Ticker,Name,buy,sell,diff,Branch,Date,Branch_Code
00632R,元大台灣50反1,1120,473,647,合庫-台中,2023-01-03,1021
1605,華新,253,78,175,合庫-台中,2023-01-03,1021
1783,和康生,102,0,102,合庫-台中,2023-01-03,1021
4114,健喬,90,21,69,合庫-台中,2023-01-03,1021
2017,官田鋼,60,0,60,合庫-台中,2023-01-03,1021
00878,國泰永續高股息,58,8,50,合庫-台中,2023-01-03,1021
00673R,期元大S＆P原油反1,56,7,49,合庫-台中,2023-01-03,1021
00665L,富邦�琤肭磪囓�2,133,91,42,合庫-台中,2023-01-03,1021
00637L,元大滬深300正2,61,20,41,合庫-台中,2023-01-03,1021
1342,八貫,48,10,38,合庫-台中,2023-01-03,1021
3523,迎輝,27,0,27,合庫-台中,2023-01-03,1021
2889,國票金,24,0,24,合庫-台中,2023-01-03,1021
2609,陽明,89,69,20,合庫-台中,2023-01-03,1021
2612,中航,21,1,20,合庫-台中,2023-01-03,1021
3521,鴻翊,20,0,20,合庫-台中,2023-01-03,1021
5202,力新,20,0,20,合庫-台中,2023-01-03,1021
8046,南電,28,9,19,合庫-台中,2023-01-03,1021
00712,復華富時不動產,17,0,17,合庫-台中,2023-01-03,1021
5464,霖宏,17,0,17,合庫-台中,2023-01-03,1021
00631L,元大台灣50正2,541,524,17,合庫-台中,2023-01-03,1021
6244,茂迪,22,5,17,合庫-台中,2023-01-03,1021
3443,創意,20,4,16,合庫-台中,2023-01-03,1021
1519,華城,34,19,15,合庫-台中,2023-01-03,1021
00688L,國泰20年美債正2,15,0,15,合庫-台中,2023-01-03,1021
9949,琉園,14,0,14,合庫-台中,2023-01-03,1021
2049,上銀,15,1,14,合庫-台中,2023-01-03,1021
3324,雙鴻,14,0,14,合庫-台中,2023-01-03,1021
1701,中化,85,72,13,合庫-台中,2023-01-03,1021
8996,高力,25,12,13,合庫-台中,2023-01-03,1021
6443,元晶,48,35,13,合庫-台中,2023-01-03,1021
3481,群創,270,258,12,合庫-台中,2023-01-03,1021
4167,松瑞藥,66,54,12,合庫-台中,2023-01-03,1021
1319,東陽,14,2,12,合庫-台中,2023-01-03,1021
00679B,元大美債20年,11,0,11,合庫-台中,2023-01-03,1021
4121,優盛,12,1,11,合庫-台中,2023-01-03,1021
4111,濟生,10,0,10,合庫-台中,2023-01-03,1021
3011,今皓,10,0,10,合庫-台中,2023-01-03,1021
1584,精剛,13,3,10,合庫-台中,2023-01-03,1021
5469,瀚宇博,10,0,10,合庫-台中,2023-01-03,1021
1760,寶齡富錦,61,51,10,合庫-台中,2023-01-03,1021
8033,雷虎,10,0,10,合庫-台中,2023-01-03,1021
00648R,元大S＆P500反1,10,0,10,合庫-台中,2023-01-03,1021
4102,永日,10,0,10,合庫-台中,2023-01-03,1021
8401,白紗科,10,0,10,合庫-台中,2023-01-03,1021
2812,台中銀,15,5,10,合庫-台中,2023-01-03,1021
1445,大宇,10,0,10,合庫-台中,2023-01-03,1021
1444,力麗,10,0,10,合庫-台中,2023-01-03,1021
2633,台灣高鐵,10,0,10,合庫-台中,2023-01-03,1021
1714,和桐,10,0,10,合庫-台中,2023-01-03,1021
2882,國泰金,21,12,9,合庫-台中,2023-01-03,1021
00715L,期街口布蘭特正2,162,0,162,合庫-台中,2023-01-04,1021
8935,邦泰,150,0,150,合庫-台中,2023-01-04,1021
1447,力鵬,104,0,104,合庫-台中,2023-01-04,1021
00878,國泰永續高股息,106,5,101,合庫-台中,2023-01-04,1021
2498,宏達電,136,46,90,合庫-台中,2023-01-04,1021
00632R,元大台灣50反1,79,0,79,合庫-台中,2023-01-04,1021
00665L,富邦�琤肭磪囓�2,258,182,76,合庫-台中,2023-01-04,1021
00650L,復華香港正2,59,5,54,合庫-台中,2023-01-04,1021
00893,國泰智能電動車,49,0,49,合庫-台中,2023-01-04,1021
00680L,元大美債20正2,45,0,45,合庫-台中,2023-01-04,1021
2317,鴻海,58,19,39,合庫-台中,2023-01-04,1021
9802,鈺齊-KY,35,0,35,合庫-台中,2023-01-04,1021
3037,欣興,39,9,30,合庫-台中,2023-01-04,1021
2610,華航,48,18,30,合庫-台中,2023-01-04,1021
6234,高僑,30,0,30,合庫-台中,2023-01-04,1021
2337,旺宏,30,0,30,合庫-台中,2023-01-04,1021
00706L,期元大S＆P日圓正2,30,3,27,合庫-台中,2023-01-04,1021
1701,中化,35,11,24,合庫-台中,2023-01-04,1021
1417,嘉裕,64,42,22,合庫-台中,2023-01-04,1021
00713,元大台灣高息低波,22,0,22,合庫-台中,2023-01-04,1021
6128,上福,40,20,20,合庫-台中,2023-01-04,1021
00670L,富邦NASDAQ正2,20,0,20,合庫-台中,2023-01-04,1021
2743,山富,25,5,20,合庫-台中,2023-01-04,1021
3466,德晉,17,0,17,合庫-台中,2023-01-04,1021
6472,保瑞,20,3,17,合庫-台中,2023-01-04,1021
5321,美而快,21,4,17,合庫-台中,2023-01-04,1021
2609,陽明,74,59,15,合庫-台中,2023-01-04,1021
2884,玉山金,15,0,15,合庫-台中,2023-01-04,1021
0056,元大高股息,17,5,12,合庫-台中,2023-01-04,1021
3027,盛達,36,24,12,合庫-台中,2023-01-04,1021
2615,萬海,20,8,12,合庫-台中,2023-01-04,1021
2882,國泰金,29,18,11,合庫-台中,2023-01-04,1021
3521,鴻翊,11,0,11,合庫-台中,2023-01-04,1021
1514,亞力,19,8,11,合庫-台中,2023-01-04,1021
00634R,富邦上証反1,11,0,11,合庫-台中,2023-01-04,1021
3205,佰研,10,0,10,合庫-台中,2023-01-04,1021
2634,漢翔,28,18,10,合庫-台中,2023-01-04,1021
00679B,元大美債20年,12,2,10,合庫-台中,2023-01-04,1021
00795B,中信美國公債20年,10,0,10,合庫-台中,2023-01-04,1021
2312,金寶,10,0,10,合庫-台中,2023-01-04,1021
5353,台林,10,0,10,合庫-台中,2023-01-04,1021
2465,麗臺,44,34,10,合庫-台中,2023-01-04,1021
00642U,期元大S＆P石油,10,0,10,合庫-台中,2023-01-04,1021
9949,琉園,17,7,10,合庫-台中,2023-01-04,1021
2601,益航,10,0,10,合庫-台中,2023-01-04,1021
2208,台船,10,0,10,合庫-台中,2023-01-04,1021
9902,台火,10,0,10,合庫-台中,2023-01-04,1021
2062,橋椿,9,0,9,合庫-台中,2023-01-04,1021
2614,東森,10,1,9,合庫-台中,2023-01-04,1021
00751B,元大AAA至A公司債,9,0,9,合庫-台中,2023-01-04,1021
3704,合勤控,138,37,101,合庫-台中,2023-01-05,1021
00715L,期街口布蘭特正2,87,3,84,合庫-台中,2023-01-05,1021
2408,南亞科,106,27,79,合庫-台中,2023-01-05,1021
00878,國泰永續高股息,87,17,70,合庫-台中,2023-01-05,1021
3523,迎輝,66,0,66,合庫-台中,2023-01-05,1021
2317,鴻海,60,7,53,合庫-台中,2023-01-05,1021
1529,樂事綠能,125,73,52,合庫-台中,2023-01-05,1021
4979,華星光,53,1,52,合庫-台中,2023-01-05,1021
1313,聯成,50,1,49,合庫-台中,2023-01-05,1021
1513,中興電,70,29,41,合庫-台中,2023-01-05,1021
00634R,富邦上証反1,40,0,40,合庫-台中,2023-01-05,1021
3521,鴻翊,40,0,40,合庫-台中,2023-01-05,1021
00642U,期元大S＆P石油,34,0,34,合庫-台中,2023-01-05,1021
1605,華新,77,45,32,合庫-台中,2023-01-05,1021
00905,FT臺灣Smart,30,0,30,合庫-台中,2023-01-05,1021
00891,中信關鍵半導體,27,0,27,合庫-台中,2023-01-05,1021
2495,普安,25,1,24,合庫-台中,2023-01-05,1021
6643,M31,25,4,21,合庫-台中,2023-01-05,1021
2017,官田鋼,21,0,21,合庫-台中,2023-01-05,1021
8069,元太,46,26,20,合庫-台中,2023-01-05,1021
2444,兆勁,20,0,20,合庫-台中,2023-01-05,1021
00909,國泰數位支付服務,20,0,20,合庫-台中,2023-01-05,1021
5351,鈺創,26,7,19,合庫-台中,2023-01-05,1021
2610,華航,36,20,16,合庫-台中,2023-01-05,1021
3706,神達,15,0,15,合庫-台中,2023-01-05,1021
3163,波若威,15,0,15,合庫-台中,2023-01-05,1021
2201,裕隆,25,10,15,合庫-台中,2023-01-05,1021
6233,旺玖,24,10,14,合庫-台中,2023-01-05,1021
00753L,中信中國50正2,20,6,14,合庫-台中,2023-01-05,1021
6104,創惟,48,35,13,合庫-台中,2023-01-05,1021
3149,正達,13,0,13,合庫-台中,2023-01-05,1021
2313,華通,14,1,13,合庫-台中,2023-01-05,1021
2324,仁寶,13,0,13,合庫-台中,2023-01-05,1021
0056,元大高股息,12,0,12,合庫-台中,2023-01-05,1021
00725B,國泰投資級公司債,12,0,12,合庫-台中,2023-01-05,1021
6257,矽格,11,0,11,合庫-台中,2023-01-05,1021
00713,元大台灣高息低波,11,0,11,合庫-台中,2023-01-05,1021
00631L,元大台灣50正2,511,500,11,合庫-台中,2023-01-05,1021
2642,宅配通,12,1,11,合庫-台中,2023-01-05,1021
00772B,中信高評級公司債,11,0,11,合庫-台中,2023-01-05,1021
00712,復華富時不動產,17,7,10,合庫-台中,2023-01-05,1021
3083,網龍,11,1,10,合庫-台中,2023-01-05,1021
4513,福裕,10,0,10,合庫-台中,2023-01-05,1021
5464,霖宏,10,0,10,合庫-台中,2023-01-05,1021
2405,輔信,10,0,10,合庫-台中,2023-01-05,1021
2034,允強,10,0,10,合庫-台中,2023-01-05,1021
8046,南電,17,7,10,合庫-台中,2023-01-05,1021
6443,元晶,39,30,9,合庫-台中,2023-01-05,1021
2419,仲琦,32,23,9,合庫-台中,2023-01-05,1021
3272,東碩,32,23,9,合庫-台中,2023-01-05,1021
3523,迎輝,173,0,173,合庫-台中,2023-01-06,1021
2851,中再保,115,0,115,合庫-台中,2023-01-06,1021
1101,台泥,65,4,61,合庫-台中,2023-01-06,1021
1108,幸福,52,0,52,合庫-台中,2023-01-06,1021
2885,元大金,50,0,50,合庫-台中,2023-01-06,1021
2888,新光金,54,8,46,合庫-台中,2023-01-06,1021
3046,建��,36,3,33,合庫-台中,2023-01-06,1021
1701,中化,78,49,29,合庫-台中,2023-01-06,1021
9933,中鼎,26,0,26,合庫-台中,2023-01-06,1021
8171,天宇,36,10,26,合庫-台中,2023-01-06,1021
00641R,富邦日本反1,25,0,25,合庫-台中,2023-01-06,1021
1605,華新,79,57,22,合庫-台中,2023-01-06,1021
00634R,富邦上証反1,20,0,20,合庫-台中,2023-01-06,1021
8935,邦泰,20,0,20,合庫-台中,2023-01-06,1021
5905,南仁湖,53,33,20,合庫-台中,2023-01-06,1021
2337,旺宏,36,17,19,合庫-台中,2023-01-06,1021
6234,高僑,19,0,19,合庫-台中,2023-01-06,1021
1519,華城,59,41,18,合庫-台中,2023-01-06,1021
5321,美而快,26,8,18,合庫-台中,2023-01-06,1021
1752,南光,28,11,17,合庫-台中,2023-01-06,1021
6443,元晶,19,3,16,合庫-台中,2023-01-06,1021
3013,晟銘電,16,0,16,合庫-台中,2023-01-06,1021
00902,中信電池及儲能,21,6,15,合庫-台中,2023-01-06,1021
00795B,中信美國公債20年,15,0,15,合庫-台中,2023-01-06,1021
2317,鴻海,21,8,13,合庫-台中,2023-01-06,1021
2330,台積電,16,3,13,合庫-台中,2023-01-06,1021
00715L,期街口布蘭特正2,13,1,12,合庫-台中,2023-01-06,1021
00882,中信中國高股息,11,0,11,合庫-台中,2023-01-06,1021
00720B,元大投資級公司債,11,0,11,合庫-台中,2023-01-06,1021
8046,南電,33,23,10,合庫-台中,2023-01-06,1021
00670L,富邦NASDAQ正2,10,0,10,合庫-台中,2023-01-06,1021
4513,福裕,10,0,10,合庫-台中,2023-01-06,1021
8155,博智,10,0,10,合庫-台中,2023-01-06,1021
1444,力麗,20,10,10,合庫-台中,2023-01-06,1021
00751B,元大AAA至A公司債,10,0,10,合庫-台中,2023-01-06,1021
00633L,富邦上証正2,10,0,10,合庫-台中,2023-01-06,1021
1432,大魯閣,10,0,10,合庫-台中,2023-01-06,1021
00682U,期元大美元指數,10,0,10,合庫-台中,2023-01-06,1021
1714,和桐,10,0,10,合庫-台中,2023-01-06,1021
6589,台康生技,155,146,9,合庫-台中,2023-01-06,1021
3272,東碩,9,0,9,合庫-台中,2023-01-06,1021
1529,樂事綠能,46,37,9,合庫-台中,2023-01-06,1021
4402,郡都開發,10,1,9,合庫-台中,2023-01-06,1021
00674R,期元大S＆P黃金反1,8,0,8,合庫-台中,2023-01-06,1021
6245,立端,10,2,8,合庫-台中,2023-01-06,1021
3466,德晉,7,0,7,合庫-台中,2023-01-06,1021
00900,富邦特選高股息30,10,3,7,合庫-台中,2023-01-06,1021
00891,中信關鍵半導體,11,4,7,合庫-台中,2023-01-06,1021
3056,富華新,9,2,7,合庫-台中,2023-01-06,1021
6176,瑞儀,12,6,6,合庫-台中,2023-01-06,1021
00671R,富邦NASDAQ反1,371,0,371,合庫-台中,2023-01-09,1021
00632R,元大台灣50反1,302,204,98,合庫-台中,2023-01-09,1021
00715L,期街口布蘭特正2,123,32,91,合庫-台中,2023-01-09,1021
00885,富邦越南,80,10,70,合庫-台中,2023-01-09,1021
3149,正達,62,0,62,合庫-台中,2023-01-09,1021
2002,中鋼,101,42,59,合庫-台中,2023-01-09,1021
2851,中再保,54,0,54,合庫-台中,2023-01-09,1021
00665L,富邦�琤肭磪囓�2,85,34,51,合庫-台中,2023-01-09,1021
2634,漢翔,58,10,48,合庫-台中,2023-01-09,1021
2014,中鴻,55,8,47,合庫-台中,2023-01-09,1021
00706L,期元大S＆P日圓正2,45,0,45,合庫-台中,2023-01-09,1021
1701,中化,86,41,45,合庫-台中,2023-01-09,1021
2615,萬海,67,22,45,合庫-台中,2023-01-09,1021
1605,華新,79,37,42,合庫-台中,2023-01-09,1021
8038,長園科,41,1,40,合庫-台中,2023-01-09,1021
2618,長榮航,111,75,36,合庫-台中,2023-01-09,1021
2609,陽明,95,65,30,合庫-台中,2023-01-09,1021
4513,福裕,30,0,30,合庫-台中,2023-01-09,1021
5905,南仁湖,25,0,25,合庫-台中,2023-01-09,1021
4114,健喬,122,97,25,合庫-台中,2023-01-09,1021
3272,東碩,26,4,22,合庫-台中,2023-01-09,1021
6235,華孚,24,2,22,合庫-台中,2023-01-09,1021
00795B,中信美國公債20年,22,0,22,合庫-台中,2023-01-09,1021
2515,中工,20,0,20,合庫-台中,2023-01-09,1021
00634R,富邦上証反1,20,0,20,合庫-台中,2023-01-09,1021
6120,達運,20,0,20,合庫-台中,2023-01-09,1021
3141,晶宏,30,10,20,合庫-台中,2023-01-09,1021
00664R,國泰臺灣加權反1,18,0,18,合庫-台中,2023-01-09,1021
8358,金居,28,10,18,合庫-台中,2023-01-09,1021
2603,長榮,22,6,16,合庫-台中,2023-01-09,1021
5227,立凱-KY,28,12,16,合庫-台中,2023-01-09,1021
00893,國泰智能電動車,22,7,15,合庫-台中,2023-01-09,1021
6133,金橋,22,7,15,合庫-台中,2023-01-09,1021
00720B,元大投資級公司債,14,0,14,合庫-台中,2023-01-09,1021
4105,東洋,14,0,14,合庫-台中,2023-01-09,1021
6182,合晶,24,10,14,合庫-台中,2023-01-09,1021
00895,富邦未來車,14,0,14,合庫-台中,2023-01-09,1021
2630,亞航,14,0,14,合庫-台中,2023-01-09,1021
3027,盛達,14,1,13,合庫-台中,2023-01-09,1021
00631L,元大台灣50正2,560,547,13,合庫-台中,2023-01-09,1021
2208,台船,12,0,12,合庫-台中,2023-01-09,1021
2358,廷鑫,12,0,12,合庫-台中,2023-01-09,1021
1417,嘉裕,12,0,12,合庫-台中,2023-01-09,1021
6234,高僑,12,0,12,合庫-台中,2023-01-09,1021
00713,元大台灣高息低波,13,1,12,合庫-台中,2023-01-09,1021
2867,三商壽,15,4,11,合庫-台中,2023-01-09,1021
3521,鴻翊,11,0,11,合庫-台中,2023-01-09,1021
5410,國眾,11,0,11,合庫-台中,2023-01-09,1021
9958,世紀鋼,21,10,11,合庫-台中,2023-01-09,1021
3062,建漢,12,1,11,合庫-台中,2023-01-09,1021
00715L,期街口布蘭特正2,106,1,105,合庫-台中,2023-01-10,1021
6770,力積電,83,27,56,合庫-台中,2023-01-10,1021
1220,台榮,50,0,50,合庫-台中,2023-01-10,1021
2409,友達,69,30,39,合庫-台中,2023-01-10,1021
4919,新唐,39,1,38,合庫-台中,2023-01-10,1021
3523,迎輝,34,0,34,合庫-台中,2023-01-10,1021
3521,鴻翊,30,0,30,合庫-台中,2023-01-10,1021
1314,中石化,33,5,28,合庫-台中,2023-01-10,1021
3454,晶睿,78,50,28,合庫-台中,2023-01-10,1021
2444,兆勁,25,0,25,合庫-台中,2023-01-10,1021
1701,中化,29,4,25,合庫-台中,2023-01-10,1021
00670L,富邦NASDAQ正2,25,1,24,合庫-台中,2023-01-10,1021
6234,高僑,24,1,23,合庫-台中,2023-01-10,1021
00632R,元大台灣50反1,103,80,23,合庫-台中,2023-01-10,1021
8249,菱光,32,10,22,合庫-台中,2023-01-10,1021
3149,正達,20,0,20,合庫-台中,2023-01-10,1021
2481,強茂,20,0,20,合庫-台中,2023-01-10,1021
2312,金寶,20,0,20,合庫-台中,2023-01-10,1021
3062,建漢,21,3,18,合庫-台中,2023-01-10,1021
2009,第一銅,18,0,18,合庫-台中,2023-01-10,1021
4566,時碩工業,17,0,17,合庫-台中,2023-01-10,1021
3466,德晉,15,0,15,合庫-台中,2023-01-10,1021
00795B,中信美國公債20年,15,0,15,合庫-台中,2023-01-10,1021
2606,裕民,15,0,15,合庫-台中,2023-01-10,1021
1513,中興電,47,32,15,合庫-台中,2023-01-10,1021
2884,玉山金,16,2,14,合庫-台中,2023-01-10,1021
2313,華通,15,1,14,合庫-台中,2023-01-10,1021
6443,元晶,21,7,14,合庫-台中,2023-01-10,1021
8358,金居,21,8,13,合庫-台中,2023-01-10,1021
5321,美而快,14,2,12,合庫-台中,2023-01-10,1021
00725B,國泰投資級公司債,13,1,12,合庫-台中,2023-01-10,1021
4147,中裕,12,0,12,合庫-台中,2023-01-10,1021
6129,普誠,11,0,11,合庫-台中,2023-01-10,1021
1325,恆大,10,0,10,合庫-台中,2023-01-10,1021
4513,福裕,10,0,10,合庫-台中,2023-01-10,1021
00713,元大台灣高息低波,10,0,10,合庫-台中,2023-01-10,1021
2603,長榮,11,1,10,合庫-台中,2023-01-10,1021
1809,中釉,10,0,10,合庫-台中,2023-01-10,1021
2607,榮運,10,0,10,合庫-台中,2023-01-10,1021
2542,興富發,10,0,10,合庫-台中,2023-01-10,1021
2108,南帝,10,0,10,合庫-台中,2023-01-10,1021
00634R,富邦上証反1,10,0,10,合庫-台中,2023-01-10,1021
1736,喬山,13,3,10,合庫-台中,2023-01-10,1021
8033,雷虎,12,2,10,合庫-台中,2023-01-10,1021
1810,和成,9,0,9,合庫-台中,2023-01-10,1021
2637,慧洋-KY,10,1,9,合庫-台中,2023-01-10,1021
00642U,期元大S＆P石油,9,0,9,合庫-台中,2023-01-10,1021
00900,富邦特選高股息30,11,2,9,合庫-台中,2023-01-10,1021
2317,鴻海,13,4,9,合庫-台中,2023-01-10,1021
2388,威盛,9,0,9,合庫-台中,2023-01-10,1021
00665L,富邦�琤肭磪囓�2,308,111,197,合庫-台中,2023-01-11,1021
2610,華航,94,21,73,合庫-台中,2023-01-11,1021
00878,國泰永續高股息,99,37,62,合庫-台中,2023-01-11,1021
00642U,期元大S＆P石油,50,0,50,合庫-台中,2023-01-11,1021
2358,廷鑫,54,8,46,合庫-台中,2023-01-11,1021
4747,強生,60,15,45,合庫-台中,2023-01-11,1021
2337,旺宏,42,0,42,合庫-台中,2023-01-11,1021
2413,環科,36,5,31,合庫-台中,2023-01-11,1021
2897,王道銀行,91,63,28,合庫-台中,2023-01-11,1021
2834,臺企銀,37,10,27,合庫-台中,2023-01-11,1021
3521,鴻翊,26,0,26,合庫-台中,2023-01-11,1021
2313,華通,21,0,21,合庫-台中,2023-01-11,1021
2633,台灣高鐵,20,0,20,合庫-台中,2023-01-11,1021
3149,正達,20,0,20,合庫-台中,2023-01-11,1021
1752,南光,37,17,20,合庫-台中,2023-01-11,1021
2812,台中銀,21,4,17,合庫-台中,2023-01-11,1021
4513,福裕,15,0,15,合庫-台中,2023-01-11,1021
2884,玉山金,37,22,15,合庫-台中,2023-01-11,1021
6186,新潤,14,0,14,合庫-台中,2023-01-11,1021
2324,仁寶,15,1,14,合庫-台中,2023-01-11,1021
1513,中興電,72,59,13,合庫-台中,2023-01-11,1021
2867,三商壽,13,0,13,合庫-台中,2023-01-11,1021
4904,遠傳,13,0,13,合庫-台中,2023-01-11,1021
6215,和椿,13,0,13,合庫-台中,2023-01-11,1021
8016,矽創,13,0,13,合庫-台中,2023-01-11,1021
00795B,中信美國公債20年,12,0,12,合庫-台中,2023-01-11,1021
2748,雲品,12,0,12,合庫-台中,2023-01-11,1021
3455,由田,12,0,12,合庫-台中,2023-01-11,1021
6533,晶心科,26,14,12,合庫-台中,2023-01-11,1021
2601,益航,21,10,11,合庫-台中,2023-01-11,1021
2368,金像電,19,9,10,合庫-台中,2023-01-11,1021
2323,中環,10,0,10,合庫-台中,2023-01-11,1021
2458,義隆,11,1,10,合庫-台中,2023-01-11,1021
1444,力麗,10,0,10,合庫-台中,2023-01-11,1021
1409,新纖,10,0,10,合庫-台中,2023-01-11,1021
5321,美而快,21,11,10,合庫-台中,2023-01-11,1021
2915,潤泰全,10,0,10,合庫-台中,2023-01-11,1021
0056,元大高股息,18,9,9,合庫-台中,2023-01-11,1021
3523,迎輝,9,0,9,合庫-台中,2023-01-11,1021
1442,名軒,9,0,9,合庫-台中,2023-01-11,1021
2605,新興,8,0,8,合庫-台中,2023-01-11,1021
2206,三陽工業,8,0,8,合庫-台中,2023-01-11,1021
4924,欣厚-KY,8,0,8,合庫-台中,2023-01-11,1021
2903,遠百,8,0,8,合庫-台中,2023-01-11,1021
4503,金雨,8,0,8,合庫-台中,2023-01-11,1021
3419,譁裕,7,0,7,合庫-台中,2023-01-11,1021
2328,廣宇,8,1,7,合庫-台中,2023-01-11,1021
9945,潤泰新,8,1,7,合庫-台中,2023-01-11,1021
4743,合一,10,3,7,合庫-台中,2023-01-11,1021
2388,威盛,8,2,6,合庫-台中,2023-01-11,1021
3523,迎輝,216,0,216,合庫-台中,2023-01-12,1021
2014,中鴻,219,59,160,合庫-台中,2023-01-12,1021
3481,群創,96,9,87,合庫-台中,2023-01-12,1021
1608,華榮,80,0,80,合庫-台中,2023-01-12,1021
1513,中興電,116,52,64,合庫-台中,2023-01-12,1021
1444,力麗,55,0,55,合庫-台中,2023-01-12,1021
2009,第一銅,118,77,41,合庫-台中,2023-01-12,1021
6609,瀧澤科,49,10,39,合庫-台中,2023-01-12,1021
2884,玉山金,37,0,37,合庫-台中,2023-01-12,1021
00882,中信中國高股息,32,0,32,合庫-台中,2023-01-12,1021
1795,美時,87,56,31,合庫-台中,2023-01-12,1021
00642U,期元大S＆P石油,50,20,30,合庫-台中,2023-01-12,1021
8358,金居,32,2,30,合庫-台中,2023-01-12,1021
2887,台新金,30,2,28,合庫-台中,2023-01-12,1021
1605,華新,127,99,28,合庫-台中,2023-01-12,1021
2603,長榮,32,7,25,合庫-台中,2023-01-12,1021
2886,兆豐金,30,7,23,合庫-台中,2023-01-12,1021
4552,力達-KY,43,21,22,合庫-台中,2023-01-12,1021
2888,新光金,52,30,22,合庫-台中,2023-01-12,1021
2610,華航,31,10,21,合庫-台中,2023-01-12,1021
8097,常珵,23,2,21,合庫-台中,2023-01-12,1021
4904,遠傳,20,0,20,合庫-台中,2023-01-12,1021
2324,仁寶,21,1,20,合庫-台中,2023-01-12,1021
3056,富華新,20,0,20,合庫-台中,2023-01-12,1021
2601,益航,20,0,20,合庫-台中,2023-01-12,1021
4114,健喬,30,11,19,合庫-台中,2023-01-12,1021
2337,旺宏,20,2,18,合庫-台中,2023-01-12,1021
4513,福裕,18,0,18,合庫-台中,2023-01-12,1021
00753L,中信中國50正2,19,2,17,合庫-台中,2023-01-12,1021
8261,富鼎,21,5,16,合庫-台中,2023-01-12,1021
2890,永豐金,21,5,16,合庫-台中,2023-01-12,1021
4162,智擎,38,23,15,合庫-台中,2023-01-12,1021
00888,永豐台灣ESG,14,0,14,合庫-台中,2023-01-12,1021
2897,王道銀行,105,91,14,合庫-台中,2023-01-12,1021
00673R,期元大S＆P原油反1,13,0,13,合庫-台中,2023-01-12,1021
4121,優盛,13,0,13,合庫-台中,2023-01-12,1021
00795B,中信美國公債20年,13,0,13,合庫-台中,2023-01-12,1021
2812,台中銀,13,0,13,合庫-台中,2023-01-12,1021
00900,富邦特選高股息30,12,0,12,合庫-台中,2023-01-12,1021
2880,華南金,12,1,11,合庫-台中,2023-01-12,1021
2609,陽明,55,44,11,合庫-台中,2023-01-12,1021
2108,南帝,10,0,10,合庫-台中,2023-01-12,1021
2380,虹光,10,0,10,合庫-台中,2023-01-12,1021
3045,台灣大,10,0,10,合庫-台中,2023-01-12,1021
4924,欣厚-KY,10,0,10,合庫-台中,2023-01-12,1021
2023,燁輝,43,33,10,合庫-台中,2023-01-12,1021
2497,怡利電,10,0,10,合庫-台中,2023-01-12,1021
4147,中裕,10,0,10,合庫-台中,2023-01-12,1021
2892,第一金,10,1,9,合庫-台中,2023-01-12,1021
2388,威盛,11,2,9,合庫-台中,2023-01-12,1021
00673R,期元大S＆P原油反1,525,0,525,合庫-台中,2023-01-13,1021
00669R,國泰美國道瓊反1,156,0,156,合庫-台中,2023-01-13,1021
2885,元大金,105,1,104,合庫-台中,2023-01-13,1021
2002,中鋼,120,42,78,合庫-台中,2023-01-13,1021
8110,華東,57,0,57,合庫-台中,2023-01-13,1021
1513,中興電,84,31,53,合庫-台中,2023-01-13,1021
4979,華星光,57,6,51,合庫-台中,2023-01-13,1021
00665L,富邦�琤肭磪囓�2,52,15,37,合庫-台中,2023-01-13,1021
00878,國泰永續高股息,63,28,35,合庫-台中,2023-01-13,1021
2344,華邦電,36,3,33,合庫-台中,2023-01-13,1021
2880,華南金,34,1,33,合庫-台中,2023-01-13,1021
2498,宏達電,67,39,28,合庫-台中,2023-01-13,1021
2891,中信金,27,0,27,合庫-台中,2023-01-13,1021
8050,廣積,25,2,23,合庫-台中,2023-01-13,1021
2027,大成鋼,24,2,22,合庫-台中,2023-01-13,1021
00637L,元大滬深300正2,109,88,21,合庫-台中,2023-01-13,1021
2108,南帝,21,0,21,合庫-台中,2023-01-13,1021
2457,飛宏,20,0,20,合庫-台中,2023-01-13,1021
00634R,富邦上証反1,20,0,20,合庫-台中,2023-01-13,1021
1417,嘉裕,20,1,19,合庫-台中,2023-01-13,1021
2049,上銀,18,0,18,合庫-台中,2023-01-13,1021
2371,大同,19,2,17,合庫-台中,2023-01-13,1021
2312,金寶,17,0,17,合庫-台中,2023-01-13,1021
3163,波若威,17,0,17,合庫-台中,2023-01-13,1021
1409,新纖,17,0,17,合庫-台中,2023-01-13,1021
6443,元晶,37,20,17,合庫-台中,2023-01-13,1021
4743,合一,18,2,16,合庫-台中,2023-01-13,1021
1560,中砂,41,25,16,合庫-台中,2023-01-13,1021
6770,力積電,26,11,15,合庫-台中,2023-01-13,1021
1201,味全,15,0,15,合庫-台中,2023-01-13,1021
00891,中信關鍵半導體,18,3,15,合庫-台中,2023-01-13,1021
2884,玉山金,34,20,14,合庫-台中,2023-01-13,1021
2014,中鴻,177,163,14,合庫-台中,2023-01-13,1021
3545,敦泰,13,0,13,合庫-台中,2023-01-13,1021
2328,廣宇,13,0,13,合庫-台中,2023-01-13,1021
3162,精確,15,2,13,合庫-台中,2023-01-13,1021
1539,巨庭,12,0,12,合庫-台中,2023-01-13,1021
2892,第一金,12,0,12,合庫-台中,2023-01-13,1021
3438,類比科,12,0,12,合庫-台中,2023-01-13,1021
6456,GIS-KY,12,0,12,合庫-台中,2023-01-13,1021
1540,喬福,12,1,11,合庫-台中,2023-01-13,1021
2887,台新金,11,0,11,合庫-台中,2023-01-13,1021
2601,益航,11,0,11,合庫-台中,2023-01-13,1021
9955,佳龍,11,0,11,合庫-台中,2023-01-13,1021
2607,榮運,12,2,10,合庫-台中,2023-01-13,1021
00674R,期元大S＆P黃金反1,10,0,10,合庫-台中,2023-01-13,1021
1444,力麗,20,10,10,合庫-台中,2023-01-13,1021
2916,滿心,10,0,10,合庫-台中,2023-01-13,1021
2458,義隆,10,0,10,合庫-台中,2023-01-13,1021
3056,富華新,9,0,9,合庫-台中,2023-01-13,1021
0056,元大高股息,86,9,77,合庫-台中,2023-01-16,1021
3576,聯合再生,64,4,60,合庫-台中,2023-01-16,1021
2303,聯電,158,104,54,合庫-台中,2023-01-16,1021
2317,鴻海,50,0,50,合庫-台中,2023-01-16,1021
6770,力積電,67,29,38,合庫-台中,2023-01-16,1021
1101,台泥,45,9,36,合庫-台中,2023-01-16,1021
4162,智擎,46,10,36,合庫-台中,2023-01-16,1021
2014,中鴻,140,105,35,合庫-台中,2023-01-16,1021
4513,福裕,32,0,32,合庫-台中,2023-01-16,1021
2610,華航,32,2,30,合庫-台中,2023-01-16,1021
8215,明基材,30,0,30,合庫-台中,2023-01-16,1021
6116,彩晶,40,12,28,合庫-台中,2023-01-16,1021
2845,遠東銀,27,1,26,合庫-台中,2023-01-16,1021
5321,美而快,44,20,24,合庫-台中,2023-01-16,1021
3162,精確,20,0,20,合庫-台中,2023-01-16,1021
2444,兆勁,20,1,19,合庫-台中,2023-01-16,1021
3037,欣興,46,27,19,合庫-台中,2023-01-16,1021
2618,長榮航,28,11,17,合庫-台中,2023-01-16,1021
6874,倍力,16,0,16,合庫-台中,2023-01-16,1021
00666R,富邦�琤肭磪齯�1,16,0,16,合庫-台中,2023-01-16,1021
3523,迎輝,16,0,16,合庫-台中,2023-01-16,1021
2337,旺宏,20,4,16,合庫-台中,2023-01-16,1021
8049,晶采,15,0,15,合庫-台中,2023-01-16,1021
3013,晟銘電,14,0,14,合庫-台中,2023-01-16,1021
3206,志豐,14,0,14,合庫-台中,2023-01-16,1021
00770,國泰北美科技,13,0,13,合庫-台中,2023-01-16,1021
1584,精剛,15,2,13,合庫-台中,2023-01-16,1021
2727,王品,13,0,13,合庫-台中,2023-01-16,1021
2880,華南金,13,1,12,合庫-台中,2023-01-16,1021
00892,富邦台灣半導體,15,3,12,合庫-台中,2023-01-16,1021
1540,喬福,12,0,12,合庫-台中,2023-01-16,1021
1313,聯成,10,0,10,合庫-台中,2023-01-16,1021
00773B,中信優先金融債,10,0,10,合庫-台中,2023-01-16,1021
3438,類比科,10,0,10,合庫-台中,2023-01-16,1021
2338,光罩,68,58,10,合庫-台中,2023-01-16,1021
2605,新興,11,1,10,合庫-台中,2023-01-16,1021
2387,精元,10,0,10,合庫-台中,2023-01-16,1021
2323,中環,10,0,10,合庫-台中,2023-01-16,1021
6104,創惟,10,0,10,合庫-台中,2023-01-16,1021
4102,永日,10,0,10,合庫-台中,2023-01-16,1021
4939,亞電,10,0,10,合庫-台中,2023-01-16,1021
8096,擎亞,10,0,10,合庫-台中,2023-01-16,1021
1605,華新,13,5,8,合庫-台中,2023-01-16,1021
2609,陽明,37,29,8,合庫-台中,2023-01-16,1021
1304,台聚,8,0,8,合庫-台中,2023-01-16,1021
9902,台火,8,0,8,合庫-台中,2023-01-16,1021
6533,晶心科,9,2,7,合庫-台中,2023-01-16,1021
9949,琉園,11,4,7,合庫-台中,2023-01-16,1021
00720B,元大投資級公司債,7,0,7,合庫-台中,2023-01-16,1021
1220,台榮,7,0,7,合庫-台中,2023-01-16,1021
2002,中鋼,185,7,178,合庫-台中,2023-01-17,1021
2834,臺企銀,180,8,172,合庫-台中,2023-01-17,1021
2618,長榮航,186,31,155,合庫-台中,2023-01-17,1021
00673R,期元大S＆P原油反1,154,0,154,合庫-台中,2023-01-17,1021
6770,力積電,149,2,147,合庫-台中,2023-01-17,1021
2883,凱基金,76,5,71,合庫-台中,2023-01-17,1021
00637L,元大滬深300正2,107,40,67,合庫-台中,2023-01-17,1021
2884,玉山金,49,0,49,合庫-台中,2023-01-17,1021
6547,高端疫苗,46,0,46,合庫-台中,2023-01-17,1021
1219,福壽,44,7,37,合庫-台中,2023-01-17,1021
00631L,元大台灣50正2,333,303,30,合庫-台中,2023-01-17,1021
3037,欣興,38,11,27,合庫-台中,2023-01-17,1021
00878,國泰永續高股息,50,23,27,合庫-台中,2023-01-17,1021
5014,建錩,26,1,25,合庫-台中,2023-01-17,1021
00682U,期元大美元指數,24,0,24,合庫-台中,2023-01-17,1021
0056,元大高股息,24,2,22,合庫-台中,2023-01-17,1021
2880,華南金,21,0,21,合庫-台中,2023-01-17,1021
2812,台中銀,21,0,21,合庫-台中,2023-01-17,1021
2367,燿華,21,0,21,合庫-台中,2023-01-17,1021
00892,富邦台灣半導體,20,0,20,合庫-台中,2023-01-17,1021
1414,東和,20,0,20,合庫-台中,2023-01-17,1021
1447,力鵬,20,0,20,合庫-台中,2023-01-17,1021
5880,合庫金,28,9,19,合庫-台中,2023-01-17,1021
2886,兆豐金,27,8,19,合庫-台中,2023-01-17,1021
00633L,富邦上証正2,19,0,19,合庫-台中,2023-01-17,1021
00882,中信中國高股息,18,0,18,合庫-台中,2023-01-17,1021
00795B,中信美國公債20年,18,0,18,合庫-台中,2023-01-17,1021
2317,鴻海,21,3,18,合庫-台中,2023-01-17,1021
1101,台泥,22,6,16,合庫-台中,2023-01-17,1021
4513,福裕,15,0,15,合庫-台中,2023-01-17,1021
00900,富邦特選高股息30,15,0,15,合庫-台中,2023-01-17,1021
2460,建通,11,0,11,合庫-台中,2023-01-17,1021
4904,遠傳,10,0,10,合庫-台中,2023-01-17,1021
1524,耿鼎,15,5,10,合庫-台中,2023-01-17,1021
2498,宏達電,10,0,10,合庫-台中,2023-01-17,1021
00770,國泰北美科技,14,4,10,合庫-台中,2023-01-17,1021
6741,91APP*-KY,10,0,10,合庫-台中,2023-01-17,1021
00720B,元大投資級公司債,10,0,10,合庫-台中,2023-01-17,1021
1760,寶齡富錦,35,25,10,合庫-台中,2023-01-17,1021
4747,強生,10,0,10,合庫-台中,2023-01-17,1021
2615,萬海,12,3,9,合庫-台中,2023-01-17,1021
0050,元大台灣50,20,11,9,合庫-台中,2023-01-17,1021
6188,廣明,15,6,9,合庫-台中,2023-01-17,1021
2887,台新金,11,2,9,合庫-台中,2023-01-17,1021
2603,長榮,13,5,8,合庫-台中,2023-01-17,1021
00679B,元大美債20年,8,0,8,合庫-台中,2023-01-17,1021
00669R,國泰美國道瓊反1,8,0,8,合庫-台中,2023-01-17,1021
3702,大聯大,10,2,8,合庫-台中,2023-01-17,1021
8038,長園科,11,3,8,合庫-台中,2023-01-17,1021
3141,晶宏,8,1,7,合庫-台中,2023-01-17,1021
00665L,富邦�琤肭磪囓�2,755,7,748,合庫-台中,2023-01-30,1021
00632R,元大台灣50反1,1026,460,566,合庫-台中,2023-01-30,1021
2897,王道銀行,137,12,125,合庫-台中,2023-01-30,1021
2891,中信金,130,33,97,合庫-台中,2023-01-30,1021
2845,遠東銀,94,17,77,合庫-台中,2023-01-30,1021
2317,鴻海,91,25,66,合庫-台中,2023-01-30,1021
00673R,期元大S＆P原油反1,59,5,54,合庫-台中,2023-01-30,1021
2903,遠百,56,5,51,合庫-台中,2023-01-30,1021
00680L,元大美債20正2,44,0,44,合庫-台中,2023-01-30,1021
1506,正道,42,0,42,合庫-台中,2023-01-30,1021
5483,中美晶,42,0,42,合庫-台中,2023-01-30,1021
2609,陽明,45,7,38,合庫-台中,2023-01-30,1021
2812,台中銀,40,3,37,合庫-台中,2023-01-30,1021
00712,復華富時不動產,63,28,35,合庫-台中,2023-01-30,1021
00753L,中信中國50正2,33,0,33,合庫-台中,2023-01-30,1021
1737,臺鹽,30,0,30,合庫-台中,2023-01-30,1021
4114,健喬,37,8,29,合庫-台中,2023-01-30,1021
2892,第一金,32,4,28,合庫-台中,2023-01-30,1021
8069,元太,49,25,24,合庫-台中,2023-01-30,1021
1701,中化,25,2,23,合庫-台中,2023-01-30,1021
00666R,富邦�琤肭磪齯�1,21,0,21,合庫-台中,2023-01-30,1021
1809,中釉,20,0,20,合庫-台中,2023-01-30,1021
2006,東和鋼鐵,20,0,20,合庫-台中,2023-01-30,1021
3141,晶宏,27,7,20,合庫-台中,2023-01-30,1021
00683L,期元大美元指正2,20,0,20,合庫-台中,2023-01-30,1021
1201,味全,30,10,20,合庫-台中,2023-01-30,1021
2328,廣宇,37,18,19,合庫-台中,2023-01-30,1021
4113,聯上,15,0,15,合庫-台中,2023-01-30,1021
2457,飛宏,25,10,15,合庫-台中,2023-01-30,1021
2601,益航,15,1,14,合庫-台中,2023-01-30,1021
1560,中砂,16,3,13,合庫-台中,2023-01-30,1021
6456,GIS-KY,13,0,13,合庫-台中,2023-01-30,1021
2358,廷鑫,12,0,12,合庫-台中,2023-01-30,1021
2603,長榮,12,0,12,合庫-台中,2023-01-30,1021
00653L,富邦印度正2,11,0,11,合庫-台中,2023-01-30,1021
5263,智崴,13,2,11,合庫-台中,2023-01-30,1021
3205,佰研,10,0,10,合庫-台中,2023-01-30,1021
2906,高林,10,0,10,合庫-台中,2023-01-30,1021
5905,南仁湖,10,0,10,合庫-台中,2023-01-30,1021
4552,力達-KY,13,3,10,合庫-台中,2023-01-30,1021
00770,國泰北美科技,10,1,9,合庫-台中,2023-01-30,1021
1909,榮成,17,8,9,合庫-台中,2023-01-30,1021
2614,東森,12,3,9,合庫-台中,2023-01-30,1021
2633,台灣高鐵,10,1,9,合庫-台中,2023-01-30,1021
00687B,國泰20年美債,9,0,9,合庫-台中,2023-01-30,1021
3035,智原,30,22,8,合庫-台中,2023-01-30,1021
2368,金像電,7,0,7,合庫-台中,2023-01-30,1021
6451,訊芯-KY,7,0,7,合庫-台中,2023-01-30,1021
2349,錸德,11,4,7,合庫-台中,2023-01-30,1021
4128,中天,15,8,7,合庫-台中,2023-01-30,1021
00665L,富邦�琤肭磪囓�2,770,0,770,合庫-台中,2023-01-31,1021
2867,三商壽,506,9,497,合庫-台中,2023-01-31,1021
00905,FT臺灣Smart,168,2,166,合庫-台中,2023-01-31,1021
5880,合庫金,150,0,150,合庫-台中,2023-01-31,1021
00632R,元大台灣50反1,165,53,112,合庫-台中,2023-01-31,1021
00878,國泰永續高股息,114,19,95,合庫-台中,2023-01-31,1021
00673R,期元大S＆P原油反1,86,0,86,合庫-台中,2023-01-31,1021
6770,力積電,106,22,84,合庫-台中,2023-01-31,1021
2845,遠東銀,82,0,82,合庫-台中,2023-01-31,1021
2892,第一金,80,0,80,合庫-台中,2023-01-31,1021
6116,彩晶,121,54,67,合庫-台中,2023-01-31,1021
2885,元大金,59,0,59,合庫-台中,2023-01-31,1021
2891,中信金,55,0,55,合庫-台中,2023-01-31,1021
2929,淘帝-KY,51,1,50,合庫-台中,2023-01-31,1021
2888,新光金,42,0,42,合庫-台中,2023-01-31,1021
2388,威盛,51,10,41,合庫-台中,2023-01-31,1021
2376,技嘉,38,2,36,合庫-台中,2023-01-31,1021
2516,新建,35,0,35,合庫-台中,2023-01-31,1021
2328,廣宇,71,37,34,合庫-台中,2023-01-31,1021
00715L,期街口布蘭特正2,34,0,34,合庫-台中,2023-01-31,1021
00682U,期元大美元指數,31,0,31,合庫-台中,2023-01-31,1021
1734,杏輝,30,0,30,合庫-台中,2023-01-31,1021
3576,聯合再生,38,10,28,合庫-台中,2023-01-31,1021
00712,復華富時不動產,28,1,27,合庫-台中,2023-01-31,1021
6180,橘子,36,12,24,合庫-台中,2023-01-31,1021
6186,新潤,23,0,23,合庫-台中,2023-01-31,1021
2890,永豐金,28,5,23,合庫-台中,2023-01-31,1021
00652,富邦印度,22,0,22,合庫-台中,2023-01-31,1021
4114,健喬,24,2,22,合庫-台中,2023-01-31,1021
3521,鴻翊,22,0,22,合庫-台中,2023-01-31,1021
1444,力麗,31,10,21,合庫-台中,2023-01-31,1021
2884,玉山金,23,3,20,合庫-台中,2023-01-31,1021
2324,仁寶,20,0,20,合庫-台中,2023-01-31,1021
1452,宏益,20,0,20,合庫-台中,2023-01-31,1021
00637L,元大滬深300正2,25,5,20,合庫-台中,2023-01-31,1021
0050,元大台灣50,19,3,16,合庫-台中,2023-01-31,1021
2603,長榮,21,5,16,合庫-台中,2023-01-31,1021
2106,建大,15,0,15,合庫-台中,2023-01-31,1021
00720B,元大投資級公司債,14,0,14,合庫-台中,2023-01-31,1021
3027,盛達,24,10,14,合庫-台中,2023-01-31,1021
3711,日月光投控,23,10,13,合庫-台中,2023-01-31,1021
0056,元大高股息,47,34,13,合庫-台中,2023-01-31,1021
6125,廣運,46,33,13,合庫-台中,2023-01-31,1021
4961,天鈺,15,2,13,合庫-台中,2023-01-31,1021
00650L,復華香港正2,13,0,13,合庫-台中,2023-01-31,1021
00669R,國泰美國道瓊反1,21,8,13,合庫-台中,2023-01-31,1021
5014,建錩,13,0,13,合庫-台中,2023-01-31,1021
3481,群創,144,131,13,合庫-台中,2023-01-31,1021
5871,中租-KY,12,1,11,合庫-台中,2023-01-31,1021
4931,新盛力,19,8,11,合庫-台中,2023-01-31,1021
00665L,富邦�琤肭磪囓�2,1773,19,1754,合庫-台中,2023-02-01,1021
2845,遠東銀,406,5,401,合庫-台中,2023-02-01,1021
2014,中鴻,214,19,195,合庫-台中,2023-02-01,1021
00632R,元大台灣50反1,182,25,157,合庫-台中,2023-02-01,1021
2409,友達,61,10,51,合庫-台中,2023-02-01,1021
1718,中纖,60,10,50,合庫-台中,2023-02-01,1021
00637L,元大滬深300正2,68,22,46,合庫-台中,2023-02-01,1021
2449,京元電子,51,6,45,合庫-台中,2023-02-01,1021
2317,鴻海,63,19,44,合庫-台中,2023-02-01,1021
1810,和成,62,20,42,合庫-台中,2023-02-01,1021
6733,博晟生醫,40,0,40,合庫-台中,2023-02-01,1021
00680L,元大美債20正2,40,0,40,合庫-台中,2023-02-01,1021
2867,三商壽,54,14,40,合庫-台中,2023-02-01,1021
00878,國泰永續高股息,41,3,38,合庫-台中,2023-02-01,1021
00905,FT臺灣Smart,37,1,36,合庫-台中,2023-02-01,1021
1605,華新,76,43,33,合庫-台中,2023-02-01,1021
2891,中信金,33,0,33,合庫-台中,2023-02-01,1021
8358,金居,34,5,29,合庫-台中,2023-02-01,1021
2929,淘帝-KY,42,14,28,合庫-台中,2023-02-01,1021
2609,陽明,41,14,27,合庫-台中,2023-02-01,1021
2615,萬海,30,4,26,合庫-台中,2023-02-01,1021
2312,金寶,26,0,26,合庫-台中,2023-02-01,1021
2009,第一銅,98,72,26,合庫-台中,2023-02-01,1021
00888,永豐台灣ESG,30,5,25,合庫-台中,2023-02-01,1021
2610,華航,112,88,24,合庫-台中,2023-02-01,1021
8044,網家,24,2,22,合庫-台中,2023-02-01,1021
2888,新光金,22,0,22,合庫-台中,2023-02-01,1021
2801,彰銀,20,0,20,合庫-台中,2023-02-01,1021
2472,立隆電,20,0,20,合庫-台中,2023-02-01,1021
1734,杏輝,20,0,20,合庫-台中,2023-02-01,1021
1304,台聚,22,2,20,合庫-台中,2023-02-01,1021
00652,富邦印度,20,0,20,合庫-台中,2023-02-01,1021
2637,慧洋-KY,19,0,19,合庫-台中,2023-02-01,1021
2330,台積電,29,11,18,合庫-台中,2023-02-01,1021
00666R,富邦�琤肭磪齯�1,18,0,18,合庫-台中,2023-02-01,1021
1453,大將,22,4,18,合庫-台中,2023-02-01,1021
3046,建��,23,6,17,合庫-台中,2023-02-01,1021
1513,中興電,53,37,16,合庫-台中,2023-02-01,1021
2634,漢翔,16,0,16,合庫-台中,2023-02-01,1021
8105,凌巨,15,0,15,合庫-台中,2023-02-01,1021
2539,櫻花建,15,0,15,合庫-台中,2023-02-01,1021
1608,華榮,48,33,15,合庫-台中,2023-02-01,1021
2027,大成鋼,22,8,14,合庫-台中,2023-02-01,1021
5351,鈺創,16,2,14,合庫-台中,2023-02-01,1021
8086,宏捷科,13,0,13,合庫-台中,2023-02-01,1021
3693,營邦,22,9,13,合庫-台中,2023-02-01,1021
2498,宏達電,28,15,13,合庫-台中,2023-02-01,1021
2812,台中銀,15,2,13,合庫-台中,2023-02-01,1021
9949,琉園,15,2,13,合庫-台中,2023-02-01,1021
3224,三顧,13,0,13,合庫-台中,2023-02-01,1021
00665L,富邦�琤肭磪囓�2,925,1,924,合庫-台中,2023-02-02,1021
2812,台中銀,366,8,358,合庫-台中,2023-02-02,1021
00885,富邦越南,306,3,303,合庫-台中,2023-02-02,1021
00632R,元大台灣50反1,246,3,243,合庫-台中,2023-02-02,1021
00715L,期街口布蘭特正2,213,0,213,合庫-台中,2023-02-02,1021
2867,三商壽,201,4,197,合庫-台中,2023-02-02,1021
2388,威盛,200,47,153,合庫-台中,2023-02-02,1021
00878,國泰永續高股息,175,23,152,合庫-台中,2023-02-02,1021
2014,中鴻,108,5,103,合庫-台中,2023-02-02,1021
2618,長榮航,121,31,90,合庫-台中,2023-02-02,1021
6733,博晟生醫,82,0,82,合庫-台中,2023-02-02,1021
2317,鴻海,94,28,66,合庫-台中,2023-02-02,1021
2884,玉山金,62,1,61,合庫-台中,2023-02-02,1021
00637L,元大滬深300正2,84,37,47,合庫-台中,2023-02-02,1021
2891,中信金,51,12,39,合庫-台中,2023-02-02,1021
2888,新光金,39,1,38,合庫-台中,2023-02-02,1021
6770,力積電,53,16,37,合庫-台中,2023-02-02,1021
3149,正達,34,0,34,合庫-台中,2023-02-02,1021
3694,海華,30,0,30,合庫-台中,2023-02-02,1021
2603,長榮,53,25,28,合庫-台中,2023-02-02,1021
2609,陽明,63,35,28,合庫-台中,2023-02-02,1021
8358,金居,28,3,25,合庫-台中,2023-02-02,1021
6129,普誠,40,15,25,合庫-台中,2023-02-02,1021
2201,裕隆,54,29,25,合庫-台中,2023-02-02,1021
2449,京元電子,46,22,24,合庫-台中,2023-02-02,1021
1519,華城,33,12,21,合庫-台中,2023-02-02,1021
5283,禾聯碩,20,0,20,合庫-台中,2023-02-02,1021
00680L,元大美債20正2,20,0,20,合庫-台中,2023-02-02,1021
1718,中纖,20,0,20,合庫-台中,2023-02-02,1021
5258,虹堡,34,16,18,合庫-台中,2023-02-02,1021
2880,華南金,18,0,18,合庫-台中,2023-02-02,1021
00631L,元大台灣50正2,318,300,18,合庫-台中,2023-02-02,1021
1734,杏輝,21,3,18,合庫-台中,2023-02-02,1021
4746,台耀,21,3,18,合庫-台中,2023-02-02,1021
00713,元大台灣高息低波,17,0,17,合庫-台中,2023-02-02,1021
2889,國票金,40,23,17,合庫-台中,2023-02-02,1021
00903,富邦元宇宙,22,5,17,合庫-台中,2023-02-02,1021
1513,中興電,76,60,16,合庫-台中,2023-02-02,1021
9945,潤泰新,16,0,16,合庫-台中,2023-02-02,1021
2364,倫飛,16,0,16,合庫-台中,2023-02-02,1021
1707,葡萄王,15,0,15,合庫-台中,2023-02-02,1021
00907,永豐優息存股,15,0,15,合庫-台中,2023-02-02,1021
3443,創意,28,13,15,合庫-台中,2023-02-02,1021
2314,台揚,15,1,14,合庫-台中,2023-02-02,1021
3019,亞光,16,2,14,合庫-台中,2023-02-02,1021
6226,光鼎,20,6,14,合庫-台中,2023-02-02,1021
5351,鈺創,58,44,14,合庫-台中,2023-02-02,1021
2892,第一金,16,3,13,合庫-台中,2023-02-02,1021
4513,福裕,13,0,13,合庫-台中,2023-02-02,1021
1605,華新,68,55,13,合庫-台中,2023-02-02,1021
00637L,元大滬深300正2,184,0,184,合庫-台中,2023-02-03,1021
2812,台中銀,171,9,162,合庫-台中,2023-02-03,1021
00715L,期街口布蘭特正2,124,0,124,合庫-台中,2023-02-03,1021
2609,陽明,185,83,102,合庫-台中,2023-02-03,1021
1513,中興電,131,31,100,合庫-台中,2023-02-03,1021
00878,國泰永續高股息,110,30,80,合庫-台中,2023-02-03,1021
6770,力積電,91,12,79,合庫-台中,2023-02-03,1021
00665L,富邦�琤肭磪囓�2,81,3,78,合庫-台中,2023-02-03,1021
2498,宏達電,340,266,74,合庫-台中,2023-02-03,1021
2891,中信金,72,0,72,合庫-台中,2023-02-03,1021
00882,中信中國高股息,67,0,67,合庫-台中,2023-02-03,1021
0056,元大高股息,73,8,65,合庫-台中,2023-02-03,1021
1718,中纖,63,3,60,合庫-台中,2023-02-03,1021
2888,新光金,56,5,51,合庫-台中,2023-02-03,1021
2634,漢翔,71,22,49,合庫-台中,2023-02-03,1021
2603,長榮,73,30,43,合庫-台中,2023-02-03,1021
00680L,元大美債20正2,40,0,40,合庫-台中,2023-02-03,1021
5258,虹堡,51,11,40,合庫-台中,2023-02-03,1021
2317,鴻海,50,10,40,合庫-台中,2023-02-03,1021
2409,友達,67,29,38,合庫-台中,2023-02-03,1021
2484,希華,48,10,38,合庫-台中,2023-02-03,1021
2449,京元電子,45,8,37,合庫-台中,2023-02-03,1021
3508,位速,39,4,35,合庫-台中,2023-02-03,1021
00909,國泰數位支付服務,36,2,34,合庫-台中,2023-02-03,1021
3523,迎輝,32,0,32,合庫-台中,2023-02-03,1021
00904,新光臺灣半導體30,30,0,30,合庫-台中,2023-02-03,1021
00905,FT臺灣Smart,28,0,28,合庫-台中,2023-02-03,1021
1319,東陽,28,0,28,合庫-台中,2023-02-03,1021
3494,誠研,27,0,27,合庫-台中,2023-02-03,1021
2618,長榮航,36,9,27,合庫-台中,2023-02-03,1021
1101,台泥,36,11,25,合庫-台中,2023-02-03,1021
2882,國泰金,35,11,24,合庫-台中,2023-02-03,1021
2610,華航,77,53,24,合庫-台中,2023-02-03,1021
1216,統一,22,0,22,合庫-台中,2023-02-03,1021
3481,群創,85,63,22,合庫-台中,2023-02-03,1021
6190,萬泰科,21,0,21,合庫-台中,2023-02-03,1021
6167,久正,20,0,20,合庫-台中,2023-02-03,1021
1605,華新,38,18,20,合庫-台中,2023-02-03,1021
5608,四維航,23,4,19,合庫-台中,2023-02-03,1021
2401,凌陽,19,1,18,合庫-台中,2023-02-03,1021
2028,威致,23,5,18,合庫-台中,2023-02-03,1021
2886,兆豐金,17,0,17,合庫-台中,2023-02-03,1021
2338,光罩,30,13,17,合庫-台中,2023-02-03,1021
00907,永豐優息存股,17,0,17,合庫-台中,2023-02-03,1021
1519,華城,16,0,16,合庫-台中,2023-02-03,1021
5321,美而快,30,14,16,合庫-台中,2023-02-03,1021
2615,萬海,22,7,15,合庫-台中,2023-02-03,1021
2884,玉山金,16,1,15,合庫-台中,2023-02-03,1021
5009,榮剛,17,2,15,合庫-台中,2023-02-03,1021
1342,八貫,26,12,14,合庫-台中,2023-02-03,1021
00665L,富邦�琤肭磪囓�2,658,3,655,合庫-台中,2023-02-06,1021
00878,國泰永續高股息,227,32,195,合庫-台中,2023-02-06,1021
2881,富邦金,118,9,109,合庫-台中,2023-02-06,1021
00682U,期元大美元指數,101,0,101,合庫-台中,2023-02-06,1021
00715L,期街口布蘭特正2,86,2,84,合庫-台中,2023-02-06,1021
2891,中信金,85,3,82,合庫-台中,2023-02-06,1021
00642U,期元大S＆P石油,74,0,74,合庫-台中,2023-02-06,1021
1605,華新,110,48,62,合庫-台中,2023-02-06,1021
2892,第一金,57,0,57,合庫-台中,2023-02-06,1021
2834,臺企銀,57,3,54,合庫-台中,2023-02-06,1021
4171,瑞基,51,0,51,合庫-台中,2023-02-06,1021
1718,中纖,50,1,49,合庫-台中,2023-02-06,1021
00882,中信中國高股息,54,11,43,合庫-台中,2023-02-06,1021
3162,精確,35,0,35,合庫-台中,2023-02-06,1021
3693,營邦,36,2,34,合庫-台中,2023-02-06,1021
2330,台積電,35,2,33,合庫-台中,2023-02-06,1021
2108,南帝,33,0,33,合庫-台中,2023-02-06,1021
1584,精剛,39,7,32,合庫-台中,2023-02-06,1021
2888,新光金,31,1,30,合庫-台中,2023-02-06,1021
2601,益航,30,0,30,合庫-台中,2023-02-06,1021
5880,合庫金,30,1,29,合庫-台中,2023-02-06,1021
9945,潤泰新,32,3,29,合庫-台中,2023-02-06,1021
2603,長榮,41,13,28,合庫-台中,2023-02-06,1021
00680L,元大美債20正2,28,0,28,合庫-台中,2023-02-06,1021
2323,中環,28,0,28,合庫-台中,2023-02-06,1021
00637L,元大滬深300正2,151,127,24,合庫-台中,2023-02-06,1021
2303,聯電,107,83,24,合庫-台中,2023-02-06,1021
2208,台船,33,10,23,合庫-台中,2023-02-06,1021
1101,台泥,27,5,22,合庫-台中,2023-02-06,1021
00751B,元大AAA至A公司債,21,0,21,合庫-台中,2023-02-06,1021
1336,台翰,21,0,21,合庫-台中,2023-02-06,1021
2328,廣宇,34,13,21,合庫-台中,2023-02-06,1021
2903,遠百,21,1,20,合庫-台中,2023-02-06,1021
1453,大將,32,12,20,合庫-台中,2023-02-06,1021
5227,立凱-KY,20,0,20,合庫-台中,2023-02-06,1021
2368,金像電,19,0,19,合庫-台中,2023-02-06,1021
00905,FT臺灣Smart,17,0,17,合庫-台中,2023-02-06,1021
4130,健亞,18,1,17,合庫-台中,2023-02-06,1021
00679B,元大美債20年,15,0,15,合庫-台中,2023-02-06,1021
2002,中鋼,26,11,15,合庫-台中,2023-02-06,1021
9958,世紀鋼,16,1,15,合庫-台中,2023-02-06,1021
6488,環球晶,15,0,15,合庫-台中,2023-02-06,1021
6133,金橋,14,0,14,合庫-台中,2023-02-06,1021
1513,中興電,17,5,12,合庫-台中,2023-02-06,1021
0056,元大高股息,22,11,11,合庫-台中,2023-02-06,1021
2379,瑞昱,11,0,11,合庫-台中,2023-02-06,1021
3141,晶宏,14,3,11,合庫-台中,2023-02-06,1021
4919,新唐,12,1,11,合庫-台中,2023-02-06,1021
2882,國泰金,13,2,11,合庫-台中,2023-02-06,1021
4157,太景*-KY,10,0,10,合庫-台中,2023-02-06,1021
00720B,元大投資級公司債,471,10,461,合庫-台中,2023-02-07,1021
00715L,期街口布蘭特正2,275,8,267,合庫-台中,2023-02-07,1021
00878,國泰永續高股息,181,1,180,合庫-台中,2023-02-07,1021
1605,華新,152,38,114,合庫-台中,2023-02-07,1021
00665L,富邦�琤肭磪囓�2,279,187,92,合庫-台中,2023-02-07,1021
2881,富邦金,71,3,68,合庫-台中,2023-02-07,1021
2317,鴻海,65,10,55,合庫-台中,2023-02-07,1021
2609,陽明,101,57,44,合庫-台中,2023-02-07,1021
00631L,元大台灣50正2,347,313,34,合庫-台中,2023-02-07,1021
6589,台康生技,91,58,33,合庫-台中,2023-02-07,1021
2498,宏達電,110,80,30,合庫-台中,2023-02-07,1021
2368,金像電,33,3,30,合庫-台中,2023-02-07,1021
2108,南帝,31,2,29,合庫-台中,2023-02-07,1021
2903,遠百,30,2,28,合庫-台中,2023-02-07,1021
2610,華航,37,10,27,合庫-台中,2023-02-07,1021
0056,元大高股息,27,1,26,合庫-台中,2023-02-07,1021
6116,彩晶,27,1,26,合庫-台中,2023-02-07,1021
2328,廣宇,25,0,25,合庫-台中,2023-02-07,1021
3046,建��,70,47,23,合庫-台中,2023-02-07,1021
2618,長榮航,26,3,23,合庫-台中,2023-02-07,1021
9945,潤泰新,21,0,21,合庫-台中,2023-02-07,1021
1512,瑞利,20,0,20,合庫-台中,2023-02-07,1021
2208,台船,20,0,20,合庫-台中,2023-02-07,1021
6509,聚和,20,1,19,合庫-台中,2023-02-07,1021
2884,玉山金,22,3,19,合庫-台中,2023-02-07,1021
2883,凱基金,38,20,18,合庫-台中,2023-02-07,1021
2891,中信金,18,0,18,合庫-台中,2023-02-07,1021
6770,力積電,16,0,16,合庫-台中,2023-02-07,1021
2014,中鴻,30,15,15,合庫-台中,2023-02-07,1021
4114,健喬,65,50,15,合庫-台中,2023-02-07,1021
2425,承啟,14,1,13,合庫-台中,2023-02-07,1021
1752,南光,77,64,13,合庫-台中,2023-02-07,1021
00680L,元大美債20正2,15,3,12,合庫-台中,2023-02-07,1021
4513,福裕,12,0,12,合庫-台中,2023-02-07,1021
9105,泰金寶-DR,12,0,12,合庫-台中,2023-02-07,1021
4162,智擎,26,15,11,合庫-台中,2023-02-07,1021
2388,威盛,16,5,11,合庫-台中,2023-02-07,1021
4171,瑞基,11,0,11,合庫-台中,2023-02-07,1021
2027,大成鋼,11,0,11,合庫-台中,2023-02-07,1021
3162,精確,33,22,11,合庫-台中,2023-02-07,1021
1795,美時,107,96,11,合庫-台中,2023-02-07,1021
2483,百容,10,0,10,合庫-台中,2023-02-07,1021
00713,元大台灣高息低波,11,1,10,合庫-台中,2023-02-07,1021
2017,官田鋼,30,20,10,合庫-台中,2023-02-07,1021
5009,榮剛,25,15,10,合庫-台中,2023-02-07,1021
1313,聯成,11,1,10,合庫-台中,2023-02-07,1021
3037,欣興,15,6,9,合庫-台中,2023-02-07,1021
3093,港建*,9,0,9,合庫-台中,2023-02-07,1021
2412,中華電,9,0,9,合庫-台中,2023-02-07,1021
3019,亞光,10,1,9,合庫-台中,2023-02-07,1021
2618,長榮航,215,26,189,合庫-台中,2023-02-08,1021
00715L,期街口布蘭特正2,300,128,172,合庫-台中,2023-02-08,1021
6182,合晶,114,3,111,合庫-台中,2023-02-08,1021
00637L,元大滬深300正2,115,6,109,合庫-台中,2023-02-08,1021
00885,富邦越南,79,0,79,合庫-台中,2023-02-08,1021
4128,中天,89,11,78,合庫-台中,2023-02-08,1021
6282,康舒,112,36,76,合庫-台中,2023-02-08,1021
00720B,元大投資級公司債,67,0,67,合庫-台中,2023-02-08,1021
00878,國泰永續高股息,75,12,63,合庫-台中,2023-02-08,1021
6443,元晶,69,6,63,合庫-台中,2023-02-08,1021
6150,撼訊,62,2,60,合庫-台中,2023-02-08,1021
2337,旺宏,63,6,57,合庫-台中,2023-02-08,1021
9105,泰金寶-DR,50,0,50,合庫-台中,2023-02-08,1021
00730,富邦臺灣優質高息,50,0,50,合庫-台中,2023-02-08,1021
3041,揚智,50,0,50,合庫-台中,2023-02-08,1021
00903,富邦元宇宙,50,2,48,合庫-台中,2023-02-08,1021
2537,聯上發,39,0,39,合庫-台中,2023-02-08,1021
6284,佳邦,37,0,37,合庫-台中,2023-02-08,1021
4541,晟田,33,0,33,合庫-台中,2023-02-08,1021
2482,連宇,43,11,32,合庫-台中,2023-02-08,1021
8069,元太,51,20,31,合庫-台中,2023-02-08,1021
9945,潤泰新,30,0,30,合庫-台中,2023-02-08,1021
00909,國泰數位支付服務,30,2,28,合庫-台中,2023-02-08,1021
2883,凱基金,27,0,27,合庫-台中,2023-02-08,1021
00679B,元大美債20年,26,0,26,合庫-台中,2023-02-08,1021
3022,威強電,31,6,25,合庫-台中,2023-02-08,1021
1609,大亞,28,4,24,合庫-台中,2023-02-08,1021
1783,和康生,22,0,22,合庫-台中,2023-02-08,1021
8426,紅木-KY,22,1,21,合庫-台中,2023-02-08,1021
1512,瑞利,20,0,20,合庫-台中,2023-02-08,1021
00733,富邦臺灣中小,20,0,20,合庫-台中,2023-02-08,1021
5460,同協,20,0,20,合庫-台中,2023-02-08,1021
1445,大宇,20,0,20,合庫-台中,2023-02-08,1021
4107,邦特,24,5,19,合庫-台中,2023-02-08,1021
2897,王道銀行,24,5,19,合庫-台中,2023-02-08,1021
5880,合庫金,19,0,19,合庫-台中,2023-02-08,1021
8358,金居,23,5,18,合庫-台中,2023-02-08,1021
3149,正達,20,2,18,合庫-台中,2023-02-08,1021
00905,FT臺灣Smart,19,1,18,合庫-台中,2023-02-08,1021
1513,中興電,50,33,17,合庫-台中,2023-02-08,1021
00893,國泰智能電動車,82,66,16,合庫-台中,2023-02-08,1021
2601,益航,16,0,16,合庫-台中,2023-02-08,1021
2358,廷鑫,23,7,16,合庫-台中,2023-02-08,1021
2317,鴻海,27,12,15,合庫-台中,2023-02-08,1021
2412,中華電,15,0,15,合庫-台中,2023-02-08,1021
4551,智伸科,15,0,15,合庫-台中,2023-02-08,1021
4958,臻鼎-KY,15,1,14,合庫-台中,2023-02-08,1021
3706,神達,23,9,14,合庫-台中,2023-02-08,1021
6104,創惟,13,0,13,合庫-台中,2023-02-08,1021
8016,矽創,13,0,13,合庫-台中,2023-02-08,1021
00878,國泰永續高股息,198,28,170,合庫-台中,2023-02-09,1021
00673R,期元大S＆P原油反1,97,0,97,合庫-台中,2023-02-09,1021
2344,華邦電,96,17,79,合庫-台中,2023-02-09,1021
2834,臺企銀,81,8,73,合庫-台中,2023-02-09,1021
2401,凌陽,77,6,71,合庫-台中,2023-02-09,1021
2498,宏達電,121,71,50,合庫-台中,2023-02-09,1021
8171,天宇,47,1,46,合庫-台中,2023-02-09,1021
00670L,富邦NASDAQ正2,42,0,42,合庫-台中,2023-02-09,1021
6235,華孚,145,103,42,合庫-台中,2023-02-09,1021
6589,台康生技,98,57,41,合庫-台中,2023-02-09,1021
2465,麗臺,42,2,40,合庫-台中,2023-02-09,1021
00720B,元大投資級公司債,40,0,40,合庫-台中,2023-02-09,1021
2601,益航,40,0,40,合庫-台中,2023-02-09,1021
1795,美時,84,51,33,合庫-台中,2023-02-09,1021
6186,新潤,31,0,31,合庫-台中,2023-02-09,1021
1432,大魯閣,31,0,31,合庫-台中,2023-02-09,1021
3624,光頡,44,14,30,合庫-台中,2023-02-09,1021
2801,彰銀,26,0,26,合庫-台中,2023-02-09,1021
00679B,元大美債20年,25,0,25,合庫-台中,2023-02-09,1021
3520,華盈,24,1,23,合庫-台中,2023-02-09,1021
2201,裕隆,27,6,21,合庫-台中,2023-02-09,1021
2886,兆豐金,22,1,21,合庫-台中,2023-02-09,1021
2884,玉山金,24,3,21,合庫-台中,2023-02-09,1021
2880,華南金,21,0,21,合庫-台中,2023-02-09,1021
00710B,復華彭博非投等債,20,0,20,合庫-台中,2023-02-09,1021
3523,迎輝,20,1,19,合庫-台中,2023-02-09,1021
1101,台泥,19,0,19,合庫-台中,2023-02-09,1021
6150,撼訊,22,3,19,合庫-台中,2023-02-09,1021
2891,中信金,18,0,18,合庫-台中,2023-02-09,1021
2883,凱基金,18,1,17,合庫-台中,2023-02-09,1021
2027,大成鋼,21,4,17,合庫-台中,2023-02-09,1021
3059,華晶科,29,12,17,合庫-台中,2023-02-09,1021
2408,南亞科,22,5,17,合庫-台中,2023-02-09,1021
1736,喬山,16,0,16,合庫-台中,2023-02-09,1021
00882,中信中國高股息,15,0,15,合庫-台中,2023-02-09,1021
4513,福裕,15,0,15,合庫-台中,2023-02-09,1021
2457,飛宏,31,16,15,合庫-台中,2023-02-09,1021
3675,德微,15,0,15,合庫-台中,2023-02-09,1021
4533,協易機,34,19,15,合庫-台中,2023-02-09,1021
4114,健喬,35,20,15,合庫-台中,2023-02-09,1021
00900,富邦特選高股息30,14,0,14,合庫-台中,2023-02-09,1021
2888,新光金,14,0,14,合庫-台中,2023-02-09,1021
1532,勤美,13,0,13,合庫-台中,2023-02-09,1021
2482,連宇,25,12,13,合庫-台中,2023-02-09,1021
2492,華新科,15,2,13,合庫-台中,2023-02-09,1021
3708,上緯投控,13,0,13,合庫-台中,2023-02-09,1021
3034,聯詠,16,4,12,合庫-台中,2023-02-09,1021
5880,合庫金,13,1,12,合庫-台中,2023-02-09,1021
00712,復華富時不動產,12,0,12,合庫-台中,2023-02-09,1021
6441,廣錠,15,3,12,合庫-台中,2023-02-09,1021
2610,華航,130,4,126,合庫-台中,2023-02-10,1021
2897,王道銀行,123,0,123,合庫-台中,2023-02-10,1021
2618,長榮航,173,57,116,合庫-台中,2023-02-10,1021
2409,友達,137,28,109,合庫-台中,2023-02-10,1021
1314,中石化,103,3,100,合庫-台中,2023-02-10,1021
2609,陽明,107,10,97,合庫-台中,2023-02-10,1021
2884,玉山金,84,7,77,合庫-台中,2023-02-10,1021
1605,華新,143,70,73,合庫-台中,2023-02-10,1021
2888,新光金,76,5,71,合庫-台中,2023-02-10,1021
2337,旺宏,73,2,71,合庫-台中,2023-02-10,1021
00878,國泰永續高股息,180,112,68,合庫-台中,2023-02-10,1021
00715L,期街口布蘭特正2,99,32,67,合庫-台中,2023-02-10,1021
4130,健亞,135,73,62,合庫-台中,2023-02-10,1021
1810,和成,87,29,58,合庫-台中,2023-02-10,1021
6282,康舒,106,49,57,合庫-台中,2023-02-10,1021
6150,撼訊,55,0,55,合庫-台中,2023-02-10,1021
6116,彩晶,54,1,53,合庫-台中,2023-02-10,1021
00720B,元大投資級公司債,56,4,52,合庫-台中,2023-02-10,1021
00900,富邦特選高股息30,46,0,46,合庫-台中,2023-02-10,1021
0056,元大高股息,55,12,43,合庫-台中,2023-02-10,1021
3046,建��,41,0,41,合庫-台中,2023-02-10,1021
2368,金像電,44,5,39,合庫-台中,2023-02-10,1021
6509,聚和,74,35,39,合庫-台中,2023-02-10,1021
3162,精確,64,25,39,合庫-台中,2023-02-10,1021
2891,中信金,52,15,37,合庫-台中,2023-02-10,1021
8171,天宇,40,3,37,合庫-台中,2023-02-10,1021
2344,華邦電,48,11,37,合庫-台中,2023-02-10,1021
4513,福裕,34,0,34,合庫-台中,2023-02-10,1021
1609,大亞,33,0,33,合庫-台中,2023-02-10,1021
1584,精剛,96,64,32,合庫-台中,2023-02-10,1021
4533,協易機,34,4,30,合庫-台中,2023-02-10,1021
6770,力積電,33,4,29,合庫-台中,2023-02-10,1021
00712,復華富時不動產,28,0,28,合庫-台中,2023-02-10,1021
4541,晟田,30,2,28,合庫-台中,2023-02-10,1021
2547,日勝生,27,0,27,合庫-台中,2023-02-10,1021
2413,環科,27,1,26,合庫-台中,2023-02-10,1021
1444,力麗,25,0,25,合庫-台中,2023-02-10,1021
1608,華榮,25,2,23,合庫-台中,2023-02-10,1021
4979,華星光,80,58,22,合庫-台中,2023-02-10,1021
3455,由田,22,0,22,合庫-台中,2023-02-10,1021
2481,強茂,23,1,22,合庫-台中,2023-02-10,1021
5014,建錩,24,2,22,合庫-台中,2023-02-10,1021
00713,元大台灣高息低波,23,1,22,合庫-台中,2023-02-10,1021
3581,博磊,22,0,22,合庫-台中,2023-02-10,1021
1519,華城,26,5,21,合庫-台中,2023-02-10,1021
2890,永豐金,20,0,20,合庫-台中,2023-02-10,1021
2367,燿華,20,0,20,合庫-台中,2023-02-10,1021
1503,士電,20,0,20,合庫-台中,2023-02-10,1021
2323,中環,20,0,20,合庫-台中,2023-02-10,1021
3035,智原,24,5,19,合庫-台中,2023-02-10,1021
00878,國泰永續高股息,446,131,315,合庫-台中,2023-02-13,1021
00673R,期元大S＆P原油反1,299,0,299,合庫-台中,2023-02-13,1021
2409,友達,272,8,264,合庫-台中,2023-02-13,1021
00665L,富邦�琤肭磪囓�2,173,4,169,合庫-台中,2023-02-13,1021
8033,雷虎,125,15,110,合庫-台中,2023-02-13,1021
3523,迎輝,54,0,54,合庫-台中,2023-02-13,1021
2889,國票金,53,0,53,合庫-台中,2023-02-13,1021
2303,聯電,126,73,53,合庫-台中,2023-02-13,1021
00671R,富邦NASDAQ反1,52,0,52,合庫-台中,2023-02-13,1021
2609,陽明,66,15,51,合庫-台中,2023-02-13,1021
2634,漢翔,92,46,46,合庫-台中,2023-02-13,1021
8358,金居,48,3,45,合庫-台中,2023-02-13,1021
2208,台船,50,9,41,合庫-台中,2023-02-13,1021
2610,華航,113,74,39,合庫-台中,2023-02-13,1021
2618,長榮航,53,15,38,合庫-台中,2023-02-13,1021
2888,新光金,47,12,35,合庫-台中,2023-02-13,1021
3289,宜特,40,5,35,合庫-台中,2023-02-13,1021
00885,富邦越南,46,11,35,合庫-台中,2023-02-13,1021
0050,元大台灣50,33,1,32,合庫-台中,2023-02-13,1021
2034,允強,47,16,31,合庫-台中,2023-02-13,1021
9945,潤泰新,30,1,29,合庫-台中,2023-02-13,1021
6806,森崴能源,42,14,28,合庫-台中,2023-02-13,1021
2201,裕隆,41,13,28,合庫-台中,2023-02-13,1021
0056,元大高股息,54,26,28,合庫-台中,2023-02-13,1021
8222,寶一,87,61,26,合庫-台中,2023-02-13,1021
00893,國泰智能電動車,34,12,22,合庫-台中,2023-02-13,1021
1519,華城,26,4,22,合庫-台中,2023-02-13,1021
1718,中纖,20,0,20,合庫-台中,2023-02-13,1021
00720B,元大投資級公司債,19,0,19,合庫-台中,2023-02-13,1021
1795,美時,87,68,19,合庫-台中,2023-02-13,1021
6116,彩晶,21,3,18,合庫-台中,2023-02-13,1021
3027,盛達,22,4,18,合庫-台中,2023-02-13,1021
3037,欣興,17,1,16,合庫-台中,2023-02-13,1021
5263,智崴,16,1,15,合庫-台中,2023-02-13,1021
5321,美而快,16,1,15,合庫-台中,2023-02-13,1021
2344,華邦電,26,12,14,合庫-台中,2023-02-13,1021
00712,復華富時不動產,14,0,14,合庫-台中,2023-02-13,1021
3044,健鼎,14,0,14,合庫-台中,2023-02-13,1021
00772B,中信高評級公司債,14,0,14,合庫-台中,2023-02-13,1021
00679B,元大美債20年,23,10,13,合庫-台中,2023-02-13,1021
00680L,元大美債20正2,13,0,13,合庫-台中,2023-02-13,1021
2882,國泰金,15,2,13,合庫-台中,2023-02-13,1021
00892,富邦台灣半導體,13,0,13,合庫-台中,2023-02-13,1021
1905,華紙,15,3,12,合庫-台中,2023-02-13,1021
1701,中化,20,9,11,合庫-台中,2023-02-13,1021
4720,德淵,11,0,11,合庫-台中,2023-02-13,1021
5243,乙盛-KY,11,0,11,合庫-台中,2023-02-13,1021
3162,精確,13,2,11,合庫-台中,2023-02-13,1021
4107,邦特,11,0,11,合庫-台中,2023-02-13,1021
2601,益航,21,10,11,合庫-台中,2023-02-13,1021
2412,中華電,499,0,499,合庫-台中,2023-02-14,1021
00673R,期元大S＆P原油反1,272,0,272,合庫-台中,2023-02-14,1021
6142,友勁,116,0,116,合庫-台中,2023-02-14,1021
2882,國泰金,105,23,82,合庫-台中,2023-02-14,1021
1513,中興電,66,13,53,合庫-台中,2023-02-14,1021
1447,力鵬,38,0,38,合庫-台中,2023-02-14,1021
00878,國泰永續高股息,115,80,35,合庫-台中,2023-02-14,1021
8222,寶一,147,115,32,合庫-台中,2023-02-14,1021
00679B,元大美債20年,34,2,32,合庫-台中,2023-02-14,1021
3523,迎輝,32,0,32,合庫-台中,2023-02-14,1021
2482,連宇,29,0,29,合庫-台中,2023-02-14,1021
5706,鳳凰,32,3,29,合庫-台中,2023-02-14,1021
2453,凌群,273,245,28,合庫-台中,2023-02-14,1021
2609,陽明,50,22,28,合庫-台中,2023-02-14,1021
00682U,期元大美元指數,25,0,25,合庫-台中,2023-02-14,1021
2885,元大金,22,0,22,合庫-台中,2023-02-14,1021
00882,中信中國高股息,20,0,20,合庫-台中,2023-02-14,1021
2349,錸德,20,0,20,合庫-台中,2023-02-14,1021
1795,美時,103,83,20,合庫-台中,2023-02-14,1021
2027,大成鋼,18,0,18,合庫-台中,2023-02-14,1021
1701,中化,24,7,17,合庫-台中,2023-02-14,1021
6874,倍力,16,0,16,合庫-台中,2023-02-14,1021
2344,華邦電,17,2,15,合庫-台中,2023-02-14,1021
5425,台半,26,11,15,合庫-台中,2023-02-14,1021
6180,橘子,16,2,14,合庫-台中,2023-02-14,1021
4919,新唐,17,3,14,合庫-台中,2023-02-14,1021
0056,元大高股息,17,4,13,合庫-台中,2023-02-14,1021
00780B,國泰A級金融債,13,0,13,合庫-台中,2023-02-14,1021
00720B,元大投資級公司債,13,0,13,合庫-台中,2023-02-14,1021
1612,宏泰,13,0,13,合庫-台中,2023-02-14,1021
4979,華星光,12,0,12,合庫-台中,2023-02-14,1021
4536,拓凱,18,6,12,合庫-台中,2023-02-14,1021
2812,台中銀,12,0,12,合庫-台中,2023-02-14,1021
2014,中鴻,12,1,11,合庫-台中,2023-02-14,1021
2615,萬海,24,13,11,合庫-台中,2023-02-14,1021
3479,安勤,32,21,11,合庫-台中,2023-02-14,1021
00633L,富邦上証正2,12,1,11,合庫-台中,2023-02-14,1021
00692,富邦公司治理,13,2,11,合庫-台中,2023-02-14,1021
00676R,富邦臺灣加權反1,10,0,10,合庫-台中,2023-02-14,1021
3704,合勤控,10,0,10,合庫-台中,2023-02-14,1021
5009,榮剛,22,12,10,合庫-台中,2023-02-14,1021
8081,致新,10,0,10,合庫-台中,2023-02-14,1021
2440,太空梭,10,0,10,合庫-台中,2023-02-14,1021
4968,立積,11,1,10,合庫-台中,2023-02-14,1021
4906,正文,10,0,10,合庫-台中,2023-02-14,1021
2601,益航,10,0,10,合庫-台中,2023-02-14,1021
2402,毅嘉,10,0,10,合庫-台中,2023-02-14,1021
5321,美而快,10,1,9,合庫-台中,2023-02-14,1021
2727,王品,10,1,9,合庫-台中,2023-02-14,1021
5309,系統電,12,4,8,合庫-台中,2023-02-14,1021
00673R,期元大S＆P原油反1,702,33,669,合庫-台中,2023-02-15,1021
00878,國泰永續高股息,489,41,448,合庫-台中,2023-02-15,1021
6235,華孚,173,56,117,合庫-台中,2023-02-15,1021
2891,中信金,75,0,75,合庫-台中,2023-02-15,1021
2618,長榮航,72,2,70,合庫-台中,2023-02-15,1021
2330,台積電,102,37,65,合庫-台中,2023-02-15,1021
2014,中鴻,54,2,52,合庫-台中,2023-02-15,1021
1314,中石化,51,1,50,合庫-台中,2023-02-15,1021
6282,康舒,76,28,48,合庫-台中,2023-02-15,1021
2486,一詮,44,2,42,合庫-台中,2023-02-15,1021
2880,華南金,42,0,42,合庫-台中,2023-02-15,1021
2609,陽明,58,18,40,合庫-台中,2023-02-15,1021
2457,飛宏,40,1,39,合庫-台中,2023-02-15,1021
0056,元大高股息,40,6,34,合庫-台中,2023-02-15,1021
00882,中信中國高股息,32,0,32,合庫-台中,2023-02-15,1021
2482,連宇,33,1,32,合庫-台中,2023-02-15,1021
2402,毅嘉,56,25,31,合庫-台中,2023-02-15,1021
2882,國泰金,33,3,30,合庫-台中,2023-02-15,1021
2481,強茂,31,1,30,合庫-台中,2023-02-15,1021
00715L,期街口布蘭特正2,31,1,30,合庫-台中,2023-02-15,1021
2206,三陽工業,50,21,29,合庫-台中,2023-02-15,1021
6116,彩晶,36,9,27,合庫-台中,2023-02-15,1021
5347,世界,36,11,25,合庫-台中,2023-02-15,1021
2634,漢翔,31,5,26,合庫-台中,2023-02-15,1021
1440,南紡,30,5,25,合庫-台中,2023-02-15,1021
3209,全科,24,0,24,合庫-台中,2023-02-15,1021
2885,元大金,24,0,24,合庫-台中,2023-02-15,1021
3189,景碩,27,4,23,合庫-台中,2023-02-15,1021
3523,迎輝,23,0,23,合庫-台中,2023-02-15,1021
1701,中化,23,2,21,合庫-台中,2023-02-15,1021
2337,旺宏,58,37,21,合庫-台中,2023-02-15,1021
2027,大成鋼,22,2,20,合庫-台中,2023-02-15,1021
2601,益航,20,0,20,合庫-台中,2023-02-15,1021
00683L,期元大美元指正2,20,0,20,合庫-台中,2023-02-15,1021
2736,富野,21,1,20,合庫-台中,2023-02-15,1021
5512,力麒,20,0,20,合庫-台中,2023-02-15,1021
1447,力鵬,20,0,20,合庫-台中,2023-02-15,1021
1611,中電,20,1,19,合庫-台中,2023-02-15,1021
2034,允強,19,0,19,合庫-台中,2023-02-15,1021
2208,台船,20,2,18,合庫-台中,2023-02-15,1021
00900,富邦特選高股息30,17,0,17,合庫-台中,2023-02-15,1021
1591,駿吉-KY,16,0,16,合庫-台中,2023-02-15,1021
4904,遠傳,16,0,16,合庫-台中,2023-02-15,1021
5880,合庫金,15,0,15,合庫-台中,2023-02-15,1021
1609,大亞,68,54,14,合庫-台中,2023-02-15,1021
2812,台中銀,14,0,14,合庫-台中,2023-02-15,1021
2615,萬海,17,3,14,合庫-台中,2023-02-15,1021
00637L,元大滬深300正2,14,0,14,合庫-台中,2023-02-15,1021
6278,台表科,14,1,13,合庫-台中,2023-02-15,1021
3710,連展投控,13,0,13,合庫-台中,2023-02-15,1021
00632R,元大台灣50反1,563,45,518,合庫-台中,2023-02-16,1021
00665L,富邦�琤肭磪囓�2,379,195,184,合庫-台中,2023-02-16,1021
00878,國泰永續高股息,188,18,170,合庫-台中,2023-02-16,1021
00673R,期元大S＆P原油反1,104,0,104,合庫-台中,2023-02-16,1021
00679B,元大美債20年,64,2,62,合庫-台中,2023-02-16,1021
2495,普安,60,1,59,合庫-台中,2023-02-16,1021
2312,金寶,63,10,53,合庫-台中,2023-02-16,1021
9105,泰金寶-DR,50,0,50,合庫-台中,2023-02-16,1021
3545,敦泰,54,12,42,合庫-台中,2023-02-16,1021
3141,晶宏,51,13,38,合庫-台中,2023-02-16,1021
5706,鳳凰,113,77,36,合庫-台中,2023-02-16,1021
00715L,期街口布蘭特正2,75,43,32,合庫-台中,2023-02-16,1021
6235,華孚,38,7,31,合庫-台中,2023-02-16,1021
2601,益航,27,0,27,合庫-台中,2023-02-16,1021
1609,大亞,41,15,26,合庫-台中,2023-02-16,1021
1591,駿吉-KY,24,0,24,合庫-台中,2023-02-16,1021
2313,華通,23,0,23,合庫-台中,2023-02-16,1021
9907,統一實,20,0,20,合庫-台中,2023-02-16,1021
1432,大魯閣,20,0,20,合庫-台中,2023-02-16,1021
1513,中興電,39,20,19,合庫-台中,2023-02-16,1021
6173,信昌電,20,2,18,合庫-台中,2023-02-16,1021
5426,振發,17,0,17,合庫-台中,2023-02-16,1021
2206,三陽工業,22,5,17,合庫-台中,2023-02-16,1021
8403,盛弘,20,4,16,合庫-台中,2023-02-16,1021
1108,幸福,20,4,16,合庫-台中,2023-02-16,1021
5905,南仁湖,18,2,16,合庫-台中,2023-02-16,1021
2882,國泰金,27,11,16,合庫-台中,2023-02-16,1021
00772B,中信高評級公司債,16,1,15,合庫-台中,2023-02-16,1021
3209,全科,15,0,15,合庫-台中,2023-02-16,1021
1503,士電,26,11,15,合庫-台中,2023-02-16,1021
2486,一詮,15,0,15,合庫-台中,2023-02-16,1021
5880,合庫金,18,5,13,合庫-台中,2023-02-16,1021
2478,大毅,12,0,12,合庫-台中,2023-02-16,1021
00780B,國泰A級金融債,12,0,12,合庫-台中,2023-02-16,1021
3576,聯合再生,22,11,11,合庫-台中,2023-02-16,1021
4130,健亞,11,0,11,合庫-台中,2023-02-16,1021
2892,第一金,11,0,11,合庫-台中,2023-02-16,1021
8222,寶一,52,41,11,合庫-台中,2023-02-16,1021
2515,中工,11,0,11,合庫-台中,2023-02-16,1021
6215,和椿,13,2,11,合庫-台中,2023-02-16,1021
8046,南電,17,6,11,合庫-台中,2023-02-16,1021
1558,伸興,10,0,10,合庫-台中,2023-02-16,1021
6206,飛捷,10,0,10,合庫-台中,2023-02-16,1021
00753L,中信中國50正2,11,1,10,合庫-台中,2023-02-16,1021
1219,福壽,10,0,10,合庫-台中,2023-02-16,1021
6237,驊訊,10,0,10,合庫-台中,2023-02-16,1021
9902,台火,10,0,10,合庫-台中,2023-02-16,1021
6488,環球晶,10,0,10,合庫-台中,2023-02-16,1021
2537,聯上發,10,0,10,合庫-台中,2023-02-16,1021
3037,欣興,32,23,9,合庫-台中,2023-02-16,1021
00715L,期街口布蘭特正2,377,3,374,合庫-台中,2023-02-17,1021
00673R,期元大S＆P原油反1,507,326,181,合庫-台中,2023-02-17,1021
00637L,元大滬深300正2,142,11,131,合庫-台中,2023-02-17,1021
00878,國泰永續高股息,159,51,108,合庫-台中,2023-02-17,1021
00893,國泰智能電動車,107,3,104,合庫-台中,2023-02-17,1021
2880,華南金,100,0,100,合庫-台中,2023-02-17,1021
2610,華航,152,76,76,合庫-台中,2023-02-17,1021
6116,彩晶,170,94,76,合庫-台中,2023-02-17,1021
2882,國泰金,113,50,63,合庫-台中,2023-02-17,1021
00679B,元大美債20年,58,0,58,合庫-台中,2023-02-17,1021
2618,長榮航,139,82,57,合庫-台中,2023-02-17,1021
2812,台中銀,53,0,53,合庫-台中,2023-02-17,1021
8050,廣積,57,6,51,合庫-台中,2023-02-17,1021
2736,富野,51,2,49,合庫-台中,2023-02-17,1021
1605,華新,94,46,48,合庫-台中,2023-02-17,1021
2886,兆豐金,52,5,47,合庫-台中,2023-02-17,1021
00665L,富邦�琤肭磪囓�2,46,0,46,合庫-台中,2023-02-17,1021
8038,長園科,46,1,45,合庫-台中,2023-02-17,1021
3545,敦泰,59,14,45,合庫-台中,2023-02-17,1021
00900,富邦特選高股息30,44,0,44,合庫-台中,2023-02-17,1021
4113,聯上,43,0,43,合庫-台中,2023-02-17,1021
4961,天鈺,71,33,38,合庫-台中,2023-02-17,1021
2484,希華,39,6,33,合庫-台中,2023-02-17,1021
5425,台半,84,52,32,合庫-台中,2023-02-17,1021
00772B,中信高評級公司債,33,2,31,合庫-台中,2023-02-17,1021
00751B,元大AAA至A公司債,31,0,31,合庫-台中,2023-02-17,1021
4919,新唐,42,14,28,合庫-台中,2023-02-17,1021
2482,連宇,58,30,28,合庫-台中,2023-02-17,1021
00680L,元大美債20正2,28,0,28,合庫-台中,2023-02-17,1021
8069,元太,32,6,26,合庫-台中,2023-02-17,1021
3058,立德,26,1,25,合庫-台中,2023-02-17,1021
1609,大亞,25,0,25,合庫-台中,2023-02-17,1021
00720B,元大投資級公司債,25,0,25,合庫-台中,2023-02-17,1021
2702,華園,26,4,22,合庫-台中,2023-02-17,1021
3209,全科,19,0,19,合庫-台中,2023-02-17,1021
2705,六福,32,14,18,合庫-台中,2023-02-17,1021
2890,永豐金,20,2,18,合庫-台中,2023-02-17,1021
00882,中信中國高股息,17,0,17,合庫-台中,2023-02-17,1021
2609,陽明,33,17,16,合庫-台中,2023-02-17,1021
1402,遠東新,16,0,16,合庫-台中,2023-02-17,1021
00713,元大台灣高息低波,17,2,15,合庫-台中,2023-02-17,1021
2511,太子,14,0,14,合庫-台中,2023-02-17,1021
2368,金像電,33,20,13,合庫-台中,2023-02-17,1021
3576,聯合再生,14,1,13,合庫-台中,2023-02-17,1021
0050,元大台灣50,18,5,13,合庫-台中,2023-02-17,1021
3289,宜特,15,3,12,合庫-台中,2023-02-17,1021
9904,寶成,12,0,12,合庫-台中,2023-02-17,1021
3006,晶豪科,25,13,12,合庫-台中,2023-02-17,1021
2344,華邦電,18,6,12,合庫-台中,2023-02-17,1021
00903,富邦元宇宙,11,0,11,合庫-台中,2023-02-17,1021
3049,精金,212,4,208,合庫-台中,2023-02-20,1021
00715L,期街口布蘭特正2,127,0,127,合庫-台中,2023-02-20,1021
00637L,元大滬深300正2,112,4,108,合庫-台中,2023-02-20,1021
2618,長榮航,159,97,62,合庫-台中,2023-02-20,1021
1218,泰山,61,0,61,合庫-台中,2023-02-20,1021
00903,富邦元宇宙,60,0,60,合庫-台中,2023-02-20,1021
1503,士電,59,7,52,合庫-台中,2023-02-20,1021
6245,立端,60,10,50,合庫-台中,2023-02-20,1021
1416,廣豐,50,0,50,合庫-台中,2023-02-20,1021
00670L,富邦NASDAQ正2,44,0,44,合庫-台中,2023-02-20,1021
3523,迎輝,41,0,41,合庫-台中,2023-02-20,1021
2313,華通,41,2,39,合庫-台中,2023-02-20,1021
1609,大亞,95,57,38,合庫-台中,2023-02-20,1021
8358,金居,110,76,34,合庫-台中,2023-02-20,1021
2425,承啟,34,0,34,合庫-台中,2023-02-20,1021
2375,凱美,41,7,34,合庫-台中,2023-02-20,1021
6282,康舒,107,73,34,合庫-台中,2023-02-20,1021
2317,鴻海,52,20,32,合庫-台中,2023-02-20,1021
3576,聯合再生,31,0,31,合庫-台中,2023-02-20,1021
2880,華南金,32,2,30,合庫-台中,2023-02-20,1021
4533,協易機,30,0,30,合庫-台中,2023-02-20,1021
6142,友勁,30,0,30,合庫-台中,2023-02-20,1021
2208,台船,42,14,28,合庫-台中,2023-02-20,1021
3062,建漢,25,1,24,合庫-台中,2023-02-20,1021
2739,寒舍,24,0,24,合庫-台中,2023-02-20,1021
1795,美時,82,61,21,合庫-台中,2023-02-20,1021
00679B,元大美債20年,27,5,22,合庫-台中,2023-02-20,1021
1712,興農,20,0,20,合庫-台中,2023-02-20,1021
8421,旭源,20,0,20,合庫-台中,2023-02-20,1021
00772B,中信高評級公司債,20,2,18,合庫-台中,2023-02-20,1021
6603,富強鑫,17,0,17,合庫-台中,2023-02-20,1021
4113,聯上,17,0,17,合庫-台中,2023-02-20,1021
2516,新建,17,0,17,合庫-台中,2023-02-20,1021
3022,威強電,20,3,17,合庫-台中,2023-02-20,1021
2489,瑞軒,20,3,17,合庫-台中,2023-02-20,1021
00902,中信電池及儲能,16,0,16,合庫-台中,2023-02-20,1021
1605,華新,64,48,16,合庫-台中,2023-02-20,1021
2453,凌群,18,2,16,合庫-台中,2023-02-20,1021
6456,GIS-KY,15,0,15,合庫-台中,2023-02-20,1021
00720B,元大投資級公司債,15,0,15,合庫-台中,2023-02-20,1021
8289,泰藝,15,0,15,合庫-台中,2023-02-20,1021
00885,富邦越南,15,0,15,合庫-台中,2023-02-20,1021
3044,健鼎,14,0,14,合庫-台中,2023-02-20,1021
2482,連宇,30,16,14,合庫-台中,2023-02-20,1021
3209,全科,14,0,14,合庫-台中,2023-02-20,1021
5464,霖宏,15,2,13,合庫-台中,2023-02-20,1021
8215,明基材,22,9,13,合庫-台中,2023-02-20,1021
6104,創惟,31,19,12,合庫-台中,2023-02-20,1021
6244,茂迪,13,1,12,合庫-台中,2023-02-20,1021
6118,建達,15,3,12,合庫-台中,2023-02-20,1021
2884,玉山金,324,92,232,合庫-台中,2023-02-21,1021
2014,中鴻,156,6,150,合庫-台中,2023-02-21,1021
2618,長榮航,201,68,133,合庫-台中,2023-02-21,1021
00683L,期元大美元指正2,90,0,90,合庫-台中,2023-02-21,1021
2610,華航,114,27,87,合庫-台中,2023-02-21,1021
00720B,元大投資級公司債,77,0,77,合庫-台中,2023-02-21,1021
00665L,富邦�琤肭磪囓�2,80,8,72,合庫-台中,2023-02-21,1021
2454,聯發科,74,3,71,合庫-台中,2023-02-21,1021
1810,和成,80,12,68,合庫-台中,2023-02-21,1021
00715L,期街口布蘭特正2,57,0,57,合庫-台中,2023-02-21,1021
1609,大亞,65,11,54,合庫-台中,2023-02-21,1021
4919,新唐,74,23,51,合庫-台中,2023-02-21,1021
3006,晶豪科,60,11,49,合庫-台中,2023-02-21,1021
8383,千附,49,1,48,合庫-台中,2023-02-21,1021
4114,健喬,57,19,38,合庫-台中,2023-02-21,1021
2337,旺宏,34,0,34,合庫-台中,2023-02-21,1021
8358,金居,35,3,32,合庫-台中,2023-02-21,1021
1417,嘉裕,30,0,30,合庫-台中,2023-02-21,1021
1519,華城,64,35,29,合庫-台中,2023-02-21,1021
6142,友勁,30,1,29,合庫-台中,2023-02-21,1021
1513,中興電,58,32,26,合庫-台中,2023-02-21,1021
2498,宏達電,144,118,26,合庫-台中,2023-02-21,1021
8421,旭源,25,0,25,合庫-台中,2023-02-21,1021
2349,錸德,24,0,24,合庫-台中,2023-02-21,1021
2812,台中銀,31,7,24,合庫-台中,2023-02-21,1021
2883,凱基金,38,14,24,合庫-台中,2023-02-21,1021
00725B,國泰投資級公司債,23,0,23,合庫-台中,2023-02-21,1021
6509,聚和,30,7,23,合庫-台中,2023-02-21,1021
6288,聯嘉,48,25,23,合庫-台中,2023-02-21,1021
8936,國統,41,19,22,合庫-台中,2023-02-21,1021
00712,復華富時不動產,21,0,21,合庫-台中,2023-02-21,1021
1308,亞聚,21,0,21,合庫-台中,2023-02-21,1021
8105,凌巨,21,1,20,合庫-台中,2023-02-21,1021
4533,協易機,20,0,20,合庫-台中,2023-02-21,1021
8927,北基,20,0,20,合庫-台中,2023-02-21,1021
6733,博晟生醫,21,2,19,合庫-台中,2023-02-21,1021
4111,濟生,19,0,19,合庫-台中,2023-02-21,1021
2367,燿華,19,0,19,合庫-台中,2023-02-21,1021
00679B,元大美債20年,18,0,18,合庫-台中,2023-02-21,1021
2888,新光金,18,0,18,合庫-台中,2023-02-21,1021
5880,合庫金,17,0,17,合庫-台中,2023-02-21,1021
1103,嘉泥,17,0,17,合庫-台中,2023-02-21,1021
6284,佳邦,21,4,17,合庫-台中,2023-02-21,1021
00772B,中信高評級公司債,17,0,17,合庫-台中,2023-02-21,1021
2371,大同,19,2,17,合庫-台中,2023-02-21,1021
1503,士電,20,4,16,合庫-台中,2023-02-21,1021
6165,浪凡,17,1,16,合庫-台中,2023-02-21,1021
2323,中環,21,6,15,合庫-台中,2023-02-21,1021
5371,中光電,20,6,14,合庫-台中,2023-02-21,1021
3675,德微,13,1,12,合庫-台中,2023-02-21,1021
00632R,元大台灣50反1,747,40,707,合庫-台中,2023-02-22,1021
2618,長榮航,213,8,205,合庫-台中,2023-02-22,1021
00637L,元大滬深300正2,105,10,95,合庫-台中,2023-02-22,1021
00679B,元大美債20年,120,30,90,合庫-台中,2023-02-22,1021
2884,玉山金,133,45,88,合庫-台中,2023-02-22,1021
2303,聯電,94,8,86,合庫-台中,2023-02-22,1021
00665L,富邦�琤肭磪囓�2,179,103,76,合庫-台中,2023-02-22,1021
6282,康舒,99,25,74,合庫-台中,2023-02-22,1021
2880,華南金,61,0,61,合庫-台中,2023-02-22,1021
2388,威盛,80,22,58,合庫-台中,2023-02-22,1021
00715L,期街口布蘭特正2,57,0,57,合庫-台中,2023-02-22,1021
5880,合庫金,81,28,53,合庫-台中,2023-02-22,1021
2462,良得電,53,0,53,合庫-台中,2023-02-22,1021
4979,華星光,56,6,50,合庫-台中,2023-02-22,1021
2337,旺宏,48,1,47,合庫-台中,2023-02-22,1021
00670L,富邦NASDAQ正2,43,0,43,合庫-台中,2023-02-22,1021
2834,臺企銀,148,106,42,合庫-台中,2023-02-22,1021
3035,智原,57,19,38,合庫-台中,2023-02-22,1021
3029,零壹,37,4,33,合庫-台中,2023-02-22,1021
6143,振曜,33,4,29,合庫-台中,2023-02-22,1021
8358,金居,35,7,28,合庫-台中,2023-02-22,1021
00878,國泰永續高股息,186,159,27,合庫-台中,2023-02-22,1021
2882,國泰金,33,7,26,合庫-台中,2023-02-22,1021
2498,宏達電,91,65,26,合庫-台中,2023-02-22,1021
2890,永豐金,26,0,26,合庫-台中,2023-02-22,1021
3438,類比科,26,0,26,合庫-台中,2023-02-22,1021
2201,裕隆,39,14,25,合庫-台中,2023-02-22,1021
2881,富邦金,26,1,25,合庫-台中,2023-02-22,1021
6142,友勁,25,1,24,合庫-台中,2023-02-22,1021
2736,富野,30,6,24,合庫-台中,2023-02-22,1021
2027,大成鋼,24,0,24,合庫-台中,2023-02-22,1021
3523,迎輝,24,0,24,合庫-台中,2023-02-22,1021
2330,台積電,43,20,23,合庫-台中,2023-02-22,1021
3545,敦泰,28,6,22,合庫-台中,2023-02-22,1021
6770,力積電,24,2,22,合庫-台中,2023-02-22,1021
1432,大魯閣,23,1,22,合庫-台中,2023-02-22,1021
5227,立凱-KY,22,0,22,合庫-台中,2023-02-22,1021
2344,華邦電,40,19,21,合庫-台中,2023-02-22,1021
2482,連宇,20,0,20,合庫-台中,2023-02-22,1021
2801,彰銀,20,0,20,合庫-台中,2023-02-22,1021
00903,富邦元宇宙,20,0,20,合庫-台中,2023-02-22,1021
00891,中信關鍵半導體,20,1,19,合庫-台中,2023-02-22,1021
1795,美時,65,47,18,合庫-台中,2023-02-22,1021
3362,先進光,17,0,17,合庫-台中,2023-02-22,1021
0056,元大高股息,18,3,15,合庫-台中,2023-02-22,1021
6531,愛普*,18,3,15,合庫-台中,2023-02-22,1021
1732,毛寶,15,0,15,合庫-台中,2023-02-22,1021
2338,光罩,24,10,14,合庫-台中,2023-02-22,1021
2515,中工,15,1,14,合庫-台中,2023-02-22,1021
00683L,期元大美元指正2,14,0,14,合庫-台中,2023-02-22,1021
2409,友達,330,44,286,合庫-台中,2023-02-23,1021
00753L,中信中國50正2,120,0,120,合庫-台中,2023-02-23,1021
00715L,期街口布蘭特正2,113,0,113,合庫-台中,2023-02-23,1021
2834,臺企銀,219,122,97,合庫-台中,2023-02-23,1021
2641,正德,83,1,82,合庫-台中,2023-02-23,1021
2888,新光金,74,6,68,合庫-台中,2023-02-23,1021
2002,中鋼,60,3,57,合庫-台中,2023-02-23,1021
2882,國泰金,66,11,55,合庫-台中,2023-02-23,1021
00637L,元大滬深300正2,81,30,51,合庫-台中,2023-02-23,1021
3481,群創,290,240,50,合庫-台中,2023-02-23,1021
00885,富邦越南,46,0,46,合庫-台中,2023-02-23,1021
2605,新興,65,21,44,合庫-台中,2023-02-23,1021
5704,老爺知,48,6,42,合庫-台中,2023-02-23,1021
6282,康舒,64,23,41,合庫-台中,2023-02-23,1021
2337,旺宏,41,1,40,合庫-台中,2023-02-23,1021
00712,復華富時不動產,49,10,39,合庫-台中,2023-02-23,1021
2399,映泰,68,32,36,合庫-台中,2023-02-23,1021
1810,和成,32,1,31,合庫-台中,2023-02-23,1021
2066,世德,31,1,30,合庫-台中,2023-02-23,1021
3594,磐儀,35,6,29,合庫-台中,2023-02-23,1021
00642U,期元大S＆P石油,28,0,28,合庫-台中,2023-02-23,1021
2344,華邦電,38,11,27,合庫-台中,2023-02-23,1021
1514,亞力,73,46,27,合庫-台中,2023-02-23,1021
00679B,元大美債20年,26,0,26,合庫-台中,2023-02-23,1021
00751B,元大AAA至A公司債,25,0,25,合庫-台中,2023-02-23,1021
5701,劍湖山,24,0,24,合庫-台中,2023-02-23,1021
5703,亞都,23,0,23,合庫-台中,2023-02-23,1021
3707,漢磊,23,0,23,合庫-台中,2023-02-23,1021
2705,六福,30,7,23,合庫-台中,2023-02-23,1021
3037,欣興,27,5,22,合庫-台中,2023-02-23,1021
3209,全科,36,15,21,合庫-台中,2023-02-23,1021
8049,晶采,21,0,21,合庫-台中,2023-02-23,1021
2884,玉山金,62,41,21,合庫-台中,2023-02-23,1021
4743,合一,29,9,20,合庫-台中,2023-02-23,1021
5225,東科-KY,20,0,20,合庫-台中,2023-02-23,1021
3027,盛達,27,7,20,合庫-台中,2023-02-23,1021
00902,中信電池及儲能,17,0,17,合庫-台中,2023-02-23,1021
8936,國統,88,72,16,合庫-台中,2023-02-23,1021
1519,華城,25,9,16,合庫-台中,2023-02-23,1021
3576,聯合再生,17,1,16,合庫-台中,2023-02-23,1021
3523,迎輝,16,0,16,合庫-台中,2023-02-23,1021
4904,遠傳,16,0,16,合庫-台中,2023-02-23,1021
6116,彩晶,15,0,15,合庫-台中,2023-02-23,1021
1522,堤維西,15,0,15,合庫-台中,2023-02-23,1021
8171,天宇,16,1,15,合庫-台中,2023-02-23,1021
1618,合機,20,5,15,合庫-台中,2023-02-23,1021
4113,聯上,15,0,15,合庫-台中,2023-02-23,1021
2313,華通,21,7,14,合庫-台中,2023-02-23,1021
2312,金寶,14,0,14,合庫-台中,2023-02-23,1021
6443,元晶,27,13,14,合庫-台中,2023-02-23,1021
3481,群創,905,225,680,合庫-台中,2023-02-24,1021
00878,國泰永續高股息,193,3,190,合庫-台中,2023-02-24,1021
5608,四維航,260,99,161,合庫-台中,2023-02-24,1021
1314,中石化,160,10,150,合庫-台中,2023-02-24,1021
00715L,期街口布蘭特正2,474,338,136,合庫-台中,2023-02-24,1021
00665L,富邦�琤肭磪囓�2,135,6,129,合庫-台中,2023-02-24,1021
2618,長榮航,222,96,126,合庫-台中,2023-02-24,1021
2834,臺企銀,116,3,113,合庫-台中,2023-02-24,1021
2498,宏達電,139,37,102,合庫-台中,2023-02-24,1021
6282,康舒,109,25,84,合庫-台中,2023-02-24,1021
5512,力麒,120,41,79,合庫-台中,2023-02-24,1021
2736,富野,96,18,78,合庫-台中,2023-02-24,1021
2337,旺宏,64,1,63,合庫-台中,2023-02-24,1021
3037,欣興,71,19,52,合庫-台中,2023-02-24,1021
2002,中鋼,51,1,50,合庫-台中,2023-02-24,1021
6231,系微,47,0,47,合庫-台中,2023-02-24,1021
00637L,元大滬深300正2,58,20,38,合庫-台中,2023-02-24,1021
2887,台新金,37,1,36,合庫-台中,2023-02-24,1021
8033,雷虎,71,35,36,合庫-台中,2023-02-24,1021
0056,元大高股息,42,9,33,合庫-台中,2023-02-24,1021
2317,鴻海,46,14,32,合庫-台中,2023-02-24,1021
5905,南仁湖,32,0,32,合庫-台中,2023-02-24,1021
2886,兆豐金,31,0,31,合庫-台中,2023-02-24,1021
2885,元大金,31,2,29,合庫-台中,2023-02-24,1021
4763,材料-KY,35,7,28,合庫-台中,2023-02-24,1021
8054,安國,29,1,28,合庫-台中,2023-02-24,1021
6770,力積電,35,8,27,合庫-台中,2023-02-24,1021
9907,統一實,26,0,26,合庫-台中,2023-02-24,1021
2062,橋椿,25,0,25,合庫-台中,2023-02-24,1021
8069,元太,36,12,24,合庫-台中,2023-02-24,1021
3162,精確,25,1,24,合庫-台中,2023-02-24,1021
2634,漢翔,35,12,23,合庫-台中,2023-02-24,1021
2641,正德,112,90,22,合庫-台中,2023-02-24,1021
2453,凌群,26,5,21,合庫-台中,2023-02-24,1021
00882,中信中國高股息,21,0,21,合庫-台中,2023-02-24,1021
1605,華新,28,8,20,合庫-台中,2023-02-24,1021
1444,力麗,20,0,20,合庫-台中,2023-02-24,1021
2444,兆勁,20,1,19,合庫-台中,2023-02-24,1021
0050,元大台灣50,19,1,18,合庫-台中,2023-02-24,1021
3576,聯合再生,24,6,18,合庫-台中,2023-02-24,1021
2702,華園,20,2,18,合庫-台中,2023-02-24,1021
6531,愛普*,22,6,16,合庫-台中,2023-02-24,1021
6116,彩晶,40,24,16,合庫-台中,2023-02-24,1021
6288,聯嘉,23,7,16,合庫-台中,2023-02-24,1021
5321,美而快,16,0,16,合庫-台中,2023-02-24,1021
1514,亞力,25,10,15,合庫-台中,2023-02-24,1021
4157,太景*-KY,15,0,15,合庫-台中,2023-02-24,1021
2515,中工,15,0,15,合庫-台中,2023-02-24,1021
1504,東元,15,0,15,合庫-台中,2023-02-24,1021
2610,華航,39,24,15,合庫-台中,2023-02-24,1021
00665L,富邦�琤肭磪囓�2,1176,43,1133,合庫-台中,2023-03-01,1021
00878,國泰永續高股息,231,1,230,合庫-台中,2023-03-01,1021
2014,中鴻,163,6,157,合庫-台中,2023-03-01,1021
1605,華新,149,39,110,合庫-台中,2023-03-01,1021
5880,合庫金,105,0,105,合庫-台中,2023-03-01,1021
2609,陽明,106,2,104,合庫-台中,2023-03-01,1021
2888,新光金,107,7,100,合庫-台中,2023-03-01,1021
00632R,元大台灣50反1,330,239,91,合庫-台中,2023-03-01,1021
2885,元大金,84,5,79,合庫-台中,2023-03-01,1021
2002,中鋼,85,7,78,合庫-台中,2023-03-01,1021
00720B,元大投資級公司債,78,5,73,合庫-台中,2023-03-01,1021
2409,友達,174,104,70,合庫-台中,2023-03-01,1021
2337,旺宏,59,1,58,合庫-台中,2023-03-01,1021
00885,富邦越南,59,3,56,合庫-台中,2023-03-01,1021
2884,玉山金,62,9,53,合庫-台中,2023-03-01,1021
2610,華航,57,11,46,合庫-台中,2023-03-01,1021
00772B,中信高評級公司債,47,1,46,合庫-台中,2023-03-01,1021
1718,中纖,50,4,46,合庫-台中,2023-03-01,1021
3523,迎輝,44,0,44,合庫-台中,2023-03-01,1021
2881,富邦金,42,0,42,合庫-台中,2023-03-01,1021
00670L,富邦NASDAQ正2,41,0,41,合庫-台中,2023-03-01,1021
00902,中信電池及儲能,40,0,40,合庫-台中,2023-03-01,1021
3481,群創,247,208,39,合庫-台中,2023-03-01,1021
2618,長榮航,43,6,37,合庫-台中,2023-03-01,1021
1609,大亞,38,1,37,合庫-台中,2023-03-01,1021
1101,台泥,55,19,36,合庫-台中,2023-03-01,1021
2882,國泰金,34,1,33,合庫-台中,2023-03-01,1021
2344,華邦電,34,5,29,合庫-台中,2023-03-01,1021
6770,力積電,29,0,29,合庫-台中,2023-03-01,1021
1584,精剛,72,43,29,合庫-台中,2023-03-01,1021
5512,力麒,41,13,28,合庫-台中,2023-03-01,1021
2634,漢翔,35,8,27,合庫-台中,2023-03-01,1021
8358,金居,25,0,25,合庫-台中,2023-03-01,1021
2471,資通,34,10,24,合庫-台中,2023-03-01,1021
3062,建漢,30,6,24,合庫-台中,2023-03-01,1021
3702,大聯大,23,0,23,合庫-台中,2023-03-01,1021
00680L,元大美債20正2,20,0,20,合庫-台中,2023-03-01,1021
2387,精元,30,10,20,合庫-台中,2023-03-01,1021
02001R,富邦蘋果反一N,20,0,20,合庫-台中,2023-03-01,1021
2323,中環,20,0,20,合庫-台中,2023-03-01,1021
1447,力鵬,20,0,20,合庫-台中,2023-03-01,1021
3706,神達,23,5,18,合庫-台中,2023-03-01,1021
6689,伊雲谷,19,1,18,合庫-台中,2023-03-01,1021
00893,國泰智能電動車,20,2,18,合庫-台中,2023-03-01,1021
00713,元大台灣高息低波,17,0,17,合庫-台中,2023-03-01,1021
1218,泰山,17,0,17,合庫-台中,2023-03-01,1021
2208,台船,16,0,16,合庫-台中,2023-03-01,1021
00773B,中信優先金融債,16,0,16,合庫-台中,2023-03-01,1021
5536,聖暉*,29,13,16,合庫-台中,2023-03-01,1021
3231,緯創,21,5,16,合庫-台中,2023-03-01,1021
00878,國泰永續高股息,208,9,199,合庫-台中,2023-03-02,1021
2641,正德,143,39,104,合庫-台中,2023-03-02,1021
1605,華新,223,120,103,合庫-台中,2023-03-02,1021
2409,友達,104,15,89,合庫-台中,2023-03-02,1021
2303,聯電,119,39,80,合庫-台中,2023-03-02,1021
2419,仲琦,124,44,80,合庫-台中,2023-03-02,1021
5210,寶碩,81,3,78,合庫-台中,2023-03-02,1021
2634,漢翔,74,5,69,合庫-台中,2023-03-02,1021
2359,所羅門,81,14,67,合庫-台中,2023-03-02,1021
5452,佶優,113,55,58,合庫-台中,2023-03-02,1021
2201,裕隆,79,22,57,合庫-台中,2023-03-02,1021
3481,群創,221,164,57,合庫-台中,2023-03-02,1021
2867,三商壽,54,0,54,合庫-台中,2023-03-02,1021
00720B,元大投資級公司債,54,1,53,合庫-台中,2023-03-02,1021
2889,國票金,52,0,52,合庫-台中,2023-03-02,1021
2596,綠意,50,0,50,合庫-台中,2023-03-02,1021
2498,宏達電,110,66,44,合庫-台中,2023-03-02,1021
8112,至上,69,26,43,合庫-台中,2023-03-02,1021
3207,耀勝,43,5,38,合庫-台中,2023-03-02,1021
3706,神達,38,5,33,合庫-台中,2023-03-02,1021
3523,迎輝,32,0,32,合庫-台中,2023-03-02,1021
2886,兆豐金,34,4,30,合庫-台中,2023-03-02,1021
2388,威盛,31,1,30,合庫-台中,2023-03-02,1021
6733,博晟生醫,31,2,29,合庫-台中,2023-03-02,1021
2023,燁輝,31,2,29,合庫-台中,2023-03-02,1021
2834,臺企銀,50,23,27,合庫-台中,2023-03-02,1021
2605,新興,58,31,27,合庫-台中,2023-03-02,1021
00772B,中信高評級公司債,26,0,26,合庫-台中,2023-03-02,1021
2888,新光金,26,0,26,合庫-台中,2023-03-02,1021
2891,中信金,31,5,26,合庫-台中,2023-03-02,1021
6116,彩晶,34,11,23,合庫-台中,2023-03-02,1021
00751B,元大AAA至A公司債,23,0,23,合庫-台中,2023-03-02,1021
2748,雲品,29,7,22,合庫-台中,2023-03-02,1021
6689,伊雲谷,24,2,22,合庫-台中,2023-03-02,1021
5880,合庫金,31,9,22,合庫-台中,2023-03-02,1021
2337,旺宏,20,0,20,合庫-台中,2023-03-02,1021
2884,玉山金,32,14,18,合庫-台中,2023-03-02,1021
00712,復華富時不動產,18,0,18,合庫-台中,2023-03-02,1021
2371,大同,17,0,17,合庫-台中,2023-03-02,1021
1503,士電,28,12,16,合庫-台中,2023-03-02,1021
2312,金寶,16,0,16,合庫-台中,2023-03-02,1021
00773B,中信優先金融債,16,0,16,合庫-台中,2023-03-02,1021
2611,志信,26,10,16,合庫-台中,2023-03-02,1021
2890,永豐金,20,5,15,合庫-台中,2023-03-02,1021
8289,泰藝,15,0,15,合庫-台中,2023-03-02,1021
2482,連宇,17,2,15,合庫-台中,2023-03-02,1021
9945,潤泰新,14,0,14,合庫-台中,2023-03-02,1021
2618,長榮航,23,9,14,合庫-台中,2023-03-02,1021
5258,虹堡,39,25,14,合庫-台中,2023-03-02,1021
6741,91APP*-KY,19,6,13,合庫-台中,2023-03-02,1021
00673R,期元大S＆P原油反1,853,0,853,合庫-台中,2023-03-03,1021
00665L,富邦�琤肭磪囓�2,728,36,692,合庫-台中,2023-03-03,1021
1514,亞力,127,6,121,合庫-台中,2023-03-03,1021
2596,綠意,117,0,117,合庫-台中,2023-03-03,1021
2454,聯發科,94,3,91,合庫-台中,2023-03-03,1021
1605,華新,95,29,66,合庫-台中,2023-03-03,1021
5512,力麒,57,1,56,合庫-台中,2023-03-03,1021
3236,千如,52,0,52,合庫-台中,2023-03-03,1021
6142,友勁,50,0,50,合庫-台中,2023-03-03,1021
2609,陽明,166,121,45,合庫-台中,2023-03-03,1021
1314,中石化,65,22,43,合庫-台中,2023-03-03,1021
1609,大亞,42,1,41,合庫-台中,2023-03-03,1021
2388,威盛,58,24,34,合庫-台中,2023-03-03,1021
2002,中鋼,36,2,34,合庫-台中,2023-03-03,1021
1795,美時,66,34,32,合庫-台中,2023-03-03,1021
2618,長榮航,53,22,31,合庫-台中,2023-03-03,1021
00773B,中信優先金融債,29,0,29,合庫-台中,2023-03-03,1021
2886,兆豐金,30,2,28,合庫-台中,2023-03-03,1021
00713,元大台灣高息低波,33,5,28,合庫-台中,2023-03-03,1021
6288,聯嘉,28,2,26,合庫-台中,2023-03-03,1021
00712,復華富時不動產,25,0,25,合庫-台中,2023-03-03,1021
00720B,元大投資級公司債,25,0,25,合庫-台中,2023-03-03,1021
3706,神達,23,0,23,合庫-台中,2023-03-03,1021
3523,迎輝,23,0,23,合庫-台中,2023-03-03,1021
2371,大同,22,0,22,合庫-台中,2023-03-03,1021
8936,國統,23,1,22,合庫-台中,2023-03-03,1021
2537,聯上發,22,0,22,合庫-台中,2023-03-03,1021
00679B,元大美債20年,23,2,21,合庫-台中,2023-03-03,1021
2617,台航,24,3,21,合庫-台中,2023-03-03,1021
3312,弘憶股,21,0,21,合庫-台中,2023-03-03,1021
1444,力麗,20,0,20,合庫-台中,2023-03-03,1021
5210,寶碩,40,20,20,合庫-台中,2023-03-03,1021
2642,宅配通,20,0,20,合庫-台中,2023-03-03,1021
1201,味全,67,48,19,合庫-台中,2023-03-03,1021
2457,飛宏,87,68,19,合庫-台中,2023-03-03,1021
3479,安勤,26,8,18,合庫-台中,2023-03-03,1021
9945,潤泰新,17,0,17,合庫-台中,2023-03-03,1021
2903,遠百,17,0,17,合庫-台中,2023-03-03,1021
00772B,中信高評級公司債,17,0,17,合庫-台中,2023-03-03,1021
00680L,元大美債20正2,16,0,16,合庫-台中,2023-03-03,1021
6506,雙邦,16,0,16,合庫-台中,2023-03-03,1021
2887,台新金,16,1,15,合庫-台中,2023-03-03,1021
2472,立隆電,15,0,15,合庫-台中,2023-03-03,1021
2328,廣宇,22,7,15,合庫-台中,2023-03-03,1021
8227,巨有科技,27,14,13,合庫-台中,2023-03-03,1021
3576,聯合再生,13,0,13,合庫-台中,2023-03-03,1021
6235,華孚,28,15,13,合庫-台中,2023-03-03,1021
5009,榮剛,22,10,12,合庫-台中,2023-03-03,1021
4960,誠美材,12,0,12,合庫-台中,2023-03-03,1021
3652,精聯,11,0,11,合庫-台中,2023-03-03,1021
00673R,期元大S＆P原油反1,577,0,577,合庫-台中,2023-03-06,1021
00665L,富邦�琤肭磪囓�2,445,59,386,合庫-台中,2023-03-06,1021
00632R,元大台灣50反1,183,10,173,合庫-台中,2023-03-06,1021
00637L,元大滬深300正2,136,5,131,合庫-台中,2023-03-06,1021
2634,漢翔,128,12,116,合庫-台中,2023-03-06,1021
5452,佶優,101,0,101,合庫-台中,2023-03-06,1021
2883,凱基金,109,21,88,合庫-台中,2023-03-06,1021
00712,復華富時不動產,82,5,77,合庫-台中,2023-03-06,1021
2344,華邦電,84,17,67,合庫-台中,2023-03-06,1021
2886,兆豐金,53,0,53,合庫-台中,2023-03-06,1021
2596,綠意,47,0,47,合庫-台中,2023-03-06,1021
3523,迎輝,46,0,46,合庫-台中,2023-03-06,1021
8215,明基材,50,10,40,合庫-台中,2023-03-06,1021
2601,益航,42,4,38,合庫-台中,2023-03-06,1021
5410,國眾,38,0,38,合庫-台中,2023-03-06,1021
00679B,元大美債20年,34,0,34,合庫-台中,2023-03-06,1021
1210,大成,42,8,34,合庫-台中,2023-03-06,1021
9945,潤泰新,33,1,32,合庫-台中,2023-03-06,1021
2313,華通,34,2,32,合庫-台中,2023-03-06,1021
2606,裕民,38,6,32,合庫-台中,2023-03-06,1021
6120,達運,30,0,30,合庫-台中,2023-03-06,1021
00720B,元大投資級公司債,28,0,28,合庫-台中,2023-03-06,1021
2457,飛宏,89,62,27,合庫-台中,2023-03-06,1021
3504,揚明光,40,13,27,合庫-台中,2023-03-06,1021
8358,金居,28,1,27,合庫-台中,2023-03-06,1021
2337,旺宏,26,0,26,合庫-台中,2023-03-06,1021
6113,亞矽,25,0,25,合庫-台中,2023-03-06,1021
8927,北基,45,20,25,合庫-台中,2023-03-06,1021
00669R,國泰美國道瓊反1,24,0,24,合庫-台中,2023-03-06,1021
5464,霖宏,25,1,24,合庫-台中,2023-03-06,1021
00885,富邦越南,23,0,23,合庫-台中,2023-03-06,1021
2014,中鴻,35,12,23,合庫-台中,2023-03-06,1021
1616,億泰,20,0,20,合庫-台中,2023-03-06,1021
5210,寶碩,27,7,20,合庫-台中,2023-03-06,1021
2453,凌群,19,0,19,合庫-台中,2023-03-06,1021
3013,晟銘電,25,6,19,合庫-台中,2023-03-06,1021
2891,中信金,22,3,19,合庫-台中,2023-03-06,1021
3321,同泰,40,21,19,合庫-台中,2023-03-06,1021
1314,中石化,20,3,17,合庫-台中,2023-03-06,1021
2884,玉山金,27,10,17,合庫-台中,2023-03-06,1021
2888,新光金,22,6,16,合庫-台中,2023-03-06,1021
3162,精確,17,1,16,合庫-台中,2023-03-06,1021
3576,聯合再生,15,0,15,合庫-台中,2023-03-06,1021
5388,中磊,15,0,15,合庫-台中,2023-03-06,1021
2729,瓦城,14,0,14,合庫-台中,2023-03-06,1021
2916,滿心,14,0,14,合庫-台中,2023-03-06,1021
00713,元大台灣高息低波,13,0,13,合庫-台中,2023-03-06,1021
2618,長榮航,23,10,13,合庫-台中,2023-03-06,1021
2332,友訊,14,1,13,合庫-台中,2023-03-06,1021
1708,東鹼,21,9,12,合庫-台中,2023-03-06,1021
00665L,富邦�琤肭磪囓�2,864,449,415,合庫-台中,2023-03-07,1021
00673R,期元大S＆P原油反1,481,199,282,合庫-台中,2023-03-07,1021
00632R,元大台灣50反1,161,25,136,合庫-台中,2023-03-07,1021
5512,力麒,130,14,116,合庫-台中,2023-03-07,1021
2596,綠意,96,0,96,合庫-台中,2023-03-07,1021
6116,彩晶,93,12,81,合庫-台中,2023-03-07,1021
2883,凱基金,69,1,68,合庫-台中,2023-03-07,1021
2344,華邦電,73,8,65,合庫-台中,2023-03-07,1021
3523,迎輝,63,0,63,合庫-台中,2023-03-07,1021
3481,群創,224,163,61,合庫-台中,2023-03-07,1021
9949,琉園,62,5,57,合庫-台中,2023-03-07,1021
2888,新光金,52,1,51,合庫-台中,2023-03-07,1021
00670L,富邦NASDAQ正2,51,0,51,合庫-台中,2023-03-07,1021
2601,益航,65,15,50,合庫-台中,2023-03-07,1021
2471,資通,58,9,49,合庫-台中,2023-03-07,1021
2371,大同,46,2,44,合庫-台中,2023-03-07,1021
2911,麗嬰房,44,0,44,合庫-台中,2023-03-07,1021
6235,華孚,65,23,42,合庫-台中,2023-03-07,1021
3702,大聯大,42,0,42,合庫-台中,2023-03-07,1021
3576,聯合再生,44,2,42,合庫-台中,2023-03-07,1021
6284,佳邦,38,0,38,合庫-台中,2023-03-07,1021
1519,華城,55,19,36,合庫-台中,2023-03-07,1021
1513,中興電,79,45,34,合庫-台中,2023-03-07,1021
2330,台積電,41,8,33,合庫-台中,2023-03-07,1021
00679B,元大美債20年,36,5,31,合庫-台中,2023-03-07,1021
00637L,元大滬深300正2,45,15,30,合庫-台中,2023-03-07,1021
1101,台泥,31,3,28,合庫-台中,2023-03-07,1021
4976,佳凌,32,6,26,合庫-台中,2023-03-07,1021
0056,元大高股息,32,7,25,合庫-台中,2023-03-07,1021
4746,台耀,22,0,22,合庫-台中,2023-03-07,1021
2405,輔信,25,4,21,合庫-台中,2023-03-07,1021
2498,宏達電,53,32,21,合庫-台中,2023-03-07,1021
5608,四維航,22,2,20,合庫-台中,2023-03-07,1021
4979,華星光,42,22,20,合庫-台中,2023-03-07,1021
2457,飛宏,85,66,19,合庫-台中,2023-03-07,1021
6548,長科*,25,6,19,合庫-台中,2023-03-07,1021
2707,晶華,26,8,18,合庫-台中,2023-03-07,1021
00772B,中信高評級公司債,19,2,17,合庫-台中,2023-03-07,1021
5258,虹堡,23,6,17,合庫-台中,2023-03-07,1021
2390,云辰,17,0,17,合庫-台中,2023-03-07,1021
00878,國泰永續高股息,65,49,16,合庫-台中,2023-03-07,1021
6806,森崴能源,25,9,16,合庫-台中,2023-03-07,1021
6456,GIS-KY,21,5,16,合庫-台中,2023-03-07,1021
2409,友達,36,21,15,合庫-台中,2023-03-07,1021
8033,雷虎,18,4,14,合庫-台中,2023-03-07,1021
00885,富邦越南,14,0,14,合庫-台中,2023-03-07,1021
2337,旺宏,29,15,14,合庫-台中,2023-03-07,1021
2884,玉山金,17,3,14,合庫-台中,2023-03-07,1021
3029,零壹,29,15,14,合庫-台中,2023-03-07,1021
3037,欣興,16,3,13,合庫-台中,2023-03-07,1021
00637L,元大滬深300正2,244,60,184,合庫-台中,2023-03-08,1021
00753L,中信中國50正2,152,1,151,合庫-台中,2023-03-08,1021
3481,群創,316,168,148,合庫-台中,2023-03-08,1021
00715L,期街口布蘭特正2,136,12,124,合庫-台中,2023-03-08,1021
3523,迎輝,123,0,123,合庫-台中,2023-03-08,1021
2812,台中銀,122,5,117,合庫-台中,2023-03-08,1021
2897,王道銀行,172,57,115,合庫-台中,2023-03-08,1021
1605,華新,130,28,102,合庫-台中,2023-03-08,1021
2884,玉山金,120,19,101,合庫-台中,2023-03-08,1021
00878,國泰永續高股息,137,37,100,合庫-台中,2023-03-08,1021
2886,兆豐金,75,12,63,合庫-台中,2023-03-08,1021
00923,群益台ESG低碳50,59,0,59,合庫-台中,2023-03-08,1021
1609,大亞,80,22,58,合庫-台中,2023-03-08,1021
5701,劍湖山,50,0,50,合庫-台中,2023-03-08,1021
1314,中石化,50,0,50,合庫-台中,2023-03-08,1021
2498,宏達電,80,35,45,合庫-台中,2023-03-08,1021
2605,新興,63,21,42,合庫-台中,2023-03-08,1021
3019,亞光,54,13,41,合庫-台中,2023-03-08,1021
5009,榮剛,110,69,41,合庫-台中,2023-03-08,1021
4526,東台,40,1,39,合庫-台中,2023-03-08,1021
00650L,復華香港正2,39,0,39,合庫-台中,2023-03-08,1021
2412,中華電,40,1,39,合庫-台中,2023-03-08,1021
1503,士電,46,11,35,合庫-台中,2023-03-08,1021
1101,台泥,35,0,35,合庫-台中,2023-03-08,1021
3706,神達,34,0,34,合庫-台中,2023-03-08,1021
6770,力積電,39,7,32,合庫-台中,2023-03-08,1021
2337,旺宏,38,8,30,合庫-台中,2023-03-08,1021
1584,精剛,47,19,28,合庫-台中,2023-03-08,1021
2371,大同,35,8,27,合庫-台中,2023-03-08,1021
2515,中工,26,0,26,合庫-台中,2023-03-08,1021
6282,康舒,113,87,26,合庫-台中,2023-03-08,1021
2606,裕民,29,4,25,合庫-台中,2023-03-08,1021
9933,中鼎,28,3,25,合庫-台中,2023-03-08,1021
6558,興能高,27,2,25,合庫-台中,2023-03-08,1021
8163,達方,66,43,23,合庫-台中,2023-03-08,1021
2444,兆勁,23,0,23,合庫-台中,2023-03-08,1021
2888,新光金,21,0,21,合庫-台中,2023-03-08,1021
1721,三晃,20,0,20,合庫-台中,2023-03-08,1021
2349,錸德,20,0,20,合庫-台中,2023-03-08,1021
2405,輔信,20,0,20,合庫-台中,2023-03-08,1021
8121,越峰,20,0,20,合庫-台中,2023-03-08,1021
1795,美時,69,50,19,合庫-台中,2023-03-08,1021
2330,台積電,21,2,19,合庫-台中,2023-03-08,1021
00633L,富邦上証正2,19,0,19,合庫-台中,2023-03-08,1021
8069,元太,23,5,18,合庫-台中,2023-03-08,1021
1515,力山,18,0,18,合庫-台中,2023-03-08,1021
1217,愛之味,21,3,18,合庫-台中,2023-03-08,1021
9945,潤泰新,17,0,17,合庫-台中,2023-03-08,1021
5425,台半,101,84,17,合庫-台中,2023-03-08,1021
00713,元大台灣高息低波,19,3,16,合庫-台中,2023-03-08,1021
2409,友達,352,37,315,合庫-台中,2023-03-09,1021
00885,富邦越南,271,10,261,合庫-台中,2023-03-09,1021
00878,國泰永續高股息,275,21,254,合庫-台中,2023-03-09,1021
3481,群創,564,320,244,合庫-台中,2023-03-09,1021
00637L,元大滬深300正2,176,25,151,合庫-台中,2023-03-09,1021
3356,奇偶,158,19,139,合庫-台中,2023-03-09,1021
3523,迎輝,121,0,121,合庫-台中,2023-03-09,1021
3272,東碩,105,1,104,合庫-台中,2023-03-09,1021
6202,盛群,100,1,99,合庫-台中,2023-03-09,1021
9105,泰金寶-DR,99,3,96,合庫-台中,2023-03-09,1021
00715L,期街口布蘭特正2,94,0,94,合庫-台中,2023-03-09,1021
2317,鴻海,119,40,79,合庫-台中,2023-03-09,1021
6129,普誠,115,38,77,合庫-台中,2023-03-09,1021
2408,南亞科,111,40,71,合庫-台中,2023-03-09,1021
6443,元晶,136,71,65,合庫-台中,2023-03-09,1021
4526,東台,64,0,64,合庫-台中,2023-03-09,1021
2359,所羅門,72,9,63,合庫-台中,2023-03-09,1021
4419,皇家美食,59,0,59,合庫-台中,2023-03-09,1021
2413,環科,102,44,58,合庫-台中,2023-03-09,1021
2891,中信金,67,10,57,合庫-台中,2023-03-09,1021
8222,寶一,234,179,55,合庫-台中,2023-03-09,1021
1515,力山,41,0,41,合庫-台中,2023-03-09,1021
5210,寶碩,40,0,40,合庫-台中,2023-03-09,1021
00923,群益台ESG低碳50,40,0,40,合庫-台中,2023-03-09,1021
2890,永豐金,37,0,37,合庫-台中,2023-03-09,1021
2888,新光金,37,0,37,合庫-台中,2023-03-09,1021
3576,聯合再生,128,92,36,合庫-台中,2023-03-09,1021
3594,磐儀,56,21,35,合庫-台中,2023-03-09,1021
2368,金像電,36,1,35,合庫-台中,2023-03-09,1021
2883,凱基金,34,0,34,合庫-台中,2023-03-09,1021
3290,東浦,45,11,34,合庫-台中,2023-03-09,1021
2337,旺宏,34,0,34,合庫-台中,2023-03-09,1021
1447,力鵬,31,0,31,合庫-台中,2023-03-09,1021
0056,元大高股息,36,5,31,合庫-台中,2023-03-09,1021
2886,兆豐金,31,0,31,合庫-台中,2023-03-09,1021
6215,和椿,30,0,30,合庫-台中,2023-03-09,1021
006205,富邦上証,30,0,30,合庫-台中,2023-03-09,1021
1608,華榮,30,0,30,合庫-台中,2023-03-09,1021
3046,建��,69,39,30,合庫-台中,2023-03-09,1021
6706,惠特,31,1,30,合庫-台中,2023-03-09,1021
4746,台耀,51,21,30,合庫-台中,2023-03-09,1021
8940,新天地,30,0,30,合庫-台中,2023-03-09,1021
6116,彩晶,32,4,28,合庫-台中,2023-03-09,1021
2486,一詮,37,9,28,合庫-台中,2023-03-09,1021
2537,聯上發,28,0,28,合庫-台中,2023-03-09,1021
1609,大亞,33,5,28,合庫-台中,2023-03-09,1021
6190,萬泰科,38,11,27,合庫-台中,2023-03-09,1021
1444,力麗,37,10,27,合庫-台中,2023-03-09,1021
3706,神達,26,0,26,合庫-台中,2023-03-09,1021
1402,遠東新,26,0,26,合庫-台中,2023-03-09,1021
00878,國泰永續高股息,379,80,299,合庫-台中,2023-03-10,1021
2609,陽明,413,206,207,合庫-台中,2023-03-10,1021
00715L,期街口布蘭特正2,216,19,197,合庫-台中,2023-03-10,1021
5608,四維航,166,9,157,合庫-台中,2023-03-10,1021
1314,中石化,150,1,149,合庫-台中,2023-03-10,1021
2618,長榮航,166,22,144,合庫-台中,2023-03-10,1021
2014,中鴻,141,12,129,合庫-台中,2023-03-10,1021
5880,合庫金,128,3,125,合庫-台中,2023-03-10,1021
00882,中信中國高股息,116,0,116,合庫-台中,2023-03-10,1021
00642U,期元大S＆P石油,113,0,113,合庫-台中,2023-03-10,1021
8069,元太,115,8,107,合庫-台中,2023-03-10,1021
4113,聯上,99,0,99,合庫-台中,2023-03-10,1021
2812,台中銀,103,10,93,合庫-台中,2023-03-10,1021
6142,友勁,90,0,90,合庫-台中,2023-03-10,1021
1432,大魯閣,87,2,85,合庫-台中,2023-03-10,1021
2888,新光金,83,8,75,合庫-台中,2023-03-10,1021
2344,華邦電,104,31,73,合庫-台中,2023-03-10,1021
2891,中信金,73,0,73,合庫-台中,2023-03-10,1021
2409,友達,135,63,72,合庫-台中,2023-03-10,1021
2883,凱基金,83,14,69,合庫-台中,2023-03-10,1021
00900,富邦特選高股息30,65,5,60,合庫-台中,2023-03-10,1021
2002,中鋼,60,0,60,合庫-台中,2023-03-10,1021
1605,華新,86,29,57,合庫-台中,2023-03-10,1021
5009,榮剛,97,42,55,合庫-台中,2023-03-10,1021
6282,康舒,67,12,55,合庫-台中,2023-03-10,1021
00713,元大台灣高息低波,51,1,50,合庫-台中,2023-03-10,1021
2610,華航,208,160,48,合庫-台中,2023-03-10,1021
6770,力積電,61,15,46,合庫-台中,2023-03-10,1021
2886,兆豐金,45,1,44,合庫-台中,2023-03-10,1021
5210,寶碩,47,4,43,合庫-台中,2023-03-10,1021
1718,中纖,53,10,43,合庫-台中,2023-03-10,1021
2881,富邦金,42,0,42,合庫-台中,2023-03-10,1021
00893,國泰智能電動車,45,4,41,合庫-台中,2023-03-10,1021
4968,立積,40,0,40,合庫-台中,2023-03-10,1021
3356,奇偶,42,2,40,合庫-台中,2023-03-10,1021
00637L,元大滬深300正2,141,104,37,合庫-台中,2023-03-10,1021
3669,圓展,35,0,35,合庫-台中,2023-03-10,1021
00712,復華富時不動產,55,20,35,合庫-台中,2023-03-10,1021
3523,迎輝,34,0,34,合庫-台中,2023-03-10,1021
2801,彰銀,33,0,33,合庫-台中,2023-03-10,1021
3272,東碩,33,0,33,合庫-台中,2023-03-10,1021
2303,聯電,60,27,33,合庫-台中,2023-03-10,1021
1608,華榮,31,0,31,合庫-台中,2023-03-10,1021
5321,美而快,33,2,31,合庫-台中,2023-03-10,1021
2636,台驊控股,31,1,30,合庫-台中,2023-03-10,1021
4533,協易機,30,0,30,合庫-台中,2023-03-10,1021
2330,台積電,30,0,30,合庫-台中,2023-03-10,1021
2337,旺宏,32,3,29,合庫-台中,2023-03-10,1021
6116,彩晶,32,5,27,合庫-台中,2023-03-10,1021
3006,晶豪科,28,1,27,合庫-台中,2023-03-10,1021
00878,國泰永續高股息,375,80,295,合庫-台中,2023-03-13,1021
2812,台中銀,205,41,164,合庫-台中,2023-03-13,1021
2886,兆豐金,129,0,129,合庫-台中,2023-03-13,1021
2457,飛宏,201,88,113,合庫-台中,2023-03-13,1021
2880,華南金,109,0,109,合庫-台中,2023-03-13,1021
1316,上曜,97,1,96,合庫-台中,2023-03-13,1021
1504,東元,96,2,94,合庫-台中,2023-03-13,1021
5880,合庫金,99,21,78,合庫-台中,2023-03-13,1021
00715L,期街口布蘭特正2,141,63,78,合庫-台中,2023-03-13,1021
00720B,元大投資級公司債,93,17,76,合庫-台中,2023-03-13,1021
2634,漢翔,122,54,68,合庫-台中,2023-03-13,1021
2337,旺宏,62,2,60,合庫-台中,2023-03-13,1021
2834,臺企銀,81,24,57,合庫-台中,2023-03-13,1021
2884,玉山金,88,33,55,合庫-台中,2023-03-13,1021
2388,威盛,106,56,50,合庫-台中,2023-03-13,1021
2023,燁輝,52,2,50,合庫-台中,2023-03-13,1021
3321,同泰,50,0,50,合庫-台中,2023-03-13,1021
1305,華夏,44,0,44,合庫-台中,2023-03-13,1021
2881,富邦金,43,1,42,合庫-台中,2023-03-13,1021
2607,榮運,41,3,38,合庫-台中,2023-03-13,1021
5210,寶碩,40,9,31,合庫-台中,2023-03-13,1021
1524,耿鼎,46,15,31,合庫-台中,2023-03-13,1021
2890,永豐金,31,2,29,合庫-台中,2023-03-13,1021
2892,第一金,28,0,28,合庫-台中,2023-03-13,1021
1513,中興電,34,9,25,合庫-台中,2023-03-13,1021
1527,鑽全,25,0,25,合庫-台中,2023-03-13,1021
00679B,元大美債20年,39,15,24,合庫-台中,2023-03-13,1021
1101,台泥,35,12,23,合庫-台中,2023-03-13,1021
00885,富邦越南,23,1,22,合庫-台中,2023-03-13,1021
2801,彰銀,20,0,20,合庫-台中,2023-03-13,1021
6191,精成科,21,2,19,合庫-台中,2023-03-13,1021
3356,奇偶,20,1,19,合庫-台中,2023-03-13,1021
6791,虎門科技,18,0,18,合庫-台中,2023-03-13,1021
8940,新天地,18,0,18,合庫-台中,2023-03-13,1021
2413,環科,37,21,16,合庫-台中,2023-03-13,1021
2885,元大金,17,2,15,合庫-台中,2023-03-13,1021
8112,至上,22,7,15,合庫-台中,2023-03-13,1021
5272,笙科,15,0,15,合庫-台中,2023-03-13,1021
6290,良維,15,0,15,合庫-台中,2023-03-13,1021
4419,皇家美食,14,0,14,合庫-台中,2023-03-13,1021
2427,三商電,35,21,14,合庫-台中,2023-03-13,1021
3491,昇達科,20,6,14,合庫-台中,2023-03-13,1021
00902,中信電池及儲能,16,3,13,合庫-台中,2023-03-13,1021
2312,金寶,13,0,13,合庫-台中,2023-03-13,1021
2402,毅嘉,13,0,13,合庫-台中,2023-03-13,1021
5905,南仁湖,13,0,13,合庫-台中,2023-03-13,1021
8038,長園科,14,1,13,合庫-台中,2023-03-13,1021
6790,永豐實,13,0,13,合庫-台中,2023-03-13,1021
2891,中信金,17,4,13,合庫-台中,2023-03-13,1021
2609,陽明,150,139,11,合庫-台中,2023-03-13,1021
2618,長榮航,402,12,390,合庫-台中,2023-03-14,1021
00715L,期街口布蘭特正2,332,0,332,合庫-台中,2023-03-14,1021
00878,國泰永續高股息,440,174,266,合庫-台中,2023-03-14,1021
00632R,元大台灣50反1,205,9,196,合庫-台中,2023-03-14,1021
5880,合庫金,162,2,160,合庫-台中,2023-03-14,1021
2891,中信金,164,9,155,合庫-台中,2023-03-14,1021
2409,友達,152,8,144,合庫-台中,2023-03-14,1021
2610,華航,146,5,141,合庫-台中,2023-03-14,1021
00637L,元大滬深300正2,174,43,131,合庫-台中,2023-03-14,1021
2884,玉山金,121,6,115,合庫-台中,2023-03-14,1021
00642U,期元大S＆P石油,115,0,115,合庫-台中,2023-03-14,1021
2882,國泰金,126,22,104,合庫-台中,2023-03-14,1021
2303,聯電,116,24,92,合庫-台中,2023-03-14,1021
2881,富邦金,78,7,71,合庫-台中,2023-03-14,1021
00712,復華富時不動產,70,0,70,合庫-台中,2023-03-14,1021
2812,台中銀,95,33,62,合庫-台中,2023-03-14,1021
3037,欣興,62,1,61,合庫-台中,2023-03-14,1021
8069,元太,91,30,61,合庫-台中,2023-03-14,1021
2609,陽明,165,108,57,合庫-台中,2023-03-14,1021
2105,正新,54,0,54,合庫-台中,2023-03-14,1021
00665L,富邦�琤肭磪囓�2,67,15,52,合庫-台中,2023-03-14,1021
3481,群創,130,80,50,合庫-台中,2023-03-14,1021
2337,旺宏,50,0,50,合庫-台中,2023-03-14,1021
00882,中信中國高股息,49,0,49,合庫-台中,2023-03-14,1021
3356,奇偶,46,0,46,合庫-台中,2023-03-14,1021
2605,新興,51,6,45,合庫-台中,2023-03-14,1021
4162,智擎,41,2,39,合庫-台中,2023-03-14,1021
5425,台半,52,13,39,合庫-台中,2023-03-14,1021
8112,至上,51,12,39,合庫-台中,2023-03-14,1021
00893,國泰智能電動車,40,2,38,合庫-台中,2023-03-14,1021
2892,第一金,37,0,37,合庫-台中,2023-03-14,1021
6235,華孚,66,29,37,合庫-台中,2023-03-14,1021
2211,長榮鋼,36,5,31,合庫-台中,2023-03-14,1021
2888,新光金,41,11,30,合庫-台中,2023-03-14,1021
2890,永豐金,37,8,29,合庫-台中,2023-03-14,1021
2313,華通,37,9,28,合庫-台中,2023-03-14,1021
2880,華南金,28,0,28,合庫-台中,2023-03-14,1021
8299,群聯,28,0,28,合庫-台中,2023-03-14,1021
6770,力積電,31,4,27,合庫-台中,2023-03-14,1021
1101,台泥,37,10,27,合庫-台中,2023-03-14,1021
2457,飛宏,128,103,25,合庫-台中,2023-03-14,1021
1762,中化生,44,19,25,合庫-台中,2023-03-14,1021
2637,慧洋-KY,53,30,23,合庫-台中,2023-03-14,1021
2344,華邦電,46,23,23,合庫-台中,2023-03-14,1021
00671R,富邦NASDAQ反1,23,0,23,合庫-台中,2023-03-14,1021
9105,泰金寶-DR,23,0,23,合庫-台中,2023-03-14,1021
1605,華新,40,19,21,合庫-台中,2023-03-14,1021
2801,彰銀,23,2,21,合庫-台中,2023-03-14,1021
2317,鴻海,38,18,20,合庫-台中,2023-03-14,1021
2645,長榮航太,22,2,20,合庫-台中,2023-03-14,1021
00715L,期街口布蘭特正2,475,9,466,合庫-台中,2023-03-15,1021
2603,長榮,404,117,287,合庫-台中,2023-03-15,1021
5880,合庫金,242,11,231,合庫-台中,2023-03-15,1021
00878,國泰永續高股息,193,2,191,合庫-台中,2023-03-15,1021
2891,中信金,190,0,190,合庫-台中,2023-03-15,1021
2915,潤泰全,181,7,174,合庫-台中,2023-03-15,1021
00632R,元大台灣50反1,514,342,172,合庫-台中,2023-03-15,1021
2883,凱基金,137,48,89,合庫-台中,2023-03-15,1021
2614,東森,101,21,80,合庫-台中,2023-03-15,1021
2834,臺企銀,69,6,63,合庫-台中,2023-03-15,1021
2880,華南金,58,0,58,合庫-台中,2023-03-15,1021
2409,友達,69,11,58,合庫-台中,2023-03-15,1021
00642U,期元大S＆P石油,68,10,58,合庫-台中,2023-03-15,1021
1314,中石化,55,1,54,合庫-台中,2023-03-15,1021
3481,群創,175,124,51,合庫-台中,2023-03-15,1021
3703,欣陸,50,0,50,合庫-台中,2023-03-15,1021
9945,潤泰新,47,0,47,合庫-台中,2023-03-15,1021
00679B,元大美債20年,50,6,44,合庫-台中,2023-03-15,1021
2886,兆豐金,46,4,42,合庫-台中,2023-03-15,1021
00713,元大台灣高息低波,40,0,40,合庫-台中,2023-03-15,1021
2884,玉山金,40,7,33,合庫-台中,2023-03-15,1021
2609,陽明,130,98,32,合庫-台中,2023-03-15,1021
6770,力積電,42,10,32,合庫-台中,2023-03-15,1021
00637L,元大滬深300正2,37,5,32,合庫-台中,2023-03-15,1021
6026,福邦證,28,0,28,合庫-台中,2023-03-15,1021
2482,連宇,59,31,28,合庫-台中,2023-03-15,1021
2368,金像電,26,0,26,合庫-台中,2023-03-15,1021
0056,元大高股息,24,1,23,合庫-台中,2023-03-15,1021
2888,新光金,55,32,23,合庫-台中,2023-03-15,1021
2801,彰銀,22,0,22,合庫-台中,2023-03-15,1021
2637,慧洋-KY,22,0,22,合庫-台中,2023-03-15,1021
3162,精確,53,32,21,合庫-台中,2023-03-15,1021
2892,第一金,22,1,21,合庫-台中,2023-03-15,1021
3015,全漢,20,0,20,合庫-台中,2023-03-15,1021
2890,永豐金,22,2,20,合庫-台中,2023-03-15,1021
6191,精成科,20,0,20,合庫-台中,2023-03-15,1021
2460,建通,20,0,20,合庫-台中,2023-03-15,1021
00751B,元大AAA至A公司債,20,1,19,合庫-台中,2023-03-15,1021
4128,中天,18,0,18,合庫-台中,2023-03-15,1021
2882,國泰金,21,4,17,合庫-台中,2023-03-15,1021
4743,合一,23,6,17,合庫-台中,2023-03-15,1021
3078,僑威,23,7,16,合庫-台中,2023-03-15,1021
5450,南良,16,0,16,合庫-台中,2023-03-15,1021
6282,康舒,46,30,16,合庫-台中,2023-03-15,1021
2889,國票金,25,10,15,合庫-台中,2023-03-15,1021
1810,和成,15,0,15,合庫-台中,2023-03-15,1021
00680L,元大美債20正2,15,0,15,合庫-台中,2023-03-15,1021
5258,虹堡,29,15,14,合庫-台中,2023-03-15,1021
2344,華邦電,21,7,14,合庫-台中,2023-03-15,1021
2520,冠德,16,2,14,合庫-台中,2023-03-15,1021
2834,臺企銀,841,314,527,合庫-台中,2023-03-16,1021
00878,國泰永續高股息,362,17,345,合庫-台中,2023-03-16,1021
00632R,元大台灣50反1,882,564,318,合庫-台中,2023-03-16,1021
00715L,期街口布蘭特正2,625,401,224,合庫-台中,2023-03-16,1021
2891,中信金,211,29,182,合庫-台中,2023-03-16,1021
2618,長榮航,171,3,168,合庫-台中,2023-03-16,1021
5880,合庫金,141,14,127,合庫-台中,2023-03-16,1021
00642U,期元大S＆P石油,113,1,112,合庫-台中,2023-03-16,1021
2883,凱基金,180,69,111,合庫-台中,2023-03-16,1021
6140,訊達,102,0,102,合庫-台中,2023-03-16,1021
9105,泰金寶-DR,102,0,102,合庫-台中,2023-03-16,1021
2498,宏達電,107,33,74,合庫-台中,2023-03-16,1021
2884,玉山金,150,86,64,合庫-台中,2023-03-16,1021
2890,永豐金,95,33,62,合庫-台中,2023-03-16,1021
5905,南仁湖,62,0,62,合庫-台中,2023-03-16,1021
2066,世德,62,0,62,合庫-台中,2023-03-16,1021
4976,佳凌,62,5,57,合庫-台中,2023-03-16,1021
0056,元大高股息,94,37,57,合庫-台中,2023-03-16,1021
2812,台中銀,52,0,52,合庫-台中,2023-03-16,1021
4306,炎洲,56,7,49,合庫-台中,2023-03-16,1021
2605,新興,48,0,48,合庫-台中,2023-03-16,1021
2888,新光金,70,30,40,合庫-台中,2023-03-16,1021
2606,裕民,40,0,40,合庫-台中,2023-03-16,1021
2419,仲琦,40,0,40,合庫-台中,2023-03-16,1021
2880,華南金,52,12,40,合庫-台中,2023-03-16,1021
2425,承啟,45,10,35,合庫-台中,2023-03-16,1021
1584,精剛,48,14,34,合庫-台中,2023-03-16,1021
6116,彩晶,56,23,33,合庫-台中,2023-03-16,1021
00712,復華富時不動產,37,5,32,合庫-台中,2023-03-16,1021
6023,元大期,30,0,30,合庫-台中,2023-03-16,1021
2881,富邦金,34,4,30,合庫-台中,2023-03-16,1021
2330,台積電,43,14,29,合庫-台中,2023-03-16,1021
3438,類比科,28,0,28,合庫-台中,2023-03-16,1021
2845,遠東銀,37,9,28,合庫-台中,2023-03-16,1021
3703,欣陸,27,0,27,合庫-台中,2023-03-16,1021
2887,台新金,29,3,26,合庫-台中,2023-03-16,1021
0050,元大台灣50,26,0,26,合庫-台中,2023-03-16,1021
2634,漢翔,71,45,26,合庫-台中,2023-03-16,1021
1312,國喬,25,0,25,合庫-台中,2023-03-16,1021
4113,聯上,24,0,24,合庫-台中,2023-03-16,1021
00637L,元大滬深300正2,63,40,23,合庫-台中,2023-03-16,1021
3209,全科,28,6,22,合庫-台中,2023-03-16,1021
2885,元大金,38,16,22,合庫-台中,2023-03-16,1021
2312,金寶,22,0,22,合庫-台中,2023-03-16,1021
8171,天宇,39,17,22,合庫-台中,2023-03-16,1021
3046,建��,64,42,22,合庫-台中,2023-03-16,1021
1314,中石化,26,4,22,合庫-台中,2023-03-16,1021
2603,長榮,59,38,21,合庫-台中,2023-03-16,1021
2915,潤泰全,27,7,20,合庫-台中,2023-03-16,1021
2303,聯電,43,23,20,合庫-台中,2023-03-16,1021
00665L,富邦�琤肭磪囓�2,582,80,502,合庫-台中,2023-03-17,1021
2888,新光金,292,3,289,合庫-台中,2023-03-17,1021
5880,合庫金,103,16,87,合庫-台中,2023-03-17,1021
2891,中信金,92,12,80,合庫-台中,2023-03-17,1021
00878,國泰永續高股息,86,16,70,合庫-台中,2023-03-17,1021
00715L,期街口布蘭特正2,86,21,65,合庫-台中,2023-03-17,1021
00713,元大台灣高息低波,55,3,52,合庫-台中,2023-03-17,1021
2614,東森,51,0,51,合庫-台中,2023-03-17,1021
4953,緯軟,52,1,51,合庫-台中,2023-03-17,1021
2905,三商,51,0,51,合庫-台中,2023-03-17,1021
5009,榮剛,89,44,45,合庫-台中,2023-03-17,1021
1444,力麗,50,10,40,合庫-台中,2023-03-17,1021
2610,華航,53,16,37,合庫-台中,2023-03-17,1021
2883,凱基金,58,21,37,合庫-台中,2023-03-17,1021
3682,亞太電,31,0,31,合庫-台中,2023-03-17,1021
1432,大魯閣,31,0,31,合庫-台中,2023-03-17,1021
6282,康舒,80,50,30,合庫-台中,2023-03-17,1021
6243,迅杰,30,1,29,合庫-台中,2023-03-17,1021
8171,天宇,32,3,29,合庫-台中,2023-03-17,1021
2880,華南金,29,1,28,合庫-台中,2023-03-17,1021
9105,泰金寶-DR,28,0,28,合庫-台中,2023-03-17,1021
2881,富邦金,26,0,26,合庫-台中,2023-03-17,1021
4979,華星光,25,0,25,合庫-台中,2023-03-17,1021
2645,長榮航太,25,1,24,合庫-台中,2023-03-17,1021
2618,長榮航,30,7,23,合庫-台中,2023-03-17,1021
3221,台嘉碩,41,19,22,合庫-台中,2023-03-17,1021
00772B,中信高評級公司債,23,1,22,合庫-台中,2023-03-17,1021
00679B,元大美債20年,29,8,21,合庫-台中,2023-03-17,1021
2884,玉山金,36,15,21,合庫-台中,2023-03-17,1021
6548,長科*,21,0,21,合庫-台中,2023-03-17,1021
6125,廣運,23,3,20,合庫-台中,2023-03-17,1021
00712,復華富時不動產,32,12,20,合庫-台中,2023-03-17,1021
4126,太醫,20,0,20,合庫-台中,2023-03-17,1021
3583,辛耘,20,0,20,合庫-台中,2023-03-17,1021
8936,國統,20,0,20,合庫-台中,2023-03-17,1021
00902,中信電池及儲能,99,80,19,合庫-台中,2023-03-17,1021
5536,聖暉*,19,0,19,合庫-台中,2023-03-17,1021
0056,元大高股息,38,20,18,合庫-台中,2023-03-17,1021
2014,中鴻,21,4,17,合庫-台中,2023-03-17,1021
8016,矽創,22,6,16,合庫-台中,2023-03-17,1021
6472,保瑞,35,20,15,合庫-台中,2023-03-17,1021
6279,胡連,15,0,15,合庫-台中,2023-03-17,1021
2388,威盛,45,31,14,合庫-台中,2023-03-17,1021
9921,巨大,13,0,13,合庫-台中,2023-03-17,1021
2537,聯上發,13,0,13,合庫-台中,2023-03-17,1021
3523,迎輝,13,0,13,合庫-台中,2023-03-17,1021
6147,頎邦,13,0,13,合庫-台中,2023-03-17,1021
1611,中電,15,2,13,合庫-台中,2023-03-17,1021
4419,皇家美食,12,0,12,合庫-台中,2023-03-17,1021
2457,飛宏,66,55,11,合庫-台中,2023-03-17,1021
00715L,期街口布蘭特正2,644,276,368,合庫-台中,2023-03-20,1021
00676R,富邦臺灣加權反1,337,0,337,合庫-台中,2023-03-20,1021
00637L,元大滬深300正2,381,143,238,合庫-台中,2023-03-20,1021
2888,新光金,236,17,219,合庫-台中,2023-03-20,1021
00878,國泰永續高股息,173,21,152,合庫-台中,2023-03-20,1021
2884,玉山金,110,0,110,合庫-台中,2023-03-20,1021
1605,華新,99,2,97,合庫-台中,2023-03-20,1021
2539,櫻花建,78,3,75,合庫-台中,2023-03-20,1021
5880,合庫金,65,2,63,合庫-台中,2023-03-20,1021
2801,彰銀,55,0,55,合庫-台中,2023-03-20,1021
8171,天宇,50,1,49,合庫-台中,2023-03-20,1021
5285,界霖,48,0,48,合庫-台中,2023-03-20,1021
2462,良得電,54,10,44,合庫-台中,2023-03-20,1021
6751,智聯服務,37,0,37,合庫-台中,2023-03-20,1021
00712,復華富時不動產,28,1,27,合庫-台中,2023-03-20,1021
3707,漢磊,30,4,26,合庫-台中,2023-03-20,1021
2748,雲品,28,3,25,合庫-台中,2023-03-20,1021
2915,潤泰全,24,0,24,合庫-台中,2023-03-20,1021
2609,陽明,42,19,23,合庫-台中,2023-03-20,1021
2891,中信金,29,7,22,合庫-台中,2023-03-20,1021
1108,幸福,60,38,22,合庫-台中,2023-03-20,1021
4109,加捷生醫,20,0,20,合庫-台中,2023-03-20,1021
2409,友達,24,5,19,合庫-台中,2023-03-20,1021
2867,三商壽,19,0,19,合庫-台中,2023-03-20,1021
2882,國泰金,25,7,18,合庫-台中,2023-03-20,1021
00885,富邦越南,22,4,18,合庫-台中,2023-03-20,1021
2722,夏都,19,2,17,合庫-台中,2023-03-20,1021
2330,台積電,20,3,17,合庫-台中,2023-03-20,1021
3029,零壹,30,14,16,合庫-台中,2023-03-20,1021
5272,笙科,16,0,16,合庫-台中,2023-03-20,1021
6244,茂迪,129,114,15,合庫-台中,2023-03-20,1021
2881,富邦金,15,0,15,合庫-台中,2023-03-20,1021
00679B,元大美債20年,28,13,15,合庫-台中,2023-03-20,1021
3523,迎輝,15,0,15,合庫-台中,2023-03-20,1021
00674R,期元大S＆P黃金反1,15,0,15,合庫-台中,2023-03-20,1021
8088,品安,14,0,14,合庫-台中,2023-03-20,1021
1504,東元,21,7,14,合庫-台中,2023-03-20,1021
1326,台化,13,0,13,合庫-台中,2023-03-20,1021
3189,景碩,15,3,12,合庫-台中,2023-03-20,1021
2880,華南金,12,0,12,合庫-台中,2023-03-20,1021
3005,神基,12,0,12,合庫-台中,2023-03-20,1021
2317,鴻海,26,15,11,合庫-台中,2023-03-20,1021
2892,第一金,25,14,11,合庫-台中,2023-03-20,1021
4513,福裕,10,0,10,合庫-台中,2023-03-20,1021
2495,普安,52,42,10,合庫-台中,2023-03-20,1021
2601,益航,11,1,10,合庫-台中,2023-03-20,1021
00751B,元大AAA至A公司債,10,0,10,合庫-台中,2023-03-20,1021
3028,增你強,10,0,10,合庫-台中,2023-03-20,1021
4551,智伸科,10,0,10,合庫-台中,2023-03-20,1021
2460,建通,10,0,10,合庫-台中,2023-03-20,1021
6244,茂迪,255,53,202,合庫-台中,2023-03-21,1021
1909,榮成,200,0,200,合庫-台中,2023-03-21,1021
3481,群創,346,221,125,合庫-台中,2023-03-21,1021
2303,聯電,119,44,75,合庫-台中,2023-03-21,1021
2388,威盛,99,31,68,合庫-台中,2023-03-21,1021
00878,國泰永續高股息,69,14,55,合庫-台中,2023-03-21,1021
2408,南亞科,54,1,53,合庫-台中,2023-03-21,1021
2812,台中銀,55,9,46,合庫-台中,2023-03-21,1021
5425,台半,52,7,45,合庫-台中,2023-03-21,1021
00888,永豐台灣ESG,39,0,39,合庫-台中,2023-03-21,1021
2399,映泰,55,17,38,合庫-台中,2023-03-21,1021
8926,台汽電,52,16,36,合庫-台中,2023-03-21,1021
2375,凱美,36,0,36,合庫-台中,2023-03-21,1021
2891,中信金,74,38,36,合庫-台中,2023-03-21,1021
2323,中環,45,10,35,合庫-台中,2023-03-21,1021
1108,幸福,40,8,32,合庫-台中,2023-03-21,1021
2610,華航,30,4,26,合庫-台中,2023-03-21,1021
00772B,中信高評級公司債,26,0,26,合庫-台中,2023-03-21,1021
2601,益航,23,1,22,合庫-台中,2023-03-21,1021
2906,高林,22,0,22,合庫-台中,2023-03-21,1021
4934,太極,26,5,21,合庫-台中,2023-03-21,1021
5880,合庫金,33,13,20,合庫-台中,2023-03-21,1021
4976,佳凌,27,7,20,合庫-台中,2023-03-21,1021
1506,正道,20,0,20,合庫-台中,2023-03-21,1021
4119,旭富,20,0,20,合庫-台中,2023-03-21,1021
00679B,元大美債20年,24,5,19,合庫-台中,2023-03-21,1021
00885,富邦越南,111,92,19,合庫-台中,2023-03-21,1021
3046,建��,52,34,18,合庫-台中,2023-03-21,1021
00712,復華富時不動產,34,16,18,合庫-台中,2023-03-21,1021
3594,磐儀,21,3,18,合庫-台中,2023-03-21,1021
2603,長榮,47,29,18,合庫-台中,2023-03-21,1021
1605,華新,31,15,16,合庫-台中,2023-03-21,1021
2406,國碩,20,5,15,合庫-台中,2023-03-21,1021
3265,台星科,15,0,15,合庫-台中,2023-03-21,1021
2462,良得電,40,25,15,合庫-台中,2023-03-21,1021
8033,雷虎,29,15,14,合庫-台中,2023-03-21,1021
4770,上品,17,4,13,合庫-台中,2023-03-21,1021
00882,中信中國高股息,13,0,13,合庫-台中,2023-03-21,1021
6733,博晟生醫,21,8,13,合庫-台中,2023-03-21,1021
00648R,元大S＆P500反1,13,0,13,合庫-台中,2023-03-21,1021
2888,新光金,33,20,13,合庫-台中,2023-03-21,1021
6462,神盾,22,9,13,合庫-台中,2023-03-21,1021
9955,佳龍,17,4,13,合庫-台中,2023-03-21,1021
9945,潤泰新,37,25,12,合庫-台中,2023-03-21,1021
6191,精成科,18,6,12,合庫-台中,2023-03-21,1021
3711,日月光投控,13,1,12,合庫-台中,2023-03-21,1021
2481,強茂,13,1,12,合庫-台中,2023-03-21,1021
5225,東科-KY,12,0,12,合庫-台中,2023-03-21,1021
1809,中釉,12,0,12,合庫-台中,2023-03-21,1021
00669R,國泰美國道瓊反1,12,0,12,合庫-台中,2023-03-21,1021
00632R,元大台灣50反1,255,7,248,合庫-台中,2023-03-22,1021
2453,凌群,223,108,115,合庫-台中,2023-03-22,1021
1529,樂事綠能,111,19,92,合庫-台中,2023-03-22,1021
00679B,元大美債20年,75,1,74,合庫-台中,2023-03-22,1021
2880,華南金,63,0,63,合庫-台中,2023-03-22,1021
00637L,元大滬深300正2,65,21,44,合庫-台中,2023-03-22,1021
2867,三商壽,54,11,43,合庫-台中,2023-03-22,1021
2614,東森,40,3,37,合庫-台中,2023-03-22,1021
4306,炎洲,37,0,37,合庫-台中,2023-03-22,1021
2201,裕隆,37,2,35,合庫-台中,2023-03-22,1021
6231,系微,38,3,35,合庫-台中,2023-03-22,1021
6165,浪凡,35,0,35,合庫-台中,2023-03-22,1021
2413,環科,46,14,32,合庫-台中,2023-03-22,1021
3013,晟銘電,40,10,30,合庫-台中,2023-03-22,1021
2885,元大金,32,3,29,合庫-台中,2023-03-22,1021
2388,威盛,41,17,24,合庫-台中,2023-03-22,1021
2882,國泰金,27,5,22,合庫-台中,2023-03-22,1021
5210,寶碩,22,0,22,合庫-台中,2023-03-22,1021
8358,金居,28,6,22,合庫-台中,2023-03-22,1021
8097,常珵,25,4,21,合庫-台中,2023-03-22,1021
1101,台泥,29,8,21,合庫-台中,2023-03-22,1021
2482,連宇,47,26,21,合庫-台中,2023-03-22,1021
2462,良得電,35,15,20,合庫-台中,2023-03-22,1021
3162,精確,28,8,20,合庫-台中,2023-03-22,1021
00680L,元大美債20正2,20,1,19,合庫-台中,2023-03-22,1021
3062,建漢,20,1,19,合庫-台中,2023-03-22,1021
2812,台中銀,25,6,19,合庫-台中,2023-03-22,1021
2427,三商電,21,3,18,合庫-台中,2023-03-22,1021
3673,TPK-KY,19,1,18,合庫-台中,2023-03-22,1021
6235,華孚,20,3,17,合庫-台中,2023-03-22,1021
3594,磐儀,18,1,17,合庫-台中,2023-03-22,1021
6116,彩晶,26,9,17,合庫-台中,2023-03-22,1021
2401,凌陽,26,10,16,合庫-台中,2023-03-22,1021
8050,廣積,21,5,16,合庫-台中,2023-03-22,1021
1605,華新,50,35,15,合庫-台中,2023-03-22,1021
1802,台玻,17,2,15,合庫-台中,2023-03-22,1021
6191,精成科,19,5,14,合庫-台中,2023-03-22,1021
5258,虹堡,41,28,13,合庫-台中,2023-03-22,1021
00772B,中信高評級公司債,15,2,13,合庫-台中,2023-03-22,1021
6279,胡連,13,0,13,合庫-台中,2023-03-22,1021
3078,僑威,14,1,13,合庫-台中,2023-03-22,1021
2457,飛宏,42,30,12,合庫-台中,2023-03-22,1021
00642U,期元大S＆P石油,15,3,12,合庫-台中,2023-03-22,1021
1609,大亞,12,1,11,合庫-台中,2023-03-22,1021
5608,四維航,11,0,11,合庫-台中,2023-03-22,1021
3596,智易,11,0,11,合庫-台中,2023-03-22,1021
2889,國票金,52,41,11,合庫-台中,2023-03-22,1021
6229,研通,11,0,11,合庫-台中,2023-03-22,1021
4958,臻鼎-KY,10,0,10,合庫-台中,2023-03-22,1021
2460,建通,10,0,10,合庫-台中,2023-03-22,1021
3481,群創,308,60,248,合庫-台中,2023-03-23,1021
00888,永豐台灣ESG,151,0,151,合庫-台中,2023-03-23,1021
3231,緯創,231,118,113,合庫-台中,2023-03-23,1021
2498,宏達電,118,17,101,合庫-台中,2023-03-23,1021
00632R,元大台灣50反1,58,0,58,合庫-台中,2023-03-23,1021
00670L,富邦NASDAQ正2,51,0,51,合庫-台中,2023-03-23,1021
3047,訊舟,50,1,49,合庫-台中,2023-03-23,1021
2883,凱基金,53,7,46,合庫-台中,2023-03-23,1021
00885,富邦越南,42,0,42,合庫-台中,2023-03-23,1021
1909,榮成,36,0,36,合庫-台中,2023-03-23,1021
1319,東陽,44,9,35,合庫-台中,2023-03-23,1021
5425,台半,51,18,33,合庫-台中,2023-03-23,1021
2453,凌群,35,2,33,合庫-台中,2023-03-23,1021
3093,港建*,31,0,31,合庫-台中,2023-03-23,1021
6282,康舒,40,9,31,合庫-台中,2023-03-23,1021
2302,麗正,31,2,29,合庫-台中,2023-03-23,1021
00637L,元大滬深300正2,39,12,27,合庫-台中,2023-03-23,1021
6171,大城地產,27,0,27,合庫-台中,2023-03-23,1021
2542,興富發,33,6,27,合庫-台中,2023-03-23,1021
6668,中揚光,25,0,25,合庫-台中,2023-03-23,1021
8050,廣積,27,3,24,合庫-台中,2023-03-23,1021
2303,聯電,92,68,24,合庫-台中,2023-03-23,1021
1712,興農,22,0,22,合庫-台中,2023-03-23,1021
2337,旺宏,24,2,22,合庫-台中,2023-03-23,1021
3432,台端,26,5,21,合庫-台中,2023-03-23,1021
2457,飛宏,58,37,21,合庫-台中,2023-03-23,1021
8097,常珵,20,0,20,合庫-台中,2023-03-23,1021
2515,中工,20,0,20,合庫-台中,2023-03-23,1021
2375,凱美,26,7,19,合庫-台中,2023-03-23,1021
6229,研通,19,0,19,合庫-台中,2023-03-23,1021
9902,台火,19,0,19,合庫-台中,2023-03-23,1021
3322,建舜電,29,10,19,合庫-台中,2023-03-23,1021
3290,東浦,18,0,18,合庫-台中,2023-03-23,1021
2471,資通,24,6,18,合庫-台中,2023-03-23,1021
8176,智捷,18,0,18,合庫-台中,2023-03-23,1021
6288,聯嘉,61,44,17,合庫-台中,2023-03-23,1021
6733,博晟生醫,21,5,16,合庫-台中,2023-03-23,1021
6284,佳邦,32,16,16,合庫-台中,2023-03-23,1021
3652,精聯,16,0,16,合庫-台中,2023-03-23,1021
1514,亞力,16,0,16,合庫-台中,2023-03-23,1021
2609,陽明,56,41,15,合庫-台中,2023-03-23,1021
8105,凌巨,15,0,15,合庫-台中,2023-03-23,1021
2539,櫻花建,15,0,15,合庫-台中,2023-03-23,1021
2413,環科,16,2,14,合庫-台中,2023-03-23,1021
9958,世紀鋼,14,0,14,合庫-台中,2023-03-23,1021
5353,台林,19,5,14,合庫-台中,2023-03-23,1021
6140,訊達,14,0,14,合庫-台中,2023-03-23,1021
6576,逸達,13,0,13,合庫-台中,2023-03-23,1021
1444,力麗,13,0,13,合庫-台中,2023-03-23,1021
4102,永日,19,6,13,合庫-台中,2023-03-23,1021
00632R,元大台灣50反1,815,10,805,合庫-台中,2023-03-24,1021
6122,擎邦,411,6,405,合庫-台中,2023-03-24,1021
6606,建德工業,173,3,170,合庫-台中,2023-03-24,1021
00665L,富邦�琤肭磪囓�2,182,22,160,合庫-台中,2023-03-24,1021
00878,國泰永續高股息,163,43,120,合庫-台中,2023-03-24,1021
6443,元晶,103,28,75,合庫-台中,2023-03-24,1021
1909,榮成,64,0,64,合庫-台中,2023-03-24,1021
4162,智擎,76,16,60,合庫-台中,2023-03-24,1021
2609,陽明,61,7,54,合庫-台中,2023-03-24,1021
2460,建通,50,0,50,合庫-台中,2023-03-24,1021
2610,華航,53,6,47,合庫-台中,2023-03-24,1021
2303,聯電,94,53,41,合庫-台中,2023-03-24,1021
2883,凱基金,80,40,40,合庫-台中,2023-03-24,1021
8926,台汽電,42,3,39,合庫-台中,2023-03-24,1021
00888,永豐台灣ESG,41,3,38,合庫-台中,2023-03-24,1021
4908,前鼎,38,0,38,合庫-台中,2023-03-24,1021
2883B,凱基金乙特,38,0,38,合庫-台中,2023-03-24,1021
3715,定穎投控,50,14,36,合庫-台中,2023-03-24,1021
6243,迅杰,35,2,33,合庫-台中,2023-03-24,1021
3013,晟銘電,75,43,32,合庫-台中,2023-03-24,1021
2413,環科,50,18,32,合庫-台中,2023-03-24,1021
4960,誠美材,34,3,31,合庫-台中,2023-03-24,1021
5009,榮剛,55,25,30,合庫-台中,2023-03-24,1021
8112,至上,30,1,29,合庫-台中,2023-03-24,1021
2498,宏達電,59,31,28,合庫-台中,2023-03-24,1021
00712,復華富時不動產,27,0,27,合庫-台中,2023-03-24,1021
3432,台端,32,5,27,合庫-台中,2023-03-24,1021
2897,王道銀行,32,5,27,合庫-台中,2023-03-24,1021
2845,遠東銀,30,5,25,合庫-台中,2023-03-24,1021
2404,漢唐,24,0,24,合庫-台中,2023-03-24,1021
6548,長科*,25,1,24,合庫-台中,2023-03-24,1021
3189,景碩,62,38,24,合庫-台中,2023-03-24,1021
2419,仲琦,25,1,24,合庫-台中,2023-03-24,1021
4763,材料-KY,37,14,23,合庫-台中,2023-03-24,1021
00715L,期街口布蘭特正2,33,11,22,合庫-台中,2023-03-24,1021
2482,連宇,37,15,22,合庫-台中,2023-03-24,1021
3016,嘉晶,21,0,21,合庫-台中,2023-03-24,1021
2601,益航,21,1,20,合庫-台中,2023-03-24,1021
6142,友勁,20,0,20,合庫-台中,2023-03-24,1021
2812,台中銀,25,5,20,合庫-台中,2023-03-24,1021
2515,中工,22,2,20,合庫-台中,2023-03-24,1021
4419,皇家美食,20,0,20,合庫-台中,2023-03-24,1021
3056,富華新,28,8,20,合庫-台中,2023-03-24,1021
2388,威盛,38,19,19,合庫-台中,2023-03-24,1021
2103,台橡,20,1,19,合庫-台中,2023-03-24,1021
3006,晶豪科,20,1,19,合庫-台中,2023-03-24,1021
3441,聯一光,30,12,18,合庫-台中,2023-03-24,1021
6191,精成科,21,3,18,合庫-台中,2023-03-24,1021
3037,欣興,47,30,17,合庫-台中,2023-03-24,1021
3652,精聯,20,3,17,合庫-台中,2023-03-24,1021
1504,東元,332,146,186,合庫-台中,2023-03-27,1021
6288,聯嘉,169,28,141,合庫-台中,2023-03-27,1021
3523,迎輝,128,0,128,合庫-台中,2023-03-27,1021
00637L,元大滬深300正2,141,15,126,合庫-台中,2023-03-27,1021
1909,榮成,106,0,106,合庫-台中,2023-03-27,1021
00882,中信中國高股息,100,0,100,合庫-台中,2023-03-27,1021
00679B,元大美債20年,119,42,77,合庫-台中,2023-03-27,1021
2332,友訊,105,31,74,合庫-台中,2023-03-27,1021
1605,華新,101,28,73,合庫-台中,2023-03-27,1021
3594,磐儀,67,6,61,合庫-台中,2023-03-27,1021
2317,鴻海,54,6,48,合庫-台中,2023-03-27,1021
00650L,復華香港正2,48,0,48,合庫-台中,2023-03-27,1021
4908,前鼎,47,0,47,合庫-台中,2023-03-27,1021
00665L,富邦�琤肭磪囓�2,63,16,47,合庫-台中,2023-03-27,1021
2413,環科,63,19,44,合庫-台中,2023-03-27,1021
00922,國泰台灣領袖50,43,0,43,合庫-台中,2023-03-27,1021
3231,緯創,84,43,41,合庫-台中,2023-03-27,1021
6733,博晟生醫,39,0,39,合庫-台中,2023-03-27,1021
6770,力積電,44,7,37,合庫-台中,2023-03-27,1021
1305,華夏,36,0,36,合庫-台中,2023-03-27,1021
3062,建漢,37,2,35,合庫-台中,2023-03-27,1021
2485,兆赫,35,0,35,合庫-台中,2023-03-27,1021
8938,明安,33,0,33,合庫-台中,2023-03-27,1021
6226,光鼎,33,1,32,合庫-台中,2023-03-27,1021
00715L,期街口布蘭特正2,31,0,31,合庫-台中,2023-03-27,1021
2890,永豐金,43,15,28,合庫-台中,2023-03-27,1021
9902,台火,28,0,28,合庫-台中,2023-03-27,1021
2201,裕隆,34,7,27,合庫-台中,2023-03-27,1021
2340,台亞,33,7,26,合庫-台中,2023-03-27,1021
2889,國票金,32,6,26,合庫-台中,2023-03-27,1021
2614,東森,30,6,24,合庫-台中,2023-03-27,1021
2105,正新,27,3,24,合庫-台中,2023-03-27,1021
1444,力麗,30,6,24,合庫-台中,2023-03-27,1021
2609,陽明,32,9,23,合庫-台中,2023-03-27,1021
2438,翔耀,31,7,24,合庫-台中,2023-03-27,1021
6835,圓裕,22,0,22,合庫-台中,2023-03-27,1021
2897,王道銀行,21,0,21,合庫-台中,2023-03-27,1021
2014,中鴻,21,0,21,合庫-台中,2023-03-27,1021
1519,華城,24,3,21,合庫-台中,2023-03-27,1021
00632R,元大台灣50反1,22,1,21,合庫-台中,2023-03-27,1021
00905,FT臺灣Smart,22,2,20,合庫-台中,2023-03-27,1021
00881,國泰台灣5G+,21,1,20,合庫-台中,2023-03-27,1021
5258,虹堡,23,3,20,合庫-台中,2023-03-27,1021
2486,一詮,21,1,20,合庫-台中,2023-03-27,1021
1529,樂事綠能,21,2,19,合庫-台中,2023-03-27,1021
6182,合晶,24,5,19,合庫-台中,2023-03-27,1021
3056,富華新,26,8,18,合庫-台中,2023-03-27,1021
3652,精聯,22,4,18,合庫-台中,2023-03-27,1021
2476,鉅祥,20,3,17,合庫-台中,2023-03-27,1021
3576,聯合再生,39,23,16,合庫-台中,2023-03-27,1021
2880,華南金,150,0,150,合庫-台中,2023-03-28,1021
9902,台火,129,0,129,合庫-台中,2023-03-28,1021
2014,中鴻,102,0,102,合庫-台中,2023-03-28,1021
2634,漢翔,160,75,85,合庫-台中,2023-03-28,1021
00679B,元大美債20年,76,2,74,合庫-台中,2023-03-28,1021
1432,大魯閣,74,1,73,合庫-台中,2023-03-28,1021
2438,翔耀,80,15,65,合庫-台中,2023-03-28,1021
2388,威盛,88,25,63,合庫-台中,2023-03-28,1021
2609,陽明,70,7,63,合庫-台中,2023-03-28,1021
6770,力積電,63,6,57,合庫-台中,2023-03-28,1021
3523,迎輝,55,0,55,合庫-台中,2023-03-28,1021
6282,康舒,53,1,52,合庫-台中,2023-03-28,1021
00720B,元大投資級公司債,50,0,50,合庫-台中,2023-03-28,1021
00713,元大台灣高息低波,51,4,47,合庫-台中,2023-03-28,1021
1584,精剛,134,88,46,合庫-台中,2023-03-28,1021
2317,鴻海,60,15,45,合庫-台中,2023-03-28,1021
00751B,元大AAA至A公司債,45,0,45,合庫-台中,2023-03-28,1021
6116,彩晶,54,10,44,合庫-台中,2023-03-28,1021
6274,台燿,47,3,44,合庫-台中,2023-03-28,1021
2337,旺宏,46,3,43,合庫-台中,2023-03-28,1021
0056,元大高股息,62,19,43,合庫-台中,2023-03-28,1021
2342,茂矽,64,22,42,合庫-台中,2023-03-28,1021
2413,環科,42,1,41,合庫-台中,2023-03-28,1021
3594,磐儀,41,1,40,合庫-台中,2023-03-28,1021
00665L,富邦�琤肭磪囓�2,37,3,34,合庫-台中,2023-03-28,1021
3046,建��,43,10,33,合庫-台中,2023-03-28,1021
4907,富宇,32,0,32,合庫-台中,2023-03-28,1021
2630,亞航,30,0,30,合庫-台中,2023-03-28,1021
00882,中信中國高股息,34,5,29,合庫-台中,2023-03-28,1021
1605,華新,194,166,28,合庫-台中,2023-03-28,1021
2303,聯電,81,53,28,合庫-台中,2023-03-28,1021
3025,星通,52,25,27,合庫-台中,2023-03-28,1021
2109,華豐,25,0,25,合庫-台中,2023-03-28,1021
00772B,中信高評級公司債,25,1,24,合庫-台中,2023-03-28,1021
6182,合晶,23,0,23,合庫-台中,2023-03-28,1021
6168,宏齊,27,4,23,合庫-台中,2023-03-28,1021
3438,類比科,23,0,23,合庫-台中,2023-03-28,1021
4906,正文,32,9,23,合庫-台中,2023-03-28,1021
6244,茂迪,30,8,22,合庫-台中,2023-03-28,1021
8936,國統,21,0,21,合庫-台中,2023-03-28,1021
00922,國泰台灣領袖50,21,0,21,合庫-台中,2023-03-28,1021
3362,先進光,22,2,20,合庫-台中,2023-03-28,1021
1609,大亞,39,19,20,合庫-台中,2023-03-28,1021
2323,中環,20,0,20,合庫-台中,2023-03-28,1021
5490,同亨,20,0,20,合庫-台中,2023-03-28,1021
4541,晟田,19,0,19,合庫-台中,2023-03-28,1021
1101,台泥,23,4,19,合庫-台中,2023-03-28,1021
3576,聯合再生,18,0,18,合庫-台中,2023-03-28,1021
3037,欣興,36,18,18,合庫-台中,2023-03-28,1021
00692,富邦公司治理,17,0,17,合庫-台中,2023-03-28,1021
6288,聯嘉,138,18,120,合庫-台中,2023-03-29,1021
2885,元大金,103,20,83,合庫-台中,2023-03-29,1021
2888,新光金,56,2,54,合庫-台中,2023-03-29,1021
3715,定穎投控,75,27,48,合庫-台中,2023-03-29,1021
9902,台火,48,0,48,合庫-台中,2023-03-29,1021
2337,旺宏,46,0,46,合庫-台中,2023-03-29,1021
00773B,中信優先金融債,45,0,45,合庫-台中,2023-03-29,1021
2609,陽明,36,1,35,合庫-台中,2023-03-29,1021
9802,鈺齊-KY,35,0,35,合庫-台中,2023-03-29,1021
8926,台汽電,37,3,34,合庫-台中,2023-03-29,1021
6770,力積電,36,4,32,合庫-台中,2023-03-29,1021
3272,東碩,36,5,31,合庫-台中,2023-03-29,1021
4903,聯光通,29,0,29,合庫-台中,2023-03-29,1021
5880,合庫金,31,2,29,合庫-台中,2023-03-29,1021
00637L,元大滬深300正2,363,335,28,合庫-台中,2023-03-29,1021
2317,鴻海,38,14,24,合庫-台中,2023-03-29,1021
00673R,期元大S＆P原油反1,24,2,22,合庫-台中,2023-03-29,1021
2303,聯電,113,91,22,合庫-台中,2023-03-29,1021
6719,力智,20,0,20,合庫-台中,2023-03-29,1021
3523,迎輝,20,0,20,合庫-台中,2023-03-29,1021
3011,今皓,20,1,19,合庫-台中,2023-03-29,1021
00720B,元大投資級公司債,18,0,18,合庫-台中,2023-03-29,1021
6418,詠昇,26,8,18,合庫-台中,2023-03-29,1021
1529,樂事綠能,18,0,18,合庫-台中,2023-03-29,1021
2634,漢翔,37,20,17,合庫-台中,2023-03-29,1021
5425,台半,33,16,17,合庫-台中,2023-03-29,1021
3105,穩懋,26,9,17,合庫-台中,2023-03-29,1021
9945,潤泰新,17,1,16,合庫-台中,2023-03-29,1021
3447,展達,18,2,16,合庫-台中,2023-03-29,1021
3035,智原,34,18,16,合庫-台中,2023-03-29,1021
1810,和成,15,0,15,合庫-台中,2023-03-29,1021
2375,凱美,15,0,15,合庫-台中,2023-03-29,1021
3027,盛達,21,6,15,合庫-台中,2023-03-29,1021
6733,博晟生醫,15,0,15,合庫-台中,2023-03-29,1021
2498,宏達電,27,12,15,合庫-台中,2023-03-29,1021
2312,金寶,14,0,14,合庫-台中,2023-03-29,1021
2645,長榮航太,16,2,14,合庫-台中,2023-03-29,1021
3706,神達,14,0,14,合庫-台中,2023-03-29,1021
00882,中信中國高股息,28,15,13,合庫-台中,2023-03-29,1021
3264,欣銓,13,0,13,合庫-台中,2023-03-29,1021
6485,點序,19,6,13,合庫-台中,2023-03-29,1021
1513,中興電,25,12,13,合庫-台中,2023-03-29,1021
00772B,中信高評級公司債,13,0,13,合庫-台中,2023-03-29,1021
6282,康舒,63,51,12,合庫-台中,2023-03-29,1021
2438,翔耀,12,0,12,合庫-台中,2023-03-29,1021
4551,智伸科,13,1,12,合庫-台中,2023-03-29,1021
2331,精英,12,0,12,合庫-台中,2023-03-29,1021
1795,美時,20,8,12,合庫-台中,2023-03-29,1021
8255,朋程,20,8,12,合庫-台中,2023-03-29,1021
6753,龍德造船,14,3,11,合庫-台中,2023-03-29,1021
2438,翔耀,539,111,428,合庫-台中,2023-03-30,1021
3231,緯創,284,141,143,合庫-台中,2023-03-30,1021
00632R,元大台灣50反1,205,80,125,合庫-台中,2023-03-30,1021
2889,國票金,106,0,106,合庫-台中,2023-03-30,1021
4903,聯光通,72,7,65,合庫-台中,2023-03-30,1021
3523,迎輝,60,0,60,合庫-台中,2023-03-30,1021
6116,彩晶,60,3,57,合庫-台中,2023-03-30,1021
1471,首利,53,0,53,合庫-台中,2023-03-30,1021
2609,陽明,51,2,49,合庫-台中,2023-03-30,1021
2890,永豐金,45,6,39,合庫-台中,2023-03-30,1021
3027,盛達,37,1,36,合庫-台中,2023-03-30,1021
2618,長榮航,37,3,34,合庫-台中,2023-03-30,1021
3706,神達,34,0,34,合庫-台中,2023-03-30,1021
2883,凱基金,33,0,33,合庫-台中,2023-03-30,1021
6770,力積電,34,1,33,合庫-台中,2023-03-30,1021
4804,大略-KY,33,0,33,合庫-台中,2023-03-30,1021
3056,富華新,46,15,31,合庫-台中,2023-03-30,1021
00885,富邦越南,31,1,30,合庫-台中,2023-03-30,1021
3576,聯合再生,31,3,28,合庫-台中,2023-03-30,1021
2481,強茂,30,3,27,合庫-台中,2023-03-30,1021
2867,三商壽,27,1,26,合庫-台中,2023-03-30,1021
6282,康舒,26,0,26,合庫-台中,2023-03-30,1021
2891,中信金,25,0,25,合庫-台中,2023-03-30,1021
1618,合機,41,16,25,合庫-台中,2023-03-30,1021
3594,磐儀,24,0,24,合庫-台中,2023-03-30,1021
1504,東元,49,28,21,合庫-台中,2023-03-30,1021
3567,逸昌,21,0,21,合庫-台中,2023-03-30,1021
1506,正道,20,0,20,合庫-台中,2023-03-30,1021
6005,群益證,20,0,20,合庫-台中,2023-03-30,1021
6276,安鈦克,20,0,20,合庫-台中,2023-03-30,1021
3481,群創,82,63,19,合庫-台中,2023-03-30,1021
5880,合庫金,25,7,18,合庫-台中,2023-03-30,1021
6134,萬旭,22,4,18,合庫-台中,2023-03-30,1021
3105,穩懋,20,3,17,合庫-台中,2023-03-30,1021
2247,汎德永業,16,0,16,合庫-台中,2023-03-30,1021
1584,精剛,63,47,16,合庫-台中,2023-03-30,1021
5243,乙盛-KY,20,4,16,合庫-台中,2023-03-30,1021
6472,保瑞,56,41,15,合庫-台中,2023-03-30,1021
2485,兆赫,15,0,15,合庫-台中,2023-03-30,1021
8940,新天地,15,0,15,合庫-台中,2023-03-30,1021
4958,臻鼎-KY,19,4,15,合庫-台中,2023-03-30,1021
2882,國泰金,15,1,14,合庫-台中,2023-03-30,1021
2344,華邦電,70,56,14,合庫-台中,2023-03-30,1021
2534,宏盛,14,0,14,合庫-台中,2023-03-30,1021
4906,正文,21,7,14,合庫-台中,2023-03-30,1021
6133,金橋,48,36,12,合庫-台中,2023-03-30,1021
00882,中信中國高股息,12,0,12,合庫-台中,2023-03-30,1021
1314,中石化,12,0,12,合庫-台中,2023-03-30,1021
2409,友達,22,10,12,合庫-台中,2023-03-30,1021
6244,茂迪,37,25,12,合庫-台中,2023-03-30,1021
1806,冠軍,215,27,188,合庫-台中,2023-03-31,1021
00673R,期元大S＆P原油反1,133,3,130,合庫-台中,2023-03-31,1021
5202,力新,120,0,120,合庫-台中,2023-03-31,1021
2610,華航,133,32,101,合庫-台中,2023-03-31,1021
2312,金寶,91,5,86,合庫-台中,2023-03-31,1021
6288,聯嘉,77,7,70,合庫-台中,2023-03-31,1021
2419,仲琦,63,0,63,合庫-台中,2023-03-31,1021
1513,中興電,61,9,52,合庫-台中,2023-03-31,1021
5522,遠雄,52,0,52,合庫-台中,2023-03-31,1021
00715L,期街口布蘭特正2,93,42,51,合庫-台中,2023-03-31,1021
9105,泰金寶-DR,40,0,40,合庫-台中,2023-03-31,1021
1314,中石化,41,1,40,合庫-台中,2023-03-31,1021
3521,鴻翊,48,10,38,合庫-台中,2023-03-31,1021
2454,聯發科,100,64,36,合庫-台中,2023-03-31,1021
2485,兆赫,35,0,35,合庫-台中,2023-03-31,1021
2609,陽明,36,6,30,合庫-台中,2023-03-31,1021
1605,華新,49,22,27,合庫-台中,2023-03-31,1021
8110,華東,26,0,26,合庫-台中,2023-03-31,1021
3447,展達,32,7,25,合庫-台中,2023-03-31,1021
2809,京城銀,24,1,23,合庫-台中,2023-03-31,1021
3715,定穎投控,29,7,22,合庫-台中,2023-03-31,1021
3308,聯德,22,0,22,合庫-台中,2023-03-31,1021
00642U,期元大S＆P石油,51,30,21,合庫-台中,2023-03-31,1021
1504,東元,55,35,20,合庫-台中,2023-03-31,1021
00679B,元大美債20年,30,10,20,合庫-台中,2023-03-31,1021
2603,長榮,28,8,20,合庫-台中,2023-03-31,1021
3037,欣興,59,40,19,合庫-台中,2023-03-31,1021
2317,鴻海,20,1,19,合庫-台中,2023-03-31,1021
3046,建��,61,43,18,合庫-台中,2023-03-31,1021
5009,榮剛,38,21,17,合庫-台中,2023-03-31,1021
3490,單井,17,0,17,合庫-台中,2023-03-31,1021
2331,精英,17,0,17,合庫-台中,2023-03-31,1021
1308,亞聚,16,0,16,合庫-台中,2023-03-31,1021
8097,常珵,16,0,16,合庫-台中,2023-03-31,1021
2401,凌陽,17,1,16,合庫-台中,2023-03-31,1021
1795,美時,49,34,15,合庫-台中,2023-03-31,1021
3035,智原,18,3,15,合庫-台中,2023-03-31,1021
6443,元晶,18,4,14,合庫-台中,2023-03-31,1021
2614,東森,20,7,13,合庫-台中,2023-03-31,1021
4903,聯光通,14,1,13,合庫-台中,2023-03-31,1021
3711,日月光投控,33,20,13,合庫-台中,2023-03-31,1021
2027,大成鋼,13,0,13,合庫-台中,2023-03-31,1021
2375,凱美,14,1,13,合庫-台中,2023-03-31,1021
2486,一詮,12,0,12,合庫-台中,2023-03-31,1021
3607,谷崧,12,0,12,合庫-台中,2023-03-31,1021
9945,潤泰新,14,2,12,合庫-台中,2023-03-31,1021
2615,萬海,19,8,11,合庫-台中,2023-03-31,1021
2368,金像電,12,1,11,合庫-台中,2023-03-31,1021
3706,神達,11,0,11,合庫-台中,2023-03-31,1021
1718,中纖,10,0,10,合庫-台中,2023-03-31,1021
00885,富邦越南,358,7,351,合庫-台中,2023-04-06,1021
00673R,期元大S＆P原油反1,218,0,218,合庫-台中,2023-04-06,1021
2337,旺宏,116,1,115,合庫-台中,2023-04-06,1021
2890,永豐金,108,0,108,合庫-台中,2023-04-06,1021
2887,台新金,142,41,101,合庫-台中,2023-04-06,1021
2344,華邦電,111,28,83,合庫-台中,2023-04-06,1021
2609,陽明,100,23,77,合庫-台中,2023-04-06,1021
00665L,富邦�琤肭磪囓�2,83,11,72,合庫-台中,2023-04-06,1021
00902,中信電池及儲能,74,7,67,合庫-台中,2023-04-06,1021
2891,中信金,119,60,59,合庫-台中,2023-04-06,1021
6282,康舒,55,0,55,合庫-台中,2023-04-06,1021
8069,元太,60,6,54,合庫-台中,2023-04-06,1021
2614,東森,51,0,51,合庫-台中,2023-04-06,1021
2443,昶虹,49,0,49,合庫-台中,2023-04-06,1021
2408,南亞科,102,54,48,合庫-台中,2023-04-06,1021
3481,群創,152,109,43,合庫-台中,2023-04-06,1021
3047,訊舟,43,0,43,合庫-台中,2023-04-06,1021
1445,大宇,40,0,40,合庫-台中,2023-04-06,1021
2317,鴻海,51,11,40,合庫-台中,2023-04-06,1021
1618,合機,36,0,36,合庫-台中,2023-04-06,1021
2834,臺企銀,38,3,35,合庫-台中,2023-04-06,1021
1785,光洋科,34,0,34,合庫-台中,2023-04-06,1021
00753L,中信中國50正2,31,0,31,合庫-台中,2023-04-06,1021
00882,中信中國高股息,33,3,30,合庫-台中,2023-04-06,1021
2444,兆勁,30,0,30,合庫-台中,2023-04-06,1021
3521,鴻翊,30,0,30,合庫-台中,2023-04-06,1021
3209,全科,30,1,29,合庫-台中,2023-04-06,1021
2867,三商壽,33,5,28,合庫-台中,2023-04-06,1021
3205,佰研,28,0,28,合庫-台中,2023-04-06,1021
6770,力積電,41,15,26,合庫-台中,2023-04-06,1021
2498,宏達電,52,26,26,合庫-台中,2023-04-06,1021
00670L,富邦NASDAQ正2,27,2,25,合庫-台中,2023-04-06,1021
2610,華航,28,4,24,合庫-台中,2023-04-06,1021
2368,金像電,30,6,24,合庫-台中,2023-04-06,1021
6418,詠昇,30,7,23,合庫-台中,2023-04-06,1021
2618,長榮航,29,7,22,合庫-台中,2023-04-06,1021
00680L,元大美債20正2,45,23,22,合庫-台中,2023-04-06,1021
6163,華電網,40,19,21,合庫-台中,2023-04-06,1021
3447,展達,27,7,20,合庫-台中,2023-04-06,1021
3296,勝德,20,0,20,合庫-台中,2023-04-06,1021
3078,僑威,24,4,20,合庫-台中,2023-04-06,1021
00893,國泰智能電動車,20,0,20,合庫-台中,2023-04-06,1021
2027,大成鋼,25,8,17,合庫-台中,2023-04-06,1021
2302,麗正,18,1,17,合庫-台中,2023-04-06,1021
5301,寶得利,16,0,16,合庫-台中,2023-04-06,1021
2457,飛宏,18,3,15,合庫-台中,2023-04-06,1021
2419,仲琦,40,25,15,合庫-台中,2023-04-06,1021
1909,榮成,15,0,15,合庫-台中,2023-04-06,1021
6811,宏�硌穈T,15,0,15,合庫-台中,2023-04-06,1021
3037,欣興,24,10,14,合庫-台中,2023-04-06,1021
00673R,期元大S＆P原油反1,1236,0,1236,合庫-台中,2023-04-07,1021
2867,三商壽,130,5,125,合庫-台中,2023-04-07,1021
2891,中信金,118,0,118,合庫-台中,2023-04-07,1021
00903,富邦元宇宙,101,1,100,合庫-台中,2023-04-07,1021
9949,琉園,180,101,79,合庫-台中,2023-04-07,1021
2027,大成鋼,55,0,55,合庫-台中,2023-04-07,1021
8383,千附,60,11,49,合庫-台中,2023-04-07,1021
3356,奇偶,40,0,40,合庫-台中,2023-04-07,1021
2208,台船,57,18,39,合庫-台中,2023-04-07,1021
2498,宏達電,124,93,31,合庫-台中,2023-04-07,1021
00751B,元大AAA至A公司債,31,0,31,合庫-台中,2023-04-07,1021
3490,單井,30,0,30,合庫-台中,2023-04-07,1021
1727,中華化,30,0,30,合庫-台中,2023-04-07,1021
1308,亞聚,34,5,29,合庫-台中,2023-04-07,1021
00878,國泰永續高股息,39,10,29,合庫-台中,2023-04-07,1021
2364,倫飛,30,2,28,合庫-台中,2023-04-07,1021
6155,鈞寶,27,0,27,合庫-台中,2023-04-07,1021
2303,聯電,63,38,25,合庫-台中,2023-04-07,1021
1444,力麗,25,0,25,合庫-台中,2023-04-07,1021
6753,龍德造船,26,2,24,合庫-台中,2023-04-07,1021
00712,復華富時不動產,49,25,24,合庫-台中,2023-04-07,1021
2002,中鋼,24,1,23,合庫-台中,2023-04-07,1021
00885,富邦越南,26,5,21,合庫-台中,2023-04-07,1021
6147,頎邦,21,0,21,合庫-台中,2023-04-07,1021
3236,千如,20,0,20,合庫-台中,2023-04-07,1021
6282,康舒,20,0,20,合庫-台中,2023-04-07,1021
3521,鴻翊,20,0,20,合庫-台中,2023-04-07,1021
1434,福懋,20,0,20,合庫-台中,2023-04-07,1021
00687B,國泰20年美債,21,1,20,合庫-台中,2023-04-07,1021
2884,玉山金,25,6,19,合庫-台中,2023-04-07,1021
4979,華星光,24,5,19,合庫-台中,2023-04-07,1021
3035,智原,27,8,19,合庫-台中,2023-04-07,1021
2317,鴻海,20,2,18,合庫-台中,2023-04-07,1021
1314,中石化,17,0,17,合庫-台中,2023-04-07,1021
00772B,中信高評級公司債,16,0,16,合庫-台中,2023-04-07,1021
1472,三洋實業,16,0,16,合庫-台中,2023-04-07,1021
8064,東捷,19,3,16,合庫-台中,2023-04-07,1021
3312,弘憶股,15,0,15,合庫-台中,2023-04-07,1021
2495,普安,18,3,15,合庫-台中,2023-04-07,1021
4976,佳凌,17,2,15,合庫-台中,2023-04-07,1021
2486,一詮,15,0,15,合庫-台中,2023-04-07,1021
00669R,國泰美國道瓊反1,14,0,14,合庫-台中,2023-04-07,1021
6142,友勁,17,3,14,合庫-台中,2023-04-07,1021
00902,中信電池及儲能,14,0,14,合庫-台中,2023-04-07,1021
1229,聯華,15,1,14,合庫-台中,2023-04-07,1021
1219,福壽,13,0,13,合庫-台中,2023-04-07,1021
00713,元大台灣高息低波,32,20,12,合庫-台中,2023-04-07,1021
2886,兆豐金,12,0,12,合庫-台中,2023-04-07,1021
6156,松上,13,1,12,合庫-台中,2023-04-07,1021
3006,晶豪科,26,15,11,合庫-台中,2023-04-07,1021
00673R,期元大S＆P原油反1,168,8,160,合庫-台中,2023-04-10,1021
00712,復華富時不動產,155,53,102,合庫-台中,2023-04-10,1021
3231,緯創,173,73,100,合庫-台中,2023-04-10,1021
2880,華南金,100,9,91,合庫-台中,2023-04-10,1021
2609,陽明,166,99,67,合庫-台中,2023-04-10,1021
2867,三商壽,76,9,67,合庫-台中,2023-04-10,1021
2344,華邦電,106,46,60,合庫-台中,2023-04-10,1021
2313,華通,61,6,55,合庫-台中,2023-04-10,1021
2438,翔耀,55,0,55,合庫-台中,2023-04-10,1021
4541,晟田,61,10,51,合庫-台中,2023-04-10,1021
9962,有益,79,30,49,合庫-台中,2023-04-10,1021
1795,美時,49,3,46,合庫-台中,2023-04-10,1021
2610,華航,44,1,43,合庫-台中,2023-04-10,1021
1108,幸福,43,2,41,合庫-台中,2023-04-10,1021
8054,安國,39,0,39,合庫-台中,2023-04-10,1021
00632R,元大台灣50反1,52,20,32,合庫-台中,2023-04-10,1021
6282,康舒,34,2,32,合庫-台中,2023-04-10,1021
2614,東森,31,0,31,合庫-台中,2023-04-10,1021
3056,富華新,36,5,31,合庫-台中,2023-04-10,1021
00891,中信關鍵半導體,30,1,29,合庫-台中,2023-04-10,1021
3689,湧德,27,0,27,合庫-台中,2023-04-10,1021
3576,聯合再生,28,1,27,合庫-台中,2023-04-10,1021
00680L,元大美債20正2,29,3,26,合庫-台中,2023-04-10,1021
8112,至上,25,0,25,合庫-台中,2023-04-10,1021
6147,頎邦,25,0,25,合庫-台中,2023-04-10,1021
2601,益航,23,0,23,合庫-台中,2023-04-10,1021
3029,零壹,31,9,22,合庫-台中,2023-04-10,1021
2302,麗正,24,4,20,合庫-台中,2023-04-10,1021
1711,永光,20,0,20,合庫-台中,2023-04-10,1021
2337,旺宏,21,1,20,合庫-台中,2023-04-10,1021
4109,加捷生醫,20,0,20,合庫-台中,2023-04-10,1021
6606,建德工業,20,1,19,合庫-台中,2023-04-10,1021
6770,力積電,20,1,19,合庫-台中,2023-04-10,1021
6148,驊宏資,19,1,18,合庫-台中,2023-04-10,1021
2317,鴻海,31,13,18,合庫-台中,2023-04-10,1021
2408,南亞科,21,4,17,合庫-台中,2023-04-10,1021
3419,譁裕,15,0,15,合庫-台中,2023-04-10,1021
6768,志強-KY,15,0,15,合庫-台中,2023-04-10,1021
3707,漢磊,14,0,14,合庫-台中,2023-04-10,1021
1519,華城,21,7,14,合庫-台中,2023-04-10,1021
6477,安集,21,7,14,合庫-台中,2023-04-10,1021
1342,八貫,16,2,14,合庫-台中,2023-04-10,1021
2371,大同,15,1,14,合庫-台中,2023-04-10,1021
3432,台端,15,1,14,合庫-台中,2023-04-10,1021
9945,潤泰新,14,0,14,合庫-台中,2023-04-10,1021
2482,連宇,23,10,13,合庫-台中,2023-04-10,1021
2891,中信金,13,0,13,合庫-台中,2023-04-10,1021
5425,台半,28,15,13,合庫-台中,2023-04-10,1021
2886,兆豐金,14,2,12,合庫-台中,2023-04-10,1021
6156,松上,25,13,12,合庫-台中,2023-04-10,1021
00637L,元大滬深300正2,241,26,215,合庫-台中,2023-04-11,1021
00673R,期元大S＆P原油反1,103,0,103,合庫-台中,2023-04-11,1021
2014,中鴻,73,0,73,合庫-台中,2023-04-11,1021
9949,琉園,71,0,71,合庫-台中,2023-04-11,1021
00679B,元大美債20年,63,0,63,合庫-台中,2023-04-11,1021
3523,迎輝,93,30,63,合庫-台中,2023-04-11,1021
1609,大亞,79,17,62,合庫-台中,2023-04-11,1021
2609,陽明,86,25,61,合庫-台中,2023-04-11,1021
00670L,富邦NASDAQ正2,60,2,58,合庫-台中,2023-04-11,1021
2208,台船,68,13,55,合庫-台中,2023-04-11,1021
3046,建��,102,48,54,合庫-台中,2023-04-11,1021
6282,康舒,55,4,51,合庫-台中,2023-04-11,1021
8171,天宇,51,0,51,合庫-台中,2023-04-11,1021
1444,力麗,50,0,50,合庫-台中,2023-04-11,1021
2313,華通,51,2,49,合庫-台中,2023-04-11,1021
6152,百一,52,5,47,合庫-台中,2023-04-11,1021
5464,霖宏,52,6,46,合庫-台中,2023-04-11,1021
2867,三商壽,51,6,45,合庫-台中,2023-04-11,1021
3354,律勝,45,0,45,合庫-台中,2023-04-11,1021
00772B,中信高評級公司債,43,0,43,合庫-台中,2023-04-11,1021
8050,廣積,47,5,42,合庫-台中,2023-04-11,1021
1504,東元,144,111,33,合庫-台中,2023-04-11,1021
5228,鈺鎧,30,0,30,合庫-台中,2023-04-11,1021
6148,驊宏資,38,9,29,合庫-台中,2023-04-11,1021
9902,台火,28,0,28,合庫-台中,2023-04-11,1021
1708,東鹼,26,0,26,合庫-台中,2023-04-11,1021
3447,展達,31,5,26,合庫-台中,2023-04-11,1021
1308,亞聚,26,0,26,合庫-台中,2023-04-11,1021
1445,大宇,22,0,22,合庫-台中,2023-04-11,1021
2344,華邦電,129,108,21,合庫-台中,2023-04-11,1021
6770,力積電,50,29,21,合庫-台中,2023-04-11,1021
3047,訊舟,28,7,21,合庫-台中,2023-04-11,1021
5353,台林,43,22,21,合庫-台中,2023-04-11,1021
3206,志豐,21,0,21,合庫-台中,2023-04-11,1021
5328,華容,21,1,20,合庫-台中,2023-04-11,1021
00665L,富邦�琤肭磪囓�2,220,200,20,合庫-台中,2023-04-11,1021
2303,聯電,55,35,20,合庫-台中,2023-04-11,1021
6133,金橋,21,1,20,合庫-台中,2023-04-11,1021
6229,研通,20,0,20,合庫-台中,2023-04-11,1021
2890,永豐金,20,1,19,合庫-台中,2023-04-11,1021
6156,松上,23,6,17,合庫-台中,2023-04-11,1021
00712,復華富時不動產,44,28,16,合庫-台中,2023-04-11,1021
6155,鈞寶,16,0,16,合庫-台中,2023-04-11,1021
2443,昶虹,17,1,16,合庫-台中,2023-04-11,1021
3231,緯創,45,29,16,合庫-台中,2023-04-11,1021
6835,圓裕,15,0,15,合庫-台中,2023-04-11,1021
2915,潤泰全,15,0,15,合庫-台中,2023-04-11,1021
6517,保勝光學,14,0,14,合庫-台中,2023-04-11,1021
1802,台玻,14,0,14,合庫-台中,2023-04-11,1021
6244,茂迪,23,10,13,合庫-台中,2023-04-11,1021
1504,東元,1095,68,1027,合庫-台中,2023-04-12,1021
00673R,期元大S＆P原油反1,257,4,253,合庫-台中,2023-04-12,1021
00637L,元大滬深300正2,277,36,241,合庫-台中,2023-04-12,1021
1445,大宇,132,0,132,合庫-台中,2023-04-12,1021
00679B,元大美債20年,97,0,97,合庫-台中,2023-04-12,1021
2516,新建,76,0,76,合庫-台中,2023-04-12,1021
1909,榮成,80,6,74,合庫-台中,2023-04-12,1021
2462,良得電,60,0,60,合庫-台中,2023-04-12,1021
6443,元晶,86,42,44,合庫-台中,2023-04-12,1021
5009,榮剛,81,42,39,合庫-台中,2023-04-12,1021
2337,旺宏,41,2,39,合庫-台中,2023-04-12,1021
6142,友勁,35,0,35,合庫-台中,2023-04-12,1021
00715L,期街口布蘭特正2,47,12,35,合庫-台中,2023-04-12,1021
6461,益得,37,4,33,合庫-台中,2023-04-12,1021
00713,元大台灣高息低波,41,10,31,合庫-台中,2023-04-12,1021
2399,映泰,32,2,30,合庫-台中,2023-04-12,1021
00712,復華富時不動產,35,5,30,合庫-台中,2023-04-12,1021
6218,豪勉,29,0,29,合庫-台中,2023-04-12,1021
3322,建舜電,30,5,25,合庫-台中,2023-04-12,1021
2812,台中銀,23,0,23,合庫-台中,2023-04-12,1021
6194,育富,23,0,23,合庫-台中,2023-04-12,1021
3689,湧德,23,0,23,合庫-台中,2023-04-12,1021
2317,鴻海,25,2,23,合庫-台中,2023-04-12,1021
2313,華通,65,45,20,合庫-台中,2023-04-12,1021
3325,旭品,20,0,20,合庫-台中,2023-04-12,1021
00905,FT臺灣Smart,20,1,19,合庫-台中,2023-04-12,1021
00633L,富邦上証正2,19,0,19,合庫-台中,2023-04-12,1021
8069,元太,24,5,19,合庫-台中,2023-04-12,1021
8936,國統,21,3,18,合庫-台中,2023-04-12,1021
2867,三商壽,38,20,18,合庫-台中,2023-04-12,1021
00669R,國泰美國道瓊反1,17,0,17,合庫-台中,2023-04-12,1021
6770,力積電,20,3,17,合庫-台中,2023-04-12,1021
2497,怡利電,16,0,16,合庫-台中,2023-04-12,1021
2610,華航,23,7,16,合庫-台中,2023-04-12,1021
5512,力麒,16,0,16,合庫-台中,2023-04-12,1021
3047,訊舟,16,0,16,合庫-台中,2023-04-12,1021
8401,白紗科,18,2,16,合庫-台中,2023-04-12,1021
3006,晶豪科,41,25,16,合庫-台中,2023-04-12,1021
0056,元大高股息,26,11,15,合庫-台中,2023-04-12,1021
1609,大亞,142,127,15,合庫-台中,2023-04-12,1021
2344,華邦電,41,26,15,合庫-台中,2023-04-12,1021
2457,飛宏,24,9,15,合庫-台中,2023-04-12,1021
3005,神基,17,2,15,合庫-台中,2023-04-12,1021
3669,圓展,15,1,14,合庫-台中,2023-04-12,1021
00919,群益台灣精選高息,13,0,13,合庫-台中,2023-04-12,1021
5488,松普,19,6,13,合庫-台中,2023-04-12,1021
2438,翔耀,13,0,13,合庫-台中,2023-04-12,1021
6282,康舒,18,5,13,合庫-台中,2023-04-12,1021
4113,聯上,13,0,13,合庫-台中,2023-04-12,1021
3673,TPK-KY,16,4,12,合庫-台中,2023-04-12,1021
1609,大亞,486,68,418,合庫-台中,2023-04-13,1021
2867,三商壽,412,84,328,合庫-台中,2023-04-13,1021
00673R,期元大S＆P原油反1,382,80,302,合庫-台中,2023-04-13,1021
3481,群創,403,144,259,合庫-台中,2023-04-13,1021
6282,康舒,141,3,138,合庫-台中,2023-04-13,1021
4129,聯合,94,0,94,合庫-台中,2023-04-13,1021
3494,誠研,85,12,73,合庫-台中,2023-04-13,1021
00712,復華富時不動產,75,5,70,合庫-台中,2023-04-13,1021
2337,旺宏,70,1,69,合庫-台中,2023-04-13,1021
1605,華新,88,29,59,合庫-台中,2023-04-13,1021
00637L,元大滬深300正2,203,145,58,合庫-台中,2023-04-13,1021
2324,仁寶,55,1,54,合庫-台中,2023-04-13,1021
1504,東元,131,83,48,合庫-台中,2023-04-13,1021
4168,醣聯,57,11,46,合庫-台中,2023-04-13,1021
6288,聯嘉,76,30,46,合庫-台中,2023-04-13,1021
00679B,元大美債20年,54,10,44,合庫-台中,2023-04-13,1021
2012,春雨,39,1,38,合庫-台中,2023-04-13,1021
1503,士電,85,48,37,合庫-台中,2023-04-13,1021
3711,日月光投控,42,7,35,合庫-台中,2023-04-13,1021
6443,元晶,37,3,34,合庫-台中,2023-04-13,1021
0056,元大高股息,51,17,34,合庫-台中,2023-04-13,1021
00720B,元大投資級公司債,30,0,30,合庫-台中,2023-04-13,1021
3715,定穎投控,65,35,30,合庫-台中,2023-04-13,1021
2388,威盛,33,4,29,合庫-台中,2023-04-13,1021
2344,華邦電,85,56,29,合庫-台中,2023-04-13,1021
3037,欣興,31,5,26,合庫-台中,2023-04-13,1021
6116,彩晶,32,6,26,合庫-台中,2023-04-13,1021
00772B,中信高評級公司債,22,0,22,合庫-台中,2023-04-13,1021
2329,華泰,22,0,22,合庫-台中,2023-04-13,1021
6753,龍德造船,26,5,21,合庫-台中,2023-04-13,1021
5258,虹堡,40,20,20,合庫-台中,2023-04-13,1021
00674R,期元大S＆P黃金反1,20,0,20,合庫-台中,2023-04-13,1021
3545,敦泰,26,6,20,合庫-台中,2023-04-13,1021
2312,金寶,20,0,20,合庫-台中,2023-04-13,1021
6182,合晶,26,6,20,合庫-台中,2023-04-13,1021
1722,台肥,20,0,20,合庫-台中,2023-04-13,1021
00751B,元大AAA至A公司債,19,0,19,合庫-台中,2023-04-13,1021
00922,國泰台灣領袖50,19,0,19,合庫-台中,2023-04-13,1021
4934,太極,18,0,18,合庫-台中,2023-04-13,1021
2331,精英,19,2,17,合庫-台中,2023-04-13,1021
3499,環天科,20,3,17,合庫-台中,2023-04-13,1021
6229,研通,19,3,16,合庫-台中,2023-04-13,1021
00905,FT臺灣Smart,31,15,16,合庫-台中,2023-04-13,1021
9928,中視,15,0,15,合庫-台中,2023-04-13,1021
5465,富驊,19,4,15,合庫-台中,2023-04-13,1021
3523,迎輝,154,139,15,合庫-台中,2023-04-13,1021
9914,美利達,15,0,15,合庫-台中,2023-04-13,1021
5309,系統電,24,10,14,合庫-台中,2023-04-13,1021
1519,華城,39,25,14,合庫-台中,2023-04-13,1021
3034,聯詠,14,0,14,合庫-台中,2023-04-13,1021
00632R,元大台灣50反1,443,0,443,合庫-台中,2023-04-14,1021
2438,翔耀,110,0,110,合庫-台中,2023-04-14,1021
2609,陽明,117,27,90,合庫-台中,2023-04-14,1021
2208,台船,122,45,77,合庫-台中,2023-04-14,1021
00679B,元大美債20年,92,21,71,合庫-台中,2023-04-14,1021
00757,統一FANG+,60,0,60,合庫-台中,2023-04-14,1021
6243,迅杰,49,2,47,合庫-台中,2023-04-14,1021
3494,誠研,45,0,45,合庫-台中,2023-04-14,1021
00712,復華富時不動產,45,0,45,合庫-台中,2023-04-14,1021
2002,中鋼,51,6,45,合庫-台中,2023-04-14,1021
1423,利華,44,1,43,合庫-台中,2023-04-14,1021
2337,旺宏,39,0,39,合庫-台中,2023-04-14,1021
4908,前鼎,40,4,36,合庫-台中,2023-04-14,1021
4541,晟田,59,23,36,合庫-台中,2023-04-14,1021
8222,寶一,155,120,35,合庫-台中,2023-04-14,1021
00715L,期街口布蘭特正2,55,20,35,合庫-台中,2023-04-14,1021
00687B,國泰20年美債,33,0,33,合庫-台中,2023-04-14,1021
1108,幸福,63,30,33,合庫-台中,2023-04-14,1021
7402,邑錡,41,8,33,合庫-台中,2023-04-14,1021
3481,群創,239,208,31,合庫-台中,2023-04-14,1021
5009,榮剛,61,31,30,合庫-台中,2023-04-14,1021
3499,環天科,30,0,30,合庫-台中,2023-04-14,1021
1608,華榮,31,2,29,合庫-台中,2023-04-14,1021
2382,廣達,28,0,28,合庫-台中,2023-04-14,1021
8926,台汽電,27,2,25,合庫-台中,2023-04-14,1021
3594,磐儀,27,2,25,合庫-台中,2023-04-14,1021
4129,聯合,25,0,25,合庫-台中,2023-04-14,1021
00773B,中信優先金融債,31,7,24,合庫-台中,2023-04-14,1021
9105,泰金寶-DR,34,11,23,合庫-台中,2023-04-14,1021
2344,華邦電,50,27,23,合庫-台中,2023-04-14,1021
00680L,元大美債20正2,22,0,22,合庫-台中,2023-04-14,1021
3014,聯陽,21,0,21,合庫-台中,2023-04-14,1021
6112,邁達特,27,7,20,合庫-台中,2023-04-14,1021
3003,健和興,24,4,20,合庫-台中,2023-04-14,1021
1513,中興電,34,15,19,合庫-台中,2023-04-14,1021
2887,台新金,32,14,18,合庫-台中,2023-04-14,1021
3380,明泰,23,5,18,合庫-台中,2023-04-14,1021
00772B,中信高評級公司債,18,0,18,合庫-台中,2023-04-14,1021
6829,千附精密,19,1,18,合庫-台中,2023-04-14,1021
1219,福壽,20,3,17,合庫-台中,2023-04-14,1021
8936,國統,34,17,17,合庫-台中,2023-04-14,1021
2302,麗正,28,12,16,合庫-台中,2023-04-14,1021
00761B,國泰A級公司債,15,0,15,合庫-台中,2023-04-14,1021
2358,廷鑫,16,1,15,合庫-台中,2023-04-14,1021
3545,敦泰,45,30,15,合庫-台中,2023-04-14,1021
2883,凱基金,32,17,15,合庫-台中,2023-04-14,1021
8383,千附,24,10,14,合庫-台中,2023-04-14,1021
2356,英業達,20,6,14,合庫-台中,2023-04-14,1021
00885,富邦越南,13,0,13,合庫-台中,2023-04-14,1021
1618,合機,17,4,13,合庫-台中,2023-04-14,1021
00665L,富邦�琤肭磪囓�2,243,10,233,合庫-台中,2023-04-17,1021
00712,復華富時不動產,234,14,220,合庫-台中,2023-04-17,1021
2603,長榮,237,32,205,合庫-台中,2023-04-17,1021
2880,華南金,206,2,204,合庫-台中,2023-04-17,1021
3231,緯創,378,247,131,合庫-台中,2023-04-17,1021
00679B,元大美債20年,121,0,121,合庫-台中,2023-04-17,1021
1514,亞力,126,12,114,合庫-台中,2023-04-17,1021
2884,玉山金,117,6,111,合庫-台中,2023-04-17,1021
2387,精元,109,0,109,合庫-台中,2023-04-17,1021
00715L,期街口布蘭特正2,100,0,100,合庫-台中,2023-04-17,1021
2885,元大金,100,6,94,合庫-台中,2023-04-17,1021
8033,雷虎,118,29,89,合庫-台中,2023-04-17,1021
2596,綠意,71,0,71,合庫-台中,2023-04-17,1021
2883,凱基金,58,9,49,合庫-台中,2023-04-17,1021
3058,立德,56,8,48,合庫-台中,2023-04-17,1021
6416,瑞祺電通,44,0,44,合庫-台中,2023-04-17,1021
3062,建漢,44,1,43,合庫-台中,2023-04-17,1021
2208,台船,118,77,41,合庫-台中,2023-04-17,1021
2002,中鋼,44,2,42,合庫-台中,2023-04-17,1021
3046,建��,99,58,41,合庫-台中,2023-04-17,1021
9105,泰金寶-DR,40,0,40,合庫-台中,2023-04-17,1021
1504,東元,102,64,38,合庫-台中,2023-04-17,1021
00669R,國泰美國道瓊反1,35,0,35,合庫-台中,2023-04-17,1021
00673R,期元大S＆P原油反1,30,0,30,合庫-台中,2023-04-17,1021
2312,金寶,141,111,30,合庫-台中,2023-04-17,1021
2610,華航,48,21,27,合庫-台中,2023-04-17,1021
6116,彩晶,66,40,26,合庫-台中,2023-04-17,1021
5009,榮剛,74,48,26,合庫-台中,2023-04-17,1021
2382,廣達,27,2,25,合庫-台中,2023-04-17,1021
5371,中光電,60,35,25,合庫-台中,2023-04-17,1021
00888,永豐台灣ESG,23,0,23,合庫-台中,2023-04-17,1021
3356,奇偶,22,0,22,合庫-台中,2023-04-17,1021
2834,臺企銀,23,1,22,合庫-台中,2023-04-17,1021
2449,京元電子,27,6,21,合庫-台中,2023-04-17,1021
2337,旺宏,30,9,21,合庫-台中,2023-04-17,1021
00878,國泰永續高股息,34,14,20,合庫-台中,2023-04-17,1021
2317,鴻海,27,8,19,合庫-台中,2023-04-17,1021
6180,橘子,22,3,19,合庫-台中,2023-04-17,1021
1584,精剛,44,25,19,合庫-台中,2023-04-17,1021
00720B,元大投資級公司債,19,0,19,合庫-台中,2023-04-17,1021
6163,華電網,36,18,18,合庫-台中,2023-04-17,1021
4129,聯合,17,0,17,合庫-台中,2023-04-17,1021
00772B,中信高評級公司債,17,0,17,合庫-台中,2023-04-17,1021
1219,福壽,20,3,17,合庫-台中,2023-04-17,1021
6547,高端疫苗,31,14,17,合庫-台中,2023-04-17,1021
00680L,元大美債20正2,16,0,16,合庫-台中,2023-04-17,1021
2454,聯發科,23,8,15,合庫-台中,2023-04-17,1021
00773B,中信優先金融債,15,0,15,合庫-台中,2023-04-17,1021
1417,嘉裕,25,10,15,合庫-台中,2023-04-17,1021
4904,遠傳,16,1,15,合庫-台中,2023-04-17,1021
1609,大亞,339,69,270,合庫-台中,2023-04-18,1021
00679B,元大美債20年,193,2,191,合庫-台中,2023-04-18,1021
1514,亞力,188,22,166,合庫-台中,2023-04-18,1021
3305,昇貿,167,14,153,合庫-台中,2023-04-18,1021
4127,天良,141,0,141,合庫-台中,2023-04-18,1021
00720B,元大投資級公司債,126,3,123,合庫-台中,2023-04-18,1021
2609,陽明,225,124,101,合庫-台中,2023-04-18,1021
8033,雷虎,210,133,77,合庫-台中,2023-04-18,1021
1605,華新,103,32,71,合庫-台中,2023-04-18,1021
6282,康舒,144,75,69,合庫-台中,2023-04-18,1021
1618,合機,60,4,56,合庫-台中,2023-04-18,1021
3056,富華新,70,18,52,合庫-台中,2023-04-18,1021
00773B,中信優先金融債,51,0,51,合庫-台中,2023-04-18,1021
00878,國泰永續高股息,66,17,49,合庫-台中,2023-04-18,1021
5009,榮剛,86,39,47,合庫-台中,2023-04-18,1021
2457,飛宏,136,89,47,合庫-台中,2023-04-18,1021
6218,豪勉,53,7,46,合庫-台中,2023-04-18,1021
3231,緯創,72,27,45,合庫-台中,2023-04-18,1021
4167,松瑞藥,41,0,41,合庫-台中,2023-04-18,1021
3481,群創,69,28,41,合庫-台中,2023-04-18,1021
1789,神隆,36,0,36,合庫-台中,2023-04-18,1021
4129,聯合,36,0,36,合庫-台中,2023-04-18,1021
2312,金寶,73,38,35,合庫-台中,2023-04-18,1021
8105,凌巨,51,17,34,合庫-台中,2023-04-18,1021
1795,美時,38,5,33,合庫-台中,2023-04-18,1021
5450,南良,30,0,30,合庫-台中,2023-04-18,1021
1708,東鹼,30,0,30,合庫-台中,2023-04-18,1021
6235,華孚,81,52,29,合庫-台中,2023-04-18,1021
1584,精剛,131,103,28,合庫-台中,2023-04-18,1021
3518,柏騰,30,2,28,合庫-台中,2023-04-18,1021
00891,中信關鍵半導體,28,0,28,合庫-台中,2023-04-18,1021
4541,晟田,43,15,28,合庫-台中,2023-04-18,1021
3038,全台,33,6,27,合庫-台中,2023-04-18,1021
0056,元大高股息,31,6,25,合庫-台中,2023-04-18,1021
1447,力鵬,25,0,25,合庫-台中,2023-04-18,1021
5465,富驊,46,21,25,合庫-台中,2023-04-18,1021
2337,旺宏,25,0,25,合庫-台中,2023-04-18,1021
2105,正新,24,0,24,合庫-台中,2023-04-18,1021
00680L,元大美債20正2,22,0,22,合庫-台中,2023-04-18,1021
2637,慧洋-KY,22,0,22,合庫-台中,2023-04-18,1021
6142,友勁,26,4,22,合庫-台中,2023-04-18,1021
00772B,中信高評級公司債,22,0,22,合庫-台中,2023-04-18,1021
2419,仲琦,31,10,21,合庫-台中,2023-04-18,1021
00687B,國泰20年美債,20,0,20,合庫-台中,2023-04-18,1021
3499,環天科,20,0,20,合庫-台中,2023-04-18,1021
6829,千附精密,29,9,20,合庫-台中,2023-04-18,1021
3419,譁裕,20,0,20,合庫-台中,2023-04-18,1021
1810,和成,24,4,20,合庫-台中,2023-04-18,1021
2883,凱基金,27,8,19,合庫-台中,2023-04-18,1021
6203,海韻電,20,1,19,合庫-台中,2023-04-18,1021
1514,亞力,143,9,134,合庫-台中,2023-04-19,1021
00632R,元大台灣50反1,121,1,120,合庫-台中,2023-04-19,1021
2888,新光金,113,0,113,合庫-台中,2023-04-19,1021
2515,中工,112,11,101,合庫-台中,2023-04-19,1021
00679B,元大美債20年,97,0,97,合庫-台中,2023-04-19,1021
1810,和成,119,34,85,合庫-台中,2023-04-19,1021
2596,綠意,77,2,75,合庫-台中,2023-04-19,1021
2883,凱基金,75,1,74,合庫-台中,2023-04-19,1021
3481,群創,243,181,62,合庫-台中,2023-04-19,1021
1584,精剛,107,53,54,合庫-台中,2023-04-19,1021
1618,合機,53,0,53,合庫-台中,2023-04-19,1021
2498,宏達電,87,35,52,合庫-台中,2023-04-19,1021
2885,元大金,51,0,51,合庫-台中,2023-04-19,1021
6770,力積電,65,22,43,合庫-台中,2023-04-19,1021
2457,飛宏,98,57,41,合庫-台中,2023-04-19,1021
00637L,元大滬深300正2,41,0,41,合庫-台中,2023-04-19,1021
2402,毅嘉,61,20,41,合庫-台中,2023-04-19,1021
2201,裕隆,66,26,40,合庫-台中,2023-04-19,1021
00712,復華富時不動產,40,2,38,合庫-台中,2023-04-19,1021
8028,昇陽半導體,35,3,32,合庫-台中,2023-04-19,1021
5704,老爺知,33,1,32,合庫-台中,2023-04-19,1021
2208,台船,54,23,31,合庫-台中,2023-04-19,1021
1444,力麗,69,39,30,合庫-台中,2023-04-19,1021
4123,晟德,34,4,30,合庫-台中,2023-04-19,1021
2312,金寶,49,21,28,合庫-台中,2023-04-19,1021
2317,鴻海,41,13,28,合庫-台中,2023-04-19,1021
3003,健和興,30,3,27,合庫-台中,2023-04-19,1021
0056,元大高股息,33,6,27,合庫-台中,2023-04-19,1021
3056,富華新,58,31,27,合庫-台中,2023-04-19,1021
3037,欣興,31,5,26,合庫-台中,2023-04-19,1021
2338,光罩,27,2,25,合庫-台中,2023-04-19,1021
2887,台新金,50,25,25,合庫-台中,2023-04-19,1021
2387,精元,25,0,25,合庫-台中,2023-04-19,1021
00923,群益台ESG低碳50,25,0,25,合庫-台中,2023-04-19,1021
3231,緯創,134,109,25,合庫-台中,2023-04-19,1021
2614,東森,30,6,24,合庫-台中,2023-04-19,1021
6116,彩晶,41,17,24,合庫-台中,2023-04-19,1021
2454,聯發科,43,19,24,合庫-台中,2023-04-19,1021
3545,敦泰,30,7,23,合庫-台中,2023-04-19,1021
00891,中信關鍵半導體,22,0,22,合庫-台中,2023-04-19,1021
2438,翔耀,22,0,22,合庫-台中,2023-04-19,1021
2330,台積電,26,4,22,合庫-台中,2023-04-19,1021
3588,通嘉,22,1,21,合庫-台中,2023-04-19,1021
2363,矽統,28,7,21,合庫-台中,2023-04-19,1021
6218,豪勉,24,3,21,合庫-台中,2023-04-19,1021
6235,華孚,66,46,20,合庫-台中,2023-04-19,1021
00665L,富邦�琤肭磪囓�2,25,5,20,合庫-台中,2023-04-19,1021
2206,三陽工業,23,3,20,合庫-台中,2023-04-19,1021
8105,凌巨,20,0,20,合庫-台中,2023-04-19,1021
8069,元太,22,3,19,合庫-台中,2023-04-19,1021
00632R,元大台灣50反1,541,31,510,合庫-台中,2023-04-20,1021
00637L,元大滬深300正2,174,2,172,合庫-台中,2023-04-20,1021
2014,中鴻,111,4,107,合庫-台中,2023-04-20,1021
3576,聯合再生,120,27,93,合庫-台中,2023-04-20,1021
00715L,期街口布蘭特正2,121,30,91,合庫-台中,2023-04-20,1021
2409,友達,106,29,77,合庫-台中,2023-04-20,1021
2351,順德,75,6,69,合庫-台中,2023-04-20,1021
00679B,元大美債20年,95,27,68,合庫-台中,2023-04-20,1021
3162,精確,59,0,59,合庫-台中,2023-04-20,1021
00665L,富邦�琤肭磪囓�2,63,4,59,合庫-台中,2023-04-20,1021
2498,宏達電,74,19,55,合庫-台中,2023-04-20,1021
4934,太極,58,7,51,合庫-台中,2023-04-20,1021
2885,元大金,51,1,50,合庫-台中,2023-04-20,1021
3236,千如,50,0,50,合庫-台中,2023-04-20,1021
6244,茂迪,96,47,49,合庫-台中,2023-04-20,1021
2312,金寶,70,22,48,合庫-台中,2023-04-20,1021
2834,臺企銀,58,12,46,合庫-台中,2023-04-20,1021
3056,富華新,55,9,46,合庫-台中,2023-04-20,1021
6282,康舒,263,218,45,合庫-台中,2023-04-20,1021
6443,元晶,89,46,43,合庫-台中,2023-04-20,1021
00878,國泰永續高股息,157,114,43,合庫-台中,2023-04-20,1021
1314,中石化,68,25,43,合庫-台中,2023-04-20,1021
3518,柏騰,42,0,42,合庫-台中,2023-04-20,1021
1514,亞力,46,5,41,合庫-台中,2023-04-20,1021
00891,中信關鍵半導體,38,0,38,合庫-台中,2023-04-20,1021
2888,新光金,37,1,36,合庫-台中,2023-04-20,1021
4552,力達-KY,34,0,34,合庫-台中,2023-04-20,1021
1802,台玻,34,0,34,合庫-台中,2023-04-20,1021
2105,正新,34,1,33,合庫-台中,2023-04-20,1021
2618,長榮航,41,8,33,合庫-台中,2023-04-20,1021
00888,永豐台灣ESG,35,3,32,合庫-台中,2023-04-20,1021
3047,訊舟,36,5,31,合庫-台中,2023-04-20,1021
5522,遠雄,30,0,30,合庫-台中,2023-04-20,1021
2471,資通,49,19,30,合庫-台中,2023-04-20,1021
1447,力鵬,30,0,30,合庫-台中,2023-04-20,1021
1608,華榮,32,2,30,合庫-台中,2023-04-20,1021
2890,永豐金,30,0,30,合庫-台中,2023-04-20,1021
6288,聯嘉,45,17,28,合庫-台中,2023-04-20,1021
2444,兆勁,28,0,28,合庫-台中,2023-04-20,1021
5371,中光電,31,3,28,合庫-台中,2023-04-20,1021
8033,雷虎,36,9,27,合庫-台中,2023-04-20,1021
3322,建舜電,37,10,27,合庫-台中,2023-04-20,1021
3221,台嘉碩,26,0,26,合庫-台中,2023-04-20,1021
2603,長榮,60,34,26,合庫-台中,2023-04-20,1021
3078,僑威,47,22,25,合庫-台中,2023-04-20,1021
5531,鄉林,25,0,25,合庫-台中,2023-04-20,1021
1718,中纖,25,0,25,合庫-台中,2023-04-20,1021
2645,長榮航太,33,9,24,合庫-台中,2023-04-20,1021
2515,中工,32,8,24,合庫-台中,2023-04-20,1021
6203,海韻電,24,0,24,合庫-台中,2023-04-20,1021
00632R,元大台灣50反1,582,65,517,合庫-台中,2023-04-21,1021
00676R,富邦臺灣加權反1,316,0,316,合庫-台中,2023-04-21,1021
00665L,富邦�琤肭磪囓�2,239,6,233,合庫-台中,2023-04-21,1021
1907,永豐餘,176,42,134,合庫-台中,2023-04-21,1021
6288,聯嘉,114,2,112,合庫-台中,2023-04-21,1021
3221,台嘉碩,110,0,110,合庫-台中,2023-04-21,1021
2337,旺宏,90,0,90,合庫-台中,2023-04-21,1021
00637L,元大滬深300正2,143,60,83,合庫-台中,2023-04-21,1021
00715L,期街口布蘭特正2,89,10,79,合庫-台中,2023-04-21,1021
2618,長榮航,78,0,78,合庫-台中,2023-04-21,1021
2884,玉山金,83,7,76,合庫-台中,2023-04-21,1021
2515,中工,81,21,60,合庫-台中,2023-04-21,1021
00720B,元大投資級公司債,58,3,55,合庫-台中,2023-04-21,1021
4129,聯合,54,0,54,合庫-台中,2023-04-21,1021
4931,新盛力,65,13,52,合庫-台中,2023-04-21,1021
2845,遠東銀,50,0,50,合庫-台中,2023-04-21,1021
2313,華通,44,0,44,合庫-台中,2023-04-21,1021
2601,益航,43,1,42,合庫-台中,2023-04-21,1021
2444,兆勁,40,0,40,合庫-台中,2023-04-21,1021
00772B,中信高評級公司債,38,1,37,合庫-台中,2023-04-21,1021
1718,中纖,36,0,36,合庫-台中,2023-04-21,1021
2351,順德,33,0,33,合庫-台中,2023-04-21,1021
6188,廣明,32,2,30,合庫-台中,2023-04-21,1021
4541,晟田,32,2,30,合庫-台中,2023-04-21,1021
8054,安國,30,0,30,合庫-台中,2023-04-21,1021
0056,元大高股息,83,55,28,合庫-台中,2023-04-21,1021
2419,仲琦,28,0,28,合庫-台中,2023-04-21,1021
5243,乙盛-KY,41,14,27,合庫-台中,2023-04-21,1021
00712,復華富時不動產,34,8,26,合庫-台中,2023-04-21,1021
2208,台船,40,15,25,合庫-台中,2023-04-21,1021
1711,永光,27,2,25,合庫-台中,2023-04-21,1021
2603,長榮,37,12,25,合庫-台中,2023-04-21,1021
6125,廣運,27,3,24,合庫-台中,2023-04-21,1021
2387,精元,24,0,24,合庫-台中,2023-04-21,1021
1522,堤維西,29,5,24,合庫-台中,2023-04-21,1021
2645,長榮航太,25,1,24,合庫-台中,2023-04-21,1021
00900,富邦特選高股息30,27,4,23,合庫-台中,2023-04-21,1021
3078,僑威,32,9,23,合庫-台中,2023-04-21,1021
3162,精確,23,0,23,合庫-台中,2023-04-21,1021
00878,國泰永續高股息,68,45,23,合庫-台中,2023-04-21,1021
5469,瀚宇博,25,3,22,合庫-台中,2023-04-21,1021
1447,力鵬,21,0,21,合庫-台中,2023-04-21,1021
8050,廣積,21,0,21,合庫-台中,2023-04-21,1021
6163,華電網,87,66,21,合庫-台中,2023-04-21,1021
2107,厚生,20,0,20,合庫-台中,2023-04-21,1021
1471,首利,21,1,20,合庫-台中,2023-04-21,1021
6156,松上,20,0,20,合庫-台中,2023-04-21,1021
8028,昇陽半導體,21,2,19,合庫-台中,2023-04-21,1021
3308,聯德,20,2,18,合庫-台中,2023-04-21,1021
2498,宏達電,29,11,18,合庫-台中,2023-04-21,1021
00637L,元大滬深300正2,228,47,181,合庫-台中,2023-04-24,1021
2913,農林,196,25,171,合庫-台中,2023-04-24,1021
00665L,富邦�琤肭磪囓�2,177,7,170,合庫-台中,2023-04-24,1021
2880,華南金,100,8,92,合庫-台中,2023-04-24,1021
1905,華紙,120,35,85,合庫-台中,2023-04-24,1021
2413,環科,70,2,68,合庫-台中,2023-04-24,1021
00715L,期街口布蘭特正2,73,15,58,合庫-台中,2023-04-24,1021
2438,翔耀,50,0,50,合庫-台中,2023-04-24,1021
00902,中信電池及儲能,40,0,40,合庫-台中,2023-04-24,1021
1312,國喬,40,1,39,合庫-台中,2023-04-24,1021
4513,福裕,38,0,38,合庫-台中,2023-04-24,1021
00878,國泰永續高股息,52,15,37,合庫-台中,2023-04-24,1021
2313,華通,45,8,37,合庫-台中,2023-04-24,1021
00680L,元大美債20正2,35,0,35,合庫-台中,2023-04-24,1021
00679B,元大美債20年,59,27,32,合庫-台中,2023-04-24,1021
4741,泓瀚,53,21,32,合庫-台中,2023-04-24,1021
00900,富邦特選高股息30,31,0,31,合庫-台中,2023-04-24,1021
3447,展達,29,0,29,合庫-台中,2023-04-24,1021
3027,盛達,30,3,27,合庫-台中,2023-04-24,1021
8038,長園科,27,0,27,合庫-台中,2023-04-24,1021
1504,東元,47,20,27,合庫-台中,2023-04-24,1021
1909,榮成,30,5,25,合庫-台中,2023-04-24,1021
6168,宏齊,23,0,23,合庫-台中,2023-04-24,1021
6257,矽格,23,1,22,合庫-台中,2023-04-24,1021
8222,寶一,23,1,22,合庫-台中,2023-04-24,1021
1584,精剛,33,12,21,合庫-台中,2023-04-24,1021
00633L,富邦上証正2,21,0,21,合庫-台中,2023-04-24,1021
2457,飛宏,28,8,20,合庫-台中,2023-04-24,1021
6288,聯嘉,22,2,20,合庫-台中,2023-04-24,1021
2610,華航,30,10,20,合庫-台中,2023-04-24,1021
4934,太極,21,2,19,合庫-台中,2023-04-24,1021
3231,緯創,67,48,19,合庫-台中,2023-04-24,1021
2027,大成鋼,18,0,18,合庫-台中,2023-04-24,1021
6116,彩晶,19,1,18,合庫-台中,2023-04-24,1021
0056,元大高股息,43,25,18,合庫-台中,2023-04-24,1021
1101,台泥,91,73,18,合庫-台中,2023-04-24,1021
2010,春源,17,0,17,合庫-台中,2023-04-24,1021
3712,永崴投控,19,2,17,合庫-台中,2023-04-24,1021
3576,聯合再生,22,5,17,合庫-台中,2023-04-24,1021
2330,台積電,22,5,17,合庫-台中,2023-04-24,1021
2303,聯電,31,15,16,合庫-台中,2023-04-24,1021
4121,優盛,16,0,16,合庫-台中,2023-04-24,1021
2618,長榮航,28,12,16,合庫-台中,2023-04-24,1021
3025,星通,16,0,16,合庫-台中,2023-04-24,1021
2107,厚生,15,0,15,合庫-台中,2023-04-24,1021
3058,立德,37,22,15,合庫-台中,2023-04-24,1021
00891,中信關鍵半導體,15,0,15,合庫-台中,2023-04-24,1021
4541,晟田,15,0,15,合庫-台中,2023-04-24,1021
2409,友達,25,11,14,合庫-台中,2023-04-24,1021
2353,宏��,16,2,14,合庫-台中,2023-04-24,1021
2409,友達,355,31,324,合庫-台中,2023-04-25,1021
00878,國泰永續高股息,336,73,263,合庫-台中,2023-04-25,1021
00632R,元大台灣50反1,476,263,213,合庫-台中,2023-04-25,1021
2014,中鴻,209,1,208,合庫-台中,2023-04-25,1021
2317,鴻海,181,15,166,合庫-台中,2023-04-25,1021
0056,元大高股息,145,11,134,合庫-台中,2023-04-25,1021
1101,台泥,159,66,93,合庫-台中,2023-04-25,1021
2303,聯電,123,31,92,合庫-台中,2023-04-25,1021
4960,誠美材,94,7,87,合庫-台中,2023-04-25,1021
2337,旺宏,86,1,85,合庫-台中,2023-04-25,1021
2634,漢翔,267,197,70,合庫-台中,2023-04-25,1021
6282,康舒,190,129,61,合庫-台中,2023-04-25,1021
8383,千附,59,4,55,合庫-台中,2023-04-25,1021
1310,台苯,139,86,53,合庫-台中,2023-04-25,1021
2408,南亞科,55,5,50,合庫-台中,2023-04-25,1021
2867,三商壽,60,10,50,合庫-台中,2023-04-25,1021
6234,高僑,49,0,49,合庫-台中,2023-04-25,1021
3027,盛達,60,12,48,合庫-台中,2023-04-25,1021
00900,富邦特選高股息30,49,2,47,合庫-台中,2023-04-25,1021
3056,富華新,54,8,46,合庫-台中,2023-04-25,1021
3013,晟銘電,56,11,45,合庫-台中,2023-04-25,1021
2610,華航,62,18,44,合庫-台中,2023-04-25,1021
2438,翔耀,41,0,41,合庫-台中,2023-04-25,1021
3231,緯創,71,31,40,合庫-台中,2023-04-25,1021
4541,晟田,45,6,39,合庫-台中,2023-04-25,1021
2618,長榮航,49,10,39,合庫-台中,2023-04-25,1021
4114,健喬,53,15,38,合庫-台中,2023-04-25,1021
00715L,期街口布蘭特正2,52,15,37,合庫-台中,2023-04-25,1021
00902,中信電池及儲能,96,60,36,合庫-台中,2023-04-25,1021
2387,精元,37,1,36,合庫-台中,2023-04-25,1021
2444,兆勁,35,0,35,合庫-台中,2023-04-25,1021
6209,今國光,49,15,34,合庫-台中,2023-04-25,1021
0050,元大台灣50,34,1,33,合庫-台中,2023-04-25,1021
00713,元大台灣高息低波,33,1,32,合庫-台中,2023-04-25,1021
2515,中工,36,4,32,合庫-台中,2023-04-25,1021
6806,森崴能源,50,19,31,合庫-台中,2023-04-25,1021
1611,中電,29,1,28,合庫-台中,2023-04-25,1021
6443,元晶,33,6,27,合庫-台中,2023-04-25,1021
3221,台嘉碩,27,0,27,合庫-台中,2023-04-25,1021
2344,華邦電,47,20,27,合庫-台中,2023-04-25,1021
6284,佳邦,28,1,27,合庫-台中,2023-04-25,1021
2358,廷鑫,27,1,26,合庫-台中,2023-04-25,1021
1504,東元,35,9,26,合庫-台中,2023-04-25,1021
4931,新盛力,37,11,26,合庫-台中,2023-04-25,1021
3481,群創,28,3,25,合庫-台中,2023-04-25,1021
00888,永豐台灣ESG,24,0,24,合庫-台中,2023-04-25,1021
2457,飛宏,41,18,23,合庫-台中,2023-04-25,1021
2375,凱美,29,7,22,合庫-台中,2023-04-25,1021
3037,欣興,33,12,21,合庫-台中,2023-04-25,1021
2002,中鋼,33,12,21,合庫-台中,2023-04-25,1021
00632R,元大台灣50反1,1105,169,936,合庫-台中,2023-04-26,1021
1445,大宇,163,0,163,合庫-台中,2023-04-26,1021
00715L,期街口布蘭特正2,101,0,101,合庫-台中,2023-04-26,1021
00666R,富邦�琤肭磪齯�1,99,0,99,合庫-台中,2023-04-26,1021
00712,復華富時不動產,74,4,70,合庫-台中,2023-04-26,1021
1314,中石化,73,23,50,合庫-台中,2023-04-26,1021
00669R,國泰美國道瓊反1,50,4,46,合庫-台中,2023-04-26,1021
2610,華航,50,14,36,合庫-台中,2023-04-26,1021
4541,晟田,38,3,35,合庫-台中,2023-04-26,1021
8222,寶一,80,45,35,合庫-台中,2023-04-26,1021
2481,強茂,32,1,31,合庫-台中,2023-04-26,1021
2609,陽明,35,5,30,合庫-台中,2023-04-26,1021
3481,群創,126,103,23,合庫-台中,2023-04-26,1021
2002,中鋼,23,2,21,合庫-台中,2023-04-26,1021
00720B,元大投資級公司債,21,0,21,合庫-台中,2023-04-26,1021
2337,旺宏,44,23,21,合庫-台中,2023-04-26,1021
00679B,元大美債20年,35,15,20,合庫-台中,2023-04-26,1021
2330,台積電,31,10,21,合庫-台中,2023-04-26,1021
4109,加捷生醫,20,0,20,合庫-台中,2023-04-26,1021
1464,得力,20,0,20,合庫-台中,2023-04-26,1021
00751B,元大AAA至A公司債,19,0,19,合庫-台中,2023-04-26,1021
1718,中纖,19,0,19,合庫-台中,2023-04-26,1021
4919,新唐,28,9,19,合庫-台中,2023-04-26,1021
1101,台泥,41,25,16,合庫-台中,2023-04-26,1021
00916,國泰全球品牌50,16,0,16,合庫-台中,2023-04-26,1021
6024,群益期,15,0,15,合庫-台中,2023-04-26,1021
3711,日月光投控,24,9,15,合庫-台中,2023-04-26,1021
6244,茂迪,27,13,14,合庫-台中,2023-04-26,1021
2358,廷鑫,14,1,13,合庫-台中,2023-04-26,1021
2889,國票金,13,0,13,合庫-台中,2023-04-26,1021
6517,保勝光學,14,1,13,合庫-台中,2023-04-26,1021
4129,聯合,12,0,12,合庫-台中,2023-04-26,1021
8028,昇陽半導體,12,0,12,合庫-台中,2023-04-26,1021
2913,農林,16,4,12,合庫-台中,2023-04-26,1021
2312,金寶,52,40,12,合庫-台中,2023-04-26,1021
2429,銘旺科,12,0,12,合庫-台中,2023-04-26,1021
3011,今皓,12,0,12,合庫-台中,2023-04-26,1021
00683L,期元大美元指正2,11,0,11,合庫-台中,2023-04-26,1021
1584,精剛,10,0,10,合庫-台中,2023-04-26,1021
1710,東聯,29,19,10,合庫-台中,2023-04-26,1021
8215,明基材,10,0,10,合庫-台中,2023-04-26,1021
2492,華新科,10,0,10,合庫-台中,2023-04-26,1021
3499,環天科,11,1,10,合庫-台中,2023-04-26,1021
00753L,中信中國50正2,20,10,10,合庫-台中,2023-04-26,1021
9105,泰金寶-DR,10,0,10,合庫-台中,2023-04-26,1021
2645,長榮航太,15,5,10,合庫-台中,2023-04-26,1021
2340,台亞,10,0,10,合庫-台中,2023-04-26,1021
1517,利奇,10,0,10,合庫-台中,2023-04-26,1021
9958,世紀鋼,10,0,10,合庫-台中,2023-04-26,1021
5340,建榮,10,0,10,合庫-台中,2023-04-26,1021
00715L,期街口布蘭特正2,312,6,306,合庫-台中,2023-04-27,1021
00679B,元大美債20年,161,71,90,合庫-台中,2023-04-27,1021
1905,華紙,155,71,84,合庫-台中,2023-04-27,1021
00642U,期元大S＆P石油,90,10,80,合庫-台中,2023-04-27,1021
2429,銘旺科,77,8,69,合庫-台中,2023-04-27,1021
2610,華航,129,63,66,合庫-台中,2023-04-27,1021
2438,翔耀,61,0,61,合庫-台中,2023-04-27,1021
1611,中電,59,1,58,合庫-台中,2023-04-27,1021
4108,懷特,56,5,51,合庫-台中,2023-04-27,1021
1721,三晃,94,43,51,合庫-台中,2023-04-27,1021
2344,華邦電,57,8,49,合庫-台中,2023-04-27,1021
2498,宏達電,52,5,47,合庫-台中,2023-04-27,1021
2208,台船,52,5,47,合庫-台中,2023-04-27,1021
00878,國泰永續高股息,58,14,44,合庫-台中,2023-04-27,1021
5880,合庫金,52,10,42,合庫-台中,2023-04-27,1021
1711,永光,94,54,40,合庫-台中,2023-04-27,1021
2887,台新金,45,5,40,合庫-台中,2023-04-27,1021
00665L,富邦�琤肭磪囓�2,39,0,39,合庫-台中,2023-04-27,1021
6116,彩晶,80,44,36,合庫-台中,2023-04-27,1021
1310,台苯,64,31,33,合庫-台中,2023-04-27,1021
2603,長榮,39,6,33,合庫-台中,2023-04-27,1021
2495,普安,35,3,32,合庫-台中,2023-04-27,1021
1314,中石化,32,0,32,合庫-台中,2023-04-27,1021
00712,復華富時不動產,37,5,32,合庫-台中,2023-04-27,1021
2002,中鋼,32,2,30,合庫-台中,2023-04-27,1021
3056,富華新,32,4,28,合庫-台中,2023-04-27,1021
4123,晟德,28,1,27,合庫-台中,2023-04-27,1021
9949,琉園,26,0,26,合庫-台中,2023-04-27,1021
2330,台積電,36,10,26,合庫-台中,2023-04-27,1021
2206,三陽工業,35,11,24,合庫-台中,2023-04-27,1021
3363,上詮,32,8,24,合庫-台中,2023-04-27,1021
3481,群創,84,61,23,合庫-台中,2023-04-27,1021
1760,寶齡富錦,25,2,23,合庫-台中,2023-04-27,1021
3058,立德,25,2,23,合庫-台中,2023-04-27,1021
4109,加捷生醫,20,0,20,合庫-台中,2023-04-27,1021
3015,全漢,20,0,20,合庫-台中,2023-04-27,1021
1108,幸福,24,4,20,合庫-台中,2023-04-27,1021
00720B,元大投資級公司債,20,0,20,合庫-台中,2023-04-27,1021
4566,時碩工業,23,3,20,合庫-台中,2023-04-27,1021
3037,欣興,23,3,20,合庫-台中,2023-04-27,1021
1503,士電,22,3,19,合庫-台中,2023-04-27,1021
1605,華新,28,10,18,合庫-台中,2023-04-27,1021
1710,東聯,48,31,17,合庫-台中,2023-04-27,1021
6753,龍德造船,16,2,14,合庫-台中,2023-04-27,1021
1101,台泥,39,25,14,合庫-台中,2023-04-27,1021
8085,福華,16,3,13,合庫-台中,2023-04-27,1021
2630,亞航,18,5,13,合庫-台中,2023-04-27,1021
0050,元大台灣50,15,2,13,合庫-台中,2023-04-27,1021
2891,中信金,18,6,12,合庫-台中,2023-04-27,1021
8033,雷虎,14,2,12,合庫-台中,2023-04-27,1021
2409,友達,248,8,240,合庫-台中,2023-04-28,1021
00632R,元大台灣50反1,601,455,146,合庫-台中,2023-04-28,1021
2352,佳世達,106,25,81,合庫-台中,2023-04-28,1021
1514,亞力,66,1,65,合庫-台中,2023-04-28,1021
6829,千附精密,70,12,58,合庫-台中,2023-04-28,1021
3481,群創,199,141,58,合庫-台中,2023-04-28,1021
1445,大宇,55,0,55,合庫-台中,2023-04-28,1021
4121,優盛,51,2,49,合庫-台中,2023-04-28,1021
00683L,期元大美元指正2,48,0,48,合庫-台中,2023-04-28,1021
2495,普安,53,11,42,合庫-台中,2023-04-28,1021
1727,中華化,90,54,36,合庫-台中,2023-04-28,1021
2462,良得電,35,0,35,合庫-台中,2023-04-28,1021
00715L,期街口布蘭特正2,44,9,35,合庫-台中,2023-04-28,1021
6116,彩晶,62,28,34,合庫-台中,2023-04-28,1021
4960,誠美材,30,0,30,合庫-台中,2023-04-28,1021
6142,友勁,31,2,29,合庫-台中,2023-04-28,1021
5880,合庫金,34,6,28,合庫-台中,2023-04-28,1021
6282,康舒,106,78,28,合庫-台中,2023-04-28,1021
4130,健亞,51,24,27,合庫-台中,2023-04-28,1021
00891,中信關鍵半導體,26,0,26,合庫-台中,2023-04-28,1021
1711,永光,43,17,26,合庫-台中,2023-04-28,1021
8403,盛弘,32,8,24,合庫-台中,2023-04-28,1021
00679B,元大美債20年,26,2,24,合庫-台中,2023-04-28,1021
00773B,中信優先金融債,22,0,22,合庫-台中,2023-04-28,1021
6180,橘子,23,1,22,合庫-台中,2023-04-28,1021
2312,金寶,21,0,21,合庫-台中,2023-04-28,1021
00772B,中信高評級公司債,20,0,20,合庫-台中,2023-04-28,1021
2614,東森,20,0,20,合庫-台中,2023-04-28,1021
4908,前鼎,20,0,20,合庫-台中,2023-04-28,1021
2511,太子,20,0,20,合庫-台中,2023-04-28,1021
00673R,期元大S＆P原油反1,26,6,20,合庫-台中,2023-04-28,1021
1718,中纖,20,0,20,合庫-台中,2023-04-28,1021
1584,精剛,23,4,19,合庫-台中,2023-04-28,1021
1907,永豐餘,29,11,18,合庫-台中,2023-04-28,1021
3231,緯創,26,9,17,合庫-台中,2023-04-28,1021
6712,長聖,17,1,16,合庫-台中,2023-04-28,1021
4763,材料-KY,18,2,16,合庫-台中,2023-04-28,1021
2603,長榮,22,6,16,合庫-台中,2023-04-28,1021
6290,良維,15,0,15,合庫-台中,2023-04-28,1021
4931,新盛力,15,0,15,合庫-台中,2023-04-28,1021
2201,裕隆,14,0,14,合庫-台中,2023-04-28,1021
1513,中興電,18,4,14,合庫-台中,2023-04-28,1021
2404,漢唐,15,2,13,合庫-台中,2023-04-28,1021
6470,宇智,13,0,13,合庫-台中,2023-04-28,1021
6770,力積電,24,11,13,合庫-台中,2023-04-28,1021
2303,聯電,74,62,12,合庫-台中,2023-04-28,1021
00902,中信電池及儲能,12,0,12,合庫-台中,2023-04-28,1021
2002,中鋼,14,2,12,合庫-台中,2023-04-28,1021
3596,智易,12,0,12,合庫-台中,2023-04-28,1021
2313,華通,40,28,12,合庫-台中,2023-04-28,1021
00878,國泰永續高股息,459,109,350,合庫-台中,2023-05-02,1021
00637L,元大滬深300正2,191,0,191,合庫-台中,2023-05-02,1021
00715L,期街口布蘭特正2,210,51,159,合庫-台中,2023-05-02,1021
1101,台泥,210,74,136,合庫-台中,2023-05-02,1021
00632R,元大台灣50反1,806,700,106,合庫-台中,2023-05-02,1021
2603,長榮,96,4,92,合庫-台中,2023-05-02,1021
00900,富邦特選高股息30,91,6,85,合庫-台中,2023-05-02,1021
1314,中石化,124,40,84,合庫-台中,2023-05-02,1021
4121,優盛,81,7,74,合庫-台中,2023-05-02,1021
2609,陽明,120,47,73,合庫-台中,2023-05-02,1021
00772B,中信高評級公司債,67,0,67,合庫-台中,2023-05-02,1021
00679B,元大美債20年,66,1,65,合庫-台中,2023-05-02,1021
3597,映興,57,0,57,合庫-台中,2023-05-02,1021
1727,中華化,57,6,51,合庫-台中,2023-05-02,1021
6234,高僑,62,14,48,合庫-台中,2023-05-02,1021
2208,台船,44,1,43,合庫-台中,2023-05-02,1021
2601,益航,43,3,40,合庫-台中,2023-05-02,1021
00669R,國泰美國道瓊反1,39,0,39,合庫-台中,2023-05-02,1021
2344,華邦電,37,4,33,合庫-台中,2023-05-02,1021
00683L,期元大美元指正2,31,0,31,合庫-台中,2023-05-02,1021
4931,新盛力,32,2,30,合庫-台中,2023-05-02,1021
2352,佳世達,53,24,29,合庫-台中,2023-05-02,1021
8093,保銳,30,1,29,合庫-台中,2023-05-02,1021
2884,玉山金,34,5,29,合庫-台中,2023-05-02,1021
2402,毅嘉,31,3,28,合庫-台中,2023-05-02,1021
1611,中電,51,23,28,合庫-台中,2023-05-02,1021
00773B,中信優先金融債,27,0,27,合庫-台中,2023-05-02,1021
1795,美時,49,22,27,合庫-台中,2023-05-02,1021
00680L,元大美債20正2,26,0,26,合庫-台中,2023-05-02,1021
2462,良得電,50,24,26,合庫-台中,2023-05-02,1021
1809,中釉,30,4,26,合庫-台中,2023-05-02,1021
00720B,元大投資級公司債,25,0,25,合庫-台中,2023-05-02,1021
1445,大宇,25,0,25,合庫-台中,2023-05-02,1021
2891,中信金,44,19,25,合庫-台中,2023-05-02,1021
3056,富華新,34,10,24,合庫-台中,2023-05-02,1021
3447,展達,22,0,22,合庫-台中,2023-05-02,1021
00751B,元大AAA至A公司債,20,0,20,合庫-台中,2023-05-02,1021
1447,力鵬,20,0,20,合庫-台中,2023-05-02,1021
6114,久威,20,0,20,合庫-台中,2023-05-02,1021
4513,福裕,20,0,20,合庫-台中,2023-05-02,1021
1802,台玻,43,23,20,合庫-台中,2023-05-02,1021
2471,資通,45,26,19,合庫-台中,2023-05-02,1021
2539,櫻花建,19,0,19,合庫-台中,2023-05-02,1021
00633L,富邦上証正2,18,0,18,合庫-台中,2023-05-02,1021
6148,驊宏資,31,13,18,合庫-台中,2023-05-02,1021
2515,中工,38,20,18,合庫-台中,2023-05-02,1021
4129,聯合,19,1,18,合庫-台中,2023-05-02,1021
2438,翔耀,15,0,15,合庫-台中,2023-05-02,1021
2482,連宇,32,17,15,合庫-台中,2023-05-02,1021
3664,安瑞-KY,15,0,15,合庫-台中,2023-05-02,1021
00878,國泰永續高股息,758,88,670,合庫-台中,2023-05-03,1021
00715L,期街口布蘭特正2,484,90,394,合庫-台中,2023-05-03,1021
00637L,元大滬深300正2,354,0,354,合庫-台中,2023-05-03,1021
00712,復華富時不動產,205,6,199,合庫-台中,2023-05-03,1021
00642U,期元大S＆P石油,173,1,172,合庫-台中,2023-05-03,1021
2891,中信金,217,48,169,合庫-台中,2023-05-03,1021
00665L,富邦�琤肭磪囓�2,167,0,167,合庫-台中,2023-05-03,1021
2609,陽明,218,67,151,合庫-台中,2023-05-03,1021
3481,群創,260,158,102,合庫-台中,2023-05-03,1021
1514,亞力,99,16,83,合庫-台中,2023-05-03,1021
2610,華航,77,17,60,合庫-台中,2023-05-03,1021
2603,長榮,75,16,59,合庫-台中,2023-05-03,1021
2801,彰銀,57,2,55,合庫-台中,2023-05-03,1021
2880,華南金,52,0,52,合庫-台中,2023-05-03,1021
6282,康舒,106,54,52,合庫-台中,2023-05-03,1021
2208,台船,51,0,51,合庫-台中,2023-05-03,1021
00720B,元大投資級公司債,50,0,50,合庫-台中,2023-05-03,1021
2886,兆豐金,51,7,44,合庫-台中,2023-05-03,1021
4129,聯合,44,2,42,合庫-台中,2023-05-03,1021
2905,三商,40,0,40,合庫-台中,2023-05-03,1021
2884,玉山金,57,20,37,合庫-台中,2023-05-03,1021
2409,友達,64,29,35,合庫-台中,2023-05-03,1021
6589,台康生技,74,39,35,合庫-台中,2023-05-03,1021
4108,懷特,36,1,35,合庫-台中,2023-05-03,1021
1528,恩德,35,0,35,合庫-台中,2023-05-03,1021
9945,潤泰新,32,0,32,合庫-台中,2023-05-03,1021
00683L,期元大美元指正2,31,0,31,合庫-台中,2023-05-03,1021
2105,正新,30,0,30,合庫-台中,2023-05-03,1021
2417,圓剛,43,13,30,合庫-台中,2023-05-03,1021
2303,聯電,33,5,28,合庫-台中,2023-05-03,1021
00772B,中信高評級公司債,26,0,26,合庫-台中,2023-05-03,1021
2337,旺宏,27,1,26,合庫-台中,2023-05-03,1021
1314,中石化,25,0,25,合庫-台中,2023-05-03,1021
00751B,元大AAA至A公司債,30,6,24,合庫-台中,2023-05-03,1021
5498,凱崴,24,0,24,合庫-台中,2023-05-03,1021
6288,聯嘉,30,7,23,合庫-台中,2023-05-03,1021
4541,晟田,82,60,22,合庫-台中,2023-05-03,1021
2462,良得電,25,5,20,合庫-台中,2023-05-03,1021
4121,優盛,44,24,20,合庫-台中,2023-05-03,1021
2352,佳世達,40,20,20,合庫-台中,2023-05-03,1021
2419,仲琦,23,3,20,合庫-台中,2023-05-03,1021
1609,大亞,29,10,19,合庫-台中,2023-05-03,1021
00753L,中信中國50正2,18,0,18,合庫-台中,2023-05-03,1021
4513,福裕,22,5,17,合庫-台中,2023-05-03,1021
2312,金寶,32,15,17,合庫-台中,2023-05-03,1021
6167,久正,29,13,16,合庫-台中,2023-05-03,1021
00650L,復華香港正2,16,0,16,合庫-台中,2023-05-03,1021
3632,研勤,16,0,16,合庫-台中,2023-05-03,1021
3324,雙鴻,18,3,15,合庫-台中,2023-05-03,1021
1519,華城,28,13,15,合庫-台中,2023-05-03,1021
00715L,期街口布蘭特正2,1101,210,891,合庫-台中,2023-05-04,1021
00878,國泰永續高股息,327,16,311,合庫-台中,2023-05-04,1021
2880,華南金,100,3,97,合庫-台中,2023-05-04,1021
2409,友達,104,12,92,合庫-台中,2023-05-04,1021
00673R,期元大S＆P原油反1,70,10,60,合庫-台中,2023-05-04,1021
2886,兆豐金,57,8,49,合庫-台中,2023-05-04,1021
00712,復華富時不動產,47,0,47,合庫-台中,2023-05-04,1021
2888,新光金,42,1,41,合庫-台中,2023-05-04,1021
4129,聯合,43,3,40,合庫-台中,2023-05-04,1021
00642U,期元大S＆P石油,130,94,36,合庫-台中,2023-05-04,1021
4513,福裕,35,0,35,合庫-台中,2023-05-04,1021
2208,台船,37,4,33,合庫-台中,2023-05-04,1021
00757,統一FANG+,33,0,33,合庫-台中,2023-05-04,1021
3715,定穎投控,31,0,31,合庫-台中,2023-05-04,1021
3056,富華新,44,14,30,合庫-台中,2023-05-04,1021
2634,漢翔,94,65,29,合庫-台中,2023-05-04,1021
2002,中鋼,29,1,28,合庫-台中,2023-05-04,1021
4541,晟田,29,3,26,合庫-台中,2023-05-04,1021
00772B,中信高評級公司債,36,10,26,合庫-台中,2023-05-04,1021
2609,陽明,29,4,25,合庫-台中,2023-05-04,1021
2601,益航,25,0,25,合庫-台中,2023-05-04,1021
8085,福華,32,9,23,合庫-台中,2023-05-04,1021
2884,玉山金,42,21,21,合庫-台中,2023-05-04,1021
3062,建漢,20,0,20,合庫-台中,2023-05-04,1021
2323,中環,20,0,20,合庫-台中,2023-05-04,1021
3236,千如,21,1,20,合庫-台中,2023-05-04,1021
2206,三陽工業,76,56,20,合庫-台中,2023-05-04,1021
1514,亞力,29,10,19,合庫-台中,2023-05-04,1021
1795,美時,51,32,19,合庫-台中,2023-05-04,1021
00720B,元大投資級公司債,18,0,18,合庫-台中,2023-05-04,1021
00670L,富邦NASDAQ正2,17,0,17,合庫-台中,2023-05-04,1021
8084,巨虹,18,1,17,合庫-台中,2023-05-04,1021
6218,豪勉,20,3,17,合庫-台中,2023-05-04,1021
3419,譁裕,35,19,16,合庫-台中,2023-05-04,1021
4960,誠美材,15,0,15,合庫-台中,2023-05-04,1021
6120,達運,15,0,15,合庫-台中,2023-05-04,1021
3712,永崴投控,28,13,15,合庫-台中,2023-05-04,1021
2107,厚生,15,0,15,合庫-台中,2023-05-04,1021
6167,久正,14,0,14,合庫-台中,2023-05-04,1021
00679B,元大美債20年,24,10,14,合庫-台中,2023-05-04,1021
4968,立積,19,6,13,合庫-台中,2023-05-04,1021
1584,精剛,13,0,13,合庫-台中,2023-05-04,1021
2905,三商,13,0,13,合庫-台中,2023-05-04,1021
3438,類比科,13,0,13,合庫-台中,2023-05-04,1021
2645,長榮航太,14,2,12,合庫-台中,2023-05-04,1021
4114,健喬,17,5,12,合庫-台中,2023-05-04,1021
6133,金橋,11,0,11,合庫-台中,2023-05-04,1021
6412,群電,11,0,11,合庫-台中,2023-05-04,1021
1710,東聯,18,7,11,合庫-台中,2023-05-04,1021
3046,建��,22,11,11,合庫-台中,2023-05-04,1021
00715L,期街口布蘭特正2,240,11,229,合庫-台中,2023-05-05,1021
00637L,元大滬深300正2,310,89,221,合庫-台中,2023-05-05,1021
00878,國泰永續高股息,233,15,218,合庫-台中,2023-05-05,1021
00642U,期元大S＆P石油,123,0,123,合庫-台中,2023-05-05,1021
2353,宏��,148,59,89,合庫-台中,2023-05-05,1021
00720B,元大投資級公司債,79,0,79,合庫-台中,2023-05-05,1021
00773B,中信優先金融債,60,0,60,合庫-台中,2023-05-05,1021
5356,協益,63,4,59,合庫-台中,2023-05-05,1021
00679B,元大美債20年,69,13,56,合庫-台中,2023-05-05,1021
00680L,元大美債20正2,55,0,55,合庫-台中,2023-05-05,1021
1445,大宇,53,0,53,合庫-台中,2023-05-05,1021
4108,懷特,52,1,51,合庫-台中,2023-05-05,1021
2313,華通,49,0,49,合庫-台中,2023-05-05,1021
00757,統一FANG+,49,1,48,合庫-台中,2023-05-05,1021
6234,高僑,82,44,38,合庫-台中,2023-05-05,1021
00772B,中信高評級公司債,38,0,38,合庫-台中,2023-05-05,1021
3481,群創,81,45,36,合庫-台中,2023-05-05,1021
00751B,元大AAA至A公司債,36,0,36,合庫-台中,2023-05-05,1021
2303,聯電,39,3,36,合庫-台中,2023-05-05,1021
6443,元晶,68,32,36,合庫-台中,2023-05-05,1021
4129,聯合,31,0,31,合庫-台中,2023-05-05,1021
2106,建大,31,0,31,合庫-台中,2023-05-05,1021
2885,元大金,122,91,31,合庫-台中,2023-05-05,1021
1101,台泥,38,9,29,合庫-台中,2023-05-05,1021
1609,大亞,98,69,29,合庫-台中,2023-05-05,1021
2515,中工,48,20,28,合庫-台中,2023-05-05,1021
1702,南僑,27,0,27,合庫-台中,2023-05-05,1021
5469,瀚宇博,28,2,26,合庫-台中,2023-05-05,1021
1513,中興電,37,13,24,合庫-台中,2023-05-05,1021
1504,東元,39,16,23,合庫-台中,2023-05-05,1021
1905,華紙,66,43,23,合庫-台中,2023-05-05,1021
2645,長榮航太,27,5,22,合庫-台中,2023-05-05,1021
1529,樂事綠能,55,33,22,合庫-台中,2023-05-05,1021
2344,華邦電,24,4,20,合庫-台中,2023-05-05,1021
8463,潤泰材,20,0,20,合庫-台中,2023-05-05,1021
1608,華榮,19,0,19,合庫-台中,2023-05-05,1021
2457,飛宏,33,14,19,合庫-台中,2023-05-05,1021
00891,中信關鍵半導體,25,6,19,合庫-台中,2023-05-05,1021
2002,中鋼,19,0,19,合庫-台中,2023-05-05,1021
00712,復華富時不動產,29,11,18,合庫-台中,2023-05-05,1021
5009,榮剛,51,35,16,合庫-台中,2023-05-05,1021
1310,台苯,18,3,15,合庫-台中,2023-05-05,1021
9949,琉園,17,2,15,合庫-台中,2023-05-05,1021
4513,福裕,15,0,15,合庫-台中,2023-05-05,1021
6244,茂迪,36,22,14,合庫-台中,2023-05-05,1021
4541,晟田,55,41,14,合庫-台中,2023-05-05,1021
2471,資通,32,18,14,合庫-台中,2023-05-05,1021
8215,明基材,25,12,13,合庫-台中,2023-05-05,1021
3494,誠研,13,0,13,合庫-台中,2023-05-05,1021
1802,台玻,13,0,13,合庫-台中,2023-05-05,1021
2891,中信金,233,40,193,合庫-台中,2023-05-08,1021
00632R,元大台灣50反1,212,32,180,合庫-台中,2023-05-08,1021
00751B,元大AAA至A公司債,108,0,108,合庫-台中,2023-05-08,1021
00720B,元大投資級公司債,83,0,83,合庫-台中,2023-05-08,1021
1605,華新,131,48,83,合庫-台中,2023-05-08,1021
3481,群創,87,30,57,合庫-台中,2023-05-08,1021
2887,台新金,122,66,56,合庫-台中,2023-05-08,1021
6589,台康生技,59,4,55,合庫-台中,2023-05-08,1021
2812,台中銀,52,2,50,合庫-台中,2023-05-08,1021
1314,中石化,40,0,40,合庫-台中,2023-05-08,1021
2883,凱基金,86,47,39,合庫-台中,2023-05-08,1021
4968,立積,46,7,39,合庫-台中,2023-05-08,1021
1810,和成,41,3,38,合庫-台中,2023-05-08,1021
5426,振發,37,0,37,合庫-台中,2023-05-08,1021
1708,東鹼,35,0,35,合庫-台中,2023-05-08,1021
2601,益航,35,0,35,合庫-台中,2023-05-08,1021
6111,大宇資,40,5,35,合庫-台中,2023-05-08,1021
2886,兆豐金,35,1,34,合庫-台中,2023-05-08,1021
00673R,期元大S＆P原油反1,88,55,33,合庫-台中,2023-05-08,1021
1802,台玻,33,0,33,合庫-台中,2023-05-08,1021
3664,安瑞-KY,32,0,32,合庫-台中,2023-05-08,1021
2734,易飛網,31,0,31,合庫-台中,2023-05-08,1021
2312,金寶,31,0,31,合庫-台中,2023-05-08,1021
00772B,中信高評級公司債,30,0,30,合庫-台中,2023-05-08,1021
5321,美而快,35,5,30,合庫-台中,2023-05-08,1021
3703,欣陸,32,3,29,合庫-台中,2023-05-08,1021
2344,華邦電,41,14,27,合庫-台中,2023-05-08,1021
9902,台火,23,0,23,合庫-台中,2023-05-08,1021
6125,廣運,25,4,21,合庫-台中,2023-05-08,1021
2888,新光金,23,2,21,合庫-台中,2023-05-08,1021
5483,中美晶,24,4,20,合庫-台中,2023-05-08,1021
1702,南僑,20,0,20,合庫-台中,2023-05-08,1021
2838,聯邦銀,20,0,20,合庫-台中,2023-05-08,1021
6446,藥華藥,21,2,19,合庫-台中,2023-05-08,1021
2745,五福,19,0,19,合庫-台中,2023-05-08,1021
2471,資通,46,27,19,合庫-台中,2023-05-08,1021
3029,零壹,38,20,18,合庫-台中,2023-05-08,1021
00679B,元大美債20年,18,0,18,合庫-台中,2023-05-08,1021
8404,百和興業-KY,17,0,17,合庫-台中,2023-05-08,1021
3038,全台,18,1,17,合庫-台中,2023-05-08,1021
4909,新復興,16,0,16,合庫-台中,2023-05-08,1021
4979,華星光,21,5,16,合庫-台中,2023-05-08,1021
1513,中興電,60,45,15,合庫-台中,2023-05-08,1021
00712,復華富時不動產,20,5,15,合庫-台中,2023-05-08,1021
6443,元晶,77,63,14,合庫-台中,2023-05-08,1021
4763,材料-KY,27,13,14,合庫-台中,2023-05-08,1021
1727,中華化,29,15,14,合庫-台中,2023-05-08,1021
6776,展�眥篕�,14,0,14,合庫-台中,2023-05-08,1021
6770,力積電,15,1,14,合庫-台中,2023-05-08,1021
8463,潤泰材,14,0,14,合庫-台中,2023-05-08,1021
00632R,元大台灣50反1,205,45,160,合庫-台中,2023-05-09,1021
00715L,期街口布蘭特正2,232,97,135,合庫-台中,2023-05-09,1021
1314,中石化,126,0,126,合庫-台中,2023-05-09,1021
1605,華新,155,40,115,合庫-台中,2023-05-09,1021
1312,國喬,110,10,100,合庫-台中,2023-05-09,1021
00751B,元大AAA至A公司債,94,0,94,合庫-台中,2023-05-09,1021
00720B,元大投資級公司債,84,0,84,合庫-台中,2023-05-09,1021
00679B,元大美債20年,83,7,76,合庫-台中,2023-05-09,1021
2457,飛宏,94,23,71,合庫-台中,2023-05-09,1021
00878,國泰永續高股息,67,0,67,合庫-台中,2023-05-09,1021
00680L,元大美債20正2,67,0,67,合庫-台中,2023-05-09,1021
00772B,中信高評級公司債,59,0,59,合庫-台中,2023-05-09,1021
1570,力肯,59,0,59,合庫-台中,2023-05-09,1021
1708,東鹼,53,0,53,合庫-台中,2023-05-09,1021
2312,金寶,47,0,47,合庫-台中,2023-05-09,1021
2634,漢翔,125,78,47,合庫-台中,2023-05-09,1021
2498,宏達電,48,3,45,合庫-台中,2023-05-09,1021
3715,定穎投控,81,36,45,合庫-台中,2023-05-09,1021
2886,兆豐金,46,2,44,合庫-台中,2023-05-09,1021
6244,茂迪,56,13,43,合庫-台中,2023-05-09,1021
00713,元大台灣高息低波,43,2,41,合庫-台中,2023-05-09,1021
00687B,國泰20年美債,36,0,36,合庫-台中,2023-05-09,1021
4129,聯合,34,0,34,合庫-台中,2023-05-09,1021
5880,合庫金,75,41,34,合庫-台中,2023-05-09,1021
2630,亞航,31,0,31,合庫-台中,2023-05-09,1021
00712,復華富時不動產,29,0,29,合庫-台中,2023-05-09,1021
3046,建��,71,43,28,合庫-台中,2023-05-09,1021
2891,中信金,56,29,27,合庫-台中,2023-05-09,1021
4541,晟田,31,5,26,合庫-台中,2023-05-09,1021
1609,大亞,27,1,26,合庫-台中,2023-05-09,1021
6112,邁達特,55,30,25,合庫-台中,2023-05-09,1021
2359,所羅門,26,1,25,合庫-台中,2023-05-09,1021
1101,台泥,42,17,25,合庫-台中,2023-05-09,1021
1909,榮成,24,0,24,合庫-台中,2023-05-09,1021
4919,新唐,26,4,22,合庫-台中,2023-05-09,1021
6016,康和證,22,0,22,合庫-台中,2023-05-09,1021
3481,群創,141,120,21,合庫-台中,2023-05-09,1021
1907,永豐餘,62,41,21,合庫-台中,2023-05-09,1021
9962,有益,20,0,20,合庫-台中,2023-05-09,1021
2889,國票金,20,0,20,合庫-台中,2023-05-09,1021
4513,福裕,20,0,20,合庫-台中,2023-05-09,1021
00920,富邦ESG綠色電力,20,0,20,合庫-台中,2023-05-09,1021
1519,華城,64,45,19,合庫-台中,2023-05-09,1021
2515,中工,51,32,19,合庫-台中,2023-05-09,1021
00885,富邦越南,20,1,19,合庫-台中,2023-05-09,1021
2812,台中銀,23,4,19,合庫-台中,2023-05-09,1021
2453,凌群,21,4,17,合庫-台中,2023-05-09,1021
00666R,富邦�琤肭磪齯�1,17,0,17,合庫-台中,2023-05-09,1021
2609,陽明,25,8,17,合庫-台中,2023-05-09,1021
1529,樂事綠能,36,20,16,合庫-台中,2023-05-09,1021
00637L,元大滬深300正2,517,207,310,合庫-台中,2023-05-10,1021
00878,國泰永續高股息,209,2,207,合庫-台中,2023-05-10,1021
00715L,期街口布蘭特正2,343,182,161,合庫-台中,2023-05-10,1021
00720B,元大投資級公司債,135,24,111,合庫-台中,2023-05-10,1021
1337,再生-KY,90,3,87,合庫-台中,2023-05-10,1021
2387,精元,71,1,70,合庫-台中,2023-05-10,1021
2303,聯電,61,2,59,合庫-台中,2023-05-10,1021
00751B,元大AAA至A公司債,69,12,57,合庫-台中,2023-05-10,1021
2610,華航,95,41,54,合庫-台中,2023-05-10,1021
1907,永豐餘,56,5,51,合庫-台中,2023-05-10,1021
00687B,國泰20年美債,48,0,48,合庫-台中,2023-05-10,1021
00665L,富邦�琤肭磪囓�2,241,193,48,合庫-台中,2023-05-10,1021
3576,聯合再生,46,0,46,合庫-台中,2023-05-10,1021
5487,通泰,46,0,46,合庫-台中,2023-05-10,1021
2882,國泰金,46,1,45,合庫-台中,2023-05-10,1021
6234,高僑,77,37,40,合庫-台中,2023-05-10,1021
00633L,富邦上証正2,40,0,40,合庫-台中,2023-05-10,1021
1570,力肯,36,0,36,合庫-台中,2023-05-10,1021
00772B,中信高評級公司債,51,15,36,合庫-台中,2023-05-10,1021
2409,友達,46,12,34,合庫-台中,2023-05-10,1021
5481,新華,34,0,34,合庫-台中,2023-05-10,1021
2457,飛宏,70,39,31,合庫-台中,2023-05-10,1021
2616,山隆,30,0,30,合庫-台中,2023-05-10,1021
00722B,群益投資級電信債,29,0,29,合庫-台中,2023-05-10,1021
1784,訊聯,27,2,25,合庫-台中,2023-05-10,1021
3013,晟銘電,47,22,25,合庫-台中,2023-05-10,1021
1503,士電,47,23,24,合庫-台中,2023-05-10,1021
2645,長榮航太,25,2,23,合庫-台中,2023-05-10,1021
2883,凱基金,28,5,23,合庫-台中,2023-05-10,1021
00680L,元大美債20正2,24,1,23,合庫-台中,2023-05-10,1021
1609,大亞,42,19,23,合庫-台中,2023-05-10,1021
3308,聯德,26,4,22,合庫-台中,2023-05-10,1021
3046,建��,56,34,22,合庫-台中,2023-05-10,1021
2352,佳世達,41,20,21,合庫-台中,2023-05-10,1021
0056,元大高股息,21,1,20,合庫-台中,2023-05-10,1021
00881,國泰台灣5G+,20,0,20,合庫-台中,2023-05-10,1021
1308,亞聚,20,0,20,合庫-台中,2023-05-10,1021
1234,黑松,20,0,20,合庫-台中,2023-05-10,1021
5301,寶得利,20,0,20,合庫-台中,2023-05-10,1021
2444,兆勁,20,0,20,合庫-台中,2023-05-10,1021
00713,元大台灣高息低波,22,2,20,合庫-台中,2023-05-10,1021
00670L,富邦NASDAQ正2,19,1,18,合庫-台中,2023-05-10,1021
6218,豪勉,20,2,18,合庫-台中,2023-05-10,1021
00882,中信中國高股息,17,0,17,合庫-台中,2023-05-10,1021
2745,五福,17,0,17,合庫-台中,2023-05-10,1021
8033,雷虎,66,50,16,合庫-台中,2023-05-10,1021
4979,華星光,33,17,16,合庫-台中,2023-05-10,1021
00712,復華富時不動產,20,5,15,合庫-台中,2023-05-10,1021
00679B,元大美債20年,50,35,15,合庫-台中,2023-05-10,1021
2367,燿華,14,0,14,合庫-台中,2023-05-10,1021
3363,上詮,146,1,145,合庫-台中,2023-05-11,1021
00878,國泰永續高股息,192,63,129,合庫-台中,2023-05-11,1021
2453,凌群,102,0,102,合庫-台中,2023-05-11,1021
5880,合庫金,131,29,102,合庫-台中,2023-05-11,1021
2387,精元,104,12,92,合庫-台中,2023-05-11,1021
00665L,富邦�琤肭磪囓�2,172,89,83,合庫-台中,2023-05-11,1021
2609,陽明,89,10,79,合庫-台中,2023-05-11,1021
2409,友達,89,12,77,合庫-台中,2023-05-11,1021
2393,億光,79,4,75,合庫-台中,2023-05-11,1021
2515,中工,74,2,72,合庫-台中,2023-05-11,1021
9103,美德醫療-DR,70,0,70,合庫-台中,2023-05-11,1021
2313,華通,62,0,62,合庫-台中,2023-05-11,1021
3056,富華新,71,14,57,合庫-台中,2023-05-11,1021
00637L,元大滬深300正2,180,124,56,合庫-台中,2023-05-11,1021
2883,凱基金,53,3,50,合庫-台中,2023-05-11,1021
3481,群創,67,20,47,合庫-台中,2023-05-11,1021
6285,啟��,49,3,46,合庫-台中,2023-05-11,1021
1795,美時,77,31,46,合庫-台中,2023-05-11,1021
2498,宏達電,62,21,41,合庫-台中,2023-05-11,1021
9907,統一實,39,0,39,合庫-台中,2023-05-11,1021
00757,統一FANG+,38,0,38,合庫-台中,2023-05-11,1021
2812,台中銀,38,1,37,合庫-台中,2023-05-11,1021
1609,大亞,33,0,33,合庫-台中,2023-05-11,1021
5481,新華,31,0,31,合庫-台中,2023-05-11,1021
1584,精剛,125,94,31,合庫-台中,2023-05-11,1021
2603,長榮,31,1,30,合庫-台中,2023-05-11,1021
1905,華紙,60,30,30,合庫-台中,2023-05-11,1021
2601,益航,30,0,30,合庫-台中,2023-05-11,1021
2312,金寶,33,5,28,合庫-台中,2023-05-11,1021
2337,旺宏,28,0,28,合庫-台中,2023-05-11,1021
2388,威盛,47,20,27,合庫-台中,2023-05-11,1021
2358,廷鑫,26,0,26,合庫-台中,2023-05-11,1021
2886,兆豐金,26,1,25,合庫-台中,2023-05-11,1021
8097,常珵,54,30,24,合庫-台中,2023-05-11,1021
4129,聯合,23,0,23,合庫-台中,2023-05-11,1021
8085,福華,25,2,23,合庫-台中,2023-05-11,1021
1802,台玻,23,0,23,合庫-台中,2023-05-11,1021
6026,福邦證,22,0,22,合庫-台中,2023-05-11,1021
0056,元大高股息,23,1,22,合庫-台中,2023-05-11,1021
1570,力肯,21,0,21,合庫-台中,2023-05-11,1021
8088,品安,21,0,21,合庫-台中,2023-05-11,1021
4919,新唐,24,4,20,合庫-台中,2023-05-11,1021
1513,中興電,23,3,20,合庫-台中,2023-05-11,1021
3049,精金,20,0,20,合庫-台中,2023-05-11,1021
2340,台亞,20,1,19,合庫-台中,2023-05-11,1021
1591,駿吉-KY,20,1,19,合庫-台中,2023-05-11,1021
2880,華南金,21,2,19,合庫-台中,2023-05-11,1021
6116,彩晶,27,9,18,合庫-台中,2023-05-11,1021
4121,優盛,21,3,18,合庫-台中,2023-05-11,1021
4931,新盛力,18,0,18,合庫-台中,2023-05-11,1021
00632R,元大台灣50反1,407,22,385,合庫-台中,2023-05-12,1021
00878,國泰永續高股息,176,38,138,合庫-台中,2023-05-12,1021
00637L,元大滬深300正2,137,0,137,合庫-台中,2023-05-12,1021
1101,台泥,126,19,107,合庫-台中,2023-05-12,1021
2409,友達,187,87,100,合庫-台中,2023-05-12,1021
4979,華星光,93,1,92,合庫-台中,2023-05-12,1021
5481,新華,82,0,82,合庫-台中,2023-05-12,1021
6285,啟��,103,31,72,合庫-台中,2023-05-12,1021
6167,久正,68,1,67,合庫-台中,2023-05-12,1021
9949,琉園,68,4,64,合庫-台中,2023-05-12,1021
6234,高僑,62,3,59,合庫-台中,2023-05-12,1021
00642U,期元大S＆P石油,54,0,54,合庫-台中,2023-05-12,1021
00888,永豐台灣ESG,49,0,49,合庫-台中,2023-05-12,1021
2317,鴻海,123,76,47,合庫-台中,2023-05-12,1021
2882,國泰金,50,3,47,合庫-台中,2023-05-12,1021
2444,兆勁,40,0,40,合庫-台中,2023-05-12,1021
0056,元大高股息,48,11,37,合庫-台中,2023-05-12,1021
8403,盛弘,51,16,35,合庫-台中,2023-05-12,1021
2327,國巨,32,0,32,合庫-台中,2023-05-12,1021
6733,博晟生醫,29,0,29,合庫-台中,2023-05-12,1021
2734,易飛網,28,0,28,合庫-台中,2023-05-12,1021
3481,群創,100,72,28,合庫-台中,2023-05-12,1021
2539,櫻花建,32,5,27,合庫-台中,2023-05-12,1021
2883,凱基金,30,6,24,合庫-台中,2023-05-12,1021
2002,中鋼,25,2,23,合庫-台中,2023-05-12,1021
2014,中鴻,22,0,22,合庫-台中,2023-05-12,1021
2313,華通,24,5,19,合庫-台中,2023-05-12,1021
2303,聯電,34,15,19,合庫-台中,2023-05-12,1021
1784,訊聯,19,1,18,合庫-台中,2023-05-12,1021
3576,聯合再生,30,12,18,合庫-台中,2023-05-12,1021
00633L,富邦上証正2,17,0,17,合庫-台中,2023-05-12,1021
00882,中信中國高股息,16,0,16,合庫-台中,2023-05-12,1021
4552,力達-KY,15,0,15,合庫-台中,2023-05-12,1021
2603,長榮,18,4,14,合庫-台中,2023-05-12,1021
2884,玉山金,19,5,14,合庫-台中,2023-05-12,1021
00720B,元大投資級公司債,16,2,14,合庫-台中,2023-05-12,1021
1314,中石化,14,0,14,合庫-台中,2023-05-12,1021
5381,合正,13,0,13,合庫-台中,2023-05-12,1021
8038,長園科,15,2,13,合庫-台中,2023-05-12,1021
00712,復華富時不動產,13,0,13,合庫-台中,2023-05-12,1021
1514,亞力,14,2,12,合庫-台中,2023-05-12,1021
00687B,國泰20年美債,12,0,12,合庫-台中,2023-05-12,1021
2615,萬海,12,0,12,合庫-台中,2023-05-12,1021
1616,億泰,11,0,11,合庫-台中,2023-05-12,1021
9907,統一實,11,0,11,合庫-台中,2023-05-12,1021
2880,華南金,10,0,10,合庫-台中,2023-05-12,1021
8028,昇陽半導體,10,0,10,合庫-台中,2023-05-12,1021
2610,華航,14,4,10,合庫-台中,2023-05-12,1021
2027,大成鋼,10,0,10,合庫-台中,2023-05-12,1021
2890,永豐金,18,8,10,合庫-台中,2023-05-12,1021
2890,永豐金,303,3,300,合庫-台中,2023-05-15,1021
2303,聯電,266,35,231,合庫-台中,2023-05-15,1021
2889,國票金,129,0,129,合庫-台中,2023-05-15,1021
1905,華紙,109,19,90,合庫-台中,2023-05-15,1021
1337,再生-KY,92,3,89,合庫-台中,2023-05-15,1021
2317,鴻海,50,6,44,合庫-台中,2023-05-15,1021
3231,緯創,75,33,42,合庫-台中,2023-05-15,1021
00642U,期元大S＆P石油,39,0,39,合庫-台中,2023-05-15,1021
2489,瑞軒,48,11,37,合庫-台中,2023-05-15,1021
00670L,富邦NASDAQ正2,53,16,37,合庫-台中,2023-05-15,1021
4161,聿新科,34,2,32,合庫-台中,2023-05-15,1021
3202,樺晟,36,5,31,合庫-台中,2023-05-15,1021
2444,兆勁,30,0,30,合庫-台中,2023-05-15,1021
00673R,期元大S＆P原油反1,30,0,30,合庫-台中,2023-05-15,1021
2634,漢翔,85,56,29,合庫-台中,2023-05-15,1021
1513,中興電,34,6,28,合庫-台中,2023-05-15,1021
1101,台泥,36,8,28,合庫-台中,2023-05-15,1021
3481,群創,100,74,26,合庫-台中,2023-05-15,1021
6472,保瑞,32,6,26,合庫-台中,2023-05-15,1021
00687B,國泰20年美債,25,0,25,合庫-台中,2023-05-15,1021
5907,大洋-KY,25,0,25,合庫-台中,2023-05-15,1021
4123,晟德,27,2,25,合庫-台中,2023-05-15,1021
1752,南光,24,3,21,合庫-台中,2023-05-15,1021
2457,飛宏,43,22,21,合庫-台中,2023-05-15,1021
2356,英業達,52,32,20,合庫-台中,2023-05-15,1021
3576,聯合再生,25,5,20,合庫-台中,2023-05-15,1021
2353,宏��,20,0,20,合庫-台中,2023-05-15,1021
8033,雷虎,22,2,20,合庫-台中,2023-05-15,1021
6589,台康生技,21,1,20,合庫-台中,2023-05-15,1021
2891,中信金,88,69,19,合庫-台中,2023-05-15,1021
2344,華邦電,20,2,18,合庫-台中,2023-05-15,1021
0056,元大高股息,39,21,18,合庫-台中,2023-05-15,1021
8299,群聯,18,0,18,合庫-台中,2023-05-15,1021
00637L,元大滬深300正2,16,0,16,合庫-台中,2023-05-15,1021
2002,中鋼,15,0,15,合庫-台中,2023-05-15,1021
1444,力麗,35,20,15,合庫-台中,2023-05-15,1021
1608,華榮,16,1,15,合庫-台中,2023-05-15,1021
8403,盛弘,14,0,14,合庫-台中,2023-05-15,1021
00881,國泰台灣5G+,14,0,14,合庫-台中,2023-05-15,1021
00772B,中信高評級公司債,16,2,14,合庫-台中,2023-05-15,1021
00891,中信關鍵半導體,18,4,14,合庫-台中,2023-05-15,1021
1605,華新,42,29,13,合庫-台中,2023-05-15,1021
00712,復華富時不動產,15,2,13,合庫-台中,2023-05-15,1021
3548,兆利,18,5,13,合庫-台中,2023-05-15,1021
2331,精英,24,11,13,合庫-台中,2023-05-15,1021
00696B,富邦美債20年,12,0,12,合庫-台中,2023-05-15,1021
00680L,元大美債20正2,13,1,12,合庫-台中,2023-05-15,1021
3703,欣陸,12,0,12,合庫-台中,2023-05-15,1021
9944,新麗,12,0,12,合庫-台中,2023-05-15,1021
3715,定穎投控,12,0,12,合庫-台中,2023-05-15,1021
00632R,元大台灣50反1,1490,28,1462,合庫-台中,2023-05-16,1021
2317,鴻海,533,16,517,合庫-台中,2023-05-16,1021
00751B,元大AAA至A公司債,148,0,148,合庫-台中,2023-05-16,1021
00680L,元大美債20正2,89,0,89,合庫-台中,2023-05-16,1021
3363,上詮,92,34,58,合庫-台中,2023-05-16,1021
1314,中石化,60,10,50,合庫-台中,2023-05-16,1021
00720B,元大投資級公司債,46,0,46,合庫-台中,2023-05-16,1021
2887,台新金,52,9,43,合庫-台中,2023-05-16,1021
2337,旺宏,43,1,42,合庫-台中,2023-05-16,1021
00772B,中信高評級公司債,37,0,37,合庫-台中,2023-05-16,1021
8222,寶一,36,3,33,合庫-台中,2023-05-16,1021
6698,旭暉應材,33,1,32,合庫-台中,2023-05-16,1021
00669R,國泰美國道瓊反1,31,0,31,合庫-台中,2023-05-16,1021
2734,易飛網,57,26,31,合庫-台中,2023-05-16,1021
2313,華通,32,3,29,合庫-台中,2023-05-16,1021
2457,飛宏,62,36,26,合庫-台中,2023-05-16,1021
2382,廣達,39,18,21,合庫-台中,2023-05-16,1021
00687B,國泰20年美債,35,15,20,合庫-台中,2023-05-16,1021
4967,十銓,35,15,20,合庫-台中,2023-05-16,1021
3202,樺晟,28,9,19,合庫-台中,2023-05-16,1021
4130,健亞,17,0,17,合庫-台中,2023-05-16,1021
1760,寶齡富錦,17,0,17,合庫-台中,2023-05-16,1021
2888,新光金,42,25,17,合庫-台中,2023-05-16,1021
8076,伍豐,23,6,17,合庫-台中,2023-05-16,1021
1616,億泰,16,0,16,合庫-台中,2023-05-16,1021
4919,新唐,19,3,16,合庫-台中,2023-05-16,1021
00773B,中信優先金融債,16,0,16,合庫-台中,2023-05-16,1021
2349,錸德,16,0,16,合庫-台中,2023-05-16,1021
1605,華新,20,4,16,合庫-台中,2023-05-16,1021
00679B,元大美債20年,38,22,16,合庫-台中,2023-05-16,1021
1402,遠東新,14,0,14,合庫-台中,2023-05-16,1021
5258,虹堡,31,17,14,合庫-台中,2023-05-16,1021
5245,智晶,20,6,14,合庫-台中,2023-05-16,1021
2812,台中銀,13,0,13,合庫-台中,2023-05-16,1021
2891,中信金,54,41,13,合庫-台中,2023-05-16,1021
1905,華紙,15,2,13,合庫-台中,2023-05-16,1021
4128,中天,14,1,13,合庫-台中,2023-05-16,1021
2609,陽明,17,4,13,合庫-台中,2023-05-16,1021
5009,榮剛,15,3,12,合庫-台中,2023-05-16,1021
5907,大洋-KY,12,0,12,合庫-台中,2023-05-16,1021
2356,英業達,20,9,11,合庫-台中,2023-05-16,1021
2616,山隆,11,0,11,合庫-台中,2023-05-16,1021
1506,正道,11,0,11,合庫-台中,2023-05-16,1021
3308,聯德,16,5,11,合庫-台中,2023-05-16,1021
2208,台船,15,5,10,合庫-台中,2023-05-16,1021
1524,耿鼎,10,0,10,合庫-台中,2023-05-16,1021
1708,東鹼,10,0,10,合庫-台中,2023-05-16,1021
2417,圓剛,12,2,10,合庫-台中,2023-05-16,1021
4743,合一,11,1,10,合庫-台中,2023-05-16,1021
1234,黑松,10,0,10,合庫-台中,2023-05-16,1021
00751B,元大AAA至A公司債,176,0,176,合庫-台中,2023-05-17,1021
00637L,元大滬深300正2,160,0,160,合庫-台中,2023-05-17,1021
00632R,元大台灣50反1,1365,1239,126,合庫-台中,2023-05-17,1021
3523,迎輝,124,0,124,合庫-台中,2023-05-17,1021
00674R,期元大S＆P黃金反1,110,0,110,合庫-台中,2023-05-17,1021
00715L,期街口布蘭特正2,104,0,104,合庫-台中,2023-05-17,1021
6005,群益證,100,0,100,合庫-台中,2023-05-17,1021
2890,永豐金,109,9,100,合庫-台中,2023-05-17,1021
00720B,元大投資級公司債,85,0,85,合庫-台中,2023-05-17,1021
00680L,元大美債20正2,73,0,73,合庫-台中,2023-05-17,1021
6589,台康生技,140,79,61,合庫-台中,2023-05-17,1021
00712,復華富時不動產,59,0,59,合庫-台中,2023-05-17,1021
4419,皇家美食,50,0,50,合庫-台中,2023-05-17,1021
00679B,元大美債20年,61,16,45,合庫-台中,2023-05-17,1021
2313,華通,44,1,43,合庫-台中,2023-05-17,1021
6148,驊宏資,43,0,43,合庫-台中,2023-05-17,1021
3715,定穎投控,44,9,35,合庫-台中,2023-05-17,1021
2317,鴻海,560,529,31,合庫-台中,2023-05-17,1021
1727,中華化,41,11,30,合庫-台中,2023-05-17,1021
3202,樺晟,30,1,29,合庫-台中,2023-05-17,1021
2734,易飛網,54,26,28,合庫-台中,2023-05-17,1021
6160,欣技,74,47,27,合庫-台中,2023-05-17,1021
00687B,國泰20年美債,24,2,22,合庫-台中,2023-05-17,1021
00902,中信電池及儲能,21,0,21,合庫-台中,2023-05-17,1021
00650L,復華香港正2,20,0,20,合庫-台中,2023-05-17,1021
00633L,富邦上証正2,23,3,20,合庫-台中,2023-05-17,1021
6294,智基,20,0,20,合庫-台中,2023-05-17,1021
5706,鳳凰,29,10,19,合庫-台中,2023-05-17,1021
2603,長榮,21,3,18,合庫-台中,2023-05-17,1021
6285,啟��,35,18,17,合庫-台中,2023-05-17,1021
00772B,中信高評級公司債,14,1,13,合庫-台中,2023-05-17,1021
6570,維田,13,0,13,合庫-台中,2023-05-17,1021
2352,佳世達,28,15,13,合庫-台中,2023-05-17,1021
1513,中興電,22,10,12,合庫-台中,2023-05-17,1021
3308,聯德,13,1,12,合庫-台中,2023-05-17,1021
1608,華榮,39,27,12,合庫-台中,2023-05-17,1021
2745,五福,15,3,12,合庫-台中,2023-05-17,1021
9921,巨大,11,0,11,合庫-台中,2023-05-17,1021
3576,聯合再生,11,0,11,合庫-台中,2023-05-17,1021
2340,台亞,10,0,10,合庫-台中,2023-05-17,1021
3034,聯詠,12,3,9,合庫-台中,2023-05-17,1021
3105,穩懋,10,1,9,合庫-台中,2023-05-17,1021
8940,新天地,12,3,9,合庫-台中,2023-05-17,1021
2443,昶虹,9,0,9,合庫-台中,2023-05-17,1021
1584,精剛,13,5,8,合庫-台中,2023-05-17,1021
5469,瀚宇博,9,1,8,合庫-台中,2023-05-17,1021
2359,所羅門,9,1,8,合庫-台中,2023-05-17,1021
6197,佳必琪,10,2,8,合庫-台中,2023-05-17,1021
3290,東浦,10,2,8,合庫-台中,2023-05-17,1021
6791,虎門科技,10,2,8,合庫-台中,2023-05-17,1021
00632R,元大台灣50反1,934,556,378,合庫-台中,2023-05-18,1021
00637L,元大滬深300正2,163,55,108,合庫-台中,2023-05-18,1021
3056,富華新,105,11,94,合庫-台中,2023-05-18,1021
3523,迎輝,89,0,89,合庫-台中,2023-05-18,1021
00751B,元大AAA至A公司債,69,0,69,合庫-台中,2023-05-18,1021
00878,國泰永續高股息,215,155,60,合庫-台中,2023-05-18,1021
5227,立凱-KY,48,0,48,合庫-台中,2023-05-18,1021
00882,中信中國高股息,43,0,43,合庫-台中,2023-05-18,1021
1314,中石化,42,0,42,合庫-台中,2023-05-18,1021
00690,兆豐藍籌30,33,0,33,合庫-台中,2023-05-18,1021
00687B,國泰20年美債,32,0,32,合庫-台中,2023-05-18,1021
00720B,元大投資級公司債,33,1,32,合庫-台中,2023-05-18,1021
9949,琉園,31,0,31,合庫-台中,2023-05-18,1021
9907,統一實,35,6,29,合庫-台中,2023-05-18,1021
4967,十銓,57,33,24,合庫-台中,2023-05-18,1021
2495,普安,24,1,23,合庫-台中,2023-05-18,1021
2313,華通,27,4,23,合庫-台中,2023-05-18,1021
6550,北極星藥業-KY,23,0,23,合庫-台中,2023-05-18,1021
6770,力積電,26,3,23,合庫-台中,2023-05-18,1021
00679B,元大美債20年,43,21,22,合庫-台中,2023-05-18,1021
3149,正達,22,0,22,合庫-台中,2023-05-18,1021
8069,元太,32,11,21,合庫-台中,2023-05-18,1021
5703,亞都,20,0,20,合庫-台中,2023-05-18,1021
00674R,期元大S＆P黃金反1,20,0,20,合庫-台中,2023-05-18,1021
5704,老爺知,20,0,20,合庫-台中,2023-05-18,1021
6235,華孚,53,34,19,合庫-台中,2023-05-18,1021
5353,台林,16,0,16,合庫-台中,2023-05-18,1021
2630,亞航,32,16,16,合庫-台中,2023-05-18,1021
2609,陽明,29,14,15,合庫-台中,2023-05-18,1021
3046,建��,41,26,15,合庫-台中,2023-05-18,1021
00725B,國泰投資級公司債,15,0,15,合庫-台中,2023-05-18,1021
2601,益航,20,5,15,合庫-台中,2023-05-18,1021
00680L,元大美債20正2,15,0,15,合庫-台中,2023-05-18,1021
2211,長榮鋼,15,0,15,合庫-台中,2023-05-18,1021
6456,GIS-KY,15,0,15,合庫-台中,2023-05-18,1021
5425,台半,17,3,14,合庫-台中,2023-05-18,1021
00772B,中信高評級公司債,14,0,14,合庫-台中,2023-05-18,1021
6470,宇智,13,0,13,合庫-台中,2023-05-18,1021
3037,欣興,50,37,13,合庫-台中,2023-05-18,1021
6266,泰詠,13,1,12,合庫-台中,2023-05-18,1021
00676R,富邦臺灣加權反1,12,0,12,合庫-台中,2023-05-18,1021
1708,東鹼,12,0,12,合庫-台中,2023-05-18,1021
9958,世紀鋼,11,0,11,合庫-台中,2023-05-18,1021
3362,先進光,21,10,11,合庫-台中,2023-05-18,1021
6589,台康生技,37,26,11,合庫-台中,2023-05-18,1021
6112,邁達特,55,44,11,合庫-台中,2023-05-18,1021
6160,欣技,24,13,11,合庫-台中,2023-05-18,1021
1101,台泥,14,4,10,合庫-台中,2023-05-18,1021
1319,東陽,12,2,10,合庫-台中,2023-05-18,1021
1809,中釉,10,0,10,合庫-台中,2023-05-18,1021
2382,廣達,1068,527,541,合庫-台中,2023-05-19,1021
00720B,元大投資級公司債,183,2,181,合庫-台中,2023-05-19,1021
00665L,富邦�琤肭磪囓�2,142,2,140,合庫-台中,2023-05-19,1021
00680L,元大美債20正2,109,0,109,合庫-台中,2023-05-19,1021
00674R,期元大S＆P黃金反1,100,16,84,合庫-台中,2023-05-19,1021
5009,榮剛,89,6,83,合庫-台中,2023-05-19,1021
00753L,中信中國50正2,96,14,82,合庫-台中,2023-05-19,1021
1514,亞力,90,18,72,合庫-台中,2023-05-19,1021
00751B,元大AAA至A公司債,58,0,58,合庫-台中,2023-05-19,1021
00687B,國泰20年美債,68,15,53,合庫-台中,2023-05-19,1021
2634,漢翔,135,82,53,合庫-台中,2023-05-19,1021
00772B,中信高評級公司債,54,3,51,合庫-台中,2023-05-19,1021
00679B,元大美債20年,70,24,46,合庫-台中,2023-05-19,1021
1504,東元,98,53,45,合庫-台中,2023-05-19,1021
3576,聯合再生,46,2,44,合庫-台中,2023-05-19,1021
2371,大同,78,34,44,合庫-台中,2023-05-19,1021
2303,聯電,53,12,41,合庫-台中,2023-05-19,1021
2462,良得電,40,0,40,合庫-台中,2023-05-19,1021
2453,凌群,46,7,39,合庫-台中,2023-05-19,1021
1529,樂事綠能,61,25,36,合庫-台中,2023-05-19,1021
00637L,元大滬深300正2,105,74,31,合庫-台中,2023-05-19,1021
1432,大魯閣,30,0,30,合庫-台中,2023-05-19,1021
3419,譁裕,35,5,30,合庫-台中,2023-05-19,1021
3029,零壹,64,35,29,合庫-台中,2023-05-19,1021
3056,富華新,31,2,29,合庫-台中,2023-05-19,1021
2630,亞航,62,34,28,合庫-台中,2023-05-19,1021
3003,健和興,29,4,25,合庫-台中,2023-05-19,1021
4931,新盛力,26,1,25,合庫-台中,2023-05-19,1021
2323,中環,83,58,25,合庫-台中,2023-05-19,1021
3011,今皓,26,1,25,合庫-台中,2023-05-19,1021
00712,復華富時不動產,28,5,23,合庫-台中,2023-05-19,1021
2457,飛宏,37,15,22,合庫-台中,2023-05-19,1021
00690,兆豐藍籌30,22,1,21,合庫-台中,2023-05-19,1021
4109,加捷生醫,20,0,20,合庫-台中,2023-05-19,1021
1417,嘉裕,20,0,20,合庫-台中,2023-05-19,1021
2409,友達,40,21,19,合庫-台中,2023-05-19,1021
3231,緯創,71,52,19,合庫-台中,2023-05-19,1021
4541,晟田,21,2,19,合庫-台中,2023-05-19,1021
2349,錸德,20,2,18,合庫-台中,2023-05-19,1021
4919,新唐,31,13,18,合庫-台中,2023-05-19,1021
8222,寶一,46,28,18,合庫-台中,2023-05-19,1021
8038,長園科,19,1,18,合庫-台中,2023-05-19,1021
3034,聯詠,18,0,18,合庫-台中,2023-05-19,1021
6550,北極星藥業-KY,18,1,17,合庫-台中,2023-05-19,1021
2498,宏達電,17,1,16,合庫-台中,2023-05-19,1021
6589,台康生技,16,1,15,合庫-台中,2023-05-19,1021
00708L,期元大S＆P黃金正2,15,0,15,合庫-台中,2023-05-19,1021
3715,定穎投控,23,9,14,合庫-台中,2023-05-19,1021
4952,凌通,14,0,14,合庫-台中,2023-05-19,1021
00633L,富邦上証正2,14,0,14,合庫-台中,2023-05-19,1021
00715L,期街口布蘭特正2,265,10,255,合庫-台中,2023-05-22,1021
2409,友達,200,34,166,合庫-台中,2023-05-22,1021
2303,聯電,158,4,154,合庫-台中,2023-05-22,1021
3027,盛達,120,2,118,合庫-台中,2023-05-22,1021
1504,東元,124,40,84,合庫-台中,2023-05-22,1021
0056,元大高股息,102,19,83,合庫-台中,2023-05-22,1021
3037,欣興,132,62,70,合庫-台中,2023-05-22,1021
00720B,元大投資級公司債,70,5,65,合庫-台中,2023-05-22,1021
2427,三商電,94,31,63,合庫-台中,2023-05-22,1021
2323,中環,74,16,58,合庫-台中,2023-05-22,1021
2031,新光鋼,56,0,56,合庫-台中,2023-05-22,1021
1727,中華化,68,13,55,合庫-台中,2023-05-22,1021
00679B,元大美債20年,60,7,53,合庫-台中,2023-05-22,1021
5243,乙盛-KY,63,14,49,合庫-台中,2023-05-22,1021
2887,台新金,53,10,43,合庫-台中,2023-05-22,1021
00751B,元大AAA至A公司債,45,3,42,合庫-台中,2023-05-22,1021
3231,緯創,133,93,40,合庫-台中,2023-05-22,1021
4402,郡都開發,39,0,39,合庫-台中,2023-05-22,1021
2880,華南金,41,4,37,合庫-台中,2023-05-22,1021
00687B,國泰20年美債,37,0,37,合庫-台中,2023-05-22,1021
2442,新美齊,32,0,32,合庫-台中,2023-05-22,1021
8097,常珵,36,6,30,合庫-台中,2023-05-22,1021
00680L,元大美債20正2,30,0,30,合庫-台中,2023-05-22,1021
1611,中電,30,0,30,合庫-台中,2023-05-22,1021
2025,千興,30,2,28,合庫-台中,2023-05-22,1021
1447,力鵬,27,0,27,合庫-台中,2023-05-22,1021
2344,華邦電,72,47,25,合庫-台中,2023-05-22,1021
00772B,中信高評級公司債,25,0,25,合庫-台中,2023-05-22,1021
1795,美時,33,9,24,合庫-台中,2023-05-22,1021
1314,中石化,24,0,24,合庫-台中,2023-05-22,1021
2457,飛宏,37,15,22,合庫-台中,2023-05-22,1021
00712,復華富時不動產,22,0,22,合庫-台中,2023-05-22,1021
2542,興富發,22,1,21,合庫-台中,2023-05-22,1021
3016,嘉晶,20,0,20,合庫-台中,2023-05-22,1021
8222,寶一,31,12,19,合庫-台中,2023-05-22,1021
6589,台康生技,18,0,18,合庫-台中,2023-05-22,1021
00632R,元大台灣50反1,141,125,16,合庫-台中,2023-05-22,1021
2462,良得電,16,0,16,合庫-台中,2023-05-22,1021
6243,迅杰,19,3,16,合庫-台中,2023-05-22,1021
4934,太極,15,0,15,合庫-台中,2023-05-22,1021
3035,智原,17,3,14,合庫-台中,2023-05-22,1021
2371,大同,37,23,14,合庫-台中,2023-05-22,1021
3011,今皓,13,0,13,合庫-台中,2023-05-22,1021
4550,長佳,13,0,13,合庫-台中,2023-05-22,1021
4763,材料-KY,16,3,13,合庫-台中,2023-05-22,1021
00853B,統一美債10年Aa-,12,0,12,合庫-台中,2023-05-22,1021
2356,英業達,16,4,12,合庫-台中,2023-05-22,1021
2312,金寶,12,0,12,合庫-台中,2023-05-22,1021
6697,東捷資訊,12,0,12,合庫-台中,2023-05-22,1021
6282,康舒,79,68,11,合庫-台中,2023-05-22,1021
2409,友達,173,32,141,合庫-台中,2023-05-23,1021
00670L,富邦NASDAQ正2,120,2,118,合庫-台中,2023-05-23,1021
3025,星通,71,3,68,合庫-台中,2023-05-23,1021
5531,鄉林,94,28,66,合庫-台中,2023-05-23,1021
2313,華通,113,48,65,合庫-台中,2023-05-23,1021
00882,中信中國高股息,63,0,63,合庫-台中,2023-05-23,1021
2610,華航,130,67,63,合庫-台中,2023-05-23,1021
2332,友訊,68,9,59,合庫-台中,2023-05-23,1021
00715L,期街口布蘭特正2,222,166,56,合庫-台中,2023-05-23,1021
2427,三商電,58,3,55,合庫-台中,2023-05-23,1021
2618,長榮航,294,239,55,合庫-台中,2023-05-23,1021
4402,郡都開發,54,0,54,合庫-台中,2023-05-23,1021
00679B,元大美債20年,54,1,53,合庫-台中,2023-05-23,1021
2634,漢翔,136,86,50,合庫-台中,2023-05-23,1021
2515,中工,61,11,50,合庫-台中,2023-05-23,1021
4541,晟田,78,30,48,合庫-台中,2023-05-23,1021
3356,奇偶,40,0,40,合庫-台中,2023-05-23,1021
00680L,元大美債20正2,46,8,38,合庫-台中,2023-05-23,1021
00772B,中信高評級公司債,32,0,32,合庫-台中,2023-05-23,1021
2371,大同,38,6,32,合庫-台中,2023-05-23,1021
00757,統一FANG+,29,0,29,合庫-台中,2023-05-23,1021
1101,台泥,38,9,29,合庫-台中,2023-05-23,1021
6446,藥華藥,40,11,29,合庫-台中,2023-05-23,1021
2633,台灣高鐵,34,6,28,合庫-台中,2023-05-23,1021
00751B,元大AAA至A公司債,29,2,27,合庫-台中,2023-05-23,1021
1514,亞力,38,11,27,合庫-台中,2023-05-23,1021
6672,騰輝電子-KY,26,0,26,合庫-台中,2023-05-23,1021
2399,映泰,36,10,26,合庫-台中,2023-05-23,1021
1504,東元,41,15,26,合庫-台中,2023-05-23,1021
00637L,元大滬深300正2,127,104,23,合庫-台中,2023-05-23,1021
2891,中信金,26,4,22,合庫-台中,2023-05-23,1021
8121,越峰,31,9,22,合庫-台中,2023-05-23,1021
3027,盛達,22,0,22,合庫-台中,2023-05-23,1021
1904,正隆,24,3,21,合庫-台中,2023-05-23,1021
4977,眾達-KY,24,3,21,合庫-台中,2023-05-23,1021
8936,國統,20,0,20,合庫-台中,2023-05-23,1021
00683L,期元大美元指正2,20,1,19,合庫-台中,2023-05-23,1021
2317,鴻海,28,9,19,合庫-台中,2023-05-23,1021
2867,三商壽,26,8,18,合庫-台中,2023-05-23,1021
6689,伊雲谷,23,6,17,合庫-台中,2023-05-23,1021
1513,中興電,155,139,16,合庫-台中,2023-05-23,1021
4543,萬在,26,10,16,合庫-台中,2023-05-23,1021
3048,益登,16,0,16,合庫-台中,2023-05-23,1021
4130,健亞,20,4,16,合庫-台中,2023-05-23,1021
3207,耀勝,16,0,16,合庫-台中,2023-05-23,1021
1605,華新,17,2,15,合庫-台中,2023-05-23,1021
3221,台嘉碩,15,0,15,合庫-台中,2023-05-23,1021
6233,旺玖,28,13,15,合庫-台中,2023-05-23,1021
6243,迅杰,16,1,15,合庫-台中,2023-05-23,1021
2208,台船,24,10,14,合庫-台中,2023-05-23,1021
00665L,富邦�琤肭磪囓�2,326,60,266,合庫-台中,2023-05-24,1021
2888,新光金,177,8,169,合庫-台中,2023-05-24,1021
00673R,期元大S＆P原油反1,160,0,160,合庫-台中,2023-05-24,1021
2402,毅嘉,168,45,123,合庫-台中,2023-05-24,1021
00679B,元大美債20年,167,55,112,合庫-台中,2023-05-24,1021
00882,中信中國高股息,98,11,87,合庫-台中,2023-05-24,1021
2834,臺企銀,78,0,78,合庫-台中,2023-05-24,1021
1513,中興電,137,80,57,合庫-台中,2023-05-24,1021
5512,力麒,59,4,55,合庫-台中,2023-05-24,1021
5706,鳳凰,65,11,54,合庫-台中,2023-05-24,1021
00687B,國泰20年美債,52,0,52,合庫-台中,2023-05-24,1021
9949,琉園,54,4,50,合庫-台中,2023-05-24,1021
2630,亞航,56,14,42,合庫-台中,2023-05-24,1021
2327,國巨,42,0,42,合庫-台中,2023-05-24,1021
00637L,元大滬深300正2,61,20,41,合庫-台中,2023-05-24,1021
1718,中纖,40,0,40,合庫-台中,2023-05-24,1021
3078,僑威,60,24,36,合庫-台中,2023-05-24,1021
3011,今皓,35,0,35,合庫-台中,2023-05-24,1021
00680L,元大美債20正2,38,5,33,合庫-台中,2023-05-24,1021
6697,東捷資訊,31,0,31,合庫-台中,2023-05-24,1021
00894,中信小資高價30,31,0,31,合庫-台中,2023-05-24,1021
3231,緯創,137,107,30,合庫-台中,2023-05-24,1021
2312,金寶,30,0,30,合庫-台中,2023-05-24,1021
1528,恩德,30,0,30,合庫-台中,2023-05-24,1021
1799,易威,30,0,30,合庫-台中,2023-05-24,1021
3523,迎輝,30,0,30,合庫-台中,2023-05-24,1021
00712,復華富時不動產,29,0,29,合庫-台中,2023-05-24,1021
5009,榮剛,33,4,29,合庫-台中,2023-05-24,1021
6220,岳豐,32,5,27,合庫-台中,2023-05-24,1021
2633,台灣高鐵,28,2,26,合庫-台中,2023-05-24,1021
3511,矽瑪,35,9,26,合庫-台中,2023-05-24,1021
6233,旺玖,27,2,25,合庫-台中,2023-05-24,1021
2537,聯上發,35,10,25,合庫-台中,2023-05-24,1021
00878,國泰永續高股息,64,40,24,合庫-台中,2023-05-24,1021
1108,幸福,22,0,22,合庫-台中,2023-05-24,1021
2731,雄獅,23,2,21,合庫-台中,2023-05-24,1021
2712,遠雄來,29,8,21,合庫-台中,2023-05-24,1021
2323,中環,41,20,21,合庫-台中,2023-05-24,1021
3272,東碩,20,0,20,合庫-台中,2023-05-24,1021
6235,華孚,30,10,20,合庫-台中,2023-05-24,1021
6609,瀧澤科,20,0,20,合庫-台中,2023-05-24,1021
4967,十銓,22,2,20,合庫-台中,2023-05-24,1021
4919,新唐,20,1,19,合庫-台中,2023-05-24,1021
5531,鄉林,81,65,16,合庫-台中,2023-05-24,1021
2438,翔耀,15,0,15,合庫-台中,2023-05-24,1021
3058,立德,20,6,14,合庫-台中,2023-05-24,1021
2645,長榮航太,19,5,14,合庫-台中,2023-05-24,1021
3617,碩天,14,1,13,合庫-台中,2023-05-24,1021
3205,佰研,20,7,13,合庫-台中,2023-05-24,1021
6111,大宇資,12,0,12,合庫-台中,2023-05-24,1021
3523,迎輝,300,0,300,合庫-台中,2023-05-25,1021
00665L,富邦�琤肭磪囓�2,278,22,256,合庫-台中,2023-05-25,1021
00632R,元大台灣50反1,230,51,179,合庫-台中,2023-05-25,1021
3056,富華新,133,8,125,合庫-台中,2023-05-25,1021
00882,中信中國高股息,109,0,109,合庫-台中,2023-05-25,1021
2344,華邦電,238,131,107,合庫-台中,2023-05-25,1021
1513,中興電,111,26,85,合庫-台中,2023-05-25,1021
2888,新光金,74,11,63,合庫-台中,2023-05-25,1021
00712,復華富時不動產,99,37,62,合庫-台中,2023-05-25,1021
1432,大魯閣,66,4,62,合庫-台中,2023-05-25,1021
2618,長榮航,287,229,58,合庫-台中,2023-05-25,1021
1718,中纖,55,5,50,合庫-台中,2023-05-25,1021
3576,聯合再生,49,5,44,合庫-台中,2023-05-25,1021
00637L,元大滬深300正2,63,20,43,合庫-台中,2023-05-25,1021
2303,聯電,73,31,42,合庫-台中,2023-05-25,1021
4960,誠美材,42,0,42,合庫-台中,2023-05-25,1021
2457,飛宏,60,18,42,合庫-台中,2023-05-25,1021
1519,華城,74,34,40,合庫-台中,2023-05-25,1021
3419,譁裕,44,4,40,合庫-台中,2023-05-25,1021
8926,台汽電,39,1,38,合庫-台中,2023-05-25,1021
00763U,期街口道瓊銅,36,0,36,合庫-台中,2023-05-25,1021
4129,聯合,38,3,35,合庫-台中,2023-05-25,1021
1905,華紙,58,23,35,合庫-台中,2023-05-25,1021
3481,群創,85,52,33,合庫-台中,2023-05-25,1021
1460,宏遠,36,4,32,合庫-台中,2023-05-25,1021
1609,大亞,41,10,31,合庫-台中,2023-05-25,1021
2890,永豐金,32,1,31,合庫-台中,2023-05-25,1021
3264,欣銓,32,1,31,合庫-台中,2023-05-25,1021
6234,高僑,30,0,30,合庫-台中,2023-05-25,1021
1504,東元,46,16,30,合庫-台中,2023-05-25,1021
6111,大宇資,32,3,29,合庫-台中,2023-05-25,1021
2337,旺宏,31,3,28,合庫-台中,2023-05-25,1021
6446,藥華藥,31,4,27,合庫-台中,2023-05-25,1021
00753L,中信中國50正2,49,23,26,合庫-台中,2023-05-25,1021
2705,六福,54,29,25,合庫-台中,2023-05-25,1021
4541,晟田,28,4,24,合庫-台中,2023-05-25,1021
1810,和成,23,0,23,合庫-台中,2023-05-25,1021
4564,元翎,56,33,23,合庫-台中,2023-05-25,1021
3011,今皓,23,0,23,合庫-台中,2023-05-25,1021
6282,康舒,28,5,23,合庫-台中,2023-05-25,1021
00679B,元大美債20年,62,39,23,合庫-台中,2023-05-25,1021
00687B,國泰20年美債,22,0,22,合庫-台中,2023-05-25,1021
8038,長園科,27,5,22,合庫-台中,2023-05-25,1021
00772B,中信高評級公司債,24,2,22,合庫-台中,2023-05-25,1021
2603,長榮,25,4,21,合庫-台中,2023-05-25,1021
2615,萬海,21,0,21,合庫-台中,2023-05-25,1021
2883,凱基金,24,3,21,合庫-台中,2023-05-25,1021
9949,琉園,21,0,21,合庫-台中,2023-05-25,1021
4763,材料-KY,28,7,21,合庫-台中,2023-05-25,1021
00900,富邦特選高股息30,25,5,20,合庫-台中,2023-05-25,1021
2323,中環,1168,118,1050,合庫-台中,2023-05-26,1021
00632R,元大台灣50反1,440,87,353,合庫-台中,2023-05-26,1021
00712,復華富時不動產,248,40,208,合庫-台中,2023-05-26,1021
2382,廣達,515,329,186,合庫-台中,2023-05-26,1021
3481,群創,231,112,119,合庫-台中,2023-05-26,1021
3231,緯創,408,295,113,合庫-台中,2023-05-26,1021
00715L,期街口布蘭特正2,139,28,111,合庫-台中,2023-05-26,1021
2630,亞航,117,7,110,合庫-台中,2023-05-26,1021
00637L,元大滬深300正2,104,16,88,合庫-台中,2023-05-26,1021
2883,凱基金,69,0,69,合庫-台中,2023-05-26,1021
1718,中纖,65,1,64,合庫-台中,2023-05-26,1021
3615,安可,57,0,57,合庫-台中,2023-05-26,1021
00795B,中信美國公債20年,54,0,54,合庫-台中,2023-05-26,1021
00882,中信中國高股息,52,0,52,合庫-台中,2023-05-26,1021
1460,宏遠,50,0,50,合庫-台中,2023-05-26,1021
00674R,期元大S＆P黃金反1,50,0,50,合庫-台中,2023-05-26,1021
2515,中工,51,6,45,合庫-台中,2023-05-26,1021
2371,大同,97,55,42,合庫-台中,2023-05-26,1021
2349,錸德,50,10,40,合庫-台中,2023-05-26,1021
2609,陽明,48,10,38,合庫-台中,2023-05-26,1021
2457,飛宏,64,29,35,合庫-台中,2023-05-26,1021
3078,僑威,57,23,34,合庫-台中,2023-05-26,1021
00752,中信中國50,34,0,34,合庫-台中,2023-05-26,1021
3511,矽瑪,34,0,34,合庫-台中,2023-05-26,1021
00680L,元大美債20正2,42,8,34,合庫-台中,2023-05-26,1021
1219,福壽,33,0,33,合庫-台中,2023-05-26,1021
6288,聯嘉,33,0,33,合庫-台中,2023-05-26,1021
5351,鈺創,33,0,33,合庫-台中,2023-05-26,1021
1504,東元,60,30,30,合庫-台中,2023-05-26,1021
2453,凌群,44,14,30,合庫-台中,2023-05-26,1021
00665L,富邦�琤肭磪囓�2,30,0,30,合庫-台中,2023-05-26,1021
2461,光群雷,30,0,30,合庫-台中,2023-05-26,1021
5531,鄉林,36,6,30,合庫-台中,2023-05-26,1021
1609,大亞,32,5,27,合庫-台中,2023-05-26,1021
00679B,元大美債20年,25,0,25,合庫-台中,2023-05-26,1021
2331,精英,34,10,24,合庫-台中,2023-05-26,1021
2705,六福,44,20,24,合庫-台中,2023-05-26,1021
3094,聯傑,23,0,23,合庫-台中,2023-05-26,1021
6234,高僑,23,0,23,合庫-台中,2023-05-26,1021
2633,台灣高鐵,27,5,22,合庫-台中,2023-05-26,1021
2634,漢翔,31,9,22,合庫-台中,2023-05-26,1021
6112,邁達特,34,13,21,合庫-台中,2023-05-26,1021
2312,金寶,31,10,21,合庫-台中,2023-05-26,1021
1529,樂事綠能,32,11,21,合庫-台中,2023-05-26,1021
9949,琉園,27,6,21,合庫-台中,2023-05-26,1021
2606,裕民,21,1,20,合庫-台中,2023-05-26,1021
4550,長佳,20,0,20,合庫-台中,2023-05-26,1021
1905,華紙,34,14,20,合庫-台中,2023-05-26,1021
2801,彰銀,20,1,19,合庫-台中,2023-05-26,1021
3046,建��,22,3,19,合庫-台中,2023-05-26,1021
00637L,元大滬深300正2,319,16,303,合庫-台中,2023-05-29,1021
2382,廣達,627,445,182,合庫-台中,2023-05-29,1021
00882,中信中國高股息,136,0,136,合庫-台中,2023-05-29,1021
0056,元大高股息,137,38,99,合庫-台中,2023-05-29,1021
1314,中石化,96,0,96,合庫-台中,2023-05-29,1021
3231,緯創,240,147,93,合庫-台中,2023-05-29,1021
2867,三商壽,106,25,81,合庫-台中,2023-05-29,1021
2883,凱基金,82,1,81,合庫-台中,2023-05-29,1021
1608,華榮,101,22,79,合庫-台中,2023-05-29,1021
2881,富邦金,78,4,74,合庫-台中,2023-05-29,1021
2409,友達,86,19,67,合庫-台中,2023-05-29,1021
00679B,元大美債20年,63,1,62,合庫-台中,2023-05-29,1021
1445,大宇,55,0,55,合庫-台中,2023-05-29,1021
2002,中鋼,48,2,46,合庫-台中,2023-05-29,1021
3037,欣興,85,46,39,合庫-台中,2023-05-29,1021
00687B,國泰20年美債,38,0,38,合庫-台中,2023-05-29,1021
2356,英業達,61,23,38,合庫-台中,2023-05-29,1021
2371,大同,128,93,35,合庫-台中,2023-05-29,1021
3202,樺晟,29,0,29,合庫-台中,2023-05-29,1021
00878,國泰永續高股息,119,92,27,合庫-台中,2023-05-29,1021
00895,富邦未來車,33,7,26,合庫-台中,2023-05-29,1021
0050,元大台灣50,31,7,24,合庫-台中,2023-05-29,1021
5328,華容,25,1,24,合庫-台中,2023-05-29,1021
00902,中信電池及儲能,29,5,24,合庫-台中,2023-05-29,1021
2425,承啟,45,23,22,合庫-台中,2023-05-29,1021
1618,合機,23,1,22,合庫-台中,2023-05-29,1021
6206,飛捷,21,0,21,合庫-台中,2023-05-29,1021
00665L,富邦�琤肭磪囓�2,27,6,21,合庫-台中,2023-05-29,1021
2031,新光鋼,21,1,20,合庫-台中,2023-05-29,1021
2705,六福,20,0,20,合庫-台中,2023-05-29,1021
2515,中工,50,30,20,合庫-台中,2023-05-29,1021
1444,力麗,20,1,19,合庫-台中,2023-05-29,1021
6218,豪勉,20,1,19,合庫-台中,2023-05-29,1021
00631L,元大台灣50正2,170,151,19,合庫-台中,2023-05-29,1021
1312,國喬,19,0,19,合庫-台中,2023-05-29,1021
00751B,元大AAA至A公司債,18,0,18,合庫-台中,2023-05-29,1021
6456,GIS-KY,18,0,18,合庫-台中,2023-05-29,1021
6244,茂迪,18,0,18,合庫-台中,2023-05-29,1021
3711,日月光投控,32,16,16,合庫-台中,2023-05-29,1021
4915,致伸,16,0,16,合庫-台中,2023-05-29,1021
5531,鄉林,15,0,15,合庫-台中,2023-05-29,1021
6282,康舒,133,118,15,合庫-台中,2023-05-29,1021
6243,迅杰,18,3,15,合庫-台中,2023-05-29,1021
00885,富邦越南,20,6,14,合庫-台中,2023-05-29,1021
00690,兆豐藍籌30,14,0,14,合庫-台中,2023-05-29,1021
5905,南仁湖,19,5,14,合庫-台中,2023-05-29,1021
2421,建準,47,34,13,合庫-台中,2023-05-29,1021
00680L,元大美債20正2,13,0,13,合庫-台中,2023-05-29,1021
2402,毅嘉,14,1,13,合庫-台中,2023-05-29,1021
2324,仁寶,42,29,13,合庫-台中,2023-05-29,1021
00715L,期街口布蘭特正2,732,20,712,合庫-台中,2023-05-30,1021
00882,中信中國高股息,216,0,216,合庫-台中,2023-05-30,1021
2356,英業達,419,215,204,合庫-台中,2023-05-30,1021
1445,大宇,170,0,170,合庫-台中,2023-05-30,1021
00637L,元大滬深300正2,186,26,160,合庫-台中,2023-05-30,1021
1570,力肯,131,0,131,合庫-台中,2023-05-30,1021
4702,中美實,100,0,100,合庫-台中,2023-05-30,1021
2317,鴻海,185,90,95,合庫-台中,2023-05-30,1021
8059,凱碩,88,5,83,合庫-台中,2023-05-30,1021
3615,安可,78,0,78,合庫-台中,2023-05-30,1021
2382,廣達,78,6,72,合庫-台中,2023-05-30,1021
1312,國喬,60,1,59,合庫-台中,2023-05-30,1021
6166,凌華,69,10,59,合庫-台中,2023-05-30,1021
3056,富華新,82,26,56,合庫-台中,2023-05-30,1021
2444,兆勁,51,0,51,合庫-台中,2023-05-30,1021
8411,福貞-KY,43,0,43,合庫-台中,2023-05-30,1021
6188,廣明,74,32,42,合庫-台中,2023-05-30,1021
2002,中鋼,42,1,41,合庫-台中,2023-05-30,1021
3037,欣興,49,10,39,合庫-台中,2023-05-30,1021
00878,國泰永續高股息,80,43,37,合庫-台中,2023-05-30,1021
1608,華榮,59,23,36,合庫-台中,2023-05-30,1021
2637,慧洋-KY,31,1,30,合庫-台中,2023-05-30,1021
8927,北基,30,0,30,合庫-台中,2023-05-30,1021
2327,國巨,30,2,28,合庫-台中,2023-05-30,1021
4745,合富-KY,27,0,27,合庫-台中,2023-05-30,1021
00687B,國泰20年美債,28,1,27,合庫-台中,2023-05-30,1021
6244,茂迪,30,3,27,合庫-台中,2023-05-30,1021
2031,新光鋼,34,8,26,合庫-台中,2023-05-30,1021
5371,中光電,32,6,26,合庫-台中,2023-05-30,1021
3481,群創,53,28,25,合庫-台中,2023-05-30,1021
2834,臺企銀,24,0,24,合庫-台中,2023-05-30,1021
2204,中華,32,10,22,合庫-台中,2023-05-30,1021
1460,宏遠,29,7,22,合庫-台中,2023-05-30,1021
2399,映泰,24,3,21,合庫-台中,2023-05-30,1021
6472,保瑞,27,6,21,合庫-台中,2023-05-30,1021
6517,保勝光學,21,1,20,合庫-台中,2023-05-30,1021
6155,鈞寶,20,0,20,合庫-台中,2023-05-30,1021
2601,益航,20,0,20,合庫-台中,2023-05-30,1021
5531,鄉林,22,2,20,合庫-台中,2023-05-30,1021
1504,東元,22,3,19,合庫-台中,2023-05-30,1021
3078,僑威,30,11,19,合庫-台中,2023-05-30,1021
00679B,元大美債20年,18,0,18,合庫-台中,2023-05-30,1021
00665L,富邦�琤肭磪囓�2,23,5,18,合庫-台中,2023-05-30,1021
2609,陽明,20,3,17,合庫-台中,2023-05-30,1021
1513,中興電,20,3,17,合庫-台中,2023-05-30,1021
3011,今皓,16,0,16,合庫-台中,2023-05-30,1021
3163,波若威,23,7,16,合庫-台中,2023-05-30,1021
00712,復華富時不動產,22,6,16,合庫-台中,2023-05-30,1021
1609,大亞,24,8,16,合庫-台中,2023-05-30,1021
3094,聯傑,32,17,15,合庫-台中,2023-05-30,1021
00715L,期街口布蘭特正2,602,10,592,合庫-台中,2023-05-31,1021
00893,國泰智能電動車,533,42,491,合庫-台中,2023-05-31,1021
2371,大同,271,137,134,合庫-台中,2023-05-31,1021
00642U,期元大S＆P石油,105,0,105,合庫-台中,2023-05-31,1021
2444,兆勁,101,0,101,合庫-台中,2023-05-31,1021
00882,中信中國高股息,63,0,63,合庫-台中,2023-05-31,1021
2801,彰銀,63,3,60,合庫-台中,2023-05-31,1021
3615,安可,56,0,56,合庫-台中,2023-05-31,1021
8940,新天地,69,19,50,合庫-台中,2023-05-31,1021
1445,大宇,50,0,50,合庫-台中,2023-05-31,1021
3625,西勝,49,0,49,合庫-台中,2023-05-31,1021
9942,茂順,47,4,43,合庫-台中,2023-05-31,1021
2890,永豐金,56,19,37,合庫-台中,2023-05-31,1021
2382,廣達,52,16,36,合庫-台中,2023-05-31,1021
00878,國泰永續高股息,73,38,35,合庫-台中,2023-05-31,1021
00637L,元大滬深300正2,34,0,34,合庫-台中,2023-05-31,1021
2614,東森,30,1,29,合庫-台中,2023-05-31,1021
3006,晶豪科,49,23,26,合庫-台中,2023-05-31,1021
2451,創見,26,1,25,合庫-台中,2023-05-31,1021
0056,元大高股息,73,49,24,合庫-台中,2023-05-31,1021
3025,星通,30,9,21,合庫-台中,2023-05-31,1021
2388,威盛,49,28,21,合庫-台中,2023-05-31,1021
5531,鄉林,28,8,20,合庫-台中,2023-05-31,1021
1101,台泥,20,0,20,合庫-台中,2023-05-31,1021
5530,龍巖,20,0,20,合庫-台中,2023-05-31,1021
2812,台中銀,19,0,19,合庫-台中,2023-05-31,1021
6829,千附精密,20,1,19,合庫-台中,2023-05-31,1021
3703,欣陸,19,0,19,合庫-台中,2023-05-31,1021
2337,旺宏,20,2,18,合庫-台中,2023-05-31,1021
4745,合富-KY,18,0,18,合庫-台中,2023-05-31,1021
4129,聯合,19,2,17,合庫-台中,2023-05-31,1021
00713,元大台灣高息低波,19,3,16,合庫-台中,2023-05-31,1021
00885,富邦越南,21,5,16,合庫-台中,2023-05-31,1021
1709,和益,16,0,16,合庫-台中,2023-05-31,1021
1513,中興電,45,29,16,合庫-台中,2023-05-31,1021
1802,台玻,15,0,15,合庫-台中,2023-05-31,1021
00665L,富邦�琤肭磪囓�2,15,0,15,合庫-台中,2023-05-31,1021
5465,富驊,30,16,14,合庫-台中,2023-05-31,1021
00902,中信電池及儲能,14,0,14,合庫-台中,2023-05-31,1021
1708,東鹼,19,5,14,合庫-台中,2023-05-31,1021
1727,中華化,27,15,12,合庫-台中,2023-05-31,1021
1519,華城,22,10,12,合庫-台中,2023-05-31,1021
1907,永豐餘,11,0,11,合庫-台中,2023-05-31,1021
8358,金居,13,2,11,合庫-台中,2023-05-31,1021
2461,光群雷,12,1,11,合庫-台中,2023-05-31,1021
2886,兆豐金,19,8,11,合庫-台中,2023-05-31,1021
2615,萬海,20,9,11,合庫-台中,2023-05-31,1021
2454,聯發科,16,5,11,合庫-台中,2023-05-31,1021
4114,健喬,12,1,11,合庫-台中,2023-05-31,1021
8086,宏捷科,14,3,11,合庫-台中,2023-05-31,1021
2323,中環,592,103,489,合庫-台中,2023-06-01,1021
00715L,期街口布蘭特正2,222,10,212,合庫-台中,2023-06-01,1021
2888,新光金,163,1,162,合庫-台中,2023-06-01,1021
5880,合庫金,129,2,127,合庫-台中,2023-06-01,1021
2303,聯電,125,17,108,合庫-台中,2023-06-01,1021
2630,亞航,287,180,107,合庫-台中,2023-06-01,1021
6188,廣明,143,56,87,合庫-台中,2023-06-01,1021
5465,富驊,60,6,54,合庫-台中,2023-06-01,1021
2371,大同,138,91,47,合庫-台中,2023-06-01,1021
3032,偉訓,46,0,46,合庫-台中,2023-06-01,1021
2103,台橡,43,0,43,合庫-台中,2023-06-01,1021
6143,振曜,41,0,41,合庫-台中,2023-06-01,1021
00642U,期元大S＆P石油,41,0,41,合庫-台中,2023-06-01,1021
00712,復華富時不動產,44,5,39,合庫-台中,2023-06-01,1021
2892,第一金,40,1,39,合庫-台中,2023-06-01,1021
3056,富華新,51,13,38,合庫-台中,2023-06-01,1021
1445,大宇,38,0,38,合庫-台中,2023-06-01,1021
4919,新唐,38,0,38,合庫-台中,2023-06-01,1021
2356,英業達,39,11,28,合庫-台中,2023-06-01,1021
3305,昇貿,31,4,27,合庫-台中,2023-06-01,1021
6789,采鈺,27,0,27,合庫-台中,2023-06-01,1021
2352,佳世達,49,22,27,合庫-台中,2023-06-01,1021
3706,神達,111,85,26,合庫-台中,2023-06-01,1021
00919,群益台灣精選高息,26,0,26,合庫-台中,2023-06-01,1021
2634,漢翔,102,77,25,合庫-台中,2023-06-01,1021
3704,合勤控,26,3,23,合庫-台中,2023-06-01,1021
00708L,期元大S＆P黃金正2,22,0,22,合庫-台中,2023-06-01,1021
8011,台通,23,1,22,合庫-台中,2023-06-01,1021
2883,凱基金,30,8,22,合庫-台中,2023-06-01,1021
00882,中信中國高股息,21,0,21,合庫-台中,2023-06-01,1021
2351,順德,25,4,21,合庫-台中,2023-06-01,1021
2332,友訊,25,4,21,合庫-台中,2023-06-01,1021
6284,佳邦,20,0,20,合庫-台中,2023-06-01,1021
2208,台船,20,1,19,合庫-台中,2023-06-01,1021
2609,陽明,44,25,19,合庫-台中,2023-06-01,1021
3025,星通,20,2,18,合庫-台中,2023-06-01,1021
8033,雷虎,36,19,17,合庫-台中,2023-06-01,1021
3013,晟銘電,47,31,16,合庫-台中,2023-06-01,1021
4745,合富-KY,15,0,15,合庫-台中,2023-06-01,1021
2353,宏��,15,1,14,合庫-台中,2023-06-01,1021
2745,五福,16,2,14,合庫-台中,2023-06-01,1021
2606,裕民,13,0,13,合庫-台中,2023-06-01,1021
3272,東碩,13,0,13,合庫-台中,2023-06-01,1021
00753L,中信中國50正2,13,0,13,合庫-台中,2023-06-01,1021
2105,正新,12,0,12,合庫-台中,2023-06-01,1021
1101,台泥,29,17,12,合庫-台中,2023-06-01,1021
2530,華建,12,0,12,合庫-台中,2023-06-01,1021
00688L,國泰20年美債正2,12,0,12,合庫-台中,2023-06-01,1021
3260,威剛,44,32,12,合庫-台中,2023-06-01,1021
2347,聯強,14,2,12,合庫-台中,2023-06-01,1021
00878,國泰永續高股息,418,91,327,合庫-台中,2023-06-02,1021
2610,華航,586,402,184,合庫-台中,2023-06-02,1021
3231,緯創,285,147,138,合庫-台中,2023-06-02,1021
00712,復華富時不動產,116,9,107,合庫-台中,2023-06-02,1021
5880,合庫金,107,9,98,合庫-台中,2023-06-02,1021
2302,麗正,92,0,92,合庫-台中,2023-06-02,1021
1905,華紙,184,101,83,合庫-台中,2023-06-02,1021
2734,易飛網,76,6,70,合庫-台中,2023-06-02,1021
1727,中華化,70,8,62,合庫-台中,2023-06-02,1021
2409,友達,77,18,59,合庫-台中,2023-06-02,1021
2722,夏都,102,47,55,合庫-台中,2023-06-02,1021
00679B,元大美債20年,70,17,53,合庫-台中,2023-06-02,1021
2331,精英,68,18,50,合庫-台中,2023-06-02,1021
00670L,富邦NASDAQ正2,52,2,50,合庫-台中,2023-06-02,1021
2498,宏達電,58,10,48,合庫-台中,2023-06-02,1021
00762,元大全球AI,41,0,41,合庫-台中,2023-06-02,1021
2913,農林,46,6,40,合庫-台中,2023-06-02,1021
00632R,元大台灣50反1,91,53,38,合庫-台中,2023-06-02,1021
00665L,富邦�琤肭磪囓�2,181,144,37,合庫-台中,2023-06-02,1021
1445,大宇,36,0,36,合庫-台中,2023-06-02,1021
00919,群益台灣精選高息,38,2,36,合庫-台中,2023-06-02,1021
2031,新光鋼,33,0,33,合庫-台中,2023-06-02,1021
2489,瑞軒,60,28,32,合庫-台中,2023-06-02,1021
3630,新鉅科,30,0,30,合庫-台中,2023-06-02,1021
4174,浩鼎,30,0,30,合庫-台中,2023-06-02,1021
4763,材料-KY,41,12,29,合庫-台中,2023-06-02,1021
3306,鼎天,66,39,27,合庫-台中,2023-06-02,1021
2337,旺宏,27,0,27,合庫-台中,2023-06-02,1021
6288,聯嘉,26,0,26,合庫-台中,2023-06-02,1021
1504,東元,129,103,26,合庫-台中,2023-06-02,1021
3025,星通,37,12,25,合庫-台中,2023-06-02,1021
2488,漢平,24,0,24,合庫-台中,2023-06-02,1021
5351,鈺創,28,4,24,合庫-台中,2023-06-02,1021
2603,長榮,23,0,23,合庫-台中,2023-06-02,1021
4979,華星光,49,27,22,合庫-台中,2023-06-02,1021
6015,宏遠證,22,0,22,合庫-台中,2023-06-02,1021
4739,康普,22,0,22,合庫-台中,2023-06-02,1021
1904,正隆,30,9,21,合庫-台中,2023-06-02,1021
3058,立德,22,1,21,合庫-台中,2023-06-02,1021
2614,東森,23,2,21,合庫-台中,2023-06-02,1021
3576,聯合再生,22,2,20,合庫-台中,2023-06-02,1021
00926,凱基全球菁英55,20,0,20,合庫-台中,2023-06-02,1021
911868,同方友友-DR,20,0,20,合庫-台中,2023-06-02,1021
2601,益航,20,0,20,合庫-台中,2023-06-02,1021
912000,晨訊科-DR,20,0,20,合庫-台中,2023-06-02,1021
1734,杏輝,28,9,19,合庫-台中,2023-06-02,1021
2393,億光,21,2,19,合庫-台中,2023-06-02,1021
3059,華晶科,20,1,19,合庫-台中,2023-06-02,1021
2371,大同,80,62,18,合庫-台中,2023-06-02,1021
2206,三陽工業,56,39,17,合庫-台中,2023-06-02,1021
2382,廣達,783,355,428,合庫-台中,2023-06-05,1021
9136,巨騰-DR,384,58,326,合庫-台中,2023-06-05,1021
00632R,元大台灣50反1,300,30,270,合庫-台中,2023-06-05,1021
2618,長榮航,379,116,263,合庫-台中,2023-06-05,1021
1806,冠軍,410,201,209,合庫-台中,2023-06-05,1021
1605,華新,188,25,163,合庫-台中,2023-06-05,1021
5880,合庫金,176,21,155,合庫-台中,2023-06-05,1021
00919,群益台灣精選高息,139,2,137,合庫-台中,2023-06-05,1021
2630,亞航,199,70,129,合庫-台中,2023-06-05,1021
6282,康舒,222,128,94,合庫-台中,2023-06-05,1021
3058,立德,85,0,85,合庫-台中,2023-06-05,1021
00679B,元大美債20年,85,1,84,合庫-台中,2023-06-05,1021
2344,華邦電,112,29,83,合庫-台中,2023-06-05,1021
2337,旺宏,80,0,80,合庫-台中,2023-06-05,1021
00712,復華富時不動產,78,4,74,合庫-台中,2023-06-05,1021
2303,聯電,73,3,70,合庫-台中,2023-06-05,1021
5426,振發,58,0,58,合庫-台中,2023-06-05,1021
1714,和桐,57,0,57,合庫-台中,2023-06-05,1021
6218,豪勉,95,41,54,合庫-台中,2023-06-05,1021
00637L,元大滬深300正2,151,100,51,合庫-台中,2023-06-05,1021
00687B,國泰20年美債,47,1,46,合庫-台中,2023-06-05,1021
00641R,富邦日本反1,45,0,45,合庫-台中,2023-06-05,1021
3706,神達,64,20,44,合庫-台中,2023-06-05,1021
6789,采鈺,47,4,43,合庫-台中,2023-06-05,1021
6111,大宇資,90,48,42,合庫-台中,2023-06-05,1021
1795,美時,78,37,41,合庫-台中,2023-06-05,1021
3607,谷崧,40,0,40,合庫-台中,2023-06-05,1021
2388,威盛,140,100,40,合庫-台中,2023-06-05,1021
1515,力山,58,19,39,合庫-台中,2023-06-05,1021
3025,星通,115,77,38,合庫-台中,2023-06-05,1021
2603,長榮,43,6,37,合庫-台中,2023-06-05,1021
00673R,期元大S＆P原油反1,29,0,29,合庫-台中,2023-06-05,1021
2331,精英,57,28,29,合庫-台中,2023-06-05,1021
3438,類比科,26,1,25,合庫-台中,2023-06-05,1021
1529,樂事綠能,56,33,23,合庫-台中,2023-06-05,1021
1445,大宇,22,0,22,合庫-台中,2023-06-05,1021
1101,台泥,28,7,21,合庫-台中,2023-06-05,1021
2317,鴻海,30,9,21,合庫-台中,2023-06-05,1021
3015,全漢,21,0,21,合庫-台中,2023-06-05,1021
2449,京元電子,31,10,21,合庫-台中,2023-06-05,1021
2614,東森,21,0,21,合庫-台中,2023-06-05,1021
2030,彰源,21,0,21,合庫-台中,2023-06-05,1021
3294,英濟,21,0,21,合庫-台中,2023-06-05,1021
1513,中興電,37,17,20,合庫-台中,2023-06-05,1021
9907,統一實,20,0,20,合庫-台中,2023-06-05,1021
3711,日月光投控,26,7,19,合庫-台中,2023-06-05,1021
2444,兆勁,25,6,19,合庫-台中,2023-06-05,1021
5478,智冠,20,2,18,合庫-台中,2023-06-05,1021
00713,元大台灣高息低波,28,10,18,合庫-台中,2023-06-05,1021
1312,國喬,22,5,17,合庫-台中,2023-06-05,1021
00878,國泰永續高股息,537,26,511,合庫-台中,2023-06-06,1021
2402,毅嘉,236,61,175,合庫-台中,2023-06-06,1021
2347,聯強,153,4,149,合庫-台中,2023-06-06,1021
1445,大宇,148,0,148,合庫-台中,2023-06-06,1021
00927,群益半導體收益,138,0,138,合庫-台中,2023-06-06,1021
00679B,元大美債20年,155,23,132,合庫-台中,2023-06-06,1021
2630,亞航,121,2,119,合庫-台中,2023-06-06,1021
00673R,期元大S＆P原油反1,100,0,100,合庫-台中,2023-06-06,1021
2206,三陽工業,99,8,91,合庫-台中,2023-06-06,1021
2498,宏達電,96,8,88,合庫-台中,2023-06-06,1021
6111,大宇資,91,6,85,合庫-台中,2023-06-06,1021
6116,彩晶,102,20,82,合庫-台中,2023-06-06,1021
4906,正文,72,2,70,合庫-台中,2023-06-06,1021
1905,華紙,162,98,64,合庫-台中,2023-06-06,1021
6282,康舒,173,112,61,合庫-台中,2023-06-06,1021
1447,力鵬,60,0,60,合庫-台中,2023-06-06,1021
2888,新光金,127,76,51,合庫-台中,2023-06-06,1021
00674R,期元大S＆P黃金反1,42,0,42,合庫-台中,2023-06-06,1021
6270,倍微,42,0,42,合庫-台中,2023-06-06,1021
00642U,期元大S＆P石油,40,0,40,合庫-台中,2023-06-06,1021
6026,福邦證,41,5,36,合庫-台中,2023-06-06,1021
2881,富邦金,36,0,36,合庫-台中,2023-06-06,1021
6456,GIS-KY,37,3,34,合庫-台中,2023-06-06,1021
5371,中光電,35,3,32,合庫-台中,2023-06-06,1021
2303,聯電,32,3,29,合庫-台中,2023-06-06,1021
4533,協易機,30,1,29,合庫-台中,2023-06-06,1021
3535,晶彩科,30,1,29,合庫-台中,2023-06-06,1021
00919,群益台灣精選高息,36,8,28,合庫-台中,2023-06-06,1021
3015,全漢,28,0,28,合庫-台中,2023-06-06,1021
1514,亞力,52,26,26,合庫-台中,2023-06-06,1021
00632R,元大台灣50反1,48,23,25,合庫-台中,2023-06-06,1021
2399,映泰,48,23,25,合庫-台中,2023-06-06,1021
6218,豪勉,25,1,24,合庫-台中,2023-06-06,1021
2425,承啟,57,33,24,合庫-台中,2023-06-06,1021
1101,台泥,29,7,22,合庫-台中,2023-06-06,1021
8411,福貞-KY,22,0,22,合庫-台中,2023-06-06,1021
8358,金居,44,22,22,合庫-台中,2023-06-06,1021
2457,飛宏,60,39,21,合庫-台中,2023-06-06,1021
2359,所羅門,21,0,21,合庫-台中,2023-06-06,1021
6874,倍力,21,0,21,合庫-台中,2023-06-06,1021
6443,元晶,28,7,21,合庫-台中,2023-06-06,1021
6290,良維,35,14,21,合庫-台中,2023-06-06,1021
2634,漢翔,29,8,21,合庫-台中,2023-06-06,1021
6235,華孚,45,25,20,合庫-台中,2023-06-06,1021
3432,台端,20,0,20,合庫-台中,2023-06-06,1021
4564,元翎,20,0,20,合庫-台中,2023-06-06,1021
1584,精剛,39,19,20,合庫-台中,2023-06-06,1021
5351,鈺創,24,4,20,合庫-台中,2023-06-06,1021
3630,新鉅科,24,6,18,合庫-台中,2023-06-06,1021
2886,兆豐金,18,1,17,合庫-台中,2023-06-06,1021
020022,元大電動車N,450,0,450,合庫-台中,2023-06-07,1021
1314,中石化,171,31,140,合庫-台中,2023-06-07,1021
00637L,元大滬深300正2,359,233,126,合庫-台中,2023-06-07,1021
2402,毅嘉,196,84,112,合庫-台中,2023-06-07,1021
6125,廣運,100,11,89,合庫-台中,2023-06-07,1021
3615,安可,80,0,80,合庫-台中,2023-06-07,1021
2609,陽明,111,35,76,合庫-台中,2023-06-07,1021
2610,華航,76,16,60,合庫-台中,2023-06-07,1021
5531,鄉林,61,3,58,合庫-台中,2023-06-07,1021
2530,華建,57,0,57,合庫-台中,2023-06-07,1021
2337,旺宏,65,9,56,合庫-台中,2023-06-07,1021
9136,巨騰-DR,54,0,54,合庫-台中,2023-06-07,1021
00712,復華富時不動產,81,33,48,合庫-台中,2023-06-07,1021
2515,中工,72,28,44,合庫-台中,2023-06-07,1021
4931,新盛力,47,5,42,合庫-台中,2023-06-07,1021
6244,茂迪,109,68,41,合庫-台中,2023-06-07,1021
00665L,富邦�琤肭磪囓�2,95,56,39,合庫-台中,2023-06-07,1021
00669R,國泰美國道瓊反1,37,0,37,合庫-台中,2023-06-07,1021
8027,鈦昇,43,8,35,合庫-台中,2023-06-07,1021
2745,五福,30,0,30,合庫-台中,2023-06-07,1021
4960,誠美材,30,0,30,合庫-台中,2023-06-07,1021
3711,日月光投控,100,72,28,合庫-台中,2023-06-07,1021
9945,潤泰新,28,3,25,合庫-台中,2023-06-07,1021
3630,新鉅科,32,7,25,合庫-台中,2023-06-07,1021
8033,雷虎,28,4,24,合庫-台中,2023-06-07,1021
3027,盛達,30,7,23,合庫-台中,2023-06-07,1021
1806,冠軍,108,85,23,合庫-台中,2023-06-07,1021
00882,中信中國高股息,22,0,22,合庫-台中,2023-06-07,1021
6191,精成科,22,0,22,合庫-台中,2023-06-07,1021
2457,飛宏,35,13,22,合庫-台中,2023-06-07,1021
00679B,元大美債20年,26,5,21,合庫-台中,2023-06-07,1021
6672,騰輝電子-KY,20,0,20,合庫-台中,2023-06-07,1021
2347,聯強,19,0,19,合庫-台中,2023-06-07,1021
4906,正文,20,1,19,合庫-台中,2023-06-07,1021
8076,伍豐,22,4,18,合庫-台中,2023-06-07,1021
3071,協禧,23,5,18,合庫-台中,2023-06-07,1021
1605,華新,37,21,16,合庫-台中,2023-06-07,1021
1519,華城,42,26,16,合庫-台中,2023-06-07,1021
4977,眾達-KY,16,0,16,合庫-台中,2023-06-07,1021
4510,高鋒,16,0,16,合庫-台中,2023-06-07,1021
00919,群益台灣精選高息,22,6,16,合庫-台中,2023-06-07,1021
3202,樺晟,15,0,15,合庫-台中,2023-06-07,1021
2731,雄獅,22,8,14,合庫-台中,2023-06-07,1021
3003,健和興,22,8,14,合庫-台中,2023-06-07,1021
2376,技嘉,21,8,13,合庫-台中,2023-06-07,1021
3673,TPK-KY,24,11,13,合庫-台中,2023-06-07,1021
2605,新興,14,2,12,合庫-台中,2023-06-07,1021
1444,力麗,12,0,12,合庫-台中,2023-06-07,1021
8222,寶一,17,5,12,合庫-台中,2023-06-07,1021
3325,旭品,20,8,12,合庫-台中,2023-06-07,1021
2382,廣達,526,14,512,合庫-台中,2023-06-08,1021
00919,群益台灣精選高息,486,0,486,合庫-台中,2023-06-08,1021
2888,新光金,279,32,247,合庫-台中,2023-06-08,1021
00673R,期元大S＆P原油反1,229,0,229,合庫-台中,2023-06-08,1021
1609,大亞,375,174,201,合庫-台中,2023-06-08,1021
00679B,元大美債20年,199,0,199,合庫-台中,2023-06-08,1021
9136,巨騰-DR,166,40,126,合庫-台中,2023-06-08,1021
1605,華新,138,19,119,合庫-台中,2023-06-08,1021
00751B,元大AAA至A公司債,107,3,104,合庫-台中,2023-06-08,1021
5531,鄉林,100,6,94,合庫-台中,2023-06-08,1021
2834,臺企銀,101,10,91,合庫-台中,2023-06-08,1021
2337,旺宏,98,21,77,合庫-台中,2023-06-08,1021
3056,富華新,87,11,76,合庫-台中,2023-06-08,1021
2344,華邦電,228,152,76,合庫-台中,2023-06-08,1021
2409,友達,115,42,73,合庫-台中,2023-06-08,1021
1445,大宇,115,42,73,合庫-台中,2023-06-08,1021
1618,合機,62,2,60,合庫-台中,2023-06-08,1021
2388,威盛,80,30,50,合庫-台中,2023-06-08,1021
4906,正文,51,3,48,合庫-台中,2023-06-08,1021
4931,新盛力,52,5,47,合庫-台中,2023-06-08,1021
4960,誠美材,41,0,41,合庫-台中,2023-06-08,1021
00927,群益半導體收益,40,0,40,合庫-台中,2023-06-08,1021
2323,中環,91,52,39,合庫-台中,2023-06-08,1021
6188,廣明,37,0,37,合庫-台中,2023-06-08,1021
2801,彰銀,34,0,34,合庫-台中,2023-06-08,1021
1718,中纖,33,0,33,合庫-台中,2023-06-08,1021
9949,琉園,33,0,33,合庫-台中,2023-06-08,1021
2327,國巨,35,3,32,合庫-台中,2023-06-08,1021
1101,台泥,36,4,32,合庫-台中,2023-06-08,1021
00687B,國泰20年美債,32,1,31,合庫-台中,2023-06-08,1021
3025,星通,100,69,31,合庫-台中,2023-06-08,1021
1612,宏泰,111,81,30,合庫-台中,2023-06-08,1021
2492,華新科,31,2,29,合庫-台中,2023-06-08,1021
2882,國泰金,30,2,28,合庫-台中,2023-06-08,1021
6112,邁達特,34,6,28,合庫-台中,2023-06-08,1021
2347,聯強,28,0,28,合庫-台中,2023-06-08,1021
3338,泰碩,28,1,27,合庫-台中,2023-06-08,1021
8043,蜜望實,30,3,27,合庫-台中,2023-06-08,1021
1905,華紙,57,31,26,合庫-台中,2023-06-08,1021
2444,兆勁,26,0,26,合庫-台中,2023-06-08,1021
3675,德微,25,0,25,合庫-台中,2023-06-08,1021
1218,泰山,24,0,24,合庫-台中,2023-06-08,1021
2702,華園,24,1,23,合庫-台中,2023-06-08,1021
4745,合富-KY,23,0,23,合庫-台中,2023-06-08,1021
6285,啟��,38,15,23,合庫-台中,2023-06-08,1021
00720B,元大投資級公司債,22,0,22,合庫-台中,2023-06-08,1021
6288,聯嘉,25,3,22,合庫-台中,2023-06-08,1021
8096,擎亞,22,0,22,合庫-台中,2023-06-08,1021
6443,元晶,22,1,21,合庫-台中,2023-06-08,1021
6770,力積電,23,2,21,合庫-台中,2023-06-08,1021
8926,台汽電,253,35,218,合庫-台中,2023-06-09,1021
2888,新光金,287,85,202,合庫-台中,2023-06-09,1021
1806,冠軍,222,122,100,合庫-台中,2023-06-09,1021
2206,三陽工業,125,35,90,合庫-台中,2023-06-09,1021
00919,群益台灣精選高息,89,2,87,合庫-台中,2023-06-09,1021
9103,美德醫療-DR,86,0,86,合庫-台中,2023-06-09,1021
6203,海韻電,100,14,86,合庫-台中,2023-06-09,1021
00929,復華台灣科技優息,87,5,82,合庫-台中,2023-06-09,1021
00715L,期街口布蘭特正2,72,0,72,合庫-台中,2023-06-09,1021
2634,漢翔,91,20,71,合庫-台中,2023-06-09,1021
6125,廣運,124,57,67,合庫-台中,2023-06-09,1021
2427,三商電,64,2,62,合庫-台中,2023-06-09,1021
2337,旺宏,61,0,61,合庫-台中,2023-06-09,1021
2323,中環,107,48,59,合庫-台中,2023-06-09,1021
2834,臺企銀,110,51,59,合庫-台中,2023-06-09,1021
00632R,元大台灣50反1,51,0,51,合庫-台中,2023-06-09,1021
3615,安可,45,0,45,合庫-台中,2023-06-09,1021
2887,台新金,83,40,43,合庫-台中,2023-06-09,1021
1432,大魯閣,42,2,40,合庫-台中,2023-06-09,1021
00712,復華富時不動產,58,19,39,合庫-台中,2023-06-09,1021
9105,泰金寶-DR,37,0,37,合庫-台中,2023-06-09,1021
00666R,富邦�琤肭磪齯�1,35,0,35,合庫-台中,2023-06-09,1021
2488,漢平,37,2,35,合庫-台中,2023-06-09,1021
2731,雄獅,36,2,34,合庫-台中,2023-06-09,1021
1504,東元,208,177,31,合庫-台中,2023-06-09,1021
3011,今皓,31,1,30,合庫-台中,2023-06-09,1021
8086,宏捷科,30,1,29,合庫-台中,2023-06-09,1021
0056,元大高股息,51,23,28,合庫-台中,2023-06-09,1021
6668,中揚光,30,2,28,合庫-台中,2023-06-09,1021
3483,力致,28,0,28,合庫-台中,2023-06-09,1021
2482,連宇,122,95,27,合庫-台中,2023-06-09,1021
2498,宏達電,34,7,27,合庫-台中,2023-06-09,1021
1533,車王電,45,18,27,合庫-台中,2023-06-09,1021
4552,力達-KY,43,16,27,合庫-台中,2023-06-09,1021
5475,德宏,27,0,27,合庫-台中,2023-06-09,1021
6152,百一,27,0,27,合庫-台中,2023-06-09,1021
2743,山富,48,22,26,合庫-台中,2023-06-09,1021
6190,萬泰科,26,0,26,合庫-台中,2023-06-09,1021
00753L,中信中國50正2,40,15,25,合庫-台中,2023-06-09,1021
1104,環泥,29,6,23,合庫-台中,2023-06-09,1021
00679B,元大美債20年,22,0,22,合庫-台中,2023-06-09,1021
1447,力鵬,21,0,21,合庫-台中,2023-06-09,1021
3048,益登,21,0,21,合庫-台中,2023-06-09,1021
6789,采鈺,26,6,20,合庫-台中,2023-06-09,1021
2363,矽統,20,0,20,合庫-台中,2023-06-09,1021
00637L,元大滬深300正2,40,21,19,合庫-台中,2023-06-09,1021
2892,第一金,20,1,19,合庫-台中,2023-06-09,1021
3707,漢磊,20,1,19,合庫-台中,2023-06-09,1021
3025,星通,61,43,18,合庫-台中,2023-06-09,1021
6288,聯嘉,43,25,18,合庫-台中,2023-06-09,1021
00715L,期街口布蘭特正2,400,3,397,合庫-台中,2023-06-12,1021
2317,鴻海,533,136,397,合庫-台中,2023-06-12,1021
00893,國泰智能電動車,386,20,366,合庫-台中,2023-06-12,1021
3711,日月光投控,397,92,305,合庫-台中,2023-06-12,1021
2888,新光金,499,281,218,合庫-台中,2023-06-12,1021
00712,復華富時不動產,138,0,138,合庫-台中,2023-06-12,1021
00929,復華台灣科技優息,132,3,129,合庫-台中,2023-06-12,1021
3025,星通,127,4,123,合庫-台中,2023-06-12,1021
3481,群創,203,89,114,合庫-台中,2023-06-12,1021
2618,長榮航,109,21,88,合庫-台中,2023-06-12,1021
2889,國票金,83,0,83,合庫-台中,2023-06-12,1021
8926,台汽電,143,63,80,合庫-台中,2023-06-12,1021
5465,富驊,92,13,79,合庫-台中,2023-06-12,1021
3363,上詮,76,0,76,合庫-台中,2023-06-12,1021
00632R,元大台灣50反1,173,101,72,合庫-台中,2023-06-12,1021
8034,榮群,76,16,60,合庫-台中,2023-06-12,1021
00919,群益台灣精選高息,59,0,59,合庫-台中,2023-06-12,1021
1513,中興電,70,15,55,合庫-台中,2023-06-12,1021
2356,英業達,94,40,54,合庫-台中,2023-06-12,1021
3027,盛達,76,22,54,合庫-台中,2023-06-12,1021
2883,凱基金,74,20,54,合庫-台中,2023-06-12,1021
2610,華航,76,25,51,合庫-台中,2023-06-12,1021
6185,幃翔,50,0,50,合庫-台中,2023-06-12,1021
3511,矽瑪,50,1,49,合庫-台中,2023-06-12,1021
2388,威盛,100,54,46,合庫-台中,2023-06-12,1021
2377,微星,43,1,42,合庫-台中,2023-06-12,1021
00642U,期元大S＆P石油,42,0,42,合庫-台中,2023-06-12,1021
3576,聯合再生,80,39,41,合庫-台中,2023-06-12,1021
1605,華新,60,20,40,合庫-台中,2023-06-12,1021
2462,良得電,40,0,40,合庫-台中,2023-06-12,1021
1515,力山,38,0,38,合庫-台中,2023-06-12,1021
3231,緯創,125,91,34,合庫-台中,2023-06-12,1021
3374,精材,41,7,34,合庫-台中,2023-06-12,1021
0056,元大高股息,56,22,34,合庫-台中,2023-06-12,1021
00670L,富邦NASDAQ正2,33,0,33,合庫-台中,2023-06-12,1021
6733,博晟生醫,50,17,33,合庫-台中,2023-06-12,1021
6443,元晶,46,13,33,合庫-台中,2023-06-12,1021
6163,華電網,37,4,33,合庫-台中,2023-06-12,1021
3615,安可,30,0,30,合庫-台中,2023-06-12,1021
4931,新盛力,35,7,28,合庫-台中,2023-06-12,1021
6789,采鈺,30,2,28,合庫-台中,2023-06-12,1021
4979,華星光,74,47,27,合庫-台中,2023-06-12,1021
2601,益航,30,3,27,合庫-台中,2023-06-12,1021
2014,中鴻,27,0,27,合庫-台中,2023-06-12,1021
2359,所羅門,27,0,27,合庫-台中,2023-06-12,1021
2743,山富,52,25,27,合庫-台中,2023-06-12,1021
4541,晟田,33,6,27,合庫-台中,2023-06-12,1021
3163,波若威,26,0,26,合庫-台中,2023-06-12,1021
2882,國泰金,26,0,26,合庫-台中,2023-06-12,1021
8358,金居,29,4,25,合庫-台中,2023-06-12,1021
00715L,期街口布蘭特正2,955,1,954,合庫-台中,2023-06-13,1021
2888,新光金,429,84,345,合庫-台中,2023-06-13,1021
00642U,期元大S＆P石油,153,0,153,合庫-台中,2023-06-13,1021
2027,大成鋼,155,33,122,合庫-台中,2023-06-13,1021
2883,凱基金,89,0,89,合庫-台中,2023-06-13,1021
00919,群益台灣精選高息,89,13,76,合庫-台中,2023-06-13,1021
1515,力山,68,2,66,合庫-台中,2023-06-13,1021
2206,三陽工業,95,30,65,合庫-台中,2023-06-13,1021
4745,合富-KY,46,0,46,合庫-台中,2023-06-13,1021
3615,安可,45,0,45,合庫-台中,2023-06-13,1021
00923,群益台ESG低碳50,46,3,43,合庫-台中,2023-06-13,1021
2603,長榮,67,27,40,合庫-台中,2023-06-13,1021
6288,聯嘉,49,12,37,合庫-台中,2023-06-13,1021
00882,中信中國高股息,39,3,36,合庫-台中,2023-06-13,1021
3289,宜特,40,4,36,合庫-台中,2023-06-13,1021
00885,富邦越南,51,18,33,合庫-台中,2023-06-13,1021
6122,擎邦,36,4,32,合庫-台中,2023-06-13,1021
2515,中工,32,1,31,合庫-台中,2023-06-13,1021
1609,大亞,123,92,31,合庫-台中,2023-06-13,1021
2031,新光鋼,30,0,30,合庫-台中,2023-06-13,1021
2351,順德,44,14,30,合庫-台中,2023-06-13,1021
00929,復華台灣科技優息,57,28,29,合庫-台中,2023-06-13,1021
0056,元大高股息,85,56,29,合庫-台中,2023-06-13,1021
00712,復華富時不動產,58,30,28,合庫-台中,2023-06-13,1021
6245,立端,33,6,27,合庫-台中,2023-06-13,1021
6668,中揚光,27,0,27,合庫-台中,2023-06-13,1021
6205,詮欣,32,6,26,合庫-台中,2023-06-13,1021
2736,富野,26,0,26,合庫-台中,2023-06-13,1021
1104,環泥,30,5,25,合庫-台中,2023-06-13,1021
3441,聯一光,25,0,25,合庫-台中,2023-06-13,1021
2601,益航,23,0,23,合庫-台中,2023-06-13,1021
2349,錸德,22,0,22,合庫-台中,2023-06-13,1021
8171,天宇,20,0,20,合庫-台中,2023-06-13,1021
2062,橋椿,20,0,20,合庫-台中,2023-06-13,1021
00753L,中信中國50正2,23,3,20,合庫-台中,2023-06-13,1021
3576,聯合再生,36,17,19,合庫-台中,2023-06-13,1021
00892,富邦台灣半導體,20,1,19,合庫-台中,2023-06-13,1021
6125,廣運,78,59,19,合庫-台中,2023-06-13,1021
6244,茂迪,19,1,18,合庫-台中,2023-06-13,1021
2488,漢平,17,0,17,合庫-台中,2023-06-13,1021
3260,威剛,17,0,17,合庫-台中,2023-06-13,1021
00927,群益半導體收益,16,0,16,合庫-台中,2023-06-13,1021
2354,鴻準,21,5,16,合庫-台中,2023-06-13,1021
9939,宏全,15,0,15,合庫-台中,2023-06-13,1021
2328,廣宇,14,0,14,合庫-台中,2023-06-13,1021
2881,富邦金,13,0,13,合庫-台中,2023-06-13,1021
1785,光洋科,14,1,13,合庫-台中,2023-06-13,1021
5258,虹堡,40,27,13,合庫-台中,2023-06-13,1021
8150,南茂,12,0,12,合庫-台中,2023-06-13,1021
6532,瑞耘,12,1,11,合庫-台中,2023-06-13,1021
3711,日月光投控,519,9,510,合庫-台中,2023-06-14,1021
2888,新光金,278,78,200,合庫-台中,2023-06-14,1021
2356,英業達,389,189,200,合庫-台中,2023-06-14,1021
00919,群益台灣精選高息,173,1,172,合庫-台中,2023-06-14,1021
00673R,期元大S＆P原油反1,114,5,109,合庫-台中,2023-06-14,1021
00712,復華富時不動產,114,7,107,合庫-台中,2023-06-14,1021
2609,陽明,227,125,102,合庫-台中,2023-06-14,1021
00893,國泰智能電動車,139,37,102,合庫-台中,2023-06-14,1021
00632R,元大台灣50反1,157,75,82,合庫-台中,2023-06-14,1021
4533,協易機,172,99,73,合庫-台中,2023-06-14,1021
2344,華邦電,120,64,56,合庫-台中,2023-06-14,1021
2457,飛宏,73,18,55,合庫-台中,2023-06-14,1021
5531,鄉林,50,0,50,合庫-台中,2023-06-14,1021
4543,萬在,56,8,48,合庫-台中,2023-06-14,1021
00679B,元大美債20年,47,0,47,合庫-台中,2023-06-14,1021
2630,亞航,87,41,46,合庫-台中,2023-06-14,1021
1104,環泥,57,11,46,合庫-台中,2023-06-14,1021
6282,康舒,60,15,45,合庫-台中,2023-06-14,1021
2388,威盛,41,0,41,合庫-台中,2023-06-14,1021
00923,群益台ESG低碳50,41,0,41,合庫-台中,2023-06-14,1021
1522,堤維西,81,41,40,合庫-台中,2023-06-14,1021
2482,連宇,79,39,40,合庫-台中,2023-06-14,1021
3011,今皓,40,0,40,合庫-台中,2023-06-14,1021
00882,中信中國高股息,38,0,38,合庫-台中,2023-06-14,1021
4564,元翎,41,3,38,合庫-台中,2023-06-14,1021
1806,冠軍,169,133,36,合庫-台中,2023-06-14,1021
00720B,元大投資級公司債,36,1,35,合庫-台中,2023-06-14,1021
4129,聯合,37,4,33,合庫-台中,2023-06-14,1021
8076,伍豐,43,10,33,合庫-台中,2023-06-14,1021
3689,湧德,34,3,31,合庫-台中,2023-06-14,1021
8050,廣積,44,13,31,合庫-台中,2023-06-14,1021
5521,工信,30,0,30,合庫-台中,2023-06-14,1021
4919,新唐,46,19,27,合庫-台中,2023-06-14,1021
00751B,元大AAA至A公司債,26,0,26,合庫-台中,2023-06-14,1021
3576,聯合再生,26,1,25,合庫-台中,2023-06-14,1021
00687B,國泰20年美債,24,0,24,合庫-台中,2023-06-14,1021
5465,富驊,92,70,22,合庫-台中,2023-06-14,1021
2352,佳世達,23,1,22,合庫-台中,2023-06-14,1021
00666R,富邦�琤肭磪齯�1,30,9,21,合庫-台中,2023-06-14,1021
2425,承啟,23,2,21,合庫-台中,2023-06-14,1021
1504,東元,22,2,20,合庫-台中,2023-06-14,1021
1529,樂事綠能,34,14,20,合庫-台中,2023-06-14,1021
2349,錸德,20,0,20,合庫-台中,2023-06-14,1021
4510,高鋒,23,3,20,合庫-台中,2023-06-14,1021
1409,新纖,20,0,20,合庫-台中,2023-06-14,1021
3491,昇達科,20,0,20,合庫-台中,2023-06-14,1021
6441,廣錠,20,0,20,合庫-台中,2023-06-14,1021
6185,幃翔,20,0,20,合庫-台中,2023-06-14,1021
2634,漢翔,28,9,19,合庫-台中,2023-06-14,1021
1524,耿鼎,31,12,19,合庫-台中,2023-06-14,1021
4533,協易機,388,56,332,合庫-台中,2023-06-15,1021
2618,長榮航,592,349,243,合庫-台中,2023-06-15,1021
00919,群益台灣精選高息,252,56,196,合庫-台中,2023-06-15,1021
2888,新光金,172,44,128,合庫-台中,2023-06-15,1021
6770,力積電,125,10,115,合庫-台中,2023-06-15,1021
3615,安可,113,0,113,合庫-台中,2023-06-15,1021
2834,臺企銀,102,6,96,合庫-台中,2023-06-15,1021
1806,冠軍,153,64,89,合庫-台中,2023-06-15,1021
00712,復華富時不動產,113,46,67,合庫-台中,2023-06-15,1021
00882,中信中國高股息,62,0,62,合庫-台中,2023-06-15,1021
2409,友達,75,15,60,合庫-台中,2023-06-15,1021
3689,湧德,70,11,59,合庫-台中,2023-06-15,1021
3576,聯合再生,114,60,54,合庫-台中,2023-06-15,1021
1609,大亞,84,30,54,合庫-台中,2023-06-15,1021
00720B,元大投資級公司債,61,10,51,合庫-台中,2023-06-15,1021
1515,力山,50,4,46,合庫-台中,2023-06-15,1021
1314,中石化,50,5,45,合庫-台中,2023-06-15,1021
00632R,元大台灣50反1,157,113,44,合庫-台中,2023-06-15,1021
8926,台汽電,84,43,41,合庫-台中,2023-06-15,1021
2382,廣達,52,11,41,合庫-台中,2023-06-15,1021
3260,威剛,46,6,40,合庫-台中,2023-06-15,1021
2002,中鋼,40,1,39,合庫-台中,2023-06-15,1021
3163,波若威,45,10,35,合庫-台中,2023-06-15,1021
3305,昇貿,35,0,35,合庫-台中,2023-06-15,1021
9945,潤泰新,41,7,34,合庫-台中,2023-06-15,1021
2352,佳世達,47,15,32,合庫-台中,2023-06-15,1021
8147,正淩,28,0,28,合庫-台中,2023-06-15,1021
00715L,期街口布蘭特正2,341,315,26,合庫-台中,2023-06-15,1021
2883,凱基金,39,14,25,合庫-台中,2023-06-15,1021
3441,聯一光,25,0,25,合庫-台中,2023-06-15,1021
1714,和桐,25,0,25,合庫-台中,2023-06-15,1021
2488,漢平,24,0,24,合庫-台中,2023-06-15,1021
6116,彩晶,25,2,23,合庫-台中,2023-06-15,1021
3055,蔚華科,27,4,23,合庫-台中,2023-06-15,1021
1102,亞泥,22,1,21,合庫-台中,2023-06-15,1021
3356,奇偶,56,35,21,合庫-台中,2023-06-15,1021
00929,復華台灣科技優息,27,7,20,合庫-台中,2023-06-15,1021
00753L,中信中國50正2,30,10,20,合庫-台中,2023-06-15,1021
00666R,富邦�琤肭磪齯�1,22,2,20,合庫-台中,2023-06-15,1021
2816,旺旺保,20,0,20,合庫-台中,2023-06-15,1021
3231,緯創,198,178,20,合庫-台中,2023-06-15,1021
3033,威健,23,3,20,合庫-台中,2023-06-15,1021
8027,鈦昇,20,0,20,合庫-台中,2023-06-15,1021
8927,北基,20,0,20,合庫-台中,2023-06-15,1021
2706,第一店,20,0,20,合庫-台中,2023-06-15,1021
2401,凌陽,45,25,20,合庫-台中,2023-06-15,1021
4916,事欣科,20,1,19,合庫-台中,2023-06-15,1021
2614,東森,20,2,18,合庫-台中,2023-06-15,1021
2062,橋椿,18,0,18,合庫-台中,2023-06-15,1021
00713,元大台灣高息低波,25,7,18,合庫-台中,2023-06-15,1021
2618,長榮航,574,219,355,合庫-台中,2023-06-16,1021
2888,新光金,352,14,338,合庫-台中,2023-06-16,1021
2610,華航,859,553,306,合庫-台中,2023-06-16,1021
00712,復華富時不動產,258,26,232,合庫-台中,2023-06-16,1021
00919,群益台灣精選高息,177,13,164,合庫-台中,2023-06-16,1021
3025,星通,122,10,112,合庫-台中,2023-06-16,1021
00632R,元大台灣50反1,150,40,110,合庫-台中,2023-06-16,1021
2601,益航,100,0,100,合庫-台中,2023-06-16,1021
1605,華新,198,98,100,合庫-台中,2023-06-16,1021
2027,大成鋼,103,17,86,合庫-台中,2023-06-16,1021
9105,泰金寶-DR,84,0,84,合庫-台中,2023-06-16,1021
8926,台汽電,102,20,82,合庫-台中,2023-06-16,1021
2371,大同,209,130,79,合庫-台中,2023-06-16,1021
2002,中鋼,79,3,76,合庫-台中,2023-06-16,1021
5880,合庫金,77,3,74,合庫-台中,2023-06-16,1021
2883,凱基金,80,12,68,合庫-台中,2023-06-16,1021
00713,元大台灣高息低波,81,15,66,合庫-台中,2023-06-16,1021
00893,國泰智能電動車,81,26,55,合庫-台中,2023-06-16,1021
2845,遠東銀,51,0,51,合庫-台中,2023-06-16,1021
1806,冠軍,140,89,51,合庫-台中,2023-06-16,1021
00647L,元大S＆P500正2,46,0,46,合庫-台中,2023-06-16,1021
4128,中天,48,2,46,合庫-台中,2023-06-16,1021
3013,晟銘電,68,25,43,合庫-台中,2023-06-16,1021
2801,彰銀,83,41,42,合庫-台中,2023-06-16,1021
00929,復華台灣科技優息,46,4,42,合庫-台中,2023-06-16,1021
4174,浩鼎,41,0,41,合庫-台中,2023-06-16,1021
2377,微星,40,1,39,合庫-台中,2023-06-16,1021
3481,群創,251,214,37,合庫-台中,2023-06-16,1021
1515,力山,49,13,36,合庫-台中,2023-06-16,1021
2308,台達電,45,10,35,合庫-台中,2023-06-16,1021
3231,緯創,149,115,34,合庫-台中,2023-06-16,1021
9945,潤泰新,44,10,34,合庫-台中,2023-06-16,1021
1905,華紙,84,52,32,合庫-台中,2023-06-16,1021
9136,巨騰-DR,30,0,30,合庫-台中,2023-06-16,1021
2327,國巨,28,0,28,合庫-台中,2023-06-16,1021
1519,華城,109,82,27,合庫-台中,2023-06-16,1021
1522,堤維西,83,58,25,合庫-台中,2023-06-16,1021
3706,神達,113,90,23,合庫-台中,2023-06-16,1021
2886,兆豐金,24,1,23,合庫-台中,2023-06-16,1021
8411,福貞-KY,23,0,23,合庫-台中,2023-06-16,1021
00666R,富邦�琤肭磪齯�1,21,0,21,合庫-台中,2023-06-16,1021
2915,潤泰全,21,0,21,合庫-台中,2023-06-16,1021
2882,國泰金,22,1,21,合庫-台中,2023-06-16,1021
5465,富驊,25,5,20,合庫-台中,2023-06-16,1021
1524,耿鼎,23,3,20,合庫-台中,2023-06-16,1021
2489,瑞軒,19,0,19,合庫-台中,2023-06-16,1021
6441,廣錠,20,2,18,合庫-台中,2023-06-16,1021
3046,建��,17,0,17,合庫-台中,2023-06-16,1021
6443,元晶,27,10,17,合庫-台中,2023-06-16,1021
0056,元大高股息,49,32,17,合庫-台中,2023-06-16,1021
00712,復華富時不動產,357,68,289,合庫-台中,2023-06-19,1021
00637L,元大滬深300正2,204,14,190,合庫-台中,2023-06-19,1021
2630,亞航,164,56,108,合庫-台中,2023-06-19,1021
2609,陽明,141,40,101,合庫-台中,2023-06-19,1021
1609,大亞,115,30,85,合庫-台中,2023-06-19,1021
2498,宏達電,83,2,81,合庫-台中,2023-06-19,1021
1513,中興電,199,122,77,合庫-台中,2023-06-19,1021
8033,雷虎,89,13,76,合庫-台中,2023-06-19,1021
00929,復華台灣科技優息,75,1,74,合庫-台中,2023-06-19,1021
00882,中信中國高股息,71,2,69,合庫-台中,2023-06-19,1021
6282,康舒,101,32,69,合庫-台中,2023-06-19,1021
0056,元大高股息,85,18,67,合庫-台中,2023-06-19,1021
4564,元翎,66,2,64,合庫-台中,2023-06-19,1021
00919,群益台灣精選高息,69,6,63,合庫-台中,2023-06-19,1021
2324,仁寶,100,42,58,合庫-台中,2023-06-19,1021
00921,兆豐龍頭等權重,52,0,52,合庫-台中,2023-06-19,1021
8038,長園科,51,0,51,合庫-台中,2023-06-19,1021
2356,英業達,77,30,47,合庫-台中,2023-06-19,1021
00673R,期元大S＆P原油反1,41,0,41,合庫-台中,2023-06-19,1021
2883,凱基金,59,19,40,合庫-台中,2023-06-19,1021
1584,精剛,72,33,39,合庫-台中,2023-06-19,1021
2353,宏��,38,0,38,合庫-台中,2023-06-19,1021
5426,振發,36,0,36,合庫-台中,2023-06-19,1021
2388,威盛,41,9,32,合庫-台中,2023-06-19,1021
2887,台新金,32,0,32,合庫-台中,2023-06-19,1021
2344,華邦電,253,224,29,合庫-台中,2023-06-19,1021
1806,冠軍,74,46,28,合庫-台中,2023-06-19,1021
2603,長榮,45,19,26,合庫-台中,2023-06-19,1021
00640L,富邦日本正2,25,0,25,合庫-台中,2023-06-19,1021
2610,華航,215,191,24,合庫-台中,2023-06-19,1021
6443,元晶,25,2,23,合庫-台中,2023-06-19,1021
1503,士電,30,8,22,合庫-台中,2023-06-19,1021
1611,中電,21,0,21,合庫-台中,2023-06-19,1021
2618,長榮航,122,101,21,合庫-台中,2023-06-19,1021
2834,臺企銀,30,10,20,合庫-台中,2023-06-19,1021
8105,凌巨,21,1,20,合庫-台中,2023-06-19,1021
1314,中石化,20,0,20,合庫-台中,2023-06-19,1021
00665L,富邦�琤肭磪囓�2,20,0,20,合庫-台中,2023-06-19,1021
6743,安普新,20,0,20,合庫-台中,2023-06-19,1021
3498,陽程,20,0,20,合庫-台中,2023-06-19,1021
2104,國際中橡,27,7,20,合庫-台中,2023-06-19,1021
3051,力特,20,0,20,合庫-台中,2023-06-19,1021
1907,永豐餘,24,5,19,合庫-台中,2023-06-19,1021
2352,佳世達,38,20,18,合庫-台中,2023-06-19,1021
3078,僑威,57,39,18,合庫-台中,2023-06-19,1021
3059,華晶科,21,3,18,合庫-台中,2023-06-19,1021
2427,三商電,27,10,17,合庫-台中,2023-06-19,1021
2468,華經,34,17,17,合庫-台中,2023-06-19,1021
2886,兆豐金,28,12,16,合庫-台中,2023-06-19,1021
1522,堤維西,36,20,16,合庫-台中,2023-06-19,1021
2610,華航,229,90,139,合庫-台中,2023-06-20,1021
00878,國泰永續高股息,158,21,137,合庫-台中,2023-06-20,1021
2618,長榮航,209,84,125,合庫-台中,2023-06-20,1021
9136,巨騰-DR,116,0,116,合庫-台中,2023-06-20,1021
3615,安可,85,0,85,合庫-台中,2023-06-20,1021
2356,英業達,99,18,81,合庫-台中,2023-06-20,1021
3576,聯合再生,85,9,76,合庫-台中,2023-06-20,1021
00632R,元大台灣50反1,135,63,72,合庫-台中,2023-06-20,1021
00673R,期元大S＆P原油反1,123,55,68,合庫-台中,2023-06-20,1021
3056,富華新,86,22,64,合庫-台中,2023-06-20,1021
2337,旺宏,64,2,62,合庫-台中,2023-06-20,1021
00683L,期元大美元指正2,63,6,57,合庫-台中,2023-06-20,1021
3481,群創,346,290,56,合庫-台中,2023-06-20,1021
5512,力麒,55,0,55,合庫-台中,2023-06-20,1021
4564,元翎,55,1,54,合庫-台中,2023-06-20,1021
2303,聯電,61,9,52,合庫-台中,2023-06-20,1021
1460,宏遠,50,0,50,合庫-台中,2023-06-20,1021
3380,明泰,80,31,49,合庫-台中,2023-06-20,1021
2890,永豐金,47,0,47,合庫-台中,2023-06-20,1021
1733,五鼎,47,0,47,合庫-台中,2023-06-20,1021
4533,協易機,51,5,46,合庫-台中,2023-06-20,1021
2801,彰銀,94,50,44,合庫-台中,2023-06-20,1021
4129,聯合,42,0,42,合庫-台中,2023-06-20,1021
6111,大宇資,58,16,42,合庫-台中,2023-06-20,1021
2883,凱基金,43,1,42,合庫-台中,2023-06-20,1021
2454,聯發科,59,18,41,合庫-台中,2023-06-20,1021
00713,元大台灣高息低波,54,14,40,合庫-台中,2023-06-20,1021
00929,復華台灣科技優息,42,8,34,合庫-台中,2023-06-20,1021
4934,太極,44,10,34,合庫-台中,2023-06-20,1021
2461,光群雷,32,0,32,合庫-台中,2023-06-20,1021
1432,大魯閣,32,1,31,合庫-台中,2023-06-20,1021
2104,國際中橡,37,7,30,合庫-台中,2023-06-20,1021
2408,南亞科,50,21,29,合庫-台中,2023-06-20,1021
00712,復華富時不動產,32,7,25,合庫-台中,2023-06-20,1021
6147,頎邦,23,0,23,合庫-台中,2023-06-20,1021
9949,琉園,23,0,23,合庫-台中,2023-06-20,1021
8358,金居,30,7,23,合庫-台中,2023-06-20,1021
2880,華南金,23,0,23,合庫-台中,2023-06-20,1021
00751B,元大AAA至A公司債,23,0,23,合庫-台中,2023-06-20,1021
5351,鈺創,27,5,22,合庫-台中,2023-06-20,1021
5905,南仁湖,95,73,22,合庫-台中,2023-06-20,1021
5465,富驊,23,1,22,合庫-台中,2023-06-20,1021
2885,元大金,22,0,22,合庫-台中,2023-06-20,1021
8926,台汽電,33,12,21,合庫-台中,2023-06-20,1021
2201,裕隆,26,5,21,合庫-台中,2023-06-20,1021
8033,雷虎,26,6,20,合庫-台中,2023-06-20,1021
1810,和成,31,11,20,合庫-台中,2023-06-20,1021
6243,迅杰,20,0,20,合庫-台中,2023-06-20,1021
4904,遠傳,25,5,20,合庫-台中,2023-06-20,1021
1737,臺鹽,20,1,19,合庫-台中,2023-06-20,1021
2634,漢翔,347,145,202,合庫-台中,2023-06-21,1021
9136,巨騰-DR,214,54,160,合庫-台中,2023-06-21,1021
2609,陽明,114,6,108,合庫-台中,2023-06-21,1021
2337,旺宏,101,4,97,合庫-台中,2023-06-21,1021
00893,國泰智能電動車,203,122,81,合庫-台中,2023-06-21,1021
3615,安可,65,0,65,合庫-台中,2023-06-21,1021
4916,事欣科,84,23,61,合庫-台中,2023-06-21,1021
2323,中環,115,60,55,合庫-台中,2023-06-21,1021
2890,永豐金,53,0,53,合庫-台中,2023-06-21,1021
00919,群益台灣精選高息,52,0,52,合庫-台中,2023-06-21,1021
5351,鈺創,54,3,51,合庫-台中,2023-06-21,1021
6120,達運,53,4,49,合庫-台中,2023-06-21,1021
6177,達麗,46,0,46,合庫-台中,2023-06-21,1021
2883,凱基金,49,8,41,合庫-台中,2023-06-21,1021
00673R,期元大S＆P原油反1,46,7,39,合庫-台中,2023-06-21,1021
2303,聯電,108,70,38,合庫-台中,2023-06-21,1021
5531,鄉林,60,25,35,合庫-台中,2023-06-21,1021
2603,長榮,61,27,34,合庫-台中,2023-06-21,1021
2002,中鋼,34,0,34,合庫-台中,2023-06-21,1021
3013,晟銘電,61,28,33,合庫-台中,2023-06-21,1021
5324,士開,32,0,32,合庫-台中,2023-06-21,1021
00907,永豐優息存股,31,0,31,合庫-台中,2023-06-21,1021
8121,越峰,33,2,31,合庫-台中,2023-06-21,1021
5258,虹堡,75,48,27,合庫-台中,2023-06-21,1021
2736,富野,48,23,25,合庫-台中,2023-06-21,1021
6182,合晶,25,0,25,合庫-台中,2023-06-21,1021
2801,彰銀,24,0,24,合庫-台中,2023-06-21,1021
2601,益航,24,0,24,合庫-台中,2023-06-21,1021
1605,華新,45,21,24,合庫-台中,2023-06-21,1021
4129,聯合,23,0,23,合庫-台中,2023-06-21,1021
2889,國票金,24,1,23,合庫-台中,2023-06-21,1021
00712,復華富時不動產,24,1,23,合庫-台中,2023-06-21,1021
4419,皇家美食,23,0,23,合庫-台中,2023-06-21,1021
1721,三晃,90,68,22,合庫-台中,2023-06-21,1021
6531,愛普*,24,3,21,合庫-台中,2023-06-21,1021
1802,台玻,35,14,21,合庫-台中,2023-06-21,1021
1609,大亞,43,23,20,合庫-台中,2023-06-21,1021
2317,鴻海,47,27,20,合庫-台中,2023-06-21,1021
4543,萬在,31,11,20,合庫-台中,2023-06-21,1021
1611,中電,20,0,20,合庫-台中,2023-06-21,1021
6282,康舒,48,29,19,合庫-台中,2023-06-21,1021
1504,東元,23,4,19,合庫-台中,2023-06-21,1021
1513,中興電,165,147,18,合庫-台中,2023-06-21,1021
3037,欣興,63,45,18,合庫-台中,2023-06-21,1021
6217,中探針,25,7,18,合庫-台中,2023-06-21,1021
5905,南仁湖,16,0,16,合庫-台中,2023-06-21,1021
2702,華園,32,17,15,合庫-台中,2023-06-21,1021
1447,力鵬,15,0,15,合庫-台中,2023-06-21,1021
2739,寒舍,18,3,15,合庫-台中,2023-06-21,1021
00882,中信中國高股息,15,1,14,合庫-台中,2023-06-21,1021
3615,安可,240,0,240,合庫-台中,2023-06-26,1021
00715L,期街口布蘭特正2,230,5,225,合庫-台中,2023-06-26,1021
2409,友達,143,36,107,合庫-台中,2023-06-26,1021
00713,元大台灣高息低波,81,1,80,合庫-台中,2023-06-26,1021
4533,協易機,88,11,77,合庫-台中,2023-06-26,1021
1605,華新,76,7,69,合庫-台中,2023-06-26,1021
3706,神達,122,55,67,合庫-台中,2023-06-26,1021
3481,群創,386,323,63,合庫-台中,2023-06-26,1021
00929,復華台灣科技優息,61,0,61,合庫-台中,2023-06-26,1021
9136,巨騰-DR,56,0,56,合庫-台中,2023-06-26,1021
6177,達麗,55,0,55,合庫-台中,2023-06-26,1021
3049,精金,54,2,52,合庫-台中,2023-06-26,1021
2610,華航,121,70,51,合庫-台中,2023-06-26,1021
2867,三商壽,66,15,51,合庫-台中,2023-06-26,1021
4543,萬在,122,75,47,合庫-台中,2023-06-26,1021
3032,偉訓,63,19,44,合庫-台中,2023-06-26,1021
2601,益航,41,0,41,合庫-台中,2023-06-26,1021
2323,中環,109,69,40,合庫-台中,2023-06-26,1021
1710,東聯,41,1,40,合庫-台中,2023-06-26,1021
1471,首利,45,7,38,合庫-台中,2023-06-26,1021
2344,華邦電,72,35,37,合庫-台中,2023-06-26,1021
1504,東元,50,14,36,合庫-台中,2023-06-26,1021
0056,元大高股息,49,13,36,合庫-台中,2023-06-26,1021
00893,國泰智能電動車,63,27,36,合庫-台中,2023-06-26,1021
1472,三洋實業,35,0,35,合庫-台中,2023-06-26,1021
4968,立積,42,7,35,合庫-台中,2023-06-26,1021
2303,聯電,96,63,33,合庫-台中,2023-06-26,1021
3025,星通,40,7,33,合庫-台中,2023-06-26,1021
4967,十銓,32,0,32,合庫-台中,2023-06-26,1021
5351,鈺創,30,0,30,合庫-台中,2023-06-26,1021
2883,凱基金,31,1,30,合庫-台中,2023-06-26,1021
9907,統一實,30,0,30,合庫-台中,2023-06-26,1021
2457,飛宏,33,5,28,合庫-台中,2023-06-26,1021
6148,驊宏資,28,0,28,合庫-台中,2023-06-26,1021
4931,新盛力,27,0,27,合庫-台中,2023-06-26,1021
1802,台玻,59,33,26,合庫-台中,2023-06-26,1021
2382,廣達,46,21,25,合庫-台中,2023-06-26,1021
2317,鴻海,65,40,25,合庫-台中,2023-06-26,1021
3523,迎輝,24,0,24,合庫-台中,2023-06-26,1021
2885,元大金,24,1,23,合庫-台中,2023-06-26,1021
2801,彰銀,23,0,23,合庫-台中,2023-06-26,1021
00642U,期元大S＆P石油,24,2,22,合庫-台中,2023-06-26,1021
2436,偉詮電,22,0,22,合庫-台中,2023-06-26,1021
4564,元翎,37,15,22,合庫-台中,2023-06-26,1021
3703,欣陸,22,0,22,合庫-台中,2023-06-26,1021
6770,力積電,25,3,22,合庫-台中,2023-06-26,1021
1904,正隆,45,23,22,合庫-台中,2023-06-26,1021
3037,欣興,28,6,22,合庫-台中,2023-06-26,1021
3231,緯創,77,57,20,合庫-台中,2023-06-26,1021
2890,永豐金,20,1,19,合庫-台中,2023-06-26,1021
3711,日月光投控,521,11,510,合庫-台中,2023-06-27,1021
3523,迎輝,291,0,291,合庫-台中,2023-06-27,1021
3706,神達,310,42,268,合庫-台中,2023-06-27,1021
2303,聯電,228,10,218,合庫-台中,2023-06-27,1021
2634,漢翔,294,77,217,合庫-台中,2023-06-27,1021
2371,大同,198,72,126,合庫-台中,2023-06-27,1021
00665L,富邦�琤肭磪囓�2,240,125,115,合庫-台中,2023-06-27,1021
2881,富邦金,119,10,109,合庫-台中,2023-06-27,1021
2867,三商壽,100,0,100,合庫-台中,2023-06-27,1021
2317,鴻海,113,26,87,合庫-台中,2023-06-27,1021
3615,安可,85,0,85,合庫-台中,2023-06-27,1021
1605,華新,97,12,85,合庫-台中,2023-06-27,1021
1905,華紙,104,37,67,合庫-台中,2023-06-27,1021
2887,台新金,62,1,61,合庫-台中,2023-06-27,1021
00830,國泰費城半導體,60,3,57,合庫-台中,2023-06-27,1021
4533,協易機,67,11,56,合庫-台中,2023-06-27,1021
00919,群益台灣精選高息,55,0,55,合庫-台中,2023-06-27,1021
2883,凱基金,57,2,55,合庫-台中,2023-06-27,1021
2618,長榮航,370,318,52,合庫-台中,2023-06-27,1021
2344,華邦電,84,33,51,合庫-台中,2023-06-27,1021
4916,事欣科,63,16,47,合庫-台中,2023-06-27,1021
3481,群創,118,72,46,合庫-台中,2023-06-27,1021
00713,元大台灣高息低波,64,18,46,合庫-台中,2023-06-27,1021
6116,彩晶,70,24,46,合庫-台中,2023-06-27,1021
1301,台塑,43,0,43,合庫-台中,2023-06-27,1021
1907,永豐餘,94,52,42,合庫-台中,2023-06-27,1021
5351,鈺創,41,0,41,合庫-台中,2023-06-27,1021
2889,國票金,37,0,37,合庫-台中,2023-06-27,1021
2323,中環,286,249,37,合庫-台中,2023-06-27,1021
6806,森崴能源,31,0,31,合庫-台中,2023-06-27,1021
5531,鄉林,31,0,31,合庫-台中,2023-06-27,1021
1529,樂事綠能,38,8,30,合庫-台中,2023-06-27,1021
1445,大宇,30,0,30,合庫-台中,2023-06-27,1021
00706L,期元大S＆P日圓正2,30,0,30,合庫-台中,2023-06-27,1021
2891,中信金,36,6,30,合庫-台中,2023-06-27,1021
00929,復華台灣科技優息,30,0,30,合庫-台中,2023-06-27,1021
3038,全台,41,12,29,合庫-台中,2023-06-27,1021
2614,東森,26,0,26,合庫-台中,2023-06-27,1021
2387,精元,48,23,25,合庫-台中,2023-06-27,1021
6125,廣運,40,16,24,合庫-台中,2023-06-27,1021
6191,精成科,25,1,24,合庫-台中,2023-06-27,1021
8213,志超,24,0,24,合庫-台中,2023-06-27,1021
1514,亞力,42,18,24,合庫-台中,2023-06-27,1021
2337,旺宏,31,8,23,合庫-台中,2023-06-27,1021
2458,義隆,22,0,22,合庫-台中,2023-06-27,1021
8940,新天地,24,2,22,合庫-台中,2023-06-27,1021
2801,彰銀,23,2,21,合庫-台中,2023-06-27,1021
2601,益航,21,0,21,合庫-台中,2023-06-27,1021
8358,金居,29,8,21,合庫-台中,2023-06-27,1021
2515,中工,20,0,20,合庫-台中,2023-06-27,1021
00715L,期街口布蘭特正2,930,15,915,合庫-台中,2023-06-28,1021
2409,友達,153,14,139,合庫-台中,2023-06-28,1021
3706,神達,120,5,115,合庫-台中,2023-06-28,1021
1605,華新,178,74,104,合庫-台中,2023-06-28,1021
4533,協易機,101,1,100,合庫-台中,2023-06-28,1021
6111,大宇資,96,8,88,合庫-台中,2023-06-28,1021
2603,長榮,91,7,84,合庫-台中,2023-06-28,1021
00642U,期元大S＆P石油,83,0,83,合庫-台中,2023-06-28,1021
4904,遠傳,73,0,73,合庫-台中,2023-06-28,1021
3615,安可,72,0,72,合庫-台中,2023-06-28,1021
2025,千興,58,0,58,合庫-台中,2023-06-28,1021
2736,富野,54,5,49,合庫-台中,2023-06-28,1021
2323,中環,134,85,49,合庫-台中,2023-06-28,1021
00885,富邦越南,70,22,48,合庫-台中,2023-06-28,1021
9136,巨騰-DR,45,0,45,合庫-台中,2023-06-28,1021
2834,臺企銀,50,6,44,合庫-台中,2023-06-28,1021
3011,今皓,44,1,43,合庫-台中,2023-06-28,1021
2801,彰銀,42,0,42,合庫-台中,2023-06-28,1021
00919,群益台灣精選高息,39,0,39,合庫-台中,2023-06-28,1021
00706L,期元大S＆P日圓正2,38,0,38,合庫-台中,2023-06-28,1021
2887,台新金,36,0,36,合庫-台中,2023-06-28,1021
4916,事欣科,95,60,35,合庫-台中,2023-06-28,1021
2303,聯電,39,7,32,合庫-台中,2023-06-28,1021
1301,台塑,32,0,32,合庫-台中,2023-06-28,1021
2883,凱基金,30,0,30,合庫-台中,2023-06-28,1021
2867,三商壽,30,0,30,合庫-台中,2023-06-28,1021
1609,大亞,29,1,28,合庫-台中,2023-06-28,1021
3596,智易,29,1,28,合庫-台中,2023-06-28,1021
1714,和桐,27,0,27,合庫-台中,2023-06-28,1021
1504,東元,45,19,26,合庫-台中,2023-06-28,1021
2337,旺宏,29,4,25,合庫-台中,2023-06-28,1021
2107,厚生,25,0,25,合庫-台中,2023-06-28,1021
6177,達麗,25,0,25,合庫-台中,2023-06-28,1021
2913,農林,28,4,24,合庫-台中,2023-06-28,1021
2734,易飛網,22,0,22,合庫-台中,2023-06-28,1021
2610,華航,218,197,21,合庫-台中,2023-06-28,1021
4906,正文,91,70,21,合庫-台中,2023-06-28,1021
2313,華通,102,82,20,合庫-台中,2023-06-28,1021
3432,台端,20,0,20,合庫-台中,2023-06-28,1021
2405,輔信,22,3,19,合庫-台中,2023-06-28,1021
8111,立��,17,0,17,合庫-台中,2023-06-28,1021
8936,國統,31,14,17,合庫-台中,2023-06-28,1021
4106,雃博,43,28,15,合庫-台中,2023-06-28,1021
1513,中興電,33,19,14,合庫-台中,2023-06-28,1021
5880,合庫金,24,10,14,合庫-台中,2023-06-28,1021
2376,技嘉,24,10,14,合庫-台中,2023-06-28,1021
2888,新光金,15,1,14,合庫-台中,2023-06-28,1021
2069,運錩,16,3,13,合庫-台中,2023-06-28,1021
3045,台灣大,14,1,13,合庫-台中,2023-06-28,1021
6188,廣明,21,9,12,合庫-台中,2023-06-28,1021
00893,國泰智能電動車,586,0,586,合庫-台中,2023-06-29,1021
2303,聯電,184,2,182,合庫-台中,2023-06-29,1021
4414,如興,218,44,174,合庫-台中,2023-06-29,1021
2618,長榮航,283,149,134,合庫-台中,2023-06-29,1021
2419,仲琦,306,212,94,合庫-台中,2023-06-29,1021
1909,榮成,101,11,90,合庫-台中,2023-06-29,1021
3615,安可,88,0,88,合庫-台中,2023-06-29,1021
2323,中環,128,43,85,合庫-台中,2023-06-29,1021
4967,十銓,107,26,81,合庫-台中,2023-06-29,1021
4904,遠傳,80,10,70,合庫-台中,2023-06-29,1021
1605,華新,77,15,62,合庫-台中,2023-06-29,1021
00637L,元大滬深300正2,51,1,50,合庫-台中,2023-06-29,1021
00674R,期元大S＆P黃金反1,50,0,50,合庫-台中,2023-06-29,1021
2462,良得電,51,12,39,合庫-台中,2023-06-29,1021
3005,神基,37,0,37,合庫-台中,2023-06-29,1021
2317,鴻海,44,8,36,合庫-台中,2023-06-29,1021
00882,中信中國高股息,34,0,34,合庫-台中,2023-06-29,1021
6589,台康生技,91,59,32,合庫-台中,2023-06-29,1021
6142,友勁,32,0,32,合庫-台中,2023-06-29,1021
2885,元大金,30,1,29,合庫-台中,2023-06-29,1021
2444,兆勁,28,0,28,合庫-台中,2023-06-29,1021
8038,長園科,26,0,26,合庫-台中,2023-06-29,1021
1710,東聯,24,0,24,合庫-台中,2023-06-29,1021
00878,國泰永續高股息,35,11,24,合庫-台中,2023-06-29,1021
5302,太欣,23,0,23,合庫-台中,2023-06-29,1021
3523,迎輝,22,0,22,合庫-台中,2023-06-29,1021
5009,榮剛,34,12,22,合庫-台中,2023-06-29,1021
00885,富邦越南,30,9,21,合庫-台中,2023-06-29,1021
2495,普安,21,0,21,合庫-台中,2023-06-29,1021
2405,輔信,20,0,20,合庫-台中,2023-06-29,1021
4417,金洲,20,0,20,合庫-台中,2023-06-29,1021
1219,福壽,20,0,20,合庫-台中,2023-06-29,1021
5703,亞都,20,0,20,合庫-台中,2023-06-29,1021
1312,國喬,20,0,20,合庫-台中,2023-06-29,1021
6243,迅杰,18,0,18,合庫-台中,2023-06-29,1021
2330,台積電,19,2,17,合庫-台中,2023-06-29,1021
2883,凱基金,27,10,17,合庫-台中,2023-06-29,1021
4155,訊映,17,0,17,合庫-台中,2023-06-29,1021
4746,台耀,18,1,17,合庫-台中,2023-06-29,1021
8277,商丞,21,4,17,合庫-台中,2023-06-29,1021
1301,台塑,17,1,16,合庫-台中,2023-06-29,1021
2409,友達,42,26,16,合庫-台中,2023-06-29,1021
2630,亞航,26,10,16,合庫-台中,2023-06-29,1021
4979,華星光,59,44,15,合庫-台中,2023-06-29,1021
1584,精剛,16,1,15,合庫-台中,2023-06-29,1021
2412,中華電,17,3,14,合庫-台中,2023-06-29,1021
8942,森鉅,14,0,14,合庫-台中,2023-06-29,1021
4107,邦特,14,0,14,合庫-台中,2023-06-29,1021
2427,三商電,16,2,14,合庫-台中,2023-06-29,1021
2025,千興,14,0,14,合庫-台中,2023-06-29,1021
00706L,期元大S＆P日圓正2,260,0,260,合庫-台中,2023-06-30,1021
2888,新光金,154,36,118,合庫-台中,2023-06-30,1021
1314,中石化,106,0,106,合庫-台中,2023-06-30,1021
00893,國泰智能電動車,103,12,91,合庫-台中,2023-06-30,1021
2880,華南金,77,1,76,合庫-台中,2023-06-30,1021
3481,群創,175,103,72,合庫-台中,2023-06-30,1021
2344,華邦電,76,20,56,合庫-台中,2023-06-30,1021
3682,亞太電,55,0,55,合庫-台中,2023-06-30,1021
3034,聯詠,62,8,54,合庫-台中,2023-06-30,1021
6185,幃翔,55,2,53,合庫-台中,2023-06-30,1021
2603,長榮,164,113,51,合庫-台中,2023-06-30,1021
2887,台新金,53,2,51,合庫-台中,2023-06-30,1021
2883,凱基金,54,7,47,合庫-台中,2023-06-30,1021
00712,復華富時不動產,68,22,46,合庫-台中,2023-06-30,1021
6153,嘉聯益,52,12,40,合庫-台中,2023-06-30,1021
4414,如興,78,38,40,合庫-台中,2023-06-30,1021
2323,中環,119,80,39,合庫-台中,2023-06-30,1021
2409,友達,58,19,39,合庫-台中,2023-06-30,1021
2618,長榮航,96,58,38,合庫-台中,2023-06-30,1021
1522,堤維西,37,0,37,合庫-台中,2023-06-30,1021
6576,逸達,33,2,31,合庫-台中,2023-06-30,1021
1604,聲寶,30,0,30,合庫-台中,2023-06-30,1021
7402,邑錡,30,0,30,合庫-台中,2023-06-30,1021
1417,嘉裕,30,1,29,合庫-台中,2023-06-30,1021
2427,三商電,47,19,28,合庫-台中,2023-06-30,1021
6125,廣運,39,11,28,合庫-台中,2023-06-30,1021
4533,協易機,28,1,27,合庫-台中,2023-06-30,1021
3045,台灣大,25,0,25,合庫-台中,2023-06-30,1021
00885,富邦越南,23,0,23,合庫-台中,2023-06-30,1021
2002,中鋼,21,0,21,合庫-台中,2023-06-30,1021
00926,凱基全球菁英55,20,0,20,合庫-台中,2023-06-30,1021
6191,精成科,20,0,20,合庫-台中,2023-06-30,1021
00773B,中信優先金融債,19,0,19,合庫-台中,2023-06-30,1021
1515,力山,21,2,19,合庫-台中,2023-06-30,1021
3011,今皓,27,9,18,合庫-台中,2023-06-30,1021
2886,兆豐金,24,6,18,合庫-台中,2023-06-30,1021
1301,台塑,19,1,18,合庫-台中,2023-06-30,1021
2353,宏��,27,11,16,合庫-台中,2023-06-30,1021
2743,山富,18,2,16,合庫-台中,2023-06-30,1021
3207,耀勝,29,13,16,合庫-台中,2023-06-30,1021
00772B,中信高評級公司債,17,1,16,合庫-台中,2023-06-30,1021
2330,台積電,25,9,16,合庫-台中,2023-06-30,1021
2303,聯電,28,13,15,合庫-台中,2023-06-30,1021
2412,中華電,14,0,14,合庫-台中,2023-06-30,1021
3447,展達,19,5,14,合庫-台中,2023-06-30,1021
6451,訊芯-KY,23,9,14,合庫-台中,2023-06-30,1021
2885,元大金,14,0,14,合庫-台中,2023-06-30,1021
2317,鴻海,41,28,13,合庫-台中,2023-06-30,1021
1905,華紙,20,7,13,合庫-台中,2023-06-30,1021
1528,恩德,18,5,13,合庫-台中,2023-06-30,1021
2601,益航,110,1,109,合庫-台中,2023-07-03,1021
00673R,期元大S＆P原油反1,105,0,105,合庫-台中,2023-07-03,1021
00893,國泰智能電動車,289,207,82,合庫-台中,2023-07-03,1021
1605,華新,129,57,72,合庫-台中,2023-07-03,1021
9136,巨騰-DR,65,0,65,合庫-台中,2023-07-03,1021
1447,力鵬,62,0,62,合庫-台中,2023-07-03,1021
2337,旺宏,66,4,62,合庫-台中,2023-07-03,1021
2615,萬海,202,143,59,合庫-台中,2023-07-03,1021
3231,緯創,252,194,58,合庫-台中,2023-07-03,1021
2603,長榮,85,28,57,合庫-台中,2023-07-03,1021
2880,華南金,76,20,56,合庫-台中,2023-07-03,1021
2303,聯電,50,6,44,合庫-台中,2023-07-03,1021
1795,美時,56,15,41,合庫-台中,2023-07-03,1021
2610,華航,64,24,40,合庫-台中,2023-07-03,1021
1417,嘉裕,40,0,40,合庫-台中,2023-07-03,1021
5465,富驊,42,6,36,合庫-台中,2023-07-03,1021
2883,凱基金,35,3,32,合庫-台中,2023-07-03,1021
00679B,元大美債20年,33,4,29,合庫-台中,2023-07-03,1021
3011,今皓,28,0,28,合庫-台中,2023-07-03,1021
6274,台燿,28,1,27,合庫-台中,2023-07-03,1021
2409,友達,31,8,23,合庫-台中,2023-07-03,1021
3615,安可,23,0,23,合庫-台中,2023-07-03,1021
3045,台灣大,22,0,22,合庫-台中,2023-07-03,1021
3038,全台,26,4,22,合庫-台中,2023-07-03,1021
2413,環科,25,3,22,合庫-台中,2023-07-03,1021
2614,東森,21,0,21,合庫-台中,2023-07-03,1021
00671R,富邦NASDAQ反1,20,0,20,合庫-台中,2023-07-03,1021
3701,大眾控,20,0,20,合庫-台中,2023-07-03,1021
3518,柏騰,20,0,20,合庫-台中,2023-07-03,1021
2382,廣達,37,18,19,合庫-台中,2023-07-03,1021
2014,中鴻,20,1,19,合庫-台中,2023-07-03,1021
1314,中石化,19,0,19,合庫-台中,2023-07-03,1021
2851,中再保,19,0,19,合庫-台中,2023-07-03,1021
3207,耀勝,70,52,18,合庫-台中,2023-07-03,1021
2412,中華電,18,0,18,合庫-台中,2023-07-03,1021
5388,中磊,29,12,17,合庫-台中,2023-07-03,1021
2206,三陽工業,22,6,16,合庫-台中,2023-07-03,1021
3034,聯詠,18,3,15,合庫-台中,2023-07-03,1021
5425,台半,23,8,15,合庫-台中,2023-07-03,1021
5443,均豪,15,0,15,合庫-台中,2023-07-03,1021
6142,友勁,15,0,15,合庫-台中,2023-07-03,1021
4971,IET-KY,14,0,14,合庫-台中,2023-07-03,1021
2105,正新,17,3,14,合庫-台中,2023-07-03,1021
3028,增你強,14,0,14,合庫-台中,2023-07-03,1021
3264,欣銓,16,2,14,合庫-台中,2023-07-03,1021
2913,農林,14,1,13,合庫-台中,2023-07-03,1021
2345,智邦,14,1,13,合庫-台中,2023-07-03,1021
4931,新盛力,12,0,12,合庫-台中,2023-07-03,1021
3515,華擎,18,6,12,合庫-台中,2023-07-03,1021
1815,富喬,12,0,12,合庫-台中,2023-07-03,1021
2317,鴻海,1249,36,1213,合庫-台中,2023-07-04,1021
2609,陽明,720,81,639,合庫-台中,2023-07-04,1021
2603,長榮,698,334,364,合庫-台中,2023-07-04,1021
00893,國泰智能電動車,237,15,222,合庫-台中,2023-07-04,1021
00632R,元大台灣50反1,437,246,191,合庫-台中,2023-07-04,1021
0056,元大高股息,220,73,147,合庫-台中,2023-07-04,1021
00665L,富邦�琤肭磪囓�2,108,0,108,合庫-台中,2023-07-04,1021
3615,安可,89,0,89,合庫-台中,2023-07-04,1021
2888,新光金,195,116,79,合庫-台中,2023-07-04,1021
2883,凱基金,81,3,78,合庫-台中,2023-07-04,1021
2313,華通,78,1,77,合庫-台中,2023-07-04,1021
2889,國票金,69,2,67,合庫-台中,2023-07-04,1021
1907,永豐餘,66,15,51,合庫-台中,2023-07-04,1021
5880,合庫金,57,6,51,合庫-台中,2023-07-04,1021
1528,恩德,54,6,48,合庫-台中,2023-07-04,1021
00712,復華富時不動產,51,8,43,合庫-台中,2023-07-04,1021
3025,星通,95,53,42,合庫-台中,2023-07-04,1021
6231,系微,41,0,41,合庫-台中,2023-07-04,1021
4121,優盛,41,0,41,合庫-台中,2023-07-04,1021
1313,聯成,40,0,40,合庫-台中,2023-07-04,1021
1314,中石化,40,1,39,合庫-台中,2023-07-04,1021
5426,振發,42,6,36,合庫-台中,2023-07-04,1021
4906,正文,105,72,33,合庫-台中,2023-07-04,1021
6112,邁達特,44,12,32,合庫-台中,2023-07-04,1021
9136,巨騰-DR,32,0,32,合庫-台中,2023-07-04,1021
2801,彰銀,30,0,30,合庫-台中,2023-07-04,1021
2421,建準,61,31,30,合庫-台中,2023-07-04,1021
00715L,期街口布蘭特正2,38,9,29,合庫-台中,2023-07-04,1021
1513,中興電,46,18,28,合庫-台中,2023-07-04,1021
00929,復華台灣科技優息,47,20,27,合庫-台中,2023-07-04,1021
1605,華新,38,12,26,合庫-台中,2023-07-04,1021
00902,中信電池及儲能,35,9,26,合庫-台中,2023-07-04,1021
2880,華南金,26,1,25,合庫-台中,2023-07-04,1021
2453,凌群,50,25,25,合庫-台中,2023-07-04,1021
3011,今皓,35,10,25,合庫-台中,2023-07-04,1021
3704,合勤控,62,39,23,合庫-台中,2023-07-04,1021
8926,台汽電,23,0,23,合庫-台中,2023-07-04,1021
9105,泰金寶-DR,22,0,22,合庫-台中,2023-07-04,1021
1905,華紙,74,53,21,合庫-台中,2023-07-04,1021
1515,力山,21,0,21,合庫-台中,2023-07-04,1021
2614,東森,20,0,20,合庫-台中,2023-07-04,1021
2349,錸德,20,0,20,合庫-台中,2023-07-04,1021
4155,訊映,26,6,20,合庫-台中,2023-07-04,1021
8038,長園科,20,0,20,合庫-台中,2023-07-04,1021
3047,訊舟,23,4,19,合庫-台中,2023-07-04,1021
1337,再生-KY,20,1,19,合庫-台中,2023-07-04,1021
2891,中信金,19,1,18,合庫-台中,2023-07-04,1021
1612,宏泰,20,2,18,合庫-台中,2023-07-04,1021
2353,宏��,19,1,18,合庫-台中,2023-07-04,1021
2208,台船,17,0,17,合庫-台中,2023-07-04,1021
2609,陽明,485,212,273,合庫-台中,2023-07-05,1021
00673R,期元大S＆P原油反1,261,1,260,合庫-台中,2023-07-05,1021
00929,復華台灣科技優息,135,11,124,合庫-台中,2023-07-05,1021
3231,緯創,239,142,97,合庫-台中,2023-07-05,1021
2801,彰銀,77,1,76,合庫-台中,2023-07-05,1021
1609,大亞,142,67,75,合庫-台中,2023-07-05,1021
3025,星通,81,7,74,合庫-台中,2023-07-05,1021
2887,台新金,71,0,71,合庫-台中,2023-07-05,1021
2356,英業達,105,42,63,合庫-台中,2023-07-05,1021
2892,第一金,62,0,62,合庫-台中,2023-07-05,1021
1312,國喬,58,0,58,合庫-台中,2023-07-05,1021
2303,聯電,65,8,57,合庫-台中,2023-07-05,1021
2889,國票金,62,7,55,合庫-台中,2023-07-05,1021
2427,三商電,103,48,55,合庫-台中,2023-07-05,1021
2883,凱基金,68,14,54,合庫-台中,2023-07-05,1021
3013,晟銘電,80,28,52,合庫-台中,2023-07-05,1021
0056,元大高股息,292,240,52,合庫-台中,2023-07-05,1021
4526,東台,50,0,50,合庫-台中,2023-07-05,1021
4904,遠傳,47,0,47,合庫-台中,2023-07-05,1021
00927,群益半導體收益,44,0,44,合庫-台中,2023-07-05,1021
8038,長園科,38,1,37,合庫-台中,2023-07-05,1021
2485,兆赫,61,24,37,合庫-台中,2023-07-05,1021
2409,友達,62,25,37,合庫-台中,2023-07-05,1021
2809,京城銀,34,0,34,合庫-台中,2023-07-05,1021
1101,台泥,37,4,33,合庫-台中,2023-07-05,1021
3078,僑威,87,55,32,合庫-台中,2023-07-05,1021
2618,長榮航,228,197,31,合庫-台中,2023-07-05,1021
3363,上詮,52,22,30,合庫-台中,2023-07-05,1021
3576,聯合再生,30,1,29,合庫-台中,2023-07-05,1021
2421,建準,32,3,29,合庫-台中,2023-07-05,1021
5706,鳳凰,31,6,25,合庫-台中,2023-07-05,1021
2107,厚生,25,0,25,合庫-台中,2023-07-05,1021
3518,柏騰,25,0,25,合庫-台中,2023-07-05,1021
2317,鴻海,53,28,25,合庫-台中,2023-07-05,1021
00919,群益台灣精選高息,26,2,24,合庫-台中,2023-07-05,1021
8105,凌巨,26,2,24,合庫-台中,2023-07-05,1021
1513,中興電,33,10,23,合庫-台中,2023-07-05,1021
6182,合晶,31,9,22,合庫-台中,2023-07-05,1021
6180,橘子,22,0,22,合庫-台中,2023-07-05,1021
2323,中環,243,222,21,合庫-台中,2023-07-05,1021
6158,禾昌,21,0,21,合庫-台中,2023-07-05,1021
2376,技嘉,76,56,20,合庫-台中,2023-07-05,1021
2743,山富,39,19,20,合庫-台中,2023-07-05,1021
2515,中工,20,0,20,合庫-台中,2023-07-05,1021
5493,三聯,20,0,20,合庫-台中,2023-07-05,1021
4979,華星光,36,17,19,合庫-台中,2023-07-05,1021
2402,毅嘉,90,71,19,合庫-台中,2023-07-05,1021
6282,康舒,152,134,18,合庫-台中,2023-07-05,1021
3706,神達,34,16,18,合庫-台中,2023-07-05,1021
2413,環科,22,5,17,合庫-台中,2023-07-05,1021
00673R,期元大S＆P原油反1,294,3,291,合庫-台中,2023-07-06,1021
2609,陽明,359,109,250,合庫-台中,2023-07-06,1021
2888,新光金,285,50,235,合庫-台中,2023-07-06,1021
2885,元大金,222,0,222,合庫-台中,2023-07-06,1021
2880,華南金,209,3,206,合庫-台中,2023-07-06,1021
0056,元大高股息,181,25,156,合庫-台中,2023-07-06,1021
00720B,元大投資級公司債,182,27,155,合庫-台中,2023-07-06,1021
5880,合庫金,161,7,154,合庫-台中,2023-07-06,1021
2002,中鋼,142,7,135,合庫-台中,2023-07-06,1021
00929,復華台灣科技優息,118,2,116,合庫-台中,2023-07-06,1021
00637L,元大滬深300正2,97,5,92,合庫-台中,2023-07-06,1021
2618,長榮航,124,35,89,合庫-台中,2023-07-06,1021
2887,台新金,89,1,88,合庫-台中,2023-07-06,1021
2883,凱基金,125,43,82,合庫-台中,2023-07-06,1021
2891,中信金,77,4,73,合庫-台中,2023-07-06,1021
1101,台泥,83,15,68,合庫-台中,2023-07-06,1021
2419,仲琦,80,12,68,合庫-台中,2023-07-06,1021
4967,十銓,70,2,68,合庫-台中,2023-07-06,1021
1905,華紙,69,2,67,合庫-台中,2023-07-06,1021
2409,友達,251,186,65,合庫-台中,2023-07-06,1021
1584,精剛,65,5,60,合庫-台中,2023-07-06,1021
2317,鴻海,76,17,59,合庫-台中,2023-07-06,1021
9907,統一實,60,2,58,合庫-台中,2023-07-06,1021
3011,今皓,87,30,57,合庫-台中,2023-07-06,1021
2845,遠東銀,52,2,50,合庫-台中,2023-07-06,1021
2340,台亞,88,40,48,合庫-台中,2023-07-06,1021
6111,大宇資,71,23,48,合庫-台中,2023-07-06,1021
8038,長園科,49,2,47,合庫-台中,2023-07-06,1021
4904,遠傳,44,0,44,合庫-台中,2023-07-06,1021
00679B,元大美債20年,42,0,42,合庫-台中,2023-07-06,1021
2323,中環,159,119,40,合庫-台中,2023-07-06,1021
2330,台積電,44,5,39,合庫-台中,2023-07-06,1021
006208,富邦台50,39,0,39,合庫-台中,2023-07-06,1021
3037,欣興,43,4,39,合庫-台中,2023-07-06,1021
3362,先進光,63,26,37,合庫-台中,2023-07-06,1021
2801,彰銀,36,1,35,合庫-台中,2023-07-06,1021
00882,中信中國高股息,36,1,35,合庫-台中,2023-07-06,1021
2884,玉山金,34,0,34,合庫-台中,2023-07-06,1021
2915,潤泰全,33,0,33,合庫-台中,2023-07-06,1021
2889,國票金,46,13,33,合庫-台中,2023-07-06,1021
1802,台玻,31,0,31,合庫-台中,2023-07-06,1021
6282,康舒,92,61,31,合庫-台中,2023-07-06,1021
1904,正隆,34,4,30,合庫-台中,2023-07-06,1021
6112,邁達特,29,0,29,合庫-台中,2023-07-06,1021
8215,明基材,48,19,29,合庫-台中,2023-07-06,1021
4744,皇將,59,30,29,合庫-台中,2023-07-06,1021
8101,華冠,28,0,28,合庫-台中,2023-07-06,1021
2601,益航,27,0,27,合庫-台中,2023-07-06,1021
3038,全台,30,4,26,合庫-台中,2023-07-06,1021
6733,博晟生醫,25,0,25,合庫-台中,2023-07-06,1021
00632R,元大台灣50反1,740,102,638,合庫-台中,2023-07-07,1021
00713,元大台灣高息低波,207,2,205,合庫-台中,2023-07-07,1021
2409,友達,175,14,161,合庫-台中,2023-07-07,1021
2609,陽明,178,29,149,合庫-台中,2023-07-07,1021
2888,新光金,146,21,125,合庫-台中,2023-07-07,1021
00929,復華台灣科技優息,118,2,116,合庫-台中,2023-07-07,1021
3481,群創,194,79,115,合庫-台中,2023-07-07,1021
00720B,元大投資級公司債,126,20,106,合庫-台中,2023-07-07,1021
4934,太極,99,8,91,合庫-台中,2023-07-07,1021
00673R,期元大S＆P原油反1,251,161,90,合庫-台中,2023-07-07,1021
2634,漢翔,199,119,80,合庫-台中,2023-07-07,1021
00679B,元大美債20年,77,4,73,合庫-台中,2023-07-07,1021
9949,琉園,74,1,73,合庫-台中,2023-07-07,1021
8096,擎亞,70,0,70,合庫-台中,2023-07-07,1021
2801,彰銀,69,5,64,合庫-台中,2023-07-07,1021
2303,聯電,78,14,64,合庫-台中,2023-07-07,1021
1312,國喬,60,0,60,合庫-台中,2023-07-07,1021
1605,華新,66,8,58,合庫-台中,2023-07-07,1021
3051,力特,52,0,52,合庫-台中,2023-07-07,1021
2883,凱基金,82,36,46,合庫-台中,2023-07-07,1021
5880,合庫金,78,33,45,合庫-台中,2023-07-07,1021
2344,華邦電,77,33,44,合庫-台中,2023-07-07,1021
3231,緯創,221,179,42,合庫-台中,2023-07-07,1021
2886,兆豐金,44,6,38,合庫-台中,2023-07-07,1021
3701,大眾控,38,1,37,合庫-台中,2023-07-07,1021
6116,彩晶,39,3,36,合庫-台中,2023-07-07,1021
2610,華航,74,39,35,合庫-台中,2023-07-07,1021
2441,超豐,35,0,35,合庫-台中,2023-07-07,1021
2337,旺宏,36,2,34,合庫-台中,2023-07-07,1021
2347,聯強,32,0,32,合庫-台中,2023-07-07,1021
1314,中石化,34,2,32,合庫-台中,2023-07-07,1021
00927,群益半導體收益,30,0,30,合庫-台中,2023-07-07,1021
1905,華紙,54,25,29,合庫-台中,2023-07-07,1021
3011,今皓,28,0,28,合庫-台中,2023-07-07,1021
2010,春源,27,1,26,合庫-台中,2023-07-07,1021
1301,台塑,28,2,26,合庫-台中,2023-07-07,1021
2427,三商電,96,72,24,合庫-台中,2023-07-07,1021
4931,新盛力,24,0,24,合庫-台中,2023-07-07,1021
1513,中興電,30,6,24,合庫-台中,2023-07-07,1021
2884,玉山金,26,4,22,合庫-台中,2023-07-07,1021
8021,尖點,22,0,22,合庫-台中,2023-07-07,1021
1795,美時,21,0,21,合庫-台中,2023-07-07,1021
4414,如興,21,0,21,合庫-台中,2023-07-07,1021
2601,益航,21,0,21,合庫-台中,2023-07-07,1021
6185,幃翔,20,0,20,合庫-台中,2023-07-07,1021
1808,潤隆,20,0,20,合庫-台中,2023-07-07,1021
3260,威剛,20,0,20,合庫-台中,2023-07-07,1021
00753L,中信中國50正2,42,22,20,合庫-台中,2023-07-07,1021
4541,晟田,21,2,19,合庫-台中,2023-07-07,1021
8926,台汽電,27,8,19,合庫-台中,2023-07-07,1021
1618,合機,426,50,376,合庫-台中,2023-07-10,1021
4533,協易機,273,10,263,合庫-台中,2023-07-10,1021
00673R,期元大S＆P原油反1,231,0,231,合庫-台中,2023-07-10,1021
2323,中環,148,32,116,合庫-台中,2023-07-10,1021
9949,琉園,115,1,114,合庫-台中,2023-07-10,1021
00679B,元大美債20年,107,0,107,合庫-台中,2023-07-10,1021
2609,陽明,112,33,79,合庫-台中,2023-07-10,1021
2419,仲琦,119,41,78,合庫-台中,2023-07-10,1021
6282,康舒,199,126,73,合庫-台中,2023-07-10,1021
00929,復華台灣科技優息,70,1,69,合庫-台中,2023-07-10,1021
1101,台泥,75,14,61,合庫-台中,2023-07-10,1021
00751B,元大AAA至A公司債,77,20,57,合庫-台中,2023-07-10,1021
1605,華新,57,0,57,合庫-台中,2023-07-10,1021
2515,中工,55,0,55,合庫-台中,2023-07-10,1021
2337,旺宏,50,0,50,合庫-台中,2023-07-10,1021
2886,兆豐金,53,7,46,合庫-台中,2023-07-10,1021
1312,國喬,44,0,44,合庫-台中,2023-07-10,1021
6125,廣運,50,9,41,合庫-台中,2023-07-10,1021
3576,聯合再生,39,0,39,合庫-台中,2023-07-10,1021
2884,玉山金,46,7,39,合庫-台中,2023-07-10,1021
00712,復華富時不動產,37,0,37,合庫-台中,2023-07-10,1021
6285,啟��,75,40,35,合庫-台中,2023-07-10,1021
4532,瑞智,63,30,33,合庫-台中,2023-07-10,1021
2489,瑞軒,33,0,33,合庫-台中,2023-07-10,1021
2317,鴻海,39,7,32,合庫-台中,2023-07-10,1021
00882,中信中國高股息,33,1,32,合庫-台中,2023-07-10,1021
3029,零壹,31,0,31,合庫-台中,2023-07-10,1021
4931,新盛力,30,0,30,合庫-台中,2023-07-10,1021
5521,工信,30,0,30,合庫-台中,2023-07-10,1021
2887,台新金,32,3,29,合庫-台中,2023-07-10,1021
6576,逸達,29,0,29,合庫-台中,2023-07-10,1021
1905,華紙,35,7,28,合庫-台中,2023-07-10,1021
2610,華航,71,43,28,合庫-台中,2023-07-10,1021
1409,新纖,27,0,27,合庫-台中,2023-07-10,1021
3011,今皓,25,0,25,合庫-台中,2023-07-10,1021
3305,昇貿,28,3,25,合庫-台中,2023-07-10,1021
2801,彰銀,25,0,25,合庫-台中,2023-07-10,1021
2457,飛宏,25,0,25,合庫-台中,2023-07-10,1021
6170,統振,25,1,24,合庫-台中,2023-07-10,1021
5432,新門,23,0,23,合庫-台中,2023-07-10,1021
6426,統新,24,2,22,合庫-台中,2023-07-10,1021
9907,統一實,22,0,22,合庫-台中,2023-07-10,1021
3163,波若威,21,0,21,合庫-台中,2023-07-10,1021
2329,華泰,33,12,21,合庫-台中,2023-07-10,1021
4979,華星光,39,19,20,合庫-台中,2023-07-10,1021
3025,星通,122,102,20,合庫-台中,2023-07-10,1021
1506,正道,20,0,20,合庫-台中,2023-07-10,1021
2614,東森,20,0,20,合庫-台中,2023-07-10,1021
6215,和椿,20,0,20,合庫-台中,2023-07-10,1021
2488,漢平,19,0,19,合庫-台中,2023-07-10,1021
00893,國泰智能電動車,205,19,186,合庫-台中,2023-07-11,1021
2801,彰銀,100,0,100,合庫-台中,2023-07-11,1021
4419,皇家美食,96,0,96,合庫-台中,2023-07-11,1021
6191,精成科,90,4,86,合庫-台中,2023-07-11,1021
00632R,元大台灣50反1,90,20,70,合庫-台中,2023-07-11,1021
9949,琉園,124,57,67,合庫-台中,2023-07-11,1021
4934,太極,69,14,55,合庫-台中,2023-07-11,1021
1434,福懋,53,0,53,合庫-台中,2023-07-11,1021
00670L,富邦NASDAQ正2,52,0,52,合庫-台中,2023-07-11,1021
2312,金寶,62,13,49,合庫-台中,2023-07-11,1021
4532,瑞智,55,11,44,合庫-台中,2023-07-11,1021
1540,喬福,44,0,44,合庫-台中,2023-07-11,1021
00720B,元大投資級公司債,43,0,43,合庫-台中,2023-07-11,1021
00706L,期元大S＆P日圓正2,40,0,40,合庫-台中,2023-07-11,1021
1806,冠軍,120,82,38,合庫-台中,2023-07-11,1021
2382,廣達,77,40,37,合庫-台中,2023-07-11,1021
1604,聲寶,39,2,37,合庫-台中,2023-07-11,1021
6288,聯嘉,39,6,33,合庫-台中,2023-07-11,1021
2340,台亞,70,37,33,合庫-台中,2023-07-11,1021
4931,新盛力,32,0,32,合庫-台中,2023-07-11,1021
00885,富邦越南,50,18,32,合庫-台中,2023-07-11,1021
9105,泰金寶-DR,32,0,32,合庫-台中,2023-07-11,1021
5381,合正,31,0,31,合庫-台中,2023-07-11,1021
2607,榮運,30,0,30,合庫-台中,2023-07-11,1021
00664R,國泰臺灣加權反1,30,0,30,合庫-台中,2023-07-11,1021
1447,力鵬,30,0,30,合庫-台中,2023-07-11,1021
6274,台燿,56,27,29,合庫-台中,2023-07-11,1021
3356,奇偶,33,6,27,合庫-台中,2023-07-11,1021
3284,太普高,25,0,25,合庫-台中,2023-07-11,1021
2498,宏達電,30,5,25,合庫-台中,2023-07-11,1021
1618,合機,28,3,25,合庫-台中,2023-07-11,1021
1608,華榮,25,0,25,合庫-台中,2023-07-11,1021
1101,台泥,26,1,25,合庫-台中,2023-07-11,1021
00882,中信中國高股息,24,1,23,合庫-台中,2023-07-11,1021
4967,十銓,23,0,23,合庫-台中,2023-07-11,1021
6179,亞通,27,5,22,合庫-台中,2023-07-11,1021
2601,益航,23,1,22,合庫-台中,2023-07-11,1021
3083,網龍,21,0,21,合庫-台中,2023-07-11,1021
6243,迅杰,22,2,20,合庫-台中,2023-07-11,1021
1718,中纖,20,0,20,合庫-台中,2023-07-11,1021
5521,工信,20,0,20,合庫-台中,2023-07-11,1021
00671R,富邦NASDAQ反1,20,0,20,合庫-台中,2023-07-11,1021
6168,宏齊,39,19,20,合庫-台中,2023-07-11,1021
6148,驊宏資,104,84,20,合庫-台中,2023-07-11,1021
6285,啟��,57,38,19,合庫-台中,2023-07-11,1021
2303,聯電,23,4,19,合庫-台中,2023-07-11,1021
6733,博晟生醫,18,0,18,合庫-台中,2023-07-11,1021
8210,勤誠,18,1,17,合庫-台中,2023-07-11,1021
3231,緯創,124,107,17,合庫-台中,2023-07-11,1021
2371,大同,39,23,16,合庫-台中,2023-07-11,1021
00673R,期元大S＆P原油反1,355,66,289,合庫-台中,2023-07-12,1021
2303,聯電,213,11,202,合庫-台中,2023-07-12,1021
0056,元大高股息,224,69,155,合庫-台中,2023-07-12,1021
2609,陽明,158,45,113,合庫-台中,2023-07-12,1021
3231,緯創,221,119,102,合庫-台中,2023-07-12,1021
2323,中環,198,97,101,合庫-台中,2023-07-12,1021
00665L,富邦�琤肭磪囓�2,95,1,94,合庫-台中,2023-07-12,1021
2498,宏達電,115,38,77,合庫-台中,2023-07-12,1021
00929,復華台灣科技優息,74,4,70,合庫-台中,2023-07-12,1021
2344,華邦電,114,47,67,合庫-台中,2023-07-12,1021
00905,FT臺灣Smart,66,0,66,合庫-台中,2023-07-12,1021
4129,聯合,59,1,58,合庫-台中,2023-07-12,1021
2356,英業達,234,177,57,合庫-台中,2023-07-12,1021
2601,益航,57,2,55,合庫-台中,2023-07-12,1021
2614,東森,53,0,53,合庫-台中,2023-07-12,1021
4532,瑞智,77,25,52,合庫-台中,2023-07-12,1021
4414,如興,52,0,52,合庫-台中,2023-07-12,1021
1314,中石化,62,11,51,合庫-台中,2023-07-12,1021
6188,廣明,209,163,46,合庫-台中,2023-07-12,1021
4931,新盛力,44,0,44,合庫-台中,2023-07-12,1021
6288,聯嘉,43,0,43,合庫-台中,2023-07-12,1021
6118,建達,69,27,42,合庫-台中,2023-07-12,1021
6120,達運,63,22,41,合庫-台中,2023-07-12,1021
2388,威盛,76,36,40,合庫-台中,2023-07-12,1021
4419,皇家美食,38,0,38,合庫-台中,2023-07-12,1021
4541,晟田,36,0,36,合庫-台中,2023-07-12,1021
00679B,元大美債20年,39,5,34,合庫-台中,2023-07-12,1021
3059,華晶科,34,0,34,合庫-台中,2023-07-12,1021
8358,金居,46,12,34,合庫-台中,2023-07-12,1021
9949,琉園,33,0,33,合庫-台中,2023-07-12,1021
6282,康舒,126,96,30,合庫-台中,2023-07-12,1021
00885,富邦越南,29,0,29,合庫-台中,2023-07-12,1021
6443,元晶,28,0,28,合庫-台中,2023-07-12,1021
1514,亞力,35,8,27,合庫-台中,2023-07-12,1021
1611,中電,27,0,27,合庫-台中,2023-07-12,1021
00720B,元大投資級公司債,32,6,26,合庫-台中,2023-07-12,1021
3363,上詮,42,16,26,合庫-台中,2023-07-12,1021
4552,力達-KY,40,16,24,合庫-台中,2023-07-12,1021
6733,博晟生醫,22,1,21,合庫-台中,2023-07-12,1021
3305,昇貿,21,0,21,合庫-台中,2023-07-12,1021
00715L,期街口布蘭特正2,70,49,21,合庫-台中,2023-07-12,1021
2444,兆勁,21,0,21,合庫-台中,2023-07-12,1021
1101,台泥,28,7,21,合庫-台中,2023-07-12,1021
6215,和椿,20,0,20,合庫-台中,2023-07-12,1021
2421,建準,36,16,20,合庫-台中,2023-07-12,1021
1806,冠軍,126,106,20,合庫-台中,2023-07-12,1021
3511,矽瑪,20,1,19,合庫-台中,2023-07-12,1021
3011,今皓,18,0,18,合庫-台中,2023-07-12,1021
6234,高僑,18,0,18,合庫-台中,2023-07-12,1021
00882,中信中國高股息,16,0,16,合庫-台中,2023-07-12,1021
3711,日月光投控,528,29,499,合庫-台中,2023-07-13,1021
00632R,元大台灣50反1,766,458,308,合庫-台中,2023-07-13,1021
00673R,期元大S＆P原油反1,294,0,294,合庫-台中,2023-07-13,1021
2329,華泰,292,41,251,合庫-台中,2023-07-13,1021
3706,神達,216,60,156,合庫-台中,2023-07-13,1021
2610,華航,211,73,138,合庫-台中,2023-07-13,1021
1314,中石化,132,0,132,合庫-台中,2023-07-13,1021
2618,長榮航,346,221,125,合庫-台中,2023-07-13,1021
2303,聯電,166,42,124,合庫-台中,2023-07-13,1021
00679B,元大美債20年,104,5,99,合庫-台中,2023-07-13,1021
3017,奇鋐,110,22,88,合庫-台中,2023-07-13,1021
00929,復華台灣科技優息,87,4,83,合庫-台中,2023-07-13,1021
2312,金寶,131,54,77,合庫-台中,2023-07-13,1021
6188,廣明,182,107,75,合庫-台中,2023-07-13,1021
2882,國泰金,71,2,69,合庫-台中,2023-07-13,1021
00720B,元大投資級公司債,66,2,64,合庫-台中,2023-07-13,1021
2614,東森,77,18,59,合庫-台中,2023-07-13,1021
5607,遠雄港,55,1,54,合庫-台中,2023-07-13,1021
2324,仁寶,129,75,54,合庫-台中,2023-07-13,1021
2425,承啟,64,11,53,合庫-台中,2023-07-13,1021
4909,新復興,50,0,50,合庫-台中,2023-07-13,1021
6282,康舒,164,115,49,合庫-台中,2023-07-13,1021
1609,大亞,52,4,48,合庫-台中,2023-07-13,1021
2359,所羅門,55,11,44,合庫-台中,2023-07-13,1021
3576,聯合再生,58,15,43,合庫-台中,2023-07-13,1021
00706L,期元大S＆P日圓正2,40,0,40,合庫-台中,2023-07-13,1021
2889,國票金,50,10,40,合庫-台中,2023-07-13,1021
9105,泰金寶-DR,40,2,38,合庫-台中,2023-07-13,1021
00753L,中信中國50正2,45,10,35,合庫-台中,2023-07-13,1021
3521,鴻翊,32,0,32,合庫-台中,2023-07-13,1021
2601,益航,32,0,32,合庫-台中,2023-07-13,1021
2368,金像電,145,113,32,合庫-台中,2023-07-13,1021
1218,泰山,32,0,32,合庫-台中,2023-07-13,1021
4931,新盛力,33,3,30,合庫-台中,2023-07-13,1021
00683L,期元大美元指正2,30,0,30,合庫-台中,2023-07-13,1021
00930,永豐ESG低碳高息,56,26,30,合庫-台中,2023-07-13,1021
2352,佳世達,92,62,30,合庫-台中,2023-07-13,1021
2455,全新,26,0,26,合庫-台中,2023-07-13,1021
3025,星通,110,84,26,合庫-台中,2023-07-13,1021
6443,元晶,25,0,25,合庫-台中,2023-07-13,1021
6190,萬泰科,50,27,23,合庫-台中,2023-07-13,1021
2323,中環,176,153,23,合庫-台中,2023-07-13,1021
5371,中光電,70,48,22,合庫-台中,2023-07-13,1021
1101,台泥,30,9,21,合庫-台中,2023-07-13,1021
2801,彰銀,22,1,21,合庫-台中,2023-07-13,1021
4939,亞電,21,0,21,合庫-台中,2023-07-13,1021
2104,國際中橡,21,0,21,合庫-台中,2023-07-13,1021
00772B,中信高評級公司債,32,12,20,合庫-台中,2023-07-13,1021
1303,南亞,21,1,20,合庫-台中,2023-07-13,1021
9933,中鼎,20,0,20,合庫-台中,2023-07-13,1021
00637L,元大滬深300正2,1420,58,1362,合庫-台中,2023-07-14,1021
00632R,元大台灣50反1,628,250,378,合庫-台中,2023-07-14,1021
2610,華航,423,142,281,合庫-台中,2023-07-14,1021
00671R,富邦NASDAQ反1,240,0,240,合庫-台中,2023-07-14,1021
00715L,期街口布蘭特正2,202,25,177,合庫-台中,2023-07-14,1021
00720B,元大投資級公司債,174,0,174,合庫-台中,2023-07-14,1021
2323,中環,268,100,168,合庫-台中,2023-07-14,1021
2356,英業達,356,212,144,合庫-台中,2023-07-14,1021
00673R,期元大S＆P原油反1,125,0,125,合庫-台中,2023-07-14,1021
2312,金寶,132,12,120,合庫-台中,2023-07-14,1021
2609,陽明,179,67,112,合庫-台中,2023-07-14,1021
2371,大同,163,60,103,合庫-台中,2023-07-14,1021
4414,如興,102,0,102,合庫-台中,2023-07-14,1021
2614,東森,83,5,78,合庫-台中,2023-07-14,1021
1314,中石化,75,0,75,合庫-台中,2023-07-14,1021
4533,協易機,106,38,68,合庫-台中,2023-07-14,1021
2313,華通,88,29,59,合庫-台中,2023-07-14,1021
2618,長榮航,261,209,52,合庫-台中,2023-07-14,1021
6190,萬泰科,51,1,50,合庫-台中,2023-07-14,1021
3576,聯合再生,52,10,42,合庫-台中,2023-07-14,1021
00929,復華台灣科技優息,43,6,37,合庫-台中,2023-07-14,1021
3521,鴻翊,44,7,37,合庫-台中,2023-07-14,1021
1440,南紡,36,0,36,合庫-台中,2023-07-14,1021
1609,大亞,77,45,32,合庫-台中,2023-07-14,1021
00679B,元大美債20年,36,5,31,合庫-台中,2023-07-14,1021
6111,大宇資,32,3,29,合庫-台中,2023-07-14,1021
2353,宏��,94,65,29,合庫-台中,2023-07-14,1021
2801,彰銀,30,2,28,合庫-台中,2023-07-14,1021
3666,光耀,26,0,26,合庫-台中,2023-07-14,1021
1905,華紙,33,8,25,合庫-台中,2023-07-14,1021
1506,正道,25,0,25,合庫-台中,2023-07-14,1021
6120,達運,37,12,25,合庫-台中,2023-07-14,1021
2401,凌陽,27,3,24,合庫-台中,2023-07-14,1021
3380,明泰,93,69,24,合庫-台中,2023-07-14,1021
3231,緯創,118,94,24,合庫-台中,2023-07-14,1021
2301,光寶科,74,51,23,合庫-台中,2023-07-14,1021
6234,高僑,27,4,23,合庫-台中,2023-07-14,1021
00712,復華富時不動產,32,11,21,合庫-台中,2023-07-14,1021
00722B,群益投資級電信債,20,0,20,合庫-台中,2023-07-14,1021
9105,泰金寶-DR,20,0,20,合庫-台中,2023-07-14,1021
2408,南亞科,22,2,20,合庫-台中,2023-07-14,1021
3062,建漢,22,2,20,合庫-台中,2023-07-14,1021
1447,力鵬,20,0,20,合庫-台中,2023-07-14,1021
3060,銘異,20,1,19,合庫-台中,2023-07-14,1021
1611,中電,19,1,18,合庫-台中,2023-07-14,1021
2634,漢翔,26,8,18,合庫-台中,2023-07-14,1021
00655L,國泰中國A50正2,20,2,18,合庫-台中,2023-07-14,1021
00642U,期元大S＆P石油,20,2,18,合庫-台中,2023-07-14,1021
00670L,富邦NASDAQ正2,19,1,18,合庫-台中,2023-07-14,1021
3694,海華,24,6,18,合庫-台中,2023-07-14,1021
3711,日月光投控,1140,37,1103,合庫-台中,2023-07-17,1021
00637L,元大滬深300正2,220,0,220,合庫-台中,2023-07-17,1021
5426,振發,188,0,188,合庫-台中,2023-07-17,1021
00929,復華台灣科技優息,199,17,182,合庫-台中,2023-07-17,1021
2353,宏��,276,99,177,合庫-台中,2023-07-17,1021
2323,中環,227,96,131,合庫-台中,2023-07-17,1021
2356,英業達,198,74,124,合庫-台中,2023-07-17,1021
2312,金寶,140,26,114,合庫-台中,2023-07-17,1021
1513,中興電,201,93,108,合庫-台中,2023-07-17,1021
3038,全台,126,53,73,合庫-台中,2023-07-17,1021
4123,晟德,107,38,69,合庫-台中,2023-07-17,1021
00882,中信中國高股息,64,0,64,合庫-台中,2023-07-17,1021
00673R,期元大S＆P原油反1,85,23,62,合庫-台中,2023-07-17,1021
1504,東元,106,55,51,合庫-台中,2023-07-17,1021
00927,群益半導體收益,46,1,45,合庫-台中,2023-07-17,1021
6112,邁達特,46,3,43,合庫-台中,2023-07-17,1021
6179,亞通,46,6,40,合庫-台中,2023-07-17,1021
3062,建漢,38,3,35,合庫-台中,2023-07-17,1021
00753L,中信中國50正2,34,0,34,合庫-台中,2023-07-17,1021
2328,廣宇,48,15,33,合庫-台中,2023-07-17,1021
2314,台揚,34,1,33,合庫-台中,2023-07-17,1021
2515,中工,43,10,33,合庫-台中,2023-07-17,1021
3380,明泰,77,45,32,合庫-台中,2023-07-17,1021
2359,所羅門,36,6,30,合庫-台中,2023-07-17,1021
8043,蜜望實,30,0,30,合庫-台中,2023-07-17,1021
00902,中信電池及儲能,30,0,30,合庫-台中,2023-07-17,1021
2401,凌陽,35,5,30,合庫-台中,2023-07-17,1021
00675L,富邦臺灣加權正2,29,0,29,合庫-台中,2023-07-17,1021
00919,群益台灣精選高息,34,6,28,合庫-台中,2023-07-17,1021
3037,欣興,56,29,27,合庫-台中,2023-07-17,1021
4916,事欣科,56,29,27,合庫-台中,2023-07-17,1021
1101,台泥,27,1,26,合庫-台中,2023-07-17,1021
2634,漢翔,48,22,26,合庫-台中,2023-07-17,1021
6111,大宇資,28,2,26,合庫-台中,2023-07-17,1021
2371,大同,92,68,24,合庫-台中,2023-07-17,1021
6570,維田,25,1,24,合庫-台中,2023-07-17,1021
5258,虹堡,50,27,23,合庫-台中,2023-07-17,1021
2027,大成鋼,27,4,23,合庫-台中,2023-07-17,1021
2352,佳世達,49,26,23,合庫-台中,2023-07-17,1021
2618,長榮航,84,62,22,合庫-台中,2023-07-17,1021
1445,大宇,22,0,22,合庫-台中,2023-07-17,1021
2301,光寶科,72,50,22,合庫-台中,2023-07-17,1021
4961,天鈺,21,0,21,合庫-台中,2023-07-17,1021
3221,台嘉碩,23,2,21,合庫-台中,2023-07-17,1021
3704,合勤控,45,25,20,合庫-台中,2023-07-17,1021
2601,益航,21,1,20,合庫-台中,2023-07-17,1021
3025,星通,104,84,20,合庫-台中,2023-07-17,1021
00725B,國泰投資級公司債,20,0,20,合庫-台中,2023-07-17,1021
6120,達運,23,4,19,合庫-台中,2023-07-17,1021
8112,至上,28,9,19,合庫-台中,2023-07-17,1021
2353,宏��,399,99,300,合庫-台中,2023-07-18,1021
2312,金寶,374,146,228,合庫-台中,2023-07-18,1021
6282,康舒,318,115,203,合庫-台中,2023-07-18,1021
8926,台汽電,187,6,181,合庫-台中,2023-07-18,1021
00632R,元大台灣50反1,171,21,150,合庫-台中,2023-07-18,1021
00882,中信中國高股息,150,0,150,合庫-台中,2023-07-18,1021
1806,冠軍,200,54,146,合庫-台中,2023-07-18,1021
00929,復華台灣科技優息,173,28,145,合庫-台中,2023-07-18,1021
2399,映泰,149,18,131,合庫-台中,2023-07-18,1021
2324,仁寶,272,148,124,合庫-台中,2023-07-18,1021
3706,神達,337,218,119,合庫-台中,2023-07-18,1021
00715L,期街口布蘭特正2,163,48,115,合庫-台中,2023-07-18,1021
4938,和碩,177,92,85,合庫-台中,2023-07-18,1021
8401,白紗科,100,15,85,合庫-台中,2023-07-18,1021
6140,訊達,80,0,80,合庫-台中,2023-07-18,1021
8936,國統,85,5,80,合庫-台中,2023-07-18,1021
2352,佳世達,155,81,74,合庫-台中,2023-07-18,1021
0056,元大高股息,168,102,66,合庫-台中,2023-07-18,1021
3078,僑威,130,67,63,合庫-台中,2023-07-18,1021
2359,所羅門,65,3,62,合庫-台中,2023-07-18,1021
00665L,富邦�琤肭磪囓�2,55,2,53,合庫-台中,2023-07-18,1021
1514,亞力,141,91,50,合庫-台中,2023-07-18,1021
8171,天宇,50,1,49,合庫-台中,2023-07-18,1021
2610,華航,203,160,43,合庫-台中,2023-07-18,1021
9105,泰金寶-DR,151,108,43,合庫-台中,2023-07-18,1021
1785,光洋科,45,3,42,合庫-台中,2023-07-18,1021
2515,中工,71,30,41,合庫-台中,2023-07-18,1021
2601,益航,40,0,40,合庫-台中,2023-07-18,1021
3321,同泰,39,0,39,合庫-台中,2023-07-18,1021
2481,強茂,61,22,39,合庫-台中,2023-07-18,1021
2801,彰銀,54,16,38,合庫-台中,2023-07-18,1021
2329,華泰,126,89,37,合庫-台中,2023-07-18,1021
2409,友達,54,19,35,合庫-台中,2023-07-18,1021
2401,凌陽,35,1,34,合庫-台中,2023-07-18,1021
6235,華孚,33,0,33,合庫-台中,2023-07-18,1021
4541,晟田,35,2,33,合庫-台中,2023-07-18,1021
2340,台亞,97,64,33,合庫-台中,2023-07-18,1021
3163,波若威,40,8,32,合庫-台中,2023-07-18,1021
00712,復華富時不動產,32,1,31,合庫-台中,2023-07-18,1021
00670L,富邦NASDAQ正2,31,0,31,合庫-台中,2023-07-18,1021
00919,群益台灣精選高息,39,8,31,合庫-台中,2023-07-18,1021
5469,瀚宇博,33,6,27,合庫-台中,2023-07-18,1021
9902,台火,27,0,27,合庫-台中,2023-07-18,1021
00788B,元大10年IG電能債,25,0,25,合庫-台中,2023-07-18,1021
6218,豪勉,35,11,24,合庫-台中,2023-07-18,1021
3058,立德,29,5,24,合庫-台中,2023-07-18,1021
1522,堤維西,24,0,24,合庫-台中,2023-07-18,1021
6118,建達,24,0,24,合庫-台中,2023-07-18,1021
2889,國票金,38,15,23,合庫-台中,2023-07-18,1021
6288,聯嘉,23,0,23,合庫-台中,2023-07-18,1021
2303,聯電,230,20,210,合庫-台中,2023-07-19,1021
2618,長榮航,273,72,201,合庫-台中,2023-07-19,1021
00919,群益台灣精選高息,216,15,201,合庫-台中,2023-07-19,1021
2356,英業達,517,317,200,合庫-台中,2023-07-19,1021
2324,仁寶,292,145,147,合庫-台中,2023-07-19,1021
2329,華泰,231,92,139,合庫-台中,2023-07-19,1021
00882,中信中國高股息,158,48,110,合庫-台中,2023-07-19,1021
9105,泰金寶-DR,135,36,99,合庫-台中,2023-07-19,1021
4938,和碩,125,41,84,合庫-台中,2023-07-19,1021
5460,同協,69,0,69,合庫-台中,2023-07-19,1021
3481,群創,149,83,66,合庫-台中,2023-07-19,1021
2317,鴻海,78,13,65,合庫-台中,2023-07-19,1021
4934,太極,68,8,60,合庫-台中,2023-07-19,1021
2882,國泰金,67,8,59,合庫-台中,2023-07-19,1021
2801,彰銀,175,122,53,合庫-台中,2023-07-19,1021
00696B,富邦美債20年,53,0,53,合庫-台中,2023-07-19,1021
00929,復華台灣科技優息,86,33,53,合庫-台中,2023-07-19,1021
6284,佳邦,47,0,47,合庫-台中,2023-07-19,1021
2883,凱基金,52,13,39,合庫-台中,2023-07-19,1021
3037,欣興,97,59,38,合庫-台中,2023-07-19,1021
1504,東元,52,14,38,合庫-台中,2023-07-19,1021
3706,神達,399,362,37,合庫-台中,2023-07-19,1021
3011,今皓,35,0,35,合庫-台中,2023-07-19,1021
00753L,中信中國50正2,67,32,35,合庫-台中,2023-07-19,1021
2457,飛宏,54,20,34,合庫-台中,2023-07-19,1021
2881,富邦金,36,5,31,合庫-台中,2023-07-19,1021
1708,東鹼,51,20,31,合庫-台中,2023-07-19,1021
8027,鈦昇,30,0,30,合庫-台中,2023-07-19,1021
6612,奈米醫材,27,0,27,合庫-台中,2023-07-19,1021
1789,神隆,32,7,25,合庫-台中,2023-07-19,1021
6153,嘉聯益,26,1,25,合庫-台中,2023-07-19,1021
2890,永豐金,27,2,25,合庫-台中,2023-07-19,1021
3163,波若威,25,2,23,合庫-台中,2023-07-19,1021
1402,遠東新,23,0,23,合庫-台中,2023-07-19,1021
6235,華孚,87,64,23,合庫-台中,2023-07-19,1021
2308,台達電,21,0,21,合庫-台中,2023-07-19,1021
3105,穩懋,25,4,21,合庫-台中,2023-07-19,1021
1101,台泥,24,3,21,合庫-台中,2023-07-19,1021
2002,中鋼,21,1,20,合庫-台中,2023-07-19,1021
2382,廣達,87,67,20,合庫-台中,2023-07-19,1021
6288,聯嘉,23,3,20,合庫-台中,2023-07-19,1021
2601,益航,20,0,20,合庫-台中,2023-07-19,1021
2498,宏達電,21,1,20,合庫-台中,2023-07-19,1021
6133,金橋,20,0,20,合庫-台中,2023-07-19,1021
6223,旺矽,24,4,20,合庫-台中,2023-07-19,1021
6547,高端疫苗,24,4,20,合庫-台中,2023-07-19,1021
6118,建達,31,12,19,合庫-台中,2023-07-19,1021
2419,仲琦,52,33,19,合庫-台中,2023-07-19,1021
1313,聯成,19,1,18,合庫-台中,2023-07-19,1021
3715,定穎投控,19,1,18,合庫-台中,2023-07-19,1021
00637L,元大滬深300正2,1996,1045,951,合庫-台中,2023-07-20,1021
00665L,富邦�琤肭磪囓�2,697,60,637,合庫-台中,2023-07-20,1021
2303,聯電,488,22,466,合庫-台中,2023-07-20,1021
4123,晟德,147,42,105,合庫-台中,2023-07-20,1021
00673R,期元大S＆P原油反1,85,0,85,合庫-台中,2023-07-20,1021
2461,光群雷,68,1,67,合庫-台中,2023-07-20,1021
2337,旺宏,66,0,66,合庫-台中,2023-07-20,1021
2630,亞航,55,2,53,合庫-台中,2023-07-20,1021
00929,復華台灣科技優息,66,16,50,合庫-台中,2023-07-20,1021
8033,雷虎,50,2,48,合庫-台中,2023-07-20,1021
1102,亞泥,45,0,45,合庫-台中,2023-07-20,1021
6531,愛普*,43,1,42,合庫-台中,2023-07-20,1021
2376,技嘉,56,17,39,合庫-台中,2023-07-20,1021
1529,樂事綠能,66,28,38,合庫-台中,2023-07-20,1021
4938,和碩,43,6,37,合庫-台中,2023-07-20,1021
3289,宜特,58,24,34,合庫-台中,2023-07-20,1021
00688L,國泰20年美債正2,34,0,34,合庫-台中,2023-07-20,1021
2352,佳世達,174,141,33,合庫-台中,2023-07-20,1021
00893,國泰智能電動車,31,0,31,合庫-台中,2023-07-20,1021
2449,京元電子,35,6,29,合庫-台中,2023-07-20,1021
6235,華孚,45,17,28,合庫-台中,2023-07-20,1021
2881,富邦金,32,4,28,合庫-台中,2023-07-20,1021
6120,達運,33,9,24,合庫-台中,2023-07-20,1021
2313,華通,61,37,24,合庫-台中,2023-07-20,1021
3013,晟銘電,43,20,23,合庫-台中,2023-07-20,1021
6770,力積電,26,4,22,合庫-台中,2023-07-20,1021
00882,中信中國高股息,22,0,22,合庫-台中,2023-07-20,1021
8050,廣積,25,3,22,合庫-台中,2023-07-20,1021
2705,六福,21,0,21,合庫-台中,2023-07-20,1021
2883,凱基金,20,1,19,合庫-台中,2023-07-20,1021
2515,中工,21,2,19,合庫-台中,2023-07-20,1021
3078,僑威,35,16,19,合庫-台中,2023-07-20,1021
4543,萬在,20,1,19,合庫-台中,2023-07-20,1021
6282,康舒,157,138,19,合庫-台中,2023-07-20,1021
2201,裕隆,19,2,17,合庫-台中,2023-07-20,1021
2317,鴻海,36,19,17,合庫-台中,2023-07-20,1021
6138,茂達,16,0,16,合庫-台中,2023-07-20,1021
00782B,國泰A級公用債,15,0,15,合庫-台中,2023-07-20,1021
6118,建達,15,0,15,合庫-台中,2023-07-20,1021
2206,三陽工業,94,79,15,合庫-台中,2023-07-20,1021
8926,台汽電,30,15,15,合庫-台中,2023-07-20,1021
2419,仲琦,31,17,14,合庫-台中,2023-07-20,1021
3264,欣銓,22,8,14,合庫-台中,2023-07-20,1021
6841,長佳智能,30,16,14,合庫-台中,2023-07-20,1021
00712,復華富時不動產,16,2,14,合庫-台中,2023-07-20,1021
1101,台泥,13,0,13,合庫-台中,2023-07-20,1021
2887,台新金,19,6,13,合庫-台中,2023-07-20,1021
2330,台積電,13,0,13,合庫-台中,2023-07-20,1021
6796,晉弘,13,1,12,合庫-台中,2023-07-20,1021
2884,玉山金,14,2,12,合庫-台中,2023-07-20,1021
00637L,元大滬深300正2,500,105,395,合庫-台中,2023-07-21,1021
00900,富邦特選高股息30,262,0,262,合庫-台中,2023-07-21,1021
1570,力肯,240,0,240,合庫-台中,2023-07-21,1021
1513,中興電,313,127,186,合庫-台中,2023-07-21,1021
00929,復華台灣科技優息,178,25,153,合庫-台中,2023-07-21,1021
2609,陽明,161,15,146,合庫-台中,2023-07-21,1021
00715L,期街口布蘭特正2,190,51,139,合庫-台中,2023-07-21,1021
2303,聯電,151,13,138,合庫-台中,2023-07-21,1021
2027,大成鋼,127,7,120,合庫-台中,2023-07-21,1021
4533,協易機,114,7,107,合庫-台中,2023-07-21,1021
00673R,期元大S＆P原油反1,96,0,96,合庫-台中,2023-07-21,1021
2323,中環,86,1,85,合庫-台中,2023-07-21,1021
3305,昇貿,85,22,63,合庫-台中,2023-07-21,1021
1101,台泥,62,3,59,合庫-台中,2023-07-21,1021
1472,三洋實業,58,0,58,合庫-台中,2023-07-21,1021
1712,興農,52,0,52,合庫-台中,2023-07-21,1021
00712,復華富時不動產,53,1,52,合庫-台中,2023-07-21,1021
2002,中鋼,54,14,40,合庫-台中,2023-07-21,1021
2888,新光金,55,21,34,合庫-台中,2023-07-21,1021
2610,華航,101,67,34,合庫-台中,2023-07-21,1021
1102,亞泥,39,6,33,合庫-台中,2023-07-21,1021
2405,輔信,42,11,31,合庫-台中,2023-07-21,1021
00930,永豐ESG低碳高息,31,0,31,合庫-台中,2023-07-21,1021
00642U,期元大S＆P石油,31,0,31,合庫-台中,2023-07-21,1021
1515,力山,31,0,31,合庫-台中,2023-07-21,1021
2382,廣達,172,141,31,合庫-台中,2023-07-21,1021
2206,三陽工業,47,17,30,合庫-台中,2023-07-21,1021
00891,中信關鍵半導體,30,0,30,合庫-台中,2023-07-21,1021
2329,華泰,118,88,30,合庫-台中,2023-07-21,1021
2330,台積電,52,23,29,合庫-台中,2023-07-21,1021
2371,大同,52,23,29,合庫-台中,2023-07-21,1021
1789,神隆,45,16,29,合庫-台中,2023-07-21,1021
6548,長科*,30,1,29,合庫-台中,2023-07-21,1021
00679B,元大美債20年,30,2,28,合庫-台中,2023-07-21,1021
3013,晟銘電,167,139,28,合庫-台中,2023-07-21,1021
1605,華新,31,4,27,合庫-台中,2023-07-21,1021
2515,中工,51,25,26,合庫-台中,2023-07-21,1021
8409,商之器,30,5,25,合庫-台中,2023-07-21,1021
00764B,群益25年美債,25,0,25,合庫-台中,2023-07-21,1021
00895,富邦未來車,34,10,24,合庫-台中,2023-07-21,1021
4526,東台,21,0,21,合庫-台中,2023-07-21,1021
2892,第一金,23,2,21,合庫-台中,2023-07-21,1021
2614,東森,20,0,20,合庫-台中,2023-07-21,1021
2241,艾姆勒,20,0,20,合庫-台中,2023-07-21,1021
1402,遠東新,20,0,20,合庫-台中,2023-07-21,1021
2705,六福,36,16,20,合庫-台中,2023-07-21,1021
0050,元大台灣50,24,5,19,合庫-台中,2023-07-21,1021
8046,南電,20,1,19,合庫-台中,2023-07-21,1021
3546,宇峻,19,0,19,合庫-台中,2023-07-21,1021
8215,明基材,30,11,19,合庫-台中,2023-07-21,1021
00893,國泰智能電動車,153,8,145,合庫-台中,2023-07-24,1021
1609,大亞,187,52,135,合庫-台中,2023-07-24,1021
00670L,富邦NASDAQ正2,104,0,104,合庫-台中,2023-07-24,1021
6125,廣運,154,56,98,合庫-台中,2023-07-24,1021
3338,泰碩,153,58,95,合庫-台中,2023-07-24,1021
00665L,富邦�琤肭磪囓�2,90,0,90,合庫-台中,2023-07-24,1021
2353,宏��,132,48,84,合庫-台中,2023-07-24,1021
2329,華泰,255,180,75,合庫-台中,2023-07-24,1021
2371,大同,114,40,74,合庫-台中,2023-07-24,1021
2382,廣達,175,102,73,合庫-台中,2023-07-24,1021
2609,陽明,90,20,70,合庫-台中,2023-07-24,1021
2313,華通,67,2,65,合庫-台中,2023-07-24,1021
1514,亞力,90,25,65,合庫-台中,2023-07-24,1021
2801,彰銀,63,0,63,合庫-台中,2023-07-24,1021
2356,英業達,104,48,56,合庫-台中,2023-07-24,1021
2457,飛宏,67,13,54,合庫-台中,2023-07-24,1021
2515,中工,59,8,51,合庫-台中,2023-07-24,1021
3051,力特,53,5,48,合庫-台中,2023-07-24,1021
2913,農林,54,7,47,合庫-台中,2023-07-24,1021
1513,中興電,182,136,46,合庫-台中,2023-07-24,1021
1708,東鹼,49,3,46,合庫-台中,2023-07-24,1021
2337,旺宏,49,4,45,合庫-台中,2023-07-24,1021
1504,東元,76,31,45,合庫-台中,2023-07-24,1021
1532,勤美,66,22,44,合庫-台中,2023-07-24,1021
2421,建準,73,32,41,合庫-台中,2023-07-24,1021
2453,凌群,41,0,41,合庫-台中,2023-07-24,1021
6231,系微,40,0,40,合庫-台中,2023-07-24,1021
2887,台新金,38,0,38,合庫-台中,2023-07-24,1021
2461,光群雷,64,27,37,合庫-台中,2023-07-24,1021
3523,迎輝,36,0,36,合庫-台中,2023-07-24,1021
1314,中石化,36,0,36,合庫-台中,2023-07-24,1021
00632R,元大台灣50反1,40,7,33,合庫-台中,2023-07-24,1021
2303,聯電,49,18,31,合庫-台中,2023-07-24,1021
2349,錸德,31,0,31,合庫-台中,2023-07-24,1021
1515,力山,35,4,31,合庫-台中,2023-07-24,1021
4960,誠美材,30,0,30,合庫-台中,2023-07-24,1021
2618,長榮航,46,17,29,合庫-台中,2023-07-24,1021
3710,連展投控,30,1,29,合庫-台中,2023-07-24,1021
3481,群創,226,200,26,合庫-台中,2023-07-24,1021
1471,首利,29,3,26,合庫-台中,2023-07-24,1021
3035,智原,59,34,25,合庫-台中,2023-07-24,1021
6548,長科*,25,0,25,合庫-台中,2023-07-24,1021
1102,亞泥,24,0,24,合庫-台中,2023-07-24,1021
1101,台泥,35,10,25,合庫-台中,2023-07-24,1021
3594,磐儀,26,3,23,合庫-台中,2023-07-24,1021
6531,愛普*,26,4,22,合庫-台中,2023-07-24,1021
3306,鼎天,40,18,22,合庫-台中,2023-07-24,1021
2390,云辰,21,0,21,合庫-台中,2023-07-24,1021
00772B,中信高評級公司債,36,15,21,合庫-台中,2023-07-24,1021
2492,華新科,22,1,21,合庫-台中,2023-07-24,1021
00680L,元大美債20正2,299,83,216,合庫-台中,2023-07-25,1021
1217,愛之味,219,15,204,合庫-台中,2023-07-25,1021
00679B,元大美債20年,112,8,104,合庫-台中,2023-07-25,1021
1584,精剛,100,6,94,合庫-台中,2023-07-25,1021
00878,國泰永續高股息,159,68,91,合庫-台中,2023-07-25,1021
8358,金居,155,66,89,合庫-台中,2023-07-25,1021
3051,力特,81,8,73,合庫-台中,2023-07-25,1021
00673R,期元大S＆P原油反1,72,0,72,合庫-台中,2023-07-25,1021
1905,華紙,177,110,67,合庫-台中,2023-07-25,1021
4543,萬在,66,7,59,合庫-台中,2023-07-25,1021
1314,中石化,50,0,50,合庫-台中,2023-07-25,1021
2031,新光鋼,50,0,50,合庫-台中,2023-07-25,1021
2382,廣達,275,229,46,合庫-台中,2023-07-25,1021
1708,東鹼,45,2,43,合庫-台中,2023-07-25,1021
9933,中鼎,42,0,42,合庫-台中,2023-07-25,1021
4523,永彰,43,3,40,合庫-台中,2023-07-25,1021
3546,宇峻,40,0,40,合庫-台中,2023-07-25,1021
2614,東森,35,0,35,合庫-台中,2023-07-25,1021
2352,佳世達,51,17,34,合庫-台中,2023-07-25,1021
00929,復華台灣科技優息,91,60,31,合庫-台中,2023-07-25,1021
2610,華航,70,39,31,合庫-台中,2023-07-25,1021
1472,三洋實業,30,0,30,合庫-台中,2023-07-25,1021
6164,華興,30,0,30,合庫-台中,2023-07-25,1021
6218,豪勉,78,49,29,合庫-台中,2023-07-25,1021
3702,大聯大,30,1,29,合庫-台中,2023-07-25,1021
6285,啟��,28,0,28,合庫-台中,2023-07-25,1021
2834,臺企銀,26,0,26,合庫-台中,2023-07-25,1021
1102,亞泥,30,6,24,合庫-台中,2023-07-25,1021
3221,台嘉碩,28,5,23,合庫-台中,2023-07-25,1021
3325,旭品,25,2,23,合庫-台中,2023-07-25,1021
2344,華邦電,35,13,22,合庫-台中,2023-07-25,1021
2419,仲琦,40,18,22,合庫-台中,2023-07-25,1021
00919,群益台灣精選高息,24,3,21,合庫-台中,2023-07-25,1021
5452,佶優,22,2,20,合庫-台中,2023-07-25,1021
1506,正道,20,0,20,合庫-台中,2023-07-25,1021
3338,泰碩,48,28,20,合庫-台中,2023-07-25,1021
2884,玉山金,20,1,19,合庫-台中,2023-07-25,1021
2357,華碩,39,20,19,合庫-台中,2023-07-25,1021
3022,威強電,20,1,19,合庫-台中,2023-07-25,1021
6770,力積電,41,22,19,合庫-台中,2023-07-25,1021
1609,大亞,33,15,18,合庫-台中,2023-07-25,1021
3689,湧德,26,9,17,合庫-台中,2023-07-25,1021
4953,緯軟,28,11,17,合庫-台中,2023-07-25,1021
1737,臺鹽,17,0,17,合庫-台中,2023-07-25,1021
3701,大眾控,20,3,17,合庫-台中,2023-07-25,1021
8093,保銳,20,4,16,合庫-台中,2023-07-25,1021
3523,迎輝,16,0,16,合庫-台中,2023-07-25,1021
00927,群益半導體收益,15,0,15,合庫-台中,2023-07-25,1021
8049,晶采,15,0,15,合庫-台中,2023-07-25,1021
6188,廣明,56,41,15,合庫-台中,2023-07-25,1021
1101,台泥,1349,30,1319,合庫-台中,2023-07-26,1021
1504,東元,509,151,358,合庫-台中,2023-07-26,1021
00673R,期元大S＆P原油反1,100,0,100,合庫-台中,2023-07-26,1021
3450,聯鈞,124,29,95,合庫-台中,2023-07-26,1021
5258,虹堡,95,11,84,合庫-台中,2023-07-26,1021
4523,永彰,84,9,75,合庫-台中,2023-07-26,1021
8011,台通,60,0,60,合庫-台中,2023-07-26,1021
1445,大宇,60,0,60,合庫-台中,2023-07-26,1021
00882,中信中國高股息,68,10,58,合庫-台中,2023-07-26,1021
2371,大同,59,7,52,合庫-台中,2023-07-26,1021
2405,輔信,95,45,50,合庫-台中,2023-07-26,1021
8027,鈦昇,50,0,50,合庫-台中,2023-07-26,1021
00929,復華台灣科技優息,82,35,47,合庫-台中,2023-07-26,1021
1618,合機,60,18,42,合庫-台中,2023-07-26,1021
2630,亞航,41,0,41,合庫-台中,2023-07-26,1021
00632R,元大台灣50反1,40,2,38,合庫-台中,2023-07-26,1021
6120,達運,61,25,36,合庫-台中,2023-07-26,1021
2344,華邦電,43,7,36,合庫-台中,2023-07-26,1021
00930,永豐ESG低碳高息,35,0,35,合庫-台中,2023-07-26,1021
2337,旺宏,40,7,33,合庫-台中,2023-07-26,1021
1102,亞泥,38,5,33,合庫-台中,2023-07-26,1021
1471,首利,39,8,31,合庫-台中,2023-07-26,1021
6188,廣明,70,40,30,合庫-台中,2023-07-26,1021
2104,國際中橡,30,0,30,合庫-台中,2023-07-26,1021
2701,萬企,30,0,30,合庫-台中,2023-07-26,1021
00927,群益半導體收益,30,1,29,合庫-台中,2023-07-26,1021
00919,群益台灣精選高息,40,11,29,合庫-台中,2023-07-26,1021
6770,力積電,27,0,27,合庫-台中,2023-07-26,1021
3546,宇峻,27,0,27,合庫-台中,2023-07-26,1021
2454,聯發科,28,1,27,合庫-台中,2023-07-26,1021
6776,展�眥篕�,26,0,26,合庫-台中,2023-07-26,1021
2303,聯電,42,17,25,合庫-台中,2023-07-26,1021
3025,星通,100,76,24,合庫-台中,2023-07-26,1021
6213,聯茂,57,34,23,合庫-台中,2023-07-26,1021
1513,中興電,29,6,23,合庫-台中,2023-07-26,1021
2618,長榮航,41,19,22,合庫-台中,2023-07-26,1021
2002,中鋼,25,3,22,合庫-台中,2023-07-26,1021
6733,博晟生醫,22,0,22,合庫-台中,2023-07-26,1021
2010,春源,26,5,21,合庫-台中,2023-07-26,1021
2323,中環,43,22,21,合庫-台中,2023-07-26,1021
3231,緯創,68,47,21,合庫-台中,2023-07-26,1021
00713,元大台灣高息低波,22,2,20,合庫-台中,2023-07-26,1021
8049,晶采,20,0,20,合庫-台中,2023-07-26,1021
6426,統新,20,0,20,合庫-台中,2023-07-26,1021
2906,高林,20,0,20,合庫-台中,2023-07-26,1021
6288,聯嘉,20,0,20,合庫-台中,2023-07-26,1021
9105,泰金寶-DR,40,20,20,合庫-台中,2023-07-26,1021
6235,華孚,115,96,19,合庫-台中,2023-07-26,1021
1605,華新,20,1,19,合庫-台中,2023-07-26,1021
3011,今皓,25,6,19,合庫-台中,2023-07-26,1021
2845,遠東銀,160,0,160,合庫-台中,2023-07-27,1021
8390,金益鼎,150,1,149,合庫-台中,2023-07-27,1021
2371,大同,186,46,140,合庫-台中,2023-07-27,1021
1570,力肯,121,0,121,合庫-台中,2023-07-27,1021
2002,中鋼,120,1,119,合庫-台中,2023-07-27,1021
00673R,期元大S＆P原油反1,127,15,112,合庫-台中,2023-07-27,1021
2382,廣達,201,97,104,合庫-台中,2023-07-27,1021
00670L,富邦NASDAQ正2,100,0,100,合庫-台中,2023-07-27,1021
3056,富華新,116,27,89,合庫-台中,2023-07-27,1021
2329,華泰,204,121,83,合庫-台中,2023-07-27,1021
2887,台新金,84,3,81,合庫-台中,2023-07-27,1021
2313,華通,95,24,71,合庫-台中,2023-07-27,1021
6148,驊宏資,60,0,60,合庫-台中,2023-07-27,1021
00679B,元大美債20年,79,21,58,合庫-台中,2023-07-27,1021
5351,鈺創,91,40,51,合庫-台中,2023-07-27,1021
4523,永彰,39,2,37,合庫-台中,2023-07-27,1021
3051,力特,65,30,35,合庫-台中,2023-07-27,1021
3037,欣興,94,63,31,合庫-台中,2023-07-27,1021
1608,華榮,41,10,31,合庫-台中,2023-07-27,1021
8027,鈦昇,32,2,30,合庫-台中,2023-07-27,1021
2405,輔信,65,36,29,合庫-台中,2023-07-27,1021
1904,正隆,50,22,28,合庫-台中,2023-07-27,1021
1101,台泥,27,1,26,合庫-台中,2023-07-27,1021
3483,力致,25,0,25,合庫-台中,2023-07-27,1021
00680L,元大美債20正2,25,0,25,合庫-台中,2023-07-27,1021
3013,晟銘電,36,12,24,合庫-台中,2023-07-27,1021
00902,中信電池及儲能,35,12,23,合庫-台中,2023-07-27,1021
1402,遠東新,23,0,23,合庫-台中,2023-07-27,1021
3576,聯合再生,22,0,22,合庫-台中,2023-07-27,1021
00715L,期街口布蘭特正2,40,19,21,合庫-台中,2023-07-27,1021
3523,迎輝,21,0,21,合庫-台中,2023-07-27,1021
4533,協易機,49,28,21,合庫-台中,2023-07-27,1021
2906,高林,20,0,20,合庫-台中,2023-07-27,1021
6274,台燿,43,24,19,合庫-台中,2023-07-27,1021
2884,玉山金,43,25,18,合庫-台中,2023-07-27,1021
1216,統一,18,0,18,合庫-台中,2023-07-27,1021
1471,首利,19,1,18,合庫-台中,2023-07-27,1021
2401,凌陽,21,4,17,合庫-台中,2023-07-27,1021
1337,再生-KY,17,0,17,合庫-台中,2023-07-27,1021
6112,邁達特,19,2,17,合庫-台中,2023-07-27,1021
2340,台亞,37,21,16,合庫-台中,2023-07-27,1021
2355,敬鵬,16,0,16,合庫-台中,2023-07-27,1021
1445,大宇,16,0,16,合庫-台中,2023-07-27,1021
1102,亞泥,17,1,16,合庫-台中,2023-07-27,1021
2392,正崴,15,0,15,合庫-台中,2023-07-27,1021
00687B,國泰20年美債,18,3,15,合庫-台中,2023-07-27,1021
2208,台船,15,0,15,合庫-台中,2023-07-27,1021
2614,東森,14,0,14,合庫-台中,2023-07-27,1021
6188,廣明,49,35,14,合庫-台中,2023-07-27,1021
2377,微星,14,1,13,合庫-台中,2023-07-27,1021
00679B,元大美債20年,245,2,243,合庫-台中,2023-07-28,1021
1905,華紙,414,257,157,合庫-台中,2023-07-28,1021
2610,華航,205,58,147,合庫-台中,2023-07-28,1021
2371,大同,141,29,112,合庫-台中,2023-07-28,1021
2409,友達,235,139,96,合庫-台中,2023-07-28,1021
2457,飛宏,225,134,91,合庫-台中,2023-07-28,1021
2888,新光金,443,353,90,合庫-台中,2023-07-28,1021
00632R,元大台灣50反1,90,14,76,合庫-台中,2023-07-28,1021
00673R,期元大S＆P原油反1,77,1,76,合庫-台中,2023-07-28,1021
2359,所羅門,76,5,71,合庫-台中,2023-07-28,1021
00680L,元大美債20正2,78,10,68,合庫-台中,2023-07-28,1021
2882,國泰金,71,10,61,合庫-台中,2023-07-28,1021
2313,華通,109,50,59,合庫-台中,2023-07-28,1021
00720B,元大投資級公司債,52,0,52,合庫-台中,2023-07-28,1021
2002,中鋼,55,3,52,合庫-台中,2023-07-28,1021
2027,大成鋼,53,3,50,合庫-台中,2023-07-28,1021
4973,廣穎,63,14,49,合庫-台中,2023-07-28,1021
5351,鈺創,52,3,49,合庫-台中,2023-07-28,1021
1570,力肯,48,0,48,合庫-台中,2023-07-28,1021
3231,緯創,194,153,41,合庫-台中,2023-07-28,1021
2498,宏達電,60,20,40,合庫-台中,2023-07-28,1021
3051,力特,54,15,39,合庫-台中,2023-07-28,1021
2884,玉山金,41,2,39,合庫-台中,2023-07-28,1021
00712,復華富時不動產,40,1,39,合庫-台中,2023-07-28,1021
00687B,國泰20年美債,40,2,38,合庫-台中,2023-07-28,1021
4906,正文,37,0,37,合庫-台中,2023-07-28,1021
6117,迎廣,38,3,35,合庫-台中,2023-07-28,1021
2801,彰銀,45,10,35,合庫-台中,2023-07-28,1021
00795B,中信美國公債20年,34,0,34,合庫-台中,2023-07-28,1021
2062,橋椿,32,0,32,合庫-台中,2023-07-28,1021
1609,大亞,39,10,29,合庫-台中,2023-07-28,1021
2317,鴻海,30,4,26,合庫-台中,2023-07-28,1021
2605,新興,27,1,26,合庫-台中,2023-07-28,1021
2743,山富,29,4,25,合庫-台中,2023-07-28,1021
2731,雄獅,24,1,23,合庫-台中,2023-07-28,1021
3706,神達,33,11,22,合庫-台中,2023-07-28,1021
2480,敦陽科,21,0,21,合庫-台中,2023-07-28,1021
4746,台耀,22,2,20,合庫-台中,2023-07-28,1021
00683L,期元大美元指正2,50,30,20,合庫-台中,2023-07-28,1021
1569,濱川,20,0,20,合庫-台中,2023-07-28,1021
6426,統新,20,0,20,合庫-台中,2023-07-28,1021
6112,邁達特,20,1,19,合庫-台中,2023-07-28,1021
3663,鑫科,20,1,19,合庫-台中,2023-07-28,1021
2104,國際中橡,22,3,19,合庫-台中,2023-07-28,1021
00888,永豐台灣ESG,18,0,18,合庫-台中,2023-07-28,1021
3047,訊舟,18,0,18,合庫-台中,2023-07-28,1021
00772B,中信高評級公司債,17,0,17,合庫-台中,2023-07-28,1021
2401,凌陽,18,1,17,合庫-台中,2023-07-28,1021
1815,富喬,44,28,16,合庫-台中,2023-07-28,1021
6146,耕興,16,0,16,合庫-台中,2023-07-28,1021
00673R,期元大S＆P原油反1,350,5,345,合庫-台中,2023-07-31,1021
00679B,元大美債20年,251,3,248,合庫-台中,2023-07-31,1021
00929,復華台灣科技優息,292,61,231,合庫-台中,2023-07-31,1021
00665L,富邦�琤肭磪囓�2,263,93,170,合庫-台中,2023-07-31,1021
00878,國泰永續高股息,512,385,127,合庫-台中,2023-07-31,1021
6269,台郡,118,0,118,合庫-台中,2023-07-31,1021
2897,王道銀行,109,0,109,合庫-台中,2023-07-31,1021
1314,中石化,107,2,105,合庫-台中,2023-07-31,1021
2426,鼎元,124,22,102,合庫-台中,2023-07-31,1021
2409,友達,118,22,96,合庫-台中,2023-07-31,1021
2002,中鋼,96,1,95,合庫-台中,2023-07-31,1021
00632R,元大台灣50反1,164,89,75,合庫-台中,2023-07-31,1021
2913,農林,125,54,71,合庫-台中,2023-07-31,1021
1815,富喬,115,44,71,合庫-台中,2023-07-31,1021
2457,飛宏,97,26,71,合庫-台中,2023-07-31,1021
6116,彩晶,174,112,62,合庫-台中,2023-07-31,1021
2329,華泰,329,272,57,合庫-台中,2023-07-31,1021
3481,群創,397,345,52,合庫-台中,2023-07-31,1021
00720B,元大投資級公司債,64,12,52,合庫-台中,2023-07-31,1021
1810,和成,51,0,51,合庫-台中,2023-07-31,1021
00885,富邦越南,60,11,49,合庫-台中,2023-07-31,1021
2884,玉山金,47,1,46,合庫-台中,2023-07-31,1021
2027,大成鋼,45,0,45,合庫-台中,2023-07-31,1021
2891,中信金,45,0,45,合庫-台中,2023-07-31,1021
8038,長園科,41,0,41,合庫-台中,2023-07-31,1021
2609,陽明,49,9,40,合庫-台中,2023-07-31,1021
4979,華星光,64,25,39,合庫-台中,2023-07-31,1021
3051,力特,41,3,38,合庫-台中,2023-07-31,1021
3231,緯創,151,114,37,合庫-台中,2023-07-31,1021
2356,英業達,79,43,36,合庫-台中,2023-07-31,1021
3693,營邦,42,7,35,合庫-台中,2023-07-31,1021
3706,神達,89,55,34,合庫-台中,2023-07-31,1021
00680L,元大美債20正2,33,0,33,合庫-台中,2023-07-31,1021
2206,三陽工業,40,9,31,合庫-台中,2023-07-31,1021
4563,百德,30,0,30,合庫-台中,2023-07-31,1021
1591,駿吉-KY,30,0,30,合庫-台中,2023-07-31,1021
2883,凱基金,31,2,29,合庫-台中,2023-07-31,1021
8358,金居,53,24,29,合庫-台中,2023-07-31,1021
6182,合晶,28,0,28,合庫-台中,2023-07-31,1021
3025,星通,41,13,28,合庫-台中,2023-07-31,1021
2392,正崴,26,0,26,合庫-台中,2023-07-31,1021
2603,長榮,38,13,25,合庫-台中,2023-07-31,1021
00795B,中信美國公債20年,24,0,24,合庫-台中,2023-07-31,1021
2618,長榮航,48,24,24,合庫-台中,2023-07-31,1021
4904,遠傳,24,0,24,合庫-台中,2023-07-31,1021
2743,山富,52,28,24,合庫-台中,2023-07-31,1021
2324,仁寶,72,48,24,合庫-台中,2023-07-31,1021
00687B,國泰20年美債,24,1,23,合庫-台中,2023-07-31,1021
2301,光寶科,86,63,23,合庫-台中,2023-07-31,1021
3325,旭品,28,6,22,合庫-台中,2023-07-31,1021
6282,康舒,218,82,136,合庫-台中,2023-08-01,1021
1815,富喬,143,8,135,合庫-台中,2023-08-01,1021
00715L,期街口布蘭特正2,115,7,108,合庫-台中,2023-08-01,1021
1905,華紙,154,46,108,合庫-台中,2023-08-01,1021
00929,復華台灣科技優息,124,24,100,合庫-台中,2023-08-01,1021
2891,中信金,88,2,86,合庫-台中,2023-08-01,1021
2312,金寶,87,12,75,合庫-台中,2023-08-01,1021
00637L,元大滬深300正2,89,15,74,合庫-台中,2023-08-01,1021
3163,波若威,92,24,68,合庫-台中,2023-08-01,1021
2363,矽統,103,47,56,合庫-台中,2023-08-01,1021
00882,中信中國高股息,64,12,52,合庫-台中,2023-08-01,1021
2382,廣達,271,220,51,合庫-台中,2023-08-01,1021
6214,精誠,48,1,47,合庫-台中,2023-08-01,1021
3706,神達,67,28,39,合庫-台中,2023-08-01,1021
2801,彰銀,40,1,39,合庫-台中,2023-08-01,1021
2344,華邦電,44,8,36,合庫-台中,2023-08-01,1021
3011,今皓,34,0,34,合庫-台中,2023-08-01,1021
00679B,元大美債20年,39,6,33,合庫-台中,2023-08-01,1021
4541,晟田,33,0,33,合庫-台中,2023-08-01,1021
6133,金橋,30,0,30,合庫-台中,2023-08-01,1021
1609,大亞,37,9,28,合庫-台中,2023-08-01,1021
3056,富華新,38,11,27,合庫-台中,2023-08-01,1021
3583,辛耘,38,13,25,合庫-台中,2023-08-01,1021
1806,冠軍,32,8,24,合庫-台中,2023-08-01,1021
2104,國際中橡,24,1,23,合庫-台中,2023-08-01,1021
9907,統一實,23,0,23,合庫-台中,2023-08-01,1021
6231,系微,50,27,23,合庫-台中,2023-08-01,1021
6257,矽格,22,1,21,合庫-台中,2023-08-01,1021
4977,眾達-KY,24,4,20,合庫-台中,2023-08-01,1021
2887,台新金,34,13,21,合庫-台中,2023-08-01,1021
2342,茂矽,20,0,20,合庫-台中,2023-08-01,1021
3033,威健,20,0,20,合庫-台中,2023-08-01,1021
6538,倉和,30,10,20,合庫-台中,2023-08-01,1021
3523,迎輝,20,0,20,合庫-台中,2023-08-01,1021
1513,中興電,33,13,20,合庫-台中,2023-08-01,1021
5880,合庫金,115,96,19,合庫-台中,2023-08-01,1021
00712,復華富時不動產,25,6,19,合庫-台中,2023-08-01,1021
3264,欣銓,22,3,19,合庫-台中,2023-08-01,1021
2323,中環,32,13,19,合庫-台中,2023-08-01,1021
8358,金居,31,13,18,合庫-台中,2023-08-01,1021
2002,中鋼,19,1,18,合庫-台中,2023-08-01,1021
3272,東碩,17,0,17,合庫-台中,2023-08-01,1021
8027,鈦昇,37,22,15,合庫-台中,2023-08-01,1021
6417,韋僑,15,0,15,合庫-台中,2023-08-01,1021
1504,東元,17,2,15,合庫-台中,2023-08-01,1021
2401,凌陽,23,9,14,合庫-台中,2023-08-01,1021
2612,中航,26,12,14,合庫-台中,2023-08-01,1021
2481,強茂,39,26,13,合庫-台中,2023-08-01,1021
1903,士紙,14,1,13,合庫-台中,2023-08-01,1021
2353,宏��,32,20,12,合庫-台中,2023-08-01,1021
00878,國泰永續高股息,754,132,622,合庫-台中,2023-08-02,1021
2801,彰銀,344,36,308,合庫-台中,2023-08-02,1021
2888,新光金,336,77,259,合庫-台中,2023-08-02,1021
00929,復華台灣科技優息,289,45,244,合庫-台中,2023-08-02,1021
00900,富邦特選高股息30,267,32,235,合庫-台中,2023-08-02,1021
00679B,元大美債20年,226,20,206,合庫-台中,2023-08-02,1021
00673R,期元大S＆P原油反1,131,0,131,合庫-台中,2023-08-02,1021
5880,合庫金,164,58,106,合庫-台中,2023-08-02,1021
1605,華新,181,93,88,合庫-台中,2023-08-02,1021
2882,國泰金,88,2,86,合庫-台中,2023-08-02,1021
00680L,元大美債20正2,190,110,80,合庫-台中,2023-08-02,1021
00923,群益台ESG低碳50,96,21,75,合庫-台中,2023-08-02,1021
6282,康舒,175,106,69,合庫-台中,2023-08-02,1021
1815,富喬,81,14,67,合庫-台中,2023-08-02,1021
2618,長榮航,75,13,62,合庫-台中,2023-08-02,1021
2002,中鋼,63,4,59,合庫-台中,2023-08-02,1021
1314,中石化,96,37,59,合庫-台中,2023-08-02,1021
3163,波若威,140,81,59,合庫-台中,2023-08-02,1021
2453,凌群,61,3,58,合庫-台中,2023-08-02,1021
2323,中環,69,11,58,合庫-台中,2023-08-02,1021
0056,元大高股息,169,114,55,合庫-台中,2023-08-02,1021
2457,飛宏,73,19,54,合庫-台中,2023-08-02,1021
3231,緯創,119,66,53,合庫-台中,2023-08-02,1021
00642U,期元大S＆P石油,55,2,53,合庫-台中,2023-08-02,1021
00885,富邦越南,61,10,51,合庫-台中,2023-08-02,1021
3481,群創,326,276,50,合庫-台中,2023-08-02,1021
2301,光寶科,73,23,50,合庫-台中,2023-08-02,1021
2883,凱基金,51,1,50,合庫-台中,2023-08-02,1021
1785,光洋科,92,42,50,合庫-台中,2023-08-02,1021
2317,鴻海,52,4,48,合庫-台中,2023-08-02,1021
2356,英業達,69,22,47,合庫-台中,2023-08-02,1021
2344,華邦電,74,28,46,合庫-台中,2023-08-02,1021
00687B,國泰20年美債,45,0,45,合庫-台中,2023-08-02,1021
1609,大亞,152,108,44,合庫-台中,2023-08-02,1021
2498,宏達電,61,19,42,合庫-台中,2023-08-02,1021
8926,台汽電,42,1,41,合庫-台中,2023-08-02,1021
00720B,元大投資級公司債,45,4,41,合庫-台中,2023-08-02,1021
2338,光罩,40,0,40,合庫-台中,2023-08-02,1021
2324,仁寶,48,13,35,合庫-台中,2023-08-02,1021
1471,首利,36,2,34,合庫-台中,2023-08-02,1021
2444,兆勁,34,0,34,合庫-台中,2023-08-02,1021
2312,金寶,62,31,31,合庫-台中,2023-08-02,1021
00881,國泰台灣5G+,33,4,29,合庫-台中,2023-08-02,1021
1217,愛之味,29,0,29,合庫-台中,2023-08-02,1021
2486,一詮,33,4,29,合庫-台中,2023-08-02,1021
1618,合機,32,4,28,合庫-台中,2023-08-02,1021
00919,群益台灣精選高息,37,11,26,合庫-台中,2023-08-02,1021
6188,廣明,85,59,26,合庫-台中,2023-08-02,1021
9933,中鼎,24,0,24,合庫-台中,2023-08-02,1021
3594,磐儀,23,0,23,合庫-台中,2023-08-02,1021
2888,新光金,1219,766,453,合庫-台中,2023-08-04,1021
00679B,元大美債20年,320,6,314,合庫-台中,2023-08-04,1021
00680L,元大美債20正2,338,48,290,合庫-台中,2023-08-04,1021
00772B,中信高評級公司債,185,29,156,合庫-台中,2023-08-04,1021
00687B,國泰20年美債,100,1,99,合庫-台中,2023-08-04,1021
1605,華新,112,14,98,合庫-台中,2023-08-04,1021
00929,復華台灣科技優息,99,11,88,合庫-台中,2023-08-04,1021
3013,晟銘電,90,4,86,合庫-台中,2023-08-04,1021
1319,東陽,81,0,81,合庫-台中,2023-08-04,1021
2344,華邦電,140,67,73,合庫-台中,2023-08-04,1021
2891,中信金,69,3,66,合庫-台中,2023-08-04,1021
2409,友達,114,58,56,合庫-台中,2023-08-04,1021
8215,明基材,56,1,55,合庫-台中,2023-08-04,1021
3163,波若威,101,50,51,合庫-台中,2023-08-04,1021
2618,長榮航,57,8,49,合庫-台中,2023-08-04,1021
00900,富邦特選高股息30,57,11,46,合庫-台中,2023-08-04,1021
00919,群益台灣精選高息,46,1,45,合庫-台中,2023-08-04,1021
3231,緯創,321,277,44,合庫-台中,2023-08-04,1021
00720B,元大投資級公司債,67,28,39,合庫-台中,2023-08-04,1021
2329,華泰,51,13,38,合庫-台中,2023-08-04,1021
1727,中華化,42,4,38,合庫-台中,2023-08-04,1021
1609,大亞,62,26,36,合庫-台中,2023-08-04,1021
00751B,元大AAA至A公司債,36,0,36,合庫-台中,2023-08-04,1021
1216,統一,33,0,33,合庫-台中,2023-08-04,1021
00795B,中信美國公債20年,33,0,33,合庫-台中,2023-08-04,1021
2009,第一銅,31,0,31,合庫-台中,2023-08-04,1021
00688L,國泰20年美債正2,39,8,31,合庫-台中,2023-08-04,1021
6615,慧智,30,0,30,合庫-台中,2023-08-04,1021
2206,三陽工業,30,1,29,合庫-台中,2023-08-04,1021
00712,復華富時不動產,58,30,28,合庫-台中,2023-08-04,1021
3665,貿聯-KY,28,0,28,合庫-台中,2023-08-04,1021
1210,大成,33,5,28,合庫-台中,2023-08-04,1021
2855,統一證,30,2,28,合庫-台中,2023-08-04,1021
2313,華通,27,0,27,合庫-台中,2023-08-04,1021
00923,群益台ESG低碳50,29,3,26,合庫-台中,2023-08-04,1021
2603,長榮,38,14,24,合庫-台中,2023-08-04,1021
2460,建通,23,0,23,合庫-台中,2023-08-04,1021
4746,台耀,27,4,23,合庫-台中,2023-08-04,1021
00773B,中信優先金融債,22,0,22,合庫-台中,2023-08-04,1021
1905,華紙,68,48,20,合庫-台中,2023-08-04,1021
1537,廣隆,20,0,20,合庫-台中,2023-08-04,1021
5871,中租-KY,21,1,20,合庫-台中,2023-08-04,1021
2405,輔信,18,0,18,合庫-台中,2023-08-04,1021
9105,泰金寶-DR,18,0,18,合庫-台中,2023-08-04,1021
2436,偉詮電,17,0,17,合庫-台中,2023-08-04,1021
8210,勤誠,17,0,17,合庫-台中,2023-08-04,1021
6235,華孚,28,12,16,合庫-台中,2023-08-04,1021
8390,金益鼎,16,0,16,合庫-台中,2023-08-04,1021
3029,零壹,21,5,16,合庫-台中,2023-08-04,1021
2425,承啟,38,23,15,合庫-台中,2023-08-04,1021
00665L,富邦�琤肭磪囓�2,240,10,230,合庫-台中,2023-08-07,1021
00715L,期街口布蘭特正2,156,1,155,合庫-台中,2023-08-07,1021
8930,青鋼,145,17,128,合庫-台中,2023-08-07,1021
2618,長榮航,371,252,119,合庫-台中,2023-08-07,1021
00931B,統一美債20年,112,5,107,合庫-台中,2023-08-07,1021
00929,復華台灣科技優息,133,35,98,合庫-台中,2023-08-07,1021
2913,農林,160,86,74,合庫-台中,2023-08-07,1021
00687B,國泰20年美債,64,1,63,合庫-台中,2023-08-07,1021
00673R,期元大S＆P原油反1,69,7,62,合庫-台中,2023-08-07,1021
00923,群益台ESG低碳50,60,1,59,合庫-台中,2023-08-07,1021
6116,彩晶,68,12,56,合庫-台中,2023-08-07,1021
3702,大聯大,52,1,51,合庫-台中,2023-08-07,1021
00878,國泰永續高股息,254,205,49,合庫-台中,2023-08-07,1021
00900,富邦特選高股息30,92,44,48,合庫-台中,2023-08-07,1021
2382,廣達,240,194,46,合庫-台中,2023-08-07,1021
2884,玉山金,45,0,45,合庫-台中,2023-08-07,1021
00637L,元大滬深300正2,75,30,45,合庫-台中,2023-08-07,1021
1608,華榮,44,0,44,合庫-台中,2023-08-07,1021
2317,鴻海,70,27,43,合庫-台中,2023-08-07,1021
3706,神達,503,463,40,合庫-台中,2023-08-07,1021
2352,佳世達,57,19,38,合庫-台中,2023-08-07,1021
6284,佳邦,38,0,38,合庫-台中,2023-08-07,1021
2356,英業達,131,94,37,合庫-台中,2023-08-07,1021
2609,陽明,69,39,30,合庫-台中,2023-08-07,1021
3323,加百裕,30,1,29,合庫-台中,2023-08-07,1021
3669,圓展,30,4,26,合庫-台中,2023-08-07,1021
8390,金益鼎,36,11,25,合庫-台中,2023-08-07,1021
1727,中華化,24,0,24,合庫-台中,2023-08-07,1021
8034,榮群,24,1,23,合庫-台中,2023-08-07,1021
1313,聯成,22,1,21,合庫-台中,2023-08-07,1021
2388,威盛,168,147,21,合庫-台中,2023-08-07,1021
2337,旺宏,50,29,21,合庫-台中,2023-08-07,1021
9907,統一實,21,0,21,合庫-台中,2023-08-07,1021
3024,憶聲,20,0,20,合庫-台中,2023-08-07,1021
00712,復華富時不動產,26,6,20,合庫-台中,2023-08-07,1021
6016,康和證,25,5,20,合庫-台中,2023-08-07,1021
1714,和桐,20,0,20,合庫-台中,2023-08-07,1021
6703,軒郁,22,3,19,合庫-台中,2023-08-07,1021
2614,東森,20,1,19,合庫-台中,2023-08-07,1021
2891,中信金,18,0,18,合庫-台中,2023-08-07,1021
3051,力特,43,25,18,合庫-台中,2023-08-07,1021
3576,聯合再生,25,7,18,合庫-台中,2023-08-07,1021
6125,廣運,42,24,18,合庫-台中,2023-08-07,1021
6153,嘉聯益,18,1,17,合庫-台中,2023-08-07,1021
2409,友達,78,61,17,合庫-台中,2023-08-07,1021
00751B,元大AAA至A公司債,16,0,16,合庫-台中,2023-08-07,1021
1795,美時,17,1,16,合庫-台中,2023-08-07,1021
3523,迎輝,16,0,16,合庫-台中,2023-08-07,1021
2880,華南金,17,1,16,合庫-台中,2023-08-07,1021
3293,鈊象,17,2,15,合庫-台中,2023-08-07,1021
00929,復華台灣科技優息,262,10,252,合庫-台中,2023-08-08,1021
3231,緯創,476,259,217,合庫-台中,2023-08-08,1021
00900,富邦特選高股息30,169,3,166,合庫-台中,2023-08-08,1021
00665L,富邦�琤肭磪囓�2,239,110,129,合庫-台中,2023-08-08,1021
3025,星通,91,1,90,合庫-台中,2023-08-08,1021
00931B,統一美債20年,82,3,79,合庫-台中,2023-08-08,1021
2892,第一金,78,1,77,合庫-台中,2023-08-08,1021
2388,威盛,138,63,75,合庫-台中,2023-08-08,1021
4160,訊聯基因,61,0,61,合庫-台中,2023-08-08,1021
2801,彰銀,54,0,54,合庫-台中,2023-08-08,1021
1905,華紙,65,12,53,合庫-台中,2023-08-08,1021
2615,萬海,44,0,44,合庫-台中,2023-08-08,1021
2303,聯電,45,5,40,合庫-台中,2023-08-08,1021
2601,益航,40,0,40,合庫-台中,2023-08-08,1021
1727,中華化,44,5,39,合庫-台中,2023-08-08,1021
00923,群益台ESG低碳50,61,23,38,合庫-台中,2023-08-08,1021
2891,中信金,38,0,38,合庫-台中,2023-08-08,1021
6282,康舒,92,56,36,合庫-台中,2023-08-08,1021
2352,佳世達,52,16,36,合庫-台中,2023-08-08,1021
2313,華通,92,57,35,合庫-台中,2023-08-08,1021
2382,廣達,197,164,33,合庫-台中,2023-08-08,1021
2301,光寶科,135,104,31,合庫-台中,2023-08-08,1021
6222,上揚,31,0,31,合庫-台中,2023-08-08,1021
3055,蔚華科,30,1,29,合庫-台中,2023-08-08,1021
6188,廣明,37,11,26,合庫-台中,2023-08-08,1021
6284,佳邦,24,0,24,合庫-台中,2023-08-08,1021
5452,佶優,30,6,24,合庫-台中,2023-08-08,1021
3293,鈊象,24,1,23,合庫-台中,2023-08-08,1021
2344,華邦電,38,16,22,合庫-台中,2023-08-08,1021
4746,台耀,25,4,21,合庫-台中,2023-08-08,1021
6770,力積電,23,2,21,合庫-台中,2023-08-08,1021
1504,東元,24,4,20,合庫-台中,2023-08-08,1021
2884,玉山金,20,0,20,合庫-台中,2023-08-08,1021
00715L,期街口布蘭特正2,33,13,20,合庫-台中,2023-08-08,1021
2371,大同,55,35,20,合庫-台中,2023-08-08,1021
1609,大亞,21,3,18,合庫-台中,2023-08-08,1021
1907,永豐餘,18,0,18,合庫-台中,2023-08-08,1021
5465,富驊,17,0,17,合庫-台中,2023-08-08,1021
3037,欣興,22,6,16,合庫-台中,2023-08-08,1021
3711,日月光投控,22,6,16,合庫-台中,2023-08-08,1021
3498,陽程,16,0,16,合庫-台中,2023-08-08,1021
3325,旭品,29,13,16,合庫-台中,2023-08-08,1021
00927,群益半導體收益,17,1,16,合庫-台中,2023-08-08,1021
1217,愛之味,21,5,16,合庫-台中,2023-08-08,1021
2002,中鋼,18,3,15,合庫-台中,2023-08-08,1021
2812,台中銀,15,0,15,合庫-台中,2023-08-08,1021
3523,迎輝,15,0,15,合庫-台中,2023-08-08,1021
1447,力鵬,15,0,15,合庫-台中,2023-08-08,1021
5531,鄉林,15,0,15,合庫-台中,2023-08-08,1021
8011,台通,15,0,15,合庫-台中,2023-08-08,1021
5880,合庫金,241,13,228,合庫-台中,2023-08-09,1021
00929,復華台灣科技優息,171,3,168,合庫-台中,2023-08-09,1021
00900,富邦特選高股息30,177,10,167,合庫-台中,2023-08-09,1021
2457,飛宏,152,0,152,合庫-台中,2023-08-09,1021
5371,中光電,113,1,112,合庫-台中,2023-08-09,1021
6120,達運,111,0,111,合庫-台中,2023-08-09,1021
00878,國泰永續高股息,109,46,63,合庫-台中,2023-08-09,1021
2027,大成鋼,61,0,61,合庫-台中,2023-08-09,1021
00665L,富邦�琤肭磪囓�2,73,12,61,合庫-台中,2023-08-09,1021
2609,陽明,63,4,59,合庫-台中,2023-08-09,1021
00673R,期元大S＆P原油反1,50,0,50,合庫-台中,2023-08-09,1021
1815,富喬,50,1,49,合庫-台中,2023-08-09,1021
9934,成霖,40,0,40,合庫-台中,2023-08-09,1021
2892,第一金,61,21,40,合庫-台中,2023-08-09,1021
4160,訊聯基因,39,0,39,合庫-台中,2023-08-09,1021
2890,永豐金,67,31,36,合庫-台中,2023-08-09,1021
1217,愛之味,48,13,35,合庫-台中,2023-08-09,1021
6412,群電,51,17,34,合庫-台中,2023-08-09,1021
2882,國泰金,35,2,33,合庫-台中,2023-08-09,1021
00712,復華富時不動產,33,0,33,合庫-台中,2023-08-09,1021
00923,群益台ESG低碳50,31,0,31,合庫-台中,2023-08-09,1021
2834,臺企銀,35,5,30,合庫-台中,2023-08-09,1021
2614,東森,30,0,30,合庫-台中,2023-08-09,1021
00795B,中信美國公債20年,28,0,28,合庫-台中,2023-08-09,1021
3481,群創,94,67,27,合庫-台中,2023-08-09,1021
00931B,統一美債20年,29,2,27,合庫-台中,2023-08-09,1021
00679B,元大美債20年,27,1,26,合庫-台中,2023-08-09,1021
2906,高林,26,0,26,合庫-台中,2023-08-09,1021
2913,農林,53,29,24,合庫-台中,2023-08-09,1021
3498,陽程,23,0,23,合庫-台中,2023-08-09,1021
00919,群益台灣精選高息,23,0,23,合庫-台中,2023-08-09,1021
6269,台郡,22,0,22,合庫-台中,2023-08-09,1021
4533,協易機,20,0,20,合庫-台中,2023-08-09,1021
2881,富邦金,20,0,20,合庫-台中,2023-08-09,1021
3710,連展投控,20,0,20,合庫-台中,2023-08-09,1021
1444,力麗,20,0,20,合庫-台中,2023-08-09,1021
2356,英業達,97,78,19,合庫-台中,2023-08-09,1021
8390,金益鼎,18,0,18,合庫-台中,2023-08-09,1021
4960,誠美材,20,2,18,合庫-台中,2023-08-09,1021
2206,三陽工業,24,7,17,合庫-台中,2023-08-09,1021
3260,威剛,39,22,17,合庫-台中,2023-08-09,1021
6605,帝寶,21,4,17,合庫-台中,2023-08-09,1021
3694,海華,17,0,17,合庫-台中,2023-08-09,1021
4745,合富-KY,28,11,17,合庫-台中,2023-08-09,1021
2352,佳世達,29,13,16,合庫-台中,2023-08-09,1021
00772B,中信高評級公司債,17,1,16,合庫-台中,2023-08-09,1021
2371,大同,32,18,14,合庫-台中,2023-08-09,1021
1514,亞力,24,10,14,合庫-台中,2023-08-09,1021
3523,迎輝,14,0,14,合庫-台中,2023-08-09,1021
8215,明基材,16,2,14,合庫-台中,2023-08-09,1021
00900,富邦特選高股息30,397,9,388,合庫-台中,2023-08-10,1021
00929,復華台灣科技優息,292,12,280,合庫-台中,2023-08-10,1021
3481,群創,142,26,116,合庫-台中,2023-08-10,1021
2457,飛宏,134,31,103,合庫-台中,2023-08-10,1021
2609,陽明,98,8,90,合庫-台中,2023-08-10,1021
00683L,期元大美元指正2,90,0,90,合庫-台中,2023-08-10,1021
2845,遠東銀,77,0,77,合庫-台中,2023-08-10,1021
2382,廣達,136,60,76,合庫-台中,2023-08-10,1021
4160,訊聯基因,71,3,68,合庫-台中,2023-08-10,1021
00923,群益台ESG低碳50,82,16,66,合庫-台中,2023-08-10,1021
00919,群益台灣精選高息,76,12,64,合庫-台中,2023-08-10,1021
1104,環泥,64,0,64,合庫-台中,2023-08-10,1021
00673R,期元大S＆P原油反1,63,0,63,合庫-台中,2023-08-10,1021
00878,國泰永續高股息,222,161,61,合庫-台中,2023-08-10,1021
1609,大亞,80,21,59,合庫-台中,2023-08-10,1021
2002,中鋼,51,0,51,合庫-台中,2023-08-10,1021
2465,麗臺,56,5,51,合庫-台中,2023-08-10,1021
2515,中工,55,5,50,合庫-台中,2023-08-10,1021
2324,仁寶,56,7,49,合庫-台中,2023-08-10,1021
1605,華新,77,28,49,合庫-台中,2023-08-10,1021
2344,華邦電,47,0,47,合庫-台中,2023-08-10,1021
0056,元大高股息,121,76,45,合庫-台中,2023-08-10,1021
00931B,統一美債20年,44,1,43,合庫-台中,2023-08-10,1021
2409,友達,83,41,42,合庫-台中,2023-08-10,1021
00927,群益半導體收益,42,0,42,合庫-台中,2023-08-10,1021
6282,康舒,159,118,41,合庫-台中,2023-08-10,1021
2881,富邦金,47,7,40,合庫-台中,2023-08-10,1021
3231,緯創,564,525,39,合庫-台中,2023-08-10,1021
00713,元大台灣高息低波,38,0,38,合庫-台中,2023-08-10,1021
6112,邁達特,41,4,37,合庫-台中,2023-08-10,1021
2610,華航,600,564,36,合庫-台中,2023-08-10,1021
2208,台船,73,37,36,合庫-台中,2023-08-10,1021
00930,永豐ESG低碳高息,34,0,34,合庫-台中,2023-08-10,1021
2886,兆豐金,59,27,32,合庫-台中,2023-08-10,1021
2614,東森,32,0,32,合庫-台中,2023-08-10,1021
3078,僑威,39,8,31,合庫-台中,2023-08-10,1021
3380,明泰,31,0,31,合庫-台中,2023-08-10,1021
6179,亞通,31,0,31,合庫-台中,2023-08-10,1021
2883,凱基金,52,22,30,合庫-台中,2023-08-10,1021
4979,華星光,29,0,29,合庫-台中,2023-08-10,1021
4168,醣聯,28,0,28,合庫-台中,2023-08-10,1021
2376,技嘉,102,74,28,合庫-台中,2023-08-10,1021
2328,廣宇,26,0,26,合庫-台中,2023-08-10,1021
5460,同協,24,0,24,合庫-台中,2023-08-10,1021
5880,合庫金,28,5,23,合庫-台中,2023-08-10,1021
3038,全台,23,0,23,合庫-台中,2023-08-10,1021
2312,金寶,26,4,22,合庫-台中,2023-08-10,1021
2303,聯電,24,3,21,合庫-台中,2023-08-10,1021
3032,偉訓,27,7,20,合庫-台中,2023-08-10,1021
6129,普誠,22,2,20,合庫-台中,2023-08-10,1021
00900,富邦特選高股息30,196,0,196,合庫-台中,2023-08-11,1021
00929,復華台灣科技優息,197,12,185,合庫-台中,2023-08-11,1021
2002,中鋼,114,6,108,合庫-台中,2023-08-11,1021
3481,群創,128,33,95,合庫-台中,2023-08-11,1021
2457,飛宏,108,13,95,合庫-台中,2023-08-11,1021
1217,愛之味,94,21,73,合庫-台中,2023-08-11,1021
00772B,中信高評級公司債,70,1,69,合庫-台中,2023-08-11,1021
2618,長榮航,203,139,64,合庫-台中,2023-08-11,1021
00931B,統一美債20年,67,5,62,合庫-台中,2023-08-11,1021
2356,英業達,86,43,43,合庫-台中,2023-08-11,1021
00665L,富邦�琤肭磪囓�2,43,0,43,合庫-台中,2023-08-11,1021
2892,第一金,51,10,41,合庫-台中,2023-08-11,1021
2066,世德,40,0,40,合庫-台中,2023-08-11,1021
2516,新建,55,15,40,合庫-台中,2023-08-11,1021
2886,兆豐金,51,12,39,合庫-台中,2023-08-11,1021
00751B,元大AAA至A公司債,39,0,39,合庫-台中,2023-08-11,1021
3325,旭品,57,19,38,合庫-台中,2023-08-11,1021
00923,群益台ESG低碳50,38,2,36,合庫-台中,2023-08-11,1021
4168,醣聯,30,0,30,合庫-台中,2023-08-11,1021
2388,威盛,146,116,30,合庫-台中,2023-08-11,1021
00679B,元大美債20年,59,30,29,合庫-台中,2023-08-11,1021
00715L,期街口布蘭特正2,29,1,28,合庫-台中,2023-08-11,1021
2317,鴻海,46,18,28,合庫-台中,2023-08-11,1021
6443,元晶,35,8,27,合庫-台中,2023-08-11,1021
3163,波若威,45,20,25,合庫-台中,2023-08-11,1021
6282,康舒,53,30,23,合庫-台中,2023-08-11,1021
00687B,國泰20年美債,24,2,22,合庫-台中,2023-08-11,1021
2867,三商壽,34,12,22,合庫-台中,2023-08-11,1021
00753L,中信中國50正2,21,0,21,合庫-台中,2023-08-11,1021
2601,益航,21,0,21,合庫-台中,2023-08-11,1021
3707,漢磊,31,11,20,合庫-台中,2023-08-11,1021
00902,中信電池及儲能,20,0,20,合庫-台中,2023-08-11,1021
1504,東元,23,4,19,合庫-台中,2023-08-11,1021
2614,東森,20,1,19,合庫-台中,2023-08-11,1021
2014,中鴻,19,1,18,合庫-台中,2023-08-11,1021
00878,國泰永續高股息,82,65,17,合庫-台中,2023-08-11,1021
8011,台通,16,0,16,合庫-台中,2023-08-11,1021
3056,富華新,21,5,16,合庫-台中,2023-08-11,1021
8070,長華*,15,0,15,合庫-台中,2023-08-11,1021
1104,環泥,15,0,15,合庫-台中,2023-08-11,1021
2539,櫻花建,15,0,15,合庫-台中,2023-08-11,1021
2845,遠東銀,16,1,15,合庫-台中,2023-08-11,1021
2330,台積電,15,0,15,合庫-台中,2023-08-11,1021
00795B,中信美國公債20年,15,0,15,合庫-台中,2023-08-11,1021
4745,合富-KY,16,2,14,合庫-台中,2023-08-11,1021
6770,力積電,18,4,14,合庫-台中,2023-08-11,1021
5871,中租-KY,14,1,13,合庫-台中,2023-08-11,1021
3050,鈺德,13,0,13,合庫-台中,2023-08-11,1021
3206,志豐,23,10,13,合庫-台中,2023-08-11,1021
3231,緯創,194,181,13,合庫-台中,2023-08-11,1021
00929,復華台灣科技優息,387,70,317,合庫-台中,2023-08-14,1021
00878,國泰永續高股息,247,62,185,合庫-台中,2023-08-14,1021
00900,富邦特選高股息30,258,89,169,合庫-台中,2023-08-14,1021
00882,中信中國高股息,175,9,166,合庫-台中,2023-08-14,1021
00673R,期元大S＆P原油反1,188,25,163,合庫-台中,2023-08-14,1021
2888,新光金,169,42,127,合庫-台中,2023-08-14,1021
1514,亞力,118,3,115,合庫-台中,2023-08-14,1021
2014,中鴻,111,4,107,合庫-台中,2023-08-14,1021
2882,國泰金,131,26,105,合庫-台中,2023-08-14,1021
2881,富邦金,120,16,104,合庫-台中,2023-08-14,1021
2317,鴻海,115,24,91,合庫-台中,2023-08-14,1021
2610,華航,136,55,81,合庫-台中,2023-08-14,1021
2323,中環,98,20,78,合庫-台中,2023-08-14,1021
1795,美時,109,35,74,合庫-台中,2023-08-14,1021
00923,群益台ESG低碳50,75,2,73,合庫-台中,2023-08-14,1021
2344,華邦電,90,23,67,合庫-台中,2023-08-14,1021
00751B,元大AAA至A公司債,63,0,63,合庫-台中,2023-08-14,1021
9105,泰金寶-DR,60,0,60,合庫-台中,2023-08-14,1021
2457,飛宏,57,0,57,合庫-台中,2023-08-14,1021
2614,東森,61,5,56,合庫-台中,2023-08-14,1021
0056,元大高股息,65,19,46,合庫-台中,2023-08-14,1021
00665L,富邦�琤肭磪囓�2,141,96,45,合庫-台中,2023-08-14,1021
00666R,富邦�琤肭磪齯�1,45,0,45,合庫-台中,2023-08-14,1021
3481,群創,73,30,43,合庫-台中,2023-08-14,1021
00715L,期街口布蘭特正2,43,0,43,合庫-台中,2023-08-14,1021
2356,英業達,136,94,42,合庫-台中,2023-08-14,1021
2002,中鋼,53,11,42,合庫-台中,2023-08-14,1021
2440,太空梭,40,0,40,合庫-台中,2023-08-14,1021
4168,醣聯,40,0,40,合庫-台中,2023-08-14,1021
6116,彩晶,40,0,40,合庫-台中,2023-08-14,1021
2897,王道銀行,36,0,36,合庫-台中,2023-08-14,1021
2883,凱基金,45,10,35,合庫-台中,2023-08-14,1021
00893,國泰智能電動車,47,14,33,合庫-台中,2023-08-14,1021
2880,華南金,72,40,32,合庫-台中,2023-08-14,1021
5460,同協,31,0,31,合庫-台中,2023-08-14,1021
2603,長榮,60,30,30,合庫-台中,2023-08-14,1021
2618,長榮航,269,239,30,合庫-台中,2023-08-14,1021
00676R,富邦臺灣加權反1,30,0,30,合庫-台中,2023-08-14,1021
1314,中石化,41,11,30,合庫-台中,2023-08-14,1021
2409,友達,66,36,30,合庫-台中,2023-08-14,1021
6282,康舒,115,86,29,合庫-台中,2023-08-14,1021
2634,漢翔,56,27,29,合庫-台中,2023-08-14,1021
8930,青鋼,33,5,28,合庫-台中,2023-08-14,1021
2812,台中銀,27,1,26,合庫-台中,2023-08-14,1021
3615,安可,26,1,25,合庫-台中,2023-08-14,1021
3701,大眾控,25,0,25,合庫-台中,2023-08-14,1021
2539,櫻花建,25,1,24,合庫-台中,2023-08-14,1021
1802,台玻,31,7,24,合庫-台中,2023-08-14,1021
00679B,元大美債20年,26,3,23,合庫-台中,2023-08-14,1021
006208,富邦台50,24,1,23,合庫-台中,2023-08-14,1021
00929,復華台灣科技優息,307,3,304,合庫-台中,2023-08-15,1021
00687B,國泰20年美債,222,0,222,合庫-台中,2023-08-15,1021
00720B,元大投資級公司債,204,3,201,合庫-台中,2023-08-15,1021
00923,群益台ESG低碳50,215,16,199,合庫-台中,2023-08-15,1021
00878,國泰永續高股息,248,98,150,合庫-台中,2023-08-15,1021
00900,富邦特選高股息30,150,28,122,合庫-台中,2023-08-15,1021
1514,亞力,104,2,102,合庫-台中,2023-08-15,1021
00665L,富邦�琤肭磪囓�2,103,6,97,合庫-台中,2023-08-15,1021
2457,飛宏,100,7,93,合庫-台中,2023-08-15,1021
2834,臺企銀,93,2,91,合庫-台中,2023-08-15,1021
2382,廣達,222,140,82,合庫-台中,2023-08-15,1021
2891,中信金,79,1,78,合庫-台中,2023-08-15,1021
2356,英業達,139,67,72,合庫-台中,2023-08-15,1021
2884,玉山金,64,3,61,合庫-台中,2023-08-15,1021
3056,富華新,58,0,58,合庫-台中,2023-08-15,1021
1312,國喬,57,0,57,合庫-台中,2023-08-15,1021
00931B,統一美債20年,51,2,49,合庫-台中,2023-08-15,1021
2618,長榮航,68,20,48,合庫-台中,2023-08-15,1021
3615,安可,77,33,44,合庫-台中,2023-08-15,1021
2801,彰銀,41,0,41,合庫-台中,2023-08-15,1021
2614,東森,40,0,40,合庫-台中,2023-08-15,1021
2888,新光金,46,10,36,合庫-台中,2023-08-15,1021
2002,中鋼,38,4,34,合庫-台中,2023-08-15,1021
2444,兆勁,34,0,34,合庫-台中,2023-08-15,1021
00882,中信中國高股息,57,26,31,合庫-台中,2023-08-15,1021
3523,迎輝,30,0,30,合庫-台中,2023-08-15,1021
00632R,元大台灣50反1,40,12,28,合庫-台中,2023-08-15,1021
2880,華南金,34,8,26,合庫-台中,2023-08-15,1021
2104,國際中橡,25,0,25,合庫-台中,2023-08-15,1021
2634,漢翔,40,16,24,合庫-台中,2023-08-15,1021
2886,兆豐金,25,2,23,合庫-台中,2023-08-15,1021
1101,台泥,22,1,21,合庫-台中,2023-08-15,1021
9105,泰金寶-DR,20,0,20,合庫-台中,2023-08-15,1021
6770,力積電,20,2,18,合庫-台中,2023-08-15,1021
00885,富邦越南,14,0,14,合庫-台中,2023-08-15,1021
3567,逸昌,18,4,14,合庫-台中,2023-08-15,1021
00751B,元大AAA至A公司債,29,15,14,合庫-台中,2023-08-15,1021
00881,國泰台灣5G+,14,0,14,合庫-台中,2023-08-15,1021
00907,永豐優息存股,14,1,13,合庫-台中,2023-08-15,1021
2539,櫻花建,13,0,13,合庫-台中,2023-08-15,1021
4160,訊聯基因,13,0,13,合庫-台中,2023-08-15,1021
2363,矽統,137,124,13,合庫-台中,2023-08-15,1021
2421,建準,36,24,12,合庫-台中,2023-08-15,1021
6531,愛普*,21,9,12,合庫-台中,2023-08-15,1021
3494,誠研,12,0,12,合庫-台中,2023-08-15,1021
3481,群創,93,81,12,合庫-台中,2023-08-15,1021
4542,科嶠,12,0,12,合庫-台中,2023-08-15,1021
4745,合富-KY,12,0,12,合庫-台中,2023-08-15,1021
0050,元大台灣50,15,3,12,合庫-台中,2023-08-15,1021
3034,聯詠,11,0,11,合庫-台中,2023-08-15,1021
00687B,國泰20年美債,274,0,274,合庫-台中,2023-08-16,1021
00665L,富邦�琤肭磪囓�2,195,0,195,合庫-台中,2023-08-16,1021
2303,聯電,170,6,164,合庫-台中,2023-08-16,1021
00712,復華富時不動產,236,74,162,合庫-台中,2023-08-16,1021
00751B,元大AAA至A公司債,153,0,153,合庫-台中,2023-08-16,1021
00929,復華台灣科技優息,148,3,145,合庫-台中,2023-08-16,1021
00923,群益台ESG低碳50,126,2,124,合庫-台中,2023-08-16,1021
2834,臺企銀,155,40,115,合庫-台中,2023-08-16,1021
00720B,元大投資級公司債,114,0,114,合庫-台中,2023-08-16,1021
2329,華泰,193,89,104,合庫-台中,2023-08-16,1021
3481,群創,104,2,102,合庫-台中,2023-08-16,1021
2889,國票金,107,5,102,合庫-台中,2023-08-16,1021
2356,英業達,200,102,98,合庫-台中,2023-08-16,1021
00900,富邦特選高股息30,97,3,94,合庫-台中,2023-08-16,1021
2882,國泰金,89,0,89,合庫-台中,2023-08-16,1021
2891,中信金,91,11,80,合庫-台中,2023-08-16,1021
2002,中鋼,73,1,72,合庫-台中,2023-08-16,1021
2457,飛宏,76,6,70,合庫-台中,2023-08-16,1021
2881,富邦金,71,2,69,合庫-台中,2023-08-16,1021
2363,矽統,103,39,64,合庫-台中,2023-08-16,1021
00878,國泰永續高股息,130,68,62,合庫-台中,2023-08-16,1021
2883,凱基金,77,15,62,合庫-台中,2023-08-16,1021
2610,華航,86,28,58,合庫-台中,2023-08-16,1021
5880,合庫金,55,1,54,合庫-台中,2023-08-16,1021
2890,永豐金,52,1,51,合庫-台中,2023-08-16,1021
2618,長榮航,69,19,50,合庫-台中,2023-08-16,1021
2603,長榮,45,1,44,合庫-台中,2023-08-16,1021
1409,新纖,44,0,44,合庫-台中,2023-08-16,1021
2317,鴻海,43,5,38,合庫-台中,2023-08-16,1021
2801,彰銀,37,0,37,合庫-台中,2023-08-16,1021
00931B,統一美債20年,36,0,36,合庫-台中,2023-08-16,1021
6231,系微,40,5,35,合庫-台中,2023-08-16,1021
8930,青鋼,36,2,34,合庫-台中,2023-08-16,1021
00753L,中信中國50正2,66,33,33,合庫-台中,2023-08-16,1021
2886,兆豐金,37,7,30,合庫-台中,2023-08-16,1021
00676R,富邦臺灣加權反1,30,0,30,合庫-台中,2023-08-16,1021
2323,中環,39,10,29,合庫-台中,2023-08-16,1021
3706,神達,34,10,24,合庫-台中,2023-08-16,1021
00715L,期街口布蘭特正2,65,41,24,合庫-台中,2023-08-16,1021
00679B,元大美債20年,22,0,22,合庫-台中,2023-08-16,1021
2344,華邦電,24,3,21,合庫-台中,2023-08-16,1021
2324,仁寶,110,89,21,合庫-台中,2023-08-16,1021
1712,興農,30,10,20,合庫-台中,2023-08-16,1021
1472,三洋實業,20,0,20,合庫-台中,2023-08-16,1021
1608,華榮,19,0,19,合庫-台中,2023-08-16,1021
4414,如興,25,6,19,合庫-台中,2023-08-16,1021
2352,佳世達,31,13,18,合庫-台中,2023-08-16,1021
1605,華新,30,12,18,合庫-台中,2023-08-16,1021
00902,中信電池及儲能,18,0,18,合庫-台中,2023-08-16,1021
3682,亞太電,27,9,18,合庫-台中,2023-08-16,1021
2317,鴻海,509,13,496,合庫-台中,2023-08-17,1021
00632R,元大台灣50反1,743,332,411,合庫-台中,2023-08-17,1021
00720B,元大投資級公司債,234,0,234,合庫-台中,2023-08-17,1021
1472,三洋實業,150,0,150,合庫-台中,2023-08-17,1021
00679B,元大美債20年,155,10,145,合庫-台中,2023-08-17,1021
00687B,國泰20年美債,133,2,131,合庫-台中,2023-08-17,1021
2324,仁寶,262,132,130,合庫-台中,2023-08-17,1021
2382,廣達,310,189,121,合庫-台中,2023-08-17,1021
00751B,元大AAA至A公司債,135,30,105,合庫-台中,2023-08-17,1021
5425,台半,108,6,102,合庫-台中,2023-08-17,1021
2002,中鋼,97,4,93,合庫-台中,2023-08-17,1021
00715L,期街口布蘭特正2,131,39,92,合庫-台中,2023-08-17,1021
00929,復華台灣科技優息,103,21,82,合庫-台中,2023-08-17,1021
00676R,富邦臺灣加權反1,80,0,80,合庫-台中,2023-08-17,1021
00641R,富邦日本反1,70,0,70,合庫-台中,2023-08-17,1021
2332,友訊,67,13,54,合庫-台中,2023-08-17,1021
2457,飛宏,55,1,54,合庫-台中,2023-08-17,1021
00923,群益台ESG低碳50,54,1,53,合庫-台中,2023-08-17,1021
2886,兆豐金,54,1,53,合庫-台中,2023-08-17,1021
2409,友達,73,21,52,合庫-台中,2023-08-17,1021
5880,合庫金,51,3,48,合庫-台中,2023-08-17,1021
2892,第一金,47,4,43,合庫-台中,2023-08-17,1021
00712,復華富時不動產,58,15,43,合庫-台中,2023-08-17,1021
2880,華南金,36,1,35,合庫-台中,2023-08-17,1021
00882,中信中國高股息,37,3,34,合庫-台中,2023-08-17,1021
2891,中信金,52,18,34,合庫-台中,2023-08-17,1021
2419,仲琦,37,3,34,合庫-台中,2023-08-17,1021
00931B,統一美債20年,35,2,33,合庫-台中,2023-08-17,1021
1609,大亞,47,15,32,合庫-台中,2023-08-17,1021
3013,晟銘電,40,9,31,合庫-台中,2023-08-17,1021
1101,台泥,36,5,31,合庫-台中,2023-08-17,1021
2885,元大金,28,0,28,合庫-台中,2023-08-17,1021
2421,建準,66,38,28,合庫-台中,2023-08-17,1021
00670L,富邦NASDAQ正2,27,0,27,合庫-台中,2023-08-17,1021
2887,台新金,25,0,25,合庫-台中,2023-08-17,1021
1301,台塑,24,0,24,合庫-台中,2023-08-17,1021
6274,台燿,44,20,24,合庫-台中,2023-08-17,1021
1504,東元,27,4,23,合庫-台中,2023-08-17,1021
4160,訊聯基因,22,0,22,合庫-台中,2023-08-17,1021
3056,富華新,120,100,20,合庫-台中,2023-08-17,1021
1802,台玻,24,4,20,合庫-台中,2023-08-17,1021
3523,迎輝,20,0,20,合庫-台中,2023-08-17,1021
2014,中鴻,21,1,20,合庫-台中,2023-08-17,1021
3047,訊舟,20,0,20,合庫-台中,2023-08-17,1021
5009,榮剛,26,7,19,合庫-台中,2023-08-17,1021
3034,聯詠,20,2,18,合庫-台中,2023-08-17,1021
6218,豪勉,19,1,18,合庫-台中,2023-08-17,1021
2610,華航,83,66,17,合庫-台中,2023-08-17,1021
2609,陽明,30,14,16,合庫-台中,2023-08-17,1021
3037,欣興,30,14,16,合庫-台中,2023-08-17,1021
00929,復華台灣科技優息,237,32,205,合庫-台中,2023-08-18,1021
00680L,元大美債20正2,182,0,182,合庫-台中,2023-08-18,1021
3231,緯創,434,253,181,合庫-台中,2023-08-18,1021
2539,櫻花建,131,1,130,合庫-台中,2023-08-18,1021
2356,英業達,178,57,121,合庫-台中,2023-08-18,1021
00673R,期元大S＆P原油反1,100,3,97,合庫-台中,2023-08-18,1021
00670L,富邦NASDAQ正2,122,27,95,合庫-台中,2023-08-18,1021
2363,矽統,360,269,91,合庫-台中,2023-08-18,1021
00676R,富邦臺灣加權反1,90,0,90,合庫-台中,2023-08-18,1021
4160,訊聯基因,106,27,79,合庫-台中,2023-08-18,1021
3163,波若威,96,28,68,合庫-台中,2023-08-18,1021
3706,神達,130,68,62,合庫-台中,2023-08-18,1021
2880,華南金,62,0,62,合庫-台中,2023-08-18,1021
3056,富華新,95,36,59,合庫-台中,2023-08-18,1021
2812,台中銀,53,0,53,合庫-台中,2023-08-18,1021
2332,友訊,67,17,50,合庫-台中,2023-08-18,1021
3715,定穎投控,113,63,50,合庫-台中,2023-08-18,1021
00753L,中信中國50正2,48,0,48,合庫-台中,2023-08-18,1021
2388,威盛,79,32,47,合庫-台中,2023-08-18,1021
00712,復華富時不動產,64,17,47,合庫-台中,2023-08-18,1021
2329,華泰,137,93,44,合庫-台中,2023-08-18,1021
00931B,統一美債20年,39,0,39,合庫-台中,2023-08-18,1021
3689,湧德,41,5,36,合庫-台中,2023-08-18,1021
4414,如興,36,1,35,合庫-台中,2023-08-18,1021
2603,長榮,64,30,34,合庫-台中,2023-08-18,1021
00878,國泰永續高股息,118,85,33,合庫-台中,2023-08-18,1021
00679B,元大美債20年,40,8,32,合庫-台中,2023-08-18,1021
00882,中信中國高股息,33,2,31,合庫-台中,2023-08-18,1021
2382,廣達,143,112,31,合庫-台中,2023-08-18,1021
00900,富邦特選高股息30,47,17,30,合庫-台中,2023-08-18,1021
1714,和桐,30,0,30,合庫-台中,2023-08-18,1021
6282,康舒,156,126,30,合庫-台中,2023-08-18,1021
2881,富邦金,35,6,29,合庫-台中,2023-08-18,1021
5347,世界,28,0,28,合庫-台中,2023-08-18,1021
0056,元大高股息,75,48,27,合庫-台中,2023-08-18,1021
2457,飛宏,55,29,26,合庫-台中,2023-08-18,1021
00720B,元大投資級公司債,25,0,25,合庫-台中,2023-08-18,1021
2913,農林,35,12,23,合庫-台中,2023-08-18,1021
00751B,元大AAA至A公司債,23,0,23,合庫-台中,2023-08-18,1021
6170,統振,23,1,22,合庫-台中,2023-08-18,1021
2906,高林,22,0,22,合庫-台中,2023-08-18,1021
3035,智原,90,70,20,合庫-台中,2023-08-18,1021
1504,東元,51,31,20,合庫-台中,2023-08-18,1021
911868,同方友友-DR,20,0,20,合庫-台中,2023-08-18,1021
2413,環科,20,0,20,合庫-台中,2023-08-18,1021
2834,臺企銀,19,0,19,合庫-台中,2023-08-18,1021
5525,順天,20,1,19,合庫-台中,2023-08-18,1021
2352,佳世達,61,42,19,合庫-台中,2023-08-18,1021
3363,上詮,19,0,19,合庫-台中,2023-08-18,1021
1101,台泥,41,23,18,合庫-台中,2023-08-18,1021
2363,矽統,828,244,584,合庫-台中,2023-08-21,1021
2539,櫻花建,211,1,210,合庫-台中,2023-08-21,1021
00720B,元大投資級公司債,216,60,156,合庫-台中,2023-08-21,1021
00929,復華台灣科技優息,96,13,83,合庫-台中,2023-08-21,1021
00751B,元大AAA至A公司債,72,0,72,合庫-台中,2023-08-21,1021
2002,中鋼,75,4,71,合庫-台中,2023-08-21,1021
2610,華航,81,22,59,合庫-台中,2023-08-21,1021
2609,陽明,90,32,58,合庫-台中,2023-08-21,1021
2324,仁寶,132,75,57,合庫-台中,2023-08-21,1021
00665L,富邦�琤肭磪囓�2,54,2,52,合庫-台中,2023-08-21,1021
2888,新光金,81,32,49,合庫-台中,2023-08-21,1021
2603,長榮,44,1,43,合庫-台中,2023-08-21,1021
00900,富邦特選高股息30,35,1,34,合庫-台中,2023-08-21,1021
1101,台泥,35,2,33,合庫-台中,2023-08-21,1021
3523,迎輝,30,0,30,合庫-台中,2023-08-21,1021
2501,國建,30,0,30,合庫-台中,2023-08-21,1021
00753L,中信中國50正2,32,2,30,合庫-台中,2023-08-21,1021
00679B,元大美債20年,34,5,29,合庫-台中,2023-08-21,1021
6472,保瑞,29,2,27,合庫-台中,2023-08-21,1021
00712,復華富時不動產,29,2,27,合庫-台中,2023-08-21,1021
00706L,期元大S＆P日圓正2,26,0,26,合庫-台中,2023-08-21,1021
3051,力特,47,22,25,合庫-台中,2023-08-21,1021
00642U,期元大S＆P石油,29,5,24,合庫-台中,2023-08-21,1021
2618,長榮航,30,6,24,合庫-台中,2023-08-21,1021
2886,兆豐金,23,0,23,合庫-台中,2023-08-21,1021
3056,富華新,63,41,22,合庫-台中,2023-08-21,1021
2883,凱基金,29,7,22,合庫-台中,2023-08-21,1021
2303,聯電,22,1,21,合庫-台中,2023-08-21,1021
5880,合庫金,22,0,22,合庫-台中,2023-08-21,1021
3567,逸昌,22,1,21,合庫-台中,2023-08-21,1021
6285,啟��,40,20,20,合庫-台中,2023-08-21,1021
1802,台玻,20,0,20,合庫-台中,2023-08-21,1021
2419,仲琦,26,6,20,合庫-台中,2023-08-21,1021
6703,軒郁,19,0,19,合庫-台中,2023-08-21,1021
00882,中信中國高股息,29,11,18,合庫-台中,2023-08-21,1021
2601,益航,20,2,18,合庫-台中,2023-08-21,1021
00931B,統一美債20年,19,3,16,合庫-台中,2023-08-21,1021
0050,元大台灣50,19,3,16,合庫-台中,2023-08-21,1021
3706,神達,36,21,15,合庫-台中,2023-08-21,1021
4160,訊聯基因,15,0,15,合庫-台中,2023-08-21,1021
2328,廣宇,15,0,15,合庫-台中,2023-08-21,1021
3714,富采,15,0,15,合庫-台中,2023-08-21,1021
2495,普安,15,0,15,合庫-台中,2023-08-21,1021
4938,和碩,17,2,15,合庫-台中,2023-08-21,1021
5347,世界,16,2,14,合庫-台中,2023-08-21,1021
4934,太極,16,2,14,合庫-台中,2023-08-21,1021
2344,華邦電,28,15,13,合庫-台中,2023-08-21,1021
1714,和桐,13,0,13,合庫-台中,2023-08-21,1021
6770,力積電,13,0,13,合庫-台中,2023-08-21,1021
3306,鼎天,27,14,13,合庫-台中,2023-08-21,1021
00670L,富邦NASDAQ正2,176,2,174,合庫-台中,2023-08-22,1021
2539,櫻花建,138,0,138,合庫-台中,2023-08-22,1021
00720B,元大投資級公司債,114,0,114,合庫-台中,2023-08-22,1021
00929,復華台灣科技優息,100,7,93,合庫-台中,2023-08-22,1021
2883,凱基金,88,9,79,合庫-台中,2023-08-22,1021
00632R,元大台灣50反1,70,0,70,合庫-台中,2023-08-22,1021
00882,中信中國高股息,62,0,62,合庫-台中,2023-08-22,1021
00679B,元大美債20年,64,5,59,合庫-台中,2023-08-22,1021
3523,迎輝,56,0,56,合庫-台中,2023-08-22,1021
1101,台泥,59,3,56,合庫-台中,2023-08-22,1021
2014,中鴻,52,0,52,合庫-台中,2023-08-22,1021
4906,正文,54,12,42,合庫-台中,2023-08-22,1021
2062,橋椿,40,0,40,合庫-台中,2023-08-22,1021
1710,東聯,40,0,40,合庫-台中,2023-08-22,1021
00885,富邦越南,45,10,35,合庫-台中,2023-08-22,1021
6125,廣運,69,37,32,合庫-台中,2023-08-22,1021
00751B,元大AAA至A公司債,30,0,30,合庫-台中,2023-08-22,1021
6026,福邦證,30,0,30,合庫-台中,2023-08-22,1021
2618,長榮航,75,45,30,合庫-台中,2023-08-22,1021
2457,飛宏,51,22,29,合庫-台中,2023-08-22,1021
3056,富華新,29,0,29,合庫-台中,2023-08-22,1021
2421,建準,74,46,28,合庫-台中,2023-08-22,1021
2324,仁寶,78,52,26,合庫-台中,2023-08-22,1021
2461,光群雷,25,1,24,合庫-台中,2023-08-22,1021
2332,友訊,42,19,23,合庫-台中,2023-08-22,1021
2886,兆豐金,32,9,23,合庫-台中,2023-08-22,1021
6108,競國,24,1,23,合庫-台中,2023-08-22,1021
2303,聯電,23,1,22,合庫-台中,2023-08-22,1021
2888,新光金,21,1,20,合庫-台中,2023-08-22,1021
2891,中信金,21,1,20,合庫-台中,2023-08-22,1021
00760B,復華新興企業債,20,0,20,合庫-台中,2023-08-22,1021
9105,泰金寶-DR,20,0,20,合庫-台中,2023-08-22,1021
3583,辛耘,45,25,20,合庫-台中,2023-08-22,1021
2002,中鋼,20,0,20,合庫-台中,2023-08-22,1021
6472,保瑞,22,3,19,合庫-台中,2023-08-22,1021
2401,凌陽,28,9,19,合庫-台中,2023-08-22,1021
3163,波若威,28,9,19,合庫-台中,2023-08-22,1021
00712,復華富時不動產,19,0,19,合庫-台中,2023-08-22,1021
00772B,中信高評級公司債,29,11,18,合庫-台中,2023-08-22,1021
4904,遠傳,17,0,17,合庫-台中,2023-08-22,1021
2645,長榮航太,20,3,17,合庫-台中,2023-08-22,1021
2462,良得電,16,0,16,合庫-台中,2023-08-22,1021
1504,東元,28,12,16,合庫-台中,2023-08-22,1021
00715L,期街口布蘭特正2,15,0,15,合庫-台中,2023-08-22,1021
2329,華泰,53,38,15,合庫-台中,2023-08-22,1021
00722B,群益投資級電信債,15,0,15,合庫-台中,2023-08-22,1021
5410,國眾,15,0,15,合庫-台中,2023-08-22,1021
2356,英業達,122,107,15,合庫-台中,2023-08-22,1021
4743,合一,15,1,14,合庫-台中,2023-08-22,1021
4950,牧東,14,0,14,合庫-台中,2023-08-22,1021
2363,矽統,704,326,378,合庫-台中,2023-08-23,1021
00878,國泰永續高股息,266,35,231,合庫-台中,2023-08-23,1021
2539,櫻花建,157,1,156,合庫-台中,2023-08-23,1021
1514,亞力,120,4,116,合庫-台中,2023-08-23,1021
2618,長榮航,279,168,111,合庫-台中,2023-08-23,1021
3523,迎輝,80,0,80,合庫-台中,2023-08-23,1021
00665L,富邦�琤肭磪囓�2,89,31,58,合庫-台中,2023-08-23,1021
3013,晟銘電,108,54,54,合庫-台中,2023-08-23,1021
1444,力麗,50,3,47,合庫-台中,2023-08-23,1021
6116,彩晶,40,0,40,合庫-台中,2023-08-23,1021
5880,合庫金,37,1,36,合庫-台中,2023-08-23,1021
3567,逸昌,114,79,35,合庫-台中,2023-08-23,1021
3051,力特,94,61,33,合庫-台中,2023-08-23,1021
00715L,期街口布蘭特正2,32,0,32,合庫-台中,2023-08-23,1021
2303,聯電,33,2,31,合庫-台中,2023-08-23,1021
4160,訊聯基因,31,0,31,合庫-台中,2023-08-23,1021
1326,台化,36,5,31,合庫-台中,2023-08-23,1021
2312,金寶,47,19,28,合庫-台中,2023-08-23,1021
3025,星通,30,2,28,合庫-台中,2023-08-23,1021
1584,精剛,34,6,28,合庫-台中,2023-08-23,1021
6170,統振,63,36,27,合庫-台中,2023-08-23,1021
3380,明泰,35,8,27,合庫-台中,2023-08-23,1021
2301,光寶科,39,14,25,合庫-台中,2023-08-23,1021
2601,益航,34,11,23,合庫-台中,2023-08-23,1021
00635U,期元大S＆P黃金,22,0,22,合庫-台中,2023-08-23,1021
2002,中鋼,24,2,22,合庫-台中,2023-08-23,1021
1519,華城,61,40,21,合庫-台中,2023-08-23,1021
3078,僑威,24,3,21,合庫-台中,2023-08-23,1021
4960,誠美材,42,21,21,合庫-台中,2023-08-23,1021
2329,華泰,42,21,21,合庫-台中,2023-08-23,1021
1714,和桐,20,0,20,合庫-台中,2023-08-23,1021
6016,康和證,20,0,20,合庫-台中,2023-08-23,1021
2630,亞航,29,10,19,合庫-台中,2023-08-23,1021
3231,緯創,154,135,19,合庫-台中,2023-08-23,1021
00923,群益台ESG低碳50,19,2,17,合庫-台中,2023-08-23,1021
3056,富華新,19,2,17,合庫-台中,2023-08-23,1021
1101,台泥,27,10,17,合庫-台中,2023-08-23,1021
1802,台玻,17,2,15,合庫-台中,2023-08-23,1021
2332,友訊,27,12,15,合庫-台中,2023-08-23,1021
1471,首利,23,9,14,合庫-台中,2023-08-23,1021
00687B,國泰20年美債,14,0,14,合庫-台中,2023-08-23,1021
3290,東浦,14,0,14,合庫-台中,2023-08-23,1021
8093,保銳,13,0,13,合庫-台中,2023-08-23,1021
2328,廣宇,14,1,13,合庫-台中,2023-08-23,1021
4745,合富-KY,22,10,12,合庫-台中,2023-08-23,1021
3689,湧德,13,1,12,合庫-台中,2023-08-23,1021
2882,國泰金,12,0,12,合庫-台中,2023-08-23,1021
8069,元太,13,1,12,合庫-台中,2023-08-23,1021
2485,兆赫,17,5,12,合庫-台中,2023-08-23,1021
2641,正德,12,1,11,合庫-台中,2023-08-23,1021
2363,矽統,748,343,405,合庫-台中,2023-08-24,1021
3231,緯創,547,320,227,合庫-台中,2023-08-24,1021
6167,久正,153,4,149,合庫-台中,2023-08-24,1021
2002,中鋼,92,0,92,合庫-台中,2023-08-24,1021
00715L,期街口布蘭特正2,88,1,87,合庫-台中,2023-08-24,1021
2883,凱基金,86,0,86,合庫-台中,2023-08-24,1021
3025,星通,64,0,64,合庫-台中,2023-08-24,1021
2419,仲琦,106,45,61,合庫-台中,2023-08-24,1021
6282,康舒,178,118,60,合庫-台中,2023-08-24,1021
00919,群益台灣精選高息,66,15,51,合庫-台中,2023-08-24,1021
8027,鈦昇,57,6,51,合庫-台中,2023-08-24,1021
2515,中工,50,0,50,合庫-台中,2023-08-24,1021
6274,台燿,58,9,49,合庫-台中,2023-08-24,1021
2337,旺宏,50,1,49,合庫-台中,2023-08-24,1021
1514,亞力,47,3,44,合庫-台中,2023-08-24,1021
00929,復華台灣科技優息,87,44,43,合庫-台中,2023-08-24,1021
00931B,統一美債20年,42,0,42,合庫-台中,2023-08-24,1021
2208,台船,45,4,41,合庫-台中,2023-08-24,1021
2356,英業達,154,115,39,合庫-台中,2023-08-24,1021
3715,定穎投控,67,35,32,合庫-台中,2023-08-24,1021
9907,統一實,30,0,30,合庫-台中,2023-08-24,1021
1515,力山,30,0,30,合庫-台中,2023-08-24,1021
4906,正文,72,43,29,合庫-台中,2023-08-24,1021
00712,復華富時不動產,36,10,26,合庫-台中,2023-08-24,1021
00632R,元大台灣50反1,64,40,24,合庫-台中,2023-08-24,1021
1513,中興電,84,61,23,合庫-台中,2023-08-24,1021
2409,友達,42,19,23,合庫-台中,2023-08-24,1021
2609,陽明,32,9,23,合庫-台中,2023-08-24,1021
5608,四維航,37,15,22,合庫-台中,2023-08-24,1021
1806,冠軍,21,0,21,合庫-台中,2023-08-24,1021
2601,益航,20,0,20,合庫-台中,2023-08-24,1021
2421,建準,66,47,19,合庫-台中,2023-08-24,1021
1714,和桐,20,1,19,合庫-台中,2023-08-24,1021
3078,僑威,24,6,18,合庫-台中,2023-08-24,1021
2344,華邦電,44,26,18,合庫-台中,2023-08-24,1021
00903,富邦元宇宙,18,0,18,合庫-台中,2023-08-24,1021
2313,華通,29,11,18,合庫-台中,2023-08-24,1021
5348,正能量智能,24,6,18,合庫-台中,2023-08-24,1021
2880,華南金,22,6,16,合庫-台中,2023-08-24,1021
2641,正德,16,0,16,合庫-台中,2023-08-24,1021
2367,燿華,16,0,16,合庫-台中,2023-08-24,1021
00907,永豐優息存股,15,0,15,合庫-台中,2023-08-24,1021
4160,訊聯基因,15,0,15,合庫-台中,2023-08-24,1021
8210,勤誠,26,11,15,合庫-台中,2023-08-24,1021
9904,寶成,14,0,14,合庫-台中,2023-08-24,1021
1810,和成,13,0,13,合庫-台中,2023-08-24,1021
4532,瑞智,13,0,13,合庫-台中,2023-08-24,1021
2891,中信金,23,10,13,合庫-台中,2023-08-24,1021
6275,元山,13,0,13,合庫-台中,2023-08-24,1021
9933,中鼎,13,0,13,合庫-台中,2023-08-24,1021
3231,緯創,526,199,327,合庫-台中,2023-08-25,1021
00878,國泰永續高股息,331,47,284,合庫-台中,2023-08-25,1021
00670L,富邦NASDAQ正2,179,2,177,合庫-台中,2023-08-25,1021
00919,群益台灣精選高息,169,0,169,合庫-台中,2023-08-25,1021
00929,復華台灣科技優息,195,33,162,合庫-台中,2023-08-25,1021
0056,元大高股息,140,0,140,合庫-台中,2023-08-25,1021
00632R,元大台灣50反1,90,5,85,合庫-台中,2023-08-25,1021
00650L,復華香港正2,80,0,80,合庫-台中,2023-08-25,1021
2409,友達,77,8,69,合庫-台中,2023-08-25,1021
2485,兆赫,99,36,63,合庫-台中,2023-08-25,1021
1514,亞力,63,1,62,合庫-台中,2023-08-25,1021
5880,合庫金,56,0,56,合庫-台中,2023-08-25,1021
2331,精英,109,56,53,合庫-台中,2023-08-25,1021
5905,南仁湖,52,1,51,合庫-台中,2023-08-25,1021
2329,華泰,57,9,48,合庫-台中,2023-08-25,1021
2457,飛宏,51,4,47,合庫-台中,2023-08-25,1021
2610,華航,51,7,44,合庫-台中,2023-08-25,1021
3523,迎輝,43,0,43,合庫-台中,2023-08-25,1021
2352,佳世達,65,23,42,合庫-台中,2023-08-25,1021
911868,同方友友-DR,39,0,39,合庫-台中,2023-08-25,1021
2618,長榮航,74,39,35,合庫-台中,2023-08-25,1021
6282,康舒,127,92,35,合庫-台中,2023-08-25,1021
2002,中鋼,35,2,33,合庫-台中,2023-08-25,1021
2734,易飛網,33,0,33,合庫-台中,2023-08-25,1021
8222,寶一,64,32,32,合庫-台中,2023-08-25,1021
2634,漢翔,121,90,31,合庫-台中,2023-08-25,1021
2382,廣達,116,85,31,合庫-台中,2023-08-25,1021
3037,欣興,29,1,28,合庫-台中,2023-08-25,1021
7402,邑錡,28,0,28,合庫-台中,2023-08-25,1021
2303,聯電,34,6,28,合庫-台中,2023-08-25,1021
2330,台積電,34,8,26,合庫-台中,2023-08-25,1021
2884,玉山金,32,7,25,合庫-台中,2023-08-25,1021
2892,第一金,23,0,23,合庫-台中,2023-08-25,1021
2743,山富,39,18,21,合庫-台中,2023-08-25,1021
00923,群益台ESG低碳50,20,0,20,合庫-台中,2023-08-25,1021
2745,五福,22,2,20,合庫-台中,2023-08-25,1021
6757,台灣虎航,20,0,20,合庫-台中,2023-08-25,1021
2402,毅嘉,30,10,20,合庫-台中,2023-08-25,1021
1802,台玻,23,3,20,合庫-台中,2023-08-25,1021
2377,微星,20,1,19,合庫-台中,2023-08-25,1021
4960,誠美材,20,1,19,合庫-台中,2023-08-25,1021
3623,富晶通,19,0,19,合庫-台中,2023-08-25,1021
3308,聯德,28,10,18,合庫-台中,2023-08-25,1021
5340,建榮,20,3,17,合庫-台中,2023-08-25,1021
3701,大眾控,16,0,16,合庫-台中,2023-08-25,1021
00753L,中信中國50正2,72,56,16,合庫-台中,2023-08-25,1021
3363,上詮,19,4,15,合庫-台中,2023-08-25,1021
00907,永豐優息存股,14,0,14,合庫-台中,2023-08-25,1021
2462,良得電,14,0,14,合庫-台中,2023-08-25,1021
6770,力積電,14,0,14,合庫-台中,2023-08-25,1021
3711,日月光投控,548,37,511,合庫-台中,2023-08-28,1021
00632R,元大台灣50反1,665,165,500,合庫-台中,2023-08-28,1021
00637L,元大滬深300正2,610,144,466,合庫-台中,2023-08-28,1021
00665L,富邦�琤肭磪囓�2,325,40,285,合庫-台中,2023-08-28,1021
00929,復華台灣科技優息,168,27,141,合庫-台中,2023-08-28,1021
2618,長榮航,153,22,131,合庫-台中,2023-08-28,1021
2356,英業達,125,33,92,合庫-台中,2023-08-28,1021
6282,康舒,159,76,83,合庫-台中,2023-08-28,1021
00919,群益台灣精選高息,75,2,73,合庫-台中,2023-08-28,1021
3704,合勤控,74,1,73,合庫-台中,2023-08-28,1021
2614,東森,63,3,60,合庫-台中,2023-08-28,1021
3308,聯德,71,15,56,合庫-台中,2023-08-28,1021
00878,國泰永續高股息,114,63,51,合庫-台中,2023-08-28,1021
2610,華航,55,4,51,合庫-台中,2023-08-28,1021
2419,仲琦,59,11,48,合庫-台中,2023-08-28,1021
2388,威盛,64,24,40,合庫-台中,2023-08-28,1021
4906,正文,138,100,38,合庫-台中,2023-08-28,1021
2331,精英,139,102,37,合庫-台中,2023-08-28,1021
0056,元大高股息,42,6,36,合庫-台中,2023-08-28,1021
2450,神腦,31,0,31,合庫-台中,2023-08-28,1021
3163,波若威,59,29,30,合庫-台中,2023-08-28,1021
2511,太子,30,0,30,合庫-台中,2023-08-28,1021
9105,泰金寶-DR,30,0,30,合庫-台中,2023-08-28,1021
3523,迎輝,30,0,30,合庫-台中,2023-08-28,1021
1444,力麗,30,1,29,合庫-台中,2023-08-28,1021
8033,雷虎,40,12,28,合庫-台中,2023-08-28,1021
3567,逸昌,28,0,28,合庫-台中,2023-08-28,1021
2515,中工,26,0,26,合庫-台中,2023-08-28,1021
2332,友訊,52,27,25,合庫-台中,2023-08-28,1021
00900,富邦特選高股息30,41,16,25,合庫-台中,2023-08-28,1021
2344,華邦電,24,1,23,合庫-台中,2023-08-28,1021
3017,奇鋐,36,13,23,合庫-台中,2023-08-28,1021
2002,中鋼,24,2,22,合庫-台中,2023-08-28,1021
00885,富邦越南,31,10,21,合庫-台中,2023-08-28,1021
00728,第一金工業30,21,0,21,合庫-台中,2023-08-28,1021
2723,美食-KY,22,2,20,合庫-台中,2023-08-28,1021
2323,中環,25,6,19,合庫-台中,2023-08-28,1021
6689,伊雲谷,19,0,19,合庫-台中,2023-08-28,1021
5880,合庫金,18,0,18,合庫-台中,2023-08-28,1021
5381,合正,88,71,17,合庫-台中,2023-08-28,1021
2382,廣達,122,104,18,合庫-台中,2023-08-28,1021
4977,眾達-KY,16,1,15,合庫-台中,2023-08-28,1021
2538,基泰,15,0,15,合庫-台中,2023-08-28,1021
1810,和成,28,13,15,合庫-台中,2023-08-28,1021
4916,事欣科,28,13,15,合庫-台中,2023-08-28,1021
6170,統振,33,18,15,合庫-台中,2023-08-28,1021
2409,友達,58,43,15,合庫-台中,2023-08-28,1021
2371,大同,20,6,14,合庫-台中,2023-08-28,1021
2421,建準,35,22,13,合庫-台中,2023-08-28,1021
9958,世紀鋼,22,9,13,合庫-台中,2023-08-28,1021
00665L,富邦�琤肭磪囓�2,672,193,479,合庫-台中,2023-08-29,1021
2363,矽統,371,192,179,合庫-台中,2023-08-29,1021
00632R,元大台灣50反1,209,55,154,合庫-台中,2023-08-29,1021
1570,力肯,117,0,117,合庫-台中,2023-08-29,1021
5880,合庫金,88,1,87,合庫-台中,2023-08-29,1021
2637,慧洋-KY,75,1,74,合庫-台中,2023-08-29,1021
2356,英業達,101,39,62,合庫-台中,2023-08-29,1021
00929,復華台灣科技優息,119,66,53,合庫-台中,2023-08-29,1021
00919,群益台灣精選高息,52,0,52,合庫-台中,2023-08-29,1021
2002,中鋼,55,3,52,合庫-台中,2023-08-29,1021
3481,群創,86,38,48,合庫-台中,2023-08-29,1021
2516,新建,48,0,48,合庫-台中,2023-08-29,1021
2614,東森,50,3,47,合庫-台中,2023-08-29,1021
9136,巨騰-DR,45,0,45,合庫-台中,2023-08-29,1021
1445,大宇,40,0,40,合庫-台中,2023-08-29,1021
3615,安可,40,0,40,合庫-台中,2023-08-29,1021
6235,華孚,87,51,36,合庫-台中,2023-08-29,1021
6443,元晶,62,29,33,合庫-台中,2023-08-29,1021
8442,威宏-KY,33,0,33,合庫-台中,2023-08-29,1021
3056,富華新,29,0,29,合庫-台中,2023-08-29,1021
2634,漢翔,79,52,27,合庫-台中,2023-08-29,1021
2049,上銀,27,0,27,合庫-台中,2023-08-29,1021
1471,首利,31,5,26,合庫-台中,2023-08-29,1021
8222,寶一,93,68,25,合庫-台中,2023-08-29,1021
2636,台驊控股,23,0,23,合庫-台中,2023-08-29,1021
00885,富邦越南,30,9,21,合庫-台中,2023-08-29,1021
4123,晟德,20,0,20,合庫-台中,2023-08-29,1021
1312,國喬,20,0,20,合庫-台中,2023-08-29,1021
2421,建準,38,19,19,合庫-台中,2023-08-29,1021
6116,彩晶,26,7,19,合庫-台中,2023-08-29,1021
2880,華南金,19,0,19,合庫-台中,2023-08-29,1021
2317,鴻海,48,30,18,合庫-台中,2023-08-29,1021
2312,金寶,18,0,18,合庫-台中,2023-08-29,1021
6168,宏齊,18,1,17,合庫-台中,2023-08-29,1021
7402,邑錡,16,0,16,合庫-台中,2023-08-29,1021
2409,友達,27,11,16,合庫-台中,2023-08-29,1021
1786,科妍,18,3,15,合庫-台中,2023-08-29,1021
2618,長榮航,48,34,14,合庫-台中,2023-08-29,1021
00892,富邦台灣半導體,14,0,14,合庫-台中,2023-08-29,1021
00900,富邦特選高股息30,14,0,14,合庫-台中,2023-08-29,1021
2303,聯電,53,39,14,合庫-台中,2023-08-29,1021
4938,和碩,18,4,14,合庫-台中,2023-08-29,1021
2884,玉山金,13,0,13,合庫-台中,2023-08-29,1021
3711,日月光投控,38,25,13,合庫-台中,2023-08-29,1021
2329,華泰,36,23,13,合庫-台中,2023-08-29,1021
9907,統一實,13,1,12,合庫-台中,2023-08-29,1021
1810,和成,35,23,12,合庫-台中,2023-08-29,1021
6770,力積電,11,0,11,合庫-台中,2023-08-29,1021
00891,中信關鍵半導體,10,0,10,合庫-台中,2023-08-29,1021
2362,藍天,10,0,10,合庫-台中,2023-08-29,1021
2331,精英,342,58,284,合庫-台中,2023-08-30,1021
00673R,期元大S＆P原油反1,178,3,175,合庫-台中,2023-08-30,1021
2457,飛宏,136,6,130,合庫-台中,2023-08-30,1021
3481,群創,77,4,73,合庫-台中,2023-08-30,1021
00655L,國泰中國A50正2,63,0,63,合庫-台中,2023-08-30,1021
1909,榮成,60,0,60,合庫-台中,2023-08-30,1021
2485,兆赫,75,22,53,合庫-台中,2023-08-30,1021
2465,麗臺,51,0,51,合庫-台中,2023-08-30,1021
9136,巨騰-DR,47,0,47,合庫-台中,2023-08-30,1021
6282,康舒,143,100,43,合庫-台中,2023-08-30,1021
2409,友達,92,52,40,合庫-台中,2023-08-30,1021
3094,聯傑,36,2,34,合庫-台中,2023-08-30,1021
3615,安可,33,0,33,合庫-台中,2023-08-30,1021
2419,仲琦,40,9,31,合庫-台中,2023-08-30,1021
1445,大宇,30,0,30,合庫-台中,2023-08-30,1021
3035,智原,68,39,29,合庫-台中,2023-08-30,1021
5222,全訊,27,0,27,合庫-台中,2023-08-30,1021
2312,金寶,27,1,26,合庫-台中,2023-08-30,1021
2344,華邦電,35,12,23,合庫-台中,2023-08-30,1021
1101,台泥,31,9,22,合庫-台中,2023-08-30,1021
1303,南亞,23,1,22,合庫-台中,2023-08-30,1021
00722B,群益投資級電信債,22,0,22,合庫-台中,2023-08-30,1021
2382,廣達,91,69,22,合庫-台中,2023-08-30,1021
9945,潤泰新,24,6,18,合庫-台中,2023-08-30,1021
4906,正文,36,19,17,合庫-台中,2023-08-30,1021
6188,廣明,32,15,17,合庫-台中,2023-08-30,1021
6168,宏齊,107,90,17,合庫-台中,2023-08-30,1021
1612,宏泰,17,0,17,合庫-台中,2023-08-30,1021
3706,神達,22,6,16,合庫-台中,2023-08-30,1021
2301,光寶科,65,49,16,合庫-台中,2023-08-30,1021
00753L,中信中國50正2,24,8,16,合庫-台中,2023-08-30,1021
2324,仁寶,25,11,14,合庫-台中,2023-08-30,1021
3037,欣興,17,4,13,合庫-台中,2023-08-30,1021
1708,東鹼,16,3,13,合庫-台中,2023-08-30,1021
6117,迎廣,13,0,13,合庫-台中,2023-08-30,1021
2630,亞航,27,14,13,合庫-台中,2023-08-30,1021
2303,聯電,44,32,12,合庫-台中,2023-08-30,1021
2425,承啟,19,7,12,合庫-台中,2023-08-30,1021
00900,富邦特選高股息30,16,4,12,合庫-台中,2023-08-30,1021
3596,智易,12,0,12,合庫-台中,2023-08-30,1021
3707,漢磊,12,1,11,合庫-台中,2023-08-30,1021
00683L,期元大美元指正2,11,0,11,合庫-台中,2023-08-30,1021
2408,南亞科,10,0,10,合庫-台中,2023-08-30,1021
5483,中美晶,11,1,10,合庫-台中,2023-08-30,1021
5876,上海商銀,10,0,10,合庫-台中,2023-08-30,1021
00772B,中信高評級公司債,11,1,10,合庫-台中,2023-08-30,1021
00688L,國泰20年美債正2,10,0,10,合庫-台中,2023-08-30,1021
4909,新復興,13,3,10,合庫-台中,2023-08-30,1021
3019,亞光,19,9,10,合庫-台中,2023-08-30,1021
00760B,復華新興企業債,10,0,10,合庫-台中,2023-08-30,1021
2303,聯電,516,21,495,合庫-台中,2023-08-31,1021
6282,康舒,277,4,273,合庫-台中,2023-08-31,1021
00878,國泰永續高股息,132,6,126,合庫-台中,2023-08-31,1021
00929,復華台灣科技優息,370,254,116,合庫-台中,2023-08-31,1021
2337,旺宏,208,95,113,合庫-台中,2023-08-31,1021
2105,正新,78,5,73,合庫-台中,2023-08-31,1021
3481,群創,116,43,73,合庫-台中,2023-08-31,1021
2440,太空梭,69,1,68,合庫-台中,2023-08-31,1021
4906,正文,77,14,63,合庫-台中,2023-08-31,1021
1471,首利,62,2,60,合庫-台中,2023-08-31,1021
2880,華南金,53,0,53,合庫-台中,2023-08-31,1021
9136,巨騰-DR,52,0,52,合庫-台中,2023-08-31,1021
2498,宏達電,51,1,50,合庫-台中,2023-08-31,1021
2618,長榮航,65,18,47,合庫-台中,2023-08-31,1021
2014,中鴻,44,1,43,合庫-台中,2023-08-31,1021
5880,合庫金,41,0,41,合庫-台中,2023-08-31,1021
1909,榮成,40,0,40,合庫-台中,2023-08-31,1021
1802,台玻,91,56,35,合庫-台中,2023-08-31,1021
1101,台泥,34,0,34,合庫-台中,2023-08-31,1021
2495,普安,48,20,28,合庫-台中,2023-08-31,1021
7402,邑錡,44,16,28,合庫-台中,2023-08-31,1021
2891,中信金,31,4,27,合庫-台中,2023-08-31,1021
3682,亞太電,27,0,27,合庫-台中,2023-08-31,1021
2610,華航,66,40,26,合庫-台中,2023-08-31,1021
2332,友訊,32,6,26,合庫-台中,2023-08-31,1021
6547,高端疫苗,30,4,26,合庫-台中,2023-08-31,1021
2324,仁寶,48,24,24,合庫-台中,2023-08-31,1021
2834,臺企銀,64,40,24,合庫-台中,2023-08-31,1021
1760,寶齡富錦,21,0,21,合庫-台中,2023-08-31,1021
5410,國眾,20,0,20,合庫-台中,2023-08-31,1021
2645,長榮航太,29,9,20,合庫-台中,2023-08-31,1021
3025,星通,20,0,20,合庫-台中,2023-08-31,1021
9105,泰金寶-DR,20,0,20,合庫-台中,2023-08-31,1021
2881,富邦金,18,0,18,合庫-台中,2023-08-31,1021
3545,敦泰,18,0,18,合庫-台中,2023-08-31,1021
2601,益航,20,3,17,合庫-台中,2023-08-31,1021
2884,玉山金,17,0,17,合庫-台中,2023-08-31,1021
2436,偉詮電,58,42,16,合庫-台中,2023-08-31,1021
3523,迎輝,15,0,15,合庫-台中,2023-08-31,1021
2352,佳世達,15,0,15,合庫-台中,2023-08-31,1021
2892,第一金,14,0,14,合庫-台中,2023-08-31,1021
2883,凱基金,27,13,14,合庫-台中,2023-08-31,1021
2801,彰銀,13,0,13,合庫-台中,2023-08-31,1021
1612,宏泰,15,2,13,合庫-台中,2023-08-31,1021
5009,榮剛,17,5,12,合庫-台中,2023-08-31,1021
6770,力積電,13,1,12,合庫-台中,2023-08-31,1021
2355,敬鵬,16,4,12,合庫-台中,2023-08-31,1021
2323,中環,12,0,12,合庫-台中,2023-08-31,1021
00891,中信關鍵半導體,12,0,12,合庫-台中,2023-08-31,1021
2886,兆豐金,17,5,12,合庫-台中,2023-08-31,1021
2363,矽統,980,347,633,合庫-台中,2023-09-01,1021
00929,復華台灣科技優息,369,14,355,合庫-台中,2023-09-01,1021
2312,金寶,302,23,279,合庫-台中,2023-09-01,1021
00919,群益台灣精選高息,200,10,190,合庫-台中,2023-09-01,1021
00637L,元大滬深300正2,191,23,168,合庫-台中,2023-09-01,1021
2206,三陽工業,174,9,165,合庫-台中,2023-09-01,1021
2887,台新金,123,0,123,合庫-台中,2023-09-01,1021
00673R,期元大S＆P原油反1,106,0,106,合庫-台中,2023-09-01,1021
2356,英業達,125,23,102,合庫-台中,2023-09-01,1021
00932,兆豐永續高息等權,92,2,90,合庫-台中,2023-09-01,1021
3231,緯創,277,190,87,合庫-台中,2023-09-01,1021
00878,國泰永續高股息,79,6,73,合庫-台中,2023-09-01,1021
3615,安可,75,22,53,合庫-台中,2023-09-01,1021
2633,台灣高鐵,52,2,50,合庫-台中,2023-09-01,1021
2618,長榮航,78,32,46,合庫-台中,2023-09-01,1021
1532,勤美,50,10,40,合庫-台中,2023-09-01,1021
3011,今皓,51,12,39,合庫-台中,2023-09-01,1021
2419,仲琦,36,0,36,合庫-台中,2023-09-01,1021
2382,廣達,193,158,35,合庫-台中,2023-09-01,1021
2884,玉山金,41,7,34,合庫-台中,2023-09-01,1021
00885,富邦越南,33,0,33,合庫-台中,2023-09-01,1021
3379,彬台,32,0,32,合庫-台中,2023-09-01,1021
5386,青雲,33,1,32,合庫-台中,2023-09-01,1021
3308,聯德,49,18,31,合庫-台中,2023-09-01,1021
2329,華泰,52,26,26,合庫-台中,2023-09-01,1021
9136,巨騰-DR,24,0,24,合庫-台中,2023-09-01,1021
1605,華新,41,18,23,合庫-台中,2023-09-01,1021
6188,廣明,27,5,22,合庫-台中,2023-09-01,1021
4533,協易機,21,0,21,合庫-台中,2023-09-01,1021
2427,三商電,20,0,20,合庫-台中,2023-09-01,1021
2421,建準,40,21,19,合庫-台中,2023-09-01,1021
6547,高端疫苗,115,96,19,合庫-台中,2023-09-01,1021
6285,啟��,29,10,19,合庫-台中,2023-09-01,1021
4747,強生,19,0,19,合庫-台中,2023-09-01,1021
2886,兆豐金,18,0,18,合庫-台中,2023-09-01,1021
00923,群益台ESG低碳50,20,2,18,合庫-台中,2023-09-01,1021
3706,神達,26,9,17,合庫-台中,2023-09-01,1021
2313,華通,25,9,16,合庫-台中,2023-09-01,1021
4113,聯上,16,0,16,合庫-台中,2023-09-01,1021
2399,映泰,26,11,15,合庫-台中,2023-09-01,1021
2062,橋椿,15,0,15,合庫-台中,2023-09-01,1021
00670L,富邦NASDAQ正2,43,28,15,合庫-台中,2023-09-01,1021
5388,中磊,15,0,15,合庫-台中,2023-09-01,1021
6153,嘉聯益,14,0,14,合庫-台中,2023-09-01,1021
2485,兆赫,59,45,14,合庫-台中,2023-09-01,1021
2603,長榮,17,4,13,合庫-台中,2023-09-01,1021
6213,聯茂,39,26,13,合庫-台中,2023-09-01,1021
5301,寶得利,13,0,13,合庫-台中,2023-09-01,1021
6770,力積電,15,2,13,合庫-台中,2023-09-01,1021
8088,品安,19,6,13,合庫-台中,2023-09-01,1021
00676R,富邦臺灣加權反1,800,30,770,合庫-台中,2023-09-04,1021
2409,友達,212,10,202,合庫-台中,2023-09-04,1021
2892,第一金,125,2,123,合庫-台中,2023-09-04,1021
2884,玉山金,104,10,94,合庫-台中,2023-09-04,1021
3481,群創,93,10,83,合庫-台中,2023-09-04,1021
2371,大同,97,31,66,合庫-台中,2023-09-04,1021
3052,夆典,52,0,52,合庫-台中,2023-09-04,1021
2363,矽統,256,205,51,合庫-台中,2023-09-04,1021
00919,群益台灣精選高息,53,8,45,合庫-台中,2023-09-04,1021
00878,國泰永續高股息,68,30,38,合庫-台中,2023-09-04,1021
1802,台玻,117,82,35,合庫-台中,2023-09-04,1021
00931B,統一美債20年,35,0,35,合庫-台中,2023-09-04,1021
2369,菱生,48,16,32,合庫-台中,2023-09-04,1021
00637L,元大滬深300正2,44,12,32,合庫-台中,2023-09-04,1021
00751B,元大AAA至A公司債,28,0,28,合庫-台中,2023-09-04,1021
00679B,元大美債20年,28,0,28,合庫-台中,2023-09-04,1021
5381,合正,72,44,28,合庫-台中,2023-09-04,1021
5880,合庫金,29,1,28,合庫-台中,2023-09-04,1021
2402,毅嘉,85,57,28,合庫-台中,2023-09-04,1021
2634,漢翔,78,52,26,合庫-台中,2023-09-04,1021
3548,兆利,26,0,26,合庫-台中,2023-09-04,1021
00715L,期街口布蘭特正2,25,1,24,合庫-台中,2023-09-04,1021
2331,精英,52,31,21,合庫-台中,2023-09-04,1021
1444,力麗,21,0,21,合庫-台中,2023-09-04,1021
6285,啟��,37,17,20,合庫-台中,2023-09-04,1021
1714,和桐,20,0,20,合庫-台中,2023-09-04,1021
00632R,元大台灣50反1,20,0,20,合庫-台中,2023-09-04,1021
1447,力鵬,20,0,20,合庫-台中,2023-09-04,1021
3025,星通,20,0,20,合庫-台中,2023-09-04,1021
2352,佳世達,78,59,19,合庫-台中,2023-09-04,1021
6143,振曜,21,2,19,合庫-台中,2023-09-04,1021
6418,詠昇,23,5,18,合庫-台中,2023-09-04,1021
4113,聯上,18,0,18,合庫-台中,2023-09-04,1021
6547,高端疫苗,38,22,16,合庫-台中,2023-09-04,1021
00687B,國泰20年美債,15,0,15,合庫-台中,2023-09-04,1021
00902,中信電池及儲能,15,0,15,合庫-台中,2023-09-04,1021
1609,大亞,32,17,15,合庫-台中,2023-09-04,1021
2323,中環,24,9,15,合庫-台中,2023-09-04,1021
3272,東碩,15,0,15,合庫-台中,2023-09-04,1021
00720B,元大投資級公司債,17,2,15,合庫-台中,2023-09-04,1021
3693,營邦,39,24,15,合庫-台中,2023-09-04,1021
8069,元太,14,0,14,合庫-台中,2023-09-04,1021
00923,群益台ESG低碳50,17,3,14,合庫-台中,2023-09-04,1021
2317,鴻海,23,9,14,合庫-台中,2023-09-04,1021
3257,虹冠電,19,6,13,合庫-台中,2023-09-04,1021
2208,台船,21,8,13,合庫-台中,2023-09-04,1021
4933,友輝,13,0,13,合庫-台中,2023-09-04,1021
2611,志信,13,0,13,合庫-台中,2023-09-04,1021
2618,長榮航,11,0,11,合庫-台中,2023-09-04,1021
1806,冠軍,11,0,11,合庫-台中,2023-09-04,1021
00665L,富邦�琤肭磪囓�2,317,6,311,合庫-台中,2023-09-05,1021
00919,群益台灣精選高息,280,52,228,合庫-台中,2023-09-05,1021
2880,華南金,111,4,107,合庫-台中,2023-09-05,1021
2886,兆豐金,104,0,104,合庫-台中,2023-09-05,1021
2409,友達,112,14,98,合庫-台中,2023-09-05,1021
2464,盟立,87,4,83,合庫-台中,2023-09-05,1021
00929,復華台灣科技優息,190,119,71,合庫-台中,2023-09-05,1021
00673R,期元大S＆P原油反1,70,0,70,合庫-台中,2023-09-05,1021
5880,合庫金,71,2,69,合庫-台中,2023-09-05,1021
3523,迎輝,67,0,67,合庫-台中,2023-09-05,1021
2344,華邦電,140,75,65,合庫-台中,2023-09-05,1021
2634,漢翔,83,33,50,合庫-台中,2023-09-05,1021
3715,定穎投控,135,91,44,合庫-台中,2023-09-05,1021
00882,中信中國高股息,44,0,44,合庫-台中,2023-09-05,1021
00915,凱基優選高股息30,44,0,44,合庫-台中,2023-09-05,1021
5488,松普,46,4,42,合庫-台中,2023-09-05,1021
2884,玉山金,44,5,39,合庫-台中,2023-09-05,1021
2834,臺企銀,39,1,38,合庫-台中,2023-09-05,1021
00751B,元大AAA至A公司債,35,0,35,合庫-台中,2023-09-05,1021
00670L,富邦NASDAQ正2,31,0,31,合庫-台中,2023-09-05,1021
6282,康舒,80,54,26,合庫-台中,2023-09-05,1021
3231,緯創,167,143,24,合庫-台中,2023-09-05,1021
5481,新華,24,0,24,合庫-台中,2023-09-05,1021
2913,農林,23,0,23,合庫-台中,2023-09-05,1021
6188,廣明,26,3,23,合庫-台中,2023-09-05,1021
1101,台泥,25,3,22,合庫-台中,2023-09-05,1021
6531,愛普*,69,47,22,合庫-台中,2023-09-05,1021
1313,聯成,21,0,21,合庫-台中,2023-09-05,1021
1314,中石化,30,9,21,合庫-台中,2023-09-05,1021
3056,富華新,43,22,21,合庫-台中,2023-09-05,1021
2337,旺宏,64,43,21,合庫-台中,2023-09-05,1021
2618,長榮航,26,5,21,合庫-台中,2023-09-05,1021
2419,仲琦,21,1,20,合庫-台中,2023-09-05,1021
8215,明基材,20,0,20,合庫-台中,2023-09-05,1021
00637L,元大滬深300正2,43,23,20,合庫-台中,2023-09-05,1021
8086,宏捷科,26,7,19,合庫-台中,2023-09-05,1021
1532,勤美,23,4,19,合庫-台中,2023-09-05,1021
3645,達邁,25,7,18,合庫-台中,2023-09-05,1021
2332,友訊,18,0,18,合庫-台中,2023-09-05,1021
6016,康和證,20,2,18,合庫-台中,2023-09-05,1021
2458,義隆,25,7,18,合庫-台中,2023-09-05,1021
1316,上曜,17,0,17,合庫-台中,2023-09-05,1021
00713,元大台灣高息低波,17,0,17,合庫-台中,2023-09-05,1021
1584,精剛,15,0,15,合庫-台中,2023-09-05,1021
1789,神隆,14,0,14,合庫-台中,2023-09-05,1021
2204,中華,19,5,14,合庫-台中,2023-09-05,1021
8016,矽創,32,18,14,合庫-台中,2023-09-05,1021
1519,華城,25,12,13,合庫-台中,2023-09-05,1021
2388,威盛,15,2,13,合庫-台中,2023-09-05,1021
00923,群益台ESG低碳50,14,1,13,合庫-台中,2023-09-05,1021
2409,友達,436,21,415,合庫-台中,2023-09-06,1021
3481,群創,383,27,356,合庫-台中,2023-09-06,1021
00929,復華台灣科技優息,580,234,346,合庫-台中,2023-09-06,1021
2888,新光金,97,0,97,合庫-台中,2023-09-06,1021
2363,矽統,222,134,88,合庫-台中,2023-09-06,1021
00932,兆豐永續高息等權,96,10,86,合庫-台中,2023-09-06,1021
00651R,復華香港反1,82,0,82,合庫-台中,2023-09-06,1021
5880,合庫金,72,3,69,合庫-台中,2023-09-06,1021
00719B,元大美債1-3,67,0,67,合庫-台中,2023-09-06,1021
00882,中信中國高股息,64,7,57,合庫-台中,2023-09-06,1021
2880,華南金,56,0,56,合庫-台中,2023-09-06,1021
8358,金居,67,11,56,合庫-台中,2023-09-06,1021
00751B,元大AAA至A公司債,55,1,54,合庫-台中,2023-09-06,1021
00673R,期元大S＆P原油反1,78,25,53,合庫-台中,2023-09-06,1021
2834,臺企銀,72,20,52,合庫-台中,2023-09-06,1021
2852,第一保,40,0,40,合庫-台中,2023-09-06,1021
00878,國泰永續高股息,63,23,40,合庫-台中,2023-09-06,1021
00921,兆豐龍頭等權重,39,1,38,合庫-台中,2023-09-06,1021
1101,台泥,54,16,38,合庫-台中,2023-09-06,1021
00642U,期元大S＆P石油,37,2,35,合庫-台中,2023-09-06,1021
2618,長榮航,45,12,33,合庫-台中,2023-09-06,1021
2340,台亞,56,24,32,合庫-台中,2023-09-06,1021
1802,台玻,41,11,30,合庫-台中,2023-09-06,1021
2401,凌陽,46,16,30,合庫-台中,2023-09-06,1021
1471,首利,29,1,28,合庫-台中,2023-09-06,1021
2801,彰銀,27,0,27,合庫-台中,2023-09-06,1021
2886,兆豐金,29,2,27,合庫-台中,2023-09-06,1021
00915,凱基優選高股息30,33,7,26,合庫-台中,2023-09-06,1021
6274,台燿,84,58,26,合庫-台中,2023-09-06,1021
2883,凱基金,77,52,25,合庫-台中,2023-09-06,1021
00896,中信綠能及電動車,23,0,23,合庫-台中,2023-09-06,1021
2913,農林,22,0,22,合庫-台中,2023-09-06,1021
8150,南茂,22,1,21,合庫-台中,2023-09-06,1021
2002,中鋼,22,1,21,合庫-台中,2023-09-06,1021
3576,聯合再生,21,0,21,合庫-台中,2023-09-06,1021
2601,益航,20,0,20,合庫-台中,2023-09-06,1021
3523,迎輝,20,0,20,合庫-台中,2023-09-06,1021
3056,富華新,20,0,20,合庫-台中,2023-09-06,1021
9105,泰金寶-DR,20,0,20,合庫-台中,2023-09-06,1021
2884,玉山金,20,1,19,合庫-台中,2023-09-06,1021
1342,八貫,20,1,19,合庫-台中,2023-09-06,1021
8110,華東,23,4,19,合庫-台中,2023-09-06,1021
5381,合正,119,100,19,合庫-台中,2023-09-06,1021
3596,智易,21,3,18,合庫-台中,2023-09-06,1021
1216,統一,18,0,18,合庫-台中,2023-09-06,1021
3499,環天科,18,0,18,合庫-台中,2023-09-06,1021
00679B,元大美債20年,20,2,18,合庫-台中,2023-09-06,1021
00931B,統一美債20年,24,7,17,合庫-台中,2023-09-06,1021
3013,晟銘電,34,17,17,合庫-台中,2023-09-06,1021
2376,技嘉,51,35,16,合庫-台中,2023-09-06,1021
00929,復華台灣科技優息,924,254,670,合庫-台中,2023-09-07,1021
00919,群益台灣精選高息,344,11,333,合庫-台中,2023-09-07,1021
3481,群創,170,5,165,合庫-台中,2023-09-07,1021
00665L,富邦�琤肭磪囓�2,184,19,165,合庫-台中,2023-09-07,1021
2897,王道銀行,130,0,130,合庫-台中,2023-09-07,1021
6108,競國,69,0,69,合庫-台中,2023-09-07,1021
00715L,期街口布蘭特正2,91,23,68,合庫-台中,2023-09-07,1021
00751B,元大AAA至A公司債,66,0,66,合庫-台中,2023-09-07,1021
00918,大華優利高填息30,62,0,62,合庫-台中,2023-09-07,1021
5880,合庫金,70,9,61,合庫-台中,2023-09-07,1021
4533,協易機,83,29,54,合庫-台中,2023-09-07,1021
00670L,富邦NASDAQ正2,50,1,49,合庫-台中,2023-09-07,1021
00632R,元大台灣50反1,260,212,48,合庫-台中,2023-09-07,1021
2316,楠梓電,70,22,48,合庫-台中,2023-09-07,1021
00882,中信中國高股息,42,0,42,合庫-台中,2023-09-07,1021
2419,仲琦,54,13,41,合庫-台中,2023-09-07,1021
2601,益航,61,20,41,合庫-台中,2023-09-07,1021
2374,佳能,40,0,40,合庫-台中,2023-09-07,1021
2313,華通,143,104,39,合庫-台中,2023-09-07,1021
8112,至上,68,29,39,合庫-台中,2023-09-07,1021
00915,凱基優選高股息30,42,5,37,合庫-台中,2023-09-07,1021
2884,玉山金,42,5,37,合庫-台中,2023-09-07,1021
00902,中信電池及儲能,35,0,35,合庫-台中,2023-09-07,1021
2002,中鋼,34,0,34,合庫-台中,2023-09-07,1021
2880,華南金,33,0,33,合庫-台中,2023-09-07,1021
1795,美時,30,1,29,合庫-台中,2023-09-07,1021
2323,中環,73,44,29,合庫-台中,2023-09-07,1021
3715,定穎投控,70,41,29,合庫-台中,2023-09-07,1021
2330,台積電,29,1,28,合庫-台中,2023-09-07,1021
2356,英業達,47,19,28,合庫-台中,2023-09-07,1021
3567,逸昌,34,7,27,合庫-台中,2023-09-07,1021
3231,緯創,77,50,27,合庫-台中,2023-09-07,1021
00932,兆豐永續高息等權,27,1,26,合庫-台中,2023-09-07,1021
2303,聯電,29,4,25,合庫-台中,2023-09-07,1021
00930,永豐ESG低碳高息,50,25,25,合庫-台中,2023-09-07,1021
4916,事欣科,25,0,25,合庫-台中,2023-09-07,1021
3548,兆利,24,1,23,合庫-台中,2023-09-07,1021
3450,聯鈞,27,4,23,合庫-台中,2023-09-07,1021
5381,合正,43,21,22,合庫-台中,2023-09-07,1021
2208,台船,22,0,22,合庫-台中,2023-09-07,1021
1314,中石化,22,0,22,合庫-台中,2023-09-07,1021
2630,亞航,28,7,21,合庫-台中,2023-09-07,1021
8927,北基,21,0,21,合庫-台中,2023-09-07,1021
2390,云辰,25,4,21,合庫-台中,2023-09-07,1021
1101,台泥,22,1,21,合庫-台中,2023-09-07,1021
3576,聯合再生,20,0,20,合庫-台中,2023-09-07,1021
2353,宏��,31,11,20,合庫-台中,2023-09-07,1021
1815,富喬,20,0,20,合庫-台中,2023-09-07,1021
3011,今皓,20,0,20,合庫-台中,2023-09-07,1021
2401,凌陽,36,18,18,合庫-台中,2023-09-07,1021
00929,復華台灣科技優息,438,144,294,合庫-台中,2023-09-08,1021
00919,群益台灣精選高息,367,82,285,合庫-台中,2023-09-08,1021
00632R,元大台灣50反1,137,10,127,合庫-台中,2023-09-08,1021
00931B,統一美債20年,114,1,113,合庫-台中,2023-09-08,1021
6282,康舒,157,64,93,合庫-台中,2023-09-08,1021
5381,合正,114,35,79,合庫-台中,2023-09-08,1021
2344,華邦電,87,10,77,合庫-台中,2023-09-08,1021
00651R,復華香港反1,75,0,75,合庫-台中,2023-09-08,1021
00918,大華優利高填息30,73,0,73,合庫-台中,2023-09-08,1021
2618,長榮航,78,8,70,合庫-台中,2023-09-08,1021
2601,益航,70,0,70,合庫-台中,2023-09-08,1021
4934,太極,66,2,64,合庫-台中,2023-09-08,1021
2002,中鋼,63,0,63,合庫-台中,2023-09-08,1021
9105,泰金寶-DR,131,70,61,合庫-台中,2023-09-08,1021
2890,永豐金,60,1,59,合庫-台中,2023-09-08,1021
4167,松瑞藥,55,0,55,合庫-台中,2023-09-08,1021
2630,亞航,105,54,51,合庫-台中,2023-09-08,1021
2382,廣達,109,59,50,合庫-台中,2023-09-08,1021
1314,中石化,109,60,49,合庫-台中,2023-09-08,1021
5880,合庫金,66,20,46,合庫-台中,2023-09-08,1021
3481,群創,47,4,43,合庫-台中,2023-09-08,1021
6108,競國,40,0,40,合庫-台中,2023-09-08,1021
00655L,國泰中國A50正2,35,0,35,合庫-台中,2023-09-08,1021
00882,中信中國高股息,34,0,34,合庫-台中,2023-09-08,1021
2409,友達,57,23,34,合庫-台中,2023-09-08,1021
00878,國泰永續高股息,47,15,32,合庫-台中,2023-09-08,1021
00915,凱基優選高股息30,32,1,31,合庫-台中,2023-09-08,1021
2324,仁寶,42,12,30,合庫-台中,2023-09-08,1021
2515,中工,40,10,30,合庫-台中,2023-09-08,1021
2338,光罩,30,0,30,合庫-台中,2023-09-08,1021
3523,迎輝,30,0,30,合庫-台中,2023-09-08,1021
00902,中信電池及儲能,30,0,30,合庫-台中,2023-09-08,1021
3046,建��,65,36,29,合庫-台中,2023-09-08,1021
1447,力鵬,28,0,28,合庫-台中,2023-09-08,1021
2614,東森,43,16,27,合庫-台中,2023-09-08,1021
1714,和桐,22,0,22,合庫-台中,2023-09-08,1021
4106,雃博,21,0,21,合庫-台中,2023-09-08,1021
00932,兆豐永續高息等權,21,0,21,合庫-台中,2023-09-08,1021
2486,一詮,26,5,21,合庫-台中,2023-09-08,1021
3576,聯合再生,20,0,20,合庫-台中,2023-09-08,1021
00664R,國泰臺灣加權反1,20,0,20,合庫-台中,2023-09-08,1021
6609,瀧澤科,20,0,20,合庫-台中,2023-09-08,1021
6182,合晶,21,2,19,合庫-台中,2023-09-08,1021
1618,合機,32,15,17,合庫-台中,2023-09-08,1021
2376,技嘉,93,76,17,合庫-台中,2023-09-08,1021
3588,通嘉,17,1,16,合庫-台中,2023-09-08,1021
2353,宏��,18,2,16,合庫-台中,2023-09-08,1021
2636,台驊控股,15,0,15,合庫-台中,2023-09-08,1021
2329,華泰,27,13,14,合庫-台中,2023-09-08,1021
2482,連宇,23,8,15,合庫-台中,2023-09-08,1021
00919,群益台灣精選高息,434,6,428,合庫-台中,2023-09-11,1021
00878,國泰永續高股息,239,53,186,合庫-台中,2023-09-11,1021
2888,新光金,137,20,117,合庫-台中,2023-09-11,1021
00918,大華優利高填息30,103,2,101,合庫-台中,2023-09-11,1021
2002,中鋼,101,1,100,合庫-台中,2023-09-11,1021
911868,同方友友-DR,89,0,89,合庫-台中,2023-09-11,1021
00931B,統一美債20年,90,5,85,合庫-台中,2023-09-11,1021
00665L,富邦�琤肭磪囓�2,99,20,79,合庫-台中,2023-09-11,1021
3481,群創,101,26,75,合庫-台中,2023-09-11,1021
9105,泰金寶-DR,67,0,67,合庫-台中,2023-09-11,1021
00673R,期元大S＆P原油反1,63,0,63,合庫-台中,2023-09-11,1021
3163,波若威,57,5,52,合庫-台中,2023-09-11,1021
0056,元大高股息,94,42,52,合庫-台中,2023-09-11,1021
2363,矽統,303,253,50,合庫-台中,2023-09-11,1021
00915,凱基優選高股息30,50,1,49,合庫-台中,2023-09-11,1021
00751B,元大AAA至A公司債,45,0,45,合庫-台中,2023-09-11,1021
1310,台苯,56,11,45,合庫-台中,2023-09-11,1021
1618,合機,62,17,45,合庫-台中,2023-09-11,1021
6282,康舒,72,27,45,合庫-台中,2023-09-11,1021
2337,旺宏,59,14,45,合庫-台中,2023-09-11,1021
00679B,元大美債20年,43,1,42,合庫-台中,2023-09-11,1021
2356,英業達,91,52,39,合庫-台中,2023-09-11,1021
00882,中信中國高股息,38,0,38,合庫-台中,2023-09-11,1021
2610,華航,37,1,36,合庫-台中,2023-09-11,1021
6214,精誠,39,4,35,合庫-台中,2023-09-11,1021
1609,大亞,47,13,34,合庫-台中,2023-09-11,1021
2323,中環,37,5,32,合庫-台中,2023-09-11,1021
2618,長榮航,74,42,32,合庫-台中,2023-09-11,1021
2630,亞航,234,202,32,合庫-台中,2023-09-11,1021
3025,星通,31,0,31,合庫-台中,2023-09-11,1021
1540,喬福,34,5,29,合庫-台中,2023-09-11,1021
2352,佳世達,135,107,28,合庫-台中,2023-09-11,1021
1802,台玻,37,10,27,合庫-台中,2023-09-11,1021
1504,東元,37,13,24,合庫-台中,2023-09-11,1021
00900,富邦特選高股息30,30,6,24,合庫-台中,2023-09-11,1021
3523,迎輝,23,0,23,合庫-台中,2023-09-11,1021
2329,華泰,40,18,22,合庫-台中,2023-09-11,1021
2601,益航,21,0,21,合庫-台中,2023-09-11,1021
2886,兆豐金,41,22,19,合庫-台中,2023-09-11,1021
2614,東森,20,1,19,合庫-台中,2023-09-11,1021
00713,元大台灣高息低波,22,5,17,合庫-台中,2023-09-11,1021
1342,八貫,17,0,17,合庫-台中,2023-09-11,1021
6829,千附精密,43,26,17,合庫-台中,2023-09-11,1021
00932,兆豐永續高息等權,18,1,17,合庫-台中,2023-09-11,1021
2376,技嘉,94,77,17,合庫-台中,2023-09-11,1021
00923,群益台ESG低碳50,17,0,17,合庫-台中,2023-09-11,1021
6236,中湛,16,0,16,合庫-台中,2023-09-11,1021
8222,寶一,20,4,16,合庫-台中,2023-09-11,1021
6515,穎崴,15,0,15,合庫-台中,2023-09-11,1021
8171,天宇,15,0,15,合庫-台中,2023-09-11,1021
2538,基泰,282,6,276,合庫-台中,2023-09-12,1021
00919,群益台灣精選高息,173,6,167,合庫-台中,2023-09-12,1021
6120,達運,155,25,130,合庫-台中,2023-09-12,1021
5381,合正,107,20,87,合庫-台中,2023-09-12,1021
00929,復華台灣科技優息,258,171,87,合庫-台中,2023-09-12,1021
2409,友達,107,46,61,合庫-台中,2023-09-12,1021
2884,玉山金,58,0,58,合庫-台中,2023-09-12,1021
00673R,期元大S＆P原油反1,51,0,51,合庫-台中,2023-09-12,1021
2241,艾姆勒,47,0,47,合庫-台中,2023-09-12,1021
2382,廣達,55,11,44,合庫-台中,2023-09-12,1021
2313,華通,148,106,42,合庫-台中,2023-09-12,1021
00915,凱基優選高股息30,41,0,41,合庫-台中,2023-09-12,1021
2890,永豐金,50,10,40,合庫-台中,2023-09-12,1021
8176,智捷,40,0,40,合庫-台中,2023-09-12,1021
3264,欣銓,53,17,36,合庫-台中,2023-09-12,1021
00751B,元大AAA至A公司債,34,0,34,合庫-台中,2023-09-12,1021
8016,矽創,34,0,34,合庫-台中,2023-09-12,1021
2002,中鋼,30,1,29,合庫-台中,2023-09-12,1021
00679B,元大美債20年,29,1,28,合庫-台中,2023-09-12,1021
3189,景碩,31,4,27,合庫-台中,2023-09-12,1021
3715,定穎投控,29,3,26,合庫-台中,2023-09-12,1021
3523,迎輝,25,0,25,合庫-台中,2023-09-12,1021
2355,敬鵬,33,8,25,合庫-台中,2023-09-12,1021
00918,大華優利高填息30,24,0,24,合庫-台中,2023-09-12,1021
00931B,統一美債20年,23,0,23,合庫-台中,2023-09-12,1021
2816,旺旺保,22,0,22,合庫-台中,2023-09-12,1021
3046,建��,50,28,22,合庫-台中,2023-09-12,1021
1609,大亞,27,5,22,合庫-台中,2023-09-12,1021
2634,漢翔,31,10,21,合庫-台中,2023-09-12,1021
00632R,元大台灣50反1,20,0,20,合庫-台中,2023-09-12,1021
00902,中信電池及儲能,88,69,19,合庫-台中,2023-09-12,1021
9105,泰金寶-DR,20,1,19,合庫-台中,2023-09-12,1021
1605,華新,21,2,19,合庫-台中,2023-09-12,1021
00882,中信中國高股息,26,8,18,合庫-台中,2023-09-12,1021
2330,台積電,26,9,17,合庫-台中,2023-09-12,1021
2645,長榮航太,19,2,17,合庫-台中,2023-09-12,1021
2516,新建,17,0,17,合庫-台中,2023-09-12,1021
3704,合勤控,47,31,16,合庫-台中,2023-09-12,1021
2457,飛宏,40,25,15,合庫-台中,2023-09-12,1021
2356,英業達,31,17,14,合庫-台中,2023-09-12,1021
1528,恩德,14,0,14,合庫-台中,2023-09-12,1021
2405,輔信,77,63,14,合庫-台中,2023-09-12,1021
3276,宇環,16,3,13,合庫-台中,2023-09-12,1021
2358,廷鑫,14,1,13,合庫-台中,2023-09-12,1021
3693,營邦,61,49,12,合庫-台中,2023-09-12,1021
2542,興富發,12,0,12,合庫-台中,2023-09-12,1021
00900,富邦特選高股息30,20,8,12,合庫-台中,2023-09-12,1021
8358,金居,29,17,12,合庫-台中,2023-09-12,1021
2323,中環,11,0,11,合庫-台中,2023-09-12,1021
4542,科嶠,12,2,10,合庫-台中,2023-09-12,1021
00929,復華台灣科技優息,489,183,306,合庫-台中,2023-09-13,1021
6282,康舒,280,66,214,合庫-台中,2023-09-13,1021
00919,群益台灣精選高息,188,11,177,合庫-台中,2023-09-13,1021
2105,正新,162,29,133,合庫-台中,2023-09-13,1021
00902,中信電池及儲能,145,60,85,合庫-台中,2023-09-13,1021
00665L,富邦�琤肭磪囓�2,75,0,75,合庫-台中,2023-09-13,1021
00715L,期街口布蘭特正2,74,0,74,合庫-台中,2023-09-13,1021
1312,國喬,60,4,56,合庫-台中,2023-09-13,1021
1471,首利,56,9,47,合庫-台中,2023-09-13,1021
3380,明泰,46,1,45,合庫-台中,2023-09-13,1021
2409,友達,62,20,42,合庫-台中,2023-09-13,1021
6419,京晨科,40,0,40,合庫-台中,2023-09-13,1021
1101,台泥,44,11,33,合庫-台中,2023-09-13,1021
9105,泰金寶-DR,30,0,30,合庫-台中,2023-09-13,1021
00655L,國泰中國A50正2,29,0,29,合庫-台中,2023-09-13,1021
2743,山富,28,2,26,合庫-台中,2023-09-13,1021
2312,金寶,27,2,25,合庫-台中,2023-09-13,1021
2382,廣達,34,9,25,合庫-台中,2023-09-13,1021
2317,鴻海,24,1,23,合庫-台中,2023-09-13,1021
2538,基泰,109,86,23,合庫-台中,2023-09-13,1021
4542,科嶠,23,0,23,合庫-台中,2023-09-13,1021
3523,迎輝,22,0,22,合庫-台中,2023-09-13,1021
2030,彰源,22,0,22,合庫-台中,2023-09-13,1021
2340,台亞,36,14,22,合庫-台中,2023-09-13,1021
2888,新光金,22,1,21,合庫-台中,2023-09-13,1021
3481,群創,41,21,20,合庫-台中,2023-09-13,1021
00679B,元大美債20年,22,1,21,合庫-台中,2023-09-13,1021
00688L,國泰20年美債正2,20,0,20,合庫-台中,2023-09-13,1021
8215,明基材,20,0,20,合庫-台中,2023-09-13,1021
2634,漢翔,27,8,19,合庫-台中,2023-09-13,1021
2929,淘帝-KY,22,4,18,合庫-台中,2023-09-13,1021
1218,泰山,20,2,18,合庫-台中,2023-09-13,1021
00753L,中信中國50正2,28,10,18,合庫-台中,2023-09-13,1021
5215,科嘉-KY,20,2,18,合庫-台中,2023-09-13,1021
00632R,元大台灣50反1,48,33,15,合庫-台中,2023-09-13,1021
1618,合機,26,11,15,合庫-台中,2023-09-13,1021
00882,中信中國高股息,27,12,15,合庫-台中,2023-09-13,1021
2356,英業達,41,27,14,合庫-台中,2023-09-13,1021
00918,大華優利高填息30,14,0,14,合庫-台中,2023-09-13,1021
1609,大亞,17,3,14,合庫-台中,2023-09-13,1021
2338,光罩,14,0,14,合庫-台中,2023-09-13,1021
9907,統一實,21,7,14,合庫-台中,2023-09-13,1021
2353,宏��,20,7,13,合庫-台中,2023-09-13,1021
911608,明輝-DR,13,0,13,合庫-台中,2023-09-13,1021
6550,北極星藥業-KY,13,0,13,合庫-台中,2023-09-13,1021
2002,中鋼,13,0,13,合庫-台中,2023-09-13,1021
3711,日月光投控,12,0,12,合庫-台中,2023-09-13,1021
3231,緯創,44,32,12,合庫-台中,2023-09-13,1021
00673R,期元大S＆P原油反1,11,0,11,合庫-台中,2023-09-13,1021
6168,宏齊,11,0,11,合庫-台中,2023-09-13,1021
00919,群益台灣精選高息,195,43,152,合庫-台中,2023-09-14,1021
00715L,期街口布蘭特正2,135,0,135,合庫-台中,2023-09-14,1021
5206,坤悅,134,0,134,合庫-台中,2023-09-14,1021
00929,復華台灣科技優息,570,445,125,合庫-台中,2023-09-14,1021
2610,華航,318,222,96,合庫-台中,2023-09-14,1021
00673R,期元大S＆P原油反1,104,8,96,合庫-台中,2023-09-14,1021
00753L,中信中國50正2,106,11,95,合庫-台中,2023-09-14,1021
6419,京晨科,59,0,59,合庫-台中,2023-09-14,1021
00632R,元大台灣50反1,134,90,44,合庫-台中,2023-09-14,1021
00665L,富邦�琤肭磪囓�2,46,6,40,合庫-台中,2023-09-14,1021
1409,新纖,35,0,35,合庫-台中,2023-09-14,1021
00772B,中信高評級公司債,35,0,35,合庫-台中,2023-09-14,1021
2106,建大,35,0,35,合庫-台中,2023-09-14,1021
00722B,群益投資級電信債,32,2,30,合庫-台中,2023-09-14,1021
2371,大同,47,21,26,合庫-台中,2023-09-14,1021
4542,科嶠,25,0,25,合庫-台中,2023-09-14,1021
00679B,元大美債20年,21,0,21,合庫-台中,2023-09-14,1021
2402,毅嘉,27,6,21,合庫-台中,2023-09-14,1021
3693,營邦,52,31,21,合庫-台中,2023-09-14,1021
3523,迎輝,20,0,20,合庫-台中,2023-09-14,1021
9105,泰金寶-DR,20,0,20,合庫-台中,2023-09-14,1021
2409,友達,26,7,19,合庫-台中,2023-09-14,1021
6547,高端疫苗,23,5,18,合庫-台中,2023-09-14,1021
2485,兆赫,31,14,17,合庫-台中,2023-09-14,1021
2885,元大金,26,9,17,合庫-台中,2023-09-14,1021
00882,中信中國高股息,19,3,16,合庫-台中,2023-09-14,1021
3264,欣銓,21,5,16,合庫-台中,2023-09-14,1021
3682,亞太電,16,0,16,合庫-台中,2023-09-14,1021
1714,和桐,17,2,15,合庫-台中,2023-09-14,1021
4551,智伸科,15,0,15,合庫-台中,2023-09-14,1021
5210,寶碩,28,14,14,合庫-台中,2023-09-14,1021
6231,系微,22,9,13,合庫-台中,2023-09-14,1021
6288,聯嘉,18,5,13,合庫-台中,2023-09-14,1021
2605,新興,49,36,13,合庫-台中,2023-09-14,1021
8150,南茂,16,4,12,合庫-台中,2023-09-14,1021
2801,彰銀,12,1,11,合庫-台中,2023-09-14,1021
2634,漢翔,43,33,10,合庫-台中,2023-09-14,1021
2027,大成鋼,10,0,10,合庫-台中,2023-09-14,1021
00902,中信電池及儲能,10,0,10,合庫-台中,2023-09-14,1021
2374,佳能,11,1,10,合庫-台中,2023-09-14,1021
1301,台塑,10,0,10,合庫-台中,2023-09-14,1021
2929,淘帝-KY,10,0,10,合庫-台中,2023-09-14,1021
00927,群益半導體收益,16,6,10,合庫-台中,2023-09-14,1021
6236,中湛,10,0,10,合庫-台中,2023-09-14,1021
2002,中鋼,20,10,10,合庫-台中,2023-09-14,1021
3213,茂訊,10,0,10,合庫-台中,2023-09-14,1021
2890,永豐金,10,0,10,合庫-台中,2023-09-14,1021
2889,國票金,14,5,9,合庫-台中,2023-09-14,1021
6550,北極星藥業-KY,9,0,9,合庫-台中,2023-09-14,1021
4906,正文,26,17,9,合庫-台中,2023-09-14,1021
00929,復華台灣科技優息,670,81,589,合庫-台中,2023-09-15,1021
00919,群益台灣精選高息,392,80,312,合庫-台中,2023-09-15,1021
2633,台灣高鐵,307,2,305,合庫-台中,2023-09-15,1021
1316,上曜,135,0,135,合庫-台中,2023-09-15,1021
2486,一詮,211,83,128,合庫-台中,2023-09-15,1021
00900,富邦特選高股息30,100,15,85,合庫-台中,2023-09-15,1021
2641,正德,179,103,76,合庫-台中,2023-09-15,1021
2634,漢翔,85,12,73,合庫-台中,2023-09-15,1021
00751B,元大AAA至A公司債,65,0,65,合庫-台中,2023-09-15,1021
2002,中鋼,76,12,64,合庫-台中,2023-09-15,1021
00632R,元大台灣50反1,62,0,62,合庫-台中,2023-09-15,1021
4916,事欣科,62,0,62,合庫-台中,2023-09-15,1021
2838,聯邦銀,60,0,60,合庫-台中,2023-09-15,1021
00772B,中信高評級公司債,56,0,56,合庫-台中,2023-09-15,1021
3231,緯創,67,23,44,合庫-台中,2023-09-15,1021
1605,華新,73,30,43,合庫-台中,2023-09-15,1021
1714,和桐,40,0,40,合庫-台中,2023-09-15,1021
1305,華夏,42,2,40,合庫-台中,2023-09-15,1021
2356,英業達,61,22,39,合庫-台中,2023-09-15,1021
00918,大華優利高填息30,40,2,38,合庫-台中,2023-09-15,1021
00679B,元大美債20年,44,7,37,合庫-台中,2023-09-15,1021
3523,迎輝,36,0,36,合庫-台中,2023-09-15,1021
3035,智原,59,24,35,合庫-台中,2023-09-15,1021
00655L,國泰中國A50正2,35,0,35,合庫-台中,2023-09-15,1021
9105,泰金寶-DR,32,0,32,合庫-台中,2023-09-15,1021
3025,星通,32,1,31,合庫-台中,2023-09-15,1021
2891,中信金,34,8,26,合庫-台中,2023-09-15,1021
8054,安國,25,0,25,合庫-台中,2023-09-15,1021
5371,中光電,33,10,23,合庫-台中,2023-09-15,1021
2892,第一金,23,1,22,合庫-台中,2023-09-15,1021
2313,華通,164,143,21,合庫-台中,2023-09-15,1021
3715,定穎投控,100,79,21,合庫-台中,2023-09-15,1021
2374,佳能,20,0,20,合庫-台中,2023-09-15,1021
8215,明基材,20,0,20,合庫-台中,2023-09-15,1021
5521,工信,20,0,20,合庫-台中,2023-09-15,1021
00915,凱基優選高股息30,24,5,19,合庫-台中,2023-09-15,1021
2615,萬海,31,13,18,合庫-台中,2023-09-15,1021
9904,寶成,17,0,17,合庫-台中,2023-09-15,1021
4541,晟田,17,0,17,合庫-台中,2023-09-15,1021
1515,力山,28,11,17,合庫-台中,2023-09-15,1021
2371,大同,37,21,16,合庫-台中,2023-09-15,1021
3078,僑威,20,5,15,合庫-台中,2023-09-15,1021
4906,正文,23,8,15,合庫-台中,2023-09-15,1021
1802,台玻,15,0,15,合庫-台中,2023-09-15,1021
00687B,國泰20年美債,15,0,15,合庫-台中,2023-09-15,1021
3081,聯亞,18,3,15,合庫-台中,2023-09-15,1021
2025,千興,13,0,13,合庫-台中,2023-09-15,1021
2812,台中銀,31,18,13,合庫-台中,2023-09-15,1021
8069,元太,13,1,12,合庫-台中,2023-09-15,1021
6547,高端疫苗,13,1,12,合庫-台中,2023-09-15,1021
2363,矽統,509,239,270,合庫-台中,2023-09-18,1021
00715L,期街口布蘭特正2,210,7,203,合庫-台中,2023-09-18,1021
1316,上曜,200,0,200,合庫-台中,2023-09-18,1021
00751B,元大AAA至A公司債,193,0,193,合庫-台中,2023-09-18,1021
5880,合庫金,191,17,174,合庫-台中,2023-09-18,1021
00679B,元大美債20年,158,1,157,合庫-台中,2023-09-18,1021
00670L,富邦NASDAQ正2,112,0,112,合庫-台中,2023-09-18,1021
2605,新興,133,36,97,合庫-台中,2023-09-18,1021
2356,英業達,119,28,91,合庫-台中,2023-09-18,1021
00650L,復華香港正2,91,0,91,合庫-台中,2023-09-18,1021
00665L,富邦�琤肭磪囓�2,115,24,91,合庫-台中,2023-09-18,1021
00878,國泰永續高股息,107,19,88,合庫-台中,2023-09-18,1021
2382,廣達,70,11,59,合庫-台中,2023-09-18,1021
00772B,中信高評級公司債,55,0,55,合庫-台中,2023-09-18,1021
3523,迎輝,48,0,48,合庫-台中,2023-09-18,1021
6282,康舒,137,91,46,合庫-台中,2023-09-18,1021
3276,宇環,54,9,45,合庫-台中,2023-09-18,1021
2609,陽明,101,56,45,合庫-台中,2023-09-18,1021
2344,華邦電,64,21,43,合庫-台中,2023-09-18,1021
2303,聯電,55,13,42,合庫-台中,2023-09-18,1021
00885,富邦越南,35,0,35,合庫-台中,2023-09-18,1021
1909,榮成,40,5,35,合庫-台中,2023-09-18,1021
00919,群益台灣精選高息,375,340,35,合庫-台中,2023-09-18,1021
2330,台積電,34,1,33,合庫-台中,2023-09-18,1021
00931B,統一美債20年,33,0,33,合庫-台中,2023-09-18,1021
2388,威盛,134,101,33,合庫-台中,2023-09-18,1021
3231,緯創,101,69,32,合庫-台中,2023-09-18,1021
00882,中信中國高股息,31,0,31,合庫-台中,2023-09-18,1021
1808,潤隆,31,0,31,合庫-台中,2023-09-18,1021
3481,群創,72,43,29,合庫-台中,2023-09-18,1021
0056,元大高股息,39,11,28,合庫-台中,2023-09-18,1021
1522,堤維西,40,12,28,合庫-台中,2023-09-18,1021
6419,京晨科,26,0,26,合庫-台中,2023-09-18,1021
2516,新建,26,0,26,合庫-台中,2023-09-18,1021
2027,大成鋼,38,13,25,合庫-台中,2023-09-18,1021
2495,普安,25,0,25,合庫-台中,2023-09-18,1021
2601,益航,43,20,23,合庫-台中,2023-09-18,1021
00923,群益台ESG低碳50,22,0,22,合庫-台中,2023-09-18,1021
2812,台中銀,57,37,20,合庫-台中,2023-09-18,1021
2886,兆豐金,25,5,20,合庫-台中,2023-09-18,1021
00687B,國泰20年美債,20,0,20,合庫-台中,2023-09-18,1021
2316,楠梓電,22,2,20,合庫-台中,2023-09-18,1021
6443,元晶,20,0,20,合庫-台中,2023-09-18,1021
2538,基泰,24,4,20,合庫-台中,2023-09-18,1021
2882,國泰金,21,1,20,合庫-台中,2023-09-18,1021
2317,鴻海,34,15,19,合庫-台中,2023-09-18,1021
2838,聯邦銀,19,0,19,合庫-台中,2023-09-18,1021
00720B,元大投資級公司債,19,0,19,合庫-台中,2023-09-18,1021
00632R,元大台灣50反1,23,5,18,合庫-台中,2023-09-18,1021
3037,欣興,18,1,17,合庫-台中,2023-09-18,1021
00929,復華台灣科技優息,441,65,376,合庫-台中,2023-09-19,1021
2605,新興,195,77,118,合庫-台中,2023-09-19,1021
00919,群益台灣精選高息,271,154,117,合庫-台中,2023-09-19,1021
2337,旺宏,101,1,100,合庫-台中,2023-09-19,1021
3276,宇環,101,25,76,合庫-台中,2023-09-19,1021
2409,友達,75,14,61,合庫-台中,2023-09-19,1021
00650L,復華香港正2,60,0,60,合庫-台中,2023-09-19,1021
2330,台積電,61,2,59,合庫-台中,2023-09-19,1021
3163,波若威,77,23,54,合庫-台中,2023-09-19,1021
3523,迎輝,46,0,46,合庫-台中,2023-09-19,1021
00931B,統一美債20年,47,2,45,合庫-台中,2023-09-19,1021
1471,首利,50,6,44,合庫-台中,2023-09-19,1021
3231,緯創,95,51,44,合庫-台中,2023-09-19,1021
00921,兆豐龍頭等權重,43,0,43,合庫-台中,2023-09-19,1021
2618,長榮航,49,7,42,合庫-台中,2023-09-19,1021
6901,鑽石投資,57,17,40,合庫-台中,2023-09-19,1021
2887,台新金,33,0,33,合庫-台中,2023-09-19,1021
4542,科嶠,35,2,33,合庫-台中,2023-09-19,1021
8086,宏捷科,35,3,32,合庫-台中,2023-09-19,1021
5608,四維航,56,25,31,合庫-台中,2023-09-19,1021
00655L,國泰中國A50正2,30,0,30,合庫-台中,2023-09-19,1021
2312,金寶,33,3,30,合庫-台中,2023-09-19,1021
00665L,富邦�琤肭磪囓�2,29,0,29,合庫-台中,2023-09-19,1021
2331,精英,28,0,28,合庫-台中,2023-09-19,1021
00712,復華富時不動產,27,0,27,合庫-台中,2023-09-19,1021
2606,裕民,38,11,27,合庫-台中,2023-09-19,1021
2002,中鋼,28,2,26,合庫-台中,2023-09-19,1021
2376,技嘉,48,22,26,合庫-台中,2023-09-19,1021
4979,華星光,64,39,25,合庫-台中,2023-09-19,1021
9105,泰金寶-DR,25,0,25,合庫-台中,2023-09-19,1021
00915,凱基優選高股息30,25,0,25,合庫-台中,2023-09-19,1021
6235,華孚,24,0,24,合庫-台中,2023-09-19,1021
2601,益航,30,7,23,合庫-台中,2023-09-19,1021
4916,事欣科,31,8,23,合庫-台中,2023-09-19,1021
6274,台燿,33,11,22,合庫-台中,2023-09-19,1021
2492,華新科,27,6,21,合庫-台中,2023-09-19,1021
2388,威盛,142,121,21,合庫-台中,2023-09-19,1021
0056,元大高股息,43,22,21,合庫-台中,2023-09-19,1021
3035,智原,59,40,19,合庫-台中,2023-09-19,1021
2610,華航,26,7,19,合庫-台中,2023-09-19,1021
00902,中信電池及儲能,19,0,19,合庫-台中,2023-09-19,1021
3531,先益,19,1,18,合庫-台中,2023-09-19,1021
5880,合庫金,23,5,18,合庫-台中,2023-09-19,1021
6550,北極星藥業-KY,19,2,17,合庫-台中,2023-09-19,1021
2425,承啟,67,51,16,合庫-台中,2023-09-19,1021
2419,仲琦,17,1,16,合庫-台中,2023-09-19,1021
5284,jpp-KY,15,0,15,合庫-台中,2023-09-19,1021
1303,南亞,16,1,15,合庫-台中,2023-09-19,1021
1101,台泥,20,5,15,合庫-台中,2023-09-19,1021
3545,敦泰,44,30,14,合庫-台中,2023-09-19,1021
00929,復華台灣科技優息,813,366,447,合庫-台中,2023-09-20,1021
00919,群益台灣精選高息,315,113,202,合庫-台中,2023-09-20,1021
00715L,期街口布蘭特正2,165,3,162,合庫-台中,2023-09-20,1021
2605,新興,227,75,152,合庫-台中,2023-09-20,1021
2888,新光金,110,0,110,合庫-台中,2023-09-20,1021
2603,長榮,106,3,103,合庫-台中,2023-09-20,1021
00932,兆豐永續高息等權,103,2,101,合庫-台中,2023-09-20,1021
2014,中鴻,104,4,100,合庫-台中,2023-09-20,1021
2367,燿華,118,35,83,合庫-台中,2023-09-20,1021
2883,凱基金,72,5,67,合庫-台中,2023-09-20,1021
1909,榮成,60,0,60,合庫-台中,2023-09-20,1021
3481,群創,148,98,50,合庫-台中,2023-09-20,1021
3276,宇環,53,10,43,合庫-台中,2023-09-20,1021
2409,友達,55,12,43,合庫-台中,2023-09-20,1021
1605,華新,72,30,42,合庫-台中,2023-09-20,1021
00753L,中信中國50正2,52,10,42,合庫-台中,2023-09-20,1021
2330,台積電,36,2,34,合庫-台中,2023-09-20,1021
00921,兆豐龍頭等權重,65,32,33,合庫-台中,2023-09-20,1021
2303,聯電,33,2,31,合庫-台中,2023-09-20,1021
2312,金寶,36,5,31,合庫-台中,2023-09-20,1021
2201,裕隆,33,4,29,合庫-台中,2023-09-20,1021
00900,富邦特選高股息30,30,3,27,合庫-台中,2023-09-20,1021
2344,華邦電,60,35,25,合庫-台中,2023-09-20,1021
6153,嘉聯益,46,21,25,合庫-台中,2023-09-20,1021
2382,廣達,48,23,25,合庫-台中,2023-09-20,1021
5880,合庫金,38,14,24,合庫-台中,2023-09-20,1021
8088,品安,24,1,23,合庫-台中,2023-09-20,1021
2385,群光,26,3,23,合庫-台中,2023-09-20,1021
00679B,元大美債20年,23,0,23,合庫-台中,2023-09-20,1021
1101,台泥,22,0,22,合庫-台中,2023-09-20,1021
5608,四維航,104,82,22,合庫-台中,2023-09-20,1021
2618,長榮航,45,24,21,合庫-台中,2023-09-20,1021
1305,華夏,21,0,21,合庫-台中,2023-09-20,1021
3230,錦明,21,0,21,合庫-台中,2023-09-20,1021
3231,緯創,65,44,21,合庫-台中,2023-09-20,1021
2354,鴻準,21,1,20,合庫-台中,2023-09-20,1021
2867,三商壽,24,4,20,合庫-台中,2023-09-20,1021
2884,玉山金,20,1,19,合庫-台中,2023-09-20,1021
3037,欣興,27,9,18,合庫-台中,2023-09-20,1021
2002,中鋼,107,89,18,合庫-台中,2023-09-20,1021
2317,鴻海,21,3,18,合庫-台中,2023-09-20,1021
1319,東陽,54,37,17,合庫-台中,2023-09-20,1021
2634,漢翔,31,16,15,合庫-台中,2023-09-20,1021
9928,中視,16,1,15,合庫-台中,2023-09-20,1021
3011,今皓,20,5,15,合庫-台中,2023-09-20,1021
2486,一詮,52,37,15,合庫-台中,2023-09-20,1021
00772B,中信高評級公司債,14,0,14,合庫-台中,2023-09-20,1021
6285,啟��,75,61,14,合庫-台中,2023-09-20,1021
6257,矽格,27,13,14,合庫-台中,2023-09-20,1021
2352,佳世達,95,82,13,合庫-台中,2023-09-20,1021
00929,復華台灣科技優息,442,171,271,合庫-台中,2023-09-21,1021
2363,矽統,372,115,257,合庫-台中,2023-09-21,1021
00919,群益台灣精選高息,332,126,206,合庫-台中,2023-09-21,1021
5880,合庫金,203,0,203,合庫-台中,2023-09-21,1021
2897,王道銀行,124,0,124,合庫-台中,2023-09-21,1021
2838,聯邦銀,120,0,120,合庫-台中,2023-09-21,1021
2888,新光金,121,20,101,合庫-台中,2023-09-21,1021
2891,中信金,94,0,94,合庫-台中,2023-09-21,1021
00673R,期元大S＆P原油反1,105,14,91,合庫-台中,2023-09-21,1021
00878,國泰永續高股息,117,35,82,合庫-台中,2023-09-21,1021
2892,第一金,85,5,80,合庫-台中,2023-09-21,1021
6282,康舒,146,76,70,合庫-台中,2023-09-21,1021
2409,友達,80,15,65,合庫-台中,2023-09-21,1021
2880,華南金,64,0,64,合庫-台中,2023-09-21,1021
00753L,中信中國50正2,80,20,60,合庫-台中,2023-09-21,1021
00665L,富邦�琤肭磪囓�2,59,0,59,合庫-台中,2023-09-21,1021
2881,富邦金,60,1,59,合庫-台中,2023-09-21,1021
2883,凱基金,111,57,54,合庫-台中,2023-09-21,1021
2884,玉山金,60,13,47,合庫-台中,2023-09-21,1021
00907,永豐優息存股,47,0,47,合庫-台中,2023-09-21,1021
00932,兆豐永續高息等權,50,4,46,合庫-台中,2023-09-21,1021
2890,永豐金,60,15,45,合庫-台中,2023-09-21,1021
2330,台積電,44,4,40,合庫-台中,2023-09-21,1021
2618,長榮航,45,6,39,合庫-台中,2023-09-21,1021
00679B,元大美債20年,38,2,36,合庫-台中,2023-09-21,1021
2337,旺宏,37,2,35,合庫-台中,2023-09-21,1021
1714,和桐,35,0,35,合庫-台中,2023-09-21,1021
2317,鴻海,40,6,34,合庫-台中,2023-09-21,1021
2801,彰銀,35,1,34,合庫-台中,2023-09-21,1021
0050,元大台灣50,54,21,33,合庫-台中,2023-09-21,1021
00751B,元大AAA至A公司債,32,0,32,合庫-台中,2023-09-21,1021
00637L,元大滬深300正2,62,30,32,合庫-台中,2023-09-21,1021
1909,榮成,30,0,30,合庫-台中,2023-09-21,1021
0056,元大高股息,49,20,29,合庫-台中,2023-09-21,1021
00713,元大台灣高息低波,29,1,28,合庫-台中,2023-09-21,1021
00902,中信電池及儲能,32,5,27,合庫-台中,2023-09-21,1021
5206,坤悅,27,0,27,合庫-台中,2023-09-21,1021
2882,國泰金,29,4,25,合庫-台中,2023-09-21,1021
1216,統一,25,0,25,合庫-台中,2023-09-21,1021
00921,兆豐龍頭等權重,25,1,24,合庫-台中,2023-09-21,1021
2324,仁寶,23,0,23,合庫-台中,2023-09-21,1021
2208,台船,21,0,21,合庫-台中,2023-09-21,1021
2402,毅嘉,24,3,21,合庫-台中,2023-09-21,1021
2887,台新金,20,0,20,合庫-台中,2023-09-21,1021
3230,錦明,20,0,20,合庫-台中,2023-09-21,1021
1447,力鵬,30,10,20,合庫-台中,2023-09-21,1021
1316,上曜,19,0,19,合庫-台中,2023-09-21,1021
00922,國泰台灣領袖50,21,3,18,合庫-台中,2023-09-21,1021
3523,迎輝,18,0,18,合庫-台中,2023-09-21,1021
3704,合勤控,19,1,18,合庫-台中,2023-09-21,1021
2838,聯邦銀,229,0,229,合庫-台中,2023-09-22,1021
00679B,元大美債20年,148,12,136,合庫-台中,2023-09-22,1021
00919,群益台灣精選高息,243,116,127,合庫-台中,2023-09-22,1021
00673R,期元大S＆P原油反1,104,0,104,合庫-台中,2023-09-22,1021
3523,迎輝,95,0,95,合庫-台中,2023-09-22,1021
00712,復華富時不動產,94,1,93,合庫-台中,2023-09-22,1021
00751B,元大AAA至A公司債,75,0,75,合庫-台中,2023-09-22,1021
00680L,元大美債20正2,75,6,69,合庫-台中,2023-09-22,1021
3481,群創,111,44,67,合庫-台中,2023-09-22,1021
00888,永豐台灣ESG,62,0,62,合庫-台中,2023-09-22,1021
2421,建準,68,7,61,合庫-台中,2023-09-22,1021
2303,聯電,58,0,58,合庫-台中,2023-09-22,1021
1718,中纖,50,0,50,合庫-台中,2023-09-22,1021
2337,旺宏,53,11,42,合庫-台中,2023-09-22,1021
5880,合庫金,49,9,40,合庫-台中,2023-09-22,1021
00720B,元大投資級公司債,39,0,39,合庫-台中,2023-09-22,1021
00885,富邦越南,68,30,38,合庫-台中,2023-09-22,1021
2323,中環,43,5,38,合庫-台中,2023-09-22,1021
2354,鴻準,37,2,35,合庫-台中,2023-09-22,1021
2883,凱基金,80,45,35,合庫-台中,2023-09-22,1021
2449,京元電子,39,5,34,合庫-台中,2023-09-22,1021
6118,建達,35,2,33,合庫-台中,2023-09-22,1021
2382,廣達,51,18,33,合庫-台中,2023-09-22,1021
4934,太極,31,0,31,合庫-台中,2023-09-22,1021
2330,台積電,42,12,30,合庫-台中,2023-09-22,1021
00772B,中信高評級公司債,38,8,30,合庫-台中,2023-09-22,1021
2891,中信金,30,0,30,合庫-台中,2023-09-22,1021
1445,大宇,30,0,30,合庫-台中,2023-09-22,1021
00931B,統一美債20年,29,0,29,合庫-台中,2023-09-22,1021
6168,宏齊,33,5,28,合庫-台中,2023-09-22,1021
2344,華邦電,34,10,24,合庫-台中,2023-09-22,1021
2605,新興,64,41,23,合庫-台中,2023-09-22,1021
1101,台泥,28,5,23,合庫-台中,2023-09-22,1021
2542,興富發,22,0,22,合庫-台中,2023-09-22,1021
6116,彩晶,21,1,20,合庫-台中,2023-09-22,1021
2392,正崴,20,0,20,合庫-台中,2023-09-22,1021
1447,力鵬,20,0,20,合庫-台中,2023-09-22,1021
00676R,富邦臺灣加權反1,20,0,20,合庫-台中,2023-09-22,1021
00688L,國泰20年美債正2,20,0,20,合庫-台中,2023-09-22,1021
2358,廷鑫,20,0,20,合庫-台中,2023-09-22,1021
1714,和桐,20,0,20,合庫-台中,2023-09-22,1021
2905,三商,25,6,19,合庫-台中,2023-09-22,1021
2408,南亞科,21,2,19,合庫-台中,2023-09-22,1021
2313,華通,185,166,19,合庫-台中,2023-09-22,1021
00687B,國泰20年美債,18,0,18,合庫-台中,2023-09-22,1021
3037,欣興,76,58,18,合庫-台中,2023-09-22,1021
2618,長榮航,38,20,18,合庫-台中,2023-09-22,1021
00645,富邦日本,17,0,17,合庫-台中,2023-09-22,1021
1444,力麗,45,28,17,合庫-台中,2023-09-22,1021
2882,國泰金,16,0,16,合庫-台中,2023-09-22,1021
2838,聯邦銀,374,5,369,合庫-台中,2023-09-25,1021
00715L,期街口布蘭特正2,117,0,117,合庫-台中,2023-09-25,1021
3706,神達,114,4,110,合庫-台中,2023-09-25,1021
1314,中石化,102,10,92,合庫-台中,2023-09-25,1021
1101,台泥,72,1,71,合庫-台中,2023-09-25,1021
00665L,富邦�琤肭磪囓�2,59,2,57,合庫-台中,2023-09-25,1021
2612,中航,66,16,50,合庫-台中,2023-09-25,1021
3231,緯創,93,44,49,合庫-台中,2023-09-25,1021
5880,合庫金,45,2,43,合庫-台中,2023-09-25,1021
2409,友達,72,33,39,合庫-台中,2023-09-25,1021
3481,群創,38,0,38,合庫-台中,2023-09-25,1021
2376,技嘉,51,15,36,合庫-台中,2023-09-25,1021
2382,廣達,58,23,35,合庫-台中,2023-09-25,1021
2812,台中銀,37,7,30,合庫-台中,2023-09-25,1021
3265,台星科,45,16,29,合庫-台中,2023-09-25,1021
2388,威盛,41,12,29,合庫-台中,2023-09-25,1021
3523,迎輝,28,0,28,合庫-台中,2023-09-25,1021
00929,復華台灣科技優息,94,66,28,合庫-台中,2023-09-25,1021
00679B,元大美債20年,42,14,28,合庫-台中,2023-09-25,1021
2618,長榮航,35,9,26,合庫-台中,2023-09-25,1021
2634,漢翔,37,12,25,合庫-台中,2023-09-25,1021
9902,台火,24,0,24,合庫-台中,2023-09-25,1021
4967,十銓,25,4,21,合庫-台中,2023-09-25,1021
6419,京晨科,21,0,21,合庫-台中,2023-09-25,1021
1305,華夏,20,0,20,合庫-台中,2023-09-25,1021
2601,益航,20,0,20,合庫-台中,2023-09-25,1021
2891,中信金,20,0,20,合庫-台中,2023-09-25,1021
00900,富邦特選高股息30,20,0,20,合庫-台中,2023-09-25,1021
1506,正道,20,0,20,合庫-台中,2023-09-25,1021
00932,兆豐永續高息等權,30,10,20,合庫-台中,2023-09-25,1021
2317,鴻海,35,17,18,合庫-台中,2023-09-25,1021
4906,正文,21,3,18,合庫-台中,2023-09-25,1021
3450,聯鈞,70,54,16,合庫-台中,2023-09-25,1021
00706L,期元大S＆P日圓正2,16,0,16,合庫-台中,2023-09-25,1021
2427,三商電,39,24,15,合庫-台中,2023-09-25,1021
1802,台玻,24,9,15,合庫-台中,2023-09-25,1021
4155,訊映,15,0,15,合庫-台中,2023-09-25,1021
2886,兆豐金,22,7,15,合庫-台中,2023-09-25,1021
2324,仁寶,14,0,14,合庫-台中,2023-09-25,1021
6443,元晶,14,0,14,合庫-台中,2023-09-25,1021
2834,臺企銀,39,25,14,合庫-台中,2023-09-25,1021
2002,中鋼,16,2,14,合庫-台中,2023-09-25,1021
4979,華星光,20,8,12,合庫-台中,2023-09-25,1021
2460,建通,12,0,12,合庫-台中,2023-09-25,1021
2542,興富發,12,0,12,合庫-台中,2023-09-25,1021
6415,矽力*-KY,14,2,12,合庫-台中,2023-09-25,1021
00882,中信中國高股息,11,0,11,合庫-台中,2023-09-25,1021
00902,中信電池及儲能,11,0,11,合庫-台中,2023-09-25,1021
1560,中砂,11,0,11,合庫-台中,2023-09-25,1021
00675L,富邦臺灣加權正2,11,0,11,合庫-台中,2023-09-25,1021
2538,基泰,215,10,205,合庫-台中,2023-09-26,1021
2516,新建,169,0,169,合庫-台中,2023-09-26,1021
00885,富邦越南,149,32,117,合庫-台中,2023-09-26,1021
00687B,國泰20年美債,115,2,113,合庫-台中,2023-09-26,1021
2609,陽明,105,5,100,合庫-台中,2023-09-26,1021
4533,協易機,101,5,96,合庫-台中,2023-09-26,1021
00929,復華台灣科技優息,173,81,92,合庫-台中,2023-09-26,1021
3231,緯創,100,23,77,合庫-台中,2023-09-26,1021
2356,英業達,86,10,76,合庫-台中,2023-09-26,1021
00679B,元大美債20年,74,0,74,合庫-台中,2023-09-26,1021
00751B,元大AAA至A公司債,69,0,69,合庫-台中,2023-09-26,1021
3481,群創,59,3,56,合庫-台中,2023-09-26,1021
1314,中石化,50,0,50,合庫-台中,2023-09-26,1021
2882,國泰金,49,0,49,合庫-台中,2023-09-26,1021
2105,正新,51,3,48,合庫-台中,2023-09-26,1021
00919,群益台灣精選高息,73,25,48,合庫-台中,2023-09-26,1021
2337,旺宏,49,4,45,合庫-台中,2023-09-26,1021
00665L,富邦�琤肭磪囓�2,52,7,45,合庫-台中,2023-09-26,1021
00931B,統一美債20年,40,0,40,合庫-台中,2023-09-26,1021
2330,台積電,46,7,39,合庫-台中,2023-09-26,1021
00720B,元大投資級公司債,39,0,39,合庫-台中,2023-09-26,1021
5880,合庫金,83,45,38,合庫-台中,2023-09-26,1021
9902,台火,38,0,38,合庫-台中,2023-09-26,1021
3450,聯鈞,48,11,37,合庫-台中,2023-09-26,1021
2634,漢翔,58,21,37,合庫-台中,2023-09-26,1021
1101,台泥,41,4,37,合庫-台中,2023-09-26,1021
1522,堤維西,111,75,36,合庫-台中,2023-09-26,1021
00772B,中信高評級公司債,35,1,34,合庫-台中,2023-09-26,1021
3035,智原,56,24,32,合庫-台中,2023-09-26,1021
3056,富華新,31,0,31,合庫-台中,2023-09-26,1021
3122,笙泉,36,5,31,合庫-台中,2023-09-26,1021
00857B,永豐20年美公債,30,0,30,合庫-台中,2023-09-26,1021
1319,東陽,40,12,28,合庫-台中,2023-09-26,1021
00888,永豐台灣ESG,27,0,27,合庫-台中,2023-09-26,1021
2388,威盛,43,17,26,合庫-台中,2023-09-26,1021
2542,興富發,54,29,25,合庫-台中,2023-09-26,1021
4931,新盛力,25,0,25,合庫-台中,2023-09-26,1021
6550,北極星藥業-KY,25,1,24,合庫-台中,2023-09-26,1021
2371,大同,41,18,23,合庫-台中,2023-09-26,1021
00712,復華富時不動產,23,0,23,合庫-台中,2023-09-26,1021
6770,力積電,26,4,22,合庫-台中,2023-09-26,1021
8069,元太,25,4,21,合庫-台中,2023-09-26,1021
2880,華南金,21,0,21,合庫-台中,2023-09-26,1021
2913,農林,21,0,21,合庫-台中,2023-09-26,1021
2601,益航,20,0,20,合庫-台中,2023-09-26,1021
3308,聯德,24,4,20,合庫-台中,2023-09-26,1021
2405,輔信,20,1,19,合庫-台中,2023-09-26,1021
2317,鴻海,43,24,19,合庫-台中,2023-09-26,1021
00715L,期街口布蘭特正2,17,0,17,合庫-台中,2023-09-26,1021
2834,臺企銀,27,10,17,合庫-台中,2023-09-26,1021
2363,矽統,320,49,271,合庫-台中,2023-09-27,1021
00929,復華台灣科技優息,276,24,252,合庫-台中,2023-09-27,1021
00715L,期街口布蘭特正2,234,126,108,合庫-台中,2023-09-27,1021
2014,中鴻,101,12,89,合庫-台中,2023-09-27,1021
2002,中鋼,96,15,81,合庫-台中,2023-09-27,1021
1314,中石化,75,0,75,合庫-台中,2023-09-27,1021
2337,旺宏,81,8,73,合庫-台中,2023-09-27,1021
3715,定穎投控,203,131,72,合庫-台中,2023-09-27,1021
00712,復華富時不動產,71,3,68,合庫-台中,2023-09-27,1021
00919,群益台灣精選高息,92,27,65,合庫-台中,2023-09-27,1021
00679B,元大美債20年,65,3,62,合庫-台中,2023-09-27,1021
00680L,元大美債20正2,60,0,60,合庫-台中,2023-09-27,1021
00932,兆豐永續高息等權,55,0,55,合庫-台中,2023-09-27,1021
3576,聯合再生,52,0,52,合庫-台中,2023-09-27,1021
3025,星通,51,2,49,合庫-台中,2023-09-27,1021
2609,陽明,58,15,43,合庫-台中,2023-09-27,1021
3706,神達,61,19,42,合庫-台中,2023-09-27,1021
9902,台火,40,0,40,合庫-台中,2023-09-27,1021
2618,長榮航,60,25,35,合庫-台中,2023-09-27,1021
3122,笙泉,38,8,30,合庫-台中,2023-09-27,1021
1714,和桐,30,0,30,合庫-台中,2023-09-27,1021
2382,廣達,117,90,27,合庫-台中,2023-09-27,1021
2303,聯電,75,48,27,合庫-台中,2023-09-27,1021
3481,群創,34,8,26,合庫-台中,2023-09-27,1021
2313,華通,137,114,23,合庫-台中,2023-09-27,1021
2727,王品,22,0,22,合庫-台中,2023-09-27,1021
4931,新盛力,21,0,21,合庫-台中,2023-09-27,1021
2606,裕民,80,59,21,合庫-台中,2023-09-27,1021
1102,亞泥,19,0,19,合庫-台中,2023-09-27,1021
1815,富喬,44,25,19,合庫-台中,2023-09-27,1021
4908,前鼎,39,21,18,合庫-台中,2023-09-27,1021
2421,建準,68,50,18,合庫-台中,2023-09-27,1021
2538,基泰,262,245,17,合庫-台中,2023-09-27,1021
2317,鴻海,19,3,16,合庫-台中,2023-09-27,1021
2634,漢翔,22,6,16,合庫-台中,2023-09-27,1021
5340,建榮,16,0,16,合庫-台中,2023-09-27,1021
2108,南帝,15,0,15,合庫-台中,2023-09-27,1021
00900,富邦特選高股息30,21,6,15,合庫-台中,2023-09-27,1021
8420,明揚,26,12,14,合庫-台中,2023-09-27,1021
00720B,元大投資級公司債,14,0,14,合庫-台中,2023-09-27,1021
1584,精剛,71,58,13,合庫-台中,2023-09-27,1021
2105,正新,22,9,13,合庫-台中,2023-09-27,1021
4961,天鈺,15,3,12,合庫-台中,2023-09-27,1021
00922,國泰台灣領袖50,12,0,12,合庫-台中,2023-09-27,1021
6576,逸達,13,1,12,合庫-台中,2023-09-27,1021
6419,京晨科,12,0,12,合庫-台中,2023-09-27,1021
2408,南亞科,11,0,11,合庫-台中,2023-09-27,1021
3615,安可,14,3,11,合庫-台中,2023-09-27,1021
5351,鈺創,42,31,11,合庫-台中,2023-09-27,1021
00931B,統一美債20年,13,2,11,合庫-台中,2023-09-27,1021
00673R,期元大S＆P原油反1,213,4,209,合庫-台中,2023-09-28,1021
00671R,富邦NASDAQ反1,150,0,150,合庫-台中,2023-09-28,1021
00648R,元大S＆P500反1,130,0,130,合庫-台中,2023-09-28,1021
2880,華南金,110,6,104,合庫-台中,2023-09-28,1021
00878,國泰永續高股息,122,26,96,合庫-台中,2023-09-28,1021
00712,復華富時不動產,82,0,82,合庫-台中,2023-09-28,1021
2324,仁寶,78,6,72,合庫-台中,2023-09-28,1021
3231,緯創,155,88,67,合庫-台中,2023-09-28,1021
00679B,元大美債20年,64,4,60,合庫-台中,2023-09-28,1021
2002,中鋼,74,15,59,合庫-台中,2023-09-28,1021
6117,迎廣,97,43,54,合庫-台中,2023-09-28,1021
2618,長榮航,48,0,48,合庫-台中,2023-09-28,1021
2201,裕隆,42,5,37,合庫-台中,2023-09-28,1021
2353,宏��,115,80,35,合庫-台中,2023-09-28,1021
00919,群益台灣精選高息,41,7,34,合庫-台中,2023-09-28,1021
00650L,復華香港正2,36,3,33,合庫-台中,2023-09-28,1021
2344,華邦電,41,9,32,合庫-台中,2023-09-28,1021
00931B,統一美債20年,41,10,31,合庫-台中,2023-09-28,1021
00772B,中信高評級公司債,31,0,31,合庫-台中,2023-09-28,1021
00720B,元大投資級公司債,31,0,31,合庫-台中,2023-09-28,1021
2376,技嘉,57,28,29,合庫-台中,2023-09-28,1021
00751B,元大AAA至A公司債,28,0,28,合庫-台中,2023-09-28,1021
00665L,富邦�琤肭磪囓�2,28,0,28,合庫-台中,2023-09-28,1021
2337,旺宏,34,9,25,合庫-台中,2023-09-28,1021
2049,上銀,25,0,25,合庫-台中,2023-09-28,1021
2634,漢翔,34,10,24,合庫-台中,2023-09-28,1021
2301,光寶科,54,32,22,合庫-台中,2023-09-28,1021
3035,智原,43,22,21,合庫-台中,2023-09-28,1021
6288,聯嘉,24,3,21,合庫-台中,2023-09-28,1021
2408,南亞科,121,100,21,合庫-台中,2023-09-28,1021
3521,鴻翊,20,0,20,合庫-台中,2023-09-28,1021
3380,明泰,17,0,17,合庫-台中,2023-09-28,1021
6419,京晨科,15,0,15,合庫-台中,2023-09-28,1021
2312,金寶,15,0,15,合庫-台中,2023-09-28,1021
6531,愛普*,17,3,14,合庫-台中,2023-09-28,1021
00753L,中信中國50正2,13,0,13,合庫-台中,2023-09-28,1021
5225,東科-KY,20,7,13,合庫-台中,2023-09-28,1021
3122,笙泉,33,21,12,合庫-台中,2023-09-28,1021
8088,品安,12,0,12,合庫-台中,2023-09-28,1021
1301,台塑,11,0,11,合庫-台中,2023-09-28,1021
2421,建準,17,6,11,合庫-台中,2023-09-28,1021
8420,明揚,13,2,11,合庫-台中,2023-09-28,1021
4542,科嶠,46,36,10,合庫-台中,2023-09-28,1021
1587,吉茂,10,0,10,合庫-台中,2023-09-28,1021
00655L,國泰中國A50正2,10,0,10,合庫-台中,2023-09-28,1021
2031,新光鋼,10,0,10,合庫-台中,2023-09-28,1021
5371,中光電,10,0,10,合庫-台中,2023-09-28,1021
00932,兆豐永續高息等權,10,0,10,合庫-台中,2023-09-28,1021
2614,東森,10,1,9,合庫-台中,2023-09-28,1021
2313,華通,172,163,9,合庫-台中,2023-09-28,1021
00720B,元大投資級公司債,215,0,215,合庫-台中,2023-10-02,1021
1815,富喬,164,16,148,合庫-台中,2023-10-02,1021
00715L,期街口布蘭特正2,134,0,134,合庫-台中,2023-10-02,1021
00929,復華台灣科技優息,355,255,100,合庫-台中,2023-10-02,1021
2409,友達,107,29,78,合庫-台中,2023-10-02,1021
00885,富邦越南,80,2,78,合庫-台中,2023-10-02,1021
2303,聯電,81,6,75,合庫-台中,2023-10-02,1021
2442,新美齊,60,1,59,合庫-台中,2023-10-02,1021
00772B,中信高評級公司債,54,0,54,合庫-台中,2023-10-02,1021
2002,中鋼,58,7,51,合庫-台中,2023-10-02,1021
5880,合庫金,69,20,49,合庫-台中,2023-10-02,1021
00751B,元大AAA至A公司債,48,0,48,合庫-台中,2023-10-02,1021
00679B,元大美債20年,46,4,42,合庫-台中,2023-10-02,1021
3230,錦明,40,0,40,合庫-台中,2023-10-02,1021
00665L,富邦�琤肭磪囓�2,38,0,38,合庫-台中,2023-10-02,1021
2888,新光金,32,0,32,合庫-台中,2023-10-02,1021
00919,群益台灣精選高息,28,1,27,合庫-台中,2023-10-02,1021
3521,鴻翊,26,0,26,合庫-台中,2023-10-02,1021
8429,金麗-KY,25,0,25,合庫-台中,2023-10-02,1021
2838,聯邦銀,25,0,25,合庫-台中,2023-10-02,1021
3025,星通,24,0,24,合庫-台中,2023-10-02,1021
1608,華榮,24,0,24,合庫-台中,2023-10-02,1021
2201,裕隆,28,5,23,合庫-台中,2023-10-02,1021
5324,士開,24,2,22,合庫-台中,2023-10-02,1021
2363,矽統,154,132,22,合庫-台中,2023-10-02,1021
2329,華泰,29,8,21,合庫-台中,2023-10-02,1021
2305,全友,22,2,20,合庫-台中,2023-10-02,1021
3580,友威科,20,0,20,合庫-台中,2023-10-02,1021
2601,益航,20,0,20,合庫-台中,2023-10-02,1021
00931B,統一美債20年,19,0,19,合庫-台中,2023-10-02,1021
2106,建大,18,0,18,合庫-台中,2023-10-02,1021
9136,巨騰-DR,18,0,18,合庫-台中,2023-10-02,1021
3523,迎輝,18,0,18,合庫-台中,2023-10-02,1021
00670L,富邦NASDAQ正2,19,1,18,合庫-台中,2023-10-02,1021
2457,飛宏,32,14,18,合庫-台中,2023-10-02,1021
2834,臺企銀,38,20,18,合庫-台中,2023-10-02,1021
3615,安可,15,0,15,合庫-台中,2023-10-02,1021
3056,富華新,16,2,14,合庫-台中,2023-10-02,1021
1519,華城,22,8,14,合庫-台中,2023-10-02,1021
1618,合機,25,11,14,合庫-台中,2023-10-02,1021
2204,中華,13,0,13,合庫-台中,2023-10-02,1021
8046,南電,12,0,12,合庫-台中,2023-10-02,1021
3693,營邦,53,41,12,合庫-台中,2023-10-02,1021
1584,精剛,14,2,12,合庫-台中,2023-10-02,1021
1319,東陽,16,4,12,合庫-台中,2023-10-02,1021
00902,中信電池及儲能,12,0,12,合庫-台中,2023-10-02,1021
1301,台塑,11,0,11,合庫-台中,2023-10-02,1021
4979,華星光,20,9,11,合庫-台中,2023-10-02,1021
6122,擎邦,11,1,10,合庫-台中,2023-10-02,1021
2891,中信金,11,1,10,合庫-台中,2023-10-02,1021
00929,復華台灣科技優息,235,61,174,合庫-台中,2023-10-03,1021
5880,合庫金,192,21,171,合庫-台中,2023-10-03,1021
2356,英業達,137,20,117,合庫-台中,2023-10-03,1021
2002,中鋼,104,5,99,合庫-台中,2023-10-03,1021
00637L,元大滬深300正2,93,0,93,合庫-台中,2023-10-03,1021
2208,台船,100,8,92,合庫-台中,2023-10-03,1021
00712,復華富時不動產,80,0,80,合庫-台中,2023-10-03,1021
2618,長榮航,84,6,78,合庫-台中,2023-10-03,1021
3013,晟銘電,87,13,74,合庫-台中,2023-10-03,1021
00900,富邦特選高股息30,66,5,61,合庫-台中,2023-10-03,1021
2417,圓剛,69,11,58,合庫-台中,2023-10-03,1021
00715L,期街口布蘭特正2,87,30,57,合庫-台中,2023-10-03,1021
2388,威盛,71,17,54,合庫-台中,2023-10-03,1021
00665L,富邦�琤肭磪囓�2,51,0,51,合庫-台中,2023-10-03,1021
3372,典範,50,0,50,合庫-台中,2023-10-03,1021
00878,國泰永續高股息,61,17,44,合庫-台中,2023-10-03,1021
3035,智原,48,6,42,合庫-台中,2023-10-03,1021
2888,新光金,44,2,42,合庫-台中,2023-10-03,1021
3325,旭品,142,101,41,合庫-台中,2023-10-03,1021
00919,群益台灣精選高息,61,20,41,合庫-台中,2023-10-03,1021
00648R,元大S＆P500反1,40,0,40,合庫-台中,2023-10-03,1021
0056,元大高股息,67,28,39,合庫-台中,2023-10-03,1021
2105,正新,37,1,36,合庫-台中,2023-10-03,1021
00655L,國泰中國A50正2,35,0,35,合庫-台中,2023-10-03,1021
2409,友達,115,81,34,合庫-台中,2023-10-03,1021
00922,國泰台灣領袖50,33,0,33,合庫-台中,2023-10-03,1021
2609,陽明,39,8,31,合庫-台中,2023-10-03,1021
1618,合機,32,3,29,合庫-台中,2023-10-03,1021
00773B,中信優先金融債,27,0,27,合庫-台中,2023-10-03,1021
2353,宏��,53,26,27,合庫-台中,2023-10-03,1021
1560,中砂,32,6,26,合庫-台中,2023-10-03,1021
1714,和桐,26,0,26,合庫-台中,2023-10-03,1021
2615,萬海,26,0,26,合庫-台中,2023-10-03,1021
00751B,元大AAA至A公司債,25,0,25,合庫-台中,2023-10-03,1021
3521,鴻翊,25,0,25,合庫-台中,2023-10-03,1021
00720B,元大投資級公司債,25,0,25,合庫-台中,2023-10-03,1021
00907,永豐優息存股,26,2,24,合庫-台中,2023-10-03,1021
4543,萬在,54,30,24,合庫-台中,2023-10-03,1021
6235,華孚,32,8,24,合庫-台中,2023-10-03,1021
5452,佶優,25,1,24,合庫-台中,2023-10-03,1021
2371,大同,31,7,24,合庫-台中,2023-10-03,1021
2838,聯邦銀,26,3,23,合庫-台中,2023-10-03,1021
00795B,中信美國公債20年,23,0,23,合庫-台中,2023-10-03,1021
00674R,期元大S＆P黃金反1,22,0,22,合庫-台中,2023-10-03,1021
00753L,中信中國50正2,21,0,21,合庫-台中,2023-10-03,1021
2834,臺企銀,45,25,20,合庫-台中,2023-10-03,1021
3576,聯合再生,20,0,20,合庫-台中,2023-10-03,1021
3230,錦明,20,0,20,合庫-台中,2023-10-03,1021
00885,富邦越南,20,0,20,合庫-台中,2023-10-03,1021
2367,燿華,23,3,20,合庫-台中,2023-10-03,1021
00720B,元大投資級公司債,291,0,291,合庫-台中,2023-10-04,1021
3481,群創,257,7,250,合庫-台中,2023-10-04,1021
5880,合庫金,218,19,199,合庫-台中,2023-10-04,1021
8277,商丞,185,0,185,合庫-台中,2023-10-04,1021
00712,復華富時不動產,217,70,147,合庫-台中,2023-10-04,1021
00632R,元大台灣50反1,156,11,145,合庫-台中,2023-10-04,1021
2002,中鋼,134,5,129,合庫-台中,2023-10-04,1021
2618,長榮航,140,15,125,合庫-台中,2023-10-04,1021
00929,復華台灣科技優息,117,23,94,合庫-台中,2023-10-04,1021
00922,國泰台灣領袖50,92,0,92,合庫-台中,2023-10-04,1021
2409,友達,100,16,84,合庫-台中,2023-10-04,1021
00679B,元大美債20年,115,37,78,合庫-台中,2023-10-04,1021
2880,華南金,77,0,77,合庫-台中,2023-10-04,1021
2303,聯電,74,1,73,合庫-台中,2023-10-04,1021
00751B,元大AAA至A公司債,71,0,71,合庫-台中,2023-10-04,1021
0056,元大高股息,77,8,69,合庫-台中,2023-10-04,1021
2884,玉山金,61,0,61,合庫-台中,2023-10-04,1021
2883,凱基金,75,23,52,合庫-台中,2023-10-04,1021
2882,國泰金,51,0,51,合庫-台中,2023-10-04,1021
00773B,中信優先金融債,53,2,51,合庫-台中,2023-10-04,1021
1314,中石化,51,1,50,合庫-台中,2023-10-04,1021
00900,富邦特選高股息30,47,1,46,合庫-台中,2023-10-04,1021
1718,中纖,45,0,45,合庫-台中,2023-10-04,1021
2891,中信金,45,1,44,合庫-台中,2023-10-04,1021
2382,廣達,76,35,41,合庫-台中,2023-10-04,1021
1444,力麗,40,0,40,合庫-台中,2023-10-04,1021
1409,新纖,39,0,39,合庫-台中,2023-10-04,1021
3025,星通,36,0,36,合庫-台中,2023-10-04,1021
2892,第一金,35,0,35,合庫-台中,2023-10-04,1021
1802,台玻,30,0,30,合庫-台中,2023-10-04,1021
00688L,國泰20年美債正2,30,0,30,合庫-台中,2023-10-04,1021
2881,富邦金,43,13,30,合庫-台中,2023-10-04,1021
3231,緯創,112,84,28,合庫-台中,2023-10-04,1021
3006,晶豪科,33,7,26,合庫-台中,2023-10-04,1021
00637L,元大滬深300正2,35,9,26,合庫-台中,2023-10-04,1021
00931B,統一美債20年,30,4,26,合庫-台中,2023-10-04,1021
3094,聯傑,33,8,25,合庫-台中,2023-10-04,1021
00648R,元大S＆P500反1,25,0,25,合庫-台中,2023-10-04,1021
2014,中鴻,25,0,25,合庫-台中,2023-10-04,1021
5351,鈺創,28,4,24,合庫-台中,2023-10-04,1021
8215,明基材,23,0,23,合庫-台中,2023-10-04,1021
00772B,中信高評級公司債,55,32,23,合庫-台中,2023-10-04,1021
2388,威盛,35,13,22,合庫-台中,2023-10-04,1021
3715,定穎投控,111,89,22,合庫-台中,2023-10-04,1021
2834,臺企銀,36,15,21,合庫-台中,2023-10-04,1021
3005,神基,24,3,21,合庫-台中,2023-10-04,1021
2330,台積電,27,7,20,合庫-台中,2023-10-04,1021
4916,事欣科,20,0,20,合庫-台中,2023-10-04,1021
3230,錦明,20,0,20,合庫-台中,2023-10-04,1021
2317,鴻海,30,11,19,合庫-台中,2023-10-04,1021
2618,長榮航,263,87,176,合庫-台中,2023-10-05,1021
1815,富喬,185,16,169,合庫-台中,2023-10-05,1021
00712,復華富時不動產,149,6,143,合庫-台中,2023-10-05,1021
2409,友達,138,17,121,合庫-台中,2023-10-05,1021
00720B,元大投資級公司債,110,1,109,合庫-台中,2023-10-05,1021
00929,復華台灣科技優息,97,8,89,合庫-台中,2023-10-05,1021
2417,圓剛,94,13,81,合庫-台中,2023-10-05,1021
3231,緯創,129,60,69,合庫-台中,2023-10-05,1021
2388,威盛,71,11,60,合庫-台中,2023-10-05,1021
2609,陽明,61,10,51,合庫-台中,2023-10-05,1021
2888,新光金,68,20,48,合庫-台中,2023-10-05,1021
00673R,期元大S＆P原油反1,45,0,45,合庫-台中,2023-10-05,1021
00888,永豐台灣ESG,45,2,43,合庫-台中,2023-10-05,1021
2314,台揚,41,0,41,合庫-台中,2023-10-05,1021
2538,基泰,69,29,40,合庫-台中,2023-10-05,1021
2241,艾姆勒,38,2,36,合庫-台中,2023-10-05,1021
00715L,期街口布蘭特正2,117,82,35,合庫-台中,2023-10-05,1021
00648R,元大S＆P500反1,30,0,30,合庫-台中,2023-10-05,1021
00674R,期元大S＆P黃金反1,30,0,30,合庫-台中,2023-10-05,1021
6288,聯嘉,28,2,26,合庫-台中,2023-10-05,1021
2405,輔信,26,2,24,合庫-台中,2023-10-05,1021
1101,台泥,24,0,24,合庫-台中,2023-10-05,1021
2891,中信金,38,15,23,合庫-台中,2023-10-05,1021
3481,群創,93,71,22,合庫-台中,2023-10-05,1021
3013,晟銘電,73,52,21,合庫-台中,2023-10-05,1021
6204,艾華,21,0,21,合庫-台中,2023-10-05,1021
2834,臺企銀,49,29,20,合庫-台中,2023-10-05,1021
6026,福邦證,20,0,20,合庫-台中,2023-10-05,1021
5351,鈺創,24,4,20,合庫-台中,2023-10-05,1021
3438,類比科,20,0,20,合庫-台中,2023-10-05,1021
9802,鈺齊-KY,20,0,20,合庫-台中,2023-10-05,1021
3037,欣興,20,1,19,合庫-台中,2023-10-05,1021
0056,元大高股息,22,3,19,合庫-台中,2023-10-05,1021
00637L,元大滬深300正2,22,5,17,合庫-台中,2023-10-05,1021
2603,長榮,19,3,16,合庫-台中,2023-10-05,1021
5460,同協,16,0,16,合庫-台中,2023-10-05,1021
00931B,統一美債20年,16,0,16,合庫-台中,2023-10-05,1021
00687B,國泰20年美債,15,0,15,合庫-台中,2023-10-05,1021
2838,聯邦銀,15,0,15,合庫-台中,2023-10-05,1021
1515,力山,15,1,14,合庫-台中,2023-10-05,1021
3530,晶相光,14,1,13,合庫-台中,2023-10-05,1021
2201,裕隆,15,3,12,合庫-台中,2023-10-05,1021
2404,漢唐,12,0,12,合庫-台中,2023-10-05,1021
1909,榮成,12,0,12,合庫-台中,2023-10-05,1021
1524,耿鼎,17,5,12,合庫-台中,2023-10-05,1021
4543,萬在,19,7,12,合庫-台中,2023-10-05,1021
4967,十銓,44,33,11,合庫-台中,2023-10-05,1021
6531,愛普*,20,9,11,合庫-台中,2023-10-05,1021
8131,福懋科,10,0,10,合庫-台中,2023-10-05,1021
00664R,國泰臺灣加權反1,10,0,10,合庫-台中,2023-10-05,1021
00715L,期街口布蘭特正2,264,0,264,合庫-台中,2023-10-06,1021
2838,聯邦銀,172,0,172,合庫-台中,2023-10-06,1021
9105,泰金寶-DR,162,0,162,合庫-台中,2023-10-06,1021
00929,復華台灣科技優息,178,18,160,合庫-台中,2023-10-06,1021
00680L,元大美債20正2,111,0,111,合庫-台中,2023-10-06,1021
3481,群創,115,5,110,合庫-台中,2023-10-06,1021
2409,友達,107,10,97,合庫-台中,2023-10-06,1021
2329,華泰,89,7,82,合庫-台中,2023-10-06,1021
5272,笙科,83,2,81,合庫-台中,2023-10-06,1021
0056,元大高股息,89,19,70,合庫-台中,2023-10-06,1021
3363,上詮,66,1,65,合庫-台中,2023-10-06,1021
3715,定穎投控,134,70,64,合庫-台中,2023-10-06,1021
3669,圓展,64,7,57,合庫-台中,2023-10-06,1021
2888,新光金,58,11,47,合庫-台中,2023-10-06,1021
00673R,期元大S＆P原油反1,51,7,44,合庫-台中,2023-10-06,1021
2891,中信金,46,4,42,合庫-台中,2023-10-06,1021
2363,矽統,99,61,38,合庫-台中,2023-10-06,1021
6114,久威,35,0,35,合庫-台中,2023-10-06,1021
00712,復華富時不動產,33,0,33,合庫-台中,2023-10-06,1021
2323,中環,61,30,31,合庫-台中,2023-10-06,1021
4953,緯軟,36,6,30,合庫-台中,2023-10-06,1021
1444,力麗,30,0,30,合庫-台中,2023-10-06,1021
2344,華邦電,116,87,29,合庫-台中,2023-10-06,1021
00885,富邦越南,28,0,28,合庫-台中,2023-10-06,1021
2618,長榮航,34,6,28,合庫-台中,2023-10-06,1021
1616,億泰,31,5,26,合庫-台中,2023-10-06,1021
00919,群益台灣精選高息,28,2,26,合庫-台中,2023-10-06,1021
1227,佳格,25,0,25,合庫-台中,2023-10-06,1021
1609,大亞,30,6,24,合庫-台中,2023-10-06,1021
2388,威盛,26,3,23,合庫-台中,2023-10-06,1021
00679B,元大美債20年,27,4,23,合庫-台中,2023-10-06,1021
6189,豐藝,42,21,21,合庫-台中,2023-10-06,1021
2365,昆盈,45,24,21,合庫-台中,2023-10-06,1021
1417,嘉裕,20,0,20,合庫-台中,2023-10-06,1021
9907,統一實,20,0,20,合庫-台中,2023-10-06,1021
2241,艾姆勒,17,0,17,合庫-台中,2023-10-06,1021
3051,力特,18,1,17,合庫-台中,2023-10-06,1021
6451,訊芯-KY,53,37,16,合庫-台中,2023-10-06,1021
00772B,中信高評級公司債,18,3,15,合庫-台中,2023-10-06,1021
00857B,永豐20年美公債,15,0,15,合庫-台中,2023-10-06,1021
00720B,元大投資級公司債,13,0,13,合庫-台中,2023-10-06,1021
00888,永豐台灣ESG,12,0,12,合庫-台中,2023-10-06,1021
3230,錦明,12,0,12,合庫-台中,2023-10-06,1021
00773B,中信優先金融債,11,0,11,合庫-台中,2023-10-06,1021
1301,台塑,11,0,11,合庫-台中,2023-10-06,1021
3163,波若威,16,5,11,合庫-台中,2023-10-06,1021
3081,聯亞,47,36,11,合庫-台中,2023-10-06,1021
3701,大眾控,13,2,11,合庫-台中,2023-10-06,1021
1737,臺鹽,11,0,11,合庫-台中,2023-10-06,1021
4746,台耀,11,0,11,合庫-台中,2023-10-06,1021
2363,矽統,511,129,382,合庫-台中,2023-10-11,1021
3231,緯創,382,95,287,合庫-台中,2023-10-11,1021
3523,迎輝,177,0,177,合庫-台中,2023-10-11,1021
2356,英業達,176,59,117,合庫-台中,2023-10-11,1021
2409,友達,152,36,116,合庫-台中,2023-10-11,1021
3013,晟銘電,138,28,110,合庫-台中,2023-10-11,1021
2442,新美齊,98,4,94,合庫-台中,2023-10-11,1021
2515,中工,80,0,80,合庫-台中,2023-10-11,1021
2618,長榮航,97,18,79,合庫-台中,2023-10-11,1021
00929,復華台灣科技優息,122,60,62,合庫-台中,2023-10-11,1021
3006,晶豪科,85,26,59,合庫-台中,2023-10-11,1021
2388,威盛,111,54,57,合庫-台中,2023-10-11,1021
00637L,元大滬深300正2,61,4,57,合庫-台中,2023-10-11,1021
2838,聯邦銀,57,4,53,合庫-台中,2023-10-11,1021
6282,康舒,78,28,50,合庫-台中,2023-10-11,1021
2834,臺企銀,58,9,49,合庫-台中,2023-10-11,1021
6443,元晶,48,0,48,合庫-台中,2023-10-11,1021
00632R,元大台灣50反1,47,0,47,合庫-台中,2023-10-11,1021
1909,榮成,40,0,40,合庫-台中,2023-10-11,1021
00753L,中信中國50正2,40,0,40,合庫-台中,2023-10-11,1021
3234,光環,41,2,39,合庫-台中,2023-10-11,1021
00878,國泰永續高股息,70,31,39,合庫-台中,2023-10-11,1021
00919,群益台灣精選高息,60,24,36,合庫-台中,2023-10-11,1021
2002,中鋼,35,0,35,合庫-台中,2023-10-11,1021
9105,泰金寶-DR,34,0,34,合庫-台中,2023-10-11,1021
00679B,元大美債20年,33,2,31,合庫-台中,2023-10-11,1021
2382,廣達,110,80,30,合庫-台中,2023-10-11,1021
6270,倍微,30,0,30,合庫-台中,2023-10-11,1021
2603,長榮,50,20,30,合庫-台中,2023-10-11,1021
3706,神達,39,10,29,合庫-台中,2023-10-11,1021
1515,力山,32,4,28,合庫-台中,2023-10-11,1021
00715L,期街口布蘭特正2,280,252,28,合庫-台中,2023-10-11,1021
00712,復華富時不動產,32,6,26,合庫-台中,2023-10-11,1021
0056,元大高股息,49,23,26,合庫-台中,2023-10-11,1021
6530,創威,40,15,25,合庫-台中,2023-10-11,1021
3005,神基,40,15,25,合庫-台中,2023-10-11,1021
3438,類比科,25,0,25,合庫-台中,2023-10-11,1021
2601,益航,25,0,25,合庫-台中,2023-10-11,1021
2610,華航,42,17,25,合庫-台中,2023-10-11,1021
3088,艾訊,24,0,24,合庫-台中,2023-10-11,1021
6570,維田,24,0,24,合庫-台中,2023-10-11,1021
00722B,群益投資級電信債,24,0,24,合庫-台中,2023-10-11,1021
1504,東元,38,15,23,合庫-台中,2023-10-11,1021
3693,營邦,38,15,23,合庫-台中,2023-10-11,1021
1471,首利,27,5,22,合庫-台中,2023-10-11,1021
3701,大眾控,22,0,22,合庫-台中,2023-10-11,1021
6156,松上,21,0,21,合庫-台中,2023-10-11,1021
1444,力麗,30,9,21,合庫-台中,2023-10-11,1021
2449,京元電子,34,14,20,合庫-台中,2023-10-11,1021
5460,同協,20,0,20,合庫-台中,2023-10-11,1021
3711,日月光投控,534,36,498,合庫-台中,2023-10-12,1021
2363,矽統,546,254,292,合庫-台中,2023-10-12,1021
00715L,期街口布蘭特正2,193,12,181,合庫-台中,2023-10-12,1021
3523,迎輝,60,0,60,合庫-台中,2023-10-12,1021
2356,英業達,87,30,57,合庫-台中,2023-10-12,1021
2801,彰銀,56,1,55,合庫-台中,2023-10-12,1021
2409,友達,98,49,49,合庫-台中,2023-10-12,1021
2838,聯邦銀,49,0,49,合庫-台中,2023-10-12,1021
2106,建大,45,0,45,合庫-台中,2023-10-12,1021
2888,新光金,43,0,43,合庫-台中,2023-10-12,1021
3363,上詮,63,28,35,合庫-台中,2023-10-12,1021
00679B,元大美債20年,42,10,32,合庫-台中,2023-10-12,1021
1815,富喬,41,11,30,合庫-台中,2023-10-12,1021
1609,大亞,31,1,30,合庫-台中,2023-10-12,1021
00902,中信電池及儲能,29,0,29,合庫-台中,2023-10-12,1021
00712,復華富時不動產,36,8,28,合庫-台中,2023-10-12,1021
00922,國泰台灣領袖50,29,1,28,合庫-台中,2023-10-12,1021
6770,力積電,40,14,26,合庫-台中,2023-10-12,1021
00680L,元大美債20正2,42,16,26,合庫-台中,2023-10-12,1021
3693,營邦,27,2,25,合庫-台中,2023-10-12,1021
2465,麗臺,32,8,24,合庫-台中,2023-10-12,1021
2349,錸德,20,0,20,合庫-台中,2023-10-12,1021
1342,八貫,24,5,19,合庫-台中,2023-10-12,1021
8429,金麗-KY,19,0,19,合庫-台中,2023-10-12,1021
2352,佳世達,22,6,16,合庫-台中,2023-10-12,1021
1603,華電,23,7,16,合庫-台中,2023-10-12,1021
4916,事欣科,16,0,16,合庫-台中,2023-10-12,1021
4167,松瑞藥,15,0,15,合庫-台中,2023-10-12,1021
1319,東陽,131,117,14,合庫-台中,2023-10-12,1021
6231,系微,15,2,13,合庫-台中,2023-10-12,1021
2365,昆盈,13,0,13,合庫-台中,2023-10-12,1021
3576,聯合再生,14,1,13,合庫-台中,2023-10-12,1021
6282,康舒,148,135,13,合庫-台中,2023-10-12,1021
8926,台汽電,12,0,12,合庫-台中,2023-10-12,1021
00918,大華優利高填息30,12,0,12,合庫-台中,2023-10-12,1021
1584,精剛,12,0,12,合庫-台中,2023-10-12,1021
00642U,期元大S＆P石油,12,0,12,合庫-台中,2023-10-12,1021
2425,承啟,12,0,12,合庫-台中,2023-10-12,1021
2376,技嘉,30,19,11,合庫-台中,2023-10-12,1021
6204,艾華,11,0,11,合庫-台中,2023-10-12,1021
2382,廣達,127,116,11,合庫-台中,2023-10-12,1021
8176,智捷,11,0,11,合庫-台中,2023-10-12,1021
2601,益航,11,0,11,合庫-台中,2023-10-12,1021
4414,如興,11,0,11,合庫-台中,2023-10-12,1021
6570,維田,11,0,11,合庫-台中,2023-10-12,1021
1305,華夏,10,0,10,合庫-台中,2023-10-12,1021
2820,華票,10,0,10,合庫-台中,2023-10-12,1021
4113,聯上,10,0,10,合庫-台中,2023-10-12,1021
2855,統一證,10,0,10,合庫-台中,2023-10-12,1021
1714,和桐,10,0,10,合庫-台中,2023-10-12,1021
00929,復華台灣科技優息,184,33,151,合庫-台中,2023-10-13,1021
0056,元大高股息,166,19,147,合庫-台中,2023-10-13,1021
2409,友達,127,19,108,合庫-台中,2023-10-13,1021
2344,華邦電,147,39,108,合庫-台中,2023-10-13,1021
2363,矽統,468,387,81,合庫-台中,2023-10-13,1021
3231,緯創,163,92,71,合庫-台中,2023-10-13,1021
00919,群益台灣精選高息,74,11,63,合庫-台中,2023-10-13,1021
6282,康舒,89,30,59,合庫-台中,2023-10-13,1021
00637L,元大滬深300正2,77,20,57,合庫-台中,2023-10-13,1021
3481,群創,66,11,55,合庫-台中,2023-10-13,1021
2324,仁寶,67,15,52,合庫-台中,2023-10-13,1021
1342,八貫,53,2,51,合庫-台中,2023-10-13,1021
2888,新光金,51,0,51,合庫-台中,2023-10-13,1021
3032,偉訓,47,3,44,合庫-台中,2023-10-13,1021
1101,台泥,58,15,43,合庫-台中,2023-10-13,1021
2303,聯電,82,39,43,合庫-台中,2023-10-13,1021
00712,復華富時不動產,47,5,42,合庫-台中,2023-10-13,1021
00922,國泰台灣領袖50,41,0,41,合庫-台中,2023-10-13,1021
2382,廣達,85,47,38,合庫-台中,2023-10-13,1021
2618,長榮航,69,32,37,合庫-台中,2023-10-13,1021
00720B,元大投資級公司債,36,0,36,合庫-台中,2023-10-13,1021
6016,康和證,30,0,30,合庫-台中,2023-10-13,1021
1447,力鵬,28,0,28,合庫-台中,2023-10-13,1021
2880,華南金,37,10,27,合庫-台中,2023-10-13,1021
00931B,統一美債20年,27,0,27,合庫-台中,2023-10-13,1021
2353,宏��,29,2,27,合庫-台中,2023-10-13,1021
00679B,元大美債20年,29,4,25,合庫-台中,2023-10-13,1021
2377,微星,25,0,25,合庫-台中,2023-10-13,1021
3062,建漢,30,7,23,合庫-台中,2023-10-13,1021
2538,基泰,23,0,23,合庫-台中,2023-10-13,1021
5880,合庫金,24,1,23,合庫-台中,2023-10-13,1021
1905,華紙,27,5,22,合庫-台中,2023-10-13,1021
2332,友訊,23,2,21,合庫-台中,2023-10-13,1021
1444,力麗,41,20,21,合庫-台中,2023-10-13,1021
9950,萬國通,31,10,21,合庫-台中,2023-10-13,1021
3217,優群,20,0,20,合庫-台中,2023-10-13,1021
3701,大眾控,20,0,20,合庫-台中,2023-10-13,1021
6231,系微,21,2,19,合庫-台中,2023-10-13,1021
4979,華星光,91,74,17,合庫-台中,2023-10-13,1021
2402,毅嘉,22,5,17,合庫-台中,2023-10-13,1021
3715,定穎投控,298,282,16,合庫-台中,2023-10-13,1021
3037,欣興,19,3,16,合庫-台中,2023-10-13,1021
1503,士電,15,0,15,合庫-台中,2023-10-13,1021
9933,中鼎,15,0,15,合庫-台中,2023-10-13,1021
2601,益航,20,5,15,合庫-台中,2023-10-13,1021
6112,邁達特,18,3,15,合庫-台中,2023-10-13,1021
1504,東元,15,1,14,合庫-台中,2023-10-13,1021
8028,昇陽半導體,14,0,14,合庫-台中,2023-10-13,1021
1609,大亞,16,3,13,合庫-台中,2023-10-13,1021
2002,中鋼,24,11,13,合庫-台中,2023-10-13,1021
6282,康舒,274,67,207,合庫-台中,2023-10-16,1021
00929,復華台灣科技優息,149,23,126,合庫-台中,2023-10-16,1021
2618,長榮航,175,53,122,合庫-台中,2023-10-16,1021
1815,富喬,127,6,121,合庫-台中,2023-10-16,1021
2881,富邦金,120,1,119,合庫-台中,2023-10-16,1021
2363,矽統,373,276,97,合庫-台中,2023-10-16,1021
0056,元大高股息,98,12,86,合庫-台中,2023-10-16,1021
3481,群創,100,20,80,合庫-台中,2023-10-16,1021
00715L,期街口布蘭特正2,215,140,75,合庫-台中,2023-10-16,1021
2344,華邦電,336,263,73,合庫-台中,2023-10-16,1021
1718,中纖,62,0,62,合庫-台中,2023-10-16,1021
2312,金寶,60,1,59,合庫-台中,2023-10-16,1021
2409,友達,69,11,58,合庫-台中,2023-10-16,1021
3615,安可,63,5,58,合庫-台中,2023-10-16,1021
00919,群益台灣精選高息,72,17,55,合庫-台中,2023-10-16,1021
2634,漢翔,52,1,51,合庫-台中,2023-10-16,1021
00712,復華富時不動產,56,6,50,合庫-台中,2023-10-16,1021
2834,臺企銀,71,22,49,合庫-台中,2023-10-16,1021
2610,華航,59,11,48,合庫-台中,2023-10-16,1021
1605,華新,57,9,48,合庫-台中,2023-10-16,1021
00670L,富邦NASDAQ正2,52,6,46,合庫-台中,2023-10-16,1021
00632R,元大台灣50反1,50,4,46,合庫-台中,2023-10-16,1021
2324,仁寶,48,2,46,合庫-台中,2023-10-16,1021
2516,新建,43,1,42,合庫-台中,2023-10-16,1021
6016,康和證,40,0,40,合庫-台中,2023-10-16,1021
00679B,元大美債20年,42,3,39,合庫-台中,2023-10-16,1021
4513,福裕,37,0,37,合庫-台中,2023-10-16,1021
2382,廣達,38,7,31,合庫-台中,2023-10-16,1021
6531,愛普*,36,5,31,合庫-台中,2023-10-16,1021
5347,世界,37,7,30,合庫-台中,2023-10-16,1021
2002,中鋼,40,14,26,合庫-台中,2023-10-16,1021
00922,國泰台灣領袖50,28,2,26,合庫-台中,2023-10-16,1021
8011,台通,25,0,25,合庫-台中,2023-10-16,1021
5519,隆大,26,2,24,合庫-台中,2023-10-16,1021
6108,競國,24,0,24,合庫-台中,2023-10-16,1021
1444,力麗,62,40,22,合庫-台中,2023-10-16,1021
00720B,元大投資級公司債,21,1,20,合庫-台中,2023-10-16,1021
2485,兆赫,20,0,20,合庫-台中,2023-10-16,1021
5351,鈺創,21,2,19,合庫-台中,2023-10-16,1021
6128,上福,19,0,19,合庫-台中,2023-10-16,1021
2027,大成鋼,21,2,19,合庫-台中,2023-10-16,1021
8390,金益鼎,86,68,18,合庫-台中,2023-10-16,1021
3049,精金,18,0,18,合庫-台中,2023-10-16,1021
00878,國泰永續高股息,23,5,18,合庫-台中,2023-10-16,1021
00888,永豐台灣ESG,20,3,17,合庫-台中,2023-10-16,1021
8349,�矬�,15,0,15,合庫-台中,2023-10-16,1021
6120,達運,14,0,14,合庫-台中,2023-10-16,1021
6419,京晨科,16,2,14,合庫-台中,2023-10-16,1021
00665L,富邦�琤肭磪囓�2,14,0,14,合庫-台中,2023-10-16,1021
3715,定穎投控,99,86,13,合庫-台中,2023-10-16,1021
3481,群創,165,13,152,合庫-台中,2023-10-17,1021
0056,元大高股息,141,4,137,合庫-台中,2023-10-17,1021
00929,復華台灣科技優息,171,34,137,合庫-台中,2023-10-17,1021
3231,緯創,223,117,106,合庫-台中,2023-10-17,1021
2356,英業達,126,26,100,合庫-台中,2023-10-17,1021
00931B,統一美債20年,89,1,88,合庫-台中,2023-10-17,1021
00720B,元大投資級公司債,81,0,81,合庫-台中,2023-10-17,1021
6419,京晨科,112,31,81,合庫-台中,2023-10-17,1021
00751B,元大AAA至A公司債,71,0,71,合庫-台中,2023-10-17,1021
6282,康舒,153,93,60,合庫-台中,2023-10-17,1021
3006,晶豪科,64,6,58,合庫-台中,2023-10-17,1021
2409,友達,97,40,57,合庫-台中,2023-10-17,1021
3013,晟銘電,61,8,53,合庫-台中,2023-10-17,1021
2888,新光金,46,1,45,合庫-台中,2023-10-17,1021
3094,聯傑,71,26,45,合庫-台中,2023-10-17,1021
2610,華航,71,28,43,合庫-台中,2023-10-17,1021
00687B,國泰20年美債,44,2,42,合庫-台中,2023-10-17,1021
6120,達運,41,0,41,合庫-台中,2023-10-17,1021
00632R,元大台灣50反1,39,0,39,合庫-台中,2023-10-17,1021
00885,富邦越南,38,0,38,合庫-台中,2023-10-17,1021
2618,長榮航,113,78,35,合庫-台中,2023-10-17,1021
8996,高力,39,5,34,合庫-台中,2023-10-17,1021
00919,群益台灣精選高息,43,9,34,合庫-台中,2023-10-17,1021
2369,菱生,37,4,33,合庫-台中,2023-10-17,1021
00674R,期元大S＆P黃金反1,30,0,30,合庫-台中,2023-10-17,1021
00665L,富邦�琤肭磪囓�2,46,18,28,合庫-台中,2023-10-17,1021
2317,鴻海,26,1,25,合庫-台中,2023-10-17,1021
2243,宏旭-KY,25,0,25,合庫-台中,2023-10-17,1021
3163,波若威,91,67,24,合庫-台中,2023-10-17,1021
1609,大亞,52,28,24,合庫-台中,2023-10-17,1021
00922,國泰台灣領袖50,23,1,22,合庫-台中,2023-10-17,1021
5210,寶碩,22,0,22,合庫-台中,2023-10-17,1021
2601,益航,21,0,21,合庫-台中,2023-10-17,1021
00680L,元大美債20正2,20,0,20,合庫-台中,2023-10-17,1021
2801,彰銀,20,0,20,合庫-台中,2023-10-17,1021
1447,力鵬,20,0,20,合庫-台中,2023-10-17,1021
1444,力麗,40,20,20,合庫-台中,2023-10-17,1021
2363,矽統,498,478,20,合庫-台中,2023-10-17,1021
2301,光寶科,46,27,19,合庫-台中,2023-10-17,1021
00878,國泰永續高股息,52,34,18,合庫-台中,2023-10-17,1021
1504,東元,25,7,18,合庫-台中,2023-10-17,1021
1524,耿鼎,23,6,17,合庫-台中,2023-10-17,1021
4938,和碩,18,1,17,合庫-台中,2023-10-17,1021
8033,雷虎,19,2,17,合庫-台中,2023-10-17,1021
2371,大同,27,10,17,合庫-台中,2023-10-17,1021
5351,鈺創,20,3,17,合庫-台中,2023-10-17,1021
2201,裕隆,29,13,16,合庫-台中,2023-10-17,1021
9907,統一實,20,4,16,合庫-台中,2023-10-17,1021
4706,大恭,16,0,16,合庫-台中,2023-10-17,1021
6530,創威,52,36,16,合庫-台中,2023-10-17,1021
2883,凱基金,246,46,200,合庫-台中,2023-10-18,1021
00878,國泰永續高股息,200,16,184,合庫-台中,2023-10-18,1021
00673R,期元大S＆P原油反1,117,0,117,合庫-台中,2023-10-18,1021
00929,復華台灣科技優息,227,110,117,合庫-台中,2023-10-18,1021
6419,京晨科,134,25,109,合庫-台中,2023-10-18,1021
2002,中鋼,129,21,108,合庫-台中,2023-10-18,1021
00679B,元大美債20年,105,0,105,合庫-台中,2023-10-18,1021
0056,元大高股息,214,133,81,合庫-台中,2023-10-18,1021
1102,亞泥,84,4,80,合庫-台中,2023-10-18,1021
1101,台泥,83,7,76,合庫-台中,2023-10-18,1021
00922,國泰台灣領袖50,75,0,75,合庫-台中,2023-10-18,1021
00680L,元大美債20正2,70,0,70,合庫-台中,2023-10-18,1021
00919,群益台灣精選高息,78,17,61,合庫-台中,2023-10-18,1021
2409,友達,93,33,60,合庫-台中,2023-10-18,1021
1444,力麗,62,7,55,合庫-台中,2023-10-18,1021
00885,富邦越南,67,13,54,合庫-台中,2023-10-18,1021
2105,正新,52,1,51,合庫-台中,2023-10-18,1021
2867,三商壽,50,4,46,合庫-台中,2023-10-18,1021
00687B,國泰20年美債,46,0,46,合庫-台中,2023-10-18,1021
6282,康舒,101,57,44,合庫-台中,2023-10-18,1021
6288,聯嘉,45,2,43,合庫-台中,2023-10-18,1021
2881,富邦金,51,9,42,合庫-台中,2023-10-18,1021
2610,華航,60,19,41,合庫-台中,2023-10-18,1021
00751B,元大AAA至A公司債,41,2,39,合庫-台中,2023-10-18,1021
3588,通嘉,56,18,38,合庫-台中,2023-10-18,1021
6530,創威,70,32,38,合庫-台中,2023-10-18,1021
3701,大眾控,36,2,34,合庫-台中,2023-10-18,1021
2614,東森,31,1,30,合庫-台中,2023-10-18,1021
4513,福裕,30,0,30,合庫-台中,2023-10-18,1021
1609,大亞,32,2,30,合庫-台中,2023-10-18,1021
2515,中工,78,49,29,合庫-台中,2023-10-18,1021
4960,誠美材,96,68,28,合庫-台中,2023-10-18,1021
5011,久陽,27,0,27,合庫-台中,2023-10-18,1021
3715,定穎投控,213,188,25,合庫-台中,2023-10-18,1021
6231,系微,28,3,25,合庫-台中,2023-10-18,1021
2243,宏旭-KY,25,0,25,合庫-台中,2023-10-18,1021
2382,廣達,104,79,25,合庫-台中,2023-10-18,1021
3163,波若威,37,13,24,合庫-台中,2023-10-18,1021
6128,上福,24,0,24,合庫-台中,2023-10-18,1021
3234,光環,24,2,22,合庫-台中,2023-10-18,1021
6531,愛普*,31,10,21,合庫-台中,2023-10-18,1021
00888,永豐台灣ESG,23,2,21,合庫-台中,2023-10-18,1021
00932,兆豐永續高息等權,20,0,20,合庫-台中,2023-10-18,1021
1802,台玻,22,2,20,合庫-台中,2023-10-18,1021
4541,晟田,20,0,20,合庫-台中,2023-10-18,1021
2485,兆赫,18,0,18,合庫-台中,2023-10-18,1021
6146,耕興,18,0,18,合庫-台中,2023-10-18,1021
6841,長佳智能,17,0,17,合庫-台中,2023-10-18,1021
00931B,統一美債20年,16,0,16,合庫-台中,2023-10-18,1021
2388,威盛,144,128,16,合庫-台中,2023-10-18,1021
00680L,元大美債20正2,400,0,400,合庫-台中,2023-10-19,1021
0056,元大高股息,220,61,159,合庫-台中,2023-10-19,1021
00929,復華台灣科技優息,230,82,148,合庫-台中,2023-10-19,1021
00637L,元大滬深300正2,146,16,130,合庫-台中,2023-10-19,1021
2618,長榮航,169,45,124,合庫-台中,2023-10-19,1021
2883,凱基金,127,18,109,合庫-台中,2023-10-19,1021
00933B,國泰10Y+金融債,93,0,93,合庫-台中,2023-10-19,1021
2002,中鋼,88,1,87,合庫-台中,2023-10-19,1021
00648R,元大S＆P500反1,80,0,80,合庫-台中,2023-10-19,1021
00878,國泰永續高股息,93,13,80,合庫-台中,2023-10-19,1021
00720B,元大投資級公司債,78,1,77,合庫-台中,2023-10-19,1021
00885,富邦越南,73,0,73,合庫-台中,2023-10-19,1021
00922,國泰台灣領袖50,67,0,67,合庫-台中,2023-10-19,1021
1101,台泥,67,2,65,合庫-台中,2023-10-19,1021
5880,合庫金,65,1,64,合庫-台中,2023-10-19,1021
00687B,國泰20年美債,61,0,61,合庫-台中,2023-10-19,1021
5355,佳總,60,0,60,合庫-台中,2023-10-19,1021
2609,陽明,61,6,55,合庫-台中,2023-10-19,1021
2317,鴻海,57,2,55,合庫-台中,2023-10-19,1021
2369,菱生,56,2,54,合庫-台中,2023-10-19,1021
00772B,中信高評級公司債,57,4,53,合庫-台中,2023-10-19,1021
2243,宏旭-KY,52,0,52,合庫-台中,2023-10-19,1021
00679B,元大美債20年,56,5,51,合庫-台中,2023-10-19,1021
00712,復華富時不動產,51,0,51,合庫-台中,2023-10-19,1021
6419,京晨科,51,0,51,合庫-台中,2023-10-19,1021
2641,正德,50,0,50,合庫-台中,2023-10-19,1021
2834,臺企銀,100,51,49,合庫-台中,2023-10-19,1021
00753L,中信中國50正2,89,42,47,合庫-台中,2023-10-19,1021
00715L,期街口布蘭特正2,155,111,44,合庫-台中,2023-10-19,1021
2409,友達,167,125,42,合庫-台中,2023-10-19,1021
00919,群益台灣精選高息,45,5,40,合庫-台中,2023-10-19,1021
6128,上福,39,0,39,合庫-台中,2023-10-19,1021
3056,富華新,52,15,37,合庫-台中,2023-10-19,1021
2498,宏達電,44,7,37,合庫-台中,2023-10-19,1021
00900,富邦特選高股息30,35,2,33,合庫-台中,2023-10-19,1021
3523,迎輝,33,0,33,合庫-台中,2023-10-19,1021
9105,泰金寶-DR,31,0,31,合庫-台中,2023-10-19,1021
00751B,元大AAA至A公司債,30,2,28,合庫-台中,2023-10-19,1021
00665L,富邦�琤肭磪囓�2,30,2,28,合庫-台中,2023-10-19,1021
00931B,統一美債20年,28,1,27,合庫-台中,2023-10-19,1021
3481,群創,35,9,26,合庫-台中,2023-10-19,1021
2886,兆豐金,28,2,26,合庫-台中,2023-10-19,1021
00670L,富邦NASDAQ正2,53,30,23,合庫-台中,2023-10-19,1021
00773B,中信優先金融債,26,3,23,合庫-台中,2023-10-19,1021
2303,聯電,146,123,23,合庫-台中,2023-10-19,1021
6901,鑽石投資,29,7,22,合庫-台中,2023-10-19,1021
2105,正新,21,0,21,合庫-台中,2023-10-19,1021
6118,建達,21,0,21,合庫-台中,2023-10-19,1021
1504,東元,22,1,21,合庫-台中,2023-10-19,1021
2388,威盛,131,111,20,合庫-台中,2023-10-19,1021
2883,凱基金,277,14,263,合庫-台中,2023-10-20,1021
00712,復華富時不動產,165,31,134,合庫-台中,2023-10-20,1021
00878,國泰永續高股息,154,39,115,合庫-台中,2023-10-20,1021
2002,中鋼,104,0,104,合庫-台中,2023-10-20,1021
2891,中信金,102,2,100,合庫-台中,2023-10-20,1021
0056,元大高股息,120,35,85,合庫-台中,2023-10-20,1021
00670L,富邦NASDAQ正2,81,0,81,合庫-台中,2023-10-20,1021
2867,三商壽,81,0,81,合庫-台中,2023-10-20,1021
3481,群創,111,33,78,合庫-台中,2023-10-20,1021
2363,矽統,104,28,76,合庫-台中,2023-10-20,1021
2888,新光金,75,0,75,合庫-台中,2023-10-20,1021
6419,京晨科,65,0,65,合庫-台中,2023-10-20,1021
2834,臺企銀,92,29,63,合庫-台中,2023-10-20,1021
9928,中視,64,2,62,合庫-台中,2023-10-20,1021
00680L,元大美債20正2,61,0,61,合庫-台中,2023-10-20,1021
00885,富邦越南,67,6,61,合庫-台中,2023-10-20,1021
2606,裕民,53,0,53,合庫-台中,2023-10-20,1021
9907,統一實,51,0,51,合庫-台中,2023-10-20,1021
2323,中環,49,0,49,合庫-台中,2023-10-20,1021
2609,陽明,52,7,45,合庫-台中,2023-10-20,1021
5880,合庫金,66,21,45,合庫-台中,2023-10-20,1021
2886,兆豐金,43,0,43,合庫-台中,2023-10-20,1021
2885,元大金,47,4,43,合庫-台中,2023-10-20,1021
2388,威盛,190,148,42,合庫-台中,2023-10-20,1021
6270,倍微,41,0,41,合庫-台中,2023-10-20,1021
2892,第一金,37,0,37,合庫-台中,2023-10-20,1021
00679B,元大美債20年,41,5,36,合庫-台中,2023-10-20,1021
3122,笙泉,92,56,36,合庫-台中,2023-10-20,1021
3006,晶豪科,39,4,35,合庫-台中,2023-10-20,1021
1101,台泥,40,7,33,合庫-台中,2023-10-20,1021
00919,群益台灣精選高息,61,28,33,合庫-台中,2023-10-20,1021
2605,新興,60,29,31,合庫-台中,2023-10-20,1021
6284,佳邦,31,0,31,合庫-台中,2023-10-20,1021
1609,大亞,28,1,27,合庫-台中,2023-10-20,1021
3264,欣銓,40,13,27,合庫-台中,2023-10-20,1021
3005,神基,27,0,27,合庫-台中,2023-10-20,1021
1605,華新,26,1,25,合庫-台中,2023-10-20,1021
3523,迎輝,25,0,25,合庫-台中,2023-10-20,1021
00687B,國泰20年美債,42,18,24,合庫-台中,2023-10-20,1021
3276,宇環,33,9,24,合庫-台中,2023-10-20,1021
3545,敦泰,40,16,24,合庫-台中,2023-10-20,1021
2243,宏旭-KY,25,1,24,合庫-台中,2023-10-20,1021
00933B,國泰10Y+金融債,24,0,24,合庫-台中,2023-10-20,1021
4908,前鼎,53,31,22,合庫-台中,2023-10-20,1021
4979,華星光,21,0,21,合庫-台中,2023-10-20,1021
3576,聯合再生,21,1,20,合庫-台中,2023-10-20,1021
2601,益航,20,0,20,合庫-台中,2023-10-20,1021
1714,和桐,20,0,20,合庫-台中,2023-10-20,1021
6288,聯嘉,20,0,20,合庫-台中,2023-10-20,1021
2241,艾姆勒,20,0,20,合庫-台中,2023-10-20,1021
00929,復華台灣科技優息,212,14,198,合庫-台中,2023-10-23,1021
0056,元大高股息,155,15,140,合庫-台中,2023-10-23,1021
00712,復華富時不動產,130,2,128,合庫-台中,2023-10-23,1021
2317,鴻海,122,12,110,合庫-台中,2023-10-23,1021
00919,群益台灣精選高息,107,8,99,合庫-台中,2023-10-23,1021
2457,飛宏,78,2,76,合庫-台中,2023-10-23,1021
2313,華通,101,26,75,合庫-台中,2023-10-23,1021
00878,國泰永續高股息,86,17,69,合庫-台中,2023-10-23,1021
00670L,富邦NASDAQ正2,67,0,67,合庫-台中,2023-10-23,1021
3523,迎輝,65,0,65,合庫-台中,2023-10-23,1021
3041,揚智,72,11,61,合庫-台中,2023-10-23,1021
00679B,元大美債20年,59,0,59,合庫-台中,2023-10-23,1021
6419,京晨科,58,0,58,合庫-台中,2023-10-23,1021
00715L,期街口布蘭特正2,83,35,48,合庫-台中,2023-10-23,1021
2409,友達,114,67,47,合庫-台中,2023-10-23,1021
00933B,國泰10Y+金融債,57,10,47,合庫-台中,2023-10-23,1021
3481,群創,61,18,43,合庫-台中,2023-10-23,1021
2618,長榮航,107,65,42,合庫-台中,2023-10-23,1021
5880,合庫金,43,2,41,合庫-台中,2023-10-23,1021
3711,日月光投控,53,13,40,合庫-台中,2023-10-23,1021
8150,南茂,55,15,40,合庫-台中,2023-10-23,1021
00923,群益台ESG低碳50,38,0,38,合庫-台中,2023-10-23,1021
2883,凱基金,40,5,35,合庫-台中,2023-10-23,1021
2002,中鋼,39,6,33,合庫-台中,2023-10-23,1021
2330,台積電,34,3,31,合庫-台中,2023-10-23,1021
4102,永日,31,0,31,合庫-台中,2023-10-23,1021
00922,國泰台灣領袖50,33,2,31,合庫-台中,2023-10-23,1021
00720B,元大投資級公司債,30,0,30,合庫-台中,2023-10-23,1021
2312,金寶,30,2,28,合庫-台中,2023-10-23,1021
6282,康舒,96,70,26,合庫-台中,2023-10-23,1021
2382,廣達,50,25,25,合庫-台中,2023-10-23,1021
2888,新光金,53,28,25,合庫-台中,2023-10-23,1021
00795B,中信美國公債20年,26,2,24,合庫-台中,2023-10-23,1021
3006,晶豪科,64,42,22,合庫-台中,2023-10-23,1021
006208,富邦台50,21,0,21,合庫-台中,2023-10-23,1021
1723,中碳,23,2,21,合庫-台中,2023-10-23,1021
2388,威盛,103,82,21,合庫-台中,2023-10-23,1021
2344,華邦電,24,3,21,合庫-台中,2023-10-23,1021
00772B,中信高評級公司債,23,2,21,合庫-台中,2023-10-23,1021
2610,華航,28,8,20,合庫-台中,2023-10-23,1021
2812,台中銀,55,37,18,合庫-台中,2023-10-23,1021
00888,永豐台灣ESG,17,0,17,合庫-台中,2023-10-23,1021
2542,興富發,16,0,16,合庫-台中,2023-10-23,1021
2891,中信金,36,21,15,合庫-台中,2023-10-23,1021
1524,耿鼎,15,0,15,合庫-台中,2023-10-23,1021
2338,光罩,16,1,15,合庫-台中,2023-10-23,1021
3706,神達,23,8,15,合庫-台中,2023-10-23,1021
00665L,富邦�琤肭磪囓�2,15,0,15,合庫-台中,2023-10-23,1021
3576,聯合再生,15,1,14,合庫-台中,2023-10-23,1021
00642U,期元大S＆P石油,14,0,14,合庫-台中,2023-10-23,1021
2317,鴻海,156,28,128,合庫-台中,2023-10-24,1021
3481,群創,162,38,124,合庫-台中,2023-10-24,1021
00720B,元大投資級公司債,102,2,100,合庫-台中,2023-10-24,1021
3523,迎輝,73,0,73,合庫-台中,2023-10-24,1021
5880,合庫金,81,10,71,合庫-台中,2023-10-24,1021
00712,復華富時不動產,74,8,66,合庫-台中,2023-10-24,1021
2369,菱生,191,126,65,合庫-台中,2023-10-24,1021
3122,笙泉,115,51,64,合庫-台中,2023-10-24,1021
2449,京元電子,83,19,64,合庫-台中,2023-10-24,1021
2486,一詮,66,5,61,合庫-台中,2023-10-24,1021
2367,燿華,49,5,44,合庫-台中,2023-10-24,1021
2887,台新金,44,0,44,合庫-台中,2023-10-24,1021
00715L,期街口布蘭特正2,61,17,44,合庫-台中,2023-10-24,1021
2891,中信金,43,0,43,合庫-台中,2023-10-24,1021
2409,友達,70,30,40,合庫-台中,2023-10-24,1021
00648R,元大S＆P500反1,40,4,36,合庫-台中,2023-10-24,1021
2388,威盛,59,25,34,合庫-台中,2023-10-24,1021
3049,精金,32,0,32,合庫-台中,2023-10-24,1021
3231,緯創,246,214,32,合庫-台中,2023-10-24,1021
3715,定穎投控,81,49,32,合庫-台中,2023-10-24,1021
00878,國泰永續高股息,44,14,30,合庫-台中,2023-10-24,1021
2014,中鴻,30,1,29,合庫-台中,2023-10-24,1021
6117,迎廣,32,3,29,合庫-台中,2023-10-24,1021
6284,佳邦,30,2,28,合庫-台中,2023-10-24,1021
3006,晶豪科,37,9,28,合庫-台中,2023-10-24,1021
00929,復華台灣科技優息,103,75,28,合庫-台中,2023-10-24,1021
2888,新光金,52,25,27,合庫-台中,2023-10-24,1021
00637L,元大滬深300正2,74,48,26,合庫-台中,2023-10-24,1021
2371,大同,43,18,25,合庫-台中,2023-10-24,1021
6419,京晨科,24,0,24,合庫-台中,2023-10-24,1021
6270,倍微,23,0,23,合庫-台中,2023-10-24,1021
2313,華通,143,121,22,合庫-台中,2023-10-24,1021
2884,玉山金,23,2,21,合庫-台中,2023-10-24,1021
00888,永豐台灣ESG,20,0,20,合庫-台中,2023-10-24,1021
6770,力積電,23,3,20,合庫-台中,2023-10-24,1021
9955,佳龍,22,2,20,合庫-台中,2023-10-24,1021
6120,達運,20,0,20,合庫-台中,2023-10-24,1021
2883,凱基金,43,26,17,合庫-台中,2023-10-24,1021
2002,中鋼,45,28,17,合庫-台中,2023-10-24,1021
2408,南亞科,17,1,16,合庫-台中,2023-10-24,1021
00885,富邦越南,25,10,15,合庫-台中,2023-10-24,1021
2886,兆豐金,16,1,15,合庫-台中,2023-10-24,1021
6168,宏齊,89,74,15,合庫-台中,2023-10-24,1021
2201,裕隆,15,0,15,合庫-台中,2023-10-24,1021
1514,亞力,20,6,14,合庫-台中,2023-10-24,1021
2243,宏旭-KY,14,0,14,合庫-台中,2023-10-24,1021
1449,佳和,14,0,14,合庫-台中,2023-10-24,1021
1101,台泥,13,0,13,合庫-台中,2023-10-24,1021
1301,台塑,13,0,13,合庫-台中,2023-10-24,1021
00919,群益台灣精選高息,27,15,12,合庫-台中,2023-10-24,1021
4950,牧東,607,5,602,合庫-台中,2023-10-25,1021
3041,揚智,385,93,292,合庫-台中,2023-10-25,1021
00715L,期街口布蘭特正2,246,14,232,合庫-台中,2023-10-25,1021
00712,復華富時不動產,222,0,222,合庫-台中,2023-10-25,1021
6282,康舒,254,47,207,合庫-台中,2023-10-25,1021
2516,新建,191,0,191,合庫-台中,2023-10-25,1021
3523,迎輝,107,0,107,合庫-台中,2023-10-25,1021
00900,富邦特選高股息30,106,0,106,合庫-台中,2023-10-25,1021
2610,華航,115,18,97,合庫-台中,2023-10-25,1021
00919,群益台灣精選高息,101,5,96,合庫-台中,2023-10-25,1021
5880,合庫金,100,6,94,合庫-台中,2023-10-25,1021
6284,佳邦,85,2,83,合庫-台中,2023-10-25,1021
2880,華南金,80,0,80,合庫-台中,2023-10-25,1021
2369,菱生,250,172,78,合庫-台中,2023-10-25,1021
2442,新美齊,76,0,76,合庫-台中,2023-10-25,1021
2834,臺企銀,62,10,52,合庫-台中,2023-10-25,1021
3078,僑威,88,37,51,合庫-台中,2023-10-25,1021
5355,佳總,50,0,50,合庫-台中,2023-10-25,1021
2317,鴻海,79,34,45,合庫-台中,2023-10-25,1021
3025,星通,72,27,45,合庫-台中,2023-10-25,1021
6419,京晨科,44,0,44,合庫-台中,2023-10-25,1021
9105,泰金寶-DR,42,0,42,合庫-台中,2023-10-25,1021
3450,聯鈞,78,36,42,合庫-台中,2023-10-25,1021
00931B,統一美債20年,42,0,42,合庫-台中,2023-10-25,1021
2618,長榮航,57,20,37,合庫-台中,2023-10-25,1021
1524,耿鼎,101,64,37,合庫-台中,2023-10-25,1021
4960,誠美材,61,25,36,合庫-台中,2023-10-25,1021
00902,中信電池及儲能,36,0,36,合庫-台中,2023-10-25,1021
2354,鴻準,36,1,35,合庫-台中,2023-10-25,1021
00878,國泰永續高股息,57,26,31,合庫-台中,2023-10-25,1021
00642U,期元大S＆P石油,31,0,31,合庫-台中,2023-10-25,1021
3006,晶豪科,33,2,31,合庫-台中,2023-10-25,1021
2363,矽統,65,34,31,合庫-台中,2023-10-25,1021
3044,健鼎,34,4,30,合庫-台中,2023-10-25,1021
00929,復華台灣科技優息,42,15,27,合庫-台中,2023-10-25,1021
00922,國泰台灣領袖50,26,0,26,合庫-台中,2023-10-25,1021
2323,中環,25,0,25,合庫-台中,2023-10-25,1021
0056,元大高股息,38,14,24,合庫-台中,2023-10-25,1021
1605,華新,27,5,22,合庫-台中,2023-10-25,1021
3715,定穎投控,92,70,22,合庫-台中,2023-10-25,1021
1101,台泥,23,2,21,合庫-台中,2023-10-25,1021
2344,華邦電,23,2,21,合庫-台中,2023-10-25,1021
4967,十銓,31,10,21,合庫-台中,2023-10-25,1021
3234,光環,34,14,20,合庫-台中,2023-10-25,1021
6016,康和證,22,2,20,合庫-台中,2023-10-25,1021
8016,矽創,20,0,20,合庫-台中,2023-10-25,1021
00885,富邦越南,19,0,19,合庫-台中,2023-10-25,1021
5210,寶碩,36,20,16,合庫-台中,2023-10-25,1021
6139,亞翔,88,72,16,合庫-台中,2023-10-25,1021
2883,凱基金,40,25,15,合庫-台中,2023-10-25,1021
00929,復華台灣科技優息,302,32,270,合庫-台中,2023-10-26,1021
2610,華航,179,11,168,合庫-台中,2023-10-26,1021
00670L,富邦NASDAQ正2,151,10,141,合庫-台中,2023-10-26,1021
00680L,元大美債20正2,121,0,121,合庫-台中,2023-10-26,1021
00650L,復華香港正2,118,0,118,合庫-台中,2023-10-26,1021
00919,群益台灣精選高息,118,0,118,合庫-台中,2023-10-26,1021
6282,康舒,112,0,112,合庫-台中,2023-10-26,1021
0056,元大高股息,110,2,108,合庫-台中,2023-10-26,1021
2883,凱基金,102,3,99,合庫-台中,2023-10-26,1021
00885,富邦越南,105,10,95,合庫-台中,2023-10-26,1021
00712,復華富時不動產,94,2,92,合庫-台中,2023-10-26,1021
2303,聯電,174,88,86,合庫-台中,2023-10-26,1021
1712,興農,73,0,73,合庫-台中,2023-10-26,1021
00878,國泰永續高股息,82,9,73,合庫-台中,2023-10-26,1021
2887,台新金,64,0,64,合庫-台中,2023-10-26,1021
2344,華邦電,102,43,59,合庫-台中,2023-10-26,1021
4552,力達-KY,57,4,53,合庫-台中,2023-10-26,1021
2330,台積電,54,3,51,合庫-台中,2023-10-26,1021
00902,中信電池及儲能,69,20,49,合庫-台中,2023-10-26,1021
3523,迎輝,49,0,49,合庫-台中,2023-10-26,1021
00900,富邦特選高股息30,49,0,49,合庫-台中,2023-10-26,1021
2886,兆豐金,46,3,43,合庫-台中,2023-10-26,1021
2618,長榮航,56,13,43,合庫-台中,2023-10-26,1021
00786B,元大10年IG銀行債,42,0,42,合庫-台中,2023-10-26,1021
00787B,元大10年IG醫療債,42,0,42,合庫-台中,2023-10-26,1021
6419,京晨科,41,0,41,合庫-台中,2023-10-26,1021
5880,合庫金,87,46,41,合庫-台中,2023-10-26,1021
2409,友達,51,12,39,合庫-台中,2023-10-26,1021
2317,鴻海,57,19,38,合庫-台中,2023-10-26,1021
3078,僑威,46,8,38,合庫-台中,2023-10-26,1021
2388,威盛,53,16,37,合庫-台中,2023-10-26,1021
00788B,元大10年IG電能債,34,0,34,合庫-台中,2023-10-26,1021
6276,安鈦克,39,7,32,合庫-台中,2023-10-26,1021
2436,偉詮電,36,5,31,合庫-台中,2023-10-26,1021
3545,敦泰,30,0,30,合庫-台中,2023-10-26,1021
00753L,中信中國50正2,41,11,30,合庫-台中,2023-10-26,1021
00891,中信關鍵半導體,30,0,30,合庫-台中,2023-10-26,1021
3037,欣興,44,15,29,合庫-台中,2023-10-26,1021
2801,彰銀,28,0,28,合庫-台中,2023-10-26,1021
2891,中信金,27,1,26,合庫-台中,2023-10-26,1021
3041,揚智,29,3,26,合庫-台中,2023-10-26,1021
00687B,國泰20年美債,29,3,26,合庫-台中,2023-10-26,1021
00648R,元大S＆P500反1,30,4,26,合庫-台中,2023-10-26,1021
3704,合勤控,27,2,25,合庫-台中,2023-10-26,1021
4960,誠美材,119,94,25,合庫-台中,2023-10-26,1021
3049,精金,25,0,25,合庫-台中,2023-10-26,1021
00922,國泰台灣領袖50,24,0,24,合庫-台中,2023-10-26,1021
00923,群益台ESG低碳50,22,0,22,合庫-台中,2023-10-26,1021
9105,泰金寶-DR,22,0,22,合庫-台中,2023-10-26,1021
2337,旺宏,30,8,22,合庫-台中,2023-10-26,1021
00885,富邦越南,165,30,135,合庫-台中,2023-10-27,1021
00929,復華台灣科技優息,196,127,69,合庫-台中,2023-10-27,1021
6419,京晨科,58,0,58,合庫-台中,2023-10-27,1021
6282,康舒,55,0,55,合庫-台中,2023-10-27,1021
00712,復華富時不動產,64,10,54,合庫-台中,2023-10-27,1021
2337,旺宏,57,4,53,合庫-台中,2023-10-27,1021
3523,迎輝,50,0,50,合庫-台中,2023-10-27,1021
9928,中視,50,0,50,合庫-台中,2023-10-27,1021
3013,晟銘電,51,1,50,合庫-台中,2023-10-27,1021
8054,安國,51,4,47,合庫-台中,2023-10-27,1021
2888,新光金,63,21,42,合庫-台中,2023-10-27,1021
6243,迅杰,50,9,41,合庫-台中,2023-10-27,1021
1101,台泥,42,2,40,合庫-台中,2023-10-27,1021
2886,兆豐金,40,1,39,合庫-台中,2023-10-27,1021
3041,揚智,41,4,37,合庫-台中,2023-10-27,1021
8240,華宏,40,3,37,合庫-台中,2023-10-27,1021
2317,鴻海,59,24,35,合庫-台中,2023-10-27,1021
2243,宏旭-KY,35,0,35,合庫-台中,2023-10-27,1021
1721,三晃,86,52,34,合庫-台中,2023-10-27,1021
1417,嘉裕,30,0,30,合庫-台中,2023-10-27,1021
6231,系微,31,2,29,合庫-台中,2023-10-27,1021
3691,碩禾,28,0,28,合庫-台中,2023-10-27,1021
6116,彩晶,28,1,27,合庫-台中,2023-10-27,1021
00751B,元大AAA至A公司債,26,0,26,合庫-台中,2023-10-27,1021
3055,蔚華科,33,7,26,合庫-台中,2023-10-27,1021
2344,華邦電,34,8,26,合庫-台中,2023-10-27,1021
3324,雙鴻,27,2,25,合庫-台中,2023-10-27,1021
2618,長榮航,100,76,24,合庫-台中,2023-10-27,1021
5351,鈺創,27,3,24,合庫-台中,2023-10-27,1021
6284,佳邦,23,0,23,合庫-台中,2023-10-27,1021
2329,華泰,32,9,23,合庫-台中,2023-10-27,1021
4123,晟德,38,15,23,合庫-台中,2023-10-27,1021
2382,廣達,30,9,21,合庫-台中,2023-10-27,1021
2883,凱基金,22,1,21,合庫-台中,2023-10-27,1021
2867,三商壽,20,0,20,合庫-台中,2023-10-27,1021
6523,達爾膚,20,0,20,合庫-台中,2023-10-27,1021
5302,太欣,20,0,20,合庫-台中,2023-10-27,1021
6472,保瑞,28,10,18,合庫-台中,2023-10-27,1021
3051,力特,20,4,16,合庫-台中,2023-10-27,1021
00878,國泰永續高股息,21,5,16,合庫-台中,2023-10-27,1021
6770,力積電,16,2,14,合庫-台中,2023-10-27,1021
3260,威剛,21,8,13,合庫-台中,2023-10-27,1021
00919,群益台灣精選高息,38,25,13,合庫-台中,2023-10-27,1021
6461,益得,12,0,12,合庫-台中,2023-10-27,1021
3162,精確,11,0,11,合庫-台中,2023-10-27,1021
1303,南亞,11,0,11,合庫-台中,2023-10-27,1021
6237,驊訊,20,9,11,合庫-台中,2023-10-27,1021
3363,上詮,41,30,11,合庫-台中,2023-10-27,1021
2388,威盛,25,15,10,合庫-台中,2023-10-27,1021
5009,榮剛,16,6,10,合庫-台中,2023-10-27,1021
2317,鴻海,261,49,212,合庫-台中,2023-10-30,1021
2363,矽統,221,37,184,合庫-台中,2023-10-30,1021
00680L,元大美債20正2,150,0,150,合庫-台中,2023-10-30,1021
2867,三商壽,121,0,121,合庫-台中,2023-10-30,1021
2888,新光金,111,0,111,合庫-台中,2023-10-30,1021
2516,新建,113,7,106,合庫-台中,2023-10-30,1021
2883,凱基金,125,23,102,合庫-台中,2023-10-30,1021
00712,復華富時不動產,76,0,76,合庫-台中,2023-10-30,1021
2801,彰銀,73,0,73,合庫-台中,2023-10-30,1021
2889,國票金,82,10,72,合庫-台中,2023-10-30,1021
00878,國泰永續高股息,67,9,58,合庫-台中,2023-10-30,1021
9907,統一實,50,0,50,合庫-台中,2023-10-30,1021
2610,華航,80,35,45,合庫-台中,2023-10-30,1021
00919,群益台灣精選高息,46,4,42,合庫-台中,2023-10-30,1021
2025,千興,38,1,37,合庫-台中,2023-10-30,1021
8054,安國,45,8,37,合庫-台中,2023-10-30,1021
1760,寶齡富錦,47,10,37,合庫-台中,2023-10-30,1021
2390,云辰,136,106,30,合庫-台中,2023-10-30,1021
2330,台積電,31,4,27,合庫-台中,2023-10-30,1021
4960,誠美材,35,9,26,合庫-台中,2023-10-30,1021
3230,錦明,25,0,25,合庫-台中,2023-10-30,1021
6415,矽力*-KY,27,4,23,合庫-台中,2023-10-30,1021
5210,寶碩,23,0,23,合庫-台中,2023-10-30,1021
2002,中鋼,23,0,23,合庫-台中,2023-10-30,1021
2354,鴻準,22,0,22,合庫-台中,2023-10-30,1021
2618,長榮航,27,5,22,合庫-台中,2023-10-30,1021
00907,永豐優息存股,21,1,20,合庫-台中,2023-10-30,1021
1444,力麗,40,20,20,合庫-台中,2023-10-30,1021
2886,兆豐金,22,2,20,合庫-台中,2023-10-30,1021
2301,光寶科,22,3,19,合庫-台中,2023-10-30,1021
2405,輔信,21,3,18,合庫-台中,2023-10-30,1021
00687B,國泰20年美債,18,1,17,合庫-台中,2023-10-30,1021
6282,康舒,60,43,17,合庫-台中,2023-10-30,1021
3523,迎輝,17,1,16,合庫-台中,2023-10-30,1021
3025,星通,41,25,16,合庫-台中,2023-10-30,1021
2881,富邦金,15,0,15,合庫-台中,2023-10-30,1021
00679B,元大美債20年,15,0,15,合庫-台中,2023-10-30,1021
2376,技嘉,24,10,14,合庫-台中,2023-10-30,1021
00751B,元大AAA至A公司債,14,0,14,合庫-台中,2023-10-30,1021
3209,全科,14,0,14,合庫-台中,2023-10-30,1021
00720B,元大投資級公司債,14,0,14,合庫-台中,2023-10-30,1021
1101,台泥,13,0,13,合庫-台中,2023-10-30,1021
6695,芯鼎,13,0,13,合庫-台中,2023-10-30,1021
6117,迎廣,45,33,12,合庫-台中,2023-10-30,1021
6244,茂迪,13,1,12,合庫-台中,2023-10-30,1021
2371,大同,13,1,12,合庫-台中,2023-10-30,1021
8011,台通,12,0,12,合庫-台中,2023-10-30,1021
2884,玉山金,15,3,12,合庫-台中,2023-10-30,1021
2612,中航,11,0,11,合庫-台中,2023-10-30,1021
1471,首利,16,5,11,合庫-台中,2023-10-30,1021
00715L,期街口布蘭特正2,192,1,191,合庫-台中,2023-10-31,1021
00670L,富邦NASDAQ正2,175,2,173,合庫-台中,2023-10-31,1021
2603,長榮,167,7,160,合庫-台中,2023-10-31,1021
6282,康舒,145,1,144,合庫-台中,2023-10-31,1021
2516,新建,220,97,123,合庫-台中,2023-10-31,1021
2303,聯電,142,34,108,合庫-台中,2023-10-31,1021
3231,緯創,151,51,100,合庫-台中,2023-10-31,1021
2344,華邦電,128,33,95,合庫-台中,2023-10-31,1021
2382,廣達,158,66,92,合庫-台中,2023-10-31,1021
00878,國泰永續高股息,91,5,86,合庫-台中,2023-10-31,1021
0056,元大高股息,95,13,82,合庫-台中,2023-10-31,1021
1718,中纖,61,0,61,合庫-台中,2023-10-31,1021
2888,新光金,54,1,53,合庫-台中,2023-10-31,1021
2419,仲琦,50,2,48,合庫-台中,2023-10-31,1021
2801,彰銀,51,5,46,合庫-台中,2023-10-31,1021
2388,威盛,125,79,46,合庫-台中,2023-10-31,1021
3438,類比科,49,4,45,合庫-台中,2023-10-31,1021
2406,國碩,56,13,43,合庫-台中,2023-10-31,1021
00919,群益台灣精選高息,56,13,43,合庫-台中,2023-10-31,1021
2312,金寶,41,3,38,合庫-台中,2023-10-31,1021
6235,華孚,41,8,33,合庫-台中,2023-10-31,1021
1760,寶齡富錦,33,0,33,合庫-台中,2023-10-31,1021
6419,京晨科,32,0,32,合庫-台中,2023-10-31,1021
00679B,元大美債20年,87,56,31,合庫-台中,2023-10-31,1021
6231,系微,32,1,31,合庫-台中,2023-10-31,1021
2498,宏達電,36,5,31,合庫-台中,2023-10-31,1021
1605,華新,42,12,30,合庫-台中,2023-10-31,1021
3545,敦泰,29,0,29,合庫-台中,2023-10-31,1021
2201,裕隆,27,0,27,合庫-台中,2023-10-31,1021
00712,復華富時不動產,30,4,26,合庫-台中,2023-10-31,1021
00885,富邦越南,91,65,26,合庫-台中,2023-10-31,1021
00922,國泰台灣領袖50,25,0,25,合庫-台中,2023-10-31,1021
2417,圓剛,32,8,24,合庫-台中,2023-10-31,1021
2324,仁寶,24,0,24,合庫-台中,2023-10-31,1021
6116,彩晶,24,0,24,合庫-台中,2023-10-31,1021
2337,旺宏,32,8,24,合庫-台中,2023-10-31,1021
00632R,元大台灣50反1,33,10,23,合庫-台中,2023-10-31,1021
00918,大華優利高填息30,23,0,23,合庫-台中,2023-10-31,1021
5210,寶碩,28,6,22,合庫-台中,2023-10-31,1021
00929,復華台灣科技優息,104,83,21,合庫-台中,2023-10-31,1021
6015,宏遠證,22,1,21,合庫-台中,2023-10-31,1021
1444,力麗,50,29,21,合庫-台中,2023-10-31,1021
2330,台積電,21,0,21,合庫-台中,2023-10-31,1021
1314,中石化,20,0,20,合庫-台中,2023-10-31,1021
8996,高力,20,0,20,合庫-台中,2023-10-31,1021
5351,鈺創,33,13,20,合庫-台中,2023-10-31,1021
3041,揚智,19,0,19,合庫-台中,2023-10-31,1021
00932,兆豐永續高息等權,19,0,19,合庫-台中,2023-10-31,1021
3055,蔚華科,20,1,19,合庫-台中,2023-10-31,1021
4960,誠美材,48,30,18,合庫-台中,2023-10-31,1021
00934,中信成長高股息,275,5,270,合庫-台中,2023-11-01,1021
3523,迎輝,214,12,202,合庫-台中,2023-11-01,1021
00885,富邦越南,184,70,114,合庫-台中,2023-11-01,1021
00929,復華台灣科技優息,133,20,113,合庫-台中,2023-11-01,1021
00878,國泰永續高股息,134,37,97,合庫-台中,2023-11-01,1021
2317,鴻海,87,9,78,合庫-台中,2023-11-01,1021
2303,聯電,85,18,67,合庫-台中,2023-11-01,1021
3372,典範,60,1,59,合庫-台中,2023-11-01,1021
6282,康舒,63,9,54,合庫-台中,2023-11-01,1021
6419,京晨科,54,0,54,合庫-台中,2023-11-01,1021
1760,寶齡富錦,64,15,49,合庫-台中,2023-11-01,1021
00715L,期街口布蘭特正2,47,0,47,合庫-台中,2023-11-01,1021
2883,凱基金,64,18,46,合庫-台中,2023-11-01,1021
00671R,富邦NASDAQ反1,44,0,44,合庫-台中,2023-11-01,1021
1714,和桐,40,0,40,合庫-台中,2023-11-01,1021
00935,野村臺灣新科技50,37,0,37,合庫-台中,2023-11-01,1021
00679B,元大美債20年,36,0,36,合庫-台中,2023-11-01,1021
6770,力積電,45,11,34,合庫-台中,2023-11-01,1021
3481,群創,118,85,33,合庫-台中,2023-11-01,1021
5469,瀚宇博,72,42,30,合庫-台中,2023-11-01,1021
2610,華航,49,19,30,合庫-台中,2023-11-01,1021
00712,復華富時不動產,25,0,25,合庫-台中,2023-11-01,1021
00680L,元大美債20正2,35,10,25,合庫-台中,2023-11-01,1021
2409,友達,35,12,23,合庫-台中,2023-11-01,1021
6182,合晶,22,1,21,合庫-台中,2023-11-01,1021
00670L,富邦NASDAQ正2,20,0,20,合庫-台中,2023-11-01,1021
1219,福壽,20,0,20,合庫-台中,2023-11-01,1021
2601,益航,21,1,20,合庫-台中,2023-11-01,1021
00687B,國泰20年美債,24,5,19,合庫-台中,2023-11-01,1021
2382,廣達,37,18,19,合庫-台中,2023-11-01,1021
00919,群益台灣精選高息,19,2,17,合庫-台中,2023-11-01,1021
4162,智擎,31,14,17,合庫-台中,2023-11-01,1021
2344,華邦電,18,1,17,合庫-台中,2023-11-01,1021
4108,懷特,17,0,17,合庫-台中,2023-11-01,1021
1444,力麗,40,23,17,合庫-台中,2023-11-01,1021
3702,大聯大,35,18,17,合庫-台中,2023-11-01,1021
4167,松瑞藥,20,4,16,合庫-台中,2023-11-01,1021
1604,聲寶,15,0,15,合庫-台中,2023-11-01,1021
3050,鈺德,15,0,15,合庫-台中,2023-11-01,1021
6492,生華科,19,4,15,合庫-台中,2023-11-01,1021
00932,兆豐永續高息等權,19,4,15,合庫-台中,2023-11-01,1021
00751B,元大AAA至A公司債,14,0,14,合庫-台中,2023-11-01,1021
6117,迎廣,27,14,13,合庫-台中,2023-11-01,1021
1471,首利,13,0,13,合庫-台中,2023-11-01,1021
2886,兆豐金,19,6,13,合庫-台中,2023-11-01,1021
1504,東元,11,0,11,合庫-台中,2023-11-01,1021
2889,國票金,11,0,11,合庫-台中,2023-11-01,1021
2328,廣宇,12,1,11,合庫-台中,2023-11-01,1021
6472,保瑞,26,16,10,合庫-台中,2023-11-01,1021
6443,元晶,10,0,10,合庫-台中,2023-11-01,1021
00669R,國泰美國道瓊反1,195,50,145,合庫-台中,2023-11-02,1021
1815,富喬,202,71,131,合庫-台中,2023-11-02,1021
2883,凱基金,125,15,110,合庫-台中,2023-11-02,1021
6419,京晨科,142,54,88,合庫-台中,2023-11-02,1021
3523,迎輝,62,0,62,合庫-台中,2023-11-02,1021
2801,彰銀,60,3,57,合庫-台中,2023-11-02,1021
00934,中信成長高股息,103,50,53,合庫-台中,2023-11-02,1021
00671R,富邦NASDAQ反1,48,0,48,合庫-台中,2023-11-02,1021
9105,泰金寶-DR,137,93,44,合庫-台中,2023-11-02,1021
00885,富邦越南,101,57,44,合庫-台中,2023-11-02,1021
1447,力鵬,42,0,42,合庫-台中,2023-11-02,1021
3715,定穎投控,112,72,40,合庫-台中,2023-11-02,1021
2886,兆豐金,52,13,39,合庫-台中,2023-11-02,1021
00688L,國泰20年美債正2,40,5,35,合庫-台中,2023-11-02,1021
6016,康和證,30,0,30,合庫-台中,2023-11-02,1021
2882,國泰金,31,1,30,合庫-台中,2023-11-02,1021
4167,松瑞藥,38,9,29,合庫-台中,2023-11-02,1021
6117,迎廣,34,7,27,合庫-台中,2023-11-02,1021
00679B,元大美債20年,28,5,23,合庫-台中,2023-11-02,1021
4915,致伸,24,1,23,合庫-台中,2023-11-02,1021
2888,新光金,52,29,23,合庫-台中,2023-11-02,1021
8213,志超,20,0,20,合庫-台中,2023-11-02,1021
2498,宏達電,29,9,20,合庫-台中,2023-11-02,1021
5483,中美晶,38,18,20,合庫-台中,2023-11-02,1021
00720B,元大投資級公司債,20,0,20,合庫-台中,2023-11-02,1021
00929,復華台灣科技優息,130,112,18,合庫-台中,2023-11-02,1021
6290,良維,25,7,18,合庫-台中,2023-11-02,1021
6274,台燿,41,23,18,合庫-台中,2023-11-02,1021
4128,中天,17,0,17,合庫-台中,2023-11-02,1021
00882,中信中國高股息,17,0,17,合庫-台中,2023-11-02,1021
5210,寶碩,16,0,16,合庫-台中,2023-11-02,1021
00637L,元大滬深300正2,20,5,15,合庫-台中,2023-11-02,1021
4960,誠美材,18,3,15,合庫-台中,2023-11-02,1021
9928,中視,13,0,13,合庫-台中,2023-11-02,1021
3094,聯傑,44,32,12,合庫-台中,2023-11-02,1021
3025,星通,24,13,11,合庫-台中,2023-11-02,1021
2457,飛宏,23,13,10,合庫-台中,2023-11-02,1021
1506,正道,10,0,10,合庫-台中,2023-11-02,1021
6552,易華電,10,0,10,合庫-台中,2023-11-02,1021
00653L,富邦印度正2,10,0,10,合庫-台中,2023-11-02,1021
2547,日勝生,10,0,10,合庫-台中,2023-11-02,1021
8048,德勝,12,2,10,合庫-台中,2023-11-02,1021
00753L,中信中國50正2,12,2,10,合庫-台中,2023-11-02,1021
6233,旺玖,16,6,10,合庫-台中,2023-11-02,1021
2732,六角,11,1,10,合庫-台中,2023-11-02,1021
00715L,期街口布蘭特正2,11,1,10,合庫-台中,2023-11-02,1021
00902,中信電池及儲能,10,0,10,合庫-台中,2023-11-02,1021
4950,牧東,10,0,10,合庫-台中,2023-11-02,1021
3689,湧德,10,0,10,合庫-台中,2023-11-02,1021
5432,新門,10,0,10,合庫-台中,2023-11-02,1021
4950,牧東,202,25,177,合庫-台中,2023-11-03,1021
2887,台新金,150,0,150,合庫-台中,2023-11-03,1021
00669R,國泰美國道瓊反1,102,0,102,合庫-台中,2023-11-03,1021
6419,京晨科,105,9,96,合庫-台中,2023-11-03,1021
2317,鴻海,140,53,87,合庫-台中,2023-11-03,1021
2363,矽統,391,313,78,合庫-台中,2023-11-03,1021
3231,緯創,102,35,67,合庫-台中,2023-11-03,1021
9105,泰金寶-DR,62,2,60,合庫-台中,2023-11-03,1021
3523,迎輝,58,1,57,合庫-台中,2023-11-03,1021
00648R,元大S＆P500反1,102,50,52,合庫-台中,2023-11-03,1021
6016,康和證,50,0,50,合庫-台中,2023-11-03,1021
2457,飛宏,51,2,49,合庫-台中,2023-11-03,1021
3006,晶豪科,90,47,43,合庫-台中,2023-11-03,1021
00671R,富邦NASDAQ反1,42,0,42,合庫-台中,2023-11-03,1021
00688L,國泰20年美債正2,60,22,38,合庫-台中,2023-11-03,1021
00712,復華富時不動產,58,22,36,合庫-台中,2023-11-03,1021
8150,南茂,42,6,36,合庫-台中,2023-11-03,1021
2867,三商壽,35,0,35,合庫-台中,2023-11-03,1021
00878,國泰永續高股息,51,21,30,合庫-台中,2023-11-03,1021
6237,驊訊,126,98,28,合庫-台中,2023-11-03,1021
6288,聯嘉,32,4,28,合庫-台中,2023-11-03,1021
3260,威剛,38,10,28,合庫-台中,2023-11-03,1021
2369,菱生,31,4,27,合庫-台中,2023-11-03,1021
00687B,國泰20年美債,36,10,26,合庫-台中,2023-11-03,1021
00933B,國泰10Y+金融債,26,0,26,合庫-台中,2023-11-03,1021
00934,中信成長高股息,30,5,25,合庫-台中,2023-11-03,1021
2427,三商電,24,0,24,合庫-台中,2023-11-03,1021
8068,全達,25,1,24,合庫-台中,2023-11-03,1021
2892,第一金,34,12,22,合庫-台中,2023-11-03,1021
2458,義隆,24,3,21,合庫-台中,2023-11-03,1021
1432,大魯閣,20,0,20,合庫-台中,2023-11-03,1021
9946,三發地產,20,0,20,合庫-台中,2023-11-03,1021
1447,力鵬,20,0,20,合庫-台中,2023-11-03,1021
00690,兆豐藍籌30,25,5,20,合庫-台中,2023-11-03,1021
2356,英業達,49,29,20,合庫-台中,2023-11-03,1021
2634,漢翔,72,53,19,合庫-台中,2023-11-03,1021
6443,元晶,21,2,19,合庫-台中,2023-11-03,1021
3078,僑威,27,8,19,合庫-台中,2023-11-03,1021
2344,華邦電,27,8,19,合庫-台中,2023-11-03,1021
6282,康舒,21,2,19,合庫-台中,2023-11-03,1021
00927,群益半導體收益,25,7,18,合庫-台中,2023-11-03,1021
00772B,中信高評級公司債,18,1,17,合庫-台中,2023-11-03,1021
5880,合庫金,33,16,17,合庫-台中,2023-11-03,1021
00720B,元大投資級公司債,22,5,17,合庫-台中,2023-11-03,1021
2382,廣達,26,10,16,合庫-台中,2023-11-03,1021
00631L,元大台灣50正2,330,314,16,合庫-台中,2023-11-03,1021
1471,首利,15,0,15,合庫-台中,2023-11-03,1021
6901,鑽石投資,15,0,15,合庫-台中,2023-11-03,1021
2618,長榮航,218,203,15,合庫-台中,2023-11-03,1021
4927,泰鼎-KY,15,0,15,合庫-台中,2023-11-03,1021
2618,長榮航,712,46,666,合庫-台中,2023-11-06,1021
00632R,元大台灣50反1,448,63,385,合庫-台中,2023-11-06,1021
4950,牧東,481,124,357,合庫-台中,2023-11-06,1021
2363,矽統,560,297,263,合庫-台中,2023-11-06,1021
2883,凱基金,273,13,260,合庫-台中,2023-11-06,1021
00669R,國泰美國道瓊反1,108,0,108,合庫-台中,2023-11-06,1021
2634,漢翔,105,8,97,合庫-台中,2023-11-06,1021
2002,中鋼,120,23,97,合庫-台中,2023-11-06,1021
00715L,期街口布蘭特正2,94,0,94,合庫-台中,2023-11-06,1021
00631L,元大台灣50正2,281,200,81,合庫-台中,2023-11-06,1021
00690,兆豐藍籌30,75,0,75,合庫-台中,2023-11-06,1021
2388,威盛,365,303,62,合庫-台中,2023-11-06,1021
00935,野村臺灣新科技50,56,2,54,合庫-台中,2023-11-06,1021
00934,中信成長高股息,64,17,47,合庫-台中,2023-11-06,1021
3094,聯傑,116,74,42,合庫-台中,2023-11-06,1021
00720B,元大投資級公司債,40,0,40,合庫-台中,2023-11-06,1021
2610,華航,68,28,40,合庫-台中,2023-11-06,1021
3523,迎輝,38,0,38,合庫-台中,2023-11-06,1021
00919,群益台灣精選高息,49,13,36,合庫-台中,2023-11-06,1021
6419,京晨科,42,9,33,合庫-台中,2023-11-06,1021
1582,信錦,40,8,32,合庫-台中,2023-11-06,1021
2883B,凱基金乙特,30,0,30,合庫-台中,2023-11-06,1021
6129,普誠,30,0,30,合庫-台中,2023-11-06,1021
2515,中工,30,0,30,合庫-台中,2023-11-06,1021
8054,安國,29,0,29,合庫-台中,2023-11-06,1021
00933B,國泰10Y+金融債,33,5,28,合庫-台中,2023-11-06,1021
3055,蔚華科,28,0,28,合庫-台中,2023-11-06,1021
2025,千興,30,2,28,合庫-台中,2023-11-06,1021
1524,耿鼎,40,13,27,合庫-台中,2023-11-06,1021
2498,宏達電,32,7,25,合庫-台中,2023-11-06,1021
3546,宇峻,25,0,25,合庫-台中,2023-11-06,1021
00680L,元大美債20正2,90,66,24,合庫-台中,2023-11-06,1021
2427,三商電,23,0,23,合庫-台中,2023-11-06,1021
1447,力鵬,20,0,20,合庫-台中,2023-11-06,1021
00687B,國泰20年美債,31,11,20,合庫-台中,2023-11-06,1021
3078,僑威,22,2,20,合庫-台中,2023-11-06,1021
00931B,統一美債20年,57,37,20,合庫-台中,2023-11-06,1021
9921,巨大,20,1,19,合庫-台中,2023-11-06,1021
00712,復華富時不動產,34,15,19,合庫-台中,2023-11-06,1021
2376,技嘉,65,47,18,合庫-台中,2023-11-06,1021
2313,華通,31,13,18,合庫-台中,2023-11-06,1021
6223,旺矽,32,15,17,合庫-台中,2023-11-06,1021
3583,辛耘,31,15,16,合庫-台中,2023-11-06,1021
3693,營邦,40,24,16,合庫-台中,2023-11-06,1021
6182,合晶,17,2,15,合庫-台中,2023-11-06,1021
3036,文曄,28,15,13,合庫-台中,2023-11-06,1021
4162,智擎,16,4,12,合庫-台中,2023-11-06,1021
4919,新唐,28,17,11,合庫-台中,2023-11-06,1021
6147,頎邦,12,1,11,合庫-台中,2023-11-06,1021
4113,聯上,11,0,11,合庫-台中,2023-11-06,1021
2618,長榮航,437,21,416,合庫-台中,2023-11-07,1021
00669R,國泰美國道瓊反1,195,0,195,合庫-台中,2023-11-07,1021
5347,世界,179,0,179,合庫-台中,2023-11-07,1021
00650L,復華香港正2,150,0,150,合庫-台中,2023-11-07,1021
2002,中鋼,114,6,108,合庫-台中,2023-11-07,1021
1815,富喬,148,50,98,合庫-台中,2023-11-07,1021
00715L,期街口布蘭特正2,79,0,79,合庫-台中,2023-11-07,1021
6449,鈺邦,68,0,68,合庫-台中,2023-11-07,1021
00934,中信成長高股息,72,8,64,合庫-台中,2023-11-07,1021
00931B,統一美債20年,53,4,49,合庫-台中,2023-11-07,1021
00900,富邦特選高股息30,55,14,41,合庫-台中,2023-11-07,1021
00878,國泰永續高股息,44,3,41,合庫-台中,2023-11-07,1021
2888,新光金,42,2,40,合庫-台中,2023-11-07,1021
3481,群創,89,51,38,合庫-台中,2023-11-07,1021
5351,鈺創,75,38,37,合庫-台中,2023-11-07,1021
2610,華航,93,56,37,合庫-台中,2023-11-07,1021
3041,揚智,37,4,33,合庫-台中,2023-11-07,1021
2486,一詮,36,4,32,合庫-台中,2023-11-07,1021
1444,力麗,30,0,30,合庫-台中,2023-11-07,1021
1342,八貫,30,1,29,合庫-台中,2023-11-07,1021
00679B,元大美債20年,26,0,26,合庫-台中,2023-11-07,1021
3017,奇鋐,26,0,26,合庫-台中,2023-11-07,1021
2359,所羅門,44,23,21,合庫-台中,2023-11-07,1021
1506,正道,20,0,20,合庫-台中,2023-11-07,1021
8432,東生華,21,1,20,合庫-台中,2023-11-07,1021
3290,東浦,21,1,20,合庫-台中,2023-11-07,1021
8213,志超,20,0,20,合庫-台中,2023-11-07,1021
2427,三商電,25,5,20,合庫-台中,2023-11-07,1021
3105,穩懋,20,1,19,合庫-台中,2023-11-07,1021
00631L,元大台灣50正2,320,301,19,合庫-台中,2023-11-07,1021
3704,合勤控,21,3,18,合庫-台中,2023-11-07,1021
2408,南亞科,23,5,18,合庫-台中,2023-11-07,1021
00882,中信中國高股息,17,0,17,合庫-台中,2023-11-07,1021
00902,中信電池及儲能,19,2,17,合庫-台中,2023-11-07,1021
3234,光環,16,0,16,合庫-台中,2023-11-07,1021
6613,朋億*,16,0,16,合庫-台中,2023-11-07,1021
2732,六角,15,0,15,合庫-台中,2023-11-07,1021
3207,耀勝,15,0,15,合庫-台中,2023-11-07,1021
2453,凌群,34,20,14,合庫-台中,2023-11-07,1021
2409,友達,43,31,12,合庫-台中,2023-11-07,1021
1217,愛之味,12,0,12,合庫-台中,2023-11-07,1021
1760,寶齡富錦,12,0,12,合庫-台中,2023-11-07,1021
6419,京晨科,12,0,12,合庫-台中,2023-11-07,1021
6282,康舒,13,1,12,合庫-台中,2023-11-07,1021
2705,六福,32,21,11,合庫-台中,2023-11-07,1021
4114,健喬,11,0,11,合庫-台中,2023-11-07,1021
8940,新天地,11,0,11,合庫-台中,2023-11-07,1021
2337,旺宏,11,0,11,合庫-台中,2023-11-07,1021
6117,迎廣,23,12,11,合庫-台中,2023-11-07,1021
8938,明安,12,1,11,合庫-台中,2023-11-07,1021
00936,台新永續高息中小,190,5,185,合庫-台中,2023-11-08,1021
00715L,期街口布蘭特正2,345,164,181,合庫-台中,2023-11-08,1021
2303,聯電,245,86,159,合庫-台中,2023-11-08,1021
2618,長榮航,288,150,138,合庫-台中,2023-11-08,1021
1314,中石化,125,4,121,合庫-台中,2023-11-08,1021
4806,桂田文創,120,0,120,合庫-台中,2023-11-08,1021
2388,威盛,178,58,120,合庫-台中,2023-11-08,1021
00631L,元大台灣50正2,385,276,109,合庫-台中,2023-11-08,1021
9136,巨騰-DR,106,0,106,合庫-台中,2023-11-08,1021
1815,富喬,202,105,97,合庫-台中,2023-11-08,1021
1301,台塑,91,0,91,合庫-台中,2023-11-08,1021
4113,聯上,76,0,76,合庫-台中,2023-11-08,1021
2002,中鋼,69,0,69,合庫-台中,2023-11-08,1021
2610,華航,96,29,67,合庫-台中,2023-11-08,1021
00934,中信成長高股息,58,0,58,合庫-台中,2023-11-08,1021
2349,錸德,50,0,50,合庫-台中,2023-11-08,1021
00632R,元大台灣50反1,49,0,49,合庫-台中,2023-11-08,1021
00878,國泰永續高股息,70,25,45,合庫-台中,2023-11-08,1021
6901,鑽石投資,75,31,44,合庫-台中,2023-11-08,1021
3025,星通,51,9,42,合庫-台中,2023-11-08,1021
00642U,期元大S＆P石油,42,0,42,合庫-台中,2023-11-08,1021
2376,技嘉,57,18,39,合庫-台中,2023-11-08,1021
00671R,富邦NASDAQ反1,38,0,38,合庫-台中,2023-11-08,1021
00933B,國泰10Y+金融債,40,4,36,合庫-台中,2023-11-08,1021
1784,訊聯,35,0,35,合庫-台中,2023-11-08,1021
0050,元大台灣50,50,16,34,合庫-台中,2023-11-08,1021
6419,京晨科,54,20,34,合庫-台中,2023-11-08,1021
2884,玉山金,42,10,32,合庫-台中,2023-11-08,1021
4128,中天,58,28,30,合庫-台中,2023-11-08,1021
3013,晟銘電,63,33,30,合庫-台中,2023-11-08,1021
2515,中工,33,4,29,合庫-台中,2023-11-08,1021
6117,迎廣,242,213,29,合庫-台中,2023-11-08,1021
3545,敦泰,31,3,28,合庫-台中,2023-11-08,1021
1609,大亞,30,5,25,合庫-台中,2023-11-08,1021
2888,新光金,28,5,23,合庫-台中,2023-11-08,1021
9946,三發地產,23,0,23,合庫-台中,2023-11-08,1021
1789,神隆,22,0,22,合庫-台中,2023-11-08,1021
2601,益航,21,0,21,合庫-台中,2023-11-08,1021
4552,力達-KY,19,0,19,合庫-台中,2023-11-08,1021
6781,AES-KY,18,0,18,合庫-台中,2023-11-08,1021
6531,愛普*,33,15,18,合庫-台中,2023-11-08,1021
3231,緯創,514,496,18,合庫-台中,2023-11-08,1021
3615,安可,17,0,17,合庫-台中,2023-11-08,1021
6799,來頡,24,8,16,合庫-台中,2023-11-08,1021
00885,富邦越南,18,3,15,合庫-台中,2023-11-08,1021
2883,凱基金,20,5,15,合庫-台中,2023-11-08,1021
1513,中興電,16,1,15,合庫-台中,2023-11-08,1021
2359,所羅門,15,0,15,合庫-台中,2023-11-08,1021
6290,良維,14,0,14,合庫-台中,2023-11-08,1021
2455,全新,15,1,14,合庫-台中,2023-11-08,1021
00680L,元大美債20正2,284,0,284,合庫-台中,2023-11-09,1021
6282,康舒,233,3,230,合庫-台中,2023-11-09,1021
00715L,期街口布蘭特正2,236,31,205,合庫-台中,2023-11-09,1021
00936,台新永續高息中小,175,5,170,合庫-台中,2023-11-09,1021
1314,中石化,124,2,122,合庫-台中,2023-11-09,1021
4806,桂田文創,77,0,77,合庫-台中,2023-11-09,1021
4743,合一,89,32,57,合庫-台中,2023-11-09,1021
3025,星通,56,0,56,合庫-台中,2023-11-09,1021
00679B,元大美債20年,62,7,55,合庫-台中,2023-11-09,1021
00632R,元大台灣50反1,56,10,46,合庫-台中,2023-11-09,1021
00670L,富邦NASDAQ正2,44,0,44,合庫-台中,2023-11-09,1021
00929,復華台灣科技優息,74,31,43,合庫-台中,2023-11-09,1021
2421,建準,61,19,42,合庫-台中,2023-11-09,1021
2486,一詮,43,1,42,合庫-台中,2023-11-09,1021
00934,中信成長高股息,44,5,39,合庫-台中,2023-11-09,1021
00712,復華富時不動產,66,27,39,合庫-台中,2023-11-09,1021
6116,彩晶,60,23,37,合庫-台中,2023-11-09,1021
1582,信錦,46,10,36,合庫-台中,2023-11-09,1021
6530,創威,50,15,35,合庫-台中,2023-11-09,1021
2610,華航,60,27,33,合庫-台中,2023-11-09,1021
3050,鈺德,33,0,33,合庫-台中,2023-11-09,1021
00687B,國泰20年美債,37,6,31,合庫-台中,2023-11-09,1021
2618,長榮航,95,64,31,合庫-台中,2023-11-09,1021
3231,緯創,217,187,30,合庫-台中,2023-11-09,1021
00878,國泰永續高股息,32,3,29,合庫-台中,2023-11-09,1021
2736,富野,28,0,28,合庫-台中,2023-11-09,1021
5347,世界,28,1,27,合庫-台中,2023-11-09,1021
00631L,元大台灣50正2,429,402,27,合庫-台中,2023-11-09,1021
00688L,國泰20年美債正2,23,0,23,合庫-台中,2023-11-09,1021
2338,光罩,26,3,23,合庫-台中,2023-11-09,1021
00650L,復華香港正2,22,0,22,合庫-台中,2023-11-09,1021
00642U,期元大S＆P石油,23,1,22,合庫-台中,2023-11-09,1021
3523,迎輝,20,0,20,合庫-台中,2023-11-09,1021
1444,力麗,20,0,20,合庫-台中,2023-11-09,1021
1522,堤維西,42,22,20,合庫-台中,2023-11-09,1021
8176,智捷,20,0,20,合庫-台中,2023-11-09,1021
2601,益航,20,0,20,合庫-台中,2023-11-09,1021
1218,泰山,20,0,20,合庫-台中,2023-11-09,1021
5452,佶優,20,0,20,合庫-台中,2023-11-09,1021
00900,富邦特選高股息30,33,15,18,合庫-台中,2023-11-09,1021
4147,中裕,17,0,17,合庫-台中,2023-11-09,1021
3041,揚智,33,17,16,合庫-台中,2023-11-09,1021
2331,精英,16,0,16,合庫-台中,2023-11-09,1021
6284,佳邦,16,1,15,合庫-台中,2023-11-09,1021
2359,所羅門,15,0,15,合庫-台中,2023-11-09,1021
2399,映泰,20,5,15,合庫-台中,2023-11-09,1021
3122,笙泉,62,48,14,合庫-台中,2023-11-09,1021
2337,旺宏,14,0,14,合庫-台中,2023-11-09,1021
00919,群益台灣精選高息,30,17,13,合庫-台中,2023-11-09,1021
2453,凌群,21,8,13,合庫-台中,2023-11-09,1021
00878,國泰永續高股息,274,3,271,合庫-台中,2023-11-10,1021
00929,復華台灣科技優息,210,5,205,合庫-台中,2023-11-10,1021
00632R,元大台灣50反1,111,0,111,合庫-台中,2023-11-10,1021
00936,台新永續高息中小,154,43,111,合庫-台中,2023-11-10,1021
00680L,元大美債20正2,93,2,91,合庫-台中,2023-11-10,1021
00919,群益台灣精選高息,93,4,89,合庫-台中,2023-11-10,1021
2801,彰銀,60,0,60,合庫-台中,2023-11-10,1021
00679B,元大美債20年,67,14,53,合庫-台中,2023-11-10,1021
4552,力達-KY,48,0,48,合庫-台中,2023-11-10,1021
3231,緯創,199,155,44,合庫-台中,2023-11-10,1021
1101,台泥,49,7,42,合庫-台中,2023-11-10,1021
2363,矽統,416,379,37,合庫-台中,2023-11-10,1021
0056,元大高股息,42,6,36,合庫-台中,2023-11-10,1021
00712,復華富時不動產,34,1,33,合庫-台中,2023-11-10,1021
2486,一詮,31,0,31,合庫-台中,2023-11-10,1021
6133,金橋,37,7,30,合庫-台中,2023-11-10,1021
00934,中信成長高股息,29,0,29,合庫-台中,2023-11-10,1021
2302,麗正,26,0,26,合庫-台中,2023-11-10,1021
2344,華邦電,24,1,23,合庫-台中,2023-11-10,1021
00753L,中信中國50正2,32,10,22,合庫-台中,2023-11-10,1021
2107,厚生,22,0,22,合庫-台中,2023-11-10,1021
2634,漢翔,28,6,22,合庫-台中,2023-11-10,1021
6901,鑽石投資,50,29,21,合庫-台中,2023-11-10,1021
00665L,富邦�琤肭磪囓�2,21,0,21,合庫-台中,2023-11-10,1021
4743,合一,72,51,21,合庫-台中,2023-11-10,1021
8110,華東,20,0,20,合庫-台中,2023-11-10,1021
1522,堤維西,22,2,20,合庫-台中,2023-11-10,1021
2897,王道銀行,20,0,20,合庫-台中,2023-11-10,1021
00708L,期元大S＆P黃金正2,25,6,19,合庫-台中,2023-11-10,1021
00900,富邦特選高股息30,18,0,18,合庫-台中,2023-11-10,1021
6150,撼訊,21,4,17,合庫-台中,2023-11-10,1021
2736,富野,38,21,17,合庫-台中,2023-11-10,1021
6732,昇佳電子,17,1,16,合庫-台中,2023-11-10,1021
2462,良得電,16,1,15,合庫-台中,2023-11-10,1021
6282,康舒,23,9,14,合庫-台中,2023-11-10,1021
2618,長榮航,19,5,14,合庫-台中,2023-11-10,1021
3189,景碩,15,1,14,合庫-台中,2023-11-10,1021
2455,全新,13,0,13,合庫-台中,2023-11-10,1021
3481,群創,62,49,13,合庫-台中,2023-11-10,1021
6419,京晨科,38,25,13,合庫-台中,2023-11-10,1021
2317,鴻海,13,0,13,合庫-台中,2023-11-10,1021
2820,華票,12,0,12,合庫-台中,2023-11-10,1021
1907,永豐餘,12,0,12,合庫-台中,2023-11-10,1021
2331,精英,14,2,12,合庫-台中,2023-11-10,1021
1584,精剛,18,6,12,合庫-台中,2023-11-10,1021
6118,建達,13,2,11,合庫-台中,2023-11-10,1021
6530,創威,39,28,11,合庫-台中,2023-11-10,1021
3523,迎輝,10,0,10,合庫-台中,2023-11-10,1021
5355,佳總,10,0,10,合庫-台中,2023-11-10,1021
2104,國際中橡,10,0,10,合庫-台中,2023-11-10,1021
2618,長榮航,451,171,280,合庫-台中,2023-11-13,1021
00878,國泰永續高股息,160,9,151,合庫-台中,2023-11-13,1021
9136,巨騰-DR,84,0,84,合庫-台中,2023-11-13,1021
6901,鑽石投資,87,6,81,合庫-台中,2023-11-13,1021
2382,廣達,165,85,80,合庫-台中,2023-11-13,1021
3615,安可,95,23,72,合庫-台中,2023-11-13,1021
00680L,元大美債20正2,59,0,59,合庫-台中,2023-11-13,1021
00712,復華富時不動產,100,43,57,合庫-台中,2023-11-13,1021
00936,台新永續高息中小,66,10,56,合庫-台中,2023-11-13,1021
4113,聯上,55,0,55,合庫-台中,2023-11-13,1021
00679B,元大美債20年,53,0,53,合庫-台中,2023-11-13,1021
2313,華通,199,159,40,合庫-台中,2023-11-13,1021
3481,群創,37,1,36,合庫-台中,2023-11-13,1021
00632R,元大台灣50反1,80,45,35,合庫-台中,2023-11-13,1021
2889,國票金,32,0,32,合庫-台中,2023-11-13,1021
2610,華航,99,69,30,合庫-台中,2023-11-13,1021
1444,力麗,30,0,30,合庫-台中,2023-11-13,1021
6016,康和證,30,0,30,合庫-台中,2023-11-13,1021
2485,兆赫,30,1,29,合庫-台中,2023-11-13,1021
2543,皇昌,30,2,28,合庫-台中,2023-11-13,1021
2352,佳世達,34,8,26,合庫-台中,2023-11-13,1021
1471,首利,23,0,23,合庫-台中,2023-11-13,1021
6288,聯嘉,22,1,21,合庫-台中,2023-11-13,1021
0056,元大高股息,28,7,21,合庫-台中,2023-11-13,1021
00882,中信中國高股息,20,0,20,合庫-台中,2023-11-13,1021
2611,志信,41,21,20,合庫-台中,2023-11-13,1021
3523,迎輝,20,0,20,合庫-台中,2023-11-13,1021
2107,厚生,20,0,20,合庫-台中,2023-11-13,1021
6015,宏遠證,30,10,20,合庫-台中,2023-11-13,1021
3013,晟銘電,27,8,19,合庫-台中,2023-11-13,1021
2601,益航,20,1,19,合庫-台中,2023-11-13,1021
6118,建達,33,15,18,合庫-台中,2023-11-13,1021
4147,中裕,18,1,17,合庫-台中,2023-11-13,1021
2301,光寶科,19,3,16,合庫-台中,2023-11-13,1021
2516,新建,15,0,15,合庫-台中,2023-11-13,1021
5880,合庫金,28,13,15,合庫-台中,2023-11-13,1021
2363,矽統,154,139,15,合庫-台中,2023-11-13,1021
6290,良維,22,7,15,合庫-台中,2023-11-13,1021
6770,力積電,70,56,14,合庫-台中,2023-11-13,1021
00929,復華台灣科技優息,146,132,14,合庫-台中,2023-11-13,1021
2408,南亞科,14,0,14,合庫-台中,2023-11-13,1021
00720B,元大投資級公司債,14,0,14,合庫-台中,2023-11-13,1021
3576,聯合再生,14,0,14,合庫-台中,2023-11-13,1021
5483,中美晶,15,2,13,合庫-台中,2023-11-13,1021
2489,瑞軒,12,0,12,合庫-台中,2023-11-13,1021
6243,迅杰,12,0,12,合庫-台中,2023-11-13,1021
4542,科嶠,13,1,12,合庫-台中,2023-11-13,1021
00902,中信電池及儲能,11,0,11,合庫-台中,2023-11-13,1021
8926,台汽電,11,0,11,合庫-台中,2023-11-13,1021
00687B,國泰20年美債,20,9,11,合庫-台中,2023-11-13,1021
00632R,元大台灣50反1,221,10,211,合庫-台中,2023-11-14,1021
00712,復華富時不動產,113,12,101,合庫-台中,2023-11-14,1021
3231,緯創,196,104,92,合庫-台中,2023-11-14,1021
00878,國泰永續高股息,125,37,88,合庫-台中,2023-11-14,1021
00757,統一FANG+,63,0,63,合庫-台中,2023-11-14,1021
00680L,元大美債20正2,50,0,50,合庫-台中,2023-11-14,1021
6016,康和證,50,0,50,合庫-台中,2023-11-14,1021
6116,彩晶,54,5,49,合庫-台中,2023-11-14,1021
00929,復華台灣科技優息,80,33,47,合庫-台中,2023-11-14,1021
1504,東元,45,0,45,合庫-台中,2023-11-14,1021
00720B,元大投資級公司債,31,0,31,合庫-台中,2023-11-14,1021
3615,安可,41,10,31,合庫-台中,2023-11-14,1021
6451,訊芯-KY,62,31,31,合庫-台中,2023-11-14,1021
00655L,國泰中國A50正2,25,0,25,合庫-台中,2023-11-14,1021
6282,康舒,90,66,24,合庫-台中,2023-11-14,1021
1815,富喬,26,4,22,合庫-台中,2023-11-14,1021
4162,智擎,23,2,21,合庫-台中,2023-11-14,1021
2107,厚生,20,0,20,合庫-台中,2023-11-14,1021
4128,中天,24,4,20,合庫-台中,2023-11-14,1021
6285,啟��,22,2,20,合庫-台中,2023-11-14,1021
2601,益航,20,0,20,合庫-台中,2023-11-14,1021
00679B,元大美債20年,20,0,20,合庫-台中,2023-11-14,1021
2427,三商電,20,1,19,合庫-台中,2023-11-14,1021
2618,長榮航,43,24,19,合庫-台中,2023-11-14,1021
00936,台新永續高息中小,23,5,18,合庫-台中,2023-11-14,1021
00923,群益台ESG低碳50,18,1,17,合庫-台中,2023-11-14,1021
2462,良得電,17,1,16,合庫-台中,2023-11-14,1021
6901,鑽石投資,25,10,15,合庫-台中,2023-11-14,1021
3706,神達,21,6,15,合庫-台中,2023-11-14,1021
1324,地球,14,0,14,合庫-台中,2023-11-14,1021
2402,毅嘉,62,49,13,合庫-台中,2023-11-14,1021
00900,富邦特選高股息30,12,0,12,合庫-台中,2023-11-14,1021
3406,玉晶光,14,2,12,合庫-台中,2023-11-14,1021
2323,中環,12,0,12,合庫-台中,2023-11-14,1021
2464,盟立,12,0,12,合庫-台中,2023-11-14,1021
4720,德淵,17,5,12,合庫-台中,2023-11-14,1021
5312,寶島科,12,0,12,合庫-台中,2023-11-14,1021
2609,陽明,23,12,11,合庫-台中,2023-11-14,1021
8011,台通,10,0,10,合庫-台中,2023-11-14,1021
2606,裕民,10,0,10,合庫-台中,2023-11-14,1021
2482,連宇,10,0,10,合庫-台中,2023-11-14,1021
3548,兆利,45,35,10,合庫-台中,2023-11-14,1021
6015,宏遠證,30,20,10,合庫-台中,2023-11-14,1021
3576,聯合再生,10,0,10,合庫-台中,2023-11-14,1021
4414,如興,10,0,10,合庫-台中,2023-11-14,1021
3094,聯傑,30,20,10,合庫-台中,2023-11-14,1021
1447,力鵬,10,0,10,合庫-台中,2023-11-14,1021
3036,文曄,38,28,10,合庫-台中,2023-11-14,1021
6243,迅杰,10,0,10,合庫-台中,2023-11-14,1021
1795,美時,15,5,10,合庫-台中,2023-11-14,1021
00878,國泰永續高股息,337,90,247,合庫-台中,2023-11-15,1021
2331,精英,100,5,95,合庫-台中,2023-11-15,1021
3035,智原,104,11,93,合庫-台中,2023-11-15,1021
00900,富邦特選高股息30,101,9,92,合庫-台中,2023-11-15,1021
2409,友達,120,30,90,合庫-台中,2023-11-15,1021
2323,中環,71,6,65,合庫-台中,2023-11-15,1021
00632R,元大台灣50反1,323,262,61,合庫-台中,2023-11-15,1021
2419,仲琦,52,0,52,合庫-台中,2023-11-15,1021
00715L,期街口布蘭特正2,51,0,51,合庫-台中,2023-11-15,1021
3450,聯鈞,85,37,48,合庫-台中,2023-11-15,1021
00712,復華富時不動產,102,60,42,合庫-台中,2023-11-15,1021
2609,陽明,109,67,42,合庫-台中,2023-11-15,1021
00655L,國泰中國A50正2,40,0,40,合庫-台中,2023-11-15,1021
00850,元大臺灣ESG永續,39,0,39,合庫-台中,2023-11-15,1021
00885,富邦越南,42,4,38,合庫-台中,2023-11-15,1021
6770,力積電,93,59,34,合庫-台中,2023-11-15,1021
2801,彰銀,60,27,33,合庫-台中,2023-11-15,1021
5452,佶優,30,0,30,合庫-台中,2023-11-15,1021
00679B,元大美債20年,37,7,30,合庫-台中,2023-11-15,1021
00895,富邦未來車,44,16,28,合庫-台中,2023-11-15,1021
3706,神達,29,2,27,合庫-台中,2023-11-15,1021
2812,台中銀,47,20,27,合庫-台中,2023-11-15,1021
00752,中信中國50,26,0,26,合庫-台中,2023-11-15,1021
2317,鴻海,49,24,25,合庫-台中,2023-11-15,1021
2486,一詮,32,8,24,合庫-台中,2023-11-15,1021
6125,廣運,23,0,23,合庫-台中,2023-11-15,1021
3176,基亞,23,2,21,合庫-台中,2023-11-15,1021
6733,博晟生醫,20,0,20,合庫-台中,2023-11-15,1021
1560,中砂,20,0,20,合庫-台中,2023-11-15,1021
006201,元大富櫃50,20,0,20,合庫-台中,2023-11-15,1021
4419,皇家美食,20,0,20,合庫-台中,2023-11-15,1021
00670L,富邦NASDAQ正2,22,2,20,合庫-台中,2023-11-15,1021
6901,鑽石投資,37,18,19,合庫-台中,2023-11-15,1021
00680L,元大美債20正2,19,0,19,合庫-台中,2023-11-15,1021
6122,擎邦,32,14,18,合庫-台中,2023-11-15,1021
2455,全新,21,3,18,合庫-台中,2023-11-15,1021
2356,英業達,33,15,18,合庫-台中,2023-11-15,1021
2816,旺旺保,18,0,18,合庫-台中,2023-11-15,1021
1522,堤維西,18,1,17,合庫-台中,2023-11-15,1021
4960,誠美材,26,10,16,合庫-台中,2023-11-15,1021
2359,所羅門,16,2,14,合庫-台中,2023-11-15,1021
2834,臺企銀,22,8,14,合庫-台中,2023-11-15,1021
2483,百容,13,0,13,合庫-台中,2023-11-15,1021
3689,湧德,13,0,13,合庫-台中,2023-11-15,1021
6732,昇佳電子,14,2,12,合庫-台中,2023-11-15,1021
6243,迅杰,16,4,12,合庫-台中,2023-11-15,1021
2543,皇昌,20,9,11,合庫-台中,2023-11-15,1021
1471,首利,13,2,11,合庫-台中,2023-11-15,1021
00688L,國泰20年美債正2,11,0,11,合庫-台中,2023-11-15,1021
6494,九齊,13,2,11,合庫-台中,2023-11-15,1021
00665L,富邦�琤肭磪囓�2,636,12,624,合庫-台中,2023-11-16,1021
4950,牧東,281,1,280,合庫-台中,2023-11-16,1021
2014,中鴻,224,17,207,合庫-台中,2023-11-16,1021
00715L,期街口布蘭特正2,141,1,140,合庫-台中,2023-11-16,1021
00878,國泰永續高股息,159,20,139,合庫-台中,2023-11-16,1021
00679B,元大美債20年,122,4,118,合庫-台中,2023-11-16,1021
00929,復華台灣科技優息,124,19,105,合庫-台中,2023-11-16,1021
2419,仲琦,100,0,100,合庫-台中,2023-11-16,1021
2002,中鋼,207,112,95,合庫-台中,2023-11-16,1021
00688L,國泰20年美債正2,110,16,94,合庫-台中,2023-11-16,1021
2388,威盛,192,100,92,合庫-台中,2023-11-16,1021
00680L,元大美債20正2,83,0,83,合庫-台中,2023-11-16,1021
5512,力麒,74,4,70,合庫-台中,2023-11-16,1021
00650L,復華香港正2,52,0,52,合庫-台中,2023-11-16,1021
3078,僑威,57,6,51,合庫-台中,2023-11-16,1021
2609,陽明,104,59,45,合庫-台中,2023-11-16,1021
00642U,期元大S＆P石油,44,0,44,合庫-台中,2023-11-16,1021
00712,復華富時不動產,54,11,43,合庫-台中,2023-11-16,1021
00637L,元大滬深300正2,89,47,42,合庫-台中,2023-11-16,1021
2369,菱生,51,10,41,合庫-台中,2023-11-16,1021
00632R,元大台灣50反1,288,250,38,合庫-台中,2023-11-16,1021
3035,智原,45,9,36,合庫-台中,2023-11-16,1021
6901,鑽石投資,36,4,32,合庫-台中,2023-11-16,1021
00751B,元大AAA至A公司債,30,0,30,合庫-台中,2023-11-16,1021
00655L,國泰中國A50正2,30,0,30,合庫-台中,2023-11-16,1021
8034,榮群,40,13,27,合庫-台中,2023-11-16,1021
6770,力積電,65,41,24,合庫-台中,2023-11-16,1021
1449,佳和,22,0,22,合庫-台中,2023-11-16,1021
3596,智易,21,0,21,合庫-台中,2023-11-16,1021
2427,三商電,23,2,21,合庫-台中,2023-11-16,1021
2417,圓剛,56,36,20,合庫-台中,2023-11-16,1021
3548,兆利,73,53,20,合庫-台中,2023-11-16,1021
6129,普誠,20,0,20,合庫-台中,2023-11-16,1021
2354,鴻準,20,0,20,合庫-台中,2023-11-16,1021
1504,東元,22,2,20,合庫-台中,2023-11-16,1021
6118,建達,25,6,19,合庫-台中,2023-11-16,1021
00936,台新永續高息中小,19,0,19,合庫-台中,2023-11-16,1021
3013,晟銘電,19,1,18,合庫-台中,2023-11-16,1021
3257,虹冠電,18,2,16,合庫-台中,2023-11-16,1021
6133,金橋,21,5,16,合庫-台中,2023-11-16,1021
5381,合正,16,0,16,合庫-台中,2023-11-16,1021
1536,和大,15,0,15,合庫-台中,2023-11-16,1021
6419,京晨科,15,0,15,合庫-台中,2023-11-16,1021
6703,軒郁,18,3,15,合庫-台中,2023-11-16,1021
00933B,國泰10Y+金融債,15,1,14,合庫-台中,2023-11-16,1021
00720B,元大投資級公司債,14,0,14,合庫-台中,2023-11-16,1021
00772B,中信高評級公司債,14,0,14,合庫-台中,2023-11-16,1021
6125,廣運,21,8,13,合庫-台中,2023-11-16,1021
6233,旺玖,13,0,13,合庫-台中,2023-11-16,1021
6526,達發,14,2,12,合庫-台中,2023-11-16,1021
00665L,富邦�琤肭磪囓�2,1285,0,1285,合庫-台中,2023-11-17,1021
00632R,元大台灣50反1,960,0,960,合庫-台中,2023-11-17,1021
2618,長榮航,845,117,728,合庫-台中,2023-11-17,1021
00715L,期街口布蘭特正2,195,14,181,合庫-台中,2023-11-17,1021
2542,興富發,159,0,159,合庫-台中,2023-11-17,1021
4908,前鼎,237,78,159,合庫-台中,2023-11-17,1021
00712,復華富時不動產,164,25,139,合庫-台中,2023-11-17,1021
2705,六福,144,5,139,合庫-台中,2023-11-17,1021
2363,矽統,188,83,105,合庫-台中,2023-11-17,1021
00679B,元大美債20年,88,1,87,合庫-台中,2023-11-17,1021
3706,神達,86,31,55,合庫-台中,2023-11-17,1021
2727,王品,54,0,54,合庫-台中,2023-11-17,1021
6419,京晨科,81,30,51,合庫-台中,2023-11-17,1021
4419,皇家美食,51,0,51,合庫-台中,2023-11-17,1021
6589,台康生技,136,87,49,合庫-台中,2023-11-17,1021
2356,英業達,42,1,41,合庫-台中,2023-11-17,1021
2352,佳世達,45,4,41,合庫-台中,2023-11-17,1021
2610,華航,77,36,41,合庫-台中,2023-11-17,1021
2883,凱基金,52,13,39,合庫-台中,2023-11-17,1021
6270,倍微,40,2,38,合庫-台中,2023-11-17,1021
0056,元大高股息,55,18,37,合庫-台中,2023-11-17,1021
3041,揚智,153,119,34,合庫-台中,2023-11-17,1021
2486,一詮,37,3,34,合庫-台中,2023-11-17,1021
2641,正德,35,2,33,合庫-台中,2023-11-17,1021
2344,華邦電,165,135,30,合庫-台中,2023-11-17,1021
00642U,期元大S＆P石油,29,0,29,合庫-台中,2023-11-17,1021
9105,泰金寶-DR,28,0,28,合庫-台中,2023-11-17,1021
00751B,元大AAA至A公司債,27,1,26,合庫-台中,2023-11-17,1021
2332,友訊,25,0,25,合庫-台中,2023-11-17,1021
2739,寒舍,37,14,23,合庫-台中,2023-11-17,1021
2515,中工,22,0,22,合庫-台中,2023-11-17,1021
1582,信錦,21,0,21,合庫-台中,2023-11-17,1021
2615,萬海,20,0,20,合庫-台中,2023-11-17,1021
3056,富華新,23,5,18,合庫-台中,2023-11-17,1021
8940,新天地,21,4,17,合庫-台中,2023-11-17,1021
00935,野村臺灣新科技50,17,0,17,合庫-台中,2023-11-17,1021
00720B,元大投資級公司債,18,1,17,合庫-台中,2023-11-17,1021
00931B,統一美債20年,16,0,16,合庫-台中,2023-11-17,1021
1815,富喬,44,28,16,合庫-台中,2023-11-17,1021
3017,奇鋐,18,2,16,合庫-台中,2023-11-17,1021
00655L,國泰中國A50正2,16,0,16,合庫-台中,2023-11-17,1021
6129,普誠,20,5,15,合庫-台中,2023-11-17,1021
6026,福邦證,15,0,15,合庫-台中,2023-11-17,1021
2312,金寶,17,2,15,合庫-台中,2023-11-17,1021
00885,富邦越南,15,0,15,合庫-台中,2023-11-17,1021
2732,六角,18,3,15,合庫-台中,2023-11-17,1021
9950,萬國通,15,1,14,合庫-台中,2023-11-17,1021
3013,晟銘電,16,3,13,合庫-台中,2023-11-17,1021
2605,新興,15,2,13,合庫-台中,2023-11-17,1021
2402,毅嘉,40,27,13,合庫-台中,2023-11-17,1021
2618,長榮航,609,124,485,合庫-台中,2023-11-20,1021
3711,日月光投控,428,97,331,合庫-台中,2023-11-20,1021
00673R,期元大S＆P原油反1,214,5,209,合庫-台中,2023-11-20,1021
2515,中工,184,0,184,合庫-台中,2023-11-20,1021
00929,復華台灣科技優息,306,175,131,合庫-台中,2023-11-20,1021
00670L,富邦NASDAQ正2,127,0,127,合庫-台中,2023-11-20,1021
00679B,元大美債20年,128,7,121,合庫-台中,2023-11-20,1021
9136,巨騰-DR,120,0,120,合庫-台中,2023-11-20,1021
2883,凱基金,109,5,104,合庫-台中,2023-11-20,1021
2388,威盛,218,134,84,合庫-台中,2023-11-20,1021
1314,中石化,80,0,80,合庫-台中,2023-11-20,1021
00712,復華富時不動產,61,7,54,合庫-台中,2023-11-20,1021
00632R,元大台灣50反1,51,0,51,合庫-台中,2023-11-20,1021
2337,旺宏,57,7,50,合庫-台中,2023-11-20,1021
2610,華航,84,36,48,合庫-台中,2023-11-20,1021
00795B,中信美國公債20年,44,0,44,合庫-台中,2023-11-20,1021
00934,中信成長高股息,63,23,40,合庫-台中,2023-11-20,1021
2356,英業達,48,12,36,合庫-台中,2023-11-20,1021
3094,聯傑,59,24,35,合庫-台中,2023-11-20,1021
4419,皇家美食,33,0,33,合庫-台中,2023-11-20,1021
2402,毅嘉,42,10,32,合庫-台中,2023-11-20,1021
1582,信錦,36,5,31,合庫-台中,2023-11-20,1021
2258,鴻華先進-創,29,0,29,合庫-台中,2023-11-20,1021
5301,寶得利,27,0,27,合庫-台中,2023-11-20,1021
2543,皇昌,37,11,26,合庫-台中,2023-11-20,1021
2312,金寶,31,6,25,合庫-台中,2023-11-20,1021
00931B,統一美債20年,26,1,25,合庫-台中,2023-11-20,1021
6016,康和證,25,0,25,合庫-台中,2023-11-20,1021
2734,易飛網,26,2,24,合庫-台中,2023-11-20,1021
00885,富邦越南,23,0,23,合庫-台中,2023-11-20,1021
4763,材料-KY,46,24,22,合庫-台中,2023-11-20,1021
00690,兆豐藍籌30,22,0,22,合庫-台中,2023-11-20,1021
0056,元大高股息,23,4,19,合庫-台中,2023-11-20,1021
2344,華邦電,44,25,19,合庫-台中,2023-11-20,1021
6243,迅杰,21,2,19,合庫-台中,2023-11-20,1021
00719B,元大美債1-3,18,0,18,合庫-台中,2023-11-20,1021
00751B,元大AAA至A公司債,18,0,18,合庫-台中,2023-11-20,1021
2317,鴻海,33,16,17,合庫-台中,2023-11-20,1021
1402,遠東新,22,6,16,合庫-台中,2023-11-20,1021
00935,野村臺灣新科技50,16,0,16,合庫-台中,2023-11-20,1021
3051,力特,16,0,16,合庫-台中,2023-11-20,1021
2201,裕隆,18,4,14,合庫-台中,2023-11-20,1021
2409,友達,24,10,14,合庫-台中,2023-11-20,1021
6118,建達,21,7,14,合庫-台中,2023-11-20,1021
6285,啟��,15,1,14,合庫-台中,2023-11-20,1021
6531,愛普*,15,2,13,合庫-台中,2023-11-20,1021
2462,良得電,23,10,13,合庫-台中,2023-11-20,1021
2739,寒舍,15,2,13,合庫-台中,2023-11-20,1021
00933B,國泰10Y+金融債,19,6,13,合庫-台中,2023-11-20,1021
2330,台積電,16,3,13,合庫-台中,2023-11-20,1021
00632R,元大台灣50反1,1505,543,962,合庫-台中,2023-11-21,1021
2344,華邦電,314,34,280,合庫-台中,2023-11-21,1021
3715,定穎投控,151,50,101,合庫-台中,2023-11-21,1021
9136,巨騰-DR,95,0,95,合庫-台中,2023-11-21,1021
1447,力鵬,80,0,80,合庫-台中,2023-11-21,1021
00680L,元大美債20正2,82,10,72,合庫-台中,2023-11-21,1021
2419,仲琦,70,0,70,合庫-台中,2023-11-21,1021
2258,鴻華先進-創,97,27,70,合庫-台中,2023-11-21,1021
00712,復華富時不動產,68,0,68,合庫-台中,2023-11-21,1021
00679B,元大美債20年,66,12,54,合庫-台中,2023-11-21,1021
6158,禾昌,55,4,51,合庫-台中,2023-11-21,1021
5471,松翰,42,2,40,合庫-台中,2023-11-21,1021
3059,華晶科,46,14,32,合庫-台中,2023-11-21,1021
2489,瑞軒,39,7,32,合庫-台中,2023-11-21,1021
8054,安國,114,82,32,合庫-台中,2023-11-21,1021
6120,達運,35,4,31,合庫-台中,2023-11-21,1021
4931,新盛力,36,5,31,合庫-台中,2023-11-21,1021
4113,聯上,30,0,30,合庫-台中,2023-11-21,1021
2801,彰銀,50,24,26,合庫-台中,2023-11-21,1021
00882,中信中國高股息,27,1,26,合庫-台中,2023-11-21,1021
9945,潤泰新,26,1,25,合庫-台中,2023-11-21,1021
2734,易飛網,25,0,25,合庫-台中,2023-11-21,1021
6168,宏齊,40,16,24,合庫-台中,2023-11-21,1021
00671R,富邦NASDAQ反1,24,0,24,合庫-台中,2023-11-21,1021
4979,華星光,36,12,24,合庫-台中,2023-11-21,1021
2303,聯電,102,78,24,合庫-台中,2023-11-21,1021
2516,新建,35,12,23,合庫-台中,2023-11-21,1021
00885,富邦越南,21,0,21,合庫-台中,2023-11-21,1021
2337,旺宏,25,5,20,合庫-台中,2023-11-21,1021
5478,智冠,20,0,20,合庫-台中,2023-11-21,1021
3265,台星科,20,0,20,合庫-台中,2023-11-21,1021
6233,旺玖,26,7,19,合庫-台中,2023-11-21,1021
3325,旭品,38,19,19,合庫-台中,2023-11-21,1021
2355,敬鵬,46,27,19,合庫-台中,2023-11-21,1021
4763,材料-KY,53,36,17,合庫-台中,2023-11-21,1021
2367,燿華,82,65,17,合庫-台中,2023-11-21,1021
2380,虹光,18,2,16,合庫-台中,2023-11-21,1021
00670L,富邦NASDAQ正2,20,4,16,合庫-台中,2023-11-21,1021
4542,科嶠,16,0,16,合庫-台中,2023-11-21,1021
4128,中天,16,0,16,合庫-台中,2023-11-21,1021
3149,正達,19,4,15,合庫-台中,2023-11-21,1021
2722,夏都,15,0,15,合庫-台中,2023-11-21,1021
3033,威健,15,0,15,合庫-台中,2023-11-21,1021
2332,友訊,16,1,15,合庫-台中,2023-11-21,1021
2313,華通,193,179,14,合庫-台中,2023-11-21,1021
00900,富邦特選高股息30,21,7,14,合庫-台中,2023-11-21,1021
00934,中信成長高股息,14,0,14,合庫-台中,2023-11-21,1021
8046,南電,16,2,14,合庫-台中,2023-11-21,1021
1524,耿鼎,22,8,14,合庫-台中,2023-11-21,1021
1449,佳和,13,0,13,合庫-台中,2023-11-21,1021
00665L,富邦�琤肭磪囓�2,1868,12,1856,合庫-台中,2023-11-22,1021
2301,光寶科,513,4,509,合庫-台中,2023-11-22,1021
2356,英業達,332,21,311,合庫-台中,2023-11-22,1021
2618,長榮航,428,135,293,合庫-台中,2023-11-22,1021
3231,緯創,284,90,194,合庫-台中,2023-11-22,1021
2888,新光金,131,2,129,合庫-台中,2023-11-22,1021
00936,台新永續高息中小,118,2,116,合庫-台中,2023-11-22,1021
00878,國泰永續高股息,111,3,108,合庫-台中,2023-11-22,1021
00753L,中信中國50正2,100,0,100,合庫-台中,2023-11-22,1021
2002,中鋼,92,4,88,合庫-台中,2023-11-22,1021
2883,凱基金,86,2,84,合庫-台中,2023-11-22,1021
00679B,元大美債20年,74,9,65,合庫-台中,2023-11-22,1021
00673R,期元大S＆P原油反1,63,0,63,合庫-台中,2023-11-22,1021
2388,威盛,231,170,61,合庫-台中,2023-11-22,1021
00905,FT臺灣Smart,51,0,51,合庫-台中,2023-11-22,1021
2332,友訊,48,0,48,合庫-台中,2023-11-22,1021
0056,元大高股息,51,4,47,合庫-台中,2023-11-22,1021
3325,旭品,76,29,47,合庫-台中,2023-11-22,1021
00919,群益台灣精選高息,71,27,44,合庫-台中,2023-11-22,1021
6233,旺玖,44,1,43,合庫-台中,2023-11-22,1021
3289,宜特,40,0,40,合庫-台中,2023-11-22,1021
2313,華通,169,129,40,合庫-台中,2023-11-22,1021
2449,京元電子,44,7,37,合庫-台中,2023-11-22,1021
00900,富邦特選高股息30,36,0,36,合庫-台中,2023-11-22,1021
00882,中信中國高股息,35,0,35,合庫-台中,2023-11-22,1021
2382,廣達,45,12,33,合庫-台中,2023-11-22,1021
2303,聯電,113,81,32,合庫-台中,2023-11-22,1021
2376,技嘉,51,19,32,合庫-台中,2023-11-22,1021
3059,華晶科,90,59,31,合庫-台中,2023-11-22,1021
5512,力麒,33,3,30,合庫-台中,2023-11-22,1021
2330,台積電,32,4,28,合庫-台中,2023-11-22,1021
2353,宏��,29,1,28,合庫-台中,2023-11-22,1021
00751B,元大AAA至A公司債,27,0,27,合庫-台中,2023-11-22,1021
4542,科嶠,27,2,25,合庫-台中,2023-11-22,1021
6016,康和證,30,5,25,合庫-台中,2023-11-22,1021
4979,華星光,26,2,24,合庫-台中,2023-11-22,1021
6118,建達,28,6,22,合庫-台中,2023-11-22,1021
2258,鴻華先進-創,24,2,22,合庫-台中,2023-11-22,1021
5272,笙科,43,21,22,合庫-台中,2023-11-22,1021
2419,仲琦,20,0,20,合庫-台中,2023-11-22,1021
3122,笙泉,32,12,20,合庫-台中,2023-11-22,1021
00687B,國泰20年美債,30,10,20,合庫-台中,2023-11-22,1021
6122,擎邦,21,1,20,合庫-台中,2023-11-22,1021
8358,金居,21,2,19,合庫-台中,2023-11-22,1021
6127,九豪,19,1,18,合庫-台中,2023-11-22,1021
3056,富華新,30,13,17,合庫-台中,2023-11-22,1021
00712,復華富時不動產,21,5,16,合庫-台中,2023-11-22,1021
2344,華邦電,21,5,16,合庫-台中,2023-11-22,1021
6156,松上,16,0,16,合庫-台中,2023-11-22,1021
3013,晟銘電,23,7,16,合庫-台中,2023-11-22,1021
2890,永豐金,204,0,204,合庫-台中,2023-11-23,1021
00919,群益台灣精選高息,135,16,119,合庫-台中,2023-11-23,1021
00929,復華台灣科技優息,138,19,119,合庫-台中,2023-11-23,1021
3231,緯創,174,70,104,合庫-台中,2023-11-23,1021
6237,驊訊,144,44,100,合庫-台中,2023-11-23,1021
5521,工信,96,2,94,合庫-台中,2023-11-23,1021
9136,巨騰-DR,85,0,85,合庫-台中,2023-11-23,1021
6282,康舒,398,319,79,合庫-台中,2023-11-23,1021
2363,矽統,139,61,78,合庫-台中,2023-11-23,1021
1314,中石化,82,4,78,合庫-台中,2023-11-23,1021
6202,盛群,77,2,75,合庫-台中,2023-11-23,1021
8054,安國,127,57,70,合庫-台中,2023-11-23,1021
2023,燁輝,60,1,59,合庫-台中,2023-11-23,1021
00891,中信關鍵半導體,102,45,57,合庫-台中,2023-11-23,1021
00715L,期街口布蘭特正2,75,20,55,合庫-台中,2023-11-23,1021
2388,威盛,73,25,48,合庫-台中,2023-11-23,1021
3035,智原,57,13,44,合庫-台中,2023-11-23,1021
2002,中鋼,42,0,42,合庫-台中,2023-11-23,1021
00679B,元大美債20年,39,1,38,合庫-台中,2023-11-23,1021
3701,大眾控,36,1,35,合庫-台中,2023-11-23,1021
9946,三發地產,30,0,30,合庫-台中,2023-11-23,1021
00680L,元大美債20正2,29,0,29,合庫-台中,2023-11-23,1021
2427,三商電,29,0,29,合庫-台中,2023-11-23,1021
9105,泰金寶-DR,30,3,27,合庫-台中,2023-11-23,1021
4960,誠美材,50,25,25,合庫-台中,2023-11-23,1021
6139,亞翔,26,2,24,合庫-台中,2023-11-23,1021
2258,鴻華先進-創,24,0,24,合庫-台中,2023-11-23,1021
3169,亞信,28,5,23,合庫-台中,2023-11-23,1021
4908,前鼎,29,6,23,合庫-台中,2023-11-23,1021
2317,鴻海,36,14,22,合庫-台中,2023-11-23,1021
4956,光鋐,21,0,21,合庫-台中,2023-11-23,1021
00935,野村臺灣新科技50,21,0,21,合庫-台中,2023-11-23,1021
3005,神基,30,10,20,合庫-台中,2023-11-23,1021
3666,光耀,35,15,20,合庫-台中,2023-11-23,1021
1210,大成,21,1,20,合庫-台中,2023-11-23,1021
6485,點序,25,6,19,合庫-台中,2023-11-23,1021
2382,廣達,30,12,18,合庫-台中,2023-11-23,1021
2476,鉅祥,23,5,18,合庫-台中,2023-11-23,1021
6243,迅杰,28,10,18,合庫-台中,2023-11-23,1021
00934,中信成長高股息,18,1,17,合庫-台中,2023-11-23,1021
00936,台新永續高息中小,17,0,17,合庫-台中,2023-11-23,1021
3078,僑威,58,42,16,合庫-台中,2023-11-23,1021
1582,信錦,27,11,16,合庫-台中,2023-11-23,1021
2633,台灣高鐵,16,0,16,合庫-台中,2023-11-23,1021
8086,宏捷科,24,8,16,合庫-台中,2023-11-23,1021
9958,世紀鋼,15,0,15,合庫-台中,2023-11-23,1021
8040,九暘,21,6,15,合庫-台中,2023-11-23,1021
3438,類比科,15,0,15,合庫-台中,2023-11-23,1021
1815,富喬,18,3,15,合庫-台中,2023-11-23,1021
3528,安馳,22,7,15,合庫-台中,2023-11-23,1021
9136,巨騰-DR,326,20,306,合庫-台中,2023-11-24,1021
6282,康舒,235,99,136,合庫-台中,2023-11-24,1021
9904,寶成,81,0,81,合庫-台中,2023-11-24,1021
2618,長榮航,608,547,61,合庫-台中,2023-11-24,1021
2610,華航,89,32,57,合庫-台中,2023-11-24,1021
00919,群益台灣精選高息,57,1,56,合庫-台中,2023-11-24,1021
00631L,元大台灣50正2,300,250,50,合庫-台中,2023-11-24,1021
00751B,元大AAA至A公司債,44,0,44,合庫-台中,2023-11-24,1021
00687B,國泰20年美債,43,1,42,合庫-台中,2023-11-24,1021
2457,飛宏,261,221,40,合庫-台中,2023-11-24,1021
00632R,元大台灣50反1,40,0,40,合庫-台中,2023-11-24,1021
00772B,中信高評級公司債,39,0,39,合庫-台中,2023-11-24,1021
2645,長榮航太,39,1,38,合庫-台中,2023-11-24,1021
00933B,國泰10Y+金融債,37,1,36,合庫-台中,2023-11-24,1021
2356,英業達,51,16,35,合庫-台中,2023-11-24,1021
3701,大眾控,37,2,35,合庫-台中,2023-11-24,1021
00885,富邦越南,33,1,32,合庫-台中,2023-11-24,1021
2401,凌陽,37,6,31,合庫-台中,2023-11-24,1021
00679B,元大美債20年,30,0,30,合庫-台中,2023-11-24,1021
1570,力肯,29,0,29,合庫-台中,2023-11-24,1021
5521,工信,39,12,27,合庫-台中,2023-11-24,1021
2734,易飛網,27,0,27,合庫-台中,2023-11-24,1021
3006,晶豪科,31,4,27,合庫-台中,2023-11-24,1021
3056,富華新,37,10,27,合庫-台中,2023-11-24,1021
2382,廣達,45,21,24,合庫-台中,2023-11-24,1021
2317,鴻海,37,13,24,合庫-台中,2023-11-24,1021
00680L,元大美債20正2,28,5,23,合庫-台中,2023-11-24,1021
2344,華邦電,46,24,22,合庫-台中,2023-11-24,1021
00931B,統一美債20年,46,25,21,合庫-台中,2023-11-24,1021
6202,盛群,21,0,21,合庫-台中,2023-11-24,1021
2312,金寶,26,5,21,合庫-台中,2023-11-24,1021
00934,中信成長高股息,28,8,20,合庫-台中,2023-11-24,1021
1471,首利,20,0,20,合庫-台中,2023-11-24,1021
00715L,期街口布蘭特正2,52,32,20,合庫-台中,2023-11-24,1021
9105,泰金寶-DR,40,20,20,合庫-台中,2023-11-24,1021
9907,統一實,20,0,20,合庫-台中,2023-11-24,1021
00642U,期元大S＆P石油,20,2,18,合庫-台中,2023-11-24,1021
4113,聯上,16,0,16,合庫-台中,2023-11-24,1021
3594,磐儀,16,0,16,合庫-台中,2023-11-24,1021
6129,普誠,19,3,16,合庫-台中,2023-11-24,1021
6168,宏齊,22,6,16,合庫-台中,2023-11-24,1021
1314,中石化,15,0,15,合庫-台中,2023-11-24,1021
1809,中釉,15,0,15,合庫-台中,2023-11-24,1021
5351,鈺創,64,49,15,合庫-台中,2023-11-24,1021
00708L,期元大S＆P黃金正2,15,0,15,合庫-台中,2023-11-24,1021
3438,類比科,15,0,15,合庫-台中,2023-11-24,1021
2838,聯邦銀,46,31,15,合庫-台中,2023-11-24,1021
2027,大成鋼,15,0,15,合庫-台中,2023-11-24,1021
2353,宏��,22,8,14,合庫-台中,2023-11-24,1021
3260,威剛,14,0,14,合庫-台中,2023-11-24,1021
1503,士電,110,5,105,合庫-台中,2023-11-27,1021
00637L,元大滬深300正2,154,49,105,合庫-台中,2023-11-27,1021
00919,群益台灣精選高息,116,28,88,合庫-台中,2023-11-27,1021
6282,康舒,158,71,87,合庫-台中,2023-11-27,1021
00720B,元大投資級公司債,80,0,80,合庫-台中,2023-11-27,1021
2313,華通,355,280,75,合庫-台中,2023-11-27,1021
00632R,元大台灣50反1,335,270,65,合庫-台中,2023-11-27,1021
00878,國泰永續高股息,77,15,62,合庫-台中,2023-11-27,1021
00687B,國泰20年美債,65,3,62,合庫-台中,2023-11-27,1021
00715L,期街口布蘭特正2,112,50,62,合庫-台中,2023-11-27,1021
00933B,國泰10Y+金融債,91,30,61,合庫-台中,2023-11-27,1021
2888,新光金,65,4,61,合庫-台中,2023-11-27,1021
2303,聯電,81,28,53,合庫-台中,2023-11-27,1021
1513,中興電,163,111,52,合庫-台中,2023-11-27,1021
6202,盛群,49,1,48,合庫-台中,2023-11-27,1021
2883,凱基金,117,70,47,合庫-台中,2023-11-27,1021
2637,慧洋-KY,56,12,44,合庫-台中,2023-11-27,1021
3231,緯創,160,120,40,合庫-台中,2023-11-27,1021
00934,中信成長高股息,62,25,37,合庫-台中,2023-11-27,1021
3594,磐儀,46,10,36,合庫-台中,2023-11-27,1021
3035,智原,36,1,35,合庫-台中,2023-11-27,1021
8222,寶一,48,13,35,合庫-台中,2023-11-27,1021
4128,中天,38,5,33,合庫-台中,2023-11-27,1021
00680L,元大美債20正2,39,7,32,合庫-台中,2023-11-27,1021
1101,台泥,32,0,32,合庫-台中,2023-11-27,1021
2330,台積電,34,3,31,合庫-台中,2023-11-27,1021
3013,晟銘電,31,1,30,合庫-台中,2023-11-27,1021
3036,文曄,43,14,29,合庫-台中,2023-11-27,1021
00931B,統一美債20年,30,4,26,合庫-台中,2023-11-27,1021
3094,聯傑,68,42,26,合庫-台中,2023-11-27,1021
5347,世界,61,36,25,合庫-台中,2023-11-27,1021
2388,威盛,30,5,25,合庫-台中,2023-11-27,1021
2344,華邦電,28,3,25,合庫-台中,2023-11-27,1021
3041,揚智,33,10,23,合庫-台中,2023-11-27,1021
4743,合一,27,4,23,合庫-台中,2023-11-27,1021
2356,英業達,35,12,23,合庫-台中,2023-11-27,1021
6732,昇佳電子,22,1,21,合庫-台中,2023-11-27,1021
1314,中石化,22,1,21,合庫-台中,2023-11-27,1021
3189,景碩,25,5,20,合庫-台中,2023-11-27,1021
3011,今皓,20,0,20,合庫-台中,2023-11-27,1021
3088,艾訊,20,0,20,合庫-台中,2023-11-27,1021
1762,中化生,19,1,18,合庫-台中,2023-11-27,1021
3260,威剛,18,0,18,合庫-台中,2023-11-27,1021
2634,漢翔,26,9,17,合庫-台中,2023-11-27,1021
00882,中信中國高股息,17,0,17,合庫-台中,2023-11-27,1021
6419,京晨科,33,16,17,合庫-台中,2023-11-27,1021
3234,光環,17,1,16,合庫-台中,2023-11-27,1021
3481,群創,16,0,16,合庫-台中,2023-11-27,1021
00857B,永豐20年美公債,15,0,15,合庫-台中,2023-11-27,1021
4934,太極,15,0,15,合庫-台中,2023-11-27,1021
00632R,元大台灣50反1,1821,89,1732,合庫-台中,2023-11-28,1021
00929,復華台灣科技優息,372,107,265,合庫-台中,2023-11-28,1021
4414,如興,130,0,130,合庫-台中,2023-11-28,1021
00670L,富邦NASDAQ正2,120,0,120,合庫-台中,2023-11-28,1021
00882,中信中國高股息,112,0,112,合庫-台中,2023-11-28,1021
00673R,期元大S＆P原油反1,102,0,102,合庫-台中,2023-11-28,1021
2867,三商壽,100,0,100,合庫-台中,2023-11-28,1021
1514,亞力,160,70,90,合庫-台中,2023-11-28,1021
2303,聯電,119,31,88,合庫-台中,2023-11-28,1021
6770,力積電,102,21,81,合庫-台中,2023-11-28,1021
4113,聯上,80,0,80,合庫-台中,2023-11-28,1021
00712,復華富時不動產,63,0,63,合庫-台中,2023-11-28,1021
1101,台泥,86,24,62,合庫-台中,2023-11-28,1021
8415,大國鋼,58,0,58,合庫-台中,2023-11-28,1021
2883,凱基金,96,42,54,合庫-台中,2023-11-28,1021
5347,世界,56,4,52,合庫-台中,2023-11-28,1021
2542,興富發,60,8,52,合庫-台中,2023-11-28,1021
00885,富邦越南,51,0,51,合庫-台中,2023-11-28,1021
2610,華航,79,36,43,合庫-台中,2023-11-28,1021
2888,新光金,40,0,40,合庫-台中,2023-11-28,1021
00679B,元大美債20年,41,6,35,合庫-台中,2023-11-28,1021
2002,中鋼,43,10,33,合庫-台中,2023-11-28,1021
6282,康舒,176,144,32,合庫-台中,2023-11-28,1021
2313,華通,370,339,31,合庫-台中,2023-11-28,1021
6237,驊訊,36,6,30,合庫-台中,2023-11-28,1021
3231,緯創,119,90,29,合庫-台中,2023-11-28,1021
2363,矽統,108,82,26,合庫-台中,2023-11-28,1021
6901,鑽石投資,27,1,26,合庫-台中,2023-11-28,1021
2427,三商電,25,0,25,合庫-台中,2023-11-28,1021
2617,台航,25,1,24,合庫-台中,2023-11-28,1021
1781,合世,30,7,23,合庫-台中,2023-11-28,1021
6204,艾華,39,16,23,合庫-台中,2023-11-28,1021
00665L,富邦�琤肭磪囓�2,29,6,23,合庫-台中,2023-11-28,1021
6128,上福,22,0,22,合庫-台中,2023-11-28,1021
6243,迅杰,30,10,20,合庫-台中,2023-11-28,1021
3715,定穎投控,72,52,20,合庫-台中,2023-11-28,1021
2353,宏��,117,100,17,合庫-台中,2023-11-28,1021
00935,野村臺灣新科技50,18,2,16,合庫-台中,2023-11-28,1021
00902,中信電池及儲能,16,0,16,合庫-台中,2023-11-28,1021
2880,華南金,15,3,12,合庫-台中,2023-11-28,1021
3437,榮創,19,7,12,合庫-台中,2023-11-28,1021
2383,台光電,14,2,12,合庫-台中,2023-11-28,1021
3234,光環,11,0,11,合庫-台中,2023-11-28,1021
6195,詩肯,10,0,10,合庫-台中,2023-11-28,1021
3290,東浦,10,0,10,合庫-台中,2023-11-28,1021
6461,益得,10,0,10,合庫-台中,2023-11-28,1021
3705,永信,11,1,10,合庫-台中,2023-11-28,1021
1339,昭輝,12,2,10,合庫-台中,2023-11-28,1021
3594,磐儀,10,0,10,合庫-台中,2023-11-28,1021
2882,國泰金,10,0,10,合庫-台中,2023-11-28,1021
00665L,富邦�琤肭磪囓�2,273,0,273,合庫-台中,2023-11-29,1021
2329,華泰,375,130,245,合庫-台中,2023-11-29,1021
2324,仁寶,210,8,202,合庫-台中,2023-11-29,1021
00882,中信中國高股息,196,0,196,合庫-台中,2023-11-29,1021
2618,長榮航,256,89,167,合庫-台中,2023-11-29,1021
1795,美時,211,44,167,合庫-台中,2023-11-29,1021
4414,如興,130,3,127,合庫-台中,2023-11-29,1021
00687B,國泰20年美債,118,4,114,合庫-台中,2023-11-29,1021
00679B,元大美債20年,103,13,90,合庫-台中,2023-11-29,1021
2515,中工,81,0,81,合庫-台中,2023-11-29,1021
2887,台新金,67,1,66,合庫-台中,2023-11-29,1021
00673R,期元大S＆P原油反1,255,200,55,合庫-台中,2023-11-29,1021
1314,中石化,55,4,51,合庫-台中,2023-11-29,1021
8086,宏捷科,54,4,50,合庫-台中,2023-11-29,1021
2610,華航,52,3,49,合庫-台中,2023-11-29,1021
2313,華通,246,200,46,合庫-台中,2023-11-29,1021
2303,聯電,81,36,45,合庫-台中,2023-11-29,1021
2002,中鋼,58,15,43,合庫-台中,2023-11-29,1021
00919,群益台灣精選高息,95,52,43,合庫-台中,2023-11-29,1021
1717,長興,40,0,40,合庫-台中,2023-11-29,1021
2377,微星,48,9,39,合庫-台中,2023-11-29,1021
8936,國統,37,0,37,合庫-台中,2023-11-29,1021
4973,廣穎,46,13,33,合庫-台中,2023-11-29,1021
2888,新光金,32,0,32,合庫-台中,2023-11-29,1021
6129,普誠,32,0,32,合庫-台中,2023-11-29,1021
2883B,凱基金乙特,30,0,30,合庫-台中,2023-11-29,1021
2605,新興,54,27,27,合庫-台中,2023-11-29,1021
5432,新門,26,0,26,合庫-台中,2023-11-29,1021
00935,野村臺灣新科技50,26,0,26,合庫-台中,2023-11-29,1021
00712,復華富時不動產,25,0,25,合庫-台中,2023-11-29,1021
2889,國票金,25,0,25,合庫-台中,2023-11-29,1021
1101,台泥,36,12,24,合庫-台中,2023-11-29,1021
3545,敦泰,44,20,24,合庫-台中,2023-11-29,1021
2867,三商壽,23,0,23,合庫-台中,2023-11-29,1021
5608,四維航,33,10,23,合庫-台中,2023-11-29,1021
1514,亞力,29,7,22,合庫-台中,2023-11-29,1021
2363,矽統,98,77,21,合庫-台中,2023-11-29,1021
2323,中環,21,0,21,合庫-台中,2023-11-29,1021
6116,彩晶,21,1,20,合庫-台中,2023-11-29,1021
4129,聯合,20,0,20,合庫-台中,2023-11-29,1021
3363,上詮,38,19,19,合庫-台中,2023-11-29,1021
3122,笙泉,29,10,19,合庫-台中,2023-11-29,1021
00888,永豐台灣ESG,19,0,19,合庫-台中,2023-11-29,1021
9945,潤泰新,18,0,18,合庫-台中,2023-11-29,1021
2634,漢翔,19,1,18,合庫-台中,2023-11-29,1021
2317,鴻海,33,16,17,合庫-台中,2023-11-29,1021
3594,磐儀,17,0,17,合庫-台中,2023-11-29,1021
3094,聯傑,26,9,17,合庫-台中,2023-11-29,1021
8110,華東,17,0,17,合庫-台中,2023-11-29,1021
1104,環泥,16,0,16,合庫-台中,2023-11-29,1021
00673R,期元大S＆P原油反1,370,0,370,合庫-台中,2023-11-30,1021
2329,華泰,557,316,241,合庫-台中,2023-11-30,1021
2421,建準,179,8,171,合庫-台中,2023-11-30,1021
3231,緯創,110,39,71,合庫-台中,2023-11-30,1021
2388,威盛,98,37,61,合庫-台中,2023-11-30,1021
4908,前鼎,68,8,60,合庫-台中,2023-11-30,1021
2303,聯電,75,15,60,合庫-台中,2023-11-30,1021
5272,笙科,62,5,57,合庫-台中,2023-11-30,1021
4401,東隆興,50,0,50,合庫-台中,2023-11-30,1021
00882,中信中國高股息,49,0,49,合庫-台中,2023-11-30,1021
6558,興能高,50,1,49,合庫-台中,2023-11-30,1021
2369,菱生,49,2,47,合庫-台中,2023-11-30,1021
2888,新光金,50,4,46,合庫-台中,2023-11-30,1021
00680L,元大美債20正2,168,122,46,合庫-台中,2023-11-30,1021
2516,新建,46,0,46,合庫-台中,2023-11-30,1021
00679B,元大美債20年,45,0,45,合庫-台中,2023-11-30,1021
3317,尼克森,64,24,40,合庫-台中,2023-11-30,1021
00720B,元大投資級公司債,55,15,40,合庫-台中,2023-11-30,1021
3481,群創,113,80,33,合庫-台中,2023-11-30,1021
2883,凱基金,87,56,31,合庫-台中,2023-11-30,1021
2344,華邦電,171,142,29,合庫-台中,2023-11-30,1021
8415,大國鋼,28,0,28,合庫-台中,2023-11-30,1021
8054,安國,63,36,27,合庫-台中,2023-11-30,1021
4919,新唐,37,12,25,合庫-台中,2023-11-30,1021
3594,磐儀,24,0,24,合庫-台中,2023-11-30,1021
2002,中鋼,93,70,23,合庫-台中,2023-11-30,1021
4739,康普,26,3,23,合庫-台中,2023-11-30,1021
3715,定穎投控,59,37,22,合庫-台中,2023-11-30,1021
5521,工信,53,32,21,合庫-台中,2023-11-30,1021
1795,美時,22,1,21,合庫-台中,2023-11-30,1021
0056,元大高股息,35,15,20,合庫-台中,2023-11-30,1021
6533,晶心科,24,4,20,合庫-台中,2023-11-30,1021
3532,台勝科,22,2,20,合庫-台中,2023-11-30,1021
3530,晶相光,24,4,20,合庫-台中,2023-11-30,1021
6129,普誠,20,0,20,合庫-台中,2023-11-30,1021
9919,康那香,80,61,19,合庫-台中,2023-11-30,1021
1325,恆大,42,23,19,合庫-台中,2023-11-30,1021
2371,大同,18,1,17,合庫-台中,2023-11-30,1021
1314,中石化,20,3,17,合庫-台中,2023-11-30,1021
00665L,富邦�琤肭磪囓�2,19,3,16,合庫-台中,2023-11-30,1021
2317,鴻海,16,0,16,合庫-台中,2023-11-30,1021
8112,至上,47,32,15,合庫-台中,2023-11-30,1021
6901,鑽石投資,18,3,15,合庫-台中,2023-11-30,1021
2201,裕隆,15,0,15,合庫-台中,2023-11-30,1021
6271,同欣電,24,10,14,合庫-台中,2023-11-30,1021
1513,中興電,30,16,14,合庫-台中,2023-11-30,1021
4114,健喬,16,3,13,合庫-台中,2023-11-30,1021
1605,華新,17,4,13,合庫-台中,2023-11-30,1021
2367,燿華,15,2,13,合庫-台中,2023-11-30,1021
00857B,永豐20年美公債,13,0,13,合庫-台中,2023-11-30,1021
2301,光寶科,504,2,502,合庫-台中,2023-12-01,1021
00637L,元大滬深300正2,265,8,257,合庫-台中,2023-12-01,1021
2618,長榮航,332,80,252,合庫-台中,2023-12-01,1021
00919,群益台灣精選高息,274,42,232,合庫-台中,2023-12-01,1021
00715L,期街口布蘭特正2,262,60,202,合庫-台中,2023-12-01,1021
2409,友達,231,29,202,合庫-台中,2023-12-01,1021
2883,凱基金,175,26,149,合庫-台中,2023-12-01,1021
2329,華泰,449,306,143,合庫-台中,2023-12-01,1021
4908,前鼎,143,4,139,合庫-台中,2023-12-01,1021
00670L,富邦NASDAQ正2,119,0,119,合庫-台中,2023-12-01,1021
4904,遠傳,107,0,107,合庫-台中,2023-12-01,1021
2002,中鋼,93,1,92,合庫-台中,2023-12-01,1021
00687B,國泰20年美債,81,2,79,合庫-台中,2023-12-01,1021
2887,台新金,77,2,75,合庫-台中,2023-12-01,1021
00679B,元大美債20年,80,7,73,合庫-台中,2023-12-01,1021
3450,聯鈞,92,24,68,合庫-台中,2023-12-01,1021
3706,神達,92,30,62,合庫-台中,2023-12-01,1021
2888,新光金,62,9,53,合庫-台中,2023-12-01,1021
2886,兆豐金,58,5,53,合庫-台中,2023-12-01,1021
00632R,元大台灣50反1,52,0,52,合庫-台中,2023-12-01,1021
2609,陽明,84,36,48,合庫-台中,2023-12-01,1021
00680L,元大美債20正2,46,0,46,合庫-台中,2023-12-01,1021
00655L,國泰中國A50正2,45,0,45,合庫-台中,2023-12-01,1021
3041,揚智,82,38,44,合庫-台中,2023-12-01,1021
2105,正新,44,1,43,合庫-台中,2023-12-01,1021
0056,元大高股息,41,0,41,合庫-台中,2023-12-01,1021
8096,擎亞,41,1,40,合庫-台中,2023-12-01,1021
00650L,復華香港正2,35,0,35,合庫-台中,2023-12-01,1021
4116,明基醫,34,0,34,合庫-台中,2023-12-01,1021
00665L,富邦�琤肭磪囓�2,40,6,34,合庫-台中,2023-12-01,1021
6187,萬潤,37,3,34,合庫-台中,2023-12-01,1021
5608,四維航,64,32,32,合庫-台中,2023-12-01,1021
6288,聯嘉,34,2,32,合庫-台中,2023-12-01,1021
8215,明基材,31,0,31,合庫-台中,2023-12-01,1021
2359,所羅門,52,22,30,合庫-台中,2023-12-01,1021
2891,中信金,28,0,28,合庫-台中,2023-12-01,1021
6426,統新,27,1,26,合庫-台中,2023-12-01,1021
2611,志信,24,0,24,合庫-台中,2023-12-01,1021
6237,驊訊,31,7,24,合庫-台中,2023-12-01,1021
00933B,國泰10Y+金融債,23,0,23,合庫-台中,2023-12-01,1021
2884,玉山金,23,0,23,合庫-台中,2023-12-01,1021
00795B,中信美國公債20年,23,0,23,合庫-台中,2023-12-01,1021
3594,磐儀,22,0,22,合庫-台中,2023-12-01,1021
4420,光明,36,14,22,合庫-台中,2023-12-01,1021
2027,大成鋼,25,3,22,合庫-台中,2023-12-01,1021
2317,鴻海,26,5,21,合庫-台中,2023-12-01,1021
00878,國泰永續高股息,175,154,21,合庫-台中,2023-12-01,1021
00935,野村臺灣新科技50,21,0,21,合庫-台中,2023-12-01,1021
8034,榮群,21,0,21,合庫-台中,2023-12-01,1021
3363,上詮,34,14,20,合庫-台中,2023-12-01,1021
00715L,期街口布蘭特正2,835,196,639,合庫-台中,2023-12-04,1021
00679B,元大美債20年,513,31,482,合庫-台中,2023-12-04,1021
00882,中信中國高股息,246,0,246,合庫-台中,2023-12-04,1021
3481,群創,498,287,211,合庫-台中,2023-12-04,1021
2883,凱基金,200,14,186,合庫-台中,2023-12-04,1021
4167,松瑞藥,140,11,129,合庫-台中,2023-12-04,1021
2388,威盛,271,151,120,合庫-台中,2023-12-04,1021
00919,群益台灣精選高息,175,64,111,合庫-台中,2023-12-04,1021
00637L,元大滬深300正2,101,0,101,合庫-台中,2023-12-04,1021
2313,華通,142,42,100,合庫-台中,2023-12-04,1021
3231,緯創,137,53,84,合庫-台中,2023-12-04,1021
3013,晟銘電,154,72,82,合庫-台中,2023-12-04,1021
2329,華泰,290,209,81,合庫-台中,2023-12-04,1021
2516,新建,127,50,77,合庫-台中,2023-12-04,1021
00688L,國泰20年美債正2,85,10,75,合庫-台中,2023-12-04,1021
9938,百和,197,123,74,合庫-台中,2023-12-04,1021
2344,華邦電,71,5,66,合庫-台中,2023-12-04,1021
1605,華新,74,9,65,合庫-台中,2023-12-04,1021
00720B,元大投資級公司債,60,1,59,合庫-台中,2023-12-04,1021
1504,東元,57,2,55,合庫-台中,2023-12-04,1021
2606,裕民,181,129,52,合庫-台中,2023-12-04,1021
2637,慧洋-KY,99,47,52,合庫-台中,2023-12-04,1021
8940,新天地,48,0,48,合庫-台中,2023-12-04,1021
4533,協易機,76,29,47,合庫-台中,2023-12-04,1021
2515,中工,41,0,41,合庫-台中,2023-12-04,1021
8358,金居,41,1,40,合庫-台中,2023-12-04,1021
00642U,期元大S＆P石油,39,0,39,合庫-台中,2023-12-04,1021
2482,連宇,65,32,33,合庫-台中,2023-12-04,1021
2486,一詮,34,1,33,合庫-台中,2023-12-04,1021
00918,大華優利高填息30,50,17,33,合庫-台中,2023-12-04,1021
2355,敬鵬,77,46,31,合庫-台中,2023-12-04,1021
5521,工信,62,33,29,合庫-台中,2023-12-04,1021
6125,廣運,57,28,29,合庫-台中,2023-12-04,1021
2498,宏達電,31,3,28,合庫-台中,2023-12-04,1021
00687B,國泰20年美債,36,10,26,合庫-台中,2023-12-04,1021
2889,國票金,25,0,25,合庫-台中,2023-12-04,1021
6233,旺玖,31,6,25,合庫-台中,2023-12-04,1021
2421,建準,29,5,24,合庫-台中,2023-12-04,1021
3047,訊舟,26,2,24,合庫-台中,2023-12-04,1021
3706,神達,46,23,23,合庫-台中,2023-12-04,1021
5328,華容,35,12,23,合庫-台中,2023-12-04,1021
3715,定穎投控,64,41,23,合庫-台中,2023-12-04,1021
8215,明基材,21,0,21,合庫-台中,2023-12-04,1021
4543,萬在,27,6,21,合庫-台中,2023-12-04,1021
2897,王道銀行,20,0,20,合庫-台中,2023-12-04,1021
8054,安國,22,3,19,合庫-台中,2023-12-04,1021
3680,家登,22,3,19,合庫-台中,2023-12-04,1021
3594,磐儀,19,0,19,合庫-台中,2023-12-04,1021
3454,晶睿,18,0,18,合庫-台中,2023-12-04,1021
3078,僑威,20,2,18,合庫-台中,2023-12-04,1021
00882,中信中國高股息,226,1,225,合庫-台中,2023-12-05,1021
00929,復華台灣科技優息,236,14,222,合庫-台中,2023-12-05,1021
00919,群益台灣精選高息,227,17,210,合庫-台中,2023-12-05,1021
6282,康舒,219,16,203,合庫-台中,2023-12-05,1021
00937B,群益ESG投等債20,214,15,199,合庫-台中,2023-12-05,1021
9103,美德醫療-DR,133,5,128,合庫-台中,2023-12-05,1021
00878,國泰永續高股息,132,9,123,合庫-台中,2023-12-05,1021
00680L,元大美債20正2,191,83,108,合庫-台中,2023-12-05,1021
0056,元大高股息,125,22,103,合庫-台中,2023-12-05,1021
00918,大華優利高填息30,103,3,100,合庫-台中,2023-12-05,1021
2883,凱基金,111,14,97,合庫-台中,2023-12-05,1021
3231,緯創,228,134,94,合庫-台中,2023-12-05,1021
5347,世界,99,5,94,合庫-台中,2023-12-05,1021
3050,鈺德,125,35,90,合庫-台中,2023-12-05,1021
2105,正新,122,34,88,合庫-台中,2023-12-05,1021
6117,迎廣,101,23,78,合庫-台中,2023-12-05,1021
2641,正德,131,56,75,合庫-台中,2023-12-05,1021
1314,中石化,80,9,71,合庫-台中,2023-12-05,1021
2888,新光金,90,22,68,合庫-台中,2023-12-05,1021
1605,華新,68,3,65,合庫-台中,2023-12-05,1021
00687B,國泰20年美債,91,30,61,合庫-台中,2023-12-05,1021
00642U,期元大S＆P石油,59,0,59,合庫-台中,2023-12-05,1021
00665L,富邦�琤肭磪囓�2,59,5,54,合庫-台中,2023-12-05,1021
00934,中信成長高股息,51,1,50,合庫-台中,2023-12-05,1021
4414,如興,50,0,50,合庫-台中,2023-12-05,1021
2303,聯電,90,41,49,合庫-台中,2023-12-05,1021
6288,聯嘉,51,2,49,合庫-台中,2023-12-05,1021
2615,萬海,81,33,48,合庫-台中,2023-12-05,1021
00632R,元大台灣50反1,92,45,47,合庫-台中,2023-12-05,1021
2617,台航,120,80,40,合庫-台中,2023-12-05,1021
8415,大國鋼,40,0,40,合庫-台中,2023-12-05,1021
2515,中工,39,0,39,合庫-台中,2023-12-05,1021
00712,復華富時不動產,48,10,38,合庫-台中,2023-12-05,1021
00715L,期街口布蘭特正2,37,2,35,合庫-台中,2023-12-05,1021
2607,榮運,37,4,33,合庫-台中,2023-12-05,1021
00915,凱基優選高股息30,34,1,33,合庫-台中,2023-12-05,1021
00936,台新永續高息中小,42,10,32,合庫-台中,2023-12-05,1021
00637L,元大滬深300正2,52,20,32,合庫-台中,2023-12-05,1021
00720B,元大投資級公司債,39,7,32,合庫-台中,2023-12-05,1021
00922,國泰台灣領袖50,43,12,31,合庫-台中,2023-12-05,1021
6598,ABC-KY,31,0,31,合庫-台中,2023-12-05,1021
00706L,期元大S＆P日圓正2,30,0,30,合庫-台中,2023-12-05,1021
2610,華航,107,77,30,合庫-台中,2023-12-05,1021
2887,台新金,28,0,28,合庫-台中,2023-12-05,1021
5603,陸海,28,0,28,合庫-台中,2023-12-05,1021
2606,裕民,512,485,27,合庫-台中,2023-12-05,1021
4167,松瑞藥,123,96,27,合庫-台中,2023-12-05,1021
00923,群益台ESG低碳50,33,7,26,合庫-台中,2023-12-05,1021
2891,中信金,27,1,26,合庫-台中,2023-12-05,1021
5351,鈺創,28,3,25,合庫-台中,2023-12-05,1021
6282,康舒,1593,234,1359,合庫-台中,2023-12-06,1021
00937B,群益ESG投等債20,521,0,521,合庫-台中,2023-12-06,1021
2301,光寶科,526,12,514,合庫-台中,2023-12-06,1021
00680L,元大美債20正2,121,5,116,合庫-台中,2023-12-06,1021
00631L,元大台灣50正2,282,180,102,合庫-台中,2023-12-06,1021
00688L,國泰20年美債正2,82,0,82,合庫-台中,2023-12-06,1021
2409,友達,96,18,78,合庫-台中,2023-12-06,1021
1515,力山,98,31,67,合庫-台中,2023-12-06,1021
3481,群創,411,344,67,合庫-台中,2023-12-06,1021
2867,三商壽,97,33,64,合庫-台中,2023-12-06,1021
8415,大國鋼,55,0,55,合庫-台中,2023-12-06,1021
5386,青雲,59,5,54,合庫-台中,2023-12-06,1021
00919,群益台灣精選高息,63,11,52,合庫-台中,2023-12-06,1021
2801,彰銀,50,1,49,合庫-台中,2023-12-06,1021
00687B,國泰20年美債,50,2,48,合庫-台中,2023-12-06,1021
2641,正德,57,12,45,合庫-台中,2023-12-06,1021
3260,威剛,51,8,43,合庫-台中,2023-12-06,1021
00918,大華優利高填息30,43,0,43,合庫-台中,2023-12-06,1021
8054,安國,59,16,43,合庫-台中,2023-12-06,1021
2371,大同,61,20,41,合庫-台中,2023-12-06,1021
2516,新建,45,5,40,合庫-台中,2023-12-06,1021
6733,博晟生醫,41,1,40,合庫-台中,2023-12-06,1021
00933B,國泰10Y+金融債,39,0,39,合庫-台中,2023-12-06,1021
2888,新光金,54,15,39,合庫-台中,2023-12-06,1021
2355,敬鵬,80,41,39,合庫-台中,2023-12-06,1021
3191,雲嘉南,39,0,39,合庫-台中,2023-12-06,1021
5347,世界,40,7,33,合庫-台中,2023-12-06,1021
1314,中石化,32,0,32,合庫-台中,2023-12-06,1021
00679B,元大美債20年,63,31,32,合庫-台中,2023-12-06,1021
8070,長華*,31,0,31,合庫-台中,2023-12-06,1021
6148,驊宏資,33,2,31,合庫-台中,2023-12-06,1021
2614,東森,31,0,31,合庫-台中,2023-12-06,1021
6121,新普,31,0,31,合庫-台中,2023-12-06,1021
00935,野村臺灣新科技50,30,0,30,合庫-台中,2023-12-06,1021
6288,聯嘉,30,0,30,合庫-台中,2023-12-06,1021
5521,工信,46,17,29,合庫-台中,2023-12-06,1021
2303,聯電,31,3,28,合庫-台中,2023-12-06,1021
00931B,統一美債20年,28,2,26,合庫-台中,2023-12-06,1021
4763,材料-KY,31,5,26,合庫-台中,2023-12-06,1021
2515,中工,30,7,23,合庫-台中,2023-12-06,1021
2542,興富發,22,0,22,合庫-台中,2023-12-06,1021
2352,佳世達,30,8,22,合庫-台中,2023-12-06,1021
2066,世德,21,0,21,合庫-台中,2023-12-06,1021
8183,精星,21,1,20,合庫-台中,2023-12-06,1021
1582,信錦,41,21,20,合庫-台中,2023-12-06,1021
2402,毅嘉,25,6,19,合庫-台中,2023-12-06,1021
2454,聯發科,19,0,19,合庫-台中,2023-12-06,1021
4113,聯上,18,0,18,合庫-台中,2023-12-06,1021
4743,合一,18,1,17,合庫-台中,2023-12-06,1021
2492,華新科,20,3,17,合庫-台中,2023-12-06,1021
00680L,元大美債20正2,380,1,379,合庫-台中,2023-12-07,1021
00919,群益台灣精選高息,370,40,330,合庫-台中,2023-12-07,1021
00706L,期元大S＆P日圓正2,220,0,220,合庫-台中,2023-12-07,1021
00688L,國泰20年美債正2,215,2,213,合庫-台中,2023-12-07,1021
00715L,期街口布蘭特正2,263,70,193,合庫-台中,2023-12-07,1021
00712,復華富時不動產,187,10,177,合庫-台中,2023-12-07,1021
4939,亞電,172,4,168,合庫-台中,2023-12-07,1021
3041,揚智,306,152,154,合庫-台中,2023-12-07,1021
00937B,群益ESG投等債20,1275,1132,143,合庫-台中,2023-12-07,1021
00650L,復華香港正2,141,0,141,合庫-台中,2023-12-07,1021
00687B,國泰20年美債,131,13,118,合庫-台中,2023-12-07,1021
00679B,元大美債20年,156,62,94,合庫-台中,2023-12-07,1021
1515,力山,86,6,80,合庫-台中,2023-12-07,1021
00642U,期元大S＆P石油,79,0,79,合庫-台中,2023-12-07,1021
00665L,富邦�琤肭磪囓�2,74,0,74,合庫-台中,2023-12-07,1021
00655L,國泰中國A50正2,61,0,61,合庫-台中,2023-12-07,1021
3260,威剛,65,7,58,合庫-台中,2023-12-07,1021
2453,凌群,106,57,49,合庫-台中,2023-12-07,1021
2880,華南金,50,5,45,合庫-台中,2023-12-07,1021
4533,協易機,64,20,44,合庫-台中,2023-12-07,1021
00931B,統一美債20年,50,9,41,合庫-台中,2023-12-07,1021
3596,智易,39,1,38,合庫-台中,2023-12-07,1021
00918,大華優利高填息30,41,4,37,合庫-台中,2023-12-07,1021
00671R,富邦NASDAQ反1,35,0,35,合庫-台中,2023-12-07,1021
2002,中鋼,37,2,35,合庫-台中,2023-12-07,1021
6419,京晨科,38,5,33,合庫-台中,2023-12-07,1021
2367,燿華,81,48,33,合庫-台中,2023-12-07,1021
1522,堤維西,83,51,32,合庫-台中,2023-12-07,1021
4915,致伸,32,0,32,合庫-台中,2023-12-07,1021
2330,台積電,32,0,32,合庫-台中,2023-12-07,1021
3088,艾訊,31,0,31,合庫-台中,2023-12-07,1021
2889,國票金,40,10,30,合庫-台中,2023-12-07,1021
2606,裕民,174,144,30,合庫-台中,2023-12-07,1021
2388,威盛,94,67,27,合庫-台中,2023-12-07,1021
4908,前鼎,27,0,27,合庫-台中,2023-12-07,1021
1447,力鵬,30,3,27,合庫-台中,2023-12-07,1021
6129,普誠,27,0,27,合庫-台中,2023-12-07,1021
3715,定穎投控,33,7,26,合庫-台中,2023-12-07,1021
6117,迎廣,73,47,26,合庫-台中,2023-12-07,1021
00935,野村臺灣新科技50,27,2,25,合庫-台中,2023-12-07,1021
2399,映泰,48,23,25,合庫-台中,2023-12-07,1021
6770,力積電,25,1,24,合庫-台中,2023-12-07,1021
9946,三發地產,22,0,22,合庫-台中,2023-12-07,1021
6223,旺矽,22,0,22,合庫-台中,2023-12-07,1021
00857B,永豐20年美公債,21,0,21,合庫-台中,2023-12-07,1021
8415,大國鋼,20,0,20,合庫-台中,2023-12-07,1021
6288,聯嘉,20,0,20,合庫-台中,2023-12-07,1021
2838,聯邦銀,20,0,20,合庫-台中,2023-12-07,1021
0056,元大高股息,72,53,19,合庫-台中,2023-12-07,1021
1513,中興電,64,45,19,合庫-台中,2023-12-07,1021
00632R,元大台灣50反1,1542,40,1502,合庫-台中,2023-12-08,1021
00680L,元大美債20正2,272,20,252,合庫-台中,2023-12-08,1021
2618,長榮航,438,257,181,合庫-台中,2023-12-08,1021
2606,裕民,170,15,155,合庫-台中,2023-12-08,1021
00715L,期街口布蘭特正2,142,15,127,合庫-台中,2023-12-08,1021
2605,新興,399,275,124,合庫-台中,2023-12-08,1021
2303,聯電,123,7,116,合庫-台中,2023-12-08,1021
00679B,元大美債20年,116,1,115,合庫-台中,2023-12-08,1021
00712,復華富時不動產,111,4,107,合庫-台中,2023-12-08,1021
1515,力山,79,2,77,合庫-台中,2023-12-08,1021
00687B,國泰20年美債,80,4,76,合庫-台中,2023-12-08,1021
00706L,期元大S＆P日圓正2,120,50,70,合庫-台中,2023-12-08,1021
2376,技嘉,133,65,68,合庫-台中,2023-12-08,1021
2421,建準,70,7,63,合庫-台中,2023-12-08,1021
1618,合機,87,27,60,合庫-台中,2023-12-08,1021
1609,大亞,72,16,56,合庫-台中,2023-12-08,1021
3013,晟銘電,69,14,55,合庫-台中,2023-12-08,1021
6233,旺玖,77,23,54,合庫-台中,2023-12-08,1021
3231,緯創,138,90,48,合庫-台中,2023-12-08,1021
00919,群益台灣精選高息,133,86,47,合庫-台中,2023-12-08,1021
00688L,國泰20年美債正2,53,10,43,合庫-台中,2023-12-08,1021
00937B,群益ESG投等債20,101,61,40,合庫-台中,2023-12-08,1021
8054,安國,79,40,39,合庫-台中,2023-12-08,1021
1616,億泰,50,12,38,合庫-台中,2023-12-08,1021
00751B,元大AAA至A公司債,42,7,35,合庫-台中,2023-12-08,1021
2363,矽統,35,0,35,合庫-台中,2023-12-08,1021
00933B,國泰10Y+金融債,35,1,34,合庫-台中,2023-12-08,1021
2427,三商電,33,0,33,合庫-台中,2023-12-08,1021
1815,富喬,34,2,32,合庫-台中,2023-12-08,1021
2457,飛宏,39,7,32,合庫-台中,2023-12-08,1021
5258,虹堡,33,1,32,合庫-台中,2023-12-08,1021
2314,台揚,36,6,30,合庫-台中,2023-12-08,1021
2614,東森,30,0,30,合庫-台中,2023-12-08,1021
4174,浩鼎,30,0,30,合庫-台中,2023-12-08,1021
2338,光罩,25,0,25,合庫-台中,2023-12-08,1021
00929,復華台灣科技優息,44,21,23,合庫-台中,2023-12-08,1021
3035,智原,45,22,23,合庫-台中,2023-12-08,1021
2884,玉山金,30,7,23,合庫-台中,2023-12-08,1021
6117,迎廣,25,3,22,合庫-台中,2023-12-08,1021
3438,類比科,22,0,22,合庫-台中,2023-12-08,1021
2889,國票金,21,0,21,合庫-台中,2023-12-08,1021
2458,義隆,25,4,21,合庫-台中,2023-12-08,1021
5351,鈺創,106,85,21,合庫-台中,2023-12-08,1021
6414,樺漢,20,0,20,合庫-台中,2023-12-08,1021
6116,彩晶,20,0,20,合庫-台中,2023-12-08,1021
8299,群聯,20,0,20,合庫-台中,2023-12-08,1021
00927,群益半導體收益,20,1,19,合庫-台中,2023-12-08,1021
3706,神達,32,14,18,合庫-台中,2023-12-08,1021
2515,中工,16,0,16,合庫-台中,2023-12-08,1021
1529,樂事綠能,41,26,15,合庫-台中,2023-12-08,1021
2301,光寶科,521,7,514,合庫-台中,2023-12-11,1021
2603,長榮,514,25,489,合庫-台中,2023-12-11,1021
00919,群益台灣精選高息,606,306,300,合庫-台中,2023-12-11,1021
6282,康舒,208,8,200,合庫-台中,2023-12-11,1021
00680L,元大美債20正2,191,15,176,合庫-台中,2023-12-11,1021
1515,力山,145,19,126,合庫-台中,2023-12-11,1021
00679B,元大美債20年,112,2,110,合庫-台中,2023-12-11,1021
00712,復華富時不動產,115,15,100,合庫-台中,2023-12-11,1021
2002,中鋼,103,3,100,合庫-台中,2023-12-11,1021
2329,華泰,112,17,95,合庫-台中,2023-12-11,1021
00687B,國泰20年美債,88,2,86,合庫-台中,2023-12-11,1021
2547,日勝生,80,0,80,合庫-台中,2023-12-11,1021
00688L,國泰20年美債正2,79,8,71,合庫-台中,2023-12-11,1021
3499,環天科,71,1,70,合庫-台中,2023-12-11,1021
2313,華通,187,118,69,合庫-台中,2023-12-11,1021
1618,合機,93,29,64,合庫-台中,2023-12-11,1021
4167,松瑞藥,71,10,61,合庫-台中,2023-12-11,1021
00882,中信中國高股息,70,13,57,合庫-台中,2023-12-11,1021
2332,友訊,59,4,55,合庫-台中,2023-12-11,1021
1524,耿鼎,114,60,54,合庫-台中,2023-12-11,1021
2421,建準,54,2,52,合庫-台中,2023-12-11,1021
3041,揚智,158,111,47,合庫-台中,2023-12-11,1021
2889,國票金,46,0,46,合庫-台中,2023-12-11,1021
1305,華夏,43,0,43,合庫-台中,2023-12-11,1021
2891,中信金,44,1,43,合庫-台中,2023-12-11,1021
2888,新光金,145,103,42,合庫-台中,2023-12-11,1021
6114,久威,40,0,40,合庫-台中,2023-12-11,1021
2641,正德,39,2,37,合庫-台中,2023-12-11,1021
6285,啟��,66,30,36,合庫-台中,2023-12-11,1021
1528,恩德,35,0,35,合庫-台中,2023-12-11,1021
2388,威盛,130,95,35,合庫-台中,2023-12-11,1021
00665L,富邦�琤肭磪囓�2,34,0,34,合庫-台中,2023-12-11,1021
5328,華容,35,1,34,合庫-台中,2023-12-11,1021
6220,岳豐,34,0,34,合庫-台中,2023-12-11,1021
2884,玉山金,43,10,33,合庫-台中,2023-12-11,1021
2610,華航,37,7,30,合庫-台中,2023-12-11,1021
00674R,期元大S＆P黃金反1,30,0,30,合庫-台中,2023-12-11,1021
2618,長榮航,45,17,28,合庫-台中,2023-12-11,1021
6266,泰詠,30,2,28,合庫-台中,2023-12-11,1021
00931B,統一美債20年,30,2,28,合庫-台中,2023-12-11,1021
00753L,中信中國50正2,58,31,27,合庫-台中,2023-12-11,1021
8996,高力,27,1,26,合庫-台中,2023-12-11,1021
3050,鈺德,27,3,24,合庫-台中,2023-12-11,1021
6547,高端疫苗,25,2,23,合庫-台中,2023-12-11,1021
3596,智易,23,0,23,合庫-台中,2023-12-11,1021
1536,和大,22,0,22,合庫-台中,2023-12-11,1021
3234,光環,21,0,21,合庫-台中,2023-12-11,1021
3390,旭軟,19,0,19,合庫-台中,2023-12-11,1021
00795B,中信美國公債20年,19,0,19,合庫-台中,2023-12-11,1021
8227,巨有科技,32,14,18,合庫-台中,2023-12-11,1021
00919,群益台灣精選高息,511,290,221,合庫-台中,2023-12-12,1021
2603,長榮,634,438,196,合庫-台中,2023-12-12,1021
00687B,國泰20年美債,129,1,128,合庫-台中,2023-12-12,1021
5521,工信,241,131,110,合庫-台中,2023-12-12,1021
2409,友達,115,21,94,合庫-台中,2023-12-12,1021
00929,復華台灣科技優息,221,138,83,合庫-台中,2023-12-12,1021
3059,華晶科,97,21,76,合庫-台中,2023-12-12,1021
00679B,元大美債20年,69,6,63,合庫-台中,2023-12-12,1021
3041,揚智,70,12,58,合庫-台中,2023-12-12,1021
00680L,元大美債20正2,63,5,58,合庫-台中,2023-12-12,1021
2002,中鋼,55,2,53,合庫-台中,2023-12-12,1021
2883,凱基金,71,20,51,合庫-台中,2023-12-12,1021
6290,良維,51,5,46,合庫-台中,2023-12-12,1021
1609,大亞,61,18,43,合庫-台中,2023-12-12,1021
1514,亞力,120,79,41,合庫-台中,2023-12-12,1021
1314,中石化,62,22,40,合庫-台中,2023-12-12,1021
2882,國泰金,42,2,40,合庫-台中,2023-12-12,1021
3231,緯創,85,45,40,合庫-台中,2023-12-12,1021
1608,華榮,78,39,39,合庫-台中,2023-12-12,1021
00878,國泰永續高股息,48,14,34,合庫-台中,2023-12-12,1021
00665L,富邦�琤肭磪囓�2,87,55,32,合庫-台中,2023-12-12,1021
00712,復華富時不動產,32,2,30,合庫-台中,2023-12-12,1021
8096,擎亞,52,26,26,合庫-台中,2023-12-12,1021
1308,亞聚,25,0,25,合庫-台中,2023-12-12,1021
2388,威盛,45,21,24,合庫-台中,2023-12-12,1021
00751B,元大AAA至A公司債,23,0,23,合庫-台中,2023-12-12,1021
2353,宏��,29,6,23,合庫-台中,2023-12-12,1021
3438,類比科,21,0,21,合庫-台中,2023-12-12,1021
6257,矽格,21,0,21,合庫-台中,2023-12-12,1021
3596,智易,26,6,20,合庫-台中,2023-12-12,1021
6116,彩晶,36,16,20,合庫-台中,2023-12-12,1021
6220,岳豐,20,0,20,合庫-台中,2023-12-12,1021
2706,第一店,20,0,20,合庫-台中,2023-12-12,1021
00907,永豐優息存股,20,0,20,合庫-台中,2023-12-12,1021
8936,國統,32,13,19,合庫-台中,2023-12-12,1021
8034,榮群,21,2,19,合庫-台中,2023-12-12,1021
4979,華星光,40,22,18,合庫-台中,2023-12-12,1021
2358,廷鑫,20,2,18,合庫-台中,2023-12-12,1021
2369,菱生,31,13,18,合庫-台中,2023-12-12,1021
4908,前鼎,28,11,17,合庫-台中,2023-12-12,1021
2402,毅嘉,36,19,17,合庫-台中,2023-12-12,1021
00931B,統一美債20年,19,2,17,合庫-台中,2023-12-12,1021
2027,大成鋼,17,0,17,合庫-台中,2023-12-12,1021
8227,巨有科技,28,12,16,合庫-台中,2023-12-12,1021
2880,華南金,18,2,16,合庫-台中,2023-12-12,1021
00937B,群益ESG投等債20,79,63,16,合庫-台中,2023-12-12,1021
3338,泰碩,17,1,16,合庫-台中,2023-12-12,1021
4743,合一,16,1,15,合庫-台中,2023-12-12,1021
2888,新光金,35,20,15,合庫-台中,2023-12-12,1021
3706,神達,22,7,15,合庫-台中,2023-12-12,1021
2618,長榮航,1231,21,1210,合庫-台中,2023-12-13,1021
00919,群益台灣精選高息,331,54,277,合庫-台中,2023-12-13,1021
00715L,期街口布蘭特正2,182,6,176,合庫-台中,2023-12-13,1021
00720B,元大投資級公司債,168,1,167,合庫-台中,2023-12-13,1021
6282,康舒,140,10,130,合庫-台中,2023-12-13,1021
2409,友達,124,32,92,合庫-台中,2023-12-13,1021
00712,復華富時不動產,127,38,89,合庫-台中,2023-12-13,1021
2610,華航,85,10,75,合庫-台中,2023-12-13,1021
00915,凱基優選高股息30,66,0,66,合庫-台中,2023-12-13,1021
6285,啟��,216,154,62,合庫-台中,2023-12-13,1021
00934,中信成長高股息,85,24,61,合庫-台中,2023-12-13,1021
3481,群創,60,0,60,合庫-台中,2023-12-13,1021
2421,建準,76,25,51,合庫-台中,2023-12-13,1021
2002,中鋼,50,6,44,合庫-台中,2023-12-13,1021
00882,中信中國高股息,43,2,41,合庫-台中,2023-12-13,1021
00642U,期元大S＆P石油,41,0,41,合庫-台中,2023-12-13,1021
2882,國泰金,48,7,41,合庫-台中,2023-12-13,1021
4933,友輝,43,6,37,合庫-台中,2023-12-13,1021
2633,台灣高鐵,33,0,33,合庫-台中,2023-12-13,1021
2612,中航,43,12,31,合庫-台中,2023-12-13,1021
8415,大國鋼,30,0,30,合庫-台中,2023-12-13,1021
00687B,國泰20年美債,54,26,28,合庫-台中,2023-12-13,1021
8112,至上,50,22,28,合庫-台中,2023-12-13,1021
1795,美時,34,6,28,合庫-台中,2023-12-13,1021
00918,大華優利高填息30,40,13,27,合庫-台中,2023-12-13,1021
00933B,國泰10Y+金融債,26,0,26,合庫-台中,2023-12-13,1021
2543,皇昌,47,21,26,合庫-台中,2023-12-13,1021
2427,三商電,27,1,26,合庫-台中,2023-12-13,1021
2413,環科,25,0,25,合庫-台中,2023-12-13,1021
00637L,元大滬深300正2,35,10,25,合庫-台中,2023-12-13,1021
1227,佳格,25,0,25,合庫-台中,2023-12-13,1021
1789,神隆,24,0,24,合庫-台中,2023-12-13,1021
00680L,元大美債20正2,24,0,24,合庫-台中,2023-12-13,1021
3310,佳穎,24,0,24,合庫-台中,2023-12-13,1021
2889,國票金,24,0,24,合庫-台中,2023-12-13,1021
2701,萬企,23,0,23,合庫-台中,2023-12-13,1021
6901,鑽石投資,21,0,21,合庫-台中,2023-12-13,1021
5340,建榮,21,0,21,合庫-台中,2023-12-13,1021
8034,榮群,22,1,21,合庫-台中,2023-12-13,1021
2369,菱生,21,0,21,合庫-台中,2023-12-13,1021
8299,群聯,29,8,21,合庫-台中,2023-12-13,1021
00679B,元大美債20年,33,12,21,合庫-台中,2023-12-13,1021
00931B,統一美債20年,20,0,20,合庫-台中,2023-12-13,1021
00690,兆豐藍籌30,20,0,20,合庫-台中,2023-12-13,1021
3035,智原,50,30,20,合庫-台中,2023-12-13,1021
2867,三商壽,24,5,19,合庫-台中,2023-12-13,1021
2201,裕隆,21,2,19,合庫-台中,2023-12-13,1021
2449,京元電子,32,14,18,合庫-台中,2023-12-13,1021
2634,漢翔,43,25,18,合庫-台中,2023-12-13,1021
2812,台中銀,62,45,17,合庫-台中,2023-12-13,1021
00632R,元大台灣50反1,478,3,475,合庫-台中,2023-12-14,1021
2324,仁寶,332,14,318,合庫-台中,2023-12-14,1021
2014,中鴻,302,13,289,合庫-台中,2023-12-14,1021
3645,達邁,256,1,255,合庫-台中,2023-12-14,1021
2516,新建,175,1,174,合庫-台中,2023-12-14,1021
6290,良維,124,4,120,合庫-台中,2023-12-14,1021
2363,矽統,458,351,107,合庫-台中,2023-12-14,1021
00919,群益台灣精選高息,507,401,106,合庫-台中,2023-12-14,1021
00918,大華優利高填息30,108,2,106,合庫-台中,2023-12-14,1021
00687B,國泰20年美債,141,39,102,合庫-台中,2023-12-14,1021
6419,京晨科,157,55,102,合庫-台中,2023-12-14,1021
3374,精材,100,0,100,合庫-台中,2023-12-14,1021
00937B,群益ESG投等債20,91,15,76,合庫-台中,2023-12-14,1021
2329,華泰,161,86,75,合庫-台中,2023-12-14,1021
00933B,國泰10Y+金融債,68,12,56,合庫-台中,2023-12-14,1021
2365,昆盈,75,20,55,合庫-台中,2023-12-14,1021
8068,全達,55,5,50,合庫-台中,2023-12-14,1021
8038,長園科,50,0,50,合庫-台中,2023-12-14,1021
00931B,統一美債20年,51,2,49,合庫-台中,2023-12-14,1021
3025,星通,68,24,44,合庫-台中,2023-12-14,1021
1504,東元,50,6,44,合庫-台中,2023-12-14,1021
2887,台新金,54,11,43,合庫-台中,2023-12-14,1021
00934,中信成長高股息,47,6,41,合庫-台中,2023-12-14,1021
00688L,國泰20年美債正2,52,11,41,合庫-台中,2023-12-14,1021
5426,振發,60,19,41,合庫-台中,2023-12-14,1021
8358,金居,41,1,40,合庫-台中,2023-12-14,1021
3481,群創,43,5,38,合庫-台中,2023-12-14,1021
00665L,富邦�琤肭磪囓�2,84,46,38,合庫-台中,2023-12-14,1021
4711,永純,37,0,37,合庫-台中,2023-12-14,1021
1815,富喬,37,0,37,合庫-台中,2023-12-14,1021
00885,富邦越南,35,2,33,合庫-台中,2023-12-14,1021
3715,定穎投控,111,80,31,合庫-台中,2023-12-14,1021
2421,建準,40,9,31,合庫-台中,2023-12-14,1021
3362,先進光,39,11,28,合庫-台中,2023-12-14,1021
3694,海華,81,55,26,合庫-台中,2023-12-14,1021
1503,士電,38,12,26,合庫-台中,2023-12-14,1021
2313,華通,287,262,25,合庫-台中,2023-12-14,1021
3623,富晶通,26,1,25,合庫-台中,2023-12-14,1021
1616,億泰,24,0,24,合庫-台中,2023-12-14,1021
2409,友達,39,16,23,合庫-台中,2023-12-14,1021
3019,亞光,29,6,23,合庫-台中,2023-12-14,1021
00936,台新永續高息中小,33,11,22,合庫-台中,2023-12-14,1021
1466,聚隆,24,2,22,合庫-台中,2023-12-14,1021
3706,神達,49,27,22,合庫-台中,2023-12-14,1021
00795B,中信美國公債20年,21,0,21,合庫-台中,2023-12-14,1021
8069,元太,23,2,21,合庫-台中,2023-12-14,1021
3390,旭軟,34,14,20,合庫-台中,2023-12-14,1021
2495,普安,20,0,20,合庫-台中,2023-12-14,1021
6173,信昌電,25,5,20,合庫-台中,2023-12-14,1021
00772B,中信高評級公司債,19,1,18,合庫-台中,2023-12-14,1021
00929,復華台灣科技優息,1164,299,865,合庫-台中,2023-12-15,1021
00665L,富邦�琤肭磪囓�2,614,138,476,合庫-台中,2023-12-15,1021
2356,英業達,731,331,400,合庫-台中,2023-12-15,1021
00632R,元大台灣50反1,314,60,254,合庫-台中,2023-12-15,1021
00728,第一金工業30,227,4,223,合庫-台中,2023-12-15,1021
1605,華新,419,249,170,合庫-台中,2023-12-15,1021
5880,合庫金,152,17,135,合庫-台中,2023-12-15,1021
2344,華邦電,219,89,130,合庫-台中,2023-12-15,1021
2363,矽統,1504,1382,122,合庫-台中,2023-12-15,1021
2421,建準,114,0,114,合庫-台中,2023-12-15,1021
1504,東元,215,103,112,合庫-台中,2023-12-15,1021
00882,中信中國高股息,125,20,105,合庫-台中,2023-12-15,1021
00878,國泰永續高股息,208,120,88,合庫-台中,2023-12-15,1021
2883,凱基金,104,17,87,合庫-台中,2023-12-15,1021
00934,中信成長高股息,94,9,85,合庫-台中,2023-12-15,1021
00918,大華優利高填息30,90,7,83,合庫-台中,2023-12-15,1021
1584,精剛,111,29,82,合庫-台中,2023-12-15,1021
3231,緯創,88,11,77,合庫-台中,2023-12-15,1021
2887,台新金,76,0,76,合庫-台中,2023-12-15,1021
00679B,元大美債20年,130,58,72,合庫-台中,2023-12-15,1021
2301,光寶科,521,451,70,合庫-台中,2023-12-15,1021
00687B,國泰20年美債,85,15,70,合庫-台中,2023-12-15,1021
3376,新日興,64,1,63,合庫-台中,2023-12-15,1021
00915,凱基優選高股息30,58,1,57,合庫-台中,2023-12-15,1021
3017,奇鋐,52,1,51,合庫-台中,2023-12-15,1021
1101,台泥,44,3,41,合庫-台中,2023-12-15,1021
2201,裕隆,46,6,40,合庫-台中,2023-12-15,1021
00673R,期元大S＆P原油反1,42,2,40,合庫-台中,2023-12-15,1021
00902,中信電池及儲能,38,1,37,合庫-台中,2023-12-15,1021
2516,新建,36,0,36,合庫-台中,2023-12-15,1021
8415,大國鋼,33,0,33,合庫-台中,2023-12-15,1021
6147,頎邦,31,2,29,合庫-台中,2023-12-15,1021
3481,群創,76,48,28,合庫-台中,2023-12-15,1021
3437,榮創,38,10,28,合庫-台中,2023-12-15,1021
00857B,永豐20年美公債,27,0,27,合庫-台中,2023-12-15,1021
2359,所羅門,26,0,26,合庫-台中,2023-12-15,1021
2382,廣達,32,7,25,合庫-台中,2023-12-15,1021
00720B,元大投資級公司債,31,6,25,合庫-台中,2023-12-15,1021
6246,臺龍,24,0,24,合庫-台中,2023-12-15,1021
2801,彰銀,23,0,23,合庫-台中,2023-12-15,1021
00712,復華富時不動產,49,26,23,合庫-台中,2023-12-15,1021
2352,佳世達,24,1,23,合庫-台中,2023-12-15,1021
6026,福邦證,25,2,23,合庫-台中,2023-12-15,1021
00706L,期元大S＆P日圓正2,21,0,21,合庫-台中,2023-12-15,1021
00935,野村臺灣新科技50,43,22,21,合庫-台中,2023-12-15,1021
3045,台灣大,21,0,21,合庫-台中,2023-12-15,1021
00933B,國泰10Y+金融債,48,27,21,合庫-台中,2023-12-15,1021
2601,益航,20,0,20,合庫-台中,2023-12-15,1021
3296,勝德,20,0,20,合庫-台中,2023-12-15,1021
2888,新光金,25,5,20,合庫-台中,2023-12-15,1021
00665L,富邦�琤肭磪囓�2,1313,0,1313,合庫-台中,2023-12-18,1021
00680L,元大美債20正2,505,58,447,合庫-台中,2023-12-18,1021
2605,新興,347,26,321,合庫-台中,2023-12-18,1021
2606,裕民,226,2,224,合庫-台中,2023-12-18,1021
00688L,國泰20年美債正2,173,13,160,合庫-台中,2023-12-18,1021
2421,建準,135,1,134,合庫-台中,2023-12-18,1021
2371,大同,105,1,104,合庫-台中,2023-12-18,1021
1609,大亞,102,6,96,合庫-台中,2023-12-18,1021
2208,台船,92,0,92,合庫-台中,2023-12-18,1021
2515,中工,90,1,89,合庫-台中,2023-12-18,1021
00933B,國泰10Y+金融債,81,0,81,合庫-台中,2023-12-18,1021
00679B,元大美債20年,89,9,80,合庫-台中,2023-12-18,1021
6419,京晨科,94,16,78,合庫-台中,2023-12-18,1021
00687B,國泰20年美債,98,21,77,合庫-台中,2023-12-18,1021
00937B,群益ESG投等債20,149,76,73,合庫-台中,2023-12-18,1021
2332,友訊,75,4,71,合庫-台中,2023-12-18,1021
2610,華航,107,37,70,合庫-台中,2023-12-18,1021
2801,彰銀,66,1,65,合庫-台中,2023-12-18,1021
5439,高技,60,2,58,合庫-台中,2023-12-18,1021
2530,華建,53,1,52,合庫-台中,2023-12-18,1021
00934,中信成長高股息,46,1,45,合庫-台中,2023-12-18,1021
2303,聯電,59,15,44,合庫-台中,2023-12-18,1021
9105,泰金寶-DR,133,89,44,合庫-台中,2023-12-18,1021
2812,台中銀,56,12,44,合庫-台中,2023-12-18,1021
4973,廣穎,41,0,41,合庫-台中,2023-12-18,1021
00751B,元大AAA至A公司債,38,1,37,合庫-台中,2023-12-18,1021
00915,凱基優選高股息30,37,1,36,合庫-台中,2023-12-18,1021
1506,正道,34,0,34,合庫-台中,2023-12-18,1021
8069,元太,34,2,32,合庫-台中,2023-12-18,1021
00918,大華優利高填息30,66,34,32,合庫-台中,2023-12-18,1021
1514,亞力,61,29,32,合庫-台中,2023-12-18,1021
6672,騰輝電子-KY,30,0,30,合庫-台中,2023-12-18,1021
2809,京城銀,30,1,29,合庫-台中,2023-12-18,1021
2356,英業達,127,97,30,合庫-台中,2023-12-18,1021
2002,中鋼,151,123,28,合庫-台中,2023-12-18,1021
1907,永豐餘,39,14,25,合庫-台中,2023-12-18,1021
3481,群創,26,2,24,合庫-台中,2023-12-18,1021
1808,潤隆,22,0,22,合庫-台中,2023-12-18,1021
6179,亞通,24,3,21,合庫-台中,2023-12-18,1021
1444,力麗,20,0,20,合庫-台中,2023-12-18,1021
2388,威盛,47,27,20,合庫-台中,2023-12-18,1021
1568,倉佑,18,0,18,合庫-台中,2023-12-18,1021
6233,旺玖,36,18,18,合庫-台中,2023-12-18,1021
2645,長榮航太,28,10,18,合庫-台中,2023-12-18,1021
6182,合晶,21,4,17,合庫-台中,2023-12-18,1021
2023,燁輝,39,22,17,合庫-台中,2023-12-18,1021
5371,中光電,16,0,16,合庫-台中,2023-12-18,1021
2028,威致,15,0,15,合庫-台中,2023-12-18,1021
2753,八方雲集,15,0,15,合庫-台中,2023-12-18,1021
2338,光罩,15,0,15,合庫-台中,2023-12-18,1021
2618,長榮航,312,22,290,合庫-台中,2023-12-19,1021
2014,中鴻,241,47,194,合庫-台中,2023-12-19,1021
2801,彰銀,191,0,191,合庫-台中,2023-12-19,1021
1314,中石化,124,1,123,合庫-台中,2023-12-19,1021
00934,中信成長高股息,95,0,95,合庫-台中,2023-12-19,1021
2610,華航,109,24,85,合庫-台中,2023-12-19,1021
00937B,群益ESG投等債20,102,22,80,合庫-台中,2023-12-19,1021
00878,國泰永續高股息,82,10,72,合庫-台中,2023-12-19,1021
00885,富邦越南,69,0,69,合庫-台中,2023-12-19,1021
00919,群益台灣精選高息,203,135,68,合庫-台中,2023-12-19,1021
00688L,國泰20年美債正2,75,12,63,合庫-台中,2023-12-19,1021
2615,萬海,315,253,62,合庫-台中,2023-12-19,1021
5483,中美晶,72,14,58,合庫-台中,2023-12-19,1021
00687B,國泰20年美債,59,2,57,合庫-台中,2023-12-19,1021
4967,十銓,65,13,52,合庫-台中,2023-12-19,1021
6005,群益證,56,5,51,合庫-台中,2023-12-19,1021
2371,大同,58,8,50,合庫-台中,2023-12-19,1021
00696B,富邦美債20年,49,0,49,合庫-台中,2023-12-19,1021
00679B,元大美債20年,61,13,48,合庫-台中,2023-12-19,1021
00918,大華優利高填息30,49,4,45,合庫-台中,2023-12-19,1021
0056,元大高股息,88,47,41,合庫-台中,2023-12-19,1021
00670L,富邦NASDAQ正2,37,0,37,合庫-台中,2023-12-19,1021
2409,友達,50,14,36,合庫-台中,2023-12-19,1021
6275,元山,37,2,35,合庫-台中,2023-12-19,1021
3481,群創,36,3,33,合庫-台中,2023-12-19,1021
2530,華建,32,0,32,合庫-台中,2023-12-19,1021
9105,泰金寶-DR,32,0,32,合庫-台中,2023-12-19,1021
8086,宏捷科,32,1,31,合庫-台中,2023-12-19,1021
5351,鈺創,39,9,30,合庫-台中,2023-12-19,1021
6116,彩晶,31,1,30,合庫-台中,2023-12-19,1021
00900,富邦特選高股息30,36,7,29,合庫-台中,2023-12-19,1021
1529,樂事綠能,30,1,29,合庫-台中,2023-12-19,1021
00931B,統一美債20年,42,13,29,合庫-台中,2023-12-19,1021
00720B,元大投資級公司債,41,15,26,合庫-台中,2023-12-19,1021
2208,台船,26,0,26,合庫-台中,2023-12-19,1021
2382,廣達,67,41,26,合庫-台中,2023-12-19,1021
00935,野村臺灣新科技50,26,1,25,合庫-台中,2023-12-19,1021
9919,康那香,44,19,25,合庫-台中,2023-12-19,1021
2884,玉山金,30,6,24,合庫-台中,2023-12-19,1021
00772B,中信高評級公司債,24,0,24,合庫-台中,2023-12-19,1021
5371,中光電,22,0,22,合庫-台中,2023-12-19,1021
2344,華邦電,36,14,22,合庫-台中,2023-12-19,1021
1582,信錦,22,0,22,合庫-台中,2023-12-19,1021
2105,正新,22,1,21,合庫-台中,2023-12-19,1021
2465,麗臺,24,4,20,合庫-台中,2023-12-19,1021
6147,頎邦,21,1,20,合庫-台中,2023-12-19,1021
00655L,國泰中國A50正2,20,0,20,合庫-台中,2023-12-19,1021
2614,東森,20,0,20,合庫-台中,2023-12-19,1021
4960,誠美材,20,0,20,合庫-台中,2023-12-19,1021
2634,漢翔,19,0,19,合庫-台中,2023-12-19,1021
00632R,元大台灣50反1,456,0,456,合庫-台中,2023-12-20,1021
2356,英業達,1355,921,434,合庫-台中,2023-12-20,1021
1605,華新,215,8,207,合庫-台中,2023-12-20,1021
2353,宏��,491,315,176,合庫-台中,2023-12-20,1021
2371,大同,161,28,133,合庫-台中,2023-12-20,1021
00919,群益台灣精選高息,136,10,126,合庫-台中,2023-12-20,1021
2888,新光金,120,2,118,合庫-台中,2023-12-20,1021
9949,琉園,110,0,110,合庫-台中,2023-12-20,1021
9136,巨騰-DR,100,0,100,合庫-台中,2023-12-20,1021
2409,友達,155,59,96,合庫-台中,2023-12-20,1021
00933B,國泰10Y+金融債,82,0,82,合庫-台中,2023-12-20,1021
2883,凱基金,104,22,82,合庫-台中,2023-12-20,1021
00937B,群益ESG投等債20,88,25,63,合庫-台中,2023-12-20,1021
00715L,期街口布蘭特正2,220,158,62,合庫-台中,2023-12-20,1021
00669R,國泰美國道瓊反1,60,0,60,合庫-台中,2023-12-20,1021
2891,中信金,83,24,59,合庫-台中,2023-12-20,1021
6419,京晨科,73,18,55,合庫-台中,2023-12-20,1021
6147,頎邦,105,51,54,合庫-台中,2023-12-20,1021
2329,華泰,68,18,50,合庫-台中,2023-12-20,1021
1101,台泥,48,0,48,合庫-台中,2023-12-20,1021
2801,彰銀,47,0,47,合庫-台中,2023-12-20,1021
00929,復華台灣科技優息,66,23,43,合庫-台中,2023-12-20,1021
2530,華建,41,0,41,合庫-台中,2023-12-20,1021
2442,新美齊,35,0,35,合庫-台中,2023-12-20,1021
6275,元山,47,12,35,合庫-台中,2023-12-20,1021
2516,新建,36,1,35,合庫-台中,2023-12-20,1021
2344,華邦電,213,180,33,合庫-台中,2023-12-20,1021
2363,矽統,43,10,33,合庫-台中,2023-12-20,1021
1314,中石化,60,28,32,合庫-台中,2023-12-20,1021
00655L,國泰中國A50正2,30,0,30,合庫-台中,2023-12-20,1021
8086,宏捷科,33,4,29,合庫-台中,2023-12-20,1021
00931B,統一美債20年,28,1,27,合庫-台中,2023-12-20,1021
4420,光明,27,1,26,合庫-台中,2023-12-20,1021
2892,第一金,26,0,26,合庫-台中,2023-12-20,1021
00687B,國泰20年美債,42,16,26,合庫-台中,2023-12-20,1021
2002,中鋼,54,29,25,合庫-台中,2023-12-20,1021
00935,野村臺灣新科技50,25,0,25,合庫-台中,2023-12-20,1021
4908,前鼎,25,0,25,合庫-台中,2023-12-20,1021
6412,群電,25,0,25,合庫-台中,2023-12-20,1021
2313,華通,190,165,25,合庫-台中,2023-12-20,1021
00720B,元大投資級公司債,24,0,24,合庫-台中,2023-12-20,1021
00679B,元大美債20年,46,23,23,合庫-台中,2023-12-20,1021
1504,東元,23,2,21,合庫-台中,2023-12-20,1021
2387,精元,33,12,21,合庫-台中,2023-12-20,1021
1905,華紙,30,9,21,合庫-台中,2023-12-20,1021
4904,遠傳,20,0,20,合庫-台中,2023-12-20,1021
2349,錸德,20,0,20,合庫-台中,2023-12-20,1021
006206,元大上證50,20,0,20,合庫-台中,2023-12-20,1021
1568,倉佑,19,1,18,合庫-台中,2023-12-20,1021
5457,宣德,18,0,18,合庫-台中,2023-12-20,1021
2356,英業達,822,399,423,合庫-台中,2023-12-21,1021
00919,群益台灣精選高息,327,6,321,合庫-台中,2023-12-21,1021
1907,永豐餘,205,32,173,合庫-台中,2023-12-21,1021
00688L,國泰20年美債正2,130,5,125,合庫-台中,2023-12-21,1021
2353,宏��,230,115,115,合庫-台中,2023-12-21,1021
00673R,期元大S＆P原油反1,104,0,104,合庫-台中,2023-12-21,1021
00929,復華台灣科技優息,117,22,95,合庫-台中,2023-12-21,1021
9105,泰金寶-DR,268,179,89,合庫-台中,2023-12-21,1021
0056,元大高股息,77,2,75,合庫-台中,2023-12-21,1021
2515,中工,288,215,73,合庫-台中,2023-12-21,1021
00650L,復華香港正2,72,0,72,合庫-台中,2023-12-21,1021
00679B,元大美債20年,96,24,72,合庫-台中,2023-12-21,1021
2303,聯電,73,5,68,合庫-台中,2023-12-21,1021
1519,華城,78,10,68,合庫-台中,2023-12-21,1021
2409,友達,65,13,52,合庫-台中,2023-12-21,1021
1905,華紙,63,13,50,合庫-台中,2023-12-21,1021
4908,前鼎,49,0,49,合庫-台中,2023-12-21,1021
2329,華泰,52,5,47,合庫-台中,2023-12-21,1021
00937B,群益ESG投等債20,85,40,45,合庫-台中,2023-12-21,1021
2312,金寶,50,5,45,合庫-台中,2023-12-21,1021
2801,彰銀,44,0,44,合庫-台中,2023-12-21,1021
00882,中信中國高股息,44,1,43,合庫-台中,2023-12-21,1021
00933B,國泰10Y+金融債,41,0,41,合庫-台中,2023-12-21,1021
00900,富邦特選高股息30,53,12,41,合庫-台中,2023-12-21,1021
2882,國泰金,36,0,36,合庫-台中,2023-12-21,1021
2317,鴻海,46,11,35,合庫-台中,2023-12-21,1021
2324,仁寶,365,330,35,合庫-台中,2023-12-21,1021
2330,台積電,43,11,32,合庫-台中,2023-12-21,1021
00931B,統一美債20年,62,31,31,合庫-台中,2023-12-21,1021
1718,中纖,30,0,30,合庫-台中,2023-12-21,1021
1314,中石化,180,150,30,合庫-台中,2023-12-21,1021
2634,漢翔,68,38,30,合庫-台中,2023-12-21,1021
2606,裕民,110,81,29,合庫-台中,2023-12-21,1021
1504,東元,35,7,28,合庫-台中,2023-12-21,1021
2331,精英,166,138,28,合庫-台中,2023-12-21,1021
6117,迎廣,26,0,26,合庫-台中,2023-12-21,1021
5880,合庫金,29,3,26,合庫-台中,2023-12-21,1021
2027,大成鋼,25,0,25,合庫-台中,2023-12-21,1021
2442,新美齊,23,0,23,合庫-台中,2023-12-21,1021
00669R,國泰美國道瓊反1,23,0,23,合庫-台中,2023-12-21,1021
2323,中環,44,22,22,合庫-台中,2023-12-21,1021
00655L,國泰中國A50正2,21,0,21,合庫-台中,2023-12-21,1021
3607,谷崧,21,0,21,合庫-台中,2023-12-21,1021
1732,毛寶,86,66,20,合庫-台中,2023-12-21,1021
2892,第一金,20,0,20,合庫-台中,2023-12-21,1021
2412,中華電,19,0,19,合庫-台中,2023-12-21,1021
2014,中鴻,22,3,19,合庫-台中,2023-12-21,1021
2357,華碩,23,4,19,合庫-台中,2023-12-21,1021
2542,興富發,19,0,19,合庫-台中,2023-12-21,1021
2201,裕隆,19,1,18,合庫-台中,2023-12-21,1021
2609,陽明,1233,499,734,合庫-台中,2023-12-22,1021
1605,華新,782,235,547,合庫-台中,2023-12-22,1021
00680L,元大美債20正2,335,99,236,合庫-台中,2023-12-22,1021
2889,國票金,99,0,99,合庫-台中,2023-12-22,1021
00665L,富邦�琤肭磪囓�2,115,30,85,合庫-台中,2023-12-22,1021
00919,群益台灣精選高息,94,14,80,合庫-台中,2023-12-22,1021
1907,永豐餘,120,48,72,合庫-台中,2023-12-22,1021
00933B,國泰10Y+金融債,75,6,69,合庫-台中,2023-12-22,1021
1314,中石化,69,0,69,合庫-台中,2023-12-22,1021
2323,中環,98,31,67,合庫-台中,2023-12-22,1021
6419,京晨科,88,23,65,合庫-台中,2023-12-22,1021
00688L,國泰20年美債正2,88,25,63,合庫-台中,2023-12-22,1021
00679B,元大美債20年,91,30,61,合庫-台中,2023-12-22,1021
2241,艾姆勒,48,1,47,合庫-台中,2023-12-22,1021
2913,農林,54,8,46,合庫-台中,2023-12-22,1021
00937B,群益ESG投等債20,55,10,45,合庫-台中,2023-12-22,1021
2465,麗臺,43,3,40,合庫-台中,2023-12-22,1021
2515,中工,99,60,39,合庫-台中,2023-12-22,1021
2105,正新,43,6,37,合庫-台中,2023-12-22,1021
00795B,中信美國公債20年,37,0,37,合庫-台中,2023-12-22,1021
2888,新光金,37,1,36,合庫-台中,2023-12-22,1021
3231,緯創,90,59,31,合庫-台中,2023-12-22,1021
1326,台化,32,1,31,合庫-台中,2023-12-22,1021
00751B,元大AAA至A公司債,36,6,30,合庫-台中,2023-12-22,1021
1444,力麗,30,0,30,合庫-台中,2023-12-22,1021
6412,群電,30,0,30,合庫-台中,2023-12-22,1021
00720B,元大投資級公司債,29,0,29,合庫-台中,2023-12-22,1021
2014,中鴻,38,9,29,合庫-台中,2023-12-22,1021
2408,南亞科,37,8,29,合庫-台中,2023-12-22,1021
1305,華夏,27,0,27,合庫-台中,2023-12-22,1021
00687B,國泰20年美債,73,46,27,合庫-台中,2023-12-22,1021
00931B,統一美債20年,26,0,26,合庫-台中,2023-12-22,1021
2615,萬海,268,242,26,合庫-台中,2023-12-22,1021
2516,新建,36,11,25,合庫-台中,2023-12-22,1021
6117,迎廣,55,30,25,合庫-台中,2023-12-22,1021
3324,雙鴻,26,2,24,合庫-台中,2023-12-22,1021
4908,前鼎,24,0,24,合庫-台中,2023-12-22,1021
00772B,中信高評級公司債,21,0,21,合庫-台中,2023-12-22,1021
5009,榮剛,32,11,21,合庫-台中,2023-12-22,1021
00706L,期元大S＆P日圓正2,20,0,20,合庫-台中,2023-12-22,1021
1409,新纖,20,0,20,合庫-台中,2023-12-22,1021
1313,聯成,20,0,20,合庫-台中,2023-12-22,1021
8034,榮群,21,2,19,合庫-台中,2023-12-22,1021
9136,巨騰-DR,18,0,18,合庫-台中,2023-12-22,1021
3234,光環,18,0,18,合庫-台中,2023-12-22,1021
8069,元太,35,19,16,合庫-台中,2023-12-22,1021
1519,華城,21,5,16,合庫-台中,2023-12-22,1021
8249,菱光,16,0,16,合庫-台中,2023-12-22,1021
3006,晶豪科,47,31,16,合庫-台中,2023-12-22,1021
4167,松瑞藥,18,2,16,合庫-台中,2023-12-22,1021
2301,光寶科,808,17,791,合庫-台中,2023-12-25,1021
00680L,元大美債20正2,297,9,288,合庫-台中,2023-12-25,1021
2371,大同,213,16,197,合庫-台中,2023-12-25,1021
2324,仁寶,611,425,186,合庫-台中,2023-12-25,1021
00919,群益台灣精選高息,181,16,165,合庫-台中,2023-12-25,1021
4908,前鼎,140,2,138,合庫-台中,2023-12-25,1021
6125,廣運,128,2,126,合庫-台中,2023-12-25,1021
00937B,群益ESG投等債20,67,2,65,合庫-台中,2023-12-25,1021
00929,復華台灣科技優息,87,24,63,合庫-台中,2023-12-25,1021
2353,宏��,168,106,62,合庫-台中,2023-12-25,1021
5009,榮剛,66,6,60,合庫-台中,2023-12-25,1021
3033,威健,50,0,50,合庫-台中,2023-12-25,1021
2356,英業達,206,158,48,合庫-台中,2023-12-25,1021
1514,亞力,63,18,45,合庫-台中,2023-12-25,1021
8096,擎亞,43,2,41,合庫-台中,2023-12-25,1021
3034,聯詠,38,0,38,合庫-台中,2023-12-25,1021
8050,廣積,33,1,32,合庫-台中,2023-12-25,1021
4973,廣穎,35,3,32,合庫-台中,2023-12-25,1021
3437,榮創,33,2,31,合庫-台中,2023-12-25,1021
2363,矽統,49,18,31,合庫-台中,2023-12-25,1021
2617,台航,36,7,29,合庫-台中,2023-12-25,1021
00679B,元大美債20年,52,25,27,合庫-台中,2023-12-25,1021
00687B,國泰20年美債,28,3,25,合庫-台中,2023-12-25,1021
6412,群電,25,0,25,合庫-台中,2023-12-25,1021
00900,富邦特選高股息30,34,10,24,合庫-台中,2023-12-25,1021
00720B,元大投資級公司債,29,5,24,合庫-台中,2023-12-25,1021
1314,中石化,33,11,22,合庫-台中,2023-12-25,1021
2208,台船,21,0,21,合庫-台中,2023-12-25,1021
6198,瑞築,20,0,20,合庫-台中,2023-12-25,1021
3576,聯合再生,20,1,19,合庫-台中,2023-12-25,1021
3715,定穎投控,91,73,18,合庫-台中,2023-12-25,1021
00715L,期街口布蘭特正2,59,41,18,合庫-台中,2023-12-25,1021
00931B,統一美債20年,18,0,18,合庫-台中,2023-12-25,1021
6547,高端疫苗,16,0,16,合庫-台中,2023-12-25,1021
3051,力特,16,0,16,合庫-台中,2023-12-25,1021
2412,中華電,17,1,16,合庫-台中,2023-12-25,1021
2329,華泰,51,36,15,合庫-台中,2023-12-25,1021
1305,華夏,15,0,15,合庫-台中,2023-12-25,1021
8011,台通,19,5,14,合庫-台中,2023-12-25,1021
3163,波若威,14,0,14,合庫-台中,2023-12-25,1021
3122,笙泉,14,1,13,合庫-台中,2023-12-25,1021
2505,國揚,13,0,13,合庫-台中,2023-12-25,1021
6443,元晶,13,0,13,合庫-台中,2023-12-25,1021
6233,旺玖,24,11,13,合庫-台中,2023-12-25,1021
00713,元大台灣高息低波,12,0,12,合庫-台中,2023-12-25,1021
4167,松瑞藥,12,0,12,合庫-台中,2023-12-25,1021
2614,東森,20,8,12,合庫-台中,2023-12-25,1021
2409,友達,62,50,12,合庫-台中,2023-12-25,1021
3149,正達,12,0,12,合庫-台中,2023-12-25,1021
1795,美時,17,5,12,合庫-台中,2023-12-25,1021
2353,宏��,716,168,548,合庫-台中,2023-12-26,1021
00632R,元大台灣50反1,486,5,481,合庫-台中,2023-12-26,1021
2014,中鴻,421,26,395,合庫-台中,2023-12-26,1021
9105,泰金寶-DR,156,3,153,合庫-台中,2023-12-26,1021
2887,台新金,149,2,147,合庫-台中,2023-12-26,1021
2356,英業達,276,139,137,合庫-台中,2023-12-26,1021
00915,凱基優選高股息30,124,1,123,合庫-台中,2023-12-26,1021
00680L,元大美債20正2,120,0,120,合庫-台中,2023-12-26,1021
2498,宏達電,163,50,113,合庫-台中,2023-12-26,1021
2444,兆勁,81,0,81,合庫-台中,2023-12-26,1021
00929,復華台灣科技優息,102,34,68,合庫-台中,2023-12-26,1021
2610,華航,83,16,67,合庫-台中,2023-12-26,1021
00687B,國泰20年美債,53,2,51,合庫-台中,2023-12-26,1021
6125,廣運,50,0,50,合庫-台中,2023-12-26,1021
6016,康和證,40,0,40,合庫-台中,2023-12-26,1021
2615,萬海,65,28,37,合庫-台中,2023-12-26,1021
3047,訊舟,36,0,36,合庫-台中,2023-12-26,1021
2609,陽明,223,189,34,合庫-台中,2023-12-26,1021
9949,琉園,30,0,30,合庫-台中,2023-12-26,1021
5426,振發,34,5,29,合庫-台中,2023-12-26,1021
2606,裕民,32,4,28,合庫-台中,2023-12-26,1021
0050,元大台灣50,36,10,26,合庫-台中,2023-12-26,1021
4102,永日,26,0,26,合庫-台中,2023-12-26,1021
5347,世界,26,4,22,合庫-台中,2023-12-26,1021
8436,大江,21,0,21,合庫-台中,2023-12-26,1021
4908,前鼎,23,2,21,合庫-台中,2023-12-26,1021
3006,晶豪科,31,10,21,合庫-台中,2023-12-26,1021
1213,大飲,20,0,20,合庫-台中,2023-12-26,1021
2601,益航,30,10,20,合庫-台中,2023-12-26,1021
00918,大華優利高填息30,20,0,20,合庫-台中,2023-12-26,1021
1444,力麗,20,0,20,合庫-台中,2023-12-26,1021
4173,久裕,20,0,20,合庫-台中,2023-12-26,1021
6288,聯嘉,20,2,18,合庫-台中,2023-12-26,1021
6237,驊訊,31,14,17,合庫-台中,2023-12-26,1021
2038,海光,17,1,16,合庫-台中,2023-12-26,1021
4414,如興,15,0,15,合庫-台中,2023-12-26,1021
1582,信錦,21,6,15,合庫-台中,2023-12-26,1021
2427,三商電,15,0,15,合庫-台中,2023-12-26,1021
1464,得力,15,0,15,合庫-台中,2023-12-26,1021
3122,笙泉,20,5,15,合庫-台中,2023-12-26,1021
00888,永豐台灣ESG,15,0,15,合庫-台中,2023-12-26,1021
8039,台虹,18,4,14,合庫-台中,2023-12-26,1021
00936,台新永續高息中小,21,7,14,合庫-台中,2023-12-26,1021
00753L,中信中國50正2,55,41,14,合庫-台中,2023-12-26,1021
2033,佳大,14,1,13,合庫-台中,2023-12-26,1021
3521,鴻翊,13,0,13,合庫-台中,2023-12-26,1021
3031,佰鴻,13,0,13,合庫-台中,2023-12-26,1021
1101,台泥,16,3,13,合庫-台中,2023-12-26,1021
8426,紅木-KY,15,3,12,合庫-台中,2023-12-26,1021
9904,寶成,12,0,12,合庫-台中,2023-12-26,1021
00632R,元大台灣50反1,1681,57,1624,合庫-台中,2023-12-27,1021
2324,仁寶,862,351,511,合庫-台中,2023-12-27,1021
00929,復華台灣科技優息,381,15,366,合庫-台中,2023-12-27,1021
00937B,群益ESG投等債20,244,1,243,合庫-台中,2023-12-27,1021
00919,群益台灣精選高息,187,14,173,合庫-台中,2023-12-27,1021
00882,中信中國高股息,147,2,145,合庫-台中,2023-12-27,1021
00933B,國泰10Y+金融債,138,5,133,合庫-台中,2023-12-27,1021
00673R,期元大S＆P原油反1,108,0,108,合庫-台中,2023-12-27,1021
5483,中美晶,92,11,81,合庫-台中,2023-12-27,1021
2618,長榮航,157,93,64,合庫-台中,2023-12-27,1021
2610,華航,72,11,61,合庫-台中,2023-12-27,1021
00650L,復華香港正2,60,0,60,合庫-台中,2023-12-27,1021
2887,台新金,52,1,51,合庫-台中,2023-12-27,1021
3231,緯創,61,12,49,合庫-台中,2023-12-27,1021
00931B,統一美債20年,45,2,43,合庫-台中,2023-12-27,1021
00687B,國泰20年美債,67,25,42,合庫-台中,2023-12-27,1021
2405,輔信,90,49,41,合庫-台中,2023-12-27,1021
2388,威盛,45,5,40,合庫-台中,2023-12-27,1021
1802,台玻,41,3,38,合庫-台中,2023-12-27,1021
6901,鑽石投資,37,0,37,合庫-台中,2023-12-27,1021
00679B,元大美債20年,60,25,35,合庫-台中,2023-12-27,1021
2323,中環,36,1,35,合庫-台中,2023-12-27,1021
2369,菱生,37,2,35,合庫-台中,2023-12-27,1021
2457,飛宏,32,1,31,合庫-台中,2023-12-27,1021
00655L,國泰中國A50正2,30,0,30,合庫-台中,2023-12-27,1021
00885,富邦越南,30,0,30,合庫-台中,2023-12-27,1021
9105,泰金寶-DR,30,2,28,合庫-台中,2023-12-27,1021
00934,中信成長高股息,46,19,27,合庫-台中,2023-12-27,1021
2462,良得電,30,4,26,合庫-台中,2023-12-27,1021
5426,振發,25,2,23,合庫-台中,2023-12-27,1021
6426,統新,22,0,22,合庫-台中,2023-12-27,1021
1440,南紡,21,0,21,合庫-台中,2023-12-27,1021
2515,中工,36,15,21,合庫-台中,2023-12-27,1021
00877,復華中國5G,20,0,20,合庫-台中,2023-12-27,1021
8249,菱光,20,0,20,合庫-台中,2023-12-27,1021
3694,海華,21,1,20,合庫-台中,2023-12-27,1021
1806,冠軍,39,20,19,合庫-台中,2023-12-27,1021
2105,正新,20,3,17,合庫-台中,2023-12-27,1021
2882,國泰金,18,1,17,合庫-台中,2023-12-27,1021
1101,台泥,21,5,16,合庫-台中,2023-12-27,1021
8028,昇陽半導體,15,0,15,合庫-台中,2023-12-27,1021
00720B,元大投資級公司債,16,1,15,合庫-台中,2023-12-27,1021
00725B,國泰投資級公司債,16,1,15,合庫-台中,2023-12-27,1021
2359,所羅門,15,0,15,合庫-台中,2023-12-27,1021
3545,敦泰,18,3,15,合庫-台中,2023-12-27,1021
6799,來頡,18,3,15,合庫-台中,2023-12-27,1021
1504,東元,25,11,14,合庫-台中,2023-12-27,1021
6733,博晟生醫,14,0,14,合庫-台中,2023-12-27,1021
2352,佳世達,24,10,14,合庫-台中,2023-12-27,1021
9945,潤泰新,16,2,14,合庫-台中,2023-12-27,1021
1605,華新,426,16,410,合庫-台中,2023-12-28,1021
00937B,群益ESG投等債20,276,15,261,合庫-台中,2023-12-28,1021
2105,正新,212,1,211,合庫-台中,2023-12-28,1021
2353,宏��,441,259,182,合庫-台中,2023-12-28,1021
00929,復華台灣科技優息,255,120,135,合庫-台中,2023-12-28,1021
00919,群益台灣精選高息,207,77,130,合庫-台中,2023-12-28,1021
00712,復華富時不動產,120,1,119,合庫-台中,2023-12-28,1021
00720B,元大投資級公司債,152,59,93,合庫-台中,2023-12-28,1021
6419,京晨科,115,22,93,合庫-台中,2023-12-28,1021
5483,中美晶,96,9,87,合庫-台中,2023-12-28,1021
00934,中信成長高股息,55,1,54,合庫-台中,2023-12-28,1021
6129,普誠,48,0,48,合庫-台中,2023-12-28,1021
8096,擎亞,66,22,44,合庫-台中,2023-12-28,1021
2365,昆盈,67,30,37,合庫-台中,2023-12-28,1021
2405,輔信,54,17,37,合庫-台中,2023-12-28,1021
00936,台新永續高息中小,36,2,34,合庫-台中,2023-12-28,1021
8086,宏捷科,31,0,31,合庫-台中,2023-12-28,1021
00885,富邦越南,36,5,31,合庫-台中,2023-12-28,1021
00715L,期街口布蘭特正2,30,0,30,合庫-台中,2023-12-28,1021
4306,炎洲,30,0,30,合庫-台中,2023-12-28,1021
00632R,元大台灣50反1,42,12,30,合庫-台中,2023-12-28,1021
3305,昇貿,33,3,30,合庫-台中,2023-12-28,1021
2888,新光金,35,10,25,合庫-台中,2023-12-28,1021
2329,華泰,24,0,24,合庫-台中,2023-12-28,1021
00680L,元大美債20正2,43,21,22,合庫-台中,2023-12-28,1021
5011,久陽,27,5,22,合庫-台中,2023-12-28,1021
3231,緯創,85,64,21,合庫-台中,2023-12-28,1021
2454,聯發科,22,1,21,合庫-台中,2023-12-28,1021
4414,如興,20,0,20,合庫-台中,2023-12-28,1021
2498,宏達電,30,10,20,合庫-台中,2023-12-28,1021
00923,群益台ESG低碳50,21,1,20,合庫-台中,2023-12-28,1021
2610,華航,37,17,20,合庫-台中,2023-12-28,1021
8046,南電,22,2,20,合庫-台中,2023-12-28,1021
6113,亞矽,24,4,20,合庫-台中,2023-12-28,1021
00710B,復華彭博非投等債,19,0,19,合庫-台中,2023-12-28,1021
2363,矽統,32,13,19,合庫-台中,2023-12-28,1021
6118,建達,19,0,19,合庫-台中,2023-12-28,1021
6188,廣明,33,14,19,合庫-台中,2023-12-28,1021
4979,華星光,21,2,19,合庫-台中,2023-12-28,1021
9105,泰金寶-DR,34,16,18,合庫-台中,2023-12-28,1021
3024,憶聲,18,1,17,合庫-台中,2023-12-28,1021
1305,華夏,17,0,17,合庫-台中,2023-12-28,1021
5324,士開,17,0,17,合庫-台中,2023-12-28,1021
00933B,國泰10Y+金融債,17,1,16,合庫-台中,2023-12-28,1021
3706,神達,283,268,15,合庫-台中,2023-12-28,1021
6182,合晶,16,1,15,合庫-台中,2023-12-28,1021
3338,泰碩,36,21,15,合庫-台中,2023-12-28,1021
6173,信昌電,15,1,14,合庫-台中,2023-12-28,1021
3346,麗清,16,2,14,合庫-台中,2023-12-28,1021
2449,京元電子,18,5,13,合庫-台中,2023-12-28,1021
2301,光寶科,200,2,198,合庫-台中,2023-12-29,1021
2356,英業達,348,158,190,合庫-台中,2023-12-29,1021
00937B,群益ESG投等債20,175,4,171,合庫-台中,2023-12-29,1021
00715L,期街口布蘭特正2,155,30,125,合庫-台中,2023-12-29,1021
2324,仁寶,421,298,123,合庫-台中,2023-12-29,1021
00919,群益台灣精選高息,100,10,90,合庫-台中,2023-12-29,1021
2618,長榮航,174,86,88,合庫-台中,2023-12-29,1021
9902,台火,76,0,76,合庫-台中,2023-12-29,1021
00933B,國泰10Y+金融債,112,40,72,合庫-台中,2023-12-29,1021
2344,華邦電,192,127,65,合庫-台中,2023-12-29,1021
00642U,期元大S＆P石油,64,0,64,合庫-台中,2023-12-29,1021
1514,亞力,122,58,64,合庫-台中,2023-12-29,1021
1513,中興電,64,4,60,合庫-台中,2023-12-29,1021
6116,彩晶,61,10,51,合庫-台中,2023-12-29,1021
00632R,元大台灣50反1,51,0,51,合庫-台中,2023-12-29,1021
6419,京晨科,503,452,51,合庫-台中,2023-12-29,1021
00637L,元大滬深300正2,101,59,42,合庫-台中,2023-12-29,1021
2353,宏��,98,57,41,合庫-台中,2023-12-29,1021
00929,復華台灣科技優息,76,36,40,合庫-台中,2023-12-29,1021
2801,彰銀,62,25,37,合庫-台中,2023-12-29,1021
8096,擎亞,51,14,37,合庫-台中,2023-12-29,1021
2303,聯電,51,14,37,合庫-台中,2023-12-29,1021
00751B,元大AAA至A公司債,33,0,33,合庫-台中,2023-12-29,1021
00772B,中信高評級公司債,32,0,32,合庫-台中,2023-12-29,1021
00934,中信成長高股息,27,0,27,合庫-台中,2023-12-29,1021
2443,昶虹,24,0,24,合庫-台中,2023-12-29,1021
00712,復華富時不動產,43,20,23,合庫-台中,2023-12-29,1021
00688L,國泰20年美債正2,23,0,23,合庫-台中,2023-12-29,1021
6118,建達,23,1,22,合庫-台中,2023-12-29,1021
2515,中工,22,1,21,合庫-台中,2023-12-29,1021
00922,國泰台灣領袖50,21,0,21,合庫-台中,2023-12-29,1021
2329,華泰,22,1,21,合庫-台中,2023-12-29,1021
00931B,統一美債20年,21,0,21,合庫-台中,2023-12-29,1021
00671R,富邦NASDAQ反1,20,0,20,合庫-台中,2023-12-29,1021
00706L,期元大S＆P日圓正2,20,0,20,合庫-台中,2023-12-29,1021
00915,凱基優選高股息30,20,0,20,合庫-台中,2023-12-29,1021
1312,國喬,20,1,19,合庫-台中,2023-12-29,1021
4908,前鼎,34,15,19,合庫-台中,2023-12-29,1021
2337,旺宏,21,3,18,合庫-台中,2023-12-29,1021
1609,大亞,20,2,18,合庫-台中,2023-12-29,1021
1519,華城,90,73,17,合庫-台中,2023-12-29,1021
00679B,元大美債20年,47,30,17,合庫-台中,2023-12-29,1021
2362,藍天,35,18,17,合庫-台中,2023-12-29,1021
1605,華新,119,103,16,合庫-台中,2023-12-29,1021
8011,台通,24,9,15,合庫-台中,2023-12-29,1021
2516,新建,20,5,15,合庫-台中,2023-12-29,1021
1503,士電,72,57,15,合庫-台中,2023-12-29,1021
3260,威剛,40,26,14,合庫-台中,2023-12-29,1021
3594,磐儀,14,0,14,合庫-台中,2023-12-29,1021
2427,三商電,14,0,14,合庫-台中,2023-12-29,1021
00929,復華台灣科技優息,348,26,322,合庫-台中,2024-01-02,1021
00937B,群益ESG投等債20,193,0,193,合庫-台中,2024-01-02,1021
3231,緯創,204,42,162,合庫-台中,2024-01-02,1021
0056,元大高股息,148,23,125,合庫-台中,2024-01-02,1021
1570,力肯,115,0,115,合庫-台中,2024-01-02,1021
00857B,永豐20年美公債,115,0,115,合庫-台中,2024-01-02,1021
00680L,元大美債20正2,214,102,112,合庫-台中,2024-01-02,1021
00637L,元大滬深300正2,114,2,112,合庫-台中,2024-01-02,1021
00712,復華富時不動產,117,11,106,合庫-台中,2024-01-02,1021
2303,聯電,167,74,93,合庫-台中,2024-01-02,1021
00919,群益台灣精選高息,136,46,90,合庫-台中,2024-01-02,1021
00679B,元大美債20年,94,13,81,合庫-台中,2024-01-02,1021
2352,佳世達,87,9,78,合庫-台中,2024-01-02,1021
2618,長榮航,518,444,74,合庫-台中,2024-01-02,1021
00934,中信成長高股息,73,0,73,合庫-台中,2024-01-02,1021
2615,萬海,68,5,63,合庫-台中,2024-01-02,1021
00931B,統一美債20年,61,0,61,合庫-台中,2024-01-02,1021
2362,藍天,92,36,56,合庫-台中,2024-01-02,1021
00687B,國泰20年美債,57,4,53,合庫-台中,2024-01-02,1021
00655L,國泰中國A50正2,40,0,40,合庫-台中,2024-01-02,1021
2323,中環,50,10,40,合庫-台中,2024-01-02,1021
8059,凱碩,38,0,38,合庫-台中,2024-01-02,1021
00665L,富邦�琤肭磪囓�2,44,7,37,合庫-台中,2024-01-02,1021
00688L,國泰20年美債正2,47,13,34,合庫-台中,2024-01-02,1021
00878,國泰永續高股息,63,30,33,合庫-台中,2024-01-02,1021
1409,新纖,32,0,32,合庫-台中,2024-01-02,1021
2883,凱基金,52,20,32,合庫-台中,2024-01-02,1021
3006,晶豪科,35,4,31,合庫-台中,2024-01-02,1021
8096,擎亞,44,13,31,合庫-台中,2024-01-02,1021
3522,御嵿,30,0,30,合庫-台中,2024-01-02,1021
8086,宏捷科,33,6,27,合庫-台中,2024-01-02,1021
5351,鈺創,34,8,26,合庫-台中,2024-01-02,1021
6770,力積電,27,2,25,合庫-台中,2024-01-02,1021
3390,旭軟,28,4,24,合庫-台中,2024-01-02,1021
00669R,國泰美國道瓊反1,23,0,23,合庫-台中,2024-01-02,1021
9945,潤泰新,22,1,21,合庫-台中,2024-01-02,1021
2801,彰銀,40,20,20,合庫-台中,2024-01-02,1021
6244,茂迪,20,0,20,合庫-台中,2024-01-02,1021
1313,聯成,20,0,20,合庫-台中,2024-01-02,1021
3594,磐儀,19,0,19,合庫-台中,2024-01-02,1021
00633L,富邦上証正2,18,0,18,合庫-台中,2024-01-02,1021
00932,兆豐永續高息等權,21,3,18,合庫-台中,2024-01-02,1021
00882,中信中國高股息,20,2,18,合庫-台中,2024-01-02,1021
2867,三商壽,17,0,17,合庫-台中,2024-01-02,1021
2337,旺宏,21,4,17,合庫-台中,2024-01-02,1021
00751B,元大AAA至A公司債,17,0,17,合庫-台中,2024-01-02,1021
6288,聯嘉,20,3,17,合庫-台中,2024-01-02,1021
2382,廣達,40,23,17,合庫-台中,2024-01-02,1021
3264,欣銓,16,0,16,合庫-台中,2024-01-02,1021
2308,台達電,15,0,15,合庫-台中,2024-01-02,1021
00715L,期街口布蘭特正2,595,12,583,合庫-台中,2024-01-03,1021
00937B,群益ESG投等債20,324,7,317,合庫-台中,2024-01-03,1021
00929,復華台灣科技優息,375,75,300,合庫-台中,2024-01-03,1021
00680L,元大美債20正2,293,12,281,合庫-台中,2024-01-03,1021
2303,聯電,242,25,217,合庫-台中,2024-01-03,1021
0056,元大高股息,179,41,138,合庫-台中,2024-01-03,1021
00720B,元大投資級公司債,135,0,135,合庫-台中,2024-01-03,1021
2105,正新,117,5,112,合庫-台中,2024-01-03,1021
2884,玉山金,110,2,108,合庫-台中,2024-01-03,1021
2409,友達,119,16,103,合庫-台中,2024-01-03,1021
2880,華南金,101,0,101,合庫-台中,2024-01-03,1021
2618,長榮航,410,326,84,合庫-台中,2024-01-03,1021
2610,華航,118,35,83,合庫-台中,2024-01-03,1021
00918,大華優利高填息30,93,11,82,合庫-台中,2024-01-03,1021
00642U,期元大S＆P石油,80,0,80,合庫-台中,2024-01-03,1021
00919,群益台灣精選高息,99,35,64,合庫-台中,2024-01-03,1021
2330,台積電,62,3,59,合庫-台中,2024-01-03,1021
00935,野村臺灣新科技50,56,0,56,合庫-台中,2024-01-03,1021
2515,中工,58,4,54,合庫-台中,2024-01-03,1021
00891,中信關鍵半導體,58,8,50,合庫-台中,2024-01-03,1021
5880,合庫金,51,1,50,合庫-台中,2024-01-03,1021
00679B,元大美債20年,71,22,49,合庫-台中,2024-01-03,1021
3481,群創,110,62,48,合庫-台中,2024-01-03,1021
00882,中信中國高股息,57,10,47,合庫-台中,2024-01-03,1021
2352,佳世達,56,10,46,合庫-台中,2024-01-03,1021
00923,群益台ESG低碳50,45,0,45,合庫-台中,2024-01-03,1021
00888,永豐台灣ESG,44,1,43,合庫-台中,2024-01-03,1021
2457,飛宏,43,1,42,合庫-台中,2024-01-03,1021
00712,復華富時不動產,65,25,40,合庫-台中,2024-01-03,1021
2605,新興,53,15,38,合庫-台中,2024-01-03,1021
2324,仁寶,281,244,37,合庫-台中,2024-01-03,1021
3046,建��,145,109,36,合庫-台中,2024-01-03,1021
2498,宏達電,36,0,36,合庫-台中,2024-01-03,1021
00878,國泰永續高股息,84,49,35,合庫-台中,2024-01-03,1021
00687B,國泰20年美債,34,0,34,合庫-台中,2024-01-03,1021
2801,彰銀,33,0,33,合庫-台中,2024-01-03,1021
00881,國泰台灣5G+,32,0,32,合庫-台中,2024-01-03,1021
5521,工信,78,48,30,合庫-台中,2024-01-03,1021
00934,中信成長高股息,32,3,29,合庫-台中,2024-01-03,1021
8076,伍豐,29,0,29,合庫-台中,2024-01-03,1021
1537,廣隆,28,0,28,合庫-台中,2024-01-03,1021
00665L,富邦�琤肭磪囓�2,26,0,26,合庫-台中,2024-01-03,1021
5347,世界,24,0,24,合庫-台中,2024-01-03,1021
2455,全新,29,5,24,合庫-台中,2024-01-03,1021
2739,寒舍,30,6,24,合庫-台中,2024-01-03,1021
2313,華通,27,4,23,合庫-台中,2024-01-03,1021
00877,復華中國5G,23,0,23,合庫-台中,2024-01-03,1021
1326,台化,22,0,22,合庫-台中,2024-01-03,1021
00857B,永豐20年美公債,21,0,21,合庫-台中,2024-01-03,1021
1301,台塑,20,0,20,合庫-台中,2024-01-03,1021
00632R,元大台灣50反1,1230,157,1073,合庫-台中,2024-01-04,1021
00929,復華台灣科技優息,403,39,364,合庫-台中,2024-01-04,1021
00720B,元大投資級公司債,277,2,275,合庫-台中,2024-01-04,1021
00919,群益台灣精選高息,221,23,198,合庫-台中,2024-01-04,1021
2618,長榮航,474,296,178,合庫-台中,2024-01-04,1021
2385,群光,153,7,146,合庫-台中,2024-01-04,1021
00937B,群益ESG投等債20,109,0,109,合庫-台中,2024-01-04,1021
2610,華航,128,26,102,合庫-台中,2024-01-04,1021
6117,迎廣,150,50,100,合庫-台中,2024-01-04,1021
00712,復華富時不動產,74,2,72,合庫-台中,2024-01-04,1021
00927,群益半導體收益,73,2,71,合庫-台中,2024-01-04,1021
9919,康那香,121,50,71,合庫-台中,2024-01-04,1021
00680L,元大美債20正2,74,11,63,合庫-台中,2024-01-04,1021
3596,智易,59,0,59,合庫-台中,2024-01-04,1021
6419,京晨科,101,45,56,合庫-台中,2024-01-04,1021
2014,中鴻,100,45,55,合庫-台中,2024-01-04,1021
00637L,元大滬深300正2,77,24,53,合庫-台中,2024-01-04,1021
9934,成霖,54,10,44,合庫-台中,2024-01-04,1021
2303,聯電,69,29,40,合庫-台中,2024-01-04,1021
00902,中信電池及儲能,35,0,35,合庫-台中,2024-01-04,1021
2332,友訊,35,0,35,合庫-台中,2024-01-04,1021
1618,合機,38,5,33,合庫-台中,2024-01-04,1021
00882,中信中國高股息,88,56,32,合庫-台中,2024-01-04,1021
00857B,永豐20年美公債,32,0,32,合庫-台中,2024-01-04,1021
4128,中天,31,0,31,合庫-台中,2024-01-04,1021
2601,益航,50,21,29,合庫-台中,2024-01-04,1021
8096,擎亞,46,17,29,合庫-台中,2024-01-04,1021
9902,台火,28,0,28,合庫-台中,2024-01-04,1021
2363,矽統,39,14,25,合庫-台中,2024-01-04,1021
2498,宏達電,25,0,25,合庫-台中,2024-01-04,1021
2603,長榮,124,100,24,合庫-台中,2024-01-04,1021
00673R,期元大S＆P原油反1,23,0,23,合庫-台中,2024-01-04,1021
2312,金寶,28,5,23,合庫-台中,2024-01-04,1021
2367,燿華,22,0,22,合庫-台中,2024-01-04,1021
00936,台新永續高息中小,29,7,22,合庫-台中,2024-01-04,1021
2409,友達,46,25,21,合庫-台中,2024-01-04,1021
1519,華城,122,102,20,合庫-台中,2024-01-04,1021
3017,奇鋐,21,2,19,合庫-台中,2024-01-04,1021
0056,元大高股息,47,28,19,合庫-台中,2024-01-04,1021
00655L,國泰中國A50正2,19,0,19,合庫-台中,2024-01-04,1021
00751B,元大AAA至A公司債,19,0,19,合庫-台中,2024-01-04,1021
4743,合一,19,1,18,合庫-台中,2024-01-04,1021
1806,冠軍,97,79,18,合庫-台中,2024-01-04,1021
3607,谷崧,18,0,18,合庫-台中,2024-01-04,1021
5351,鈺創,22,5,17,合庫-台中,2024-01-04,1021
00706L,期元大S＆P日圓正2,27,10,17,合庫-台中,2024-01-04,1021
00933B,國泰10Y+金融債,16,0,16,合庫-台中,2024-01-04,1021
3078,僑威,16,0,16,合庫-台中,2024-01-04,1021
00877,復華中國5G,16,0,16,合庫-台中,2024-01-04,1021
00725B,國泰投資級公司債,16,0,16,合庫-台中,2024-01-04,1021
2618,長榮航,743,223,520,合庫-台中,2024-01-05,1021
00937B,群益ESG投等債20,244,14,230,合庫-台中,2024-01-05,1021
00929,復華台灣科技優息,276,50,226,合庫-台中,2024-01-05,1021
3481,群創,2415,2201,214,合庫-台中,2024-01-05,1021
2605,新興,278,96,182,合庫-台中,2024-01-05,1021
00715L,期街口布蘭特正2,220,66,154,合庫-台中,2024-01-05,1021
00919,群益台灣精選高息,159,20,139,合庫-台中,2024-01-05,1021
00857B,永豐20年美公債,85,0,85,合庫-台中,2024-01-05,1021
9105,泰金寶-DR,60,1,59,合庫-台中,2024-01-05,1021
00687B,國泰20年美債,62,7,55,合庫-台中,2024-01-05,1021
2610,華航,121,66,55,合庫-台中,2024-01-05,1021
1325,恆大,56,2,54,合庫-台中,2024-01-05,1021
00927,群益半導體收益,77,23,54,合庫-台中,2024-01-05,1021
00679B,元大美債20年,95,41,54,合庫-台中,2024-01-05,1021
00751B,元大AAA至A公司債,68,18,50,合庫-台中,2024-01-05,1021
0056,元大高股息,51,5,46,合庫-台中,2024-01-05,1021
00931B,統一美債20年,78,35,43,合庫-台中,2024-01-05,1021
9902,台火,37,0,37,合庫-台中,2024-01-05,1021
2515,中工,50,16,34,合庫-台中,2024-01-05,1021
2353,宏��,294,262,32,合庫-台中,2024-01-05,1021
00915,凱基優選高股息30,32,0,32,合庫-台中,2024-01-05,1021
2356,英業達,77,47,30,合庫-台中,2024-01-05,1021
2486,一詮,42,12,30,合庫-台中,2024-01-05,1021
2362,藍天,36,7,29,合庫-台中,2024-01-05,1021
1504,東元,28,1,27,合庫-台中,2024-01-05,1021
00877,復華中國5G,25,0,25,合庫-台中,2024-01-05,1021
2607,榮運,44,19,25,合庫-台中,2024-01-05,1021
2330,台積電,28,3,25,合庫-台中,2024-01-05,1021
00652,富邦印度,23,0,23,合庫-台中,2024-01-05,1021
2449,京元電子,23,1,22,合庫-台中,2024-01-05,1021
2344,華邦電,35,13,22,合庫-台中,2024-01-05,1021
00933B,國泰10Y+金融債,26,6,20,合庫-台中,2024-01-05,1021
3711,日月光投控,35,15,20,合庫-台中,2024-01-05,1021
00909,國泰數位支付服務,20,0,20,合庫-台中,2024-01-05,1021
8932,智通*,23,8,15,合庫-台中,2024-01-05,1021
6462,神盾,31,16,15,合庫-台中,2024-01-05,1021
2002,中鋼,19,4,15,合庫-台中,2024-01-05,1021
00795B,中信美國公債20年,15,0,15,合庫-台中,2024-01-05,1021
3037,欣興,17,2,15,合庫-台中,2024-01-05,1021
2615,萬海,36,22,14,合庫-台中,2024-01-05,1021
00936,台新永續高息中小,17,3,14,合庫-台中,2024-01-05,1021
00878,國泰永續高股息,27,13,14,合庫-台中,2024-01-05,1021
6695,芯鼎,72,59,13,合庫-台中,2024-01-05,1021
2355,敬鵬,13,0,13,合庫-台中,2024-01-05,1021
00891,中信關鍵半導體,13,0,13,合庫-台中,2024-01-05,1021
2101,南港,14,2,12,合庫-台中,2024-01-05,1021
3033,威健,15,3,12,合庫-台中,2024-01-05,1021
3031,佰鴻,12,0,12,合庫-台中,2024-01-05,1021
6550,北極星藥業-KY,14,2,12,合庫-台中,2024-01-05,1021
2363,矽統,22,10,12,合庫-台中,2024-01-05,1021
00929,復華台灣科技優息,313,5,308,合庫-台中,2024-01-08,1021
2324,仁寶,225,84,141,合庫-台中,2024-01-08,1021
00679B,元大美債20年,135,8,127,合庫-台中,2024-01-08,1021
1605,華新,124,0,124,合庫-台中,2024-01-08,1021
00882,中信中國高股息,123,1,122,合庫-台中,2024-01-08,1021
00919,群益台灣精選高息,138,19,119,合庫-台中,2024-01-08,1021
6695,芯鼎,152,35,117,合庫-台中,2024-01-08,1021
00751B,元大AAA至A公司債,112,0,112,合庫-台中,2024-01-08,1021
00680L,元大美債20正2,172,66,106,合庫-台中,2024-01-08,1021
9105,泰金寶-DR,102,2,100,合庫-台中,2024-01-08,1021
00665L,富邦�琤肭磪囓�2,99,0,99,合庫-台中,2024-01-08,1021
2353,宏��,210,115,95,合庫-台中,2024-01-08,1021
2002,中鋼,86,7,79,合庫-台中,2024-01-08,1021
00637L,元大滬深300正2,129,53,76,合庫-台中,2024-01-08,1021
00687B,國泰20年美債,83,9,74,合庫-台中,2024-01-08,1021
1514,亞力,107,36,71,合庫-台中,2024-01-08,1021
2888,新光金,80,11,69,合庫-台中,2024-01-08,1021
2388,威盛,121,54,67,合庫-台中,2024-01-08,1021
8096,擎亞,79,16,63,合庫-台中,2024-01-08,1021
2609,陽明,318,259,59,合庫-台中,2024-01-08,1021
00857B,永豐20年美公債,50,0,50,合庫-台中,2024-01-08,1021
00673R,期元大S＆P原油反1,50,0,50,合庫-台中,2024-01-08,1021
00720B,元大投資級公司債,46,6,40,合庫-台中,2024-01-08,1021
2605,新興,55,17,38,合庫-台中,2024-01-08,1021
2362,藍天,78,43,35,合庫-台中,2024-01-08,1021
6770,力積電,53,18,35,合庫-台中,2024-01-08,1021
2303,聯電,43,9,34,合庫-台中,2024-01-08,1021
2337,旺宏,36,3,33,合庫-台中,2024-01-08,1021
00636,國泰中國A50,28,0,28,合庫-台中,2024-01-08,1021
2344,華邦電,37,9,28,合庫-台中,2024-01-08,1021
6757,台灣虎航,27,0,27,合庫-台中,2024-01-08,1021
2317,鴻海,28,1,27,合庫-台中,2024-01-08,1021
2405,輔信,25,0,25,合庫-台中,2024-01-08,1021
8068,全達,25,0,25,合庫-台中,2024-01-08,1021
00933B,國泰10Y+金融債,33,9,24,合庫-台中,2024-01-08,1021
3715,定穎投控,26,3,23,合庫-台中,2024-01-08,1021
5521,工信,23,1,22,合庫-台中,2024-01-08,1021
00770,國泰北美科技,22,0,22,合庫-台中,2024-01-08,1021
2606,裕民,29,8,21,合庫-台中,2024-01-08,1021
2323,中環,20,0,20,合庫-台中,2024-01-08,1021
00877,復華中國5G,20,0,20,合庫-台中,2024-01-08,1021
2836A,高雄銀甲特,20,0,20,合庫-台中,2024-01-08,1021
00927,群益半導體收益,21,2,19,合庫-台中,2024-01-08,1021
00902,中信電池及儲能,21,3,18,合庫-台中,2024-01-08,1021
2603,長榮,71,54,17,合庫-台中,2024-01-08,1021
2530,華建,34,17,17,合庫-台中,2024-01-08,1021
00934,中信成長高股息,17,1,16,合庫-台中,2024-01-08,1021
00753L,中信中國50正2,98,82,16,合庫-台中,2024-01-08,1021
4167,松瑞藥,16,0,16,合庫-台中,2024-01-08,1021
3017,奇鋐,22,7,15,合庫-台中,2024-01-08,1021
00715L,期街口布蘭特正2,466,16,450,合庫-台中,2024-01-09,1021
00919,群益台灣精選高息,284,24,260,合庫-台中,2024-01-09,1021
2324,仁寶,338,136,202,合庫-台中,2024-01-09,1021
3481,群創,383,181,202,合庫-台中,2024-01-09,1021
2618,長榮航,378,207,171,合庫-台中,2024-01-09,1021
2356,英業達,176,29,147,合庫-台中,2024-01-09,1021
2610,華航,148,6,142,合庫-台中,2024-01-09,1021
5425,台半,123,5,118,合庫-台中,2024-01-09,1021
00688L,國泰20年美債正2,101,0,101,合庫-台中,2024-01-09,1021
4533,協易機,90,0,90,合庫-台中,2024-01-09,1021
00929,復華台灣科技優息,174,87,87,合庫-台中,2024-01-09,1021
6116,彩晶,87,4,83,合庫-台中,2024-01-09,1021
2634,漢翔,106,27,79,合庫-台中,2024-01-09,1021
2609,陽明,216,149,67,合庫-台中,2024-01-09,1021
00937B,群益ESG投等債20,67,0,67,合庫-台中,2024-01-09,1021
2884,玉山金,93,31,62,合庫-台中,2024-01-09,1021
00900,富邦特選高股息30,65,7,58,合庫-台中,2024-01-09,1021
0056,元大高股息,55,0,55,合庫-台中,2024-01-09,1021
3231,緯創,118,63,55,合庫-台中,2024-01-09,1021
2402,毅嘉,53,0,53,合庫-台中,2024-01-09,1021
2332,友訊,52,0,52,合庫-台中,2024-01-09,1021
2498,宏達電,363,317,46,合庫-台中,2024-01-09,1021
00680L,元大美債20正2,45,0,45,合庫-台中,2024-01-09,1021
2303,聯電,54,12,42,合庫-台中,2024-01-09,1021
2363,矽統,139,99,40,合庫-台中,2024-01-09,1021
2457,飛宏,39,1,38,合庫-台中,2024-01-09,1021
2409,友達,146,111,35,合庫-台中,2024-01-09,1021
3276,宇環,35,0,35,合庫-台中,2024-01-09,1021
2913,農林,35,1,34,合庫-台中,2024-01-09,1021
2317,鴻海,33,0,33,合庫-台中,2024-01-09,1021
00927,群益半導體收益,31,0,31,合庫-台中,2024-01-09,1021
2323,中環,31,0,31,合庫-台中,2024-01-09,1021
2617,台航,30,0,30,合庫-台中,2024-01-09,1021
3260,威剛,33,3,30,合庫-台中,2024-01-09,1021
6419,京晨科,42,14,28,合庫-台中,2024-01-09,1021
4113,聯上,28,0,28,合庫-台中,2024-01-09,1021
1515,力山,32,4,28,合庫-台中,2024-01-09,1021
2308,台達電,27,0,27,合庫-台中,2024-01-09,1021
00891,中信關鍵半導體,29,2,27,合庫-台中,2024-01-09,1021
3006,晶豪科,34,8,26,合庫-台中,2024-01-09,1021
6757,台灣虎航,25,0,25,合庫-台中,2024-01-09,1021
1219,福壽,25,0,25,合庫-台中,2024-01-09,1021
4979,華星光,25,2,23,合庫-台中,2024-01-09,1021
2601,益航,23,0,23,合庫-台中,2024-01-09,1021
9136,巨騰-DR,21,0,21,合庫-台中,2024-01-09,1021
5309,系統電,34,13,21,合庫-台中,2024-01-09,1021
8076,伍豐,30,9,21,合庫-台中,2024-01-09,1021
3056,富華新,31,10,21,合庫-台中,2024-01-09,1021
2388,威盛,109,89,20,合庫-台中,2024-01-09,1021
3523,迎輝,20,0,20,合庫-台中,2024-01-09,1021
00632R,元大台灣50反1,608,191,417,合庫-台中,2024-01-10,1021
2618,長榮航,411,87,324,合庫-台中,2024-01-10,1021
3481,群創,543,253,290,合庫-台中,2024-01-10,1021
2329,華泰,242,35,207,合庫-台中,2024-01-10,1021
00929,復華台灣科技優息,227,20,207,合庫-台中,2024-01-10,1021
2371,大同,197,38,159,合庫-台中,2024-01-10,1021
00673R,期元大S＆P原油反1,100,0,100,合庫-台中,2024-01-10,1021
2610,華航,170,80,90,合庫-台中,2024-01-10,1021
5425,台半,80,0,80,合庫-台中,2024-01-10,1021
3521,鴻翊,69,3,66,合庫-台中,2024-01-10,1021
3276,宇環,56,0,56,合庫-台中,2024-01-10,1021
2887,台新金,56,1,55,合庫-台中,2024-01-10,1021
6129,普誠,51,0,51,合庫-台中,2024-01-10,1021
6419,京晨科,74,24,50,合庫-台中,2024-01-10,1021
00919,群益台灣精選高息,122,73,49,合庫-台中,2024-01-10,1021
00937B,群益ESG投等債20,67,20,47,合庫-台中,2024-01-10,1021
2356,英業達,98,52,46,合庫-台中,2024-01-10,1021
1535,中宇,46,1,45,合庫-台中,2024-01-10,1021
00712,復華富時不動產,45,0,45,合庫-台中,2024-01-10,1021
2883,凱基金,54,10,44,合庫-台中,2024-01-10,1021
2498,宏達電,99,57,42,合庫-台中,2024-01-10,1021
2324,仁寶,71,30,41,合庫-台中,2024-01-10,1021
6220,岳豐,40,0,40,合庫-台中,2024-01-10,1021
1444,力麗,40,0,40,合庫-台中,2024-01-10,1021
2630,亞航,54,14,40,合庫-台中,2024-01-10,1021
1515,力山,47,8,39,合庫-台中,2024-01-10,1021
1802,台玻,38,0,38,合庫-台中,2024-01-10,1021
00927,群益半導體收益,37,0,37,合庫-台中,2024-01-10,1021
2801,彰銀,34,0,34,合庫-台中,2024-01-10,1021
5355,佳總,33,0,33,合庫-台中,2024-01-10,1021
8442,威宏-KY,33,0,33,合庫-台中,2024-01-10,1021
00933B,國泰10Y+金融債,32,0,32,合庫-台中,2024-01-10,1021
2317,鴻海,33,1,32,合庫-台中,2024-01-10,1021
2601,益航,32,0,32,合庫-台中,2024-01-10,1021
3231,緯創,78,50,28,合庫-台中,2024-01-10,1021
1101,台泥,27,0,27,合庫-台中,2024-01-10,1021
4711,永純,27,0,27,合庫-台中,2024-01-10,1021
00918,大華優利高填息30,24,0,24,合庫-台中,2024-01-10,1021
9919,康那香,25,1,24,合庫-台中,2024-01-10,1021
2457,飛宏,24,2,22,合庫-台中,2024-01-10,1021
00770,國泰北美科技,22,0,22,合庫-台中,2024-01-10,1021
2867,三商壽,22,0,22,合庫-台中,2024-01-10,1021
3373,熱映,31,9,22,合庫-台中,2024-01-10,1021
00935,野村臺灣新科技50,22,1,21,合庫-台中,2024-01-10,1021
2337,旺宏,23,2,21,合庫-台中,2024-01-10,1021
3707,漢磊,23,2,21,合庫-台中,2024-01-10,1021
5432,新門,20,0,20,合庫-台中,2024-01-10,1021
00904,新光臺灣半導體30,20,0,20,合庫-台中,2024-01-10,1021
6112,邁達特,20,0,20,合庫-台中,2024-01-10,1021
2634,漢翔,38,19,19,合庫-台中,2024-01-10,1021
00715L,期街口布蘭特正2,460,0,460,合庫-台中,2024-01-11,1021
3481,群創,690,255,435,合庫-台中,2024-01-11,1021
6120,達運,311,80,231,合庫-台中,2024-01-11,1021
3521,鴻翊,205,8,197,合庫-台中,2024-01-11,1021
2329,華泰,439,249,190,合庫-台中,2024-01-11,1021
3025,星通,177,19,158,合庫-台中,2024-01-11,1021
00929,復華台灣科技優息,152,20,132,合庫-台中,2024-01-11,1021
00919,群益台灣精選高息,99,9,90,合庫-台中,2024-01-11,1021
00712,復華富時不動產,90,6,84,合庫-台中,2024-01-11,1021
00933B,國泰10Y+金融債,67,0,67,合庫-台中,2024-01-11,1021
3499,環天科,60,1,59,合庫-台中,2024-01-11,1021
2353,宏��,202,147,55,合庫-台中,2024-01-11,1021
4938,和碩,53,0,53,合庫-台中,2024-01-11,1021
2338,光罩,50,0,50,合庫-台中,2024-01-11,1021
2498,宏達電,65,16,49,合庫-台中,2024-01-11,1021
00927,群益半導體收益,48,0,48,合庫-台中,2024-01-11,1021
00679B,元大美債20年,47,1,46,合庫-台中,2024-01-11,1021
00725B,國泰投資級公司債,45,0,45,合庫-台中,2024-01-11,1021
6226,光鼎,40,0,40,合庫-台中,2024-01-11,1021
00637L,元大滬深300正2,33,0,33,合庫-台中,2024-01-11,1021
2388,威盛,90,58,32,合庫-台中,2024-01-11,1021
00937B,群益ESG投等債20,31,0,31,合庫-台中,2024-01-11,1021
2105,正新,34,4,30,合庫-台中,2024-01-11,1021
2845,遠東銀,30,0,30,合庫-台中,2024-01-11,1021
1608,華榮,30,0,30,合庫-台中,2024-01-11,1021
2449,京元電子,46,18,28,合庫-台中,2024-01-11,1021
2408,南亞科,51,23,28,合庫-台中,2024-01-11,1021
4406,新昕纖,28,0,28,合庫-台中,2024-01-11,1021
6239,力成,29,2,27,合庫-台中,2024-01-11,1021
00857B,永豐20年美公債,27,0,27,合庫-台中,2024-01-11,1021
2454,聯發科,30,3,27,合庫-台中,2024-01-11,1021
00642U,期元大S＆P石油,25,0,25,合庫-台中,2024-01-11,1021
00931B,統一美債20年,24,0,24,合庫-台中,2024-01-11,1021
1802,台玻,24,0,24,合庫-台中,2024-01-11,1021
2610,華航,204,180,24,合庫-台中,2024-01-11,1021
00687B,國泰20年美債,24,1,23,合庫-台中,2024-01-11,1021
2615,萬海,25,3,22,合庫-台中,2024-01-11,1021
6116,彩晶,22,0,22,合庫-台中,2024-01-11,1021
2609,陽明,77,55,22,合庫-台中,2024-01-11,1021
2596,綠意,21,0,21,合庫-台中,2024-01-11,1021
3024,憶聲,20,0,20,合庫-台中,2024-01-11,1021
2324,仁寶,20,0,20,合庫-台中,2024-01-11,1021
6275,元山,20,0,20,合庫-台中,2024-01-11,1021
6695,芯鼎,62,43,19,合庫-台中,2024-01-11,1021
2897,王道銀行,18,0,18,合庫-台中,2024-01-11,1021
2022,聚亨,18,0,18,合庫-台中,2024-01-11,1021
1301,台塑,21,3,18,合庫-台中,2024-01-11,1021
2409,友達,54,37,17,合庫-台中,2024-01-11,1021
8227,巨有科技,42,25,17,合庫-台中,2024-01-11,1021
3094,聯傑,21,5,16,合庫-台中,2024-01-11,1021
00673R,期元大S＆P原油反1,379,2,377,合庫-台中,2024-01-12,1021
00929,復華台灣科技優息,209,29,180,合庫-台中,2024-01-12,1021
2486,一詮,204,67,137,合庫-台中,2024-01-12,1021
2208,台船,80,8,72,合庫-台中,2024-01-12,1021
00919,群益台灣精選高息,72,6,66,合庫-台中,2024-01-12,1021
2353,宏��,111,51,60,合庫-台中,2024-01-12,1021
2887,台新金,56,0,56,合庫-台中,2024-01-12,1021
2371,大同,64,9,55,合庫-台中,2024-01-12,1021
00712,復華富時不動產,68,19,49,合庫-台中,2024-01-12,1021
00927,群益半導體收益,47,1,46,合庫-台中,2024-01-12,1021
8096,擎亞,109,64,45,合庫-台中,2024-01-12,1021
2880,華南金,46,6,40,合庫-台中,2024-01-12,1021
2303,聯電,42,5,37,合庫-台中,2024-01-12,1021
5880,合庫金,105,70,35,合庫-台中,2024-01-12,1021
5351,鈺創,35,0,35,合庫-台中,2024-01-12,1021
0056,元大高股息,44,11,33,合庫-台中,2024-01-12,1021
2605,新興,33,0,33,合庫-台中,2024-01-12,1021
4979,華星光,37,6,31,合庫-台中,2024-01-12,1021
00878,國泰永續高股息,71,40,31,合庫-台中,2024-01-12,1021
2002,中鋼,30,1,29,合庫-台中,2024-01-12,1021
4406,新昕纖,28,0,28,合庫-台中,2024-01-12,1021
00937B,群益ESG投等債20,36,10,26,合庫-台中,2024-01-12,1021
00632R,元大台灣50反1,32,6,26,合庫-台中,2024-01-12,1021
4909,新復興,70,45,25,合庫-台中,2024-01-12,1021
1806,冠軍,26,2,24,合庫-台中,2024-01-12,1021
2543,皇昌,32,9,23,合庫-台中,2024-01-12,1021
2618,長榮航,48,25,23,合庫-台中,2024-01-12,1021
2498,宏達電,32,11,21,合庫-台中,2024-01-12,1021
4720,德淵,20,0,20,合庫-台中,2024-01-12,1021
2324,仁寶,27,7,20,合庫-台中,2024-01-12,1021
6275,元山,20,0,20,合庫-台中,2024-01-12,1021
00687B,國泰20年美債,19,0,19,合庫-台中,2024-01-12,1021
00931B,統一美債20年,19,0,19,合庫-台中,2024-01-12,1021
00751B,元大AAA至A公司債,30,12,18,合庫-台中,2024-01-12,1021
3607,谷崧,20,2,18,合庫-台中,2024-01-12,1021
6695,芯鼎,62,45,17,合庫-台中,2024-01-12,1021
2317,鴻海,26,9,17,合庫-台中,2024-01-12,1021
4541,晟田,18,1,17,合庫-台中,2024-01-12,1021
6770,力積電,16,0,16,合庫-台中,2024-01-12,1021
6625,必應,16,0,16,合庫-台中,2024-01-12,1021
4746,台耀,16,0,16,合庫-台中,2024-01-12,1021
2382,廣達,79,63,16,合庫-台中,2024-01-12,1021
5347,世界,18,3,15,合庫-台中,2024-01-12,1021
1732,毛寶,15,0,15,合庫-台中,2024-01-12,1021
1301,台塑,16,1,15,合庫-台中,2024-01-12,1021
2409,友達,50,35,15,合庫-台中,2024-01-12,1021
00713,元大台灣高息低波,17,2,15,合庫-台中,2024-01-12,1021
2897,王道銀行,14,0,14,合庫-台中,2024-01-12,1021
3706,神達,23,9,14,合庫-台中,2024-01-12,1021
1528,恩德,47,34,13,合庫-台中,2024-01-12,1021
00632R,元大台灣50反1,1035,7,1028,合庫-台中,2024-01-15,1021
2634,漢翔,406,76,330,合庫-台中,2024-01-15,1021
00881,國泰台灣5G+,236,16,220,合庫-台中,2024-01-15,1021
2630,亞航,231,25,206,合庫-台中,2024-01-15,1021
3231,緯創,277,97,180,合庫-台中,2024-01-15,1021
2618,長榮航,260,126,134,合庫-台中,2024-01-15,1021
2353,宏��,164,31,133,合庫-台中,2024-01-15,1021
2883,凱基金,128,1,127,合庫-台中,2024-01-15,1021
1513,中興電,152,33,119,合庫-台中,2024-01-15,1021
00715L,期街口布蘭特正2,108,15,93,合庫-台中,2024-01-15,1021
00929,復華台灣科技優息,109,19,90,合庫-台中,2024-01-15,1021
00933B,國泰10Y+金融債,99,13,86,合庫-台中,2024-01-15,1021
2409,友達,138,54,84,合庫-台中,2024-01-15,1021
00904,新光臺灣半導體30,80,0,80,合庫-台中,2024-01-15,1021
3481,群創,375,300,75,合庫-台中,2024-01-15,1021
8033,雷虎,68,1,67,合庫-台中,2024-01-15,1021
2603,長榮,80,13,67,合庫-台中,2024-01-15,1021
8111,立��,67,1,66,合庫-台中,2024-01-15,1021
2444,兆勁,43,0,43,合庫-台中,2024-01-15,1021
2845,遠東銀,43,1,42,合庫-台中,2024-01-15,1021
6223,旺矽,49,9,40,合庫-台中,2024-01-15,1021
1712,興農,36,0,36,合庫-台中,2024-01-15,1021
4406,新昕纖,35,0,35,合庫-台中,2024-01-15,1021
2303,聯電,58,23,35,合庫-台中,2024-01-15,1021
2601,益航,36,2,34,合庫-台中,2024-01-15,1021
1314,中石化,70,40,30,合庫-台中,2024-01-15,1021
00919,群益台灣精選高息,43,13,30,合庫-台中,2024-01-15,1021
2331,精英,31,2,29,合庫-台中,2024-01-15,1021
2317,鴻海,33,5,28,合庫-台中,2024-01-15,1021
6547,高端疫苗,43,16,27,合庫-台中,2024-01-15,1021
00927,群益半導體收益,24,0,24,合庫-台中,2024-01-15,1021
00670L,富邦NASDAQ正2,23,0,23,合庫-台中,2024-01-15,1021
3521,鴻翊,22,0,22,合庫-台中,2024-01-15,1021
2515,中工,25,4,21,合庫-台中,2024-01-15,1021
2882,國泰金,21,1,20,合庫-台中,2024-01-15,1021
2838,聯邦銀,20,0,20,合庫-台中,2024-01-15,1021
5347,世界,19,1,18,合庫-台中,2024-01-15,1021
00665L,富邦�琤肭磪囓�2,34,16,18,合庫-台中,2024-01-15,1021
8034,榮群,55,37,18,合庫-台中,2024-01-15,1021
2382,廣達,44,26,18,合庫-台中,2024-01-15,1021
2834,臺企銀,28,10,18,合庫-台中,2024-01-15,1021
8442,威宏-KY,17,0,17,合庫-台中,2024-01-15,1021
2356,英業達,87,70,17,合庫-台中,2024-01-15,1021
4541,晟田,16,0,16,合庫-台中,2024-01-15,1021
5880,合庫金,18,2,16,合庫-台中,2024-01-15,1021
6207,雷科,33,18,15,合庫-台中,2024-01-15,1021
6538,倉和,15,0,15,合庫-台中,2024-01-15,1021
2897,王道銀行,15,0,15,合庫-台中,2024-01-15,1021
4979,華星光,16,2,14,合庫-台中,2024-01-15,1021
1440,南紡,14,0,14,合庫-台中,2024-01-15,1021
00919,群益台灣精選高息,409,19,390,合庫-台中,2024-01-16,1021
2887,台新金,277,1,276,合庫-台中,2024-01-16,1021
2618,長榮航,352,151,201,合庫-台中,2024-01-16,1021
5351,鈺創,214,37,177,合庫-台中,2024-01-16,1021
2486,一詮,243,73,170,合庫-台中,2024-01-16,1021
5880,合庫金,169,1,168,合庫-台中,2024-01-16,1021
0056,元大高股息,164,14,150,合庫-台中,2024-01-16,1021
2883,凱基金,156,10,146,合庫-台中,2024-01-16,1021
2002,中鋼,137,0,137,合庫-台中,2024-01-16,1021
00720B,元大投資級公司債,128,0,128,合庫-台中,2024-01-16,1021
00881,國泰台灣5G+,110,0,110,合庫-台中,2024-01-16,1021
00929,復華台灣科技優息,136,34,102,合庫-台中,2024-01-16,1021
00680L,元大美債20正2,94,0,94,合庫-台中,2024-01-16,1021
2353,宏��,140,47,93,合庫-台中,2024-01-16,1021
00927,群益半導體收益,112,29,83,合庫-台中,2024-01-16,1021
2610,華航,160,78,82,合庫-台中,2024-01-16,1021
8096,擎亞,234,163,71,合庫-台中,2024-01-16,1021
2889,國票金,69,10,59,合庫-台中,2024-01-16,1021
1409,新纖,53,0,53,合庫-台中,2024-01-16,1021
00878,國泰永續高股息,53,1,52,合庫-台中,2024-01-16,1021
8176,智捷,51,0,51,合庫-台中,2024-01-16,1021
2337,旺宏,61,11,50,合庫-台中,2024-01-16,1021
00912,中信臺灣智慧50,50,0,50,合庫-台中,2024-01-16,1021
4960,誠美材,45,2,43,合庫-台中,2024-01-16,1021
1301,台塑,46,3,43,合庫-台中,2024-01-16,1021
2313,華通,148,106,42,合庫-台中,2024-01-16,1021
1504,東元,41,1,40,合庫-台中,2024-01-16,1021
2444,兆勁,38,0,38,合庫-台中,2024-01-16,1021
2515,中工,73,38,35,合庫-台中,2024-01-16,1021
2834,臺企銀,44,10,34,合庫-台中,2024-01-16,1021
1440,南紡,34,0,34,合庫-台中,2024-01-16,1021
2882,國泰金,46,13,33,合庫-台中,2024-01-16,1021
00933B,國泰10Y+金融債,32,0,32,合庫-台中,2024-01-16,1021
2603,長榮,34,3,31,合庫-台中,2024-01-16,1021
3025,星通,122,92,30,合庫-台中,2024-01-16,1021
1326,台化,34,4,30,合庫-台中,2024-01-16,1021
1216,統一,30,1,29,合庫-台中,2024-01-16,1021
1101,台泥,29,2,27,合庫-台中,2024-01-16,1021
2609,陽明,68,41,27,合庫-台中,2024-01-16,1021
2880,華南金,27,0,27,合庫-台中,2024-01-16,1021
2344,華邦電,30,5,25,合庫-台中,2024-01-16,1021
6233,旺玖,26,2,24,合庫-台中,2024-01-16,1021
00904,新光臺灣半導體30,64,40,24,合庫-台中,2024-01-16,1021
6243,迅杰,66,42,24,合庫-台中,2024-01-16,1021
1609,大亞,36,12,24,合庫-台中,2024-01-16,1021
2324,仁寶,38,15,23,合庫-台中,2024-01-16,1021
1570,力肯,23,0,23,合庫-台中,2024-01-16,1021
2412,中華電,22,0,22,合庫-台中,2024-01-16,1021
00773B,中信優先金融債,21,0,21,合庫-台中,2024-01-16,1021
4414,如興,21,0,21,合庫-台中,2024-01-16,1021
00929,復華台灣科技優息,572,12,560,合庫-台中,2024-01-17,1021
00882,中信中國高股息,426,39,387,合庫-台中,2024-01-17,1021
00919,群益台灣精選高息,361,8,353,合庫-台中,2024-01-17,1021
2618,長榮航,352,36,316,合庫-台中,2024-01-17,1021
2303,聯電,378,69,309,合庫-台中,2024-01-17,1021
2603,長榮,278,5,273,合庫-台中,2024-01-17,1021
0056,元大高股息,237,12,225,合庫-台中,2024-01-17,1021
5880,合庫金,207,0,207,合庫-台中,2024-01-17,1021
2886,兆豐金,193,1,192,合庫-台中,2024-01-17,1021
00937B,群益ESG投等債20,177,4,173,合庫-台中,2024-01-17,1021
00770,國泰北美科技,224,52,172,合庫-台中,2024-01-17,1021
2887,台新金,150,0,150,合庫-台中,2024-01-17,1021
3521,鴻翊,127,3,124,合庫-台中,2024-01-17,1021
2883,凱基金,129,6,123,合庫-台中,2024-01-17,1021
2376,技嘉,133,13,120,合庫-台中,2024-01-17,1021
2002,中鋼,122,6,116,合庫-台中,2024-01-17,1021
00680L,元大美債20正2,79,0,79,合庫-台中,2024-01-17,1021
2317,鴻海,74,4,70,合庫-台中,2024-01-17,1021
2801,彰銀,79,10,69,合庫-台中,2024-01-17,1021
00665L,富邦�琤肭磪囓�2,120,53,67,合庫-台中,2024-01-17,1021
00679B,元大美債20年,109,45,64,合庫-台中,2024-01-17,1021
00878,國泰永續高股息,96,37,59,合庫-台中,2024-01-17,1021
2882,國泰金,60,2,58,合庫-台中,2024-01-17,1021
3231,緯創,135,77,58,合庫-台中,2024-01-17,1021
6770,力積電,63,6,57,合庫-台中,2024-01-17,1021
2409,友達,101,45,56,合庫-台中,2024-01-17,1021
2344,華邦電,78,24,54,合庫-台中,2024-01-17,1021
4529,淳紳,51,2,49,合庫-台中,2024-01-17,1021
00902,中信電池及儲能,47,0,47,合庫-台中,2024-01-17,1021
00927,群益半導體收益,56,9,47,合庫-台中,2024-01-17,1021
2371,大同,40,0,40,合庫-台中,2024-01-17,1021
2885,元大金,38,0,38,合庫-台中,2024-01-17,1021
8076,伍豐,37,0,37,合庫-台中,2024-01-17,1021
5488,松普,35,1,34,合庫-台中,2024-01-17,1021
6282,康舒,35,1,34,合庫-台中,2024-01-17,1021
2444,兆勁,34,0,34,合庫-台中,2024-01-17,1021
2834,臺企銀,34,0,34,合庫-台中,2024-01-17,1021
00904,新光臺灣半導體30,58,25,33,合庫-台中,2024-01-17,1021
6695,芯鼎,106,73,33,合庫-台中,2024-01-17,1021
2892,第一金,33,0,33,合庫-台中,2024-01-17,1021
8111,立��,37,5,32,合庫-台中,2024-01-17,1021
1313,聯成,31,0,31,合庫-台中,2024-01-17,1021
2308,台達電,33,3,30,合庫-台中,2024-01-17,1021
8112,至上,47,17,30,合庫-台中,2024-01-17,1021
0050,元大台灣50,32,2,30,合庫-台中,2024-01-17,1021
2353,宏��,66,38,28,合庫-台中,2024-01-17,1021
3597,映興,26,0,26,合庫-台中,2024-01-17,1021
2356,英業達,63,37,26,合庫-台中,2024-01-17,1021
3176,基亞,25,0,25,合庫-台中,2024-01-17,1021
2615,萬海,25,0,25,合庫-台中,2024-01-17,1021
00753L,中信中國50正2,500,62,438,合庫-台中,2024-01-18,1021
2603,長榮,327,29,298,合庫-台中,2024-01-18,1021
3481,群創,2062,1828,234,合庫-台中,2024-01-18,1021
5328,華容,195,6,189,合庫-台中,2024-01-18,1021
00882,中信中國高股息,151,3,148,合庫-台中,2024-01-18,1021
00937B,群益ESG投等債20,143,0,143,合庫-台中,2024-01-18,1021
2303,聯電,159,19,140,合庫-台中,2024-01-18,1021
00929,復華台灣科技優息,433,297,136,合庫-台中,2024-01-18,1021
00680L,元大美債20正2,114,1,113,合庫-台中,2024-01-18,1021
5880,合庫金,103,6,97,合庫-台中,2024-01-18,1021
3521,鴻翊,80,0,80,合庫-台中,2024-01-18,1021
00637L,元大滬深300正2,93,14,79,合庫-台中,2024-01-18,1021
5426,振發,237,165,72,合庫-台中,2024-01-18,1021
2888,新光金,69,2,67,合庫-台中,2024-01-18,1021
5351,鈺創,72,8,64,合庫-台中,2024-01-18,1021
2887,台新金,63,0,63,合庫-台中,2024-01-18,1021
2329,華泰,202,144,58,合庫-台中,2024-01-18,1021
5228,鈺鎧,58,0,58,合庫-台中,2024-01-18,1021
2486,一詮,123,66,57,合庫-台中,2024-01-18,1021
0056,元大高股息,77,22,55,合庫-台中,2024-01-18,1021
4406,新昕纖,49,0,49,合庫-台中,2024-01-18,1021
2449,京元電子,59,11,48,合庫-台中,2024-01-18,1021
00878,國泰永續高股息,74,27,47,合庫-台中,2024-01-18,1021
2353,宏��,84,37,47,合庫-台中,2024-01-18,1021
2485,兆赫,52,5,47,合庫-台中,2024-01-18,1021
00679B,元大美債20年,72,28,44,合庫-台中,2024-01-18,1021
00770,國泰北美科技,36,0,36,合庫-台中,2024-01-18,1021
4960,誠美材,75,40,35,合庫-台中,2024-01-18,1021
1506,正道,30,0,30,合庫-台中,2024-01-18,1021
00712,復華富時不動產,59,30,29,合庫-台中,2024-01-18,1021
2002,中鋼,31,3,28,合庫-台中,2024-01-18,1021
00687B,國泰20年美債,31,3,28,合庫-台中,2024-01-18,1021
2883,凱基金,28,2,26,合庫-台中,2024-01-18,1021
5324,士開,26,0,26,合庫-台中,2024-01-18,1021
2362,藍天,76,50,26,合庫-台中,2024-01-18,1021
1303,南亞,26,0,26,合庫-台中,2024-01-18,1021
2324,仁寶,47,22,25,合庫-台中,2024-01-18,1021
2884,玉山金,25,0,25,合庫-台中,2024-01-18,1021
3306,鼎天,25,0,25,合庫-台中,2024-01-18,1021
2892,第一金,24,0,24,合庫-台中,2024-01-18,1021
5309,系統電,24,1,23,合庫-台中,2024-01-18,1021
1314,中石化,23,0,23,合庫-台中,2024-01-18,1021
00927,群益半導體收益,22,0,22,合庫-台中,2024-01-18,1021
2105,正新,22,1,21,合庫-台中,2024-01-18,1021
9907,統一實,20,0,20,合庫-台中,2024-01-18,1021
2897,王道銀行,20,0,20,合庫-台中,2024-01-18,1021
2607,榮運,20,0,20,合庫-台中,2024-01-18,1021
00902,中信電池及儲能,20,0,20,合庫-台中,2024-01-18,1021
2605,新興,21,3,18,合庫-台中,2024-01-18,1021
2834,臺企銀,22,4,18,合庫-台中,2024-01-18,1021
2618,長榮航,552,224,328,合庫-台中,2024-01-19,1021
4406,新昕纖,313,0,313,合庫-台中,2024-01-19,1021
00632R,元大台灣50反1,276,0,276,合庫-台中,2024-01-19,1021
00882,中信中國高股息,221,0,221,合庫-台中,2024-01-19,1021
00673R,期元大S＆P原油反1,209,0,209,合庫-台中,2024-01-19,1021
2838,聯邦銀,218,10,208,合庫-台中,2024-01-19,1021
00680L,元大美債20正2,266,100,166,合庫-台中,2024-01-19,1021
00937B,群益ESG投等債20,184,28,156,合庫-台中,2024-01-19,1021
00929,復華台灣科技優息,180,42,138,合庫-台中,2024-01-19,1021
8096,擎亞,199,63,136,合庫-台中,2024-01-19,1021
2845,遠東銀,110,0,110,合庫-台中,2024-01-19,1021
9136,巨騰-DR,109,0,109,合庫-台中,2024-01-19,1021
2002,中鋼,108,3,105,合庫-台中,2024-01-19,1021
00720B,元大投資級公司債,155,52,103,合庫-台中,2024-01-19,1021
00687B,國泰20年美債,105,4,101,合庫-台中,2024-01-19,1021
9105,泰金寶-DR,100,0,100,合庫-台中,2024-01-19,1021
00933B,國泰10Y+金融債,87,1,86,合庫-台中,2024-01-19,1021
00770,國泰北美科技,77,4,73,合庫-台中,2024-01-19,1021
4960,誠美材,89,21,68,合庫-台中,2024-01-19,1021
2356,英業達,353,290,63,合庫-台中,2024-01-19,1021
2609,陽明,75,15,60,合庫-台中,2024-01-19,1021
2610,華航,69,10,59,合庫-台中,2024-01-19,1021
5880,合庫金,57,5,52,合庫-台中,2024-01-19,1021
2014,中鴻,61,10,51,合庫-台中,2024-01-19,1021
00931B,統一美債20年,49,0,49,合庫-台中,2024-01-19,1021
00904,新光臺灣半導體30,40,0,40,合庫-台中,2024-01-19,1021
0052,富邦科技,41,2,39,合庫-台中,2024-01-19,1021
6770,力積電,52,13,39,合庫-台中,2024-01-19,1021
00688L,國泰20年美債正2,36,0,36,合庫-台中,2024-01-19,1021
3047,訊舟,35,0,35,合庫-台中,2024-01-19,1021
6223,旺矽,72,38,34,合庫-台中,2024-01-19,1021
1101,台泥,31,0,31,合庫-台中,2024-01-19,1021
9925,新保,30,0,30,合庫-台中,2024-01-19,1021
9902,台火,30,0,30,合庫-台中,2024-01-19,1021
00751B,元大AAA至A公司債,29,0,29,合庫-台中,2024-01-19,1021
1444,力麗,30,1,29,合庫-台中,2024-01-19,1021
00857B,永豐20年美公債,28,0,28,合庫-台中,2024-01-19,1021
1528,恩德,29,1,28,合庫-台中,2024-01-19,1021
3706,神達,95,69,26,合庫-台中,2024-01-19,1021
2607,榮運,26,0,26,合庫-台中,2024-01-19,1021
00665L,富邦�琤肭磪囓�2,28,2,26,合庫-台中,2024-01-19,1021
1514,亞力,31,5,26,合庫-台中,2024-01-19,1021
00664R,國泰臺灣加權反1,25,0,25,合庫-台中,2024-01-19,1021
00881,國泰台灣5G+,25,2,23,合庫-台中,2024-01-19,1021
6117,迎廣,43,23,20,合庫-台中,2024-01-19,1021
6285,啟��,30,10,20,合庫-台中,2024-01-19,1021
2886,兆豐金,28,9,19,合庫-台中,2024-01-19,1021
6155,鈞寶,51,32,19,合庫-台中,2024-01-19,1021
2888,新光金,39,20,19,合庫-台中,2024-01-19,1021
3029,零壹,22,6,16,合庫-台中,2024-01-19,1021
2618,長榮航,540,19,521,合庫-台中,2024-01-22,1021
00882,中信中國高股息,411,22,389,合庫-台中,2024-01-22,1021
2324,仁寶,381,66,315,合庫-台中,2024-01-22,1021
00830,國泰費城半導體,150,0,150,合庫-台中,2024-01-22,1021
2353,宏��,203,73,130,合庫-台中,2024-01-22,1021
00902,中信電池及儲能,93,3,90,合庫-台中,2024-01-22,1021
5347,世界,97,10,87,合庫-台中,2024-01-22,1021
6220,岳豐,81,0,81,合庫-台中,2024-01-22,1021
00665L,富邦�琤肭磪囓�2,498,420,78,合庫-台中,2024-01-22,1021
3013,晟銘電,92,17,75,合庫-台中,2024-01-22,1021
3231,緯創,543,470,73,合庫-台中,2024-01-22,1021
1301,台塑,63,5,58,合庫-台中,2024-01-22,1021
3265,台星科,63,6,57,合庫-台中,2024-01-22,1021
2834,臺企銀,54,0,54,合庫-台中,2024-01-22,1021
00919,群益台灣精選高息,63,11,52,合庫-台中,2024-01-22,1021
9945,潤泰新,46,0,46,合庫-台中,2024-01-22,1021
2603,長榮,58,13,45,合庫-台中,2024-01-22,1021
2444,兆勁,42,0,42,合庫-台中,2024-01-22,1021
5469,瀚宇博,40,0,40,合庫-台中,2024-01-22,1021
1795,美時,53,17,36,合庫-台中,2024-01-22,1021
2377,微星,40,5,35,合庫-台中,2024-01-22,1021
00688L,國泰20年美債正2,35,1,34,合庫-台中,2024-01-22,1021
00680L,元大美債20正2,55,22,33,合庫-台中,2024-01-22,1021
2313,華通,77,46,31,合庫-台中,2024-01-22,1021
2371,大同,35,6,29,合庫-台中,2024-01-22,1021
6292,迅德,29,1,28,合庫-台中,2024-01-22,1021
5880,合庫金,42,16,26,合庫-台中,2024-01-22,1021
00715L,期街口布蘭特正2,27,1,26,合庫-台中,2024-01-22,1021
3055,蔚華科,34,10,24,合庫-台中,2024-01-22,1021
2317,鴻海,28,5,23,合庫-台中,2024-01-22,1021
8059,凱碩,37,16,21,合庫-台中,2024-01-22,1021
8054,安國,76,56,20,合庫-台中,2024-01-22,1021
1506,正道,20,0,20,合庫-台中,2024-01-22,1021
1732,毛寶,20,0,20,合庫-台中,2024-01-22,1021
00706L,期元大S＆P日圓正2,20,0,20,合庫-台中,2024-01-22,1021
6233,旺玖,48,28,20,合庫-台中,2024-01-22,1021
2308,台達電,23,3,20,合庫-台中,2024-01-22,1021
3149,正達,20,1,19,合庫-台中,2024-01-22,1021
2382,廣達,78,61,17,合庫-台中,2024-01-22,1021
3202,樺晟,16,0,16,合庫-台中,2024-01-22,1021
1101,台泥,16,0,16,合庫-台中,2024-01-22,1021
2812,台中銀,45,30,15,合庫-台中,2024-01-22,1021
3623,富晶通,56,41,15,合庫-台中,2024-01-22,1021
2892,第一金,16,2,14,合庫-台中,2024-01-22,1021
2359,所羅門,30,17,13,合庫-台中,2024-01-22,1021
2449,京元電子,103,91,12,合庫-台中,2024-01-22,1021
00632R,元大台灣50反1,117,105,12,合庫-台中,2024-01-22,1021
4743,合一,16,6,10,合庫-台中,2024-01-22,1021
00934,中信成長高股息,12,2,10,合庫-台中,2024-01-22,1021
2889,國票金,20,10,10,合庫-台中,2024-01-22,1021
00665L,富邦�琤肭磪囓�2,4056,937,3119,合庫-台中,2024-01-23,1021
00632R,元大台灣50反1,714,80,634,合庫-台中,2024-01-23,1021
2301,光寶科,523,6,517,合庫-台中,2024-01-23,1021
00673R,期元大S＆P原油反1,214,0,214,合庫-台中,2024-01-23,1021
8054,安國,170,26,144,合庫-台中,2024-01-23,1021
00937B,群益ESG投等債20,154,40,114,合庫-台中,2024-01-23,1021
8096,擎亞,122,50,72,合庫-台中,2024-01-23,1021
00830,國泰費城半導體,62,0,62,合庫-台中,2024-01-23,1021
2329,華泰,91,36,55,合庫-台中,2024-01-23,1021
2363,矽統,73,21,52,合庫-台中,2024-01-23,1021
3005,神基,56,6,50,合庫-台中,2024-01-23,1021
00933B,國泰10Y+金融債,85,36,49,合庫-台中,2024-01-23,1021
1795,美時,64,18,46,合庫-台中,2024-01-23,1021
00680L,元大美債20正2,56,10,46,合庫-台中,2024-01-23,1021
3354,律勝,59,16,43,合庫-台中,2024-01-23,1021
2609,陽明,64,23,41,合庫-台中,2024-01-23,1021
1471,首利,41,1,40,合庫-台中,2024-01-23,1021
00772B,中信高評級公司債,41,1,40,合庫-台中,2024-01-23,1021
9945,潤泰新,45,7,38,合庫-台中,2024-01-23,1021
00931B,統一美債20年,37,1,36,合庫-台中,2024-01-23,1021
00891,中信關鍵半導體,36,0,36,合庫-台中,2024-01-23,1021
6116,彩晶,130,96,34,合庫-台中,2024-01-23,1021
00637L,元大滬深300正2,65,31,34,合庫-台中,2024-01-23,1021
00712,復華富時不動產,32,0,32,合庫-台中,2024-01-23,1021
3390,旭軟,30,0,30,合庫-台中,2024-01-23,1021
00753L,中信中國50正2,25,1,24,合庫-台中,2024-01-23,1021
2002,中鋼,32,8,24,合庫-台中,2024-01-23,1021
00679B,元大美債20年,24,1,23,合庫-台中,2024-01-23,1021
00902,中信電池及儲能,22,0,22,合庫-台中,2024-01-23,1021
5328,華容,21,0,21,合庫-台中,2024-01-23,1021
5880,合庫金,27,7,20,合庫-台中,2024-01-23,1021
9907,統一實,20,0,20,合庫-台中,2024-01-23,1021
2845,遠東銀,20,1,19,合庫-台中,2024-01-23,1021
4956,光鋐,19,0,19,合庫-台中,2024-01-23,1021
4127,天良,18,0,18,合庫-台中,2024-01-23,1021
2208,台船,29,11,18,合庫-台中,2024-01-23,1021
3149,正達,17,0,17,合庫-台中,2024-01-23,1021
2353,宏��,50,33,17,合庫-台中,2024-01-23,1021
00720B,元大投資級公司債,16,0,16,合庫-台中,2024-01-23,1021
3031,佰鴻,15,0,15,合庫-台中,2024-01-23,1021
00882,中信中國高股息,16,1,15,合庫-台中,2024-01-23,1021
6243,迅杰,16,2,14,合庫-台中,2024-01-23,1021
3217,優群,14,0,14,合庫-台中,2024-01-23,1021
6530,創威,21,7,14,合庫-台中,2024-01-23,1021
1504,東元,26,12,14,合庫-台中,2024-01-23,1021
2890,永豐金,15,2,13,合庫-台中,2024-01-23,1021
6462,神盾,20,7,13,合庫-台中,2024-01-23,1021
3037,欣興,15,3,12,合庫-台中,2024-01-23,1021
2884,玉山金,14,2,12,合庫-台中,2024-01-23,1021
6120,達運,13,1,12,合庫-台中,2024-01-23,1021
00937B,群益ESG投等債20,437,3,434,合庫-台中,2024-01-24,1021
3481,群創,490,207,283,合庫-台中,2024-01-24,1021
00712,復華富時不動產,166,2,164,合庫-台中,2024-01-24,1021
00877,復華中國5G,150,0,150,合庫-台中,2024-01-24,1021
2324,仁寶,139,31,108,合庫-台中,2024-01-24,1021
00902,中信電池及儲能,103,0,103,合庫-台中,2024-01-24,1021
2542,興富發,101,2,99,合庫-台中,2024-01-24,1021
2801,彰銀,85,2,83,合庫-台中,2024-01-24,1021
00637L,元大滬深300正2,272,199,73,合庫-台中,2024-01-24,1021
2834,臺企銀,68,0,68,合庫-台中,2024-01-24,1021
00929,復華台灣科技優息,127,63,64,合庫-台中,2024-01-24,1021
8046,南電,60,0,60,合庫-台中,2024-01-24,1021
8215,明基材,62,6,56,合庫-台中,2024-01-24,1021
00679B,元大美債20年,51,1,50,合庫-台中,2024-01-24,1021
00680L,元大美債20正2,69,20,49,合庫-台中,2024-01-24,1021
6237,驊訊,179,133,46,合庫-台中,2024-01-24,1021
2344,華邦電,63,22,41,合庫-台中,2024-01-24,1021
4127,天良,34,0,34,合庫-台中,2024-01-24,1021
00632R,元大台灣50反1,764,730,34,合庫-台中,2024-01-24,1021
3047,訊舟,31,1,30,合庫-台中,2024-01-24,1021
6531,愛普*,71,43,28,合庫-台中,2024-01-24,1021
3037,欣興,32,4,28,合庫-台中,2024-01-24,1021
3260,威剛,28,1,27,合庫-台中,2024-01-24,1021
9904,寶成,24,0,24,合庫-台中,2024-01-24,1021
1514,亞力,44,20,24,合庫-台中,2024-01-24,1021
8050,廣積,40,17,23,合庫-台中,2024-01-24,1021
5521,工信,21,0,21,合庫-台中,2024-01-24,1021
2884,玉山金,20,0,20,合庫-台中,2024-01-24,1021
00933B,國泰10Y+金融債,20,0,20,合庫-台中,2024-01-24,1021
1471,首利,20,0,20,合庫-台中,2024-01-24,1021
00687B,國泰20年美債,19,0,19,合庫-台中,2024-01-24,1021
00830,國泰費城半導體,21,2,19,合庫-台中,2024-01-24,1021
5324,士開,17,0,17,合庫-台中,2024-01-24,1021
3706,神達,84,67,17,合庫-台中,2024-01-24,1021
3006,晶豪科,18,2,16,合庫-台中,2024-01-24,1021
2301,光寶科,27,12,15,合庫-台中,2024-01-24,1021
3265,台星科,17,3,14,合庫-台中,2024-01-24,1021
3615,安可,29,16,13,合庫-台中,2024-01-24,1021
1325,恆大,22,9,13,合庫-台中,2024-01-24,1021
4919,新唐,22,10,12,合庫-台中,2024-01-24,1021
1528,恩德,12,0,12,合庫-台中,2024-01-24,1021
3232,昱捷,12,0,12,合庫-台中,2024-01-24,1021
3545,敦泰,18,6,12,合庫-台中,2024-01-24,1021
2462,良得電,15,3,12,合庫-台中,2024-01-24,1021
00688L,國泰20年美債正2,12,0,12,合庫-台中,2024-01-24,1021
2897,王道銀行,12,0,12,合庫-台中,2024-01-24,1021
4909,新復興,39,28,11,合庫-台中,2024-01-24,1021
8011,台通,14,3,11,合庫-台中,2024-01-24,1021
6435,大中,14,3,11,合庫-台中,2024-01-24,1021
6233,旺玖,21,10,11,合庫-台中,2024-01-24,1021
00665L,富邦�琤肭磪囓�2,2917,412,2505,合庫-台中,2024-01-25,1021
00937B,群益ESG投等債20,226,20,206,合庫-台中,2024-01-25,1021
9136,巨騰-DR,141,0,141,合庫-台中,2024-01-25,1021
3481,群創,472,339,133,合庫-台中,2024-01-25,1021
2409,友達,133,24,109,合庫-台中,2024-01-25,1021
2880,華南金,103,0,103,合庫-台中,2024-01-25,1021
00830,國泰費城半導體,93,1,92,合庫-台中,2024-01-25,1021
00902,中信電池及儲能,116,24,92,合庫-台中,2024-01-25,1021
00673R,期元大S＆P原油反1,91,0,91,合庫-台中,2024-01-25,1021
00770,國泰北美科技,100,11,89,合庫-台中,2024-01-25,1021
8064,東捷,82,1,81,合庫-台中,2024-01-25,1021
00687B,國泰20年美債,77,0,77,合庫-台中,2024-01-25,1021
2365,昆盈,89,19,70,合庫-台中,2024-01-25,1021
1815,富喬,67,0,67,合庫-台中,2024-01-25,1021
00688L,國泰20年美債正2,68,4,64,合庫-台中,2024-01-25,1021
3231,緯創,200,138,62,合庫-台中,2024-01-25,1021
00680L,元大美債20正2,78,16,62,合庫-台中,2024-01-25,1021
00637L,元大滬深300正2,272,214,58,合庫-台中,2024-01-25,1021
00929,復華台灣科技優息,126,68,58,合庫-台中,2024-01-25,1021
4908,前鼎,48,1,47,合庫-台中,2024-01-25,1021
5478,智冠,52,9,43,合庫-台中,2024-01-25,1021
00632R,元大台灣50反1,41,0,41,合庫-台中,2024-01-25,1021
6116,彩晶,38,0,38,合庫-台中,2024-01-25,1021
00679B,元大美債20年,41,3,38,合庫-台中,2024-01-25,1021
3712,永崴投控,35,0,35,合庫-台中,2024-01-25,1021
00751B,元大AAA至A公司債,28,0,28,合庫-台中,2024-01-25,1021
6113,亞矽,39,14,25,合庫-台中,2024-01-25,1021
2337,旺宏,25,1,24,合庫-台中,2024-01-25,1021
3025,星通,53,31,22,合庫-台中,2024-01-25,1021
00712,復華富時不動產,23,2,21,合庫-台中,2024-01-25,1021
2344,華邦電,129,109,20,合庫-台中,2024-01-25,1021
9902,台火,20,0,20,合庫-台中,2024-01-25,1021
5351,鈺創,22,3,19,合庫-台中,2024-01-25,1021
00882,中信中國高股息,39,21,18,合庫-台中,2024-01-25,1021
2443,昶虹,17,0,17,合庫-台中,2024-01-25,1021
2363,矽統,30,13,17,合庫-台中,2024-01-25,1021
4729,熒茂,26,9,17,合庫-台中,2024-01-25,1021
00933B,國泰10Y+金融債,17,0,17,合庫-台中,2024-01-25,1021
6770,力積電,21,4,17,合庫-台中,2024-01-25,1021
2313,華通,225,209,16,合庫-台中,2024-01-25,1021
3211,順達,18,2,16,合庫-台中,2024-01-25,1021
8046,南電,15,0,15,合庫-台中,2024-01-25,1021
00708L,期元大S＆P黃金正2,15,0,15,合庫-台中,2024-01-25,1021
2387,精元,14,0,14,合庫-台中,2024-01-25,1021
3374,精材,15,1,14,合庫-台中,2024-01-25,1021
5223,安力-KY,15,1,14,合庫-台中,2024-01-25,1021
2634,漢翔,24,10,14,合庫-台中,2024-01-25,1021
4123,晟德,16,2,14,合庫-台中,2024-01-25,1021
6231,系微,14,1,13,合庫-台中,2024-01-25,1021
6120,達運,13,0,13,合庫-台中,2024-01-25,1021
00673R,期元大S＆P原油反1,270,0,270,合庫-台中,2024-01-26,1021
2303,聯電,391,163,228,合庫-台中,2024-01-26,1021
00937B,群益ESG投等債20,200,0,200,合庫-台中,2024-01-26,1021
00929,復華台灣科技優息,190,10,180,合庫-台中,2024-01-26,1021
3005,神基,118,17,101,合庫-台中,2024-01-26,1021
2421,建準,124,25,99,合庫-台中,2024-01-26,1021
00931B,統一美債20年,104,7,97,合庫-台中,2024-01-26,1021
2324,仁寶,113,16,97,合庫-台中,2024-01-26,1021
9105,泰金寶-DR,165,76,89,合庫-台中,2024-01-26,1021
3354,律勝,73,11,62,合庫-台中,2024-01-26,1021
00877,復華中國5G,61,0,61,合庫-台中,2024-01-26,1021
4406,新昕纖,60,0,60,合庫-台中,2024-01-26,1021
00680L,元大美債20正2,60,0,60,合庫-台中,2024-01-26,1021
3380,明泰,62,5,57,合庫-台中,2024-01-26,1021
9136,巨騰-DR,54,0,54,合庫-台中,2024-01-26,1021
1503,士電,64,12,52,合庫-台中,2024-01-26,1021
00687B,國泰20年美債,48,0,48,合庫-台中,2024-01-26,1021
2353,宏��,93,52,41,合庫-台中,2024-01-26,1021
00679B,元大美債20年,40,0,40,合庫-台中,2024-01-26,1021
2376,技嘉,70,31,39,合庫-台中,2024-01-26,1021
1515,力山,33,0,33,合庫-台中,2024-01-26,1021
3390,旭軟,33,0,33,合庫-台中,2024-01-26,1021
1444,力麗,30,0,30,合庫-台中,2024-01-26,1021
8096,擎亞,46,16,30,合庫-台中,2024-01-26,1021
8105,凌巨,30,1,29,合庫-台中,2024-01-26,1021
2365,昆盈,136,109,27,合庫-台中,2024-01-26,1021
00632R,元大台灣50反1,23,0,23,合庫-台中,2024-01-26,1021
5521,工信,23,1,22,合庫-台中,2024-01-26,1021
6237,驊訊,30,9,21,合庫-台中,2024-01-26,1021
5272,笙科,20,0,20,合庫-台中,2024-01-26,1021
2106,建大,20,0,20,合庫-台中,2024-01-26,1021
00919,群益台灣精選高息,71,52,19,合庫-台中,2024-01-26,1021
2356,英業達,89,70,19,合庫-台中,2024-01-26,1021
3623,富晶通,50,31,19,合庫-台中,2024-01-26,1021
4916,事欣科,18,0,18,合庫-台中,2024-01-26,1021
0056,元大高股息,27,10,17,合庫-台中,2024-01-26,1021
2618,長榮航,47,30,17,合庫-台中,2024-01-26,1021
00936,台新永續高息中小,20,3,17,合庫-台中,2024-01-26,1021
1528,恩德,30,14,16,合庫-台中,2024-01-26,1021
00882,中信中國高股息,20,4,16,合庫-台中,2024-01-26,1021
3265,台星科,20,5,15,合庫-台中,2024-01-26,1021
2887,台新金,16,1,15,合庫-台中,2024-01-26,1021
2462,良得電,15,0,15,合庫-台中,2024-01-26,1021
2301,光寶科,20,6,14,合庫-台中,2024-01-26,1021
2032,新鋼,14,0,14,合庫-台中,2024-01-26,1021
3374,精材,15,1,14,合庫-台中,2024-01-26,1021
00934,中信成長高股息,14,0,14,合庫-台中,2024-01-26,1021
3360,尚立,50,37,13,合庫-台中,2024-01-26,1021
6235,華孚,19,6,13,合庫-台中,2024-01-26,1021
3312,弘憶股,13,0,13,合庫-台中,2024-01-26,1021
00632R,元大台灣50反1,687,0,687,合庫-台中,2024-01-29,1021
00676R,富邦臺灣加權反1,505,0,505,合庫-台中,2024-01-29,1021
00937B,群益ESG投等債20,261,5,256,合庫-台中,2024-01-29,1021
2603,長榮,235,13,222,合庫-台中,2024-01-29,1021
00877,復華中國5G,198,0,198,合庫-台中,2024-01-29,1021
00673R,期元大S＆P原油反1,183,0,183,合庫-台中,2024-01-29,1021
9136,巨騰-DR,115,0,115,合庫-台中,2024-01-29,1021
00935,野村臺灣新科技50,118,10,108,合庫-台中,2024-01-29,1021
00665L,富邦�琤肭磪囓�2,252,150,102,合庫-台中,2024-01-29,1021
00882,中信中國高股息,119,21,98,合庫-台中,2024-01-29,1021
00933B,國泰10Y+金融債,78,0,78,合庫-台中,2024-01-29,1021
2409,友達,108,42,66,合庫-台中,2024-01-29,1021
3191,雲嘉南,61,0,61,合庫-台中,2024-01-29,1021
2337,旺宏,62,4,58,合庫-台中,2024-01-29,1021
2610,華航,104,47,57,合庫-台中,2024-01-29,1021
6116,彩晶,53,0,53,合庫-台中,2024-01-29,1021
2369,菱生,52,0,52,合庫-台中,2024-01-29,1021
00679B,元大美債20年,53,1,52,合庫-台中,2024-01-29,1021
2303,聯電,68,17,51,合庫-台中,2024-01-29,1021
00680L,元大美債20正2,50,1,49,合庫-台中,2024-01-29,1021
6282,康舒,57,12,45,合庫-台中,2024-01-29,1021
8059,凱碩,57,13,44,合庫-台中,2024-01-29,1021
00751B,元大AAA至A公司債,43,0,43,合庫-台中,2024-01-29,1021
9105,泰金寶-DR,44,10,34,合庫-台中,2024-01-29,1021
2438,翔耀,30,0,30,合庫-台中,2024-01-29,1021
00720B,元大投資級公司債,30,0,30,合庫-台中,2024-01-29,1021
3005,神基,36,9,27,合庫-台中,2024-01-29,1021
3694,海華,69,44,25,合庫-台中,2024-01-29,1021
3360,尚立,92,67,25,合庫-台中,2024-01-29,1021
2543,皇昌,27,3,24,合庫-台中,2024-01-29,1021
2897,王道銀行,23,0,23,合庫-台中,2024-01-29,1021
3231,緯創,166,145,21,合庫-台中,2024-01-29,1021
00764B,群益25年美債,21,0,21,合庫-台中,2024-01-29,1021
3523,迎輝,20,0,20,合庫-台中,2024-01-29,1021
2887,台新金,57,38,19,合庫-台中,2024-01-29,1021
00919,群益台灣精選高息,43,24,19,合庫-台中,2024-01-29,1021
00687B,國泰20年美債,40,22,18,合庫-台中,2024-01-29,1021
6270,倍微,20,3,17,合庫-台中,2024-01-29,1021
6530,創威,26,9,17,合庫-台中,2024-01-29,1021
6770,力積電,18,1,17,合庫-台中,2024-01-29,1021
2609,陽明,25,9,16,合庫-台中,2024-01-29,1021
0056,元大高股息,25,10,15,合庫-台中,2024-01-29,1021
4968,立積,19,4,15,合庫-台中,2024-01-29,1021
1444,力麗,30,15,15,合庫-台中,2024-01-29,1021
3354,律勝,14,0,14,合庫-台中,2024-01-29,1021
3706,神達,20,6,14,合庫-台中,2024-01-29,1021
8227,巨有科技,42,30,12,合庫-台中,2024-01-29,1021
00753L,中信中國50正2,12,0,12,合庫-台中,2024-01-29,1021
2344,華邦電,23,11,12,合庫-台中,2024-01-29,1021
3481,群創,317,306,11,合庫-台中,2024-01-29,1021
00937B,群益ESG投等債20,348,24,324,合庫-台中,2024-01-30,1021
00882,中信中國高股息,261,3,258,合庫-台中,2024-01-30,1021
00687B,國泰20年美債,196,5,191,合庫-台中,2024-01-30,1021
6125,廣運,179,15,164,合庫-台中,2024-01-30,1021
00665L,富邦�琤肭磪囓�2,122,0,122,合庫-台中,2024-01-30,1021
00715L,期街口布蘭特正2,103,10,93,合庫-台中,2024-01-30,1021
00770,國泰北美科技,80,0,80,合庫-台中,2024-01-30,1021
2002,中鋼,89,12,77,合庫-台中,2024-01-30,1021
3005,神基,72,0,72,合庫-台中,2024-01-30,1021
1605,華新,122,56,66,合庫-台中,2024-01-30,1021
6282,康舒,157,97,60,合庫-台中,2024-01-30,1021
2516,新建,59,0,59,合庫-台中,2024-01-30,1021
6117,迎廣,55,0,55,合庫-台中,2024-01-30,1021
00877,復華中國5G,52,0,52,合庫-台中,2024-01-30,1021
5880,合庫金,65,14,51,合庫-台中,2024-01-30,1021
2337,旺宏,44,0,44,合庫-台中,2024-01-30,1021
3051,力特,44,0,44,合庫-台中,2024-01-30,1021
00669R,國泰美國道瓊反1,40,0,40,合庫-台中,2024-01-30,1021
2344,華邦電,43,4,39,合庫-台中,2024-01-30,1021
1216,統一,40,1,39,合庫-台中,2024-01-30,1021
1795,美時,38,1,37,合庫-台中,2024-01-30,1021
9136,巨騰-DR,35,0,35,合庫-台中,2024-01-30,1021
2382,廣達,55,21,34,合庫-台中,2024-01-30,1021
0056,元大高股息,44,10,34,合庫-台中,2024-01-30,1021
1314,中石化,53,20,33,合庫-台中,2024-01-30,1021
8054,安國,210,183,27,合庫-台中,2024-01-30,1021
00933B,國泰10Y+金融債,26,0,26,合庫-台中,2024-01-30,1021
3523,迎輝,25,0,25,合庫-台中,2024-01-30,1021
8064,東捷,41,17,24,合庫-台中,2024-01-30,1021
2888,新光金,29,5,24,合庫-台中,2024-01-30,1021
00751B,元大AAA至A公司債,35,11,24,合庫-台中,2024-01-30,1021
5426,振發,35,11,24,合庫-台中,2024-01-30,1021
6116,彩晶,24,1,23,合庫-台中,2024-01-30,1021
00936,台新永續高息中小,22,0,22,合庫-台中,2024-01-30,1021
6770,力積電,22,0,22,合庫-台中,2024-01-30,1021
2884,玉山金,22,0,22,合庫-台中,2024-01-30,1021
2610,華航,28,7,21,合庫-台中,2024-01-30,1021
00935,野村臺灣新科技50,20,0,20,合庫-台中,2024-01-30,1021
6733,博晟生醫,20,0,20,合庫-台中,2024-01-30,1021
5202,力新,20,0,20,合庫-台中,2024-01-30,1021
5876,上海商銀,27,7,20,合庫-台中,2024-01-30,1021
4542,科嶠,27,7,20,合庫-台中,2024-01-30,1021
3443,創意,24,5,19,合庫-台中,2024-01-30,1021
00764B,群益25年美債,18,0,18,合庫-台中,2024-01-30,1021
2882,國泰金,18,0,18,合庫-台中,2024-01-30,1021
2845,遠東銀,20,2,18,合庫-台中,2024-01-30,1021
6165,浪凡,25,7,18,合庫-台中,2024-01-30,1021
2356,英業達,118,101,17,合庫-台中,2024-01-30,1021
2892,第一金,17,0,17,合庫-台中,2024-01-30,1021
3038,全台,17,0,17,合庫-台中,2024-01-30,1021
00937B,群益ESG投等債20,136,5,131,合庫-台中,2024-01-31,1021
00680L,元大美債20正2,154,50,104,合庫-台中,2024-01-31,1021
00751B,元大AAA至A公司債,113,10,103,合庫-台中,2024-01-31,1021
00753L,中信中國50正2,93,12,81,合庫-台中,2024-01-31,1021
2303,聯電,88,8,80,合庫-台中,2024-01-31,1021
00929,復華台灣科技優息,99,30,69,合庫-台中,2024-01-31,1021
4406,新昕纖,65,0,65,合庫-台中,2024-01-31,1021
1605,華新,63,0,63,合庫-台中,2024-01-31,1021
3035,智原,80,20,60,合庫-台中,2024-01-31,1021
00687B,國泰20年美債,78,25,53,合庫-台中,2024-01-31,1021
2409,友達,59,8,51,合庫-台中,2024-01-31,1021
6282,康舒,99,54,45,合庫-台中,2024-01-31,1021
3038,全台,51,8,43,合庫-台中,2024-01-31,1021
2609,陽明,44,1,43,合庫-台中,2024-01-31,1021
2002,中鋼,45,3,42,合庫-台中,2024-01-31,1021
00934,中信成長高股息,42,0,42,合庫-台中,2024-01-31,1021
6451,訊芯-KY,72,30,42,合庫-台中,2024-01-31,1021
5876,上海商銀,40,0,40,合庫-台中,2024-01-31,1021
2356,英業達,64,28,36,合庫-台中,2024-01-31,1021
00665L,富邦�琤肭磪囓�2,67,33,34,合庫-台中,2024-01-31,1021
2330,台積電,81,48,33,合庫-台中,2024-01-31,1021
2208,台船,30,0,30,合庫-台中,2024-01-31,1021
6196,帆宣,32,2,30,合庫-台中,2024-01-31,1021
1535,中宇,31,1,30,合庫-台中,2024-01-31,1021
2634,漢翔,36,6,30,合庫-台中,2024-01-31,1021
8096,擎亞,45,17,28,合庫-台中,2024-01-31,1021
2812,台中銀,71,44,27,合庫-台中,2024-01-31,1021
1312,國喬,25,0,25,合庫-台中,2024-01-31,1021
2501,國建,25,0,25,合庫-台中,2024-01-31,1021
6125,廣運,25,2,23,合庫-台中,2024-01-31,1021
2465,麗臺,27,6,21,合庫-台中,2024-01-31,1021
3523,迎輝,21,0,21,合庫-台中,2024-01-31,1021
1101,台泥,21,1,20,合庫-台中,2024-01-31,1021
3338,泰碩,21,1,20,合庫-台中,2024-01-31,1021
8215,明基材,20,0,20,合庫-台中,2024-01-31,1021
00671R,富邦NASDAQ反1,20,0,20,合庫-台中,2024-01-31,1021
2344,華邦電,28,8,20,合庫-台中,2024-01-31,1021
2352,佳世達,22,3,19,合庫-台中,2024-01-31,1021
2369,菱生,35,17,18,合庫-台中,2024-01-31,1021
6684,安格,62,44,18,合庫-台中,2024-01-31,1021
00882,中信中國高股息,20,3,17,合庫-台中,2024-01-31,1021
6695,芯鼎,32,15,17,合庫-台中,2024-01-31,1021
00918,大華優利高填息30,16,0,16,合庫-台中,2024-01-31,1021
6120,達運,19,3,16,合庫-台中,2024-01-31,1021
4111,濟生,15,0,15,合庫-台中,2024-01-31,1021
5426,振發,26,11,15,合庫-台中,2024-01-31,1021
2426,鼎元,15,0,15,合庫-台中,2024-01-31,1021
6117,迎廣,27,12,15,合庫-台中,2024-01-31,1021
2329,華泰,101,86,15,合庫-台中,2024-01-31,1021
2886,兆豐金,29,14,15,合庫-台中,2024-01-31,1021
2409,友達,258,44,214,合庫-台中,2024-02-01,1021
6684,安格,232,32,200,合庫-台中,2024-02-01,1021
6282,康舒,261,138,123,合庫-台中,2024-02-01,1021
00929,復華台灣科技優息,100,0,100,合庫-台中,2024-02-01,1021
00770,國泰北美科技,79,0,79,合庫-台中,2024-02-01,1021
00712,復華富時不動產,68,0,68,合庫-台中,2024-02-01,1021
8227,巨有科技,75,10,65,合庫-台中,2024-02-01,1021
00715L,期街口布蘭特正2,165,104,61,合庫-台中,2024-02-01,1021
00937B,群益ESG投等債20,78,18,60,合庫-台中,2024-02-01,1021
00882,中信中國高股息,55,2,53,合庫-台中,2024-02-01,1021
2353,宏��,68,15,53,合庫-台中,2024-02-01,1021
00878,國泰永續高股息,75,24,51,合庫-台中,2024-02-01,1021
1471,首利,50,1,49,合庫-台中,2024-02-01,1021
5426,振發,65,26,39,合庫-台中,2024-02-01,1021
2454,聯發科,55,18,37,合庫-台中,2024-02-01,1021
2303,聯電,52,17,35,合庫-台中,2024-02-01,1021
3434,哲固,43,8,35,合庫-台中,2024-02-01,1021
5251,天鉞電,35,0,35,合庫-台中,2024-02-01,1021
6116,彩晶,32,0,32,合庫-台中,2024-02-01,1021
3324,雙鴻,40,10,30,合庫-台中,2024-02-01,1021
5388,中磊,25,0,25,合庫-台中,2024-02-01,1021
2363,矽統,53,31,22,合庫-台中,2024-02-01,1021
3523,迎輝,20,0,20,合庫-台中,2024-02-01,1021
8096,擎亞,34,15,19,合庫-台中,2024-02-01,1021
2634,漢翔,22,3,19,合庫-台中,2024-02-01,1021
6113,亞矽,36,18,18,合庫-台中,2024-02-01,1021
3694,海華,22,4,18,合庫-台中,2024-02-01,1021
00904,新光臺灣半導體30,16,0,16,合庫-台中,2024-02-01,1021
6233,旺玖,15,0,15,合庫-台中,2024-02-01,1021
6265,方土昶,28,13,15,合庫-台中,2024-02-01,1021
6785,昱展新藥,14,0,14,合庫-台中,2024-02-01,1021
6125,廣運,20,6,14,合庫-台中,2024-02-01,1021
8064,東捷,16,2,14,合庫-台中,2024-02-01,1021
2382,廣達,17,4,13,合庫-台中,2024-02-01,1021
3693,營邦,20,7,13,合庫-台中,2024-02-01,1021
6530,創威,19,6,13,合庫-台中,2024-02-01,1021
8011,台通,14,1,13,合庫-台中,2024-02-01,1021
5512,力麒,29,16,13,合庫-台中,2024-02-01,1021
2349,錸德,20,7,13,合庫-台中,2024-02-01,1021
00927,群益半導體收益,22,10,12,合庫-台中,2024-02-01,1021
3033,威健,19,7,12,合庫-台中,2024-02-01,1021
6589,台康生技,12,0,12,合庫-台中,2024-02-01,1021
1440,南紡,11,0,11,合庫-台中,2024-02-01,1021
3228,金麗科,11,0,11,合庫-台中,2024-02-01,1021
8936,國統,112,101,11,合庫-台中,2024-02-01,1021
3025,星通,11,1,10,合庫-台中,2024-02-01,1021
3297,杭特,10,0,10,合庫-台中,2024-02-01,1021
6152,百一,10,0,10,合庫-台中,2024-02-01,1021
00671R,富邦NASDAQ反1,10,0,10,合庫-台中,2024-02-01,1021
2337,旺宏,24,14,10,合庫-台中,2024-02-01,1021
6282,康舒,300,42,258,合庫-台中,2024-02-02,1021
4406,新昕纖,210,0,210,合庫-台中,2024-02-02,1021
00770,國泰北美科技,170,0,170,合庫-台中,2024-02-02,1021
00937B,群益ESG投等債20,207,44,163,合庫-台中,2024-02-02,1021
00632R,元大台灣50反1,154,0,154,合庫-台中,2024-02-02,1021
6243,迅杰,250,106,144,合庫-台中,2024-02-02,1021
8111,立��,141,0,141,合庫-台中,2024-02-02,1021
00680L,元大美債20正2,133,1,132,合庫-台中,2024-02-02,1021
00933B,國泰10Y+金融債,161,40,121,合庫-台中,2024-02-02,1021
2515,中工,122,2,120,合庫-台中,2024-02-02,1021
00637L,元大滬深300正2,1081,973,108,合庫-台中,2024-02-02,1021
9105,泰金寶-DR,100,0,100,合庫-台中,2024-02-02,1021
00878,國泰永續高股息,163,63,100,合庫-台中,2024-02-02,1021
00712,復華富時不動產,86,1,85,合庫-台中,2024-02-02,1021
2303,聯電,88,4,84,合庫-台中,2024-02-02,1021
2364,倫飛,82,1,81,合庫-台中,2024-02-02,1021
3050,鈺德,64,5,59,合庫-台中,2024-02-02,1021
2603,長榮,59,1,58,合庫-台中,2024-02-02,1021
3363,上詮,68,12,56,合庫-台中,2024-02-02,1021
2353,宏��,88,34,54,合庫-台中,2024-02-02,1021
1514,亞力,58,14,44,合庫-台中,2024-02-02,1021
2609,陽明,44,3,41,合庫-台中,2024-02-02,1021
00929,復華台灣科技優息,69,30,39,合庫-台中,2024-02-02,1021
3005,神基,42,3,39,合庫-台中,2024-02-02,1021
3504,揚明光,38,3,35,合庫-台中,2024-02-02,1021
5347,世界,32,0,32,合庫-台中,2024-02-02,1021
3535,晶彩科,38,6,32,合庫-台中,2024-02-02,1021
4711,永純,30,0,30,合庫-台中,2024-02-02,1021
2317,鴻海,39,10,29,合庫-台中,2024-02-02,1021
3523,迎輝,29,0,29,合庫-台中,2024-02-02,1021
8096,擎亞,62,35,27,合庫-台中,2024-02-02,1021
2442,新美齊,26,0,26,合庫-台中,2024-02-02,1021
5521,工信,26,0,26,合庫-台中,2024-02-02,1021
00919,群益台灣精選高息,26,0,26,合庫-台中,2024-02-02,1021
00902,中信電池及儲能,35,10,25,合庫-台中,2024-02-02,1021
3036,文曄,46,22,24,合庫-台中,2024-02-02,1021
4552,力達-KY,35,12,23,合庫-台中,2024-02-02,1021
3324,雙鴻,40,20,20,合庫-台中,2024-02-02,1021
2460,建通,27,7,20,合庫-台中,2024-02-02,1021
4906,正文,24,5,19,合庫-台中,2024-02-02,1021
6770,力積電,21,2,19,合庫-台中,2024-02-02,1021
3360,尚立,19,0,19,合庫-台中,2024-02-02,1021
6451,訊芯-KY,20,1,19,合庫-台中,2024-02-02,1021
2344,華邦電,18,0,18,合庫-台中,2024-02-02,1021
1560,中砂,22,4,18,合庫-台中,2024-02-02,1021
2002,中鋼,18,0,18,合庫-台中,2024-02-02,1021
5426,振發,21,3,18,合庫-台中,2024-02-02,1021
6265,方土昶,21,4,17,合庫-台中,2024-02-02,1021
4938,和碩,20,3,17,合庫-台中,2024-02-02,1021
8034,榮群,16,0,16,合庫-台中,2024-02-02,1021
00929,復華台灣科技優息,280,10,270,合庫-台中,2024-02-05,1021
00937B,群益ESG投等債20,260,10,250,合庫-台中,2024-02-05,1021
2301,光寶科,227,13,214,合庫-台中,2024-02-05,1021
00715L,期街口布蘭特正2,182,15,167,合庫-台中,2024-02-05,1021
2356,英業達,163,42,121,合庫-台中,2024-02-05,1021
2365,昆盈,134,23,111,合庫-台中,2024-02-05,1021
6116,彩晶,103,1,102,合庫-台中,2024-02-05,1021
4552,力達-KY,137,47,90,合庫-台中,2024-02-05,1021
2303,聯電,93,18,75,合庫-台中,2024-02-05,1021
3523,迎輝,74,1,73,合庫-台中,2024-02-05,1021
2812,台中銀,72,1,71,合庫-台中,2024-02-05,1021
00712,復華富時不動產,73,3,70,合庫-台中,2024-02-05,1021
4406,新昕纖,70,0,70,合庫-台中,2024-02-05,1021
9902,台火,66,0,66,合庫-台中,2024-02-05,1021
00882,中信中國高股息,79,18,61,合庫-台中,2024-02-05,1021
2313,華通,101,42,59,合庫-台中,2024-02-05,1021
2884,玉山金,54,0,54,合庫-台中,2024-02-05,1021
00679B,元大美債20年,58,6,52,合庫-台中,2024-02-05,1021
00891,中信關鍵半導體,51,0,51,合庫-台中,2024-02-05,1021
00680L,元大美債20正2,96,47,49,合庫-台中,2024-02-05,1021
2025,千興,55,8,47,合庫-台中,2024-02-05,1021
2002,中鋼,54,9,45,合庫-台中,2024-02-05,1021
2421,建準,75,32,43,合庫-台中,2024-02-05,1021
00642U,期元大S＆P石油,43,0,43,合庫-台中,2024-02-05,1021
6531,愛普*,48,8,40,合庫-台中,2024-02-05,1021
00933B,國泰10Y+金融債,42,3,39,合庫-台中,2024-02-05,1021
5876,上海商銀,36,0,36,合庫-台中,2024-02-05,1021
4533,協易機,40,6,34,合庫-台中,2024-02-05,1021
5880,合庫金,36,4,32,合庫-台中,2024-02-05,1021
00931B,統一美債20年,32,0,32,合庫-台中,2024-02-05,1021
00650L,復華香港正2,632,600,32,合庫-台中,2024-02-05,1021
6462,神盾,28,1,27,合庫-台中,2024-02-05,1021
2498,宏達電,33,7,26,合庫-台中,2024-02-05,1021
4960,誠美材,29,3,26,合庫-台中,2024-02-05,1021
2465,麗臺,27,2,25,合庫-台中,2024-02-05,1021
1605,華新,27,3,24,合庫-台中,2024-02-05,1021
8940,新天地,26,2,24,合庫-台中,2024-02-05,1021
0056,元大高股息,39,15,24,合庫-台中,2024-02-05,1021
1582,信錦,26,4,22,合庫-台中,2024-02-05,1021
5475,德宏,24,2,22,合庫-台中,2024-02-05,1021
6274,台燿,35,14,21,合庫-台中,2024-02-05,1021
3354,律勝,32,12,20,合庫-台中,2024-02-05,1021
00688L,國泰20年美債正2,20,0,20,合庫-台中,2024-02-05,1021
6220,岳豐,20,0,20,合庫-台中,2024-02-05,1021
3294,英濟,20,0,20,合庫-台中,2024-02-05,1021
5291,邑昇,18,0,18,合庫-台中,2024-02-05,1021
5469,瀚宇博,19,1,18,合庫-台中,2024-02-05,1021
2801,彰銀,18,1,17,合庫-台中,2024-02-05,1021
3481,群創,57,41,16,合庫-台中,2024-02-05,1021
1528,恩德,30,14,16,合庫-台中,2024-02-05,1021
00680L,元大美債20正2,534,0,534,合庫-台中,2024-02-15,1021
00937B,群益ESG投等債20,436,1,435,合庫-台中,2024-02-15,1021
00720B,元大投資級公司債,349,0,349,合庫-台中,2024-02-15,1021
00933B,國泰10Y+金融債,344,0,344,合庫-台中,2024-02-15,1021
00673R,期元大S＆P原油反1,266,0,266,合庫-台中,2024-02-15,1021
00687B,國泰20年美債,212,0,212,合庫-台中,2024-02-15,1021
2618,長榮航,250,47,203,合庫-台中,2024-02-15,1021
00751B,元大AAA至A公司債,198,0,198,合庫-台中,2024-02-15,1021
3481,群創,234,52,182,合庫-台中,2024-02-15,1021
00679B,元大美債20年,147,2,145,合庫-台中,2024-02-15,1021
00919,群益台灣精選高息,145,25,120,合庫-台中,2024-02-15,1021
00632R,元大台灣50反1,93,2,91,合庫-台中,2024-02-15,1021
00688L,國泰20年美債正2,68,0,68,合庫-台中,2024-02-15,1021
00929,復華台灣科技優息,207,141,66,合庫-台中,2024-02-15,1021
2888,新光金,104,41,63,合庫-台中,2024-02-15,1021
2301,光寶科,69,9,60,合庫-台中,2024-02-15,1021
2610,華航,65,11,54,合庫-台中,2024-02-15,1021
3005,神基,64,11,53,合庫-台中,2024-02-15,1021
2408,南亞科,44,0,44,合庫-台中,2024-02-15,1021
2409,友達,73,30,43,合庫-台中,2024-02-15,1021
2344,華邦電,92,49,43,合庫-台中,2024-02-15,1021
2421,建準,73,32,41,合庫-台中,2024-02-15,1021
4111,濟生,36,0,36,合庫-台中,2024-02-15,1021
2603,長榮,43,10,33,合庫-台中,2024-02-15,1021
00706L,期元大S＆P日圓正2,33,0,33,合庫-台中,2024-02-15,1021
4938,和碩,32,1,31,合庫-台中,2024-02-15,1021
3523,迎輝,30,0,30,合庫-台中,2024-02-15,1021
3294,英濟,30,0,30,合庫-台中,2024-02-15,1021
00918,大華優利高填息30,28,0,28,合庫-台中,2024-02-15,1021
00795B,中信美國公債20年,27,0,27,合庫-台中,2024-02-15,1021
00772B,中信高評級公司債,26,0,26,合庫-台中,2024-02-15,1021
2062,橋椿,26,0,26,合庫-台中,2024-02-15,1021
3017,奇鋐,38,12,26,合庫-台中,2024-02-15,1021
3362,先進光,26,1,25,合庫-台中,2024-02-15,1021
3036,文曄,44,22,22,合庫-台中,2024-02-15,1021
0056,元大高股息,80,59,21,合庫-台中,2024-02-15,1021
6589,台康生技,36,15,21,合庫-台中,2024-02-15,1021
1444,力麗,40,20,20,合庫-台中,2024-02-15,1021
00710B,復華彭博非投等債,20,0,20,合庫-台中,2024-02-15,1021
6128,上福,37,17,20,合庫-台中,2024-02-15,1021
2884,玉山金,28,8,20,合庫-台中,2024-02-15,1021
2233,宇隆,20,4,16,合庫-台中,2024-02-15,1021
5871,中租-KY,17,1,16,合庫-台中,2024-02-15,1021
1717,長興,15,0,15,合庫-台中,2024-02-15,1021
1324,地球,16,1,15,合庫-台中,2024-02-15,1021
3712,永崴投控,16,1,15,合庫-台中,2024-02-15,1021
1605,華新,16,1,15,合庫-台中,2024-02-15,1021
6901,鑽石投資,14,0,14,合庫-台中,2024-02-15,1021
9105,泰金寶-DR,14,0,14,合庫-台中,2024-02-15,1021
2892,第一金,18,4,14,合庫-台中,2024-02-15,1021
00929,復華台灣科技優息,737,169,568,合庫-台中,2024-02-16,1021
00680L,元大美債20正2,267,0,267,合庫-台中,2024-02-16,1021
00933B,國泰10Y+金融債,149,2,147,合庫-台中,2024-02-16,1021
2609,陽明,150,15,135,合庫-台中,2024-02-16,1021
00712,復華富時不動產,133,1,132,合庫-台中,2024-02-16,1021
00937B,群益ESG投等債20,137,6,131,合庫-台中,2024-02-16,1021
00919,群益台灣精選高息,150,32,118,合庫-台中,2024-02-16,1021
00673R,期元大S＆P原油反1,104,0,104,合庫-台中,2024-02-16,1021
9902,台火,97,0,97,合庫-台中,2024-02-16,1021
00878,國泰永續高股息,174,83,91,合庫-台中,2024-02-16,1021
2303,聯電,95,5,90,合庫-台中,2024-02-16,1021
4956,光鋐,104,14,90,合庫-台中,2024-02-16,1021
00687B,國泰20年美債,88,2,86,合庫-台中,2024-02-16,1021
00679B,元大美債20年,85,6,79,合庫-台中,2024-02-16,1021
3523,迎輝,79,2,77,合庫-台中,2024-02-16,1021
00795B,中信美國公債20年,69,0,69,合庫-台中,2024-02-16,1021
2329,華泰,155,88,67,合庫-台中,2024-02-16,1021
00713,元大台灣高息低波,72,6,66,合庫-台中,2024-02-16,1021
2382,廣達,108,52,56,合庫-台中,2024-02-16,1021
00931B,統一美債20年,56,2,54,合庫-台中,2024-02-16,1021
4552,力達-KY,91,43,48,合庫-台中,2024-02-16,1021
2486,一詮,62,21,41,合庫-台中,2024-02-16,1021
3090,日電貿,41,1,40,合庫-台中,2024-02-16,1021
00772B,中信高評級公司債,40,0,40,合庫-台中,2024-02-16,1021
00669R,國泰美國道瓊反1,30,0,30,合庫-台中,2024-02-16,1021
4306,炎洲,30,0,30,合庫-台中,2024-02-16,1021
00720B,元大投資級公司債,29,0,29,合庫-台中,2024-02-16,1021
3036,文曄,43,15,28,合庫-台中,2024-02-16,1021
00665L,富邦�琤肭磪囓�2,406,379,27,合庫-台中,2024-02-16,1021
2886,兆豐金,32,5,27,合庫-台中,2024-02-16,1021
6282,康舒,114,88,26,合庫-台中,2024-02-16,1021
6530,創威,34,9,25,合庫-台中,2024-02-16,1021
2355,敬鵬,41,16,25,合庫-台中,2024-02-16,1021
3002,歐格,31,6,25,合庫-台中,2024-02-16,1021
00725B,國泰投資級公司債,24,0,24,合庫-台中,2024-02-16,1021
00753L,中信中國50正2,198,175,23,合庫-台中,2024-02-16,1021
00900,富邦特選高股息30,30,9,21,合庫-台中,2024-02-16,1021
3535,晶彩科,27,6,21,合庫-台中,2024-02-16,1021
3372,典範,21,0,21,合庫-台中,2024-02-16,1021
2317,鴻海,29,8,21,合庫-台中,2024-02-16,1021
6616,特昇-KY,20,0,20,合庫-台中,2024-02-16,1021
5315,光聯,20,0,20,合庫-台中,2024-02-16,1021
6442,光聖,33,14,19,合庫-台中,2024-02-16,1021
5381,合正,21,2,19,合庫-台中,2024-02-16,1021
00751B,元大AAA至A公司債,19,0,19,合庫-台中,2024-02-16,1021
1717,長興,19,0,19,合庫-台中,2024-02-16,1021
2363,矽統,103,84,19,合庫-台中,2024-02-16,1021
3294,英濟,22,4,18,合庫-台中,2024-02-16,1021
00891,中信關鍵半導體,36,18,18,合庫-台中,2024-02-16,1021
2812,台中銀,41,24,17,合庫-台中,2024-02-16,1021
00665L,富邦�琤肭磪囓�2,2815,294,2521,合庫-台中,2024-02-19,1021
00637L,元大滬深300正2,1242,826,416,合庫-台中,2024-02-19,1021
00937B,群益ESG投等債20,239,5,234,合庫-台中,2024-02-19,1021
2605,新興,210,47,163,合庫-台中,2024-02-19,1021
2515,中工,249,103,146,合庫-台中,2024-02-19,1021
00919,群益台灣精選高息,147,8,139,合庫-台中,2024-02-19,1021
00680L,元大美債20正2,136,3,133,合庫-台中,2024-02-19,1021
00720B,元大投資級公司債,139,10,129,合庫-台中,2024-02-19,1021
00878,國泰永續高股息,144,16,128,合庫-台中,2024-02-19,1021
00712,復華富時不動產,126,1,125,合庫-台中,2024-02-19,1021
00687B,國泰20年美債,124,2,122,合庫-台中,2024-02-19,1021
3294,英濟,77,2,75,合庫-台中,2024-02-19,1021
2353,宏��,185,112,73,合庫-台中,2024-02-19,1021
3231,緯創,173,100,73,合庫-台中,2024-02-19,1021
00933B,國泰10Y+金融債,72,1,71,合庫-台中,2024-02-19,1021
00751B,元大AAA至A公司債,85,18,67,合庫-台中,2024-02-19,1021
00673R,期元大S＆P原油反1,67,0,67,合庫-台中,2024-02-19,1021
00632R,元大台灣50反1,63,0,63,合庫-台中,2024-02-19,1021
2369,菱生,305,244,61,合庫-台中,2024-02-19,1021
9933,中鼎,58,0,58,合庫-台中,2024-02-19,1021
00650L,復華香港正2,303,250,53,合庫-台中,2024-02-19,1021
00679B,元大美債20年,73,20,53,合庫-台中,2024-02-19,1021
00929,復華台灣科技優息,139,88,51,合庫-台中,2024-02-19,1021
00655L,國泰中國A50正2,50,0,50,合庫-台中,2024-02-19,1021
2025,千興,50,1,49,合庫-台中,2024-02-19,1021
00891,中信關鍵半導體,46,0,46,合庫-台中,2024-02-19,1021
00882,中信中國高股息,59,16,43,合庫-台中,2024-02-19,1021
2364,倫飛,41,0,41,合庫-台中,2024-02-19,1021
5356,協益,36,2,34,合庫-台中,2024-02-19,1021
8121,越峰,34,0,34,合庫-台中,2024-02-19,1021
6290,良維,72,38,34,合庫-台中,2024-02-19,1021
3217,優群,33,1,32,合庫-台中,2024-02-19,1021
00795B,中信美國公債20年,32,0,32,合庫-台中,2024-02-19,1021
00753L,中信中國50正2,257,229,28,合庫-台中,2024-02-19,1021
00857B,永豐20年美公債,25,0,25,合庫-台中,2024-02-19,1021
2356,英業達,55,31,24,合庫-台中,2024-02-19,1021
2324,仁寶,42,18,24,合庫-台中,2024-02-19,1021
6419,京晨科,24,0,24,合庫-台中,2024-02-19,1021
1513,中興電,51,27,24,合庫-台中,2024-02-19,1021
6274,台燿,62,39,23,合庫-台中,2024-02-19,1021
3002,歐格,23,0,23,合庫-台中,2024-02-19,1021
3523,迎輝,21,0,21,合庫-台中,2024-02-19,1021
6530,創威,20,0,20,合庫-台中,2024-02-19,1021
6733,博晟生醫,20,0,20,合庫-台中,2024-02-19,1021
2305,全友,20,0,20,合庫-台中,2024-02-19,1021
3703,欣陸,20,0,20,合庫-台中,2024-02-19,1021
3380,明泰,22,2,20,合庫-台中,2024-02-19,1021
1717,長興,21,1,20,合庫-台中,2024-02-19,1021
4909,新復興,108,88,20,合庫-台中,2024-02-19,1021
5315,光聯,20,0,20,合庫-台中,2024-02-19,1021
00929,復華台灣科技優息,589,300,289,合庫-台中,2024-02-20,1021
00673R,期元大S＆P原油反1,211,2,209,合庫-台中,2024-02-20,1021
2605,新興,315,126,189,合庫-台中,2024-02-20,1021
00650L,復華香港正2,386,200,186,合庫-台中,2024-02-20,1021
3231,緯創,238,77,161,合庫-台中,2024-02-20,1021
3481,群創,215,55,160,合庫-台中,2024-02-20,1021
00665L,富邦�琤肭磪囓�2,162,31,131,合庫-台中,2024-02-20,1021
00919,群益台灣精選高息,187,56,131,合庫-台中,2024-02-20,1021
2610,華航,143,20,123,合庫-台中,2024-02-20,1021
00680L,元大美債20正2,121,17,104,合庫-台中,2024-02-20,1021
00632R,元大台灣50反1,102,0,102,合庫-台中,2024-02-20,1021
00687B,國泰20年美債,102,1,101,合庫-台中,2024-02-20,1021
00933B,國泰10Y+金融債,110,10,100,合庫-台中,2024-02-20,1021
00679B,元大美債20年,96,4,92,合庫-台中,2024-02-20,1021
2489,瑞軒,96,18,78,合庫-台中,2024-02-20,1021
3523,迎輝,72,1,71,合庫-台中,2024-02-20,1021
00712,復華富時不動產,70,1,69,合庫-台中,2024-02-20,1021
00882,中信中國高股息,58,3,55,合庫-台中,2024-02-20,1021
00753L,中信中國50正2,82,30,52,合庫-台中,2024-02-20,1021
00720B,元大投資級公司債,50,0,50,合庫-台中,2024-02-20,1021
2353,宏��,80,31,49,合庫-台中,2024-02-20,1021
00751B,元大AAA至A公司債,58,10,48,合庫-台中,2024-02-20,1021
6419,京晨科,48,0,48,合庫-台中,2024-02-20,1021
2385,群光,50,3,47,合庫-台中,2024-02-20,1021
00878,國泰永續高股息,102,59,43,合庫-台中,2024-02-20,1021
1717,長興,45,2,43,合庫-台中,2024-02-20,1021
2501,國建,40,0,40,合庫-台中,2024-02-20,1021
4745,合富-KY,69,31,38,合庫-台中,2024-02-20,1021
2344,華邦電,41,5,36,合庫-台中,2024-02-20,1021
2365,昆盈,42,7,35,合庫-台中,2024-02-20,1021
8110,華東,85,51,34,合庫-台中,2024-02-20,1021
1455,集盛,39,5,34,合庫-台中,2024-02-20,1021
3234,光環,52,22,30,合庫-台中,2024-02-20,1021
00918,大華優利高填息30,52,23,29,合庫-台中,2024-02-20,1021
2382,廣達,71,43,28,合庫-台中,2024-02-20,1021
8064,東捷,38,10,28,合庫-台中,2024-02-20,1021
00937B,群益ESG投等債20,117,90,27,合庫-台中,2024-02-20,1021
2329,華泰,71,44,27,合庫-台中,2024-02-20,1021
3516,亞帝歐,28,1,27,合庫-台中,2024-02-20,1021
00931B,統一美債20年,29,3,26,合庫-台中,2024-02-20,1021
2208,台船,26,0,26,合庫-台中,2024-02-20,1021
2330,台積電,33,7,26,合庫-台中,2024-02-20,1021
4960,誠美材,46,20,26,合庫-台中,2024-02-20,1021
2367,燿華,32,7,25,合庫-台中,2024-02-20,1021
1514,亞力,43,19,24,合庫-台中,2024-02-20,1021
3287,廣寰科,24,0,24,合庫-台中,2024-02-20,1021
2376,技嘉,78,54,24,合庫-台中,2024-02-20,1021
2405,輔信,50,27,23,合庫-台中,2024-02-20,1021
1414,東和,33,10,23,合庫-台中,2024-02-20,1021
1312,國喬,22,0,22,合庫-台中,2024-02-20,1021
6282,康舒,378,105,273,合庫-台中,2024-02-21,1021
00878,國泰永續高股息,289,28,261,合庫-台中,2024-02-21,1021
00933B,國泰10Y+金融債,225,4,221,合庫-台中,2024-02-21,1021
00673R,期元大S＆P原油反1,217,3,214,合庫-台中,2024-02-21,1021
00929,復華台灣科技優息,210,24,186,合庫-台中,2024-02-21,1021
00712,復華富時不動產,142,0,142,合庫-台中,2024-02-21,1021
00937B,群益ESG投等債20,166,50,116,合庫-台中,2024-02-21,1021
1605,華新,220,104,116,合庫-台中,2024-02-21,1021
1314,中石化,110,0,110,合庫-台中,2024-02-21,1021
3481,群創,162,77,85,合庫-台中,2024-02-21,1021
2609,陽明,129,47,82,合庫-台中,2024-02-21,1021
00632R,元大台灣50反1,70,0,70,合庫-台中,2024-02-21,1021
2605,新興,324,255,69,合庫-台中,2024-02-21,1021
00772B,中信高評級公司債,68,0,68,合庫-台中,2024-02-21,1021
2201,裕隆,68,0,68,合庫-台中,2024-02-21,1021
00688L,國泰20年美債正2,66,0,66,合庫-台中,2024-02-21,1021
8096,擎亞,71,8,63,合庫-台中,2024-02-21,1021
2303,聯電,79,17,62,合庫-台中,2024-02-21,1021
00687B,國泰20年美債,59,0,59,合庫-台中,2024-02-21,1021
6120,達運,55,0,55,合庫-台中,2024-02-21,1021
00679B,元大美債20年,60,5,55,合庫-台中,2024-02-21,1021
2301,光寶科,57,6,51,合庫-台中,2024-02-21,1021
2610,華航,70,20,50,合庫-台中,2024-02-21,1021
3231,緯創,138,89,49,合庫-台中,2024-02-21,1021
2332,友訊,47,0,47,合庫-台中,2024-02-21,1021
2882,國泰金,43,0,43,合庫-台中,2024-02-21,1021
6770,力積電,44,2,42,合庫-台中,2024-02-21,1021
00680L,元大美債20正2,42,0,42,合庫-台中,2024-02-21,1021
00753L,中信中國50正2,123,82,41,合庫-台中,2024-02-21,1021
2457,飛宏,55,16,39,合庫-台中,2024-02-21,1021
2330,台積電,45,7,38,合庫-台中,2024-02-21,1021
1316,上曜,245,207,38,合庫-台中,2024-02-21,1021
2515,中工,40,6,34,合庫-台中,2024-02-21,1021
3035,智原,53,20,33,合庫-台中,2024-02-21,1021
00891,中信關鍵半導體,33,0,33,合庫-台中,2024-02-21,1021
1524,耿鼎,34,2,32,合庫-台中,2024-02-21,1021
3437,榮創,34,2,32,合庫-台中,2024-02-21,1021
00670L,富邦NASDAQ正2,31,1,30,合庫-台中,2024-02-21,1021
3715,定穎投控,40,11,29,合庫-台中,2024-02-21,1021
2462,良得電,30,3,27,合庫-台中,2024-02-21,1021
00918,大華優利高填息30,26,0,26,合庫-台中,2024-02-21,1021
9933,中鼎,26,1,25,合庫-台中,2024-02-21,1021
1219,福壽,25,0,25,合庫-台中,2024-02-21,1021
5426,振發,55,30,25,合庫-台中,2024-02-21,1021
3362,先進光,38,13,25,合庫-台中,2024-02-21,1021
2367,燿華,25,1,24,合庫-台中,2024-02-21,1021
2014,中鴻,24,0,24,合庫-台中,2024-02-21,1021
6733,博晟生醫,23,0,23,合庫-台中,2024-02-21,1021
5519,隆大,22,0,22,合庫-台中,2024-02-21,1021
3520,華盈,22,0,22,合庫-台中,2024-02-21,1021
00665L,富邦�琤肭磪囓�2,1119,44,1075,合庫-台中,2024-02-22,1021
00937B,群益ESG投等債20,261,3,258,合庫-台中,2024-02-22,1021
2371,大同,294,88,206,合庫-台中,2024-02-22,1021
1316,上曜,178,7,171,合庫-台中,2024-02-22,1021
1503,士電,222,71,151,合庫-台中,2024-02-22,1021
00673R,期元大S＆P原油反1,127,0,127,合庫-台中,2024-02-22,1021
2356,英業達,238,119,119,合庫-台中,2024-02-22,1021
2353,宏��,150,48,102,合庫-台中,2024-02-22,1021
00679B,元大美債20年,114,18,96,合庫-台中,2024-02-22,1021
2606,裕民,104,9,95,合庫-台中,2024-02-22,1021
3362,先進光,116,28,88,合庫-台中,2024-02-22,1021
3234,光環,77,1,76,合庫-台中,2024-02-22,1021
00933B,國泰10Y+金融債,70,0,70,合庫-台中,2024-02-22,1021
00878,國泰永續高股息,85,25,60,合庫-台中,2024-02-22,1021
3693,營邦,60,0,60,合庫-台中,2024-02-22,1021
00706L,期元大S＆P日圓正2,55,0,55,合庫-台中,2024-02-22,1021
3231,緯創,136,86,50,合庫-台中,2024-02-22,1021
1514,亞力,63,20,43,合庫-台中,2024-02-22,1021
1524,耿鼎,51,10,41,合庫-台中,2024-02-22,1021
2537,聯上發,41,0,41,合庫-台中,2024-02-22,1021
5498,凱崴,42,4,38,合庫-台中,2024-02-22,1021
1515,力山,54,16,38,合庫-台中,2024-02-22,1021
2313,華通,173,138,35,合庫-台中,2024-02-22,1021
00712,復華富時不動產,35,1,34,合庫-台中,2024-02-22,1021
00931B,統一美債20年,33,0,33,合庫-台中,2024-02-22,1021
00650L,復華香港正2,32,0,32,合庫-台中,2024-02-22,1021
3213,茂訊,32,1,31,合庫-台中,2024-02-22,1021
00795B,中信美國公債20年,37,6,31,合庫-台中,2024-02-22,1021
6179,亞通,33,4,29,合庫-台中,2024-02-22,1021
6770,力積電,32,3,29,合庫-台中,2024-02-22,1021
2610,華航,65,38,27,合庫-台中,2024-02-22,1021
6233,旺玖,72,45,27,合庫-台中,2024-02-22,1021
2421,建準,59,32,27,合庫-台中,2024-02-22,1021
00687B,國泰20年美債,46,20,26,合庫-台中,2024-02-22,1021
8936,國統,35,10,25,合庫-台中,2024-02-22,1021
6164,華興,31,6,25,合庫-台中,2024-02-22,1021
4956,光鋐,25,1,24,合庫-台中,2024-02-22,1021
2312,金寶,23,0,23,合庫-台中,2024-02-22,1021
3041,揚智,93,70,23,合庫-台中,2024-02-22,1021
3228,金麗科,23,2,21,合庫-台中,2024-02-22,1021
4111,濟生,21,0,21,合庫-台中,2024-02-22,1021
1455,集盛,21,0,21,合庫-台中,2024-02-22,1021
6419,京晨科,21,0,21,合庫-台中,2024-02-22,1021
6505,台塑化,20,0,20,合庫-台中,2024-02-22,1021
6134,萬旭,20,0,20,合庫-台中,2024-02-22,1021
8093,保銳,20,0,20,合庫-台中,2024-02-22,1021
3689,湧德,32,12,20,合庫-台中,2024-02-22,1021
9103,美德醫療-DR,20,0,20,合庫-台中,2024-02-22,1021
8215,明基材,20,0,20,合庫-台中,2024-02-22,1021
00637L,元大滬深300正2,289,270,19,合庫-台中,2024-02-22,1021
00933B,國泰10Y+金融債,1111,23,1088,合庫-台中,2024-02-23,1021
6282,康舒,244,3,241,合庫-台中,2024-02-23,1021
1504,東元,109,9,100,合庫-台中,2024-02-23,1021
00679B,元大美債20年,105,10,95,合庫-台中,2024-02-23,1021
00937B,群益ESG投等債20,118,33,85,合庫-台中,2024-02-23,1021
00687B,國泰20年美債,91,13,78,合庫-台中,2024-02-23,1021
1503,士電,267,196,71,合庫-台中,2024-02-23,1021
2408,南亞科,68,0,68,合庫-台中,2024-02-23,1021
3231,緯創,139,71,68,合庫-台中,2024-02-23,1021
3047,訊舟,75,8,67,合庫-台中,2024-02-23,1021
2062,橋椿,66,0,66,合庫-台中,2024-02-23,1021
8064,東捷,143,78,65,合庫-台中,2024-02-23,1021
1303,南亞,66,2,64,合庫-台中,2024-02-23,1021
2353,宏��,93,30,63,合庫-台中,2024-02-23,1021
6419,京晨科,80,19,61,合庫-台中,2024-02-23,1021
2609,陽明,200,141,59,合庫-台中,2024-02-23,1021
2884,玉山金,58,0,58,合庫-台中,2024-02-23,1021
3005,神基,71,14,57,合庫-台中,2024-02-23,1021
5272,笙科,57,1,56,合庫-台中,2024-02-23,1021
00900,富邦特選高股息30,57,2,55,合庫-台中,2024-02-23,1021
00680L,元大美債20正2,53,0,53,合庫-台中,2024-02-23,1021
2208,台船,51,0,51,合庫-台中,2024-02-23,1021
2303,聯電,60,10,50,合庫-台中,2024-02-23,1021
00673R,期元大S＆P原油反1,50,0,50,合庫-台中,2024-02-23,1021
6207,雷科,62,13,49,合庫-台中,2024-02-23,1021
2376,技嘉,91,43,48,合庫-台中,2024-02-23,1021
3234,光環,93,47,46,合庫-台中,2024-02-23,1021
5340,建榮,45,0,45,合庫-台中,2024-02-23,1021
4111,濟生,44,0,44,合庫-台中,2024-02-23,1021
2331,精英,46,3,43,合庫-台中,2024-02-23,1021
3221,台嘉碩,77,34,43,合庫-台中,2024-02-23,1021
3450,聯鈞,66,25,41,合庫-台中,2024-02-23,1021
3360,尚立,42,2,40,合庫-台中,2024-02-23,1021
00637L,元大滬深300正2,192,153,39,合庫-台中,2024-02-23,1021
3516,亞帝歐,41,3,38,合庫-台中,2024-02-23,1021
6530,創威,43,6,37,合庫-台中,2024-02-23,1021
2601,益航,40,3,37,合庫-台中,2024-02-23,1021
2105,正新,35,0,35,合庫-台中,2024-02-23,1021
6113,亞矽,47,14,33,合庫-台中,2024-02-23,1021
6141,柏承,36,7,29,合庫-台中,2024-02-23,1021
3715,定穎投控,39,10,29,合庫-台中,2024-02-23,1021
5426,振發,32,3,29,合庫-台中,2024-02-23,1021
3689,湧德,34,5,29,合庫-台中,2024-02-23,1021
2610,華航,68,41,27,合庫-台中,2024-02-23,1021
00712,復華富時不動產,34,9,25,合庫-台中,2024-02-23,1021
00918,大華優利高填息30,41,16,25,合庫-台中,2024-02-23,1021
6770,力積電,23,0,23,合庫-台中,2024-02-23,1021
5315,光聯,23,0,23,合庫-台中,2024-02-23,1021
2637,慧洋-KY,23,0,23,合庫-台中,2024-02-23,1021
2634,漢翔,32,10,22,合庫-台中,2024-02-23,1021
2301,光寶科,522,7,515,合庫-台中,2024-02-26,1021
00937B,群益ESG投等債20,467,126,341,合庫-台中,2024-02-26,1021
00878,國泰永續高股息,301,24,277,合庫-台中,2024-02-26,1021
2884,玉山金,218,3,215,合庫-台中,2024-02-26,1021
00715L,期街口布蘭特正2,256,67,189,合庫-台中,2024-02-26,1021
2356,英業達,148,23,125,合庫-台中,2024-02-26,1021
00933B,國泰10Y+金融債,186,71,115,合庫-台中,2024-02-26,1021
00919,群益台灣精選高息,166,52,114,合庫-台中,2024-02-26,1021
00637L,元大滬深300正2,300,207,93,合庫-台中,2024-02-26,1021
00632R,元大台灣50反1,86,0,86,合庫-台中,2024-02-26,1021
3231,緯創,137,59,78,合庫-台中,2024-02-26,1021
2329,華泰,150,78,72,合庫-台中,2024-02-26,1021
1514,亞力,263,193,70,合庫-台中,2024-02-26,1021
6419,京晨科,83,20,63,合庫-台中,2024-02-26,1021
00687B,國泰20年美債,89,26,63,合庫-台中,2024-02-26,1021
1503,士電,129,68,61,合庫-台中,2024-02-26,1021
00655L,國泰中國A50正2,50,0,50,合庫-台中,2024-02-26,1021
1717,長興,99,50,49,合庫-台中,2024-02-26,1021
2610,華航,65,16,49,合庫-台中,2024-02-26,1021
2547,日勝生,50,5,45,合庫-台中,2024-02-26,1021
2495,普安,65,22,43,合庫-台中,2024-02-26,1021
3481,群創,112,70,42,合庫-台中,2024-02-26,1021
00665L,富邦�琤肭磪囓�2,189,149,40,合庫-台中,2024-02-26,1021
3516,亞帝歐,39,0,39,合庫-台中,2024-02-26,1021
1608,華榮,52,16,36,合庫-台中,2024-02-26,1021
8086,宏捷科,36,2,34,合庫-台中,2024-02-26,1021
2867,三商壽,31,0,31,合庫-台中,2024-02-26,1021
9105,泰金寶-DR,30,0,30,合庫-台中,2024-02-26,1021
2601,益航,30,0,30,合庫-台中,2024-02-26,1021
8040,九暘,45,15,30,合庫-台中,2024-02-26,1021
00670L,富邦NASDAQ正2,37,8,29,合庫-台中,2024-02-26,1021
2312,金寶,45,16,29,合庫-台中,2024-02-26,1021
00712,復華富時不動產,28,1,27,合庫-台中,2024-02-26,1021
6274,台燿,48,21,27,合庫-台中,2024-02-26,1021
2405,輔信,109,83,26,合庫-台中,2024-02-26,1021
2376,技嘉,52,27,25,合庫-台中,2024-02-26,1021
00882,中信中國高股息,37,13,24,合庫-台中,2024-02-26,1021
2337,旺宏,28,5,23,合庫-台中,2024-02-26,1021
2258,鴻華先進-創,23,0,23,合庫-台中,2024-02-26,1021
9136,巨騰-DR,23,0,23,合庫-台中,2024-02-26,1021
00690,兆豐藍籌30,23,0,23,合庫-台中,2024-02-26,1021
2489,瑞軒,37,14,23,合庫-台中,2024-02-26,1021
00633L,富邦上証正2,22,0,22,合庫-台中,2024-02-26,1021
6168,宏齊,32,10,22,合庫-台中,2024-02-26,1021
5210,寶碩,22,0,22,合庫-台中,2024-02-26,1021
00918,大華優利高填息30,21,1,20,合庫-台中,2024-02-26,1021
00929,復華台灣科技優息,173,154,19,合庫-台中,2024-02-26,1021
6189,豐藝,23,4,19,合庫-台中,2024-02-26,1021
2888,新光金,21,3,18,合庫-台中,2024-02-26,1021
1101,台泥,20,2,18,合庫-台中,2024-02-26,1021
00937B,群益ESG投等債20,562,2,560,合庫-台中,2024-02-27,1021
00878,國泰永續高股息,292,56,236,合庫-台中,2024-02-27,1021
8096,擎亞,179,41,138,合庫-台中,2024-02-27,1021
2002,中鋼,109,3,106,合庫-台中,2024-02-27,1021
9902,台火,92,0,92,合庫-台中,2024-02-27,1021
6419,京晨科,98,8,90,合庫-台中,2024-02-27,1021
2888,新光金,120,31,89,合庫-台中,2024-02-27,1021
2834,臺企銀,113,27,86,合庫-台中,2024-02-27,1021
2498,宏達電,106,24,82,合庫-台中,2024-02-27,1021
3213,茂訊,77,0,77,合庫-台中,2024-02-27,1021
00712,復華富時不動產,90,27,63,合庫-台中,2024-02-27,1021
00933B,國泰10Y+金融債,76,13,63,合庫-台中,2024-02-27,1021
5272,笙科,67,5,62,合庫-台中,2024-02-27,1021
00687B,國泰20年美債,77,20,57,合庫-台中,2024-02-27,1021
00655L,國泰中國A50正2,50,2,48,合庫-台中,2024-02-27,1021
2329,華泰,123,78,45,合庫-台中,2024-02-27,1021
2634,漢翔,57,14,43,合庫-台中,2024-02-27,1021
1504,東元,46,10,36,合庫-台中,2024-02-27,1021
0056,元大高股息,44,8,36,合庫-台中,2024-02-27,1021
2408,南亞科,97,64,33,合庫-台中,2024-02-27,1021
00637L,元大滬深300正2,292,260,32,合庫-台中,2024-02-27,1021
5512,力麒,30,0,30,合庫-台中,2024-02-27,1021
3163,波若威,87,57,30,合庫-台中,2024-02-27,1021
2363,矽統,185,156,29,合庫-台中,2024-02-27,1021
1711,永光,64,36,28,合庫-台中,2024-02-27,1021
1717,長興,34,7,27,合庫-台中,2024-02-27,1021
1815,富喬,29,3,26,合庫-台中,2024-02-27,1021
6290,良維,37,12,25,合庫-台中,2024-02-27,1021
6164,華興,25,0,25,合庫-台中,2024-02-27,1021
00720B,元大投資級公司債,33,10,23,合庫-台中,2024-02-27,1021
00927,群益半導體收益,23,0,23,合庫-台中,2024-02-27,1021
2610,華航,47,25,22,合庫-台中,2024-02-27,1021
9904,寶成,22,0,22,合庫-台中,2024-02-27,1021
2492,華新科,23,1,22,合庫-台中,2024-02-27,1021
2312,金寶,22,0,22,合庫-台中,2024-02-27,1021
2301,光寶科,57,36,21,合庫-台中,2024-02-27,1021
4967,十銓,23,2,21,合庫-台中,2024-02-27,1021
1101,台泥,27,6,21,合庫-台中,2024-02-27,1021
2409,友達,75,54,21,合庫-台中,2024-02-27,1021
8210,勤誠,24,3,21,合庫-台中,2024-02-27,1021
6125,廣運,48,28,20,合庫-台中,2024-02-27,1021
2462,良得電,20,0,20,合庫-台中,2024-02-27,1021
2382,廣達,45,25,20,合庫-台中,2024-02-27,1021
2332,友訊,21,2,19,合庫-台中,2024-02-27,1021
1514,亞力,47,28,19,合庫-台中,2024-02-27,1021
1316,上曜,40,22,18,合庫-台中,2024-02-27,1021
6141,柏承,24,6,18,合庫-台中,2024-02-27,1021
6485,點序,18,0,18,合庫-台中,2024-02-27,1021
1303,南亞,18,1,17,合庫-台中,2024-02-27,1021
6770,力積電,33,16,17,合庫-台中,2024-02-27,1021
6282,康舒,584,188,396,合庫-台中,2024-02-29,1021
00680L,元大美債20正2,231,2,229,合庫-台中,2024-02-29,1021
00937B,群益ESG投等債20,417,194,223,合庫-台中,2024-02-29,1021
00650L,復華香港正2,260,51,209,合庫-台中,2024-02-29,1021
00632R,元大台灣50反1,206,10,196,合庫-台中,2024-02-29,1021
2888,新光金,183,20,163,合庫-台中,2024-02-29,1021
00673R,期元大S＆P原油反1,151,0,151,合庫-台中,2024-02-29,1021
2812,台中銀,160,29,131,合庫-台中,2024-02-29,1021
00929,復華台灣科技優息,308,184,124,合庫-台中,2024-02-29,1021
2353,宏��,127,10,117,合庫-台中,2024-02-29,1021
8096,擎亞,118,5,113,合庫-台中,2024-02-29,1021
00687B,國泰20年美債,131,22,109,合庫-台中,2024-02-29,1021
00665L,富邦�琤肭磪囓�2,484,378,106,合庫-台中,2024-02-29,1021
00679B,元大美債20年,70,1,69,合庫-台中,2024-02-29,1021
1513,中興電,116,60,56,合庫-台中,2024-02-29,1021
00919,群益台灣精選高息,115,66,49,合庫-台中,2024-02-29,1021
00933B,國泰10Y+金融債,50,1,49,合庫-台中,2024-02-29,1021
1717,長興,51,2,49,合庫-台中,2024-02-29,1021
3028,增你強,46,0,46,合庫-台中,2024-02-29,1021
00891,中信關鍵半導體,61,18,43,合庫-台中,2024-02-29,1021
2836,高雄銀,43,0,43,合庫-台中,2024-02-29,1021
2329,華泰,139,98,41,合庫-台中,2024-02-29,1021
1725,元禎,41,0,41,合庫-台中,2024-02-29,1021
1314,中石化,53,13,40,合庫-台中,2024-02-29,1021
00751B,元大AAA至A公司債,37,0,37,合庫-台中,2024-02-29,1021
8926,台汽電,71,36,35,合庫-台中,2024-02-29,1021
00688L,國泰20年美債正2,40,5,35,合庫-台中,2024-02-29,1021
00753L,中信中國50正2,40,5,35,合庫-台中,2024-02-29,1021
1514,亞力,136,101,35,合庫-台中,2024-02-29,1021
1528,恩德,35,0,35,合庫-台中,2024-02-29,1021
1101,台泥,33,0,33,合庫-台中,2024-02-29,1021
5880,合庫金,44,12,32,合庫-台中,2024-02-29,1021
2421,建準,49,17,32,合庫-台中,2024-02-29,1021
3213,茂訊,29,0,29,合庫-台中,2024-02-29,1021
1618,合機,50,22,28,合庫-台中,2024-02-29,1021
6901,鑽石投資,27,2,25,合庫-台中,2024-02-29,1021
2062,橋椿,54,29,25,合庫-台中,2024-02-29,1021
3231,緯創,82,58,24,合庫-台中,2024-02-29,1021
2838,聯邦銀,34,10,24,合庫-台中,2024-02-29,1021
3390,旭軟,33,11,22,合庫-台中,2024-02-29,1021
6165,浪凡,23,1,22,合庫-台中,2024-02-29,1021
6419,京晨科,28,7,21,合庫-台中,2024-02-29,1021
2489,瑞軒,21,0,21,合庫-台中,2024-02-29,1021
6270,倍微,22,1,21,合庫-台中,2024-02-29,1021
5487,通泰,20,0,20,合庫-台中,2024-02-29,1021
00706L,期元大S＆P日圓正2,20,0,20,合庫-台中,2024-02-29,1021
4908,前鼎,24,5,19,合庫-台中,2024-02-29,1021
1815,富喬,67,48,19,合庫-台中,2024-02-29,1021
6120,達運,20,2,18,合庫-台中,2024-02-29,1021
2382,廣達,30,13,17,合庫-台中,2024-02-29,1021
00937B,群益ESG投等債20,763,61,702,合庫-台中,2024-03-01,1021
00919,群益台灣精選高息,493,30,463,合庫-台中,2024-03-01,1021
1605,華新,206,1,205,合庫-台中,2024-03-01,1021
2812,台中銀,207,32,175,合庫-台中,2024-03-01,1021
00933B,國泰10Y+金融債,129,11,118,合庫-台中,2024-03-01,1021
6282,康舒,205,96,109,合庫-台中,2024-03-01,1021
1504,東元,112,8,104,合庫-台中,2024-03-01,1021
00882,中信中國高股息,120,19,101,合庫-台中,2024-03-01,1021
00650L,復華香港正2,300,200,100,合庫-台中,2024-03-01,1021
00665L,富邦�琤肭磪囓�2,442,346,96,合庫-台中,2024-03-01,1021
00918,大華優利高填息30,102,18,84,合庫-台中,2024-03-01,1021
4908,前鼎,81,4,77,合庫-台中,2024-03-01,1021
5310,天剛,70,0,70,合庫-台中,2024-03-01,1021
3516,亞帝歐,69,0,69,合庫-台中,2024-03-01,1021
1513,中興電,244,176,68,合庫-台中,2024-03-01,1021
2002,中鋼,87,20,67,合庫-台中,2024-03-01,1021
2409,友達,81,21,60,合庫-台中,2024-03-01,1021
3372,典範,75,22,53,合庫-台中,2024-03-01,1021
00720B,元大投資級公司債,47,0,47,合庫-台中,2024-03-01,1021
1717,長興,46,1,45,合庫-台中,2024-03-01,1021
2615,萬海,46,2,44,合庫-台中,2024-03-01,1021
00632R,元大台灣50反1,40,0,40,合庫-台中,2024-03-01,1021
2204,中華,40,1,39,合庫-台中,2024-03-01,1021
2317,鴻海,55,17,38,合庫-台中,2024-03-01,1021
9902,台火,38,0,38,合庫-台中,2024-03-01,1021
3062,建漢,40,2,38,合庫-台中,2024-03-01,1021
8926,台汽電,46,14,32,合庫-台中,2024-03-01,1021
3498,陽程,31,0,31,合庫-台中,2024-03-01,1021
3036,文曄,53,23,30,合庫-台中,2024-03-01,1021
1727,中華化,37,7,30,合庫-台中,2024-03-01,1021
8105,凌巨,39,9,30,合庫-台中,2024-03-01,1021
6116,彩晶,30,0,30,合庫-台中,2024-03-01,1021
2371,大同,108,78,30,合庫-台中,2024-03-01,1021
1432,大魯閣,31,2,29,合庫-台中,2024-03-01,1021
1609,大亞,62,33,29,合庫-台中,2024-03-01,1021
3321,同泰,28,0,28,合庫-台中,2024-03-01,1021
2618,長榮航,26,0,26,合庫-台中,2024-03-01,1021
9907,統一實,25,0,25,合庫-台中,2024-03-01,1021
6112,邁達特,26,2,24,合庫-台中,2024-03-01,1021
00679B,元大美債20年,25,2,23,合庫-台中,2024-03-01,1021
3481,群創,149,127,22,合庫-台中,2024-03-01,1021
00751B,元大AAA至A公司債,25,4,21,合庫-台中,2024-03-01,1021
3714,富采,21,0,21,合庫-台中,2024-03-01,1021
2489,瑞軒,23,2,21,合庫-台中,2024-03-01,1021
1444,力麗,80,60,20,合庫-台中,2024-03-01,1021
2492,華新科,21,1,20,合庫-台中,2024-03-01,1021
00633L,富邦上証正2,30,10,20,合庫-台中,2024-03-01,1021
6270,倍微,20,0,20,合庫-台中,2024-03-01,1021
6733,博晟生醫,20,0,20,合庫-台中,2024-03-01,1021
2495,普安,19,0,19,合庫-台中,2024-03-01,1021
00937B,群益ESG投等債20,2526,10,2516,合庫-台中,2024-03-04,1021
00637L,元大滬深300正2,850,61,789,合庫-台中,2024-03-04,1021
00919,群益台灣精選高息,390,146,244,合庫-台中,2024-03-04,1021
00918,大華優利高填息30,270,32,238,合庫-台中,2024-03-04,1021
2834,臺企銀,213,10,203,合庫-台中,2024-03-04,1021
00673R,期元大S＆P原油反1,177,0,177,合庫-台中,2024-03-04,1021
2324,仁寶,312,192,120,合庫-台中,2024-03-04,1021
2812,台中銀,144,39,105,合庫-台中,2024-03-04,1021
00655L,國泰中國A50正2,130,30,100,合庫-台中,2024-03-04,1021
3062,建漢,110,11,99,合庫-台中,2024-03-04,1021
3042,晶技,106,14,92,合庫-台中,2024-03-04,1021
00664R,國泰臺灣加權反1,100,9,91,合庫-台中,2024-03-04,1021
2002,中鋼,107,25,82,合庫-台中,2024-03-04,1021
00857B,永豐20年美公債,63,0,63,合庫-台中,2024-03-04,1021
1444,力麗,60,0,60,合庫-台中,2024-03-04,1021
2405,輔信,62,9,53,合庫-台中,2024-03-04,1021
00688L,國泰20年美債正2,67,23,44,合庫-台中,2024-03-04,1021
00712,復華富時不動產,43,0,43,合庫-台中,2024-03-04,1021
6179,亞通,44,1,43,合庫-台中,2024-03-04,1021
00715L,期街口布蘭特正2,50,7,43,合庫-台中,2024-03-04,1021
00632R,元大台灣50反1,102,63,39,合庫-台中,2024-03-04,1021
1717,長興,42,3,39,合庫-台中,2024-03-04,1021
00680L,元大美債20正2,59,20,39,合庫-台中,2024-03-04,1021
1513,中興電,102,65,37,合庫-台中,2024-03-04,1021
5488,松普,43,7,36,合庫-台中,2024-03-04,1021
6161,捷波,36,0,36,合庫-台中,2024-03-04,1021
6026,福邦證,35,0,35,合庫-台中,2024-03-04,1021
5452,佶優,57,23,34,合庫-台中,2024-03-04,1021
2409,友達,66,34,32,合庫-台中,2024-03-04,1021
1582,信錦,35,4,31,合庫-台中,2024-03-04,1021
00679B,元大美債20年,35,5,30,合庫-台中,2024-03-04,1021
00650L,復華香港正2,80,50,30,合庫-台中,2024-03-04,1021
2303,聯電,82,52,30,合庫-台中,2024-03-04,1021
2486,一詮,30,1,29,合庫-台中,2024-03-04,1021
6120,達運,32,3,29,合庫-台中,2024-03-04,1021
1305,華夏,30,1,29,合庫-台中,2024-03-04,1021
3005,神基,99,71,28,合庫-台中,2024-03-04,1021
9103,美德醫療-DR,28,0,28,合庫-台中,2024-03-04,1021
3624,光頡,28,0,28,合庫-台中,2024-03-04,1021
00935,野村臺灣新科技50,28,1,27,合庫-台中,2024-03-04,1021
2482,連宇,27,0,27,合庫-台中,2024-03-04,1021
6770,力積電,39,12,27,合庫-台中,2024-03-04,1021
1815,富喬,42,16,26,合庫-台中,2024-03-04,1021
3034,聯詠,26,1,25,合庫-台中,2024-03-04,1021
1316,上曜,45,21,24,合庫-台中,2024-03-04,1021
3390,旭軟,32,8,24,合庫-台中,2024-03-04,1021
3321,同泰,25,1,24,合庫-台中,2024-03-04,1021
2836,高雄銀,24,0,24,合庫-台中,2024-03-04,1021
1313,聯成,23,0,23,合庫-台中,2024-03-04,1021
6275,元山,24,1,23,合庫-台中,2024-03-04,1021
2317,鴻海,541,53,488,合庫-台中,2024-03-05,1021
2888,新光金,386,14,372,合庫-台中,2024-03-05,1021
00632R,元大台灣50反1,511,150,361,合庫-台中,2024-03-05,1021
00937B,群益ESG投等債20,353,3,350,合庫-台中,2024-03-05,1021
00919,群益台灣精選高息,464,162,302,合庫-台中,2024-03-05,1021
00650L,復華香港正2,553,252,301,合庫-台中,2024-03-05,1021
00882,中信中國高股息,215,25,190,合庫-台中,2024-03-05,1021
2409,友達,252,74,178,合庫-台中,2024-03-05,1021
00712,復華富時不動產,174,3,171,合庫-台中,2024-03-05,1021
1605,華新,134,9,125,合庫-台中,2024-03-05,1021
1409,新纖,117,12,105,合庫-台中,2024-03-05,1021
2313,華通,262,158,104,合庫-台中,2024-03-05,1021
2340,台亞,105,4,101,合庫-台中,2024-03-05,1021
00664R,國泰臺灣加權反1,100,0,100,合庫-台中,2024-03-05,1021
3062,建漢,135,47,88,合庫-台中,2024-03-05,1021
2002,中鋼,94,10,84,合庫-台中,2024-03-05,1021
00665L,富邦�琤肭磪囓�2,405,327,78,合庫-台中,2024-03-05,1021
8054,安國,89,17,72,合庫-台中,2024-03-05,1021
00680L,元大美債20正2,63,1,62,合庫-台中,2024-03-05,1021
2208,台船,60,0,60,合庫-台中,2024-03-05,1021
00637L,元大滬深300正2,522,463,59,合庫-台中,2024-03-05,1021
00679B,元大美債20年,60,1,59,合庫-台中,2024-03-05,1021
00933B,國泰10Y+金融債,70,13,57,合庫-台中,2024-03-05,1021
3481,群創,106,50,56,合庫-台中,2024-03-05,1021
4961,天鈺,55,1,54,合庫-台中,2024-03-05,1021
2367,燿華,159,106,53,合庫-台中,2024-03-05,1021
2485,兆赫,51,1,50,合庫-台中,2024-03-05,1021
4906,正文,103,58,45,合庫-台中,2024-03-05,1021
8163,達方,64,20,44,合庫-台中,2024-03-05,1021
6163,華電網,52,11,41,合庫-台中,2024-03-05,1021
2324,仁寶,59,19,40,合庫-台中,2024-03-05,1021
2344,華邦電,43,3,40,合庫-台中,2024-03-05,1021
1101,台泥,43,3,40,合庫-台中,2024-03-05,1021
8401,白紗科,43,4,39,合庫-台中,2024-03-05,1021
2337,旺宏,39,2,37,合庫-台中,2024-03-05,1021
6227,茂綸,32,0,32,合庫-台中,2024-03-05,1021
2312,金寶,32,0,32,合庫-台中,2024-03-05,1021
2457,飛宏,31,0,31,合庫-台中,2024-03-05,1021
2610,華航,33,2,31,合庫-台中,2024-03-05,1021
2338,光罩,30,0,30,合庫-台中,2024-03-05,1021
1725,元禎,55,25,30,合庫-台中,2024-03-05,1021
00915,凱基優選高股息30,32,2,30,合庫-台中,2024-03-05,1021
2609,陽明,58,29,29,合庫-台中,2024-03-05,1021
3011,今皓,28,0,28,合庫-台中,2024-03-05,1021
4908,前鼎,36,9,27,合庫-台中,2024-03-05,1021
6419,京晨科,32,5,27,合庫-台中,2024-03-05,1021
3006,晶豪科,37,10,27,合庫-台中,2024-03-05,1021
00715L,期街口布蘭特正2,31,5,26,合庫-台中,2024-03-05,1021
2316,楠梓電,34,9,25,合庫-台中,2024-03-05,1021
6125,廣運,41,16,25,合庫-台中,2024-03-05,1021
4716,大立,518,0,518,合庫-台中,2024-03-06,1021
00919,群益台灣精選高息,746,251,495,合庫-台中,2024-03-06,1021
00918,大華優利高填息30,400,44,356,合庫-台中,2024-03-06,1021
00937B,群益ESG投等債20,347,81,266,合庫-台中,2024-03-06,1021
00712,復華富時不動產,261,9,252,合庫-台中,2024-03-06,1021
00632R,元大台灣50反1,241,50,191,合庫-台中,2024-03-06,1021
6207,雷科,151,4,147,合庫-台中,2024-03-06,1021
2313,華通,275,144,131,合庫-台中,2024-03-06,1021
00688L,國泰20年美債正2,200,80,120,合庫-台中,2024-03-06,1021
2206,三陽工業,105,14,91,合庫-台中,2024-03-06,1021
3213,茂訊,83,1,82,合庫-台中,2024-03-06,1021
1409,新纖,83,8,75,合庫-台中,2024-03-06,1021
00715L,期街口布蘭特正2,99,24,75,合庫-台中,2024-03-06,1021
00915,凱基優選高股息30,76,11,65,合庫-台中,2024-03-06,1021
1102,亞泥,60,0,60,合庫-台中,2024-03-06,1021
8011,台通,94,36,58,合庫-台中,2024-03-06,1021
3231,緯創,79,22,57,合庫-台中,2024-03-06,1021
4768,晶呈科技,52,0,52,合庫-台中,2024-03-06,1021
6117,迎廣,178,126,52,合庫-台中,2024-03-06,1021
2610,華航,89,43,46,合庫-台中,2024-03-06,1021
2002,中鋼,63,17,46,合庫-台中,2024-03-06,1021
3013,晟銘電,107,65,42,合庫-台中,2024-03-06,1021
8092,建暐,44,2,42,合庫-台中,2024-03-06,1021
3481,群創,126,85,41,合庫-台中,2024-03-06,1021
2352,佳世達,52,12,40,合庫-台中,2024-03-06,1021
8401,白紗科,42,2,40,合庫-台中,2024-03-06,1021
6770,力積電,40,5,35,合庫-台中,2024-03-06,1021
3071,協禧,40,6,34,合庫-台中,2024-03-06,1021
1717,長興,38,6,32,合庫-台中,2024-03-06,1021
2353,宏��,36,5,31,合庫-台中,2024-03-06,1021
3694,海華,34,3,31,合庫-台中,2024-03-06,1021
1513,中興電,173,143,30,合庫-台中,2024-03-06,1021
4303,信立,30,1,29,合庫-台中,2024-03-06,1021
3042,晶技,33,4,29,合庫-台中,2024-03-06,1021
00857B,永豐20年美公債,25,0,25,合庫-台中,2024-03-06,1021
6160,欣技,24,0,24,合庫-台中,2024-03-06,1021
2634,漢翔,28,4,24,合庫-台中,2024-03-06,1021
2836,高雄銀,31,7,24,合庫-台中,2024-03-06,1021
5388,中磊,24,1,23,合庫-台中,2024-03-06,1021
3062,建漢,45,22,23,合庫-台中,2024-03-06,1021
1727,中華化,33,10,23,合庫-台中,2024-03-06,1021
8163,達方,25,2,23,合庫-台中,2024-03-06,1021
2892,第一金,25,2,23,合庫-台中,2024-03-06,1021
6533,晶心科,29,7,22,合庫-台中,2024-03-06,1021
2388,威盛,28,6,22,合庫-台中,2024-03-06,1021
9907,統一實,21,0,21,合庫-台中,2024-03-06,1021
2338,光罩,22,1,21,合庫-台中,2024-03-06,1021
00687B,國泰20年美債,58,37,21,合庫-台中,2024-03-06,1021
6591,動力-KY,24,3,21,合庫-台中,2024-03-06,1021
2609,陽明,33,12,21,合庫-台中,2024-03-06,1021
00632R,元大台灣50反1,1073,4,1069,合庫-台中,2024-03-07,1021
00937B,群益ESG投等債20,331,47,284,合庫-台中,2024-03-07,1021
2834,臺企銀,300,73,227,合庫-台中,2024-03-07,1021
2888,新光金,206,3,203,合庫-台中,2024-03-07,1021
3231,緯創,221,47,174,合庫-台中,2024-03-07,1021
00679B,元大美債20年,208,35,173,合庫-台中,2024-03-07,1021
1316,上曜,235,101,134,合庫-台中,2024-03-07,1021
3013,晟銘電,432,308,124,合庫-台中,2024-03-07,1021
1409,新纖,119,2,117,合庫-台中,2024-03-07,1021
2367,燿華,211,111,100,合庫-台中,2024-03-07,1021
2890,永豐金,105,10,95,合庫-台中,2024-03-07,1021
1713,國化,90,0,90,合庫-台中,2024-03-07,1021
4961,天鈺,85,0,85,合庫-台中,2024-03-07,1021
2368,金像電,88,22,66,合庫-台中,2024-03-07,1021
2353,宏��,67,8,59,合庫-台中,2024-03-07,1021
2206,三陽工業,58,4,54,合庫-台中,2024-03-07,1021
2324,仁寶,104,52,52,合庫-台中,2024-03-07,1021
3294,英濟,78,26,52,合庫-台中,2024-03-07,1021
2421,建準,123,73,50,合庫-台中,2024-03-07,1021
2365,昆盈,47,0,47,合庫-台中,2024-03-07,1021
00915,凱基優選高股息30,53,7,46,合庫-台中,2024-03-07,1021
2208,台船,45,1,44,合庫-台中,2024-03-07,1021
3042,晶技,55,11,44,合庫-台中,2024-03-07,1021
1616,億泰,43,0,43,合庫-台中,2024-03-07,1021
6274,台燿,100,57,43,合庫-台中,2024-03-07,1021
3338,泰碩,141,99,42,合庫-台中,2024-03-07,1021
1444,力麗,40,0,40,合庫-台中,2024-03-07,1021
2409,友達,68,28,40,合庫-台中,2024-03-07,1021
6125,廣運,59,20,39,合庫-台中,2024-03-07,1021
2465,麗臺,38,0,38,合庫-台中,2024-03-07,1021
2344,華邦電,142,104,38,合庫-台中,2024-03-07,1021
00918,大華優利高填息30,75,37,38,合庫-台中,2024-03-07,1021
5512,力麒,40,3,37,合庫-台中,2024-03-07,1021
5452,佶優,55,18,37,合庫-台中,2024-03-07,1021
4111,濟生,37,0,37,合庫-台中,2024-03-07,1021
9907,統一實,37,0,37,合庫-台中,2024-03-07,1021
2329,華泰,74,40,34,合庫-台中,2024-03-07,1021
6732,昇佳電子,34,1,33,合庫-台中,2024-03-07,1021
1815,富喬,193,160,33,合庫-台中,2024-03-07,1021
2025,千興,36,3,33,合庫-台中,2024-03-07,1021
3481,群創,206,173,33,合庫-台中,2024-03-07,1021
6770,力積電,37,5,32,合庫-台中,2024-03-07,1021
2610,華航,56,24,32,合庫-台中,2024-03-07,1021
2356,英業達,60,28,32,合庫-台中,2024-03-07,1021
1432,大魯閣,40,9,31,合庫-台中,2024-03-07,1021
3178,公準,37,6,31,合庫-台中,2024-03-07,1021
4916,事欣科,31,0,31,合庫-台中,2024-03-07,1021
6179,亞通,32,1,31,合庫-台中,2024-03-07,1021
5521,工信,71,41,30,合庫-台中,2024-03-07,1021
2883B,凱基金乙特,30,0,30,合庫-台中,2024-03-07,1021
00632R,元大台灣50反1,268,2,266,合庫-台中,2024-03-08,1021
00687B,國泰20年美債,137,2,135,合庫-台中,2024-03-08,1021
00915,凱基優選高股息30,181,48,133,合庫-台中,2024-03-08,1021
00706L,期元大S＆P日圓正2,121,0,121,合庫-台中,2024-03-08,1021
2313,華通,331,211,120,合庫-台中,2024-03-08,1021
6116,彩晶,117,0,117,合庫-台中,2024-03-08,1021
1316,上曜,195,85,110,合庫-台中,2024-03-08,1021
00680L,元大美債20正2,125,24,101,合庫-台中,2024-03-08,1021
4111,濟生,94,0,94,合庫-台中,2024-03-08,1021
00918,大華優利高填息30,169,76,93,合庫-台中,2024-03-08,1021
2329,華泰,194,102,92,合庫-台中,2024-03-08,1021
6770,力積電,106,22,84,合庫-台中,2024-03-08,1021
6207,雷科,73,4,69,合庫-台中,2024-03-08,1021
3056,富華新,62,1,61,合庫-台中,2024-03-08,1021
6165,浪凡,58,0,58,合庫-台中,2024-03-08,1021
00927,群益半導體收益,89,34,55,合庫-台中,2024-03-08,1021
3213,茂訊,52,0,52,合庫-台中,2024-03-08,1021
2330,台積電,78,28,50,合庫-台中,2024-03-08,1021
00937B,群益ESG投等債20,254,207,47,合庫-台中,2024-03-08,1021
3021,鴻名,49,2,47,合庫-台中,2024-03-08,1021
2388,威盛,60,14,46,合庫-台中,2024-03-08,1021
2365,昆盈,51,5,46,合庫-台中,2024-03-08,1021
2634,漢翔,76,31,45,合庫-台中,2024-03-08,1021
2801,彰銀,53,10,43,合庫-台中,2024-03-08,1021
6026,福邦證,41,0,41,合庫-台中,2024-03-08,1021
5498,凱崴,64,24,40,合庫-台中,2024-03-08,1021
1532,勤美,40,0,40,合庫-台中,2024-03-08,1021
1314,中石化,50,10,40,合庫-台中,2024-03-08,1021
00933B,國泰10Y+金融債,67,28,39,合庫-台中,2024-03-08,1021
2002,中鋼,60,21,39,合庫-台中,2024-03-08,1021
1312,國喬,38,0,38,合庫-台中,2024-03-08,1021
00720B,元大投資級公司債,38,0,38,合庫-台中,2024-03-08,1021
2465,麗臺,39,2,37,合庫-台中,2024-03-08,1021
6156,松上,47,10,37,合庫-台中,2024-03-08,1021
1815,富喬,74,38,36,合庫-台中,2024-03-08,1021
2409,友達,83,50,33,合庫-台中,2024-03-08,1021
2358,廷鑫,60,27,33,合庫-台中,2024-03-08,1021
2601,益航,42,10,32,合庫-台中,2024-03-08,1021
2344,華邦電,68,37,31,合庫-台中,2024-03-08,1021
00637L,元大滬深300正2,1096,1065,31,合庫-台中,2024-03-08,1021
2062,橋椿,54,24,30,合庫-台中,2024-03-08,1021
1301,台塑,37,9,28,合庫-台中,2024-03-08,1021
2515,中工,126,98,28,合庫-台中,2024-03-08,1021
2610,華航,36,10,26,合庫-台中,2024-03-08,1021
2836,高雄銀,31,5,26,合庫-台中,2024-03-08,1021
3711,日月光投控,120,94,26,合庫-台中,2024-03-08,1021
3044,健鼎,30,4,26,合庫-台中,2024-03-08,1021
2603,長榮,82,56,26,合庫-台中,2024-03-08,1021
2462,良得電,25,0,25,合庫-台中,2024-03-08,1021
5301,寶得利,24,0,24,合庫-台中,2024-03-08,1021
00753L,中信中國50正2,347,0,347,合庫-台中,2024-03-11,1021
00919,群益台灣精選高息,848,625,223,合庫-台中,2024-03-11,1021
00918,大華優利高填息30,177,4,173,合庫-台中,2024-03-11,1021
00715L,期街口布蘭特正2,142,0,142,合庫-台中,2024-03-11,1021
00665L,富邦�琤肭磪囓�2,250,110,140,合庫-台中,2024-03-11,1021
3034,聯詠,78,0,78,合庫-台中,2024-03-11,1021
1514,亞力,112,43,69,合庫-台中,2024-03-11,1021
00937B,群益ESG投等債20,257,194,63,合庫-台中,2024-03-11,1021
00632R,元大台灣50反1,108,47,61,合庫-台中,2024-03-11,1021
1815,富喬,65,5,60,合庫-台中,2024-03-11,1021
00915,凱基優選高股息30,61,10,51,合庫-台中,2024-03-11,1021
1513,中興電,76,26,50,合庫-台中,2024-03-11,1021
3339,泰谷,58,10,48,合庫-台中,2024-03-11,1021
5515,建國,69,22,47,合庫-台中,2024-03-11,1021
00641R,富邦日本反1,45,0,45,合庫-台中,2024-03-11,1021
00772B,中信高評級公司債,48,5,43,合庫-台中,2024-03-11,1021
2834,臺企銀,273,231,42,合庫-台中,2024-03-11,1021
1582,信錦,55,13,42,合庫-台中,2024-03-11,1021
2330,台積電,56,14,42,合庫-台中,2024-03-11,1021
9945,潤泰新,42,2,40,合庫-台中,2024-03-11,1021
00720B,元大投資級公司債,61,27,34,合庫-台中,2024-03-11,1021
2836,高雄銀,36,3,33,合庫-台中,2024-03-11,1021
2365,昆盈,34,3,31,合庫-台中,2024-03-11,1021
4552,力達-KY,43,12,31,合庫-台中,2024-03-11,1021
2440,太空梭,30,0,30,合庫-台中,2024-03-11,1021
6005,群益證,34,4,30,合庫-台中,2024-03-11,1021
3523,迎輝,30,0,30,合庫-台中,2024-03-11,1021
2342,茂矽,32,3,29,合庫-台中,2024-03-11,1021
2504,國產,32,3,29,合庫-台中,2024-03-11,1021
4406,新昕纖,29,0,29,合庫-台中,2024-03-11,1021
5272,笙科,54,25,29,合庫-台中,2024-03-11,1021
3022,威強電,28,0,28,合庫-台中,2024-03-11,1021
5324,士開,26,0,26,合庫-台中,2024-03-11,1021
00687B,國泰20年美債,68,42,26,合庫-台中,2024-03-11,1021
6806,森崴能源,37,12,25,合庫-台中,2024-03-11,1021
2465,麗臺,28,3,25,合庫-台中,2024-03-11,1021
2888,新光金,45,20,25,合庫-台中,2024-03-11,1021
1314,中石化,24,0,24,合庫-台中,2024-03-11,1021
2610,華航,34,10,24,合庫-台中,2024-03-11,1021
5301,寶得利,23,0,23,合庫-台中,2024-03-11,1021
2371,大同,42,21,21,合庫-台中,2024-03-11,1021
2363,矽統,26,5,21,合庫-台中,2024-03-11,1021
00764B,群益25年美債,21,0,21,合庫-台中,2024-03-11,1021
2603,長榮,33,12,21,合庫-台中,2024-03-11,1021
2897,王道銀行,31,10,21,合庫-台中,2024-03-11,1021
2515,中工,55,35,20,合庫-台中,2024-03-11,1021
2349,錸德,20,0,20,合庫-台中,2024-03-11,1021
00927,群益半導體收益,19,0,19,合庫-台中,2024-03-11,1021
8401,白紗科,19,0,19,合庫-台中,2024-03-11,1021
5530,龍巖,18,0,18,合庫-台中,2024-03-11,1021
00632R,元大台灣50反1,594,5,589,合庫-台中,2024-03-12,1021
00929,復華台灣科技優息,684,113,571,合庫-台中,2024-03-12,1021
00919,群益台灣精選高息,905,442,463,合庫-台中,2024-03-12,1021
00937B,群益ESG投等債20,378,132,246,合庫-台中,2024-03-12,1021
4716,大立,220,0,220,合庫-台中,2024-03-12,1021
2317,鴻海,1263,1049,214,合庫-台中,2024-03-12,1021
2367,燿華,173,45,128,合庫-台中,2024-03-12,1021
2409,友達,143,66,77,合庫-台中,2024-03-12,1021
3011,今皓,70,0,70,合庫-台中,2024-03-12,1021
3339,泰谷,70,0,70,合庫-台中,2024-03-12,1021
1316,上曜,81,32,49,合庫-台中,2024-03-12,1021
1722,台肥,50,2,48,合庫-台中,2024-03-12,1021
00687B,國泰20年美債,73,26,47,合庫-台中,2024-03-12,1021
2323,中環,126,85,41,合庫-台中,2024-03-12,1021
5512,力麒,40,0,40,合庫-台中,2024-03-12,1021
6531,愛普*,41,4,37,合庫-台中,2024-03-12,1021
1605,華新,35,1,34,合庫-台中,2024-03-12,1021
2025,千興,35,2,33,合庫-台中,2024-03-12,1021
6179,亞通,31,1,30,合庫-台中,2024-03-12,1021
2303,聯電,109,81,28,合庫-台中,2024-03-12,1021
3036,文曄,30,3,27,合庫-台中,2024-03-12,1021
3231,緯創,118,91,27,合庫-台中,2024-03-12,1021
3013,晟銘電,33,7,26,合庫-台中,2024-03-12,1021
1305,華夏,26,0,26,合庫-台中,2024-03-12,1021
2352,佳世達,34,10,24,合庫-台中,2024-03-12,1021
6412,群電,26,3,23,合庫-台中,2024-03-12,1021
00857B,永豐20年美公債,23,0,23,合庫-台中,2024-03-12,1021
6770,力積電,28,6,22,合庫-台中,2024-03-12,1021
2836,高雄銀,21,0,21,合庫-台中,2024-03-12,1021
2027,大成鋼,22,1,21,合庫-台中,2024-03-12,1021
2353,宏��,103,82,21,合庫-台中,2024-03-12,1021
2451,創見,21,1,20,合庫-台中,2024-03-12,1021
00669R,國泰美國道瓊反1,20,0,20,合庫-台中,2024-03-12,1021
8401,白紗科,20,0,20,合庫-台中,2024-03-12,1021
1805,寶徠,20,0,20,合庫-台中,2024-03-12,1021
6163,華電網,27,7,20,合庫-台中,2024-03-12,1021
00712,復華富時不動產,19,0,19,合庫-台中,2024-03-12,1021
00679B,元大美債20年,47,29,18,合庫-台中,2024-03-12,1021
6147,頎邦,20,2,18,合庫-台中,2024-03-12,1021
2104,國際中橡,21,3,18,合庫-台中,2024-03-12,1021
00680L,元大美債20正2,51,33,18,合庫-台中,2024-03-12,1021
00720B,元大投資級公司債,17,0,17,合庫-台中,2024-03-12,1021
2883,凱基金,96,79,17,合庫-台中,2024-03-12,1021
2406,國碩,26,10,16,合庫-台中,2024-03-12,1021
8011,台通,28,12,16,合庫-台中,2024-03-12,1021
6213,聯茂,15,0,15,合庫-台中,2024-03-12,1021
2501,國建,15,0,15,合庫-台中,2024-03-12,1021
2408,南亞科,15,1,14,合庫-台中,2024-03-12,1021
2606,裕民,15,1,14,合庫-台中,2024-03-12,1021
3712,永崴投控,14,0,14,合庫-台中,2024-03-12,1021
00919,群益台灣精選高息,853,371,482,合庫-台中,2024-03-13,1021
2618,長榮航,377,48,329,合庫-台中,2024-03-13,1021
3013,晟銘電,287,10,277,合庫-台中,2024-03-13,1021
00933B,國泰10Y+金融債,199,21,178,合庫-台中,2024-03-13,1021
00918,大華優利高填息30,369,192,177,合庫-台中,2024-03-13,1021
3231,緯創,290,151,139,合庫-台中,2024-03-13,1021
2371,大同,167,37,130,合庫-台中,2024-03-13,1021
3011,今皓,122,0,122,合庫-台中,2024-03-13,1021
00680L,元大美債20正2,119,0,119,合庫-台中,2024-03-13,1021
2002,中鋼,143,25,118,合庫-台中,2024-03-13,1021
00679B,元大美債20年,87,5,82,合庫-台中,2024-03-13,1021
00650L,復華香港正2,431,349,82,合庫-台中,2024-03-13,1021
3521,鴻翊,81,0,81,合庫-台中,2024-03-13,1021
00687B,國泰20年美債,124,48,76,合庫-台中,2024-03-13,1021
2603,長榮,112,37,75,合庫-台中,2024-03-13,1021
00915,凱基優選高股息30,194,120,74,合庫-台中,2024-03-13,1021
2344,華邦電,69,2,67,合庫-台中,2024-03-13,1021
3516,亞帝歐,64,0,64,合庫-台中,2024-03-13,1021
6531,愛普*,64,5,59,合庫-台中,2024-03-13,1021
2610,華航,69,16,53,合庫-台中,2024-03-13,1021
8011,台通,97,44,53,合庫-台中,2024-03-13,1021
5511,德昌,55,4,51,合庫-台中,2024-03-13,1021
00637L,元大滬深300正2,658,611,47,合庫-台中,2024-03-13,1021
2408,南亞科,58,12,46,合庫-台中,2024-03-13,1021
1608,華榮,76,31,45,合庫-台中,2024-03-13,1021
3481,群創,86,43,43,合庫-台中,2024-03-13,1021
3663,鑫科,45,3,42,合庫-台中,2024-03-13,1021
6770,力積電,74,32,42,合庫-台中,2024-03-13,1021
2376,技嘉,53,13,40,合庫-台中,2024-03-13,1021
2486,一詮,89,52,37,合庫-台中,2024-03-13,1021
1717,長興,39,2,37,合庫-台中,2024-03-13,1021
3171,炎洲流通,36,0,36,合庫-台中,2024-03-13,1021
6120,達運,36,0,36,合庫-台中,2024-03-13,1021
2359,所羅門,36,1,35,合庫-台中,2024-03-13,1021
5230,雷笛克光學,33,0,33,合庫-台中,2024-03-13,1021
1314,中石化,33,0,33,合庫-台中,2024-03-13,1021
5498,凱崴,40,7,33,合庫-台中,2024-03-13,1021
1514,亞力,124,93,31,合庫-台中,2024-03-13,1021
1447,力鵬,30,0,30,合庫-台中,2024-03-13,1021
1802,台玻,32,2,30,合庫-台中,2024-03-13,1021
2329,華泰,50,21,29,合庫-台中,2024-03-13,1021
6275,元山,66,37,29,合庫-台中,2024-03-13,1021
2453,凌群,33,4,29,合庫-台中,2024-03-13,1021
3715,定穎投控,28,0,28,合庫-台中,2024-03-13,1021
3022,威強電,28,0,28,合庫-台中,2024-03-13,1021
5351,鈺創,31,3,28,合庫-台中,2024-03-13,1021
8096,擎亞,33,7,26,合庫-台中,2024-03-13,1021
1326,台化,25,0,25,合庫-台中,2024-03-13,1021
2337,旺宏,26,4,22,合庫-台中,2024-03-13,1021
2484,希華,22,0,22,合庫-台中,2024-03-13,1021
00929,復華台灣科技優息,833,212,621,合庫-台中,2024-03-14,1021
2618,長榮航,682,192,490,合庫-台中,2024-03-14,1021
00919,群益台灣精選高息,1252,851,401,合庫-台中,2024-03-14,1021
2812,台中銀,333,38,295,合庫-台中,2024-03-14,1021
2884,玉山金,310,19,291,合庫-台中,2024-03-14,1021
00673R,期元大S＆P原油反1,150,0,150,合庫-台中,2024-03-14,1021
00915,凱基優選高股息30,130,19,111,合庫-台中,2024-03-14,1021
00637L,元大滬深300正2,1134,1035,99,合庫-台中,2024-03-14,1021
00679B,元大美債20年,108,10,98,合庫-台中,2024-03-14,1021
6269,台郡,100,5,95,合庫-台中,2024-03-14,1021
00712,復華富時不動產,104,10,94,合庫-台中,2024-03-14,1021
00680L,元大美債20正2,110,20,90,合庫-台中,2024-03-14,1021
3322,建舜電,85,6,79,合庫-台中,2024-03-14,1021
00933B,國泰10Y+金融債,84,9,75,合庫-台中,2024-03-14,1021
3339,泰谷,70,0,70,合庫-台中,2024-03-14,1021
3011,今皓,64,0,64,合庫-台中,2024-03-14,1021
3005,神基,78,15,63,合庫-台中,2024-03-14,1021
2303,聯電,96,34,62,合庫-台中,2024-03-14,1021
2516,新建,61,0,61,合庫-台中,2024-03-14,1021
00650L,復華香港正2,350,296,54,合庫-台中,2024-03-14,1021
9902,台火,81,27,54,合庫-台中,2024-03-14,1021
9907,統一實,50,0,50,合庫-台中,2024-03-14,1021
00665L,富邦�琤肭磪囓�2,405,361,44,合庫-台中,2024-03-14,1021
3163,波若威,61,18,43,合庫-台中,2024-03-14,1021
4906,正文,47,7,40,合庫-台中,2024-03-14,1021
2845,遠東銀,92,52,40,合庫-台中,2024-03-14,1021
3702,大聯大,42,2,40,合庫-台中,2024-03-14,1021
2855,統一證,39,1,38,合庫-台中,2024-03-14,1021
1513,中興電,129,93,36,合庫-台中,2024-03-14,1021
1717,長興,33,0,33,合庫-台中,2024-03-14,1021
2453,凌群,32,1,31,合庫-台中,2024-03-14,1021
6165,浪凡,60,30,30,合庫-台中,2024-03-14,1021
3264,欣銓,30,0,30,合庫-台中,2024-03-14,1021
8054,安國,40,12,28,合庫-台中,2024-03-14,1021
6026,福邦證,34,7,27,合庫-台中,2024-03-14,1021
2354,鴻準,56,30,26,合庫-台中,2024-03-14,1021
6419,京晨科,80,54,26,合庫-台中,2024-03-14,1021
2609,陽明,26,2,24,合庫-台中,2024-03-14,1021
00857B,永豐20年美公債,24,0,24,合庫-台中,2024-03-14,1021
6139,亞翔,25,2,23,合庫-台中,2024-03-14,1021
1444,力麗,22,0,22,合庫-台中,2024-03-14,1021
6120,達運,20,0,20,合庫-台中,2024-03-14,1021
3059,華晶科,21,1,20,合庫-台中,2024-03-14,1021
5443,均豪,21,1,20,合庫-台中,2024-03-14,1021
2601,益航,20,0,20,合庫-台中,2024-03-14,1021
2382,廣達,29,11,18,合庫-台中,2024-03-14,1021
00688L,國泰20年美債正2,22,4,18,合庫-台中,2024-03-14,1021
2408,南亞科,20,2,18,合庫-台中,2024-03-14,1021
2603,長榮,38,20,18,合庫-台中,2024-03-14,1021
2729,瓦城,19,1,18,合庫-台中,2024-03-14,1021
2834,臺企銀,538,144,394,合庫-台中,2024-03-15,1021
00650L,復華香港正2,699,349,350,合庫-台中,2024-03-15,1021
00941,中信上游半導體,476,154,322,合庫-台中,2024-03-15,1021
1605,華新,283,43,240,合庫-台中,2024-03-15,1021
00937B,群益ESG投等債20,234,2,232,合庫-台中,2024-03-15,1021
00680L,元大美債20正2,221,21,200,合庫-台中,2024-03-15,1021
00665L,富邦�琤肭磪囓�2,623,429,194,合庫-台中,2024-03-15,1021
00857B,永豐20年美公債,178,0,178,合庫-台中,2024-03-15,1021
00673R,期元大S＆P原油反1,182,20,162,合庫-台中,2024-03-15,1021
00918,大華優利高填息30,306,162,144,合庫-台中,2024-03-15,1021
00933B,國泰10Y+金融債,135,0,135,合庫-台中,2024-03-15,1021
00919,群益台灣精選高息,677,557,120,合庫-台中,2024-03-15,1021
2836,高雄銀,113,12,101,合庫-台中,2024-03-15,1021
00679B,元大美債20年,110,13,97,合庫-台中,2024-03-15,1021
2889,國票金,152,60,92,合庫-台中,2024-03-15,1021
00915,凱基優選高股息30,92,1,91,合庫-台中,2024-03-15,1021
2330,台積電,86,14,72,合庫-台中,2024-03-15,1021
2356,英業達,159,88,71,合庫-台中,2024-03-15,1021
2443,昶虹,70,0,70,合庫-台中,2024-03-15,1021
00715L,期街口布蘭特正2,107,39,68,合庫-台中,2024-03-15,1021
2618,長榮航,77,14,63,合庫-台中,2024-03-15,1021
00687B,國泰20年美債,81,23,58,合庫-台中,2024-03-15,1021
3576,聯合再生,59,1,58,合庫-台中,2024-03-15,1021
3231,緯創,137,79,58,合庫-台中,2024-03-15,1021
3521,鴻翊,55,0,55,合庫-台中,2024-03-15,1021
00751B,元大AAA至A公司債,57,4,53,合庫-台中,2024-03-15,1021
1314,中石化,77,27,50,合庫-台中,2024-03-15,1021
00753L,中信中國50正2,434,393,41,合庫-台中,2024-03-15,1021
6026,福邦證,61,20,41,合庫-台中,2024-03-15,1021
00688L,國泰20年美債正2,40,0,40,合庫-台中,2024-03-15,1021
6239,力成,42,3,39,合庫-台中,2024-03-15,1021
3715,定穎投控,58,22,36,合庫-台中,2024-03-15,1021
1519,華城,174,141,33,合庫-台中,2024-03-15,1021
1504,東元,34,3,31,合庫-台中,2024-03-15,1021
4714,永捷,83,52,31,合庫-台中,2024-03-15,1021
4960,誠美材,31,0,31,合庫-台中,2024-03-15,1021
1513,中興電,70,39,31,合庫-台中,2024-03-15,1021
1451,年興,30,0,30,合庫-台中,2024-03-15,1021
4406,新昕纖,30,0,30,合庫-台中,2024-03-15,1021
3163,波若威,44,14,30,合庫-台中,2024-03-15,1021
3481,群創,232,203,29,合庫-台中,2024-03-15,1021
3438,類比科,51,23,28,合庫-台中,2024-03-15,1021
9907,統一實,28,0,28,合庫-台中,2024-03-15,1021
00712,復華富時不動產,35,7,28,合庫-台中,2024-03-15,1021
2442,新美齊,28,0,28,合庫-台中,2024-03-15,1021
1608,華榮,57,30,27,合庫-台中,2024-03-15,1021
2354,鴻準,86,59,27,合庫-台中,2024-03-15,1021
1455,集盛,26,0,26,合庫-台中,2024-03-15,1021
00642U,期元大S＆P石油,31,5,26,合庫-台中,2024-03-15,1021
2308,台達電,30,5,25,合庫-台中,2024-03-15,1021
2317,鴻海,1207,235,972,合庫-台中,2024-03-18,1021
00937B,群益ESG投等債20,807,10,797,合庫-台中,2024-03-18,1021
9902,台火,481,0,481,合庫-台中,2024-03-18,1021
2834,臺企銀,498,105,393,合庫-台中,2024-03-18,1021
00919,群益台灣精選高息,273,66,207,合庫-台中,2024-03-18,1021
00941,中信上游半導體,160,5,155,合庫-台中,2024-03-18,1021
8488,吉源-KY,149,0,149,合庫-台中,2024-03-18,1021
2888,新光金,158,11,147,合庫-台中,2024-03-18,1021
2323,中環,477,345,132,合庫-台中,2024-03-18,1021
00673R,期元大S＆P原油反1,118,0,118,合庫-台中,2024-03-18,1021
2002,中鋼,123,11,112,合庫-台中,2024-03-18,1021
1513,中興電,199,101,98,合庫-台中,2024-03-18,1021
00680L,元大美債20正2,81,2,79,合庫-台中,2024-03-18,1021
1605,華新,315,239,76,合庫-台中,2024-03-18,1021
00918,大華優利高填息30,89,18,71,合庫-台中,2024-03-18,1021
2329,華泰,211,143,68,合庫-台中,2024-03-18,1021
3481,群創,252,185,67,合庫-台中,2024-03-18,1021
00679B,元大美債20年,74,12,62,合庫-台中,2024-03-18,1021
2609,陽明,81,20,61,合庫-台中,2024-03-18,1021
00878,國泰永續高股息,82,26,56,合庫-台中,2024-03-18,1021
1609,大亞,104,51,53,合庫-台中,2024-03-18,1021
8011,台通,58,5,53,合庫-台中,2024-03-18,1021
5201,凱衛,52,0,52,合庫-台中,2024-03-18,1021
2887,台新金,65,14,51,合庫-台中,2024-03-18,1021
6116,彩晶,52,3,49,合庫-台中,2024-03-18,1021
00632R,元大台灣50反1,77,31,46,合庫-台中,2024-03-18,1021
00706L,期元大S＆P日圓正2,43,0,43,合庫-台中,2024-03-18,1021
9907,統一實,42,0,42,合庫-台中,2024-03-18,1021
00933B,國泰10Y+金融債,42,2,40,合庫-台中,2024-03-18,1021
2495,普安,40,0,40,合庫-台中,2024-03-18,1021
00687B,國泰20年美債,91,54,37,合庫-台中,2024-03-18,1021
6016,康和證,39,3,36,合庫-台中,2024-03-18,1021
2812,台中銀,96,60,36,合庫-台中,2024-03-18,1021
3339,泰谷,50,15,35,合庫-台中,2024-03-18,1021
2408,南亞科,34,1,33,合庫-台中,2024-03-18,1021
00751B,元大AAA至A公司債,79,50,29,合庫-台中,2024-03-18,1021
4714,永捷,94,65,29,合庫-台中,2024-03-18,1021
3622,洋華,32,3,29,合庫-台中,2024-03-18,1021
2611,志信,49,21,28,合庫-台中,2024-03-18,1021
2603,長榮,49,22,27,合庫-台中,2024-03-18,1021
6026,福邦證,30,3,27,合庫-台中,2024-03-18,1021
3294,英濟,143,117,26,合庫-台中,2024-03-18,1021
2530,華建,24,0,24,合庫-台中,2024-03-18,1021
2303,聯電,41,17,24,合庫-台中,2024-03-18,1021
1101,台泥,26,3,23,合庫-台中,2024-03-18,1021
2610,華航,29,6,23,合庫-台中,2024-03-18,1021
2025,千興,22,0,22,合庫-台中,2024-03-18,1021
2353,宏��,25,5,20,合庫-台中,2024-03-18,1021
00720B,元大投資級公司債,25,5,20,合庫-台中,2024-03-18,1021
2449,京元電子,28,8,20,合庫-台中,2024-03-18,1021
00937B,群益ESG投等債20,173,10,163,合庫-台中,2024-03-19,1021
00679B,元大美債20年,162,9,153,合庫-台中,2024-03-19,1021
00665L,富邦�琤肭磪囓�2,708,578,130,合庫-台中,2024-03-19,1021
00919,群益台灣精選高息,601,481,120,合庫-台中,2024-03-19,1021
2329,華泰,188,72,116,合庫-台中,2024-03-19,1021
2834,臺企銀,240,125,115,合庫-台中,2024-03-19,1021
00687B,國泰20年美債,150,39,111,合庫-台中,2024-03-19,1021
1609,大亞,106,6,100,合庫-台中,2024-03-19,1021
00706L,期元大S＆P日圓正2,170,71,99,合庫-台中,2024-03-19,1021
3672,康聯訊,97,0,97,合庫-台中,2024-03-19,1021
2887,台新金,96,8,88,合庫-台中,2024-03-19,1021
00857B,永豐20年美公債,79,0,79,合庫-台中,2024-03-19,1021
00673R,期元大S＆P原油反1,60,0,60,合庫-台中,2024-03-19,1021
00795B,中信美國公債20年,59,0,59,合庫-台中,2024-03-19,1021
00782B,國泰A級公用債,56,0,56,合庫-台中,2024-03-19,1021
00847B,中信美國市政債,54,0,54,合庫-台中,2024-03-19,1021
2323,中環,191,137,54,合庫-台中,2024-03-19,1021
2371,大同,172,119,53,合庫-台中,2024-03-19,1021
2884,玉山金,67,17,50,合庫-台中,2024-03-19,1021
00941,中信上游半導體,51,3,48,合庫-台中,2024-03-19,1021
5201,凱衛,43,2,41,合庫-台中,2024-03-19,1021
2368,金像電,43,2,41,合庫-台中,2024-03-19,1021
00915,凱基優選高股息30,45,5,40,合庫-台中,2024-03-19,1021
2812,台中銀,50,11,39,合庫-台中,2024-03-19,1021
2355,敬鵬,50,13,37,合庫-台中,2024-03-19,1021
2002,中鋼,96,63,33,合庫-台中,2024-03-19,1021
3521,鴻翊,33,0,33,合庫-台中,2024-03-19,1021
1503,士電,94,63,31,合庫-台中,2024-03-19,1021
00901,永豐智能車供應鏈,30,0,30,合庫-台中,2024-03-19,1021
00934,中信成長高股息,32,4,28,合庫-台中,2024-03-19,1021
00753L,中信中國50正2,335,309,26,合庫-台中,2024-03-19,1021
2855,統一證,26,0,26,合庫-台中,2024-03-19,1021
2105,正新,29,3,26,合庫-台中,2024-03-19,1021
2633,台灣高鐵,25,0,25,合庫-台中,2024-03-19,1021
00680L,元大美債20正2,25,0,25,合庫-台中,2024-03-19,1021
2354,鴻準,37,13,24,合庫-台中,2024-03-19,1021
2601,益航,24,0,24,合庫-台中,2024-03-19,1021
6125,廣運,26,2,24,合庫-台中,2024-03-19,1021
2332,友訊,22,0,22,合庫-台中,2024-03-19,1021
3011,今皓,22,0,22,合庫-台中,2024-03-19,1021
4503,金雨,42,20,22,合庫-台中,2024-03-19,1021
3322,建舜電,21,0,21,合庫-台中,2024-03-19,1021
3005,神基,64,43,21,合庫-台中,2024-03-19,1021
2330,台積電,28,7,21,合庫-台中,2024-03-19,1021
9950,萬國通,20,0,20,合庫-台中,2024-03-19,1021
3033,威健,20,0,20,合庫-台中,2024-03-19,1021
3380,明泰,20,0,20,合庫-台中,2024-03-19,1021
1316,上曜,23,3,20,合庫-台中,2024-03-19,1021
2353,宏��,26,7,19,合庫-台中,2024-03-19,1021
4714,永捷,50,31,19,合庫-台中,2024-03-19,1021
2888,新光金,463,107,356,合庫-台中,2024-03-20,1021
00680L,元大美債20正2,275,0,275,合庫-台中,2024-03-20,1021
2356,英業達,243,47,196,合庫-台中,2024-03-20,1021
00650L,復華香港正2,436,299,137,合庫-台中,2024-03-20,1021
00679B,元大美債20年,128,2,126,合庫-台中,2024-03-20,1021
00673R,期元大S＆P原油反1,111,0,111,合庫-台中,2024-03-20,1021
1609,大亞,145,42,103,合庫-台中,2024-03-20,1021
9902,台火,98,1,97,合庫-台中,2024-03-20,1021
00930,永豐ESG低碳高息,99,5,94,合庫-台中,2024-03-20,1021
00891,中信關鍵半導體,79,5,74,合庫-台中,2024-03-20,1021
3322,建舜電,85,13,72,合庫-台中,2024-03-20,1021
2834,臺企銀,196,127,69,合庫-台中,2024-03-20,1021
3231,緯創,173,119,54,合庫-台中,2024-03-20,1021
2453,凌群,80,28,52,合庫-台中,2024-03-20,1021
1416,廣豐,50,0,50,合庫-台中,2024-03-20,1021
6120,達運,50,1,49,合庫-台中,2024-03-20,1021
5880,合庫金,58,12,46,合庫-台中,2024-03-20,1021
2313,華通,227,182,45,合庫-台中,2024-03-20,1021
1101,台泥,53,9,44,合庫-台中,2024-03-20,1021
00882,中信中國高股息,72,28,44,合庫-台中,2024-03-20,1021
2363,矽統,54,11,43,合庫-台中,2024-03-20,1021
00918,大華優利高填息30,112,71,41,合庫-台中,2024-03-20,1021
3481,群創,225,185,40,合庫-台中,2024-03-20,1021
6770,力積電,43,4,39,合庫-台中,2024-03-20,1021
2208,台船,38,0,38,合庫-台中,2024-03-20,1021
00941,中信上游半導體,70,33,37,合庫-台中,2024-03-20,1021
8234,新漢,58,22,36,合庫-台中,2024-03-20,1021
2382,廣達,52,16,36,合庫-台中,2024-03-20,1021
00687B,國泰20年美債,115,83,32,合庫-台中,2024-03-20,1021
1725,元禎,31,0,31,合庫-台中,2024-03-20,1021
6443,元晶,31,0,31,合庫-台中,2024-03-20,1021
4938,和碩,58,27,31,合庫-台中,2024-03-20,1021
00706L,期元大S＆P日圓正2,52,22,30,合庫-台中,2024-03-20,1021
2618,長榮航,32,2,30,合庫-台中,2024-03-20,1021
6223,旺矽,29,0,29,合庫-台中,2024-03-20,1021
6176,瑞儀,48,20,28,合庫-台中,2024-03-20,1021
2454,聯發科,29,1,28,合庫-台中,2024-03-20,1021
2408,南亞科,27,0,27,合庫-台中,2024-03-20,1021
6194,育富,27,0,27,合庫-台中,2024-03-20,1021
8131,福懋科,27,0,27,合庫-台中,2024-03-20,1021
1326,台化,28,1,27,合庫-台中,2024-03-20,1021
5301,寶得利,24,0,24,合庫-台中,2024-03-20,1021
3005,神基,244,223,21,合庫-台中,2024-03-20,1021
1301,台塑,34,13,21,合庫-台中,2024-03-20,1021
9105,泰金寶-DR,30,9,21,合庫-台中,2024-03-20,1021
00688L,國泰20年美債正2,21,0,21,合庫-台中,2024-03-20,1021
2634,漢翔,26,6,20,合庫-台中,2024-03-20,1021
3047,訊舟,20,0,20,合庫-台中,2024-03-20,1021
3516,亞帝歐,20,0,20,合庫-台中,2024-03-20,1021
2344,華邦電,66,46,20,合庫-台中,2024-03-20,1021
00939,統一台灣高息動能,766,245,521,合庫-台中,2024-03-21,1021
00919,群益台灣精選高息,644,463,181,合庫-台中,2024-03-21,1021
00687B,國泰20年美債,161,11,150,合庫-台中,2024-03-21,1021
00680L,元大美債20正2,141,0,141,合庫-台中,2024-03-21,1021
3005,神基,254,129,125,合庫-台中,2024-03-21,1021
00679B,元大美債20年,117,1,116,合庫-台中,2024-03-21,1021
3029,零壹,96,0,96,合庫-台中,2024-03-21,1021
2301,光寶科,204,109,95,合庫-台中,2024-03-21,1021
00688L,國泰20年美債正2,85,0,85,合庫-台中,2024-03-21,1021
6016,康和證,71,0,71,合庫-台中,2024-03-21,1021
00632R,元大台灣50反1,115,45,70,合庫-台中,2024-03-21,1021
00857B,永豐20年美公債,55,0,55,合庫-台中,2024-03-21,1021
6488,環球晶,52,2,50,合庫-台中,2024-03-21,1021
2317,鴻海,138,89,49,合庫-台中,2024-03-21,1021
3508,位速,45,0,45,合庫-台中,2024-03-21,1021
00720B,元大投資級公司債,42,0,42,合庫-台中,2024-03-21,1021
2006,東和鋼鐵,42,0,42,合庫-台中,2024-03-21,1021
1734,杏輝,37,0,37,合庫-台中,2024-03-21,1021
1609,大亞,57,23,34,合庫-台中,2024-03-21,1021
2527,宏璟,33,0,33,合庫-台中,2024-03-21,1021
00696B,富邦美債20年,32,0,32,合庫-台中,2024-03-21,1021
3703,欣陸,31,0,31,合庫-台中,2024-03-21,1021
00904,新光臺灣半導體30,30,0,30,合庫-台中,2024-03-21,1021
00751B,元大AAA至A公司債,30,0,30,合庫-台中,2024-03-21,1021
3025,星通,40,11,29,合庫-台中,2024-03-21,1021
3594,磐儀,36,8,28,合庫-台中,2024-03-21,1021
4979,華星光,29,1,28,合庫-台中,2024-03-21,1021
6285,啟��,46,18,28,合庫-台中,2024-03-21,1021
3234,光環,28,1,27,合庫-台中,2024-03-21,1021
6223,旺矽,25,0,25,合庫-台中,2024-03-21,1021
2482,連宇,33,8,25,合庫-台中,2024-03-21,1021
3706,神達,279,255,24,合庫-台中,2024-03-21,1021
1530,亞崴,24,0,24,合庫-台中,2024-03-21,1021
00931B,統一美債20年,22,0,22,合庫-台中,2024-03-21,1021
2368,金像電,28,6,22,合庫-台中,2024-03-21,1021
2611,志信,24,2,22,合庫-台中,2024-03-21,1021
2362,藍天,51,31,20,合庫-台中,2024-03-21,1021
00650L,復華香港正2,435,415,20,合庫-台中,2024-03-21,1021
00664R,國泰臺灣加權反1,20,0,20,合庫-台中,2024-03-21,1021
6419,京晨科,20,0,20,合庫-台中,2024-03-21,1021
4414,如興,20,0,20,合庫-台中,2024-03-21,1021
5301,寶得利,20,0,20,合庫-台中,2024-03-21,1021
4938,和碩,48,29,19,合庫-台中,2024-03-21,1021
6412,群電,25,6,19,合庫-台中,2024-03-21,1021
2303,聯電,176,158,18,合庫-台中,2024-03-21,1021
00772B,中信高評級公司債,35,17,18,合庫-台中,2024-03-21,1021
00918,大華優利高填息30,34,16,18,合庫-台中,2024-03-21,1021
6235,華孚,21,3,18,合庫-台中,2024-03-21,1021
2618,長榮航,41,23,18,合庫-台中,2024-03-21,1021
1101,台泥,32,14,18,合庫-台中,2024-03-21,1021
00648R,元大S＆P500反1,460,0,460,合庫-台中,2024-03-22,1021
00939,統一台灣高息動能,445,63,382,合庫-台中,2024-03-22,1021
00941,中信上游半導體,235,39,196,合庫-台中,2024-03-22,1021
00937B,群益ESG投等債20,250,65,185,合庫-台中,2024-03-22,1021
00919,群益台灣精選高息,739,558,181,合庫-台中,2024-03-22,1021
2344,華邦電,274,97,177,合庫-台中,2024-03-22,1021
6026,福邦證,138,0,138,合庫-台中,2024-03-22,1021
9902,台火,133,0,133,合庫-台中,2024-03-22,1021
6015,宏遠證,120,0,120,合庫-台中,2024-03-22,1021
00665L,富邦�琤肭磪囓�2,463,349,114,合庫-台中,2024-03-22,1021
2409,友達,164,63,101,合庫-台中,2024-03-22,1021
3706,神達,271,178,93,合庫-台中,2024-03-22,1021
00687B,國泰20年美債,107,15,92,合庫-台中,2024-03-22,1021
00857B,永豐20年美公債,103,20,83,合庫-台中,2024-03-22,1021
6282,康舒,107,40,67,合庫-台中,2024-03-22,1021
2888,新光金,93,32,61,合庫-台中,2024-03-22,1021
2303,聯電,236,180,56,合庫-台中,2024-03-22,1021
2489,瑞軒,50,0,50,合庫-台中,2024-03-22,1021
2356,英業達,526,476,50,合庫-台中,2024-03-22,1021
8271,宇瞻,86,37,49,合庫-台中,2024-03-22,1021
6120,達運,45,0,45,合庫-台中,2024-03-22,1021
2376,技嘉,99,55,44,合庫-台中,2024-03-22,1021
6005,群益證,52,10,42,合庫-台中,2024-03-22,1021
1504,東元,70,32,38,合庫-台中,2024-03-22,1021
1513,中興電,85,47,38,合庫-台中,2024-03-22,1021
3005,神基,76,40,36,合庫-台中,2024-03-22,1021
00632R,元大台灣50反1,63,30,33,合庫-台中,2024-03-22,1021
9907,統一實,33,0,33,合庫-台中,2024-03-22,1021
00904,新光臺灣半導體30,36,5,31,合庫-台中,2024-03-22,1021
1316,上曜,46,16,30,合庫-台中,2024-03-22,1021
8112,至上,53,23,30,合庫-台中,2024-03-22,1021
2855,統一證,30,0,30,合庫-台中,2024-03-22,1021
2603,長榮,84,55,29,合庫-台中,2024-03-22,1021
3047,訊舟,28,0,28,合庫-台中,2024-03-22,1021
6116,彩晶,29,2,27,合庫-台中,2024-03-22,1021
2610,華航,38,11,27,合庫-台中,2024-03-22,1021
00679B,元大美債20年,42,15,27,合庫-台中,2024-03-22,1021
1503,士電,75,50,25,合庫-台中,2024-03-22,1021
6016,康和證,37,12,25,合庫-台中,2024-03-22,1021
2002,中鋼,34,9,25,合庫-台中,2024-03-22,1021
00891,中信關鍵半導體,24,0,24,合庫-台中,2024-03-22,1021
2006,東和鋼鐵,26,3,23,合庫-台中,2024-03-22,1021
1722,台肥,22,0,22,合庫-台中,2024-03-22,1021
3294,英濟,27,6,21,合庫-台中,2024-03-22,1021
5871,中租-KY,23,3,20,合庫-台中,2024-03-22,1021
3234,光環,40,20,20,合庫-台中,2024-03-22,1021
1101,台泥,22,2,20,合庫-台中,2024-03-22,1021
3338,泰碩,20,0,20,合庫-台中,2024-03-22,1021
2834,臺企銀,31,11,20,合庫-台中,2024-03-22,1021
00752,中信中國50,20,0,20,合庫-台中,2024-03-22,1021
00941,中信上游半導體,797,79,718,合庫-台中,2024-03-25,1021
2317,鴻海,374,77,297,合庫-台中,2024-03-25,1021
00763U,期街口道瓊銅,135,0,135,合庫-台中,2024-03-25,1021
00715L,期街口布蘭特正2,131,6,125,合庫-台中,2024-03-25,1021
00939,統一台灣高息動能,345,223,122,合庫-台中,2024-03-25,1021
2002,中鋼,102,1,101,合庫-台中,2024-03-25,1021
00929,復華台灣科技優息,341,251,90,合庫-台中,2024-03-25,1021
5880,合庫金,86,4,82,合庫-台中,2024-03-25,1021
1609,大亞,293,218,75,合庫-台中,2024-03-25,1021
00937B,群益ESG投等債20,123,55,68,合庫-台中,2024-03-25,1021
8112,至上,52,0,52,合庫-台中,2024-03-25,1021
2409,友達,73,24,49,合庫-台中,2024-03-25,1021
2884,玉山金,48,0,48,合庫-台中,2024-03-25,1021
2845,遠東銀,50,2,48,合庫-台中,2024-03-25,1021
00679B,元大美債20年,47,8,39,合庫-台中,2024-03-25,1021
3062,建漢,55,18,37,合庫-台中,2024-03-25,1021
2303,聯電,60,26,34,合庫-台中,2024-03-25,1021
1795,美時,57,25,32,合庫-台中,2024-03-25,1021
2888,新光金,56,25,31,合庫-台中,2024-03-25,1021
2363,矽統,32,1,31,合庫-台中,2024-03-25,1021
6163,華電網,31,0,31,合庫-台中,2024-03-25,1021
6015,宏遠證,30,0,30,合庫-台中,2024-03-25,1021
2887,台新金,42,12,30,合庫-台中,2024-03-25,1021
00632R,元大台灣50反1,58,30,28,合庫-台中,2024-03-25,1021
6188,廣明,53,26,27,合庫-台中,2024-03-25,1021
00720B,元大投資級公司債,27,1,26,合庫-台中,2024-03-25,1021
00706L,期元大S＆P日圓正2,26,0,26,合庫-台中,2024-03-25,1021
2382,廣達,30,4,26,合庫-台中,2024-03-25,1021
2337,旺宏,25,0,25,合庫-台中,2024-03-25,1021
3708,上緯投控,47,23,24,合庫-台中,2024-03-25,1021
1316,上曜,25,2,23,合庫-台中,2024-03-25,1021
4127,天良,25,2,23,合庫-台中,2024-03-25,1021
00857B,永豐20年美公債,22,0,22,合庫-台中,2024-03-25,1021
1503,士電,37,15,22,合庫-台中,2024-03-25,1021
2301,光寶科,34,13,21,合庫-台中,2024-03-25,1021
5381,合正,29,8,21,合庫-台中,2024-03-25,1021
00673R,期元大S＆P原油反1,21,0,21,合庫-台中,2024-03-25,1021
2618,長榮航,25,5,20,合庫-台中,2024-03-25,1021
8926,台汽電,35,16,19,合庫-台中,2024-03-25,1021
5460,同協,19,0,19,合庫-台中,2024-03-25,1021
2801,彰銀,21,2,19,合庫-台中,2024-03-25,1021
2323,中環,67,48,19,合庫-台中,2024-03-25,1021
8222,寶一,23,4,19,合庫-台中,2024-03-25,1021
8096,擎亞,20,1,19,合庫-台中,2024-03-25,1021
2312,金寶,32,14,18,合庫-台中,2024-03-25,1021
1905,華紙,21,3,18,合庫-台中,2024-03-25,1021
2313,華通,98,80,18,合庫-台中,2024-03-25,1021
2025,千興,18,0,18,合庫-台中,2024-03-25,1021
2385,群光,17,0,17,合庫-台中,2024-03-25,1021
2352,佳世達,31,14,17,合庫-台中,2024-03-25,1021
00939,統一台灣高息動能,720,249,471,合庫-台中,2024-03-26,1021
5880,合庫金,238,81,157,合庫-台中,2024-03-26,1021
2883,凱基金,186,36,150,合庫-台中,2024-03-26,1021
3231,緯創,210,104,106,合庫-台中,2024-03-26,1021
00632R,元大台灣50反1,111,10,101,合庫-台中,2024-03-26,1021
6419,京晨科,113,26,87,合庫-台中,2024-03-26,1021
2313,華通,303,223,80,合庫-台中,2024-03-26,1021
1417,嘉裕,80,0,80,合庫-台中,2024-03-26,1021
8112,至上,79,1,78,合庫-台中,2024-03-26,1021
2609,陽明,84,7,77,合庫-台中,2024-03-26,1021
1513,中興電,161,95,66,合庫-台中,2024-03-26,1021
00680L,元大美債20正2,62,0,62,合庫-台中,2024-03-26,1021
6125,廣運,132,71,61,合庫-台中,2024-03-26,1021
00919,群益台灣精選高息,419,360,59,合庫-台中,2024-03-26,1021
2344,華邦電,151,93,58,合庫-台中,2024-03-26,1021
2109,華豐,52,0,52,合庫-台中,2024-03-26,1021
3058,立德,48,2,46,合庫-台中,2024-03-26,1021
6875,國邑*,51,6,45,合庫-台中,2024-03-26,1021
4938,和碩,105,61,44,合庫-台中,2024-03-26,1021
1220,台榮,46,4,42,合庫-台中,2024-03-26,1021
2610,華航,53,11,42,合庫-台中,2024-03-26,1021
6530,創威,94,54,40,合庫-台中,2024-03-26,1021
6770,力積電,38,0,38,合庫-台中,2024-03-26,1021
1101,台泥,42,4,38,合庫-台中,2024-03-26,1021
2885,元大金,106,69,37,合庫-台中,2024-03-26,1021
8096,擎亞,42,7,35,合庫-台中,2024-03-26,1021
3168,眾福科,33,0,33,合庫-台中,2024-03-26,1021
3044,健鼎,33,2,31,合庫-台中,2024-03-26,1021
6015,宏遠證,31,0,31,合庫-台中,2024-03-26,1021
6412,群電,31,0,31,合庫-台中,2024-03-26,1021
6189,豐藝,44,14,30,合庫-台中,2024-03-26,1021
3312,弘憶股,40,11,29,合庫-台中,2024-03-26,1021
2352,佳世達,45,16,29,合庫-台中,2024-03-26,1021
2618,長榮航,28,0,28,合庫-台中,2024-03-26,1021
1603,華電,41,14,27,合庫-台中,2024-03-26,1021
1584,精剛,26,0,26,合庫-台中,2024-03-26,1021
4916,事欣科,25,0,25,合庫-台中,2024-03-26,1021
2888,新光金,30,5,25,合庫-台中,2024-03-26,1021
3056,富華新,24,0,24,合庫-台中,2024-03-26,1021
00891,中信關鍵半導體,30,6,24,合庫-台中,2024-03-26,1021
6026,福邦證,23,0,23,合庫-台中,2024-03-26,1021
3689,湧德,29,6,23,合庫-台中,2024-03-26,1021
1514,亞力,43,20,23,合庫-台中,2024-03-26,1021
1714,和桐,22,0,22,合庫-台中,2024-03-26,1021
1611,中電,23,1,22,合庫-台中,2024-03-26,1021
2603,長榮,39,19,20,合庫-台中,2024-03-26,1021
1727,中華化,20,0,20,合庫-台中,2024-03-26,1021
2617,台航,20,0,20,合庫-台中,2024-03-26,1021
4526,東台,35,16,19,合庫-台中,2024-03-26,1021
2388,威盛,43,24,19,合庫-台中,2024-03-26,1021
00632R,元大台灣50反1,852,1,851,合庫-台中,2024-03-27,1021
00669R,國泰美國道瓊反1,628,0,628,合庫-台中,2024-03-27,1021
00937B,群益ESG投等債20,649,33,616,合庫-台中,2024-03-27,1021
00680L,元大美債20正2,476,23,453,合庫-台中,2024-03-27,1021
2317,鴻海,1351,962,389,合庫-台中,2024-03-27,1021
2353,宏��,354,9,345,合庫-台中,2024-03-27,1021
6419,京晨科,132,0,132,合庫-台中,2024-03-27,1021
3231,緯創,113,23,90,合庫-台中,2024-03-27,1021
2486,一詮,82,1,81,合庫-台中,2024-03-27,1021
1713,國化,74,0,74,合庫-台中,2024-03-27,1021
3005,神基,108,36,72,合庫-台中,2024-03-27,1021
00939,統一台灣高息動能,157,86,71,合庫-台中,2024-03-27,1021
2367,燿華,96,35,61,合庫-台中,2024-03-27,1021
5880,合庫金,66,8,58,合庫-台中,2024-03-27,1021
1616,億泰,55,2,53,合庫-台中,2024-03-27,1021
3576,聯合再生,53,1,52,合庫-台中,2024-03-27,1021
1605,華新,136,90,46,合庫-台中,2024-03-27,1021
2301,光寶科,52,9,43,合庫-台中,2024-03-27,1021
1808,潤隆,87,44,43,合庫-台中,2024-03-27,1021
6531,愛普*,44,3,41,合庫-台中,2024-03-27,1021
2371,大同,215,174,41,合庫-台中,2024-03-27,1021
1513,中興電,104,63,41,合庫-台中,2024-03-27,1021
2417,圓剛,39,1,38,合庫-台中,2024-03-27,1021
6163,華電網,42,4,38,合庫-台中,2024-03-27,1021
8096,擎亞,31,0,31,合庫-台中,2024-03-27,1021
2884,玉山金,31,1,30,合庫-台中,2024-03-27,1021
00719B,元大美債1-3,31,2,29,合庫-台中,2024-03-27,1021
1722,台肥,28,0,28,合庫-台中,2024-03-27,1021
3481,群創,158,131,27,合庫-台中,2024-03-27,1021
3312,弘憶股,27,1,26,合庫-台中,2024-03-27,1021
8064,東捷,32,7,25,合庫-台中,2024-03-27,1021
2312,金寶,25,1,24,合庫-台中,2024-03-27,1021
00665L,富邦�琤肭磪囓�2,536,512,24,合庫-台中,2024-03-27,1021
2457,飛宏,27,4,23,合庫-台中,2024-03-27,1021
1584,精剛,28,5,23,合庫-台中,2024-03-27,1021
00751B,元大AAA至A公司債,22,0,22,合庫-台中,2024-03-27,1021
2303,聯電,51,29,22,合庫-台中,2024-03-27,1021
6412,群電,21,0,21,合庫-台中,2024-03-27,1021
2009,第一銅,22,1,21,合庫-台中,2024-03-27,1021
5498,凱崴,20,0,20,合庫-台中,2024-03-27,1021
9945,潤泰新,20,0,20,合庫-台中,2024-03-27,1021
00688L,國泰20年美債正2,20,0,20,合庫-台中,2024-03-27,1021
9907,統一實,20,0,20,合庫-台中,2024-03-27,1021
1612,宏泰,114,95,19,合庫-台中,2024-03-27,1021
4128,中天,20,1,19,合庫-台中,2024-03-27,1021
9933,中鼎,31,12,19,合庫-台中,2024-03-27,1021
3264,欣銓,23,4,19,合庫-台中,2024-03-27,1021
1785,光洋科,24,5,19,合庫-台中,2024-03-27,1021
00715L,期街口布蘭特正2,17,0,17,合庫-台中,2024-03-27,1021
2374,佳能,16,0,16,合庫-台中,2024-03-27,1021
2317,鴻海,1161,379,782,合庫-台中,2024-03-28,1021
2618,長榮航,213,10,203,合庫-台中,2024-03-28,1021
3706,神達,240,61,179,合庫-台中,2024-03-28,1021
00939,統一台灣高息動能,197,34,163,合庫-台中,2024-03-28,1021
2883,凱基金,208,64,144,合庫-台中,2024-03-28,1021
1314,中石化,149,5,144,合庫-台中,2024-03-28,1021
2486,一詮,137,17,120,合庫-台中,2024-03-28,1021
5880,合庫金,97,5,92,合庫-台中,2024-03-28,1021
00669R,國泰美國道瓊反1,72,0,72,合庫-台中,2024-03-28,1021
2888,新光金,79,20,59,合庫-台中,2024-03-28,1021
00882,中信中國高股息,59,1,58,合庫-台中,2024-03-28,1021
2301,光寶科,66,9,57,合庫-台中,2024-03-28,1021
2303,聯電,82,32,50,合庫-台中,2024-03-28,1021
3005,神基,80,32,48,合庫-台中,2024-03-28,1021
00919,群益台灣精選高息,161,113,48,合庫-台中,2024-03-28,1021
2834,臺企銀,76,31,45,合庫-台中,2024-03-28,1021
3062,建漢,101,56,45,合庫-台中,2024-03-28,1021
2417,圓剛,44,1,43,合庫-台中,2024-03-28,1021
00937B,群益ESG投等債20,65,22,43,合庫-台中,2024-03-28,1021
2801,彰銀,67,28,39,合庫-台中,2024-03-28,1021
2615,萬海,41,3,38,合庫-台中,2024-03-28,1021
3576,聯合再生,50,12,38,合庫-台中,2024-03-28,1021
2330,台積電,37,1,36,合庫-台中,2024-03-28,1021
6116,彩晶,35,0,35,合庫-台中,2024-03-28,1021
1220,台榮,34,0,34,合庫-台中,2024-03-28,1021
8383,千附,38,5,33,合庫-台中,2024-03-28,1021
3437,榮創,38,5,33,合庫-台中,2024-03-28,1021
5309,系統電,41,9,32,合庫-台中,2024-03-28,1021
9907,統一實,31,0,31,合庫-台中,2024-03-28,1021
0056,元大高股息,46,17,29,合庫-台中,2024-03-28,1021
8033,雷虎,73,44,29,合庫-台中,2024-03-28,1021
00878,國泰永續高股息,53,25,28,合庫-台中,2024-03-28,1021
6412,群電,27,0,27,合庫-台中,2024-03-28,1021
1725,元禎,27,0,27,合庫-台中,2024-03-28,1021
8011,台通,29,2,27,合庫-台中,2024-03-28,1021
8096,擎亞,27,0,27,合庫-台中,2024-03-28,1021
00637L,元大滬深300正2,462,436,26,合庫-台中,2024-03-28,1021
6165,浪凡,28,3,25,合庫-台中,2024-03-28,1021
3704,合勤控,25,0,25,合庫-台中,2024-03-28,1021
1701,中化,24,0,24,合庫-台中,2024-03-28,1021
00673R,期元大S＆P原油反1,23,0,23,合庫-台中,2024-03-28,1021
4306,炎洲,33,10,23,合庫-台中,2024-03-28,1021
00941,中信上游半導體,28,5,23,合庫-台中,2024-03-28,1021
2368,金像電,32,11,21,合庫-台中,2024-03-28,1021
8112,至上,22,1,21,合庫-台中,2024-03-28,1021
4526,東台,24,3,21,合庫-台中,2024-03-28,1021
2349,錸德,20,0,20,合庫-台中,2024-03-28,1021
3056,富華新,20,0,20,合庫-台中,2024-03-28,1021
3481,群創,146,126,20,合庫-台中,2024-03-28,1021
6244,茂迪,22,3,19,合庫-台中,2024-03-28,1021
8488,吉源-KY,276,0,276,合庫-台中,2024-03-29,1021
00939,統一台灣高息動能,123,21,102,合庫-台中,2024-03-29,1021
1605,華新,102,2,100,合庫-台中,2024-03-29,1021
00673R,期元大S＆P原油反1,81,0,81,合庫-台中,2024-03-29,1021
2301,光寶科,111,36,75,合庫-台中,2024-03-29,1021
6412,群電,68,1,67,合庫-台中,2024-03-29,1021
2409,友達,156,90,66,合庫-台中,2024-03-29,1021
2630,亞航,72,7,65,合庫-台中,2024-03-29,1021
2324,仁寶,100,36,64,合庫-台中,2024-03-29,1021
3013,晟銘電,178,114,64,合庫-台中,2024-03-29,1021
2303,聯電,169,107,62,合庫-台中,2024-03-29,1021
6578,達邦蛋白,53,0,53,合庫-台中,2024-03-29,1021
2836,高雄銀,60,12,48,合庫-台中,2024-03-29,1021
3481,群創,162,116,46,合庫-台中,2024-03-29,1021
00919,群益台灣精選高息,181,138,43,合庫-台中,2024-03-29,1021
1806,冠軍,112,70,42,合庫-台中,2024-03-29,1021
2208,台船,42,0,42,合庫-台中,2024-03-29,1021
8054,安國,61,22,39,合庫-台中,2024-03-29,1021
9902,台火,36,0,36,合庫-台中,2024-03-29,1021
3615,安可,30,0,30,合庫-台中,2024-03-29,1021
4967,十銓,30,1,29,合庫-台中,2024-03-29,1021
3234,光環,33,4,29,合庫-台中,2024-03-29,1021
2606,裕民,30,2,28,合庫-台中,2024-03-29,1021
4526,東台,30,3,27,合庫-台中,2024-03-29,1021
8112,至上,30,4,26,合庫-台中,2024-03-29,1021
2465,麗臺,27,2,25,合庫-台中,2024-03-29,1021
2382,廣達,130,106,24,合庫-台中,2024-03-29,1021
6112,邁達特,24,0,24,合庫-台中,2024-03-29,1021
2442,新美齊,23,0,23,合庫-台中,2024-03-29,1021
6125,廣運,39,17,22,合庫-台中,2024-03-29,1021
00937B,群益ESG投等債20,71,49,22,合庫-台中,2024-03-29,1021
00857B,永豐20年美公債,21,0,21,合庫-台中,2024-03-29,1021
6186,新潤,21,0,21,合庫-台中,2024-03-29,1021
3022,威強電,20,0,20,合庫-台中,2024-03-29,1021
1101,台泥,35,15,20,合庫-台中,2024-03-29,1021
8064,東捷,20,0,20,合庫-台中,2024-03-29,1021
2371,大同,99,79,20,合庫-台中,2024-03-29,1021
3466,德晉,19,0,19,合庫-台中,2024-03-29,1021
4714,永捷,19,0,19,合庫-台中,2024-03-29,1021
2308,台達電,22,4,18,合庫-台中,2024-03-29,1021
6770,力積電,17,0,17,合庫-台中,2024-03-29,1021
1529,樂事綠能,17,0,17,合庫-台中,2024-03-29,1021
2358,廷鑫,18,1,17,合庫-台中,2024-03-29,1021
2328,廣宇,38,22,16,合庫-台中,2024-03-29,1021
4303,信立,25,9,16,合庫-台中,2024-03-29,1021
2888,新光金,16,0,16,合庫-台中,2024-03-29,1021
1444,力麗,16,0,16,合庫-台中,2024-03-29,1021
4991,環宇-KY,15,0,15,合庫-台中,2024-03-29,1021
00642U,期元大S＆P石油,15,0,15,合庫-台中,2024-03-29,1021
5388,中磊,16,2,14,合庫-台中,2024-03-29,1021
00940,元大台灣價值高息,2624,469,2155,合庫-台中,2024-04-01,1021
2317,鴻海,414,80,334,合庫-台中,2024-04-01,1021
00929,復華台灣科技優息,256,22,234,合庫-台中,2024-04-01,1021
00719B,元大美債1-3,158,1,157,合庫-台中,2024-04-01,1021
00937B,群益ESG投等債20,145,21,124,合庫-台中,2024-04-01,1021
3231,緯創,175,67,108,合庫-台中,2024-04-01,1021
2890,永豐金,101,1,100,合庫-台中,2024-04-01,1021
2892,第一金,100,1,99,合庫-台中,2024-04-01,1021
2105,正新,100,1,99,合庫-台中,2024-04-01,1021
00919,群益台灣精選高息,178,85,93,合庫-台中,2024-04-01,1021
2886,兆豐金,100,11,89,合庫-台中,2024-04-01,1021
6015,宏遠證,90,2,88,合庫-台中,2024-04-01,1021
2891,中信金,63,0,63,合庫-台中,2024-04-01,1021
9902,台火,57,0,57,合庫-台中,2024-04-01,1021
3481,群創,161,109,52,合庫-台中,2024-04-01,1021
3706,神達,66,21,45,合庫-台中,2024-04-01,1021
2867,三商壽,42,0,42,合庫-台中,2024-04-01,1021
2884,玉山金,58,18,40,合庫-台中,2024-04-01,1021
2359,所羅門,39,0,39,合庫-台中,2024-04-01,1021
00673R,期元大S＆P原油反1,35,0,35,合庫-台中,2024-04-01,1021
1504,東元,77,46,31,合庫-台中,2024-04-01,1021
00939,統一台灣高息動能,170,140,30,合庫-台中,2024-04-01,1021
2303,聯電,90,60,30,合庫-台中,2024-04-01,1021
6788,華景電,30,0,30,合庫-台中,2024-04-01,1021
00671R,富邦NASDAQ反1,30,0,30,合庫-台中,2024-04-01,1021
2382,廣達,72,43,29,合庫-台中,2024-04-01,1021
2356,英業達,71,42,29,合庫-台中,2024-04-01,1021
6414,樺漢,42,17,25,合庫-台中,2024-04-01,1021
2352,佳世達,25,0,25,合庫-台中,2024-04-01,1021
2375,凱美,25,1,24,合庫-台中,2024-04-01,1021
3234,光環,44,20,24,合庫-台中,2024-04-01,1021
4114,健喬,24,1,23,合庫-台中,2024-04-01,1021
2609,陽明,22,0,22,合庫-台中,2024-04-01,1021
2885,元大金,23,1,22,合庫-台中,2024-04-01,1021
3711,日月光投控,23,3,20,合庫-台中,2024-04-01,1021
4938,和碩,24,4,20,合庫-台中,2024-04-01,1021
1530,亞崴,20,0,20,合庫-台中,2024-04-01,1021
1584,精剛,23,3,20,合庫-台中,2024-04-01,1021
1609,大亞,20,0,20,合庫-台中,2024-04-01,1021
5876,上海商銀,20,0,20,合庫-台中,2024-04-01,1021
2330,台積電,20,0,20,合庫-台中,2024-04-01,1021
1301,台塑,33,14,19,合庫-台中,2024-04-01,1021
9933,中鼎,20,2,18,合庫-台中,2024-04-01,1021
4541,晟田,19,1,18,合庫-台中,2024-04-01,1021
1101,台泥,18,0,18,合庫-台中,2024-04-01,1021
1714,和桐,28,10,18,合庫-台中,2024-04-01,1021
00679B,元大美債20年,17,0,17,合庫-台中,2024-04-01,1021
6442,光聖,17,1,16,合庫-台中,2024-04-01,1021
2882,國泰金,22,6,16,合庫-台中,2024-04-01,1021
911868,同方友友-DR,15,0,15,合庫-台中,2024-04-01,1021
00940,元大台灣價值高息,856,152,704,合庫-台中,2024-04-02,1021
00706L,期元大S＆P日圓正2,485,0,485,合庫-台中,2024-04-02,1021
00680L,元大美債20正2,341,0,341,合庫-台中,2024-04-02,1021
00937B,群益ESG投等債20,414,81,333,合庫-台中,2024-04-02,1021
4716,大立,255,0,255,合庫-台中,2024-04-02,1021
00939,統一台灣高息動能,272,18,254,合庫-台中,2024-04-02,1021
2834,臺企銀,233,10,223,合庫-台中,2024-04-02,1021
9902,台火,192,0,192,合庫-台中,2024-04-02,1021
00687B,國泰20年美債,135,3,132,合庫-台中,2024-04-02,1021
2890,永豐金,107,0,107,合庫-台中,2024-04-02,1021
00650L,復華香港正2,356,256,100,合庫-台中,2024-04-02,1021
00679B,元大美債20年,99,0,99,合庫-台中,2024-04-02,1021
2886,兆豐金,100,2,98,合庫-台中,2024-04-02,1021
00751B,元大AAA至A公司債,94,6,88,合庫-台中,2024-04-02,1021
00941,中信上游半導體,64,6,58,合庫-台中,2024-04-02,1021
6005,群益證,58,0,58,合庫-台中,2024-04-02,1021
2369,菱生,58,1,57,合庫-台中,2024-04-02,1021
6414,樺漢,95,40,55,合庫-台中,2024-04-02,1021
3231,緯創,130,76,54,合庫-台中,2024-04-02,1021
3666,光耀,53,0,53,合庫-台中,2024-04-02,1021
5443,均豪,94,42,52,合庫-台中,2024-04-02,1021
00637L,元大滬深300正2,1308,1257,51,合庫-台中,2024-04-02,1021
2371,大同,74,24,50,合庫-台中,2024-04-02,1021
2892,第一金,51,1,50,合庫-台中,2024-04-02,1021
2409,友達,46,1,45,合庫-台中,2024-04-02,1021
00688L,國泰20年美債正2,45,0,45,合庫-台中,2024-04-02,1021
00655L,國泰中國A50正2,41,1,40,合庫-台中,2024-04-02,1021
2461,光群雷,40,0,40,合庫-台中,2024-04-02,1021
00795B,中信美國公債20年,38,0,38,合庫-台中,2024-04-02,1021
2382,廣達,192,156,36,合庫-台中,2024-04-02,1021
00753L,中信中國50正2,51,16,35,合庫-台中,2024-04-02,1021
3122,笙泉,34,0,34,合庫-台中,2024-04-02,1021
00929,復華台灣科技優息,307,274,33,合庫-台中,2024-04-02,1021
1524,耿鼎,36,4,32,合庫-台中,2024-04-02,1021
00933B,國泰10Y+金融債,89,58,31,合庫-台中,2024-04-02,1021
4967,十銓,35,4,31,合庫-台中,2024-04-02,1021
1513,中興電,45,14,31,合庫-台中,2024-04-02,1021
5351,鈺創,82,53,29,合庫-台中,2024-04-02,1021
2301,光寶科,82,53,29,合庫-台中,2024-04-02,1021
2636,台驊控股,28,0,28,合庫-台中,2024-04-02,1021
1722,台肥,33,5,28,合庫-台中,2024-04-02,1021
2344,華邦電,130,103,27,合庫-台中,2024-04-02,1021
1725,元禎,31,6,25,合庫-台中,2024-04-02,1021
2359,所羅門,29,4,25,合庫-台中,2024-04-02,1021
6532,瑞耘,25,1,24,合庫-台中,2024-04-02,1021
1905,華紙,24,1,23,合庫-台中,2024-04-02,1021
00857B,永豐20年美公債,23,0,23,合庫-台中,2024-04-02,1021
5371,中光電,36,13,23,合庫-台中,2024-04-02,1021
2027,大成鋼,22,0,22,合庫-台中,2024-04-02,1021
00931B,統一美債20年,22,0,22,合庫-台中,2024-04-02,1021
00940,元大台灣價值高息,611,36,575,合庫-台中,2024-04-03,1021
00929,復華台灣科技優息,402,2,400,合庫-台中,2024-04-03,1021
4716,大立,252,2,250,合庫-台中,2024-04-03,1021
00673R,期元大S＆P原油反1,212,0,212,合庫-台中,2024-04-03,1021
3481,群創,199,20,179,合庫-台中,2024-04-03,1021
00680L,元大美債20正2,168,0,168,合庫-台中,2024-04-03,1021
00687B,國泰20年美債,172,10,162,合庫-台中,2024-04-03,1021
00751B,元大AAA至A公司債,142,2,140,合庫-台中,2024-04-03,1021
00679B,元大美債20年,140,18,122,合庫-台中,2024-04-03,1021
00706L,期元大S＆P日圓正2,120,0,120,合庫-台中,2024-04-03,1021
1101,台泥,140,25,115,合庫-台中,2024-04-03,1021
2409,友達,136,22,114,合庫-台中,2024-04-03,1021
00720B,元大投資級公司債,109,5,104,合庫-台中,2024-04-03,1021
2382,廣達,128,40,88,合庫-台中,2024-04-03,1021
00939,統一台灣高息動能,95,14,81,合庫-台中,2024-04-03,1021
2323,中環,100,20,80,合庫-台中,2024-04-03,1021
2834,臺企銀,74,0,74,合庫-台中,2024-04-03,1021
2002,中鋼,151,78,73,合庫-台中,2024-04-03,1021
2317,鴻海,108,39,69,合庫-台中,2024-04-03,1021
2884,玉山金,68,2,66,合庫-台中,2024-04-03,1021
1795,美時,62,4,58,合庫-台中,2024-04-03,1021
4109,加捷生醫,50,0,50,合庫-台中,2024-04-03,1021
5905,南仁湖,50,0,50,合庫-台中,2024-04-03,1021
00927,群益半導體收益,51,2,49,合庫-台中,2024-04-03,1021
2486,一詮,162,113,49,合庫-台中,2024-04-03,1021
5880,合庫金,59,11,48,合庫-台中,2024-04-03,1021
1504,東元,54,13,41,合庫-台中,2024-04-03,1021
2303,聯電,45,9,36,合庫-台中,2024-04-03,1021
2610,華航,36,1,35,合庫-台中,2024-04-03,1021
2801,彰銀,34,0,34,合庫-台中,2024-04-03,1021
2371,大同,63,29,34,合庫-台中,2024-04-03,1021
8064,東捷,101,67,34,合庫-台中,2024-04-03,1021
00941,中信上游半導體,70,37,33,合庫-台中,2024-04-03,1021
6414,樺漢,38,6,32,合庫-台中,2024-04-03,1021
1609,大亞,80,48,32,合庫-台中,2024-04-03,1021
1802,台玻,41,9,32,合庫-台中,2024-04-03,1021
4198,欣大健康,32,0,32,合庫-台中,2024-04-03,1021
1568,倉佑,31,0,31,合庫-台中,2024-04-03,1021
8163,達方,32,1,31,合庫-台中,2024-04-03,1021
00878,國泰永續高股息,37,6,31,合庫-台中,2024-04-03,1021
6189,豐藝,38,8,30,合庫-台中,2024-04-03,1021
2498,宏達電,30,1,29,合庫-台中,2024-04-03,1021
00637L,元大滬深300正2,1109,1080,29,合庫-台中,2024-04-03,1021
2618,長榮航,34,5,29,合庫-台中,2024-04-03,1021
00696B,富邦美債20年,28,0,28,合庫-台中,2024-04-03,1021
2105,正新,27,0,27,合庫-台中,2024-04-03,1021
9934,成霖,27,0,27,合庫-台中,2024-04-03,1021
2887,台新金,27,1,26,合庫-台中,2024-04-03,1021
2301,光寶科,54,29,25,合庫-台中,2024-04-03,1021
00632R,元大台灣50反1,25,0,25,合庫-台中,2024-04-03,1021
00940,元大台灣價值高息,697,29,668,合庫-台中,2024-04-08,1021
00929,復華台灣科技優息,442,22,420,合庫-台中,2024-04-08,1021
1815,富喬,316,0,316,合庫-台中,2024-04-08,1021
00679B,元大美債20年,241,4,237,合庫-台中,2024-04-08,1021
00919,群益台灣精選高息,246,41,205,合庫-台中,2024-04-08,1021
6120,達運,162,1,161,合庫-台中,2024-04-08,1021
00937B,群益ESG投等債20,329,177,152,合庫-台中,2024-04-08,1021
00673R,期元大S＆P原油反1,123,0,123,合庫-台中,2024-04-08,1021
00687B,國泰20年美債,108,2,106,合庫-台中,2024-04-08,1021
2014,中鴻,108,7,101,合庫-台中,2024-04-08,1021
00680L,元大美債20正2,98,5,93,合庫-台中,2024-04-08,1021
00751B,元大AAA至A公司債,112,26,86,合庫-台中,2024-04-08,1021
3056,富華新,93,13,80,合庫-台中,2024-04-08,1021
00927,群益半導體收益,73,0,73,合庫-台中,2024-04-08,1021
2371,大同,83,16,67,合庫-台中,2024-04-08,1021
00637L,元大滬深300正2,1591,1534,57,合庫-台中,2024-04-08,1021
4533,協易機,64,10,54,合庫-台中,2024-04-08,1021
2356,英業達,86,32,54,合庫-台中,2024-04-08,1021
2501,國建,55,3,52,合庫-台中,2024-04-08,1021
3576,聯合再生,50,1,49,合庫-台中,2024-04-08,1021
6146,耕興,47,0,47,合庫-台中,2024-04-08,1021
00688L,國泰20年美債正2,51,5,46,合庫-台中,2024-04-08,1021
00720B,元大投資級公司債,44,1,43,合庫-台中,2024-04-08,1021
6177,達麗,42,1,41,合庫-台中,2024-04-08,1021
2374,佳能,101,62,39,合庫-台中,2024-04-08,1021
00795B,中信美國公債20年,39,0,39,合庫-台中,2024-04-08,1021
00933B,國泰10Y+金融債,39,0,39,合庫-台中,2024-04-08,1021
2442,新美齊,39,1,38,合庫-台中,2024-04-08,1021
2881,富邦金,36,0,36,合庫-台中,2024-04-08,1021
2417,圓剛,35,1,34,合庫-台中,2024-04-08,1021
1722,台肥,34,0,34,合庫-台中,2024-04-08,1021
2408,南亞科,36,2,34,合庫-台中,2024-04-08,1021
3227,原相,38,5,33,合庫-台中,2024-04-08,1021
00665L,富邦�琤肭磪囓�2,727,694,33,合庫-台中,2024-04-08,1021
1587,吉茂,32,0,32,合庫-台中,2024-04-08,1021
8054,安國,53,21,32,合庫-台中,2024-04-08,1021
4306,炎洲,35,6,29,合庫-台中,2024-04-08,1021
1532,勤美,26,0,26,合庫-台中,2024-04-08,1021
2103,台橡,25,0,25,合庫-台中,2024-04-08,1021
3005,神基,42,17,25,合庫-台中,2024-04-08,1021
6438,迅得,24,1,23,合庫-台中,2024-04-08,1021
8064,東捷,31,9,22,合庫-台中,2024-04-08,1021
2388,威盛,21,0,21,合庫-台中,2024-04-08,1021
2355,敬鵬,22,1,21,合庫-台中,2024-04-08,1021
8930,青鋼,20,0,20,合庫-台中,2024-04-08,1021
3322,建舜電,20,0,20,合庫-台中,2024-04-08,1021
2033,佳大,20,0,20,合庫-台中,2024-04-08,1021
8926,台汽電,29,10,19,合庫-台中,2024-04-08,1021
2838,聯邦銀,50,31,19,合庫-台中,2024-04-08,1021
6419,京晨科,19,0,19,合庫-台中,2024-04-08,1021
00673R,期元大S＆P原油反1,506,0,506,合庫-台中,2024-04-09,1021
00929,復華台灣科技優息,265,6,259,合庫-台中,2024-04-09,1021
00937B,群益ESG投等債20,258,15,243,合庫-台中,2024-04-09,1021
3231,緯創,256,62,194,合庫-台中,2024-04-09,1021
2367,燿華,237,44,193,合庫-台中,2024-04-09,1021
2323,中環,241,110,131,合庫-台中,2024-04-09,1021
00940,元大台灣價值高息,278,162,116,合庫-台中,2024-04-09,1021
3056,富華新,105,1,104,合庫-台中,2024-04-09,1021
2382,廣達,132,61,71,合庫-台中,2024-04-09,1021
2371,大同,145,84,61,合庫-台中,2024-04-09,1021
00637L,元大滬深300正2,1193,1134,59,合庫-台中,2024-04-09,1021
6163,華電網,88,31,57,合庫-台中,2024-04-09,1021
00715L,期街口布蘭特正2,56,10,46,合庫-台中,2024-04-09,1021
2014,中鴻,252,208,44,合庫-台中,2024-04-09,1021
5351,鈺創,41,0,41,合庫-台中,2024-04-09,1021
00939,統一台灣高息動能,64,25,39,合庫-台中,2024-04-09,1021
00679B,元大美債20年,36,1,35,合庫-台中,2024-04-09,1021
3005,神基,42,7,35,合庫-台中,2024-04-09,1021
00919,群益台灣精選高息,76,42,34,合庫-台中,2024-04-09,1021
2501,國建,32,1,31,合庫-台中,2024-04-09,1021
2349,錸德,30,0,30,合庫-台中,2024-04-09,1021
1101,台泥,33,3,30,合庫-台中,2024-04-09,1021
3466,德晉,36,7,29,合庫-台中,2024-04-09,1021
2313,華通,196,167,29,合庫-台中,2024-04-09,1021
1423,利華,28,0,28,合庫-台中,2024-04-09,1021
00941,中信上游半導體,30,3,27,合庫-台中,2024-04-09,1021
4533,協易機,84,57,27,合庫-台中,2024-04-09,1021
6188,廣明,72,46,26,合庫-台中,2024-04-09,1021
2062,橋椿,46,20,26,合庫-台中,2024-04-09,1021
1416,廣豐,25,0,25,合庫-台中,2024-04-09,1021
4714,永捷,23,0,23,合庫-台中,2024-04-09,1021
3042,晶技,24,2,22,合庫-台中,2024-04-09,1021
00687B,國泰20年美債,32,11,21,合庫-台中,2024-04-09,1021
9105,泰金寶-DR,20,0,20,合庫-台中,2024-04-09,1021
2417,圓剛,22,3,19,合庫-台中,2024-04-09,1021
9902,台火,19,0,19,合庫-台中,2024-04-09,1021
1417,嘉裕,20,1,19,合庫-台中,2024-04-09,1021
2359,所羅門,24,7,17,合庫-台中,2024-04-09,1021
9933,中鼎,22,5,17,合庫-台中,2024-04-09,1021
1530,亞崴,17,0,17,合庫-台中,2024-04-09,1021
3013,晟銘電,74,58,16,合庫-台中,2024-04-09,1021
2603,長榮,23,7,16,合庫-台中,2024-04-09,1021
2884,玉山金,18,2,16,合庫-台中,2024-04-09,1021
1514,亞力,43,27,16,合庫-台中,2024-04-09,1021
3037,欣興,16,1,15,合庫-台中,2024-04-09,1021
2425,承啟,15,0,15,合庫-台中,2024-04-09,1021
1702,南僑,15,0,15,合庫-台中,2024-04-09,1021
6207,雷科,93,79,14,合庫-台中,2024-04-09,1021
3006,晶豪科,14,0,14,合庫-台中,2024-04-09,1021
2881,富邦金,28,14,14,合庫-台中,2024-04-09,1021
1514,亞力,631,232,399,合庫-台中,2024-04-10,1021
00688L,國泰20年美債正2,215,30,185,合庫-台中,2024-04-10,1021
9902,台火,152,0,152,合庫-台中,2024-04-10,1021
00632R,元大台灣50反1,136,4,132,合庫-台中,2024-04-10,1021
2014,中鴻,146,15,131,合庫-台中,2024-04-10,1021
00715L,期街口布蘭特正2,128,0,128,合庫-台中,2024-04-10,1021
00937B,群益ESG投等債20,139,24,115,合庫-台中,2024-04-10,1021
2618,長榮航,116,15,101,合庫-台中,2024-04-10,1021
3231,緯創,135,37,98,合庫-台中,2024-04-10,1021
3056,富華新,124,34,90,合庫-台中,2024-04-10,1021
2464,盟立,129,46,83,合庫-台中,2024-04-10,1021
6419,京晨科,91,10,81,合庫-台中,2024-04-10,1021
2002,中鋼,162,82,80,合庫-台中,2024-04-10,1021
00637L,元大滬深300正2,521,449,72,合庫-台中,2024-04-10,1021
00650L,復華香港正2,500,429,71,合庫-台中,2024-04-10,1021
1608,華榮,149,79,70,合庫-台中,2024-04-10,1021
2371,大同,81,11,70,合庫-台中,2024-04-10,1021
6016,康和證,75,6,69,合庫-台中,2024-04-10,1021
2883,凱基金,79,11,68,合庫-台中,2024-04-10,1021
00940,元大台灣價值高息,204,141,63,合庫-台中,2024-04-10,1021
2376,技嘉,73,16,57,合庫-台中,2024-04-10,1021
3481,群創,184,130,54,合庫-台中,2024-04-10,1021
00673R,期元大S＆P原油反1,50,0,50,合庫-台中,2024-04-10,1021
1416,廣豐,49,0,49,合庫-台中,2024-04-10,1021
00941,中信上游半導體,65,17,48,合庫-台中,2024-04-10,1021
8096,擎亞,75,30,45,合庫-台中,2024-04-10,1021
2062,橋椿,80,35,45,合庫-台中,2024-04-10,1021
2025,千興,47,2,45,合庫-台中,2024-04-10,1021
2457,飛宏,40,0,40,合庫-台中,2024-04-10,1021
2382,廣達,101,64,37,合庫-台中,2024-04-10,1021
1513,中興電,76,40,36,合庫-台中,2024-04-10,1021
2442,新美齊,35,1,34,合庫-台中,2024-04-10,1021
5371,中光電,45,12,33,合庫-台中,2024-04-10,1021
2515,中工,138,106,32,合庫-台中,2024-04-10,1021
2891,中信金,32,0,32,合庫-台中,2024-04-10,1021
00687B,國泰20年美債,41,12,29,合庫-台中,2024-04-10,1021
1618,合機,29,3,26,合庫-台中,2024-04-10,1021
2301,光寶科,28,3,25,合庫-台中,2024-04-10,1021
6505,台塑化,25,1,24,合庫-台中,2024-04-10,1021
1455,集盛,22,0,22,合庫-台中,2024-04-10,1021
1503,士電,80,58,22,合庫-台中,2024-04-10,1021
00933B,國泰10Y+金融債,42,20,22,合庫-台中,2024-04-10,1021
1722,台肥,30,10,20,合庫-台中,2024-04-10,1021
2349,錸德,20,0,20,合庫-台中,2024-04-10,1021
6026,福邦證,22,2,20,合庫-台中,2024-04-10,1021
2009,第一銅,149,130,19,合庫-台中,2024-04-10,1021
6215,和椿,68,49,19,合庫-台中,2024-04-10,1021
8064,東捷,30,11,19,合庫-台中,2024-04-10,1021
2915,潤泰全,20,2,18,合庫-台中,2024-04-10,1021
2105,正新,18,0,18,合庫-台中,2024-04-10,1021
9902,台火,344,6,338,合庫-台中,2024-04-11,1021
3481,群創,335,21,314,合庫-台中,2024-04-11,1021
00680L,元大美債20正2,295,0,295,合庫-台中,2024-04-11,1021
2353,宏��,399,105,294,合庫-台中,2024-04-11,1021
2002,中鋼,252,9,243,合庫-台中,2024-04-11,1021
2610,華航,334,139,195,合庫-台中,2024-04-11,1021
00687B,國泰20年美債,167,10,157,合庫-台中,2024-04-11,1021
00673R,期元大S＆P原油反1,152,0,152,合庫-台中,2024-04-11,1021
2537,聯上發,163,14,149,合庫-台中,2024-04-11,1021
00706L,期元大S＆P日圓正2,210,62,148,合庫-台中,2024-04-11,1021
00712,復華富時不動產,147,3,144,合庫-台中,2024-04-11,1021
00720B,元大投資級公司債,161,30,131,合庫-台中,2024-04-11,1021
6770,力積電,139,16,123,合庫-台中,2024-04-11,1021
00751B,元大AAA至A公司債,121,0,121,合庫-台中,2024-04-11,1021
00679B,元大美債20年,204,87,117,合庫-台中,2024-04-11,1021
00931B,統一美債20年,111,0,111,合庫-台中,2024-04-11,1021
9919,康那香,96,0,96,合庫-台中,2024-04-11,1021
2634,漢翔,148,57,91,合庫-台中,2024-04-11,1021
3231,緯創,164,96,68,合庫-台中,2024-04-11,1021
00937B,群益ESG投等債20,237,176,61,合庫-台中,2024-04-11,1021
2303,聯電,69,10,59,合庫-台中,2024-04-11,1021
2313,華通,101,43,58,合庫-台中,2024-04-11,1021
2371,大同,129,73,56,合庫-台中,2024-04-11,1021
5351,鈺創,56,2,54,合庫-台中,2024-04-11,1021
2409,友達,93,42,51,合庫-台中,2024-04-11,1021
2329,華泰,105,63,42,合庫-台中,2024-04-11,1021
00940,元大台灣價值高息,166,124,42,合庫-台中,2024-04-11,1021
1455,集盛,44,4,40,合庫-台中,2024-04-11,1021
8064,東捷,73,33,40,合庫-台中,2024-04-11,1021
00664R,國泰臺灣加權反1,40,0,40,合庫-台中,2024-04-11,1021
00665L,富邦�琤肭磪囓�2,580,540,40,合庫-台中,2024-04-11,1021
2903,遠百,40,1,39,合庫-台中,2024-04-11,1021
0056,元大高股息,39,3,36,合庫-台中,2024-04-11,1021
2603,長榮,58,24,34,合庫-台中,2024-04-11,1021
2630,亞航,111,78,33,合庫-台中,2024-04-11,1021
4967,十銓,89,56,33,合庫-台中,2024-04-11,1021
1314,中石化,91,60,31,合庫-台中,2024-04-11,1021
00637L,元大滬深300正2,1295,1265,30,合庫-台中,2024-04-11,1021
6117,迎廣,77,48,29,合庫-台中,2024-04-11,1021
1530,亞崴,28,0,28,合庫-台中,2024-04-11,1021
2312,金寶,31,3,28,合庫-台中,2024-04-11,1021
2382,廣達,55,28,27,合庫-台中,2024-04-11,1021
00927,群益半導體收益,29,2,27,合庫-台中,2024-04-11,1021
2062,橋椿,47,21,26,合庫-台中,2024-04-11,1021
6505,台塑化,26,0,26,合庫-台中,2024-04-11,1021
1605,華新,45,20,25,合庫-台中,2024-04-11,1021
4109,加捷生醫,24,0,24,合庫-台中,2024-04-11,1021
6179,亞通,25,1,24,合庫-台中,2024-04-11,1021
2405,輔信,23,0,23,合庫-台中,2024-04-11,1021
3013,晟銘電,59,36,23,合庫-台中,2024-04-11,1021
00937B,群益ESG投等債20,398,6,392,合庫-台中,2024-04-12,1021
2317,鴻海,480,109,371,合庫-台中,2024-04-12,1021
00665L,富邦�琤肭磪囓�2,716,440,276,合庫-台中,2024-04-12,1021
00680L,元大美債20正2,244,0,244,合庫-台中,2024-04-12,1021
2888,新光金,196,1,195,合庫-台中,2024-04-12,1021
00687B,國泰20年美債,178,1,177,合庫-台中,2024-04-12,1021
2356,英業達,150,15,135,合庫-台中,2024-04-12,1021
00679B,元大美債20年,141,10,131,合庫-台中,2024-04-12,1021
00715L,期街口布蘭特正2,127,3,124,合庫-台中,2024-04-12,1021
3523,迎輝,113,0,113,合庫-台中,2024-04-12,1021
2002,中鋼,113,10,103,合庫-台中,2024-04-12,1021
2382,廣達,127,26,101,合庫-台中,2024-04-12,1021
2882,國泰金,121,20,101,合庫-台中,2024-04-12,1021
2501,國建,138,43,95,合庫-台中,2024-04-12,1021
9919,康那香,93,2,91,合庫-台中,2024-04-12,1021
3481,群創,145,64,81,合庫-台中,2024-04-12,1021
00933B,國泰10Y+金融債,72,3,69,合庫-台中,2024-04-12,1021
6177,達麗,64,0,64,合庫-台中,2024-04-12,1021
00929,復華台灣科技優息,160,97,63,合庫-台中,2024-04-12,1021
00751B,元大AAA至A公司債,62,0,62,合庫-台中,2024-04-12,1021
2427,三商電,66,4,62,合庫-台中,2024-04-12,1021
00878,國泰永續高股息,74,18,56,合庫-台中,2024-04-12,1021
5880,合庫金,60,5,55,合庫-台中,2024-04-12,1021
00664R,國泰臺灣加權反1,50,0,50,合庫-台中,2024-04-12,1021
2887,台新金,55,5,50,合庫-台中,2024-04-12,1021
6419,京晨科,59,12,47,合庫-台中,2024-04-12,1021
3294,英濟,72,30,42,合庫-台中,2024-04-12,1021
2340,台亞,54,13,41,合庫-台中,2024-04-12,1021
3011,今皓,40,0,40,合庫-台中,2024-04-12,1021
2745,五福,40,2,38,合庫-台中,2024-04-12,1021
00882,中信中國高股息,37,0,37,合庫-台中,2024-04-12,1021
00720B,元大投資級公司債,37,1,36,合庫-台中,2024-04-12,1021
3339,泰谷,36,0,36,合庫-台中,2024-04-12,1021
8033,雷虎,39,5,34,合庫-台中,2024-04-12,1021
8096,擎亞,62,28,34,合庫-台中,2024-04-12,1021
2329,華泰,62,29,33,合庫-台中,2024-04-12,1021
2881,富邦金,27,0,27,合庫-台中,2024-04-12,1021
6505,台塑化,27,0,27,合庫-台中,2024-04-12,1021
3260,威剛,52,29,23,合庫-台中,2024-04-12,1021
2464,盟立,41,18,23,合庫-台中,2024-04-12,1021
2374,佳能,28,5,23,合庫-台中,2024-04-12,1021
4541,晟田,23,0,23,合庫-台中,2024-04-12,1021
2444,兆勁,22,0,22,合庫-台中,2024-04-12,1021
6116,彩晶,26,4,22,合庫-台中,2024-04-12,1021
2883,凱基金,40,19,21,合庫-台中,2024-04-12,1021
3325,旭品,21,0,21,合庫-台中,2024-04-12,1021
1316,上曜,23,2,21,合庫-台中,2024-04-12,1021
8111,立��,21,0,21,合庫-台中,2024-04-12,1021
4938,和碩,26,6,20,合庫-台中,2024-04-12,1021
1312,國喬,20,0,20,合庫-台中,2024-04-12,1021
2371,大同,1074,313,761,合庫-台中,2024-04-15,1021
00929,復華台灣科技優息,742,134,608,合庫-台中,2024-04-15,1021
0056,元大高股息,582,1,581,合庫-台中,2024-04-15,1021
00941,中信上游半導體,229,1,228,合庫-台中,2024-04-15,1021
1609,大亞,470,325,145,合庫-台中,2024-04-15,1021
1608,華榮,250,116,134,合庫-台中,2024-04-15,1021
00937B,群益ESG投等債20,136,11,125,合庫-台中,2024-04-15,1021
00664R,國泰臺灣加權反1,130,10,120,合庫-台中,2024-04-15,1021
2356,英業達,133,16,117,合庫-台中,2024-04-15,1021
2867,三商壽,143,26,117,合庫-台中,2024-04-15,1021
1504,東元,212,115,97,合庫-台中,2024-04-15,1021
5009,榮剛,146,65,81,合庫-台中,2024-04-15,1021
2883,凱基金,104,24,80,合庫-台中,2024-04-15,1021
00940,元大台灣價值高息,357,280,77,合庫-台中,2024-04-15,1021
00679B,元大美債20年,78,4,74,合庫-台中,2024-04-15,1021
00939,統一台灣高息動能,92,22,70,合庫-台中,2024-04-15,1021
00919,群益台灣精選高息,87,20,67,合庫-台中,2024-04-15,1021
6419,京晨科,61,0,61,合庫-台中,2024-04-15,1021
2002,中鋼,65,6,59,合庫-台中,2024-04-15,1021
00665L,富邦�琤肭磪囓�2,461,403,58,合庫-台中,2024-04-15,1021
2303,聯電,79,23,56,合庫-台中,2024-04-15,1021
1513,中興電,159,105,54,合庫-台中,2024-04-15,1021
00927,群益半導體收益,52,0,52,合庫-台中,2024-04-15,1021
2009,第一銅,63,14,49,合庫-台中,2024-04-15,1021
3005,神基,53,5,48,合庫-台中,2024-04-15,1021
00712,復華富時不動產,71,24,47,合庫-台中,2024-04-15,1021
2801,彰銀,51,4,47,合庫-台中,2024-04-15,1021
6770,力積電,45,0,45,合庫-台中,2024-04-15,1021
1464,得力,45,0,45,合庫-台中,2024-04-15,1021
00715L,期街口布蘭特正2,44,0,44,合庫-台中,2024-04-15,1021
2405,輔信,44,0,44,合庫-台中,2024-04-15,1021
3052,夆典,40,0,40,合庫-台中,2024-04-15,1021
00936,台新永續高息中小,40,0,40,合庫-台中,2024-04-15,1021
8121,越峰,43,3,40,合庫-台中,2024-04-15,1021
6016,康和證,40,0,40,合庫-台中,2024-04-15,1021
2324,仁寶,47,10,37,合庫-台中,2024-04-15,1021
1612,宏泰,69,33,36,合庫-台中,2024-04-15,1021
6188,廣明,36,1,35,合庫-台中,2024-04-15,1021
00909,國泰數位支付服務,42,10,32,合庫-台中,2024-04-15,1021
1815,富喬,33,1,32,合庫-台中,2024-04-15,1021
9934,成霖,66,34,32,合庫-台中,2024-04-15,1021
2367,燿華,56,26,30,合庫-台中,2024-04-15,1021
2444,兆勁,30,0,30,合庫-台中,2024-04-15,1021
1339,昭輝,30,0,30,合庫-台中,2024-04-15,1021
1444,力麗,30,0,30,合庫-台中,2024-04-15,1021
4960,誠美材,31,2,29,合庫-台中,2024-04-15,1021
1540,喬福,32,3,29,合庫-台中,2024-04-15,1021
2618,長榮航,41,13,28,合庫-台中,2024-04-15,1021
2486,一詮,32,5,27,合庫-台中,2024-04-15,1021
9938,百和,28,1,27,合庫-台中,2024-04-15,1021
00940,元大台灣價值高息,1501,134,1367,合庫-台中,2024-04-16,1021
00937B,群益ESG投等債20,967,27,940,合庫-台中,2024-04-16,1021
00919,群益台灣精選高息,871,35,836,合庫-台中,2024-04-16,1021
00929,復華台灣科技優息,691,62,629,合庫-台中,2024-04-16,1021
00939,統一台灣高息動能,400,19,381,合庫-台中,2024-04-16,1021
00941,中信上游半導體,299,34,265,合庫-台中,2024-04-16,1021
2834,臺企銀,199,40,159,合庫-台中,2024-04-16,1021
9902,台火,157,0,157,合庫-台中,2024-04-16,1021
0056,元大高股息,163,16,147,合庫-台中,2024-04-16,1021
00878,國泰永續高股息,265,118,147,合庫-台中,2024-04-16,1021
00680L,元大美債20正2,156,10,146,合庫-台中,2024-04-16,1021
00720B,元大投資級公司債,131,0,131,合庫-台中,2024-04-16,1021
2887,台新金,130,0,130,合庫-台中,2024-04-16,1021
1609,大亞,294,167,127,合庫-台中,2024-04-16,1021
00751B,元大AAA至A公司債,125,5,120,合庫-台中,2024-04-16,1021
2630,亞航,239,119,120,合庫-台中,2024-04-16,1021
6419,京晨科,145,31,114,合庫-台中,2024-04-16,1021
5880,合庫金,160,50,110,合庫-台中,2024-04-16,1021
6116,彩晶,115,5,110,合庫-台中,2024-04-16,1021
1605,華新,124,20,104,合庫-台中,2024-04-16,1021
3481,群創,112,14,98,合庫-台中,2024-04-16,1021
2344,華邦電,124,27,97,合庫-台中,2024-04-16,1021
2603,長榮,108,11,97,合庫-台中,2024-04-16,1021
00885,富邦越南,100,10,90,合庫-台中,2024-04-16,1021
2486,一詮,96,13,83,合庫-台中,2024-04-16,1021
00712,復華富時不動產,91,8,83,合庫-台中,2024-04-16,1021
3163,波若威,82,6,76,合庫-台中,2024-04-16,1021
2303,聯電,114,41,73,合庫-台中,2024-04-16,1021
00664R,國泰臺灣加權反1,70,0,70,合庫-台中,2024-04-16,1021
3231,緯創,104,35,69,合庫-台中,2024-04-16,1021
00927,群益半導體收益,64,0,64,合庫-台中,2024-04-16,1021
00665L,富邦�琤肭磪囓�2,518,455,63,合庫-台中,2024-04-16,1021
2884,玉山金,69,10,59,合庫-台中,2024-04-16,1021
8440,綠電,110,54,56,合庫-台中,2024-04-16,1021
2890,永豐金,57,2,55,合庫-台中,2024-04-16,1021
2313,華通,288,233,55,合庫-台中,2024-04-16,1021
2801,彰銀,53,0,53,合庫-台中,2024-04-16,1021
2886,兆豐金,57,4,53,合庫-台中,2024-04-16,1021
4973,廣穎,52,0,52,合庫-台中,2024-04-16,1021
2880,華南金,48,0,48,合庫-台中,2024-04-16,1021
2208,台船,52,4,48,合庫-台中,2024-04-16,1021
00679B,元大美債20年,68,22,46,合庫-台中,2024-04-16,1021
2888,新光金,44,0,44,合庫-台中,2024-04-16,1021
00753L,中信中國50正2,56,12,44,合庫-台中,2024-04-16,1021
2515,中工,54,11,43,合庫-台中,2024-04-16,1021
2618,長榮航,71,29,42,合庫-台中,2024-04-16,1021
2330,台積電,58,18,40,合庫-台中,2024-04-16,1021
2324,仁寶,46,6,40,合庫-台中,2024-04-16,1021
9945,潤泰新,42,3,39,合庫-台中,2024-04-16,1021
1568,倉佑,39,0,39,合庫-台中,2024-04-16,1021
00929,復華台灣科技優息,451,24,427,合庫-台中,2024-04-17,1021
00937B,群益ESG投等債20,413,3,410,合庫-台中,2024-04-17,1021
3231,緯創,347,91,256,合庫-台中,2024-04-17,1021
00650L,復華香港正2,601,400,201,合庫-台中,2024-04-17,1021
00940,元大台灣價值高息,259,74,185,合庫-台中,2024-04-17,1021
3523,迎輝,152,2,150,合庫-台中,2024-04-17,1021
2618,長榮航,239,113,126,合庫-台中,2024-04-17,1021
0056,元大高股息,127,13,114,合庫-台中,2024-04-17,1021
1503,士電,129,19,110,合庫-台中,2024-04-17,1021
00933B,國泰10Y+金融債,111,2,109,合庫-台中,2024-04-17,1021
00712,復華富時不動產,94,0,94,合庫-台中,2024-04-17,1021
00878,國泰永續高股息,129,36,93,合庫-台中,2024-04-17,1021
4532,瑞智,104,13,91,合庫-台中,2024-04-17,1021
6125,廣運,121,34,87,合庫-台中,2024-04-17,1021
3481,群創,92,11,81,合庫-台中,2024-04-17,1021
2704,國賓,143,64,79,合庫-台中,2024-04-17,1021
00905,FT臺灣Smart,75,0,75,合庫-台中,2024-04-17,1021
5880,合庫金,77,2,75,合庫-台中,2024-04-17,1021
6239,力成,75,5,70,合庫-台中,2024-04-17,1021
00720B,元大投資級公司債,68,0,68,合庫-台中,2024-04-17,1021
00679B,元大美債20年,95,30,65,合庫-台中,2024-04-17,1021
2356,英業達,136,77,59,合庫-台中,2024-04-17,1021
2892,第一金,52,0,52,合庫-台中,2024-04-17,1021
2408,南亞科,53,3,50,合庫-台中,2024-04-17,1021
00857B,永豐20年美公債,60,10,50,合庫-台中,2024-04-17,1021
2888,新光金,49,1,48,合庫-台中,2024-04-17,1021
00901,永豐智能車供應鏈,50,5,45,合庫-台中,2024-04-17,1021
3041,揚智,44,0,44,合庫-台中,2024-04-17,1021
1513,中興電,204,162,42,合庫-台中,2024-04-17,1021
00941,中信上游半導體,42,0,42,合庫-台中,2024-04-17,1021
2002,中鋼,43,3,40,合庫-台中,2024-04-17,1021
00665L,富邦�琤肭磪囓�2,480,441,39,合庫-台中,2024-04-17,1021
00715L,期街口布蘭特正2,48,9,39,合庫-台中,2024-04-17,1021
2884,玉山金,43,5,38,合庫-台中,2024-04-17,1021
2409,友達,69,31,38,合庫-台中,2024-04-17,1021
2363,矽統,72,38,34,合庫-台中,2024-04-17,1021
2382,廣達,57,26,31,合庫-台中,2024-04-17,1021
00751B,元大AAA至A公司債,33,2,31,合庫-台中,2024-04-17,1021
00687B,國泰20年美債,73,42,31,合庫-台中,2024-04-17,1021
2303,聯電,60,29,31,合庫-台中,2024-04-17,1021
00939,統一台灣高息動能,36,8,28,合庫-台中,2024-04-17,1021
00772B,中信高評級公司債,26,0,26,合庫-台中,2024-04-17,1021
6283,淳安,26,1,25,合庫-台中,2024-04-17,1021
3483,力致,24,0,24,合庫-台中,2024-04-17,1021
2881,富邦金,24,0,24,合庫-台中,2024-04-17,1021
3289,宜特,24,1,23,合庫-台中,2024-04-17,1021
1314,中石化,25,2,23,合庫-台中,2024-04-17,1021
2301,光寶科,31,8,23,合庫-台中,2024-04-17,1021
2374,佳能,22,0,22,合庫-台中,2024-04-17,1021
8070,長華*,21,0,21,合庫-台中,2024-04-17,1021
00937B,群益ESG投等債20,2710,20,2690,合庫-台中,2024-04-18,1021
00706L,期元大S＆P日圓正2,448,0,448,合庫-台中,2024-04-18,1021
00720B,元大投資級公司債,309,10,299,合庫-台中,2024-04-18,1021
1605,華新,303,132,171,合庫-台中,2024-04-18,1021
6282,康舒,203,40,163,合庫-台中,2024-04-18,1021
00929,復華台灣科技優息,152,33,119,合庫-台中,2024-04-18,1021
00941,中信上游半導體,140,23,117,合庫-台中,2024-04-18,1021
00933B,國泰10Y+金融債,110,3,107,合庫-台中,2024-04-18,1021
00940,元大台灣價值高息,127,24,103,合庫-台中,2024-04-18,1021
2329,華泰,126,27,99,合庫-台中,2024-04-18,1021
6770,力積電,108,13,95,合庫-台中,2024-04-18,1021
2356,英業達,95,11,84,合庫-台中,2024-04-18,1021
2504,國產,108,35,73,合庫-台中,2024-04-18,1021
1529,樂事綠能,94,26,68,合庫-台中,2024-04-18,1021
2374,佳能,80,15,65,合庫-台中,2024-04-18,1021
00942B,台新美A公司債20+,64,1,63,合庫-台中,2024-04-18,1021
2867,三商壽,117,60,57,合庫-台中,2024-04-18,1021
00919,群益台灣精選高息,89,34,55,合庫-台中,2024-04-18,1021
2367,燿華,100,53,47,合庫-台中,2024-04-18,1021
2303,聯電,49,2,47,合庫-台中,2024-04-18,1021
2371,大同,341,295,46,合庫-台中,2024-04-18,1021
3339,泰谷,45,1,44,合庫-台中,2024-04-18,1021
1504,東元,134,92,42,合庫-台中,2024-04-18,1021
3015,全漢,43,2,41,合庫-台中,2024-04-18,1021
1503,士電,89,49,40,合庫-台中,2024-04-18,1021
00878,國泰永續高股息,59,20,39,合庫-台中,2024-04-18,1021
00830,國泰費城半導體,38,1,37,合庫-台中,2024-04-18,1021
0056,元大高股息,65,28,37,合庫-台中,2024-04-18,1021
1444,力麗,46,10,36,合庫-台中,2024-04-18,1021
3011,今皓,35,0,35,合庫-台中,2024-04-18,1021
2610,華航,46,12,34,合庫-台中,2024-04-18,1021
5512,力麒,54,20,34,合庫-台中,2024-04-18,1021
00931B,統一美債20年,33,0,33,合庫-台中,2024-04-18,1021
2344,華邦電,33,1,32,合庫-台中,2024-04-18,1021
6120,達運,31,0,31,合庫-台中,2024-04-18,1021
00885,富邦越南,31,0,31,合庫-台中,2024-04-18,1021
6419,京晨科,37,6,31,合庫-台中,2024-04-18,1021
3296,勝德,33,2,31,合庫-台中,2024-04-18,1021
00664R,國泰臺灣加權反1,30,0,30,合庫-台中,2024-04-18,1021
9962,有益,30,0,30,合庫-台中,2024-04-18,1021
2388,威盛,26,2,24,合庫-台中,2024-04-18,1021
1609,大亞,191,168,23,合庫-台中,2024-04-18,1021
5009,榮剛,32,9,23,合庫-台中,2024-04-18,1021
2887,台新金,43,20,23,合庫-台中,2024-04-18,1021
2014,中鴻,65,43,22,合庫-台中,2024-04-18,1021
2002,中鋼,37,15,22,合庫-台中,2024-04-18,1021
2010,春源,27,6,21,合庫-台中,2024-04-18,1021
00679B,元大美債20年,28,7,21,合庫-台中,2024-04-18,1021
2034,允強,20,0,20,合庫-台中,2024-04-18,1021
8390,金益鼎,33,14,19,合庫-台中,2024-04-18,1021
00940,元大台灣價值高息,922,124,798,合庫-台中,2024-04-19,1021
00929,復華台灣科技優息,833,356,477,合庫-台中,2024-04-19,1021
00941,中信上游半導體,425,16,409,合庫-台中,2024-04-19,1021
0056,元大高股息,376,37,339,合庫-台中,2024-04-19,1021
00919,群益台灣精選高息,404,126,278,合庫-台中,2024-04-19,1021
00927,群益半導體收益,234,6,228,合庫-台中,2024-04-19,1021
3231,緯創,297,74,223,合庫-台中,2024-04-19,1021
00687B,國泰20年美債,247,36,211,合庫-台中,2024-04-19,1021
2330,台積電,234,37,197,合庫-台中,2024-04-19,1021
2303,聯電,218,36,182,合庫-台中,2024-04-19,1021
2812,台中銀,189,31,158,合庫-台中,2024-04-19,1021
00937B,群益ESG投等債20,229,84,145,合庫-台中,2024-04-19,1021
00878,國泰永續高股息,189,44,145,合庫-台中,2024-04-19,1021
00939,統一台灣高息動能,252,113,139,合庫-台中,2024-04-19,1021
2887,台新金,137,0,137,合庫-台中,2024-04-19,1021
2888,新光金,178,51,127,合庫-台中,2024-04-19,1021
5880,合庫金,148,28,120,合庫-台中,2024-04-19,1021
00915,凱基優選高股息30,105,0,105,合庫-台中,2024-04-19,1021
6419,京晨科,105,0,105,合庫-台中,2024-04-19,1021
2427,三商電,127,29,98,合庫-台中,2024-04-19,1021
00665L,富邦�琤肭磪囓�2,490,400,90,合庫-台中,2024-04-19,1021
3672,康聯訊,78,0,78,合庫-台中,2024-04-19,1021
00715L,期街口布蘭特正2,322,250,72,合庫-台中,2024-04-19,1021
2547,日勝生,81,12,69,合庫-台中,2024-04-19,1021
1609,大亞,603,536,67,合庫-台中,2024-04-19,1021
1612,宏泰,176,110,66,合庫-台中,2024-04-19,1021
2409,友達,124,60,64,合庫-台中,2024-04-19,1021
2515,中工,433,370,63,合庫-台中,2024-04-19,1021
1504,東元,161,99,62,合庫-台中,2024-04-19,1021
6125,廣運,113,53,60,合庫-台中,2024-04-19,1021
1603,華電,97,39,58,合庫-台中,2024-04-19,1021
2317,鴻海,161,104,57,合庫-台中,2024-04-19,1021
2834,臺企銀,69,15,54,合庫-台中,2024-04-19,1021
3011,今皓,54,0,54,合庫-台中,2024-04-19,1021
9955,佳龍,101,50,51,合庫-台中,2024-04-19,1021
2388,威盛,60,13,47,合庫-台中,2024-04-19,1021
2883,凱基金,72,25,47,合庫-台中,2024-04-19,1021
2891,中信金,45,0,45,合庫-台中,2024-04-19,1021
00725B,國泰投資級公司債,45,0,45,合庫-台中,2024-04-19,1021
2408,南亞科,50,7,43,合庫-台中,2024-04-19,1021
2344,華邦電,54,12,42,合庫-台中,2024-04-19,1021
00712,復華富時不動產,50,10,40,合庫-台中,2024-04-19,1021
2374,佳能,60,21,39,合庫-台中,2024-04-19,1021
8936,國統,86,47,39,合庫-台中,2024-04-19,1021
3013,晟銘電,54,17,37,合庫-台中,2024-04-19,1021
0050,元大台灣50,61,26,35,合庫-台中,2024-04-19,1021
8383,千附,39,4,35,合庫-台中,2024-04-19,1021
1786,科妍,45,11,34,合庫-台中,2024-04-19,1021
1618,合機,154,121,33,合庫-台中,2024-04-19,1021
5515,建國,36,3,33,合庫-台中,2024-04-19,1021
2515,中工,1116,356,760,合庫-台中,2024-04-22,1021
00929,復華台灣科技優息,945,186,759,合庫-台中,2024-04-22,1021
2867,三商壽,535,61,474,合庫-台中,2024-04-22,1021
00940,元大台灣價值高息,395,65,330,合庫-台中,2024-04-22,1021
00939,統一台灣高息動能,180,24,156,合庫-台中,2024-04-22,1021
2547,日勝生,164,42,122,合庫-台中,2024-04-22,1021
00878,國泰永續高股息,140,21,119,合庫-台中,2024-04-22,1021
1457,宜進,118,2,116,合庫-台中,2024-04-22,1021
2409,友達,170,55,115,合庫-台中,2024-04-22,1021
1101,台泥,112,15,97,合庫-台中,2024-04-22,1021
00937B,群益ESG投等債20,209,118,91,合庫-台中,2024-04-22,1021
3672,康聯訊,89,0,89,合庫-台中,2024-04-22,1021
2303,聯電,104,17,87,合庫-台中,2024-04-22,1021
0056,元大高股息,109,23,86,合庫-台中,2024-04-22,1021
1618,合機,183,99,84,合庫-台中,2024-04-22,1021
1440,南紡,114,31,83,合庫-台中,2024-04-22,1021
1616,億泰,88,13,75,合庫-台中,2024-04-22,1021
3481,群創,188,118,70,合庫-台中,2024-04-22,1021
5521,工信,90,20,70,合庫-台中,2024-04-22,1021
5371,中光電,77,12,65,合庫-台中,2024-04-22,1021
3231,緯創,107,42,65,合庫-台中,2024-04-22,1021
00706L,期元大S＆P日圓正2,60,0,60,合庫-台中,2024-04-22,1021
3703,欣陸,153,102,51,合庫-台中,2024-04-22,1021
00751B,元大AAA至A公司債,46,0,46,合庫-台中,2024-04-22,1021
00664R,國泰臺灣加權反1,40,0,40,合庫-台中,2024-04-22,1021
00720B,元大投資級公司債,58,18,40,合庫-台中,2024-04-22,1021
2427,三商電,75,38,37,合庫-台中,2024-04-22,1021
2344,華邦電,48,11,37,合庫-台中,2024-04-22,1021
1513,中興電,122,85,37,合庫-台中,2024-04-22,1021
6770,力積電,38,4,34,合庫-台中,2024-04-22,1021
2330,台積電,43,10,33,合庫-台中,2024-04-22,1021
00687B,國泰20年美債,44,11,33,合庫-台中,2024-04-22,1021
00919,群益台灣精選高息,260,227,33,合庫-台中,2024-04-22,1021
2511,太子,45,13,32,合庫-台中,2024-04-22,1021
5351,鈺創,37,5,32,合庫-台中,2024-04-22,1021
5512,力麒,327,296,31,合庫-台中,2024-04-22,1021
1612,宏泰,46,15,31,合庫-台中,2024-04-22,1021
2605,新興,42,12,30,合庫-台中,2024-04-22,1021
00753L,中信中國50正2,30,0,30,合庫-台中,2024-04-22,1021
00679B,元大美債20年,32,3,29,合庫-台中,2024-04-22,1021
2324,仁寶,32,5,27,合庫-台中,2024-04-22,1021
6125,廣運,47,21,26,合庫-台中,2024-04-22,1021
2009,第一銅,84,59,25,合庫-台中,2024-04-22,1021
3339,泰谷,34,10,24,合庫-台中,2024-04-22,1021
00927,群益半導體收益,24,0,24,合庫-台中,2024-04-22,1021
2539,櫻花建,23,0,23,合庫-台中,2024-04-22,1021
2356,英業達,42,19,23,合庫-台中,2024-04-22,1021
00941,中信上游半導體,55,33,22,合庫-台中,2024-04-22,1021
00891,中信關鍵半導體,24,2,22,合庫-台中,2024-04-22,1021
2382,廣達,32,10,22,合庫-台中,2024-04-22,1021
00665L,富邦�琤肭磪囓�2,767,559,208,合庫-台中,2024-04-23,1021
00929,復華台灣科技優息,214,18,196,合庫-台中,2024-04-23,1021
00919,群益台灣精選高息,175,47,128,合庫-台中,2024-04-23,1021
00940,元大台灣價值高息,136,67,69,合庫-台中,2024-04-23,1021
3523,迎輝,76,7,69,合庫-台中,2024-04-23,1021
6116,彩晶,92,30,62,合庫-台中,2024-04-23,1021
00939,統一台灣高息動能,68,15,53,合庫-台中,2024-04-23,1021
00937B,群益ESG投等債20,73,20,53,合庫-台中,2024-04-23,1021
2867,三商壽,58,5,53,合庫-台中,2024-04-23,1021
6770,力積電,62,13,49,合庫-台中,2024-04-23,1021
5512,力麒,79,38,41,合庫-台中,2024-04-23,1021
2374,佳能,152,112,40,合庫-台中,2024-04-23,1021
3024,憶聲,64,26,38,合庫-台中,2024-04-23,1021
2303,聯電,113,76,37,合庫-台中,2024-04-23,1021
2888,新光金,52,18,34,合庫-台中,2024-04-23,1021
5371,中光電,61,27,34,合庫-台中,2024-04-23,1021
2520,冠德,39,7,32,合庫-台中,2024-04-23,1021
00941,中信上游半導體,31,0,31,合庫-台中,2024-04-23,1021
00706L,期元大S＆P日圓正2,30,0,30,合庫-台中,2024-04-23,1021
00882,中信中國高股息,30,0,30,合庫-台中,2024-04-23,1021
00664R,國泰臺灣加權反1,30,0,30,合庫-台中,2024-04-23,1021
0056,元大高股息,29,3,26,合庫-台中,2024-04-23,1021
2890,永豐金,30,4,26,合庫-台中,2024-04-23,1021
3011,今皓,23,0,23,合庫-台中,2024-04-23,1021
00902,中信電池及儲能,22,0,22,合庫-台中,2024-04-23,1021
1618,合機,88,67,21,合庫-台中,2024-04-23,1021
2330,台積電,33,13,20,合庫-台中,2024-04-23,1021
00927,群益半導體收益,19,0,19,合庫-台中,2024-04-23,1021
3708,上緯投控,37,18,19,合庫-台中,2024-04-23,1021
2301,光寶科,22,4,18,合庫-台中,2024-04-23,1021
3703,欣陸,102,85,17,合庫-台中,2024-04-23,1021
00878,國泰永續高股息,22,6,16,合庫-台中,2024-04-23,1021
00712,復華富時不動產,23,7,16,合庫-台中,2024-04-23,1021
1316,上曜,23,7,16,合庫-台中,2024-04-23,1021
3294,英濟,16,0,16,合庫-台中,2024-04-23,1021
1616,億泰,31,15,16,合庫-台中,2024-04-23,1021
9955,佳龍,15,0,15,合庫-台中,2024-04-23,1021
3535,晶彩科,23,8,15,合庫-台中,2024-04-23,1021
912000,晨訊科-DR,15,0,15,合庫-台中,2024-04-23,1021
6005,群益證,16,2,14,合庫-台中,2024-04-23,1021
4303,信立,34,20,14,合庫-台中,2024-04-23,1021
2344,華邦電,23,9,14,合庫-台中,2024-04-23,1021
5521,工信,36,22,14,合庫-台中,2024-04-23,1021
8936,國統,34,21,13,合庫-台中,2024-04-23,1021
6192,巨路,13,0,13,合庫-台中,2024-04-23,1021
2328,廣宇,13,0,13,合庫-台中,2024-04-23,1021
2884,玉山金,38,25,13,合庫-台中,2024-04-23,1021
00637L,元大滬深300正2,413,401,12,合庫-台中,2024-04-23,1021
2889,國票金,13,1,12,合庫-台中,2024-04-23,1021
2337,旺宏,12,0,12,合庫-台中,2024-04-23,1021
00665L,富邦�琤肭磪囓�2,741,499,242,合庫-台中,2024-04-24,1021
9949,琉園,242,0,242,合庫-台中,2024-04-24,1021
00632R,元大台灣50反1,131,0,131,合庫-台中,2024-04-24,1021
2371,大同,274,187,87,合庫-台中,2024-04-24,1021
2409,友達,93,11,82,合庫-台中,2024-04-24,1021
2101,南港,83,10,73,合庫-台中,2024-04-24,1021
3481,群創,125,61,64,合庫-台中,2024-04-24,1021
3264,欣銓,65,2,63,合庫-台中,2024-04-24,1021
2884,玉山金,70,7,63,合庫-台中,2024-04-24,1021
2886,兆豐金,53,0,53,合庫-台中,2024-04-24,1021
00687B,國泰20年美債,48,0,48,合庫-台中,2024-04-24,1021
6120,達運,63,15,48,合庫-台中,2024-04-24,1021
2630,亞航,52,7,45,合庫-台中,2024-04-24,1021
2890,永豐金,41,0,41,合庫-台中,2024-04-24,1021
00937B,群益ESG投等債20,41,2,39,合庫-台中,2024-04-24,1021
00929,復華台灣科技優息,134,100,34,合庫-台中,2024-04-24,1021
2867,三商壽,35,2,33,合庫-台中,2024-04-24,1021
6419,京晨科,33,1,32,合庫-台中,2024-04-24,1021
3715,定穎投控,61,30,31,合庫-台中,2024-04-24,1021
2536,宏普,33,2,31,合庫-台中,2024-04-24,1021
2834,臺企銀,34,3,31,合庫-台中,2024-04-24,1021
5880,合庫金,36,7,29,合庫-台中,2024-04-24,1021
3005,神基,32,3,29,合庫-台中,2024-04-24,1021
00679B,元大美債20年,27,0,27,合庫-台中,2024-04-24,1021
2501,國建,59,33,26,合庫-台中,2024-04-24,1021
6244,茂迪,26,1,25,合庫-台中,2024-04-24,1021
1612,宏泰,29,6,23,合庫-台中,2024-04-24,1021
3294,英濟,25,2,23,合庫-台中,2024-04-24,1021
5351,鈺創,31,9,22,合庫-台中,2024-04-24,1021
1216,統一,22,0,22,合庫-台中,2024-04-24,1021
3672,康聯訊,21,0,21,合庫-台中,2024-04-24,1021
2812,台中銀,20,0,20,合庫-台中,2024-04-24,1021
1326,台化,20,0,20,合庫-台中,2024-04-24,1021
6451,訊芯-KY,20,0,20,合庫-台中,2024-04-24,1021
3231,緯創,92,72,20,合庫-台中,2024-04-24,1021
1603,華電,31,11,20,合庫-台中,2024-04-24,1021
6005,群益證,21,2,19,合庫-台中,2024-04-24,1021
00637L,元大滬深300正2,497,480,17,合庫-台中,2024-04-24,1021
2509,全坤建,17,0,17,合庫-台中,2024-04-24,1021
1101,台泥,19,3,16,合庫-台中,2024-04-24,1021
1444,力麗,15,0,15,合庫-台中,2024-04-24,1021
00712,復華富時不動產,55,40,15,合庫-台中,2024-04-24,1021
3035,智原,32,19,13,合庫-台中,2024-04-24,1021
5230,雷笛克光學,20,7,13,合庫-台中,2024-04-24,1021
00795B,中信美國公債20年,13,0,13,合庫-台中,2024-04-24,1021
1536,和大,14,1,13,合庫-台中,2024-04-24,1021
00633L,富邦上証正2,13,0,13,合庫-台中,2024-04-24,1021
3059,華晶科,15,2,13,合庫-台中,2024-04-24,1021
6016,康和證,12,0,12,合庫-台中,2024-04-24,1021
2323,中環,17,6,11,合庫-台中,2024-04-24,1021
00665L,富邦�琤肭磪囓�2,1029,641,388,合庫-台中,2024-04-25,1021
00632R,元大台灣50反1,200,10,190,合庫-台中,2024-04-25,1021
00940,元大台灣價值高息,193,37,156,合庫-台中,2024-04-25,1021
00878,國泰永續高股息,143,1,142,合庫-台中,2024-04-25,1021
2618,長榮航,558,428,130,合庫-台中,2024-04-25,1021
3231,緯創,154,29,125,合庫-台中,2024-04-25,1021
00937B,群益ESG投等債20,109,0,109,合庫-台中,2024-04-25,1021
6125,廣運,138,40,98,合庫-台中,2024-04-25,1021
00933B,國泰10Y+金融債,62,3,59,合庫-台中,2024-04-25,1021
2317,鴻海,624,567,57,合庫-台中,2024-04-25,1021
00687B,國泰20年美債,54,2,52,合庫-台中,2024-04-25,1021
2836,高雄銀,50,0,50,合庫-台中,2024-04-25,1021
6770,力積電,49,1,48,合庫-台中,2024-04-25,1021
00929,復華台灣科技優息,127,84,43,合庫-台中,2024-04-25,1021
00680L,元大美債20正2,37,0,37,合庫-台中,2024-04-25,1021
2888,新光金,37,0,37,合庫-台中,2024-04-25,1021
2303,聯電,54,21,33,合庫-台中,2024-04-25,1021
3523,迎輝,30,0,30,合庫-台中,2024-04-25,1021
2328,廣宇,30,1,29,合庫-台中,2024-04-25,1021
2886,兆豐金,29,1,28,合庫-台中,2024-04-25,1021
5534,長虹,29,1,28,合庫-台中,2024-04-25,1021
1504,東元,29,2,27,合庫-台中,2024-04-25,1021
2344,華邦電,25,0,25,合庫-台中,2024-04-25,1021
5880,合庫金,25,1,24,合庫-台中,2024-04-25,1021
1301,台塑,25,1,24,合庫-台中,2024-04-25,1021
9945,潤泰新,27,4,23,合庫-台中,2024-04-25,1021
1326,台化,23,1,22,合庫-台中,2024-04-25,1021
1612,宏泰,25,3,22,合庫-台中,2024-04-25,1021
6288,聯嘉,22,0,22,合庫-台中,2024-04-25,1021
6215,和椿,23,2,21,合庫-台中,2024-04-25,1021
8111,立��,21,0,21,合庫-台中,2024-04-25,1021
2892,第一金,20,0,20,合庫-台中,2024-04-25,1021
2031,新光鋼,20,0,20,合庫-台中,2024-04-25,1021
00887,永豐中國科技50大,20,0,20,合庫-台中,2024-04-25,1021
3672,康聯訊,20,0,20,合庫-台中,2024-04-25,1021
9105,泰金寶-DR,20,0,20,合庫-台中,2024-04-25,1021
6419,京晨科,32,13,19,合庫-台中,2024-04-25,1021
5529,鉅陞,19,0,19,合庫-台中,2024-04-25,1021
5426,振發,27,8,19,合庫-台中,2024-04-25,1021
00679B,元大美債20年,25,6,19,合庫-台中,2024-04-25,1021
2880,華南金,18,0,18,合庫-台中,2024-04-25,1021
2812,台中銀,20,2,18,合庫-台中,2024-04-25,1021
4939,亞電,20,2,18,合庫-台中,2024-04-25,1021
2887,台新金,19,1,18,合庫-台中,2024-04-25,1021
2891,中信金,17,0,17,合庫-台中,2024-04-25,1021
3701,大眾控,17,0,17,合庫-台中,2024-04-25,1021
00751B,元大AAA至A公司債,17,0,17,合庫-台中,2024-04-25,1021
2881,富邦金,17,0,17,合庫-台中,2024-04-25,1021
2405,輔信,17,0,17,合庫-台中,2024-04-25,1021
2002,中鋼,17,1,16,合庫-台中,2024-04-25,1021
00937B,群益ESG投等債20,186,0,186,合庫-台中,2024-04-26,1021
2317,鴻海,756,608,148,合庫-台中,2024-04-26,1021
2371,大同,266,133,133,合庫-台中,2024-04-26,1021
8358,金居,125,7,118,合庫-台中,2024-04-26,1021
3481,群創,178,65,113,合庫-台中,2024-04-26,1021
00632R,元大台灣50反1,841,748,93,合庫-台中,2024-04-26,1021
2515,中工,338,246,92,合庫-台中,2024-04-26,1021
00679B,元大美債20年,85,3,82,合庫-台中,2024-04-26,1021
00687B,國泰20年美債,78,0,78,合庫-台中,2024-04-26,1021
1444,力麗,69,0,69,合庫-台中,2024-04-26,1021
1605,華新,67,7,60,合庫-台中,2024-04-26,1021
00929,復華台灣科技優息,62,4,58,合庫-台中,2024-04-26,1021
3706,神達,68,15,53,合庫-台中,2024-04-26,1021
3264,欣銓,52,2,50,合庫-台中,2024-04-26,1021
2630,亞航,54,5,49,合庫-台中,2024-04-26,1021
8111,立��,48,0,48,合庫-台中,2024-04-26,1021
6120,達運,52,4,48,合庫-台中,2024-04-26,1021
2845,遠東銀,48,0,48,合庫-台中,2024-04-26,1021
2359,所羅門,187,139,48,合庫-台中,2024-04-26,1021
6442,光聖,55,8,47,合庫-台中,2024-04-26,1021
1459,聯發,45,0,45,合庫-台中,2024-04-26,1021
2812,台中銀,42,0,42,合庫-台中,2024-04-26,1021
00751B,元大AAA至A公司債,38,0,38,合庫-台中,2024-04-26,1021
3036,文曄,37,0,37,合庫-台中,2024-04-26,1021
3715,定穎投控,55,19,36,合庫-台中,2024-04-26,1021
2363,矽統,49,14,35,合庫-台中,2024-04-26,1021
2834,臺企銀,43,10,33,合庫-台中,2024-04-26,1021
6207,雷科,80,47,33,合庫-台中,2024-04-26,1021
3523,迎輝,33,0,33,合庫-台中,2024-04-26,1021
2241,艾姆勒,40,7,33,合庫-台中,2024-04-26,1021
6275,元山,41,9,32,合庫-台中,2024-04-26,1021
2102,泰豐,33,1,32,合庫-台中,2024-04-26,1021
3363,上詮,77,47,30,合庫-台中,2024-04-26,1021
5340,建榮,30,0,30,合庫-台中,2024-04-26,1021
00706L,期元大S＆P日圓正2,30,0,30,合庫-台中,2024-04-26,1021
5880,合庫金,70,40,30,合庫-台中,2024-04-26,1021
00933B,國泰10Y+金融債,28,0,28,合庫-台中,2024-04-26,1021
6770,力積電,35,8,27,合庫-台中,2024-04-26,1021
2030,彰源,27,0,27,合庫-台中,2024-04-26,1021
8213,志超,27,0,27,合庫-台中,2024-04-26,1021
2486,一詮,51,26,25,合庫-台中,2024-04-26,1021
3583,辛耘,32,8,24,合庫-台中,2024-04-26,1021
8064,東捷,48,25,23,合庫-台中,2024-04-26,1021
3011,今皓,22,0,22,合庫-台中,2024-04-26,1021
2543,皇昌,27,5,22,合庫-台中,2024-04-26,1021
1540,喬福,22,0,22,合庫-台中,2024-04-26,1021
8096,擎亞,27,5,22,合庫-台中,2024-04-26,1021
5516,雙喜,20,0,20,合庫-台中,2024-04-26,1021
6190,萬泰科,23,4,19,合庫-台中,2024-04-26,1021
2201,裕隆,35,16,19,合庫-台中,2024-04-26,1021
2317,鴻海,1176,78,1098,合庫-台中,2024-04-29,1021
00665L,富邦�琤肭磪囓�2,937,434,503,合庫-台中,2024-04-29,1021
00632R,元大台灣50反1,389,0,389,合庫-台中,2024-04-29,1021
2618,長榮航,574,241,333,合庫-台中,2024-04-29,1021
2323,中環,178,45,133,合庫-台中,2024-04-29,1021
2610,華航,210,101,109,合庫-台中,2024-04-29,1021
2609,陽明,252,147,105,合庫-台中,2024-04-29,1021
5009,榮剛,117,14,103,合庫-台中,2024-04-29,1021
3481,群創,170,68,102,合庫-台中,2024-04-29,1021
00650L,復華香港正2,410,315,95,合庫-台中,2024-04-29,1021
00680L,元大美債20正2,100,5,95,合庫-台中,2024-04-29,1021
2363,矽統,245,160,85,合庫-台中,2024-04-29,1021
1713,國化,84,0,84,合庫-台中,2024-04-29,1021
2101,南港,94,14,80,合庫-台中,2024-04-29,1021
00706L,期元大S＆P日圓正2,82,20,62,合庫-台中,2024-04-29,1021
2630,亞航,61,2,59,合庫-台中,2024-04-29,1021
00637L,元大滬深300正2,496,440,56,合庫-台中,2024-04-29,1021
00940,元大台灣價值高息,77,22,55,合庫-台中,2024-04-29,1021
1587,吉茂,112,62,50,合庫-台中,2024-04-29,1021
1612,宏泰,44,0,44,合庫-台中,2024-04-29,1021
1806,冠軍,58,17,41,合庫-台中,2024-04-29,1021
3523,迎輝,32,0,32,合庫-台中,2024-04-29,1021
2514,龍邦,30,0,30,合庫-台中,2024-04-29,1021
2349,錸德,29,0,29,合庫-台中,2024-04-29,1021
5512,力麒,40,13,27,合庫-台中,2024-04-29,1021
2641,正德,26,1,25,合庫-台中,2024-04-29,1021
4532,瑞智,52,28,24,合庫-台中,2024-04-29,1021
2506,太設,45,22,23,合庫-台中,2024-04-29,1021
2017,官田鋼,24,1,23,合庫-台中,2024-04-29,1021
3264,欣銓,59,36,23,合庫-台中,2024-04-29,1021
6217,中探針,23,0,23,合庫-台中,2024-04-29,1021
1725,元禎,21,0,21,合庫-台中,2024-04-29,1021
2444,兆勁,20,0,20,合庫-台中,2024-04-29,1021
2601,益航,21,1,20,合庫-台中,2024-04-29,1021
6215,和椿,44,25,19,合庫-台中,2024-04-29,1021
6668,中揚光,26,8,18,合庫-台中,2024-04-29,1021
2880,華南金,62,44,18,合庫-台中,2024-04-29,1021
8213,志超,19,1,18,合庫-台中,2024-04-29,1021
2359,所羅門,75,58,17,合庫-台中,2024-04-29,1021
1514,亞力,21,4,17,合庫-台中,2024-04-29,1021
1442,名軒,18,1,17,合庫-台中,2024-04-29,1021
8054,安國,23,6,17,合庫-台中,2024-04-29,1021
1616,億泰,20,3,17,合庫-台中,2024-04-29,1021
2371,大同,85,68,17,合庫-台中,2024-04-29,1021
2498,宏達電,21,5,16,合庫-台中,2024-04-29,1021
00666R,富邦�琤肭磪齯�1,16,0,16,合庫-台中,2024-04-29,1021
2883B,凱基金乙特,16,0,16,合庫-台中,2024-04-29,1021
1447,力鵬,15,0,15,合庫-台中,2024-04-29,1021
2537,聯上發,17,2,15,合庫-台中,2024-04-29,1021
2486,一詮,74,60,14,合庫-台中,2024-04-29,1021
1440,南紡,491,40,451,合庫-台中,2024-04-30,1021
00632R,元大台灣50反1,362,5,357,合庫-台中,2024-04-30,1021
3672,康聯訊,200,0,200,合庫-台中,2024-04-30,1021
00878,國泰永續高股息,166,6,160,合庫-台中,2024-04-30,1021
2515,中工,160,43,117,合庫-台中,2024-04-30,1021
00882,中信中國高股息,206,105,101,合庫-台中,2024-04-30,1021
2610,華航,107,20,87,合庫-台中,2024-04-30,1021
2363,矽統,456,379,77,合庫-台中,2024-04-30,1021
2501,國建,171,96,75,合庫-台中,2024-04-30,1021
3363,上詮,157,84,73,合庫-台中,2024-04-30,1021
00637L,元大滬深300正2,501,431,70,合庫-台中,2024-04-30,1021
5525,順天,67,0,67,合庫-台中,2024-04-30,1021
1605,華新,65,0,65,合庫-台中,2024-04-30,1021
2506,太設,66,4,62,合庫-台中,2024-04-30,1021
00937B,群益ESG投等債20,62,3,59,合庫-台中,2024-04-30,1021
2880,華南金,83,25,58,合庫-台中,2024-04-30,1021
6219,富旺,56,0,56,合庫-台中,2024-04-30,1021
00877,復華中國5G,51,2,49,合庫-台中,2024-04-30,1021
00665L,富邦�琤肭磪囓�2,476,428,48,合庫-台中,2024-04-30,1021
1314,中石化,98,51,47,合庫-台中,2024-04-30,1021
5531,鄉林,107,63,44,合庫-台中,2024-04-30,1021
00650L,復華香港正2,365,322,43,合庫-台中,2024-04-30,1021
00679B,元大美債20年,41,1,40,合庫-台中,2024-04-30,1021
2888,新光金,56,19,37,合庫-台中,2024-04-30,1021
2913,農林,92,56,36,合庫-台中,2024-04-30,1021
1101,台泥,31,0,31,合庫-台中,2024-04-30,1021
1219,福壽,30,0,30,合庫-台中,2024-04-30,1021
8096,擎亞,62,32,30,合庫-台中,2024-04-30,1021
1514,亞力,31,1,30,合庫-台中,2024-04-30,1021
2002,中鋼,35,6,29,合庫-台中,2024-04-30,1021
5512,力麒,36,9,27,合庫-台中,2024-04-30,1021
2442,新美齊,29,2,27,合庫-台中,2024-04-30,1021
2887,台新金,64,37,27,合庫-台中,2024-04-30,1021
00680L,元大美債20正2,26,0,26,合庫-台中,2024-04-30,1021
2359,所羅門,84,60,24,合庫-台中,2024-04-30,1021
1413,宏洲,24,0,24,合庫-台中,2024-04-30,1021
5347,世界,29,6,23,合庫-台中,2024-04-30,1021
2385,群光,24,2,22,合庫-台中,2024-04-30,1021
9942,茂順,21,0,21,合庫-台中,2024-04-30,1021
2031,新光鋼,21,0,21,合庫-台中,2024-04-30,1021
2349,錸德,20,0,20,合庫-台中,2024-04-30,1021
2601,益航,20,0,20,合庫-台中,2024-04-30,1021
1725,元禎,37,17,20,合庫-台中,2024-04-30,1021
3005,神基,22,3,19,合庫-台中,2024-04-30,1021
3033,威健,25,8,17,合庫-台中,2024-04-30,1021
2537,聯上發,40,23,17,合庫-台中,2024-04-30,1021
6589,台康生技,18,1,17,合庫-台中,2024-04-30,1021
2371,大同,101,85,16,合庫-台中,2024-04-30,1021
1905,華紙,16,0,16,合庫-台中,2024-04-30,1021
8210,勤誠,16,1,15,合庫-台中,2024-04-30,1021
2867,三商壽,1323,0,1323,合庫-台中,2024-05-02,1021
2371,大同,672,73,599,合庫-台中,2024-05-02,1021
3481,群創,221,6,215,合庫-台中,2024-05-02,1021
00878,國泰永續高股息,172,8,164,合庫-台中,2024-05-02,1021
2537,聯上發,160,18,142,合庫-台中,2024-05-02,1021
00715L,期街口布蘭特正2,121,10,111,合庫-台中,2024-05-02,1021
00650L,復華香港正2,399,303,96,合庫-台中,2024-05-02,1021
00929,復華台灣科技優息,103,13,90,合庫-台中,2024-05-02,1021
2062,橋椿,137,57,80,合庫-台中,2024-05-02,1021
6120,達運,81,1,80,合庫-台中,2024-05-02,1021
2501,國建,286,213,73,合庫-台中,2024-05-02,1021
2409,友達,79,20,59,合庫-台中,2024-05-02,1021
00937B,群益ESG投等債20,58,3,55,合庫-台中,2024-05-02,1021
00882,中信中國高股息,50,0,50,合庫-台中,2024-05-02,1021
2514,龍邦,50,0,50,合庫-台中,2024-05-02,1021
00885,富邦越南,50,0,50,合庫-台中,2024-05-02,1021
8064,東捷,52,2,50,合庫-台中,2024-05-02,1021
1713,國化,49,0,49,合庫-台中,2024-05-02,1021
2547,日勝生,73,27,46,合庫-台中,2024-05-02,1021
2883B,凱基金乙特,41,0,41,合庫-台中,2024-05-02,1021
1440,南紡,101,63,38,合庫-台中,2024-05-02,1021
2505,國揚,40,3,37,合庫-台中,2024-05-02,1021
2615,萬海,65,29,36,合庫-台中,2024-05-02,1021
1220,台榮,37,2,35,合庫-台中,2024-05-02,1021
2301,光寶科,38,7,31,合庫-台中,2024-05-02,1021
2705,六福,38,7,31,合庫-台中,2024-05-02,1021
6770,力積電,77,48,29,合庫-台中,2024-05-02,1021
6147,頎邦,30,1,29,合庫-台中,2024-05-02,1021
2312,金寶,29,0,29,合庫-台中,2024-05-02,1021
1905,華紙,33,4,29,合庫-台中,2024-05-02,1021
00919,群益台灣精選高息,135,108,27,合庫-台中,2024-05-02,1021
2303,聯電,47,20,27,合庫-台中,2024-05-02,1021
2316,楠梓電,42,16,26,合庫-台中,2024-05-02,1021
2401,凌陽,26,0,26,合庫-台中,2024-05-02,1021
6589,台康生技,26,0,26,合庫-台中,2024-05-02,1021
3312,弘憶股,25,0,25,合庫-台中,2024-05-02,1021
00637L,元大滬深300正2,440,415,25,合庫-台中,2024-05-02,1021
2891,中信金,25,0,25,合庫-台中,2024-05-02,1021
6419,京晨科,54,29,25,合庫-台中,2024-05-02,1021
00679B,元大美債20年,24,1,23,合庫-台中,2024-05-02,1021
2324,仁寶,23,0,23,合庫-台中,2024-05-02,1021
1618,合機,28,6,22,合庫-台中,2024-05-02,1021
2504,國產,51,29,22,合庫-台中,2024-05-02,1021
3024,憶聲,26,4,22,合庫-台中,2024-05-02,1021
3715,定穎投控,56,35,21,合庫-台中,2024-05-02,1021
2465,麗臺,22,2,20,合庫-台中,2024-05-02,1021
00940,元大台灣價值高息,40,20,20,合庫-台中,2024-05-02,1021
3031,佰鴻,20,0,20,合庫-台中,2024-05-02,1021
3466,德晉,30,10,20,合庫-台中,2024-05-02,1021
6616,特昇-KY,20,0,20,合庫-台中,2024-05-02,1021
00940,元大台灣價值高息,423,67,356,合庫-台中,2024-05-03,1021
2317,鴻海,373,64,309,合庫-台中,2024-05-03,1021
6120,達運,285,24,261,合庫-台中,2024-05-03,1021
1440,南紡,169,3,166,合庫-台中,2024-05-03,1021
1713,國化,160,0,160,合庫-台中,2024-05-03,1021
2356,英業達,130,16,114,合庫-台中,2024-05-03,1021
2897,王道銀行,106,0,106,合庫-台中,2024-05-03,1021
00937B,群益ESG投等債20,105,0,105,合庫-台中,2024-05-03,1021
3231,緯創,125,26,99,合庫-台中,2024-05-03,1021
5512,力麒,127,45,82,合庫-台中,2024-05-03,1021
2836,高雄銀,101,19,82,合庫-台中,2024-05-03,1021
00650L,復華香港正2,302,230,72,合庫-台中,2024-05-03,1021
1316,上曜,132,64,68,合庫-台中,2024-05-03,1021
00878,國泰永續高股息,70,17,53,合庫-台中,2024-05-03,1021
1444,力麗,48,0,48,合庫-台中,2024-05-03,1021
2359,所羅門,79,35,44,合庫-台中,2024-05-03,1021
00929,復華台灣科技優息,98,55,43,合庫-台中,2024-05-03,1021
1453,大將,64,26,38,合庫-台中,2024-05-03,1021
00679B,元大美債20年,37,1,36,合庫-台中,2024-05-03,1021
1301,台塑,40,6,34,合庫-台中,2024-05-03,1021
2739,寒舍,37,5,32,合庫-台中,2024-05-03,1021
1217,愛之味,32,0,32,合庫-台中,2024-05-03,1021
5531,鄉林,168,137,31,合庫-台中,2024-05-03,1021
2641,正德,32,1,31,合庫-台中,2024-05-03,1021
3044,健鼎,37,6,31,合庫-台中,2024-05-03,1021
2520,冠德,59,29,30,合庫-台中,2024-05-03,1021
3313,斐成,29,1,28,合庫-台中,2024-05-03,1021
1587,吉茂,43,17,26,合庫-台中,2024-05-03,1021
3466,德晉,27,2,25,合庫-台中,2024-05-03,1021
6113,亞矽,25,0,25,合庫-台中,2024-05-03,1021
6419,京晨科,191,167,24,合庫-台中,2024-05-03,1021
4906,正文,23,0,23,合庫-台中,2024-05-03,1021
3266,昇陽,27,4,23,合庫-台中,2024-05-03,1021
8442,威宏-KY,22,0,22,合庫-台中,2024-05-03,1021
2801,彰銀,31,10,21,合庫-台中,2024-05-03,1021
1532,勤美,40,19,21,合庫-台中,2024-05-03,1021
2323,中環,20,0,20,合庫-台中,2024-05-03,1021
4167,松瑞藥,20,0,20,合庫-台中,2024-05-03,1021
5251,天鉞電,26,6,20,合庫-台中,2024-05-03,1021
3321,同泰,20,0,20,合庫-台中,2024-05-03,1021
00715L,期街口布蘭特正2,20,0,20,合庫-台中,2024-05-03,1021
6278,台表科,22,2,20,合庫-台中,2024-05-03,1021
6158,禾昌,20,0,20,合庫-台中,2024-05-03,1021
2543,皇昌,50,30,20,合庫-台中,2024-05-03,1021
00687B,國泰20年美債,19,0,19,合庫-台中,2024-05-03,1021
5230,雷笛克光學,48,29,19,合庫-台中,2024-05-03,1021
3013,晟銘電,28,9,19,合庫-台中,2024-05-03,1021
2009,第一銅,35,17,18,合庫-台中,2024-05-03,1021
4532,瑞智,20,2,18,合庫-台中,2024-05-03,1021
2344,華邦電,28,10,18,合庫-台中,2024-05-03,1021
00937B,群益ESG投等債20,889,66,823,合庫-台中,2024-05-06,1021
00632R,元大台灣50反1,551,0,551,合庫-台中,2024-05-06,1021
2618,長榮航,364,148,216,合庫-台中,2024-05-06,1021
6419,京晨科,205,59,146,合庫-台中,2024-05-06,1021
2515,中工,155,34,121,合庫-台中,2024-05-06,1021
1713,國化,131,10,121,合庫-台中,2024-05-06,1021
2371,大同,144,26,118,合庫-台中,2024-05-06,1021
00929,復華台灣科技優息,133,17,116,合庫-台中,2024-05-06,1021
00679B,元大美債20年,121,5,116,合庫-台中,2024-05-06,1021
2449,京元電子,105,4,101,合庫-台中,2024-05-06,1021
00650L,復華香港正2,252,151,101,合庫-台中,2024-05-06,1021
1440,南紡,97,7,90,合庫-台中,2024-05-06,1021
1417,嘉裕,88,0,88,合庫-台中,2024-05-06,1021
3481,群創,110,29,81,合庫-台中,2024-05-06,1021
4303,信立,113,48,65,合庫-台中,2024-05-06,1021
2834,臺企銀,74,24,50,合庫-台中,2024-05-06,1021
6451,訊芯-KY,69,22,47,合庫-台中,2024-05-06,1021
00940,元大台灣價值高息,75,33,42,合庫-台中,2024-05-06,1021
9933,中鼎,49,7,42,合庫-台中,2024-05-06,1021
3545,敦泰,37,0,37,合庫-台中,2024-05-06,1021
2106,建大,35,0,35,合庫-台中,2024-05-06,1021
2312,金寶,30,0,30,合庫-台中,2024-05-06,1021
2008,高興昌,30,0,30,合庫-台中,2024-05-06,1021
2399,映泰,27,0,27,合庫-台中,2024-05-06,1021
8064,東捷,34,8,26,合庫-台中,2024-05-06,1021
8111,立��,26,0,26,合庫-台中,2024-05-06,1021
2706,第一店,30,5,25,合庫-台中,2024-05-06,1021
6265,方土昶,25,0,25,合庫-台中,2024-05-06,1021
1444,力麗,30,6,24,合庫-台中,2024-05-06,1021
5531,鄉林,32,8,24,合庫-台中,2024-05-06,1021
6173,信昌電,23,1,22,合庫-台中,2024-05-06,1021
4923,力士,22,0,22,合庫-台中,2024-05-06,1021
2634,漢翔,29,8,21,合庫-台中,2024-05-06,1021
00671R,富邦NASDAQ反1,20,0,20,合庫-台中,2024-05-06,1021
2329,華泰,20,0,20,合庫-台中,2024-05-06,1021
4919,新唐,20,0,20,合庫-台中,2024-05-06,1021
6770,力積電,41,22,19,合庫-台中,2024-05-06,1021
2409,友達,28,11,17,合庫-台中,2024-05-06,1021
00725B,國泰投資級公司債,19,2,17,合庫-台中,2024-05-06,1021
00715L,期街口布蘭特正2,22,5,17,合庫-台中,2024-05-06,1021
00665L,富邦�琤肭磪囓�2,360,343,17,合庫-台中,2024-05-06,1021
00936,台新永續高息中小,17,0,17,合庫-台中,2024-05-06,1021
2301,光寶科,61,45,16,合庫-台中,2024-05-06,1021
4714,永捷,27,11,16,合庫-台中,2024-05-06,1021
00891,中信關鍵半導體,20,4,16,合庫-台中,2024-05-06,1021
2352,佳世達,19,3,16,合庫-台中,2024-05-06,1021
00642U,期元大S＆P石油,15,0,15,合庫-台中,2024-05-06,1021
2363,矽統,74,59,15,合庫-台中,2024-05-06,1021
3430,奇鈦科,15,0,15,合庫-台中,2024-05-06,1021
6216,居易,15,0,15,合庫-台中,2024-05-06,1021
00665L,富邦�琤肭磪囓�2,1628,284,1344,合庫-台中,2024-05-07,1021
00632R,元大台灣50反1,463,152,311,合庫-台中,2024-05-07,1021
2618,長榮航,422,212,210,合庫-台中,2024-05-07,1021
00878,國泰永續高股息,197,24,173,合庫-台中,2024-05-07,1021
1440,南紡,178,31,147,合庫-台中,2024-05-07,1021
2486,一詮,312,205,107,合庫-台中,2024-05-07,1021
2515,中工,165,59,106,合庫-台中,2024-05-07,1021
3576,聯合再生,110,5,105,合庫-台中,2024-05-07,1021
2317,鴻海,153,62,91,合庫-台中,2024-05-07,1021
3481,群創,115,24,91,合庫-台中,2024-05-07,1021
5531,鄉林,95,11,84,合庫-台中,2024-05-07,1021
00929,復華台灣科技優息,101,18,83,合庫-台中,2024-05-07,1021
2062,橋椿,112,46,66,合庫-台中,2024-05-07,1021
1608,華榮,82,28,54,合庫-台中,2024-05-07,1021
2891,中信金,62,8,54,合庫-台中,2024-05-07,1021
2356,英業達,71,18,53,合庫-台中,2024-05-07,1021
2367,燿華,54,1,53,合庫-台中,2024-05-07,1021
3056,富華新,69,17,52,合庫-台中,2024-05-07,1021
2009,第一銅,63,12,51,合庫-台中,2024-05-07,1021
00679B,元大美債20年,73,22,51,合庫-台中,2024-05-07,1021
2002,中鋼,53,6,47,合庫-台中,2024-05-07,1021
2880,華南金,78,34,44,合庫-台中,2024-05-07,1021
00919,群益台灣精選高息,72,28,44,合庫-台中,2024-05-07,1021
2524,京城,41,1,40,合庫-台中,2024-05-07,1021
2887,台新金,45,5,40,合庫-台中,2024-05-07,1021
9945,潤泰新,55,15,40,合庫-台中,2024-05-07,1021
2539,櫻花建,43,5,38,合庫-台中,2024-05-07,1021
8096,擎亞,81,43,38,合庫-台中,2024-05-07,1021
3033,威健,53,17,36,合庫-台中,2024-05-07,1021
3312,弘憶股,57,24,33,合庫-台中,2024-05-07,1021
00891,中信關鍵半導體,32,1,31,合庫-台中,2024-05-07,1021
00936,台新永續高息中小,31,0,31,合庫-台中,2024-05-07,1021
2392,正崴,73,42,31,合庫-台中,2024-05-07,1021
2101,南港,36,6,30,合庫-台中,2024-05-07,1021
5512,力麒,42,12,30,合庫-台中,2024-05-07,1021
2611,志信,38,10,28,合庫-台中,2024-05-07,1021
2542,興富發,49,21,28,合庫-台中,2024-05-07,1021
3231,緯創,46,19,27,合庫-台中,2024-05-07,1021
2344,華邦電,251,225,26,合庫-台中,2024-05-07,1021
1905,華紙,26,1,25,合庫-台中,2024-05-07,1021
2705,六福,25,0,25,合庫-台中,2024-05-07,1021
00688L,國泰20年美債正2,35,10,25,合庫-台中,2024-05-07,1021
3013,晟銘電,81,58,23,合庫-台中,2024-05-07,1021
6207,雷科,43,21,22,合庫-台中,2024-05-07,1021
2444,兆勁,22,0,22,合庫-台中,2024-05-07,1021
2061,風青,21,0,21,合庫-台中,2024-05-07,1021
1101,台泥,26,6,20,合庫-台中,2024-05-07,1021
3706,神達,22,2,20,合庫-台中,2024-05-07,1021
2324,仁寶,20,0,20,合庫-台中,2024-05-07,1021
5871,中租-KY,19,0,19,合庫-台中,2024-05-07,1021
00937B,群益ESG投等債20,432,30,402,合庫-台中,2024-05-08,1021
2834,臺企銀,211,8,203,合庫-台中,2024-05-08,1021
5871,中租-KY,200,16,184,合庫-台中,2024-05-08,1021
00679B,元大美債20年,167,44,123,合庫-台中,2024-05-08,1021
00940,元大台灣價值高息,178,57,121,合庫-台中,2024-05-08,1021
00632R,元大台灣50反1,166,60,106,合庫-台中,2024-05-08,1021
2801,彰銀,102,0,102,合庫-台中,2024-05-08,1021
2359,所羅門,133,40,93,合庫-台中,2024-05-08,1021
3231,緯創,134,42,92,合庫-台中,2024-05-08,1021
00715L,期街口布蘭特正2,94,4,90,合庫-台中,2024-05-08,1021
3672,康聯訊,100,11,89,合庫-台中,2024-05-08,1021
3466,德晉,92,8,84,合庫-台中,2024-05-08,1021
1609,大亞,186,104,82,合庫-台中,2024-05-08,1021
1722,台肥,80,0,80,合庫-台中,2024-05-08,1021
3481,群創,79,2,77,合庫-台中,2024-05-08,1021
2609,陽明,145,71,74,合庫-台中,2024-05-08,1021
4109,加捷生醫,72,0,72,合庫-台中,2024-05-08,1021
00919,群益台灣精選高息,72,3,69,合庫-台中,2024-05-08,1021
2515,中工,112,43,69,合庫-台中,2024-05-08,1021
2363,矽統,279,213,66,合庫-台中,2024-05-08,1021
2374,佳能,134,76,58,合庫-台中,2024-05-08,1021
2520,冠德,73,17,56,合庫-台中,2024-05-08,1021
00751B,元大AAA至A公司債,85,31,54,合庫-台中,2024-05-08,1021
2618,長榮航,132,80,52,合庫-台中,2024-05-08,1021
1314,中石化,90,42,48,合庫-台中,2024-05-08,1021
00941,中信上游半導體,51,5,46,合庫-台中,2024-05-08,1021
3564,其陽,47,2,45,合庫-台中,2024-05-08,1021
2101,南港,57,13,44,合庫-台中,2024-05-08,1021
2409,友達,57,15,42,合庫-台中,2024-05-08,1021
00932,兆豐永續高息等權,37,0,37,合庫-台中,2024-05-08,1021
2704,國賓,39,2,37,合庫-台中,2024-05-08,1021
2608,嘉里大榮,35,0,35,合庫-台中,2024-05-08,1021
00680L,元大美債20正2,34,2,32,合庫-台中,2024-05-08,1021
1504,東元,32,1,31,合庫-台中,2024-05-08,1021
2002,中鋼,41,11,30,合庫-台中,2024-05-08,1021
2611,志信,80,50,30,合庫-台中,2024-05-08,1021
2603,長榮,60,30,30,合庫-台中,2024-05-08,1021
2634,漢翔,106,77,29,合庫-台中,2024-05-08,1021
6456,GIS-KY,29,0,29,合庫-台中,2024-05-08,1021
2913,農林,28,0,28,合庫-台中,2024-05-08,1021
2009,第一銅,38,10,28,合庫-台中,2024-05-08,1021
6282,康舒,33,6,27,合庫-台中,2024-05-08,1021
2014,中鴻,25,0,25,合庫-台中,2024-05-08,1021
00878,國泰永續高股息,57,32,25,合庫-台中,2024-05-08,1021
5531,鄉林,24,0,24,合庫-台中,2024-05-08,1021
3033,威健,34,11,23,合庫-台中,2024-05-08,1021
2880,華南金,50,28,22,合庫-台中,2024-05-08,1021
8033,雷虎,23,1,22,合庫-台中,2024-05-08,1021
2637,慧洋-KY,48,27,21,合庫-台中,2024-05-08,1021
6113,亞矽,24,3,21,合庫-台中,2024-05-08,1021
2618,長榮航,529,91,438,合庫-台中,2024-05-09,1021
2323,中環,270,2,268,合庫-台中,2024-05-09,1021
00679B,元大美債20年,267,22,245,合庫-台中,2024-05-09,1021
00946,群益科技高息成長,210,9,201,合庫-台中,2024-05-09,1021
1440,南紡,120,0,120,合庫-台中,2024-05-09,1021
6116,彩晶,109,0,109,合庫-台中,2024-05-09,1021
00932,兆豐永續高息等權,107,2,105,合庫-台中,2024-05-09,1021
1314,中石化,129,24,105,合庫-台中,2024-05-09,1021
2367,燿華,226,125,101,合庫-台中,2024-05-09,1021
00929,復華台灣科技優息,129,35,94,合庫-台中,2024-05-09,1021
9103,美德醫療-DR,94,0,94,合庫-台中,2024-05-09,1021
00944,野村趨勢動能高息,68,0,68,合庫-台中,2024-05-09,1021
3672,康聯訊,68,0,68,合庫-台中,2024-05-09,1021
2888,新光金,160,97,63,合庫-台中,2024-05-09,1021
2834,臺企銀,62,2,60,合庫-台中,2024-05-09,1021
00751B,元大AAA至A公司債,57,2,55,合庫-台中,2024-05-09,1021
2608,嘉里大榮,50,0,50,合庫-台中,2024-05-09,1021
3041,揚智,51,2,49,合庫-台中,2024-05-09,1021
2101,南港,45,1,44,合庫-台中,2024-05-09,1021
2409,友達,68,25,43,合庫-台中,2024-05-09,1021
2317,鴻海,96,53,43,合庫-台中,2024-05-09,1021
4109,加捷生醫,39,0,39,合庫-台中,2024-05-09,1021
2892,第一金,48,10,38,合庫-台中,2024-05-09,1021
1301,台塑,38,0,38,合庫-台中,2024-05-09,1021
1515,力山,38,0,38,合庫-台中,2024-05-09,1021
2006,東和鋼鐵,37,0,37,合庫-台中,2024-05-09,1021
2887,台新金,39,4,35,合庫-台中,2024-05-09,1021
5871,中租-KY,40,5,35,合庫-台中,2024-05-09,1021
00687B,國泰20年美債,35,0,35,合庫-台中,2024-05-09,1021
6163,華電網,33,1,32,合庫-台中,2024-05-09,1021
2344,華邦電,35,3,32,合庫-台中,2024-05-09,1021
9945,潤泰新,32,0,32,合庫-台中,2024-05-09,1021
2349,錸德,30,0,30,合庫-台中,2024-05-09,1021
1615,大山,45,17,28,合庫-台中,2024-05-09,1021
6188,廣明,50,22,28,合庫-台中,2024-05-09,1021
2881,富邦金,32,4,28,合庫-台中,2024-05-09,1021
6187,萬潤,40,13,27,合庫-台中,2024-05-09,1021
00915,凱基優選高股息30,31,4,27,合庫-台中,2024-05-09,1021
2543,皇昌,32,6,26,合庫-台中,2024-05-09,1021
6770,力積電,28,3,25,合庫-台中,2024-05-09,1021
2371,大同,70,47,23,合庫-台中,2024-05-09,1021
3037,欣興,41,20,21,合庫-台中,2024-05-09,1021
5230,雷笛克光學,23,3,20,合庫-台中,2024-05-09,1021
3231,緯創,70,50,20,合庫-台中,2024-05-09,1021
9105,泰金寶-DR,20,0,20,合庫-台中,2024-05-09,1021
2524,京城,20,0,20,合庫-台中,2024-05-09,1021
4938,和碩,20,0,20,合庫-台中,2024-05-09,1021
1540,喬福,20,0,20,合庫-台中,2024-05-09,1021
3036,文曄,39,19,20,合庫-台中,2024-05-09,1021
2880,華南金,40,20,20,合庫-台中,2024-05-09,1021
00937B,群益ESG投等債20,3329,25,3304,合庫-台中,2024-05-10,1021
00929,復華台灣科技優息,325,44,281,合庫-台中,2024-05-10,1021
00679B,元大美債20年,355,81,274,合庫-台中,2024-05-10,1021
00946,群益科技高息成長,154,17,137,合庫-台中,2024-05-10,1021
2062,橋椿,139,6,133,合庫-台中,2024-05-10,1021
3036,文曄,127,15,112,合庫-台中,2024-05-10,1021
2836,高雄銀,91,0,91,合庫-台中,2024-05-10,1021
2374,佳能,139,65,74,合庫-台中,2024-05-10,1021
00632R,元大台灣50反1,62,0,62,合庫-台中,2024-05-10,1021
6419,京晨科,59,1,58,合庫-台中,2024-05-10,1021
1815,富喬,58,0,58,合庫-台中,2024-05-10,1021
2409,友達,87,31,56,合庫-台中,2024-05-10,1021
3481,群創,109,61,48,合庫-台中,2024-05-10,1021
00751B,元大AAA至A公司債,46,0,46,合庫-台中,2024-05-10,1021
1515,力山,43,0,43,合庫-台中,2024-05-10,1021
6005,群益證,46,6,40,合庫-台中,2024-05-10,1021
3356,奇偶,80,40,40,合庫-台中,2024-05-10,1021
2392,正崴,50,12,38,合庫-台中,2024-05-10,1021
6770,力積電,48,11,37,合庫-台中,2024-05-10,1021
2313,華通,244,209,35,合庫-台中,2024-05-10,1021
00795B,中信美國公債20年,35,0,35,合庫-台中,2024-05-10,1021
2427,三商電,33,2,31,合庫-台中,2024-05-10,1021
3033,威健,32,2,30,合庫-台中,2024-05-10,1021
8112,至上,131,101,30,合庫-台中,2024-05-10,1021
2501,國建,83,55,28,合庫-台中,2024-05-10,1021
2801,彰銀,58,31,27,合庫-台中,2024-05-10,1021
3609,三一東林,27,0,27,合庫-台中,2024-05-10,1021
1587,吉茂,27,1,26,合庫-台中,2024-05-10,1021
3564,其陽,27,1,26,合庫-台中,2024-05-10,1021
00637L,元大滬深300正2,953,928,25,合庫-台中,2024-05-10,1021
4916,事欣科,24,0,24,合庫-台中,2024-05-10,1021
00944,野村趨勢動能高息,23,0,23,合庫-台中,2024-05-10,1021
4303,信立,24,1,23,合庫-台中,2024-05-10,1021
00930,永豐ESG低碳高息,25,2,23,合庫-台中,2024-05-10,1021
00665L,富邦�琤肭磪囓�2,522,501,21,合庫-台中,2024-05-10,1021
5871,中租-KY,27,7,20,合庫-台中,2024-05-10,1021
911868,同方友友-DR,20,0,20,合庫-台中,2024-05-10,1021
00932,兆豐永續高息等權,24,4,20,合庫-台中,2024-05-10,1021
2408,南亞科,22,2,20,合庫-台中,2024-05-10,1021
1540,喬福,21,2,19,合庫-台中,2024-05-10,1021
6239,力成,22,4,18,合庫-台中,2024-05-10,1021
6120,達運,22,4,18,合庫-台中,2024-05-10,1021
2388,威盛,24,7,17,合庫-台中,2024-05-10,1021
4979,華星光,18,1,17,合庫-台中,2024-05-10,1021
00713,元大台灣高息低波,21,4,17,合庫-台中,2024-05-10,1021
5469,瀚宇博,16,0,16,合庫-台中,2024-05-10,1021
6462,神盾,18,2,16,合庫-台中,2024-05-10,1021
2317,鴻海,109,93,16,合庫-台中,2024-05-10,1021
2371,大同,59,44,15,合庫-台中,2024-05-10,1021
1440,南紡,21,6,15,合庫-台中,2024-05-10,1021
00937B,群益ESG投等債20,795,124,671,合庫-台中,2024-05-13,1021
4716,大立,499,0,499,合庫-台中,2024-05-13,1021
2618,長榮航,326,95,231,合庫-台中,2024-05-13,1021
00929,復華台灣科技優息,273,57,216,合庫-台中,2024-05-13,1021
00665L,富邦�琤肭磪囓�2,664,458,206,合庫-台中,2024-05-13,1021
3036,文曄,211,11,200,合庫-台中,2024-05-13,1021
2062,橋椿,168,2,166,合庫-台中,2024-05-13,1021
1522,堤維西,184,20,164,合庫-台中,2024-05-13,1021
2888,新光金,215,74,141,合庫-台中,2024-05-13,1021
3231,緯創,150,16,134,合庫-台中,2024-05-13,1021
00687B,國泰20年美債,82,5,77,合庫-台中,2024-05-13,1021
2891,中信金,80,9,71,合庫-台中,2024-05-13,1021
00715L,期街口布蘭特正2,95,33,62,合庫-台中,2024-05-13,1021
00936,台新永續高息中小,63,1,62,合庫-台中,2024-05-13,1021
00637L,元大滬深300正2,261,200,61,合庫-台中,2024-05-13,1021
00940,元大台灣價值高息,174,117,57,合庫-台中,2024-05-13,1021
2317,鴻海,109,54,55,合庫-台中,2024-05-13,1021
00944,野村趨勢動能高息,55,0,55,合庫-台中,2024-05-13,1021
1563,巧新,57,6,51,合庫-台中,2024-05-13,1021
00933B,國泰10Y+金融債,62,12,50,合庫-台中,2024-05-13,1021
6419,京晨科,50,2,48,合庫-台中,2024-05-13,1021
2406,國碩,90,43,47,合庫-台中,2024-05-13,1021
2392,正崴,64,17,47,合庫-台中,2024-05-13,1021
2349,錸德,50,6,44,合庫-台中,2024-05-13,1021
2356,英業達,170,129,41,合庫-台中,2024-05-13,1021
2603,長榮,145,104,41,合庫-台中,2024-05-13,1021
2241,艾姆勒,59,19,40,合庫-台中,2024-05-13,1021
4109,加捷生醫,40,0,40,合庫-台中,2024-05-13,1021
2634,漢翔,43,4,39,合庫-台中,2024-05-13,1021
3206,志豐,34,0,34,合庫-台中,2024-05-13,1021
3260,威剛,83,51,32,合庫-台中,2024-05-13,1021
2641,正德,44,14,30,合庫-台中,2024-05-13,1021
1584,精剛,30,0,30,合庫-台中,2024-05-13,1021
9944,新麗,32,2,30,合庫-台中,2024-05-13,1021
00932,兆豐永續高息等權,29,0,29,合庫-台中,2024-05-13,1021
2371,大同,84,56,28,合庫-台中,2024-05-13,1021
00636,國泰中國A50,27,0,27,合庫-台中,2024-05-13,1021
00946,群益科技高息成長,25,0,25,合庫-台中,2024-05-13,1021
9945,潤泰新,32,8,24,合庫-台中,2024-05-13,1021
00927,群益半導體收益,24,0,24,合庫-台中,2024-05-13,1021
6283,淳安,45,21,24,合庫-台中,2024-05-13,1021
6125,廣運,59,36,23,合庫-台中,2024-05-13,1021
2344,華邦電,23,2,21,合庫-台中,2024-05-13,1021
2883B,凱基金乙特,20,0,20,合庫-台中,2024-05-13,1021
2903,遠百,19,0,19,合庫-台中,2024-05-13,1021
1455,集盛,20,1,19,合庫-台中,2024-05-13,1021
5512,力麒,29,10,19,合庫-台中,2024-05-13,1021
6207,雷科,26,7,19,合庫-台中,2024-05-13,1021
6139,亞翔,20,2,18,合庫-台中,2024-05-13,1021
4973,廣穎,25,7,18,合庫-台中,2024-05-13,1021
4716,大立,710,14,696,合庫-台中,2024-05-14,1021
00632R,元大台灣50反1,513,200,313,合庫-台中,2024-05-14,1021
2615,萬海,693,422,271,合庫-台中,2024-05-14,1021
00937B,群益ESG投等債20,175,0,175,合庫-台中,2024-05-14,1021
9105,泰金寶-DR,130,4,126,合庫-台中,2024-05-14,1021
3036,文曄,107,2,105,合庫-台中,2024-05-14,1021
2836,高雄銀,102,0,102,合庫-台中,2024-05-14,1021
00637L,元大滬深300正2,327,250,77,合庫-台中,2024-05-14,1021
2884,玉山金,49,0,49,合庫-台中,2024-05-14,1021
00679B,元大美債20年,48,1,47,合庫-台中,2024-05-14,1021
00919,群益台灣精選高息,77,35,42,合庫-台中,2024-05-14,1021
00932,兆豐永續高息等權,39,0,39,合庫-台中,2024-05-14,1021
2731,雄獅,46,8,38,合庫-台中,2024-05-14,1021
1563,巧新,40,6,34,合庫-台中,2024-05-14,1021
2890,永豐金,34,0,34,合庫-台中,2024-05-14,1021
6596,寬宏藝術,33,1,32,合庫-台中,2024-05-14,1021
00946,群益科技高息成長,32,0,32,合庫-台中,2024-05-14,1021
3284,太普高,32,0,32,合庫-台中,2024-05-14,1021
2801,彰銀,37,7,30,合庫-台中,2024-05-14,1021
2409,友達,40,11,29,合庫-台中,2024-05-14,1021
2317,鴻海,117,88,29,合庫-台中,2024-05-14,1021
4562,穎漢,32,3,29,合庫-台中,2024-05-14,1021
9103,美德醫療-DR,29,0,29,合庫-台中,2024-05-14,1021
00929,復華台灣科技優息,47,18,29,合庫-台中,2024-05-14,1021
5871,中租-KY,26,1,25,合庫-台中,2024-05-14,1021
5215,科嘉-KY,25,0,25,合庫-台中,2024-05-14,1021
2461,光群雷,25,2,23,合庫-台中,2024-05-14,1021
3596,智易,22,1,21,合庫-台中,2024-05-14,1021
3231,緯創,93,73,20,合庫-台中,2024-05-14,1021
00887,永豐中國科技50大,20,0,20,合庫-台中,2024-05-14,1021
6177,達麗,20,0,20,合庫-台中,2024-05-14,1021
1301,台塑,19,0,19,合庫-台中,2024-05-14,1021
2611,志信,21,2,19,合庫-台中,2024-05-14,1021
3234,光環,20,1,19,合庫-台中,2024-05-14,1021
1312,國喬,18,1,17,合庫-台中,2024-05-14,1021
3481,群創,49,32,17,合庫-台中,2024-05-14,1021
00673R,期元大S＆P原油反1,20,3,17,合庫-台中,2024-05-14,1021
2880,華南金,21,4,17,合庫-台中,2024-05-14,1021
3033,威健,17,1,16,合庫-台中,2024-05-14,1021
3213,茂訊,20,5,15,合庫-台中,2024-05-14,1021
1101,台泥,21,6,15,合庫-台中,2024-05-14,1021
6592,和潤企業,15,1,14,合庫-台中,2024-05-14,1021
00878,國泰永續高股息,39,24,15,合庫-台中,2024-05-14,1021
5880,合庫金,26,12,14,合庫-台中,2024-05-14,1021
3666,光耀,14,0,14,合庫-台中,2024-05-14,1021
1409,新纖,15,1,14,合庫-台中,2024-05-14,1021
2392,正崴,16,2,14,合庫-台中,2024-05-14,1021
2324,仁寶,47,34,13,合庫-台中,2024-05-14,1021
3703,欣陸,13,0,13,合庫-台中,2024-05-14,1021
5512,力麒,13,0,13,合庫-台中,2024-05-14,1021
00632R,元大台灣50反1,650,0,650,合庫-台中,2024-05-15,1021
00937B,群益ESG投等債20,231,0,231,合庫-台中,2024-05-15,1021
2618,長榮航,354,155,199,合庫-台中,2024-05-15,1021
00929,復華台灣科技優息,284,94,190,合庫-台中,2024-05-15,1021
00936,台新永續高息中小,161,0,161,合庫-台中,2024-05-15,1021
2356,英業達,363,203,160,合庫-台中,2024-05-15,1021
00715L,期街口布蘭特正2,141,0,141,合庫-台中,2024-05-15,1021
2363,矽統,277,137,140,合庫-台中,2024-05-15,1021
1609,大亞,157,25,132,合庫-台中,2024-05-15,1021
3047,訊舟,144,35,109,合庫-台中,2024-05-15,1021
00878,國泰永續高股息,176,72,104,合庫-台中,2024-05-15,1021
1314,中石化,105,1,104,合庫-台中,2024-05-15,1021
2323,中環,86,2,84,合庫-台中,2024-05-15,1021
6120,達運,80,12,68,合庫-台中,2024-05-15,1021
1608,華榮,144,78,66,合庫-台中,2024-05-15,1021
1522,堤維西,158,93,65,合庫-台中,2024-05-15,1021
2516,新建,63,0,63,合庫-台中,2024-05-15,1021
00919,群益台灣精選高息,107,52,55,合庫-台中,2024-05-15,1021
2630,亞航,74,20,54,合庫-台中,2024-05-15,1021
00679B,元大美債20年,68,16,52,合庫-台中,2024-05-15,1021
3706,神達,172,127,45,合庫-台中,2024-05-15,1021
00637L,元大滬深300正2,604,561,43,合庫-台中,2024-05-15,1021
2515,中工,49,6,43,合庫-台中,2024-05-15,1021
5388,中磊,42,1,41,合庫-台中,2024-05-15,1021
9105,泰金寶-DR,75,35,40,合庫-台中,2024-05-15,1021
2405,輔信,73,35,38,合庫-台中,2024-05-15,1021
2615,萬海,155,119,36,合庫-台中,2024-05-15,1021
3062,建漢,40,6,34,合庫-台中,2024-05-15,1021
2486,一詮,54,21,33,合庫-台中,2024-05-15,1021
00752,中信中國50,33,0,33,合庫-台中,2024-05-15,1021
2882,國泰金,128,97,31,合庫-台中,2024-05-15,1021
00932,兆豐永續高息等權,31,0,31,合庫-台中,2024-05-15,1021
4414,如興,31,0,31,合庫-台中,2024-05-15,1021
00946,群益科技高息成長,79,48,31,合庫-台中,2024-05-15,1021
00918,大華優利高填息30,54,23,31,合庫-台中,2024-05-15,1021
2603,長榮,497,469,28,合庫-台中,2024-05-15,1021
1563,巧新,27,2,25,合庫-台中,2024-05-15,1021
2464,盟立,35,11,24,合庫-台中,2024-05-15,1021
2801,彰銀,33,10,23,合庫-台中,2024-05-15,1021
00690,兆豐藍籌30,22,1,21,合庫-台中,2024-05-15,1021
3234,光環,23,2,21,合庫-台中,2024-05-15,1021
00706L,期元大S＆P日圓正2,20,0,20,合庫-台中,2024-05-15,1021
2601,益航,20,0,20,合庫-台中,2024-05-15,1021
2324,仁寶,27,8,19,合庫-台中,2024-05-15,1021
2614,東森,20,1,19,合庫-台中,2024-05-15,1021
2349,錸德,20,3,17,合庫-台中,2024-05-15,1021
2002,中鋼,27,11,16,合庫-台中,2024-05-15,1021
2427,三商電,17,1,16,合庫-台中,2024-05-15,1021
5258,虹堡,16,0,16,合庫-台中,2024-05-15,1021
2913,農林,15,0,15,合庫-台中,2024-05-15,1021
00665L,富邦�琤肭磪囓�2,1611,591,1020,合庫-台中,2024-05-16,1021
2356,英業達,274,54,220,合庫-台中,2024-05-16,1021
2317,鴻海,652,459,193,合庫-台中,2024-05-16,1021
2382,廣達,281,109,172,合庫-台中,2024-05-16,1021
00632R,元大台灣50反1,261,90,171,合庫-台中,2024-05-16,1021
2329,華泰,157,31,126,合庫-台中,2024-05-16,1021
2609,陽明,471,347,124,合庫-台中,2024-05-16,1021
00688L,國泰20年美債正2,134,18,116,合庫-台中,2024-05-16,1021
1587,吉茂,138,26,112,合庫-台中,2024-05-16,1021
3231,緯創,185,73,112,合庫-台中,2024-05-16,1021
2614,東森,102,0,102,合庫-台中,2024-05-16,1021
1440,南紡,100,1,99,合庫-台中,2024-05-16,1021
2892,第一金,106,12,94,合庫-台中,2024-05-16,1021
00878,國泰永續高股息,192,103,89,合庫-台中,2024-05-16,1021
2489,瑞軒,119,39,80,合庫-台中,2024-05-16,1021
2401,凌陽,92,13,79,合庫-台中,2024-05-16,1021
8096,擎亞,156,82,74,合庫-台中,2024-05-16,1021
2101,南港,70,1,69,合庫-台中,2024-05-16,1021
2357,華碩,51,1,50,合庫-台中,2024-05-16,1021
00680L,元大美債20正2,53,5,48,合庫-台中,2024-05-16,1021
2881,富邦金,60,13,47,合庫-台中,2024-05-16,1021
2301,光寶科,84,43,41,合庫-台中,2024-05-16,1021
5871,中租-KY,42,4,38,合庫-台中,2024-05-16,1021
1608,華榮,118,83,35,合庫-台中,2024-05-16,1021
9955,佳龍,36,3,33,合庫-台中,2024-05-16,1021
2062,橋椿,64,33,31,合庫-台中,2024-05-16,1021
3305,昇貿,41,10,31,合庫-台中,2024-05-16,1021
3706,神達,48,17,31,合庫-台中,2024-05-16,1021
1442,名軒,31,2,29,合庫-台中,2024-05-16,1021
2405,輔信,32,4,28,合庫-台中,2024-05-16,1021
3481,群創,85,57,28,合庫-台中,2024-05-16,1021
6282,康舒,45,18,27,合庫-台中,2024-05-16,1021
2464,盟立,60,35,25,合庫-台中,2024-05-16,1021
6188,廣明,31,6,25,合庫-台中,2024-05-16,1021
2545,皇翔,32,7,25,合庫-台中,2024-05-16,1021
8070,長華*,35,10,25,合庫-台中,2024-05-16,1021
1618,合機,39,16,23,合庫-台中,2024-05-16,1021
3596,智易,22,0,22,合庫-台中,2024-05-16,1021
9105,泰金寶-DR,23,1,22,合庫-台中,2024-05-16,1021
3363,上詮,169,148,21,合庫-台中,2024-05-16,1021
2363,矽統,122,102,20,合庫-台中,2024-05-16,1021
00887,永豐中國科技50大,20,0,20,合庫-台中,2024-05-16,1021
9945,潤泰新,45,25,20,合庫-台中,2024-05-16,1021
3036,文曄,24,5,19,合庫-台中,2024-05-16,1021
9110,越南控-DR,18,0,18,合庫-台中,2024-05-16,1021
2331,精英,27,10,17,合庫-台中,2024-05-16,1021
2006,東和鋼鐵,17,1,16,合庫-台中,2024-05-16,1021
6901,鑽石投資,19,3,16,合庫-台中,2024-05-16,1021
00936,台新永續高息中小,16,0,16,合庫-台中,2024-05-16,1021
3523,迎輝,16,0,16,合庫-台中,2024-05-16,1021
00665L,富邦�琤肭磪囓�2,1299,576,723,合庫-台中,2024-05-17,1021
2618,長榮航,896,386,510,合庫-台中,2024-05-17,1021
00937B,群益ESG投等債20,516,114,402,合庫-台中,2024-05-17,1021
00929,復華台灣科技優息,300,1,299,合庫-台中,2024-05-17,1021
00878,國泰永續高股息,271,43,228,合庫-台中,2024-05-17,1021
2610,華航,415,275,140,合庫-台中,2024-05-17,1021
4908,前鼎,133,1,132,合庫-台中,2024-05-17,1021
5880,合庫金,120,4,116,合庫-台中,2024-05-17,1021
3036,文曄,107,2,105,合庫-台中,2024-05-17,1021
1608,華榮,130,37,93,合庫-台中,2024-05-17,1021
00679B,元大美債20年,93,0,93,合庫-台中,2024-05-17,1021
2317,鴻海,186,93,93,合庫-台中,2024-05-17,1021
00919,群益台灣精選高息,158,81,77,合庫-台中,2024-05-17,1021
6770,力積電,94,18,76,合庫-台中,2024-05-17,1021
2489,瑞軒,184,123,61,合庫-台中,2024-05-17,1021
2062,橋椿,60,0,60,合庫-台中,2024-05-17,1021
2313,華通,62,7,55,合庫-台中,2024-05-17,1021
2501,國建,100,48,52,合庫-台中,2024-05-17,1021
5392,能率,84,32,52,合庫-台中,2024-05-17,1021
2801,彰銀,66,15,51,合庫-台中,2024-05-17,1021
00944,野村趨勢動能高息,51,0,51,合庫-台中,2024-05-17,1021
00650L,復華香港正2,350,300,50,合庫-台中,2024-05-17,1021
3312,弘憶股,82,37,45,合庫-台中,2024-05-17,1021
2367,燿華,305,262,43,合庫-台中,2024-05-17,1021
3481,群創,77,34,43,合庫-台中,2024-05-17,1021
2408,南亞科,42,0,42,合庫-台中,2024-05-17,1021
00680L,元大美債20正2,43,6,37,合庫-台中,2024-05-17,1021
2537,聯上發,85,48,37,合庫-台中,2024-05-17,1021
3024,憶聲,56,20,36,合庫-台中,2024-05-17,1021
00631L,元大台灣50正2,71,36,35,合庫-台中,2024-05-17,1021
6120,達運,38,3,35,合庫-台中,2024-05-17,1021
5871,中租-KY,33,0,33,合庫-台中,2024-05-17,1021
2409,友達,43,10,33,合庫-台中,2024-05-17,1021
2352,佳世達,38,5,33,合庫-台中,2024-05-17,1021
00936,台新永續高息中小,32,0,32,合庫-台中,2024-05-17,1021
3060,銘異,77,48,29,合庫-台中,2024-05-17,1021
2241,艾姆勒,153,126,27,合庫-台中,2024-05-17,1021
00946,群益科技高息成長,27,1,26,合庫-台中,2024-05-17,1021
2359,所羅門,96,71,25,合庫-台中,2024-05-17,1021
00891,中信關鍵半導體,23,1,22,合庫-台中,2024-05-17,1021
2511,太子,37,15,22,合庫-台中,2024-05-17,1021
2617,台航,21,0,21,合庫-台中,2024-05-17,1021
3059,華晶科,79,58,21,合庫-台中,2024-05-17,1021
4960,誠美材,29,8,21,合庫-台中,2024-05-17,1021
8213,志超,21,0,21,合庫-台中,2024-05-17,1021
9945,潤泰新,29,8,21,合庫-台中,2024-05-17,1021
2401,凌陽,42,22,20,合庫-台中,2024-05-17,1021
2449,京元電子,36,16,20,合庫-台中,2024-05-17,1021
8111,立��,20,0,20,合庫-台中,2024-05-17,1021
6541,泰福-KY,20,1,19,合庫-台中,2024-05-17,1021
00665L,富邦�琤肭磪囓�2,1273,529,744,合庫-台中,2024-05-20,1021
1440,南紡,369,0,369,合庫-台中,2024-05-20,1021
2867,三商壽,421,116,305,合庫-台中,2024-05-20,1021
00929,復華台灣科技優息,348,73,275,合庫-台中,2024-05-20,1021
00679B,元大美債20年,143,31,112,合庫-台中,2024-05-20,1021
3231,緯創,138,30,108,合庫-台中,2024-05-20,1021
00637L,元大滬深300正2,462,387,75,合庫-台中,2024-05-20,1021
00687B,國泰20年美債,66,0,66,合庫-台中,2024-05-20,1021
00680L,元大美債20正2,60,5,55,合庫-台中,2024-05-20,1021
4906,正文,85,32,53,合庫-台中,2024-05-20,1021
2409,友達,120,67,53,合庫-台中,2024-05-20,1021
4513,福裕,48,0,48,合庫-台中,2024-05-20,1021
2317,鴻海,130,83,47,合庫-台中,2024-05-20,1021
2489,瑞軒,119,75,44,合庫-台中,2024-05-20,1021
00878,國泰永續高股息,109,68,41,合庫-台中,2024-05-20,1021
00915,凱基優選高股息30,39,0,39,合庫-台中,2024-05-20,1021
4533,協易機,88,51,37,合庫-台中,2024-05-20,1021
2611,志信,43,11,32,合庫-台中,2024-05-20,1021
4908,前鼎,32,0,32,合庫-台中,2024-05-20,1021
2356,英業達,77,47,30,合庫-台中,2024-05-20,1021
00945B,凱基美國非投等債,30,0,30,合庫-台中,2024-05-20,1021
1442,名軒,40,10,30,合庫-台中,2024-05-20,1021
9105,泰金寶-DR,50,20,30,合庫-台中,2024-05-20,1021
2601,益航,30,0,30,合庫-台中,2024-05-20,1021
8096,擎亞,56,27,29,合庫-台中,2024-05-20,1021
2367,燿華,153,124,29,合庫-台中,2024-05-20,1021
1301,台塑,28,0,28,合庫-台中,2024-05-20,1021
2516,新建,28,0,28,合庫-台中,2024-05-20,1021
2208,台船,30,3,27,合庫-台中,2024-05-20,1021
00933B,國泰10Y+金融債,29,2,27,合庫-台中,2024-05-20,1021
3035,智原,28,1,27,合庫-台中,2024-05-20,1021
5009,榮剛,31,6,25,合庫-台中,2024-05-20,1021
2017,官田鋼,30,5,25,合庫-台中,2024-05-20,1021
2352,佳世達,33,13,20,合庫-台中,2024-05-20,1021
00673R,期元大S＆P原油反1,20,0,20,合庫-台中,2024-05-20,1021
00936,台新永續高息中小,21,2,19,合庫-台中,2024-05-20,1021
8070,長華*,20,2,18,合庫-台中,2024-05-20,1021
4976,佳凌,46,29,17,合庫-台中,2024-05-20,1021
3363,上詮,41,24,17,合庫-台中,2024-05-20,1021
3047,訊舟,50,34,16,合庫-台中,2024-05-20,1021
5011,久陽,16,0,16,合庫-台中,2024-05-20,1021
6443,元晶,17,1,16,合庫-台中,2024-05-20,1021
1504,東元,17,1,16,合庫-台中,2024-05-20,1021
00918,大華優利高填息30,17,2,15,合庫-台中,2024-05-20,1021
8438,昶昕,15,0,15,合庫-台中,2024-05-20,1021
2706,第一店,15,0,15,合庫-台中,2024-05-20,1021
1312,國喬,15,0,15,合庫-台中,2024-05-20,1021
8028,昇陽半導體,51,36,15,合庫-台中,2024-05-20,1021
3712,永崴投控,14,0,14,合庫-台中,2024-05-20,1021
2603,長榮,111,98,13,合庫-台中,2024-05-20,1021
00929,復華台灣科技優息,481,16,465,合庫-台中,2024-05-21,1021
00632R,元大台灣50反1,400,4,396,合庫-台中,2024-05-21,1021
00665L,富邦�琤肭磪囓�2,521,220,301,合庫-台中,2024-05-21,1021
00650L,復華香港正2,424,189,235,合庫-台中,2024-05-21,1021
3523,迎輝,200,0,200,合庫-台中,2024-05-21,1021
1440,南紡,139,0,139,合庫-台中,2024-05-21,1021
00937B,群益ESG投等債20,148,22,126,合庫-台中,2024-05-21,1021
00687B,國泰20年美債,127,10,117,合庫-台中,2024-05-21,1021
2888,新光金,125,30,95,合庫-台中,2024-05-21,1021
00878,國泰永續高股息,127,32,95,合庫-台中,2024-05-21,1021
2515,中工,114,42,72,合庫-台中,2024-05-21,1021
2351,順德,68,1,67,合庫-台中,2024-05-21,1021
1522,堤維西,153,87,66,合庫-台中,2024-05-21,1021
2618,長榮航,116,51,65,合庫-台中,2024-05-21,1021
1608,華榮,175,113,62,合庫-台中,2024-05-21,1021
4906,正文,60,0,60,合庫-台中,2024-05-21,1021
2409,友達,75,16,59,合庫-台中,2024-05-21,1021
00715L,期街口布蘭特正2,72,14,58,合庫-台中,2024-05-21,1021
5302,太欣,55,0,55,合庫-台中,2024-05-21,1021
2324,仁寶,53,0,53,合庫-台中,2024-05-21,1021
3033,威健,104,52,52,合庫-台中,2024-05-21,1021
2883,凱基金,79,29,50,合庫-台中,2024-05-21,1021
2801,彰銀,50,0,50,合庫-台中,2024-05-21,1021
2890,永豐金,49,6,43,合庫-台中,2024-05-21,1021
00752,中信中國50,51,10,41,合庫-台中,2024-05-21,1021
2887,台新金,39,0,39,合庫-台中,2024-05-21,1021
2317,鴻海,62,24,38,合庫-台中,2024-05-21,1021
00670L,富邦NASDAQ正2,34,0,34,合庫-台中,2024-05-21,1021
6005,群益證,45,11,34,合庫-台中,2024-05-21,1021
2884,玉山金,58,25,33,合庫-台中,2024-05-21,1021
020032,元大綠能N,33,0,33,合庫-台中,2024-05-21,1021
1314,中石化,40,7,33,合庫-台中,2024-05-21,1021
2027,大成鋼,72,41,31,合庫-台中,2024-05-21,1021
9945,潤泰新,41,11,30,合庫-台中,2024-05-21,1021
3376,新日興,32,3,29,合庫-台中,2024-05-21,1021
00637L,元大滬深300正2,335,306,29,合庫-台中,2024-05-21,1021
00936,台新永續高息中小,49,20,29,合庫-台中,2024-05-21,1021
2605,新興,31,3,28,合庫-台中,2024-05-21,1021
3059,華晶科,53,26,27,合庫-台中,2024-05-21,1021
2611,志信,28,1,27,合庫-台中,2024-05-21,1021
2504,國產,33,6,27,合庫-台中,2024-05-21,1021
3338,泰碩,59,33,26,合庫-台中,2024-05-21,1021
2913,農林,25,0,25,合庫-台中,2024-05-21,1021
2809,京城銀,25,0,25,合庫-台中,2024-05-21,1021
1301,台塑,25,1,24,合庫-台中,2024-05-21,1021
00679B,元大美債20年,25,1,24,合庫-台中,2024-05-21,1021
2313,華通,95,71,24,合庫-台中,2024-05-21,1021
2489,瑞軒,38,14,24,合庫-台中,2024-05-21,1021
6147,頎邦,24,1,23,合庫-台中,2024-05-21,1021
6016,康和證,23,0,23,合庫-台中,2024-05-21,1021
00632R,元大台灣50反1,1149,0,1149,合庫-台中,2024-05-22,1021
00665L,富邦�琤肭磪囓�2,1289,1050,239,合庫-台中,2024-05-22,1021
00715L,期街口布蘭特正2,237,34,203,合庫-台中,2024-05-22,1021
5371,中光電,248,67,181,合庫-台中,2024-05-22,1021
00753L,中信中國50正2,126,0,126,合庫-台中,2024-05-22,1021
4961,天鈺,120,1,119,合庫-台中,2024-05-22,1021
2002,中鋼,117,6,111,合庫-台中,2024-05-22,1021
3176,基亞,109,6,103,合庫-台中,2024-05-22,1021
4160,訊聯基因,86,5,81,合庫-台中,2024-05-22,1021
8234,新漢,84,8,76,合庫-台中,2024-05-22,1021
1608,華榮,127,56,71,合庫-台中,2024-05-22,1021
2610,華航,157,87,70,合庫-台中,2024-05-22,1021
2618,長榮航,277,210,67,合庫-台中,2024-05-22,1021
4906,正文,79,21,58,合庫-台中,2024-05-22,1021
1444,力麗,59,2,57,合庫-台中,2024-05-22,1021
1605,華新,63,9,54,合庫-台中,2024-05-22,1021
00720B,元大投資級公司債,51,0,51,合庫-台中,2024-05-22,1021
1713,國化,54,3,51,合庫-台中,2024-05-22,1021
2838A,聯邦銀甲特,50,0,50,合庫-台中,2024-05-22,1021
4543,萬在,65,17,48,合庫-台中,2024-05-22,1021
00650L,復華香港正2,266,221,45,合庫-台中,2024-05-22,1021
3005,神基,56,13,43,合庫-台中,2024-05-22,1021
6125,廣運,187,144,43,合庫-台中,2024-05-22,1021
1618,合機,45,3,42,合庫-台中,2024-05-22,1021
2884,玉山金,65,24,41,合庫-台中,2024-05-22,1021
2367,燿華,120,80,40,合庫-台中,2024-05-22,1021
3706,神達,78,39,39,合庫-台中,2024-05-22,1021
2007,燁興,39,0,39,合庫-台中,2024-05-22,1021
9919,康那香,38,0,38,合庫-台中,2024-05-22,1021
9949,琉園,37,0,37,合庫-台中,2024-05-22,1021
2241,艾姆勒,44,7,37,合庫-台中,2024-05-22,1021
2401,凌陽,38,1,37,合庫-台中,2024-05-22,1021
1612,宏泰,45,10,35,合庫-台中,2024-05-22,1021
2845,遠東銀,32,0,32,合庫-台中,2024-05-22,1021
2009,第一銅,358,327,31,合庫-台中,2024-05-22,1021
8163,達方,35,4,31,合庫-台中,2024-05-22,1021
2504,國產,33,3,30,合庫-台中,2024-05-22,1021
1721,三晃,30,0,30,合庫-台中,2024-05-22,1021
2374,佳能,111,82,29,合庫-台中,2024-05-22,1021
3013,晟銘電,191,163,28,合庫-台中,2024-05-22,1021
3060,銘異,34,9,25,合庫-台中,2024-05-22,1021
5009,榮剛,26,1,25,合庫-台中,2024-05-22,1021
2887E,台新戊特,25,0,25,合庫-台中,2024-05-22,1021
5230,雷笛克光學,49,24,25,合庫-台中,2024-05-22,1021
6265,方土昶,25,0,25,合庫-台中,2024-05-22,1021
8110,華東,30,7,23,合庫-台中,2024-05-22,1021
00670L,富邦NASDAQ正2,23,0,23,合庫-台中,2024-05-22,1021
5443,均豪,41,18,23,合庫-台中,2024-05-22,1021
2337,旺宏,22,0,22,合庫-台中,2024-05-22,1021
1303,南亞,22,0,22,合庫-台中,2024-05-22,1021
00632R,元大台灣50反1,237,3,234,合庫-台中,2024-05-23,1021
2515,中工,168,16,152,合庫-台中,2024-05-23,1021
00650L,復華香港正2,390,250,140,合庫-台中,2024-05-23,1021
2002,中鋼,128,5,123,合庫-台中,2024-05-23,1021
2409,友達,132,19,113,合庫-台中,2024-05-23,1021
2464,盟立,197,103,94,合庫-台中,2024-05-23,1021
2888,新光金,89,0,89,合庫-台中,2024-05-23,1021
2367,燿華,320,231,89,合庫-台中,2024-05-23,1021
1713,國化,86,0,86,合庫-台中,2024-05-23,1021
6288,聯嘉,85,0,85,合庫-台中,2024-05-23,1021
2444,兆勁,90,11,79,合庫-台中,2024-05-23,1021
2812,台中銀,87,10,77,合庫-台中,2024-05-23,1021
2313,華通,166,94,72,合庫-台中,2024-05-23,1021
8936,國統,83,11,72,合庫-台中,2024-05-23,1021
2801,彰銀,63,0,63,合庫-台中,2024-05-23,1021
2884,玉山金,69,7,62,合庫-台中,2024-05-23,1021
00919,群益台灣精選高息,121,59,62,合庫-台中,2024-05-23,1021
6147,頎邦,61,1,60,合庫-台中,2024-05-23,1021
2356,英業達,103,45,58,合庫-台中,2024-05-23,1021
2883,凱基金,63,7,56,合庫-台中,2024-05-23,1021
5498,凱崴,71,17,54,合庫-台中,2024-05-23,1021
3056,富華新,55,2,53,合庫-台中,2024-05-23,1021
1609,大亞,62,9,53,合庫-台中,2024-05-23,1021
6120,達運,50,0,50,合庫-台中,2024-05-23,1021
00878,國泰永續高股息,70,21,49,合庫-台中,2024-05-23,1021
00715L,期街口布蘭特正2,105,62,43,合庫-台中,2024-05-23,1021
4906,正文,41,2,39,合庫-台中,2024-05-23,1021
8071,能率網通,73,37,36,合庫-台中,2024-05-23,1021
5521,工信,35,0,35,合庫-台中,2024-05-23,1021
2363,矽統,66,32,34,合庫-台中,2024-05-23,1021
00751B,元大AAA至A公司債,34,0,34,合庫-台中,2024-05-23,1021
1314,中石化,44,10,34,合庫-台中,2024-05-23,1021
2352,佳世達,37,5,32,合庫-台中,2024-05-23,1021
8234,新漢,32,2,30,合庫-台中,2024-05-23,1021
2401,凌陽,42,12,30,合庫-台中,2024-05-23,1021
1219,福壽,29,0,29,合庫-台中,2024-05-23,1021
4303,信立,28,0,28,合庫-台中,2024-05-23,1021
2330,台積電,60,32,28,合庫-台中,2024-05-23,1021
6116,彩晶,64,37,27,合庫-台中,2024-05-23,1021
00936,台新永續高息中小,27,0,27,合庫-台中,2024-05-23,1021
00882,中信中國高股息,70,44,26,合庫-台中,2024-05-23,1021
2337,旺宏,27,1,26,合庫-台中,2024-05-23,1021
3481,群創,152,126,26,合庫-台中,2024-05-23,1021
3376,新日興,44,19,25,合庫-台中,2024-05-23,1021
1515,力山,27,2,25,合庫-台中,2024-05-23,1021
1618,合機,26,1,25,合庫-台中,2024-05-23,1021
00680L,元大美債20正2,25,0,25,合庫-台中,2024-05-23,1021
3312,弘憶股,111,86,25,合庫-台中,2024-05-23,1021
9945,潤泰新,29,5,24,合庫-台中,2024-05-23,1021
6139,亞翔,26,2,24,合庫-台中,2024-05-23,1021
2365,昆盈,435,103,332,合庫-台中,2024-05-24,1021
00937B,群益ESG投等債20,242,1,241,合庫-台中,2024-05-24,1021
2618,長榮航,495,256,239,合庫-台中,2024-05-24,1021
6188,廣明,230,46,184,合庫-台中,2024-05-24,1021
00712,復華富時不動產,141,2,139,合庫-台中,2024-05-24,1021
2610,華航,172,39,133,合庫-台中,2024-05-24,1021
00650L,復華香港正2,335,250,85,合庫-台中,2024-05-24,1021
2344,華邦電,110,26,84,合庫-台中,2024-05-24,1021
3047,訊舟,108,36,72,合庫-台中,2024-05-24,1021
9105,泰金寶-DR,105,33,72,合庫-台中,2024-05-24,1021
5880,合庫金,70,4,66,合庫-台中,2024-05-24,1021
4160,訊聯基因,70,11,59,合庫-台中,2024-05-24,1021
2486,一詮,161,104,57,合庫-台中,2024-05-24,1021
2444,兆勁,48,1,47,合庫-台中,2024-05-24,1021
6770,力積電,53,7,46,合庫-台中,2024-05-24,1021
2002,中鋼,53,9,44,合庫-台中,2024-05-24,1021
00751B,元大AAA至A公司債,42,0,42,合庫-台中,2024-05-24,1021
2891,中信金,49,7,42,合庫-台中,2024-05-24,1021
2303,聯電,84,48,36,合庫-台中,2024-05-24,1021
00933B,國泰10Y+金融債,37,0,37,合庫-台中,2024-05-24,1021
2884,玉山金,45,8,37,合庫-台中,2024-05-24,1021
2887,台新金,34,2,32,合庫-台中,2024-05-24,1021
2801,彰銀,40,10,30,合庫-台中,2024-05-24,1021
1516,川飛,35,5,30,合庫-台中,2024-05-24,1021
6117,迎廣,84,58,26,合庫-台中,2024-05-24,1021
00941,中信上游半導體,26,0,26,合庫-台中,2024-05-24,1021
00715L,期街口布蘭特正2,43,17,26,合庫-台中,2024-05-24,1021
2409,友達,52,26,26,合庫-台中,2024-05-24,1021
9945,潤泰新,32,6,26,合庫-台中,2024-05-24,1021
00687B,國泰20年美債,36,10,26,合庫-台中,2024-05-24,1021
2834,臺企銀,35,10,25,合庫-台中,2024-05-24,1021
2886,兆豐金,24,0,24,合庫-台中,2024-05-24,1021
3176,基亞,24,0,24,合庫-台中,2024-05-24,1021
2337,旺宏,23,1,22,合庫-台中,2024-05-24,1021
00944,野村趨勢動能高息,22,0,22,合庫-台中,2024-05-24,1021
2501,國建,64,42,22,合庫-台中,2024-05-24,1021
2889,國票金,40,20,20,合庫-台中,2024-05-24,1021
8936,國統,22,3,19,合庫-台中,2024-05-24,1021
3231,緯創,64,46,18,合庫-台中,2024-05-24,1021
6197,佳必琪,24,6,18,合庫-台中,2024-05-24,1021
4979,華星光,57,40,17,合庫-台中,2024-05-24,1021
3163,波若威,199,181,18,合庫-台中,2024-05-24,1021
2313,華通,84,67,17,合庫-台中,2024-05-24,1021
00946,群益科技高息成長,23,6,17,合庫-台中,2024-05-24,1021
1608,華榮,32,16,16,合庫-台中,2024-05-24,1021
6282,康舒,28,12,16,合庫-台中,2024-05-24,1021
6147,頎邦,19,3,16,合庫-台中,2024-05-24,1021
3576,聯合再生,17,2,15,合庫-台中,2024-05-24,1021
2867,三商壽,26,11,15,合庫-台中,2024-05-24,1021
2014,中鴻,14,0,14,合庫-台中,2024-05-24,1021
2317,鴻海,1072,665,407,合庫-台中,2024-05-27,1021
3047,訊舟,421,64,357,合庫-台中,2024-05-27,1021
00680L,元大美債20正2,342,0,342,合庫-台中,2024-05-27,1021
00937B,群益ESG投等債20,296,87,209,合庫-台中,2024-05-27,1021
00877,復華中國5G,208,0,208,合庫-台中,2024-05-27,1021
5371,中光電,256,52,204,合庫-台中,2024-05-27,1021
9105,泰金寶-DR,263,127,136,合庫-台中,2024-05-27,1021
2353,宏��,261,141,120,合庫-台中,2024-05-27,1021
2515,中工,108,1,107,合庫-台中,2024-05-27,1021
2892,第一金,107,0,107,合庫-台中,2024-05-27,1021
00712,復華富時不動產,116,28,88,合庫-台中,2024-05-27,1021
00919,群益台灣精選高息,122,41,81,合庫-台中,2024-05-27,1021
2618,長榮航,201,123,78,合庫-台中,2024-05-27,1021
4908,前鼎,64,1,63,合庫-台中,2024-05-27,1021
00670L,富邦NASDAQ正2,59,0,59,合庫-台中,2024-05-27,1021
2002,中鋼,90,32,58,合庫-台中,2024-05-27,1021
3338,泰碩,108,50,58,合庫-台中,2024-05-27,1021
2330,台積電,65,12,53,合庫-台中,2024-05-27,1021
2887,台新金,54,4,50,合庫-台中,2024-05-27,1021
2103,台橡,50,0,50,合庫-台中,2024-05-27,1021
2313,華通,75,28,47,合庫-台中,2024-05-27,1021
00946,群益科技高息成長,55,10,45,合庫-台中,2024-05-27,1021
8110,華東,43,0,43,合庫-台中,2024-05-27,1021
6187,萬潤,43,1,42,合庫-台中,2024-05-27,1021
5498,凱崴,55,14,41,合庫-台中,2024-05-27,1021
6125,廣運,175,134,41,合庫-台中,2024-05-27,1021
6147,頎邦,41,1,40,合庫-台中,2024-05-27,1021
00945B,凱基美國非投等債,40,0,40,合庫-台中,2024-05-27,1021
3312,弘憶股,87,47,40,合庫-台中,2024-05-27,1021
3706,神達,62,22,40,合庫-台中,2024-05-27,1021
2609,陽明,129,94,35,合庫-台中,2024-05-27,1021
2886,兆豐金,35,0,35,合庫-台中,2024-05-27,1021
3024,憶聲,42,7,35,合庫-台中,2024-05-27,1021
2352,佳世達,58,24,34,合庫-台中,2024-05-27,1021
6209,今國光,39,9,30,合庫-台中,2024-05-27,1021
2017,官田鋼,30,0,30,合庫-台中,2024-05-27,1021
6609,瀧澤科,30,1,29,合庫-台中,2024-05-27,1021
3481,群創,128,99,29,合庫-台中,2024-05-27,1021
2489,瑞軒,51,22,29,合庫-台中,2024-05-27,1021
6770,力積電,26,0,26,合庫-台中,2024-05-27,1021
00933B,國泰10Y+金融債,25,0,25,合庫-台中,2024-05-27,1021
5521,工信,25,0,25,合庫-台中,2024-05-27,1021
4967,十銓,32,8,24,合庫-台中,2024-05-27,1021
6133,金橋,30,6,24,合庫-台中,2024-05-27,1021
3013,晟銘電,42,18,24,合庫-台中,2024-05-27,1021
3234,光環,39,16,23,合庫-台中,2024-05-27,1021
2208,台船,24,1,23,合庫-台中,2024-05-27,1021
1815,富喬,62,39,23,合庫-台中,2024-05-27,1021
6177,達麗,23,0,23,合庫-台中,2024-05-27,1021
5251,天鉞電,30,9,21,合庫-台中,2024-05-27,1021
00937B,群益ESG投等債20,347,24,323,合庫-台中,2024-05-28,1021
2353,宏��,436,141,295,合庫-台中,2024-05-28,1021
4908,前鼎,249,5,244,合庫-台中,2024-05-28,1021
3047,訊舟,240,48,192,合庫-台中,2024-05-28,1021
2801,彰銀,186,0,186,合庫-台中,2024-05-28,1021
9919,康那香,156,0,156,合庫-台中,2024-05-28,1021
2363,矽統,284,132,152,合庫-台中,2024-05-28,1021
3202,樺晟,172,63,109,合庫-台中,2024-05-28,1021
6188,廣明,215,113,102,合庫-台中,2024-05-28,1021
2317,鴻海,119,27,92,合庫-台中,2024-05-28,1021
00946,群益科技高息成長,108,22,86,合庫-台中,2024-05-28,1021
00919,群益台灣精選高息,114,41,73,合庫-台中,2024-05-28,1021
00650L,復華香港正2,278,209,69,合庫-台中,2024-05-28,1021
00637L,元大滬深300正2,266,200,66,合庫-台中,2024-05-28,1021
2409,友達,83,18,65,合庫-台中,2024-05-28,1021
6160,欣技,60,0,60,合庫-台中,2024-05-28,1021
00929,復華台灣科技優息,90,31,59,合庫-台中,2024-05-28,1021
2354,鴻準,273,215,58,合庫-台中,2024-05-28,1021
2382,廣達,65,9,56,合庫-台中,2024-05-28,1021
2609,陽明,120,66,54,合庫-台中,2024-05-28,1021
6197,佳必琪,52,1,51,合庫-台中,2024-05-28,1021
00655L,國泰中國A50正2,51,0,51,合庫-台中,2024-05-28,1021
00751B,元大AAA至A公司債,52,1,51,合庫-台中,2024-05-28,1021
2641,正德,150,101,49,合庫-台中,2024-05-28,1021
00712,復華富時不動產,48,0,48,合庫-台中,2024-05-28,1021
2891,中信金,58,10,48,合庫-台中,2024-05-28,1021
2303,聯電,95,50,45,合庫-台中,2024-05-28,1021
2615,萬海,95,54,41,合庫-台中,2024-05-28,1021
2365,昆盈,41,0,41,合庫-台中,2024-05-28,1021
2834,臺企銀,53,12,41,合庫-台中,2024-05-28,1021
00933B,國泰10Y+金融債,50,11,39,合庫-台中,2024-05-28,1021
2912,統一超,37,0,37,合庫-台中,2024-05-28,1021
4533,協易機,36,1,35,合庫-台中,2024-05-28,1021
2392,正崴,60,27,33,合庫-台中,2024-05-28,1021
2417,圓剛,75,43,32,合庫-台中,2024-05-28,1021
4160,訊聯基因,123,93,30,合庫-台中,2024-05-28,1021
1303,南亞,30,0,30,合庫-台中,2024-05-28,1021
6215,和椿,74,44,30,合庫-台中,2024-05-28,1021
1444,力麗,28,0,28,合庫-台中,2024-05-28,1021
5608,四維航,73,46,27,合庫-台中,2024-05-28,1021
00753L,中信中國50正2,44,17,27,合庫-台中,2024-05-28,1021
3013,晟銘電,51,25,26,合庫-台中,2024-05-28,1021
00679B,元大美債20年,80,54,26,合庫-台中,2024-05-28,1021
1563,巧新,25,0,25,合庫-台中,2024-05-28,1021
00939,統一台灣高息動能,32,7,25,合庫-台中,2024-05-28,1021
2313,華通,32,8,24,合庫-台中,2024-05-28,1021
2886,兆豐金,25,2,23,合庫-台中,2024-05-28,1021
00673R,期元大S＆P原油反1,23,0,23,合庫-台中,2024-05-28,1021
3535,晶彩科,34,11,23,合庫-台中,2024-05-28,1021
2486,一詮,85,63,22,合庫-台中,2024-05-28,1021
00665L,富邦�琤肭磪囓�2,2013,150,1863,合庫-台中,2024-05-29,1021
00857B,永豐20年美公債,652,0,652,合庫-台中,2024-05-29,1021
3047,訊舟,678,85,593,合庫-台中,2024-05-29,1021
2867,三商壽,398,32,366,合庫-台中,2024-05-29,1021
00937B,群益ESG投等債20,1250,949,301,合庫-台中,2024-05-29,1021
2353,宏��,367,92,275,合庫-台中,2024-05-29,1021
00712,復華富時不動產,230,0,230,合庫-台中,2024-05-29,1021
2883,凱基金,227,1,226,合庫-台中,2024-05-29,1021
00946,群益科技高息成長,202,20,182,合庫-台中,2024-05-29,1021
2409,友達,192,30,162,合庫-台中,2024-05-29,1021
00679B,元大美債20年,228,68,160,合庫-台中,2024-05-29,1021
3036,文曄,154,0,154,合庫-台中,2024-05-29,1021
3481,群創,183,38,145,合庫-台中,2024-05-29,1021
00680L,元大美債20正2,253,109,144,合庫-台中,2024-05-29,1021
5880,合庫金,163,21,142,合庫-台中,2024-05-29,1021
2801,彰銀,142,0,142,合庫-台中,2024-05-29,1021
2613,中櫃,144,7,137,合庫-台中,2024-05-29,1021
00751B,元大AAA至A公司債,133,5,128,合庫-台中,2024-05-29,1021
2002,中鋼,113,10,103,合庫-台中,2024-05-29,1021
2884,玉山金,101,6,95,合庫-台中,2024-05-29,1021
00753L,中信中國50正2,94,1,93,合庫-台中,2024-05-29,1021
2610,華航,105,18,87,合庫-台中,2024-05-29,1021
2891,中信金,86,0,86,合庫-台中,2024-05-29,1021
2317,鴻海,121,40,81,合庫-台中,2024-05-29,1021
1444,力麗,80,0,80,合庫-台中,2024-05-29,1021
2303,聯電,94,19,75,合庫-台中,2024-05-29,1021
2834,臺企銀,75,0,75,合庫-台中,2024-05-29,1021
00687B,國泰20年美債,77,3,74,合庫-台中,2024-05-29,1021
3535,晶彩科,77,7,70,合庫-台中,2024-05-29,1021
3231,緯創,99,31,68,合庫-台中,2024-05-29,1021
2401,凌陽,205,140,65,合庫-台中,2024-05-29,1021
2885,元大金,66,1,65,合庫-台中,2024-05-29,1021
2489,瑞軒,258,197,61,合庫-台中,2024-05-29,1021
2349,錸德,83,22,61,合庫-台中,2024-05-29,1021
2105,正新,62,2,60,合庫-台中,2024-05-29,1021
2609,陽明,95,37,58,合庫-台中,2024-05-29,1021
00933B,國泰10Y+金融債,52,0,52,合庫-台中,2024-05-29,1021
2913,農林,51,0,51,合庫-台中,2024-05-29,1021
9945,潤泰新,48,2,46,合庫-台中,2024-05-29,1021
2890,永豐金,45,0,45,合庫-台中,2024-05-29,1021
3537,堡達,68,25,43,合庫-台中,2024-05-29,1021
2892,第一金,42,0,42,合庫-台中,2024-05-29,1021
2886,兆豐金,41,0,41,合庫-台中,2024-05-29,1021
6227,茂綸,110,70,40,合庫-台中,2024-05-29,1021
2614,東森,69,30,39,合庫-台中,2024-05-29,1021
2887,台新金,59,21,38,合庫-台中,2024-05-29,1021
6120,達運,42,5,37,合庫-台中,2024-05-29,1021
3287,廣寰科,52,15,37,合庫-台中,2024-05-29,1021
4906,正文,50,13,37,合庫-台中,2024-05-29,1021
00878,國泰永續高股息,46,9,37,合庫-台中,2024-05-29,1021
00937B,群益ESG投等債20,309,20,289,合庫-台中,2024-05-30,1021
2618,長榮航,289,47,242,合庫-台中,2024-05-30,1021
00680L,元大美債20正2,217,0,217,合庫-台中,2024-05-30,1021
2002,中鋼,219,6,213,合庫-台中,2024-05-30,1021
00688L,國泰20年美債正2,207,25,182,合庫-台中,2024-05-30,1021
00929,復華台灣科技優息,212,52,160,合庫-台中,2024-05-30,1021
2845,遠東銀,152,0,152,合庫-台中,2024-05-30,1021
5880,合庫金,129,0,129,合庫-台中,2024-05-30,1021
2834,臺企銀,126,1,125,合庫-台中,2024-05-30,1021
2363,矽統,164,47,117,合庫-台中,2024-05-30,1021
2353,宏��,263,146,117,合庫-台中,2024-05-30,1021
00712,復華富時不動產,119,2,117,合庫-台中,2024-05-30,1021
00878,國泰永續高股息,121,13,108,合庫-台中,2024-05-30,1021
6120,達運,104,1,103,合庫-台中,2024-05-30,1021
00753L,中信中國50正2,85,0,85,合庫-台中,2024-05-30,1021
2891,中信金,83,5,78,合庫-台中,2024-05-30,1021
00933B,國泰10Y+金融債,77,2,75,合庫-台中,2024-05-30,1021
2610,華航,104,31,73,合庫-台中,2024-05-30,1021
2634,漢翔,86,16,70,合庫-台中,2024-05-30,1021
2317,鴻海,129,58,71,合庫-台中,2024-05-30,1021
00679B,元大美債20年,84,14,70,合庫-台中,2024-05-30,1021
2408,南亞科,69,2,67,合庫-台中,2024-05-30,1021
5608,四維航,89,23,66,合庫-台中,2024-05-30,1021
00650L,復華香港正2,285,220,65,合庫-台中,2024-05-30,1021
00940,元大台灣價值高息,149,86,63,合庫-台中,2024-05-30,1021
1609,大亞,70,8,62,合庫-台中,2024-05-30,1021
00687B,國泰20年美債,81,20,61,合庫-台中,2024-05-30,1021
4562,穎漢,148,87,61,合庫-台中,2024-05-30,1021
00751B,元大AAA至A公司債,60,0,60,合庫-台中,2024-05-30,1021
2354,鴻準,78,21,57,合庫-台中,2024-05-30,1021
4533,協易機,99,46,53,合庫-台中,2024-05-30,1021
2356,英業達,60,8,52,合庫-台中,2024-05-30,1021
00919,群益台灣精選高息,78,28,50,合庫-台中,2024-05-30,1021
8215,明基材,50,0,50,合庫-台中,2024-05-30,1021
2884,玉山金,48,1,47,合庫-台中,2024-05-30,1021
00946,群益科技高息成長,98,54,44,合庫-台中,2024-05-30,1021
3011,今皓,44,0,44,合庫-台中,2024-05-30,1021
2609,陽明,75,33,42,合庫-台中,2024-05-30,1021
00637L,元大滬深300正2,246,204,42,合庫-台中,2024-05-30,1021
1815,富喬,261,222,39,合庫-台中,2024-05-30,1021
2405,輔信,85,46,39,合庫-台中,2024-05-30,1021
2886,兆豐金,39,1,38,合庫-台中,2024-05-30,1021
2344,華邦電,48,12,36,合庫-台中,2024-05-30,1021
2316,楠梓電,37,1,36,合庫-台中,2024-05-30,1021
2605,新興,96,60,36,合庫-台中,2024-05-30,1021
6188,廣明,86,50,36,合庫-台中,2024-05-30,1021
2313,華通,138,103,35,合庫-台中,2024-05-30,1021
3005,神基,35,0,35,合庫-台中,2024-05-30,1021
4908,前鼎,36,1,35,合庫-台中,2024-05-30,1021
6116,彩晶,66,32,34,合庫-台中,2024-05-30,1021
00929,復華台灣科技優息,310,6,304,合庫-台中,2024-05-31,1021
1440,南紡,215,2,213,合庫-台中,2024-05-31,1021
00919,群益台灣精選高息,232,54,178,合庫-台中,2024-05-31,1021
2609,陽明,438,272,166,合庫-台中,2024-05-31,1021
4562,穎漢,170,39,131,合庫-台中,2024-05-31,1021
5880,合庫金,130,2,128,合庫-台中,2024-05-31,1021
00665L,富邦�琤肭磪囓�2,416,301,115,合庫-台中,2024-05-31,1021
2375,凱美,119,10,109,合庫-台中,2024-05-31,1021
00715L,期街口布蘭特正2,105,0,105,合庫-台中,2024-05-31,1021
4906,正文,120,17,103,合庫-台中,2024-05-31,1021
2610,華航,115,17,98,合庫-台中,2024-05-31,1021
2328,廣宇,130,42,88,合庫-台中,2024-05-31,1021
2303,聯電,121,39,82,合庫-台中,2024-05-31,1021
1802,台玻,110,29,81,合庫-台中,2024-05-31,1021
2363,矽統,108,35,73,合庫-台中,2024-05-31,1021
00939,統一台灣高息動能,70,0,70,合庫-台中,2024-05-31,1021
2002,中鋼,68,1,67,合庫-台中,2024-05-31,1021
00946,群益科技高息成長,74,8,66,合庫-台中,2024-05-31,1021
6770,力積電,66,1,65,合庫-台中,2024-05-31,1021
3260,威剛,69,4,65,合庫-台中,2024-05-31,1021
00753L,中信中國50正2,68,8,60,合庫-台中,2024-05-31,1021
2867,三商壽,76,17,59,合庫-台中,2024-05-31,1021
1784,訊聯,55,2,53,合庫-台中,2024-05-31,1021
6188,廣明,143,90,53,合庫-台中,2024-05-31,1021
1815,富喬,110,58,52,合庫-台中,2024-05-31,1021
2801,彰銀,49,0,49,合庫-台中,2024-05-31,1021
4979,華星光,50,2,48,合庫-台中,2024-05-31,1021
2382,廣達,56,11,45,合庫-台中,2024-05-31,1021
00918,大華優利高填息30,60,15,45,合庫-台中,2024-05-31,1021
3059,華晶科,58,13,45,合庫-台中,2024-05-31,1021
3011,今皓,43,0,43,合庫-台中,2024-05-31,1021
2353,宏��,100,58,42,合庫-台中,2024-05-31,1021
2614,東森,41,0,41,合庫-台中,2024-05-31,1021
00878,國泰永續高股息,75,34,41,合庫-台中,2024-05-31,1021
2344,華邦電,45,6,39,合庫-台中,2024-05-31,1021
2903,遠百,37,0,37,合庫-台中,2024-05-31,1021
3062,建漢,42,6,36,合庫-台中,2024-05-31,1021
3380,明泰,41,6,35,合庫-台中,2024-05-31,1021
8473,山林水,35,1,34,合庫-台中,2024-05-31,1021
00679B,元大美債20年,55,21,34,合庫-台中,2024-05-31,1021
00891,中信關鍵半導體,31,0,31,合庫-台中,2024-05-31,1021
6120,達運,31,0,31,合庫-台中,2024-05-31,1021
2885,元大金,28,0,28,合庫-台中,2024-05-31,1021
00881,國泰台灣5G+,28,0,28,合庫-台中,2024-05-31,1021
8935,邦泰,26,0,26,合庫-台中,2024-05-31,1021
3712,永崴投控,27,1,26,合庫-台中,2024-05-31,1021
2905,三商,25,0,25,合庫-台中,2024-05-31,1021
2506,太設,52,28,24,合庫-台中,2024-05-31,1021
2634,漢翔,28,5,23,合庫-台中,2024-05-31,1021
2892,第一金,25,2,23,合庫-台中,2024-05-31,1021
00665L,富邦�琤肭磪囓�2,1512,261,1251,合庫-台中,2024-06-03,1021
00632R,元大台灣50反1,447,0,447,合庫-台中,2024-06-03,1021
2867,三商壽,246,22,224,合庫-台中,2024-06-03,1021
00715L,期街口布蘭特正2,160,0,160,合庫-台中,2024-06-03,1021
6188,廣明,252,102,150,合庫-台中,2024-06-03,1021
00637L,元大滬深300正2,319,200,119,合庫-台中,2024-06-03,1021
3481,群創,119,2,117,合庫-台中,2024-06-03,1021
00918,大華優利高填息30,113,5,108,合庫-台中,2024-06-03,1021
00919,群益台灣精選高息,162,63,99,合庫-台中,2024-06-03,1021
2615,萬海,174,82,92,合庫-台中,2024-06-03,1021
5880,合庫金,89,0,89,合庫-台中,2024-06-03,1021
6120,達運,80,1,79,合庫-台中,2024-06-03,1021
4533,協易機,113,51,62,合庫-台中,2024-06-03,1021
2801,彰銀,63,3,60,合庫-台中,2024-06-03,1021
00946,群益科技高息成長,70,10,60,合庫-台中,2024-06-03,1021
00642U,期元大S＆P石油,53,0,53,合庫-台中,2024-06-03,1021
2353,宏��,85,38,47,合庫-台中,2024-06-03,1021
2324,仁寶,92,47,45,合庫-台中,2024-06-03,1021
2354,鴻準,113,70,43,合庫-台中,2024-06-03,1021
6770,力積電,49,7,42,合庫-台中,2024-06-03,1021
2618,長榮航,184,143,41,合庫-台中,2024-06-03,1021
3380,明泰,40,3,37,合庫-台中,2024-06-03,1021
00850,元大臺灣ESG永續,35,0,35,合庫-台中,2024-06-03,1021
2467,志聖,35,2,33,合庫-台中,2024-06-03,1021
2616,山隆,33,0,33,合庫-台中,2024-06-03,1021
4541,晟田,32,0,32,合庫-台中,2024-06-03,1021
1539,巨庭,31,0,31,合庫-台中,2024-06-03,1021
3260,威剛,38,8,30,合庫-台中,2024-06-03,1021
3312,弘憶股,56,26,30,合庫-台中,2024-06-03,1021
00929,復華台灣科技優息,166,137,29,合庫-台中,2024-06-03,1021
2460,建通,29,0,29,合庫-台中,2024-06-03,1021
2002,中鋼,40,13,27,合庫-台中,2024-06-03,1021
3059,華晶科,56,30,26,合庫-台中,2024-06-03,1021
3490,單井,35,9,26,合庫-台中,2024-06-03,1021
2880,華南金,25,1,24,合庫-台中,2024-06-03,1021
2365,昆盈,31,7,24,合庫-台中,2024-06-03,1021
2889,國票金,35,11,24,合庫-台中,2024-06-03,1021
1519,華城,31,8,23,合庫-台中,2024-06-03,1021
1447,力鵬,23,0,23,合庫-台中,2024-06-03,1021
3594,磐儀,29,6,23,合庫-台中,2024-06-03,1021
6005,群益證,22,0,22,合庫-台中,2024-06-03,1021
3615,安可,20,0,20,合庫-台中,2024-06-03,1021
00687B,國泰20年美債,86,66,20,合庫-台中,2024-06-03,1021
1455,集盛,20,0,20,合庫-台中,2024-06-03,1021
4127,天良,20,0,20,合庫-台中,2024-06-03,1021
2886,兆豐金,19,0,19,合庫-台中,2024-06-03,1021
2301,光寶科,36,17,19,合庫-台中,2024-06-03,1021
1608,華榮,19,0,19,合庫-台中,2024-06-03,1021
6189,豐藝,20,1,19,合庫-台中,2024-06-03,1021
00650L,復華香港正2,218,200,18,合庫-台中,2024-06-03,1021
2317,鴻海,626,46,580,合庫-台中,2024-06-04,1021
00936,台新永續高息中小,369,74,295,合庫-台中,2024-06-04,1021
00665L,富邦�琤肭磪囓�2,830,586,244,合庫-台中,2024-06-04,1021
6125,廣運,404,181,223,合庫-台中,2024-06-04,1021
00919,群益台灣精選高息,329,109,220,合庫-台中,2024-06-04,1021
00715L,期街口布蘭特正2,281,62,219,合庫-台中,2024-06-04,1021
00918,大華優利高填息30,221,5,216,合庫-台中,2024-06-04,1021
2344,華邦電,201,6,195,合庫-台中,2024-06-04,1021
2888,新光金,279,90,189,合庫-台中,2024-06-04,1021
00929,復華台灣科技優息,248,65,183,合庫-台中,2024-06-04,1021
2312,金寶,172,17,155,合庫-台中,2024-06-04,1021
2515,中工,189,35,154,合庫-台中,2024-06-04,1021
5880,合庫金,154,4,150,合庫-台中,2024-06-04,1021
2409,友達,161,13,148,合庫-台中,2024-06-04,1021
1303,南亞,146,2,144,合庫-台中,2024-06-04,1021
6270,倍微,176,53,123,合庫-台中,2024-06-04,1021
6116,彩晶,138,16,122,合庫-台中,2024-06-04,1021
00642U,期元大S＆P石油,103,0,103,合庫-台中,2024-06-04,1021
00878,國泰永續高股息,97,4,93,合庫-台中,2024-06-04,1021
3520,華盈,102,10,92,合庫-台中,2024-06-04,1021
2353,宏��,115,25,90,合庫-台中,2024-06-04,1021
2329,華泰,98,36,62,合庫-台中,2024-06-04,1021
2337,旺宏,63,1,62,合庫-台中,2024-06-04,1021
9105,泰金寶-DR,115,59,56,合庫-台中,2024-06-04,1021
2324,仁寶,93,38,55,合庫-台中,2024-06-04,1021
2354,鴻準,117,63,54,合庫-台中,2024-06-04,1021
2331,精英,123,73,50,合庫-台中,2024-06-04,1021
3231,緯創,64,15,49,合庫-台中,2024-06-04,1021
2801,彰銀,48,1,47,合庫-台中,2024-06-04,1021
3481,群創,55,11,44,合庫-台中,2024-06-04,1021
2883,凱基金,51,10,41,合庫-台中,2024-06-04,1021
3011,今皓,40,0,40,合庫-台中,2024-06-04,1021
6117,迎廣,131,94,37,合庫-台中,2024-06-04,1021
2486,一詮,93,56,37,合庫-台中,2024-06-04,1021
1440,南紡,38,3,35,合庫-台中,2024-06-04,1021
1316,上曜,36,1,35,合庫-台中,2024-06-04,1021
2303,聯電,187,152,35,合庫-台中,2024-06-04,1021
2002,中鋼,53,19,34,合庫-台中,2024-06-04,1021
1815,富喬,100,67,33,合庫-台中,2024-06-04,1021
2301,光寶科,44,11,33,合庫-台中,2024-06-04,1021
2363,矽統,120,88,32,合庫-台中,2024-06-04,1021
0050,元大台灣50,31,1,30,合庫-台中,2024-06-04,1021
1220,台榮,30,0,30,合庫-台中,2024-06-04,1021
2609,陽明,213,183,30,合庫-台中,2024-06-04,1021
2641,正德,32,3,29,合庫-台中,2024-06-04,1021
2230,泰茂,29,0,29,合庫-台中,2024-06-04,1021
2834,臺企銀,30,1,29,合庫-台中,2024-06-04,1021
3338,泰碩,59,30,29,合庫-台中,2024-06-04,1021
4967,十銓,80,51,29,合庫-台中,2024-06-04,1021
9902,台火,29,0,29,合庫-台中,2024-06-04,1021
00665L,富邦�琤肭磪囓�2,2496,1033,1463,合庫-台中,2024-06-05,1021
00632R,元大台灣50反1,1246,204,1042,合庫-台中,2024-06-05,1021
4726,永昕,333,12,321,合庫-台中,2024-06-05,1021
00929,復華台灣科技優息,357,57,300,合庫-台中,2024-06-05,1021
00936,台新永續高息中小,225,49,176,合庫-台中,2024-06-05,1021
00679B,元大美債20年,268,96,172,合庫-台中,2024-06-05,1021
2303,聯電,177,39,138,合庫-台中,2024-06-05,1021
00878,國泰永續高股息,153,25,128,合庫-台中,2024-06-05,1021
2888,新光金,191,67,124,合庫-台中,2024-06-05,1021
2105,正新,100,9,91,合庫-台中,2024-06-05,1021
00637L,元大滬深300正2,393,303,90,合庫-台中,2024-06-05,1021
2618,長榮航,170,88,82,合庫-台中,2024-06-05,1021
5880,合庫金,100,21,79,合庫-台中,2024-06-05,1021
2331,精英,108,33,75,合庫-台中,2024-06-05,1021
00942B,台新美A公司債20+,72,0,72,合庫-台中,2024-06-05,1021
2356,英業達,87,16,71,合庫-台中,2024-06-05,1021
00918,大華優利高填息30,68,1,67,合庫-台中,2024-06-05,1021
2002,中鋼,66,0,66,合庫-台中,2024-06-05,1021
00688L,國泰20年美債正2,60,0,60,合庫-台中,2024-06-05,1021
3088,艾訊,120,64,56,合庫-台中,2024-06-05,1021
6116,彩晶,69,13,56,合庫-台中,2024-06-05,1021
2417,圓剛,115,65,50,合庫-台中,2024-06-05,1021
5351,鈺創,59,15,44,合庫-台中,2024-06-05,1021
6166,凌華,57,15,42,合庫-台中,2024-06-05,1021
3276,宇環,39,0,39,合庫-台中,2024-06-05,1021
1713,國化,41,2,39,合庫-台中,2024-06-05,1021
00941,中信上游半導體,46,8,38,合庫-台中,2024-06-05,1021
1220,台榮,33,0,33,合庫-台中,2024-06-05,1021
2344,華邦電,50,18,32,合庫-台中,2024-06-05,1021
2208,台船,32,0,32,合庫-台中,2024-06-05,1021
6197,佳必琪,38,7,31,合庫-台中,2024-06-05,1021
00713,元大台灣高息低波,32,1,31,合庫-台中,2024-06-05,1021
6443,元晶,30,0,30,合庫-台中,2024-06-05,1021
00751B,元大AAA至A公司債,100,70,30,合庫-台中,2024-06-05,1021
3594,磐儀,35,6,29,合庫-台中,2024-06-05,1021
3011,今皓,28,0,28,合庫-台中,2024-06-05,1021
6120,達運,30,2,28,合庫-台中,2024-06-05,1021
5474,聰泰,27,0,27,合庫-台中,2024-06-05,1021
4532,瑞智,36,9,27,合庫-台中,2024-06-05,1021
3048,益登,38,12,26,合庫-台中,2024-06-05,1021
00919,群益台灣精選高息,37,11,26,合庫-台中,2024-06-05,1021
2305,全友,25,0,25,合庫-台中,2024-06-05,1021
2324,仁寶,31,7,24,合庫-台中,2024-06-05,1021
0056,元大高股息,25,1,24,合庫-台中,2024-06-05,1021
4906,正文,27,4,23,合庫-台中,2024-06-05,1021
3481,群創,24,2,22,合庫-台中,2024-06-05,1021
2886,兆豐金,23,1,22,合庫-台中,2024-06-05,1021
3024,憶聲,22,0,22,合庫-台中,2024-06-05,1021
1521,大億,22,0,22,合庫-台中,2024-06-05,1021
2534,宏盛,21,0,21,合庫-台中,2024-06-05,1021
00632R,元大台灣50反1,877,55,822,合庫-台中,2024-06-06,1021
00936,台新永續高息中小,475,11,464,合庫-台中,2024-06-06,1021
00937B,群益ESG投等債20,699,434,265,合庫-台中,2024-06-06,1021
2354,鴻準,157,52,105,合庫-台中,2024-06-06,1021
9902,台火,101,0,101,合庫-台中,2024-06-06,1021
3276,宇環,96,0,96,合庫-台中,2024-06-06,1021
2801,彰銀,86,0,86,合庫-台中,2024-06-06,1021
5880,合庫金,69,4,65,合庫-台中,2024-06-06,1021
1815,富喬,151,90,61,合庫-台中,2024-06-06,1021
2547,日勝生,60,0,60,合庫-台中,2024-06-06,1021
4533,協易機,75,17,58,合庫-台中,2024-06-06,1021
2374,佳能,66,8,58,合庫-台中,2024-06-06,1021
00929,復華台灣科技優息,133,79,54,合庫-台中,2024-06-06,1021
2344,華邦電,60,6,54,合庫-台中,2024-06-06,1021
00946,群益科技高息成長,58,11,47,合庫-台中,2024-06-06,1021
00712,復華富時不動產,62,19,43,合庫-台中,2024-06-06,1021
5347,世界,68,27,41,合庫-台中,2024-06-06,1021
3380,明泰,49,10,39,合庫-台中,2024-06-06,1021
00715L,期街口布蘭特正2,63,26,37,合庫-台中,2024-06-06,1021
2323,中環,37,0,37,合庫-台中,2024-06-06,1021
00942B,台新美A公司債20+,37,1,36,合庫-台中,2024-06-06,1021
6188,廣明,96,63,33,合庫-台中,2024-06-06,1021
2353,宏��,72,39,33,合庫-台中,2024-06-06,1021
3229,晟鈦,35,3,32,合庫-台中,2024-06-06,1021
2101,南港,48,16,32,合庫-台中,2024-06-06,1021
00753L,中信中國50正2,31,0,31,合庫-台中,2024-06-06,1021
1305,華夏,36,5,31,合庫-台中,2024-06-06,1021
2303,聯電,53,25,28,合庫-台中,2024-06-06,1021
4726,永昕,38,11,27,合庫-台中,2024-06-06,1021
2609,陽明,366,339,27,合庫-台中,2024-06-06,1021
00687B,國泰20年美債,69,43,26,合庫-台中,2024-06-06,1021
2465,麗臺,33,7,26,合庫-台中,2024-06-06,1021
00764B,群益25年美債,25,0,25,合庫-台中,2024-06-06,1021
2888,新光金,58,34,24,合庫-台中,2024-06-06,1021
3202,樺晟,103,79,24,合庫-台中,2024-06-06,1021
2401,凌陽,25,1,24,合庫-台中,2024-06-06,1021
00713,元大台灣高息低波,25,1,24,合庫-台中,2024-06-06,1021
6125,廣運,153,130,23,合庫-台中,2024-06-06,1021
3594,磐儀,24,2,22,合庫-台中,2024-06-06,1021
3438,類比科,22,0,22,合庫-台中,2024-06-06,1021
5469,瀚宇博,22,0,22,合庫-台中,2024-06-06,1021
6770,力積電,34,12,22,合庫-台中,2024-06-06,1021
5009,榮剛,25,4,21,合庫-台中,2024-06-06,1021
5302,太欣,52,31,21,合庫-台中,2024-06-06,1021
6560,欣普羅,21,0,21,合庫-台中,2024-06-06,1021
2049,上銀,20,0,20,合庫-台中,2024-06-06,1021
2460,建通,20,0,20,合庫-台中,2024-06-06,1021
9945,潤泰新,37,17,20,合庫-台中,2024-06-06,1021
3481,群創,53,33,20,合庫-台中,2024-06-06,1021
6243,迅杰,20,0,20,合庫-台中,2024-06-06,1021
2317,鴻海,559,84,475,合庫-台中,2024-06-07,1021
3056,富華新,302,10,292,合庫-台中,2024-06-07,1021
00936,台新永續高息中小,353,86,267,合庫-台中,2024-06-07,1021
00929,復華台灣科技優息,200,12,188,合庫-台中,2024-06-07,1021
00637L,元大滬深300正2,472,301,171,合庫-台中,2024-06-07,1021
00918,大華優利高填息30,151,2,149,合庫-台中,2024-06-07,1021
9105,泰金寶-DR,259,110,149,合庫-台中,2024-06-07,1021
3231,緯創,124,7,117,合庫-台中,2024-06-07,1021
4908,前鼎,113,1,112,合庫-台中,2024-06-07,1021
4714,永捷,101,13,88,合庫-台中,2024-06-07,1021
00753L,中信中國50正2,76,0,76,合庫-台中,2024-06-07,1021
00680L,元大美債20正2,67,1,66,合庫-台中,2024-06-07,1021
2312,金寶,127,63,64,合庫-台中,2024-06-07,1021
00919,群益台灣精選高息,106,45,61,合庫-台中,2024-06-07,1021
2105,正新,61,1,60,合庫-台中,2024-06-07,1021
5880,合庫金,78,18,60,合庫-台中,2024-06-07,1021
2356,英業達,62,4,58,合庫-台中,2024-06-07,1021
00665L,富邦�琤肭磪囓�2,289,232,57,合庫-台中,2024-06-07,1021
9902,台火,56,0,56,合庫-台中,2024-06-07,1021
2489,瑞軒,76,24,52,合庫-台中,2024-06-07,1021
00902,中信電池及儲能,50,0,50,合庫-台中,2024-06-07,1021
8064,東捷,50,3,47,合庫-台中,2024-06-07,1021
2353,宏��,48,6,42,合庫-台中,2024-06-07,1021
00687B,國泰20年美債,90,50,40,合庫-台中,2024-06-07,1021
2615,萬海,170,136,34,合庫-台中,2024-06-07,1021
2392,正崴,34,1,33,合庫-台中,2024-06-07,1021
2313,華通,177,145,32,合庫-台中,2024-06-07,1021
2070,精湛,36,5,31,合庫-台中,2024-06-07,1021
00712,復華富時不動產,31,0,31,合庫-台中,2024-06-07,1021
00633L,富邦上証正2,31,0,31,合庫-台中,2024-06-07,1021
2331,精英,36,6,30,合庫-台中,2024-06-07,1021
2330,台積電,53,24,29,合庫-台中,2024-06-07,1021
6609,瀧澤科,27,0,27,合庫-台中,2024-06-07,1021
2371,大同,49,24,25,合庫-台中,2024-06-07,1021
4123,晟德,42,17,25,合庫-台中,2024-06-07,1021
2401,凌陽,29,5,24,合庫-台中,2024-06-07,1021
5469,瀚宇博,23,0,23,合庫-台中,2024-06-07,1021
2542,興富發,55,32,23,合庫-台中,2024-06-07,1021
3024,憶聲,28,6,22,合庫-台中,2024-06-07,1021
2376,技嘉,40,19,21,合庫-台中,2024-06-07,1021
00632R,元大台灣50反1,21,0,21,合庫-台中,2024-06-07,1021
2460,建通,21,0,21,合庫-台中,2024-06-07,1021
5234,達興材料,21,0,21,合庫-台中,2024-06-07,1021
00720B,元大投資級公司債,20,0,20,合庫-台中,2024-06-07,1021
9907,統一實,20,0,20,合庫-台中,2024-06-07,1021
3048,益登,27,7,20,合庫-台中,2024-06-07,1021
5243,乙盛-KY,21,2,19,合庫-台中,2024-06-07,1021
2101,南港,20,1,19,合庫-台中,2024-06-07,1021
2382,廣達,25,7,18,合庫-台中,2024-06-07,1021
2464,盟立,39,22,17,合庫-台中,2024-06-07,1021
2867,三商壽,1226,327,899,合庫-台中,2024-06-11,1021
3047,訊舟,645,142,503,合庫-台中,2024-06-11,1021
9919,康那香,402,18,384,合庫-台中,2024-06-11,1021
2883,凱基金,726,375,351,合庫-台中,2024-06-11,1021
00929,復華台灣科技優息,364,41,323,合庫-台中,2024-06-11,1021
00919,群益台灣精選高息,301,17,284,合庫-台中,2024-06-11,1021
2609,陽明,610,351,259,合庫-台中,2024-06-11,1021
00918,大華優利高填息30,261,12,249,合庫-台中,2024-06-11,1021
2801,彰銀,228,0,228,合庫-台中,2024-06-11,1021
2515,中工,206,16,190,合庫-台中,2024-06-11,1021
00936,台新永續高息中小,211,26,185,合庫-台中,2024-06-11,1021
00679B,元大美債20年,160,3,157,合庫-台中,2024-06-11,1021
00882,中信中國高股息,245,100,145,合庫-台中,2024-06-11,1021
00680L,元大美債20正2,239,105,134,合庫-台中,2024-06-11,1021
2618,長榮航,221,88,133,合庫-台中,2024-06-11,1021
1539,巨庭,133,0,133,合庫-台中,2024-06-11,1021
2002,中鋼,124,0,124,合庫-台中,2024-06-11,1021
1815,富喬,190,68,122,合庫-台中,2024-06-11,1021
3481,群創,130,12,118,合庫-台中,2024-06-11,1021
00687B,國泰20年美債,172,58,114,合庫-台中,2024-06-11,1021
00650L,復華香港正2,412,301,111,合庫-台中,2024-06-11,1021
00878,國泰永續高股息,167,65,102,合庫-台中,2024-06-11,1021
5302,太欣,91,3,88,合庫-台中,2024-06-11,1021
9902,台火,84,0,84,合庫-台中,2024-06-11,1021
00712,復華富時不動產,91,14,77,合庫-台中,2024-06-11,1021
1514,亞力,167,96,71,合庫-台中,2024-06-11,1021
00751B,元大AAA至A公司債,74,6,68,合庫-台中,2024-06-11,1021
1316,上曜,102,36,66,合庫-台中,2024-06-11,1021
00933B,國泰10Y+金融債,82,23,59,合庫-台中,2024-06-11,1021
00753L,中信中國50正2,50,0,50,合庫-台中,2024-06-11,1021
1609,大亞,72,23,49,合庫-台中,2024-06-11,1021
1608,華榮,115,68,47,合庫-台中,2024-06-11,1021
00946,群益科技高息成長,56,12,44,合庫-台中,2024-06-11,1021
2634,漢翔,41,0,41,合庫-台中,2024-06-11,1021
2603,長榮,200,159,41,合庫-台中,2024-06-11,1021
2641,正德,50,13,37,合庫-台中,2024-06-11,1021
4726,永昕,62,26,36,合庫-台中,2024-06-11,1021
3231,緯創,64,28,36,合庫-台中,2024-06-11,1021
2501,國建,49,14,35,合庫-台中,2024-06-11,1021
6116,彩晶,35,0,35,合庫-台中,2024-06-11,1021
5608,四維航,63,29,34,合庫-台中,2024-06-11,1021
0056,元大高股息,32,2,30,合庫-台中,2024-06-11,1021
2401,凌陽,33,3,30,合庫-台中,2024-06-11,1021
3202,樺晟,47,18,29,合庫-台中,2024-06-11,1021
00795B,中信美國公債20年,30,2,28,合庫-台中,2024-06-11,1021
2301,光寶科,26,0,26,合庫-台中,2024-06-11,1021
00713,元大台灣高息低波,27,1,26,合庫-台中,2024-06-11,1021
8110,華東,26,0,26,合庫-台中,2024-06-11,1021
5864,致和證,37,11,26,合庫-台中,2024-06-11,1021
3229,晟鈦,25,0,25,合庫-台中,2024-06-11,1021
2883,凱基金,550,183,367,合庫-台中,2024-06-12,1021
3481,群創,394,42,352,合庫-台中,2024-06-12,1021
00712,復華富時不動產,334,1,333,合庫-台中,2024-06-12,1021
00918,大華優利高填息30,228,0,228,合庫-台中,2024-06-12,1021
1714,和桐,160,0,160,合庫-台中,2024-06-12,1021
3085,新零售,132,0,132,合庫-台中,2024-06-12,1021
5905,南仁湖,100,0,100,合庫-台中,2024-06-12,1021
1440,南紡,98,0,98,合庫-台中,2024-06-12,1021
2409,友達,108,14,94,合庫-台中,2024-06-12,1021
00687B,國泰20年美債,113,19,94,合庫-台中,2024-06-12,1021
1303,南亞,87,1,86,合庫-台中,2024-06-12,1021
2888,新光金,227,146,81,合庫-台中,2024-06-12,1021
2328,廣宇,74,2,72,合庫-台中,2024-06-12,1021
2618,長榮航,131,60,71,合庫-台中,2024-06-12,1021
00688L,國泰20年美債正2,70,0,70,合庫-台中,2024-06-12,1021
3056,富華新,56,0,56,合庫-台中,2024-06-12,1021
2610,華航,134,80,54,合庫-台中,2024-06-12,1021
6589,台康生技,116,62,54,合庫-台中,2024-06-12,1021
4160,訊聯基因,53,0,53,合庫-台中,2024-06-12,1021
00706L,期元大S＆P日圓正2,53,0,53,合庫-台中,2024-06-12,1021
3231,緯創,121,69,52,合庫-台中,2024-06-12,1021
00632R,元大台灣50反1,52,0,52,合庫-台中,2024-06-12,1021
2353,宏��,66,18,48,合庫-台中,2024-06-12,1021
00948B,中信優息投資級債,49,4,45,合庫-台中,2024-06-12,1021
2615,萬海,134,89,45,合庫-台中,2024-06-12,1021
9902,台火,38,0,38,合庫-台中,2024-06-12,1021
00919,群益台灣精選高息,51,14,37,合庫-台中,2024-06-12,1021
1455,集盛,36,0,36,合庫-台中,2024-06-12,1021
2515,中工,41,6,35,合庫-台中,2024-06-12,1021
6120,達運,55,20,35,合庫-台中,2024-06-12,1021
1539,巨庭,33,0,33,合庫-台中,2024-06-12,1021
5484,慧友,34,2,32,合庫-台中,2024-06-12,1021
2606,裕民,35,4,31,合庫-台中,2024-06-12,1021
1522,堤維西,51,22,29,合庫-台中,2024-06-12,1021
2609,陽明,282,253,29,合庫-台中,2024-06-12,1021
5880,合庫金,37,8,29,合庫-台中,2024-06-12,1021
9103,美德醫療-DR,28,0,28,合庫-台中,2024-06-12,1021
3047,訊舟,68,40,28,合庫-台中,2024-06-12,1021
00931B,統一美債20年,31,4,27,合庫-台中,2024-06-12,1021
4907,富宇,26,0,26,合庫-台中,2024-06-12,1021
2303,聯電,115,89,26,合庫-台中,2024-06-12,1021
6209,今國光,26,0,26,合庫-台中,2024-06-12,1021
9945,潤泰新,34,8,26,合庫-台中,2024-06-12,1021
1732,毛寶,25,1,24,合庫-台中,2024-06-12,1021
2002,中鋼,29,5,24,合庫-台中,2024-06-12,1021
6472,保瑞,26,3,23,合庫-台中,2024-06-12,1021
00901,永豐智能車供應鏈,23,1,22,合庫-台中,2024-06-12,1021
2801,彰銀,22,0,22,合庫-台中,2024-06-12,1021
2611,志信,38,16,22,合庫-台中,2024-06-12,1021
2617,台航,36,15,21,合庫-台中,2024-06-12,1021
2317,鴻海,799,240,559,合庫-台中,2024-06-13,1021
9902,台火,146,0,146,合庫-台中,2024-06-13,1021
9945,潤泰新,170,44,126,合庫-台中,2024-06-13,1021
1815,富喬,163,53,110,合庫-台中,2024-06-13,1021
5905,南仁湖,125,25,100,合庫-台中,2024-06-13,1021
2365,昆盈,130,33,97,合庫-台中,2024-06-13,1021
2367,燿華,131,42,89,合庫-台中,2024-06-13,1021
1714,和桐,86,0,86,合庫-台中,2024-06-13,1021
00901,永豐智能車供應鏈,77,0,77,合庫-台中,2024-06-13,1021
2002,中鋼,86,20,66,合庫-台中,2024-06-13,1021
2392,正崴,79,17,62,合庫-台中,2024-06-13,1021
2603,長榮,107,48,59,合庫-台中,2024-06-13,1021
00882,中信中國高股息,63,8,55,合庫-台中,2024-06-13,1021
6116,彩晶,54,0,54,合庫-台中,2024-06-13,1021
2614,東森,53,0,53,合庫-台中,2024-06-13,1021
00687B,國泰20年美債,71,21,50,合庫-台中,2024-06-13,1021
2371,大同,65,18,47,合庫-台中,2024-06-13,1021
2618,長榮航,195,150,45,合庫-台中,2024-06-13,1021
5484,慧友,41,0,41,合庫-台中,2024-06-13,1021
8110,華東,68,30,38,合庫-台中,2024-06-13,1021
2888,新光金,92,55,37,合庫-台中,2024-06-13,1021
2609,陽明,345,309,36,合庫-台中,2024-06-13,1021
2605,新興,48,14,34,合庫-台中,2024-06-13,1021
2464,盟立,87,54,33,合庫-台中,2024-06-13,1021
2501,國建,44,13,31,合庫-台中,2024-06-13,1021
4979,華星光,33,2,31,合庫-台中,2024-06-13,1021
3048,益登,46,17,29,合庫-台中,2024-06-13,1021
5608,四維航,62,34,28,合庫-台中,2024-06-13,1021
2354,鴻準,80,52,28,合庫-台中,2024-06-13,1021
1609,大亞,70,43,27,合庫-台中,2024-06-13,1021
9136,巨騰-DR,27,0,27,合庫-台中,2024-06-13,1021
1617,榮星,81,54,27,合庫-台中,2024-06-13,1021
2884,玉山金,34,8,26,合庫-台中,2024-06-13,1021
4967,十銓,140,117,23,合庫-台中,2024-06-13,1021
2542,興富發,29,6,23,合庫-台中,2024-06-13,1021
5531,鄉林,23,0,23,合庫-台中,2024-06-13,1021
1220,台榮,23,0,23,合庫-台中,2024-06-13,1021
4906,正文,26,3,23,合庫-台中,2024-06-13,1021
1539,巨庭,23,0,23,合庫-台中,2024-06-13,1021
3481,群創,90,67,23,合庫-台中,2024-06-13,1021
4533,協易機,32,11,21,合庫-台中,2024-06-13,1021
1440,南紡,21,0,21,合庫-台中,2024-06-13,1021
00679B,元大美債20年,36,15,21,合庫-台中,2024-06-13,1021
1314,中石化,29,8,21,合庫-台中,2024-06-13,1021
2105,正新,22,2,20,合庫-台中,2024-06-13,1021
8039,台虹,34,14,20,合庫-台中,2024-06-13,1021
4160,訊聯基因,20,0,20,合庫-台中,2024-06-13,1021
2442,新美齊,20,0,20,合庫-台中,2024-06-13,1021
2230,泰茂,26,7,19,合庫-台中,2024-06-13,1021
3019,亞光,33,14,19,合庫-台中,2024-06-13,1021
00665L,富邦�琤肭磪囓�2,1448,329,1119,合庫-台中,2024-06-14,1021
2356,英業達,266,21,245,合庫-台中,2024-06-14,1021
00673R,期元大S＆P原油反1,200,0,200,合庫-台中,2024-06-14,1021
1504,東元,160,22,138,合庫-台中,2024-06-14,1021
2371,大同,230,123,107,合庫-台中,2024-06-14,1021
1513,中興電,174,67,107,合庫-台中,2024-06-14,1021
1815,富喬,118,13,105,合庫-台中,2024-06-14,1021
00680L,元大美債20正2,103,6,97,合庫-台中,2024-06-14,1021
3708,上緯投控,85,2,83,合庫-台中,2024-06-14,1021
1608,華榮,130,69,61,合庫-台中,2024-06-14,1021
2887,台新金,60,0,60,合庫-台中,2024-06-14,1021
00687B,國泰20年美債,95,42,53,合庫-台中,2024-06-14,1021
2317,鴻海,177,125,52,合庫-台中,2024-06-14,1021
00902,中信電池及儲能,50,0,50,合庫-台中,2024-06-14,1021
2330,台積電,45,0,45,合庫-台中,2024-06-14,1021
1785,光洋科,49,6,43,合庫-台中,2024-06-14,1021
2455,全新,79,37,42,合庫-台中,2024-06-14,1021
00706L,期元大S＆P日圓正2,40,0,40,合庫-台中,2024-06-14,1021
2374,佳能,45,5,40,合庫-台中,2024-06-14,1021
00919,群益台灣精選高息,101,62,39,合庫-台中,2024-06-14,1021
1584,精剛,41,3,38,合庫-台中,2024-06-14,1021
00942B,台新美A公司債20+,35,0,35,合庫-台中,2024-06-14,1021
6161,捷波,55,21,34,合庫-台中,2024-06-14,1021
2392,正崴,92,58,34,合庫-台中,2024-06-14,1021
8936,國統,39,5,34,合庫-台中,2024-06-14,1021
2882,國泰金,36,3,33,合庫-台中,2024-06-14,1021
1609,大亞,137,105,32,合庫-台中,2024-06-14,1021
3058,立德,31,0,31,合庫-台中,2024-06-14,1021
00710B,復華彭博非投等債,30,0,30,合庫-台中,2024-06-14,1021
3437,榮創,45,16,29,合庫-台中,2024-06-14,1021
00918,大華優利高填息30,97,69,28,合庫-台中,2024-06-14,1021
00713,元大台灣高息低波,28,0,28,合庫-台中,2024-06-14,1021
00947,台新臺灣IC設計,25,0,25,合庫-台中,2024-06-14,1021
2401,凌陽,25,0,25,合庫-台中,2024-06-14,1021
2537,聯上發,45,21,24,合庫-台中,2024-06-14,1021
00915,凱基優選高股息30,31,7,24,合庫-台中,2024-06-14,1021
2363,矽統,95,71,24,合庫-台中,2024-06-14,1021
2027,大成鋼,23,0,23,合庫-台中,2024-06-14,1021
2324,仁寶,23,2,21,合庫-台中,2024-06-14,1021
3374,精材,51,30,21,合庫-台中,2024-06-14,1021
2002,中鋼,29,9,20,合庫-台中,2024-06-14,1021
1316,上曜,32,12,20,合庫-台中,2024-06-14,1021
1540,喬福,20,0,20,合庫-台中,2024-06-14,1021
4160,訊聯基因,20,0,20,合庫-台中,2024-06-14,1021
3062,建漢,37,19,18,合庫-台中,2024-06-14,1021
2014,中鴻,18,0,18,合庫-台中,2024-06-14,1021
6197,佳必琪,26,8,18,合庫-台中,2024-06-14,1021
2376,技嘉,27,11,16,合庫-台中,2024-06-14,1021
2388,威盛,28,12,16,合庫-台中,2024-06-14,1021
2486,一詮,48,32,16,合庫-台中,2024-06-14,1021
00948B,中信優息投資級債,194,2,192,合庫-台中,2024-06-17,1021
00929,復華台灣科技優息,400,219,181,合庫-台中,2024-06-17,1021
00885,富邦越南,153,0,153,合庫-台中,2024-06-17,1021
1608,華榮,154,33,121,合庫-台中,2024-06-17,1021
2609,陽明,305,186,119,合庫-台中,2024-06-17,1021
2515,中工,116,0,116,合庫-台中,2024-06-17,1021
00937B,群益ESG投等債20,138,24,114,合庫-台中,2024-06-17,1021
00942B,台新美A公司債20+,110,0,110,合庫-台中,2024-06-17,1021
1713,國化,100,0,100,合庫-台中,2024-06-17,1021
00751B,元大AAA至A公司債,100,10,90,合庫-台中,2024-06-17,1021
9105,泰金寶-DR,93,12,81,合庫-台中,2024-06-17,1021
1616,億泰,68,7,61,合庫-台中,2024-06-17,1021
2618,長榮航,167,107,60,合庫-台中,2024-06-17,1021
00687B,國泰20年美債,86,28,58,合庫-台中,2024-06-17,1021
00712,復華富時不動產,64,7,57,合庫-台中,2024-06-17,1021
00921,兆豐龍頭等權重,55,0,55,合庫-台中,2024-06-17,1021
6781,AES-KY,52,0,52,合庫-台中,2024-06-17,1021
2801,彰銀,53,5,48,合庫-台中,2024-06-17,1021
2615,萬海,189,143,46,合庫-台中,2024-06-17,1021
3466,德晉,52,7,45,合庫-台中,2024-06-17,1021
00713,元大台灣高息低波,43,1,42,合庫-台中,2024-06-17,1021
00918,大華優利高填息30,173,131,42,合庫-台中,2024-06-17,1021
2314,台揚,59,17,42,合庫-台中,2024-06-17,1021
6419,京晨科,181,139,42,合庫-台中,2024-06-17,1021
2371,大同,319,278,41,合庫-台中,2024-06-17,1021
00710B,復華彭博非投等債,40,0,40,合庫-台中,2024-06-17,1021
1513,中興電,81,44,37,合庫-台中,2024-06-17,1021
1503,士電,91,54,37,合庫-台中,2024-06-17,1021
3576,聯合再生,36,0,36,合庫-台中,2024-06-17,1021
00936,台新永續高息中小,200,166,34,合庫-台中,2024-06-17,1021
2312,金寶,76,43,33,合庫-台中,2024-06-17,1021
3056,富華新,35,2,33,合庫-台中,2024-06-17,1021
1609,大亞,135,103,32,合庫-台中,2024-06-17,1021
4303,信立,32,0,32,合庫-台中,2024-06-17,1021
00902,中信電池及儲能,31,0,31,合庫-台中,2024-06-17,1021
1473,台南,31,1,30,合庫-台中,2024-06-17,1021
2031,新光鋼,48,18,30,合庫-台中,2024-06-17,1021
1227,佳格,31,2,29,合庫-台中,2024-06-17,1021
00946,群益科技高息成長,28,0,28,合庫-台中,2024-06-17,1021
1440,南紡,27,0,27,合庫-台中,2024-06-17,1021
6117,迎廣,25,0,25,合庫-台中,2024-06-17,1021
3312,弘憶股,27,2,25,合庫-台中,2024-06-17,1021
2401,凌陽,40,17,23,合庫-台中,2024-06-17,1021
00934,中信成長高股息,21,0,21,合庫-台中,2024-06-17,1021
1618,合機,102,81,21,合庫-台中,2024-06-17,1021
3622,洋華,58,37,21,合庫-台中,2024-06-17,1021
2489,瑞軒,22,1,21,合庫-台中,2024-06-17,1021
4979,華星光,22,1,21,合庫-台中,2024-06-17,1021
8277,商丞,24,3,21,合庫-台中,2024-06-17,1021
2613,中櫃,25,4,21,合庫-台中,2024-06-17,1021
00632R,元大台灣50反1,895,0,895,合庫-台中,2024-06-18,1021
6770,力積電,231,25,206,合庫-台中,2024-06-18,1021
00929,復華台灣科技優息,325,138,187,合庫-台中,2024-06-18,1021
00936,台新永續高息中小,327,156,171,合庫-台中,2024-06-18,1021
00665L,富邦�琤肭磪囓�2,344,207,137,合庫-台中,2024-06-18,1021
00687B,國泰20年美債,153,20,133,合庫-台中,2024-06-18,1021
9105,泰金寶-DR,253,145,108,合庫-台中,2024-06-18,1021
00751B,元大AAA至A公司債,104,0,104,合庫-台中,2024-06-18,1021
2353,宏��,127,24,103,合庫-台中,2024-06-18,1021
6282,康舒,125,26,99,合庫-台中,2024-06-18,1021
00919,群益台灣精選高息,138,40,98,合庫-台中,2024-06-18,1021
3041,揚智,100,13,87,合庫-台中,2024-06-18,1021
2363,矽統,90,19,71,合庫-台中,2024-06-18,1021
2801,彰銀,69,1,68,合庫-台中,2024-06-18,1021
00673R,期元大S＆P原油反1,66,0,66,合庫-台中,2024-06-18,1021
00947,台新臺灣IC設計,70,17,53,合庫-台中,2024-06-18,1021
912000,晨訊科-DR,66,15,51,合庫-台中,2024-06-18,1021
2401,凌陽,51,0,51,合庫-台中,2024-06-18,1021
6120,達運,60,10,50,合庫-台中,2024-06-18,1021
8064,東捷,69,20,49,合庫-台中,2024-06-18,1021
9136,巨騰-DR,64,17,47,合庫-台中,2024-06-18,1021
5388,中磊,44,0,44,合庫-台中,2024-06-18,1021
2409,友達,90,47,43,合庫-台中,2024-06-18,1021
3706,神達,75,32,43,合庫-台中,2024-06-18,1021
00942B,台新美A公司債20+,40,0,40,合庫-台中,2024-06-18,1021
1504,東元,46,6,40,合庫-台中,2024-06-18,1021
00937B,群益ESG投等債20,118,79,39,合庫-台中,2024-06-18,1021
1802,台玻,64,26,38,合庫-台中,2024-06-18,1021
00940,元大台灣價值高息,180,142,38,合庫-台中,2024-06-18,1021
00946,群益科技高息成長,33,0,33,合庫-台中,2024-06-18,1021
5351,鈺創,51,18,33,合庫-台中,2024-06-18,1021
00915,凱基優選高股息30,46,14,32,合庫-台中,2024-06-18,1021
4534,慶騰,30,0,30,合庫-台中,2024-06-18,1021
00896,中信綠能及電動車,31,1,30,合庫-台中,2024-06-18,1021
2887,台新金,33,4,29,合庫-台中,2024-06-18,1021
2312,金寶,28,0,28,合庫-台中,2024-06-18,1021
1314,中石化,52,24,28,合庫-台中,2024-06-18,1021
2388,威盛,42,15,27,合庫-台中,2024-06-18,1021
00881,國泰台灣5G+,29,2,27,合庫-台中,2024-06-18,1021
8096,擎亞,118,91,27,合庫-台中,2024-06-18,1021
2537,聯上發,49,24,25,合庫-台中,2024-06-18,1021
6187,萬潤,38,13,25,合庫-台中,2024-06-18,1021
6117,迎廣,27,3,24,合庫-台中,2024-06-18,1021
3338,泰碩,23,0,23,合庫-台中,2024-06-18,1021
8255,朋程,25,2,23,合庫-台中,2024-06-18,1021
3006,晶豪科,32,10,22,合庫-台中,2024-06-18,1021
00680L,元大美債20正2,21,0,21,合庫-台中,2024-06-18,1021
1563,巧新,21,1,20,合庫-台中,2024-06-18,1021
2611,志信,20,0,20,合庫-台中,2024-06-18,1021
6617,共信-KY,28,8,20,合庫-台中,2024-06-18,1021
00632R,元大台灣50反1,1002,360,642,合庫-台中,2024-06-19,1021
00937B,群益ESG投等債20,599,60,539,合庫-台中,2024-06-19,1021
2317,鴻海,892,611,281,合庫-台中,2024-06-19,1021
00673R,期元大S＆P原油反1,249,0,249,合庫-台中,2024-06-19,1021
00712,復華富時不動產,340,149,191,合庫-台中,2024-06-19,1021
00936,台新永續高息中小,293,137,156,合庫-台中,2024-06-19,1021
2367,燿華,176,28,148,合庫-台中,2024-06-19,1021
9136,巨騰-DR,138,20,118,合庫-台中,2024-06-19,1021
6152,百一,113,0,113,合庫-台中,2024-06-19,1021
6834,天二科技,106,0,106,合庫-台中,2024-06-19,1021
2801,彰銀,103,0,103,合庫-台中,2024-06-19,1021
00946,群益科技高息成長,112,10,102,合庫-台中,2024-06-19,1021
00933B,國泰10Y+金融債,106,12,94,合庫-台中,2024-06-19,1021
4907,富宇,67,0,67,合庫-台中,2024-06-19,1021
00687B,國泰20年美債,133,67,66,合庫-台中,2024-06-19,1021
00713,元大台灣高息低波,67,1,66,合庫-台中,2024-06-19,1021
6270,倍微,65,2,63,合庫-台中,2024-06-19,1021
4979,華星光,69,7,62,合庫-台中,2024-06-19,1021
2371,大同,120,62,58,合庫-台中,2024-06-19,1021
3622,洋華,74,20,54,合庫-台中,2024-06-19,1021
3013,晟銘電,68,14,54,合庫-台中,2024-06-19,1021
2408,南亞科,63,10,53,合庫-台中,2024-06-19,1021
3481,群創,190,138,52,合庫-台中,2024-06-19,1021
2365,昆盈,169,120,49,合庫-台中,2024-06-19,1021
3666,光耀,47,0,47,合庫-台中,2024-06-19,1021
4562,穎漢,68,23,45,合庫-台中,2024-06-19,1021
1591,駿吉-KY,54,11,43,合庫-台中,2024-06-19,1021
2392,正崴,60,17,43,合庫-台中,2024-06-19,1021
6470,宇智,41,0,41,合庫-台中,2024-06-19,1021
2486,一詮,67,27,40,合庫-台中,2024-06-19,1021
00947,台新臺灣IC設計,40,0,40,合庫-台中,2024-06-19,1021
1815,富喬,94,58,36,合庫-台中,2024-06-19,1021
2388,威盛,45,9,36,合庫-台中,2024-06-19,1021
00881,國泰台灣5G+,42,8,34,合庫-台中,2024-06-19,1021
6190,萬泰科,41,7,34,合庫-台中,2024-06-19,1021
2634,漢翔,83,52,31,合庫-台中,2024-06-19,1021
3062,建漢,94,63,31,合庫-台中,2024-06-19,1021
00935,野村臺灣新科技50,29,0,29,合庫-台中,2024-06-19,1021
2460,建通,27,0,27,合庫-台中,2024-06-19,1021
2027,大成鋼,27,0,27,合庫-台中,2024-06-19,1021
2359,所羅門,48,22,26,合庫-台中,2024-06-19,1021
1325,恆大,26,1,25,合庫-台中,2024-06-19,1021
3041,揚智,41,16,25,合庫-台中,2024-06-19,1021
8150,南茂,25,0,25,合庫-台中,2024-06-19,1021
3011,今皓,25,0,25,合庫-台中,2024-06-19,1021
2409,友達,56,32,24,合庫-台中,2024-06-19,1021
6112,邁達特,41,17,24,合庫-台中,2024-06-19,1021
6126,信音,24,0,24,合庫-台中,2024-06-19,1021
3202,樺晟,28,5,23,合庫-台中,2024-06-19,1021
5392,能率,22,0,22,合庫-台中,2024-06-19,1021
00687B,國泰20年美債,397,7,390,合庫-台中,2024-06-20,1021
00712,復華富時不動產,450,62,388,合庫-台中,2024-06-20,1021
00936,台新永續高息中小,389,31,358,合庫-台中,2024-06-20,1021
00632R,元大台灣50反1,744,410,334,合庫-台中,2024-06-20,1021
2371,大同,183,30,153,合庫-台中,2024-06-20,1021
00940,元大台灣價值高息,224,91,133,合庫-台中,2024-06-20,1021
00946,群益科技高息成長,122,11,111,合庫-台中,2024-06-20,1021
6419,京晨科,201,98,103,合庫-台中,2024-06-20,1021
2353,宏��,134,37,97,合庫-台中,2024-06-20,1021
00751B,元大AAA至A公司債,96,0,96,合庫-台中,2024-06-20,1021
2888,新光金,111,15,96,合庫-台中,2024-06-20,1021
00937B,群益ESG投等債20,153,60,93,合庫-台中,2024-06-20,1021
8033,雷虎,78,1,77,合庫-台中,2024-06-20,1021
2867,三商壽,92,18,74,合庫-台中,2024-06-20,1021
2330,台積電,84,17,67,合庫-台中,2024-06-20,1021
00919,群益台灣精選高息,320,255,65,合庫-台中,2024-06-20,1021
3234,光環,64,4,60,合庫-台中,2024-06-20,1021
2323,中環,64,4,60,合庫-台中,2024-06-20,1021
2409,友達,75,18,57,合庫-台中,2024-06-20,1021
00655L,國泰中國A50正2,52,0,52,合庫-台中,2024-06-20,1021
2605,新興,50,0,50,合庫-台中,2024-06-20,1021
00947,台新臺灣IC設計,46,0,46,合庫-台中,2024-06-20,1021
9136,巨騰-DR,44,0,44,合庫-台中,2024-06-20,1021
2352,佳世達,91,51,40,合庫-台中,2024-06-20,1021
8096,擎亞,56,16,40,合庫-台中,2024-06-20,1021
4113,聯上,39,2,37,合庫-台中,2024-06-20,1021
2834,臺企銀,53,16,37,合庫-台中,2024-06-20,1021
6834,天二科技,35,1,34,合庫-台中,2024-06-20,1021
2365,昆盈,123,90,33,合庫-台中,2024-06-20,1021
3379,彬台,41,10,31,合庫-台中,2024-06-20,1021
00719B,元大美債1-3,30,0,30,合庫-台中,2024-06-20,1021
00934,中信成長高股息,30,0,30,合庫-台中,2024-06-20,1021
8277,商丞,34,4,30,合庫-台中,2024-06-20,1021
2801,彰銀,29,0,29,合庫-台中,2024-06-20,1021
00650L,復華香港正2,180,151,29,合庫-台中,2024-06-20,1021
00933B,國泰10Y+金融債,39,10,29,合庫-台中,2024-06-20,1021
1314,中石化,27,0,27,合庫-台中,2024-06-20,1021
3231,緯創,59,32,27,合庫-台中,2024-06-20,1021
00902,中信電池及儲能,26,0,26,合庫-台中,2024-06-20,1021
00679B,元大美債20年,49,23,26,合庫-台中,2024-06-20,1021
2610,華航,33,8,25,合庫-台中,2024-06-20,1021
2426,鼎元,23,0,23,合庫-台中,2024-06-20,1021
3013,晟銘電,45,23,22,合庫-台中,2024-06-20,1021
1609,大亞,108,86,22,合庫-台中,2024-06-20,1021
00680L,元大美債20正2,22,0,22,合庫-台中,2024-06-20,1021
6125,廣運,93,71,22,合庫-台中,2024-06-20,1021
6112,邁達特,21,0,21,合庫-台中,2024-06-20,1021
2812,台中銀,20,0,20,合庫-台中,2024-06-20,1021
2208,台船,20,0,20,合庫-台中,2024-06-20,1021
1524,耿鼎,20,0,20,合庫-台中,2024-06-20,1021
2317,鴻海,592,105,487,合庫-台中,2024-06-21,1021
6116,彩晶,519,199,320,合庫-台中,2024-06-21,1021
9949,琉園,292,0,292,合庫-台中,2024-06-21,1021
00919,群益台灣精選高息,370,121,249,合庫-台中,2024-06-21,1021
00936,台新永續高息中小,194,14,180,合庫-台中,2024-06-21,1021
00937B,群益ESG投等債20,424,269,155,合庫-台中,2024-06-21,1021
2801,彰銀,127,6,121,合庫-台中,2024-06-21,1021
00751B,元大AAA至A公司債,116,0,116,合庫-台中,2024-06-21,1021
00753L,中信中國50正2,109,0,109,合庫-台中,2024-06-21,1021
00929,復華台灣科技優息,312,204,108,合庫-台中,2024-06-21,1021
00901,永豐智能車供應鏈,100,0,100,合庫-台中,2024-06-21,1021
5880,合庫金,99,13,86,合庫-台中,2024-06-21,1021
00687B,國泰20年美債,101,19,82,合庫-台中,2024-06-21,1021
2354,鴻準,94,16,78,合庫-台中,2024-06-21,1021
1514,亞力,106,29,77,合庫-台中,2024-06-21,1021
8210,勤誠,76,0,76,合庫-台中,2024-06-21,1021
2515,中工,77,9,68,合庫-台中,2024-06-21,1021
2313,華通,120,59,61,合庫-台中,2024-06-21,1021
00673R,期元大S＆P原油反1,59,0,59,合庫-台中,2024-06-21,1021
00881,國泰台灣5G+,98,39,59,合庫-台中,2024-06-21,1021
2388,威盛,60,8,52,合庫-台中,2024-06-21,1021
00885,富邦越南,52,0,52,合庫-台中,2024-06-21,1021
2615,萬海,161,109,52,合庫-台中,2024-06-21,1021
00939,統一台灣高息動能,52,4,48,合庫-台中,2024-06-21,1021
00902,中信電池及儲能,49,1,48,合庫-台中,2024-06-21,1021
1785,光洋科,128,81,47,合庫-台中,2024-06-21,1021
2303,聯電,123,78,45,合庫-台中,2024-06-21,1021
2002,中鋼,93,49,44,合庫-台中,2024-06-21,1021
2329,華泰,114,72,42,合庫-台中,2024-06-21,1021
1587,吉茂,46,5,41,合庫-台中,2024-06-21,1021
2543,皇昌,41,2,39,合庫-台中,2024-06-21,1021
2371,大同,52,13,39,合庫-台中,2024-06-21,1021
2498,宏達電,58,22,36,合庫-台中,2024-06-21,1021
2337,旺宏,39,4,35,合庫-台中,2024-06-21,1021
4526,東台,75,42,33,合庫-台中,2024-06-21,1021
00948B,中信優息投資級債,31,0,31,合庫-台中,2024-06-21,1021
1303,南亞,32,1,31,合庫-台中,2024-06-21,1021
2353,宏��,44,14,30,合庫-台中,2024-06-21,1021
1309,台達化,30,0,30,合庫-台中,2024-06-21,1021
3540,曜越,30,0,30,合庫-台中,2024-06-21,1021
00946,群益科技高息成長,29,0,29,合庫-台中,2024-06-21,1021
6419,京晨科,29,0,29,合庫-台中,2024-06-21,1021
00679B,元大美債20年,62,34,28,合庫-台中,2024-06-21,1021
4123,晟德,27,1,26,合庫-台中,2024-06-21,1021
5905,南仁湖,31,5,26,合庫-台中,2024-06-21,1021
3615,安可,25,0,25,合庫-台中,2024-06-21,1021
3033,威健,25,0,25,合庫-台中,2024-06-21,1021
4726,永昕,30,5,25,合庫-台中,2024-06-21,1021
2609,陽明,166,142,24,合庫-台中,2024-06-21,1021
3006,晶豪科,28,5,23,合庫-台中,2024-06-21,1021
00929,復華台灣科技優息,649,69,580,合庫-台中,2024-06-24,1021
00919,群益台灣精選高息,638,94,544,合庫-台中,2024-06-24,1021
3481,群創,1225,793,432,合庫-台中,2024-06-24,1021
00937B,群益ESG投等債20,496,211,285,合庫-台中,2024-06-24,1021
2409,友達,378,148,230,合庫-台中,2024-06-24,1021
00946,群益科技高息成長,163,22,141,合庫-台中,2024-06-24,1021
00665L,富邦�琤肭磪囓�2,277,152,125,合庫-台中,2024-06-24,1021
3013,晟銘電,110,9,101,合庫-台中,2024-06-24,1021
9105,泰金寶-DR,122,25,97,合庫-台中,2024-06-24,1021
1785,光洋科,162,70,92,合庫-台中,2024-06-24,1021
00933B,國泰10Y+金融債,190,101,89,合庫-台中,2024-06-24,1021
3047,訊舟,156,69,87,合庫-台中,2024-06-24,1021
00947,台新臺灣IC設計,96,9,87,合庫-台中,2024-06-24,1021
00948B,中信優息投資級債,83,0,83,合庫-台中,2024-06-24,1021
00936,台新永續高息中小,206,126,80,合庫-台中,2024-06-24,1021
00881,國泰台灣5G+,117,46,71,合庫-台中,2024-06-24,1021
2365,昆盈,131,62,69,合庫-台中,2024-06-24,1021
00918,大華優利高填息30,166,99,67,合庫-台中,2024-06-24,1021
1611,中電,61,1,60,合庫-台中,2024-06-24,1021
3202,樺晟,64,8,56,合庫-台中,2024-06-24,1021
4979,華星光,101,50,51,合庫-台中,2024-06-24,1021
3231,緯創,87,38,49,合庫-台中,2024-06-24,1021
00885,富邦越南,48,0,48,合庫-台中,2024-06-24,1021
6120,達運,48,2,46,合庫-台中,2024-06-24,1021
2609,陽明,127,82,45,合庫-台中,2024-06-24,1021
2330,台積電,88,45,43,合庫-台中,2024-06-24,1021
00878,國泰永續高股息,46,3,43,合庫-台中,2024-06-24,1021
2329,華泰,60,18,42,合庫-台中,2024-06-24,1021
2354,鴻準,51,9,42,合庫-台中,2024-06-24,1021
2501,國建,65,24,41,合庫-台中,2024-06-24,1021
8064,東捷,99,58,41,合庫-台中,2024-06-24,1021
2352,佳世達,42,2,40,合庫-台中,2024-06-24,1021
2347,聯強,51,13,38,合庫-台中,2024-06-24,1021
2634,漢翔,48,11,37,合庫-台中,2024-06-24,1021
2367,燿華,75,39,36,合庫-台中,2024-06-24,1021
1409,新纖,35,0,35,合庫-台中,2024-06-24,1021
2615,萬海,109,74,35,合庫-台中,2024-06-24,1021
1301,台塑,37,3,34,合庫-台中,2024-06-24,1021
5452,佶優,40,6,34,合庫-台中,2024-06-24,1021
00934,中信成長高股息,33,0,33,合庫-台中,2024-06-24,1021
6269,台郡,33,0,33,合庫-台中,2024-06-24,1021
00935,野村臺灣新科技50,31,0,31,合庫-台中,2024-06-24,1021
00942B,台新美A公司債20+,30,0,30,合庫-台中,2024-06-24,1021
3062,建漢,171,141,30,合庫-台中,2024-06-24,1021
00676R,富邦臺灣加權反1,30,0,30,合庫-台中,2024-06-24,1021
6770,力積電,29,0,29,合庫-台中,2024-06-24,1021
8105,凌巨,36,7,29,合庫-台中,2024-06-24,1021
6526,達發,28,0,28,合庫-台中,2024-06-24,1021
00939,統一台灣高息動能,31,3,28,合庫-台中,2024-06-24,1021
4737,華廣,29,1,28,合庫-台中,2024-06-24,1021
00937B,群益ESG投等債20,607,24,583,合庫-台中,2024-06-25,1021
00632R,元大台灣50反1,1034,479,555,合庫-台中,2024-06-25,1021
3481,群創,808,292,516,合庫-台中,2024-06-25,1021
00929,復華台灣科技優息,444,90,354,合庫-台中,2024-06-25,1021
00919,群益台灣精選高息,506,152,354,合庫-台中,2024-06-25,1021
00650L,復華香港正2,550,200,350,合庫-台中,2024-06-25,1021
2409,友達,250,64,186,合庫-台中,2024-06-25,1021
1309,台達化,163,19,144,合庫-台中,2024-06-25,1021
2356,英業達,117,3,114,合庫-台中,2024-06-25,1021
6120,達運,90,0,90,合庫-台中,2024-06-25,1021
2002,中鋼,98,14,84,合庫-台中,2024-06-25,1021
2352,佳世達,156,74,82,合庫-台中,2024-06-25,1021
2618,長榮航,237,161,76,合庫-台中,2024-06-25,1021
1815,富喬,138,69,69,合庫-台中,2024-06-25,1021
2543,皇昌,76,8,68,合庫-台中,2024-06-25,1021
00946,群益科技高息成長,78,13,65,合庫-台中,2024-06-25,1021
00673R,期元大S＆P原油反1,62,0,62,合庫-台中,2024-06-25,1021
00637L,元大滬深300正2,262,202,60,合庫-台中,2024-06-25,1021
00936,台新永續高息中小,54,0,54,合庫-台中,2024-06-25,1021
2634,漢翔,59,8,51,合庫-台中,2024-06-25,1021
00902,中信電池及儲能,50,0,50,合庫-台中,2024-06-25,1021
5608,四維航,50,2,48,合庫-台中,2024-06-25,1021
2881,富邦金,51,8,43,合庫-台中,2024-06-25,1021
00941,中信上游半導體,42,2,40,合庫-台中,2024-06-25,1021
6116,彩晶,45,6,39,合庫-台中,2024-06-25,1021
6419,京晨科,111,73,38,合庫-台中,2024-06-25,1021
3231,緯創,70,34,36,合庫-台中,2024-06-25,1021
3011,今皓,35,0,35,合庫-台中,2024-06-25,1021
9105,泰金寶-DR,83,48,35,合庫-台中,2024-06-25,1021
3037,欣興,36,1,35,合庫-台中,2024-06-25,1021
00918,大華優利高填息30,94,62,32,合庫-台中,2024-06-25,1021
3005,神基,54,23,31,合庫-台中,2024-06-25,1021
6153,嘉聯益,34,4,30,合庫-台中,2024-06-25,1021
8110,華東,125,95,30,合庫-台中,2024-06-25,1021
6235,華孚,47,19,28,合庫-台中,2024-06-25,1021
2444,兆勁,40,12,28,合庫-台中,2024-06-25,1021
3535,晶彩科,37,10,27,合庫-台中,2024-06-25,1021
6173,信昌電,44,20,24,合庫-台中,2024-06-25,1021
00947,台新臺灣IC設計,22,0,22,合庫-台中,2024-06-25,1021
2324,仁寶,27,6,21,合庫-台中,2024-06-25,1021
9902,台火,20,0,20,合庫-台中,2024-06-25,1021
2377,微星,19,0,19,合庫-台中,2024-06-25,1021
3312,弘憶股,45,26,19,合庫-台中,2024-06-25,1021
2313,華通,48,30,18,合庫-台中,2024-06-25,1021
00687B,國泰20年美債,71,53,18,合庫-台中,2024-06-25,1021
3033,威健,18,0,18,合庫-台中,2024-06-25,1021
1301,台塑,18,0,18,合庫-台中,2024-06-25,1021
2303,聯電,131,114,17,合庫-台中,2024-06-25,1021
1611,中電,24,8,16,合庫-台中,2024-06-25,1021
2516,新建,40,24,16,合庫-台中,2024-06-25,1021
00929,復華台灣科技優息,307,22,285,合庫-台中,2024-06-26,1021
3481,群創,516,265,251,合庫-台中,2024-06-26,1021
00665L,富邦�琤肭磪囓�2,322,171,151,合庫-台中,2024-06-26,1021
2002,中鋼,139,2,137,合庫-台中,2024-06-26,1021
00937B,群益ESG投等債20,132,10,122,合庫-台中,2024-06-26,1021
00931B,統一美債20年,133,22,111,合庫-台中,2024-06-26,1021
9105,泰金寶-DR,174,65,109,合庫-台中,2024-06-26,1021
6117,迎廣,117,12,105,合庫-台中,2024-06-26,1021
2317,鴻海,130,33,97,合庫-台中,2024-06-26,1021
00919,群益台灣精選高息,172,76,96,合庫-台中,2024-06-26,1021
2543,皇昌,78,4,74,合庫-台中,2024-06-26,1021
00946,群益科技高息成長,69,0,69,合庫-台中,2024-06-26,1021
00936,台新永續高息中小,77,8,69,合庫-台中,2024-06-26,1021
6419,京晨科,77,10,67,合庫-台中,2024-06-26,1021
2354,鴻準,77,21,56,合庫-台中,2024-06-26,1021
3062,建漢,130,76,54,合庫-台中,2024-06-26,1021
2371,大同,64,10,54,合庫-台中,2024-06-26,1021
2401,凌陽,85,32,53,合庫-台中,2024-06-26,1021
4123,晟德,52,0,52,合庫-台中,2024-06-26,1021
2314,台揚,51,0,51,合庫-台中,2024-06-26,1021
8110,華東,61,12,49,合庫-台中,2024-06-26,1021
2883,凱基金,125,76,49,合庫-台中,2024-06-26,1021
2353,宏��,108,60,48,合庫-台中,2024-06-26,1021
1714,和桐,46,1,45,合庫-台中,2024-06-26,1021
3581,博磊,77,33,44,合庫-台中,2024-06-26,1021
2885,元大金,58,15,43,合庫-台中,2024-06-26,1021
3231,緯創,49,10,39,合庫-台中,2024-06-26,1021
6526,達發,33,0,33,合庫-台中,2024-06-26,1021
2892,第一金,32,0,32,合庫-台中,2024-06-26,1021
6877,鏵友益,52,20,32,合庫-台中,2024-06-26,1021
2834,臺企銀,32,1,31,合庫-台中,2024-06-26,1021
00637L,元大滬深300正2,230,200,30,合庫-台中,2024-06-26,1021
2365,昆盈,35,5,30,合庫-台中,2024-06-26,1021
5484,慧友,28,0,28,合庫-台中,2024-06-26,1021
4968,立積,33,5,28,合庫-台中,2024-06-26,1021
4967,十銓,101,74,27,合庫-台中,2024-06-26,1021
2515,中工,29,2,27,合庫-台中,2024-06-26,1021
5452,佶優,54,28,26,合庫-台中,2024-06-26,1021
2888,新光金,58,32,26,合庫-台中,2024-06-26,1021
00687B,國泰20年美債,37,11,26,合庫-台中,2024-06-26,1021
00933B,國泰10Y+金融債,25,0,25,合庫-台中,2024-06-26,1021
00830,國泰費城半導體,25,0,25,合庫-台中,2024-06-26,1021
00680L,元大美債20正2,25,0,25,合庫-台中,2024-06-26,1021
8064,東捷,49,25,24,合庫-台中,2024-06-26,1021
2812,台中銀,26,3,23,合庫-台中,2024-06-26,1021
00882,中信中國高股息,24,1,23,合庫-台中,2024-06-26,1021
2312,金寶,26,3,23,合庫-台中,2024-06-26,1021
2891,中信金,38,15,23,合庫-台中,2024-06-26,1021
00706L,期元大S＆P日圓正2,22,0,22,合庫-台中,2024-06-26,1021
1447,力鵬,25,3,22,合庫-台中,2024-06-26,1021
00632R,元大台灣50反1,450,20,430,合庫-台中,2024-06-27,1021
00753L,中信中國50正2,249,10,239,合庫-台中,2024-06-27,1021
00937B,群益ESG投等債20,258,29,229,合庫-台中,2024-06-27,1021
3481,群創,367,151,216,合庫-台中,2024-06-27,1021
00665L,富邦�琤肭磪囓�2,587,399,188,合庫-台中,2024-06-27,1021
00687B,國泰20年美債,168,6,162,合庫-台中,2024-06-27,1021
2885,元大金,113,1,112,合庫-台中,2024-06-27,1021
2883,凱基金,93,5,88,合庫-台中,2024-06-27,1021
2515,中工,89,7,82,合庫-台中,2024-06-27,1021
3047,訊舟,191,116,75,合庫-台中,2024-06-27,1021
9105,泰金寶-DR,123,48,75,合庫-台中,2024-06-27,1021
8064,東捷,108,34,74,合庫-台中,2024-06-27,1021
00751B,元大AAA至A公司債,83,10,73,合庫-台中,2024-06-27,1021
6443,元晶,248,177,71,合庫-台中,2024-06-27,1021
6116,彩晶,75,6,69,合庫-台中,2024-06-27,1021
1785,光洋科,103,36,67,合庫-台中,2024-06-27,1021
00931B,統一美債20年,79,14,65,合庫-台中,2024-06-27,1021
00929,復華台灣科技優息,239,178,61,合庫-台中,2024-06-27,1021
00919,群益台灣精選高息,141,83,58,合庫-台中,2024-06-27,1021
6026,福邦證,50,0,50,合庫-台中,2024-06-27,1021
4938,和碩,48,1,47,合庫-台中,2024-06-27,1021
00712,復華富時不動產,55,10,45,合庫-台中,2024-06-27,1021
2002,中鋼,45,2,43,合庫-台中,2024-06-27,1021
4111,濟生,43,0,43,合庫-台中,2024-06-27,1021
9902,台火,43,0,43,合庫-台中,2024-06-27,1021
00936,台新永續高息中小,112,70,42,合庫-台中,2024-06-27,1021
00680L,元大美債20正2,43,3,40,合庫-台中,2024-06-27,1021
9904,寶成,39,0,39,合庫-台中,2024-06-27,1021
2481,強茂,35,0,35,合庫-台中,2024-06-27,1021
00946,群益科技高息成長,32,0,32,合庫-台中,2024-06-27,1021
2344,華邦電,52,21,31,合庫-台中,2024-06-27,1021
3652,精聯,31,1,30,合庫-台中,2024-06-27,1021
4167,松瑞藥,61,32,29,合庫-台中,2024-06-27,1021
6160,欣技,36,7,29,合庫-台中,2024-06-27,1021
2317,鴻海,78,50,28,合庫-台中,2024-06-27,1021
5489,彩富,27,0,27,合庫-台中,2024-06-27,1021
3450,聯鈞,85,59,26,合庫-台中,2024-06-27,1021
00918,大華優利高填息30,25,0,25,合庫-台中,2024-06-27,1021
2352,佳世達,25,1,24,合庫-台中,2024-06-27,1021
5871,中租-KY,24,0,24,合庫-台中,2024-06-27,1021
2356,英業達,35,11,24,合庫-台中,2024-06-27,1021
00720B,元大投資級公司債,24,0,24,合庫-台中,2024-06-27,1021
8358,金居,43,19,24,合庫-台中,2024-06-27,1021
5355,佳總,47,23,24,合庫-台中,2024-06-27,1021
2330,台積電,32,8,24,合庫-台中,2024-06-27,1021
6152,百一,24,0,24,合庫-台中,2024-06-27,1021
4707,磐亞,33,10,23,合庫-台中,2024-06-27,1021
2603,長榮,45,22,23,合庫-台中,2024-06-27,1021
2467,志聖,66,45,21,合庫-台中,2024-06-27,1021
00878,國泰永續高股息,51,31,20,合庫-台中,2024-06-27,1021
2301,光寶科,1053,10,1043,合庫-台中,2024-06-28,1021
00688L,國泰20年美債正2,520,10,510,合庫-台中,2024-06-28,1021
2618,長榮航,458,30,428,合庫-台中,2024-06-28,1021
1785,光洋科,612,277,335,合庫-台中,2024-06-28,1021
4123,晟德,331,4,327,合庫-台中,2024-06-28,1021
1504,東元,265,5,260,合庫-台中,2024-06-28,1021
3576,聯合再生,275,118,157,合庫-台中,2024-06-28,1021
00937B,群益ESG投等債20,156,12,144,合庫-台中,2024-06-28,1021
00929,復華台灣科技優息,167,24,143,合庫-台中,2024-06-28,1021
00673R,期元大S＆P原油反1,142,0,142,合庫-台中,2024-06-28,1021
00936,台新永續高息中小,151,13,138,合庫-台中,2024-06-28,1021
2610,華航,202,68,134,合庫-台中,2024-06-28,1021
2354,鴻準,187,66,121,合庫-台中,2024-06-28,1021
00687B,國泰20年美債,118,25,93,合庫-台中,2024-06-28,1021
00948B,中信優息投資級債,80,4,76,合庫-台中,2024-06-28,1021
00712,復華富時不動產,81,8,73,合庫-台中,2024-06-28,1021
5351,鈺創,83,20,63,合庫-台中,2024-06-28,1021
6753,龍德造船,54,4,50,合庫-台中,2024-06-28,1021
00902,中信電池及儲能,50,0,50,合庫-台中,2024-06-28,1021
2881,富邦金,60,12,48,合庫-台中,2024-06-28,1021
2406,國碩,84,37,47,合庫-台中,2024-06-28,1021
9136,巨騰-DR,67,21,46,合庫-台中,2024-06-28,1021
2883,凱基金,65,21,44,合庫-台中,2024-06-28,1021
00632R,元大台灣50反1,442,398,44,合庫-台中,2024-06-28,1021
3265,台星科,56,14,42,合庫-台中,2024-06-28,1021
2464,盟立,70,28,42,合庫-台中,2024-06-28,1021
3296,勝德,40,0,40,合庫-台中,2024-06-28,1021
3231,緯創,54,16,38,合庫-台中,2024-06-28,1021
00933B,國泰10Y+金融債,38,0,38,合庫-台中,2024-06-28,1021
2303,聯電,71,34,37,合庫-台中,2024-06-28,1021
3712,永崴投控,49,13,36,合庫-台中,2024-06-28,1021
6477,安集,61,25,36,合庫-台中,2024-06-28,1021
9904,寶成,35,0,35,合庫-台中,2024-06-28,1021
8440,綠電,91,60,31,合庫-台中,2024-06-28,1021
00719B,元大美債1-3,30,0,30,合庫-台中,2024-06-28,1021
2324,仁寶,35,6,29,合庫-台中,2024-06-28,1021
2337,旺宏,30,1,29,合庫-台中,2024-06-28,1021
5371,中光電,37,10,27,合庫-台中,2024-06-28,1021
00679B,元大美債20年,37,11,26,合庫-台中,2024-06-28,1021
6152,百一,52,27,25,合庫-台中,2024-06-28,1021
5871,中租-KY,39,15,24,合庫-台中,2024-06-28,1021
5355,佳總,36,12,24,合庫-台中,2024-06-28,1021
2481,強茂,23,0,23,合庫-台中,2024-06-28,1021
2103,台橡,23,0,23,合庫-台中,2024-06-28,1021
4934,太極,28,6,22,合庫-台中,2024-06-28,1021
9958,世紀鋼,25,4,21,合庫-台中,2024-06-28,1021
3498,陽程,41,20,21,合庫-台中,2024-06-28,1021
3379,彬台,21,0,21,合庫-台中,2024-06-28,1021
2352,佳世達,21,0,21,合庫-台中,2024-06-28,1021
00753L,中信中國50正2,23,2,21,合庫-台中,2024-06-28,1021
00937B,群益ESG投等債20,2553,28,2525,合庫-台中,2024-07-01,1021
00720B,元大投資級公司債,624,0,624,合庫-台中,2024-07-01,1021
00679B,元大美債20年,588,1,587,合庫-台中,2024-07-01,1021
00680L,元大美債20正2,503,240,263,合庫-台中,2024-07-01,1021
00687B,國泰20年美債,241,17,224,合庫-台中,2024-07-01,1021
1785,光洋科,278,64,214,合庫-台中,2024-07-01,1021
6753,龍德造船,222,17,205,合庫-台中,2024-07-01,1021
00929,復華台灣科技優息,322,130,192,合庫-台中,2024-07-01,1021
2897A,王道銀甲特,134,0,134,合庫-台中,2024-07-01,1021
1440,南紡,136,3,133,合庫-台中,2024-07-01,1021
5880,合庫金,124,25,99,合庫-台中,2024-07-01,1021
00751B,元大AAA至A公司債,94,0,94,合庫-台中,2024-07-01,1021
00948B,中信優息投資級債,89,0,89,合庫-台中,2024-07-01,1021
00688L,國泰20年美債正2,138,50,88,合庫-台中,2024-07-01,1021
0056,元大高股息,89,7,82,合庫-台中,2024-07-01,1021
00933B,國泰10Y+金融債,73,2,71,合庫-台中,2024-07-01,1021
2359,所羅門,206,136,70,合庫-台中,2024-07-01,1021
1513,中興電,80,14,66,合庫-台中,2024-07-01,1021
2374,佳能,97,35,62,合庫-台中,2024-07-01,1021
00936,台新永續高息中小,89,30,59,合庫-台中,2024-07-01,1021
5009,榮剛,92,36,56,合庫-台中,2024-07-01,1021
8111,立��,54,0,54,合庫-台中,2024-07-01,1021
2363,矽統,58,11,47,合庫-台中,2024-07-01,1021
9105,泰金寶-DR,83,40,43,合庫-台中,2024-07-01,1021
00919,群益台灣精選高息,222,182,40,合庫-台中,2024-07-01,1021
00902,中信電池及儲能,39,1,38,合庫-台中,2024-07-01,1021
2883,凱基金,43,7,36,合庫-台中,2024-07-01,1021
2401,凌陽,38,2,36,合庫-台中,2024-07-01,1021
00764B,群益25年美債,35,0,35,合庫-台中,2024-07-01,1021
00905,FT臺灣Smart,36,2,34,合庫-台中,2024-07-01,1021
00934,中信成長高股息,38,4,34,合庫-台中,2024-07-01,1021
1802,台玻,41,9,32,合庫-台中,2024-07-01,1021
1303,南亞,39,8,31,合庫-台中,2024-07-01,1021
00885,富邦越南,36,6,30,合庫-台中,2024-07-01,1021
2337,旺宏,42,13,29,合庫-台中,2024-07-01,1021
00713,元大台灣高息低波,31,2,29,合庫-台中,2024-07-01,1021
2609,陽明,86,58,28,合庫-台中,2024-07-01,1021
2406,國碩,39,11,28,合庫-台中,2024-07-01,1021
2882,國泰金,30,2,28,合庫-台中,2024-07-01,1021
2486,一詮,32,5,27,合庫-台中,2024-07-01,1021
3296,勝德,80,54,26,合庫-台中,2024-07-01,1021
3481,群創,103,77,26,合庫-台中,2024-07-01,1021
6160,欣技,27,2,25,合庫-台中,2024-07-01,1021
5608,四維航,25,0,25,合庫-台中,2024-07-01,1021
5603,陸海,24,0,24,合庫-台中,2024-07-01,1021
6188,廣明,65,42,23,合庫-台中,2024-07-01,1021
2313,華通,157,135,22,合庫-台中,2024-07-01,1021
3017,奇鋐,30,9,21,合庫-台中,2024-07-01,1021
00946,群益科技高息成長,21,0,21,合庫-台中,2024-07-01,1021
00650L,復華香港正2,21,0,21,合庫-台中,2024-07-01,1021
2303,聯電,623,229,394,合庫-台中,2024-07-02,1021
00929,復華台灣科技優息,593,221,372,合庫-台中,2024-07-02,1021
00673R,期元大S＆P原油反1,372,0,372,合庫-台中,2024-07-02,1021
00934,中信成長高股息,355,11,344,合庫-台中,2024-07-02,1021
00946,群益科技高息成長,275,10,265,合庫-台中,2024-07-02,1021
00680L,元大美債20正2,244,0,244,合庫-台中,2024-07-02,1021
2618,長榮航,354,142,212,合庫-台中,2024-07-02,1021
1785,光洋科,272,65,207,合庫-台中,2024-07-02,1021
9105,泰金寶-DR,222,16,206,合庫-台中,2024-07-02,1021
00679B,元大美債20年,187,1,186,合庫-台中,2024-07-02,1021
0056,元大高股息,185,4,181,合庫-台中,2024-07-02,1021
00937B,群益ESG投等債20,181,1,180,合庫-台中,2024-07-02,1021
2317,鴻海,217,41,176,合庫-台中,2024-07-02,1021
00919,群益台灣精選高息,190,54,136,合庫-台中,2024-07-02,1021
00687B,國泰20年美債,133,2,131,合庫-台中,2024-07-02,1021
2402,毅嘉,165,61,104,合庫-台中,2024-07-02,1021
00936,台新永續高息中小,126,29,97,合庫-台中,2024-07-02,1021
00751B,元大AAA至A公司債,96,0,96,合庫-台中,2024-07-02,1021
9136,巨騰-DR,107,13,94,合庫-台中,2024-07-02,1021
1440,南紡,90,0,90,合庫-台中,2024-07-02,1021
8064,東捷,110,31,79,合庫-台中,2024-07-02,1021
2515,中工,74,0,74,合庫-台中,2024-07-02,1021
00720B,元大投資級公司債,70,0,70,合庫-台中,2024-07-02,1021
00688L,國泰20年美債正2,67,0,67,合庫-台中,2024-07-02,1021
00948B,中信優息投資級債,65,0,65,合庫-台中,2024-07-02,1021
2002,中鋼,61,2,59,合庫-台中,2024-07-02,1021
00712,復華富時不動產,56,0,56,合庫-台中,2024-07-02,1021
3059,華晶科,63,8,55,合庫-台中,2024-07-02,1021
3576,聯合再生,165,116,49,合庫-台中,2024-07-02,1021
2897A,王道銀甲特,47,0,47,合庫-台中,2024-07-02,1021
6120,達運,50,6,44,合庫-台中,2024-07-02,1021
00949,復華日本龍頭,44,0,44,合庫-台中,2024-07-02,1021
00941,中信上游半導體,63,20,43,合庫-台中,2024-07-02,1021
00933B,國泰10Y+金融債,42,0,42,合庫-台中,2024-07-02,1021
00881,國泰台灣5G+,45,4,41,合庫-台中,2024-07-02,1021
3265,台星科,47,8,39,合庫-台中,2024-07-02,1021
00878,國泰永續高股息,44,6,38,合庫-台中,2024-07-02,1021
5230,雷笛克光學,38,0,38,合庫-台中,2024-07-02,1021
3481,群創,78,40,38,合庫-台中,2024-07-02,1021
2354,鴻準,37,2,35,合庫-台中,2024-07-02,1021
6285,啟��,36,1,35,合庫-台中,2024-07-02,1021
00931B,統一美債20年,34,0,34,合庫-台中,2024-07-02,1021
912000,晨訊科-DR,34,0,34,合庫-台中,2024-07-02,1021
8473,山林水,42,9,33,合庫-台中,2024-07-02,1021
6189,豐藝,62,29,33,合庫-台中,2024-07-02,1021
6538,倉和,42,11,31,合庫-台中,2024-07-02,1021
3702,大聯大,34,3,31,合庫-台中,2024-07-02,1021
1303,南亞,33,2,31,合庫-台中,2024-07-02,1021
5351,鈺創,31,0,31,合庫-台中,2024-07-02,1021
4534,慶騰,36,5,31,合庫-台中,2024-07-02,1021
00934,中信成長高股息,637,11,626,合庫-台中,2024-07-03,1021
00937B,群益ESG投等債20,169,29,140,合庫-台中,2024-07-03,1021
9105,泰金寶-DR,219,82,137,合庫-台中,2024-07-03,1021
4726,永昕,122,6,116,合庫-台中,2024-07-03,1021
00680L,元大美債20正2,146,30,116,合庫-台中,2024-07-03,1021
00946,群益科技高息成長,129,17,112,合庫-台中,2024-07-03,1021
00688L,國泰20年美債正2,105,0,105,合庫-台中,2024-07-03,1021
00679B,元大美債20年,100,3,97,合庫-台中,2024-07-03,1021
1785,光洋科,245,160,85,合庫-台中,2024-07-03,1021
3005,神基,124,41,83,合庫-台中,2024-07-03,1021
2303,聯電,202,133,69,合庫-台中,2024-07-03,1021
00632R,元大台灣50反1,61,0,61,合庫-台中,2024-07-03,1021
2801,彰銀,102,45,57,合庫-台中,2024-07-03,1021
3050,鈺德,97,44,53,合庫-台中,2024-07-03,1021
9136,巨騰-DR,111,60,51,合庫-台中,2024-07-03,1021
1444,力麗,85,35,50,合庫-台中,2024-07-03,1021
3047,訊舟,90,41,49,合庫-台中,2024-07-03,1021
00948B,中信優息投資級債,42,0,42,合庫-台中,2024-07-03,1021
3713,新晶投控,38,1,37,合庫-台中,2024-07-03,1021
00933B,國泰10Y+金融債,47,10,37,合庫-台中,2024-07-03,1021
2609,陽明,69,34,35,合庫-台中,2024-07-03,1021
4123,晟德,43,9,34,合庫-台中,2024-07-03,1021
6244,茂迪,102,68,34,合庫-台中,2024-07-03,1021
2606,裕民,54,21,33,合庫-台中,2024-07-03,1021
00637L,元大滬深300正2,420,390,30,合庫-台中,2024-07-03,1021
3189,景碩,30,0,30,合庫-台中,2024-07-03,1021
6189,豐藝,74,44,30,合庫-台中,2024-07-03,1021
2002,中鋼,38,8,30,合庫-台中,2024-07-03,1021
6188,廣明,34,4,30,合庫-台中,2024-07-03,1021
5347,世界,37,8,29,合庫-台中,2024-07-03,1021
4510,高鋒,42,13,29,合庫-台中,2024-07-03,1021
6733,博晟生醫,33,4,29,合庫-台中,2024-07-03,1021
4960,誠美材,32,6,26,合庫-台中,2024-07-03,1021
00935,野村臺灣新科技50,26,2,24,合庫-台中,2024-07-03,1021
3715,定穎投控,35,12,23,合庫-台中,2024-07-03,1021
2105,正新,23,0,23,合庫-台中,2024-07-03,1021
4906,正文,74,52,22,合庫-台中,2024-07-03,1021
5009,榮剛,25,3,22,合庫-台中,2024-07-03,1021
1504,東元,23,1,22,合庫-台中,2024-07-03,1021
00919,群益台灣精選高息,51,30,21,合庫-台中,2024-07-03,1021
1440,南紡,21,1,20,合庫-台中,2024-07-03,1021
5351,鈺創,21,1,20,合庫-台中,2024-07-03,1021
1506,正道,20,0,20,合庫-台中,2024-07-03,1021
3615,安可,34,14,20,合庫-台中,2024-07-03,1021
3591,艾笛森,24,4,20,合庫-台中,2024-07-03,1021
5355,佳總,19,0,19,合庫-台中,2024-07-03,1021
6442,光聖,22,3,19,合庫-台中,2024-07-03,1021
3663,鑫科,39,21,18,合庫-台中,2024-07-03,1021
1608,華榮,20,2,18,合庫-台中,2024-07-03,1021
1305,華夏,20,2,18,合庫-台中,2024-07-03,1021
00632R,元大台灣50反1,1145,61,1084,合庫-台中,2024-07-04,1021
2301,光寶科,1007,27,980,合庫-台中,2024-07-04,1021
00937B,群益ESG投等債20,707,20,687,合庫-台中,2024-07-04,1021
4726,永昕,207,10,197,合庫-台中,2024-07-04,1021
00688L,國泰20年美債正2,165,21,144,合庫-台中,2024-07-04,1021
2412,中華電,147,3,144,合庫-台中,2024-07-04,1021
00934,中信成長高股息,236,100,136,合庫-台中,2024-07-04,1021
2888,新光金,235,107,128,合庫-台中,2024-07-04,1021
00673R,期元大S＆P原油反1,105,0,105,合庫-台中,2024-07-04,1021
5608,四維航,89,1,88,合庫-台中,2024-07-04,1021
2405,輔信,193,105,88,合庫-台中,2024-07-04,1021
2618,長榮航,202,118,84,合庫-台中,2024-07-04,1021
5443,均豪,97,16,81,合庫-台中,2024-07-04,1021
00679B,元大美債20年,71,0,71,合庫-台中,2024-07-04,1021
2606,裕民,72,2,70,合庫-台中,2024-07-04,1021
2417,圓剛,214,152,62,合庫-台中,2024-07-04,1021
3703,欣陸,73,12,61,合庫-台中,2024-07-04,1021
2354,鴻準,73,13,60,合庫-台中,2024-07-04,1021
2609,陽明,79,21,58,合庫-台中,2024-07-04,1021
4908,前鼎,62,6,56,合庫-台中,2024-07-04,1021
2834,臺企銀,62,11,51,合庫-台中,2024-07-04,1021
00650L,復華香港正2,250,200,50,合庫-台中,2024-07-04,1021
2515,中工,50,0,50,合庫-台中,2024-07-04,1021
1713,國化,47,0,47,合庫-台中,2024-07-04,1021
5347,世界,60,14,46,合庫-台中,2024-07-04,1021
6016,康和證,45,0,45,合庫-台中,2024-07-04,1021
4109,加捷生醫,78,35,43,合庫-台中,2024-07-04,1021
2886,兆豐金,45,2,43,合庫-台中,2024-07-04,1021
9136,巨騰-DR,180,137,43,合庫-台中,2024-07-04,1021
1815,富喬,111,68,43,合庫-台中,2024-07-04,1021
9105,泰金寶-DR,75,35,40,合庫-台中,2024-07-04,1021
2002,中鋼,57,18,39,合庫-台中,2024-07-04,1021
8028,昇陽半導體,74,39,35,合庫-台中,2024-07-04,1021
2401,凌陽,55,20,35,合庫-台中,2024-07-04,1021
6698,旭暉應材,65,31,34,合庫-台中,2024-07-04,1021
3047,訊舟,244,211,33,合庫-台中,2024-07-04,1021
2444,兆勁,33,0,33,合庫-台中,2024-07-04,1021
3276,宇環,33,0,33,合庫-台中,2024-07-04,1021
1539,巨庭,33,0,33,合庫-台中,2024-07-04,1021
2359,所羅門,279,249,30,合庫-台中,2024-07-04,1021
2323,中環,94,65,29,合庫-台中,2024-07-04,1021
6127,九豪,49,20,29,合庫-台中,2024-07-04,1021
6770,力積電,31,3,28,合庫-台中,2024-07-04,1021
3450,聯鈞,161,133,28,合庫-台中,2024-07-04,1021
1402,遠東新,53,27,26,合庫-台中,2024-07-04,1021
1409,新纖,42,16,26,合庫-台中,2024-07-04,1021
00637L,元大滬深300正2,250,226,24,合庫-台中,2024-07-04,1021
00948B,中信優息投資級債,33,9,24,合庫-台中,2024-07-04,1021
2349,錸德,58,34,24,合庫-台中,2024-07-04,1021
00936,台新永續高息中小,29,5,24,合庫-台中,2024-07-04,1021
8105,凌巨,703,12,691,合庫-台中,2024-07-05,1021
1785,光洋科,737,145,592,合庫-台中,2024-07-05,1021
1101,台泥,285,19,266,合庫-台中,2024-07-05,1021
00937B,群益ESG投等債20,222,20,202,合庫-台中,2024-07-05,1021
3576,聯合再生,192,12,180,合庫-台中,2024-07-05,1021
2323,中環,230,91,139,合庫-台中,2024-07-05,1021
00936,台新永續高息中小,100,0,100,合庫-台中,2024-07-05,1021
00665L,富邦�琤肭磪囓�2,292,202,90,合庫-台中,2024-07-05,1021
2888,新光金,310,225,85,合庫-台中,2024-07-05,1021
00712,復華富時不動產,81,0,81,合庫-台中,2024-07-05,1021
00655L,國泰中國A50正2,95,15,80,合庫-台中,2024-07-05,1021
00940,元大台灣價值高息,122,47,75,合庫-台中,2024-07-05,1021
00934,中信成長高股息,123,50,73,合庫-台中,2024-07-05,1021
4123,晟德,82,8,74,合庫-台中,2024-07-05,1021
2618,長榮航,164,98,66,合庫-台中,2024-07-05,1021
2349,錸德,69,4,65,合庫-台中,2024-07-05,1021
2498,宏達電,77,15,62,合庫-台中,2024-07-05,1021
00687B,國泰20年美債,64,3,61,合庫-台中,2024-07-05,1021
2329,華泰,173,112,61,合庫-台中,2024-07-05,1021
4906,正文,74,19,55,合庫-台中,2024-07-05,1021
1504,東元,107,55,52,合庫-台中,2024-07-05,1021
2312,金寶,80,28,52,合庫-台中,2024-07-05,1021
2352,佳世達,56,5,51,合庫-台中,2024-07-05,1021
1611,中電,50,1,49,合庫-台中,2024-07-05,1021
3048,益登,130,83,47,合庫-台中,2024-07-05,1021
2457,飛宏,51,4,47,合庫-台中,2024-07-05,1021
2911,麗嬰房,47,0,47,合庫-台中,2024-07-05,1021
2105,正新,52,5,47,合庫-台中,2024-07-05,1021
2464,盟立,130,84,46,合庫-台中,2024-07-05,1021
2301,光寶科,48,6,42,合庫-台中,2024-07-05,1021
6116,彩晶,60,20,40,合庫-台中,2024-07-05,1021
8039,台虹,50,11,39,合庫-台中,2024-07-05,1021
1718,中纖,48,10,38,合庫-台中,2024-07-05,1021
1608,華榮,52,14,38,合庫-台中,2024-07-05,1021
1714,和桐,50,13,37,合庫-台中,2024-07-05,1021
6282,康舒,67,32,35,合庫-台中,2024-07-05,1021
2330,台積電,45,11,34,合庫-台中,2024-07-05,1021
3050,鈺德,106,73,33,合庫-台中,2024-07-05,1021
5347,世界,46,13,33,合庫-台中,2024-07-05,1021
2412,中華電,32,2,30,合庫-台中,2024-07-05,1021
1402,遠東新,28,0,28,合庫-台中,2024-07-05,1021
00905,FT臺灣Smart,27,0,27,合庫-台中,2024-07-05,1021
5481,新華,28,1,27,合庫-台中,2024-07-05,1021
4726,永昕,33,7,26,合庫-台中,2024-07-05,1021
3580,友威科,71,45,26,合庫-台中,2024-07-05,1021
00673R,期元大S＆P原油反1,26,0,26,合庫-台中,2024-07-05,1021
2851,中再保,26,0,26,合庫-台中,2024-07-05,1021
2641,正德,27,2,25,合庫-台中,2024-07-05,1021
8234,新漢,39,14,25,合庫-台中,2024-07-05,1021
0056,元大高股息,28,5,23,合庫-台中,2024-07-05,1021
00664R,國泰臺灣加權反1,900,0,900,合庫-台中,2024-07-08,1021
00632R,元大台灣50反1,753,110,643,合庫-台中,2024-07-08,1021
00934,中信成長高股息,416,3,413,合庫-台中,2024-07-08,1021
00937B,群益ESG投等債20,402,106,296,合庫-台中,2024-07-08,1021
1785,光洋科,361,107,254,合庫-台中,2024-07-08,1021
2464,盟立,387,163,224,合庫-台中,2024-07-08,1021
00882,中信中國高股息,157,0,157,合庫-台中,2024-07-08,1021
6120,達運,181,30,151,合庫-台中,2024-07-08,1021
2401,凌陽,182,42,140,合庫-台中,2024-07-08,1021
00665L,富邦�琤肭磪囓�2,280,150,130,合庫-台中,2024-07-08,1021
8064,東捷,170,70,100,合庫-台中,2024-07-08,1021
2834,臺企銀,94,5,89,合庫-台中,2024-07-08,1021
2002,中鋼,82,2,80,合庫-台中,2024-07-08,1021
2801,彰銀,100,20,80,合庫-台中,2024-07-08,1021
2618,長榮航,150,77,73,合庫-台中,2024-07-08,1021
00940,元大台灣價值高息,222,150,72,合庫-台中,2024-07-08,1021
2374,佳能,152,84,68,合庫-台中,2024-07-08,1021
2344,華邦電,85,19,66,合庫-台中,2024-07-08,1021
2365,昆盈,227,168,59,合庫-台中,2024-07-08,1021
6152,百一,58,0,58,合庫-台中,2024-07-08,1021
3062,建漢,83,26,57,合庫-台中,2024-07-08,1021
2354,鴻準,112,56,56,合庫-台中,2024-07-08,1021
4562,穎漢,64,11,53,合庫-台中,2024-07-08,1021
6244,茂迪,78,25,53,合庫-台中,2024-07-08,1021
5392,能率,71,20,51,合庫-台中,2024-07-08,1021
6443,元晶,78,28,50,合庫-台中,2024-07-08,1021
00946,群益科技高息成長,53,3,50,合庫-台中,2024-07-08,1021
8234,新漢,108,62,46,合庫-台中,2024-07-08,1021
3163,波若威,93,49,44,合庫-台中,2024-07-08,1021
3576,聯合再生,57,14,43,合庫-台中,2024-07-08,1021
8935,邦泰,40,0,40,合庫-台中,2024-07-08,1021
3313,斐成,48,10,38,合庫-台中,2024-07-08,1021
4906,正文,67,30,37,合庫-台中,2024-07-08,1021
2359,所羅門,53,18,35,合庫-台中,2024-07-08,1021
8936,國統,35,0,35,合庫-台中,2024-07-08,1021
00936,台新永續高息中小,44,10,34,合庫-台中,2024-07-08,1021
6207,雷科,86,52,34,合庫-台中,2024-07-08,1021
00679B,元大美債20年,79,46,33,合庫-台中,2024-07-08,1021
8085,福華,36,3,33,合庫-台中,2024-07-08,1021
2397,友通,31,1,30,合庫-台中,2024-07-08,1021
00895,富邦未來車,30,1,29,合庫-台中,2024-07-08,1021
1608,華榮,91,62,29,合庫-台中,2024-07-08,1021
2611,志信,29,0,29,合庫-台中,2024-07-08,1021
2337,旺宏,56,28,28,合庫-台中,2024-07-08,1021
2355,敬鵬,30,2,28,合庫-台中,2024-07-08,1021
2489,瑞軒,33,5,28,合庫-台中,2024-07-08,1021
5272,笙科,63,36,27,合庫-台中,2024-07-08,1021
8374,羅昇,74,48,26,合庫-台中,2024-07-08,1021
00713,元大台灣高息低波,27,1,26,合庫-台中,2024-07-08,1021
3005,神基,54,29,25,合庫-台中,2024-07-08,1021
00937B,群益ESG投等債20,858,141,717,合庫-台中,2024-07-09,1021
2801,彰銀,410,1,409,合庫-台中,2024-07-09,1021
9105,泰金寶-DR,468,192,276,合庫-台中,2024-07-09,1021
2312,金寶,408,190,218,合庫-台中,2024-07-09,1021
2367,燿華,345,142,203,合庫-台中,2024-07-09,1021
9136,巨騰-DR,172,10,162,合庫-台中,2024-07-09,1021
2349,錸德,183,21,162,合庫-台中,2024-07-09,1021
00936,台新永續高息中小,177,17,160,合庫-台中,2024-07-09,1021
2405,輔信,383,237,146,合庫-台中,2024-07-09,1021
5481,新華,139,3,136,合庫-台中,2024-07-09,1021
00934,中信成長高股息,133,16,117,合庫-台中,2024-07-09,1021
2867,三商壽,182,94,88,合庫-台中,2024-07-09,1021
6120,達運,87,8,79,合庫-台中,2024-07-09,1021
2486,一詮,65,3,62,合庫-台中,2024-07-09,1021
2834,臺企銀,155,94,61,合庫-台中,2024-07-09,1021
5469,瀚宇博,59,0,59,合庫-台中,2024-07-09,1021
3047,訊舟,187,129,58,合庫-台中,2024-07-09,1021
2353,宏��,60,2,58,合庫-台中,2024-07-09,1021
4804,大略-KY,58,0,58,合庫-台中,2024-07-09,1021
2515,中工,112,55,57,合庫-台中,2024-07-09,1021
00942B,台新美A公司債20+,51,0,51,合庫-台中,2024-07-09,1021
1605,華新,51,1,50,合庫-台中,2024-07-09,1021
3276,宇環,49,0,49,合庫-台中,2024-07-09,1021
2355,敬鵬,52,4,48,合庫-台中,2024-07-09,1021
2610,華航,50,3,47,合庫-台中,2024-07-09,1021
2317,鴻海,137,90,47,合庫-台中,2024-07-09,1021
4716,大立,46,0,46,合庫-台中,2024-07-09,1021
00946,群益科技高息成長,56,11,45,合庫-台中,2024-07-09,1021
8059,凱碩,46,2,44,合庫-台中,2024-07-09,1021
0056,元大高股息,51,9,42,合庫-台中,2024-07-09,1021
3050,鈺德,75,33,42,合庫-台中,2024-07-09,1021
3231,緯創,100,58,42,合庫-台中,2024-07-09,1021
2426,鼎元,41,1,40,合庫-台中,2024-07-09,1021
5608,四維航,44,5,39,合庫-台中,2024-07-09,1021
3062,建漢,45,6,39,合庫-台中,2024-07-09,1021
00929,復華台灣科技優息,143,104,39,合庫-台中,2024-07-09,1021
6117,迎廣,41,3,38,合庫-台中,2024-07-09,1021
3537,堡達,38,3,35,合庫-台中,2024-07-09,1021
00918,大華優利高填息30,40,6,34,合庫-台中,2024-07-09,1021
2617,台航,33,0,33,合庫-台中,2024-07-09,1021
4564,元翎,33,0,33,合庫-台中,2024-07-09,1021
1536,和大,114,81,33,合庫-台中,2024-07-09,1021
4160,訊聯基因,33,2,31,合庫-台中,2024-07-09,1021
2449,京元電子,61,30,31,合庫-台中,2024-07-09,1021
1301,台塑,30,0,30,合庫-台中,2024-07-09,1021
8937,合騏,30,0,30,合庫-台中,2024-07-09,1021
2344,華邦電,35,9,26,合庫-台中,2024-07-09,1021
2330,台積電,37,11,26,合庫-台中,2024-07-09,1021
2392,正崴,223,198,25,合庫-台中,2024-07-09,1021
3432,台端,25,0,25,合庫-台中,2024-07-09,1021
8105,凌巨,1360,21,1339,合庫-台中,2024-07-10,1021
00937B,群益ESG投等債20,1080,47,1033,合庫-台中,2024-07-10,1021
2317,鴻海,756,23,733,合庫-台中,2024-07-10,1021
2888,新光金,739,403,336,合庫-台中,2024-07-10,1021
2392,正崴,406,154,252,合庫-台中,2024-07-10,1021
00929,復華台灣科技優息,191,56,135,合庫-台中,2024-07-10,1021
2834,臺企銀,134,16,118,合庫-台中,2024-07-10,1021
9105,泰金寶-DR,170,53,117,合庫-台中,2024-07-10,1021
2449,京元電子,130,20,110,合庫-台中,2024-07-10,1021
00946,群益科技高息成長,92,4,88,合庫-台中,2024-07-10,1021
1608,華榮,88,8,80,合庫-台中,2024-07-10,1021
5876,上海商銀,68,0,68,合庫-台中,2024-07-10,1021
00934,中信成長高股息,77,12,65,合庫-台中,2024-07-10,1021
2002,中鋼,67,7,60,合庫-台中,2024-07-10,1021
6133,金橋,69,10,59,合庫-台中,2024-07-10,1021
4904,遠傳,62,4,58,合庫-台中,2024-07-10,1021
9136,巨騰-DR,114,64,50,合庫-台中,2024-07-10,1021
5347,世界,42,1,41,合庫-台中,2024-07-10,1021
6218,豪勉,52,12,40,合庫-台中,2024-07-10,1021
3673,TPK-KY,62,22,40,合庫-台中,2024-07-10,1021
00933B,國泰10Y+金融債,39,0,39,合庫-台中,2024-07-10,1021
1515,力山,46,7,39,合庫-台中,2024-07-10,1021
3312,弘憶股,98,59,39,合庫-台中,2024-07-10,1021
2312,金寶,69,31,38,合庫-台中,2024-07-10,1021
2367,燿華,148,113,35,合庫-台中,2024-07-10,1021
00949,復華日本龍頭,35,0,35,合庫-台中,2024-07-10,1021
00725B,國泰投資級公司債,35,0,35,合庫-台中,2024-07-10,1021
2352,佳世達,39,4,35,合庫-台中,2024-07-10,1021
1616,億泰,64,30,34,合庫-台中,2024-07-10,1021
3011,今皓,34,0,34,合庫-台中,2024-07-10,1021
4111,濟生,31,0,31,合庫-台中,2024-07-10,1021
2355,敬鵬,41,11,30,合庫-台中,2024-07-10,1021
2301,光寶科,70,42,28,合庫-台中,2024-07-10,1021
2303,聯電,94,66,28,合庫-台中,2024-07-10,1021
3105,穩懋,28,0,28,合庫-台中,2024-07-10,1021
3712,永崴投控,57,30,27,合庫-台中,2024-07-10,1021
2634,漢翔,43,18,25,合庫-台中,2024-07-10,1021
2401,凌陽,31,6,25,合庫-台中,2024-07-10,1021
2801,彰銀,25,1,24,合庫-台中,2024-07-10,1021
00927,群益半導體收益,36,12,24,合庫-台中,2024-07-10,1021
2605,新興,24,0,24,合庫-台中,2024-07-10,1021
5272,笙科,30,6,24,合庫-台中,2024-07-10,1021
00881,國泰台灣5G+,26,3,23,合庫-台中,2024-07-10,1021
1447,力鵬,25,2,23,合庫-台中,2024-07-10,1021
9904,寶成,23,0,23,合庫-台中,2024-07-10,1021
2412,中華電,22,0,22,合庫-台中,2024-07-10,1021
00902,中信電池及儲能,22,0,22,合庫-台中,2024-07-10,1021
5351,鈺創,22,0,22,合庫-台中,2024-07-10,1021
5426,振發,26,4,22,合庫-台中,2024-07-10,1021
00936,台新永續高息中小,21,0,21,合庫-台中,2024-07-10,1021
4804,大略-KY,976,0,976,合庫-台中,2024-07-11,1021
00937B,群益ESG投等債20,763,12,751,合庫-台中,2024-07-11,1021
00665L,富邦�琤肭磪囓�2,838,180,658,合庫-台中,2024-07-11,1021
2464,盟立,355,99,256,合庫-台中,2024-07-11,1021
00632R,元大台灣50反1,243,1,242,合庫-台中,2024-07-11,1021
2618,長榮航,297,153,144,合庫-台中,2024-07-11,1021
00679B,元大美債20年,113,2,111,合庫-台中,2024-07-11,1021
00934,中信成長高股息,150,46,104,合庫-台中,2024-07-11,1021
6120,達運,103,0,103,合庫-台中,2024-07-11,1021
00740B,富邦全球投等債,96,0,96,合庫-台中,2024-07-11,1021
00725B,國泰投資級公司債,89,0,89,合庫-台中,2024-07-11,1021
3050,鈺德,156,68,88,合庫-台中,2024-07-11,1021
2867,三商壽,115,31,84,合庫-台中,2024-07-11,1021
2401,凌陽,151,72,79,合庫-台中,2024-07-11,1021
2884,玉山金,96,26,70,合庫-台中,2024-07-11,1021
00687B,國泰20年美債,79,10,69,合庫-台中,2024-07-11,1021
00673R,期元大S＆P原油反1,58,0,58,合庫-台中,2024-07-11,1021
00936,台新永續高息中小,53,0,53,合庫-台中,2024-07-11,1021
2353,宏��,88,35,53,合庫-台中,2024-07-11,1021
00950B,凱基A級公司債,52,0,52,合庫-台中,2024-07-11,1021
1314,中石化,67,20,47,合庫-台中,2024-07-11,1021
3202,樺晟,46,0,46,合庫-台中,2024-07-11,1021
3707,漢磊,79,33,46,合庫-台中,2024-07-11,1021
2388,威盛,57,12,45,合庫-台中,2024-07-11,1021
1514,亞力,84,40,44,合庫-台中,2024-07-11,1021
3498,陽程,56,13,43,合庫-台中,2024-07-11,1021
2897,王道銀行,42,0,42,合庫-台中,2024-07-11,1021
2330,台積電,71,29,42,合庫-台中,2024-07-11,1021
912000,晨訊科-DR,50,10,40,合庫-台中,2024-07-11,1021
2382,廣達,53,14,39,合庫-台中,2024-07-11,1021
2363,矽統,78,41,37,合庫-台中,2024-07-11,1021
3363,上詮,61,27,34,合庫-台中,2024-07-11,1021
2634,漢翔,45,11,34,合庫-台中,2024-07-11,1021
8028,昇陽半導體,63,29,34,合庫-台中,2024-07-11,1021
6834,天二科技,33,0,33,合庫-台中,2024-07-11,1021
2374,佳能,55,22,33,合庫-台中,2024-07-11,1021
2891,中信金,47,15,32,合庫-台中,2024-07-11,1021
3162,精確,30,0,30,合庫-台中,2024-07-11,1021
8064,東捷,61,31,30,合庫-台中,2024-07-11,1021
4979,華星光,30,1,29,合庫-台中,2024-07-11,1021
5452,佶優,40,12,28,合庫-台中,2024-07-11,1021
1784,訊聯,29,1,28,合庫-台中,2024-07-11,1021
1101,台泥,27,0,27,合庫-台中,2024-07-11,1021
4111,濟生,26,0,26,合庫-台中,2024-07-11,1021
1569,濱川,42,16,26,合庫-台中,2024-07-11,1021
00881,國泰台灣5G+,42,16,26,合庫-台中,2024-07-11,1021
2105,正新,27,2,25,合庫-台中,2024-07-11,1021
2913,農林,25,0,25,合庫-台中,2024-07-11,1021
4406,新昕纖,25,0,25,合庫-台中,2024-07-11,1021
6118,建達,25,0,25,合庫-台中,2024-07-11,1021
00929,復華台灣科技優息,764,64,700,合庫-台中,2024-07-12,1021
00919,群益台灣精選高息,362,16,346,合庫-台中,2024-07-12,1021
2367,燿華,349,14,335,合庫-台中,2024-07-12,1021
00881,國泰台灣5G+,327,33,294,合庫-台中,2024-07-12,1021
2317,鴻海,249,47,202,合庫-台中,2024-07-12,1021
2312,金寶,349,184,165,合庫-台中,2024-07-12,1021
00934,中信成長高股息,195,46,149,合庫-台中,2024-07-12,1021
00882,中信中國高股息,150,3,147,合庫-台中,2024-07-12,1021
00687B,國泰20年美債,200,64,136,合庫-台中,2024-07-12,1021
00927,群益半導體收益,124,5,119,合庫-台中,2024-07-12,1021
00688L,國泰20年美債正2,172,59,113,合庫-台中,2024-07-12,1021
00940,元大台灣價值高息,151,46,105,合庫-台中,2024-07-12,1021
1785,光洋科,105,13,92,合庫-台中,2024-07-12,1021
2303,聯電,230,139,91,合庫-台中,2024-07-12,1021
3047,訊舟,86,7,79,合庫-台中,2024-07-12,1021
1717,長興,80,1,79,合庫-台中,2024-07-12,1021
2610,華航,81,10,71,合庫-台中,2024-07-12,1021
00936,台新永續高息中小,67,0,67,合庫-台中,2024-07-12,1021
2330,台積電,92,25,67,合庫-台中,2024-07-12,1021
00850,元大臺灣ESG永續,56,0,56,合庫-台中,2024-07-12,1021
3712,永崴投控,154,100,54,合庫-台中,2024-07-12,1021
00946,群益科技高息成長,53,0,53,合庫-台中,2024-07-12,1021
00673R,期元大S＆P原油反1,50,0,50,合庫-台中,2024-07-12,1021
00680L,元大美債20正2,81,31,50,合庫-台中,2024-07-12,1021
00679B,元大美債20年,142,97,45,合庫-台中,2024-07-12,1021
3580,友威科,42,1,41,合庫-台中,2024-07-12,1021
2609,陽明,72,33,39,合庫-台中,2024-07-12,1021
1514,亞力,67,27,40,合庫-台中,2024-07-12,1021
1503,士電,46,8,38,合庫-台中,2024-07-12,1021
5347,世界,54,17,37,合庫-台中,2024-07-12,1021
00935,野村臺灣新科技50,37,0,37,合庫-台中,2024-07-12,1021
00772B,中信高評級公司債,51,15,36,合庫-台中,2024-07-12,1021
3163,波若威,81,46,35,合庫-台中,2024-07-12,1021
1563,巧新,35,0,35,合庫-台中,2024-07-12,1021
00941,中信上游半導體,34,0,34,合庫-台中,2024-07-12,1021
00905,FT臺灣Smart,34,1,33,合庫-台中,2024-07-12,1021
1314,中石化,59,26,33,合庫-台中,2024-07-12,1021
0050,元大台灣50,36,3,33,合庫-台中,2024-07-12,1021
2401,凌陽,68,36,32,合庫-台中,2024-07-12,1021
2405,輔信,93,61,32,合庫-台中,2024-07-12,1021
00933B,國泰10Y+金融債,54,23,31,合庫-台中,2024-07-12,1021
2486,一詮,32,1,31,合庫-台中,2024-07-12,1021
00928,中信上櫃ESG30,30,0,30,合庫-台中,2024-07-12,1021
3710,連展投控,28,0,28,合庫-台中,2024-07-12,1021
6126,信音,44,16,28,合庫-台中,2024-07-12,1021
00891,中信關鍵半導體,37,10,27,合庫-台中,2024-07-12,1021
3312,弘憶股,33,7,26,合庫-台中,2024-07-12,1021
2313,華通,157,133,24,合庫-台中,2024-07-12,1021
00949,復華日本龍頭,24,0,24,合庫-台中,2024-07-12,1021
1513,中興電,72,49,23,合庫-台中,2024-07-12,1021
00706L,期元大S＆P日圓正2,848,2,846,合庫-台中,2024-07-15,1021
4804,大略-KY,429,0,429,合庫-台中,2024-07-15,1021
00937B,群益ESG投等債20,427,24,403,合庫-台中,2024-07-15,1021
2489,瑞軒,367,104,263,合庫-台中,2024-07-15,1021
2891,中信金,211,9,202,合庫-台中,2024-07-15,1021
1314,中石化,160,0,160,合庫-台中,2024-07-15,1021
00929,復華台灣科技優息,193,35,158,合庫-台中,2024-07-15,1021
00919,群益台灣精選高息,172,27,145,合庫-台中,2024-07-15,1021
8105,凌巨,172,28,144,合庫-台中,2024-07-15,1021
2353,宏��,147,4,143,合庫-台中,2024-07-15,1021
6120,達運,143,0,143,合庫-台中,2024-07-15,1021
9105,泰金寶-DR,194,56,138,合庫-台中,2024-07-15,1021
0056,元大高股息,143,12,131,合庫-台中,2024-07-15,1021
00720B,元大投資級公司債,131,0,131,合庫-台中,2024-07-15,1021
00687B,國泰20年美債,126,7,119,合庫-台中,2024-07-15,1021
00680L,元大美債20正2,115,0,115,合庫-台中,2024-07-15,1021
00882,中信中國高股息,114,0,114,合庫-台中,2024-07-15,1021
5381,合正,117,16,101,合庫-台中,2024-07-15,1021
2356,英業達,216,119,97,合庫-台中,2024-07-15,1021
6419,京晨科,187,97,90,合庫-台中,2024-07-15,1021
2834,臺企銀,117,33,84,合庫-台中,2024-07-15,1021
00934,中信成長高股息,215,134,81,合庫-台中,2024-07-15,1021
2312,金寶,197,118,79,合庫-台中,2024-07-15,1021
2426,鼎元,76,2,74,合庫-台中,2024-07-15,1021
6005,群益證,76,3,73,合庫-台中,2024-07-15,1021
2313,華通,152,85,67,合庫-台中,2024-07-15,1021
2542,興富發,93,34,59,合庫-台中,2024-07-15,1021
2883,凱基金,88,31,57,合庫-台中,2024-07-15,1021
00650L,復華香港正2,137,81,56,合庫-台中,2024-07-15,1021
6219,富旺,57,1,56,合庫-台中,2024-07-15,1021
00753L,中信中國50正2,55,4,51,合庫-台中,2024-07-15,1021
00948B,中信優息投資級債,51,0,51,合庫-台中,2024-07-15,1021
2501,國建,75,25,50,合庫-台中,2024-07-15,1021
2885,元大金,48,0,48,合庫-台中,2024-07-15,1021
2538,基泰,63,18,45,合庫-台中,2024-07-15,1021
2897,王道銀行,45,3,42,合庫-台中,2024-07-15,1021
2882,國泰金,40,1,39,合庫-台中,2024-07-15,1021
1532,勤美,40,2,38,合庫-台中,2024-07-15,1021
6806,森崴能源,49,13,36,合庫-台中,2024-07-15,1021
1301,台塑,35,1,34,合庫-台中,2024-07-15,1021
2365,昆盈,65,31,34,合庫-台中,2024-07-15,1021
8996,高力,33,0,33,合庫-台中,2024-07-15,1021
3379,彬台,40,8,32,合庫-台中,2024-07-15,1021
8028,昇陽半導體,86,56,30,合庫-台中,2024-07-15,1021
1785,光洋科,46,16,30,合庫-台中,2024-07-15,1021
2610,華航,52,22,30,合庫-台中,2024-07-15,1021
3535,晶彩科,71,42,29,合庫-台中,2024-07-15,1021
2243,宏旭-KY,35,8,27,合庫-台中,2024-07-15,1021
1618,合機,37,10,27,合庫-台中,2024-07-15,1021
00878,國泰永續高股息,38,11,27,合庫-台中,2024-07-15,1021
00937B,群益ESG投等債20,396,5,391,合庫-台中,2024-07-16,1021
00919,群益台灣精選高息,302,47,255,合庫-台中,2024-07-16,1021
00665L,富邦�琤肭磪囓�2,283,97,186,合庫-台中,2024-07-16,1021
2501,國建,176,27,149,合庫-台中,2024-07-16,1021
0056,元大高股息,151,3,148,合庫-台中,2024-07-16,1021
00934,中信成長高股息,164,25,139,合庫-台中,2024-07-16,1021
2542,興富發,170,32,138,合庫-台中,2024-07-16,1021
9105,泰金寶-DR,152,17,135,合庫-台中,2024-07-16,1021
00753L,中信中國50正2,106,0,106,合庫-台中,2024-07-16,1021
2882,國泰金,112,12,100,合庫-台中,2024-07-16,1021
2303,聯電,160,70,90,合庫-台中,2024-07-16,1021
8935,邦泰,88,0,88,合庫-台中,2024-07-16,1021
8105,凌巨,103,18,85,合庫-台中,2024-07-16,1021
4510,高鋒,80,1,79,合庫-台中,2024-07-16,1021
2891,中信金,80,1,79,合庫-台中,2024-07-16,1021
3481,群創,164,88,76,合庫-台中,2024-07-16,1021
2610,華航,98,24,74,合庫-台中,2024-07-16,1021
00929,復華台灣科技優息,190,120,70,合庫-台中,2024-07-16,1021
00905,FT臺灣Smart,70,0,70,合庫-台中,2024-07-16,1021
8011,台通,212,145,67,合庫-台中,2024-07-16,1021
00632R,元大台灣50反1,83,21,62,合庫-台中,2024-07-16,1021
6419,京晨科,62,1,61,合庫-台中,2024-07-16,1021
2881,富邦金,70,14,56,合庫-台中,2024-07-16,1021
2834,臺企銀,58,3,55,合庫-台中,2024-07-16,1021
00949,復華日本龍頭,53,0,53,合庫-台中,2024-07-16,1021
2317,鴻海,111,62,49,合庫-台中,2024-07-16,1021
6179,亞通,68,21,47,合庫-台中,2024-07-16,1021
1609,大亞,83,39,44,合庫-台中,2024-07-16,1021
2444,兆勁,42,0,42,合庫-台中,2024-07-16,1021
2312,金寶,120,80,40,合庫-台中,2024-07-16,1021
3545,敦泰,46,6,40,合庫-台中,2024-07-16,1021
2887,台新金,40,3,37,合庫-台中,2024-07-16,1021
00882,中信中國高股息,37,0,37,合庫-台中,2024-07-16,1021
2634,漢翔,42,6,36,合庫-台中,2024-07-16,1021
9945,潤泰新,66,30,36,合庫-台中,2024-07-16,1021
00725B,國泰投資級公司債,39,5,34,合庫-台中,2024-07-16,1021
3708,上緯投控,33,1,32,合庫-台中,2024-07-16,1021
00720B,元大投資級公司債,31,0,31,合庫-台中,2024-07-16,1021
2352,佳世達,34,5,29,合庫-台中,2024-07-16,1021
4109,加捷生醫,36,7,29,合庫-台中,2024-07-16,1021
2897,王道銀行,40,11,29,合庫-台中,2024-07-16,1021
3596,智易,31,4,27,合庫-台中,2024-07-16,1021
2371,大同,37,10,27,合庫-台中,2024-07-16,1021
2492,華新科,31,5,26,合庫-台中,2024-07-16,1021
1514,亞力,55,29,26,合庫-台中,2024-07-16,1021
3357,臺慶科,26,0,26,合庫-台中,2024-07-16,1021
6806,森崴能源,48,23,25,合庫-台中,2024-07-16,1021
6695,芯鼎,47,23,24,合庫-台中,2024-07-16,1021
2338,光罩,22,0,22,合庫-台中,2024-07-16,1021
2367,燿華,60,38,22,合庫-台中,2024-07-16,1021
00929,復華台灣科技優息,526,45,481,合庫-台中,2024-07-17,1021
00706L,期元大S＆P日圓正2,470,0,470,合庫-台中,2024-07-17,1021
2489,瑞軒,474,225,249,合庫-台中,2024-07-17,1021
00715L,期街口布蘭特正2,239,0,239,合庫-台中,2024-07-17,1021
2618,長榮航,241,22,219,合庫-台中,2024-07-17,1021
0056,元大高股息,190,12,178,合庫-台中,2024-07-17,1021
2801,彰銀,168,0,168,合庫-台中,2024-07-17,1021
2501,國建,177,18,159,合庫-台中,2024-07-17,1021
2543,皇昌,160,21,139,合庫-台中,2024-07-17,1021
00919,群益台灣精選高息,154,42,112,合庫-台中,2024-07-17,1021
3231,緯創,121,25,96,合庫-台中,2024-07-17,1021
00665L,富邦�琤肭磪囓�2,244,150,94,合庫-台中,2024-07-17,1021
3673,TPK-KY,148,56,92,合庫-台中,2024-07-17,1021
00933B,國泰10Y+金融債,84,0,84,合庫-台中,2024-07-17,1021
00936,台新永續高息中小,88,5,83,合庫-台中,2024-07-17,1021
00635U,期元大S＆P黃金,80,0,80,合庫-台中,2024-07-17,1021
9105,泰金寶-DR,90,11,79,合庫-台中,2024-07-17,1021
1608,華榮,101,25,76,合庫-台中,2024-07-17,1021
00927,群益半導體收益,70,0,70,合庫-台中,2024-07-17,1021
4903,聯光通,67,0,67,合庫-台中,2024-07-17,1021
4729,熒茂,100,34,66,合庫-台中,2024-07-17,1021
6117,迎廣,131,69,62,合庫-台中,2024-07-17,1021
00878,國泰永續高股息,63,5,58,合庫-台中,2024-07-17,1021
4566,時碩工業,100,42,58,合庫-台中,2024-07-17,1021
00753L,中信中國50正2,55,0,55,合庫-台中,2024-07-17,1021
2354,鴻準,67,14,53,合庫-台中,2024-07-17,1021
2330,台積電,78,25,53,合庫-台中,2024-07-17,1021
3706,神達,55,6,49,合庫-台中,2024-07-17,1021
00881,國泰台灣5G+,48,0,48,合庫-台中,2024-07-17,1021
2436,偉詮電,47,0,47,合庫-台中,2024-07-17,1021
2812,台中銀,56,10,46,合庫-台中,2024-07-17,1021
2303,聯電,227,183,44,合庫-台中,2024-07-17,1021
00948B,中信優息投資級債,41,0,41,合庫-台中,2024-07-17,1021
4406,新昕纖,41,0,41,合庫-台中,2024-07-17,1021
3615,安可,40,0,40,合庫-台中,2024-07-17,1021
2312,金寶,99,59,40,合庫-台中,2024-07-17,1021
6179,亞通,37,0,37,合庫-台中,2024-07-17,1021
2486,一詮,37,0,37,合庫-台中,2024-07-17,1021
00918,大華優利高填息30,98,61,37,合庫-台中,2024-07-17,1021
8105,凌巨,101,65,36,合庫-台中,2024-07-17,1021
2891,中信金,37,2,35,合庫-台中,2024-07-17,1021
2392,正崴,70,36,34,合庫-台中,2024-07-17,1021
2867,三商壽,98,65,33,合庫-台中,2024-07-17,1021
6419,京晨科,31,0,31,合庫-台中,2024-07-17,1021
00905,FT臺灣Smart,31,1,30,合庫-台中,2024-07-17,1021
00931B,統一美債20年,33,3,30,合庫-台中,2024-07-17,1021
1806,冠軍,56,26,30,合庫-台中,2024-07-17,1021
4513,福裕,33,3,30,合庫-台中,2024-07-17,1021
2356,英業達,51,22,29,合庫-台中,2024-07-17,1021
2408,南亞科,28,1,27,合庫-台中,2024-07-17,1021
4804,大略-KY,775,10,765,合庫-台中,2024-07-18,1021
1709,和益,510,5,505,合庫-台中,2024-07-18,1021
00929,復華台灣科技優息,535,115,420,合庫-台中,2024-07-18,1021
00937B,群益ESG投等債20,436,53,383,合庫-台中,2024-07-18,1021
3481,群創,534,312,222,合庫-台中,2024-07-18,1021
2313,華通,219,35,184,合庫-台中,2024-07-18,1021
0056,元大高股息,208,31,177,合庫-台中,2024-07-18,1021
00650L,復華香港正2,243,100,143,合庫-台中,2024-07-18,1021
00919,群益台灣精選高息,365,236,129,合庫-台中,2024-07-18,1021
2867,三商壽,162,34,128,合庫-台中,2024-07-18,1021
00878,國泰永續高股息,164,37,127,合庫-台中,2024-07-18,1021
00934,中信成長高股息,130,13,117,合庫-台中,2024-07-18,1021
00927,群益半導體收益,115,2,113,合庫-台中,2024-07-18,1021
2356,英業達,104,5,99,合庫-台中,2024-07-18,1021
2891,中信金,107,8,99,合庫-台中,2024-07-18,1021
2515,中工,100,9,91,合庫-台中,2024-07-18,1021
00881,國泰台灣5G+,119,31,88,合庫-台中,2024-07-18,1021
6770,力積電,87,8,79,合庫-台中,2024-07-18,1021
00946,群益科技高息成長,82,11,71,合庫-台中,2024-07-18,1021
1609,大亞,103,34,69,合庫-台中,2024-07-18,1021
2610,華航,71,5,66,合庫-台中,2024-07-18,1021
2382,廣達,72,7,65,合庫-台中,2024-07-18,1021
3049,精金,86,27,59,合庫-台中,2024-07-18,1021
2401,凌陽,76,19,57,合庫-台中,2024-07-18,1021
9105,泰金寶-DR,113,58,55,合庫-台中,2024-07-18,1021
00687B,國泰20年美債,79,26,53,合庫-台中,2024-07-18,1021
9945,潤泰新,59,6,53,合庫-台中,2024-07-18,1021
00936,台新永續高息中小,64,12,52,合庫-台中,2024-07-18,1021
2354,鴻準,69,18,51,合庫-台中,2024-07-18,1021
00676R,富邦臺灣加權反1,50,0,50,合庫-台中,2024-07-18,1021
00679B,元大美債20年,62,15,47,合庫-台中,2024-07-18,1021
00905,FT臺灣Smart,44,1,43,合庫-台中,2024-07-18,1021
2887,台新金,48,6,42,合庫-台中,2024-07-18,1021
2330,台積電,123,81,42,合庫-台中,2024-07-18,1021
6547,高端疫苗,42,3,39,合庫-台中,2024-07-18,1021
2317,鴻海,143,106,37,合庫-台中,2024-07-18,1021
1402,遠東新,36,0,36,合庫-台中,2024-07-18,1021
00891,中信關鍵半導體,44,7,37,合庫-台中,2024-07-18,1021
00858,永豐美國500大,36,0,36,合庫-台中,2024-07-18,1021
3231,緯創,53,19,34,合庫-台中,2024-07-18,1021
3624,光頡,31,0,31,合庫-台中,2024-07-18,1021
2537,聯上發,61,31,30,合庫-台中,2024-07-18,1021
6155,鈞寶,30,0,30,合庫-台中,2024-07-18,1021
3013,晟銘電,172,142,30,合庫-台中,2024-07-18,1021
00935,野村臺灣新科技50,34,4,30,合庫-台中,2024-07-18,1021
3276,宇環,29,0,29,合庫-台中,2024-07-18,1021
2328,廣宇,32,4,28,合庫-台中,2024-07-18,1021
2486,一詮,31,3,28,合庫-台中,2024-07-18,1021
2323,中環,29,2,27,合庫-台中,2024-07-18,1021
3163,波若威,101,75,26,合庫-台中,2024-07-18,1021
4804,大略-KY,357,0,357,合庫-台中,2024-07-19,1021
2913,農林,352,0,352,合庫-台中,2024-07-19,1021
00929,復華台灣科技優息,474,159,315,合庫-台中,2024-07-19,1021
2801,彰銀,307,6,301,合庫-台中,2024-07-19,1021
2888,新光金,407,114,293,合庫-台中,2024-07-19,1021
00919,群益台灣精選高息,380,103,277,合庫-台中,2024-07-19,1021
8105,凌巨,270,67,203,合庫-台中,2024-07-19,1021
2883,凱基金,223,39,184,合庫-台中,2024-07-19,1021
2891,中信金,150,6,144,合庫-台中,2024-07-19,1021
6116,彩晶,145,2,143,合庫-台中,2024-07-19,1021
2330,台積電,195,57,138,合庫-台中,2024-07-19,1021
2834,臺企銀,146,8,138,合庫-台中,2024-07-19,1021
0056,元大高股息,220,83,137,合庫-台中,2024-07-19,1021
00753L,中信中國50正2,112,0,112,合庫-台中,2024-07-19,1021
2867,三商壽,115,6,109,合庫-台中,2024-07-19,1021
00878,國泰永續高股息,121,19,102,合庫-台中,2024-07-19,1021
2882,國泰金,113,12,101,合庫-台中,2024-07-19,1021
00918,大華優利高填息30,109,13,96,合庫-台中,2024-07-19,1021
1301,台塑,99,14,85,合庫-台中,2024-07-19,1021
1314,中石化,85,0,85,合庫-台中,2024-07-19,1021
00650L,復華香港正2,264,180,84,合庫-台中,2024-07-19,1021
2634,漢翔,91,9,82,合庫-台中,2024-07-19,1021
3276,宇環,78,0,78,合庫-台中,2024-07-19,1021
00934,中信成長高股息,103,26,77,合庫-台中,2024-07-19,1021
6770,力積電,80,5,75,合庫-台中,2024-07-19,1021
2887,台新金,104,38,66,合庫-台中,2024-07-19,1021
1611,中電,167,101,66,合庫-台中,2024-07-19,1021
2365,昆盈,337,273,64,合庫-台中,2024-07-19,1021
1529,樂事綠能,94,34,60,合庫-台中,2024-07-19,1021
1785,光洋科,79,24,55,合庫-台中,2024-07-19,1021
2303,聯電,72,19,53,合庫-台中,2024-07-19,1021
00927,群益半導體收益,51,0,51,合庫-台中,2024-07-19,1021
2618,長榮航,55,4,51,合庫-台中,2024-07-19,1021
2356,英業達,60,10,50,合庫-台中,2024-07-19,1021
3380,明泰,84,34,50,合庫-台中,2024-07-19,1021
1713,國化,50,0,50,合庫-台中,2024-07-19,1021
1717,長興,50,0,50,合庫-台中,2024-07-19,1021
1539,巨庭,45,0,45,合庫-台中,2024-07-19,1021
3049,精金,48,6,42,合庫-台中,2024-07-19,1021
2903,遠百,42,0,42,合庫-台中,2024-07-19,1021
9907,統一實,42,0,42,合庫-台中,2024-07-19,1021
8463,潤泰材,40,0,40,合庫-台中,2024-07-19,1021
3013,晟銘電,119,79,40,合庫-台中,2024-07-19,1021
2317,鴻海,99,64,35,合庫-台中,2024-07-19,1021
2610,華航,40,5,35,合庫-台中,2024-07-19,1021
2409,友達,101,68,33,合庫-台中,2024-07-19,1021
2477,美隆電,33,0,33,合庫-台中,2024-07-19,1021
00937B,群益ESG投等債20,319,286,33,合庫-台中,2024-07-19,1021
2408,南亞科,35,3,32,合庫-台中,2024-07-19,1021
4763,材料-KY,33,1,32,合庫-台中,2024-07-19,1021
00929,復華台灣科技優息,811,383,428,合庫-台中,2024-07-22,1021
3481,群創,1093,683,410,合庫-台中,2024-07-22,1021
00919,群益台灣精選高息,475,177,298,合庫-台中,2024-07-22,1021
5512,力麒,267,37,230,合庫-台中,2024-07-22,1021
00664R,國泰臺灣加權反1,480,250,230,合庫-台中,2024-07-22,1021
0056,元大高股息,169,36,133,合庫-台中,2024-07-22,1021
8473,山林水,164,56,108,合庫-台中,2024-07-22,1021
2539,櫻花建,102,0,102,合庫-台中,2024-07-22,1021
00918,大華優利高填息30,136,48,88,合庫-台中,2024-07-22,1021
4566,時碩工業,100,21,79,合庫-台中,2024-07-22,1021
00715L,期街口布蘭特正2,77,0,77,合庫-台中,2024-07-22,1021
00946,群益科技高息成長,71,0,71,合庫-台中,2024-07-22,1021
6116,彩晶,73,2,71,合庫-台中,2024-07-22,1021
00927,群益半導體收益,74,4,70,合庫-台中,2024-07-22,1021
00676R,富邦臺灣加權反1,70,0,70,合庫-台中,2024-07-22,1021
2498,宏達電,90,23,67,合庫-台中,2024-07-22,1021
2409,友達,129,67,62,合庫-台中,2024-07-22,1021
3276,宇環,62,0,62,合庫-台中,2024-07-22,1021
2610,華航,82,20,62,合庫-台中,2024-07-22,1021
00881,國泰台灣5G+,72,15,57,合庫-台中,2024-07-22,1021
2801,彰銀,62,6,56,合庫-台中,2024-07-22,1021
2618,長榮航,83,29,54,合庫-台中,2024-07-22,1021
00680L,元大美債20正2,120,70,50,合庫-台中,2024-07-22,1021
3037,欣興,96,51,45,合庫-台中,2024-07-22,1021
00947,台新臺灣IC設計,51,8,43,合庫-台中,2024-07-22,1021
1584,精剛,42,0,42,合庫-台中,2024-07-22,1021
2303,聯電,100,60,40,合庫-台中,2024-07-22,1021
00830,國泰費城半導體,40,1,39,合庫-台中,2024-07-22,1021
00720B,元大投資級公司債,43,5,38,合庫-台中,2024-07-22,1021
4552,力達-KY,38,0,38,合庫-台中,2024-07-22,1021
1539,巨庭,37,0,37,合庫-台中,2024-07-22,1021
1312,國喬,37,1,36,合庫-台中,2024-07-22,1021
00712,復華富時不動產,44,9,35,合庫-台中,2024-07-22,1021
00940,元大台灣價值高息,486,452,34,合庫-台中,2024-07-22,1021
2515,中工,155,122,33,合庫-台中,2024-07-22,1021
4979,華星光,33,4,29,合庫-台中,2024-07-22,1021
2323,中環,33,4,29,合庫-台中,2024-07-22,1021
3189,景碩,56,28,28,合庫-台中,2024-07-22,1021
00751B,元大AAA至A公司債,28,0,28,合庫-台中,2024-07-22,1021
5351,鈺創,28,0,28,合庫-台中,2024-07-22,1021
4960,誠美材,42,15,27,合庫-台中,2024-07-22,1021
1605,華新,27,0,27,合庫-台中,2024-07-22,1021
2449,京元電子,34,8,26,合庫-台中,2024-07-22,1021
3597,映興,28,2,26,合庫-台中,2024-07-22,1021
1529,樂事綠能,46,20,26,合庫-台中,2024-07-22,1021
2356,英業達,53,28,25,合庫-台中,2024-07-22,1021
2885,元大金,30,5,25,合庫-台中,2024-07-22,1021
2344,華邦電,29,4,25,合庫-台中,2024-07-22,1021
2408,南亞科,26,2,24,合庫-台中,2024-07-22,1021
5876,上海商銀,24,0,24,合庫-台中,2024-07-22,1021
00937B,群益ESG投等債20,287,1,286,合庫-台中,2024-07-23,1021
00632R,元大台灣50反1,347,61,286,合庫-台中,2024-07-23,1021
00929,復華台灣科技優息,309,73,236,合庫-台中,2024-07-23,1021
3481,群創,952,765,187,合庫-台中,2024-07-23,1021
2609,陽明,171,24,147,合庫-台中,2024-07-23,1021
2317,鴻海,204,83,121,合庫-台中,2024-07-23,1021
2359,所羅門,161,65,96,合庫-台中,2024-07-23,1021
5512,力麒,128,36,92,合庫-台中,2024-07-23,1021
00919,群益台灣精選高息,125,36,89,合庫-台中,2024-07-23,1021
2409,友達,126,51,75,合庫-台中,2024-07-23,1021
2349,錸德,70,1,69,合庫-台中,2024-07-23,1021
2812,台中銀,94,40,54,合庫-台中,2024-07-23,1021
4960,誠美材,50,0,50,合庫-台中,2024-07-23,1021
1806,冠軍,54,4,50,合庫-台中,2024-07-23,1021
2408,南亞科,49,0,49,合庫-台中,2024-07-23,1021
2834,臺企銀,58,10,48,合庫-台中,2024-07-23,1021
0056,元大高股息,49,2,47,合庫-台中,2024-07-23,1021
00679B,元大美債20年,38,1,37,合庫-台中,2024-07-23,1021
00933B,國泰10Y+金融債,37,0,37,合庫-台中,2024-07-23,1021
3576,聯合再生,38,1,37,合庫-台中,2024-07-23,1021
00936,台新永續高息中小,35,0,35,合庫-台中,2024-07-23,1021
4804,大略-KY,34,0,34,合庫-台中,2024-07-23,1021
4109,加捷生醫,35,2,33,合庫-台中,2024-07-23,1021
1618,合機,33,0,33,合庫-台中,2024-07-23,1021
00858,永豐美國500大,32,0,32,合庫-台中,2024-07-23,1021
00878,國泰永續高股息,41,10,31,合庫-台中,2024-07-23,1021
00934,中信成長高股息,32,1,31,合庫-台中,2024-07-23,1021
00940,元大台灣價值高息,98,68,30,合庫-台中,2024-07-23,1021
3189,景碩,115,86,29,合庫-台中,2024-07-23,1021
8105,凌巨,60,33,27,合庫-台中,2024-07-23,1021
2344,華邦電,33,7,26,合庫-台中,2024-07-23,1021
00631L,元大台灣50正2,33,8,25,合庫-台中,2024-07-23,1021
00946,群益科技高息成長,25,0,25,合庫-台中,2024-07-23,1021
8033,雷虎,32,7,25,合庫-台中,2024-07-23,1021
00918,大華優利高填息30,23,0,23,合庫-台中,2024-07-23,1021
00930,永豐ESG低碳高息,23,0,23,合庫-台中,2024-07-23,1021
8085,福華,28,7,21,合庫-台中,2024-07-23,1021
3564,其陽,22,1,21,合庫-台中,2024-07-23,1021
6173,信昌電,21,0,21,合庫-台中,2024-07-23,1021
9105,泰金寶-DR,41,20,21,合庫-台中,2024-07-23,1021
2897,王道銀行,20,0,20,合庫-台中,2024-07-23,1021
2460,建通,20,0,20,合庫-台中,2024-07-23,1021
1608,華榮,29,11,18,合庫-台中,2024-07-23,1021
2891,中信金,25,8,17,合庫-台中,2024-07-23,1021
2867,三商壽,17,0,17,合庫-台中,2024-07-23,1021
8213,志超,20,4,16,合庫-台中,2024-07-23,1021
2603,長榮,29,13,16,合庫-台中,2024-07-23,1021
2883,凱基金,53,38,15,合庫-台中,2024-07-23,1021
3033,威健,25,10,15,合庫-台中,2024-07-23,1021
2330,台積電,35,21,14,合庫-台中,2024-07-23,1021
00937B,群益ESG投等債20,3526,265,3261,合庫-台中,2024-07-26,1021
00929,復華台灣科技優息,762,74,688,合庫-台中,2024-07-26,1021
8105,凌巨,514,98,416,合庫-台中,2024-07-26,1021
00940,元大台灣價值高息,352,67,285,合庫-台中,2024-07-26,1021
2834,臺企銀,270,1,269,合庫-台中,2024-07-26,1021
00919,群益台灣精選高息,308,64,244,合庫-台中,2024-07-26,1021
00946,群益科技高息成長,227,2,225,合庫-台中,2024-07-26,1021
00632R,元大台灣50反1,565,361,204,合庫-台中,2024-07-26,1021
00665L,富邦�琤肭磪囓�2,390,217,173,合庫-台中,2024-07-26,1021
00878,國泰永續高股息,197,27,170,合庫-台中,2024-07-26,1021
00753L,中信中國50正2,167,0,167,合庫-台中,2024-07-26,1021
00712,復華富時不動產,156,5,151,合庫-台中,2024-07-26,1021
0056,元大高股息,149,2,147,合庫-台中,2024-07-26,1021
00951,台新日本半導體,191,50,141,合庫-台中,2024-07-26,1021
2330,台積電,155,22,133,合庫-台中,2024-07-26,1021
2881,富邦金,117,1,116,合庫-台中,2024-07-26,1021
00918,大華優利高填息30,109,0,109,合庫-台中,2024-07-26,1021
00934,中信成長高股息,121,17,104,合庫-台中,2024-07-26,1021
1314,中石化,99,10,89,合庫-台中,2024-07-26,1021
2884,玉山金,123,35,88,合庫-台中,2024-07-26,1021
5443,均豪,129,41,88,合庫-台中,2024-07-26,1021
2408,南亞科,57,3,54,合庫-台中,2024-07-26,1021
0050,元大台灣50,54,1,53,合庫-台中,2024-07-26,1021
2851,中再保,53,0,53,合庫-台中,2024-07-26,1021
2409,友達,95,43,52,合庫-台中,2024-07-26,1021
00687B,國泰20年美債,68,17,51,合庫-台中,2024-07-26,1021
00715L,期街口布蘭特正2,62,12,50,合庫-台中,2024-07-26,1021
2498,宏達電,51,1,50,合庫-台中,2024-07-26,1021
6116,彩晶,53,3,50,合庫-台中,2024-07-26,1021
2344,華邦電,52,2,50,合庫-台中,2024-07-26,1021
4128,中天,60,11,49,合庫-台中,2024-07-26,1021
00941,中信上游半導體,48,0,48,合庫-台中,2024-07-26,1021
3711,日月光投控,48,2,46,合庫-台中,2024-07-26,1021
2349,錸德,72,27,45,合庫-台中,2024-07-26,1021
2382,廣達,49,5,44,合庫-台中,2024-07-26,1021
8926,台汽電,124,80,44,合庫-台中,2024-07-26,1021
2303,聯電,60,18,42,合庫-台中,2024-07-26,1021
00915,凱基優選高股息30,41,0,41,合庫-台中,2024-07-26,1021
00947,台新臺灣IC設計,45,5,40,合庫-台中,2024-07-26,1021
00733,富邦臺灣中小,40,0,40,合庫-台中,2024-07-26,1021
2486,一詮,61,22,39,合庫-台中,2024-07-26,1021
2888,新光金,186,147,39,合庫-台中,2024-07-26,1021
00939,統一台灣高息動能,37,2,35,合庫-台中,2024-07-26,1021
00882,中信中國高股息,34,0,34,合庫-台中,2024-07-26,1021
3056,富華新,33,0,33,合庫-台中,2024-07-26,1021
6016,康和證,32,0,32,合庫-台中,2024-07-26,1021
00936,台新永續高息中小,57,25,32,合庫-台中,2024-07-26,1021
2607,榮運,30,0,30,合庫-台中,2024-07-26,1021
2801,彰銀,39,10,29,合庫-台中,2024-07-26,1021
1312,國喬,30,1,29,合庫-台中,2024-07-26,1021
00632R,元大台灣50反1,1253,56,1197,合庫-台中,2024-07-29,1021
00679B,元大美債20年,626,15,611,合庫-台中,2024-07-29,1021
00929,復華台灣科技優息,433,62,371,合庫-台中,2024-07-29,1021
2881,富邦金,368,7,361,合庫-台中,2024-07-29,1021
2867,三商壽,421,63,358,合庫-台中,2024-07-29,1021
6219,富旺,286,7,279,合庫-台中,2024-07-29,1021
00878,國泰永續高股息,309,76,233,合庫-台中,2024-07-29,1021
00940,元大台灣價值高息,244,18,226,合庫-台中,2024-07-29,1021
00948B,中信優息投資級債,200,32,168,合庫-台中,2024-07-29,1021
3481,群創,649,490,159,合庫-台中,2024-07-29,1021
00919,群益台灣精選高息,207,61,146,合庫-台中,2024-07-29,1021
00937B,群益ESG投等債20,199,54,145,合庫-台中,2024-07-29,1021
00918,大華優利高填息30,142,0,142,合庫-台中,2024-07-29,1021
2367,燿華,288,168,120,合庫-台中,2024-07-29,1021
0056,元大高股息,125,17,108,合庫-台中,2024-07-29,1021
1609,大亞,128,36,92,合庫-台中,2024-07-29,1021
9105,泰金寶-DR,106,16,90,合庫-台中,2024-07-29,1021
2618,長榮航,111,27,84,合庫-台中,2024-07-29,1021
2363,矽統,104,21,83,合庫-台中,2024-07-29,1021
2356,英業達,98,16,82,合庫-台中,2024-07-29,1021
00715L,期街口布蘭特正2,76,1,75,合庫-台中,2024-07-29,1021
2888,新光金,115,42,73,合庫-台中,2024-07-29,1021
2884,玉山金,79,11,68,合庫-台中,2024-07-29,1021
8926,台汽電,74,7,67,合庫-台中,2024-07-29,1021
00915,凱基優選高股息30,62,0,62,合庫-台中,2024-07-29,1021
2303,聯電,66,10,56,合庫-台中,2024-07-29,1021
1540,喬福,75,19,56,合庫-台中,2024-07-29,1021
00946,群益科技高息成長,56,0,56,合庫-台中,2024-07-29,1021
3231,緯創,75,19,56,合庫-台中,2024-07-29,1021
2486,一詮,94,38,56,合庫-台中,2024-07-29,1021
3276,宇環,53,0,53,合庫-台中,2024-07-29,1021
2409,友達,72,24,48,合庫-台中,2024-07-29,1021
2388,威盛,46,2,44,合庫-台中,2024-07-29,1021
3163,波若威,97,54,43,合庫-台中,2024-07-29,1021
4720,德淵,43,0,43,合庫-台中,2024-07-29,1021
2504,國產,48,6,42,合庫-台中,2024-07-29,1021
6197,佳必琪,42,2,40,合庫-台中,2024-07-29,1021
3058,立德,40,0,40,合庫-台中,2024-07-29,1021
00637L,元大滬深300正2,96,60,36,合庫-台中,2024-07-29,1021
00936,台新永續高息中小,36,1,35,合庫-台中,2024-07-29,1021
6269,台郡,34,0,34,合庫-台中,2024-07-29,1021
2101,南港,34,3,31,合庫-台中,2024-07-29,1021
2603,長榮,37,6,31,合庫-台中,2024-07-29,1021
2312,金寶,49,18,31,合庫-台中,2024-07-29,1021
1402,遠東新,30,0,30,合庫-台中,2024-07-29,1021
3056,富華新,51,21,30,合庫-台中,2024-07-29,1021
6173,信昌電,35,5,30,合庫-台中,2024-07-29,1021
8054,安國,102,74,28,合庫-台中,2024-07-29,1021
00664R,國泰臺灣加權反1,28,0,28,合庫-台中,2024-07-29,1021
00939,統一台灣高息動能,28,2,26,合庫-台中,2024-07-29,1021
00632R,元大台灣50反1,1561,920,641,合庫-台中,2024-07-30,1021
2367,燿華,477,4,473,合庫-台中,2024-07-30,1021
00878,國泰永續高股息,317,53,264,合庫-台中,2024-07-30,1021
00929,復華台灣科技優息,377,123,254,合庫-台中,2024-07-30,1021
00948B,中信優息投資級債,211,33,178,合庫-台中,2024-07-30,1021
00940,元大台灣價值高息,198,21,177,合庫-台中,2024-07-30,1021
00937B,群益ESG投等債20,343,167,176,合庫-台中,2024-07-30,1021
00939,統一台灣高息動能,105,1,104,合庫-台中,2024-07-30,1021
0056,元大高股息,129,41,88,合庫-台中,2024-07-30,1021
2891,中信金,79,1,78,合庫-台中,2024-07-30,1021
2303,聯電,77,0,77,合庫-台中,2024-07-30,1021
2884,玉山金,72,5,67,合庫-台中,2024-07-30,1021
00642U,期元大S＆P石油,60,0,60,合庫-台中,2024-07-30,1021
00715L,期街口布蘭特正2,68,10,58,合庫-台中,2024-07-30,1021
00947,台新臺灣IC設計,57,2,55,合庫-台中,2024-07-30,1021
00918,大華優利高填息30,59,4,55,合庫-台中,2024-07-30,1021
00882,中信中國高股息,53,0,53,合庫-台中,2024-07-30,1021
2344,華邦電,176,124,52,合庫-台中,2024-07-30,1021
00919,群益台灣精選高息,91,40,51,合庫-台中,2024-07-30,1021
00946,群益科技高息成長,51,0,51,合庫-台中,2024-07-30,1021
00712,復華富時不動產,51,1,50,合庫-台中,2024-07-30,1021
2349,錸德,192,143,49,合庫-台中,2024-07-30,1021
2408,南亞科,47,1,46,合庫-台中,2024-07-30,1021
00637L,元大滬深300正2,244,204,40,合庫-台中,2024-07-30,1021
1806,冠軍,56,17,39,合庫-台中,2024-07-30,1021
2883,凱基金,37,1,36,合庫-台中,2024-07-30,1021
2409,友達,41,6,35,合庫-台中,2024-07-30,1021
2365,昆盈,121,90,31,合庫-台中,2024-07-30,1021
00679B,元大美債20年,51,21,30,合庫-台中,2024-07-30,1021
2337,旺宏,35,7,28,合庫-台中,2024-07-30,1021
6133,金橋,28,0,28,合庫-台中,2024-07-30,1021
3037,欣興,85,58,27,合庫-台中,2024-07-30,1021
00941,中信上游半導體,31,4,27,合庫-台中,2024-07-30,1021
2801,彰銀,26,0,26,合庫-台中,2024-07-30,1021
00951,台新日本半導體,76,50,26,合庫-台中,2024-07-30,1021
2353,宏��,31,6,25,合庫-台中,2024-07-30,1021
3024,憶聲,23,1,22,合庫-台中,2024-07-30,1021
00795B,中信美國公債20年,21,0,21,合庫-台中,2024-07-30,1021
2406,國碩,26,5,21,合庫-台中,2024-07-30,1021
2328,廣宇,21,0,21,合庫-台中,2024-07-30,1021
5864,致和證,20,0,20,合庫-台中,2024-07-30,1021
00664R,國泰臺灣加權反1,20,0,20,合庫-台中,2024-07-30,1021
3257,虹冠電,20,0,20,合庫-台中,2024-07-30,1021
3363,上詮,20,0,20,合庫-台中,2024-07-30,1021
9136,巨騰-DR,19,0,19,合庫-台中,2024-07-30,1021
1301,台塑,20,1,19,合庫-台中,2024-07-30,1021
1810,和成,20,2,18,合庫-台中,2024-07-30,1021
6177,達麗,34,16,18,合庫-台中,2024-07-30,1021
3047,訊舟,64,46,18,合庫-台中,2024-07-30,1021
00934,中信成長高股息,48,31,17,合庫-台中,2024-07-30,1021
2317,鴻海,224,59,165,合庫-台中,2024-07-31,1021
3481,群創,1150,996,154,合庫-台中,2024-07-31,1021
00937B,群益ESG投等債20,143,9,134,合庫-台中,2024-07-31,1021
2349,錸德,369,248,121,合庫-台中,2024-07-31,1021
00929,復華台灣科技優息,195,93,102,合庫-台中,2024-07-31,1021
3523,迎輝,85,0,85,合庫-台中,2024-07-31,1021
00687B,國泰20年美債,95,25,70,合庫-台中,2024-07-31,1021
6187,萬潤,81,15,66,合庫-台中,2024-07-31,1021
00715L,期街口布蘭特正2,84,25,59,合庫-台中,2024-07-31,1021
2884,玉山金,56,0,56,合庫-台中,2024-07-31,1021
2409,友達,59,3,56,合庫-台中,2024-07-31,1021
00946,群益科技高息成長,56,0,56,合庫-台中,2024-07-31,1021
2313,華通,57,6,51,合庫-台中,2024-07-31,1021
2002,中鋼,62,11,51,合庫-台中,2024-07-31,1021
00679B,元大美債20年,53,3,50,合庫-台中,2024-07-31,1021
3663,鑫科,106,57,49,合庫-台中,2024-07-31,1021
00919,群益台灣精選高息,77,31,46,合庫-台中,2024-07-31,1021
9105,泰金寶-DR,60,20,40,合庫-台中,2024-07-31,1021
6128,上福,32,0,32,合庫-台中,2024-07-31,1021
4564,元翎,38,9,29,合庫-台中,2024-07-31,1021
2611,志信,32,4,28,合庫-台中,2024-07-31,1021
3339,泰谷,28,0,28,合庫-台中,2024-07-31,1021
3715,定穎投控,75,48,27,合庫-台中,2024-07-31,1021
8028,昇陽半導體,64,37,27,合庫-台中,2024-07-31,1021
2609,陽明,78,52,26,合庫-台中,2024-07-31,1021
2365,昆盈,151,127,24,合庫-台中,2024-07-31,1021
3037,欣興,162,139,23,合庫-台中,2024-07-31,1021
4526,東台,40,17,23,合庫-台中,2024-07-31,1021
0056,元大高股息,34,12,22,合庫-台中,2024-07-31,1021
3047,訊舟,81,60,21,合庫-台中,2024-07-31,1021
4562,穎漢,21,1,20,合庫-台中,2024-07-31,1021
2362,藍天,30,10,20,合庫-台中,2024-07-31,1021
00664R,國泰臺灣加權反1,50,30,20,合庫-台中,2024-07-31,1021
3105,穩懋,51,32,19,合庫-台中,2024-07-31,1021
4960,誠美材,21,2,19,合庫-台中,2024-07-31,1021
3706,神達,27,8,19,合庫-台中,2024-07-31,1021
2634,漢翔,18,0,18,合庫-台中,2024-07-31,1021
00878,國泰永續高股息,41,23,18,合庫-台中,2024-07-31,1021
6112,邁達特,16,0,16,合庫-台中,2024-07-31,1021
2408,南亞科,18,2,16,合庫-台中,2024-07-31,1021
2486,一詮,51,36,15,合庫-台中,2024-07-31,1021
2301,光寶科,17,1,16,合庫-台中,2024-07-31,1021
9945,潤泰新,31,17,14,合庫-台中,2024-07-31,1021
8358,金居,16,2,14,合庫-台中,2024-07-31,1021
2618,長榮航,25,12,13,合庫-台中,2024-07-31,1021
00934,中信成長高股息,28,15,13,合庫-台中,2024-07-31,1021
3293,鈊象,13,0,13,合庫-台中,2024-07-31,1021
2382,廣達,25,13,12,合庫-台中,2024-07-31,1021
2867,三商壽,23,12,11,合庫-台中,2024-07-31,1021
3163,波若威,33,22,11,合庫-台中,2024-07-31,1021
00937B,群益ESG投等債20,1096,138,958,合庫-台中,2024-08-01,1021
2317,鴻海,647,43,604,合庫-台中,2024-08-01,1021
00715L,期街口布蘭特正2,560,86,474,合庫-台中,2024-08-01,1021
3481,群創,550,263,287,合庫-台中,2024-08-01,1021
2323,中環,204,10,194,合庫-台中,2024-08-01,1021
00878,國泰永續高股息,161,18,143,合庫-台中,2024-08-01,1021
2349,錸德,294,158,136,合庫-台中,2024-08-01,1021
00679B,元大美債20年,142,50,92,合庫-台中,2024-08-01,1021
2867,三商壽,97,6,91,合庫-台中,2024-08-01,1021
9945,潤泰新,122,40,82,合庫-台中,2024-08-01,1021
3047,訊舟,130,58,72,合庫-台中,2024-08-01,1021
00949,復華日本龍頭,58,0,58,合庫-台中,2024-08-01,1021
00939,統一台灣高息動能,59,3,56,合庫-台中,2024-08-01,1021
00665L,富邦�琤肭磪囓�2,274,219,55,合庫-台中,2024-08-01,1021
5443,均豪,120,68,52,合庫-台中,2024-08-01,1021
6770,力積電,48,7,41,合庫-台中,2024-08-01,1021
2845,遠東銀,41,1,40,合庫-台中,2024-08-01,1021
2337,旺宏,372,333,39,合庫-台中,2024-08-01,1021
3663,鑫科,79,41,38,合庫-台中,2024-08-01,1021
2542,興富發,49,11,38,合庫-台中,2024-08-01,1021
1316,上曜,51,15,36,合庫-台中,2024-08-01,1021
00881,國泰台灣5G+,53,19,34,合庫-台中,2024-08-01,1021
00751B,元大AAA至A公司債,33,0,33,合庫-台中,2024-08-01,1021
00637L,元大滬深300正2,153,120,33,合庫-台中,2024-08-01,1021
2489,瑞軒,45,13,32,合庫-台中,2024-08-01,1021
3535,晶彩科,46,16,30,合庫-台中,2024-08-01,1021
00934,中信成長高股息,33,5,28,合庫-台中,2024-08-01,1021
6834,天二科技,25,0,25,合庫-台中,2024-08-01,1021
2454,聯發科,26,1,25,合庫-台中,2024-08-01,1021
3189,景碩,83,60,23,合庫-台中,2024-08-01,1021
9938,百和,23,0,23,合庫-台中,2024-08-01,1021
9955,佳龍,23,0,23,合庫-台中,2024-08-01,1021
1711,永光,33,11,22,合庫-台中,2024-08-01,1021
3339,泰谷,22,0,22,合庫-台中,2024-08-01,1021
00946,群益科技高息成長,22,0,22,合庫-台中,2024-08-01,1021
1528,恩德,26,4,22,合庫-台中,2024-08-01,1021
5876,上海商銀,21,0,21,合庫-台中,2024-08-01,1021
9904,寶成,42,22,20,合庫-台中,2024-08-01,1021
1305,華夏,25,5,20,合庫-台中,2024-08-01,1021
00770,國泰北美科技,20,0,20,合庫-台中,2024-08-01,1021
6016,康和證,20,0,20,合庫-台中,2024-08-01,1021
4406,新昕纖,20,0,20,合庫-台中,2024-08-01,1021
2427,三商電,20,0,20,合庫-台中,2024-08-01,1021
1216,統一,19,0,19,合庫-台中,2024-08-01,1021
00933B,國泰10Y+金融債,33,14,19,合庫-台中,2024-08-01,1021
9935,慶豐富,20,1,19,合庫-台中,2024-08-01,1021
8936,國統,20,2,18,合庫-台中,2024-08-01,1021
2460,建通,17,0,17,合庫-台中,2024-08-01,1021
8028,昇陽半導體,21,4,17,合庫-台中,2024-08-01,1021
2405,輔信,18,2,16,合庫-台中,2024-08-01,1021
00929,復華台灣科技優息,681,71,610,合庫-台中,2024-08-02,1021
00878,國泰永續高股息,581,7,574,合庫-台中,2024-08-02,1021
00937B,群益ESG投等債20,562,82,480,合庫-台中,2024-08-02,1021
00885,富邦越南,312,0,312,合庫-台中,2024-08-02,1021
2883,凱基金,296,5,291,合庫-台中,2024-08-02,1021
00940,元大台灣價值高息,285,1,284,合庫-台中,2024-08-02,1021
00632R,元大台灣50反1,445,195,250,合庫-台中,2024-08-02,1021
00919,群益台灣精選高息,326,103,223,合庫-台中,2024-08-02,1021
00679B,元大美債20年,224,53,171,合庫-台中,2024-08-02,1021
00918,大華優利高填息30,171,2,169,合庫-台中,2024-08-02,1021
0056,元大高股息,152,5,147,合庫-台中,2024-08-02,1021
00665L,富邦�琤肭磪囓�2,300,156,144,合庫-台中,2024-08-02,1021
00927,群益半導體收益,139,2,137,合庫-台中,2024-08-02,1021
2515,中工,142,8,134,合庫-台中,2024-08-02,1021
2330,台積電,181,49,132,合庫-台中,2024-08-02,1021
00923,群益台ESG低碳50,130,1,129,合庫-台中,2024-08-02,1021
00881,國泰台灣5G+,126,1,125,合庫-台中,2024-08-02,1021
3481,群創,296,179,117,合庫-台中,2024-08-02,1021
00753L,中信中國50正2,114,0,114,合庫-台中,2024-08-02,1021
00948B,中信優息投資級債,119,6,113,合庫-台中,2024-08-02,1021
2801,彰銀,137,30,107,合庫-台中,2024-08-02,1021
00903,富邦元宇宙,101,0,101,合庫-台中,2024-08-02,1021
8105,凌巨,100,3,97,合庫-台中,2024-08-02,1021
00687B,國泰20年美債,134,41,93,合庫-台中,2024-08-02,1021
00934,中信成長高股息,95,5,90,合庫-台中,2024-08-02,1021
5443,均豪,119,32,87,合庫-台中,2024-08-02,1021
00946,群益科技高息成長,88,2,86,合庫-台中,2024-08-02,1021
9945,潤泰新,116,36,80,合庫-台中,2024-08-02,1021
2408,南亞科,80,4,76,合庫-台中,2024-08-02,1021
2891,中信金,87,14,73,合庫-台中,2024-08-02,1021
4907,富宇,72,0,72,合庫-台中,2024-08-02,1021
00951,台新日本半導體,68,0,68,合庫-台中,2024-08-02,1021
3037,欣興,207,145,62,合庫-台中,2024-08-02,1021
2382,廣達,73,11,62,合庫-台中,2024-08-02,1021
00650L,復華香港正2,239,178,61,合庫-台中,2024-08-02,1021
5880,合庫金,76,16,60,合庫-台中,2024-08-02,1021
00933B,國泰10Y+金融債,77,17,60,合庫-台中,2024-08-02,1021
2634,漢翔,71,14,57,合庫-台中,2024-08-02,1021
2337,旺宏,88,31,57,合庫-台中,2024-08-02,1021
2002,中鋼,68,12,56,合庫-台中,2024-08-02,1021
00947,台新臺灣IC設計,62,6,56,合庫-台中,2024-08-02,1021
00941,中信上游半導體,53,0,53,合庫-台中,2024-08-02,1021
2501,國建,88,36,52,合庫-台中,2024-08-02,1021
3056,富華新,62,11,51,合庫-台中,2024-08-02,1021
00936,台新永續高息中小,56,7,49,合庫-台中,2024-08-02,1021
00915,凱基優選高股息30,49,0,49,合庫-台中,2024-08-02,1021
0050,元大台灣50,51,2,49,合庫-台中,2024-08-02,1021
2884,玉山金,49,1,48,合庫-台中,2024-08-02,1021
00900,富邦特選高股息30,46,0,46,合庫-台中,2024-08-02,1021
2365,昆盈,248,204,44,合庫-台中,2024-08-02,1021
00940,元大台灣價值高息,1133,74,1059,合庫-台中,2024-08-05,1021
00929,復華台灣科技優息,1204,479,725,合庫-台中,2024-08-05,1021
2834,臺企銀,652,101,551,合庫-台中,2024-08-05,1021
00878,國泰永續高股息,540,52,488,合庫-台中,2024-08-05,1021
00706L,期元大S＆P日圓正2,450,110,340,合庫-台中,2024-08-05,1021
00679B,元大美債20年,480,161,319,合庫-台中,2024-08-05,1021
00936,台新永續高息中小,286,50,236,合庫-台中,2024-08-05,1021
2409,友達,258,32,226,合庫-台中,2024-08-05,1021
00688L,國泰20年美債正2,259,40,219,合庫-台中,2024-08-05,1021
0056,元大高股息,260,50,210,合庫-台中,2024-08-05,1021
00942B,台新美A公司債20+,205,6,199,合庫-台中,2024-08-05,1021
1540,喬福,405,211,194,合庫-台中,2024-08-05,1021
2515,中工,206,13,193,合庫-台中,2024-08-05,1021
2883,凱基金,191,14,177,合庫-台中,2024-08-05,1021
2317,鴻海,296,144,152,合庫-台中,2024-08-05,1021
2539,櫻花建,146,3,143,合庫-台中,2024-08-05,1021
2349,錸德,159,17,142,合庫-台中,2024-08-05,1021
3481,群創,555,421,134,合庫-台中,2024-08-05,1021
00715L,期街口布蘭特正2,233,100,133,合庫-台中,2024-08-05,1021
6116,彩晶,128,0,128,合庫-台中,2024-08-05,1021
2801,彰銀,128,3,125,合庫-台中,2024-08-05,1021
00881,國泰台灣5G+,134,15,119,合庫-台中,2024-08-05,1021
00830,國泰費城半導體,139,26,113,合庫-台中,2024-08-05,1021
2002,中鋼,121,17,104,合庫-台中,2024-08-05,1021
00900,富邦特選高股息30,159,60,99,合庫-台中,2024-08-05,1021
4406,新昕纖,95,0,95,合庫-台中,2024-08-05,1021
2330,台積電,200,106,94,合庫-台中,2024-08-05,1021
00937B,群益ESG投等債20,559,467,92,合庫-台中,2024-08-05,1021
00918,大華優利高填息30,116,29,87,合庫-台中,2024-08-05,1021
2367,燿華,89,3,86,合庫-台中,2024-08-05,1021
3056,富華新,89,4,85,合庫-台中,2024-08-05,1021
00642U,期元大S＆P石油,82,0,82,合庫-台中,2024-08-05,1021
5484,慧友,82,0,82,合庫-台中,2024-08-05,1021
2881,富邦金,97,20,77,合庫-台中,2024-08-05,1021
00934,中信成長高股息,81,5,76,合庫-台中,2024-08-05,1021
00712,復華富時不動產,148,74,74,合庫-台中,2024-08-05,1021
5880,合庫金,180,111,69,合庫-台中,2024-08-05,1021
1314,中石化,102,34,68,合庫-台中,2024-08-05,1021
00947,台新臺灣IC設計,71,6,65,合庫-台中,2024-08-05,1021
2634,漢翔,167,102,65,合庫-台中,2024-08-05,1021
00951,台新日本半導體,115,51,64,合庫-台中,2024-08-05,1021
2382,廣達,77,15,62,合庫-台中,2024-08-05,1021
006208,富邦台50,66,4,62,合庫-台中,2024-08-05,1021
3523,迎輝,60,0,60,合庫-台中,2024-08-05,1021
00945B,凱基美國非投等債,59,0,59,合庫-台中,2024-08-05,1021
3663,鑫科,73,16,57,合庫-台中,2024-08-05,1021
2882,國泰金,110,54,56,合庫-台中,2024-08-05,1021
1808,潤隆,59,5,54,合庫-台中,2024-08-05,1021
2610,華航,98,45,53,合庫-台中,2024-08-05,1021
2812,台中銀,74,22,52,合庫-台中,2024-08-05,1021
00632R,元大台灣50反1,4647,2167,2480,合庫-台中,2024-08-06,1021
2409,友達,621,211,410,合庫-台中,2024-08-06,1021
00676R,富邦臺灣加權反1,699,299,400,合庫-台中,2024-08-06,1021
00940,元大台灣價值高息,348,40,308,合庫-台中,2024-08-06,1021
00929,復華台灣科技優息,758,476,282,合庫-台中,2024-08-06,1021
2867,三商壽,248,10,238,合庫-台中,2024-08-06,1021
2883,凱基金,150,13,137,合庫-台中,2024-08-06,1021
5481,新華,145,23,122,合庫-台中,2024-08-06,1021
2317,鴻海,299,200,99,合庫-台中,2024-08-06,1021
3523,迎輝,98,0,98,合庫-台中,2024-08-06,1021
2887,台新金,89,3,86,合庫-台中,2024-08-06,1021
00878,國泰永續高股息,198,124,74,合庫-台中,2024-08-06,1021
2002,中鋼,88,14,74,合庫-台中,2024-08-06,1021
2851,中再保,72,1,71,合庫-台中,2024-08-06,1021
2539,櫻花建,73,10,63,合庫-台中,2024-08-06,1021
3056,富華新,72,17,55,合庫-台中,2024-08-06,1021
6770,力積電,78,26,52,合庫-台中,2024-08-06,1021
3013,晟銘電,113,65,48,合庫-台中,2024-08-06,1021
5443,均豪,122,78,44,合庫-台中,2024-08-06,1021
00900,富邦特選高股息30,57,14,43,合庫-台中,2024-08-06,1021
2070,精湛,66,23,43,合庫-台中,2024-08-06,1021
2834,臺企銀,63,20,43,合庫-台中,2024-08-06,1021
4123,晟德,46,8,38,合庫-台中,2024-08-06,1021
3163,波若威,40,5,35,合庫-台中,2024-08-06,1021
2106,建大,34,0,34,合庫-台中,2024-08-06,1021
2636,台驊控股,34,0,34,合庫-台中,2024-08-06,1021
00885,富邦越南,33,0,33,合庫-台中,2024-08-06,1021
00918,大華優利高填息30,46,15,31,合庫-台中,2024-08-06,1021
2888,新光金,45,14,31,合庫-台中,2024-08-06,1021
4916,事欣科,28,0,28,合庫-台中,2024-08-06,1021
1711,永光,31,3,28,合庫-台中,2024-08-06,1021
00665L,富邦�琤肭磪囓�2,161,134,27,合庫-台中,2024-08-06,1021
00713,元大台灣高息低波,35,9,26,合庫-台中,2024-08-06,1021
5511,德昌,25,0,25,合庫-台中,2024-08-06,1021
6834,天二科技,25,0,25,合庫-台中,2024-08-06,1021
2388,威盛,26,1,25,合庫-台中,2024-08-06,1021
4111,濟生,28,5,23,合庫-台中,2024-08-06,1021
9958,世紀鋼,30,8,22,合庫-台中,2024-08-06,1021
2349,錸德,106,84,22,合庫-台中,2024-08-06,1021
3037,欣興,48,26,22,合庫-台中,2024-08-06,1021
6125,廣運,23,2,21,合庫-台中,2024-08-06,1021
00706L,期元大S＆P日圓正2,21,0,21,合庫-台中,2024-08-06,1021
2483,百容,21,0,21,合庫-台中,2024-08-06,1021
1338,廣華-KY,21,0,21,合庫-台中,2024-08-06,1021
2618,長榮航,31,11,20,合庫-台中,2024-08-06,1021
2356,英業達,31,11,20,合庫-台中,2024-08-06,1021
1799,易威,20,0,20,合庫-台中,2024-08-06,1021
00922,國泰台灣領袖50,25,5,20,合庫-台中,2024-08-06,1021
00933B,國泰10Y+金融債,23,3,20,合庫-台中,2024-08-06,1021
1402,遠東新,20,0,20,合庫-台中,2024-08-06,1021
00632R,元大台灣50反1,2501,1123,1378,合庫-台中,2024-08-07,1021
00929,復華台灣科技優息,604,171,433,合庫-台中,2024-08-07,1021
5481,新華,451,56,395,合庫-台中,2024-08-07,1021
00940,元大台灣價值高息,316,43,273,合庫-台中,2024-08-07,1021
00878,國泰永續高股息,285,19,266,合庫-台中,2024-08-07,1021
00679B,元大美債20年,255,56,199,合庫-台中,2024-08-07,1021
00937B,群益ESG投等債20,222,34,188,合庫-台中,2024-08-07,1021
00919,群益台灣精選高息,192,30,162,合庫-台中,2024-08-07,1021
2317,鴻海,284,169,115,合庫-台中,2024-08-07,1021
0056,元大高股息,195,85,110,合庫-台中,2024-08-07,1021
00939,統一台灣高息動能,90,0,90,合庫-台中,2024-08-07,1021
00680L,元大美債20正2,116,30,86,合庫-台中,2024-08-07,1021
00715L,期街口布蘭特正2,83,0,83,合庫-台中,2024-08-07,1021
00918,大華優利高填息30,78,5,73,合庫-台中,2024-08-07,1021
2409,友達,107,40,67,合庫-台中,2024-08-07,1021
00948B,中信優息投資級債,71,16,55,合庫-台中,2024-08-07,1021
00642U,期元大S＆P石油,51,0,51,合庫-台中,2024-08-07,1021
2884,玉山金,49,0,49,合庫-台中,2024-08-07,1021
00795B,中信美國公債20年,45,0,45,合庫-台中,2024-08-07,1021
3663,鑫科,58,13,45,合庫-台中,2024-08-07,1021
00665L,富邦�琤肭磪囓�2,238,197,41,合庫-台中,2024-08-07,1021
2408,南亞科,40,3,37,合庫-台中,2024-08-07,1021
2382,廣達,61,27,34,合庫-台中,2024-08-07,1021
3024,憶聲,33,0,33,合庫-台中,2024-08-07,1021
2887,台新金,40,8,32,合庫-台中,2024-08-07,1021
1449,佳和,32,1,31,合庫-台中,2024-08-07,1021
6213,聯茂,45,15,30,合庫-台中,2024-08-07,1021
3374,精材,36,8,28,合庫-台中,2024-08-07,1021
00830,國泰費城半導體,27,0,27,合庫-台中,2024-08-07,1021
00946,群益科技高息成長,47,20,27,合庫-台中,2024-08-07,1021
00922,國泰台灣領袖50,27,0,27,合庫-台中,2024-08-07,1021
3523,迎輝,26,0,26,合庫-台中,2024-08-07,1021
00688L,國泰20年美債正2,62,36,26,合庫-台中,2024-08-07,1021
4729,熒茂,25,0,25,合庫-台中,2024-08-07,1021
00690,兆豐藍籌30,25,0,25,合庫-台中,2024-08-07,1021
9955,佳龍,31,6,25,合庫-台中,2024-08-07,1021
006208,富邦台50,34,10,24,合庫-台中,2024-08-07,1021
2405,輔信,25,1,24,合庫-台中,2024-08-07,1021
1529,樂事綠能,30,6,24,合庫-台中,2024-08-07,1021
2883,凱基金,29,5,24,合庫-台中,2024-08-07,1021
00713,元大台灣高息低波,25,2,23,合庫-台中,2024-08-07,1021
00947,台新臺灣IC設計,23,0,23,合庫-台中,2024-08-07,1021
6834,天二科技,23,0,23,合庫-台中,2024-08-07,1021
3013,晟銘電,80,57,23,合庫-台中,2024-08-07,1021
8054,安國,103,82,21,合庫-台中,2024-08-07,1021
1338,廣華-KY,20,0,20,合庫-台中,2024-08-07,1021
2601,益航,20,0,20,合庫-台中,2024-08-07,1021
5465,富驊,20,0,20,合庫-台中,2024-08-07,1021
00720B,元大投資級公司債,20,1,19,合庫-台中,2024-08-07,1021
2851,中再保,19,0,19,合庫-台中,2024-08-07,1021
00937B,群益ESG投等債20,465,18,447,合庫-台中,2024-08-08,1021
00679B,元大美債20年,397,30,367,合庫-台中,2024-08-08,1021
00932,兆豐永續高息等權,343,2,341,合庫-台中,2024-08-08,1021
2886,兆豐金,332,1,331,合庫-台中,2024-08-08,1021
2892,第一金,180,1,179,合庫-台中,2024-08-08,1021
2834,臺企銀,164,0,164,合庫-台中,2024-08-08,1021
2867,三商壽,184,30,154,合庫-台中,2024-08-08,1021
3523,迎輝,124,0,124,合庫-台中,2024-08-08,1021
00878,國泰永續高股息,120,15,105,合庫-台中,2024-08-08,1021
0056,元大高股息,113,10,103,合庫-台中,2024-08-08,1021
00680L,元大美債20正2,113,12,101,合庫-台中,2024-08-08,1021
00929,復華台灣科技優息,280,193,87,合庫-台中,2024-08-08,1021
00919,群益台灣精選高息,123,39,84,合庫-台中,2024-08-08,1021
3481,群創,114,31,83,合庫-台中,2024-08-08,1021
00712,復華富時不動產,84,12,72,合庫-台中,2024-08-08,1021
2615,萬海,93,21,72,合庫-台中,2024-08-08,1021
2317,鴻海,200,129,71,合庫-台中,2024-08-08,1021
3715,定穎投控,89,21,68,合庫-台中,2024-08-08,1021
2376,技嘉,74,14,60,合庫-台中,2024-08-08,1021
00946,群益科技高息成長,64,5,59,合庫-台中,2024-08-08,1021
00772B,中信高評級公司債,61,2,59,合庫-台中,2024-08-08,1021
00881,國泰台灣5G+,63,25,38,合庫-台中,2024-08-08,1021
6116,彩晶,40,3,37,合庫-台中,2024-08-08,1021
2382,廣達,53,17,36,合庫-台中,2024-08-08,1021
00923,群益台ESG低碳50,37,1,36,合庫-台中,2024-08-08,1021
00948B,中信優息投資級債,36,0,36,合庫-台中,2024-08-08,1021
3024,憶聲,39,3,36,合庫-台中,2024-08-08,1021
00927,群益半導體收益,33,0,33,合庫-台中,2024-08-08,1021
3673,TPK-KY,31,0,31,合庫-台中,2024-08-08,1021
4763,材料-KY,35,6,29,合庫-台中,2024-08-08,1021
2344,華邦電,30,1,29,合庫-台中,2024-08-08,1021
00936,台新永續高息中小,32,3,29,合庫-台中,2024-08-08,1021
00713,元大台灣高息低波,29,1,28,合庫-台中,2024-08-08,1021
1714,和桐,28,0,28,合庫-台中,2024-08-08,1021
00830,國泰費城半導體,28,0,28,合庫-台中,2024-08-08,1021
1514,亞力,30,2,28,合庫-台中,2024-08-08,1021
2489,瑞軒,44,18,26,合庫-台中,2024-08-08,1021
8028,昇陽半導體,33,8,25,合庫-台中,2024-08-08,1021
5011,久陽,25,0,25,合庫-台中,2024-08-08,1021
3047,訊舟,97,72,25,合庫-台中,2024-08-08,1021
2601,益航,24,0,24,合庫-台中,2024-08-08,1021
00949,復華日本龍頭,23,0,23,合庫-台中,2024-08-08,1021
4532,瑞智,22,0,22,合庫-台中,2024-08-08,1021
2356,英業達,64,42,22,合庫-台中,2024-08-08,1021
2610,華航,32,10,22,合庫-台中,2024-08-08,1021
1303,南亞,24,3,21,合庫-台中,2024-08-08,1021
3189,景碩,53,32,21,合庫-台中,2024-08-08,1021
2338,光罩,28,7,21,合庫-台中,2024-08-08,1021
2368,金像電,36,15,21,合庫-台中,2024-08-08,1021
2444,兆勁,20,0,20,合庫-台中,2024-08-08,1021
00937B,群益ESG投等債20,781,260,521,合庫-台中,2024-08-09,1021
2609,陽明,196,65,131,合庫-台中,2024-08-09,1021
6239,力成,106,3,103,合庫-台中,2024-08-09,1021
00706L,期元大S＆P日圓正2,101,1,100,合庫-台中,2024-08-09,1021
2867,三商壽,100,5,95,合庫-台中,2024-08-09,1021
00680L,元大美債20正2,145,53,92,合庫-台中,2024-08-09,1021
00948B,中信優息投資級債,96,8,88,合庫-台中,2024-08-09,1021
00951,台新日本半導體,82,0,82,合庫-台中,2024-08-09,1021
00687B,國泰20年美債,213,136,77,合庫-台中,2024-08-09,1021
2489,瑞軒,115,38,77,合庫-台中,2024-08-09,1021
00688L,國泰20年美債正2,87,14,73,合庫-台中,2024-08-09,1021
2349,錸德,124,61,63,合庫-台中,2024-08-09,1021
2887,台新金,60,9,51,合庫-台中,2024-08-09,1021
3231,緯創,90,41,49,合庫-台中,2024-08-09,1021
2886,兆豐金,62,19,43,合庫-台中,2024-08-09,1021
0056,元大高股息,51,10,41,合庫-台中,2024-08-09,1021
00939,統一台灣高息動能,51,14,37,合庫-台中,2024-08-09,1021
2834,臺企銀,39,4,35,合庫-台中,2024-08-09,1021
1316,上曜,44,9,35,合庫-台中,2024-08-09,1021
8096,擎亞,55,22,33,合庫-台中,2024-08-09,1021
1506,正道,30,0,30,合庫-台中,2024-08-09,1021
4562,穎漢,95,66,29,合庫-台中,2024-08-09,1021
3576,聯合再生,29,0,29,合庫-台中,2024-08-09,1021
6285,啟��,29,1,28,合庫-台中,2024-08-09,1021
2317,鴻海,198,169,29,合庫-台中,2024-08-09,1021
4545,銘鈺,30,2,28,合庫-台中,2024-08-09,1021
00795B,中信美國公債20年,26,0,26,合庫-台中,2024-08-09,1021
1905,華紙,26,0,26,合庫-台中,2024-08-09,1021
1449,佳和,25,0,25,合庫-台中,2024-08-09,1021
6180,橘子,26,2,24,合庫-台中,2024-08-09,1021
5443,均豪,85,63,22,合庫-台中,2024-08-09,1021
6016,康和證,22,0,22,合庫-台中,2024-08-09,1021
2634,漢翔,34,13,21,合庫-台中,2024-08-09,1021
1609,大亞,66,46,20,合庫-台中,2024-08-09,1021
2897,王道銀行,20,1,19,合庫-台中,2024-08-09,1021
2892,第一金,44,26,18,合庫-台中,2024-08-09,1021
2444,兆勁,18,0,18,合庫-台中,2024-08-09,1021
6122,擎邦,30,12,18,合庫-台中,2024-08-09,1021
2486,一詮,59,41,18,合庫-台中,2024-08-09,1021
3498,陽程,30,13,17,合庫-台中,2024-08-09,1021
00715L,期街口布蘭特正2,31,14,17,合庫-台中,2024-08-09,1021
00933B,國泰10Y+金融債,25,8,17,合庫-台中,2024-08-09,1021
00751B,元大AAA至A公司債,16,0,16,合庫-台中,2024-08-09,1021
2365,昆盈,318,302,16,合庫-台中,2024-08-09,1021
2313,華通,152,137,15,合庫-台中,2024-08-09,1021
2031,新光鋼,15,0,15,合庫-台中,2024-08-09,1021
00713,元大台灣高息低波,19,5,14,合庫-台中,2024-08-09,1021
00931B,統一美債20年,14,0,14,合庫-台中,2024-08-09,1021
3522,御嵿,23,9,14,合庫-台中,2024-08-09,1021
1528,恩德,15,1,14,合庫-台中,2024-08-09,1021
5481,新華,517,8,509,合庫-台中,2024-08-12,1021
00679B,元大美債20年,331,7,324,合庫-台中,2024-08-12,1021
2312,金寶,254,103,151,合庫-台中,2024-08-12,1021
00932,兆豐永續高息等權,154,10,144,合庫-台中,2024-08-12,1021
00687B,國泰20年美債,166,25,141,合庫-台中,2024-08-12,1021
00881,國泰台灣5G+,137,20,117,合庫-台中,2024-08-12,1021
00632R,元大台灣50反1,173,56,117,合庫-台中,2024-08-12,1021
2892,第一金,121,15,106,合庫-台中,2024-08-12,1021
2867,三商壽,103,3,100,合庫-台中,2024-08-12,1021
00655L,國泰中國A50正2,100,0,100,合庫-台中,2024-08-12,1021
2883,凱基金,95,6,89,合庫-台中,2024-08-12,1021
00680L,元大美債20正2,68,1,67,合庫-台中,2024-08-12,1021
2062,橋椿,64,1,63,合庫-台中,2024-08-12,1021
00688L,國泰20年美債正2,55,0,55,合庫-台中,2024-08-12,1021
3047,訊舟,58,6,52,合庫-台中,2024-08-12,1021
1314,中石化,56,6,50,合庫-台中,2024-08-12,1021
00937B,群益ESG投等債20,64,15,49,合庫-台中,2024-08-12,1021
2382,廣達,86,39,47,合庫-台中,2024-08-12,1021
4560,強信-KY,77,32,45,合庫-台中,2024-08-12,1021
2880,華南金,46,1,45,合庫-台中,2024-08-12,1021
2610,華航,115,72,43,合庫-台中,2024-08-12,1021
00936,台新永續高息中小,54,16,38,合庫-台中,2024-08-12,1021
00785B,富邦金融投等債,37,0,37,合庫-台中,2024-08-12,1021
00878,國泰永續高股息,58,24,34,合庫-台中,2024-08-12,1021
2368,金像電,35,3,32,合庫-台中,2024-08-12,1021
2885,元大金,33,1,32,合庫-台中,2024-08-12,1021
1301,台塑,37,6,31,合庫-台中,2024-08-12,1021
5202,力新,30,0,30,合庫-台中,2024-08-12,1021
2838A,聯邦銀甲特,30,0,30,合庫-台中,2024-08-12,1021
2371,大同,30,0,30,合庫-台中,2024-08-12,1021
2891,中信金,38,9,29,合庫-台中,2024-08-12,1021
4566,時碩工業,31,2,29,合庫-台中,2024-08-12,1021
1527,鑽全,26,2,24,合庫-台中,2024-08-12,1021
4563,百德,48,24,24,合庫-台中,2024-08-12,1021
4909,新復興,31,7,24,合庫-台中,2024-08-12,1021
00919,群益台灣精選高息,64,41,23,合庫-台中,2024-08-12,1021
00692,富邦公司治理,26,4,22,合庫-台中,2024-08-12,1021
1608,華榮,25,3,22,合庫-台中,2024-08-12,1021
00795B,中信美國公債20年,27,5,22,合庫-台中,2024-08-12,1021
2537,聯上發,33,12,21,合庫-台中,2024-08-12,1021
6215,和椿,66,46,20,合庫-台中,2024-08-12,1021
00857B,永豐20年美公債,20,0,20,合庫-台中,2024-08-12,1021
00665L,富邦�琤肭磪囓�2,238,218,20,合庫-台中,2024-08-12,1021
00650L,復華香港正2,130,110,20,合庫-台中,2024-08-12,1021
2464,盟立,104,85,19,合庫-台中,2024-08-12,1021
1784,訊聯,19,0,19,合庫-台中,2024-08-12,1021
3379,彬台,30,11,19,合庫-台中,2024-08-12,1021
1449,佳和,18,0,18,合庫-台中,2024-08-12,1021
2359,所羅門,105,87,18,合庫-台中,2024-08-12,1021
1530,亞崴,16,0,16,合庫-台中,2024-08-12,1021
00664R,國泰臺灣加權反1,521,28,493,合庫-台中,2024-08-13,1021
00632R,元大台灣50反1,399,0,399,合庫-台中,2024-08-13,1021
2880,華南金,385,15,370,合庫-台中,2024-08-13,1021
00680L,元大美債20正2,286,12,274,合庫-台中,2024-08-13,1021
00679B,元大美債20年,243,4,239,合庫-台中,2024-08-13,1021
00937B,群益ESG投等債20,276,43,233,合庫-台中,2024-08-13,1021
00936,台新永續高息中小,187,10,177,合庫-台中,2024-08-13,1021
00712,復華富時不動產,137,1,136,合庫-台中,2024-08-13,1021
1314,中石化,125,0,125,合庫-台中,2024-08-13,1021
2365,昆盈,213,91,122,合庫-台中,2024-08-13,1021
00901,永豐智能車供應鏈,100,0,100,合庫-台中,2024-08-13,1021
2615,萬海,123,36,87,合庫-台中,2024-08-13,1021
00687B,國泰20年美債,95,10,85,合庫-台中,2024-08-13,1021
00655L,國泰中國A50正2,81,0,81,合庫-台中,2024-08-13,1021
2891,中信金,105,27,78,合庫-台中,2024-08-13,1021
00929,復華台灣科技優息,183,106,77,合庫-台中,2024-08-13,1021
2886,兆豐金,67,0,67,合庫-台中,2024-08-13,1021
00673R,期元大S＆P原油反1,63,0,63,合庫-台中,2024-08-13,1021
00795B,中信美國公債20年,67,9,58,合庫-台中,2024-08-13,1021
2610,華航,51,2,49,合庫-台中,2024-08-13,1021
00878,國泰永續高股息,78,29,49,合庫-台中,2024-08-13,1021
00932,兆豐永續高息等權,45,0,45,合庫-台中,2024-08-13,1021
6269,台郡,46,2,44,合庫-台中,2024-08-13,1021
2486,一詮,75,32,43,合庫-台中,2024-08-13,1021
00919,群益台灣精選高息,79,37,42,合庫-台中,2024-08-13,1021
3523,迎輝,40,0,40,合庫-台中,2024-08-13,1021
00881,國泰台灣5G+,56,17,39,合庫-台中,2024-08-13,1021
00891,中信關鍵半導體,38,0,38,合庫-台中,2024-08-13,1021
2883,凱基金,54,16,38,合庫-台中,2024-08-13,1021
2834,臺企銀,43,5,38,合庫-台中,2024-08-13,1021
2609,陽明,61,24,37,合庫-台中,2024-08-13,1021
2382,廣達,76,39,37,合庫-台中,2024-08-13,1021
6282,康舒,35,1,34,合庫-台中,2024-08-13,1021
2883B,凱基金乙特,54,20,34,合庫-台中,2024-08-13,1021
2885,元大金,32,1,31,合庫-台中,2024-08-13,1021
9945,潤泰新,35,6,29,合庫-台中,2024-08-13,1021
4540,全球傳動,54,26,28,合庫-台中,2024-08-13,1021
8440,綠電,25,1,24,合庫-台中,2024-08-13,1021
1303,南亞,25,1,24,合庫-台中,2024-08-13,1021
1513,中興電,31,8,23,合庫-台中,2024-08-13,1021
00931B,統一美債20年,24,2,22,合庫-台中,2024-08-13,1021
4979,華星光,26,4,22,合庫-台中,2024-08-13,1021
2371,大同,27,6,21,合庫-台中,2024-08-13,1021
1301,台塑,22,2,20,合庫-台中,2024-08-13,1021
6116,彩晶,21,1,20,合庫-台中,2024-08-13,1021
3231,緯創,83,63,20,合庫-台中,2024-08-13,1021
6419,京晨科,19,0,19,合庫-台中,2024-08-13,1021
5443,均豪,40,21,19,合庫-台中,2024-08-13,1021
3450,聯鈞,69,50,19,合庫-台中,2024-08-13,1021
3706,神達,44,26,18,合庫-台中,2024-08-13,1021
00687B,國泰20年美債,657,40,617,合庫-台中,2024-08-14,1021
00679B,元大美債20年,357,28,329,合庫-台中,2024-08-14,1021
00632R,元大台灣50反1,162,21,141,合庫-台中,2024-08-14,1021
2834,臺企銀,122,11,111,合庫-台中,2024-08-14,1021
00929,復華台灣科技優息,158,59,99,合庫-台中,2024-08-14,1021
00680L,元大美債20正2,143,50,93,合庫-台中,2024-08-14,1021
00795B,中信美國公債20年,95,2,93,合庫-台中,2024-08-14,1021
3231,緯創,140,49,91,合庫-台中,2024-08-14,1021
00688L,國泰20年美債正2,101,40,61,合庫-台中,2024-08-14,1021
2615,萬海,105,46,59,合庫-台中,2024-08-14,1021
00937B,群益ESG投等債20,83,25,58,合庫-台中,2024-08-14,1021
00665L,富邦�琤肭磪囓�2,185,131,54,合庫-台中,2024-08-14,1021
4526,東台,56,7,49,合庫-台中,2024-08-14,1021
00881,國泰台灣5G+,62,15,47,合庫-台中,2024-08-14,1021
00948B,中信優息投資級債,47,2,45,合庫-台中,2024-08-14,1021
2365,昆盈,148,104,44,合庫-台中,2024-08-14,1021
4562,穎漢,123,80,43,合庫-台中,2024-08-14,1021
00900,富邦特選高股息30,42,0,42,合庫-台中,2024-08-14,1021
1101,台泥,44,4,40,合庫-台中,2024-08-14,1021
8096,擎亞,128,89,39,合庫-台中,2024-08-14,1021
2374,佳能,47,14,33,合庫-台中,2024-08-14,1021
2539,櫻花建,40,9,31,合庫-台中,2024-08-14,1021
2880,華南金,30,0,30,合庫-台中,2024-08-14,1021
00936,台新永續高息中小,34,7,27,合庫-台中,2024-08-14,1021
9902,台火,28,1,27,合庫-台中,2024-08-14,1021
3523,迎輝,27,0,27,合庫-台中,2024-08-14,1021
4534,慶騰,33,10,23,合庫-台中,2024-08-14,1021
2324,仁寶,26,5,21,合庫-台中,2024-08-14,1021
1708,東鹼,32,11,21,合庫-台中,2024-08-14,1021
4916,事欣科,21,0,21,合庫-台中,2024-08-14,1021
3540,曜越,20,0,20,合庫-台中,2024-08-14,1021
5511,德昌,22,2,20,合庫-台中,2024-08-14,1021
2367,燿華,30,10,20,合庫-台中,2024-08-14,1021
6603,富強鑫,20,1,19,合庫-台中,2024-08-14,1021
1316,上曜,21,2,19,合庫-台中,2024-08-14,1021
4513,福裕,37,19,18,合庫-台中,2024-08-14,1021
2344,華邦電,34,17,17,合庫-台中,2024-08-14,1021
5880,合庫金,200,183,17,合庫-台中,2024-08-14,1021
3006,晶豪科,20,3,17,合庫-台中,2024-08-14,1021
00719B,元大美債1-3,17,0,17,合庫-台中,2024-08-14,1021
3580,友威科,28,11,17,合庫-台中,2024-08-14,1021
2356,英業達,37,20,17,合庫-台中,2024-08-14,1021
9105,泰金寶-DR,28,12,16,合庫-台中,2024-08-14,1021
00637L,元大滬深300正2,123,107,16,合庫-台中,2024-08-14,1021
2739,寒舍,18,2,16,合庫-台中,2024-08-14,1021
00932,兆豐永續高息等權,21,5,16,合庫-台中,2024-08-14,1021
4958,臻鼎-KY,31,15,16,合庫-台中,2024-08-14,1021
6492,生華科,15,0,15,合庫-台中,2024-08-14,1021
3050,鈺德,17,2,15,合庫-台中,2024-08-14,1021
2464,盟立,119,105,14,合庫-台中,2024-08-14,1021
00687B,國泰20年美債,801,71,730,合庫-台中,2024-08-15,1021
00679B,元大美債20年,797,213,584,合庫-台中,2024-08-15,1021
00878,國泰永續高股息,454,17,437,合庫-台中,2024-08-15,1021
00680L,元大美債20正2,492,184,308,合庫-台中,2024-08-15,1021
00900,富邦特選高股息30,295,17,278,合庫-台中,2024-08-15,1021
00929,復華台灣科技優息,233,81,152,合庫-台中,2024-08-15,1021
3645,達邁,154,19,135,合庫-台中,2024-08-15,1021
00632R,元大台灣50反1,134,2,132,合庫-台中,2024-08-15,1021
00795B,中信美國公債20年,116,0,116,合庫-台中,2024-08-15,1021
2883B,凱基金乙特,100,0,100,合庫-台中,2024-08-15,1021
2801,彰銀,160,70,90,合庫-台中,2024-08-15,1021
2887,台新金,77,0,77,合庫-台中,2024-08-15,1021
2884,玉山金,60,0,60,合庫-台中,2024-08-15,1021
00719B,元大美債1-3,50,0,50,合庫-台中,2024-08-15,1021
00881,國泰台灣5G+,49,2,47,合庫-台中,2024-08-15,1021
00936,台新永續高息中小,57,14,43,合庫-台中,2024-08-15,1021
2834,臺企銀,38,0,38,合庫-台中,2024-08-15,1021
4540,全球傳動,80,44,36,合庫-台中,2024-08-15,1021
2002,中鋼,40,5,35,合庫-台中,2024-08-15,1021
4562,穎漢,72,38,34,合庫-台中,2024-08-15,1021
5880,合庫金,42,10,32,合庫-台中,2024-08-15,1021
2891,中信金,46,14,32,合庫-台中,2024-08-15,1021
6269,台郡,35,4,31,合庫-台中,2024-08-15,1021
3056,富華新,31,1,30,合庫-台中,2024-08-15,1021
5484,慧友,31,2,29,合庫-台中,2024-08-15,1021
2886,兆豐金,30,3,27,合庫-台中,2024-08-15,1021
9945,潤泰新,31,5,26,合庫-台中,2024-08-15,1021
2359,所羅門,62,36,26,合庫-台中,2024-08-15,1021
00934,中信成長高股息,26,2,24,合庫-台中,2024-08-15,1021
9902,台火,29,5,24,合庫-台中,2024-08-15,1021
2349,錸德,26,3,23,合庫-台中,2024-08-15,1021
1909,榮成,27,5,22,合庫-台中,2024-08-15,1021
3303,岱稜,25,4,21,合庫-台中,2024-08-15,1021
1805,寶徠,20,0,20,合庫-台中,2024-08-15,1021
1810,和成,20,0,20,合庫-台中,2024-08-15,1021
2106,建大,20,0,20,合庫-台中,2024-08-15,1021
2444,兆勁,20,0,20,合庫-台中,2024-08-15,1021
2890,永豐金,39,20,19,合庫-台中,2024-08-15,1021
00715L,期街口布蘭特正2,68,50,18,合庫-台中,2024-08-15,1021
6505,台塑化,17,0,17,合庫-台中,2024-08-15,1021
3073,天方能源,18,1,17,合庫-台中,2024-08-15,1021
4906,正文,19,3,16,合庫-台中,2024-08-15,1021
4561,健椿,78,62,16,合庫-台中,2024-08-15,1021
1583,程泰,16,0,16,合庫-台中,2024-08-15,1021
4958,臻鼎-KY,20,5,15,合庫-台中,2024-08-15,1021
00891,中信關鍵半導體,43,28,15,合庫-台中,2024-08-15,1021
2596,綠意,15,0,15,合庫-台中,2024-08-15,1021
00951,台新日本半導體,14,0,14,合庫-台中,2024-08-15,1021
2497,怡利電,15,1,14,合庫-台中,2024-08-15,1021
2892,第一金,19,6,13,合庫-台中,2024-08-15,1021
00687B,國泰20年美債,489,72,417,合庫-台中,2024-08-16,1021
00679B,元大美債20年,295,15,280,合庫-台中,2024-08-16,1021
00680L,元大美債20正2,184,45,139,合庫-台中,2024-08-16,1021
00632R,元大台灣50反1,136,10,126,合庫-台中,2024-08-16,1021
2317,鴻海,182,64,118,合庫-台中,2024-08-16,1021
2323,中環,183,77,106,合庫-台中,2024-08-16,1021
00937B,群益ESG投等債20,239,136,103,合庫-台中,2024-08-16,1021
00929,復華台灣科技優息,224,124,100,合庫-台中,2024-08-16,1021
5484,慧友,95,13,82,合庫-台中,2024-08-16,1021
1609,大亞,85,10,75,合庫-台中,2024-08-16,1021
6505,台塑化,71,0,71,合庫-台中,2024-08-16,1021
1301,台塑,65,7,58,合庫-台中,2024-08-16,1021
3663,鑫科,102,46,56,合庫-台中,2024-08-16,1021
00706L,期元大S＆P日圓正2,53,0,53,合庫-台中,2024-08-16,1021
8096,擎亞,151,104,47,合庫-台中,2024-08-16,1021
00882,中信中國高股息,57,15,42,合庫-台中,2024-08-16,1021
8374,羅昇,105,64,41,合庫-台中,2024-08-16,1021
1909,榮成,41,0,41,合庫-台中,2024-08-16,1021
1785,光洋科,56,16,40,合庫-台中,2024-08-16,1021
00931B,統一美債20年,38,0,38,合庫-台中,2024-08-16,1021
00795B,中信美國公債20年,34,0,34,合庫-台中,2024-08-16,1021
00878,國泰永續高股息,116,83,33,合庫-台中,2024-08-16,1021
2344,華邦電,32,2,30,合庫-台中,2024-08-16,1021
1708,東鹼,31,3,28,合庫-台中,2024-08-16,1021
00900,富邦特選高股息30,34,6,28,合庫-台中,2024-08-16,1021
4562,穎漢,114,87,27,合庫-台中,2024-08-16,1021
3615,安可,26,0,26,合庫-台中,2024-08-16,1021
5371,中光電,34,9,25,合庫-台中,2024-08-16,1021
8234,新漢,26,1,25,合庫-台中,2024-08-16,1021
3712,永崴投控,41,17,24,合庫-台中,2024-08-16,1021
1583,程泰,23,0,23,合庫-台中,2024-08-16,1021
4540,全球傳動,41,18,23,合庫-台中,2024-08-16,1021
2489,瑞軒,35,14,21,合庫-台中,2024-08-16,1021
3276,宇環,21,0,21,合庫-台中,2024-08-16,1021
00671R,富邦NASDAQ反1,20,0,20,合庫-台中,2024-08-16,1021
3062,建漢,34,16,18,合庫-台中,2024-08-16,1021
2615,萬海,41,24,17,合庫-台中,2024-08-16,1021
9955,佳龍,19,2,17,合庫-台中,2024-08-16,1021
4523,永彰,16,0,16,合庫-台中,2024-08-16,1021
6589,台康生技,17,2,15,合庫-台中,2024-08-16,1021
1310,台苯,15,0,15,合庫-台中,2024-08-16,1021
00720B,元大投資級公司債,20,5,15,合庫-台中,2024-08-16,1021
6215,和椿,39,25,14,合庫-台中,2024-08-16,1021
2327,國巨,15,1,14,合庫-台中,2024-08-16,1021
2349,錸德,21,7,14,合庫-台中,2024-08-16,1021
1584,精剛,15,1,14,合庫-台中,2024-08-16,1021
4303,信立,14,0,14,合庫-台中,2024-08-16,1021
00751B,元大AAA至A公司債,16,2,14,合庫-台中,2024-08-16,1021
00918,大華優利高填息30,14,0,14,合庫-台中,2024-08-16,1021
3535,晶彩科,39,25,14,合庫-台中,2024-08-16,1021
00632R,元大台灣50反1,469,38,431,合庫-台中,2024-08-19,1021
00664R,國泰臺灣加權反1,400,0,400,合庫-台中,2024-08-19,1021
00687B,國泰20年美債,455,108,347,合庫-台中,2024-08-19,1021
3047,訊舟,309,122,187,合庫-台中,2024-08-19,1021
00929,復華台灣科技優息,290,159,131,合庫-台中,2024-08-19,1021
2845,遠東銀,105,10,95,合庫-台中,2024-08-19,1021
00719B,元大美債1-3,82,0,82,合庫-台中,2024-08-19,1021
00650L,復華香港正2,190,110,80,合庫-台中,2024-08-19,1021
2062,橋椿,136,59,77,合庫-台中,2024-08-19,1021
3523,迎輝,76,0,76,合庫-台中,2024-08-19,1021
6609,瀧澤科,74,2,72,合庫-台中,2024-08-19,1021
2317,鴻海,100,36,64,合庫-台中,2024-08-19,1021
2002,中鋼,68,6,62,合庫-台中,2024-08-19,1021
1611,中電,60,6,54,合庫-台中,2024-08-19,1021
00931B,統一美債20年,56,5,51,合庫-台中,2024-08-19,1021
3048,益登,63,14,49,合庫-台中,2024-08-19,1021
00715L,期街口布蘭特正2,66,18,48,合庫-台中,2024-08-19,1021
2344,華邦電,53,11,42,合庫-台中,2024-08-19,1021
3231,緯創,57,17,40,合庫-台中,2024-08-19,1021
00900,富邦特選高股息30,47,7,40,合庫-台中,2024-08-19,1021
00918,大華優利高填息30,50,10,40,合庫-台中,2024-08-19,1021
00946,群益科技高息成長,42,4,38,合庫-台中,2024-08-19,1021
1909,榮成,37,0,37,合庫-台中,2024-08-19,1021
1815,富喬,42,6,36,合庫-台中,2024-08-19,1021
2330,台積電,46,10,36,合庫-台中,2024-08-19,1021
8028,昇陽半導體,96,61,35,合庫-台中,2024-08-19,1021
6589,台康生技,53,19,34,合庫-台中,2024-08-19,1021
2359,所羅門,165,131,34,合庫-台中,2024-08-19,1021
2365,昆盈,243,210,33,合庫-台中,2024-08-19,1021
5905,南仁湖,35,3,32,合庫-台中,2024-08-19,1021
6220,岳豐,30,0,30,合庫-台中,2024-08-19,1021
00665L,富邦�琤肭磪囓�2,192,165,27,合庫-台中,2024-08-19,1021
5484,慧友,40,15,25,合庫-台中,2024-08-19,1021
8043,蜜望實,27,3,24,合庫-台中,2024-08-19,1021
00795B,中信美國公債20年,25,1,24,合庫-台中,2024-08-19,1021
8070,長華*,26,3,23,合庫-台中,2024-08-19,1021
8096,擎亞,90,67,23,合庫-台中,2024-08-19,1021
6188,廣明,92,70,22,合庫-台中,2024-08-19,1021
00907,永豐優息存股,21,0,21,合庫-台中,2024-08-19,1021
3645,達邁,28,7,21,合庫-台中,2024-08-19,1021
00936,台新永續高息中小,21,0,21,合庫-台中,2024-08-19,1021
6770,力積電,21,0,21,合庫-台中,2024-08-19,1021
2106,建大,20,0,20,合庫-台中,2024-08-19,1021
00706L,期元大S＆P日圓正2,30,10,20,合庫-台中,2024-08-19,1021
3019,亞光,51,33,18,合庫-台中,2024-08-19,1021
0056,元大高股息,34,16,18,合庫-台中,2024-08-19,1021
2883B,凱基金乙特,18,0,18,合庫-台中,2024-08-19,1021
6125,廣運,32,15,17,合庫-台中,2024-08-19,1021
00945B,凱基美國非投等債,16,0,16,合庫-台中,2024-08-19,1021
2537,聯上發,23,7,16,合庫-台中,2024-08-19,1021
00715L,期街口布蘭特正2,394,1,393,合庫-台中,2024-08-20,1021
3512,皇龍,219,0,219,合庫-台中,2024-08-20,1021
00937B,群益ESG投等債20,233,14,219,合庫-台中,2024-08-20,1021
00664R,國泰臺灣加權反1,205,0,205,合庫-台中,2024-08-20,1021
00679B,元大美債20年,154,14,140,合庫-台中,2024-08-20,1021
00945B,凱基美國非投等債,133,0,133,合庫-台中,2024-08-20,1021
00907,永豐優息存股,117,1,116,合庫-台中,2024-08-20,1021
00687B,國泰20年美債,236,125,111,合庫-台中,2024-08-20,1021
00901,永豐智能車供應鏈,100,0,100,合庫-台中,2024-08-20,1021
00665L,富邦�琤肭磪囓�2,254,158,96,合庫-台中,2024-08-20,1021
3523,迎輝,102,8,94,合庫-台中,2024-08-20,1021
1314,中石化,85,9,76,合庫-台中,2024-08-20,1021
8071,能率網通,79,5,74,合庫-台中,2024-08-20,1021
2374,佳能,103,37,66,合庫-台中,2024-08-20,1021
1326,台化,73,12,61,合庫-台中,2024-08-20,1021
2356,英業達,75,18,57,合庫-台中,2024-08-20,1021
2515,中工,58,1,57,合庫-台中,2024-08-20,1021
00929,復華台灣科技優息,212,155,57,合庫-台中,2024-08-20,1021
6133,金橋,55,0,55,合庫-台中,2024-08-20,1021
8096,擎亞,122,69,53,合庫-台中,2024-08-20,1021
00655L,國泰中國A50正2,52,0,52,合庫-台中,2024-08-20,1021
9945,潤泰新,52,1,51,合庫-台中,2024-08-20,1021
2520,冠德,44,0,44,合庫-台中,2024-08-20,1021
8070,長華*,46,5,41,合庫-台中,2024-08-20,1021
2312,金寶,61,21,40,合庫-台中,2024-08-20,1021
00919,群益台灣精選高息,56,17,39,合庫-台中,2024-08-20,1021
2337,旺宏,40,4,36,合庫-台中,2024-08-20,1021
2401,凌陽,90,55,35,合庫-台中,2024-08-20,1021
3312,弘憶股,118,84,34,合庫-台中,2024-08-20,1021
1416,廣豐,31,0,31,合庫-台中,2024-08-20,1021
3293,鈊象,28,0,28,合庫-台中,2024-08-20,1021
00637L,元大滬深300正2,188,160,28,合庫-台中,2024-08-20,1021
4303,信立,33,5,28,合庫-台中,2024-08-20,1021
8028,昇陽半導體,104,76,28,合庫-台中,2024-08-20,1021
6213,聯茂,25,0,25,合庫-台中,2024-08-20,1021
00731,復華富時高息低波,24,0,24,合庫-台中,2024-08-20,1021
00918,大華優利高填息30,25,1,24,合庫-台中,2024-08-20,1021
4906,正文,35,11,24,合庫-台中,2024-08-20,1021
2002,中鋼,34,11,23,合庫-台中,2024-08-20,1021
2464,盟立,84,61,23,合庫-台中,2024-08-20,1021
2539,櫻花建,23,0,23,合庫-台中,2024-08-20,1021
2883,凱基金,34,11,23,合庫-台中,2024-08-20,1021
5392,能率,24,3,21,合庫-台中,2024-08-20,1021
3056,富華新,31,10,21,合庫-台中,2024-08-20,1021
00706L,期元大S＆P日圓正2,21,0,21,合庫-台中,2024-08-20,1021
4513,福裕,25,5,20,合庫-台中,2024-08-20,1021
3005,神基,20,0,20,合庫-台中,2024-08-20,1021
3576,聯合再生,20,1,19,合庫-台中,2024-08-20,1021
00931B,統一美債20年,19,0,19,合庫-台中,2024-08-20,1021
2338,光罩,33,14,19,合庫-台中,2024-08-20,1021
2888,新光金,2282,1218,1064,合庫-台中,2024-08-21,1021
2891,中信金,304,33,271,合庫-台中,2024-08-21,1021
9105,泰金寶-DR,300,43,257,合庫-台中,2024-08-21,1021
00919,群益台灣精選高息,239,7,232,合庫-台中,2024-08-21,1021
00687B,國泰20年美債,247,74,173,合庫-台中,2024-08-21,1021
00929,復華台灣科技優息,214,57,157,合庫-台中,2024-08-21,1021
00953B,群益優選非投等債,148,12,136,合庫-台中,2024-08-21,1021
00715L,期街口布蘭特正2,214,103,111,合庫-台中,2024-08-21,1021
5905,南仁湖,116,21,95,合庫-台中,2024-08-21,1021
00878,國泰永續高股息,112,18,94,合庫-台中,2024-08-21,1021
3523,迎輝,78,0,78,合庫-台中,2024-08-21,1021
00632R,元大台灣50反1,108,32,76,合庫-台中,2024-08-21,1021
2356,英業達,72,7,65,合庫-台中,2024-08-21,1021
00918,大華優利高填息30,59,0,59,合庫-台中,2024-08-21,1021
2317,鴻海,102,47,55,合庫-台中,2024-08-21,1021
1785,光洋科,113,64,49,合庫-台中,2024-08-21,1021
2330,台積電,51,7,44,合庫-台中,2024-08-21,1021
00937B,群益ESG投等債20,114,74,40,合庫-台中,2024-08-21,1021
2539,櫻花建,40,0,40,合庫-台中,2024-08-21,1021
00712,復華富時不動產,37,0,37,合庫-台中,2024-08-21,1021
00881,國泰台灣5G+,31,0,31,合庫-台中,2024-08-21,1021
4555,氣立,42,12,30,合庫-台中,2024-08-21,1021
6462,神盾,42,16,26,合庫-台中,2024-08-21,1021
3062,建漢,56,30,26,合庫-台中,2024-08-21,1021
00923,群益台ESG低碳50,25,0,25,合庫-台中,2024-08-21,1021
2409,友達,345,320,25,合庫-台中,2024-08-21,1021
2344,華邦電,29,6,23,合庫-台中,2024-08-21,1021
00900,富邦特選高股息30,26,3,23,合庫-台中,2024-08-21,1021
00947,台新臺灣IC設計,25,3,22,合庫-台中,2024-08-21,1021
00942B,台新美A公司債20+,22,0,22,合庫-台中,2024-08-21,1021
4566,時碩工業,24,3,21,合庫-台中,2024-08-21,1021
3019,亞光,81,61,20,合庫-台中,2024-08-21,1021
3013,晟銘電,42,22,20,合庫-台中,2024-08-21,1021
4109,加捷生醫,21,1,20,合庫-台中,2024-08-21,1021
6869,雲豹能源,100,81,19,合庫-台中,2024-08-21,1021
8054,安國,58,39,19,合庫-台中,2024-08-21,1021
00954,中信日本半導體,19,0,19,合庫-台中,2024-08-21,1021
00713,元大台灣高息低波,18,0,18,合庫-台中,2024-08-21,1021
2359,所羅門,104,86,18,合庫-台中,2024-08-21,1021
00679B,元大美債20年,61,44,17,合庫-台中,2024-08-21,1021
6117,迎廣,24,8,16,合庫-台中,2024-08-21,1021
2388,威盛,30,14,16,合庫-台中,2024-08-21,1021
2812,台中銀,23,8,15,合庫-台中,2024-08-21,1021
1714,和桐,15,0,15,合庫-台中,2024-08-21,1021
8064,東捷,36,21,15,合庫-台中,2024-08-21,1021
2353,宏��,19,5,14,合庫-台中,2024-08-21,1021
2241,艾姆勒,14,0,14,合庫-台中,2024-08-21,1021
4564,元翎,18,4,14,合庫-台中,2024-08-21,1021
9945,潤泰新,15,1,14,合庫-台中,2024-08-21,1021
9902,台火,15,1,14,合庫-台中,2024-08-21,1021
00650L,復華香港正2,673,150,523,合庫-台中,2024-08-22,1021
00715L,期街口布蘭特正2,311,5,306,合庫-台中,2024-08-22,1021
00953B,群益優選非投等債,295,0,295,合庫-台中,2024-08-22,1021
00907,永豐優息存股,178,1,177,合庫-台中,2024-08-22,1021
00935,野村臺灣新科技50,145,0,145,合庫-台中,2024-08-22,1021
00687B,國泰20年美債,140,3,137,合庫-台中,2024-08-22,1021
00929,復華台灣科技優息,215,94,121,合庫-台中,2024-08-22,1021
2834,臺企銀,111,9,102,合庫-台中,2024-08-22,1021
2539,櫻花建,102,0,102,合庫-台中,2024-08-22,1021
4958,臻鼎-KY,103,2,101,合庫-台中,2024-08-22,1021
2891,中信金,126,47,79,合庫-台中,2024-08-22,1021
8070,長華*,108,34,74,合庫-台中,2024-08-22,1021
00878,國泰永續高股息,74,7,67,合庫-台中,2024-08-22,1021
2515,中工,65,0,65,合庫-台中,2024-08-22,1021
2890,永豐金,66,5,61,合庫-台中,2024-08-22,1021
1569,濱川,60,0,60,合庫-台中,2024-08-22,1021
00680L,元大美債20正2,74,14,60,合庫-台中,2024-08-22,1021
00918,大華優利高填息30,58,1,57,合庫-台中,2024-08-22,1021
00642U,期元大S＆P石油,53,0,53,合庫-台中,2024-08-22,1021
3663,鑫科,96,44,52,合庫-台中,2024-08-22,1021
00937B,群益ESG投等債20,79,32,47,合庫-台中,2024-08-22,1021
5511,德昌,40,0,40,合庫-台中,2024-08-22,1021
3523,迎輝,40,0,40,合庫-台中,2024-08-22,1021
1584,精剛,54,14,40,合庫-台中,2024-08-22,1021
00950B,凱基A級公司債,40,2,38,合庫-台中,2024-08-22,1021
1717,長興,63,26,37,合庫-台中,2024-08-22,1021
2405,輔信,32,0,32,合庫-台中,2024-08-22,1021
00679B,元大美債20年,82,51,31,合庫-台中,2024-08-22,1021
3645,達邁,36,8,28,合庫-台中,2024-08-22,1021
8103,瀚荃,40,13,27,合庫-台中,2024-08-22,1021
3047,訊舟,249,223,26,合庫-台中,2024-08-22,1021
3073,天方能源,33,8,25,合庫-台中,2024-08-22,1021
5371,中光電,82,60,22,合庫-台中,2024-08-22,1021
3512,皇龍,22,0,22,合庫-台中,2024-08-22,1021
4510,高鋒,26,4,22,合庫-台中,2024-08-22,1021
00940,元大台灣價值高息,21,0,21,合庫-台中,2024-08-22,1021
4109,加捷生醫,22,1,21,合庫-台中,2024-08-22,1021
2618,長榮航,27,7,20,合庫-台中,2024-08-22,1021
4916,事欣科,20,0,20,合庫-台中,2024-08-22,1021
00939,統一台灣高息動能,20,0,20,合庫-台中,2024-08-22,1021
4566,時碩工業,22,3,19,合庫-台中,2024-08-22,1021
3149,正達,22,4,18,合庫-台中,2024-08-22,1021
3050,鈺德,40,22,18,合庫-台中,2024-08-22,1021
2883,凱基金,17,0,17,合庫-台中,2024-08-22,1021
2062,橋椿,69,52,17,合庫-台中,2024-08-22,1021
9136,巨騰-DR,17,0,17,合庫-台中,2024-08-22,1021
3105,穩懋,16,0,16,合庫-台中,2024-08-22,1021
5521,工信,21,5,16,合庫-台中,2024-08-22,1021
1312,國喬,16,0,16,合庫-台中,2024-08-22,1021
00936,台新永續高息中小,17,1,16,合庫-台中,2024-08-22,1021
00632R,元大台灣50反1,409,50,359,合庫-台中,2024-08-23,1021
00664R,國泰臺灣加權反1,310,0,310,合庫-台中,2024-08-23,1021
00687B,國泰20年美債,284,1,283,合庫-台中,2024-08-23,1021
00953B,群益優選非投等債,260,0,260,合庫-台中,2024-08-23,1021
00679B,元大美債20年,254,1,253,合庫-台中,2024-08-23,1021
2208,台船,231,13,218,合庫-台中,2024-08-23,1021
2887,台新金,216,42,174,合庫-台中,2024-08-23,1021
00937B,群益ESG投等債20,232,60,172,合庫-台中,2024-08-23,1021
2891,中信金,146,6,140,合庫-台中,2024-08-23,1021
00919,群益台灣精選高息,137,5,132,合庫-台中,2024-08-23,1021
00940,元大台灣價值高息,162,54,108,合庫-台中,2024-08-23,1021
2812,台中銀,117,10,107,合庫-台中,2024-08-23,1021
00669R,國泰美國道瓊反1,72,0,72,合庫-台中,2024-08-23,1021
2539,櫻花建,70,0,70,合庫-台中,2024-08-23,1021
00929,復華台灣科技優息,216,148,68,合庫-台中,2024-08-23,1021
2349,錸德,460,398,62,合庫-台中,2024-08-23,1021
1708,東鹼,129,78,51,合庫-台中,2024-08-23,1021
00680L,元大美債20正2,50,0,50,合庫-台中,2024-08-23,1021
1316,上曜,56,12,44,合庫-台中,2024-08-23,1021
3189,景碩,77,34,43,合庫-台中,2024-08-23,1021
1409,新纖,41,0,41,合庫-台中,2024-08-23,1021
00946,群益科技高息成長,40,2,38,合庫-台中,2024-08-23,1021
00688L,國泰20年美債正2,88,50,38,合庫-台中,2024-08-23,1021
00715L,期街口布蘭特正2,112,74,38,合庫-台中,2024-08-23,1021
6834,天二科技,36,0,36,合庫-台中,2024-08-23,1021
00830,國泰費城半導體,36,0,36,合庫-台中,2024-08-23,1021
6443,元晶,74,38,36,合庫-台中,2024-08-23,1021
00936,台新永續高息中小,37,1,36,合庫-台中,2024-08-23,1021
00878,國泰永續高股息,41,6,35,合庫-台中,2024-08-23,1021
3512,皇龍,34,0,34,合庫-台中,2024-08-23,1021
00795B,中信美國公債20年,31,0,31,合庫-台中,2024-08-23,1021
4109,加捷生醫,30,0,30,合庫-台中,2024-08-23,1021
8440,綠電,28,0,28,合庫-台中,2024-08-23,1021
2834,臺企銀,37,10,27,合庫-台中,2024-08-23,1021
2354,鴻準,30,3,27,合庫-台中,2024-08-23,1021
1326,台化,38,12,26,合庫-台中,2024-08-23,1021
2409,友達,52,27,25,合庫-台中,2024-08-23,1021
4510,高鋒,25,2,23,合庫-台中,2024-08-23,1021
6125,廣運,27,6,21,合庫-台中,2024-08-23,1021
1515,力山,20,0,20,合庫-台中,2024-08-23,1021
2444,兆勁,20,0,20,合庫-台中,2024-08-23,1021
00662,富邦NASDAQ,20,0,20,合庫-台中,2024-08-23,1021
3518,柏騰,26,7,19,合庫-台中,2024-08-23,1021
6216,居易,20,2,18,合庫-台中,2024-08-23,1021
2337,旺宏,24,6,18,合庫-台中,2024-08-23,1021
3652,精聯,27,10,17,合庫-台中,2024-08-23,1021
4111,濟生,18,1,17,合庫-台中,2024-08-23,1021
5309,系統電,27,11,16,合庫-台中,2024-08-23,1021
3211,順達,20,4,16,合庫-台中,2024-08-23,1021
1711,永光,93,78,15,合庫-台中,2024-08-23,1021
00953B,群益優選非投等債,512,1,511,合庫-台中,2024-08-26,1021
00933B,國泰10Y+金融債,207,2,205,合庫-台中,2024-08-26,1021
00687B,國泰20年美債,153,5,148,合庫-台中,2024-08-26,1021
2891,中信金,152,30,122,合庫-台中,2024-08-26,1021
2890,永豐金,139,30,109,合庫-台中,2024-08-26,1021
4958,臻鼎-KY,106,0,106,合庫-台中,2024-08-26,1021
00664R,國泰臺灣加權反1,550,450,100,合庫-台中,2024-08-26,1021
3512,皇龍,101,1,100,合庫-台中,2024-08-26,1021
6133,金橋,102,4,98,合庫-台中,2024-08-26,1021
3073,天方能源,109,13,96,合庫-台中,2024-08-26,1021
00937B,群益ESG投等債20,261,186,75,合庫-台中,2024-08-26,1021
00679B,元大美債20年,201,127,74,合庫-台中,2024-08-26,1021
00945B,凱基美國非投等債,65,5,60,合庫-台中,2024-08-26,1021
00688L,國泰20年美債正2,65,6,59,合庫-台中,2024-08-26,1021
2402,毅嘉,101,43,58,合庫-台中,2024-08-26,1021
2637,慧洋-KY,61,4,57,合庫-台中,2024-08-26,1021
00655L,國泰中國A50正2,55,0,55,合庫-台中,2024-08-26,1021
00680L,元大美債20正2,54,0,54,合庫-台中,2024-08-26,1021
3149,正達,50,3,47,合庫-台中,2024-08-26,1021
2349,錸德,296,250,46,合庫-台中,2024-08-26,1021
8039,台虹,86,41,45,合庫-台中,2024-08-26,1021
2062,橋椿,59,16,43,合庫-台中,2024-08-26,1021
5443,均豪,138,97,41,合庫-台中,2024-08-26,1021
8249,菱光,40,2,38,合庫-台中,2024-08-26,1021
1711,永光,83,45,38,合庫-台中,2024-08-26,1021
2363,矽統,41,4,37,合庫-台中,2024-08-26,1021
2388,威盛,53,19,34,合庫-台中,2024-08-26,1021
2409,友達,139,105,34,合庫-台中,2024-08-26,1021
3374,精材,37,3,34,合庫-台中,2024-08-26,1021
2317,鴻海,86,54,32,合庫-台中,2024-08-26,1021
3047,訊舟,145,114,31,合庫-台中,2024-08-26,1021
00882,中信中國高股息,28,0,28,合庫-台中,2024-08-26,1021
00673R,期元大S＆P原油反1,27,0,27,合庫-台中,2024-08-26,1021
00923,群益台ESG低碳50,36,11,25,合庫-台中,2024-08-26,1021
3523,迎輝,26,2,24,合庫-台中,2024-08-26,1021
00931B,統一美債20年,24,0,24,合庫-台中,2024-08-26,1021
1708,東鹼,42,18,24,合庫-台中,2024-08-26,1021
8043,蜜望實,25,4,21,合庫-台中,2024-08-26,1021
1776,展宇,21,0,21,合庫-台中,2024-08-26,1021
2506,太設,20,0,20,合庫-台中,2024-08-26,1021
2883B,凱基金乙特,20,0,20,合庫-台中,2024-08-26,1021
1570,力肯,20,0,20,合庫-台中,2024-08-26,1021
6220,岳豐,20,0,20,合庫-台中,2024-08-26,1021
2408,南亞科,21,1,20,合庫-台中,2024-08-26,1021
6218,豪勉,18,0,18,合庫-台中,2024-08-26,1021
3450,聯鈞,21,4,17,合庫-台中,2024-08-26,1021
3231,緯創,21,4,17,合庫-台中,2024-08-26,1021
00891,中信關鍵半導體,18,2,16,合庫-台中,2024-08-26,1021
2365,昆盈,40,24,16,合庫-台中,2024-08-26,1021
8438,昶昕,16,1,15,合庫-台中,2024-08-26,1021
00632R,元大台灣50反1,511,10,501,合庫-台中,2024-08-27,1021
3481,群創,441,229,212,合庫-台中,2024-08-27,1021
00919,群益台灣精選高息,149,1,148,合庫-台中,2024-08-27,1021
00929,復華台灣科技優息,149,7,142,合庫-台中,2024-08-27,1021
00673R,期元大S＆P原油反1,129,0,129,合庫-台中,2024-08-27,1021
3523,迎輝,109,0,109,合庫-台中,2024-08-27,1021
2890,永豐金,105,3,102,合庫-台中,2024-08-27,1021
2891,中信金,117,23,94,合庫-台中,2024-08-27,1021
00936,台新永續高息中小,82,0,82,合庫-台中,2024-08-27,1021
00679B,元大美債20年,142,62,80,合庫-台中,2024-08-27,1021
4303,信立,91,17,74,合庫-台中,2024-08-27,1021
00937B,群益ESG投等債20,70,3,67,合庫-台中,2024-08-27,1021
00687B,國泰20年美債,70,7,63,合庫-台中,2024-08-27,1021
00664R,國泰臺灣加權反1,60,0,60,合庫-台中,2024-08-27,1021
2845,遠東銀,57,0,57,合庫-台中,2024-08-27,1021
00680L,元大美債20正2,68,15,53,合庫-台中,2024-08-27,1021
2834,臺企銀,54,3,51,合庫-台中,2024-08-27,1021
2539,櫻花建,48,0,48,合庫-台中,2024-08-27,1021
2317,鴻海,65,23,42,合庫-台中,2024-08-27,1021
2883,凱基金,37,0,37,合庫-台中,2024-08-27,1021
1784,訊聯,37,0,37,合庫-台中,2024-08-27,1021
00954,中信日本半導體,36,0,36,合庫-台中,2024-08-27,1021
4960,誠美材,36,0,36,合庫-台中,2024-08-27,1021
00725B,國泰投資級公司債,35,0,35,合庫-台中,2024-08-27,1021
00688L,國泰20年美債正2,44,10,34,合庫-台中,2024-08-27,1021
2330,台積電,43,10,33,合庫-台中,2024-08-27,1021
6151,晉倫,34,1,33,合庫-台中,2024-08-27,1021
5876,上海商銀,30,0,30,合庫-台中,2024-08-27,1021
4510,高鋒,133,105,28,合庫-台中,2024-08-27,1021
6443,元晶,63,37,26,合庫-台中,2024-08-27,1021
2408,南亞科,26,0,26,合庫-台中,2024-08-27,1021
2609,陽明,35,9,26,合庫-台中,2024-08-27,1021
00878,國泰永續高股息,30,4,26,合庫-台中,2024-08-27,1021
5475,德宏,25,0,25,合庫-台中,2024-08-27,1021
2303,聯電,52,28,24,合庫-台中,2024-08-27,1021
1314,中石化,24,0,24,合庫-台中,2024-08-27,1021
3149,正達,30,7,23,合庫-台中,2024-08-27,1021
00940,元大台灣價值高息,26,3,23,合庫-台中,2024-08-27,1021
4729,熒茂,27,4,23,合庫-台中,2024-08-27,1021
6834,天二科技,23,0,23,合庫-台中,2024-08-27,1021
2603,長榮,61,38,23,合庫-台中,2024-08-27,1021
9955,佳龍,27,5,22,合庫-台中,2024-08-27,1021
2365,昆盈,94,72,22,合庫-台中,2024-08-27,1021
2617,台航,20,0,20,合庫-台中,2024-08-27,1021
1540,喬福,58,39,19,合庫-台中,2024-08-27,1021
5905,南仁湖,20,2,18,合庫-台中,2024-08-27,1021
8027,鈦昇,42,25,17,合庫-台中,2024-08-27,1021
00881,國泰台灣5G+,20,3,17,合庫-台中,2024-08-27,1021
6838,台新藥,17,0,17,合庫-台中,2024-08-27,1021
2344,華邦電,17,1,16,合庫-台中,2024-08-27,1021
00715L,期街口布蘭特正2,475,91,384,合庫-台中,2024-08-28,1021
00706L,期元大S＆P日圓正2,220,0,220,合庫-台中,2024-08-28,1021
00680L,元大美債20正2,204,17,187,合庫-台中,2024-08-28,1021
2891,中信金,152,22,130,合庫-台中,2024-08-28,1021
1314,中石化,127,0,127,合庫-台中,2024-08-28,1021
2890,永豐金,121,12,109,合庫-台中,2024-08-28,1021
00753L,中信中國50正2,66,0,66,合庫-台中,2024-08-28,1021
00665L,富邦�琤肭磪囓�2,235,170,65,合庫-台中,2024-08-28,1021
3523,迎輝,65,2,63,合庫-台中,2024-08-28,1021
00637L,元大滬深300正2,231,170,61,合庫-台中,2024-08-28,1021
00929,復華台灣科技優息,117,58,59,合庫-台中,2024-08-28,1021
00679B,元大美債20年,64,10,54,合庫-台中,2024-08-28,1021
00919,群益台灣精選高息,55,1,54,合庫-台中,2024-08-28,1021
6834,天二科技,50,0,50,合庫-台中,2024-08-28,1021
2409,友達,81,34,47,合庫-台中,2024-08-28,1021
1597,直得,43,2,41,合庫-台中,2024-08-28,1021
8028,昇陽半導體,72,32,40,合庫-台中,2024-08-28,1021
3062,建漢,66,26,40,合庫-台中,2024-08-28,1021
8039,台虹,132,97,35,合庫-台中,2024-08-28,1021
3047,訊舟,49,14,35,合庫-台中,2024-08-28,1021
6215,和椿,34,4,30,合庫-台中,2024-08-28,1021
00725B,國泰投資級公司債,30,0,30,合庫-台中,2024-08-28,1021
3167,大量,81,51,30,合庫-台中,2024-08-28,1021
00687B,國泰20年美債,46,16,30,合庫-台中,2024-08-28,1021
6188,廣明,38,10,28,合庫-台中,2024-08-28,1021
2365,昆盈,36,9,27,合庫-台中,2024-08-28,1021
00935,野村臺灣新科技50,26,0,26,合庫-台中,2024-08-28,1021
3581,博磊,44,19,25,合庫-台中,2024-08-28,1021
2486,一詮,28,3,25,合庫-台中,2024-08-28,1021
2884,玉山金,24,0,24,合庫-台中,2024-08-28,1021
2354,鴻準,30,7,23,合庫-台中,2024-08-28,1021
3105,穩懋,23,0,23,合庫-台中,2024-08-28,1021
00937B,群益ESG投等債20,82,59,23,合庫-台中,2024-08-28,1021
4303,信立,90,67,23,合庫-台中,2024-08-28,1021
2637,慧洋-KY,20,0,20,合庫-台中,2024-08-28,1021
2539,櫻花建,20,0,20,合庫-台中,2024-08-28,1021
6695,芯鼎,19,1,18,合庫-台中,2024-08-28,1021
2062,橋椿,119,101,18,合庫-台中,2024-08-28,1021
1530,亞崴,18,0,18,合庫-台中,2024-08-28,1021
00795B,中信美國公債20年,18,0,18,合庫-台中,2024-08-28,1021
6603,富強鑫,32,14,18,合庫-台中,2024-08-28,1021
00953B,群益優選非投等債,20,3,17,合庫-台中,2024-08-28,1021
6609,瀧澤科,23,6,17,合庫-台中,2024-08-28,1021
2880,華南金,15,0,15,合庫-台中,2024-08-28,1021
6863,永道-KY,15,0,15,合庫-台中,2024-08-28,1021
4909,新復興,16,1,15,合庫-台中,2024-08-28,1021
00933B,國泰10Y+金融債,14,0,14,合庫-台中,2024-08-28,1021
2489,瑞軒,13,0,13,合庫-台中,2024-08-28,1021
00959B,大華投等美債15Y+,13,0,13,合庫-台中,2024-08-28,1021
1409,新纖,13,0,13,合庫-台中,2024-08-28,1021
00937B,群益ESG投等債20,2767,3,2764,合庫-台中,2024-08-29,1021
00687B,國泰20年美債,1073,0,1073,合庫-台中,2024-08-29,1021
00715L,期街口布蘭特正2,247,11,236,合庫-台中,2024-08-29,1021
00664R,國泰臺灣加權反1,201,0,201,合庫-台中,2024-08-29,1021
00679B,元大美債20年,196,1,195,合庫-台中,2024-08-29,1021
00650L,復華香港正2,284,113,171,合庫-台中,2024-08-29,1021
2891,中信金,172,21,151,合庫-台中,2024-08-29,1021
2890,永豐金,133,22,111,合庫-台中,2024-08-29,1021
2356,英業達,112,5,107,合庫-台中,2024-08-29,1021
00680L,元大美債20正2,106,5,101,合庫-台中,2024-08-29,1021
3481,群創,227,140,87,合庫-台中,2024-08-29,1021
00878,國泰永續高股息,85,17,68,合庫-台中,2024-08-29,1021
00933B,國泰10Y+金融債,66,0,66,合庫-台中,2024-08-29,1021
2515,中工,76,11,65,合庫-台中,2024-08-29,1021
2317,鴻海,114,51,63,合庫-台中,2024-08-29,1021
00665L,富邦�琤肭磪囓�2,181,119,62,合庫-台中,2024-08-29,1021
2886,兆豐金,57,0,57,合庫-台中,2024-08-29,1021
2382,廣達,73,16,57,合庫-台中,2024-08-29,1021
6133,金橋,56,2,54,合庫-台中,2024-08-29,1021
2610,華航,53,2,51,合庫-台中,2024-08-29,1021
00907,永豐優息存股,50,0,50,合庫-台中,2024-08-29,1021
1721,三晃,50,6,44,合庫-台中,2024-08-29,1021
2801,彰銀,38,0,38,合庫-台中,2024-08-29,1021
2330,台積電,49,11,38,合庫-台中,2024-08-29,1021
00919,群益台灣精選高息,87,50,37,合庫-台中,2024-08-29,1021
00632R,元大台灣50反1,445,410,35,合庫-台中,2024-08-29,1021
00936,台新永續高息中小,35,0,35,合庫-台中,2024-08-29,1021
4526,東台,138,103,35,合庫-台中,2024-08-29,1021
6603,富強鑫,56,22,34,合庫-台中,2024-08-29,1021
8070,長華*,33,0,33,合庫-台中,2024-08-29,1021
00725B,國泰投資級公司債,32,0,32,合庫-台中,2024-08-29,1021
2303,聯電,38,7,31,合庫-台中,2024-08-29,1021
00922,國泰台灣領袖50,31,0,31,合庫-台中,2024-08-29,1021
00918,大華優利高填息30,28,0,28,合庫-台中,2024-08-29,1021
4561,健椿,67,40,27,合庫-台中,2024-08-29,1021
00637L,元大滬深300正2,135,110,25,合庫-台中,2024-08-29,1021
5521,工信,25,0,25,合庫-台中,2024-08-29,1021
3231,緯創,25,2,23,合庫-台中,2024-08-29,1021
00934,中信成長高股息,22,0,22,合庫-台中,2024-08-29,1021
3615,安可,29,8,21,合庫-台中,2024-08-29,1021
2539,櫻花建,20,0,20,合庫-台中,2024-08-29,1021
3689,湧德,23,3,20,合庫-台中,2024-08-29,1021
2464,盟立,38,18,20,合庫-台中,2024-08-29,1021
2062,橋椿,20,1,19,合庫-台中,2024-08-29,1021
6788,華景電,21,2,19,合庫-台中,2024-08-29,1021
00915,凱基優選高股息30,22,4,18,合庫-台中,2024-08-29,1021
2314,台揚,23,5,18,合庫-台中,2024-08-29,1021
2912,統一超,17,0,17,合庫-台中,2024-08-29,1021
8096,擎亞,32,15,17,合庫-台中,2024-08-29,1021
2486,一詮,17,1,16,合庫-台中,2024-08-29,1021
2409,友達,192,9,183,合庫-台中,2024-08-30,1021
00687B,國泰20年美債,172,6,166,合庫-台中,2024-08-30,1021
4526,東台,255,116,139,合庫-台中,2024-08-30,1021
1314,中石化,120,5,115,合庫-台中,2024-08-30,1021
00632R,元大台灣50反1,530,415,115,合庫-台中,2024-08-30,1021
00948B,中信優息投資級債,115,2,113,合庫-台中,2024-08-30,1021
2609,陽明,129,22,107,合庫-台中,2024-08-30,1021
3167,大量,134,34,100,合庫-台中,2024-08-30,1021
00673R,期元大S＆P原油反1,76,0,76,合庫-台中,2024-08-30,1021
2886,兆豐金,70,0,70,合庫-台中,2024-08-30,1021
00915,凱基優選高股息30,73,3,70,合庫-台中,2024-08-30,1021
2891,中信金,87,23,64,合庫-台中,2024-08-30,1021
3481,群創,118,55,63,合庫-台中,2024-08-30,1021
2801,彰銀,62,0,62,合庫-台中,2024-08-30,1021
00679B,元大美債20年,72,15,57,合庫-台中,2024-08-30,1021
00680L,元大美債20正2,52,0,52,合庫-台中,2024-08-30,1021
2399,映泰,55,4,51,合庫-台中,2024-08-30,1021
6743,安普新,59,12,47,合庫-台中,2024-08-30,1021
2330,台積電,58,15,43,合庫-台中,2024-08-30,1021
3062,建漢,59,21,38,合庫-台中,2024-08-30,1021
2883,凱基金,91,53,38,合庫-台中,2024-08-30,1021
00959B,大華投等美債15Y+,37,0,37,合庫-台中,2024-08-30,1021
2845,遠東銀,35,0,35,合庫-台中,2024-08-30,1021
9802,鈺齊-KY,35,0,35,合庫-台中,2024-08-30,1021
8071,能率網通,35,2,33,合庫-台中,2024-08-30,1021
6133,金橋,33,2,31,合庫-台中,2024-08-30,1021
3374,精材,42,12,30,合庫-台中,2024-08-30,1021
3005,神基,53,23,30,合庫-台中,2024-08-30,1021
00725B,國泰投資級公司債,29,0,29,合庫-台中,2024-08-30,1021
6156,松上,40,14,26,合庫-台中,2024-08-30,1021
8028,昇陽半導體,41,16,25,合庫-台中,2024-08-30,1021
00937B,群益ESG投等債20,47,22,25,合庫-台中,2024-08-30,1021
3523,迎輝,25,0,25,合庫-台中,2024-08-30,1021
2367,燿華,143,118,25,合庫-台中,2024-08-30,1021
1711,永光,329,306,23,合庫-台中,2024-08-30,1021
2323,中環,24,2,22,合庫-台中,2024-08-30,1021
3663,鑫科,32,12,20,合庫-台中,2024-08-30,1021
00751B,元大AAA至A公司債,20,0,20,合庫-台中,2024-08-30,1021
6285,啟��,20,0,20,合庫-台中,2024-08-30,1021
6895,宏碩系統,19,0,19,合庫-台中,2024-08-30,1021
8064,東捷,73,54,19,合庫-台中,2024-08-30,1021
6168,宏齊,20,1,19,合庫-台中,2024-08-30,1021
4909,新復興,30,11,19,合庫-台中,2024-08-30,1021
3490,單井,21,3,18,合庫-台中,2024-08-30,1021
3576,聯合再生,21,3,18,合庫-台中,2024-08-30,1021
3015,全漢,29,12,17,合庫-台中,2024-08-30,1021
00933B,國泰10Y+金融債,17,0,17,合庫-台中,2024-08-30,1021
00712,復華富時不動產,21,5,16,合庫-台中,2024-08-30,1021
6834,天二科技,16,0,16,合庫-台中,2024-08-30,1021
2408,南亞科,16,0,16,合庫-台中,2024-08-30,1021
2615,萬海,381,12,369,合庫-台中,2024-09-02,1021
00715L,期街口布蘭特正2,611,251,360,合庫-台中,2024-09-02,1021
00665L,富邦�琤肭磪囓�2,380,60,320,合庫-台中,2024-09-02,1021
00929,復華台灣科技優息,279,22,257,合庫-台中,2024-09-02,1021
00687B,國泰20年美債,205,1,204,合庫-台中,2024-09-02,1021
00680L,元大美債20正2,185,15,170,合庫-台中,2024-09-02,1021
9902,台火,139,0,139,合庫-台中,2024-09-02,1021
3481,群創,186,51,135,合庫-台中,2024-09-02,1021
2882,國泰金,131,24,107,合庫-台中,2024-09-02,1021
00915,凱基優選高股息30,104,6,98,合庫-台中,2024-09-02,1021
4526,東台,235,144,91,合庫-台中,2024-09-02,1021
00940,元大台灣價值高息,134,59,75,合庫-台中,2024-09-02,1021
00642U,期元大S＆P石油,75,0,75,合庫-台中,2024-09-02,1021
2609,陽明,73,4,69,合庫-台中,2024-09-02,1021
3523,迎輝,66,0,66,合庫-台中,2024-09-02,1021
00712,復華富時不動產,57,1,56,合庫-台中,2024-09-02,1021
00959B,大華投等美債15Y+,53,0,53,合庫-台中,2024-09-02,1021
00878,國泰永續高股息,67,19,48,合庫-台中,2024-09-02,1021
1314,中石化,48,0,48,合庫-台中,2024-09-02,1021
6016,康和證,41,0,41,合庫-台中,2024-09-02,1021
9945,潤泰新,51,10,41,合庫-台中,2024-09-02,1021
2399,映泰,40,1,39,合庫-台中,2024-09-02,1021
00650L,復華香港正2,129,90,39,合庫-台中,2024-09-02,1021
00937B,群益ESG投等債20,71,34,37,合庫-台中,2024-09-02,1021
00679B,元大美債20年,72,38,34,合庫-台中,2024-09-02,1021
00688L,國泰20年美債正2,34,0,34,合庫-台中,2024-09-02,1021
6431,光麗-KY,33,0,33,合庫-台中,2024-09-02,1021
8085,福華,39,8,31,合庫-台中,2024-09-02,1021
00918,大華優利高填息30,43,12,31,合庫-台中,2024-09-02,1021
00719B,元大美債1-3,30,0,30,合庫-台中,2024-09-02,1021
00882,中信中國高股息,26,0,26,合庫-台中,2024-09-02,1021
00933B,國泰10Y+金融債,26,0,26,合庫-台中,2024-09-02,1021
00752,中信中國50,25,0,25,合庫-台中,2024-09-02,1021
00948B,中信優息投資級債,25,0,25,合庫-台中,2024-09-02,1021
00706L,期元大S＆P日圓正2,24,0,24,合庫-台中,2024-09-02,1021
4426,利勤,24,0,24,合庫-台中,2024-09-02,1021
2402,毅嘉,27,3,24,合庫-台中,2024-09-02,1021
3374,精材,32,9,23,合庫-台中,2024-09-02,1021
3231,緯創,42,19,23,合庫-台中,2024-09-02,1021
2008,高興昌,23,0,23,合庫-台中,2024-09-02,1021
2062,橋椿,22,0,22,合庫-台中,2024-09-02,1021
3293,鈊象,23,1,22,合庫-台中,2024-09-02,1021
2388,威盛,21,0,21,合庫-台中,2024-09-02,1021
00655L,國泰中國A50正2,21,0,21,合庫-台中,2024-09-02,1021
3227,原相,27,6,21,合庫-台中,2024-09-02,1021
2344,華邦電,30,10,20,合庫-台中,2024-09-02,1021
3339,泰谷,20,0,20,合庫-台中,2024-09-02,1021
00919,群益台灣精選高息,100,81,19,合庫-台中,2024-09-02,1021
2313,華通,116,98,18,合庫-台中,2024-09-02,1021
6274,台燿,28,11,17,合庫-台中,2024-09-02,1021
00919,群益台灣精選高息,301,7,294,合庫-台中,2024-09-03,1021
00937B,群益ESG投等債20,310,42,268,合庫-台中,2024-09-03,1021
9902,台火,216,0,216,合庫-台中,2024-09-03,1021
00680L,元大美債20正2,221,40,181,合庫-台中,2024-09-03,1021
00715L,期街口布蘭特正2,385,213,172,合庫-台中,2024-09-03,1021
00687B,國泰20年美債,151,0,151,合庫-台中,2024-09-03,1021
00918,大華優利高填息30,156,16,140,合庫-台中,2024-09-03,1021
2615,萬海,150,17,133,合庫-台中,2024-09-03,1021
1314,中石化,144,24,120,合庫-台中,2024-09-03,1021
00915,凱基優選高股息30,135,20,115,合庫-台中,2024-09-03,1021
00679B,元大美債20年,93,0,93,合庫-台中,2024-09-03,1021
00637L,元大滬深300正2,169,80,89,合庫-台中,2024-09-03,1021
1785,光洋科,114,43,71,合庫-台中,2024-09-03,1021
6213,聯茂,104,41,63,合庫-台中,2024-09-03,1021
00665L,富邦�琤肭磪囓�2,174,112,62,合庫-台中,2024-09-03,1021
2409,友達,71,12,59,合庫-台中,2024-09-03,1021
00954,中信日本半導體,53,0,53,合庫-台中,2024-09-03,1021
6431,光麗-KY,49,0,49,合庫-台中,2024-09-03,1021
2610,華航,46,5,41,合庫-台中,2024-09-03,1021
00878,國泰永續高股息,41,0,41,合庫-台中,2024-09-03,1021
6834,天二科技,39,0,39,合庫-台中,2024-09-03,1021
4906,正文,39,5,34,合庫-台中,2024-09-03,1021
2486,一詮,121,88,33,合庫-台中,2024-09-03,1021
2891,中信金,33,0,33,合庫-台中,2024-09-03,1021
00948B,中信優息投資級債,33,0,33,合庫-台中,2024-09-03,1021
2884,玉山金,32,0,32,合庫-台中,2024-09-03,1021
00882,中信中國高股息,33,2,31,合庫-台中,2024-09-03,1021
5484,慧友,30,0,30,合庫-台中,2024-09-03,1021
2515,中工,29,0,29,合庫-台中,2024-09-03,1021
3231,緯創,61,32,29,合庫-台中,2024-09-03,1021
1101,台泥,29,0,29,合庫-台中,2024-09-03,1021
4111,濟生,28,0,28,合庫-台中,2024-09-03,1021
8027,鈦昇,88,61,27,合庫-台中,2024-09-03,1021
4919,新唐,27,0,27,合庫-台中,2024-09-03,1021
2323,中環,27,0,27,合庫-台中,2024-09-03,1021
00940,元大台灣價值高息,38,13,25,合庫-台中,2024-09-03,1021
00939,統一台灣高息動能,24,0,24,合庫-台中,2024-09-03,1021
3037,欣興,23,1,22,合庫-台中,2024-09-03,1021
3062,建漢,31,9,22,合庫-台中,2024-09-03,1021
4714,永捷,35,13,22,合庫-台中,2024-09-03,1021
6116,彩晶,22,0,22,合庫-台中,2024-09-03,1021
2002,中鋼,26,6,20,合庫-台中,2024-09-03,1021
2313,華通,136,116,20,合庫-台中,2024-09-03,1021
00933B,國泰10Y+金融債,20,0,20,合庫-台中,2024-09-03,1021
6658,聯策,20,0,20,合庫-台中,2024-09-03,1021
3689,湧德,21,2,19,合庫-台中,2024-09-03,1021
2399,映泰,18,0,18,合庫-台中,2024-09-03,1021
6114,久威,19,1,18,合庫-台中,2024-09-03,1021
2402,毅嘉,18,1,17,合庫-台中,2024-09-03,1021
2449,京元電子,23,6,17,合庫-台中,2024-09-03,1021
00940,元大台灣價值高息,659,129,530,合庫-台中,2024-09-04,1021
00929,復華台灣科技優息,558,51,507,合庫-台中,2024-09-04,1021
00919,群益台灣精選高息,609,146,463,合庫-台中,2024-09-04,1021
00878,國泰永續高股息,370,32,338,合庫-台中,2024-09-04,1021
00951,台新日本半導體,291,0,291,合庫-台中,2024-09-04,1021
00918,大華優利高填息30,291,51,240,合庫-台中,2024-09-04,1021
2883,凱基金,240,2,238,合庫-台中,2024-09-04,1021
00665L,富邦�琤肭磪囓�2,355,132,223,合庫-台中,2024-09-04,1021
0056,元大高股息,199,2,197,合庫-台中,2024-09-04,1021
00937B,群益ESG投等債20,281,91,190,合庫-台中,2024-09-04,1021
00664R,國泰臺灣加權反1,200,16,184,合庫-台中,2024-09-04,1021
00915,凱基優選高股息30,182,4,178,合庫-台中,2024-09-04,1021
3481,群創,163,17,146,合庫-台中,2024-09-04,1021
5880,合庫金,150,13,137,合庫-台中,2024-09-04,1021
00679B,元大美債20年,162,49,113,合庫-台中,2024-09-04,1021
6005,群益證,111,2,109,合庫-台中,2024-09-04,1021
2885,元大金,112,4,108,合庫-台中,2024-09-04,1021
8105,凌巨,108,7,101,合庫-台中,2024-09-04,1021
2801,彰銀,103,3,100,合庫-台中,2024-09-04,1021
2317,鴻海,199,102,97,合庫-台中,2024-09-04,1021
00830,國泰費城半導體,96,1,95,合庫-台中,2024-09-04,1021
00650L,復華香港正2,249,161,88,合庫-台中,2024-09-04,1021
2886,兆豐金,88,1,87,合庫-台中,2024-09-04,1021
00688L,國泰20年美債正2,110,24,86,合庫-台中,2024-09-04,1021
2887,台新金,87,4,83,合庫-台中,2024-09-04,1021
2834,臺企銀,106,25,81,合庫-台中,2024-09-04,1021
2002,中鋼,81,4,77,合庫-台中,2024-09-04,1021
00891,中信關鍵半導體,77,1,76,合庫-台中,2024-09-04,1021
00881,國泰台灣5G+,82,8,74,合庫-台中,2024-09-04,1021
00642U,期元大S＆P石油,73,0,73,合庫-台中,2024-09-04,1021
2891,中信金,113,42,71,合庫-台中,2024-09-04,1021
2890,永豐金,117,50,67,合庫-台中,2024-09-04,1021
00954,中信日本半導體,65,3,62,合庫-台中,2024-09-04,1021
2637,慧洋-KY,60,0,60,合庫-台中,2024-09-04,1021
3037,欣興,64,7,57,合庫-台中,2024-09-04,1021
1326,台化,63,7,56,合庫-台中,2024-09-04,1021
0050,元大台灣50,62,6,56,合庫-台中,2024-09-04,1021
2330,台積電,139,87,52,合庫-台中,2024-09-04,1021
2382,廣達,87,36,51,合庫-台中,2024-09-04,1021
00943,兆豐電子高息等權,50,0,50,合庫-台中,2024-09-04,1021
00923,群益台ESG低碳50,48,0,48,合庫-台中,2024-09-04,1021
2845,遠東銀,67,20,47,合庫-台中,2024-09-04,1021
00713,元大台灣高息低波,49,4,45,合庫-台中,2024-09-04,1021
2208,台船,45,0,45,合庫-台中,2024-09-04,1021
9902,台火,44,0,44,合庫-台中,2024-09-04,1021
2881,富邦金,44,1,43,合庫-台中,2024-09-04,1021
1303,南亞,46,4,42,合庫-台中,2024-09-04,1021
1316,上曜,39,0,39,合庫-台中,2024-09-04,1021
2851,中再保,37,0,37,合庫-台中,2024-09-04,1021
8442,威宏-KY,37,0,37,合庫-台中,2024-09-04,1021
00937B,群益ESG投等債20,1147,161,986,合庫-台中,2024-09-05,1021
00715L,期街口布蘭特正2,887,85,802,合庫-台中,2024-09-05,1021
00632R,元大台灣50反1,882,540,342,合庫-台中,2024-09-05,1021
00919,群益台灣精選高息,289,24,265,合庫-台中,2024-09-05,1021
00706L,期元大S＆P日圓正2,206,30,176,合庫-台中,2024-09-05,1021
00943,兆豐電子高息等權,176,0,176,合庫-台中,2024-09-05,1021
00664R,國泰臺灣加權反1,179,10,169,合庫-台中,2024-09-05,1021
00878,國泰永續高股息,174,23,151,合庫-台中,2024-09-05,1021
00929,復華台灣科技優息,185,50,135,合庫-台中,2024-09-05,1021
6125,廣運,126,1,125,合庫-台中,2024-09-05,1021
00940,元大台灣價值高息,141,17,124,合庫-台中,2024-09-05,1021
00952,凱基台灣AI50,121,0,121,合庫-台中,2024-09-05,1021
00753L,中信中國50正2,100,0,100,合庫-台中,2024-09-05,1021
00918,大華優利高填息30,90,2,88,合庫-台中,2024-09-05,1021
3481,群創,97,9,88,合庫-台中,2024-09-05,1021
2317,鴻海,140,53,87,合庫-台中,2024-09-05,1021
00676R,富邦臺灣加權反1,79,0,79,合庫-台中,2024-09-05,1021
00951,台新日本半導體,64,0,64,合庫-台中,2024-09-05,1021
9902,台火,61,0,61,合庫-台中,2024-09-05,1021
4979,華星光,70,10,60,合庫-台中,2024-09-05,1021
2002,中鋼,54,1,53,合庫-台中,2024-09-05,1021
00671R,富邦NASDAQ反1,50,0,50,合庫-台中,2024-09-05,1021
2884,玉山金,70,21,49,合庫-台中,2024-09-05,1021
00686R,群益臺灣加權反1,49,0,49,合庫-台中,2024-09-05,1021
00881,國泰台灣5G+,55,8,47,合庫-台中,2024-09-05,1021
8028,昇陽半導體,50,4,46,合庫-台中,2024-09-05,1021
00712,復華富時不動產,43,0,43,合庫-台中,2024-09-05,1021
3047,訊舟,71,28,43,合庫-台中,2024-09-05,1021
1528,恩德,42,0,42,合庫-台中,2024-09-05,1021
2486,一詮,110,70,40,合庫-台中,2024-09-05,1021
2382,廣達,47,8,39,合庫-台中,2024-09-05,1021
4950,牧東,40,7,33,合庫-台中,2024-09-05,1021
2338,光罩,39,6,33,合庫-台中,2024-09-05,1021
00921,兆豐龍頭等權重,32,0,32,合庫-台中,2024-09-05,1021
2337,旺宏,37,5,32,合庫-台中,2024-09-05,1021
5443,均豪,46,15,31,合庫-台中,2024-09-05,1021
2344,華邦電,34,3,31,合庫-台中,2024-09-05,1021
00915,凱基優選高股息30,38,7,31,合庫-台中,2024-09-05,1021
3202,樺晟,30,0,30,合庫-台中,2024-09-05,1021
4109,加捷生醫,30,0,30,合庫-台中,2024-09-05,1021
8070,長華*,42,12,30,合庫-台中,2024-09-05,1021
00946,群益科技高息成長,33,3,30,合庫-台中,2024-09-05,1021
1314,中石化,40,11,29,合庫-台中,2024-09-05,1021
4510,高鋒,98,69,29,合庫-台中,2024-09-05,1021
2539,櫻花建,28,0,28,合庫-台中,2024-09-05,1021
3581,博磊,44,17,27,合庫-台中,2024-09-05,1021
4561,健椿,42,18,24,合庫-台中,2024-09-05,1021
4906,正文,25,1,24,合庫-台中,2024-09-05,1021
00751B,元大AAA至A公司債,26,2,24,合庫-台中,2024-09-05,1021
2353,宏��,26,3,23,合庫-台中,2024-09-05,1021
2891,中信金,387,12,375,合庫-台中,2024-09-06,1021
00715L,期街口布蘭特正2,243,15,228,合庫-台中,2024-09-06,1021
00687B,國泰20年美債,291,86,205,合庫-台中,2024-09-06,1021
00937B,群益ESG投等債20,307,107,200,合庫-台中,2024-09-06,1021
00779B,凱基美債25+,171,0,171,合庫-台中,2024-09-06,1021
00929,復華台灣科技優息,275,132,143,合庫-台中,2024-09-06,1021
00679B,元大美債20年,236,96,140,合庫-台中,2024-09-06,1021
1711,永光,126,19,107,合庫-台中,2024-09-06,1021
2609,陽明,124,50,74,合庫-台中,2024-09-06,1021
3481,群創,97,26,71,合庫-台中,2024-09-06,1021
2002,中鋼,68,1,67,合庫-台中,2024-09-06,1021
1815,富喬,81,30,51,合庫-台中,2024-09-06,1021
00686R,群益臺灣加權反1,50,0,50,合庫-台中,2024-09-06,1021
00764B,群益25年美債,49,0,49,合庫-台中,2024-09-06,1021
00878,國泰永續高股息,54,8,46,合庫-台中,2024-09-06,1021
9902,台火,42,0,42,合庫-台中,2024-09-06,1021
2344,華邦電,68,26,42,合庫-台中,2024-09-06,1021
00918,大華優利高填息30,43,5,38,合庫-台中,2024-09-06,1021
2539,櫻花建,36,0,36,合庫-台中,2024-09-06,1021
8374,羅昇,70,34,36,合庫-台中,2024-09-06,1021
4566,時碩工業,36,2,34,合庫-台中,2024-09-06,1021
6016,康和證,30,0,30,合庫-台中,2024-09-06,1021
2464,盟立,86,56,30,合庫-台中,2024-09-06,1021
1530,亞崴,29,0,29,合庫-台中,2024-09-06,1021
00915,凱基優選高股息30,29,2,27,合庫-台中,2024-09-06,1021
3437,榮創,43,16,27,合庫-台中,2024-09-06,1021
6431,光麗-KY,26,0,26,合庫-台中,2024-09-06,1021
00943,兆豐電子高息等權,24,0,24,合庫-台中,2024-09-06,1021
00949,復華日本龍頭,26,2,24,合庫-台中,2024-09-06,1021
0056,元大高股息,23,0,23,合庫-台中,2024-09-06,1021
8070,長華*,36,13,23,合庫-台中,2024-09-06,1021
2409,友達,29,7,22,合庫-台中,2024-09-06,1021
4406,新昕纖,22,0,22,合庫-台中,2024-09-06,1021
00933B,國泰10Y+金融債,21,0,21,合庫-台中,2024-09-06,1021
00664R,國泰臺灣加權反1,20,0,20,合庫-台中,2024-09-06,1021
00676R,富邦臺灣加權反1,20,0,20,合庫-台中,2024-09-06,1021
00951,台新日本半導體,38,18,20,合庫-台中,2024-09-06,1021
4426,利勤,21,1,20,合庫-台中,2024-09-06,1021
6125,廣運,21,1,20,合庫-台中,2024-09-06,1021
3056,富華新,20,1,19,合庫-台中,2024-09-06,1021
3019,亞光,62,44,18,合庫-台中,2024-09-06,1021
3581,博磊,63,45,18,合庫-台中,2024-09-06,1021
2467,志聖,26,9,17,合庫-台中,2024-09-06,1021
00720B,元大投資級公司債,17,0,17,合庫-台中,2024-09-06,1021
00725B,國泰投資級公司債,16,0,16,合庫-台中,2024-09-06,1021
4561,健椿,29,13,16,合庫-台中,2024-09-06,1021
6706,惠特,38,22,16,合庫-台中,2024-09-06,1021
3276,宇環,16,1,15,合庫-台中,2024-09-06,1021
8105,凌巨,17,2,15,合庫-台中,2024-09-06,1021
2880,華南金,21,7,14,合庫-台中,2024-09-06,1021
00919,群益台灣精選高息,332,35,297,合庫-台中,2024-09-09,1021
00715L,期街口布蘭特正2,287,10,277,合庫-台中,2024-09-09,1021
00878,國泰永續高股息,248,14,234,合庫-台中,2024-09-09,1021
00680L,元大美債20正2,211,11,200,合庫-台中,2024-09-09,1021
00933B,國泰10Y+金融債,202,2,200,合庫-台中,2024-09-09,1021
0056,元大高股息,167,6,161,合庫-台中,2024-09-09,1021
2891,中信金,176,17,159,合庫-台中,2024-09-09,1021
00918,大華優利高填息30,172,20,152,合庫-台中,2024-09-09,1021
2885,元大金,142,10,132,合庫-台中,2024-09-09,1021
1301,台塑,122,2,120,合庫-台中,2024-09-09,1021
8249,菱光,116,12,104,合庫-台中,2024-09-09,1021
00753L,中信中國50正2,100,0,100,合庫-台中,2024-09-09,1021
00940,元大台灣價值高息,143,48,95,合庫-台中,2024-09-09,1021
2890,永豐金,95,12,83,合庫-台中,2024-09-09,1021
2539,櫻花建,72,0,72,合庫-台中,2024-09-09,1021
00881,國泰台灣5G+,68,2,66,合庫-台中,2024-09-09,1021
2881,富邦金,51,0,51,合庫-台中,2024-09-09,1021
2317,鴻海,95,50,45,合庫-台中,2024-09-09,1021
00929,復華台灣科技優息,313,270,43,合庫-台中,2024-09-09,1021
6005,群益證,51,10,41,合庫-台中,2024-09-09,1021
00637L,元大滬深300正2,161,120,41,合庫-台中,2024-09-09,1021
5388,中磊,40,0,40,合庫-台中,2024-09-09,1021
3293,鈊象,69,30,39,合庫-台中,2024-09-09,1021
1785,光洋科,57,18,39,合庫-台中,2024-09-09,1021
00665L,富邦�琤肭磪囓�2,213,180,33,合庫-台中,2024-09-09,1021
2615,萬海,43,11,32,合庫-台中,2024-09-09,1021
2367,燿華,35,4,31,合庫-台中,2024-09-09,1021
2349,錸德,132,103,29,合庫-台中,2024-09-09,1021
8071,能率網通,31,3,28,合庫-台中,2024-09-09,1021
006208,富邦台50,27,1,26,合庫-台中,2024-09-09,1021
00934,中信成長高股息,30,5,25,合庫-台中,2024-09-09,1021
00951,台新日本半導體,24,0,24,合庫-台中,2024-09-09,1021
6505,台塑化,24,1,23,合庫-台中,2024-09-09,1021
00915,凱基優選高股息30,35,12,23,合庫-台中,2024-09-09,1021
2354,鴻準,23,1,22,合庫-台中,2024-09-09,1021
9902,台火,22,0,22,合庫-台中,2024-09-09,1021
2409,友達,37,15,22,合庫-台中,2024-09-09,1021
2618,長榮航,39,17,22,合庫-台中,2024-09-09,1021
6441,廣錠,22,0,22,合庫-台中,2024-09-09,1021
2301,光寶科,21,1,20,合庫-台中,2024-09-09,1021
1905,華紙,20,0,20,合庫-台中,2024-09-09,1021
6194,育富,22,2,20,合庫-台中,2024-09-09,1021
2402,毅嘉,43,23,20,合庫-台中,2024-09-09,1021
3663,鑫科,60,40,20,合庫-台中,2024-09-09,1021
00947,台新臺灣IC設計,20,1,19,合庫-台中,2024-09-09,1021
8064,東捷,38,19,19,合庫-台中,2024-09-09,1021
1326,台化,26,8,18,合庫-台中,2024-09-09,1021
6215,和椿,22,4,18,合庫-台中,2024-09-09,1021
2303,聯電,33,16,17,合庫-台中,2024-09-09,1021
2356,英業達,19,3,16,合庫-台中,2024-09-09,1021
00632R,元大台灣50反1,1410,910,500,合庫-台中,2024-09-10,1021
00919,群益台灣精選高息,318,103,215,合庫-台中,2024-09-10,1021
00940,元大台灣價值高息,246,67,179,合庫-台中,2024-09-10,1021
00688L,國泰20年美債正2,179,2,177,合庫-台中,2024-09-10,1021
00918,大華優利高填息30,180,11,169,合庫-台中,2024-09-10,1021
00687B,國泰20年美債,262,139,123,合庫-台中,2024-09-10,1021
00715L,期街口布蘭特正2,147,30,117,合庫-台中,2024-09-10,1021
2382,廣達,135,20,115,合庫-台中,2024-09-10,1021
00878,國泰永續高股息,111,3,108,合庫-台中,2024-09-10,1021
00680L,元大美債20正2,165,59,106,合庫-台中,2024-09-10,1021
3481,群創,113,13,100,合庫-台中,2024-09-10,1021
6108,競國,93,0,93,合庫-台中,2024-09-10,1021
2317,鴻海,134,52,82,合庫-台中,2024-09-10,1021
00664R,國泰臺灣加權反1,80,0,80,合庫-台中,2024-09-10,1021
00929,復華台灣科技優息,151,83,68,合庫-台中,2024-09-10,1021
5880,合庫金,105,39,66,合庫-台中,2024-09-10,1021
2485,兆赫,62,0,62,合庫-台中,2024-09-10,1021
0056,元大高股息,65,8,57,合庫-台中,2024-09-10,1021
2002,中鋼,74,18,56,合庫-台中,2024-09-10,1021
00679B,元大美債20年,113,58,55,合庫-台中,2024-09-10,1021
2344,華邦電,68,24,44,合庫-台中,2024-09-10,1021
3535,晶彩科,46,3,43,合庫-台中,2024-09-10,1021
2330,台積電,49,8,41,合庫-台中,2024-09-10,1021
8111,立��,41,0,41,合庫-台中,2024-09-10,1021
3379,彬台,38,0,38,合庫-台中,2024-09-10,1021
2313,華通,220,185,35,合庫-台中,2024-09-10,1021
3293,鈊象,33,1,32,合庫-台中,2024-09-10,1021
2062,橋椿,34,2,32,合庫-台中,2024-09-10,1021
2337,旺宏,32,0,32,合庫-台中,2024-09-10,1021
00888,永豐台灣ESG,32,1,31,合庫-台中,2024-09-10,1021
6213,聯茂,29,1,28,合庫-台中,2024-09-10,1021
4763,材料-KY,31,3,28,合庫-台中,2024-09-10,1021
4127,天良,28,1,27,合庫-台中,2024-09-10,1021
00915,凱基優選高股息30,38,13,25,合庫-台中,2024-09-10,1021
2303,聯電,81,57,24,合庫-台中,2024-09-10,1021
3025,星通,55,32,23,合庫-台中,2024-09-10,1021
2539,櫻花建,22,0,22,合庫-台中,2024-09-10,1021
1605,華新,22,0,22,合庫-台中,2024-09-10,1021
00881,國泰台灣5G+,33,12,21,合庫-台中,2024-09-10,1021
00751B,元大AAA至A公司債,51,30,21,合庫-台中,2024-09-10,1021
1314,中石化,22,1,21,合庫-台中,2024-09-10,1021
00946,群益科技高息成長,20,0,20,合庫-台中,2024-09-10,1021
00930,永豐ESG低碳高息,22,2,20,合庫-台中,2024-09-10,1021
4513,福裕,27,7,20,合庫-台中,2024-09-10,1021
3050,鈺德,20,0,20,合庫-台中,2024-09-10,1021
00942B,台新美A公司債20+,19,0,19,合庫-台中,2024-09-10,1021
2609,陽明,55,37,18,合庫-台中,2024-09-10,1021
9136,巨騰-DR,37,19,18,合庫-台中,2024-09-10,1021
4564,元翎,29,11,18,合庫-台中,2024-09-10,1021
2408,南亞科,18,1,17,合庫-台中,2024-09-10,1021
00632R,元大台灣50反1,2917,400,2517,合庫-台中,2024-09-11,1021
00706L,期元大S＆P日圓正2,758,50,708,合庫-台中,2024-09-11,1021
00937B,群益ESG投等債20,541,30,511,合庫-台中,2024-09-11,1021
4950,牧東,236,2,234,合庫-台中,2024-09-11,1021
00940,元大台灣價值高息,229,35,194,合庫-台中,2024-09-11,1021
00929,復華台灣科技優息,146,24,122,合庫-台中,2024-09-11,1021
00688L,國泰20年美債正2,116,4,112,合庫-台中,2024-09-11,1021
00919,群益台灣精選高息,147,39,108,合庫-台中,2024-09-11,1021
2834,臺企銀,115,10,105,合庫-台中,2024-09-11,1021
2891,中信金,115,21,94,合庫-台中,2024-09-11,1021
00712,復華富時不動產,92,8,84,合庫-台中,2024-09-11,1021
00948B,中信優息投資級債,81,0,81,合庫-台中,2024-09-11,1021
00915,凱基優選高股息30,79,2,77,合庫-台中,2024-09-11,1021
00878,國泰永續高股息,75,3,72,合庫-台中,2024-09-11,1021
4510,高鋒,135,67,68,合庫-台中,2024-09-11,1021
00665L,富邦�琤肭磪囓�2,194,126,68,合庫-台中,2024-09-11,1021
00687B,國泰20年美債,145,85,60,合庫-台中,2024-09-11,1021
2537,聯上發,59,4,55,合庫-台中,2024-09-11,1021
0056,元大高股息,46,1,45,合庫-台中,2024-09-11,1021
00764B,群益25年美債,40,0,40,合庫-台中,2024-09-11,1021
00664R,國泰臺灣加權反1,40,0,40,合庫-台中,2024-09-11,1021
00673R,期元大S＆P原油反1,50,10,40,合庫-台中,2024-09-11,1021
4566,時碩工業,67,28,39,合庫-台中,2024-09-11,1021
00680L,元大美債20正2,215,178,37,合庫-台中,2024-09-11,1021
2883,凱基金,38,2,36,合庫-台中,2024-09-11,1021
00857B,永豐20年美公債,32,0,32,合庫-台中,2024-09-11,1021
5876,上海商銀,32,0,32,合庫-台中,2024-09-11,1021
00918,大華優利高填息30,29,2,27,合庫-台中,2024-09-11,1021
1522,堤維西,29,4,25,合庫-台中,2024-09-11,1021
2890,永豐金,59,34,25,合庫-台中,2024-09-11,1021
6194,育富,26,3,23,合庫-台中,2024-09-11,1021
6743,安普新,94,71,23,合庫-台中,2024-09-11,1021
2323,中環,25,2,23,合庫-台中,2024-09-11,1021
2497,怡利電,113,91,22,合庫-台中,2024-09-11,1021
1506,正道,20,0,20,合庫-台中,2024-09-11,1021
6108,競國,20,0,20,合庫-台中,2024-09-11,1021
1314,中石化,20,3,17,合庫-台中,2024-09-11,1021
3576,聯合再生,22,6,16,合庫-台中,2024-09-11,1021
00957B,兆豐US優選投等債,18,2,16,合庫-台中,2024-09-11,1021
4906,正文,20,5,15,合庫-台中,2024-09-11,1021
2338,光罩,22,7,15,合庫-台中,2024-09-11,1021
6443,元晶,15,0,15,合庫-台中,2024-09-11,1021
00900,富邦特選高股息30,15,0,15,合庫-台中,2024-09-11,1021
1514,亞力,14,0,14,合庫-台中,2024-09-11,1021
2539,櫻花建,16,2,14,合庫-台中,2024-09-11,1021
1301,台塑,28,14,14,合庫-台中,2024-09-11,1021
4113,聯上,13,0,13,合庫-台中,2024-09-11,1021
2897A,王道銀甲特,12,0,12,合庫-台中,2024-09-11,1021
6204,艾華,15,3,12,合庫-台中,2024-09-11,1021
6139,亞翔,15,3,12,合庫-台中,2024-09-11,1021
00665L,富邦�琤肭磪囓�2,903,99,804,合庫-台中,2024-09-12,1021
00680L,元大美債20正2,436,86,350,合庫-台中,2024-09-12,1021
1711,永光,143,44,99,合庫-台中,2024-09-12,1021
00715L,期街口布蘭特正2,99,21,78,合庫-台中,2024-09-12,1021
00935,野村臺灣新科技50,76,5,71,合庫-台中,2024-09-12,1021
2891,中信金,71,4,67,合庫-台中,2024-09-12,1021
00918,大華優利高填息30,68,4,64,合庫-台中,2024-09-12,1021
00673R,期元大S＆P原油反1,53,0,53,合庫-台中,2024-09-12,1021
00679B,元大美債20年,92,40,52,合庫-台中,2024-09-12,1021
6016,康和證,41,0,41,合庫-台中,2024-09-12,1021
5009,榮剛,34,0,34,合庫-台中,2024-09-12,1021
00921,兆豐龍頭等權重,29,2,27,合庫-台中,2024-09-12,1021
00915,凱基優選高股息30,27,0,27,合庫-台中,2024-09-12,1021
4958,臻鼎-KY,29,3,26,合庫-台中,2024-09-12,1021
4561,健椿,27,4,23,合庫-台中,2024-09-12,1021
2539,櫻花建,21,0,21,合庫-台中,2024-09-12,1021
6152,百一,25,4,21,合庫-台中,2024-09-12,1021
1506,正道,20,0,20,合庫-台中,2024-09-12,1021
4960,誠美材,20,0,20,合庫-台中,2024-09-12,1021
00764B,群益25年美債,21,1,20,合庫-台中,2024-09-12,1021
1524,耿鼎,20,0,20,合庫-台中,2024-09-12,1021
5512,力麒,20,0,20,合庫-台中,2024-09-12,1021
00688L,國泰20年美債正2,62,43,19,合庫-台中,2024-09-12,1021
8039,台虹,23,4,19,合庫-台中,2024-09-12,1021
2845,遠東銀,59,40,19,合庫-台中,2024-09-12,1021
00712,復華富時不動產,18,0,18,合庫-台中,2024-09-12,1021
2884,玉山金,30,12,18,合庫-台中,2024-09-12,1021
6134,萬旭,53,36,17,合庫-台中,2024-09-12,1021
00857B,永豐20年美公債,17,0,17,合庫-台中,2024-09-12,1021
3455,由田,16,0,16,合庫-台中,2024-09-12,1021
6442,光聖,16,0,16,合庫-台中,2024-09-12,1021
2371,大同,40,25,15,合庫-台中,2024-09-12,1021
00772B,中信高評級公司債,15,0,15,合庫-台中,2024-09-12,1021
3535,晶彩科,23,8,15,合庫-台中,2024-09-12,1021
6530,創威,73,59,14,合庫-台中,2024-09-12,1021
6139,亞翔,15,1,14,合庫-台中,2024-09-12,1021
1446,宏和,23,10,13,合庫-台中,2024-09-12,1021
2881,富邦金,24,11,13,合庫-台中,2024-09-12,1021
00713,元大台灣高息低波,13,1,12,合庫-台中,2024-09-12,1021
5452,佶優,12,1,11,合庫-台中,2024-09-12,1021
1609,大亞,10,0,10,合庫-台中,2024-09-12,1021
4168,醣聯,10,0,10,合庫-台中,2024-09-12,1021
4935,茂林-KY,10,0,10,合庫-台中,2024-09-12,1021
2643,捷迅,10,0,10,合庫-台中,2024-09-12,1021
1718,中纖,10,0,10,合庫-台中,2024-09-12,1021
2477,美隆電,12,2,10,合庫-台中,2024-09-12,1021
1409,新纖,10,0,10,合庫-台中,2024-09-12,1021
8107,大億金茂,11,1,10,合庫-台中,2024-09-12,1021
2497,怡利電,30,20,10,合庫-台中,2024-09-12,1021
1611,中電,10,0,10,合庫-台中,2024-09-12,1021
00673R,期元大S＆P原油反1,185,0,185,合庫-台中,2024-09-13,1021
2888,新光金,223,54,169,合庫-台中,2024-09-13,1021
00948B,中信優息投資級債,143,0,143,合庫-台中,2024-09-13,1021
2485,兆赫,135,0,135,合庫-台中,2024-09-13,1021
00687B,國泰20年美債,158,29,129,合庫-台中,2024-09-13,1021
00919,群益台灣精選高息,105,6,99,合庫-台中,2024-09-13,1021
00929,復華台灣科技優息,103,5,98,合庫-台中,2024-09-13,1021
1540,喬福,97,35,62,合庫-台中,2024-09-13,1021
00937B,群益ESG投等債20,71,15,56,合庫-台中,2024-09-13,1021
00878,國泰永續高股息,66,11,55,合庫-台中,2024-09-13,1021
8070,長華*,60,7,53,合庫-台中,2024-09-13,1021
00915,凱基優選高股息30,66,14,52,合庫-台中,2024-09-13,1021
1711,永光,67,17,50,合庫-台中,2024-09-13,1021
00933B,國泰10Y+金融債,54,5,49,合庫-台中,2024-09-13,1021
00779B,凱基美債25+,47,0,47,合庫-台中,2024-09-13,1021
00921,兆豐龍頭等權重,46,0,46,合庫-台中,2024-09-13,1021
00712,復華富時不動產,113,70,43,合庫-台中,2024-09-13,1021
2344,華邦電,46,5,41,合庫-台中,2024-09-13,1021
6456,GIS-KY,31,0,31,合庫-台中,2024-09-13,1021
2301,光寶科,30,0,30,合庫-台中,2024-09-13,1021
3163,波若威,43,16,27,合庫-台中,2024-09-13,1021
00764B,群益25年美債,27,0,27,合庫-台中,2024-09-13,1021
3663,鑫科,59,34,25,合庫-台中,2024-09-13,1021
00665L,富邦�琤肭磪囓�2,157,132,25,合庫-台中,2024-09-13,1021
8039,台虹,106,84,22,合庫-台中,2024-09-13,1021
6152,百一,29,8,21,合庫-台中,2024-09-13,1021
00918,大華優利高填息30,23,3,20,合庫-台中,2024-09-13,1021
2890,永豐金,20,0,20,合庫-台中,2024-09-13,1021
3481,群創,24,6,18,合庫-台中,2024-09-13,1021
3013,晟銘電,21,3,18,合庫-台中,2024-09-13,1021
3583,辛耘,36,23,13,合庫-台中,2024-09-13,1021
00679B,元大美債20年,28,15,13,合庫-台中,2024-09-13,1021
2467,志聖,22,9,13,合庫-台中,2024-09-13,1021
2486,一詮,18,5,13,合庫-台中,2024-09-13,1021
2371,大同,33,20,13,合庫-台中,2024-09-13,1021
0056,元大高股息,14,2,12,合庫-台中,2024-09-13,1021
5905,南仁湖,15,3,12,合庫-台中,2024-09-13,1021
3049,精金,13,1,12,合庫-台中,2024-09-13,1021
2409,友達,30,18,12,合庫-台中,2024-09-13,1021
00942B,台新美A公司債20+,12,0,12,合庫-台中,2024-09-13,1021
2845,遠東銀,32,21,11,合庫-台中,2024-09-13,1021
2408,南亞科,11,0,11,合庫-台中,2024-09-13,1021
00671R,富邦NASDAQ反1,11,0,11,合庫-台中,2024-09-13,1021
3073,天方能源,11,0,11,合庫-台中,2024-09-13,1021
3550,聯穎,14,3,11,合庫-台中,2024-09-13,1021
4909,新復興,61,50,11,合庫-台中,2024-09-13,1021
00795B,中信美國公債20年,10,0,10,合庫-台中,2024-09-13,1021
1560,中砂,11,1,10,合庫-台中,2024-09-13,1021
2537,聯上發,12,2,10,合庫-台中,2024-09-13,1021
4123,晟德,10,0,10,合庫-台中,2024-09-13,1021
00937B,群益ESG投等債20,939,42,897,合庫-台中,2024-09-16,1021
00919,群益台灣精選高息,229,12,217,合庫-台中,2024-09-16,1021
2485,兆赫,166,1,165,合庫-台中,2024-09-16,1021
2609,陽明,113,1,112,合庫-台中,2024-09-16,1021
00918,大華優利高填息30,124,24,100,合庫-台中,2024-09-16,1021
00929,復華台灣科技優息,103,18,85,合庫-台中,2024-09-16,1021
2070,精湛,102,19,83,合庫-台中,2024-09-16,1021
00715L,期街口布蘭特正2,61,0,61,合庫-台中,2024-09-16,1021
00712,復華富時不動產,60,8,52,合庫-台中,2024-09-16,1021
00943,兆豐電子高息等權,50,0,50,合庫-台中,2024-09-16,1021
00921,兆豐龍頭等權重,50,0,50,合庫-台中,2024-09-16,1021
00933B,國泰10Y+金融債,47,0,47,合庫-台中,2024-09-16,1021
00878,國泰永續高股息,63,19,44,合庫-台中,2024-09-16,1021
00679B,元大美債20年,64,23,41,合庫-台中,2024-09-16,1021
1815,富喬,55,16,39,合庫-台中,2024-09-16,1021
2371,大同,40,9,31,合庫-台中,2024-09-16,1021
00665L,富邦�琤肭磪囓�2,123,93,30,合庫-台中,2024-09-16,1021
00706L,期元大S＆P日圓正2,30,0,30,合庫-台中,2024-09-16,1021
8039,台虹,52,23,29,合庫-台中,2024-09-16,1021
8032,光菱,30,1,29,合庫-台中,2024-09-16,1021
2374,佳能,65,38,27,合庫-台中,2024-09-16,1021
4909,新復興,39,15,24,合庫-台中,2024-09-16,1021
6706,惠特,71,48,23,合庫-台中,2024-09-16,1021
00664R,國泰臺灣加權反1,23,0,23,合庫-台中,2024-09-16,1021
6442,光聖,23,1,22,合庫-台中,2024-09-16,1021
9914,美利達,22,0,22,合庫-台中,2024-09-16,1021
8249,菱光,30,9,21,合庫-台中,2024-09-16,1021
2337,旺宏,24,3,21,合庫-台中,2024-09-16,1021
00650L,復華香港正2,107,86,21,合庫-台中,2024-09-16,1021
00687B,國泰20年美債,196,176,20,合庫-台中,2024-09-16,1021
2867,三商壽,23,3,20,合庫-台中,2024-09-16,1021
0056,元大高股息,21,1,20,合庫-台中,2024-09-16,1021
8096,擎亞,22,3,19,合庫-台中,2024-09-16,1021
4123,晟德,19,0,19,合庫-台中,2024-09-16,1021
3290,東浦,49,30,19,合庫-台中,2024-09-16,1021
3303,岱稜,19,0,19,合庫-台中,2024-09-16,1021
4561,健椿,44,25,19,合庫-台中,2024-09-16,1021
8074,鉅橡,20,1,19,合庫-台中,2024-09-16,1021
3062,建漢,69,50,19,合庫-台中,2024-09-16,1021
3583,辛耘,24,6,18,合庫-台中,2024-09-16,1021
2454,聯發科,19,1,18,合庫-台中,2024-09-16,1021
00772B,中信高評級公司債,17,0,17,合庫-台中,2024-09-16,1021
3022,威強電,17,0,17,合庫-台中,2024-09-16,1021
2344,華邦電,28,11,17,合庫-台中,2024-09-16,1021
9105,泰金寶-DR,16,0,16,合庫-台中,2024-09-16,1021
1101,台泥,30,15,15,合庫-台中,2024-09-16,1021
2539,櫻花建,15,0,15,合庫-台中,2024-09-16,1021
1806,冠軍,15,0,15,合庫-台中,2024-09-16,1021
3339,泰谷,15,0,15,合庫-台中,2024-09-16,1021
4903,聯光通,20,5,15,合庫-台中,2024-09-16,1021
00632R,元大台灣50反1,443,20,423,合庫-台中,2024-09-18,1021
00929,復華台灣科技優息,371,39,332,合庫-台中,2024-09-18,1021
00688L,國泰20年美債正2,308,1,307,合庫-台中,2024-09-18,1021
00673R,期元大S＆P原油反1,302,0,302,合庫-台中,2024-09-18,1021
00687B,國泰20年美債,232,21,211,合庫-台中,2024-09-18,1021
2485,兆赫,175,0,175,合庫-台中,2024-09-18,1021
00919,群益台灣精選高息,228,71,157,合庫-台中,2024-09-18,1021
8111,立��,115,29,86,合庫-台中,2024-09-18,1021
2317,鴻海,133,47,86,合庫-台中,2024-09-18,1021
00937B,群益ESG投等債20,82,4,78,合庫-台中,2024-09-18,1021
2349,錸德,324,256,68,合庫-台中,2024-09-18,1021
2313,華通,88,26,62,合庫-台中,2024-09-18,1021
00706L,期元大S＆P日圓正2,57,0,57,合庫-台中,2024-09-18,1021
00712,復華富時不動產,96,40,56,合庫-台中,2024-09-18,1021
2344,華邦電,72,16,56,合庫-台中,2024-09-18,1021
9105,泰金寶-DR,53,5,48,合庫-台中,2024-09-18,1021
00878,國泰永續高股息,63,18,45,合庫-台中,2024-09-18,1021
2371,大同,48,3,45,合庫-台中,2024-09-18,1021
00713,元大台灣高息低波,53,9,44,合庫-台中,2024-09-18,1021
2392,正崴,42,0,42,合庫-台中,2024-09-18,1021
00915,凱基優選高股息30,46,5,41,合庫-台中,2024-09-18,1021
2637,慧洋-KY,40,1,39,合庫-台中,2024-09-18,1021
9902,台火,38,0,38,合庫-台中,2024-09-18,1021
00881,國泰台灣5G+,34,0,34,合庫-台中,2024-09-18,1021
1530,亞崴,31,0,31,合庫-台中,2024-09-18,1021
00943,兆豐電子高息等權,35,5,30,合庫-台中,2024-09-18,1021
2887,台新金,37,10,27,合庫-台中,2024-09-18,1021
5443,均豪,34,7,27,合庫-台中,2024-09-18,1021
5905,南仁湖,35,9,26,合庫-台中,2024-09-18,1021
0056,元大高股息,33,8,25,合庫-台中,2024-09-18,1021
2303,聯電,58,33,25,合庫-台中,2024-09-18,1021
8039,台虹,66,42,24,合庫-台中,2024-09-18,1021
2477,美隆電,27,3,24,合庫-台中,2024-09-18,1021
2062,橋椿,24,0,24,合庫-台中,2024-09-18,1021
3019,亞光,30,6,24,合庫-台中,2024-09-18,1021
00947,台新臺灣IC設計,22,0,22,合庫-台中,2024-09-18,1021
6104,創惟,31,9,22,合庫-台中,2024-09-18,1021
4906,正文,22,1,21,合庫-台中,2024-09-18,1021
2328,廣宇,21,0,21,合庫-台中,2024-09-18,1021
8932,智通*,20,0,20,合庫-台中,2024-09-18,1021
2539,櫻花建,20,0,20,合庫-台中,2024-09-18,1021
3607,谷崧,37,17,20,合庫-台中,2024-09-18,1021
8473,山林水,20,0,20,合庫-台中,2024-09-18,1021
3034,聯詠,21,1,20,合庫-台中,2024-09-18,1021
6274,台燿,25,6,19,合庫-台中,2024-09-18,1021
00891,中信關鍵半導體,21,2,19,合庫-台中,2024-09-18,1021
00921,兆豐龍頭等權重,23,4,19,合庫-台中,2024-09-18,1021
6016,康和證,20,2,18,合庫-台中,2024-09-18,1021
2426,鼎元,42,25,17,合庫-台中,2024-09-18,1021
2515,中工,17,0,17,合庫-台中,2024-09-18,1021
2867,三商壽,738,33,705,合庫-台中,2024-09-19,1021
00687B,國泰20年美債,506,78,428,合庫-台中,2024-09-19,1021
0050,元大台灣50,151,7,144,合庫-台中,2024-09-19,1021
00679B,元大美債20年,147,11,136,合庫-台中,2024-09-19,1021
2344,華邦電,132,9,123,合庫-台中,2024-09-19,1021
3049,精金,176,53,123,合庫-台中,2024-09-19,1021
00929,復華台灣科技優息,176,69,107,合庫-台中,2024-09-19,1021
00919,群益台灣精選高息,128,26,102,合庫-台中,2024-09-19,1021
00680L,元大美債20正2,98,0,98,合庫-台中,2024-09-19,1021
2485,兆赫,95,0,95,合庫-台中,2024-09-19,1021
00712,復華富時不動產,77,6,71,合庫-台中,2024-09-19,1021
00915,凱基優選高股息30,67,1,66,合庫-台中,2024-09-19,1021
3481,群創,179,114,65,合庫-台中,2024-09-19,1021
00948B,中信優息投資級債,63,0,63,合庫-台中,2024-09-19,1021
2610,華航,71,14,57,合庫-台中,2024-09-19,1021
00918,大華優利高填息30,65,15,50,合庫-台中,2024-09-19,1021
00637L,元大滬深300正2,88,40,48,合庫-台中,2024-09-19,1021
2477,美隆電,47,2,45,合庫-台中,2024-09-19,1021
2834,臺企銀,73,28,45,合庫-台中,2024-09-19,1021
4571,鈞興-KY,41,0,41,合庫-台中,2024-09-19,1021
6431,光麗-KY,40,0,40,合庫-台中,2024-09-19,1021
00958B,永豐ESG銀行債15,48,14,34,合庫-台中,2024-09-19,1021
4401,東隆興,34,0,34,合庫-台中,2024-09-19,1021
6179,亞通,31,0,31,合庫-台中,2024-09-19,1021
3580,友威科,49,21,28,合庫-台中,2024-09-19,1021
2614,東森,26,0,26,合庫-台中,2024-09-19,1021
6706,惠特,31,7,24,合庫-台中,2024-09-19,1021
00795B,中信美國公債20年,32,8,24,合庫-台中,2024-09-19,1021
2367,燿華,30,7,23,合庫-台中,2024-09-19,1021
3013,晟銘電,57,35,22,合庫-台中,2024-09-19,1021
00931B,統一美債20年,25,5,20,合庫-台中,2024-09-19,1021
00953B,群益優選非投等債,20,0,20,合庫-台中,2024-09-19,1021
4960,誠美材,20,0,20,合庫-台中,2024-09-19,1021
3706,神達,25,6,19,合庫-台中,2024-09-19,1021
3437,榮創,18,0,18,合庫-台中,2024-09-19,1021
00706L,期元大S＆P日圓正2,18,0,18,合庫-台中,2024-09-19,1021
3711,日月光投控,33,16,17,合庫-台中,2024-09-19,1021
00952,凱基台灣AI50,16,0,16,合庫-台中,2024-09-19,1021
00942B,台新美A公司債20+,17,1,16,合庫-台中,2024-09-19,1021
00655L,國泰中國A50正2,15,0,15,合庫-台中,2024-09-19,1021
1727,中華化,72,57,15,合庫-台中,2024-09-19,1021
2241,艾姆勒,14,0,14,合庫-台中,2024-09-19,1021
3290,東浦,41,27,14,合庫-台中,2024-09-19,1021
8096,擎亞,23,9,14,合庫-台中,2024-09-19,1021
1583,程泰,14,0,14,合庫-台中,2024-09-19,1021
00713,元大台灣高息低波,16,2,14,合庫-台中,2024-09-19,1021
4904,遠傳,14,0,14,合庫-台中,2024-09-19,1021
5234,達興材料,81,68,13,合庫-台中,2024-09-19,1021
4916,事欣科,14,1,13,合庫-台中,2024-09-19,1021
6609,瀧澤科,16,3,13,合庫-台中,2024-09-19,1021
4526,東台,373,54,319,合庫-台中,2024-09-20,1021
00665L,富邦�琤肭磪囓�2,1052,773,279,合庫-台中,2024-09-20,1021
2485,兆赫,206,0,206,合庫-台中,2024-09-20,1021
4530,宏易,158,0,158,合庫-台中,2024-09-20,1021
00919,群益台灣精選高息,356,226,130,合庫-台中,2024-09-20,1021
00929,復華台灣科技優息,213,87,126,合庫-台中,2024-09-20,1021
3049,精金,114,14,100,合庫-台中,2024-09-20,1021
2836,高雄銀,100,0,100,合庫-台中,2024-09-20,1021
2399,映泰,137,48,89,合庫-台中,2024-09-20,1021
2464,盟立,340,254,86,合庫-台中,2024-09-20,1021
00712,復華富時不動產,83,9,74,合庫-台中,2024-09-20,1021
2356,英業達,71,3,68,合庫-台中,2024-09-20,1021
00673R,期元大S＆P原油反1,173,114,59,合庫-台中,2024-09-20,1021
2353,宏��,74,15,59,合庫-台中,2024-09-20,1021
2609,陽明,95,36,59,合庫-台中,2024-09-20,1021
00650L,復華香港正2,130,80,50,合庫-台中,2024-09-20,1021
2515,中工,58,10,48,合庫-台中,2024-09-20,1021
00958B,永豐ESG銀行債15,42,0,42,合庫-台中,2024-09-20,1021
0056,元大高股息,55,13,42,合庫-台中,2024-09-20,1021
3231,緯創,52,13,39,合庫-台中,2024-09-20,1021
00631L,元大台灣50正2,41,2,39,合庫-台中,2024-09-20,1021
00960,野村全球航運龍頭,38,0,38,合庫-台中,2024-09-20,1021
2241,艾姆勒,32,0,32,合庫-台中,2024-09-20,1021
4510,高鋒,45,14,31,合庫-台中,2024-09-20,1021
2236,百達-KY,30,0,30,合庫-台中,2024-09-20,1021
8070,長華*,59,30,29,合庫-台中,2024-09-20,1021
3276,宇環,29,0,29,合庫-台中,2024-09-20,1021
3056,富華新,49,20,29,合庫-台中,2024-09-20,1021
5512,力麒,30,2,28,合庫-台中,2024-09-20,1021
2539,櫻花建,28,0,28,合庫-台中,2024-09-20,1021
1583,程泰,27,0,27,合庫-台中,2024-09-20,1021
00915,凱基優選高股息30,27,0,27,合庫-台中,2024-09-20,1021
00946,群益科技高息成長,26,0,26,合庫-台中,2024-09-20,1021
2888,新光金,73,47,26,合庫-台中,2024-09-20,1021
1314,中石化,26,0,26,合庫-台中,2024-09-20,1021
9136,巨騰-DR,75,50,25,合庫-台中,2024-09-20,1021
00878,國泰永續高股息,37,12,25,合庫-台中,2024-09-20,1021
1806,冠軍,72,48,24,合庫-台中,2024-09-20,1021
1540,喬福,37,14,23,合庫-台中,2024-09-20,1021
2303,聯電,66,44,22,合庫-台中,2024-09-20,1021
1617,榮星,23,1,22,合庫-台中,2024-09-20,1021
3550,聯穎,27,6,21,合庫-台中,2024-09-20,1021
4417,金洲,20,0,20,合庫-台中,2024-09-20,1021
3025,星通,20,0,20,合庫-台中,2024-09-20,1021
3663,鑫科,39,19,20,合庫-台中,2024-09-20,1021
3017,奇鋐,29,10,19,合庫-台中,2024-09-20,1021
3706,神達,20,1,19,合庫-台中,2024-09-20,1021
6177,達麗,27,8,19,合庫-台中,2024-09-20,1021
4906,正文,23,4,19,合庫-台中,2024-09-20,1021
2349,錸德,271,253,18,合庫-台中,2024-09-20,1021
00679B,元大美債20年,1712,143,1569,合庫-台中,2024-09-23,1021
00687B,國泰20年美債,1449,38,1411,合庫-台中,2024-09-23,1021
2891,中信金,674,265,409,合庫-台中,2024-09-23,1021
00919,群益台灣精選高息,266,26,240,合庫-台中,2024-09-23,1021
2485,兆赫,208,0,208,合庫-台中,2024-09-23,1021
00948B,中信優息投資級債,172,0,172,合庫-台中,2024-09-23,1021
00857B,永豐20年美公債,125,0,125,合庫-台中,2024-09-23,1021
3489,森寶,100,15,85,合庫-台中,2024-09-23,1021
2425,承啟,134,54,80,合庫-台中,2024-09-23,1021
00680L,元大美債20正2,99,23,76,合庫-台中,2024-09-23,1021
2105,正新,62,0,62,合庫-台中,2024-09-23,1021
1711,永光,82,23,59,合庫-台中,2024-09-23,1021
4510,高鋒,54,2,52,合庫-台中,2024-09-23,1021
2845,遠東銀,80,30,50,合庫-台中,2024-09-23,1021
1524,耿鼎,76,26,50,合庫-台中,2024-09-23,1021
6431,光麗-KY,50,0,50,合庫-台中,2024-09-23,1021
2367,燿華,40,0,40,合庫-台中,2024-09-23,1021
4530,宏易,40,0,40,合庫-台中,2024-09-23,1021
3324,雙鴻,57,18,39,合庫-台中,2024-09-23,1021
6548,長科*,45,10,35,合庫-台中,2024-09-23,1021
2464,盟立,58,25,33,合庫-台中,2024-09-23,1021
9136,巨騰-DR,64,31,33,合庫-台中,2024-09-23,1021
3374,精材,40,9,31,合庫-台中,2024-09-23,1021
2408,南亞科,38,8,30,合庫-台中,2024-09-23,1021
8028,昇陽半導體,41,13,28,合庫-台中,2024-09-23,1021
00673R,期元大S＆P原油反1,27,0,27,合庫-台中,2024-09-23,1021
00947,台新臺灣IC設計,30,3,27,合庫-台中,2024-09-23,1021
4772,台特化,27,1,26,合庫-台中,2024-09-23,1021
1709,和益,23,0,23,合庫-台中,2024-09-23,1021
2353,宏��,33,10,23,合庫-台中,2024-09-23,1021
2539,櫻花建,21,0,21,合庫-台中,2024-09-23,1021
3276,宇環,21,0,21,合庫-台中,2024-09-23,1021
2515,中工,26,5,21,合庫-台中,2024-09-23,1021
2312,金寶,23,2,21,合庫-台中,2024-09-23,1021
3303,岱稜,20,0,20,合庫-台中,2024-09-23,1021
4523,永彰,20,0,20,合庫-台中,2024-09-23,1021
8033,雷虎,20,1,19,合庫-台中,2024-09-23,1021
9105,泰金寶-DR,45,26,19,合庫-台中,2024-09-23,1021
6838,台新藥,19,0,19,合庫-台中,2024-09-23,1021
00878,國泰永續高股息,39,21,18,合庫-台中,2024-09-23,1021
00958B,永豐ESG銀行債15,18,0,18,合庫-台中,2024-09-23,1021
6116,彩晶,22,4,18,合庫-台中,2024-09-23,1021
3056,富華新,18,2,16,合庫-台中,2024-09-23,1021
2867,三商壽,15,0,15,合庫-台中,2024-09-23,1021
2374,佳能,15,0,15,合庫-台中,2024-09-23,1021
1735,日勝化,15,0,15,合庫-台中,2024-09-23,1021
2483,百容,15,0,15,合庫-台中,2024-09-23,1021
6698,旭暉應材,14,0,14,合庫-台中,2024-09-23,1021
4737,華廣,14,0,14,合庫-台中,2024-09-23,1021
6834,天二科技,14,0,14,合庫-台中,2024-09-23,1021
00877,復華中國5G,558,0,558,合庫-台中,2024-09-24,1021
00687B,國泰20年美債,145,28,117,合庫-台中,2024-09-24,1021
4530,宏易,115,0,115,合庫-台中,2024-09-24,1021
00712,復華富時不動產,124,10,114,合庫-台中,2024-09-24,1021
3360,尚立,100,3,97,合庫-台中,2024-09-24,1021
00929,復華台灣科技優息,116,23,93,合庫-台中,2024-09-24,1021
2609,陽明,428,347,81,合庫-台中,2024-09-24,1021
00919,群益台灣精選高息,87,18,69,合庫-台中,2024-09-24,1021
6185,幃翔,70,1,69,合庫-台中,2024-09-24,1021
3715,定穎投控,199,136,63,合庫-台中,2024-09-24,1021
3605,宏致,66,4,62,合庫-台中,2024-09-24,1021
00946,群益科技高息成長,50,0,50,合庫-台中,2024-09-24,1021
2344,華邦電,64,15,49,合庫-台中,2024-09-24,1021
1742,台蠟,47,0,47,合庫-台中,2024-09-24,1021
00960,野村全球航運龍頭,63,16,47,合庫-台中,2024-09-24,1021
3481,群創,145,100,45,合庫-台中,2024-09-24,1021
8096,擎亞,64,23,41,合庫-台中,2024-09-24,1021
00715L,期街口布蘭特正2,54,15,39,合庫-台中,2024-09-24,1021
3043,科風,38,0,38,合庫-台中,2024-09-24,1021
00713,元大台灣高息低波,38,2,36,合庫-台中,2024-09-24,1021
5608,四維航,47,12,35,合庫-台中,2024-09-24,1021
9902,台火,35,0,35,合庫-台中,2024-09-24,1021
00650L,復華香港正2,130,96,34,合庫-台中,2024-09-24,1021
00900,富邦特選高股息30,36,2,34,合庫-台中,2024-09-24,1021
1539,巨庭,54,20,34,合庫-台中,2024-09-24,1021
6838,台新藥,32,0,32,合庫-台中,2024-09-24,1021
2399,映泰,156,126,30,合庫-台中,2024-09-24,1021
00669R,國泰美國道瓊反1,30,0,30,合庫-台中,2024-09-24,1021
2888,新光金,76,47,29,合庫-台中,2024-09-24,1021
4526,東台,31,2,29,合庫-台中,2024-09-24,1021
4979,華星光,58,29,29,合庫-台中,2024-09-24,1021
3430,奇鈦科,28,0,28,合庫-台中,2024-09-24,1021
0056,元大高股息,28,2,26,合庫-台中,2024-09-24,1021
2485,兆赫,26,0,26,合庫-台中,2024-09-24,1021
00958B,永豐ESG銀行債15,26,0,26,合庫-台中,2024-09-24,1021
00948B,中信優息投資級債,29,5,24,合庫-台中,2024-09-24,1021
9105,泰金寶-DR,24,0,24,合庫-台中,2024-09-24,1021
2356,英業達,24,1,23,合庫-台中,2024-09-24,1021
2349,錸德,220,197,23,合庫-台中,2024-09-24,1021
4716,大立,34,13,21,合庫-台中,2024-09-24,1021
2605,新興,22,1,21,合庫-台中,2024-09-24,1021
6768,志強-KY,22,1,21,合庫-台中,2024-09-24,1021
6405,悅城,38,17,21,合庫-台中,2024-09-24,1021
2353,宏��,26,6,20,合庫-台中,2024-09-24,1021
4967,十銓,20,0,20,合庫-台中,2024-09-24,1021
6548,長科*,30,10,20,合庫-台中,2024-09-24,1021
2388,威盛,25,6,19,合庫-台中,2024-09-24,1021
3049,精金,19,1,18,合庫-台中,2024-09-24,1021
00878,國泰永續高股息,30,13,17,合庫-台中,2024-09-24,1021
3037,欣興,17,1,16,合庫-台中,2024-09-24,1021
3481,群創,206,71,135,合庫-台中,2024-09-25,1021
4406,新昕纖,88,0,88,合庫-台中,2024-09-25,1021
2485,兆赫,65,0,65,合庫-台中,2024-09-25,1021
00631L,元大台灣50正2,59,1,58,合庫-台中,2024-09-25,1021
00650L,復華香港正2,141,83,58,合庫-台中,2024-09-25,1021
2495,普安,64,6,58,合庫-台中,2024-09-25,1021
00679B,元大美債20年,81,24,57,合庫-台中,2024-09-25,1021
2618,長榮航,70,13,57,合庫-台中,2024-09-25,1021
2436,偉詮電,107,50,57,合庫-台中,2024-09-25,1021
3714,富采,125,68,57,合庫-台中,2024-09-25,1021
2888,新光金,64,7,57,合庫-台中,2024-09-25,1021
00948B,中信優息投資級債,52,0,52,合庫-台中,2024-09-25,1021
00687B,國泰20年美債,78,32,46,合庫-台中,2024-09-25,1021
6890,來億-KY,45,2,43,合庫-台中,2024-09-25,1021
00960,野村全球航運龍頭,64,24,40,合庫-台中,2024-09-25,1021
9907,統一實,47,10,37,合庫-台中,2024-09-25,1021
4903,聯光通,50,16,34,合庫-台中,2024-09-25,1021
00882,中信中國高股息,86,53,33,合庫-台中,2024-09-25,1021
1314,中石化,46,13,33,合庫-台中,2024-09-25,1021
2613,中櫃,37,5,32,合庫-台中,2024-09-25,1021
2609,陽明,200,170,30,合庫-台中,2024-09-25,1021
3034,聯詠,32,2,30,合庫-台中,2024-09-25,1021
2388,威盛,63,35,28,合庫-台中,2024-09-25,1021
6706,惠特,55,27,28,合庫-台中,2024-09-25,1021
9902,台火,27,0,27,合庫-台中,2024-09-25,1021
1808,潤隆,31,6,25,合庫-台中,2024-09-25,1021
2542,興富發,26,2,24,合庫-台中,2024-09-25,1021
2365,昆盈,40,17,23,合庫-台中,2024-09-25,1021
00936,台新永續高息中小,22,0,22,合庫-台中,2024-09-25,1021
6589,台康生技,37,15,22,合庫-台中,2024-09-25,1021
00635U,期元大S＆P黃金,21,0,21,合庫-台中,2024-09-25,1021
6016,康和證,20,0,20,合庫-台中,2024-09-25,1021
3276,宇環,20,0,20,合庫-台中,2024-09-25,1021
2634,漢翔,41,22,19,合庫-台中,2024-09-25,1021
1514,亞力,34,15,19,合庫-台中,2024-09-25,1021
3062,建漢,31,13,18,合庫-台中,2024-09-25,1021
4534,慶騰,21,3,18,合庫-台中,2024-09-25,1021
3437,榮創,18,2,16,合庫-台中,2024-09-25,1021
2539,櫻花建,15,0,15,合庫-台中,2024-09-25,1021
2228,劍麟,15,0,15,合庫-台中,2024-09-25,1021
00933B,國泰10Y+金融債,15,1,14,合庫-台中,2024-09-25,1021
8039,台虹,19,5,14,合庫-台中,2024-09-25,1021
2641,正德,19,6,13,合庫-台中,2024-09-25,1021
3149,正達,69,56,13,合庫-台中,2024-09-25,1021
6451,訊芯-KY,17,4,13,合庫-台中,2024-09-25,1021
1785,光洋科,26,13,13,合庫-台中,2024-09-25,1021
00675L,富邦臺灣加權正2,13,0,13,合庫-台中,2024-09-25,1021
00795B,中信美國公債20年,12,0,12,合庫-台中,2024-09-25,1021
00919,群益台灣精選高息,52,39,13,合庫-台中,2024-09-25,1021
00953B,群益優選非投等債,12,0,12,合庫-台中,2024-09-25,1021
00665L,富邦�琤肭磪囓�2,2680,410,2270,合庫-台中,2024-09-26,1021
00687B,國泰20年美債,666,62,604,合庫-台中,2024-09-26,1021
00632R,元大台灣50反1,392,50,342,合庫-台中,2024-09-26,1021
00948B,中信優息投資級債,270,0,270,合庫-台中,2024-09-26,1021
00715L,期街口布蘭特正2,325,62,263,合庫-台中,2024-09-26,1021
2609,陽明,457,252,205,合庫-台中,2024-09-26,1021
2367,燿華,214,16,198,合庫-台中,2024-09-26,1021
8111,立��,192,20,172,合庫-台中,2024-09-26,1021
2356,英業達,177,9,168,合庫-台中,2024-09-26,1021
00960,野村全球航運龍頭,153,13,140,合庫-台中,2024-09-26,1021
2801,彰銀,107,3,104,合庫-台中,2024-09-26,1021
00712,復華富時不動產,91,0,91,合庫-台中,2024-09-26,1021
2436,偉詮電,157,70,87,合庫-台中,2024-09-26,1021
2312,金寶,130,47,83,合庫-台中,2024-09-26,1021
2485,兆赫,75,1,74,合庫-台中,2024-09-26,1021
4716,大立,105,34,71,合庫-台中,2024-09-26,1021
1808,潤隆,74,5,69,合庫-台中,2024-09-26,1021
3019,亞光,89,23,66,合庫-台中,2024-09-26,1021
00688L,國泰20年美債正2,74,10,64,合庫-台中,2024-09-26,1021
2353,宏��,65,4,61,合庫-台中,2024-09-26,1021
0056,元大高股息,82,25,57,合庫-台中,2024-09-26,1021
1609,大亞,59,3,56,合庫-台中,2024-09-26,1021
2313,華通,71,16,55,合庫-台中,2024-09-26,1021
2409,友達,112,57,55,合庫-台中,2024-09-26,1021
00929,復華台灣科技優息,133,85,48,合庫-台中,2024-09-26,1021
2634,漢翔,41,2,39,合庫-台中,2024-09-26,1021
2354,鴻準,64,27,37,合庫-台中,2024-09-26,1021
00631L,元大台灣50正2,37,1,36,合庫-台中,2024-09-26,1021
1314,中石化,35,0,35,合庫-台中,2024-09-26,1021
2359,所羅門,32,0,32,合庫-台中,2024-09-26,1021
3047,訊舟,45,14,31,合庫-台中,2024-09-26,1021
3149,正達,76,46,30,合庫-台中,2024-09-26,1021
6133,金橋,35,5,30,合庫-台中,2024-09-26,1021
3605,宏致,35,9,26,合庫-台中,2024-09-26,1021
2881,富邦金,33,8,25,合庫-台中,2024-09-26,1021
00795B,中信美國公債20年,24,0,24,合庫-台中,2024-09-26,1021
00927,群益半導體收益,28,4,24,合庫-台中,2024-09-26,1021
3714,富采,41,17,24,合庫-台中,2024-09-26,1021
2258,鴻華先進-創,22,0,22,合庫-台中,2024-09-26,1021
1727,中華化,27,5,22,合庫-台中,2024-09-26,1021
2241,艾姆勒,22,0,22,合庫-台中,2024-09-26,1021
3006,晶豪科,30,8,22,合庫-台中,2024-09-26,1021
3231,緯創,30,9,21,合庫-台中,2024-09-26,1021
4977,眾達-KY,21,0,21,合庫-台中,2024-09-26,1021
3062,建漢,21,0,21,合庫-台中,2024-09-26,1021
8069,元太,20,0,20,合庫-台中,2024-09-26,1021
2332,友訊,20,0,20,合庫-台中,2024-09-26,1021
6016,康和證,20,0,20,合庫-台中,2024-09-26,1021
4147,中裕,20,0,20,合庫-台中,2024-09-26,1021
2344,華邦電,32,12,20,合庫-台中,2024-09-26,1021
00665L,富邦�琤肭磪囓�2,5418,3109,2309,合庫-台中,2024-09-27,1021
00632R,元大台灣50反1,1045,306,739,合庫-台中,2024-09-27,1021
00674R,期元大S＆P黃金反1,733,1,732,合庫-台中,2024-09-27,1021
00688L,國泰20年美債正2,415,5,410,合庫-台中,2024-09-27,1021
00948B,中信優息投資級債,271,3,268,合庫-台中,2024-09-27,1021
00680L,元大美債20正2,202,12,190,合庫-台中,2024-09-27,1021
00687B,國泰20年美債,148,17,131,合庫-台中,2024-09-27,1021
00937B,群益ESG投等債20,139,10,129,合庫-台中,2024-09-27,1021
2845,遠東銀,110,11,99,合庫-台中,2024-09-27,1021
2887,台新金,100,4,96,合庫-台中,2024-09-27,1021
00715L,期街口布蘭特正2,105,10,95,合庫-台中,2024-09-27,1021
2485,兆赫,80,0,80,合庫-台中,2024-09-27,1021
3512,皇龍,53,0,53,合庫-台中,2024-09-27,1021
2371,大同,67,14,53,合庫-台中,2024-09-27,1021
00706L,期元大S＆P日圓正2,50,0,50,合庫-台中,2024-09-27,1021
00636,國泰中國A50,57,7,50,合庫-台中,2024-09-27,1021
3041,揚智,69,20,49,合庫-台中,2024-09-27,1021
00679B,元大美債20年,143,95,48,合庫-台中,2024-09-27,1021
1727,中華化,66,20,46,合庫-台中,2024-09-27,1021
2388,威盛,73,27,46,合庫-台中,2024-09-27,1021
2801,彰銀,44,0,44,合庫-台中,2024-09-27,1021
2634,漢翔,50,7,43,合庫-台中,2024-09-27,1021
6834,天二科技,42,0,42,合庫-台中,2024-09-27,1021
1540,喬福,70,29,41,合庫-台中,2024-09-27,1021
6257,矽格,43,3,40,合庫-台中,2024-09-27,1021
1312,國喬,40,0,40,合庫-台中,2024-09-27,1021
00642U,期元大S＆P石油,39,0,39,合庫-台中,2024-09-27,1021
4729,熒茂,46,13,33,合庫-台中,2024-09-27,1021
2486,一詮,41,10,31,合庫-台中,2024-09-27,1021
2353,宏��,31,1,30,合庫-台中,2024-09-27,1021
3149,正達,117,88,29,合庫-台中,2024-09-27,1021
00655L,國泰中國A50正2,53,25,28,合庫-台中,2024-09-27,1021
3206,志豐,27,0,27,合庫-台中,2024-09-27,1021
4952,凌通,33,8,25,合庫-台中,2024-09-27,1021
3019,亞光,62,37,25,合庫-台中,2024-09-27,1021
2313,華通,28,4,24,合庫-台中,2024-09-27,1021
00958B,永豐ESG銀行債15,24,0,24,合庫-台中,2024-09-27,1021
6120,達運,24,0,24,合庫-台中,2024-09-27,1021
2884,玉山金,31,7,24,合庫-台中,2024-09-27,1021
5443,均豪,25,2,23,合庫-台中,2024-09-27,1021
8043,蜜望實,25,2,23,合庫-台中,2024-09-27,1021
3605,宏致,50,27,23,合庫-台中,2024-09-27,1021
3363,上詮,76,54,22,合庫-台中,2024-09-27,1021
00712,復華富時不動產,34,13,21,合庫-台中,2024-09-27,1021
6016,康和證,20,0,20,合庫-台中,2024-09-27,1021
1506,正道,20,0,20,合庫-台中,2024-09-27,1021
2409,友達,33,13,20,合庫-台中,2024-09-27,1021
2610,華航,31,11,20,合庫-台中,2024-09-27,1021
5347,世界,19,0,19,合庫-台中,2024-09-27,1021
2301,光寶科,36,17,19,合庫-台中,2024-09-27,1021
2601,益航,794,7,787,合庫-台中,2024-09-30,1021
00929,復華台灣科技優息,340,1,339,合庫-台中,2024-09-30,1021
00919,群益台灣精選高息,265,32,233,合庫-台中,2024-09-30,1021
00632R,元大台灣50反1,248,20,228,合庫-台中,2024-09-30,1021
00937B,群益ESG投等債20,183,3,180,合庫-台中,2024-09-30,1021
1301,台塑,178,9,169,合庫-台中,2024-09-30,1021
00650L,復華香港正2,275,132,143,合庫-台中,2024-09-30,1021
00687B,國泰20年美債,144,10,134,合庫-台中,2024-09-30,1021
00945B,凱基美國非投等債,122,0,122,合庫-台中,2024-09-30,1021
00665L,富邦�琤肭磪囓�2,1916,1794,122,合庫-台中,2024-09-30,1021
00642U,期元大S＆P石油,110,4,106,合庫-台中,2024-09-30,1021
00940,元大台灣價值高息,153,48,105,合庫-台中,2024-09-30,1021
00753L,中信中國50正2,154,58,96,合庫-台中,2024-09-30,1021
1314,中石化,76,0,76,合庫-台中,2024-09-30,1021
00948B,中信優息投資級債,71,0,71,合庫-台中,2024-09-30,1021
2485,兆赫,70,0,70,合庫-台中,2024-09-30,1021
2489,瑞軒,68,1,67,合庫-台中,2024-09-30,1021
2605,新興,98,39,59,合庫-台中,2024-09-30,1021
2615,萬海,135,81,54,合庫-台中,2024-09-30,1021
2330,台積電,69,17,52,合庫-台中,2024-09-30,1021
00939,統一台灣高息動能,53,1,52,合庫-台中,2024-09-30,1021
2543,皇昌,77,27,50,合庫-台中,2024-09-30,1021
6890,來億-KY,48,1,47,合庫-台中,2024-09-30,1021
00679B,元大美債20年,80,35,45,合庫-台中,2024-09-30,1021
2382,廣達,54,9,45,合庫-台中,2024-09-30,1021
4906,正文,44,0,44,合庫-台中,2024-09-30,1021
00633L,富邦上証正2,54,11,43,合庫-台中,2024-09-30,1021
00918,大華優利高填息30,40,0,40,合庫-台中,2024-09-30,1021
3605,宏致,52,14,38,合庫-台中,2024-09-30,1021
2313,華通,54,17,37,合庫-台中,2024-09-30,1021
4979,華星光,92,55,37,合庫-台中,2024-09-30,1021
00715L,期街口布蘭特正2,57,22,35,合庫-台中,2024-09-30,1021
00951,台新日本半導體,32,0,32,合庫-台中,2024-09-30,1021
8028,昇陽半導體,40,8,32,合庫-台中,2024-09-30,1021
0056,元大高股息,40,9,31,合庫-台中,2024-09-30,1021
2070,精湛,38,8,30,合庫-台中,2024-09-30,1021
1519,華城,36,7,29,合庫-台中,2024-09-30,1021
4406,新昕纖,29,0,29,合庫-台中,2024-09-30,1021
1905,華紙,33,5,28,合庫-台中,2024-09-30,1021
00943,兆豐電子高息等權,28,0,28,合庫-台中,2024-09-30,1021
2610,華航,37,9,28,合庫-台中,2024-09-30,1021
2609,陽明,114,86,28,合庫-台中,2024-09-30,1021
00915,凱基優選高股息30,29,2,27,合庫-台中,2024-09-30,1021
00947,台新臺灣IC設計,27,0,27,合庫-台中,2024-09-30,1021
00881,國泰台灣5G+,57,30,27,合庫-台中,2024-09-30,1021
6213,聯茂,31,5,26,合庫-台中,2024-09-30,1021
00795B,中信美國公債20年,27,1,26,合庫-台中,2024-09-30,1021
1313,聯成,71,45,26,合庫-台中,2024-09-30,1021
9938,百和,50,25,25,合庫-台中,2024-09-30,1021
2030,彰源,27,3,24,合庫-台中,2024-09-30,1021
00664R,國泰臺灣加權反1,300,0,300,合庫-台中,2024-10-01,1021
00929,復華台灣科技優息,294,33,261,合庫-台中,2024-10-01,1021
0056,元大高股息,253,9,244,合庫-台中,2024-10-01,1021
00878,國泰永續高股息,194,19,175,合庫-台中,2024-10-01,1021
00919,群益台灣精選高息,162,9,153,合庫-台中,2024-10-01,1021
2801,彰銀,144,0,144,合庫-台中,2024-10-01,1021
00937B,群益ESG投等債20,142,21,121,合庫-台中,2024-10-01,1021
00650L,復華香港正2,180,75,105,合庫-台中,2024-10-01,1021
2845,遠東銀,99,0,99,合庫-台中,2024-10-01,1021
2609,陽明,496,400,96,合庫-台中,2024-10-01,1021
2618,長榮航,142,51,91,合庫-台中,2024-10-01,1021
00631L,元大台灣50正2,54,2,52,合庫-台中,2024-10-01,1021
2543,皇昌,65,14,51,合庫-台中,2024-10-01,1021
1722,台肥,51,0,51,合庫-台中,2024-10-01,1021
00687B,國泰20年美債,78,30,48,合庫-台中,2024-10-01,1021
3481,群創,120,77,43,合庫-台中,2024-10-01,1021
3322,建舜電,40,0,40,合庫-台中,2024-10-01,1021
00891,中信關鍵半導體,44,6,38,合庫-台中,2024-10-01,1021
00922,國泰台灣領袖50,34,0,34,合庫-台中,2024-10-01,1021
00882,中信中國高股息,62,32,30,合庫-台中,2024-10-01,1021
3430,奇鈦科,68,38,30,合庫-台中,2024-10-01,1021
1727,中華化,49,20,29,合庫-台中,2024-10-01,1021
3715,定穎投控,40,13,27,合庫-台中,2024-10-01,1021
00940,元大台灣價值高息,55,28,27,合庫-台中,2024-10-01,1021
2033,佳大,27,0,27,合庫-台中,2024-10-01,1021
6243,迅杰,26,0,26,合庫-台中,2024-10-01,1021
1314,中石化,27,1,26,合庫-台中,2024-10-01,1021
3058,立德,25,0,25,合庫-台中,2024-10-01,1021
2382,廣達,27,3,24,合庫-台中,2024-10-01,1021
2337,旺宏,24,1,23,合庫-台中,2024-10-01,1021
2913,農林,24,2,22,合庫-台中,2024-10-01,1021
2605,新興,65,44,21,合庫-台中,2024-10-01,1021
2313,華通,40,19,21,合庫-台中,2024-10-01,1021
00633L,富邦上証正2,21,0,21,合庫-台中,2024-10-01,1021
2330,台積電,30,9,21,合庫-台中,2024-10-01,1021
3580,友威科,25,4,21,合庫-台中,2024-10-01,1021
6189,豐藝,21,1,20,合庫-台中,2024-10-01,1021
1303,南亞,22,2,20,合庫-台中,2024-10-01,1021
2317,鴻海,42,22,20,合庫-台中,2024-10-01,1021
00713,元大台灣高息低波,19,0,19,合庫-台中,2024-10-01,1021
00915,凱基優選高股息30,18,0,18,合庫-台中,2024-10-01,1021
4763,材料-KY,18,1,17,合庫-台中,2024-10-01,1021
00725B,國泰投資級公司債,16,0,16,合庫-台中,2024-10-01,1021
00680L,元大美債20正2,39,23,16,合庫-台中,2024-10-01,1021
2455,全新,78,62,16,合庫-台中,2024-10-01,1021
6770,力積電,16,0,16,合庫-台中,2024-10-01,1021
00642U,期元大S＆P石油,20,4,16,合庫-台中,2024-10-01,1021
6015,宏遠證,15,0,15,合庫-台中,2024-10-01,1021
3708,上緯投控,23,8,15,合庫-台中,2024-10-01,1021
6763,綠界科技*,15,0,15,合庫-台中,2024-10-01,1021
00665L,富邦�琤肭磪囓�2,4022,96,3926,合庫-台中,2024-10-04,1021
00919,群益台灣精選高息,479,121,358,合庫-台中,2024-10-04,1021
00637L,元大滬深300正2,685,351,334,合庫-台中,2024-10-04,1021
00639,富邦深100,323,28,295,合庫-台中,2024-10-04,1021
00943,兆豐電子高息等權,255,30,225,合庫-台中,2024-10-04,1021
00673R,期元大S＆P原油反1,268,80,188,合庫-台中,2024-10-04,1021
0056,元大高股息,172,0,172,合庫-台中,2024-10-04,1021
00656R,國泰中國A50反1,155,0,155,合庫-台中,2024-10-04,1021
2610,華航,117,0,117,合庫-台中,2024-10-04,1021
2353,宏��,118,3,115,合庫-台中,2024-10-04,1021
00633L,富邦上証正2,103,5,98,合庫-台中,2024-10-04,1021
2498,宏達電,205,110,95,合庫-台中,2024-10-04,1021
00712,復華富時不動產,87,0,87,合庫-台中,2024-10-04,1021
2603,長榮,88,4,84,合庫-台中,2024-10-04,1021
2609,陽明,215,134,81,合庫-台中,2024-10-04,1021
00878,國泰永續高股息,93,17,76,合庫-台中,2024-10-04,1021
2884,玉山金,77,14,63,合庫-台中,2024-10-04,1021
00918,大華優利高填息30,62,1,61,合庫-台中,2024-10-04,1021
2543,皇昌,75,15,60,合庫-台中,2024-10-04,1021
5351,鈺創,61,3,58,合庫-台中,2024-10-04,1021
0061,元大寶滬深,57,0,57,合庫-台中,2024-10-04,1021
3149,正達,90,41,49,合庫-台中,2024-10-04,1021
00688L,國泰20年美債正2,42,0,42,合庫-台中,2024-10-04,1021
2303,聯電,94,53,41,合庫-台中,2024-10-04,1021
00937B,群益ESG投等債20,38,0,38,合庫-台中,2024-10-04,1021
3062,建漢,84,46,38,合庫-台中,2024-10-04,1021
5880,合庫金,47,10,37,合庫-台中,2024-10-04,1021
2615,萬海,47,11,36,合庫-台中,2024-10-04,1021
2834,臺企銀,34,0,34,合庫-台中,2024-10-04,1021
9914,美利達,33,0,33,合庫-台中,2024-10-04,1021
4526,東台,35,3,32,合庫-台中,2024-10-04,1021
00655L,國泰中國A50正2,54,23,31,合庫-台中,2024-10-04,1021
00907,永豐優息存股,32,2,30,合庫-台中,2024-10-04,1021
00940,元大台灣價值高息,66,37,29,合庫-台中,2024-10-04,1021
2641,正德,30,3,27,合庫-台中,2024-10-04,1021
2382,廣達,32,5,27,合庫-台中,2024-10-04,1021
3041,揚智,34,8,26,合庫-台中,2024-10-04,1021
00687B,國泰20年美債,31,6,25,合庫-台中,2024-10-04,1021
00795B,中信美國公債20年,25,0,25,合庫-台中,2024-10-04,1021
2033,佳大,27,2,25,合庫-台中,2024-10-04,1021
5452,佶優,26,2,24,合庫-台中,2024-10-04,1021
00915,凱基優選高股息30,24,0,24,合庫-台中,2024-10-04,1021
9921,巨大,30,7,23,合庫-台中,2024-10-04,1021
8039,台虹,43,20,23,合庫-台中,2024-10-04,1021
00753L,中信中國50正2,65,42,23,合庫-台中,2024-10-04,1021
8249,菱光,26,5,21,合庫-台中,2024-10-04,1021
3047,訊舟,36,15,21,合庫-台中,2024-10-04,1021
00713,元大台灣高息低波,21,0,21,合庫-台中,2024-10-04,1021
00706L,期元大S＆P日圓正2,20,0,20,合庫-台中,2024-10-04,1021
4906,正文,20,0,20,合庫-台中,2024-10-04,1021
00665L,富邦�琤肭磪囓�2,2070,122,1948,合庫-台中,2024-10-07,1021
00637L,元大滬深300正2,996,345,651,合庫-台中,2024-10-07,1021
00882,中信中國高股息,759,211,548,合庫-台中,2024-10-07,1021
9105,泰金寶-DR,558,56,502,合庫-台中,2024-10-07,1021
00753L,中信中國50正2,482,173,309,合庫-台中,2024-10-07,1021
2105,正新,209,14,195,合庫-台中,2024-10-07,1021
4406,新昕纖,144,0,144,合庫-台中,2024-10-07,1021
00919,群益台灣精選高息,124,5,119,合庫-台中,2024-10-07,1021
00948B,中信優息投資級債,109,0,109,合庫-台中,2024-10-07,1021
00720B,元大投資級公司債,91,1,90,合庫-台中,2024-10-07,1021
2313,華通,105,26,79,合庫-台中,2024-10-07,1021
2929,淘帝-KY,72,2,70,合庫-台中,2024-10-07,1021
00706L,期元大S＆P日圓正2,70,0,70,合庫-台中,2024-10-07,1021
00752,中信中國50,74,11,63,合庫-台中,2024-10-07,1021
4128,中天,61,1,60,合庫-台中,2024-10-07,1021
3025,星通,86,32,54,合庫-台中,2024-10-07,1021
00725B,國泰投資級公司債,53,0,53,合庫-台中,2024-10-07,1021
00636,國泰中國A50,54,1,53,合庫-台中,2024-10-07,1021
00937B,群益ESG投等債20,62,16,46,合庫-台中,2024-10-07,1021
1314,中石化,163,118,45,合庫-台中,2024-10-07,1021
0056,元大高股息,54,9,45,合庫-台中,2024-10-07,1021
2317,鴻海,98,55,43,合庫-台中,2024-10-07,1021
4903,聯光通,100,57,43,合庫-台中,2024-10-07,1021
00679B,元大美債20年,57,15,42,合庫-台中,2024-10-07,1021
00887,永豐中國科技50大,261,221,40,合庫-台中,2024-10-07,1021
3481,群創,173,134,39,合庫-台中,2024-10-07,1021
00633L,富邦上証正2,72,35,37,合庫-台中,2024-10-07,1021
3234,光環,43,9,34,合庫-台中,2024-10-07,1021
2834,臺企銀,65,32,33,合庫-台中,2024-10-07,1021
2344,華邦電,34,1,33,合庫-台中,2024-10-07,1021
2353,宏��,43,10,33,合庫-台中,2024-10-07,1021
3374,精材,56,26,30,合庫-台中,2024-10-07,1021
00688L,國泰20年美債正2,45,15,30,合庫-台中,2024-10-07,1021
4763,材料-KY,29,0,29,合庫-台中,2024-10-07,1021
2408,南亞科,27,0,27,合庫-台中,2024-10-07,1021
2033,佳大,27,0,27,合庫-台中,2024-10-07,1021
1304,台聚,31,5,26,合庫-台中,2024-10-07,1021
5347,世界,26,0,26,合庫-台中,2024-10-07,1021
1810,和成,26,0,26,合庫-台中,2024-10-07,1021
2515,中工,29,6,23,合庫-台中,2024-10-07,1021
2609,陽明,49,26,23,合庫-台中,2024-10-07,1021
2486,一詮,52,29,23,合庫-台中,2024-10-07,1021
2303,聯電,23,1,22,合庫-台中,2024-10-07,1021
2388,威盛,31,10,21,合庫-台中,2024-10-07,1021
6284,佳邦,23,2,21,合庫-台中,2024-10-07,1021
2337,旺宏,26,5,21,合庫-台中,2024-10-07,1021
8240,華宏,21,0,21,合庫-台中,2024-10-07,1021
4523,永彰,21,1,20,合庫-台中,2024-10-07,1021
4116,明基醫,20,0,20,合庫-台中,2024-10-07,1021
2615,萬海,111,92,19,合庫-台中,2024-10-07,1021
9105,泰金寶-DR,727,0,727,合庫-台中,2024-10-08,1021
00637L,元大滬深300正2,940,607,333,合庫-台中,2024-10-08,1021
2801,彰銀,265,0,265,合庫-台中,2024-10-08,1021
1314,中石化,227,24,203,合庫-台中,2024-10-08,1021
3481,群創,173,21,152,合庫-台中,2024-10-08,1021
8176,智捷,146,0,146,合庫-台中,2024-10-08,1021
0056,元大高股息,145,0,145,合庫-台中,2024-10-08,1021
00673R,期元大S＆P原油反1,196,51,145,合庫-台中,2024-10-08,1021
00919,群益台灣精選高息,164,24,140,合庫-台中,2024-10-08,1021
00753L,中信中國50正2,346,234,112,合庫-台中,2024-10-08,1021
00929,復華台灣科技優息,186,79,107,合庫-台中,2024-10-08,1021
2105,正新,107,8,99,合庫-台中,2024-10-08,1021
2485,兆赫,90,0,90,合庫-台中,2024-10-08,1021
00878,國泰永續高股息,95,11,84,合庫-台中,2024-10-08,1021
2353,宏��,82,0,82,合庫-台中,2024-10-08,1021
3209,全科,97,15,82,合庫-台中,2024-10-08,1021
2409,友達,101,23,78,合庫-台中,2024-10-08,1021
2498,宏達電,158,82,76,合庫-台中,2024-10-08,1021
00688L,國泰20年美債正2,89,14,75,合庫-台中,2024-10-08,1021
2356,英業達,80,7,73,合庫-台中,2024-10-08,1021
8111,立��,150,78,72,合庫-台中,2024-10-08,1021
5880,合庫金,69,3,66,合庫-台中,2024-10-08,1021
00948B,中信優息投資級債,65,0,65,合庫-台中,2024-10-08,1021
00887,永豐中國科技50大,228,165,63,合庫-台中,2024-10-08,1021
2317,鴻海,75,28,47,合庫-台中,2024-10-08,1021
00712,復華富時不動產,44,0,44,合庫-台中,2024-10-08,1021
00940,元大台灣價值高息,60,17,43,合庫-台中,2024-10-08,1021
2883,凱基金,53,10,43,合庫-台中,2024-10-08,1021
3149,正達,221,178,43,合庫-台中,2024-10-08,1021
2610,華航,44,4,40,合庫-台中,2024-10-08,1021
00713,元大台灣高息低波,38,0,38,合庫-台中,2024-10-08,1021
2845,遠東銀,40,3,37,合庫-台中,2024-10-08,1021
00918,大華優利高填息30,35,0,35,合庫-台中,2024-10-08,1021
00922,國泰台灣領袖50,34,0,34,合庫-台中,2024-10-08,1021
2033,佳大,34,0,34,合庫-台中,2024-10-08,1021
5014,建錩,48,18,30,合庫-台中,2024-10-08,1021
1721,三晃,33,3,30,合庫-台中,2024-10-08,1021
2834,臺企銀,70,40,30,合庫-台中,2024-10-08,1021
00882,中信中國高股息,225,196,29,合庫-台中,2024-10-08,1021
2399,映泰,206,178,28,合庫-台中,2024-10-08,1021
4729,熒茂,32,4,28,合庫-台中,2024-10-08,1021
2101,南港,32,4,28,合庫-台中,2024-10-08,1021
2412,中華電,26,0,26,合庫-台中,2024-10-08,1021
00679B,元大美債20年,68,42,26,合庫-台中,2024-10-08,1021
2891,中信金,37,11,26,合庫-台中,2024-10-08,1021
00636,國泰中國A50,28,3,25,合庫-台中,2024-10-08,1021
1717,長興,25,0,25,合庫-台中,2024-10-08,1021
6425,易發,37,13,24,合庫-台中,2024-10-08,1021
8249,菱光,45,21,24,合庫-台中,2024-10-08,1021
2064,晉椿,36,13,23,合庫-台中,2024-10-08,1021
00665L,富邦�琤肭磪囓�2,2166,1028,1138,合庫-台中,2024-10-09,1021
00650L,復華香港正2,477,109,368,合庫-台中,2024-10-09,1021
00882,中信中國高股息,328,53,275,合庫-台中,2024-10-09,1021
2485,兆赫,233,0,233,合庫-台中,2024-10-09,1021
00753L,中信中國50正2,218,52,166,合庫-台中,2024-10-09,1021
2344,華邦電,170,7,163,合庫-台中,2024-10-09,1021
00937B,群益ESG投等債20,163,26,137,合庫-台中,2024-10-09,1021
4958,臻鼎-KY,142,8,134,合庫-台中,2024-10-09,1021
00687B,國泰20年美債,157,48,109,合庫-台中,2024-10-09,1021
00636,國泰中國A50,117,10,107,合庫-台中,2024-10-09,1021
00919,群益台灣精選高息,118,21,97,合庫-台中,2024-10-09,1021
00637L,元大滬深300正2,593,506,87,合庫-台中,2024-10-09,1021
2498,宏達電,99,22,77,合庫-台中,2024-10-09,1021
00715L,期街口布蘭特正2,138,68,70,合庫-台中,2024-10-09,1021
2353,宏��,80,11,69,合庫-台中,2024-10-09,1021
3710,連展投控,71,5,66,合庫-台中,2024-10-09,1021
00948B,中信優息投資級債,65,2,63,合庫-台中,2024-10-09,1021
00679B,元大美債20年,59,3,56,合庫-台中,2024-10-09,1021
5443,均豪,76,24,52,合庫-台中,2024-10-09,1021
5880,合庫金,51,4,47,合庫-台中,2024-10-09,1021
0056,元大高股息,48,7,41,合庫-台中,2024-10-09,1021
2617,台航,40,0,40,合庫-台中,2024-10-09,1021
00634R,富邦上証反1,40,0,40,合庫-台中,2024-10-09,1021
2002,中鋼,42,3,39,合庫-台中,2024-10-09,1021
2634,漢翔,131,95,36,合庫-台中,2024-10-09,1021
2363,矽統,206,171,35,合庫-台中,2024-10-09,1021
1314,中石化,184,150,34,合庫-台中,2024-10-09,1021
00940,元大台灣價值高息,66,34,32,合庫-台中,2024-10-09,1021
3632,研勤,32,0,32,合庫-台中,2024-10-09,1021
2362,藍天,36,5,31,合庫-台中,2024-10-09,1021
2845,遠東銀,43,12,31,合庫-台中,2024-10-09,1021
00666R,富邦�琤肭磪齯�1,30,0,30,合庫-台中,2024-10-09,1021
2610,華航,33,3,30,合庫-台中,2024-10-09,1021
3049,精金,76,46,30,合庫-台中,2024-10-09,1021
00922,國泰台灣領袖50,38,8,30,合庫-台中,2024-10-09,1021
00656R,國泰中國A50反1,30,1,29,合庫-台中,2024-10-09,1021
3005,神基,29,1,28,合庫-台中,2024-10-09,1021
6269,台郡,28,0,28,合庫-台中,2024-10-09,1021
2409,友達,56,28,28,合庫-台中,2024-10-09,1021
2609,陽明,37,10,27,合庫-台中,2024-10-09,1021
00936,台新永續高息中小,28,2,26,合庫-台中,2024-10-09,1021
1802,台玻,25,0,25,合庫-台中,2024-10-09,1021
00651R,復華香港反1,29,4,25,合庫-台中,2024-10-09,1021
3025,星通,115,90,25,合庫-台中,2024-10-09,1021
6742,澤米,36,11,25,合庫-台中,2024-10-09,1021
00943,兆豐電子高息等權,25,1,24,合庫-台中,2024-10-09,1021
1530,亞崴,24,0,24,合庫-台中,2024-10-09,1021
2892,第一金,24,0,24,合庫-台中,2024-10-09,1021
2641,正德,24,1,23,合庫-台中,2024-10-09,1021
1303,南亞,24,2,22,合庫-台中,2024-10-09,1021
00706L,期元大S＆P日圓正2,2145,0,2145,合庫-台中,2024-10-11,1021
00637L,元大滬深300正2,2283,232,2051,合庫-台中,2024-10-11,1021
00632R,元大台灣50反1,255,0,255,合庫-台中,2024-10-11,1021
00673R,期元大S＆P原油反1,150,0,150,合庫-台中,2024-10-11,1021
00882,中信中國高股息,173,39,134,合庫-台中,2024-10-11,1021
2887,台新金,117,0,117,合庫-台中,2024-10-11,1021
2845,遠東銀,100,5,95,合庫-台中,2024-10-11,1021
1314,中石化,94,4,90,合庫-台中,2024-10-11,1021
3149,正達,204,131,73,合庫-台中,2024-10-11,1021
00922,國泰台灣領袖50,70,0,70,合庫-台中,2024-10-11,1021
2062,橋椿,135,66,69,合庫-台中,2024-10-11,1021
2897,王道銀行,60,0,60,合庫-台中,2024-10-11,1021
2485,兆赫,57,0,57,合庫-台中,2024-10-11,1021
2344,華邦電,57,1,56,合庫-台中,2024-10-11,1021
2449,京元電子,86,35,51,合庫-台中,2024-10-11,1021
00633L,富邦上証正2,55,4,51,合庫-台中,2024-10-11,1021
2892,第一金,50,1,49,合庫-台中,2024-10-11,1021
2388,威盛,101,56,45,合庫-台中,2024-10-11,1021
4906,正文,45,0,45,合庫-台中,2024-10-11,1021
1515,力山,42,1,41,合庫-台中,2024-10-11,1021
2444,兆勁,40,0,40,合庫-台中,2024-10-11,1021
00943,兆豐電子高息等權,40,5,35,合庫-台中,2024-10-11,1021
9136,巨騰-DR,58,24,34,合庫-台中,2024-10-11,1021
1714,和桐,31,0,31,合庫-台中,2024-10-11,1021
1605,華新,31,1,30,合庫-台中,2024-10-11,1021
3481,群創,60,30,30,合庫-台中,2024-10-11,1021
3306,鼎天,31,1,30,合庫-台中,2024-10-11,1021
3013,晟銘電,68,39,29,合庫-台中,2024-10-11,1021
00753L,中信中國50正2,34,6,28,合庫-台中,2024-10-11,1021
3049,精金,59,32,27,合庫-台中,2024-10-11,1021
2356,英業達,40,13,27,合庫-台中,2024-10-11,1021
2834,臺企銀,42,16,26,合庫-台中,2024-10-11,1021
3550,聯穎,29,4,25,合庫-台中,2024-10-11,1021
00887,永豐中國科技50大,34,10,24,合庫-台中,2024-10-11,1021
2337,旺宏,23,0,23,合庫-台中,2024-10-11,1021
00960,野村全球航運龍頭,34,12,22,合庫-台中,2024-10-11,1021
3710,連展投控,26,4,22,合庫-台中,2024-10-11,1021
4909,新復興,53,33,20,合庫-台中,2024-10-11,1021
00927,群益半導體收益,21,1,20,合庫-台中,2024-10-11,1021
0061,元大寶滬深,20,0,20,合庫-台中,2024-10-11,1021
9904,寶成,20,0,20,合庫-台中,2024-10-11,1021
1506,正道,20,0,20,合庫-台中,2024-10-11,1021
6217,中探針,20,0,20,合庫-台中,2024-10-11,1021
1721,三晃,31,11,20,合庫-台中,2024-10-11,1021
2105,正新,26,6,20,合庫-台中,2024-10-11,1021
2881,富邦金,22,3,19,合庫-台中,2024-10-11,1021
6425,易發,32,13,19,合庫-台中,2024-10-11,1021
3048,益登,26,8,18,合庫-台中,2024-10-11,1021
00712,復華富時不動產,17,0,17,合庫-台中,2024-10-11,1021
6152,百一,31,14,17,合庫-台中,2024-10-11,1021
00665L,富邦�琤肭磪囓�2,1000,285,715,合庫-台中,2024-10-14,1021
00637L,元大滬深300正2,891,232,659,合庫-台中,2024-10-14,1021
00887,永豐中國科技50大,255,37,218,合庫-台中,2024-10-14,1021
3522,御嵿,182,0,182,合庫-台中,2024-10-14,1021
00632R,元大台灣50反1,141,0,141,合庫-台中,2024-10-14,1021
6156,松上,135,1,134,合庫-台中,2024-10-14,1021
3036,文曄,108,6,102,合庫-台中,2024-10-14,1021
1314,中石化,97,5,92,合庫-台中,2024-10-14,1021
00720B,元大投資級公司債,109,25,84,合庫-台中,2024-10-14,1021
2312,金寶,116,38,78,合庫-台中,2024-10-14,1021
2303,聯電,78,8,70,合庫-台中,2024-10-14,1021
2337,旺宏,65,0,65,合庫-台中,2024-10-14,1021
00712,復華富時不動產,66,1,65,合庫-台中,2024-10-14,1021
0056,元大高股息,93,31,62,合庫-台中,2024-10-14,1021
2887,台新金,165,109,56,合庫-台中,2024-10-14,1021
2362,藍天,84,30,54,合庫-台中,2024-10-14,1021
6530,創威,72,18,54,合庫-台中,2024-10-14,1021
00751B,元大AAA至A公司債,42,0,42,合庫-台中,2024-10-14,1021
3437,榮創,49,9,40,合庫-台中,2024-10-14,1021
00688L,國泰20年美債正2,86,50,36,合庫-台中,2024-10-14,1021
3231,緯創,60,27,33,合庫-台中,2024-10-14,1021
00927,群益半導體收益,32,2,30,合庫-台中,2024-10-14,1021
4763,材料-KY,32,2,30,合庫-台中,2024-10-14,1021
9105,泰金寶-DR,46,18,28,合庫-台中,2024-10-14,1021
00692,富邦公司治理,28,0,28,合庫-台中,2024-10-14,1021
6742,澤米,28,0,28,合庫-台中,2024-10-14,1021
3481,群創,31,4,27,合庫-台中,2024-10-14,1021
6838,台新藥,27,0,27,合庫-台中,2024-10-14,1021
00960,野村全球航運龍頭,25,0,25,合庫-台中,2024-10-14,1021
9902,台火,25,0,25,合庫-台中,2024-10-14,1021
3163,波若威,33,8,25,合庫-台中,2024-10-14,1021
6770,力積電,24,0,24,合庫-台中,2024-10-14,1021
006208,富邦台50,26,2,24,合庫-台中,2024-10-14,1021
1808,潤隆,24,1,23,合庫-台中,2024-10-14,1021
00639,富邦深100,30,7,23,合庫-台中,2024-10-14,1021
00730,富邦臺灣優質高息,23,0,23,合庫-台中,2024-10-14,1021
2103,台橡,27,5,22,合庫-台中,2024-10-14,1021
2832,台產,22,0,22,合庫-台中,2024-10-14,1021
2330,台積電,41,19,22,合庫-台中,2024-10-14,1021
9955,佳龍,21,0,21,合庫-台中,2024-10-14,1021
5225,東科-KY,20,0,20,合庫-台中,2024-10-14,1021
00952,凱基台灣AI50,20,1,19,合庫-台中,2024-10-14,1021
1734,杏輝,18,0,18,合庫-台中,2024-10-14,1021
3093,港建*,18,0,18,合庫-台中,2024-10-14,1021
00752,中信中國50,23,5,18,合庫-台中,2024-10-14,1021
00933B,國泰10Y+金融債,19,1,18,合庫-台中,2024-10-14,1021
5880,合庫金,19,1,18,合庫-台中,2024-10-14,1021
6546,正基,19,2,17,合庫-台中,2024-10-14,1021
2543,皇昌,53,36,17,合庫-台中,2024-10-14,1021
6187,萬潤,23,7,16,合庫-台中,2024-10-14,1021
9105,泰金寶-DR,1242,71,1171,合庫-台中,2024-10-15,1021
00943,兆豐電子高息等權,484,5,479,合庫-台中,2024-10-15,1021
00715L,期街口布蘭特正2,483,78,405,合庫-台中,2024-10-15,1021
1314,中石化,343,56,287,合庫-台中,2024-10-15,1021
00637L,元大滬深300正2,484,207,277,合庫-台中,2024-10-15,1021
2105,正新,163,0,163,合庫-台中,2024-10-15,1021
00688L,國泰20年美債正2,105,5,100,合庫-台中,2024-10-15,1021
00937B,群益ESG投等債20,119,20,99,合庫-台中,2024-10-15,1021
2033,佳大,100,10,90,合庫-台中,2024-10-15,1021
00687B,國泰20年美債,98,10,88,合庫-台中,2024-10-15,1021
5230,雷笛克光學,84,2,82,合庫-台中,2024-10-15,1021
3522,御嵿,70,0,70,合庫-台中,2024-10-15,1021
00679B,元大美債20年,68,1,67,合庫-台中,2024-10-15,1021
00650L,復華香港正2,246,188,58,合庫-台中,2024-10-15,1021
4956,光鋐,110,55,55,合庫-台中,2024-10-15,1021
00919,群益台灣精選高息,84,39,45,合庫-台中,2024-10-15,1021
3013,晟銘電,89,46,43,合庫-台中,2024-10-15,1021
0056,元大高股息,58,15,43,合庫-台中,2024-10-15,1021
00665L,富邦�琤肭磪囓�2,167,125,42,合庫-台中,2024-10-15,1021
00907,永豐優息存股,41,0,41,合庫-台中,2024-10-15,1021
1506,正道,40,0,40,合庫-台中,2024-10-15,1021
00961,FT臺灣永續高息,40,0,40,合庫-台中,2024-10-15,1021
00642U,期元大S＆P石油,40,1,39,合庫-台中,2024-10-15,1021
2426,鼎元,59,23,36,合庫-台中,2024-10-15,1021
3710,連展投控,38,5,33,合庫-台中,2024-10-15,1021
2362,藍天,31,0,31,合庫-台中,2024-10-15,1021
2399,映泰,155,124,31,合庫-台中,2024-10-15,1021
00753L,中信中國50正2,60,32,28,合庫-台中,2024-10-15,1021
2832,台產,28,0,28,合庫-台中,2024-10-15,1021
9902,台火,27,0,27,合庫-台中,2024-10-15,1021
1711,永光,25,0,25,合庫-台中,2024-10-15,1021
5438,東友,58,34,24,合庫-台中,2024-10-15,1021
2062,橋椿,41,18,23,合庫-台中,2024-10-15,1021
4532,瑞智,25,2,23,合庫-台中,2024-10-15,1021
1714,和桐,22,0,22,合庫-台中,2024-10-15,1021
00960,野村全球航運龍頭,22,0,22,合庫-台中,2024-10-15,1021
2349,錸德,39,17,22,合庫-台中,2024-10-15,1021
3047,訊舟,29,7,22,合庫-台中,2024-10-15,1021
00922,國泰台灣領袖50,24,3,21,合庫-台中,2024-10-15,1021
2449,京元電子,53,32,21,合庫-台中,2024-10-15,1021
4772,台特化,20,0,20,合庫-台中,2024-10-15,1021
00952,凱基台灣AI50,19,0,19,合庫-台中,2024-10-15,1021
2313,華通,27,8,19,合庫-台中,2024-10-15,1021
3207,耀勝,18,0,18,合庫-台中,2024-10-15,1021
3706,神達,18,1,17,合庫-台中,2024-10-15,1021
1815,富喬,17,0,17,合庫-台中,2024-10-15,1021
2515,中工,17,0,17,合庫-台中,2024-10-15,1021
8011,台通,22,5,17,合庫-台中,2024-10-15,1021
2801,彰銀,16,0,16,合庫-台中,2024-10-15,1021
5351,鈺創,19,3,16,合庫-台中,2024-10-15,1021
00679B,元大美債20年,1798,24,1774,合庫-台中,2024-10-16,1021
00687B,國泰20年美債,710,6,704,合庫-台中,2024-10-16,1021
00637L,元大滬深300正2,436,139,297,合庫-台中,2024-10-16,1021
00887,永豐中國科技50大,306,32,274,合庫-台中,2024-10-16,1021
00937B,群益ESG投等債20,296,110,186,合庫-台中,2024-10-16,1021
2603,長榮,204,21,183,合庫-台中,2024-10-16,1021
00943,兆豐電子高息等權,165,2,163,合庫-台中,2024-10-16,1021
00922,國泰台灣領袖50,119,8,111,合庫-台中,2024-10-16,1021
00934,中信成長高股息,103,0,103,合庫-台中,2024-10-16,1021
0056,元大高股息,116,15,101,合庫-台中,2024-10-16,1021
00932,兆豐永續高息等權,101,0,101,合庫-台中,2024-10-16,1021
6125,廣運,111,10,101,合庫-台中,2024-10-16,1021
2317,鴻海,177,78,99,合庫-台中,2024-10-16,1021
00919,群益台灣精選高息,106,12,94,合庫-台中,2024-10-16,1021
4729,熒茂,84,0,84,合庫-台中,2024-10-16,1021
1314,中石化,82,15,67,合庫-台中,2024-10-16,1021
00715L,期街口布蘭特正2,66,0,66,合庫-台中,2024-10-16,1021
2888,新光金,88,24,64,合庫-台中,2024-10-16,1021
2313,華通,72,10,62,合庫-台中,2024-10-16,1021
6770,力積電,57,0,57,合庫-台中,2024-10-16,1021
4406,新昕纖,55,0,55,合庫-台中,2024-10-16,1021
5351,鈺創,51,1,50,合庫-台中,2024-10-16,1021
2441,超豐,58,8,50,合庫-台中,2024-10-16,1021
5880,合庫金,50,9,41,合庫-台中,2024-10-16,1021
2887,台新金,39,2,37,合庫-台中,2024-10-16,1021
00927,群益半導體收益,39,2,37,合庫-台中,2024-10-16,1021
00878,國泰永續高股息,49,15,34,合庫-台中,2024-10-16,1021
00941,中信上游半導體,34,1,33,合庫-台中,2024-10-16,1021
00688L,國泰20年美債正2,47,16,31,合庫-台中,2024-10-16,1021
00753L,中信中國50正2,91,61,30,合庫-台中,2024-10-16,1021
3062,建漢,79,50,29,合庫-台中,2024-10-16,1021
00912,中信臺灣智慧50,29,0,29,合庫-台中,2024-10-16,1021
00961,FT臺灣永續高息,28,0,28,合庫-台中,2024-10-16,1021
00918,大華優利高填息30,27,0,27,合庫-台中,2024-10-16,1021
2834,臺企銀,29,4,25,合庫-台中,2024-10-16,1021
2303,聯電,25,1,24,合庫-台中,2024-10-16,1021
1409,新纖,21,0,21,合庫-台中,2024-10-16,1021
00944,野村趨勢動能高息,21,0,21,合庫-台中,2024-10-16,1021
1536,和大,21,0,21,合庫-台中,2024-10-16,1021
2365,昆盈,48,27,21,合庫-台中,2024-10-16,1021
6530,創威,65,44,21,合庫-台中,2024-10-16,1021
00905,FT臺灣Smart,23,2,21,合庫-台中,2024-10-16,1021
6187,萬潤,33,12,21,合庫-台中,2024-10-16,1021
00685L,群益臺灣加權正2,20,0,20,合庫-台中,2024-10-16,1021
2332,友訊,20,0,20,合庫-台中,2024-10-16,1021
1714,和桐,20,0,20,合庫-台中,2024-10-16,1021
006206,元大上證50,20,0,20,合庫-台中,2024-10-16,1021
00713,元大台灣高息低波,20,0,20,合庫-台中,2024-10-16,1021
2881,富邦金,19,1,18,合庫-台中,2024-10-16,1021
5536,聖暉*,19,2,17,合庫-台中,2024-10-16,1021
00632R,元大台灣50反1,1350,2,1348,合庫-台中,2024-10-17,1021
00665L,富邦�琤肭磪囓�2,938,79,859,合庫-台中,2024-10-17,1021
00664R,國泰臺灣加權反1,300,0,300,合庫-台中,2024-10-17,1021
00637L,元大滬深300正2,1262,998,264,合庫-台中,2024-10-17,1021
2891,中信金,263,6,257,合庫-台中,2024-10-17,1021
00887,永豐中國科技50大,266,15,251,合庫-台中,2024-10-17,1021
0056,元大高股息,186,9,177,合庫-台中,2024-10-17,1021
2888,新光金,126,12,114,合庫-台中,2024-10-17,1021
2845,遠東銀,106,0,106,合庫-台中,2024-10-17,1021
00943,兆豐電子高息等權,71,0,71,合庫-台中,2024-10-17,1021
3062,建漢,94,24,70,合庫-台中,2024-10-17,1021
2449,京元電子,132,65,67,合庫-台中,2024-10-17,1021
00882,中信中國高股息,93,29,64,合庫-台中,2024-10-17,1021
2485,兆赫,54,0,54,合庫-台中,2024-10-17,1021
5202,力新,51,0,51,合庫-台中,2024-10-17,1021
00922,國泰台灣領袖50,64,14,50,合庫-台中,2024-10-17,1021
00941,中信上游半導體,58,10,48,合庫-台中,2024-10-17,1021
00650L,復華香港正2,126,79,47,合庫-台中,2024-10-17,1021
2317,鴻海,618,572,46,合庫-台中,2024-10-17,1021
5452,佶優,77,37,40,合庫-台中,2024-10-17,1021
006206,元大上證50,40,0,40,合庫-台中,2024-10-17,1021
2399,映泰,78,39,39,合庫-台中,2024-10-17,1021
2388,威盛,42,4,38,合庫-台中,2024-10-17,1021
2618,長榮航,61,30,31,合庫-台中,2024-10-17,1021
00715L,期街口布蘭特正2,32,2,30,合庫-台中,2024-10-17,1021
5521,工信,30,0,30,合庫-台中,2024-10-17,1021
00692,富邦公司治理,30,0,30,合庫-台中,2024-10-17,1021
8240,華宏,28,0,28,合庫-台中,2024-10-17,1021
8111,立��,71,45,26,合庫-台中,2024-10-17,1021
1708,東鹼,21,0,21,合庫-台中,2024-10-17,1021
2605,新興,21,1,20,合庫-台中,2024-10-17,1021
2915,潤泰全,21,1,20,合庫-台中,2024-10-17,1021
1506,正道,20,0,20,合庫-台中,2024-10-17,1021
4729,熒茂,19,0,19,合庫-台中,2024-10-17,1021
00919,群益台灣精選高息,34,16,18,合庫-台中,2024-10-17,1021
6215,和椿,24,6,18,合庫-台中,2024-10-17,1021
00951,台新日本半導體,22,5,17,合庫-台中,2024-10-17,1021
00912,中信臺灣智慧50,16,0,16,合庫-台中,2024-10-17,1021
1595,川寶,17,1,16,合庫-台中,2024-10-17,1021
00927,群益半導體收益,17,2,15,合庫-台中,2024-10-17,1021
8103,瀚荃,14,0,14,合庫-台中,2024-10-17,1021
1612,宏泰,14,0,14,合庫-台中,2024-10-17,1021
3663,鑫科,22,8,14,合庫-台中,2024-10-17,1021
4956,光鋐,30,16,14,合庫-台中,2024-10-17,1021
1721,三晃,34,21,13,合庫-台中,2024-10-17,1021
00655L,國泰中國A50正2,13,0,13,合庫-台中,2024-10-17,1021
1727,中華化,28,15,13,合庫-台中,2024-10-17,1021
2633,台灣高鐵,14,1,13,合庫-台中,2024-10-17,1021
2426,鼎元,13,0,13,合庫-台中,2024-10-17,1021
6274,台燿,13,1,12,合庫-台中,2024-10-17,1021
9105,泰金寶-DR,1150,41,1109,合庫-台中,2024-10-18,1021
00929,復華台灣科技優息,306,98,208,合庫-台中,2024-10-18,1021
00937B,群益ESG投等債20,231,39,192,合庫-台中,2024-10-18,1021
00687B,國泰20年美債,172,3,169,合庫-台中,2024-10-18,1021
2303,聯電,271,116,155,合庫-台中,2024-10-18,1021
2485,兆赫,121,0,121,合庫-台中,2024-10-18,1021
00948B,中信優息投資級債,112,0,112,合庫-台中,2024-10-18,1021
2887,台新金,116,5,111,合庫-台中,2024-10-18,1021
00720B,元大投資級公司債,109,0,109,合庫-台中,2024-10-18,1021
2356,英業達,118,12,106,合庫-台中,2024-10-18,1021
00751B,元大AAA至A公司債,101,0,101,合庫-台中,2024-10-18,1021
0056,元大高股息,103,12,91,合庫-台中,2024-10-18,1021
2867,三商壽,110,21,89,合庫-台中,2024-10-18,1021
00679B,元大美債20年,163,75,88,合庫-台中,2024-10-18,1021
5347,世界,69,9,60,合庫-台中,2024-10-18,1021
00887,永豐中國科技50大,99,40,59,合庫-台中,2024-10-18,1021
2449,京元電子,74,21,53,合庫-台中,2024-10-18,1021
3149,正達,100,49,51,合庫-台中,2024-10-18,1021
6016,康和證,50,0,50,合庫-台中,2024-10-18,1021
2402,毅嘉,65,16,49,合庫-台中,2024-10-18,1021
3005,神基,53,5,48,合庫-台中,2024-10-18,1021
00918,大華優利高填息30,57,11,46,合庫-台中,2024-10-18,1021
2399,映泰,78,33,45,合庫-台中,2024-10-18,1021
6215,和椿,44,0,44,合庫-台中,2024-10-18,1021
3031,佰鴻,55,11,44,合庫-台中,2024-10-18,1021
1314,中石化,149,110,39,合庫-台中,2024-10-18,1021
6425,易發,38,1,37,合庫-台中,2024-10-18,1021
6213,聯茂,37,1,36,合庫-台中,2024-10-18,1021
3062,建漢,43,8,35,合庫-台中,2024-10-18,1021
2344,華邦電,36,1,35,合庫-台中,2024-10-18,1021
00688L,國泰20年美債正2,37,4,33,合庫-台中,2024-10-18,1021
00680L,元大美債20正2,53,20,33,合庫-台中,2024-10-18,1021
00941,中信上游半導體,30,0,30,合庫-台中,2024-10-18,1021
6134,萬旭,59,30,29,合庫-台中,2024-10-18,1021
2313,華通,36,7,29,合庫-台中,2024-10-18,1021
8028,昇陽半導體,150,122,28,合庫-台中,2024-10-18,1021
2388,威盛,42,15,27,合庫-台中,2024-10-18,1021
8033,雷虎,27,1,26,合庫-台中,2024-10-18,1021
2888,新光金,32,7,25,合庫-台中,2024-10-18,1021
00950B,凱基A級公司債,25,0,25,合庫-台中,2024-10-18,1021
00946,群益科技高息成長,24,0,24,合庫-台中,2024-10-18,1021
00733,富邦臺灣中小,23,0,23,合庫-台中,2024-10-18,1021
00650L,復華香港正2,216,193,23,合庫-台中,2024-10-18,1021
2349,錸德,28,6,22,合庫-台中,2024-10-18,1021
006206,元大上證50,21,0,21,合庫-台中,2024-10-18,1021
2409,友達,55,35,20,合庫-台中,2024-10-18,1021
00919,群益台灣精選高息,82,62,20,合庫-台中,2024-10-18,1021
00642U,期元大S＆P石油,20,0,20,合庫-台中,2024-10-18,1021
1785,光洋科,37,17,20,合庫-台中,2024-10-18,1021
2617,台航,20,0,20,合庫-台中,2024-10-18,1021
2317,鴻海,574,66,508,合庫-台中,2024-10-21,1021
00937B,群益ESG投等債20,489,40,449,合庫-台中,2024-10-21,1021
2891,中信金,386,23,363,合庫-台中,2024-10-21,1021
4576,大銀微系統,348,93,255,合庫-台中,2024-10-21,1021
2883,凱基金,221,21,200,合庫-台中,2024-10-21,1021
00905,FT臺灣Smart,197,2,195,合庫-台中,2024-10-21,1021
8069,元太,124,1,123,合庫-台中,2024-10-21,1021
00907,永豐優息存股,113,2,111,合庫-台中,2024-10-21,1021
00878,國泰永續高股息,139,52,87,合庫-台中,2024-10-21,1021
00688L,國泰20年美債正2,117,30,87,合庫-台中,2024-10-21,1021
00637L,元大滬深300正2,239,164,75,合庫-台中,2024-10-21,1021
00650L,復華香港正2,169,99,70,合庫-台中,2024-10-21,1021
00679B,元大美債20年,138,74,64,合庫-台中,2024-10-21,1021
2303,聯電,152,90,62,合庫-台中,2024-10-21,1021
00751B,元大AAA至A公司債,62,0,62,合庫-台中,2024-10-21,1021
0056,元大高股息,85,25,60,合庫-台中,2024-10-21,1021
00715L,期街口布蘭特正2,55,0,55,合庫-台中,2024-10-21,1021
2515,中工,53,0,53,合庫-台中,2024-10-21,1021
00687B,國泰20年美債,103,51,52,合庫-台中,2024-10-21,1021
00753L,中信中國50正2,57,5,52,合庫-台中,2024-10-21,1021
3339,泰谷,55,5,50,合庫-台中,2024-10-21,1021
00712,復華富時不動產,47,0,47,合庫-台中,2024-10-21,1021
2884,玉山金,51,4,47,合庫-台中,2024-10-21,1021
00882,中信中國高股息,155,110,45,合庫-台中,2024-10-21,1021
2104,國際中橡,41,0,41,合庫-台中,2024-10-21,1021
00960,野村全球航運龍頭,48,10,38,合庫-台中,2024-10-21,1021
2409,友達,82,50,32,合庫-台中,2024-10-21,1021
00887,永豐中國科技50大,97,66,31,合庫-台中,2024-10-21,1021
6016,康和證,31,0,31,合庫-台中,2024-10-21,1021
3013,晟銘電,127,98,29,合庫-台中,2024-10-21,1021
9938,百和,33,4,29,合庫-台中,2024-10-21,1021
2349,錸德,57,28,29,合庫-台中,2024-10-21,1021
2537,聯上發,29,0,29,合庫-台中,2024-10-21,1021
4406,新昕纖,29,0,29,合庫-台中,2024-10-21,1021
2002,中鋼,31,4,27,合庫-台中,2024-10-21,1021
2323,中環,27,0,27,合庫-台中,2024-10-21,1021
1326,台化,27,0,27,合庫-台中,2024-10-21,1021
4533,協易機,33,7,26,合庫-台中,2024-10-21,1021
1309,台達化,25,0,25,合庫-台中,2024-10-21,1021
00680L,元大美債20正2,25,0,25,合庫-台中,2024-10-21,1021
00642U,期元大S＆P石油,24,0,24,合庫-台中,2024-10-21,1021
6530,創威,32,8,24,合庫-台中,2024-10-21,1021
00795B,中信美國公債20年,26,4,22,合庫-台中,2024-10-21,1021
00950B,凱基A級公司債,22,0,22,合庫-台中,2024-10-21,1021
00632R,元大台灣50反1,27,5,22,合庫-台中,2024-10-21,1021
1101,台泥,21,0,21,合庫-台中,2024-10-21,1021
8932,智通*,21,0,21,合庫-台中,2024-10-21,1021
2888,新光金,21,0,21,合庫-台中,2024-10-21,1021
1810,和成,20,0,20,合庫-台中,2024-10-21,1021
00877,復華中國5G,21,1,20,合庫-台中,2024-10-21,1021
00937B,群益ESG投等債20,894,327,567,合庫-台中,2024-10-22,1021
2801,彰銀,250,50,200,合庫-台中,2024-10-22,1021
00680L,元大美債20正2,183,0,183,合庫-台中,2024-10-22,1021
2543,皇昌,122,3,119,合庫-台中,2024-10-22,1021
00712,復華富時不動產,117,20,97,合庫-台中,2024-10-22,1021
2388,威盛,92,21,71,合庫-台中,2024-10-22,1021
00929,復華台灣科技優息,119,51,68,合庫-台中,2024-10-22,1021
00959B,大華投等美債15Y+,65,0,65,合庫-台中,2024-10-22,1021
00922,國泰台灣領袖50,65,1,64,合庫-台中,2024-10-22,1021
5315,光聯,84,21,63,合庫-台中,2024-10-22,1021
00751B,元大AAA至A公司債,60,2,58,合庫-台中,2024-10-22,1021
2363,矽統,94,38,56,合庫-台中,2024-10-22,1021
0056,元大高股息,63,9,54,合庫-台中,2024-10-22,1021
00950B,凱基A級公司債,52,0,52,合庫-台中,2024-10-22,1021
2002,中鋼,49,2,47,合庫-台中,2024-10-22,1021
3339,泰谷,45,0,45,合庫-台中,2024-10-22,1021
1528,恩德,44,2,42,合庫-台中,2024-10-22,1021
00927,群益半導體收益,41,0,41,合庫-台中,2024-10-22,1021
2376,技嘉,54,16,38,合庫-台中,2024-10-22,1021
2615,萬海,50,13,37,合庫-台中,2024-10-22,1021
00941,中信上游半導體,36,0,36,合庫-台中,2024-10-22,1021
5488,松普,36,0,36,合庫-台中,2024-10-22,1021
2609,陽明,205,172,33,合庫-台中,2024-10-22,1021
00720B,元大投資級公司債,42,10,32,合庫-台中,2024-10-22,1021
5215,科嘉-KY,52,20,32,合庫-台中,2024-10-22,1021
00688L,國泰20年美債正2,31,0,31,合庫-台中,2024-10-22,1021
2888,新光金,64,36,28,合庫-台中,2024-10-22,1021
3615,安可,87,60,27,合庫-台中,2024-10-22,1021
3710,連展投控,28,1,27,合庫-台中,2024-10-22,1021
6134,萬旭,28,3,25,合庫-台中,2024-10-22,1021
00933B,國泰10Y+金融債,45,20,25,合庫-台中,2024-10-22,1021
00905,FT臺灣Smart,25,0,25,合庫-台中,2024-10-22,1021
2313,華通,48,24,24,合庫-台中,2024-10-22,1021
4406,新昕纖,23,0,23,合庫-台中,2024-10-22,1021
00637L,元大滬深300正2,141,118,23,合庫-台中,2024-10-22,1021
00948B,中信優息投資級債,59,38,21,合庫-台中,2024-10-22,1021
5234,達興材料,21,0,21,合庫-台中,2024-10-22,1021
8032,光菱,66,45,21,合庫-台中,2024-10-22,1021
4540,全球傳動,68,47,21,合庫-台中,2024-10-22,1021
6125,廣運,28,9,19,合庫-台中,2024-10-22,1021
1513,中興電,18,0,18,合庫-台中,2024-10-22,1021
2344,華邦電,19,1,18,合庫-台中,2024-10-22,1021
5443,均豪,18,1,17,合庫-台中,2024-10-22,1021
3049,精金,85,68,17,合庫-台中,2024-10-22,1021
3189,景碩,64,47,17,合庫-台中,2024-10-22,1021
9921,巨大,16,0,16,合庫-台中,2024-10-22,1021
4533,協易機,20,4,16,合庫-台中,2024-10-22,1021
00907,永豐優息存股,15,0,15,合庫-台中,2024-10-22,1021
4908,前鼎,16,1,15,合庫-台中,2024-10-22,1021
2485,兆赫,15,0,15,合庫-台中,2024-10-22,1021
00937B,群益ESG投等債20,1041,105,936,合庫-台中,2024-10-23,1021
00665L,富邦�琤肭磪囓�2,982,104,878,合庫-台中,2024-10-23,1021
00673R,期元大S＆P原油反1,210,0,210,合庫-台中,2024-10-23,1021
00680L,元大美債20正2,162,0,162,合庫-台中,2024-10-23,1021
2477,美隆電,108,13,95,合庫-台中,2024-10-23,1021
00878,國泰永續高股息,107,21,86,合庫-台中,2024-10-23,1021
00679B,元大美債20年,81,1,80,合庫-台中,2024-10-23,1021
00687B,國泰20年美債,95,16,79,合庫-台中,2024-10-23,1021
0056,元大高股息,75,0,75,合庫-台中,2024-10-23,1021
00887,永豐中國科技50大,86,11,75,合庫-台中,2024-10-23,1021
3372,典範,69,5,64,合庫-台中,2024-10-23,1021
00637L,元大滬深300正2,250,187,63,合庫-台中,2024-10-23,1021
5880,合庫金,65,4,61,合庫-台中,2024-10-23,1021
00706L,期元大S＆P日圓正2,59,0,59,合庫-台中,2024-10-23,1021
2303,聯電,66,11,55,合庫-台中,2024-10-23,1021
00712,復華富時不動產,54,0,54,合庫-台中,2024-10-23,1021
2887,台新金,45,0,45,合庫-台中,2024-10-23,1021
6120,達運,67,28,39,合庫-台中,2024-10-23,1021
1301,台塑,40,3,37,合庫-台中,2024-10-23,1021
2618,長榮航,60,23,37,合庫-台中,2024-10-23,1021
2388,威盛,37,3,34,合庫-台中,2024-10-23,1021
2542,興富發,38,5,33,合庫-台中,2024-10-23,1021
00933B,國泰10Y+金融債,36,4,32,合庫-台中,2024-10-23,1021
00919,群益台灣精選高息,82,50,32,合庫-台中,2024-10-23,1021
6151,晉倫,72,41,31,合庫-台中,2024-10-23,1021
6016,康和證,30,0,30,合庫-台中,2024-10-23,1021
00688L,國泰20年美債正2,28,0,28,合庫-台中,2024-10-23,1021
1316,上曜,27,0,27,合庫-台中,2024-10-23,1021
3049,精金,32,5,27,合庫-台中,2024-10-23,1021
2884,玉山金,26,0,26,合庫-台中,2024-10-23,1021
2312,金寶,39,13,26,合庫-台中,2024-10-23,1021
00945B,凱基美國非投等債,26,0,26,合庫-台中,2024-10-23,1021
2834,臺企銀,38,13,25,合庫-台中,2024-10-23,1021
2369,菱生,47,22,25,合庫-台中,2024-10-23,1021
00938,凱基優選30,25,0,25,合庫-台中,2024-10-23,1021
8032,光菱,54,29,25,合庫-台中,2024-10-23,1021
00940,元大台灣價值高息,67,42,25,合庫-台中,2024-10-23,1021
3339,泰谷,25,0,25,合庫-台中,2024-10-23,1021
1314,中石化,24,0,24,合庫-台中,2024-10-23,1021
3149,正達,32,8,24,合庫-台中,2024-10-23,1021
00631L,元大台灣50正2,73,51,22,合庫-台中,2024-10-23,1021
2540,愛山林,21,0,21,合庫-台中,2024-10-23,1021
00751B,元大AAA至A公司債,20,0,20,合庫-台中,2024-10-23,1021
1326,台化,24,5,19,合庫-台中,2024-10-23,1021
00907,永豐優息存股,18,0,18,合庫-台中,2024-10-23,1021
3167,大量,31,13,18,合庫-台中,2024-10-23,1021
3013,晟銘電,74,57,17,合庫-台中,2024-10-23,1021
2337,旺宏,17,0,17,合庫-台中,2024-10-23,1021
2374,佳能,18,1,17,合庫-台中,2024-10-23,1021
2867,三商壽,38,22,16,合庫-台中,2024-10-23,1021
00937B,群益ESG投等債20,1172,41,1131,合庫-台中,2024-10-24,1021
2489,瑞軒,502,91,411,合庫-台中,2024-10-24,1021
2317,鴻海,591,194,397,合庫-台中,2024-10-24,1021
00882,中信中國高股息,334,21,313,合庫-台中,2024-10-24,1021
2388,威盛,158,7,151,合庫-台中,2024-10-24,1021
00878,國泰永續高股息,144,1,143,合庫-台中,2024-10-24,1021
0056,元大高股息,153,11,142,合庫-台中,2024-10-24,1021
1528,恩德,195,75,120,合庫-台中,2024-10-24,1021
00655L,國泰中國A50正2,118,0,118,合庫-台中,2024-10-24,1021
00650L,復華香港正2,389,273,116,合庫-台中,2024-10-24,1021
00753L,中信中國50正2,125,20,105,合庫-台中,2024-10-24,1021
00929,復華台灣科技優息,133,30,103,合庫-台中,2024-10-24,1021
8069,元太,102,5,97,合庫-台中,2024-10-24,1021
3481,群創,155,62,93,合庫-台中,2024-10-24,1021
00887,永豐中國科技50大,119,38,81,合庫-台中,2024-10-24,1021
4716,大立,157,77,80,合庫-台中,2024-10-24,1021
2485,兆赫,75,0,75,合庫-台中,2024-10-24,1021
00919,群益台灣精選高息,108,33,75,合庫-台中,2024-10-24,1021
6213,聯茂,69,18,51,合庫-台中,2024-10-24,1021
2312,金寶,73,24,49,合庫-台中,2024-10-24,1021
00891,中信關鍵半導體,47,0,47,合庫-台中,2024-10-24,1021
4563,百德,44,1,43,合庫-台中,2024-10-24,1021
00948B,中信優息投資級債,44,3,41,合庫-台中,2024-10-24,1021
2349,錸德,52,12,40,合庫-台中,2024-10-24,1021
2486,一詮,62,26,36,合庫-台中,2024-10-24,1021
2449,京元電子,42,7,35,合庫-台中,2024-10-24,1021
2891,中信金,36,2,34,合庫-台中,2024-10-24,1021
6589,台康生技,37,3,34,合庫-台中,2024-10-24,1021
00933B,國泰10Y+金融債,34,0,34,合庫-台中,2024-10-24,1021
1806,冠軍,75,42,33,合庫-台中,2024-10-24,1021
00720B,元大投資級公司債,53,20,33,合庫-台中,2024-10-24,1021
2303,聯電,99,66,33,合庫-台中,2024-10-24,1021
2884,玉山金,34,2,32,合庫-台中,2024-10-24,1021
00950B,凱基A級公司債,30,0,30,合庫-台中,2024-10-24,1021
2498,宏達電,64,34,30,合庫-台中,2024-10-24,1021
4729,熒茂,110,83,27,合庫-台中,2024-10-24,1021
2062,橋椿,26,0,26,合庫-台中,2024-10-24,1021
6405,悅城,45,19,26,合庫-台中,2024-10-24,1021
6770,力積電,154,129,25,合庫-台中,2024-10-24,1021
00881,國泰台灣5G+,25,0,25,合庫-台中,2024-10-24,1021
6451,訊芯-KY,34,9,25,合庫-台中,2024-10-24,1021
4958,臻鼎-KY,24,0,24,合庫-台中,2024-10-24,1021
4979,華星光,51,28,23,合庫-台中,2024-10-24,1021
3709,鑫聯大投控,23,0,23,合庫-台中,2024-10-24,1021
2329,華泰,56,33,23,合庫-台中,2024-10-24,1021
1717,長興,22,0,22,合庫-台中,2024-10-24,1021
2399,映泰,74,52,22,合庫-台中,2024-10-24,1021
6139,亞翔,22,1,21,合庫-台中,2024-10-24,1021
00679B,元大美債20年,62,42,20,合庫-台中,2024-10-24,1021
00632R,元大台灣50反1,30,10,20,合庫-台中,2024-10-24,1021
2646,星宇航空,855,205,650,合庫-台中,2024-10-25,1021
00937B,群益ESG投等債20,567,142,425,合庫-台中,2024-10-25,1021
00715L,期街口布蘭特正2,121,0,121,合庫-台中,2024-10-25,1021
00959B,大華投等美債15Y+,103,0,103,合庫-台中,2024-10-25,1021
2834,臺企銀,66,4,62,合庫-台中,2024-10-25,1021
00915,凱基優選高股息30,57,0,57,合庫-台中,2024-10-25,1021
4739,康普,61,6,55,合庫-台中,2024-10-25,1021
2204,中華,52,0,52,合庫-台中,2024-10-25,1021
00887,永豐中國科技50大,57,10,47,合庫-台中,2024-10-25,1021
4406,新昕纖,44,0,44,合庫-台中,2024-10-25,1021
00642U,期元大S＆P石油,42,0,42,合庫-台中,2024-10-25,1021
2344,華邦電,44,2,42,合庫-台中,2024-10-25,1021
5521,工信,38,1,37,合庫-台中,2024-10-25,1021
6770,力積電,186,154,32,合庫-台中,2024-10-25,1021
3149,正達,47,17,30,合庫-台中,2024-10-25,1021
2887,台新金,31,1,30,合庫-台中,2024-10-25,1021
00905,FT臺灣Smart,28,0,28,合庫-台中,2024-10-25,1021
2884,玉山金,25,0,25,合庫-台中,2024-10-25,1021
2356,英業達,50,25,25,合庫-台中,2024-10-25,1021
3013,晟銘電,100,76,24,合庫-台中,2024-10-25,1021
4526,東台,25,1,24,合庫-台中,2024-10-25,1021
4303,信立,25,1,24,合庫-台中,2024-10-25,1021
00919,群益台灣精選高息,25,3,22,合庫-台中,2024-10-25,1021
00795B,中信美國公債20年,22,0,22,合庫-台中,2024-10-25,1021
1810,和成,22,0,22,合庫-台中,2024-10-25,1021
2543,皇昌,37,15,22,合庫-台中,2024-10-25,1021
6405,悅城,43,21,22,合庫-台中,2024-10-25,1021
1506,正道,20,0,20,合庫-台中,2024-10-25,1021
8043,蜜望實,29,9,20,合庫-台中,2024-10-25,1021
2303,聯電,40,20,20,合庫-台中,2024-10-25,1021
3481,群創,77,57,20,合庫-台中,2024-10-25,1021
8074,鉅橡,29,12,17,合庫-台中,2024-10-25,1021
2495,普安,127,111,16,合庫-台中,2024-10-25,1021
2338,光罩,16,0,16,合庫-台中,2024-10-25,1021
00751B,元大AAA至A公司債,17,1,16,合庫-台中,2024-10-25,1021
1528,恩德,29,13,16,合庫-台中,2024-10-25,1021
4903,聯光通,58,42,16,合庫-台中,2024-10-25,1021
2388,威盛,23,8,15,合庫-台中,2024-10-25,1021
2455,全新,41,26,15,合庫-台中,2024-10-25,1021
3060,銘異,16,1,15,合庫-台中,2024-10-25,1021
00857B,永豐20年美公債,15,0,15,合庫-台中,2024-10-25,1021
1307,三芳,16,2,14,合庫-台中,2024-10-25,1021
00960,野村全球航運龍頭,14,0,14,合庫-台中,2024-10-25,1021
6207,雷科,17,3,14,合庫-台中,2024-10-25,1021
4952,凌通,21,7,14,合庫-台中,2024-10-25,1021
2449,京元電子,14,1,13,合庫-台中,2024-10-25,1021
6416,瑞祺電通,13,0,13,合庫-台中,2024-10-25,1021
2363,矽統,19,7,12,合庫-台中,2024-10-25,1021
00938,凱基優選30,12,0,12,合庫-台中,2024-10-25,1021
2462,良得電,12,0,12,合庫-台中,2024-10-25,1021
00715L,期街口布蘭特正2,600,0,600,合庫-台中,2024-10-28,1021
00948B,中信優息投資級債,230,0,230,合庫-台中,2024-10-28,1021
6133,金橋,213,33,180,合庫-台中,2024-10-28,1021
00680L,元大美債20正2,156,40,116,合庫-台中,2024-10-28,1021
2801,彰銀,108,1,107,合庫-台中,2024-10-28,1021
5488,松普,147,40,107,合庫-台中,2024-10-28,1021
2646,星宇航空,295,198,97,合庫-台中,2024-10-28,1021
00679B,元大美債20年,144,53,91,合庫-台中,2024-10-28,1021
00937B,群益ESG投等債20,145,65,80,合庫-台中,2024-10-28,1021
00712,復華富時不動產,68,1,67,合庫-台中,2024-10-28,1021
00929,復華台灣科技優息,95,31,64,合庫-台中,2024-10-28,1021
1528,恩德,88,28,60,合庫-台中,2024-10-28,1021
00958B,永豐ESG銀行債15,57,0,57,合庫-台中,2024-10-28,1021
00637L,元大滬深300正2,131,78,53,合庫-台中,2024-10-28,1021
2439,美律,50,0,50,合庫-台中,2024-10-28,1021
00642U,期元大S＆P石油,48,0,48,合庫-台中,2024-10-28,1021
00751B,元大AAA至A公司債,60,15,45,合庫-台中,2024-10-28,1021
00887,永豐中國科技50大,62,18,44,合庫-台中,2024-10-28,1021
8249,菱光,211,169,42,合庫-台中,2024-10-28,1021
0056,元大高股息,55,13,42,合庫-台中,2024-10-28,1021
1584,精剛,42,0,42,合庫-台中,2024-10-28,1021
00795B,中信美國公債20年,46,6,40,合庫-台中,2024-10-28,1021
00933B,國泰10Y+金融債,39,0,39,合庫-台中,2024-10-28,1021
2884,玉山金,38,0,38,合庫-台中,2024-10-28,1021
6770,力積電,48,11,37,合庫-台中,2024-10-28,1021
00687B,國泰20年美債,45,11,34,合庫-台中,2024-10-28,1021
1718,中纖,30,0,30,合庫-台中,2024-10-28,1021
2485,兆赫,29,0,29,合庫-台中,2024-10-28,1021
1605,華新,31,2,29,合庫-台中,2024-10-28,1021
6127,九豪,33,4,29,合庫-台中,2024-10-28,1021
2515,中工,31,3,28,合庫-台中,2024-10-28,1021
2303,聯電,206,178,28,合庫-台中,2024-10-28,1021
6288,聯嘉,102,75,27,合庫-台中,2024-10-28,1021
6763,綠界科技*,29,3,26,合庫-台中,2024-10-28,1021
4406,新昕纖,23,0,23,合庫-台中,2024-10-28,1021
2025,千興,23,0,23,合庫-台中,2024-10-28,1021
1307,三芳,22,0,22,合庫-台中,2024-10-28,1021
2486,一詮,83,62,21,合庫-台中,2024-10-28,1021
2444,兆勁,20,0,20,合庫-台中,2024-10-28,1021
00650L,復華香港正2,96,76,20,合庫-台中,2024-10-28,1021
6114,久威,22,2,20,合庫-台中,2024-10-28,1021
9105,泰金寶-DR,44,25,19,合庫-台中,2024-10-28,1021
2376,技嘉,22,3,19,合庫-台中,2024-10-28,1021
3338,泰碩,20,2,18,合庫-台中,2024-10-28,1021
4510,高鋒,31,14,17,合庫-台中,2024-10-28,1021
8111,立��,20,3,17,合庫-台中,2024-10-28,1021
8064,東捷,20,3,17,合庫-台中,2024-10-28,1021
2393,億光,20,4,16,合庫-台中,2024-10-28,1021
00943,兆豐電子高息等權,16,0,16,合庫-台中,2024-10-28,1021
5386,青雲,21,5,16,合庫-台中,2024-10-28,1021
00664R,國泰臺灣加權反1,450,2,448,合庫-台中,2024-10-29,1021
00715L,期街口布蘭特正2,353,1,352,合庫-台中,2024-10-29,1021
2883,凱基金,269,12,257,合庫-台中,2024-10-29,1021
00919,群益台灣精選高息,281,66,215,合庫-台中,2024-10-29,1021
00878,國泰永續高股息,234,44,190,合庫-台中,2024-10-29,1021
0056,元大高股息,152,2,150,合庫-台中,2024-10-29,1021
1314,中石化,145,4,141,合庫-台中,2024-10-29,1021
00642U,期元大S＆P石油,114,0,114,合庫-台中,2024-10-29,1021
5880,合庫金,120,34,86,合庫-台中,2024-10-29,1021
00918,大華優利高填息30,80,4,76,合庫-台中,2024-10-29,1021
2303,聯電,165,90,75,合庫-台中,2024-10-29,1021
00927,群益半導體收益,75,1,74,合庫-台中,2024-10-29,1021
2609,陽明,100,31,69,合庫-台中,2024-10-29,1021
2317,鴻海,150,81,69,合庫-台中,2024-10-29,1021
1785,光洋科,69,4,65,合庫-台中,2024-10-29,1021
2362,藍天,65,1,64,合庫-台中,2024-10-29,1021
2105,正新,59,0,59,合庫-台中,2024-10-29,1021
00712,復華富時不動產,58,0,58,合庫-台中,2024-10-29,1021
00940,元大台灣價值高息,58,2,56,合庫-台中,2024-10-29,1021
2409,友達,58,4,54,合庫-台中,2024-10-29,1021
1718,中纖,50,0,50,合庫-台中,2024-10-29,1021
00922,國泰台灣領袖50,50,0,50,合庫-台中,2024-10-29,1021
00687B,國泰20年美債,59,10,49,合庫-台中,2024-10-29,1021
1605,華新,49,0,49,合庫-台中,2024-10-29,1021
4569,六方科-KY,49,1,48,合庫-台中,2024-10-29,1021
6156,松上,46,1,45,合庫-台中,2024-10-29,1021
00881,國泰台灣5G+,42,1,41,合庫-台中,2024-10-29,1021
3481,群創,84,48,36,合庫-台中,2024-10-29,1021
8107,大億金茂,74,38,36,合庫-台中,2024-10-29,1021
2834,臺企銀,44,10,34,合庫-台中,2024-10-29,1021
00937B,群益ESG投等債20,112,78,34,合庫-台中,2024-10-29,1021
00915,凱基優選高股息30,34,1,33,合庫-台中,2024-10-29,1021
2884,玉山金,32,0,32,合庫-台中,2024-10-29,1021
00713,元大台灣高息低波,32,0,32,合庫-台中,2024-10-29,1021
00959B,大華投等美債15Y+,32,0,32,合庫-台中,2024-10-29,1021
2344,華邦電,37,5,32,合庫-台中,2024-10-29,1021
2323,中環,34,2,32,合庫-台中,2024-10-29,1021
00692,富邦公司治理,30,0,30,合庫-台中,2024-10-29,1021
2376,技嘉,33,3,30,合庫-台中,2024-10-29,1021
1789,神隆,26,0,26,合庫-台中,2024-10-29,1021
6770,力積電,33,7,26,合庫-台中,2024-10-29,1021
2301,光寶科,30,5,25,合庫-台中,2024-10-29,1021
00891,中信關鍵半導體,25,0,25,合庫-台中,2024-10-29,1021
1449,佳和,35,10,25,合庫-台中,2024-10-29,1021
00690,兆豐藍籌30,23,0,23,合庫-台中,2024-10-29,1021
1714,和桐,22,0,22,合庫-台中,2024-10-29,1021
4527,方土霖,21,0,21,合庫-台中,2024-10-29,1021
6451,訊芯-KY,26,5,21,合庫-台中,2024-10-29,1021
8070,長華*,21,0,21,合庫-台中,2024-10-29,1021
00905,FT臺灣Smart,21,1,20,合庫-台中,2024-10-29,1021
3481,群創,319,81,238,合庫-台中,2024-10-30,1021
00715L,期街口布蘭特正2,172,4,168,合庫-台中,2024-10-30,1021
00664R,國泰臺灣加權反1,150,0,150,合庫-台中,2024-10-30,1021
00637L,元大滬深300正2,225,81,144,合庫-台中,2024-10-30,1021
00919,群益台灣精選高息,144,14,130,合庫-台中,2024-10-30,1021
1314,中石化,104,0,104,合庫-台中,2024-10-30,1021
2303,聯電,112,12,100,合庫-台中,2024-10-30,1021
3059,華晶科,90,3,87,合庫-台中,2024-10-30,1021
00708L,期元大S＆P黃金正2,71,0,71,合庫-台中,2024-10-30,1021
00878,國泰永續高股息,70,0,70,合庫-台中,2024-10-30,1021
2338,光罩,58,0,58,合庫-台中,2024-10-30,1021
0056,元大高股息,64,11,53,合庫-台中,2024-10-30,1021
00929,復華台灣科技優息,68,18,50,合庫-台中,2024-10-30,1021
4919,新唐,76,28,48,合庫-台中,2024-10-30,1021
2892,第一金,48,0,48,合庫-台中,2024-10-30,1021
2477,美隆電,83,40,43,合庫-台中,2024-10-30,1021
00650L,復華香港正2,114,72,42,合庫-台中,2024-10-30,1021
00642U,期元大S＆P石油,39,0,39,合庫-台中,2024-10-30,1021
00712,復華富時不動產,38,0,38,合庫-台中,2024-10-30,1021
00679B,元大美債20年,35,1,34,合庫-台中,2024-10-30,1021
2388,威盛,114,81,33,合庫-台中,2024-10-30,1021
2891,中信金,34,1,33,合庫-台中,2024-10-30,1021
2337,旺宏,34,3,31,合庫-台中,2024-10-30,1021
2344,華邦電,39,8,31,合庫-台中,2024-10-30,1021
6770,力積電,37,8,29,合庫-台中,2024-10-30,1021
6834,天二科技,29,0,29,合庫-台中,2024-10-30,1021
00937B,群益ESG投等債20,31,3,28,合庫-台中,2024-10-30,1021
2312,金寶,114,86,28,合庫-台中,2024-10-30,1021
5371,中光電,31,5,26,合庫-台中,2024-10-30,1021
2867,三商壽,30,4,26,合庫-台中,2024-10-30,1021
6257,矽格,26,0,26,合庫-台中,2024-10-30,1021
00915,凱基優選高股息30,25,0,25,合庫-台中,2024-10-30,1021
00927,群益半導體收益,25,0,25,合庫-台中,2024-10-30,1021
3325,旭品,75,51,24,合庫-台中,2024-10-30,1021
1449,佳和,38,14,24,合庫-台中,2024-10-30,1021
8404,百和興業-KY,25,1,24,合庫-台中,2024-10-30,1021
00753L,中信中國50正2,73,49,24,合庫-台中,2024-10-30,1021
00932,兆豐永續高息等權,23,0,23,合庫-台中,2024-10-30,1021
5438,東友,22,0,22,合庫-台中,2024-10-30,1021
00946,群益科技高息成長,22,0,22,合庫-台中,2024-10-30,1021
00952,凱基台灣AI50,20,0,20,合庫-台中,2024-10-30,1021
5521,工信,20,0,20,合庫-台中,2024-10-30,1021
2614,東森,22,2,20,合庫-台中,2024-10-30,1021
00943,兆豐電子高息等權,24,4,20,合庫-台中,2024-10-30,1021
1714,和桐,20,0,20,合庫-台中,2024-10-30,1021
00687B,國泰20年美債,24,5,19,合庫-台中,2024-10-30,1021
1605,華新,18,0,18,合庫-台中,2024-10-30,1021
3049,精金,35,17,18,合庫-台中,2024-10-30,1021
5460,同協,19,1,18,合庫-台中,2024-10-30,1021
3438,類比科,17,0,17,合庫-台中,2024-10-30,1021
00927,群益半導體收益,257,0,257,合庫-台中,2024-11-01,1021
5880,合庫金,249,2,247,合庫-台中,2024-11-01,1021
2303,聯電,195,18,177,合庫-台中,2024-11-01,1021
00887,永豐中國科技50大,234,80,154,合庫-台中,2024-11-01,1021
00929,復華台灣科技優息,196,71,125,合庫-台中,2024-11-01,1021
2801,彰銀,121,0,121,合庫-台中,2024-11-01,1021
00673R,期元大S＆P原油反1,120,1,119,合庫-台中,2024-11-01,1021
2891,中信金,121,19,102,合庫-台中,2024-11-01,1021
00878,國泰永續高股息,106,4,102,合庫-台中,2024-11-01,1021
0056,元大高股息,87,15,72,合庫-台中,2024-11-01,1021
00712,復華富時不動產,64,0,64,合庫-台中,2024-11-01,1021
2890,永豐金,67,5,62,合庫-台中,2024-11-01,1021
2880,華南金,56,0,56,合庫-台中,2024-11-01,1021
8011,台通,66,15,51,合庫-台中,2024-11-01,1021
00688L,國泰20年美債正2,54,4,50,合庫-台中,2024-11-01,1021
00937B,群益ESG投等債20,53,7,46,合庫-台中,2024-11-01,1021
00706L,期元大S＆P日圓正2,45,0,45,合庫-台中,2024-11-01,1021
2409,友達,60,16,44,合庫-台中,2024-11-01,1021
2354,鴻準,219,176,43,合庫-台中,2024-11-01,1021
00953B,群益優選非投等債,43,0,43,合庫-台中,2024-11-01,1021
00940,元大台灣價值高息,45,3,42,合庫-台中,2024-11-01,1021
00949,復華日本龍頭,41,0,41,合庫-台中,2024-11-01,1021
2885,元大金,40,0,40,合庫-台中,2024-11-01,1021
6216,居易,51,13,38,合庫-台中,2024-11-01,1021
3013,晟銘電,76,39,37,合庫-台中,2024-11-01,1021
2317,鴻海,135,100,35,合庫-台中,2024-11-01,1021
00918,大華優利高填息30,46,12,34,合庫-台中,2024-11-01,1021
2337,旺宏,37,4,33,合庫-台中,2024-11-01,1021
2646,星宇航空,77,45,32,合庫-台中,2024-11-01,1021
5234,達興材料,33,1,32,合庫-台中,2024-11-01,1021
2441,超豐,45,15,30,合庫-台中,2024-11-01,1021
2884,玉山金,50,21,29,合庫-台中,2024-11-01,1021
2887,台新金,33,6,27,合庫-台中,2024-11-01,1021
006208,富邦台50,26,0,26,合庫-台中,2024-11-01,1021
8032,光菱,35,9,26,合庫-台中,2024-11-01,1021
2330,台積電,31,6,25,合庫-台中,2024-11-01,1021
00915,凱基優選高股息30,25,0,25,合庫-台中,2024-11-01,1021
3481,群創,79,55,24,合庫-台中,2024-11-01,1021
00946,群益科技高息成長,22,0,22,合庫-台中,2024-11-01,1021
2834,臺企銀,26,4,22,合庫-台中,2024-11-01,1021
2515,中工,22,0,22,合庫-台中,2024-11-01,1021
2892,第一金,22,1,21,合庫-台中,2024-11-01,1021
2405,輔信,21,0,21,合庫-台中,2024-11-01,1021
9136,巨騰-DR,21,0,21,合庫-台中,2024-11-01,1021
8171,天宇,21,0,21,合庫-台中,2024-11-01,1021
3234,光環,21,0,21,合庫-台中,2024-11-01,1021
00713,元大台灣高息低波,21,0,21,合庫-台中,2024-11-01,1021
2883,凱基金,21,1,20,合庫-台中,2024-11-01,1021
00950B,凱基A級公司債,22,2,20,合庫-台中,2024-11-01,1021
3583,辛耘,28,8,20,合庫-台中,2024-11-01,1021
00712,復華富時不動產,248,0,248,合庫-台中,2024-11-04,1021
00937B,群益ESG投等債20,202,0,202,合庫-台中,2024-11-04,1021
00878,國泰永續高股息,195,7,188,合庫-台中,2024-11-04,1021
00686R,群益臺灣加權反1,150,0,150,合庫-台中,2024-11-04,1021
00687B,國泰20年美債,137,5,132,合庫-台中,2024-11-04,1021
00919,群益台灣精選高息,153,27,126,合庫-台中,2024-11-04,1021
2303,聯電,152,54,98,合庫-台中,2024-11-04,1021
2615,萬海,234,146,88,合庫-台中,2024-11-04,1021
00943,兆豐電子高息等權,82,0,82,合庫-台中,2024-11-04,1021
2376,技嘉,91,14,77,合庫-台中,2024-11-04,1021
00715L,期街口布蘭特正2,106,40,66,合庫-台中,2024-11-04,1021
2609,陽明,83,21,62,合庫-台中,2024-11-04,1021
2834,臺企銀,61,0,61,合庫-台中,2024-11-04,1021
00637L,元大滬深300正2,109,51,58,合庫-台中,2024-11-04,1021
1605,華新,60,4,56,合庫-台中,2024-11-04,1021
5880,合庫金,65,11,54,合庫-台中,2024-11-04,1021
3605,宏致,52,0,52,合庫-台中,2024-11-04,1021
6016,康和證,50,0,50,合庫-台中,2024-11-04,1021
1314,中石化,50,0,50,合庫-台中,2024-11-04,1021
2409,友達,63,16,47,合庫-台中,2024-11-04,1021
00915,凱基優選高股息30,48,5,43,合庫-台中,2024-11-04,1021
00932,兆豐永續高息等權,43,0,43,合庫-台中,2024-11-04,1021
3481,群創,42,0,42,合庫-台中,2024-11-04,1021
00650L,復華香港正2,77,40,37,合庫-台中,2024-11-04,1021
00887,永豐中國科技50大,37,0,37,合庫-台中,2024-11-04,1021
00751B,元大AAA至A公司債,32,0,32,合庫-台中,2024-11-04,1021
3324,雙鴻,49,17,32,合庫-台中,2024-11-04,1021
2337,旺宏,32,5,27,合庫-台中,2024-11-04,1021
9136,巨騰-DR,40,14,26,合庫-台中,2024-11-04,1021
00636,國泰中國A50,30,4,26,合庫-台中,2024-11-04,1021
00929,復華台灣科技優息,143,118,25,合庫-台中,2024-11-04,1021
00795B,中信美國公債20年,25,0,25,合庫-台中,2024-11-04,1021
2486,一詮,24,0,24,合庫-台中,2024-11-04,1021
4406,新昕纖,23,0,23,合庫-台中,2024-11-04,1021
2338,光罩,21,0,21,合庫-台中,2024-11-04,1021
00930,永豐ESG低碳高息,21,0,21,合庫-台中,2024-11-04,1021
00946,群益科技高息成長,20,0,20,合庫-台中,2024-11-04,1021
1810,和成,20,0,20,合庫-台中,2024-11-04,1021
2501,國建,24,4,20,合庫-台中,2024-11-04,1021
3234,光環,37,19,18,合庫-台中,2024-11-04,1021
3062,建漢,31,13,18,合庫-台中,2024-11-04,1021
5347,世界,26,9,17,合庫-台中,2024-11-04,1021
2328,廣宇,47,30,17,合庫-台中,2024-11-04,1021
00713,元大台灣高息低波,17,0,17,合庫-台中,2024-11-04,1021
3034,聯詠,18,1,17,合庫-台中,2024-11-04,1021
00953B,群益優選非投等債,18,1,17,合庫-台中,2024-11-04,1021
0056,元大高股息,26,9,17,合庫-台中,2024-11-04,1021
00948B,中信優息投資級債,19,3,16,合庫-台中,2024-11-04,1021
3059,華晶科,16,0,16,合庫-台中,2024-11-04,1021
4569,六方科-KY,15,0,15,合庫-台中,2024-11-04,1021
2317,鴻海,549,81,468,合庫-台中,2024-11-05,1021
00918,大華優利高填息30,272,8,264,合庫-台中,2024-11-05,1021
00919,群益台灣精選高息,189,10,179,合庫-台中,2024-11-05,1021
00637L,元大滬深300正2,332,161,171,合庫-台中,2024-11-05,1021
00665L,富邦�琤肭磪囓�2,260,103,157,合庫-台中,2024-11-05,1021
2303,聯電,175,34,141,合庫-台中,2024-11-05,1021
2344,華邦電,138,0,138,合庫-台中,2024-11-05,1021
00673R,期元大S＆P原油反1,130,0,130,合庫-台中,2024-11-05,1021
2882,國泰金,114,16,98,合庫-台中,2024-11-05,1021
1605,華新,95,1,94,合庫-台中,2024-11-05,1021
00930,永豐ESG低碳高息,76,0,76,合庫-台中,2024-11-05,1021
2354,鴻準,285,241,44,合庫-台中,2024-11-05,1021
5315,光聯,56,12,44,合庫-台中,2024-11-05,1021
8070,長華*,36,0,36,合庫-台中,2024-11-05,1021
2834,臺企銀,40,4,36,合庫-台中,2024-11-05,1021
3551,世禾,36,1,35,合庫-台中,2024-11-05,1021
3059,華晶科,35,0,35,合庫-台中,2024-11-05,1021
6213,聯茂,35,1,34,合庫-台中,2024-11-05,1021
3711,日月光投控,33,0,33,合庫-台中,2024-11-05,1021
3013,晟銘電,63,35,28,合庫-台中,2024-11-05,1021
00946,群益科技高息成長,28,0,28,合庫-台中,2024-11-05,1021
2363,矽統,33,8,25,合庫-台中,2024-11-05,1021
00712,復華富時不動產,35,10,25,合庫-台中,2024-11-05,1021
2328,廣宇,51,26,25,合庫-台中,2024-11-05,1021
00959B,大華投等美債15Y+,25,0,25,合庫-台中,2024-11-05,1021
5258,虹堡,25,0,25,合庫-台中,2024-11-05,1021
9921,巨大,24,0,24,合庫-台中,2024-11-05,1021
00933B,國泰10Y+金融債,26,3,23,合庫-台中,2024-11-05,1021
1584,精剛,23,1,22,合庫-台中,2024-11-05,1021
00878,國泰永續高股息,82,61,21,合庫-台中,2024-11-05,1021
00953B,群益優選非投等債,21,0,21,合庫-台中,2024-11-05,1021
6234,高僑,20,0,20,合庫-台中,2024-11-05,1021
6168,宏齊,20,0,20,合庫-台中,2024-11-05,1021
3490,單井,37,17,20,合庫-台中,2024-11-05,1021
2441,超豐,36,18,18,合庫-台中,2024-11-05,1021
5488,松普,16,0,16,合庫-台中,2024-11-05,1021
2520,冠德,16,0,16,合庫-台中,2024-11-05,1021
00932,兆豐永續高息等權,16,0,16,合庫-台中,2024-11-05,1021
3149,正達,35,19,16,合庫-台中,2024-11-05,1021
2031,新光鋼,15,0,15,合庫-台中,2024-11-05,1021
8011,台通,15,2,13,合庫-台中,2024-11-05,1021
1301,台塑,13,1,12,合庫-台中,2024-11-05,1021
2351,順德,12,0,12,合庫-台中,2024-11-05,1021
00937B,群益ESG投等債20,19,8,11,合庫-台中,2024-11-05,1021
00945B,凱基美國非投等債,11,0,11,合庫-台中,2024-11-05,1021
00632R,元大台灣50反1,11,0,11,合庫-台中,2024-11-05,1021
3034,聯詠,12,1,11,合庫-台中,2024-11-05,1021
1326,台化,11,0,11,合庫-台中,2024-11-05,1021
6505,台塑化,10,0,10,合庫-台中,2024-11-05,1021
3058,立德,10,0,10,合庫-台中,2024-11-05,1021
00665L,富邦�琤肭磪囓�2,996,105,891,合庫-台中,2024-11-06,1021
2834,臺企銀,505,10,495,合庫-台中,2024-11-06,1021
00680L,元大美債20正2,296,0,296,合庫-台中,2024-11-06,1021
00687B,國泰20年美債,300,10,290,合庫-台中,2024-11-06,1021
00688L,國泰20年美債正2,262,20,242,合庫-台中,2024-11-06,1021
00679B,元大美債20年,359,160,199,合庫-台中,2024-11-06,1021
00887,永豐中國科技50大,224,54,170,合庫-台中,2024-11-06,1021
00650L,復華香港正2,213,56,157,合庫-台中,2024-11-06,1021
8249,菱光,194,69,125,合庫-台中,2024-11-06,1021
2609,陽明,97,17,80,合庫-台中,2024-11-06,1021
1314,中石化,71,1,70,合庫-台中,2024-11-06,1021
6125,廣運,70,0,70,合庫-台中,2024-11-06,1021
5438,東友,69,7,62,合庫-台中,2024-11-06,1021
00753L,中信中國50正2,56,0,56,合庫-台中,2024-11-06,1021
00948B,中信優息投資級債,61,5,56,合庫-台中,2024-11-06,1021
00636,國泰中國A50,65,10,55,合庫-台中,2024-11-06,1021
2431,聯昌,111,56,55,合庫-台中,2024-11-06,1021
2103,台橡,55,2,53,合庫-台中,2024-11-06,1021
00878,國泰永續高股息,105,52,53,合庫-台中,2024-11-06,1021
5347,世界,57,5,52,合庫-台中,2024-11-06,1021
00937B,群益ESG投等債20,60,14,46,合庫-台中,2024-11-06,1021
6257,矽格,43,0,43,合庫-台中,2024-11-06,1021
4526,東台,79,38,41,合庫-台中,2024-11-06,1021
00958B,永豐ESG銀行債15,40,0,40,合庫-台中,2024-11-06,1021
6220,岳豐,38,0,38,合庫-台中,2024-11-06,1021
00930,永豐ESG低碳高息,33,0,33,合庫-台中,2024-11-06,1021
00891,中信關鍵半導體,39,6,33,合庫-台中,2024-11-06,1021
2349,錸德,51,20,31,合庫-台中,2024-11-06,1021
2031,新光鋼,30,0,30,合庫-台中,2024-11-06,1021
3711,日月光投控,38,9,29,合庫-台中,2024-11-06,1021
6838,台新藥,29,0,29,合庫-台中,2024-11-06,1021
8064,東捷,48,19,29,合庫-台中,2024-11-06,1021
5258,虹堡,29,1,28,合庫-台中,2024-11-06,1021
2867,三商壽,28,0,28,合庫-台中,2024-11-06,1021
00919,群益台灣精選高息,55,27,28,合庫-台中,2024-11-06,1021
2354,鴻準,138,111,27,合庫-台中,2024-11-06,1021
00932,兆豐永續高息等權,28,2,26,合庫-台中,2024-11-06,1021
6768,志強-KY,26,0,26,合庫-台中,2024-11-06,1021
2887,台新金,26,0,26,合庫-台中,2024-11-06,1021
4510,高鋒,36,11,25,合庫-台中,2024-11-06,1021
00795B,中信美國公債20年,24,0,24,合庫-台中,2024-11-06,1021
2337,旺宏,29,5,24,合庫-台中,2024-11-06,1021
3013,晟銘電,78,56,22,合庫-台中,2024-11-06,1021
2882,國泰金,22,2,20,合庫-台中,2024-11-06,1021
1808,潤隆,20,0,20,合庫-台中,2024-11-06,1021
00715L,期街口布蘭特正2,36,16,20,合庫-台中,2024-11-06,1021
00633L,富邦上証正2,26,6,20,合庫-台中,2024-11-06,1021
9907,統一實,20,0,20,合庫-台中,2024-11-06,1021
1714,和桐,20,0,20,合庫-台中,2024-11-06,1021
2338,光罩,19,0,19,合庫-台中,2024-11-06,1021
00688L,國泰20年美債正2,297,0,297,合庫-台中,2024-11-07,1021
9105,泰金寶-DR,675,414,261,合庫-台中,2024-11-07,1021
2609,陽明,178,42,136,合庫-台中,2024-11-07,1021
00673R,期元大S＆P原油反1,116,0,116,合庫-台中,2024-11-07,1021
6239,力成,95,0,95,合庫-台中,2024-11-07,1021
2356,英業達,140,49,91,合庫-台中,2024-11-07,1021
2883B,凱基金乙特,84,0,84,合庫-台中,2024-11-07,1021
2314,台揚,85,7,78,合庫-台中,2024-11-07,1021
2303,聯電,130,73,57,合庫-台中,2024-11-07,1021
3576,聯合再生,50,0,50,合庫-台中,2024-11-07,1021
3013,晟銘電,136,89,47,合庫-台中,2024-11-07,1021
2486,一詮,45,3,42,合庫-台中,2024-11-07,1021
2323,中環,41,0,41,合庫-台中,2024-11-07,1021
00919,群益台灣精選高息,57,17,40,合庫-台中,2024-11-07,1021
00706L,期元大S＆P日圓正2,40,0,40,合庫-台中,2024-11-07,1021
6285,啟��,41,1,40,合庫-台中,2024-11-07,1021
2014,中鴻,53,14,39,合庫-台中,2024-11-07,1021
00953B,群益優選非投等債,35,0,35,合庫-台中,2024-11-07,1021
4991,環宇-KY,49,14,35,合庫-台中,2024-11-07,1021
6125,廣運,33,0,33,合庫-台中,2024-11-07,1021
00712,復華富時不動產,36,4,32,合庫-台中,2024-11-07,1021
2892,第一金,31,0,31,合庫-台中,2024-11-07,1021
2312,金寶,166,137,29,合庫-台中,2024-11-07,1021
6282,康舒,27,0,27,合庫-台中,2024-11-07,1021
00632R,元大台灣50反1,27,0,27,合庫-台中,2024-11-07,1021
00687B,國泰20年美債,96,74,22,合庫-台中,2024-11-07,1021
00635U,期元大S＆P黃金,25,4,21,合庫-台中,2024-11-07,1021
2615,萬海,101,81,20,合庫-台中,2024-11-07,1021
2497,怡利電,32,12,20,合庫-台中,2024-11-07,1021
5258,虹堡,21,1,20,合庫-台中,2024-11-07,1021
1446,宏和,21,1,20,合庫-台中,2024-11-07,1021
1466,聚隆,20,0,20,合庫-台中,2024-11-07,1021
6234,高僑,20,0,20,合庫-台中,2024-11-07,1021
6643,M31,19,0,19,合庫-台中,2024-11-07,1021
00948B,中信優息投資級債,22,3,19,合庫-台中,2024-11-07,1021
2027,大成鋼,21,3,18,合庫-台中,2024-11-07,1021
1612,宏泰,20,2,18,合庫-台中,2024-11-07,1021
1301,台塑,22,5,17,合庫-台中,2024-11-07,1021
5880,合庫金,23,7,16,合庫-台中,2024-11-07,1021
3293,鈊象,15,1,14,合庫-台中,2024-11-07,1021
00960,野村全球航運龍頭,14,0,14,合庫-台中,2024-11-07,1021
2031,新光鋼,13,0,13,合庫-台中,2024-11-07,1021
4563,百德,13,0,13,合庫-台中,2024-11-07,1021
00930,永豐ESG低碳高息,13,0,13,合庫-台中,2024-11-07,1021
2633,台灣高鐵,12,0,12,合庫-台中,2024-11-07,1021
9955,佳龍,12,0,12,合庫-台中,2024-11-07,1021
3710,連展投控,11,0,11,合庫-台中,2024-11-07,1021
8112,至上,11,0,11,合庫-台中,2024-11-07,1021
9921,巨大,10,0,10,合庫-台中,2024-11-07,1021
2444,兆勁,10,0,10,合庫-台中,2024-11-07,1021
00706L,期元大S＆P日圓正2,1128,0,1128,合庫-台中,2024-11-08,1021
2834,臺企銀,291,1,290,合庫-台中,2024-11-08,1021
1586,和勤,140,0,140,合庫-台中,2024-11-08,1021
00632R,元大台灣50反1,184,50,134,合庫-台中,2024-11-08,1021
1314,中石化,132,6,126,合庫-台中,2024-11-08,1021
00932,兆豐永續高息等權,113,1,112,合庫-台中,2024-11-08,1021
2388,威盛,139,28,111,合庫-台中,2024-11-08,1021
2884,玉山金,111,2,109,合庫-台中,2024-11-08,1021
3062,建漢,192,89,103,合庫-台中,2024-11-08,1021
2313,華通,110,15,95,合庫-台中,2024-11-08,1021
4526,東台,94,0,94,合庫-台中,2024-11-08,1021
1605,華新,78,0,78,合庫-台中,2024-11-08,1021
6282,康舒,98,30,68,合庫-台中,2024-11-08,1021
00679B,元大美債20年,102,36,66,合庫-台中,2024-11-08,1021
00948B,中信優息投資級債,57,3,54,合庫-台中,2024-11-08,1021
2812,台中銀,51,0,51,合庫-台中,2024-11-08,1021
6609,瀧澤科,52,1,51,合庫-台中,2024-11-08,1021
1718,中纖,50,0,50,合庫-台中,2024-11-08,1021
3419,譁裕,50,0,50,合庫-台中,2024-11-08,1021
6005,群益證,50,0,50,合庫-台中,2024-11-08,1021
3059,華晶科,50,0,50,合庫-台中,2024-11-08,1021
00919,群益台灣精選高息,134,87,47,合庫-台中,2024-11-08,1021
00882,中信中國高股息,146,100,46,合庫-台中,2024-11-08,1021
00636,國泰中國A50,118,74,44,合庫-台中,2024-11-08,1021
6505,台塑化,41,1,40,合庫-台中,2024-11-08,1021
8070,長華*,38,0,38,合庫-台中,2024-11-08,1021
00930,永豐ESG低碳高息,38,0,38,合庫-台中,2024-11-08,1021
2303,聯電,65,29,36,合庫-台中,2024-11-08,1021
00713,元大台灣高息低波,37,0,37,合庫-台中,2024-11-08,1021
2408,南亞科,36,1,35,合庫-台中,2024-11-08,1021
00929,復華台灣科技優息,432,397,35,合庫-台中,2024-11-08,1021
1531,高林股,32,0,32,合庫-台中,2024-11-08,1021
4510,高鋒,39,8,31,合庫-台中,2024-11-08,1021
5880,合庫金,36,5,31,合庫-台中,2024-11-08,1021
2731,雄獅,30,0,30,合庫-台中,2024-11-08,1021
00642U,期元大S＆P石油,30,0,30,合庫-台中,2024-11-08,1021
4909,新復興,41,12,29,合庫-台中,2024-11-08,1021
2349,錸德,37,8,29,合庫-台中,2024-11-08,1021
3450,聯鈞,100,73,27,合庫-台中,2024-11-08,1021
2929,淘帝-KY,27,1,26,合庫-台中,2024-11-08,1021
2312,金寶,106,80,26,合庫-台中,2024-11-08,1021
3498,陽程,33,9,24,合庫-台中,2024-11-08,1021
2883B,凱基金乙特,24,0,24,合庫-台中,2024-11-08,1021
00943,兆豐電子高息等權,41,17,24,合庫-台中,2024-11-08,1021
1326,台化,38,14,24,合庫-台中,2024-11-08,1021
3013,晟銘電,54,31,23,合庫-台中,2024-11-08,1021
00933B,國泰10Y+金融債,26,4,22,合庫-台中,2024-11-08,1021
00878,國泰永續高股息,105,83,22,合庫-台中,2024-11-08,1021
3005,神基,21,0,21,合庫-台中,2024-11-08,1021
00952,凱基台灣AI50,21,0,21,合庫-台中,2024-11-08,1021
00632R,元大台灣50反1,1000,0,1000,合庫-台中,2024-11-11,1021
3231,緯創,571,48,523,合庫-台中,2024-11-11,1021
00878,國泰永續高股息,206,7,199,合庫-台中,2024-11-11,1021
00715L,期街口布蘭特正2,220,50,170,合庫-台中,2024-11-11,1021
3481,群創,148,5,143,合庫-台中,2024-11-11,1021
00753L,中信中國50正2,213,85,128,合庫-台中,2024-11-11,1021
00665L,富邦�琤肭磪囓�2,126,2,124,合庫-台中,2024-11-11,1021
00637L,元大滬深300正2,148,31,117,合庫-台中,2024-11-11,1021
1605,華新,109,0,109,合庫-台中,2024-11-11,1021
00650L,復華香港正2,103,20,83,合庫-台中,2024-11-11,1021
00882,中信中國高股息,97,26,71,合庫-台中,2024-11-11,1021
00932,兆豐永續高息等權,74,10,64,合庫-台中,2024-11-11,1021
00930,永豐ESG低碳高息,61,0,61,合庫-台中,2024-11-11,1021
2356,英業達,143,89,54,合庫-台中,2024-11-11,1021
1584,精剛,57,4,53,合庫-台中,2024-11-11,1021
2337,旺宏,58,7,51,合庫-台中,2024-11-11,1021
00943,兆豐電子高息等權,86,40,46,合庫-台中,2024-11-11,1021
00909,國泰數位支付服務,44,0,44,合庫-台中,2024-11-11,1021
3324,雙鴻,50,7,43,合庫-台中,2024-11-11,1021
3234,光環,76,33,43,合庫-台中,2024-11-11,1021
006208,富邦台50,49,7,42,合庫-台中,2024-11-11,1021
00900,富邦特選高股息30,40,0,40,合庫-台中,2024-11-11,1021
1326,台化,41,3,38,合庫-台中,2024-11-11,1021
1314,中石化,50,12,38,合庫-台中,2024-11-11,1021
6269,台郡,44,7,37,合庫-台中,2024-11-11,1021
00636,國泰中國A50,46,10,36,合庫-台中,2024-11-11,1021
00919,群益台灣精選高息,71,35,36,合庫-台中,2024-11-11,1021
3085,新零售,34,0,34,合庫-台中,2024-11-11,1021
2486,一詮,100,68,32,合庫-台中,2024-11-11,1021
9921,巨大,30,0,30,合庫-台中,2024-11-11,1021
2354,鴻準,173,145,28,合庫-台中,2024-11-11,1021
3047,訊舟,44,16,28,合庫-台中,2024-11-11,1021
2834,臺企銀,170,144,26,合庫-台中,2024-11-11,1021
2892,第一金,24,0,24,合庫-台中,2024-11-11,1021
2303,聯電,57,33,24,合庫-台中,2024-11-11,1021
1449,佳和,59,35,24,合庫-台中,2024-11-11,1021
2462,良得電,24,0,24,合庫-台中,2024-11-11,1021
4979,華星光,64,42,22,合庫-台中,2024-11-11,1021
3062,建漢,53,32,21,合庫-台中,2024-11-11,1021
2882,國泰金,21,0,21,合庫-台中,2024-11-11,1021
00713,元大台灣高息低波,21,0,21,合庫-台中,2024-11-11,1021
6285,啟��,23,2,21,合庫-台中,2024-11-11,1021
4510,高鋒,23,3,20,合庫-台中,2024-11-11,1021
1536,和大,24,4,20,合庫-台中,2024-11-11,1021
00642U,期元大S＆P石油,20,0,20,合庫-台中,2024-11-11,1021
2845,遠東銀,40,20,20,合庫-台中,2024-11-11,1021
1416,廣豐,20,0,20,合庫-台中,2024-11-11,1021
6901,鑽石投資,20,0,20,合庫-台中,2024-11-11,1021
2646,星宇航空,27,8,19,合庫-台中,2024-11-11,1021
00891,中信關鍵半導體,19,0,19,合庫-台中,2024-11-11,1021
00878,國泰永續高股息,483,11,472,合庫-台中,2024-11-12,1021
00715L,期街口布蘭特正2,399,0,399,合庫-台中,2024-11-12,1021
1314,中石化,403,6,397,合庫-台中,2024-11-12,1021
2892,第一金,170,0,170,合庫-台中,2024-11-12,1021
00642U,期元大S＆P石油,166,0,166,合庫-台中,2024-11-12,1021
00927,群益半導體收益,160,0,160,合庫-台中,2024-11-12,1021
00919,群益台灣精選高息,132,10,122,合庫-台中,2024-11-12,1021
3481,群創,116,2,114,合庫-台中,2024-11-12,1021
2845,遠東銀,100,0,100,合庫-台中,2024-11-12,1021
6005,群益證,100,0,100,合庫-台中,2024-11-12,1021
9105,泰金寶-DR,124,27,97,合庫-台中,2024-11-12,1021
00891,中信關鍵半導體,97,0,97,合庫-台中,2024-11-12,1021
0056,元大高股息,93,4,89,合庫-台中,2024-11-12,1021
00929,復華台灣科技優息,152,67,85,合庫-台中,2024-11-12,1021
5871,中租-KY,79,3,76,合庫-台中,2024-11-12,1021
2356,英業達,99,27,72,合庫-台中,2024-11-12,1021
00915,凱基優選高股息30,70,1,69,合庫-台中,2024-11-12,1021
1605,華新,70,2,68,合庫-台中,2024-11-12,1021
2882,國泰金,68,1,67,合庫-台中,2024-11-12,1021
2408,南亞科,69,3,66,合庫-台中,2024-11-12,1021
2834,臺企銀,66,4,62,合庫-台中,2024-11-12,1021
2615,萬海,184,123,61,合庫-台中,2024-11-12,1021
00650L,復華香港正2,153,97,56,合庫-台中,2024-11-12,1021
2888,新光金,64,8,56,合庫-台中,2024-11-12,1021
2317,鴻海,105,50,55,合庫-台中,2024-11-12,1021
2367,燿華,55,0,55,合庫-台中,2024-11-12,1021
5443,均豪,65,12,53,合庫-台中,2024-11-12,1021
2002,中鋼,53,0,53,合庫-台中,2024-11-12,1021
2441,超豐,52,0,52,合庫-台中,2024-11-12,1021
4303,信立,58,7,51,合庫-台中,2024-11-12,1021
2312,金寶,80,29,51,合庫-台中,2024-11-12,1021
00665L,富邦�琤肭磪囓�2,254,203,51,合庫-台中,2024-11-12,1021
2801,彰銀,51,0,51,合庫-台中,2024-11-12,1021
2897,王道銀行,50,0,50,合庫-台中,2024-11-12,1021
2392,正崴,65,17,48,合庫-台中,2024-11-12,1021
1586,和勤,48,0,48,合庫-台中,2024-11-12,1021
2344,華邦電,51,4,47,合庫-台中,2024-11-12,1021
00932,兆豐永續高息等權,46,0,46,合庫-台中,2024-11-12,1021
2332,友訊,46,0,46,合庫-台中,2024-11-12,1021
5880,合庫金,99,54,45,合庫-台中,2024-11-12,1021
2542,興富發,47,4,43,合庫-台中,2024-11-12,1021
2330,台積電,48,4,44,合庫-台中,2024-11-12,1021
2883,凱基金,58,16,42,合庫-台中,2024-11-12,1021
00881,國泰台灣5G+,43,1,42,合庫-台中,2024-11-12,1021
3231,緯創,63,22,41,合庫-台中,2024-11-12,1021
2884,玉山金,46,6,40,合庫-台中,2024-11-12,1021
3059,華晶科,38,0,38,合庫-台中,2024-11-12,1021
00922,國泰台灣領袖50,35,0,35,合庫-台中,2024-11-12,1021
00712,復華富時不動產,34,1,33,合庫-台中,2024-11-12,1021
00882,中信中國高股息,55,23,32,合庫-台中,2024-11-12,1021
9105,泰金寶-DR,1047,112,935,合庫-台中,2024-11-13,1021
00632R,元大台灣50反1,935,60,875,合庫-台中,2024-11-13,1021
00680L,元大美債20正2,737,15,722,合庫-台中,2024-11-13,1021
00637L,元大滬深300正2,445,186,259,合庫-台中,2024-11-13,1021
00878,國泰永續高股息,196,0,196,合庫-台中,2024-11-13,1021
2834,臺企銀,164,21,143,合庫-台中,2024-11-13,1021
2888,新光金,135,0,135,合庫-台中,2024-11-13,1021
2356,英業達,218,88,130,合庫-台中,2024-11-13,1021
1301,台塑,107,0,107,合庫-台中,2024-11-13,1021
2105,正新,102,2,100,合庫-台中,2024-11-13,1021
00664R,國泰臺灣加權反1,100,0,100,合庫-台中,2024-11-13,1021
3481,群創,122,44,78,合庫-台中,2024-11-13,1021
3013,晟銘電,155,82,73,合庫-台中,2024-11-13,1021
5880,合庫金,91,20,71,合庫-台中,2024-11-13,1021
2891,中信金,94,25,69,合庫-台中,2024-11-13,1021
00715L,期街口布蘭特正2,80,15,65,合庫-台中,2024-11-13,1021
00943,兆豐電子高息等權,85,20,65,合庫-台中,2024-11-13,1021
2801,彰銀,60,0,60,合庫-台中,2024-11-13,1021
2515,中工,59,0,59,合庫-台中,2024-11-13,1021
2880,華南金,59,3,56,合庫-台中,2024-11-13,1021
2486,一詮,75,23,52,合庫-台中,2024-11-13,1021
2317,鴻海,67,15,52,合庫-台中,2024-11-13,1021
2884,玉山金,52,0,52,合庫-台中,2024-11-13,1021
2882,國泰金,49,0,49,合庫-台中,2024-11-13,1021
00919,群益台灣精選高息,61,18,43,合庫-台中,2024-11-13,1021
00642U,期元大S＆P石油,35,0,35,合庫-台中,2024-11-13,1021
00753L,中信中國50正2,63,28,35,合庫-台中,2024-11-13,1021
0056,元大高股息,37,5,32,合庫-台中,2024-11-13,1021
6282,康舒,66,34,32,合庫-台中,2024-11-13,1021
2323,中環,34,2,32,合庫-台中,2024-11-13,1021
6279,胡連,30,0,30,合庫-台中,2024-11-13,1021
4979,華星光,63,34,29,合庫-台中,2024-11-13,1021
00891,中信關鍵半導體,29,0,29,合庫-台中,2024-11-13,1021
4931,新盛力,78,49,29,合庫-台中,2024-11-13,1021
00930,永豐ESG低碳高息,27,0,27,合庫-台中,2024-11-13,1021
3702A,大聯大甲特,27,0,27,合庫-台中,2024-11-13,1021
2489,瑞軒,26,0,26,合庫-台中,2024-11-13,1021
2353,宏��,38,12,26,合庫-台中,2024-11-13,1021
2609,陽明,245,221,24,合庫-台中,2024-11-13,1021
00915,凱基優選高股息30,24,0,24,合庫-台中,2024-11-13,1021
3450,聯鈞,58,35,23,合庫-台中,2024-11-13,1021
3035,智原,23,0,23,合庫-台中,2024-11-13,1021
3037,欣興,43,20,23,合庫-台中,2024-11-13,1021
4938,和碩,23,0,23,合庫-台中,2024-11-13,1021
6269,台郡,23,0,23,合庫-台中,2024-11-13,1021
8064,東捷,38,15,23,合庫-台中,2024-11-13,1021
5871,中租-KY,36,13,23,合庫-台中,2024-11-13,1021
2330,台積電,35,15,20,合庫-台中,2024-11-13,1021
3537,堡達,20,0,20,合庫-台中,2024-11-13,1021
2338,光罩,20,0,20,合庫-台中,2024-11-13,1021
00878,國泰永續高股息,585,5,580,合庫-台中,2024-11-14,1021
00937B,群益ESG投等債20,352,80,272,合庫-台中,2024-11-14,1021
00929,復華台灣科技優息,225,28,197,合庫-台中,2024-11-14,1021
0056,元大高股息,196,22,174,合庫-台中,2024-11-14,1021
1314,中石化,175,1,174,合庫-台中,2024-11-14,1021
2303,聯電,167,10,157,合庫-台中,2024-11-14,1021
9105,泰金寶-DR,347,197,150,合庫-台中,2024-11-14,1021
00687B,國泰20年美債,131,5,126,合庫-台中,2024-11-14,1021
2884,玉山金,120,0,120,合庫-台中,2024-11-14,1021
00943,兆豐電子高息等權,128,25,103,合庫-台中,2024-11-14,1021
00679B,元大美債20年,100,3,97,合庫-台中,2024-11-14,1021
00919,群益台灣精選高息,103,8,95,合庫-台中,2024-11-14,1021
3481,群創,139,53,86,合庫-台中,2024-11-14,1021
1815,富喬,96,17,79,合庫-台中,2024-11-14,1021
6125,廣運,88,10,78,合庫-台中,2024-11-14,1021
2634,漢翔,112,35,77,合庫-台中,2024-11-14,1021
2845,遠東銀,74,10,64,合庫-台中,2024-11-14,1021
5880,合庫金,162,105,57,合庫-台中,2024-11-14,1021
6005,群益證,55,0,55,合庫-台中,2024-11-14,1021
00915,凱基優選高股息30,50,0,50,合庫-台中,2024-11-14,1021
1524,耿鼎,62,13,49,合庫-台中,2024-11-14,1021
00932,兆豐永續高息等權,48,0,48,合庫-台中,2024-11-14,1021
2885,元大金,52,4,48,合庫-台中,2024-11-14,1021
2880,華南金,50,3,47,合庫-台中,2024-11-14,1021
2354,鴻準,80,36,44,合庫-台中,2024-11-14,1021
1515,力山,41,0,41,合庫-台中,2024-11-14,1021
5871,中租-KY,40,1,39,合庫-台中,2024-11-14,1021
3059,華晶科,38,0,38,合庫-台中,2024-11-14,1021
2312,金寶,43,6,37,合庫-台中,2024-11-14,1021
00930,永豐ESG低碳高息,37,0,37,合庫-台中,2024-11-14,1021
00887,永豐中國科技50大,47,12,35,合庫-台中,2024-11-14,1021
4763,材料-KY,42,8,34,合庫-台中,2024-11-14,1021
00715L,期街口布蘭特正2,38,5,33,合庫-台中,2024-11-14,1021
3015,全漢,69,37,32,合庫-台中,2024-11-14,1021
1301,台塑,39,8,31,合庫-台中,2024-11-14,1021
1586,和勤,31,0,31,合庫-台中,2024-11-14,1021
00635U,期元大S＆P黃金,31,0,31,合庫-台中,2024-11-14,1021
00927,群益半導體收益,31,0,31,合庫-台中,2024-11-14,1021
3062,建漢,50,20,30,合庫-台中,2024-11-14,1021
2543,皇昌,45,16,29,合庫-台中,2024-11-14,1021
3085,新零售,30,2,28,合庫-台中,2024-11-14,1021
2405,輔信,34,6,28,合庫-台中,2024-11-14,1021
2356,英業達,44,16,28,合庫-台中,2024-11-14,1021
2344,華邦電,36,9,27,合庫-台中,2024-11-14,1021
2337,旺宏,38,11,27,合庫-台中,2024-11-14,1021
2409,友達,53,26,27,合庫-台中,2024-11-14,1021
1303,南亞,26,0,26,合庫-台中,2024-11-14,1021
00795B,中信美國公債20年,25,0,25,合庫-台中,2024-11-14,1021
2883,凱基金,29,5,24,合庫-台中,2024-11-14,1021
2892,第一金,23,0,23,合庫-台中,2024-11-14,1021
00878,國泰永續高股息,615,4,611,合庫-台中,2024-11-15,1021
00929,復華台灣科技優息,210,18,192,合庫-台中,2024-11-15,1021
2409,友達,185,21,164,合庫-台中,2024-11-15,1021
2382,廣達,177,32,145,合庫-台中,2024-11-15,1021
2317,鴻海,185,66,119,合庫-台中,2024-11-15,1021
00637L,元大滬深300正2,158,56,102,合庫-台中,2024-11-15,1021
3085,新零售,91,0,91,合庫-台中,2024-11-15,1021
2002,中鋼,81,0,81,合庫-台中,2024-11-15,1021
00632R,元大台灣50反1,75,0,75,合庫-台中,2024-11-15,1021
4956,光鋐,80,11,69,合庫-台中,2024-11-15,1021
00753L,中信中國50正2,86,20,66,合庫-台中,2024-11-15,1021
3202,樺晟,66,1,65,合庫-台中,2024-11-15,1021
3013,晟銘電,240,175,65,合庫-台中,2024-11-15,1021
00930,永豐ESG低碳高息,51,0,51,合庫-台中,2024-11-15,1021
2634,漢翔,45,1,44,合庫-台中,2024-11-15,1021
9904,寶成,48,6,42,合庫-台中,2024-11-15,1021
00943,兆豐電子高息等權,37,0,37,合庫-台中,2024-11-15,1021
3017,奇鋐,59,22,37,合庫-台中,2024-11-15,1021
2489,瑞軒,31,0,31,合庫-台中,2024-11-15,1021
00738U,期元大道瓊白銀,30,0,30,合庫-台中,2024-11-15,1021
6405,悅城,100,70,30,合庫-台中,2024-11-15,1021
00932,兆豐永續高息等權,29,0,29,合庫-台中,2024-11-15,1021
6125,廣運,28,0,28,合庫-台中,2024-11-15,1021
2353,宏��,27,2,25,合庫-台中,2024-11-15,1021
00713,元大台灣高息低波,26,1,25,合庫-台中,2024-11-15,1021
3338,泰碩,38,15,23,合庫-台中,2024-11-15,1021
4541,晟田,30,10,20,合庫-台中,2024-11-15,1021
5398,慕康生醫,22,2,20,合庫-台中,2024-11-15,1021
00655L,國泰中國A50正2,219,200,19,合庫-台中,2024-11-15,1021
6156,松上,17,0,17,合庫-台中,2024-11-15,1021
7708,全家餐飲,18,2,16,合庫-台中,2024-11-15,1021
8240,華宏,22,6,16,合庫-台中,2024-11-15,1021
3047,訊舟,30,14,16,合庫-台中,2024-11-15,1021
4729,熒茂,33,17,16,合庫-台中,2024-11-15,1021
3324,雙鴻,32,17,15,合庫-台中,2024-11-15,1021
2330,台積電,18,3,15,合庫-台中,2024-11-15,1021
9136,巨騰-DR,15,0,15,合庫-台中,2024-11-15,1021
2337,旺宏,18,3,15,合庫-台中,2024-11-15,1021
2356,英業達,19,5,14,合庫-台中,2024-11-15,1021
3293,鈊象,19,5,14,合庫-台中,2024-11-15,1021
2204,中華,26,12,14,合庫-台中,2024-11-15,1021
9921,巨大,15,2,13,合庫-台中,2024-11-15,1021
1503,士電,17,5,12,合庫-台中,2024-11-15,1021
2344,華邦電,41,29,12,合庫-台中,2024-11-15,1021
2812,台中銀,12,0,12,合庫-台中,2024-11-15,1021
00941,中信上游半導體,12,0,12,合庫-台中,2024-11-15,1021
4979,華星光,123,111,12,合庫-台中,2024-11-15,1021
6202,盛群,11,0,11,合庫-台中,2024-11-15,1021
3290,東浦,11,0,11,合庫-台中,2024-11-15,1021
6706,惠特,18,7,11,合庫-台中,2024-11-15,1021
00664R,國泰臺灣加權反1,500,0,500,合庫-台中,2024-11-18,1021
00878,國泰永續高股息,346,11,335,合庫-台中,2024-11-18,1021
2834,臺企銀,314,12,302,合庫-台中,2024-11-18,1021
00632R,元大台灣50反1,250,0,250,合庫-台中,2024-11-18,1021
2317,鴻海,125,53,72,合庫-台中,2024-11-18,1021
3085,新零售,64,0,64,合庫-台中,2024-11-18,1021
3005,神基,67,6,61,合庫-台中,2024-11-18,1021
9105,泰金寶-DR,294,233,61,合庫-台中,2024-11-18,1021
00943,兆豐電子高息等權,56,0,56,合庫-台中,2024-11-18,1021
0056,元大高股息,60,10,50,合庫-台中,2024-11-18,1021
00881,國泰台灣5G+,52,2,50,合庫-台中,2024-11-18,1021
00671R,富邦NASDAQ反1,50,0,50,合庫-台中,2024-11-18,1021
2338,光罩,50,0,50,合庫-台中,2024-11-18,1021
2337,旺宏,52,2,50,合庫-台中,2024-11-18,1021
00932,兆豐永續高息等權,62,20,42,合庫-台中,2024-11-18,1021
00637L,元大滬深300正2,177,136,41,合庫-台中,2024-11-18,1021
3323,加百裕,41,0,41,合庫-台中,2024-11-18,1021
2881,富邦金,38,0,38,合庫-台中,2024-11-18,1021
2025,千興,35,0,35,合庫-台中,2024-11-18,1021
2515,中工,50,17,33,合庫-台中,2024-11-18,1021
4109,加捷生醫,30,0,30,合庫-台中,2024-11-18,1021
8039,台虹,30,0,30,合庫-台中,2024-11-18,1021
3024,憶聲,30,0,30,合庫-台中,2024-11-18,1021
00713,元大台灣高息低波,33,3,30,合庫-台中,2024-11-18,1021
5309,系統電,87,58,29,合庫-台中,2024-11-18,1021
9136,巨騰-DR,28,0,28,合庫-台中,2024-11-18,1021
00679B,元大美債20年,30,3,27,合庫-台中,2024-11-18,1021
00642U,期元大S＆P石油,25,0,25,合庫-台中,2024-11-18,1021
3689,湧德,32,9,23,合庫-台中,2024-11-18,1021
00930,永豐ESG低碳高息,23,0,23,合庫-台中,2024-11-18,1021
2883,凱基金,25,4,21,合庫-台中,2024-11-18,1021
00715L,期街口布蘭特正2,21,0,21,合庫-台中,2024-11-18,1021
2887,台新金,18,0,18,合庫-台中,2024-11-18,1021
8028,昇陽半導體,48,30,18,合庫-台中,2024-11-18,1021
5469,瀚宇博,18,0,18,合庫-台中,2024-11-18,1021
00929,復華台灣科技優息,157,139,18,合庫-台中,2024-11-18,1021
8044,網家,57,40,17,合庫-台中,2024-11-18,1021
3706,神達,293,276,17,合庫-台中,2024-11-18,1021
1471,首利,20,4,16,合庫-台中,2024-11-18,1021
00905,FT臺灣Smart,14,0,14,合庫-台中,2024-11-18,1021
2344,華邦電,28,14,14,合庫-台中,2024-11-18,1021
3030,德律,14,0,14,合庫-台中,2024-11-18,1021
2392,正崴,39,25,14,合庫-台中,2024-11-18,1021
3231,緯創,33,19,14,合庫-台中,2024-11-18,1021
00891,中信關鍵半導體,13,0,13,合庫-台中,2024-11-18,1021
00927,群益半導體收益,13,0,13,合庫-台中,2024-11-18,1021
00933B,國泰10Y+金融債,15,2,13,合庫-台中,2024-11-18,1021
3605,宏致,13,0,13,合庫-台中,2024-11-18,1021
6186,新潤,13,0,13,合庫-台中,2024-11-18,1021
2314,台揚,12,0,12,合庫-台中,2024-11-18,1021
00887,永豐中國科技50大,450,22,428,合庫-台中,2024-11-19,1021
00637L,元大滬深300正2,440,179,261,合庫-台中,2024-11-19,1021
1460,宏遠,219,0,219,合庫-台中,2024-11-19,1021
00878,國泰永續高股息,220,10,210,合庫-台中,2024-11-19,1021
5276,達輝-KY,100,0,100,合庫-台中,2024-11-19,1021
00930,永豐ESG低碳高息,96,0,96,合庫-台中,2024-11-19,1021
00632R,元大台灣50反1,87,4,83,合庫-台中,2024-11-19,1021
3481,群創,94,31,63,合庫-台中,2024-11-19,1021
00932,兆豐永續高息等權,61,0,61,合庫-台中,2024-11-19,1021
00953B,群益優選非投等債,60,0,60,合庫-台中,2024-11-19,1021
2105,正新,121,63,58,合庫-台中,2024-11-19,1021
6589,台康生技,71,18,53,合庫-台中,2024-11-19,1021
1301,台塑,59,12,47,合庫-台中,2024-11-19,1021
1316,上曜,46,0,46,合庫-台中,2024-11-19,1021
00933B,國泰10Y+金融債,46,2,44,合庫-台中,2024-11-19,1021
3580,友威科,45,2,43,合庫-台中,2024-11-19,1021
0050,元大台灣50,41,1,40,合庫-台中,2024-11-19,1021
3231,緯創,58,21,37,合庫-台中,2024-11-19,1021
8929,富堡,37,2,35,合庫-台中,2024-11-19,1021
00633L,富邦上証正2,64,30,34,合庫-台中,2024-11-19,1021
2317,鴻海,73,40,33,合庫-台中,2024-11-19,1021
2382,廣達,43,11,32,合庫-台中,2024-11-19,1021
00673R,期元大S＆P原油反1,29,0,29,合庫-台中,2024-11-19,1021
3013,晟銘電,98,70,28,合庫-台中,2024-11-19,1021
2881,富邦金,30,3,27,合庫-台中,2024-11-19,1021
2349,錸德,102,77,25,合庫-台中,2024-11-19,1021
00655L,國泰中國A50正2,25,0,25,合庫-台中,2024-11-19,1021
00915,凱基優選高股息30,21,0,21,合庫-台中,2024-11-19,1021
00922,國泰台灣領袖50,21,0,21,合庫-台中,2024-11-19,1021
2498,宏達電,21,0,21,合庫-台中,2024-11-19,1021
2025,千興,21,0,21,合庫-台中,2024-11-19,1021
3037,欣興,37,16,21,合庫-台中,2024-11-19,1021
2646,星宇航空,33,12,21,合庫-台中,2024-11-19,1021
8064,東捷,21,0,21,合庫-台中,2024-11-19,1021
2103,台橡,20,0,20,合庫-台中,2024-11-19,1021
4526,東台,21,1,20,合庫-台中,2024-11-19,1021
8011,台通,20,1,19,合庫-台中,2024-11-19,1021
8104,錸寶,25,6,19,合庫-台中,2024-11-19,1021
00636,國泰中國A50,23,5,18,合庫-台中,2024-11-19,1021
00900,富邦特選高股息30,18,0,18,合庫-台中,2024-11-19,1021
00665L,富邦�琤肭磪囓�2,83,66,17,合庫-台中,2024-11-19,1021
00731,復華富時高息低波,16,0,16,合庫-台中,2024-11-19,1021
9921,巨大,20,4,16,合庫-台中,2024-11-19,1021
006208,富邦台50,15,0,15,合庫-台中,2024-11-19,1021
1102,亞泥,15,0,15,合庫-台中,2024-11-19,1021
2027,大成鋼,25,10,15,合庫-台中,2024-11-19,1021
1528,恩德,17,3,14,合庫-台中,2024-11-19,1021
00753L,中信中國50正2,84,71,13,合庫-台中,2024-11-19,1021
2890,永豐金,28,15,13,合庫-台中,2024-11-19,1021
3032,偉訓,42,30,12,合庫-台中,2024-11-19,1021
00706L,期元大S＆P日圓正2,1142,0,1142,合庫-台中,2024-11-20,1021
00929,復華台灣科技優息,188,2,186,合庫-台中,2024-11-20,1021
00878,國泰永續高股息,141,5,136,合庫-台中,2024-11-20,1021
2634,漢翔,116,14,102,合庫-台中,2024-11-20,1021
00919,群益台灣精選高息,157,58,99,合庫-台中,2024-11-20,1021
2883,凱基金,102,11,91,合庫-台中,2024-11-20,1021
4956,光鋐,141,57,84,合庫-台中,2024-11-20,1021
0056,元大高股息,84,1,83,合庫-台中,2024-11-20,1021
1301,台塑,82,0,82,合庫-台中,2024-11-20,1021
2354,鴻準,251,170,81,合庫-台中,2024-11-20,1021
2349,錸德,491,426,65,合庫-台中,2024-11-20,1021
2834,臺企銀,66,10,56,合庫-台中,2024-11-20,1021
2105,正新,59,4,55,合庫-台中,2024-11-20,1021
2603,長榮,64,15,49,合庫-台中,2024-11-20,1021
5880,合庫金,57,11,46,合庫-台中,2024-11-20,1021
3323,加百裕,95,54,41,合庫-台中,2024-11-20,1021
4745,合富-KY,40,0,40,合庫-台中,2024-11-20,1021
2646,星宇航空,41,5,36,合庫-台中,2024-11-20,1021
2356,英業達,63,29,34,合庫-台中,2024-11-20,1021
2615,萬海,224,190,34,合庫-台中,2024-11-20,1021
1314,中石化,34,0,34,合庫-台中,2024-11-20,1021
2449,京元電子,47,15,32,合庫-台中,2024-11-20,1021
2353,宏��,34,2,32,合庫-台中,2024-11-20,1021
8032,光菱,54,24,30,合庫-台中,2024-11-20,1021
2613,中櫃,32,2,30,合庫-台中,2024-11-20,1021
00635U,期元大S＆P黃金,29,0,29,合庫-台中,2024-11-20,1021
006208,富邦台50,27,0,27,合庫-台中,2024-11-20,1021
2303,聯電,61,36,25,合庫-台中,2024-11-20,1021
2887,台新金,25,0,25,合庫-台中,2024-11-20,1021
2338,光罩,24,0,24,合庫-台中,2024-11-20,1021
2409,友達,33,9,24,合庫-台中,2024-11-20,1021
3363,上詮,81,59,22,合庫-台中,2024-11-20,1021
2330,台積電,25,2,23,合庫-台中,2024-11-20,1021
2344,華邦電,24,3,21,合庫-台中,2024-11-20,1021
00679B,元大美債20年,28,7,21,合庫-台中,2024-11-20,1021
9105,泰金寶-DR,97,76,21,合庫-台中,2024-11-20,1021
00941,中信上游半導體,21,0,21,合庫-台中,2024-11-20,1021
8039,台虹,20,0,20,合庫-台中,2024-11-20,1021
1471,首利,21,1,20,合庫-台中,2024-11-20,1021
3374,精材,21,2,19,合庫-台中,2024-11-20,1021
3167,大量,38,19,19,合庫-台中,2024-11-20,1021
00927,群益半導體收益,19,0,19,合庫-台中,2024-11-20,1021
3625,西勝,21,2,19,合庫-台中,2024-11-20,1021
3711,日月光投控,24,7,17,合庫-台中,2024-11-20,1021
1524,耿鼎,17,0,17,合庫-台中,2024-11-20,1021
2881,富邦金,17,1,16,合庫-台中,2024-11-20,1021
4977,眾達-KY,23,7,16,合庫-台中,2024-11-20,1021
6116,彩晶,16,0,16,合庫-台中,2024-11-20,1021
2880,華南金,16,0,16,合庫-台中,2024-11-20,1021
3706,神達,294,278,16,合庫-台中,2024-11-20,1021
00632R,元大台灣50反1,300,20,280,合庫-台中,2024-11-21,1021
00878,國泰永續高股息,153,9,144,合庫-台中,2024-11-21,1021
1314,中石化,109,9,100,合庫-台中,2024-11-21,1021
0056,元大高股息,104,6,98,合庫-台中,2024-11-21,1021
2834,臺企銀,72,2,70,合庫-台中,2024-11-21,1021
00888,永豐台灣ESG,62,0,62,合庫-台中,2024-11-21,1021
2349,錸德,360,301,59,合庫-台中,2024-11-21,1021
2881,富邦金,54,3,51,合庫-台中,2024-11-21,1021
00930,永豐ESG低碳高息,50,0,50,合庫-台中,2024-11-21,1021
2890,永豐金,69,19,50,合庫-台中,2024-11-21,1021
2303,聯電,179,131,48,合庫-台中,2024-11-21,1021
1301,台塑,57,10,47,合庫-台中,2024-11-21,1021
3511,矽瑪,80,39,41,合庫-台中,2024-11-21,1021
2317,鴻海,61,20,41,合庫-台中,2024-11-21,1021
2354,鴻準,199,162,37,合庫-台中,2024-11-21,1021
2353,宏��,39,4,35,合庫-台中,2024-11-21,1021
2204,中華,149,115,34,合庫-台中,2024-11-21,1021
2330,台積電,34,1,33,合庫-台中,2024-11-21,1021
00909,國泰數位支付服務,45,13,32,合庫-台中,2024-11-21,1021
00927,群益半導體收益,30,0,30,合庫-台中,2024-11-21,1021
2486,一詮,28,0,28,合庫-台中,2024-11-21,1021
00953B,群益優選非投等債,29,1,28,合庫-台中,2024-11-21,1021
00933B,國泰10Y+金融債,34,7,27,合庫-台中,2024-11-21,1021
2618,長榮航,40,14,26,合庫-台中,2024-11-21,1021
8240,華宏,36,11,25,合庫-台中,2024-11-21,1021
006208,富邦台50,25,0,25,合庫-台中,2024-11-21,1021
2884,玉山金,23,0,23,合庫-台中,2024-11-21,1021
2002,中鋼,28,5,23,合庫-台中,2024-11-21,1021
3013,晟銘電,59,37,22,合庫-台中,2024-11-21,1021
00940,元大台灣價值高息,23,1,22,合庫-台中,2024-11-21,1021
5880,合庫金,28,6,22,合庫-台中,2024-11-21,1021
00631L,元大台灣50正2,106,85,21,合庫-台中,2024-11-21,1021
2312,金寶,143,123,20,合庫-台中,2024-11-21,1021
00715L,期街口布蘭特正2,30,10,20,合庫-台中,2024-11-21,1021
2332,友訊,31,11,20,合庫-台中,2024-11-21,1021
0050,元大台灣50,35,16,19,合庫-台中,2024-11-21,1021
5531,鄉林,17,0,17,合庫-台中,2024-11-21,1021
6585,鼎基,17,0,17,合庫-台中,2024-11-21,1021
3017,奇鋐,32,16,16,合庫-台中,2024-11-21,1021
1303,南亞,14,0,14,合庫-台中,2024-11-21,1021
00713,元大台灣高息低波,14,0,14,合庫-台中,2024-11-21,1021
3625,西勝,29,16,13,合庫-台中,2024-11-21,1021
5905,南仁湖,24,11,13,合庫-台中,2024-11-21,1021
3481,群創,34,22,12,合庫-台中,2024-11-21,1021
6177,達麗,12,0,12,合庫-台中,2024-11-21,1021
3490,單井,15,3,12,合庫-台中,2024-11-21,1021
2409,友達,29,17,12,合庫-台中,2024-11-21,1021
5488,松普,21,10,11,合庫-台中,2024-11-21,1021
00904,新光臺灣半導體30,11,0,11,合庫-台中,2024-11-21,1021
4958,臻鼎-KY,12,1,11,合庫-台中,2024-11-21,1021
1460,宏遠,676,0,676,合庫-台中,2024-11-22,1021
00632R,元大台灣50反1,432,10,422,合庫-台中,2024-11-22,1021
00665L,富邦�琤肭磪囓�2,302,124,178,合庫-台中,2024-11-22,1021
00795B,中信美國公債20年,130,9,121,合庫-台中,2024-11-22,1021
2609,陽明,495,376,119,合庫-台中,2024-11-22,1021
00909,國泰數位支付服務,121,2,119,合庫-台中,2024-11-22,1021
6156,松上,95,2,93,合庫-台中,2024-11-22,1021
00664R,國泰臺灣加權反1,70,0,70,合庫-台中,2024-11-22,1021
00882,中信中國高股息,58,1,57,合庫-台中,2024-11-22,1021
00753L,中信中國50正2,105,50,55,合庫-台中,2024-11-22,1021
1316,上曜,45,0,45,合庫-台中,2024-11-22,1021
2881,富邦金,46,2,44,合庫-台中,2024-11-22,1021
2834,臺企銀,45,2,43,合庫-台中,2024-11-22,1021
8032,光菱,42,1,41,合庫-台中,2024-11-22,1021
3323,加百裕,157,118,39,合庫-台中,2024-11-22,1021
3511,矽瑪,74,36,38,合庫-台中,2024-11-22,1021
2204,中華,106,71,35,合庫-台中,2024-11-22,1021
3702,大聯大,33,0,33,合庫-台中,2024-11-22,1021
8104,錸寶,72,40,32,合庫-台中,2024-11-22,1021
4128,中天,31,0,31,合庫-台中,2024-11-22,1021
6116,彩晶,34,4,30,合庫-台中,2024-11-22,1021
5880,合庫金,34,4,30,合庫-台中,2024-11-22,1021
4513,福裕,48,19,29,合庫-台中,2024-11-22,1021
2317,鴻海,50,22,28,合庫-台中,2024-11-22,1021
5519,隆大,27,0,27,合庫-台中,2024-11-22,1021
2349,錸德,130,105,25,合庫-台中,2024-11-22,1021
2867,三商壽,25,0,25,合庫-台中,2024-11-22,1021
3037,欣興,38,13,25,合庫-台中,2024-11-22,1021
8261,富鼎,35,11,24,合庫-台中,2024-11-22,1021
00637L,元大滬深300正2,156,133,23,合庫-台中,2024-11-22,1021
1802,台玻,54,31,23,合庫-台中,2024-11-22,1021
2641,正德,22,0,22,合庫-台中,2024-11-22,1021
3290,東浦,24,2,22,合庫-台中,2024-11-22,1021
5309,系統電,96,74,22,合庫-台中,2024-11-22,1021
8163,達方,49,28,21,合庫-台中,2024-11-22,1021
6155,鈞寶,20,0,20,合庫-台中,2024-11-22,1021
00633L,富邦上証正2,21,1,20,合庫-台中,2024-11-22,1021
2328,廣宇,31,11,20,合庫-台中,2024-11-22,1021
3580,友威科,20,2,18,合庫-台中,2024-11-22,1021
5398,慕康生醫,18,0,18,合庫-台中,2024-11-22,1021
2439,美律,17,0,17,合庫-台中,2024-11-22,1021
3593,力銘,17,0,17,合庫-台中,2024-11-22,1021
00673R,期元大S＆P原油反1,17,0,17,合庫-台中,2024-11-22,1021
1587,吉茂,22,6,16,合庫-台中,2024-11-22,1021
2356,英業達,42,27,15,合庫-台中,2024-11-22,1021
2547,日勝生,15,0,15,合庫-台中,2024-11-22,1021
1808,潤隆,15,0,15,合庫-台中,2024-11-22,1021
5876,上海商銀,15,1,14,合庫-台中,2024-11-22,1021
1582,信錦,14,0,14,合庫-台中,2024-11-22,1021
2444,兆勁,20,6,14,合庫-台中,2024-11-22,1021
00887,永豐中國科技50大,1036,11,1025,合庫-台中,2024-11-25,1021
9105,泰金寶-DR,489,242,247,合庫-台中,2024-11-25,1021
1314,中石化,233,78,155,合庫-台中,2024-11-25,1021
00909,國泰數位支付服務,141,3,138,合庫-台中,2024-11-25,1021
00637L,元大滬深300正2,332,212,120,合庫-台中,2024-11-25,1021
2515,中工,125,10,115,合庫-台中,2024-11-25,1021
00673R,期元大S＆P原油反1,111,0,111,合庫-台中,2024-11-25,1021
00919,群益台灣精選高息,98,5,93,合庫-台中,2024-11-25,1021
00753L,中信中國50正2,85,10,75,合庫-台中,2024-11-25,1021
00664R,國泰臺灣加權反1,70,0,70,合庫-台中,2024-11-25,1021
2371,大同,99,30,69,合庫-台中,2024-11-25,1021
1815,富喬,142,85,57,合庫-台中,2024-11-25,1021
00665L,富邦�琤肭磪囓�2,222,170,52,合庫-台中,2024-11-25,1021
2477,美隆電,51,3,48,合庫-台中,2024-11-25,1021
3706,神達,195,150,45,合庫-台中,2024-11-25,1021
2801,彰銀,200,160,40,合庫-台中,2024-11-25,1021
2444,兆勁,64,26,38,合庫-台中,2024-11-25,1021
2312,金寶,364,327,37,合庫-台中,2024-11-25,1021
2449,京元電子,47,13,34,合庫-台中,2024-11-25,1021
6770,力積電,32,0,32,合庫-台中,2024-11-25,1021
2328,廣宇,33,1,32,合庫-台中,2024-11-25,1021
2603,長榮,46,18,28,合庫-台中,2024-11-25,1021
3032,偉訓,47,20,27,合庫-台中,2024-11-25,1021
2349,錸德,73,48,25,合庫-台中,2024-11-25,1021
2331,精英,25,0,25,合庫-台中,2024-11-25,1021
4576,大銀微系統,32,8,24,合庫-台中,2024-11-25,1021
5426,振發,26,4,22,合庫-台中,2024-11-25,1021
3450,聯鈞,111,90,21,合庫-台中,2024-11-25,1021
4956,光鋐,38,18,20,合庫-台中,2024-11-25,1021
2617,台航,20,0,20,合庫-台中,2024-11-25,1021
3234,光環,35,15,20,合庫-台中,2024-11-25,1021
00706L,期元大S＆P日圓正2,20,0,20,合庫-台中,2024-11-25,1021
2344,華邦電,30,11,19,合庫-台中,2024-11-25,1021
6585,鼎基,20,1,19,合庫-台中,2024-11-25,1021
2641,正德,21,3,18,合庫-台中,2024-11-25,1021
6125,廣運,20,2,18,合庫-台中,2024-11-25,1021
00953B,群益優選非投等債,18,0,18,合庫-台中,2024-11-25,1021
6005,群益證,17,0,17,合庫-台中,2024-11-25,1021
4714,永捷,19,2,17,合庫-台中,2024-11-25,1021
4931,新盛力,23,7,16,合庫-台中,2024-11-25,1021
2421,建準,19,3,16,合庫-台中,2024-11-25,1021
00633L,富邦上証正2,24,8,16,合庫-台中,2024-11-25,1021
5871,中租-KY,21,5,16,合庫-台中,2024-11-25,1021
3693,營邦,16,0,16,合庫-台中,2024-11-25,1021
5347,世界,16,1,15,合庫-台中,2024-11-25,1021
2885,元大金,15,0,15,合庫-台中,2024-11-25,1021
2002,中鋼,19,4,15,合庫-台中,2024-11-25,1021
3027,盛達,21,7,14,合庫-台中,2024-11-25,1021
8171,天宇,43,29,14,合庫-台中,2024-11-25,1021
2609,陽明,266,253,13,合庫-台中,2024-11-25,1021
2834,臺企銀,503,7,496,合庫-台中,2024-11-26,1021
00665L,富邦�琤肭磪囓�2,334,108,226,合庫-台中,2024-11-26,1021
2317,鴻海,234,11,223,合庫-台中,2024-11-26,1021
00687B,國泰20年美債,178,19,159,合庫-台中,2024-11-26,1021
2344,華邦電,126,16,110,合庫-台中,2024-11-26,1021
2354,鴻準,212,114,98,合庫-台中,2024-11-26,1021
00715L,期街口布蘭特正2,215,124,91,合庫-台中,2024-11-26,1021
5309,系統電,200,114,86,合庫-台中,2024-11-26,1021
2392,正崴,182,96,86,合庫-台中,2024-11-26,1021
2887,台新金,84,5,79,合庫-台中,2024-11-26,1021
9105,泰金寶-DR,145,71,74,合庫-台中,2024-11-26,1021
00878,國泰永續高股息,87,18,69,合庫-台中,2024-11-26,1021
2890,永豐金,69,0,69,合庫-台中,2024-11-26,1021
00909,國泰數位支付服務,81,20,61,合庫-台中,2024-11-26,1021
2801,彰銀,110,50,60,合庫-台中,2024-11-26,1021
00918,大華優利高填息30,58,4,54,合庫-台中,2024-11-26,1021
3481,群創,66,14,52,合庫-台中,2024-11-26,1021
2547,日勝生,62,11,51,合庫-台中,2024-11-26,1021
00708L,期元大S＆P黃金正2,46,0,46,合庫-台中,2024-11-26,1021
4746,台耀,42,0,42,合庫-台中,2024-11-26,1021
3593,力銘,41,0,41,合庫-台中,2024-11-26,1021
2312,金寶,205,170,35,合庫-台中,2024-11-26,1021
00664R,國泰臺灣加權反1,35,0,35,合庫-台中,2024-11-26,1021
4931,新盛力,33,0,33,合庫-台中,2024-11-26,1021
3511,矽瑪,36,4,32,合庫-台中,2024-11-26,1021
00959B,大華投等美債15Y+,31,0,31,合庫-台中,2024-11-26,1021
00929,復華台灣科技優息,57,28,29,合庫-台中,2024-11-26,1021
2609,陽明,36,10,26,合庫-台中,2024-11-26,1021
2330,台積電,27,3,24,合庫-台中,2024-11-26,1021
6589,台康生技,26,3,23,合庫-台中,2024-11-26,1021
2489,瑞軒,30,8,22,合庫-台中,2024-11-26,1021
2332,友訊,22,0,22,合庫-台中,2024-11-26,1021
00939,統一台灣高息動能,22,0,22,合庫-台中,2024-11-26,1021
3231,緯創,54,33,21,合庫-台中,2024-11-26,1021
00692,富邦公司治理,20,0,20,合庫-台中,2024-11-26,1021
6134,萬旭,26,6,20,合庫-台中,2024-11-26,1021
00712,復華富時不動產,20,2,18,合庫-台中,2024-11-26,1021
00927,群益半導體收益,18,0,18,合庫-台中,2024-11-26,1021
00881,國泰台灣5G+,18,0,18,合庫-台中,2024-11-26,1021
4743,合一,21,4,17,合庫-台中,2024-11-26,1021
4128,中天,17,0,17,合庫-台中,2024-11-26,1021
3323,加百裕,292,275,17,合庫-台中,2024-11-26,1021
6558,興能高,88,71,17,合庫-台中,2024-11-26,1021
5371,中光電,53,36,17,合庫-台中,2024-11-26,1021
2204,中華,56,39,17,合庫-台中,2024-11-26,1021
00919,群益台灣精選高息,22,5,17,合庫-台中,2024-11-26,1021
3276,宇環,15,0,15,合庫-台中,2024-11-26,1021
00960,野村全球航運龍頭,15,0,15,合庫-台中,2024-11-26,1021
4729,熒茂,16,1,15,合庫-台中,2024-11-26,1021
2615,萬海,16,1,15,合庫-台中,2024-11-26,1021
00664R,國泰臺灣加權反1,400,10,390,合庫-台中,2024-11-27,1021
00919,群益台灣精選高息,220,1,219,合庫-台中,2024-11-27,1021
00878,國泰永續高股息,300,102,198,合庫-台中,2024-11-27,1021
0056,元大高股息,168,2,166,合庫-台中,2024-11-27,1021
2303,聯電,173,36,137,合庫-台中,2024-11-27,1021
00929,復華台灣科技優息,136,4,132,合庫-台中,2024-11-27,1021
4931,新盛力,105,4,101,合庫-台中,2024-11-27,1021
1605,華新,95,1,94,合庫-台中,2024-11-27,1021
6156,松上,113,20,93,合庫-台中,2024-11-27,1021
00918,大華優利高填息30,94,12,82,合庫-台中,2024-11-27,1021
00940,元大台灣價值高息,84,2,82,合庫-台中,2024-11-27,1021
2392,正崴,218,142,76,合庫-台中,2024-11-27,1021
3706,神達,302,231,71,合庫-台中,2024-11-27,1021
3481,群創,87,22,65,合庫-台中,2024-11-27,1021
3231,緯創,112,60,52,合庫-台中,2024-11-27,1021
2409,友達,66,14,52,合庫-台中,2024-11-27,1021
1536,和大,208,161,47,合庫-台中,2024-11-27,1021
2330,台積電,55,8,47,合庫-台中,2024-11-27,1021
6558,興能高,80,34,46,合庫-台中,2024-11-27,1021
00715L,期街口布蘭特正2,55,11,44,合庫-台中,2024-11-27,1021
1316,上曜,44,0,44,合庫-台中,2024-11-27,1021
3050,鈺德,43,0,43,合庫-台中,2024-11-27,1021
2834,臺企銀,56,14,42,合庫-台中,2024-11-27,1021
5880,合庫金,74,32,42,合庫-台中,2024-11-27,1021
2382,廣達,46,9,37,合庫-台中,2024-11-27,1021
00930,永豐ESG低碳高息,36,0,36,合庫-台中,2024-11-27,1021
2103,台橡,35,0,35,合庫-台中,2024-11-27,1021
9105,泰金寶-DR,101,68,33,合庫-台中,2024-11-27,1021
2615,萬海,110,77,33,合庫-台中,2024-11-27,1021
6770,力積電,41,8,33,合庫-台中,2024-11-27,1021
2609,陽明,336,303,33,合庫-台中,2024-11-27,1021
00922,國泰台灣領袖50,32,0,32,合庫-台中,2024-11-27,1021
6124,業強,31,0,31,合庫-台中,2024-11-27,1021
5403,中菲,30,0,30,合庫-台中,2024-11-27,1021
4729,熒茂,45,15,30,合庫-台中,2024-11-27,1021
00881,國泰台灣5G+,29,0,29,合庫-台中,2024-11-27,1021
2441,超豐,26,0,26,合庫-台中,2024-11-27,1021
2317,鴻海,144,118,26,合庫-台中,2024-11-27,1021
00946,群益科技高息成長,24,0,24,合庫-台中,2024-11-27,1021
2313,華通,29,5,24,合庫-台中,2024-11-27,1021
3037,欣興,27,3,24,合庫-台中,2024-11-27,1021
2353,宏��,22,0,22,合庫-台中,2024-11-27,1021
2356,英業達,25,3,22,合庫-台中,2024-11-27,1021
3276,宇環,21,0,21,合庫-台中,2024-11-27,1021
00959B,大華投等美債15Y+,21,0,21,合庫-台中,2024-11-27,1021
2867,三商壽,21,1,20,合庫-台中,2024-11-27,1021
0050,元大台灣50,20,0,20,合庫-台中,2024-11-27,1021
6016,康和證,20,0,20,合庫-台中,2024-11-27,1021
6134,萬旭,21,1,20,合庫-台中,2024-11-27,1021
1815,富喬,59,40,19,合庫-台中,2024-11-27,1021
5880,合庫金,668,30,638,合庫-台中,2024-11-28,1021
6127,九豪,283,27,256,合庫-台中,2024-11-28,1021
00919,群益台灣精選高息,210,9,201,合庫-台中,2024-11-28,1021
00878,國泰永續高股息,239,55,184,合庫-台中,2024-11-28,1021
00637L,元大滬深300正2,266,96,170,合庫-台中,2024-11-28,1021
00929,復華台灣科技優息,144,18,126,合庫-台中,2024-11-28,1021
2312,金寶,385,285,100,合庫-台中,2024-11-28,1021
00688L,國泰20年美債正2,100,1,99,合庫-台中,2024-11-28,1021
4510,高鋒,197,105,92,合庫-台中,2024-11-28,1021
2409,友達,105,17,88,合庫-台中,2024-11-28,1021
00632R,元大台灣50反1,233,150,83,合庫-台中,2024-11-28,1021
3090,日電貿,101,24,77,合庫-台中,2024-11-28,1021
2801,彰銀,72,10,62,合庫-台中,2024-11-28,1021
2344,華邦電,82,23,59,合庫-台中,2024-11-28,1021
00918,大華優利高填息30,56,0,56,合庫-台中,2024-11-28,1021
00680L,元大美債20正2,125,78,47,合庫-台中,2024-11-28,1021
3029,零壹,56,12,44,合庫-台中,2024-11-28,1021
00665L,富邦�琤肭磪囓�2,254,211,43,合庫-台中,2024-11-28,1021
1605,華新,179,138,41,合庫-台中,2024-11-28,1021
2317,鴻海,81,41,40,合庫-台中,2024-11-28,1021
1314,中石化,50,10,40,合庫-台中,2024-11-28,1021
2419,仲琦,42,3,39,合庫-台中,2024-11-28,1021
2392,正崴,112,74,38,合庫-台中,2024-11-28,1021
6706,惠特,45,11,34,合庫-台中,2024-11-28,1021
00753L,中信中國50正2,100,68,32,合庫-台中,2024-11-28,1021
00915,凱基優選高股息30,31,0,31,合庫-台中,2024-11-28,1021
1536,和大,109,79,30,合庫-台中,2024-11-28,1021
6770,力積電,38,8,30,合庫-台中,2024-11-28,1021
2887,台新金,31,1,30,合庫-台中,2024-11-28,1021
2354,鴻準,117,89,28,合庫-台中,2024-11-28,1021
8114,振樺電,29,1,28,合庫-台中,2024-11-28,1021
2337,旺宏,28,2,26,合庫-台中,2024-11-28,1021
3481,群創,38,13,25,合庫-台中,2024-11-28,1021
00713,元大台灣高息低波,25,0,25,合庫-台中,2024-11-28,1021
2332,友訊,133,110,23,合庫-台中,2024-11-28,1021
00881,國泰台灣5G+,23,0,23,合庫-台中,2024-11-28,1021
8171,天宇,24,2,22,合庫-台中,2024-11-28,1021
3520,華盈,22,0,22,合庫-台中,2024-11-28,1021
2441,超豐,20,0,20,合庫-台中,2024-11-28,1021
2330,台積電,29,9,20,合庫-台中,2024-11-28,1021
00922,國泰台灣領袖50,19,0,19,合庫-台中,2024-11-28,1021
00934,中信成長高股息,19,1,18,合庫-台中,2024-11-28,1021
4991,環宇-KY,25,7,18,合庫-台中,2024-11-28,1021
00930,永豐ESG低碳高息,18,0,18,合庫-台中,2024-11-28,1021
00882,中信中國高股息,200,183,17,合庫-台中,2024-11-28,1021
3557,嘉威,20,3,17,合庫-台中,2024-11-28,1021
3450,聯鈞,81,65,16,合庫-台中,2024-11-28,1021
2408,南亞科,27,11,16,合庫-台中,2024-11-28,1021
2615,萬海,23,8,15,合庫-台中,2024-11-28,1021
006208,富邦台50,15,0,15,合庫-台中,2024-11-28,1021
2801,彰銀,110,0,110,合庫-台中,2024-11-29,1021
2002,中鋼,103,2,101,合庫-台中,2024-11-29,1021
0056,元大高股息,103,4,99,合庫-台中,2024-11-29,1021
2887,台新金,87,0,87,合庫-台中,2024-11-29,1021
00878,國泰永續高股息,105,19,86,合庫-台中,2024-11-29,1021
6127,九豪,105,20,85,合庫-台中,2024-11-29,1021
00680L,元大美債20正2,80,2,78,合庫-台中,2024-11-29,1021
2888,新光金,106,37,69,合庫-台中,2024-11-29,1021
00919,群益台灣精選高息,83,18,65,合庫-台中,2024-11-29,1021
2388,威盛,64,0,64,合庫-台中,2024-11-29,1021
00909,國泰數位支付服務,62,1,61,合庫-台中,2024-11-29,1021
1301,台塑,58,0,58,合庫-台中,2024-11-29,1021
5309,系統電,115,58,57,合庫-台中,2024-11-29,1021
2303,聯電,70,14,56,合庫-台中,2024-11-29,1021
2317,鴻海,82,28,54,合庫-台中,2024-11-29,1021
2883,凱基金,57,6,51,合庫-台中,2024-11-29,1021
00632R,元大台灣50反1,52,1,51,合庫-台中,2024-11-29,1021
00664R,國泰臺灣加權反1,50,0,50,合庫-台中,2024-11-29,1021
2367,燿華,52,4,48,合庫-台中,2024-11-29,1021
2646,星宇航空,43,2,41,合庫-台中,2024-11-29,1021
00929,復華台灣科技優息,47,6,41,合庫-台中,2024-11-29,1021
00915,凱基優選高股息30,37,0,37,合庫-台中,2024-11-29,1021
1586,和勤,35,0,35,合庫-台中,2024-11-29,1021
2634,漢翔,34,1,33,合庫-台中,2024-11-29,1021
00950B,凱基A級公司債,32,0,32,合庫-台中,2024-11-29,1021
2330,台積電,37,6,31,合庫-台中,2024-11-29,1021
2337,旺宏,32,2,30,合庫-台中,2024-11-29,1021
2426,鼎元,66,40,26,合庫-台中,2024-11-29,1021
8404,百和興業-KY,26,2,24,合庫-台中,2024-11-29,1021
2834,臺企銀,32,9,23,合庫-台中,2024-11-29,1021
2609,陽明,134,112,22,合庫-台中,2024-11-29,1021
2884,玉山金,23,1,22,合庫-台中,2024-11-29,1021
8070,長華*,21,0,21,合庫-台中,2024-11-29,1021
3032,偉訓,23,3,20,合庫-台中,2024-11-29,1021
3712,永崴投控,22,2,20,合庫-台中,2024-11-29,1021
9934,成霖,20,0,20,合庫-台中,2024-11-29,1021
2882,國泰金,20,1,19,合庫-台中,2024-11-29,1021
00713,元大台灣高息低波,20,1,19,合庫-台中,2024-11-29,1021
00706L,期元大S＆P日圓正2,19,2,17,合庫-台中,2024-11-29,1021
00940,元大台灣價值高息,19,3,16,合庫-台中,2024-11-29,1021
2371,大同,56,40,16,合庫-台中,2024-11-29,1021
2356,英業達,19,3,16,合庫-台中,2024-11-29,1021
1584,精剛,15,0,15,合庫-台中,2024-11-29,1021
1536,和大,36,21,15,合庫-台中,2024-11-29,1021
2344,華邦電,26,12,14,合庫-台中,2024-11-29,1021
5871,中租-KY,17,4,13,合庫-台中,2024-11-29,1021
1815,富喬,72,59,13,合庫-台中,2024-11-29,1021
1304,台聚,13,0,13,合庫-台中,2024-11-29,1021
2382,廣達,19,6,13,合庫-台中,2024-11-29,1021
3323,加百裕,57,45,12,合庫-台中,2024-11-29,1021
00680L,元大美債20正2,506,32,474,合庫-台中,2024-12-02,1021
00878,國泰永續高股息,174,25,149,合庫-台中,2024-12-02,1021
1528,恩德,128,1,127,合庫-台中,2024-12-02,1021
0056,元大高股息,84,6,78,合庫-台中,2024-12-02,1021
00909,國泰數位支付服務,75,0,75,合庫-台中,2024-12-02,1021
2312,金寶,174,106,68,合庫-台中,2024-12-02,1021
00965,元大航太防衛科技,63,0,63,合庫-台中,2024-12-02,1021
00712,復華富時不動產,61,5,56,合庫-台中,2024-12-02,1021
00715L,期街口布蘭特正2,63,7,56,合庫-台中,2024-12-02,1021
00708L,期元大S＆P黃金正2,53,0,53,合庫-台中,2024-12-02,1021
3059,華晶科,51,0,51,合庫-台中,2024-12-02,1021
6770,力積電,50,0,50,合庫-台中,2024-12-02,1021
2337,旺宏,52,7,45,合庫-台中,2024-12-02,1021
00918,大華優利高填息30,61,20,41,合庫-台中,2024-12-02,1021
00650L,復華香港正2,115,75,40,合庫-台中,2024-12-02,1021
2338,光罩,40,0,40,合庫-台中,2024-12-02,1021
2344,華邦電,41,7,34,合庫-台中,2024-12-02,1021
00960,野村全球航運龍頭,33,0,33,合庫-台中,2024-12-02,1021
2886,兆豐金,37,5,32,合庫-台中,2024-12-02,1021
4916,事欣科,33,1,32,合庫-台中,2024-12-02,1021
2317,鴻海,72,42,30,合庫-台中,2024-12-02,1021
2444,兆勁,44,15,29,合庫-台中,2024-12-02,1021
3211,順達,140,114,26,合庫-台中,2024-12-02,1021
3013,晟銘電,54,30,24,合庫-台中,2024-12-02,1021
2351,順德,24,0,24,合庫-台中,2024-12-02,1021
1536,和大,52,29,23,合庫-台中,2024-12-02,1021
1815,富喬,111,88,23,合庫-台中,2024-12-02,1021
00713,元大台灣高息低波,23,0,23,合庫-台中,2024-12-02,1021
1513,中興電,22,1,21,合庫-台中,2024-12-02,1021
2349,錸德,22,1,21,合庫-台中,2024-12-02,1021
1586,和勤,20,0,20,合庫-台中,2024-12-02,1021
2375,凱美,26,6,20,合庫-台中,2024-12-02,1021
1611,中電,20,2,18,合庫-台中,2024-12-02,1021
2929,淘帝-KY,49,32,17,合庫-台中,2024-12-02,1021
1301,台塑,43,26,17,合庫-台中,2024-12-02,1021
2392,正崴,31,14,17,合庫-台中,2024-12-02,1021
6505,台塑化,16,0,16,合庫-台中,2024-12-02,1021
00632R,元大台灣50反1,341,325,16,合庫-台中,2024-12-02,1021
1605,華新,193,177,16,合庫-台中,2024-12-02,1021
9136,巨騰-DR,15,0,15,合庫-台中,2024-12-02,1021
00950B,凱基A級公司債,15,0,15,合庫-台中,2024-12-02,1021
2354,鴻準,40,25,15,合庫-台中,2024-12-02,1021
2426,鼎元,24,10,14,合庫-台中,2024-12-02,1021
3706,神達,129,115,14,合庫-台中,2024-12-02,1021
00953B,群益優選非投等債,13,0,13,合庫-台中,2024-12-02,1021
1466,聚隆,13,0,13,合庫-台中,2024-12-02,1021
2002,中鋼,21,8,13,合庫-台中,2024-12-02,1021
4729,熒茂,14,2,12,合庫-台中,2024-12-02,1021
00915,凱基優選高股息30,17,5,12,合庫-台中,2024-12-02,1021
3189,景碩,11,0,11,合庫-台中,2024-12-02,1021
00919,群益台灣精選高息,239,34,205,合庫-台中,2024-12-03,1021
00715L,期街口布蘭特正2,196,0,196,合庫-台中,2024-12-03,1021
00713,元大台灣高息低波,121,0,121,合庫-台中,2024-12-03,1021
4303,信立,231,149,82,合庫-台中,2024-12-03,1021
00687B,國泰20年美債,130,56,74,合庫-台中,2024-12-03,1021
00953B,群益優選非投等債,74,0,74,合庫-台中,2024-12-03,1021
00965,元大航太防衛科技,73,0,73,合庫-台中,2024-12-03,1021
00918,大華優利高填息30,81,17,64,合庫-台中,2024-12-03,1021
2883,凱基金,101,39,62,合庫-台中,2024-12-03,1021
00878,國泰永續高股息,72,12,60,合庫-台中,2024-12-03,1021
3043,科風,64,5,59,合庫-台中,2024-12-03,1021
2388,威盛,50,2,48,合庫-台中,2024-12-03,1021
3625,西勝,42,3,39,合庫-台中,2024-12-03,1021
1785,光洋科,68,30,38,合庫-台中,2024-12-03,1021
8042,金山電,40,3,37,合庫-台中,2024-12-03,1021
2303,聯電,45,11,34,合庫-台中,2024-12-03,1021
3149,正達,32,0,32,合庫-台中,2024-12-03,1021
6127,九豪,39,7,32,合庫-台中,2024-12-03,1021
2034,允強,30,0,30,合庫-台中,2024-12-03,1021
2017,官田鋼,30,0,30,合庫-台中,2024-12-03,1021
5880,合庫金,91,64,27,合庫-台中,2024-12-03,1021
2344,華邦電,34,11,23,合庫-台中,2024-12-03,1021
00915,凱基優選高股息30,38,15,23,合庫-台中,2024-12-03,1021
4406,新昕纖,22,0,22,合庫-台中,2024-12-03,1021
3090,日電貿,29,8,21,合庫-台中,2024-12-03,1021
00950B,凱基A級公司債,21,0,21,合庫-台中,2024-12-03,1021
2014,中鴻,18,0,18,合庫-台中,2024-12-03,1021
3025,星通,34,16,18,合庫-台中,2024-12-03,1021
5309,系統電,57,40,17,合庫-台中,2024-12-03,1021
4113,聯上,17,0,17,合庫-台中,2024-12-03,1021
6117,迎廣,21,5,16,合庫-台中,2024-12-03,1021
4430,耀億,16,0,16,合庫-台中,2024-12-03,1021
2338,光罩,15,0,15,合庫-台中,2024-12-03,1021
0056,元大高股息,31,16,15,合庫-台中,2024-12-03,1021
2444,兆勁,54,40,14,合庫-台中,2024-12-03,1021
00712,復華富時不動產,24,10,14,合庫-台中,2024-12-03,1021
4510,高鋒,30,16,14,合庫-台中,2024-12-03,1021
2382,廣達,19,6,13,合庫-台中,2024-12-03,1021
8028,昇陽半導體,15,3,12,合庫-台中,2024-12-03,1021
3711,日月光投控,22,10,12,合庫-台中,2024-12-03,1021
2614,東森,12,0,12,合庫-台中,2024-12-03,1021
8936,國統,12,1,11,合庫-台中,2024-12-03,1021
2429,銘旺科,11,0,11,合庫-台中,2024-12-03,1021
00731,復華富時高息低波,11,0,11,合庫-台中,2024-12-03,1021
5469,瀚宇博,11,0,11,合庫-台中,2024-12-03,1021
4904,遠傳,10,0,10,合庫-台中,2024-12-03,1021
5864,致和證,12,2,10,合庫-台中,2024-12-03,1021
00857B,永豐20年美公債,10,0,10,合庫-台中,2024-12-03,1021
2460,建通,10,0,10,合庫-台中,2024-12-03,1021
3022,威強電,10,0,10,合庫-台中,2024-12-03,1021
00919,群益台灣精選高息,292,61,231,合庫-台中,2024-12-04,1021
00918,大華優利高填息30,236,9,227,合庫-台中,2024-12-04,1021
9105,泰金寶-DR,266,48,218,合庫-台中,2024-12-04,1021
00680L,元大美債20正2,161,14,147,合庫-台中,2024-12-04,1021
00940,元大台灣價值高息,143,21,122,合庫-台中,2024-12-04,1021
00687B,國泰20年美債,107,33,74,合庫-台中,2024-12-04,1021
2883,凱基金,101,28,73,合庫-台中,2024-12-04,1021
2344,華邦電,93,22,71,合庫-台中,2024-12-04,1021
2312,金寶,96,25,71,合庫-台中,2024-12-04,1021
00937B,群益ESG投等債20,79,12,67,合庫-台中,2024-12-04,1021
00679B,元大美債20年,74,8,66,合庫-台中,2024-12-04,1021
00953B,群益優選非投等債,66,0,66,合庫-台中,2024-12-04,1021
2303,聯電,66,4,62,合庫-台中,2024-12-04,1021
2472,立隆電,80,20,60,合庫-台中,2024-12-04,1021
3059,華晶科,57,1,56,合庫-台中,2024-12-04,1021
5244,弘凱,57,7,50,合庫-台中,2024-12-04,1021
8070,長華*,50,0,50,合庫-台中,2024-12-04,1021
2834,臺企銀,46,0,46,合庫-台中,2024-12-04,1021
2887,台新金,47,2,45,合庫-台中,2024-12-04,1021
00959B,大華投等美債15Y+,39,0,39,合庫-台中,2024-12-04,1021
2392,正崴,87,51,36,合庫-台中,2024-12-04,1021
00915,凱基優選高股息30,35,1,34,合庫-台中,2024-12-04,1021
5880,合庫金,55,22,33,合庫-台中,2024-12-04,1021
8097,常珵,32,0,32,合庫-台中,2024-12-04,1021
2408,南亞科,42,12,30,合庫-台中,2024-12-04,1021
00965,元大航太防衛科技,30,0,30,合庫-台中,2024-12-04,1021
2430,燦坤,30,0,30,合庫-台中,2024-12-04,1021
00713,元大台灣高息低波,29,1,28,合庫-台中,2024-12-04,1021
3706,神達,256,228,28,合庫-台中,2024-12-04,1021
6265,方土昶,28,1,27,合庫-台中,2024-12-04,1021
00892,富邦台灣半導體,30,4,26,合庫-台中,2024-12-04,1021
4406,新昕纖,26,0,26,合庫-台中,2024-12-04,1021
1460,宏遠,25,0,25,合庫-台中,2024-12-04,1021
2646,星宇航空,29,4,25,合庫-台中,2024-12-04,1021
8105,凌巨,25,0,25,合庫-台中,2024-12-04,1021
2891,中信金,30,6,24,合庫-台中,2024-12-04,1021
00795B,中信美國公債20年,24,1,23,合庫-台中,2024-12-04,1021
2409,友達,51,29,22,合庫-台中,2024-12-04,1021
3015,全漢,31,9,22,合庫-台中,2024-12-04,1021
0056,元大高股息,24,3,21,合庫-台中,2024-12-04,1021
2881,富邦金,41,20,21,合庫-台中,2024-12-04,1021
00751B,元大AAA至A公司債,20,0,20,合庫-台中,2024-12-04,1021
4916,事欣科,20,0,20,合庫-台中,2024-12-04,1021
2486,一詮,34,15,19,合庫-台中,2024-12-04,1021
3090,日電貿,47,28,19,合庫-台中,2024-12-04,1021
2324,仁寶,21,3,18,合庫-台中,2024-12-04,1021
2457,飛宏,17,1,16,合庫-台中,2024-12-04,1021
5371,中光電,29,13,16,合庫-台中,2024-12-04,1021
00926,凱基全球菁英55,14,0,14,合庫-台中,2024-12-04,1021
2884,玉山金,19,5,14,合庫-台中,2024-12-04,1021
2609,陽明,399,33,366,合庫-台中,2024-12-05,1021
2367,燿華,262,100,162,合庫-台中,2024-12-05,1021
5880,合庫金,157,2,155,合庫-台中,2024-12-05,1021
00665L,富邦�琤肭磪囓�2,264,124,140,合庫-台中,2024-12-05,1021
00919,群益台灣精選高息,160,21,139,合庫-台中,2024-12-05,1021
9105,泰金寶-DR,130,4,126,合庫-台中,2024-12-05,1021
4406,新昕纖,109,0,109,合庫-台中,2024-12-05,1021
1314,中石化,100,0,100,合庫-台中,2024-12-05,1021
00715L,期街口布蘭特正2,93,0,93,合庫-台中,2024-12-05,1021
6558,興能高,161,75,86,合庫-台中,2024-12-05,1021
1815,富喬,431,349,82,合庫-台中,2024-12-05,1021
2615,萬海,80,4,76,合庫-台中,2024-12-05,1021
00918,大華優利高填息30,94,19,75,合庫-台中,2024-12-05,1021
4729,熒茂,66,3,63,合庫-台中,2024-12-05,1021
8171,天宇,71,15,56,合庫-台中,2024-12-05,1021
3059,華晶科,51,4,47,合庫-台中,2024-12-05,1021
2489,瑞軒,44,3,41,合庫-台中,2024-12-05,1021
2303,聯電,66,26,40,合庫-台中,2024-12-05,1021
2353,宏��,40,1,39,合庫-台中,2024-12-05,1021
3706,神達,171,134,37,合庫-台中,2024-12-05,1021
00713,元大台灣高息低波,38,2,36,合庫-台中,2024-12-05,1021
6127,九豪,46,12,34,合庫-台中,2024-12-05,1021
3211,順達,114,80,34,合庫-台中,2024-12-05,1021
3090,日電貿,112,81,31,合庫-台中,2024-12-05,1021
4510,高鋒,38,7,31,合庫-台中,2024-12-05,1021
8176,智捷,31,0,31,合庫-台中,2024-12-05,1021
6706,惠特,68,38,30,合庫-台中,2024-12-05,1021
2359,所羅門,30,0,30,合庫-台中,2024-12-05,1021
00887,永豐中國科技50大,28,0,28,合庫-台中,2024-12-05,1021
4931,新盛力,122,94,28,合庫-台中,2024-12-05,1021
1515,力山,28,0,28,合庫-台中,2024-12-05,1021
2317,鴻海,48,22,26,合庫-台中,2024-12-05,1021
3481,群創,28,3,25,合庫-台中,2024-12-05,1021
00924,復華S＆P500成長,25,0,25,合庫-台中,2024-12-05,1021
4979,華星光,71,47,24,合庫-台中,2024-12-05,1021
2002,中鋼,25,2,23,合庫-台中,2024-12-05,1021
5483,中美晶,23,1,22,合庫-台中,2024-12-05,1021
2399,映泰,35,13,22,合庫-台中,2024-12-05,1021
5243,乙盛-KY,42,20,22,合庫-台中,2024-12-05,1021
2547,日勝生,22,0,22,合庫-台中,2024-12-05,1021
1305,華夏,21,0,21,合庫-台中,2024-12-05,1021
5438,東友,62,41,21,合庫-台中,2024-12-05,1021
00930,永豐ESG低碳高息,20,0,20,合庫-台中,2024-12-05,1021
00953B,群益優選非投等債,20,0,20,合庫-台中,2024-12-05,1021
00965,元大航太防衛科技,20,0,20,合庫-台中,2024-12-05,1021
1722,台肥,20,0,20,合庫-台中,2024-12-05,1021
6530,創威,22,2,20,合庫-台中,2024-12-05,1021
1528,恩德,30,10,20,合庫-台中,2024-12-05,1021
1785,光洋科,56,37,19,合庫-台中,2024-12-05,1021
1301,台塑,21,2,19,合庫-台中,2024-12-05,1021
9105,泰金寶-DR,567,10,557,合庫-台中,2024-12-06,1021
00715L,期街口布蘭特正2,385,50,335,合庫-台中,2024-12-06,1021
1909,榮成,167,0,167,合庫-台中,2024-12-06,1021
00953B,群益優選非投等債,125,0,125,合庫-台中,2024-12-06,1021
00919,群益台灣精選高息,131,16,115,合庫-台中,2024-12-06,1021
2337,旺宏,147,51,96,合庫-台中,2024-12-06,1021
3706,神達,440,378,62,合庫-台中,2024-12-06,1021
2354,鴻準,233,175,58,合庫-台中,2024-12-06,1021
2317,鴻海,66,12,54,合庫-台中,2024-12-06,1021
5202,力新,91,38,53,合庫-台中,2024-12-06,1021
00933B,國泰10Y+金融債,50,0,50,合庫-台中,2024-12-06,1021
2610,華航,77,28,49,合庫-台中,2024-12-06,1021
2363,矽統,49,4,45,合庫-台中,2024-12-06,1021
2429,銘旺科,44,0,44,合庫-台中,2024-12-06,1021
2399,映泰,90,47,43,合庫-台中,2024-12-06,1021
00753L,中信中國50正2,58,20,38,合庫-台中,2024-12-06,1021
8033,雷虎,43,6,37,合庫-台中,2024-12-06,1021
4743,合一,39,5,34,合庫-台中,2024-12-06,1021
00708L,期元大S＆P黃金正2,50,17,33,合庫-台中,2024-12-06,1021
00713,元大台灣高息低波,34,2,32,合庫-台中,2024-12-06,1021
4729,熒茂,34,3,31,合庫-台中,2024-12-06,1021
00918,大華優利高填息30,35,5,30,合庫-台中,2024-12-06,1021
1605,華新,30,0,30,合庫-台中,2024-12-06,1021
00655L,國泰中國A50正2,38,8,30,合庫-台中,2024-12-06,1021
5014,建錩,30,0,30,合庫-台中,2024-12-06,1021
2486,一詮,32,5,27,合庫-台中,2024-12-06,1021
2888,新光金,30,3,27,合庫-台中,2024-12-06,1021
5309,系統電,35,10,25,合庫-台中,2024-12-06,1021
8069,元太,25,0,25,合庫-台中,2024-12-06,1021
6173,信昌電,24,1,23,合庫-台中,2024-12-06,1021
2312,金寶,45,23,22,合庫-台中,2024-12-06,1021
3054,立萬利,20,0,20,合庫-台中,2024-12-06,1021
00676R,富邦臺灣加權反1,23,3,20,合庫-台中,2024-12-06,1021
2641,正德,21,2,19,合庫-台中,2024-12-06,1021
6257,矽格,20,1,19,合庫-台中,2024-12-06,1021
00909,國泰數位支付服務,22,4,18,合庫-台中,2024-12-06,1021
00941,中信上游半導體,17,0,17,合庫-台中,2024-12-06,1021
1303,南亞,19,3,16,合庫-台中,2024-12-06,1021
5521,工信,15,0,15,合庫-台中,2024-12-06,1021
1316,上曜,15,0,15,合庫-台中,2024-12-06,1021
3043,科風,17,2,15,合庫-台中,2024-12-06,1021
3032,偉訓,28,15,13,合庫-台中,2024-12-06,1021
00965,元大航太防衛科技,13,0,13,合庫-台中,2024-12-06,1021
2892,第一金,13,0,13,合庫-台中,2024-12-06,1021
2375,凱美,31,19,12,合庫-台中,2024-12-06,1021
3265,台星科,15,3,12,合庫-台中,2024-12-06,1021
1528,恩德,32,20,12,合庫-台中,2024-12-06,1021
8930,青鋼,12,0,12,合庫-台中,2024-12-06,1021
00712,復華富時不動產,12,0,12,合庫-台中,2024-12-06,1021
2454,聯發科,12,1,11,合庫-台中,2024-12-06,1021
00715L,期街口布蘭特正2,375,2,373,合庫-台中,2024-12-09,1021
9105,泰金寶-DR,241,3,238,合庫-台中,2024-12-09,1021
1216,統一,201,0,201,合庫-台中,2024-12-09,1021
00953B,群益優選非投等債,145,0,145,合庫-台中,2024-12-09,1021
00637L,元大滬深300正2,283,181,102,合庫-台中,2024-12-09,1021
00918,大華優利高填息30,95,10,85,合庫-台中,2024-12-09,1021
0056,元大高股息,96,14,82,合庫-台中,2024-12-09,1021
6243,迅杰,67,4,63,合庫-台中,2024-12-09,1021
6142,友勁,60,1,59,合庫-台中,2024-12-09,1021
6282,康舒,65,9,56,合庫-台中,2024-12-09,1021
2887,台新金,60,10,50,合庫-台中,2024-12-09,1021
00915,凱基優選高股息30,54,5,49,合庫-台中,2024-12-09,1021
2615,萬海,180,132,48,合庫-台中,2024-12-09,1021
2354,鴻準,197,151,46,合庫-台中,2024-12-09,1021
00951,台新日本半導體,45,0,45,合庫-台中,2024-12-09,1021
2809,京城銀,45,0,45,合庫-台中,2024-12-09,1021
4729,熒茂,45,0,45,合庫-台中,2024-12-09,1021
00713,元大台灣高息低波,46,4,42,合庫-台中,2024-12-09,1021
2317,鴻海,56,15,41,合庫-台中,2024-12-09,1021
00907,永豐優息存股,34,0,34,合庫-台中,2024-12-09,1021
2449,京元電子,35,2,33,合庫-台中,2024-12-09,1021
3607,谷崧,33,1,32,合庫-台中,2024-12-09,1021
1584,精剛,60,30,30,合庫-台中,2024-12-09,1021
6684,安格,32,3,29,合庫-台中,2024-12-09,1021
2363,矽統,45,16,29,合庫-台中,2024-12-09,1021
1815,富喬,65,36,29,合庫-台中,2024-12-09,1021
1909,榮成,33,4,29,合庫-台中,2024-12-09,1021
00882,中信中國高股息,37,9,28,合庫-台中,2024-12-09,1021
2409,友達,29,2,27,合庫-台中,2024-12-09,1021
2455,全新,33,6,27,合庫-台中,2024-12-09,1021
3234,光環,47,22,25,合庫-台中,2024-12-09,1021
3211,順達,53,29,24,合庫-台中,2024-12-09,1021
2002,中鋼,26,3,23,合庫-台中,2024-12-09,1021
8928,鉅明,23,0,23,合庫-台中,2024-12-09,1021
4406,新昕纖,22,0,22,合庫-台中,2024-12-09,1021
5309,系統電,24,2,22,合庫-台中,2024-12-09,1021
00932,兆豐永續高息等權,22,1,21,合庫-台中,2024-12-09,1021
3035,智原,27,6,21,合庫-台中,2024-12-09,1021
2349,錸德,28,8,20,合庫-台中,2024-12-09,1021
2441,超豐,20,0,20,合庫-台中,2024-12-09,1021
3050,鈺德,20,0,20,合庫-台中,2024-12-09,1021
3037,欣興,24,4,20,合庫-台中,2024-12-09,1021
6139,亞翔,30,11,19,合庫-台中,2024-12-09,1021
8104,錸寶,18,0,18,合庫-台中,2024-12-09,1021
00900,富邦特選高股息30,18,0,18,合庫-台中,2024-12-09,1021
2457,飛宏,18,1,17,合庫-台中,2024-12-09,1021
4303,信立,17,0,17,合庫-台中,2024-12-09,1021
1605,華新,67,51,16,合庫-台中,2024-12-09,1021
1595,川寶,32,17,15,合庫-台中,2024-12-09,1021
1708,東鹼,15,0,15,合庫-台中,2024-12-09,1021
00680L,元大美債20正2,456,0,456,合庫-台中,2024-12-10,1021
5907,大洋-KY,205,11,194,合庫-台中,2024-12-10,1021
00918,大華優利高填息30,187,1,186,合庫-台中,2024-12-10,1021
2812,台中銀,157,1,156,合庫-台中,2024-12-10,1021
00637L,元大滬深300正2,1527,1410,117,合庫-台中,2024-12-10,1021
00882,中信中國高股息,191,80,111,合庫-台中,2024-12-10,1021
1314,中石化,110,0,110,合庫-台中,2024-12-10,1021
2367,燿華,105,6,99,合庫-台中,2024-12-10,1021
00715L,期街口布蘭特正2,111,17,94,合庫-台中,2024-12-10,1021
00665L,富邦�琤肭磪囓�2,385,293,92,合庫-台中,2024-12-10,1021
2317,鴻海,118,31,87,合庫-台中,2024-12-10,1021
2609,陽明,462,380,82,合庫-台中,2024-12-10,1021
00953B,群益優選非投等債,72,0,72,合庫-台中,2024-12-10,1021
00919,群益台灣精選高息,77,18,59,合庫-台中,2024-12-10,1021
9105,泰金寶-DR,56,0,56,合庫-台中,2024-12-10,1021
00878,國泰永續高股息,69,18,51,合庫-台中,2024-12-10,1021
1449,佳和,87,37,50,合庫-台中,2024-12-10,1021
00650L,復華香港正2,140,91,49,合庫-台中,2024-12-10,1021
9136,巨騰-DR,104,65,39,合庫-台中,2024-12-10,1021
00679B,元大美債20年,59,27,32,合庫-台中,2024-12-10,1021
6128,上福,30,0,30,合庫-台中,2024-12-10,1021
2354,鴻準,121,91,30,合庫-台中,2024-12-10,1021
2002,中鋼,43,14,29,合庫-台中,2024-12-10,1021
1815,富喬,75,50,25,合庫-台中,2024-12-10,1021
6462,神盾,26,2,24,合庫-台中,2024-12-10,1021
1605,華新,115,91,24,合庫-台中,2024-12-10,1021
2618,長榮航,34,10,24,合庫-台中,2024-12-10,1021
2449,京元電子,27,3,24,合庫-台中,2024-12-10,1021
2382,廣達,34,12,22,合庫-台中,2024-12-10,1021
2615,萬海,27,5,22,合庫-台中,2024-12-10,1021
2344,華邦電,28,6,22,合庫-台中,2024-12-10,1021
0056,元大高股息,43,21,22,合庫-台中,2024-12-10,1021
2845,遠東銀,22,0,22,合庫-台中,2024-12-10,1021
2477,美隆電,23,1,22,合庫-台中,2024-12-10,1021
3481,群創,31,10,21,合庫-台中,2024-12-10,1021
4123,晟德,21,1,20,合庫-台中,2024-12-10,1021
4991,環宇-KY,22,2,20,合庫-台中,2024-12-10,1021
8936,國統,21,1,20,合庫-台中,2024-12-10,1021
3710,連展投控,20,1,19,合庫-台中,2024-12-10,1021
3025,星通,30,12,18,合庫-台中,2024-12-10,1021
4406,新昕纖,18,0,18,合庫-台中,2024-12-10,1021
2402,毅嘉,16,0,16,合庫-台中,2024-12-10,1021
8054,安國,45,29,16,合庫-台中,2024-12-10,1021
1611,中電,15,0,15,合庫-台中,2024-12-10,1021
00881,國泰台灣5G+,16,1,15,合庫-台中,2024-12-10,1021
3576,聯合再生,15,0,15,合庫-台中,2024-12-10,1021
3293,鈊象,14,0,14,合庫-台中,2024-12-10,1021
8112,至上,14,0,14,合庫-台中,2024-12-10,1021
2444,兆勁,30,16,14,合庫-台中,2024-12-10,1021
2405,輔信,14,0,14,合庫-台中,2024-12-10,1021
00637L,元大滬深300正2,406,171,235,合庫-台中,2024-12-11,1021
00680L,元大美債20正2,201,0,201,合庫-台中,2024-12-11,1021
2367,燿華,202,4,198,合庫-台中,2024-12-11,1021
00919,群益台灣精選高息,207,26,181,合庫-台中,2024-12-11,1021
6770,力積電,156,8,148,合庫-台中,2024-12-11,1021
00918,大華優利高填息30,219,81,138,合庫-台中,2024-12-11,1021
5328,華容,110,6,104,合庫-台中,2024-12-11,1021
2317,鴻海,109,39,70,合庫-台中,2024-12-11,1021
2888,新光金,70,3,67,合庫-台中,2024-12-11,1021
2303,聯電,80,13,67,合庫-台中,2024-12-11,1021
1785,光洋科,100,36,64,合庫-台中,2024-12-11,1021
0056,元大高股息,53,0,53,合庫-台中,2024-12-11,1021
2812,台中銀,53,0,53,合庫-台中,2024-12-11,1021
00664R,國泰臺灣加權反1,50,0,50,合庫-台中,2024-12-11,1021
1540,喬福,47,0,47,合庫-台中,2024-12-11,1021
5202,力新,46,0,46,合庫-台中,2024-12-11,1021
2344,華邦電,77,32,45,合庫-台中,2024-12-11,1021
2002,中鋼,41,0,41,合庫-台中,2024-12-11,1021
8096,擎亞,43,2,41,合庫-台中,2024-12-11,1021
00915,凱基優選高股息30,59,20,39,合庫-台中,2024-12-11,1021
4729,熒茂,39,1,38,合庫-台中,2024-12-11,1021
00688L,國泰20年美債正2,36,0,36,合庫-台中,2024-12-11,1021
2363,矽統,45,9,36,合庫-台中,2024-12-11,1021
00713,元大台灣高息低波,42,7,35,合庫-台中,2024-12-11,1021
2382,廣達,52,17,35,合庫-台中,2024-12-11,1021
2337,旺宏,35,0,35,合庫-台中,2024-12-11,1021
6706,惠特,34,2,32,合庫-台中,2024-12-11,1021
1584,精剛,65,35,30,合庫-台中,2024-12-11,1021
3231,緯創,38,9,29,合庫-台中,2024-12-11,1021
9905,大華,26,0,26,合庫-台中,2024-12-11,1021
1536,和大,26,0,26,合庫-台中,2024-12-11,1021
6187,萬潤,30,5,25,合庫-台中,2024-12-11,1021
4909,新復興,47,23,24,合庫-台中,2024-12-11,1021
4931,新盛力,86,62,24,合庫-台中,2024-12-11,1021
2201,裕隆,26,2,24,合庫-台中,2024-12-11,1021
1301,台塑,25,2,23,合庫-台中,2024-12-11,1021
2610,華航,28,7,21,合庫-台中,2024-12-11,1021
00679B,元大美債20年,32,12,20,合庫-台中,2024-12-11,1021
2617,台航,20,0,20,合庫-台中,2024-12-11,1021
1605,華新,20,1,19,合庫-台中,2024-12-11,1021
1595,川寶,50,31,19,合庫-台中,2024-12-11,1021
2103,台橡,18,0,18,合庫-台中,2024-12-11,1021
6443,元晶,32,15,17,合庫-台中,2024-12-11,1021
6128,上福,17,0,17,合庫-台中,2024-12-11,1021
2609,陽明,68,51,17,合庫-台中,2024-12-11,1021
1326,台化,59,42,17,合庫-台中,2024-12-11,1021
1303,南亞,18,1,17,合庫-台中,2024-12-11,1021
00887,永豐中國科技50大,53,37,16,合庫-台中,2024-12-11,1021
8249,菱光,29,13,16,合庫-台中,2024-12-11,1021
2330,台積電,17,1,16,合庫-台中,2024-12-11,1021
3231,緯創,509,22,487,合庫-台中,2024-12-12,1021
00918,大華優利高填息30,252,0,252,合庫-台中,2024-12-12,1021
00687B,國泰20年美債,251,20,231,合庫-台中,2024-12-12,1021
2303,聯電,349,136,213,合庫-台中,2024-12-12,1021
2834,臺企銀,200,1,199,合庫-台中,2024-12-12,1021
00673R,期元大S＆P原油反1,165,0,165,合庫-台中,2024-12-12,1021
00676R,富邦臺灣加權反1,108,0,108,合庫-台中,2024-12-12,1021
2367,燿華,101,1,100,合庫-台中,2024-12-12,1021
3706,神達,179,99,80,合庫-台中,2024-12-12,1021
00937B,群益ESG投等債20,69,0,69,合庫-台中,2024-12-12,1021
2317,鴻海,92,24,68,合庫-台中,2024-12-12,1021
00680L,元大美債20正2,225,158,67,合庫-台中,2024-12-12,1021
00751B,元大AAA至A公司債,57,0,57,合庫-台中,2024-12-12,1021
00915,凱基優選高股息30,60,4,56,合庫-台中,2024-12-12,1021
6770,力積電,56,6,50,合庫-台中,2024-12-12,1021
00679B,元大美債20年,52,11,41,合庫-台中,2024-12-12,1021
2344,華邦電,57,17,40,合庫-台中,2024-12-12,1021
2328,廣宇,57,20,37,合庫-台中,2024-12-12,1021
3363,上詮,83,52,31,合庫-台中,2024-12-12,1021
6016,康和證,30,0,30,合庫-台中,2024-12-12,1021
00664R,國泰臺灣加權反1,30,0,30,合庫-台中,2024-12-12,1021
1303,南亞,29,3,26,合庫-台中,2024-12-12,1021
2449,京元電子,29,5,24,合庫-台中,2024-12-12,1021
2455,全新,38,14,24,合庫-台中,2024-12-12,1021
1301,台塑,39,15,24,合庫-台中,2024-12-12,1021
2609,陽明,270,247,23,合庫-台中,2024-12-12,1021
2354,鴻準,59,36,23,合庫-台中,2024-12-12,1021
6505,台塑化,21,0,21,合庫-台中,2024-12-12,1021
2342,茂矽,21,0,21,合庫-台中,2024-12-12,1021
8096,擎亞,21,0,21,合庫-台中,2024-12-12,1021
3062,建漢,29,8,21,合庫-台中,2024-12-12,1021
6197,佳必琪,20,0,20,合庫-台中,2024-12-12,1021
00919,群益台灣精選高息,44,25,19,合庫-台中,2024-12-12,1021
00712,復華富時不動產,20,0,20,合庫-台中,2024-12-12,1021
3207,耀勝,21,2,19,合庫-台中,2024-12-12,1021
2405,輔信,19,0,19,合庫-台中,2024-12-12,1021
2002,中鋼,19,0,19,合庫-台中,2024-12-12,1021
4406,新昕纖,18,0,18,合庫-台中,2024-12-12,1021
00795B,中信美國公債20年,18,0,18,合庫-台中,2024-12-12,1021
00922,國泰台灣領袖50,17,1,16,合庫-台中,2024-12-12,1021
1815,富喬,40,24,16,合庫-台中,2024-12-12,1021
9905,大華,16,0,16,合庫-台中,2024-12-12,1021
6757,台灣虎航,17,2,15,合庫-台中,2024-12-12,1021
4979,華星光,97,82,15,合庫-台中,2024-12-12,1021
3029,零壹,87,73,14,合庫-台中,2024-12-12,1021
4510,高鋒,35,22,13,合庫-台中,2024-12-12,1021
2365,昆盈,21,8,13,合庫-台中,2024-12-12,1021
6558,興能高,38,25,13,合庫-台中,2024-12-12,1021
3694,海華,17,4,13,合庫-台中,2024-12-12,1021
1708,東鹼,15,2,13,合庫-台中,2024-12-12,1021
00887,永豐中國科技50大,414,100,314,合庫-台中,2024-12-13,1021
00919,群益台灣精選高息,268,12,256,合庫-台中,2024-12-13,1021
00937B,群益ESG投等債20,321,83,238,合庫-台中,2024-12-13,1021
00918,大華優利高填息30,188,0,188,合庫-台中,2024-12-13,1021
2834,臺企銀,158,1,157,合庫-台中,2024-12-13,1021
2634,漢翔,155,1,154,合庫-台中,2024-12-13,1021
2609,陽明,204,68,136,合庫-台中,2024-12-13,1021
00712,復華富時不動產,124,0,124,合庫-台中,2024-12-13,1021
1785,光洋科,232,111,121,合庫-台中,2024-12-13,1021
2812,台中銀,115,1,114,合庫-台中,2024-12-13,1021
2887,台新金,106,0,106,合庫-台中,2024-12-13,1021
00673R,期元大S＆P原油反1,100,0,100,合庫-台中,2024-12-13,1021
2303,聯電,139,44,95,合庫-台中,2024-12-13,1021
00915,凱基優選高股息30,76,0,76,合庫-台中,2024-12-13,1021
2002,中鋼,77,5,72,合庫-台中,2024-12-13,1021
2489,瑞軒,59,0,59,合庫-台中,2024-12-13,1021
00665L,富邦�琤肭磪囓�2,114,55,59,合庫-台中,2024-12-13,1021
00751B,元大AAA至A公司債,57,0,57,合庫-台中,2024-12-13,1021
6116,彩晶,52,0,52,合庫-台中,2024-12-13,1021
2618,長榮航,61,9,52,合庫-台中,2024-12-13,1021
00676R,富邦臺灣加權反1,50,0,50,合庫-台中,2024-12-13,1021
2354,鴻準,120,70,50,合庫-台中,2024-12-13,1021
8096,擎亞,47,0,47,合庫-台中,2024-12-13,1021
0056,元大高股息,53,8,45,合庫-台中,2024-12-13,1021
8042,金山電,40,0,40,合庫-台中,2024-12-13,1021
2317,鴻海,115,75,40,合庫-台中,2024-12-13,1021
2338,光罩,41,1,40,合庫-台中,2024-12-13,1021
2610,華航,37,2,35,合庫-台中,2024-12-13,1021
00878,國泰永續高股息,42,11,31,合庫-台中,2024-12-13,1021
2062,橋椿,31,0,31,合庫-台中,2024-12-13,1021
3019,亞光,79,49,30,合庫-台中,2024-12-13,1021
3013,晟銘電,61,32,29,合庫-台中,2024-12-13,1021
5880,合庫金,35,6,29,合庫-台中,2024-12-13,1021
1326,台化,68,40,28,合庫-台中,2024-12-13,1021
3710,連展投控,30,2,28,合庫-台中,2024-12-13,1021
00795B,中信美國公債20年,28,0,28,合庫-台中,2024-12-13,1021
3712,永崴投控,25,0,25,合庫-台中,2024-12-13,1021
4956,光鋐,26,1,25,合庫-台中,2024-12-13,1021
3062,建漢,29,4,25,合庫-台中,2024-12-13,1021
2603,長榮,37,14,23,合庫-台中,2024-12-13,1021
2363,矽統,35,13,22,合庫-台中,2024-12-13,1021
3041,揚智,40,18,22,合庫-台中,2024-12-13,1021
1718,中纖,21,0,21,合庫-台中,2024-12-13,1021
3594,磐儀,25,5,20,合庫-台中,2024-12-13,1021
1810,和成,20,0,20,合庫-台中,2024-12-13,1021
6248,沛波,20,0,20,合庫-台中,2024-12-13,1021
2353,宏��,33,13,20,合庫-台中,2024-12-13,1021
00900,富邦特選高股息30,20,0,20,合庫-台中,2024-12-13,1021
3481,群創,27,8,19,合庫-台中,2024-12-13,1021
8039,台虹,22,3,19,合庫-台中,2024-12-13,1021
2887,台新金,400,7,393,合庫-台中,2024-12-16,1021
00918,大華優利高填息30,264,0,264,合庫-台中,2024-12-16,1021
00664R,國泰臺灣加權反1,235,0,235,合庫-台中,2024-12-16,1021
00919,群益台灣精選高息,264,40,224,合庫-台中,2024-12-16,1021
00673R,期元大S＆P原油反1,163,0,163,合庫-台中,2024-12-16,1021
2609,陽明,195,40,155,合庫-台中,2024-12-16,1021
1314,中石化,109,10,99,合庫-台中,2024-12-16,1021
0056,元大高股息,93,2,91,合庫-台中,2024-12-16,1021
00679B,元大美債20年,89,0,89,合庫-台中,2024-12-16,1021
2486,一詮,93,6,87,合庫-台中,2024-12-16,1021
2002,中鋼,97,11,86,合庫-台中,2024-12-16,1021
00937B,群益ESG投等債20,71,1,70,合庫-台中,2024-12-16,1021
00687B,國泰20年美債,73,5,68,合庫-台中,2024-12-16,1021
00637L,元大滬深300正2,206,140,66,合庫-台中,2024-12-16,1021
00948B,中信優息投資級債,55,0,55,合庫-台中,2024-12-16,1021
00688L,國泰20年美債正2,52,0,52,合庫-台中,2024-12-16,1021
4114,健喬,47,1,46,合庫-台中,2024-12-16,1021
00665L,富邦�琤肭磪囓�2,90,49,41,合庫-台中,2024-12-16,1021
2317,鴻海,140,99,41,合庫-台中,2024-12-16,1021
6885,全福生技,38,2,36,合庫-台中,2024-12-16,1021
2349,錸德,35,0,35,合庫-台中,2024-12-16,1021
4540,全球傳動,58,25,33,合庫-台中,2024-12-16,1021
6706,惠特,58,25,33,合庫-台中,2024-12-16,1021
2367,燿華,32,0,32,合庫-台中,2024-12-16,1021
4908,前鼎,31,0,31,合庫-台中,2024-12-16,1021
3607,谷崧,31,1,30,合庫-台中,2024-12-16,1021
2867,三商壽,39,10,29,合庫-台中,2024-12-16,1021
3035,智原,48,19,29,合庫-台中,2024-12-16,1021
3169,亞信,40,12,28,合庫-台中,2024-12-16,1021
3231,緯創,53,25,28,合庫-台中,2024-12-16,1021
00795B,中信美國公債20年,27,1,26,合庫-台中,2024-12-16,1021
00751B,元大AAA至A公司債,25,0,25,合庫-台中,2024-12-16,1021
2338,光罩,24,0,24,合庫-台中,2024-12-16,1021
2449,京元電子,46,23,23,合庫-台中,2024-12-16,1021
00706L,期元大S＆P日圓正2,22,0,22,合庫-台中,2024-12-16,1021
2363,矽統,41,20,21,合庫-台中,2024-12-16,1021
6248,沛波,21,0,21,合庫-台中,2024-12-16,1021
1434,福懋,21,0,21,合庫-台中,2024-12-16,1021
2834,臺企銀,20,0,20,合庫-台中,2024-12-16,1021
4739,康普,20,0,20,合庫-台中,2024-12-16,1021
6128,上福,20,0,20,合庫-台中,2024-12-16,1021
4406,新昕纖,20,0,20,合庫-台中,2024-12-16,1021
2382,廣達,47,27,20,合庫-台中,2024-12-16,1021
2354,鴻準,84,65,19,合庫-台中,2024-12-16,1021
00632R,元大台灣50反1,18,0,18,合庫-台中,2024-12-16,1021
2886,兆豐金,20,2,18,合庫-台中,2024-12-16,1021
8039,台虹,35,17,18,合庫-台中,2024-12-16,1021
00713,元大台灣高息低波,19,2,17,合庫-台中,2024-12-16,1021
00728,第一金工業30,17,0,17,合庫-台中,2024-12-16,1021
3625,西勝,16,0,16,合庫-台中,2024-12-16,1021
00937B,群益ESG投等債20,2028,42,1986,合庫-台中,2024-12-17,1021
00679B,元大美債20年,919,111,808,合庫-台中,2024-12-17,1021
2033,佳大,646,0,646,合庫-台中,2024-12-17,1021
00857B,永豐20年美公債,406,0,406,合庫-台中,2024-12-17,1021
2317,鴻海,276,56,220,合庫-台中,2024-12-17,1021
2303,聯電,307,115,192,合庫-台中,2024-12-17,1021
0056,元大高股息,179,3,176,合庫-台中,2024-12-17,1021
00918,大華優利高填息30,135,4,131,合庫-台中,2024-12-17,1021
5880,合庫金,150,27,123,合庫-台中,2024-12-17,1021
2409,友達,122,0,122,合庫-台中,2024-12-17,1021
9105,泰金寶-DR,225,116,109,合庫-台中,2024-12-17,1021
2609,陽明,156,55,101,合庫-台中,2024-12-17,1021
1314,中石化,107,10,97,合庫-台中,2024-12-17,1021
00915,凱基優選高股息30,95,5,90,合庫-台中,2024-12-17,1021
2323,中環,100,20,80,合庫-台中,2024-12-17,1021
2374,佳能,206,130,76,合庫-台中,2024-12-17,1021
3481,群創,67,1,66,合庫-台中,2024-12-17,1021
2801,彰銀,217,153,64,合庫-台中,2024-12-17,1021
00680L,元大美債20正2,60,0,60,合庫-台中,2024-12-17,1021
00713,元大台灣高息低波,57,3,54,合庫-台中,2024-12-17,1021
00887,永豐中國科技50大,52,0,52,合庫-台中,2024-12-17,1021
2812,台中銀,52,2,50,合庫-台中,2024-12-17,1021
2002,中鋼,45,0,45,合庫-台中,2024-12-17,1021
00687B,國泰20年美債,42,0,42,合庫-台中,2024-12-17,1021
2408,南亞科,74,34,40,合庫-台中,2024-12-17,1021
00919,群益台灣精選高息,296,257,39,合庫-台中,2024-12-17,1021
2646,星宇航空,42,6,36,合庫-台中,2024-12-17,1021
6188,廣明,92,59,33,合庫-台中,2024-12-17,1021
8249,菱光,85,53,32,合庫-台中,2024-12-17,1021
3085,新零售,31,0,31,合庫-台中,2024-12-17,1021
2884,玉山金,46,15,31,合庫-台中,2024-12-17,1021
2365,昆盈,33,3,30,合庫-台中,2024-12-17,1021
00753L,中信中國50正2,67,38,29,合庫-台中,2024-12-17,1021
2301,光寶科,28,0,28,合庫-台中,2024-12-17,1021
00900,富邦特選高股息30,25,0,25,合庫-台中,2024-12-17,1021
2062,橋椿,51,27,24,合庫-台中,2024-12-17,1021
2417,圓剛,43,19,24,合庫-台中,2024-12-17,1021
00706L,期元大S＆P日圓正2,21,0,21,合庫-台中,2024-12-17,1021
1718,中纖,21,0,21,合庫-台中,2024-12-17,1021
2382,廣達,29,9,20,合庫-台中,2024-12-17,1021
2449,京元電子,34,14,20,合庫-台中,2024-12-17,1021
9907,統一實,20,0,20,合庫-台中,2024-12-17,1021
3710,連展投控,20,0,20,合庫-台中,2024-12-17,1021
3576,聯合再生,20,0,20,合庫-台中,2024-12-17,1021
2109,華豐,20,0,20,合庫-台中,2024-12-17,1021
1810,和成,20,0,20,合庫-台中,2024-12-17,1021
2455,全新,35,15,20,合庫-台中,2024-12-17,1021
2886,兆豐金,21,2,19,合庫-台中,2024-12-17,1021
4541,晟田,21,2,19,合庫-台中,2024-12-17,1021
00665L,富邦�琤肭磪囓�2,133,116,17,合庫-台中,2024-12-17,1021
00680L,元大美債20正2,206,0,206,合庫-台中,2024-12-18,1021
00676R,富邦臺灣加權反1,136,0,136,合庫-台中,2024-12-18,1021
00715L,期街口布蘭特正2,111,0,111,合庫-台中,2024-12-18,1021
4533,協易機,108,7,101,合庫-台中,2024-12-18,1021
2354,鴻準,98,9,89,合庫-台中,2024-12-18,1021
1314,中石化,74,0,74,合庫-台中,2024-12-18,1021
2062,橋椿,91,20,71,合庫-台中,2024-12-18,1021
2312,金寶,93,24,69,合庫-台中,2024-12-18,1021
5871,中租-KY,67,2,65,合庫-台中,2024-12-18,1021
00712,復華富時不動產,61,2,59,合庫-台中,2024-12-18,1021
00887,永豐中國科技50大,119,64,55,合庫-台中,2024-12-18,1021
2618,長榮航,144,93,51,合庫-台中,2024-12-18,1021
2002,中鋼,50,2,48,合庫-台中,2024-12-18,1021
00878,國泰永續高股息,44,2,42,合庫-台中,2024-12-18,1021
5880,合庫金,61,21,40,合庫-台中,2024-12-18,1021
00713,元大台灣高息低波,38,2,36,合庫-台中,2024-12-18,1021
00687B,國泰20年美債,33,0,33,合庫-台中,2024-12-18,1021
5202,力新,35,5,30,合庫-台中,2024-12-18,1021
0056,元大高股息,47,18,29,合庫-台中,2024-12-18,1021
00945B,凱基美國非投等債,35,7,28,合庫-台中,2024-12-18,1021
6188,廣明,27,0,27,合庫-台中,2024-12-18,1021
2890,永豐金,26,0,26,合庫-台中,2024-12-18,1021
2486,一詮,32,7,25,合庫-台中,2024-12-18,1021
2303,聯電,71,46,25,合庫-台中,2024-12-18,1021
4976,佳凌,25,1,24,合庫-台中,2024-12-18,1021
3323,加百裕,45,23,22,合庫-台中,2024-12-18,1021
2356,英業達,25,4,21,合庫-台中,2024-12-18,1021
2886,兆豐金,21,0,21,合庫-台中,2024-12-18,1021
00662,富邦NASDAQ,20,0,20,合庫-台中,2024-12-18,1021
00959B,大華投等美債15Y+,20,0,20,合庫-台中,2024-12-18,1021
2014,中鴻,20,3,17,合庫-台中,2024-12-18,1021
2408,南亞科,39,22,17,合庫-台中,2024-12-18,1021
4729,熒茂,17,0,17,合庫-台中,2024-12-18,1021
00757,統一FANG+,17,0,17,合庫-台中,2024-12-18,1021
5483,中美晶,17,1,16,合庫-台中,2024-12-18,1021
4979,華星光,61,46,15,合庫-台中,2024-12-18,1021
1434,福懋,15,0,15,合庫-台中,2024-12-18,1021
3231,緯創,21,6,15,合庫-台中,2024-12-18,1021
1303,南亞,19,4,15,合庫-台中,2024-12-18,1021
5438,東友,19,5,14,合庫-台中,2024-12-18,1021
5009,榮剛,16,2,14,合庫-台中,2024-12-18,1021
2317,鴻海,20,7,13,合庫-台中,2024-12-18,1021
3041,揚智,163,150,13,合庫-台中,2024-12-18,1021
2883,凱基金,12,0,12,合庫-台中,2024-12-18,1021
2332,友訊,12,0,12,合庫-台中,2024-12-18,1021
2233,宇隆,19,7,12,合庫-台中,2024-12-18,1021
8935,邦泰,12,0,12,合庫-台中,2024-12-18,1021
2349,錸德,41,30,11,合庫-台中,2024-12-18,1021
6558,興能高,35,24,11,合庫-台中,2024-12-18,1021
2478,大毅,10,0,10,合庫-台中,2024-12-18,1021
00937B,群益ESG投等債20,630,106,524,合庫-台中,2024-12-19,1021
00940,元大台灣價值高息,481,118,363,合庫-台中,2024-12-19,1021
5880,合庫金,316,20,296,合庫-台中,2024-12-19,1021
00918,大華優利高填息30,264,0,264,合庫-台中,2024-12-19,1021
00712,復華富時不動產,216,0,216,合庫-台中,2024-12-19,1021
00919,群益台灣精選高息,473,286,187,合庫-台中,2024-12-19,1021
00687B,國泰20年美債,145,6,139,合庫-台中,2024-12-19,1021
2887,台新金,138,0,138,合庫-台中,2024-12-19,1021
00878,國泰永續高股息,133,3,130,合庫-台中,2024-12-19,1021
00679B,元大美債20年,135,20,115,合庫-台中,2024-12-19,1021
2883,凱基金,112,0,112,合庫-台中,2024-12-19,1021
2409,友達,111,20,91,合庫-台中,2024-12-19,1021
2317,鴻海,120,36,84,合庫-台中,2024-12-19,1021
8249,菱光,108,36,72,合庫-台中,2024-12-19,1021
2801,彰銀,63,0,63,合庫-台中,2024-12-19,1021
00915,凱基優選高股息30,67,4,63,合庫-台中,2024-12-19,1021
2609,陽明,182,122,60,合庫-台中,2024-12-19,1021
2812,台中銀,56,0,56,合庫-台中,2024-12-19,1021
00688L,國泰20年美債正2,54,0,54,合庫-台中,2024-12-19,1021
0056,元大高股息,58,5,53,合庫-台中,2024-12-19,1021
2845,遠東銀,73,21,52,合庫-台中,2024-12-19,1021
00795B,中信美國公債20年,51,0,51,合庫-台中,2024-12-19,1021
2884,玉山金,50,0,50,合庫-台中,2024-12-19,1021
3481,群創,57,10,47,合庫-台中,2024-12-19,1021
2002,中鋼,44,0,44,合庫-台中,2024-12-19,1021
2417,圓剛,96,52,44,合庫-台中,2024-12-19,1021
6116,彩晶,40,0,40,合庫-台中,2024-12-19,1021
6558,興能高,63,24,39,合庫-台中,2024-12-19,1021
00637L,元大滬深300正2,110,73,37,合庫-台中,2024-12-19,1021
5371,中光電,40,9,31,合庫-台中,2024-12-19,1021
2458,義隆,26,0,26,合庫-台中,2024-12-19,1021
5484,慧友,26,0,26,合庫-台中,2024-12-19,1021
2408,南亞科,49,24,25,合庫-台中,2024-12-19,1021
2897,王道銀行,25,0,25,合庫-台中,2024-12-19,1021
3231,緯創,30,6,24,合庫-台中,2024-12-19,1021
2349,錸德,26,2,24,合庫-台中,2024-12-19,1021
00930,永豐ESG低碳高息,24,0,24,合庫-台中,2024-12-19,1021
6134,萬旭,22,0,22,合庫-台中,2024-12-19,1021
00945B,凱基美國非投等債,30,8,22,合庫-台中,2024-12-19,1021
00922,國泰台灣領袖50,22,0,22,合庫-台中,2024-12-19,1021
00907,永豐優息存股,21,0,21,合庫-台中,2024-12-19,1021
2886,兆豐金,24,3,21,合庫-台中,2024-12-19,1021
2486,一詮,30,9,21,合庫-台中,2024-12-19,1021
1434,福懋,21,0,21,合庫-台中,2024-12-19,1021
2371,大同,32,11,21,合庫-台中,2024-12-19,1021
2880,華南金,23,2,21,合庫-台中,2024-12-19,1021
2017,官田鋼,20,0,20,合庫-台中,2024-12-19,1021
6770,力積電,53,33,20,合庫-台中,2024-12-19,1021
5871,中租-KY,22,2,20,合庫-台中,2024-12-19,1021
2382,廣達,38,19,19,合庫-台中,2024-12-19,1021
