Ticker,Name,buy,sell,diff,Branch,Date,Branch_Code
2882,國泰金,76,5,71,亞東-新竹,2023-01-03,2184
5009,榮剛,46,0,46,亞東-新竹,2023-01-03,2184
00751B,元大AAA至A公司債,32,0,32,亞東-新竹,2023-01-03,2184
9904,寶成,31,0,31,亞東-新竹,2023-01-03,2184
4153,鈺緯,20,0,20,亞東-新竹,2023-01-03,2184
5386,青雲,32,12,20,亞東-新竹,2023-01-03,2184
00637L,元大滬深300正2,18,3,15,亞東-新竹,2023-01-03,2184
00878,國泰永續高股息,14,0,14,亞東-新竹,2023-01-03,2184
00676R,富邦臺灣加權反1,12,0,12,亞東-新竹,2023-01-03,2184
6589,台康生技,43,32,11,亞東-新竹,2023-01-03,2184
00895,富邦未來車,10,0,10,亞東-新竹,2023-01-03,2184
2884,玉山金,10,0,10,亞東-新竹,2023-01-03,2184
00650L,復華香港正2,12,4,8,亞東-新竹,2023-01-03,2184
1605,華新,26,21,5,亞東-新竹,2023-01-03,2184
1720,生達,6,1,5,亞東-新竹,2023-01-03,2184
1752,南光,51,46,5,亞東-新竹,2023-01-03,2184
00900,富邦特選高股息30,5,0,5,亞東-新竹,2023-01-03,2184
2603,長榮,9,4,5,亞東-新竹,2023-01-03,2184
2867,三商壽,5,0,5,亞東-新竹,2023-01-03,2184
3402,漢科,5,0,5,亞東-新竹,2023-01-03,2184
2317,鴻海,10,6,4,亞東-新竹,2023-01-03,2184
00679B,元大美債20年,6,2,4,亞東-新竹,2023-01-03,2184
2352,佳世達,4,0,4,亞東-新竹,2023-01-03,2184
3149,正達,4,0,4,亞東-新竹,2023-01-03,2184
3704,合勤控,10,6,4,亞東-新竹,2023-01-03,2184
9802,鈺齊-KY,4,0,4,亞東-新竹,2023-01-03,2184
2891,中信金,13,10,3,亞東-新竹,2023-01-03,2184
2347,聯強,3,0,3,亞東-新竹,2023-01-03,2184
2421,建準,3,0,3,亞東-新竹,2023-01-03,2184
4716,大立,3,0,3,亞東-新竹,2023-01-03,2184
2892,第一金,2,0,2,亞東-新竹,2023-01-03,2184
00713,元大台灣高息低波,2,0,2,亞東-新竹,2023-01-03,2184
00885,富邦越南,2,0,2,亞東-新竹,2023-01-03,2184
1524,耿鼎,6,4,2,亞東-新竹,2023-01-03,2184
2038,海光,2,0,2,亞東-新竹,2023-01-03,2184
2383,台光電,2,0,2,亞東-新竹,2023-01-03,2184
2537,聯上發,2,0,2,亞東-新竹,2023-01-03,2184
2606,裕民,2,0,2,亞東-新竹,2023-01-03,2184
2609,陽明,3,1,2,亞東-新竹,2023-01-03,2184
2727,王品,4,2,2,亞東-新竹,2023-01-03,2184
4105,東洋,2,0,2,亞東-新竹,2023-01-03,2184
4545,銘鈺,2,0,2,亞東-新竹,2023-01-03,2184
4736,泰博,2,0,2,亞東-新竹,2023-01-03,2184
6505,台塑化,2,0,2,亞東-新竹,2023-01-03,2184
6708,天擎,2,0,2,亞東-新竹,2023-01-03,2184
4743,合一,2,0,2,亞東-新竹,2023-01-03,2184
2023,燁輝,1,0,1,亞東-新竹,2023-01-03,2184
1909,榮成,1,0,1,亞東-新竹,2023-01-03,2184
1722,台肥,1,0,1,亞東-新竹,2023-01-03,2184
1721,三晃,1,0,1,亞東-新竹,2023-01-03,2184
00632R,元大台灣50反1,499,10,489,亞東-新竹,2023-01-04,2184
2882,國泰金,48,1,47,亞東-新竹,2023-01-04,2184
2317,鴻海,23,3,20,亞東-新竹,2023-01-04,2184
8234,新漢,15,0,15,亞東-新竹,2023-01-04,2184
8996,高力,20,8,12,亞東-新竹,2023-01-04,2184
00637L,元大滬深300正2,20,10,10,亞東-新竹,2023-01-04,2184
2614,東森,9,0,9,亞東-新竹,2023-01-04,2184
2636,台驊控股,9,0,9,亞東-新竹,2023-01-04,2184
2609,陽明,9,1,8,亞東-新竹,2023-01-04,2184
00676R,富邦臺灣加權反1,8,0,8,亞東-新竹,2023-01-04,2184
2615,萬海,17,9,8,亞東-新竹,2023-01-04,2184
3661,世芯-KY,17,9,8,亞東-新竹,2023-01-04,2184
2303,聯電,9,2,7,亞東-新竹,2023-01-04,2184
3293,鈊象,8,1,7,亞東-新竹,2023-01-04,2184
9945,潤泰新,7,0,7,亞東-新竹,2023-01-04,2184
4919,新唐,7,1,6,亞東-新竹,2023-01-04,2184
9958,世紀鋼,7,1,6,亞東-新竹,2023-01-04,2184
00900,富邦特選高股息30,5,0,5,亞東-新竹,2023-01-04,2184
00636,國泰中國A50,5,0,5,亞東-新竹,2023-01-04,2184
0061,元大寶滬深,5,0,5,亞東-新竹,2023-01-04,2184
3004,豐達科,5,0,5,亞東-新竹,2023-01-04,2184
3504,揚明光,9,4,5,亞東-新竹,2023-01-04,2184
00893,國泰智能電動車,4,0,4,亞東-新竹,2023-01-04,2184
00878,國泰永續高股息,4,0,4,亞東-新竹,2023-01-04,2184
2347,聯強,4,0,4,亞東-新竹,2023-01-04,2184
8222,寶一,4,0,4,亞東-新竹,2023-01-04,2184
3189,景碩,10,7,3,亞東-新竹,2023-01-04,2184
8046,南電,5,2,3,亞東-新竹,2023-01-04,2184
1701,中化,17,14,3,亞東-新竹,2023-01-04,2184
3322,建舜電,3,0,3,亞東-新竹,2023-01-04,2184
3491,昇達科,3,0,3,亞東-新竹,2023-01-04,2184
4541,晟田,4,1,3,亞東-新竹,2023-01-04,2184
8171,天宇,3,0,3,亞東-新竹,2023-01-04,2184
9802,鈺齊-KY,3,0,3,亞東-新竹,2023-01-04,2184
6806,森崴能源,6,3,3,亞東-新竹,2023-01-04,2184
2884,玉山金,2,0,2,亞東-新竹,2023-01-04,2184
3037,欣興,18,16,2,亞東-新竹,2023-01-04,2184
2206,三陽工業,2,0,2,亞東-新竹,2023-01-04,2184
00706L,期元大S＆P日圓正2,2,0,2,亞東-新竹,2023-01-04,2184
2308,台達電,3,1,2,亞東-新竹,2023-01-04,2184
2414,精技,2,0,2,亞東-新竹,2023-01-04,2184
2610,華航,2,0,2,亞東-新竹,2023-01-04,2184
2617,台航,2,0,2,亞東-新竹,2023-01-04,2184
2834,臺企銀,2,0,2,亞東-新竹,2023-01-04,2184
3034,聯詠,6,4,2,亞東-新竹,2023-01-04,2184
3060,銘異,2,0,2,亞東-新竹,2023-01-04,2184
3128,昇銳,2,0,2,亞東-新竹,2023-01-04,2184
3284,太普高,2,0,2,亞東-新竹,2023-01-04,2184
3454,晶睿,2,0,2,亞東-新竹,2023-01-04,2184
4155,訊映,2,0,2,亞東-新竹,2023-01-04,2184
00753L,中信中國50正2,35,0,35,亞東-新竹,2023-01-05,2184
2610,華航,33,16,17,亞東-新竹,2023-01-05,2184
4919,新唐,12,0,12,亞東-新竹,2023-01-05,2184
1216,統一,10,0,10,亞東-新竹,2023-01-05,2184
00893,國泰智能電動車,10,0,10,亞東-新竹,2023-01-05,2184
00878,國泰永續高股息,8,0,8,亞東-新竹,2023-01-05,2184
2317,鴻海,9,1,8,亞東-新竹,2023-01-05,2184
2419,仲琦,8,0,8,亞東-新竹,2023-01-05,2184
1909,榮成,8,1,7,亞東-新竹,2023-01-05,2184
4114,健喬,7,0,7,亞東-新竹,2023-01-05,2184
00715L,期街口布蘭特正2,6,0,6,亞東-新竹,2023-01-05,2184
2409,友達,6,0,6,亞東-新竹,2023-01-05,2184
3004,豐達科,6,0,6,亞東-新竹,2023-01-05,2184
5263,智崴,6,0,6,亞東-新竹,2023-01-05,2184
1219,福壽,5,0,5,亞東-新竹,2023-01-05,2184
1218,泰山,5,0,5,亞東-新竹,2023-01-05,2184
1301,台塑,5,0,5,亞東-新竹,2023-01-05,2184
00891,中信關鍵半導體,5,0,5,亞東-新竹,2023-01-05,2184
00862B,中信投資級公司債,5,0,5,亞東-新竹,2023-01-05,2184
2104,國際中橡,20,15,5,亞東-新竹,2023-01-05,2184
8070,長華*,5,0,5,亞東-新竹,2023-01-05,2184
1720,生達,4,0,4,亞東-新竹,2023-01-05,2184
2347,聯強,4,0,4,亞東-新竹,2023-01-05,2184
3272,東碩,7,3,4,亞東-新竹,2023-01-05,2184
3284,太普高,4,0,4,亞東-新竹,2023-01-05,2184
3293,鈊象,5,1,4,亞東-新竹,2023-01-05,2184
4147,中裕,4,0,4,亞東-新竹,2023-01-05,2184
4541,晟田,4,0,4,亞東-新竹,2023-01-05,2184
5351,鈺創,8,4,4,亞東-新竹,2023-01-05,2184
00772B,中信高評級公司債,3,0,3,亞東-新竹,2023-01-05,2184
1605,華新,20,17,3,亞東-新竹,2023-01-05,2184
2337,旺宏,3,0,3,亞東-新竹,2023-01-05,2184
3661,世芯-KY,4,1,3,亞東-新竹,2023-01-05,2184
3687,歐買尬,3,0,3,亞東-新竹,2023-01-05,2184
4129,聯合,3,0,3,亞東-新竹,2023-01-05,2184
4931,新盛力,7,4,3,亞東-新竹,2023-01-05,2184
4974,亞泰,3,0,3,亞東-新竹,2023-01-05,2184
6276,安鈦克,5,2,3,亞東-新竹,2023-01-05,2184
8046,南電,5,2,3,亞東-新竹,2023-01-05,2184
2412,中華電,3,0,3,亞東-新竹,2023-01-05,2184
1701,中化,16,14,2,亞東-新竹,2023-01-05,2184
1722,台肥,2,0,2,亞東-新竹,2023-01-05,2184
00706L,期元大S＆P日圓正2,2,0,2,亞東-新竹,2023-01-05,2184
1905,華紙,2,0,2,亞東-新竹,2023-01-05,2184
2201,裕隆,8,6,2,亞東-新竹,2023-01-05,2184
2230,泰茂,5,3,2,亞東-新竹,2023-01-05,2184
2303,聯電,8,6,2,亞東-新竹,2023-01-05,2184
2308,台達電,2,0,2,亞東-新竹,2023-01-05,2184
2328,廣宇,4,2,2,亞東-新竹,2023-01-05,2184
2612,中航,2,0,2,亞東-新竹,2023-01-05,2184
00637L,元大滬深300正2,138,9,129,亞東-新竹,2023-01-06,2184
1216,統一,55,0,55,亞東-新竹,2023-01-06,2184
2888,新光金,50,0,50,亞東-新竹,2023-01-06,2184
2104,國際中橡,40,0,40,亞東-新竹,2023-01-06,2184
1301,台塑,41,6,35,亞東-新竹,2023-01-06,2184
00751B,元大AAA至A公司債,30,6,24,亞東-新竹,2023-01-06,2184
00770,國泰北美科技,20,0,20,亞東-新竹,2023-01-06,2184
00720B,元大投資級公司債,17,0,17,亞東-新竹,2023-01-06,2184
4105,東洋,13,0,13,亞東-新竹,2023-01-06,2184
1101,台泥,12,0,12,亞東-新竹,2023-01-06,2184
4167,松瑞藥,15,3,12,亞東-新竹,2023-01-06,2184
1701,中化,29,19,10,亞東-新竹,2023-01-06,2184
1752,南光,23,14,9,亞東-新竹,2023-01-06,2184
1720,生達,11,4,7,亞東-新竹,2023-01-06,2184
3293,鈊象,8,1,7,亞東-新竹,2023-01-06,2184
4153,鈺緯,6,0,6,亞東-新竹,2023-01-06,2184
4541,晟田,6,0,6,亞東-新竹,2023-01-06,2184
6190,萬泰科,6,0,6,亞東-新竹,2023-01-06,2184
2313,華通,5,0,5,亞東-新竹,2023-01-06,2184
2201,裕隆,22,17,5,亞東-新竹,2023-01-06,2184
00650L,復華香港正2,18,13,5,亞東-新竹,2023-01-06,2184
2359,所羅門,5,0,5,亞東-新竹,2023-01-06,2184
3038,全台,5,0,5,亞東-新竹,2023-01-06,2184
9105,泰金寶-DR,5,0,5,亞東-新竹,2023-01-06,2184
3030,德律,4,0,4,亞東-新竹,2023-01-06,2184
4162,智擎,4,0,4,亞東-新竹,2023-01-06,2184
8222,寶一,4,0,4,亞東-新竹,2023-01-06,2184
1524,耿鼎,3,0,3,亞東-新竹,2023-01-06,2184
00646,元大S＆P500,3,0,3,亞東-新竹,2023-01-06,2184
2606,裕民,3,0,3,亞東-新竹,2023-01-06,2184
2636,台驊控股,3,0,3,亞東-新竹,2023-01-06,2184
4171,瑞基,3,0,3,亞東-新竹,2023-01-06,2184
5321,美而快,4,1,3,亞東-新竹,2023-01-06,2184
5483,中美晶,3,0,3,亞東-新竹,2023-01-06,2184
8171,天宇,6,3,3,亞東-新竹,2023-01-06,2184
0050,元大台灣50,2,0,2,亞東-新竹,2023-01-06,2184
00706L,期元大S＆P日圓正2,2,0,2,亞東-新竹,2023-01-06,2184
1909,榮成,2,0,2,亞東-新竹,2023-01-06,2184
2820,華票,2,0,2,亞東-新竹,2023-01-06,2184
3047,訊舟,2,0,2,亞東-新竹,2023-01-06,2184
4114,健喬,14,12,2,亞東-新竹,2023-01-06,2184
4129,聯合,2,0,2,亞東-新竹,2023-01-06,2184
4716,大立,2,0,2,亞東-新竹,2023-01-06,2184
6578,達邦蛋白,2,0,2,亞東-新竹,2023-01-06,2184
2108,南帝,1,0,1,亞東-新竹,2023-01-06,2184
00725B,國泰投資級公司債,1,0,1,亞東-新竹,2023-01-06,2184
00893,國泰智能電動車,1,0,1,亞東-新竹,2023-01-06,2184
1514,亞力,1,0,1,亞東-新竹,2023-01-06,2184
1342,八貫,1,0,1,亞東-新竹,2023-01-06,2184
2351,順德,1,0,1,亞東-新竹,2023-01-06,2184
1519,華城,74,0,74,亞東-新竹,2023-01-09,2184
2610,華航,22,4,18,亞東-新竹,2023-01-09,2184
1569,濱川,13,0,13,亞東-新竹,2023-01-09,2184
2328,廣宇,13,0,13,亞東-新竹,2023-01-09,2184
2603,長榮,13,1,12,亞東-新竹,2023-01-09,2184
2609,陽明,16,5,11,亞東-新竹,2023-01-09,2184
2419,仲琦,10,0,10,亞東-新竹,2023-01-09,2184
2867,三商壽,10,0,10,亞東-新竹,2023-01-09,2184
4105,東洋,10,1,9,亞東-新竹,2023-01-09,2184
1752,南光,52,44,8,亞東-新竹,2023-01-09,2184
3141,晶宏,8,0,8,亞東-新竹,2023-01-09,2184
6550,北極星藥業-KY,40,32,8,亞東-新竹,2023-01-09,2184
1605,華新,13,6,7,亞東-新竹,2023-01-09,2184
00720B,元大投資級公司債,6,0,6,亞東-新竹,2023-01-09,2184
3034,聯詠,6,1,5,亞東-新竹,2023-01-09,2184
2534,宏盛,5,0,5,亞東-新竹,2023-01-09,2184
5227,立凱-KY,5,0,5,亞東-新竹,2023-01-09,2184
9958,世紀鋼,5,0,5,亞東-新竹,2023-01-09,2184
4541,晟田,4,0,4,亞東-新竹,2023-01-09,2184
6109,亞元,4,0,4,亞東-新竹,2023-01-09,2184
1720,生達,6,3,3,亞東-新竹,2023-01-09,2184
1319,東陽,3,0,3,亞東-新竹,2023-01-09,2184
2486,一詮,3,0,3,亞東-新竹,2023-01-09,2184
2615,萬海,29,26,3,亞東-新竹,2023-01-09,2184
3454,晶睿,21,18,3,亞東-新竹,2023-01-09,2184
5263,智崴,3,0,3,亞東-新竹,2023-01-09,2184
1342,八貫,2,0,2,亞東-新竹,2023-01-09,2184
1515,力山,2,0,2,亞東-新竹,2023-01-09,2184
2230,泰茂,9,7,2,亞東-新竹,2023-01-09,2184
2344,華邦電,2,0,2,亞東-新竹,2023-01-09,2184
2409,友達,5,3,2,亞東-新竹,2023-01-09,2184
2457,飛宏,2,0,2,亞東-新竹,2023-01-09,2184
3004,豐達科,2,0,2,亞東-新竹,2023-01-09,2184
3218,大學光,2,0,2,亞東-新竹,2023-01-09,2184
3504,揚明光,2,0,2,亞東-新竹,2023-01-09,2184
4908,前鼎,2,0,2,亞東-新竹,2023-01-09,2184
4979,華星光,2,0,2,亞東-新竹,2023-01-09,2184
5225,東科-KY,2,0,2,亞東-新竹,2023-01-09,2184
5340,建榮,2,0,2,亞東-新竹,2023-01-09,2184
6461,益得,2,0,2,亞東-新竹,2023-01-09,2184
1783,和康生,2,1,1,亞東-新竹,2023-01-09,2184
1810,和成,1,0,1,亞東-新竹,2023-01-09,2184
1442,名軒,1,0,1,亞東-新竹,2023-01-09,2184
1227,佳格,1,0,1,亞東-新竹,2023-01-09,2184
00858,永豐美國500大,1,0,1,亞東-新竹,2023-01-09,2184
00751B,元大AAA至A公司債,1,0,1,亞東-新竹,2023-01-09,2184
2014,中鴻,1,0,1,亞東-新竹,2023-01-09,2184
2201,裕隆,23,22,1,亞東-新竹,2023-01-09,2184
2337,旺宏,2,1,1,亞東-新竹,2023-01-09,2184
2441,超豐,1,0,1,亞東-新竹,2023-01-09,2184
2408,南亞科,100,2,98,亞東-新竹,2023-01-10,2184
9958,世紀鋼,42,0,42,亞東-新竹,2023-01-10,2184
00720B,元大投資級公司債,30,0,30,亞東-新竹,2023-01-10,2184
1904,正隆,25,0,25,亞東-新竹,2023-01-10,2184
2882A,國泰特,23,0,23,亞東-新竹,2023-01-10,2184
3685,元創精密,22,0,22,亞東-新竹,2023-01-10,2184
1701,中化,18,2,16,亞東-新竹,2023-01-10,2184
1708,東鹼,15,0,15,亞東-新竹,2023-01-10,2184
4155,訊映,15,0,15,亞東-新竹,2023-01-10,2184
8028,昇陽半導體,15,0,15,亞東-新竹,2023-01-10,2184
1720,生達,12,0,12,亞東-新竹,2023-01-10,2184
2347,聯強,12,0,12,亞東-新竹,2023-01-10,2184
2929,淘帝-KY,10,0,10,亞東-新竹,2023-01-10,2184
2328,廣宇,8,0,8,亞東-新竹,2023-01-10,2184
4931,新盛力,8,1,7,亞東-新竹,2023-01-10,2184
1216,統一,6,0,6,亞東-新竹,2023-01-10,2184
3207,耀勝,6,0,6,亞東-新竹,2023-01-10,2184
4105,東洋,6,0,6,亞東-新竹,2023-01-10,2184
1569,濱川,5,0,5,亞東-新竹,2023-01-10,2184
4532,瑞智,5,0,5,亞東-新竹,2023-01-10,2184
5347,世界,6,1,5,亞東-新竹,2023-01-10,2184
2201,裕隆,8,4,4,亞東-新竹,2023-01-10,2184
2615,萬海,9,5,4,亞東-新竹,2023-01-10,2184
3004,豐達科,4,0,4,亞東-新竹,2023-01-10,2184
5011,久陽,4,0,4,亞東-新竹,2023-01-10,2184
8227,巨有科技,4,0,4,亞東-新竹,2023-01-10,2184
00646,元大S＆P500,3,0,3,亞東-新竹,2023-01-10,2184
4171,瑞基,4,1,3,亞東-新竹,2023-01-10,2184
6550,北極星藥業-KY,3,0,3,亞東-新竹,2023-01-10,2184
8255,朋程,3,0,3,亞東-新竹,2023-01-10,2184
3034,聯詠,5,2,3,亞東-新竹,2023-01-10,2184
00706L,期元大S＆P日圓正2,2,0,2,亞東-新竹,2023-01-10,2184
00645,富邦日本,2,0,2,亞東-新竹,2023-01-10,2184
00637L,元大滬深300正2,12,10,2,亞東-新竹,2023-01-10,2184
2014,中鴻,2,0,2,亞東-新竹,2023-01-10,2184
2027,大成鋼,2,0,2,亞東-新竹,2023-01-10,2184
2401,凌陽,2,0,2,亞東-新竹,2023-01-10,2184
2748,雲品,2,0,2,亞東-新竹,2023-01-10,2184
3218,大學光,2,0,2,亞東-新竹,2023-01-10,2184
3293,鈊象,3,1,2,亞東-新竹,2023-01-10,2184
3479,安勤,8,6,2,亞東-新竹,2023-01-10,2184
4541,晟田,2,0,2,亞東-新竹,2023-01-10,2184
6109,亞元,2,0,2,亞東-新竹,2023-01-10,2184
6533,晶心科,4,2,2,亞東-新竹,2023-01-10,2184
1402,遠東新,2,0,2,亞東-新竹,2023-01-10,2184
1529,樂事綠能,2,0,2,亞東-新竹,2023-01-10,2184
2884,玉山金,1,0,1,亞東-新竹,2023-01-10,2184
1810,和成,1,0,1,亞東-新竹,2023-01-10,2184
1605,華新,10,9,1,亞東-新竹,2023-01-10,2184
00652,富邦印度,1,0,1,亞東-新竹,2023-01-10,2184
4904,遠傳,33,0,33,亞東-新竹,2023-01-11,2184
00751B,元大AAA至A公司債,30,0,30,亞東-新竹,2023-01-11,2184
2888,新光金,25,0,25,亞東-新竹,2023-01-11,2184
2882A,國泰特,22,0,22,亞東-新竹,2023-01-11,2184
00632R,元大台灣50反1,26,10,16,亞東-新竹,2023-01-11,2184
3034,聯詠,17,1,16,亞東-新竹,2023-01-11,2184
2449,京元電子,12,0,12,亞東-新竹,2023-01-11,2184
2610,華航,11,0,11,亞東-新竹,2023-01-11,2184
01002T,土銀國泰R1,10,0,10,亞東-新竹,2023-01-11,2184
4105,東洋,9,0,9,亞東-新竹,2023-01-11,2184
2834,臺企銀,8,0,8,亞東-新竹,2023-01-11,2184
6231,系微,8,0,8,亞東-新竹,2023-01-11,2184
1605,華新,15,8,7,亞東-新竹,2023-01-11,2184
9958,世紀鋼,7,0,7,亞東-新竹,2023-01-11,2184
2609,陽明,17,10,7,亞東-新竹,2023-01-11,2184
2201,裕隆,13,7,6,亞東-新竹,2023-01-11,2184
3380,明泰,6,0,6,亞東-新竹,2023-01-11,2184
2206,三陽工業,5,0,5,亞東-新竹,2023-01-11,2184
1532,勤美,5,0,5,亞東-新竹,2023-01-11,2184
00650L,復華香港正2,44,39,5,亞東-新竹,2023-01-11,2184
2929,淘帝-KY,5,0,5,亞東-新竹,2023-01-11,2184
5469,瀚宇博,5,0,5,亞東-新竹,2023-01-11,2184
6275,元山,5,0,5,亞東-新竹,2023-01-11,2184
00773B,中信優先金融債,4,0,4,亞東-新竹,2023-01-11,2184
2382,廣達,4,0,4,亞東-新竹,2023-01-11,2184
4162,智擎,4,0,4,亞東-新竹,2023-01-11,2184
00878,國泰永續高股息,3,0,3,亞東-新竹,2023-01-11,2184
00888,永豐台灣ESG,3,0,3,亞東-新竹,2023-01-11,2184
2497,怡利電,3,0,3,亞東-新竹,2023-01-11,2184
6257,矽格,3,0,3,亞東-新竹,2023-01-11,2184
2313,華通,3,0,3,亞東-新竹,2023-01-11,2184
1708,東鹼,2,0,2,亞東-新竹,2023-01-11,2184
2356,英業達,2,0,2,亞東-新竹,2023-01-11,2184
2412,中華電,2,0,2,亞東-新竹,2023-01-11,2184
3005,神基,2,0,2,亞東-新竹,2023-01-11,2184
3594,磐儀,2,0,2,亞東-新竹,2023-01-11,2184
4153,鈺緯,2,0,2,亞東-新竹,2023-01-11,2184
4747,強生,8,6,2,亞東-新竹,2023-01-11,2184
4971,IET-KY,2,0,2,亞東-新竹,2023-01-11,2184
6239,力成,2,0,2,亞東-新竹,2023-01-11,2184
6456,GIS-KY,2,0,2,亞東-新竹,2023-01-11,2184
6589,台康生技,2,0,2,亞東-新竹,2023-01-11,2184
6756,威鋒電子,2,0,2,亞東-新竹,2023-01-11,2184
8171,天宇,3,1,2,亞東-新竹,2023-01-11,2184
2317,鴻海,2,0,2,亞東-新竹,2023-01-11,2184
2883,凱基金,1,0,1,亞東-新竹,2023-01-11,2184
00885,富邦越南,1,0,1,亞東-新竹,2023-01-11,2184
00652,富邦印度,1,0,1,亞東-新竹,2023-01-11,2184
1810,和成,1,0,1,亞東-新竹,2023-01-11,2184
1730,花仙子,1,0,1,亞東-新竹,2023-01-11,2184
00679B,元大美債20年,100,3,97,亞東-新竹,2023-01-12,2184
2603,長榮,33,3,30,亞東-新竹,2023-01-12,2184
00878,國泰永續高股息,26,0,26,亞東-新竹,2023-01-12,2184
1326,台化,26,0,26,亞東-新竹,2023-01-12,2184
1301,台塑,21,0,21,亞東-新竹,2023-01-12,2184
3594,磐儀,21,0,21,亞東-新竹,2023-01-12,2184
4153,鈺緯,20,0,20,亞東-新竹,2023-01-12,2184
8938,明安,20,0,20,亞東-新竹,2023-01-12,2184
1303,南亞,16,0,16,亞東-新竹,2023-01-12,2184
3030,德律,15,0,15,亞東-新竹,2023-01-12,2184
2882A,國泰特,14,0,14,亞東-新竹,2023-01-12,2184
2633,台灣高鐵,13,0,13,亞東-新竹,2023-01-12,2184
4105,東洋,13,2,11,亞東-新竹,2023-01-12,2184
2610,華航,10,0,10,亞東-新竹,2023-01-12,2184
5876,上海商銀,10,0,10,亞東-新竹,2023-01-12,2184
2615,萬海,29,20,9,亞東-新竹,2023-01-12,2184
3454,晶睿,16,7,9,亞東-新竹,2023-01-12,2184
2014,中鴻,9,1,8,亞東-新竹,2023-01-12,2184
2328,廣宇,8,0,8,亞東-新竹,2023-01-12,2184
8996,高力,21,13,8,亞東-新竹,2023-01-12,2184
00882,中信中國高股息,6,0,6,亞東-新竹,2023-01-12,2184
2609,陽明,8,2,6,亞東-新竹,2023-01-12,2184
4904,遠傳,6,0,6,亞東-新竹,2023-01-12,2184
5880,合庫金,6,0,6,亞東-新竹,2023-01-12,2184
00637L,元大滬深300正2,10,5,5,亞東-新竹,2023-01-12,2184
2409,友達,5,0,5,亞東-新竹,2023-01-12,2184
2834,臺企銀,5,0,5,亞東-新竹,2023-01-12,2184
2929,淘帝-KY,5,0,5,亞東-新竹,2023-01-12,2184
5011,久陽,5,0,5,亞東-新竹,2023-01-12,2184
1720,生達,4,0,4,亞東-新竹,2023-01-12,2184
1417,嘉裕,3,0,3,亞東-新竹,2023-01-12,2184
1584,精剛,3,0,3,亞東-新竹,2023-01-12,2184
1789,神隆,3,0,3,亞東-新竹,2023-01-12,2184
2308,台達電,3,0,3,亞東-新竹,2023-01-12,2184
2412,中華電,3,0,3,亞東-新竹,2023-01-12,2184
8227,巨有科技,3,0,3,亞東-新竹,2023-01-12,2184
8421,旭源,3,0,3,亞東-新竹,2023-01-12,2184
00885,富邦越南,2,0,2,亞東-新竹,2023-01-12,2184
2357,華碩,2,0,2,亞東-新竹,2023-01-12,2184
00892,富邦台灣半導體,2,0,2,亞東-新竹,2023-01-12,2184
00751B,元大AAA至A公司債,2,0,2,亞東-新竹,2023-01-12,2184
00706L,期元大S＆P日圓正2,2,0,2,亞東-新竹,2023-01-12,2184
1513,中興電,2,0,2,亞東-新竹,2023-01-12,2184
1342,八貫,2,0,2,亞東-新竹,2023-01-12,2184
1609,大亞,2,0,2,亞東-新竹,2023-01-12,2184
2338,光罩,2,0,2,亞東-新竹,2023-01-12,2184
2351,順德,2,0,2,亞東-新竹,2023-01-12,2184
3149,正達,2,0,2,亞東-新竹,2023-01-12,2184
3630,新鉅科,2,0,2,亞東-新竹,2023-01-12,2184
4716,大立,2,0,2,亞東-新竹,2023-01-12,2184
00632R,元大台灣50反1,27,0,27,亞東-新竹,2023-01-13,2184
2498,宏達電,26,2,24,亞東-新竹,2023-01-13,2184
2606,裕民,20,0,20,亞東-新竹,2023-01-13,2184
2723,美食-KY,20,0,20,亞東-新竹,2023-01-13,2184
2472,立隆電,15,0,15,亞東-新竹,2023-01-13,2184
2458,義隆,11,0,11,亞東-新竹,2023-01-13,2184
2633,台灣高鐵,20,10,10,亞東-新竹,2023-01-13,2184
4153,鈺緯,10,0,10,亞東-新竹,2023-01-13,2184
5522,遠雄,10,0,10,亞東-新竹,2023-01-13,2184
2882A,國泰特,8,0,8,亞東-新竹,2023-01-13,2184
3511,矽瑪,8,0,8,亞東-新竹,2023-01-13,2184
1608,華榮,10,3,7,亞東-新竹,2023-01-13,2184
3016,嘉晶,6,0,6,亞東-新竹,2023-01-13,2184
00893,國泰智能電動車,5,0,5,亞東-新竹,2023-01-13,2184
00892,富邦台灣半導體,5,0,5,亞東-新竹,2023-01-13,2184
00671R,富邦NASDAQ反1,5,0,5,亞東-新竹,2023-01-13,2184
5011,久陽,5,0,5,亞東-新竹,2023-01-13,2184
5227,立凱-KY,5,0,5,亞東-新竹,2023-01-13,2184
1102,亞泥,4,0,4,亞東-新竹,2023-01-13,2184
2328,廣宇,3,0,3,亞東-新竹,2023-01-13,2184
1459,聯發,3,0,3,亞東-新竹,2023-01-13,2184
00676R,富邦臺灣加權反1,3,0,3,亞東-新竹,2023-01-13,2184
00713,元大台灣高息低波,3,0,3,亞東-新竹,2023-01-13,2184
2889,國票金,3,0,3,亞東-新竹,2023-01-13,2184
3030,德律,3,0,3,亞東-新竹,2023-01-13,2184
3707,漢磊,3,0,3,亞東-新竹,2023-01-13,2184
3714,富采,3,0,3,亞東-新竹,2023-01-13,2184
00740B,富邦全球投等債,2,0,2,亞東-新竹,2023-01-13,2184
00720B,元大投資級公司債,2,0,2,亞東-新竹,2023-01-13,2184
00878,國泰永續高股息,2,0,2,亞東-新竹,2023-01-13,2184
1587,吉茂,2,0,2,亞東-新竹,2023-01-13,2184
2392,正崴,2,0,2,亞東-新竹,2023-01-13,2184
2609,陽明,2,0,2,亞東-新竹,2023-01-13,2184
2637,慧洋-KY,2,0,2,亞東-新竹,2023-01-13,2184
3034,聯詠,2,0,2,亞東-新竹,2023-01-13,2184
3042,晶技,2,0,2,亞東-新竹,2023-01-13,2184
3481,群創,2,0,2,亞東-新竹,2023-01-13,2184
4128,中天,2,0,2,亞東-新竹,2023-01-13,2184
4961,天鈺,2,0,2,亞東-新竹,2023-01-13,2184
5285,界霖,2,0,2,亞東-新竹,2023-01-13,2184
5347,世界,2,0,2,亞東-新竹,2023-01-13,2184
5351,鈺創,2,0,2,亞東-新竹,2023-01-13,2184
6443,元晶,2,0,2,亞東-新竹,2023-01-13,2184
3665,貿聯-KY,2,0,2,亞東-新竹,2023-01-13,2184
2317,鴻海,2,1,1,亞東-新竹,2023-01-13,2184
2308,台達電,1,0,1,亞東-新竹,2023-01-13,2184
1201,味全,1,0,1,亞東-新竹,2023-01-13,2184
1524,耿鼎,1,0,1,亞東-新竹,2023-01-13,2184
00693U,期街口S＆P黃豆,1,0,1,亞東-新竹,2023-01-13,2184
00885,富邦越南,1,0,1,亞東-新竹,2023-01-13,2184
00632R,元大台灣50反1,318,0,318,亞東-新竹,2023-01-16,2184
2618,長榮航,81,2,79,亞東-新竹,2023-01-16,2184
00683L,期元大美元指正2,75,0,75,亞東-新竹,2023-01-16,2184
00751B,元大AAA至A公司債,60,0,60,亞東-新竹,2023-01-16,2184
2104,國際中橡,25,0,25,亞東-新竹,2023-01-16,2184
2610,華航,21,1,20,亞東-新竹,2023-01-16,2184
2338,光罩,23,5,18,亞東-新竹,2023-01-16,2184
2317,鴻海,21,6,15,亞東-新竹,2023-01-16,2184
2401,凌陽,11,0,11,亞東-新竹,2023-01-16,2184
00676R,富邦臺灣加權反1,10,0,10,亞東-新竹,2023-01-16,2184
4545,銘鈺,10,0,10,亞東-新竹,2023-01-16,2184
6231,系微,10,0,10,亞東-新竹,2023-01-16,2184
2603,長榮,18,10,8,亞東-新竹,2023-01-16,2184
2303,聯電,13,5,8,亞東-新竹,2023-01-16,2184
00631L,元大台灣50正2,6,0,6,亞東-新竹,2023-01-16,2184
2633,台灣高鐵,6,0,6,亞東-新竹,2023-01-16,2184
00893,國泰智能電動車,5,0,5,亞東-新竹,2023-01-16,2184
1101,台泥,10,5,5,亞東-新竹,2023-01-16,2184
00679B,元大美債20年,5,0,5,亞東-新竹,2023-01-16,2184
00671R,富邦NASDAQ反1,5,0,5,亞東-新竹,2023-01-16,2184
2449,京元電子,5,0,5,亞東-新竹,2023-01-16,2184
2634,漢翔,5,0,5,亞東-新竹,2023-01-16,2184
3576,聯合再生,5,0,5,亞東-新竹,2023-01-16,2184
5469,瀚宇博,5,0,5,亞東-新竹,2023-01-16,2184
9904,寶成,5,0,5,亞東-新竹,2023-01-16,2184
3207,耀勝,4,0,4,亞東-新竹,2023-01-16,2184
00645,富邦日本,3,0,3,亞東-新竹,2023-01-16,2184
2468,華經,3,0,3,亞東-新竹,2023-01-16,2184
3540,曜越,3,0,3,亞東-新竹,2023-01-16,2184
00900,富邦特選高股息30,2,0,2,亞東-新竹,2023-01-16,2184
00720B,元大投資級公司債,2,0,2,亞東-新竹,2023-01-16,2184
2388,威盛,8,6,2,亞東-新竹,2023-01-16,2184
2489,瑞軒,2,0,2,亞東-新竹,2023-01-16,2184
2881,富邦金,2,0,2,亞東-新竹,2023-01-16,2184
3231,緯創,2,0,2,亞東-新竹,2023-01-16,2184
4105,東洋,2,0,2,亞東-新竹,2023-01-16,2184
5285,界霖,2,0,2,亞東-新竹,2023-01-16,2184
8121,越峰,2,0,2,亞東-新竹,2023-01-16,2184
1459,聯發,2,0,2,亞東-新竹,2023-01-16,2184
00652,富邦印度,1,0,1,亞東-新竹,2023-01-16,2184
0056,元大高股息,1,0,1,亞東-新竹,2023-01-16,2184
00881,國泰台灣5G+,1,0,1,亞東-新竹,2023-01-16,2184
00770,國泰北美科技,1,0,1,亞東-新竹,2023-01-16,2184
00693U,期街口S＆P黃豆,1,0,1,亞東-新竹,2023-01-16,2184
0061,元大寶滬深,1,0,1,亞東-新竹,2023-01-16,2184
1904,正隆,1,0,1,亞東-新竹,2023-01-16,2184
2059,川湖,1,0,1,亞東-新竹,2023-01-16,2184
2367,燿華,1,0,1,亞東-新竹,2023-01-16,2184
2612,中航,1,0,1,亞東-新竹,2023-01-16,2184
2754,亞洲藏壽司,1,0,1,亞東-新竹,2023-01-16,2184
1909,榮成,45,2,43,亞東-新竹,2023-01-17,2184
00673R,期元大S＆P原油反1,30,0,30,亞東-新竹,2023-01-17,2184
3481,群創,30,0,30,亞東-新竹,2023-01-17,2184
2365,昆盈,18,0,18,亞東-新竹,2023-01-17,2184
2204,中華,15,0,15,亞東-新竹,2023-01-17,2184
00632R,元大台灣50反1,11,0,11,亞東-新竹,2023-01-17,2184
2388,威盛,17,6,11,亞東-新竹,2023-01-17,2184
01002T,土銀國泰R1,10,0,10,亞東-新竹,2023-01-17,2184
2324,仁寶,10,0,10,亞東-新竹,2023-01-17,2184
2887,台新金,10,0,10,亞東-新竹,2023-01-17,2184
2888,新光金,10,0,10,亞東-新竹,2023-01-17,2184
3594,磐儀,9,0,9,亞東-新竹,2023-01-17,2184
5284,jpp-KY,8,0,8,亞東-新竹,2023-01-17,2184
6770,力積電,34,27,7,亞東-新竹,2023-01-17,2184
2317,鴻海,6,0,6,亞東-新竹,2023-01-17,2184
2328,廣宇,6,0,6,亞東-新竹,2023-01-17,2184
1701,中化,8,2,6,亞東-新竹,2023-01-17,2184
00675L,富邦臺灣加權正2,6,0,6,亞東-新竹,2023-01-17,2184
2834,臺企銀,6,0,6,亞東-新竹,2023-01-17,2184
8222,寶一,6,0,6,亞東-新竹,2023-01-17,2184
00878,國泰永續高股息,6,1,5,亞東-新竹,2023-01-17,2184
00706L,期元大S＆P日圓正2,5,0,5,亞東-新竹,2023-01-17,2184
2462,良得電,5,0,5,亞東-新竹,2023-01-17,2184
2542,興富發,5,0,5,亞東-新竹,2023-01-17,2184
4105,東洋,6,1,5,亞東-新竹,2023-01-17,2184
3443,創意,19,14,5,亞東-新竹,2023-01-17,2184
00645,富邦日本,4,0,4,亞東-新竹,2023-01-17,2184
3454,晶睿,6,2,4,亞東-新竹,2023-01-17,2184
4123,晟德,4,0,4,亞東-新竹,2023-01-17,2184
4545,銘鈺,4,0,4,亞東-新竹,2023-01-17,2184
5425,台半,4,0,4,亞東-新竹,2023-01-17,2184
6609,瀧澤科,5,1,4,亞東-新竹,2023-01-17,2184
6695,芯鼎,4,0,4,亞東-新竹,2023-01-17,2184
5321,美而快,6,2,4,亞東-新竹,2023-01-17,2184
00882,中信中國高股息,3,0,3,亞東-新竹,2023-01-17,2184
00715L,期街口布蘭特正2,3,0,3,亞東-新竹,2023-01-17,2184
1752,南光,45,42,3,亞東-新竹,2023-01-17,2184
00650L,復華香港正2,11,8,3,亞東-新竹,2023-01-17,2184
2634,漢翔,3,0,3,亞東-新竹,2023-01-17,2184
3019,亞光,3,0,3,亞東-新竹,2023-01-17,2184
3293,鈊象,6,3,3,亞東-新竹,2023-01-17,2184
6118,建達,3,0,3,亞東-新竹,2023-01-17,2184
6719,力智,5,2,3,亞東-新竹,2023-01-17,2184
2027,大成鋼,3,1,2,亞東-新竹,2023-01-17,2184
00681R,元大美債20反1,2,0,2,亞東-新竹,2023-01-17,2184
00770,國泰北美科技,2,0,2,亞東-新竹,2023-01-17,2184
00720B,元大投資級公司債,2,0,2,亞東-新竹,2023-01-17,2184
00643,群益深証中小,2,0,2,亞東-新竹,2023-01-17,2184
2882A,國泰特,2,0,2,亞東-新竹,2023-01-17,2184
3707,漢磊,2,0,2,亞東-新竹,2023-01-17,2184
1909,榮成,100,8,92,亞東-新竹,2023-01-30,2184
2888,新光金,50,5,45,亞東-新竹,2023-01-30,2184
2634,漢翔,33,0,33,亞東-新竹,2023-01-30,2184
5469,瀚宇博,33,0,33,亞東-新竹,2023-01-30,2184
4105,東洋,24,0,24,亞東-新竹,2023-01-30,2184
2633,台灣高鐵,20,0,20,亞東-新竹,2023-01-30,2184
2845,遠東銀,20,1,19,亞東-新竹,2023-01-30,2184
8222,寶一,19,0,19,亞東-新竹,2023-01-30,2184
00715L,期街口布蘭特正2,18,0,18,亞東-新竹,2023-01-30,2184
8996,高力,33,15,18,亞東-新竹,2023-01-30,2184
00720B,元大投資級公司債,16,0,16,亞東-新竹,2023-01-30,2184
00751B,元大AAA至A公司債,10,0,10,亞東-新竹,2023-01-30,2184
2358,廷鑫,10,0,10,亞東-新竹,2023-01-30,2184
3390,旭軟,10,0,10,亞東-新竹,2023-01-30,2184
8150,南茂,10,0,10,亞東-新竹,2023-01-30,2184
2317,鴻海,10,1,9,亞東-新竹,2023-01-30,2184
2308,台達電,8,1,7,亞東-新竹,2023-01-30,2184
5011,久陽,7,0,7,亞東-新竹,2023-01-30,2184
2367,燿華,7,1,6,亞東-新竹,2023-01-30,2184
5263,智崴,7,1,6,亞東-新竹,2023-01-30,2184
8069,元太,9,3,6,亞東-新竹,2023-01-30,2184
00631L,元大台灣50正2,15,10,5,亞東-新竹,2023-01-30,2184
00679B,元大美債20年,5,0,5,亞東-新竹,2023-01-30,2184
2867,三商壽,5,0,5,亞東-新竹,2023-01-30,2184
4162,智擎,5,0,5,亞東-新竹,2023-01-30,2184
5227,立凱-KY,5,0,5,亞東-新竹,2023-01-30,2184
5340,建榮,5,0,5,亞東-新竹,2023-01-30,2184
6182,合晶,5,0,5,亞東-新竹,2023-01-30,2184
6259,百徽,5,0,5,亞東-新竹,2023-01-30,2184
3594,磐儀,4,0,4,亞東-新竹,2023-01-30,2184
5258,虹堡,4,0,4,亞東-新竹,2023-01-30,2184
6275,元山,4,0,4,亞東-新竹,2023-01-30,2184
2609,陽明,5,2,3,亞東-新竹,2023-01-30,2184
00710B,復華彭博非投等債,3,0,3,亞東-新竹,2023-01-30,2184
1216,統一,3,0,3,亞東-新竹,2023-01-30,2184
3231,緯創,6,3,3,亞東-新竹,2023-01-30,2184
4155,訊映,5,2,3,亞東-新竹,2023-01-30,2184
8936,國統,3,0,3,亞東-新竹,2023-01-30,2184
2748,雲品,3,0,3,亞東-新竹,2023-01-30,2184
2881,富邦金,2,0,2,亞東-新竹,2023-01-30,2184
00878,國泰永續高股息,14,12,2,亞東-新竹,2023-01-30,2184
4770,上品,2,0,2,亞東-新竹,2023-01-30,2184
1817,凱撒衛,2,0,2,亞東-新竹,2023-01-30,2184
1701,中化,6,4,2,亞東-新竹,2023-01-30,2184
1442,名軒,2,0,2,亞東-新竹,2023-01-30,2184
00772B,中信高評級公司債,2,0,2,亞東-新竹,2023-01-30,2184
00722B,群益投資級電信債,2,0,2,亞東-新竹,2023-01-30,2184
00675L,富邦臺灣加權正2,4,2,2,亞東-新竹,2023-01-30,2184
00701,國泰股利精選30,2,0,2,亞東-新竹,2023-01-30,2184
2492,華新科,2,0,2,亞東-新竹,2023-01-30,2184
2834,臺企銀,300,100,200,亞東-新竹,2023-01-31,2184
00632R,元大台灣50反1,75,0,75,亞東-新竹,2023-01-31,2184
00878,國泰永續高股息,52,0,52,亞東-新竹,2023-01-31,2184
00715L,期街口布蘭特正2,50,0,50,亞東-新竹,2023-01-31,2184
5876,上海商銀,40,0,40,亞東-新竹,2023-01-31,2184
2610,華航,40,6,34,亞東-新竹,2023-01-31,2184
9958,世紀鋼,30,0,30,亞東-新竹,2023-01-31,2184
0056,元大高股息,20,0,20,亞東-新竹,2023-01-31,2184
3711,日月光投控,20,0,20,亞東-新竹,2023-01-31,2184
8105,凌巨,22,2,20,亞東-新竹,2023-01-31,2184
2892,第一金,18,0,18,亞東-新竹,2023-01-31,2184
5272,笙科,18,0,18,亞東-新竹,2023-01-31,2184
00905,FT臺灣Smart,17,0,17,亞東-新竹,2023-01-31,2184
2330,台積電,17,2,15,亞東-新竹,2023-01-31,2184
6732,昇佳電子,14,0,14,亞東-新竹,2023-01-31,2184
2201,裕隆,31,20,11,亞東-新竹,2023-01-31,2184
3217,優群,12,1,11,亞東-新竹,2023-01-31,2184
1218,泰山,10,0,10,亞東-新竹,2023-01-31,2184
2633,台灣高鐵,10,0,10,亞東-新竹,2023-01-31,2184
3189,景碩,9,0,9,亞東-新竹,2023-01-31,2184
00670L,富邦NASDAQ正2,9,0,9,亞東-新竹,2023-01-31,2184
6266,泰詠,10,1,9,亞東-新竹,2023-01-31,2184
00679B,元大美債20年,8,0,8,亞東-新竹,2023-01-31,2184
3624,光頡,8,0,8,亞東-新竹,2023-01-31,2184
0050,元大台灣50,7,0,7,亞東-新竹,2023-01-31,2184
00720B,元大投資級公司債,6,0,6,亞東-新竹,2023-01-31,2184
00652,富邦印度,5,0,5,亞東-新竹,2023-01-31,2184
3705,永信,5,0,5,亞東-新竹,2023-01-31,2184
4123,晟德,5,0,5,亞東-新竹,2023-01-31,2184
4153,鈺緯,8,3,5,亞東-新竹,2023-01-31,2184
4716,大立,5,0,5,亞東-新竹,2023-01-31,2184
4746,台耀,5,0,5,亞東-新竹,2023-01-31,2184
6116,彩晶,6,1,5,亞東-新竹,2023-01-31,2184
6269,台郡,5,0,5,亞東-新竹,2023-01-31,2184
2887,台新金,4,0,4,亞東-新竹,2023-01-31,2184
3030,德律,4,0,4,亞東-新竹,2023-01-31,2184
2002,中鋼,3,0,3,亞東-新竹,2023-01-31,2184
5871,中租-KY,3,0,3,亞東-新竹,2023-01-31,2184
1608,華榮,3,0,3,亞東-新竹,2023-01-31,2184
1701,中化,15,12,3,亞東-新竹,2023-01-31,2184
1612,宏泰,3,0,3,亞東-新竹,2023-01-31,2184
2731,雄獅,3,0,3,亞東-新竹,2023-01-31,2184
4545,銘鈺,3,0,3,亞東-新竹,2023-01-31,2184
5011,久陽,3,0,3,亞東-新竹,2023-01-31,2184
6121,新普,3,0,3,亞東-新竹,2023-01-31,2184
8261,富鼎,5,2,3,亞東-新竹,2023-01-31,2184
5347,世界,2,0,2,亞東-新竹,2023-01-31,2184
2412,中華電,3,1,2,亞東-新竹,2023-01-31,2184
1720,生達,2,0,2,亞東-新竹,2023-01-31,2184
00650L,復華香港正2,2,0,2,亞東-新竹,2023-01-31,2184
2883,凱基金,301,200,101,亞東-新竹,2023-02-01,2184
2382,廣達,40,2,38,亞東-新竹,2023-02-01,2184
3218,大學光,23,0,23,亞東-新竹,2023-02-01,2184
4763,材料-KY,28,7,21,亞東-新竹,2023-02-01,2184
2338,光罩,21,1,20,亞東-新竹,2023-02-01,2184
6712,長聖,20,1,19,亞東-新竹,2023-02-01,2184
8261,富鼎,21,5,16,亞東-新竹,2023-02-01,2184
2634,漢翔,16,1,15,亞東-新竹,2023-02-01,2184
2317,鴻海,31,17,14,亞東-新竹,2023-02-01,2184
4164,承業醫,16,2,14,亞東-新竹,2023-02-01,2184
6456,GIS-KY,11,0,11,亞東-新竹,2023-02-01,2184
00637L,元大滬深300正2,12,2,10,亞東-新竹,2023-02-01,2184
00632R,元大台灣50反1,10,0,10,亞東-新竹,2023-02-01,2184
00675L,富邦臺灣加權正2,10,0,10,亞東-新竹,2023-02-01,2184
2358,廷鑫,10,0,10,亞東-新竹,2023-02-01,2184
2449,京元電子,10,0,10,亞東-新竹,2023-02-01,2184
6126,信音,10,0,10,亞東-新竹,2023-02-01,2184
6441,廣錠,10,0,10,亞東-新竹,2023-02-01,2184
8936,國統,9,0,9,亞東-新竹,2023-02-01,2184
2409,友達,9,1,8,亞東-新竹,2023-02-01,2184
6282,康舒,10,2,8,亞東-新竹,2023-02-01,2184
00878,國泰永續高股息,7,0,7,亞東-新竹,2023-02-01,2184
2206,三陽工業,7,0,7,亞東-新竹,2023-02-01,2184
2610,華航,7,0,7,亞東-新竹,2023-02-01,2184
2614,東森,6,0,6,亞東-新竹,2023-02-01,2184
3013,晟銘電,6,0,6,亞東-新竹,2023-02-01,2184
3141,晶宏,6,0,6,亞東-新竹,2023-02-01,2184
2618,長榮航,19,13,6,亞東-新竹,2023-02-01,2184
00671R,富邦NASDAQ反1,5,0,5,亞東-新竹,2023-02-01,2184
1524,耿鼎,5,0,5,亞東-新竹,2023-02-01,2184
2342,茂矽,5,0,5,亞東-新竹,2023-02-01,2184
2548,華固,5,0,5,亞東-新竹,2023-02-01,2184
4105,東洋,6,1,5,亞東-新竹,2023-02-01,2184
4904,遠傳,5,0,5,亞東-新竹,2023-02-01,2184
8478,東哥遊艇,8,3,5,亞東-新竹,2023-02-01,2184
9945,潤泰新,7,2,5,亞東-新竹,2023-02-01,2184
1701,中化,20,16,4,亞東-新竹,2023-02-01,2184
1612,宏泰,4,0,4,亞東-新竹,2023-02-01,2184
1569,濱川,4,0,4,亞東-新竹,2023-02-01,2184
2603,長榮,9,5,4,亞東-新竹,2023-02-01,2184
1603,華電,3,0,3,亞東-新竹,2023-02-01,2184
00720B,元大投資級公司債,3,0,3,亞東-新竹,2023-02-01,2184
2399,映泰,3,0,3,亞東-新竹,2023-02-01,2184
2412,中華電,3,0,3,亞東-新竹,2023-02-01,2184
2891,中信金,3,0,3,亞東-新竹,2023-02-01,2184
3056,富華新,3,0,3,亞東-新竹,2023-02-01,2184
6443,元晶,3,0,3,亞東-新竹,2023-02-01,2184
6695,芯鼎,3,0,3,亞東-新竹,2023-02-01,2184
8033,雷虎,3,0,3,亞東-新竹,2023-02-01,2184
8341,日友,3,0,3,亞東-新竹,2023-02-01,2184
2891,中信金,59,0,59,亞東-新竹,2023-02-02,2184
2317,鴻海,64,16,48,亞東-新竹,2023-02-02,2184
00679B,元大美債20年,45,3,42,亞東-新竹,2023-02-02,2184
3665,貿聯-KY,36,2,34,亞東-新竹,2023-02-02,2184
00751B,元大AAA至A公司債,30,0,30,亞東-新竹,2023-02-02,2184
6732,昇佳電子,28,0,28,亞東-新竹,2023-02-02,2184
00878,國泰永續高股息,44,17,27,亞東-新竹,2023-02-02,2184
3710,連展投控,43,20,23,亞東-新竹,2023-02-02,2184
1611,中電,20,0,20,亞東-新竹,2023-02-02,2184
00671R,富邦NASDAQ反1,20,0,20,亞東-新竹,2023-02-02,2184
1760,寶齡富錦,20,0,20,亞東-新竹,2023-02-02,2184
3207,耀勝,22,2,20,亞東-新竹,2023-02-02,2184
00715L,期街口布蘭特正2,22,5,17,亞東-新竹,2023-02-02,2184
2201,裕隆,137,122,15,亞東-新竹,2023-02-02,2184
5011,久陽,15,0,15,亞東-新竹,2023-02-02,2184
0056,元大高股息,21,8,13,亞東-新竹,2023-02-02,2184
2363,矽統,13,0,13,亞東-新竹,2023-02-02,2184
8916,光隆,12,0,12,亞東-新竹,2023-02-02,2184
00900,富邦特選高股息30,11,0,11,亞東-新竹,2023-02-02,2184
1785,光洋科,15,5,10,亞東-新竹,2023-02-02,2184
2462,良得電,10,0,10,亞東-新竹,2023-02-02,2184
2481,強茂,10,0,10,亞東-新竹,2023-02-02,2184
2890,永豐金,10,0,10,亞東-新竹,2023-02-02,2184
6275,元山,10,0,10,亞東-新竹,2023-02-02,2184
6712,長聖,10,0,10,亞東-新竹,2023-02-02,2184
4919,新唐,10,0,10,亞東-新竹,2023-02-02,2184
00720B,元大投資級公司債,9,0,9,亞東-新竹,2023-02-02,2184
00676R,富邦臺灣加權反1,9,0,9,亞東-新竹,2023-02-02,2184
3504,揚明光,15,6,9,亞東-新竹,2023-02-02,2184
00675L,富邦臺灣加權正2,6,0,6,亞東-新竹,2023-02-02,2184
1708,東鹼,6,0,6,亞東-新竹,2023-02-02,2184
2206,三陽工業,6,0,6,亞東-新竹,2023-02-02,2184
2867,三商壽,6,0,6,亞東-新竹,2023-02-02,2184
6239,力成,5,0,5,亞東-新竹,2023-02-02,2184
6781,AES-KY,5,0,5,亞東-新竹,2023-02-02,2184
8424,惠普,5,0,5,亞東-新竹,2023-02-02,2184
9958,世紀鋼,5,0,5,亞東-新竹,2023-02-02,2184
1605,華新,7,3,4,亞東-新竹,2023-02-02,2184
4572,駐龍,4,0,4,亞東-新竹,2023-02-02,2184
8033,雷虎,4,0,4,亞東-新竹,2023-02-02,2184
00893,國泰智能電動車,5,1,4,亞東-新竹,2023-02-02,2184
2892,第一金,3,0,3,亞東-新竹,2023-02-02,2184
1612,宏泰,3,0,3,亞東-新竹,2023-02-02,2184
2208,台船,3,0,3,亞東-新竹,2023-02-02,2184
3532,台勝科,3,0,3,亞東-新竹,2023-02-02,2184
4114,健喬,3,0,3,亞東-新竹,2023-02-02,2184
4163,鐿鈦,3,0,3,亞東-新竹,2023-02-02,2184
5263,智崴,3,0,3,亞東-新竹,2023-02-02,2184
6770,力積電,10,7,3,亞東-新竹,2023-02-02,2184
8016,矽創,3,0,3,亞東-新竹,2023-02-02,2184
2883,凱基金,600,501,99,亞東-新竹,2023-02-03,2184
00632R,元大台灣50反1,60,0,60,亞東-新竹,2023-02-03,2184
3322,建舜電,50,0,50,亞東-新竹,2023-02-03,2184
00878,國泰永續高股息,46,6,40,亞東-新竹,2023-02-03,2184
00751B,元大AAA至A公司債,30,0,30,亞東-新竹,2023-02-03,2184
1909,榮成,30,0,30,亞東-新竹,2023-02-03,2184
1784,訊聯,25,0,25,亞東-新竹,2023-02-03,2184
00900,富邦特選高股息30,21,0,21,亞東-新竹,2023-02-03,2184
00679B,元大美債20年,21,0,21,亞東-新竹,2023-02-03,2184
2367,燿華,20,0,20,亞東-新竹,2023-02-03,2184
2358,廷鑫,18,0,18,亞東-新竹,2023-02-03,2184
6118,建達,24,8,16,亞東-新竹,2023-02-03,2184
2388,威盛,23,8,15,亞東-新竹,2023-02-03,2184
2867,三商壽,15,0,15,亞東-新竹,2023-02-03,2184
5351,鈺創,19,4,15,亞東-新竹,2023-02-03,2184
6133,金橋,15,0,15,亞東-新竹,2023-02-03,2184
3594,磐儀,14,0,14,亞東-新竹,2023-02-03,2184
2891,中信金,13,0,13,亞東-新竹,2023-02-03,2184
1795,美時,28,17,11,亞東-新竹,2023-02-03,2184
2409,友達,11,0,11,亞東-新竹,2023-02-03,2184
00650L,復華香港正2,10,0,10,亞東-新竹,2023-02-03,2184
2230,泰茂,23,13,10,亞東-新竹,2023-02-03,2184
2462,良得電,10,0,10,亞東-新竹,2023-02-03,2184
2888,新光金,10,0,10,亞東-新竹,2023-02-03,2184
6188,廣明,10,0,10,亞東-新竹,2023-02-03,2184
8261,富鼎,10,0,10,亞東-新竹,2023-02-03,2184
2317,鴻海,8,0,8,亞東-新竹,2023-02-03,2184
00671R,富邦NASDAQ反1,8,0,8,亞東-新竹,2023-02-03,2184
3558,神準,8,0,8,亞東-新竹,2023-02-03,2184
3661,世芯-KY,8,0,8,亞東-新竹,2023-02-03,2184
00893,國泰智能電動車,10,3,7,亞東-新竹,2023-02-03,2184
00882,中信中國高股息,16,9,7,亞東-新竹,2023-02-03,2184
00715L,期街口布蘭特正2,10,3,7,亞東-新竹,2023-02-03,2184
3680,家登,7,0,7,亞東-新竹,2023-02-03,2184
8039,台虹,9,2,7,亞東-新竹,2023-02-03,2184
2882,國泰金,6,0,6,亞東-新竹,2023-02-03,2184
2929,淘帝-KY,6,0,6,亞東-新竹,2023-02-03,2184
6248,沛波,6,0,6,亞東-新竹,2023-02-03,2184
00720B,元大投資級公司債,5,0,5,亞東-新竹,2023-02-03,2184
00676R,富邦臺灣加權反1,5,0,5,亞東-新竹,2023-02-03,2184
1783,和康生,5,0,5,亞東-新竹,2023-02-03,2184
3021,鴻名,5,0,5,亞東-新竹,2023-02-03,2184
4102,永日,5,0,5,亞東-新竹,2023-02-03,2184
5272,笙科,5,0,5,亞東-新竹,2023-02-03,2184
5347,世界,5,0,5,亞東-新竹,2023-02-03,2184
6259,百徽,5,0,5,亞東-新竹,2023-02-03,2184
6667,信紘科,5,0,5,亞東-新竹,2023-02-03,2184
8227,巨有科技,13,8,5,亞東-新竹,2023-02-03,2184
2347,聯強,6,2,4,亞東-新竹,2023-02-03,2184
1701,中化,8,4,4,亞東-新竹,2023-02-03,2184
2903,遠百,122,0,122,亞東-新竹,2023-02-06,2184
2891,中信金,100,0,100,亞東-新竹,2023-02-06,2184
00715L,期街口布蘭特正2,68,0,68,亞東-新竹,2023-02-06,2184
00878,國泰永續高股息,63,3,60,亞東-新竹,2023-02-06,2184
00632R,元大台灣50反1,50,5,45,亞東-新竹,2023-02-06,2184
2610,華航,84,41,43,亞東-新竹,2023-02-06,2184
2890,永豐金,42,0,42,亞東-新竹,2023-02-06,2184
3625,西勝,40,0,40,亞東-新竹,2023-02-06,2184
9962,有益,40,0,40,亞東-新竹,2023-02-06,2184
2882,國泰金,34,1,33,亞東-新竹,2023-02-06,2184
00753L,中信中國50正2,30,0,30,亞東-新竹,2023-02-06,2184
6603,富強鑫,30,0,30,亞東-新竹,2023-02-06,2184
2002,中鋼,30,1,29,亞東-新竹,2023-02-06,2184
1605,華新,32,9,23,亞東-新竹,2023-02-06,2184
00676R,富邦臺灣加權反1,20,0,20,亞東-新竹,2023-02-06,2184
2330,台積電,21,3,18,亞東-新竹,2023-02-06,2184
00679B,元大美債20年,18,0,18,亞東-新竹,2023-02-06,2184
00772B,中信高評級公司債,13,0,13,亞東-新竹,2023-02-06,2184
00650L,復華香港正2,10,0,10,亞東-新竹,2023-02-06,2184
00892,富邦台灣半導體,10,0,10,亞東-新竹,2023-02-06,2184
1809,中釉,10,0,10,亞東-新竹,2023-02-06,2184
1817,凱撒衛,10,0,10,亞東-新竹,2023-02-06,2184
2462,良得電,10,0,10,亞東-新竹,2023-02-06,2184
2888,新光金,10,0,10,亞東-新竹,2023-02-06,2184
3207,耀勝,10,0,10,亞東-新竹,2023-02-06,2184
3576,聯合再生,10,0,10,亞東-新竹,2023-02-06,2184
6282,康舒,12,2,10,亞東-新竹,2023-02-06,2184
3037,欣興,9,0,9,亞東-新竹,2023-02-06,2184
00900,富邦特選高股息30,10,1,9,亞東-新竹,2023-02-06,2184
2615,萬海,9,1,8,亞東-新竹,2023-02-06,2184
2618,長榮航,10,2,8,亞東-新竹,2023-02-06,2184
6531,愛普*,13,5,8,亞東-新竹,2023-02-06,2184
0056,元大高股息,20,13,7,亞東-新竹,2023-02-06,2184
00720B,元大投資級公司債,7,0,7,亞東-新竹,2023-02-06,2184
2303,聯電,8,1,7,亞東-新竹,2023-02-06,2184
2603,長榮,20,13,7,亞東-新竹,2023-02-06,2184
3034,聯詠,7,0,7,亞東-新竹,2023-02-06,2184
1560,中砂,6,0,6,亞東-新竹,2023-02-06,2184
2809,京城銀,6,0,6,亞東-新竹,2023-02-06,2184
3594,磐儀,6,0,6,亞東-新竹,2023-02-06,2184
2609,陽明,5,0,5,亞東-新竹,2023-02-06,2184
1409,新纖,5,0,5,亞東-新竹,2023-02-06,2184
00885,富邦越南,5,0,5,亞東-新竹,2023-02-06,2184
00671R,富邦NASDAQ反1,5,0,5,亞東-新竹,2023-02-06,2184
1785,光洋科,5,0,5,亞東-新竹,2023-02-06,2184
2201,裕隆,92,87,5,亞東-新竹,2023-02-06,2184
2451,創見,5,0,5,亞東-新竹,2023-02-06,2184
3105,穩懋,6,1,5,亞東-新竹,2023-02-06,2184
6548,長科*,5,0,5,亞東-新竹,2023-02-06,2184
8261,富鼎,5,0,5,亞東-新竹,2023-02-06,2184
2014,中鴻,300,0,300,亞東-新竹,2023-02-07,2184
2002,中鋼,118,0,118,亞東-新竹,2023-02-07,2184
2891,中信金,111,0,111,亞東-新竹,2023-02-07,2184
00751B,元大AAA至A公司債,30,0,30,亞東-新竹,2023-02-07,2184
1584,精剛,31,2,29,亞東-新竹,2023-02-07,2184
2412,中華電,30,1,29,亞東-新竹,2023-02-07,2184
9904,寶成,20,0,20,亞東-新竹,2023-02-07,2184
2504,國產,16,0,16,亞東-新竹,2023-02-07,2184
2317,鴻海,19,4,15,亞東-新竹,2023-02-07,2184
3548,兆利,15,0,15,亞東-新竹,2023-02-07,2184
6129,普誠,11,0,11,亞東-新竹,2023-02-07,2184
00772B,中信高評級公司債,10,0,10,亞東-新竹,2023-02-07,2184
2633,台灣高鐵,10,0,10,亞東-新竹,2023-02-07,2184
4527,方土霖,10,0,10,亞東-新竹,2023-02-07,2184
5876,上海商銀,10,0,10,亞東-新竹,2023-02-07,2184
6282,康舒,12,2,10,亞東-新竹,2023-02-07,2184
3034,聯詠,15,7,8,亞東-新竹,2023-02-07,2184
00670L,富邦NASDAQ正2,8,0,8,亞東-新竹,2023-02-07,2184
6531,愛普*,15,7,8,亞東-新竹,2023-02-07,2184
2618,長榮航,7,0,7,亞東-新竹,2023-02-07,2184
6235,華孚,6,0,6,亞東-新竹,2023-02-07,2184
1612,宏泰,6,0,6,亞東-新竹,2023-02-07,2184
2308,台達電,7,1,6,亞東-新竹,2023-02-07,2184
00679B,元大美債20年,5,0,5,亞東-新竹,2023-02-07,2184
3088,艾訊,5,0,5,亞東-新竹,2023-02-07,2184
3576,聯合再生,5,0,5,亞東-新竹,2023-02-07,2184
4747,強生,15,10,5,亞東-新竹,2023-02-07,2184
4545,銘鈺,4,0,4,亞東-新竹,2023-02-07,2184
5536,聖暉*,4,0,4,亞東-新竹,2023-02-07,2184
1605,華新,41,38,3,亞東-新竹,2023-02-07,2184
2892,第一金,3,0,3,亞東-新竹,2023-02-07,2184
3045,台灣大,3,0,3,亞東-新竹,2023-02-07,2184
3093,港建*,3,0,3,亞東-新竹,2023-02-07,2184
3710,連展投控,3,0,3,亞東-新竹,2023-02-07,2184
6613,朋億*,3,0,3,亞東-新竹,2023-02-07,2184
2498,宏達電,12,9,3,亞東-新竹,2023-02-07,2184
3661,世芯-KY,9,6,3,亞東-新竹,2023-02-07,2184
0056,元大高股息,2,0,2,亞東-新竹,2023-02-07,2184
1519,華城,2,0,2,亞東-新竹,2023-02-07,2184
1108,幸福,2,0,2,亞東-新竹,2023-02-07,2184
00675L,富邦臺灣加權正2,2,0,2,亞東-新竹,2023-02-07,2184
1762,中化生,2,0,2,亞東-新竹,2023-02-07,2184
2545,皇翔,2,0,2,亞東-新竹,2023-02-07,2184
3042,晶技,2,0,2,亞東-新竹,2023-02-07,2184
3205,佰研,2,0,2,亞東-新竹,2023-02-07,2184
4564,元翎,2,0,2,亞東-新竹,2023-02-07,2184
5425,台半,2,0,2,亞東-新竹,2023-02-07,2184
6121,新普,2,0,2,亞東-新竹,2023-02-07,2184
6188,廣明,2,0,2,亞東-新竹,2023-02-07,2184
9938,百和,2,0,2,亞東-新竹,2023-02-07,2184
2834,臺企銀,100,7,93,亞東-新竹,2023-02-08,2184
6163,華電網,60,0,60,亞東-新竹,2023-02-08,2184
1402,遠東新,23,0,23,亞東-新竹,2023-02-08,2184
6548,長科*,20,1,19,亞東-新竹,2023-02-08,2184
00679B,元大美債20年,18,0,18,亞東-新竹,2023-02-08,2184
00772B,中信高評級公司債,16,1,15,亞東-新竹,2023-02-08,2184
00632R,元大台灣50反1,14,0,14,亞東-新竹,2023-02-08,2184
2867,三商壽,13,0,13,亞東-新竹,2023-02-08,2184
5425,台半,12,0,12,亞東-新竹,2023-02-08,2184
2891,中信金,11,0,11,亞東-新竹,2023-02-08,2184
2030,彰源,10,0,10,亞東-新竹,2023-02-08,2184
3576,聯合再生,10,0,10,亞東-新竹,2023-02-08,2184
4527,方土霖,10,0,10,亞東-新竹,2023-02-08,2184
4417,金洲,8,0,8,亞東-新竹,2023-02-08,2184
6589,台康生技,25,17,8,亞東-新竹,2023-02-08,2184
00671R,富邦NASDAQ反1,7,0,7,亞東-新竹,2023-02-08,2184
00753L,中信中國50正2,10,3,7,亞東-新竹,2023-02-08,2184
00720B,元大投資級公司債,7,0,7,亞東-新竹,2023-02-08,2184
2364,倫飛,7,0,7,亞東-新竹,2023-02-08,2184
2886,兆豐金,6,0,6,亞東-新竹,2023-02-08,2184
3147,大綜,6,0,6,亞東-新竹,2023-02-08,2184
00878,國泰永續高股息,17,12,5,亞東-新竹,2023-02-08,2184
3141,晶宏,7,2,5,亞東-新竹,2023-02-08,2184
00885,富邦越南,4,0,4,亞東-新竹,2023-02-08,2184
1611,中電,4,0,4,亞東-新竹,2023-02-08,2184
2338,光罩,8,4,4,亞東-新竹,2023-02-08,2184
2442,新美齊,4,0,4,亞東-新竹,2023-02-08,2184
5285,界霖,4,0,4,亞東-新竹,2023-02-08,2184
6275,元山,4,0,4,亞東-新竹,2023-02-08,2184
6806,森崴能源,4,0,4,亞東-新竹,2023-02-08,2184
2201,裕隆,157,154,3,亞東-新竹,2023-02-08,2184
1459,聯發,3,0,3,亞東-新竹,2023-02-08,2184
2308,台達電,3,0,3,亞東-新竹,2023-02-08,2184
2425,承啟,17,14,3,亞東-新竹,2023-02-08,2184
2633,台灣高鐵,3,0,3,亞東-新竹,2023-02-08,2184
3714,富采,3,0,3,亞東-新竹,2023-02-08,2184
4961,天鈺,7,4,3,亞東-新竹,2023-02-08,2184
6411,晶焱,3,0,3,亞東-新竹,2023-02-08,2184
00701,國泰股利精選30,2,0,2,亞東-新竹,2023-02-08,2184
00882,中信中國高股息,2,0,2,亞東-新竹,2023-02-08,2184
1102,亞泥,2,0,2,亞東-新竹,2023-02-08,2184
00893,國泰智能電動車,2,0,2,亞東-新竹,2023-02-08,2184
1722,台肥,3,1,2,亞東-新竹,2023-02-08,2184
2302,麗正,2,0,2,亞東-新竹,2023-02-08,2184
3205,佰研,8,6,2,亞東-新竹,2023-02-08,2184
3227,原相,2,0,2,亞東-新竹,2023-02-08,2184
3682,亞太電,2,0,2,亞東-新竹,2023-02-08,2184
5272,笙科,2,0,2,亞東-新竹,2023-02-08,2184
6116,彩晶,2,0,2,亞東-新竹,2023-02-08,2184
6133,金橋,2,0,2,亞東-新竹,2023-02-08,2184
00751B,元大AAA至A公司債,33,0,33,亞東-新竹,2023-02-09,2184
1104,環泥,22,0,22,亞東-新竹,2023-02-09,2184
00772B,中信高評級公司債,22,1,21,亞東-新竹,2023-02-09,2184
1402,遠東新,21,0,21,亞東-新竹,2023-02-09,2184
00632R,元大台灣50反1,21,0,21,亞東-新竹,2023-02-09,2184
6531,愛普*,25,5,20,亞東-新竹,2023-02-09,2184
00878,國泰永續高股息,17,1,16,亞東-新竹,2023-02-09,2184
6163,華電網,15,0,15,亞東-新竹,2023-02-09,2184
3034,聯詠,15,0,15,亞東-新竹,2023-02-09,2184
1785,光洋科,14,0,14,亞東-新竹,2023-02-09,2184
2344,華邦電,15,3,12,亞東-新竹,2023-02-09,2184
3149,正達,12,0,12,亞東-新竹,2023-02-09,2184
3706,神達,14,2,12,亞東-新竹,2023-02-09,2184
6733,博晟生醫,12,0,12,亞東-新竹,2023-02-09,2184
00679B,元大美債20年,10,0,10,亞東-新竹,2023-02-09,2184
00673R,期元大S＆P原油反1,10,0,10,亞東-新竹,2023-02-09,2184
3218,大學光,10,0,10,亞東-新竹,2023-02-09,2184
4130,健亞,16,6,10,亞東-新竹,2023-02-09,2184
3443,創意,14,4,10,亞東-新竹,2023-02-09,2184
00670L,富邦NASDAQ正2,7,0,7,亞東-新竹,2023-02-09,2184
4153,鈺緯,7,0,7,亞東-新竹,2023-02-09,2184
2603,長榮,8,2,6,亞東-新竹,2023-02-09,2184
3046,建��,6,0,6,亞東-新竹,2023-02-09,2184
4163,鐿鈦,6,0,6,亞東-新竹,2023-02-09,2184
1503,士電,5,0,5,亞東-新竹,2023-02-09,2184
2504,國產,5,0,5,亞東-新竹,2023-02-09,2184
2891,中信金,5,0,5,亞東-新竹,2023-02-09,2184
4961,天鈺,6,1,5,亞東-新竹,2023-02-09,2184
6796,晉弘,5,0,5,亞東-新竹,2023-02-09,2184
8150,南茂,5,0,5,亞東-新竹,2023-02-09,2184
1101,台泥,5,1,4,亞東-新竹,2023-02-09,2184
6719,力智,5,1,4,亞東-新竹,2023-02-09,2184
1513,中興電,6,3,3,亞東-新竹,2023-02-09,2184
6533,晶心科,6,3,3,亞東-新竹,2023-02-09,2184
1219,福壽,3,0,3,亞東-新竹,2023-02-09,2184
00895,富邦未來車,4,1,3,亞東-新竹,2023-02-09,2184
2236,百達-KY,6,3,3,亞東-新竹,2023-02-09,2184
2492,華新科,3,0,3,亞東-新竹,2023-02-09,2184
2610,華航,8,5,3,亞東-新竹,2023-02-09,2184
3504,揚明光,3,0,3,亞東-新竹,2023-02-09,2184
4768,晶呈科技,3,0,3,亞東-新竹,2023-02-09,2184
6281,全國電,3,0,3,亞東-新竹,2023-02-09,2184
9802,鈺齊-KY,3,0,3,亞東-新竹,2023-02-09,2184
00675L,富邦臺灣加權正2,4,2,2,亞東-新竹,2023-02-09,2184
00885,富邦越南,2,0,2,亞東-新竹,2023-02-09,2184
1742,台蠟,2,0,2,亞東-新竹,2023-02-09,2184
2031,新光鋼,2,0,2,亞東-新竹,2023-02-09,2184
2425,承啟,18,16,2,亞東-新竹,2023-02-09,2184
2615,萬海,4,2,2,亞東-新竹,2023-02-09,2184
2812,台中銀,2,0,2,亞東-新竹,2023-02-09,2184
2201,裕隆,79,27,52,亞東-新竹,2023-02-10,2184
6589,台康生技,41,2,39,亞東-新竹,2023-02-10,2184
00751B,元大AAA至A公司債,32,0,32,亞東-新竹,2023-02-10,2184
6550,北極星藥業-KY,31,1,30,亞東-新竹,2023-02-10,2184
00772B,中信高評級公司債,30,2,28,亞東-新竹,2023-02-10,2184
00679B,元大美債20年,23,0,23,亞東-新竹,2023-02-10,2184
00632R,元大台灣50反1,22,0,22,亞東-新竹,2023-02-10,2184
00715L,期街口布蘭特正2,20,0,20,亞東-新竹,2023-02-10,2184
4743,合一,28,8,20,亞東-新竹,2023-02-10,2184
9904,寶成,20,0,20,亞東-新竹,2023-02-10,2184
6770,力積電,28,10,18,亞東-新竹,2023-02-10,2184
00878,國泰永續高股息,17,0,17,亞東-新竹,2023-02-10,2184
2409,友達,15,0,15,亞東-新竹,2023-02-10,2184
6129,普誠,14,0,14,亞東-新竹,2023-02-10,2184
6288,聯嘉,14,0,14,亞東-新竹,2023-02-10,2184
4153,鈺緯,12,0,12,亞東-新竹,2023-02-10,2184
00720B,元大投資級公司債,11,0,11,亞東-新竹,2023-02-10,2184
1789,神隆,11,0,11,亞東-新竹,2023-02-10,2184
2498,宏達電,11,0,11,亞東-新竹,2023-02-10,2184
1612,宏泰,11,1,10,亞東-新竹,2023-02-10,2184
2618,長榮航,10,0,10,亞東-新竹,2023-02-10,2184
8261,富鼎,10,0,10,亞東-新竹,2023-02-10,2184
8349,�矬�,10,0,10,亞東-新竹,2023-02-10,2184
2603,長榮,12,3,9,亞東-新竹,2023-02-10,2184
1785,光洋科,9,0,9,亞東-新竹,2023-02-10,2184
2929,淘帝-KY,10,1,9,亞東-新竹,2023-02-10,2184
00670L,富邦NASDAQ正2,8,0,8,亞東-新竹,2023-02-10,2184
2357,華碩,8,0,8,亞東-新竹,2023-02-10,2184
2405,輔信,8,0,8,亞東-新竹,2023-02-10,2184
4763,材料-KY,8,0,8,亞東-新竹,2023-02-10,2184
6269,台郡,7,0,7,亞東-新竹,2023-02-10,2184
6446,藥華藥,7,0,7,亞東-新竹,2023-02-10,2184
1104,環泥,6,0,6,亞東-新竹,2023-02-10,2184
00753L,中信中國50正2,6,0,6,亞東-新竹,2023-02-10,2184
3374,精材,9,3,6,亞東-新竹,2023-02-10,2184
3162,精確,5,0,5,亞東-新竹,2023-02-10,2184
3037,欣興,5,0,5,亞東-新竹,2023-02-10,2184
1301,台塑,5,0,5,亞東-新竹,2023-02-10,2184
2489,瑞軒,5,0,5,亞東-新竹,2023-02-10,2184
2888,新光金,5,0,5,亞東-新竹,2023-02-10,2184
4931,新盛力,25,20,5,亞東-新竹,2023-02-10,2184
6187,萬潤,5,0,5,亞東-新竹,2023-02-10,2184
6195,詩肯,5,0,5,亞東-新竹,2023-02-10,2184
2609,陽明,4,0,4,亞東-新竹,2023-02-10,2184
6531,愛普*,6,2,4,亞東-新竹,2023-02-10,2184
2344,華邦電,5,1,4,亞東-新竹,2023-02-10,2184
2484,希華,7,3,4,亞東-新竹,2023-02-10,2184
3105,穩懋,6,2,4,亞東-新竹,2023-02-10,2184
4952,凌通,4,0,4,亞東-新竹,2023-02-10,2184
5009,榮剛,5,1,4,亞東-新竹,2023-02-10,2184
00878,國泰永續高股息,42,6,36,亞東-新竹,2023-02-13,2184
00751B,元大AAA至A公司債,30,0,30,亞東-新竹,2023-02-13,2184
4114,健喬,23,1,22,亞東-新竹,2023-02-13,2184
1503,士電,20,0,20,亞東-新竹,2023-02-13,2184
00676R,富邦臺灣加權反1,20,0,20,亞東-新竹,2023-02-13,2184
2634,漢翔,25,5,20,亞東-新竹,2023-02-13,2184
5469,瀚宇博,20,0,20,亞東-新竹,2023-02-13,2184
00679B,元大美債20年,14,0,14,亞東-新竹,2023-02-13,2184
6625,必應,13,0,13,亞東-新竹,2023-02-13,2184
2409,友達,12,0,12,亞東-新竹,2023-02-13,2184
2603,長榮,21,10,11,亞東-新竹,2023-02-13,2184
00673R,期元大S＆P原油反1,10,0,10,亞東-新竹,2023-02-13,2184
00687B,國泰20年美債,10,0,10,亞東-新竹,2023-02-13,2184
6168,宏齊,11,1,10,亞東-新竹,2023-02-13,2184
6770,力積電,20,10,10,亞東-新竹,2023-02-13,2184
2330,台積電,10,0,10,亞東-新竹,2023-02-13,2184
00720B,元大投資級公司債,8,0,8,亞東-新竹,2023-02-13,2184
2889,國票金,7,0,7,亞東-新竹,2023-02-13,2184
6248,沛波,7,0,7,亞東-新竹,2023-02-13,2184
00763U,期街口道瓊銅,5,0,5,亞東-新竹,2023-02-13,2184
2201,裕隆,11,6,5,亞東-新竹,2023-02-13,2184
2344,華邦電,5,0,5,亞東-新竹,2023-02-13,2184
2888,新光金,5,0,5,亞東-新竹,2023-02-13,2184
6188,廣明,5,0,5,亞東-新竹,2023-02-13,2184
2364,倫飛,6,2,4,亞東-新竹,2023-02-13,2184
00882,中信中國高股息,3,0,3,亞東-新竹,2023-02-13,2184
2303,聯電,7,4,3,亞東-新竹,2023-02-13,2184
2615,萬海,4,1,3,亞東-新竹,2023-02-13,2184
3013,晟銘電,3,0,3,亞東-新竹,2023-02-13,2184
3027,盛達,3,0,3,亞東-新竹,2023-02-13,2184
3284,太普高,3,0,3,亞東-新竹,2023-02-13,2184
3454,晶睿,7,4,3,亞東-新竹,2023-02-13,2184
4747,強生,4,1,3,亞東-新竹,2023-02-13,2184
6589,台康生技,3,0,3,亞東-新竹,2023-02-13,2184
8222,寶一,4,1,3,亞東-新竹,2023-02-13,2184
8227,巨有科技,3,0,3,亞東-新竹,2023-02-13,2184
8261,富鼎,3,0,3,亞東-新竹,2023-02-13,2184
8478,東哥遊艇,3,0,3,亞東-新竹,2023-02-13,2184
2609,陽明,4,2,2,亞東-新竹,2023-02-13,2184
1519,華城,2,0,2,亞東-新竹,2023-02-13,2184
00893,國泰智能電動車,2,0,2,亞東-新竹,2023-02-13,2184
2328,廣宇,2,0,2,亞東-新竹,2023-02-13,2184
2337,旺宏,2,0,2,亞東-新竹,2023-02-13,2184
2379,瑞昱,2,0,2,亞東-新竹,2023-02-13,2184
2425,承啟,8,6,2,亞東-新竹,2023-02-13,2184
2492,華新科,2,0,2,亞東-新竹,2023-02-13,2184
2886,兆豐金,2,0,2,亞東-新竹,2023-02-13,2184
3034,聯詠,3,1,2,亞東-新竹,2023-02-13,2184
3094,聯傑,2,0,2,亞東-新竹,2023-02-13,2184
3128,昇銳,8,6,2,亞東-新竹,2023-02-13,2184
6163,華電網,50,0,50,亞東-新竹,2023-02-14,2184
00632R,元大台灣50反1,57,10,47,亞東-新竹,2023-02-14,2184
1216,統一,44,0,44,亞東-新竹,2023-02-14,2184
4114,健喬,44,0,44,亞東-新竹,2023-02-14,2184
8050,廣積,37,0,37,亞東-新竹,2023-02-14,2184
2897,王道銀行,30,0,30,亞東-新竹,2023-02-14,2184
1402,遠東新,20,0,20,亞東-新竹,2023-02-14,2184
2388,威盛,29,14,15,亞東-新竹,2023-02-14,2184
2471,資通,17,2,15,亞東-新竹,2023-02-14,2184
3704,合勤控,15,1,14,亞東-新竹,2023-02-14,2184
00878,國泰永續高股息,15,1,14,亞東-新竹,2023-02-14,2184
2206,三陽工業,10,0,10,亞東-新竹,2023-02-14,2184
00673R,期元大S＆P原油反1,10,0,10,亞東-新竹,2023-02-14,2184
3653,健策,10,0,10,亞東-新竹,2023-02-14,2184
5876,上海商銀,10,0,10,亞東-新竹,2023-02-14,2184
4938,和碩,10,1,9,亞東-新竹,2023-02-14,2184
8016,矽創,8,0,8,亞東-新竹,2023-02-14,2184
8996,高力,9,2,7,亞東-新竹,2023-02-14,2184
9958,世紀鋼,9,2,7,亞東-新竹,2023-02-14,2184
2634,漢翔,9,3,6,亞東-新竹,2023-02-14,2184
3149,正達,6,0,6,亞東-新竹,2023-02-14,2184
00679B,元大美債20年,5,0,5,亞東-新竹,2023-02-14,2184
2547,日勝生,5,0,5,亞東-新竹,2023-02-14,2184
2888,新光金,10,5,5,亞東-新竹,2023-02-14,2184
5009,榮剛,5,0,5,亞東-新竹,2023-02-14,2184
5388,中磊,5,0,5,亞東-新竹,2023-02-14,2184
6288,聯嘉,10,5,5,亞東-新竹,2023-02-14,2184
6579,研揚,5,0,5,亞東-新竹,2023-02-14,2184
8227,巨有科技,5,0,5,亞東-新竹,2023-02-14,2184
2028,威致,4,0,4,亞東-新竹,2023-02-14,2184
2201,裕隆,10,6,4,亞東-新竹,2023-02-14,2184
2332,友訊,4,0,4,亞東-新竹,2023-02-14,2184
2344,華邦電,4,0,4,亞東-新竹,2023-02-14,2184
5475,德宏,4,0,4,亞東-新竹,2023-02-14,2184
8069,元太,4,0,4,亞東-新竹,2023-02-14,2184
1721,三晃,3,0,3,亞東-新竹,2023-02-14,2184
2481,強茂,3,0,3,亞東-新竹,2023-02-14,2184
2731,雄獅,3,0,3,亞東-新竹,2023-02-14,2184
2884,玉山金,3,0,3,亞東-新竹,2023-02-14,2184
3029,零壹,3,0,3,亞東-新竹,2023-02-14,2184
4736,泰博,3,0,3,亞東-新竹,2023-02-14,2184
6733,博晟生醫,3,0,3,亞東-新竹,2023-02-14,2184
3661,世芯-KY,15,13,2,亞東-新竹,2023-02-14,2184
1101,台泥,4,2,2,亞東-新竹,2023-02-14,2184
1605,華新,9,7,2,亞東-新竹,2023-02-14,2184
1210,大成,2,0,2,亞東-新竹,2023-02-14,2184
0056,元大高股息,2,0,2,亞東-新竹,2023-02-14,2184
00882,中信中國高股息,2,0,2,亞東-新竹,2023-02-14,2184
2338,光罩,2,0,2,亞東-新竹,2023-02-14,2184
2379,瑞昱,4,2,2,亞東-新竹,2023-02-14,2184
5905,南仁湖,90,0,90,亞東-新竹,2023-02-15,2184
00878,國泰永續高股息,69,4,65,亞東-新竹,2023-02-15,2184
2330,台積電,56,11,45,亞東-新竹,2023-02-15,2184
2201,裕隆,43,10,33,亞東-新竹,2023-02-15,2184
2618,長榮航,56,26,30,亞東-新竹,2023-02-15,2184
1569,濱川,23,2,21,亞東-新竹,2023-02-15,2184
6168,宏齊,20,0,20,亞東-新竹,2023-02-15,2184
6550,北極星藥業-KY,20,0,20,亞東-新竹,2023-02-15,2184
2603,長榮,17,1,16,亞東-新竹,2023-02-15,2184
6770,力積電,14,0,14,亞東-新竹,2023-02-15,2184
2504,國產,10,0,10,亞東-新竹,2023-02-15,2184
2812,台中銀,10,0,10,亞東-新竹,2023-02-15,2184
5469,瀚宇博,10,0,10,亞東-新竹,2023-02-15,2184
00673R,期元大S＆P原油反1,10,1,9,亞東-新竹,2023-02-15,2184
00671R,富邦NASDAQ反1,8,0,8,亞東-新竹,2023-02-15,2184
3211,順達,8,0,8,亞東-新竹,2023-02-15,2184
00753L,中信中國50正2,7,0,7,亞東-新竹,2023-02-15,2184
2486,一詮,7,0,7,亞東-新竹,2023-02-15,2184
2609,陽明,7,0,7,亞東-新竹,2023-02-15,2184
2303,聯電,15,8,7,亞東-新竹,2023-02-15,2184
2023,燁輝,6,0,6,亞東-新竹,2023-02-15,2184
4919,新唐,11,5,6,亞東-新竹,2023-02-15,2184
00631L,元大台灣50正2,9,3,6,亞東-新竹,2023-02-15,2184
00715L,期街口布蘭特正2,5,0,5,亞東-新竹,2023-02-15,2184
00637L,元大滬深300正2,12,7,5,亞東-新竹,2023-02-15,2184
2388,威盛,20,15,5,亞東-新竹,2023-02-15,2184
2886,兆豐金,5,0,5,亞東-新竹,2023-02-15,2184
2891,中信金,5,0,5,亞東-新竹,2023-02-15,2184
2882,國泰金,5,0,5,亞東-新竹,2023-02-15,2184
00675L,富邦臺灣加權正2,4,0,4,亞東-新竹,2023-02-15,2184
00900,富邦特選高股息30,4,0,4,亞東-新竹,2023-02-15,2184
3540,曜越,4,0,4,亞東-新竹,2023-02-15,2184
8044,網家,4,0,4,亞東-新竹,2023-02-15,2184
2454,聯發科,3,0,3,亞東-新竹,2023-02-15,2184
3189,景碩,3,0,3,亞東-新竹,2023-02-15,2184
00882,中信中國高股息,3,0,3,亞東-新竹,2023-02-15,2184
2027,大成鋼,3,0,3,亞東-新竹,2023-02-15,2184
2028,威致,3,0,3,亞東-新竹,2023-02-15,2184
2615,萬海,4,1,3,亞東-新竹,2023-02-15,2184
2801,彰銀,3,0,3,亞東-新竹,2023-02-15,2184
3128,昇銳,3,0,3,亞東-新竹,2023-02-15,2184
3528,安馳,3,0,3,亞東-新竹,2023-02-15,2184
5347,世界,4,1,3,亞東-新竹,2023-02-15,2184
5410,國眾,3,0,3,亞東-新竹,2023-02-15,2184
6235,華孚,8,5,3,亞東-新竹,2023-02-15,2184
6441,廣錠,3,0,3,亞東-新竹,2023-02-15,2184
0050,元大台灣50,4,2,2,亞東-新竹,2023-02-15,2184
1304,台聚,2,0,2,亞東-新竹,2023-02-15,2184
0056,元大高股息,2,0,2,亞東-新竹,2023-02-15,2184
00680L,元大美債20正2,2,0,2,亞東-新竹,2023-02-15,2184
00878,國泰永續高股息,140,10,130,亞東-新竹,2023-02-16,2184
00679B,元大美債20年,126,0,126,亞東-新竹,2023-02-16,2184
1584,精剛,100,0,100,亞東-新竹,2023-02-16,2184
2834,臺企銀,100,0,100,亞東-新竹,2023-02-16,2184
2014,中鴻,90,0,90,亞東-新竹,2023-02-16,2184
1605,華新,53,4,49,亞東-新竹,2023-02-16,2184
2369,菱生,49,0,49,亞東-新竹,2023-02-16,2184
00632R,元大台灣50反1,43,0,43,亞東-新竹,2023-02-16,2184
00751B,元大AAA至A公司債,30,0,30,亞東-新竹,2023-02-16,2184
2702,華園,25,0,25,亞東-新竹,2023-02-16,2184
3264,欣銓,15,0,15,亞東-新竹,2023-02-16,2184
1513,中興電,13,0,13,亞東-新竹,2023-02-16,2184
2904,匯僑,13,0,13,亞東-新竹,2023-02-16,2184
2867,三商壽,10,0,10,亞東-新竹,2023-02-16,2184
6505,台塑化,10,0,10,亞東-新竹,2023-02-16,2184
3710,連展投控,12,3,9,亞東-新竹,2023-02-16,2184
5469,瀚宇博,10,1,9,亞東-新竹,2023-02-16,2184
00671R,富邦NASDAQ反1,8,0,8,亞東-新竹,2023-02-16,2184
1611,中電,7,0,7,亞東-新竹,2023-02-16,2184
00631L,元大台灣50正2,7,0,7,亞東-新竹,2023-02-16,2184
2028,威致,7,0,7,亞東-新竹,2023-02-16,2184
2481,強茂,10,3,7,亞東-新竹,2023-02-16,2184
3289,宜特,7,0,7,亞東-新竹,2023-02-16,2184
3661,世芯-KY,25,18,7,亞東-新竹,2023-02-16,2184
4541,晟田,7,0,7,亞東-新竹,2023-02-16,2184
00885,富邦越南,6,0,6,亞東-新竹,2023-02-16,2184
00772B,中信高評級公司債,6,0,6,亞東-新竹,2023-02-16,2184
1612,宏泰,6,0,6,亞東-新竹,2023-02-16,2184
5536,聖暉*,6,0,6,亞東-新竹,2023-02-16,2184
00773B,中信優先金融債,5,0,5,亞東-新竹,2023-02-16,2184
2455,全新,5,0,5,亞東-新竹,2023-02-16,2184
2457,飛宏,5,0,5,亞東-新竹,2023-02-16,2184
4114,健喬,5,0,5,亞東-新竹,2023-02-16,2184
5269,祥碩,5,0,5,亞東-新竹,2023-02-16,2184
8088,品安,5,0,5,亞東-新竹,2023-02-16,2184
9914,美利達,5,0,5,亞東-新竹,2023-02-16,2184
3443,創意,30,26,4,亞東-新竹,2023-02-16,2184
3189,景碩,3,0,3,亞東-新竹,2023-02-16,2184
1101,台泥,4,1,3,亞東-新竹,2023-02-16,2184
00893,國泰智能電動車,3,0,3,亞東-新竹,2023-02-16,2184
2472,立隆電,3,0,3,亞東-新竹,2023-02-16,2184
6547,高端疫苗,3,0,3,亞東-新竹,2023-02-16,2184
8936,國統,3,0,3,亞東-新竹,2023-02-16,2184
5871,中租-KY,2,0,2,亞東-新竹,2023-02-16,2184
1314,中石化,2,0,2,亞東-新竹,2023-02-16,2184
1268,漢來美食,2,0,2,亞東-新竹,2023-02-16,2184
00682U,期元大美元指數,2,0,2,亞東-新竹,2023-02-16,2184
2476,鉅祥,2,0,2,亞東-新竹,2023-02-16,2184
2486,一詮,2,0,2,亞東-新竹,2023-02-16,2184
2637,慧洋-KY,2,0,2,亞東-新竹,2023-02-16,2184
1584,精剛,150,0,150,亞東-新竹,2023-02-17,2184
2002,中鋼,95,0,95,亞東-新竹,2023-02-17,2184
1102,亞泥,70,0,70,亞東-新竹,2023-02-17,2184
00751B,元大AAA至A公司債,60,0,60,亞東-新竹,2023-02-17,2184
00878,國泰永續高股息,44,1,43,亞東-新竹,2023-02-17,2184
00679B,元大美債20年,31,1,30,亞東-新竹,2023-02-17,2184
6505,台塑化,27,0,27,亞東-新竹,2023-02-17,2184
2614,東森,26,0,26,亞東-新竹,2023-02-17,2184
2028,威致,25,0,25,亞東-新竹,2023-02-17,2184
3209,全科,23,2,21,亞東-新竹,2023-02-17,2184
00877,復華中國5G,20,0,20,亞東-新竹,2023-02-17,2184
00772B,中信高評級公司債,17,0,17,亞東-新竹,2023-02-17,2184
2618,長榮航,46,31,15,亞東-新竹,2023-02-17,2184
2867,三商壽,15,0,15,亞東-新竹,2023-02-17,2184
2330,台積電,18,4,14,亞東-新竹,2023-02-17,2184
00893,國泰智能電動車,13,0,13,亞東-新竹,2023-02-17,2184
6235,華孚,15,2,13,亞東-新竹,2023-02-17,2184
6788,華景電,12,0,12,亞東-新竹,2023-02-17,2184
1314,中石化,10,0,10,亞東-新竹,2023-02-17,2184
00795B,中信美國公債20年,10,0,10,亞東-新竹,2023-02-17,2184
00665L,富邦�琤肭磪囓�2,10,0,10,亞東-新竹,2023-02-17,2184
00687B,國泰20年美債,10,0,10,亞東-新竹,2023-02-17,2184
2458,義隆,10,0,10,亞東-新竹,2023-02-17,2184
3062,建漢,10,0,10,亞東-新竹,2023-02-17,2184
3711,日月光投控,10,0,10,亞東-新竹,2023-02-17,2184
5258,虹堡,10,0,10,亞東-新竹,2023-02-17,2184
6109,亞元,10,0,10,亞東-新竹,2023-02-17,2184
6550,北極星藥業-KY,10,0,10,亞東-新竹,2023-02-17,2184
2201,裕隆,23,14,9,亞東-新竹,2023-02-17,2184
3704,合勤控,10,1,9,亞東-新竹,2023-02-17,2184
8048,德勝,9,0,9,亞東-新竹,2023-02-17,2184
00720B,元大投資級公司債,8,0,8,亞東-新竹,2023-02-17,2184
3454,晶睿,11,3,8,亞東-新竹,2023-02-17,2184
9962,有益,8,0,8,亞東-新竹,2023-02-17,2184
00753L,中信中國50正2,8,0,8,亞東-新竹,2023-02-17,2184
00757,統一FANG+,7,0,7,亞東-新竹,2023-02-17,2184
6770,力積電,16,10,6,亞東-新竹,2023-02-17,2184
00830,國泰費城半導體,6,0,6,亞東-新竹,2023-02-17,2184
00670L,富邦NASDAQ正2,6,0,6,亞東-新竹,2023-02-17,2184
2303,聯電,15,9,6,亞東-新竹,2023-02-17,2184
2308,台達電,6,0,6,亞東-新竹,2023-02-17,2184
2603,長榮,9,3,6,亞東-新竹,2023-02-17,2184
5263,智崴,6,0,6,亞東-新竹,2023-02-17,2184
6168,宏齊,6,0,6,亞東-新竹,2023-02-17,2184
3037,欣興,8,3,5,亞東-新竹,2023-02-17,2184
5483,中美晶,5,0,5,亞東-新竹,2023-02-17,2184
00725B,國泰投資級公司債,5,0,5,亞東-新竹,2023-02-17,2184
1609,大亞,5,0,5,亞東-新竹,2023-02-17,2184
1720,生達,5,0,5,亞東-新竹,2023-02-17,2184
2329,華泰,5,0,5,亞東-新竹,2023-02-17,2184
3710,連展投控,101,0,101,亞東-新竹,2023-02-20,2184
2867,三商壽,95,0,95,亞東-新竹,2023-02-20,2184
00751B,元大AAA至A公司債,45,0,45,亞東-新竹,2023-02-20,2184
2468,華經,35,0,35,亞東-新竹,2023-02-20,2184
2883,凱基金,31,0,31,亞東-新竹,2023-02-20,2184
2028,威致,26,1,25,亞東-新竹,2023-02-20,2184
2610,華航,31,10,21,亞東-新竹,2023-02-20,2184
1104,環泥,20,0,20,亞東-新竹,2023-02-20,2184
2329,華泰,20,0,20,亞東-新竹,2023-02-20,2184
2462,良得電,20,0,20,亞東-新竹,2023-02-20,2184
8421,旭源,20,0,20,亞東-新竹,2023-02-20,2184
8091,翔名,18,0,18,亞東-新竹,2023-02-20,2184
1783,和康生,17,0,17,亞東-新竹,2023-02-20,2184
00878,國泰永續高股息,15,0,15,亞東-新竹,2023-02-20,2184
2317,鴻海,16,1,15,亞東-新竹,2023-02-20,2184
1442,名軒,12,0,12,亞東-新竹,2023-02-20,2184
6609,瀧澤科,12,0,12,亞東-新竹,2023-02-20,2184
3034,聯詠,14,3,11,亞東-新竹,2023-02-20,2184
0050,元大台灣50,10,0,10,亞東-新竹,2023-02-20,2184
1443,立益物流,10,0,10,亞東-新竹,2023-02-20,2184
4934,太極,10,0,10,亞東-新竹,2023-02-20,2184
6116,彩晶,10,0,10,亞東-新竹,2023-02-20,2184
6603,富強鑫,10,0,10,亞東-新竹,2023-02-20,2184
6788,華景電,10,0,10,亞東-新竹,2023-02-20,2184
8261,富鼎,10,0,10,亞東-新竹,2023-02-20,2184
8936,國統,14,4,10,亞東-新竹,2023-02-20,2184
2330,台積電,12,2,10,亞東-新竹,2023-02-20,2184
1529,樂事綠能,8,0,8,亞東-新竹,2023-02-20,2184
1701,中化,8,0,8,亞東-新竹,2023-02-20,2184
00720B,元大投資級公司債,8,0,8,亞東-新竹,2023-02-20,2184
5351,鈺創,7,0,7,亞東-新竹,2023-02-20,2184
6541,泰福-KY,7,0,7,亞東-新竹,2023-02-20,2184
8109,博大,7,0,7,亞東-新竹,2023-02-20,2184
1438,三地開發,6,0,6,亞東-新竹,2023-02-20,2184
00760B,復華新興企業債,6,0,6,亞東-新竹,2023-02-20,2184
1752,南光,6,0,6,亞東-新竹,2023-02-20,2184
2546,根基,6,0,6,亞東-新竹,2023-02-20,2184
4977,眾達-KY,6,0,6,亞東-新竹,2023-02-20,2184
5478,智冠,6,0,6,亞東-新竹,2023-02-20,2184
6214,精誠,6,0,6,亞東-新竹,2023-02-20,2184
8046,南電,6,0,6,亞東-新竹,2023-02-20,2184
1709,和益,5,0,5,亞東-新竹,2023-02-20,2184
1535,中宇,5,0,5,亞東-新竹,2023-02-20,2184
2006,東和鋼鐵,5,0,5,亞東-新竹,2023-02-20,2184
2349,錸德,5,0,5,亞東-新竹,2023-02-20,2184
2450,神腦,5,0,5,亞東-新竹,2023-02-20,2184
2904,匯僑,5,0,5,亞東-新竹,2023-02-20,2184
4545,銘鈺,5,0,5,亞東-新竹,2023-02-20,2184
4563,百德,5,0,5,亞東-新竹,2023-02-20,2184
6180,橘子,5,0,5,亞東-新竹,2023-02-20,2184
6235,華孚,118,2,116,亞東-新竹,2023-02-21,2184
2883,凱基金,200,100,100,亞東-新竹,2023-02-21,2184
2867,三商壽,80,0,80,亞東-新竹,2023-02-21,2184
2884,玉山金,88,10,78,亞東-新竹,2023-02-21,2184
4960,誠美材,50,0,50,亞東-新竹,2023-02-21,2184
2201,裕隆,59,19,40,亞東-新竹,2023-02-21,2184
00751B,元大AAA至A公司債,31,0,31,亞東-新竹,2023-02-21,2184
5353,台林,30,1,29,亞東-新竹,2023-02-21,2184
00720B,元大投資級公司債,23,0,23,亞東-新竹,2023-02-21,2184
2610,華航,33,11,22,亞東-新竹,2023-02-21,2184
6485,點序,16,0,16,亞東-新竹,2023-02-21,2184
5469,瀚宇博,15,0,15,亞東-新竹,2023-02-21,2184
00885,富邦越南,13,0,13,亞東-新竹,2023-02-21,2184
2027,大成鋼,14,1,13,亞東-新竹,2023-02-21,2184
3027,盛達,15,3,12,亞東-新竹,2023-02-21,2184
1506,正道,11,0,11,亞東-新竹,2023-02-21,2184
6443,元晶,11,0,11,亞東-新竹,2023-02-21,2184
8261,富鼎,11,0,11,亞東-新竹,2023-02-21,2184
9904,寶成,11,0,11,亞東-新竹,2023-02-21,2184
00632R,元大台灣50反1,10,0,10,亞東-新竹,2023-02-21,2184
00665L,富邦�琤肭磪囓�2,10,0,10,亞東-新竹,2023-02-21,2184
2329,華泰,10,0,10,亞東-新竹,2023-02-21,2184
3653,健策,10,0,10,亞東-新竹,2023-02-21,2184
5202,力新,10,0,10,亞東-新竹,2023-02-21,2184
5876,上海商銀,10,0,10,亞東-新竹,2023-02-21,2184
2891,中信金,8,0,8,亞東-新竹,2023-02-21,2184
00753L,中信中國50正2,10,2,8,亞東-新竹,2023-02-21,2184
1584,精剛,8,1,7,亞東-新竹,2023-02-21,2184
2618,長榮航,7,0,7,亞東-新竹,2023-02-21,2184
2208,台船,6,0,6,亞東-新竹,2023-02-21,2184
6133,金橋,6,0,6,亞東-新竹,2023-02-21,2184
2317,鴻海,15,10,5,亞東-新竹,2023-02-21,2184
1817,凱撒衛,5,0,5,亞東-新竹,2023-02-21,2184
2444,兆勁,5,0,5,亞東-新竹,2023-02-21,2184
3419,譁裕,5,0,5,亞東-新竹,2023-02-21,2184
3504,揚明光,5,0,5,亞東-新竹,2023-02-21,2184
3528,安馳,5,0,5,亞東-新竹,2023-02-21,2184
4931,新盛力,5,0,5,亞東-新竹,2023-02-21,2184
00772B,中信高評級公司債,4,0,4,亞東-新竹,2023-02-21,2184
2897,王道銀行,5,1,4,亞東-新竹,2023-02-21,2184
3289,宜特,4,0,4,亞東-新竹,2023-02-21,2184
6416,瑞祺電通,4,0,4,亞東-新竹,2023-02-21,2184
8433,弘帆,4,0,4,亞東-新竹,2023-02-21,2184
2330,台積電,3,0,3,亞東-新竹,2023-02-21,2184
2028,威致,3,0,3,亞東-新竹,2023-02-21,2184
2351,順德,3,0,3,亞東-新竹,2023-02-21,2184
2409,友達,10,7,3,亞東-新竹,2023-02-21,2184
2904,匯僑,3,0,3,亞東-新竹,2023-02-21,2184
3264,欣銓,3,0,3,亞東-新竹,2023-02-21,2184
3444,利機,3,0,3,亞東-新竹,2023-02-21,2184
3276,宇環,200,0,200,亞東-新竹,2023-02-22,2184
00632R,元大台灣50反1,190,46,144,亞東-新竹,2023-02-22,2184
3027,盛達,128,8,120,亞東-新竹,2023-02-22,2184
1584,精剛,131,13,118,亞東-新竹,2023-02-22,2184
4168,醣聯,102,1,101,亞東-新竹,2023-02-22,2184
00751B,元大AAA至A公司債,92,0,92,亞東-新竹,2023-02-22,2184
00878,國泰永續高股息,73,6,67,亞東-新竹,2023-02-22,2184
1810,和成,56,5,51,亞東-新竹,2023-02-22,2184
3034,聯詠,28,1,27,亞東-新竹,2023-02-22,2184
00885,富邦越南,24,1,23,亞東-新竹,2023-02-22,2184
00902,中信電池及儲能,21,0,21,亞東-新竹,2023-02-22,2184
2027,大成鋼,21,0,21,亞東-新竹,2023-02-22,2184
4114,健喬,24,3,21,亞東-新竹,2023-02-22,2184
00720B,元大投資級公司債,20,0,20,亞東-新竹,2023-02-22,2184
8111,立��,20,0,20,亞東-新竹,2023-02-22,2184
00772B,中信高評級公司債,19,0,19,亞東-新竹,2023-02-22,2184
2618,長榮航,19,1,18,亞東-新竹,2023-02-22,2184
2303,聯電,18,1,17,亞東-新竹,2023-02-22,2184
1514,亞力,22,7,15,亞東-新竹,2023-02-22,2184
9802,鈺齊-KY,13,0,13,亞東-新竹,2023-02-22,2184
6788,華景電,12,0,12,亞東-新竹,2023-02-22,2184
3037,欣興,11,1,10,亞東-新竹,2023-02-22,2184
2317,鴻海,10,0,10,亞東-新竹,2023-02-22,2184
3062,建漢,10,0,10,亞東-新竹,2023-02-22,2184
3558,神準,12,2,10,亞東-新竹,2023-02-22,2184
4137,麗豐-KY,10,0,10,亞東-新竹,2023-02-22,2184
4931,新盛力,10,0,10,亞東-新竹,2023-02-22,2184
00830,國泰費城半導體,8,0,8,亞東-新竹,2023-02-22,2184
2201,裕隆,12,4,8,亞東-新竹,2023-02-22,2184
8937,合騏,8,0,8,亞東-新竹,2023-02-22,2184
2388,威盛,19,11,8,亞東-新竹,2023-02-22,2184
3035,智原,7,0,7,亞東-新竹,2023-02-22,2184
5263,智崴,7,0,7,亞東-新竹,2023-02-22,2184
6257,矽格,8,1,7,亞東-新竹,2023-02-22,2184
2308,台達電,6,0,6,亞東-新竹,2023-02-22,2184
2498,宏達電,6,0,6,亞東-新竹,2023-02-22,2184
6443,元晶,7,1,6,亞東-新竹,2023-02-22,2184
1707,葡萄王,6,0,6,亞東-新竹,2023-02-22,2184
00896,中信綠能及電動車,5,0,5,亞東-新竹,2023-02-22,2184
00893,國泰智能電動車,5,0,5,亞東-新竹,2023-02-22,2184
1785,光洋科,5,0,5,亞東-新竹,2023-02-22,2184
2337,旺宏,5,0,5,亞東-新竹,2023-02-22,2184
2887,台新金,5,0,5,亞東-新竹,2023-02-22,2184
2888,新光金,5,0,5,亞東-新竹,2023-02-22,2184
3520,華盈,5,0,5,亞東-新竹,2023-02-22,2184
6142,友勁,5,0,5,亞東-新竹,2023-02-22,2184
8097,常珵,5,0,5,亞東-新竹,2023-02-22,2184
9934,成霖,5,0,5,亞東-新竹,2023-02-22,2184
1336,台翰,4,0,4,亞東-新竹,2023-02-22,2184
2834,臺企銀,4,0,4,亞東-新竹,2023-02-22,2184
00751B,元大AAA至A公司債,130,0,130,亞東-新竹,2023-02-23,2184
2883,凱基金,103,0,103,亞東-新竹,2023-02-23,2184
2867,三商壽,50,0,50,亞東-新竹,2023-02-23,2184
3027,盛達,52,2,50,亞東-新竹,2023-02-23,2184
6235,華孚,57,7,50,亞東-新竹,2023-02-23,2184
00671R,富邦NASDAQ反1,45,0,45,亞東-新竹,2023-02-23,2184
2618,長榮航,44,3,41,亞東-新竹,2023-02-23,2184
2705,六福,35,0,35,亞東-新竹,2023-02-23,2184
2884,玉山金,38,6,32,亞東-新竹,2023-02-23,2184
2913,農林,32,0,32,亞東-新竹,2023-02-23,2184
9962,有益,30,0,30,亞東-新竹,2023-02-23,2184
1108,幸福,32,3,29,亞東-新竹,2023-02-23,2184
00878,國泰永續高股息,27,0,27,亞東-新竹,2023-02-23,2184
4137,麗豐-KY,25,0,25,亞東-新竹,2023-02-23,2184
00720B,元大投資級公司債,24,0,24,亞東-新竹,2023-02-23,2184
00715L,期街口布蘭特正2,22,0,22,亞東-新竹,2023-02-23,2184
2734,易飛網,20,0,20,亞東-新竹,2023-02-23,2184
3265,台星科,20,0,20,亞東-新竹,2023-02-23,2184
6168,宏齊,20,0,20,亞東-新竹,2023-02-23,2184
5353,台林,20,0,20,亞東-新竹,2023-02-23,2184
2014,中鴻,20,0,20,亞東-新竹,2023-02-23,2184
2704,國賓,18,0,18,亞東-新竹,2023-02-23,2184
5469,瀚宇博,15,0,15,亞東-新竹,2023-02-23,2184
00679B,元大美債20年,14,0,14,亞東-新竹,2023-02-23,2184
4729,熒茂,12,0,12,亞東-新竹,2023-02-23,2184
8936,國統,13,1,12,亞東-新竹,2023-02-23,2184
5608,四維航,19,8,11,亞東-新竹,2023-02-23,2184
00683L,期元大美元指正2,10,0,10,亞東-新竹,2023-02-23,2184
2504,國產,10,0,10,亞東-新竹,2023-02-23,2184
2904,匯僑,10,0,10,亞東-新竹,2023-02-23,2184
4541,晟田,10,0,10,亞東-新竹,2023-02-23,2184
6188,廣明,10,0,10,亞東-新竹,2023-02-23,2184
6770,力積電,10,0,10,亞東-新竹,2023-02-23,2184
3037,欣興,13,4,9,亞東-新竹,2023-02-23,2184
5347,世界,11,2,9,亞東-新竹,2023-02-23,2184
6220,岳豐,9,0,9,亞東-新竹,2023-02-23,2184
00637L,元大滬深300正2,8,0,8,亞東-新竹,2023-02-23,2184
2633,台灣高鐵,8,0,8,亞東-新竹,2023-02-23,2184
8996,高力,10,3,7,亞東-新竹,2023-02-23,2184
4953,緯軟,6,0,6,亞東-新竹,2023-02-23,2184
6190,萬泰科,6,0,6,亞東-新竹,2023-02-23,2184
6541,泰福-KY,6,0,6,亞東-新竹,2023-02-23,2184
00642U,期元大S＆P石油,5,0,5,亞東-新竹,2023-02-23,2184
2323,中環,5,0,5,亞東-新竹,2023-02-23,2184
2601,益航,5,0,5,亞東-新竹,2023-02-23,2184
8038,長園科,5,0,5,亞東-新竹,2023-02-23,2184
8097,常珵,5,0,5,亞東-新竹,2023-02-23,2184
8147,正淩,5,0,5,亞東-新竹,2023-02-23,2184
9802,鈺齊-KY,5,0,5,亞東-新竹,2023-02-23,2184
2637,慧洋-KY,5,1,4,亞東-新竹,2023-02-23,2184
00878,國泰永續高股息,123,1,122,亞東-新竹,2023-02-24,2184
4960,誠美材,110,40,70,亞東-新竹,2023-02-24,2184
00632R,元大台灣50反1,60,6,54,亞東-新竹,2023-02-24,2184
6770,力積電,42,0,42,亞東-新竹,2023-02-24,2184
2317,鴻海,34,4,30,亞東-新竹,2023-02-24,2184
6168,宏齊,30,0,30,亞東-新竹,2023-02-24,2184
2303,聯電,32,8,24,亞東-新竹,2023-02-24,2184
6257,矽格,21,0,21,亞東-新竹,2023-02-24,2184
00892,富邦台灣半導體,20,0,20,亞東-新竹,2023-02-24,2184
2867,三商壽,40,20,20,亞東-新竹,2023-02-24,2184
5353,台林,20,0,20,亞東-新竹,2023-02-24,2184
00753L,中信中國50正2,19,0,19,亞東-新竹,2023-02-24,2184
2610,華航,15,1,14,亞東-新竹,2023-02-24,2184
6443,元晶,13,0,13,亞東-新竹,2023-02-24,2184
3037,欣興,19,7,12,亞東-新竹,2023-02-24,2184
3714,富采,11,0,11,亞東-新竹,2023-02-24,2184
8150,南茂,19,8,11,亞東-新竹,2023-02-24,2184
3704,合勤控,11,0,11,亞東-新竹,2023-02-24,2184
1459,聯發,11,1,10,亞東-新竹,2023-02-24,2184
00671R,富邦NASDAQ反1,10,0,10,亞東-新竹,2023-02-24,2184
2388,威盛,17,7,10,亞東-新竹,2023-02-24,2184
2457,飛宏,10,0,10,亞東-新竹,2023-02-24,2184
2504,國產,10,0,10,亞東-新竹,2023-02-24,2184
2618,長榮航,12,2,10,亞東-新竹,2023-02-24,2184
2705,六福,10,0,10,亞東-新竹,2023-02-24,2184
4934,太極,10,0,10,亞東-新竹,2023-02-24,2184
4919,新唐,10,2,8,亞東-新竹,2023-02-24,2184
00679B,元大美債20年,20,13,7,亞東-新竹,2023-02-24,2184
5288,豐祥-KY,7,0,7,亞東-新竹,2023-02-24,2184
2208,台船,6,0,6,亞東-新竹,2023-02-24,2184
2498,宏達電,12,6,6,亞東-新竹,2023-02-24,2184
4153,鈺緯,6,0,6,亞東-新竹,2023-02-24,2184
5011,久陽,6,0,6,亞東-新竹,2023-02-24,2184
6438,迅得,6,0,6,亞東-新竹,2023-02-24,2184
00882,中信中國高股息,5,0,5,亞東-新竹,2023-02-24,2184
1907,永豐餘,5,0,5,亞東-新竹,2023-02-24,2184
2882,國泰金,6,1,5,亞東-新竹,2023-02-24,2184
5351,鈺創,5,0,5,亞東-新竹,2023-02-24,2184
6220,岳豐,5,0,5,亞東-新竹,2023-02-24,2184
3576,聯合再生,4,0,4,亞東-新竹,2023-02-24,2184
00637L,元大滬深300正2,4,0,4,亞東-新竹,2023-02-24,2184
2884,玉山金,6,2,4,亞東-新竹,2023-02-24,2184
2603,長榮,9,5,4,亞東-新竹,2023-02-24,2184
1314,中石化,4,0,4,亞東-新竹,2023-02-24,2184
1593,祺驊,4,0,4,亞東-新竹,2023-02-24,2184
2027,大成鋼,4,0,4,亞東-新竹,2023-02-24,2184
2405,輔信,4,0,4,亞東-新竹,2023-02-24,2184
2887,台新金,4,0,4,亞東-新竹,2023-02-24,2184
6129,普誠,4,0,4,亞東-新竹,2023-02-24,2184
6282,康舒,13,9,4,亞東-新竹,2023-02-24,2184
3535,晶彩科,50,0,50,亞東-新竹,2023-03-01,2184
6770,力積電,38,0,38,亞東-新竹,2023-03-01,2184
3704,合勤控,35,0,35,亞東-新竹,2023-03-01,2184
2002,中鋼,35,1,34,亞東-新竹,2023-03-01,2184
00878,國泰永續高股息,34,3,31,亞東-新竹,2023-03-01,2184
2027,大成鋼,29,0,29,亞東-新竹,2023-03-01,2184
2412,中華電,21,0,21,亞東-新竹,2023-03-01,2184
2705,六福,20,0,20,亞東-新竹,2023-03-01,2184
2867,三商壽,20,0,20,亞東-新竹,2023-03-01,2184
6005,群益證,37,20,17,亞東-新竹,2023-03-01,2184
00671R,富邦NASDAQ反1,15,0,15,亞東-新竹,2023-03-01,2184
3264,欣銓,16,1,15,亞東-新竹,2023-03-01,2184
2317,鴻海,20,6,14,亞東-新竹,2023-03-01,2184
6443,元晶,14,0,14,亞東-新竹,2023-03-01,2184
2201,裕隆,32,19,13,亞東-新竹,2023-03-01,2184
2618,長榮航,13,0,13,亞東-新竹,2023-03-01,2184
8289,泰藝,13,0,13,亞東-新竹,2023-03-01,2184
2637,慧洋-KY,12,0,12,亞東-新竹,2023-03-01,2184
2884,玉山金,32,20,12,亞東-新竹,2023-03-01,2184
2882,國泰金,11,0,11,亞東-新竹,2023-03-01,2184
8097,常珵,11,0,11,亞東-新竹,2023-03-01,2184
8210,勤誠,11,0,11,亞東-新竹,2023-03-01,2184
5608,四維航,31,21,10,亞東-新竹,2023-03-01,2184
1402,遠東新,10,0,10,亞東-新竹,2023-03-01,2184
2812,台中銀,10,0,10,亞東-新竹,2023-03-01,2184
2888,新光金,10,0,10,亞東-新竹,2023-03-01,2184
2891,中信金,10,0,10,亞東-新竹,2023-03-01,2184
4564,元翎,10,0,10,亞東-新竹,2023-03-01,2184
6136,富爾特,10,0,10,亞東-新竹,2023-03-01,2184
8403,盛弘,14,4,10,亞東-新竹,2023-03-01,2184
4763,材料-KY,9,0,9,亞東-新竹,2023-03-01,2184
6220,岳豐,9,0,9,亞東-新竹,2023-03-01,2184
2605,新興,8,0,8,亞東-新竹,2023-03-01,2184
00675L,富邦臺灣加權正2,6,0,6,亞東-新竹,2023-03-01,2184
1219,福壽,6,0,6,亞東-新竹,2023-03-01,2184
1314,中石化,5,0,5,亞東-新竹,2023-03-01,2184
00712,復華富時不動產,5,0,5,亞東-新竹,2023-03-01,2184
00632R,元大台灣50反1,10,5,5,亞東-新竹,2023-03-01,2184
1785,光洋科,10,5,5,亞東-新竹,2023-03-01,2184
2601,益航,7,2,5,亞東-新竹,2023-03-01,2184
2610,華航,5,0,5,亞東-新竹,2023-03-01,2184
4931,新盛力,5,0,5,亞東-新竹,2023-03-01,2184
6269,台郡,5,0,5,亞東-新竹,2023-03-01,2184
2539,櫻花建,4,0,4,亞東-新竹,2023-03-01,2184
2885,元大金,4,0,4,亞東-新竹,2023-03-01,2184
4716,大立,4,0,4,亞東-新竹,2023-03-01,2184
4919,新唐,8,4,4,亞東-新竹,2023-03-01,2184
2603,長榮,11,8,3,亞東-新竹,2023-03-01,2184
1611,中電,3,0,3,亞東-新竹,2023-03-01,2184
0050,元大台灣50,4,1,3,亞東-新竹,2023-03-01,2184
1540,喬福,60,0,60,亞東-新竹,2023-03-02,2184
00751B,元大AAA至A公司債,55,0,55,亞東-新竹,2023-03-02,2184
00878,國泰永續高股息,50,2,48,亞東-新竹,2023-03-02,2184
4114,健喬,33,0,33,亞東-新竹,2023-03-02,2184
1593,祺驊,31,0,31,亞東-新竹,2023-03-02,2184
2380,虹光,30,0,30,亞東-新竹,2023-03-02,2184
2359,所羅門,20,0,20,亞東-新竹,2023-03-02,2184
2402,毅嘉,20,0,20,亞東-新竹,2023-03-02,2184
3356,奇偶,21,1,20,亞東-新竹,2023-03-02,2184
2409,友達,15,1,14,亞東-新竹,2023-03-02,2184
2369,菱生,11,0,11,亞東-新竹,2023-03-02,2184
3034,聯詠,12,1,11,亞東-新竹,2023-03-02,2184
6190,萬泰科,22,11,11,亞東-新竹,2023-03-02,2184
3481,群創,10,0,10,亞東-新竹,2023-03-02,2184
1314,中石化,10,0,10,亞東-新竹,2023-03-02,2184
1785,光洋科,10,0,10,亞東-新竹,2023-03-02,2184
1907,永豐餘,10,0,10,亞東-新竹,2023-03-02,2184
2615,萬海,20,10,10,亞東-新竹,2023-03-02,2184
5469,瀚宇博,10,0,10,亞東-新竹,2023-03-02,2184
6168,宏齊,10,0,10,亞東-新竹,2023-03-02,2184
00632R,元大台灣50反1,9,0,9,亞東-新竹,2023-03-02,2184
2303,聯電,16,7,9,亞東-新竹,2023-03-02,2184
2344,華邦電,27,19,8,亞東-新竹,2023-03-02,2184
2884,玉山金,12,4,8,亞東-新竹,2023-03-02,2184
00687B,國泰20年美債,6,0,6,亞東-新竹,2023-03-02,2184
2887,台新金,6,0,6,亞東-新竹,2023-03-02,2184
3311,閎暉,6,0,6,亞東-新竹,2023-03-02,2184
6733,博晟生醫,7,1,6,亞東-新竹,2023-03-02,2184
1219,福壽,5,0,5,亞東-新竹,2023-03-02,2184
00637L,元大滬深300正2,10,5,5,亞東-新竹,2023-03-02,2184
2317,鴻海,5,0,5,亞東-新竹,2023-03-02,2184
2498,宏達電,5,0,5,亞東-新竹,2023-03-02,2184
2547,日勝生,5,0,5,亞東-新竹,2023-03-02,2184
2801,彰銀,5,0,5,亞東-新竹,2023-03-02,2184
2888,新光金,5,0,5,亞東-新竹,2023-03-02,2184
2915,潤泰全,5,0,5,亞東-新竹,2023-03-02,2184
3346,麗清,5,0,5,亞東-新竹,2023-03-02,2184
5388,中磊,5,0,5,亞東-新竹,2023-03-02,2184
6129,普誠,10,5,5,亞東-新竹,2023-03-02,2184
2892,第一金,4,0,4,亞東-新竹,2023-03-02,2184
2208,台船,4,0,4,亞東-新竹,2023-03-02,2184
2471,資通,4,0,4,亞東-新竹,2023-03-02,2184
2886,兆豐金,4,0,4,亞東-新竹,2023-03-02,2184
2495,普安,3,0,3,亞東-新竹,2023-03-02,2184
6643,M31,10,7,3,亞東-新竹,2023-03-02,2184
00670L,富邦NASDAQ正2,3,0,3,亞東-新竹,2023-03-02,2184
00712,復華富時不動產,3,0,3,亞東-新竹,2023-03-02,2184
1101,台泥,3,0,3,亞東-新竹,2023-03-02,2184
1605,華新,32,29,3,亞東-新竹,2023-03-02,2184
1240,茂生農經,3,0,3,亞東-新竹,2023-03-02,2184
2834,臺企銀,300,202,98,亞東-新竹,2023-03-03,2184
8105,凌巨,65,0,65,亞東-新竹,2023-03-03,2184
00712,復華富時不動產,61,0,61,亞東-新竹,2023-03-03,2184
00878,國泰永續高股息,55,3,52,亞東-新竹,2023-03-03,2184
1584,精剛,50,0,50,亞東-新竹,2023-03-03,2184
00751B,元大AAA至A公司債,50,0,50,亞東-新竹,2023-03-03,2184
2867,三商壽,50,0,50,亞東-新竹,2023-03-03,2184
3013,晟銘電,46,2,44,亞東-新竹,2023-03-03,2184
2610,華航,40,0,40,亞東-新竹,2023-03-03,2184
00671R,富邦NASDAQ反1,20,0,20,亞東-新竹,2023-03-03,2184
4934,太極,20,0,20,亞東-新竹,2023-03-03,2184
00900,富邦特選高股息30,17,0,17,亞東-新竹,2023-03-03,2184
2845,遠東銀,15,0,15,亞東-新竹,2023-03-03,2184
6142,友勁,15,0,15,亞東-新竹,2023-03-03,2184
8234,新漢,15,0,15,亞東-新竹,2023-03-03,2184
2891,中信金,13,0,13,亞東-新竹,2023-03-03,2184
2498,宏達電,12,0,12,亞東-新竹,2023-03-03,2184
2722,夏都,12,0,12,亞東-新竹,2023-03-03,2184
8049,晶采,12,0,12,亞東-新竹,2023-03-03,2184
1762,中化生,10,0,10,亞東-新竹,2023-03-03,2184
1217,愛之味,10,0,10,亞東-新竹,2023-03-03,2184
1101,台泥,10,0,10,亞東-新竹,2023-03-03,2184
2104,國際中橡,10,0,10,亞東-新竹,2023-03-03,2184
2897,王道銀行,10,0,10,亞東-新竹,2023-03-03,2184
3576,聯合再生,10,0,10,亞東-新竹,2023-03-03,2184
6456,GIS-KY,10,0,10,亞東-新竹,2023-03-03,2184
8048,德勝,10,0,10,亞東-新竹,2023-03-03,2184
3693,營邦,8,0,8,亞東-新竹,2023-03-03,2184
2419,仲琦,7,0,7,亞東-新竹,2023-03-03,2184
3346,麗清,10,3,7,亞東-新竹,2023-03-03,2184
3661,世芯-KY,14,8,6,亞東-新竹,2023-03-03,2184
00919,群益台灣精選高息,6,0,6,亞東-新竹,2023-03-03,2184
2887,台新金,6,0,6,亞東-新竹,2023-03-03,2184
6170,統振,6,0,6,亞東-新竹,2023-03-03,2184
00687B,國泰20年美債,5,0,5,亞東-新竹,2023-03-03,2184
00676R,富邦臺灣加權反1,5,0,5,亞東-新竹,2023-03-03,2184
1708,東鹼,5,0,5,亞東-新竹,2023-03-03,2184
2342,茂矽,5,0,5,亞東-新竹,2023-03-03,2184
2347,聯強,5,0,5,亞東-新竹,2023-03-03,2184
2915,潤泰全,5,0,5,亞東-新竹,2023-03-03,2184
3218,大學光,5,0,5,亞東-新竹,2023-03-03,2184
3682,亞太電,5,0,5,亞東-新竹,2023-03-03,2184
4536,拓凱,5,0,5,亞東-新竹,2023-03-03,2184
6598,ABC-KY,5,0,5,亞東-新竹,2023-03-03,2184
8255,朋程,5,0,5,亞東-新竹,2023-03-03,2184
2330,台積電,4,0,4,亞東-新竹,2023-03-03,2184
1752,南光,6,2,4,亞東-新竹,2023-03-03,2184
1720,生達,6,2,4,亞東-新竹,2023-03-03,2184
1786,科妍,4,0,4,亞東-新竹,2023-03-03,2184
2617,台航,4,0,4,亞東-新竹,2023-03-03,2184
00632R,元大台灣50反1,176,50,126,亞東-新竹,2023-03-06,2184
00878,國泰永續高股息,115,1,114,亞東-新竹,2023-03-06,2184
3027,盛達,100,0,100,亞東-新竹,2023-03-06,2184
1605,華新,75,28,47,亞東-新竹,2023-03-06,2184
4919,新唐,34,5,29,亞東-新竹,2023-03-06,2184
3432,台端,27,0,27,亞東-新竹,2023-03-06,2184
2617,台航,21,0,21,亞東-新竹,2023-03-06,2184
2890,永豐金,21,0,21,亞東-新竹,2023-03-06,2184
00919,群益台灣精選高息,20,0,20,亞東-新竹,2023-03-06,2184
2601,益航,20,0,20,亞東-新竹,2023-03-06,2184
3545,敦泰,20,0,20,亞東-新竹,2023-03-06,2184
5469,瀚宇博,20,0,20,亞東-新竹,2023-03-06,2184
5880,合庫金,20,0,20,亞東-新竹,2023-03-06,2184
8176,智捷,20,0,20,亞東-新竹,2023-03-06,2184
3481,群創,32,13,19,亞東-新竹,2023-03-06,2184
3665,貿聯-KY,20,1,19,亞東-新竹,2023-03-06,2184
6257,矽格,20,2,18,亞東-新竹,2023-03-06,2184
2358,廷鑫,18,0,18,亞東-新竹,2023-03-06,2184
2028,威致,15,0,15,亞東-新竹,2023-03-06,2184
00900,富邦特選高股息30,14,0,14,亞東-新竹,2023-03-06,2184
5608,四維航,21,8,13,亞東-新竹,2023-03-06,2184
00637L,元大滬深300正2,11,1,10,亞東-新竹,2023-03-06,2184
1701,中化,12,2,10,亞東-新竹,2023-03-06,2184
2367,燿華,10,0,10,亞東-新竹,2023-03-06,2184
3558,神準,13,3,10,亞東-新竹,2023-03-06,2184
6109,亞元,10,0,10,亞東-新竹,2023-03-06,2184
6128,上福,10,0,10,亞東-新竹,2023-03-06,2184
6163,華電網,10,0,10,亞東-新竹,2023-03-06,2184
6205,詮欣,10,0,10,亞東-新竹,2023-03-06,2184
6245,立端,10,0,10,亞東-新竹,2023-03-06,2184
6443,元晶,12,2,10,亞東-新竹,2023-03-06,2184
4736,泰博,9,0,9,亞東-新竹,2023-03-06,2184
6142,友勁,9,0,9,亞東-新竹,2023-03-06,2184
1519,華城,7,1,6,亞東-新竹,2023-03-06,2184
2615,萬海,25,19,6,亞東-新竹,2023-03-06,2184
2731,雄獅,6,0,6,亞東-新竹,2023-03-06,2184
5519,隆大,6,0,6,亞東-新竹,2023-03-06,2184
6558,興能高,6,0,6,亞東-新竹,2023-03-06,2184
00715L,期街口布蘭特正2,7,2,5,亞東-新竹,2023-03-06,2184
2634,漢翔,5,0,5,亞東-新竹,2023-03-06,2184
2486,一詮,4,0,4,亞東-新竹,2023-03-06,2184
3029,零壹,4,0,4,亞東-新竹,2023-03-06,2184
3289,宜特,5,1,4,亞東-新竹,2023-03-06,2184
3498,陽程,4,0,4,亞東-新竹,2023-03-06,2184
4503,金雨,4,0,4,亞東-新竹,2023-03-06,2184
5706,鳳凰,4,0,4,亞東-新竹,2023-03-06,2184
6788,華景電,4,0,4,亞東-新竹,2023-03-06,2184
8390,金益鼎,4,0,4,亞東-新竹,2023-03-06,2184
9939,宏全,4,0,4,亞東-新竹,2023-03-06,2184
3147,大綜,3,0,3,亞東-新竹,2023-03-06,2184
00632R,元大台灣50反1,431,0,431,亞東-新竹,2023-03-07,2184
2457,飛宏,96,3,93,亞東-新竹,2023-03-07,2184
00772B,中信高評級公司債,50,8,42,亞東-新竹,2023-03-07,2184
4114,健喬,40,2,38,亞東-新竹,2023-03-07,2184
2444,兆勁,37,0,37,亞東-新竹,2023-03-07,2184
2886,兆豐金,30,0,30,亞東-新竹,2023-03-07,2184
2317,鴻海,38,12,26,亞東-新竹,2023-03-07,2184
00751B,元大AAA至A公司債,24,0,24,亞東-新竹,2023-03-07,2184
2609,陽明,27,5,22,亞東-新竹,2023-03-07,2184
3551,世禾,15,0,15,亞東-新竹,2023-03-07,2184
0050,元大台灣50,18,4,14,亞東-新竹,2023-03-07,2184
6234,高僑,13,0,13,亞東-新竹,2023-03-07,2184
4105,東洋,12,0,12,亞東-新竹,2023-03-07,2184
00753L,中信中國50正2,11,0,11,亞東-新竹,2023-03-07,2184
3504,揚明光,12,1,11,亞東-新竹,2023-03-07,2184
00673R,期元大S＆P原油反1,10,0,10,亞東-新竹,2023-03-07,2184
2104,國際中橡,10,0,10,亞東-新竹,2023-03-07,2184
2380,虹光,10,0,10,亞東-新竹,2023-03-07,2184
6190,萬泰科,10,0,10,亞東-新竹,2023-03-07,2184
8011,台通,10,0,10,亞東-新竹,2023-03-07,2184
8048,德勝,10,0,10,亞東-新竹,2023-03-07,2184
8261,富鼎,10,0,10,亞東-新竹,2023-03-07,2184
2476,鉅祥,10,0,10,亞東-新竹,2023-03-07,2184
3704,合勤控,10,1,9,亞東-新竹,2023-03-07,2184
4743,合一,8,0,8,亞東-新竹,2023-03-07,2184
6245,立端,10,2,8,亞東-新竹,2023-03-07,2184
2352,佳世達,7,0,7,亞東-新竹,2023-03-07,2184
2458,義隆,7,0,7,亞東-新竹,2023-03-07,2184
3264,欣銓,8,2,6,亞東-新竹,2023-03-07,2184
6109,亞元,6,0,6,亞東-新竹,2023-03-07,2184
0056,元大高股息,7,2,5,亞東-新竹,2023-03-07,2184
00679B,元大美債20年,5,0,5,亞東-新竹,2023-03-07,2184
1449,佳和,5,0,5,亞東-新竹,2023-03-07,2184
1308,亞聚,5,0,5,亞東-新竹,2023-03-07,2184
2913,農林,5,0,5,亞東-新竹,2023-03-07,2184
4129,聯合,5,0,5,亞東-新竹,2023-03-07,2184
4536,拓凱,5,0,5,亞東-新竹,2023-03-07,2184
4563,百德,5,0,5,亞東-新竹,2023-03-07,2184
8071,能率網通,5,0,5,亞東-新竹,2023-03-07,2184
8097,常珵,5,0,5,亞東-新竹,2023-03-07,2184
1584,精剛,6,2,4,亞東-新竹,2023-03-07,2184
1612,宏泰,4,0,4,亞東-新竹,2023-03-07,2184
3029,零壹,7,3,4,亞東-新竹,2023-03-07,2184
3037,欣興,4,0,4,亞東-新竹,2023-03-07,2184
5876,上海商銀,4,0,4,亞東-新竹,2023-03-07,2184
6168,宏齊,4,0,4,亞東-新竹,2023-03-07,2184
6461,益得,4,0,4,亞東-新竹,2023-03-07,2184
6548,長科*,14,10,4,亞東-新竹,2023-03-07,2184
8201,無敵,4,0,4,亞東-新竹,2023-03-07,2184
8227,巨有科技,4,0,4,亞東-新竹,2023-03-07,2184
2359,所羅門,72,0,72,亞東-新竹,2023-03-08,2184
00753L,中信中國50正2,67,0,67,亞東-新竹,2023-03-08,2184
2891,中信金,55,10,45,亞東-新竹,2023-03-08,2184
2317,鴻海,44,3,41,亞東-新竹,2023-03-08,2184
2884,玉山金,40,0,40,亞東-新竹,2023-03-08,2184
2603,長榮,39,2,37,亞東-新竹,2023-03-08,2184
2409,友達,30,0,30,亞東-新竹,2023-03-08,2184
1102,亞泥,30,1,29,亞東-新竹,2023-03-08,2184
2371,大同,28,0,28,亞東-新竹,2023-03-08,2184
00878,國泰永續高股息,25,0,25,亞東-新竹,2023-03-08,2184
3093,港建*,37,12,25,亞東-新竹,2023-03-08,2184
3264,欣銓,35,10,25,亞東-新竹,2023-03-08,2184
8926,台汽電,25,0,25,亞東-新竹,2023-03-08,2184
3034,聯詠,22,1,21,亞東-新竹,2023-03-08,2184
2867,三商壽,21,0,21,亞東-新竹,2023-03-08,2184
00665L,富邦�琤肭磪囓�2,20,0,20,亞東-新竹,2023-03-08,2184
00882,中信中國高股息,19,0,19,亞東-新竹,2023-03-08,2184
5608,四維航,16,0,16,亞東-新竹,2023-03-08,2184
6168,宏齊,16,0,16,亞東-新竹,2023-03-08,2184
2489,瑞軒,15,0,15,亞東-新竹,2023-03-08,2184
2609,陽明,15,1,14,亞東-新竹,2023-03-08,2184
3259,鑫創,14,0,14,亞東-新竹,2023-03-08,2184
2330,台積電,12,0,12,亞東-新竹,2023-03-08,2184
00720B,元大投資級公司債,11,0,11,亞東-新竹,2023-03-08,2184
4743,合一,11,0,11,亞東-新竹,2023-03-08,2184
00673R,期元大S＆P原油反1,10,0,10,亞東-新竹,2023-03-08,2184
2615,萬海,19,9,10,亞東-新竹,2023-03-08,2184
2618,長榮航,10,0,10,亞東-新竹,2023-03-08,2184
6245,立端,10,0,10,亞東-新竹,2023-03-08,2184
6005,群益證,10,0,10,亞東-新竹,2023-03-08,2184
2498,宏達電,11,2,9,亞東-新竹,2023-03-08,2184
1539,巨庭,8,0,8,亞東-新竹,2023-03-08,2184
1101,台泥,14,6,8,亞東-新竹,2023-03-08,2184
00919,群益台灣精選高息,8,0,8,亞東-新竹,2023-03-08,2184
2458,義隆,8,0,8,亞東-新竹,2023-03-08,2184
5706,鳳凰,8,0,8,亞東-新竹,2023-03-08,2184
2368,金像電,7,0,7,亞東-新竹,2023-03-08,2184
2481,強茂,8,1,7,亞東-新竹,2023-03-08,2184
6120,達運,7,0,7,亞東-新竹,2023-03-08,2184
9933,中鼎,7,0,7,亞東-新竹,2023-03-08,2184
00830,國泰費城半導體,6,0,6,亞東-新竹,2023-03-08,2184
3023,信邦,6,0,6,亞東-新竹,2023-03-08,2184
3380,明泰,6,0,6,亞東-新竹,2023-03-08,2184
3576,聯合再生,6,0,6,亞東-新竹,2023-03-08,2184
4105,東洋,6,0,6,亞東-新竹,2023-03-08,2184
00715L,期街口布蘭特正2,5,0,5,亞東-新竹,2023-03-08,2184
1235,興泰,5,0,5,亞東-新竹,2023-03-08,2184
1513,中興電,5,0,5,亞東-新竹,2023-03-08,2184
1802,台玻,5,0,5,亞東-新竹,2023-03-08,2184
2105,正新,5,0,5,亞東-新竹,2023-03-08,2184
1718,中纖,114,2,112,亞東-新竹,2023-03-09,2184
2834,臺企銀,100,0,100,亞東-新竹,2023-03-09,2184
2457,飛宏,108,9,99,亞東-新竹,2023-03-09,2184
6205,詮欣,56,1,55,亞東-新竹,2023-03-09,2184
00772B,中信高評級公司債,51,0,51,亞東-新竹,2023-03-09,2184
1605,華新,58,7,51,亞東-新竹,2023-03-09,2184
1459,聯發,47,1,46,亞東-新竹,2023-03-09,2184
2317,鴻海,46,0,46,亞東-新竹,2023-03-09,2184
2489,瑞軒,30,0,30,亞東-新竹,2023-03-09,2184
6269,台郡,30,0,30,亞東-新竹,2023-03-09,2184
00751B,元大AAA至A公司債,28,0,28,亞東-新竹,2023-03-09,2184
00878,國泰永續高股息,29,2,27,亞東-新竹,2023-03-09,2184
2367,燿華,24,0,24,亞東-新竹,2023-03-09,2184
1101,台泥,26,2,24,亞東-新竹,2023-03-09,2184
1402,遠東新,20,0,20,亞東-新竹,2023-03-09,2184
2409,友達,24,4,20,亞東-新竹,2023-03-09,2184
2618,長榮航,30,10,20,亞東-新竹,2023-03-09,2184
2852,第一保,20,0,20,亞東-新竹,2023-03-09,2184
6120,達運,20,0,20,亞東-新竹,2023-03-09,2184
6142,友勁,20,0,20,亞東-新竹,2023-03-09,2184
1785,光洋科,15,0,15,亞東-新竹,2023-03-09,2184
5608,四維航,24,10,14,亞東-新竹,2023-03-09,2184
00679B,元大美債20年,11,0,11,亞東-新竹,2023-03-09,2184
2497,怡利電,12,1,11,亞東-新竹,2023-03-09,2184
3056,富華新,11,0,11,亞東-新竹,2023-03-09,2184
1303,南亞,10,0,10,亞東-新竹,2023-03-09,2184
00665L,富邦�琤肭磪囓�2,10,0,10,亞東-新竹,2023-03-09,2184
2867,三商壽,10,0,10,亞東-新竹,2023-03-09,2184
4961,天鈺,10,0,10,亞東-新竹,2023-03-09,2184
6168,宏齊,10,0,10,亞東-新竹,2023-03-09,2184
9933,中鼎,10,0,10,亞東-新竹,2023-03-09,2184
2476,鉅祥,10,0,10,亞東-新竹,2023-03-09,2184
6266,泰詠,10,1,9,亞東-新竹,2023-03-09,2184
6443,元晶,9,0,9,亞東-新竹,2023-03-09,2184
00720B,元大投資級公司債,8,0,8,亞東-新竹,2023-03-09,2184
8227,巨有科技,12,4,8,亞東-新竹,2023-03-09,2184
2419,仲琦,7,0,7,亞東-新竹,2023-03-09,2184
8112,至上,7,0,7,亞東-新竹,2023-03-09,2184
1909,榮成,6,0,6,亞東-新竹,2023-03-09,2184
8215,明基材,6,0,6,亞東-新竹,2023-03-09,2184
8936,國統,6,0,6,亞東-新竹,2023-03-09,2184
2890,永豐金,5,0,5,亞東-新竹,2023-03-09,2184
1515,力山,5,0,5,亞東-新竹,2023-03-09,2184
00637L,元大滬深300正2,5,0,5,亞東-新竹,2023-03-09,2184
00888,永豐台灣ESG,5,0,5,亞東-新竹,2023-03-09,2184
1810,和成,5,0,5,亞東-新竹,2023-03-09,2184
2201,裕隆,23,18,5,亞東-新竹,2023-03-09,2184
2630,亞航,5,0,5,亞東-新竹,2023-03-09,2184
2884,玉山金,10,5,5,亞東-新竹,2023-03-09,2184
3504,揚明光,15,10,5,亞東-新竹,2023-03-09,2184
00878,國泰永續高股息,70,0,70,亞東-新竹,2023-03-10,2184
6133,金橋,69,0,69,亞東-新竹,2023-03-10,2184
2618,長榮航,66,15,51,亞東-新竹,2023-03-10,2184
2610,華航,57,7,50,亞東-新竹,2023-03-10,2184
9904,寶成,41,0,41,亞東-新竹,2023-03-10,2184
2884,玉山金,43,5,38,亞東-新竹,2023-03-10,2184
3264,欣銓,42,9,33,亞東-新竹,2023-03-10,2184
2504,國產,30,0,30,亞東-新竹,2023-03-10,2184
0056,元大高股息,29,0,29,亞東-新竹,2023-03-10,2184
2330,台積電,28,0,28,亞東-新竹,2023-03-10,2184
6443,元晶,39,12,27,亞東-新竹,2023-03-10,2184
4142,國光生,25,0,25,亞東-新竹,2023-03-10,2184
8069,元太,23,0,23,亞東-新竹,2023-03-10,2184
2392,正崴,21,0,21,亞東-新竹,2023-03-10,2184
4960,誠美材,21,0,21,亞東-新竹,2023-03-10,2184
6168,宏齊,21,0,21,亞東-新竹,2023-03-10,2184
6142,友勁,20,0,20,亞東-新竹,2023-03-10,2184
6005,群益證,20,1,19,亞東-新竹,2023-03-10,2184
3535,晶彩科,18,0,18,亞東-新竹,2023-03-10,2184
2888,新光金,17,0,17,亞東-新竹,2023-03-10,2184
6221,晉泰,16,0,16,亞東-新竹,2023-03-10,2184
00646,元大S＆P500,14,0,14,亞東-新竹,2023-03-10,2184
00715L,期街口布蘭特正2,13,0,13,亞東-新竹,2023-03-10,2184
6129,普誠,14,1,13,亞東-新竹,2023-03-10,2184
8112,至上,13,0,13,亞東-新竹,2023-03-10,2184
0050,元大台灣50,12,0,12,亞東-新竹,2023-03-10,2184
4105,東洋,12,0,12,亞東-新竹,2023-03-10,2184
2453,凌群,30,18,12,亞東-新竹,2023-03-10,2184
00902,中信電池及儲能,11,0,11,亞東-新竹,2023-03-10,2184
2344,華邦電,11,0,11,亞東-新竹,2023-03-10,2184
3037,欣興,13,2,11,亞東-新竹,2023-03-10,2184
5531,鄉林,13,2,11,亞東-新竹,2023-03-10,2184
6138,茂達,12,1,11,亞東-新竹,2023-03-10,2184
2891,中信金,12,1,11,亞東-新竹,2023-03-10,2184
00893,國泰智能電動車,10,0,10,亞東-新竹,2023-03-10,2184
00676R,富邦臺灣加權反1,10,0,10,亞東-新竹,2023-03-10,2184
1611,中電,10,0,10,亞東-新竹,2023-03-10,2184
2867,三商壽,20,10,10,亞東-新竹,2023-03-10,2184
3062,建漢,10,0,10,亞東-新竹,2023-03-10,2184
6156,松上,10,0,10,亞東-新竹,2023-03-10,2184
6163,華電網,10,0,10,亞東-新竹,2023-03-10,2184
6245,立端,10,0,10,亞東-新竹,2023-03-10,2184
8261,富鼎,10,0,10,亞東-新竹,2023-03-10,2184
2890,永豐金,9,0,9,亞東-新竹,2023-03-10,2184
2882,國泰金,9,0,9,亞東-新竹,2023-03-10,2184
1314,中石化,9,0,9,亞東-新竹,2023-03-10,2184
2886,兆豐金,9,0,9,亞東-新竹,2023-03-10,2184
4953,緯軟,10,1,9,亞東-新竹,2023-03-10,2184
6220,岳豐,9,0,9,亞東-新竹,2023-03-10,2184
00713,元大台灣高息低波,9,0,9,亞東-新竹,2023-03-10,2184
00632R,元大台灣50反1,915,2,913,亞東-新竹,2023-03-13,2184
00878,國泰永續高股息,67,12,55,亞東-新竹,2023-03-13,2184
2891,中信金,52,0,52,亞東-新竹,2023-03-13,2184
00772B,中信高評級公司債,51,1,50,亞東-新竹,2023-03-13,2184
2887,台新金,50,0,50,亞東-新竹,2023-03-13,2184
2884,玉山金,65,23,42,亞東-新竹,2023-03-13,2184
00751B,元大AAA至A公司債,38,0,38,亞東-新竹,2023-03-13,2184
2882,國泰金,34,2,32,亞東-新竹,2023-03-13,2184
1569,濱川,36,4,32,亞東-新竹,2023-03-13,2184
6770,力積電,34,7,27,亞東-新竹,2023-03-13,2184
5211,蒙恬,26,0,26,亞東-新竹,2023-03-13,2184
9921,巨大,25,0,25,亞東-新竹,2023-03-13,2184
2881,富邦金,20,0,20,亞東-新竹,2023-03-13,2184
6139,亞翔,21,1,20,亞東-新竹,2023-03-13,2184
4155,訊映,20,1,19,亞東-新竹,2023-03-13,2184
2888,新光金,25,7,18,亞東-新竹,2023-03-13,2184
2609,陽明,37,21,16,亞東-新竹,2023-03-13,2184
2365,昆盈,15,0,15,亞東-新竹,2023-03-13,2184
6166,凌華,15,0,15,亞東-新竹,2023-03-13,2184
6443,元晶,17,2,15,亞東-新竹,2023-03-13,2184
5469,瀚宇博,11,0,11,亞東-新竹,2023-03-13,2184
1301,台塑,11,1,10,亞東-新竹,2023-03-13,2184
2458,義隆,10,0,10,亞東-新竹,2023-03-13,2184
2610,華航,12,2,10,亞東-新竹,2023-03-13,2184
2812,台中銀,10,0,10,亞東-新竹,2023-03-13,2184
2885,元大金,10,0,10,亞東-新竹,2023-03-13,2184
4564,元翎,10,0,10,亞東-新竹,2023-03-13,2184
6005,群益證,10,0,10,亞東-新竹,2023-03-13,2184
6221,晉泰,10,0,10,亞東-新竹,2023-03-13,2184
6266,泰詠,10,0,10,亞東-新竹,2023-03-13,2184
1539,巨庭,9,0,9,亞東-新竹,2023-03-13,2184
2331,精英,10,1,9,亞東-新竹,2023-03-13,2184
2376,技嘉,9,0,9,亞東-新竹,2023-03-13,2184
00680L,元大美債20正2,8,0,8,亞東-新竹,2023-03-13,2184
6129,普誠,10,2,8,亞東-新竹,2023-03-13,2184
6220,岳豐,8,0,8,亞東-新竹,2023-03-13,2184
0056,元大高股息,9,2,7,亞東-新竹,2023-03-13,2184
2317,鴻海,17,10,7,亞東-新竹,2023-03-13,2184
3535,晶彩科,7,0,7,亞東-新竹,2023-03-13,2184
4142,國光生,7,0,7,亞東-新竹,2023-03-13,2184
00679B,元大美債20年,7,2,5,亞東-新竹,2023-03-13,2184
1785,光洋科,5,0,5,亞東-新竹,2023-03-13,2184
2014,中鴻,6,1,5,亞東-新竹,2023-03-13,2184
2357,華碩,5,0,5,亞東-新竹,2023-03-13,2184
2867,三商壽,5,0,5,亞東-新竹,2023-03-13,2184
4931,新盛力,5,0,5,亞東-新竹,2023-03-13,2184
8097,常珵,5,0,5,亞東-新竹,2023-03-13,2184
00713,元大台灣高息低波,4,0,4,亞東-新竹,2023-03-13,2184
2352,佳世達,4,0,4,亞東-新竹,2023-03-13,2184
2615,萬海,6,2,4,亞東-新竹,2023-03-13,2184
00878,國泰永續高股息,137,10,127,亞東-新竹,2023-03-14,2184
2883,凱基金,102,0,102,亞東-新竹,2023-03-14,2184
2887,台新金,62,0,62,亞東-新竹,2023-03-14,2184
2891,中信金,60,0,60,亞東-新竹,2023-03-14,2184
2618,長榮航,67,11,56,亞東-新竹,2023-03-14,2184
00772B,中信高評級公司債,51,0,51,亞東-新竹,2023-03-14,2184
2867,三商壽,50,0,50,亞東-新竹,2023-03-14,2184
00680L,元大美債20正2,36,0,36,亞東-新竹,2023-03-14,2184
2882,國泰金,35,0,35,亞東-新竹,2023-03-14,2184
00893,國泰智能電動車,35,0,35,亞東-新竹,2023-03-14,2184
2317,鴻海,34,1,33,亞東-新竹,2023-03-14,2184
2897,王道銀行,30,0,30,亞東-新竹,2023-03-14,2184
3052,夆典,30,0,30,亞東-新竹,2023-03-14,2184
6770,力積電,29,0,29,亞東-新竹,2023-03-14,2184
2303,聯電,23,1,22,亞東-新竹,2023-03-14,2184
2603,長榮,35,14,21,亞東-新竹,2023-03-14,2184
00664R,國泰臺灣加權反1,20,0,20,亞東-新竹,2023-03-14,2184
2888,新光金,20,0,20,亞東-新竹,2023-03-14,2184
4155,訊映,20,1,19,亞東-新竹,2023-03-14,2184
2409,友達,17,0,17,亞東-新竹,2023-03-14,2184
4129,聯合,16,0,16,亞東-新竹,2023-03-14,2184
3481,群創,14,0,14,亞東-新竹,2023-03-14,2184
8936,國統,20,6,14,亞東-新竹,2023-03-14,2184
00715L,期街口布蘭特正2,12,0,12,亞東-新竹,2023-03-14,2184
6573,虹揚-KY,26,15,11,亞東-新竹,2023-03-14,2184
00665L,富邦�琤肭磪囓�2,10,0,10,亞東-新竹,2023-03-14,2184
2845,遠東銀,10,0,10,亞東-新竹,2023-03-14,2184
5469,瀚宇博,10,0,10,亞東-新竹,2023-03-14,2184
6016,康和證,10,0,10,亞東-新竹,2023-03-14,2184
9904,寶成,10,0,10,亞東-新竹,2023-03-14,2184
2610,華航,19,10,9,亞東-新竹,2023-03-14,2184
00830,國泰費城半導體,11,2,9,亞東-新竹,2023-03-14,2184
6168,宏齊,9,0,9,亞東-新竹,2023-03-14,2184
2337,旺宏,8,0,8,亞東-新竹,2023-03-14,2184
6532,瑞耘,8,0,8,亞東-新竹,2023-03-14,2184
2330,台積電,8,0,8,亞東-新竹,2023-03-14,2184
00713,元大台灣高息低波,8,1,7,亞東-新竹,2023-03-14,2184
2886,兆豐金,8,1,7,亞東-新竹,2023-03-14,2184
1459,聯發,7,0,7,亞東-新竹,2023-03-14,2184
4163,鐿鈦,7,0,7,亞東-新竹,2023-03-14,2184
00646,元大S＆P500,6,0,6,亞東-新竹,2023-03-14,2184
1402,遠東新,6,0,6,亞東-新竹,2023-03-14,2184
3090,日電貿,6,0,6,亞東-新竹,2023-03-14,2184
3707,漢磊,6,0,6,亞東-新竹,2023-03-14,2184
00676R,富邦臺灣加權反1,5,0,5,亞東-新竹,2023-03-14,2184
1605,華新,8,3,5,亞東-新竹,2023-03-14,2184
2929,淘帝-KY,5,0,5,亞東-新竹,2023-03-14,2184
3702,大聯大,5,0,5,亞東-新竹,2023-03-14,2184
4903,聯光通,7,2,5,亞東-新竹,2023-03-14,2184
6005,群益證,5,0,5,亞東-新竹,2023-03-14,2184
00632R,元大台灣50反1,305,100,205,亞東-新竹,2023-03-15,2184
00679B,元大美債20年,68,1,67,亞東-新竹,2023-03-15,2184
2515,中工,66,0,66,亞東-新竹,2023-03-15,2184
00772B,中信高評級公司債,55,0,55,亞東-新竹,2023-03-15,2184
00671R,富邦NASDAQ反1,40,0,40,亞東-新竹,2023-03-15,2184
3481,群創,40,3,37,亞東-新竹,2023-03-15,2184
3052,夆典,33,0,33,亞東-新竹,2023-03-15,2184
00751B,元大AAA至A公司債,32,0,32,亞東-新竹,2023-03-15,2184
6243,迅杰,32,0,32,亞東-新竹,2023-03-15,2184
2603,長榮,43,15,28,亞東-新竹,2023-03-15,2184
00878,國泰永續高股息,27,0,27,亞東-新竹,2023-03-15,2184
2457,飛宏,64,37,27,亞東-新竹,2023-03-15,2184
00713,元大台灣高息低波,25,0,25,亞東-新竹,2023-03-15,2184
2891,中信金,23,0,23,亞東-新竹,2023-03-15,2184
2331,精英,22,0,22,亞東-新竹,2023-03-15,2184
2409,友達,23,6,17,亞東-新竹,2023-03-15,2184
2888,新光金,15,0,15,亞東-新竹,2023-03-15,2184
2897,王道銀行,15,0,15,亞東-新竹,2023-03-15,2184
8926,台汽電,37,22,15,亞東-新竹,2023-03-15,2184
1539,巨庭,14,0,14,亞東-新竹,2023-03-15,2184
2330,台積電,18,7,11,亞東-新竹,2023-03-15,2184
8112,至上,11,0,11,亞東-新竹,2023-03-15,2184
00687B,國泰20年美債,10,0,10,亞東-新竹,2023-03-15,2184
00720B,元大投資級公司債,10,0,10,亞東-新竹,2023-03-15,2184
1570,力肯,10,0,10,亞東-新竹,2023-03-15,2184
2915,潤泰全,13,3,10,亞東-新竹,2023-03-15,2184
8050,廣積,10,0,10,亞東-新竹,2023-03-15,2184
8234,新漢,10,0,10,亞東-新竹,2023-03-15,2184
5263,智崴,9,0,9,亞東-新竹,2023-03-15,2184
2610,華航,8,0,8,亞東-新竹,2023-03-15,2184
2889,國票金,7,0,7,亞東-新竹,2023-03-15,2184
4763,材料-KY,7,0,7,亞東-新竹,2023-03-15,2184
5880,合庫金,7,0,7,亞東-新竹,2023-03-15,2184
0056,元大高股息,6,0,6,亞東-新竹,2023-03-15,2184
2615,萬海,8,2,6,亞東-新竹,2023-03-15,2184
1785,光洋科,6,1,5,亞東-新竹,2023-03-15,2184
2027,大成鋼,5,0,5,亞東-新竹,2023-03-15,2184
2425,承啟,5,0,5,亞東-新竹,2023-03-15,2184
2890,永豐金,5,0,5,亞東-新竹,2023-03-15,2184
4938,和碩,5,0,5,亞東-新竹,2023-03-15,2184
5243,乙盛-KY,5,0,5,亞東-新竹,2023-03-15,2184
6120,達運,5,0,5,亞東-新竹,2023-03-15,2184
6282,康舒,10,5,5,亞東-新竹,2023-03-15,2184
3558,神準,7,3,4,亞東-新竹,2023-03-15,2184
2884,玉山金,4,0,4,亞東-新竹,2023-03-15,2184
1529,樂事綠能,4,0,4,亞東-新竹,2023-03-15,2184
1569,濱川,4,0,4,亞東-新竹,2023-03-15,2184
1813,寶利徠,4,0,4,亞東-新竹,2023-03-15,2184
2388,威盛,11,7,4,亞東-新竹,2023-03-15,2184
2453,凌群,5,1,4,亞東-新竹,2023-03-15,2184
2867,三商壽,205,0,205,亞東-新竹,2023-03-16,2184
2891,中信金,90,1,89,亞東-新竹,2023-03-16,2184
2027,大成鋼,71,0,71,亞東-新竹,2023-03-16,2184
00713,元大台灣高息低波,52,0,52,亞東-新竹,2023-03-16,2184
6443,元晶,36,1,35,亞東-新竹,2023-03-16,2184
00715L,期街口布蘭特正2,67,34,33,亞東-新竹,2023-03-16,2184
3264,欣銓,33,0,33,亞東-新竹,2023-03-16,2184
2881,富邦金,31,0,31,亞東-新竹,2023-03-16,2184
3380,明泰,28,0,28,亞東-新竹,2023-03-16,2184
2834,臺企銀,62,35,27,亞東-新竹,2023-03-16,2184
1539,巨庭,25,0,25,亞東-新竹,2023-03-16,2184
00671R,富邦NASDAQ反1,25,0,25,亞東-新竹,2023-03-16,2184
3576,聯合再生,25,0,25,亞東-新竹,2023-03-16,2184
2618,長榮航,23,0,23,亞東-新竹,2023-03-16,2184
2887,台新金,21,0,21,亞東-新竹,2023-03-16,2184
00642U,期元大S＆P石油,20,0,20,亞東-新竹,2023-03-16,2184
6188,廣明,20,0,20,亞東-新竹,2023-03-16,2184
2888,新光金,19,0,19,亞東-新竹,2023-03-16,2184
2337,旺宏,15,0,15,亞東-新竹,2023-03-16,2184
2610,華航,47,32,15,亞東-新竹,2023-03-16,2184
2301,光寶科,14,0,14,亞東-新竹,2023-03-16,2184
1314,中石化,12,0,12,亞東-新竹,2023-03-16,2184
2338,光罩,18,6,12,亞東-新竹,2023-03-16,2184
2609,陽明,18,6,12,亞東-新竹,2023-03-16,2184
2603,長榮,30,19,11,亞東-新竹,2023-03-16,2184
00878,國泰永續高股息,23,13,10,亞東-新竹,2023-03-16,2184
2880,華南金,10,0,10,亞東-新竹,2023-03-16,2184
00896,中信綠能及電動車,10,0,10,亞東-新竹,2023-03-16,2184
2884,玉山金,10,0,10,亞東-新竹,2023-03-16,2184
6168,宏齊,10,0,10,亞東-新竹,2023-03-16,2184
6266,泰詠,10,2,8,亞東-新竹,2023-03-16,2184
4105,東洋,9,1,8,亞東-新竹,2023-03-16,2184
4128,中天,8,0,8,亞東-新竹,2023-03-16,2184
2882,國泰金,7,0,7,亞東-新竹,2023-03-16,2184
2845,遠東銀,7,0,7,亞東-新竹,2023-03-16,2184
2886,兆豐金,7,0,7,亞東-新竹,2023-03-16,2184
6788,華景電,7,0,7,亞東-新竹,2023-03-16,2184
9945,潤泰新,19,12,7,亞東-新竹,2023-03-16,2184
2885,元大金,6,0,6,亞東-新竹,2023-03-16,2184
2897,王道銀行,26,20,6,亞東-新竹,2023-03-16,2184
3710,連展投控,8,2,6,亞東-新竹,2023-03-16,2184
6461,益得,6,0,6,亞東-新竹,2023-03-16,2184
6271,同欣電,6,1,5,亞東-新竹,2023-03-16,2184
00680L,元大美債20正2,5,0,5,亞東-新竹,2023-03-16,2184
00645,富邦日本,5,0,5,亞東-新竹,2023-03-16,2184
00676R,富邦臺灣加權反1,5,0,5,亞東-新竹,2023-03-16,2184
0056,元大高股息,6,1,5,亞東-新竹,2023-03-16,2184
2605,新興,17,12,5,亞東-新竹,2023-03-16,2184
3033,威健,5,0,5,亞東-新竹,2023-03-16,2184
6120,達運,5,0,5,亞東-新竹,2023-03-16,2184
2891,中信金,218,0,218,亞東-新竹,2023-03-17,2184
9904,寶成,67,0,67,亞東-新竹,2023-03-17,2184
00671R,富邦NASDAQ反1,57,0,57,亞東-新竹,2023-03-17,2184
2610,華航,52,1,51,亞東-新竹,2023-03-17,2184
00642U,期元大S＆P石油,50,0,50,亞東-新竹,2023-03-17,2184
2338,光罩,41,5,36,亞東-新竹,2023-03-17,2184
1569,濱川,29,0,29,亞東-新竹,2023-03-17,2184
4916,事欣科,28,0,28,亞東-新竹,2023-03-17,2184
1402,遠東新,24,1,23,亞東-新竹,2023-03-17,2184
2352,佳世達,22,0,22,亞東-新竹,2023-03-17,2184
2883,凱基金,21,1,20,亞東-新竹,2023-03-17,2184
3481,群創,22,3,19,亞東-新竹,2023-03-17,2184
2603,長榮,30,11,19,亞東-新竹,2023-03-17,2184
4534,慶騰,18,0,18,亞東-新竹,2023-03-17,2184
00680L,元大美債20正2,16,0,16,亞東-新竹,2023-03-17,2184
6133,金橋,16,0,16,亞東-新竹,2023-03-17,2184
2888,新光金,12,0,12,亞東-新竹,2023-03-17,2184
2812,台中銀,11,0,11,亞東-新竹,2023-03-17,2184
00770,國泰北美科技,10,0,10,亞東-新竹,2023-03-17,2184
2605,新興,19,9,10,亞東-新竹,2023-03-17,2184
2834,臺企銀,10,0,10,亞東-新竹,2023-03-17,2184
3653,健策,10,1,9,亞東-新竹,2023-03-17,2184
4155,訊映,10,1,9,亞東-新竹,2023-03-17,2184
2489,瑞軒,8,0,8,亞東-新竹,2023-03-17,2184
2399,映泰,7,0,7,亞東-新竹,2023-03-17,2184
2892,第一金,6,0,6,亞東-新竹,2023-03-17,2184
1108,幸福,6,0,6,亞東-新竹,2023-03-17,2184
00679B,元大美債20年,7,1,6,亞東-新竹,2023-03-17,2184
2314,台揚,6,0,6,亞東-新竹,2023-03-17,2184
00687B,國泰20年美債,5,0,5,亞東-新竹,2023-03-17,2184
00715L,期街口布蘭特正2,5,0,5,亞東-新竹,2023-03-17,2184
2323,中環,5,0,5,亞東-新竹,2023-03-17,2184
3264,欣銓,5,0,5,亞東-新竹,2023-03-17,2184
6188,廣明,5,0,5,亞東-新竹,2023-03-17,2184
00637L,元大滬深300正2,4,0,4,亞東-新竹,2023-03-17,2184
2376,技嘉,4,0,4,亞東-新竹,2023-03-17,2184
3105,穩懋,4,0,4,亞東-新竹,2023-03-17,2184
2243,宏旭-KY,3,0,3,亞東-新竹,2023-03-17,2184
0056,元大高股息,3,0,3,亞東-新竹,2023-03-17,2184
1101,台泥,4,1,3,亞東-新竹,2023-03-17,2184
00720B,元大投資級公司債,3,0,3,亞東-新竹,2023-03-17,2184
00878,國泰永續高股息,3,0,3,亞東-新竹,2023-03-17,2184
1524,耿鼎,3,0,3,亞東-新竹,2023-03-17,2184
2028,威致,3,0,3,亞東-新竹,2023-03-17,2184
2313,華通,3,0,3,亞東-新竹,2023-03-17,2184
2492,華新科,3,0,3,亞東-新竹,2023-03-17,2184
2609,陽明,8,5,3,亞東-新竹,2023-03-17,2184
2890,永豐金,3,0,3,亞東-新竹,2023-03-17,2184
3540,曜越,3,0,3,亞東-新竹,2023-03-17,2184
3680,家登,4,1,3,亞東-新竹,2023-03-17,2184
2891,中信金,87,0,87,亞東-新竹,2023-03-20,2184
00878,國泰永續高股息,76,0,76,亞東-新竹,2023-03-20,2184
00720B,元大投資級公司債,55,0,55,亞東-新竹,2023-03-20,2184
00642U,期元大S＆P石油,50,0,50,亞東-新竹,2023-03-20,2184
00772B,中信高評級公司債,51,1,50,亞東-新竹,2023-03-20,2184
00715L,期街口布蘭特正2,57,10,47,亞東-新竹,2023-03-20,2184
2890,永豐金,43,0,43,亞東-新竹,2023-03-20,2184
4306,炎洲,35,0,35,亞東-新竹,2023-03-20,2184
00665L,富邦�琤肭磪囓�2,20,0,20,亞東-新竹,2023-03-20,2184
2897,王道銀行,20,0,20,亞東-新竹,2023-03-20,2184
6288,聯嘉,20,0,20,亞東-新竹,2023-03-20,2184
8390,金益鼎,20,0,20,亞東-新竹,2023-03-20,2184
4111,濟生,20,3,17,亞東-新竹,2023-03-20,2184
9945,潤泰新,16,0,16,亞東-新竹,2023-03-20,2184
1324,地球,16,0,16,亞東-新竹,2023-03-20,2184
1611,中電,16,1,15,亞東-新竹,2023-03-20,2184
00680L,元大美債20正2,15,0,15,亞東-新竹,2023-03-20,2184
3481,群創,13,0,13,亞東-新竹,2023-03-20,2184
2603,長榮,45,34,11,亞東-新竹,2023-03-20,2184
2881,富邦金,10,0,10,亞東-新竹,2023-03-20,2184
6188,廣明,10,1,9,亞東-新竹,2023-03-20,2184
2330,台積電,8,0,8,亞東-新竹,2023-03-20,2184
3019,亞光,7,0,7,亞東-新竹,2023-03-20,2184
2882,國泰金,6,0,6,亞東-新竹,2023-03-20,2184
2892,第一金,10,5,5,亞東-新竹,2023-03-20,2184
00632R,元大台灣50反1,10,5,5,亞東-新竹,2023-03-20,2184
2352,佳世達,5,0,5,亞東-新竹,2023-03-20,2184
5211,蒙恬,5,0,5,亞東-新竹,2023-03-20,2184
00670L,富邦NASDAQ正2,4,0,4,亞東-新竹,2023-03-20,2184
2618,長榮航,6,2,4,亞東-新竹,2023-03-20,2184
2880,華南金,4,0,4,亞東-新竹,2023-03-20,2184
2338,光罩,11,8,3,亞東-新竹,2023-03-20,2184
2888,新光金,3,0,3,亞東-新竹,2023-03-20,2184
4977,眾達-KY,3,0,3,亞東-新竹,2023-03-20,2184
5880,合庫金,3,0,3,亞東-新竹,2023-03-20,2184
6715,嘉基,4,1,3,亞東-新竹,2023-03-20,2184
8358,金居,3,0,3,亞東-新竹,2023-03-20,2184
8926,台汽電,10,7,3,亞東-新竹,2023-03-20,2184
1605,華新,4,2,2,亞東-新竹,2023-03-20,2184
0050,元大台灣50,2,0,2,亞東-新竹,2023-03-20,2184
1783,和康生,2,0,2,亞東-新竹,2023-03-20,2184
00892,富邦台灣半導體,3,1,2,亞東-新竹,2023-03-20,2184
1519,華城,2,0,2,亞東-新竹,2023-03-20,2184
1432,大魯閣,2,0,2,亞東-新竹,2023-03-20,2184
00751B,元大AAA至A公司債,6,4,2,亞東-新竹,2023-03-20,2184
00633L,富邦上証正2,7,5,2,亞東-新竹,2023-03-20,2184
1904,正隆,2,0,2,亞東-新竹,2023-03-20,2184
2206,三陽工業,2,0,2,亞東-新竹,2023-03-20,2184
2481,強茂,2,0,2,亞東-新竹,2023-03-20,2184
2845,遠東銀,3,1,2,亞東-新竹,2023-03-20,2184
6188,廣明,100,0,100,亞東-新竹,2023-03-21,2184
2610,華航,61,10,51,亞東-新竹,2023-03-21,2184
6140,訊達,40,0,40,亞東-新竹,2023-03-21,2184
2915,潤泰全,42,10,32,亞東-新竹,2023-03-21,2184
2457,飛宏,68,37,31,亞東-新竹,2023-03-21,2184
3481,群創,26,1,25,亞東-新竹,2023-03-21,2184
00878,國泰永續高股息,25,0,25,亞東-新竹,2023-03-21,2184
8936,國統,24,2,22,亞東-新竹,2023-03-21,2184
2402,毅嘉,23,2,21,亞東-新竹,2023-03-21,2184
1605,華新,24,4,20,亞東-新竹,2023-03-21,2184
00712,復華富時不動產,20,0,20,亞東-新竹,2023-03-21,2184
2444,兆勁,20,0,20,亞東-新竹,2023-03-21,2184
5469,瀚宇博,30,10,20,亞東-新竹,2023-03-21,2184
6243,迅杰,20,0,20,亞東-新竹,2023-03-21,2184
6288,聯嘉,30,10,20,亞東-新竹,2023-03-21,2184
00680L,元大美債20正2,18,0,18,亞東-新竹,2023-03-21,2184
1402,遠東新,17,0,17,亞東-新竹,2023-03-21,2184
6266,泰詠,16,0,16,亞東-新竹,2023-03-21,2184
00751B,元大AAA至A公司債,16,0,16,亞東-新竹,2023-03-21,2184
00882,中信中國高股息,13,0,13,亞東-新竹,2023-03-21,2184
2891,中信金,15,3,12,亞東-新竹,2023-03-21,2184
2618,長榮航,14,2,12,亞東-新竹,2023-03-21,2184
6770,力積電,12,1,11,亞東-新竹,2023-03-21,2184
3558,神準,13,3,10,亞東-新竹,2023-03-21,2184
00665L,富邦�琤肭磪囓�2,10,0,10,亞東-新竹,2023-03-21,2184
2303,聯電,16,7,9,亞東-新竹,2023-03-21,2184
5512,力麒,9,0,9,亞東-新竹,2023-03-21,2184
6233,旺玖,10,1,9,亞東-新竹,2023-03-21,2184
3037,欣興,11,2,9,亞東-新竹,2023-03-21,2184
3443,創意,9,1,8,亞東-新竹,2023-03-21,2184
1539,巨庭,8,0,8,亞東-新竹,2023-03-21,2184
5203,訊連,9,1,8,亞東-新竹,2023-03-21,2184
1611,中電,7,0,7,亞東-新竹,2023-03-21,2184
1524,耿鼎,6,0,6,亞東-新竹,2023-03-21,2184
0056,元大高股息,6,0,6,亞東-新竹,2023-03-21,2184
2408,南亞科,6,0,6,亞東-新竹,2023-03-21,2184
2313,華通,6,0,6,亞東-新竹,2023-03-21,2184
6531,愛普*,58,53,5,亞東-新竹,2023-03-21,2184
3189,景碩,6,1,5,亞東-新竹,2023-03-21,2184
3686,達能,5,0,5,亞東-新竹,2023-03-21,2184
6416,瑞祺電通,5,0,5,亞東-新竹,2023-03-21,2184
6449,鈺邦,5,0,5,亞東-新竹,2023-03-21,2184
8222,寶一,5,0,5,亞東-新竹,2023-03-21,2184
00679B,元大美債20年,7,3,4,亞東-新竹,2023-03-21,2184
2360,致茂,4,0,4,亞東-新竹,2023-03-21,2184
2401,凌陽,4,0,4,亞東-新竹,2023-03-21,2184
3047,訊舟,4,0,4,亞東-新竹,2023-03-21,2184
6148,驊宏資,4,0,4,亞東-新竹,2023-03-21,2184
6191,精成科,5,1,4,亞東-新竹,2023-03-21,2184
8111,立��,4,0,4,亞東-新竹,2023-03-21,2184
00632R,元大台灣50反1,337,10,327,亞東-新竹,2023-03-22,2184
2881,富邦金,41,0,41,亞東-新竹,2023-03-22,2184
1589,永冠-KY,66,32,34,亞東-新竹,2023-03-22,2184
6122,擎邦,34,0,34,亞東-新竹,2023-03-22,2184
3322,建舜電,31,1,30,亞東-新竹,2023-03-22,2184
2888,新光金,35,8,27,亞東-新竹,2023-03-22,2184
5469,瀚宇博,25,0,25,亞東-新竹,2023-03-22,2184
2436,偉詮電,20,0,20,亞東-新竹,2023-03-22,2184
2486,一詮,20,0,20,亞東-新竹,2023-03-22,2184
3052,夆典,17,0,17,亞東-新竹,2023-03-22,2184
3545,敦泰,29,12,17,亞東-新竹,2023-03-22,2184
1524,耿鼎,16,3,13,亞東-新竹,2023-03-22,2184
00671R,富邦NASDAQ反1,12,0,12,亞東-新竹,2023-03-22,2184
2201,裕隆,26,14,12,亞東-新竹,2023-03-22,2184
2834,臺企銀,22,10,12,亞東-新竹,2023-03-22,2184
8936,國統,12,0,12,亞東-新竹,2023-03-22,2184
2380,虹光,11,0,11,亞東-新竹,2023-03-22,2184
6196,帆宣,11,0,11,亞東-新竹,2023-03-22,2184
3481,群創,10,0,10,亞東-新竹,2023-03-22,2184
6125,廣運,11,1,10,亞東-新竹,2023-03-22,2184
00888,永豐台灣ESG,8,1,7,亞東-新竹,2023-03-22,2184
00679B,元大美債20年,19,12,7,亞東-新竹,2023-03-22,2184
3046,建��,15,8,7,亞東-新竹,2023-03-22,2184
1324,地球,6,0,6,亞東-新竹,2023-03-22,2184
00713,元大台灣高息低波,6,0,6,亞東-新竹,2023-03-22,2184
2408,南亞科,6,0,6,亞東-新竹,2023-03-22,2184
6104,創惟,6,0,6,亞東-新竹,2023-03-22,2184
6443,元晶,6,0,6,亞東-新竹,2023-03-22,2184
6770,力積電,6,0,6,亞東-新竹,2023-03-22,2184
00680L,元大美債20正2,5,0,5,亞東-新竹,2023-03-22,2184
1609,大亞,5,0,5,亞東-新竹,2023-03-22,2184
1909,榮成,5,0,5,亞東-新竹,2023-03-22,2184
8050,廣積,5,0,5,亞東-新竹,2023-03-22,2184
1513,中興電,4,0,4,亞東-新竹,2023-03-22,2184
8996,高力,8,4,4,亞東-新竹,2023-03-22,2184
1304,台聚,4,0,4,亞東-新竹,2023-03-22,2184
1611,中電,4,0,4,亞東-新竹,2023-03-22,2184
2376,技嘉,4,0,4,亞東-新竹,2023-03-22,2184
3264,欣銓,4,0,4,亞東-新竹,2023-03-22,2184
3499,環天科,4,0,4,亞東-新竹,2023-03-22,2184
4432,銘旺實,4,0,4,亞東-新竹,2023-03-22,2184
4743,合一,17,13,4,亞東-新竹,2023-03-22,2184
6550,北極星藥業-KY,4,0,4,亞東-新竹,2023-03-22,2184
8403,盛弘,4,0,4,亞東-新竹,2023-03-22,2184
9945,潤泰新,6,2,4,亞東-新竹,2023-03-22,2184
5608,四維航,13,10,3,亞東-新竹,2023-03-22,2184
01002T,土銀國泰R1,3,0,3,亞東-新竹,2023-03-22,2184
00670L,富邦NASDAQ正2,4,1,3,亞東-新竹,2023-03-22,2184
2388,威盛,10,7,3,亞東-新竹,2023-03-22,2184
2421,建準,3,0,3,亞東-新竹,2023-03-22,2184
00632R,元大台灣50反1,621,440,181,亞東-新竹,2023-03-23,2184
6188,廣明,60,0,60,亞東-新竹,2023-03-23,2184
1402,遠東新,42,1,41,亞東-新竹,2023-03-23,2184
00713,元大台灣高息低波,50,11,39,亞東-新竹,2023-03-23,2184
6163,華電網,35,4,31,亞東-新竹,2023-03-23,2184
6733,博晟生醫,31,0,31,亞東-新竹,2023-03-23,2184
6168,宏齊,30,0,30,亞東-新竹,2023-03-23,2184
6133,金橋,26,0,26,亞東-新竹,2023-03-23,2184
5465,富驊,25,0,25,亞東-新竹,2023-03-23,2184
4763,材料-KY,23,0,23,亞東-新竹,2023-03-23,2184
3702,大聯大,21,0,21,亞東-新竹,2023-03-23,2184
6531,愛普*,39,20,19,亞東-新竹,2023-03-23,2184
4919,新唐,23,5,18,亞東-新竹,2023-03-23,2184
00715L,期街口布蘭特正2,20,2,18,亞東-新竹,2023-03-23,2184
3025,星通,18,0,18,亞東-新竹,2023-03-23,2184
00679B,元大美債20年,17,6,11,亞東-新竹,2023-03-23,2184
00830,國泰費城半導體,11,0,11,亞東-新竹,2023-03-23,2184
3217,優群,10,0,10,亞東-新竹,2023-03-23,2184
3297,杭特,10,0,10,亞東-新竹,2023-03-23,2184
8086,宏捷科,10,0,10,亞東-新竹,2023-03-23,2184
8215,明基材,10,0,10,亞東-新竹,2023-03-23,2184
2402,毅嘉,29,20,9,亞東-新竹,2023-03-23,2184
3545,敦泰,9,0,9,亞東-新竹,2023-03-23,2184
4961,天鈺,8,0,8,亞東-新竹,2023-03-23,2184
00878,國泰永續高股息,7,0,7,亞東-新竹,2023-03-23,2184
8390,金益鼎,7,0,7,亞東-新竹,2023-03-23,2184
00646,元大S＆P500,6,0,6,亞東-新竹,2023-03-23,2184
2031,新光鋼,6,0,6,亞東-新竹,2023-03-23,2184
8046,南電,6,0,6,亞東-新竹,2023-03-23,2184
8926,台汽電,6,0,6,亞東-新竹,2023-03-23,2184
00637L,元大滬深300正2,5,0,5,亞東-新竹,2023-03-23,2184
00751B,元大AAA至A公司債,5,0,5,亞東-新竹,2023-03-23,2184
1783,和康生,5,0,5,亞東-新竹,2023-03-23,2184
2328,廣宇,5,0,5,亞東-新竹,2023-03-23,2184
3432,台端,5,0,5,亞東-新竹,2023-03-23,2184
3491,昇達科,10,5,5,亞東-新竹,2023-03-23,2184
6235,華孚,5,0,5,亞東-新竹,2023-03-23,2184
6570,維田,5,0,5,亞東-新竹,2023-03-23,2184
1319,東陽,4,0,4,亞東-新竹,2023-03-23,2184
00885,富邦越南,4,0,4,亞東-新竹,2023-03-23,2184
00720B,元大投資級公司債,4,0,4,亞東-新竹,2023-03-23,2184
2374,佳能,4,0,4,亞東-新竹,2023-03-23,2184
3483,力致,4,0,4,亞東-新竹,2023-03-23,2184
6274,台燿,4,0,4,亞東-新竹,2023-03-23,2184
4207,環泰,4,0,4,亞東-新竹,2023-03-23,2184
8996,高力,4,1,3,亞東-新竹,2023-03-23,2184
2603,長榮,11,8,3,亞東-新竹,2023-03-23,2184
00852L,國泰美國道瓊正2,3,0,3,亞東-新竹,2023-03-23,2184
1736,喬山,3,0,3,亞東-新竹,2023-03-23,2184
2453,凌群,3,0,3,亞東-新竹,2023-03-23,2184
2867,三商壽,110,0,110,亞東-新竹,2023-03-24,2184
2388,威盛,83,18,65,亞東-新竹,2023-03-24,2184
2498,宏達電,65,0,65,亞東-新竹,2023-03-24,2184
00632R,元大台灣50反1,468,410,58,亞東-新竹,2023-03-24,2184
3558,神準,34,2,32,亞東-新竹,2023-03-24,2184
1504,東元,35,4,31,亞東-新竹,2023-03-24,2184
2376,技嘉,31,0,31,亞東-新竹,2023-03-24,2184
3481,群創,105,75,30,亞東-新竹,2023-03-24,2184
3025,星通,30,1,29,亞東-新竹,2023-03-24,2184
2904,匯僑,25,0,25,亞東-新竹,2023-03-24,2184
9962,有益,25,0,25,亞東-新竹,2023-03-24,2184
2027,大成鋼,22,2,20,亞東-新竹,2023-03-24,2184
2489,瑞軒,20,0,20,亞東-新竹,2023-03-24,2184
2618,長榮航,30,10,20,亞東-新竹,2023-03-24,2184
8046,南電,23,5,18,亞東-新竹,2023-03-24,2184
4906,正文,17,0,17,亞東-新竹,2023-03-24,2184
2891,中信金,15,0,15,亞東-新竹,2023-03-24,2184
3704,合勤控,15,1,14,亞東-新竹,2023-03-24,2184
2303,聯電,14,1,13,亞東-新竹,2023-03-24,2184
3032,偉訓,11,0,11,亞東-新竹,2023-03-24,2184
3260,威剛,17,6,11,亞東-新竹,2023-03-24,2184
1524,耿鼎,10,0,10,亞東-新竹,2023-03-24,2184
00637L,元大滬深300正2,10,0,10,亞東-新竹,2023-03-24,2184
4108,懷特,10,0,10,亞東-新竹,2023-03-24,2184
4534,慶騰,10,0,10,亞東-新竹,2023-03-24,2184
8171,天宇,10,0,10,亞東-新竹,2023-03-24,2184
2382,廣達,9,0,9,亞東-新竹,2023-03-24,2184
8926,台汽電,9,0,9,亞東-新竹,2023-03-24,2184
2886,兆豐金,8,0,8,亞東-新竹,2023-03-24,2184
5469,瀚宇博,8,0,8,亞東-新竹,2023-03-24,2184
1609,大亞,8,1,7,亞東-新竹,2023-03-24,2184
2882,國泰金,7,0,7,亞東-新竹,2023-03-24,2184
3289,宜特,7,0,7,亞東-新竹,2023-03-24,2184
9951,皇田,7,0,7,亞東-新竹,2023-03-24,2184
00900,富邦特選高股息30,7,1,6,亞東-新竹,2023-03-24,2184
00751B,元大AAA至A公司債,6,0,6,亞東-新竹,2023-03-24,2184
2332,友訊,17,11,6,亞東-新竹,2023-03-24,2184
6133,金橋,6,0,6,亞東-新竹,2023-03-24,2184
00679B,元大美債20年,8,3,5,亞東-新竹,2023-03-24,2184
1529,樂事綠能,5,0,5,亞東-新竹,2023-03-24,2184
00908,富邦入息REITs+,5,0,5,亞東-新竹,2023-03-24,2184
00671R,富邦NASDAQ反1,5,0,5,亞東-新竹,2023-03-24,2184
1810,和成,5,0,5,亞東-新竹,2023-03-24,2184
3715,定穎投控,5,0,5,亞東-新竹,2023-03-24,2184
4157,太景*-KY,21,16,5,亞東-新竹,2023-03-24,2184
6209,今國光,5,0,5,亞東-新竹,2023-03-24,2184
8249,菱光,5,0,5,亞東-新竹,2023-03-24,2184
8478,東哥遊艇,10,5,5,亞東-新竹,2023-03-24,2184
0056,元大高股息,4,0,4,亞東-新竹,2023-03-24,2184
00853B,統一美債10年Aa-,4,0,4,亞東-新竹,2023-03-24,2184
00772B,中信高評級公司債,54,0,54,亞東-新竹,2023-03-27,2184
00715L,期街口布蘭特正2,50,3,47,亞東-新竹,2023-03-27,2184
2867,三商壽,30,0,30,亞東-新竹,2023-03-27,2184
2380,虹光,25,0,25,亞東-新竹,2023-03-27,2184
3322,建舜電,25,0,25,亞東-新竹,2023-03-27,2184
00882,中信中國高股息,22,0,22,亞東-新竹,2023-03-27,2184
1319,東陽,21,0,21,亞東-新竹,2023-03-27,2184
6129,普誠,21,0,21,亞東-新竹,2023-03-27,2184
4989,榮科,20,0,20,亞東-新竹,2023-03-27,2184
2201,裕隆,22,4,18,亞東-新竹,2023-03-27,2184
2342,茂矽,19,2,17,亞東-新竹,2023-03-27,2184
1605,華新,16,0,16,亞東-新竹,2023-03-27,2184
2904,匯僑,15,0,15,亞東-新竹,2023-03-27,2184
8358,金居,15,0,15,亞東-新竹,2023-03-27,2184
3558,神準,15,1,14,亞東-新竹,2023-03-27,2184
00671R,富邦NASDAQ反1,12,0,12,亞東-新竹,2023-03-27,2184
00632R,元大台灣50反1,12,0,12,亞東-新竹,2023-03-27,2184
3264,欣銓,12,0,12,亞東-新竹,2023-03-27,2184
2886,兆豐金,11,0,11,亞東-新竹,2023-03-27,2184
3046,建��,18,7,11,亞東-新竹,2023-03-27,2184
1539,巨庭,10,0,10,亞東-新竹,2023-03-27,2184
1609,大亞,11,1,10,亞東-新竹,2023-03-27,2184
00642U,期元大S＆P石油,10,0,10,亞東-新竹,2023-03-27,2184
3545,敦泰,10,0,10,亞東-新竹,2023-03-27,2184
4551,智伸科,8,0,8,亞東-新竹,2023-03-27,2184
00680L,元大美債20正2,7,0,7,亞東-新竹,2023-03-27,2184
5263,智崴,6,0,6,亞東-新竹,2023-03-27,2184
2329,華泰,6,0,6,亞東-新竹,2023-03-27,2184
2330,台積電,8,2,6,亞東-新竹,2023-03-27,2184
2482,連宇,6,0,6,亞東-新竹,2023-03-27,2184
2634,漢翔,8,2,6,亞東-新竹,2023-03-27,2184
3090,日電貿,6,0,6,亞東-新竹,2023-03-27,2184
3287,廣寰科,6,0,6,亞東-新竹,2023-03-27,2184
6163,華電網,9,3,6,亞東-新竹,2023-03-27,2184
8403,盛弘,6,0,6,亞東-新竹,2023-03-27,2184
2002,中鋼,5,0,5,亞東-新竹,2023-03-27,2184
1785,光洋科,5,0,5,亞東-新竹,2023-03-27,2184
00878,國泰永續高股息,5,0,5,亞東-新竹,2023-03-27,2184
00922,國泰台灣領袖50,5,0,5,亞東-新竹,2023-03-27,2184
2006,東和鋼鐵,5,0,5,亞東-新竹,2023-03-27,2184
3605,宏致,5,0,5,亞東-新竹,2023-03-27,2184
4157,太景*-KY,5,0,5,亞東-新竹,2023-03-27,2184
5469,瀚宇博,5,0,5,亞東-新竹,2023-03-27,2184
6288,聯嘉,10,5,5,亞東-新竹,2023-03-27,2184
6733,博晟生醫,13,8,5,亞東-新竹,2023-03-27,2184
9933,中鼎,5,0,5,亞東-新竹,2023-03-27,2184
2303,聯電,24,20,4,亞東-新竹,2023-03-27,2184
1342,八貫,4,0,4,亞東-新竹,2023-03-27,2184
1591,駿吉-KY,4,0,4,亞東-新竹,2023-03-27,2184
3703,欣陸,4,0,4,亞東-新竹,2023-03-27,2184
2883,凱基金,100,0,100,亞東-新竹,2023-03-28,2184
00772B,中信高評級公司債,56,0,56,亞東-新竹,2023-03-28,2184
3025,星通,51,0,51,亞東-新竹,2023-03-28,2184
2891,中信金,50,5,45,亞東-新竹,2023-03-28,2184
4743,合一,40,0,40,亞東-新竹,2023-03-28,2184
6168,宏齊,40,0,40,亞東-新竹,2023-03-28,2184
6129,普誠,36,0,36,亞東-新竹,2023-03-28,2184
6133,金橋,32,0,32,亞東-新竹,2023-03-28,2184
2303,聯電,20,0,20,亞東-新竹,2023-03-28,2184
00922,國泰台灣領袖50,20,0,20,亞東-新竹,2023-03-28,2184
1762,中化生,20,0,20,亞東-新竹,2023-03-28,2184
3037,欣興,21,2,19,亞東-新竹,2023-03-28,2184
2358,廷鑫,19,0,19,亞東-新竹,2023-03-28,2184
00679B,元大美債20年,19,1,18,亞東-新竹,2023-03-28,2184
3481,群創,15,2,13,亞東-新竹,2023-03-28,2184
2458,義隆,11,0,11,亞東-新竹,2023-03-28,2184
3046,建��,15,4,11,亞東-新竹,2023-03-28,2184
00676R,富邦臺灣加權反1,10,0,10,亞東-新竹,2023-03-28,2184
00673R,期元大S＆P原油反1,10,0,10,亞東-新竹,2023-03-28,2184
1529,樂事綠能,10,0,10,亞東-新竹,2023-03-28,2184
1504,東元,10,0,10,亞東-新竹,2023-03-28,2184
3310,佳穎,10,0,10,亞東-新竹,2023-03-28,2184
6590,普鴻,10,0,10,亞東-新竹,2023-03-28,2184
8289,泰藝,10,0,10,亞東-新竹,2023-03-28,2184
1539,巨庭,10,1,9,亞東-新竹,2023-03-28,2184
4961,天鈺,9,0,9,亞東-新竹,2023-03-28,2184
2330,台積電,8,0,8,亞東-新竹,2023-03-28,2184
4989,榮科,10,2,8,亞東-新竹,2023-03-28,2184
1101,台泥,9,2,7,亞東-新竹,2023-03-28,2184
00751B,元大AAA至A公司債,7,0,7,亞東-新竹,2023-03-28,2184
3287,廣寰科,7,0,7,亞東-新竹,2023-03-28,2184
4916,事欣科,7,0,7,亞東-新竹,2023-03-28,2184
4979,華星光,8,1,7,亞東-新竹,2023-03-28,2184
6282,康舒,7,0,7,亞東-新竹,2023-03-28,2184
1618,合機,6,0,6,亞東-新竹,2023-03-28,2184
00708L,期元大S＆P黃金正2,6,0,6,亞東-新竹,2023-03-28,2184
00720B,元大投資級公司債,6,0,6,亞東-新竹,2023-03-28,2184
2409,友達,6,0,6,亞東-新竹,2023-03-28,2184
2481,強茂,6,0,6,亞東-新竹,2023-03-28,2184
2886,兆豐金,6,0,6,亞東-新竹,2023-03-28,2184
4566,時碩工業,6,0,6,亞東-新竹,2023-03-28,2184
00830,國泰費城半導體,5,0,5,亞東-新竹,2023-03-28,2184
00795B,中信美國公債20年,5,0,5,亞東-新竹,2023-03-28,2184
1319,東陽,5,0,5,亞東-新竹,2023-03-28,2184
00680L,元大美債20正2,5,0,5,亞東-新竹,2023-03-28,2184
2006,東和鋼鐵,5,0,5,亞東-新竹,2023-03-28,2184
2809,京城銀,5,0,5,亞東-新竹,2023-03-28,2184
3702,大聯大,5,0,5,亞東-新竹,2023-03-28,2184
4971,IET-KY,5,0,5,亞東-新竹,2023-03-28,2184
5011,久陽,6,1,5,亞東-新竹,2023-03-28,2184
2331,精英,121,0,121,亞東-新竹,2023-03-29,2184
2852,第一保,47,0,47,亞東-新竹,2023-03-29,2184
00892,富邦台灣半導體,40,0,40,亞東-新竹,2023-03-29,2184
2867,三商壽,30,0,30,亞東-新竹,2023-03-29,2184
2380,虹光,27,0,27,亞東-新竹,2023-03-29,2184
2887,台新金,20,0,20,亞東-新竹,2023-03-29,2184
2303,聯電,19,0,19,亞東-新竹,2023-03-29,2184
6770,力積電,15,0,15,亞東-新竹,2023-03-29,2184
00680L,元大美債20正2,12,0,12,亞東-新竹,2023-03-29,2184
2603,長榮,12,1,11,亞東-新竹,2023-03-29,2184
00679B,元大美債20年,11,0,11,亞東-新竹,2023-03-29,2184
6590,普鴻,10,0,10,亞東-新竹,2023-03-29,2184
6147,頎邦,9,0,9,亞東-新竹,2023-03-29,2184
6753,龍德造船,9,0,9,亞東-新竹,2023-03-29,2184
5309,系統電,8,0,8,亞東-新竹,2023-03-29,2184
1605,華新,10,3,7,亞東-新竹,2023-03-29,2184
2314,台揚,7,0,7,亞東-新竹,2023-03-29,2184
6288,聯嘉,8,1,7,亞東-新竹,2023-03-29,2184
00637L,元大滬深300正2,11,5,6,亞東-新竹,2023-03-29,2184
00713,元大台灣高息低波,6,0,6,亞東-新竹,2023-03-29,2184
5475,德宏,6,0,6,亞東-新竹,2023-03-29,2184
3034,聯詠,6,0,6,亞東-新竹,2023-03-29,2184
00720B,元大投資級公司債,5,0,5,亞東-新竹,2023-03-29,2184
00673R,期元大S＆P原油反1,5,0,5,亞東-新竹,2023-03-29,2184
1314,中石化,5,0,5,亞東-新竹,2023-03-29,2184
00878,國泰永續高股息,5,0,5,亞東-新竹,2023-03-29,2184
00850,元大臺灣ESG永續,5,0,5,亞東-新竹,2023-03-29,2184
2489,瑞軒,5,0,5,亞東-新竹,2023-03-29,2184
2618,長榮航,5,0,5,亞東-新竹,2023-03-29,2184
2845,遠東銀,5,0,5,亞東-新竹,2023-03-29,2184
3041,揚智,5,0,5,亞東-新竹,2023-03-29,2184
4971,IET-KY,5,0,5,亞東-新竹,2023-03-29,2184
5272,笙科,5,0,5,亞東-新竹,2023-03-29,2184
6220,岳豐,5,0,5,亞東-新竹,2023-03-29,2184
9904,寶成,5,0,5,亞東-新竹,2023-03-29,2184
9933,中鼎,5,0,5,亞東-新竹,2023-03-29,2184
6531,愛普*,5,1,4,亞東-新竹,2023-03-29,2184
1539,巨庭,4,0,4,亞東-新竹,2023-03-29,2184
1529,樂事綠能,4,0,4,亞東-新竹,2023-03-29,2184
00772B,中信高評級公司債,4,0,4,亞東-新竹,2023-03-29,2184
2408,南亞科,4,0,4,亞東-新竹,2023-03-29,2184
2449,京元電子,4,0,4,亞東-新竹,2023-03-29,2184
3264,欣銓,5,1,4,亞東-新竹,2023-03-29,2184
3322,建舜電,4,0,4,亞東-新竹,2023-03-29,2184
3529,力旺,6,2,4,亞東-新竹,2023-03-29,2184
6443,元晶,4,0,4,亞東-新竹,2023-03-29,2184
8028,昇陽半導體,4,0,4,亞東-新竹,2023-03-29,2184
5347,世界,3,0,3,亞東-新竹,2023-03-29,2184
3528,安馳,3,0,3,亞東-新竹,2023-03-29,2184
4973,廣穎,3,0,3,亞東-新竹,2023-03-29,2184
00632R,元大台灣50反1,232,0,232,亞東-新竹,2023-03-30,2184
00772B,中信高評級公司債,50,0,50,亞東-新竹,2023-03-30,2184
2515,中工,40,0,40,亞東-新竹,2023-03-30,2184
5309,系統電,40,8,32,亞東-新竹,2023-03-30,2184
5469,瀚宇博,30,0,30,亞東-新竹,2023-03-30,2184
2302,麗正,30,1,29,亞東-新竹,2023-03-30,2184
3715,定穎投控,30,7,23,亞東-新竹,2023-03-30,2184
2889,國票金,21,0,21,亞東-新竹,2023-03-30,2184
2891,中信金,21,0,21,亞東-新竹,2023-03-30,2184
2486,一詮,20,0,20,亞東-新竹,2023-03-30,2184
4207,環泰,20,0,20,亞東-新竹,2023-03-30,2184
8046,南電,20,0,20,亞東-新竹,2023-03-30,2184
2867,三商壽,19,0,19,亞東-新竹,2023-03-30,2184
1605,華新,24,6,18,亞東-新竹,2023-03-30,2184
2380,虹光,17,0,17,亞東-新竹,2023-03-30,2184
4157,太景*-KY,15,0,15,亞東-新竹,2023-03-30,2184
00665L,富邦�琤肭磪囓�2,40,30,10,亞東-新竹,2023-03-30,2184
2498,宏達電,16,6,10,亞東-新竹,2023-03-30,2184
3704,合勤控,10,0,10,亞東-新竹,2023-03-30,2184
3711,日月光投控,10,0,10,亞東-新竹,2023-03-30,2184
2409,友達,9,0,9,亞東-新竹,2023-03-30,2184
2006,東和鋼鐵,8,0,8,亞東-新竹,2023-03-30,2184
1786,科妍,8,0,8,亞東-新竹,2023-03-30,2184
3693,營邦,24,16,8,亞東-新竹,2023-03-30,2184
00679B,元大美債20年,8,0,8,亞東-新竹,2023-03-30,2184
3290,東浦,7,0,7,亞東-新竹,2023-03-30,2184
4306,炎洲,7,0,7,亞東-新竹,2023-03-30,2184
8110,華東,7,0,7,亞東-新竹,2023-03-30,2184
3707,漢磊,7,1,6,亞東-新竹,2023-03-30,2184
00710B,復華彭博非投等債,6,0,6,亞東-新竹,2023-03-30,2184
2457,飛宏,11,5,6,亞東-新竹,2023-03-30,2184
3540,曜越,6,0,6,亞東-新竹,2023-03-30,2184
4967,十銓,7,1,6,亞東-新竹,2023-03-30,2184
6129,普誠,6,0,6,亞東-新竹,2023-03-30,2184
3034,聯詠,7,2,5,亞東-新竹,2023-03-30,2184
1319,東陽,5,0,5,亞東-新竹,2023-03-30,2184
6133,金橋,13,8,5,亞東-新竹,2023-03-30,2184
1817,凱撒衛,4,0,4,亞東-新竹,2023-03-30,2184
2388,威盛,13,9,4,亞東-新竹,2023-03-30,2184
3504,揚明光,4,0,4,亞東-新竹,2023-03-30,2184
9945,潤泰新,4,0,4,亞東-新竹,2023-03-30,2184
00751B,元大AAA至A公司債,13,10,3,亞東-新竹,2023-03-30,2184
2347,聯強,3,0,3,亞東-新竹,2023-03-30,2184
2753,八方雲集,3,0,3,亞東-新竹,2023-03-30,2184
4566,時碩工業,3,0,3,亞東-新竹,2023-03-30,2184
3706,神達,2,0,2,亞東-新竹,2023-03-30,2184
1721,三晃,2,0,2,亞東-新竹,2023-03-30,2184
1504,東元,4,2,2,亞東-新竹,2023-03-30,2184
2331,精英,3,1,2,亞東-新竹,2023-03-30,2184
2392,正崴,2,0,2,亞東-新竹,2023-03-30,2184
00632R,元大台灣50反1,352,0,352,亞東-新竹,2023-03-31,2184
00772B,中信高評級公司債,55,3,52,亞東-新竹,2023-03-31,2184
2331,精英,50,0,50,亞東-新竹,2023-03-31,2184
0056,元大高股息,42,2,40,亞東-新竹,2023-03-31,2184
2027,大成鋼,40,0,40,亞東-新竹,2023-03-31,2184
00679B,元大美債20年,33,1,32,亞東-新竹,2023-03-31,2184
1605,華新,38,16,22,亞東-新竹,2023-03-31,2184
5309,系統電,30,10,20,亞東-新竹,2023-03-31,2184
6147,頎邦,30,11,19,亞東-新竹,2023-03-31,2184
6288,聯嘉,13,1,12,亞東-新竹,2023-03-31,2184
00671R,富邦NASDAQ反1,10,0,10,亞東-新竹,2023-03-31,2184
2812,台中銀,10,0,10,亞東-新竹,2023-03-31,2184
3259,鑫創,10,0,10,亞東-新竹,2023-03-31,2184
3596,智易,10,0,10,亞東-新竹,2023-03-31,2184
8936,國統,10,0,10,亞東-新竹,2023-03-31,2184
6770,力積電,9,0,9,亞東-新竹,2023-03-31,2184
00720B,元大投資級公司債,8,0,8,亞東-新竹,2023-03-31,2184
2201,裕隆,15,7,8,亞東-新竹,2023-03-31,2184
4105,東洋,6,0,6,亞東-新竹,2023-03-31,2184
6829,千附精密,6,0,6,亞東-新竹,2023-03-31,2184
3592,瑞鼎,5,0,5,亞東-新竹,2023-03-31,2184
00726B,國泰新興投等債,5,0,5,亞東-新竹,2023-03-31,2184
00673R,期元大S＆P原油反1,5,0,5,亞東-新竹,2023-03-31,2184
2002,中鋼,5,0,5,亞東-新竹,2023-03-31,2184
3059,華晶科,5,0,5,亞東-新竹,2023-03-31,2184
3564,其陽,5,0,5,亞東-新竹,2023-03-31,2184
5469,瀚宇博,5,0,5,亞東-新竹,2023-03-31,2184
2402,毅嘉,6,2,4,亞東-新竹,2023-03-31,2184
3037,欣興,11,7,4,亞東-新竹,2023-03-31,2184
3714,富采,4,0,4,亞東-新竹,2023-03-31,2184
6461,益得,4,0,4,亞東-新竹,2023-03-31,2184
6719,力智,3,0,3,亞東-新竹,2023-03-31,2184
2753,八方雲集,3,0,3,亞東-新竹,2023-03-31,2184
1504,東元,7,4,3,亞東-新竹,2023-03-31,2184
1539,巨庭,3,0,3,亞東-新竹,2023-03-31,2184
3289,宜特,3,0,3,亞東-新竹,2023-03-31,2184
4551,智伸科,3,0,3,亞東-新竹,2023-03-31,2184
8271,宇瞻,3,0,3,亞東-新竹,2023-03-31,2184
8284,三竹,3,0,3,亞東-新竹,2023-03-31,2184
00713,元大台灣高息低波,2,0,2,亞東-新竹,2023-03-31,2184
1565,精華,2,0,2,亞東-新竹,2023-03-31,2184
2364,倫飛,2,0,2,亞東-新竹,2023-03-31,2184
3042,晶技,2,0,2,亞東-新竹,2023-03-31,2184
3231,緯創,3,1,2,亞東-新竹,2023-03-31,2184
5351,鈺創,4,2,2,亞東-新竹,2023-03-31,2184
5536,聖暉*,2,0,2,亞東-新竹,2023-03-31,2184
5880,合庫金,2,0,2,亞東-新竹,2023-03-31,2184
6443,元晶,2,0,2,亞東-新竹,2023-03-31,2184
6799,來頡,2,0,2,亞東-新竹,2023-03-31,2184
8121,越峰,2,0,2,亞東-新竹,2023-03-31,2184
00772B,中信高評級公司債,54,0,54,亞東-新竹,2023-04-06,2184
2317,鴻海,46,2,44,亞東-新竹,2023-04-06,2184
6770,力積電,40,0,40,亞東-新竹,2023-04-06,2184
5465,富驊,37,0,37,亞東-新竹,2023-04-06,2184
4207,環泰,30,0,30,亞東-新竹,2023-04-06,2184
00673R,期元大S＆P原油反1,29,0,29,亞東-新竹,2023-04-06,2184
6139,亞翔,20,0,20,亞東-新竹,2023-04-06,2184
00892,富邦台灣半導體,20,0,20,亞東-新竹,2023-04-06,2184
1218,泰山,16,0,16,亞東-新竹,2023-04-06,2184
00893,國泰智能電動車,15,0,15,亞東-新竹,2023-04-06,2184
2442,新美齊,15,0,15,亞東-新竹,2023-04-06,2184
00830,國泰費城半導體,14,0,14,亞東-新竹,2023-04-06,2184
3162,精確,17,3,14,亞東-新竹,2023-04-06,2184
1402,遠東新,12,0,12,亞東-新竹,2023-04-06,2184
1785,光洋科,16,5,11,亞東-新竹,2023-04-06,2184
6244,茂迪,11,0,11,亞東-新竹,2023-04-06,2184
00922,國泰台灣領袖50,10,0,10,亞東-新竹,2023-04-06,2184
2358,廷鑫,10,0,10,亞東-新竹,2023-04-06,2184
4726,永昕,10,0,10,亞東-新竹,2023-04-06,2184
6138,茂達,12,2,10,亞東-新竹,2023-04-06,2184
6266,泰詠,20,10,10,亞東-新竹,2023-04-06,2184
00882,中信中國高股息,9,0,9,亞東-新竹,2023-04-06,2184
2324,仁寶,8,0,8,亞東-新竹,2023-04-06,2184
2609,陽明,13,5,8,亞東-新竹,2023-04-06,2184
3037,欣興,8,0,8,亞東-新竹,2023-04-06,2184
4306,炎洲,8,0,8,亞東-新竹,2023-04-06,2184
3034,聯詠,8,1,7,亞東-新竹,2023-04-06,2184
3004,豐達科,7,0,7,亞東-新竹,2023-04-06,2184
0056,元大高股息,9,3,6,亞東-新竹,2023-04-06,2184
00712,復華富時不動產,6,0,6,亞東-新竹,2023-04-06,2184
00713,元大台灣高息低波,10,5,5,亞東-新竹,2023-04-06,2184
00850,元大臺灣ESG永續,5,0,5,亞東-新竹,2023-04-06,2184
2006,東和鋼鐵,5,0,5,亞東-新竹,2023-04-06,2184
2458,義隆,5,0,5,亞東-新竹,2023-04-06,2184
2809,京城銀,5,0,5,亞東-新竹,2023-04-06,2184
2889,國票金,5,0,5,亞東-新竹,2023-04-06,2184
3081,聯亞,5,0,5,亞東-新竹,2023-04-06,2184
3141,晶宏,5,0,5,亞東-新竹,2023-04-06,2184
6148,驊宏資,5,0,5,亞東-新竹,2023-04-06,2184
8938,明安,5,0,5,亞東-新竹,2023-04-06,2184
9904,寶成,5,0,5,亞東-新竹,2023-04-06,2184
2454,聯發科,4,0,4,亞東-新竹,2023-04-06,2184
00923,群益台ESG低碳50,4,0,4,亞東-新竹,2023-04-06,2184
2303,聯電,4,0,4,亞東-新竹,2023-04-06,2184
3032,偉訓,4,0,4,亞東-新竹,2023-04-06,2184
3289,宜特,4,0,4,亞東-新竹,2023-04-06,2184
5309,系統電,6,2,4,亞東-新竹,2023-04-06,2184
5706,鳳凰,4,0,4,亞東-新竹,2023-04-06,2184
9921,巨大,3,0,3,亞東-新竹,2023-04-06,2184
1324,地球,3,0,3,亞東-新竹,2023-04-06,2184
00632R,元大台灣50反1,320,0,320,亞東-新竹,2023-04-07,2184
00773B,中信優先金融債,70,0,70,亞東-新竹,2023-04-07,2184
2317,鴻海,50,2,48,亞東-新竹,2023-04-07,2184
6163,華電網,48,0,48,亞東-新竹,2023-04-07,2184
3025,星通,27,0,27,亞東-新竹,2023-04-07,2184
00772B,中信高評級公司債,26,2,24,亞東-新竹,2023-04-07,2184
3062,建漢,12,0,12,亞東-新竹,2023-04-07,2184
3711,日月光投控,12,0,12,亞東-新竹,2023-04-07,2184
4207,環泰,11,0,11,亞東-新竹,2023-04-07,2184
01007T,兆豐國泰R2,10,0,10,亞東-新竹,2023-04-07,2184
2380,虹光,10,0,10,亞東-新竹,2023-04-07,2184
2834,臺企銀,10,0,10,亞東-新竹,2023-04-07,2184
2867,三商壽,10,0,10,亞東-新竹,2023-04-07,2184
4123,晟德,10,0,10,亞東-新竹,2023-04-07,2184
3287,廣寰科,7,0,7,亞東-新竹,2023-04-07,2184
2303,聯電,6,0,6,亞東-新竹,2023-04-07,2184
00642U,期元大S＆P石油,6,0,6,亞東-新竹,2023-04-07,2184
00923,群益台ESG低碳50,6,0,6,亞東-新竹,2023-04-07,2184
6548,長科*,6,0,6,亞東-新竹,2023-04-07,2184
6605,帝寶,6,0,6,亞東-新竹,2023-04-07,2184
1535,中宇,5,0,5,亞東-新竹,2023-04-07,2184
00922,國泰台灣領袖50,5,0,5,亞東-新竹,2023-04-07,2184
00770,國泰北美科技,5,0,5,亞東-新竹,2023-04-07,2184
00724B,群益投資級金融債,5,0,5,亞東-新竹,2023-04-07,2184
2610,華航,7,2,5,亞東-新竹,2023-04-07,2184
2884,玉山金,6,1,5,亞東-新竹,2023-04-07,2184
3432,台端,5,0,5,亞東-新竹,2023-04-07,2184
4138,曜亞,5,0,5,亞東-新竹,2023-04-07,2184
6184,大豐電,5,0,5,亞東-新竹,2023-04-07,2184
8403,盛弘,5,0,5,亞東-新竹,2023-04-07,2184
2364,倫飛,4,0,4,亞東-新竹,2023-04-07,2184
2402,毅嘉,4,0,4,亞東-新竹,2023-04-07,2184
5263,智崴,4,0,4,亞東-新竹,2023-04-07,2184
8409,商之器,4,0,4,亞東-新竹,2023-04-07,2184
8415,大國鋼,4,0,4,亞東-新竹,2023-04-07,2184
6770,力積電,3,0,3,亞東-新竹,2023-04-07,2184
00713,元大台灣高息低波,3,0,3,亞東-新竹,2023-04-07,2184
2302,麗正,5,2,3,亞東-新竹,2023-04-07,2184
2013,中鋼構,3,0,3,亞東-新竹,2023-04-07,2184
1504,東元,3,0,3,亞東-新竹,2023-04-07,2184
00902,中信電池及儲能,3,0,3,亞東-新竹,2023-04-07,2184
00878,國泰永續高股息,6,3,3,亞東-新竹,2023-04-07,2184
2379,瑞昱,3,0,3,亞東-新竹,2023-04-07,2184
3046,建��,4,1,3,亞東-新竹,2023-04-07,2184
4306,炎洲,3,0,3,亞東-新竹,2023-04-07,2184
4566,時碩工業,3,0,3,亞東-新竹,2023-04-07,2184
6133,金橋,3,0,3,亞東-新竹,2023-04-07,2184
6715,嘉基,3,0,3,亞東-新竹,2023-04-07,2184
8227,巨有科技,3,0,3,亞東-新竹,2023-04-07,2184
1210,大成,2,0,2,亞東-新竹,2023-04-07,2184
00772B,中信高評級公司債,61,2,59,亞東-新竹,2023-04-10,2184
2427,三商電,55,0,55,亞東-新竹,2023-04-10,2184
00751B,元大AAA至A公司債,50,0,50,亞東-新竹,2023-04-10,2184
6133,金橋,46,2,44,亞東-新竹,2023-04-10,2184
2603,長榮,36,0,36,亞東-新竹,2023-04-10,2184
2344,華邦電,36,7,29,亞東-新竹,2023-04-10,2184
4977,眾達-KY,24,0,24,亞東-新竹,2023-04-10,2184
00773B,中信優先金融債,20,0,20,亞東-新竹,2023-04-10,2184
4207,環泰,19,0,19,亞東-新竹,2023-04-10,2184
8050,廣積,20,1,19,亞東-新竹,2023-04-10,2184
00673R,期元大S＆P原油反1,15,0,15,亞東-新竹,2023-04-10,2184
1605,華新,14,0,14,亞東-新竹,2023-04-10,2184
6829,千附精密,11,0,11,亞東-新竹,2023-04-10,2184
00881,國泰台灣5G+,10,0,10,亞東-新竹,2023-04-10,2184
2605,新興,10,0,10,亞東-新竹,2023-04-10,2184
6125,廣運,10,0,10,亞東-新竹,2023-04-10,2184
6770,力積電,11,1,10,亞東-新竹,2023-04-10,2184
1609,大亞,10,1,9,亞東-新竹,2023-04-10,2184
2610,華航,30,21,9,亞東-新竹,2023-04-10,2184
6288,聯嘉,10,1,9,亞東-新竹,2023-04-10,2184
3287,廣寰科,8,0,8,亞東-新竹,2023-04-10,2184
9934,成霖,8,0,8,亞東-新竹,2023-04-10,2184
3490,單井,7,0,7,亞東-新竹,2023-04-10,2184
6227,茂綸,7,0,7,亞東-新竹,2023-04-10,2184
2303,聯電,7,1,6,亞東-新竹,2023-04-10,2184
4953,緯軟,6,0,6,亞東-新竹,2023-04-10,2184
5425,台半,10,4,6,亞東-新竹,2023-04-10,2184
2323,中環,6,0,6,亞東-新竹,2023-04-10,2184
2006,東和鋼鐵,5,0,5,亞東-新竹,2023-04-10,2184
1762,中化生,5,0,5,亞東-新竹,2023-04-10,2184
1451,年興,5,0,5,亞東-新竹,2023-04-10,2184
00720B,元大投資級公司債,5,0,5,亞東-新竹,2023-04-10,2184
0056,元大高股息,6,1,5,亞東-新竹,2023-04-10,2184
3520,華盈,5,0,5,亞東-新竹,2023-04-10,2184
4128,中天,7,2,5,亞東-新竹,2023-04-10,2184
6530,創威,5,0,5,亞東-新竹,2023-04-10,2184
6605,帝寶,5,0,5,亞東-新竹,2023-04-10,2184
8924,大田,5,0,5,亞東-新竹,2023-04-10,2184
00679B,元大美債20年,6,1,5,亞東-新竹,2023-04-10,2184
2454,聯發科,4,0,4,亞東-新竹,2023-04-10,2184
6733,博晟生醫,17,13,4,亞東-新竹,2023-04-10,2184
00713,元大台灣高息低波,5,1,4,亞東-新竹,2023-04-10,2184
1786,科妍,4,0,4,亞東-新竹,2023-04-10,2184
2457,飛宏,12,8,4,亞東-新竹,2023-04-10,2184
4763,材料-KY,4,0,4,亞東-新竹,2023-04-10,2184
5203,訊連,4,0,4,亞東-新竹,2023-04-10,2184
6101,寬魚國際,4,0,4,亞東-新竹,2023-04-10,2184
00712,復華富時不動產,3,0,3,亞東-新竹,2023-04-10,2184
3432,台端,3,0,3,亞東-新竹,2023-04-10,2184
3447,展達,3,0,3,亞東-新竹,2023-04-10,2184
2633,台灣高鐵,225,0,225,亞東-新竹,2023-04-11,2184
6770,力積電,100,1,99,亞東-新竹,2023-04-11,2184
6605,帝寶,33,0,33,亞東-新竹,2023-04-11,2184
5425,台半,30,0,30,亞東-新竹,2023-04-11,2184
6005,群益證,30,0,30,亞東-新竹,2023-04-11,2184
00632R,元大台灣50反1,24,0,24,亞東-新竹,2023-04-11,2184
1514,亞力,20,0,20,亞東-新竹,2023-04-11,2184
00720B,元大投資級公司債,20,0,20,亞東-新竹,2023-04-11,2184
3052,夆典,20,0,20,亞東-新竹,2023-04-11,2184
2834,臺企銀,30,12,18,亞東-新竹,2023-04-11,2184
2303,聯電,14,0,14,亞東-新竹,2023-04-11,2184
6185,幃翔,14,1,13,亞東-新竹,2023-04-11,2184
6733,博晟生醫,12,0,12,亞東-新竹,2023-04-11,2184
00713,元大台灣高息低波,11,0,11,亞東-新竹,2023-04-11,2184
00772B,中信高評級公司債,13,2,11,亞東-新竹,2023-04-11,2184
2331,精英,13,3,10,亞東-新竹,2023-04-11,2184
2380,虹光,10,0,10,亞東-新竹,2023-04-11,2184
2480,敦陽科,10,0,10,亞東-新竹,2023-04-11,2184
3518,柏騰,8,0,8,亞東-新竹,2023-04-11,2184
6245,立端,8,0,8,亞東-新竹,2023-04-11,2184
00679B,元大美債20年,7,0,7,亞東-新竹,2023-04-11,2184
1504,東元,8,1,7,亞東-新竹,2023-04-11,2184
2482,連宇,9,2,7,亞東-新竹,2023-04-11,2184
5315,光聯,7,0,7,亞東-新竹,2023-04-11,2184
1533,車王電,7,1,6,亞東-新竹,2023-04-11,2184
1409,新纖,6,0,6,亞東-新竹,2023-04-11,2184
00676R,富邦臺灣加權反1,5,0,5,亞東-新竹,2023-04-11,2184
1618,合機,5,0,5,亞東-新竹,2023-04-11,2184
2201,裕隆,15,10,5,亞東-新竹,2023-04-11,2184
2882,國泰金,5,0,5,亞東-新竹,2023-04-11,2184
3596,智易,5,0,5,亞東-新竹,2023-04-11,2184
4971,IET-KY,5,0,5,亞東-新竹,2023-04-11,2184
8091,翔名,5,0,5,亞東-新竹,2023-04-11,2184
3558,神準,4,0,4,亞東-新竹,2023-04-11,2184
2330,台積電,4,0,4,亞東-新竹,2023-04-11,2184
2457,飛宏,6,2,4,亞東-新竹,2023-04-11,2184
2884,玉山金,20,16,4,亞東-新竹,2023-04-11,2184
3432,台端,6,2,4,亞東-新竹,2023-04-11,2184
6147,頎邦,4,0,4,亞東-新竹,2023-04-11,2184
6148,驊宏資,8,4,4,亞東-新竹,2023-04-11,2184
6282,康舒,4,0,4,亞東-新竹,2023-04-11,2184
00852L,國泰美國道瓊正2,3,0,3,亞東-新竹,2023-04-11,2184
1712,興農,3,0,3,亞東-新竹,2023-04-11,2184
2049,上銀,3,0,3,亞東-新竹,2023-04-11,2184
3490,單井,3,0,3,亞東-新竹,2023-04-11,2184
3680,家登,3,0,3,亞東-新竹,2023-04-11,2184
4105,東洋,3,0,3,亞東-新竹,2023-04-11,2184
4927,泰鼎-KY,8,5,3,亞東-新竹,2023-04-11,2184
6133,金橋,3,0,3,亞東-新竹,2023-04-11,2184
8086,宏捷科,3,0,3,亞東-新竹,2023-04-11,2184
00772B,中信高評級公司債,100,0,100,亞東-新竹,2023-04-12,2184
00713,元大台灣高息低波,90,0,90,亞東-新竹,2023-04-12,2184
1319,東陽,85,0,85,亞東-新竹,2023-04-12,2184
00679B,元大美債20年,68,0,68,亞東-新竹,2023-04-12,2184
00687B,國泰20年美債,60,0,60,亞東-新竹,2023-04-12,2184
6133,金橋,26,0,26,亞東-新竹,2023-04-12,2184
1609,大亞,23,1,22,亞東-新竹,2023-04-12,2184
00892,富邦台灣半導體,20,0,20,亞東-新竹,2023-04-12,2184
2884,玉山金,20,0,20,亞東-新竹,2023-04-12,2184
00673R,期元大S＆P原油反1,16,0,16,亞東-新竹,2023-04-12,2184
2633,台灣高鐵,15,0,15,亞東-新竹,2023-04-12,2184
8926,台汽電,14,3,11,亞東-新竹,2023-04-12,2184
00881,國泰台灣5G+,10,0,10,亞東-新竹,2023-04-12,2184
00637L,元大滬深300正2,13,3,10,亞東-新竹,2023-04-12,2184
2371,大同,10,0,10,亞東-新竹,2023-04-12,2184
2834,臺企銀,10,0,10,亞東-新竹,2023-04-12,2184
3217,優群,10,0,10,亞東-新竹,2023-04-12,2184
6138,茂達,11,1,10,亞東-新竹,2023-04-12,2184
6770,力積電,20,10,10,亞東-新竹,2023-04-12,2184
8390,金益鼎,10,0,10,亞東-新竹,2023-04-12,2184
2618,長榮航,11,2,9,亞東-新竹,2023-04-12,2184
9958,世紀鋼,8,0,8,亞東-新竹,2023-04-12,2184
3037,欣興,9,2,7,亞東-新竹,2023-04-12,2184
2402,毅嘉,8,1,7,亞東-新竹,2023-04-12,2184
2330,台積電,10,3,7,亞東-新竹,2023-04-12,2184
6570,維田,6,0,6,亞東-新竹,2023-04-12,2184
1810,和成,5,0,5,亞東-新竹,2023-04-12,2184
2481,強茂,5,0,5,亞東-新竹,2023-04-12,2184
5315,光聯,5,0,5,亞東-新竹,2023-04-12,2184
5434,崇越,5,0,5,亞東-新竹,2023-04-12,2184
6244,茂迪,5,0,5,亞東-新竹,2023-04-12,2184
006208,富邦台50,4,0,4,亞東-新竹,2023-04-12,2184
2392,正崴,4,0,4,亞東-新竹,2023-04-12,2184
2889,國票金,5,1,4,亞東-新竹,2023-04-12,2184
5706,鳳凰,4,0,4,亞東-新竹,2023-04-12,2184
6129,普誠,6,2,4,亞東-新竹,2023-04-12,2184
6185,幃翔,4,0,4,亞東-新竹,2023-04-12,2184
6288,聯嘉,4,0,4,亞東-新竹,2023-04-12,2184
1514,亞力,24,20,4,亞東-新竹,2023-04-12,2184
1618,合機,3,0,3,亞東-新竹,2023-04-12,2184
2308,台達電,3,0,3,亞東-新竹,2023-04-12,2184
3209,全科,3,0,3,亞東-新竹,2023-04-12,2184
3432,台端,4,1,3,亞東-新竹,2023-04-12,2184
3491,昇達科,3,0,3,亞東-新竹,2023-04-12,2184
3592,瑞鼎,3,0,3,亞東-新竹,2023-04-12,2184
4123,晟德,3,0,3,亞東-新竹,2023-04-12,2184
3035,智原,15,13,2,亞東-新竹,2023-04-12,2184
2890,永豐金,2,0,2,亞東-新竹,2023-04-12,2184
00773B,中信優先金融債,2,0,2,亞東-新竹,2023-04-12,2184
1734,杏輝,2,0,2,亞東-新竹,2023-04-12,2184
00772B,中信高評級公司債,107,0,107,亞東-新竹,2023-04-13,2184
2897,王道銀行,150,50,100,亞東-新竹,2023-04-13,2184
4114,健喬,63,0,63,亞東-新竹,2023-04-13,2184
00751B,元大AAA至A公司債,51,0,51,亞東-新竹,2023-04-13,2184
00892,富邦台灣半導體,40,0,40,亞東-新竹,2023-04-13,2184
00713,元大台灣高息低波,35,2,33,亞東-新竹,2023-04-13,2184
2701,萬企,30,0,30,亞東-新竹,2023-04-13,2184
2610,華航,80,51,29,亞東-新竹,2023-04-13,2184
6770,力積電,30,1,29,亞東-新竹,2023-04-13,2184
00673R,期元大S＆P原油反1,25,0,25,亞東-新竹,2023-04-13,2184
2317,鴻海,22,0,22,亞東-新竹,2023-04-13,2184
2330,台積電,21,0,21,亞東-新竹,2023-04-13,2184
2515,中工,26,6,20,亞東-新竹,2023-04-13,2184
3711,日月光投控,19,0,19,亞東-新竹,2023-04-13,2184
00912,中信臺灣智慧50,15,0,15,亞東-新竹,2023-04-13,2184
00680L,元大美債20正2,15,0,15,亞東-新竹,2023-04-13,2184
6005,群益證,15,0,15,亞東-新竹,2023-04-13,2184
6217,中探針,15,0,15,亞東-新竹,2023-04-13,2184
00679B,元大美債20年,21,7,14,亞東-新竹,2023-04-13,2184
2303,聯電,17,3,14,亞東-新竹,2023-04-13,2184
3576,聯合再生,15,2,13,亞東-新竹,2023-04-13,2184
5351,鈺創,13,0,13,亞東-新竹,2023-04-13,2184
2323,中環,12,0,12,亞東-新竹,2023-04-13,2184
3209,全科,12,0,12,亞東-新竹,2023-04-13,2184
2402,毅嘉,12,1,11,亞東-新竹,2023-04-13,2184
2453,凌群,11,0,11,亞東-新竹,2023-04-13,2184
6138,茂達,12,1,11,亞東-新竹,2023-04-13,2184
4743,合一,10,0,10,亞東-新竹,2023-04-13,2184
5203,訊連,9,0,9,亞東-新竹,2023-04-13,2184
6753,龍德造船,10,1,9,亞東-新竹,2023-04-13,2184
6829,千附精密,9,0,9,亞東-新竹,2023-04-13,2184
00830,國泰費城半導體,8,0,8,亞東-新竹,2023-04-13,2184
1605,華新,10,2,8,亞東-新竹,2023-04-13,2184
2809,京城銀,7,0,7,亞東-新竹,2023-04-13,2184
3078,僑威,8,1,7,亞東-新竹,2023-04-13,2184
3231,緯創,6,0,6,亞東-新竹,2023-04-13,2184
2481,強茂,6,0,6,亞東-新竹,2023-04-13,2184
3596,智易,6,0,6,亞東-新竹,2023-04-13,2184
6235,華孚,14,8,6,亞東-新竹,2023-04-13,2184
6443,元晶,6,0,6,亞東-新竹,2023-04-13,2184
3006,晶豪科,7,2,5,亞東-新竹,2023-04-13,2184
5465,富驊,5,0,5,亞東-新竹,2023-04-13,2184
00903,富邦元宇宙,5,0,5,亞東-新竹,2023-04-13,2184
2201,裕隆,27,22,5,亞東-新竹,2023-04-13,2184
2882,國泰金,5,0,5,亞東-新竹,2023-04-13,2184
5876,上海商銀,5,0,5,亞東-新竹,2023-04-13,2184
6274,台燿,5,0,5,亞東-新竹,2023-04-13,2184
2492,華新科,10,6,4,亞東-新竹,2023-04-13,2184
2887,台新金,4,0,4,亞東-新竹,2023-04-13,2184
3032,偉訓,4,0,4,亞東-新竹,2023-04-13,2184
00632R,元大台灣50反1,150,5,145,亞東-新竹,2023-04-14,2184
4114,健喬,110,3,107,亞東-新竹,2023-04-14,2184
00772B,中信高評級公司債,106,0,106,亞東-新竹,2023-04-14,2184
8105,凌巨,100,0,100,亞東-新竹,2023-04-14,2184
00751B,元大AAA至A公司債,51,0,51,亞東-新竹,2023-04-14,2184
6120,達運,50,0,50,亞東-新竹,2023-04-14,2184
2634,漢翔,40,13,27,亞東-新竹,2023-04-14,2184
2380,虹光,25,0,25,亞東-新竹,2023-04-14,2184
2303,聯電,18,0,18,亞東-新竹,2023-04-14,2184
00679B,元大美債20年,18,0,18,亞東-新竹,2023-04-14,2184
00912,中信臺灣智慧50,15,0,15,亞東-新竹,2023-04-14,2184
6288,聯嘉,15,0,15,亞東-新竹,2023-04-14,2184
1718,中纖,14,0,14,亞東-新竹,2023-04-14,2184
1437,勤益控,13,0,13,亞東-新竹,2023-04-14,2184
4536,拓凱,12,0,12,亞東-新竹,2023-04-14,2184
00713,元大台灣高息低波,11,0,11,亞東-新竹,2023-04-14,2184
4958,臻鼎-KY,11,0,11,亞東-新竹,2023-04-14,2184
5469,瀚宇博,11,0,11,亞東-新竹,2023-04-14,2184
00877,復華中國5G,10,0,10,亞東-新竹,2023-04-14,2184
00665L,富邦�琤肭磪囓�2,20,10,10,亞東-新竹,2023-04-14,2184
00664R,國泰臺灣加權反1,10,0,10,亞東-新竹,2023-04-14,2184
1515,力山,10,0,10,亞東-新竹,2023-04-14,2184
1525,江申,10,0,10,亞東-新竹,2023-04-14,2184
1709,和益,10,0,10,亞東-新竹,2023-04-14,2184
2314,台揚,10,0,10,亞東-新竹,2023-04-14,2184
2845,遠東銀,10,0,10,亞東-新竹,2023-04-14,2184
2887E,台新戊特,10,0,10,亞東-新竹,2023-04-14,2184
3564,其陽,10,0,10,亞東-新竹,2023-04-14,2184
4953,緯軟,10,0,10,亞東-新竹,2023-04-14,2184
5284,jpp-KY,10,0,10,亞東-新竹,2023-04-14,2184
6196,帆宣,10,0,10,亞東-新竹,2023-04-14,2184
6269,台郡,10,0,10,亞東-新竹,2023-04-14,2184
1416,廣豐,9,0,9,亞東-新竹,2023-04-14,2184
1605,華新,17,8,9,亞東-新竹,2023-04-14,2184
4931,新盛力,9,0,9,亞東-新竹,2023-04-14,2184
1409,新纖,8,0,8,亞東-新竹,2023-04-14,2184
4207,環泰,8,0,8,亞東-新竹,2023-04-14,2184
8121,越峰,10,2,8,亞東-新竹,2023-04-14,2184
1539,巨庭,7,0,7,亞東-新竹,2023-04-14,2184
1809,中釉,7,0,7,亞東-新竹,2023-04-14,2184
3356,奇偶,7,0,7,亞東-新竹,2023-04-14,2184
3037,欣興,6,0,6,亞東-新竹,2023-04-14,2184
1324,地球,6,0,6,亞東-新竹,2023-04-14,2184
00680L,元大美債20正2,6,0,6,亞東-新竹,2023-04-14,2184
1529,樂事綠能,10,4,6,亞東-新竹,2023-04-14,2184
1734,杏輝,6,0,6,亞東-新竹,2023-04-14,2184
8016,矽創,6,0,6,亞東-新竹,2023-04-14,2184
1789,神隆,5,0,5,亞東-新竹,2023-04-14,2184
2013,中鋼構,5,0,5,亞東-新竹,2023-04-14,2184
2104,國際中橡,5,0,5,亞東-新竹,2023-04-14,2184
2897,王道銀行,565,220,345,亞東-新竹,2023-04-17,2184
1319,東陽,80,0,80,亞東-新竹,2023-04-17,2184
00712,復華富時不動產,34,0,34,亞東-新竹,2023-04-17,2184
5258,虹堡,33,0,33,亞東-新竹,2023-04-17,2184
4953,緯軟,31,1,30,亞東-新竹,2023-04-17,2184
6179,亞通,30,0,30,亞東-新竹,2023-04-17,2184
1513,中興電,36,7,29,亞東-新竹,2023-04-17,2184
2867,三商壽,28,0,28,亞東-新竹,2023-04-17,2184
6112,邁達特,30,2,28,亞東-新竹,2023-04-17,2184
2402,毅嘉,27,4,23,亞東-新竹,2023-04-17,2184
2331,精英,20,0,20,亞東-新竹,2023-04-17,2184
00751B,元大AAA至A公司債,18,0,18,亞東-新竹,2023-04-17,2184
00720B,元大投資級公司債,18,0,18,亞東-新竹,2023-04-17,2184
6163,華電網,30,13,17,亞東-新竹,2023-04-17,2184
6133,金橋,15,0,15,亞東-新竹,2023-04-17,2184
4105,東洋,14,0,14,亞東-新竹,2023-04-17,2184
4114,健喬,16,2,14,亞東-新竹,2023-04-17,2184
00878,國泰永續高股息,23,10,13,亞東-新竹,2023-04-17,2184
00680L,元大美債20正2,10,0,10,亞東-新竹,2023-04-17,2184
1605,華新,16,6,10,亞東-新竹,2023-04-17,2184
2337,旺宏,10,0,10,亞東-新竹,2023-04-17,2184
2493,揚博,10,0,10,亞東-新竹,2023-04-17,2184
2845,遠東銀,10,0,10,亞東-新竹,2023-04-17,2184
2887E,台新戊特,10,0,10,亞東-新竹,2023-04-17,2184
5876,上海商銀,20,10,10,亞東-新竹,2023-04-17,2184
6799,來頡,10,0,10,亞東-新竹,2023-04-17,2184
8421,旭源,10,0,10,亞東-新竹,2023-04-17,2184
9958,世紀鋼,12,2,10,亞東-新竹,2023-04-17,2184
00679B,元大美債20年,9,0,9,亞東-新竹,2023-04-17,2184
2618,長榮航,11,2,9,亞東-新竹,2023-04-17,2184
2421,建準,8,0,8,亞東-新竹,2023-04-17,2184
3338,泰碩,8,0,8,亞東-新竹,2023-04-17,2184
4116,明基醫,8,0,8,亞東-新竹,2023-04-17,2184
9802,鈺齊-KY,8,0,8,亞東-新竹,2023-04-17,2184
2630,亞航,7,0,7,亞東-新竹,2023-04-17,2184
3712,永崴投控,7,0,7,亞東-新竹,2023-04-17,2184
2380,虹光,6,0,6,亞東-新竹,2023-04-17,2184
3447,展達,6,0,6,亞東-新竹,2023-04-17,2184
1452,宏益,5,0,5,亞東-新竹,2023-04-17,2184
00631L,元大台灣50正2,9,4,5,亞東-新竹,2023-04-17,2184
8927,北基,5,0,5,亞東-新竹,2023-04-17,2184
2454,聯發科,7,2,5,亞東-新竹,2023-04-17,2184
2233,宇隆,4,0,4,亞東-新竹,2023-04-17,2184
6167,久正,5,1,4,亞東-新竹,2023-04-17,2184
00795B,中信美國公債20年,4,0,4,亞東-新竹,2023-04-17,2184
00772B,中信高評級公司債,4,0,4,亞東-新竹,2023-04-17,2184
0056,元大高股息,4,0,4,亞東-新竹,2023-04-17,2184
2002,中鋼,4,0,4,亞東-新竹,2023-04-17,2184
2208,台船,10,6,4,亞東-新竹,2023-04-17,2184
5351,鈺創,3,0,3,亞東-新竹,2023-04-17,2184
2897,王道銀行,1067,0,1067,亞東-新竹,2023-04-18,2184
00664R,國泰臺灣加權反1,400,0,400,亞東-新竹,2023-04-18,2184
00772B,中信高評級公司債,112,0,112,亞東-新竹,2023-04-18,2184
2888,新光金,99,0,99,亞東-新竹,2023-04-18,2184
00751B,元大AAA至A公司債,58,0,58,亞東-新竹,2023-04-18,2184
2634,漢翔,100,48,52,亞東-新竹,2023-04-18,2184
2402,毅嘉,38,0,38,亞東-新竹,2023-04-18,2184
6288,聯嘉,37,0,37,亞東-新竹,2023-04-18,2184
9958,世紀鋼,35,0,35,亞東-新竹,2023-04-18,2184
2380,虹光,34,0,34,亞東-新竹,2023-04-18,2184
4953,緯軟,31,0,31,亞東-新竹,2023-04-18,2184
2610,華航,50,20,30,亞東-新竹,2023-04-18,2184
00679B,元大美債20年,25,0,25,亞東-新竹,2023-04-18,2184
1513,中興電,35,12,23,亞東-新竹,2023-04-18,2184
00720B,元大投資級公司債,21,0,21,亞東-新竹,2023-04-18,2184
00665L,富邦�琤肭磪囓�2,20,0,20,亞東-新竹,2023-04-18,2184
00712,復華富時不動產,17,0,17,亞東-新竹,2023-04-18,2184
0056,元大高股息,18,1,17,亞東-新竹,2023-04-18,2184
8033,雷虎,22,6,16,亞東-新竹,2023-04-18,2184
00673R,期元大S＆P原油反1,15,0,15,亞東-新竹,2023-04-18,2184
1101,台泥,15,0,15,亞東-新竹,2023-04-18,2184
2331,精英,15,0,15,亞東-新竹,2023-04-18,2184
3046,建��,16,3,13,亞東-新竹,2023-04-18,2184
9802,鈺齊-KY,12,0,12,亞東-新竹,2023-04-18,2184
1312,國喬,11,0,11,亞東-新竹,2023-04-18,2184
6770,力積電,11,0,11,亞東-新竹,2023-04-18,2184
00713,元大台灣高息低波,10,0,10,亞東-新竹,2023-04-18,2184
00882,中信中國高股息,10,0,10,亞東-新竹,2023-04-18,2184
00680L,元大美債20正2,10,0,10,亞東-新竹,2023-04-18,2184
1402,遠東新,10,0,10,亞東-新竹,2023-04-18,2184
2363,矽統,10,0,10,亞東-新竹,2023-04-18,2184
2867,三商壽,10,0,10,亞東-新竹,2023-04-18,2184
5465,富驊,10,0,10,亞東-新竹,2023-04-18,2184
6122,擎邦,10,0,10,亞東-新竹,2023-04-18,2184
2454,聯發科,12,3,9,亞東-新竹,2023-04-18,2184
1605,華新,9,0,9,亞東-新竹,2023-04-18,2184
1752,南光,10,1,9,亞東-新竹,2023-04-18,2184
2482,連宇,9,0,9,亞東-新竹,2023-04-18,2184
6829,千附精密,9,0,9,亞東-新竹,2023-04-18,2184
2365,昆盈,8,0,8,亞東-新竹,2023-04-18,2184
3374,精材,10,2,8,亞東-新竹,2023-04-18,2184
2317,鴻海,8,0,8,亞東-新竹,2023-04-18,2184
2605,新興,20,13,7,亞東-新竹,2023-04-18,2184
1444,力麗,8,2,6,亞東-新竹,2023-04-18,2184
00632R,元大台灣50反1,6,0,6,亞東-新竹,2023-04-18,2184
4105,東洋,6,0,6,亞東-新竹,2023-04-18,2184
5227,立凱-KY,6,0,6,亞東-新竹,2023-04-18,2184
1522,堤維西,5,0,5,亞東-新竹,2023-04-18,2184
2457,飛宏,18,13,5,亞東-新竹,2023-04-18,2184
2849,安泰銀,5,0,5,亞東-新竹,2023-04-18,2184
2888,新光金,104,0,104,亞東-新竹,2023-04-19,2184
00751B,元大AAA至A公司債,58,0,58,亞東-新竹,2023-04-19,2184
00772B,中信高評級公司債,54,0,54,亞東-新竹,2023-04-19,2184
3046,建��,57,10,47,亞東-新竹,2023-04-19,2184
2002,中鋼,41,0,41,亞東-新竹,2023-04-19,2184
00720B,元大投資級公司債,38,0,38,亞東-新竹,2023-04-19,2184
2603,長榮,42,10,32,亞東-新竹,2023-04-19,2184
2303,聯電,29,8,21,亞東-新竹,2023-04-19,2184
6770,力積電,21,0,21,亞東-新竹,2023-04-19,2184
00892,富邦台灣半導體,20,0,20,亞東-新竹,2023-04-19,2184
2337,旺宏,17,0,17,亞東-新竹,2023-04-19,2184
2498,宏達電,16,0,16,亞東-新竹,2023-04-19,2184
2356,英業達,15,0,15,亞東-新竹,2023-04-19,2184
2610,華航,20,5,15,亞東-新竹,2023-04-19,2184
2409,友達,14,0,14,亞東-新竹,2023-04-19,2184
1525,江申,12,0,12,亞東-新竹,2023-04-19,2184
2342,茂矽,12,0,12,亞東-新竹,2023-04-19,2184
2515,中工,12,0,12,亞東-新竹,2023-04-19,2184
3545,敦泰,12,0,12,亞東-新竹,2023-04-19,2184
3576,聯合再生,36,24,12,亞東-新竹,2023-04-19,2184
5371,中光電,11,0,11,亞東-新竹,2023-04-19,2184
1312,國喬,10,0,10,亞東-新竹,2023-04-19,2184
00922,國泰台灣領袖50,10,0,10,亞東-新竹,2023-04-19,2184
00885,富邦越南,10,0,10,亞東-新竹,2023-04-19,2184
2382,廣達,10,0,10,亞東-新竹,2023-04-19,2184
2884,玉山金,10,0,10,亞東-新竹,2023-04-19,2184
2886,兆豐金,10,0,10,亞東-新竹,2023-04-19,2184
3711,日月光投控,10,0,10,亞東-新竹,2023-04-19,2184
4119,旭富,10,0,10,亞東-新竹,2023-04-19,2184
4958,臻鼎-KY,10,0,10,亞東-新竹,2023-04-19,2184
4979,華星光,16,7,9,亞東-新竹,2023-04-19,2184
3035,智原,8,0,8,亞東-新竹,2023-04-19,2184
6523,達爾膚,17,9,8,亞東-新竹,2023-04-19,2184
00679B,元大美債20年,8,0,8,亞東-新竹,2023-04-19,2184
1734,杏輝,8,0,8,亞東-新竹,2023-04-19,2184
8222,寶一,8,0,8,亞東-新竹,2023-04-19,2184
2454,聯發科,9,1,8,亞東-新竹,2023-04-19,2184
1504,東元,9,2,7,亞東-新竹,2023-04-19,2184
2201,裕隆,22,15,7,亞東-新竹,2023-04-19,2184
2330,台積電,8,1,7,亞東-新竹,2023-04-19,2184
6133,金橋,6,0,6,亞東-新竹,2023-04-19,2184
6202,盛群,6,0,6,亞東-新竹,2023-04-19,2184
0050,元大台灣50,5,0,5,亞東-新竹,2023-04-19,2184
6446,藥華藥,5,0,5,亞東-新竹,2023-04-19,2184
2380,虹光,5,0,5,亞東-新竹,2023-04-19,2184
3094,聯傑,5,0,5,亞東-新竹,2023-04-19,2184
5243,乙盛-KY,7,2,5,亞東-新竹,2023-04-19,2184
6472,保瑞,5,0,5,亞東-新竹,2023-04-19,2184
6548,長科*,4,0,4,亞東-新竹,2023-04-19,2184
1560,中砂,4,0,4,亞東-新竹,2023-04-19,2184
2897,王道銀行,300,200,100,亞東-新竹,2023-04-20,2184
00772B,中信高評級公司債,52,0,52,亞東-新竹,2023-04-20,2184
9904,寶成,45,0,45,亞東-新竹,2023-04-20,2184
6129,普誠,38,0,38,亞東-新竹,2023-04-20,2184
2303,聯電,35,4,31,亞東-新竹,2023-04-20,2184
6120,達運,30,0,30,亞東-新竹,2023-04-20,2184
00633L,富邦上証正2,35,7,28,亞東-新竹,2023-04-20,2184
3466,德晉,20,0,20,亞東-新竹,2023-04-20,2184
3576,聯合再生,20,0,20,亞東-新竹,2023-04-20,2184
4157,太景*-KY,14,0,14,亞東-新竹,2023-04-20,2184
1539,巨庭,14,1,13,亞東-新竹,2023-04-20,2184
00673R,期元大S＆P原油反1,25,12,13,亞東-新竹,2023-04-20,2184
1402,遠東新,12,0,12,亞東-新竹,2023-04-20,2184
00888,永豐台灣ESG,12,0,12,亞東-新竹,2023-04-20,2184
2634,漢翔,23,11,12,亞東-新竹,2023-04-20,2184
2382,廣達,10,0,10,亞東-新竹,2023-04-20,2184
2380,虹光,10,0,10,亞東-新竹,2023-04-20,2184
2633,台灣高鐵,10,0,10,亞東-新竹,2023-04-20,2184
2885,元大金,10,0,10,亞東-新竹,2023-04-20,2184
2887,台新金,10,0,10,亞東-新竹,2023-04-20,2184
3686,達能,10,0,10,亞東-新竹,2023-04-20,2184
3149,正達,10,1,9,亞東-新竹,2023-04-20,2184
2201,裕隆,27,19,8,亞東-新竹,2023-04-20,2184
2409,友達,8,0,8,亞東-新竹,2023-04-20,2184
2886,兆豐金,8,0,8,亞東-新竹,2023-04-20,2184
4123,晟德,14,6,8,亞東-新竹,2023-04-20,2184
6122,擎邦,8,0,8,亞東-新竹,2023-04-20,2184
2313,華通,7,0,7,亞東-新竹,2023-04-20,2184
00878,國泰永續高股息,17,10,7,亞東-新竹,2023-04-20,2184
00882,中信中國高股息,7,0,7,亞東-新竹,2023-04-20,2184
6244,茂迪,23,16,7,亞東-新竹,2023-04-20,2184
3162,精確,6,0,6,亞東-新竹,2023-04-20,2184
1720,生達,6,0,6,亞東-新竹,2023-04-20,2184
4114,健喬,25,19,6,亞東-新竹,2023-04-20,2184
6133,金橋,6,0,6,亞東-新竹,2023-04-20,2184
8105,凌巨,6,0,6,亞東-新竹,2023-04-20,2184
1312,國喬,5,0,5,亞東-新竹,2023-04-20,2184
00680L,元大美債20正2,5,0,5,亞東-新竹,2023-04-20,2184
2331,精英,5,0,5,亞東-新竹,2023-04-20,2184
2542,興富發,5,0,5,亞東-新竹,2023-04-20,2184
2645,長榮航太,5,0,5,亞東-新竹,2023-04-20,2184
2888,新光金,5,0,5,亞東-新竹,2023-04-20,2184
3289,宜特,5,0,5,亞東-新竹,2023-04-20,2184
6443,元晶,10,5,5,亞東-新竹,2023-04-20,2184
2453,凌群,7,3,4,亞東-新竹,2023-04-20,2184
1907,永豐餘,24,20,4,亞東-新竹,2023-04-20,2184
2402,毅嘉,4,0,4,亞東-新竹,2023-04-20,2184
2457,飛宏,27,23,4,亞東-新竹,2023-04-20,2184
2471,資通,4,0,4,亞東-新竹,2023-04-20,2184
3016,嘉晶,4,0,4,亞東-新竹,2023-04-20,2184
1101,台泥,159,14,145,亞東-新竹,2023-04-21,2184
2897,王道銀行,100,0,100,亞東-新竹,2023-04-21,2184
00632R,元大台灣50反1,110,23,87,亞東-新竹,2023-04-21,2184
1906,寶隆,86,5,81,亞東-新竹,2023-04-21,2184
00679B,元大美債20年,102,28,74,亞東-新竹,2023-04-21,2184
00772B,中信高評級公司債,74,0,74,亞東-新竹,2023-04-21,2184
2610,華航,70,1,69,亞東-新竹,2023-04-21,2184
00857B,永豐20年美公債,60,0,60,亞東-新竹,2023-04-21,2184
00751B,元大AAA至A公司債,56,0,56,亞東-新竹,2023-04-21,2184
6120,達運,30,0,30,亞東-新竹,2023-04-21,2184
00893,國泰智能電動車,26,0,26,亞東-新竹,2023-04-21,2184
2891,中信金,25,0,25,亞東-新竹,2023-04-21,2184
6129,普誠,24,5,19,亞東-新竹,2023-04-21,2184
2884,玉山金,20,2,18,亞東-新竹,2023-04-21,2184
5706,鳳凰,12,0,12,亞東-新竹,2023-04-21,2184
2303,聯電,30,19,11,亞東-新竹,2023-04-21,2184
6285,啟��,11,0,11,亞東-新竹,2023-04-21,2184
00795B,中信美國公債20年,10,0,10,亞東-新竹,2023-04-21,2184
2313,華通,10,0,10,亞東-新竹,2023-04-21,2184
2501,國建,10,0,10,亞東-新竹,2023-04-21,2184
2867,三商壽,10,0,10,亞東-新竹,2023-04-21,2184
4114,健喬,10,0,10,亞東-新竹,2023-04-21,2184
4157,太景*-KY,15,5,10,亞東-新竹,2023-04-21,2184
5263,智崴,10,0,10,亞東-新竹,2023-04-21,2184
0056,元大高股息,10,0,10,亞東-新竹,2023-04-21,2184
2482,連宇,9,0,9,亞東-新竹,2023-04-21,2184
2820,華票,9,0,9,亞東-新竹,2023-04-21,2184
2889,國票金,9,0,9,亞東-新竹,2023-04-21,2184
3287,廣寰科,12,3,9,亞東-新竹,2023-04-21,2184
00715L,期街口布蘭特正2,8,0,8,亞東-新竹,2023-04-21,2184
2882,國泰金,8,0,8,亞東-新竹,2023-04-21,2184
3303,岱稜,8,0,8,亞東-新竹,2023-04-21,2184
3596,智易,8,0,8,亞東-新竹,2023-04-21,2184
4961,天鈺,8,0,8,亞東-新竹,2023-04-21,2184
5258,虹堡,7,0,7,亞東-新竹,2023-04-21,2184
3289,宜特,7,0,7,亞東-新竹,2023-04-21,2184
1219,福壽,7,0,7,亞東-新竹,2023-04-21,2184
2888,新光金,7,0,7,亞東-新竹,2023-04-21,2184
3027,盛達,6,0,6,亞東-新竹,2023-04-21,2184
3149,正達,6,0,6,亞東-新竹,2023-04-21,2184
4967,十銓,7,1,6,亞東-新竹,2023-04-21,2184
1605,華新,7,2,5,亞東-新竹,2023-04-21,2184
2344,華邦電,5,0,5,亞東-新竹,2023-04-21,2184
2634,漢翔,22,17,5,亞東-新竹,2023-04-21,2184
2855,統一證,5,0,5,亞東-新竹,2023-04-21,2184
5469,瀚宇博,5,0,5,亞東-新竹,2023-04-21,2184
1784,訊聯,4,0,4,亞東-新竹,2023-04-21,2184
1815,富喬,4,0,4,亞東-新竹,2023-04-21,2184
1907,永豐餘,33,29,4,亞東-新竹,2023-04-21,2184
2027,大成鋼,4,0,4,亞東-新竹,2023-04-21,2184
2705,六福,101,1,100,亞東-新竹,2023-04-24,2184
1711,永光,93,0,93,亞東-新竹,2023-04-24,2184
2010,春源,70,0,70,亞東-新竹,2023-04-24,2184
00772B,中信高評級公司債,56,0,56,亞東-新竹,2023-04-24,2184
6167,久正,50,0,50,亞東-新竹,2023-04-24,2184
2603,長榮,34,3,31,亞東-新竹,2023-04-24,2184
00893,國泰智能電動車,23,0,23,亞東-新竹,2023-04-24,2184
2884,玉山金,20,1,19,亞東-新竹,2023-04-24,2184
0050,元大台灣50,16,0,16,亞東-新竹,2023-04-24,2184
00878,國泰永續高股息,15,0,15,亞東-新竹,2023-04-24,2184
2453,凌群,16,3,13,亞東-新竹,2023-04-24,2184
2618,長榮航,14,3,11,亞東-新竹,2023-04-24,2184
2845,遠東銀,10,0,10,亞東-新竹,2023-04-24,2184
2867,三商壽,10,0,10,亞東-新竹,2023-04-24,2184
2313,華通,9,0,9,亞東-新竹,2023-04-24,2184
00751B,元大AAA至A公司債,9,0,9,亞東-新竹,2023-04-24,2184
00882,中信中國高股息,9,0,9,亞東-新竹,2023-04-24,2184
1409,新纖,8,0,8,亞東-新竹,2023-04-24,2184
00685L,群益臺灣加權正2,7,0,7,亞東-新竹,2023-04-24,2184
2515,中工,7,0,7,亞東-新竹,2023-04-24,2184
2402,毅嘉,6,0,6,亞東-新竹,2023-04-24,2184
6202,盛群,6,0,6,亞東-新竹,2023-04-24,2184
2634,漢翔,41,36,5,亞東-新竹,2023-04-24,2184
1785,光洋科,5,0,5,亞東-新竹,2023-04-24,2184
00720B,元大投資級公司債,5,0,5,亞東-新竹,2023-04-24,2184
2344,華邦電,8,3,5,亞東-新竹,2023-04-24,2184
2380,虹光,5,0,5,亞東-新竹,2023-04-24,2184
1303,南亞,5,0,5,亞東-新竹,2023-04-24,2184
3592,瑞鼎,4,0,4,亞東-新竹,2023-04-24,2184
1440,南紡,4,0,4,亞東-新竹,2023-04-24,2184
2809,京城銀,4,0,4,亞東-新竹,2023-04-24,2184
3303,岱稜,4,0,4,亞東-新竹,2023-04-24,2184
3512,皇龍,4,0,4,亞東-新竹,2023-04-24,2184
5706,鳳凰,4,0,4,亞東-新竹,2023-04-24,2184
00679B,元大美債20年,3,0,3,亞東-新竹,2023-04-24,2184
1712,興農,3,0,3,亞東-新竹,2023-04-24,2184
1560,中砂,3,0,3,亞東-新竹,2023-04-24,2184
2388,威盛,7,4,3,亞東-新竹,2023-04-24,2184
2889,國票金,3,0,3,亞東-新竹,2023-04-24,2184
3596,智易,3,0,3,亞東-新竹,2023-04-24,2184
6285,啟��,3,0,3,亞東-新竹,2023-04-24,2184
2330,台積電,3,0,3,亞東-新竹,2023-04-24,2184
5351,鈺創,2,0,2,亞東-新竹,2023-04-24,2184
5243,乙盛-KY,2,0,2,亞東-新竹,2023-04-24,2184
3661,世芯-KY,2,0,2,亞東-新竹,2023-04-24,2184
1519,華城,5,3,2,亞東-新竹,2023-04-24,2184
1709,和益,2,0,2,亞東-新竹,2023-04-24,2184
00637L,元大滬深300正2,12,10,2,亞東-新竹,2023-04-24,2184
0056,元大高股息,3,1,2,亞東-新竹,2023-04-24,2184
00631L,元大台灣50正2,7,5,2,亞東-新竹,2023-04-24,2184
00680L,元大美債20正2,160,0,160,亞東-新竹,2023-04-25,2184
00679B,元大美債20年,77,2,75,亞東-新竹,2023-04-25,2184
00713,元大台灣高息低波,48,0,48,亞東-新竹,2023-04-25,2184
1314,中石化,48,0,48,亞東-新竹,2023-04-25,2184
2610,華航,41,0,41,亞東-新竹,2023-04-25,2184
0050,元大台灣50,39,0,39,亞東-新竹,2023-04-25,2184
0056,元大高股息,38,0,38,亞東-新竹,2023-04-25,2184
1528,恩德,35,0,35,亞東-新竹,2023-04-25,2184
6770,力積電,32,1,31,亞東-新竹,2023-04-25,2184
2303,聯電,31,0,31,亞東-新竹,2023-04-25,2184
2482,連宇,30,0,30,亞東-新竹,2023-04-25,2184
3548,兆利,30,0,30,亞東-新竹,2023-04-25,2184
3535,晶彩科,26,0,26,亞東-新竹,2023-04-25,2184
1721,三晃,30,5,25,亞東-新竹,2023-04-25,2184
6269,台郡,25,0,25,亞東-新竹,2023-04-25,2184
2317,鴻海,26,2,24,亞東-新竹,2023-04-25,2184
6129,普誠,20,0,20,亞東-新竹,2023-04-25,2184
00892,富邦台灣半導體,20,0,20,亞東-新竹,2023-04-25,2184
2883,凱基金,20,0,20,亞東-新竹,2023-04-25,2184
2423,固緯,20,1,19,亞東-新竹,2023-04-25,2184
2458,義隆,18,0,18,亞東-新竹,2023-04-25,2184
2328,廣宇,18,0,18,亞東-新竹,2023-04-25,2184
1785,光洋科,15,0,15,亞東-新竹,2023-04-25,2184
8926,台汽電,23,8,15,亞東-新竹,2023-04-25,2184
2634,漢翔,34,20,14,亞東-新竹,2023-04-25,2184
1101,台泥,14,1,13,亞東-新竹,2023-04-25,2184
4111,濟生,25,13,12,亞東-新竹,2023-04-25,2184
2330,台積電,13,2,11,亞東-新竹,2023-04-25,2184
5469,瀚宇博,11,0,11,亞東-新竹,2023-04-25,2184
00893,國泰智能電動車,10,0,10,亞東-新竹,2023-04-25,2184
2002,中鋼,11,1,10,亞東-新竹,2023-04-25,2184
2338,光罩,10,0,10,亞東-新竹,2023-04-25,2184
2359,所羅門,10,0,10,亞東-新竹,2023-04-25,2184
2498,宏達電,20,10,10,亞東-新竹,2023-04-25,2184
2889,國票金,10,0,10,亞東-新竹,2023-04-25,2184
3046,建��,14,4,10,亞東-新竹,2023-04-25,2184
4157,太景*-KY,10,0,10,亞東-新竹,2023-04-25,2184
4739,康普,10,0,10,亞東-新竹,2023-04-25,2184
9802,鈺齊-KY,11,1,10,亞東-新竹,2023-04-25,2184
00772B,中信高評級公司債,24,15,9,亞東-新竹,2023-04-25,2184
4931,新盛力,9,0,9,亞東-新竹,2023-04-25,2184
5263,智崴,9,0,9,亞東-新竹,2023-04-25,2184
8215,明基材,9,0,9,亞東-新竹,2023-04-25,2184
2027,大成鋼,8,0,8,亞東-新竹,2023-04-25,2184
8426,紅木-KY,8,0,8,亞東-新竹,2023-04-25,2184
00830,國泰費城半導體,7,0,7,亞東-新竹,2023-04-25,2184
00631L,元大台灣50正2,13,6,7,亞東-新竹,2023-04-25,2184
1905,華紙,13,6,7,亞東-新竹,2023-04-25,2184
2886,兆豐金,7,0,7,亞東-新竹,2023-04-25,2184
3231,緯創,13,6,7,亞東-新竹,2023-04-25,2184
2867,三商壽,100,0,100,亞東-新竹,2023-04-26,2184
2897,王道銀行,200,150,50,亞東-新竹,2023-04-26,2184
6770,力積電,45,0,45,亞東-新竹,2023-04-26,2184
2610,華航,42,1,41,亞東-新竹,2023-04-26,2184
00671R,富邦NASDAQ反1,38,0,38,亞東-新竹,2023-04-26,2184
2913,農林,28,0,28,亞東-新竹,2023-04-26,2184
9925,新保,28,0,28,亞東-新竹,2023-04-26,2184
5263,智崴,22,0,22,亞東-新竹,2023-04-26,2184
2881,富邦金,21,0,21,亞東-新竹,2023-04-26,2184
2884,玉山金,20,0,20,亞東-新竹,2023-04-26,2184
00751B,元大AAA至A公司債,26,7,19,亞東-新竹,2023-04-26,2184
1711,永光,17,1,16,亞東-新竹,2023-04-26,2184
1609,大亞,15,0,15,亞東-新竹,2023-04-26,2184
3711,日月光投控,16,2,14,亞東-新竹,2023-04-26,2184
2338,光罩,15,2,13,亞東-新竹,2023-04-26,2184
3363,上詮,15,2,13,亞東-新竹,2023-04-26,2184
00683L,期元大美元指正2,12,1,11,亞東-新竹,2023-04-26,2184
00665L,富邦�琤肭磪囓�2,10,0,10,亞東-新竹,2023-04-26,2184
6016,康和證,10,0,10,亞東-新竹,2023-04-26,2184
00773B,中信優先金融債,10,1,9,亞東-新竹,2023-04-26,2184
3004,豐達科,9,0,9,亞東-新竹,2023-04-26,2184
4741,泓瀚,9,0,9,亞東-新竹,2023-04-26,2184
00830,國泰費城半導體,8,0,8,亞東-新竹,2023-04-26,2184
1762,中化生,8,0,8,亞東-新竹,2023-04-26,2184
2337,旺宏,8,0,8,亞東-新竹,2023-04-26,2184
6733,博晟生醫,8,0,8,亞東-新竹,2023-04-26,2184
2328,廣宇,7,0,7,亞東-新竹,2023-04-26,2184
4931,新盛力,7,0,7,亞東-新竹,2023-04-26,2184
6874,倍力,14,7,7,亞東-新竹,2023-04-26,2184
3535,晶彩科,6,0,6,亞東-新竹,2023-04-26,2184
6472,保瑞,5,0,5,亞東-新竹,2023-04-26,2184
0056,元大高股息,5,0,5,亞東-新竹,2023-04-26,2184
00878,國泰永續高股息,5,0,5,亞東-新竹,2023-04-26,2184
00857B,永豐20年美公債,5,0,5,亞東-新竹,2023-04-26,2184
4977,眾達-KY,5,0,5,亞東-新竹,2023-04-26,2184
8926,台汽電,5,0,5,亞東-新竹,2023-04-26,2184
2603,長榮,5,1,4,亞東-新竹,2023-04-26,2184
1784,訊聯,4,0,4,亞東-新竹,2023-04-26,2184
2002,中鋼,4,0,4,亞東-新竹,2023-04-26,2184
3303,岱稜,4,0,4,亞東-新竹,2023-04-26,2184
5706,鳳凰,4,0,4,亞東-新竹,2023-04-26,2184
6148,驊宏資,4,0,4,亞東-新竹,2023-04-26,2184
6477,安集,4,0,4,亞東-新竹,2023-04-26,2184
6829,千附精密,10,6,4,亞東-新竹,2023-04-26,2184
0050,元大台灣50,4,0,4,亞東-新竹,2023-04-26,2184
3035,智原,11,8,3,亞東-新竹,2023-04-26,2184
3008,大立光,3,0,3,亞東-新竹,2023-04-26,2184
00888,永豐台灣ESG,3,0,3,亞東-新竹,2023-04-26,2184
00715L,期街口布蘭特正2,3,0,3,亞東-新竹,2023-04-26,2184
1503,士電,4,1,3,亞東-新竹,2023-04-26,2184
2634,漢翔,175,33,142,亞東-新竹,2023-04-27,2184
2408,南亞科,100,0,100,亞東-新竹,2023-04-27,2184
00751B,元大AAA至A公司債,71,0,71,亞東-新竹,2023-04-27,2184
3260,威剛,60,0,60,亞東-新竹,2023-04-27,2184
00772B,中信高評級公司債,48,0,48,亞東-新竹,2023-04-27,2184
2603,長榮,33,3,30,亞東-新竹,2023-04-27,2184
1710,東聯,33,6,27,亞東-新竹,2023-04-27,2184
2486,一詮,25,0,25,亞東-新竹,2023-04-27,2184
00715L,期街口布蘭特正2,21,0,21,亞東-新竹,2023-04-27,2184
2884,玉山金,20,0,20,亞東-新竹,2023-04-27,2184
2002,中鋼,17,2,15,亞東-新竹,2023-04-27,2184
2915,潤泰全,15,0,15,亞東-新竹,2023-04-27,2184
2324,仁寶,10,0,10,亞東-新竹,2023-04-27,2184
5880,合庫金,10,0,10,亞東-新竹,2023-04-27,2184
6129,普誠,10,0,10,亞東-新竹,2023-04-27,2184
00720B,元大投資級公司債,9,0,9,亞東-新竹,2023-04-27,2184
3479,安勤,10,1,9,亞東-新竹,2023-04-27,2184
4105,東洋,29,20,9,亞東-新竹,2023-04-27,2184
2317,鴻海,9,1,8,亞東-新竹,2023-04-27,2184
1101,台泥,11,4,7,亞東-新竹,2023-04-27,2184
00679B,元大美債20年,8,2,6,亞東-新竹,2023-04-27,2184
2342,茂矽,6,0,6,亞東-新竹,2023-04-27,2184
4153,鈺緯,7,1,6,亞東-新竹,2023-04-27,2184
5227,立凱-KY,6,0,6,亞東-新竹,2023-04-27,2184
00712,復華富時不動產,5,0,5,亞東-新竹,2023-04-27,2184
00908,富邦入息REITs+,5,0,5,亞東-新竹,2023-04-27,2184
00900,富邦特選高股息30,5,0,5,亞東-新竹,2023-04-27,2184
1525,江申,5,0,5,亞東-新竹,2023-04-27,2184
1905,華紙,7,2,5,亞東-新竹,2023-04-27,2184
2888,新光金,5,0,5,亞東-新竹,2023-04-27,2184
2891,中信金,10,5,5,亞東-新竹,2023-04-27,2184
4908,前鼎,5,0,5,亞東-新竹,2023-04-27,2184
8111,立��,5,0,5,亞東-新竹,2023-04-27,2184
3027,盛達,4,0,4,亞東-新竹,2023-04-27,2184
3037,欣興,4,0,4,亞東-新竹,2023-04-27,2184
2882,國泰金,3,0,3,亞東-新竹,2023-04-27,2184
1310,台苯,3,0,3,亞東-新竹,2023-04-27,2184
00753L,中信中國50正2,3,0,3,亞東-新竹,2023-04-27,2184
00852L,國泰美國道瓊正2,3,0,3,亞東-新竹,2023-04-27,2184
2206,三陽工業,4,1,3,亞東-新竹,2023-04-27,2184
2406,國碩,3,0,3,亞東-新竹,2023-04-27,2184
2498,宏達電,3,0,3,亞東-新竹,2023-04-27,2184
3596,智易,3,0,3,亞東-新竹,2023-04-27,2184
6285,啟��,3,0,3,亞東-新竹,2023-04-27,2184
0050,元大台灣50,3,1,2,亞東-新竹,2023-04-27,2184
4123,晟德,2,0,2,亞東-新竹,2023-04-27,2184
2330,台積電,2,0,2,亞東-新竹,2023-04-27,2184
1513,中興電,3,1,2,亞東-新竹,2023-04-27,2184
2609,陽明,3,1,2,亞東-新竹,2023-04-27,2184
00773B,中信優先金融債,2,0,2,亞東-新竹,2023-04-27,2184
00680L,元大美債20正2,165,0,165,亞東-新竹,2023-04-28,2184
2897,王道銀行,120,0,120,亞東-新竹,2023-04-28,2184
2634,漢翔,135,59,76,亞東-新竹,2023-04-28,2184
2891B,中信金乙特,50,0,50,亞東-新竹,2023-04-28,2184
00632R,元大台灣50反1,20,0,20,亞東-新竹,2023-04-28,2184
6269,台郡,20,0,20,亞東-新竹,2023-04-28,2184
6234,高僑,18,0,18,亞東-新竹,2023-04-28,2184
1734,杏輝,16,0,16,亞東-新竹,2023-04-28,2184
2880,華南金,14,0,14,亞東-新竹,2023-04-28,2184
3576,聯合再生,13,0,13,亞東-新竹,2023-04-28,2184
2380,虹光,10,0,10,亞東-新竹,2023-04-28,2184
2645,長榮航太,10,0,10,亞東-新竹,2023-04-28,2184
2886,兆豐金,10,0,10,亞東-新竹,2023-04-28,2184
3705,永信,10,0,10,亞東-新竹,2023-04-28,2184
6733,博晟生醫,10,0,10,亞東-新竹,2023-04-28,2184
00900,富邦特選高股息30,8,0,8,亞東-新竹,2023-04-28,2184
5469,瀚宇博,8,0,8,亞東-新竹,2023-04-28,2184
1789,神隆,7,0,7,亞東-新竹,2023-04-28,2184
2453,凌群,9,3,6,亞東-新竹,2023-04-28,2184
4967,十銓,6,0,6,亞東-新竹,2023-04-28,2184
8111,立��,6,0,6,亞東-新竹,2023-04-28,2184
00679B,元大美債20年,7,2,5,亞東-新竹,2023-04-28,2184
00751B,元大AAA至A公司債,5,0,5,亞東-新竹,2023-04-28,2184
2612,中航,5,0,5,亞東-新竹,2023-04-28,2184
3004,豐達科,5,0,5,亞東-新竹,2023-04-28,2184
3025,星通,5,0,5,亞東-新竹,2023-04-28,2184
4908,前鼎,5,0,5,亞東-新竹,2023-04-28,2184
4979,華星光,10,5,5,亞東-新竹,2023-04-28,2184
5284,jpp-KY,6,1,5,亞東-新竹,2023-04-28,2184
6111,大宇資,5,0,5,亞東-新竹,2023-04-28,2184
6443,元晶,6,1,5,亞東-新竹,2023-04-28,2184
2201,裕隆,29,25,4,亞東-新竹,2023-04-28,2184
2515,中工,4,0,4,亞東-新竹,2023-04-28,2184
3707,漢磊,4,0,4,亞東-新竹,2023-04-28,2184
4207,環泰,4,0,4,亞東-新竹,2023-04-28,2184
6112,邁達特,4,0,4,亞東-新竹,2023-04-28,2184
8011,台通,4,0,4,亞東-新竹,2023-04-28,2184
2022,聚亨,3,0,3,亞東-新竹,2023-04-28,2184
2542,興富發,3,0,3,亞東-新竹,2023-04-28,2184
3479,安勤,4,1,3,亞東-新竹,2023-04-28,2184
3596,智易,3,0,3,亞東-新竹,2023-04-28,2184
4105,東洋,5,2,3,亞東-新竹,2023-04-28,2184
5227,立凱-KY,3,0,3,亞東-新竹,2023-04-28,2184
6176,瑞儀,3,0,3,亞東-新竹,2023-04-28,2184
8215,明基材,3,0,3,亞東-新竹,2023-04-28,2184
8222,寶一,24,21,3,亞東-新竹,2023-04-28,2184
9802,鈺齊-KY,3,0,3,亞東-新竹,2023-04-28,2184
6285,啟��,2,0,2,亞東-新竹,2023-04-28,2184
1589,永冠-KY,4,2,2,亞東-新竹,2023-04-28,2184
1314,中石化,2,0,2,亞東-新竹,2023-04-28,2184
00772B,中信高評級公司債,112,1,111,亞東-新竹,2023-05-02,2184
00751B,元大AAA至A公司債,56,0,56,亞東-新竹,2023-05-02,2184
3033,威健,34,0,34,亞東-新竹,2023-05-02,2184
2897,王道銀行,130,100,30,亞東-新竹,2023-05-02,2184
00632R,元大台灣50反1,25,0,25,亞東-新竹,2023-05-02,2184
2380,虹光,20,0,20,亞東-新竹,2023-05-02,2184
3025,星通,20,0,20,亞東-新竹,2023-05-02,2184
6288,聯嘉,20,0,20,亞東-新竹,2023-05-02,2184
2495,普安,20,1,19,亞東-新竹,2023-05-02,2184
2501,國建,19,0,19,亞東-新竹,2023-05-02,2184
00720B,元大投資級公司債,18,0,18,亞東-新竹,2023-05-02,2184
00712,復華富時不動產,15,0,15,亞東-新竹,2023-05-02,2184
2913,農林,14,0,14,亞東-新竹,2023-05-02,2184
6790,永豐實,14,0,14,亞東-新竹,2023-05-02,2184
2610,華航,12,0,12,亞東-新竹,2023-05-02,2184
3419,譁裕,11,0,11,亞東-新竹,2023-05-02,2184
8403,盛弘,16,5,11,亞東-新竹,2023-05-02,2184
2834,臺企銀,10,0,10,亞東-新竹,2023-05-02,2184
2886,兆豐金,10,0,10,亞東-新竹,2023-05-02,2184
9904,寶成,10,0,10,亞東-新竹,2023-05-02,2184
8936,國統,10,1,9,亞東-新竹,2023-05-02,2184
2603,長榮,10,1,9,亞東-新竹,2023-05-02,2184
2891B,中信金乙特,9,0,9,亞東-新竹,2023-05-02,2184
00687B,國泰20年美債,8,0,8,亞東-新竹,2023-05-02,2184
2363,矽統,8,0,8,亞東-新竹,2023-05-02,2184
2882,國泰金,8,0,8,亞東-新竹,2023-05-02,2184
3705,永信,8,0,8,亞東-新竹,2023-05-02,2184
00773B,中信優先金融債,7,0,7,亞東-新竹,2023-05-02,2184
0056,元大高股息,6,0,6,亞東-新竹,2023-05-02,2184
1539,巨庭,6,0,6,亞東-新竹,2023-05-02,2184
2344,華邦電,7,1,6,亞東-新竹,2023-05-02,2184
4111,濟生,6,0,6,亞東-新竹,2023-05-02,2184
6190,萬泰科,6,0,6,亞東-新竹,2023-05-02,2184
00795B,中信美國公債20年,5,0,5,亞東-新竹,2023-05-02,2184
00680L,元大美債20正2,5,0,5,亞東-新竹,2023-05-02,2184
1324,地球,5,0,5,亞東-新竹,2023-05-02,2184
1589,永冠-KY,5,0,5,亞東-新竹,2023-05-02,2184
1593,祺驊,6,1,5,亞東-新竹,2023-05-02,2184
1762,中化生,15,10,5,亞東-新竹,2023-05-02,2184
2031,新光鋼,5,0,5,亞東-新竹,2023-05-02,2184
2449,京元電子,5,0,5,亞東-新竹,2023-05-02,2184
4953,緯軟,6,1,5,亞東-新竹,2023-05-02,2184
6235,華孚,5,0,5,亞東-新竹,2023-05-02,2184
2609,陽明,5,1,4,亞東-新竹,2023-05-02,2184
2002,中鋼,4,0,4,亞東-新竹,2023-05-02,2184
2312,金寶,4,0,4,亞東-新竹,2023-05-02,2184
2402,毅嘉,4,0,4,亞東-新竹,2023-05-02,2184
3701,大眾控,10,6,4,亞東-新竹,2023-05-02,2184
5706,鳳凰,4,0,4,亞東-新竹,2023-05-02,2184
6127,九豪,4,0,4,亞東-新竹,2023-05-02,2184
00712,復華富時不動產,113,0,113,亞東-新竹,2023-05-03,2184
2897,王道銀行,50,0,50,亞東-新竹,2023-05-03,2184
2515,中工,30,0,30,亞東-新竹,2023-05-03,2184
2409,友達,28,3,25,亞東-新竹,2023-05-03,2184
2603,長榮,25,3,22,亞東-新竹,2023-05-03,2184
4510,高鋒,20,0,20,亞東-新竹,2023-05-03,2184
2427,三商電,15,0,15,亞東-新竹,2023-05-03,2184
2314,台揚,13,0,13,亞東-新竹,2023-05-03,2184
2352,佳世達,13,0,13,亞東-新竹,2023-05-03,2184
1711,永光,42,30,12,亞東-新竹,2023-05-03,2184
00642U,期元大S＆P石油,12,0,12,亞東-新竹,2023-05-03,2184
3276,宇環,20,8,12,亞東-新竹,2023-05-03,2184
00878,國泰永續高股息,16,4,12,亞東-新竹,2023-05-03,2184
00830,國泰費城半導體,11,0,11,亞東-新竹,2023-05-03,2184
4111,濟生,11,0,11,亞東-新竹,2023-05-03,2184
2022,聚亨,10,0,10,亞東-新竹,2023-05-03,2184
3545,敦泰,10,0,10,亞東-新竹,2023-05-03,2184
4157,太景*-KY,10,0,10,亞東-新竹,2023-05-03,2184
1513,中興電,13,4,9,亞東-新竹,2023-05-03,2184
3147,大綜,9,0,9,亞東-新竹,2023-05-03,2184
2380,虹光,8,0,8,亞東-新竹,2023-05-03,2184
3231,緯創,7,0,7,亞東-新竹,2023-05-03,2184
00715L,期街口布蘭特正2,26,20,6,亞東-新竹,2023-05-03,2184
1907,永豐餘,6,0,6,亞東-新竹,2023-05-03,2184
2027,大成鋼,7,1,6,亞東-新竹,2023-05-03,2184
2337,旺宏,6,0,6,亞東-新竹,2023-05-03,2184
2913,農林,10,4,6,亞東-新竹,2023-05-03,2184
3558,神準,8,2,6,亞東-新竹,2023-05-03,2184
6233,旺玖,6,0,6,亞東-新竹,2023-05-03,2184
1452,宏益,5,0,5,亞東-新竹,2023-05-03,2184
1324,地球,5,0,5,亞東-新竹,2023-05-03,2184
1310,台苯,5,0,5,亞東-新竹,2023-05-03,2184
00665L,富邦�琤肭磪囓�2,10,5,5,亞東-新竹,2023-05-03,2184
2243,宏旭-KY,5,0,5,亞東-新竹,2023-05-03,2184
2855,統一證,5,0,5,亞東-新竹,2023-05-03,2184
2886,兆豐金,5,0,5,亞東-新竹,2023-05-03,2184
3066,李洲,5,0,5,亞東-新竹,2023-05-03,2184
3363,上詮,5,0,5,亞東-新竹,2023-05-03,2184
4909,新復興,6,1,5,亞東-新竹,2023-05-03,2184
2201,裕隆,14,10,4,亞東-新竹,2023-05-03,2184
2634,漢翔,25,21,4,亞東-新竹,2023-05-03,2184
3206,志豐,5,1,4,亞東-新竹,2023-05-03,2184
3705,永信,4,0,4,亞東-新竹,2023-05-03,2184
6531,愛普*,34,30,4,亞東-新竹,2023-05-03,2184
00713,元大台灣高息低波,4,1,3,亞東-新竹,2023-05-03,2184
00852L,國泰美國道瓊正2,3,0,3,亞東-新竹,2023-05-03,2184
00633L,富邦上証正2,3,0,3,亞東-新竹,2023-05-03,2184
0056,元大高股息,3,0,3,亞東-新竹,2023-05-03,2184
2317,鴻海,3,0,3,亞東-新竹,2023-05-03,2184
3029,零壹,3,0,3,亞東-新竹,2023-05-03,2184
00715L,期街口布蘭特正2,108,8,100,亞東-新竹,2023-05-04,2184
2883,凱基金,75,0,75,亞東-新竹,2023-05-04,2184
00751B,元大AAA至A公司債,64,0,64,亞東-新竹,2023-05-04,2184
2408,南亞科,50,0,50,亞東-新竹,2023-05-04,2184
2867,三商壽,50,0,50,亞東-新竹,2023-05-04,2184
3260,威剛,50,0,50,亞東-新竹,2023-05-04,2184
00712,復華富時不動產,48,0,48,亞東-新竹,2023-05-04,2184
4168,醣聯,34,0,34,亞東-新竹,2023-05-04,2184
00679B,元大美債20年,28,8,20,亞東-新竹,2023-05-04,2184
6288,聯嘉,20,0,20,亞東-新竹,2023-05-04,2184
5469,瀚宇博,19,0,19,亞東-新竹,2023-05-04,2184
1708,東鹼,16,0,16,亞東-新竹,2023-05-04,2184
2303,聯電,16,2,14,亞東-新竹,2023-05-04,2184
2882,國泰金,12,0,12,亞東-新竹,2023-05-04,2184
00632R,元大台灣50反1,10,0,10,亞東-新竹,2023-05-04,2184
1734,杏輝,11,1,10,亞東-新竹,2023-05-04,2184
3202,樺晟,10,0,10,亞東-新竹,2023-05-04,2184
8938,明安,10,0,10,亞東-新竹,2023-05-04,2184
8478,東哥遊艇,10,1,9,亞東-新竹,2023-05-04,2184
3594,磐儀,8,0,8,亞東-新竹,2023-05-04,2184
1907,永豐餘,7,0,7,亞東-新竹,2023-05-04,2184
2344,華邦電,8,1,7,亞東-新竹,2023-05-04,2184
3380,明泰,6,0,6,亞東-新竹,2023-05-04,2184
00642U,期元大S＆P石油,6,0,6,亞東-新竹,2023-05-04,2184
1762,中化生,6,0,6,亞東-新竹,2023-05-04,2184
4909,新復興,8,2,6,亞東-新竹,2023-05-04,2184
9955,佳龍,6,0,6,亞東-新竹,2023-05-04,2184
1314,中石化,5,0,5,亞東-新竹,2023-05-04,2184
2342,茂矽,5,0,5,亞東-新竹,2023-05-04,2184
2425,承啟,5,0,5,亞東-新竹,2023-05-04,2184
2889,國票金,5,0,5,亞東-新竹,2023-05-04,2184
3013,晟銘電,5,0,5,亞東-新竹,2023-05-04,2184
5009,榮剛,5,0,5,亞東-新竹,2023-05-04,2184
5203,訊連,5,0,5,亞東-新竹,2023-05-04,2184
5222,全訊,5,0,5,亞東-新竹,2023-05-04,2184
6148,驊宏資,5,0,5,亞東-新竹,2023-05-04,2184
9904,寶成,5,0,5,亞東-新竹,2023-05-04,2184
1513,中興電,4,0,4,亞東-新竹,2023-05-04,2184
2454,聯發科,4,0,4,亞東-新竹,2023-05-04,2184
3006,晶豪科,4,0,4,亞東-新竹,2023-05-04,2184
3545,敦泰,4,0,4,亞東-新竹,2023-05-04,2184
5355,佳總,4,0,4,亞東-新竹,2023-05-04,2184
5538,東明-KY,4,0,4,亞東-新竹,2023-05-04,2184
6160,欣技,5,1,4,亞東-新竹,2023-05-04,2184
00646,元大S＆P500,3,0,3,亞東-新竹,2023-05-04,2184
00668,國泰美國道瓊,3,0,3,亞東-新竹,2023-05-04,2184
00852L,國泰美國道瓊正2,3,0,3,亞東-新竹,2023-05-04,2184
00830,國泰費城半導體,3,0,3,亞東-新竹,2023-05-04,2184
00878,國泰永續高股息,3,0,3,亞東-新竹,2023-05-04,2184
2338,光罩,3,0,3,亞東-新竹,2023-05-04,2184
00878,國泰永續高股息,54,0,54,亞東-新竹,2023-05-05,2184
00772B,中信高評級公司債,52,0,52,亞東-新竹,2023-05-05,2184
6129,普誠,33,1,32,亞東-新竹,2023-05-05,2184
2002,中鋼,30,0,30,亞東-新竹,2023-05-05,2184
00715L,期街口布蘭特正2,40,10,30,亞東-新竹,2023-05-05,2184
4114,健喬,32,10,22,亞東-新竹,2023-05-05,2184
0056,元大高股息,20,0,20,亞東-新竹,2023-05-05,2184
2105,正新,20,0,20,亞東-新竹,2023-05-05,2184
3038,全台,20,0,20,亞東-新竹,2023-05-05,2184
00679B,元大美債20年,21,2,19,亞東-新竹,2023-05-05,2184
2352,佳世達,18,0,18,亞東-新竹,2023-05-05,2184
1513,中興電,20,4,16,亞東-新竹,2023-05-05,2184
2913,農林,15,0,15,亞東-新竹,2023-05-05,2184
4157,太景*-KY,15,0,15,亞東-新竹,2023-05-05,2184
00720B,元大投資級公司債,13,0,13,亞東-新竹,2023-05-05,2184
2449,京元電子,13,0,13,亞東-新竹,2023-05-05,2184
00751B,元大AAA至A公司債,12,0,12,亞東-新竹,2023-05-05,2184
1516,川飛,11,0,11,亞東-新竹,2023-05-05,2184
1752,南光,15,4,11,亞東-新竹,2023-05-05,2184
2427,三商電,10,0,10,亞東-新竹,2023-05-05,2184
2618,長榮航,10,0,10,亞東-新竹,2023-05-05,2184
6770,力積電,10,0,10,亞東-新竹,2023-05-05,2184
8215,明基材,10,0,10,亞東-新竹,2023-05-05,2184
8403,盛弘,14,5,9,亞東-新竹,2023-05-05,2184
6191,精成科,15,6,9,亞東-新竹,2023-05-05,2184
6244,茂迪,22,13,9,亞東-新竹,2023-05-05,2184
6733,博晟生醫,9,0,9,亞東-新竹,2023-05-05,2184
4161,聿新科,8,0,8,亞東-新竹,2023-05-05,2184
2886,兆豐金,12,5,7,亞東-新竹,2023-05-05,2184
6443,元晶,7,0,7,亞東-新竹,2023-05-05,2184
1907,永豐餘,7,0,7,亞東-新竹,2023-05-05,2184
3714,富采,6,0,6,亞東-新竹,2023-05-05,2184
00713,元大台灣高息低波,5,0,5,亞東-新竹,2023-05-05,2184
00632R,元大台灣50反1,5,0,5,亞東-新竹,2023-05-05,2184
1529,樂事綠能,7,2,5,亞東-新竹,2023-05-05,2184
1416,廣豐,5,0,5,亞東-新竹,2023-05-05,2184
2027,大成鋼,5,0,5,亞東-新竹,2023-05-05,2184
2458,義隆,5,0,5,亞東-新竹,2023-05-05,2184
2528,皇普,5,0,5,亞東-新竹,2023-05-05,2184
2867,三商壽,5,0,5,亞東-新竹,2023-05-05,2184
2889,國票金,5,0,5,亞東-新竹,2023-05-05,2184
3046,建��,6,1,5,亞東-新竹,2023-05-05,2184
3231,緯創,7,2,5,亞東-新竹,2023-05-05,2184
6189,豐藝,5,0,5,亞東-新竹,2023-05-05,2184
6612,奈米醫材,5,0,5,亞東-新竹,2023-05-05,2184
1612,宏泰,4,0,4,亞東-新竹,2023-05-05,2184
4541,晟田,4,0,4,亞東-新竹,2023-05-05,2184
6741,91APP*-KY,4,0,4,亞東-新竹,2023-05-05,2184
1904,正隆,3,0,3,亞東-新竹,2023-05-05,2184
2206,三陽工業,6,3,3,亞東-新竹,2023-05-05,2184
2449,京元電子,50,0,50,亞東-新竹,2023-05-08,2184
2610,華航,50,0,50,亞東-新竹,2023-05-08,2184
2468,華經,40,1,39,亞東-新竹,2023-05-08,2184
2317,鴻海,40,1,39,亞東-新竹,2023-05-08,2184
00772B,中信高評級公司債,32,1,31,亞東-新竹,2023-05-08,2184
00725B,國泰投資級公司債,30,0,30,亞東-新竹,2023-05-08,2184
00632R,元大台灣50反1,30,0,30,亞東-新竹,2023-05-08,2184
3481,群創,28,0,28,亞東-新竹,2023-05-08,2184
1605,華新,25,5,20,亞東-新竹,2023-05-08,2184
6288,聯嘉,20,0,20,亞東-新竹,2023-05-08,2184
4114,健喬,20,1,19,亞東-新竹,2023-05-08,2184
1326,台化,15,0,15,亞東-新竹,2023-05-08,2184
00900,富邦特選高股息30,14,0,14,亞東-新竹,2023-05-08,2184
3545,敦泰,13,0,13,亞東-新竹,2023-05-08,2184
8926,台汽電,11,0,11,亞東-新竹,2023-05-08,2184
1218,泰山,10,0,10,亞東-新竹,2023-05-08,2184
1516,川飛,10,0,10,亞東-新竹,2023-05-08,2184
2105,正新,10,0,10,亞東-新竹,2023-05-08,2184
2344,華邦電,12,2,10,亞東-新竹,2023-05-08,2184
3058,立德,10,0,10,亞東-新竹,2023-05-08,2184
6290,良維,10,0,10,亞東-新竹,2023-05-08,2184
6770,力積電,10,0,10,亞東-新竹,2023-05-08,2184
00642U,期元大S＆P石油,9,0,9,亞東-新竹,2023-05-08,2184
2886,兆豐金,10,1,9,亞東-新竹,2023-05-08,2184
3029,零壹,13,4,9,亞東-新竹,2023-05-08,2184
6235,華孚,10,1,9,亞東-新竹,2023-05-08,2184
9962,有益,10,2,8,亞東-新竹,2023-05-08,2184
1762,中化生,8,0,8,亞東-新竹,2023-05-08,2184
00680L,元大美債20正2,7,0,7,亞東-新竹,2023-05-08,2184
00751B,元大AAA至A公司債,7,0,7,亞東-新竹,2023-05-08,2184
1904,正隆,9,2,7,亞東-新竹,2023-05-08,2184
8049,晶采,7,0,7,亞東-新竹,2023-05-08,2184
2368,金像電,5,0,5,亞東-新竹,2023-05-08,2184
1504,東元,5,0,5,亞東-新竹,2023-05-08,2184
1229,聯華,5,0,5,亞東-新竹,2023-05-08,2184
1316,上曜,5,0,5,亞東-新竹,2023-05-08,2184
1611,中電,5,0,5,亞東-新竹,2023-05-08,2184
2427,三商電,5,0,5,亞東-新竹,2023-05-08,2184
2834,臺企銀,5,0,5,亞東-新竹,2023-05-08,2184
00795B,中信美國公債20年,4,0,4,亞東-新竹,2023-05-08,2184
2609,陽明,4,0,4,亞東-新竹,2023-05-08,2184
4915,致伸,4,0,4,亞東-新竹,2023-05-08,2184
6161,捷波,4,0,4,亞東-新竹,2023-05-08,2184
6625,必應,4,0,4,亞東-新竹,2023-05-08,2184
6733,博晟生醫,4,0,4,亞東-新竹,2023-05-08,2184
1101,台泥,3,0,3,亞東-新竹,2023-05-08,2184
00720B,元大投資級公司債,3,0,3,亞東-新竹,2023-05-08,2184
1514,亞力,4,1,3,亞東-新竹,2023-05-08,2184
1503,士電,4,1,3,亞東-新竹,2023-05-08,2184
2442,新美齊,3,0,3,亞東-新竹,2023-05-08,2184
00687B,國泰20年美債,57,0,57,亞東-新竹,2023-05-09,2184
00795B,中信美國公債20年,57,0,57,亞東-新竹,2023-05-09,2184
00772B,中信高評級公司債,57,1,56,亞東-新竹,2023-05-09,2184
2897,王道銀行,50,0,50,亞東-新竹,2023-05-09,2184
1609,大亞,31,3,28,亞東-新竹,2023-05-09,2184
6443,元晶,28,0,28,亞東-新竹,2023-05-09,2184
2331,精英,25,0,25,亞東-新竹,2023-05-09,2184
9904,寶成,24,0,24,亞東-新竹,2023-05-09,2184
3078,僑威,21,0,21,亞東-新竹,2023-05-09,2184
2105,正新,20,0,20,亞東-新竹,2023-05-09,2184
3037,欣興,21,3,18,亞東-新竹,2023-05-09,2184
1762,中化生,20,5,15,亞東-新竹,2023-05-09,2184
3207,耀勝,15,0,15,亞東-新竹,2023-05-09,2184
4510,高鋒,15,0,15,亞東-新竹,2023-05-09,2184
4739,康普,15,0,15,亞東-新竹,2023-05-09,2184
2457,飛宏,21,7,14,亞東-新竹,2023-05-09,2184
2634,漢翔,115,102,13,亞東-新竹,2023-05-09,2184
6138,茂達,12,0,12,亞東-新竹,2023-05-09,2184
1402,遠東新,12,0,12,亞東-新竹,2023-05-09,2184
8049,晶采,12,0,12,亞東-新竹,2023-05-09,2184
0056,元大高股息,11,0,11,亞東-新竹,2023-05-09,2184
1101,台泥,12,2,10,亞東-新竹,2023-05-09,2184
1316,上曜,10,0,10,亞東-新竹,2023-05-09,2184
00892,富邦台灣半導體,10,0,10,亞東-新竹,2023-05-09,2184
6125,廣運,10,0,10,亞東-新竹,2023-05-09,2184
6288,聯嘉,11,1,10,亞東-新竹,2023-05-09,2184
2382,廣達,10,1,9,亞東-新竹,2023-05-09,2184
00751B,元大AAA至A公司債,9,0,9,亞東-新竹,2023-05-09,2184
2303,聯電,9,0,9,亞東-新竹,2023-05-09,2184
3419,譁裕,9,0,9,亞東-新竹,2023-05-09,2184
6770,力積電,9,0,9,亞東-新竹,2023-05-09,2184
1612,宏泰,8,0,8,亞東-新竹,2023-05-09,2184
2027,大成鋼,9,1,8,亞東-新竹,2023-05-09,2184
3708,上緯投控,8,0,8,亞東-新竹,2023-05-09,2184
8403,盛弘,8,0,8,亞東-新竹,2023-05-09,2184
1605,華新,11,5,6,亞東-新竹,2023-05-09,2184
00680L,元大美債20正2,6,0,6,亞東-新竹,2023-05-09,2184
00720B,元大投資級公司債,6,0,6,亞東-新竹,2023-05-09,2184
00632R,元大台灣50反1,6,0,6,亞東-新竹,2023-05-09,2184
2609,陽明,8,2,6,亞東-新竹,2023-05-09,2184
3025,星通,6,0,6,亞東-新竹,2023-05-09,2184
4173,久裕,6,0,6,亞東-新竹,2023-05-09,2184
5498,凱崴,6,0,6,亞東-新竹,2023-05-09,2184
9962,有益,6,0,6,亞東-新竹,2023-05-09,2184
4919,新唐,7,2,5,亞東-新竹,2023-05-09,2184
00631L,元大台灣50正2,8,3,5,亞東-新竹,2023-05-09,2184
3046,建��,17,12,5,亞東-新竹,2023-05-09,2184
3202,樺晟,5,0,5,亞東-新竹,2023-05-09,2184
3535,晶彩科,5,0,5,亞東-新竹,2023-05-09,2184
3605,宏致,5,0,5,亞東-新竹,2023-05-09,2184
00680L,元大美債20正2,102,0,102,亞東-新竹,2023-05-10,2184
00665L,富邦�琤肭磪囓�2,40,0,40,亞東-新竹,2023-05-10,2184
00878,國泰永續高股息,39,0,39,亞東-新竹,2023-05-10,2184
2610,華航,60,22,38,亞東-新竹,2023-05-10,2184
00713,元大台灣高息低波,33,0,33,亞東-新竹,2023-05-10,2184
9904,寶成,31,0,31,亞東-新竹,2023-05-10,2184
00687B,國泰20年美債,27,0,27,亞東-新竹,2023-05-10,2184
00857B,永豐20年美公債,27,0,27,亞東-新竹,2023-05-10,2184
00882,中信中國高股息,23,0,23,亞東-新竹,2023-05-10,2184
2303,聯電,24,4,20,亞東-新竹,2023-05-10,2184
2337,旺宏,22,2,20,亞東-新竹,2023-05-10,2184
2380,虹光,20,0,20,亞東-新竹,2023-05-10,2184
2330,台積電,16,0,16,亞東-新竹,2023-05-10,2184
6244,茂迪,12,0,12,亞東-新竹,2023-05-10,2184
2344,華邦電,11,0,11,亞東-新竹,2023-05-10,2184
00892,富邦台灣半導體,10,0,10,亞東-新竹,2023-05-10,2184
2633,台灣高鐵,10,0,10,亞東-新竹,2023-05-10,2184
6770,力積電,10,0,10,亞東-新竹,2023-05-10,2184
3231,緯創,20,11,9,亞東-新竹,2023-05-10,2184
00753L,中信中國50正2,9,0,9,亞東-新竹,2023-05-10,2184
2352,佳世達,14,5,9,亞東-新竹,2023-05-10,2184
00633L,富邦上証正2,7,0,7,亞東-新竹,2023-05-10,2184
3535,晶彩科,7,0,7,亞東-新竹,2023-05-10,2184
5469,瀚宇博,8,1,7,亞東-新竹,2023-05-10,2184
2027,大成鋼,6,0,6,亞東-新竹,2023-05-10,2184
2427,三商電,6,0,6,亞東-新竹,2023-05-10,2184
3046,建��,9,3,6,亞東-新竹,2023-05-10,2184
4979,華星光,6,0,6,亞東-新竹,2023-05-10,2184
6138,茂達,5,0,5,亞東-新竹,2023-05-10,2184
00885,富邦越南,5,0,5,亞東-新竹,2023-05-10,2184
1785,光洋科,5,0,5,亞東-新竹,2023-05-10,2184
00772B,中信高評級公司債,5,0,5,亞東-新竹,2023-05-10,2184
00720B,元大投資級公司債,5,0,5,亞東-新竹,2023-05-10,2184
3481,群創,5,0,5,亞東-新竹,2023-05-10,2184
6274,台燿,5,0,5,亞東-新竹,2023-05-10,2184
9103,美德醫療-DR,5,0,5,亞東-新竹,2023-05-10,2184
00908,富邦入息REITs+,4,0,4,亞東-新竹,2023-05-10,2184
2882,國泰金,4,0,4,亞東-新竹,2023-05-10,2184
3303,岱稜,4,0,4,亞東-新竹,2023-05-10,2184
3511,矽瑪,4,0,4,亞東-新竹,2023-05-10,2184
8403,盛弘,4,0,4,亞東-新竹,2023-05-10,2184
2458,義隆,3,0,3,亞東-新竹,2023-05-10,2184
1101,台泥,4,1,3,亞東-新竹,2023-05-10,2184
00795B,中信美國公債20年,3,0,3,亞東-新竹,2023-05-10,2184
1904,正隆,3,0,3,亞東-新竹,2023-05-10,2184
2338,光罩,3,0,3,亞東-新竹,2023-05-10,2184
2409,友達,3,0,3,亞東-新竹,2023-05-10,2184
3504,揚明光,3,0,3,亞東-新竹,2023-05-10,2184
9939,宏全,5,2,3,亞東-新竹,2023-05-10,2184
00891,中信關鍵半導體,2,0,2,亞東-新竹,2023-05-10,2184
6120,達運,55,0,55,亞東-新竹,2023-05-11,2184
00772B,中信高評級公司債,53,1,52,亞東-新竹,2023-05-11,2184
00679B,元大美債20年,52,2,50,亞東-新竹,2023-05-11,2184
2641,正德,40,0,40,亞東-新竹,2023-05-11,2184
2206,三陽工業,39,0,39,亞東-新竹,2023-05-11,2184
3522,御嵿,37,0,37,亞東-新竹,2023-05-11,2184
3006,晶豪科,38,9,29,亞東-新竹,2023-05-11,2184
00725B,國泰投資級公司債,25,0,25,亞東-新竹,2023-05-11,2184
6770,力積電,25,0,25,亞東-新竹,2023-05-11,2184
00857B,永豐20年美公債,23,0,23,亞東-新竹,2023-05-11,2184
3535,晶彩科,23,0,23,亞東-新竹,2023-05-11,2184
2201,裕隆,28,7,21,亞東-新竹,2023-05-11,2184
2897,王道銀行,20,0,20,亞東-新竹,2023-05-11,2184
1609,大亞,19,0,19,亞東-新竹,2023-05-11,2184
2618,長榮航,18,2,16,亞東-新竹,2023-05-11,2184
8926,台汽電,15,0,15,亞東-新竹,2023-05-11,2184
2603,長榮,11,0,11,亞東-新竹,2023-05-11,2184
0056,元大高股息,29,18,11,亞東-新竹,2023-05-11,2184
1402,遠東新,11,0,11,亞東-新竹,2023-05-11,2184
2609,陽明,11,0,11,亞東-新竹,2023-05-11,2184
1314,中石化,10,0,10,亞東-新竹,2023-05-11,2184
00892,富邦台灣半導體,10,0,10,亞東-新竹,2023-05-11,2184
1720,生達,10,0,10,亞東-新竹,2023-05-11,2184
2501,國建,10,0,10,亞東-新竹,2023-05-11,2184
6138,茂達,11,2,9,亞東-新竹,2023-05-11,2184
6285,啟��,8,0,8,亞東-新竹,2023-05-11,2184
00878,國泰永續高股息,10,3,7,亞東-新竹,2023-05-11,2184
1612,宏泰,10,3,7,亞東-新竹,2023-05-11,2184
2634,漢翔,50,43,7,亞東-新竹,2023-05-11,2184
1605,華新,7,1,6,亞東-新竹,2023-05-11,2184
1219,福壽,6,0,6,亞東-新竹,2023-05-11,2184
2409,友達,6,0,6,亞東-新竹,2023-05-11,2184
3511,矽瑪,6,0,6,亞東-新竹,2023-05-11,2184
6134,萬旭,6,0,6,亞東-新竹,2023-05-11,2184
3034,聯詠,6,0,6,亞東-新竹,2023-05-11,2184
1316,上曜,5,0,5,亞東-新竹,2023-05-11,2184
00795B,中信美國公債20年,5,0,5,亞東-新竹,2023-05-11,2184
00896,中信綠能及電動車,5,0,5,亞東-新竹,2023-05-11,2184
00713,元大台灣高息低波,5,0,5,亞東-新竹,2023-05-11,2184
1711,永光,5,0,5,亞東-新竹,2023-05-11,2184
1752,南光,5,0,5,亞東-新竹,2023-05-11,2184
1762,中化生,10,5,5,亞東-新竹,2023-05-11,2184
2376,技嘉,5,0,5,亞東-新竹,2023-05-11,2184
2888,新光金,5,0,5,亞東-新竹,2023-05-11,2184
3088,艾訊,5,0,5,亞東-新竹,2023-05-11,2184
4958,臻鼎-KY,5,0,5,亞東-新竹,2023-05-11,2184
8463,潤泰材,5,0,5,亞東-新竹,2023-05-11,2184
00768B,復華20年美債,4,0,4,亞東-新竹,2023-05-11,2184
1310,台苯,4,0,4,亞東-新竹,2023-05-11,2184
1516,川飛,4,0,4,亞東-新竹,2023-05-11,2184
00878,國泰永續高股息,63,10,53,亞東-新竹,2023-05-12,2184
00857B,永豐20年美公債,50,0,50,亞東-新竹,2023-05-12,2184
6163,華電網,50,0,50,亞東-新竹,2023-05-12,2184
2888,新光金,42,0,42,亞東-新竹,2023-05-12,2184
00687B,國泰20年美債,50,16,34,亞東-新竹,2023-05-12,2184
2317,鴻海,42,11,31,亞東-新竹,2023-05-12,2184
3704,合勤控,24,1,23,亞東-新竹,2023-05-12,2184
1609,大亞,38,15,23,亞東-新竹,2023-05-12,2184
2105,正新,20,0,20,亞東-新竹,2023-05-12,2184
00772B,中信高評級公司債,20,3,17,亞東-新竹,2023-05-12,2184
2886,兆豐金,16,0,16,亞東-新竹,2023-05-12,2184
2606,裕民,15,0,15,亞東-新竹,2023-05-12,2184
2027,大成鋼,14,0,14,亞東-新竹,2023-05-12,2184
00679B,元大美債20年,20,8,12,亞東-新竹,2023-05-12,2184
5258,虹堡,14,2,12,亞東-新竹,2023-05-12,2184
00632R,元大台灣50反1,15,5,10,亞東-新竹,2023-05-12,2184
2633,台灣高鐵,10,0,10,亞東-新竹,2023-05-12,2184
3014,聯陽,11,1,10,亞東-新竹,2023-05-12,2184
5533,皇鼎,10,0,10,亞東-新竹,2023-05-12,2184
6265,方土昶,10,0,10,亞東-新竹,2023-05-12,2184
2609,陽明,7,0,7,亞東-新竹,2023-05-12,2184
2845,遠東銀,7,0,7,亞東-新竹,2023-05-12,2184
5538,東明-KY,7,0,7,亞東-新竹,2023-05-12,2184
6285,啟��,6,0,6,亞東-新竹,2023-05-12,2184
1516,川飛,6,0,6,亞東-新竹,2023-05-12,2184
2303,聯電,6,0,6,亞東-新竹,2023-05-12,2184
2409,友達,6,0,6,亞東-新竹,2023-05-12,2184
2457,飛宏,31,25,6,亞東-新竹,2023-05-12,2184
2890,永豐金,5,0,5,亞東-新竹,2023-05-12,2184
00713,元大台灣高息低波,5,0,5,亞東-新竹,2023-05-12,2184
1605,華新,6,1,5,亞東-新竹,2023-05-12,2184
1762,中化生,5,0,5,亞東-新竹,2023-05-12,2184
4979,華星光,5,0,5,亞東-新竹,2023-05-12,2184
6112,邁達特,6,1,5,亞東-新竹,2023-05-12,2184
8176,智捷,9,4,5,亞東-新竹,2023-05-12,2184
1529,樂事綠能,14,10,4,亞東-新竹,2023-05-12,2184
00882,中信中國高股息,4,0,4,亞東-新竹,2023-05-12,2184
2882,國泰金,5,1,4,亞東-新竹,2023-05-12,2184
00633L,富邦上証正2,5,1,4,亞東-新竹,2023-05-12,2184
2204,中華,14,10,4,亞東-新竹,2023-05-12,2184
2211,長榮鋼,4,0,4,亞東-新竹,2023-05-12,2184
2308,台達電,4,0,4,亞東-新竹,2023-05-12,2184
3522,御嵿,4,0,4,亞東-新竹,2023-05-12,2184
6612,奈米醫材,5,1,4,亞東-新竹,2023-05-12,2184
00891,中信關鍵半導體,3,0,3,亞東-新竹,2023-05-12,2184
3504,揚明光,3,0,3,亞東-新竹,2023-05-12,2184
5876,上海商銀,3,0,3,亞東-新竹,2023-05-12,2184
6197,佳必琪,5,2,3,亞東-新竹,2023-05-12,2184
6282,康舒,3,0,3,亞東-新竹,2023-05-12,2184
8215,明基材,3,0,3,亞東-新竹,2023-05-12,2184
2633,台灣高鐵,100,20,80,亞東-新竹,2023-05-15,2184
2317,鴻海,66,0,66,亞東-新竹,2023-05-15,2184
00686R,群益臺灣加權反1,60,0,60,亞東-新竹,2023-05-15,2184
2867,三商壽,60,0,60,亞東-新竹,2023-05-15,2184
00772B,中信高評級公司債,54,8,46,亞東-新竹,2023-05-15,2184
3625,西勝,30,0,30,亞東-新竹,2023-05-15,2184
8927,北基,22,0,22,亞東-新竹,2023-05-15,2184
2915,潤泰全,16,0,16,亞東-新竹,2023-05-15,2184
6290,良維,15,0,15,亞東-新竹,2023-05-15,2184
00687B,國泰20年美債,13,0,13,亞東-新竹,2023-05-15,2184
2303,聯電,12,0,12,亞東-新竹,2023-05-15,2184
2603,長榮,29,18,11,亞東-新竹,2023-05-15,2184
3231,緯創,25,15,10,亞東-新竹,2023-05-15,2184
00877,復華中國5G,10,0,10,亞東-新竹,2023-05-15,2184
00764B,群益25年美債,10,0,10,亞東-新竹,2023-05-15,2184
00722B,群益投資級電信債,10,0,10,亞東-新竹,2023-05-15,2184
2883,凱基金,110,100,10,亞東-新竹,2023-05-15,2184
6443,元晶,10,0,10,亞東-新竹,2023-05-15,2184
2489,瑞軒,8,0,8,亞東-新竹,2023-05-15,2184
3576,聯合再生,13,6,7,亞東-新竹,2023-05-15,2184
6129,普誠,7,0,7,亞東-新竹,2023-05-15,2184
8048,德勝,7,0,7,亞東-新竹,2023-05-15,2184
00720B,元大投資級公司債,6,0,6,亞東-新竹,2023-05-15,2184
1720,生達,7,1,6,亞東-新竹,2023-05-15,2184
2201,裕隆,16,10,6,亞東-新竹,2023-05-15,2184
2402,毅嘉,12,6,6,亞東-新竹,2023-05-15,2184
3046,建��,7,1,6,亞東-新竹,2023-05-15,2184
2330,台積電,5,0,5,亞東-新竹,2023-05-15,2184
00632R,元大台灣50反1,5,0,5,亞東-新竹,2023-05-15,2184
00642U,期元大S＆P石油,5,0,5,亞東-新竹,2023-05-15,2184
1734,杏輝,5,0,5,亞東-新竹,2023-05-15,2184
2528,皇普,5,0,5,亞東-新竹,2023-05-15,2184
3522,御嵿,5,0,5,亞東-新竹,2023-05-15,2184
9944,新麗,5,0,5,亞東-新竹,2023-05-15,2184
4119,旭富,4,0,4,亞東-新竹,2023-05-15,2184
4763,材料-KY,4,0,4,亞東-新竹,2023-05-15,2184
5469,瀚宇博,4,0,4,亞東-新竹,2023-05-15,2184
5905,南仁湖,4,0,4,亞東-新竹,2023-05-15,2184
6509,聚和,4,0,4,亞東-新竹,2023-05-15,2184
4961,天鈺,4,1,3,亞東-新竹,2023-05-15,2184
00882,中信中國高股息,3,0,3,亞東-新竹,2023-05-15,2184
3712,永崴投控,3,0,3,亞東-新竹,2023-05-15,2184
6770,力積電,3,0,3,亞東-新竹,2023-05-15,2184
1445,大宇,3,0,3,亞東-新竹,2023-05-15,2184
1324,地球,3,0,3,亞東-新竹,2023-05-15,2184
2371,大同,11,8,3,亞東-新竹,2023-05-15,2184
2634,漢翔,5,2,3,亞東-新竹,2023-05-15,2184
3202,樺晟,3,0,3,亞東-新竹,2023-05-15,2184
3504,揚明光,3,0,3,亞東-新竹,2023-05-15,2184
4155,訊映,3,0,3,亞東-新竹,2023-05-15,2184
00715L,期街口布蘭特正2,60,0,60,亞東-新竹,2023-05-16,2184
00687B,國泰20年美債,53,0,53,亞東-新竹,2023-05-16,2184
2323,中環,94,41,53,亞東-新竹,2023-05-16,2184
00857B,永豐20年美公債,51,0,51,亞東-新竹,2023-05-16,2184
2601,益航,40,0,40,亞東-新竹,2023-05-16,2184
2603,長榮,33,0,33,亞東-新竹,2023-05-16,2184
3037,欣興,34,1,33,亞東-新竹,2023-05-16,2184
2852,第一保,20,0,20,亞東-新竹,2023-05-16,2184
2913,農林,20,0,20,亞東-新竹,2023-05-16,2184
2393,億光,20,1,19,亞東-新竹,2023-05-16,2184
3231,緯創,40,24,16,亞東-新竹,2023-05-16,2184
2331,精英,15,0,15,亞東-新竹,2023-05-16,2184
2313,華通,16,2,14,亞東-新竹,2023-05-16,2184
00772B,中信高評級公司債,12,0,12,亞東-新竹,2023-05-16,2184
4541,晟田,12,0,12,亞東-新竹,2023-05-16,2184
2402,毅嘉,16,5,11,亞東-新竹,2023-05-16,2184
1402,遠東新,10,0,10,亞東-新竹,2023-05-16,2184
00632R,元大台灣50反1,10,0,10,亞東-新竹,2023-05-16,2184
01007T,兆豐國泰R2,10,0,10,亞東-新竹,2023-05-16,2184
2731,雄獅,12,2,10,亞東-新竹,2023-05-16,2184
3005,神基,10,0,10,亞東-新竹,2023-05-16,2184
4533,協易機,10,0,10,亞東-新竹,2023-05-16,2184
5351,鈺創,10,0,10,亞東-新竹,2023-05-16,2184
5876,上海商銀,10,0,10,亞東-新竹,2023-05-16,2184
6770,力積電,10,0,10,亞東-新竹,2023-05-16,2184
6160,欣技,10,2,8,亞東-新竹,2023-05-16,2184
3287,廣寰科,8,0,8,亞東-新竹,2023-05-16,2184
3419,譁裕,8,0,8,亞東-新竹,2023-05-16,2184
3511,矽瑪,6,0,6,亞東-新竹,2023-05-16,2184
1451,年興,5,0,5,亞東-新竹,2023-05-16,2184
00853B,統一美債10年Aa-,5,0,5,亞東-新竹,2023-05-16,2184
3455,由田,5,0,5,亞東-新竹,2023-05-16,2184
6128,上福,5,0,5,亞東-新竹,2023-05-16,2184
8261,富鼎,5,0,5,亞東-新竹,2023-05-16,2184
00720B,元大投資級公司債,4,0,4,亞東-新竹,2023-05-16,2184
5905,南仁湖,4,0,4,亞東-新竹,2023-05-16,2184
5907,大洋-KY,4,0,4,亞東-新竹,2023-05-16,2184
6194,育富,4,0,4,亞東-新竹,2023-05-16,2184
6243,迅杰,6,2,4,亞東-新竹,2023-05-16,2184
6248,沛波,4,0,4,亞東-新竹,2023-05-16,2184
6558,興能高,4,0,4,亞東-新竹,2023-05-16,2184
1709,和益,5,2,3,亞東-新竹,2023-05-16,2184
1513,中興電,3,0,3,亞東-新竹,2023-05-16,2184
00679B,元大美債20年,3,0,3,亞東-新竹,2023-05-16,2184
1218,泰山,3,0,3,亞東-新竹,2023-05-16,2184
2314,台揚,3,0,3,亞東-新竹,2023-05-16,2184
2453,凌群,3,0,3,亞東-新竹,2023-05-16,2184
2615,萬海,3,0,3,亞東-新竹,2023-05-16,2184
8121,越峰,3,0,3,亞東-新竹,2023-05-16,2184
8426,紅木-KY,10,7,3,亞東-新竹,2023-05-16,2184
2402,毅嘉,117,1,116,亞東-新竹,2023-05-17,2184
00632R,元大台灣50反1,94,17,77,亞東-新竹,2023-05-17,2184
00751B,元大AAA至A公司債,55,0,55,亞東-新竹,2023-05-17,2184
1616,億泰,49,0,49,亞東-新竹,2023-05-17,2184
00878,國泰永續高股息,46,10,36,亞東-新竹,2023-05-17,2184
8261,富鼎,35,0,35,亞東-新竹,2023-05-17,2184
00687B,國泰20年美債,34,0,34,亞東-新竹,2023-05-17,2184
00895,富邦未來車,20,0,20,亞東-新竹,2023-05-17,2184
2308,台達電,20,0,20,亞東-新竹,2023-05-17,2184
3260,威剛,20,0,20,亞東-新竹,2023-05-17,2184
2634,漢翔,68,49,19,亞東-新竹,2023-05-17,2184
00715L,期街口布蘭特正2,15,0,15,亞東-新竹,2023-05-17,2184
00665L,富邦�琤肭磪囓�2,10,0,10,亞東-新竹,2023-05-17,2184
2610,華航,31,21,10,亞東-新竹,2023-05-17,2184
9914,美利達,10,0,10,亞東-新竹,2023-05-17,2184
00882,中信中國高股息,9,0,9,亞東-新竹,2023-05-17,2184
2201,裕隆,26,17,9,亞東-新竹,2023-05-17,2184
5243,乙盛-KY,11,2,9,亞東-新竹,2023-05-17,2184
2881,富邦金,8,0,8,亞東-新竹,2023-05-17,2184
6160,欣技,27,19,8,亞東-新竹,2023-05-17,2184
00772B,中信高評級公司債,6,0,6,亞東-新竹,2023-05-17,2184
2731,雄獅,6,0,6,亞東-新竹,2023-05-17,2184
4541,晟田,6,0,6,亞東-新竹,2023-05-17,2184
1445,大宇,5,0,5,亞東-新竹,2023-05-17,2184
1711,永光,5,0,5,亞東-新竹,2023-05-17,2184
2421,建準,5,0,5,亞東-新竹,2023-05-17,2184
2457,飛宏,26,21,5,亞東-新竹,2023-05-17,2184
4527,方土霖,5,0,5,亞東-新竹,2023-05-17,2184
4906,正文,5,0,5,亞東-新竹,2023-05-17,2184
6282,康舒,5,0,5,亞東-新竹,2023-05-17,2184
6753,龍德造船,5,0,5,亞東-新竹,2023-05-17,2184
3034,聯詠,5,0,5,亞東-新竹,2023-05-17,2184
00680L,元大美債20正2,4,0,4,亞東-新竹,2023-05-17,2184
3504,揚明光,8,4,4,亞東-新竹,2023-05-17,2184
3522,御嵿,4,0,4,亞東-新竹,2023-05-17,2184
5469,瀚宇博,21,17,4,亞東-新竹,2023-05-17,2184
6243,迅杰,19,15,4,亞東-新竹,2023-05-17,2184
9945,潤泰新,4,0,4,亞東-新竹,2023-05-17,2184
00637L,元大滬深300正2,3,0,3,亞東-新竹,2023-05-17,2184
1513,中興電,3,0,3,亞東-新竹,2023-05-17,2184
1402,遠東新,10,7,3,亞東-新竹,2023-05-17,2184
2206,三陽工業,6,3,3,亞東-新竹,2023-05-17,2184
2408,南亞科,5,2,3,亞東-新竹,2023-05-17,2184
3005,神基,5,2,3,亞東-新竹,2023-05-17,2184
3046,建��,17,14,3,亞東-新竹,2023-05-17,2184
4119,旭富,3,0,3,亞東-新竹,2023-05-17,2184
4931,新盛力,3,0,3,亞東-新竹,2023-05-17,2184
6874,倍力,5,2,3,亞東-新竹,2023-05-17,2184
6285,啟��,2,0,2,亞東-新竹,2023-05-17,2184
00722B,群益投資級電信債,2,0,2,亞東-新竹,2023-05-17,2184
2897,王道銀行,130,0,130,亞東-新竹,2023-05-18,2184
2867,三商壽,99,0,99,亞東-新竹,2023-05-18,2184
00632R,元大台灣50反1,112,30,82,亞東-新竹,2023-05-18,2184
00772B,中信高評級公司債,51,0,51,亞東-新竹,2023-05-18,2184
1513,中興電,39,1,38,亞東-新竹,2023-05-18,2184
6266,泰詠,31,1,30,亞東-新竹,2023-05-18,2184
5465,富驊,20,0,20,亞東-新竹,2023-05-18,2184
5469,瀚宇博,20,0,20,亞東-新竹,2023-05-18,2184
2633,台灣高鐵,15,0,15,亞東-新竹,2023-05-18,2184
6625,必應,12,0,12,亞東-新竹,2023-05-18,2184
4908,前鼎,11,0,11,亞東-新竹,2023-05-18,2184
6188,廣明,11,0,11,亞東-新竹,2023-05-18,2184
00895,富邦未來車,10,0,10,亞東-新竹,2023-05-18,2184
00665L,富邦�琤肭磪囓�2,10,0,10,亞東-新竹,2023-05-18,2184
00687B,國泰20年美債,10,0,10,亞東-新竹,2023-05-18,2184
2845,遠東銀,10,0,10,亞東-新竹,2023-05-18,2184
3322,建舜電,10,0,10,亞東-新竹,2023-05-18,2184
3694,海華,10,1,9,亞東-新竹,2023-05-18,2184
8261,富鼎,10,2,8,亞東-新竹,2023-05-18,2184
9945,潤泰新,8,0,8,亞東-新竹,2023-05-18,2184
2206,三陽工業,22,14,8,亞東-新竹,2023-05-18,2184
1529,樂事綠能,11,4,7,亞東-新竹,2023-05-18,2184
6751,智聯服務,7,0,7,亞東-新竹,2023-05-18,2184
1324,地球,6,0,6,亞東-新竹,2023-05-18,2184
00680L,元大美債20正2,6,0,6,亞東-新竹,2023-05-18,2184
2425,承啟,6,0,6,亞東-新竹,2023-05-18,2184
2618,長榮航,6,1,5,亞東-新竹,2023-05-18,2184
2637,慧洋-KY,5,0,5,亞東-新竹,2023-05-18,2184
3260,威剛,5,0,5,亞東-新竹,2023-05-18,2184
3287,廣寰科,5,0,5,亞東-新竹,2023-05-18,2184
5009,榮剛,4,0,4,亞東-新竹,2023-05-18,2184
2468,華經,14,10,4,亞東-新竹,2023-05-18,2184
2886,兆豐金,4,0,4,亞東-新竹,2023-05-18,2184
3707,漢磊,4,0,4,亞東-新竹,2023-05-18,2184
6443,元晶,4,0,4,亞東-新竹,2023-05-18,2184
00751B,元大AAA至A公司債,4,0,4,亞東-新竹,2023-05-18,2184
9958,世紀鋼,3,0,3,亞東-新竹,2023-05-18,2184
2491,吉祥全,3,0,3,亞東-新竹,2023-05-18,2184
2617,台航,3,0,3,亞東-新竹,2023-05-18,2184
3005,神基,5,2,3,亞東-新竹,2023-05-18,2184
6874,倍力,4,1,3,亞東-新竹,2023-05-18,2184
8222,寶一,3,0,3,亞東-新竹,2023-05-18,2184
1777,生泰,2,0,2,亞東-新竹,2023-05-18,2184
2481,強茂,2,0,2,亞東-新竹,2023-05-18,2184
2630,亞航,5,3,2,亞東-新竹,2023-05-18,2184
2754,亞洲藏壽司,2,0,2,亞東-新竹,2023-05-18,2184
2884,玉山金,2,0,2,亞東-新竹,2023-05-18,2184
2913,農林,2,0,2,亞東-新竹,2023-05-18,2184
6182,合晶,2,0,2,亞東-新竹,2023-05-18,2184
6220,岳豐,2,0,2,亞東-新竹,2023-05-18,2184
00632R,元大台灣50反1,267,0,267,亞東-新竹,2023-05-19,2184
00772B,中信高評級公司債,55,2,53,亞東-新竹,2023-05-19,2184
00751B,元大AAA至A公司債,39,0,39,亞東-新竹,2023-05-19,2184
00665L,富邦�琤肭磪囓�2,30,0,30,亞東-新竹,2023-05-19,2184
00687B,國泰20年美債,23,0,23,亞東-新竹,2023-05-19,2184
1514,亞力,23,2,21,亞東-新竹,2023-05-19,2184
5465,富驊,15,0,15,亞東-新竹,2023-05-19,2184
00882,中信中國高股息,14,0,14,亞東-新竹,2023-05-19,2184
2633,台灣高鐵,15,1,14,亞東-新竹,2023-05-19,2184
1711,永光,14,2,12,亞東-新竹,2023-05-19,2184
1616,億泰,11,0,11,亞東-新竹,2023-05-19,2184
1762,中化生,10,0,10,亞東-新竹,2023-05-19,2184
2328,廣宇,10,0,10,亞東-新竹,2023-05-19,2184
2331,精英,10,0,10,亞東-新竹,2023-05-19,2184
2442,新美齊,10,0,10,亞東-新竹,2023-05-19,2184
3046,建��,17,7,10,亞東-新竹,2023-05-19,2184
4747,強生,10,0,10,亞東-新竹,2023-05-19,2184
6547,高端疫苗,10,0,10,亞東-新竹,2023-05-19,2184
00753L,中信中國50正2,9,0,9,亞東-新竹,2023-05-19,2184
6266,泰詠,11,2,9,亞東-新竹,2023-05-19,2184
0050,元大台灣50,20,12,8,亞東-新竹,2023-05-19,2184
1504,東元,16,8,8,亞東-新竹,2023-05-19,2184
2022,聚亨,8,0,8,亞東-新竹,2023-05-19,2184
2371,大同,8,0,8,亞東-新竹,2023-05-19,2184
6770,力積電,8,0,8,亞東-新竹,2023-05-19,2184
5263,智崴,7,0,7,亞東-新竹,2023-05-19,2184
8059,凱碩,7,0,7,亞東-新竹,2023-05-19,2184
1723,中碳,6,0,6,亞東-新竹,2023-05-19,2184
3287,廣寰科,5,0,5,亞東-新竹,2023-05-19,2184
3362,先進光,5,0,5,亞東-新竹,2023-05-19,2184
3652,精聯,5,0,5,亞東-新竹,2023-05-19,2184
3682,亞太電,5,0,5,亞東-新竹,2023-05-19,2184
5469,瀚宇博,5,0,5,亞東-新竹,2023-05-19,2184
6235,華孚,11,6,5,亞東-新竹,2023-05-19,2184
6288,聯嘉,5,0,5,亞東-新竹,2023-05-19,2184
00908,富邦入息REITs+,4,0,4,亞東-新竹,2023-05-19,2184
00713,元大台灣高息低波,4,0,4,亞東-新竹,2023-05-19,2184
1752,南光,10,6,4,亞東-新竹,2023-05-19,2184
2201,裕隆,20,16,4,亞東-新竹,2023-05-19,2184
2314,台揚,4,0,4,亞東-新竹,2023-05-19,2184
2332,友訊,4,0,4,亞東-新竹,2023-05-19,2184
2399,映泰,4,0,4,亞東-新竹,2023-05-19,2184
6244,茂迪,4,0,4,亞東-新竹,2023-05-19,2184
8996,高力,6,2,4,亞東-新竹,2023-05-19,2184
00900,富邦特選高股息30,3,0,3,亞東-新竹,2023-05-19,2184
00795B,中信美國公債20年,3,0,3,亞東-新竹,2023-05-19,2184
1524,耿鼎,3,0,3,亞東-新竹,2023-05-19,2184
2427,三商電,3,0,3,亞東-新竹,2023-05-19,2184
3322,建舜電,5,2,3,亞東-新竹,2023-05-19,2184
4744,皇將,3,0,3,亞東-新竹,2023-05-19,2184
00632R,元大台灣50反1,356,0,356,亞東-新竹,2023-05-22,2184
00919,群益台灣精選高息,100,0,100,亞東-新竹,2023-05-22,2184
00751B,元大AAA至A公司債,80,0,80,亞東-新竹,2023-05-22,2184
5425,台半,68,0,68,亞東-新竹,2023-05-22,2184
2303,聯電,52,0,52,亞東-新竹,2023-05-22,2184
3032,偉訓,47,0,47,亞東-新竹,2023-05-22,2184
6282,康舒,49,6,43,亞東-新竹,2023-05-22,2184
8222,寶一,40,2,38,亞東-新竹,2023-05-22,2184
1514,亞力,39,4,35,亞東-新竹,2023-05-22,2184
2610,華航,31,2,29,亞東-新竹,2023-05-22,2184
00888,永豐台灣ESG,21,0,21,亞東-新竹,2023-05-22,2184
6509,聚和,21,0,21,亞東-新竹,2023-05-22,2184
2701,萬企,20,0,20,亞東-新竹,2023-05-22,2184
3380,明泰,20,0,20,亞東-新竹,2023-05-22,2184
1618,合機,20,2,18,亞東-新竹,2023-05-22,2184
6234,高僑,12,0,12,亞東-新竹,2023-05-22,2184
00882,中信中國高股息,11,0,11,亞東-新竹,2023-05-22,2184
1605,華新,12,1,11,亞東-新竹,2023-05-22,2184
1616,億泰,10,0,10,亞東-新竹,2023-05-22,2184
00687B,國泰20年美債,10,0,10,亞東-新竹,2023-05-22,2184
2352,佳世達,14,4,10,亞東-新竹,2023-05-22,2184
2887,台新金,10,0,10,亞東-新竹,2023-05-22,2184
3522,御嵿,9,0,9,亞東-新竹,2023-05-22,2184
3540,曜越,7,0,7,亞東-新竹,2023-05-22,2184
2313,華通,6,0,6,亞東-新竹,2023-05-22,2184
3035,智原,6,0,6,亞東-新竹,2023-05-22,2184
00795B,中信美國公債20年,5,0,5,亞東-新竹,2023-05-22,2184
00642U,期元大S＆P石油,5,0,5,亞東-新竹,2023-05-22,2184
00712,復華富時不動產,5,0,5,亞東-新竹,2023-05-22,2184
1437,勤益控,5,0,5,亞東-新竹,2023-05-22,2184
3322,建舜電,5,0,5,亞東-新竹,2023-05-22,2184
2317,鴻海,4,0,4,亞東-新竹,2023-05-22,2184
1529,樂事綠能,22,18,4,亞東-新竹,2023-05-22,2184
00679B,元大美債20年,4,0,4,亞東-新竹,2023-05-22,2184
3071,協禧,4,0,4,亞東-新竹,2023-05-22,2184
00772B,中信高評級公司債,5,2,3,亞東-新竹,2023-05-22,2184
00725B,國泰投資級公司債,3,0,3,亞東-新竹,2023-05-22,2184
1539,巨庭,3,0,3,亞東-新竹,2023-05-22,2184
4919,新唐,4,1,3,亞東-新竹,2023-05-22,2184
5284,jpp-KY,3,0,3,亞東-新竹,2023-05-22,2184
2609,陽明,5,2,3,亞東-新竹,2023-05-22,2184
3661,世芯-KY,4,1,3,亞東-新竹,2023-05-22,2184
2884,玉山金,3,1,2,亞東-新竹,2023-05-22,2184
1533,車王電,2,0,2,亞東-新竹,2023-05-22,2184
0056,元大高股息,2,0,2,亞東-新竹,2023-05-22,2184
1760,寶齡富錦,2,0,2,亞東-新竹,2023-05-22,2184
2356,英業達,2,0,2,亞東-新竹,2023-05-22,2184
2745,五福,2,0,2,亞東-新竹,2023-05-22,2184
3030,德律,2,0,2,亞東-新竹,2023-05-22,2184
3044,健鼎,2,0,2,亞東-新竹,2023-05-22,2184
2618,長榮航,132,26,106,亞東-新竹,2023-05-23,2184
00919,群益台灣精選高息,100,0,100,亞東-新竹,2023-05-23,2184
3322,建舜電,40,4,36,亞東-新竹,2023-05-23,2184
6547,高端疫苗,31,1,30,亞東-新竹,2023-05-23,2184
00679B,元大美債20年,115,92,23,亞東-新竹,2023-05-23,2184
1459,聯發,22,0,22,亞東-新竹,2023-05-23,2184
00665L,富邦�琤肭磪囓�2,20,0,20,亞東-新竹,2023-05-23,2184
1616,億泰,20,0,20,亞東-新竹,2023-05-23,2184
2601,益航,20,0,20,亞東-新竹,2023-05-23,2184
00632R,元大台灣50反1,19,0,19,亞東-新竹,2023-05-23,2184
2634,漢翔,22,3,19,亞東-新竹,2023-05-23,2184
3339,泰谷,16,0,16,亞東-新竹,2023-05-23,2184
4763,材料-KY,16,0,16,亞東-新竹,2023-05-23,2184
3481,群創,11,0,11,亞東-新竹,2023-05-23,2184
3694,海華,21,10,11,亞東-新竹,2023-05-23,2184
2323,中環,10,0,10,亞東-新竹,2023-05-23,2184
2363,矽統,10,0,10,亞東-新竹,2023-05-23,2184
2882,國泰金,10,0,10,亞東-新竹,2023-05-23,2184
3052,夆典,10,0,10,亞東-新竹,2023-05-23,2184
4908,前鼎,10,0,10,亞東-新竹,2023-05-23,2184
5511,德昌,10,0,10,亞東-新竹,2023-05-23,2184
3231,緯創,19,9,10,亞東-新竹,2023-05-23,2184
1762,中化生,10,1,9,亞東-新竹,2023-05-23,2184
3591,艾笛森,13,4,9,亞東-新竹,2023-05-23,2184
6235,華孚,14,5,9,亞東-新竹,2023-05-23,2184
6138,茂達,10,1,9,亞東-新竹,2023-05-23,2184
2409,友達,8,0,8,亞東-新竹,2023-05-23,2184
00687B,國泰20年美債,7,0,7,亞東-新竹,2023-05-23,2184
00795B,中信美國公債20年,7,0,7,亞東-新竹,2023-05-23,2184
3325,旭品,6,0,6,亞東-新竹,2023-05-23,2184
3504,揚明光,6,0,6,亞東-新竹,2023-05-23,2184
9904,寶成,6,0,6,亞東-新竹,2023-05-23,2184
1605,華新,5,0,5,亞東-新竹,2023-05-23,2184
2603,長榮,7,2,5,亞東-新竹,2023-05-23,2184
00903,富邦元宇宙,5,0,5,亞東-新竹,2023-05-23,2184
1316,上曜,5,0,5,亞東-新竹,2023-05-23,2184
2204,中華,10,5,5,亞東-新竹,2023-05-23,2184
3036,文曄,5,0,5,亞東-新竹,2023-05-23,2184
3540,曜越,7,2,5,亞東-新竹,2023-05-23,2184
5227,立凱-KY,5,0,5,亞東-新竹,2023-05-23,2184
8478,東哥遊艇,5,0,5,亞東-新竹,2023-05-23,2184
5425,台半,5,0,5,亞東-新竹,2023-05-23,2184
2201,裕隆,38,34,4,亞東-新竹,2023-05-23,2184
4153,鈺緯,4,0,4,亞東-新竹,2023-05-23,2184
6197,佳必琪,6,2,4,亞東-新竹,2023-05-23,2184
6203,海韻電,4,0,4,亞東-新竹,2023-05-23,2184
6697,東捷資訊,5,1,4,亞東-新竹,2023-05-23,2184
1785,光洋科,3,0,3,亞東-新竹,2023-05-23,2184
2610,華航,39,36,3,亞東-新竹,2023-05-23,2184
3202,樺晟,3,0,3,亞東-新竹,2023-05-23,2184
00687B,國泰20年美債,113,0,113,亞東-新竹,2023-05-24,2184
00632R,元大台灣50反1,35,5,30,亞東-新竹,2023-05-24,2184
00878,國泰永續高股息,30,2,28,亞東-新竹,2023-05-24,2184
00761B,國泰A級公司債,20,0,20,亞東-新竹,2023-05-24,2184
1616,億泰,20,0,20,亞東-新竹,2023-05-24,2184
6235,華孚,21,1,20,亞東-新竹,2023-05-24,2184
6288,聯嘉,20,0,20,亞東-新竹,2023-05-24,2184
00751B,元大AAA至A公司債,17,0,17,亞東-新竹,2023-05-24,2184
6733,博晟生醫,16,0,16,亞東-新竹,2023-05-24,2184
00882,中信中國高股息,14,0,14,亞東-新竹,2023-05-24,2184
6535,順藥,14,0,14,亞東-新竹,2023-05-24,2184
6547,高端疫苗,10,0,10,亞東-新竹,2023-05-24,2184
00665L,富邦�琤肭磪囓�2,10,0,10,亞東-新竹,2023-05-24,2184
2382,廣達,10,0,10,亞東-新竹,2023-05-24,2184
2457,飛宏,38,28,10,亞東-新竹,2023-05-24,2184
3287,廣寰科,20,10,10,亞東-新竹,2023-05-24,2184
3035,智原,8,0,8,亞東-新竹,2023-05-24,2184
3545,敦泰,10,2,8,亞東-新竹,2023-05-24,2184
2450,神腦,7,0,7,亞東-新竹,2023-05-24,2184
2634,漢翔,8,1,7,亞東-新竹,2023-05-24,2184
3522,御嵿,7,0,7,亞東-新竹,2023-05-24,2184
2206,三陽工業,6,0,6,亞東-新竹,2023-05-24,2184
2399,映泰,10,4,6,亞東-新竹,2023-05-24,2184
3419,譁裕,26,20,6,亞東-新竹,2023-05-24,2184
1584,精剛,5,0,5,亞東-新竹,2023-05-24,2184
00753L,中信中國50正2,5,0,5,亞東-新竹,2023-05-24,2184
00633L,富邦上証正2,30,25,5,亞東-新竹,2023-05-24,2184
00712,復華富時不動產,5,0,5,亞東-新竹,2023-05-24,2184
1907,永豐餘,6,1,5,亞東-新竹,2023-05-24,2184
3058,立德,5,0,5,亞東-新竹,2023-05-24,2184
3702,大聯大,5,0,5,亞東-新竹,2023-05-24,2184
9904,寶成,5,0,5,亞東-新竹,2023-05-24,2184
00675L,富邦臺灣加權正2,4,0,4,亞東-新竹,2023-05-24,2184
0056,元大高股息,7,3,4,亞東-新竹,2023-05-24,2184
00795B,中信美國公債20年,4,0,4,亞東-新竹,2023-05-24,2184
2314,台揚,4,0,4,亞東-新竹,2023-05-24,2184
4306,炎洲,4,0,4,亞東-新竹,2023-05-24,2184
6596,寬宏藝術,4,0,4,亞東-新竹,2023-05-24,2184
6753,龍德造船,4,0,4,亞東-新竹,2023-05-24,2184
5871,中租-KY,3,0,3,亞東-新竹,2023-05-24,2184
1514,亞力,3,0,3,亞東-新竹,2023-05-24,2184
00853B,統一美債10年Aa-,3,0,3,亞東-新竹,2023-05-24,2184
00720B,元大投資級公司債,3,0,3,亞東-新竹,2023-05-24,2184
2630,亞航,4,1,3,亞東-新竹,2023-05-24,2184
2890,永豐金,3,0,3,亞東-新竹,2023-05-24,2184
3046,建��,5,2,3,亞東-新竹,2023-05-24,2184
3715,定穎投控,3,0,3,亞東-新竹,2023-05-24,2184
6233,旺玖,3,0,3,亞東-新竹,2023-05-24,2184
6271,同欣電,3,0,3,亞東-新竹,2023-05-24,2184
9941,裕融,3,0,3,亞東-新竹,2023-05-24,2184
00632R,元大台灣50反1,190,0,190,亞東-新竹,2023-05-25,2184
2885,元大金,100,0,100,亞東-新竹,2023-05-25,2184
00679B,元大美債20年,63,6,57,亞東-新竹,2023-05-25,2184
00882,中信中國高股息,45,0,45,亞東-新竹,2023-05-25,2184
6235,華孚,43,10,33,亞東-新竹,2023-05-25,2184
00751B,元大AAA至A公司債,27,0,27,亞東-新竹,2023-05-25,2184
6125,廣運,35,8,27,亞東-新竹,2023-05-25,2184
2402,毅嘉,26,0,26,亞東-新竹,2023-05-25,2184
2450,神腦,23,0,23,亞東-新竹,2023-05-25,2184
5864,致和證,23,0,23,亞東-新竹,2023-05-25,2184
1402,遠東新,22,0,22,亞東-新竹,2023-05-25,2184
1762,中化生,22,0,22,亞東-新竹,2023-05-25,2184
5531,鄉林,22,0,22,亞東-新竹,2023-05-25,2184
00722B,群益投資級電信債,20,0,20,亞東-新竹,2023-05-25,2184
00720B,元大投資級公司債,20,0,20,亞東-新竹,2023-05-25,2184
1616,億泰,20,0,20,亞東-新竹,2023-05-25,2184
2489,瑞軒,20,0,20,亞東-新竹,2023-05-25,2184
6770,力積電,17,0,17,亞東-新竹,2023-05-25,2184
2317,鴻海,16,0,16,亞東-新竹,2023-05-25,2184
00753L,中信中國50正2,14,0,14,亞東-新竹,2023-05-25,2184
6547,高端疫苗,14,0,14,亞東-新竹,2023-05-25,2184
2303,聯電,31,19,12,亞東-新竹,2023-05-25,2184
3046,建��,16,4,12,亞東-新竹,2023-05-25,2184
2637,慧洋-KY,11,0,11,亞東-新竹,2023-05-25,2184
3706,神達,11,0,11,亞東-新竹,2023-05-25,2184
2349,錸德,10,0,10,亞東-新竹,2023-05-25,2184
2901,欣欣,10,0,10,亞東-新竹,2023-05-25,2184
2206,三陽工業,12,3,9,亞東-新竹,2023-05-25,2184
2371,大同,10,1,9,亞東-新竹,2023-05-25,2184
6188,廣明,10,1,9,亞東-新竹,2023-05-25,2184
5871,中租-KY,10,2,8,亞東-新竹,2023-05-25,2184
1608,華榮,8,0,8,亞東-新竹,2023-05-25,2184
2201,裕隆,23,15,8,亞東-新竹,2023-05-25,2184
00712,復華富時不動產,6,0,6,亞東-新竹,2023-05-25,2184
2601,益航,6,0,6,亞東-新竹,2023-05-25,2184
2610,華航,11,5,6,亞東-新竹,2023-05-25,2184
00637L,元大滬深300正2,6,1,5,亞東-新竹,2023-05-25,2184
1589,永冠-KY,6,1,5,亞東-新竹,2023-05-25,2184
1539,巨庭,5,0,5,亞東-新竹,2023-05-25,2184
1525,江申,5,0,5,亞東-新竹,2023-05-25,2184
2328,廣宇,5,0,5,亞東-新竹,2023-05-25,2184
2603,長榮,5,0,5,亞東-新竹,2023-05-25,2184
2882,國泰金,11,6,5,亞東-新竹,2023-05-25,2184
2913,農林,5,0,5,亞東-新竹,2023-05-25,2184
3363,上詮,10,5,5,亞東-新竹,2023-05-25,2184
4906,正文,5,0,5,亞東-新竹,2023-05-25,2184
6112,邁達特,6,1,5,亞東-新竹,2023-05-25,2184
8121,越峰,5,0,5,亞東-新竹,2023-05-25,2184
1513,中興電,6,2,4,亞東-新竹,2023-05-25,2184
1101,台泥,4,0,4,亞東-新竹,2023-05-25,2184
00712,復華富時不動產,117,0,117,亞東-新竹,2023-05-26,2184
00637L,元大滬深300正2,53,0,53,亞東-新竹,2023-05-26,2184
1416,廣豐,45,0,45,亞東-新竹,2023-05-26,2184
00632R,元大台灣50反1,45,2,43,亞東-新竹,2023-05-26,2184
00679B,元大美債20年,36,2,34,亞東-新竹,2023-05-26,2184
2610,華航,32,4,28,亞東-新竹,2023-05-26,2184
2317,鴻海,27,0,27,亞東-新竹,2023-05-26,2184
2888,新光金,25,0,25,亞東-新竹,2023-05-26,2184
1785,光洋科,23,0,23,亞東-新竹,2023-05-26,2184
2402,毅嘉,21,0,21,亞東-新竹,2023-05-26,2184
6163,華電網,21,0,21,亞東-新竹,2023-05-26,2184
00882,中信中國高股息,20,0,20,亞東-新竹,2023-05-26,2184
00642U,期元大S＆P石油,20,0,20,亞東-新竹,2023-05-26,2184
3481,群創,20,0,20,亞東-新竹,2023-05-26,2184
6547,高端疫苗,20,0,20,亞東-新竹,2023-05-26,2184
1560,中砂,19,0,19,亞東-新竹,2023-05-26,2184
6125,廣運,20,2,18,亞東-新竹,2023-05-26,2184
5469,瀚宇博,16,0,16,亞東-新竹,2023-05-26,2184
00751B,元大AAA至A公司債,15,0,15,亞東-新竹,2023-05-26,2184
2489,瑞軒,15,0,15,亞東-新竹,2023-05-26,2184
2637,慧洋-KY,15,0,15,亞東-新竹,2023-05-26,2184
3324,雙鴻,16,1,15,亞東-新竹,2023-05-26,2184
00895,富邦未來車,13,0,13,亞東-新竹,2023-05-26,2184
1711,永光,12,0,12,亞東-新竹,2023-05-26,2184
1316,上曜,10,0,10,亞東-新竹,2023-05-26,2184
00885,富邦越南,10,0,10,亞東-新竹,2023-05-26,2184
0056,元大高股息,11,1,10,亞東-新竹,2023-05-26,2184
3545,敦泰,10,0,10,亞東-新竹,2023-05-26,2184
5706,鳳凰,34,24,10,亞東-新竹,2023-05-26,2184
6150,撼訊,12,2,10,亞東-新竹,2023-05-26,2184
00720B,元大投資級公司債,9,0,9,亞東-新竹,2023-05-26,2184
3231,緯創,43,35,8,亞東-新竹,2023-05-26,2184
00878,國泰永續高股息,8,0,8,亞東-新竹,2023-05-26,2184
2201,裕隆,20,12,8,亞東-新竹,2023-05-26,2184
5512,力麒,8,0,8,亞東-新竹,2023-05-26,2184
8478,東哥遊艇,7,0,7,亞東-新竹,2023-05-26,2184
00713,元大台灣高息低波,7,0,7,亞東-新竹,2023-05-26,2184
2468,華經,7,0,7,亞東-新竹,2023-05-26,2184
2736,富野,51,44,7,亞東-新竹,2023-05-26,2184
3046,建��,14,7,7,亞東-新竹,2023-05-26,2184
3646,艾恩特,9,2,7,亞東-新竹,2023-05-26,2184
4979,華星光,13,6,7,亞東-新竹,2023-05-26,2184
2388,威盛,11,5,6,亞東-新竹,2023-05-26,2184
2409,友達,6,0,6,亞東-新竹,2023-05-26,2184
6126,信音,6,0,6,亞東-新竹,2023-05-26,2184
1720,生達,5,0,5,亞東-新竹,2023-05-26,2184
1721,三晃,5,0,5,亞東-新竹,2023-05-26,2184
2344,華邦電,5,0,5,亞東-新竹,2023-05-26,2184
2548,華固,5,0,5,亞東-新竹,2023-05-26,2184
3540,曜越,6,1,5,亞東-新竹,2023-05-26,2184
2883,凱基金,205,0,205,亞東-新竹,2023-05-29,2184
00751B,元大AAA至A公司債,50,0,50,亞東-新竹,2023-05-29,2184
6016,康和證,40,0,40,亞東-新竹,2023-05-29,2184
1762,中化生,30,0,30,亞東-新竹,2023-05-29,2184
2610,華航,71,43,28,亞東-新竹,2023-05-29,2184
2314,台揚,24,0,24,亞東-新竹,2023-05-29,2184
6592,和潤企業,21,0,21,亞東-新竹,2023-05-29,2184
6191,精成科,20,0,20,亞東-新竹,2023-05-29,2184
2344,華邦電,21,2,19,亞東-新竹,2023-05-29,2184
2495,普安,18,0,18,亞東-新竹,2023-05-29,2184
2618,長榮航,35,18,17,亞東-新竹,2023-05-29,2184
00878,國泰永續高股息,16,1,15,亞東-新竹,2023-05-29,2184
3287,廣寰科,13,0,13,亞東-新竹,2023-05-29,2184
5263,智崴,13,0,13,亞東-新竹,2023-05-29,2184
00882,中信中國高股息,12,0,12,亞東-新竹,2023-05-29,2184
2442,新美齊,11,0,11,亞東-新竹,2023-05-29,2184
00680L,元大美債20正2,10,0,10,亞東-新竹,2023-05-29,2184
1785,光洋科,10,0,10,亞東-新竹,2023-05-29,2184
3504,揚明光,10,0,10,亞東-新竹,2023-05-29,2184
3707,漢磊,11,1,10,亞東-新竹,2023-05-29,2184
5706,鳳凰,14,4,10,亞東-新竹,2023-05-29,2184
00687B,國泰20年美債,15,6,9,亞東-新竹,2023-05-29,2184
3325,旭品,9,0,9,亞東-新竹,2023-05-29,2184
5328,華容,10,1,9,亞東-新竹,2023-05-29,2184
1101,台泥,8,0,8,亞東-新竹,2023-05-29,2184
8996,高力,12,4,8,亞東-新竹,2023-05-29,2184
00795B,中信美國公債20年,7,0,7,亞東-新竹,2023-05-29,2184
1459,聯發,7,0,7,亞東-新竹,2023-05-29,2184
2324,仁寶,12,5,7,亞東-新竹,2023-05-29,2184
4102,永日,7,0,7,亞東-新竹,2023-05-29,2184
5512,力麒,7,0,7,亞東-新竹,2023-05-29,2184
2382,廣達,8,1,7,亞東-新竹,2023-05-29,2184
2845,遠東銀,6,0,6,亞東-新竹,2023-05-29,2184
8088,品安,6,0,6,亞東-新竹,2023-05-29,2184
1452,宏益,5,0,5,亞東-新竹,2023-05-29,2184
00712,復華富時不動產,5,0,5,亞東-新竹,2023-05-29,2184
1718,中纖,5,0,5,亞東-新竹,2023-05-29,2184
2342,茂矽,5,0,5,亞東-新竹,2023-05-29,2184
4908,前鼎,5,0,5,亞東-新竹,2023-05-29,2184
5464,霖宏,5,0,5,亞東-新竹,2023-05-29,2184
8927,北基,5,0,5,亞東-新竹,2023-05-29,2184
0050,元大台灣50,5,0,5,亞東-新竹,2023-05-29,2184
2002,中鋼,6,2,4,亞東-新竹,2023-05-29,2184
2486,一詮,5,1,4,亞東-新竹,2023-05-29,2184
2736,富野,11,7,4,亞東-新竹,2023-05-29,2184
4114,健喬,4,0,4,亞東-新竹,2023-05-29,2184
6550,北極星藥業-KY,4,0,4,亞東-新竹,2023-05-29,2184
8110,華東,4,0,4,亞東-新竹,2023-05-29,2184
3706,神達,6,2,4,亞東-新竹,2023-05-29,2184
5871,中租-KY,8,5,3,亞東-新竹,2023-05-29,2184
2883,凱基金,114,0,114,亞東-新竹,2023-05-30,2184
3363,上詮,105,15,90,亞東-新竹,2023-05-30,2184
00919,群益台灣精選高息,53,0,53,亞東-新竹,2023-05-30,2184
020034,元大IC設計N,50,0,50,亞東-新竹,2023-05-30,2184
00918,大華優利高填息30,41,0,41,亞東-新竹,2023-05-30,2184
3704,合勤控,35,3,32,亞東-新竹,2023-05-30,2184
4938,和碩,26,0,26,亞東-新竹,2023-05-30,2184
2637,慧洋-KY,21,0,21,亞東-新竹,2023-05-30,2184
00665L,富邦�琤肭磪囓�2,20,0,20,亞東-新竹,2023-05-30,2184
3013,晟銘電,26,6,20,亞東-新竹,2023-05-30,2184
3545,敦泰,20,0,20,亞東-新竹,2023-05-30,2184
6547,高端疫苗,20,0,20,亞東-新竹,2023-05-30,2184
00878,國泰永續高股息,20,3,17,亞東-新竹,2023-05-30,2184
00882,中信中國高股息,17,1,16,亞東-新竹,2023-05-30,2184
2356,英業達,34,18,16,亞東-新竹,2023-05-30,2184
2442,新美齊,16,0,16,亞東-新竹,2023-05-30,2184
00680L,元大美債20正2,15,0,15,亞東-新竹,2023-05-30,2184
00633L,富邦上証正2,20,8,12,亞東-新竹,2023-05-30,2184
2468,華經,12,0,12,亞東-新竹,2023-05-30,2184
6138,茂達,11,0,11,亞東-新竹,2023-05-30,2184
2882,國泰金,12,1,11,亞東-新竹,2023-05-30,2184
3518,柏騰,16,5,11,亞東-新竹,2023-05-30,2184
4113,聯上,11,0,11,亞東-新竹,2023-05-30,2184
2603,長榮,14,3,11,亞東-新竹,2023-05-30,2184
00637L,元大滬深300正2,20,10,10,亞東-新竹,2023-05-30,2184
2363,矽統,10,0,10,亞東-新竹,2023-05-30,2184
6024,群益期,10,0,10,亞東-新竹,2023-05-30,2184
2409,友達,9,0,9,亞東-新竹,2023-05-30,2184
00719B,元大美債1-3,8,0,8,亞東-新竹,2023-05-30,2184
2634,漢翔,12,4,8,亞東-新竹,2023-05-30,2184
3231,緯創,71,63,8,亞東-新竹,2023-05-30,2184
4102,永日,9,1,8,亞東-新竹,2023-05-30,2184
6535,順藥,8,0,8,亞東-新竹,2023-05-30,2184
6767,台微醫,8,0,8,亞東-新竹,2023-05-30,2184
3046,建��,9,2,7,亞東-新竹,2023-05-30,2184
3252,海灣,7,0,7,亞東-新竹,2023-05-30,2184
6703,軒郁,7,0,7,亞東-新竹,2023-05-30,2184
1459,聯發,6,0,6,亞東-新竹,2023-05-30,2184
1720,生達,6,0,6,亞東-新竹,2023-05-30,2184
2206,三陽工業,12,6,6,亞東-新竹,2023-05-30,2184
2401,凌陽,12,6,6,亞東-新竹,2023-05-30,2184
3522,御嵿,6,0,6,亞東-新竹,2023-05-30,2184
6806,森崴能源,6,0,6,亞東-新竹,2023-05-30,2184
3035,智原,6,1,5,亞東-新竹,2023-05-30,2184
1326,台化,5,0,5,亞東-新竹,2023-05-30,2184
2002,中鋼,5,0,5,亞東-新竹,2023-05-30,2184
2913,農林,5,0,5,亞東-新竹,2023-05-30,2184
6125,廣運,5,0,5,亞東-新竹,2023-05-30,2184
6874,倍力,5,0,5,亞東-新竹,2023-05-30,2184
00900,富邦特選高股息30,7,3,4,亞東-新竹,2023-05-30,2184
00642U,期元大S＆P石油,225,0,225,亞東-新竹,2023-05-31,2184
00715L,期街口布蘭特正2,130,0,130,亞東-新竹,2023-05-31,2184
00919,群益台灣精選高息,50,0,50,亞東-新竹,2023-05-31,2184
020034,元大IC設計N,50,0,50,亞東-新竹,2023-05-31,2184
5425,台半,40,0,40,亞東-新竹,2023-05-31,2184
3231,緯創,70,45,25,亞東-新竹,2023-05-31,2184
00675L,富邦臺灣加權正2,25,0,25,亞東-新竹,2023-05-31,2184
00713,元大台灣高息低波,23,0,23,亞東-新竹,2023-05-31,2184
00882,中信中國高股息,21,0,21,亞東-新竹,2023-05-31,2184
3051,力特,30,10,20,亞東-新竹,2023-05-31,2184
8996,高力,21,1,20,亞東-新竹,2023-05-31,2184
2637,慧洋-KY,16,0,16,亞東-新竹,2023-05-31,2184
3625,西勝,13,0,13,亞東-新竹,2023-05-31,2184
2356,英業達,12,1,11,亞東-新竹,2023-05-31,2184
1459,聯發,10,0,10,亞東-新竹,2023-05-31,2184
0056,元大高股息,11,1,10,亞東-新竹,2023-05-31,2184
2883,凱基金,110,100,10,亞東-新竹,2023-05-31,2184
3576,聯合再生,10,0,10,亞東-新竹,2023-05-31,2184
4747,強生,29,19,10,亞東-新竹,2023-05-31,2184
5353,台林,10,0,10,亞東-新竹,2023-05-31,2184
6231,系微,10,0,10,亞東-新竹,2023-05-31,2184
00712,復華富時不動產,10,1,9,亞東-新竹,2023-05-31,2184
00720B,元大投資級公司債,8,0,8,亞東-新竹,2023-05-31,2184
3545,敦泰,10,2,8,亞東-新竹,2023-05-31,2184
5011,久陽,7,0,7,亞東-新竹,2023-05-31,2184
4977,眾達-KY,7,1,6,亞東-新竹,2023-05-31,2184
00637L,元大滬深300正2,6,0,6,亞東-新竹,2023-05-31,2184
2886,兆豐金,6,0,6,亞東-新竹,2023-05-31,2184
6770,力積電,11,5,6,亞東-新竹,2023-05-31,2184
6282,康舒,8,3,5,亞東-新竹,2023-05-31,2184
1539,巨庭,5,0,5,亞東-新竹,2023-05-31,2184
1515,力山,5,0,5,亞東-新竹,2023-05-31,2184
2006,東和鋼鐵,5,0,5,亞東-新竹,2023-05-31,2184
2408,南亞科,5,0,5,亞東-新竹,2023-05-31,2184
3287,廣寰科,5,0,5,亞東-新竹,2023-05-31,2184
6451,訊芯-KY,5,0,5,亞東-新竹,2023-05-31,2184
6486,互動,5,0,5,亞東-新竹,2023-05-31,2184
6515,穎崴,5,0,5,亞東-新竹,2023-05-31,2184
6547,高端疫苗,5,0,5,亞東-新竹,2023-05-31,2184
9904,寶成,5,0,5,亞東-新竹,2023-05-31,2184
4906,正文,5,0,5,亞東-新竹,2023-05-31,2184
00633L,富邦上証正2,32,28,4,亞東-新竹,2023-05-31,2184
2382,廣達,9,5,4,亞東-新竹,2023-05-31,2184
3504,揚明光,4,0,4,亞東-新竹,2023-05-31,2184
3694,海華,14,10,4,亞東-新竹,2023-05-31,2184
6550,北極星藥業-KY,5,1,4,亞東-新竹,2023-05-31,2184
6683,雍智科技,4,0,4,亞東-新竹,2023-05-31,2184
8147,正淩,4,0,4,亞東-新竹,2023-05-31,2184
2330,台積電,6,2,4,亞東-新竹,2023-05-31,2184
1219,福壽,3,0,3,亞東-新竹,2023-05-31,2184
2883,凱基金,200,10,190,亞東-新竹,2023-06-01,2184
6163,華電網,170,0,170,亞東-新竹,2023-06-01,2184
00665L,富邦�琤肭磪囓�2,100,17,83,亞東-新竹,2023-06-01,2184
00637L,元大滬深300正2,67,3,64,亞東-新竹,2023-06-01,2184
00878,國泰永續高股息,53,2,51,亞東-新竹,2023-06-01,2184
4973,廣穎,40,0,40,亞東-新竹,2023-06-01,2184
2489,瑞軒,40,3,37,亞東-新竹,2023-06-01,2184
1402,遠東新,33,0,33,亞東-新竹,2023-06-01,2184
00632R,元大台灣50反1,30,0,30,亞東-新竹,2023-06-01,2184
2610,華航,115,87,28,亞東-新竹,2023-06-01,2184
2449,京元電子,26,5,21,亞東-新竹,2023-06-01,2184
3703,欣陸,21,0,21,亞東-新竹,2023-06-01,2184
00715L,期街口布蘭特正2,20,0,20,亞東-新竹,2023-06-01,2184
2637,慧洋-KY,20,0,20,亞東-新竹,2023-06-01,2184
00919,群益台灣精選高息,18,0,18,亞東-新竹,2023-06-01,2184
3163,波若威,25,9,16,亞東-新竹,2023-06-01,2184
2206,三陽工業,15,1,14,亞東-新竹,2023-06-01,2184
2303,聯電,24,10,14,亞東-新竹,2023-06-01,2184
5425,台半,12,1,11,亞東-新竹,2023-06-01,2184
4977,眾達-KY,10,0,10,亞東-新竹,2023-06-01,2184
2882,國泰金,10,0,10,亞東-新竹,2023-06-01,2184
00679B,元大美債20年,10,0,10,亞東-新竹,2023-06-01,2184
3481,群創,10,0,10,亞東-新竹,2023-06-01,2184
4533,協易機,10,0,10,亞東-新竹,2023-06-01,2184
1539,巨庭,8,0,8,亞東-新竹,2023-06-01,2184
00751B,元大AAA至A公司債,8,0,8,亞東-新竹,2023-06-01,2184
2352,佳世達,8,0,8,亞東-新竹,2023-06-01,2184
6733,博晟生醫,9,1,8,亞東-新竹,2023-06-01,2184
00890B,凱基ESG BBB債,7,0,7,亞東-新竹,2023-06-01,2184
6535,順藥,7,0,7,亞東-新竹,2023-06-01,2184
00918,大華優利高填息30,6,0,6,亞東-新竹,2023-06-01,2184
2468,華經,8,2,6,亞東-新竹,2023-06-01,2184
3037,欣興,7,1,6,亞東-新竹,2023-06-01,2184
0056,元大高股息,5,0,5,亞東-新竹,2023-06-01,2184
00642U,期元大S＆P石油,5,0,5,亞東-新竹,2023-06-01,2184
00687B,國泰20年美債,6,1,5,亞東-新竹,2023-06-01,2184
00680L,元大美債20正2,5,0,5,亞東-新竹,2023-06-01,2184
1907,永豐餘,5,0,5,亞東-新竹,2023-06-01,2184
6231,系微,5,0,5,亞東-新竹,2023-06-01,2184
6547,高端疫苗,5,0,5,亞東-新竹,2023-06-01,2184
2356,英業達,9,4,5,亞東-新竹,2023-06-01,2184
00706L,期元大S＆P日圓正2,4,0,4,亞東-新竹,2023-06-01,2184
1609,大亞,5,1,4,亞東-新竹,2023-06-01,2184
2337,旺宏,4,0,4,亞東-新竹,2023-06-01,2184
2388,威盛,8,4,4,亞東-新竹,2023-06-01,2184
3252,海灣,16,12,4,亞東-新竹,2023-06-01,2184
3264,欣銓,4,0,4,亞東-新竹,2023-06-01,2184
6185,幃翔,4,0,4,亞東-新竹,2023-06-01,2184
6188,廣明,24,20,4,亞東-新竹,2023-06-01,2184
6821,聯寶,4,0,4,亞東-新竹,2023-06-01,2184
2371,大同,106,1,105,亞東-新竹,2023-06-02,2184
2323,中環,43,0,43,亞東-新竹,2023-06-02,2184
00919,群益台灣精選高息,34,0,34,亞東-新竹,2023-06-02,2184
5498,凱崴,33,0,33,亞東-新竹,2023-06-02,2184
00632R,元大台灣50反1,42,15,27,亞東-新竹,2023-06-02,2184
5425,台半,23,0,23,亞東-新竹,2023-06-02,2184
2393,億光,20,0,20,亞東-新竹,2023-06-02,2184
2481,強茂,25,5,20,亞東-新竹,2023-06-02,2184
4105,東洋,20,0,20,亞東-新竹,2023-06-02,2184
2376,技嘉,22,2,20,亞東-新竹,2023-06-02,2184
3306,鼎天,24,6,18,亞東-新竹,2023-06-02,2184
6235,華孚,20,2,18,亞東-新竹,2023-06-02,2184
6509,聚和,14,0,14,亞東-新竹,2023-06-02,2184
8996,高力,16,3,13,亞東-新竹,2023-06-02,2184
6531,愛普*,11,1,10,亞東-新竹,2023-06-02,2184
00665L,富邦�琤肭磪囓�2,120,110,10,亞東-新竹,2023-06-02,2184
1605,華新,10,0,10,亞東-新竹,2023-06-02,2184
2486,一詮,10,0,10,亞東-新竹,2023-06-02,2184
8935,邦泰,10,0,10,亞東-新竹,2023-06-02,2184
00712,復華富時不動產,10,1,9,亞東-新竹,2023-06-02,2184
3058,立德,10,1,9,亞東-新竹,2023-06-02,2184
5469,瀚宇博,9,0,9,亞東-新竹,2023-06-02,2184
3231,緯創,94,86,8,亞東-新竹,2023-06-02,2184
4763,材料-KY,12,4,8,亞東-新竹,2023-06-02,2184
00878,國泰永續高股息,37,29,8,亞東-新竹,2023-06-02,2184
00715L,期街口布蘭特正2,8,0,8,亞東-新竹,2023-06-02,2184
6547,高端疫苗,8,0,8,亞東-新竹,2023-06-02,2184
6712,長聖,8,0,8,亞東-新竹,2023-06-02,2184
1459,聯發,7,0,7,亞東-新竹,2023-06-02,2184
5009,榮剛,15,8,7,亞東-新竹,2023-06-02,2184
1513,中興電,12,5,7,亞東-新竹,2023-06-02,2184
00882,中信中國高股息,11,5,6,亞東-新竹,2023-06-02,2184
1324,地球,6,0,6,亞東-新竹,2023-06-02,2184
1539,巨庭,6,0,6,亞東-新竹,2023-06-02,2184
6733,博晟生醫,6,0,6,亞東-新竹,2023-06-02,2184
8069,元太,7,1,6,亞東-新竹,2023-06-02,2184
1533,車王電,5,0,5,亞東-新竹,2023-06-02,2184
1717,長興,5,0,5,亞東-新竹,2023-06-02,2184
5011,久陽,5,0,5,亞東-新竹,2023-06-02,2184
5483,中美晶,5,0,5,亞東-新竹,2023-06-02,2184
00675L,富邦臺灣加權正2,4,0,4,亞東-新竹,2023-06-02,2184
1734,杏輝,5,1,4,亞東-新竹,2023-06-02,2184
2641,正德,5,1,4,亞東-新竹,2023-06-02,2184
4111,濟生,4,0,4,亞東-新竹,2023-06-02,2184
4541,晟田,4,0,4,亞東-新竹,2023-06-02,2184
6188,廣明,9,5,4,亞東-新竹,2023-06-02,2184
6191,精成科,4,0,4,亞東-新竹,2023-06-02,2184
9958,世紀鋼,3,0,3,亞東-新竹,2023-06-02,2184
2603,長榮,5,2,3,亞東-新竹,2023-06-02,2184
1504,東元,7,4,3,亞東-新竹,2023-06-02,2184
2634,漢翔,128,2,126,亞東-新竹,2023-06-05,2184
2618,長榮航,55,2,53,亞東-新竹,2023-06-05,2184
2885,元大金,40,0,40,亞東-新竹,2023-06-05,2184
3363,上詮,50,12,38,亞東-新竹,2023-06-05,2184
00772B,中信高評級公司債,32,0,32,亞東-新竹,2023-06-05,2184
00903,富邦元宇宙,30,0,30,亞東-新竹,2023-06-05,2184
2014,中鴻,27,0,27,亞東-新竹,2023-06-05,2184
2449,京元電子,25,0,25,亞東-新竹,2023-06-05,2184
00882,中信中國高股息,22,0,22,亞東-新竹,2023-06-05,2184
1513,中興電,26,5,21,亞東-新竹,2023-06-05,2184
2002,中鋼,21,1,20,亞東-新竹,2023-06-05,2184
8234,新漢,22,2,20,亞東-新竹,2023-06-05,2184
00680L,元大美債20正2,19,0,19,亞東-新竹,2023-06-05,2184
2481,強茂,18,0,18,亞東-新竹,2023-06-05,2184
6234,高僑,17,1,16,亞東-新竹,2023-06-05,2184
2303,聯電,15,0,15,亞東-新竹,2023-06-05,2184
8924,大田,15,0,15,亞東-新竹,2023-06-05,2184
6125,廣運,17,3,14,亞東-新竹,2023-06-05,2184
2528,皇普,12,0,12,亞東-新竹,2023-06-05,2184
2436,偉詮電,11,0,11,亞東-新竹,2023-06-05,2184
00687B,國泰20年美債,11,0,11,亞東-新竹,2023-06-05,2184
00714,群益道瓊美國地產,10,0,10,亞東-新竹,2023-06-05,2184
4958,臻鼎-KY,10,0,10,亞東-新竹,2023-06-05,2184
5706,鳳凰,16,6,10,亞東-新竹,2023-06-05,2184
1810,和成,14,5,9,亞東-新竹,2023-06-05,2184
2609,陽明,9,0,9,亞東-新竹,2023-06-05,2184
1532,勤美,8,0,8,亞東-新竹,2023-06-05,2184
00878,國泰永續高股息,8,1,7,亞東-新竹,2023-06-05,2184
3259,鑫創,7,0,7,亞東-新竹,2023-06-05,2184
1539,巨庭,6,0,6,亞東-新竹,2023-06-05,2184
3504,揚明光,11,5,6,亞東-新竹,2023-06-05,2184
6733,博晟生醫,6,0,6,亞東-新竹,2023-06-05,2184
8478,東哥遊艇,7,1,6,亞東-新竹,2023-06-05,2184
0061,元大寶滬深,5,0,5,亞東-新竹,2023-06-05,2184
1452,宏益,5,0,5,亞東-新竹,2023-06-05,2184
2913,農林,12,7,5,亞東-新竹,2023-06-05,2184
3025,星通,16,11,5,亞東-新竹,2023-06-05,2184
4906,正文,5,0,5,亞東-新竹,2023-06-05,2184
5386,青雲,5,0,5,亞東-新竹,2023-06-05,2184
6248,沛波,5,0,5,亞東-新竹,2023-06-05,2184
8064,東捷,5,0,5,亞東-新竹,2023-06-05,2184
1560,中砂,4,0,4,亞東-新竹,2023-06-05,2184
00720B,元大投資級公司債,4,0,4,亞東-新竹,2023-06-05,2184
3711,日月光投控,14,10,4,亞東-新竹,2023-06-05,2184
6214,精誠,4,0,4,亞東-新竹,2023-06-05,2184
6269,台郡,4,0,4,亞東-新竹,2023-06-05,2184
2603,長榮,6,3,3,亞東-新竹,2023-06-05,2184
00713,元大台灣高息低波,3,0,3,亞東-新竹,2023-06-05,2184
00795B,中信美國公債20年,3,0,3,亞東-新竹,2023-06-05,2184
1905,華紙,14,11,3,亞東-新竹,2023-06-05,2184
1905,華紙,110,1,109,亞東-新竹,2023-06-06,2184
2634,漢翔,80,0,80,亞東-新竹,2023-06-06,2184
1616,億泰,70,6,64,亞東-新竹,2023-06-06,2184
00712,復華富時不動產,51,0,51,亞東-新竹,2023-06-06,2184
2610,華航,93,44,49,亞東-新竹,2023-06-06,2184
00679B,元大美債20年,30,0,30,亞東-新竹,2023-06-06,2184
00893,國泰智能電動車,30,3,27,亞東-新竹,2023-06-06,2184
2331,精英,30,4,26,亞東-新竹,2023-06-06,2184
00919,群益台灣精選高息,21,0,21,亞東-新竹,2023-06-06,2184
00927,群益半導體收益,21,0,21,亞東-新竹,2023-06-06,2184
1609,大亞,51,30,21,亞東-新竹,2023-06-06,2184
2888,新光金,21,0,21,亞東-新竹,2023-06-06,2184
2303,聯電,18,0,18,亞東-新竹,2023-06-06,2184
2481,強茂,17,0,17,亞東-新竹,2023-06-06,2184
6509,聚和,17,0,17,亞東-新竹,2023-06-06,2184
00632R,元大台灣50反1,16,0,16,亞東-新竹,2023-06-06,2184
00878,國泰永續高股息,15,1,14,亞東-新竹,2023-06-06,2184
5534,長虹,11,0,11,亞東-新竹,2023-06-06,2184
6235,華孚,11,0,11,亞東-新竹,2023-06-06,2184
5309,系統電,10,0,10,亞東-新竹,2023-06-06,2184
8176,智捷,10,0,10,亞東-新竹,2023-06-06,2184
2206,三陽工業,19,10,9,亞東-新竹,2023-06-06,2184
1608,華榮,9,0,9,亞東-新竹,2023-06-06,2184
6231,系微,9,0,9,亞東-新竹,2023-06-06,2184
00713,元大台灣高息低波,8,0,8,亞東-新竹,2023-06-06,2184
3481,群創,10,2,8,亞東-新竹,2023-06-06,2184
3501,維熹,8,0,8,亞東-新竹,2023-06-06,2184
5511,德昌,8,0,8,亞東-新竹,2023-06-06,2184
2492,華新科,7,0,7,亞東-新竹,2023-06-06,2184
3046,建��,9,2,7,亞東-新竹,2023-06-06,2184
6129,普誠,7,0,7,亞東-新竹,2023-06-06,2184
1904,正隆,6,0,6,亞東-新竹,2023-06-06,2184
3035,智原,6,0,6,亞東-新竹,2023-06-06,2184
3031,佰鴻,6,0,6,亞東-新竹,2023-06-06,2184
6124,業強,6,0,6,亞東-新竹,2023-06-06,2184
8478,東哥遊艇,6,0,6,亞東-新竹,2023-06-06,2184
6535,順藥,11,5,6,亞東-新竹,2023-06-06,2184
2301,光寶科,5,0,5,亞東-新竹,2023-06-06,2184
2402,毅嘉,7,2,5,亞東-新竹,2023-06-06,2184
2449,京元電子,12,7,5,亞東-新竹,2023-06-06,2184
2618,長榮航,15,10,5,亞東-新竹,2023-06-06,2184
3163,波若威,5,0,5,亞東-新竹,2023-06-06,2184
4102,永日,5,0,5,亞東-新竹,2023-06-06,2184
6416,瑞祺電通,5,0,5,亞東-新竹,2023-06-06,2184
8088,品安,5,0,5,亞東-新竹,2023-06-06,2184
00751B,元大AAA至A公司債,4,0,4,亞東-新竹,2023-06-06,2184
00680L,元大美債20正2,4,0,4,亞東-新竹,2023-06-06,2184
2399,映泰,4,0,4,亞東-新竹,2023-06-06,2184
2498,宏達電,5,1,4,亞東-新竹,2023-06-06,2184
3041,揚智,4,0,4,亞東-新竹,2023-06-06,2184
00882,中信中國高股息,93,0,93,亞東-新竹,2023-06-07,2184
00919,群益台灣精選高息,90,2,88,亞東-新竹,2023-06-07,2184
1104,環泥,60,1,59,亞東-新竹,2023-06-07,2184
2380,虹光,50,0,50,亞東-新竹,2023-06-07,2184
00902,中信電池及儲能,40,0,40,亞東-新竹,2023-06-07,2184
00927,群益半導體收益,33,0,33,亞東-新竹,2023-06-07,2184
1218,泰山,29,0,29,亞東-新竹,2023-06-07,2184
3324,雙鴻,27,1,26,亞東-新竹,2023-06-07,2184
6570,維田,25,0,25,亞東-新竹,2023-06-07,2184
8403,盛弘,26,2,24,亞東-新竹,2023-06-07,2184
2706,第一店,22,0,22,亞東-新竹,2023-06-07,2184
3058,立德,28,6,22,亞東-新竹,2023-06-07,2184
2002,中鋼,20,1,19,亞東-新竹,2023-06-07,2184
2881,富邦金,15,0,15,亞東-新竹,2023-06-07,2184
2468,華經,14,0,14,亞東-新竹,2023-06-07,2184
1605,華新,14,2,12,亞東-新竹,2023-06-07,2184
1806,冠軍,12,0,12,亞東-新竹,2023-06-07,2184
2486,一詮,12,0,12,亞東-新竹,2023-06-07,2184
6443,元晶,12,0,12,亞東-新竹,2023-06-07,2184
1514,亞力,12,1,11,亞東-新竹,2023-06-07,2184
2882,國泰金,11,0,11,亞東-新竹,2023-06-07,2184
00665L,富邦�琤肭磪囓�2,10,0,10,亞東-新竹,2023-06-07,2184
2376,技嘉,11,1,10,亞東-新竹,2023-06-07,2184
2634,漢翔,10,0,10,亞東-新竹,2023-06-07,2184
2887,台新金,10,0,10,亞東-新竹,2023-06-07,2184
3227,原相,10,0,10,亞東-新竹,2023-06-07,2184
4726,永昕,18,8,10,亞東-新竹,2023-06-07,2184
00687B,國泰20年美債,9,0,9,亞東-新竹,2023-06-07,2184
2314,台揚,11,2,9,亞東-新竹,2023-06-07,2184
8033,雷虎,10,1,9,亞東-新竹,2023-06-07,2184
0056,元大高股息,9,1,8,亞東-新竹,2023-06-07,2184
6703,軒郁,8,0,8,亞東-新竹,2023-06-07,2184
2308,台達電,10,2,8,亞東-新竹,2023-06-07,2184
1459,聯發,7,0,7,亞東-新竹,2023-06-07,2184
3311,閎暉,7,0,7,亞東-新竹,2023-06-07,2184
6535,順藥,7,0,7,亞東-新竹,2023-06-07,2184
1618,合機,6,0,6,亞東-新竹,2023-06-07,2184
2498,宏達電,6,0,6,亞東-新竹,2023-06-07,2184
2888,新光金,18,12,6,亞東-新竹,2023-06-07,2184
2929,淘帝-KY,6,0,6,亞東-新竹,2023-06-07,2184
5511,德昌,9,3,6,亞東-新竹,2023-06-07,2184
6124,業強,6,0,6,亞東-新竹,2023-06-07,2184
6438,迅得,6,0,6,亞東-新竹,2023-06-07,2184
00642U,期元大S＆P石油,5,0,5,亞東-新竹,2023-06-07,2184
00679B,元大美債20年,5,0,5,亞東-新竹,2023-06-07,2184
2404,漢唐,5,0,5,亞東-新竹,2023-06-07,2184
2618,長榮航,9,4,5,亞東-新竹,2023-06-07,2184
3056,富華新,5,0,5,亞東-新竹,2023-06-07,2184
5483,中美晶,5,0,5,亞東-新竹,2023-06-07,2184
6125,廣運,21,16,5,亞東-新竹,2023-06-07,2184
2883,凱基金,200,18,182,亞東-新竹,2023-06-08,2184
00772B,中信高評級公司債,84,2,82,亞東-新竹,2023-06-08,2184
00830,國泰費城半導體,40,0,40,亞東-新竹,2023-06-08,2184
00679B,元大美債20年,35,1,34,亞東-新竹,2023-06-08,2184
00751B,元大AAA至A公司債,30,0,30,亞東-新竹,2023-06-08,2184
3545,敦泰,22,0,22,亞東-新竹,2023-06-08,2184
6179,亞通,24,2,22,亞東-新竹,2023-06-08,2184
6733,博晟生醫,23,1,22,亞東-新竹,2023-06-08,2184
6203,海韻電,20,0,20,亞東-新竹,2023-06-08,2184
2468,華經,19,0,19,亞東-新竹,2023-06-08,2184
1605,華新,16,1,15,亞東-新竹,2023-06-08,2184
1720,生達,15,0,15,亞東-新竹,2023-06-08,2184
4123,晟德,16,1,15,亞東-新竹,2023-06-08,2184
1459,聯發,15,0,15,亞東-新竹,2023-06-08,2184
2457,飛宏,32,18,14,亞東-新竹,2023-06-08,2184
2380,虹光,13,0,13,亞東-新竹,2023-06-08,2184
3163,波若威,12,0,12,亞東-新竹,2023-06-08,2184
00665L,富邦�琤肭磪囓�2,10,0,10,亞東-新竹,2023-06-08,2184
00655L,國泰中國A50正2,10,0,10,亞東-新竹,2023-06-08,2184
00878,國泰永續高股息,12,2,10,亞東-新竹,2023-06-08,2184
2363,矽統,10,0,10,亞東-新竹,2023-06-08,2184
4979,華星光,10,0,10,亞東-新竹,2023-06-08,2184
8940,新天地,10,0,10,亞東-新竹,2023-06-08,2184
9962,有益,10,0,10,亞東-新竹,2023-06-08,2184
2330,台積電,12,2,10,亞東-新竹,2023-06-08,2184
2201,裕隆,17,8,9,亞東-新竹,2023-06-08,2184
2328,廣宇,9,0,9,亞東-新竹,2023-06-08,2184
3711,日月光投控,10,1,9,亞東-新竹,2023-06-08,2184
6770,力積電,9,0,9,亞東-新竹,2023-06-08,2184
2206,三陽工業,9,1,8,亞東-新竹,2023-06-08,2184
2382,廣達,13,5,8,亞東-新竹,2023-06-08,2184
2481,強茂,8,0,8,亞東-新竹,2023-06-08,2184
3287,廣寰科,8,0,8,亞東-新竹,2023-06-08,2184
4111,濟生,8,0,8,亞東-新竹,2023-06-08,2184
00720B,元大投資級公司債,7,0,7,亞東-新竹,2023-06-08,2184
1786,科妍,7,0,7,亞東-新竹,2023-06-08,2184
2428,興勤,7,0,7,亞東-新竹,2023-06-08,2184
2492,華新科,7,0,7,亞東-新竹,2023-06-08,2184
6282,康舒,7,0,7,亞東-新竹,2023-06-08,2184
6443,元晶,7,0,7,亞東-新竹,2023-06-08,2184
0056,元大高股息,9,3,6,亞東-新竹,2023-06-08,2184
6231,系微,6,0,6,亞東-新竹,2023-06-08,2184
00687B,國泰20年美債,6,0,6,亞東-新竹,2023-06-08,2184
00636,國泰中國A50,6,0,6,亞東-新竹,2023-06-08,2184
3511,矽瑪,6,0,6,亞東-新竹,2023-06-08,2184
4129,聯合,6,0,6,亞東-新竹,2023-06-08,2184
5371,中光電,6,0,6,亞東-新竹,2023-06-08,2184
2882,國泰金,5,0,5,亞東-新竹,2023-06-08,2184
00890B,凱基ESG BBB債,5,0,5,亞東-新竹,2023-06-08,2184
00900,富邦特選高股息30,5,0,5,亞東-新竹,2023-06-08,2184
2883,凱基金,300,0,300,亞東-新竹,2023-06-09,2184
2323,中環,40,0,40,亞東-新竹,2023-06-09,2184
00919,群益台灣精選高息,30,0,30,亞東-新竹,2023-06-09,2184
00929,復華台灣科技優息,22,0,22,亞東-新竹,2023-06-09,2184
6235,華孚,22,0,22,亞東-新竹,2023-06-09,2184
1514,亞力,22,1,21,亞東-新竹,2023-06-09,2184
00712,復華富時不動產,20,0,20,亞東-新竹,2023-06-09,2184
6005,群益證,20,0,20,亞東-新竹,2023-06-09,2184
6733,博晟生醫,18,1,17,亞東-新竹,2023-06-09,2184
2888,新光金,15,0,15,亞東-新竹,2023-06-09,2184
2929,淘帝-KY,15,0,15,亞東-新竹,2023-06-09,2184
3703,欣陸,15,0,15,亞東-新竹,2023-06-09,2184
6205,詮欣,15,0,15,亞東-新竹,2023-06-09,2184
8403,盛弘,14,0,14,亞東-新竹,2023-06-09,2184
00795B,中信美國公債20年,14,0,14,亞東-新竹,2023-06-09,2184
6158,禾昌,12,0,12,亞東-新竹,2023-06-09,2184
5425,台半,10,0,10,亞東-新竹,2023-06-09,2184
00751B,元大AAA至A公司債,10,0,10,亞東-新竹,2023-06-09,2184
6026,福邦證,10,0,10,亞東-新竹,2023-06-09,2184
2328,廣宇,9,0,9,亞東-新竹,2023-06-09,2184
2312,金寶,9,0,9,亞東-新竹,2023-06-09,2184
1504,東元,8,0,8,亞東-新竹,2023-06-09,2184
4726,永昕,7,0,7,亞東-新竹,2023-06-09,2184
5225,東科-KY,7,0,7,亞東-新竹,2023-06-09,2184
6243,迅杰,7,0,7,亞東-新竹,2023-06-09,2184
1459,聯發,6,0,6,亞東-新竹,2023-06-09,2184
2371,大同,6,0,6,亞東-新竹,2023-06-09,2184
2482,連宇,16,11,5,亞東-新竹,2023-06-09,2184
00642U,期元大S＆P石油,5,0,5,亞東-新竹,2023-06-09,2184
2409,友達,5,0,5,亞東-新竹,2023-06-09,2184
5243,乙盛-KY,5,0,5,亞東-新竹,2023-06-09,2184
6449,鈺邦,5,0,5,亞東-新竹,2023-06-09,2184
6257,矽格,4,0,4,亞東-新竹,2023-06-09,2184
1314,中石化,4,0,4,亞東-新竹,2023-06-09,2184
3515,華擎,4,0,4,亞東-新竹,2023-06-09,2184
6443,元晶,4,0,4,亞東-新竹,2023-06-09,2184
6625,必應,22,18,4,亞東-新竹,2023-06-09,2184
8049,晶采,4,0,4,亞東-新竹,2023-06-09,2184
8091,翔名,5,1,4,亞東-新竹,2023-06-09,2184
9942,茂順,4,0,4,亞東-新竹,2023-06-09,2184
2436,偉詮電,10,6,4,亞東-新竹,2023-06-09,2184
1513,中興電,3,0,3,亞東-新竹,2023-06-09,2184
1463,強盛新,3,0,3,亞東-新竹,2023-06-09,2184
2385,群光,3,0,3,亞東-新竹,2023-06-09,2184
2884,玉山金,4,1,3,亞東-新竹,2023-06-09,2184
3041,揚智,3,0,3,亞東-新竹,2023-06-09,2184
3265,台星科,3,0,3,亞東-新竹,2023-06-09,2184
3540,曜越,4,1,3,亞東-新竹,2023-06-09,2184
3673,TPK-KY,3,0,3,亞東-新竹,2023-06-09,2184
4931,新盛力,3,0,3,亞東-新竹,2023-06-09,2184
00929,復華台灣科技優息,69,0,69,亞東-新竹,2023-06-12,2184
00772B,中信高評級公司債,53,0,53,亞東-新竹,2023-06-12,2184
00751B,元大AAA至A公司債,53,0,53,亞東-新竹,2023-06-12,2184
6143,振曜,50,0,50,亞東-新竹,2023-06-12,2184
00715L,期街口布蘭特正2,53,10,43,亞東-新竹,2023-06-12,2184
6005,群益證,40,0,40,亞東-新竹,2023-06-12,2184
6122,擎邦,50,15,35,亞東-新竹,2023-06-12,2184
2882,國泰金,34,0,34,亞東-新竹,2023-06-12,2184
3032,偉訓,30,0,30,亞東-新竹,2023-06-12,2184
2206,三陽工業,25,0,25,亞東-新竹,2023-06-12,2184
2618,長榮航,132,108,24,亞東-新竹,2023-06-12,2184
1609,大亞,28,8,20,亞東-新竹,2023-06-12,2184
2489,瑞軒,20,0,20,亞東-新竹,2023-06-12,2184
6139,亞翔,20,0,20,亞東-新竹,2023-06-12,2184
6147,頎邦,20,0,20,亞東-新竹,2023-06-12,2184
6203,海韻電,20,0,20,亞東-新竹,2023-06-12,2184
1459,聯發,19,0,19,亞東-新竹,2023-06-12,2184
00895,富邦未來車,20,3,17,亞東-新竹,2023-06-12,2184
2516,新建,17,0,17,亞東-新竹,2023-06-12,2184
6148,驊宏資,18,1,17,亞東-新竹,2023-06-12,2184
8926,台汽電,26,9,17,亞東-新竹,2023-06-12,2184
6248,沛波,16,0,16,亞東-新竹,2023-06-12,2184
8916,光隆,15,0,15,亞東-新竹,2023-06-12,2184
00918,大華優利高填息30,15,0,15,亞東-新竹,2023-06-12,2184
3206,志豐,15,0,15,亞東-新竹,2023-06-12,2184
00878,國泰永續高股息,16,2,14,亞東-新竹,2023-06-12,2184
5439,高技,12,0,12,亞東-新竹,2023-06-12,2184
5469,瀚宇博,12,0,12,亞東-新竹,2023-06-12,2184
2891,中信金,11,0,11,亞東-新竹,2023-06-12,2184
3046,建��,17,6,11,亞東-新竹,2023-06-12,2184
3287,廣寰科,11,0,11,亞東-新竹,2023-06-12,2184
3325,旭品,11,0,11,亞東-新竹,2023-06-12,2184
00919,群益台灣精選高息,10,0,10,亞東-新竹,2023-06-12,2184
00642U,期元大S＆P石油,10,0,10,亞東-新竹,2023-06-12,2184
2323,中環,50,40,10,亞東-新竹,2023-06-12,2184
2449,京元電子,10,0,10,亞東-新竹,2023-06-12,2184
2482,連宇,10,0,10,亞東-新竹,2023-06-12,2184
2845,遠東銀,10,0,10,亞東-新竹,2023-06-12,2184
3231,緯創,47,37,10,亞東-新竹,2023-06-12,2184
4979,華星光,11,1,10,亞東-新竹,2023-06-12,2184
8021,尖點,10,0,10,亞東-新竹,2023-06-12,2184
0056,元大高股息,13,4,9,亞東-新竹,2023-06-12,2184
5009,榮剛,10,1,9,亞東-新竹,2023-06-12,2184
3481,群創,11,3,8,亞東-新竹,2023-06-12,2184
6733,博晟生醫,8,0,8,亞東-新竹,2023-06-12,2184
2344,華邦電,7,0,7,亞東-新竹,2023-06-12,2184
00636,國泰中國A50,6,0,6,亞東-新竹,2023-06-12,2184
00712,復華富時不動產,6,0,6,亞東-新竹,2023-06-12,2184
1711,永光,6,0,6,亞東-新竹,2023-06-12,2184
2356,英業達,10,4,6,亞東-新竹,2023-06-12,2184
2634,漢翔,160,0,160,亞東-新竹,2023-06-13,2184
00929,復華台灣科技優息,101,0,101,亞東-新竹,2023-06-13,2184
00715L,期街口布蘭特正2,69,0,69,亞東-新竹,2023-06-13,2184
00632R,元大台灣50反1,56,5,51,亞東-新竹,2023-06-13,2184
00772B,中信高評級公司債,50,0,50,亞東-新竹,2023-06-13,2184
2889,國票金,50,0,50,亞東-新竹,2023-06-13,2184
2897,王道銀行,100,50,50,亞東-新竹,2023-06-13,2184
6167,久正,48,0,48,亞東-新竹,2023-06-13,2184
3032,偉訓,40,0,40,亞東-新竹,2023-06-13,2184
00878,國泰永續高股息,34,11,23,亞東-新竹,2023-06-13,2184
2610,華航,111,91,20,亞東-新竹,2023-06-13,2184
2888,新光金,18,0,18,亞東-新竹,2023-06-13,2184
00642U,期元大S＆P石油,15,0,15,亞東-新竹,2023-06-13,2184
2882,國泰金,33,20,13,亞東-新竹,2023-06-13,2184
3287,廣寰科,12,0,12,亞東-新竹,2023-06-13,2184
4533,協易機,14,2,12,亞東-新竹,2023-06-13,2184
1459,聯發,11,0,11,亞東-新竹,2023-06-13,2184
1310,台苯,10,0,10,亞東-新竹,2023-06-13,2184
00665L,富邦�琤肭磪囓�2,10,0,10,亞東-新竹,2023-06-13,2184
2367,燿華,10,0,10,亞東-新竹,2023-06-13,2184
2913,農林,10,0,10,亞東-新竹,2023-06-13,2184
3652,精聯,15,5,10,亞東-新竹,2023-06-13,2184
3704,合勤控,10,0,10,亞東-新竹,2023-06-13,2184
5706,鳳凰,10,0,10,亞東-新竹,2023-06-13,2184
00891,中信關鍵半導體,9,0,9,亞東-新竹,2023-06-13,2184
4105,東洋,10,1,9,亞東-新竹,2023-06-13,2184
5512,力麒,8,0,8,亞東-新竹,2023-06-13,2184
00679B,元大美債20年,9,1,8,亞東-新竹,2023-06-13,2184
2887,台新金,7,0,7,亞東-新竹,2023-06-13,2184
00919,群益台灣精選高息,7,0,7,亞東-新竹,2023-06-13,2184
1608,華榮,7,0,7,亞東-新竹,2023-06-13,2184
2606,裕民,7,0,7,亞東-新竹,2023-06-13,2184
00636,國泰中國A50,6,0,6,亞東-新竹,2023-06-13,2184
1711,永光,6,0,6,亞東-新竹,2023-06-13,2184
6443,元晶,8,2,6,亞東-新竹,2023-06-13,2184
8926,台汽電,6,0,6,亞東-新竹,2023-06-13,2184
1909,榮成,5,0,5,亞東-新竹,2023-06-13,2184
2206,三陽工業,17,12,5,亞東-新竹,2023-06-13,2184
2404,漢唐,7,2,5,亞東-新竹,2023-06-13,2184
2615,萬海,5,0,5,亞東-新竹,2023-06-13,2184
6733,博晟生醫,5,0,5,亞東-新竹,2023-06-13,2184
9930,中聯資源,5,0,5,亞東-新竹,2023-06-13,2184
3105,穩懋,4,0,4,亞東-新竹,2023-06-13,2184
0056,元大高股息,11,7,4,亞東-新竹,2023-06-13,2184
1524,耿鼎,8,4,4,亞東-新竹,2023-06-13,2184
2357,華碩,4,0,4,亞東-新竹,2023-06-13,2184
2436,偉詮電,5,1,4,亞東-新竹,2023-06-13,2184
2883,凱基金,4,0,4,亞東-新竹,2023-06-13,2184
2886,兆豐金,5,1,4,亞東-新竹,2023-06-13,2184
3483,力致,5,1,4,亞東-新竹,2023-06-13,2184
2634,漢翔,109,23,86,亞東-新竹,2023-06-14,2184
00751B,元大AAA至A公司債,36,0,36,亞東-新竹,2023-06-14,2184
2356,英業達,51,15,36,亞東-新竹,2023-06-14,2184
1611,中電,37,2,35,亞東-新竹,2023-06-14,2184
2405,輔信,30,0,30,亞東-新竹,2023-06-14,2184
2450,神腦,29,0,29,亞東-新竹,2023-06-14,2184
2440,太空梭,20,0,20,亞東-新竹,2023-06-14,2184
6005,群益證,20,0,20,亞東-新竹,2023-06-14,2184
2486,一詮,20,2,18,亞東-新竹,2023-06-14,2184
2317,鴻海,20,3,17,亞東-新竹,2023-06-14,2184
00919,群益台灣精選高息,17,0,17,亞東-新竹,2023-06-14,2184
2206,三陽工業,19,2,17,亞東-新竹,2023-06-14,2184
6248,沛波,20,6,14,亞東-新竹,2023-06-14,2184
2516,新建,12,0,12,亞東-新竹,2023-06-14,2184
6122,擎邦,12,0,12,亞東-新竹,2023-06-14,2184
6138,茂達,11,0,11,亞東-新竹,2023-06-14,2184
1582,信錦,11,0,11,亞東-新竹,2023-06-14,2184
3583,辛耘,12,1,11,亞東-新竹,2023-06-14,2184
2449,京元電子,31,20,11,亞東-新竹,2023-06-14,2184
3006,晶豪科,11,1,10,亞東-新竹,2023-06-14,2184
00753L,中信中國50正2,10,0,10,亞東-新竹,2023-06-14,2184
00665L,富邦�琤肭磪囓�2,20,10,10,亞東-新竹,2023-06-14,2184
1609,大亞,21,11,10,亞東-新竹,2023-06-14,2184
2891,中信金,10,0,10,亞東-新竹,2023-06-14,2184
3260,威剛,10,0,10,亞東-新竹,2023-06-14,2184
3545,敦泰,10,0,10,亞東-新竹,2023-06-14,2184
2489,瑞軒,11,2,9,亞東-新竹,2023-06-14,2184
2888,新光金,9,0,9,亞東-新竹,2023-06-14,2184
5511,德昌,9,0,9,亞東-新竹,2023-06-14,2184
00713,元大台灣高息低波,8,0,8,亞東-新竹,2023-06-14,2184
2330,台積電,12,4,8,亞東-新竹,2023-06-14,2184
1504,東元,9,1,8,亞東-新竹,2023-06-14,2184
3419,譁裕,8,0,8,亞東-新竹,2023-06-14,2184
0056,元大高股息,18,11,7,亞東-新竹,2023-06-14,2184
2457,飛宏,12,5,7,亞東-新竹,2023-06-14,2184
3025,星通,7,0,7,亞東-新竹,2023-06-14,2184
3652,精聯,12,5,7,亞東-新竹,2023-06-14,2184
4564,元翎,7,0,7,亞東-新竹,2023-06-14,2184
6125,廣運,8,2,6,亞東-新竹,2023-06-14,2184
8050,廣積,10,4,6,亞東-新竹,2023-06-14,2184
1314,中石化,5,0,5,亞東-新竹,2023-06-14,2184
00918,大華優利高填息30,5,0,5,亞東-新竹,2023-06-14,2184
00679B,元大美債20年,5,0,5,亞東-新竹,2023-06-14,2184
1785,光洋科,5,0,5,亞東-新竹,2023-06-14,2184
1905,華紙,5,0,5,亞東-新竹,2023-06-14,2184
3032,偉訓,5,0,5,亞東-新竹,2023-06-14,2184
3035,智原,5,0,5,亞東-新竹,2023-06-14,2184
3498,陽程,5,0,5,亞東-新竹,2023-06-14,2184
5234,達興材料,5,0,5,亞東-新竹,2023-06-14,2184
6535,順藥,5,0,5,亞東-新竹,2023-06-14,2184
2883,凱基金,221,103,118,亞東-新竹,2023-06-15,2184
2457,飛宏,56,3,53,亞東-新竹,2023-06-15,2184
2489,瑞軒,36,0,36,亞東-新竹,2023-06-15,2184
3206,志豐,33,0,33,亞東-新竹,2023-06-15,2184
6248,沛波,30,0,30,亞東-新竹,2023-06-15,2184
00751B,元大AAA至A公司債,25,0,25,亞東-新竹,2023-06-15,2184
1605,華新,22,0,22,亞東-新竹,2023-06-15,2184
2380,虹光,20,0,20,亞東-新竹,2023-06-15,2184
6005,群益證,20,0,20,亞東-新竹,2023-06-15,2184
3013,晟銘電,21,4,17,亞東-新竹,2023-06-15,2184
1459,聯發,16,1,15,亞東-新竹,2023-06-15,2184
00895,富邦未來車,17,5,12,亞東-新竹,2023-06-15,2184
3024,憶聲,12,0,12,亞東-新竹,2023-06-15,2184
3071,協禧,12,0,12,亞東-新竹,2023-06-15,2184
8028,昇陽半導體,14,2,12,亞東-新竹,2023-06-15,2184
2888,新光金,11,0,11,亞東-新竹,2023-06-15,2184
2340,台亞,10,0,10,亞東-新竹,2023-06-15,2184
2402,毅嘉,10,0,10,亞東-新竹,2023-06-15,2184
2605,新興,10,0,10,亞東-新竹,2023-06-15,2184
3707,漢磊,10,0,10,亞東-新竹,2023-06-15,2184
5443,均豪,9,0,9,亞東-新竹,2023-06-15,2184
8069,元太,10,1,9,亞東-新竹,2023-06-15,2184
8299,群聯,10,1,9,亞東-新竹,2023-06-15,2184
2317,鴻海,8,0,8,亞東-新竹,2023-06-15,2184
3034,聯詠,9,1,8,亞東-新竹,2023-06-15,2184
00919,群益台灣精選高息,16,8,8,亞東-新竹,2023-06-15,2184
00720B,元大投資級公司債,7,0,7,亞東-新竹,2023-06-15,2184
5511,德昌,7,0,7,亞東-新竹,2023-06-15,2184
00912,中信臺灣智慧50,6,0,6,亞東-新竹,2023-06-15,2184
4105,東洋,6,0,6,亞東-新竹,2023-06-15,2184
4153,鈺緯,6,0,6,亞東-新竹,2023-06-15,2184
5263,智崴,6,0,6,亞東-新竹,2023-06-15,2184
6269,台郡,6,0,6,亞東-新竹,2023-06-15,2184
6443,元晶,9,3,6,亞東-新竹,2023-06-15,2184
00642U,期元大S＆P石油,5,0,5,亞東-新竹,2023-06-15,2184
2634,漢翔,6,1,5,亞東-新竹,2023-06-15,2184
3078,僑威,7,2,5,亞東-新竹,2023-06-15,2184
4979,華星光,5,0,5,亞東-新竹,2023-06-15,2184
4994,傳奇,5,0,5,亞東-新竹,2023-06-15,2184
6158,禾昌,5,0,5,亞東-新竹,2023-06-15,2184
6546,正基,5,0,5,亞東-新竹,2023-06-15,2184
00885,富邦越南,4,0,4,亞東-新竹,2023-06-15,2184
00679B,元大美債20年,4,0,4,亞東-新竹,2023-06-15,2184
00675L,富邦臺灣加權正2,4,0,4,亞東-新竹,2023-06-15,2184
2409,友達,4,0,4,亞東-新竹,2023-06-15,2184
2545,皇翔,4,0,4,亞東-新竹,2023-06-15,2184
2719,燦星旅,4,0,4,亞東-新竹,2023-06-15,2184
2882,國泰金,4,0,4,亞東-新竹,2023-06-15,2184
8076,伍豐,4,0,4,亞東-新竹,2023-06-15,2184
8112,至上,4,0,4,亞東-新竹,2023-06-15,2184
3231,緯創,336,44,292,亞東-新竹,2023-06-16,2184
2884,玉山金,193,2,191,亞東-新竹,2023-06-16,2184
2371,大同,119,6,113,亞東-新竹,2023-06-16,2184
1514,亞力,97,4,93,亞東-新竹,2023-06-16,2184
2323,中環,118,40,78,亞東-新竹,2023-06-16,2184
2312,金寶,63,15,48,亞東-新竹,2023-06-16,2184
2618,長榮航,117,73,44,亞東-新竹,2023-06-16,2184
2883,凱基金,40,0,40,亞東-新竹,2023-06-16,2184
2402,毅嘉,35,0,35,亞東-新竹,2023-06-16,2184
3024,憶聲,35,0,35,亞東-新竹,2023-06-16,2184
6248,沛波,41,10,31,亞東-新竹,2023-06-16,2184
00878,國泰永續高股息,30,1,29,亞東-新竹,2023-06-16,2184
3260,威剛,30,1,29,亞東-新竹,2023-06-16,2184
2610,華航,161,133,28,亞東-新竹,2023-06-16,2184
6138,茂達,27,0,27,亞東-新竹,2023-06-16,2184
00675L,富邦臺灣加權正2,21,0,21,亞東-新竹,2023-06-16,2184
1905,華紙,20,0,20,亞東-新竹,2023-06-16,2184
3576,聯合再生,20,0,20,亞東-新竹,2023-06-16,2184
00830,國泰費城半導體,20,4,16,亞東-新竹,2023-06-16,2184
4919,新唐,15,0,15,亞東-新竹,2023-06-16,2184
00919,群益台灣精選高息,14,0,14,亞東-新竹,2023-06-16,2184
2201,裕隆,29,15,14,亞東-新竹,2023-06-16,2184
2204,中華,16,2,14,亞東-新竹,2023-06-16,2184
2886,兆豐金,14,0,14,亞東-新竹,2023-06-16,2184
6733,博晟生醫,14,0,14,亞東-新竹,2023-06-16,2184
1522,堤維西,15,2,13,亞東-新竹,2023-06-16,2184
1307,三芳,12,0,12,亞東-新竹,2023-06-16,2184
2888,新光金,11,0,11,亞東-新竹,2023-06-16,2184
2401,凌陽,12,1,11,亞東-新竹,2023-06-16,2184
1301,台塑,10,0,10,亞東-新竹,2023-06-16,2184
1460,宏遠,10,0,10,亞東-新竹,2023-06-16,2184
1504,東元,14,4,10,亞東-新竹,2023-06-16,2184
2340,台亞,10,0,10,亞東-新竹,2023-06-16,2184
2405,輔信,10,0,10,亞東-新竹,2023-06-16,2184
2707,晶華,10,0,10,亞東-新竹,2023-06-16,2184
6417,韋僑,10,0,10,亞東-新竹,2023-06-16,2184
2301,光寶科,21,13,8,亞東-新竹,2023-06-16,2184
3625,西勝,8,0,8,亞東-新竹,2023-06-16,2184
5425,台半,8,0,8,亞東-新竹,2023-06-16,2184
2105,正新,7,0,7,亞東-新竹,2023-06-16,2184
4994,傳奇,7,0,7,亞東-新竹,2023-06-16,2184
5258,虹堡,14,7,7,亞東-新竹,2023-06-16,2184
1459,聯發,7,0,7,亞東-新竹,2023-06-16,2184
5876,上海商銀,6,0,6,亞東-新竹,2023-06-16,2184
6245,立端,6,0,6,亞東-新竹,2023-06-16,2184
6282,康舒,8,2,6,亞東-新竹,2023-06-16,2184
2352,佳世達,11,5,6,亞東-新竹,2023-06-16,2184
3006,晶豪科,5,0,5,亞東-新竹,2023-06-16,2184
6515,穎崴,6,1,5,亞東-新竹,2023-06-16,2184
00671R,富邦NASDAQ反1,5,0,5,亞東-新竹,2023-06-16,2184
2884,玉山金,190,3,187,亞東-新竹,2023-06-19,2184
3231,緯創,185,23,162,亞東-新竹,2023-06-19,2184
00632R,元大台灣50反1,150,57,93,亞東-新竹,2023-06-19,2184
2495,普安,35,0,35,亞東-新竹,2023-06-19,2184
1215,卜蜂,31,0,31,亞東-新竹,2023-06-19,2184
5243,乙盛-KY,30,0,30,亞東-新竹,2023-06-19,2184
00753L,中信中國50正2,26,0,26,亞東-新竹,2023-06-19,2184
6148,驊宏資,26,3,23,亞東-新竹,2023-06-19,2184
3380,明泰,20,0,20,亞東-新竹,2023-06-19,2184
3287,廣寰科,18,0,18,亞東-新竹,2023-06-19,2184
00891,中信關鍵半導體,16,0,16,亞東-新竹,2023-06-19,2184
5328,華容,15,0,15,亞東-新竹,2023-06-19,2184
00633L,富邦上証正2,50,36,14,亞東-新竹,2023-06-19,2184
6235,華孚,14,0,14,亞東-新竹,2023-06-19,2184
2707,晶華,14,1,13,亞東-新竹,2023-06-19,2184
2330,台積電,11,0,11,亞東-新竹,2023-06-19,2184
00878,國泰永續高股息,14,3,11,亞東-新竹,2023-06-19,2184
00882,中信中國高股息,10,0,10,亞東-新竹,2023-06-19,2184
00713,元大台灣高息低波,10,0,10,亞東-新竹,2023-06-19,2184
1802,台玻,21,11,10,亞東-新竹,2023-06-19,2184
2353,宏��,10,0,10,亞東-新竹,2023-06-19,2184
2515,中工,10,0,10,亞東-新竹,2023-06-19,2184
2701,萬企,10,0,10,亞東-新竹,2023-06-19,2184
2882,國泰金,10,0,10,亞東-新竹,2023-06-19,2184
6016,康和證,10,0,10,亞東-新竹,2023-06-19,2184
9962,有益,10,0,10,亞東-新竹,2023-06-19,2184
1528,恩德,10,1,9,亞東-新竹,2023-06-19,2184
2887,台新金,8,0,8,亞東-新竹,2023-06-19,2184
4938,和碩,10,2,8,亞東-新竹,2023-06-19,2184
6266,泰詠,8,0,8,亞東-新竹,2023-06-19,2184
2323,中環,7,0,7,亞東-新竹,2023-06-19,2184
2324,仁寶,7,0,7,亞東-新竹,2023-06-19,2184
5483,中美晶,10,3,7,亞東-新竹,2023-06-19,2184
2615,萬海,6,0,6,亞東-新竹,2023-06-19,2184
2888,新光金,12,6,6,亞東-新竹,2023-06-19,2184
6591,動力-KY,6,0,6,亞東-新竹,2023-06-19,2184
00929,復華台灣科技優息,5,0,5,亞東-新竹,2023-06-19,2184
1582,信錦,5,0,5,亞東-新竹,2023-06-19,2184
2392,正崴,5,0,5,亞東-新竹,2023-06-19,2184
2405,輔信,5,0,5,亞東-新竹,2023-06-19,2184
2845,遠東銀,5,0,5,亞東-新竹,2023-06-19,2184
4155,訊映,5,0,5,亞東-新竹,2023-06-19,2184
4958,臻鼎-KY,5,0,5,亞東-新竹,2023-06-19,2184
6282,康舒,5,0,5,亞東-新竹,2023-06-19,2184
6509,聚和,5,0,5,亞東-新竹,2023-06-19,2184
8933,愛地雅,6,1,5,亞東-新竹,2023-06-19,2184
2890,永豐金,5,0,5,亞東-新竹,2023-06-19,2184
2317,鴻海,8,3,5,亞東-新竹,2023-06-19,2184
1312,國喬,4,0,4,亞東-新竹,2023-06-19,2184
2206,三陽工業,16,12,4,亞東-新竹,2023-06-19,2184
2634,漢翔,258,6,252,亞東-新竹,2023-06-20,2184
2618,長榮航,178,92,86,亞東-新竹,2023-06-20,2184
2323,中環,42,5,37,亞東-新竹,2023-06-20,2184
00675L,富邦臺灣加權正2,35,0,35,亞東-新竹,2023-06-20,2184
3231,緯創,95,62,33,亞東-新竹,2023-06-20,2184
00751B,元大AAA至A公司債,26,0,26,亞東-新竹,2023-06-20,2184
2712,遠雄來,21,0,21,亞東-新竹,2023-06-20,2184
2885,元大金,24,3,21,亞東-新竹,2023-06-20,2184
6806,森崴能源,20,0,20,亞東-新竹,2023-06-20,2184
2409,友達,23,6,17,亞東-新竹,2023-06-20,2184
3252,海灣,55,39,16,亞東-新竹,2023-06-20,2184
00673R,期元大S＆P原油反1,15,0,15,亞東-新竹,2023-06-20,2184
5328,華容,15,0,15,亞東-新竹,2023-06-20,2184
6290,良維,15,0,15,亞東-新竹,2023-06-20,2184
00713,元大台灣高息低波,13,0,13,亞東-新竹,2023-06-20,2184
4541,晟田,14,1,13,亞東-新竹,2023-06-20,2184
6235,華孚,13,0,13,亞東-新竹,2023-06-20,2184
2371,大同,42,30,12,亞東-新竹,2023-06-20,2184
3206,志豐,12,0,12,亞東-新竹,2023-06-20,2184
2454,聯發科,16,4,12,亞東-新竹,2023-06-20,2184
00687B,國泰20年美債,11,0,11,亞東-新竹,2023-06-20,2184
00895,富邦未來車,10,0,10,亞東-新竹,2023-06-20,2184
2402,毅嘉,10,0,10,亞東-新竹,2023-06-20,2184
2637,慧洋-KY,10,0,10,亞東-新竹,2023-06-20,2184
3522,御嵿,10,0,10,亞東-新竹,2023-06-20,2184
5876,上海商銀,10,0,10,亞東-新竹,2023-06-20,2184
6593,台灣銘板,10,0,10,亞東-新竹,2023-06-20,2184
2356,英業達,35,27,8,亞東-新竹,2023-06-20,2184
4534,慶騰,8,0,8,亞東-新竹,2023-06-20,2184
4919,新唐,8,1,7,亞東-新竹,2023-06-20,2184
6443,元晶,10,3,7,亞東-新竹,2023-06-20,2184
00772B,中信高評級公司債,6,0,6,亞東-新竹,2023-06-20,2184
2201,裕隆,20,14,6,亞東-新竹,2023-06-20,2184
006208,富邦台50,5,0,5,亞東-新竹,2023-06-20,2184
1513,中興電,9,4,5,亞東-新竹,2023-06-20,2184
00888,永豐台灣ESG,5,0,5,亞東-新竹,2023-06-20,2184
1802,台玻,6,1,5,亞東-新竹,2023-06-20,2184
2482,連宇,8,3,5,亞東-新竹,2023-06-20,2184
3105,穩懋,5,0,5,亞東-新竹,2023-06-20,2184
4904,遠傳,5,0,5,亞東-新竹,2023-06-20,2184
8210,勤誠,6,1,5,亞東-新竹,2023-06-20,2184
6531,愛普*,8,4,4,亞東-新竹,2023-06-20,2184
2545,皇翔,4,0,4,亞東-新竹,2023-06-20,2184
3162,精確,4,0,4,亞東-新竹,2023-06-20,2184
6515,穎崴,3,0,3,亞東-新竹,2023-06-20,2184
00679B,元大美債20年,3,0,3,亞東-新竹,2023-06-20,2184
1905,華紙,3,0,3,亞東-新竹,2023-06-20,2184
2382,廣達,5,2,3,亞東-新竹,2023-06-20,2184
2468,華經,11,8,3,亞東-新竹,2023-06-20,2184
2889,國票金,3,0,3,亞東-新竹,2023-06-20,2184
2323,中環,180,20,160,亞東-新竹,2023-06-21,2184
1337,再生-KY,70,0,70,亞東-新竹,2023-06-21,2184
2371,大同,116,48,68,亞東-新竹,2023-06-21,2184
3011,今皓,40,1,39,亞東-新竹,2023-06-21,2184
1616,億泰,35,0,35,亞東-新竹,2023-06-21,2184
3522,御嵿,33,0,33,亞東-新竹,2023-06-21,2184
2883,凱基金,23,0,23,亞東-新竹,2023-06-21,2184
6005,群益證,40,20,20,亞東-新竹,2023-06-21,2184
2489,瑞軒,16,0,16,亞東-新竹,2023-06-21,2184
2603,長榮,14,2,12,亞東-新竹,2023-06-21,2184
2637,慧洋-KY,12,0,12,亞東-新竹,2023-06-21,2184
3049,精金,12,0,12,亞東-新竹,2023-06-21,2184
3006,晶豪科,10,0,10,亞東-新竹,2023-06-21,2184
00752,中信中國50,10,0,10,亞東-新竹,2023-06-21,2184
4951,精拓科,10,0,10,亞東-新竹,2023-06-21,2184
6806,森崴能源,10,0,10,亞東-新竹,2023-06-21,2184
00712,復華富時不動產,9,0,9,亞東-新竹,2023-06-21,2184
3264,欣銓,8,0,8,亞東-新竹,2023-06-21,2184
3390,旭軟,8,0,8,亞東-新竹,2023-06-21,2184
6290,良維,8,0,8,亞東-新竹,2023-06-21,2184
2356,英業達,7,0,7,亞東-新竹,2023-06-21,2184
3178,公準,7,0,7,亞東-新竹,2023-06-21,2184
4904,遠傳,7,0,7,亞東-新竹,2023-06-21,2184
4916,事欣科,25,18,7,亞東-新竹,2023-06-21,2184
2610,華航,75,69,6,亞東-新竹,2023-06-21,2184
5483,中美晶,10,5,5,亞東-新竹,2023-06-21,2184
00882,中信中國高股息,5,0,5,亞東-新竹,2023-06-21,2184
1720,生達,5,0,5,亞東-新竹,2023-06-21,2184
1316,上曜,5,0,5,亞東-新竹,2023-06-21,2184
2427,三商電,11,6,5,亞東-新竹,2023-06-21,2184
2801,彰銀,5,0,5,亞東-新竹,2023-06-21,2184
3078,僑威,15,10,5,亞東-新竹,2023-06-21,2184
5511,德昌,5,0,5,亞東-新竹,2023-06-21,2184
6016,康和證,5,0,5,亞東-新竹,2023-06-21,2184
6125,廣運,6,1,5,亞東-新竹,2023-06-21,2184
6451,訊芯-KY,5,0,5,亞東-新竹,2023-06-21,2184
8215,明基材,5,0,5,亞東-新竹,2023-06-21,2184
6531,愛普*,5,1,4,亞東-新竹,2023-06-21,2184
00679B,元大美債20年,5,1,4,亞東-新竹,2023-06-21,2184
00892,富邦台灣半導體,4,0,4,亞東-新竹,2023-06-21,2184
1612,宏泰,4,0,4,亞東-新竹,2023-06-21,2184
2201,裕隆,14,10,4,亞東-新竹,2023-06-21,2184
4934,太極,4,0,4,亞東-新竹,2023-06-21,2184
6214,精誠,4,0,4,亞東-新竹,2023-06-21,2184
5871,中租-KY,3,0,3,亞東-新竹,2023-06-21,2184
1717,長興,3,0,3,亞東-新竹,2023-06-21,2184
1777,生泰,3,0,3,亞東-新竹,2023-06-21,2184
2362,藍天,3,0,3,亞東-新竹,2023-06-21,2184
2369,菱生,3,0,3,亞東-新竹,2023-06-21,2184
2609,陽明,3,0,3,亞東-新竹,2023-06-21,2184
3032,偉訓,67,5,62,亞東-新竹,2023-06-26,2184
2883,凱基金,60,0,60,亞東-新竹,2023-06-26,2184
00715L,期街口布蘭特正2,40,0,40,亞東-新竹,2023-06-26,2184
6451,訊芯-KY,31,0,31,亞東-新竹,2023-06-26,2184
3434,哲固,22,0,22,亞東-新竹,2023-06-26,2184
6203,海韻電,24,2,22,亞東-新竹,2023-06-26,2184
4541,晟田,16,1,15,亞東-新竹,2023-06-26,2184
6120,達運,18,3,15,亞東-新竹,2023-06-26,2184
3522,御嵿,14,0,14,亞東-新竹,2023-06-26,2184
5426,振發,13,0,13,亞東-新竹,2023-06-26,2184
6248,沛波,13,0,13,亞東-新竹,2023-06-26,2184
00895,富邦未來車,11,0,11,亞東-新竹,2023-06-26,2184
2340,台亞,20,9,11,亞東-新竹,2023-06-26,2184
2618,長榮航,40,29,11,亞東-新竹,2023-06-26,2184
6005,群益證,11,0,11,亞東-新竹,2023-06-26,2184
2405,輔信,11,0,11,亞東-新竹,2023-06-26,2184
00878,國泰永續高股息,12,2,10,亞東-新竹,2023-06-26,2184
00882,中信中國高股息,10,0,10,亞東-新竹,2023-06-26,2184
1806,冠軍,10,0,10,亞東-新竹,2023-06-26,2184
2353,宏��,10,0,10,亞東-新竹,2023-06-26,2184
3322,建舜電,10,0,10,亞東-新竹,2023-06-26,2184
3380,明泰,10,0,10,亞東-新竹,2023-06-26,2184
2371,大同,12,3,9,亞東-新竹,2023-06-26,2184
5706,鳳凰,9,0,9,亞東-新竹,2023-06-26,2184
2409,友達,12,3,9,亞東-新竹,2023-06-26,2184
2352,佳世達,10,2,8,亞東-新竹,2023-06-26,2184
00637L,元大滬深300正2,7,0,7,亞東-新竹,2023-06-26,2184
4538,大詠城,7,0,7,亞東-新竹,2023-06-26,2184
00753L,中信中國50正2,6,0,6,亞東-新竹,2023-06-26,2184
1215,卜蜂,6,0,6,亞東-新竹,2023-06-26,2184
3055,蔚華科,6,0,6,亞東-新竹,2023-06-26,2184
3071,協禧,14,8,6,亞東-新竹,2023-06-26,2184
3588,通嘉,6,0,6,亞東-新竹,2023-06-26,2184
3706,神達,17,11,6,亞東-新竹,2023-06-26,2184
6874,倍力,6,0,6,亞東-新竹,2023-06-26,2184
1514,亞力,5,0,5,亞東-新竹,2023-06-26,2184
2301,光寶科,5,0,5,亞東-新竹,2023-06-26,2184
2367,燿華,9,4,5,亞東-新竹,2023-06-26,2184
2492,華新科,5,0,5,亞東-新竹,2023-06-26,2184
3287,廣寰科,5,0,5,亞東-新竹,2023-06-26,2184
3362,先進光,5,0,5,亞東-新竹,2023-06-26,2184
6243,迅杰,5,0,5,亞東-新竹,2023-06-26,2184
6417,韋僑,5,0,5,亞東-新竹,2023-06-26,2184
2330,台積電,4,0,4,亞東-新竹,2023-06-26,2184
00900,富邦特選高股息30,4,0,4,亞東-新竹,2023-06-26,2184
00712,復華富時不動產,4,0,4,亞東-新竹,2023-06-26,2184
1532,勤美,4,0,4,亞東-新竹,2023-06-26,2184
00679B,元大美債20年,4,0,4,亞東-新竹,2023-06-26,2184
2382,廣達,6,2,4,亞東-新竹,2023-06-26,2184
3105,穩懋,4,0,4,亞東-新竹,2023-06-26,2184
2883,凱基金,120,0,120,亞東-新竹,2023-06-27,2184
2371,大同,46,1,45,亞東-新竹,2023-06-27,2184
0056,元大高股息,33,0,33,亞東-新竹,2023-06-27,2184
2323,中環,33,1,32,亞東-新竹,2023-06-27,2184
2303,聯電,31,0,31,亞東-新竹,2023-06-27,2184
00893,國泰智能電動車,30,5,25,亞東-新竹,2023-06-27,2184
2449,京元電子,21,0,21,亞東-新竹,2023-06-27,2184
1218,泰山,20,0,20,亞東-新竹,2023-06-27,2184
00888,永豐台灣ESG,20,0,20,亞東-新竹,2023-06-27,2184
00882,中信中國高股息,20,0,20,亞東-新竹,2023-06-27,2184
3231,緯創,38,18,20,亞東-新竹,2023-06-27,2184
3564,其陽,20,0,20,亞東-新竹,2023-06-27,2184
6163,華電網,20,0,20,亞東-新竹,2023-06-27,2184
00751B,元大AAA至A公司債,17,0,17,亞東-新竹,2023-06-27,2184
00929,復華台灣科技優息,15,0,15,亞東-新竹,2023-06-27,2184
00919,群益台灣精選高息,14,0,14,亞東-新竹,2023-06-27,2184
2317,鴻海,14,0,14,亞東-新竹,2023-06-27,2184
2328,廣宇,13,0,13,亞東-新竹,2023-06-27,2184
2201,裕隆,13,1,12,亞東-新竹,2023-06-27,2184
6179,亞通,12,0,12,亞東-新竹,2023-06-27,2184
3522,御嵿,11,0,11,亞東-新竹,2023-06-27,2184
00636,國泰中國A50,10,0,10,亞東-新竹,2023-06-27,2184
00676R,富邦臺灣加權反1,10,0,10,亞東-新竹,2023-06-27,2184
00752,中信中國50,10,0,10,亞東-新竹,2023-06-27,2184
2352,佳世達,13,3,10,亞東-新竹,2023-06-27,2184
2363,矽統,10,0,10,亞東-新竹,2023-06-27,2184
6026,福邦證,10,0,10,亞東-新竹,2023-06-27,2184
6248,沛波,10,0,10,亞東-新竹,2023-06-27,2184
8048,德勝,10,0,10,亞東-新竹,2023-06-27,2184
8215,明基材,10,0,10,亞東-新竹,2023-06-27,2184
3083,網龍,16,7,9,亞東-新竹,2023-06-27,2184
6451,訊芯-KY,9,0,9,亞東-新竹,2023-06-27,2184
2330,台積電,8,0,8,亞東-新竹,2023-06-27,2184
2382,廣達,11,3,8,亞東-新竹,2023-06-27,2184
2344,華邦電,10,2,8,亞東-新竹,2023-06-27,2184
3322,建舜電,10,2,8,亞東-新竹,2023-06-27,2184
5512,力麒,8,0,8,亞東-新竹,2023-06-27,2184
8926,台汽電,8,0,8,亞東-新竹,2023-06-27,2184
1215,卜蜂,7,0,7,亞東-新竹,2023-06-27,2184
3025,星通,7,0,7,亞東-新竹,2023-06-27,2184
6116,彩晶,7,0,7,亞東-新竹,2023-06-27,2184
00900,富邦特選高股息30,6,0,6,亞東-新竹,2023-06-27,2184
1904,正隆,9,3,6,亞東-新竹,2023-06-27,2184
6203,海韻電,6,0,6,亞東-新竹,2023-06-27,2184
6770,力積電,6,0,6,亞東-新竹,2023-06-27,2184
00725B,國泰投資級公司債,5,0,5,亞東-新竹,2023-06-27,2184
0050,元大台灣50,10,5,5,亞東-新竹,2023-06-27,2184
1504,東元,9,4,5,亞東-新竹,2023-06-27,2184
2412,中華電,5,0,5,亞東-新竹,2023-06-27,2184
2867,三商壽,5,0,5,亞東-新竹,2023-06-27,2184
2618,長榮航,221,41,180,亞東-新竹,2023-06-28,2184
00715L,期街口布蘭特正2,99,10,89,亞東-新竹,2023-06-28,2184
8210,勤誠,41,1,40,亞東-新竹,2023-06-28,2184
1762,中化生,34,0,34,亞東-新竹,2023-06-28,2184
1905,華紙,33,1,32,亞東-新竹,2023-06-28,2184
2489,瑞軒,30,2,28,亞東-新竹,2023-06-28,2184
1904,正隆,25,0,25,亞東-新竹,2023-06-28,2184
6270,倍微,20,0,20,亞東-新竹,2023-06-28,2184
6443,元晶,20,0,20,亞東-新竹,2023-06-28,2184
2457,飛宏,22,4,18,亞東-新竹,2023-06-28,2184
4747,強生,21,3,18,亞東-新竹,2023-06-28,2184
2427,三商電,16,0,16,亞東-新竹,2023-06-28,2184
2442,新美齊,16,0,16,亞東-新竹,2023-06-28,2184
0056,元大高股息,20,5,15,亞東-新竹,2023-06-28,2184
2247,汎德永業,15,0,15,亞東-新竹,2023-06-28,2184
1785,光洋科,14,0,14,亞東-新竹,2023-06-28,2184
00687B,國泰20年美債,10,0,10,亞東-新竹,2023-06-28,2184
00675L,富邦臺灣加權正2,10,0,10,亞東-新竹,2023-06-28,2184
1802,台玻,10,0,10,亞東-新竹,2023-06-28,2184
2303,聯電,18,8,10,亞東-新竹,2023-06-28,2184
2882A,國泰特,10,0,10,亞東-新竹,2023-06-28,2184
3481,群創,13,3,10,亞東-新竹,2023-06-28,2184
3711,日月光投控,10,0,10,亞東-新竹,2023-06-28,2184
8403,盛弘,10,0,10,亞東-新竹,2023-06-28,2184
2408,南亞科,10,1,9,亞東-新竹,2023-06-28,2184
5512,力麒,9,0,9,亞東-新竹,2023-06-28,2184
2603,長榮,11,4,7,亞東-新竹,2023-06-28,2184
1514,亞力,7,0,7,亞東-新竹,2023-06-28,2184
1301,台塑,7,0,7,亞東-新竹,2023-06-28,2184
3083,網龍,6,0,6,亞東-新竹,2023-06-28,2184
6139,亞翔,6,0,6,亞東-新竹,2023-06-28,2184
6282,康舒,6,0,6,亞東-新竹,2023-06-28,2184
6523,達爾膚,6,0,6,亞東-新竹,2023-06-28,2184
4121,優盛,6,0,6,亞東-新竹,2023-06-28,2184
00885,富邦越南,5,0,5,亞東-新竹,2023-06-28,2184
1598,岱宇,5,0,5,亞東-新竹,2023-06-28,2184
1504,東元,8,3,5,亞東-新竹,2023-06-28,2184
3037,欣興,5,0,5,亞東-新竹,2023-06-28,2184
5312,寶島科,5,0,5,亞東-新竹,2023-06-28,2184
1471,首利,4,0,4,亞東-新竹,2023-06-28,2184
2317,鴻海,6,2,4,亞東-新竹,2023-06-28,2184
2356,英業達,6,2,4,亞東-新竹,2023-06-28,2184
2409,友達,4,0,4,亞東-新竹,2023-06-28,2184
2605,新興,4,0,4,亞東-新竹,2023-06-28,2184
2906,高林,4,0,4,亞東-新竹,2023-06-28,2184
3306,鼎天,4,0,4,亞東-新竹,2023-06-28,2184
5263,智崴,4,0,4,亞東-新竹,2023-06-28,2184
6770,力積電,4,0,4,亞東-新竹,2023-06-28,2184
1513,中興電,3,0,3,亞東-新竹,2023-06-28,2184
1817,凱撒衛,3,0,3,亞東-新竹,2023-06-28,2184
3071,協禧,50,0,50,亞東-新竹,2023-06-29,2184
00919,群益台灣精選高息,35,0,35,亞東-新竹,2023-06-29,2184
4526,東台,36,3,33,亞東-新竹,2023-06-29,2184
2883,凱基金,22,0,22,亞東-新竹,2023-06-29,2184
5465,富驊,21,0,21,亞東-新竹,2023-06-29,2184
3287,廣寰科,19,0,19,亞東-新竹,2023-06-29,2184
1314,中石化,15,0,15,亞東-新竹,2023-06-29,2184
2610,華航,56,41,15,亞東-新竹,2023-06-29,2184
2303,聯電,16,2,14,亞東-新竹,2023-06-29,2184
1525,江申,10,0,10,亞東-新竹,2023-06-29,2184
1785,光洋科,10,0,10,亞東-新竹,2023-06-29,2184
2371,大同,12,2,10,亞東-新竹,2023-06-29,2184
2412,中華電,10,0,10,亞東-新竹,2023-06-29,2184
6108,競國,10,0,10,亞東-新竹,2023-06-29,2184
8215,明基材,10,0,10,亞東-新竹,2023-06-29,2184
6276,安鈦克,15,6,9,亞東-新竹,2023-06-29,2184
2442,新美齊,8,0,8,亞東-新竹,2023-06-29,2184
2618,長榮航,19,11,8,亞東-新竹,2023-06-29,2184
2419,仲琦,12,5,7,亞東-新竹,2023-06-29,2184
2427,三商電,9,2,7,亞東-新竹,2023-06-29,2184
00675L,富邦臺灣加權正2,6,0,6,亞東-新竹,2023-06-29,2184
4155,訊映,6,0,6,亞東-新竹,2023-06-29,2184
2330,台積電,5,0,5,亞東-新竹,2023-06-29,2184
1528,恩德,5,0,5,亞東-新竹,2023-06-29,2184
00888,永豐台灣ESG,5,0,5,亞東-新竹,2023-06-29,2184
00885,富邦越南,5,0,5,亞東-新竹,2023-06-29,2184
00676R,富邦臺灣加權反1,5,0,5,亞東-新竹,2023-06-29,2184
00687B,國泰20年美債,5,0,5,亞東-新竹,2023-06-29,2184
2637,慧洋-KY,5,0,5,亞東-新竹,2023-06-29,2184
4916,事欣科,5,0,5,亞東-新竹,2023-06-29,2184
5426,振發,5,0,5,亞東-新竹,2023-06-29,2184
8050,廣積,5,0,5,亞東-新竹,2023-06-29,2184
8222,寶一,5,0,5,亞東-新竹,2023-06-29,2184
006208,富邦台50,4,0,4,亞東-新竹,2023-06-29,2184
00633L,富邦上証正2,7,3,4,亞東-新竹,2023-06-29,2184
1440,南紡,4,0,4,亞東-新竹,2023-06-29,2184
3264,欣銓,4,0,4,亞東-新竹,2023-06-29,2184
3511,矽瑪,4,0,4,亞東-新竹,2023-06-29,2184
3515,華擎,4,0,4,亞東-新竹,2023-06-29,2184
5471,松翰,4,0,4,亞東-新竹,2023-06-29,2184
6124,業強,7,3,4,亞東-新竹,2023-06-29,2184
6197,佳必琪,4,0,4,亞東-新竹,2023-06-29,2184
6235,華孚,5,1,4,亞東-新竹,2023-06-29,2184
2882,國泰金,33,30,3,亞東-新竹,2023-06-29,2184
2884,玉山金,3,0,3,亞東-新竹,2023-06-29,2184
4915,致伸,3,0,3,亞東-新竹,2023-06-29,2184
4968,立積,4,1,3,亞東-新竹,2023-06-29,2184
6190,萬泰科,3,0,3,亞東-新竹,2023-06-29,2184
6266,泰詠,3,0,3,亞東-新竹,2023-06-29,2184
6535,順藥,3,0,3,亞東-新竹,2023-06-29,2184
3231,緯創,419,20,399,亞東-新竹,2023-06-30,2184
00772B,中信高評級公司債,120,0,120,亞東-新竹,2023-06-30,2184
00751B,元大AAA至A公司債,51,0,51,亞東-新竹,2023-06-30,2184
2891,中信金,50,0,50,亞東-新竹,2023-06-30,2184
6806,森崴能源,45,0,45,亞東-新竹,2023-06-30,2184
1513,中興電,38,0,38,亞東-新竹,2023-06-30,2184
2303,聯電,41,6,35,亞東-新竹,2023-06-30,2184
2412,中華電,34,0,34,亞東-新竹,2023-06-30,2184
9914,美利達,25,0,25,亞東-新竹,2023-06-30,2184
2368,金像電,27,4,23,亞東-新竹,2023-06-30,2184
3034,聯詠,27,5,22,亞東-新竹,2023-06-30,2184
2344,華邦電,16,0,16,亞東-新竹,2023-06-30,2184
4744,皇將,14,0,14,亞東-新竹,2023-06-30,2184
2330,台積電,14,2,12,亞東-新竹,2023-06-30,2184
0056,元大高股息,12,0,12,亞東-新竹,2023-06-30,2184
3711,日月光投控,11,0,11,亞東-新竹,2023-06-30,2184
2409,友達,10,0,10,亞東-新竹,2023-06-30,2184
00919,群益台灣精選高息,10,0,10,亞東-新竹,2023-06-30,2184
6243,迅杰,10,0,10,亞東-新竹,2023-06-30,2184
8234,新漢,10,0,10,亞東-新竹,2023-06-30,2184
1303,南亞,8,0,8,亞東-新竹,2023-06-30,2184
6733,博晟生醫,8,0,8,亞東-新竹,2023-06-30,2184
00927,群益半導體收益,6,0,6,亞東-新竹,2023-06-30,2184
3591,艾笛森,6,0,6,亞東-新竹,2023-06-30,2184
3376,新日興,5,0,5,亞東-新竹,2023-06-30,2184
4114,健喬,5,0,5,亞東-新竹,2023-06-30,2184
5315,光聯,5,0,5,亞東-新竹,2023-06-30,2184
5328,華容,5,0,5,亞東-新竹,2023-06-30,2184
5425,台半,5,0,5,亞東-新竹,2023-06-30,2184
3045,台灣大,5,1,4,亞東-新竹,2023-06-30,2184
2887,台新金,4,0,4,亞東-新竹,2023-06-30,2184
4128,中天,4,0,4,亞東-新竹,2023-06-30,2184
4977,眾達-KY,4,0,4,亞東-新竹,2023-06-30,2184
6153,嘉聯益,4,0,4,亞東-新竹,2023-06-30,2184
6640,均華,4,0,4,亞東-新竹,2023-06-30,2184
6697,東捷資訊,5,1,4,亞東-新竹,2023-06-30,2184
8403,盛弘,4,0,4,亞東-新竹,2023-06-30,2184
1605,華新,4,1,3,亞東-新竹,2023-06-30,2184
1301,台塑,3,0,3,亞東-新竹,2023-06-30,2184
2453,凌群,3,0,3,亞東-新竹,2023-06-30,2184
3035,智原,5,2,3,亞東-新竹,2023-06-30,2184
3518,柏騰,3,0,3,亞東-新竹,2023-06-30,2184
3715,定穎投控,3,0,3,亞東-新竹,2023-06-30,2184
4746,台耀,3,0,3,亞東-新竹,2023-06-30,2184
8936,國統,2,0,2,亞東-新竹,2023-06-30,2184
3293,鈊象,2,0,2,亞東-新竹,2023-06-30,2184
00725B,國泰投資級公司債,2,0,2,亞東-新竹,2023-06-30,2184
00687B,國泰20年美債,2,0,2,亞東-新竹,2023-06-30,2184
00679B,元大美債20年,2,0,2,亞東-新竹,2023-06-30,2184
1721,三晃,2,0,2,亞東-新竹,2023-06-30,2184
2888,新光金,600,0,600,亞東-新竹,2023-07-03,2184
3231,緯創,331,15,316,亞東-新竹,2023-07-03,2184
3036,文曄,60,0,60,亞東-新竹,2023-07-03,2184
00720B,元大投資級公司債,60,1,59,亞東-新竹,2023-07-03,2184
00878,國泰永續高股息,55,0,55,亞東-新竹,2023-07-03,2184
2883,凱基金,41,0,41,亞東-新竹,2023-07-03,2184
3576,聯合再生,40,0,40,亞東-新竹,2023-07-03,2184
2412,中華電,38,0,38,亞東-新竹,2023-07-03,2184
4105,東洋,37,0,37,亞東-新竹,2023-07-03,2184
5243,乙盛-KY,35,0,35,亞東-新竹,2023-07-03,2184
6806,森崴能源,33,0,33,亞東-新竹,2023-07-03,2184
2228,劍麟,25,0,25,亞東-新竹,2023-07-03,2184
2303,聯電,36,13,23,亞東-新竹,2023-07-03,2184
1609,大亞,24,2,22,亞東-新竹,2023-07-03,2184
00679B,元大美債20年,21,1,20,亞東-新竹,2023-07-03,2184
6288,聯嘉,20,0,20,亞東-新竹,2023-07-03,2184
0056,元大高股息,24,6,18,亞東-新竹,2023-07-03,2184
5306,桂盟,13,0,13,亞東-新竹,2023-07-03,2184
5483,中美晶,13,0,13,亞東-新竹,2023-07-03,2184
2356,英業達,22,10,12,亞東-新竹,2023-07-03,2184
6449,鈺邦,12,0,12,亞東-新竹,2023-07-03,2184
00712,復華富時不動產,11,0,11,亞東-新竹,2023-07-03,2184
00675L,富邦臺灣加權正2,10,0,10,亞東-新竹,2023-07-03,2184
1218,泰山,10,0,10,亞東-新竹,2023-07-03,2184
2201,裕隆,20,10,10,亞東-新竹,2023-07-03,2184
2380,虹光,10,0,10,亞東-新竹,2023-07-03,2184
3259,鑫創,10,0,10,亞東-新竹,2023-07-03,2184
5607,遠雄港,10,0,10,亞東-新竹,2023-07-03,2184
6139,亞翔,11,1,10,亞東-新竹,2023-07-03,2184
9914,美利達,10,0,10,亞東-新竹,2023-07-03,2184
9962,有益,10,0,10,亞東-新竹,2023-07-03,2184
2486,一詮,10,1,9,亞東-新竹,2023-07-03,2184
1786,科妍,8,0,8,亞東-新竹,2023-07-03,2184
5521,工信,7,0,7,亞東-新竹,2023-07-03,2184
8478,東哥遊艇,9,2,7,亞東-新竹,2023-07-03,2184
2371,大同,11,5,6,亞東-新竹,2023-07-03,2184
2606,裕民,6,0,6,亞東-新竹,2023-07-03,2184
3346,麗清,6,0,6,亞東-新竹,2023-07-03,2184
4906,正文,46,40,6,亞東-新竹,2023-07-03,2184
4746,台耀,5,0,5,亞東-新竹,2023-07-03,2184
1582,信錦,5,0,5,亞東-新竹,2023-07-03,2184
1528,恩德,10,5,5,亞東-新竹,2023-07-03,2184
2206,三陽工業,6,1,5,亞東-新竹,2023-07-03,2184
2701,萬企,5,0,5,亞東-新竹,2023-07-03,2184
3027,盛達,6,1,5,亞東-新竹,2023-07-03,2184
3178,公準,5,0,5,亞東-新竹,2023-07-03,2184
4904,遠傳,5,0,5,亞東-新竹,2023-07-03,2184
8926,台汽電,5,0,5,亞東-新竹,2023-07-03,2184
2425,承啟,5,1,4,亞東-新竹,2023-07-03,2184
2892,第一金,4,0,4,亞東-新竹,2023-07-03,2184
3231,緯創,352,20,332,亞東-新竹,2023-07-04,2184
2883,凱基金,215,0,215,亞東-新竹,2023-07-04,2184
2888,新光金,208,0,208,亞東-新竹,2023-07-04,2184
2356,英業達,141,28,113,亞東-新竹,2023-07-04,2184
00632R,元大台灣50反1,100,5,95,亞東-新竹,2023-07-04,2184
2812,台中銀,100,5,95,亞東-新竹,2023-07-04,2184
00679B,元大美債20年,62,0,62,亞東-新竹,2023-07-04,2184
6288,聯嘉,65,10,55,亞東-新竹,2023-07-04,2184
2603,長榮,66,17,49,亞東-新竹,2023-07-04,2184
3027,盛達,40,0,40,亞東-新竹,2023-07-04,2184
0056,元大高股息,51,17,34,亞東-新竹,2023-07-04,2184
00675L,富邦臺灣加權正2,30,0,30,亞東-新竹,2023-07-04,2184
2412,中華電,30,0,30,亞東-新竹,2023-07-04,2184
4105,東洋,27,0,27,亞東-新竹,2023-07-04,2184
1904,正隆,24,0,24,亞東-新竹,2023-07-04,2184
5531,鄉林,17,0,17,亞東-新竹,2023-07-04,2184
4543,萬在,38,22,16,亞東-新竹,2023-07-04,2184
00673R,期元大S＆P原油反1,15,0,15,亞東-新竹,2023-07-04,2184
5306,桂盟,15,0,15,亞東-新竹,2023-07-04,2184
5315,光聯,15,0,15,亞東-新竹,2023-07-04,2184
1609,大亞,15,1,14,亞東-新竹,2023-07-04,2184
2328,廣宇,14,0,14,亞東-新竹,2023-07-04,2184
2371,大同,13,0,13,亞東-新竹,2023-07-04,2184
00929,復華台灣科技優息,12,0,12,亞東-新竹,2023-07-04,2184
9904,寶成,12,0,12,亞東-新竹,2023-07-04,2184
3289,宜特,11,0,11,亞東-新竹,2023-07-04,2184
2317,鴻海,13,3,10,亞東-新竹,2023-07-04,2184
1310,台苯,10,0,10,亞東-新竹,2023-07-04,2184
2615,萬海,19,9,10,亞東-新竹,2023-07-04,2184
4960,誠美材,10,0,10,亞東-新竹,2023-07-04,2184
2402,毅嘉,11,1,10,亞東-新竹,2023-07-04,2184
2618,長榮航,40,31,9,亞東-新竹,2023-07-04,2184
3260,威剛,8,0,8,亞東-新竹,2023-07-04,2184
2312,金寶,10,2,8,亞東-新竹,2023-07-04,2184
3078,僑威,8,1,7,亞東-新竹,2023-07-04,2184
6248,沛波,7,0,7,亞東-新竹,2023-07-04,2184
3045,台灣大,8,2,6,亞東-新竹,2023-07-04,2184
2457,飛宏,10,4,6,亞東-新竹,2023-07-04,2184
3047,訊舟,6,0,6,亞東-新竹,2023-07-04,2184
8054,安國,6,0,6,亞東-新竹,2023-07-04,2184
1316,上曜,5,0,5,亞東-新竹,2023-07-04,2184
2106,建大,5,0,5,亞東-新竹,2023-07-04,2184
2324,仁寶,5,0,5,亞東-新竹,2023-07-04,2184
3071,協禧,5,0,5,亞東-新竹,2023-07-04,2184
6108,競國,5,0,5,亞東-新竹,2023-07-04,2184
6449,鈺邦,5,0,5,亞東-新竹,2023-07-04,2184
1104,環泥,4,0,4,亞東-新竹,2023-07-04,2184
2609,陽明,28,24,4,亞東-新竹,2023-07-04,2184
3324,雙鴻,6,2,4,亞東-新竹,2023-07-04,2184
5258,虹堡,4,0,4,亞東-新竹,2023-07-04,2184
00929,復華台灣科技優息,106,0,106,亞東-新竹,2023-07-05,2184
00679B,元大美債20年,65,0,65,亞東-新竹,2023-07-05,2184
3027,盛達,86,30,56,亞東-新竹,2023-07-05,2184
3231,緯創,70,15,55,亞東-新竹,2023-07-05,2184
00919,群益台灣精選高息,52,2,50,亞東-新竹,2023-07-05,2184
2380,虹光,26,0,26,亞東-新竹,2023-07-05,2184
4904,遠傳,25,0,25,亞東-新竹,2023-07-05,2184
2301,光寶科,21,0,21,亞東-新竹,2023-07-05,2184
6535,順藥,27,7,20,亞東-新竹,2023-07-05,2184
2610,華航,120,102,18,亞東-新竹,2023-07-05,2184
00888,永豐台灣ESG,16,0,16,亞東-新竹,2023-07-05,2184
6005,群益證,30,15,15,亞東-新竹,2023-07-05,2184
2317,鴻海,17,2,15,亞東-新竹,2023-07-05,2184
0056,元大高股息,24,10,14,亞東-新竹,2023-07-05,2184
2412,中華電,13,0,13,亞東-新竹,2023-07-05,2184
3511,矽瑪,13,0,13,亞東-新竹,2023-07-05,2184
6684,安格,13,0,13,亞東-新竹,2023-07-05,2184
2356,英業達,14,2,12,亞東-新竹,2023-07-05,2184
2303,聯電,14,2,12,亞東-新竹,2023-07-05,2184
1459,聯發,12,0,12,亞東-新竹,2023-07-05,2184
2609,陽明,30,18,12,亞東-新竹,2023-07-05,2184
3682,亞太電,12,0,12,亞東-新竹,2023-07-05,2184
8049,晶采,12,0,12,亞東-新竹,2023-07-05,2184
2618,長榮航,32,21,11,亞東-新竹,2023-07-05,2184
00887,永豐中國科技50大,10,0,10,亞東-新竹,2023-07-05,2184
1310,台苯,10,0,10,亞東-新竹,2023-07-05,2184
00680L,元大美債20正2,10,0,10,亞東-新竹,2023-07-05,2184
00724B,群益投資級金融債,10,0,10,亞東-新竹,2023-07-05,2184
1905,華紙,10,0,10,亞東-新竹,2023-07-05,2184
4120,友華,10,0,10,亞東-新竹,2023-07-05,2184
6288,聯嘉,10,0,10,亞東-新竹,2023-07-05,2184
9955,佳龍,10,0,10,亞東-新竹,2023-07-05,2184
9962,有益,10,0,10,亞東-新竹,2023-07-05,2184
2106,建大,7,0,7,亞東-新竹,2023-07-05,2184
5439,高技,7,0,7,亞東-新竹,2023-07-05,2184
6733,博晟生醫,7,0,7,亞東-新竹,2023-07-05,2184
1504,東元,6,0,6,亞東-新竹,2023-07-05,2184
00877,復華中國5G,6,0,6,亞東-新竹,2023-07-05,2184
2369,菱生,18,12,6,亞東-新竹,2023-07-05,2184
2449,京元電子,10,4,6,亞東-新竹,2023-07-05,2184
2880,華南金,6,0,6,亞東-新竹,2023-07-05,2184
3036,文曄,5,0,5,亞東-新竹,2023-07-05,2184
1316,上曜,5,0,5,亞東-新竹,2023-07-05,2184
00882,中信中國高股息,5,0,5,亞東-新竹,2023-07-05,2184
2206,三陽工業,6,1,5,亞東-新竹,2023-07-05,2184
2542,興富發,5,0,5,亞東-新竹,2023-07-05,2184
2548,華固,5,0,5,亞東-新竹,2023-07-05,2184
2888,新光金,5,0,5,亞東-新竹,2023-07-05,2184
3006,晶豪科,5,0,5,亞東-新竹,2023-07-05,2184
3372,典範,16,11,5,亞東-新竹,2023-07-05,2184
00772B,中信高評級公司債,295,0,295,亞東-新竹,2023-07-06,2184
2882,國泰金,214,0,214,亞東-新竹,2023-07-06,2184
00720B,元大投資級公司債,181,0,181,亞東-新竹,2023-07-06,2184
00919,群益台灣精選高息,121,7,114,亞東-新竹,2023-07-06,2184
6163,華電網,90,0,90,亞東-新竹,2023-07-06,2184
00751B,元大AAA至A公司債,89,0,89,亞東-新竹,2023-07-06,2184
3027,盛達,68,3,65,亞東-新竹,2023-07-06,2184
4904,遠傳,50,0,50,亞東-新竹,2023-07-06,2184
2002,中鋼,44,0,44,亞東-新竹,2023-07-06,2184
2317,鴻海,41,0,41,亞東-新竹,2023-07-06,2184
3022,威強電,40,0,40,亞東-新竹,2023-07-06,2184
5388,中磊,40,0,40,亞東-新竹,2023-07-06,2184
8215,明基材,40,0,40,亞東-新竹,2023-07-06,2184
0056,元大高股息,31,0,31,亞東-新竹,2023-07-06,2184
2884,玉山金,31,0,31,亞東-新竹,2023-07-06,2184
2887,台新金,29,0,29,亞東-新竹,2023-07-06,2184
00888,永豐台灣ESG,27,0,27,亞東-新竹,2023-07-06,2184
00892,富邦台灣半導體,24,0,24,亞東-新竹,2023-07-06,2184
1609,大亞,25,1,24,亞東-新竹,2023-07-06,2184
1301,台塑,20,0,20,亞東-新竹,2023-07-06,2184
2323,中環,20,0,20,亞東-新竹,2023-07-06,2184
2929,淘帝-KY,20,0,20,亞東-新竹,2023-07-06,2184
6770,力積電,19,0,19,亞東-新竹,2023-07-06,2184
9904,寶成,18,0,18,亞東-新竹,2023-07-06,2184
2356,英業達,19,3,16,亞東-新竹,2023-07-06,2184
4541,晟田,17,1,16,亞東-新竹,2023-07-06,2184
00679B,元大美債20年,15,0,15,亞東-新竹,2023-07-06,2184
3587,閎康,15,1,14,亞東-新竹,2023-07-06,2184
1402,遠東新,13,1,12,亞東-新竹,2023-07-06,2184
00882,中信中國高股息,12,0,12,亞東-新竹,2023-07-06,2184
2812,台中銀,226,215,11,亞東-新竹,2023-07-06,2184
6142,友勁,11,0,11,亞東-新竹,2023-07-06,2184
00640L,富邦日本正2,10,0,10,亞東-新竹,2023-07-06,2184
00673R,期元大S＆P原油反1,10,0,10,亞東-新竹,2023-07-06,2184
1909,榮成,10,0,10,亞東-新竹,2023-07-06,2184
2888,新光金,10,0,10,亞東-新竹,2023-07-06,2184
2889,國票金,10,0,10,亞東-新竹,2023-07-06,2184
9908,大台北,10,0,10,亞東-新竹,2023-07-06,2184
2330,台積電,15,5,10,亞東-新竹,2023-07-06,2184
4951,精拓科,9,0,9,亞東-新竹,2023-07-06,2184
1326,台化,9,0,9,亞東-新竹,2023-07-06,2184
2409,友達,28,20,8,亞東-新竹,2023-07-06,2184
4566,時碩工業,8,0,8,亞東-新竹,2023-07-06,2184
1101,台泥,9,2,7,亞東-新竹,2023-07-06,2184
00929,復華台灣科技優息,7,0,7,亞東-新竹,2023-07-06,2184
2885,元大金,7,0,7,亞東-新竹,2023-07-06,2184
3522,御嵿,7,0,7,亞東-新竹,2023-07-06,2184
00753L,中信中國50正2,6,0,6,亞東-新竹,2023-07-06,2184
00675L,富邦臺灣加權正2,6,0,6,亞東-新竹,2023-07-06,2184
2328,廣宇,6,0,6,亞東-新竹,2023-07-06,2184
6005,群益證,470,270,200,亞東-新竹,2023-07-07,2184
00712,復華富時不動產,105,0,105,亞東-新竹,2023-07-07,2184
00772B,中信高評級公司債,104,0,104,亞東-新竹,2023-07-07,2184
00720B,元大投資級公司債,52,0,52,亞東-新竹,2023-07-07,2184
1809,中釉,103,53,50,亞東-新竹,2023-07-07,2184
2323,中環,62,20,42,亞東-新竹,2023-07-07,2184
00888,永豐台灣ESG,41,0,41,亞東-新竹,2023-07-07,2184
2867,三商壽,38,0,38,亞東-新竹,2023-07-07,2184
00751B,元大AAA至A公司債,32,0,32,亞東-新竹,2023-07-07,2184
6443,元晶,28,0,28,亞東-新竹,2023-07-07,2184
2610,華航,48,24,24,亞東-新竹,2023-07-07,2184
1218,泰山,20,0,20,亞東-新竹,2023-07-07,2184
00892,富邦台灣半導體,20,0,20,亞東-新竹,2023-07-07,2184
00679B,元大美債20年,20,0,20,亞東-新竹,2023-07-07,2184
00632R,元大台灣50反1,20,0,20,亞東-新竹,2023-07-07,2184
2489,瑞軒,20,0,20,亞東-新竹,2023-07-07,2184
2888,新光金,20,0,20,亞東-新竹,2023-07-07,2184
8215,明基材,20,0,20,亞東-新竹,2023-07-07,2184
3287,廣寰科,19,0,19,亞東-新竹,2023-07-07,2184
0056,元大高股息,26,9,17,亞東-新竹,2023-07-07,2184
00878,國泰永續高股息,38,21,17,亞東-新竹,2023-07-07,2184
1402,遠東新,17,0,17,亞東-新竹,2023-07-07,2184
2344,華邦電,28,11,17,亞東-新竹,2023-07-07,2184
3706,神達,19,2,17,亞東-新竹,2023-07-07,2184
5328,華容,16,0,16,亞東-新竹,2023-07-07,2184
1611,中電,15,0,15,亞東-新竹,2023-07-07,2184
1234,黑松,13,0,13,亞東-新竹,2023-07-07,2184
2855,統一證,13,0,13,亞東-新竹,2023-07-07,2184
5706,鳳凰,13,0,13,亞東-新竹,2023-07-07,2184
2929,淘帝-KY,12,0,12,亞東-新竹,2023-07-07,2184
6176,瑞儀,12,0,12,亞東-新竹,2023-07-07,2184
2002,中鋼,11,0,11,亞東-新竹,2023-07-07,2184
00713,元大台灣高息低波,11,0,11,亞東-新竹,2023-07-07,2184
00680L,元大美債20正2,10,0,10,亞東-新竹,2023-07-07,2184
00676R,富邦臺灣加權反1,10,0,10,亞東-新竹,2023-07-07,2184
4532,瑞智,21,11,10,亞東-新竹,2023-07-07,2184
4533,協易機,10,0,10,亞東-新竹,2023-07-07,2184
4538,大詠城,10,0,10,亞東-新竹,2023-07-07,2184
2330,台積電,9,0,9,亞東-新竹,2023-07-07,2184
00929,復華台灣科技優息,9,0,9,亞東-新竹,2023-07-07,2184
3522,御嵿,9,0,9,亞東-新竹,2023-07-07,2184
2634,漢翔,9,1,8,亞東-新竹,2023-07-07,2184
3363,上詮,10,2,8,亞東-新竹,2023-07-07,2184
4919,新唐,8,1,7,亞東-新竹,2023-07-07,2184
00919,群益台灣精選高息,7,0,7,亞東-新竹,2023-07-07,2184
00673R,期元大S＆P原油反1,7,0,7,亞東-新竹,2023-07-07,2184
2340,台亞,15,8,7,亞東-新竹,2023-07-07,2184
2880,華南金,7,0,7,亞東-新竹,2023-07-07,2184
2886,兆豐金,9,2,7,亞東-新竹,2023-07-07,2184
8046,南電,7,0,7,亞東-新竹,2023-07-07,2184
00632R,元大台灣50反1,404,0,404,亞東-新竹,2023-07-10,2184
1402,遠東新,61,0,61,亞東-新竹,2023-07-10,2184
2882,國泰金,57,1,56,亞東-新竹,2023-07-10,2184
00673R,期元大S＆P原油反1,50,0,50,亞東-新竹,2023-07-10,2184
2610,華航,76,34,42,亞東-新竹,2023-07-10,2184
1611,中電,35,0,35,亞東-新竹,2023-07-10,2184
6248,沛波,29,0,29,亞東-新竹,2023-07-10,2184
2618,長榮航,35,10,25,亞東-新竹,2023-07-10,2184
2356,英業達,24,2,22,亞東-新竹,2023-07-10,2184
1101,台泥,22,1,21,亞東-新竹,2023-07-10,2184
2324,仁寶,21,0,21,亞東-新竹,2023-07-10,2184
00675L,富邦臺灣加權正2,20,0,20,亞東-新竹,2023-07-10,2184
00895,富邦未來車,19,0,19,亞東-新竹,2023-07-10,2184
3504,揚明光,20,2,18,亞東-新竹,2023-07-10,2184
00751B,元大AAA至A公司債,16,0,16,亞東-新竹,2023-07-10,2184
4906,正文,15,0,15,亞東-新竹,2023-07-10,2184
4934,太極,15,0,15,亞東-新竹,2023-07-10,2184
00679B,元大美債20年,14,1,13,亞東-新竹,2023-07-10,2184
4533,協易機,13,0,13,亞東-新竹,2023-07-10,2184
2303,聯電,17,5,12,亞東-新竹,2023-07-10,2184
3535,晶彩科,12,0,12,亞東-新竹,2023-07-10,2184
00687B,國泰20年美債,11,0,11,亞東-新竹,2023-07-10,2184
2201,裕隆,21,10,11,亞東-新竹,2023-07-10,2184
6024,群益期,10,0,10,亞東-新竹,2023-07-10,2184
00680L,元大美債20正2,10,0,10,亞東-新竹,2023-07-10,2184
2886,兆豐金,10,0,10,亞東-新竹,2023-07-10,2184
4526,東台,10,0,10,亞東-新竹,2023-07-10,2184
6026,福邦證,10,0,10,亞東-新竹,2023-07-10,2184
2457,飛宏,16,7,9,亞東-新竹,2023-07-10,2184
2880,華南金,9,0,9,亞東-新竹,2023-07-10,2184
3013,晟銘電,9,0,9,亞東-新竹,2023-07-10,2184
00877,復華中國5G,8,0,8,亞東-新竹,2023-07-10,2184
3706,神達,12,4,8,亞東-新竹,2023-07-10,2184
6112,邁達特,8,0,8,亞東-新竹,2023-07-10,2184
2317,鴻海,7,0,7,亞東-新竹,2023-07-10,2184
2468,華經,8,1,7,亞東-新竹,2023-07-10,2184
4904,遠傳,7,0,7,亞東-新竹,2023-07-10,2184
8071,能率網通,7,0,7,亞東-新竹,2023-07-10,2184
2328,廣宇,6,0,6,亞東-新竹,2023-07-10,2184
4147,中裕,12,6,6,亞東-新竹,2023-07-10,2184
00772B,中信高評級公司債,5,0,5,亞東-新竹,2023-07-10,2184
00892,富邦台灣半導體,5,0,5,亞東-新竹,2023-07-10,2184
2412,中華電,5,0,5,亞東-新竹,2023-07-10,2184
2855,統一證,5,0,5,亞東-新竹,2023-07-10,2184
2887,台新金,5,0,5,亞東-新竹,2023-07-10,2184
2929,淘帝-KY,5,0,5,亞東-新竹,2023-07-10,2184
3228,金麗科,5,0,5,亞東-新竹,2023-07-10,2184
3289,宜特,6,1,5,亞東-新竹,2023-07-10,2184
4938,和碩,5,0,5,亞東-新竹,2023-07-10,2184
5607,遠雄港,14,9,5,亞東-新竹,2023-07-10,2184
00712,復華富時不動產,101,0,101,亞東-新竹,2023-07-11,2184
6163,華電網,61,0,61,亞東-新竹,2023-07-11,2184
5876,上海商銀,41,0,41,亞東-新竹,2023-07-11,2184
1460,宏遠,40,0,40,亞東-新竹,2023-07-11,2184
00757,統一FANG+,30,0,30,亞東-新竹,2023-07-11,2184
2368,金像電,27,2,25,亞東-新竹,2023-07-11,2184
4532,瑞智,42,20,22,亞東-新竹,2023-07-11,2184
1785,光洋科,18,0,18,亞東-新竹,2023-07-11,2184
2323,中環,48,30,18,亞東-新竹,2023-07-11,2184
4538,大詠城,17,0,17,亞東-新竹,2023-07-11,2184
2340,台亞,33,19,14,亞東-新竹,2023-07-11,2184
00679B,元大美債20年,13,0,13,亞東-新竹,2023-07-11,2184
1611,中電,12,0,12,亞東-新竹,2023-07-11,2184
4934,太極,13,2,11,亞東-新竹,2023-07-11,2184
3034,聯詠,15,5,10,亞東-新竹,2023-07-11,2184
5009,榮剛,10,0,10,亞東-新竹,2023-07-11,2184
8011,台通,10,0,10,亞東-新竹,2023-07-11,2184
2457,飛宏,13,5,8,亞東-新竹,2023-07-11,2184
2337,旺宏,8,0,8,亞東-新竹,2023-07-11,2184
2201,裕隆,11,4,7,亞東-新竹,2023-07-11,2184
3522,御嵿,6,0,6,亞東-新竹,2023-07-11,2184
4105,東洋,6,0,6,亞東-新竹,2023-07-11,2184
5425,台半,10,4,6,亞東-新竹,2023-07-11,2184
6188,廣明,6,0,6,亞東-新竹,2023-07-11,2184
1504,東元,5,0,5,亞東-新竹,2023-07-11,2184
1515,力山,5,0,5,亞東-新竹,2023-07-11,2184
00763U,期街口道瓊銅,5,0,5,亞東-新竹,2023-07-11,2184
1718,中纖,5,0,5,亞東-新竹,2023-07-11,2184
3141,晶宏,5,0,5,亞東-新竹,2023-07-11,2184
3511,矽瑪,5,0,5,亞東-新竹,2023-07-11,2184
6023,元大期,5,0,5,亞東-新竹,2023-07-11,2184
00673R,期元大S＆P原油反1,4,0,4,亞東-新竹,2023-07-11,2184
00887,永豐中國科技50大,4,0,4,亞東-新竹,2023-07-11,2184
3515,華擎,4,0,4,亞東-新竹,2023-07-11,2184
4157,太景*-KY,4,0,4,亞東-新竹,2023-07-11,2184
4541,晟田,5,1,4,亞東-新竹,2023-07-11,2184
1301,台塑,3,0,3,亞東-新竹,2023-07-11,2184
00877,復華中國5G,3,0,3,亞東-新竹,2023-07-11,2184
2303,聯電,14,11,3,亞東-新竹,2023-07-11,2184
2388,威盛,5,2,3,亞東-新竹,2023-07-11,2184
3535,晶彩科,3,0,3,亞東-新竹,2023-07-11,2184
3703,欣陸,3,0,3,亞東-新竹,2023-07-11,2184
5263,智崴,3,0,3,亞東-新竹,2023-07-11,2184
6276,安鈦克,3,0,3,亞東-新竹,2023-07-11,2184
6733,博晟生醫,3,0,3,亞東-新竹,2023-07-11,2184
8034,榮群,3,0,3,亞東-新竹,2023-07-11,2184
8938,明安,3,0,3,亞東-新竹,2023-07-11,2184
3661,世芯-KY,2,0,2,亞東-新竹,2023-07-11,2184
8478,東哥遊艇,2,0,2,亞東-新竹,2023-07-11,2184
1319,東陽,2,0,2,亞東-新竹,2023-07-11,2184
2845,遠東銀,101,0,101,亞東-新竹,2023-07-12,2184
8069,元太,60,0,60,亞東-新竹,2023-07-12,2184
00673R,期元大S＆P原油反1,54,0,54,亞東-新竹,2023-07-12,2184
5439,高技,54,1,53,亞東-新竹,2023-07-12,2184
6005,群益證,50,0,50,亞東-新竹,2023-07-12,2184
00679B,元大美債20年,47,0,47,亞東-新竹,2023-07-12,2184
1737,臺鹽,33,0,33,亞東-新竹,2023-07-12,2184
2317,鴻海,37,5,32,亞東-新竹,2023-07-12,2184
1809,中釉,30,0,30,亞東-新竹,2023-07-12,2184
2610,華航,54,26,28,亞東-新竹,2023-07-12,2184
2888,新光金,28,0,28,亞東-新竹,2023-07-12,2184
8210,勤誠,26,1,25,亞東-新竹,2023-07-12,2184
6139,亞翔,25,2,23,亞東-新竹,2023-07-12,2184
00929,復華台灣科技優息,20,0,20,亞東-新竹,2023-07-12,2184
2368,金像電,21,1,20,亞東-新竹,2023-07-12,2184
6218,豪勉,34,16,18,亞東-新竹,2023-07-12,2184
3535,晶彩科,16,0,16,亞東-新竹,2023-07-12,2184
2303,聯電,24,10,14,亞東-新竹,2023-07-12,2184
2356,英業達,44,30,14,亞東-新竹,2023-07-12,2184
3706,神達,31,18,13,亞東-新竹,2023-07-12,2184
5457,宣德,36,24,12,亞東-新竹,2023-07-12,2184
1402,遠東新,12,1,11,亞東-新竹,2023-07-12,2184
4908,前鼎,11,0,11,亞東-新竹,2023-07-12,2184
8433,弘帆,11,0,11,亞東-新竹,2023-07-12,2184
2002,中鋼,11,1,10,亞東-新竹,2023-07-12,2184
00687B,國泰20年美債,10,0,10,亞東-新竹,2023-07-12,2184
00882,中信中國高股息,10,0,10,亞東-新竹,2023-07-12,2184
2380,虹光,10,0,10,亞東-新竹,2023-07-12,2184
2838,聯邦銀,10,0,10,亞東-新竹,2023-07-12,2184
4953,緯軟,11,1,10,亞東-新竹,2023-07-12,2184
2399,映泰,11,2,9,亞東-新竹,2023-07-12,2184
6168,宏齊,9,0,9,亞東-新竹,2023-07-12,2184
2468,華經,8,0,8,亞東-新竹,2023-07-12,2184
4532,瑞智,18,10,8,亞東-新竹,2023-07-12,2184
3037,欣興,11,4,7,亞東-新竹,2023-07-12,2184
1909,榮成,7,0,7,亞東-新竹,2023-07-12,2184
2887,台新金,7,0,7,亞東-新竹,2023-07-12,2184
5706,鳳凰,7,0,7,亞東-新竹,2023-07-12,2184
2344,華邦電,23,17,6,亞東-新竹,2023-07-12,2184
2603,長榮,16,10,6,亞東-新竹,2023-07-12,2184
3289,宜特,6,0,6,亞東-新竹,2023-07-12,2184
00892,富邦台灣半導體,5,0,5,亞東-新竹,2023-07-12,2184
00885,富邦越南,5,0,5,亞東-新竹,2023-07-12,2184
2423,固緯,5,0,5,亞東-新竹,2023-07-12,2184
2444,兆勁,5,0,5,亞東-新竹,2023-07-12,2184
3287,廣寰科,27,22,5,亞東-新竹,2023-07-12,2184
4510,高鋒,5,0,5,亞東-新竹,2023-07-12,2184
4526,東台,5,0,5,亞東-新竹,2023-07-12,2184
5880,合庫金,5,0,5,亞東-新竹,2023-07-12,2184
6266,泰詠,5,0,5,亞東-新竹,2023-07-12,2184
00720B,元大投資級公司債,201,0,201,亞東-新竹,2023-07-13,2184
00929,復華台灣科技優息,108,2,106,亞東-新竹,2023-07-13,2184
2834,臺企銀,200,100,100,亞東-新竹,2023-07-13,2184
5457,宣德,60,3,57,亞東-新竹,2023-07-13,2184
8358,金居,50,0,50,亞東-新竹,2023-07-13,2184
1785,光洋科,39,0,39,亞東-新竹,2023-07-13,2184
2610,華航,123,84,39,亞東-新竹,2023-07-13,2184
00687B,國泰20年美債,33,0,33,亞東-新竹,2023-07-13,2184
00772B,中信高評級公司債,80,50,30,亞東-新竹,2023-07-13,2184
3071,協禧,30,0,30,亞東-新竹,2023-07-13,2184
2882,國泰金,44,20,24,亞東-新竹,2023-07-13,2184
9958,世紀鋼,25,1,24,亞東-新竹,2023-07-13,2184
8210,勤誠,23,1,22,亞東-新竹,2023-07-13,2184
9904,寶成,22,0,22,亞東-新竹,2023-07-13,2184
2888,新光金,20,0,20,亞東-新竹,2023-07-13,2184
2913,農林,20,0,20,亞東-新竹,2023-07-13,2184
8050,廣積,21,1,20,亞東-新竹,2023-07-13,2184
00673R,期元大S＆P原油反1,16,0,16,亞東-新竹,2023-07-13,2184
6248,沛波,16,0,16,亞東-新竹,2023-07-13,2184
3522,御嵿,14,0,14,亞東-新竹,2023-07-13,2184
6443,元晶,14,0,14,亞東-新竹,2023-07-13,2184
6139,亞翔,27,14,13,亞東-新竹,2023-07-13,2184
3264,欣銓,14,2,12,亞東-新竹,2023-07-13,2184
1301,台塑,11,0,11,亞東-新竹,2023-07-13,2184
2359,所羅門,11,0,11,亞東-新竹,2023-07-13,2184
2615,萬海,27,16,11,亞東-新竹,2023-07-13,2184
2886,兆豐金,11,0,11,亞東-新竹,2023-07-13,2184
6168,宏齊,11,0,11,亞東-新竹,2023-07-13,2184
6770,力積電,31,20,11,亞東-新竹,2023-07-13,2184
1218,泰山,10,0,10,亞東-新竹,2023-07-13,2184
00893,國泰智能電動車,11,1,10,亞東-新竹,2023-07-13,2184
2367,燿華,10,0,10,亞東-新竹,2023-07-13,2184
2855,統一證,10,0,10,亞東-新竹,2023-07-13,2184
4967,十銓,24,14,10,亞東-新竹,2023-07-13,2184
6449,鈺邦,10,0,10,亞東-新竹,2023-07-13,2184
3231,緯創,27,17,10,亞東-新竹,2023-07-13,2184
3036,文曄,9,0,9,亞東-新竹,2023-07-13,2184
2356,英業達,17,9,8,亞東-新竹,2023-07-13,2184
1609,大亞,11,4,7,亞東-新竹,2023-07-13,2184
5864,致和證,9,2,7,亞東-新竹,2023-07-13,2184
6188,廣明,11,4,7,亞東-新竹,2023-07-13,2184
00722B,群益投資級電信債,6,0,6,亞東-新竹,2023-07-13,2184
00685L,群益臺灣加權正2,6,0,6,亞東-新竹,2023-07-13,2184
2353,宏��,6,0,6,亞東-新竹,2023-07-13,2184
2516,新建,6,0,6,亞東-新竹,2023-07-13,2184
3032,偉訓,7,1,6,亞東-新竹,2023-07-13,2184
4533,協易機,6,0,6,亞東-新竹,2023-07-13,2184
1402,遠東新,6,1,5,亞東-新竹,2023-07-13,2184
2331,精英,5,0,5,亞東-新竹,2023-07-13,2184
2408,南亞科,5,0,5,亞東-新竹,2023-07-13,2184
00720B,元大投資級公司債,512,10,502,亞東-新竹,2023-07-14,2184
3231,緯創,310,5,305,亞東-新竹,2023-07-14,2184
2610,華航,271,160,111,亞東-新竹,2023-07-14,2184
00632R,元大台灣50反1,52,0,52,亞東-新竹,2023-07-14,2184
2301,光寶科,61,12,49,亞東-新竹,2023-07-14,2184
00679B,元大美債20年,41,0,41,亞東-新竹,2023-07-14,2184
5457,宣德,36,0,36,亞東-新竹,2023-07-14,2184
2402,毅嘉,33,0,33,亞東-新竹,2023-07-14,2184
00687B,國泰20年美債,31,0,31,亞東-新竹,2023-07-14,2184
00673R,期元大S＆P原油反1,28,0,28,亞東-新竹,2023-07-14,2184
2880,華南金,25,0,25,亞東-新竹,2023-07-14,2184
2436,偉詮電,22,1,21,亞東-新竹,2023-07-14,2184
00882,中信中國高股息,17,0,17,亞東-新竹,2023-07-14,2184
2481,強茂,16,0,16,亞東-新竹,2023-07-14,2184
6168,宏齊,15,0,15,亞東-新竹,2023-07-14,2184
2355,敬鵬,10,0,10,亞東-新竹,2023-07-14,2184
3052,夆典,10,0,10,亞東-新竹,2023-07-14,2184
3682,亞太電,10,0,10,亞東-新竹,2023-07-14,2184
5876,上海商銀,10,0,10,亞東-新竹,2023-07-14,2184
8070,長華*,10,0,10,亞東-新竹,2023-07-14,2184
6245,立端,9,0,9,亞東-新竹,2023-07-14,2184
1504,東元,10,2,8,亞東-新竹,2023-07-14,2184
4532,瑞智,14,6,8,亞東-新竹,2023-07-14,2184
00719B,元大美債1-3,6,0,6,亞東-新竹,2023-07-14,2184
2211,長榮鋼,6,0,6,亞東-新竹,2023-07-14,2184
3025,星通,6,0,6,亞東-新竹,2023-07-14,2184
4541,晟田,7,1,6,亞東-新竹,2023-07-14,2184
5469,瀚宇博,6,0,6,亞東-新竹,2023-07-14,2184
6505,台塑化,6,0,6,亞東-新竹,2023-07-14,2184
8049,晶采,6,0,6,亞東-新竹,2023-07-14,2184
00753L,中信中國50正2,5,0,5,亞東-新竹,2023-07-14,2184
00722B,群益投資級電信債,5,0,5,亞東-新竹,2023-07-14,2184
00929,復華台灣科技優息,5,0,5,亞東-新竹,2023-07-14,2184
1609,大亞,5,0,5,亞東-新竹,2023-07-14,2184
3296,勝德,5,0,5,亞東-新竹,2023-07-14,2184
6122,擎邦,5,0,5,亞東-新竹,2023-07-14,2184
1402,遠東新,4,0,4,亞東-新竹,2023-07-14,2184
2392,正崴,4,0,4,亞東-新竹,2023-07-14,2184
2465,麗臺,4,0,4,亞東-新竹,2023-07-14,2184
3078,僑威,13,9,4,亞東-新竹,2023-07-14,2184
6282,康舒,4,0,4,亞東-新竹,2023-07-14,2184
8050,廣積,6,2,4,亞東-新竹,2023-07-14,2184
2329,華泰,3,0,3,亞東-新竹,2023-07-14,2184
00643,群益深証中小,3,0,3,亞東-新竹,2023-07-14,2184
2368,金像電,4,1,3,亞東-新竹,2023-07-14,2184
2419,仲琦,5,2,3,亞東-新竹,2023-07-14,2184
2427,三商電,3,0,3,亞東-新竹,2023-07-14,2184
4549,桓達,3,0,3,亞東-新竹,2023-07-14,2184
5328,華容,3,0,3,亞東-新竹,2023-07-14,2184
6449,鈺邦,3,0,3,亞東-新竹,2023-07-14,2184
2885,元大金,591,21,570,亞東-新竹,2023-07-17,2184
2845,遠東銀,198,3,195,亞東-新竹,2023-07-17,2184
6282,康舒,128,13,115,亞東-新竹,2023-07-17,2184
00720B,元大投資級公司債,105,0,105,亞東-新竹,2023-07-17,2184
00929,復華台灣科技優息,66,0,66,亞東-新竹,2023-07-17,2184
1402,遠東新,61,3,58,亞東-新竹,2023-07-17,2184
00919,群益台灣精選高息,50,0,50,亞東-新竹,2023-07-17,2184
2201,裕隆,55,14,41,亞東-新竹,2023-07-17,2184
5457,宣德,39,0,39,亞東-新竹,2023-07-17,2184
2380,虹光,35,0,35,亞東-新竹,2023-07-17,2184
00878,國泰永續高股息,42,9,33,亞東-新竹,2023-07-17,2184
4538,大詠城,30,0,30,亞東-新竹,2023-07-17,2184
2897,王道銀行,26,0,26,亞東-新竹,2023-07-17,2184
3715,定穎投控,24,0,24,亞東-新竹,2023-07-17,2184
2481,強茂,26,3,23,亞東-新竹,2023-07-17,2184
2382,廣達,27,5,22,亞東-新竹,2023-07-17,2184
3703,欣陸,20,0,20,亞東-新竹,2023-07-17,2184
9802,鈺齊-KY,20,0,20,亞東-新竹,2023-07-17,2184
6015,宏遠證,18,0,18,亞東-新竹,2023-07-17,2184
1101,台泥,16,2,14,亞東-新竹,2023-07-17,2184
00753L,中信中國50正2,14,0,14,亞東-新竹,2023-07-17,2184
2211,長榮鋼,12,0,12,亞東-新竹,2023-07-17,2184
6235,華孚,11,0,11,亞東-新竹,2023-07-17,2184
00687B,國泰20年美債,10,0,10,亞東-新竹,2023-07-17,2184
3322,建舜電,10,0,10,亞東-新竹,2023-07-17,2184
3711,日月光投控,10,0,10,亞東-新竹,2023-07-17,2184
5432,新門,10,0,10,亞東-新竹,2023-07-17,2184
6138,茂達,10,0,10,亞東-新竹,2023-07-17,2184
9933,中鼎,10,0,10,亞東-新竹,2023-07-17,2184
00679B,元大美債20年,9,0,9,亞東-新竹,2023-07-17,2184
1459,聯發,9,0,9,亞東-新竹,2023-07-17,2184
3338,泰碩,9,0,9,亞東-新竹,2023-07-17,2184
2449,京元電子,13,5,8,亞東-新竹,2023-07-17,2184
1504,東元,11,3,8,亞東-新竹,2023-07-17,2184
2412,中華電,8,0,8,亞東-新竹,2023-07-17,2184
3037,欣興,8,0,8,亞東-新竹,2023-07-17,2184
3558,神準,10,2,8,亞東-新竹,2023-07-17,2184
4123,晟德,10,2,8,亞東-新竹,2023-07-17,2184
5483,中美晶,10,2,8,亞東-新竹,2023-07-17,2184
6515,穎崴,6,0,6,亞東-新竹,2023-07-17,2184
00885,富邦越南,6,0,6,亞東-新竹,2023-07-17,2184
5706,鳳凰,6,0,6,亞東-新竹,2023-07-17,2184
00673R,期元大S＆P原油反1,15,10,5,亞東-新竹,2023-07-17,2184
1326,台化,5,0,5,亞東-新竹,2023-07-17,2184
2340,台亞,7,2,5,亞東-新竹,2023-07-17,2184
3680,家登,7,2,5,亞東-新竹,2023-07-17,2184
6411,晶焱,5,0,5,亞東-新竹,2023-07-17,2184
00893,國泰智能電動車,3,0,3,亞東-新竹,2023-07-17,2184
2303,聯電,16,13,3,亞東-新竹,2023-07-17,2184
2427,三商電,5,2,3,亞東-新竹,2023-07-17,2184
2883,凱基金,800,20,780,亞東-新竹,2023-07-18,2184
4938,和碩,468,16,452,亞東-新竹,2023-07-18,2184
2885,元大金,260,20,240,亞東-新竹,2023-07-18,2184
00929,復華台灣科技優息,117,0,117,亞東-新竹,2023-07-18,2184
00720B,元大投資級公司債,107,0,107,亞東-新竹,2023-07-18,2184
2401,凌陽,40,0,40,亞東-新竹,2023-07-18,2184
2402,毅嘉,41,1,40,亞東-新竹,2023-07-18,2184
00882,中信中國高股息,38,0,38,亞東-新竹,2023-07-18,2184
2352,佳世達,56,21,35,亞東-新竹,2023-07-18,2184
3481,群創,34,0,34,亞東-新竹,2023-07-18,2184
1402,遠東新,32,0,32,亞東-新竹,2023-07-18,2184
2324,仁寶,45,16,29,亞東-新竹,2023-07-18,2184
2201,裕隆,27,2,25,亞東-新竹,2023-07-18,2184
6248,沛波,22,0,22,亞東-新竹,2023-07-18,2184
1609,大亞,23,3,20,亞東-新竹,2023-07-18,2184
2303,聯電,22,2,20,亞東-新竹,2023-07-18,2184
2312,金寶,26,6,20,亞東-新竹,2023-07-18,2184
3055,蔚華科,20,0,20,亞東-新竹,2023-07-18,2184
2468,華經,21,2,19,亞東-新竹,2023-07-18,2184
1504,東元,21,3,18,亞東-新竹,2023-07-18,2184
2204,中華,17,0,17,亞東-新竹,2023-07-18,2184
8210,勤誠,18,2,16,亞東-新竹,2023-07-18,2184
2427,三商電,21,6,15,亞東-新竹,2023-07-18,2184
3071,協禧,34,19,15,亞東-新竹,2023-07-18,2184
2340,台亞,15,1,14,亞東-新竹,2023-07-18,2184
3264,欣銓,14,0,14,亞東-新竹,2023-07-18,2184
2308,台達電,17,4,13,亞東-新竹,2023-07-18,2184
4538,大詠城,15,3,12,亞東-新竹,2023-07-18,2184
2405,輔信,12,0,12,亞東-新竹,2023-07-18,2184
8049,晶采,11,0,11,亞東-新竹,2023-07-18,2184
5457,宣德,10,0,10,亞東-新竹,2023-07-18,2184
6138,茂達,10,0,10,亞東-新竹,2023-07-18,2184
00676R,富邦臺灣加權反1,10,0,10,亞東-新竹,2023-07-18,2184
1711,永光,10,0,10,亞東-新竹,2023-07-18,2184
1785,光洋科,10,0,10,亞東-新竹,2023-07-18,2184
2354,鴻準,10,0,10,亞東-新竹,2023-07-18,2184
2412,中華電,10,0,10,亞東-新竹,2023-07-18,2184
4533,協易機,10,0,10,亞東-新竹,2023-07-18,2184
5478,智冠,10,0,10,亞東-新竹,2023-07-18,2184
6290,良維,9,0,9,亞東-新竹,2023-07-18,2184
1612,宏泰,8,0,8,亞東-新竹,2023-07-18,2184
2474,可成,9,1,8,亞東-新竹,2023-07-18,2184
3025,星通,8,0,8,亞東-新竹,2023-07-18,2184
3036,文曄,8,0,8,亞東-新竹,2023-07-18,2184
3035,智原,16,8,8,亞東-新竹,2023-07-18,2184
2409,友達,8,1,7,亞東-新竹,2023-07-18,2184
3596,智易,7,0,7,亞東-新竹,2023-07-18,2184
5263,智崴,7,0,7,亞東-新竹,2023-07-18,2184
6531,愛普*,6,0,6,亞東-新竹,2023-07-18,2184
00772B,中信高評級公司債,6,0,6,亞東-新竹,2023-07-18,2184
2885,元大金,378,0,378,亞東-新竹,2023-07-19,2184
00882,中信中國高股息,120,10,110,亞東-新竹,2023-07-19,2184
2882,國泰金,89,0,89,亞東-新竹,2023-07-19,2184
4906,正文,90,11,79,亞東-新竹,2023-07-19,2184
4538,大詠城,51,0,51,亞東-新竹,2023-07-19,2184
00878,國泰永續高股息,47,8,39,亞東-新竹,2023-07-19,2184
2303,聯電,38,0,38,亞東-新竹,2023-07-19,2184
1402,遠東新,34,0,34,亞東-新竹,2023-07-19,2184
00713,元大台灣高息低波,29,1,28,亞東-新竹,2023-07-19,2184
2380,虹光,25,0,25,亞東-新竹,2023-07-19,2184
2886,兆豐金,25,2,23,亞東-新竹,2023-07-19,2184
2362,藍天,20,0,20,亞東-新竹,2023-07-19,2184
2634,漢翔,17,0,17,亞東-新竹,2023-07-19,2184
6443,元晶,22,5,17,亞東-新竹,2023-07-19,2184
2618,長榮航,23,9,14,亞東-新竹,2023-07-19,2184
3594,磐儀,14,0,14,亞東-新竹,2023-07-19,2184
6168,宏齊,14,0,14,亞東-新竹,2023-07-19,2184
2313,華通,13,0,13,亞東-新竹,2023-07-19,2184
3706,神達,110,97,13,亞東-新竹,2023-07-19,2184
1101,台泥,11,0,11,亞東-新竹,2023-07-19,2184
00929,復華台灣科技優息,11,0,11,亞東-新竹,2023-07-19,2184
5457,宣德,10,0,10,亞東-新竹,2023-07-19,2184
2106,建大,10,0,10,亞東-新竹,2023-07-19,2184
5328,華容,20,10,10,亞東-新竹,2023-07-19,2184
5353,台林,10,0,10,亞東-新竹,2023-07-19,2184
1459,聯發,9,0,9,亞東-新竹,2023-07-19,2184
2356,英業達,54,45,9,亞東-新竹,2023-07-19,2184
5351,鈺創,14,5,9,亞東-新竹,2023-07-19,2184
2317,鴻海,8,0,8,亞東-新竹,2023-07-19,2184
2330,台積電,9,1,8,亞東-新竹,2023-07-19,2184
00893,國泰智能電動車,10,2,8,亞東-新竹,2023-07-19,2184
1909,榮成,8,0,8,亞東-新竹,2023-07-19,2184
2419,仲琦,16,8,8,亞東-新竹,2023-07-19,2184
6416,瑞祺電通,8,0,8,亞東-新竹,2023-07-19,2184
3034,聯詠,8,1,7,亞東-新竹,2023-07-19,2184
2891,中信金,13,6,7,亞東-新竹,2023-07-19,2184
3078,僑威,7,0,7,亞東-新竹,2023-07-19,2184
4128,中天,9,2,7,亞東-新竹,2023-07-19,2184
2324,仁寶,20,14,6,亞東-新竹,2023-07-19,2184
5386,青雲,13,7,6,亞東-新竹,2023-07-19,2184
00673R,期元大S＆P原油反1,6,0,6,亞東-新竹,2023-07-19,2184
2915,潤泰全,6,0,6,亞東-新竹,2023-07-19,2184
3522,御嵿,6,0,6,亞東-新竹,2023-07-19,2184
6282,康舒,12,6,6,亞東-新竹,2023-07-19,2184
00888,永豐台灣ESG,5,0,5,亞東-新竹,2023-07-19,2184
1301,台塑,5,0,5,亞東-新竹,2023-07-19,2184
1582,信錦,5,0,5,亞東-新竹,2023-07-19,2184
2605,新興,5,0,5,亞東-新竹,2023-07-19,2184
2887,台新金,5,0,5,亞東-新竹,2023-07-19,2184
3006,晶豪科,5,0,5,亞東-新竹,2023-07-19,2184
2883,凱基金,390,0,390,亞東-新竹,2023-07-20,2184
2303,聯電,73,3,70,亞東-新竹,2023-07-20,2184
1102,亞泥,57,1,56,亞東-新竹,2023-07-20,2184
2352,佳世達,47,1,46,亞東-新竹,2023-07-20,2184
4123,晟德,39,5,34,亞東-新竹,2023-07-20,2184
00680L,元大美債20正2,33,0,33,亞東-新竹,2023-07-20,2184
3011,今皓,30,0,30,亞東-新竹,2023-07-20,2184
3032,偉訓,51,22,29,亞東-新竹,2023-07-20,2184
2380,虹光,25,0,25,亞東-新竹,2023-07-20,2184
2330,台積電,22,0,22,亞東-新竹,2023-07-20,2184
5457,宣德,20,0,20,亞東-新竹,2023-07-20,2184
4919,新唐,20,1,19,亞東-新竹,2023-07-20,2184
2340,台亞,14,0,14,亞東-新竹,2023-07-20,2184
3706,神達,35,22,13,亞東-新竹,2023-07-20,2184
00773B,中信優先金融債,12,1,11,亞東-新竹,2023-07-20,2184
00888,永豐台灣ESG,11,0,11,亞東-新竹,2023-07-20,2184
2314,台揚,11,0,11,亞東-新竹,2023-07-20,2184
2449,京元電子,11,0,11,亞東-新竹,2023-07-20,2184
2420,新巨,10,0,10,亞東-新竹,2023-07-20,2184
4977,眾達-KY,10,0,10,亞東-新竹,2023-07-20,2184
6016,康和證,10,0,10,亞東-新竹,2023-07-20,2184
00929,復華台灣科技優息,9,0,9,亞東-新竹,2023-07-20,2184
3264,欣銓,19,10,9,亞東-新竹,2023-07-20,2184
3711,日月光投控,9,0,9,亞東-新竹,2023-07-20,2184
5469,瀚宇博,9,0,9,亞東-新竹,2023-07-20,2184
6531,愛普*,7,0,7,亞東-新竹,2023-07-20,2184
00882,中信中國高股息,7,0,7,亞東-新竹,2023-07-20,2184
3293,鈊象,8,1,7,亞東-新竹,2023-07-20,2184
2637,慧洋-KY,10,3,7,亞東-新竹,2023-07-20,2184
6535,順藥,7,0,7,亞東-新竹,2023-07-20,2184
6533,晶心科,5,0,5,亞東-新竹,2023-07-20,2184
00924,復華S＆P500成長,5,0,5,亞東-新竹,2023-07-20,2184
00764B,群益25年美債,5,0,5,亞東-新竹,2023-07-20,2184
2105,正新,5,0,5,亞東-新竹,2023-07-20,2184
6248,沛波,5,0,5,亞東-新竹,2023-07-20,2184
8215,明基材,45,40,5,亞東-新竹,2023-07-20,2184
8390,金益鼎,5,0,5,亞東-新竹,2023-07-20,2184
00713,元大台灣高息低波,5,1,4,亞東-新竹,2023-07-20,2184
3289,宜特,5,1,4,亞東-新竹,2023-07-20,2184
00643,群益深証中小,4,0,4,亞東-新竹,2023-07-20,2184
00893,國泰智能電動車,8,4,4,亞東-新竹,2023-07-20,2184
2458,義隆,4,0,4,亞東-新竹,2023-07-20,2184
3305,昇貿,5,1,4,亞東-新竹,2023-07-20,2184
3594,磐儀,4,0,4,亞東-新竹,2023-07-20,2184
4533,協易機,4,0,4,亞東-新竹,2023-07-20,2184
4545,銘鈺,4,0,4,亞東-新竹,2023-07-20,2184
4931,新盛力,4,0,4,亞東-新竹,2023-07-20,2184
6188,廣明,6,2,4,亞東-新竹,2023-07-20,2184
1402,遠東新,3,0,3,亞東-新竹,2023-07-20,2184
00916,國泰全球品牌50,3,0,3,亞東-新竹,2023-07-20,2184
2883,凱基金,50,0,50,亞東-新竹,2023-07-21,2184
0056,元大高股息,42,0,42,亞東-新竹,2023-07-21,2184
2303,聯電,58,19,39,亞東-新竹,2023-07-21,2184
1102,亞泥,42,10,32,亞東-新竹,2023-07-21,2184
5443,均豪,30,0,30,亞東-新竹,2023-07-21,2184
00877,復華中國5G,27,0,27,亞東-新竹,2023-07-21,2184
2380,虹光,21,0,21,亞東-新竹,2023-07-21,2184
5457,宣德,20,0,20,亞東-新竹,2023-07-21,2184
1785,光洋科,20,0,20,亞東-新竹,2023-07-21,2184
3583,辛耘,15,0,15,亞東-新竹,2023-07-21,2184
2618,長榮航,24,9,15,亞東-新竹,2023-07-21,2184
0050,元大台灣50,14,0,14,亞東-新竹,2023-07-21,2184
2382,廣達,32,18,14,亞東-新竹,2023-07-21,2184
00675L,富邦臺灣加權正2,13,0,13,亞東-新竹,2023-07-21,2184
2330,台積電,20,8,12,亞東-新竹,2023-07-21,2184
2352,佳世達,14,2,12,亞東-新竹,2023-07-21,2184
4747,強生,14,2,12,亞東-新竹,2023-07-21,2184
3013,晟銘電,11,0,11,亞東-新竹,2023-07-21,2184
3711,日月光投控,15,4,11,亞東-新竹,2023-07-21,2184
00680L,元大美債20正2,10,0,10,亞東-新竹,2023-07-21,2184
1905,華紙,10,0,10,亞東-新竹,2023-07-21,2184
2734,易飛網,10,0,10,亞東-新竹,2023-07-21,2184
5607,遠雄港,10,0,10,亞東-新竹,2023-07-21,2184
3078,僑威,10,0,10,亞東-新竹,2023-07-21,2184
2301,光寶科,9,0,9,亞東-新竹,2023-07-21,2184
1101,台泥,8,0,8,亞東-新竹,2023-07-21,2184
3037,欣興,10,2,8,亞東-新竹,2023-07-21,2184
00929,復華台灣科技優息,8,0,8,亞東-新竹,2023-07-21,2184
00893,國泰智能電動車,8,0,8,亞東-新竹,2023-07-21,2184
2377,微星,10,2,8,亞東-新竹,2023-07-21,2184
6416,瑞祺電通,8,0,8,亞東-新竹,2023-07-21,2184
00882,中信中國高股息,7,0,7,亞東-新竹,2023-07-21,2184
3522,御嵿,7,0,7,亞東-新竹,2023-07-21,2184
00830,國泰費城半導體,6,0,6,亞東-新竹,2023-07-21,2184
8299,群聯,6,0,6,亞東-新竹,2023-07-21,2184
2405,輔信,6,0,6,亞東-新竹,2023-07-21,2184
1301,台塑,6,1,5,亞東-新竹,2023-07-21,2184
00643,群益深証中小,5,0,5,亞東-新竹,2023-07-21,2184
00919,群益台灣精選高息,5,0,5,亞東-新竹,2023-07-21,2184
1710,東聯,5,0,5,亞東-新竹,2023-07-21,2184
2344,華邦電,6,1,5,亞東-新竹,2023-07-21,2184
2615,萬海,5,0,5,亞東-新竹,2023-07-21,2184
3704,合勤控,10,5,5,亞東-新竹,2023-07-21,2184
4707,磐亞,5,0,5,亞東-新竹,2023-07-21,2184
5340,建榮,5,0,5,亞東-新竹,2023-07-21,2184
5351,鈺創,5,0,5,亞東-新竹,2023-07-21,2184
6282,康舒,8,3,5,亞東-新竹,2023-07-21,2184
8201,無敵,5,0,5,亞東-新竹,2023-07-21,2184
1504,東元,5,1,4,亞東-新竹,2023-07-21,2184
2719,燦星旅,4,0,4,亞東-新竹,2023-07-21,2184
00679B,元大美債20年,92,0,92,亞東-新竹,2023-07-24,2184
6163,華電網,63,0,63,亞東-新竹,2023-07-24,2184
2323,中環,63,12,51,亞東-新竹,2023-07-24,2184
5864,致和證,35,0,35,亞東-新竹,2023-07-24,2184
6770,力積電,34,0,34,亞東-新竹,2023-07-24,2184
00929,復華台灣科技優息,30,0,30,亞東-新竹,2023-07-24,2184
00772B,中信高評級公司債,26,0,26,亞東-新竹,2023-07-24,2184
2380,虹光,25,0,25,亞東-新竹,2023-07-24,2184
2427,三商電,24,4,20,亞東-新竹,2023-07-24,2184
8222,寶一,20,0,20,亞東-新竹,2023-07-24,2184
1402,遠東新,21,2,19,亞東-新竹,2023-07-24,2184
1905,華紙,35,18,17,亞東-新竹,2023-07-24,2184
1795,美時,15,0,15,亞東-新竹,2023-07-24,2184
3535,晶彩科,15,0,15,亞東-新竹,2023-07-24,2184
00757,統一FANG+,14,0,14,亞東-新竹,2023-07-24,2184
3357,臺慶科,15,1,14,亞東-新竹,2023-07-24,2184
1785,光洋科,11,0,11,亞東-新竹,2023-07-24,2184
2368,金像電,42,31,11,亞東-新竹,2023-07-24,2184
1102,亞泥,15,5,10,亞東-新竹,2023-07-24,2184
2002,中鋼,10,0,10,亞東-新竹,2023-07-24,2184
6026,福邦證,10,0,10,亞東-新竹,2023-07-24,2184
2405,輔信,10,0,10,亞東-新竹,2023-07-24,2184
2409,友達,10,0,10,亞東-新竹,2023-07-24,2184
2328,廣宇,9,0,9,亞東-新竹,2023-07-24,2184
2353,宏��,28,19,9,亞東-新竹,2023-07-24,2184
2356,英業達,19,10,9,亞東-新竹,2023-07-24,2184
2442,新美齊,9,0,9,亞東-新竹,2023-07-24,2184
3013,晟銘電,21,12,9,亞東-新竹,2023-07-24,2184
5457,宣德,9,0,9,亞東-新竹,2023-07-24,2184
6125,廣運,12,3,9,亞東-新竹,2023-07-24,2184
2882,國泰金,8,0,8,亞東-新竹,2023-07-24,2184
1710,東聯,8,0,8,亞東-新竹,2023-07-24,2184
00885,富邦越南,8,0,8,亞東-新竹,2023-07-24,2184
3035,智原,20,12,8,亞東-新竹,2023-07-24,2184
3592,瑞鼎,8,0,8,亞東-新竹,2023-07-24,2184
2887,台新金,13,7,6,亞東-新竹,2023-07-24,2184
2352,佳世達,6,0,6,亞東-新竹,2023-07-24,2184
2886,兆豐金,6,0,6,亞東-新竹,2023-07-24,2184
3689,湧德,6,0,6,亞東-新竹,2023-07-24,2184
5706,鳳凰,6,0,6,亞東-新竹,2023-07-24,2184
6168,宏齊,6,0,6,亞東-新竹,2023-07-24,2184
2337,旺宏,5,0,5,亞東-新竹,2023-07-24,2184
2344,華邦電,5,0,5,亞東-新竹,2023-07-24,2184
2449,京元電子,5,0,5,亞東-新竹,2023-07-24,2184
2609,陽明,5,0,5,亞東-新竹,2023-07-24,2184
3338,泰碩,7,2,5,亞東-新竹,2023-07-24,2184
4128,中天,5,0,5,亞東-新竹,2023-07-24,2184
6282,康舒,20,15,5,亞東-新竹,2023-07-24,2184
6684,安格,5,0,5,亞東-新竹,2023-07-24,2184
8049,晶采,5,0,5,亞東-新竹,2023-07-24,2184
2634,漢翔,101,0,101,亞東-新竹,2023-07-25,2184
00673R,期元大S＆P原油反1,72,0,72,亞東-新竹,2023-07-25,2184
2618,長榮航,62,7,55,亞東-新竹,2023-07-25,2184
2324,仁寶,55,12,43,亞東-新竹,2023-07-25,2184
0056,元大高股息,44,6,38,亞東-新竹,2023-07-25,2184
2913,農林,25,0,25,亞東-新竹,2023-07-25,2184
00712,復華富時不動產,24,0,24,亞東-新竹,2023-07-25,2184
00929,復華台灣科技優息,20,0,20,亞東-新竹,2023-07-25,2184
00885,富邦越南,20,0,20,亞東-新竹,2023-07-25,2184
2427,三商電,19,0,19,亞東-新竹,2023-07-25,2184
2340,台亞,20,2,18,亞東-新竹,2023-07-25,2184
1301,台塑,16,0,16,亞東-新竹,2023-07-25,2184
2380,虹光,16,0,16,亞東-新竹,2023-07-25,2184
9958,世紀鋼,12,0,12,亞東-新竹,2023-07-25,2184
2834,臺企銀,11,0,11,亞東-新竹,2023-07-25,2184
3702,大聯大,11,0,11,亞東-新竹,2023-07-25,2184
2851,中再保,10,0,10,亞東-新竹,2023-07-25,2184
6217,中探針,10,0,10,亞東-新竹,2023-07-25,2184
1402,遠東新,11,2,9,亞東-新竹,2023-07-25,2184
2354,鴻準,10,1,9,亞東-新竹,2023-07-25,2184
8924,大田,9,0,9,亞東-新竹,2023-07-25,2184
5457,宣德,8,0,8,亞東-新竹,2023-07-25,2184
6285,啟��,12,5,7,亞東-新竹,2023-07-25,2184
1710,東聯,7,0,7,亞東-新竹,2023-07-25,2184
2420,新巨,7,0,7,亞東-新竹,2023-07-25,2184
3406,玉晶光,7,0,7,亞東-新竹,2023-07-25,2184
3078,僑威,7,0,7,亞東-新竹,2023-07-25,2184
2382,廣達,20,13,7,亞東-新竹,2023-07-25,2184
1503,士電,6,0,6,亞東-新竹,2023-07-25,2184
1532,勤美,6,0,6,亞東-新竹,2023-07-25,2184
3024,憶聲,6,0,6,亞東-新竹,2023-07-25,2184
3704,合勤控,6,0,6,亞東-新竹,2023-07-25,2184
8996,高力,5,0,5,亞東-新竹,2023-07-25,2184
00679B,元大美債20年,5,0,5,亞東-新竹,2023-07-25,2184
2812,台中銀,5,0,5,亞東-新竹,2023-07-25,2184
3025,星通,5,0,5,亞東-新竹,2023-07-25,2184
3231,緯創,13,8,5,亞東-新竹,2023-07-25,2184
8028,昇陽半導體,5,0,5,亞東-新竹,2023-07-25,2184
8069,元太,5,0,5,亞東-新竹,2023-07-25,2184
9933,中鼎,5,0,5,亞東-新竹,2023-07-25,2184
00720B,元大投資級公司債,4,0,4,亞東-新竹,2023-07-25,2184
2363,矽統,4,0,4,亞東-新竹,2023-07-25,2184
2376,技嘉,21,17,4,亞東-新竹,2023-07-25,2184
3706,神達,8,4,4,亞東-新竹,2023-07-25,2184
3037,欣興,24,21,3,亞東-新竹,2023-07-25,2184
3443,創意,6,3,3,亞東-新竹,2023-07-25,2184
2886,兆豐金,3,0,3,亞東-新竹,2023-07-25,2184
3105,穩懋,3,0,3,亞東-新竹,2023-07-25,2184
3703,欣陸,3,0,3,亞東-新竹,2023-07-25,2184
5706,鳳凰,3,0,3,亞東-新竹,2023-07-25,2184
6005,群益證,1152,268,884,亞東-新竹,2023-07-26,2184
00720B,元大投資級公司債,202,0,202,亞東-新竹,2023-07-26,2184
2883,凱基金,127,0,127,亞東-新竹,2023-07-26,2184
1108,幸福,70,0,70,亞東-新竹,2023-07-26,2184
1504,東元,56,19,37,亞東-新竹,2023-07-26,2184
4726,永昕,43,8,35,亞東-新竹,2023-07-26,2184
8358,金居,30,2,28,亞東-新竹,2023-07-26,2184
2201,裕隆,27,1,26,亞東-新竹,2023-07-26,2184
00673R,期元大S＆P原油反1,20,0,20,亞東-新竹,2023-07-26,2184
00772B,中信高評級公司債,17,0,17,亞東-新竹,2023-07-26,2184
2352,佳世達,18,1,17,亞東-新竹,2023-07-26,2184
4938,和碩,20,3,17,亞東-新竹,2023-07-26,2184
00712,復華富時不動產,16,0,16,亞東-新竹,2023-07-26,2184
2887,台新金,15,0,15,亞東-新竹,2023-07-26,2184
9914,美利達,15,0,15,亞東-新竹,2023-07-26,2184
2855,統一證,14,0,14,亞東-新竹,2023-07-26,2184
6271,同欣電,13,0,13,亞東-新竹,2023-07-26,2184
5203,訊連,12,0,12,亞東-新竹,2023-07-26,2184
2338,光罩,12,1,11,亞東-新竹,2023-07-26,2184
3055,蔚華科,21,10,11,亞東-新竹,2023-07-26,2184
2303,聯電,14,4,10,亞東-新竹,2023-07-26,2184
6104,創惟,10,0,10,亞東-新竹,2023-07-26,2184
00882,中信中國高股息,10,0,10,亞東-新竹,2023-07-26,2184
00892,富邦台灣半導體,10,0,10,亞東-新竹,2023-07-26,2184
2331,精英,10,0,10,亞東-新竹,2023-07-26,2184
2380,虹光,10,0,10,亞東-新竹,2023-07-26,2184
3548,兆利,10,0,10,亞東-新竹,2023-07-26,2184
5531,鄉林,10,0,10,亞東-新竹,2023-07-26,2184
8049,晶采,10,0,10,亞東-新竹,2023-07-26,2184
2634,漢翔,9,0,9,亞東-新竹,2023-07-26,2184
2880,華南金,9,0,9,亞東-新竹,2023-07-26,2184
2328,廣宇,8,0,8,亞東-新竹,2023-07-26,2184
2329,華泰,35,27,8,亞東-新竹,2023-07-26,2184
4188,安克,8,0,8,亞東-新竹,2023-07-26,2184
6472,保瑞,8,0,8,亞東-新竹,2023-07-26,2184
5483,中美晶,9,1,8,亞東-新竹,2023-07-26,2184
2337,旺宏,7,0,7,亞東-新竹,2023-07-26,2184
2356,英業達,15,8,7,亞東-新竹,2023-07-26,2184
4116,明基醫,7,0,7,亞東-新竹,2023-07-26,2184
6443,元晶,7,0,7,亞東-新竹,2023-07-26,2184
6535,順藥,7,0,7,亞東-新竹,2023-07-26,2184
2330,台積電,7,1,6,亞東-新竹,2023-07-26,2184
1815,富喬,6,0,6,亞東-新竹,2023-07-26,2184
00679B,元大美債20年,6,0,6,亞東-新竹,2023-07-26,2184
2344,華邦電,6,0,6,亞東-新竹,2023-07-26,2184
6213,聯茂,7,1,6,亞東-新竹,2023-07-26,2184
8924,大田,6,0,6,亞東-新竹,2023-07-26,2184
3105,穩懋,6,0,6,亞東-新竹,2023-07-26,2184
00877,復華中國5G,5,0,5,亞東-新竹,2023-07-26,2184
00751B,元大AAA至A公司債,5,0,5,亞東-新竹,2023-07-26,2184
2002,中鋼,104,1,103,亞東-新竹,2023-07-27,2184
00878,國泰永續高股息,101,10,91,亞東-新竹,2023-07-27,2184
00712,復華富時不動產,36,0,36,亞東-新竹,2023-07-27,2184
2301,光寶科,34,4,30,亞東-新竹,2023-07-27,2184
2392,正崴,30,0,30,亞東-新竹,2023-07-27,2184
3693,營邦,30,0,30,亞東-新竹,2023-07-27,2184
00650L,復華香港正2,25,0,25,亞東-新竹,2023-07-27,2184
3029,零壹,27,2,25,亞東-新竹,2023-07-27,2184
00753L,中信中國50正2,24,0,24,亞東-新竹,2023-07-27,2184
2610,華航,33,10,23,亞東-新竹,2023-07-27,2184
8358,金居,25,2,23,亞東-新竹,2023-07-27,2184
00673R,期元大S＆P原油反1,21,0,21,亞東-新竹,2023-07-27,2184
2332,友訊,20,0,20,亞東-新竹,2023-07-27,2184
3702,大聯大,20,0,20,亞東-新竹,2023-07-27,2184
0056,元大高股息,24,7,17,亞東-新竹,2023-07-27,2184
3055,蔚華科,20,5,15,亞東-新竹,2023-07-27,2184
2884,玉山金,14,0,14,亞東-新竹,2023-07-27,2184
5285,界霖,14,0,14,亞東-新竹,2023-07-27,2184
2421,建準,16,3,13,亞東-新竹,2023-07-27,2184
3576,聯合再生,10,0,10,亞東-新竹,2023-07-27,2184
5203,訊連,10,0,10,亞東-新竹,2023-07-27,2184
3231,緯創,15,6,9,亞東-新竹,2023-07-27,2184
1314,中石化,8,0,8,亞東-新竹,2023-07-27,2184
4541,晟田,8,0,8,亞東-新竹,2023-07-27,2184
2356,英業達,20,14,6,亞東-新竹,2023-07-27,2184
2442,新美齊,6,0,6,亞東-新竹,2023-07-27,2184
2468,華經,11,5,6,亞東-新竹,2023-07-27,2184
4157,太景*-KY,6,0,6,亞東-新竹,2023-07-27,2184
4938,和碩,8,2,6,亞東-新竹,2023-07-27,2184
3037,欣興,15,10,5,亞東-新竹,2023-07-27,2184
2608,嘉里大榮,5,0,5,亞東-新竹,2023-07-27,2184
3013,晟銘電,8,3,5,亞東-新竹,2023-07-27,2184
3033,威健,5,0,5,亞東-新竹,2023-07-27,2184
6223,旺矽,4,0,4,亞東-新竹,2023-07-27,2184
00916,國泰全球品牌50,4,0,4,亞東-新竹,2023-07-27,2184
00757,統一FANG+,4,0,4,亞東-新竹,2023-07-27,2184
1587,吉茂,4,0,4,亞東-新竹,2023-07-27,2184
2382,廣達,30,26,4,亞東-新竹,2023-07-27,2184
2887,台新金,4,0,4,亞東-新竹,2023-07-27,2184
2913,農林,5,1,4,亞東-新竹,2023-07-27,2184
6416,瑞祺電通,4,0,4,亞東-新竹,2023-07-27,2184
8050,廣積,4,0,4,亞東-新竹,2023-07-27,2184
2317,鴻海,4,0,4,亞東-新竹,2023-07-27,2184
6188,廣明,5,1,4,亞東-新竹,2023-07-27,2184
8478,東哥遊艇,15,12,3,亞東-新竹,2023-07-27,2184
2027,大成鋼,10,7,3,亞東-新竹,2023-07-27,2184
00752,中信中國50,3,0,3,亞東-新竹,2023-07-27,2184
00877,復華中國5G,3,0,3,亞東-新竹,2023-07-27,2184
00927,群益半導體收益,3,0,3,亞東-新竹,2023-07-27,2184
2338,光罩,3,0,3,亞東-新竹,2023-07-27,2184
2883,凱基金,114,0,114,亞東-新竹,2023-07-28,2184
00720B,元大投資級公司債,60,0,60,亞東-新竹,2023-07-28,2184
1802,台玻,57,0,57,亞東-新竹,2023-07-28,2184
2301,光寶科,42,5,37,亞東-新竹,2023-07-28,2184
1229,聯華,37,0,37,亞東-新竹,2023-07-28,2184
00679B,元大美債20年,31,0,31,亞東-新竹,2023-07-28,2184
2610,華航,65,40,25,亞東-新竹,2023-07-28,2184
8105,凌巨,25,0,25,亞東-新竹,2023-07-28,2184
6535,順藥,25,9,16,亞東-新竹,2023-07-28,2184
6223,旺矽,15,0,15,亞東-新竹,2023-07-28,2184
3706,神達,37,23,14,亞東-新竹,2023-07-28,2184
2362,藍天,13,0,13,亞東-新竹,2023-07-28,2184
2913,農林,14,1,13,亞東-新竹,2023-07-28,2184
3049,精金,13,0,13,亞東-新竹,2023-07-28,2184
6217,中探針,12,0,12,亞東-新竹,2023-07-28,2184
2468,華經,12,0,12,亞東-新竹,2023-07-28,2184
1402,遠東新,10,0,10,亞東-新竹,2023-07-28,2184
00680L,元大美債20正2,10,0,10,亞東-新竹,2023-07-28,2184
8049,晶采,10,0,10,亞東-新竹,2023-07-28,2184
00650L,復華香港正2,9,0,9,亞東-新竹,2023-07-28,2184
5203,訊連,9,0,9,亞東-新竹,2023-07-28,2184
2882,國泰金,15,7,8,亞東-新竹,2023-07-28,2184
2312,金寶,7,0,7,亞東-新竹,2023-07-28,2184
3481,群創,19,12,7,亞東-新竹,2023-07-28,2184
8155,博智,9,2,7,亞東-新竹,2023-07-28,2184
00757,統一FANG+,6,0,6,亞東-新竹,2023-07-28,2184
00753L,中信中國50正2,6,0,6,亞東-新竹,2023-07-28,2184
1305,華夏,6,0,6,亞東-新竹,2023-07-28,2184
1905,華紙,27,21,6,亞東-新竹,2023-07-28,2184
2427,三商電,12,6,6,亞東-新竹,2023-07-28,2184
2888,新光金,6,0,6,亞東-新竹,2023-07-28,2184
3131,弘塑,6,0,6,亞東-新竹,2023-07-28,2184
3702,大聯大,6,0,6,亞東-新竹,2023-07-28,2184
5706,鳳凰,9,3,6,亞東-新竹,2023-07-28,2184
6170,統振,6,0,6,亞東-新竹,2023-07-28,2184
6548,長科*,6,0,6,亞東-新竹,2023-07-28,2184
00687B,國泰20年美債,5,0,5,亞東-新竹,2023-07-28,2184
00712,復華富時不動產,5,0,5,亞東-新竹,2023-07-28,2184
1101,台泥,5,0,5,亞東-新竹,2023-07-28,2184
00763U,期街口道瓊銅,5,0,5,亞東-新竹,2023-07-28,2184
2014,中鴻,5,0,5,亞東-新竹,2023-07-28,2184
2409,友達,18,13,5,亞東-新竹,2023-07-28,2184
2609,陽明,7,2,5,亞東-新竹,2023-07-28,2184
2886,兆豐金,5,0,5,亞東-新竹,2023-07-28,2184
3625,西勝,5,0,5,亞東-新竹,2023-07-28,2184
6753,龍德造船,5,0,5,亞東-新竹,2023-07-28,2184
9802,鈺齊-KY,5,0,5,亞東-新竹,2023-07-28,2184
2317,鴻海,10,5,5,亞東-新竹,2023-07-28,2184
1760,寶齡富錦,4,0,4,亞東-新竹,2023-07-28,2184
1904,正隆,4,0,4,亞東-新竹,2023-07-28,2184
6005,群益證,171,56,115,亞東-新竹,2023-07-31,2184
00753L,中信中國50正2,107,1,106,亞東-新竹,2023-07-31,2184
00720B,元大投資級公司債,85,0,85,亞東-新竹,2023-07-31,2184
1504,東元,81,1,80,亞東-新竹,2023-07-31,2184
3231,緯創,105,39,66,亞東-新竹,2023-07-31,2184
00650L,復華香港正2,60,1,59,亞東-新竹,2023-07-31,2184
00679B,元大美債20年,44,0,44,亞東-新竹,2023-07-31,2184
00632R,元大台灣50反1,50,6,44,亞東-新竹,2023-07-31,2184
2610,華航,82,40,42,亞東-新竹,2023-07-31,2184
2382,廣達,81,39,42,亞東-新竹,2023-07-31,2184
3055,蔚華科,35,0,35,亞東-新竹,2023-07-31,2184
3234,光環,40,5,35,亞東-新竹,2023-07-31,2184
00878,國泰永續高股息,92,58,34,亞東-新竹,2023-07-31,2184
3702,大聯大,31,0,31,亞東-新竹,2023-07-31,2184
5443,均豪,34,4,30,亞東-新竹,2023-07-31,2184
1532,勤美,29,0,29,亞東-新竹,2023-07-31,2184
3706,神達,49,21,28,亞東-新竹,2023-07-31,2184
3114,好德,25,0,25,亞東-新竹,2023-07-31,2184
00646,元大S＆P500,24,0,24,亞東-新竹,2023-07-31,2184
1809,中釉,20,0,20,亞東-新竹,2023-07-31,2184
2342,茂矽,20,0,20,亞東-新竹,2023-07-31,2184
2427,三商電,20,0,20,亞東-新竹,2023-07-31,2184
3576,聯合再生,18,0,18,亞東-新竹,2023-07-31,2184
4207,環泰,18,0,18,亞東-新竹,2023-07-31,2184
00697B,元大美債7-10,17,0,17,亞東-新竹,2023-07-31,2184
8358,金居,26,9,17,亞東-新竹,2023-07-31,2184
00916,國泰全球品牌50,16,0,16,亞東-新竹,2023-07-31,2184
2328,廣宇,16,0,16,亞東-新竹,2023-07-31,2184
4739,康普,15,0,15,亞東-新竹,2023-07-31,2184
6269,台郡,15,0,15,亞東-新竹,2023-07-31,2184
2317,鴻海,14,0,14,亞東-新竹,2023-07-31,2184
2329,華泰,48,34,14,亞東-新竹,2023-07-31,2184
2362,藍天,13,0,13,亞東-新竹,2023-07-31,2184
6138,茂達,10,0,10,亞東-新竹,2023-07-31,2184
1309,台達化,10,0,10,亞東-新竹,2023-07-31,2184
1229,聯華,12,2,10,亞東-新竹,2023-07-31,2184
8034,榮群,10,0,10,亞東-新竹,2023-07-31,2184
8409,商之器,10,0,10,亞東-新竹,2023-07-31,2184
9962,有益,10,0,10,亞東-新竹,2023-07-31,2184
00642U,期元大S＆P石油,9,0,9,亞東-新竹,2023-07-31,2184
1402,遠東新,9,0,9,亞東-新竹,2023-07-31,2184
2915,潤泰全,10,1,9,亞東-新竹,2023-07-31,2184
3049,精金,9,0,9,亞東-新竹,2023-07-31,2184
00687B,國泰20年美債,13,5,8,亞東-新竹,2023-07-31,2184
2352,佳世達,9,1,8,亞東-新竹,2023-07-31,2184
3092,鴻碩,12,4,8,亞東-新竹,2023-07-31,2184
3141,晶宏,8,0,8,亞東-新竹,2023-07-31,2184
8016,矽創,8,0,8,亞東-新竹,2023-07-31,2184
2330,台積電,12,4,8,亞東-新竹,2023-07-31,2184
00636,國泰中國A50,7,0,7,亞東-新竹,2023-07-31,2184
2883,凱基金,330,0,330,亞東-新竹,2023-08-01,2184
00753L,中信中國50正2,110,0,110,亞東-新竹,2023-08-01,2184
6116,彩晶,100,0,100,亞東-新竹,2023-08-01,2184
00650L,復華香港正2,70,0,70,亞東-新竹,2023-08-01,2184
6005,群益證,222,163,59,亞東-新竹,2023-08-01,2184
2891,中信金,101,47,54,亞東-新竹,2023-08-01,2184
00665L,富邦�琤肭磪囓�2,35,0,35,亞東-新竹,2023-08-01,2184
2392,正崴,30,0,30,亞東-新竹,2023-08-01,2184
00636,國泰中國A50,27,0,27,亞東-新竹,2023-08-01,2184
1802,台玻,32,6,26,亞東-新竹,2023-08-01,2184
00673R,期元大S＆P原油反1,24,0,24,亞東-新竹,2023-08-01,2184
1905,華紙,24,0,24,亞東-新竹,2023-08-01,2184
3706,神達,74,54,20,亞東-新竹,2023-08-01,2184
4938,和碩,22,2,20,亞東-新竹,2023-08-01,2184
6139,亞翔,20,0,20,亞東-新竹,2023-08-01,2184
2913,農林,21,4,17,亞東-新竹,2023-08-01,2184
3264,欣銓,14,0,14,亞東-新竹,2023-08-01,2184
00892,富邦台灣半導體,13,0,13,亞東-新竹,2023-08-01,2184
2201,裕隆,14,1,13,亞東-新竹,2023-08-01,2184
3234,光環,12,0,12,亞東-新竹,2023-08-01,2184
1795,美時,10,0,10,亞東-新竹,2023-08-01,2184
2380,虹光,10,0,10,亞東-新竹,2023-08-01,2184
3057,喬鼎,10,0,10,亞東-新竹,2023-08-01,2184
6138,茂達,10,0,10,亞東-新竹,2023-08-01,2184
1102,亞泥,10,0,10,亞東-新竹,2023-08-01,2184
3051,力特,9,0,9,亞東-新竹,2023-08-01,2184
6282,康舒,16,7,9,亞東-新竹,2023-08-01,2184
2356,英業達,31,23,8,亞東-新竹,2023-08-01,2184
2427,三商電,12,4,8,亞東-新竹,2023-08-01,2184
8046,南電,8,0,8,亞東-新竹,2023-08-01,2184
2401,凌陽,7,0,7,亞東-新竹,2023-08-01,2184
4994,傳奇,7,0,7,亞東-新竹,2023-08-01,2184
6239,力成,8,1,7,亞東-新竹,2023-08-01,2184
3078,僑威,6,0,6,亞東-新竹,2023-08-01,2184
00639,富邦深100,6,0,6,亞東-新竹,2023-08-01,2184
1402,遠東新,6,0,6,亞東-新竹,2023-08-01,2184
1504,東元,6,0,6,亞東-新竹,2023-08-01,2184
1532,勤美,6,0,6,亞東-新竹,2023-08-01,2184
3217,優群,6,0,6,亞東-新竹,2023-08-01,2184
3380,明泰,6,0,6,亞東-新竹,2023-08-01,2184
1503,士電,5,0,5,亞東-新竹,2023-08-01,2184
2328,廣宇,6,1,5,亞東-新竹,2023-08-01,2184
2363,矽統,9,4,5,亞東-新竹,2023-08-01,2184
2371,大同,6,1,5,亞東-新竹,2023-08-01,2184
3324,雙鴻,9,4,5,亞東-新竹,2023-08-01,2184
3583,辛耘,16,11,5,亞東-新竹,2023-08-01,2184
6189,豐藝,5,0,5,亞東-新竹,2023-08-01,2184
2301,光寶科,14,10,4,亞東-新竹,2023-08-01,2184
00923,群益台ESG低碳50,4,0,4,亞東-新竹,2023-08-01,2184
00919,群益台灣精選高息,4,0,4,亞東-新竹,2023-08-01,2184
3625,西勝,54,0,54,亞東-新竹,2023-08-02,2184
4114,健喬,54,0,54,亞東-新竹,2023-08-02,2184
00878,國泰永續高股息,73,24,49,亞東-新竹,2023-08-02,2184
00720B,元大投資級公司債,51,2,49,亞東-新竹,2023-08-02,2184
00713,元大台灣高息低波,50,1,49,亞東-新竹,2023-08-02,2184
2468,華經,38,0,38,亞東-新竹,2023-08-02,2184
6770,力積電,34,0,34,亞東-新竹,2023-08-02,2184
00929,復華台灣科技優息,32,0,32,亞東-新竹,2023-08-02,2184
2882,國泰金,45,13,32,亞東-新竹,2023-08-02,2184
00673R,期元大S＆P原油反1,30,0,30,亞東-新竹,2023-08-02,2184
00923,群益台ESG低碳50,29,0,29,亞東-新竹,2023-08-02,2184
00885,富邦越南,26,0,26,亞東-新竹,2023-08-02,2184
2338,光罩,23,0,23,亞東-新竹,2023-08-02,2184
2883,凱基金,23,0,23,亞東-新竹,2023-08-02,2184
00679B,元大美債20年,22,0,22,亞東-新竹,2023-08-02,2184
00773B,中信優先金融債,22,0,22,亞東-新竹,2023-08-02,2184
2402,毅嘉,27,5,22,亞東-新竹,2023-08-02,2184
3231,緯創,38,18,20,亞東-新竹,2023-08-02,2184
00772B,中信高評級公司債,20,0,20,亞東-新竹,2023-08-02,2184
6138,茂達,20,0,20,亞東-新竹,2023-08-02,2184
6548,長科*,20,0,20,亞東-新竹,2023-08-02,2184
2881,富邦金,18,0,18,亞東-新竹,2023-08-02,2184
6282,康舒,18,0,18,亞東-新竹,2023-08-02,2184
2356,英業達,36,19,17,亞東-新竹,2023-08-02,2184
2301,光寶科,19,2,17,亞東-新竹,2023-08-02,2184
3711,日月光投控,20,4,16,亞東-新竹,2023-08-02,2184
3055,蔚華科,15,0,15,亞東-新竹,2023-08-02,2184
00687B,國泰20年美債,14,0,14,亞東-新竹,2023-08-02,2184
3481,群創,15,1,14,亞東-新竹,2023-08-02,2184
2002,中鋼,14,0,14,亞東-新竹,2023-08-02,2184
00675L,富邦臺灣加權正2,14,0,14,亞東-新竹,2023-08-02,2184
2427,三商電,13,0,13,亞東-新竹,2023-08-02,2184
1101,台泥,13,1,12,亞東-新竹,2023-08-02,2184
4906,正文,11,0,11,亞東-新竹,2023-08-02,2184
00881,國泰台灣5G+,10,0,10,亞東-新竹,2023-08-02,2184
00763U,期街口道瓊銅,10,0,10,亞東-新竹,2023-08-02,2184
2376,技嘉,15,5,10,亞東-新竹,2023-08-02,2184
2618,長榮航,10,0,10,亞東-新竹,2023-08-02,2184
5328,華容,10,0,10,亞東-新竹,2023-08-02,2184
8049,晶采,10,0,10,亞東-新竹,2023-08-02,2184
2886,兆豐金,10,0,10,亞東-新竹,2023-08-02,2184
2330,台積電,11,2,9,亞東-新竹,2023-08-02,2184
2382,廣達,50,41,9,亞東-新竹,2023-08-02,2184
2328,廣宇,9,0,9,亞東-新竹,2023-08-02,2184
3535,晶彩科,9,0,9,亞東-新竹,2023-08-02,2184
00752,中信中國50,8,0,8,亞東-新竹,2023-08-02,2184
5871,中租-KY,7,0,7,亞東-新竹,2023-08-02,2184
00892,富邦台灣半導體,7,0,7,亞東-新竹,2023-08-02,2184
2388,威盛,13,6,7,亞東-新竹,2023-08-02,2184
2637,慧洋-KY,8,1,7,亞東-新竹,2023-08-02,2184
00720B,元大投資級公司債,117,0,117,亞東-新竹,2023-08-04,2184
2891,中信金,60,0,60,亞東-新竹,2023-08-04,2184
00878,國泰永續高股息,55,2,53,亞東-新竹,2023-08-04,2184
2206,三陽工業,52,4,48,亞東-新竹,2023-08-04,2184
00929,復華台灣科技優息,28,0,28,亞東-新竹,2023-08-04,2184
1513,中興電,25,0,25,亞東-新竹,2023-08-04,2184
2442,新美齊,24,0,24,亞東-新竹,2023-08-04,2184
1785,光洋科,61,40,21,亞東-新竹,2023-08-04,2184
00757,統一FANG+,21,0,21,亞東-新竹,2023-08-04,2184
2610,華航,20,0,20,亞東-新竹,2023-08-04,2184
1605,華新,17,2,15,亞東-新竹,2023-08-04,2184
3406,玉晶光,15,0,15,亞東-新竹,2023-08-04,2184
2460,建通,12,0,12,亞東-新竹,2023-08-04,2184
00900,富邦特選高股息30,11,0,11,亞東-新竹,2023-08-04,2184
1326,台化,10,0,10,亞東-新竹,2023-08-04,2184
1312,國喬,10,0,10,亞東-新竹,2023-08-04,2184
1608,華榮,10,0,10,亞東-新竹,2023-08-04,2184
1742,台蠟,10,0,10,亞東-新竹,2023-08-04,2184
2913,農林,41,31,10,亞東-新竹,2023-08-04,2184
3706,神達,15,5,10,亞東-新竹,2023-08-04,2184
4533,協易機,10,0,10,亞東-新竹,2023-08-04,2184
4906,正文,20,10,10,亞東-新竹,2023-08-04,2184
6290,良維,10,0,10,亞東-新竹,2023-08-04,2184
00687B,國泰20年美債,9,0,9,亞東-新竹,2023-08-04,2184
2344,華邦電,18,10,8,亞東-新竹,2023-08-04,2184
3037,欣興,20,12,8,亞東-新竹,2023-08-04,2184
00923,群益台ESG低碳50,8,0,8,亞東-新竹,2023-08-04,2184
6443,元晶,11,3,8,亞東-新竹,2023-08-04,2184
3231,緯創,70,62,8,亞東-新竹,2023-08-04,2184
0050,元大台灣50,7,0,7,亞東-新竹,2023-08-04,2184
6282,康舒,7,0,7,亞東-新竹,2023-08-04,2184
00696B,富邦美債20年,6,0,6,亞東-新竹,2023-08-04,2184
2371,大同,6,0,6,亞東-新竹,2023-08-04,2184
00719B,元大美債1-3,5,0,5,亞東-新竹,2023-08-04,2184
1305,華夏,5,0,5,亞東-新竹,2023-08-04,2184
2303,聯電,5,0,5,亞東-新竹,2023-08-04,2184
2388,威盛,7,2,5,亞東-新竹,2023-08-04,2184
3380,明泰,5,0,5,亞東-新竹,2023-08-04,2184
6116,彩晶,5,0,5,亞東-新竹,2023-08-04,2184
6125,廣運,5,0,5,亞東-新竹,2023-08-04,2184
6288,聯嘉,5,0,5,亞東-新竹,2023-08-04,2184
2330,台積電,9,4,5,亞東-新竹,2023-08-04,2184
3443,創意,5,1,4,亞東-新竹,2023-08-04,2184
00680L,元大美債20正2,10,6,4,亞東-新竹,2023-08-04,2184
2886,兆豐金,4,0,4,亞東-新竹,2023-08-04,2184
2845,遠東銀,3,0,3,亞東-新竹,2023-08-04,2184
5871,中租-KY,3,0,3,亞東-新竹,2023-08-04,2184
2892,第一金,5,2,3,亞東-新竹,2023-08-04,2184
00662,富邦NASDAQ,3,0,3,亞東-新竹,2023-08-04,2184
9941,裕融,3,0,3,亞東-新竹,2023-08-04,2184
00720B,元大投資級公司債,238,0,238,亞東-新竹,2023-08-07,2184
2610,華航,69,0,69,亞東-新竹,2023-08-07,2184
2317,鴻海,63,1,62,亞東-新竹,2023-08-07,2184
3052,夆典,75,19,56,亞東-新竹,2023-08-07,2184
2618,長榮航,73,20,53,亞東-新竹,2023-08-07,2184
00900,富邦特選高股息30,48,1,47,亞東-新竹,2023-08-07,2184
2883,凱基金,31,0,31,亞東-新竹,2023-08-07,2184
1616,億泰,30,0,30,亞東-新竹,2023-08-07,2184
4114,健喬,27,0,27,亞東-新竹,2023-08-07,2184
00673R,期元大S＆P原油反1,21,0,21,亞東-新竹,2023-08-07,2184
2303,聯電,23,2,21,亞東-新竹,2023-08-07,2184
2383,台光電,21,1,20,亞東-新竹,2023-08-07,2184
1477,聚陽,18,0,18,亞東-新竹,2023-08-07,2184
00687B,國泰20年美債,16,1,15,亞東-新竹,2023-08-07,2184
00772B,中信高評級公司債,16,1,15,亞東-新竹,2023-08-07,2184
00929,復華台灣科技優息,14,0,14,亞東-新竹,2023-08-07,2184
00773B,中信優先金融債,15,1,14,亞東-新竹,2023-08-07,2184
1785,光洋科,14,0,14,亞東-新竹,2023-08-07,2184
2913,農林,18,5,13,亞東-新竹,2023-08-07,2184
5471,松翰,11,0,11,亞東-新竹,2023-08-07,2184
1459,聯發,10,0,10,亞東-新竹,2023-08-07,2184
00679B,元大美債20年,10,0,10,亞東-新竹,2023-08-07,2184
2897,王道銀行,10,0,10,亞東-新竹,2023-08-07,2184
5519,隆大,10,0,10,亞東-新竹,2023-08-07,2184
8299,群聯,8,0,8,亞東-新竹,2023-08-07,2184
2409,友達,11,4,7,亞東-新竹,2023-08-07,2184
2301,光寶科,14,7,7,亞東-新竹,2023-08-07,2184
00639,富邦深100,6,0,6,亞東-新竹,2023-08-07,2184
4904,遠傳,8,2,6,亞東-新竹,2023-08-07,2184
00763U,期街口道瓊銅,5,0,5,亞東-新竹,2023-08-07,2184
1608,華榮,5,0,5,亞東-新竹,2023-08-07,2184
1786,科妍,5,0,5,亞東-新竹,2023-08-07,2184
1905,華紙,5,0,5,亞東-新竹,2023-08-07,2184
2388,威盛,8,3,5,亞東-新竹,2023-08-07,2184
2609,陽明,6,1,5,亞東-新竹,2023-08-07,2184
4147,中裕,5,0,5,亞東-新竹,2023-08-07,2184
5880,合庫金,5,0,5,亞東-新竹,2023-08-07,2184
5871,中租-KY,7,3,4,亞東-新竹,2023-08-07,2184
2464,盟立,10,6,4,亞東-新竹,2023-08-07,2184
2603,長榮,4,0,4,亞東-新竹,2023-08-07,2184
3535,晶彩科,4,0,4,亞東-新竹,2023-08-07,2184
6016,康和證,4,0,4,亞東-新竹,2023-08-07,2184
00713,元大台灣高息低波,3,0,3,亞東-新竹,2023-08-07,2184
2419,仲琦,3,0,3,亞東-新竹,2023-08-07,2184
2492,華新科,3,0,3,亞東-新竹,2023-08-07,2184
2615,萬海,3,0,3,亞東-新竹,2023-08-07,2184
2905,三商,3,0,3,亞東-新竹,2023-08-07,2184
3017,奇鋐,5,2,3,亞東-新竹,2023-08-07,2184
3046,建��,3,0,3,亞東-新竹,2023-08-07,2184
3163,波若威,3,0,3,亞東-新竹,2023-08-07,2184
3325,旭品,41,1,40,亞東-新竹,2023-08-08,2184
2891,中信金,53,20,33,亞東-新竹,2023-08-08,2184
6770,力積電,31,0,31,亞東-新竹,2023-08-08,2184
1305,華夏,30,0,30,亞東-新竹,2023-08-08,2184
3052,夆典,25,1,24,亞東-新竹,2023-08-08,2184
2330,台積電,26,2,24,亞東-新竹,2023-08-08,2184
2634,漢翔,31,7,24,亞東-新竹,2023-08-08,2184
00931B,統一美債20年,23,0,23,亞東-新竹,2023-08-08,2184
2303,聯電,21,0,21,亞東-新竹,2023-08-08,2184
00673R,期元大S＆P原油反1,20,0,20,亞東-新竹,2023-08-08,2184
00680L,元大美債20正2,20,0,20,亞東-新竹,2023-08-08,2184
00929,復華台灣科技優息,20,0,20,亞東-新竹,2023-08-08,2184
3706,神達,54,34,20,亞東-新竹,2023-08-08,2184
5519,隆大,20,0,20,亞東-新竹,2023-08-08,2184
2352,佳世達,20,1,19,亞東-新竹,2023-08-08,2184
2880,華南金,19,2,17,亞東-新竹,2023-08-08,2184
00772B,中信高評級公司債,15,0,15,亞東-新竹,2023-08-08,2184
00720B,元大投資級公司債,15,0,15,亞東-新竹,2023-08-08,2184
1742,台蠟,15,0,15,亞東-新竹,2023-08-08,2184
00679B,元大美債20年,14,0,14,亞東-新竹,2023-08-08,2184
4739,康普,14,0,14,亞東-新竹,2023-08-08,2184
00751B,元大AAA至A公司債,11,0,11,亞東-新竹,2023-08-08,2184
3231,緯創,73,62,11,亞東-新竹,2023-08-08,2184
1616,億泰,10,0,10,亞東-新竹,2023-08-08,2184
3044,健鼎,10,0,10,亞東-新竹,2023-08-08,2184
5306,桂盟,10,0,10,亞東-新竹,2023-08-08,2184
3037,欣興,10,1,9,亞東-新竹,2023-08-08,2184
2344,華邦電,9,0,9,亞東-新竹,2023-08-08,2184
2385,群光,9,0,9,亞東-新竹,2023-08-08,2184
3535,晶彩科,9,0,9,亞東-新竹,2023-08-08,2184
3287,廣寰科,8,0,8,亞東-新竹,2023-08-08,2184
6114,久威,8,0,8,亞東-新竹,2023-08-08,2184
6191,精成科,8,0,8,亞東-新竹,2023-08-08,2184
8034,榮群,8,0,8,亞東-新竹,2023-08-08,2184
9941,裕融,7,0,7,亞東-新竹,2023-08-08,2184
1504,東元,7,0,7,亞東-新竹,2023-08-08,2184
00795B,中信美國公債20年,7,0,7,亞東-新竹,2023-08-08,2184
2356,英業達,49,42,7,亞東-新竹,2023-08-08,2184
2427,三商電,7,0,7,亞東-新竹,2023-08-08,2184
4536,拓凱,7,0,7,亞東-新竹,2023-08-08,2184
6667,信紘科,7,0,7,亞東-新竹,2023-08-08,2184
00900,富邦特選高股息30,6,0,6,亞東-新竹,2023-08-08,2184
6223,旺矽,8,2,6,亞東-新竹,2023-08-08,2184
2201,裕隆,6,0,6,亞東-新竹,2023-08-08,2184
2468,華經,6,0,6,亞東-新竹,2023-08-08,2184
2892,第一金,6,0,6,亞東-新竹,2023-08-08,2184
5469,瀚宇博,6,0,6,亞東-新竹,2023-08-08,2184
2881,富邦金,6,0,6,亞東-新竹,2023-08-08,2184
5483,中美晶,5,0,5,亞東-新竹,2023-08-08,2184
2834,臺企銀,5,0,5,亞東-新竹,2023-08-08,2184
00772B,中信高評級公司債,402,0,402,亞東-新竹,2023-08-09,2184
6163,華電網,50,15,35,亞東-新竹,2023-08-09,2184
2884,玉山金,30,0,30,亞東-新竹,2023-08-09,2184
0056,元大高股息,31,2,29,亞東-新竹,2023-08-09,2184
00929,復華台灣科技優息,29,0,29,亞東-新竹,2023-08-09,2184
2303,聯電,23,1,22,亞東-新竹,2023-08-09,2184
2882,國泰金,21,0,21,亞東-新竹,2023-08-09,2184
2002,中鋼,20,0,20,亞東-新竹,2023-08-09,2184
3481,群創,20,1,19,亞東-新竹,2023-08-09,2184
1402,遠東新,18,0,18,亞東-新竹,2023-08-09,2184
8112,至上,20,2,18,亞東-新竹,2023-08-09,2184
2201,裕隆,30,14,16,亞東-新竹,2023-08-09,2184
2409,友達,13,0,13,亞東-新竹,2023-08-09,2184
2206,三陽工業,14,2,12,亞東-新竹,2023-08-09,2184
2472,立隆電,11,0,11,亞東-新竹,2023-08-09,2184
2603,長榮,12,1,11,亞東-新竹,2023-08-09,2184
00673R,期元大S＆P原油反1,10,0,10,亞東-新竹,2023-08-09,2184
00757,統一FANG+,10,0,10,亞東-新竹,2023-08-09,2184
2405,輔信,10,0,10,亞東-新竹,2023-08-09,2184
2427,三商電,10,0,10,亞東-新竹,2023-08-09,2184
2468,華經,10,0,10,亞東-新竹,2023-08-09,2184
6257,矽格,10,0,10,亞東-新竹,2023-08-09,2184
3231,緯創,39,31,8,亞東-新竹,2023-08-09,2184
3034,聯詠,12,4,8,亞東-新竹,2023-08-09,2184
00795B,中信美國公債20年,6,0,6,亞東-新竹,2023-08-09,2184
00919,群益台灣精選高息,6,0,6,亞東-新竹,2023-08-09,2184
2867,三商壽,6,0,6,亞東-新竹,2023-08-09,2184
5706,鳳凰,6,0,6,亞東-新竹,2023-08-09,2184
1513,中興電,7,2,5,亞東-新竹,2023-08-09,2184
2453,凌群,5,0,5,亞東-新竹,2023-08-09,2184
2515,中工,5,0,5,亞東-新竹,2023-08-09,2184
3013,晟銘電,5,0,5,亞東-新竹,2023-08-09,2184
4207,環泰,5,0,5,亞東-新竹,2023-08-09,2184
8105,凌巨,5,0,5,亞東-新竹,2023-08-09,2184
1605,華新,10,5,5,亞東-新竹,2023-08-09,2184
2352,佳世達,4,0,4,亞東-新竹,2023-08-09,2184
00900,富邦特選高股息30,4,0,4,亞東-新竹,2023-08-09,2184
2890,永豐金,4,0,4,亞東-新竹,2023-08-09,2184
6269,台郡,4,0,4,亞東-新竹,2023-08-09,2184
8299,群聯,3,0,3,亞東-新竹,2023-08-09,2184
2308,台達電,4,1,3,亞東-新竹,2023-08-09,2184
00752,中信中國50,3,0,3,亞東-新竹,2023-08-09,2184
006205,富邦上証,3,0,3,亞東-新竹,2023-08-09,2184
2342,茂矽,3,0,3,亞東-新竹,2023-08-09,2184
2363,矽統,3,0,3,亞東-新竹,2023-08-09,2184
3338,泰碩,3,0,3,亞東-新竹,2023-08-09,2184
4744,皇將,3,0,3,亞東-新竹,2023-08-09,2184
5880,合庫金,3,0,3,亞東-新竹,2023-08-09,2184
6733,博晟生醫,6,3,3,亞東-新竹,2023-08-09,2184
8046,南電,8,5,3,亞東-新竹,2023-08-09,2184
00751B,元大AAA至A公司債,202,0,202,亞東-新竹,2023-08-10,2184
00900,富邦特選高股息30,142,0,142,亞東-新竹,2023-08-10,2184
00772B,中信高評級公司債,110,0,110,亞東-新竹,2023-08-10,2184
00929,復華台灣科技優息,80,0,80,亞東-新竹,2023-08-10,2184
2323,中環,70,28,42,亞東-新竹,2023-08-10,2184
9934,成霖,40,0,40,亞東-新竹,2023-08-10,2184
3078,僑威,37,0,37,亞東-新竹,2023-08-10,2184
2886,兆豐金,33,0,33,亞東-新竹,2023-08-10,2184
6770,力積電,31,0,31,亞東-新竹,2023-08-10,2184
1102,亞泥,31,0,31,亞東-新竹,2023-08-10,2184
2376,技嘉,35,5,30,亞東-新竹,2023-08-10,2184
00923,群益台ESG低碳50,28,0,28,亞東-新竹,2023-08-10,2184
0056,元大高股息,28,1,27,亞東-新竹,2023-08-10,2184
00679B,元大美債20年,27,1,26,亞東-新竹,2023-08-10,2184
2427,三商電,24,0,24,亞東-新竹,2023-08-10,2184
00673R,期元大S＆P原油反1,22,0,22,亞東-新竹,2023-08-10,2184
1802,台玻,24,2,22,亞東-新竹,2023-08-10,2184
2888,新光金,82,60,22,亞東-新竹,2023-08-10,2184
00919,群益台灣精選高息,21,0,21,亞東-新竹,2023-08-10,2184
3481,群創,21,0,21,亞東-新竹,2023-08-10,2184
4938,和碩,18,0,18,亞東-新竹,2023-08-10,2184
3576,聯合再生,16,0,16,亞東-新竹,2023-08-10,2184
6163,華電網,16,0,16,亞東-新竹,2023-08-10,2184
6282,康舒,16,0,16,亞東-新竹,2023-08-10,2184
2409,友達,15,0,15,亞東-新竹,2023-08-10,2184
0050,元大台灣50,12,0,12,亞東-新竹,2023-08-10,2184
2362,藍天,12,0,12,亞東-新竹,2023-08-10,2184
2468,華經,11,0,11,亞東-新竹,2023-08-10,2184
3706,神達,18,7,11,亞東-新竹,2023-08-10,2184
1305,華夏,10,0,10,亞東-新竹,2023-08-10,2184
00773B,中信優先金融債,10,0,10,亞東-新竹,2023-08-10,2184
2890,永豐金,10,0,10,亞東-新竹,2023-08-10,2184
2645,長榮航太,9,0,9,亞東-新竹,2023-08-10,2184
5263,智崴,9,0,9,亞東-新竹,2023-08-10,2184
8299,群聯,8,0,8,亞東-新竹,2023-08-10,2184
00850,元大臺灣ESG永續,8,0,8,亞東-新竹,2023-08-10,2184
8112,至上,14,6,8,亞東-新竹,2023-08-10,2184
3034,聯詠,8,1,7,亞東-新竹,2023-08-10,2184
5284,jpp-KY,7,0,7,亞東-新竹,2023-08-10,2184
5457,宣德,6,0,6,亞東-新竹,2023-08-10,2184
2356,英業達,41,35,6,亞東-新竹,2023-08-10,2184
3483,力致,9,3,6,亞東-新竹,2023-08-10,2184
8069,元太,6,0,6,亞東-新竹,2023-08-10,2184
00675L,富邦臺灣加權正2,5,0,5,亞東-新竹,2023-08-10,2184
2382,廣達,28,23,5,亞東-新竹,2023-08-10,2184
3231,緯創,40,35,5,亞東-新竹,2023-08-10,2184
1504,東元,10,5,5,亞東-新竹,2023-08-10,2184
2442,新美齊,5,0,5,亞東-新竹,2023-08-10,2184
3714,富采,5,0,5,亞東-新竹,2023-08-10,2184
5306,桂盟,5,0,5,亞東-新竹,2023-08-10,2184
00720B,元大投資級公司債,47,0,47,亞東-新竹,2023-08-11,2184
2618,長榮航,61,19,42,亞東-新竹,2023-08-11,2184
2886,兆豐金,39,0,39,亞東-新竹,2023-08-11,2184
00715L,期街口布蘭特正2,35,0,35,亞東-新竹,2023-08-11,2184
9934,成霖,30,1,29,亞東-新竹,2023-08-11,2184
2427,三商電,28,0,28,亞東-新竹,2023-08-11,2184
00929,復華台灣科技優息,27,0,27,亞東-新竹,2023-08-11,2184
2888,新光金,21,0,21,亞東-新竹,2023-08-11,2184
2634,漢翔,21,0,21,亞東-新竹,2023-08-11,2184
1102,亞泥,21,0,21,亞東-新竹,2023-08-11,2184
00679B,元大美債20年,24,5,19,亞東-新竹,2023-08-11,2184
3035,智原,27,10,17,亞東-新竹,2023-08-11,2184
2201,裕隆,20,4,16,亞東-新竹,2023-08-11,2184
2482,連宇,15,0,15,亞東-新竹,2023-08-11,2184
2834,臺企銀,15,0,15,亞東-新竹,2023-08-11,2184
6282,康舒,13,0,13,亞東-新竹,2023-08-11,2184
2409,友達,12,0,12,亞東-新竹,2023-08-11,2184
00877,復華中國5G,22,11,11,亞東-新竹,2023-08-11,2184
00923,群益台ESG低碳50,11,0,11,亞東-新竹,2023-08-11,2184
2614,東森,11,0,11,亞東-新竹,2023-08-11,2184
00931B,統一美債20年,10,0,10,亞東-新竹,2023-08-11,2184
00795B,中信美國公債20年,10,0,10,亞東-新竹,2023-08-11,2184
1785,光洋科,10,0,10,亞東-新竹,2023-08-11,2184
3322,建舜電,10,0,10,亞東-新竹,2023-08-11,2184
3481,群創,10,0,10,亞東-新竹,2023-08-11,2184
2892,第一金,10,0,10,亞東-新竹,2023-08-11,2184
0056,元大高股息,20,11,9,亞東-新竹,2023-08-11,2184
2002,中鋼,9,0,9,亞東-新竹,2023-08-11,2184
2330,台積電,9,1,8,亞東-新竹,2023-08-11,2184
2412,中華電,10,2,8,亞東-新竹,2023-08-11,2184
6547,高端疫苗,10,2,8,亞東-新竹,2023-08-11,2184
00687B,國泰20年美債,7,0,7,亞東-新竹,2023-08-11,2184
00772B,中信高評級公司債,7,0,7,亞東-新竹,2023-08-11,2184
2356,英業達,37,31,6,亞東-新竹,2023-08-11,2184
2377,微星,6,0,6,亞東-新竹,2023-08-11,2184
6116,彩晶,6,0,6,亞東-新竹,2023-08-11,2184
1210,大成,5,0,5,亞東-新竹,2023-08-11,2184
1784,訊聯,5,0,5,亞東-新竹,2023-08-11,2184
1909,榮成,5,0,5,亞東-新竹,2023-08-11,2184
5328,華容,5,0,5,亞東-新竹,2023-08-11,2184
1402,遠東新,4,0,4,亞東-新竹,2023-08-11,2184
00773B,中信優先金融債,4,0,4,亞東-新竹,2023-08-11,2184
2206,三陽工業,5,1,4,亞東-新竹,2023-08-11,2184
8069,元太,4,0,4,亞東-新竹,2023-08-11,2184
6190,萬泰科,3,0,3,亞東-新竹,2023-08-11,2184
00751B,元大AAA至A公司債,3,0,3,亞東-新竹,2023-08-11,2184
1609,大亞,3,0,3,亞東-新竹,2023-08-11,2184
1710,東聯,3,0,3,亞東-新竹,2023-08-11,2184
2453,凌群,3,0,3,亞東-新竹,2023-08-11,2184
2472,立隆電,3,0,3,亞東-新竹,2023-08-11,2184
2882,國泰金,215,0,215,亞東-新竹,2023-08-14,2184
2610,華航,119,0,119,亞東-新竹,2023-08-14,2184
2891,中信金,111,2,109,亞東-新竹,2023-08-14,2184
00929,復華台灣科技優息,83,0,83,亞東-新竹,2023-08-14,2184
2105,正新,51,0,51,亞東-新竹,2023-08-14,2184
2002,中鋼,48,1,47,亞東-新竹,2023-08-14,2184
2323,中環,42,1,41,亞東-新竹,2023-08-14,2184
6770,力積電,31,1,30,亞東-新竹,2023-08-14,2184
2890,永豐金,29,0,29,亞東-新竹,2023-08-14,2184
2324,仁寶,34,9,25,亞東-新竹,2023-08-14,2184
00751B,元大AAA至A公司債,24,0,24,亞東-新竹,2023-08-14,2184
0050,元大台灣50,23,0,23,亞東-新竹,2023-08-14,2184
00923,群益台ESG低碳50,22,0,22,亞東-新竹,2023-08-14,2184
2427,三商電,22,0,22,亞東-新竹,2023-08-14,2184
00900,富邦特選高股息30,21,0,21,亞東-新竹,2023-08-14,2184
3535,晶彩科,19,0,19,亞東-新竹,2023-08-14,2184
2915,潤泰全,30,14,16,亞東-新竹,2023-08-14,2184
2614,東森,15,0,15,亞東-新竹,2023-08-14,2184
1229,聯華,15,1,14,亞東-新竹,2023-08-14,2184
00655L,國泰中國A50正2,13,0,13,亞東-新竹,2023-08-14,2184
00931B,統一美債20年,12,0,12,亞東-新竹,2023-08-14,2184
2330,台積電,16,4,12,亞東-新竹,2023-08-14,2184
00720B,元大投資級公司債,12,0,12,亞東-新竹,2023-08-14,2184
2201,裕隆,14,2,12,亞東-新竹,2023-08-14,2184
2303,聯電,12,0,12,亞東-新竹,2023-08-14,2184
2356,英業達,26,14,12,亞東-新竹,2023-08-14,2184
2460,建通,12,0,12,亞東-新竹,2023-08-14,2184
8926,台汽電,11,0,11,亞東-新竹,2023-08-14,2184
00715L,期街口布蘭特正2,10,0,10,亞東-新竹,2023-08-14,2184
1609,大亞,10,0,10,亞東-新竹,2023-08-14,2184
5871,中租-KY,11,1,10,亞東-新竹,2023-08-14,2184
1513,中興電,9,0,9,亞東-新竹,2023-08-14,2184
2881,富邦金,19,10,9,亞東-新竹,2023-08-14,2184
00878,國泰永續高股息,18,10,8,亞東-新竹,2023-08-14,2184
5457,宣德,8,0,8,亞東-新竹,2023-08-14,2184
00882,中信中國高股息,8,0,8,亞東-新竹,2023-08-14,2184
00927,群益半導體收益,8,0,8,亞東-新竹,2023-08-14,2184
2886,兆豐金,8,0,8,亞東-新竹,2023-08-14,2184
00637L,元大滬深300正2,16,9,7,亞東-新竹,2023-08-14,2184
2880,華南金,7,0,7,亞東-新竹,2023-08-14,2184
2834,臺企銀,7,0,7,亞東-新竹,2023-08-14,2184
00675L,富邦臺灣加權正2,6,0,6,亞東-新竹,2023-08-14,2184
00830,國泰費城半導體,6,0,6,亞東-新竹,2023-08-14,2184
2206,三陽工業,6,0,6,亞東-新竹,2023-08-14,2184
2845,遠東銀,6,0,6,亞東-新竹,2023-08-14,2184
2867,三商壽,6,0,6,亞東-新竹,2023-08-14,2184
3324,雙鴻,6,0,6,亞東-新竹,2023-08-14,2184
2027,大成鋼,6,0,6,亞東-新竹,2023-08-14,2184
4538,大詠城,6,1,5,亞東-新竹,2023-08-14,2184
0056,元大高股息,5,0,5,亞東-新竹,2023-08-14,2184
00632R,元大台灣50反1,630,0,630,亞東-新竹,2023-08-15,2184
3715,定穎投控,100,0,100,亞東-新竹,2023-08-15,2184
2883,凱基金,162,100,62,亞東-新竹,2023-08-15,2184
6005,群益證,50,0,50,亞東-新竹,2023-08-15,2184
2317,鴻海,45,0,45,亞東-新竹,2023-08-15,2184
2845,遠東銀,45,0,45,亞東-新竹,2023-08-15,2184
2891,中信金,43,0,43,亞東-新竹,2023-08-15,2184
0056,元大高股息,29,4,25,亞東-新竹,2023-08-15,2184
2892,第一金,23,0,23,亞東-新竹,2023-08-15,2184
1402,遠東新,22,0,22,亞東-新竹,2023-08-15,2184
00929,復華台灣科技優息,16,0,16,亞東-新竹,2023-08-15,2184
1229,聯華,15,0,15,亞東-新竹,2023-08-15,2184
2204,中華,15,0,15,亞東-新竹,2023-08-15,2184
00931B,統一美債20年,14,0,14,亞東-新竹,2023-08-15,2184
1319,東陽,18,4,14,亞東-新竹,2023-08-15,2184
00679B,元大美債20年,13,0,13,亞東-新竹,2023-08-15,2184
00720B,元大投資級公司債,12,0,12,亞東-新竹,2023-08-15,2184
00675L,富邦臺灣加權正2,11,0,11,亞東-新竹,2023-08-15,2184
2609,陽明,11,0,11,亞東-新竹,2023-08-15,2184
3481,群創,11,0,11,亞東-新竹,2023-08-15,2184
1305,華夏,10,0,10,亞東-新竹,2023-08-15,2184
00722B,群益投資級電信債,10,0,10,亞東-新竹,2023-08-15,2184
00664R,國泰臺灣加權反1,10,0,10,亞東-新竹,2023-08-15,2184
2887,台新金,10,0,10,亞東-新竹,2023-08-15,2184
3346,麗清,10,0,10,亞東-新竹,2023-08-15,2184
4538,大詠城,10,0,10,亞東-新竹,2023-08-15,2184
0050,元大台灣50,9,0,9,亞東-新竹,2023-08-15,2184
2376,技嘉,18,9,9,亞東-新竹,2023-08-15,2184
00923,群益台ESG低碳50,8,0,8,亞東-新竹,2023-08-15,2184
2357,華碩,11,3,8,亞東-新竹,2023-08-15,2184
2880,華南金,8,0,8,亞東-新竹,2023-08-15,2184
3032,偉訓,7,0,7,亞東-新竹,2023-08-15,2184
2614,東森,6,0,6,亞東-新竹,2023-08-15,2184
2867,三商壽,6,0,6,亞東-新竹,2023-08-15,2184
3306,鼎天,6,0,6,亞東-新竹,2023-08-15,2184
3576,聯合再生,8,2,6,亞東-新竹,2023-08-15,2184
1102,亞泥,5,0,5,亞東-新竹,2023-08-15,2184
2634,漢翔,5,0,5,亞東-新竹,2023-08-15,2184
3051,力特,5,0,5,亞東-新竹,2023-08-15,2184
3231,緯創,15,10,5,亞東-新竹,2023-08-15,2184
5425,台半,5,0,5,亞東-新竹,2023-08-15,2184
6269,台郡,5,0,5,亞東-新竹,2023-08-15,2184
6530,創威,5,0,5,亞東-新竹,2023-08-15,2184
2603,長榮,5,1,4,亞東-新竹,2023-08-15,2184
6547,高端疫苗,4,0,4,亞東-新竹,2023-08-15,2184
2834,臺企銀,3,0,3,亞東-新竹,2023-08-15,2184
2890,永豐金,3,0,3,亞東-新竹,2023-08-15,2184
1301,台塑,5,2,3,亞東-新竹,2023-08-15,2184
1909,榮成,3,0,3,亞東-新竹,2023-08-15,2184
2886,兆豐金,3,0,3,亞東-新竹,2023-08-15,2184
2891,中信金,138,2,136,亞東-新竹,2023-08-16,2184
2801,彰銀,70,0,70,亞東-新竹,2023-08-16,2184
2303,聯電,62,0,62,亞東-新竹,2023-08-16,2184
2880,華南金,51,0,51,亞東-新竹,2023-08-16,2184
00882,中信中國高股息,45,0,45,亞東-新竹,2023-08-16,2184
2317,鴻海,35,0,35,亞東-新竹,2023-08-16,2184
3324,雙鴻,30,0,30,亞東-新竹,2023-08-16,2184
1402,遠東新,32,3,29,亞東-新竹,2023-08-16,2184
00900,富邦特選高股息30,25,0,25,亞東-新竹,2023-08-16,2184
00923,群益台ESG低碳50,23,0,23,亞東-新竹,2023-08-16,2184
3682,亞太電,20,0,20,亞東-新竹,2023-08-16,2184
5469,瀚宇博,19,0,19,亞東-新竹,2023-08-16,2184
3715,定穎投控,32,15,17,亞東-新竹,2023-08-16,2184
1102,亞泥,15,0,15,亞東-新竹,2023-08-16,2184
2834,臺企銀,14,0,14,亞東-新竹,2023-08-16,2184
2890,永豐金,14,0,14,亞東-新竹,2023-08-16,2184
00931B,統一美債20年,13,0,13,亞東-新竹,2023-08-16,2184
5880,合庫金,13,0,13,亞東-新竹,2023-08-16,2184
2887,台新金,12,0,12,亞東-新竹,2023-08-16,2184
2357,華碩,12,0,12,亞東-新竹,2023-08-16,2184
2421,建準,12,0,12,亞東-新竹,2023-08-16,2184
2460,建通,12,0,12,亞東-新竹,2023-08-16,2184
2886,兆豐金,12,0,12,亞東-新竹,2023-08-16,2184
6139,亞翔,12,0,12,亞東-新竹,2023-08-16,2184
8050,廣積,15,3,12,亞東-新竹,2023-08-16,2184
2892,第一金,11,0,11,亞東-新竹,2023-08-16,2184
00720B,元大投資級公司債,11,0,11,亞東-新竹,2023-08-16,2184
2915,潤泰全,11,0,11,亞東-新竹,2023-08-16,2184
0056,元大高股息,13,3,10,亞東-新竹,2023-08-16,2184
00687B,國泰20年美債,10,0,10,亞東-新竹,2023-08-16,2184
00680L,元大美債20正2,10,0,10,亞東-新竹,2023-08-16,2184
00679B,元大美債20年,10,0,10,亞東-新竹,2023-08-16,2184
00751B,元大AAA至A公司債,9,0,9,亞東-新竹,2023-08-16,2184
2409,友達,9,0,9,亞東-新竹,2023-08-16,2184
4909,新復興,15,6,9,亞東-新竹,2023-08-16,2184
2002,中鋼,8,0,8,亞東-新竹,2023-08-16,2184
2383,台光電,8,0,8,亞東-新竹,2023-08-16,2184
2884,玉山金,8,0,8,亞東-新竹,2023-08-16,2184
00930,永豐ESG低碳高息,6,0,6,亞東-新竹,2023-08-16,2184
00712,復華富時不動產,6,0,6,亞東-新竹,2023-08-16,2184
2027,大成鋼,6,0,6,亞東-新竹,2023-08-16,2184
2368,金像電,6,0,6,亞東-新竹,2023-08-16,2184
3032,偉訓,8,2,6,亞東-新竹,2023-08-16,2184
2330,台積電,7,2,5,亞東-新竹,2023-08-16,2184
3481,群創,12,7,5,亞東-新竹,2023-08-16,2184
00715L,期街口布蘭特正2,5,0,5,亞東-新竹,2023-08-16,2184
00753L,中信中國50正2,5,0,5,亞東-新竹,2023-08-16,2184
00907,永豐優息存股,5,0,5,亞東-新竹,2023-08-16,2184
2009,第一銅,5,0,5,亞東-新竹,2023-08-16,2184
2427,三商電,14,9,5,亞東-新竹,2023-08-16,2184
00772B,中信高評級公司債,97,0,97,亞東-新竹,2023-08-17,2184
2891,中信金,75,0,75,亞東-新竹,2023-08-17,2184
00720B,元大投資級公司債,68,4,64,亞東-新竹,2023-08-17,2184
9958,世紀鋼,40,0,40,亞東-新竹,2023-08-17,2184
2353,宏��,41,5,36,亞東-新竹,2023-08-17,2184
00679B,元大美債20年,35,1,34,亞東-新竹,2023-08-17,2184
3231,緯創,55,25,30,亞東-新竹,2023-08-17,2184
3483,力致,37,8,29,亞東-新竹,2023-08-17,2184
00929,復華台灣科技優息,25,0,25,亞東-新竹,2023-08-17,2184
3558,神準,25,0,25,亞東-新竹,2023-08-17,2184
00751B,元大AAA至A公司債,21,0,21,亞東-新竹,2023-08-17,2184
3056,富華新,23,4,19,亞東-新竹,2023-08-17,2184
2886,兆豐金,16,2,14,亞東-新竹,2023-08-17,2184
00712,復華富時不動產,13,0,13,亞東-新竹,2023-08-17,2184
00882,中信中國高股息,12,0,12,亞東-新竹,2023-08-17,2184
00795B,中信美國公債20年,12,0,12,亞東-新竹,2023-08-17,2184
2409,友達,12,0,12,亞東-新竹,2023-08-17,2184
0056,元大高股息,11,0,11,亞東-新竹,2023-08-17,2184
00773B,中信優先金融債,9,0,9,亞東-新竹,2023-08-17,2184
2618,長榮航,17,8,9,亞東-新竹,2023-08-17,2184
5009,榮剛,11,2,9,亞東-新竹,2023-08-17,2184
2867,三商壽,7,0,7,亞東-新竹,2023-08-17,2184
5880,合庫金,7,0,7,亞東-新竹,2023-08-17,2184
00687B,國泰20年美債,6,0,6,亞東-新竹,2023-08-17,2184
00757,統一FANG+,6,0,6,亞東-新竹,2023-08-17,2184
2356,英業達,48,42,6,亞東-新竹,2023-08-17,2184
2812,台中銀,6,0,6,亞東-新竹,2023-08-17,2184
2897,王道銀行,18,12,6,亞東-新竹,2023-08-17,2184
3706,神達,29,23,6,亞東-新竹,2023-08-17,2184
5511,德昌,6,0,6,亞東-新竹,2023-08-17,2184
2887,台新金,5,0,5,亞東-新竹,2023-08-17,2184
00719B,元大美債1-3,5,0,5,亞東-新竹,2023-08-17,2184
00931B,統一美債20年,5,0,5,亞東-新竹,2023-08-17,2184
1608,華榮,5,0,5,亞東-新竹,2023-08-17,2184
1709,和益,5,0,5,亞東-新竹,2023-08-17,2184
2402,毅嘉,5,0,5,亞東-新竹,2023-08-17,2184
2915,潤泰全,5,0,5,亞東-新竹,2023-08-17,2184
3049,精金,5,0,5,亞東-新竹,2023-08-17,2184
3078,僑威,6,1,5,亞東-新竹,2023-08-17,2184
5483,中美晶,5,0,5,亞東-新竹,2023-08-17,2184
3035,智原,12,8,4,亞東-新竹,2023-08-17,2184
2892,第一金,4,0,4,亞東-新竹,2023-08-17,2184
2888,新光金,10,6,4,亞東-新竹,2023-08-17,2184
1532,勤美,4,0,4,亞東-新竹,2023-08-17,2184
3711,日月光投控,4,0,4,亞東-新竹,2023-08-17,2184
4541,晟田,4,0,4,亞東-新竹,2023-08-17,2184
2303,聯電,6,3,3,亞東-新竹,2023-08-17,2184
1101,台泥,3,0,3,亞東-新竹,2023-08-17,2184
00878,國泰永續高股息,9,6,3,亞東-新竹,2023-08-17,2184
00722B,群益投資級電信債,3,0,3,亞東-新竹,2023-08-17,2184
00632R,元大台灣50反1,100,0,100,亞東-新竹,2023-08-18,2184
1459,聯發,60,0,60,亞東-新竹,2023-08-18,2184
00929,復華台灣科技優息,50,3,47,亞東-新竹,2023-08-18,2184
2388,威盛,47,3,44,亞東-新竹,2023-08-18,2184
2883,凱基金,125,100,25,亞東-新竹,2023-08-18,2184
3231,緯創,64,40,24,亞東-新竹,2023-08-18,2184
3056,富華新,35,11,24,亞東-新竹,2023-08-18,2184
2363,矽統,33,11,22,亞東-新竹,2023-08-18,2184
3035,智原,25,3,22,亞東-新竹,2023-08-18,2184
2427,三商電,20,0,20,亞東-新竹,2023-08-18,2184
2356,英業達,44,25,19,亞東-新竹,2023-08-18,2184
2610,華航,40,22,18,亞東-新竹,2023-08-18,2184
00720B,元大投資級公司債,17,0,17,亞東-新竹,2023-08-18,2184
2382,廣達,32,15,17,亞東-新竹,2023-08-18,2184
3036,文曄,16,0,16,亞東-新竹,2023-08-18,2184
8105,凌巨,15,0,15,亞東-新竹,2023-08-18,2184
00712,復華富時不動產,15,0,15,亞東-新竹,2023-08-18,2184
3576,聯合再生,12,0,12,亞東-新竹,2023-08-18,2184
2834,臺企銀,30,20,10,亞東-新竹,2023-08-18,2184
00722B,群益投資級電信債,10,0,10,亞東-新竹,2023-08-18,2184
2409,友達,10,0,10,亞東-新竹,2023-08-18,2184
2887,台新金,10,0,10,亞東-新竹,2023-08-18,2184
3388,崇越電,10,0,10,亞東-新竹,2023-08-18,2184
6005,群益證,10,0,10,亞東-新竹,2023-08-18,2184
9929,秋雨,10,0,10,亞東-新竹,2023-08-18,2184
00878,國泰永續高股息,32,23,9,亞東-新竹,2023-08-18,2184
00751B,元大AAA至A公司債,9,0,9,亞東-新竹,2023-08-18,2184
00679B,元大美債20年,8,0,8,亞東-新竹,2023-08-18,2184
4909,新復興,8,0,8,亞東-新竹,2023-08-18,2184
8049,晶采,8,0,8,亞東-新竹,2023-08-18,2184
8050,廣積,12,4,8,亞東-新竹,2023-08-18,2184
00715L,期街口布蘭特正2,7,0,7,亞東-新竹,2023-08-18,2184
00713,元大台灣高息低波,12,5,7,亞東-新竹,2023-08-18,2184
3311,閎暉,7,0,7,亞東-新竹,2023-08-18,2184
6235,華孚,7,0,7,亞東-新竹,2023-08-18,2184
1101,台泥,6,0,6,亞東-新竹,2023-08-18,2184
00882,中信中國高股息,6,0,6,亞東-新竹,2023-08-18,2184
6770,力積電,6,0,6,亞東-新竹,2023-08-18,2184
6531,愛普*,6,0,6,亞東-新竹,2023-08-18,2184
2330,台積電,5,0,5,亞東-新竹,2023-08-18,2184
1402,遠東新,5,0,5,亞東-新竹,2023-08-18,2184
2204,中華,5,0,5,亞東-新竹,2023-08-18,2184
2329,華泰,19,14,5,亞東-新竹,2023-08-18,2184
2421,建準,9,4,5,亞東-新竹,2023-08-18,2184
4538,大詠城,5,0,5,亞東-新竹,2023-08-18,2184
6290,良維,5,0,5,亞東-新竹,2023-08-18,2184
5871,中租-KY,5,1,4,亞東-新竹,2023-08-18,2184
3037,欣興,6,2,4,亞東-新竹,2023-08-18,2184
00757,統一FANG+,4,0,4,亞東-新竹,2023-08-18,2184
1605,華新,4,0,4,亞東-新竹,2023-08-18,2184
2883,凱基金,985,0,985,亞東-新竹,2023-08-21,2184
00720B,元大投資級公司債,59,0,59,亞東-新竹,2023-08-21,2184
00751B,元大AAA至A公司債,38,0,38,亞東-新竹,2023-08-21,2184
2380,虹光,25,0,25,亞東-新竹,2023-08-21,2184
4934,太極,27,2,25,亞東-新竹,2023-08-21,2184
1513,中興電,45,21,24,亞東-新竹,2023-08-21,2184
2324,仁寶,30,12,18,亞東-新竹,2023-08-21,2184
1459,聯發,16,0,16,亞東-新竹,2023-08-21,2184
2427,三商電,15,0,15,亞東-新竹,2023-08-21,2184
2637,慧洋-KY,18,4,14,亞東-新竹,2023-08-21,2184
6197,佳必琪,14,0,14,亞東-新竹,2023-08-21,2184
2897,王道銀行,11,0,11,亞東-新竹,2023-08-21,2184
2374,佳能,10,0,10,亞東-新竹,2023-08-21,2184
2382,廣達,20,10,10,亞東-新竹,2023-08-21,2184
2615,萬海,10,0,10,亞東-新竹,2023-08-21,2184
2887,台新金,10,0,10,亞東-新竹,2023-08-21,2184
6269,台郡,9,0,9,亞東-新竹,2023-08-21,2184
00919,群益台灣精選高息,7,0,7,亞東-新竹,2023-08-21,2184
00687B,國泰20年美債,6,0,6,亞東-新竹,2023-08-21,2184
2329,華泰,11,5,6,亞東-新竹,2023-08-21,2184
2603,長榮,6,0,6,亞東-新竹,2023-08-21,2184
3706,神達,13,7,6,亞東-新竹,2023-08-21,2184
00679B,元大美債20年,5,0,5,亞東-新竹,2023-08-21,2184
2303,聯電,5,0,5,亞東-新竹,2023-08-21,2184
2337,旺宏,5,0,5,亞東-新竹,2023-08-21,2184
2472,立隆電,5,0,5,亞東-新竹,2023-08-21,2184
2610,華航,24,19,5,亞東-新竹,2023-08-21,2184
2890,永豐金,5,0,5,亞東-新竹,2023-08-21,2184
3339,泰谷,5,0,5,亞東-新竹,2023-08-21,2184
6005,群益證,5,0,5,亞東-新竹,2023-08-21,2184
8049,晶采,5,0,5,亞東-新竹,2023-08-21,2184
1709,和益,5,1,4,亞東-新竹,2023-08-21,2184
6223,旺矽,4,0,4,亞東-新竹,2023-08-21,2184
1532,勤美,5,1,4,亞東-新竹,2023-08-21,2184
1504,東元,5,1,4,亞東-新竹,2023-08-21,2184
00722B,群益投資級電信債,4,0,4,亞東-新竹,2023-08-21,2184
00764B,群益25年美債,4,0,4,亞東-新竹,2023-08-21,2184
2330,台積電,3,0,3,亞東-新竹,2023-08-21,2184
00931B,統一美債20年,3,0,3,亞東-新竹,2023-08-21,2184
3443,創意,3,0,3,亞東-新竹,2023-08-21,2184
2338,光罩,4,1,3,亞東-新竹,2023-08-21,2184
2618,長榮航,17,14,3,亞東-新竹,2023-08-21,2184
3035,智原,11,8,3,亞東-新竹,2023-08-21,2184
5511,德昌,3,0,3,亞東-新竹,2023-08-21,2184
6274,台燿,2,0,2,亞東-新竹,2023-08-21,2184
00882,中信中國高股息,2,0,2,亞東-新竹,2023-08-21,2184
00893,國泰智能電動車,2,0,2,亞東-新竹,2023-08-21,2184
00888,永豐台灣ESG,2,0,2,亞東-新竹,2023-08-21,2184
00733,富邦臺灣中小,2,0,2,亞東-新竹,2023-08-21,2184
1907,永豐餘,2,0,2,亞東-新竹,2023-08-21,2184
2891,中信金,236,5,231,亞東-新竹,2023-08-22,2184
00929,復華台灣科技優息,109,0,109,亞東-新竹,2023-08-22,2184
00878,國泰永續高股息,93,3,90,亞東-新竹,2023-08-22,2184
2882,國泰金,61,0,61,亞東-新竹,2023-08-22,2184
00888,永豐台灣ESG,37,0,37,亞東-新竹,2023-08-22,2184
1459,聯發,26,0,26,亞東-新竹,2023-08-22,2184
1402,遠東新,24,0,24,亞東-新竹,2023-08-22,2184
2301,光寶科,33,9,24,亞東-新竹,2023-08-22,2184
2449,京元電子,26,2,24,亞東-新竹,2023-08-22,2184
2897,王道銀行,30,9,21,亞東-新竹,2023-08-22,2184
3083,網龍,17,0,17,亞東-新竹,2023-08-22,2184
2201,裕隆,20,4,16,亞東-新竹,2023-08-22,2184
2363,矽統,34,18,16,亞東-新竹,2023-08-22,2184
4113,聯上,12,0,12,亞東-新竹,2023-08-22,2184
2645,長榮航太,10,0,10,亞東-新竹,2023-08-22,2184
0056,元大高股息,11,2,9,亞東-新竹,2023-08-22,2184
1504,東元,8,0,8,亞東-新竹,2023-08-22,2184
2886,兆豐金,8,0,8,亞東-新竹,2023-08-22,2184
6285,啟��,8,0,8,亞東-新竹,2023-08-22,2184
00633L,富邦上証正2,7,0,7,亞東-新竹,2023-08-22,2184
2421,建準,7,0,7,亞東-新竹,2023-08-22,2184
3511,矽瑪,7,0,7,亞東-新竹,2023-08-22,2184
2834,臺企銀,6,0,6,亞東-新竹,2023-08-22,2184
2472,立隆電,6,0,6,亞東-新竹,2023-08-22,2184
3051,力特,6,0,6,亞東-新竹,2023-08-22,2184
6168,宏齊,6,0,6,亞東-新竹,2023-08-22,2184
00795B,中信美國公債20年,6,0,6,亞東-新竹,2023-08-22,2184
2887,台新金,5,0,5,亞東-新竹,2023-08-22,2184
6223,旺矽,5,0,5,亞東-新竹,2023-08-22,2184
00679B,元大美債20年,6,1,5,亞東-新竹,2023-08-22,2184
00720B,元大投資級公司債,5,0,5,亞東-新竹,2023-08-22,2184
1605,華新,5,0,5,亞東-新竹,2023-08-22,2184
2344,華邦電,6,1,5,亞東-新竹,2023-08-22,2184
2427,三商電,13,8,5,亞東-新竹,2023-08-22,2184
4906,正文,5,0,5,亞東-新竹,2023-08-22,2184
5471,松翰,5,0,5,亞東-新竹,2023-08-22,2184
6005,群益證,5,0,5,亞東-新竹,2023-08-22,2184
6282,康舒,5,0,5,亞東-新竹,2023-08-22,2184
2303,聯電,6,2,4,亞東-新竹,2023-08-22,2184
3596,智易,4,0,4,亞東-新竹,2023-08-22,2184
00882,中信中國高股息,4,0,4,亞東-新竹,2023-08-22,2184
1795,美時,4,0,4,亞東-新竹,2023-08-22,2184
2356,英業達,20,16,4,亞東-新竹,2023-08-22,2184
2362,藍天,4,0,4,亞東-新竹,2023-08-22,2184
2492,華新科,5,1,4,亞東-新竹,2023-08-22,2184
3218,大學光,5,1,4,亞東-新竹,2023-08-22,2184
5434,崇越,4,0,4,亞東-新竹,2023-08-22,2184
6125,廣運,12,8,4,亞東-新竹,2023-08-22,2184
6684,安格,4,0,4,亞東-新竹,2023-08-22,2184
8091,翔名,4,0,4,亞東-新竹,2023-08-22,2184
2883,凱基金,200,0,200,亞東-新竹,2023-08-23,2184
3083,網龍,50,0,50,亞東-新竹,2023-08-23,2184
8358,金居,50,0,50,亞東-新竹,2023-08-23,2184
2618,長榮航,44,7,37,亞東-新竹,2023-08-23,2184
00930,永豐ESG低碳高息,33,0,33,亞東-新竹,2023-08-23,2184
3071,協禧,27,1,26,亞東-新竹,2023-08-23,2184
2855,統一證,25,0,25,亞東-新竹,2023-08-23,2184
8222,寶一,22,0,22,亞東-新竹,2023-08-23,2184
00632R,元大台灣50反1,20,0,20,亞東-新竹,2023-08-23,2184
2303,聯電,21,2,19,亞東-新竹,2023-08-23,2184
9958,世紀鋼,15,0,15,亞東-新竹,2023-08-23,2184
3013,晟銘電,34,20,14,亞東-新竹,2023-08-23,2184
5388,中磊,15,1,14,亞東-新竹,2023-08-23,2184
1609,大亞,12,0,12,亞東-新竹,2023-08-23,2184
9904,寶成,12,0,12,亞東-新竹,2023-08-23,2184
3587,閎康,12,2,10,亞東-新竹,2023-08-23,2184
01001T,土銀富邦R1,10,0,10,亞東-新竹,2023-08-23,2184
00680L,元大美債20正2,10,0,10,亞東-新竹,2023-08-23,2184
00715L,期街口布蘭特正2,10,0,10,亞東-新竹,2023-08-23,2184
3558,神準,10,0,10,亞東-新竹,2023-08-23,2184
4915,致伸,10,0,10,亞東-新竹,2023-08-23,2184
5348,正能量智能,10,0,10,亞東-新竹,2023-08-23,2184
2382,廣達,21,11,10,亞東-新竹,2023-08-23,2184
2427,三商電,8,0,8,亞東-新竹,2023-08-23,2184
00712,復華富時不動產,7,0,7,亞東-新竹,2023-08-23,2184
2887,台新金,6,0,6,亞東-新竹,2023-08-23,2184
5285,界霖,10,4,6,亞東-新竹,2023-08-23,2184
6125,廣運,9,3,6,亞東-新竹,2023-08-23,2184
00679B,元大美債20年,5,0,5,亞東-新竹,2023-08-23,2184
1720,生達,5,0,5,亞東-新竹,2023-08-23,2184
00885,富邦越南,5,0,5,亞東-新竹,2023-08-23,2184
8109,博大,5,0,5,亞東-新竹,2023-08-23,2184
00720B,元大投資級公司債,4,0,4,亞東-新竹,2023-08-23,2184
2002,中鋼,4,0,4,亞東-新竹,2023-08-23,2184
5371,中光電,4,0,4,亞東-新竹,2023-08-23,2184
6684,安格,4,0,4,亞東-新竹,2023-08-23,2184
1709,和益,4,1,3,亞東-新竹,2023-08-23,2184
3035,智原,15,12,3,亞東-新竹,2023-08-23,2184
1471,首利,3,0,3,亞東-新竹,2023-08-23,2184
2362,藍天,3,0,3,亞東-新竹,2023-08-23,2184
2610,華航,4,1,3,亞東-新竹,2023-08-23,2184
4763,材料-KY,3,0,3,亞東-新竹,2023-08-23,2184
6026,福邦證,3,0,3,亞東-新竹,2023-08-23,2184
6167,久正,3,0,3,亞東-新竹,2023-08-23,2184
3265,台星科,3,0,3,亞東-新竹,2023-08-23,2184
2886,兆豐金,2,0,2,亞東-新竹,2023-08-23,2184
6223,旺矽,2,0,2,亞東-新竹,2023-08-23,2184
1532,勤美,2,0,2,亞東-新竹,2023-08-23,2184
1519,華城,19,17,2,亞東-新竹,2023-08-23,2184
1514,亞力,2,0,2,亞東-新竹,2023-08-23,2184
2883,凱基金,180,0,180,亞東-新竹,2023-08-24,2184
2317,鴻海,76,12,64,亞東-新竹,2023-08-24,2184
1101,台泥,51,0,51,亞東-新竹,2023-08-24,2184
00919,群益台灣精選高息,56,6,50,亞東-新竹,2023-08-24,2184
2882,國泰金,35,0,35,亞東-新竹,2023-08-24,2184
8234,新漢,32,0,32,亞東-新竹,2023-08-24,2184
00923,群益台ESG低碳50,31,0,31,亞東-新竹,2023-08-24,2184
3013,晟銘電,38,8,30,亞東-新竹,2023-08-24,2184
3206,志豐,30,0,30,亞東-新竹,2023-08-24,2184
2332,友訊,26,0,26,亞東-新竹,2023-08-24,2184
3083,網龍,25,0,25,亞東-新竹,2023-08-24,2184
4157,太景*-KY,22,0,22,亞東-新竹,2023-08-24,2184
00881,國泰台灣5G+,21,0,21,亞東-新竹,2023-08-24,2184
00929,復華台灣科技優息,18,0,18,亞東-新竹,2023-08-24,2184
4967,十銓,15,0,15,亞東-新竹,2023-08-24,2184
3035,智原,25,12,13,亞東-新竹,2023-08-24,2184
00679B,元大美債20年,12,0,12,亞東-新竹,2023-08-24,2184
00900,富邦特選高股息30,12,1,11,亞東-新竹,2023-08-24,2184
3587,閎康,11,0,11,亞東-新竹,2023-08-24,2184
00719B,元大美債1-3,10,0,10,亞東-新竹,2023-08-24,2184
2023,燁輝,10,0,10,亞東-新竹,2023-08-24,2184
2734,易飛網,10,0,10,亞東-新竹,2023-08-24,2184
8105,凌巨,10,0,10,亞東-新竹,2023-08-24,2184
2357,華碩,11,1,10,亞東-新竹,2023-08-24,2184
8091,翔名,9,0,9,亞東-新竹,2023-08-24,2184
2618,長榮航,16,8,8,亞東-新竹,2023-08-24,2184
3715,定穎投控,11,3,8,亞東-新竹,2023-08-24,2184
9904,寶成,8,0,8,亞東-新竹,2023-08-24,2184
00670L,富邦NASDAQ正2,7,0,7,亞東-新竹,2023-08-24,2184
01001T,土銀富邦R1,7,0,7,亞東-新竹,2023-08-24,2184
1319,東陽,9,2,7,亞東-新竹,2023-08-24,2184
1459,聯發,6,0,6,亞東-新竹,2023-08-24,2184
00673R,期元大S＆P原油反1,6,0,6,亞東-新竹,2023-08-24,2184
2884,玉山金,6,0,6,亞東-新竹,2023-08-24,2184
00713,元大台灣高息低波,10,5,5,亞東-新竹,2023-08-24,2184
3702,大聯大,5,0,5,亞東-新竹,2023-08-24,2184
5381,合正,5,0,5,亞東-新竹,2023-08-24,2184
6170,統振,7,2,5,亞東-新竹,2023-08-24,2184
00712,復華富時不動產,4,0,4,亞東-新竹,2023-08-24,2184
00882,中信中國高股息,4,0,4,亞東-新竹,2023-08-24,2184
2383,台光電,4,0,4,亞東-新竹,2023-08-24,2184
2605,新興,4,0,4,亞東-新竹,2023-08-24,2184
2329,華泰,11,8,3,亞東-新竹,2023-08-24,2184
2344,華邦電,3,0,3,亞東-新竹,2023-08-24,2184
2352,佳世達,4,1,3,亞東-新竹,2023-08-24,2184
2449,京元電子,3,0,3,亞東-新竹,2023-08-24,2184
2481,強茂,3,0,3,亞東-新竹,2023-08-24,2184
2486,一詮,3,0,3,亞東-新竹,2023-08-24,2184
2637,慧洋-KY,3,0,3,亞東-新竹,2023-08-24,2184
2880,華南金,3,0,3,亞東-新竹,2023-08-24,2184
2891,中信金,158,0,158,亞東-新竹,2023-08-25,2184
00919,群益台灣精選高息,156,0,156,亞東-新竹,2023-08-25,2184
2363,矽統,156,47,109,亞東-新竹,2023-08-25,2184
00878,國泰永續高股息,55,0,55,亞東-新竹,2023-08-25,2184
2002,中鋼,35,3,32,亞東-新竹,2023-08-25,2184
2399,映泰,30,0,30,亞東-新竹,2023-08-25,2184
0050,元大台灣50,27,0,27,亞東-新竹,2023-08-25,2184
2887,台新金,27,0,27,亞東-新竹,2023-08-25,2184
00893,國泰智能電動車,23,0,23,亞東-新竹,2023-08-25,2184
00877,復華中國5G,21,0,21,亞東-新竹,2023-08-25,2184
3083,網龍,21,0,21,亞東-新竹,2023-08-25,2184
3231,緯創,34,14,20,亞東-新竹,2023-08-25,2184
00830,國泰費城半導體,19,0,19,亞東-新竹,2023-08-25,2184
2303,聯電,18,0,18,亞東-新竹,2023-08-25,2184
00929,復華台灣科技優息,15,0,15,亞東-新竹,2023-08-25,2184
0056,元大高股息,15,1,14,亞東-新竹,2023-08-25,2184
00757,統一FANG+,12,0,12,亞東-新竹,2023-08-25,2184
2460,建通,12,0,12,亞東-新竹,2023-08-25,2184
3264,欣銓,11,0,11,亞東-新竹,2023-08-25,2184
8942,森鉅,11,0,11,亞東-新竹,2023-08-25,2184
2382,廣達,18,7,11,亞東-新竹,2023-08-25,2184
1609,大亞,11,1,10,亞東-新竹,2023-08-25,2184
2485,兆赫,10,0,10,亞東-新竹,2023-08-25,2184
3057,喬鼎,10,0,10,亞東-新竹,2023-08-25,2184
9904,寶成,10,0,10,亞東-新竹,2023-08-25,2184
2610,華航,40,31,9,亞東-新竹,2023-08-25,2184
2330,台積電,9,0,9,亞東-新竹,2023-08-25,2184
2409,友達,8,0,8,亞東-新竹,2023-08-25,2184
2482,連宇,7,0,7,亞東-新竹,2023-08-25,2184
00679B,元大美債20年,6,0,6,亞東-新竹,2023-08-25,2184
3306,鼎天,6,0,6,亞東-新竹,2023-08-25,2184
00900,富邦特選高股息30,5,0,5,亞東-新竹,2023-08-25,2184
2356,英業達,34,29,5,亞東-新竹,2023-08-25,2184
00923,群益台ESG低碳50,5,0,5,亞東-新竹,2023-08-25,2184
2419,仲琦,16,11,5,亞東-新竹,2023-08-25,2184
3094,聯傑,6,1,5,亞東-新竹,2023-08-25,2184
2308,台達電,4,0,4,亞東-新竹,2023-08-25,2184
00907,永豐優息存股,4,0,4,亞東-新竹,2023-08-25,2184
00753L,中信中國50正2,4,0,4,亞東-新竹,2023-08-25,2184
2402,毅嘉,4,0,4,亞東-新竹,2023-08-25,2184
1513,中興電,13,10,3,亞東-新竹,2023-08-25,2184
1504,東元,4,1,3,亞東-新竹,2023-08-25,2184
00633L,富邦上証正2,5,2,3,亞東-新竹,2023-08-25,2184
1605,華新,4,1,3,亞東-新竹,2023-08-25,2184
2360,致茂,3,0,3,亞東-新竹,2023-08-25,2184
4543,萬在,5,2,3,亞東-新竹,2023-08-25,2184
8046,南電,3,0,3,亞東-新竹,2023-08-25,2184
00670L,富邦NASDAQ正2,3,1,2,亞東-新竹,2023-08-25,2184
5483,中美晶,2,0,2,亞東-新竹,2023-08-25,2184
2059,川湖,2,0,2,亞東-新竹,2023-08-25,2184
00878,國泰永續高股息,71,0,71,亞東-新竹,2023-08-28,2184
00720B,元大投資級公司債,52,0,52,亞東-新竹,2023-08-28,2184
2323,中環,50,0,50,亞東-新竹,2023-08-28,2184
6282,康舒,45,0,45,亞東-新竹,2023-08-28,2184
00929,復華台灣科技優息,27,0,27,亞東-新竹,2023-08-28,2184
5876,上海商銀,20,0,20,亞東-新竹,2023-08-28,2184
3083,網龍,19,0,19,亞東-新竹,2023-08-28,2184
1402,遠東新,17,0,17,亞東-新竹,2023-08-28,2184
2460,建通,12,0,12,亞東-新竹,2023-08-28,2184
1471,首利,10,0,10,亞東-新竹,2023-08-28,2184
00670L,富邦NASDAQ正2,10,0,10,亞東-新竹,2023-08-28,2184
2340,台亞,10,0,10,亞東-新竹,2023-08-28,2184
2362,藍天,10,0,10,亞東-新竹,2023-08-28,2184
2405,輔信,10,0,10,亞東-新竹,2023-08-28,2184
2883,凱基金,10,0,10,亞東-新竹,2023-08-28,2184
3576,聯合再生,10,0,10,亞東-新竹,2023-08-28,2184
5283,禾聯碩,10,0,10,亞東-新竹,2023-08-28,2184
6418,詠昇,10,0,10,亞東-新竹,2023-08-28,2184
8039,台虹,10,0,10,亞東-新竹,2023-08-28,2184
3217,優群,9,0,9,亞東-新竹,2023-08-28,2184
3715,定穎投控,15,6,9,亞東-新竹,2023-08-28,2184
2427,三商電,17,9,8,亞東-新竹,2023-08-28,2184
00751B,元大AAA至A公司債,7,0,7,亞東-新竹,2023-08-28,2184
2312,金寶,7,0,7,亞東-新竹,2023-08-28,2184
2388,威盛,7,1,6,亞東-新竹,2023-08-28,2184
8049,晶采,6,0,6,亞東-新竹,2023-08-28,2184
1513,中興電,5,0,5,亞東-新竹,2023-08-28,2184
2356,英業達,16,11,5,亞東-新竹,2023-08-28,2184
2468,華經,16,11,5,亞東-新竹,2023-08-28,2184
2734,易飛網,5,0,5,亞東-新竹,2023-08-28,2184
3711,日月光投控,16,11,5,亞東-新竹,2023-08-28,2184
2887,台新金,7,2,5,亞東-新竹,2023-08-28,2184
8933,愛地雅,4,0,4,亞東-新竹,2023-08-28,2184
3037,欣興,4,0,4,亞東-新竹,2023-08-28,2184
00733,富邦臺灣中小,4,0,4,亞東-新竹,2023-08-28,2184
00795B,中信美國公債20年,4,0,4,亞東-新竹,2023-08-28,2184
3551,世禾,4,0,4,亞東-新竹,2023-08-28,2184
5285,界霖,4,0,4,亞東-新竹,2023-08-28,2184
8931,大汽電,4,0,4,亞東-新竹,2023-08-28,2184
3045,台灣大,4,0,4,亞東-新竹,2023-08-28,2184
2363,矽統,31,28,3,亞東-新竹,2023-08-28,2184
6533,晶心科,3,0,3,亞東-新竹,2023-08-28,2184
1532,勤美,3,0,3,亞東-新竹,2023-08-28,2184
00919,群益台灣精選高息,3,0,3,亞東-新竹,2023-08-28,2184
4572,駐龍,3,0,3,亞東-新竹,2023-08-28,2184
6415,矽力*-KY,3,0,3,亞東-新竹,2023-08-28,2184
6547,高端疫苗,2,0,2,亞東-新竹,2023-08-28,2184
2308,台達電,2,0,2,亞東-新竹,2023-08-28,2184
00724B,群益投資級金融債,2,0,2,亞東-新竹,2023-08-28,2184
00633L,富邦上証正2,5,3,2,亞東-新竹,2023-08-28,2184
2897,王道銀行,98,0,98,亞東-新竹,2023-08-29,2184
00712,復華富時不動產,50,0,50,亞東-新竹,2023-08-29,2184
00919,群益台灣精選高息,30,0,30,亞東-新竹,2023-08-29,2184
3044,健鼎,34,4,30,亞東-新竹,2023-08-29,2184
3083,網龍,22,0,22,亞東-新竹,2023-08-29,2184
00892,富邦台灣半導體,20,0,20,亞東-新竹,2023-08-29,2184
00751B,元大AAA至A公司債,15,0,15,亞東-新竹,2023-08-29,2184
2362,藍天,11,0,11,亞東-新竹,2023-08-29,2184
2441,超豐,11,0,11,亞東-新竹,2023-08-29,2184
2312,金寶,10,0,10,亞東-新竹,2023-08-29,2184
2832,台產,10,0,10,亞東-新竹,2023-08-29,2184
3078,僑威,10,0,10,亞東-新竹,2023-08-29,2184
6548,長科*,10,0,10,亞東-新竹,2023-08-29,2184
3231,緯創,20,11,9,亞東-新竹,2023-08-29,2184
2363,矽統,28,19,9,亞東-新竹,2023-08-29,2184
00929,復華台灣科技優息,16,7,9,亞東-新竹,2023-08-29,2184
1319,東陽,7,0,7,亞東-新竹,2023-08-29,2184
2338,光罩,10,3,7,亞東-新竹,2023-08-29,2184
2460,建通,6,0,6,亞東-新竹,2023-08-29,2184
2485,兆赫,6,0,6,亞東-新竹,2023-08-29,2184
1785,光洋科,5,0,5,亞東-新竹,2023-08-29,2184
2323,中環,5,0,5,亞東-新竹,2023-08-29,2184
3017,奇鋐,6,1,5,亞東-新竹,2023-08-29,2184
5880,合庫金,5,0,5,亞東-新竹,2023-08-29,2184
00795B,中信美國公債20年,4,0,4,亞東-新竹,2023-08-29,2184
00878,國泰永續高股息,7,3,4,亞東-新竹,2023-08-29,2184
2402,毅嘉,4,0,4,亞東-新竹,2023-08-29,2184
2618,長榮航,7,3,4,亞東-新竹,2023-08-29,2184
3711,日月光投控,7,3,4,亞東-新竹,2023-08-29,2184
5283,禾聯碩,4,0,4,亞東-新竹,2023-08-29,2184
6799,來頡,4,0,4,亞東-新竹,2023-08-29,2184
8033,雷虎,5,1,4,亞東-新竹,2023-08-29,2184
5871,中租-KY,4,0,4,亞東-新竹,2023-08-29,2184
1720,生達,3,0,3,亞東-新竹,2023-08-29,2184
1471,首利,3,0,3,亞東-新竹,2023-08-29,2184
1460,宏遠,3,0,3,亞東-新竹,2023-08-29,2184
1324,地球,3,0,3,亞東-新竹,2023-08-29,2184
00720B,元大投資級公司債,3,0,3,亞東-新竹,2023-08-29,2184
00680L,元大美債20正2,3,0,3,亞東-新竹,2023-08-29,2184
2633,台灣高鐵,3,0,3,亞東-新竹,2023-08-29,2184
3706,神達,3,0,3,亞東-新竹,2023-08-29,2184
0056,元大高股息,3,0,3,亞東-新竹,2023-08-29,2184
2059,川湖,3,1,2,亞東-新竹,2023-08-29,2184
1216,統一,2,0,2,亞東-新竹,2023-08-29,2184
1402,遠東新,2,0,2,亞東-新竹,2023-08-29,2184
1786,科妍,2,0,2,亞東-新竹,2023-08-29,2184
2352,佳世達,2,0,2,亞東-新竹,2023-08-29,2184
2376,技嘉,3,1,2,亞東-新竹,2023-08-29,2184
2913,農林,2,0,2,亞東-新竹,2023-08-29,2184
3011,今皓,2,0,2,亞東-新竹,2023-08-29,2184
3083,網龍,71,0,71,亞東-新竹,2023-08-30,2184
2897,王道銀行,50,5,45,亞東-新竹,2023-08-30,2184
2618,長榮航,38,0,38,亞東-新竹,2023-08-30,2184
3013,晟銘電,47,18,29,亞東-新竹,2023-08-30,2184
4938,和碩,20,0,20,亞東-新竹,2023-08-30,2184
2886,兆豐金,19,2,17,亞東-新竹,2023-08-30,2184
00679B,元大美債20年,17,0,17,亞東-新竹,2023-08-30,2184
1710,東聯,16,3,13,亞東-新竹,2023-08-30,2184
2610,華航,13,0,13,亞東-新竹,2023-08-30,2184
4128,中天,12,0,12,亞東-新竹,2023-08-30,2184
00720B,元大投資級公司債,10,0,10,亞東-新竹,2023-08-30,2184
00888,永豐台灣ESG,10,0,10,亞東-新竹,2023-08-30,2184
2440,太空梭,10,0,10,亞東-新竹,2023-08-30,2184
5388,中磊,10,0,10,亞東-新竹,2023-08-30,2184
2331,精英,10,1,9,亞東-新竹,2023-08-30,2184
5876,上海商銀,8,0,8,亞東-新竹,2023-08-30,2184
00919,群益台灣精選高息,9,2,7,亞東-新竹,2023-08-30,2184
4572,駐龍,7,0,7,亞東-新竹,2023-08-30,2184
4971,IET-KY,7,0,7,亞東-新竹,2023-08-30,2184
6282,康舒,7,0,7,亞東-新竹,2023-08-30,2184
00670L,富邦NASDAQ正2,6,0,6,亞東-新竹,2023-08-30,2184
00795B,中信美國公債20年,6,0,6,亞東-新竹,2023-08-30,2184
4930,燦星網,6,0,6,亞東-新竹,2023-08-30,2184
00878,國泰永續高股息,5,0,5,亞東-新竹,2023-08-30,2184
1460,宏遠,5,0,5,亞東-新竹,2023-08-30,2184
00637L,元大滬深300正2,21,16,5,亞東-新竹,2023-08-30,2184
00687B,國泰20年美債,5,0,5,亞東-新竹,2023-08-30,2184
00857B,永豐20年美公債,5,0,5,亞東-新竹,2023-08-30,2184
2409,友達,5,0,5,亞東-新竹,2023-08-30,2184
6005,群益證,15,10,5,亞東-新竹,2023-08-30,2184
6829,千附精密,5,0,5,亞東-新竹,2023-08-30,2184
2356,英業達,23,19,4,亞東-新竹,2023-08-30,2184
00916,國泰全球品牌50,4,0,4,亞東-新竹,2023-08-30,2184
00685L,群益臺灣加權正2,4,0,4,亞東-新竹,2023-08-30,2184
00680L,元大美債20正2,4,0,4,亞東-新竹,2023-08-30,2184
2363,矽統,35,31,4,亞東-新竹,2023-08-30,2184
3522,御嵿,4,0,4,亞東-新竹,2023-08-30,2184
3583,辛耘,4,0,4,亞東-新竹,2023-08-30,2184
2002,中鋼,6,2,4,亞東-新竹,2023-08-30,2184
1609,大亞,3,0,3,亞東-新竹,2023-08-30,2184
00633L,富邦上証正2,3,0,3,亞東-新竹,2023-08-30,2184
2313,華通,3,0,3,亞東-新竹,2023-08-30,2184
2402,毅嘉,6,3,3,亞東-新竹,2023-08-30,2184
2436,偉詮電,7,4,3,亞東-新竹,2023-08-30,2184
2492,華新科,3,0,3,亞東-新竹,2023-08-30,2184
3163,波若威,3,0,3,亞東-新竹,2023-08-30,2184
3529,力旺,3,0,3,亞東-新竹,2023-08-30,2184
5272,笙科,3,0,3,亞東-新竹,2023-08-30,2184
5522,遠雄,3,0,3,亞東-新竹,2023-08-30,2184
6126,信音,3,0,3,亞東-新竹,2023-08-30,2184
2883,凱基金,120,0,120,亞東-新竹,2023-08-31,2184
2834,臺企銀,106,0,106,亞東-新竹,2023-08-31,2184
00632R,元大台灣50反1,100,10,90,亞東-新竹,2023-08-31,2184
00720B,元大投資級公司債,81,0,81,亞東-新竹,2023-08-31,2184
2897,王道銀行,40,0,40,亞東-新竹,2023-08-31,2184
00929,復華台灣科技優息,41,2,39,亞東-新竹,2023-08-31,2184
2303,聯電,39,2,37,亞東-新竹,2023-08-31,2184
2610,華航,58,25,33,亞東-新竹,2023-08-31,2184
1603,華電,27,0,27,亞東-新竹,2023-08-31,2184
1402,遠東新,24,3,21,亞東-新竹,2023-08-31,2184
8358,金居,73,52,21,亞東-新竹,2023-08-31,2184
3078,僑威,19,2,17,亞東-新竹,2023-08-31,2184
6770,力積電,15,0,15,亞東-新竹,2023-08-31,2184
2891,中信金,23,9,14,亞東-新竹,2023-08-31,2184
1711,永光,12,0,12,亞東-新竹,2023-08-31,2184
00795B,中信美國公債20年,12,0,12,亞東-新竹,2023-08-31,2184
2337,旺宏,16,4,12,亞東-新竹,2023-08-31,2184
2886,兆豐金,11,0,11,亞東-新竹,2023-08-31,2184
2330,台積電,12,1,11,亞東-新竹,2023-08-31,2184
2317,鴻海,19,8,11,亞東-新竹,2023-08-31,2184
2345,智邦,11,0,11,亞東-新竹,2023-08-31,2184
3325,旭品,15,4,11,亞東-新竹,2023-08-31,2184
2201,裕隆,20,10,10,亞東-新竹,2023-08-31,2184
2323,中環,10,0,10,亞東-新竹,2023-08-31,2184
2405,輔信,10,0,10,亞東-新竹,2023-08-31,2184
4915,致伸,10,1,9,亞東-新竹,2023-08-31,2184
4938,和碩,9,0,9,亞東-新竹,2023-08-31,2184
2376,技嘉,9,1,8,亞東-新竹,2023-08-31,2184
00919,群益台灣精選高息,8,0,8,亞東-新竹,2023-08-31,2184
2382,廣達,20,12,8,亞東-新竹,2023-08-31,2184
3522,御嵿,6,0,6,亞東-新竹,2023-08-31,2184
3231,緯創,38,33,5,亞東-新竹,2023-08-31,2184
1101,台泥,5,0,5,亞東-新竹,2023-08-31,2184
3083,網龍,5,0,5,亞東-新竹,2023-08-31,2184
3311,閎暉,14,9,5,亞東-新竹,2023-08-31,2184
5457,宣德,5,0,5,亞東-新竹,2023-08-31,2184
6282,康舒,7,2,5,亞東-新竹,2023-08-31,2184
8105,凌巨,5,0,5,亞東-新竹,2023-08-31,2184
9904,寶成,5,0,5,亞東-新竹,2023-08-31,2184
6005,群益證,4,0,4,亞東-新竹,2023-08-31,2184
2892,第一金,11,7,4,亞東-新竹,2023-08-31,2184
00923,群益台ESG低碳50,4,0,4,亞東-新竹,2023-08-31,2184
2436,偉詮電,6,2,4,亞東-新竹,2023-08-31,2184
2481,強茂,4,0,4,亞東-新竹,2023-08-31,2184
2887,台新金,4,0,4,亞東-新竹,2023-08-31,2184
3622,洋華,4,0,4,亞東-新竹,2023-08-31,2184
3711,日月光投控,11,7,4,亞東-新竹,2023-08-31,2184
5225,東科-KY,5,1,4,亞東-新竹,2023-08-31,2184
6485,點序,5,1,4,亞東-新竹,2023-08-31,2184
2002,中鋼,5,2,3,亞東-新竹,2023-08-31,2184
2834,臺企銀,400,200,200,亞東-新竹,2023-09-01,2184
00929,復華台灣科技優息,131,6,125,亞東-新竹,2023-09-01,2184
2845,遠東銀,100,0,100,亞東-新竹,2023-09-01,2184
00919,群益台灣精選高息,93,0,93,亞東-新竹,2023-09-01,2184
00720B,元大投資級公司債,74,0,74,亞東-新竹,2023-09-01,2184
2897,王道銀行,80,28,52,亞東-新竹,2023-09-01,2184
00878,國泰永續高股息,49,0,49,亞東-新竹,2023-09-01,2184
2382,廣達,31,4,27,亞東-新竹,2023-09-01,2184
2450,神腦,27,0,27,亞東-新竹,2023-09-01,2184
2356,英業達,40,15,25,亞東-新竹,2023-09-01,2184
3231,緯創,35,12,23,亞東-新竹,2023-09-01,2184
3105,穩懋,24,3,21,亞東-新竹,2023-09-01,2184
4938,和碩,20,0,20,亞東-新竹,2023-09-01,2184
00885,富邦越南,21,5,16,亞東-新竹,2023-09-01,2184
2637,慧洋-KY,15,0,15,亞東-新竹,2023-09-01,2184
2867,三商壽,12,0,12,亞東-新竹,2023-09-01,2184
2376,技嘉,15,4,11,亞東-新竹,2023-09-01,2184
00632R,元大台灣50反1,10,0,10,亞東-新竹,2023-09-01,2184
00932,兆豐永續高息等權,9,0,9,亞東-新竹,2023-09-01,2184
00733,富邦臺灣中小,9,0,9,亞東-新竹,2023-09-01,2184
2633,台灣高鐵,9,0,9,亞東-新竹,2023-09-01,2184
00679B,元大美債20年,8,0,8,亞東-新竹,2023-09-01,2184
00715L,期街口布蘭特正2,40,32,8,亞東-新竹,2023-09-01,2184
1532,勤美,7,0,7,亞東-新竹,2023-09-01,2184
2485,兆赫,13,6,7,亞東-新竹,2023-09-01,2184
1711,永光,6,0,6,亞東-新竹,2023-09-01,2184
00902,中信電池及儲能,5,0,5,亞東-新竹,2023-09-01,2184
00888,永豐台灣ESG,5,0,5,亞東-新竹,2023-09-01,2184
00719B,元大美債1-3,5,0,5,亞東-新竹,2023-09-01,2184
1709,和益,5,0,5,亞東-新竹,2023-09-01,2184
2329,華泰,7,2,5,亞東-新竹,2023-09-01,2184
4930,燦星網,5,0,5,亞東-新竹,2023-09-01,2184
5608,四維航,5,0,5,亞東-新竹,2023-09-01,2184
0056,元大高股息,4,0,4,亞東-新竹,2023-09-01,2184
00751B,元大AAA至A公司債,4,0,4,亞東-新竹,2023-09-01,2184
1301,台塑,5,1,4,亞東-新竹,2023-09-01,2184
1612,宏泰,4,0,4,亞東-新竹,2023-09-01,2184
2886,兆豐金,4,0,4,亞東-新竹,2023-09-01,2184
3357,臺慶科,5,1,4,亞東-新竹,2023-09-01,2184
4157,太景*-KY,5,1,4,亞東-新竹,2023-09-01,2184
8927,北基,3,0,3,亞東-新竹,2023-09-01,2184
2059,川湖,4,1,3,亞東-新竹,2023-09-01,2184
1303,南亞,3,0,3,亞東-新竹,2023-09-01,2184
2308,台達電,4,1,3,亞東-新竹,2023-09-01,2184
4541,晟田,4,1,3,亞東-新竹,2023-09-01,2184
8155,博智,3,0,3,亞東-新竹,2023-09-01,2184
8210,勤誠,6,3,3,亞東-新竹,2023-09-01,2184
6139,亞翔,2,0,2,亞東-新竹,2023-09-01,2184
6223,旺矽,2,0,2,亞東-新竹,2023-09-01,2184
3443,創意,4,2,2,亞東-新竹,2023-09-01,2184
2891,中信金,250,0,250,亞東-新竹,2023-09-04,2184
00720B,元大投資級公司債,52,0,52,亞東-新竹,2023-09-04,2184
2340,台亞,52,0,52,亞東-新竹,2023-09-04,2184
1802,台玻,53,11,42,亞東-新竹,2023-09-04,2184
2371,大同,38,2,36,亞東-新竹,2023-09-04,2184
00907,永豐優息存股,35,0,35,亞東-新竹,2023-09-04,2184
1718,中纖,33,0,33,亞東-新竹,2023-09-04,2184
2885,元大金,30,0,30,亞東-新竹,2023-09-04,2184
3576,聯合再生,30,0,30,亞東-新竹,2023-09-04,2184
00929,復華台灣科技優息,47,19,28,亞東-新竹,2023-09-04,2184
00915,凱基優選高股息30,25,0,25,亞東-新竹,2023-09-04,2184
2323,中環,25,0,25,亞東-新竹,2023-09-04,2184
2353,宏��,25,0,25,亞東-新竹,2023-09-04,2184
8048,德勝,25,0,25,亞東-新竹,2023-09-04,2184
3105,穩懋,20,0,20,亞東-新竹,2023-09-04,2184
1210,大成,18,0,18,亞東-新竹,2023-09-04,2184
2460,建通,12,0,12,亞東-新竹,2023-09-04,2184
6291,沛亨,12,0,12,亞東-新竹,2023-09-04,2184
2409,友達,13,1,12,亞東-新竹,2023-09-04,2184
1326,台化,11,1,10,亞東-新竹,2023-09-04,2184
2880,華南金,10,0,10,亞東-新竹,2023-09-04,2184
4106,雃博,10,0,10,亞東-新竹,2023-09-04,2184
6138,茂達,10,0,10,亞東-新竹,2023-09-04,2184
1101,台泥,9,0,9,亞東-新竹,2023-09-04,2184
1504,東元,10,1,9,亞東-新竹,2023-09-04,2184
5381,合正,17,8,9,亞東-新竹,2023-09-04,2184
2881,富邦金,7,0,7,亞東-新竹,2023-09-04,2184
1305,華夏,12,5,7,亞東-新竹,2023-09-04,2184
1720,生達,7,0,7,亞東-新竹,2023-09-04,2184
2317,鴻海,7,0,7,亞東-新竹,2023-09-04,2184
00687B,國泰20年美債,6,0,6,亞東-新竹,2023-09-04,2184
2201,裕隆,22,16,6,亞東-新竹,2023-09-04,2184
2633,台灣高鐵,6,0,6,亞東-新竹,2023-09-04,2184
3673,TPK-KY,6,0,6,亞東-新竹,2023-09-04,2184
4155,訊映,8,3,5,亞東-新竹,2023-09-04,2184
3014,聯陽,5,0,5,亞東-新竹,2023-09-04,2184
2331,精英,5,0,5,亞東-新竹,2023-09-04,2184
3322,建舜電,5,0,5,亞東-新竹,2023-09-04,2184
6282,康舒,5,0,5,亞東-新竹,2023-09-04,2184
2303,聯電,6,2,4,亞東-新竹,2023-09-04,2184
3522,御嵿,4,0,4,亞東-新竹,2023-09-04,2184
3622,洋華,4,0,4,亞東-新竹,2023-09-04,2184
2887,台新金,4,0,4,亞東-新竹,2023-09-04,2184
0056,元大高股息,4,0,4,亞東-新竹,2023-09-04,2184
6173,信昌電,5,2,3,亞東-新竹,2023-09-04,2184
00751B,元大AAA至A公司債,3,0,3,亞東-新竹,2023-09-04,2184
2377,微星,3,0,3,亞東-新竹,2023-09-04,2184
3083,網龍,3,0,3,亞東-新竹,2023-09-04,2184
4147,中裕,3,0,3,亞東-新竹,2023-09-04,2184
4572,駐龍,3,0,3,亞東-新竹,2023-09-04,2184
2885,元大金,240,0,240,亞東-新竹,2023-09-05,2184
2897,王道銀行,112,10,102,亞東-新竹,2023-09-05,2184
2883,凱基金,200,100,100,亞東-新竹,2023-09-05,2184
3338,泰碩,50,0,50,亞東-新竹,2023-09-05,2184
2634,漢翔,48,1,47,亞東-新竹,2023-09-05,2184
2027,大成鋼,32,0,32,亞東-新竹,2023-09-05,2184
8050,廣積,25,0,25,亞東-新竹,2023-09-05,2184
00720B,元大投資級公司債,23,0,23,亞東-新竹,2023-09-05,2184
2603,長榮,21,0,21,亞東-新竹,2023-09-05,2184
00918,大華優利高填息30,20,0,20,亞東-新竹,2023-09-05,2184
6482,弘煜科,20,0,20,亞東-新竹,2023-09-05,2184
1210,大成,18,0,18,亞東-新竹,2023-09-05,2184
6223,旺矽,15,0,15,亞東-新竹,2023-09-05,2184
2338,光罩,20,6,14,亞東-新竹,2023-09-05,2184
3522,御嵿,14,0,14,亞東-新竹,2023-09-05,2184
2330,台積電,13,1,12,亞東-新竹,2023-09-05,2184
1802,台玻,11,0,11,亞東-新竹,2023-09-05,2184
2201,裕隆,30,19,11,亞東-新竹,2023-09-05,2184
9958,世紀鋼,10,0,10,亞東-新竹,2023-09-05,2184
1477,聚陽,10,0,10,亞東-新竹,2023-09-05,2184
2486,一詮,11,1,10,亞東-新竹,2023-09-05,2184
3693,營邦,15,5,10,亞東-新竹,2023-09-05,2184
8390,金益鼎,10,0,10,亞東-新竹,2023-09-05,2184
1101,台泥,9,0,9,亞東-新竹,2023-09-05,2184
3035,智原,18,9,9,亞東-新竹,2023-09-05,2184
2409,友達,9,1,8,亞東-新竹,2023-09-05,2184
3311,閎暉,10,2,8,亞東-新竹,2023-09-05,2184
2383,台光電,8,1,7,亞東-新竹,2023-09-05,2184
3680,家登,6,0,6,亞東-新竹,2023-09-05,2184
4147,中裕,8,2,6,亞東-新竹,2023-09-05,2184
6213,聯茂,7,1,6,亞東-新竹,2023-09-05,2184
00637L,元大滬深300正2,12,7,5,亞東-新竹,2023-09-05,2184
006208,富邦台50,5,0,5,亞東-新竹,2023-09-05,2184
2382,廣達,10,5,5,亞東-新竹,2023-09-05,2184
2402,毅嘉,7,2,5,亞東-新竹,2023-09-05,2184
2915,潤泰全,5,0,5,亞東-新竹,2023-09-05,2184
4938,和碩,5,0,5,亞東-新竹,2023-09-05,2184
6191,精成科,5,0,5,亞東-新竹,2023-09-05,2184
6517,保勝光學,5,0,5,亞東-新竹,2023-09-05,2184
6531,愛普*,9,4,5,亞東-新竹,2023-09-05,2184
00795B,中信美國公債20年,4,0,4,亞東-新竹,2023-09-05,2184
00753L,中信中國50正2,4,0,4,亞東-新竹,2023-09-05,2184
00713,元大台灣高息低波,4,0,4,亞東-新竹,2023-09-05,2184
00751B,元大AAA至A公司債,4,0,4,亞東-新竹,2023-09-05,2184
2312,金寶,6,2,4,亞東-新竹,2023-09-05,2184
2464,盟立,5,1,4,亞東-新竹,2023-09-05,2184
2618,長榮航,10,6,4,亞東-新竹,2023-09-05,2184
3622,洋華,4,0,4,亞東-新竹,2023-09-05,2184
3704,合勤控,4,0,4,亞東-新竹,2023-09-05,2184
4541,晟田,4,0,4,亞東-新竹,2023-09-05,2184
2897,王道銀行,140,0,140,亞東-新竹,2023-09-06,2184
00720B,元大投資級公司債,111,0,111,亞東-新竹,2023-09-06,2184
2409,友達,45,1,44,亞東-新竹,2023-09-06,2184
00673R,期元大S＆P原油反1,43,0,43,亞東-新竹,2023-09-06,2184
2884,玉山金,42,0,42,亞東-新竹,2023-09-06,2184
00918,大華優利高填息30,40,0,40,亞東-新竹,2023-09-06,2184
00929,復華台灣科技優息,53,17,36,亞東-新竹,2023-09-06,2184
00919,群益台灣精選高息,36,3,33,亞東-新竹,2023-09-06,2184
2603,長榮,30,0,30,亞東-新竹,2023-09-06,2184
1802,台玻,29,0,29,亞東-新竹,2023-09-06,2184
3013,晟銘電,24,0,24,亞東-新竹,2023-09-06,2184
3522,御嵿,24,0,24,亞東-新竹,2023-09-06,2184
2610,華航,30,10,20,亞東-新竹,2023-09-06,2184
1101,台泥,18,0,18,亞東-新竹,2023-09-06,2184
2880,華南金,17,0,17,亞東-新竹,2023-09-06,2184
00751B,元大AAA至A公司債,15,0,15,亞東-新竹,2023-09-06,2184
3044,健鼎,17,2,15,亞東-新竹,2023-09-06,2184
3052,夆典,15,0,15,亞東-新竹,2023-09-06,2184
5225,東科-KY,14,0,14,亞東-新竹,2023-09-06,2184
3163,波若威,16,3,13,亞東-新竹,2023-09-06,2184
1301,台塑,11,0,11,亞東-新竹,2023-09-06,2184
5381,合正,13,2,11,亞東-新竹,2023-09-06,2184
2883,凱基金,36,26,10,亞東-新竹,2023-09-06,2184
6288,聯嘉,10,0,10,亞東-新竹,2023-09-06,2184
2888,新光金,10,1,9,亞東-新竹,2023-09-06,2184
2303,聯電,18,9,9,亞東-新竹,2023-09-06,2184
1815,富喬,8,0,8,亞東-新竹,2023-09-06,2184
2886,兆豐金,8,0,8,亞東-新竹,2023-09-06,2184
2618,長榮航,13,6,7,亞東-新竹,2023-09-06,2184
2887,台新金,6,0,6,亞東-新竹,2023-09-06,2184
1102,亞泥,6,0,6,亞東-新竹,2023-09-06,2184
2201,裕隆,20,14,6,亞東-新竹,2023-09-06,2184
2402,毅嘉,17,11,6,亞東-新竹,2023-09-06,2184
2485,兆赫,6,0,6,亞東-新竹,2023-09-06,2184
2891,中信金,6,0,6,亞東-新竹,2023-09-06,2184
2027,大成鋼,5,0,5,亞東-新竹,2023-09-06,2184
2382,廣達,11,6,5,亞東-新竹,2023-09-06,2184
00679B,元大美債20年,6,1,5,亞東-新竹,2023-09-06,2184
00915,凱基優選高股息30,16,11,5,亞東-新竹,2023-09-06,2184
2363,矽統,39,34,5,亞東-新竹,2023-09-06,2184
2436,偉詮電,10,5,5,亞東-新竹,2023-09-06,2184
2453,凌群,5,0,5,亞東-新竹,2023-09-06,2184
3260,威剛,5,0,5,亞東-新竹,2023-09-06,2184
4930,燦星網,5,0,5,亞東-新竹,2023-09-06,2184
6239,力成,5,0,5,亞東-新竹,2023-09-06,2184
1709,和益,5,0,5,亞東-新竹,2023-09-06,2184
2915,潤泰全,4,0,4,亞東-新竹,2023-09-06,2184
00902,中信電池及儲能,4,0,4,亞東-新竹,2023-09-06,2184
00753L,中信中國50正2,4,0,4,亞東-新竹,2023-09-06,2184
2704,國賓,4,0,4,亞東-新竹,2023-09-06,2184
00632R,元大台灣50反1,101,0,101,亞東-新竹,2023-09-07,2184
00673R,期元大S＆P原油反1,41,0,41,亞東-新竹,2023-09-07,2184
2409,友達,39,3,36,亞東-新竹,2023-09-07,2184
00919,群益台灣精選高息,32,10,22,亞東-新竹,2023-09-07,2184
2313,華通,22,0,22,亞東-新竹,2023-09-07,2184
1802,台玻,18,0,18,亞東-新竹,2023-09-07,2184
2316,楠梓電,16,0,16,亞東-新竹,2023-09-07,2184
2441,超豐,15,0,15,亞東-新竹,2023-09-07,2184
6416,瑞祺電通,15,0,15,亞東-新竹,2023-09-07,2184
8112,至上,44,30,14,亞東-新竹,2023-09-07,2184
2303,聯電,17,3,14,亞東-新竹,2023-09-07,2184
1720,生達,12,0,12,亞東-新竹,2023-09-07,2184
2356,英業達,18,6,12,亞東-新竹,2023-09-07,2184
3231,緯創,12,1,11,亞東-新竹,2023-09-07,2184
3083,網龍,11,0,11,亞東-新竹,2023-09-07,2184
2330,台積電,11,0,11,亞東-新竹,2023-09-07,2184
1102,亞泥,10,0,10,亞東-新竹,2023-09-07,2184
3479,安勤,10,0,10,亞東-新竹,2023-09-07,2184
3228,金麗科,10,1,9,亞東-新竹,2023-09-07,2184
1711,永光,8,0,8,亞東-新竹,2023-09-07,2184
1524,耿鼎,7,0,7,亞東-新竹,2023-09-07,2184
8069,元太,8,1,7,亞東-新竹,2023-09-07,2184
2614,東森,10,4,6,亞東-新竹,2023-09-07,2184
00687B,國泰20年美債,6,0,6,亞東-新竹,2023-09-07,2184
00932,兆豐永續高息等權,6,0,6,亞東-新竹,2023-09-07,2184
3004,豐達科,6,0,6,亞東-新竹,2023-09-07,2184
5608,四維航,6,0,6,亞東-新竹,2023-09-07,2184
2884,玉山金,6,1,5,亞東-新竹,2023-09-07,2184
5871,中租-KY,5,0,5,亞東-新竹,2023-09-07,2184
2887,台新金,7,2,5,亞東-新竹,2023-09-07,2184
1707,葡萄王,5,0,5,亞東-新竹,2023-09-07,2184
2486,一詮,5,0,5,亞東-新竹,2023-09-07,2184
3078,僑威,6,1,5,亞東-新竹,2023-09-07,2184
4958,臻鼎-KY,5,0,5,亞東-新竹,2023-09-07,2184
6456,GIS-KY,5,0,5,亞東-新竹,2023-09-07,2184
6770,力積電,5,0,5,亞東-新竹,2023-09-07,2184
00902,中信電池及儲能,4,0,4,亞東-新竹,2023-09-07,2184
1324,地球,6,2,4,亞東-新竹,2023-09-07,2184
2603,長榮,4,0,4,亞東-新竹,2023-09-07,2184
2605,新興,4,0,4,亞東-新竹,2023-09-07,2184
4930,燦星網,4,0,4,亞東-新竹,2023-09-07,2184
00679B,元大美債20年,3,0,3,亞東-新竹,2023-09-07,2184
00930,永豐ESG低碳高息,3,0,3,亞東-新竹,2023-09-07,2184
1101,台泥,5,2,3,亞東-新竹,2023-09-07,2184
00915,凱基優選高股息30,3,0,3,亞東-新竹,2023-09-07,2184
2353,宏��,3,0,3,亞東-新竹,2023-09-07,2184
2364,倫飛,6,3,3,亞東-新竹,2023-09-07,2184
2402,毅嘉,8,5,3,亞東-新竹,2023-09-07,2184
4105,東洋,3,0,3,亞東-新竹,2023-09-07,2184
5381,合正,3,0,3,亞東-新竹,2023-09-07,2184
2897,王道銀行,60,1,59,亞東-新竹,2023-09-08,2184
00632R,元大台灣50反1,52,0,52,亞東-新竹,2023-09-08,2184
2603,長榮,37,0,37,亞東-新竹,2023-09-08,2184
00919,群益台灣精選高息,83,59,24,亞東-新竹,2023-09-08,2184
2614,東森,21,0,21,亞東-新竹,2023-09-08,2184
00751B,元大AAA至A公司債,20,0,20,亞東-新竹,2023-09-08,2184
2201,裕隆,26,10,16,亞東-新竹,2023-09-08,2184
00915,凱基優選高股息30,25,10,15,亞東-新竹,2023-09-08,2184
3587,閎康,13,0,13,亞東-新竹,2023-09-08,2184
00673R,期元大S＆P原油反1,12,0,12,亞東-新竹,2023-09-08,2184
2482,連宇,11,0,11,亞東-新竹,2023-09-08,2184
2390,云辰,11,0,11,亞東-新竹,2023-09-08,2184
1101,台泥,10,0,10,亞東-新竹,2023-09-08,2184
3051,力特,10,0,10,亞東-新竹,2023-09-08,2184
4909,新復興,10,0,10,亞東-新竹,2023-09-08,2184
4934,太極,10,0,10,亞東-新竹,2023-09-08,2184
5381,合正,13,3,10,亞東-新竹,2023-09-08,2184
6138,茂達,10,0,10,亞東-新竹,2023-09-08,2184
1319,東陽,11,2,9,亞東-新竹,2023-09-08,2184
3006,晶豪科,9,0,9,亞東-新竹,2023-09-08,2184
6799,來頡,10,2,8,亞東-新竹,2023-09-08,2184
1324,地球,8,0,8,亞東-新竹,2023-09-08,2184
00878,國泰永續高股息,8,0,8,亞東-新竹,2023-09-08,2184
3206,志豐,13,5,8,亞東-新竹,2023-09-08,2184
0056,元大高股息,7,0,7,亞東-新竹,2023-09-08,2184
8069,元太,6,0,6,亞東-新竹,2023-09-08,2184
2313,華通,5,0,5,亞東-新竹,2023-09-08,2184
3231,緯創,10,5,5,亞東-新竹,2023-09-08,2184
1514,亞力,5,0,5,亞東-新竹,2023-09-08,2184
00680L,元大美債20正2,5,0,5,亞東-新竹,2023-09-08,2184
6770,力積電,5,0,5,亞東-新竹,2023-09-08,2184
2338,光罩,5,1,4,亞東-新竹,2023-09-08,2184
3481,群創,9,4,5,亞東-新竹,2023-09-08,2184
006208,富邦台50,4,0,4,亞東-新竹,2023-09-08,2184
1409,新纖,4,0,4,亞東-新竹,2023-09-08,2184
00713,元大台灣高息低波,4,0,4,亞東-新竹,2023-09-08,2184
00929,復華台灣科技優息,14,10,4,亞東-新竹,2023-09-08,2184
3013,晟銘電,8,4,4,亞東-新竹,2023-09-08,2184
3522,御嵿,4,0,4,亞東-新竹,2023-09-08,2184
4763,材料-KY,5,1,4,亞東-新竹,2023-09-08,2184
8409,商之器,4,0,4,亞東-新竹,2023-09-08,2184
3680,家登,4,1,3,亞東-新竹,2023-09-08,2184
2457,飛宏,4,1,3,亞東-新竹,2023-09-08,2184
5871,中租-KY,4,1,3,亞東-新竹,2023-09-08,2184
2376,技嘉,9,6,3,亞東-新竹,2023-09-08,2184
00900,富邦特選高股息30,3,0,3,亞東-新竹,2023-09-08,2184
00733,富邦臺灣中小,3,0,3,亞東-新竹,2023-09-08,2184
1786,科妍,3,0,3,亞東-新竹,2023-09-08,2184
2356,英業達,19,16,3,亞東-新竹,2023-09-08,2184
2915,潤泰全,3,0,3,亞東-新竹,2023-09-08,2184
00878,國泰永續高股息,111,12,99,亞東-新竹,2023-09-11,2184
00929,復華台灣科技優息,85,1,84,亞東-新竹,2023-09-11,2184
2002,中鋼,38,0,38,亞東-新竹,2023-09-11,2184
4953,緯軟,37,0,37,亞東-新竹,2023-09-11,2184
00733,富邦臺灣中小,34,0,34,亞東-新竹,2023-09-11,2184
2338,光罩,31,0,31,亞東-新竹,2023-09-11,2184
3522,御嵿,30,0,30,亞東-新竹,2023-09-11,2184
3576,聯合再生,30,0,30,亞東-新竹,2023-09-11,2184
00675L,富邦臺灣加權正2,27,0,27,亞東-新竹,2023-09-11,2184
00919,群益台灣精選高息,26,0,26,亞東-新竹,2023-09-11,2184
6026,福邦證,31,5,26,亞東-新竹,2023-09-11,2184
2845,遠東銀,50,30,20,亞東-新竹,2023-09-11,2184
2888,新光金,21,0,21,亞東-新竹,2023-09-11,2184
2603,長榮,20,0,20,亞東-新竹,2023-09-11,2184
00915,凱基優選高股息30,17,0,17,亞東-新竹,2023-09-11,2184
2468,華經,17,0,17,亞東-新竹,2023-09-11,2184
00923,群益台ESG低碳50,16,0,16,亞東-新竹,2023-09-11,2184
3231,緯創,25,10,15,亞東-新竹,2023-09-11,2184
00670L,富邦NASDAQ正2,15,0,15,亞東-新竹,2023-09-11,2184
00918,大華優利高填息30,14,0,14,亞東-新竹,2023-09-11,2184
0050,元大台灣50,13,0,13,亞東-新竹,2023-09-11,2184
6291,沛亨,13,0,13,亞東-新竹,2023-09-11,2184
00850,元大臺灣ESG永續,12,0,12,亞東-新竹,2023-09-11,2184
1101,台泥,10,0,10,亞東-新竹,2023-09-11,2184
00720B,元大投資級公司債,10,0,10,亞東-新竹,2023-09-11,2184
2614,東森,10,0,10,亞東-新竹,2023-09-11,2184
6188,廣明,10,0,10,亞東-新竹,2023-09-11,2184
2887,台新金,12,3,9,亞東-新竹,2023-09-11,2184
00679B,元大美債20年,9,0,9,亞東-新竹,2023-09-11,2184
2376,技嘉,14,6,8,亞東-新竹,2023-09-11,2184
6117,迎廣,8,0,8,亞東-新竹,2023-09-11,2184
6223,旺矽,8,0,8,亞東-新竹,2023-09-11,2184
0056,元大高股息,7,0,7,亞東-新竹,2023-09-11,2184
00896,中信綠能及電動車,7,0,7,亞東-新竹,2023-09-11,2184
00932,兆豐永續高息等權,7,0,7,亞東-新竹,2023-09-11,2184
2363,矽統,23,16,7,亞東-新竹,2023-09-11,2184
2618,長榮航,15,8,7,亞東-新竹,2023-09-11,2184
3071,協禧,6,0,6,亞東-新竹,2023-09-11,2184
1436,華友聯,5,0,5,亞東-新竹,2023-09-11,2184
1802,台玻,5,0,5,亞東-新竹,2023-09-11,2184
2344,華邦電,5,0,5,亞東-新竹,2023-09-11,2184
2377,微星,5,0,5,亞東-新竹,2023-09-11,2184
2388,威盛,9,4,5,亞東-新竹,2023-09-11,2184
2834,臺企銀,5,0,5,亞東-新竹,2023-09-11,2184
3083,網龍,5,0,5,亞東-新竹,2023-09-11,2184
3380,明泰,5,0,5,亞東-新竹,2023-09-11,2184
3037,欣興,4,0,4,亞東-新竹,2023-09-11,2184
1717,長興,4,0,4,亞東-新竹,2023-09-11,2184
2324,仁寶,4,0,4,亞東-新竹,2023-09-11,2184
2308,台達電,4,0,4,亞東-新竹,2023-09-11,2184
2883,凱基金,1092,0,1092,亞東-新竹,2023-09-12,2184
2834,臺企銀,301,200,101,亞東-新竹,2023-09-12,2184
00632R,元大台灣50反1,100,6,94,亞東-新竹,2023-09-12,2184
00919,群益台灣精選高息,43,0,43,亞東-新竹,2023-09-12,2184
1460,宏遠,38,0,38,亞東-新竹,2023-09-12,2184
00931B,統一美債20年,31,0,31,亞東-新竹,2023-09-12,2184
2353,宏��,25,0,25,亞東-新竹,2023-09-12,2184
2337,旺宏,20,0,20,亞東-新竹,2023-09-12,2184
4106,雃博,17,0,17,亞東-新竹,2023-09-12,2184
00679B,元大美債20年,10,0,10,亞東-新竹,2023-09-12,2184
2450,神腦,10,0,10,亞東-新竹,2023-09-12,2184
4541,晟田,10,0,10,亞東-新竹,2023-09-12,2184
3704,合勤控,15,6,9,亞東-新竹,2023-09-12,2184
0050,元大台灣50,8,0,8,亞東-新竹,2023-09-12,2184
2402,毅嘉,16,8,8,亞東-新竹,2023-09-12,2184
6770,力積電,11,4,7,亞東-新竹,2023-09-12,2184
00712,復華富時不動產,6,0,6,亞東-新竹,2023-09-12,2184
1436,華友聯,6,0,6,亞東-新竹,2023-09-12,2184
2314,台揚,6,0,6,亞東-新竹,2023-09-12,2184
2329,華泰,12,6,6,亞東-新竹,2023-09-12,2184
3715,定穎投控,7,1,6,亞東-新竹,2023-09-12,2184
4906,正文,6,0,6,亞東-新竹,2023-09-12,2184
8409,商之器,6,0,6,亞東-新竹,2023-09-12,2184
00900,富邦特選高股息30,5,0,5,亞東-新竹,2023-09-12,2184
5381,合正,9,4,5,亞東-新竹,2023-09-12,2184
1709,和益,5,0,5,亞東-新竹,2023-09-12,2184
8069,元太,4,0,4,亞東-新竹,2023-09-12,2184
00902,中信電池及儲能,4,0,4,亞東-新竹,2023-09-12,2184
2356,英業達,17,13,4,亞東-新竹,2023-09-12,2184
2401,凌陽,5,1,4,亞東-新竹,2023-09-12,2184
2801,彰銀,4,0,4,亞東-新竹,2023-09-12,2184
6869,雲豹能源,4,0,4,亞東-新竹,2023-09-12,2184
2330,台積電,5,1,4,亞東-新竹,2023-09-12,2184
00753L,中信中國50正2,3,0,3,亞東-新竹,2023-09-12,2184
1784,訊聯,4,1,3,亞東-新竹,2023-09-12,2184
2204,中華,5,2,3,亞東-新竹,2023-09-12,2184
3005,神基,3,0,3,亞東-新竹,2023-09-12,2184
3025,星通,3,0,3,亞東-新竹,2023-09-12,2184
3037,欣興,6,3,3,亞東-新竹,2023-09-12,2184
3169,亞信,3,0,3,亞東-新竹,2023-09-12,2184
4533,協易機,3,0,3,亞東-新竹,2023-09-12,2184
5457,宣德,3,0,3,亞東-新竹,2023-09-12,2184
8358,金居,3,0,3,亞東-新竹,2023-09-12,2184
1522,堤維西,3,0,3,亞東-新竹,2023-09-12,2184
2376,技嘉,16,14,2,亞東-新竹,2023-09-12,2184
2382,廣達,7,5,2,亞東-新竹,2023-09-12,2184
1584,精剛,2,0,2,亞東-新竹,2023-09-12,2184
2538,基泰,2,0,2,亞東-新竹,2023-09-12,2184
2890,永豐金,2,0,2,亞東-新竹,2023-09-12,2184
3052,夆典,2,0,2,亞東-新竹,2023-09-12,2184
00919,群益台灣精選高息,103,0,103,亞東-新竹,2023-09-13,2184
2356,英業達,53,14,39,亞東-新竹,2023-09-13,2184
2405,輔信,32,0,32,亞東-新竹,2023-09-13,2184
2313,華通,36,5,31,亞東-新竹,2023-09-13,2184
3576,聯合再生,30,0,30,亞東-新竹,2023-09-13,2184
1324,地球,28,0,28,亞東-新竹,2023-09-13,2184
3715,定穎投控,57,34,23,亞東-新竹,2023-09-13,2184
3037,欣興,22,1,21,亞東-新竹,2023-09-13,2184
0050,元大台灣50,15,0,15,亞東-新竹,2023-09-13,2184
00733,富邦臺灣中小,13,0,13,亞東-新竹,2023-09-13,2184
00878,國泰永續高股息,12,0,12,亞東-新竹,2023-09-13,2184
3005,神基,16,4,12,亞東-新竹,2023-09-13,2184
6125,廣運,10,0,10,亞東-新竹,2023-09-13,2184
1762,中化生,8,0,8,亞東-新竹,2023-09-13,2184
3260,威剛,9,1,8,亞東-新竹,2023-09-13,2184
8011,台通,10,3,7,亞東-新竹,2023-09-13,2184
3711,日月光投控,8,2,6,亞東-新竹,2023-09-13,2184
4123,晟德,6,0,6,亞東-新竹,2023-09-13,2184
6134,萬旭,6,0,6,亞東-新竹,2023-09-13,2184
4147,中裕,5,0,5,亞東-新竹,2023-09-13,2184
2308,台達電,5,0,5,亞東-新竹,2023-09-13,2184
2002,中鋼,5,0,5,亞東-新竹,2023-09-13,2184
00932,兆豐永續高息等權,5,0,5,亞東-新竹,2023-09-13,2184
006208,富邦台50,5,0,5,亞東-新竹,2023-09-13,2184
2312,金寶,5,0,5,亞東-新竹,2023-09-13,2184
3046,建��,5,0,5,亞東-新竹,2023-09-13,2184
3535,晶彩科,5,0,5,亞東-新竹,2023-09-13,2184
6168,宏齊,5,0,5,亞東-新竹,2023-09-13,2184
00720B,元大投資級公司債,4,0,4,亞東-新竹,2023-09-13,2184
00773B,中信優先金融債,4,0,4,亞東-新竹,2023-09-13,2184
3322,建舜電,6,2,4,亞東-新竹,2023-09-13,2184
4541,晟田,4,0,4,亞東-新竹,2023-09-13,2184
00929,復華台灣科技優息,16,13,3,亞東-新竹,2023-09-13,2184
3231,緯創,7,4,3,亞東-新竹,2023-09-13,2184
00923,群益台ESG低碳50,3,0,3,亞東-新竹,2023-09-13,2184
2417,圓剛,3,0,3,亞東-新竹,2023-09-13,2184
3044,健鼎,3,0,3,亞東-新竹,2023-09-13,2184
5457,宣德,3,0,3,亞東-新竹,2023-09-13,2184
2887,台新金,3,0,3,亞東-新竹,2023-09-13,2184
2317,鴻海,2,0,2,亞東-新竹,2023-09-13,2184
00931B,統一美債20年,2,0,2,亞東-新竹,2023-09-13,2184
1102,亞泥,2,0,2,亞東-新竹,2023-09-13,2184
00673R,期元大S＆P原油反1,2,0,2,亞東-新竹,2023-09-13,2184
0056,元大高股息,2,0,2,亞東-新竹,2023-09-13,2184
00751B,元大AAA至A公司債,2,0,2,亞東-新竹,2023-09-13,2184
00830,國泰費城半導體,2,0,2,亞東-新竹,2023-09-13,2184
1540,喬福,2,0,2,亞東-新竹,2023-09-13,2184
2020,美亞,5,3,2,亞東-新竹,2023-09-13,2184
2342,茂矽,2,0,2,亞東-新竹,2023-09-13,2184
2474,可成,2,0,2,亞東-新竹,2023-09-13,2184
2888,新光金,200,10,190,亞東-新竹,2023-09-14,2184
2371,大同,136,11,125,亞東-新竹,2023-09-14,2184
2402,毅嘉,42,0,42,亞東-新竹,2023-09-14,2184
3715,定穎投控,34,1,33,亞東-新竹,2023-09-14,2184
00712,復華富時不動產,31,0,31,亞東-新竹,2023-09-14,2184
00929,復華台灣科技優息,32,5,27,亞東-新竹,2023-09-14,2184
1616,億泰,20,0,20,亞東-新竹,2023-09-14,2184
00679B,元大美債20年,20,0,20,亞東-新竹,2023-09-14,2184
00632R,元大台灣50反1,20,0,20,亞東-新竹,2023-09-14,2184
00919,群益台灣精選高息,39,20,19,亞東-新竹,2023-09-14,2184
00751B,元大AAA至A公司債,15,0,15,亞東-新竹,2023-09-14,2184
00773B,中信優先金融債,15,0,15,亞東-新竹,2023-09-14,2184
0050,元大台灣50,15,0,15,亞東-新竹,2023-09-14,2184
1324,地球,14,0,14,亞東-新竹,2023-09-14,2184
00720B,元大投資級公司債,12,0,12,亞東-新竹,2023-09-14,2184
00676R,富邦臺灣加權反1,10,0,10,亞東-新竹,2023-09-14,2184
6593,台灣銘板,10,0,10,亞東-新竹,2023-09-14,2184
2614,東森,10,0,10,亞東-新竹,2023-09-14,2184
2486,一詮,40,31,9,亞東-新竹,2023-09-14,2184
3005,神基,11,2,9,亞東-新竹,2023-09-14,2184
3338,泰碩,10,1,9,亞東-新竹,2023-09-14,2184
6834,天二科技,8,0,8,亞東-新竹,2023-09-14,2184
2890,永豐金,23,16,7,亞東-新竹,2023-09-14,2184
2408,南亞科,7,1,6,亞東-新竹,2023-09-14,2184
2427,三商電,6,0,6,亞東-新竹,2023-09-14,2184
3596,智易,6,0,6,亞東-新竹,2023-09-14,2184
3673,TPK-KY,6,0,6,亞東-新竹,2023-09-14,2184
3653,健策,5,0,5,亞東-新竹,2023-09-14,2184
6558,興能高,5,0,5,亞東-新竹,2023-09-14,2184
1591,駿吉-KY,4,0,4,亞東-新竹,2023-09-14,2184
1760,寶齡富錦,6,2,4,亞東-新竹,2023-09-14,2184
3260,威剛,6,2,4,亞東-新竹,2023-09-14,2184
6530,創威,4,0,4,亞東-新竹,2023-09-14,2184
6515,穎崴,5,1,4,亞東-新竹,2023-09-14,2184
2457,飛宏,7,4,3,亞東-新竹,2023-09-14,2184
1216,統一,3,0,3,亞東-新竹,2023-09-14,2184
2030,彰源,3,0,3,亞東-新竹,2023-09-14,2184
3006,晶豪科,4,1,3,亞東-新竹,2023-09-14,2184
3163,波若威,6,3,3,亞東-新竹,2023-09-14,2184
3272,東碩,3,0,3,亞東-新竹,2023-09-14,2184
3450,聯鈞,3,0,3,亞東-新竹,2023-09-14,2184
4572,駐龍,3,0,3,亞東-新竹,2023-09-14,2184
5457,宣德,3,0,3,亞東-新竹,2023-09-14,2184
6117,迎廣,3,0,3,亞東-新竹,2023-09-14,2184
6418,詠昇,3,0,3,亞東-新竹,2023-09-14,2184
6477,安集,3,0,3,亞東-新竹,2023-09-14,2184
3356,奇偶,3,0,3,亞東-新竹,2023-09-14,2184
00719B,元大美債1-3,2,0,2,亞東-新竹,2023-09-14,2184
00764B,群益25年美債,2,0,2,亞東-新竹,2023-09-14,2184
1727,中華化,2,0,2,亞東-新竹,2023-09-14,2184
2834,臺企銀,300,188,112,亞東-新竹,2023-09-15,2184
00919,群益台灣精選高息,68,10,58,亞東-新竹,2023-09-15,2184
00929,復華台灣科技優息,57,0,57,亞東-新竹,2023-09-15,2184
1616,億泰,54,0,54,亞東-新竹,2023-09-15,2184
2317,鴻海,52,0,52,亞東-新竹,2023-09-15,2184
00696B,富邦美債20年,50,0,50,亞東-新竹,2023-09-15,2184
00878,國泰永續高股息,52,7,45,亞東-新竹,2023-09-15,2184
2610,華航,40,0,40,亞東-新竹,2023-09-15,2184
00673R,期元大S＆P原油反1,36,0,36,亞東-新竹,2023-09-15,2184
3035,智原,32,5,27,亞東-新竹,2023-09-15,2184
3037,欣興,31,5,26,亞東-新竹,2023-09-15,2184
00931B,統一美債20年,22,0,22,亞東-新竹,2023-09-15,2184
3673,TPK-KY,20,0,20,亞東-新竹,2023-09-15,2184
0050,元大台灣50,19,0,19,亞東-新竹,2023-09-15,2184
2890,永豐金,15,0,15,亞東-新竹,2023-09-15,2184
1324,地球,15,0,15,亞東-新竹,2023-09-15,2184
2201,裕隆,26,14,12,亞東-新竹,2023-09-15,2184
2867,三商壽,12,0,12,亞東-新竹,2023-09-15,2184
8147,正淩,11,0,11,亞東-新竹,2023-09-15,2184
1402,遠東新,11,0,11,亞東-新竹,2023-09-15,2184
2313,華通,25,15,10,亞東-新竹,2023-09-15,2184
00902,中信電池及儲能,10,0,10,亞東-新竹,2023-09-15,2184
00772B,中信高評級公司債,10,0,10,亞東-新竹,2023-09-15,2184
4157,太景*-KY,10,0,10,亞東-新竹,2023-09-15,2184
8215,明基材,10,0,10,亞東-新竹,2023-09-15,2184
2425,承啟,10,0,10,亞東-新竹,2023-09-15,2184
6120,達運,9,0,9,亞東-新竹,2023-09-15,2184
2408,南亞科,7,0,7,亞東-新竹,2023-09-15,2184
00679B,元大美債20年,7,0,7,亞東-新竹,2023-09-15,2184
00733,富邦臺灣中小,7,0,7,亞東-新竹,2023-09-15,2184
6257,矽格,8,1,7,亞東-新竹,2023-09-15,2184
2886,兆豐金,8,2,6,亞東-新竹,2023-09-15,2184
2634,漢翔,7,1,6,亞東-新竹,2023-09-15,2184
00720B,元大投資級公司債,6,0,6,亞東-新竹,2023-09-15,2184
4147,中裕,6,0,6,亞東-新竹,2023-09-15,2184
2405,輔信,5,0,5,亞東-新竹,2023-09-15,2184
2605,新興,11,6,5,亞東-新竹,2023-09-15,2184
2618,長榮航,14,9,5,亞東-新竹,2023-09-15,2184
3653,健策,5,0,5,亞東-新竹,2023-09-15,2184
5871,中租-KY,5,0,5,亞東-新竹,2023-09-15,2184
9962,有益,5,0,5,亞東-新竹,2023-09-15,2184
1737,臺鹽,4,0,4,亞東-新竹,2023-09-15,2184
2020,美亞,4,0,4,亞東-新竹,2023-09-15,2184
2880,華南金,4,0,4,亞東-新竹,2023-09-15,2184
2884,玉山金,4,0,4,亞東-新竹,2023-09-15,2184
5285,界霖,4,0,4,亞東-新竹,2023-09-15,2184
6770,力積電,5,1,4,亞東-新竹,2023-09-15,2184
4906,正文,3,0,3,亞東-新竹,2023-09-15,2184
00751B,元大AAA至A公司債,3,0,3,亞東-新竹,2023-09-15,2184
1301,台塑,3,0,3,亞東-新竹,2023-09-15,2184
00929,復華台灣科技優息,168,6,162,亞東-新竹,2023-09-18,2184
00919,群益台灣精選高息,153,6,147,亞東-新竹,2023-09-18,2184
1471,首利,128,0,128,亞東-新竹,2023-09-18,2184
00632R,元大台灣50反1,100,0,100,亞東-新竹,2023-09-18,2184
6257,矽格,68,5,63,亞東-新竹,2023-09-18,2184
00720B,元大投資級公司債,58,0,58,亞東-新竹,2023-09-18,2184
2363,矽統,68,14,54,亞東-新竹,2023-09-18,2184
2884,玉山金,42,0,42,亞東-新竹,2023-09-18,2184
2462,良得電,28,0,28,亞東-新竹,2023-09-18,2184
2388,威盛,50,24,26,亞東-新竹,2023-09-18,2184
00878,國泰永續高股息,24,0,24,亞東-新竹,2023-09-18,2184
2330,台積電,23,0,23,亞東-新竹,2023-09-18,2184
00931B,統一美債20年,22,0,22,亞東-新竹,2023-09-18,2184
2356,英業達,22,2,20,亞東-新竹,2023-09-18,2184
6005,群益證,20,0,20,亞東-新竹,2023-09-18,2184
6282,康舒,15,0,15,亞東-新竹,2023-09-18,2184
8299,群聯,15,0,15,亞東-新竹,2023-09-18,2184
00733,富邦臺灣中小,14,0,14,亞東-新竹,2023-09-18,2184
00757,統一FANG+,14,0,14,亞東-新竹,2023-09-18,2184
2610,華航,14,0,14,亞東-新竹,2023-09-18,2184
00751B,元大AAA至A公司債,13,0,13,亞東-新竹,2023-09-18,2184
00679B,元大美債20年,12,0,12,亞東-新竹,2023-09-18,2184
4106,雃博,11,0,11,亞東-新竹,2023-09-18,2184
3034,聯詠,11,0,11,亞東-新竹,2023-09-18,2184
2303,聯電,13,2,11,亞東-新竹,2023-09-18,2184
00888,永豐台灣ESG,10,0,10,亞東-新竹,2023-09-18,2184
2342,茂矽,10,0,10,亞東-新竹,2023-09-18,2184
6026,福邦證,10,0,10,亞東-新竹,2023-09-18,2184
6138,茂達,10,0,10,亞東-新竹,2023-09-18,2184
9921,巨大,10,0,10,亞東-新竹,2023-09-18,2184
00930,永豐ESG低碳高息,9,0,9,亞東-新竹,2023-09-18,2184
00687B,國泰20年美債,9,0,9,亞東-新竹,2023-09-18,2184
00753L,中信中國50正2,8,0,8,亞東-新竹,2023-09-18,2184
2402,毅嘉,10,2,8,亞東-新竹,2023-09-18,2184
3673,TPK-KY,8,0,8,亞東-新竹,2023-09-18,2184
6233,旺玖,8,0,8,亞東-新竹,2023-09-18,2184
3231,緯創,12,5,7,亞東-新竹,2023-09-18,2184
00915,凱基優選高股息30,7,0,7,亞東-新竹,2023-09-18,2184
6239,力成,7,0,7,亞東-新竹,2023-09-18,2184
00918,大華優利高填息30,6,0,6,亞東-新竹,2023-09-18,2184
2387,精元,6,0,6,亞東-新竹,2023-09-18,2184
2887,台新金,5,0,5,亞東-新竹,2023-09-18,2184
2382,廣達,6,1,5,亞東-新竹,2023-09-18,2184
1104,環泥,5,0,5,亞東-新竹,2023-09-18,2184
2352,佳世達,5,0,5,亞東-新竹,2023-09-18,2184
2367,燿華,5,0,5,亞東-新竹,2023-09-18,2184
2409,友達,5,0,5,亞東-新竹,2023-09-18,2184
2915,潤泰全,5,0,5,亞東-新竹,2023-09-18,2184
3491,昇達科,5,0,5,亞東-新竹,2023-09-18,2184
3702,大聯大,5,0,5,亞東-新竹,2023-09-18,2184
2834,臺企銀,200,117,83,亞東-新竹,2023-09-19,2184
00929,復華台灣科技優息,60,0,60,亞東-新竹,2023-09-19,2184
00680L,元大美債20正2,100,44,56,亞東-新竹,2023-09-19,2184
00919,群益台灣精選高息,92,51,41,亞東-新竹,2023-09-19,2184
6257,矽格,36,3,33,亞東-新竹,2023-09-19,2184
6901,鑽石投資,29,0,29,亞東-新竹,2023-09-19,2184
2354,鴻準,23,0,23,亞東-新竹,2023-09-19,2184
2409,友達,20,5,15,亞東-新竹,2023-09-19,2184
3322,建舜電,15,0,15,亞東-新竹,2023-09-19,2184
6026,福邦證,25,10,15,亞東-新竹,2023-09-19,2184
0056,元大高股息,14,0,14,亞東-新竹,2023-09-19,2184
00673R,期元大S＆P原油反1,12,0,12,亞東-新竹,2023-09-19,2184
2002,中鋼,12,0,12,亞東-新竹,2023-09-19,2184
2618,長榮航,12,0,12,亞東-新竹,2023-09-19,2184
3044,健鼎,12,0,12,亞東-新竹,2023-09-19,2184
2356,英業達,43,32,11,亞東-新竹,2023-09-19,2184
00878,國泰永續高股息,11,0,11,亞東-新竹,2023-09-19,2184
00877,復華中國5G,11,0,11,亞東-新竹,2023-09-19,2184
1102,亞泥,10,0,10,亞東-新竹,2023-09-19,2184
4128,中天,10,0,10,亞東-新竹,2023-09-19,2184
6126,信音,10,0,10,亞東-新竹,2023-09-19,2184
2637,慧洋-KY,11,2,9,亞東-新竹,2023-09-19,2184
00932,兆豐永續高息等權,8,0,8,亞東-新竹,2023-09-19,2184
00923,群益台ESG低碳50,8,0,8,亞東-新竹,2023-09-19,2184
1616,億泰,8,0,8,亞東-新竹,2023-09-19,2184
2312,金寶,8,0,8,亞東-新竹,2023-09-19,2184
2371,大同,8,0,8,亞東-新竹,2023-09-19,2184
3034,聯詠,8,0,8,亞東-新竹,2023-09-19,2184
2468,華經,7,0,7,亞東-新竹,2023-09-19,2184
6147,頎邦,7,0,7,亞東-新竹,2023-09-19,2184
2330,台積電,7,1,6,亞東-新竹,2023-09-19,2184
00752,中信中國50,6,0,6,亞東-新竹,2023-09-19,2184
00733,富邦臺灣中小,6,0,6,亞東-新竹,2023-09-19,2184
1815,富喬,6,0,6,亞東-新竹,2023-09-19,2184
2329,華泰,12,6,6,亞東-新竹,2023-09-19,2184
2387,精元,6,0,6,亞東-新竹,2023-09-19,2184
3673,TPK-KY,6,0,6,亞東-新竹,2023-09-19,2184
3715,定穎投控,9,3,6,亞東-新竹,2023-09-19,2184
4966,譜瑞-KY,6,0,6,亞東-新竹,2023-09-19,2184
6531,愛普*,9,3,6,亞東-新竹,2023-09-19,2184
2887,台新金,5,0,5,亞東-新竹,2023-09-19,2184
00888,永豐台灣ESG,5,0,5,亞東-新竹,2023-09-19,2184
00922,國泰台灣領袖50,5,0,5,亞東-新竹,2023-09-19,2184
2342,茂矽,10,5,5,亞東-新竹,2023-09-19,2184
6187,萬潤,5,0,5,亞東-新竹,2023-09-19,2184
6547,高端疫苗,5,0,5,亞東-新竹,2023-09-19,2184
2206,三陽工業,7,2,5,亞東-新竹,2023-09-19,2184
4961,天鈺,10,6,4,亞東-新竹,2023-09-19,2184
0050,元大台灣50,4,0,4,亞東-新竹,2023-09-19,2184
2303,聯電,6,2,4,亞東-新竹,2023-09-19,2184
2834,臺企銀,200,0,200,亞東-新竹,2023-09-20,2184
2354,鴻準,103,0,103,亞東-新竹,2023-09-20,2184
00929,復華台灣科技優息,100,35,65,亞東-新竹,2023-09-20,2184
3576,聯合再生,30,0,30,亞東-新竹,2023-09-20,2184
2201,裕隆,40,15,25,亞東-新竹,2023-09-20,2184
00888,永豐台灣ESG,20,0,20,亞東-新竹,2023-09-20,2184
2344,華邦電,25,5,20,亞東-新竹,2023-09-20,2184
1720,生達,17,0,17,亞東-新竹,2023-09-20,2184
2887,台新金,15,0,15,亞東-新竹,2023-09-20,2184
1616,億泰,15,0,15,亞東-新竹,2023-09-20,2184
2427,三商電,15,0,15,亞東-新竹,2023-09-20,2184
4157,太景*-KY,25,10,15,亞東-新竹,2023-09-20,2184
6026,福邦證,25,10,15,亞東-新竹,2023-09-20,2184
3706,神達,13,1,12,亞東-新竹,2023-09-20,2184
4105,東洋,11,0,11,亞東-新竹,2023-09-20,2184
3231,緯創,33,22,11,亞東-新竹,2023-09-20,2184
00683L,期元大美元指正2,10,0,10,亞東-新竹,2023-09-20,2184
2460,建通,12,2,10,亞東-新竹,2023-09-20,2184
3673,TPK-KY,10,0,10,亞東-新竹,2023-09-20,2184
3715,定穎投控,11,1,10,亞東-新竹,2023-09-20,2184
6005,群益證,30,20,10,亞東-新竹,2023-09-20,2184
8039,台虹,10,0,10,亞東-新竹,2023-09-20,2184
00757,統一FANG+,9,0,9,亞東-新竹,2023-09-20,2184
1101,台泥,14,6,8,亞東-新竹,2023-09-20,2184
2402,毅嘉,8,0,8,亞東-新竹,2023-09-20,2184
9921,巨大,8,0,8,亞東-新竹,2023-09-20,2184
2882,國泰金,7,0,7,亞東-新竹,2023-09-20,2184
00932,兆豐永續高息等權,7,0,7,亞東-新竹,2023-09-20,2184
2324,仁寶,7,0,7,亞東-新竹,2023-09-20,2184
2352,佳世達,7,0,7,亞東-新竹,2023-09-20,2184
6684,安格,11,4,7,亞東-新竹,2023-09-20,2184
2449,京元電子,8,2,6,亞東-新竹,2023-09-20,2184
00773B,中信優先金融債,6,0,6,亞東-新竹,2023-09-20,2184
00679B,元大美債20年,6,0,6,亞東-新竹,2023-09-20,2184
6223,旺矽,6,0,6,亞東-新竹,2023-09-20,2184
2330,台積電,9,4,5,亞東-新竹,2023-09-20,2184
00751B,元大AAA至A公司債,5,0,5,亞東-新竹,2023-09-20,2184
00878,國泰永續高股息,8,3,5,亞東-新竹,2023-09-20,2184
2618,長榮航,15,10,5,亞東-新竹,2023-09-20,2184
2634,漢翔,5,0,5,亞東-新竹,2023-09-20,2184
6269,台郡,5,0,5,亞東-新竹,2023-09-20,2184
3034,聯詠,5,0,5,亞東-新竹,2023-09-20,2184
1319,東陽,5,1,4,亞東-新竹,2023-09-20,2184
2542,興富發,4,0,4,亞東-新竹,2023-09-20,2184
8033,雷虎,4,0,4,亞東-新竹,2023-09-20,2184
3260,威剛,3,0,3,亞東-新竹,2023-09-20,2184
3481,群創,3,0,3,亞東-新竹,2023-09-20,2184
00850,元大臺灣ESG永續,3,0,3,亞東-新竹,2023-09-20,2184
00830,國泰費城半導體,3,0,3,亞東-新竹,2023-09-20,2184
00753L,中信中國50正2,3,0,3,亞東-新竹,2023-09-20,2184
2891,中信金,185,5,180,亞東-新竹,2023-09-21,2184
2882,國泰金,102,0,102,亞東-新竹,2023-09-21,2184
00919,群益台灣精選高息,66,6,60,亞東-新竹,2023-09-21,2184
00673R,期元大S＆P原油反1,35,0,35,亞東-新竹,2023-09-21,2184
2401,凌陽,44,11,33,亞東-新竹,2023-09-21,2184
00878,國泰永續高股息,33,1,32,亞東-新竹,2023-09-21,2184
2610,華航,46,14,32,亞東-新竹,2023-09-21,2184
2887,台新金,32,1,31,亞東-新竹,2023-09-21,2184
2417,圓剛,30,0,30,亞東-新竹,2023-09-21,2184
6026,福邦證,40,10,30,亞東-新竹,2023-09-21,2184
2354,鴻準,25,1,24,亞東-新竹,2023-09-21,2184
1324,地球,22,0,22,亞東-新竹,2023-09-21,2184
2888,新光金,20,0,20,亞東-新竹,2023-09-21,2184
4114,健喬,20,0,20,亞東-新竹,2023-09-21,2184
2605,新興,24,6,18,亞東-新竹,2023-09-21,2184
2377,微星,17,0,17,亞東-新竹,2023-09-21,2184
2881,富邦金,16,0,16,亞東-新竹,2023-09-21,2184
3673,TPK-KY,15,0,15,亞東-新竹,2023-09-21,2184
2801,彰銀,15,3,12,亞東-新竹,2023-09-21,2184
2890,永豐金,12,0,12,亞東-新竹,2023-09-21,2184
1402,遠東新,11,0,11,亞東-新竹,2023-09-21,2184
2201,裕隆,26,15,11,亞東-新竹,2023-09-21,2184
00902,中信電池及儲能,10,0,10,亞東-新竹,2023-09-21,2184
00893,國泰智能電動車,21,11,10,亞東-新竹,2023-09-21,2184
2402,毅嘉,18,8,10,亞東-新竹,2023-09-21,2184
2618,長榮航,26,16,10,亞東-新竹,2023-09-21,2184
8039,台虹,10,0,10,亞東-新竹,2023-09-21,2184
8358,金居,10,0,10,亞東-新竹,2023-09-21,2184
2330,台積電,21,11,10,亞東-新竹,2023-09-21,2184
1720,生達,8,0,8,亞東-新竹,2023-09-21,2184
00720B,元大投資級公司債,7,0,7,亞東-新竹,2023-09-21,2184
3511,矽瑪,7,0,7,亞東-新竹,2023-09-21,2184
4119,旭富,7,0,7,亞東-新竹,2023-09-21,2184
1101,台泥,8,2,6,亞東-新竹,2023-09-21,2184
2002,中鋼,6,0,6,亞東-新竹,2023-09-21,2184
1301,台塑,6,0,6,亞東-新竹,2023-09-21,2184
00751B,元大AAA至A公司債,6,0,6,亞東-新竹,2023-09-21,2184
2317,鴻海,6,0,6,亞東-新竹,2023-09-21,2184
2324,仁寶,6,0,6,亞東-新竹,2023-09-21,2184
3711,日月光投控,7,1,6,亞東-新竹,2023-09-21,2184
0050,元大台灣50,5,0,5,亞東-新竹,2023-09-21,2184
0056,元大高股息,5,0,5,亞東-新竹,2023-09-21,2184
00679B,元大美債20年,5,0,5,亞東-新竹,2023-09-21,2184
00830,國泰費城半導體,5,0,5,亞東-新竹,2023-09-21,2184
1710,東聯,5,0,5,亞東-新竹,2023-09-21,2184
2409,友達,5,0,5,亞東-新竹,2023-09-21,2184
2838,聯邦銀,5,0,5,亞東-新竹,2023-09-21,2184
2885,元大金,5,0,5,亞東-新竹,2023-09-21,2184
3005,神基,5,0,5,亞東-新竹,2023-09-21,2184
4128,中天,5,0,5,亞東-新竹,2023-09-21,2184
2882,國泰金,131,0,131,亞東-新竹,2023-09-22,2184
00712,復華富時不動產,107,0,107,亞東-新竹,2023-09-22,2184
2316,楠梓電,76,0,76,亞東-新竹,2023-09-22,2184
00720B,元大投資級公司債,68,0,68,亞東-新竹,2023-09-22,2184
1616,億泰,71,10,61,亞東-新竹,2023-09-22,2184
1504,東元,55,2,53,亞東-新竹,2023-09-22,2184
0050,元大台灣50,43,0,43,亞東-新竹,2023-09-22,2184
2368,金像電,40,0,40,亞東-新竹,2023-09-22,2184
00679B,元大美債20年,34,1,33,亞東-新竹,2023-09-22,2184
2905,三商,32,0,32,亞東-新竹,2023-09-22,2184
00632R,元大台灣50反1,40,10,30,亞東-新竹,2023-09-22,2184
1802,台玻,30,0,30,亞東-新竹,2023-09-22,2184
4114,健喬,30,0,30,亞東-新竹,2023-09-22,2184
2376,技嘉,36,7,29,亞東-新竹,2023-09-22,2184
00931B,統一美債20年,23,0,23,亞東-新竹,2023-09-22,2184
00773B,中信優先金融債,21,0,21,亞東-新竹,2023-09-22,2184
3324,雙鴻,21,0,21,亞東-新竹,2023-09-22,2184
00919,群益台灣精選高息,20,0,20,亞東-新竹,2023-09-22,2184
00929,復華台灣科技優息,23,3,20,亞東-新竹,2023-09-22,2184
1324,地球,18,0,18,亞東-新竹,2023-09-22,2184
00751B,元大AAA至A公司債,18,0,18,亞東-新竹,2023-09-22,2184
00687B,國泰20年美債,17,0,17,亞東-新竹,2023-09-22,2184
00932,兆豐永續高息等權,14,0,14,亞東-新竹,2023-09-22,2184
2002,中鋼,14,0,14,亞東-新竹,2023-09-22,2184
6026,福邦證,44,30,14,亞東-新竹,2023-09-22,2184
00795B,中信美國公債20年,13,0,13,亞東-新竹,2023-09-22,2184
00857B,永豐20年美公債,13,0,13,亞東-新竹,2023-09-22,2184
00722B,群益投資級電信債,13,1,12,亞東-新竹,2023-09-22,2184
2303,聯電,12,0,12,亞東-新竹,2023-09-22,2184
00680L,元大美債20正2,12,0,12,亞東-新竹,2023-09-22,2184
00878,國泰永續高股息,12,0,12,亞東-新竹,2023-09-22,2184
00772B,中信高評級公司債,12,0,12,亞東-新竹,2023-09-22,2184
00757,統一FANG+,9,0,9,亞東-新竹,2023-09-22,2184
3025,星通,7,0,7,亞東-新竹,2023-09-22,2184
3083,網龍,7,0,7,亞東-新竹,2023-09-22,2184
2330,台積電,14,7,7,亞東-新竹,2023-09-22,2184
2881,富邦金,6,0,6,亞東-新竹,2023-09-22,2184
1101,台泥,9,4,5,亞東-新竹,2023-09-22,2184
00885,富邦越南,5,0,5,亞東-新竹,2023-09-22,2184
1513,中興電,5,0,5,亞東-新竹,2023-09-22,2184
1785,光洋科,5,0,5,亞東-新竹,2023-09-22,2184
2363,矽統,22,17,5,亞東-新竹,2023-09-22,2184
5306,桂盟,5,0,5,亞東-新竹,2023-09-22,2184
5880,合庫金,5,0,5,亞東-新竹,2023-09-22,2184
3037,欣興,8,4,4,亞東-新竹,2023-09-22,2184
2338,光罩,5,1,4,亞東-新竹,2023-09-22,2184
3706,神達,4,0,4,亞東-新竹,2023-09-22,2184
00930,永豐ESG低碳高息,3,0,3,亞東-新竹,2023-09-22,2184
00924,復華S＆P500成長,3,0,3,亞東-新竹,2023-09-22,2184
00830,國泰費城半導體,3,0,3,亞東-新竹,2023-09-22,2184
00680L,元大美債20正2,200,0,200,亞東-新竹,2023-09-25,2184
00929,復華台灣科技優息,58,8,50,亞東-新竹,2023-09-25,2184
00931B,統一美債20年,20,0,20,亞東-新竹,2023-09-25,2184
2885,元大金,20,0,20,亞東-新竹,2023-09-25,2184
00888,永豐台灣ESG,19,0,19,亞東-新竹,2023-09-25,2184
2867,三商壽,12,0,12,亞東-新竹,2023-09-25,2184
00893,國泰智能電動車,11,0,11,亞東-新竹,2023-09-25,2184
00679B,元大美債20年,12,1,11,亞東-新竹,2023-09-25,2184
1560,中砂,10,0,10,亞東-新竹,2023-09-25,2184
2201,裕隆,27,17,10,亞東-新竹,2023-09-25,2184
4106,雃博,10,0,10,亞東-新竹,2023-09-25,2184
4908,前鼎,11,1,10,亞東-新竹,2023-09-25,2184
6901,鑽石投資,10,0,10,亞東-新竹,2023-09-25,2184
2462,良得電,10,0,10,亞東-新竹,2023-09-25,2184
2313,華通,14,4,10,亞東-新竹,2023-09-25,2184
2376,技嘉,14,5,9,亞東-新竹,2023-09-25,2184
3013,晟銘電,8,0,8,亞東-新竹,2023-09-25,2184
1101,台泥,8,1,7,亞東-新竹,2023-09-25,2184
6274,台燿,7,0,7,亞東-新竹,2023-09-25,2184
2002,中鋼,6,0,6,亞東-新竹,2023-09-25,2184
2887,台新金,6,0,6,亞東-新竹,2023-09-25,2184
5347,世界,6,0,6,亞東-新竹,2023-09-25,2184
2206,三陽工業,17,12,5,亞東-新竹,2023-09-25,2184
2371,大同,5,0,5,亞東-新竹,2023-09-25,2184
3034,聯詠,5,0,5,亞東-新竹,2023-09-25,2184
5536,聖暉*,5,0,5,亞東-新竹,2023-09-25,2184
1709,和益,5,1,4,亞東-新竹,2023-09-25,2184
2382,廣達,9,5,4,亞東-新竹,2023-09-25,2184
00753L,中信中國50正2,4,0,4,亞東-新竹,2023-09-25,2184
6546,正基,4,0,4,亞東-新竹,2023-09-25,2184
910322,康師傅-DR,4,0,4,亞東-新竹,2023-09-25,2184
3665,貿聯-KY,4,0,4,亞東-新竹,2023-09-25,2184
2330,台積電,4,1,3,亞東-新竹,2023-09-25,2184
2618,長榮航,3,0,3,亞東-新竹,2023-09-25,2184
00878,國泰永續高股息,4,1,3,亞東-新竹,2023-09-25,2184
1717,長興,4,1,3,亞東-新竹,2023-09-25,2184
2838,聯邦銀,3,0,3,亞東-新竹,2023-09-25,2184
4766,南寶,3,0,3,亞東-新竹,2023-09-25,2184
6156,松上,3,0,3,亞東-新竹,2023-09-25,2184
6684,安格,3,0,3,亞東-新竹,2023-09-25,2184
6869,雲豹能源,3,0,3,亞東-新竹,2023-09-25,2184
4155,訊映,3,0,3,亞東-新竹,2023-09-25,2184
6531,愛普*,6,4,2,亞東-新竹,2023-09-25,2184
00714,群益道瓊美國地產,2,0,2,亞東-新竹,2023-09-25,2184
1409,新纖,2,0,2,亞東-新竹,2023-09-25,2184
2329,華泰,5,3,2,亞東-新竹,2023-09-25,2184
2884,玉山金,3,1,2,亞東-新竹,2023-09-25,2184
3025,星通,2,0,2,亞東-新竹,2023-09-25,2184
3311,閎暉,2,0,2,亞東-新竹,2023-09-25,2184
3529,力旺,2,0,2,亞東-新竹,2023-09-25,2184
00720B,元大投資級公司債,155,0,155,亞東-新竹,2023-09-26,2184
2834,臺企銀,100,0,100,亞東-新竹,2023-09-26,2184
00929,復華台灣科技優息,65,0,65,亞東-新竹,2023-09-26,2184
5531,鄉林,30,0,30,亞東-新竹,2023-09-26,2184
00878,國泰永續高股息,28,1,27,亞東-新竹,2023-09-26,2184
00931B,統一美債20年,26,0,26,亞東-新竹,2023-09-26,2184
00680L,元大美債20正2,22,0,22,亞東-新竹,2023-09-26,2184
2614,東森,20,0,20,亞東-新竹,2023-09-26,2184
2303,聯電,24,5,19,亞東-新竹,2023-09-26,2184
2356,英業達,31,12,19,亞東-新竹,2023-09-26,2184
00687B,國泰20年美債,16,0,16,亞東-新竹,2023-09-26,2184
2330,台積電,16,0,16,亞東-新竹,2023-09-26,2184
1101,台泥,16,2,14,亞東-新竹,2023-09-26,2184
00919,群益台灣精選高息,12,0,12,亞東-新竹,2023-09-26,2184
2610,華航,20,8,12,亞東-新竹,2023-09-26,2184
3711,日月光投控,16,5,11,亞東-新竹,2023-09-26,2184
2462,良得電,11,0,11,亞東-新竹,2023-09-26,2184
5347,世界,10,0,10,亞東-新竹,2023-09-26,2184
1618,合機,10,0,10,亞東-新竹,2023-09-26,2184
2888,新光金,10,0,10,亞東-新竹,2023-09-26,2184
6026,福邦證,20,10,10,亞東-新竹,2023-09-26,2184
6770,力積電,10,0,10,亞東-新竹,2023-09-26,2184
4906,正文,9,0,9,亞東-新竹,2023-09-26,2184
3673,TPK-KY,8,0,8,亞東-新竹,2023-09-26,2184
2308,台達電,7,0,7,亞東-新竹,2023-09-26,2184
2201,裕隆,21,14,7,亞東-新竹,2023-09-26,2184
0056,元大高股息,7,1,6,亞東-新竹,2023-09-26,2184
00751B,元大AAA至A公司債,6,0,6,亞東-新竹,2023-09-26,2184
4106,雃博,6,0,6,亞東-新竹,2023-09-26,2184
2634,漢翔,5,0,5,亞東-新竹,2023-09-26,2184
1522,堤維西,6,1,5,亞東-新竹,2023-09-26,2184
1513,中興電,5,0,5,亞東-新竹,2023-09-26,2184
1402,遠東新,5,0,5,亞東-新竹,2023-09-26,2184
00900,富邦特選高股息30,5,0,5,亞東-新竹,2023-09-26,2184
00772B,中信高評級公司債,5,0,5,亞東-新竹,2023-09-26,2184
2344,華邦電,5,0,5,亞東-新竹,2023-09-26,2184
4147,中裕,5,0,5,亞東-新竹,2023-09-26,2184
4538,大詠城,5,0,5,亞東-新竹,2023-09-26,2184
5880,合庫金,5,0,5,亞東-新竹,2023-09-26,2184
9919,康那香,5,0,5,亞東-新竹,2023-09-26,2184
2881,富邦金,4,0,4,亞東-新竹,2023-09-26,2184
0050,元大台灣50,4,0,4,亞東-新竹,2023-09-26,2184
00795B,中信美國公債20年,4,0,4,亞東-新竹,2023-09-26,2184
2382,廣達,12,8,4,亞東-新竹,2023-09-26,2184
00932,兆豐永續高息等權,4,0,4,亞東-新竹,2023-09-26,2184
2379,瑞昱,4,0,4,亞東-新竹,2023-09-26,2184
2402,毅嘉,6,2,4,亞東-新竹,2023-09-26,2184
2884,玉山金,4,0,4,亞東-新竹,2023-09-26,2184
3615,安可,4,0,4,亞東-新竹,2023-09-26,2184
6108,競國,4,0,4,亞東-新竹,2023-09-26,2184
00929,復華台灣科技優息,159,2,157,亞東-新竹,2023-09-27,2184
2538,基泰,72,0,72,亞東-新竹,2023-09-27,2184
2014,中鴻,61,0,61,亞東-新竹,2023-09-27,2184
2002,中鋼,43,6,37,亞東-新竹,2023-09-27,2184
1802,台玻,30,0,30,亞東-新竹,2023-09-27,2184
3025,星通,26,1,25,亞東-新竹,2023-09-27,2184
2303,聯電,26,6,20,亞東-新竹,2023-09-27,2184
00720B,元大投資級公司債,20,0,20,亞東-新竹,2023-09-27,2184
1514,亞力,19,0,19,亞東-新竹,2023-09-27,2184
1609,大亞,30,14,16,亞東-新竹,2023-09-27,2184
2883,凱基金,15,0,15,亞東-新竹,2023-09-27,2184
6026,福邦證,20,5,15,亞東-新竹,2023-09-27,2184
1720,生達,14,1,13,亞東-新竹,2023-09-27,2184
4906,正文,12,0,12,亞東-新竹,2023-09-27,2184
00919,群益台灣精選高息,14,3,11,亞東-新竹,2023-09-27,2184
2427,三商電,13,2,11,亞東-新竹,2023-09-27,2184
4542,科嶠,32,21,11,亞東-新竹,2023-09-27,2184
00664R,國泰臺灣加權反1,10,0,10,亞東-新竹,2023-09-27,2184
2354,鴻準,10,0,10,亞東-新竹,2023-09-27,2184
2441,超豐,10,0,10,亞東-新竹,2023-09-27,2184
6269,台郡,10,0,10,亞東-新竹,2023-09-27,2184
1102,亞泥,8,0,8,亞東-新竹,2023-09-27,2184
00679B,元大美債20年,9,1,8,亞東-新竹,2023-09-27,2184
2542,興富發,7,0,7,亞東-新竹,2023-09-27,2184
3045,台灣大,7,0,7,亞東-新竹,2023-09-27,2184
1784,訊聯,6,0,6,亞東-新竹,2023-09-27,2184
2206,三陽工業,6,0,6,亞東-新竹,2023-09-27,2184
2338,光罩,6,0,6,亞東-新竹,2023-09-27,2184
9921,巨大,6,0,6,亞東-新竹,2023-09-27,2184
5347,世界,5,0,5,亞東-新竹,2023-09-27,2184
2367,燿華,5,0,5,亞東-新竹,2023-09-27,2184
2618,長榮航,5,0,5,亞東-新竹,2023-09-27,2184
2886,兆豐金,7,2,5,亞東-新竹,2023-09-27,2184
3691,碩禾,5,0,5,亞東-新竹,2023-09-27,2184
3712,永崴投控,5,0,5,亞東-新竹,2023-09-27,2184
8358,金居,5,0,5,亞東-新竹,2023-09-27,2184
00631L,元大台灣50正2,13,9,4,亞東-新竹,2023-09-27,2184
2486,一詮,4,0,4,亞東-新竹,2023-09-27,2184
4908,前鼎,9,5,4,亞東-新竹,2023-09-27,2184
4953,緯軟,4,0,4,亞東-新竹,2023-09-27,2184
6129,普誠,4,0,4,亞東-新竹,2023-09-27,2184
6499,益安,4,0,4,亞東-新竹,2023-09-27,2184
8420,明揚,4,0,4,亞東-新竹,2023-09-27,2184
9904,寶成,4,0,4,亞東-新竹,2023-09-27,2184
1605,華新,3,0,3,亞東-新竹,2023-09-27,2184
00878,國泰永續高股息,3,0,3,亞東-新竹,2023-09-27,2184
0056,元大高股息,3,0,3,亞東-新竹,2023-09-27,2184
00757,統一FANG+,3,0,3,亞東-新竹,2023-09-27,2184
00753L,中信中國50正2,3,0,3,亞東-新竹,2023-09-27,2184
2645,長榮航太,3,0,3,亞東-新竹,2023-09-27,2184
2610,華航,44,0,44,亞東-新竹,2023-09-28,2184
00720B,元大投資級公司債,29,0,29,亞東-新竹,2023-09-28,2184
2436,偉詮電,20,0,20,亞東-新竹,2023-09-28,2184
2363,矽統,22,4,18,亞東-新竹,2023-09-28,2184
3680,家登,18,1,17,亞東-新竹,2023-09-28,2184
2201,裕隆,27,12,15,亞東-新竹,2023-09-28,2184
2337,旺宏,15,0,15,亞東-新竹,2023-09-28,2184
3545,敦泰,15,0,15,亞東-新竹,2023-09-28,2184
5871,中租-KY,12,0,12,亞東-新竹,2023-09-28,2184
2002,中鋼,12,0,12,亞東-新竹,2023-09-28,2184
3231,緯創,24,13,11,亞東-新竹,2023-09-28,2184
00631L,元大台灣50正2,11,0,11,亞東-新竹,2023-09-28,2184
3083,網龍,11,0,11,亞東-新竹,2023-09-28,2184
9904,寶成,11,0,11,亞東-新竹,2023-09-28,2184
00683L,期元大美元指正2,10,0,10,亞東-新竹,2023-09-28,2184
00688L,國泰20年美債正2,10,0,10,亞東-新竹,2023-09-28,2184
3558,神準,10,0,10,亞東-新竹,2023-09-28,2184
00931B,統一美債20年,11,2,9,亞東-新竹,2023-09-28,2184
00929,復華台灣科技優息,9,0,9,亞東-新竹,2023-09-28,2184
2344,華邦電,10,1,9,亞東-新竹,2023-09-28,2184
2345,智邦,9,0,9,亞東-新竹,2023-09-28,2184
3715,定穎投控,43,34,9,亞東-新竹,2023-09-28,2184
3011,今皓,8,0,8,亞東-新竹,2023-09-28,2184
00712,復華富時不動產,8,0,8,亞東-新竹,2023-09-28,2184
2317,鴻海,7,0,7,亞東-新竹,2023-09-28,2184
2313,華通,16,9,7,亞東-新竹,2023-09-28,2184
1471,首利,7,0,7,亞東-新竹,2023-09-28,2184
1402,遠東新,5,0,5,亞東-新竹,2023-09-28,2184
00902,中信電池及儲能,5,0,5,亞東-新竹,2023-09-28,2184
00773B,中信優先金融債,5,0,5,亞東-新竹,2023-09-28,2184
3481,群創,5,0,5,亞東-新竹,2023-09-28,2184
3522,御嵿,5,0,5,亞東-新竹,2023-09-28,2184
6187,萬潤,10,5,5,亞東-新竹,2023-09-28,2184
2618,長榮航,14,9,5,亞東-新竹,2023-09-28,2184
00878,國泰永續高股息,4,0,4,亞東-新竹,2023-09-28,2184
00680L,元大美債20正2,4,0,4,亞東-新竹,2023-09-28,2184
2376,技嘉,7,3,4,亞東-新竹,2023-09-28,2184
3105,穩懋,4,0,4,亞東-新竹,2023-09-28,2184
4908,前鼎,6,2,4,亞東-新竹,2023-09-28,2184
6125,廣運,4,0,4,亞東-新竹,2023-09-28,2184
2330,台積電,3,0,3,亞東-新竹,2023-09-28,2184
4763,材料-KY,3,0,3,亞東-新竹,2023-09-28,2184
1503,士電,4,1,3,亞東-新竹,2023-09-28,2184
00740B,富邦全球投等債,3,0,3,亞東-新竹,2023-09-28,2184
00919,群益台灣精選高息,3,0,3,亞東-新竹,2023-09-28,2184
2368,金像電,3,0,3,亞東-新竹,2023-09-28,2184
3014,聯陽,3,0,3,亞東-新竹,2023-09-28,2184
3645,達邁,3,0,3,亞東-新竹,2023-09-28,2184
4979,華星光,3,0,3,亞東-新竹,2023-09-28,2184
5263,智崴,3,0,3,亞東-新竹,2023-09-28,2184
2845,遠東銀,352,249,103,亞東-新竹,2023-10-02,2184
2883,凱基金,100,0,100,亞東-新竹,2023-10-02,2184
00929,復華台灣科技優息,90,1,89,亞東-新竹,2023-10-02,2184
00751B,元大AAA至A公司債,63,0,63,亞東-新竹,2023-10-02,2184
0056,元大高股息,50,10,40,亞東-新竹,2023-10-02,2184
3036,文曄,41,1,40,亞東-新竹,2023-10-02,2184
4114,健喬,36,0,36,亞東-新竹,2023-10-02,2184
2913,農林,35,0,35,亞東-新竹,2023-10-02,2184
1710,東聯,25,0,25,亞東-新竹,2023-10-02,2184
2618,長榮航,23,0,23,亞東-新竹,2023-10-02,2184
2409,友達,23,0,23,亞東-新竹,2023-10-02,2184
1720,生達,20,0,20,亞東-新竹,2023-10-02,2184
00885,富邦越南,20,0,20,亞東-新竹,2023-10-02,2184
00679B,元大美債20年,20,1,19,亞東-新竹,2023-10-02,2184
2204,中華,20,1,19,亞東-新竹,2023-10-02,2184
00720B,元大投資級公司債,16,0,16,亞東-新竹,2023-10-02,2184
8924,大田,15,0,15,亞東-新竹,2023-10-02,2184
2885,元大金,14,0,14,亞東-新竹,2023-10-02,2184
2316,楠梓電,14,1,13,亞東-新竹,2023-10-02,2184
2542,興富發,12,0,12,亞東-新竹,2023-10-02,2184
00931B,統一美債20年,12,0,12,亞東-新竹,2023-10-02,2184
2888,新光金,30,20,10,亞東-新竹,2023-10-02,2184
1102,亞泥,10,0,10,亞東-新竹,2023-10-02,2184
00786B,元大10年IG銀行債,10,0,10,亞東-新竹,2023-10-02,2184
3680,家登,11,1,10,亞東-新竹,2023-10-02,2184
00772B,中信高評級公司債,7,0,7,亞東-新竹,2023-10-02,2184
3025,星通,9,2,7,亞東-新竹,2023-10-02,2184
2374,佳能,7,1,6,亞東-新竹,2023-10-02,2184
8936,國統,6,0,6,亞東-新竹,2023-10-02,2184
2002,中鋼,5,0,5,亞東-新竹,2023-10-02,2184
00773B,中信優先金融債,5,0,5,亞東-新竹,2023-10-02,2184
2324,仁寶,5,0,5,亞東-新竹,2023-10-02,2184
3083,網龍,5,0,5,亞東-新竹,2023-10-02,2184
3705,永信,5,0,5,亞東-新竹,2023-10-02,2184
00919,群益台灣精選高息,4,0,4,亞東-新竹,2023-10-02,2184
00850,元大臺灣ESG永續,4,0,4,亞東-新竹,2023-10-02,2184
1784,訊聯,6,2,4,亞東-新竹,2023-10-02,2184
1519,華城,4,0,4,亞東-新竹,2023-10-02,2184
1609,大亞,4,0,4,亞東-新竹,2023-10-02,2184
3011,今皓,4,0,4,亞東-新竹,2023-10-02,2184
6126,信音,4,0,4,亞東-新竹,2023-10-02,2184
6869,雲豹能源,4,0,4,亞東-新竹,2023-10-02,2184
1709,和益,6,3,3,亞東-新竹,2023-10-02,2184
3105,穩懋,3,0,3,亞東-新竹,2023-10-02,2184
00713,元大台灣高息低波,3,0,3,亞東-新竹,2023-10-02,2184
1618,合機,3,0,3,亞東-新竹,2023-10-02,2184
2363,矽統,67,64,3,亞東-新竹,2023-10-02,2184
2801,彰銀,3,0,3,亞東-新竹,2023-10-02,2184
3218,大學光,4,1,3,亞東-新竹,2023-10-02,2184
4533,協易機,3,0,3,亞東-新竹,2023-10-02,2184
00929,復華台灣科技優息,202,0,202,亞東-新竹,2023-10-03,2184
2834,臺企銀,100,0,100,亞東-新竹,2023-10-03,2184
4114,健喬,81,0,81,亞東-新竹,2023-10-03,2184
2881,富邦金,41,1,40,亞東-新竹,2023-10-03,2184
00922,國泰台灣領袖50,27,0,27,亞東-新竹,2023-10-03,2184
2313,華通,29,4,25,亞東-新竹,2023-10-03,2184
2409,友達,34,9,25,亞東-新竹,2023-10-03,2184
4739,康普,23,0,23,亞東-新竹,2023-10-03,2184
6282,康舒,22,0,22,亞東-新竹,2023-10-03,2184
2356,英業達,24,4,20,亞東-新竹,2023-10-03,2184
6026,福邦證,25,5,20,亞東-新竹,2023-10-03,2184
00679B,元大美債20年,17,1,16,亞東-新竹,2023-10-03,2184
2618,長榮航,23,8,15,亞東-新竹,2023-10-03,2184
2002,中鋼,17,2,15,亞東-新竹,2023-10-03,2184
2887,台新金,15,0,15,亞東-新竹,2023-10-03,2184
00877,復華中國5G,14,0,14,亞東-新竹,2023-10-03,2184
00751B,元大AAA至A公司債,13,0,13,亞東-新竹,2023-10-03,2184
1301,台塑,12,0,12,亞東-新竹,2023-10-03,2184
1710,東聯,12,0,12,亞東-新竹,2023-10-03,2184
3083,網龍,12,0,12,亞東-新竹,2023-10-03,2184
2888,新光金,12,0,12,亞東-新竹,2023-10-03,2184
3322,建舜電,11,0,11,亞東-新竹,2023-10-03,2184
1522,堤維西,11,0,11,亞東-新竹,2023-10-03,2184
00887,永豐中國科技50大,11,0,11,亞東-新竹,2023-10-03,2184
2390,云辰,10,0,10,亞東-新竹,2023-10-03,2184
3027,盛達,10,0,10,亞東-新竹,2023-10-03,2184
6138,茂達,10,0,10,亞東-新竹,2023-10-03,2184
1616,億泰,8,0,8,亞東-新竹,2023-10-03,2184
1815,富喬,10,2,8,亞東-新竹,2023-10-03,2184
00687B,國泰20年美債,7,0,7,亞東-新竹,2023-10-03,2184
8210,勤誠,8,1,7,亞東-新竹,2023-10-03,2184
00882,中信中國高股息,6,0,6,亞東-新竹,2023-10-03,2184
2882,國泰金,6,0,6,亞東-新竹,2023-10-03,2184
2402,毅嘉,6,0,6,亞東-新竹,2023-10-03,2184
2520,冠德,6,0,6,亞東-新竹,2023-10-03,2184
2801,彰銀,6,0,6,亞東-新竹,2023-10-03,2184
2845,遠東銀,6,0,6,亞東-新竹,2023-10-03,2184
1514,亞力,10,5,5,亞東-新竹,2023-10-03,2184
00712,復華富時不動產,5,0,5,亞東-新竹,2023-10-03,2184
00633L,富邦上証正2,5,0,5,亞東-新竹,2023-10-03,2184
2417,圓剛,5,0,5,亞東-新竹,2023-10-03,2184
2467,志聖,5,0,5,亞東-新竹,2023-10-03,2184
3515,華擎,5,0,5,亞東-新竹,2023-10-03,2184
6158,禾昌,5,0,5,亞東-新竹,2023-10-03,2184
6442,光聖,6,1,5,亞東-新竹,2023-10-03,2184
1402,遠東新,5,0,5,亞東-新竹,2023-10-03,2184
2891,中信金,5,0,5,亞東-新竹,2023-10-03,2184
00932,兆豐永續高息等權,4,0,4,亞東-新竹,2023-10-03,2184
00857B,永豐20年美公債,4,0,4,亞東-新竹,2023-10-03,2184
00850,元大臺灣ESG永續,4,0,4,亞東-新竹,2023-10-03,2184
00720B,元大投資級公司債,229,0,229,亞東-新竹,2023-10-04,2184
00632R,元大台灣50反1,140,0,140,亞東-新竹,2023-10-04,2184
00929,復華台灣科技優息,114,3,111,亞東-新竹,2023-10-04,2184
00751B,元大AAA至A公司債,67,10,57,亞東-新竹,2023-10-04,2184
3013,晟銘電,52,4,48,亞東-新竹,2023-10-04,2184
2303,聯電,49,2,47,亞東-新竹,2023-10-04,2184
9904,寶成,46,0,46,亞東-新竹,2023-10-04,2184
00673R,期元大S＆P原油反1,50,10,40,亞東-新竹,2023-10-04,2184
1802,台玻,35,0,35,亞東-新竹,2023-10-04,2184
2885,元大金,26,0,26,亞東-新竹,2023-10-04,2184
00712,復華富時不動產,28,3,25,亞東-新竹,2023-10-04,2184
2887,台新金,24,0,24,亞東-新竹,2023-10-04,2184
6288,聯嘉,26,2,24,亞東-新竹,2023-10-04,2184
0056,元大高股息,35,15,20,亞東-新竹,2023-10-04,2184
2409,友達,17,0,17,亞東-新竹,2023-10-04,2184
3027,盛達,15,0,15,亞東-新竹,2023-10-04,2184
2891,中信金,15,0,15,亞東-新竹,2023-10-04,2184
0050,元大台灣50,14,0,14,亞東-新竹,2023-10-04,2184
00922,國泰台灣領袖50,14,0,14,亞東-新竹,2023-10-04,2184
00679B,元大美債20年,21,7,14,亞東-新竹,2023-10-04,2184
3189,景碩,14,0,14,亞東-新竹,2023-10-04,2184
2382,廣達,20,7,13,亞東-新竹,2023-10-04,2184
00719B,元大美債1-3,13,0,13,亞東-新竹,2023-10-04,2184
00919,群益台灣精選高息,12,0,12,亞東-新竹,2023-10-04,2184
00931B,統一美債20年,11,0,11,亞東-新竹,2023-10-04,2184
5439,高技,11,0,11,亞東-新竹,2023-10-04,2184
6770,力積電,11,0,11,亞東-新竹,2023-10-04,2184
2881,富邦金,11,1,10,亞東-新竹,2023-10-04,2184
3055,蔚華科,10,0,10,亞東-新竹,2023-10-04,2184
3083,網龍,10,0,10,亞東-新竹,2023-10-04,2184
3162,精確,10,0,10,亞東-新竹,2023-10-04,2184
3545,敦泰,10,0,10,亞東-新竹,2023-10-04,2184
3322,建舜電,9,0,9,亞東-新竹,2023-10-04,2184
3231,緯創,22,13,9,亞東-新竹,2023-10-04,2184
1720,生達,8,0,8,亞東-新竹,2023-10-04,2184
2641,正德,8,0,8,亞東-新竹,2023-10-04,2184
2884,玉山金,7,0,7,亞東-新竹,2023-10-04,2184
00687B,國泰20年美債,7,0,7,亞東-新竹,2023-10-04,2184
00772B,中信高評級公司債,12,5,7,亞東-新竹,2023-10-04,2184
2022,聚亨,7,0,7,亞東-新竹,2023-10-04,2184
3481,群創,8,1,7,亞東-新竹,2023-10-04,2184
4961,天鈺,7,0,7,亞東-新竹,2023-10-04,2184
1709,和益,7,0,7,亞東-新竹,2023-10-04,2184
00893,國泰智能電動車,6,0,6,亞東-新竹,2023-10-04,2184
1101,台泥,6,0,6,亞東-新竹,2023-10-04,2184
1784,訊聯,6,0,6,亞東-新竹,2023-10-04,2184
2801,彰銀,6,0,6,亞東-新竹,2023-10-04,2184
3260,威剛,6,0,6,亞東-新竹,2023-10-04,2184
6443,元晶,6,0,6,亞東-新竹,2023-10-04,2184
5321,美而快,6,0,6,亞東-新竹,2023-10-04,2184
00632R,元大台灣50反1,599,0,599,亞東-新竹,2023-10-05,2184
00751B,元大AAA至A公司債,50,0,50,亞東-新竹,2023-10-05,2184
00929,復華台灣科技優息,65,21,44,亞東-新竹,2023-10-05,2184
1560,中砂,30,1,29,亞東-新竹,2023-10-05,2184
00631L,元大台灣50正2,23,0,23,亞東-新竹,2023-10-05,2184
3027,盛達,20,0,20,亞東-新竹,2023-10-05,2184
3715,定穎投控,20,1,19,亞東-新竹,2023-10-05,2184
2436,偉詮電,18,0,18,亞東-新竹,2023-10-05,2184
2201,裕隆,29,12,17,亞東-新竹,2023-10-05,2184
2312,金寶,15,0,15,亞東-新竹,2023-10-05,2184
2886,兆豐金,20,7,13,亞東-新竹,2023-10-05,2184
2887,台新金,13,0,13,亞東-新竹,2023-10-05,2184
00712,復華富時不動產,12,0,12,亞東-新竹,2023-10-05,2184
1460,宏遠,12,0,12,亞東-新竹,2023-10-05,2184
2427,三商電,11,0,11,亞東-新竹,2023-10-05,2184
00715L,期街口布蘭特正2,10,0,10,亞東-新竹,2023-10-05,2184
4564,元翎,10,0,10,亞東-新竹,2023-10-05,2184
2618,長榮航,60,52,8,亞東-新竹,2023-10-05,2184
1711,永光,8,0,8,亞東-新竹,2023-10-05,2184
3122,笙泉,25,17,8,亞東-新竹,2023-10-05,2184
4744,皇將,8,0,8,亞東-新竹,2023-10-05,2184
3006,晶豪科,6,0,6,亞東-新竹,2023-10-05,2184
5426,振發,6,0,6,亞東-新竹,2023-10-05,2184
3078,僑威,5,0,5,亞東-新竹,2023-10-05,2184
00722B,群益投資級電信債,5,0,5,亞東-新竹,2023-10-05,2184
00679B,元大美債20年,5,0,5,亞東-新竹,2023-10-05,2184
00637L,元大滬深300正2,5,0,5,亞東-新竹,2023-10-05,2184
2441,超豐,5,0,5,亞東-新竹,2023-10-05,2184
2520,冠德,5,0,5,亞東-新竹,2023-10-05,2184
3380,明泰,5,0,5,亞東-新竹,2023-10-05,2184
6269,台郡,10,5,5,亞東-新竹,2023-10-05,2184
1815,富喬,6,2,4,亞東-新竹,2023-10-05,2184
3037,欣興,5,1,4,亞東-新竹,2023-10-05,2184
4108,懷特,4,0,4,亞東-新竹,2023-10-05,2184
1319,東陽,3,0,3,亞東-新竹,2023-10-05,2184
2812,台中銀,3,0,3,亞東-新竹,2023-10-05,2184
5381,合正,3,0,3,亞東-新竹,2023-10-05,2184
6142,友勁,3,0,3,亞東-新竹,2023-10-05,2184
2634,漢翔,3,1,2,亞東-新竹,2023-10-05,2184
1459,聯發,2,0,2,亞東-新竹,2023-10-05,2184
1402,遠東新,2,0,2,亞東-新竹,2023-10-05,2184
00687B,國泰20年美債,2,0,2,亞東-新竹,2023-10-05,2184
1532,勤美,2,0,2,亞東-新竹,2023-10-05,2184
00931B,統一美債20年,2,0,2,亞東-新竹,2023-10-05,2184
2204,中華,2,0,2,亞東-新竹,2023-10-05,2184
2362,藍天,2,0,2,亞東-新竹,2023-10-05,2184
2801,彰銀,2,0,2,亞東-新竹,2023-10-05,2184
3481,群創,6,4,2,亞東-新竹,2023-10-05,2184
4147,中裕,3,1,2,亞東-新竹,2023-10-05,2184
4155,訊映,2,1,1,亞東-新竹,2023-10-05,2184
00632R,元大台灣50反1,300,0,300,亞東-新竹,2023-10-06,2184
2883,凱基金,110,0,110,亞東-新竹,2023-10-06,2184
00751B,元大AAA至A公司債,58,0,58,亞東-新竹,2023-10-06,2184
00715L,期街口布蘭特正2,40,0,40,亞東-新竹,2023-10-06,2184
00929,復華台灣科技優息,33,1,32,亞東-新竹,2023-10-06,2184
3481,群創,32,0,32,亞東-新竹,2023-10-06,2184
1522,堤維西,26,0,26,亞東-新竹,2023-10-06,2184
00720B,元大投資級公司債,24,0,24,亞東-新竹,2023-10-06,2184
00712,復華富時不動產,19,0,19,亞東-新竹,2023-10-06,2184
2886,兆豐金,27,11,16,亞東-新竹,2023-10-06,2184
2409,友達,15,0,15,亞東-新竹,2023-10-06,2184
3483,力致,15,2,13,亞東-新竹,2023-10-06,2184
1616,億泰,10,0,10,亞東-新竹,2023-10-06,2184
00902,中信電池及儲能,10,0,10,亞東-新竹,2023-10-06,2184
00893,國泰智能電動車,10,0,10,亞東-新竹,2023-10-06,2184
00655L,國泰中國A50正2,10,0,10,亞東-新竹,2023-10-06,2184
2313,華通,8,2,6,亞東-新竹,2023-10-06,2184
2356,英業達,18,12,6,亞東-新竹,2023-10-06,2184
2468,華經,6,0,6,亞東-新竹,2023-10-06,2184
2486,一詮,8,2,6,亞東-新竹,2023-10-06,2184
00687B,國泰20年美債,5,0,5,亞東-新竹,2023-10-06,2184
00679B,元大美債20年,5,0,5,亞東-新竹,2023-10-06,2184
1815,富喬,6,1,5,亞東-新竹,2023-10-06,2184
2382,廣達,25,20,5,亞東-新竹,2023-10-06,2184
2436,偉詮電,5,0,5,亞東-新竹,2023-10-06,2184
4564,元翎,5,0,5,亞東-新竹,2023-10-06,2184
9933,中鼎,5,0,5,亞東-新竹,2023-10-06,2184
3032,偉訓,4,0,4,亞東-新竹,2023-10-06,2184
3037,欣興,4,0,4,亞東-新竹,2023-10-06,2184
4744,皇將,4,0,4,亞東-新竹,2023-10-06,2184
4908,前鼎,5,1,4,亞東-新竹,2023-10-06,2184
2206,三陽工業,3,0,3,亞東-新竹,2023-10-06,2184
2363,矽統,8,5,3,亞東-新竹,2023-10-06,2184
3034,聯詠,3,0,3,亞東-新竹,2023-10-06,2184
3231,緯創,15,12,3,亞東-新竹,2023-10-06,2184
4909,新復興,3,0,3,亞東-新竹,2023-10-06,2184
6477,安集,3,0,3,亞東-新竹,2023-10-06,2184
2002,中鋼,6,4,2,亞東-新竹,2023-10-06,2184
4763,材料-KY,2,0,2,亞東-新竹,2023-10-06,2184
2031,新光鋼,2,0,2,亞東-新竹,2023-10-06,2184
00772B,中信高評級公司債,2,0,2,亞東-新竹,2023-10-06,2184
00725B,國泰投資級公司債,2,0,2,亞東-新竹,2023-10-06,2184
1312,國喬,2,0,2,亞東-新竹,2023-10-06,2184
2402,毅嘉,8,6,2,亞東-新竹,2023-10-06,2184
2421,建準,3,1,2,亞東-新竹,2023-10-06,2184
2609,陽明,2,0,2,亞東-新竹,2023-10-06,2184
2615,萬海,2,0,2,亞東-新竹,2023-10-06,2184
2636,台驊控股,2,0,2,亞東-新竹,2023-10-06,2184
2915,潤泰全,2,0,2,亞東-新竹,2023-10-06,2184
3027,盛達,2,0,2,亞東-新竹,2023-10-06,2184
2834,臺企銀,696,100,596,亞東-新竹,2023-10-11,2184
2610,華航,51,1,50,亞東-新竹,2023-10-11,2184
00720B,元大投資級公司債,44,2,42,亞東-新竹,2023-10-11,2184
00919,群益台灣精選高息,39,0,39,亞東-新竹,2023-10-11,2184
3481,群創,40,1,39,亞東-新竹,2023-10-11,2184
2356,英業達,92,56,36,亞東-新竹,2023-10-11,2184
2002,中鋼,36,4,32,亞東-新竹,2023-10-11,2184
00673R,期元大S＆P原油反1,30,0,30,亞東-新竹,2023-10-11,2184
2618,長榮航,33,12,21,亞東-新竹,2023-10-11,2184
1720,生達,21,0,21,亞東-新竹,2023-10-11,2184
3231,緯創,58,38,20,亞東-新竹,2023-10-11,2184
0056,元大高股息,20,2,18,亞東-新竹,2023-10-11,2184
00929,復華台灣科技優息,28,10,18,亞東-新竹,2023-10-11,2184
3083,網龍,16,0,16,亞東-新竹,2023-10-11,2184
4147,中裕,16,0,16,亞東-新竹,2023-10-11,2184
2376,技嘉,19,4,15,亞東-新竹,2023-10-11,2184
00633L,富邦上証正2,15,0,15,亞東-新竹,2023-10-11,2184
3711,日月光投控,28,13,15,亞東-新竹,2023-10-11,2184
2382,廣達,24,12,12,亞東-新竹,2023-10-11,2184
2201,裕隆,37,25,12,亞東-新竹,2023-10-11,2184
3122,笙泉,31,19,12,亞東-新竹,2023-10-11,2184
9921,巨大,12,0,12,亞東-新竹,2023-10-11,2184
1802,台玻,11,0,11,亞東-新竹,2023-10-11,2184
00902,中信電池及儲能,10,0,10,亞東-新竹,2023-10-11,2184
2340,台亞,10,0,10,亞東-新竹,2023-10-11,2184
3706,神達,10,0,10,亞東-新竹,2023-10-11,2184
3715,定穎投控,12,3,9,亞東-新竹,2023-10-11,2184
6026,福邦證,25,16,9,亞東-新竹,2023-10-11,2184
6443,元晶,10,2,8,亞東-新竹,2023-10-11,2184
00733,富邦臺灣中小,6,0,6,亞東-新竹,2023-10-11,2184
2427,三商電,6,0,6,亞東-新竹,2023-10-11,2184
2367,燿華,5,0,5,亞東-新竹,2023-10-11,2184
3090,日電貿,5,0,5,亞東-新竹,2023-10-11,2184
6523,達爾膚,4,0,4,亞東-新竹,2023-10-11,2184
3276,宇環,4,0,4,亞東-新竹,2023-10-11,2184
4105,東洋,8,4,4,亞東-新竹,2023-10-11,2184
4763,材料-KY,4,0,4,亞東-新竹,2023-10-11,2184
2317,鴻海,5,2,3,亞東-新竹,2023-10-11,2184
3217,優群,3,0,3,亞東-新竹,2023-10-11,2184
3693,營邦,7,4,3,亞東-新竹,2023-10-11,2184
1609,大亞,3,0,3,亞東-新竹,2023-10-11,2184
2485,兆赫,3,0,3,亞東-新竹,2023-10-11,2184
2486,一詮,3,0,3,亞東-新竹,2023-10-11,2184
3019,亞光,3,0,3,亞東-新竹,2023-10-11,2184
3162,精確,3,0,3,亞東-新竹,2023-10-11,2184
3691,碩禾,3,0,3,亞東-新竹,2023-10-11,2184
5285,界霖,3,0,3,亞東-新竹,2023-10-11,2184
6223,旺矽,3,0,3,亞東-新竹,2023-10-11,2184
8255,朋程,3,0,3,亞東-新竹,2023-10-11,2184
2887,台新金,8,6,2,亞東-新竹,2023-10-11,2184
6005,群益證,100,0,100,亞東-新竹,2023-10-12,2184
00632R,元大台灣50反1,99,0,99,亞東-新竹,2023-10-12,2184
2449,京元電子,37,0,37,亞東-新竹,2023-10-12,2184
00720B,元大投資級公司債,35,1,34,亞東-新竹,2023-10-12,2184
00929,復華台灣科技優息,31,0,31,亞東-新竹,2023-10-12,2184
1616,億泰,30,0,30,亞東-新竹,2023-10-12,2184
0056,元大高股息,30,9,21,亞東-新竹,2023-10-12,2184
2363,矽統,25,11,14,亞東-新竹,2023-10-12,2184
00679B,元大美債20年,13,0,13,亞東-新竹,2023-10-12,2184
2441,超豐,12,0,12,亞東-新竹,2023-10-12,2184
3706,神達,11,0,11,亞東-新竹,2023-10-12,2184
3035,智原,16,5,11,亞東-新竹,2023-10-12,2184
00772B,中信高評級公司債,10,0,10,亞東-新竹,2023-10-12,2184
00680L,元大美債20正2,10,0,10,亞東-新竹,2023-10-12,2184
2353,宏��,10,0,10,亞東-新竹,2023-10-12,2184
5469,瀚宇博,10,0,10,亞東-新竹,2023-10-12,2184
6189,豐藝,10,0,10,亞東-新竹,2023-10-12,2184
8039,台虹,10,0,10,亞東-新竹,2023-10-12,2184
3169,亞信,8,0,8,亞東-新竹,2023-10-12,2184
2303,聯電,20,13,7,亞東-新竹,2023-10-12,2184
2316,楠梓電,6,0,6,亞東-新竹,2023-10-12,2184
2609,陽明,6,0,6,亞東-新竹,2023-10-12,2184
1301,台塑,5,0,5,亞東-新竹,2023-10-12,2184
00773B,中信優先金融債,7,2,5,亞東-新竹,2023-10-12,2184
00887,永豐中國科技50大,5,0,5,亞東-新竹,2023-10-12,2184
00712,復華富時不動產,5,0,5,亞東-新竹,2023-10-12,2184
1802,台玻,10,5,5,亞東-新竹,2023-10-12,2184
2468,華經,5,0,5,亞東-新竹,2023-10-12,2184
2883,凱基金,5,0,5,亞東-新竹,2023-10-12,2184
3090,日電貿,5,0,5,亞東-新竹,2023-10-12,2184
3311,閎暉,5,0,5,亞東-新竹,2023-10-12,2184
3680,家登,5,0,5,亞東-新竹,2023-10-12,2184
00719B,元大美債1-3,4,0,4,亞東-新竹,2023-10-12,2184
00902,中信電池及儲能,4,0,4,亞東-新竹,2023-10-12,2184
1101,台泥,4,0,4,亞東-新竹,2023-10-12,2184
1815,富喬,4,0,4,亞東-新竹,2023-10-12,2184
3078,僑威,6,2,4,亞東-新竹,2023-10-12,2184
1402,遠東新,3,0,3,亞東-新竹,2023-10-12,2184
1216,統一,3,0,3,亞東-新竹,2023-10-12,2184
00631L,元大台灣50正2,3,0,3,亞東-新竹,2023-10-12,2184
2352,佳世達,3,0,3,亞東-新竹,2023-10-12,2184
3013,晟銘電,5,2,3,亞東-新竹,2023-10-12,2184
5381,合正,3,0,3,亞東-新竹,2023-10-12,2184
2308,台達電,2,0,2,亞東-新竹,2023-10-12,2184
1532,勤美,2,0,2,亞東-新竹,2023-10-12,2184
1519,華城,4,2,2,亞東-新竹,2023-10-12,2184
1709,和益,2,0,2,亞東-新竹,2023-10-12,2184
1720,生達,2,0,2,亞東-新竹,2023-10-12,2184
2388,威盛,7,5,2,亞東-新竹,2023-10-12,2184
2465,麗臺,3,1,2,亞東-新竹,2023-10-12,2184
00632R,元大台灣50反1,600,0,600,亞東-新竹,2023-10-13,2184
2882,國泰金,106,0,106,亞東-新竹,2023-10-13,2184
0056,元大高股息,65,0,65,亞東-新竹,2023-10-13,2184
2313,華通,65,2,63,亞東-新竹,2023-10-13,2184
00751B,元大AAA至A公司債,54,0,54,亞東-新竹,2023-10-13,2184
2897,王道銀行,40,0,40,亞東-新竹,2023-10-13,2184
2317,鴻海,35,3,32,亞東-新竹,2023-10-13,2184
3083,網龍,27,0,27,亞東-新竹,2023-10-13,2184
8924,大田,20,0,20,亞東-新竹,2023-10-13,2184
3231,緯創,34,15,19,亞東-新竹,2023-10-13,2184
00929,復華台灣科技優息,17,0,17,亞東-新竹,2023-10-13,2184
00919,群益台灣精選高息,14,0,14,亞東-新竹,2023-10-13,2184
00878,國泰永續高股息,14,1,13,亞東-新竹,2023-10-13,2184
00720B,元大投資級公司債,13,0,13,亞東-新竹,2023-10-13,2184
2356,英業達,35,22,13,亞東-新竹,2023-10-13,2184
2887,台新金,12,0,12,亞東-新竹,2023-10-13,2184
2618,長榮航,21,10,11,亞東-新竹,2023-10-13,2184
020034,元大IC設計N,10,0,10,亞東-新竹,2023-10-13,2184
2332,友訊,10,0,10,亞東-新竹,2023-10-13,2184
6449,鈺邦,10,0,10,亞東-新竹,2023-10-13,2184
2382,廣達,12,3,9,亞東-新竹,2023-10-13,2184
3363,上詮,9,0,9,亞東-新竹,2023-10-13,2184
00753L,中信中國50正2,8,0,8,亞東-新竹,2023-10-13,2184
3051,力特,8,0,8,亞東-新竹,2023-10-13,2184
1720,生達,7,0,7,亞東-新竹,2023-10-13,2184
2393,億光,7,0,7,亞東-新竹,2023-10-13,2184
2886,兆豐金,8,1,7,亞東-新竹,2023-10-13,2184
2376,技嘉,16,10,6,亞東-新竹,2023-10-13,2184
00633L,富邦上証正2,6,0,6,亞東-新竹,2023-10-13,2184
00679B,元大美債20年,6,0,6,亞東-新竹,2023-10-13,2184
2363,矽統,41,35,6,亞東-新竹,2023-10-13,2184
3583,辛耘,6,0,6,亞東-新竹,2023-10-13,2184
4126,太醫,6,0,6,亞東-新竹,2023-10-13,2184
00680L,元大美債20正2,5,0,5,亞東-新竹,2023-10-13,2184
2106,建大,5,0,5,亞東-新竹,2023-10-13,2184
2324,仁寶,5,0,5,亞東-新竹,2023-10-13,2184
2402,毅嘉,11,6,5,亞東-新竹,2023-10-13,2184
3380,明泰,5,0,5,亞東-新竹,2023-10-13,2184
3522,御嵿,5,0,5,亞東-新竹,2023-10-13,2184
3704,合勤控,5,0,5,亞東-新竹,2023-10-13,2184
3715,定穎投控,11,6,5,亞東-新竹,2023-10-13,2184
2892,第一金,5,1,4,亞東-新竹,2023-10-13,2184
00712,復華富時不動產,4,0,4,亞東-新竹,2023-10-13,2184
8996,高力,4,0,4,亞東-新竹,2023-10-13,2184
6669,緯穎,5,1,4,亞東-新竹,2023-10-13,2184
00733,富邦臺灣中小,4,0,4,亞東-新竹,2023-10-13,2184
1802,台玻,4,0,4,亞東-新竹,2023-10-13,2184
2468,華經,4,0,4,亞東-新竹,2023-10-13,2184
6670,復盛應用,5,1,4,亞東-新竹,2023-10-13,2184
6770,力積電,4,0,4,亞東-新竹,2023-10-13,2184
00720B,元大投資級公司債,268,0,268,亞東-新竹,2023-10-16,2184
00929,復華台灣科技優息,103,0,103,亞東-新竹,2023-10-16,2184
2887,台新金,52,1,51,亞東-新竹,2023-10-16,2184
00751B,元大AAA至A公司債,50,0,50,亞東-新竹,2023-10-16,2184
0056,元大高股息,36,3,33,亞東-新竹,2023-10-16,2184
5443,均豪,30,0,30,亞東-新竹,2023-10-16,2184
00878,國泰永續高股息,27,0,27,亞東-新竹,2023-10-16,2184
2344,華邦電,21,0,21,亞東-新竹,2023-10-16,2184
9904,寶成,20,0,20,亞東-新竹,2023-10-16,2184
2610,華航,83,66,17,亞東-新竹,2023-10-16,2184
00919,群益台灣精選高息,16,0,16,亞東-新竹,2023-10-16,2184
2201,裕隆,44,31,13,亞東-新竹,2023-10-16,2184
6163,華電網,13,0,13,亞東-新竹,2023-10-16,2184
6187,萬潤,13,0,13,亞東-新竹,2023-10-16,2184
6770,力積電,50,39,11,亞東-新竹,2023-10-16,2184
0061,元大寶滬深,10,0,10,亞東-新竹,2023-10-16,2184
1301,台塑,10,0,10,亞東-新竹,2023-10-16,2184
1612,宏泰,10,0,10,亞東-新竹,2023-10-16,2184
2888,新光金,10,0,10,亞東-新竹,2023-10-16,2184
3083,網龍,10,0,10,亞東-新竹,2023-10-16,2184
5531,鄉林,10,0,10,亞東-新竹,2023-10-16,2184
6138,茂達,10,0,10,亞東-新竹,2023-10-16,2184
2204,中華,11,2,9,亞東-新竹,2023-10-16,2184
5215,科嘉-KY,11,2,9,亞東-新竹,2023-10-16,2184
2382,廣達,11,3,8,亞東-新竹,2023-10-16,2184
2605,新興,8,0,8,亞東-新竹,2023-10-16,2184
6531,愛普*,8,1,7,亞東-新竹,2023-10-16,2184
3037,欣興,13,6,7,亞東-新竹,2023-10-16,2184
2356,英業達,21,14,7,亞東-新竹,2023-10-16,2184
2363,矽統,23,16,7,亞東-新竹,2023-10-16,2184
1616,億泰,6,0,6,亞東-新竹,2023-10-16,2184
6026,福邦證,26,20,6,亞東-新竹,2023-10-16,2184
00900,富邦特選高股息30,5,0,5,亞東-新竹,2023-10-16,2184
00885,富邦越南,5,0,5,亞東-新竹,2023-10-16,2184
1720,生達,5,0,5,亞東-新竹,2023-10-16,2184
2106,建大,5,0,5,亞東-新竹,2023-10-16,2184
2409,友達,15,10,5,亞東-新竹,2023-10-16,2184
2468,華經,6,1,5,亞東-新竹,2023-10-16,2184
2539,櫻花建,5,0,5,亞東-新竹,2023-10-16,2184
2606,裕民,5,0,5,亞東-新竹,2023-10-16,2184
2754,亞洲藏壽司,5,0,5,亞東-新竹,2023-10-16,2184
3515,華擎,5,0,5,亞東-新竹,2023-10-16,2184
5425,台半,5,0,5,亞東-新竹,2023-10-16,2184
2618,長榮航,17,13,4,亞東-新竹,2023-10-16,2184
2427,三商電,5,1,4,亞東-新竹,2023-10-16,2184
6449,鈺邦,5,1,4,亞東-新竹,2023-10-16,2184
8054,安國,5,1,4,亞東-新竹,2023-10-16,2184
8996,高力,3,0,3,亞東-新竹,2023-10-16,2184
8112,至上,3,0,3,亞東-新竹,2023-10-16,2184
3706,神達,16,13,3,亞東-新竹,2023-10-16,2184
00720B,元大投資級公司債,508,0,508,亞東-新竹,2023-10-17,2184
2887,台新金,131,2,129,亞東-新竹,2023-10-17,2184
0056,元大高股息,71,0,71,亞東-新竹,2023-10-17,2184
00905,FT臺灣Smart,50,0,50,亞東-新竹,2023-10-17,2184
2610,華航,47,5,42,亞東-新竹,2023-10-17,2184
2317,鴻海,40,1,39,亞東-新竹,2023-10-17,2184
2014,中鴻,30,0,30,亞東-新竹,2023-10-17,2184
5531,鄉林,30,0,30,亞東-新竹,2023-10-17,2184
00751B,元大AAA至A公司債,25,0,25,亞東-新竹,2023-10-17,2184
2002,中鋼,28,4,24,亞東-新竹,2023-10-17,2184
00929,復華台灣科技優息,23,0,23,亞東-新竹,2023-10-17,2184
8039,台虹,20,0,20,亞東-新竹,2023-10-17,2184
2204,中華,21,4,17,亞東-新竹,2023-10-17,2184
00687B,國泰20年美債,14,0,14,亞東-新竹,2023-10-17,2184
1324,地球,14,0,14,亞東-新竹,2023-10-17,2184
00679B,元大美債20年,11,0,11,亞東-新竹,2023-10-17,2184
3006,晶豪科,10,0,10,亞東-新竹,2023-10-17,2184
1524,耿鼎,10,0,10,亞東-新竹,2023-10-17,2184
1612,宏泰,10,0,10,亞東-新竹,2023-10-17,2184
00680L,元大美債20正2,10,0,10,亞東-新竹,2023-10-17,2184
1616,億泰,10,0,10,亞東-新竹,2023-10-17,2184
1909,榮成,10,0,10,亞東-新竹,2023-10-17,2184
2332,友訊,10,0,10,亞東-新竹,2023-10-17,2184
4933,友輝,10,0,10,亞東-新竹,2023-10-17,2184
6274,台燿,10,0,10,亞東-新竹,2023-10-17,2184
6442,光聖,10,1,9,亞東-新竹,2023-10-17,2184
3673,TPK-KY,8,0,8,亞東-新竹,2023-10-17,2184
3706,神達,8,0,8,亞東-新竹,2023-10-17,2184
2892,第一金,7,0,7,亞東-新竹,2023-10-17,2184
2485,兆赫,7,0,7,亞東-新竹,2023-10-17,2184
3044,健鼎,7,0,7,亞東-新竹,2023-10-17,2184
3231,緯創,43,37,6,亞東-新竹,2023-10-17,2184
00772B,中信高評級公司債,6,0,6,亞東-新竹,2023-10-17,2184
1785,光洋科,6,0,6,亞東-新竹,2023-10-17,2184
9933,中鼎,6,0,6,亞東-新竹,2023-10-17,2184
8996,高力,7,2,5,亞東-新竹,2023-10-17,2184
1609,大亞,5,0,5,亞東-新竹,2023-10-17,2184
1802,台玻,5,0,5,亞東-新竹,2023-10-17,2184
2106,建大,5,0,5,亞東-新竹,2023-10-17,2184
2539,櫻花建,5,0,5,亞東-新竹,2023-10-17,2184
2883,凱基金,305,300,5,亞東-新竹,2023-10-17,2184
2886,兆豐金,5,0,5,亞東-新竹,2023-10-17,2184
6449,鈺邦,5,0,5,亞東-新竹,2023-10-17,2184
8049,晶采,5,0,5,亞東-新竹,2023-10-17,2184
2376,技嘉,13,9,4,亞東-新竹,2023-10-17,2184
1101,台泥,5,1,4,亞東-新竹,2023-10-17,2184
2201,裕隆,13,9,4,亞東-新竹,2023-10-17,2184
2427,三商電,4,0,4,亞東-新竹,2023-10-17,2184
2465,麗臺,4,0,4,亞東-新竹,2023-10-17,2184
2641,正德,4,0,4,亞東-新竹,2023-10-17,2184
00720B,元大投資級公司債,105,0,105,亞東-新竹,2023-10-18,2184
2834,臺企銀,201,100,101,亞東-新竹,2023-10-18,2184
1102,亞泥,43,0,43,亞東-新竹,2023-10-18,2184
2485,兆赫,36,0,36,亞東-新竹,2023-10-18,2184
00878,國泰永續高股息,33,0,33,亞東-新竹,2023-10-18,2184
00673R,期元大S＆P原油反1,50,20,30,亞東-新竹,2023-10-18,2184
2897,王道銀行,30,0,30,亞東-新竹,2023-10-18,2184
6026,福邦證,40,10,30,亞東-新竹,2023-10-18,2184
0056,元大高股息,32,4,28,亞東-新竹,2023-10-18,2184
1710,東聯,23,0,23,亞東-新竹,2023-10-18,2184
1101,台泥,20,0,20,亞東-新竹,2023-10-18,2184
2363,矽統,47,27,20,亞東-新竹,2023-10-18,2184
8039,台虹,20,0,20,亞東-新竹,2023-10-18,2184
00929,復華台灣科技優息,25,7,18,亞東-新竹,2023-10-18,2184
2382,廣達,27,11,16,亞東-新竹,2023-10-18,2184
00725B,國泰投資級公司債,15,0,15,亞東-新竹,2023-10-18,2184
3122,笙泉,21,6,15,亞東-新竹,2023-10-18,2184
1815,富喬,17,4,13,亞東-新竹,2023-10-18,2184
00687B,國泰20年美債,12,0,12,亞東-新竹,2023-10-18,2184
6190,萬泰科,12,0,12,亞東-新竹,2023-10-18,2184
00679B,元大美債20年,11,0,11,亞東-新竹,2023-10-18,2184
6138,茂達,10,0,10,亞東-新竹,2023-10-18,2184
00893,國泰智能電動車,10,0,10,亞東-新竹,2023-10-18,2184
00877,復華中國5G,10,0,10,亞東-新竹,2023-10-18,2184
1802,台玻,10,0,10,亞東-新竹,2023-10-18,2184
2106,建大,10,0,10,亞東-新竹,2023-10-18,2184
3545,敦泰,10,0,10,亞東-新竹,2023-10-18,2184
3714,富采,10,0,10,亞東-新竹,2023-10-18,2184
2883,凱基金,209,200,9,亞東-新竹,2023-10-18,2184
2002,中鋼,23,14,9,亞東-新竹,2023-10-18,2184
2427,三商電,9,0,9,亞東-新竹,2023-10-18,2184
2618,長榮航,10,1,9,亞東-新竹,2023-10-18,2184
2313,華通,9,0,9,亞東-新竹,2023-10-18,2184
2845,遠東銀,100,92,8,亞東-新竹,2023-10-18,2184
6229,研通,10,3,7,亞東-新竹,2023-10-18,2184
6695,芯鼎,7,0,7,亞東-新竹,2023-10-18,2184
1709,和益,8,2,6,亞東-新竹,2023-10-18,2184
00862B,中信投資級公司債,6,0,6,亞東-新竹,2023-10-18,2184
6213,聯茂,6,0,6,亞東-新竹,2023-10-18,2184
1513,中興電,5,0,5,亞東-新竹,2023-10-18,2184
2330,台積電,5,0,5,亞東-新竹,2023-10-18,2184
00637L,元大滬深300正2,5,0,5,亞東-新竹,2023-10-18,2184
3090,日電貿,5,0,5,亞東-新竹,2023-10-18,2184
5306,桂盟,5,0,5,亞東-新竹,2023-10-18,2184
6416,瑞祺電通,5,0,5,亞東-新竹,2023-10-18,2184
6442,光聖,5,0,5,亞東-新竹,2023-10-18,2184
2388,威盛,18,14,4,亞東-新竹,2023-10-18,2184
00733,富邦臺灣中小,4,0,4,亞東-新竹,2023-10-18,2184
1609,大亞,6,2,4,亞東-新竹,2023-10-18,2184
3706,神達,6,2,4,亞東-新竹,2023-10-18,2184
00720B,元大投資級公司債,409,0,409,亞東-新竹,2023-10-19,2184
00706L,期元大S＆P日圓正2,70,0,70,亞東-新竹,2023-10-19,2184
6163,華電網,52,0,52,亞東-新竹,2023-10-19,2184
0056,元大高股息,53,7,46,亞東-新竹,2023-10-19,2184
00893,國泰智能電動車,42,0,42,亞東-新竹,2023-10-19,2184
3704,合勤控,50,10,40,亞東-新竹,2023-10-19,2184
3041,揚智,30,0,30,亞東-新竹,2023-10-19,2184
00933B,國泰10Y+金融債,25,0,25,亞東-新竹,2023-10-19,2184
00751B,元大AAA至A公司債,24,0,24,亞東-新竹,2023-10-19,2184
2610,華航,21,0,21,亞東-新竹,2023-10-19,2184
6770,力積電,30,9,21,亞東-新竹,2023-10-19,2184
00655L,國泰中國A50正2,20,0,20,亞東-新竹,2023-10-19,2184
3715,定穎投控,26,11,15,亞東-新竹,2023-10-19,2184
8039,台虹,15,0,15,亞東-新竹,2023-10-19,2184
1101,台泥,17,3,14,亞東-新竹,2023-10-19,2184
00687B,國泰20年美債,14,0,14,亞東-新竹,2023-10-19,2184
00679B,元大美債20年,14,0,14,亞東-新竹,2023-10-19,2184
00922,國泰台灣領袖50,12,0,12,亞東-新竹,2023-10-19,2184
5457,宣德,14,2,12,亞東-新竹,2023-10-19,2184
00725B,國泰投資級公司債,11,0,11,亞東-新竹,2023-10-19,2184
00772B,中信高評級公司債,11,0,11,亞東-新竹,2023-10-19,2184
6190,萬泰科,11,0,11,亞東-新竹,2023-10-19,2184
00878,國泰永續高股息,17,7,10,亞東-新竹,2023-10-19,2184
00722B,群益投資級電信債,16,6,10,亞東-新竹,2023-10-19,2184
00902,中信電池及儲能,10,0,10,亞東-新竹,2023-10-19,2184
00931B,統一美債20年,10,0,10,亞東-新竹,2023-10-19,2184
2458,義隆,10,0,10,亞東-新竹,2023-10-19,2184
8049,晶采,10,0,10,亞東-新竹,2023-10-19,2184
2330,台積電,11,1,10,亞東-新竹,2023-10-19,2184
3317,尼克森,9,0,9,亞東-新竹,2023-10-19,2184
1504,東元,9,0,9,亞東-新竹,2023-10-19,2184
4908,前鼎,22,13,9,亞東-新竹,2023-10-19,2184
00637L,元大滬深300正2,10,2,8,亞東-新竹,2023-10-19,2184
3481,群創,7,0,7,亞東-新竹,2023-10-19,2184
00633L,富邦上証正2,7,0,7,亞東-新竹,2023-10-19,2184
2344,華邦電,6,0,6,亞東-新竹,2023-10-19,2184
2485,兆赫,6,0,6,亞東-新竹,2023-10-19,2184
8255,朋程,6,0,6,亞東-新竹,2023-10-19,2184
9907,統一實,6,0,6,亞東-新竹,2023-10-19,2184
2409,友達,5,0,5,亞東-新竹,2023-10-19,2184
006208,富邦台50,5,0,5,亞東-新竹,2023-10-19,2184
2301,光寶科,5,0,5,亞東-新竹,2023-10-19,2184
2542,興富發,5,0,5,亞東-新竹,2023-10-19,2184
2615,萬海,5,0,5,亞東-新竹,2023-10-19,2184
2618,長榮航,15,10,5,亞東-新竹,2023-10-19,2184
3162,精確,5,0,5,亞東-新竹,2023-10-19,2184
3217,優群,5,0,5,亞東-新竹,2023-10-19,2184
3673,TPK-KY,5,0,5,亞東-新竹,2023-10-19,2184
6129,普誠,5,0,5,亞東-新竹,2023-10-19,2184
6449,鈺邦,5,0,5,亞東-新竹,2023-10-19,2184
2885,元大金,102,0,102,亞東-新竹,2023-10-20,2184
00919,群益台灣精選高息,106,14,92,亞東-新竹,2023-10-20,2184
2903,遠百,81,0,81,亞東-新竹,2023-10-20,2184
00680L,元大美債20正2,80,5,75,亞東-新竹,2023-10-20,2184
0050,元大台灣50,55,0,55,亞東-新竹,2023-10-20,2184
4938,和碩,53,0,53,亞東-新竹,2023-10-20,2184
3704,合勤控,51,0,51,亞東-新竹,2023-10-20,2184
6026,福邦證,40,0,40,亞東-新竹,2023-10-20,2184
00720B,元大投資級公司債,38,0,38,亞東-新竹,2023-10-20,2184
00878,國泰永續高股息,40,5,35,亞東-新竹,2023-10-20,2184
6163,華電網,34,0,34,亞東-新竹,2023-10-20,2184
2204,中華,35,2,33,亞東-新竹,2023-10-20,2184
2313,華通,30,0,30,亞東-新竹,2023-10-20,2184
1560,中砂,26,1,25,亞東-新竹,2023-10-20,2184
2881,富邦金,26,1,25,亞東-新竹,2023-10-20,2184
0056,元大高股息,24,0,24,亞東-新竹,2023-10-20,2184
2887,台新金,23,0,23,亞東-新竹,2023-10-20,2184
00751B,元大AAA至A公司債,23,0,23,亞東-新竹,2023-10-20,2184
00929,復華台灣科技優息,22,0,22,亞東-新竹,2023-10-20,2184
00893,國泰智能電動車,21,0,21,亞東-新竹,2023-10-20,2184
6770,力積電,43,22,21,亞東-新竹,2023-10-20,2184
2002,中鋼,22,2,20,亞東-新竹,2023-10-20,2184
2427,三商電,22,4,18,亞東-新竹,2023-10-20,2184
2303,聯電,43,25,18,亞東-新竹,2023-10-20,2184
2883,凱基金,16,0,16,亞東-新竹,2023-10-20,2184
2382,廣達,20,4,16,亞東-新竹,2023-10-20,2184
2886,兆豐金,14,0,14,亞東-新竹,2023-10-20,2184
3083,網龍,14,0,14,亞東-新竹,2023-10-20,2184
00877,復華中國5G,12,0,12,亞東-新竹,2023-10-20,2184
2353,宏��,11,0,11,亞東-新竹,2023-10-20,2184
2884,玉山金,10,0,10,亞東-新竹,2023-10-20,2184
1522,堤維西,10,0,10,亞東-新竹,2023-10-20,2184
2409,友達,10,0,10,亞東-新竹,2023-10-20,2184
2485,兆赫,10,0,10,亞東-新竹,2023-10-20,2184
3545,敦泰,10,0,10,亞東-新竹,2023-10-20,2184
5871,中租-KY,11,2,9,亞東-新竹,2023-10-20,2184
1101,台泥,8,0,8,亞東-新竹,2023-10-20,2184
2201,裕隆,12,4,8,亞東-新竹,2023-10-20,2184
8176,智捷,9,1,8,亞東-新竹,2023-10-20,2184
00922,國泰台灣領袖50,7,0,7,亞東-新竹,2023-10-20,2184
2812,台中銀,7,0,7,亞東-新竹,2023-10-20,2184
3122,笙泉,18,11,7,亞東-新竹,2023-10-20,2184
2891,中信金,7,0,7,亞東-新竹,2023-10-20,2184
00713,元大台灣高息低波,7,1,6,亞東-新竹,2023-10-20,2184
1301,台塑,6,0,6,亞東-新竹,2023-10-20,2184
2542,興富發,6,0,6,亞東-新竹,2023-10-20,2184
3711,日月光投控,10,4,6,亞東-新竹,2023-10-20,2184
5263,智崴,6,0,6,亞東-新竹,2023-10-20,2184
00772B,中信高評級公司債,5,0,5,亞東-新竹,2023-10-20,2184
00918,大華優利高填息30,5,0,5,亞東-新竹,2023-10-20,2184
00751B,元大AAA至A公司債,214,0,214,亞東-新竹,2023-10-23,2184
2883,凱基金,204,0,204,亞東-新竹,2023-10-23,2184
00680L,元大美債20正2,159,0,159,亞東-新竹,2023-10-23,2184
2888,新光金,100,0,100,亞東-新竹,2023-10-23,2184
2845,遠東銀,92,0,92,亞東-新竹,2023-10-23,2184
00878,國泰永續高股息,72,2,70,亞東-新竹,2023-10-23,2184
2409,友達,61,0,61,亞東-新竹,2023-10-23,2184
2317,鴻海,40,0,40,亞東-新竹,2023-10-23,2184
2885,元大金,40,0,40,亞東-新竹,2023-10-23,2184
3264,欣銓,32,0,32,亞東-新竹,2023-10-23,2184
00720B,元大投資級公司債,28,0,28,亞東-新竹,2023-10-23,2184
6024,群益期,24,0,24,亞東-新竹,2023-10-23,2184
8040,九暘,24,2,22,亞東-新竹,2023-10-23,2184
2313,華通,30,10,20,亞東-新竹,2023-10-23,2184
0050,元大台灣50,18,0,18,亞東-新竹,2023-10-23,2184
6176,瑞儀,16,0,16,亞東-新竹,2023-10-23,2184
6233,旺玖,19,4,15,亞東-新竹,2023-10-23,2184
0056,元大高股息,14,0,14,亞東-新竹,2023-10-23,2184
2330,台積電,23,10,13,亞東-新竹,2023-10-23,2184
6187,萬潤,13,0,13,亞東-新竹,2023-10-23,2184
00712,復華富時不動產,12,0,12,亞東-新竹,2023-10-23,2184
00881,國泰台灣5G+,10,0,10,亞東-新竹,2023-10-23,2184
2344,華邦電,14,4,10,亞東-新竹,2023-10-23,2184
00675L,富邦臺灣加權正2,9,0,9,亞東-新竹,2023-10-23,2184
00687B,國泰20年美債,9,0,9,亞東-新竹,2023-10-23,2184
1101,台泥,9,0,9,亞東-新竹,2023-10-23,2184
6830,汎銓,9,0,9,亞東-新竹,2023-10-23,2184
8024,佑華,16,8,8,亞東-新竹,2023-10-23,2184
2002,中鋼,7,0,7,亞東-新竹,2023-10-23,2184
2884,玉山金,7,0,7,亞東-新竹,2023-10-23,2184
5272,笙科,10,3,7,亞東-新竹,2023-10-23,2184
6770,力積電,10,3,7,亞東-新竹,2023-10-23,2184
2886,兆豐金,7,0,7,亞東-新竹,2023-10-23,2184
00931B,統一美債20年,6,0,6,亞東-新竹,2023-10-23,2184
00919,群益台灣精選高息,6,0,6,亞東-新竹,2023-10-23,2184
3522,御嵿,6,0,6,亞東-新竹,2023-10-23,2184
00900,富邦特選高股息30,5,0,5,亞東-新竹,2023-10-23,2184
2606,裕民,5,0,5,亞東-新竹,2023-10-23,2184
1316,上曜,5,0,5,亞東-新竹,2023-10-23,2184
2897,王道銀行,5,0,5,亞東-新竹,2023-10-23,2184
00679B,元大美債20年,6,2,4,亞東-新竹,2023-10-23,2184
3443,創意,8,4,4,亞東-新竹,2023-10-23,2184
6531,愛普*,6,2,4,亞東-新竹,2023-10-23,2184
2882,國泰金,4,0,4,亞東-新竹,2023-10-23,2184
00830,國泰費城半導體,4,0,4,亞東-新竹,2023-10-23,2184
2605,新興,5,1,4,亞東-新竹,2023-10-23,2184
2618,長榮航,15,11,4,亞東-新竹,2023-10-23,2184
3711,日月光投控,4,0,4,亞東-新竹,2023-10-23,2184
2881,富邦金,4,0,4,亞東-新竹,2023-10-23,2184
2609,陽明,4,1,3,亞東-新竹,2023-10-23,2184
2317,鴻海,64,2,62,亞東-新竹,2023-10-24,2184
3704,合勤控,50,1,49,亞東-新竹,2023-10-24,2184
0050,元大台灣50,42,0,42,亞東-新竹,2023-10-24,2184
3419,譁裕,40,0,40,亞東-新竹,2023-10-24,2184
00712,復華富時不動產,31,0,31,亞東-新竹,2023-10-24,2184
0056,元大高股息,21,1,20,亞東-新竹,2023-10-24,2184
1609,大亞,25,5,20,亞東-新竹,2023-10-24,2184
2313,華通,20,0,20,亞東-新竹,2023-10-24,2184
00929,復華台灣科技優息,18,0,18,亞東-新竹,2023-10-24,2184
3715,定穎投控,31,17,14,亞東-新竹,2023-10-24,2184
2303,聯電,37,25,12,亞東-新竹,2023-10-24,2184
2485,兆赫,12,0,12,亞東-新竹,2023-10-24,2184
2367,燿華,11,0,11,亞東-新竹,2023-10-24,2184
1785,光洋科,10,0,10,亞東-新竹,2023-10-24,2184
00795B,中信美國公債20年,10,0,10,亞東-新竹,2023-10-24,2184
2472,立隆電,10,0,10,亞東-新竹,2023-10-24,2184
2886,兆豐金,10,0,10,亞東-新竹,2023-10-24,2184
3545,敦泰,10,0,10,亞東-新竹,2023-10-24,2184
6284,佳邦,10,0,10,亞東-新竹,2023-10-24,2184
00878,國泰永續高股息,18,10,8,亞東-新竹,2023-10-24,2184
2002,中鋼,8,0,8,亞東-新竹,2023-10-24,2184
2338,光罩,7,0,7,亞東-新竹,2023-10-24,2184
3114,好德,7,0,7,亞東-新竹,2023-10-24,2184
2618,長榮航,18,11,7,亞東-新竹,2023-10-24,2184
00877,復華中國5G,6,0,6,亞東-新竹,2023-10-24,2184
2369,菱生,6,0,6,亞東-新竹,2023-10-24,2184
6288,聯嘉,6,0,6,亞東-新竹,2023-10-24,2184
00887,永豐中國科技50大,5,0,5,亞東-新竹,2023-10-24,2184
2363,矽統,8,3,5,亞東-新竹,2023-10-24,2184
6449,鈺邦,5,0,5,亞東-新竹,2023-10-24,2184
3711,日月光投控,8,4,4,亞東-新竹,2023-10-24,2184
8069,元太,4,0,4,亞東-新竹,2023-10-24,2184
2330,台積電,3,0,3,亞東-新竹,2023-10-24,2184
5871,中租-KY,4,1,3,亞東-新竹,2023-10-24,2184
00679B,元大美債20年,3,0,3,亞東-新竹,2023-10-24,2184
4979,華星光,5,2,3,亞東-新竹,2023-10-24,2184
5272,笙科,3,0,3,亞東-新竹,2023-10-24,2184
6279,胡連,3,0,3,亞東-新竹,2023-10-24,2184
2308,台達電,3,1,2,亞東-新竹,2023-10-24,2184
3443,創意,5,3,2,亞東-新竹,2023-10-24,2184
00919,群益台灣精選高息,2,0,2,亞東-新竹,2023-10-24,2184
1101,台泥,2,0,2,亞東-新竹,2023-10-24,2184
2206,三陽工業,2,0,2,亞東-新竹,2023-10-24,2184
2233,宇隆,3,1,2,亞東-新竹,2023-10-24,2184
2408,南亞科,2,0,2,亞東-新竹,2023-10-24,2184
2417,圓剛,2,0,2,亞東-新竹,2023-10-24,2184
3234,光環,2,0,2,亞東-新竹,2023-10-24,2184
5263,智崴,2,0,2,亞東-新竹,2023-10-24,2184
6231,系微,5,3,2,亞東-新竹,2023-10-24,2184
6243,迅杰,5,3,2,亞東-新竹,2023-10-24,2184
2462,良得電,50,0,50,亞東-新竹,2023-10-25,2184
3051,力特,40,0,40,亞東-新竹,2023-10-25,2184
3704,合勤控,40,7,33,亞東-新竹,2023-10-25,2184
3041,揚智,53,22,31,亞東-新竹,2023-10-25,2184
00929,復華台灣科技優息,28,0,28,亞東-新竹,2023-10-25,2184
4908,前鼎,23,1,22,亞東-新竹,2023-10-25,2184
2317,鴻海,22,3,19,亞東-新竹,2023-10-25,2184
2344,華邦電,17,0,17,亞東-新竹,2023-10-25,2184
2614,東森,15,0,15,亞東-新竹,2023-10-25,2184
3481,群創,19,6,13,亞東-新竹,2023-10-25,2184
00877,復華中國5G,12,0,12,亞東-新竹,2023-10-25,2184
2204,中華,14,2,12,亞東-新竹,2023-10-25,2184
4944,兆遠,12,0,12,亞東-新竹,2023-10-25,2184
00795B,中信美國公債20年,10,0,10,亞東-新竹,2023-10-25,2184
2337,旺宏,10,1,9,亞東-新竹,2023-10-25,2184
3231,緯創,32,23,9,亞東-新竹,2023-10-25,2184
0056,元大高股息,10,1,9,亞東-新竹,2023-10-25,2184
2618,長榮航,13,5,8,亞東-新竹,2023-10-25,2184
3035,智原,10,3,7,亞東-新竹,2023-10-25,2184
2356,英業達,12,6,6,亞東-新竹,2023-10-25,2184
3234,光環,6,0,6,亞東-新竹,2023-10-25,2184
2886,兆豐金,5,0,5,亞東-新竹,2023-10-25,2184
00878,國泰永續高股息,5,0,5,亞東-新竹,2023-10-25,2184
00931B,統一美債20年,5,0,5,亞東-新竹,2023-10-25,2184
00900,富邦特選高股息30,5,0,5,亞東-新竹,2023-10-25,2184
2313,華通,5,0,5,亞東-新竹,2023-10-25,2184
5533,皇鼎,5,0,5,亞東-新竹,2023-10-25,2184
6116,彩晶,5,0,5,亞東-新竹,2023-10-25,2184
1524,耿鼎,9,5,4,亞東-新竹,2023-10-25,2184
1815,富喬,4,0,4,亞東-新竹,2023-10-25,2184
3078,僑威,5,1,4,亞東-新竹,2023-10-25,2184
5269,祥碩,4,0,4,亞東-新竹,2023-10-25,2184
2308,台達電,5,2,3,亞東-新竹,2023-10-25,2184
00864B,中信美國公債0-1,3,0,3,亞東-新竹,2023-10-25,2184
00719B,元大美債1-3,3,0,3,亞東-新竹,2023-10-25,2184
00679B,元大美債20年,3,0,3,亞東-新竹,2023-10-25,2184
4552,力達-KY,3,0,3,亞東-新竹,2023-10-25,2184
4967,十銓,3,0,3,亞東-新竹,2023-10-25,2184
6189,豐藝,3,0,3,亞東-新竹,2023-10-25,2184
6442,光聖,3,0,3,亞東-新竹,2023-10-25,2184
2606,裕民,2,0,2,亞東-新竹,2023-10-25,2184
1604,聲寶,2,0,2,亞東-新竹,2023-10-25,2184
00751B,元大AAA至A公司債,2,0,2,亞東-新竹,2023-10-25,2184
00924,復華S＆P500成長,2,0,2,亞東-新竹,2023-10-25,2184
2542,興富發,2,0,2,亞東-新竹,2023-10-25,2184
2609,陽明,2,0,2,亞東-新竹,2023-10-25,2184
2884,玉山金,2,0,2,亞東-新竹,2023-10-25,2184
2913,農林,2,0,2,亞東-新竹,2023-10-25,2184
3583,辛耘,2,0,2,亞東-新竹,2023-10-25,2184
4763,材料-KY,2,0,2,亞東-新竹,2023-10-25,2184
0050,元大台灣50,142,0,142,亞東-新竹,2023-10-26,2184
00929,復華台灣科技優息,82,0,82,亞東-新竹,2023-10-26,2184
00712,復華富時不動產,52,0,52,亞東-新竹,2023-10-26,2184
00680L,元大美債20正2,50,0,50,亞東-新竹,2023-10-26,2184
6026,福邦證,75,31,44,亞東-新竹,2023-10-26,2184
2367,燿華,40,0,40,亞東-新竹,2023-10-26,2184
2303,聯電,35,6,29,亞東-新竹,2023-10-26,2184
2344,華邦電,28,0,28,亞東-新竹,2023-10-26,2184
2401,凌陽,21,0,21,亞東-新竹,2023-10-26,2184
0056,元大高股息,18,0,18,亞東-新竹,2023-10-26,2184
3231,緯創,24,9,15,亞東-新竹,2023-10-26,2184
00878,國泰永續高股息,16,2,14,亞東-新竹,2023-10-26,2184
2449,京元電子,15,1,14,亞東-新竹,2023-10-26,2184
2882,國泰金,12,0,12,亞東-新竹,2023-10-26,2184
00687B,國泰20年美債,12,0,12,亞東-新竹,2023-10-26,2184
3545,敦泰,12,0,12,亞東-新竹,2023-10-26,2184
00893,國泰智能電動車,10,0,10,亞東-新竹,2023-10-26,2184
2201,裕隆,11,1,10,亞東-新竹,2023-10-26,2184
2402,毅嘉,10,0,10,亞東-新竹,2023-10-26,2184
3306,鼎天,10,0,10,亞東-新竹,2023-10-26,2184
00919,群益台灣精選高息,8,0,8,亞東-新竹,2023-10-26,2184
00670L,富邦NASDAQ正2,8,0,8,亞東-新竹,2023-10-26,2184
2308,台達電,8,0,8,亞東-新竹,2023-10-26,2184
00830,國泰費城半導體,7,0,7,亞東-新竹,2023-10-26,2184
2405,輔信,7,0,7,亞東-新竹,2023-10-26,2184
3169,亞信,7,0,7,亞東-新竹,2023-10-26,2184
3715,定穎投控,24,17,7,亞東-新竹,2023-10-26,2184
00751B,元大AAA至A公司債,6,0,6,亞東-新竹,2023-10-26,2184
2382,廣達,9,3,6,亞東-新竹,2023-10-26,2184
00922,國泰台灣領袖50,6,0,6,亞東-新竹,2023-10-26,2184
1101,台泥,6,0,6,亞東-新竹,2023-10-26,2184
00719B,元大美債1-3,6,0,6,亞東-新竹,2023-10-26,2184
1609,大亞,6,0,6,亞東-新竹,2023-10-26,2184
2427,三商電,6,0,6,亞東-新竹,2023-10-26,2184
3276,宇環,6,0,6,亞東-新竹,2023-10-26,2184
3673,TPK-KY,6,0,6,亞東-新竹,2023-10-26,2184
6117,迎廣,9,3,6,亞東-新竹,2023-10-26,2184
9921,巨大,6,0,6,亞東-新竹,2023-10-26,2184
00795B,中信美國公債20年,5,0,5,亞東-新竹,2023-10-26,2184
6531,愛普*,7,2,5,亞東-新竹,2023-10-26,2184
3037,欣興,10,5,5,亞東-新竹,2023-10-26,2184
9958,世紀鋼,5,0,5,亞東-新竹,2023-10-26,2184
00931B,統一美債20年,5,0,5,亞東-新竹,2023-10-26,2184
00857B,永豐20年美公債,5,0,5,亞東-新竹,2023-10-26,2184
2485,兆赫,5,0,5,亞東-新竹,2023-10-26,2184
2801,彰銀,5,0,5,亞東-新竹,2023-10-26,2184
3363,上詮,5,0,5,亞東-新竹,2023-10-26,2184
5880,合庫金,5,0,5,亞東-新竹,2023-10-26,2184
6449,鈺邦,5,0,5,亞東-新竹,2023-10-26,2184
6770,力積電,5,0,5,亞東-新竹,2023-10-26,2184
00632R,元大台灣50反1,600,5,595,亞東-新竹,2023-10-27,2184
00929,復華台灣科技優息,63,3,60,亞東-新竹,2023-10-27,2184
00900,富邦特選高股息30,45,0,45,亞東-新竹,2023-10-27,2184
2427,三商電,20,0,20,亞東-新竹,2023-10-27,2184
3481,群創,20,0,20,亞東-新竹,2023-10-27,2184
2883,凱基金,19,0,19,亞東-新竹,2023-10-27,2184
3055,蔚華科,18,0,18,亞東-新竹,2023-10-27,2184
0050,元大台灣50,17,0,17,亞東-新竹,2023-10-27,2184
2409,友達,16,0,16,亞東-新竹,2023-10-27,2184
3083,網龍,15,0,15,亞東-新竹,2023-10-27,2184
6770,力積電,15,0,15,亞東-新竹,2023-10-27,2184
8110,華東,15,0,15,亞東-新竹,2023-10-27,2184
3287,廣寰科,15,2,13,亞東-新竹,2023-10-27,2184
6005,群益證,10,0,10,亞東-新竹,2023-10-27,2184
2855,統一證,9,0,9,亞東-新竹,2023-10-27,2184
2330,台積電,10,2,8,亞東-新竹,2023-10-27,2184
2317,鴻海,9,1,8,亞東-新竹,2023-10-27,2184
4960,誠美材,10,2,8,亞東-新竹,2023-10-27,2184
8996,高力,8,0,8,亞東-新竹,2023-10-27,2184
2303,聯電,9,2,7,亞東-新竹,2023-10-27,2184
2363,矽統,22,15,7,亞東-新竹,2023-10-27,2184
2002,中鋼,14,8,6,亞東-新竹,2023-10-27,2184
2338,光罩,6,0,6,亞東-新竹,2023-10-27,2184
1612,宏泰,5,0,5,亞東-新竹,2023-10-27,2184
1609,大亞,5,0,5,亞東-新竹,2023-10-27,2184
00931B,統一美債20年,5,0,5,亞東-新竹,2023-10-27,2184
2458,義隆,5,0,5,亞東-新竹,2023-10-27,2184
5272,笙科,6,1,5,亞東-新竹,2023-10-27,2184
00719B,元大美債1-3,4,0,4,亞東-新竹,2023-10-27,2184
00864B,中信美國公債0-1,4,0,4,亞東-新竹,2023-10-27,2184
4908,前鼎,12,8,4,亞東-新竹,2023-10-27,2184
2204,中華,9,6,3,亞東-新竹,2023-10-27,2184
2376,技嘉,4,1,3,亞東-新竹,2023-10-27,2184
2379,瑞昱,3,0,3,亞東-新竹,2023-10-27,2184
3032,偉訓,4,1,3,亞東-新竹,2023-10-27,2184
3122,笙泉,10,7,3,亞東-新竹,2023-10-27,2184
3218,大學光,3,0,3,亞東-新竹,2023-10-27,2184
3701,大眾控,3,0,3,亞東-新竹,2023-10-27,2184
4977,眾達-KY,3,0,3,亞東-新竹,2023-10-27,2184
8390,金益鼎,3,0,3,亞東-新竹,2023-10-27,2184
3035,智原,2,0,2,亞東-新竹,2023-10-27,2184
2486,一詮,2,0,2,亞東-新竹,2023-10-27,2184
1519,華城,5,3,2,亞東-新竹,2023-10-27,2184
1514,亞力,2,0,2,亞東-新竹,2023-10-27,2184
00885,富邦越南,2,0,2,亞東-新竹,2023-10-27,2184
00720B,元大投資級公司債,2,0,2,亞東-新竹,2023-10-27,2184
2206,三陽工業,2,0,2,亞東-新竹,2023-10-27,2184
2352,佳世達,3,1,2,亞東-新竹,2023-10-27,2184
2369,菱生,2,0,2,亞東-新竹,2023-10-27,2184
2882,國泰金,2,0,2,亞東-新竹,2023-10-27,2184
00632R,元大台灣50反1,1517,0,1517,亞東-新竹,2023-10-30,2184
2303,聯電,131,2,129,亞東-新竹,2023-10-30,2184
2317,鴻海,78,7,71,亞東-新竹,2023-10-30,2184
2330,台積電,18,0,18,亞東-新竹,2023-10-30,2184
0050,元大台灣50,16,0,16,亞東-新竹,2023-10-30,2184
6204,艾華,15,0,15,亞東-新竹,2023-10-30,2184
6026,福邦證,20,7,13,亞東-新竹,2023-10-30,2184
1616,億泰,12,0,12,亞東-新竹,2023-10-30,2184
00878,國泰永續高股息,10,0,10,亞東-新竹,2023-10-30,2184
2401,凌陽,11,1,10,亞東-新竹,2023-10-30,2184
2417,圓剛,10,0,10,亞東-新竹,2023-10-30,2184
00795B,中信美國公債20年,10,0,10,亞東-新竹,2023-10-30,2184
6117,迎廣,28,19,9,亞東-新竹,2023-10-30,2184
2356,英業達,19,11,8,亞東-新竹,2023-10-30,2184
4908,前鼎,11,3,8,亞東-新竹,2023-10-30,2184
8049,晶采,8,0,8,亞東-新竹,2023-10-30,2184
5321,美而快,6,0,6,亞東-新竹,2023-10-30,2184
2881,富邦金,5,0,5,亞東-新竹,2023-10-30,2184
00772B,中信高評級公司債,5,0,5,亞東-新竹,2023-10-30,2184
2337,旺宏,6,1,5,亞東-新竹,2023-10-30,2184
3083,網龍,5,0,5,亞東-新竹,2023-10-30,2184
00712,復華富時不動產,4,0,4,亞東-新竹,2023-10-30,2184
2891,中信金,4,0,4,亞東-新竹,2023-10-30,2184
3231,緯創,11,7,4,亞東-新竹,2023-10-30,2184
00773B,中信優先金融債,4,0,4,亞東-新竹,2023-10-30,2184
00751B,元大AAA至A公司債,4,0,4,亞東-新竹,2023-10-30,2184
2344,華邦電,18,14,4,亞東-新竹,2023-10-30,2184
2516,新建,4,0,4,亞東-新竹,2023-10-30,2184
2618,長榮航,4,0,4,亞東-新竹,2023-10-30,2184
2883,凱基金,4,0,4,亞東-新竹,2023-10-30,2184
3711,日月光投控,6,2,4,亞東-新竹,2023-10-30,2184
006208,富邦台50,3,0,3,亞東-新竹,2023-10-30,2184
8299,群聯,3,0,3,亞東-新竹,2023-10-30,2184
2065,世豐,3,0,3,亞東-新竹,2023-10-30,2184
2485,兆赫,6,3,3,亞東-新竹,2023-10-30,2184
2634,漢翔,3,0,3,亞東-新竹,2023-10-30,2184
2882,國泰金,3,0,3,亞東-新竹,2023-10-30,2184
3037,欣興,3,0,3,亞東-新竹,2023-10-30,2184
3094,聯傑,3,0,3,亞東-新竹,2023-10-30,2184
8176,智捷,3,0,3,亞東-新竹,2023-10-30,2184
2388,威盛,2,0,2,亞東-新竹,2023-10-30,2184
00922,國泰台灣領袖50,2,0,2,亞東-新竹,2023-10-30,2184
00887,永豐中國科技50大,2,0,2,亞東-新竹,2023-10-30,2184
00720B,元大投資級公司債,2,0,2,亞東-新竹,2023-10-30,2184
1532,勤美,2,0,2,亞東-新竹,2023-10-30,2184
2305,全友,2,0,2,亞東-新竹,2023-10-30,2184
2408,南亞科,2,0,2,亞東-新竹,2023-10-30,2184
5347,世界,1,0,1,亞東-新竹,2023-10-30,2184
1519,華城,5,4,1,亞東-新竹,2023-10-30,2184
2002,中鋼,6,5,1,亞東-新竹,2023-10-30,2184
00632R,元大台灣50反1,509,0,509,亞東-新竹,2023-10-31,2184
2313,華通,54,2,52,亞東-新竹,2023-10-31,2184
0056,元大高股息,44,0,44,亞東-新竹,2023-10-31,2184
6806,森崴能源,40,0,40,亞東-新竹,2023-10-31,2184
00878,國泰永續高股息,39,5,34,亞東-新竹,2023-10-31,2184
3545,敦泰,30,0,30,亞東-新竹,2023-10-31,2184
8089,康全電訊,29,0,29,亞東-新竹,2023-10-31,2184
3661,世芯-KY,24,0,24,亞東-新竹,2023-10-31,2184
5531,鄉林,20,0,20,亞東-新竹,2023-10-31,2184
8926,台汽電,20,0,20,亞東-新竹,2023-10-31,2184
2363,矽統,22,6,16,亞東-新竹,2023-10-31,2184
4908,前鼎,16,0,16,亞東-新竹,2023-10-31,2184
1524,耿鼎,15,0,15,亞東-新竹,2023-10-31,2184
3041,揚智,12,0,12,亞東-新竹,2023-10-31,2184
3122,笙泉,29,17,12,亞東-新竹,2023-10-31,2184
6277,宏正,10,0,10,亞東-新竹,2023-10-31,2184
2915,潤泰全,10,0,10,亞東-新竹,2023-10-31,2184
6026,福邦證,40,30,10,亞東-新竹,2023-10-31,2184
6138,茂達,10,0,10,亞東-新竹,2023-10-31,2184
006208,富邦台50,10,0,10,亞東-新竹,2023-10-31,2184
3169,亞信,8,0,8,亞東-新竹,2023-10-31,2184
2382,廣達,13,6,7,亞東-新竹,2023-10-31,2184
1310,台苯,7,0,7,亞東-新竹,2023-10-31,2184
1720,生達,12,5,7,亞東-新竹,2023-10-31,2184
2376,技嘉,11,5,6,亞東-新竹,2023-10-31,2184
3231,緯創,28,22,6,亞東-新竹,2023-10-31,2184
2002,中鋼,8,2,6,亞東-新竹,2023-10-31,2184
3025,星通,6,0,6,亞東-新竹,2023-10-31,2184
1721,三晃,5,0,5,亞東-新竹,2023-10-31,2184
00893,國泰智能電動車,5,0,5,亞東-新竹,2023-10-31,2184
2201,裕隆,26,21,5,亞東-新竹,2023-10-31,2184
2204,中華,5,0,5,亞東-新竹,2023-10-31,2184
3289,宜特,5,0,5,亞東-新竹,2023-10-31,2184
3324,雙鴻,5,0,5,亞東-新竹,2023-10-31,2184
3715,定穎投控,18,13,5,亞東-新竹,2023-10-31,2184
6449,鈺邦,5,0,5,亞東-新竹,2023-10-31,2184
8049,晶采,5,0,5,亞東-新竹,2023-10-31,2184
8936,國統,5,0,5,亞東-新竹,2023-10-31,2184
1504,東元,5,0,5,亞東-新竹,2023-10-31,2184
0050,元大台灣50,4,0,4,亞東-新竹,2023-10-31,2184
00719B,元大美債1-3,4,0,4,亞東-新竹,2023-10-31,2184
00922,國泰台灣領袖50,4,0,4,亞東-新竹,2023-10-31,2184
00753L,中信中國50正2,4,0,4,亞東-新竹,2023-10-31,2184
1785,光洋科,5,1,4,亞東-新竹,2023-10-31,2184
2337,旺宏,6,2,4,亞東-新竹,2023-10-31,2184
2340,台亞,4,0,4,亞東-新竹,2023-10-31,2184
2344,華邦電,18,14,4,亞東-新竹,2023-10-31,2184
2417,圓剛,8,4,4,亞東-新竹,2023-10-31,2184
2427,三商電,21,17,4,亞東-新竹,2023-10-31,2184
2468,華經,4,0,4,亞東-新竹,2023-10-31,2184
00751B,元大AAA至A公司債,55,0,55,亞東-新竹,2023-11-01,2184
00720B,元大投資級公司債,53,0,53,亞東-新竹,2023-11-01,2184
3623,富晶通,54,7,47,亞東-新竹,2023-11-01,2184
00933B,國泰10Y+金融債,41,0,41,亞東-新竹,2023-11-01,2184
2317,鴻海,20,0,20,亞東-新竹,2023-11-01,2184
6770,力積電,20,0,20,亞東-新竹,2023-11-01,2184
6806,森崴能源,22,2,20,亞東-新竹,2023-11-01,2184
2409,友達,18,0,18,亞東-新竹,2023-11-01,2184
2401,凌陽,17,0,17,亞東-新竹,2023-11-01,2184
00934,中信成長高股息,21,5,16,亞東-新竹,2023-11-01,2184
2880,華南金,11,1,10,亞東-新竹,2023-11-01,2184
3231,緯創,29,19,10,亞東-新竹,2023-11-01,2184
2104,國際中橡,10,0,10,亞東-新竹,2023-11-01,2184
6196,帆宣,10,0,10,亞東-新竹,2023-11-01,2184
00712,復華富時不動產,9,0,9,亞東-新竹,2023-11-01,2184
0056,元大高股息,8,0,8,亞東-新竹,2023-11-01,2184
2485,兆赫,6,0,6,亞東-新竹,2023-11-01,2184
2542,興富發,6,0,6,亞東-新竹,2023-11-01,2184
4108,懷特,7,1,6,亞東-新竹,2023-11-01,2184
00929,復華台灣科技優息,6,1,5,亞東-新竹,2023-11-01,2184
2891,中信金,5,0,5,亞東-新竹,2023-11-01,2184
3114,好德,5,0,5,亞東-新竹,2023-11-01,2184
3162,精確,5,0,5,亞東-新竹,2023-11-01,2184
3213,茂訊,5,0,5,亞東-新竹,2023-11-01,2184
8089,康全電訊,5,0,5,亞東-新竹,2023-11-01,2184
00878,國泰永續高股息,4,0,4,亞東-新竹,2023-11-01,2184
2308,台達電,4,0,4,亞東-新竹,2023-11-01,2184
2376,技嘉,5,1,4,亞東-新竹,2023-11-01,2184
3322,建舜電,8,4,4,亞東-新竹,2023-11-01,2184
3035,智原,20,17,3,亞東-新竹,2023-11-01,2184
8996,高力,3,0,3,亞東-新竹,2023-11-01,2184
2002,中鋼,7,4,3,亞東-新竹,2023-11-01,2184
1616,億泰,3,0,3,亞東-新竹,2023-11-01,2184
2417,圓剛,5,2,3,亞東-新竹,2023-11-01,2184
3044,健鼎,3,0,3,亞東-新竹,2023-11-01,2184
5269,祥碩,3,0,3,亞東-新竹,2023-11-01,2184
1301,台塑,2,0,2,亞東-新竹,2023-11-01,2184
1101,台泥,2,0,2,亞東-新竹,2023-11-01,2184
00935,野村臺灣新科技50,2,0,2,亞東-新竹,2023-11-01,2184
1609,大亞,2,0,2,亞東-新竹,2023-11-01,2184
1815,富喬,2,0,2,亞東-新竹,2023-11-01,2184
2338,光罩,3,1,2,亞東-新竹,2023-11-01,2184
2383,台光電,2,0,2,亞東-新竹,2023-11-01,2184
2468,華經,2,0,2,亞東-新竹,2023-11-01,2184
2884,玉山金,2,0,2,亞東-新竹,2023-11-01,2184
3693,營邦,2,0,2,亞東-新竹,2023-11-01,2184
5388,中磊,2,0,2,亞東-新竹,2023-11-01,2184
5871,中租-KY,2,0,2,亞東-新竹,2023-11-01,2184
6005,群益證,2,0,2,亞東-新竹,2023-11-01,2184
6231,系微,2,0,2,亞東-新竹,2023-11-01,2184
00632R,元大台灣50反1,499,0,499,亞東-新竹,2023-11-02,2184
2885,元大金,40,20,20,亞東-新竹,2023-11-02,2184
2363,矽統,20,2,18,亞東-新竹,2023-11-02,2184
3213,茂訊,15,1,14,亞東-新竹,2023-11-02,2184
2374,佳能,13,0,13,亞東-新竹,2023-11-02,2184
2883,凱基金,13,0,13,亞東-新竹,2023-11-02,2184
00637L,元大滬深300正2,10,0,10,亞東-新竹,2023-11-02,2184
2485,兆赫,14,6,8,亞東-新竹,2023-11-02,2184
2610,華航,20,12,8,亞東-新竹,2023-11-02,2184
4105,東洋,9,1,8,亞東-新竹,2023-11-02,2184
00756B,群益投等新興公債,7,0,7,亞東-新竹,2023-11-02,2184
00631L,元大台灣50正2,6,0,6,亞東-新竹,2023-11-02,2184
1721,三晃,6,0,6,亞東-新竹,2023-11-02,2184
3704,合勤控,7,1,6,亞東-新竹,2023-11-02,2184
4167,松瑞藥,5,0,5,亞東-新竹,2023-11-02,2184
5351,鈺創,5,0,5,亞東-新竹,2023-11-02,2184
6282,康舒,5,0,5,亞東-新竹,2023-11-02,2184
2356,英業達,12,9,3,亞東-新竹,2023-11-02,2184
00719B,元大美債1-3,3,0,3,亞東-新竹,2023-11-02,2184
1720,生達,3,0,3,亞東-新竹,2023-11-02,2184
2364,倫飛,3,0,3,亞東-新竹,2023-11-02,2184
2417,圓剛,6,3,3,亞東-新竹,2023-11-02,2184
6806,森崴能源,3,0,3,亞東-新竹,2023-11-02,2184
8936,國統,3,0,3,亞東-新竹,2023-11-02,2184
6223,旺矽,2,0,2,亞東-新竹,2023-11-02,2184
6703,軒郁,2,0,2,亞東-新竹,2023-11-02,2184
2317,鴻海,5,3,2,亞東-新竹,2023-11-02,2184
2211,長榮鋼,2,0,2,亞東-新竹,2023-11-02,2184
9958,世紀鋼,1,0,1,亞東-新竹,2023-11-02,2184
00701,國泰股利精選30,1,0,1,亞東-新竹,2023-11-02,2184
00687B,國泰20年美債,3,2,1,亞東-新竹,2023-11-02,2184
00685L,群益臺灣加權正2,1,0,1,亞東-新竹,2023-11-02,2184
00680L,元大美債20正2,1,0,1,亞東-新竹,2023-11-02,2184
00679B,元大美債20年,2,1,1,亞東-新竹,2023-11-02,2184
00731,復華富時高息低波,1,0,1,亞東-新竹,2023-11-02,2184
1210,大成,1,0,1,亞東-新竹,2023-11-02,2184
1515,力山,1,0,1,亞東-新竹,2023-11-02,2184
1319,東陽,13,12,1,亞東-新竹,2023-11-02,2184
1702,南僑,1,0,1,亞東-新竹,2023-11-02,2184
1752,南光,1,0,1,亞東-新竹,2023-11-02,2184
2014,中鴻,1,0,1,亞東-新竹,2023-11-02,2184
2337,旺宏,1,0,1,亞東-新竹,2023-11-02,2184
2376,技嘉,2,1,1,亞東-新竹,2023-11-02,2184
2379,瑞昱,1,0,1,亞東-新竹,2023-11-02,2184
2428,興勤,1,0,1,亞東-新竹,2023-11-02,2184
2455,全新,1,0,1,亞東-新竹,2023-11-02,2184
2723,美食-KY,1,0,1,亞東-新竹,2023-11-02,2184
2743,山富,1,0,1,亞東-新竹,2023-11-02,2184
3004,豐達科,1,0,1,亞東-新竹,2023-11-02,2184
3093,港建*,1,0,1,亞東-新竹,2023-11-02,2184
00680L,元大美債20正2,53,0,53,亞東-新竹,2023-11-03,2184
6005,群益證,50,0,50,亞東-新竹,2023-11-03,2184
9919,康那香,50,0,50,亞東-新竹,2023-11-03,2184
00878,國泰永續高股息,43,0,43,亞東-新竹,2023-11-03,2184
3483,力致,35,1,34,亞東-新竹,2023-11-03,2184
5521,工信,27,0,27,亞東-新竹,2023-11-03,2184
2363,矽統,97,71,26,亞東-新竹,2023-11-03,2184
00919,群益台灣精選高息,21,0,21,亞東-新竹,2023-11-03,2184
00670L,富邦NASDAQ正2,21,0,21,亞東-新竹,2023-11-03,2184
00696B,富邦美債20年,20,0,20,亞東-新竹,2023-11-03,2184
2885,元大金,40,20,20,亞東-新竹,2023-11-03,2184
3017,奇鋐,21,1,20,亞東-新竹,2023-11-03,2184
3545,敦泰,20,0,20,亞東-新竹,2023-11-03,2184
2317,鴻海,16,1,15,亞東-新竹,2023-11-03,2184
3231,緯創,22,9,13,亞東-新竹,2023-11-03,2184
4908,前鼎,12,1,11,亞東-新竹,2023-11-03,2184
3013,晟銘電,11,1,10,亞東-新竹,2023-11-03,2184
3025,星通,10,0,10,亞東-新竹,2023-11-03,2184
4401,東隆興,10,0,10,亞東-新竹,2023-11-03,2184
4188,安克,9,0,9,亞東-新竹,2023-11-03,2184
5469,瀚宇博,8,0,8,亞東-新竹,2023-11-03,2184
00929,復華台灣科技優息,7,0,7,亞東-新竹,2023-11-03,2184
00631L,元大台灣50正2,6,0,6,亞東-新竹,2023-11-03,2184
1612,宏泰,6,0,6,亞東-新竹,2023-11-03,2184
3035,智原,20,15,5,亞東-新竹,2023-11-03,2184
00712,復華富時不動產,6,1,5,亞東-新竹,2023-11-03,2184
00898,國泰基因免疫革命,5,0,5,亞東-新竹,2023-11-03,2184
4904,遠傳,5,0,5,亞東-新竹,2023-11-03,2184
4763,材料-KY,6,2,4,亞東-新竹,2023-11-03,2184
00934,中信成長高股息,6,2,4,亞東-新竹,2023-11-03,2184
00719B,元大美債1-3,4,0,4,亞東-新竹,2023-11-03,2184
2485,兆赫,6,2,4,亞東-新竹,2023-11-03,2184
3260,威剛,6,2,4,亞東-新竹,2023-11-03,2184
3322,建舜電,4,0,4,亞東-新竹,2023-11-03,2184
8076,伍豐,4,0,4,亞東-新竹,2023-11-03,2184
2376,技嘉,3,0,3,亞東-新竹,2023-11-03,2184
3406,玉晶光,3,0,3,亞東-新竹,2023-11-03,2184
4979,華星光,3,0,3,亞東-新竹,2023-11-03,2184
5439,高技,3,0,3,亞東-新竹,2023-11-03,2184
6703,軒郁,3,0,3,亞東-新竹,2023-11-03,2184
2382,廣達,12,9,3,亞東-新竹,2023-11-03,2184
00930,永豐ESG低碳高息,2,0,2,亞東-新竹,2023-11-03,2184
1795,美時,3,1,2,亞東-新竹,2023-11-03,2184
2401,凌陽,4,2,2,亞東-新竹,2023-11-03,2184
2417,圓剛,2,0,2,亞東-新竹,2023-11-03,2184
2486,一詮,2,0,2,亞東-新竹,2023-11-03,2184
3479,安勤,2,0,2,亞東-新竹,2023-11-03,2184
5484,慧友,2,0,2,亞東-新竹,2023-11-03,2184
6515,穎崴,2,0,2,亞東-新竹,2023-11-03,2184
6830,汎銓,2,0,2,亞東-新竹,2023-11-03,2184
2885,元大金,808,401,407,亞東-新竹,2023-11-06,2184
00687B,國泰20年美債,16,0,16,亞東-新竹,2023-11-06,2184
1314,中石化,15,0,15,亞東-新竹,2023-11-06,2184
2317,鴻海,30,17,13,亞東-新竹,2023-11-06,2184
00637L,元大滬深300正2,10,0,10,亞東-新竹,2023-11-06,2184
00632R,元大台灣50反1,10,0,10,亞東-新竹,2023-11-06,2184
00935,野村臺灣新科技50,10,0,10,亞東-新竹,2023-11-06,2184
1460,宏遠,10,0,10,亞東-新竹,2023-11-06,2184
3290,東浦,10,0,10,亞東-新竹,2023-11-06,2184
3481,群創,10,0,10,亞東-新竹,2023-11-06,2184
8076,伍豐,10,0,10,亞東-新竹,2023-11-06,2184
2344,華邦電,10,1,9,亞東-新竹,2023-11-06,2184
2884,玉山金,6,0,6,亞東-新竹,2023-11-06,2184
6213,聯茂,6,0,6,亞東-新竹,2023-11-06,2184
1514,亞力,5,0,5,亞東-新竹,2023-11-06,2184
3706,神達,6,1,5,亞東-新竹,2023-11-06,2184
2303,聯電,14,9,5,亞東-新竹,2023-11-06,2184
6243,迅杰,5,1,4,亞東-新竹,2023-11-06,2184
00927,群益半導體收益,3,0,3,亞東-新竹,2023-11-06,2184
1605,華新,3,0,3,亞東-新竹,2023-11-06,2184
2388,威盛,12,9,3,亞東-新竹,2023-11-06,2184
2603,長榮,4,1,3,亞東-新竹,2023-11-06,2184
3450,聯鈞,3,0,3,亞東-新竹,2023-11-06,2184
5608,四維航,3,0,3,亞東-新竹,2023-11-06,2184
2542,興富發,3,0,3,亞東-新竹,2023-11-06,2184
00929,復華台灣科技優息,4,2,2,亞東-新竹,2023-11-06,2184
3260,威剛,5,3,2,亞東-新竹,2023-11-06,2184
3479,安勤,2,0,2,亞東-新竹,2023-11-06,2184
4105,東洋,5,3,2,亞東-新竹,2023-11-06,2184
4961,天鈺,2,0,2,亞東-新竹,2023-11-06,2184
5469,瀚宇博,2,0,2,亞東-新竹,2023-11-06,2184
6282,康舒,2,0,2,亞東-新竹,2023-11-06,2184
8936,國統,2,0,2,亞東-新竹,2023-11-06,2184
6182,合晶,1,0,1,亞東-新竹,2023-11-06,2184
00773B,中信優先金融債,1,0,1,亞東-新竹,2023-11-06,2184
00685L,群益臺灣加權正2,1,0,1,亞東-新竹,2023-11-06,2184
006208,富邦台50,1,0,1,亞東-新竹,2023-11-06,2184
00670L,富邦NASDAQ正2,1,0,1,亞東-新竹,2023-11-06,2184
2031,新光鋼,1,0,1,亞東-新竹,2023-11-06,2184
2427,三商電,1,0,1,亞東-新竹,2023-11-06,2184
2610,華航,3,2,1,亞東-新竹,2023-11-06,2184
3010,華立,1,0,1,亞東-新竹,2023-11-06,2184
3090,日電貿,1,0,1,亞東-新竹,2023-11-06,2184
3122,笙泉,3,2,1,亞東-新竹,2023-11-06,2184
3252,海灣,1,0,1,亞東-新竹,2023-11-06,2184
3483,力致,1,0,1,亞東-新竹,2023-11-06,2184
5227,立凱-KY,1,0,1,亞東-新竹,2023-11-06,2184
6139,亞翔,1,0,1,亞東-新竹,2023-11-06,2184
6143,振曜,1,0,1,亞東-新竹,2023-11-06,2184
6270,倍微,1,0,1,亞東-新竹,2023-11-06,2184
2885,元大金,127,21,106,亞東-新竹,2023-11-07,2184
00632R,元大台灣50反1,40,0,40,亞東-新竹,2023-11-07,2184
2332,友訊,40,0,40,亞東-新竹,2023-11-07,2184
2317,鴻海,38,0,38,亞東-新竹,2023-11-07,2184
6770,力積電,35,0,35,亞東-新竹,2023-11-07,2184
1514,亞力,40,9,31,亞東-新竹,2023-11-07,2184
2368,金像電,30,0,30,亞東-新竹,2023-11-07,2184
00878,國泰永續高股息,27,0,27,亞東-新竹,2023-11-07,2184
2460,建通,25,0,25,亞東-新竹,2023-11-07,2184
2002,中鋼,13,1,12,亞東-新竹,2023-11-07,2184
00892,富邦台灣半導體,11,0,11,亞東-新竹,2023-11-07,2184
2025,千興,10,0,10,亞東-新竹,2023-11-07,2184
00891,中信關鍵半導體,10,0,10,亞東-新竹,2023-11-07,2184
2515,中工,10,0,10,亞東-新竹,2023-11-07,2184
00687B,國泰20年美債,9,0,9,亞東-新竹,2023-11-07,2184
2634,漢翔,11,2,9,亞東-新竹,2023-11-07,2184
2618,長榮航,11,3,8,亞東-新竹,2023-11-07,2184
00720B,元大投資級公司債,8,0,8,亞東-新竹,2023-11-07,2184
6026,福邦證,26,19,7,亞東-新竹,2023-11-07,2184
3055,蔚華科,6,0,6,亞東-新竹,2023-11-07,2184
2883,凱基金,5,0,5,亞東-新竹,2023-11-07,2184
6456,GIS-KY,5,0,5,亞東-新竹,2023-11-07,2184
3176,基亞,4,0,4,亞東-新竹,2023-11-07,2184
4162,智擎,12,8,4,亞東-新竹,2023-11-07,2184
4961,天鈺,4,0,4,亞東-新竹,2023-11-07,2184
6197,佳必琪,5,1,4,亞東-新竹,2023-11-07,2184
6613,朋億*,4,0,4,亞東-新竹,2023-11-07,2184
8936,國統,4,0,4,亞東-新竹,2023-11-07,2184
2303,聯電,11,8,3,亞東-新竹,2023-11-07,2184
2201,裕隆,12,9,3,亞東-新竹,2023-11-07,2184
1229,聯華,3,0,3,亞東-新竹,2023-11-07,2184
4532,瑞智,3,0,3,亞東-新竹,2023-11-07,2184
4763,材料-KY,3,0,3,亞東-新竹,2023-11-07,2184
2884,玉山金,2,0,2,亞東-新竹,2023-11-07,2184
00753L,中信中國50正2,2,0,2,亞東-新竹,2023-11-07,2184
00931B,統一美債20年,5,3,2,亞東-新竹,2023-11-07,2184
1504,東元,2,0,2,亞東-新竹,2023-11-07,2184
2204,中華,2,0,2,亞東-新竹,2023-11-07,2184
2451,創見,2,0,2,亞東-新竹,2023-11-07,2184
2542,興富發,2,0,2,亞東-新竹,2023-11-07,2184
3022,威強電,2,0,2,亞東-新竹,2023-11-07,2184
3211,順達,2,0,2,亞東-新竹,2023-11-07,2184
3306,鼎天,2,0,2,亞東-新竹,2023-11-07,2184
3443,創意,5,3,2,亞東-新竹,2023-11-07,2184
3479,安勤,2,0,2,亞東-新竹,2023-11-07,2184
3583,辛耘,2,0,2,亞東-新竹,2023-11-07,2184
4207,環泰,2,0,2,亞東-新竹,2023-11-07,2184
6235,華孚,2,0,2,亞東-新竹,2023-11-07,2184
6449,鈺邦,2,0,2,亞東-新竹,2023-11-07,2184
6494,九齊,2,0,2,亞東-新竹,2023-11-07,2184
2885,元大金,596,106,490,亞東-新竹,2023-11-08,2184
2603,長榮,281,1,280,亞東-新竹,2023-11-08,2184
2352,佳世達,66,1,65,亞東-新竹,2023-11-08,2184
2421,建準,32,1,31,亞東-新竹,2023-11-08,2184
5452,佶優,30,0,30,亞東-新竹,2023-11-08,2184
2485,兆赫,38,11,27,亞東-新竹,2023-11-08,2184
3483,力致,30,3,27,亞東-新竹,2023-11-08,2184
3545,敦泰,20,0,20,亞東-新竹,2023-11-08,2184
6026,福邦證,23,5,18,亞東-新竹,2023-11-08,2184
2884,玉山金,19,4,15,亞東-新竹,2023-11-08,2184
00936,台新永續高息中小,14,0,14,亞東-新竹,2023-11-08,2184
2356,英業達,36,22,14,亞東-新竹,2023-11-08,2184
2368,金像電,13,0,13,亞東-新竹,2023-11-08,2184
2462,良得電,13,0,13,亞東-新竹,2023-11-08,2184
00929,復華台灣科技優息,12,0,12,亞東-新竹,2023-11-08,2184
2618,長榮航,15,5,10,亞東-新竹,2023-11-08,2184
00664R,國泰臺灣加權反1,10,0,10,亞東-新竹,2023-11-08,2184
00706L,期元大S＆P日圓正2,10,0,10,亞東-新竹,2023-11-08,2184
00688L,國泰20年美債正2,10,0,10,亞東-新竹,2023-11-08,2184
00715L,期街口布蘭特正2,10,0,10,亞東-新竹,2023-11-08,2184
2520,冠德,10,0,10,亞東-新竹,2023-11-08,2184
5272,笙科,13,3,10,亞東-新竹,2023-11-08,2184
6530,創威,10,0,10,亞東-新竹,2023-11-08,2184
5347,世界,9,1,8,亞東-新竹,2023-11-08,2184
2201,裕隆,13,5,8,亞東-新竹,2023-11-08,2184
2337,旺宏,8,0,8,亞東-新竹,2023-11-08,2184
2303,聯電,32,25,7,亞東-新竹,2023-11-08,2184
3680,家登,7,0,7,亞東-新竹,2023-11-08,2184
6727,亞泰金屬,7,0,7,亞東-新竹,2023-11-08,2184
1560,中砂,10,3,7,亞東-新竹,2023-11-08,2184
1721,三晃,6,0,6,亞東-新竹,2023-11-08,2184
4908,前鼎,6,0,6,亞東-新竹,2023-11-08,2184
2313,華通,7,1,6,亞東-新竹,2023-11-08,2184
3034,聯詠,9,4,5,亞東-新竹,2023-11-08,2184
00885,富邦越南,5,0,5,亞東-新竹,2023-11-08,2184
1301,台塑,5,0,5,亞東-新竹,2023-11-08,2184
1720,生達,5,0,5,亞東-新竹,2023-11-08,2184
1785,光洋科,5,0,5,亞東-新竹,2023-11-08,2184
3055,蔚華科,5,0,5,亞東-新竹,2023-11-08,2184
5225,東科-KY,5,0,5,亞東-新竹,2023-11-08,2184
5351,鈺創,5,0,5,亞東-新竹,2023-11-08,2184
3317,尼克森,4,0,4,亞東-新竹,2023-11-08,2184
2002,中鋼,8,4,4,亞東-新竹,2023-11-08,2184
3693,營邦,5,1,4,亞東-新竹,2023-11-08,2184
8936,國統,4,0,4,亞東-新竹,2023-11-08,2184
2883,凱基金,4,1,3,亞東-新竹,2023-11-08,2184
6531,愛普*,3,0,3,亞東-新竹,2023-11-08,2184
1514,亞力,5,2,3,亞東-新竹,2023-11-08,2184
1568,倉佑,3,0,3,亞東-新竹,2023-11-08,2184
00720B,元大投資級公司債,3,0,3,亞東-新竹,2023-11-08,2184
2834,臺企銀,100,0,100,亞東-新竹,2023-11-09,2184
00936,台新永續高息中小,46,10,36,亞東-新竹,2023-11-09,2184
2356,英業達,47,12,35,亞東-新竹,2023-11-09,2184
5452,佶優,30,0,30,亞東-新竹,2023-11-09,2184
00878,國泰永續高股息,28,0,28,亞東-新竹,2023-11-09,2184
2353,宏��,28,0,28,亞東-新竹,2023-11-09,2184
2363,矽統,49,21,28,亞東-新竹,2023-11-09,2184
00773B,中信優先金融債,21,0,21,亞東-新竹,2023-11-09,2184
1324,地球,20,0,20,亞東-新竹,2023-11-09,2184
6770,力積電,20,1,19,亞東-新竹,2023-11-09,2184
2485,兆赫,18,0,18,亞東-新竹,2023-11-09,2184
3231,緯創,40,24,16,亞東-新竹,2023-11-09,2184
2344,華邦電,15,0,15,亞東-新竹,2023-11-09,2184
00680L,元大美債20正2,14,0,14,亞東-新竹,2023-11-09,2184
6188,廣明,13,0,13,亞東-新竹,2023-11-09,2184
1522,堤維西,10,0,10,亞東-新竹,2023-11-09,2184
1319,東陽,10,0,10,亞東-新竹,2023-11-09,2184
00715L,期街口布蘭特正2,10,0,10,亞東-新竹,2023-11-09,2184
2323,中環,10,0,10,亞東-新竹,2023-11-09,2184
3346,麗清,10,0,10,亞東-新竹,2023-11-09,2184
3545,敦泰,30,20,10,亞東-新竹,2023-11-09,2184
6026,福邦證,30,20,10,亞東-新竹,2023-11-09,2184
2427,三商電,9,0,9,亞東-新竹,2023-11-09,2184
5469,瀚宇博,18,9,9,亞東-新竹,2023-11-09,2184
00679B,元大美債20年,7,0,7,亞東-新竹,2023-11-09,2184
2338,光罩,10,3,7,亞東-新竹,2023-11-09,2184
3169,亞信,7,0,7,亞東-新竹,2023-11-09,2184
6548,長科*,7,0,7,亞東-新竹,2023-11-09,2184
00902,中信電池及儲能,6,0,6,亞東-新竹,2023-11-09,2184
00887,永豐中國科技50大,6,0,6,亞東-新竹,2023-11-09,2184
2332,友訊,6,0,6,亞東-新竹,2023-11-09,2184
2610,華航,6,0,6,亞東-新竹,2023-11-09,2184
3481,群創,6,0,6,亞東-新竹,2023-11-09,2184
3522,御嵿,6,0,6,亞東-新竹,2023-11-09,2184
4908,前鼎,7,1,6,亞東-新竹,2023-11-09,2184
8163,達方,6,0,6,亞東-新竹,2023-11-09,2184
8183,精星,6,0,6,亞東-新竹,2023-11-09,2184
9958,世紀鋼,6,0,6,亞東-新竹,2023-11-09,2184
00882,中信中國高股息,5,0,5,亞東-新竹,2023-11-09,2184
3715,定穎投控,9,4,5,亞東-新竹,2023-11-09,2184
00885,富邦越南,5,0,5,亞東-新竹,2023-11-09,2184
00877,復華中國5G,5,0,5,亞東-新竹,2023-11-09,2184
00643,群益深証中小,5,0,5,亞東-新竹,2023-11-09,2184
00676R,富邦臺灣加權反1,5,0,5,亞東-新竹,2023-11-09,2184
2481,強茂,5,0,5,亞東-新竹,2023-11-09,2184
2498,宏達電,5,0,5,亞東-新竹,2023-11-09,2184
5306,桂盟,5,0,5,亞東-新竹,2023-11-09,2184
6806,森崴能源,5,0,5,亞東-新竹,2023-11-09,2184
8024,佑華,5,0,5,亞東-新竹,2023-11-09,2184
2486,一詮,4,0,4,亞東-新竹,2023-11-09,2184
00720B,元大投資級公司債,111,18,93,亞東-新竹,2023-11-10,2184
1795,美時,89,35,54,亞東-新竹,2023-11-10,2184
5880,合庫金,51,0,51,亞東-新竹,2023-11-10,2184
00688L,國泰20年美債正2,40,0,40,亞東-新竹,2023-11-10,2184
00936,台新永續高息中小,34,0,34,亞東-新竹,2023-11-10,2184
00929,復華台灣科技優息,34,2,32,亞東-新竹,2023-11-10,2184
00919,群益台灣精選高息,28,0,28,亞東-新竹,2023-11-10,2184
6584,南俊國際,26,0,26,亞東-新竹,2023-11-10,2184
2618,長榮航,27,5,22,亞東-新竹,2023-11-10,2184
1324,地球,20,0,20,亞東-新竹,2023-11-10,2184
00773B,中信優先金融債,20,0,20,亞東-新竹,2023-11-10,2184
2329,華泰,21,1,20,亞東-新竹,2023-11-10,2184
2303,聯電,12,0,12,亞東-新竹,2023-11-10,2184
00632R,元大台灣50反1,11,0,11,亞東-新竹,2023-11-10,2184
00772B,中信高評級公司債,11,0,11,亞東-新竹,2023-11-10,2184
1402,遠東新,10,0,10,亞東-新竹,2023-11-10,2184
2409,友達,10,0,10,亞東-新竹,2023-11-10,2184
4533,協易機,16,6,10,亞東-新竹,2023-11-10,2184
1101,台泥,10,0,10,亞東-新竹,2023-11-10,2184
2201,裕隆,10,1,9,亞東-新竹,2023-11-10,2184
2495,普安,9,0,9,亞東-新竹,2023-11-10,2184
4105,東洋,11,2,9,亞東-新竹,2023-11-10,2184
1616,億泰,8,0,8,亞東-新竹,2023-11-10,2184
00679B,元大美債20年,7,0,7,亞東-新竹,2023-11-10,2184
6026,福邦證,30,23,7,亞東-新竹,2023-11-10,2184
1785,光洋科,10,4,6,亞東-新竹,2023-11-10,2184
2316,楠梓電,6,0,6,亞東-新竹,2023-11-10,2184
2417,圓剛,6,0,6,亞東-新竹,2023-11-10,2184
2340,台亞,5,0,5,亞東-新竹,2023-11-10,2184
2401,凌陽,5,0,5,亞東-新竹,2023-11-10,2184
3346,麗清,5,0,5,亞東-新竹,2023-11-10,2184
6690,安�硌穈T,5,0,5,亞東-新竹,2023-11-10,2184
8064,東捷,5,0,5,亞東-新竹,2023-11-10,2184
5871,中租-KY,4,0,4,亞東-新竹,2023-11-10,2184
1605,華新,4,0,4,亞東-新竹,2023-11-10,2184
00753L,中信中國50正2,4,0,4,亞東-新竹,2023-11-10,2184
00687B,國泰20年美債,7,3,4,亞東-新竹,2023-11-10,2184
1734,杏輝,4,0,4,亞東-新竹,2023-11-10,2184
3373,熱映,4,0,4,亞東-新竹,2023-11-10,2184
4961,天鈺,4,0,4,亞東-新竹,2023-11-10,2184
6290,良維,4,0,4,亞東-新竹,2023-11-10,2184
6669,緯穎,5,1,4,亞東-新竹,2023-11-10,2184
8039,台虹,4,0,4,亞東-新竹,2023-11-10,2184
3035,智原,5,2,3,亞東-新竹,2023-11-10,2184
3526,凡甲,3,0,3,亞東-新竹,2023-11-10,2184
5469,瀚宇博,3,0,3,亞東-新竹,2023-11-10,2184
1309,台達化,3,0,3,亞東-新竹,2023-11-10,2184
3715,定穎投控,10,7,3,亞東-新竹,2023-11-10,2184
3231,緯創,25,23,2,亞東-新竹,2023-11-10,2184
2376,技嘉,14,12,2,亞東-新竹,2023-11-10,2184
2885,元大金,400,0,400,亞東-新竹,2023-11-13,2184
00680L,元大美債20正2,230,27,203,亞東-新竹,2023-11-13,2184
3231,緯創,110,15,95,亞東-新竹,2023-11-13,2184
1710,東聯,70,0,70,亞東-新竹,2023-11-13,2184
00878,國泰永續高股息,35,0,35,亞東-新竹,2023-11-13,2184
4105,東洋,32,0,32,亞東-新竹,2023-11-13,2184
00929,復華台灣科技優息,33,2,31,亞東-新竹,2023-11-13,2184
2363,矽統,58,28,30,亞東-新竹,2023-11-13,2184
5388,中磊,34,4,30,亞東-新竹,2023-11-13,2184
2316,楠梓電,27,0,27,亞東-新竹,2023-11-13,2184
6770,力積電,36,10,26,亞東-新竹,2023-11-13,2184
1720,生達,20,0,20,亞東-新竹,2023-11-13,2184
2337,旺宏,20,0,20,亞東-新竹,2023-11-13,2184
2344,華邦電,33,13,20,亞東-新竹,2023-11-13,2184
2323,中環,17,0,17,亞東-新竹,2023-11-13,2184
0056,元大高股息,15,0,15,亞東-新竹,2023-11-13,2184
5531,鄉林,14,0,14,亞東-新竹,2023-11-13,2184
6274,台燿,12,0,12,亞東-新竹,2023-11-13,2184
1513,中興電,12,0,12,亞東-新竹,2023-11-13,2184
00919,群益台灣精選高息,21,9,12,亞東-新竹,2023-11-13,2184
3083,網龍,11,0,11,亞東-新竹,2023-11-13,2184
8936,國統,11,0,11,亞東-新竹,2023-11-13,2184
1101,台泥,10,0,10,亞東-新竹,2023-11-13,2184
2355,敬鵬,10,0,10,亞東-新竹,2023-11-13,2184
2883,凱基金,10,0,10,亞東-新竹,2023-11-13,2184
8050,廣積,10,0,10,亞東-新竹,2023-11-13,2184
5347,世界,10,0,10,亞東-新竹,2023-11-13,2184
1514,亞力,8,0,8,亞東-新竹,2023-11-13,2184
2382,廣達,10,4,6,亞東-新竹,2023-11-13,2184
1504,東元,6,0,6,亞東-新竹,2023-11-13,2184
1522,堤維西,5,0,5,亞東-新竹,2023-11-13,2184
00631L,元大台灣50正2,5,0,5,亞東-新竹,2023-11-13,2184
00679B,元大美債20年,5,0,5,亞東-新竹,2023-11-13,2184
00882,中信中國高股息,5,0,5,亞東-新竹,2023-11-13,2184
00931B,統一美債20年,5,0,5,亞東-新竹,2023-11-13,2184
3090,日電貿,5,0,5,亞東-新竹,2023-11-13,2184
4915,致伸,5,0,5,亞東-新竹,2023-11-13,2184
5306,桂盟,5,0,5,亞東-新竹,2023-11-13,2184
6139,亞翔,5,0,5,亞東-新竹,2023-11-13,2184
6584,南俊國際,5,0,5,亞東-新竹,2023-11-13,2184
9921,巨大,5,0,5,亞東-新竹,2023-11-13,2184
2330,台積電,14,10,4,亞東-新竹,2023-11-13,2184
2376,技嘉,11,7,4,亞東-新竹,2023-11-13,2184
1314,中石化,5,1,4,亞東-新竹,2023-11-13,2184
00936,台新永續高息中小,11,7,4,亞東-新竹,2023-11-13,2184
3322,建舜電,4,0,4,亞東-新竹,2023-11-13,2184
4142,國光生,4,0,4,亞東-新竹,2023-11-13,2184
5381,合正,4,0,4,亞東-新竹,2023-11-13,2184
6285,啟��,5,1,4,亞東-新竹,2023-11-13,2184
6548,長科*,4,0,4,亞東-新竹,2023-11-13,2184
2402,毅嘉,62,0,62,亞東-新竹,2023-11-14,2184
00929,復華台灣科技優息,31,0,31,亞東-新竹,2023-11-14,2184
3231,緯創,22,3,19,亞東-新竹,2023-11-14,2184
00936,台新永續高息中小,16,0,16,亞東-新竹,2023-11-14,2184
00882,中信中國高股息,15,0,15,亞東-新竹,2023-11-14,2184
2355,敬鵬,15,0,15,亞東-新竹,2023-11-14,2184
3264,欣銓,15,2,13,亞東-新竹,2023-11-14,2184
2356,英業達,29,18,11,亞東-新竹,2023-11-14,2184
1229,聯華,10,0,10,亞東-新竹,2023-11-14,2184
2618,長榮航,18,8,10,亞東-新竹,2023-11-14,2184
8076,伍豐,10,0,10,亞東-新竹,2023-11-14,2184
1815,富喬,7,0,7,亞東-新竹,2023-11-14,2184
2427,三商電,7,0,7,亞東-新竹,2023-11-14,2184
2615,萬海,8,1,7,亞東-新竹,2023-11-14,2184
00679B,元大美債20年,6,0,6,亞東-新竹,2023-11-14,2184
2323,中環,6,0,6,亞東-新竹,2023-11-14,2184
3704,合勤控,6,0,6,亞東-新竹,2023-11-14,2184
8088,品安,6,0,6,亞東-新竹,2023-11-14,2184
00915,凱基優選高股息30,5,0,5,亞東-新竹,2023-11-14,2184
00934,中信成長高股息,5,0,5,亞東-新竹,2023-11-14,2184
2812,台中銀,5,0,5,亞東-新竹,2023-11-14,2184
3033,威健,5,0,5,亞東-新竹,2023-11-14,2184
3055,蔚華科,5,0,5,亞東-新竹,2023-11-14,2184
4102,永日,5,0,5,亞東-新竹,2023-11-14,2184
5871,中租-KY,4,0,4,亞東-新竹,2023-11-14,2184
1784,訊聯,4,0,4,亞東-新竹,2023-11-14,2184
1514,亞力,4,0,4,亞東-新竹,2023-11-14,2184
00720B,元大投資級公司債,4,0,4,亞東-新竹,2023-11-14,2184
2329,華泰,4,0,4,亞東-新竹,2023-11-14,2184
2388,威盛,13,9,4,亞東-新竹,2023-11-14,2184
2607,榮運,5,1,4,亞東-新竹,2023-11-14,2184
3045,台灣大,4,0,4,亞東-新竹,2023-11-14,2184
4105,東洋,4,0,4,亞東-新竹,2023-11-14,2184
4128,中天,4,0,4,亞東-新竹,2023-11-14,2184
2324,仁寶,3,0,3,亞東-新竹,2023-11-14,2184
2474,可成,3,0,3,亞東-新竹,2023-11-14,2184
4904,遠傳,3,0,3,亞東-新竹,2023-11-14,2184
6143,振曜,3,0,3,亞東-新竹,2023-11-14,2184
6451,訊芯-KY,3,0,3,亞東-新竹,2023-11-14,2184
6684,安格,4,1,3,亞東-新竹,2023-11-14,2184
2891,中信金,10,7,3,亞東-新竹,2023-11-14,2184
2883,凱基金,2,0,2,亞東-新竹,2023-11-14,2184
3479,安勤,2,0,2,亞東-新竹,2023-11-14,2184
2382,廣達,12,10,2,亞東-新竹,2023-11-14,2184
00637L,元大滬深300正2,2,0,2,亞東-新竹,2023-11-14,2184
00697B,元大美債7-10,2,0,2,亞東-新竹,2023-11-14,2184
1720,生達,2,0,2,亞東-新竹,2023-11-14,2184
1504,東元,2,0,2,亞東-新竹,2023-11-14,2184
2204,中華,2,0,2,亞東-新竹,2023-11-14,2184
2417,圓剛,6,4,2,亞東-新竹,2023-11-14,2184
2885,元大金,350,0,350,亞東-新竹,2023-11-15,2184
00680L,元大美債20正2,374,190,184,亞東-新竹,2023-11-15,2184
5351,鈺創,108,1,107,亞東-新竹,2023-11-15,2184
2323,中環,40,0,40,亞東-新竹,2023-11-15,2184
00687B,國泰20年美債,39,0,39,亞東-新竹,2023-11-15,2184
2882,國泰金,60,22,38,亞東-新竹,2023-11-15,2184
1795,美時,67,30,37,亞東-新竹,2023-11-15,2184
2618,長榮航,50,14,36,亞東-新竹,2023-11-15,2184
2458,義隆,33,1,32,亞東-新竹,2023-11-15,2184
6806,森崴能源,30,1,29,亞東-新竹,2023-11-15,2184
00679B,元大美債20年,23,0,23,亞東-新竹,2023-11-15,2184
6138,茂達,22,3,19,亞東-新竹,2023-11-15,2184
2332,友訊,18,0,18,亞東-新竹,2023-11-15,2184
00934,中信成長高股息,17,0,17,亞東-新竹,2023-11-15,2184
5521,工信,16,0,16,亞東-新竹,2023-11-15,2184
00929,復華台灣科技優息,38,25,13,亞東-新竹,2023-11-15,2184
2449,京元電子,10,0,10,亞東-新竹,2023-11-15,2184
3522,御嵿,16,7,9,亞東-新竹,2023-11-15,2184
2408,南亞科,9,0,9,亞東-新竹,2023-11-15,2184
00722B,群益投資級電信債,22,14,8,亞東-新竹,2023-11-15,2184
00720B,元大投資級公司債,8,0,8,亞東-新竹,2023-11-15,2184
2464,盟立,8,0,8,亞東-新竹,2023-11-15,2184
00933B,國泰10Y+金融債,7,0,7,亞東-新竹,2023-11-15,2184
3406,玉晶光,7,0,7,亞東-新竹,2023-11-15,2184
00878,國泰永續高股息,38,31,7,亞東-新竹,2023-11-15,2184
1709,和益,9,2,7,亞東-新竹,2023-11-15,2184
1449,佳和,6,0,6,亞東-新竹,2023-11-15,2184
00795B,中信美國公債20年,7,1,6,亞東-新竹,2023-11-15,2184
2543,皇昌,16,10,6,亞東-新竹,2023-11-15,2184
3041,揚智,7,1,6,亞東-新竹,2023-11-15,2184
00631L,元大台灣50正2,5,0,5,亞東-新竹,2023-11-15,2184
00931B,統一美債20年,5,0,5,亞東-新竹,2023-11-15,2184
2441,超豐,5,0,5,亞東-新竹,2023-11-15,2184
4108,懷特,5,0,5,亞東-新竹,2023-11-15,2184
4960,誠美材,5,0,5,亞東-新竹,2023-11-15,2184
5225,東科-KY,7,2,5,亞東-新竹,2023-11-15,2184
1515,力山,7,3,4,亞東-新竹,2023-11-15,2184
2363,矽統,68,64,4,亞東-新竹,2023-11-15,2184
2376,技嘉,11,7,4,亞東-新竹,2023-11-15,2184
6550,北極星藥業-KY,4,0,4,亞東-新竹,2023-11-15,2184
6139,亞翔,4,1,3,亞東-新竹,2023-11-15,2184
2369,菱生,4,1,3,亞東-新竹,2023-11-15,2184
2634,漢翔,3,0,3,亞東-新竹,2023-11-15,2184
4105,東洋,3,0,3,亞東-新竹,2023-11-15,2184
4908,前鼎,6,3,3,亞東-新竹,2023-11-15,2184
6285,啟��,3,0,3,亞東-新竹,2023-11-15,2184
2388,威盛,15,12,3,亞東-新竹,2023-11-15,2184
2357,華碩,6,3,3,亞東-新竹,2023-11-15,2184
3035,智原,4,2,2,亞東-新竹,2023-11-15,2184
1720,生達,2,0,2,亞東-新竹,2023-11-15,2184
2885,元大金,400,7,393,亞東-新竹,2023-11-16,2184
2834,臺企銀,296,0,296,亞東-新竹,2023-11-16,2184
8088,品安,36,0,36,亞東-新竹,2023-11-16,2184
2417,圓剛,29,1,28,亞東-新竹,2023-11-16,2184
00631L,元大台灣50正2,20,0,20,亞東-新竹,2023-11-16,2184
1324,地球,15,0,15,亞東-新竹,2023-11-16,2184
00878,國泰永續高股息,50,36,14,亞東-新竹,2023-11-16,2184
00751B,元大AAA至A公司債,13,0,13,亞東-新竹,2023-11-16,2184
00679B,元大美債20年,12,1,11,亞東-新竹,2023-11-16,2184
00932,兆豐永續高息等權,10,0,10,亞東-新竹,2023-11-16,2184
6770,力積電,10,0,10,亞東-新竹,2023-11-16,2184
3702,大聯大,10,0,10,亞東-新竹,2023-11-16,2184
2332,友訊,8,0,8,亞東-新竹,2023-11-16,2184
3623,富晶通,8,0,8,亞東-新竹,2023-11-16,2184
3324,雙鴻,7,0,7,亞東-新竹,2023-11-16,2184
4164,承業醫,7,0,7,亞東-新竹,2023-11-16,2184
4128,中天,6,0,6,亞東-新竹,2023-11-16,2184
00720B,元大投資級公司債,6,0,6,亞東-新竹,2023-11-16,2184
6290,良維,6,0,6,亞東-新竹,2023-11-16,2184
6274,台燿,5,0,5,亞東-新竹,2023-11-16,2184
00931B,統一美債20年,5,0,5,亞東-新竹,2023-11-16,2184
00885,富邦越南,5,0,5,亞東-新竹,2023-11-16,2184
1605,華新,6,1,5,亞東-新竹,2023-11-16,2184
3038,全台,5,0,5,亞東-新竹,2023-11-16,2184
3594,磐儀,5,0,5,亞東-新竹,2023-11-16,2184
00687B,國泰20年美債,8,3,5,亞東-新竹,2023-11-16,2184
2344,華邦電,11,7,4,亞東-新竹,2023-11-16,2184
2369,菱生,5,1,4,亞東-新竹,2023-11-16,2184
2462,良得電,4,0,4,亞東-新竹,2023-11-16,2184
3034,聯詠,4,0,4,亞東-新竹,2023-11-16,2184
3035,智原,5,1,4,亞東-新竹,2023-11-16,2184
5469,瀚宇博,4,0,4,亞東-新竹,2023-11-16,2184
8996,高力,4,0,4,亞東-新竹,2023-11-16,2184
3231,緯創,11,7,4,亞東-新竹,2023-11-16,2184
00877,復華中國5G,3,0,3,亞東-新竹,2023-11-16,2184
00887,永豐中國科技50大,3,0,3,亞東-新竹,2023-11-16,2184
00900,富邦特選高股息30,4,1,3,亞東-新竹,2023-11-16,2184
00643,群益深証中小,3,0,3,亞東-新竹,2023-11-16,2184
1504,東元,3,0,3,亞東-新竹,2023-11-16,2184
2063,世鎧,3,0,3,亞東-新竹,2023-11-16,2184
2352,佳世達,3,0,3,亞東-新竹,2023-11-16,2184
3704,合勤控,3,0,3,亞東-新竹,2023-11-16,2184
8261,富鼎,3,0,3,亞東-新竹,2023-11-16,2184
8473,山林水,3,0,3,亞東-新竹,2023-11-16,2184
2330,台積電,17,14,3,亞東-新竹,2023-11-16,2184
3450,聯鈞,2,0,2,亞東-新竹,2023-11-16,2184
00935,野村臺灣新科技50,2,0,2,亞東-新竹,2023-11-16,2184
00633L,富邦上証正2,2,0,2,亞東-新竹,2023-11-16,2184
00655L,國泰中國A50正2,2,0,2,亞東-新竹,2023-11-16,2184
00923,群益台ESG低碳50,2,0,2,亞東-新竹,2023-11-16,2184
5009,榮剛,202,2,200,亞東-新竹,2023-11-17,2184
8088,品安,155,0,155,亞東-新竹,2023-11-17,2184
00929,復華台灣科技優息,152,22,130,亞東-新竹,2023-11-17,2184
2495,普安,25,4,21,亞東-新竹,2023-11-17,2184
00687B,國泰20年美債,21,0,21,亞東-新竹,2023-11-17,2184
2002,中鋼,20,0,20,亞東-新竹,2023-11-17,2184
00931B,統一美債20年,17,0,17,亞東-新竹,2023-11-17,2184
00632R,元大台灣50反1,15,0,15,亞東-新竹,2023-11-17,2184
2317,鴻海,21,7,14,亞東-新竹,2023-11-17,2184
00751B,元大AAA至A公司債,11,0,11,亞東-新竹,2023-11-17,2184
00680L,元大美債20正2,11,0,11,亞東-新竹,2023-11-17,2184
6125,廣運,10,0,10,亞東-新竹,2023-11-17,2184
1324,地球,10,0,10,亞東-新竹,2023-11-17,2184
00713,元大台灣高息低波,10,0,10,亞東-新竹,2023-11-17,2184
00936,台新永續高息中小,10,0,10,亞東-新竹,2023-11-17,2184
4915,致伸,10,0,10,亞東-新竹,2023-11-17,2184
5381,合正,10,0,10,亞東-新竹,2023-11-17,2184
6282,康舒,10,0,10,亞東-新竹,2023-11-17,2184
6770,力積電,10,0,10,亞東-新竹,2023-11-17,2184
3289,宜特,10,0,10,亞東-新竹,2023-11-17,2184
00753L,中信中國50正2,9,0,9,亞東-新竹,2023-11-17,2184
3041,揚智,8,0,8,亞東-新竹,2023-11-17,2184
2330,台積電,11,3,8,亞東-新竹,2023-11-17,2184
2641,正德,8,0,8,亞東-新竹,2023-11-17,2184
3231,緯創,13,6,7,亞東-新竹,2023-11-17,2184
1218,泰山,7,0,7,亞東-新竹,2023-11-17,2184
1582,信錦,7,0,7,亞東-新竹,2023-11-17,2184
3380,明泰,7,0,7,亞東-新竹,2023-11-17,2184
2743,山富,6,0,6,亞東-新竹,2023-11-17,2184
1515,力山,9,3,6,亞東-新竹,2023-11-17,2184
3036,文曄,6,0,6,亞東-新竹,2023-11-17,2184
6182,合晶,5,0,5,亞東-新竹,2023-11-17,2184
1452,宏益,5,0,5,亞東-新竹,2023-11-17,2184
00633L,富邦上証正2,5,0,5,亞東-新竹,2023-11-17,2184
00712,復華富時不動產,5,0,5,亞東-新竹,2023-11-17,2184
00679B,元大美債20年,5,0,5,亞東-新竹,2023-11-17,2184
1612,宏泰,5,0,5,亞東-新竹,2023-11-17,2184
2427,三商電,6,1,5,亞東-新竹,2023-11-17,2184
3055,蔚華科,5,0,5,亞東-新竹,2023-11-17,2184
3206,志豐,5,0,5,亞東-新竹,2023-11-17,2184
4536,拓凱,5,0,5,亞東-新竹,2023-11-17,2184
6290,良維,5,0,5,亞東-新竹,2023-11-17,2184
8358,金居,5,0,5,亞東-新竹,2023-11-17,2184
0056,元大高股息,4,0,4,亞東-新竹,2023-11-17,2184
00915,凱基優選高股息30,4,0,4,亞東-新竹,2023-11-17,2184
00935,野村臺灣新科技50,4,0,4,亞東-新竹,2023-11-17,2184
2460,建通,4,0,4,亞東-新竹,2023-11-17,2184
3045,台灣大,4,0,4,亞東-新竹,2023-11-17,2184
3594,磐儀,4,0,4,亞東-新竹,2023-11-17,2184
6284,佳邦,4,0,4,亞東-新竹,2023-11-17,2184
2915,潤泰全,131,0,131,亞東-新竹,2023-11-20,2184
3706,神達,100,13,87,亞東-新竹,2023-11-20,2184
2409,友達,70,0,70,亞東-新竹,2023-11-20,2184
00720B,元大投資級公司債,50,0,50,亞東-新竹,2023-11-20,2184
2313,華通,50,9,41,亞東-新竹,2023-11-20,2184
3715,定穎投控,61,22,39,亞東-新竹,2023-11-20,2184
6168,宏齊,45,15,30,亞東-新竹,2023-11-20,2184
2330,台積電,29,2,27,亞東-新竹,2023-11-20,2184
00900,富邦特選高股息30,20,0,20,亞東-新竹,2023-11-20,2184
2495,普安,20,0,20,亞東-新竹,2023-11-20,2184
2382,廣達,23,6,17,亞東-新竹,2023-11-20,2184
1402,遠東新,17,0,17,亞東-新竹,2023-11-20,2184
1218,泰山,13,0,13,亞東-新竹,2023-11-20,2184
00885,富邦越南,12,0,12,亞東-新竹,2023-11-20,2184
6589,台康生技,12,1,11,亞東-新竹,2023-11-20,2184
00706L,期元大S＆P日圓正2,10,0,10,亞東-新竹,2023-11-20,2184
00687B,國泰20年美債,10,0,10,亞東-新竹,2023-11-20,2184
8163,達方,10,0,10,亞東-新竹,2023-11-20,2184
1101,台泥,12,2,10,亞東-新竹,2023-11-20,2184
2201,裕隆,21,12,9,亞東-新竹,2023-11-20,2184
00679B,元大美債20年,8,0,8,亞東-新竹,2023-11-20,2184
3035,智原,9,2,7,亞東-新竹,2023-11-20,2184
1785,光洋科,7,0,7,亞東-新竹,2023-11-20,2184
00936,台新永續高息中小,6,0,6,亞東-新竹,2023-11-20,2184
00676R,富邦臺灣加權反1,6,0,6,亞東-新竹,2023-11-20,2184
2516,新建,6,0,6,亞東-新竹,2023-11-20,2184
3017,奇鋐,6,0,6,亞東-新竹,2023-11-20,2184
5483,中美晶,6,0,6,亞東-新竹,2023-11-20,2184
6290,良維,6,0,6,亞東-新竹,2023-11-20,2184
2105,正新,5,0,5,亞東-新竹,2023-11-20,2184
2618,長榮航,9,4,5,亞東-新竹,2023-11-20,2184
2834,臺企銀,5,0,5,亞東-新竹,2023-11-20,2184
3363,上詮,5,0,5,亞東-新竹,2023-11-20,2184
4536,拓凱,5,0,5,亞東-新竹,2023-11-20,2184
2882,國泰金,10,5,5,亞東-新竹,2023-11-20,2184
0056,元大高股息,8,4,4,亞東-新竹,2023-11-20,2184
2367,燿華,6,2,4,亞東-新竹,2023-11-20,2184
2369,菱生,5,1,4,亞東-新竹,2023-11-20,2184
9945,潤泰新,4,0,4,亞東-新竹,2023-11-20,2184
2344,華邦電,11,8,3,亞東-新竹,2023-11-20,2184
2402,毅嘉,3,0,3,亞東-新竹,2023-11-20,2184
2645,長榮航太,3,0,3,亞東-新竹,2023-11-20,2184
4746,台耀,3,0,3,亞東-新竹,2023-11-20,2184
4763,材料-KY,5,2,3,亞東-新竹,2023-11-20,2184
6158,禾昌,3,0,3,亞東-新竹,2023-11-20,2184
6291,沛亨,3,0,3,亞東-新竹,2023-11-20,2184
6806,森崴能源,3,0,3,亞東-新竹,2023-11-20,2184
8088,品安,3,0,3,亞東-新竹,2023-11-20,2184
8176,智捷,3,0,3,亞東-新竹,2023-11-20,2184
2408,南亞科,3,0,3,亞東-新竹,2023-11-20,2184
2409,友達,70,0,70,亞東-新竹,2023-11-21,2184
00919,群益台灣精選高息,60,1,59,亞東-新竹,2023-11-21,2184
00933B,國泰10Y+金融債,51,0,51,亞東-新竹,2023-11-21,2184
00687B,國泰20年美債,50,0,50,亞東-新竹,2023-11-21,2184
3059,華晶科,50,0,50,亞東-新竹,2023-11-21,2184
00929,復華台灣科技優息,49,0,49,亞東-新竹,2023-11-21,2184
00632R,元大台灣50反1,42,0,42,亞東-新竹,2023-11-21,2184
2303,聯電,34,9,25,亞東-新竹,2023-11-21,2184
00680L,元大美債20正2,23,0,23,亞東-新竹,2023-11-21,2184
5465,富驊,20,0,20,亞東-新竹,2023-11-21,2184
3715,定穎投控,18,5,13,亞東-新竹,2023-11-21,2184
00934,中信成長高股息,13,0,13,亞東-新竹,2023-11-21,2184
3483,力致,28,15,13,亞東-新竹,2023-11-21,2184
00900,富邦特選高股息30,13,1,12,亞東-新竹,2023-11-21,2184
6770,力積電,13,1,12,亞東-新竹,2023-11-21,2184
00706L,期元大S＆P日圓正2,11,0,11,亞東-新竹,2023-11-21,2184
00751B,元大AAA至A公司債,11,0,11,亞東-新竹,2023-11-21,2184
00902,中信電池及儲能,10,0,10,亞東-新竹,2023-11-21,2184
2353,宏��,10,0,10,亞東-新竹,2023-11-21,2184
2888,新光金,10,0,10,亞東-新竹,2023-11-21,2184
3055,蔚華科,10,0,10,亞東-新竹,2023-11-21,2184
8936,國統,10,0,10,亞東-新竹,2023-11-21,2184
1720,生達,9,0,9,亞東-新竹,2023-11-21,2184
00885,富邦越南,8,0,8,亞東-新竹,2023-11-21,2184
2486,一詮,10,2,8,亞東-新竹,2023-11-21,2184
6901,鑽石投資,8,0,8,亞東-新竹,2023-11-21,2184
2367,燿華,20,12,8,亞東-新竹,2023-11-21,2184
2618,長榮航,21,14,7,亞東-新竹,2023-11-21,2184
6125,廣運,11,4,7,亞東-新竹,2023-11-21,2184
00712,復華富時不動產,6,0,6,亞東-新竹,2023-11-21,2184
2388,威盛,7,1,6,亞東-新竹,2023-11-21,2184
3047,訊舟,6,0,6,亞東-新竹,2023-11-21,2184
6168,宏齊,7,1,6,亞東-新竹,2023-11-21,2184
3479,安勤,5,0,5,亞東-新竹,2023-11-21,2184
1514,亞力,10,5,5,亞東-新竹,2023-11-21,2184
2834,臺企銀,5,0,5,亞東-新竹,2023-11-21,2184
3491,昇達科,10,5,5,亞東-新竹,2023-11-21,2184
6558,興能高,5,0,5,亞東-新竹,2023-11-21,2184
00931B,統一美債20年,4,0,4,亞東-新竹,2023-11-21,2184
1784,訊聯,6,2,4,亞東-新竹,2023-11-21,2184
3036A,文曄甲特,4,0,4,亞東-新竹,2023-11-21,2184
3041,揚智,6,2,4,亞東-新竹,2023-11-21,2184
6127,九豪,4,0,4,亞東-新竹,2023-11-21,2184
6435,大中,4,0,4,亞東-新竹,2023-11-21,2184
2027,大成鋼,3,0,3,亞東-新竹,2023-11-21,2184
2313,華通,6,3,3,亞東-新竹,2023-11-21,2184
3035,智原,6,3,3,亞東-新竹,2023-11-21,2184
00720B,元大投資級公司債,3,0,3,亞東-新竹,2023-11-21,2184
1533,車王電,3,0,3,亞東-新竹,2023-11-21,2184
2369,菱生,4,1,3,亞東-新竹,2023-11-21,2184
00680L,元大美債20正2,302,0,302,亞東-新竹,2023-11-22,2184
2409,友達,115,4,111,亞東-新竹,2023-11-22,2184
00720B,元大投資級公司債,51,0,51,亞東-新竹,2023-11-22,2184
2885,元大金,40,0,40,亞東-新竹,2023-11-22,2184
3231,緯創,60,21,39,亞東-新竹,2023-11-22,2184
2330,台積電,39,1,38,亞東-新竹,2023-11-22,2184
3036,文曄,30,0,30,亞東-新竹,2023-11-22,2184
00919,群益台灣精選高息,29,1,28,亞東-新竹,2023-11-22,2184
00679B,元大美債20年,26,0,26,亞東-新竹,2023-11-22,2184
3545,敦泰,28,7,21,亞東-新竹,2023-11-22,2184
1611,中電,20,0,20,亞東-新竹,2023-11-22,2184
2888,新光金,20,0,20,亞東-新竹,2023-11-22,2184
5531,鄉林,20,0,20,亞東-新竹,2023-11-22,2184
6148,驊宏資,20,0,20,亞東-新竹,2023-11-22,2184
5225,東科-KY,14,0,14,亞東-新竹,2023-11-22,2184
6285,啟��,15,1,14,亞東-新竹,2023-11-22,2184
2618,長榮航,23,11,12,亞東-新竹,2023-11-22,2184
2356,英業達,16,5,11,亞東-新竹,2023-11-22,2184
3706,神達,11,0,11,亞東-新竹,2023-11-22,2184
2382,廣達,12,2,10,亞東-新竹,2023-11-22,2184
00632R,元大台灣50反1,10,0,10,亞東-新竹,2023-11-22,2184
2405,輔信,10,0,10,亞東-新竹,2023-11-22,2184
2838,聯邦銀,10,0,10,亞東-新竹,2023-11-22,2184
3051,力特,10,0,10,亞東-新竹,2023-11-22,2184
3322,建舜電,10,0,10,亞東-新竹,2023-11-22,2184
3701,大眾控,10,1,9,亞東-新竹,2023-11-22,2184
00936,台新永續高息中小,8,0,8,亞東-新竹,2023-11-22,2184
2201,裕隆,11,4,7,亞東-新竹,2023-11-22,2184
4908,前鼎,13,6,7,亞東-新竹,2023-11-22,2184
8034,榮群,10,3,7,亞東-新竹,2023-11-22,2184
00878,國泰永續高股息,6,0,6,亞東-新竹,2023-11-22,2184
4542,科嶠,6,0,6,亞東-新竹,2023-11-22,2184
00687B,國泰20年美債,5,0,5,亞東-新竹,2023-11-22,2184
00935,野村臺灣新科技50,5,0,5,亞東-新竹,2023-11-22,2184
2355,敬鵬,5,0,5,亞東-新竹,2023-11-22,2184
2406,國碩,5,0,5,亞東-新竹,2023-11-22,2184
3206,志豐,5,0,5,亞東-新竹,2023-11-22,2184
3665,貿聯-KY,5,0,5,亞東-新竹,2023-11-22,2184
5210,寶碩,5,0,5,亞東-新竹,2023-11-22,2184
6129,普誠,5,0,5,亞東-新竹,2023-11-22,2184
6290,良維,5,0,5,亞東-新竹,2023-11-22,2184
6547,高端疫苗,5,0,5,亞東-新竹,2023-11-22,2184
00753L,中信中國50正2,4,0,4,亞東-新竹,2023-11-22,2184
00676R,富邦臺灣加權反1,4,0,4,亞東-新竹,2023-11-22,2184
2371,大同,4,0,4,亞東-新竹,2023-11-22,2184
2388,威盛,8,4,4,亞東-新竹,2023-11-22,2184
2891,中信金,5,1,4,亞東-新竹,2023-11-22,2184
3122,笙泉,12,8,4,亞東-新竹,2023-11-22,2184
4931,新盛力,4,0,4,亞東-新竹,2023-11-22,2184
6188,廣明,4,0,4,亞東-新竹,2023-11-22,2184
6530,創威,75,1,74,亞東-新竹,2023-11-23,2184
3715,定穎投控,58,16,42,亞東-新竹,2023-11-23,2184
00919,群益台灣精選高息,41,0,41,亞東-新竹,2023-11-23,2184
00929,復華台灣科技優息,35,2,33,亞東-新竹,2023-11-23,2184
6138,茂達,23,1,22,亞東-新竹,2023-11-23,2184
2363,矽統,40,19,21,亞東-新竹,2023-11-23,2184
00725B,國泰投資級公司債,20,0,20,亞東-新竹,2023-11-23,2184
5465,富驊,21,1,20,亞東-新竹,2023-11-23,2184
5469,瀚宇博,19,0,19,亞東-新竹,2023-11-23,2184
2887,台新金,18,0,18,亞東-新竹,2023-11-23,2184
3231,緯創,23,9,14,亞東-新竹,2023-11-23,2184
6125,廣運,18,4,14,亞東-新竹,2023-11-23,2184
00878,國泰永續高股息,14,1,13,亞東-新竹,2023-11-23,2184
00679B,元大美債20年,13,1,12,亞東-新竹,2023-11-23,2184
3122,笙泉,20,9,11,亞東-新竹,2023-11-23,2184
00655L,國泰中國A50正2,10,0,10,亞東-新竹,2023-11-23,2184
3055,蔚華科,10,0,10,亞東-新竹,2023-11-23,2184
3702,大聯大,10,0,10,亞東-新竹,2023-11-23,2184
9105,泰金寶-DR,10,0,10,亞東-新竹,2023-11-23,2184
2303,聯電,17,8,9,亞東-新竹,2023-11-23,2184
3035,智原,9,1,8,亞東-新竹,2023-11-23,2184
2891,中信金,12,4,8,亞東-新竹,2023-11-23,2184
6282,康舒,17,9,8,亞東-新竹,2023-11-23,2184
4968,立積,11,4,7,亞東-新竹,2023-11-23,2184
00715L,期街口布蘭特正2,6,0,6,亞東-新竹,2023-11-23,2184
0056,元大高股息,5,0,5,亞東-新竹,2023-11-23,2184
3041,揚智,30,25,5,亞東-新竹,2023-11-23,2184
4157,太景*-KY,10,5,5,亞東-新竹,2023-11-23,2184
4908,前鼎,5,0,5,亞東-新竹,2023-11-23,2184
1709,和益,4,0,4,亞東-新竹,2023-11-23,2184
1722,台肥,4,0,4,亞東-新竹,2023-11-23,2184
1513,中興電,5,1,4,亞東-新竹,2023-11-23,2184
00934,中信成長高股息,4,0,4,亞東-新竹,2023-11-23,2184
2382,廣達,8,4,4,亞東-新竹,2023-11-23,2184
2892,第一金,4,0,4,亞東-新竹,2023-11-23,2184
3169,亞信,4,0,4,亞東-新竹,2023-11-23,2184
3515,華擎,6,2,4,亞東-新竹,2023-11-23,2184
4533,協易機,4,0,4,亞東-新竹,2023-11-23,2184
5244,弘凱,4,0,4,亞東-新竹,2023-11-23,2184
6533,晶心科,7,3,4,亞東-新竹,2023-11-23,2184
3443,創意,7,3,4,亞東-新竹,2023-11-23,2184
00935,野村臺灣新科技50,3,0,3,亞東-新竹,2023-11-23,2184
1582,信錦,4,1,3,亞東-新竹,2023-11-23,2184
2344,華邦電,4,1,3,亞東-新竹,2023-11-23,2184
2417,圓剛,29,26,3,亞東-新竹,2023-11-23,2184
2427,三商電,3,0,3,亞東-新竹,2023-11-23,2184
3704,合勤控,3,0,3,亞東-新竹,2023-11-23,2184
5321,美而快,3,0,3,亞東-新竹,2023-11-23,2184
6684,安格,7,4,3,亞東-新竹,2023-11-23,2184
8183,精星,3,0,3,亞東-新竹,2023-11-23,2184
2610,華航,60,0,60,亞東-新竹,2023-11-24,2184
00934,中信成長高股息,43,0,43,亞東-新竹,2023-11-24,2184
2618,長榮航,71,33,38,亞東-新竹,2023-11-24,2184
2485,兆赫,23,0,23,亞東-新竹,2023-11-24,2184
2913,農林,20,0,20,亞東-新竹,2023-11-24,2184
2363,矽統,33,17,16,亞東-新竹,2023-11-24,2184
5706,鳳凰,14,0,14,亞東-新竹,2023-11-24,2184
2002,中鋼,38,24,14,亞東-新竹,2023-11-24,2184
00885,富邦越南,12,0,12,亞東-新竹,2023-11-24,2184
2303,聯電,41,29,12,亞東-新竹,2023-11-24,2184
2888,新光金,11,0,11,亞東-新竹,2023-11-24,2184
2356,英業達,16,5,11,亞東-新竹,2023-11-24,2184
3036,文曄,11,0,11,亞東-新竹,2023-11-24,2184
00888,永豐台灣ESG,10,0,10,亞東-新竹,2023-11-24,2184
00679B,元大美債20年,10,0,10,亞東-新竹,2023-11-24,2184
00655L,國泰中國A50正2,10,0,10,亞東-新竹,2023-11-24,2184
8034,榮群,9,0,9,亞東-新竹,2023-11-24,2184
3006,晶豪科,9,1,8,亞東-新竹,2023-11-24,2184
1101,台泥,8,0,8,亞東-新竹,2023-11-24,2184
2317,鴻海,8,1,7,亞東-新竹,2023-11-24,2184
00720B,元大投資級公司債,7,0,7,亞東-新竹,2023-11-24,2184
1605,華新,6,0,6,亞東-新竹,2023-11-24,2184
1609,大亞,15,9,6,亞東-新竹,2023-11-24,2184
00687B,國泰20年美債,6,0,6,亞東-新竹,2023-11-24,2184
2520,冠德,6,0,6,亞東-新竹,2023-11-24,2184
00751B,元大AAA至A公司債,5,0,5,亞東-新竹,2023-11-24,2184
1584,精剛,5,0,5,亞東-新竹,2023-11-24,2184
1437,勤益控,5,0,5,亞東-新竹,2023-11-24,2184
2405,輔信,5,0,5,亞東-新竹,2023-11-24,2184
3704,合勤控,8,3,5,亞東-新竹,2023-11-24,2184
4157,太景*-KY,5,0,5,亞東-新竹,2023-11-24,2184
8105,凌巨,5,0,5,亞東-新竹,2023-11-24,2184
00772B,中信高評級公司債,4,0,4,亞東-新竹,2023-11-24,2184
4168,醣聯,4,0,4,亞東-新竹,2023-11-24,2184
5225,東科-KY,4,0,4,亞東-新竹,2023-11-24,2184
2330,台積電,4,0,4,亞東-新竹,2023-11-24,2184
2382,廣達,7,4,3,亞東-新竹,2023-11-24,2184
1532,勤美,3,0,3,亞東-新竹,2023-11-24,2184
2338,光罩,3,0,3,亞東-新竹,2023-11-24,2184
2355,敬鵬,3,0,3,亞東-新竹,2023-11-24,2184
2376,技嘉,3,0,3,亞東-新竹,2023-11-24,2184
5483,中美晶,3,0,3,亞東-新竹,2023-11-24,2184
9907,統一實,3,0,3,亞東-新竹,2023-11-24,2184
6235,華孚,3,1,2,亞東-新竹,2023-11-24,2184
1785,光洋科,2,0,2,亞東-新竹,2023-11-24,2184
00936,台新永續高息中小,2,0,2,亞東-新竹,2023-11-24,2184
00935,野村臺灣新科技50,2,0,2,亞東-新竹,2023-11-24,2184
00929,復華台灣科技優息,2,0,2,亞東-新竹,2023-11-24,2184
2344,華邦電,5,3,2,亞東-新竹,2023-11-24,2184
2425,承啟,2,0,2,亞東-新竹,2023-11-24,2184
00751B,元大AAA至A公司債,102,0,102,亞東-新竹,2023-11-27,2184
2634,漢翔,79,0,79,亞東-新竹,2023-11-27,2184
00679B,元大美債20年,50,0,50,亞東-新竹,2023-11-27,2184
00919,群益台灣精選高息,27,5,22,亞東-新竹,2023-11-27,2184
2405,輔信,20,0,20,亞東-新竹,2023-11-27,2184
2888,新光金,20,0,20,亞東-新竹,2023-11-27,2184
3041,揚智,20,0,20,亞東-新竹,2023-11-27,2184
4133,亞諾法,20,0,20,亞東-新竹,2023-11-27,2184
2303,聯電,22,7,15,亞東-新竹,2023-11-27,2184
2382,廣達,13,1,12,亞東-新竹,2023-11-27,2184
2867,三商壽,12,0,12,亞東-新竹,2023-11-27,2184
5469,瀚宇博,19,7,12,亞東-新竹,2023-11-27,2184
00935,野村臺灣新科技50,11,0,11,亞東-新竹,2023-11-27,2184
6138,茂達,13,2,11,亞東-新竹,2023-11-27,2184
2883,凱基金,13,3,10,亞東-新竹,2023-11-27,2184
00936,台新永續高息中小,10,0,10,亞東-新竹,2023-11-27,2184
2838,聯邦銀,10,0,10,亞東-新竹,2023-11-27,2184
2882,國泰金,20,10,10,亞東-新竹,2023-11-27,2184
4114,健喬,10,0,10,亞東-新竹,2023-11-27,2184
9958,世紀鋼,10,0,10,亞東-新竹,2023-11-27,2184
1514,亞力,10,1,9,亞東-新竹,2023-11-27,2184
00712,復華富時不動產,9,0,9,亞東-新竹,2023-11-27,2184
2201,裕隆,9,0,9,亞東-新竹,2023-11-27,2184
3035,智原,9,1,8,亞東-新竹,2023-11-27,2184
00633L,富邦上証正2,7,0,7,亞東-新竹,2023-11-27,2184
1532,勤美,6,0,6,亞東-新竹,2023-11-27,2184
3006,晶豪科,5,0,5,亞東-新竹,2023-11-27,2184
0056,元大高股息,5,0,5,亞東-新竹,2023-11-27,2184
00931B,統一美債20年,5,0,5,亞東-新竹,2023-11-27,2184
2323,中環,5,0,5,亞東-新竹,2023-11-27,2184
2355,敬鵬,10,5,5,亞東-新竹,2023-11-27,2184
3169,亞信,5,0,5,亞東-新竹,2023-11-27,2184
4541,晟田,5,0,5,亞東-新竹,2023-11-27,2184
4906,正文,5,0,5,亞東-新竹,2023-11-27,2184
6244,茂迪,5,0,5,亞東-新竹,2023-11-27,2184
8105,凌巨,5,0,5,亞東-新竹,2023-11-27,2184
0050,元大台灣50,5,0,5,亞東-新竹,2023-11-27,2184
00878,國泰永續高股息,14,10,4,亞東-新竹,2023-11-27,2184
2427,三商電,4,0,4,亞東-新竹,2023-11-27,2184
2449,京元電子,4,0,4,亞東-新竹,2023-11-27,2184
3078,僑威,4,0,4,亞東-新竹,2023-11-27,2184
3083,網龍,4,0,4,亞東-新竹,2023-11-27,2184
5706,鳳凰,4,0,4,亞東-新竹,2023-11-27,2184
2892,第一金,3,0,3,亞東-新竹,2023-11-27,2184
6901,鑽石投資,3,0,3,亞東-新竹,2023-11-27,2184
3693,營邦,5,2,3,亞東-新竹,2023-11-27,2184
00655L,國泰中國A50正2,3,0,3,亞東-新竹,2023-11-27,2184
00720B,元大投資級公司債,3,0,3,亞東-新竹,2023-11-27,2184
2308,台達電,3,0,3,亞東-新竹,2023-11-27,2184
2338,光罩,3,0,3,亞東-新竹,2023-11-27,2184
00751B,元大AAA至A公司債,100,3,97,亞東-新竹,2023-11-28,2184
00642U,期元大S＆P石油,50,0,50,亞東-新竹,2023-11-28,2184
6143,振曜,44,4,40,亞東-新竹,2023-11-28,2184
1612,宏泰,30,0,30,亞東-新竹,2023-11-28,2184
2460,建通,25,0,25,亞東-新竹,2023-11-28,2184
2887,台新金,25,0,25,亞東-新竹,2023-11-28,2184
2637,慧洋-KY,31,10,21,亞東-新竹,2023-11-28,2184
00885,富邦越南,17,0,17,亞東-新竹,2023-11-28,2184
00892,富邦台灣半導體,15,0,15,亞東-新竹,2023-11-28,2184
5469,瀚宇博,15,0,15,亞東-新竹,2023-11-28,2184
2330,台積電,17,3,14,亞東-新竹,2023-11-28,2184
00878,國泰永續高股息,11,0,11,亞東-新竹,2023-11-28,2184
00919,群益台灣精選高息,10,0,10,亞東-新竹,2023-11-28,2184
1734,杏輝,10,0,10,亞東-新竹,2023-11-28,2184
2605,新興,18,8,10,亞東-新竹,2023-11-28,2184
2838,聯邦銀,10,0,10,亞東-新竹,2023-11-28,2184
3227,原相,10,0,10,亞東-新竹,2023-11-28,2184
3715,定穎投控,41,31,10,亞東-新竹,2023-11-28,2184
4714,永捷,10,0,10,亞東-新竹,2023-11-28,2184
6806,森崴能源,10,0,10,亞東-新竹,2023-11-28,2184
8105,凌巨,10,0,10,亞東-新竹,2023-11-28,2184
2408,南亞科,9,0,9,亞東-新竹,2023-11-28,2184
00637L,元大滬深300正2,8,0,8,亞東-新竹,2023-11-28,2184
2303,聯電,27,19,8,亞東-新竹,2023-11-28,2184
00929,復華台灣科技優息,13,6,7,亞東-新竹,2023-11-28,2184
2317,鴻海,19,12,7,亞東-新竹,2023-11-28,2184
2834,臺企銀,59,52,7,亞東-新竹,2023-11-28,2184
3122,笙泉,10,3,7,亞東-新竹,2023-11-28,2184
3322,建舜電,10,3,7,亞東-新竹,2023-11-28,2184
00712,復華富時不動產,6,0,6,亞東-新竹,2023-11-28,2184
2419,仲琦,6,0,6,亞東-新竹,2023-11-28,2184
2641,正德,6,0,6,亞東-新竹,2023-11-28,2184
3706,神達,6,0,6,亞東-新竹,2023-11-28,2184
2258,鴻華先進-創,5,0,5,亞東-新竹,2023-11-28,2184
2323,中環,5,0,5,亞東-新竹,2023-11-28,2184
2376,技嘉,6,1,5,亞東-新竹,2023-11-28,2184
2401,凌陽,15,10,5,亞東-新竹,2023-11-28,2184
2606,裕民,8,3,5,亞東-新竹,2023-11-28,2184
8936,國統,5,0,5,亞東-新竹,2023-11-28,2184
2388,威盛,8,3,5,亞東-新竹,2023-11-28,2184
2382,廣達,9,5,4,亞東-新竹,2023-11-28,2184
00877,復華中國5G,4,0,4,亞東-新竹,2023-11-28,2184
00935,野村臺灣新科技50,4,0,4,亞東-新竹,2023-11-28,2184
00756B,群益投等新興公債,3,0,3,亞東-新竹,2023-11-28,2184
00753L,中信中國50正2,3,0,3,亞東-新竹,2023-11-28,2184
1720,生達,3,0,3,亞東-新竹,2023-11-28,2184
3704,合勤控,3,0,3,亞東-新竹,2023-11-28,2184
4168,醣聯,3,0,3,亞東-新竹,2023-11-28,2184
4904,遠傳,3,0,3,亞東-新竹,2023-11-28,2184
4906,正文,3,0,3,亞東-新竹,2023-11-28,2184
2885,元大金,718,10,708,亞東-新竹,2023-11-29,2184
8112,至上,100,5,95,亞東-新竹,2023-11-29,2184
2610,華航,60,0,60,亞東-新竹,2023-11-29,2184
3704,合勤控,67,7,60,亞東-新竹,2023-11-29,2184
1612,宏泰,55,5,50,亞東-新竹,2023-11-29,2184
6143,振曜,43,3,40,亞東-新竹,2023-11-29,2184
00934,中信成長高股息,32,1,31,亞東-新竹,2023-11-29,2184
00720B,元大投資級公司債,27,0,27,亞東-新竹,2023-11-29,2184
2330,台積電,26,3,23,亞東-新竹,2023-11-29,2184
2329,華泰,28,8,20,亞東-新竹,2023-11-29,2184
5531,鄉林,20,0,20,亞東-新竹,2023-11-29,2184
2882,國泰金,16,0,16,亞東-新竹,2023-11-29,2184
4157,太景*-KY,15,0,15,亞東-新竹,2023-11-29,2184
2317,鴻海,12,0,12,亞東-新竹,2023-11-29,2184
00680L,元大美債20正2,11,0,11,亞東-新竹,2023-11-29,2184
2409,友達,11,0,11,亞東-新竹,2023-11-29,2184
2883,凱基金,11,0,11,亞東-新竹,2023-11-29,2184
00632R,元大台灣50反1,10,0,10,亞東-新竹,2023-11-29,2184
00665L,富邦�琤肭磪囓�2,10,0,10,亞東-新竹,2023-11-29,2184
00773B,中信優先金融債,10,0,10,亞東-新竹,2023-11-29,2184
2201,裕隆,13,3,10,亞東-新竹,2023-11-29,2184
3545,敦泰,14,4,10,亞東-新竹,2023-11-29,2184
00882,中信中國高股息,10,1,9,亞東-新竹,2023-11-29,2184
00650L,復華香港正2,9,0,9,亞東-新竹,2023-11-29,2184
9919,康那香,31,22,9,亞東-新竹,2023-11-29,2184
00633L,富邦上証正2,8,0,8,亞東-新竹,2023-11-29,2184
2891,中信金,18,10,8,亞東-新竹,2023-11-29,2184
00637L,元大滬深300正2,13,6,7,亞東-新竹,2023-11-29,2184
1752,南光,7,0,7,亞東-新竹,2023-11-29,2184
5347,世界,8,1,7,亞東-新竹,2023-11-29,2184
00753L,中信中國50正2,8,2,6,亞東-新竹,2023-11-29,2184
3522,御嵿,6,0,6,亞東-新竹,2023-11-29,2184
6257,矽格,6,0,6,亞東-新竹,2023-11-29,2184
00710B,復華彭博非投等債,5,0,5,亞東-新竹,2023-11-29,2184
2618,長榮航,10,5,5,亞東-新竹,2023-11-29,2184
4906,正文,10,5,5,亞東-新竹,2023-11-29,2184
5306,桂盟,5,0,5,亞東-新竹,2023-11-29,2184
6462,神盾,7,2,5,亞東-新竹,2023-11-29,2184
8064,東捷,5,0,5,亞東-新竹,2023-11-29,2184
6278,台表科,4,0,4,亞東-新竹,2023-11-29,2184
1101,台泥,5,1,4,亞東-新竹,2023-11-29,2184
00918,大華優利高填息30,4,0,4,亞東-新竹,2023-11-29,2184
2736,富野,4,0,4,亞東-新竹,2023-11-29,2184
3218,大學光,4,0,4,亞東-新竹,2023-11-29,2184
6245,立端,4,0,4,亞東-新竹,2023-11-29,2184
6139,亞翔,4,1,3,亞東-新竹,2023-11-29,2184
00752,中信中國50,3,0,3,亞東-新竹,2023-11-29,2184
00687B,國泰20年美債,3,0,3,亞東-新竹,2023-11-29,2184
2867,三商壽,3,0,3,亞東-新竹,2023-11-29,2184
3287,廣寰科,3,0,3,亞東-新竹,2023-11-29,2184
00632R,元大台灣50反1,610,0,610,亞東-新竹,2023-11-30,2184
00680L,元大美債20正2,590,250,340,亞東-新竹,2023-11-30,2184
2885,元大金,190,1,189,亞東-新竹,2023-11-30,2184
6257,矽格,52,2,50,亞東-新竹,2023-11-30,2184
00929,復華台灣科技優息,46,10,36,亞東-新竹,2023-11-30,2184
2915,潤泰全,38,2,36,亞東-新竹,2023-11-30,2184
4157,太景*-KY,46,11,35,亞東-新竹,2023-11-30,2184
2317,鴻海,21,0,21,亞東-新竹,2023-11-30,2184
2838,聯邦銀,20,0,20,亞東-新竹,2023-11-30,2184
00931B,統一美債20年,20,5,15,亞東-新竹,2023-11-30,2184
00722B,群益投資級電信債,15,1,14,亞東-新竹,2023-11-30,2184
2303,聯電,23,10,13,亞東-新竹,2023-11-30,2184
1612,宏泰,10,0,10,亞東-新竹,2023-11-30,2184
00772B,中信高評級公司債,10,0,10,亞東-新竹,2023-11-30,2184
2834,臺企銀,10,0,10,亞東-新竹,2023-11-30,2184
3653,健策,12,2,10,亞東-新竹,2023-11-30,2184
2344,華邦電,14,5,9,亞東-新竹,2023-11-30,2184
3545,敦泰,11,2,9,亞東-新竹,2023-11-30,2184
4105,東洋,9,0,9,亞東-新竹,2023-11-30,2184
00878,國泰永續高股息,19,11,8,亞東-新竹,2023-11-30,2184
5381,合正,9,1,8,亞東-新竹,2023-11-30,2184
6472,保瑞,8,0,8,亞東-新竹,2023-11-30,2184
3231,緯創,12,5,7,亞東-新竹,2023-11-30,2184
5483,中美晶,7,0,7,亞東-新竹,2023-11-30,2184
3022,威強電,15,8,7,亞東-新竹,2023-11-30,2184
6806,森崴能源,8,1,7,亞東-新竹,2023-11-30,2184
8176,智捷,7,0,7,亞東-新竹,2023-11-30,2184
2314,台揚,7,1,6,亞東-新竹,2023-11-30,2184
2401,凌陽,9,3,6,亞東-新竹,2023-11-30,2184
4908,前鼎,6,0,6,亞東-新竹,2023-11-30,2184
5272,笙科,6,0,6,亞東-新竹,2023-11-30,2184
9958,世紀鋼,5,0,5,亞東-新竹,2023-11-30,2184
00719B,元大美債1-3,5,0,5,亞東-新竹,2023-11-30,2184
2465,麗臺,6,1,5,亞東-新竹,2023-11-30,2184
2603,長榮,6,1,5,亞東-新竹,2023-11-30,2184
3045,台灣大,5,0,5,亞東-新竹,2023-11-30,2184
3481,群創,5,0,5,亞東-新竹,2023-11-30,2184
9904,寶成,5,0,5,亞東-新竹,2023-11-30,2184
00687B,國泰20年美債,4,0,4,亞東-新竹,2023-11-30,2184
2201,裕隆,8,4,4,亞東-新竹,2023-11-30,2184
2457,飛宏,4,0,4,亞東-新竹,2023-11-30,2184
6125,廣運,4,0,4,亞東-新竹,2023-11-30,2184
6593,台灣銘板,5,1,4,亞東-新竹,2023-11-30,2184
2887,台新金,4,0,4,亞東-新竹,2023-11-30,2184
4961,天鈺,10,6,4,亞東-新竹,2023-11-30,2184
00795B,中信美國公債20年,3,0,3,亞東-新竹,2023-11-30,2184
00922,國泰台灣領袖50,3,0,3,亞東-新竹,2023-11-30,2184
2302,麗正,3,0,3,亞東-新竹,2023-11-30,2184
2492,華新科,3,0,3,亞東-新竹,2023-11-30,2184
3557,嘉威,3,0,3,亞東-新竹,2023-11-30,2184
2885,元大金,222,0,222,亞東-新竹,2023-12-01,2184
00751B,元大AAA至A公司債,221,0,221,亞東-新竹,2023-12-01,2184
00680L,元大美債20正2,111,0,111,亞東-新竹,2023-12-01,2184
2883,凱基金,210,100,110,亞東-新竹,2023-12-01,2184
00919,群益台灣精選高息,60,0,60,亞東-新竹,2023-12-01,2184
2888,新光金,26,0,26,亞東-新竹,2023-12-01,2184
2405,輔信,20,0,20,亞東-新竹,2023-12-01,2184
2495,普安,20,0,20,亞東-新竹,2023-12-01,2184
1795,美時,33,15,18,亞東-新竹,2023-12-01,2184
00720B,元大投資級公司債,16,0,16,亞東-新竹,2023-12-01,2184
00687B,國泰20年美債,15,0,15,亞東-新竹,2023-12-01,2184
6282,康舒,15,1,14,亞東-新竹,2023-12-01,2184
2317,鴻海,13,0,13,亞東-新竹,2023-12-01,2184
00878,國泰永續高股息,12,0,12,亞東-新竹,2023-12-01,2184
8096,擎亞,22,11,11,亞東-新竹,2023-12-01,2184
1460,宏遠,10,0,10,亞東-新竹,2023-12-01,2184
1102,亞泥,10,0,10,亞東-新竹,2023-12-01,2184
2886,兆豐金,10,0,10,亞東-新竹,2023-12-01,2184
3013,晟銘電,11,1,10,亞東-新竹,2023-12-01,2184
6443,元晶,10,0,10,亞東-新竹,2023-12-01,2184
8105,凌巨,10,0,10,亞東-新竹,2023-12-01,2184
00773B,中信優先金融債,9,0,9,亞東-新竹,2023-12-01,2184
2363,矽統,18,9,9,亞東-新竹,2023-12-01,2184
2313,華通,24,15,9,亞東-新竹,2023-12-01,2184
00882,中信中國高股息,8,0,8,亞東-新竹,2023-12-01,2184
00679B,元大美債20年,8,0,8,亞東-新竹,2023-12-01,2184
2891,中信金,8,0,8,亞東-新竹,2023-12-01,2184
2356,英業達,13,6,7,亞東-新竹,2023-12-01,2184
2359,所羅門,7,0,7,亞東-新竹,2023-12-01,2184
2449,京元電子,7,0,7,亞東-新竹,2023-12-01,2184
3545,敦泰,8,1,7,亞東-新竹,2023-12-01,2184
6276,安鈦克,8,1,7,亞東-新竹,2023-12-01,2184
00637L,元大滬深300正2,8,2,6,亞東-新竹,2023-12-01,2184
2344,華邦電,10,4,6,亞東-新竹,2023-12-01,2184
3050,鈺德,6,0,6,亞東-新竹,2023-12-01,2184
2442,新美齊,5,0,5,亞東-新竹,2023-12-01,2184
3338,泰碩,5,0,5,亞東-新竹,2023-12-01,2184
3702,大聯大,5,0,5,亞東-新竹,2023-12-01,2184
4105,東洋,5,0,5,亞東-新竹,2023-12-01,2184
6143,振曜,5,0,5,亞東-新竹,2023-12-01,2184
8112,至上,5,0,5,亞東-新竹,2023-12-01,2184
6202,盛群,5,0,5,亞東-新竹,2023-12-01,2184
2376,技嘉,5,1,4,亞東-新竹,2023-12-01,2184
00722B,群益投資級電信債,5,1,4,亞東-新竹,2023-12-01,2184
2002,中鋼,8,4,4,亞東-新竹,2023-12-01,2184
2314,台揚,4,0,4,亞東-新竹,2023-12-01,2184
2369,菱生,5,1,4,亞東-新竹,2023-12-01,2184
2377,微星,4,0,4,亞東-新竹,2023-12-01,2184
2408,南亞科,4,0,4,亞東-新竹,2023-12-01,2184
2439,美律,4,0,4,亞東-新竹,2023-12-01,2184
00919,群益台灣精選高息,261,30,231,亞東-新竹,2023-12-04,2184
2883,凱基金,132,10,122,亞東-新竹,2023-12-04,2184
00929,復華台灣科技優息,57,3,54,亞東-新竹,2023-12-04,2184
00642U,期元大S＆P石油,50,0,50,亞東-新竹,2023-12-04,2184
00715L,期街口布蘭特正2,40,0,40,亞東-新竹,2023-12-04,2184
00720B,元大投資級公司債,36,0,36,亞東-新竹,2023-12-04,2184
2105,正新,30,0,30,亞東-新竹,2023-12-04,2184
3325,旭品,26,1,25,亞東-新竹,2023-12-04,2184
8112,至上,25,1,24,亞東-新竹,2023-12-04,2184
1605,華新,20,0,20,亞東-新竹,2023-12-04,2184
00764B,群益25年美債,20,0,20,亞東-新竹,2023-12-04,2184
00680L,元大美債20正2,20,0,20,亞東-新竹,2023-12-04,2184
6770,力積電,30,10,20,亞東-新竹,2023-12-04,2184
00900,富邦特選高股息30,24,5,19,亞東-新竹,2023-12-04,2184
2618,長榮航,27,10,17,亞東-新竹,2023-12-04,2184
6282,康舒,17,0,17,亞東-新竹,2023-12-04,2184
2409,友達,22,8,14,亞東-新竹,2023-12-04,2184
1513,中興電,15,2,13,亞東-新竹,2023-12-04,2184
5864,致和證,13,0,13,亞東-新竹,2023-12-04,2184
00773B,中信優先金融債,12,0,12,亞東-新竹,2023-12-04,2184
2462,良得電,12,0,12,亞東-新竹,2023-12-04,2184
4561,健椿,12,0,12,亞東-新竹,2023-12-04,2184
8936,國統,12,0,12,亞東-新竹,2023-12-04,2184
00935,野村臺灣新科技50,11,0,11,亞東-新竹,2023-12-04,2184
1568,倉佑,11,0,11,亞東-新竹,2023-12-04,2184
3715,定穎投控,21,11,10,亞東-新竹,2023-12-04,2184
00882,中信中國高股息,10,0,10,亞東-新竹,2023-12-04,2184
0061,元大寶滬深,10,0,10,亞東-新竹,2023-12-04,2184
1402,遠東新,15,5,10,亞東-新竹,2023-12-04,2184
1817,凱撒衛,10,0,10,亞東-新竹,2023-12-04,2184
2915,潤泰全,11,1,10,亞東-新竹,2023-12-04,2184
4714,永捷,20,10,10,亞東-新竹,2023-12-04,2184
6143,振曜,10,0,10,亞東-新竹,2023-12-04,2184
1319,東陽,10,0,10,亞東-新竹,2023-12-04,2184
00679B,元大美債20年,12,3,9,亞東-新竹,2023-12-04,2184
00934,中信成長高股息,9,0,9,亞東-新竹,2023-12-04,2184
5328,華容,10,1,9,亞東-新竹,2023-12-04,2184
9955,佳龍,9,0,9,亞東-新竹,2023-12-04,2184
00922,國泰台灣領袖50,8,0,8,亞東-新竹,2023-12-04,2184
1711,永光,8,0,8,亞東-新竹,2023-12-04,2184
6233,旺玖,8,0,8,亞東-新竹,2023-12-04,2184
2330,台積電,9,2,7,亞東-新竹,2023-12-04,2184
1717,長興,7,0,7,亞東-新竹,2023-12-04,2184
3035,智原,7,1,6,亞東-新竹,2023-12-04,2184
00712,復華富時不動產,6,0,6,亞東-新竹,2023-12-04,2184
00687B,國泰20年美債,6,0,6,亞東-新竹,2023-12-04,2184
00753L,中信中國50正2,6,0,6,亞東-新竹,2023-12-04,2184
1504,東元,6,0,6,亞東-新竹,2023-12-04,2184
2201,裕隆,12,6,6,亞東-新竹,2023-12-04,2184
9919,康那香,22,16,6,亞東-新竹,2023-12-04,2184
00919,群益台灣精選高息,201,0,201,亞東-新竹,2023-12-05,2184
2882,國泰金,118,0,118,亞東-新竹,2023-12-05,2184
00937B,群益ESG投等債20,38,0,38,亞東-新竹,2023-12-05,2184
00680L,元大美債20正2,30,0,30,亞東-新竹,2023-12-05,2184
00679B,元大美債20年,37,8,29,亞東-新竹,2023-12-05,2184
2303,聯電,28,2,26,亞東-新竹,2023-12-05,2184
2457,飛宏,25,0,25,亞東-新竹,2023-12-05,2184
3037,欣興,25,0,25,亞東-新竹,2023-12-05,2184
3231,緯創,20,0,20,亞東-新竹,2023-12-05,2184
00888,永豐台灣ESG,20,0,20,亞東-新竹,2023-12-05,2184
5531,鄉林,18,0,18,亞東-新竹,2023-12-05,2184
00882,中信中國高股息,22,5,17,亞東-新竹,2023-12-05,2184
2427,三商電,17,0,17,亞東-新竹,2023-12-05,2184
4157,太景*-KY,40,25,15,亞東-新竹,2023-12-05,2184
2607,榮運,12,0,12,亞東-新竹,2023-12-05,2184
4167,松瑞藥,12,0,12,亞東-新竹,2023-12-05,2184
00935,野村臺灣新科技50,11,0,11,亞東-新竹,2023-12-05,2184
2888,新光金,21,10,11,亞東-新竹,2023-12-05,2184
00633L,富邦上証正2,10,0,10,亞東-新竹,2023-12-05,2184
1568,倉佑,10,0,10,亞東-新竹,2023-12-05,2184
1785,光洋科,11,1,10,亞東-新竹,2023-12-05,2184
6190,萬泰科,10,0,10,亞東-新竹,2023-12-05,2184
6443,元晶,10,0,10,亞東-新竹,2023-12-05,2184
8105,凌巨,10,0,10,亞東-新竹,2023-12-05,2184
3035,智原,9,0,9,亞東-新竹,2023-12-05,2184
2618,長榮航,11,5,6,亞東-新竹,2023-12-05,2184
00915,凱基優選高股息30,6,0,6,亞東-新竹,2023-12-05,2184
2727,王品,6,0,6,亞東-新竹,2023-12-05,2184
6276,安鈦克,6,0,6,亞東-新竹,2023-12-05,2184
2606,裕民,10,5,5,亞東-新竹,2023-12-05,2184
2363,矽統,10,5,5,亞東-新竹,2023-12-05,2184
5347,世界,5,0,5,亞東-新竹,2023-12-05,2184
00918,大華優利高填息30,5,0,5,亞東-新竹,2023-12-05,2184
2485,兆赫,15,10,5,亞東-新竹,2023-12-05,2184
3036,文曄,5,0,5,亞東-新竹,2023-12-05,2184
3346,麗清,5,0,5,亞東-新竹,2023-12-05,2184
4414,如興,5,0,5,亞東-新竹,2023-12-05,2184
5457,宣德,5,0,5,亞東-新竹,2023-12-05,2184
6733,博晟生醫,5,0,5,亞東-新竹,2023-12-05,2184
2892,第一金,4,0,4,亞東-新竹,2023-12-05,2184
00764B,群益25年美債,4,0,4,亞東-新竹,2023-12-05,2184
00655L,國泰中國A50正2,4,0,4,亞東-新竹,2023-12-05,2184
00687B,國泰20年美債,7,3,4,亞東-新竹,2023-12-05,2184
1701,中化,4,0,4,亞東-新竹,2023-12-05,2184
2528,皇普,4,0,4,亞東-新竹,2023-12-05,2184
2891,中信金,5,1,4,亞東-新竹,2023-12-05,2184
3005,神基,4,0,4,亞東-新竹,2023-12-05,2184
3013,晟銘電,6,2,4,亞東-新竹,2023-12-05,2184
3515,華擎,4,0,4,亞東-新竹,2023-12-05,2184
2887,台新金,3,0,3,亞東-新竹,2023-12-05,2184
00688L,國泰20年美債正2,200,0,200,亞東-新竹,2023-12-06,2184
00937B,群益ESG投等債20,64,3,61,亞東-新竹,2023-12-06,2184
6005,群益證,50,0,50,亞東-新竹,2023-12-06,2184
2845,遠東銀,52,5,47,亞東-新竹,2023-12-06,2184
00919,群益台灣精選高息,43,0,43,亞東-新竹,2023-12-06,2184
9958,世紀鋼,40,0,40,亞東-新竹,2023-12-06,2184
00680L,元大美債20正2,325,290,35,亞東-新竹,2023-12-06,2184
6770,力積電,35,0,35,亞東-新竹,2023-12-06,2184
3051,力特,44,11,33,亞東-新竹,2023-12-06,2184
00715L,期街口布蘭特正2,32,0,32,亞東-新竹,2023-12-06,2184
00929,復華台灣科技優息,46,15,31,亞東-新竹,2023-12-06,2184
3702,大聯大,32,1,31,亞東-新竹,2023-12-06,2184
3390,旭軟,30,0,30,亞東-新竹,2023-12-06,2184
2354,鴻準,29,0,29,亞東-新竹,2023-12-06,2184
2303,聯電,28,0,28,亞東-新竹,2023-12-06,2184
2485,兆赫,25,0,25,亞東-新竹,2023-12-06,2184
3041,揚智,31,7,24,亞東-新竹,2023-12-06,2184
2313,華通,26,4,22,亞東-新竹,2023-12-06,2184
00679B,元大美債20年,25,4,21,亞東-新竹,2023-12-06,2184
00687B,國泰20年美債,22,2,20,亞東-新竹,2023-12-06,2184
1611,中電,20,0,20,亞東-新竹,2023-12-06,2184
2867,三商壽,20,0,20,亞東-新竹,2023-12-06,2184
2892,第一金,20,0,20,亞東-新竹,2023-12-06,2184
1785,光洋科,15,0,15,亞東-新竹,2023-12-06,2184
4157,太景*-KY,20,5,15,亞東-新竹,2023-12-06,2184
2377,微星,14,0,14,亞東-新竹,2023-12-06,2184
3481,群創,13,0,13,亞東-新竹,2023-12-06,2184
00712,復華富時不動產,10,0,10,亞東-新竹,2023-12-06,2184
6589,台康生技,10,0,10,亞東-新竹,2023-12-06,2184
3450,聯鈞,14,7,7,亞東-新竹,2023-12-06,2184
1432,大魯閣,6,0,6,亞東-新竹,2023-12-06,2184
1514,亞力,11,5,6,亞東-新竹,2023-12-06,2184
2419,仲琦,21,15,6,亞東-新竹,2023-12-06,2184
2905,三商,10,4,6,亞東-新竹,2023-12-06,2184
6278,台表科,6,0,6,亞東-新竹,2023-12-06,2184
2882,國泰金,5,0,5,亞東-新竹,2023-12-06,2184
1314,中石化,5,0,5,亞東-新竹,2023-12-06,2184
1312,國喬,5,0,5,亞東-新竹,2023-12-06,2184
00935,野村臺灣新科技50,5,0,5,亞東-新竹,2023-12-06,2184
00877,復華中國5G,5,0,5,亞東-新竹,2023-12-06,2184
4133,亞諾法,5,0,5,亞東-新竹,2023-12-06,2184
4167,松瑞藥,5,0,5,亞東-新竹,2023-12-06,2184
6443,元晶,5,0,5,亞東-新竹,2023-12-06,2184
8938,明安,5,0,5,亞東-新竹,2023-12-06,2184
1513,中興電,5,0,5,亞東-新竹,2023-12-06,2184
1504,東元,4,0,4,亞東-新竹,2023-12-06,2184
1342,八貫,4,0,4,亞東-新竹,2023-12-06,2184
1529,樂事綠能,14,10,4,亞東-新竹,2023-12-06,2184
2201,裕隆,16,12,4,亞東-新竹,2023-12-06,2184
3013,晟銘電,6,2,4,亞東-新竹,2023-12-06,2184
00688L,國泰20年美債正2,631,0,631,亞東-新竹,2023-12-07,2184
00919,群益台灣精選高息,189,74,115,亞東-新竹,2023-12-07,2184
00933B,國泰10Y+金融債,60,3,57,亞東-新竹,2023-12-07,2184
2845,遠東銀,50,1,49,亞東-新竹,2023-12-07,2184
2449,京元電子,48,0,48,亞東-新竹,2023-12-07,2184
2618,長榮航,84,42,42,亞東-新竹,2023-12-07,2184
00715L,期街口布蘭特正2,36,0,36,亞東-新竹,2023-12-07,2184
00937B,群益ESG投等債20,42,12,30,亞東-新竹,2023-12-07,2184
00830,國泰費城半導體,30,0,30,亞東-新竹,2023-12-07,2184
2105,正新,30,0,30,亞東-新竹,2023-12-07,2184
4133,亞諾法,25,0,25,亞東-新竹,2023-12-07,2184
2303,聯電,27,2,25,亞東-新竹,2023-12-07,2184
00751B,元大AAA至A公司債,23,2,21,亞東-新竹,2023-12-07,2184
00712,復華富時不動產,20,0,20,亞東-新竹,2023-12-07,2184
00772B,中信高評級公司債,21,1,20,亞東-新竹,2023-12-07,2184
6288,聯嘉,20,0,20,亞東-新竹,2023-12-07,2184
00687B,國泰20年美債,18,0,18,亞東-新竹,2023-12-07,2184
6005,群益證,17,0,17,亞東-新竹,2023-12-07,2184
2313,華通,24,8,16,亞東-新竹,2023-12-07,2184
3041,揚智,17,1,16,亞東-新竹,2023-12-07,2184
2641,正德,14,0,14,亞東-新竹,2023-12-07,2184
00720B,元大投資級公司債,26,12,14,亞東-新竹,2023-12-07,2184
1618,合機,12,0,12,亞東-新竹,2023-12-07,2184
4167,松瑞藥,12,0,12,亞東-新竹,2023-12-07,2184
1504,東元,14,4,10,亞東-新竹,2023-12-07,2184
00888,永豐台灣ESG,10,0,10,亞東-新竹,2023-12-07,2184
2399,映泰,10,0,10,亞東-新竹,2023-12-07,2184
2888,新光金,15,5,10,亞東-新竹,2023-12-07,2184
3704,合勤控,10,0,10,亞東-新竹,2023-12-07,2184
3711,日月光投控,10,0,10,亞東-新竹,2023-12-07,2184
4967,十銓,11,1,10,亞東-新竹,2023-12-07,2184
6121,新普,10,0,10,亞東-新竹,2023-12-07,2184
6190,萬泰科,10,0,10,亞東-新竹,2023-12-07,2184
1513,中興電,12,2,10,亞東-新竹,2023-12-07,2184
2727,王品,8,0,8,亞東-新竹,2023-12-07,2184
3450,聯鈞,8,0,8,亞東-新竹,2023-12-07,2184
00670L,富邦NASDAQ正2,7,0,7,亞東-新竹,2023-12-07,2184
00753L,中信中國50正2,7,0,7,亞東-新竹,2023-12-07,2184
00935,野村臺灣新科技50,7,0,7,亞東-新竹,2023-12-07,2184
00878,國泰永續高股息,7,0,7,亞東-新竹,2023-12-07,2184
00918,大華優利高填息30,7,0,7,亞東-新竹,2023-12-07,2184
1720,生達,7,0,7,亞東-新竹,2023-12-07,2184
2369,菱生,7,0,7,亞東-新竹,2023-12-07,2184
1304,台聚,6,0,6,亞東-新竹,2023-12-07,2184
1568,倉佑,6,0,6,亞東-新竹,2023-12-07,2184
9921,巨大,6,0,6,亞東-新竹,2023-12-07,2184
9945,潤泰新,6,0,6,亞東-新竹,2023-12-07,2184
00921,兆豐龍頭等權重,5,0,5,亞東-新竹,2023-12-07,2184
00885,富邦越南,5,0,5,亞東-新竹,2023-12-07,2184
1316,上曜,5,0,5,亞東-新竹,2023-12-07,2184
00688L,國泰20年美債正2,120,0,120,亞東-新竹,2023-12-08,2184
00680L,元大美債20正2,104,0,104,亞東-新竹,2023-12-08,2184
00878,國泰永續高股息,105,12,93,亞東-新竹,2023-12-08,2184
00720B,元大投資級公司債,68,2,66,亞東-新竹,2023-12-08,2184
00687B,國泰20年美債,58,0,58,亞東-新竹,2023-12-08,2184
1319,東陽,50,0,50,亞東-新竹,2023-12-08,2184
1522,堤維西,51,2,49,亞東-新竹,2023-12-08,2184
00937B,群益ESG投等債20,35,0,35,亞東-新竹,2023-12-08,2184
3231,緯創,39,11,28,亞東-新竹,2023-12-08,2184
1609,大亞,26,3,23,亞東-新竹,2023-12-08,2184
00919,群益台灣精選高息,23,2,21,亞東-新竹,2023-12-08,2184
2881,富邦金,20,0,20,亞東-新竹,2023-12-08,2184
4432,銘旺實,20,0,20,亞東-新竹,2023-12-08,2184
00929,復華台灣科技優息,18,0,18,亞東-新竹,2023-12-08,2184
8354,冠好,17,0,17,亞東-新竹,2023-12-08,2184
2330,台積電,21,4,17,亞東-新竹,2023-12-08,2184
2887,台新金,15,0,15,亞東-新竹,2023-12-08,2184
1560,中砂,15,0,15,亞東-新竹,2023-12-08,2184
6005,群益證,13,0,13,亞東-新竹,2023-12-08,2184
1720,生達,11,0,11,亞東-新竹,2023-12-08,2184
2314,台揚,11,0,11,亞東-新竹,2023-12-08,2184
1569,濱川,10,0,10,亞東-新竹,2023-12-08,2184
1611,中電,30,20,10,亞東-新竹,2023-12-08,2184
2732,六角,10,0,10,亞東-新竹,2023-12-08,2184
3704,合勤控,10,0,10,亞東-新竹,2023-12-08,2184
4157,太景*-KY,10,0,10,亞東-新竹,2023-12-08,2184
2885,元大金,8,0,8,亞東-新竹,2023-12-08,2184
2069,運錩,7,0,7,亞東-新竹,2023-12-08,2184
6703,軒郁,7,0,7,亞東-新竹,2023-12-08,2184
4906,正文,7,0,7,亞東-新竹,2023-12-08,2184
1514,亞力,20,14,6,亞東-新竹,2023-12-08,2184
2356,英業達,10,4,6,亞東-新竹,2023-12-08,2184
2882,國泰金,6,0,6,亞東-新竹,2023-12-08,2184
5871,中租-KY,8,2,6,亞東-新竹,2023-12-08,2184
8996,高力,5,0,5,亞東-新竹,2023-12-08,2184
00632R,元大台灣50反1,5,0,5,亞東-新竹,2023-12-08,2184
00712,復華富時不動產,5,0,5,亞東-新竹,2023-12-08,2184
00751B,元大AAA至A公司債,5,0,5,亞東-新竹,2023-12-08,2184
2607,榮運,5,0,5,亞東-新竹,2023-12-08,2184
2727,王品,5,0,5,亞東-新竹,2023-12-08,2184
2888,新光金,15,10,5,亞東-新竹,2023-12-08,2184
4129,聯合,5,0,5,亞東-新竹,2023-12-08,2184
4904,遠傳,5,0,5,亞東-新竹,2023-12-08,2184
6196,帆宣,5,0,5,亞東-新竹,2023-12-08,2184
6558,興能高,15,10,5,亞東-新竹,2023-12-08,2184
00931B,統一美債20年,4,0,4,亞東-新竹,2023-12-08,2184
1909,榮成,4,0,4,亞東-新竹,2023-12-08,2184
2201,裕隆,6,2,4,亞東-新竹,2023-12-08,2184
2338,光罩,4,0,4,亞東-新竹,2023-12-08,2184
2344,華邦電,17,13,4,亞東-新竹,2023-12-08,2184
00688L,國泰20年美債正2,90,0,90,亞東-新竹,2023-12-11,2184
00933B,國泰10Y+金融債,80,0,80,亞東-新竹,2023-12-11,2184
2897,王道銀行,80,0,80,亞東-新竹,2023-12-11,2184
2888,新光金,65,10,55,亞東-新竹,2023-12-11,2184
6770,力積電,55,0,55,亞東-新竹,2023-12-11,2184
00679B,元大美債20年,54,0,54,亞東-新竹,2023-12-11,2184
00720B,元大投資級公司債,55,1,54,亞東-新竹,2023-12-11,2184
00751B,元大AAA至A公司債,51,0,51,亞東-新竹,2023-12-11,2184
2882,國泰金,42,0,42,亞東-新竹,2023-12-11,2184
00919,群益台灣精選高息,52,10,42,亞東-新竹,2023-12-11,2184
2002,中鋼,42,2,40,亞東-新竹,2023-12-11,2184
00937B,群益ESG投等債20,33,0,33,亞東-新竹,2023-12-11,2184
2883,凱基金,31,0,31,亞東-新竹,2023-12-11,2184
00918,大華優利高填息30,30,0,30,亞東-新竹,2023-12-11,2184
00687B,國泰20年美債,25,0,25,亞東-新竹,2023-12-11,2184
1611,中電,25,0,25,亞東-新竹,2023-12-11,2184
2353,宏��,25,0,25,亞東-新竹,2023-12-11,2184
4904,遠傳,24,0,24,亞東-新竹,2023-12-11,2184
00929,復華台灣科技優息,24,1,23,亞東-新竹,2023-12-11,2184
00878,國泰永續高股息,30,11,19,亞東-新竹,2023-12-11,2184
8354,冠好,35,17,18,亞東-新竹,2023-12-11,2184
2313,華通,23,6,17,亞東-新竹,2023-12-11,2184
9919,康那香,14,0,14,亞東-新竹,2023-12-11,2184
01001T,土銀富邦R1,12,0,12,亞東-新竹,2023-12-11,2184
2727,王品,12,0,12,亞東-新竹,2023-12-11,2184
00936,台新永續高息中小,10,0,10,亞東-新竹,2023-12-11,2184
00753L,中信中國50正2,10,0,10,亞東-新竹,2023-12-11,2184
8938,明安,10,0,10,亞東-新竹,2023-12-11,2184
2314,台揚,8,0,8,亞東-新竹,2023-12-11,2184
3025,星通,8,0,8,亞東-新竹,2023-12-11,2184
3715,定穎投控,16,8,8,亞東-新竹,2023-12-11,2184
5871,中租-KY,7,0,7,亞東-新竹,2023-12-11,2184
2618,長榮航,10,4,6,亞東-新竹,2023-12-11,2184
00772B,中信高評級公司債,6,0,6,亞東-新竹,2023-12-11,2184
00934,中信成長高股息,6,0,6,亞東-新竹,2023-12-11,2184
1615,大山,6,0,6,亞東-新竹,2023-12-11,2184
2329,華泰,32,26,6,亞東-新竹,2023-12-11,2184
3346,麗清,6,0,6,亞東-新竹,2023-12-11,2184
8463,潤泰材,6,0,6,亞東-新竹,2023-12-11,2184
1314,中石化,5,0,5,亞東-新竹,2023-12-11,2184
1402,遠東新,5,0,5,亞東-新竹,2023-12-11,2184
3712,永崴投控,5,0,5,亞東-新竹,2023-12-11,2184
4114,健喬,5,0,5,亞東-新竹,2023-12-11,2184
6116,彩晶,5,0,5,亞東-新竹,2023-12-11,2184
6547,高端疫苗,5,0,5,亞東-新竹,2023-12-11,2184
6558,興能高,5,0,5,亞東-新竹,2023-12-11,2184
6703,軒郁,5,0,5,亞東-新竹,2023-12-11,2184
8105,凌巨,5,0,5,亞東-新竹,2023-12-11,2184
3231,緯創,14,10,4,亞東-新竹,2023-12-11,2184
00882,中信中國高股息,4,0,4,亞東-新竹,2023-12-11,2184
2885,元大金,102,2,100,亞東-新竹,2023-12-12,2184
00935,野村臺灣新科技50,66,0,66,亞東-新竹,2023-12-12,2184
00687B,國泰20年美債,62,0,62,亞東-新竹,2023-12-12,2184
2882,國泰金,67,15,52,亞東-新竹,2023-12-12,2184
2374,佳能,50,0,50,亞東-新竹,2023-12-12,2184
1609,大亞,40,0,40,亞東-新竹,2023-12-12,2184
6005,群益證,40,0,40,亞東-新竹,2023-12-12,2184
2363,矽統,37,2,35,亞東-新竹,2023-12-12,2184
00918,大華優利高填息30,31,0,31,亞東-新竹,2023-12-12,2184
1524,耿鼎,30,1,29,亞東-新竹,2023-12-12,2184
4908,前鼎,28,0,28,亞東-新竹,2023-12-12,2184
00679B,元大美債20年,30,3,27,亞東-新竹,2023-12-12,2184
00919,群益台灣精選高息,29,7,22,亞東-新竹,2023-12-12,2184
2002,中鋼,22,2,20,亞東-新竹,2023-12-12,2184
1720,生達,17,0,17,亞東-新竹,2023-12-12,2184
1560,中砂,15,0,15,亞東-新竹,2023-12-12,2184
00937B,群益ESG投等債20,15,0,15,亞東-新竹,2023-12-12,2184
00931B,統一美債20年,13,0,13,亞東-新竹,2023-12-12,2184
3481,群創,13,0,13,亞東-新竹,2023-12-12,2184
1101,台泥,11,0,11,亞東-新竹,2023-12-12,2184
00720B,元大投資級公司債,11,0,11,亞東-新竹,2023-12-12,2184
6703,軒郁,11,0,11,亞東-新竹,2023-12-12,2184
3231,緯創,24,14,10,亞東-新竹,2023-12-12,2184
00921,兆豐龍頭等權重,10,0,10,亞東-新竹,2023-12-12,2184
1324,地球,10,0,10,亞東-新竹,2023-12-12,2184
2897,王道銀行,30,20,10,亞東-新竹,2023-12-12,2184
3557,嘉威,10,0,10,亞東-新竹,2023-12-12,2184
5531,鄉林,10,0,10,亞東-新竹,2023-12-12,2184
6799,來頡,10,0,10,亞東-新竹,2023-12-12,2184
8096,擎亞,18,8,10,亞東-新竹,2023-12-12,2184
1618,合機,10,1,9,亞東-新竹,2023-12-12,2184
2329,華泰,19,10,9,亞東-新竹,2023-12-12,2184
2468,華經,9,0,9,亞東-新竹,2023-12-12,2184
2401,凌陽,7,0,7,亞東-新竹,2023-12-12,2184
2402,毅嘉,7,0,7,亞東-新竹,2023-12-12,2184
2884,玉山金,7,0,7,亞東-新竹,2023-12-12,2184
1521,大億,8,2,6,亞東-新竹,2023-12-12,2184
3122,笙泉,6,0,6,亞東-新竹,2023-12-12,2184
3715,定穎投控,12,6,6,亞東-新竹,2023-12-12,2184
6248,沛波,6,0,6,亞東-新竹,2023-12-12,2184
00934,中信成長高股息,5,0,5,亞東-新竹,2023-12-12,2184
2618,長榮航,9,4,5,亞東-新竹,2023-12-12,2184
00712,復華富時不動產,5,0,5,亞東-新竹,2023-12-12,2184
2367,燿華,5,0,5,亞東-新竹,2023-12-12,2184
6257,矽格,5,0,5,亞東-新竹,2023-12-12,2184
6770,力積電,25,20,5,亞東-新竹,2023-12-12,2184
8105,凌巨,5,0,5,亞東-新竹,2023-12-12,2184
9921,巨大,5,0,5,亞東-新竹,2023-12-12,2184
9958,世紀鋼,5,0,5,亞東-新竹,2023-12-12,2184
2344,華邦電,4,0,4,亞東-新竹,2023-12-12,2184
2885,元大金,330,68,262,亞東-新竹,2023-12-13,2184
2882,國泰金,123,0,123,亞東-新竹,2023-12-13,2184
00751B,元大AAA至A公司債,120,0,120,亞東-新竹,2023-12-13,2184
00720B,元大投資級公司債,105,0,105,亞東-新竹,2023-12-13,2184
00919,群益台灣精選高息,86,5,81,亞東-新竹,2023-12-13,2184
00887,永豐中國科技50大,65,0,65,亞東-新竹,2023-12-13,2184
00687B,國泰20年美債,47,0,47,亞東-新竹,2023-12-13,2184
00931B,統一美債20年,36,0,36,亞東-新竹,2023-12-13,2184
00715L,期街口布蘭特正2,40,10,30,亞東-新竹,2023-12-13,2184
00918,大華優利高填息30,22,0,22,亞東-新竹,2023-12-13,2184
2330,台積電,23,2,21,亞東-新竹,2023-12-13,2184
2801,彰銀,20,0,20,亞東-新竹,2023-12-13,2184
3504,揚明光,20,0,20,亞東-新竹,2023-12-13,2184
6005,群益證,20,0,20,亞東-新竹,2023-12-13,2184
1101,台泥,17,0,17,亞東-新竹,2023-12-13,2184
2201,裕隆,17,0,17,亞東-新竹,2023-12-13,2184
2883,凱基金,16,0,16,亞東-新竹,2023-12-13,2184
00933B,國泰10Y+金融債,13,0,13,亞東-新竹,2023-12-13,2184
1584,精剛,12,0,12,亞東-新竹,2023-12-13,2184
1618,合機,20,10,10,亞東-新竹,2023-12-13,2184
1909,榮成,10,0,10,亞東-新竹,2023-12-13,2184
2812,台中銀,10,0,10,亞東-新竹,2023-12-13,2184
2606,裕民,11,1,10,亞東-新竹,2023-12-13,2184
2520,冠德,11,2,9,亞東-新竹,2023-12-13,2184
3311,閎暉,9,0,9,亞東-新竹,2023-12-13,2184
6138,茂達,11,3,8,亞東-新竹,2023-12-13,2184
3035,智原,18,10,8,亞東-新竹,2023-12-13,2184
3362,先進光,8,0,8,亞東-新竹,2023-12-13,2184
3419,譁裕,8,0,8,亞東-新竹,2023-12-13,2184
2002,中鋼,10,4,6,亞東-新竹,2023-12-13,2184
00934,中信成長高股息,6,0,6,亞東-新竹,2023-12-13,2184
2303,聯電,14,8,6,亞東-新竹,2023-12-13,2184
2427,三商電,6,0,6,亞東-新竹,2023-12-13,2184
6248,沛波,6,0,6,亞東-新竹,2023-12-13,2184
6516,勤崴國際,6,0,6,亞東-新竹,2023-12-13,2184
3705,永信,6,0,6,亞東-新竹,2023-12-13,2184
00921,兆豐龍頭等權重,5,0,5,亞東-新竹,2023-12-13,2184
4105,東洋,5,0,5,亞東-新竹,2023-12-13,2184
5386,青雲,6,1,5,亞東-新竹,2023-12-13,2184
5864,致和證,5,0,5,亞東-新竹,2023-12-13,2184
8105,凌巨,5,0,5,亞東-新竹,2023-12-13,2184
9904,寶成,5,0,5,亞東-新竹,2023-12-13,2184
4906,正文,16,12,4,亞東-新竹,2023-12-13,2184
00753L,中信中國50正2,4,0,4,亞東-新竹,2023-12-13,2184
00633L,富邦上証正2,4,0,4,亞東-新竹,2023-12-13,2184
2388,威盛,5,1,4,亞東-新竹,2023-12-13,2184
2915,潤泰全,4,0,4,亞東-新竹,2023-12-13,2184
4909,新復興,4,0,4,亞東-新竹,2023-12-13,2184
2353,宏��,4,0,4,亞東-新竹,2023-12-13,2184
2618,長榮航,11,8,3,亞東-新竹,2023-12-13,2184
00680L,元大美債20正2,685,0,685,亞東-新竹,2023-12-14,2184
2897,王道銀行,343,0,343,亞東-新竹,2023-12-14,2184
00688L,國泰20年美債正2,204,0,204,亞東-新竹,2023-12-14,2184
0056,元大高股息,81,28,53,亞東-新竹,2023-12-14,2184
2317,鴻海,50,0,50,亞東-新竹,2023-12-14,2184
2371,大同,40,0,40,亞東-新竹,2023-12-14,2184
00687B,國泰20年美債,34,0,34,亞東-新竹,2023-12-14,2184
2520,冠德,31,4,27,亞東-新竹,2023-12-14,2184
00933B,國泰10Y+金融債,24,0,24,亞東-新竹,2023-12-14,2184
3231,緯創,62,38,24,亞東-新竹,2023-12-14,2184
2365,昆盈,23,0,23,亞東-新竹,2023-12-14,2184
6015,宏遠證,23,0,23,亞東-新竹,2023-12-14,2184
2329,華泰,41,19,22,亞東-新竹,2023-12-14,2184
00632R,元大台灣50反1,20,0,20,亞東-新竹,2023-12-14,2184
00795B,中信美國公債20年,20,0,20,亞東-新竹,2023-12-14,2184
8110,華東,18,0,18,亞東-新竹,2023-12-14,2184
3715,定穎投控,18,2,16,亞東-新竹,2023-12-14,2184
9958,世紀鋼,18,5,13,亞東-新竹,2023-12-14,2184
00931B,統一美債20年,13,0,13,亞東-新竹,2023-12-14,2184
9919,康那香,15,2,13,亞東-新竹,2023-12-14,2184
00720B,元大投資級公司債,13,2,11,亞東-新竹,2023-12-14,2184
3705,永信,12,1,11,亞東-新竹,2023-12-14,2184
2409,友達,31,20,11,亞東-新竹,2023-12-14,2184
00936,台新永續高息中小,10,0,10,亞東-新竹,2023-12-14,2184
00935,野村臺灣新科技50,10,0,10,亞東-新竹,2023-12-14,2184
2801,彰銀,10,0,10,亞東-新竹,2023-12-14,2184
2834,臺企銀,10,0,10,亞東-新竹,2023-12-14,2184
8105,凌巨,10,0,10,亞東-新竹,2023-12-14,2184
2427,三商電,9,0,9,亞東-新竹,2023-12-14,2184
00918,大華優利高填息30,8,0,8,亞東-新竹,2023-12-14,2184
2606,裕民,7,0,7,亞東-新竹,2023-12-14,2184
00891,中信關鍵半導體,14,7,7,亞東-新竹,2023-12-14,2184
2387,精元,7,0,7,亞東-新竹,2023-12-14,2184
5388,中磊,12,5,7,亞東-新竹,2023-12-14,2184
00915,凱基優選高股息30,6,0,6,亞東-新竹,2023-12-14,2184
00934,中信成長高股息,6,0,6,亞東-新竹,2023-12-14,2184
00670L,富邦NASDAQ正2,6,0,6,亞東-新竹,2023-12-14,2184
00637L,元大滬深300正2,6,0,6,亞東-新竹,2023-12-14,2184
00696B,富邦美債20年,6,0,6,亞東-新竹,2023-12-14,2184
2425,承啟,9,3,6,亞東-新竹,2023-12-14,2184
00772B,中信高評級公司債,5,0,5,亞東-新竹,2023-12-14,2184
1618,合機,15,10,5,亞東-新竹,2023-12-14,2184
2023,燁輝,5,0,5,亞東-新竹,2023-12-14,2184
2065,世豐,5,0,5,亞東-新竹,2023-12-14,2184
2327,國巨,5,0,5,亞東-新竹,2023-12-14,2184
2464,盟立,5,0,5,亞東-新竹,2023-12-14,2184
3051,力特,16,11,5,亞東-新竹,2023-12-14,2184
3704,合勤控,7,2,5,亞東-新竹,2023-12-14,2184
5272,笙科,6,1,5,亞東-新竹,2023-12-14,2184
5498,凱崴,10,5,5,亞東-新竹,2023-12-14,2184
00720B,元大投資級公司債,215,27,188,亞東-新竹,2023-12-15,2184
2344,華邦電,169,27,142,亞東-新竹,2023-12-15,2184
00929,復華台灣科技優息,99,1,98,亞東-新竹,2023-12-15,2184
00712,復華富時不動產,100,8,92,亞東-新竹,2023-12-15,2184
00680L,元大美債20正2,92,0,92,亞東-新竹,2023-12-15,2184
00919,群益台灣精選高息,101,47,54,亞東-新竹,2023-12-15,2184
2887,台新金,52,0,52,亞東-新竹,2023-12-15,2184
00632R,元大台灣50反1,50,0,50,亞東-新竹,2023-12-15,2184
00751B,元大AAA至A公司債,50,1,49,亞東-新竹,2023-12-15,2184
6248,沛波,36,6,30,亞東-新竹,2023-12-15,2184
00687B,國泰20年美債,31,3,28,亞東-新竹,2023-12-15,2184
0056,元大高股息,36,9,27,亞東-新竹,2023-12-15,2184
3231,緯創,27,6,21,亞東-新竹,2023-12-15,2184
2329,華泰,37,17,20,亞東-新竹,2023-12-15,2184
2801,彰銀,20,0,20,亞東-新竹,2023-12-15,2184
00878,國泰永續高股息,51,32,19,亞東-新竹,2023-12-15,2184
3035,智原,21,3,18,亞東-新竹,2023-12-15,2184
2903,遠百,20,4,16,亞東-新竹,2023-12-15,2184
00795B,中信美國公債20年,16,1,15,亞東-新竹,2023-12-15,2184
1584,精剛,26,12,14,亞東-新竹,2023-12-15,2184
1504,東元,27,13,14,亞東-新竹,2023-12-15,2184
00679B,元大美債20年,11,0,11,亞東-新竹,2023-12-15,2184
00931B,統一美債20年,21,10,11,亞東-新竹,2023-12-15,2184
2618,長榮航,11,0,11,亞東-新竹,2023-12-15,2184
3041,揚智,14,3,11,亞東-新竹,2023-12-15,2184
1708,東鹼,10,0,10,亞東-新竹,2023-12-15,2184
2388,威盛,13,3,10,亞東-新竹,2023-12-15,2184
2027,大成鋼,12,2,10,亞東-新竹,2023-12-15,2184
2884,玉山金,15,6,9,亞東-新竹,2023-12-15,2184
5009,榮剛,10,1,9,亞東-新竹,2023-12-15,2184
6462,神盾,9,0,9,亞東-新竹,2023-12-15,2184
9919,康那香,9,0,9,亞東-新竹,2023-12-15,2184
2363,矽統,72,65,7,亞東-新竹,2023-12-15,2184
00915,凱基優選高股息30,7,0,7,亞東-新竹,2023-12-15,2184
00670L,富邦NASDAQ正2,6,0,6,亞東-新竹,2023-12-15,2184
1514,亞力,7,1,6,亞東-新竹,2023-12-15,2184
1519,華城,18,12,6,亞東-新竹,2023-12-15,2184
6182,合晶,7,1,6,亞東-新竹,2023-12-15,2184
9958,世紀鋼,7,2,5,亞東-新竹,2023-12-15,2184
1402,遠東新,5,0,5,亞東-新竹,2023-12-15,2184
00885,富邦越南,5,0,5,亞東-新竹,2023-12-15,2184
2201,裕隆,5,0,5,亞東-新竹,2023-12-15,2184
2727,王品,5,0,5,亞東-新竹,2023-12-15,2184
3047,訊舟,5,0,5,亞東-新竹,2023-12-15,2184
5014,建錩,5,0,5,亞東-新竹,2023-12-15,2184
6196,帆宣,5,0,5,亞東-新竹,2023-12-15,2184
6805,富世達,5,0,5,亞東-新竹,2023-12-15,2184
8105,凌巨,5,0,5,亞東-新竹,2023-12-15,2184
5425,台半,9,4,5,亞東-新竹,2023-12-15,2184
2606,裕民,5,1,4,亞東-新竹,2023-12-15,2184
00680L,元大美債20正2,1304,40,1264,亞東-新竹,2023-12-18,2184
2303,聯電,202,6,196,亞東-新竹,2023-12-18,2184
00919,群益台灣精選高息,179,19,160,亞東-新竹,2023-12-18,2184
00720B,元大投資級公司債,67,15,52,亞東-新竹,2023-12-18,2184
00929,復華台灣科技優息,117,65,52,亞東-新竹,2023-12-18,2184
00688L,國泰20年美債正2,335,300,35,亞東-新竹,2023-12-18,2184
00931B,統一美債20年,40,8,32,亞東-新竹,2023-12-18,2184
5324,士開,28,0,28,亞東-新竹,2023-12-18,2184
1785,光洋科,30,5,25,亞東-新竹,2023-12-18,2184
2610,華航,22,0,22,亞東-新竹,2023-12-18,2184
2887,台新金,20,0,20,亞東-新竹,2023-12-18,2184
2201,裕隆,16,0,16,亞東-新竹,2023-12-18,2184
00937B,群益ESG投等債20,21,6,15,亞東-新竹,2023-12-18,2184
2449,京元電子,13,0,13,亞東-新竹,2023-12-18,2184
00857B,永豐20年美公債,12,0,12,亞東-新竹,2023-12-18,2184
00915,凱基優選高股息30,12,0,12,亞東-新竹,2023-12-18,2184
00878,國泰永續高股息,11,0,11,亞東-新竹,2023-12-18,2184
2427,三商電,11,0,11,亞東-新竹,2023-12-18,2184
6138,茂達,11,0,11,亞東-新竹,2023-12-18,2184
2609,陽明,13,3,10,亞東-新竹,2023-12-18,2184
00679B,元大美債20年,14,4,10,亞東-新竹,2023-12-18,2184
2014,中鴻,10,0,10,亞東-新竹,2023-12-18,2184
2369,菱生,10,0,10,亞東-新竹,2023-12-18,2184
2801,彰銀,10,0,10,亞東-新竹,2023-12-18,2184
6015,宏遠證,10,0,10,亞東-新竹,2023-12-18,2184
2363,矽統,22,13,9,亞東-新竹,2023-12-18,2184
00918,大華優利高填息30,8,0,8,亞東-新竹,2023-12-18,2184
00795B,中信美國公債20年,10,2,8,亞東-新竹,2023-12-18,2184
2637,慧洋-KY,9,1,8,亞東-新竹,2023-12-18,2184
5608,四維航,7,0,7,亞東-新竹,2023-12-18,2184
6274,台燿,6,0,6,亞東-新竹,2023-12-18,2184
1905,華紙,8,2,6,亞東-新竹,2023-12-18,2184
2032,新鋼,6,0,6,亞東-新竹,2023-12-18,2184
2101,南港,6,0,6,亞東-新竹,2023-12-18,2184
5351,鈺創,9,3,6,亞東-新竹,2023-12-18,2184
2607,榮運,6,0,6,亞東-新竹,2023-12-18,2184
2882,國泰金,5,0,5,亞東-新竹,2023-12-18,2184
1504,東元,5,0,5,亞東-新竹,2023-12-18,2184
2023,燁輝,5,0,5,亞東-新竹,2023-12-18,2184
2062,橋椿,5,0,5,亞東-新竹,2023-12-18,2184
2352,佳世達,5,0,5,亞東-新竹,2023-12-18,2184
2883,凱基金,5,0,5,亞東-新竹,2023-12-18,2184
3706,神達,5,0,5,亞東-新竹,2023-12-18,2184
8105,凌巨,5,0,5,亞東-新竹,2023-12-18,2184
00885,富邦越南,4,0,4,亞東-新竹,2023-12-18,2184
2401,凌陽,4,0,4,亞東-新竹,2023-12-18,2184
3466,德晉,6,2,4,亞東-新竹,2023-12-18,2184
4128,中天,4,0,4,亞東-新竹,2023-12-18,2184
5425,台半,4,0,4,亞東-新竹,2023-12-18,2184
6703,軒郁,4,0,4,亞東-新竹,2023-12-18,2184
00688L,國泰20年美債正2,190,100,90,亞東-新竹,2023-12-19,2184
00919,群益台灣精選高息,97,19,78,亞東-新竹,2023-12-19,2184
2409,友達,83,10,73,亞東-新竹,2023-12-19,2184
6770,力積電,71,0,71,亞東-新竹,2023-12-19,2184
2610,華航,62,0,62,亞東-新竹,2023-12-19,2184
00679B,元大美債20年,56,6,50,亞東-新竹,2023-12-19,2184
00720B,元大投資級公司債,52,9,43,亞東-新竹,2023-12-19,2184
00929,復華台灣科技優息,102,61,41,亞東-新竹,2023-12-19,2184
00937B,群益ESG投等債20,33,0,33,亞東-新竹,2023-12-19,2184
3231,緯創,38,6,32,亞東-新竹,2023-12-19,2184
00751B,元大AAA至A公司債,31,1,30,亞東-新竹,2023-12-19,2184
2882,國泰金,46,20,26,亞東-新竹,2023-12-19,2184
2365,昆盈,20,0,20,亞東-新竹,2023-12-19,2184
9919,康那香,18,0,18,亞東-新竹,2023-12-19,2184
00680L,元大美債20正2,13,0,13,亞東-新竹,2023-12-19,2184
00885,富邦越南,11,0,11,亞東-新竹,2023-12-19,2184
2412,中華電,11,0,11,亞東-新竹,2023-12-19,2184
6015,宏遠證,11,0,11,亞東-新竹,2023-12-19,2184
1216,統一,10,0,10,亞東-新竹,2023-12-19,2184
1785,光洋科,10,0,10,亞東-新竹,2023-12-19,2184
2356,英業達,20,10,10,亞東-新竹,2023-12-19,2184
2462,良得電,10,0,10,亞東-新竹,2023-12-19,2184
3051,力特,10,0,10,亞東-新竹,2023-12-19,2184
6443,元晶,10,0,10,亞東-新竹,2023-12-19,2184
2338,光罩,9,0,9,亞東-新竹,2023-12-19,2184
3481,群創,11,2,9,亞東-新竹,2023-12-19,2184
1324,地球,8,0,8,亞東-新竹,2023-12-19,2184
00931B,統一美債20年,12,4,8,亞東-新竹,2023-12-19,2184
1720,生達,8,0,8,亞東-新竹,2023-12-19,2184
2324,仁寶,8,0,8,亞東-新竹,2023-12-19,2184
3034,聯詠,8,0,8,亞東-新竹,2023-12-19,2184
2303,聯電,16,9,7,亞東-新竹,2023-12-19,2184
1513,中興電,8,1,7,亞東-新竹,2023-12-19,2184
3206,志豐,7,0,7,亞東-新竹,2023-12-19,2184
4432,銘旺實,10,3,7,亞東-新竹,2023-12-19,2184
6223,旺矽,7,0,7,亞東-新竹,2023-12-19,2184
6274,台燿,7,0,7,亞東-新竹,2023-12-19,2184
3006,晶豪科,7,1,6,亞東-新竹,2023-12-19,2184
2023,燁輝,6,0,6,亞東-新竹,2023-12-19,2184
5457,宣德,6,0,6,亞東-新竹,2023-12-19,2184
00891,中信關鍵半導體,5,0,5,亞東-新竹,2023-12-19,2184
00882,中信中國高股息,5,0,5,亞東-新竹,2023-12-19,2184
1326,台化,5,0,5,亞東-新竹,2023-12-19,2184
2605,新興,5,0,5,亞東-新竹,2023-12-19,2184
2606,裕民,5,0,5,亞東-新竹,2023-12-19,2184
2883,凱基金,5,0,5,亞東-新竹,2023-12-19,2184
3714,富采,5,0,5,亞東-新竹,2023-12-19,2184
6257,矽格,6,1,5,亞東-新竹,2023-12-19,2184
8105,凌巨,5,0,5,亞東-新竹,2023-12-19,2184
1102,亞泥,4,0,4,亞東-新竹,2023-12-19,2184
2317,鴻海,100,3,97,亞東-新竹,2023-12-20,2184
00929,復華台灣科技優息,76,1,75,亞東-新竹,2023-12-20,2184
00751B,元大AAA至A公司債,51,0,51,亞東-新竹,2023-12-20,2184
00636,國泰中國A50,50,0,50,亞東-新竹,2023-12-20,2184
2885,元大金,50,0,50,亞東-新竹,2023-12-20,2184
00679B,元大美債20年,52,4,48,亞東-新竹,2023-12-20,2184
00919,群益台灣精選高息,41,0,41,亞東-新竹,2023-12-20,2184
1616,億泰,32,0,32,亞東-新竹,2023-12-20,2184
00715L,期街口布蘭特正2,25,0,25,亞東-新竹,2023-12-20,2184
8105,凌巨,25,0,25,亞東-新竹,2023-12-20,2184
0056,元大高股息,24,0,24,亞東-新竹,2023-12-20,2184
2891,中信金,143,120,23,亞東-新竹,2023-12-20,2184
2382,廣達,25,4,21,亞東-新竹,2023-12-20,2184
00937B,群益ESG投等債20,17,0,17,亞東-新竹,2023-12-20,2184
2892,第一金,16,0,16,亞東-新竹,2023-12-20,2184
9919,康那香,16,0,16,亞東-新竹,2023-12-20,2184
1324,地球,15,0,15,亞東-新竹,2023-12-20,2184
6015,宏遠證,12,0,12,亞東-新竹,2023-12-20,2184
2324,仁寶,42,31,11,亞東-新竹,2023-12-20,2184
00687B,國泰20年美債,11,0,11,亞東-新竹,2023-12-20,2184
1522,堤維西,10,0,10,亞東-新竹,2023-12-20,2184
2029,盛餘,10,0,10,亞東-新竹,2023-12-20,2184
3131,弘塑,10,0,10,亞東-新竹,2023-12-20,2184
2520,冠德,10,1,9,亞東-新竹,2023-12-20,2184
2303,聯電,14,6,8,亞東-新竹,2023-12-20,2184
1909,榮成,7,0,7,亞東-新竹,2023-12-20,2184
3035,智原,7,1,6,亞東-新竹,2023-12-20,2184
2731,雄獅,5,0,5,亞東-新竹,2023-12-20,2184
2887,台新金,5,0,5,亞東-新竹,2023-12-20,2184
3051,力特,6,1,5,亞東-新竹,2023-12-20,2184
3306,鼎天,5,0,5,亞東-新竹,2023-12-20,2184
8112,至上,5,0,5,亞東-新竹,2023-12-20,2184
0061,元大寶滬深,4,0,4,亞東-新竹,2023-12-20,2184
1326,台化,4,0,4,亞東-新竹,2023-12-20,2184
1582,信錦,4,0,4,亞東-新竹,2023-12-20,2184
2002,中鋼,5,1,4,亞東-新竹,2023-12-20,2184
2886,兆豐金,4,0,4,亞東-新竹,2023-12-20,2184
5425,台半,6,2,4,亞東-新竹,2023-12-20,2184
6223,旺矽,4,0,4,亞東-新竹,2023-12-20,2184
8034,榮群,4,0,4,亞東-新竹,2023-12-20,2184
3706,神達,15,11,4,亞東-新竹,2023-12-20,2184
3264,欣銓,3,0,3,亞東-新竹,2023-12-20,2184
2606,裕民,3,0,3,亞東-新竹,2023-12-20,2184
1504,東元,3,0,3,亞東-新竹,2023-12-20,2184
1319,東陽,3,0,3,亞東-新竹,2023-12-20,2184
00927,群益半導體收益,3,0,3,亞東-新竹,2023-12-20,2184
00680L,元大美債20正2,3,0,3,亞東-新竹,2023-12-20,2184
00720B,元大投資級公司債,3,0,3,亞東-新竹,2023-12-20,2184
00772B,中信高評級公司債,3,0,3,亞東-新竹,2023-12-20,2184
00934,中信成長高股息,3,0,3,亞東-新竹,2023-12-20,2184
00680L,元大美債20正2,144,0,144,亞東-新竹,2023-12-21,2184
00919,群益台灣精選高息,88,0,88,亞東-新竹,2023-12-21,2184
00929,復華台灣科技優息,75,0,75,亞東-新竹,2023-12-21,2184
2882,國泰金,57,0,57,亞東-新竹,2023-12-21,2184
2313,華通,60,6,54,亞東-新竹,2023-12-21,2184
6138,茂達,43,1,42,亞東-新竹,2023-12-21,2184
2412,中華電,37,0,37,亞東-新竹,2023-12-21,2184
2324,仁寶,45,14,31,亞東-新竹,2023-12-21,2184
2323,中環,62,32,30,亞東-新竹,2023-12-21,2184
2881,富邦金,25,0,25,亞東-新竹,2023-12-21,2184
9934,成霖,22,0,22,亞東-新竹,2023-12-21,2184
1616,億泰,20,0,20,亞東-新竹,2023-12-21,2184
00688L,國泰20年美債正2,270,250,20,亞東-新竹,2023-12-21,2184
3481,群創,23,3,20,亞東-新竹,2023-12-21,2184
00712,復華富時不動產,16,0,16,亞東-新竹,2023-12-21,2184
2303,聯電,23,8,15,亞東-新竹,2023-12-21,2184
0056,元大高股息,11,0,11,亞東-新竹,2023-12-21,2184
00888,永豐台灣ESG,10,0,10,亞東-新竹,2023-12-21,2184
00937B,群益ESG投等債20,9,0,9,亞東-新竹,2023-12-21,2184
2330,台積電,14,6,8,亞東-新竹,2023-12-21,2184
00670L,富邦NASDAQ正2,8,0,8,亞東-新竹,2023-12-21,2184
2201,裕隆,10,2,8,亞東-新竹,2023-12-21,2184
3083,網龍,7,0,7,亞東-新竹,2023-12-21,2184
6285,啟��,7,1,6,亞東-新竹,2023-12-21,2184
00830,國泰費城半導體,6,0,6,亞東-新竹,2023-12-21,2184
00720B,元大投資級公司債,6,0,6,亞東-新竹,2023-12-21,2184
2449,京元電子,6,0,6,亞東-新竹,2023-12-21,2184
3260,威剛,6,0,6,亞東-新竹,2023-12-21,2184
6443,元晶,6,0,6,亞東-新竹,2023-12-21,2184
3034,聯詠,6,1,5,亞東-新竹,2023-12-21,2184
1325,恆大,6,1,5,亞東-新竹,2023-12-21,2184
2329,華泰,21,16,5,亞東-新竹,2023-12-21,2184
00687B,國泰20年美債,4,0,4,亞東-新竹,2023-12-21,2184
2371,大同,4,0,4,亞東-新竹,2023-12-21,2184
2636,台驊控股,6,2,4,亞東-新竹,2023-12-21,2184
2727,王品,4,0,4,亞東-新竹,2023-12-21,2184
2884,玉山金,4,0,4,亞東-新竹,2023-12-21,2184
2886,兆豐金,4,0,4,亞東-新竹,2023-12-21,2184
3035,智原,4,0,4,亞東-新竹,2023-12-21,2184
3264,欣銓,3,0,3,亞東-新竹,2023-12-21,2184
00751B,元大AAA至A公司債,3,0,3,亞東-新竹,2023-12-21,2184
00795B,中信美國公債20年,3,0,3,亞東-新竹,2023-12-21,2184
2338,光罩,3,0,3,亞東-新竹,2023-12-21,2184
2883,凱基金,3,0,3,亞東-新竹,2023-12-21,2184
3045,台灣大,3,0,3,亞東-新竹,2023-12-21,2184
3704,合勤控,4,1,3,亞東-新竹,2023-12-21,2184
4968,立積,3,0,3,亞東-新竹,2023-12-21,2184
2408,南亞科,7,4,3,亞東-新竹,2023-12-21,2184
00891,中信關鍵半導體,4,1,3,亞東-新竹,2023-12-21,2184
2211,長榮鋼,2,0,2,亞東-新竹,2023-12-21,2184
2603,長榮,263,3,260,亞東-新竹,2023-12-22,2184
00720B,元大投資級公司債,128,18,110,亞東-新竹,2023-12-22,2184
2204,中華,100,0,100,亞東-新竹,2023-12-22,2184
2845,遠東銀,100,5,95,亞東-新竹,2023-12-22,2184
00679B,元大美債20年,63,0,63,亞東-新竹,2023-12-22,2184
2611,志信,49,0,49,亞東-新竹,2023-12-22,2184
2313,華通,40,0,40,亞東-新竹,2023-12-22,2184
2515,中工,50,10,40,亞東-新竹,2023-12-22,2184
2376,技嘉,26,0,26,亞東-新竹,2023-12-22,2184
0056,元大高股息,33,10,23,亞東-新竹,2023-12-22,2184
00878,國泰永續高股息,22,0,22,亞東-新竹,2023-12-22,2184
2382,廣達,23,1,22,亞東-新竹,2023-12-22,2184
2618,長榮航,33,11,22,亞東-新竹,2023-12-22,2184
2323,中環,20,0,20,亞東-新竹,2023-12-22,2184
4157,太景*-KY,20,0,20,亞東-新竹,2023-12-22,2184
2324,仁寶,25,10,15,亞東-新竹,2023-12-22,2184
2201,裕隆,28,14,14,亞東-新竹,2023-12-22,2184
9934,成霖,14,0,14,亞東-新竹,2023-12-22,2184
2886,兆豐金,12,0,12,亞東-新竹,2023-12-22,2184
2727,王品,12,0,12,亞東-新竹,2023-12-22,2184
3704,合勤控,11,0,11,亞東-新竹,2023-12-22,2184
2356,英業達,40,30,10,亞東-新竹,2023-12-22,2184
3013,晟銘電,10,0,10,亞東-新竹,2023-12-22,2184
1326,台化,9,0,9,亞東-新竹,2023-12-22,2184
00919,群益台灣精選高息,8,0,8,亞東-新竹,2023-12-22,2184
00918,大華優利高填息30,8,0,8,亞東-新竹,2023-12-22,2184
3287,廣寰科,8,0,8,亞東-新竹,2023-12-22,2184
1314,中石化,7,0,7,亞東-新竹,2023-12-22,2184
3609,三一東林,10,3,7,亞東-新竹,2023-12-22,2184
8105,凌巨,7,0,7,亞東-新竹,2023-12-22,2184
00692,富邦公司治理,7,1,6,亞東-新竹,2023-12-22,2184
00937B,群益ESG投等債20,6,0,6,亞東-新竹,2023-12-22,2184
00931B,統一美債20年,10,4,6,亞東-新竹,2023-12-22,2184
1785,光洋科,5,0,5,亞東-新竹,2023-12-22,2184
2388,威盛,7,2,5,亞東-新竹,2023-12-22,2184
6703,軒郁,5,0,5,亞東-新竹,2023-12-22,2184
00753L,中信中國50正2,4,0,4,亞東-新竹,2023-12-22,2184
1805,寶徠,5,1,4,亞東-新竹,2023-12-22,2184
2412,中華電,4,0,4,亞東-新竹,2023-12-22,2184
2427,三商電,6,2,4,亞東-新竹,2023-12-22,2184
2617,台航,12,8,4,亞東-新竹,2023-12-22,2184
2890,永豐金,4,0,4,亞東-新竹,2023-12-22,2184
3037,欣興,4,0,4,亞東-新竹,2023-12-22,2184
4102,永日,4,0,4,亞東-新竹,2023-12-22,2184
6443,元晶,4,0,4,亞東-新竹,2023-12-22,2184
2637,慧洋-KY,3,0,3,亞東-新竹,2023-12-22,2184
00929,復華台灣科技優息,3,0,3,亞東-新竹,2023-12-22,2184
1532,勤美,3,0,3,亞東-新竹,2023-12-22,2184
1709,和益,3,0,3,亞東-新竹,2023-12-22,2184
2855,統一證,3,0,3,亞東-新竹,2023-12-22,2184
2609,陽明,228,28,200,亞東-新竹,2023-12-25,2184
00680L,元大美債20正2,194,0,194,亞東-新竹,2023-12-25,2184
2882,國泰金,142,0,142,亞東-新竹,2023-12-25,2184
00720B,元大投資級公司債,101,0,101,亞東-新竹,2023-12-25,2184
00882,中信中國高股息,60,0,60,亞東-新竹,2023-12-25,2184
00679B,元大美債20年,59,0,59,亞東-新竹,2023-12-25,2184
00919,群益台灣精選高息,57,0,57,亞東-新竹,2023-12-25,2184
2353,宏��,59,9,50,亞東-新竹,2023-12-25,2184
2885,元大金,50,15,35,亞東-新竹,2023-12-25,2184
2324,仁寶,60,29,31,亞東-新竹,2023-12-25,2184
2883,凱基金,28,0,28,亞東-新竹,2023-12-25,2184
6138,茂達,24,0,24,亞東-新竹,2023-12-25,2184
2520,冠德,14,0,14,亞東-新竹,2023-12-25,2184
00929,復華台灣科技優息,12,0,12,亞東-新竹,2023-12-25,2184
00937B,群益ESG投等債20,11,0,11,亞東-新竹,2023-12-25,2184
00712,復華富時不動產,10,0,10,亞東-新竹,2023-12-25,2184
00676R,富邦臺灣加權反1,10,0,10,亞東-新竹,2023-12-25,2184
2617,台航,10,0,10,亞東-新竹,2023-12-25,2184
00918,大華優利高填息30,9,0,9,亞東-新竹,2023-12-25,2184
1514,亞力,9,0,9,亞東-新竹,2023-12-25,2184
2603,長榮,15,7,8,亞東-新竹,2023-12-25,2184
1612,宏泰,8,0,8,亞東-新竹,2023-12-25,2184
5531,鄉林,8,0,8,亞東-新竹,2023-12-25,2184
00923,群益台ESG低碳50,7,0,7,亞東-新竹,2023-12-25,2184
3715,定穎投控,19,12,7,亞東-新竹,2023-12-25,2184
6443,元晶,7,0,7,亞東-新竹,2023-12-25,2184
00687B,國泰20年美債,6,0,6,亞東-新竹,2023-12-25,2184
3380,明泰,6,0,6,亞東-新竹,2023-12-25,2184
5202,力新,6,0,6,亞東-新竹,2023-12-25,2184
3264,欣銓,5,0,5,亞東-新竹,2023-12-25,2184
2441,超豐,5,0,5,亞東-新竹,2023-12-25,2184
2887,台新金,5,0,5,亞東-新竹,2023-12-25,2184
3051,力特,5,0,5,亞東-新竹,2023-12-25,2184
6139,亞翔,6,1,5,亞東-新竹,2023-12-25,2184
00772B,中信高評級公司債,5,1,4,亞東-新竹,2023-12-25,2184
00891,中信關鍵半導體,4,0,4,亞東-新竹,2023-12-25,2184
1762,中化生,4,0,4,亞東-新竹,2023-12-25,2184
2313,華通,4,0,4,亞東-新竹,2023-12-25,2184
2387,精元,4,0,4,亞東-新竹,2023-12-25,2184
3025,星通,4,0,4,亞東-新竹,2023-12-25,2184
3346,麗清,5,1,4,亞東-新竹,2023-12-25,2184
3622,洋華,4,0,4,亞東-新竹,2023-12-25,2184
6237,驊訊,4,0,4,亞東-新竹,2023-12-25,2184
1304,台聚,3,0,3,亞東-新竹,2023-12-25,2184
2338,光罩,3,0,3,亞東-新竹,2023-12-25,2184
5371,中光電,3,0,3,亞東-新竹,2023-12-25,2184
6168,宏齊,3,0,3,亞東-新竹,2023-12-25,2184
2618,長榮航,7,4,3,亞東-新竹,2023-12-25,2184
2357,華碩,3,0,3,亞東-新竹,2023-12-25,2184
00713,元大台灣高息低波,2,0,2,亞東-新竹,2023-12-25,2184
00680L,元大美債20正2,130,0,130,亞東-新竹,2023-12-26,2184
2027,大成鋼,130,0,130,亞東-新竹,2023-12-26,2184
00720B,元大投資級公司債,107,10,97,亞東-新竹,2023-12-26,2184
2897,王道銀行,80,0,80,亞東-新竹,2023-12-26,2184
2885,元大金,106,41,65,亞東-新竹,2023-12-26,2184
3037,欣興,53,0,53,亞東-新竹,2023-12-26,2184
00915,凱基優選高股息30,50,0,50,亞東-新竹,2023-12-26,2184
2442,新美齊,40,0,40,亞東-新竹,2023-12-26,2184
8114,振樺電,40,0,40,亞東-新竹,2023-12-26,2184
00936,台新永續高息中小,32,1,31,亞東-新竹,2023-12-26,2184
00934,中信成長高股息,28,0,28,亞東-新竹,2023-12-26,2184
00931B,統一美債20年,24,0,24,亞東-新竹,2023-12-26,2184
3704,合勤控,15,0,15,亞東-新竹,2023-12-26,2184
00687B,國泰20年美債,14,0,14,亞東-新竹,2023-12-26,2184
6257,矽格,14,0,14,亞東-新竹,2023-12-26,2184
1324,地球,11,0,11,亞東-新竹,2023-12-26,2184
2634,漢翔,10,0,10,亞東-新竹,2023-12-26,2184
2115,六暉-KY,10,0,10,亞東-新竹,2023-12-26,2184
2201,裕隆,10,0,10,亞東-新竹,2023-12-26,2184
9934,成霖,12,2,10,亞東-新竹,2023-12-26,2184
2618,長榮航,7,1,6,亞東-新竹,2023-12-26,2184
00679B,元大美債20年,6,0,6,亞東-新竹,2023-12-26,2184
6243,迅杰,7,1,6,亞東-新竹,2023-12-26,2184
6806,森崴能源,6,0,6,亞東-新竹,2023-12-26,2184
2356,英業達,13,7,6,亞東-新竹,2023-12-26,2184
2355,敬鵬,5,0,5,亞東-新竹,2023-12-26,2184
3518,柏騰,5,0,5,亞東-新竹,2023-12-26,2184
5272,笙科,7,2,5,亞東-新竹,2023-12-26,2184
6288,聯嘉,5,0,5,亞東-新竹,2023-12-26,2184
8938,明安,5,0,5,亞東-新竹,2023-12-26,2184
2915,潤泰全,4,0,4,亞東-新竹,2023-12-26,2184
00713,元大台灣高息低波,3,0,3,亞東-新竹,2023-12-26,2184
1532,勤美,3,0,3,亞東-新竹,2023-12-26,2184
00887,永豐中國科技50大,3,0,3,亞東-新竹,2023-12-26,2184
2009,第一銅,3,0,3,亞東-新竹,2023-12-26,2184
2382,廣達,5,2,3,亞東-新竹,2023-12-26,2184
3363,上詮,3,0,3,亞東-新竹,2023-12-26,2184
4908,前鼎,3,0,3,亞東-新竹,2023-12-26,2184
5443,均豪,3,0,3,亞東-新竹,2023-12-26,2184
6235,華孚,3,0,3,亞東-新竹,2023-12-26,2184
6456,GIS-KY,6,3,3,亞東-新竹,2023-12-26,2184
2609,陽明,11,8,3,亞東-新竹,2023-12-26,2184
1312,國喬,2,0,2,亞東-新竹,2023-12-26,2184
00923,群益台ESG低碳50,2,0,2,亞東-新竹,2023-12-26,2184
00710B,復華彭博非投等債,2,0,2,亞東-新竹,2023-12-26,2184
1417,嘉裕,2,0,2,亞東-新竹,2023-12-26,2184
1582,信錦,2,0,2,亞東-新竹,2023-12-26,2184
1611,中電,2,0,2,亞東-新竹,2023-12-26,2184
2002,中鋼,4,2,2,亞東-新竹,2023-12-26,2184
2357,華碩,2,0,2,亞東-新竹,2023-12-26,2184
00919,群益台灣精選高息,134,3,131,亞東-新竹,2023-12-27,2184
00720B,元大投資級公司債,117,0,117,亞東-新竹,2023-12-27,2184
00937B,群益ESG投等債20,93,0,93,亞東-新竹,2023-12-27,2184
2329,華泰,36,11,25,亞東-新竹,2023-12-27,2184
00929,復華台灣科技優息,28,4,24,亞東-新竹,2023-12-27,2184
00632R,元大台灣50反1,20,0,20,亞東-新竹,2023-12-27,2184
2377,微星,21,1,20,亞東-新竹,2023-12-27,2184
5009,榮剛,20,0,20,亞東-新竹,2023-12-27,2184
2609,陽明,21,6,15,亞東-新竹,2023-12-27,2184
3260,威剛,14,0,14,亞東-新竹,2023-12-27,2184
00687B,國泰20年美債,11,0,11,亞東-新竹,2023-12-27,2184
2308,台達電,10,0,10,亞東-新竹,2023-12-27,2184
1616,億泰,10,0,10,亞東-新竹,2023-12-27,2184
2010,春源,10,0,10,亞東-新竹,2023-12-27,2184
2442,新美齊,10,0,10,亞東-新竹,2023-12-27,2184
7402,邑錡,10,0,10,亞東-新竹,2023-12-27,2184
8114,振樺電,11,1,10,亞東-新竹,2023-12-27,2184
2731,雄獅,8,0,8,亞東-新竹,2023-12-27,2184
5371,中光電,7,0,7,亞東-新竹,2023-12-27,2184
6550,北極星藥業-KY,7,0,7,亞東-新竹,2023-12-27,2184
8426,紅木-KY,7,0,7,亞東-新竹,2023-12-27,2184
1611,中電,6,0,6,亞東-新竹,2023-12-27,2184
2382,廣達,9,3,6,亞東-新竹,2023-12-27,2184
2548,華固,6,0,6,亞東-新竹,2023-12-27,2184
3483,力致,7,1,6,亞東-新竹,2023-12-27,2184
1215,卜蜂,5,0,5,亞東-新竹,2023-12-27,2184
00680L,元大美債20正2,5,0,5,亞東-新竹,2023-12-27,2184
00923,群益台ESG低碳50,5,0,5,亞東-新竹,2023-12-27,2184
00933B,國泰10Y+金融債,5,0,5,亞東-新竹,2023-12-27,2184
00931B,統一美債20年,5,0,5,亞東-新竹,2023-12-27,2184
2520,冠德,5,0,5,亞東-新竹,2023-12-27,2184
2883,凱基金,10,5,5,亞東-新竹,2023-12-27,2184
8938,明安,5,0,5,亞東-新竹,2023-12-27,2184
5483,中美晶,4,0,4,亞東-新竹,2023-12-27,2184
00934,中信成長高股息,4,0,4,亞東-新竹,2023-12-27,2184
2352,佳世達,4,0,4,亞東-新竹,2023-12-27,2184
2353,宏��,19,15,4,亞東-新竹,2023-12-27,2184
2357,華碩,4,0,4,亞東-新竹,2023-12-27,2184
6733,博晟生醫,4,0,4,亞東-新竹,2023-12-27,2184
1605,華新,4,1,3,亞東-新竹,2023-12-27,2184
2915,潤泰全,3,0,3,亞東-新竹,2023-12-27,2184
3041,揚智,3,0,3,亞東-新竹,2023-12-27,2184
1709,和益,3,0,3,亞東-新竹,2023-12-27,2184
3450,聯鈞,4,1,3,亞東-新竹,2023-12-27,2184
2603,長榮,6,4,2,亞東-新竹,2023-12-27,2184
1301,台塑,2,0,2,亞東-新竹,2023-12-27,2184
00719B,元大美債1-3,2,0,2,亞東-新竹,2023-12-27,2184
00772B,中信高評級公司債,2,0,2,亞東-新竹,2023-12-27,2184
0061,元大寶滬深,2,0,2,亞東-新竹,2023-12-27,2184
2355,敬鵬,2,0,2,亞東-新竹,2023-12-27,2184
00688L,國泰20年美債正2,310,0,310,亞東-新竹,2023-12-28,2184
2897,王道銀行,100,0,100,亞東-新竹,2023-12-28,2184
2303,聯電,101,24,77,亞東-新竹,2023-12-28,2184
00720B,元大投資級公司債,69,0,69,亞東-新竹,2023-12-28,2184
2915,潤泰全,51,0,51,亞東-新竹,2023-12-28,2184
1513,中興電,68,18,50,亞東-新竹,2023-12-28,2184
00919,群益台灣精選高息,42,4,38,亞東-新竹,2023-12-28,2184
0056,元大高股息,51,14,37,亞東-新竹,2023-12-28,2184
00929,復華台灣科技優息,42,10,32,亞東-新竹,2023-12-28,2184
2405,輔信,31,0,31,亞東-新竹,2023-12-28,2184
3006,晶豪科,32,3,29,亞東-新竹,2023-12-28,2184
2324,仁寶,45,23,22,亞東-新竹,2023-12-28,2184
00934,中信成長高股息,19,0,19,亞東-新竹,2023-12-28,2184
00764B,群益25年美債,16,0,16,亞東-新竹,2023-12-28,2184
00687B,國泰20年美債,16,1,15,亞東-新竹,2023-12-28,2184
2027,大成鋼,15,0,15,亞東-新竹,2023-12-28,2184
00719B,元大美債1-3,14,0,14,亞東-新竹,2023-12-28,2184
00696B,富邦美債20年,12,0,12,亞東-新竹,2023-12-28,2184
2801,彰銀,12,0,12,亞東-新竹,2023-12-28,2184
3338,泰碩,11,0,11,亞東-新竹,2023-12-28,2184
00878,國泰永續高股息,30,20,10,亞東-新竹,2023-12-28,2184
00882,中信中國高股息,10,0,10,亞東-新竹,2023-12-28,2184
00679B,元大美債20年,10,0,10,亞東-新竹,2023-12-28,2184
2327,國巨,10,0,10,亞東-新竹,2023-12-28,2184
2355,敬鵬,10,0,10,亞東-新竹,2023-12-28,2184
4934,太極,10,0,10,亞東-新竹,2023-12-28,2184
2421,建準,9,0,9,亞東-新竹,2023-12-28,2184
00646,元大S＆P500,8,0,8,亞東-新竹,2023-12-28,2184
2329,華泰,43,35,8,亞東-新竹,2023-12-28,2184
2727,王品,8,0,8,亞東-新竹,2023-12-28,2184
9958,世紀鋼,8,0,8,亞東-新竹,2023-12-28,2184
3035,智原,11,4,7,亞東-新竹,2023-12-28,2184
00885,富邦越南,6,0,6,亞東-新竹,2023-12-28,2184
00697B,元大美債7-10,6,0,6,亞東-新竹,2023-12-28,2184
00937B,群益ESG投等債20,6,0,6,亞東-新竹,2023-12-28,2184
00918,大華優利高填息30,6,0,6,亞東-新竹,2023-12-28,2184
00933B,國泰10Y+金融債,6,0,6,亞東-新竹,2023-12-28,2184
6248,沛波,6,0,6,亞東-新竹,2023-12-28,2184
8039,台虹,6,0,6,亞東-新竹,2023-12-28,2184
00923,群益台ESG低碳50,6,0,6,亞東-新竹,2023-12-28,2184
4904,遠傳,5,0,5,亞東-新竹,2023-12-28,2184
6443,元晶,5,0,5,亞東-新竹,2023-12-28,2184
3131,弘塑,4,0,4,亞東-新竹,2023-12-28,2184
3231,緯創,13,9,4,亞東-新竹,2023-12-28,2184
4536,拓凱,4,0,4,亞東-新竹,2023-12-28,2184
6789,采鈺,5,1,4,亞東-新竹,2023-12-28,2184
6901,鑽石投資,4,0,4,亞東-新竹,2023-12-28,2184
9919,康那香,4,0,4,亞東-新竹,2023-12-28,2184
5483,中美晶,4,0,4,亞東-新竹,2023-12-28,2184
1532,勤美,3,0,3,亞東-新竹,2023-12-28,2184
00720B,元大投資級公司債,59,2,57,亞東-新竹,2023-12-29,2184
00751B,元大AAA至A公司債,55,0,55,亞東-新竹,2023-12-29,2184
00688L,國泰20年美債正2,50,0,50,亞東-新竹,2023-12-29,2184
3706,神達,24,2,22,亞東-新竹,2023-12-29,2184
01007T,兆豐國泰R2,20,0,20,亞東-新竹,2023-12-29,2184
2344,華邦電,30,10,20,亞東-新竹,2023-12-29,2184
00937B,群益ESG投等債20,19,0,19,亞東-新竹,2023-12-29,2184
00885,富邦越南,19,0,19,亞東-新竹,2023-12-29,2184
4916,事欣科,19,0,19,亞東-新竹,2023-12-29,2184
00929,復華台灣科技優息,18,0,18,亞東-新竹,2023-12-29,2184
2201,裕隆,15,2,13,亞東-新竹,2023-12-29,2184
3041,揚智,12,0,12,亞東-新竹,2023-12-29,2184
6138,茂達,13,1,12,亞東-新竹,2023-12-29,2184
00687B,國泰20年美債,11,0,11,亞東-新竹,2023-12-29,2184
3006,晶豪科,14,3,11,亞東-新竹,2023-12-29,2184
00655L,國泰中國A50正2,10,0,10,亞東-新竹,2023-12-29,2184
5371,中光電,10,0,10,亞東-新竹,2023-12-29,2184
6589,台康生技,10,0,10,亞東-新竹,2023-12-29,2184
2376,技嘉,11,2,9,亞東-新竹,2023-12-29,2184
00933B,國泰10Y+金融債,13,5,8,亞東-新竹,2023-12-29,2184
6248,沛波,6,0,6,亞東-新竹,2023-12-29,2184
9925,新保,6,0,6,亞東-新竹,2023-12-29,2184
1504,東元,5,0,5,亞東-新竹,2023-12-29,2184
00934,中信成長高股息,5,0,5,亞東-新竹,2023-12-29,2184
0061,元大寶滬深,5,0,5,亞東-新竹,2023-12-29,2184
00639,富邦深100,5,0,5,亞東-新竹,2023-12-29,2184
2032,新鋼,5,0,5,亞東-新竹,2023-12-29,2184
2355,敬鵬,5,0,5,亞東-新竹,2023-12-29,2184
2705,六福,5,0,5,亞東-新竹,2023-12-29,2184
2727,王品,8,3,5,亞東-新竹,2023-12-29,2184
2886,兆豐金,5,0,5,亞東-新竹,2023-12-29,2184
2915,潤泰全,5,0,5,亞東-新竹,2023-12-29,2184
3037,欣興,5,0,5,亞東-新竹,2023-12-29,2184
4116,明基醫,5,0,5,亞東-新竹,2023-12-29,2184
4157,太景*-KY,5,0,5,亞東-新竹,2023-12-29,2184
1519,華城,6,2,4,亞東-新竹,2023-12-29,2184
2609,陽明,6,2,4,亞東-新竹,2023-12-29,2184
3022,威強電,4,0,4,亞東-新竹,2023-12-29,2184
4536,拓凱,4,0,4,亞東-新竹,2023-12-29,2184
5351,鈺創,4,0,4,亞東-新竹,2023-12-29,2184
9941,裕融,4,0,4,亞東-新竹,2023-12-29,2184
3228,金麗科,4,0,4,亞東-新竹,2023-12-29,2184
2330,台積電,5,1,4,亞東-新竹,2023-12-29,2184
3481,群創,3,0,3,亞東-新竹,2023-12-29,2184
2458,義隆,3,0,3,亞東-新竹,2023-12-29,2184
2867,三商壽,3,0,3,亞東-新竹,2023-12-29,2184
3035,智原,4,1,3,亞東-新竹,2023-12-29,2184
4413,飛寶企業,3,0,3,亞東-新竹,2023-12-29,2184
6187,萬潤,3,0,3,亞東-新竹,2023-12-29,2184
6294,智基,3,0,3,亞東-新竹,2023-12-29,2184
2885,元大金,933,0,933,亞東-新竹,2024-01-02,2184
00688L,國泰20年美債正2,142,4,138,亞東-新竹,2024-01-02,2184
00929,復華台灣科技優息,71,0,71,亞東-新竹,2024-01-02,2184
00720B,元大投資級公司債,68,3,65,亞東-新竹,2024-01-02,2184
2883,凱基金,47,0,47,亞東-新竹,2024-01-02,2184
00712,復華富時不動產,43,0,43,亞東-新竹,2024-01-02,2184
00632R,元大台灣50反1,40,0,40,亞東-新竹,2024-01-02,2184
2615,萬海,39,0,39,亞東-新竹,2024-01-02,2184
2303,聯電,62,25,37,亞東-新竹,2024-01-02,2184
2609,陽明,105,71,34,亞東-新竹,2024-01-02,2184
00937B,群益ESG投等債20,63,35,28,亞東-新竹,2024-01-02,2184
00751B,元大AAA至A公司債,23,0,23,亞東-新竹,2024-01-02,2184
00915,凱基優選高股息30,22,0,22,亞東-新竹,2024-01-02,2184
00878,國泰永續高股息,22,1,21,亞東-新竹,2024-01-02,2184
00888,永豐台灣ESG,20,0,20,亞東-新竹,2024-01-02,2184
2201,裕隆,35,18,17,亞東-新竹,2024-01-02,2184
3231,緯創,17,1,16,亞東-新竹,2024-01-02,2184
00933B,國泰10Y+金融債,13,0,13,亞東-新竹,2024-01-02,2184
6138,茂達,18,5,13,亞東-新竹,2024-01-02,2184
00772B,中信高評級公司債,12,0,12,亞東-新竹,2024-01-02,2184
6113,亞矽,11,0,11,亞東-新竹,2024-01-02,2184
00693U,期街口S＆P黃豆,10,0,10,亞東-新竹,2024-01-02,2184
1909,榮成,10,0,10,亞東-新竹,2024-01-02,2184
2353,宏��,35,25,10,亞東-新竹,2024-01-02,2184
4157,太景*-KY,10,0,10,亞東-新竹,2024-01-02,2184
5531,鄉林,10,0,10,亞東-新竹,2024-01-02,2184
5426,振發,9,0,9,亞東-新竹,2024-01-02,2184
2027,大成鋼,10,2,8,亞東-新竹,2024-01-02,2184
6546,正基,8,0,8,亞東-新竹,2024-01-02,2184
2313,華通,7,0,7,亞東-新竹,2024-01-02,2184
2493,揚博,7,0,7,亞東-新竹,2024-01-02,2184
2546,根基,7,0,7,亞東-新竹,2024-01-02,2184
2731,雄獅,7,0,7,亞東-新竹,2024-01-02,2184
5905,南仁湖,7,0,7,亞東-新竹,2024-01-02,2184
00687B,國泰20年美債,18,12,6,亞東-新竹,2024-01-02,2184
2449,京元電子,6,0,6,亞東-新竹,2024-01-02,2184
3711,日月光投控,7,1,6,亞東-新竹,2024-01-02,2184
5452,佶優,6,0,6,亞東-新竹,2024-01-02,2184
00931B,統一美債20年,5,0,5,亞東-新竹,2024-01-02,2184
006208,富邦台50,5,0,5,亞東-新竹,2024-01-02,2184
2441,超豐,5,0,5,亞東-新竹,2024-01-02,2184
3563,牧德,5,0,5,亞東-新竹,2024-01-02,2184
3630,新鉅科,5,0,5,亞東-新竹,2024-01-02,2184
5210,寶碩,5,0,5,亞東-新竹,2024-01-02,2184
5347,世界,5,0,5,亞東-新竹,2024-01-02,2184
5521,工信,20,15,5,亞東-新竹,2024-01-02,2184
2454,聯發科,5,0,5,亞東-新竹,2024-01-02,2184
4908,前鼎,6,2,4,亞東-新竹,2024-01-02,2184
00680L,元大美債20正2,8,4,4,亞東-新竹,2024-01-02,2184
00918,大華優利高填息30,4,0,4,亞東-新竹,2024-01-02,2184
00929,復華台灣科技優息,128,0,128,亞東-新竹,2024-01-03,2184
2885,元大金,300,202,98,亞東-新竹,2024-01-03,2184
0056,元大高股息,93,0,93,亞東-新竹,2024-01-03,2184
2303,聯電,56,2,54,亞東-新竹,2024-01-03,2184
3390,旭軟,56,2,54,亞東-新竹,2024-01-03,2184
00919,群益台灣精選高息,42,0,42,亞東-新竹,2024-01-03,2184
6770,力積電,40,5,35,亞東-新竹,2024-01-03,2184
00935,野村臺灣新科技50,34,0,34,亞東-新竹,2024-01-03,2184
2201,裕隆,32,4,28,亞東-新竹,2024-01-03,2184
00878,國泰永續高股息,33,7,26,亞東-新竹,2024-01-03,2184
2881,富邦金,25,0,25,亞東-新竹,2024-01-03,2184
00915,凱基優選高股息30,22,0,22,亞東-新竹,2024-01-03,2184
00937B,群益ESG投等債20,21,0,21,亞東-新竹,2024-01-03,2184
3483,力致,20,0,20,亞東-新竹,2024-01-03,2184
00693U,期街口S＆P黃豆,20,0,20,亞東-新竹,2024-01-03,2184
0050,元大台灣50,17,0,17,亞東-新竹,2024-01-03,2184
00746B,富邦A級公司債,16,0,16,亞東-新竹,2024-01-03,2184
6163,華電網,16,0,16,亞東-新竹,2024-01-03,2184
2002,中鋼,15,1,14,亞東-新竹,2024-01-03,2184
2329,華泰,25,11,14,亞東-新竹,2024-01-03,2184
2615,萬海,18,4,14,亞東-新竹,2024-01-03,2184
2330,台積電,16,3,13,亞東-新竹,2024-01-03,2184
6138,茂達,13,0,13,亞東-新竹,2024-01-03,2184
00830,國泰費城半導體,13,0,13,亞東-新竹,2024-01-03,2184
00715L,期街口布蘭特正2,25,12,13,亞東-新竹,2024-01-03,2184
00918,大華優利高填息30,12,0,12,亞東-新竹,2024-01-03,2184
00934,中信成長高股息,10,0,10,亞東-新竹,2024-01-03,2184
00712,復華富時不動產,10,0,10,亞東-新竹,2024-01-03,2184
00757,統一FANG+,10,0,10,亞東-新竹,2024-01-03,2184
00888,永豐台灣ESG,10,0,10,亞東-新竹,2024-01-03,2184
2888,新光金,10,0,10,亞東-新竹,2024-01-03,2184
3522,御嵿,10,0,10,亞東-新竹,2024-01-03,2184
00891,中信關鍵半導體,9,0,9,亞東-新竹,2024-01-03,2184
00933B,國泰10Y+金融債,8,0,8,亞東-新竹,2024-01-03,2184
2352,佳世達,11,4,7,亞東-新竹,2024-01-03,2184
3034,聯詠,6,0,6,亞東-新竹,2024-01-03,2184
2412,中華電,6,0,6,亞東-新竹,2024-01-03,2184
2468,華經,6,0,6,亞東-新竹,2024-01-03,2184
3645,達邁,6,0,6,亞東-新竹,2024-01-03,2184
4938,和碩,6,0,6,亞東-新竹,2024-01-03,2184
2887,台新金,5,0,5,亞東-新竹,2024-01-03,2184
3533,嘉澤,5,0,5,亞東-新竹,2024-01-03,2184
00751B,元大AAA至A公司債,5,0,5,亞東-新竹,2024-01-03,2184
006208,富邦台50,5,0,5,亞東-新竹,2024-01-03,2184
00687B,國泰20年美債,5,0,5,亞東-新竹,2024-01-03,2184
1319,東陽,5,0,5,亞東-新竹,2024-01-03,2184
9921,巨大,5,0,5,亞東-新竹,2024-01-03,2184
3481,群創,6,1,5,亞東-新竹,2024-01-03,2184
1709,和益,6,2,4,亞東-新竹,2024-01-03,2184
00675L,富邦臺灣加權正2,4,0,4,亞東-新竹,2024-01-03,2184
00929,復華台灣科技優息,81,2,79,亞東-新竹,2024-01-04,2184
2610,華航,202,150,52,亞東-新竹,2024-01-04,2184
3390,旭軟,31,0,31,亞東-新竹,2024-01-04,2184
00937B,群益ESG投等債20,29,0,29,亞東-新竹,2024-01-04,2184
00720B,元大投資級公司債,23,0,23,亞東-新竹,2024-01-04,2184
00933B,國泰10Y+金融債,21,0,21,亞東-新竹,2024-01-04,2184
2606,裕民,27,6,21,亞東-新竹,2024-01-04,2184
3312,弘憶股,23,2,21,亞東-新竹,2024-01-04,2184
6163,華電網,23,2,21,亞東-新竹,2024-01-04,2184
00725B,國泰投資級公司債,20,0,20,亞東-新竹,2024-01-04,2184
2460,建通,20,0,20,亞東-新竹,2024-01-04,2184
9912,偉聯,20,0,20,亞東-新竹,2024-01-04,2184
3402,漢科,19,0,19,亞東-新竹,2024-01-04,2184
0056,元大高股息,19,2,17,亞東-新竹,2024-01-04,2184
00680L,元大美債20正2,17,0,17,亞東-新竹,2024-01-04,2184
2329,華泰,33,16,17,亞東-新竹,2024-01-04,2184
00927,群益半導體收益,16,0,16,亞東-新竹,2024-01-04,2184
00772B,中信高評級公司債,12,0,12,亞東-新竹,2024-01-04,2184
2345,智邦,12,0,12,亞東-新竹,2024-01-04,2184
00877,復華中國5G,11,0,11,亞東-新竹,2024-01-04,2184
2609,陽明,40,30,10,亞東-新竹,2024-01-04,2184
00928,中信上櫃ESG30,10,0,10,亞東-新竹,2024-01-04,2184
1312,國喬,10,0,10,亞東-新竹,2024-01-04,2184
2421,建準,10,0,10,亞東-新竹,2024-01-04,2184
00687B,國泰20年美債,9,0,9,亞東-新竹,2024-01-04,2184
00751B,元大AAA至A公司債,9,0,9,亞東-新竹,2024-01-04,2184
3006,晶豪科,11,2,9,亞東-新竹,2024-01-04,2184
2201,裕隆,18,10,8,亞東-新竹,2024-01-04,2184
2204,中華,8,0,8,亞東-新竹,2024-01-04,2184
00935,野村臺灣新科技50,7,0,7,亞東-新竹,2024-01-04,2184
00795B,中信美國公債20年,7,0,7,亞東-新竹,2024-01-04,2184
2486,一詮,7,0,7,亞東-新竹,2024-01-04,2184
00882,中信中國高股息,11,4,7,亞東-新竹,2024-01-04,2184
3706,神達,11,5,6,亞東-新竹,2024-01-04,2184
2915,潤泰全,6,0,6,亞東-新竹,2024-01-04,2184
3479,安勤,6,0,6,亞東-新竹,2024-01-04,2184
6248,沛波,6,0,6,亞東-新竹,2024-01-04,2184
0050,元大台灣50,5,0,5,亞東-新竹,2024-01-04,2184
3017,奇鋐,6,1,5,亞東-新竹,2024-01-04,2184
00753L,中信中國50正2,8,3,5,亞東-新竹,2024-01-04,2184
00637L,元大滬深300正2,6,1,5,亞東-新竹,2024-01-04,2184
1303,南亞,5,0,5,亞東-新竹,2024-01-04,2184
6670,復盛應用,5,0,5,亞東-新竹,2024-01-04,2184
00915,凱基優選高股息30,4,0,4,亞東-新竹,2024-01-04,2184
00633L,富邦上証正2,4,0,4,亞東-新竹,2024-01-04,2184
00650L,復華香港正2,4,0,4,亞東-新竹,2024-01-04,2184
2618,長榮航,18,14,4,亞東-新竹,2024-01-04,2184
3034,聯詠,4,0,4,亞東-新竹,2024-01-04,2184
3037,欣興,4,0,4,亞東-新竹,2024-01-04,2184
6113,亞矽,4,0,4,亞東-新竹,2024-01-04,2184
2409,友達,206,20,186,亞東-新竹,2024-01-05,2184
00929,復華台灣科技優息,127,6,121,亞東-新竹,2024-01-05,2184
2027,大成鋼,50,0,50,亞東-新竹,2024-01-05,2184
2618,長榮航,51,8,43,亞東-新竹,2024-01-05,2184
00720B,元大投資級公司債,63,30,33,亞東-新竹,2024-01-05,2184
00679B,元大美債20年,22,0,22,亞東-新竹,2024-01-05,2184
1216,統一,20,0,20,亞東-新竹,2024-01-05,2184
1701,中化,20,0,20,亞東-新竹,2024-01-05,2184
2033,佳大,20,0,20,亞東-新竹,2024-01-05,2184
3714,富采,20,0,20,亞東-新竹,2024-01-05,2184
0056,元大高股息,42,24,18,亞東-新竹,2024-01-05,2184
00687B,國泰20年美債,17,0,17,亞東-新竹,2024-01-05,2184
3390,旭軟,28,11,17,亞東-新竹,2024-01-05,2184
2603,長榮,20,5,15,亞東-新竹,2024-01-05,2184
00919,群益台灣精選高息,23,8,15,亞東-新竹,2024-01-05,2184
2353,宏��,63,49,14,亞東-新竹,2024-01-05,2184
1218,泰山,12,0,12,亞東-新竹,2024-01-05,2184
3030,德律,12,0,12,亞東-新竹,2024-01-05,2184
3481,群創,25,13,12,亞東-新竹,2024-01-05,2184
00757,統一FANG+,11,0,11,亞東-新竹,2024-01-05,2184
2303,聯電,36,25,11,亞東-新竹,2024-01-05,2184
00712,復華富時不動產,10,0,10,亞東-新竹,2024-01-05,2184
00937B,群益ESG投等債20,10,0,10,亞東-新竹,2024-01-05,2184
2354,鴻準,10,0,10,亞東-新竹,2024-01-05,2184
2356,英業達,14,5,9,亞東-新竹,2024-01-05,2184
2382,廣達,11,2,9,亞東-新竹,2024-01-05,2184
3402,漢科,9,0,9,亞東-新竹,2024-01-05,2184
9919,康那香,9,0,9,亞東-新竹,2024-01-05,2184
1314,中石化,8,0,8,亞東-新竹,2024-01-05,2184
1324,地球,8,0,8,亞東-新竹,2024-01-05,2184
5469,瀚宇博,12,4,8,亞東-新竹,2024-01-05,2184
00933B,國泰10Y+金融債,7,0,7,亞東-新竹,2024-01-05,2184
2732,六角,12,5,7,亞東-新竹,2024-01-05,2184
00751B,元大AAA至A公司債,6,0,6,亞東-新竹,2024-01-05,2184
2405,輔信,6,0,6,亞東-新竹,2024-01-05,2184
5438,東友,6,0,6,亞東-新竹,2024-01-05,2184
6285,啟��,6,0,6,亞東-新竹,2024-01-05,2184
2609,陽明,33,28,5,亞東-新竹,2024-01-05,2184
2330,台積電,8,2,6,亞東-新竹,2024-01-05,2184
3533,嘉澤,5,0,5,亞東-新竹,2024-01-05,2184
0050,元大台灣50,5,0,5,亞東-新竹,2024-01-05,2184
2363,矽統,7,2,5,亞東-新竹,2024-01-05,2184
2427,三商電,12,7,5,亞東-新竹,2024-01-05,2184
2641,正德,5,0,5,亞東-新竹,2024-01-05,2184
2020,美亞,4,0,4,亞東-新竹,2024-01-05,2184
2308,台達電,4,0,4,亞東-新竹,2024-01-05,2184
4116,明基醫,4,0,4,亞東-新竹,2024-01-05,2184
4938,和碩,4,0,4,亞東-新竹,2024-01-05,2184
5519,隆大,4,0,4,亞東-新竹,2024-01-05,2184
3189,景碩,3,0,3,亞東-新竹,2024-01-05,2184
00720B,元大投資級公司債,194,0,194,亞東-新竹,2024-01-08,2184
00679B,元大美債20年,57,5,52,亞東-新竹,2024-01-08,2184
2885,元大金,50,0,50,亞東-新竹,2024-01-08,2184
2834,臺企銀,100,55,45,亞東-新竹,2024-01-08,2184
00929,復華台灣科技優息,48,7,41,亞東-新竹,2024-01-08,2184
00680L,元大美債20正2,34,0,34,亞東-新竹,2024-01-08,2184
6770,力積電,53,23,30,亞東-新竹,2024-01-08,2184
00937B,群益ESG投等債20,20,0,20,亞東-新竹,2024-01-08,2184
00688L,國泰20年美債正2,20,0,20,亞東-新竹,2024-01-08,2184
2897,王道銀行,20,0,20,亞東-新竹,2024-01-08,2184
00751B,元大AAA至A公司債,15,0,15,亞東-新竹,2024-01-08,2184
0061,元大寶滬深,15,0,15,亞東-新竹,2024-01-08,2184
00637L,元大滬深300正2,15,0,15,亞東-新竹,2024-01-08,2184
2618,長榮航,15,0,15,亞東-新竹,2024-01-08,2184
00919,群益台灣精選高息,15,1,14,亞東-新竹,2024-01-08,2184
2520,冠德,14,0,14,亞東-新竹,2024-01-08,2184
2303,聯電,22,9,13,亞東-新竹,2024-01-08,2184
2344,華邦電,23,10,13,亞東-新竹,2024-01-08,2184
2329,華泰,12,1,11,亞東-新竹,2024-01-08,2184
00882,中信中國高股息,10,0,10,亞東-新竹,2024-01-08,2184
00773B,中信優先金融債,10,0,10,亞東-新竹,2024-01-08,2184
2332,友訊,10,0,10,亞東-新竹,2024-01-08,2184
2481,強茂,10,0,10,亞東-新竹,2024-01-08,2184
3206,志豐,10,0,10,亞東-新竹,2024-01-08,2184
8936,國統,10,0,10,亞東-新竹,2024-01-08,2184
1720,生達,9,0,9,亞東-新竹,2024-01-08,2184
00650L,復華香港正2,8,0,8,亞東-新竹,2024-01-08,2184
4116,明基醫,8,0,8,亞東-新竹,2024-01-08,2184
5225,東科-KY,8,0,8,亞東-新竹,2024-01-08,2184
6462,神盾,9,1,8,亞東-新竹,2024-01-08,2184
2603,長榮,10,2,8,亞東-新竹,2024-01-08,2184
00655L,國泰中國A50正2,7,0,7,亞東-新竹,2024-01-08,2184
3006,晶豪科,9,2,7,亞東-新竹,2024-01-08,2184
00687B,國泰20年美債,9,3,6,亞東-新竹,2024-01-08,2184
3227,原相,6,0,6,亞東-新竹,2024-01-08,2184
8011,台通,6,0,6,亞東-新竹,2024-01-08,2184
3533,嘉澤,5,0,5,亞東-新竹,2024-01-08,2184
1325,恆大,10,5,5,亞東-新竹,2024-01-08,2184
00738U,期元大道瓊白銀,5,0,5,亞東-新竹,2024-01-08,2184
00633L,富邦上証正2,5,0,5,亞東-新竹,2024-01-08,2184
00712,復華富時不動產,5,0,5,亞東-新竹,2024-01-08,2184
2449,京元電子,5,0,5,亞東-新竹,2024-01-08,2184
2605,新興,5,0,5,亞東-新竹,2024-01-08,2184
4167,松瑞藥,5,0,5,亞東-新竹,2024-01-08,2184
6259,百徽,5,0,5,亞東-新竹,2024-01-08,2184
6485,點序,5,0,5,亞東-新竹,2024-01-08,2184
2801,彰銀,4,0,4,亞東-新竹,2024-01-08,2184
6116,彩晶,10,6,4,亞東-新竹,2024-01-08,2184
6187,萬潤,4,0,4,亞東-新竹,2024-01-08,2184
6274,台燿,3,0,3,亞東-新竹,2024-01-08,2184
00937B,群益ESG投等債20,101,0,101,亞東-新竹,2024-01-09,2184
00919,群益台灣精選高息,95,6,89,亞東-新竹,2024-01-09,2184
00929,復華台灣科技優息,84,0,84,亞東-新竹,2024-01-09,2184
00720B,元大投資級公司債,55,15,40,亞東-新竹,2024-01-09,2184
2609,陽明,52,17,35,亞東-新竹,2024-01-09,2184
2002,中鋼,35,0,35,亞東-新竹,2024-01-09,2184
00680L,元大美債20正2,33,0,33,亞東-新竹,2024-01-09,2184
2603,長榮,37,12,25,亞東-新竹,2024-01-09,2184
3714,富采,25,0,25,亞東-新竹,2024-01-09,2184
1477,聚陽,19,0,19,亞東-新竹,2024-01-09,2184
00753L,中信中國50正2,18,0,18,亞東-新竹,2024-01-09,2184
2317,鴻海,16,0,16,亞東-新竹,2024-01-09,2184
2303,聯電,22,6,16,亞東-新竹,2024-01-09,2184
1460,宏遠,15,0,15,亞東-新竹,2024-01-09,2184
3051,力特,15,1,14,亞東-新竹,2024-01-09,2184
2308,台達電,11,0,11,亞東-新竹,2024-01-09,2184
00687B,國泰20年美債,11,0,11,亞東-新竹,2024-01-09,2184
00770,國泰北美科技,11,0,11,亞東-新竹,2024-01-09,2184
2201,裕隆,11,0,11,亞東-新竹,2024-01-09,2184
2344,華邦電,11,0,11,亞東-新竹,2024-01-09,2184
4167,松瑞藥,11,0,11,亞東-新竹,2024-01-09,2184
1218,泰山,10,0,10,亞東-新竹,2024-01-09,2184
00715L,期街口布蘭特正2,10,0,10,亞東-新竹,2024-01-09,2184
1524,耿鼎,11,1,10,亞東-新竹,2024-01-09,2184
2332,友訊,10,0,10,亞東-新竹,2024-01-09,2184
2354,鴻準,10,0,10,亞東-新竹,2024-01-09,2184
0056,元大高股息,11,2,9,亞東-新竹,2024-01-09,2184
1304,台聚,9,0,9,亞東-新竹,2024-01-09,2184
4919,新唐,8,0,8,亞東-新竹,2024-01-09,2184
2352,佳世達,10,2,8,亞東-新竹,2024-01-09,2184
1733,五鼎,7,0,7,亞東-新竹,2024-01-09,2184
2337,旺宏,7,0,7,亞東-新竹,2024-01-09,2184
2897,王道銀行,7,0,7,亞東-新竹,2024-01-09,2184
3622,洋華,12,5,7,亞東-新竹,2024-01-09,2184
8111,立��,7,0,7,亞東-新竹,2024-01-09,2184
2356,英業達,11,4,7,亞東-新竹,2024-01-09,2184
2617,台航,6,0,6,亞東-新竹,2024-01-09,2184
3704,合勤控,6,0,6,亞東-新竹,2024-01-09,2184
4916,事欣科,6,0,6,亞東-新竹,2024-01-09,2184
6116,彩晶,6,0,6,亞東-新竹,2024-01-09,2184
3260,威剛,7,2,5,亞東-新竹,2024-01-09,2184
4961,天鈺,5,0,5,亞東-新竹,2024-01-09,2184
00927,群益半導體收益,5,0,5,亞東-新竹,2024-01-09,2184
00712,復華富時不動產,7,2,5,亞東-新竹,2024-01-09,2184
1785,光洋科,5,0,5,亞東-新竹,2024-01-09,2184
2913,農林,5,0,5,亞東-新竹,2024-01-09,2184
3022,威強電,5,0,5,亞東-新竹,2024-01-09,2184
3078,僑威,5,0,5,亞東-新竹,2024-01-09,2184
3105,穩懋,5,0,5,亞東-新竹,2024-01-09,2184
3322,建舜電,5,0,5,亞東-新竹,2024-01-09,2184
00751B,元大AAA至A公司債,100,0,100,亞東-新竹,2024-01-10,2184
00937B,群益ESG投等債20,99,2,97,亞東-新竹,2024-01-10,2184
00753L,中信中國50正2,80,0,80,亞東-新竹,2024-01-10,2184
00680L,元大美債20正2,84,9,75,亞東-新竹,2024-01-10,2184
2610,華航,64,0,64,亞東-新竹,2024-01-10,2184
00720B,元大投資級公司債,56,0,56,亞東-新竹,2024-01-10,2184
00679B,元大美債20年,52,2,50,亞東-新竹,2024-01-10,2184
00688L,國泰20年美債正2,38,0,38,亞東-新竹,2024-01-10,2184
00929,復華台灣科技優息,33,1,32,亞東-新竹,2024-01-10,2184
1609,大亞,21,0,21,亞東-新竹,2024-01-10,2184
6248,沛波,20,0,20,亞東-新竹,2024-01-10,2184
2883,凱基金,20,0,20,亞東-新竹,2024-01-10,2184
00712,復華富時不動產,20,2,18,亞東-新竹,2024-01-10,2184
3025,星通,21,6,15,亞東-新竹,2024-01-10,2184
3413,京鼎,15,0,15,亞東-新竹,2024-01-10,2184
3481,群創,15,0,15,亞東-新竹,2024-01-10,2184
9103,美德醫療-DR,15,0,15,亞東-新竹,2024-01-10,2184
8403,盛弘,14,0,14,亞東-新竹,2024-01-10,2184
2882,國泰金,11,0,11,亞東-新竹,2024-01-10,2184
1218,泰山,10,0,10,亞東-新竹,2024-01-10,2184
2812,台中銀,10,0,10,亞東-新竹,2024-01-10,2184
0050,元大台灣50,9,0,9,亞東-新竹,2024-01-10,2184
2356,英業達,12,3,9,亞東-新竹,2024-01-10,2184
2363,矽統,10,1,9,亞東-新竹,2024-01-10,2184
6550,北極星藥業-KY,9,0,9,亞東-新竹,2024-01-10,2184
1326,台化,9,1,8,亞東-新竹,2024-01-10,2184
4958,臻鼎-KY,8,0,8,亞東-新竹,2024-01-10,2184
5706,鳳凰,8,0,8,亞東-新竹,2024-01-10,2184
2317,鴻海,7,0,7,亞東-新竹,2024-01-10,2184
1304,台聚,6,0,6,亞東-新竹,2024-01-10,2184
2345,智邦,6,0,6,亞東-新竹,2024-01-10,2184
3293,鈊象,6,0,6,亞東-新竹,2024-01-10,2184
6274,台燿,6,0,6,亞東-新竹,2024-01-10,2184
8255,朋程,6,0,6,亞東-新竹,2024-01-10,2184
2376,技嘉,9,4,5,亞東-新竹,2024-01-10,2184
5306,桂盟,5,0,5,亞東-新竹,2024-01-10,2184
9941,裕融,5,0,5,亞東-新竹,2024-01-10,2184
00930,永豐ESG低碳高息,5,0,5,亞東-新竹,2024-01-10,2184
1319,東陽,5,0,5,亞東-新竹,2024-01-10,2184
1720,生達,6,1,5,亞東-新竹,2024-01-10,2184
1909,榮成,5,0,5,亞東-新竹,2024-01-10,2184
2033,佳大,5,0,5,亞東-新竹,2024-01-10,2184
2208,台船,5,0,5,亞東-新竹,2024-01-10,2184
2401,凌陽,5,0,5,亞東-新竹,2024-01-10,2184
2460,建通,10,5,5,亞東-新竹,2024-01-10,2184
2464,盟立,5,0,5,亞東-新竹,2024-01-10,2184
2727,王品,13,8,5,亞東-新竹,2024-01-10,2184
3272,東碩,5,0,5,亞東-新竹,2024-01-10,2184
2618,長榮航,12,8,4,亞東-新竹,2024-01-10,2184
00878,國泰永續高股息,5,1,4,亞東-新竹,2024-01-10,2184
00929,復華台灣科技優息,149,12,137,亞東-新竹,2024-01-11,2184
2845,遠東銀,100,0,100,亞東-新竹,2024-01-11,2184
2888,新光金,70,0,70,亞東-新竹,2024-01-11,2184
2882,國泰金,29,0,29,亞東-新竹,2024-01-11,2184
3287,廣寰科,22,0,22,亞東-新竹,2024-01-11,2184
00688L,國泰20年美債正2,20,0,20,亞東-新竹,2024-01-11,2184
1513,中興電,23,5,18,亞東-新竹,2024-01-11,2184
2915,潤泰全,16,0,16,亞東-新竹,2024-01-11,2184
3499,環天科,14,0,14,亞東-新竹,2024-01-11,2184
00927,群益半導體收益,13,0,13,亞東-新竹,2024-01-11,2184
1301,台塑,13,1,12,亞東-新竹,2024-01-11,2184
3206,志豐,12,0,12,亞東-新竹,2024-01-11,2184
00930,永豐ESG低碳高息,11,0,11,亞東-新竹,2024-01-11,2184
2603,長榮,16,5,11,亞東-新竹,2024-01-11,2184
3033,威健,11,0,11,亞東-新竹,2024-01-11,2184
00632R,元大台灣50反1,10,0,10,亞東-新竹,2024-01-11,2184
3051,力特,10,0,10,亞東-新竹,2024-01-11,2184
4157,太景*-KY,20,10,10,亞東-新竹,2024-01-11,2184
5258,虹堡,10,0,10,亞東-新竹,2024-01-11,2184
6116,彩晶,10,0,10,亞東-新竹,2024-01-11,2184
6589,台康生技,10,0,10,亞東-新竹,2024-01-11,2184
9921,巨大,10,0,10,亞東-新竹,2024-01-11,2184
00919,群益台灣精選高息,23,14,9,亞東-新竹,2024-01-11,2184
1460,宏遠,10,1,9,亞東-新竹,2024-01-11,2184
2745,五福,7,0,7,亞東-新竹,2024-01-11,2184
1324,地球,6,0,6,亞東-新竹,2024-01-11,2184
3006,晶豪科,5,0,5,亞東-新竹,2024-01-11,2184
1101,台泥,5,0,5,亞東-新竹,2024-01-11,2184
2101,南港,5,0,5,亞東-新竹,2024-01-11,2184
2354,鴻準,5,0,5,亞東-新竹,2024-01-11,2184
6485,點序,5,0,5,亞東-新竹,2024-01-11,2184
00687B,國泰20年美債,4,0,4,亞東-新竹,2024-01-11,2184
2449,京元電子,4,0,4,亞東-新竹,2024-01-11,2184
2454,聯發科,4,0,4,亞東-新竹,2024-01-11,2184
3715,定穎投控,10,6,4,亞東-新竹,2024-01-11,2184
5469,瀚宇博,4,0,4,亞東-新竹,2024-01-11,2184
6282,康舒,4,0,4,亞東-新竹,2024-01-11,2184
6684,安格,4,0,4,亞東-新竹,2024-01-11,2184
6753,龍德造船,4,0,4,亞東-新竹,2024-01-11,2184
8936,國統,4,0,4,亞東-新竹,2024-01-11,2184
9919,康那香,4,0,4,亞東-新竹,2024-01-11,2184
3450,聯鈞,5,1,4,亞東-新竹,2024-01-11,2184
1312,國喬,4,1,3,亞東-新竹,2024-01-11,2184
1342,八貫,3,0,3,亞東-新竹,2024-01-11,2184
2303,聯電,5,2,3,亞東-新竹,2024-01-11,2184
2436,偉詮電,3,0,3,亞東-新竹,2024-01-11,2184
2634,漢翔,3,0,3,亞東-新竹,2024-01-11,2184
3034,聯詠,4,1,3,亞東-新竹,2024-01-11,2184
4563,百德,3,0,3,亞東-新竹,2024-01-11,2184
4967,十銓,3,0,3,亞東-新竹,2024-01-11,2184
00929,復華台灣科技優息,126,35,91,亞東-新竹,2024-01-12,2184
0056,元大高股息,73,0,73,亞東-新竹,2024-01-12,2184
00720B,元大投資級公司債,60,1,59,亞東-新竹,2024-01-12,2184
2882,國泰金,48,0,48,亞東-新竹,2024-01-12,2184
00751B,元大AAA至A公司債,56,9,47,亞東-新竹,2024-01-12,2184
00680L,元大美債20正2,56,21,35,亞東-新竹,2024-01-12,2184
1528,恩德,34,0,34,亞東-新竹,2024-01-12,2184
8096,擎亞,58,25,33,亞東-新竹,2024-01-12,2184
8033,雷虎,30,0,30,亞東-新竹,2024-01-12,2184
3036,文曄,30,1,29,亞東-新竹,2024-01-12,2184
00927,群益半導體收益,26,0,26,亞東-新竹,2024-01-12,2184
00712,復華富時不動產,21,0,21,亞東-新竹,2024-01-12,2184
0050,元大台灣50,20,0,20,亞東-新竹,2024-01-12,2184
1565,精華,20,0,20,亞東-新竹,2024-01-12,2184
2208,台船,24,5,19,亞東-新竹,2024-01-12,2184
00937B,群益ESG投等債20,17,0,17,亞東-新竹,2024-01-12,2184
6679,鈺太,15,0,15,亞東-新竹,2024-01-12,2184
1514,亞力,16,2,14,亞東-新竹,2024-01-12,2184
2303,聯電,16,2,14,亞東-新竹,2024-01-12,2184
4906,正文,11,0,11,亞東-新竹,2024-01-12,2184
1218,泰山,10,0,10,亞東-新竹,2024-01-12,2184
00650L,復華香港正2,14,4,10,亞東-新竹,2024-01-12,2184
00673R,期元大S＆P原油反1,10,0,10,亞東-新竹,2024-01-12,2184
2332,友訊,10,0,10,亞東-新竹,2024-01-12,2184
2353,宏��,46,37,9,亞東-新竹,2024-01-12,2184
6233,旺玖,9,0,9,亞東-新竹,2024-01-12,2184
6443,元晶,8,0,8,亞東-新竹,2024-01-12,2184
8201,無敵,8,0,8,亞東-新竹,2024-01-12,2184
00878,國泰永續高股息,7,0,7,亞東-新竹,2024-01-12,2184
2492,華新科,7,0,7,亞東-新竹,2024-01-12,2184
2887,台新金,6,0,6,亞東-新竹,2024-01-12,2184
00885,富邦越南,6,0,6,亞東-新竹,2024-01-12,2184
1720,生達,6,0,6,亞東-新竹,2024-01-12,2184
2609,陽明,14,8,6,亞東-新竹,2024-01-12,2184
3035,智原,22,16,6,亞東-新竹,2024-01-12,2184
6163,華電網,6,0,6,亞東-新竹,2024-01-12,2184
6547,高端疫苗,6,0,6,亞東-新竹,2024-01-12,2184
3006,晶豪科,5,0,5,亞東-新竹,2024-01-12,2184
00936,台新永續高息中小,5,0,5,亞東-新竹,2024-01-12,2184
1324,地球,5,0,5,亞東-新竹,2024-01-12,2184
2641,正德,5,0,5,亞東-新竹,2024-01-12,2184
3051,力特,5,0,5,亞東-新竹,2024-01-12,2184
3272,東碩,5,0,5,亞東-新竹,2024-01-12,2184
3322,建舜電,5,0,5,亞東-新竹,2024-01-12,2184
6485,點序,5,0,5,亞東-新竹,2024-01-12,2184
9919,康那香,9,4,5,亞東-新竹,2024-01-12,2184
1325,恆大,4,0,4,亞東-新竹,2024-01-12,2184
00679B,元大美債20年,4,0,4,亞東-新竹,2024-01-12,2184
00687B,國泰20年美債,4,0,4,亞東-新竹,2024-01-12,2184
3673,TPK-KY,4,0,4,亞東-新竹,2024-01-12,2184
00720B,元大投資級公司債,130,6,124,亞東-新竹,2024-01-15,2184
2885,元大金,50,0,50,亞東-新竹,2024-01-15,2184
00751B,元大AAA至A公司債,58,9,49,亞東-新竹,2024-01-15,2184
00878,國泰永續高股息,46,0,46,亞東-新竹,2024-01-15,2184
2618,長榮航,43,9,34,亞東-新竹,2024-01-15,2184
2610,華航,22,0,22,亞東-新竹,2024-01-15,2184
00929,復華台灣科技優息,42,20,22,亞東-新竹,2024-01-15,2184
2392,正崴,20,0,20,亞東-新竹,2024-01-15,2184
00753L,中信中國50正2,27,9,18,亞東-新竹,2024-01-15,2184
3041,揚智,18,0,18,亞東-新竹,2024-01-15,2184
8112,至上,19,1,18,亞東-新竹,2024-01-15,2184
2883,凱基金,16,0,16,亞東-新竹,2024-01-15,2184
2888,新光金,14,0,14,亞東-新竹,2024-01-15,2184
5706,鳳凰,11,0,11,亞東-新竹,2024-01-15,2184
2353,宏��,30,20,10,亞東-新竹,2024-01-15,2184
6248,沛波,10,0,10,亞東-新竹,2024-01-15,2184
2344,華邦電,15,6,9,亞東-新竹,2024-01-15,2184
0056,元大高股息,20,12,8,亞東-新竹,2024-01-15,2184
2356,英業達,10,2,8,亞東-新竹,2024-01-15,2184
6679,鈺太,8,0,8,亞東-新竹,2024-01-15,2184
2845,遠東銀,6,0,6,亞東-新竹,2024-01-15,2184
00937B,群益ESG投等債20,13,7,6,亞東-新竹,2024-01-15,2184
00679B,元大美債20年,6,0,6,亞東-新竹,2024-01-15,2184
3033,威健,6,0,6,亞東-新竹,2024-01-15,2184
3035,智原,20,14,6,亞東-新竹,2024-01-15,2184
6271,同欣電,6,0,6,亞東-新竹,2024-01-15,2184
2324,仁寶,5,0,5,亞東-新竹,2024-01-15,2184
2354,鴻準,5,0,5,亞東-新竹,2024-01-15,2184
9921,巨大,5,0,5,亞東-新竹,2024-01-15,2184
1326,台化,5,0,5,亞東-新竹,2024-01-15,2184
1612,宏泰,5,0,5,亞東-新竹,2024-01-15,2184
00687B,國泰20年美債,4,0,4,亞東-新竹,2024-01-15,2184
00734B,台新JPM新興債,4,0,4,亞東-新竹,2024-01-15,2184
2427,三商電,4,0,4,亞東-新竹,2024-01-15,2184
2436,偉詮電,4,0,4,亞東-新竹,2024-01-15,2184
2634,漢翔,5,1,4,亞東-新竹,2024-01-15,2184
3105,穩懋,4,0,4,亞東-新竹,2024-01-15,2184
6204,艾華,4,0,4,亞東-新竹,2024-01-15,2184
6625,必應,4,0,4,亞東-新竹,2024-01-15,2184
2609,陽明,9,5,4,亞東-新竹,2024-01-15,2184
2382,廣達,8,5,3,亞東-新竹,2024-01-15,2184
2317,鴻海,3,0,3,亞東-新竹,2024-01-15,2184
00927,群益半導體收益,3,0,3,亞東-新竹,2024-01-15,2184
00725B,國泰投資級公司債,3,0,3,亞東-新竹,2024-01-15,2184
1909,榮成,3,0,3,亞東-新竹,2024-01-15,2184
2376,技嘉,4,1,3,亞東-新竹,2024-01-15,2184
2889,國票金,3,0,3,亞東-新竹,2024-01-15,2184
3543,州巧,3,0,3,亞東-新竹,2024-01-15,2184
5426,振發,36,33,3,亞東-新竹,2024-01-15,2184
6139,亞翔,6,3,3,亞東-新竹,2024-01-15,2184
00929,復華台灣科技優息,133,1,132,亞東-新竹,2024-01-16,2184
00720B,元大投資級公司債,61,0,61,亞東-新竹,2024-01-16,2184
2610,華航,60,0,60,亞東-新竹,2024-01-16,2184
2882,國泰金,61,4,57,亞東-新竹,2024-01-16,2184
0050,元大台灣50,32,0,32,亞東-新竹,2024-01-16,2184
00919,群益台灣精選高息,32,0,32,亞東-新竹,2024-01-16,2184
2002,中鋼,33,2,31,亞東-新竹,2024-01-16,2184
2543,皇昌,31,0,31,亞東-新竹,2024-01-16,2184
8096,擎亞,73,47,26,亞東-新竹,2024-01-16,2184
2867,三商壽,25,0,25,亞東-新竹,2024-01-16,2184
4908,前鼎,22,0,22,亞東-新竹,2024-01-16,2184
0056,元大高股息,35,13,22,亞東-新竹,2024-01-16,2184
3036,文曄,22,2,20,亞東-新竹,2024-01-16,2184
2887,台新金,19,0,19,亞東-新竹,2024-01-16,2184
1565,精華,19,0,19,亞東-新竹,2024-01-16,2184
1609,大亞,21,2,19,亞東-新竹,2024-01-16,2184
1528,恩德,19,2,17,亞東-新竹,2024-01-16,2184
2201,裕隆,24,8,16,亞東-新竹,2024-01-16,2184
2883,凱基金,15,0,15,亞東-新竹,2024-01-16,2184
00687B,國泰20年美債,14,0,14,亞東-新竹,2024-01-16,2184
2344,華邦電,23,9,14,亞東-新竹,2024-01-16,2184
2338,光罩,12,0,12,亞東-新竹,2024-01-16,2184
2618,長榮航,11,0,11,亞東-新竹,2024-01-16,2184
6443,元晶,11,0,11,亞東-新竹,2024-01-16,2184
4157,太景*-KY,20,10,10,亞東-新竹,2024-01-16,2184
4551,智伸科,10,0,10,亞東-新竹,2024-01-16,2184
6485,點序,10,0,10,亞東-新竹,2024-01-16,2184
6239,力成,9,0,9,亞東-新竹,2024-01-16,2184
8105,凌巨,10,1,9,亞東-新竹,2024-01-16,2184
3231,緯創,21,12,9,亞東-新竹,2024-01-16,2184
2454,聯發科,8,0,8,亞東-新竹,2024-01-16,2184
2353,宏��,68,60,8,亞東-新竹,2024-01-16,2184
5706,鳳凰,8,0,8,亞東-新竹,2024-01-16,2184
6248,沛波,8,0,8,亞東-新竹,2024-01-16,2184
2634,漢翔,8,1,7,亞東-新竹,2024-01-16,2184
2731,雄獅,7,0,7,亞東-新竹,2024-01-16,2184
3714,富采,7,0,7,亞東-新竹,2024-01-16,2184
6451,訊芯-KY,10,3,7,亞東-新竹,2024-01-16,2184
00878,國泰永續高股息,6,0,6,亞東-新竹,2024-01-16,2184
2308,台達電,6,0,6,亞東-新竹,2024-01-16,2184
1324,地球,6,0,6,亞東-新竹,2024-01-16,2184
00679B,元大美債20年,16,10,6,亞東-新竹,2024-01-16,2184
00753L,中信中國50正2,6,0,6,亞東-新竹,2024-01-16,2184
00935,野村臺灣新科技50,6,0,6,亞東-新竹,2024-01-16,2184
2362,藍天,6,0,6,亞東-新竹,2024-01-16,2184
2427,三商電,6,0,6,亞東-新竹,2024-01-16,2184
3206,志豐,6,0,6,亞東-新竹,2024-01-16,2184
2609,陽明,18,12,6,亞東-新竹,2024-01-16,2184
1301,台塑,5,0,5,亞東-新竹,2024-01-16,2184
2317,鴻海,5,0,5,亞東-新竹,2024-01-16,2184
2486,一詮,176,0,176,亞東-新竹,2024-01-17,2184
00688L,國泰20年美債正2,130,0,130,亞東-新竹,2024-01-17,2184
00680L,元大美債20正2,113,0,113,亞東-新竹,2024-01-17,2184
00919,群益台灣精選高息,92,2,90,亞東-新竹,2024-01-17,2184
0056,元大高股息,90,0,90,亞東-新竹,2024-01-17,2184
2610,華航,63,1,62,亞東-新竹,2024-01-17,2184
00751B,元大AAA至A公司債,59,0,59,亞東-新竹,2024-01-17,2184
2882,國泰金,58,1,57,亞東-新竹,2024-01-17,2184
00720B,元大投資級公司債,35,0,35,亞東-新竹,2024-01-17,2184
00937B,群益ESG投等債20,70,37,33,亞東-新竹,2024-01-17,2184
6770,力積電,33,0,33,亞東-新竹,2024-01-17,2184
6163,華電網,29,0,29,亞東-新竹,2024-01-17,2184
2884,玉山金,29,0,29,亞東-新竹,2024-01-17,2184
2885,元大金,25,0,25,亞東-新竹,2024-01-17,2184
2303,聯電,103,82,21,亞東-新竹,2024-01-17,2184
2801,彰銀,20,0,20,亞東-新竹,2024-01-17,2184
2838,聯邦銀,20,0,20,亞東-新竹,2024-01-17,2184
0050,元大台灣50,17,0,17,亞東-新竹,2024-01-17,2184
2887,台新金,17,0,17,亞東-新竹,2024-01-17,2184
00882,中信中國高股息,15,0,15,亞東-新竹,2024-01-17,2184
00888,永豐台灣ESG,15,0,15,亞東-新竹,2024-01-17,2184
1301,台塑,22,7,15,亞東-新竹,2024-01-17,2184
3694,海華,16,2,14,亞東-新竹,2024-01-17,2184
3034,聯詠,14,1,13,亞東-新竹,2024-01-17,2184
2338,光罩,13,0,13,亞東-新竹,2024-01-17,2184
3149,正達,13,0,13,亞東-新竹,2024-01-17,2184
00878,國泰永續高股息,12,0,12,亞東-新竹,2024-01-17,2184
00687B,國泰20年美債,12,0,12,亞東-新竹,2024-01-17,2184
2427,三商電,12,0,12,亞東-新竹,2024-01-17,2184
3357,臺慶科,12,0,12,亞東-新竹,2024-01-17,2184
4958,臻鼎-KY,12,0,12,亞東-新竹,2024-01-17,2184
00753L,中信中國50正2,11,0,11,亞東-新竹,2024-01-17,2184
2888,新光金,11,0,11,亞東-新竹,2024-01-17,2184
00679B,元大美債20年,15,5,10,亞東-新竹,2024-01-17,2184
2441,超豐,10,0,10,亞東-新竹,2024-01-17,2184
4157,太景*-KY,10,0,10,亞東-新竹,2024-01-17,2184
4551,智伸科,10,0,10,亞東-新竹,2024-01-17,2184
6125,廣運,10,0,10,亞東-新竹,2024-01-17,2184
2317,鴻海,9,1,8,亞東-新竹,2024-01-17,2184
2330,台積電,10,2,8,亞東-新竹,2024-01-17,2184
3260,威剛,8,0,8,亞東-新竹,2024-01-17,2184
00881,國泰台灣5G+,8,0,8,亞東-新竹,2024-01-17,2184
6425,易發,9,1,8,亞東-新竹,2024-01-17,2184
2344,華邦電,16,9,7,亞東-新竹,2024-01-17,2184
5880,合庫金,7,0,7,亞東-新竹,2024-01-17,2184
2883,凱基金,7,0,7,亞東-新竹,2024-01-17,2184
2892,第一金,6,0,6,亞東-新竹,2024-01-17,2184
2002,中鋼,6,0,6,亞東-新竹,2024-01-17,2184
3044,健鼎,6,0,6,亞東-新竹,2024-01-17,2184
2308,台達電,7,1,6,亞東-新竹,2024-01-17,2184
00929,復華台灣科技優息,64,16,48,亞東-新竹,2024-01-18,2184
4958,臻鼎-KY,35,0,35,亞東-新竹,2024-01-18,2184
2303,聯電,75,45,30,亞東-新竹,2024-01-18,2184
1795,美時,52,22,30,亞東-新竹,2024-01-18,2184
6120,達運,42,12,30,亞東-新竹,2024-01-18,2184
2405,輔信,32,10,22,亞東-新竹,2024-01-18,2184
2886,兆豐金,20,0,20,亞東-新竹,2024-01-18,2184
6190,萬泰科,18,0,18,亞東-新竹,2024-01-18,2184
1324,地球,16,0,16,亞東-新竹,2024-01-18,2184
00693U,期街口S＆P黃豆,15,0,15,亞東-新竹,2024-01-18,2184
00919,群益台灣精選高息,18,5,13,亞東-新竹,2024-01-18,2184
00733,富邦臺灣中小,13,0,13,亞東-新竹,2024-01-18,2184
3231,緯創,29,16,13,亞東-新竹,2024-01-18,2184
2002,中鋼,13,2,11,亞東-新竹,2024-01-18,2184
0050,元大台灣50,10,0,10,亞東-新竹,2024-01-18,2184
00877,復華中國5G,10,0,10,亞東-新竹,2024-01-18,2184
00679B,元大美債20年,11,1,10,亞東-新竹,2024-01-18,2184
2401,凌陽,10,0,10,亞東-新竹,2024-01-18,2184
6248,沛波,10,0,10,亞東-新竹,2024-01-18,2184
6485,點序,10,0,10,亞東-新竹,2024-01-18,2184
0056,元大高股息,13,3,10,亞東-新竹,2024-01-18,2184
00637L,元大滬深300正2,9,0,9,亞東-新竹,2024-01-18,2184
4960,誠美材,9,0,9,亞東-新竹,2024-01-18,2184
00687B,國泰20年美債,8,0,8,亞東-新竹,2024-01-18,2184
00937B,群益ESG投等債20,8,0,8,亞東-新竹,2024-01-18,2184
00882,中信中國高股息,7,0,7,亞東-新竹,2024-01-18,2184
2344,華邦電,17,10,7,亞東-新竹,2024-01-18,2184
00632R,元大台灣50反1,5,0,5,亞東-新竹,2024-01-18,2184
00680L,元大美債20正2,5,0,5,亞東-新竹,2024-01-18,2184
00738U,期元大道瓊白銀,5,0,5,亞東-新竹,2024-01-18,2184
2337,旺宏,7,2,5,亞東-新竹,2024-01-18,2184
2421,建準,5,0,5,亞東-新竹,2024-01-18,2184
2610,華航,5,0,5,亞東-新竹,2024-01-18,2184
4904,遠傳,5,0,5,亞東-新竹,2024-01-18,2184
5488,松普,5,0,5,亞東-新竹,2024-01-18,2184
4906,正文,5,0,5,亞東-新竹,2024-01-18,2184
2382,廣達,9,5,4,亞東-新竹,2024-01-18,2184
2308,台達電,4,0,4,亞東-新竹,2024-01-18,2184
2329,華泰,8,4,4,亞東-新竹,2024-01-18,2184
6451,訊芯-KY,6,2,4,亞東-新竹,2024-01-18,2184
9919,康那香,4,0,4,亞東-新竹,2024-01-18,2184
3260,威剛,3,0,3,亞東-新竹,2024-01-18,2184
00751B,元大AAA至A公司債,3,0,3,亞東-新竹,2024-01-18,2184
00927,群益半導體收益,3,0,3,亞東-新竹,2024-01-18,2184
1720,生達,3,0,3,亞東-新竹,2024-01-18,2184
2324,仁寶,3,0,3,亞東-新竹,2024-01-18,2184
2427,三商電,3,0,3,亞東-新竹,2024-01-18,2184
2727,王品,3,0,3,亞東-新竹,2024-01-18,2184
3029,零壹,5,2,3,亞東-新竹,2024-01-18,2184
6516,勤崴國際,3,0,3,亞東-新竹,2024-01-18,2184
00720B,元大投資級公司債,460,0,460,亞東-新竹,2024-01-19,2184
2356,英業達,120,13,107,亞東-新竹,2024-01-19,2184
00751B,元大AAA至A公司債,100,0,100,亞東-新竹,2024-01-19,2184
2353,宏��,214,116,98,亞東-新竹,2024-01-19,2184
2454,聯發科,50,0,50,亞東-新竹,2024-01-19,2184
3264,欣銓,50,3,47,亞東-新竹,2024-01-19,2184
00929,復華台灣科技優息,35,0,35,亞東-新竹,2024-01-19,2184
00892,富邦台灣半導體,35,0,35,亞東-新竹,2024-01-19,2184
5488,松普,30,5,25,亞東-新竹,2024-01-19,2184
00712,復華富時不動產,24,0,24,亞東-新竹,2024-01-19,2184
1101,台泥,22,0,22,亞東-新竹,2024-01-19,2184
2618,長榮航,28,8,20,亞東-新竹,2024-01-19,2184
2460,建通,20,0,20,亞東-新竹,2024-01-19,2184
0056,元大高股息,22,5,17,亞東-新竹,2024-01-19,2184
2405,輔信,36,20,16,亞東-新竹,2024-01-19,2184
00687B,國泰20年美債,15,0,15,亞東-新竹,2024-01-19,2184
00882,中信中國高股息,13,0,13,亞東-新竹,2024-01-19,2184
00931B,統一美債20年,13,0,13,亞東-新竹,2024-01-19,2184
00679B,元大美債20年,13,0,13,亞東-新竹,2024-01-19,2184
2409,友達,13,0,13,亞東-新竹,2024-01-19,2184
2377,微星,12,0,12,亞東-新竹,2024-01-19,2184
00631L,元大台灣50正2,13,2,11,亞東-新竹,2024-01-19,2184
3228,金麗科,10,0,10,亞東-新竹,2024-01-19,2184
00927,群益半導體收益,10,0,10,亞東-新竹,2024-01-19,2184
6116,彩晶,10,0,10,亞東-新竹,2024-01-19,2184
8222,寶一,10,0,10,亞東-新竹,2024-01-19,2184
8096,擎亞,20,11,9,亞東-新竹,2024-01-19,2184
00919,群益台灣精選高息,8,0,8,亞東-新竹,2024-01-19,2184
1324,地球,8,0,8,亞東-新竹,2024-01-19,2184
00696B,富邦美債20年,7,0,7,亞東-新竹,2024-01-19,2184
5426,振發,15,8,7,亞東-新竹,2024-01-19,2184
6451,訊芯-KY,6,0,6,亞東-新竹,2024-01-19,2184
00857B,永豐20年美公債,5,0,5,亞東-新竹,2024-01-19,2184
1616,億泰,5,0,5,亞東-新竹,2024-01-19,2184
2337,旺宏,5,0,5,亞東-新竹,2024-01-19,2184
2344,華邦電,22,17,5,亞東-新竹,2024-01-19,2184
2352,佳世達,5,0,5,亞東-新竹,2024-01-19,2184
2368,金像電,6,1,5,亞東-新竹,2024-01-19,2184
2915,潤泰全,5,0,5,亞東-新竹,2024-01-19,2184
3380,明泰,5,0,5,亞東-新竹,2024-01-19,2184
6485,點序,5,0,5,亞東-新竹,2024-01-19,2184
2464,盟立,4,0,4,亞東-新竹,2024-01-19,2184
2609,陽明,5,1,4,亞東-新竹,2024-01-19,2184
2812,台中銀,5,1,4,亞東-新竹,2024-01-19,2184
4116,明基醫,4,0,4,亞東-新竹,2024-01-19,2184
8215,明基材,4,0,4,亞東-新竹,2024-01-19,2184
9919,康那香,4,0,4,亞東-新竹,2024-01-19,2184
2303,聯電,25,22,3,亞東-新竹,2024-01-19,2184
2727,王品,3,0,3,亞東-新竹,2024-01-19,2184
2882,國泰金,4,1,3,亞東-新竹,2024-01-19,2184
2637,慧洋-KY,100,0,100,亞東-新竹,2024-01-22,2184
2885,元大金,100,0,100,亞東-新竹,2024-01-22,2184
2356,英業達,67,15,52,亞東-新竹,2024-01-22,2184
00795B,中信美國公債20年,49,0,49,亞東-新竹,2024-01-22,2184
6257,矽格,44,2,42,亞東-新竹,2024-01-22,2184
00885,富邦越南,40,1,39,亞東-新竹,2024-01-22,2184
3147,大綜,33,0,33,亞東-新竹,2024-01-22,2184
2454,聯發科,32,1,31,亞東-新竹,2024-01-22,2184
3481,群創,333,305,28,亞東-新竹,2024-01-22,2184
3483,力致,20,0,20,亞東-新竹,2024-01-22,2184
2317,鴻海,19,0,19,亞東-新竹,2024-01-22,2184
00927,群益半導體收益,19,0,19,亞東-新竹,2024-01-22,2184
2886,兆豐金,17,0,17,亞東-新竹,2024-01-22,2184
2363,矽統,15,1,14,亞東-新竹,2024-01-22,2184
6196,帆宣,13,0,13,亞東-新竹,2024-01-22,2184
00687B,國泰20年美債,12,0,12,亞東-新竹,2024-01-22,2184
2301,光寶科,14,2,12,亞東-新竹,2024-01-22,2184
00751B,元大AAA至A公司債,50,40,10,亞東-新竹,2024-01-22,2184
2520,冠德,10,0,10,亞東-新竹,2024-01-22,2184
00882,中信中國高股息,13,4,9,亞東-新竹,2024-01-22,2184
00937B,群益ESG投等債20,9,0,9,亞東-新竹,2024-01-22,2184
00753L,中信中國50正2,8,0,8,亞東-新竹,2024-01-22,2184
2201,裕隆,10,2,8,亞東-新竹,2024-01-22,2184
3293,鈊象,8,0,8,亞東-新竹,2024-01-22,2184
0056,元大高股息,51,44,7,亞東-新竹,2024-01-22,2184
8096,擎亞,15,8,7,亞東-新竹,2024-01-22,2184
6190,萬泰科,6,0,6,亞東-新竹,2024-01-22,2184
2743,山富,5,0,5,亞東-新竹,2024-01-22,2184
3504,揚明光,5,0,5,亞東-新竹,2024-01-22,2184
4551,智伸科,5,0,5,亞東-新竹,2024-01-22,2184
5439,高技,5,0,5,亞東-新竹,2024-01-22,2184
5488,松普,5,0,5,亞東-新竹,2024-01-22,2184
6485,點序,5,0,5,亞東-新竹,2024-01-22,2184
1102,亞泥,4,0,4,亞東-新竹,2024-01-22,2184
2465,麗臺,4,0,4,亞東-新竹,2024-01-22,2184
2727,王品,9,5,4,亞東-新竹,2024-01-22,2184
4904,遠傳,4,0,4,亞東-新竹,2024-01-22,2184
6584,南俊國際,5,1,4,亞東-新竹,2024-01-22,2184
9907,統一實,4,0,4,亞東-新竹,2024-01-22,2184
00936,台新永續高息中小,5,2,3,亞東-新竹,2024-01-22,2184
00931B,統一美債20年,3,0,3,亞東-新竹,2024-01-22,2184
1216,統一,3,0,3,亞東-新竹,2024-01-22,2184
00923,群益台ESG低碳50,3,0,3,亞東-新竹,2024-01-22,2184
1301,台塑,5,2,3,亞東-新竹,2024-01-22,2184
2436,偉詮電,3,0,3,亞東-新竹,2024-01-22,2184
5880,合庫金,3,0,3,亞東-新竹,2024-01-22,2184
6451,訊芯-KY,3,0,3,亞東-新竹,2024-01-22,2184
8033,雷虎,3,0,3,亞東-新竹,2024-01-22,2184
2618,長榮航,53,50,3,亞東-新竹,2024-01-22,2184
3706,神達,6,3,3,亞東-新竹,2024-01-22,2184
00885,富邦越南,100,0,100,亞東-新竹,2024-01-23,2184
00937B,群益ESG投等債20,58,0,58,亞東-新竹,2024-01-23,2184
1513,中興電,60,8,52,亞東-新竹,2024-01-23,2184
00751B,元大AAA至A公司債,52,1,51,亞東-新竹,2024-01-23,2184
00892,富邦台灣半導體,50,0,50,亞東-新竹,2024-01-23,2184
00882,中信中國高股息,50,0,50,亞東-新竹,2024-01-23,2184
3264,欣銓,26,0,26,亞東-新竹,2024-01-23,2184
2316,楠梓電,23,0,23,亞東-新竹,2024-01-23,2184
00907,永豐優息存股,20,0,20,亞東-新竹,2024-01-23,2184
00690,兆豐藍籌30,20,0,20,亞東-新竹,2024-01-23,2184
2618,長榮航,17,2,15,亞東-新竹,2024-01-23,2184
00679B,元大美債20年,15,0,15,亞東-新竹,2024-01-23,2184
2486,一詮,14,1,13,亞東-新竹,2024-01-23,2184
6239,力成,13,1,12,亞東-新竹,2024-01-23,2184
2376,技嘉,16,5,11,亞東-新竹,2024-01-23,2184
3217,優群,10,0,10,亞東-新竹,2024-01-23,2184
00773B,中信優先金融債,10,0,10,亞東-新竹,2024-01-23,2184
3504,揚明光,10,0,10,亞東-新竹,2024-01-23,2184
1326,台化,9,0,9,亞東-新竹,2024-01-23,2184
8059,凱碩,9,0,9,亞東-新竹,2024-01-23,2184
2002,中鋼,8,0,8,亞東-新竹,2024-01-23,2184
6219,富旺,7,0,7,亞東-新竹,2024-01-23,2184
3232,昱捷,6,0,6,亞東-新竹,2024-01-23,2184
3615,安可,6,0,6,亞東-新竹,2024-01-23,2184
4714,永捷,6,0,6,亞東-新竹,2024-01-23,2184
00935,野村臺灣新科技50,5,0,5,亞東-新竹,2024-01-23,2184
00740B,富邦全球投等債,5,0,5,亞東-新竹,2024-01-23,2184
00738U,期元大道瓊白銀,5,0,5,亞東-新竹,2024-01-23,2184
1325,恆大,15,10,5,亞東-新竹,2024-01-23,2184
2609,陽明,11,6,5,亞東-新竹,2024-01-23,2184
4979,華星光,5,0,5,亞東-新竹,2024-01-23,2184
8096,擎亞,33,28,5,亞東-新竹,2024-01-23,2184
9907,統一實,5,0,5,亞東-新竹,2024-01-23,2184
9921,巨大,5,0,5,亞東-新竹,2024-01-23,2184
00680L,元大美債20正2,4,0,4,亞東-新竹,2024-01-23,2184
2363,矽統,14,10,4,亞東-新竹,2024-01-23,2184
3443,創意,8,4,4,亞東-新竹,2024-01-23,2184
3523,迎輝,4,0,4,亞東-新竹,2024-01-23,2184
3645,達邁,4,0,4,亞東-新竹,2024-01-23,2184
6462,神盾,18,14,4,亞東-新竹,2024-01-23,2184
2886,兆豐金,3,0,3,亞東-新竹,2024-01-23,2184
1324,地球,3,0,3,亞東-新竹,2024-01-23,2184
00724B,群益投資級金融債,3,0,3,亞東-新竹,2024-01-23,2184
1434,福懋,3,0,3,亞東-新竹,2024-01-23,2184
1720,生達,3,0,3,亞東-新竹,2024-01-23,2184
2344,華邦電,16,13,3,亞東-新竹,2024-01-23,2184
2634,漢翔,3,0,3,亞東-新竹,2024-01-23,2184
4960,誠美材,4,1,3,亞東-新竹,2024-01-23,2184
6213,聯茂,3,0,3,亞東-新竹,2024-01-23,2184
00713,元大台灣高息低波,2,0,2,亞東-新竹,2024-01-23,2184
00885,富邦越南,70,0,70,亞東-新竹,2024-01-24,2184
00751B,元大AAA至A公司債,53,0,53,亞東-新竹,2024-01-24,2184
00892,富邦台灣半導體,44,0,44,亞東-新竹,2024-01-24,2184
3623,富晶通,34,0,34,亞東-新竹,2024-01-24,2184
2462,良得電,30,0,30,亞東-新竹,2024-01-24,2184
00937B,群益ESG投等債20,29,0,29,亞東-新竹,2024-01-24,2184
00637L,元大滬深300正2,75,50,25,亞東-新竹,2024-01-24,2184
1609,大亞,22,0,22,亞東-新竹,2024-01-24,2184
2369,菱生,21,0,21,亞東-新竹,2024-01-24,2184
1513,中興電,20,0,20,亞東-新竹,2024-01-24,2184
1616,億泰,20,0,20,亞東-新竹,2024-01-24,2184
00679B,元大美債20年,15,0,15,亞東-新竹,2024-01-24,2184
3030,德律,14,0,14,亞東-新竹,2024-01-24,2184
6589,台康生技,14,0,14,亞東-新竹,2024-01-24,2184
00680L,元大美債20正2,11,0,11,亞東-新竹,2024-01-24,2184
2356,英業達,20,9,11,亞東-新竹,2024-01-24,2184
3231,緯創,27,16,11,亞東-新竹,2024-01-24,2184
00902,中信電池及儲能,10,0,10,亞東-新竹,2024-01-24,2184
2002,中鋼,10,0,10,亞東-新竹,2024-01-24,2184
1522,堤維西,8,0,8,亞東-新竹,2024-01-24,2184
2606,裕民,9,1,8,亞東-新竹,2024-01-24,2184
3380,明泰,8,0,8,亞東-新竹,2024-01-24,2184
3715,定穎投控,16,8,8,亞東-新竹,2024-01-24,2184
00933B,國泰10Y+金融債,7,0,7,亞東-新竹,2024-01-24,2184
00687B,國泰20年美債,7,0,7,亞東-新竹,2024-01-24,2184
00753L,中信中國50正2,13,6,7,亞東-新竹,2024-01-24,2184
1785,光洋科,24,17,7,亞東-新竹,2024-01-24,2184
00904,新光臺灣半導體30,6,0,6,亞東-新竹,2024-01-24,2184
00929,復華台灣科技優息,16,10,6,亞東-新竹,2024-01-24,2184
2069,運錩,6,0,6,亞東-新竹,2024-01-24,2184
2363,矽統,6,0,6,亞東-新竹,2024-01-24,2184
00935,野村臺灣新科技50,5,0,5,亞東-新竹,2024-01-24,2184
00740B,富邦全球投等債,5,0,5,亞東-新竹,2024-01-24,2184
00688L,國泰20年美債正2,5,0,5,亞東-新竹,2024-01-24,2184
1459,聯發,5,0,5,亞東-新竹,2024-01-24,2184
1618,合機,5,0,5,亞東-新竹,2024-01-24,2184
3051,力特,5,0,5,亞東-新竹,2024-01-24,2184
3149,正達,5,0,5,亞東-新竹,2024-01-24,2184
2301,光寶科,4,0,4,亞東-新竹,2024-01-24,2184
0056,元大高股息,11,7,4,亞東-新竹,2024-01-24,2184
3712,永崴投控,4,0,4,亞東-新竹,2024-01-24,2184
00923,群益台ESG低碳50,4,0,4,亞東-新竹,2024-01-24,2184
6531,愛普*,6,3,3,亞東-新竹,2024-01-24,2184
2329,華泰,3,0,3,亞東-新竹,2024-01-24,2184
2382,廣達,6,3,3,亞東-新竹,2024-01-24,2184
3260,威剛,10,7,3,亞東-新竹,2024-01-24,2184
1216,統一,3,0,3,亞東-新竹,2024-01-24,2184
00931B,統一美債20年,3,0,3,亞東-新竹,2024-01-24,2184
00936,台新永續高息中小,3,0,3,亞東-新竹,2024-01-24,2184
00934,中信成長高股息,3,0,3,亞東-新竹,2024-01-24,2184
00751B,元大AAA至A公司債,110,0,110,亞東-新竹,2024-01-25,2184
2885,元大金,71,0,71,亞東-新竹,2024-01-25,2184
0056,元大高股息,44,3,41,亞東-新竹,2024-01-25,2184
2610,華航,40,0,40,亞東-新竹,2024-01-25,2184
00892,富邦台灣半導體,30,0,30,亞東-新竹,2024-01-25,2184
2313,華通,30,0,30,亞東-新竹,2024-01-25,2184
3036,文曄,25,2,23,亞東-新竹,2024-01-25,2184
00885,富邦越南,20,0,20,亞東-新竹,2024-01-25,2184
1618,合機,20,0,20,亞東-新竹,2024-01-25,2184
2460,建通,20,0,20,亞東-新竹,2024-01-25,2184
2637,慧洋-KY,20,0,20,亞東-新竹,2024-01-25,2184
1795,美時,30,12,18,亞東-新竹,2024-01-25,2184
00937B,群益ESG投等債20,17,0,17,亞東-新竹,2024-01-25,2184
00679B,元大美債20年,15,0,15,亞東-新竹,2024-01-25,2184
4729,熒茂,15,0,15,亞東-新竹,2024-01-25,2184
00931B,統一美債20年,14,0,14,亞東-新竹,2024-01-25,2184
00687B,國泰20年美債,16,3,13,亞東-新竹,2024-01-25,2184
2486,一詮,13,0,13,亞東-新竹,2024-01-25,2184
3504,揚明光,13,0,13,亞東-新竹,2024-01-25,2184
2382,廣達,14,2,12,亞東-新竹,2024-01-25,2184
3055,蔚華科,12,0,12,亞東-新竹,2024-01-25,2184
00933B,國泰10Y+金融債,11,0,11,亞東-新竹,2024-01-25,2184
6451,訊芯-KY,10,0,10,亞東-新竹,2024-01-25,2184
00773B,中信優先金融債,10,0,10,亞東-新竹,2024-01-25,2184
2344,華邦電,20,10,10,亞東-新竹,2024-01-25,2184
3522,御嵿,10,0,10,亞東-新竹,2024-01-25,2184
8222,寶一,10,0,10,亞東-新竹,2024-01-25,2184
00637L,元大滬深300正2,11,3,8,亞東-新竹,2024-01-25,2184
2059,川湖,8,0,8,亞東-新竹,2024-01-25,2184
00720B,元大投資級公司債,7,0,7,亞東-新竹,2024-01-25,2184
3443,創意,7,1,6,亞東-新竹,2024-01-25,2184
2314,台揚,6,0,6,亞東-新竹,2024-01-25,2184
8926,台汽電,6,0,6,亞東-新竹,2024-01-25,2184
3362,先進光,6,1,5,亞東-新竹,2024-01-25,2184
1785,光洋科,5,0,5,亞東-新竹,2024-01-25,2184
2359,所羅門,5,0,5,亞東-新竹,2024-01-25,2184
2727,王品,5,0,5,亞東-新竹,2024-01-25,2184
3051,力特,5,0,5,亞東-新竹,2024-01-25,2184
3149,正達,5,0,5,亞東-新竹,2024-01-25,2184
4157,太景*-KY,5,0,5,亞東-新竹,2024-01-25,2184
4977,眾達-KY,5,0,5,亞東-新竹,2024-01-25,2184
5488,松普,5,0,5,亞東-新竹,2024-01-25,2184
6202,盛群,5,0,5,亞東-新竹,2024-01-25,2184
6485,點序,5,0,5,亞東-新竹,2024-01-25,2184
6550,北極星藥業-KY,5,0,5,亞東-新竹,2024-01-25,2184
00680L,元大美債20正2,4,0,4,亞東-新竹,2024-01-25,2184
2201,裕隆,14,10,4,亞東-新竹,2024-01-25,2184
2405,輔信,4,0,4,亞東-新竹,2024-01-25,2184
00923,群益台ESG低碳50,3,0,3,亞東-新竹,2024-01-25,2184
00857B,永豐20年美公債,3,0,3,亞東-新竹,2024-01-25,2184
2303,聯電,139,19,120,亞東-新竹,2024-01-26,2184
00919,群益台灣精選高息,94,0,94,亞東-新竹,2024-01-26,2184
2885,元大金,70,0,70,亞東-新竹,2024-01-26,2184
00929,復華台灣科技優息,58,2,56,亞東-新竹,2024-01-26,2184
00751B,元大AAA至A公司債,55,0,55,亞東-新竹,2024-01-26,2184
00679B,元大美債20年,38,0,38,亞東-新竹,2024-01-26,2184
4729,熒茂,31,1,30,亞東-新竹,2024-01-26,2184
00892,富邦台灣半導體,26,0,26,亞東-新竹,2024-01-26,2184
2401,凌陽,24,0,24,亞東-新竹,2024-01-26,2184
00878,國泰永續高股息,21,4,17,亞東-新竹,2024-01-26,2184
3035,智原,21,6,15,亞東-新竹,2024-01-26,2184
9958,世紀鋼,15,0,15,亞東-新竹,2024-01-26,2184
00937B,群益ESG投等債20,14,0,14,亞東-新竹,2024-01-26,2184
2376,技嘉,14,0,14,亞東-新竹,2024-01-26,2184
1301,台塑,13,0,13,亞東-新竹,2024-01-26,2184
2543,皇昌,11,0,11,亞東-新竹,2024-01-26,2184
3217,優群,10,0,10,亞東-新竹,2024-01-26,2184
6167,久正,10,0,10,亞東-新竹,2024-01-26,2184
2329,華泰,12,4,8,亞東-新竹,2024-01-26,2184
2356,英業達,12,4,8,亞東-新竹,2024-01-26,2184
2353,宏��,22,14,8,亞東-新竹,2024-01-26,2184
3034,聯詠,7,0,7,亞東-新竹,2024-01-26,2184
0056,元大高股息,7,0,7,亞東-新竹,2024-01-26,2184
1325,恆大,6,0,6,亞東-新竹,2024-01-26,2184
00934,中信成長高股息,6,0,6,亞東-新竹,2024-01-26,2184
4916,事欣科,6,0,6,亞東-新竹,2024-01-26,2184
5483,中美晶,6,0,6,亞東-新竹,2024-01-26,2184
6733,博晟生醫,6,0,6,亞東-新竹,2024-01-26,2184
00830,國泰費城半導體,5,0,5,亞東-新竹,2024-01-26,2184
3714,富采,5,0,5,亞東-新竹,2024-01-26,2184
4956,光鋐,5,0,5,亞東-新竹,2024-01-26,2184
00936,台新永續高息中小,4,0,4,亞東-新竹,2024-01-26,2184
00687B,國泰20年美債,4,0,4,亞東-新竹,2024-01-26,2184
00680L,元大美債20正2,4,0,4,亞東-新竹,2024-01-26,2184
00696B,富邦美債20年,4,0,4,亞東-新竹,2024-01-26,2184
1565,精華,4,0,4,亞東-新竹,2024-01-26,2184
1784,訊聯,4,0,4,亞東-新竹,2024-01-26,2184
2101,南港,4,0,4,亞東-新竹,2024-01-26,2184
3260,威剛,4,0,4,亞東-新竹,2024-01-26,2184
4126,太醫,4,0,4,亞東-新竹,2024-01-26,2184
6219,富旺,4,0,4,亞東-新竹,2024-01-26,2184
00927,群益半導體收益,3,0,3,亞東-新竹,2024-01-26,2184
00795B,中信美國公債20年,3,0,3,亞東-新竹,2024-01-26,2184
1432,大魯閣,3,0,3,亞東-新竹,2024-01-26,2184
2406,國碩,3,0,3,亞東-新竹,2024-01-26,2184
2645,長榮航太,3,0,3,亞東-新竹,2024-01-26,2184
3066,李洲,12,9,3,亞東-新竹,2024-01-26,2184
3706,神達,3,0,3,亞東-新竹,2024-01-26,2184
6188,廣明,3,0,3,亞東-新竹,2024-01-26,2184
3443,創意,5,3,2,亞東-新竹,2024-01-26,2184
2885,元大金,282,0,282,亞東-新竹,2024-01-29,2184
00751B,元大AAA至A公司債,105,0,105,亞東-新竹,2024-01-29,2184
00679B,元大美債20年,67,2,65,亞東-新竹,2024-01-29,2184
2605,新興,40,0,40,亞東-新竹,2024-01-29,2184
2303,聯電,20,2,18,亞東-新竹,2024-01-29,2184
3041,揚智,15,2,13,亞東-新竹,2024-01-29,2184
1301,台塑,10,0,10,亞東-新竹,2024-01-29,2184
1806,冠軍,10,0,10,亞東-新竹,2024-01-29,2184
2369,菱生,10,0,10,亞東-新竹,2024-01-29,2184
3522,御嵿,10,0,10,亞東-新竹,2024-01-29,2184
8112,至上,10,0,10,亞東-新竹,2024-01-29,2184
00933B,國泰10Y+金融債,10,1,9,亞東-新竹,2024-01-29,2184
00687B,國泰20年美債,9,0,9,亞東-新竹,2024-01-29,2184
8936,國統,8,0,8,亞東-新竹,2024-01-29,2184
3066,李洲,11,4,7,亞東-新竹,2024-01-29,2184
5426,振發,49,42,7,亞東-新竹,2024-01-29,2184
2355,敬鵬,6,0,6,亞東-新竹,2024-01-29,2184
00688L,國泰20年美債正2,5,0,5,亞東-新竹,2024-01-29,2184
00830,國泰費城半導體,5,0,5,亞東-新竹,2024-01-29,2184
1733,五鼎,5,0,5,亞東-新竹,2024-01-29,2184
2208,台船,5,0,5,亞東-新竹,2024-01-29,2184
2317,鴻海,10,5,5,亞東-新竹,2024-01-29,2184
2897,王道銀行,5,0,5,亞東-新竹,2024-01-29,2184
3450,聯鈞,7,2,5,亞東-新竹,2024-01-29,2184
3587,閎康,5,0,5,亞東-新竹,2024-01-29,2184
4958,臻鼎-KY,5,0,5,亞東-新竹,2024-01-29,2184
1513,中興電,4,0,4,亞東-新竹,2024-01-29,2184
1720,生達,4,0,4,亞東-新竹,2024-01-29,2184
2727,王品,5,1,4,亞東-新竹,2024-01-29,2184
3272,東碩,4,0,4,亞東-新竹,2024-01-29,2184
3360,尚立,10,6,4,亞東-新竹,2024-01-29,2184
00878,國泰永續高股息,5,2,3,亞東-新竹,2024-01-29,2184
00937B,群益ESG投等債20,3,0,3,亞東-新竹,2024-01-29,2184
00931B,統一美債20年,3,0,3,亞東-新竹,2024-01-29,2184
1605,華新,3,0,3,亞東-新竹,2024-01-29,2184
1324,地球,3,0,3,亞東-新竹,2024-01-29,2184
2002,中鋼,3,0,3,亞東-新竹,2024-01-29,2184
3529,力旺,4,1,3,亞東-新竹,2024-01-29,2184
5234,達興材料,3,0,3,亞東-新竹,2024-01-29,2184
6104,創惟,3,0,3,亞東-新竹,2024-01-29,2184
6405,悅城,3,0,3,亞東-新竹,2024-01-29,2184
1565,精華,2,0,2,亞東-新竹,2024-01-29,2184
1784,訊聯,2,0,2,亞東-新竹,2024-01-29,2184
3047,訊舟,2,0,2,亞東-新竹,2024-01-29,2184
6282,康舒,6,4,2,亞東-新竹,2024-01-29,2184
5469,瀚宇博,1,0,1,亞東-新竹,2024-01-29,2184
6271,同欣電,1,0,1,亞東-新竹,2024-01-29,2184
00740B,富邦全球投等債,1,0,1,亞東-新竹,2024-01-29,2184
00712,復華富時不動產,1,0,1,亞東-新竹,2024-01-29,2184
00881,國泰台灣5G+,1,0,1,亞東-新竹,2024-01-29,2184
2885,元大金,512,50,462,亞東-新竹,2024-01-30,2184
00923,群益台ESG低碳50,62,0,62,亞東-新竹,2024-01-30,2184
00929,復華台灣科技優息,50,4,46,亞東-新竹,2024-01-30,2184
8064,東捷,52,12,40,亞東-新竹,2024-01-30,2184
6770,力積電,35,1,34,亞東-新竹,2024-01-30,2184
2887,台新金,29,0,29,亞東-新竹,2024-01-30,2184
3623,富晶通,50,25,25,亞東-新竹,2024-01-30,2184
00751B,元大AAA至A公司債,24,0,24,亞東-新竹,2024-01-30,2184
2838,聯邦銀,20,0,20,亞東-新竹,2024-01-30,2184
5251,天鉞電,20,0,20,亞東-新竹,2024-01-30,2184
2313,華通,20,1,19,亞東-新竹,2024-01-30,2184
3481,群創,16,0,16,亞東-新竹,2024-01-30,2184
2618,長榮航,25,10,15,亞東-新竹,2024-01-30,2184
00877,復華中國5G,12,0,12,亞東-新竹,2024-01-30,2184
2303,聯電,14,2,12,亞東-新竹,2024-01-30,2184
2520,冠德,11,0,11,亞東-新竹,2024-01-30,2184
00680L,元大美債20正2,10,0,10,亞東-新竹,2024-01-30,2184
2201,裕隆,20,10,10,亞東-新竹,2024-01-30,2184
6248,沛波,10,0,10,亞東-新竹,2024-01-30,2184
9921,巨大,10,0,10,亞東-新竹,2024-01-30,2184
00919,群益台灣精選高息,40,31,9,亞東-新竹,2024-01-30,2184
00753L,中信中國50正2,9,0,9,亞東-新竹,2024-01-30,2184
5871,中租-KY,9,0,9,亞東-新竹,2024-01-30,2184
2363,矽統,8,0,8,亞東-新竹,2024-01-30,2184
4977,眾達-KY,8,0,8,亞東-新竹,2024-01-30,2184
00687B,國泰20年美債,7,0,7,亞東-新竹,2024-01-30,2184
1101,台泥,11,4,7,亞東-新竹,2024-01-30,2184
2727,王品,6,0,6,亞東-新竹,2024-01-30,2184
6113,亞矽,6,0,6,亞東-新竹,2024-01-30,2184
3034,聯詠,6,1,5,亞東-新竹,2024-01-30,2184
1301,台塑,5,0,5,亞東-新竹,2024-01-30,2184
1785,光洋科,5,0,5,亞東-新竹,2024-01-30,2184
2033,佳大,5,0,5,亞東-新竹,2024-01-30,2184
2405,輔信,5,0,5,亞東-新竹,2024-01-30,2184
3605,宏致,5,0,5,亞東-新竹,2024-01-30,2184
3645,達邁,5,0,5,亞東-新竹,2024-01-30,2184
4123,晟德,5,0,5,亞東-新竹,2024-01-30,2184
6485,點序,5,0,5,亞東-新竹,2024-01-30,2184
8096,擎亞,11,6,5,亞東-新竹,2024-01-30,2184
2427,三商電,4,0,4,亞東-新竹,2024-01-30,2184
00936,台新永續高息中小,4,0,4,亞東-新竹,2024-01-30,2184
00633L,富邦上証正2,4,0,4,亞東-新竹,2024-01-30,2184
2314,台揚,4,0,4,亞東-新竹,2024-01-30,2184
2337,旺宏,4,0,4,亞東-新竹,2024-01-30,2184
6589,台康生技,5,1,4,亞東-新竹,2024-01-30,2184
1316,上曜,3,0,3,亞東-新竹,2024-01-30,2184
00637L,元大滬深300正2,3,0,3,亞東-新竹,2024-01-30,2184
2002,中鋼,3,0,3,亞東-新竹,2024-01-30,2184
2353,宏��,11,8,3,亞東-新竹,2024-01-30,2184
2609,陽明,11,8,3,亞東-新竹,2024-01-30,2184
2303,聯電,56,0,56,亞東-新竹,2024-01-31,2184
6163,華電網,52,0,52,亞東-新竹,2024-01-31,2184
1101,台泥,41,1,40,亞東-新竹,2024-01-31,2184
00632R,元大台灣50反1,40,0,40,亞東-新竹,2024-01-31,2184
3231,緯創,36,13,23,亞東-新竹,2024-01-31,2184
00935,野村臺灣新科技50,16,0,16,亞東-新竹,2024-01-31,2184
3260,威剛,15,0,15,亞東-新竹,2024-01-31,2184
2330,台積電,13,0,13,亞東-新竹,2024-01-31,2184
2883,凱基金,13,0,13,亞東-新竹,2024-01-31,2184
2520,冠德,12,0,12,亞東-新竹,2024-01-31,2184
6113,亞矽,12,1,11,亞東-新竹,2024-01-31,2184
00891,中信關鍵半導體,10,0,10,亞東-新竹,2024-01-31,2184
00753L,中信中國50正2,10,0,10,亞東-新竹,2024-01-31,2184
2838,聯邦銀,10,0,10,亞東-新竹,2024-01-31,2184
8064,東捷,10,0,10,亞東-新竹,2024-01-31,2184
6139,亞翔,11,2,9,亞東-新竹,2024-01-31,2184
6179,亞通,9,0,9,亞東-新竹,2024-01-31,2184
2353,宏��,10,2,8,亞東-新竹,2024-01-31,2184
8227,巨有科技,14,6,8,亞東-新竹,2024-01-31,2184
00878,國泰永續高股息,8,0,8,亞東-新竹,2024-01-31,2184
00857B,永豐20年美公債,7,0,7,亞東-新竹,2024-01-31,2184
2344,華邦電,17,11,6,亞東-新竹,2024-01-31,2184
2618,長榮航,6,0,6,亞東-新竹,2024-01-31,2184
2727,王品,6,0,6,亞東-新竹,2024-01-31,2184
8936,國統,6,0,6,亞東-新竹,2024-01-31,2184
00830,國泰費城半導體,5,0,5,亞東-新竹,2024-01-31,2184
3481,群創,15,10,5,亞東-新竹,2024-01-31,2184
5483,中美晶,5,0,5,亞東-新竹,2024-01-31,2184
2454,聯發科,6,1,5,亞東-新竹,2024-01-31,2184
00679B,元大美債20年,6,2,4,亞東-新竹,2024-01-31,2184
1324,地球,4,0,4,亞東-新竹,2024-01-31,2184
2634,漢翔,5,1,4,亞東-新竹,2024-01-31,2184
3030,德律,4,0,4,亞東-新竹,2024-01-31,2184
3450,聯鈞,6,2,4,亞東-新竹,2024-01-31,2184
6462,神盾,15,11,4,亞東-新竹,2024-01-31,2184
2308,台達電,4,1,3,亞東-新竹,2024-01-31,2184
00882,中信中國高股息,3,0,3,亞東-新竹,2024-01-31,2184
2427,三商電,3,0,3,亞東-新竹,2024-01-31,2184
00637L,元大滬深300正2,3,0,3,亞東-新竹,2024-01-31,2184
1434,福懋,3,0,3,亞東-新竹,2024-01-31,2184
3583,辛耘,3,0,3,亞東-新竹,2024-01-31,2184
6180,橘子,3,0,3,亞東-新竹,2024-01-31,2184
4155,訊映,3,1,2,亞東-新竹,2024-01-31,2184
3035,智原,2,0,2,亞東-新竹,2024-01-31,2184
3055,蔚華科,15,13,2,亞東-新竹,2024-01-31,2184
9941,裕融,2,0,2,亞東-新竹,2024-01-31,2184
1565,精華,2,0,2,亞東-新竹,2024-01-31,2184
0061,元大寶滬深,2,0,2,亞東-新竹,2024-01-31,2184
2338,光罩,2,0,2,亞東-新竹,2024-01-31,2184
2355,敬鵬,2,0,2,亞東-新竹,2024-01-31,2184
00929,復華台灣科技優息,170,0,170,亞東-新竹,2024-02-01,2184
00937B,群益ESG投等債20,106,20,86,亞東-新竹,2024-02-01,2184
00795B,中信美國公債20年,67,3,64,亞東-新竹,2024-02-01,2184
2885,元大金,110,51,59,亞東-新竹,2024-02-01,2184
2812,台中銀,58,6,52,亞東-新竹,2024-02-01,2184
4729,熒茂,40,0,40,亞東-新竹,2024-02-01,2184
6270,倍微,39,0,39,亞東-新竹,2024-02-01,2184
00919,群益台灣精選高息,40,3,37,亞東-新竹,2024-02-01,2184
00878,國泰永續高股息,36,1,35,亞東-新竹,2024-02-01,2184
00712,復華富時不動產,35,0,35,亞東-新竹,2024-02-01,2184
2520,冠德,30,0,30,亞東-新竹,2024-02-01,2184
3481,群創,31,1,30,亞東-新竹,2024-02-01,2184
8111,立��,29,2,27,亞東-新竹,2024-02-01,2184
00935,野村臺灣新科技50,23,0,23,亞東-新竹,2024-02-01,2184
2382,廣達,14,1,13,亞東-新竹,2024-02-01,2184
00877,復華中國5G,11,0,11,亞東-新竹,2024-02-01,2184
00891,中信關鍵半導體,10,0,10,亞東-新竹,2024-02-01,2184
00664R,國泰臺灣加權反1,10,0,10,亞東-新竹,2024-02-01,2184
3338,泰碩,10,0,10,亞東-新竹,2024-02-01,2184
2303,聯電,27,20,7,亞東-新竹,2024-02-01,2184
2369,菱生,5,0,5,亞東-新竹,2024-02-01,2184
3005,神基,5,0,5,亞東-新竹,2024-02-01,2184
4908,前鼎,5,0,5,亞東-新竹,2024-02-01,2184
6116,彩晶,5,0,5,亞東-新竹,2024-02-01,2184
00720B,元大投資級公司債,16,12,4,亞東-新竹,2024-02-01,2184
3580,友威科,4,0,4,亞東-新竹,2024-02-01,2184
5381,合正,4,0,4,亞東-新竹,2024-02-01,2184
6139,亞翔,5,1,4,亞東-新竹,2024-02-01,2184
2364,倫飛,3,0,3,亞東-新竹,2024-02-01,2184
2409,友達,3,0,3,亞東-新竹,2024-02-01,2184
2460,建通,5,2,3,亞東-新竹,2024-02-01,2184
3360,尚立,4,1,3,亞東-新竹,2024-02-01,2184
5351,鈺創,3,0,3,亞東-新竹,2024-02-01,2184
6488,環球晶,3,0,3,亞東-新竹,2024-02-01,2184
2454,聯發科,2,0,2,亞東-新竹,2024-02-01,2184
2330,台積電,4,2,2,亞東-新竹,2024-02-01,2184
1722,台肥,2,0,2,亞東-新竹,2024-02-01,2184
1795,美時,2,0,2,亞東-新竹,2024-02-01,2184
2301,光寶科,2,0,2,亞東-新竹,2024-02-01,2184
2476,鉅祥,2,0,2,亞東-新竹,2024-02-01,2184
3312,弘憶股,2,0,2,亞東-新竹,2024-02-01,2184
3515,華擎,2,0,2,亞東-新竹,2024-02-01,2184
4958,臻鼎-KY,2,0,2,亞東-新竹,2024-02-01,2184
6210,慶生,2,0,2,亞東-新竹,2024-02-01,2184
6782,視陽,2,0,2,亞東-新竹,2024-02-01,2184
8222,寶一,2,0,2,亞東-新竹,2024-02-01,2184
2329,華泰,3,1,2,亞東-新竹,2024-02-01,2184
3434,哲固,2,0,2,亞東-新竹,2024-02-01,2184
8210,勤誠,1,0,1,亞東-新竹,2024-02-01,2184
6147,頎邦,1,0,1,亞東-新竹,2024-02-01,2184
00680L,元大美債20正2,284,0,284,亞東-新竹,2024-02-02,2184
00937B,群益ESG投等債20,239,0,239,亞東-新竹,2024-02-02,2184
00919,群益台灣精選高息,78,1,77,亞東-新竹,2024-02-02,2184
4958,臻鼎-KY,52,0,52,亞東-新竹,2024-02-02,2184
2885,元大金,34,0,34,亞東-新竹,2024-02-02,2184
1513,中興電,36,7,29,亞東-新竹,2024-02-02,2184
2303,聯電,26,0,26,亞東-新竹,2024-02-02,2184
6789,采鈺,31,6,25,亞東-新竹,2024-02-02,2184
1795,美時,39,16,23,亞東-新竹,2024-02-02,2184
00929,復華台灣科技優息,22,0,22,亞東-新竹,2024-02-02,2184
00715L,期街口布蘭特正2,20,0,20,亞東-新竹,2024-02-02,2184
00900,富邦特選高股息30,20,2,18,亞東-新竹,2024-02-02,2184
00712,復華富時不動產,18,0,18,亞東-新竹,2024-02-02,2184
8227,巨有科技,33,16,17,亞東-新竹,2024-02-02,2184
2201,裕隆,19,4,15,亞東-新竹,2024-02-02,2184
2609,陽明,17,3,14,亞東-新竹,2024-02-02,2184
00673R,期元大S＆P原油反1,13,0,13,亞東-新竹,2024-02-02,2184
00933B,國泰10Y+金融債,12,0,12,亞東-新竹,2024-02-02,2184
2401,凌陽,12,0,12,亞東-新竹,2024-02-02,2184
3450,聯鈞,12,0,12,亞東-新竹,2024-02-02,2184
6116,彩晶,11,0,11,亞東-新竹,2024-02-02,2184
2377,微星,10,0,10,亞東-新竹,2024-02-02,2184
2492,華新科,10,0,10,亞東-新竹,2024-02-02,2184
3522,御嵿,10,0,10,亞東-新竹,2024-02-02,2184
9945,潤泰新,10,0,10,亞東-新竹,2024-02-02,2184
8936,國統,10,1,9,亞東-新竹,2024-02-02,2184
00687B,國泰20年美債,8,0,8,亞東-新竹,2024-02-02,2184
2353,宏��,15,7,8,亞東-新竹,2024-02-02,2184
3044,健鼎,8,0,8,亞東-新竹,2024-02-02,2184
2388,威盛,11,5,6,亞東-新竹,2024-02-02,2184
3047,訊舟,6,0,6,亞東-新竹,2024-02-02,2184
6841,長佳智能,6,0,6,亞東-新竹,2024-02-02,2184
00934,中信成長高股息,5,0,5,亞東-新竹,2024-02-02,2184
00902,中信電池及儲能,5,0,5,亞東-新竹,2024-02-02,2184
00753L,中信中國50正2,7,2,5,亞東-新竹,2024-02-02,2184
2354,鴻準,5,0,5,亞東-新竹,2024-02-02,2184
2603,長榮,6,1,5,亞東-新竹,2024-02-02,2184
3605,宏致,5,0,5,亞東-新竹,2024-02-02,2184
3705,永信,5,0,5,亞東-新竹,2024-02-02,2184
3715,定穎投控,13,8,5,亞東-新竹,2024-02-02,2184
6485,點序,5,0,5,亞東-新竹,2024-02-02,2184
2498,宏達電,4,0,4,亞東-新竹,2024-02-02,2184
3036,文曄,4,0,4,亞東-新竹,2024-02-02,2184
3041,揚智,4,0,4,亞東-新竹,2024-02-02,2184
3360,尚立,8,4,4,亞東-新竹,2024-02-02,2184
2618,長榮航,15,11,4,亞東-新竹,2024-02-02,2184
2317,鴻海,3,0,3,亞東-新竹,2024-02-02,2184
00633L,富邦上証正2,3,0,3,亞東-新竹,2024-02-02,2184
00679B,元大美債20年,13,10,3,亞東-新竹,2024-02-02,2184
00696B,富邦美債20年,3,0,3,亞東-新竹,2024-02-02,2184
00665L,富邦�琤肭磪囓�2,100,0,100,亞東-新竹,2024-02-05,2184
2352,佳世達,97,6,91,亞東-新竹,2024-02-05,2184
00680L,元大美債20正2,57,1,56,亞東-新竹,2024-02-05,2184
00882,中信中國高股息,41,0,41,亞東-新竹,2024-02-05,2184
00687B,國泰20年美債,34,0,34,亞東-新竹,2024-02-05,2184
00937B,群益ESG投等債20,31,0,31,亞東-新竹,2024-02-05,2184
00679B,元大美債20年,31,0,31,亞東-新竹,2024-02-05,2184
2330,台積電,44,13,31,亞東-新竹,2024-02-05,2184
00751B,元大AAA至A公司債,30,0,30,亞東-新竹,2024-02-05,2184
2884,玉山金,24,0,24,亞東-新竹,2024-02-05,2184
00712,復華富時不動產,24,0,24,亞東-新竹,2024-02-05,2184
00919,群益台灣精選高息,36,13,23,亞東-新竹,2024-02-05,2184
5871,中租-KY,22,0,22,亞東-新竹,2024-02-05,2184
00795B,中信美國公債20年,22,0,22,亞東-新竹,2024-02-05,2184
00715L,期街口布蘭特正2,20,0,20,亞東-新竹,2024-02-05,2184
2485,兆赫,20,0,20,亞東-新竹,2024-02-05,2184
3522,御嵿,20,0,20,亞東-新竹,2024-02-05,2184
0050,元大台灣50,19,0,19,亞東-新竹,2024-02-05,2184
1513,中興電,19,0,19,亞東-新竹,2024-02-05,2184
2377,微星,20,2,18,亞東-新竹,2024-02-05,2184
9958,世紀鋼,18,0,18,亞東-新竹,2024-02-05,2184
2603,長榮,22,5,17,亞東-新竹,2024-02-05,2184
3443,創意,13,1,12,亞東-新竹,2024-02-05,2184
00696B,富邦美債20年,12,0,12,亞東-新竹,2024-02-05,2184
6138,茂達,11,0,11,亞東-新竹,2024-02-05,2184
4729,熒茂,11,0,11,亞東-新竹,2024-02-05,2184
00878,國泰永續高股息,14,4,10,亞東-新竹,2024-02-05,2184
00764B,群益25年美債,10,0,10,亞東-新竹,2024-02-05,2184
2354,鴻準,10,0,10,亞東-新竹,2024-02-05,2184
3354,律勝,10,0,10,亞東-新竹,2024-02-05,2184
6124,業強,10,0,10,亞東-新竹,2024-02-05,2184
6789,采鈺,10,0,10,亞東-新竹,2024-02-05,2184
9945,潤泰新,10,0,10,亞東-新竹,2024-02-05,2184
1720,生達,8,0,8,亞東-新竹,2024-02-05,2184
2348A,海悅甲特,8,0,8,亞東-新竹,2024-02-05,2184
4303,信立,11,3,8,亞東-新竹,2024-02-05,2184
6546,正基,10,2,8,亞東-新竹,2024-02-05,2184
6841,長佳智能,8,0,8,亞東-新竹,2024-02-05,2184
2303,聯電,21,14,7,亞東-新竹,2024-02-05,2184
2885,元大金,7,0,7,亞東-新竹,2024-02-05,2184
3260,威剛,7,0,7,亞東-新竹,2024-02-05,2184
3268,海德威,9,2,7,亞東-新竹,2024-02-05,2184
3530,晶相光,9,2,7,亞東-新竹,2024-02-05,2184
6248,沛波,7,0,7,亞東-新竹,2024-02-05,2184
3034,聯詠,8,2,6,亞東-新竹,2024-02-05,2184
1102,亞泥,6,0,6,亞東-新竹,2024-02-05,2184
2427,三商電,8,2,6,亞東-新竹,2024-02-05,2184
3481,群創,6,0,6,亞東-新竹,2024-02-05,2184
4532,瑞智,6,0,6,亞東-新竹,2024-02-05,2184
6531,愛普*,7,2,5,亞東-新竹,2024-02-05,2184
00665L,富邦�琤肭磪囓�2,700,0,700,亞東-新竹,2024-02-15,2184
00679B,元大美債20年,140,0,140,亞東-新竹,2024-02-15,2184
00937B,群益ESG投等債20,137,0,137,亞東-新竹,2024-02-15,2184
00751B,元大AAA至A公司債,94,0,94,亞東-新竹,2024-02-15,2184
2882,國泰金,71,0,71,亞東-新竹,2024-02-15,2184
3522,御嵿,50,0,50,亞東-新竹,2024-02-15,2184
00687B,國泰20年美債,48,0,48,亞東-新竹,2024-02-15,2184
2610,華航,41,0,41,亞東-新竹,2024-02-15,2184
00795B,中信美國公債20年,35,0,35,亞東-新竹,2024-02-15,2184
00720B,元大投資級公司債,32,0,32,亞東-新竹,2024-02-15,2184
1101,台泥,31,0,31,亞東-新竹,2024-02-15,2184
00933B,國泰10Y+金融債,24,0,24,亞東-新竹,2024-02-15,2184
2369,菱生,25,5,20,亞東-新竹,2024-02-15,2184
2605,新興,20,0,20,亞東-新竹,2024-02-15,2184
2834,臺企銀,20,0,20,亞東-新竹,2024-02-15,2184
3712,永崴投控,19,4,15,亞東-新竹,2024-02-15,2184
0056,元大高股息,32,21,11,亞東-新竹,2024-02-15,2184
2344,華邦電,25,15,10,亞東-新竹,2024-02-15,2184
2486,一詮,10,0,10,亞東-新竹,2024-02-15,2184
2888,新光金,10,0,10,亞東-新竹,2024-02-15,2184
6505,台塑化,20,10,10,亞東-新竹,2024-02-15,2184
8011,台通,10,0,10,亞東-新竹,2024-02-15,2184
00931B,統一美債20年,8,0,8,亞東-新竹,2024-02-15,2184
1815,富喬,8,0,8,亞東-新竹,2024-02-15,2184
6229,研通,8,0,8,亞東-新竹,2024-02-15,2184
8936,國統,8,0,8,亞東-新竹,2024-02-15,2184
2618,長榮航,7,0,7,亞東-新竹,2024-02-15,2184
00712,復華富時不動產,7,0,7,亞東-新竹,2024-02-15,2184
1582,信錦,10,3,7,亞東-新竹,2024-02-15,2184
2727,王品,7,0,7,亞東-新竹,2024-02-15,2184
3234,光環,7,0,7,亞東-新竹,2024-02-15,2184
5225,東科-KY,7,0,7,亞東-新竹,2024-02-15,2184
5871,中租-KY,8,1,7,亞東-新竹,2024-02-15,2184
1529,樂事綠能,6,0,6,亞東-新竹,2024-02-15,2184
3705,永信,6,0,6,亞東-新竹,2024-02-15,2184
3715,定穎投控,16,10,6,亞東-新竹,2024-02-15,2184
4105,東洋,7,1,6,亞東-新竹,2024-02-15,2184
4939,亞電,6,0,6,亞東-新竹,2024-02-15,2184
2812,台中銀,5,0,5,亞東-新竹,2024-02-15,2184
00757,統一FANG+,5,0,5,亞東-新竹,2024-02-15,2184
1524,耿鼎,5,0,5,亞東-新竹,2024-02-15,2184
2449,京元電子,6,1,5,亞東-新竹,2024-02-15,2184
2458,義隆,5,0,5,亞東-新竹,2024-02-15,2184
6485,點序,5,0,5,亞東-新竹,2024-02-15,2184
00680L,元大美債20正2,4,0,4,亞東-新竹,2024-02-15,2184
00764B,群益25年美債,4,0,4,亞東-新竹,2024-02-15,2184
1102,亞泥,4,0,4,亞東-新竹,2024-02-15,2184
2201,裕隆,8,4,4,亞東-新竹,2024-02-15,2184
2247,汎德永業,4,0,4,亞東-新竹,2024-02-15,2184
2353,宏��,11,7,4,亞東-新竹,2024-02-15,2184
00937B,群益ESG投等債20,371,0,371,亞東-新竹,2024-02-16,2184
2605,新興,150,0,150,亞東-新竹,2024-02-16,2184
2888,新光金,50,1,49,亞東-新竹,2024-02-16,2184
5488,松普,38,0,38,亞東-新竹,2024-02-16,2184
00679B,元大美債20年,34,0,34,亞東-新竹,2024-02-16,2184
2303,聯電,38,5,33,亞東-新竹,2024-02-16,2184
00673R,期元大S＆P原油反1,32,0,32,亞東-新竹,2024-02-16,2184
00687B,國泰20年美債,31,0,31,亞東-新竹,2024-02-16,2184
2543,皇昌,31,0,31,亞東-新竹,2024-02-16,2184
2049,上銀,30,0,30,亞東-新竹,2024-02-16,2184
00795B,中信美國公債20年,26,0,26,亞東-新竹,2024-02-16,2184
1101,台泥,23,0,23,亞東-新竹,2024-02-16,2184
6125,廣運,25,2,23,亞東-新竹,2024-02-16,2184
00772B,中信高評級公司債,21,0,21,亞東-新竹,2024-02-16,2184
6015,宏遠證,20,0,20,亞東-新竹,2024-02-16,2184
6446,藥華藥,20,0,20,亞東-新竹,2024-02-16,2184
00751B,元大AAA至A公司債,18,0,18,亞東-新竹,2024-02-16,2184
2727,王品,20,2,18,亞東-新竹,2024-02-16,2184
3231,緯創,39,22,17,亞東-新竹,2024-02-16,2184
00720B,元大投資級公司債,16,0,16,亞東-新竹,2024-02-16,2184
2371,大同,16,0,16,亞東-新竹,2024-02-16,2184
00680L,元大美債20正2,15,0,15,亞東-新竹,2024-02-16,2184
00764B,群益25年美債,14,0,14,亞東-新竹,2024-02-16,2184
00688L,國泰20年美債正2,13,0,13,亞東-新竹,2024-02-16,2184
3607,谷崧,13,0,13,亞東-新竹,2024-02-16,2184
2353,宏��,31,19,12,亞東-新竹,2024-02-16,2184
3234,光環,11,0,11,亞東-新竹,2024-02-16,2184
00857B,永豐20年美公債,10,0,10,亞東-新竹,2024-02-16,2184
2337,旺宏,10,0,10,亞東-新竹,2024-02-16,2184
2486,一詮,15,5,10,亞東-新竹,2024-02-16,2184
3481,群創,10,0,10,亞東-新竹,2024-02-16,2184
4908,前鼎,10,0,10,亞東-新竹,2024-02-16,2184
3035,智原,16,6,10,亞東-新竹,2024-02-16,2184
3321,同泰,9,0,9,亞東-新竹,2024-02-16,2184
00933B,國泰10Y+金融債,8,0,8,亞東-新竹,2024-02-16,2184
2363,矽統,15,7,8,亞東-新竹,2024-02-16,2184
6165,浪凡,7,0,7,亞東-新竹,2024-02-16,2184
6139,亞翔,7,1,6,亞東-新竹,2024-02-16,2184
2330,台積電,10,4,6,亞東-新竹,2024-02-16,2184
00891,中信關鍵半導體,10,4,6,亞東-新竹,2024-02-16,2184
3322,建舜電,6,0,6,亞東-新竹,2024-02-16,2184
5706,鳳凰,6,0,6,亞東-新竹,2024-02-16,2184
6120,達運,6,0,6,亞東-新竹,2024-02-16,2184
6233,旺玖,6,0,6,亞東-新竹,2024-02-16,2184
2002,中鋼,7,2,5,亞東-新竹,2024-02-16,2184
00696B,富邦美債20年,5,0,5,亞東-新竹,2024-02-16,2184
2409,友達,5,0,5,亞東-新竹,2024-02-16,2184
3623,富晶通,30,25,5,亞東-新竹,2024-02-16,2184
4729,熒茂,10,5,5,亞東-新竹,2024-02-16,2184
6485,點序,5,0,5,亞東-新竹,2024-02-16,2184
00636,國泰中國A50,91,0,91,亞東-新竹,2024-02-19,2184
2605,新興,60,0,60,亞東-新竹,2024-02-19,2184
00712,復華富時不動產,57,0,57,亞東-新竹,2024-02-19,2184
00632R,元大台灣50反1,50,0,50,亞東-新竹,2024-02-19,2184
6285,啟��,50,1,49,亞東-新竹,2024-02-19,2184
2303,聯電,45,2,43,亞東-新竹,2024-02-19,2184
8215,明基材,40,0,40,亞東-新竹,2024-02-19,2184
2369,菱生,39,3,36,亞東-新竹,2024-02-19,2184
00933B,國泰10Y+金融債,33,0,33,亞東-新竹,2024-02-19,2184
00679B,元大美債20年,31,0,31,亞東-新竹,2024-02-19,2184
1503,士電,29,1,28,亞東-新竹,2024-02-19,2184
6190,萬泰科,20,0,20,亞東-新竹,2024-02-19,2184
6138,茂達,20,1,19,亞東-新竹,2024-02-19,2184
3372,典範,19,0,19,亞東-新竹,2024-02-19,2184
2405,輔信,20,2,18,亞東-新竹,2024-02-19,2184
00878,國泰永續高股息,38,20,18,亞東-新竹,2024-02-19,2184
3231,緯創,18,4,14,亞東-新竹,2024-02-19,2184
00680L,元大美債20正2,14,0,14,亞東-新竹,2024-02-19,2184
00937B,群益ESG投等債20,13,0,13,亞東-新竹,2024-02-19,2184
3557,嘉威,12,0,12,亞東-新竹,2024-02-19,2184
3284,太普高,12,0,12,亞東-新竹,2024-02-19,2184
3035,智原,13,2,11,亞東-新竹,2024-02-19,2184
2330,台積電,14,4,10,亞東-新竹,2024-02-19,2184
00891,中信關鍵半導體,10,0,10,亞東-新竹,2024-02-19,2184
2023,燁輝,10,0,10,亞東-新竹,2024-02-19,2184
2353,宏��,16,6,10,亞東-新竹,2024-02-19,2184
3005,神基,10,0,10,亞東-新竹,2024-02-19,2184
3033,威健,10,0,10,亞東-新竹,2024-02-19,2184
3217,優群,10,0,10,亞東-新竹,2024-02-19,2184
3576,聯合再生,10,0,10,亞東-新竹,2024-02-19,2184
4529,淳紳,10,0,10,亞東-新竹,2024-02-19,2184
6015,宏遠證,10,0,10,亞東-新竹,2024-02-19,2184
6269,台郡,10,0,10,亞東-新竹,2024-02-19,2184
6530,創威,10,0,10,亞東-新竹,2024-02-19,2184
2356,英業達,11,2,9,亞東-新竹,2024-02-19,2184
00918,大華優利高填息30,9,0,9,亞東-新竹,2024-02-19,2184
2329,華泰,25,17,8,亞東-新竹,2024-02-19,2184
00687B,國泰20年美債,8,0,8,亞東-新竹,2024-02-19,2184
1459,聯發,8,0,8,亞東-新竹,2024-02-19,2184
2049,上銀,8,0,8,亞東-新竹,2024-02-19,2184
5706,鳳凰,8,0,8,亞東-新竹,2024-02-19,2184
00643,群益深証中小,6,0,6,亞東-新竹,2024-02-19,2184
00753L,中信中國50正2,6,0,6,亞東-新竹,2024-02-19,2184
00751B,元大AAA至A公司債,6,0,6,亞東-新竹,2024-02-19,2184
00772B,中信高評級公司債,6,0,6,亞東-新竹,2024-02-19,2184
00857B,永豐20年美公債,6,0,6,亞東-新竹,2024-02-19,2184
1504,東元,6,0,6,亞東-新竹,2024-02-19,2184
2486,一詮,7,1,6,亞東-新竹,2024-02-19,2184
2727,王品,9,3,6,亞東-新竹,2024-02-19,2184
3694,海華,6,0,6,亞東-新竹,2024-02-19,2184
8112,至上,100,0,100,亞東-新竹,2024-02-20,2184
00679B,元大美債20年,93,0,93,亞東-新竹,2024-02-20,2184
00933B,國泰10Y+金融債,81,0,81,亞東-新竹,2024-02-20,2184
2489,瑞軒,71,10,61,亞東-新竹,2024-02-20,2184
020034,元大IC設計N,50,0,50,亞東-新竹,2024-02-20,2184
2882,國泰金,56,10,46,亞東-新竹,2024-02-20,2184
3522,御嵿,30,0,30,亞東-新竹,2024-02-20,2184
6285,啟��,25,0,25,亞東-新竹,2024-02-20,2184
00937B,群益ESG投等債20,32,10,22,亞東-新竹,2024-02-20,2184
3481,群創,21,0,21,亞東-新竹,2024-02-20,2184
2105,正新,20,0,20,亞東-新竹,2024-02-20,2184
4960,誠美材,22,2,20,亞東-新竹,2024-02-20,2184
6190,萬泰科,20,0,20,亞東-新竹,2024-02-20,2184
2201,裕隆,17,0,17,亞東-新竹,2024-02-20,2184
00680L,元大美債20正2,17,0,17,亞東-新竹,2024-02-20,2184
00751B,元大AAA至A公司債,16,0,16,亞東-新竹,2024-02-20,2184
3580,友威科,16,0,16,亞東-新竹,2024-02-20,2184
4164,承業醫,17,3,14,亞東-新竹,2024-02-20,2184
1560,中砂,12,0,12,亞東-新竹,2024-02-20,2184
1455,集盛,11,0,11,亞東-新竹,2024-02-20,2184
0061,元大寶滬深,10,0,10,亞東-新竹,2024-02-20,2184
2354,鴻準,10,0,10,亞東-新竹,2024-02-20,2184
3380,明泰,10,0,10,亞東-新竹,2024-02-20,2184
3576,聯合再生,10,0,10,亞東-新竹,2024-02-20,2184
3605,宏致,10,0,10,亞東-新竹,2024-02-20,2184
4129,聯合,10,0,10,亞東-新竹,2024-02-20,2184
6485,點序,10,0,10,亞東-新竹,2024-02-20,2184
00795B,中信美國公債20年,9,0,9,亞東-新竹,2024-02-20,2184
2405,輔信,10,1,9,亞東-新竹,2024-02-20,2184
8011,台通,10,1,9,亞東-新竹,2024-02-20,2184
00772B,中信高評級公司債,8,0,8,亞東-新竹,2024-02-20,2184
00673R,期元大S＆P原油反1,15,7,8,亞東-新竹,2024-02-20,2184
3363,上詮,13,5,8,亞東-新竹,2024-02-20,2184
3607,谷崧,8,1,7,亞東-新竹,2024-02-20,2184
00650L,復華香港正2,10,4,6,亞東-新竹,2024-02-20,2184
1504,東元,6,0,6,亞東-新竹,2024-02-20,2184
1815,富喬,10,4,6,亞東-新竹,2024-02-20,2184
2406,國碩,6,0,6,亞東-新竹,2024-02-20,2184
2515,中工,6,0,6,亞東-新竹,2024-02-20,2184
2731,雄獅,6,0,6,亞東-新竹,2024-02-20,2184
3312,弘憶股,6,0,6,亞東-新竹,2024-02-20,2184
5706,鳳凰,6,0,6,亞東-新竹,2024-02-20,2184
6237,驊訊,8,2,6,亞東-新竹,2024-02-20,2184
3035,智原,19,14,5,亞東-新竹,2024-02-20,2184
00764B,群益25年美債,5,0,5,亞東-新竹,2024-02-20,2184
2062,橋椿,5,0,5,亞東-新竹,2024-02-20,2184
3294,英濟,5,0,5,亞東-新竹,2024-02-20,2184
3306,鼎天,5,0,5,亞東-新竹,2024-02-20,2184
3588,通嘉,9,4,5,亞東-新竹,2024-02-20,2184
5258,虹堡,5,0,5,亞東-新竹,2024-02-20,2184
00937B,群益ESG投等債20,219,0,219,亞東-新竹,2024-02-21,2184
2303,聯電,78,0,78,亞東-新竹,2024-02-21,2184
00752,中信中國50,60,0,60,亞東-新竹,2024-02-21,2184
00878,國泰永續高股息,57,10,47,亞東-新竹,2024-02-21,2184
4729,熒茂,45,0,45,亞東-新竹,2024-02-21,2184
00679B,元大美債20年,60,21,39,亞東-新竹,2024-02-21,2184
2609,陽明,38,1,37,亞東-新竹,2024-02-21,2184
00680L,元大美債20正2,21,0,21,亞東-新竹,2024-02-21,2184
3545,敦泰,23,2,21,亞東-新竹,2024-02-21,2184
00891,中信關鍵半導體,23,3,20,亞東-新竹,2024-02-21,2184
6578,達邦蛋白,20,0,20,亞東-新竹,2024-02-21,2184
6257,矽格,20,0,20,亞東-新竹,2024-02-21,2184
6282,康舒,19,0,19,亞東-新竹,2024-02-21,2184
3035,智原,18,2,16,亞東-新竹,2024-02-21,2184
020034,元大IC設計N,15,0,15,亞東-新竹,2024-02-21,2184
3047,訊舟,14,0,14,亞東-新竹,2024-02-21,2184
3083,網龍,14,0,14,亞東-新竹,2024-02-21,2184
2727,王品,14,1,13,亞東-新竹,2024-02-21,2184
3027,盛達,12,0,12,亞東-新竹,2024-02-21,2184
00918,大華優利高填息30,11,0,11,亞東-新竹,2024-02-21,2184
3481,群創,11,0,11,亞東-新竹,2024-02-21,2184
00888,永豐台灣ESG,10,0,10,亞東-新竹,2024-02-21,2184
6189,豐藝,38,28,10,亞東-新竹,2024-02-21,2184
00934,中信成長高股息,9,0,9,亞東-新竹,2024-02-21,2184
3264,欣銓,10,1,9,亞東-新竹,2024-02-21,2184
3588,通嘉,10,1,9,亞東-新竹,2024-02-21,2184
00712,復華富時不動產,9,0,9,亞東-新竹,2024-02-21,2184
2382,廣達,18,10,8,亞東-新竹,2024-02-21,2184
3583,辛耘,10,2,8,亞東-新竹,2024-02-21,2184
2206,三陽工業,7,0,7,亞東-新竹,2024-02-21,2184
2301,光寶科,7,1,6,亞東-新竹,2024-02-21,2184
2897,王道銀行,6,0,6,亞東-新竹,2024-02-21,2184
6472,保瑞,6,0,6,亞東-新竹,2024-02-21,2184
5871,中租-KY,5,0,5,亞東-新竹,2024-02-21,2184
00933B,國泰10Y+金融債,5,0,5,亞東-新竹,2024-02-21,2184
00935,野村臺灣新科技50,5,0,5,亞東-新竹,2024-02-21,2184
00757,統一FANG+,5,0,5,亞東-新竹,2024-02-21,2184
2405,輔信,5,0,5,亞東-新竹,2024-02-21,2184
2834,臺企銀,5,0,5,亞東-新竹,2024-02-21,2184
3712,永崴投控,5,0,5,亞東-新竹,2024-02-21,2184
5469,瀚宇博,5,0,5,亞東-新竹,2024-02-21,2184
00902,中信電池及儲能,5,0,5,亞東-新竹,2024-02-21,2184
2353,宏��,4,0,4,亞東-新竹,2024-02-21,2184
2884,玉山金,4,0,4,亞東-新竹,2024-02-21,2184
2885,元大金,84,80,4,亞東-新竹,2024-02-21,2184
8064,東捷,7,3,4,亞東-新竹,2024-02-21,2184
2330,台積電,4,0,4,亞東-新竹,2024-02-21,2184
2892,第一金,3,0,3,亞東-新竹,2024-02-21,2184
00830,國泰費城半導體,3,0,3,亞東-新竹,2024-02-21,2184
2247,汎德永業,3,0,3,亞東-新竹,2024-02-21,2184
4534,慶騰,200,0,200,亞東-新竹,2024-02-22,2184
00680L,元大美債20正2,107,0,107,亞東-新竹,2024-02-22,2184
2353,宏��,65,10,55,亞東-新竹,2024-02-22,2184
00878,國泰永續高股息,51,5,46,亞東-新竹,2024-02-22,2184
00752,中信中國50,30,0,30,亞東-新竹,2024-02-22,2184
6190,萬泰科,29,0,29,亞東-新竹,2024-02-22,2184
8215,明基材,29,0,29,亞東-新竹,2024-02-22,2184
1513,中興電,45,18,27,亞東-新竹,2024-02-22,2184
00679B,元大美債20年,66,40,26,亞東-新竹,2024-02-22,2184
6505,台塑化,22,0,22,亞東-新竹,2024-02-22,2184
00919,群益台灣精選高息,63,42,21,亞東-新竹,2024-02-22,2184
3576,聯合再生,20,0,20,亞東-新竹,2024-02-22,2184
00795B,中信美國公債20年,17,0,17,亞東-新竹,2024-02-22,2184
2884,玉山金,21,5,16,亞東-新竹,2024-02-22,2184
2303,聯電,21,6,15,亞東-新竹,2024-02-22,2184
2727,王品,19,4,15,亞東-新竹,2024-02-22,2184
4157,太景*-KY,15,0,15,亞東-新竹,2024-02-22,2184
4561,健椿,13,0,13,亞東-新竹,2024-02-22,2184
00937B,群益ESG投等債20,22,10,12,亞東-新竹,2024-02-22,2184
00772B,中信高評級公司債,11,0,11,亞東-新竹,2024-02-22,2184
1785,光洋科,15,4,11,亞東-新竹,2024-02-22,2184
2379,瑞昱,15,4,11,亞東-新竹,2024-02-22,2184
00931B,統一美債20年,10,0,10,亞東-新竹,2024-02-22,2184
2834,臺企銀,10,0,10,亞東-新竹,2024-02-22,2184
2867,三商壽,10,0,10,亞東-新竹,2024-02-22,2184
3047,訊舟,10,0,10,亞東-新竹,2024-02-22,2184
3481,群創,20,10,10,亞東-新竹,2024-02-22,2184
3522,御嵿,10,0,10,亞東-新竹,2024-02-22,2184
6684,安格,17,7,10,亞東-新竹,2024-02-22,2184
9911,櫻花,10,0,10,亞東-新竹,2024-02-22,2184
1560,中砂,12,3,9,亞東-新竹,2024-02-22,2184
2388,威盛,10,1,9,亞東-新竹,2024-02-22,2184
2401,凌陽,9,0,9,亞東-新竹,2024-02-22,2184
5388,中磊,10,1,9,亞東-新竹,2024-02-22,2184
2609,陽明,16,7,9,亞東-新竹,2024-02-22,2184
2329,華泰,32,24,8,亞東-新竹,2024-02-22,2184
00753L,中信中國50正2,7,0,7,亞東-新竹,2024-02-22,2184
6668,中揚光,7,0,7,亞東-新竹,2024-02-22,2184
8054,安國,7,0,7,亞東-新竹,2024-02-22,2184
2356,英業達,11,5,6,亞東-新竹,2024-02-22,2184
3013,晟銘電,6,0,6,亞東-新竹,2024-02-22,2184
3663,鑫科,6,0,6,亞東-新竹,2024-02-22,2184
5706,鳳凰,6,0,6,亞東-新竹,2024-02-22,2184
3231,緯創,15,10,5,亞東-新竹,2024-02-22,2184
0061,元大寶滬深,5,0,5,亞東-新竹,2024-02-22,2184
1608,華榮,7,2,5,亞東-新竹,2024-02-22,2184
2439,美律,5,0,5,亞東-新竹,2024-02-22,2184
2641,正德,5,0,5,亞東-新竹,2024-02-22,2184
3006,晶豪科,5,0,5,亞東-新竹,2024-02-22,2184
3689,湧德,5,0,5,亞東-新竹,2024-02-22,2184
00919,群益台灣精選高息,444,55,389,亞東-新竹,2024-02-23,2184
2408,南亞科,100,0,100,亞東-新竹,2024-02-23,2184
2610,華航,62,0,62,亞東-新竹,2024-02-23,2184
00679B,元大美債20年,47,10,37,亞東-新竹,2024-02-23,2184
2303,聯電,51,14,37,亞東-新竹,2024-02-23,2184
0056,元大高股息,62,31,31,亞東-新竹,2024-02-23,2184
3481,群創,30,1,29,亞東-新竹,2024-02-23,2184
3083,網龍,26,0,26,亞東-新竹,2024-02-23,2184
6285,啟��,25,1,24,亞東-新竹,2024-02-23,2184
2329,華泰,60,36,24,亞東-新竹,2024-02-23,2184
2025,千興,21,0,21,亞東-新竹,2024-02-23,2184
2605,新興,20,0,20,亞東-新竹,2024-02-23,2184
2845,遠東銀,20,0,20,亞東-新竹,2024-02-23,2184
4739,康普,25,5,20,亞東-新竹,2024-02-23,2184
2462,良得電,20,0,20,亞東-新竹,2024-02-23,2184
5469,瀚宇博,18,0,18,亞東-新竹,2024-02-23,2184
3323,加百裕,15,0,15,亞東-新竹,2024-02-23,2184
3025,星通,21,7,14,亞東-新竹,2024-02-23,2184
1101,台泥,15,1,14,亞東-新竹,2024-02-23,2184
3231,緯創,29,16,13,亞東-新竹,2024-02-23,2184
3260,威剛,13,0,13,亞東-新竹,2024-02-23,2184
2618,長榮航,23,10,13,亞東-新竹,2024-02-23,2184
3265,台星科,12,0,12,亞東-新竹,2024-02-23,2184
6207,雷科,12,1,11,亞東-新竹,2024-02-23,2184
00918,大華優利高填息30,11,0,11,亞東-新竹,2024-02-23,2184
3694,海華,11,0,11,亞東-新竹,2024-02-23,2184
3576,聯合再生,10,0,10,亞東-新竹,2024-02-23,2184
5344,立衛,10,0,10,亞東-新竹,2024-02-23,2184
6129,普誠,10,0,10,亞東-新竹,2024-02-23,2184
00770,國泰北美科技,9,0,9,亞東-新竹,2024-02-23,2184
3081,聯亞,11,2,9,亞東-新竹,2024-02-23,2184
00933B,國泰10Y+金融債,8,0,8,亞東-新竹,2024-02-23,2184
00637L,元大滬深300正2,9,1,8,亞東-新竹,2024-02-23,2184
6703,軒郁,8,0,8,亞東-新竹,2024-02-23,2184
00753L,中信中國50正2,7,0,7,亞東-新竹,2024-02-23,2184
00680L,元大美債20正2,47,40,7,亞東-新竹,2024-02-23,2184
00927,群益半導體收益,6,0,6,亞東-新竹,2024-02-23,2184
2367,燿華,10,4,6,亞東-新竹,2024-02-23,2184
2882,國泰金,6,0,6,亞東-新竹,2024-02-23,2184
3311,閎暉,6,0,6,亞東-新竹,2024-02-23,2184
3715,定穎投控,10,4,6,亞東-新竹,2024-02-23,2184
6189,豐藝,19,13,6,亞東-新竹,2024-02-23,2184
6485,點序,6,0,6,亞東-新竹,2024-02-23,2184
6546,正基,6,0,6,亞東-新竹,2024-02-23,2184
1785,光洋科,5,0,5,亞東-新竹,2024-02-23,2184
00687B,國泰20年美債,9,4,5,亞東-新竹,2024-02-23,2184
00693U,期街口S＆P黃豆,5,0,5,亞東-新竹,2024-02-23,2184
1459,聯發,5,0,5,亞東-新竹,2024-02-23,2184
6117,迎廣,5,0,5,亞東-新竹,2024-02-23,2184
8096,擎亞,5,0,5,亞東-新竹,2024-02-23,2184
00937B,群益ESG投等債20,176,24,152,亞東-新竹,2024-02-26,2184
00878,國泰永續高股息,113,0,113,亞東-新竹,2024-02-26,2184
00679B,元大美債20年,161,75,86,亞東-新竹,2024-02-26,2184
00919,群益台灣精選高息,77,4,73,亞東-新竹,2024-02-26,2184
4908,前鼎,43,10,33,亞東-新竹,2024-02-26,2184
00850,元大臺灣ESG永續,30,0,30,亞東-新竹,2024-02-26,2184
2883,凱基金,21,0,21,亞東-新竹,2024-02-26,2184
3083,網龍,21,0,21,亞東-新竹,2024-02-26,2184
3042,晶技,20,0,20,亞東-新竹,2024-02-26,2184
6558,興能高,20,0,20,亞東-新竹,2024-02-26,2184
2303,聯電,31,14,17,亞東-新竹,2024-02-26,2184
6125,廣運,20,3,17,亞東-新竹,2024-02-26,2184
2329,華泰,38,24,14,亞東-新竹,2024-02-26,2184
2409,友達,23,10,13,亞東-新竹,2024-02-26,2184
6684,安格,18,5,13,亞東-新竹,2024-02-26,2184
8114,振樺電,13,0,13,亞東-新竹,2024-02-26,2184
6190,萬泰科,12,0,12,亞東-新竹,2024-02-26,2184
6257,矽格,12,0,12,亞東-新竹,2024-02-26,2184
6505,台塑化,12,0,12,亞東-新竹,2024-02-26,2184
6005,群益證,11,0,11,亞東-新竹,2024-02-26,2184
00885,富邦越南,11,0,11,亞東-新竹,2024-02-26,2184
00720B,元大投資級公司債,11,0,11,亞東-新竹,2024-02-26,2184
2331,精英,11,0,11,亞東-新竹,2024-02-26,2184
3163,波若威,19,8,11,亞東-新竹,2024-02-26,2184
2888,新光金,10,0,10,亞東-新竹,2024-02-26,2184
00693U,期街口S＆P黃豆,10,0,10,亞東-新竹,2024-02-26,2184
3522,御嵿,10,0,10,亞東-新竹,2024-02-26,2184
1616,億泰,9,0,9,亞東-新竹,2024-02-26,2184
2548,華固,8,0,8,亞東-新竹,2024-02-26,2184
6189,豐藝,12,4,8,亞東-新竹,2024-02-26,2184
4960,誠美材,7,0,7,亞東-新竹,2024-02-26,2184
2890,永豐金,6,0,6,亞東-新竹,2024-02-26,2184
8040,九暘,9,3,6,亞東-新竹,2024-02-26,2184
2201,裕隆,8,2,6,亞東-新竹,2024-02-26,2184
00713,元大台灣高息低波,15,10,5,亞東-新竹,2024-02-26,2184
2002,中鋼,5,0,5,亞東-新竹,2024-02-26,2184
2313,華通,6,1,5,亞東-新竹,2024-02-26,2184
00935,野村臺灣新科技50,5,0,5,亞東-新竹,2024-02-26,2184
3051,力特,5,0,5,亞東-新竹,2024-02-26,2184
3296,勝德,5,0,5,亞東-新竹,2024-02-26,2184
3362,先進光,6,1,5,亞東-新竹,2024-02-26,2184
3479,安勤,5,0,5,亞東-新竹,2024-02-26,2184
3706,神達,5,0,5,亞東-新竹,2024-02-26,2184
8021,尖點,5,0,5,亞東-新竹,2024-02-26,2184
8936,國統,9,4,5,亞東-新竹,2024-02-26,2184
2314,台揚,4,0,4,亞東-新竹,2024-02-26,2184
2449,京元電子,6,2,4,亞東-新竹,2024-02-26,2184
00929,復華台灣科技優息,14,10,4,亞東-新竹,2024-02-26,2184
2065,世豐,4,0,4,亞東-新竹,2024-02-26,2184
2609,陽明,4,0,4,亞東-新竹,2024-02-26,2184
00929,復華台灣科技優息,352,112,240,亞東-新竹,2024-02-27,2184
00937B,群益ESG投等債20,166,30,136,亞東-新竹,2024-02-27,2184
00878,國泰永續高股息,126,21,105,亞東-新竹,2024-02-27,2184
3041,揚智,82,1,81,亞東-新竹,2024-02-27,2184
00679B,元大美債20年,75,0,75,亞東-新竹,2024-02-27,2184
3576,聯合再生,70,0,70,亞東-新竹,2024-02-27,2184
2409,友達,53,0,53,亞東-新竹,2024-02-27,2184
2845,遠東銀,50,6,44,亞東-新竹,2024-02-27,2184
00720B,元大投資級公司債,43,0,43,亞東-新竹,2024-02-27,2184
00632R,元大台灣50反1,40,0,40,亞東-新竹,2024-02-27,2184
0056,元大高股息,51,12,39,亞東-新竹,2024-02-27,2184
3083,網龍,38,0,38,亞東-新竹,2024-02-27,2184
00795B,中信美國公債20年,36,0,36,亞東-新竹,2024-02-27,2184
2002,中鋼,35,0,35,亞東-新竹,2024-02-27,2184
2610,華航,31,0,31,亞東-新竹,2024-02-27,2184
9945,潤泰新,30,0,30,亞東-新竹,2024-02-27,2184
2887,台新金,29,0,29,亞東-新竹,2024-02-27,2184
6167,久正,28,0,28,亞東-新竹,2024-02-27,2184
1319,東陽,36,9,27,亞東-新竹,2024-02-27,2184
00933B,國泰10Y+金融債,26,0,26,亞東-新竹,2024-02-27,2184
2834,臺企銀,125,100,25,亞東-新竹,2024-02-27,2184
3481,群創,27,5,22,亞東-新竹,2024-02-27,2184
2883,凱基金,20,0,20,亞東-新竹,2024-02-27,2184
2344,華邦電,30,10,20,亞東-新竹,2024-02-27,2184
6451,訊芯-KY,27,7,20,亞東-新竹,2024-02-27,2184
00680L,元大美債20正2,17,0,17,亞東-新竹,2024-02-27,2184
1524,耿鼎,34,17,17,亞東-新竹,2024-02-27,2184
00919,群益台灣精選高息,113,98,15,亞東-新竹,2024-02-27,2184
2382,廣達,14,0,14,亞東-新竹,2024-02-27,2184
2892,第一金,16,3,13,亞東-新竹,2024-02-27,2184
5471,松翰,13,0,13,亞東-新竹,2024-02-27,2184
00857B,永豐20年美公債,12,0,12,亞東-新竹,2024-02-27,2184
1514,亞力,13,1,12,亞東-新竹,2024-02-27,2184
1529,樂事綠能,12,0,12,亞東-新竹,2024-02-27,2184
3163,波若威,26,14,12,亞東-新竹,2024-02-27,2184
3037,欣興,11,0,11,亞東-新竹,2024-02-27,2184
3313,斐成,11,0,11,亞東-新竹,2024-02-27,2184
00850,元大臺灣ESG永續,10,0,10,亞東-新竹,2024-02-27,2184
2888,新光金,10,0,10,亞東-新竹,2024-02-27,2184
3217,優群,10,0,10,亞東-新竹,2024-02-27,2184
3479,安勤,10,0,10,亞東-新竹,2024-02-27,2184
3231,緯創,20,11,9,亞東-新竹,2024-02-27,2184
00772B,中信高評級公司債,9,0,9,亞東-新竹,2024-02-27,2184
1101,台泥,9,0,9,亞東-新竹,2024-02-27,2184
2609,陽明,19,10,9,亞東-新竹,2024-02-27,2184
2308,台達電,8,0,8,亞東-新竹,2024-02-27,2184
2201,裕隆,8,0,8,亞東-新竹,2024-02-27,2184
9914,美利達,8,0,8,亞東-新竹,2024-02-27,2184
3588,通嘉,7,1,6,亞東-新竹,2024-02-27,2184
00725B,國泰投資級公司債,6,0,6,亞東-新竹,2024-02-27,2184
00885,富邦越南,131,0,131,亞東-新竹,2024-02-29,2184
00751B,元大AAA至A公司債,122,0,122,亞東-新竹,2024-02-29,2184
2605,新興,101,1,100,亞東-新竹,2024-02-29,2184
00937B,群益ESG投等債20,56,0,56,亞東-新竹,2024-02-29,2184
2845,遠東銀,60,4,56,亞東-新竹,2024-02-29,2184
00680L,元大美債20正2,45,0,45,亞東-新竹,2024-02-29,2184
00706L,期元大S＆P日圓正2,40,0,40,亞東-新竹,2024-02-29,2184
1609,大亞,40,2,38,亞東-新竹,2024-02-29,2184
3083,網龍,27,1,26,亞東-新竹,2024-02-29,2184
00679B,元大美債20年,23,0,23,亞東-新竹,2024-02-29,2184
3234,光環,20,0,20,亞東-新竹,2024-02-29,2184
4904,遠傳,20,0,20,亞東-新竹,2024-02-29,2184
1514,亞力,33,15,18,亞東-新竹,2024-02-29,2184
4129,聯合,16,0,16,亞東-新竹,2024-02-29,2184
00919,群益台灣精選高息,43,28,15,亞東-新竹,2024-02-29,2184
9914,美利達,15,0,15,亞東-新竹,2024-02-29,2184
2809,京城銀,12,0,12,亞東-新竹,2024-02-29,2184
1711,永光,10,0,10,亞東-新竹,2024-02-29,2184
1773,勝一,10,0,10,亞東-新竹,2024-02-29,2184
3288,點晶,10,0,10,亞東-新竹,2024-02-29,2184
6243,迅杰,10,0,10,亞東-新竹,2024-02-29,2184
3490,單井,8,0,8,亞東-新竹,2024-02-29,2184
2353,宏��,12,4,8,亞東-新竹,2024-02-29,2184
6202,盛群,9,1,8,亞東-新竹,2024-02-29,2184
00687B,國泰20年美債,7,0,7,亞東-新竹,2024-02-29,2184
2002,中鋼,7,0,7,亞東-新竹,2024-02-29,2184
00929,復華台灣科技優息,8,2,6,亞東-新竹,2024-02-29,2184
6147,頎邦,6,0,6,亞東-新竹,2024-02-29,2184
5443,均豪,6,0,6,亞東-新竹,2024-02-29,2184
5388,中磊,5,0,5,亞東-新竹,2024-02-29,2184
6139,亞翔,6,1,5,亞東-新竹,2024-02-29,2184
4960,誠美材,5,0,5,亞東-新竹,2024-02-29,2184
5471,松翰,5,0,5,亞東-新竹,2024-02-29,2184
00930,永豐ESG低碳高息,5,0,5,亞東-新竹,2024-02-29,2184
00927,群益半導體收益,5,0,5,亞東-新竹,2024-02-29,2184
00773B,中信優先金融債,5,0,5,亞東-新竹,2024-02-29,2184
2305,全友,5,0,5,亞東-新竹,2024-02-29,2184
2886,兆豐金,5,0,5,亞東-新竹,2024-02-29,2184
6462,神盾,10,5,5,亞東-新竹,2024-02-29,2184
6695,芯鼎,5,0,5,亞東-新竹,2024-02-29,2184
3580,友威科,4,0,4,亞東-新竹,2024-02-29,2184
00878,國泰永續高股息,19,15,4,亞東-新竹,2024-02-29,2184
1459,聯發,4,0,4,亞東-新竹,2024-02-29,2184
6288,聯嘉,6,2,4,亞東-新竹,2024-02-29,2184
8096,擎亞,4,0,4,亞東-新竹,2024-02-29,2184
1101,台泥,11,7,4,亞東-新竹,2024-02-29,2184
3231,緯創,19,15,4,亞東-新竹,2024-02-29,2184
3363,上詮,18,14,4,亞東-新竹,2024-02-29,2184
00720B,元大投資級公司債,3,0,3,亞東-新竹,2024-02-29,2184
00772B,中信高評級公司債,3,0,3,亞東-新竹,2024-02-29,2184
2882,國泰金,246,0,246,亞東-新竹,2024-03-01,2184
00751B,元大AAA至A公司債,102,8,94,亞東-新竹,2024-03-01,2184
00937B,群益ESG投等債20,45,0,45,亞東-新竹,2024-03-01,2184
2409,友達,38,0,38,亞東-新竹,2024-03-01,2184
6770,力積電,29,0,29,亞東-新竹,2024-03-01,2184
00919,群益台灣精選高息,66,37,29,亞東-新竹,2024-03-01,2184
3372,典範,28,0,28,亞東-新竹,2024-03-01,2184
2399,映泰,26,0,26,亞東-新竹,2024-03-01,2184
6505,台塑化,25,0,25,亞東-新竹,2024-03-01,2184
1815,富喬,24,0,24,亞東-新竹,2024-03-01,2184
3360,尚立,24,2,22,亞東-新竹,2024-03-01,2184
00706L,期元大S＆P日圓正2,20,0,20,亞東-新竹,2024-03-01,2184
1603,華電,16,0,16,亞東-新竹,2024-03-01,2184
1513,中興電,17,2,15,亞東-新竹,2024-03-01,2184
3376,新日興,15,1,14,亞東-新竹,2024-03-01,2184
3580,友威科,14,0,14,亞東-新竹,2024-03-01,2184
2834,臺企銀,113,100,13,亞東-新竹,2024-03-01,2184
2324,仁寶,11,0,11,亞東-新竹,2024-03-01,2184
00929,復華台灣科技優息,14,3,11,亞東-新竹,2024-03-01,2184
2303,聯電,13,3,10,亞東-新竹,2024-03-01,2184
1727,中華化,10,0,10,亞東-新竹,2024-03-01,2184
2201,裕隆,20,10,10,亞東-新竹,2024-03-01,2184
6138,茂達,12,2,10,亞東-新竹,2024-03-01,2184
2887,台新金,9,0,9,亞東-新竹,2024-03-01,2184
3483,力致,22,13,9,亞東-新竹,2024-03-01,2184
00935,野村臺灣新科技50,8,0,8,亞東-新竹,2024-03-01,2184
3083,網龍,8,0,8,亞東-新竹,2024-03-01,2184
2609,陽明,9,2,7,亞東-新竹,2024-03-01,2184
5471,松翰,7,0,7,亞東-新竹,2024-03-01,2184
6116,彩晶,7,0,7,亞東-新竹,2024-03-01,2184
00933B,國泰10Y+金融債,7,0,7,亞東-新竹,2024-03-01,2184
2603,長榮,11,4,7,亞東-新竹,2024-03-01,2184
6451,訊芯-KY,6,0,6,亞東-新竹,2024-03-01,2184
3706,神達,6,0,6,亞東-新竹,2024-03-01,2184
00795B,中信美國公債20年,6,0,6,亞東-新竹,2024-03-01,2184
2367,燿華,37,31,6,亞東-新竹,2024-03-01,2184
3645,達邁,6,0,6,亞東-新竹,2024-03-01,2184
3705,永信,6,0,6,亞東-新竹,2024-03-01,2184
4102,永日,6,0,6,亞東-新竹,2024-03-01,2184
6695,芯鼎,16,10,6,亞東-新竹,2024-03-01,2184
5351,鈺創,5,0,5,亞東-新竹,2024-03-01,2184
6189,豐藝,24,19,5,亞東-新竹,2024-03-01,2184
6243,迅杰,17,12,5,亞東-新竹,2024-03-01,2184
00687B,國泰20年美債,5,0,5,亞東-新竹,2024-03-01,2184
00773B,中信優先金融債,5,0,5,亞東-新竹,2024-03-01,2184
1459,聯發,5,0,5,亞東-新竹,2024-03-01,2184
1101,台泥,5,0,5,亞東-新竹,2024-03-01,2184
2329,華泰,30,25,5,亞東-新竹,2024-03-01,2184
3029,零壹,5,0,5,亞東-新竹,2024-03-01,2184
3163,波若威,5,0,5,亞東-新竹,2024-03-01,2184
00937B,群益ESG投等債20,77,0,77,亞東-新竹,2024-03-04,2184
2882,國泰金,64,0,64,亞東-新竹,2024-03-04,2184
00918,大華優利高填息30,60,0,60,亞東-新竹,2024-03-04,2184
2367,燿華,86,27,59,亞東-新竹,2024-03-04,2184
2612,中航,38,0,38,亞東-新竹,2024-03-04,2184
1301,台塑,32,0,32,亞東-新竹,2024-03-04,2184
00632R,元大台灣50反1,60,40,20,亞東-新竹,2024-03-04,2184
2889,國票金,20,0,20,亞東-新竹,2024-03-04,2184
1618,合機,20,1,19,亞東-新竹,2024-03-04,2184
00679B,元大美債20年,19,0,19,亞東-新竹,2024-03-04,2184
1603,華電,18,0,18,亞東-新竹,2024-03-04,2184
00720B,元大投資級公司債,16,0,16,亞東-新竹,2024-03-04,2184
3005,神基,18,2,16,亞東-新竹,2024-03-04,2184
00680L,元大美債20正2,15,0,15,亞東-新竹,2024-03-04,2184
4157,太景*-KY,15,0,15,亞東-新竹,2024-03-04,2184
2353,宏��,23,9,14,亞東-新竹,2024-03-04,2184
2417,圓剛,14,1,13,亞東-新竹,2024-03-04,2184
8926,台汽電,13,0,13,亞東-新竹,2024-03-04,2184
00751B,元大AAA至A公司債,11,0,11,亞東-新竹,2024-03-04,2184
1609,大亞,11,0,11,亞東-新竹,2024-03-04,2184
2329,華泰,25,14,11,亞東-新竹,2024-03-04,2184
2609,陽明,20,10,10,亞東-新竹,2024-03-04,2184
1303,南亞,10,0,10,亞東-新竹,2024-03-04,2184
00673R,期元大S＆P原油反1,10,0,10,亞東-新竹,2024-03-04,2184
00665L,富邦�琤肭磪囓�2,10,0,10,亞東-新竹,2024-03-04,2184
00688L,國泰20年美債正2,10,0,10,亞東-新竹,2024-03-04,2184
00904,新光臺灣半導體30,10,0,10,亞東-新竹,2024-03-04,2184
2888,新光金,10,0,10,亞東-新竹,2024-03-04,2184
3516,亞帝歐,10,0,10,亞東-新竹,2024-03-04,2184
4432,銘旺實,10,0,10,亞東-新竹,2024-03-04,2184
1459,聯發,9,0,9,亞東-新竹,2024-03-04,2184
00915,凱基優選高股息30,8,0,8,亞東-新竹,2024-03-04,2184
5383,金利,8,0,8,亞東-新竹,2024-03-04,2184
2002,中鋼,7,0,7,亞東-新竹,2024-03-04,2184
2495,普安,7,0,7,亞東-新竹,2024-03-04,2184
2727,王品,7,0,7,亞東-新竹,2024-03-04,2184
3231,緯創,16,9,7,亞東-新竹,2024-03-04,2184
5871,中租-KY,8,1,7,亞東-新竹,2024-03-04,2184
00687B,國泰20年美債,7,0,7,亞東-新竹,2024-03-04,2184
2356,英業達,6,0,6,亞東-新竹,2024-03-04,2184
2486,一詮,6,0,6,亞東-新竹,2024-03-04,2184
6462,神盾,6,0,6,亞東-新竹,2024-03-04,2184
8227,巨有科技,7,1,6,亞東-新竹,2024-03-04,2184
2464,盟立,5,0,5,亞東-新竹,2024-03-04,2184
2834,臺企銀,105,100,5,亞東-新竹,2024-03-04,2184
3323,加百裕,5,0,5,亞東-新竹,2024-03-04,2184
3588,通嘉,5,0,5,亞東-新竹,2024-03-04,2184
3704,合勤控,9,4,5,亞東-新竹,2024-03-04,2184
4564,元翎,5,0,5,亞東-新竹,2024-03-04,2184
5443,均豪,5,0,5,亞東-新竹,2024-03-04,2184
2834,臺企銀,140,0,140,亞東-新竹,2024-03-05,2184
6125,廣運,60,0,60,亞東-新竹,2024-03-05,2184
00937B,群益ESG投等債20,56,0,56,亞東-新竹,2024-03-05,2184
2897,王道銀行,44,0,44,亞東-新竹,2024-03-05,2184
2316,楠梓電,43,0,43,亞東-新竹,2024-03-05,2184
2820,華票,40,0,40,亞東-新竹,2024-03-05,2184
2360,致茂,36,3,33,亞東-新竹,2024-03-05,2184
2887,台新金,38,5,33,亞東-新竹,2024-03-05,2184
00712,復華富時不動產,31,0,31,亞東-新竹,2024-03-05,2184
3234,光環,30,0,30,亞東-新竹,2024-03-05,2184
3587,閎康,30,0,30,亞東-新竹,2024-03-05,2184
00919,群益台灣精選高息,67,37,30,亞東-新竹,2024-03-05,2184
8926,台汽電,30,2,28,亞東-新竹,2024-03-05,2184
00918,大華優利高填息30,26,0,26,亞東-新竹,2024-03-05,2184
00915,凱基優選高股息30,22,0,22,亞東-新竹,2024-03-05,2184
6505,台塑化,22,0,22,亞東-新竹,2024-03-05,2184
1108,幸福,21,0,21,亞東-新竹,2024-03-05,2184
2460,建通,20,0,20,亞東-新竹,2024-03-05,2184
4960,誠美材,20,1,19,亞東-新竹,2024-03-05,2184
00687B,國泰20年美債,21,3,18,亞東-新竹,2024-03-05,2184
2303,聯電,17,0,17,亞東-新竹,2024-03-05,2184
3623,富晶通,16,0,16,亞東-新竹,2024-03-05,2184
9914,美利達,15,0,15,亞東-新竹,2024-03-05,2184
3583,辛耘,14,0,14,亞東-新竹,2024-03-05,2184
2606,裕民,11,0,11,亞東-新竹,2024-03-05,2184
4938,和碩,11,0,11,亞東-新竹,2024-03-05,2184
6126,信音,10,0,10,亞東-新竹,2024-03-05,2184
1303,南亞,14,5,9,亞東-新竹,2024-03-05,2184
1324,地球,9,0,9,亞東-新竹,2024-03-05,2184
2367,燿華,15,6,9,亞東-新竹,2024-03-05,2184
3481,群創,10,1,9,亞東-新竹,2024-03-05,2184
3037,欣興,8,0,8,亞東-新竹,2024-03-05,2184
2892,第一金,8,0,8,亞東-新竹,2024-03-05,2184
00679B,元大美債20年,8,0,8,亞東-新竹,2024-03-05,2184
1582,信錦,10,2,8,亞東-新竹,2024-03-05,2184
2201,裕隆,12,4,8,亞東-新竹,2024-03-05,2184
3312,弘憶股,16,8,8,亞東-新竹,2024-03-05,2184
00753L,中信中國50正2,7,0,7,亞東-新竹,2024-03-05,2184
2371,大同,26,19,7,亞東-新竹,2024-03-05,2184
2727,王品,7,0,7,亞東-新竹,2024-03-05,2184
00680L,元大美債20正2,6,0,6,亞東-新竹,2024-03-05,2184
3050,鈺德,6,0,6,亞東-新竹,2024-03-05,2184
3450,聯鈞,14,8,6,亞東-新竹,2024-03-05,2184
4303,信立,6,0,6,亞東-新竹,2024-03-05,2184
6139,亞翔,13,7,6,亞東-新竹,2024-03-05,2184
00929,復華台灣科技優息,27,22,5,亞東-新竹,2024-03-05,2184
2442,新美齊,5,0,5,亞東-新竹,2024-03-05,2184
00688L,國泰20年美債正2,5,0,5,亞東-新竹,2024-03-05,2184
00902,中信電池及儲能,5,0,5,亞東-新竹,2024-03-05,2184
2313,華通,5,0,5,亞東-新竹,2024-03-05,2184
2897,王道銀行,950,0,950,亞東-新竹,2024-03-06,2184
00632R,元大台灣50反1,190,0,190,亞東-新竹,2024-03-06,2184
00918,大華優利高填息30,156,0,156,亞東-新竹,2024-03-06,2184
2885,元大金,100,0,100,亞東-新竹,2024-03-06,2184
2845,遠東銀,122,39,83,亞東-新竹,2024-03-06,2184
00937B,群益ESG投等債20,81,0,81,亞東-新竹,2024-03-06,2184
4960,誠美材,47,0,47,亞東-新竹,2024-03-06,2184
006208,富邦台50,37,0,37,亞東-新竹,2024-03-06,2184
2365,昆盈,37,0,37,亞東-新竹,2024-03-06,2184
00929,復華台灣科技優息,37,3,34,亞東-新竹,2024-03-06,2184
2329,華泰,44,18,26,亞東-新竹,2024-03-06,2184
3234,光環,26,1,25,亞東-新竹,2024-03-06,2184
00720B,元大投資級公司債,22,0,22,亞東-新竹,2024-03-06,2184
00646,元大S＆P500,21,0,21,亞東-新竹,2024-03-06,2184
6505,台塑化,41,20,21,亞東-新竹,2024-03-06,2184
00680L,元大美債20正2,32,12,20,亞東-新竹,2024-03-06,2184
2344,華邦電,20,0,20,亞東-新竹,2024-03-06,2184
8011,台通,44,24,20,亞東-新竹,2024-03-06,2184
00751B,元大AAA至A公司債,17,0,17,亞東-新竹,2024-03-06,2184
3013,晟銘電,26,9,17,亞東-新竹,2024-03-06,2184
2383,台光電,16,0,16,亞東-新竹,2024-03-06,2184
5443,均豪,15,0,15,亞東-新竹,2024-03-06,2184
1101,台泥,15,0,15,亞東-新竹,2024-03-06,2184
1815,富喬,25,10,15,亞東-新竹,2024-03-06,2184
3623,富晶通,12,0,12,亞東-新竹,2024-03-06,2184
5383,金利,12,1,11,亞東-新竹,2024-03-06,2184
00764B,群益25年美債,10,0,10,亞東-新竹,2024-03-06,2184
2409,友達,10,0,10,亞東-新竹,2024-03-06,2184
2460,建通,10,0,10,亞東-新竹,2024-03-06,2184
2838,聯邦銀,10,0,10,亞東-新竹,2024-03-06,2184
3083,網龍,10,0,10,亞東-新竹,2024-03-06,2184
3268,海德威,10,0,10,亞東-新竹,2024-03-06,2184
4908,前鼎,10,0,10,亞東-新竹,2024-03-06,2184
6109,亞元,10,0,10,亞東-新竹,2024-03-06,2184
4763,材料-KY,13,4,9,亞東-新竹,2024-03-06,2184
0056,元大高股息,9,1,8,亞東-新竹,2024-03-06,2184
1710,東聯,8,0,8,亞東-新竹,2024-03-06,2184
3481,群創,14,6,8,亞東-新竹,2024-03-06,2184
8926,台汽電,8,0,8,亞東-新竹,2024-03-06,2184
3231,緯創,12,4,8,亞東-新竹,2024-03-06,2184
1609,大亞,36,29,7,亞東-新竹,2024-03-06,2184
2324,仁寶,7,0,7,亞東-新竹,2024-03-06,2184
5426,振發,8,1,7,亞東-新竹,2024-03-06,2184
6443,元晶,7,0,7,亞東-新竹,2024-03-06,2184
2317,鴻海,6,0,6,亞東-新竹,2024-03-06,2184
6269,台郡,6,0,6,亞東-新竹,2024-03-06,2184
1303,南亞,7,1,6,亞東-新竹,2024-03-06,2184
2065,世豐,5,0,5,亞東-新竹,2024-03-06,2184
00902,中信電池及儲能,5,0,5,亞東-新竹,2024-03-06,2184
2353,宏��,10,5,5,亞東-新竹,2024-03-06,2184
2885,元大金,605,48,557,亞東-新竹,2024-03-07,2184
00632R,元大台灣50反1,260,0,260,亞東-新竹,2024-03-07,2184
2845,遠東銀,160,20,140,亞東-新竹,2024-03-07,2184
6125,廣運,104,2,102,亞東-新竹,2024-03-07,2184
2897,王道銀行,65,5,60,亞東-新竹,2024-03-07,2184
0056,元大高股息,62,8,54,亞東-新竹,2024-03-07,2184
00720B,元大投資級公司債,69,16,53,亞東-新竹,2024-03-07,2184
6016,康和證,50,0,50,亞東-新竹,2024-03-07,2184
00706L,期元大S＆P日圓正2,45,0,45,亞東-新竹,2024-03-07,2184
1785,光洋科,53,16,37,亞東-新竹,2024-03-07,2184
1324,地球,33,0,33,亞東-新竹,2024-03-07,2184
8011,台通,29,0,29,亞東-新竹,2024-03-07,2184
3036,文曄,30,3,27,亞東-新竹,2024-03-07,2184
00713,元大台灣高息低波,27,2,25,亞東-新竹,2024-03-07,2184
3231,緯創,36,12,24,亞東-新竹,2024-03-07,2184
00674R,期元大S＆P黃金反1,20,0,20,亞東-新竹,2024-03-07,2184
2612,中航,20,0,20,亞東-新竹,2024-03-07,2184
00878,國泰永續高股息,24,5,19,亞東-新竹,2024-03-07,2184
2606,裕民,17,0,17,亞東-新竹,2024-03-07,2184
6163,華電網,28,12,16,亞東-新竹,2024-03-07,2184
8401,白紗科,20,5,15,亞東-新竹,2024-03-07,2184
6239,力成,13,0,13,亞東-新竹,2024-03-07,2184
00712,復華富時不動產,13,0,13,亞東-新竹,2024-03-07,2184
2313,華通,12,0,12,亞東-新竹,2024-03-07,2184
2634,漢翔,14,2,12,亞東-新竹,2024-03-07,2184
4960,誠美材,12,0,12,亞東-新竹,2024-03-07,2184
6139,亞翔,13,1,12,亞東-新竹,2024-03-07,2184
2317,鴻海,23,11,12,亞東-新竹,2024-03-07,2184
2344,華邦電,37,26,11,亞東-新竹,2024-03-07,2184
00904,新光臺灣半導體30,12,1,11,亞東-新竹,2024-03-07,2184
5263,智崴,11,0,11,亞東-新竹,2024-03-07,2184
2371,大同,26,16,10,亞東-新竹,2024-03-07,2184
3035,智原,11,1,10,亞東-新竹,2024-03-07,2184
1104,環泥,10,0,10,亞東-新竹,2024-03-07,2184
2201,裕隆,10,0,10,亞東-新竹,2024-03-07,2184
9914,美利達,10,0,10,亞東-新竹,2024-03-07,2184
6257,矽格,10,0,10,亞東-新竹,2024-03-07,2184
2356,英業達,21,12,9,亞東-新竹,2024-03-07,2184
3376,新日興,16,8,8,亞東-新竹,2024-03-07,2184
6189,豐藝,11,4,7,亞東-新竹,2024-03-07,2184
2388,威盛,22,15,7,亞東-新竹,2024-03-07,2184
2002,中鋼,7,0,7,亞東-新竹,2024-03-07,2184
00905,FT臺灣Smart,6,0,6,亞東-新竹,2024-03-07,2184
1905,華紙,6,0,6,亞東-新竹,2024-03-07,2184
2417,圓剛,10,4,6,亞東-新竹,2024-03-07,2184
2427,三商電,6,0,6,亞東-新竹,2024-03-07,2184
2449,京元電子,8,2,6,亞東-新竹,2024-03-07,2184
2729,瓦城,6,0,6,亞東-新竹,2024-03-07,2184
3711,日月光投控,12,6,6,亞東-新竹,2024-03-07,2184
6143,振曜,8,2,6,亞東-新竹,2024-03-07,2184
00885,富邦越南,300,1,299,亞東-新竹,2024-03-08,2184
2885,元大金,377,161,216,亞東-新竹,2024-03-08,2184
00919,群益台灣精選高息,189,67,122,亞東-新竹,2024-03-08,2184
6125,廣運,71,2,69,亞東-新竹,2024-03-08,2184
00720B,元大投資級公司債,57,5,52,亞東-新竹,2024-03-08,2184
2409,友達,51,0,51,亞東-新竹,2024-03-08,2184
00632R,元大台灣50反1,50,1,49,亞東-新竹,2024-03-08,2184
2845,遠東銀,41,0,41,亞東-新竹,2024-03-08,2184
4432,銘旺實,28,3,25,亞東-新竹,2024-03-08,2184
3041,揚智,25,2,23,亞東-新竹,2024-03-08,2184
6163,華電網,22,0,22,亞東-新竹,2024-03-08,2184
00915,凱基優選高股息30,23,2,21,亞東-新竹,2024-03-08,2184
2801,彰銀,21,0,21,亞東-新竹,2024-03-08,2184
3481,群創,21,0,21,亞東-新竹,2024-03-08,2184
00918,大華優利高填息30,23,3,20,亞東-新竹,2024-03-08,2184
00652,富邦印度,20,0,20,亞東-新竹,2024-03-08,2184
00645,富邦日本,20,0,20,亞東-新竹,2024-03-08,2184
2449,京元電子,30,11,19,亞東-新竹,2024-03-08,2184
2618,長榮航,49,30,19,亞東-新竹,2024-03-08,2184
2367,燿華,29,12,17,亞東-新竹,2024-03-08,2184
3234,光環,18,1,17,亞東-新竹,2024-03-08,2184
00706L,期元大S＆P日圓正2,15,0,15,亞東-新竹,2024-03-08,2184
3035,智原,14,0,14,亞東-新竹,2024-03-08,2184
2634,漢翔,14,0,14,亞東-新竹,2024-03-08,2184
6139,亞翔,29,16,13,亞東-新竹,2024-03-08,2184
00933B,國泰10Y+金融債,12,0,12,亞東-新竹,2024-03-08,2184
4545,銘鈺,12,0,12,亞東-新竹,2024-03-08,2184
6257,矽格,12,0,12,亞東-新竹,2024-03-08,2184
00751B,元大AAA至A公司債,16,5,11,亞東-新竹,2024-03-08,2184
8112,至上,12,1,11,亞東-新竹,2024-03-08,2184
1618,合機,10,0,10,亞東-新竹,2024-03-08,2184
2329,華泰,34,24,10,亞東-新竹,2024-03-08,2184
3645,達邁,10,0,10,亞東-新竹,2024-03-08,2184
0061,元大寶滬深,10,0,10,亞東-新竹,2024-03-08,2184
00636,國泰中國A50,10,0,10,亞東-新竹,2024-03-08,2184
3169,亞信,10,0,10,亞東-新竹,2024-03-08,2184
3207,耀勝,10,0,10,亞東-新竹,2024-03-08,2184
4960,誠美材,10,0,10,亞東-新竹,2024-03-08,2184
6485,點序,10,0,10,亞東-新竹,2024-03-08,2184
8936,國統,11,1,10,亞東-新竹,2024-03-08,2184
00929,復華台灣科技優息,26,17,9,亞東-新竹,2024-03-08,2184
2340,台亞,9,0,9,亞東-新竹,2024-03-08,2184
3325,旭品,10,1,9,亞東-新竹,2024-03-08,2184
2002,中鋼,8,0,8,亞東-新竹,2024-03-08,2184
4147,中裕,10,2,8,亞東-新竹,2024-03-08,2184
6237,驊訊,8,0,8,亞東-新竹,2024-03-08,2184
9962,有益,8,0,8,亞東-新竹,2024-03-08,2184
1609,大亞,7,0,7,亞東-新竹,2024-03-08,2184
1784,訊聯,8,1,7,亞東-新竹,2024-03-08,2184
3287,廣寰科,7,0,7,亞東-新竹,2024-03-08,2184
00919,群益台灣精選高息,187,13,174,亞東-新竹,2024-03-11,2184
2882,國泰金,183,31,152,亞東-新竹,2024-03-11,2184
2885,元大金,139,4,135,亞東-新竹,2024-03-11,2184
2845,遠東銀,100,10,90,亞東-新竹,2024-03-11,2184
2303,聯電,77,20,57,亞東-新竹,2024-03-11,2184
2367,燿華,57,11,46,亞東-新竹,2024-03-11,2184
9945,潤泰新,45,0,45,亞東-新竹,2024-03-11,2184
00712,復華富時不動產,30,0,30,亞東-新竹,2024-03-11,2184
2485,兆赫,30,0,30,亞東-新竹,2024-03-11,2184
2892,第一金,30,0,30,亞東-新竹,2024-03-11,2184
6120,達運,30,0,30,亞東-新竹,2024-03-11,2184
2543,皇昌,24,0,24,亞東-新竹,2024-03-11,2184
3234,光環,23,2,21,亞東-新竹,2024-03-11,2184
00680L,元大美債20正2,32,12,20,亞東-新竹,2024-03-11,2184
00645,富邦日本,20,0,20,亞東-新竹,2024-03-11,2184
2610,華航,20,0,20,亞東-新竹,2024-03-11,2184
3703,欣陸,21,1,20,亞東-新竹,2024-03-11,2184
0056,元大高股息,26,9,17,亞東-新竹,2024-03-11,2184
00882,中信中國高股息,16,0,16,亞東-新竹,2024-03-11,2184
00878,國泰永續高股息,22,7,15,亞東-新竹,2024-03-11,2184
2049,上銀,15,0,15,亞東-新竹,2024-03-11,2184
2618,長榮航,52,38,14,亞東-新竹,2024-03-11,2184
3041,揚智,13,0,13,亞東-新竹,2024-03-11,2184
2330,台積電,27,15,12,亞東-新竹,2024-03-11,2184
8089,康全電訊,12,1,11,亞東-新竹,2024-03-11,2184
1785,光洋科,10,0,10,亞東-新竹,2024-03-11,2184
00830,國泰費城半導體,10,0,10,亞東-新竹,2024-03-11,2184
00933B,國泰10Y+金融債,10,0,10,亞東-新竹,2024-03-11,2184
00915,凱基優選高股息30,10,0,10,亞東-新竹,2024-03-11,2184
3027,盛達,10,0,10,亞東-新竹,2024-03-11,2184
6143,振曜,10,0,10,亞東-新竹,2024-03-11,2184
6275,元山,10,0,10,亞東-新竹,2024-03-11,2184
8112,至上,10,0,10,亞東-新竹,2024-03-11,2184
8933,愛地雅,10,0,10,亞東-新竹,2024-03-11,2184
00918,大華優利高填息30,10,2,8,亞東-新竹,2024-03-11,2184
00927,群益半導體收益,8,0,8,亞東-新竹,2024-03-11,2184
0050,元大台灣50,12,4,8,亞東-新竹,2024-03-11,2184
00795B,中信美國公債20年,8,0,8,亞東-新竹,2024-03-11,2184
9941,裕融,6,0,6,亞東-新竹,2024-03-11,2184
00757,統一FANG+,5,0,5,亞東-新竹,2024-03-11,2184
00764B,群益25年美債,5,0,5,亞東-新竹,2024-03-11,2184
00891,中信關鍵半導體,5,0,5,亞東-新竹,2024-03-11,2184
1734,杏輝,5,0,5,亞東-新竹,2024-03-11,2184
2314,台揚,5,0,5,亞東-新竹,2024-03-11,2184
3022,威強電,5,0,5,亞東-新竹,2024-03-11,2184
3711,日月光投控,5,0,5,亞東-新竹,2024-03-11,2184
6285,啟��,5,0,5,亞東-新竹,2024-03-11,2184
8150,南茂,5,0,5,亞東-新竹,2024-03-11,2184
3035,智原,7,2,5,亞東-新竹,2024-03-11,2184
3034,聯詠,4,0,4,亞東-新竹,2024-03-11,2184
00933B,國泰10Y+金融債,527,0,527,亞東-新竹,2024-03-12,2184
00937B,群益ESG投等債20,40,0,40,亞東-新竹,2024-03-12,2184
00929,復華台灣科技優息,57,25,32,亞東-新竹,2024-03-12,2184
3231,緯創,35,9,26,亞東-新竹,2024-03-12,2184
2606,裕民,22,0,22,亞東-新竹,2024-03-12,2184
00680L,元大美債20正2,22,1,21,亞東-新竹,2024-03-12,2184
6190,萬泰科,20,0,20,亞東-新竹,2024-03-12,2184
00857B,永豐20年美公債,20,0,20,亞東-新竹,2024-03-12,2184
6120,達運,20,0,20,亞東-新竹,2024-03-12,2184
4714,永捷,15,0,15,亞東-新竹,2024-03-12,2184
2612,中航,13,0,13,亞東-新竹,2024-03-12,2184
1316,上曜,11,0,11,亞東-新竹,2024-03-12,2184
6139,亞翔,12,1,11,亞東-新竹,2024-03-12,2184
2489,瑞軒,10,0,10,亞東-新竹,2024-03-12,2184
3027,盛達,10,0,10,亞東-新竹,2024-03-12,2184
4108,懷特,10,0,10,亞東-新竹,2024-03-12,2184
4960,誠美材,10,0,10,亞東-新竹,2024-03-12,2184
6116,彩晶,10,0,10,亞東-新竹,2024-03-12,2184
00878,國泰永續高股息,29,20,9,亞東-新竹,2024-03-12,2184
1905,華紙,9,0,9,亞東-新竹,2024-03-12,2184
2883,凱基金,11,2,9,亞東-新竹,2024-03-12,2184
3036,文曄,9,1,8,亞東-新竹,2024-03-12,2184
9950,萬國通,8,0,8,亞東-新竹,2024-03-12,2184
6147,頎邦,8,0,8,亞東-新竹,2024-03-12,2184
3013,晟銘電,11,4,7,亞東-新竹,2024-03-12,2184
3522,御嵿,7,0,7,亞東-新竹,2024-03-12,2184
8070,長華*,7,0,7,亞東-新竹,2024-03-12,2184
6143,振曜,6,0,6,亞東-新竹,2024-03-12,2184
2881,富邦金,6,0,6,亞東-新竹,2024-03-12,2184
3312,弘憶股,6,0,6,亞東-新竹,2024-03-12,2184
3583,辛耘,10,4,6,亞東-新竹,2024-03-12,2184
1324,地球,5,0,5,亞東-新竹,2024-03-12,2184
00706L,期元大S＆P日圓正2,5,0,5,亞東-新竹,2024-03-12,2184
00902,中信電池及儲能,10,5,5,亞東-新竹,2024-03-12,2184
2313,華通,6,1,5,亞東-新竹,2024-03-12,2184
2342,茂矽,5,0,5,亞東-新竹,2024-03-12,2184
2543,皇昌,5,0,5,亞東-新竹,2024-03-12,2184
2836,高雄銀,5,0,5,亞東-新竹,2024-03-12,2184
2913,農林,5,0,5,亞東-新竹,2024-03-12,2184
5443,均豪,5,0,5,亞東-新竹,2024-03-12,2184
8033,雷虎,5,0,5,亞東-新竹,2024-03-12,2184
2404,漢唐,5,0,5,亞東-新竹,2024-03-12,2184
2330,台積電,12,8,4,亞東-新竹,2024-03-12,2184
00632R,元大台灣50反1,3,0,3,亞東-新竹,2024-03-12,2184
2352,佳世達,5,2,3,亞東-新竹,2024-03-12,2184
2376,技嘉,3,0,3,亞東-新竹,2024-03-12,2184
2485,兆赫,3,0,3,亞東-新竹,2024-03-12,2184
3006,晶豪科,8,5,3,亞東-新竹,2024-03-12,2184
3062,建漢,3,0,3,亞東-新竹,2024-03-12,2184
3163,波若威,6,3,3,亞東-新竹,2024-03-12,2184
00933B,國泰10Y+金融債,319,0,319,亞東-新竹,2024-03-13,2184
3062,建漢,160,0,160,亞東-新竹,2024-03-13,2184
00878,國泰永續高股息,135,50,85,亞東-新竹,2024-03-13,2184
6163,華電網,65,0,65,亞東-新竹,2024-03-13,2184
2618,長榮航,63,8,55,亞東-新竹,2024-03-13,2184
00751B,元大AAA至A公司債,51,0,51,亞東-新竹,2024-03-13,2184
2880,華南金,50,0,50,亞東-新竹,2024-03-13,2184
8110,華東,50,0,50,亞東-新竹,2024-03-13,2184
2882,國泰金,156,110,46,亞東-新竹,2024-03-13,2184
00795B,中信美國公債20年,43,0,43,亞東-新竹,2024-03-13,2184
2344,華邦電,51,11,40,亞東-新竹,2024-03-13,2184
00915,凱基優選高股息30,46,10,36,亞東-新竹,2024-03-13,2184
2317,鴻海,93,58,35,亞東-新竹,2024-03-13,2184
00665L,富邦�琤肭磪囓�2,30,0,30,亞東-新竹,2024-03-13,2184
4157,太景*-KY,30,0,30,亞東-新竹,2024-03-13,2184
2427,三商電,32,3,29,亞東-新竹,2024-03-13,2184
00680L,元大美債20正2,28,0,28,亞東-新竹,2024-03-13,2184
00904,新光臺灣半導體30,28,5,23,亞東-新竹,2024-03-13,2184
00719B,元大美債1-3,23,0,23,亞東-新竹,2024-03-13,2184
5871,中租-KY,25,5,20,亞東-新竹,2024-03-13,2184
2460,建通,20,0,20,亞東-新竹,2024-03-13,2184
00646,元大S＆P500,18,0,18,亞東-新竹,2024-03-13,2184
00919,群益台灣精選高息,151,134,17,亞東-新竹,2024-03-13,2184
00918,大華優利高填息30,23,6,17,亞東-新竹,2024-03-13,2184
2636,台驊控股,22,8,14,亞東-新竹,2024-03-13,2184
6139,亞翔,17,4,13,亞東-新竹,2024-03-13,2184
00857B,永豐20年美公債,13,0,13,亞東-新竹,2024-03-13,2184
2201,裕隆,16,3,13,亞東-新竹,2024-03-13,2184
2609,陽明,17,5,12,亞東-新竹,2024-03-13,2184
3231,緯創,36,25,11,亞東-新竹,2024-03-13,2184
4908,前鼎,17,6,11,亞東-新竹,2024-03-13,2184
6275,元山,12,1,11,亞東-新竹,2024-03-13,2184
00923,群益台ESG低碳50,10,0,10,亞東-新竹,2024-03-13,2184
2337,旺宏,10,0,10,亞東-新竹,2024-03-13,2184
2359,所羅門,10,0,10,亞東-新竹,2024-03-13,2184
3325,旭品,10,0,10,亞東-新竹,2024-03-13,2184
6185,幃翔,10,0,10,亞東-新竹,2024-03-13,2184
6219,富旺,10,0,10,亞東-新竹,2024-03-13,2184
1101,台泥,15,6,9,亞東-新竹,2024-03-13,2184
2641,正德,10,1,9,亞東-新竹,2024-03-13,2184
00679B,元大美債20年,8,0,8,亞東-新竹,2024-03-13,2184
1720,生達,8,0,8,亞東-新竹,2024-03-13,2184
6451,訊芯-KY,7,0,7,亞東-新竹,2024-03-13,2184
2408,南亞科,7,0,7,亞東-新竹,2024-03-13,2184
3260,威剛,7,0,7,亞東-新竹,2024-03-13,2184
3592,瑞鼎,8,1,7,亞東-新竹,2024-03-13,2184
5469,瀚宇博,7,0,7,亞東-新竹,2024-03-13,2184
3035,智原,6,0,6,亞東-新竹,2024-03-13,2184
2382,廣達,7,1,6,亞東-新竹,2024-03-13,2184
1314,中石化,6,0,6,亞東-新竹,2024-03-13,2184
2883,凱基金,313,25,288,亞東-新竹,2024-03-14,2184
00919,群益台灣精選高息,356,154,202,亞東-新竹,2024-03-14,2184
00933B,國泰10Y+金融債,154,0,154,亞東-新竹,2024-03-14,2184
2603,長榮,125,4,121,亞東-新竹,2024-03-14,2184
00885,富邦越南,103,0,103,亞東-新竹,2024-03-14,2184
00751B,元大AAA至A公司債,100,0,100,亞東-新竹,2024-03-14,2184
2890,永豐金,103,8,95,亞東-新竹,2024-03-14,2184
2317,鴻海,78,12,66,亞東-新竹,2024-03-14,2184
2323,中環,65,0,65,亞東-新竹,2024-03-14,2184
3062,建漢,50,0,50,亞東-新竹,2024-03-14,2184
8110,華東,50,0,50,亞東-新竹,2024-03-14,2184
00918,大華優利高填息30,32,2,30,亞東-新竹,2024-03-14,2184
00915,凱基優選高股息30,47,18,29,亞東-新竹,2024-03-14,2184
2845,遠東銀,39,13,26,亞東-新竹,2024-03-14,2184
0056,元大高股息,26,8,18,亞東-新竹,2024-03-14,2184
00679B,元大美債20年,17,0,17,亞東-新竹,2024-03-14,2184
2363,矽統,17,1,16,亞東-新竹,2024-03-14,2184
00795B,中信美國公債20年,15,0,15,亞東-新竹,2024-03-14,2184
6139,亞翔,14,1,13,亞東-新竹,2024-03-14,2184
00830,國泰費城半導體,13,0,13,亞東-新竹,2024-03-14,2184
3034,聯詠,12,0,12,亞東-新竹,2024-03-14,2184
00687B,國泰20年美債,12,0,12,亞東-新竹,2024-03-14,2184
1326,台化,11,0,11,亞東-新竹,2024-03-14,2184
00929,復華台灣科技優息,22,11,11,亞東-新竹,2024-03-14,2184
2301,光寶科,10,0,10,亞東-新竹,2024-03-14,2184
00673R,期元大S＆P原油反1,10,0,10,亞東-新竹,2024-03-14,2184
2338,光罩,12,2,10,亞東-新竹,2024-03-14,2184
2412,中華電,10,0,10,亞東-新竹,2024-03-14,2184
1709,和益,10,2,8,亞東-新竹,2024-03-14,2184
2454,聯發科,8,0,8,亞東-新竹,2024-03-14,2184
00900,富邦特選高股息30,8,0,8,亞東-新竹,2024-03-14,2184
2485,兆赫,8,0,8,亞東-新竹,2024-03-14,2184
2409,友達,10,3,7,亞東-新竹,2024-03-14,2184
00772B,中信高評級公司債,7,0,7,亞東-新竹,2024-03-14,2184
2460,建通,7,0,7,亞東-新竹,2024-03-14,2184
2609,陽明,7,0,7,亞東-新竹,2024-03-14,2184
3706,神達,10,3,7,亞東-新竹,2024-03-14,2184
4743,合一,7,1,6,亞東-新竹,2024-03-14,2184
1108,幸福,6,0,6,亞東-新竹,2024-03-14,2184
2354,鴻準,17,12,5,亞東-新竹,2024-03-14,2184
2356,英業達,9,4,5,亞東-新竹,2024-03-14,2184
2906,高林,5,0,5,亞東-新竹,2024-03-14,2184
3522,御嵿,5,0,5,亞東-新竹,2024-03-14,2184
4952,凌通,5,0,5,亞東-新竹,2024-03-14,2184
6530,創威,5,0,5,亞東-新竹,2024-03-14,2184
8011,台通,5,0,5,亞東-新竹,2024-03-14,2184
00878,國泰永續高股息,33,29,4,亞東-新竹,2024-03-14,2184
00927,群益半導體收益,4,0,4,亞東-新竹,2024-03-14,2184
2303,聯電,10,6,4,亞東-新竹,2024-03-14,2184
2353,宏��,6,2,4,亞東-新竹,2024-03-14,2184
2834,臺企銀,410,100,310,亞東-新竹,2024-03-15,2184
00751B,元大AAA至A公司債,110,0,110,亞東-新竹,2024-03-15,2184
2897,王道銀行,200,100,100,亞東-新竹,2024-03-15,2184
00919,群益台灣精選高息,189,117,72,亞東-新竹,2024-03-15,2184
1108,幸福,55,0,55,亞東-新竹,2024-03-15,2184
00933B,國泰10Y+金融債,49,0,49,亞東-新竹,2024-03-15,2184
00937B,群益ESG投等債20,49,1,48,亞東-新竹,2024-03-15,2184
2356,英業達,45,12,33,亞東-新竹,2024-03-15,2184
2610,華航,32,0,32,亞東-新竹,2024-03-15,2184
00941,中信上游半導體,92,60,32,亞東-新竹,2024-03-15,2184
8110,華東,30,0,30,亞東-新竹,2024-03-15,2184
2401,凌陽,40,15,25,亞東-新竹,2024-03-15,2184
1303,南亞,23,0,23,亞東-新竹,2024-03-15,2184
00795B,中信美國公債20年,22,0,22,亞東-新竹,2024-03-15,2184
00679B,元大美債20年,21,0,21,亞東-新竹,2024-03-15,2184
3289,宜特,20,0,20,亞東-新竹,2024-03-15,2184
3663,鑫科,20,0,20,亞東-新竹,2024-03-15,2184
2330,台積電,25,5,20,亞東-新竹,2024-03-15,2184
00918,大華優利高填息30,20,4,16,亞東-新竹,2024-03-15,2184
3234,光環,16,0,16,亞東-新竹,2024-03-15,2184
2344,華邦電,25,10,15,亞東-新竹,2024-03-15,2184
3481,群創,15,0,15,亞東-新竹,2024-03-15,2184
2303,聯電,22,7,15,亞東-新竹,2024-03-15,2184
00687B,國泰20年美債,14,0,14,亞東-新竹,2024-03-15,2184
00915,凱基優選高股息30,21,7,14,亞東-新竹,2024-03-15,2184
2611,志信,12,0,12,亞東-新竹,2024-03-15,2184
2618,長榮航,26,15,11,亞東-新竹,2024-03-15,2184
00900,富邦特選高股息30,12,1,11,亞東-新竹,2024-03-15,2184
00688L,國泰20年美債正2,10,0,10,亞東-新竹,2024-03-15,2184
00713,元大台灣高息低波,10,0,10,亞東-新竹,2024-03-15,2184
2352,佳世達,10,0,10,亞東-新竹,2024-03-15,2184
3083,網龍,10,0,10,亞東-新竹,2024-03-15,2184
3339,泰谷,10,0,10,亞東-新竹,2024-03-15,2184
3551,世禾,10,0,10,亞東-新竹,2024-03-15,2184
8089,康全電訊,10,0,10,亞東-新竹,2024-03-15,2184
00830,國泰費城半導體,9,0,9,亞東-新竹,2024-03-15,2184
00720B,元大投資級公司債,9,0,9,亞東-新竹,2024-03-15,2184
1324,地球,9,0,9,亞東-新竹,2024-03-15,2184
3169,亞信,9,0,9,亞東-新竹,2024-03-15,2184
2454,聯發科,8,0,8,亞東-新竹,2024-03-15,2184
2609,陽明,7,0,7,亞東-新竹,2024-03-15,2184
00773B,中信優先金融債,7,0,7,亞東-新竹,2024-03-15,2184
2427,三商電,7,0,7,亞東-新竹,2024-03-15,2184
3037,欣興,7,0,7,亞東-新竹,2024-03-15,2184
9950,萬國通,7,0,7,亞東-新竹,2024-03-15,2184
2308,台達電,6,0,6,亞東-新竹,2024-03-15,2184
1459,聯發,6,0,6,亞東-新竹,2024-03-15,2184
2441,超豐,6,0,6,亞東-新竹,2024-03-15,2184
2812,台中銀,6,0,6,亞東-新竹,2024-03-15,2184
8926,台汽電,6,0,6,亞東-新竹,2024-03-15,2184
6530,創威,60,0,60,亞東-新竹,2024-03-18,2184
2317,鴻海,62,18,44,亞東-新竹,2024-03-18,2184
00937B,群益ESG投等債20,85,45,40,亞東-新竹,2024-03-18,2184
00933B,國泰10Y+金融債,35,0,35,亞東-新竹,2024-03-18,2184
6451,訊芯-KY,30,0,30,亞東-新竹,2024-03-18,2184
8936,國統,31,1,30,亞東-新竹,2024-03-18,2184
6290,良維,30,1,29,亞東-新竹,2024-03-18,2184
2344,華邦電,37,10,27,亞東-新竹,2024-03-18,2184
2887,台新金,23,0,23,亞東-新竹,2024-03-18,2184
2885,元大金,24,2,22,亞東-新竹,2024-03-18,2184
2915,潤泰全,22,0,22,亞東-新竹,2024-03-18,2184
00687B,國泰20年美債,21,0,21,亞東-新竹,2024-03-18,2184
1324,地球,20,0,20,亞東-新竹,2024-03-18,2184
2442,新美齊,20,0,20,亞東-新竹,2024-03-18,2184
2820,華票,20,0,20,亞東-新竹,2024-03-18,2184
3663,鑫科,20,0,20,亞東-新竹,2024-03-18,2184
1808,潤隆,16,0,16,亞東-新竹,2024-03-18,2184
2801,彰銀,15,0,15,亞東-新竹,2024-03-18,2184
2382,廣達,16,3,13,亞東-新竹,2024-03-18,2184
00941,中信上游半導體,13,0,13,亞東-新竹,2024-03-18,2184
1101,台泥,16,4,12,亞東-新竹,2024-03-18,2184
2618,長榮航,11,0,11,亞東-新竹,2024-03-18,2184
1504,東元,12,1,11,亞東-新竹,2024-03-18,2184
2609,陽明,11,1,10,亞東-新竹,2024-03-18,2184
00722B,群益投資級電信債,10,0,10,亞東-新竹,2024-03-18,2184
00680L,元大美債20正2,10,0,10,亞東-新竹,2024-03-18,2184
3006,晶豪科,12,2,10,亞東-新竹,2024-03-18,2184
6243,迅杰,10,0,10,亞東-新竹,2024-03-18,2184
8011,台通,10,0,10,亞東-新竹,2024-03-18,2184
9902,台火,10,1,9,亞東-新竹,2024-03-18,2184
00772B,中信高評級公司債,8,0,8,亞東-新竹,2024-03-18,2184
1720,生達,8,0,8,亞東-新竹,2024-03-18,2184
6005,群益證,8,0,8,亞東-新竹,2024-03-18,2184
2603,長榮,12,5,7,亞東-新竹,2024-03-18,2184
2002,中鋼,6,0,6,亞東-新竹,2024-03-18,2184
00679B,元大美債20年,16,10,6,亞東-新竹,2024-03-18,2184
5483,中美晶,6,0,6,亞東-新竹,2024-03-18,2184
1513,中興電,11,6,5,亞東-新竹,2024-03-18,2184
2408,南亞科,5,0,5,亞東-新竹,2024-03-18,2184
00878,國泰永續高股息,7,2,5,亞東-新竹,2024-03-18,2184
00673R,期元大S＆P原油反1,5,0,5,亞東-新竹,2024-03-18,2184
00773B,中信優先金融債,5,0,5,亞東-新竹,2024-03-18,2184
1402,遠東新,5,0,5,亞東-新竹,2024-03-18,2184
1616,億泰,5,0,5,亞東-新竹,2024-03-18,2184
2241,艾姆勒,5,0,5,亞東-新竹,2024-03-18,2184
2332,友訊,5,0,5,亞東-新竹,2024-03-18,2184
6695,芯鼎,7,2,5,亞東-新竹,2024-03-18,2184
8033,雷虎,5,0,5,亞東-新竹,2024-03-18,2184
00918,大華優利高填息30,25,21,4,亞東-新竹,2024-03-18,2184
00751B,元大AAA至A公司債,4,0,4,亞東-新竹,2024-03-18,2184
00941,中信上游半導體,109,0,109,亞東-新竹,2024-03-19,2184
00929,復華台灣科技優息,130,66,64,亞東-新竹,2024-03-19,2184
00679B,元大美債20年,39,5,34,亞東-新竹,2024-03-19,2184
2834,臺企銀,233,202,31,亞東-新竹,2024-03-19,2184
00673R,期元大S＆P原油反1,25,0,25,亞東-新竹,2024-03-19,2184
2888,新光金,25,0,25,亞東-新竹,2024-03-19,2184
00937B,群益ESG投等債20,25,1,24,亞東-新竹,2024-03-19,2184
00680L,元大美債20正2,24,0,24,亞東-新竹,2024-03-19,2184
3062,建漢,21,0,21,亞東-新竹,2024-03-19,2184
6138,茂達,20,0,20,亞東-新竹,2024-03-19,2184
2353,宏��,26,6,20,亞東-新竹,2024-03-19,2184
2880,華南金,20,0,20,亞東-新竹,2024-03-19,2184
00687B,國泰20年美債,18,0,18,亞東-新竹,2024-03-19,2184
00878,國泰永續高股息,16,0,16,亞東-新竹,2024-03-19,2184
2504,國產,15,0,15,亞東-新竹,2024-03-19,2184
5489,彩富,15,0,15,亞東-新竹,2024-03-19,2184
6127,九豪,15,0,15,亞東-新竹,2024-03-19,2184
6191,精成科,16,1,15,亞東-新竹,2024-03-19,2184
1303,南亞,13,0,13,亞東-新竹,2024-03-19,2184
00933B,國泰10Y+金融債,10,0,10,亞東-新竹,2024-03-19,2184
1101,台泥,11,1,10,亞東-新竹,2024-03-19,2184
00751B,元大AAA至A公司債,10,0,10,亞東-新竹,2024-03-19,2184
00795B,中信美國公債20年,10,0,10,亞東-新竹,2024-03-19,2184
00902,中信電池及儲能,10,0,10,亞東-新竹,2024-03-19,2184
00632R,元大台灣50反1,10,0,10,亞東-新竹,2024-03-19,2184
2340,台亞,10,0,10,亞東-新竹,2024-03-19,2184
2363,矽統,10,0,10,亞東-新竹,2024-03-19,2184
3372,典範,10,0,10,亞東-新竹,2024-03-19,2184
5515,建國,10,0,10,亞東-新竹,2024-03-19,2184
6190,萬泰科,10,0,10,亞東-新竹,2024-03-19,2184
6605,帝寶,10,0,10,亞東-新竹,2024-03-19,2184
1809,中釉,12,3,9,亞東-新竹,2024-03-19,2184
2417,圓剛,9,0,9,亞東-新竹,2024-03-19,2184
00713,元大台灣高息低波,8,0,8,亞東-新竹,2024-03-19,2184
2329,華泰,30,22,8,亞東-新竹,2024-03-19,2184
2915,潤泰全,8,0,8,亞東-新竹,2024-03-19,2184
2301,光寶科,13,5,8,亞東-新竹,2024-03-19,2184
00891,中信關鍵半導體,8,1,7,亞東-新竹,2024-03-19,2184
4938,和碩,19,12,7,亞東-新竹,2024-03-19,2184
1402,遠東新,6,0,6,亞東-新竹,2024-03-19,2184
00830,國泰費城半導體,6,0,6,亞東-新竹,2024-03-19,2184
1324,地球,6,0,6,亞東-新竹,2024-03-19,2184
2201,裕隆,10,4,6,亞東-新竹,2024-03-19,2184
2412,中華電,6,0,6,亞東-新竹,2024-03-19,2184
2845,遠東銀,6,0,6,亞東-新竹,2024-03-19,2184
3234,光環,6,0,6,亞東-新竹,2024-03-19,2184
6451,訊芯-KY,6,0,6,亞東-新竹,2024-03-19,2184
8234,新漢,10,4,6,亞東-新竹,2024-03-19,2184
2371,大同,5,0,5,亞東-新竹,2024-03-19,2184
006208,富邦台50,5,0,5,亞東-新竹,2024-03-19,2184
00939,統一台灣高息動能,475,0,475,亞東-新竹,2024-03-20,2184
00919,群益台灣精選高息,291,144,147,亞東-新竹,2024-03-20,2184
2834,臺企銀,613,500,113,亞東-新竹,2024-03-20,2184
00680L,元大美債20正2,73,0,73,亞東-新竹,2024-03-20,2184
00941,中信上游半導體,63,0,63,亞東-新竹,2024-03-20,2184
3481,群創,41,0,41,亞東-新竹,2024-03-20,2184
00878,國泰永續高股息,38,1,37,亞東-新竹,2024-03-20,2184
6835,圓裕,30,0,30,亞東-新竹,2024-03-20,2184
2354,鴻準,42,14,28,亞東-新竹,2024-03-20,2184
00679B,元大美債20年,27,0,27,亞東-新竹,2024-03-20,2184
2888,新光金,25,0,25,亞東-新竹,2024-03-20,2184
2603,長榮,34,11,23,亞東-新竹,2024-03-20,2184
00937B,群益ESG投等債20,34,13,21,亞東-新竹,2024-03-20,2184
2374,佳能,23,2,21,亞東-新竹,2024-03-20,2184
00688L,國泰20年美債正2,20,0,20,亞東-新竹,2024-03-20,2184
8089,康全電訊,20,0,20,亞東-新竹,2024-03-20,2184
1605,華新,19,1,18,亞東-新竹,2024-03-20,2184
3036,文曄,17,0,17,亞東-新竹,2024-03-20,2184
8234,新漢,23,7,16,亞東-新竹,2024-03-20,2184
8086,宏捷科,14,0,14,亞東-新竹,2024-03-20,2184
6278,台表科,13,0,13,亞東-新竹,2024-03-20,2184
4763,材料-KY,13,1,12,亞東-新竹,2024-03-20,2184
0056,元大高股息,33,21,12,亞東-新竹,2024-03-20,2184
00706L,期元大S＆P日圓正2,12,0,12,亞東-新竹,2024-03-20,2184
1101,台泥,11,0,11,亞東-新竹,2024-03-20,2184
6591,動力-KY,11,0,11,亞東-新竹,2024-03-20,2184
8163,達方,11,0,11,亞東-新竹,2024-03-20,2184
00687B,國泰20年美債,10,0,10,亞東-新竹,2024-03-20,2184
00899,FT潔淨能源,10,0,10,亞東-新竹,2024-03-20,2184
1402,遠東新,10,0,10,亞東-新竹,2024-03-20,2184
2206,三陽工業,11,1,10,亞東-新竹,2024-03-20,2184
2460,建通,13,3,10,亞東-新竹,2024-03-20,2184
4938,和碩,16,6,10,亞東-新竹,2024-03-20,2184
6243,迅杰,10,0,10,亞東-新竹,2024-03-20,2184
2317,鴻海,37,28,9,亞東-新竹,2024-03-20,2184
2356,英業達,17,8,9,亞東-新竹,2024-03-20,2184
3705,永信,9,0,9,亞東-新竹,2024-03-20,2184
2002,中鋼,7,0,7,亞東-新竹,2024-03-20,2184
2344,華邦電,7,0,7,亞東-新竹,2024-03-20,2184
2412,中華電,7,0,7,亞東-新竹,2024-03-20,2184
6191,精成科,7,0,7,亞東-新竹,2024-03-20,2184
6525,捷敏-KY,7,0,7,亞東-新竹,2024-03-20,2184
3260,威剛,6,0,6,亞東-新竹,2024-03-20,2184
1303,南亞,6,0,6,亞東-新竹,2024-03-20,2184
2915,潤泰全,6,0,6,亞東-新竹,2024-03-20,2184
00935,野村臺灣新科技50,6,0,6,亞東-新竹,2024-03-20,2184
1532,勤美,6,0,6,亞東-新竹,2024-03-20,2184
3234,光環,6,0,6,亞東-新竹,2024-03-20,2184
6120,達運,6,0,6,亞東-新竹,2024-03-20,2184
6176,瑞儀,6,0,6,亞東-新竹,2024-03-20,2184
00665L,富邦�琤肭磪囓�2,201,0,201,亞東-新竹,2024-03-21,2184
2618,長榮航,126,10,116,亞東-新竹,2024-03-21,2184
00632R,元大台灣50反1,108,0,108,亞東-新竹,2024-03-21,2184
00939,統一台灣高息動能,111,21,90,亞東-新竹,2024-03-21,2184
00919,群益台灣精選高息,112,23,89,亞東-新竹,2024-03-21,2184
00720B,元大投資級公司債,103,26,77,亞東-新竹,2024-03-21,2184
00937B,群益ESG投等債20,56,0,56,亞東-新竹,2024-03-21,2184
2603,長榮,38,3,35,亞東-新竹,2024-03-21,2184
00680L,元大美債20正2,30,0,30,亞東-新竹,2024-03-21,2184
6015,宏遠證,30,0,30,亞東-新竹,2024-03-21,2184
2367,燿華,46,20,26,亞東-新竹,2024-03-21,2184
1459,聯發,22,0,22,亞東-新竹,2024-03-21,2184
00929,復華台灣科技優息,32,11,21,亞東-新竹,2024-03-21,2184
2031,新光鋼,21,0,21,亞東-新竹,2024-03-21,2184
2915,潤泰全,17,0,17,亞東-新竹,2024-03-21,2184
00687B,國泰20年美債,16,0,16,亞東-新竹,2024-03-21,2184
3522,御嵿,15,0,15,亞東-新竹,2024-03-21,2184
00679B,元大美債20年,14,0,14,亞東-新竹,2024-03-21,2184
3013,晟銘電,16,2,14,亞東-新竹,2024-03-21,2184
3645,達邁,13,0,13,亞東-新竹,2024-03-21,2184
00857B,永豐20年美公債,12,0,12,亞東-新竹,2024-03-21,2184
1587,吉茂,17,6,11,亞東-新竹,2024-03-21,2184
2609,陽明,11,0,11,亞東-新竹,2024-03-21,2184
5483,中美晶,18,7,11,亞東-新竹,2024-03-21,2184
1220,台榮,10,0,10,亞東-新竹,2024-03-21,2184
1513,中興電,18,8,10,亞東-新竹,2024-03-21,2184
1712,興農,10,0,10,亞東-新竹,2024-03-21,2184
3322,建舜電,10,0,10,亞東-新竹,2024-03-21,2184
3346,麗清,10,0,10,亞東-新竹,2024-03-21,2184
4916,事欣科,10,0,10,亞東-新竹,2024-03-21,2184
6416,瑞祺電通,10,0,10,亞東-新竹,2024-03-21,2184
8089,康全電訊,10,0,10,亞東-新竹,2024-03-21,2184
00751B,元大AAA至A公司債,10,1,9,亞東-新竹,2024-03-21,2184
3027,盛達,9,0,9,亞東-新竹,2024-03-21,2184
3234,光環,10,1,9,亞東-新竹,2024-03-21,2184
2329,華泰,17,10,7,亞東-新竹,2024-03-21,2184
00795B,中信美國公債20年,7,0,7,亞東-新竹,2024-03-21,2184
8163,達方,10,3,7,亞東-新竹,2024-03-21,2184
00930,永豐ESG低碳高息,6,0,6,亞東-新竹,2024-03-21,2184
00926,凱基全球菁英55,6,0,6,亞東-新竹,2024-03-21,2184
3163,波若威,6,0,6,亞東-新竹,2024-03-21,2184
2317,鴻海,47,41,6,亞東-新竹,2024-03-21,2184
2454,聯發科,5,0,5,亞東-新竹,2024-03-21,2184
0061,元大寶滬深,5,0,5,亞東-新竹,2024-03-21,2184
00715L,期街口布蘭特正2,9,4,5,亞東-新竹,2024-03-21,2184
2610,華航,5,0,5,亞東-新竹,2024-03-21,2184
2727,王品,5,0,5,亞東-新竹,2024-03-21,2184
3272,東碩,5,0,5,亞東-新竹,2024-03-21,2184
3363,上詮,6,1,5,亞東-新竹,2024-03-21,2184
3231,緯創,7,2,5,亞東-新竹,2024-03-21,2184
6005,群益證,350,0,350,亞東-新竹,2024-03-22,2184
00919,群益台灣精選高息,199,18,181,亞東-新竹,2024-03-22,2184
00885,富邦越南,101,0,101,亞東-新竹,2024-03-22,2184
2834,臺企銀,101,10,91,亞東-新竹,2024-03-22,2184
2881,富邦金,54,0,54,亞東-新竹,2024-03-22,2184
00937B,群益ESG投等債20,102,55,47,亞東-新竹,2024-03-22,2184
1455,集盛,35,0,35,亞東-新竹,2024-03-22,2184
00939,統一台灣高息動能,37,5,32,亞東-新竹,2024-03-22,2184
2303,聯電,48,20,28,亞東-新竹,2024-03-22,2184
1609,大亞,53,28,25,亞東-新竹,2024-03-22,2184
00753L,中信中國50正2,25,0,25,亞東-新竹,2024-03-22,2184
00830,國泰費城半導體,21,0,21,亞東-新竹,2024-03-22,2184
3294,英濟,20,0,20,亞東-新竹,2024-03-22,2184
3322,建舜電,20,0,20,亞東-新竹,2024-03-22,2184
4953,緯軟,20,2,18,亞東-新竹,2024-03-22,2184
2356,英業達,43,25,18,亞東-新竹,2024-03-22,2184
00929,復華台灣科技優息,17,0,17,亞東-新竹,2024-03-22,2184
6591,動力-KY,17,0,17,亞東-新竹,2024-03-22,2184
2449,京元電子,27,12,15,亞東-新竹,2024-03-22,2184
00637L,元大滬深300正2,13,0,13,亞東-新竹,2024-03-22,2184
00941,中信上游半導體,33,21,12,亞東-新竹,2024-03-22,2184
0056,元大高股息,33,22,11,亞東-新竹,2024-03-22,2184
3706,神達,33,22,11,亞東-新竹,2024-03-22,2184
1303,南亞,10,0,10,亞東-新竹,2024-03-22,2184
00687B,國泰20年美債,10,0,10,亞東-新竹,2024-03-22,2184
2313,華通,10,0,10,亞東-新竹,2024-03-22,2184
2882,國泰金,70,60,10,亞東-新竹,2024-03-22,2184
2888,新光金,10,0,10,亞東-新竹,2024-03-22,2184
3083,網龍,10,0,10,亞東-新竹,2024-03-22,2184
3217,優群,10,0,10,亞東-新竹,2024-03-22,2184
8011,台通,10,0,10,亞東-新竹,2024-03-22,2184
6139,亞翔,17,7,10,亞東-新竹,2024-03-22,2184
00891,中信關鍵半導體,9,0,9,亞東-新竹,2024-03-22,2184
00670L,富邦NASDAQ正2,9,0,9,亞東-新竹,2024-03-22,2184
2891,中信金,31,22,9,亞東-新竹,2024-03-22,2184
3023,信邦,9,0,9,亞東-新竹,2024-03-22,2184
3481,群創,11,2,9,亞東-新竹,2024-03-22,2184
8349,�矬�,8,0,8,亞東-新竹,2024-03-22,2184
2809,京城銀,7,0,7,亞東-新竹,2024-03-22,2184
5871,中租-KY,7,0,7,亞東-新竹,2024-03-22,2184
00713,元大台灣高息低波,16,10,6,亞東-新竹,2024-03-22,2184
5483,中美晶,13,7,6,亞東-新竹,2024-03-22,2184
1459,聯發,6,0,6,亞東-新竹,2024-03-22,2184
2353,宏��,11,5,6,亞東-新竹,2024-03-22,2184
3711,日月光投控,6,0,6,亞東-新竹,2024-03-22,2184
8089,康全電訊,6,0,6,亞東-新竹,2024-03-22,2184
3346,麗清,5,0,5,亞東-新竹,2024-03-22,2184
2374,佳能,5,0,5,亞東-新竹,2024-03-22,2184
2603,長榮,19,14,5,亞東-新竹,2024-03-22,2184
2727,王品,5,0,5,亞東-新竹,2024-03-22,2184
2882,國泰金,135,0,135,亞東-新竹,2024-03-25,2184
2356,英業達,108,15,93,亞東-新竹,2024-03-25,2184
00937B,群益ESG投等債20,82,0,82,亞東-新竹,2024-03-25,2184
00939,統一台灣高息動能,75,0,75,亞東-新竹,2024-03-25,2184
00941,中信上游半導體,95,33,62,亞東-新竹,2024-03-25,2184
1609,大亞,83,28,55,亞東-新竹,2024-03-25,2184
3231,緯創,45,2,43,亞東-新竹,2024-03-25,2184
2303,聯電,36,0,36,亞東-新竹,2024-03-25,2184
6416,瑞祺電通,35,0,35,亞東-新竹,2024-03-25,2184
1605,華新,29,0,29,亞東-新竹,2024-03-25,2184
2845,遠東銀,30,6,24,亞東-新竹,2024-03-25,2184
2317,鴻海,27,4,23,亞東-新竹,2024-03-25,2184
00878,國泰永續高股息,33,10,23,亞東-新竹,2024-03-25,2184
6488,環球晶,22,0,22,亞東-新竹,2024-03-25,2184
0056,元大高股息,26,5,21,亞東-新竹,2024-03-25,2184
1808,潤隆,19,0,19,亞東-新竹,2024-03-25,2184
00679B,元大美債20年,30,13,17,亞東-新竹,2024-03-25,2184
2618,長榮航,16,0,16,亞東-新竹,2024-03-25,2184
3083,網龍,16,0,16,亞東-新竹,2024-03-25,2184
6806,森崴能源,13,0,13,亞東-新竹,2024-03-25,2184
00891,中信關鍵半導體,13,0,13,亞東-新竹,2024-03-25,2184
00646,元大S＆P500,20,8,12,亞東-新竹,2024-03-25,2184
3321,同泰,13,1,12,亞東-新竹,2024-03-25,2184
2316,楠梓電,14,3,11,亞東-新竹,2024-03-25,2184
00931B,統一美債20年,10,0,10,亞東-新竹,2024-03-25,2184
2897A,王道銀甲特,10,0,10,亞東-新竹,2024-03-25,2184
3322,建舜電,10,0,10,亞東-新竹,2024-03-25,2184
3522,御嵿,10,0,10,亞東-新竹,2024-03-25,2184
6015,宏遠證,10,0,10,亞東-新竹,2024-03-25,2184
6719,力智,10,0,10,亞東-新竹,2024-03-25,2184
1616,億泰,8,0,8,亞東-新竹,2024-03-25,2184
2376,技嘉,9,1,8,亞東-新竹,2024-03-25,2184
1310,台苯,7,0,7,亞東-新竹,2024-03-25,2184
00697B,元大美債7-10,13,6,7,亞東-新竹,2024-03-25,2184
2464,盟立,11,4,7,亞東-新竹,2024-03-25,2184
2359,所羅門,8,1,7,亞東-新竹,2024-03-25,2184
2329,華泰,15,8,7,亞東-新竹,2024-03-25,2184
2337,旺宏,6,0,6,亞東-新竹,2024-03-25,2184
1785,光洋科,21,15,6,亞東-新竹,2024-03-25,2184
2344,華邦電,16,10,6,亞東-新竹,2024-03-25,2184
3062,建漢,7,1,6,亞東-新竹,2024-03-25,2184
3481,群創,6,0,6,亞東-新竹,2024-03-25,2184
3708,上緯投控,6,0,6,亞東-新竹,2024-03-25,2184
4938,和碩,6,0,6,亞東-新竹,2024-03-25,2184
6668,中揚光,7,1,6,亞東-新竹,2024-03-25,2184
4958,臻鼎-KY,5,0,5,亞東-新竹,2024-03-25,2184
4109,加捷生醫,5,0,5,亞東-新竹,2024-03-25,2184
00687B,國泰20年美債,5,0,5,亞東-新竹,2024-03-25,2184
00642U,期元大S＆P石油,8,3,5,亞東-新竹,2024-03-25,2184
1524,耿鼎,5,0,5,亞東-新竹,2024-03-25,2184
00939,統一台灣高息動能,137,20,117,亞東-新竹,2024-03-26,2184
2603,長榮,49,3,46,亞東-新竹,2024-03-26,2184
1603,華電,36,0,36,亞東-新竹,2024-03-26,2184
2356,英業達,59,24,35,亞東-新竹,2024-03-26,2184
2382,廣達,39,4,35,亞東-新竹,2024-03-26,2184
9105,泰金寶-DR,30,0,30,亞東-新竹,2024-03-26,2184
1513,中興電,43,13,30,亞東-新竹,2024-03-26,2184
3346,麗清,25,0,25,亞東-新竹,2024-03-26,2184
3217,優群,20,0,20,亞東-新竹,2024-03-26,2184
6591,動力-KY,18,0,18,亞東-新竹,2024-03-26,2184
2610,華航,17,0,17,亞東-新竹,2024-03-26,2184
4915,致伸,19,2,17,亞東-新竹,2024-03-26,2184
2449,京元電子,33,17,16,亞東-新竹,2024-03-26,2184
3708,上緯投控,17,3,14,亞東-新竹,2024-03-26,2184
4938,和碩,15,1,14,亞東-新竹,2024-03-26,2184
1785,光洋科,18,5,13,亞東-新竹,2024-03-26,2184
1815,富喬,12,1,11,亞東-新竹,2024-03-26,2184
2359,所羅門,53,42,11,亞東-新竹,2024-03-26,2184
3035,智原,12,2,10,亞東-新竹,2024-03-26,2184
020034,元大IC設計N,10,0,10,亞東-新竹,2024-03-26,2184
2460,建通,10,0,10,亞東-新竹,2024-03-26,2184
3062,建漢,10,0,10,亞東-新竹,2024-03-26,2184
8111,立��,10,0,10,亞東-新竹,2024-03-26,2184
3545,敦泰,10,1,9,亞東-新竹,2024-03-26,2184
4908,前鼎,19,10,9,亞東-新竹,2024-03-26,2184
00637L,元大滬深300正2,10,1,9,亞東-新竹,2024-03-26,2184
00679B,元大美債20年,8,0,8,亞東-新竹,2024-03-26,2184
3583,辛耘,14,6,8,亞東-新竹,2024-03-26,2184
2313,華通,7,0,7,亞東-新竹,2024-03-26,2184
2338,光罩,7,0,7,亞東-新竹,2024-03-26,2184
4714,永捷,7,0,7,亞東-新竹,2024-03-26,2184
5347,世界,13,6,7,亞東-新竹,2024-03-26,2184
6215,和椿,8,1,7,亞東-新竹,2024-03-26,2184
2329,華泰,28,22,6,亞東-新竹,2024-03-26,2184
00751B,元大AAA至A公司債,6,0,6,亞東-新竹,2024-03-26,2184
2020,美亞,6,0,6,亞東-新竹,2024-03-26,2184
2409,友達,6,0,6,亞東-新竹,2024-03-26,2184
3321,同泰,6,0,6,亞東-新竹,2024-03-26,2184
8033,雷虎,6,0,6,亞東-新竹,2024-03-26,2184
3231,緯創,18,12,6,亞東-新竹,2024-03-26,2184
00764B,群益25年美債,5,0,5,亞東-新竹,2024-03-26,2184
00931B,統一美債20年,5,0,5,亞東-新竹,2024-03-26,2184
00900,富邦特選高股息30,11,6,5,亞東-新竹,2024-03-26,2184
2006,東和鋼鐵,5,0,5,亞東-新竹,2024-03-26,2184
3272,東碩,5,0,5,亞東-新竹,2024-03-26,2184
3363,上詮,6,1,5,亞東-新竹,2024-03-26,2184
3481,群創,15,10,5,亞東-新竹,2024-03-26,2184
6167,久正,5,0,5,亞東-新竹,2024-03-26,2184
6191,精成科,5,0,5,亞東-新竹,2024-03-26,2184
6683,雍智科技,5,0,5,亞東-新竹,2024-03-26,2184
00687B,國泰20年美債,129,0,129,亞東-新竹,2024-03-27,2184
00937B,群益ESG投等債20,121,0,121,亞東-新竹,2024-03-27,2184
00751B,元大AAA至A公司債,86,0,86,亞東-新竹,2024-03-27,2184
00941,中信上游半導體,65,10,55,亞東-新竹,2024-03-27,2184
00632R,元大台灣50反1,50,0,50,亞東-新竹,2024-03-27,2184
00680L,元大美債20正2,45,0,45,亞東-新竹,2024-03-27,2184
00696B,富邦美債20年,40,0,40,亞東-新竹,2024-03-27,2184
00720B,元大投資級公司債,39,0,39,亞東-新竹,2024-03-27,2184
00637L,元大滬深300正2,24,1,23,亞東-新竹,2024-03-27,2184
3287,廣寰科,16,0,16,亞東-新竹,2024-03-27,2184
2367,燿華,15,3,12,亞東-新竹,2024-03-27,2184
2460,建通,11,0,11,亞東-新竹,2024-03-27,2184
00933B,國泰10Y+金融債,10,0,10,亞東-新竹,2024-03-27,2184
00915,凱基優選高股息30,10,0,10,亞東-新竹,2024-03-27,2184
1314,中石化,10,0,10,亞東-新竹,2024-03-27,2184
1701,中化,10,0,10,亞東-新竹,2024-03-27,2184
2388,威盛,10,0,10,亞東-新竹,2024-03-27,2184
3490,單井,10,0,10,亞東-新竹,2024-03-27,2184
4417,金洲,10,0,10,亞東-新竹,2024-03-27,2184
2301,光寶科,10,1,9,亞東-新竹,2024-03-27,2184
1310,台苯,8,0,8,亞東-新竹,2024-03-27,2184
2010,春源,8,0,8,亞東-新竹,2024-03-27,2184
2353,宏��,10,2,8,亞東-新竹,2024-03-27,2184
6271,同欣電,7,0,7,亞東-新竹,2024-03-27,2184
3052,夆典,7,0,7,亞東-新竹,2024-03-27,2184
2884,玉山金,6,0,6,亞東-新竹,2024-03-27,2184
3231,緯創,6,0,6,亞東-新竹,2024-03-27,2184
2404,漢唐,8,2,6,亞東-新竹,2024-03-27,2184
3321,同泰,6,0,6,亞東-新竹,2024-03-27,2184
4938,和碩,6,0,6,亞東-新竹,2024-03-27,2184
8040,九暘,6,0,6,亞東-新竹,2024-03-27,2184
3051,力特,5,0,5,亞東-新竹,2024-03-27,2184
1442,名軒,5,0,5,亞東-新竹,2024-03-27,2184
1452,宏益,5,0,5,亞東-新竹,2024-03-27,2184
1471,首利,5,0,5,亞東-新竹,2024-03-27,2184
2006,東和鋼鐵,5,0,5,亞東-新竹,2024-03-27,2184
2402,毅嘉,5,0,5,亞東-新竹,2024-03-27,2184
2481,強茂,5,0,5,亞東-新竹,2024-03-27,2184
3522,御嵿,5,0,5,亞東-新竹,2024-03-27,2184
4109,加捷生醫,5,0,5,亞東-新竹,2024-03-27,2184
4526,東台,5,0,5,亞東-新竹,2024-03-27,2184
5443,均豪,5,0,5,亞東-新竹,2024-03-27,2184
6015,宏遠證,5,0,5,亞東-新竹,2024-03-27,2184
6140,訊達,5,0,5,亞東-新竹,2024-03-27,2184
6167,久正,5,0,5,亞東-新竹,2024-03-27,2184
6591,動力-KY,5,0,5,亞東-新竹,2024-03-27,2184
8358,金居,5,0,5,亞東-新竹,2024-03-27,2184
2371,大同,9,5,4,亞東-新竹,2024-03-27,2184
6770,力積電,9,5,4,亞東-新竹,2024-03-27,2184
2401,凌陽,4,0,4,亞東-新竹,2024-03-27,2184
2883,凱基金,207,102,105,亞東-新竹,2024-03-28,2184
00632R,元大台灣50反1,62,0,62,亞東-新竹,2024-03-28,2184
00857B,永豐20年美公債,62,0,62,亞東-新竹,2024-03-28,2184
6005,群益證,74,14,60,亞東-新竹,2024-03-28,2184
00937B,群益ESG投等債20,60,4,56,亞東-新竹,2024-03-28,2184
2401,凌陽,50,0,50,亞東-新竹,2024-03-28,2184
2354,鴻準,46,10,36,亞東-新竹,2024-03-28,2184
5880,合庫金,36,1,35,亞東-新竹,2024-03-28,2184
3313,斐成,30,0,30,亞東-新竹,2024-03-28,2184
9945,潤泰新,30,0,30,亞東-新竹,2024-03-28,2184
2458,義隆,21,0,21,亞東-新竹,2024-03-28,2184
2402,毅嘉,20,0,20,亞東-新竹,2024-03-28,2184
00751B,元大AAA至A公司債,19,0,19,亞東-新竹,2024-03-28,2184
3163,波若威,22,3,19,亞東-新竹,2024-03-28,2184
3706,神達,20,1,19,亞東-新竹,2024-03-28,2184
00919,群益台灣精選高息,47,32,15,亞東-新竹,2024-03-28,2184
00882,中信中國高股息,14,0,14,亞東-新竹,2024-03-28,2184
0056,元大高股息,14,1,13,亞東-新竹,2024-03-28,2184
00939,統一台灣高息動能,11,1,10,亞東-新竹,2024-03-28,2184
00941,中信上游半導體,10,0,10,亞東-新竹,2024-03-28,2184
2352,佳世達,10,0,10,亞東-新竹,2024-03-28,2184
2888,新光金,10,0,10,亞東-新竹,2024-03-28,2184
4129,聯合,10,0,10,亞東-新竹,2024-03-28,2184
4916,事欣科,10,0,10,亞東-新竹,2024-03-28,2184
8086,宏捷科,9,0,9,亞東-新竹,2024-03-28,2184
00878,國泰永續高股息,9,0,9,亞東-新竹,2024-03-28,2184
00905,FT臺灣Smart,9,0,9,亞東-新竹,2024-03-28,2184
1808,潤隆,23,14,9,亞東-新竹,2024-03-28,2184
8040,九暘,9,0,9,亞東-新竹,2024-03-28,2184
2382,廣達,14,5,9,亞東-新竹,2024-03-28,2184
2330,台積電,11,2,9,亞東-新竹,2024-03-28,2184
3312,弘憶股,8,0,8,亞東-新竹,2024-03-28,2184
1314,中石化,7,0,7,亞東-新竹,2024-03-28,2184
3272,東碩,7,0,7,亞東-新竹,2024-03-28,2184
2301,光寶科,7,1,6,亞東-新竹,2024-03-28,2184
4105,東洋,7,1,6,亞東-新竹,2024-03-28,2184
00929,復華台灣科技優息,10,4,6,亞東-新竹,2024-03-28,2184
2368,金像電,6,0,6,亞東-新竹,2024-03-28,2184
3287,廣寰科,6,0,6,亞東-新竹,2024-03-28,2184
3339,泰谷,6,0,6,亞東-新竹,2024-03-28,2184
2329,華泰,12,7,5,亞東-新竹,2024-03-28,2184
00713,元大台灣高息低波,5,0,5,亞東-新竹,2024-03-28,2184
00904,新光臺灣半導體30,5,0,5,亞東-新竹,2024-03-28,2184
00719B,元大美債1-3,5,0,5,亞東-新竹,2024-03-28,2184
1442,名軒,5,0,5,亞東-新竹,2024-03-28,2184
2603,長榮,39,34,5,亞東-新竹,2024-03-28,2184
3545,敦泰,5,0,5,亞東-新竹,2024-03-28,2184
6282,康舒,5,0,5,亞東-新竹,2024-03-28,2184
6591,動力-KY,5,0,5,亞東-新竹,2024-03-28,2184
6683,雍智科技,5,0,5,亞東-新竹,2024-03-28,2184
00933B,國泰10Y+金融債,270,0,270,亞東-新竹,2024-03-29,2184
6163,華電網,140,0,140,亞東-新竹,2024-03-29,2184
00673R,期元大S＆P原油反1,75,0,75,亞東-新竹,2024-03-29,2184
1459,聯發,58,0,58,亞東-新竹,2024-03-29,2184
2356,英業達,98,42,56,亞東-新竹,2024-03-29,2184
1618,合機,52,0,52,亞東-新竹,2024-03-29,2184
3450,聯鈞,52,2,50,亞東-新竹,2024-03-29,2184
00939,統一台灣高息動能,37,0,37,亞東-新竹,2024-03-29,2184
6219,富旺,31,0,31,亞東-新竹,2024-03-29,2184
2317,鴻海,66,39,27,亞東-新竹,2024-03-29,2184
2354,鴻準,40,15,25,亞東-新竹,2024-03-29,2184
1808,潤隆,20,0,20,亞東-新竹,2024-03-29,2184
2314,台揚,22,5,17,亞東-新竹,2024-03-29,2184
2405,輔信,16,0,16,亞東-新竹,2024-03-29,2184
2449,京元電子,16,0,16,亞東-新竹,2024-03-29,2184
2382,廣達,28,14,14,亞東-新竹,2024-03-29,2184
3325,旭品,11,0,11,亞東-新竹,2024-03-29,2184
00637L,元大滬深300正2,11,0,11,亞東-新竹,2024-03-29,2184
00753L,中信中國50正2,10,0,10,亞東-新竹,2024-03-29,2184
1909,榮成,10,0,10,亞東-新竹,2024-03-29,2184
2464,盟立,10,0,10,亞東-新竹,2024-03-29,2184
2734,易飛網,10,0,10,亞東-新竹,2024-03-29,2184
2834,臺企銀,10,0,10,亞東-新竹,2024-03-29,2184
5876,上海商銀,20,10,10,亞東-新竹,2024-03-29,2184
00919,群益台灣精選高息,22,12,10,亞東-新竹,2024-03-29,2184
6139,亞翔,14,5,9,亞東-新竹,2024-03-29,2184
1722,台肥,9,0,9,亞東-新竹,2024-03-29,2184
00713,元大台灣高息低波,9,1,8,亞東-新竹,2024-03-29,2184
00687B,國泰20年美債,8,0,8,亞東-新竹,2024-03-29,2184
3312,弘憶股,8,0,8,亞東-新竹,2024-03-29,2184
6122,擎邦,8,0,8,亞東-新竹,2024-03-29,2184
6136,富爾特,8,0,8,亞東-新竹,2024-03-29,2184
6591,動力-KY,8,0,8,亞東-新竹,2024-03-29,2184
2301,光寶科,7,0,7,亞東-新竹,2024-03-29,2184
00929,復華台灣科技優息,20,13,7,亞東-新竹,2024-03-29,2184
2409,友達,7,0,7,亞東-新竹,2024-03-29,2184
2421,建準,13,6,7,亞東-新竹,2024-03-29,2184
2492,華新科,9,2,7,亞東-新竹,2024-03-29,2184
2618,長榮航,17,10,7,亞東-新竹,2024-03-29,2184
3372,典範,10,3,7,亞東-新竹,2024-03-29,2184
8463,潤泰材,7,0,7,亞東-新竹,2024-03-29,2184
1515,力山,6,0,6,亞東-新竹,2024-03-29,2184
2328,廣宇,6,0,6,亞東-新竹,2024-03-29,2184
4908,前鼎,6,0,6,亞東-新竹,2024-03-29,2184
5457,宣德,6,0,6,亞東-新竹,2024-03-29,2184
6197,佳必琪,6,0,6,亞東-新竹,2024-03-29,2184
9921,巨大,6,0,6,亞東-新竹,2024-03-29,2184
00918,大華優利高填息30,5,0,5,亞東-新竹,2024-03-29,2184
0061,元大寶滬深,5,0,5,亞東-新竹,2024-03-29,2184
00632R,元大台灣50反1,5,0,5,亞東-新竹,2024-03-29,2184
00940,元大台灣價值高息,502,50,452,亞東-新竹,2024-04-01,2184
2515,中工,67,0,67,亞東-新竹,2024-04-01,2184
2885,元大金,50,0,50,亞東-新竹,2024-04-01,2184
1582,信錦,31,0,31,亞東-新竹,2024-04-01,2184
2417,圓剛,30,0,30,亞東-新竹,2024-04-01,2184
00939,統一台灣高息動能,30,1,29,亞東-新竹,2024-04-01,2184
2634,漢翔,32,3,29,亞東-新竹,2024-04-01,2184
8463,潤泰材,26,0,26,亞東-新竹,2024-04-01,2184
2313,華通,27,2,25,亞東-新竹,2024-04-01,2184
00680L,元大美債20正2,23,0,23,亞東-新竹,2024-04-01,2184
2891,中信金,31,10,21,亞東-新竹,2024-04-01,2184
3481,群創,21,0,21,亞東-新竹,2024-04-01,2184
00919,群益台灣精選高息,21,2,19,亞東-新竹,2024-04-01,2184
00941,中信上游半導體,16,0,16,亞東-新竹,2024-04-01,2184
6770,力積電,21,5,16,亞東-新竹,2024-04-01,2184
1808,潤隆,20,6,14,亞東-新竹,2024-04-01,2184
00878,國泰永續高股息,22,10,12,亞東-新竹,2024-04-01,2184
2382,廣達,15,3,12,亞東-新竹,2024-04-01,2184
2603,長榮,47,36,11,亞東-新竹,2024-04-01,2184
3450,聯鈞,11,0,11,亞東-新竹,2024-04-01,2184
00632R,元大台灣50反1,10,0,10,亞東-新竹,2024-04-01,2184
00665L,富邦�琤肭磪囓�2,10,0,10,亞東-新竹,2024-04-01,2184
1584,精剛,10,0,10,亞東-新竹,2024-04-01,2184
2316,楠梓電,10,0,10,亞東-新竹,2024-04-01,2184
2352,佳世達,10,0,10,亞東-新竹,2024-04-01,2184
3522,御嵿,10,0,10,亞東-新竹,2024-04-01,2184
6239,力成,10,0,10,亞東-新竹,2024-04-01,2184
6416,瑞祺電通,10,0,10,亞東-新竹,2024-04-01,2184
00687B,國泰20年美債,9,0,9,亞東-新竹,2024-04-01,2184
2367,燿華,10,1,9,亞東-新竹,2024-04-01,2184
2439,美律,9,0,9,亞東-新竹,2024-04-01,2184
6550,北極星藥業-KY,9,0,9,亞東-新竹,2024-04-01,2184
2618,長榮航,15,7,8,亞東-新竹,2024-04-01,2184
1310,台苯,8,0,8,亞東-新竹,2024-04-01,2184
2505,國揚,8,0,8,亞東-新竹,2024-04-01,2184
4952,凌通,8,0,8,亞東-新竹,2024-04-01,2184
2303,聯電,20,13,7,亞東-新竹,2024-04-01,2184
2330,台積電,8,1,7,亞東-新竹,2024-04-01,2184
3260,威剛,9,2,7,亞東-新竹,2024-04-01,2184
3583,辛耘,12,5,7,亞東-新竹,2024-04-01,2184
4743,合一,7,0,7,亞東-新竹,2024-04-01,2184
1720,生達,5,0,5,亞東-新竹,2024-04-01,2184
2038,海光,5,0,5,亞東-新竹,2024-04-01,2184
2393,億光,5,0,5,亞東-新竹,2024-04-01,2184
2449,京元電子,5,0,5,亞東-新竹,2024-04-01,2184
2467,志聖,10,5,5,亞東-新竹,2024-04-01,2184
2601,益航,5,0,5,亞東-新竹,2024-04-01,2184
6188,廣明,14,9,5,亞東-新竹,2024-04-01,2184
6235,華孚,5,0,5,亞東-新竹,2024-04-01,2184
00640L,富邦日本正2,4,0,4,亞東-新竹,2024-04-01,2184
00941,中信上游半導體,314,0,314,亞東-新竹,2024-04-02,2184
00940,元大台灣價值高息,150,11,139,亞東-新竹,2024-04-02,2184
00720B,元大投資級公司債,124,0,124,亞東-新竹,2024-04-02,2184
00929,復華台灣科技優息,105,11,94,亞東-新竹,2024-04-02,2184
00680L,元大美債20正2,95,3,92,亞東-新竹,2024-04-02,2184
5521,工信,60,0,60,亞東-新竹,2024-04-02,2184
00933B,國泰10Y+金融債,59,0,59,亞東-新竹,2024-04-02,2184
00795B,中信美國公債20年,40,0,40,亞東-新竹,2024-04-02,2184
00687B,國泰20年美債,34,0,34,亞東-新竹,2024-04-02,2184
00751B,元大AAA至A公司債,31,0,31,亞東-新竹,2024-04-02,2184
00679B,元大美債20年,30,0,30,亞東-新竹,2024-04-02,2184
2374,佳能,30,0,30,亞東-新竹,2024-04-02,2184
00937B,群益ESG投等債20,29,0,29,亞東-新竹,2024-04-02,2184
00878,國泰永續高股息,30,1,29,亞東-新竹,2024-04-02,2184
1582,信錦,26,0,26,亞東-新竹,2024-04-02,2184
2345,智邦,24,0,24,亞東-新竹,2024-04-02,2184
2405,輔信,24,0,24,亞東-新竹,2024-04-02,2184
2329,華泰,20,0,20,亞東-新竹,2024-04-02,2184
2912,統一超,20,0,20,亞東-新竹,2024-04-02,2184
6770,力積電,25,5,20,亞東-新竹,2024-04-02,2184
5498,凱崴,18,0,18,亞東-新竹,2024-04-02,2184
1720,生達,14,0,14,亞東-新竹,2024-04-02,2184
00740B,富邦全球投等債,13,0,13,亞東-新竹,2024-04-02,2184
2634,漢翔,14,1,13,亞東-新竹,2024-04-02,2184
6202,盛群,20,8,12,亞東-新竹,2024-04-02,2184
00637L,元大滬深300正2,12,1,11,亞東-新竹,2024-04-02,2184
3706,神達,15,4,11,亞東-新竹,2024-04-02,2184
6120,達運,12,1,11,亞東-新竹,2024-04-02,2184
6138,茂達,10,0,10,亞東-新竹,2024-04-02,2184
0061,元大寶滬深,10,0,10,亞東-新竹,2024-04-02,2184
1402,遠東新,10,0,10,亞東-新竹,2024-04-02,2184
2408,南亞科,10,0,10,亞東-新竹,2024-04-02,2184
3322,建舜電,10,0,10,亞東-新竹,2024-04-02,2184
3715,定穎投控,12,2,10,亞東-新竹,2024-04-02,2184
4129,聯合,10,0,10,亞東-新竹,2024-04-02,2184
5876,上海商銀,10,0,10,亞東-新竹,2024-04-02,2184
6015,宏遠證,10,0,10,亞東-新竹,2024-04-02,2184
1785,光洋科,10,1,9,亞東-新竹,2024-04-02,2184
00939,統一台灣高息動能,11,2,9,亞東-新竹,2024-04-02,2184
8092,建暐,8,0,8,亞東-新竹,2024-04-02,2184
2371,大同,27,20,7,亞東-新竹,2024-04-02,2184
3324,雙鴻,10,3,7,亞東-新竹,2024-04-02,2184
6197,佳必琪,8,1,7,亞東-新竹,2024-04-02,2184
2618,長榮航,16,10,6,亞東-新竹,2024-04-02,2184
00673R,期元大S＆P原油反1,6,0,6,亞東-新竹,2024-04-02,2184
2344,華邦電,6,0,6,亞東-新竹,2024-04-02,2184
2352,佳世達,6,0,6,亞東-新竹,2024-04-02,2184
3013,晟銘電,7,1,6,亞東-新竹,2024-04-02,2184
8064,東捷,12,6,6,亞東-新竹,2024-04-02,2184
1102,亞泥,5,0,5,亞東-新竹,2024-04-02,2184
00940,元大台灣價值高息,815,2,813,亞東-新竹,2024-04-03,2184
3062,建漢,218,3,215,亞東-新竹,2024-04-03,2184
00929,復華台灣科技優息,92,11,81,亞東-新竹,2024-04-03,2184
00720B,元大投資級公司債,70,0,70,亞東-新竹,2024-04-03,2184
6120,達運,72,3,69,亞東-新竹,2024-04-03,2184
2610,華航,66,0,66,亞東-新竹,2024-04-03,2184
2618,長榮航,43,0,43,亞東-新竹,2024-04-03,2184
2882,國泰金,41,0,41,亞東-新竹,2024-04-03,2184
00751B,元大AAA至A公司債,71,30,41,亞東-新竹,2024-04-03,2184
00933B,國泰10Y+金融債,39,0,39,亞東-新竹,2024-04-03,2184
00687B,國泰20年美債,38,0,38,亞東-新竹,2024-04-03,2184
00941,中信上游半導體,47,10,37,亞東-新竹,2024-04-03,2184
00680L,元大美債20正2,35,0,35,亞東-新竹,2024-04-03,2184
1795,美時,31,0,31,亞東-新竹,2024-04-03,2184
00927,群益半導體收益,27,0,27,亞東-新竹,2024-04-03,2184
5443,均豪,26,0,26,亞東-新竹,2024-04-03,2184
00679B,元大美債20年,27,3,24,亞東-新竹,2024-04-03,2184
00637L,元大滬深300正2,21,0,21,亞東-新竹,2024-04-03,2184
2014,中鴻,20,0,20,亞東-新竹,2024-04-03,2184
5880,合庫金,20,0,20,亞東-新竹,2024-04-03,2184
00937B,群益ESG投等債20,18,1,17,亞東-新竹,2024-04-03,2184
4908,前鼎,15,0,15,亞東-新竹,2024-04-03,2184
1603,華電,15,0,15,亞東-新竹,2024-04-03,2184
2809,京城銀,14,0,14,亞東-新竹,2024-04-03,2184
2412,中華電,13,0,13,亞東-新竹,2024-04-03,2184
00795B,中信美國公債20年,11,0,11,亞東-新竹,2024-04-03,2184
3450,聯鈞,13,2,11,亞東-新竹,2024-04-03,2184
6668,中揚光,11,0,11,亞東-新竹,2024-04-03,2184
0061,元大寶滬深,10,0,10,亞東-新竹,2024-04-03,2184
3357,臺慶科,10,0,10,亞東-新竹,2024-04-03,2184
5009,榮剛,11,1,10,亞東-新竹,2024-04-03,2184
5521,工信,10,0,10,亞東-新竹,2024-04-03,2184
4129,聯合,9,0,9,亞東-新竹,2024-04-03,2184
2201,裕隆,8,0,8,亞東-新竹,2024-04-03,2184
2303,聯電,10,2,8,亞東-新竹,2024-04-03,2184
2344,華邦電,18,10,8,亞東-新竹,2024-04-03,2184
3715,定穎投控,8,0,8,亞東-新竹,2024-04-03,2184
2330,台積電,7,0,7,亞東-新竹,2024-04-03,2184
2406,國碩,7,0,7,亞東-新竹,2024-04-03,2184
2409,友達,14,7,7,亞東-新竹,2024-04-03,2184
2883,凱基金,7,0,7,亞東-新竹,2024-04-03,2184
3013,晟銘電,12,5,7,亞東-新竹,2024-04-03,2184
4952,凌通,7,0,7,亞東-新竹,2024-04-03,2184
6462,神盾,15,8,7,亞東-新竹,2024-04-03,2184
3035,智原,7,1,6,亞東-新竹,2024-04-03,2184
00712,復華富時不動產,6,0,6,亞東-新竹,2024-04-03,2184
00936,台新永續高息中小,6,0,6,亞東-新竹,2024-04-03,2184
00724B,群益投資級金融債,6,0,6,亞東-新竹,2024-04-03,2184
00632R,元大台灣50反1,6,0,6,亞東-新竹,2024-04-03,2184
3078,僑威,6,0,6,亞東-新竹,2024-04-03,2184
00940,元大台灣價值高息,567,10,557,亞東-新竹,2024-04-08,2184
00941,中信上游半導體,293,5,288,亞東-新竹,2024-04-08,2184
6015,宏遠證,70,0,70,亞東-新竹,2024-04-08,2184
00720B,元大投資級公司債,61,0,61,亞東-新竹,2024-04-08,2184
00751B,元大AAA至A公司債,64,15,49,亞東-新竹,2024-04-08,2184
00937B,群益ESG投等債20,43,0,43,亞東-新竹,2024-04-08,2184
00919,群益台灣精選高息,47,6,41,亞東-新竹,2024-04-08,2184
00679B,元大美債20年,32,0,32,亞東-新竹,2024-04-08,2184
2367,燿華,30,0,30,亞東-新竹,2024-04-08,2184
00687B,國泰20年美債,27,0,27,亞東-新竹,2024-04-08,2184
1609,大亞,37,10,27,亞東-新竹,2024-04-08,2184
00929,復華台灣科技優息,36,9,27,亞東-新竹,2024-04-08,2184
00927,群益半導體收益,23,0,23,亞東-新竹,2024-04-08,2184
00712,復華富時不動產,21,0,21,亞東-新竹,2024-04-08,2184
00857B,永豐20年美公債,21,0,21,亞東-新竹,2024-04-08,2184
00637L,元大滬深300正2,20,0,20,亞東-新竹,2024-04-08,2184
2603,長榮,51,31,20,亞東-新竹,2024-04-08,2184
8011,台通,20,0,20,亞東-新竹,2024-04-08,2184
1808,潤隆,32,14,18,亞東-新竹,2024-04-08,2184
1582,信錦,17,0,17,亞東-新竹,2024-04-08,2184
2449,京元電子,16,0,16,亞東-新竹,2024-04-08,2184
00931B,統一美債20年,15,0,15,亞東-新竹,2024-04-08,2184
1710,東聯,15,0,15,亞東-新竹,2024-04-08,2184
00680L,元大美債20正2,14,2,12,亞東-新竹,2024-04-08,2184
2344,華邦電,26,15,11,亞東-新竹,2024-04-08,2184
00772B,中信高評級公司債,11,0,11,亞東-新竹,2024-04-08,2184
00673R,期元大S＆P原油反1,10,0,10,亞東-新竹,2024-04-08,2184
1608,華榮,10,0,10,亞東-新竹,2024-04-08,2184
2460,建通,20,10,10,亞東-新竹,2024-04-08,2184
2489,瑞軒,10,0,10,亞東-新竹,2024-04-08,2184
3466,德晉,10,0,10,亞東-新竹,2024-04-08,2184
3522,御嵿,10,0,10,亞東-新竹,2024-04-08,2184
4510,高鋒,10,0,10,亞東-新竹,2024-04-08,2184
2506,太設,9,0,9,亞東-新竹,2024-04-08,2184
2352,佳世達,8,0,8,亞東-新竹,2024-04-08,2184
3032,偉訓,8,0,8,亞東-新竹,2024-04-08,2184
4545,銘鈺,8,0,8,亞東-新竹,2024-04-08,2184
8933,愛地雅,8,0,8,亞東-新竹,2024-04-08,2184
3035,智原,15,8,7,亞東-新竹,2024-04-08,2184
6179,亞通,7,0,7,亞東-新竹,2024-04-08,2184
00939,統一台灣高息動能,6,0,6,亞東-新竹,2024-04-08,2184
00891,中信關鍵半導體,7,1,6,亞東-新竹,2024-04-08,2184
1442,名軒,6,0,6,亞東-新竹,2024-04-08,2184
1722,台肥,6,0,6,亞東-新竹,2024-04-08,2184
2402,毅嘉,6,0,6,亞東-新竹,2024-04-08,2184
2727,王品,6,0,6,亞東-新竹,2024-04-08,2184
3702,大聯大,6,0,6,亞東-新竹,2024-04-08,2184
4958,臻鼎-KY,6,0,6,亞東-新竹,2024-04-08,2184
6139,亞翔,12,6,6,亞東-新竹,2024-04-08,2184
00900,富邦特選高股息30,5,0,5,亞東-新竹,2024-04-08,2184
00940,元大台灣價值高息,111,0,111,亞東-新竹,2024-04-09,2184
2520,冠德,50,0,50,亞東-新竹,2024-04-09,2184
6005,群益證,205,155,50,亞東-新竹,2024-04-09,2184
1609,大亞,64,18,46,亞東-新竹,2024-04-09,2184
00929,復華台灣科技優息,46,3,43,亞東-新竹,2024-04-09,2184
2353,宏��,41,0,41,亞東-新竹,2024-04-09,2184
1402,遠東新,32,1,31,亞東-新竹,2024-04-09,2184
2609,陽明,30,0,30,亞東-新竹,2024-04-09,2184
3062,建漢,40,12,28,亞東-新竹,2024-04-09,2184
4958,臻鼎-KY,26,0,26,亞東-新竹,2024-04-09,2184
2354,鴻準,26,0,26,亞東-新竹,2024-04-09,2184
2406,國碩,30,7,23,亞東-新竹,2024-04-09,2184
3006,晶豪科,20,0,20,亞東-新竹,2024-04-09,2184
6116,彩晶,20,0,20,亞東-新竹,2024-04-09,2184
6190,萬泰科,20,1,19,亞東-新竹,2024-04-09,2184
00632R,元大台灣50反1,18,0,18,亞東-新竹,2024-04-09,2184
00927,群益半導體收益,17,0,17,亞東-新竹,2024-04-09,2184
2405,輔信,13,0,13,亞東-新竹,2024-04-09,2184
00679B,元大美債20年,12,0,12,亞東-新竹,2024-04-09,2184
1513,中興電,16,5,11,亞東-新竹,2024-04-09,2184
00751B,元大AAA至A公司債,11,0,11,亞東-新竹,2024-04-09,2184
6189,豐藝,11,0,11,亞東-新竹,2024-04-09,2184
00637L,元大滬深300正2,11,0,11,亞東-新竹,2024-04-09,2184
00857B,永豐20年美公債,10,0,10,亞東-新竹,2024-04-09,2184
00924,復華S＆P500成長,10,0,10,亞東-新竹,2024-04-09,2184
00680L,元大美債20正2,10,0,10,亞東-新竹,2024-04-09,2184
00933B,國泰10Y+金融債,10,0,10,亞東-新竹,2024-04-09,2184
3027,盛達,10,0,10,亞東-新竹,2024-04-09,2184
4533,協易機,10,0,10,亞東-新竹,2024-04-09,2184
2356,英業達,9,0,9,亞東-新竹,2024-04-09,2184
1314,中石化,10,1,9,亞東-新竹,2024-04-09,2184
6425,易發,11,2,9,亞東-新竹,2024-04-09,2184
8936,國統,10,1,9,亞東-新竹,2024-04-09,2184
3213,茂訊,8,0,8,亞東-新竹,2024-04-09,2184
6122,擎邦,8,0,8,亞東-新竹,2024-04-09,2184
6747,亨泰光,8,0,8,亞東-新竹,2024-04-09,2184
3147,大綜,7,0,7,亞東-新竹,2024-04-09,2184
1587,吉茂,6,0,6,亞東-新竹,2024-04-09,2184
2337,旺宏,6,0,6,亞東-新竹,2024-04-09,2184
2890,永豐金,6,0,6,亞東-新竹,2024-04-09,2184
2201,裕隆,18,12,6,亞東-新竹,2024-04-09,2184
2883,凱基金,6,0,6,亞東-新竹,2024-04-09,2184
2329,華泰,5,0,5,亞東-新竹,2024-04-09,2184
2383,台光電,5,0,5,亞東-新竹,2024-04-09,2184
0061,元大寶滬深,5,0,5,亞東-新竹,2024-04-09,2184
1459,聯發,5,0,5,亞東-新竹,2024-04-09,2184
2375,凱美,5,0,5,亞東-新竹,2024-04-09,2184
4162,智擎,5,0,5,亞東-新竹,2024-04-09,2184
4707,磐亞,5,0,5,亞東-新竹,2024-04-09,2184
4989,榮科,5,0,5,亞東-新竹,2024-04-09,2184
00937B,群益ESG投等債20,68,0,68,亞東-新竹,2024-04-10,2184
1618,合機,50,0,50,亞東-新竹,2024-04-10,2184
2885,元大金,50,0,50,亞東-新竹,2024-04-10,2184
6015,宏遠證,50,0,50,亞東-新竹,2024-04-10,2184
1459,聯發,45,0,45,亞東-新竹,2024-04-10,2184
2882,國泰金,30,0,30,亞東-新竹,2024-04-10,2184
00720B,元大投資級公司債,36,9,27,亞東-新竹,2024-04-10,2184
1785,光洋科,30,5,25,亞東-新竹,2024-04-10,2184
2888,新光金,74,50,24,亞東-新竹,2024-04-10,2184
00725B,國泰投資級公司債,20,0,20,亞東-新竹,2024-04-10,2184
2317,鴻海,23,3,20,亞東-新竹,2024-04-10,2184
2449,京元電子,18,2,16,亞東-新竹,2024-04-10,2184
2520,冠德,15,0,15,亞東-新竹,2024-04-10,2184
6016,康和證,15,0,15,亞東-新竹,2024-04-10,2184
6190,萬泰科,15,0,15,亞東-新竹,2024-04-10,2184
6747,亨泰光,15,0,15,亞東-新竹,2024-04-10,2184
00941,中信上游半導體,14,0,14,亞東-新竹,2024-04-10,2184
2409,友達,20,6,14,亞東-新竹,2024-04-10,2184
2374,佳能,23,10,13,亞東-新竹,2024-04-10,2184
6005,群益證,161,150,11,亞東-新竹,2024-04-10,2184
6189,豐藝,10,0,10,亞東-新竹,2024-04-10,2184
1795,美時,10,0,10,亞東-新竹,2024-04-10,2184
2323,中環,10,0,10,亞東-新竹,2024-04-10,2184
2883,凱基金,10,0,10,亞東-新竹,2024-04-10,2184
2883B,凱基金乙特,10,0,10,亞東-新竹,2024-04-10,2184
3060,銘異,10,0,10,亞東-新竹,2024-04-10,2184
4168,醣聯,9,0,9,亞東-新竹,2024-04-10,2184
5515,建國,8,0,8,亞東-新竹,2024-04-10,2184
6220,岳豐,8,0,8,亞東-新竹,2024-04-10,2184
3450,聯鈞,22,14,8,亞東-新竹,2024-04-10,2184
6443,元晶,11,4,7,亞東-新竹,2024-04-10,2184
1720,生達,6,0,6,亞東-新竹,2024-04-10,2184
6026,福邦證,6,0,6,亞東-新竹,2024-04-10,2184
2634,漢翔,6,1,5,亞東-新竹,2024-04-10,2184
2308,台達電,5,0,5,亞東-新竹,2024-04-10,2184
00934,中信成長高股息,5,0,5,亞東-新竹,2024-04-10,2184
00936,台新永續高息中小,5,0,5,亞東-新竹,2024-04-10,2184
00909,國泰數位支付服務,5,0,5,亞東-新竹,2024-04-10,2184
0061,元大寶滬深,5,0,5,亞東-新竹,2024-04-10,2184
1316,上曜,5,0,5,亞東-新竹,2024-04-10,2184
1605,華新,7,2,5,亞東-新竹,2024-04-10,2184
3163,波若威,5,0,5,亞東-新竹,2024-04-10,2184
3710,連展投控,5,0,5,亞東-新竹,2024-04-10,2184
6462,神盾,7,2,5,亞東-新竹,2024-04-10,2184
8086,宏捷科,5,0,5,亞東-新竹,2024-04-10,2184
8349,�矬�,5,0,5,亞東-新竹,2024-04-10,2184
4958,臻鼎-KY,6,2,4,亞東-新竹,2024-04-10,2184
3189,景碩,4,0,4,亞東-新竹,2024-04-10,2184
4147,中裕,5,1,4,亞東-新竹,2024-04-10,2184
6188,廣明,16,12,4,亞東-新竹,2024-04-10,2184
00720B,元大投資級公司債,164,25,139,亞東-新竹,2024-04-11,2184
00929,復華台灣科技優息,88,1,87,亞東-新竹,2024-04-11,2184
00680L,元大美債20正2,78,0,78,亞東-新竹,2024-04-11,2184
00673R,期元大S＆P原油反1,70,0,70,亞東-新竹,2024-04-11,2184
00937B,群益ESG投等債20,66,0,66,亞東-新竹,2024-04-11,2184
2882,國泰金,73,11,62,亞東-新竹,2024-04-11,2184
0056,元大高股息,62,22,40,亞東-新竹,2024-04-11,2184
6770,力積電,39,0,39,亞東-新竹,2024-04-11,2184
1609,大亞,108,72,36,亞東-新竹,2024-04-11,2184
00919,群益台灣精選高息,56,20,36,亞東-新竹,2024-04-11,2184
3481,群創,32,0,32,亞東-新竹,2024-04-11,2184
2832,台產,30,0,30,亞東-新竹,2024-04-11,2184
2002,中鋼,30,0,30,亞東-新竹,2024-04-11,2184
00933B,國泰10Y+金融債,27,0,27,亞東-新竹,2024-04-11,2184
2371,大同,25,0,25,亞東-新竹,2024-04-11,2184
00940,元大台灣價值高息,24,0,24,亞東-新竹,2024-04-11,2184
2363,矽統,61,38,23,亞東-新竹,2024-04-11,2184
00712,復華富時不動產,22,0,22,亞東-新竹,2024-04-11,2184
1785,光洋科,20,0,20,亞東-新竹,2024-04-11,2184
6257,矽格,20,0,20,亞東-新竹,2024-04-11,2184
2427,三商電,20,0,20,亞東-新竹,2024-04-11,2184
5213,亞昕,18,0,18,亞東-新竹,2024-04-11,2184
00687B,國泰20年美債,19,2,17,亞東-新竹,2024-04-11,2184
00941,中信上游半導體,17,0,17,亞東-新竹,2024-04-11,2184
6125,廣運,17,0,17,亞東-新竹,2024-04-11,2184
2303,聯電,22,5,17,亞東-新竹,2024-04-11,2184
2027,大成鋼,16,0,16,亞東-新竹,2024-04-11,2184
8011,台通,27,11,16,亞東-新竹,2024-04-11,2184
1453,大將,15,0,15,亞東-新竹,2024-04-11,2184
2468,華經,15,0,15,亞東-新竹,2024-04-11,2184
2912,統一超,15,0,15,亞東-新竹,2024-04-11,2184
6108,競國,15,0,15,亞東-新竹,2024-04-11,2184
9902,台火,15,1,14,亞東-新竹,2024-04-11,2184
00927,群益半導體收益,10,0,10,亞東-新竹,2024-04-11,2184
00772B,中信高評級公司債,10,0,10,亞東-新竹,2024-04-11,2184
2460,建通,10,0,10,亞東-新竹,2024-04-11,2184
2888,新光金,10,0,10,亞東-新竹,2024-04-11,2184
6747,亨泰光,10,0,10,亞東-新竹,2024-04-11,2184
2464,盟立,11,1,10,亞東-新竹,2024-04-11,2184
2610,華航,12,3,9,亞東-新竹,2024-04-11,2184
2344,華邦電,10,1,9,亞東-新竹,2024-04-11,2184
00830,國泰費城半導體,8,0,8,亞東-新竹,2024-04-11,2184
2409,友達,8,0,8,亞東-新竹,2024-04-11,2184
2881,富邦金,8,0,8,亞東-新竹,2024-04-11,2184
2915,潤泰全,7,0,7,亞東-新竹,2024-04-11,2184
006208,富邦台50,7,1,6,亞東-新竹,2024-04-11,2184
00931B,統一美債20年,6,0,6,亞東-新竹,2024-04-11,2184
2355,敬鵬,6,0,6,亞東-新竹,2024-04-11,2184
3265,台星科,6,0,6,亞東-新竹,2024-04-11,2184
3450,聯鈞,7,1,6,亞東-新竹,2024-04-11,2184
2905,三商,109,0,109,亞東-新竹,2024-04-12,2184
2882,國泰金,103,0,103,亞東-新竹,2024-04-12,2184
00929,復華台灣科技優息,54,0,54,亞東-新竹,2024-04-12,2184
2363,矽統,104,57,47,亞東-新竹,2024-04-12,2184
00933B,國泰10Y+金融債,42,0,42,亞東-新竹,2024-04-12,2184
0056,元大高股息,39,1,38,亞東-新竹,2024-04-12,2184
00878,國泰永續高股息,36,0,36,亞東-新竹,2024-04-12,2184
00720B,元大投資級公司債,23,0,23,亞東-新竹,2024-04-12,2184
00724B,群益投資級金融債,21,0,21,亞東-新竹,2024-04-12,2184
2313,華通,16,0,16,亞東-新竹,2024-04-12,2184
00751B,元大AAA至A公司債,15,0,15,亞東-新竹,2024-04-12,2184
2330,台積電,13,0,13,亞東-新竹,2024-04-12,2184
2002,中鋼,12,0,12,亞東-新竹,2024-04-12,2184
00687B,國泰20年美債,17,5,12,亞東-新竹,2024-04-12,2184
2409,友達,12,0,12,亞東-新竹,2024-04-12,2184
00680L,元大美債20正2,37,25,12,亞東-新竹,2024-04-12,2184
2382,廣達,27,16,11,亞東-新竹,2024-04-12,2184
00919,群益台灣精選高息,25,14,11,亞東-新竹,2024-04-12,2184
00637L,元大滬深300正2,10,0,10,亞東-新竹,2024-04-12,2184
2891,中信金,10,0,10,亞東-新竹,2024-04-12,2184
00772B,中信高評級公司債,10,0,10,亞東-新竹,2024-04-12,2184
00715L,期街口布蘭特正2,10,0,10,亞東-新竹,2024-04-12,2184
1720,生達,10,0,10,亞東-新竹,2024-04-12,2184
2344,華邦電,21,11,10,亞東-新竹,2024-04-12,2184
2467,志聖,10,0,10,亞東-新竹,2024-04-12,2184
2888,新光金,10,0,10,亞東-新竹,2024-04-12,2184
3176,基亞,10,0,10,亞東-新竹,2024-04-12,2184
3481,群創,10,0,10,亞東-新竹,2024-04-12,2184
4908,前鼎,10,0,10,亞東-新竹,2024-04-12,2184
6220,岳豐,10,0,10,亞東-新竹,2024-04-12,2184
2367,燿華,26,17,9,亞東-新竹,2024-04-12,2184
3321,同泰,8,0,8,亞東-新竹,2024-04-12,2184
2892,第一金,7,0,7,亞東-新竹,2024-04-12,2184
00688L,國泰20年美債正2,7,0,7,亞東-新竹,2024-04-12,2184
00753L,中信中國50正2,7,0,7,亞東-新竹,2024-04-12,2184
1402,遠東新,7,0,7,亞東-新竹,2024-04-12,2184
6198,瑞築,7,0,7,亞東-新竹,2024-04-12,2184
8463,潤泰材,7,0,7,亞東-新竹,2024-04-12,2184
2883,凱基金,9,2,7,亞東-新竹,2024-04-12,2184
00795B,中信美國公債20年,6,0,6,亞東-新竹,2024-04-12,2184
1718,中纖,6,0,6,亞東-新竹,2024-04-12,2184
2464,盟立,7,1,6,亞東-新竹,2024-04-12,2184
3083,網龍,6,0,6,亞東-新竹,2024-04-12,2184
00885,富邦越南,5,0,5,亞東-新竹,2024-04-12,2184
00937B,群益ESG投等債20,35,30,5,亞東-新竹,2024-04-12,2184
3284,太普高,5,0,5,亞東-新竹,2024-04-12,2184
3704,合勤控,5,0,5,亞東-新竹,2024-04-12,2184
3710,連展投控,5,0,5,亞東-新竹,2024-04-12,2184
4129,聯合,5,0,5,亞東-新竹,2024-04-12,2184
6219,富旺,5,0,5,亞東-新竹,2024-04-12,2184
2867,三商壽,130,7,123,亞東-新竹,2024-04-15,2184
00940,元大台灣價值高息,66,0,66,亞東-新竹,2024-04-15,2184
0056,元大高股息,76,12,64,亞東-新竹,2024-04-15,2184
00675L,富邦臺灣加權正2,62,0,62,亞東-新竹,2024-04-15,2184
00929,復華台灣科技優息,66,12,54,亞東-新竹,2024-04-15,2184
2890,永豐金,50,0,50,亞東-新竹,2024-04-15,2184
2353,宏��,42,3,39,亞東-新竹,2024-04-15,2184
3712,永崴投控,36,2,34,亞東-新竹,2024-04-15,2184
6257,矽格,35,2,33,亞東-新竹,2024-04-15,2184
2303,聯電,38,9,29,亞東-新竹,2024-04-15,2184
00919,群益台灣精選高息,41,15,26,亞東-新竹,2024-04-15,2184
1453,大將,32,7,25,亞東-新竹,2024-04-15,2184
4739,康普,25,0,25,亞東-新竹,2024-04-15,2184
2409,友達,30,8,22,亞東-新竹,2024-04-15,2184
6005,群益證,161,139,22,亞東-新竹,2024-04-15,2184
2317,鴻海,29,9,20,亞東-新竹,2024-04-15,2184
00857B,永豐20年美公債,20,0,20,亞東-新竹,2024-04-15,2184
00724B,群益投資級金融債,20,0,20,亞東-新竹,2024-04-15,2184
2109,華豐,20,0,20,亞東-新竹,2024-04-15,2184
2606,裕民,20,0,20,亞東-新竹,2024-04-15,2184
2449,京元電子,19,0,19,亞東-新竹,2024-04-15,2184
6139,亞翔,18,1,17,亞東-新竹,2024-04-15,2184
3234,光環,15,0,15,亞東-新竹,2024-04-15,2184
6190,萬泰科,15,0,15,亞東-新竹,2024-04-15,2184
2330,台積電,17,4,13,亞東-新竹,2024-04-15,2184
6603,富強鑫,13,0,13,亞東-新竹,2024-04-15,2184
1608,華榮,13,0,13,亞東-新竹,2024-04-15,2184
00772B,中信高評級公司債,12,0,12,亞東-新竹,2024-04-15,2184
00687B,國泰20年美債,17,5,12,亞東-新竹,2024-04-15,2184
1504,東元,15,4,11,亞東-新竹,2024-04-15,2184
2374,佳能,11,0,11,亞東-新竹,2024-04-15,2184
020034,元大IC設計N,10,0,10,亞東-新竹,2024-04-15,2184
00673R,期元大S＆P原油反1,10,0,10,亞東-新竹,2024-04-15,2184
00830,國泰費城半導體,10,0,10,亞東-新竹,2024-04-15,2184
1603,華電,10,0,10,亞東-新竹,2024-04-15,2184
1605,華新,29,19,10,亞東-新竹,2024-04-15,2184
1808,潤隆,14,4,10,亞東-新竹,2024-04-15,2184
1909,榮成,10,0,10,亞東-新竹,2024-04-15,2184
2323,中環,10,0,10,亞東-新竹,2024-04-15,2184
2882,國泰金,10,0,10,亞東-新竹,2024-04-15,2184
2888,新光金,10,0,10,亞東-新竹,2024-04-15,2184
3710,連展投控,10,0,10,亞東-新竹,2024-04-15,2184
8064,東捷,10,0,10,亞東-新竹,2024-04-15,2184
00751B,元大AAA至A公司債,9,0,9,亞東-新竹,2024-04-15,2184
00935,野村臺灣新科技50,9,0,9,亞東-新竹,2024-04-15,2184
1515,力山,9,0,9,亞東-新竹,2024-04-15,2184
2442,新美齊,9,0,9,亞東-新竹,2024-04-15,2184
6143,振曜,9,0,9,亞東-新竹,2024-04-15,2184
5871,中租-KY,8,0,8,亞東-新竹,2024-04-15,2184
00927,群益半導體收益,10,2,8,亞東-新竹,2024-04-15,2184
00929,復華台灣科技優息,332,13,319,亞東-新竹,2024-04-16,2184
2883,凱基金,219,0,219,亞東-新竹,2024-04-16,2184
00919,群益台灣精選高息,172,0,172,亞東-新竹,2024-04-16,2184
00940,元大台灣價值高息,207,42,165,亞東-新竹,2024-04-16,2184
00720B,元大投資級公司債,75,0,75,亞東-新竹,2024-04-16,2184
0056,元大高股息,81,20,61,亞東-新竹,2024-04-16,2184
1810,和成,58,0,58,亞東-新竹,2024-04-16,2184
2891,中信金,56,0,56,亞東-新竹,2024-04-16,2184
00751B,元大AAA至A公司債,54,0,54,亞東-新竹,2024-04-16,2184
2603,長榮,73,24,49,亞東-新竹,2024-04-16,2184
9802,鈺齊-KY,45,0,45,亞東-新竹,2024-04-16,2184
2834,臺企銀,58,15,43,亞東-新竹,2024-04-16,2184
1402,遠東新,41,0,41,亞東-新竹,2024-04-16,2184
00878,國泰永續高股息,58,21,37,亞東-新竹,2024-04-16,2184
2881,富邦金,36,0,36,亞東-新竹,2024-04-16,2184
2888,新光金,31,0,31,亞東-新竹,2024-04-16,2184
2609,陽明,31,0,31,亞東-新竹,2024-04-16,2184
00939,統一台灣高息動能,26,0,26,亞東-新竹,2024-04-16,2184
00941,中信上游半導體,25,0,25,亞東-新竹,2024-04-16,2184
2303,聯電,31,6,25,亞東-新竹,2024-04-16,2184
2301,光寶科,24,0,24,亞東-新竹,2024-04-16,2184
1304,台聚,24,1,23,亞東-新竹,2024-04-16,2184
00927,群益半導體收益,22,0,22,亞東-新竹,2024-04-16,2184
00933B,國泰10Y+金融債,20,0,20,亞東-新竹,2024-04-16,2184
2033,佳大,20,0,20,亞東-新竹,2024-04-16,2184
3062,建漢,20,0,20,亞東-新竹,2024-04-16,2184
5531,鄉林,20,0,20,亞東-新竹,2024-04-16,2184
6143,振曜,18,0,18,亞東-新竹,2024-04-16,2184
2317,鴻海,29,13,16,亞東-新竹,2024-04-16,2184
2630,亞航,28,13,15,亞東-新竹,2024-04-16,2184
2618,長榮航,25,11,14,亞東-新竹,2024-04-16,2184
0050,元大台灣50,14,1,13,亞東-新竹,2024-04-16,2184
2344,華邦電,13,0,13,亞東-新竹,2024-04-16,2184
3006,晶豪科,13,0,13,亞東-新竹,2024-04-16,2184
00915,凱基優選高股息30,12,0,12,亞東-新竹,2024-04-16,2184
3260,威剛,13,1,12,亞東-新竹,2024-04-16,2184
8222,寶一,13,1,12,亞東-新竹,2024-04-16,2184
1301,台塑,11,0,11,亞東-新竹,2024-04-16,2184
1617,榮星,11,0,11,亞東-新竹,2024-04-16,2184
2338,光罩,11,0,11,亞東-新竹,2024-04-16,2184
3231,緯創,14,4,10,亞東-新竹,2024-04-16,2184
00830,國泰費城半導體,10,0,10,亞東-新竹,2024-04-16,2184
00724B,群益投資級金融債,10,0,10,亞東-新竹,2024-04-16,2184
00665L,富邦�琤肭磪囓�2,10,0,10,亞東-新竹,2024-04-16,2184
1529,樂事綠能,10,0,10,亞東-新竹,2024-04-16,2184
1710,東聯,10,0,10,亞東-新竹,2024-04-16,2184
4908,前鼎,10,0,10,亞東-新竹,2024-04-16,2184
6015,宏遠證,10,0,10,亞東-新竹,2024-04-16,2184
8011,台通,10,0,10,亞東-新竹,2024-04-16,2184
8064,東捷,10,0,10,亞東-新竹,2024-04-16,2184
00680L,元大美債20正2,398,0,398,亞東-新竹,2024-04-17,2184
00937B,群益ESG投等債20,221,9,212,亞東-新竹,2024-04-17,2184
00720B,元大投資級公司債,79,6,73,亞東-新竹,2024-04-17,2184
00929,復華台灣科技優息,65,0,65,亞東-新竹,2024-04-17,2184
00751B,元大AAA至A公司債,54,0,54,亞東-新竹,2024-04-17,2184
1101,台泥,31,0,31,亞東-新竹,2024-04-17,2184
00857B,永豐20年美公債,30,0,30,亞東-新竹,2024-04-17,2184
8011,台通,30,0,30,亞東-新竹,2024-04-17,2184
0056,元大高股息,61,35,26,亞東-新竹,2024-04-17,2184
00681R,元大美債20反1,25,0,25,亞東-新竹,2024-04-17,2184
00878,國泰永續高股息,20,0,20,亞東-新竹,2024-04-17,2184
2460,建通,20,0,20,亞東-新竹,2024-04-17,2184
00927,群益半導體收益,20,2,18,亞東-新竹,2024-04-17,2184
2543,皇昌,15,0,15,亞東-新竹,2024-04-17,2184
00885,富邦越南,14,0,14,亞東-新竹,2024-04-17,2184
2367,燿華,15,1,14,亞東-新竹,2024-04-17,2184
6197,佳必琪,14,0,14,亞東-新竹,2024-04-17,2184
2409,友達,13,0,13,亞東-新竹,2024-04-17,2184
00933B,國泰10Y+金融債,12,0,12,亞東-新竹,2024-04-17,2184
1402,遠東新,12,0,12,亞東-新竹,2024-04-17,2184
00637L,元大滬深300正2,13,2,11,亞東-新竹,2024-04-17,2184
00795B,中信美國公債20年,11,0,11,亞東-新竹,2024-04-17,2184
1514,亞力,12,1,11,亞東-新竹,2024-04-17,2184
2101,南港,11,0,11,亞東-新竹,2024-04-17,2184
2883,凱基金,10,0,10,亞東-新竹,2024-04-17,2184
00940,元大台灣價值高息,20,10,10,亞東-新竹,2024-04-17,2184
00632R,元大台灣50反1,10,0,10,亞東-新竹,2024-04-17,2184
2009,第一銅,10,0,10,亞東-新竹,2024-04-17,2184
2634,漢翔,10,0,10,亞東-新竹,2024-04-17,2184
00687B,國泰20年美債,8,0,8,亞東-新竹,2024-04-17,2184
3231,緯創,28,20,8,亞東-新竹,2024-04-17,2184
2412,中華電,7,0,7,亞東-新竹,2024-04-17,2184
8440,綠電,7,0,7,亞東-新竹,2024-04-17,2184
00753L,中信中國50正2,6,0,6,亞東-新竹,2024-04-17,2184
00905,FT臺灣Smart,6,0,6,亞東-新竹,2024-04-17,2184
3005,神基,7,1,6,亞東-新竹,2024-04-17,2184
9955,佳龍,6,0,6,亞東-新竹,2024-04-17,2184
00939,統一台灣高息動能,5,0,5,亞東-新竹,2024-04-17,2184
00679B,元大美債20年,12,7,5,亞東-新竹,2024-04-17,2184
2388,威盛,7,2,5,亞東-新竹,2024-04-17,2184
2889,國票金,5,0,5,亞東-新竹,2024-04-17,2184
3027,盛達,5,0,5,亞東-新竹,2024-04-17,2184
3294,英濟,5,0,5,亞東-新竹,2024-04-17,2184
3339,泰谷,5,0,5,亞東-新竹,2024-04-17,2184
3363,上詮,5,0,5,亞東-新竹,2024-04-17,2184
3481,群創,5,0,5,亞東-新竹,2024-04-17,2184
3522,御嵿,5,0,5,亞東-新竹,2024-04-17,2184
6243,迅杰,5,0,5,亞東-新竹,2024-04-17,2184
2353,宏��,4,0,4,亞東-新竹,2024-04-17,2184
2354,鴻準,8,4,4,亞東-新竹,2024-04-17,2184
4960,誠美材,65,0,65,亞東-新竹,2024-04-18,2184
00940,元大台灣價值高息,49,0,49,亞東-新竹,2024-04-18,2184
5512,力麒,51,6,45,亞東-新竹,2024-04-18,2184
2812,台中銀,45,0,45,亞東-新竹,2024-04-18,2184
1810,和成,55,20,35,亞東-新竹,2024-04-18,2184
00937B,群益ESG投等債20,36,2,34,亞東-新竹,2024-04-18,2184
00632R,元大台灣50反1,33,0,33,亞東-新竹,2024-04-18,2184
1504,東元,37,11,26,亞東-新竹,2024-04-18,2184
6219,富旺,25,0,25,亞東-新竹,2024-04-18,2184
4107,邦特,20,0,20,亞東-新竹,2024-04-18,2184
6120,達運,20,0,20,亞東-新竹,2024-04-18,2184
0056,元大高股息,19,0,19,亞東-新竹,2024-04-18,2184
1785,光洋科,19,0,19,亞東-新竹,2024-04-18,2184
00929,復華台灣科技優息,37,20,17,亞東-新竹,2024-04-18,2184
2406,國碩,16,0,16,亞東-新竹,2024-04-18,2184
2460,建通,15,0,15,亞東-新竹,2024-04-18,2184
2371,大同,28,14,14,亞東-新竹,2024-04-18,2184
2367,燿華,13,0,13,亞東-新竹,2024-04-18,2184
2329,華泰,21,9,12,亞東-新竹,2024-04-18,2184
2027,大成鋼,12,0,12,亞東-新竹,2024-04-18,2184
00712,復華富時不動產,12,0,12,亞東-新竹,2024-04-18,2184
8027,鈦昇,11,0,11,亞東-新竹,2024-04-18,2184
00642U,期元大S＆P石油,10,0,10,亞東-新竹,2024-04-18,2184
00927,群益半導體收益,10,0,10,亞東-新竹,2024-04-18,2184
00715L,期街口布蘭特正2,10,0,10,亞東-新竹,2024-04-18,2184
1615,大山,10,0,10,亞東-新竹,2024-04-18,2184
2832,台產,10,0,10,亞東-新竹,2024-04-18,2184
6215,和椿,10,0,10,亞東-新竹,2024-04-18,2184
3481,群創,10,1,9,亞東-新竹,2024-04-18,2184
8255,朋程,8,0,8,亞東-新竹,2024-04-18,2184
6770,力積電,37,29,8,亞東-新竹,2024-04-18,2184
00941,中信上游半導體,8,0,8,亞東-新竹,2024-04-18,2184
00680L,元大美債20正2,12,4,8,亞東-新竹,2024-04-18,2184
1402,遠東新,8,0,8,亞東-新竹,2024-04-18,2184
3712,永崴投控,10,2,8,亞東-新竹,2024-04-18,2184
2344,華邦電,18,11,7,亞東-新竹,2024-04-18,2184
8054,安國,13,6,7,亞東-新竹,2024-04-18,2184
2330,台積電,11,5,6,亞東-新竹,2024-04-18,2184
6125,廣運,15,9,6,亞東-新竹,2024-04-18,2184
00720B,元大投資級公司債,6,0,6,亞東-新竹,2024-04-18,2184
1611,中電,6,0,6,亞東-新竹,2024-04-18,2184
2388,威盛,6,0,6,亞東-新竹,2024-04-18,2184
2603,長榮,6,0,6,亞東-新竹,2024-04-18,2184
00830,國泰費城半導體,5,0,5,亞東-新竹,2024-04-18,2184
00676R,富邦臺灣加權反1,5,0,5,亞東-新竹,2024-04-18,2184
2303,聯電,5,0,5,亞東-新竹,2024-04-18,2184
2314,台揚,5,0,5,亞東-新竹,2024-04-18,2184
2316,楠梓電,5,0,5,亞東-新竹,2024-04-18,2184
3176,基亞,5,0,5,亞東-新竹,2024-04-18,2184
4147,中裕,7,2,5,亞東-新竹,2024-04-18,2184
2883,凱基金,1067,30,1037,亞東-新竹,2024-04-19,2184
00929,復華台灣科技優息,265,6,259,亞東-新竹,2024-04-19,2184
1402,遠東新,139,1,138,亞東-新竹,2024-04-19,2184
00940,元大台灣價值高息,135,39,96,亞東-新竹,2024-04-19,2184
1504,東元,92,5,87,亞東-新竹,2024-04-19,2184
2891,中信金,75,8,67,亞東-新竹,2024-04-19,2184
00687B,國泰20年美債,58,0,58,亞東-新竹,2024-04-19,2184
00919,群益台灣精選高息,68,15,53,亞東-新竹,2024-04-19,2184
2882,國泰金,52,7,45,亞東-新竹,2024-04-19,2184
2409,友達,40,0,40,亞東-新竹,2024-04-19,2184
4739,康普,34,0,34,亞東-新竹,2024-04-19,2184
0056,元大高股息,46,16,30,亞東-新竹,2024-04-19,2184
2303,聯電,26,0,26,亞東-新竹,2024-04-19,2184
2330,台積電,37,12,25,亞東-新竹,2024-04-19,2184
2101,南港,31,6,25,亞東-新竹,2024-04-19,2184
00878,國泰永續高股息,22,0,22,亞東-新竹,2024-04-19,2184
2888,新光金,22,0,22,亞東-新竹,2024-04-19,2184
00706L,期元大S＆P日圓正2,21,0,21,亞東-新竹,2024-04-19,2184
1603,華電,33,12,21,亞東-新竹,2024-04-19,2184
2363,矽統,28,7,21,亞東-新竹,2024-04-19,2184
2637,慧洋-KY,23,3,20,亞東-新竹,2024-04-19,2184
00631L,元大台灣50正2,19,0,19,亞東-新竹,2024-04-19,2184
5512,力麒,22,5,17,亞東-新竹,2024-04-19,2184
00712,復華富時不動產,17,0,17,亞東-新竹,2024-04-19,2184
5876,上海商銀,17,0,17,亞東-新竹,2024-04-19,2184
006208,富邦台50,18,1,17,亞東-新竹,2024-04-19,2184
00891,中信關鍵半導體,16,0,16,亞東-新竹,2024-04-19,2184
2412,中華電,16,0,16,亞東-新竹,2024-04-19,2184
00900,富邦特選高股息30,15,0,15,亞東-新竹,2024-04-19,2184
2338,光罩,16,1,15,亞東-新竹,2024-04-19,2184
2460,建通,15,1,14,亞東-新竹,2024-04-19,2184
2633,台灣高鐵,14,0,14,亞東-新竹,2024-04-19,2184
00650L,復華香港正2,13,0,13,亞東-新竹,2024-04-19,2184
1409,新纖,13,0,13,亞東-新竹,2024-04-19,2184
0050,元大台灣50,21,8,13,亞東-新竹,2024-04-19,2184
00915,凱基優選高股息30,12,0,12,亞東-新竹,2024-04-19,2184
2371,大同,52,40,12,亞東-新竹,2024-04-19,2184
2468,華經,12,0,12,亞東-新竹,2024-04-19,2184
3512,皇龍,12,0,12,亞東-新竹,2024-04-19,2184
2634,漢翔,17,6,11,亞東-新竹,2024-04-19,2184
00637L,元大滬深300正2,10,0,10,亞東-新竹,2024-04-19,2184
1709,和益,12,2,10,亞東-新竹,2024-04-19,2184
1584,精剛,40,30,10,亞東-新竹,2024-04-19,2184
2023,燁輝,10,0,10,亞東-新竹,2024-04-19,2184
3522,御嵿,20,10,10,亞東-新竹,2024-04-19,2184
4916,事欣科,10,0,10,亞東-新竹,2024-04-19,2184
5426,振發,10,0,10,亞東-新竹,2024-04-19,2184
6216,居易,10,0,10,亞東-新竹,2024-04-19,2184
6668,中揚光,10,0,10,亞東-新竹,2024-04-19,2184
5347,世界,10,1,9,亞東-新竹,2024-04-19,2184
00940,元大台灣價值高息,558,155,403,亞東-新竹,2024-04-22,2184
00919,群益台灣精選高息,120,8,112,亞東-新竹,2024-04-22,2184
2534,宏盛,100,0,100,亞東-新竹,2024-04-22,2184
4960,誠美材,65,0,65,亞東-新竹,2024-04-22,2184
00679B,元大美債20年,68,7,61,亞東-新竹,2024-04-22,2184
0056,元大高股息,46,3,43,亞東-新竹,2024-04-22,2184
1609,大亞,98,56,42,亞東-新竹,2024-04-22,2184
00929,復華台灣科技優息,103,63,40,亞東-新竹,2024-04-22,2184
1442,名軒,40,0,40,亞東-新竹,2024-04-22,2184
2611,志信,40,0,40,亞東-新竹,2024-04-22,2184
6125,廣運,36,2,34,亞東-新竹,2024-04-22,2184
00942B,台新美A公司債20+,30,0,30,亞東-新竹,2024-04-22,2184
6005,群益證,180,153,27,亞東-新竹,2024-04-22,2184
00687B,國泰20年美債,26,0,26,亞東-新竹,2024-04-22,2184
8422,可寧衛,25,0,25,亞東-新竹,2024-04-22,2184
2520,冠德,25,2,23,亞東-新竹,2024-04-22,2184
2515,中工,26,4,22,亞東-新竹,2024-04-22,2184
1785,光洋科,20,0,20,亞東-新竹,2024-04-22,2184
2303,聯電,41,22,19,亞東-新竹,2024-04-22,2184
8222,寶一,18,0,18,亞東-新竹,2024-04-22,2184
2363,矽統,21,7,14,亞東-新竹,2024-04-22,2184
00937B,群益ESG投等債20,13,0,13,亞東-新竹,2024-04-22,2184
00939,統一台灣高息動能,13,0,13,亞東-新竹,2024-04-22,2184
00720B,元大投資級公司債,13,0,13,亞東-新竹,2024-04-22,2184
2409,友達,13,0,13,亞東-新竹,2024-04-22,2184
00891,中信關鍵半導體,11,0,11,亞東-新竹,2024-04-22,2184
00751B,元大AAA至A公司債,11,0,11,亞東-新竹,2024-04-22,2184
1617,榮星,31,20,11,亞東-新竹,2024-04-22,2184
3703,欣陸,12,1,11,亞東-新竹,2024-04-22,2184
6143,振曜,11,0,11,亞東-新竹,2024-04-22,2184
3231,緯創,17,7,10,亞東-新竹,2024-04-22,2184
6288,聯嘉,10,0,10,亞東-新竹,2024-04-22,2184
1515,力山,10,0,10,亞東-新竹,2024-04-22,2184
1530,亞崴,10,0,10,亞東-新竹,2024-04-22,2184
4157,太景*-KY,15,5,10,亞東-新竹,2024-04-22,2184
0050,元大台灣50,10,0,10,亞東-新竹,2024-04-22,2184
00941,中信上游半導體,9,0,9,亞東-新竹,2024-04-22,2184
5251,天鉞電,8,0,8,亞東-新竹,2024-04-22,2184
2603,長榮,28,20,8,亞東-新竹,2024-04-22,2184
2886,兆豐金,10,2,8,亞東-新竹,2024-04-22,2184
2033,佳大,7,0,7,亞東-新竹,2024-04-22,2184
2356,英業達,10,4,6,亞東-新竹,2024-04-22,2184
2609,陽明,8,2,6,亞東-新竹,2024-04-22,2184
2344,華邦電,10,4,6,亞東-新竹,2024-04-22,2184
2506,太設,6,0,6,亞東-新竹,2024-04-22,2184
5230,雷笛克光學,6,0,6,亞東-新竹,2024-04-22,2184
2345,智邦,5,0,5,亞東-新竹,2024-04-22,2184
00857B,永豐20年美公債,5,0,5,亞東-新竹,2024-04-22,2184
1524,耿鼎,5,0,5,亞東-新竹,2024-04-22,2184
1612,宏泰,5,0,5,亞東-新竹,2024-04-22,2184
2834,臺企銀,227,46,181,亞東-新竹,2024-04-23,2184
00929,復華台灣科技優息,124,1,123,亞東-新竹,2024-04-23,2184
4938,和碩,80,0,80,亞東-新竹,2024-04-23,2184
1216,統一,76,0,76,亞東-新竹,2024-04-23,2184
00878,國泰永續高股息,54,1,53,亞東-新竹,2024-04-23,2184
2890,永豐金,50,0,50,亞東-新竹,2024-04-23,2184
00940,元大台灣價值高息,42,1,41,亞東-新竹,2024-04-23,2184
2618,長榮航,62,22,40,亞東-新竹,2024-04-23,2184
2303,聯電,44,8,36,亞東-新竹,2024-04-23,2184
00687B,國泰20年美債,33,0,33,亞東-新竹,2024-04-23,2184
1215,卜蜂,30,0,30,亞東-新竹,2024-04-23,2184
00919,群益台灣精選高息,23,0,23,亞東-新竹,2024-04-23,2184
2603,長榮,26,4,22,亞東-新竹,2024-04-23,2184
2371,大同,37,19,18,亞東-新竹,2024-04-23,2184
0056,元大高股息,18,2,16,亞東-新竹,2024-04-23,2184
4157,太景*-KY,25,10,15,亞東-新竹,2024-04-23,2184
2201,裕隆,24,12,12,亞東-新竹,2024-04-23,2184
1316,上曜,10,0,10,亞東-新竹,2024-04-23,2184
2547,日勝生,10,0,10,亞東-新竹,2024-04-23,2184
5381,合正,9,0,9,亞東-新竹,2024-04-23,2184
9914,美利達,9,0,9,亞東-新竹,2024-04-23,2184
3522,御嵿,8,0,8,亞東-新竹,2024-04-23,2184
4127,天良,8,0,8,亞東-新竹,2024-04-23,2184
2427,三商電,8,1,7,亞東-新竹,2024-04-23,2184
2301,光寶科,6,0,6,亞東-新竹,2024-04-23,2184
00933B,國泰10Y+金融債,6,0,6,亞東-新竹,2024-04-23,2184
00877,復華中國5G,6,0,6,亞東-新竹,2024-04-23,2184
3035,智原,6,0,6,亞東-新竹,2024-04-23,2184
3481,群創,15,9,6,亞東-新竹,2024-04-23,2184
3666,光耀,6,0,6,亞東-新竹,2024-04-23,2184
5880,合庫金,8,2,6,亞東-新竹,2024-04-23,2184
2314,台揚,5,0,5,亞東-新竹,2024-04-23,2184
2408,南亞科,5,0,5,亞東-新竹,2024-04-23,2184
2748,雲品,5,0,5,亞東-新竹,2024-04-23,2184
2881,富邦金,5,0,5,亞東-新竹,2024-04-23,2184
8222,寶一,6,1,5,亞東-新竹,2024-04-23,2184
2454,聯發科,5,1,4,亞東-新竹,2024-04-23,2184
00680L,元大美債20正2,4,0,4,亞東-新竹,2024-04-23,2184
3596,智易,4,0,4,亞東-新竹,2024-04-23,2184
5347,世界,4,0,4,亞東-新竹,2024-04-23,2184
6207,雷科,4,0,4,亞東-新竹,2024-04-23,2184
6526,達發,5,1,4,亞東-新竹,2024-04-23,2184
2317,鴻海,18,15,3,亞東-新竹,2024-04-23,2184
00679B,元大美債20年,3,0,3,亞東-新竹,2024-04-23,2184
00724B,群益投資級金融債,3,0,3,亞東-新竹,2024-04-23,2184
00900,富邦特選高股息30,3,0,3,亞東-新竹,2024-04-23,2184
2206,三陽工業,5,2,3,亞東-新竹,2024-04-23,2184
2489,瑞軒,10,7,3,亞東-新竹,2024-04-23,2184
6683,雍智科技,3,0,3,亞東-新竹,2024-04-23,2184
8926,台汽電,3,0,3,亞東-新竹,2024-04-23,2184
2883,凱基金,290,16,274,亞東-新竹,2024-04-24,2184
00632R,元大台灣50反1,250,25,225,亞東-新竹,2024-04-24,2184
2408,南亞科,35,1,34,亞東-新竹,2024-04-24,2184
0056,元大高股息,42,9,33,亞東-新竹,2024-04-24,2184
2329,華泰,31,1,30,亞東-新竹,2024-04-24,2184
2427,三商電,34,5,29,亞東-新竹,2024-04-24,2184
2464,盟立,27,4,23,亞東-新竹,2024-04-24,2184
2374,佳能,33,12,21,亞東-新竹,2024-04-24,2184
2891,中信金,20,1,19,亞東-新竹,2024-04-24,2184
3522,御嵿,18,0,18,亞東-新竹,2024-04-24,2184
5371,中光電,24,6,18,亞東-新竹,2024-04-24,2184
2347,聯強,17,0,17,亞東-新竹,2024-04-24,2184
3027,盛達,15,0,15,亞東-新竹,2024-04-24,2184
1605,華新,14,0,14,亞東-新竹,2024-04-24,2184
2543,皇昌,15,2,13,亞東-新竹,2024-04-24,2184
5880,合庫金,12,0,12,亞東-新竹,2024-04-24,2184
00665L,富邦�琤肭磪囓�2,10,0,10,亞東-新竹,2024-04-24,2184
2367,燿華,10,0,10,亞東-新竹,2024-04-24,2184
3141,晶宏,10,0,10,亞東-新竹,2024-04-24,2184
9105,泰金寶-DR,10,0,10,亞東-新竹,2024-04-24,2184
9945,潤泰新,10,0,10,亞東-新竹,2024-04-24,2184
2206,三陽工業,17,9,8,亞東-新竹,2024-04-24,2184
3321,同泰,8,0,8,亞東-新竹,2024-04-24,2184
00687B,國泰20年美債,10,2,8,亞東-新竹,2024-04-24,2184
2881,富邦金,8,0,8,亞東-新竹,2024-04-24,2184
6668,中揚光,10,2,8,亞東-新竹,2024-04-24,2184
3576,聯合再生,12,5,7,亞東-新竹,2024-04-24,2184
4303,信立,7,0,7,亞東-新竹,2024-04-24,2184
1514,亞力,6,0,6,亞東-新竹,2024-04-24,2184
2515,中工,13,7,6,亞東-新竹,2024-04-24,2184
00795B,中信美國公債20年,5,0,5,亞東-新竹,2024-04-24,2184
00941,中信上游半導體,5,0,5,亞東-新竹,2024-04-24,2184
2101,南港,8,3,5,亞東-新竹,2024-04-24,2184
3025,星通,5,0,5,亞東-新竹,2024-04-24,2184
3227,原相,7,2,5,亞東-新竹,2024-04-24,2184
6220,岳豐,5,0,5,亞東-新竹,2024-04-24,2184
00940,元大台灣價值高息,7,3,4,亞東-新竹,2024-04-24,2184
1618,合機,5,1,4,亞東-新竹,2024-04-24,2184
2201,裕隆,17,13,4,亞東-新竹,2024-04-24,2184
4545,銘鈺,4,0,4,亞東-新竹,2024-04-24,2184
8054,安國,12,8,4,亞東-新竹,2024-04-24,2184
3450,聯鈞,3,0,3,亞東-新竹,2024-04-24,2184
00722B,群益投資級電信債,3,0,3,亞東-新竹,2024-04-24,2184
00939,統一台灣高息動能,3,0,3,亞東-新竹,2024-04-24,2184
1569,濱川,3,0,3,亞東-新竹,2024-04-24,2184
1784,訊聯,3,0,3,亞東-新竹,2024-04-24,2184
2412,中華電,3,0,3,亞東-新竹,2024-04-24,2184
2442,新美齊,3,0,3,亞東-新竹,2024-04-24,2184
2485,兆赫,3,0,3,亞東-新竹,2024-04-24,2184
3013,晟銘電,11,8,3,亞東-新竹,2024-04-24,2184
4938,和碩,89,0,89,亞東-新竹,2024-04-25,2184
2883,凱基金,70,0,70,亞東-新竹,2024-04-25,2184
00679B,元大美債20年,53,0,53,亞東-新竹,2024-04-25,2184
3024,憶聲,60,7,53,亞東-新竹,2024-04-25,2184
00929,復華台灣科技優息,35,0,35,亞東-新竹,2024-04-25,2184
00632R,元大台灣50反1,30,8,22,亞東-新竹,2024-04-25,2184
2611,志信,20,0,20,亞東-新竹,2024-04-25,2184
5880,合庫金,20,0,20,亞東-新竹,2024-04-25,2184
00937B,群益ESG投等債20,19,0,19,亞東-新竹,2024-04-25,2184
2534,宏盛,20,1,19,亞東-新竹,2024-04-25,2184
4207,環泰,16,0,16,亞東-新竹,2024-04-25,2184
6188,廣明,15,1,14,亞東-新竹,2024-04-25,2184
6770,力積電,15,1,14,亞東-新竹,2024-04-25,2184
00772B,中信高評級公司債,13,0,13,亞東-新竹,2024-04-25,2184
00940,元大台灣價值高息,14,2,12,亞東-新竹,2024-04-25,2184
2330,台積電,15,3,12,亞東-新竹,2024-04-25,2184
1301,台塑,11,0,11,亞東-新竹,2024-04-25,2184
00919,群益台灣精選高息,11,0,11,亞東-新竹,2024-04-25,2184
00706L,期元大S＆P日圓正2,10,0,10,亞東-新竹,2024-04-25,2184
1524,耿鼎,10,0,10,亞東-新竹,2024-04-25,2184
6271,同欣電,10,0,10,亞東-新竹,2024-04-25,2184
00670L,富邦NASDAQ正2,9,0,9,亞東-新竹,2024-04-25,2184
2885,元大金,9,0,9,亞東-新竹,2024-04-25,2184
2603,長榮,34,25,9,亞東-新竹,2024-04-25,2184
00687B,國泰20年美債,9,1,8,亞東-新竹,2024-04-25,2184
1808,潤隆,12,4,8,亞東-新竹,2024-04-25,2184
2316,楠梓電,16,8,8,亞東-新竹,2024-04-25,2184
6197,佳必琪,10,2,8,亞東-新竹,2024-04-25,2184
3006,晶豪科,14,6,8,亞東-新竹,2024-04-25,2184
00878,國泰永續高股息,9,1,8,亞東-新竹,2024-04-25,2184
3163,波若威,9,2,7,亞東-新竹,2024-04-25,2184
3653,健策,7,0,7,亞東-新竹,2024-04-25,2184
00941,中信上游半導體,8,2,6,亞東-新竹,2024-04-25,2184
2303,聯電,20,14,6,亞東-新竹,2024-04-25,2184
2367,燿華,6,0,6,亞東-新竹,2024-04-25,2184
2727,王品,6,0,6,亞東-新竹,2024-04-25,2184
0056,元大高股息,5,0,5,亞東-新竹,2024-04-25,2184
3708,上緯投控,8,3,5,亞東-新竹,2024-04-25,2184
6125,廣運,20,15,5,亞東-新竹,2024-04-25,2184
1314,中石化,5,0,5,亞東-新竹,2024-04-25,2184
00857B,永豐20年美公債,5,0,5,亞東-新竹,2024-04-25,2184
00720B,元大投資級公司債,5,0,5,亞東-新竹,2024-04-25,2184
00631L,元大台灣50正2,5,0,5,亞東-新竹,2024-04-25,2184
2547,日勝生,5,0,5,亞東-新竹,2024-04-25,2184
2912,統一超,5,0,5,亞東-新竹,2024-04-25,2184
3521,鴻翊,5,0,5,亞東-新竹,2024-04-25,2184
6485,點序,5,0,5,亞東-新竹,2024-04-25,2184
0050,元大台灣50,4,0,4,亞東-新竹,2024-04-25,2184
00891,中信關鍵半導體,4,0,4,亞東-新竹,2024-04-25,2184
00923,群益台ESG低碳50,4,0,4,亞東-新竹,2024-04-25,2184
2610,華航,137,35,102,亞東-新竹,2024-04-26,2184
00720B,元大投資級公司債,56,0,56,亞東-新竹,2024-04-26,2184
00751B,元大AAA至A公司債,54,0,54,亞東-新竹,2024-04-26,2184
2883,凱基金,51,0,51,亞東-新竹,2024-04-26,2184
5512,力麒,50,0,50,亞東-新竹,2024-04-26,2184
00632R,元大台灣50反1,45,0,45,亞東-新竹,2024-04-26,2184
2363,矽統,40,0,40,亞東-新竹,2024-04-26,2184
00882,中信中國高股息,30,0,30,亞東-新竹,2024-04-26,2184
5234,達興材料,26,0,26,亞東-新竹,2024-04-26,2184
2329,華泰,30,5,25,亞東-新竹,2024-04-26,2184
4960,誠美材,30,7,23,亞東-新竹,2024-04-26,2184
3645,達邁,17,0,17,亞東-新竹,2024-04-26,2184
1453,大將,15,0,15,亞東-新竹,2024-04-26,2184
00937B,群益ESG投等債20,15,0,15,亞東-新竹,2024-04-26,2184
8024,佑華,15,0,15,亞東-新竹,2024-04-26,2184
9945,潤泰新,15,2,13,亞東-新竹,2024-04-26,2184
00772B,中信高評級公司債,11,0,11,亞東-新竹,2024-04-26,2184
6806,森崴能源,10,0,10,亞東-新竹,2024-04-26,2184
2241,艾姆勒,14,4,10,亞東-新竹,2024-04-26,2184
2344,華邦電,23,13,10,亞東-新竹,2024-04-26,2184
2408,南亞科,10,0,10,亞東-新竹,2024-04-26,2184
3024,憶聲,10,0,10,亞東-新竹,2024-04-26,2184
6126,信音,10,0,10,亞東-新竹,2024-04-26,2184
6282,康舒,10,0,10,亞東-新竹,2024-04-26,2184
9105,泰金寶-DR,10,0,10,亞東-新竹,2024-04-26,2184
6451,訊芯-KY,11,1,10,亞東-新竹,2024-04-26,2184
00679B,元大美債20年,8,0,8,亞東-新竹,2024-04-26,2184
00929,復華台灣科技優息,21,13,8,亞東-新竹,2024-04-26,2184
1784,訊聯,15,7,8,亞東-新竹,2024-04-26,2184
2206,三陽工業,8,1,7,亞東-新竹,2024-04-26,2184
2464,盟立,9,2,7,亞東-新竹,2024-04-26,2184
2486,一詮,16,9,7,亞東-新竹,2024-04-26,2184
5871,中租-KY,6,0,6,亞東-新竹,2024-04-26,2184
00931B,統一美債20年,6,0,6,亞東-新竹,2024-04-26,2184
1582,信錦,6,0,6,亞東-新竹,2024-04-26,2184
2371,大同,18,12,6,亞東-新竹,2024-04-26,2184
2382,廣達,23,17,6,亞東-新竹,2024-04-26,2184
2641,正德,6,0,6,亞東-新竹,2024-04-26,2184
6274,台燿,6,0,6,亞東-新竹,2024-04-26,2184
9938,百和,6,0,6,亞東-新竹,2024-04-26,2184
1101,台泥,6,0,6,亞東-新竹,2024-04-26,2184
00712,復華富時不動產,5,0,5,亞東-新竹,2024-04-26,2184
00942B,台新美A公司債20+,5,0,5,亞東-新竹,2024-04-26,2184
00941,中信上游半導體,5,0,5,亞東-新竹,2024-04-26,2184
1515,力山,5,0,5,亞東-新竹,2024-04-26,2184
2359,所羅門,29,24,5,亞東-新竹,2024-04-26,2184
2417,圓剛,5,0,5,亞東-新竹,2024-04-26,2184
2867,三商壽,5,0,5,亞東-新竹,2024-04-26,2184
3481,群創,30,25,5,亞東-新竹,2024-04-26,2184
3707,漢磊,6,1,5,亞東-新竹,2024-04-26,2184
00700,富邦�琤肭磪�,50,0,50,亞東-新竹,2024-04-29,2184
2609,陽明,35,9,26,亞東-新竹,2024-04-29,2184
00632R,元大台灣50反1,25,0,25,亞東-新竹,2024-04-29,2184
2547,日勝生,20,0,20,亞東-新竹,2024-04-29,2184
2618,長榮航,27,8,19,亞東-新竹,2024-04-29,2184
2887,台新金,19,3,16,亞東-新竹,2024-04-29,2184
3163,波若威,14,0,14,亞東-新竹,2024-04-29,2184
2363,矽統,35,24,11,亞東-新竹,2024-04-29,2184
0050,元大台灣50,10,0,10,亞東-新竹,2024-04-29,2184
2367,燿華,10,0,10,亞東-新竹,2024-04-29,2184
2464,盟立,10,0,10,亞東-新竹,2024-04-29,2184
5230,雷笛克光學,10,0,10,亞東-新竹,2024-04-29,2184
00680L,元大美債20正2,8,0,8,亞東-新竹,2024-04-29,2184
3588,通嘉,8,0,8,亞東-新竹,2024-04-29,2184
2449,京元電子,7,0,7,亞東-新竹,2024-04-29,2184
1453,大將,6,0,6,亞東-新竹,2024-04-29,2184
2630,亞航,6,0,6,亞東-新竹,2024-04-29,2184
2359,所羅門,31,26,5,亞東-新竹,2024-04-29,2184
6806,森崴能源,5,0,5,亞東-新竹,2024-04-29,2184
2101,南港,5,0,5,亞東-新竹,2024-04-29,2184
2323,中環,10,5,5,亞東-新竹,2024-04-29,2184
2727,王品,5,0,5,亞東-新竹,2024-04-29,2184
3024,憶聲,5,0,5,亞東-新竹,2024-04-29,2184
3234,光環,5,0,5,亞東-新竹,2024-04-29,2184
5243,乙盛-KY,5,0,5,亞東-新竹,2024-04-29,2184
5371,中光電,6,1,5,亞東-新竹,2024-04-29,2184
6188,廣明,13,8,5,亞東-新竹,2024-04-29,2184
6288,聯嘉,7,2,5,亞東-新竹,2024-04-29,2184
8024,佑華,5,0,5,亞東-新竹,2024-04-29,2184
8255,朋程,5,0,5,亞東-新竹,2024-04-29,2184
6770,力積電,10,5,5,亞東-新竹,2024-04-29,2184
1513,中興電,4,0,4,亞東-新竹,2024-04-29,2184
00857B,永豐20年美公債,4,0,4,亞東-新竹,2024-04-29,2184
1612,宏泰,4,0,4,亞東-新竹,2024-04-29,2184
2327,國巨,4,0,4,亞東-新竹,2024-04-29,2184
2404,漢唐,4,0,4,亞東-新竹,2024-04-29,2184
4526,東台,4,0,4,亞東-新竹,2024-04-29,2184
4919,新唐,5,1,4,亞東-新竹,2024-04-29,2184
5512,力麒,14,10,4,亞東-新竹,2024-04-29,2184
6274,台燿,4,0,4,亞東-新竹,2024-04-29,2184
8110,華東,4,0,4,亞東-新竹,2024-04-29,2184
6143,振曜,3,0,3,亞東-新竹,2024-04-29,2184
1529,樂事綠能,3,0,3,亞東-新竹,2024-04-29,2184
2206,三陽工業,5,2,3,亞東-新竹,2024-04-29,2184
2374,佳能,16,13,3,亞東-新竹,2024-04-29,2184
4583,台灣精銳,3,0,3,亞東-新竹,2024-04-29,2184
5483,中美晶,4,1,3,亞東-新竹,2024-04-29,2184
00713,元大台灣高息低波,2,0,2,亞東-新竹,2024-04-29,2184
3443,創意,2,0,2,亞東-新竹,2024-04-29,2184
00751B,元大AAA至A公司債,2,0,2,亞東-新竹,2024-04-29,2184
2890,永豐金,136,2,134,亞東-新竹,2024-04-30,2184
2845,遠東銀,100,0,100,亞東-新竹,2024-04-30,2184
2610,華航,122,49,73,亞東-新竹,2024-04-30,2184
1314,中石化,57,0,57,亞東-新竹,2024-04-30,2184
9945,潤泰新,61,10,51,亞東-新竹,2024-04-30,2184
00919,群益台灣精選高息,44,0,44,亞東-新竹,2024-04-30,2184
6005,群益證,61,20,41,亞東-新竹,2024-04-30,2184
8112,至上,40,0,40,亞東-新竹,2024-04-30,2184
2611,志信,36,0,36,亞東-新竹,2024-04-30,2184
3483,力致,53,17,36,亞東-新竹,2024-04-30,2184
2912,統一超,32,0,32,亞東-新竹,2024-04-30,2184
2883,凱基金,30,0,30,亞東-新竹,2024-04-30,2184
2618,長榮航,47,25,22,亞東-新竹,2024-04-30,2184
2609,陽明,22,0,22,亞東-新竹,2024-04-30,2184
00929,復華台灣科技優息,21,0,21,亞東-新竹,2024-04-30,2184
00665L,富邦�琤肭磪囓�2,30,10,20,亞東-新竹,2024-04-30,2184
00725B,國泰投資級公司債,20,0,20,亞東-新竹,2024-04-30,2184
6163,華電網,20,0,20,亞東-新竹,2024-04-30,2184
2009,第一銅,16,0,16,亞東-新竹,2024-04-30,2184
8088,品安,16,0,16,亞東-新竹,2024-04-30,2184
2405,輔信,14,0,14,亞東-新竹,2024-04-30,2184
5706,鳳凰,14,0,14,亞東-新竹,2024-04-30,2184
3481,群創,11,0,11,亞東-新竹,2024-04-30,2184
1609,大亞,37,26,11,亞東-新竹,2024-04-30,2184
5009,榮剛,13,3,10,亞東-新竹,2024-04-30,2184
1524,耿鼎,10,0,10,亞東-新竹,2024-04-30,2184
1560,中砂,12,2,10,亞東-新竹,2024-04-30,2184
2534,宏盛,10,0,10,亞東-新竹,2024-04-30,2184
2889,國票金,10,0,10,亞東-新竹,2024-04-30,2184
3017,奇鋐,10,0,10,亞東-新竹,2024-04-30,2184
3339,泰谷,10,0,10,亞東-新竹,2024-04-30,2184
2882,國泰金,11,1,10,亞東-新竹,2024-04-30,2184
6770,力積電,15,5,10,亞東-新竹,2024-04-30,2184
2515,中工,20,11,9,亞東-新竹,2024-04-30,2184
8477,創業家,9,0,9,亞東-新竹,2024-04-30,2184
1101,台泥,10,2,8,亞東-新竹,2024-04-30,2184
6125,廣運,11,3,8,亞東-新竹,2024-04-30,2184
8931,大汽電,8,0,8,亞東-新竹,2024-04-30,2184
2501,國建,7,0,7,亞東-新竹,2024-04-30,2184
3363,上詮,11,4,7,亞東-新竹,2024-04-30,2184
4162,智擎,7,0,7,亞東-新竹,2024-04-30,2184
2201,裕隆,14,8,6,亞東-新竹,2024-04-30,2184
2371,大同,6,0,6,亞東-新竹,2024-04-30,2184
4931,新盛力,6,0,6,亞東-新竹,2024-04-30,2184
2317,鴻海,8,2,6,亞東-新竹,2024-04-30,2184
2607,榮運,5,0,5,亞東-新竹,2024-04-30,2184
00939,統一台灣高息動能,5,0,5,亞東-新竹,2024-04-30,2184
01007T,兆豐國泰R2,5,0,5,亞東-新竹,2024-04-30,2184
1720,生達,5,0,5,亞東-新竹,2024-04-30,2184
1909,榮成,5,0,5,亞東-新竹,2024-04-30,2184
2401,凌陽,54,0,54,亞東-新竹,2024-05-02,2184
3024,憶聲,100,60,40,亞東-新竹,2024-05-02,2184
3033,威健,41,1,40,亞東-新竹,2024-05-02,2184
2891,中信金,40,6,34,亞東-新竹,2024-05-02,2184
00632R,元大台灣50反1,30,0,30,亞東-新竹,2024-05-02,2184
2885,元大金,50,20,30,亞東-新竹,2024-05-02,2184
2915,潤泰全,35,5,30,亞東-新竹,2024-05-02,2184
1314,中石化,32,3,29,亞東-新竹,2024-05-02,2184
00878,國泰永續高股息,25,1,24,亞東-新竹,2024-05-02,2184
00857B,永豐20年美公債,24,0,24,亞東-新竹,2024-05-02,2184
1530,亞崴,21,0,21,亞東-新竹,2024-05-02,2184
2317,鴻海,22,5,17,亞東-新竹,2024-05-02,2184
00929,復華台灣科技優息,37,20,17,亞東-新竹,2024-05-02,2184
3522,御嵿,17,0,17,亞東-新竹,2024-05-02,2184
6177,達麗,20,3,17,亞東-新竹,2024-05-02,2184
00919,群益台灣精選高息,26,10,16,亞東-新竹,2024-05-02,2184
2609,陽明,21,5,16,亞東-新竹,2024-05-02,2184
2611,志信,15,0,15,亞東-新竹,2024-05-02,2184
3490,單井,14,0,14,亞東-新竹,2024-05-02,2184
2427,三商電,13,0,13,亞東-新竹,2024-05-02,2184
3481,群創,13,0,13,亞東-新竹,2024-05-02,2184
00933B,國泰10Y+金融債,12,0,12,亞東-新竹,2024-05-02,2184
2030,彰源,12,0,12,亞東-新竹,2024-05-02,2184
2303,聯電,29,17,12,亞東-新竹,2024-05-02,2184
2344,華邦電,11,0,11,亞東-新竹,2024-05-02,2184
8112,至上,13,2,11,亞東-新竹,2024-05-02,2184
00687B,國泰20年美債,10,0,10,亞東-新竹,2024-05-02,2184
3006,晶豪科,11,1,10,亞東-新竹,2024-05-02,2184
3512,皇龍,10,0,10,亞東-新竹,2024-05-02,2184
5533,皇鼎,10,0,10,亞東-新竹,2024-05-02,2184
8163,達方,10,0,10,亞東-新竹,2024-05-02,2184
8234,新漢,20,10,10,亞東-新竹,2024-05-02,2184
00940,元大台灣價值高息,9,0,9,亞東-新竹,2024-05-02,2184
8358,金居,9,0,9,亞東-新竹,2024-05-02,2184
2408,南亞科,8,0,8,亞東-新竹,2024-05-02,2184
2528,皇普,8,0,8,亞東-新竹,2024-05-02,2184
2330,台積電,10,3,7,亞東-新竹,2024-05-02,2184
2359,所羅門,35,28,7,亞東-新竹,2024-05-02,2184
00830,國泰費城半導體,6,0,6,亞東-新竹,2024-05-02,2184
2501,國建,12,6,6,亞東-新竹,2024-05-02,2184
6239,力成,6,0,6,亞東-新竹,2024-05-02,2184
1312,國喬,5,0,5,亞東-新竹,2024-05-02,2184
00939,統一台灣高息動能,5,0,5,亞東-新竹,2024-05-02,2184
00934,中信成長高股息,5,0,5,亞東-新竹,2024-05-02,2184
1101,台泥,7,2,5,亞東-新竹,2024-05-02,2184
00679B,元大美債20年,5,0,5,亞東-新竹,2024-05-02,2184
1316,上曜,5,0,5,亞東-新竹,2024-05-02,2184
2323,中環,5,0,5,亞東-新竹,2024-05-02,2184
2354,鴻準,5,0,5,亞東-新竹,2024-05-02,2184
2603,長榮,16,11,5,亞東-新竹,2024-05-02,2184
2834,臺企銀,400,146,254,亞東-新竹,2024-05-03,2184
2845,遠東銀,101,1,100,亞東-新竹,2024-05-03,2184
00752,中信中國50,70,0,70,亞東-新竹,2024-05-03,2184
6005,群益證,120,64,56,亞東-新竹,2024-05-03,2184
00720B,元大投資級公司債,55,0,55,亞東-新竹,2024-05-03,2184
1316,上曜,38,0,38,亞東-新竹,2024-05-03,2184
1101,台泥,37,0,37,亞東-新竹,2024-05-03,2184
1785,光洋科,35,0,35,亞東-新竹,2024-05-03,2184
00919,群益台灣精選高息,32,12,20,亞東-新竹,2024-05-03,2184
8089,康全電訊,38,19,19,亞東-新竹,2024-05-03,2184
00679B,元大美債20年,18,0,18,亞東-新竹,2024-05-03,2184
2618,長榮航,68,52,16,亞東-新竹,2024-05-03,2184
00830,國泰費城半導體,16,0,16,亞東-新竹,2024-05-03,2184
00632R,元大台灣50反1,15,0,15,亞東-新竹,2024-05-03,2184
2883,凱基金,15,0,15,亞東-新竹,2024-05-03,2184
2520,冠德,23,10,13,亞東-新竹,2024-05-03,2184
6290,良維,13,0,13,亞東-新竹,2024-05-03,2184
4908,前鼎,12,0,12,亞東-新竹,2024-05-03,2184
8234,新漢,13,1,12,亞東-新竹,2024-05-03,2184
00929,復華台灣科技優息,27,16,11,亞東-新竹,2024-05-03,2184
6190,萬泰科,11,0,11,亞東-新竹,2024-05-03,2184
00715L,期街口布蘭特正2,11,0,11,亞東-新竹,2024-05-03,2184
0056,元大高股息,10,0,10,亞東-新竹,2024-05-03,2184
00665L,富邦�琤肭磪囓�2,20,10,10,亞東-新竹,2024-05-03,2184
1524,耿鼎,10,0,10,亞東-新竹,2024-05-03,2184
1909,榮成,10,0,10,亞東-新竹,2024-05-03,2184
2316,楠梓電,18,8,10,亞東-新竹,2024-05-03,2184
2329,華泰,10,0,10,亞東-新竹,2024-05-03,2184
2359,所羅門,44,35,9,亞東-新竹,2024-05-03,2184
1504,東元,9,1,8,亞東-新竹,2024-05-03,2184
1720,生達,8,0,8,亞東-新竹,2024-05-03,2184
1784,訊聯,11,3,8,亞東-新竹,2024-05-03,2184
3711,日月光投控,9,1,8,亞東-新竹,2024-05-03,2184
5383,金利,8,0,8,亞東-新竹,2024-05-03,2184
3231,緯創,11,4,7,亞東-新竹,2024-05-03,2184
00687B,國泰20年美債,7,0,7,亞東-新竹,2024-05-03,2184
1529,樂事綠能,7,0,7,亞東-新竹,2024-05-03,2184
2206,三陽工業,6,0,6,亞東-新竹,2024-05-03,2184
5230,雷笛克光學,6,0,6,亞東-新竹,2024-05-03,2184
5512,力麒,6,0,6,亞東-新竹,2024-05-03,2184
3339,泰谷,5,0,5,亞東-新竹,2024-05-03,2184
5531,鄉林,8,3,5,亞東-新竹,2024-05-03,2184
8024,佑華,5,0,5,亞東-新竹,2024-05-03,2184
2356,英業達,4,0,4,亞東-新竹,2024-05-03,2184
2382,廣達,6,2,4,亞東-新竹,2024-05-03,2184
00680L,元大美債20正2,4,0,4,亞東-新竹,2024-05-03,2184
2314,台揚,4,0,4,亞東-新竹,2024-05-03,2184
2374,佳能,6,2,4,亞東-新竹,2024-05-03,2184
2609,陽明,4,0,4,亞東-新竹,2024-05-03,2184
2630,亞航,4,0,4,亞東-新竹,2024-05-03,2184
00929,復華台灣科技優息,43,2,41,亞東-新竹,2024-05-06,2184
2618,長榮航,68,29,39,亞東-新竹,2024-05-06,2184
00679B,元大美債20年,33,0,33,亞東-新竹,2024-05-06,2184
8088,品安,33,1,32,亞東-新竹,2024-05-06,2184
2887,台新金,30,0,30,亞東-新竹,2024-05-06,2184
00680L,元大美債20正2,27,4,23,亞東-新竹,2024-05-06,2184
4526,東台,23,0,23,亞東-新竹,2024-05-06,2184
1101,台泥,22,1,21,亞東-新竹,2024-05-06,2184
2363,矽統,25,4,21,亞東-新竹,2024-05-06,2184
5498,凱崴,18,0,18,亞東-新竹,2024-05-06,2184
9910,豐泰,18,0,18,亞東-新竹,2024-05-06,2184
00706L,期元大S＆P日圓正2,17,0,17,亞東-新竹,2024-05-06,2184
3512,皇龍,15,0,15,亞東-新竹,2024-05-06,2184
9938,百和,14,0,14,亞東-新竹,2024-05-06,2184
4303,信立,13,0,13,亞東-新竹,2024-05-06,2184
00940,元大台灣價值高息,12,0,12,亞東-新竹,2024-05-06,2184
2427,三商電,11,0,11,亞東-新竹,2024-05-06,2184
1312,國喬,10,0,10,亞東-新竹,2024-05-06,2184
00632R,元大台灣50反1,10,0,10,亞東-新竹,2024-05-06,2184
1909,榮成,10,0,10,亞東-新竹,2024-05-06,2184
2542,興富發,10,0,10,亞東-新竹,2024-05-06,2184
2547,日勝生,10,0,10,亞東-新竹,2024-05-06,2184
3013,晟銘電,11,1,10,亞東-新竹,2024-05-06,2184
3025,星通,10,0,10,亞東-新竹,2024-05-06,2184
3481,群創,10,0,10,亞東-新竹,2024-05-06,2184
3557,嘉威,10,0,10,亞東-新竹,2024-05-06,2184
4306,炎洲,10,0,10,亞東-新竹,2024-05-06,2184
4916,事欣科,10,0,10,亞東-新竹,2024-05-06,2184
4967,十銓,10,0,10,亞東-新竹,2024-05-06,2184
8016,矽創,10,0,10,亞東-新竹,2024-05-06,2184
2328,廣宇,12,3,9,亞東-新竹,2024-05-06,2184
2402,毅嘉,10,1,9,亞東-新竹,2024-05-06,2184
3260,威剛,11,2,9,亞東-新竹,2024-05-06,2184
1609,大亞,11,3,8,亞東-新竹,2024-05-06,2184
00878,國泰永續高股息,16,8,8,亞東-新竹,2024-05-06,2184
00670L,富邦NASDAQ正2,8,0,8,亞東-新竹,2024-05-06,2184
6451,訊芯-KY,8,0,8,亞東-新竹,2024-05-06,2184
3088,艾訊,7,0,7,亞東-新竹,2024-05-06,2184
1720,生達,6,0,6,亞東-新竹,2024-05-06,2184
2206,三陽工業,10,4,6,亞東-新竹,2024-05-06,2184
2611,志信,6,0,6,亞東-新竹,2024-05-06,2184
6190,萬泰科,6,0,6,亞東-新竹,2024-05-06,2184
3661,世芯-KY,5,0,5,亞東-新竹,2024-05-06,2184
00685L,群益臺灣加權正2,5,0,5,亞東-新竹,2024-05-06,2184
2049,上銀,5,0,5,亞東-新竹,2024-05-06,2184
2329,華泰,5,0,5,亞東-新竹,2024-05-06,2184
2388,威盛,5,0,5,亞東-新竹,2024-05-06,2184
2607,榮運,5,0,5,亞東-新竹,2024-05-06,2184
5227,立凱-KY,5,0,5,亞東-新竹,2024-05-06,2184
5443,均豪,5,0,5,亞東-新竹,2024-05-06,2184
6005,群益證,829,40,789,亞東-新竹,2024-05-07,2184
00929,復華台灣科技優息,68,5,63,亞東-新竹,2024-05-07,2184
6770,力積電,53,12,41,亞東-新竹,2024-05-07,2184
2405,輔信,40,0,40,亞東-新竹,2024-05-07,2184
2408,南亞科,40,0,40,亞東-新竹,2024-05-07,2184
1453,大將,42,7,35,亞東-新竹,2024-05-07,2184
00919,群益台灣精選高息,28,0,28,亞東-新竹,2024-05-07,2184
2382,廣達,32,7,25,亞東-新竹,2024-05-07,2184
2603,長榮,29,4,25,亞東-新竹,2024-05-07,2184
00878,國泰永續高股息,26,2,24,亞東-新竹,2024-05-07,2184
2515,中工,44,23,21,亞東-新竹,2024-05-07,2184
1524,耿鼎,20,0,20,亞東-新竹,2024-05-07,2184
2323,中環,20,0,20,亞東-新竹,2024-05-07,2184
9941,裕融,20,0,20,亞東-新竹,2024-05-07,2184
00940,元大台灣價值高息,18,0,18,亞東-新竹,2024-05-07,2184
5871,中租-KY,14,0,14,亞東-新竹,2024-05-07,2184
2303,聯電,15,2,13,亞東-新竹,2024-05-07,2184
3512,皇龍,15,2,13,亞東-新竹,2024-05-07,2184
5531,鄉林,27,14,13,亞東-新竹,2024-05-07,2184
00680L,元大美債20正2,24,12,12,亞東-新竹,2024-05-07,2184
3006,晶豪科,16,6,10,亞東-新竹,2024-05-07,2184
3017,奇鋐,12,2,10,亞東-新竹,2024-05-07,2184
3615,安可,10,0,10,亞東-新竹,2024-05-07,2184
3030,德律,10,0,10,亞東-新竹,2024-05-07,2184
020034,元大IC設計N,9,0,9,亞東-新竹,2024-05-07,2184
0056,元大高股息,9,0,9,亞東-新竹,2024-05-07,2184
2912,統一超,8,0,8,亞東-新竹,2024-05-07,2184
8040,九暘,8,0,8,亞東-新竹,2024-05-07,2184
00679B,元大美債20年,7,0,7,亞東-新竹,2024-05-07,2184
1442,名軒,20,13,7,亞東-新竹,2024-05-07,2184
2612,中航,7,0,7,亞東-新竹,2024-05-07,2184
3481,群創,8,1,7,亞東-新竹,2024-05-07,2184
8271,宇瞻,10,3,7,亞東-新竹,2024-05-07,2184
1808,潤隆,12,6,6,亞東-新竹,2024-05-07,2184
2486,一詮,13,7,6,亞東-新竹,2024-05-07,2184
3047,訊舟,6,0,6,亞東-新竹,2024-05-07,2184
3163,波若威,6,0,6,亞東-新竹,2024-05-07,2184
4933,友輝,8,2,6,亞東-新竹,2024-05-07,2184
5251,天鉞電,6,0,6,亞東-新竹,2024-05-07,2184
5880,合庫金,6,0,6,亞東-新竹,2024-05-07,2184
2063,世鎧,5,0,5,亞東-新竹,2024-05-07,2184
2520,冠德,5,0,5,亞東-新竹,2024-05-07,2184
2743,山富,5,0,5,亞東-新竹,2024-05-07,2184
2886,兆豐金,5,0,5,亞東-新竹,2024-05-07,2184
4979,華星光,5,0,5,亞東-新竹,2024-05-07,2184
6120,達運,5,0,5,亞東-新竹,2024-05-07,2184
8105,凌巨,5,0,5,亞東-新竹,2024-05-07,2184
3596,智易,7,2,5,亞東-新竹,2024-05-07,2184
2618,長榮航,28,24,4,亞東-新竹,2024-05-07,2184
00939,統一台灣高息動能,4,0,4,亞東-新竹,2024-05-07,2184
00679B,元大美債20年,122,3,119,亞東-新竹,2024-05-08,2184
2882,國泰金,98,0,98,亞東-新竹,2024-05-08,2184
2609,陽明,84,4,80,亞東-新竹,2024-05-08,2184
2603,長榮,69,1,68,亞東-新竹,2024-05-08,2184
00637L,元大滬深300正2,34,2,32,亞東-新竹,2024-05-08,2184
2359,所羅門,66,35,31,亞東-新竹,2024-05-08,2184
0056,元大高股息,30,1,29,亞東-新竹,2024-05-08,2184
5871,中租-KY,29,0,29,亞東-新竹,2024-05-08,2184
2371,大同,27,1,26,亞東-新竹,2024-05-08,2184
1101,台泥,22,0,22,亞東-新竹,2024-05-08,2184
00919,群益台灣精選高息,20,0,20,亞東-新竹,2024-05-08,2184
00933B,國泰10Y+金融債,20,0,20,亞東-新竹,2024-05-08,2184
1611,中電,20,0,20,亞東-新竹,2024-05-08,2184
6589,台康生技,20,0,20,亞東-新竹,2024-05-08,2184
6005,群益證,345,326,19,亞東-新竹,2024-05-08,2184
2442,新美齊,16,0,16,亞東-新竹,2024-05-08,2184
2618,長榮航,47,33,14,亞東-新竹,2024-05-08,2184
00940,元大台灣價值高息,14,0,14,亞東-新竹,2024-05-08,2184
2363,矽統,22,9,13,亞東-新竹,2024-05-08,2184
3025,星通,13,0,13,亞東-新竹,2024-05-08,2184
1608,華榮,12,0,12,亞東-新竹,2024-05-08,2184
4207,環泰,12,0,12,亞東-新竹,2024-05-08,2184
2374,佳能,33,22,11,亞東-新竹,2024-05-08,2184
2614,東森,10,0,10,亞東-新竹,2024-05-08,2184
3033,威健,22,12,10,亞東-新竹,2024-05-08,2184
1304,台聚,8,0,8,亞東-新竹,2024-05-08,2184
1808,潤隆,10,2,8,亞東-新竹,2024-05-08,2184
1513,中興電,18,11,7,亞東-新竹,2024-05-08,2184
3034,聯詠,8,1,7,亞東-新竹,2024-05-08,2184
1603,華電,10,3,7,亞東-新竹,2024-05-08,2184
3708,上緯投控,7,0,7,亞東-新竹,2024-05-08,2184
0050,元大台灣50,6,0,6,亞東-新竹,2024-05-08,2184
2376,技嘉,21,15,6,亞東-新竹,2024-05-08,2184
3024,憶聲,6,0,6,亞東-新竹,2024-05-08,2184
5426,振發,6,0,6,亞東-新竹,2024-05-08,2184
2892,第一金,6,0,6,亞東-新竹,2024-05-08,2184
00680L,元大美債20正2,5,0,5,亞東-新竹,2024-05-08,2184
00720B,元大投資級公司債,5,0,5,亞東-新竹,2024-05-08,2184
1312,國喬,5,0,5,亞東-新竹,2024-05-08,2184
1560,中砂,5,0,5,亞東-新竹,2024-05-08,2184
1615,大山,19,14,5,亞東-新竹,2024-05-08,2184
2063,世鎧,5,0,5,亞東-新竹,2024-05-08,2184
2206,三陽工業,11,6,5,亞東-新竹,2024-05-08,2184
2637,慧洋-KY,5,0,5,亞東-新竹,2024-05-08,2184
5609,中菲行,6,1,5,亞東-新竹,2024-05-08,2184
6488,環球晶,5,0,5,亞東-新竹,2024-05-08,2184
8089,康全電訊,5,0,5,亞東-新竹,2024-05-08,2184
8936,國統,6,1,5,亞東-新竹,2024-05-08,2184
2606,裕民,7,2,5,亞東-新竹,2024-05-08,2184
1314,中石化,4,0,4,亞東-新竹,2024-05-08,2184
2883,凱基金,905,6,899,亞東-新竹,2024-05-09,2184
2888,新光金,125,10,115,亞東-新竹,2024-05-09,2184
2887,台新金,55,0,55,亞東-新竹,2024-05-09,2184
1513,中興電,40,0,40,亞東-新竹,2024-05-09,2184
8011,台通,40,0,40,亞東-新竹,2024-05-09,2184
00679B,元大美債20年,31,0,31,亞東-新竹,2024-05-09,2184
00946,群益科技高息成長,23,0,23,亞東-新竹,2024-05-09,2184
9958,世紀鋼,21,0,21,亞東-新竹,2024-05-09,2184
1524,耿鼎,21,1,20,亞東-新竹,2024-05-09,2184
2838,聯邦銀,20,0,20,亞東-新竹,2024-05-09,2184
5871,中租-KY,19,0,19,亞東-新竹,2024-05-09,2184
1326,台化,17,0,17,亞東-新竹,2024-05-09,2184
5478,智冠,15,0,15,亞東-新竹,2024-05-09,2184
6645,金萬林-創,15,0,15,亞東-新竹,2024-05-09,2184
1615,大山,15,1,14,亞東-新竹,2024-05-09,2184
4513,福裕,14,0,14,亞東-新竹,2024-05-09,2184
2449,京元電子,13,0,13,亞東-新竹,2024-05-09,2184
00713,元大台灣高息低波,12,0,12,亞東-新竹,2024-05-09,2184
1101,台泥,10,0,10,亞東-新竹,2024-05-09,2184
00942B,台新美A公司債20+,10,0,10,亞東-新竹,2024-05-09,2184
2547,日勝生,10,0,10,亞東-新竹,2024-05-09,2184
4526,東台,15,5,10,亞東-新竹,2024-05-09,2184
00929,復華台灣科技優息,9,0,9,亞東-新竹,2024-05-09,2184
2489,瑞軒,9,0,9,亞東-新竹,2024-05-09,2184
9945,潤泰新,9,0,9,亞東-新竹,2024-05-09,2184
3231,緯創,14,6,8,亞東-新竹,2024-05-09,2184
3029,零壹,8,0,8,亞東-新竹,2024-05-09,2184
3338,泰碩,8,0,8,亞東-新竹,2024-05-09,2184
2882,國泰金,28,20,8,亞東-新竹,2024-05-09,2184
00878,國泰永續高股息,11,4,7,亞東-新竹,2024-05-09,2184
00857B,永豐20年美公債,7,0,7,亞東-新竹,2024-05-09,2184
2338,光罩,7,0,7,亞東-新竹,2024-05-09,2184
1609,大亞,8,2,6,亞東-新竹,2024-05-09,2184
2809,京城銀,7,1,6,亞東-新竹,2024-05-09,2184
00680L,元大美債20正2,6,0,6,亞東-新竹,2024-05-09,2184
00720B,元大投資級公司債,6,0,6,亞東-新竹,2024-05-09,2184
1442,名軒,6,0,6,亞東-新竹,2024-05-09,2184
2316,楠梓電,6,0,6,亞東-新竹,2024-05-09,2184
6863,永道-KY,6,0,6,亞東-新竹,2024-05-09,2184
2337,旺宏,5,0,5,亞東-新竹,2024-05-09,2184
2344,華邦電,5,0,5,亞東-新竹,2024-05-09,2184
2516,新建,5,0,5,亞東-新竹,2024-05-09,2184
6016,康和證,5,0,5,亞東-新竹,2024-05-09,2184
6591,動力-KY,5,0,5,亞東-新竹,2024-05-09,2184
8089,康全電訊,6,1,5,亞東-新竹,2024-05-09,2184
2317,鴻海,12,7,5,亞東-新竹,2024-05-09,2184
3036,文曄,5,0,5,亞東-新竹,2024-05-09,2184
00940,元大台灣價值高息,4,0,4,亞東-新竹,2024-05-09,2184
1314,中石化,4,0,4,亞東-新竹,2024-05-09,2184
1529,樂事綠能,4,0,4,亞東-新竹,2024-05-09,2184
00929,復華台灣科技優息,178,0,178,亞東-新竹,2024-05-10,2184
2605,新興,170,0,170,亞東-新竹,2024-05-10,2184
3052,夆典,124,0,124,亞東-新竹,2024-05-10,2184
00919,群益台灣精選高息,121,17,104,亞東-新竹,2024-05-10,2184
2323,中環,130,30,100,亞東-新竹,2024-05-10,2184
00751B,元大AAA至A公司債,50,0,50,亞東-新竹,2024-05-10,2184
00720B,元大投資級公司債,50,6,44,亞東-新竹,2024-05-10,2184
6147,頎邦,38,0,38,亞東-新竹,2024-05-10,2184
3356,奇偶,26,4,22,亞東-新竹,2024-05-10,2184
2883,凱基金,161,140,21,亞東-新竹,2024-05-10,2184
3013,晟銘電,60,42,18,亞東-新竹,2024-05-10,2184
2329,華泰,20,3,17,亞東-新竹,2024-05-10,2184
00680L,元大美債20正2,16,2,14,亞東-新竹,2024-05-10,2184
6239,力成,14,0,14,亞東-新竹,2024-05-10,2184
4908,前鼎,13,0,13,亞東-新竹,2024-05-10,2184
8040,九暘,13,0,13,亞東-新竹,2024-05-10,2184
3056,富華新,12,0,12,亞東-新竹,2024-05-10,2184
8916,光隆,12,0,12,亞東-新竹,2024-05-10,2184
00665L,富邦�琤肭磪囓�2,10,0,10,亞東-新竹,2024-05-10,2184
2509,全坤建,10,0,10,亞東-新竹,2024-05-10,2184
3060,銘異,10,0,10,亞東-新竹,2024-05-10,2184
5519,隆大,10,0,10,亞東-新竹,2024-05-10,2184
5608,四維航,11,1,10,亞東-新竹,2024-05-10,2184
2382,廣達,13,4,9,亞東-新竹,2024-05-10,2184
00679B,元大美債20年,9,0,9,亞東-新竹,2024-05-10,2184
2618,長榮航,43,34,9,亞東-新竹,2024-05-10,2184
2313,華通,9,1,8,亞東-新竹,2024-05-10,2184
6125,廣運,10,2,8,亞東-新竹,2024-05-10,2184
00946,群益科技高息成長,13,5,8,亞東-新竹,2024-05-10,2184
2442,新美齊,8,0,8,亞東-新竹,2024-05-10,2184
5498,凱崴,8,0,8,亞東-新竹,2024-05-10,2184
6005,群益證,10,2,8,亞東-新竹,2024-05-10,2184
1314,中石化,6,0,6,亞東-新竹,2024-05-10,2184
1529,樂事綠能,6,0,6,亞東-新竹,2024-05-10,2184
2201,裕隆,22,16,6,亞東-新竹,2024-05-10,2184
2388,威盛,8,2,6,亞東-新竹,2024-05-10,2184
6789,采鈺,6,0,6,亞東-新竹,2024-05-10,2184
8086,宏捷科,6,0,6,亞東-新竹,2024-05-10,2184
1785,光洋科,11,5,6,亞東-新竹,2024-05-10,2184
00713,元大台灣高息低波,5,0,5,亞東-新竹,2024-05-10,2184
8936,國統,8,3,5,亞東-新竹,2024-05-10,2184
00936,台新永續高息中小,5,0,5,亞東-新竹,2024-05-10,2184
2352,佳世達,5,0,5,亞東-新竹,2024-05-10,2184
2606,裕民,7,2,5,亞東-新竹,2024-05-10,2184
3481,群創,5,0,5,亞東-新竹,2024-05-10,2184
3564,其陽,16,11,5,亞東-新竹,2024-05-10,2184
5478,智冠,5,0,5,亞東-新竹,2024-05-10,2184
5483,中美晶,5,0,5,亞東-新竹,2024-05-10,2184
9945,潤泰新,5,0,5,亞東-新竹,2024-05-10,2184
9958,世紀鋼,5,0,5,亞東-新竹,2024-05-10,2184
00929,復華台灣科技優息,216,0,216,亞東-新竹,2024-05-13,2184
2891,中信金,142,20,122,亞東-新竹,2024-05-13,2184
00937B,群益ESG投等債20,112,0,112,亞東-新竹,2024-05-13,2184
00712,復華富時不動產,100,0,100,亞東-新竹,2024-05-13,2184
2897,王道銀行,100,0,100,亞東-新竹,2024-05-13,2184
2883,凱基金,75,1,74,亞東-新竹,2024-05-13,2184
9904,寶成,61,0,61,亞東-新竹,2024-05-13,2184
00934,中信成長高股息,50,0,50,亞東-新竹,2024-05-13,2184
6770,力積電,52,3,49,亞東-新竹,2024-05-13,2184
1314,中石化,41,0,41,亞東-新竹,2024-05-13,2184
1524,耿鼎,25,0,25,亞東-新竹,2024-05-13,2184
2317,鴻海,26,4,22,亞東-新竹,2024-05-13,2184
00878,國泰永續高股息,23,2,21,亞東-新竹,2024-05-13,2184
2618,長榮航,62,42,20,亞東-新竹,2024-05-13,2184
2915,潤泰全,32,13,19,亞東-新竹,2024-05-13,2184
00919,群益台灣精選高息,20,3,17,亞東-新竹,2024-05-13,2184
2427,三商電,17,0,17,亞東-新竹,2024-05-13,2184
2201,裕隆,28,17,11,亞東-新竹,2024-05-13,2184
2367,燿華,12,1,11,亞東-新竹,2024-05-13,2184
2603,長榮,60,49,11,亞東-新竹,2024-05-13,2184
00942B,台新美A公司債20+,10,0,10,亞東-新竹,2024-05-13,2184
00690,兆豐藍籌30,10,0,10,亞東-新竹,2024-05-13,2184
4909,新復興,10,0,10,亞東-新竹,2024-05-13,2184
5230,雷笛克光學,10,0,10,亞東-新竹,2024-05-13,2184
6271,同欣電,10,0,10,亞東-新竹,2024-05-13,2184
2882,國泰金,9,0,9,亞東-新竹,2024-05-13,2184
5483,中美晶,10,1,9,亞東-新竹,2024-05-13,2184
4207,環泰,10,2,8,亞東-新竹,2024-05-13,2184
4513,福裕,8,0,8,亞東-新竹,2024-05-13,2184
5263,智崴,8,0,8,亞東-新竹,2024-05-13,2184
2241,艾姆勒,8,1,7,亞東-新竹,2024-05-13,2184
2636,台驊控股,7,0,7,亞東-新竹,2024-05-13,2184
2888,新光金,10,3,7,亞東-新竹,2024-05-13,2184
3231,緯創,10,4,6,亞東-新竹,2024-05-13,2184
3017,奇鋐,7,1,6,亞東-新竹,2024-05-13,2184
3483,力致,6,0,6,亞東-新竹,2024-05-13,2184
6189,豐藝,5,0,5,亞東-新竹,2024-05-13,2184
1718,中纖,5,0,5,亞東-新竹,2024-05-13,2184
3013,晟銘電,31,26,5,亞東-新竹,2024-05-13,2184
8150,南茂,5,0,5,亞東-新竹,2024-05-13,2184
9924,福興,5,0,5,亞東-新竹,2024-05-13,2184
00857B,永豐20年美公債,4,0,4,亞東-新竹,2024-05-13,2184
2354,鴻準,4,0,4,亞東-新竹,2024-05-13,2184
2357,華碩,5,1,4,亞東-新竹,2024-05-13,2184
2739,寒舍,4,0,4,亞東-新竹,2024-05-13,2184
3645,達邁,4,0,4,亞東-新竹,2024-05-13,2184
6115,鎰勝,4,0,4,亞東-新竹,2024-05-13,2184
8936,國統,15,11,4,亞東-新竹,2024-05-13,2184
2329,華泰,3,0,3,亞東-新竹,2024-05-13,2184
5871,中租-KY,3,0,3,亞東-新竹,2024-05-13,2184
00680L,元大美債20正2,55,0,55,亞東-新竹,2024-05-14,2184
2801,彰銀,40,1,39,亞東-新竹,2024-05-14,2184
2534,宏盛,36,0,36,亞東-新竹,2024-05-14,2184
2365,昆盈,35,0,35,亞東-新竹,2024-05-14,2184
2363,矽統,38,7,31,亞東-新竹,2024-05-14,2184
3705,永信,30,0,30,亞東-新竹,2024-05-14,2184
00665L,富邦�琤肭磪囓�2,35,10,25,亞東-新竹,2024-05-14,2184
6015,宏遠證,24,0,24,亞東-新竹,2024-05-14,2184
2880,華南金,20,0,20,亞東-新竹,2024-05-14,2184
4909,新復興,20,0,20,亞東-新竹,2024-05-14,2184
5522,遠雄,20,0,20,亞東-新竹,2024-05-14,2184
4716,大立,20,4,16,亞東-新竹,2024-05-14,2184
00937B,群益ESG投等債20,15,0,15,亞東-新竹,2024-05-14,2184
00936,台新永續高息中小,15,0,15,亞東-新竹,2024-05-14,2184
2323,中環,15,0,15,亞東-新竹,2024-05-14,2184
6770,力積電,15,4,11,亞東-新竹,2024-05-14,2184
01004T,土銀富邦R2,10,0,10,亞東-新竹,2024-05-14,2184
00690,兆豐藍籌30,10,0,10,亞東-新竹,2024-05-14,2184
0061,元大寶滬深,10,0,10,亞東-新竹,2024-05-14,2184
2324,仁寶,13,3,10,亞東-新竹,2024-05-14,2184
2615,萬海,35,25,10,亞東-新竹,2024-05-14,2184
8107,大億金茂,10,0,10,亞東-新竹,2024-05-14,2184
3231,緯創,22,13,9,亞東-新竹,2024-05-14,2184
3691,碩禾,9,0,9,亞東-新竹,2024-05-14,2184
2313,華通,8,0,8,亞東-新竹,2024-05-14,2184
3090,日電貿,8,0,8,亞東-新竹,2024-05-14,2184
4903,聯光通,8,0,8,亞東-新竹,2024-05-14,2184
6177,達麗,8,0,8,亞東-新竹,2024-05-14,2184
1524,耿鼎,7,0,7,亞東-新竹,2024-05-14,2184
2545,皇翔,7,0,7,亞東-新竹,2024-05-14,2184
3443,創意,8,1,7,亞東-新竹,2024-05-14,2184
5525,順天,7,0,7,亞東-新竹,2024-05-14,2184
2892,第一金,6,0,6,亞東-新竹,2024-05-14,2184
2303,聯電,13,7,6,亞東-新竹,2024-05-14,2184
00679B,元大美債20年,6,0,6,亞東-新竹,2024-05-14,2184
00650L,復華香港正2,6,0,6,亞東-新竹,2024-05-14,2184
5609,中菲行,6,0,6,亞東-新竹,2024-05-14,2184
2834,臺企銀,5,0,5,亞東-新竹,2024-05-14,2184
4105,東洋,6,1,5,亞東-新竹,2024-05-14,2184
1560,中砂,5,0,5,亞東-新竹,2024-05-14,2184
2308,台達電,6,1,5,亞東-新竹,2024-05-14,2184
2501,國建,6,1,5,亞東-新竹,2024-05-14,2184
2915,潤泰全,11,6,5,亞東-新竹,2024-05-14,2184
3036A,文曄甲特,5,0,5,亞東-新竹,2024-05-14,2184
3708,上緯投控,5,0,5,亞東-新竹,2024-05-14,2184
4157,太景*-KY,5,0,5,亞東-新竹,2024-05-14,2184
4303,信立,5,0,5,亞東-新竹,2024-05-14,2184
6282,康舒,5,0,5,亞東-新竹,2024-05-14,2184
6462,神盾,10,5,5,亞東-新竹,2024-05-14,2184
8299,群聯,8,4,4,亞東-新竹,2024-05-14,2184
00929,復華台灣科技優息,190,6,184,亞東-新竹,2024-05-15,2184
2409,友達,163,3,160,亞東-新竹,2024-05-15,2184
00919,群益台灣精選高息,89,0,89,亞東-新竹,2024-05-15,2184
00882,中信中國高股息,65,0,65,亞東-新竹,2024-05-15,2184
00632R,元大台灣50反1,60,0,60,亞東-新竹,2024-05-15,2184
00937B,群益ESG投等債20,50,0,50,亞東-新竹,2024-05-15,2184
1714,和桐,47,0,47,亞東-新竹,2024-05-15,2184
2605,新興,85,40,45,亞東-新竹,2024-05-15,2184
00679B,元大美債20年,40,0,40,亞東-新竹,2024-05-15,2184
3481,群創,33,0,33,亞東-新竹,2024-05-15,2184
00940,元大台灣價值高息,22,0,22,亞東-新竹,2024-05-15,2184
3706,神達,22,0,22,亞東-新竹,2024-05-15,2184
4533,協易機,21,0,21,亞東-新竹,2024-05-15,2184
2514,龍邦,20,0,20,亞東-新竹,2024-05-15,2184
00878,國泰永續高股息,32,13,19,亞東-新竹,2024-05-15,2184
5498,凱崴,18,0,18,亞東-新竹,2024-05-15,2184
2618,長榮航,27,11,16,亞東-新竹,2024-05-15,2184
00936,台新永續高息中小,15,0,15,亞東-新竹,2024-05-15,2184
2363,矽統,31,17,14,亞東-新竹,2024-05-15,2184
2406,國碩,19,5,14,亞東-新竹,2024-05-15,2184
00939,統一台灣高息動能,12,0,12,亞東-新竹,2024-05-15,2184
5371,中光電,13,1,12,亞東-新竹,2024-05-15,2184
4714,永捷,11,0,11,亞東-新竹,2024-05-15,2184
2002,中鋼,10,0,10,亞東-新竹,2024-05-15,2184
8234,新漢,10,0,10,亞東-新竹,2024-05-15,2184
1611,中電,10,1,9,亞東-新竹,2024-05-15,2184
3691,碩禾,10,1,9,亞東-新竹,2024-05-15,2184
2613,中櫃,10,2,8,亞東-新竹,2024-05-15,2184
2617,台航,8,0,8,亞東-新竹,2024-05-15,2184
1316,上曜,7,0,7,亞東-新竹,2024-05-15,2184
2241,艾姆勒,9,2,7,亞東-新竹,2024-05-15,2184
2356,英業達,7,1,6,亞東-新竹,2024-05-15,2184
2603,長榮,19,13,6,亞東-新竹,2024-05-15,2184
3705,永信,6,0,6,亞東-新竹,2024-05-15,2184
2357,華碩,5,0,5,亞東-新竹,2024-05-15,2184
00713,元大台灣高息低波,5,0,5,亞東-新竹,2024-05-15,2184
5871,中租-KY,5,0,5,亞東-新竹,2024-05-15,2184
2367,燿華,10,5,5,亞東-新竹,2024-05-15,2184
2636,台驊控股,5,0,5,亞東-新竹,2024-05-15,2184
9924,福興,5,0,5,亞東-新竹,2024-05-15,2184
2317,鴻海,18,14,4,亞東-新竹,2024-05-15,2184
00946,群益科技高息成長,4,0,4,亞東-新竹,2024-05-15,2184
1710,東聯,4,0,4,亞東-新竹,2024-05-15,2184
1808,潤隆,4,0,4,亞東-新竹,2024-05-15,2184
2061,風青,4,0,4,亞東-新竹,2024-05-15,2184
2376,技嘉,9,5,4,亞東-新竹,2024-05-15,2184
2392,正崴,4,0,4,亞東-新竹,2024-05-15,2184
2427,三商電,4,0,4,亞東-新竹,2024-05-15,2184
2476,鉅祥,6,2,4,亞東-新竹,2024-05-15,2184
3013,晟銘電,20,16,4,亞東-新竹,2024-05-15,2184
2514,龍邦,140,0,140,亞東-新竹,2024-05-16,2184
2883,凱基金,145,27,118,亞東-新竹,2024-05-16,2184
2605,新興,120,30,90,亞東-新竹,2024-05-16,2184
2882,國泰金,82,2,80,亞東-新竹,2024-05-16,2184
00632R,元大台灣50反1,115,53,62,亞東-新竹,2024-05-16,2184
00680L,元大美債20正2,460,400,60,亞東-新竹,2024-05-16,2184
3052,夆典,60,0,60,亞東-新竹,2024-05-16,2184
3024,憶聲,55,0,55,亞東-新竹,2024-05-16,2184
1314,中石化,53,0,53,亞東-新竹,2024-05-16,2184
2353,宏��,47,6,41,亞東-新竹,2024-05-16,2184
5534,長虹,31,0,31,亞東-新竹,2024-05-16,2184
2405,輔信,30,0,30,亞東-新竹,2024-05-16,2184
2915,潤泰全,28,0,28,亞東-新竹,2024-05-16,2184
2609,陽明,39,13,26,亞東-新竹,2024-05-16,2184
3231,緯創,28,4,24,亞東-新竹,2024-05-16,2184
2610,華航,71,52,19,亞東-新竹,2024-05-16,2184
2464,盟立,22,5,17,亞東-新竹,2024-05-16,2184
2101,南港,11,0,11,亞東-新竹,2024-05-16,2184
8150,南茂,11,0,11,亞東-新竹,2024-05-16,2184
00635U,期元大S＆P黃金,10,0,10,亞東-新竹,2024-05-16,2184
1614,三洋電,10,0,10,亞東-新竹,2024-05-16,2184
2312,金寶,10,0,10,亞東-新竹,2024-05-16,2184
2515,中工,10,0,10,亞東-新竹,2024-05-16,2184
2641,正德,10,0,10,亞東-新竹,2024-05-16,2184
5392,能率,10,0,10,亞東-新竹,2024-05-16,2184
5522,遠雄,10,0,10,亞東-新竹,2024-05-16,2184
2317,鴻海,18,9,9,亞東-新竹,2024-05-16,2184
2359,所羅門,41,33,8,亞東-新竹,2024-05-16,2184
3260,威剛,8,0,8,亞東-新竹,2024-05-16,2184
2028,威致,7,0,7,亞東-新竹,2024-05-16,2184
6163,華電網,7,0,7,亞東-新竹,2024-05-16,2184
9927,泰銘,7,0,7,亞東-新竹,2024-05-16,2184
1319,東陽,6,0,6,亞東-新竹,2024-05-16,2184
3025,星通,6,0,6,亞東-新竹,2024-05-16,2184
3234,光環,6,0,6,亞東-新竹,2024-05-16,2184
6462,神盾,6,0,6,亞東-新竹,2024-05-16,2184
2356,英業達,5,0,5,亞東-新竹,2024-05-16,2184
00941,中信上游半導體,5,0,5,亞東-新竹,2024-05-16,2184
0061,元大寶滬深,5,0,5,亞東-新竹,2024-05-16,2184
00673R,期元大S＆P原油反1,5,0,5,亞東-新竹,2024-05-16,2184
2704,國賓,5,0,5,亞東-新竹,2024-05-16,2184
3030,德律,5,0,5,亞東-新竹,2024-05-16,2184
4414,如興,5,0,5,亞東-新竹,2024-05-16,2184
8070,長華*,5,0,5,亞東-新竹,2024-05-16,2184
2534,宏盛,5,0,5,亞東-新竹,2024-05-16,2184
6125,廣運,4,0,4,亞東-新竹,2024-05-16,2184
1503,士電,6,2,4,亞東-新竹,2024-05-16,2184
1727,中華化,4,0,4,亞東-新竹,2024-05-16,2184
2027,大成鋼,4,0,4,亞東-新竹,2024-05-16,2184
2481,強茂,4,0,4,亞東-新竹,2024-05-16,2184
6005,群益證,80,0,80,亞東-新竹,2024-05-17,2184
00878,國泰永續高股息,58,5,53,亞東-新竹,2024-05-17,2184
2367,燿華,56,5,51,亞東-新竹,2024-05-17,2184
2514,龍邦,49,0,49,亞東-新竹,2024-05-17,2184
2897,王道銀行,47,0,47,亞東-新竹,2024-05-17,2184
6770,力積電,52,5,47,亞東-新竹,2024-05-17,2184
00731,復華富時高息低波,44,0,44,亞東-新竹,2024-05-17,2184
00680L,元大美債20正2,44,4,40,亞東-新竹,2024-05-17,2184
5534,長虹,40,1,39,亞東-新竹,2024-05-17,2184
3287,廣寰科,37,1,36,亞東-新竹,2024-05-17,2184
4207,環泰,33,0,33,亞東-新竹,2024-05-17,2184
2882,國泰金,42,11,31,亞東-新竹,2024-05-17,2184
1785,光洋科,30,0,30,亞東-新竹,2024-05-17,2184
2383,台光電,25,2,23,亞東-新竹,2024-05-17,2184
00940,元大台灣價值高息,25,3,22,亞東-新竹,2024-05-17,2184
2489,瑞軒,21,0,21,亞東-新竹,2024-05-17,2184
3705,永信,25,6,19,亞東-新竹,2024-05-17,2184
2201,裕隆,24,7,17,亞東-新竹,2024-05-17,2184
00946,群益科技高息成長,14,0,14,亞東-新竹,2024-05-17,2184
4545,銘鈺,14,0,14,亞東-新竹,2024-05-17,2184
2241,艾姆勒,18,6,12,亞東-新竹,2024-05-17,2184
1442,名軒,11,0,11,亞東-新竹,2024-05-17,2184
1909,榮成,10,0,10,亞東-新竹,2024-05-17,2184
2903,遠百,10,0,10,亞東-新竹,2024-05-17,2184
00937B,群益ESG投等債20,15,6,9,亞東-新竹,2024-05-17,2184
00939,統一台灣高息動能,10,2,8,亞東-新竹,2024-05-17,2184
00919,群益台灣精選高息,8,0,8,亞東-新竹,2024-05-17,2184
2606,裕民,8,0,8,亞東-新竹,2024-05-17,2184
5498,凱崴,8,0,8,亞東-新竹,2024-05-17,2184
5522,遠雄,8,0,8,亞東-新竹,2024-05-17,2184
2317,鴻海,14,6,8,亞東-新竹,2024-05-17,2184
9904,寶成,8,1,7,亞東-新竹,2024-05-17,2184
3047,訊舟,56,50,6,亞東-新竹,2024-05-17,2184
3303,岱稜,10,4,6,亞東-新竹,2024-05-17,2184
5014,建錩,6,0,6,亞東-新竹,2024-05-17,2184
5234,達興材料,6,0,6,亞東-新竹,2024-05-17,2184
8227,巨有科技,6,0,6,亞東-新竹,2024-05-17,2184
00712,復華富時不動產,5,0,5,亞東-新竹,2024-05-17,2184
00795B,中信美國公債20年,5,0,5,亞東-新竹,2024-05-17,2184
2101,南港,5,0,5,亞東-新竹,2024-05-17,2184
2312,金寶,5,0,5,亞東-新竹,2024-05-17,2184
2313,華通,5,0,5,亞東-新竹,2024-05-17,2184
2324,仁寶,5,0,5,亞東-新竹,2024-05-17,2184
2427,三商電,5,0,5,亞東-新竹,2024-05-17,2184
9945,潤泰新,13,8,5,亞東-新竹,2024-05-17,2184
2376,技嘉,6,1,5,亞東-新竹,2024-05-17,2184
1326,台化,4,0,4,亞東-新竹,2024-05-17,2184
1316,上曜,4,0,4,亞東-新竹,2024-05-17,2184
1808,潤隆,8,4,4,亞東-新竹,2024-05-17,2184
2537,聯上發,5,1,4,亞東-新竹,2024-05-17,2184
6005,群益證,157,0,157,亞東-新竹,2024-05-20,2184
2882,國泰金,63,0,63,亞東-新竹,2024-05-20,2184
5014,建錩,40,0,40,亞東-新竹,2024-05-20,2184
00929,復華台灣科技優息,66,29,37,亞東-新竹,2024-05-20,2184
00937B,群益ESG投等債20,85,50,35,亞東-新竹,2024-05-20,2184
00940,元大台灣價值高息,47,16,31,亞東-新竹,2024-05-20,2184
2603,長榮,40,11,29,亞東-新竹,2024-05-20,2184
00918,大華優利高填息30,27,0,27,亞東-新竹,2024-05-20,2184
2618,長榮航,48,22,26,亞東-新竹,2024-05-20,2184
1608,華榮,56,33,23,亞東-新竹,2024-05-20,2184
9904,寶成,24,1,23,亞東-新竹,2024-05-20,2184
00946,群益科技高息成長,22,0,22,亞東-新竹,2024-05-20,2184
1815,富喬,31,10,21,亞東-新竹,2024-05-20,2184
2534,宏盛,20,0,20,亞東-新竹,2024-05-20,2184
00878,國泰永續高股息,19,0,19,亞東-新竹,2024-05-20,2184
00680L,元大美債20正2,17,0,17,亞東-新竹,2024-05-20,2184
2317,鴻海,24,8,16,亞東-新竹,2024-05-20,2184
00857B,永豐20年美公債,16,0,16,亞東-新竹,2024-05-20,2184
0056,元大高股息,17,2,15,亞東-新竹,2024-05-20,2184
3481,群創,12,0,12,亞東-新竹,2024-05-20,2184
4545,銘鈺,12,0,12,亞東-新竹,2024-05-20,2184
00690,兆豐藍籌30,11,0,11,亞東-新竹,2024-05-20,2184
5498,凱崴,11,0,11,亞東-新竹,2024-05-20,2184
3231,緯創,18,8,10,亞東-新竹,2024-05-20,2184
00665L,富邦�琤肭磪囓�2,10,0,10,亞東-新竹,2024-05-20,2184
4506,崇友,10,0,10,亞東-新竹,2024-05-20,2184
1612,宏泰,10,1,9,亞東-新竹,2024-05-20,2184
00900,富邦特選高股息30,8,0,8,亞東-新竹,2024-05-20,2184
2329,華泰,8,0,8,亞東-新竹,2024-05-20,2184
2481,強茂,7,0,7,亞東-新竹,2024-05-20,2184
3013,晟銘電,25,18,7,亞東-新竹,2024-05-20,2184
6188,廣明,15,8,7,亞東-新竹,2024-05-20,2184
9945,潤泰新,11,4,7,亞東-新竹,2024-05-20,2184
2357,華碩,7,0,7,亞東-新竹,2024-05-20,2184
00915,凱基優選高股息30,6,0,6,亞東-新竹,2024-05-20,2184
2881,富邦金,6,0,6,亞東-新竹,2024-05-20,2184
6698,旭暉應材,6,0,6,亞東-新竹,2024-05-20,2184
2330,台積電,6,1,5,亞東-新竹,2024-05-20,2184
00936,台新永續高息中小,5,0,5,亞東-新竹,2024-05-20,2184
00679B,元大美債20年,5,0,5,亞東-新竹,2024-05-20,2184
2367,燿華,23,18,5,亞東-新竹,2024-05-20,2184
2609,陽明,6,1,5,亞東-新竹,2024-05-20,2184
2634,漢翔,5,0,5,亞東-新竹,2024-05-20,2184
2903,遠百,5,0,5,亞東-新竹,2024-05-20,2184
3025,星通,5,0,5,亞東-新竹,2024-05-20,2184
4157,太景*-KY,5,0,5,亞東-新竹,2024-05-20,2184
6275,元山,5,0,5,亞東-新竹,2024-05-20,2184
6670,復盛應用,5,0,5,亞東-新竹,2024-05-20,2184
8096,擎亞,9,4,5,亞東-新竹,2024-05-20,2184
00905,FT臺灣Smart,4,0,4,亞東-新竹,2024-05-20,2184
2312,金寶,370,0,370,亞東-新竹,2024-05-21,2184
2883,凱基金,316,31,285,亞東-新竹,2024-05-21,2184
2882,國泰金,86,0,86,亞東-新竹,2024-05-21,2184
9945,潤泰新,82,4,78,亞東-新竹,2024-05-21,2184
00937B,群益ESG投等債20,74,0,74,亞東-新竹,2024-05-21,2184
2354,鴻準,55,11,44,亞東-新竹,2024-05-21,2184
00929,復華台灣科技優息,46,11,35,亞東-新竹,2024-05-21,2184
2890,永豐金,48,24,24,亞東-新竹,2024-05-21,2184
00878,國泰永續高股息,23,0,23,亞東-新竹,2024-05-21,2184
1314,中石化,23,0,23,亞東-新竹,2024-05-21,2184
3481,群創,21,0,21,亞東-新竹,2024-05-21,2184
00919,群益台灣精選高息,33,13,20,亞東-新竹,2024-05-21,2184
2314,台揚,20,0,20,亞東-新竹,2024-05-21,2184
6257,矽格,20,0,20,亞東-新竹,2024-05-21,2184
00940,元大台灣價值高息,24,5,19,亞東-新竹,2024-05-21,2184
3705,永信,17,0,17,亞東-新竹,2024-05-21,2184
2881,富邦金,16,0,16,亞東-新竹,2024-05-21,2184
1301,台塑,15,0,15,亞東-新竹,2024-05-21,2184
2618,長榮航,37,22,15,亞東-新竹,2024-05-21,2184
9958,世紀鋼,15,0,15,亞東-新竹,2024-05-21,2184
00882,中信中國高股息,13,1,12,亞東-新竹,2024-05-21,2184
3049,精金,12,0,12,亞東-新竹,2024-05-21,2184
2201,裕隆,14,3,11,亞東-新竹,2024-05-21,2184
2204,中華,11,0,11,亞東-新竹,2024-05-21,2184
2888,新光金,11,0,11,亞東-新竹,2024-05-21,2184
00939,統一台灣高息動能,10,0,10,亞東-新竹,2024-05-21,2184
00712,復華富時不動產,10,0,10,亞東-新竹,2024-05-21,2184
00665L,富邦�琤肭磪囓�2,10,0,10,亞東-新竹,2024-05-21,2184
2360,致茂,10,0,10,亞東-新竹,2024-05-21,2184
2534,宏盛,10,0,10,亞東-新竹,2024-05-21,2184
4562,穎漢,9,0,9,亞東-新竹,2024-05-21,2184
1808,潤隆,8,0,8,亞東-新竹,2024-05-21,2184
2009,第一銅,12,4,8,亞東-新竹,2024-05-21,2184
3702,大聯大,8,0,8,亞東-新竹,2024-05-21,2184
3338,泰碩,11,3,8,亞東-新竹,2024-05-21,2184
2615,萬海,9,1,8,亞東-新竹,2024-05-21,2184
8150,南茂,7,0,7,亞東-新竹,2024-05-21,2184
00680L,元大美債20正2,6,0,6,亞東-新竹,2024-05-21,2184
00679B,元大美債20年,6,0,6,亞東-新竹,2024-05-21,2184
2020,美亞,6,0,6,亞東-新竹,2024-05-21,2184
2323,中環,20,14,6,亞東-新竹,2024-05-21,2184
2891,中信金,7,1,6,亞東-新竹,2024-05-21,2184
3021,鴻名,6,0,6,亞東-新竹,2024-05-21,2184
3038,全台,6,0,6,亞東-新竹,2024-05-21,2184
4114,健喬,6,0,6,亞東-新竹,2024-05-21,2184
5531,鄉林,6,0,6,亞東-新竹,2024-05-21,2184
6505,台塑化,6,0,6,亞東-新竹,2024-05-21,2184
6550,北極星藥業-KY,6,0,6,亞東-新竹,2024-05-21,2184
8390,金益鼎,6,0,6,亞東-新竹,2024-05-21,2184
0056,元大高股息,8,3,5,亞東-新竹,2024-05-21,2184
2303,聯電,125,47,78,亞東-新竹,2024-05-22,2184
2882,國泰金,82,20,62,亞東-新竹,2024-05-22,2184
2515,中工,50,0,50,亞東-新竹,2024-05-22,2184
2367,燿華,52,4,48,亞東-新竹,2024-05-22,2184
2890,永豐金,49,6,43,亞東-新竹,2024-05-22,2184
4909,新復興,40,0,40,亞東-新竹,2024-05-22,2184
2618,長榮航,56,26,30,亞東-新竹,2024-05-22,2184
1216,統一,24,1,23,亞東-新竹,2024-05-22,2184
1319,東陽,22,0,22,亞東-新竹,2024-05-22,2184
3059,華晶科,27,6,21,亞東-新竹,2024-05-22,2184
3481,群創,39,19,20,亞東-新竹,2024-05-22,2184
3356,奇偶,15,0,15,亞東-新竹,2024-05-22,2184
6125,廣運,20,7,13,亞東-新竹,2024-05-22,2184
2884,玉山金,11,0,11,亞東-新竹,2024-05-22,2184
9945,潤泰新,21,10,11,亞東-新竹,2024-05-22,2184
00679B,元大美債20年,11,1,10,亞東-新竹,2024-05-22,2184
2204,中華,10,0,10,亞東-新竹,2024-05-22,2184
3163,波若威,11,1,10,亞東-新竹,2024-05-22,2184
2392,正崴,10,1,9,亞東-新竹,2024-05-22,2184
3321,同泰,9,0,9,亞東-新竹,2024-05-22,2184
8096,擎亞,25,16,9,亞東-新竹,2024-05-22,2184
8110,華東,10,1,9,亞東-新竹,2024-05-22,2184
9946,三發地產,9,0,9,亞東-新竹,2024-05-22,2184
00753L,中信中國50正2,8,0,8,亞東-新竹,2024-05-22,2184
3047,訊舟,12,4,8,亞東-新竹,2024-05-22,2184
2505,國揚,7,0,7,亞東-新竹,2024-05-22,2184
8064,東捷,10,3,7,亞東-新竹,2024-05-22,2184
1316,上曜,6,0,6,亞東-新竹,2024-05-22,2184
2354,鴻準,15,9,6,亞東-新竹,2024-05-22,2184
3479,安勤,6,0,6,亞東-新竹,2024-05-22,2184
4128,中天,6,0,6,亞東-新竹,2024-05-22,2184
6188,廣明,20,14,6,亞東-新竹,2024-05-22,2184
1608,華榮,8,3,5,亞東-新竹,2024-05-22,2184
00939,統一台灣高息動能,10,5,5,亞東-新竹,2024-05-22,2184
0061,元大寶滬深,5,0,5,亞東-新竹,2024-05-22,2184
2329,華泰,5,0,5,亞東-新竹,2024-05-22,2184
2369,菱生,5,0,5,亞東-新竹,2024-05-22,2184
2486,一詮,7,2,5,亞東-新竹,2024-05-22,2184
2534,宏盛,5,0,5,亞東-新竹,2024-05-22,2184
3346,麗清,5,0,5,亞東-新竹,2024-05-22,2184
4142,國光生,5,0,5,亞東-新竹,2024-05-22,2184
6282,康舒,5,0,5,亞東-新竹,2024-05-22,2184
6547,高端疫苗,5,0,5,亞東-新竹,2024-05-22,2184
9924,福興,5,0,5,亞東-新竹,2024-05-22,2184
2609,陽明,5,1,4,亞東-新竹,2024-05-22,2184
2417,圓剛,5,1,4,亞東-新竹,2024-05-22,2184
3363,上詮,7,3,4,亞東-新竹,2024-05-22,2184
6753,龍德造船,4,0,4,亞東-新竹,2024-05-22,2184
6257,矽格,4,0,4,亞東-新竹,2024-05-22,2184
00722B,群益投資級電信債,3,0,3,亞東-新竹,2024-05-22,2184
00679B,元大美債20年,110,0,110,亞東-新竹,2024-05-23,2184
00937B,群益ESG投等債20,108,0,108,亞東-新竹,2024-05-23,2184
2002,中鋼,74,0,74,亞東-新竹,2024-05-23,2184
1815,富喬,65,6,59,亞東-新竹,2024-05-23,2184
2618,長榮航,75,17,58,亞東-新竹,2024-05-23,2184
2882,國泰金,49,1,48,亞東-新竹,2024-05-23,2184
3339,泰谷,30,0,30,亞東-新竹,2024-05-23,2184
6165,浪凡,30,0,30,亞東-新竹,2024-05-23,2184
3006,晶豪科,29,3,26,亞東-新竹,2024-05-23,2184
00753L,中信中國50正2,28,5,23,亞東-新竹,2024-05-23,2184
1560,中砂,20,0,20,亞東-新竹,2024-05-23,2184
5498,凱崴,20,0,20,亞東-新竹,2024-05-23,2184
2912,統一超,14,0,14,亞東-新竹,2024-05-23,2184
00751B,元大AAA至A公司債,13,0,13,亞東-新竹,2024-05-23,2184
4533,協易機,12,0,12,亞東-新竹,2024-05-23,2184
2359,所羅門,52,41,11,亞東-新竹,2024-05-23,2184
2427,三商電,21,10,11,亞東-新竹,2024-05-23,2184
00680L,元大美債20正2,10,0,10,亞東-新竹,2024-05-23,2184
2888,新光金,10,0,10,亞東-新竹,2024-05-23,2184
3049,精金,10,0,10,亞東-新竹,2024-05-23,2184
6753,龍德造船,10,0,10,亞東-新竹,2024-05-23,2184
8064,東捷,14,4,10,亞東-新竹,2024-05-23,2184
8476,台境*,10,0,10,亞東-新竹,2024-05-23,2184
6147,頎邦,9,0,9,亞東-新竹,2024-05-23,2184
1608,華榮,9,0,9,亞東-新竹,2024-05-23,2184
9945,潤泰新,14,5,9,亞東-新竹,2024-05-23,2184
2610,華航,8,0,8,亞東-新竹,2024-05-23,2184
4563,百德,8,0,8,亞東-新竹,2024-05-23,2184
4919,新唐,8,0,8,亞東-新竹,2024-05-23,2184
1303,南亞,12,5,7,亞東-新竹,2024-05-23,2184
4105,東洋,7,0,7,亞東-新竹,2024-05-23,2184
2516,新建,7,0,7,亞東-新竹,2024-05-23,2184
3202,樺晟,7,0,7,亞東-新竹,2024-05-23,2184
8033,雷虎,11,4,7,亞東-新竹,2024-05-23,2184
2892,第一金,6,0,6,亞東-新竹,2024-05-23,2184
00936,台新永續高息中小,6,0,6,亞東-新竹,2024-05-23,2184
1324,地球,6,0,6,亞東-新竹,2024-05-23,2184
1808,潤隆,10,4,6,亞東-新竹,2024-05-23,2184
2867,三商壽,6,0,6,亞東-新竹,2024-05-23,2184
6698,旭暉應材,6,0,6,亞東-新竹,2024-05-23,2184
2353,宏��,80,74,6,亞東-新竹,2024-05-23,2184
2357,華碩,6,0,6,亞東-新竹,2024-05-23,2184
00939,統一台灣高息動能,5,0,5,亞東-新竹,2024-05-23,2184
0061,元大寶滬深,5,0,5,亞東-新竹,2024-05-23,2184
00878,國泰永續高股息,8,3,5,亞東-新竹,2024-05-23,2184
1312,國喬,5,0,5,亞東-新竹,2024-05-23,2184
1536,和大,5,0,5,亞東-新竹,2024-05-23,2184
2049,上銀,5,0,5,亞東-新竹,2024-05-23,2184
2851,中再保,5,0,5,亞東-新竹,2024-05-23,2184
2903,遠百,5,0,5,亞東-新竹,2024-05-23,2184
2344,華邦電,120,0,120,亞東-新竹,2024-05-24,2184
6770,力積電,68,0,68,亞東-新竹,2024-05-24,2184
6005,群益證,50,1,49,亞東-新竹,2024-05-24,2184
6125,廣運,61,13,48,亞東-新竹,2024-05-24,2184
00712,復華富時不動產,46,0,46,亞東-新竹,2024-05-24,2184
1810,和成,35,1,34,亞東-新竹,2024-05-24,2184
2354,鴻準,40,7,33,亞東-新竹,2024-05-24,2184
2611,志信,30,0,30,亞東-新竹,2024-05-24,2184
2891,中信金,33,6,27,亞東-新竹,2024-05-24,2184
2303,聯電,43,22,21,亞東-新竹,2024-05-24,2184
00681R,元大美債20反1,21,0,21,亞東-新竹,2024-05-24,2184
00642U,期元大S＆P石油,20,0,20,亞東-新竹,2024-05-24,2184
00753L,中信中國50正2,20,0,20,亞東-新竹,2024-05-24,2184
6589,台康生技,20,0,20,亞東-新竹,2024-05-24,2184
1809,中釉,20,1,19,亞東-新竹,2024-05-24,2184
00882,中信中國高股息,18,0,18,亞東-新竹,2024-05-24,2184
1815,富喬,21,3,18,亞東-新竹,2024-05-24,2184
2353,宏��,26,8,18,亞東-新竹,2024-05-24,2184
2367,燿華,20,3,17,亞東-新竹,2024-05-24,2184
00679B,元大美債20年,16,0,16,亞東-新竹,2024-05-24,2184
2542,興富發,15,0,15,亞東-新竹,2024-05-24,2184
00915,凱基優選高股息30,13,0,13,亞東-新竹,2024-05-24,2184
2610,華航,18,5,13,亞東-新竹,2024-05-24,2184
6117,迎廣,24,11,13,亞東-新竹,2024-05-24,2184
1720,生達,12,0,12,亞東-新竹,2024-05-24,2184
00940,元大台灣價值高息,11,0,11,亞東-新竹,2024-05-24,2184
2486,一詮,34,23,11,亞東-新竹,2024-05-24,2184
3312,弘憶股,11,0,11,亞東-新竹,2024-05-24,2184
2884,玉山金,10,0,10,亞東-新竹,2024-05-24,2184
00700,富邦�琤肭磪�,10,0,10,亞東-新竹,2024-05-24,2184
2888,新光金,10,0,10,亞東-新竹,2024-05-24,2184
3006,晶豪科,14,4,10,亞東-新竹,2024-05-24,2184
3021,鴻名,10,0,10,亞東-新竹,2024-05-24,2184
6197,佳必琪,10,0,10,亞東-新竹,2024-05-24,2184
00937B,群益ESG投等債20,9,0,9,亞東-新竹,2024-05-24,2184
2505,國揚,8,0,8,亞東-新竹,2024-05-24,2184
2605,新興,7,0,7,亞東-新竹,2024-05-24,2184
1312,國喬,6,0,6,亞東-新竹,2024-05-24,2184
2392,正崴,8,3,5,亞東-新竹,2024-05-24,2184
3260,威剛,13,8,5,亞東-新竹,2024-05-24,2184
3545,敦泰,7,2,5,亞東-新竹,2024-05-24,2184
3702,大聯大,5,0,5,亞東-新竹,2024-05-24,2184
5371,中光電,6,1,5,亞東-新竹,2024-05-24,2184
6443,元晶,5,0,5,亞東-新竹,2024-05-24,2184
00941,中信上游半導體,4,0,4,亞東-新竹,2024-05-24,2184
1316,上曜,4,0,4,亞東-新竹,2024-05-24,2184
1324,地球,4,0,4,亞東-新竹,2024-05-24,2184
2399,映泰,4,0,4,亞東-新竹,2024-05-24,2184
3034,聯詠,5,1,4,亞東-新竹,2024-05-24,2184
6526,達發,5,1,4,亞東-新竹,2024-05-24,2184
00919,群益台灣精選高息,98,40,58,亞東-新竹,2024-05-27,2184
00751B,元大AAA至A公司債,50,0,50,亞東-新竹,2024-05-27,2184
2915,潤泰全,41,0,41,亞東-新竹,2024-05-27,2184
3580,友威科,26,0,26,亞東-新竹,2024-05-27,2184
00712,復華富時不動產,24,0,24,亞東-新竹,2024-05-27,2184
2363,矽統,44,22,22,亞東-新竹,2024-05-27,2184
1611,中電,20,0,20,亞東-新竹,2024-05-27,2184
1905,華紙,20,0,20,亞東-新竹,2024-05-27,2184
5225,東科-KY,20,0,20,亞東-新竹,2024-05-27,2184
2606,裕民,20,1,19,亞東-新竹,2024-05-27,2184
1522,堤維西,19,2,17,亞東-新竹,2024-05-27,2184
2618,長榮航,29,16,13,亞東-新竹,2024-05-27,2184
4908,前鼎,15,2,13,亞東-新竹,2024-05-27,2184
3083,網龍,12,0,12,亞東-新竹,2024-05-27,2184
00700,富邦�琤肭磪�,10,0,10,亞東-新竹,2024-05-27,2184
00687B,國泰20年美債,10,0,10,亞東-新竹,2024-05-27,2184
00753L,中信中國50正2,12,2,10,亞東-新竹,2024-05-27,2184
2633,台灣高鐵,10,0,10,亞東-新竹,2024-05-27,2184
2867,三商壽,10,0,10,亞東-新竹,2024-05-27,2184
6126,信音,10,0,10,亞東-新竹,2024-05-27,2184
9921,巨大,10,0,10,亞東-新竹,2024-05-27,2184
1720,生達,9,0,9,亞東-新竹,2024-05-27,2184
1314,中石化,8,0,8,亞東-新竹,2024-05-27,2184
2449,京元電子,8,0,8,亞東-新竹,2024-05-27,2184
3234,光環,11,3,8,亞東-新竹,2024-05-27,2184
3231,緯創,18,12,6,亞東-新竹,2024-05-27,2184
00937B,群益ESG投等債20,6,0,6,亞東-新竹,2024-05-27,2184
00936,台新永續高息中小,6,0,6,亞東-新竹,2024-05-27,2184
00935,野村臺灣新科技50,6,0,6,亞東-新竹,2024-05-27,2184
3163,波若威,6,0,6,亞東-新竹,2024-05-27,2184
6117,迎廣,13,7,6,亞東-新竹,2024-05-27,2184
2330,台積電,5,0,5,亞東-新竹,2024-05-27,2184
1402,遠東新,5,0,5,亞東-新竹,2024-05-27,2184
2352,佳世達,5,0,5,亞東-新竹,2024-05-27,2184
2912,統一超,5,0,5,亞東-新竹,2024-05-27,2184
3227,原相,5,0,5,亞東-新竹,2024-05-27,2184
3363,上詮,6,1,5,亞東-新竹,2024-05-27,2184
5371,中光電,12,7,5,亞東-新竹,2024-05-27,2184
5498,凱崴,6,1,5,亞東-新竹,2024-05-27,2184
8255,朋程,5,0,5,亞東-新竹,2024-05-27,2184
8358,金居,5,0,5,亞東-新竹,2024-05-27,2184
2489,瑞軒,5,0,5,亞東-新竹,2024-05-27,2184
2543,皇昌,4,0,4,亞東-新竹,2024-05-27,2184
3587,閎康,5,1,4,亞東-新竹,2024-05-27,2184
4303,信立,5,1,4,亞東-新竹,2024-05-27,2184
6147,頎邦,4,0,4,亞東-新竹,2024-05-27,2184
2308,台達電,5,1,4,亞東-新竹,2024-05-27,2184
1101,台泥,3,0,3,亞東-新竹,2024-05-27,2184
00724B,群益投資級金融債,3,0,3,亞東-新竹,2024-05-27,2184
3653,健策,3,0,3,亞東-新竹,2024-05-27,2184
00937B,群益ESG投等債20,160,0,160,亞東-新竹,2024-05-28,2184
1605,華新,79,3,76,亞東-新竹,2024-05-28,2184
2915,潤泰全,76,0,76,亞東-新竹,2024-05-28,2184
2891,中信金,40,2,38,亞東-新竹,2024-05-28,2184
1815,富喬,43,8,35,亞東-新竹,2024-05-28,2184
00940,元大台灣價值高息,51,20,31,亞東-新竹,2024-05-28,2184
2486,一詮,35,8,27,亞東-新竹,2024-05-28,2184
6282,康舒,30,3,27,亞東-新竹,2024-05-28,2184
2367,燿華,35,10,25,亞東-新竹,2024-05-28,2184
6188,廣明,30,5,25,亞東-新竹,2024-05-28,2184
6265,方土昶,25,0,25,亞東-新竹,2024-05-28,2184
2313,華通,25,1,24,亞東-新竹,2024-05-28,2184
9945,潤泰新,25,1,24,亞東-新竹,2024-05-28,2184
00679B,元大美債20年,22,0,22,亞東-新竹,2024-05-28,2184
2611,志信,20,0,20,亞東-新竹,2024-05-28,2184
2353,宏��,30,11,19,亞東-新竹,2024-05-28,2184
3035,智原,29,12,17,亞東-新竹,2024-05-28,2184
2427,三商電,15,0,15,亞東-新竹,2024-05-28,2184
2912,統一超,15,0,15,亞東-新竹,2024-05-28,2184
8054,安國,21,9,12,亞東-新竹,2024-05-28,2184
5227,立凱-KY,11,0,11,亞東-新竹,2024-05-28,2184
00700,富邦�琤肭磪�,10,0,10,亞東-新竹,2024-05-28,2184
2201,裕隆,18,8,10,亞東-新竹,2024-05-28,2184
3006,晶豪科,10,0,10,亞東-新竹,2024-05-28,2184
3021,鴻名,14,4,10,亞東-新竹,2024-05-28,2184
6443,元晶,10,0,10,亞東-新竹,2024-05-28,2184
6719,力智,10,0,10,亞東-新竹,2024-05-28,2184
3163,波若威,10,1,9,亞東-新竹,2024-05-28,2184
5340,建榮,9,0,9,亞東-新竹,2024-05-28,2184
6197,佳必琪,9,0,9,亞東-新竹,2024-05-28,2184
2603,長榮,16,8,8,亞東-新竹,2024-05-28,2184
00915,凱基優選高股息30,8,0,8,亞東-新竹,2024-05-28,2184
3260,威剛,8,0,8,亞東-新竹,2024-05-28,2184
2421,建準,11,4,7,亞東-新竹,2024-05-28,2184
2884,玉山金,7,0,7,亞東-新竹,2024-05-28,2184
00882,中信中國高股息,6,0,6,亞東-新竹,2024-05-28,2184
2809,京城銀,9,3,6,亞東-新竹,2024-05-28,2184
00712,復華富時不動產,12,6,6,亞東-新竹,2024-05-28,2184
2301,光寶科,16,10,6,亞東-新竹,2024-05-28,2184
5392,能率,6,0,6,亞東-新竹,2024-05-28,2184
1316,上曜,5,0,5,亞東-新竹,2024-05-28,2184
2328,廣宇,5,0,5,亞東-新竹,2024-05-28,2184
2476,鉅祥,5,0,5,亞東-新竹,2024-05-28,2184
2505,國揚,5,0,5,亞東-新竹,2024-05-28,2184
2607,榮運,6,1,5,亞東-新竹,2024-05-28,2184
8401,白紗科,5,0,5,亞東-新竹,2024-05-28,2184
1522,堤維西,7,2,5,亞東-新竹,2024-05-28,2184
00680L,元大美債20正2,4,0,4,亞東-新竹,2024-05-28,2184
1513,中興電,4,0,4,亞東-新竹,2024-05-28,2184
2374,佳能,6,2,4,亞東-新竹,2024-05-28,2184
00937B,群益ESG投等債20,264,0,264,亞東-新竹,2024-05-29,2184
2610,華航,235,20,215,亞東-新竹,2024-05-29,2184
00679B,元大美債20年,122,0,122,亞東-新竹,2024-05-29,2184
00751B,元大AAA至A公司債,81,0,81,亞東-新竹,2024-05-29,2184
6548,長科*,75,0,75,亞東-新竹,2024-05-29,2184
2353,宏��,77,28,49,亞東-新竹,2024-05-29,2184
3537,堡達,31,0,31,亞東-新竹,2024-05-29,2184
3481,群創,32,1,31,亞東-新竹,2024-05-29,2184
2317,鴻海,35,4,31,亞東-新竹,2024-05-29,2184
2882,國泰金,29,0,29,亞東-新竹,2024-05-29,2184
4958,臻鼎-KY,26,0,26,亞東-新竹,2024-05-29,2184
3356,奇偶,23,2,21,亞東-新竹,2024-05-29,2184
2603,長榮,22,1,21,亞東-新竹,2024-05-29,2184
8011,台通,20,0,20,亞東-新竹,2024-05-29,2184
3306,鼎天,19,0,19,亞東-新竹,2024-05-29,2184
00680L,元大美債20正2,18,0,18,亞東-新竹,2024-05-29,2184
00940,元大台灣價值高息,17,0,17,亞東-新竹,2024-05-29,2184
1210,大成,20,3,17,亞東-新竹,2024-05-29,2184
1316,上曜,17,0,17,亞東-新竹,2024-05-29,2184
6209,今國光,22,5,17,亞東-新竹,2024-05-29,2184
2891,中信金,20,5,15,亞東-新竹,2024-05-29,2184
2890,永豐金,17,2,15,亞東-新竹,2024-05-29,2184
1609,大亞,15,0,15,亞東-新竹,2024-05-29,2184
1802,台玻,15,0,15,亞東-新竹,2024-05-29,2184
1815,富喬,33,18,15,亞東-新竹,2024-05-29,2184
2049,上銀,15,0,15,亞東-新竹,2024-05-29,2184
3576,聯合再生,15,0,15,亞東-新竹,2024-05-29,2184
6190,萬泰科,14,0,14,亞東-新竹,2024-05-29,2184
2324,仁寶,13,0,13,亞東-新竹,2024-05-29,2184
1303,南亞,12,1,11,亞東-新竹,2024-05-29,2184
00753L,中信中國50正2,21,10,11,亞東-新竹,2024-05-29,2184
2464,盟立,13,2,11,亞東-新竹,2024-05-29,2184
3260,威剛,15,4,11,亞東-新竹,2024-05-29,2184
00946,群益科技高息成長,10,0,10,亞東-新竹,2024-05-29,2184
1529,樂事綠能,10,0,10,亞東-新竹,2024-05-29,2184
2419,仲琦,10,0,10,亞東-新竹,2024-05-29,2184
2633,台灣高鐵,10,0,10,亞東-新竹,2024-05-29,2184
2897,王道銀行,10,0,10,亞東-新竹,2024-05-29,2184
4105,東洋,10,0,10,亞東-新竹,2024-05-29,2184
8096,擎亞,10,0,10,亞東-新竹,2024-05-29,2184
8277,商丞,10,0,10,亞東-新竹,2024-05-29,2184
00687B,國泰20年美債,9,0,9,亞東-新竹,2024-05-29,2184
2388,威盛,10,1,9,亞東-新竹,2024-05-29,2184
2884,玉山金,11,2,9,亞東-新竹,2024-05-29,2184
4714,永捷,9,0,9,亞東-新竹,2024-05-29,2184
8071,能率網通,10,1,9,亞東-新竹,2024-05-29,2184
2303,聯電,34,26,8,亞東-新竹,2024-05-29,2184
3231,緯創,18,10,8,亞東-新竹,2024-05-29,2184
00857B,永豐20年美公債,8,0,8,亞東-新竹,2024-05-29,2184
2605,新興,11,3,8,亞東-新竹,2024-05-29,2184
00937B,群益ESG投等債20,162,1,161,亞東-新竹,2024-05-30,2184
6770,力積電,59,0,59,亞東-新竹,2024-05-30,2184
6269,台郡,45,0,45,亞東-新竹,2024-05-30,2184
00680L,元大美債20正2,40,0,40,亞東-新竹,2024-05-30,2184
00940,元大台灣價值高息,33,0,33,亞東-新竹,2024-05-30,2184
3537,堡達,29,0,29,亞東-新竹,2024-05-30,2184
00751B,元大AAA至A公司債,27,0,27,亞東-新竹,2024-05-30,2184
2317,鴻海,39,12,27,亞東-新竹,2024-05-30,2184
3035,智原,43,18,25,亞東-新竹,2024-05-30,2184
00753L,中信中國50正2,25,2,23,亞東-新竹,2024-05-30,2184
2405,輔信,22,0,22,亞東-新竹,2024-05-30,2184
00720B,元大投資級公司債,21,0,21,亞東-新竹,2024-05-30,2184
00882,中信中國高股息,20,0,20,亞東-新竹,2024-05-30,2184
00671R,富邦NASDAQ反1,20,0,20,亞東-新竹,2024-05-30,2184
2606,裕民,24,5,19,亞東-新竹,2024-05-30,2184
3033,威健,20,1,19,亞東-新竹,2024-05-30,2184
8096,擎亞,20,3,17,亞東-新竹,2024-05-30,2184
00712,復華富時不動產,15,0,15,亞東-新竹,2024-05-30,2184
6190,萬泰科,15,0,15,亞東-新竹,2024-05-30,2184
2891,中信金,14,0,14,亞東-新竹,2024-05-30,2184
00679B,元大美債20年,14,0,14,亞東-新竹,2024-05-30,2184
6788,華景電,14,0,14,亞東-新竹,2024-05-30,2184
5251,天鉞電,13,0,13,亞東-新竹,2024-05-30,2184
006208,富邦台50,12,0,12,亞東-新竹,2024-05-30,2184
00915,凱基優選高股息30,11,0,11,亞東-新竹,2024-05-30,2184
2603,長榮,32,21,11,亞東-新竹,2024-05-30,2184
3338,泰碩,16,5,11,亞東-新竹,2024-05-30,2184
3260,威剛,18,8,10,亞東-新竹,2024-05-30,2184
00936,台新永續高息中小,10,0,10,亞東-新竹,2024-05-30,2184
00665L,富邦�琤肭磪囓�2,10,0,10,亞東-新竹,2024-05-30,2184
00632R,元大台灣50反1,10,0,10,亞東-新竹,2024-05-30,2184
2408,南亞科,10,0,10,亞東-新竹,2024-05-30,2184
2886,兆豐金,9,0,9,亞東-新竹,2024-05-30,2184
2002,中鋼,9,0,9,亞東-新竹,2024-05-30,2184
3339,泰谷,9,0,9,亞東-新竹,2024-05-30,2184
4147,中裕,10,1,9,亞東-新竹,2024-05-30,2184
3481,群創,16,7,9,亞東-新竹,2024-05-30,2184
0056,元大高股息,23,15,8,亞東-新竹,2024-05-30,2184
3356,奇偶,8,0,8,亞東-新竹,2024-05-30,2184
2353,宏��,21,13,8,亞東-新竹,2024-05-30,2184
6117,迎廣,13,5,8,亞東-新竹,2024-05-30,2184
6220,岳豐,8,0,8,亞東-新竹,2024-05-30,2184
6443,元晶,9,1,8,亞東-新竹,2024-05-30,2184
1303,南亞,8,0,8,亞東-新竹,2024-05-30,2184
00918,大華優利高填息30,7,0,7,亞東-新竹,2024-05-30,2184
2618,長榮航,21,14,7,亞東-新竹,2024-05-30,2184
2892,第一金,7,0,7,亞東-新竹,2024-05-30,2184
2357,華碩,7,0,7,亞東-新竹,2024-05-30,2184
2801,彰銀,7,0,7,亞東-新竹,2024-05-30,2184
3005,神基,7,0,7,亞東-新竹,2024-05-30,2184
00929,復華台灣科技優息,129,0,129,亞東-新竹,2024-05-31,2184
1316,上曜,40,0,40,亞東-新竹,2024-05-31,2184
1442,名軒,40,0,40,亞東-新竹,2024-05-31,2184
2809,京城銀,39,0,39,亞東-新竹,2024-05-31,2184
1453,大將,43,9,34,亞東-新竹,2024-05-31,2184
00919,群益台灣精選高息,38,7,31,亞東-新竹,2024-05-31,2184
2527,宏璟,30,0,30,亞東-新竹,2024-05-31,2184
00940,元大台灣價值高息,29,1,28,亞東-新竹,2024-05-31,2184
2603,長榮,31,10,21,亞東-新竹,2024-05-31,2184
2609,陽明,36,15,21,亞東-新竹,2024-05-31,2184
8071,能率網通,20,0,20,亞東-新竹,2024-05-31,2184
3339,泰谷,24,5,19,亞東-新竹,2024-05-31,2184
2382,廣達,19,1,18,亞東-新竹,2024-05-31,2184
2392,正崴,15,0,15,亞東-新竹,2024-05-31,2184
4908,前鼎,14,0,14,亞東-新竹,2024-05-31,2184
2634,漢翔,14,1,13,亞東-新竹,2024-05-31,2184
2338,光罩,15,3,12,亞東-新竹,2024-05-31,2184
00878,國泰永續高股息,14,2,12,亞東-新竹,2024-05-31,2184
3006,晶豪科,13,2,11,亞東-新竹,2024-05-31,2184
00882,中信中國高股息,10,0,10,亞東-新竹,2024-05-31,2184
00751B,元大AAA至A公司債,10,0,10,亞東-新竹,2024-05-31,2184
00642U,期元大S＆P石油,10,0,10,亞東-新竹,2024-05-31,2184
1809,中釉,10,0,10,亞東-新竹,2024-05-31,2184
2597,潤弘,10,0,10,亞東-新竹,2024-05-31,2184
3041,揚智,10,0,10,亞東-新竹,2024-05-31,2184
3037,欣興,10,1,9,亞東-新竹,2024-05-31,2184
6239,力成,13,5,8,亞東-新竹,2024-05-31,2184
1102,亞泥,9,2,7,亞東-新竹,2024-05-31,2184
2486,一詮,12,5,7,亞東-新竹,2024-05-31,2184
5230,雷笛克光學,7,0,7,亞東-新竹,2024-05-31,2184
5251,天鉞電,7,0,7,亞東-新竹,2024-05-31,2184
2303,聯電,26,20,6,亞東-新竹,2024-05-31,2184
2891,中信金,14,8,6,亞東-新竹,2024-05-31,2184
2230,泰茂,6,0,6,亞東-新竹,2024-05-31,2184
2313,華通,6,0,6,亞東-新竹,2024-05-31,2184
2367,燿華,8,2,6,亞東-新竹,2024-05-31,2184
3014,聯陽,6,0,6,亞東-新竹,2024-05-31,2184
2330,台積電,8,2,6,亞東-新竹,2024-05-31,2184
6290,良維,5,0,5,亞東-新竹,2024-05-31,2184
2002,中鋼,7,2,5,亞東-新竹,2024-05-31,2184
0056,元大高股息,17,12,5,亞東-新竹,2024-05-31,2184
00681R,元大美債20反1,5,0,5,亞東-新竹,2024-05-31,2184
00757,統一FANG+,5,0,5,亞東-新竹,2024-05-31,2184
1615,大山,5,0,5,亞東-新竹,2024-05-31,2184
4533,協易機,5,0,5,亞東-新竹,2024-05-31,2184
5371,中光電,7,2,5,亞東-新竹,2024-05-31,2184
8096,擎亞,5,0,5,亞東-新竹,2024-05-31,2184
8255,朋程,5,0,5,亞東-新竹,2024-05-31,2184
3661,世芯-KY,5,0,5,亞東-新竹,2024-05-31,2184
6125,廣運,5,0,5,亞東-新竹,2024-05-31,2184
2618,長榮航,68,6,62,亞東-新竹,2024-06-03,2184
00937B,群益ESG投等債20,62,5,57,亞東-新竹,2024-06-03,2184
2809,京城銀,54,1,53,亞東-新竹,2024-06-03,2184
6005,群益證,59,10,49,亞東-新竹,2024-06-03,2184
9904,寶成,31,0,31,亞東-新竹,2024-06-03,2184
00919,群益台灣精選高息,40,10,30,亞東-新竹,2024-06-03,2184
4533,協易機,30,0,30,亞東-新竹,2024-06-03,2184
00632R,元大台灣50反1,25,5,20,亞東-新竹,2024-06-03,2184
1815,富喬,31,12,19,亞東-新竹,2024-06-03,2184
2905,三商,18,0,18,亞東-新竹,2024-06-03,2184
2105,正新,16,0,16,亞東-新竹,2024-06-03,2184
6188,廣明,17,1,16,亞東-新竹,2024-06-03,2184
8163,達方,16,0,16,亞東-新竹,2024-06-03,2184
00687B,國泰20年美債,15,0,15,亞東-新竹,2024-06-03,2184
3224,三顧,15,0,15,亞東-新竹,2024-06-03,2184
6443,元晶,17,2,15,亞東-新竹,2024-06-03,2184
1453,大將,17,3,14,亞東-新竹,2024-06-03,2184
2353,宏��,24,10,14,亞東-新竹,2024-06-03,2184
2527,宏璟,12,0,12,亞東-新竹,2024-06-03,2184
2354,鴻準,29,18,11,亞東-新竹,2024-06-03,2184
2365,昆盈,11,0,11,亞東-新竹,2024-06-03,2184
1445,大宇,10,0,10,亞東-新竹,2024-06-03,2184
00795B,中信美國公債20年,10,0,10,亞東-新竹,2024-06-03,2184
2597,潤弘,10,0,10,亞東-新竹,2024-06-03,2184
4167,松瑞藥,10,0,10,亞東-新竹,2024-06-03,2184
9105,泰金寶-DR,10,0,10,亞東-新竹,2024-06-03,2184
1784,訊聯,11,2,9,亞東-新竹,2024-06-03,2184
2886,兆豐金,14,5,9,亞東-新竹,2024-06-03,2184
3189,景碩,9,0,9,亞東-新竹,2024-06-03,2184
00918,大華優利高填息30,13,5,8,亞東-新竹,2024-06-03,2184
2317,鴻海,26,18,8,亞東-新竹,2024-06-03,2184
4147,中裕,11,3,8,亞東-新竹,2024-06-03,2184
3576,聯合再生,7,0,7,亞東-新竹,2024-06-03,2184
6113,亞矽,7,0,7,亞東-新竹,2024-06-03,2184
00929,復華台灣科技優息,6,0,6,亞東-新竹,2024-06-03,2184
00679B,元大美債20年,6,0,6,亞東-新竹,2024-06-03,2184
2374,佳能,12,6,6,亞東-新竹,2024-06-03,2184
1440,南紡,5,0,5,亞東-新竹,2024-06-03,2184
3167,大量,5,0,5,亞東-新竹,2024-06-03,2184
8105,凌巨,5,0,5,亞東-新竹,2024-06-03,2184
8110,華東,5,0,5,亞東-新竹,2024-06-03,2184
1101,台泥,4,0,4,亞東-新竹,2024-06-03,2184
1727,中華化,4,0,4,亞東-新竹,2024-06-03,2184
1808,潤隆,4,0,4,亞東-新竹,2024-06-03,2184
3035,智原,12,8,4,亞東-新竹,2024-06-03,2184
3047,訊舟,5,1,4,亞東-新竹,2024-06-03,2184
4105,東洋,4,0,4,亞東-新竹,2024-06-03,2184
8147,正淩,4,0,4,亞東-新竹,2024-06-03,2184
1232,大統益,3,0,3,亞東-新竹,2024-06-03,2184
1304,台聚,3,0,3,亞東-新竹,2024-06-03,2184
00680L,元大美債20正2,407,0,407,亞東-新竹,2024-06-04,2184
2888,新光金,84,0,84,亞東-新竹,2024-06-04,2184
00918,大華優利高填息30,54,0,54,亞東-新竹,2024-06-04,2184
00929,復華台灣科技優息,98,50,48,亞東-新竹,2024-06-04,2184
2312,金寶,34,2,32,亞東-新竹,2024-06-04,2184
2331,精英,36,14,22,亞東-新竹,2024-06-04,2184
2344,華邦電,21,0,21,亞東-新竹,2024-06-04,2184
2367,燿華,41,20,21,亞東-新竹,2024-06-04,2184
3545,敦泰,20,0,20,亞東-新竹,2024-06-04,2184
6443,元晶,20,0,20,亞東-新竹,2024-06-04,2184
1313,聯成,19,0,19,亞東-新竹,2024-06-04,2184
2303,聯電,17,1,16,亞東-新竹,2024-06-04,2184
2603,長榮,17,1,16,亞東-新竹,2024-06-04,2184
4967,十銓,14,0,14,亞東-新竹,2024-06-04,2184
6462,神盾,16,2,14,亞東-新竹,2024-06-04,2184
1301,台塑,14,0,14,亞東-新竹,2024-06-04,2184
00878,國泰永續高股息,11,0,11,亞東-新竹,2024-06-04,2184
2020,美亞,11,0,11,亞東-新竹,2024-06-04,2184
2464,盟立,12,1,11,亞東-新竹,2024-06-04,2184
2610,華航,10,0,10,亞東-新竹,2024-06-04,2184
00715L,期街口布蘭特正2,11,1,10,亞東-新竹,2024-06-04,2184
00693U,期街口S＆P黃豆,10,0,10,亞東-新竹,2024-06-04,2184
1308,亞聚,10,0,10,亞東-新竹,2024-06-04,2184
1582,信錦,12,2,10,亞東-新竹,2024-06-04,2184
2385,群光,10,0,10,亞東-新竹,2024-06-04,2184
2317,鴻海,30,21,9,亞東-新竹,2024-06-04,2184
2634,漢翔,10,1,9,亞東-新竹,2024-06-04,2184
3374,精材,9,0,9,亞東-新竹,2024-06-04,2184
6117,迎廣,26,17,9,亞東-新竹,2024-06-04,2184
00675L,富邦臺灣加權正2,8,0,8,亞東-新竹,2024-06-04,2184
1718,中纖,8,0,8,亞東-新竹,2024-06-04,2184
2002,中鋼,8,0,8,亞東-新竹,2024-06-04,2184
9914,美利達,8,0,8,亞東-新竹,2024-06-04,2184
00713,元大台灣高息低波,7,0,7,亞東-新竹,2024-06-04,2184
00905,FT臺灣Smart,7,0,7,亞東-新竹,2024-06-04,2184
1786,科妍,7,0,7,亞東-新竹,2024-06-04,2184
2324,仁寶,10,3,7,亞東-新竹,2024-06-04,2184
2365,昆盈,8,1,7,亞東-新竹,2024-06-04,2184
2409,友達,7,0,7,亞東-新竹,2024-06-04,2184
4533,協易機,7,0,7,亞東-新竹,2024-06-04,2184
00712,復華富時不動產,6,0,6,亞東-新竹,2024-06-04,2184
2486,一詮,21,15,6,亞東-新竹,2024-06-04,2184
2613,中櫃,6,0,6,亞東-新竹,2024-06-04,2184
2890,永豐金,6,0,6,亞東-新竹,2024-06-04,2184
5283,禾聯碩,6,0,6,亞東-新竹,2024-06-04,2184
3041,揚智,6,0,6,亞東-新竹,2024-06-04,2184
2892,第一金,5,0,5,亞東-新竹,2024-06-04,2184
6125,廣運,25,20,5,亞東-新竹,2024-06-04,2184
3231,緯創,5,0,5,亞東-新竹,2024-06-04,2184
0056,元大高股息,20,15,5,亞東-新竹,2024-06-04,2184
00712,復華富時不動產,201,0,201,亞東-新竹,2024-06-05,2184
2313,華通,60,0,60,亞東-新竹,2024-06-05,2184
00715L,期街口布蘭特正2,52,0,52,亞東-新竹,2024-06-05,2184
1453,大將,52,2,50,亞東-新竹,2024-06-05,2184
5519,隆大,40,0,40,亞東-新竹,2024-06-05,2184
2020,美亞,39,0,39,亞東-新竹,2024-06-05,2184
00878,國泰永續高股息,39,1,38,亞東-新竹,2024-06-05,2184
3481,群創,36,0,36,亞東-新竹,2024-06-05,2184
00929,復華台灣科技優息,71,38,33,亞東-新竹,2024-06-05,2184
00720B,元大投資級公司債,33,0,33,亞東-新竹,2024-06-05,2184
00936,台新永續高息中小,41,9,32,亞東-新竹,2024-06-05,2184
6143,振曜,25,0,25,亞東-新竹,2024-06-05,2184
6122,擎邦,23,0,23,亞東-新竹,2024-06-05,2184
2241,艾姆勒,22,0,22,亞東-新竹,2024-06-05,2184
2636,台驊控股,21,1,20,亞東-新竹,2024-06-05,2184
2886,兆豐金,20,0,20,亞東-新竹,2024-06-05,2184
1301,台塑,19,0,19,亞東-新竹,2024-06-05,2184
5251,天鉞電,17,0,17,亞東-新竹,2024-06-05,2184
1710,東聯,16,0,16,亞東-新竹,2024-06-05,2184
2201,裕隆,32,18,14,亞東-新竹,2024-06-05,2184
2486,一詮,21,8,13,亞東-新竹,2024-06-05,2184
3062,建漢,13,0,13,亞東-新竹,2024-06-05,2184
2888,新光金,43,30,13,亞東-新竹,2024-06-05,2184
1720,生達,12,0,12,亞東-新竹,2024-06-05,2184
2206,三陽工業,12,0,12,亞東-新竹,2024-06-05,2184
2337,旺宏,11,0,11,亞東-新竹,2024-06-05,2184
3048,益登,13,2,11,亞東-新竹,2024-06-05,2184
00942B,台新美A公司債20+,10,0,10,亞東-新竹,2024-06-05,2184
1721,三晃,10,0,10,亞東-新竹,2024-06-05,2184
2611,志信,10,0,10,亞東-新竹,2024-06-05,2184
2885,元大金,10,0,10,亞東-新竹,2024-06-05,2184
3372,典範,10,0,10,亞東-新竹,2024-06-05,2184
00675L,富邦臺灣加權正2,9,0,9,亞東-新竹,2024-06-05,2184
00918,大華優利高填息30,9,0,9,亞東-新竹,2024-06-05,2184
00680L,元大美債20正2,9,0,9,亞東-新竹,2024-06-05,2184
8071,能率網通,9,0,9,亞東-新竹,2024-06-05,2184
8234,新漢,9,0,9,亞東-新竹,2024-06-05,2184
0056,元大高股息,9,1,8,亞東-新竹,2024-06-05,2184
2605,新興,11,3,8,亞東-新竹,2024-06-05,2184
1808,潤隆,7,0,7,亞東-新竹,2024-06-05,2184
2417,圓剛,19,12,7,亞東-新竹,2024-06-05,2184
4908,前鼎,13,6,7,亞東-新竹,2024-06-05,2184
3231,緯創,8,2,6,亞東-新竹,2024-06-05,2184
3321,同泰,6,0,6,亞東-新竹,2024-06-05,2184
3596,智易,6,0,6,亞東-新竹,2024-06-05,2184
9904,寶成,6,0,6,亞東-新竹,2024-06-05,2184
2357,華碩,6,0,6,亞東-新竹,2024-06-05,2184
6462,神盾,8,2,6,亞東-新竹,2024-06-05,2184
2382,廣達,11,6,5,亞東-新竹,2024-06-05,2184
00632R,元大台灣50反1,35,30,5,亞東-新竹,2024-06-05,2184
2915,潤泰全,70,0,70,亞東-新竹,2024-06-06,2184
00919,群益台灣精選高息,68,2,66,亞東-新竹,2024-06-06,2184
2409,友達,56,0,56,亞東-新竹,2024-06-06,2184
1459,聯發,53,0,53,亞東-新竹,2024-06-06,2184
2520,冠德,51,0,51,亞東-新竹,2024-06-06,2184
00679B,元大美債20年,50,2,48,亞東-新竹,2024-06-06,2184
4909,新復興,40,3,37,亞東-新竹,2024-06-06,2184
1457,宜進,35,0,35,亞東-新竹,2024-06-06,2184
2545,皇翔,32,0,32,亞東-新竹,2024-06-06,2184
2353,宏��,38,18,20,亞東-新竹,2024-06-06,2184
3406,玉晶光,20,0,20,亞東-新竹,2024-06-06,2184
6264,富裔,20,0,20,亞東-新竹,2024-06-06,2184
1710,東聯,19,0,19,亞東-新竹,2024-06-06,2184
3231,緯創,19,2,17,亞東-新竹,2024-06-06,2184
2368,金像電,15,0,15,亞東-新竹,2024-06-06,2184
5534,長虹,15,0,15,亞東-新竹,2024-06-06,2184
4904,遠傳,12,0,12,亞東-新竹,2024-06-06,2184
5347,世界,25,13,12,亞東-新竹,2024-06-06,2184
00680L,元大美債20正2,11,0,11,亞東-新竹,2024-06-06,2184
00918,大華優利高填息30,10,0,10,亞東-新竹,2024-06-06,2184
00882,中信中國高股息,10,0,10,亞東-新竹,2024-06-06,2184
1560,中砂,10,0,10,亞東-新竹,2024-06-06,2184
2201,裕隆,26,16,10,亞東-新竹,2024-06-06,2184
2338,光罩,10,0,10,亞東-新竹,2024-06-06,2184
2392,正崴,10,0,10,亞東-新竹,2024-06-06,2184
2905,三商,10,0,10,亞東-新竹,2024-06-06,2184
4147,中裕,10,0,10,亞東-新竹,2024-06-06,2184
6163,華電網,10,0,10,亞東-新竹,2024-06-06,2184
6416,瑞祺電通,10,0,10,亞東-新竹,2024-06-06,2184
6695,芯鼎,10,0,10,亞東-新竹,2024-06-06,2184
6770,力積電,10,0,10,亞東-新竹,2024-06-06,2184
9105,泰金寶-DR,10,0,10,亞東-新竹,2024-06-06,2184
9904,寶成,10,0,10,亞東-新竹,2024-06-06,2184
00687B,國泰20年美債,10,1,9,亞東-新竹,2024-06-06,2184
2542,興富發,9,0,9,亞東-新竹,2024-06-06,2184
3048,益登,9,0,9,亞東-新竹,2024-06-06,2184
3202,樺晟,13,4,9,亞東-新竹,2024-06-06,2184
6188,廣明,19,10,9,亞東-新竹,2024-06-06,2184
8071,能率網通,9,0,9,亞東-新竹,2024-06-06,2184
00936,台新永續高息中小,13,5,8,亞東-新竹,2024-06-06,2184
4958,臻鼎-KY,8,0,8,亞東-新竹,2024-06-06,2184
2464,盟立,23,16,7,亞東-新竹,2024-06-06,2184
4908,前鼎,7,0,7,亞東-新竹,2024-06-06,2184
6122,擎邦,7,0,7,亞東-新竹,2024-06-06,2184
9945,潤泰新,8,1,7,亞東-新竹,2024-06-06,2184
1522,堤維西,6,0,6,亞東-新竹,2024-06-06,2184
2331,精英,6,0,6,亞東-新竹,2024-06-06,2184
2613,中櫃,19,13,6,亞東-新竹,2024-06-06,2184
2603,長榮,18,13,5,亞東-新竹,2024-06-06,2184
1303,南亞,5,0,5,亞東-新竹,2024-06-06,2184
2888,新光金,1227,88,1139,亞東-新竹,2024-06-07,2184
2883,凱基金,118,8,110,亞東-新竹,2024-06-07,2184
00933B,國泰10Y+金融債,60,0,60,亞東-新竹,2024-06-07,2184
00687B,國泰20年美債,52,0,52,亞東-新竹,2024-06-07,2184
1314,中石化,54,4,50,亞東-新竹,2024-06-07,2184
2885,元大金,50,1,49,亞東-新竹,2024-06-07,2184
2867,三商壽,60,27,33,亞東-新竹,2024-06-07,2184
1612,宏泰,33,3,30,亞東-新竹,2024-06-07,2184
3231,緯創,24,1,23,亞東-新竹,2024-06-07,2184
2615,萬海,47,25,22,亞東-新竹,2024-06-07,2184
2031,新光鋼,21,0,21,亞東-新竹,2024-06-07,2184
2489,瑞軒,20,0,20,亞東-新竹,2024-06-07,2184
2514,龍邦,20,0,20,亞東-新竹,2024-06-07,2184
4157,太景*-KY,20,0,20,亞東-新竹,2024-06-07,2184
00918,大華優利高填息30,18,0,18,亞東-新竹,2024-06-07,2184
2881,富邦金,25,7,18,亞東-新竹,2024-06-07,2184
2354,鴻準,31,14,17,亞東-新竹,2024-06-07,2184
00936,台新永續高息中小,17,0,17,亞東-新竹,2024-06-07,2184
8163,達方,16,0,16,亞東-新竹,2024-06-07,2184
2743,山富,11,0,11,亞東-新竹,2024-06-07,2184
6269,台郡,12,1,11,亞東-新竹,2024-06-07,2184
2329,華泰,21,10,11,亞東-新竹,2024-06-07,2184
00857B,永豐20年美公債,10,0,10,亞東-新竹,2024-06-07,2184
1457,宜進,10,0,10,亞東-新竹,2024-06-07,2184
2368,金像電,10,0,10,亞東-新竹,2024-06-07,2184
3481,群創,10,0,10,亞東-新竹,2024-06-07,2184
4167,松瑞藥,23,13,10,亞東-新竹,2024-06-07,2184
4952,凌通,10,0,10,亞東-新竹,2024-06-07,2184
2002,中鋼,9,0,9,亞東-新竹,2024-06-07,2184
2330,台積電,9,1,8,亞東-新竹,2024-06-07,2184
1324,地球,8,0,8,亞東-新竹,2024-06-07,2184
2313,華通,8,0,8,亞東-新竹,2024-06-07,2184
3705,永信,8,0,8,亞東-新竹,2024-06-07,2184
2376,技嘉,7,0,7,亞東-新竹,2024-06-07,2184
3260,威剛,12,5,7,亞東-新竹,2024-06-07,2184
4908,前鼎,7,0,7,亞東-新竹,2024-06-07,2184
2353,宏��,13,7,6,亞東-新竹,2024-06-07,2184
2101,南港,6,0,6,亞東-新竹,2024-06-07,2184
5471,松翰,6,0,6,亞東-新竹,2024-06-07,2184
6782,視陽,9,3,6,亞東-新竹,2024-06-07,2184
3017,奇鋐,5,0,5,亞東-新竹,2024-06-07,2184
00680L,元大美債20正2,5,0,5,亞東-新竹,2024-06-07,2184
2382,廣達,6,1,5,亞東-新竹,2024-06-07,2184
3056,富華新,5,0,5,亞東-新竹,2024-06-07,2184
3576,聯合再生,5,0,5,亞東-新竹,2024-06-07,2184
5443,均豪,5,0,5,亞東-新竹,2024-06-07,2184
6005,群益證,5,0,5,亞東-新竹,2024-06-07,2184
8033,雷虎,5,0,5,亞東-新竹,2024-06-07,2184
8234,新漢,5,0,5,亞東-新竹,2024-06-07,2184
2317,鴻海,9,5,4,亞東-新竹,2024-06-07,2184
2888,新光金,704,1,703,亞東-新竹,2024-06-11,2184
00933B,國泰10Y+金融債,436,0,436,亞東-新竹,2024-06-11,2184
1612,宏泰,153,3,150,亞東-新竹,2024-06-11,2184
00751B,元大AAA至A公司債,124,0,124,亞東-新竹,2024-06-11,2184
00720B,元大投資級公司債,66,0,66,亞東-新竹,2024-06-11,2184
2915,潤泰全,70,5,65,亞東-新竹,2024-06-11,2184
2002,中鋼,68,4,64,亞東-新竹,2024-06-11,2184
00929,復華台灣科技優息,58,0,58,亞東-新竹,2024-06-11,2184
2615,萬海,77,27,50,亞東-新竹,2024-06-11,2184
3481,群創,41,0,41,亞東-新竹,2024-06-11,2184
5351,鈺創,40,0,40,亞東-新竹,2024-06-11,2184
00937B,群益ESG投等債20,37,0,37,亞東-新竹,2024-06-11,2184
9945,潤泰新,39,6,33,亞東-新竹,2024-06-11,2184
00918,大華優利高填息30,32,1,31,亞東-新竹,2024-06-11,2184
00679B,元大美債20年,29,0,29,亞東-新竹,2024-06-11,2184
6186,新潤,29,0,29,亞東-新竹,2024-06-11,2184
2609,陽明,55,30,25,亞東-新竹,2024-06-11,2184
2891,中信金,21,0,21,亞東-新竹,2024-06-11,2184
0056,元大高股息,18,0,18,亞東-新竹,2024-06-11,2184
00946,群益科技高息成長,17,0,17,亞東-新竹,2024-06-11,2184
00687B,國泰20年美債,16,0,16,亞東-新竹,2024-06-11,2184
2634,漢翔,16,0,16,亞東-新竹,2024-06-11,2184
00919,群益台灣精選高息,21,5,16,亞東-新竹,2024-06-11,2184
2329,華泰,15,0,15,亞東-新竹,2024-06-11,2184
1609,大亞,15,2,13,亞東-新竹,2024-06-11,2184
6190,萬泰科,15,2,13,亞東-新竹,2024-06-11,2184
3705,永信,12,0,12,亞東-新竹,2024-06-11,2184
6015,宏遠證,12,0,12,亞東-新竹,2024-06-11,2184
00878,國泰永續高股息,10,0,10,亞東-新竹,2024-06-11,2184
00909,國泰數位支付服務,10,0,10,亞東-新竹,2024-06-11,2184
1316,上曜,13,3,10,亞東-新竹,2024-06-11,2184
1808,潤隆,14,4,10,亞東-新竹,2024-06-11,2184
3047,訊舟,12,2,10,亞東-新竹,2024-06-11,2184
3535,晶彩科,10,0,10,亞東-新竹,2024-06-11,2184
3231,緯創,11,2,9,亞東-新竹,2024-06-11,2184
3034,聯詠,9,0,9,亞東-新竹,2024-06-11,2184
3037,欣興,10,1,9,亞東-新竹,2024-06-11,2184
3122,笙泉,10,1,9,亞東-新竹,2024-06-11,2184
4971,IET-KY,9,0,9,亞東-新竹,2024-06-11,2184
00900,富邦特選高股息30,8,0,8,亞東-新竹,2024-06-11,2184
2353,宏��,11,3,8,亞東-新竹,2024-06-11,2184
2359,所羅門,18,10,8,亞東-新竹,2024-06-11,2184
2617,台航,10,2,8,亞東-新竹,2024-06-11,2184
3321,同泰,8,0,8,亞東-新竹,2024-06-11,2184
6164,華興,8,0,8,亞東-新竹,2024-06-11,2184
6175,立敦,8,0,8,亞東-新竹,2024-06-11,2184
00680L,元大美債20正2,8,0,8,亞東-新竹,2024-06-11,2184
00675L,富邦臺灣加權正2,8,1,7,亞東-新竹,2024-06-11,2184
1308,亞聚,7,0,7,亞東-新竹,2024-06-11,2184
1617,榮星,7,0,7,亞東-新竹,2024-06-11,2184
00933B,國泰10Y+金融債,385,0,385,亞東-新竹,2024-06-12,2184
00919,群益台灣精選高息,79,0,79,亞東-新竹,2024-06-12,2184
2883,凱基金,162,100,62,亞東-新竹,2024-06-12,2184
00937B,群益ESG投等債20,43,10,33,亞東-新竹,2024-06-12,2184
00929,復華台灣科技優息,27,1,26,亞東-新竹,2024-06-12,2184
00751B,元大AAA至A公司債,26,1,25,亞東-新竹,2024-06-12,2184
1447,力鵬,27,5,22,亞東-新竹,2024-06-12,2184
2201,裕隆,31,10,21,亞東-新竹,2024-06-12,2184
00642U,期元大S＆P石油,20,0,20,亞東-新竹,2024-06-12,2184
1809,中釉,20,0,20,亞東-新竹,2024-06-12,2184
00918,大華優利高填息30,19,0,19,亞東-新竹,2024-06-12,2184
2460,建通,20,1,19,亞東-新竹,2024-06-12,2184
2888,新光金,34,16,18,亞東-新竹,2024-06-12,2184
2374,佳能,18,1,17,亞東-新竹,2024-06-12,2184
2881,富邦金,17,0,17,亞東-新竹,2024-06-12,2184
1301,台塑,15,0,15,亞東-新竹,2024-06-12,2184
1781,合世,15,0,15,亞東-新竹,2024-06-12,2184
2851,中再保,15,0,15,亞東-新竹,2024-06-12,2184
4105,東洋,15,1,14,亞東-新竹,2024-06-12,2184
3481,群創,13,0,13,亞東-新竹,2024-06-12,2184
3231,緯創,12,2,10,亞東-新竹,2024-06-12,2184
1460,宏遠,10,0,10,亞東-新竹,2024-06-12,2184
1471,首利,10,0,10,亞東-新竹,2024-06-12,2184
1785,光洋科,10,0,10,亞東-新竹,2024-06-12,2184
2886,兆豐金,10,0,10,亞東-新竹,2024-06-12,2184
5519,隆大,12,2,10,亞東-新竹,2024-06-12,2184
9945,潤泰新,14,4,10,亞東-新竹,2024-06-12,2184
2002,中鋼,9,0,9,亞東-新竹,2024-06-12,2184
00679B,元大美債20年,8,0,8,亞東-新竹,2024-06-12,2184
00631L,元大台灣50正2,19,11,8,亞東-新竹,2024-06-12,2184
0056,元大高股息,7,0,7,亞東-新竹,2024-06-12,2184
3260,威剛,7,0,7,亞東-新竹,2024-06-12,2184
2329,華泰,7,0,7,亞東-新竹,2024-06-12,2184
2486,一詮,17,10,7,亞東-新竹,2024-06-12,2184
3705,永信,7,0,7,亞東-新竹,2024-06-12,2184
2303,聯電,12,6,6,亞東-新竹,2024-06-12,2184
2357,華碩,6,0,6,亞東-新竹,2024-06-12,2184
00687B,國泰20年美債,5,0,5,亞東-新竹,2024-06-12,2184
2344,華邦電,7,2,5,亞東-新竹,2024-06-12,2184
2405,輔信,5,0,5,亞東-新竹,2024-06-12,2184
2607,榮運,5,0,5,亞東-新竹,2024-06-12,2184
2637,慧洋-KY,5,0,5,亞東-新竹,2024-06-12,2184
3321,同泰,5,0,5,亞東-新竹,2024-06-12,2184
4157,太景*-KY,5,0,5,亞東-新竹,2024-06-12,2184
6190,萬泰科,20,15,5,亞東-新竹,2024-06-12,2184
6443,元晶,5,0,5,亞東-新竹,2024-06-12,2184
8926,台汽電,5,0,5,亞東-新竹,2024-06-12,2184
1609,大亞,4,0,4,亞東-新竹,2024-06-12,2184
1514,亞力,13,9,4,亞東-新竹,2024-06-12,2184
2105,正新,5,1,4,亞東-新竹,2024-06-12,2184
2883,凱基金,263,12,251,亞東-新竹,2024-06-13,2184
00919,群益台灣精選高息,145,13,132,亞東-新竹,2024-06-13,2184
1326,台化,120,0,120,亞東-新竹,2024-06-13,2184
8069,元太,30,0,30,亞東-新竹,2024-06-13,2184
00947,台新臺灣IC設計,23,0,23,亞東-新竹,2024-06-13,2184
2617,台航,20,0,20,亞東-新竹,2024-06-13,2184
2367,燿華,27,10,17,亞東-新竹,2024-06-13,2184
3372,典範,20,3,17,亞東-新竹,2024-06-13,2184
00679B,元大美債20年,19,3,16,亞東-新竹,2024-06-13,2184
1460,宏遠,15,0,15,亞東-新竹,2024-06-13,2184
2606,裕民,15,2,13,亞東-新竹,2024-06-13,2184
3356,奇偶,15,3,12,亞東-新竹,2024-06-13,2184
6290,良維,11,0,11,亞東-新竹,2024-06-13,2184
00929,復華台灣科技優息,22,12,10,亞東-新竹,2024-06-13,2184
1809,中釉,10,0,10,亞東-新竹,2024-06-13,2184
2201,裕隆,16,6,10,亞東-新竹,2024-06-13,2184
3339,泰谷,9,0,9,亞東-新竹,2024-06-13,2184
3712,永崴投控,10,1,9,亞東-新竹,2024-06-13,2184
6805,富世達,9,0,9,亞東-新竹,2024-06-13,2184
6125,廣運,11,3,8,亞東-新竹,2024-06-13,2184
2809,京城銀,9,1,8,亞東-新竹,2024-06-13,2184
00632R,元大台灣50反1,20,13,7,亞東-新竹,2024-06-13,2184
6188,廣明,10,3,7,亞東-新竹,2024-06-13,2184
00941,中信上游半導體,10,4,6,亞東-新竹,2024-06-13,2184
3025,星通,6,0,6,亞東-新竹,2024-06-13,2184
8299,群聯,8,2,6,亞東-新竹,2024-06-13,2184
00674R,期元大S＆P黃金反1,5,0,5,亞東-新竹,2024-06-13,2184
3005,神基,5,0,5,亞東-新竹,2024-06-13,2184
3481,群創,6,1,5,亞東-新竹,2024-06-13,2184
3706,神達,5,0,5,亞東-新竹,2024-06-13,2184
4536,拓凱,5,0,5,亞東-新竹,2024-06-13,2184
6016,康和證,5,0,5,亞東-新竹,2024-06-13,2184
6877,鏵友益,5,0,5,亞東-新竹,2024-06-13,2184
8046,南電,5,0,5,亞東-新竹,2024-06-13,2184
8234,新漢,5,0,5,亞東-新竹,2024-06-13,2184
00936,台新永續高息中小,4,0,4,亞東-新竹,2024-06-13,2184
1319,東陽,4,0,4,亞東-新竹,2024-06-13,2184
1312,國喬,4,0,4,亞東-新竹,2024-06-13,2184
2460,建通,4,0,4,亞東-新竹,2024-06-13,2184
2603,長榮,4,0,4,亞東-新竹,2024-06-13,2184
2903,遠百,4,0,4,亞東-新竹,2024-06-13,2184
4967,十銓,18,14,4,亞東-新竹,2024-06-13,2184
5347,世界,9,5,4,亞東-新竹,2024-06-13,2184
6782,視陽,6,2,4,亞東-新竹,2024-06-13,2184
8096,擎亞,5,1,4,亞東-新竹,2024-06-13,2184
8936,國統,4,0,4,亞東-新竹,2024-06-13,2184
5871,中租-KY,5,2,3,亞東-新竹,2024-06-13,2184
1232,大統益,3,0,3,亞東-新竹,2024-06-13,2184
1304,台聚,3,0,3,亞東-新竹,2024-06-13,2184
00681R,元大美債20反1,3,0,3,亞東-新竹,2024-06-13,2184
2883,凱基金,214,3,211,亞東-新竹,2024-06-14,2184
2408,南亞科,80,1,79,亞東-新竹,2024-06-14,2184
00929,復華台灣科技優息,95,27,68,亞東-新竹,2024-06-14,2184
1612,宏泰,71,5,66,亞東-新竹,2024-06-14,2184
2312,金寶,71,8,63,亞東-新竹,2024-06-14,2184
1608,華榮,43,5,38,亞東-新竹,2024-06-14,2184
8277,商丞,38,0,38,亞東-新竹,2024-06-14,2184
00688L,國泰20年美債正2,30,0,30,亞東-新竹,2024-06-14,2184
8215,明基材,30,0,30,亞東-新竹,2024-06-14,2184
00919,群益台灣精選高息,29,1,28,亞東-新竹,2024-06-14,2184
00687B,國泰20年美債,25,0,25,亞東-新竹,2024-06-14,2184
2882,國泰金,24,1,23,亞東-新竹,2024-06-14,2184
00937B,群益ESG投等債20,38,15,23,亞東-新竹,2024-06-14,2184
1785,光洋科,27,5,22,亞東-新竹,2024-06-14,2184
5522,遠雄,30,10,20,亞東-新竹,2024-06-14,2184
00632R,元大台灣50反1,20,1,19,亞東-新竹,2024-06-14,2184
2367,燿華,19,1,18,亞東-新竹,2024-06-14,2184
2201,裕隆,17,2,15,亞東-新竹,2024-06-14,2184
6265,方土昶,14,0,14,亞東-新竹,2024-06-14,2184
2351,順德,11,0,11,亞東-新竹,2024-06-14,2184
6451,訊芯-KY,11,0,11,亞東-新竹,2024-06-14,2184
2027,大成鋼,10,0,10,亞東-新竹,2024-06-14,2184
2303,聯電,14,4,10,亞東-新竹,2024-06-14,2184
2886,兆豐金,20,10,10,亞東-新竹,2024-06-14,2184
2317,鴻海,41,32,9,亞東-新竹,2024-06-14,2184
2486,一詮,10,1,9,亞東-新竹,2024-06-14,2184
2610,華航,9,0,9,亞東-新竹,2024-06-14,2184
3708,上緯投控,10,1,9,亞東-新竹,2024-06-14,2184
0056,元大高股息,14,6,8,亞東-新竹,2024-06-14,2184
1316,上曜,9,1,8,亞東-新竹,2024-06-14,2184
3557,嘉威,8,0,8,亞東-新竹,2024-06-14,2184
5347,世界,16,8,8,亞東-新竹,2024-06-14,2184
1476,儒鴻,7,0,7,亞東-新竹,2024-06-14,2184
2454,聯發科,7,0,7,亞東-新竹,2024-06-14,2184
6670,復盛應用,7,0,7,亞東-新竹,2024-06-14,2184
3231,緯創,6,0,6,亞東-新竹,2024-06-14,2184
2002,中鋼,6,0,6,亞東-新竹,2024-06-14,2184
2460,建通,6,0,6,亞東-新竹,2024-06-14,2184
5519,隆大,12,6,6,亞東-新竹,2024-06-14,2184
6269,台郡,6,0,6,亞東-新竹,2024-06-14,2184
3017,奇鋐,8,2,6,亞東-新竹,2024-06-14,2184
4155,訊映,6,0,6,亞東-新竹,2024-06-14,2184
00939,統一台灣高息動能,5,0,5,亞東-新竹,2024-06-14,2184
1460,宏遠,5,0,5,亞東-新竹,2024-06-14,2184
3025,星通,9,4,5,亞東-新竹,2024-06-14,2184
3687,歐買尬,5,0,5,亞東-新竹,2024-06-14,2184
4961,天鈺,5,0,5,亞東-新竹,2024-06-14,2184
6488,環球晶,5,0,5,亞東-新竹,2024-06-14,2184
6789,采鈺,7,2,5,亞東-新竹,2024-06-14,2184
1473,台南,5,1,4,亞東-新竹,2024-06-14,2184
2913,農林,147,0,147,亞東-新竹,2024-06-17,2184
00751B,元大AAA至A公司債,67,0,67,亞東-新竹,2024-06-17,2184
00936,台新永續高息中小,42,0,42,亞東-新竹,2024-06-17,2184
6005,群益證,33,0,33,亞東-新竹,2024-06-17,2184
00942B,台新美A公司債20+,25,0,25,亞東-新竹,2024-06-17,2184
00679B,元大美債20年,22,0,22,亞東-新竹,2024-06-17,2184
2427,三商電,17,0,17,亞東-新竹,2024-06-17,2184
4533,協易機,16,0,16,亞東-新竹,2024-06-17,2184
1324,地球,14,0,14,亞東-新竹,2024-06-17,2184
2002,中鋼,14,0,14,亞東-新竹,2024-06-17,2184
6265,方土昶,14,0,14,亞東-新竹,2024-06-17,2184
9904,寶成,14,0,14,亞東-新竹,2024-06-17,2184
00929,復華台灣科技優息,18,6,12,亞東-新竹,2024-06-17,2184
2615,萬海,25,13,12,亞東-新竹,2024-06-17,2184
5230,雷笛克光學,12,0,12,亞東-新竹,2024-06-17,2184
6138,茂達,10,0,10,亞東-新竹,2024-06-17,2184
2460,建通,10,0,10,亞東-新竹,2024-06-17,2184
3049,精金,30,20,10,亞東-新竹,2024-06-17,2184
6546,正基,10,0,10,亞東-新竹,2024-06-17,2184
9103,美德醫療-DR,11,2,9,亞東-新竹,2024-06-17,2184
1101,台泥,11,3,8,亞東-新竹,2024-06-17,2184
00713,元大台灣高息低波,8,0,8,亞東-新竹,2024-06-17,2184
2371,大同,19,11,8,亞東-新竹,2024-06-17,2184
3006,晶豪科,8,0,8,亞東-新竹,2024-06-17,2184
4714,永捷,8,0,8,亞東-新竹,2024-06-17,2184
8028,昇陽半導體,10,2,8,亞東-新竹,2024-06-17,2184
9919,康那香,9,1,8,亞東-新竹,2024-06-17,2184
00933B,國泰10Y+金融債,7,0,7,亞東-新竹,2024-06-17,2184
00937B,群益ESG投等債20,7,0,7,亞東-新竹,2024-06-17,2184
2206,三陽工業,8,1,7,亞東-新竹,2024-06-17,2184
2376,技嘉,6,0,6,亞東-新竹,2024-06-17,2184
1605,華新,6,0,6,亞東-新竹,2024-06-17,2184
1808,潤隆,8,2,6,亞東-新竹,2024-06-17,2184
2458,義隆,6,0,6,亞東-新竹,2024-06-17,2184
3317,尼克森,6,0,6,亞東-新竹,2024-06-17,2184
00631L,元大台灣50正2,11,6,5,亞東-新竹,2024-06-17,2184
2492,華新科,6,1,5,亞東-新竹,2024-06-17,2184
2832,台產,5,0,5,亞東-新竹,2024-06-17,2184
2903,遠百,5,0,5,亞東-新竹,2024-06-17,2184
6202,盛群,5,0,5,亞東-新竹,2024-06-17,2184
6216,居易,5,0,5,亞東-新竹,2024-06-17,2184
8054,安國,8,3,5,亞東-新竹,2024-06-17,2184
01001T,土銀富邦R1,4,0,4,亞東-新竹,2024-06-17,2184
1503,士電,10,6,4,亞東-新竹,2024-06-17,2184
1570,力肯,4,0,4,亞東-新竹,2024-06-17,2184
1815,富喬,7,3,4,亞東-新竹,2024-06-17,2184
2314,台揚,4,0,4,亞東-新竹,2024-06-17,2184
2354,鴻準,6,2,4,亞東-新竹,2024-06-17,2184
2367,燿華,4,0,4,亞東-新竹,2024-06-17,2184
2542,興富發,12,8,4,亞東-新竹,2024-06-17,2184
00679B,元大美債20年,207,4,203,亞東-新竹,2024-06-18,2184
00713,元大台灣高息低波,151,0,151,亞東-新竹,2024-06-18,2184
00680L,元大美債20正2,85,0,85,亞東-新竹,2024-06-18,2184
00929,復華台灣科技優息,79,12,67,亞東-新竹,2024-06-18,2184
3374,精材,58,1,57,亞東-新竹,2024-06-18,2184
00937B,群益ESG投等債20,49,0,49,亞東-新竹,2024-06-18,2184
1460,宏遠,35,0,35,亞東-新竹,2024-06-18,2184
4909,新復興,37,2,35,亞東-新竹,2024-06-18,2184
3706,神達,32,0,32,亞東-新竹,2024-06-18,2184
2486,一詮,38,6,32,亞東-新竹,2024-06-18,2184
6005,群益證,35,10,25,亞東-新竹,2024-06-18,2184
1802,台玻,18,0,18,亞東-新竹,2024-06-18,2184
00915,凱基優選高股息30,20,5,15,亞東-新竹,2024-06-18,2184
4967,十銓,15,0,15,亞東-新竹,2024-06-18,2184
3481,群創,23,9,14,亞東-新竹,2024-06-18,2184
2882,國泰金,20,6,14,亞東-新竹,2024-06-18,2184
00936,台新永續高息中小,13,0,13,亞東-新竹,2024-06-18,2184
3294,英濟,12,0,12,亞東-新竹,2024-06-18,2184
8028,昇陽半導體,18,6,12,亞東-新竹,2024-06-18,2184
2887,台新金,11,0,11,亞東-新竹,2024-06-18,2184
3048,益登,10,0,10,亞東-新竹,2024-06-18,2184
3021,鴻名,9,0,9,亞東-新竹,2024-06-18,2184
3645,達邁,9,0,9,亞東-新竹,2024-06-18,2184
9105,泰金寶-DR,8,0,8,亞東-新竹,2024-06-18,2184
2516,新建,7,0,7,亞東-新竹,2024-06-18,2184
4903,聯光通,7,0,7,亞東-新竹,2024-06-18,2184
9921,巨大,7,0,7,亞東-新竹,2024-06-18,2184
3034,聯詠,6,0,6,亞東-新竹,2024-06-18,2184
1788,杏昌,6,0,6,亞東-新竹,2024-06-18,2184
3024,憶聲,6,0,6,亞東-新竹,2024-06-18,2184
5452,佶優,7,1,6,亞東-新竹,2024-06-18,2184
00941,中信上游半導體,5,0,5,亞東-新竹,2024-06-18,2184
00947,台新臺灣IC設計,5,0,5,亞東-新竹,2024-06-18,2184
01001T,土銀富邦R1,5,0,5,亞東-新竹,2024-06-18,2184
00687B,國泰20年美債,5,0,5,亞東-新竹,2024-06-18,2184
1524,耿鼎,5,0,5,亞東-新竹,2024-06-18,2184
1611,中電,10,5,5,亞東-新竹,2024-06-18,2184
1721,三晃,5,0,5,亞東-新竹,2024-06-18,2184
1808,潤隆,5,0,5,亞東-新竹,2024-06-18,2184
2393,億光,6,1,5,亞東-新竹,2024-06-18,2184
2460,建通,5,0,5,亞東-新竹,2024-06-18,2184
2617,台航,5,0,5,亞東-新竹,2024-06-18,2184
3551,世禾,5,0,5,亞東-新竹,2024-06-18,2184
4562,穎漢,14,9,5,亞東-新竹,2024-06-18,2184
5443,均豪,5,0,5,亞東-新竹,2024-06-18,2184
5490,同亨,6,1,5,亞東-新竹,2024-06-18,2184
6239,力成,6,1,5,亞東-新竹,2024-06-18,2184
2371,大同,10,6,4,亞東-新竹,2024-06-18,2184
2317,鴻海,9,5,4,亞東-新竹,2024-06-18,2184
1710,東聯,8,4,4,亞東-新竹,2024-06-18,2184
2888,新光金,468,16,452,亞東-新竹,2024-06-19,2184
00688L,國泰20年美債正2,200,0,200,亞東-新竹,2024-06-19,2184
00940,元大台灣價值高息,155,23,132,亞東-新竹,2024-06-19,2184
2882,國泰金,75,3,72,亞東-新竹,2024-06-19,2184
00632R,元大台灣50反1,110,44,66,亞東-新竹,2024-06-19,2184
00680L,元大美債20正2,55,0,55,亞東-新竹,2024-06-19,2184
00933B,國泰10Y+金融債,51,0,51,亞東-新竹,2024-06-19,2184
2515,中工,50,0,50,亞東-新竹,2024-06-19,2184
6163,華電網,43,0,43,亞東-新竹,2024-06-19,2184
6770,力積電,53,11,42,亞東-新竹,2024-06-19,2184
2482,連宇,40,0,40,亞東-新竹,2024-06-19,2184
00937B,群益ESG投等債20,37,4,33,亞東-新竹,2024-06-19,2184
00712,復華富時不動產,32,0,32,亞東-新竹,2024-06-19,2184
2365,昆盈,32,5,27,亞東-新竹,2024-06-19,2184
00947,台新臺灣IC設計,22,0,22,亞東-新竹,2024-06-19,2184
6126,信音,20,0,20,亞東-新竹,2024-06-19,2184
00936,台新永續高息中小,24,5,19,亞東-新竹,2024-06-19,2184
00713,元大台灣高息低波,19,0,19,亞東-新竹,2024-06-19,2184
00850,元大臺灣ESG永續,17,0,17,亞東-新竹,2024-06-19,2184
00918,大華優利高填息30,17,0,17,亞東-新竹,2024-06-19,2184
01001T,土銀富邦R1,15,0,15,亞東-新竹,2024-06-19,2184
5443,均豪,21,6,15,亞東-新竹,2024-06-19,2184
4534,慶騰,14,0,14,亞東-新竹,2024-06-19,2184
6139,亞翔,14,0,14,亞東-新竹,2024-06-19,2184
00687B,國泰20年美債,13,0,13,亞東-新竹,2024-06-19,2184
00764B,群益25年美債,12,0,12,亞東-新竹,2024-06-19,2184
1720,生達,12,0,12,亞東-新竹,2024-06-19,2184
00929,復華台灣科技優息,39,27,12,亞東-新竹,2024-06-19,2184
2606,裕民,11,0,11,亞東-新竹,2024-06-19,2184
00948B,中信優息投資級債,10,0,10,亞東-新竹,2024-06-19,2184
2399,映泰,10,0,10,亞東-新竹,2024-06-19,2184
2417,圓剛,10,0,10,亞東-新竹,2024-06-19,2184
3287,廣寰科,10,0,10,亞東-新竹,2024-06-19,2184
4147,中裕,10,0,10,亞東-新竹,2024-06-19,2184
6451,訊芯-KY,16,6,10,亞東-新竹,2024-06-19,2184
6546,正基,10,0,10,亞東-新竹,2024-06-19,2184
8277,商丞,10,0,10,亞東-新竹,2024-06-19,2184
6895,宏碩系統,9,0,9,亞東-新竹,2024-06-19,2184
2201,裕隆,14,6,8,亞東-新竹,2024-06-19,2184
2427,三商電,8,0,8,亞東-新竹,2024-06-19,2184
3321,同泰,8,0,8,亞東-新竹,2024-06-19,2184
3481,群創,8,0,8,亞東-新竹,2024-06-19,2184
4714,永捷,8,0,8,亞東-新竹,2024-06-19,2184
9105,泰金寶-DR,15,7,8,亞東-新竹,2024-06-19,2184
00679B,元大美債20年,7,0,7,亞東-新竹,2024-06-19,2184
1788,杏昌,7,0,7,亞東-新竹,2024-06-19,2184
2027,大成鋼,7,0,7,亞東-新竹,2024-06-19,2184
2359,所羅門,18,11,7,亞東-新竹,2024-06-19,2184
00915,凱基優選高股息30,7,0,7,亞東-新竹,2024-06-19,2184
3013,晟銘電,6,0,6,亞東-新竹,2024-06-19,2184
6005,群益證,371,0,371,亞東-新竹,2024-06-20,2184
00942B,台新美A公司債20+,79,0,79,亞東-新竹,2024-06-20,2184
00751B,元大AAA至A公司債,59,0,59,亞東-新竹,2024-06-20,2184
00679B,元大美債20年,49,0,49,亞東-新竹,2024-06-20,2184
6505,台塑化,37,0,37,亞東-新竹,2024-06-20,2184
00936,台新永續高息中小,37,1,36,亞東-新竹,2024-06-20,2184
00680L,元大美債20正2,30,0,30,亞東-新竹,2024-06-20,2184
2303,聯電,30,9,21,亞東-新竹,2024-06-20,2184
2888,新光金,21,0,21,亞東-新竹,2024-06-20,2184
6589,台康生技,25,4,21,亞東-新竹,2024-06-20,2184
2886,兆豐金,20,0,20,亞東-新竹,2024-06-20,2184
00937B,群益ESG投等債20,19,0,19,亞東-新竹,2024-06-20,2184
00940,元大台灣價值高息,27,9,18,亞東-新竹,2024-06-20,2184
00687B,國泰20年美債,17,0,17,亞東-新竹,2024-06-20,2184
0056,元大高股息,17,1,16,亞東-新竹,2024-06-20,2184
00915,凱基優選高股息30,16,0,16,亞東-新竹,2024-06-20,2184
3705,永信,16,0,16,亞東-新竹,2024-06-20,2184
2367,燿華,22,7,15,亞東-新竹,2024-06-20,2184
4526,東台,17,2,15,亞東-新竹,2024-06-20,2184
2317,鴻海,43,29,14,亞東-新竹,2024-06-20,2184
00675L,富邦臺灣加權正2,13,0,13,亞東-新竹,2024-06-20,2184
00850,元大臺灣ESG永續,11,0,11,亞東-新竹,2024-06-20,2184
00947,台新臺灣IC設計,10,0,10,亞東-新竹,2024-06-20,2184
2605,新興,10,0,10,亞東-新竹,2024-06-20,2184
6187,萬潤,10,0,10,亞東-新竹,2024-06-20,2184
2330,台積電,10,1,9,亞東-新竹,2024-06-20,2184
3231,緯創,14,5,9,亞東-新竹,2024-06-20,2184
2615,萬海,17,8,9,亞東-新竹,2024-06-20,2184
2033,佳大,8,0,8,亞東-新竹,2024-06-20,2184
6140,訊達,11,3,8,亞東-新竹,2024-06-20,2184
3596,智易,7,0,7,亞東-新竹,2024-06-20,2184
6207,雷科,7,0,7,亞東-新竹,2024-06-20,2184
00948B,中信優息投資級債,6,0,6,亞東-新竹,2024-06-20,2184
2611,志信,6,0,6,亞東-新竹,2024-06-20,2184
5530,龍巖,6,0,6,亞東-新竹,2024-06-20,2184
6488,環球晶,6,0,6,亞東-新竹,2024-06-20,2184
8105,凌巨,6,0,6,亞東-新竹,2024-06-20,2184
3034,聯詠,5,0,5,亞東-新竹,2024-06-20,2184
00905,FT臺灣Smart,5,0,5,亞東-新竹,2024-06-20,2184
00795B,中信美國公債20年,5,0,5,亞東-新竹,2024-06-20,2184
00891,中信關鍵半導體,5,0,5,亞東-新竹,2024-06-20,2184
00632R,元大台灣50反1,30,25,5,亞東-新竹,2024-06-20,2184
1218,泰山,5,0,5,亞東-新竹,2024-06-20,2184
1301,台塑,5,0,5,亞東-新竹,2024-06-20,2184
1309,台達化,5,0,5,亞東-新竹,2024-06-20,2184
2023,燁輝,5,0,5,亞東-新竹,2024-06-20,2184
2354,鴻準,17,12,5,亞東-新竹,2024-06-20,2184
2892,第一金,5,0,5,亞東-新竹,2024-06-20,2184
3217,優群,5,0,5,亞東-新竹,2024-06-20,2184
3234,光環,10,5,5,亞東-新竹,2024-06-20,2184
00937B,群益ESG投等債20,173,62,111,亞東-新竹,2024-06-21,2184
2801,彰銀,100,0,100,亞東-新竹,2024-06-21,2184
00751B,元大AAA至A公司債,60,0,60,亞東-新竹,2024-06-21,2184
2317,鴻海,98,48,50,亞東-新竹,2024-06-21,2184
1809,中釉,50,0,50,亞東-新竹,2024-06-21,2184
2324,仁寶,50,0,50,亞東-新竹,2024-06-21,2184
2365,昆盈,28,0,28,亞東-新竹,2024-06-21,2184
00830,國泰費城半導體,22,0,22,亞東-新竹,2024-06-21,2184
00673R,期元大S＆P原油反1,21,0,21,亞東-新竹,2024-06-21,2184
00753L,中信中國50正2,20,0,20,亞東-新竹,2024-06-21,2184
2615,萬海,44,25,19,亞東-新竹,2024-06-21,2184
00850,元大臺灣ESG永續,15,0,15,亞東-新竹,2024-06-21,2184
2330,台積電,20,5,15,亞東-新竹,2024-06-21,2184
0056,元大高股息,19,7,12,亞東-新竹,2024-06-21,2184
2892,第一金,12,0,12,亞東-新竹,2024-06-21,2184
3551,世禾,13,1,12,亞東-新竹,2024-06-21,2184
00757,統一FANG+,11,0,11,亞東-新竹,2024-06-21,2184
00933B,國泰10Y+金融債,11,0,11,亞東-新竹,2024-06-21,2184
00931B,統一美債20年,10,0,10,亞東-新竹,2024-06-21,2184
00706L,期元大S＆P日圓正2,10,0,10,亞東-新竹,2024-06-21,2184
00693U,期街口S＆P黃豆,10,0,10,亞東-新竹,2024-06-21,2184
1455,集盛,10,0,10,亞東-新竹,2024-06-21,2184
1721,三晃,10,0,10,亞東-新竹,2024-06-21,2184
2405,輔信,10,0,10,亞東-新竹,2024-06-21,2184
3576,聯合再生,10,0,10,亞東-新竹,2024-06-21,2184
8076,伍豐,10,0,10,亞東-新竹,2024-06-21,2184
00679B,元大美債20年,18,9,9,亞東-新竹,2024-06-21,2184
00687B,國泰20年美債,9,0,9,亞東-新竹,2024-06-21,2184
6173,信昌電,9,1,8,亞東-新竹,2024-06-21,2184
2359,所羅門,18,11,7,亞東-新竹,2024-06-21,2184
3021,鴻名,7,0,7,亞東-新竹,2024-06-21,2184
00915,凱基優選高股息30,6,0,6,亞東-新竹,2024-06-21,2184
6188,廣明,8,2,6,亞東-新竹,2024-06-21,2184
00918,大華優利高填息30,6,0,6,亞東-新竹,2024-06-21,2184
00891,中信關鍵半導體,6,0,6,亞東-新竹,2024-06-21,2184
00940,元大台灣價值高息,8,2,6,亞東-新竹,2024-06-21,2184
2377,微星,6,0,6,亞東-新竹,2024-06-21,2184
3163,波若威,7,1,6,亞東-新竹,2024-06-21,2184
4714,永捷,6,0,6,亞東-新竹,2024-06-21,2184
4952,凌通,6,0,6,亞東-新竹,2024-06-21,2184
00881,國泰台灣5G+,5,0,5,亞東-新竹,2024-06-21,2184
00946,群益科技高息成長,5,0,5,亞東-新竹,2024-06-21,2184
01001T,土銀富邦R1,5,0,5,亞東-新竹,2024-06-21,2184
1324,地球,5,0,5,亞東-新竹,2024-06-21,2184
1504,東元,5,0,5,亞東-新竹,2024-06-21,2184
1514,亞力,12,7,5,亞東-新竹,2024-06-21,2184
1560,中砂,5,0,5,亞東-新竹,2024-06-21,2184
3217,優群,5,0,5,亞東-新竹,2024-06-21,2184
3687,歐買尬,5,0,5,亞東-新竹,2024-06-21,2184
4147,中裕,6,1,5,亞東-新竹,2024-06-21,2184
2888,新光金,610,50,560,亞東-新竹,2024-06-24,2184
00680L,元大美債20正2,230,0,230,亞東-新竹,2024-06-24,2184
00929,復華台灣科技優息,153,8,145,亞東-新竹,2024-06-24,2184
2485,兆赫,111,0,111,亞東-新竹,2024-06-24,2184
00919,群益台灣精選高息,139,43,96,亞東-新竹,2024-06-24,2184
3481,群創,131,39,92,亞東-新竹,2024-06-24,2184
3047,訊舟,76,0,76,亞東-新竹,2024-06-24,2184
00940,元大台灣價值高息,74,0,74,亞東-新竹,2024-06-24,2184
1722,台肥,46,0,46,亞東-新竹,2024-06-24,2184
00915,凱基優選高股息30,32,0,32,亞東-新竹,2024-06-24,2184
00937B,群益ESG投等債20,104,85,19,亞東-新竹,2024-06-24,2184
00830,國泰費城半導體,19,0,19,亞東-新竹,2024-06-24,2184
2634,漢翔,15,0,15,亞東-新竹,2024-06-24,2184
2897A,王道銀甲特,15,0,15,亞東-新竹,2024-06-24,2184
2338,光罩,15,2,13,亞東-新竹,2024-06-24,2184
00713,元大台灣高息低波,12,0,12,亞東-新竹,2024-06-24,2184
1702,南僑,12,0,12,亞東-新竹,2024-06-24,2184
2379,瑞昱,12,0,12,亞東-新竹,2024-06-24,2184
6257,矽格,11,0,11,亞東-新竹,2024-06-24,2184
5871,中租-KY,11,0,11,亞東-新竹,2024-06-24,2184
1326,台化,11,0,11,亞東-新竹,2024-06-24,2184
1409,新纖,11,0,11,亞東-新竹,2024-06-24,2184
3231,緯創,26,15,11,亞東-新竹,2024-06-24,2184
3372,典範,21,10,11,亞東-新竹,2024-06-24,2184
00931B,統一美債20年,10,0,10,亞東-新竹,2024-06-24,2184
00679B,元大美債20年,10,0,10,亞東-新竹,2024-06-24,2184
2314,台揚,10,0,10,亞東-新竹,2024-06-24,2184
6016,康和證,10,0,10,亞東-新竹,2024-06-24,2184
2615,萬海,10,1,9,亞東-新竹,2024-06-24,2184
6216,居易,9,0,9,亞東-新竹,2024-06-24,2184
00687B,國泰20年美債,8,0,8,亞東-新竹,2024-06-24,2184
00946,群益科技高息成長,8,0,8,亞東-新竹,2024-06-24,2184
4506,崇友,8,0,8,亞東-新竹,2024-06-24,2184
3149,正達,9,2,7,亞東-新竹,2024-06-24,2184
8016,矽創,7,0,7,亞東-新竹,2024-06-24,2184
2374,佳能,6,0,6,亞東-新竹,2024-06-24,2184
2406,國碩,13,7,6,亞東-新竹,2024-06-24,2184
3163,波若威,7,1,6,亞東-新竹,2024-06-24,2184
4714,永捷,6,0,6,亞東-新竹,2024-06-24,2184
5234,達興材料,6,0,6,亞東-新竹,2024-06-24,2184
2382,廣達,14,9,5,亞東-新竹,2024-06-24,2184
2363,矽統,5,0,5,亞東-新竹,2024-06-24,2184
2371,大同,5,0,5,亞東-新竹,2024-06-24,2184
1218,泰山,5,0,5,亞東-新竹,2024-06-24,2184
1303,南亞,5,0,5,亞東-新竹,2024-06-24,2184
00941,中信上游半導體,5,0,5,亞東-新竹,2024-06-24,2184
00935,野村臺灣新科技50,5,0,5,亞東-新竹,2024-06-24,2184
00795B,中信美國公債20年,5,0,5,亞東-新竹,2024-06-24,2184
00881,國泰台灣5G+,6,1,5,亞東-新竹,2024-06-24,2184
1325,恆大,5,0,5,亞東-新竹,2024-06-24,2184
2801,彰銀,162,0,162,亞東-新竹,2024-06-25,2184
00929,復華台灣科技優息,112,25,87,亞東-新竹,2024-06-25,2184
00937B,群益ESG投等債20,105,19,86,亞東-新竹,2024-06-25,2184
2409,友達,75,0,75,亞東-新竹,2024-06-25,2184
6695,芯鼎,64,3,61,亞東-新竹,2024-06-25,2184
2317,鴻海,84,23,61,亞東-新竹,2024-06-25,2184
00850,元大臺灣ESG永續,25,0,25,亞東-新竹,2024-06-25,2184
2337,旺宏,25,1,24,亞東-新竹,2024-06-25,2184
0056,元大高股息,24,3,21,亞東-新竹,2024-06-25,2184
6869,雲豹能源,20,0,20,亞東-新竹,2024-06-25,2184
3372,典範,20,1,19,亞東-新竹,2024-06-25,2184
00830,國泰費城半導體,17,0,17,亞東-新竹,2024-06-25,2184
3481,群創,105,89,16,亞東-新竹,2024-06-25,2184
3037,欣興,16,1,15,亞東-新竹,2024-06-25,2184
00936,台新永續高息中小,15,0,15,亞東-新竹,2024-06-25,2184
6016,康和證,15,0,15,亞東-新竹,2024-06-25,2184
2338,光罩,17,6,11,亞東-新竹,2024-06-25,2184
2882,國泰金,11,0,11,亞東-新竹,2024-06-25,2184
00675L,富邦臺灣加權正2,11,1,10,亞東-新竹,2024-06-25,2184
00947,台新臺灣IC設計,10,0,10,亞東-新竹,2024-06-25,2184
1460,宏遠,10,0,10,亞東-新竹,2024-06-25,2184
2393,億光,10,0,10,亞東-新竹,2024-06-25,2184
6285,啟��,10,0,10,亞東-新竹,2024-06-25,2184
9105,泰金寶-DR,10,0,10,亞東-新竹,2024-06-25,2184
00757,統一FANG+,10,0,10,亞東-新竹,2024-06-25,2184
3450,聯鈞,12,4,8,亞東-新竹,2024-06-25,2184
8016,矽創,8,0,8,亞東-新竹,2024-06-25,2184
3231,緯創,28,21,7,亞東-新竹,2024-06-25,2184
5871,中租-KY,11,4,7,亞東-新竹,2024-06-25,2184
2330,台積電,11,5,6,亞東-新竹,2024-06-25,2184
00946,群益科技高息成長,6,0,6,亞東-新竹,2024-06-25,2184
1102,亞泥,6,0,6,亞東-新竹,2024-06-25,2184
1616,億泰,6,0,6,亞東-新竹,2024-06-25,2184
00885,富邦越南,5,0,5,亞東-新竹,2024-06-25,2184
0050,元大台灣50,5,0,5,亞東-新竹,2024-06-25,2184
00712,復華富時不動產,5,0,5,亞東-新竹,2024-06-25,2184
2455,全新,5,0,5,亞東-新竹,2024-06-25,2184
2891,中信金,5,0,5,亞東-新竹,2024-06-25,2184
3048,益登,5,0,5,亞東-新竹,2024-06-25,2184
3217,優群,5,0,5,亞東-新竹,2024-06-25,2184
3289,宜特,17,12,5,亞東-新竹,2024-06-25,2184
9945,潤泰新,14,9,5,亞東-新竹,2024-06-25,2184
8255,朋程,6,1,5,亞東-新竹,2024-06-25,2184
00915,凱基優選高股息30,4,0,4,亞東-新竹,2024-06-25,2184
1326,台化,4,0,4,亞東-新竹,2024-06-25,2184
1319,東陽,4,0,4,亞東-新竹,2024-06-25,2184
2377,微星,4,0,4,亞東-新竹,2024-06-25,2184
2438,翔耀,4,0,4,亞東-新竹,2024-06-25,2184
2542,興富發,8,4,4,亞東-新竹,2024-06-25,2184
3551,世禾,4,0,4,亞東-新竹,2024-06-25,2184
00937B,群益ESG投等債20,119,0,119,亞東-新竹,2024-06-26,2184
6288,聯嘉,40,0,40,亞東-新竹,2024-06-26,2184
1785,光洋科,36,2,34,亞東-新竹,2024-06-26,2184
1460,宏遠,30,0,30,亞東-新竹,2024-06-26,2184
2897,王道銀行,30,0,30,亞東-新竹,2024-06-26,2184
00680L,元大美債20正2,21,0,21,亞東-新竹,2024-06-26,2184
3481,群創,84,66,18,亞東-新竹,2024-06-26,2184
2409,友達,21,5,16,亞東-新竹,2024-06-26,2184
2615,萬海,46,31,15,亞東-新竹,2024-06-26,2184
8110,華東,15,0,15,亞東-新竹,2024-06-26,2184
5483,中美晶,15,2,13,亞東-新竹,2024-06-26,2184
00940,元大台灣價值高息,12,0,12,亞東-新竹,2024-06-26,2184
1471,首利,10,0,10,亞東-新竹,2024-06-26,2184
020034,元大IC設計N,10,0,10,亞東-新竹,2024-06-26,2184
2406,國碩,16,6,10,亞東-新竹,2024-06-26,2184
2515,中工,10,0,10,亞東-新竹,2024-06-26,2184
2884,玉山金,10,0,10,亞東-新竹,2024-06-26,2184
2897A,王道銀甲特,10,0,10,亞東-新竹,2024-06-26,2184
9945,潤泰新,10,0,10,亞東-新竹,2024-06-26,2184
2360,致茂,11,1,10,亞東-新竹,2024-06-26,2184
00931B,統一美債20年,10,1,9,亞東-新竹,2024-06-26,2184
5371,中光電,12,3,9,亞東-新竹,2024-06-26,2184
3596,智易,8,0,8,亞東-新竹,2024-06-26,2184
5468,凱鈺,8,0,8,亞東-新竹,2024-06-26,2184
6239,力成,10,2,8,亞東-新竹,2024-06-26,2184
6684,安格,9,1,8,亞東-新竹,2024-06-26,2184
2845,遠東銀,7,0,7,亞東-新竹,2024-06-26,2184
3163,波若威,10,4,6,亞東-新竹,2024-06-26,2184
6139,亞翔,15,9,6,亞東-新竹,2024-06-26,2184
1312,國喬,6,0,6,亞東-新竹,2024-06-26,2184
2201,裕隆,13,7,6,亞東-新竹,2024-06-26,2184
2353,宏��,11,5,6,亞東-新竹,2024-06-26,2184
2374,佳能,25,19,6,亞東-新竹,2024-06-26,2184
2882,國泰金,5,0,5,亞東-新竹,2024-06-26,2184
3034,聯詠,7,2,5,亞東-新竹,2024-06-26,2184
00687B,國泰20年美債,5,0,5,亞東-新竹,2024-06-26,2184
00882,中信中國高股息,5,0,5,亞東-新竹,2024-06-26,2184
2101,南港,5,0,5,亞東-新竹,2024-06-26,2184
2337,旺宏,5,0,5,亞東-新竹,2024-06-26,2184
2834,臺企銀,5,0,5,亞東-新竹,2024-06-26,2184
3303,岱稜,5,0,5,亞東-新竹,2024-06-26,2184
3339,泰谷,5,0,5,亞東-新竹,2024-06-26,2184
3406,玉晶光,5,0,5,亞東-新竹,2024-06-26,2184
4908,前鼎,5,0,5,亞東-新竹,2024-06-26,2184
6645,金萬林-創,5,0,5,亞東-新竹,2024-06-26,2184
6877,鏵友益,5,0,5,亞東-新竹,2024-06-26,2184
3037,欣興,5,0,5,亞東-新竹,2024-06-26,2184
1301,台塑,4,0,4,亞東-新竹,2024-06-26,2184
1305,華夏,4,0,4,亞東-新竹,2024-06-26,2184
00942B,台新美A公司債20+,4,0,4,亞東-新竹,2024-06-26,2184
2883,凱基金,315,11,304,亞東-新竹,2024-06-27,2184
00937B,群益ESG投等債20,166,45,121,亞東-新竹,2024-06-27,2184
00687B,國泰20年美債,42,0,42,亞東-新竹,2024-06-27,2184
00878,國泰永續高股息,31,0,31,亞東-新竹,2024-06-27,2184
00751B,元大AAA至A公司債,30,0,30,亞東-新竹,2024-06-27,2184
1459,聯發,26,0,26,亞東-新竹,2024-06-27,2184
2374,佳能,24,0,24,亞東-新竹,2024-06-27,2184
2809,京城銀,22,0,22,亞東-新竹,2024-06-27,2184
00936,台新永續高息中小,20,0,20,亞東-新竹,2024-06-27,2184
3037,欣興,16,0,16,亞東-新竹,2024-06-27,2184
00900,富邦特選高股息30,14,0,14,亞東-新竹,2024-06-27,2184
3338,泰碩,14,1,13,亞東-新竹,2024-06-27,2184
5871,中租-KY,13,1,12,亞東-新竹,2024-06-27,2184
00929,復華台灣科技優息,11,0,11,亞東-新竹,2024-06-27,2184
00830,國泰費城半導體,11,0,11,亞東-新竹,2024-06-27,2184
00931B,統一美債20年,10,0,10,亞東-新竹,2024-06-27,2184
1560,中砂,11,1,10,亞東-新竹,2024-06-27,2184
2607,榮運,10,0,10,亞東-新竹,2024-06-27,2184
3048,益登,10,0,10,亞東-新竹,2024-06-27,2184
4157,太景*-KY,10,0,10,亞東-新竹,2024-06-27,2184
4167,松瑞藥,17,7,10,亞東-新竹,2024-06-27,2184
4938,和碩,10,0,10,亞東-新竹,2024-06-27,2184
1301,台塑,9,0,9,亞東-新竹,2024-06-27,2184
00753L,中信中國50正2,9,0,9,亞東-新竹,2024-06-27,2184
1324,地球,9,0,9,亞東-新竹,2024-06-27,2184
2885,元大金,59,51,8,亞東-新竹,2024-06-27,2184
2201,裕隆,8,0,8,亞東-新竹,2024-06-27,2184
0056,元大高股息,7,0,7,亞東-新竹,2024-06-27,2184
1402,遠東新,7,0,7,亞東-新竹,2024-06-27,2184
3312,弘憶股,7,0,7,亞東-新竹,2024-06-27,2184
3450,聯鈞,8,1,7,亞東-新竹,2024-06-27,2184
1709,和益,10,4,6,亞東-新竹,2024-06-27,2184
1303,南亞,6,0,6,亞東-新竹,2024-06-27,2184
1609,大亞,9,3,6,亞東-新竹,2024-06-27,2184
3372,典範,6,0,6,亞東-新竹,2024-06-27,2184
6257,矽格,6,0,6,亞東-新竹,2024-06-27,2184
00693U,期街口S＆P黃豆,5,0,5,亞東-新竹,2024-06-27,2184
00881,國泰台灣5G+,5,0,5,亞東-新竹,2024-06-27,2184
00795B,中信美國公債20年,5,0,5,亞東-新竹,2024-06-27,2184
1524,耿鼎,5,0,5,亞東-新竹,2024-06-27,2184
1734,杏輝,5,0,5,亞東-新竹,2024-06-27,2184
1781,合世,5,0,5,亞東-新竹,2024-06-27,2184
1802,台玻,5,0,5,亞東-新竹,2024-06-27,2184
2313,華通,8,3,5,亞東-新竹,2024-06-27,2184
2605,新興,6,1,5,亞東-新竹,2024-06-27,2184
2897,王道銀行,5,0,5,亞東-新竹,2024-06-27,2184
3024,憶聲,5,0,5,亞東-新竹,2024-06-27,2184
3705,永信,5,0,5,亞東-新竹,2024-06-27,2184
3711,日月光投控,5,0,5,亞東-新竹,2024-06-27,2184
6231,系微,6,1,5,亞東-新竹,2024-06-27,2184
2888,新光金,365,71,294,亞東-新竹,2024-06-28,2184
2913,農林,193,0,193,亞東-新竹,2024-06-28,2184
00937B,群益ESG投等債20,124,0,124,亞東-新竹,2024-06-28,2184
00687B,國泰20年美債,66,0,66,亞東-新竹,2024-06-28,2184
2406,國碩,98,43,55,亞東-新竹,2024-06-28,2184
00632R,元大台灣50反1,50,0,50,亞東-新竹,2024-06-28,2184
00679B,元大美債20年,45,0,45,亞東-新竹,2024-06-28,2184
2201,裕隆,56,25,31,亞東-新竹,2024-06-28,2184
2609,陽明,30,1,29,亞東-新竹,2024-06-28,2184
00675L,富邦臺灣加權正2,27,1,26,亞東-新竹,2024-06-28,2184
8110,華東,24,0,24,亞東-新竹,2024-06-28,2184
6244,茂迪,45,24,21,亞東-新竹,2024-06-28,2184
1809,中釉,20,0,20,亞東-新竹,2024-06-28,2184
2883B,凱基金乙特,20,0,20,亞東-新竹,2024-06-28,2184
8440,綠電,23,7,16,亞東-新竹,2024-06-28,2184
2884,玉山金,11,0,11,亞東-新竹,2024-06-28,2184
3498,陽程,13,2,11,亞東-新竹,2024-06-28,2184
1781,合世,10,0,10,亞東-新竹,2024-06-28,2184
2337,旺宏,10,0,10,亞東-新竹,2024-06-28,2184
2897,王道銀行,10,0,10,亞東-新竹,2024-06-28,2184
3211,順達,10,0,10,亞東-新竹,2024-06-28,2184
6215,和椿,10,0,10,亞東-新竹,2024-06-28,2184
8926,台汽電,10,0,10,亞東-新竹,2024-06-28,2184
6257,矽格,11,1,10,亞東-新竹,2024-06-28,2184
2610,華航,9,0,9,亞東-新竹,2024-06-28,2184
00751B,元大AAA至A公司債,9,0,9,亞東-新竹,2024-06-28,2184
3163,波若威,10,1,9,亞東-新竹,2024-06-28,2184
5515,建國,9,0,9,亞東-新竹,2024-06-28,2184
00929,復華台灣科技優息,8,0,8,亞東-新竹,2024-06-28,2184
00919,群益台灣精選高息,8,0,8,亞東-新竹,2024-06-28,2184
2509,全坤建,8,0,8,亞東-新竹,2024-06-28,2184
00936,台新永續高息中小,7,0,7,亞東-新竹,2024-06-28,2184
00720B,元大投資級公司債,7,0,7,亞東-新竹,2024-06-28,2184
00680L,元大美債20正2,7,0,7,亞東-新竹,2024-06-28,2184
3520,華盈,7,0,7,亞東-新竹,2024-06-28,2184
5371,中光電,8,1,7,亞東-新竹,2024-06-28,2184
2303,聯電,8,2,6,亞東-新竹,2024-06-28,2184
6509,聚和,7,1,6,亞東-新竹,2024-06-28,2184
6770,力積電,10,4,6,亞東-新竹,2024-06-28,2184
9904,寶成,6,0,6,亞東-新竹,2024-06-28,2184
9958,世紀鋼,6,0,6,亞東-新竹,2024-06-28,2184
5351,鈺創,5,0,5,亞東-新竹,2024-06-28,2184
00712,復華富時不動產,5,0,5,亞東-新竹,2024-06-28,2184
00795B,中信美國公債20年,5,0,5,亞東-新竹,2024-06-28,2184
00882,中信中國高股息,5,0,5,亞東-新竹,2024-06-28,2184
1313,聯成,5,0,5,亞東-新竹,2024-06-28,2184
2002,中鋼,5,0,5,亞東-新竹,2024-06-28,2184
4931,新盛力,5,0,5,亞東-新竹,2024-06-28,2184
5392,能率,5,0,5,亞東-新竹,2024-06-28,2184
6220,岳豐,5,0,5,亞東-新竹,2024-06-28,2184
2888,新光金,710,30,680,亞東-新竹,2024-07-01,2184
00937B,群益ESG投等債20,126,0,126,亞東-新竹,2024-07-01,2184
2609,陽明,84,7,77,亞東-新竹,2024-07-01,2184
00933B,國泰10Y+金融債,70,14,56,亞東-新竹,2024-07-01,2184
2367,燿華,38,2,36,亞東-新竹,2024-07-01,2184
9904,寶成,35,0,35,亞東-新竹,2024-07-01,2184
0056,元大高股息,34,0,34,亞東-新竹,2024-07-01,2184
00687B,國泰20年美債,34,0,34,亞東-新竹,2024-07-01,2184
2406,國碩,50,16,34,亞東-新竹,2024-07-01,2184
00929,復華台灣科技優息,32,3,29,亞東-新竹,2024-07-01,2184
6770,力積電,29,3,26,亞東-新竹,2024-07-01,2184
2317,鴻海,41,19,22,亞東-新竹,2024-07-01,2184
6257,矽格,21,0,21,亞東-新竹,2024-07-01,2184
3483,力致,20,0,20,亞東-新竹,2024-07-01,2184
00751B,元大AAA至A公司債,19,0,19,亞東-新竹,2024-07-01,2184
00939,統一台灣高息動能,19,1,18,亞東-新竹,2024-07-01,2184
00681R,元大美債20反1,15,0,15,亞東-新竹,2024-07-01,2184
1587,吉茂,15,0,15,亞東-新竹,2024-07-01,2184
2515,中工,15,0,15,亞東-新竹,2024-07-01,2184
2882,國泰金,18,4,14,亞東-新竹,2024-07-01,2184
2897A,王道銀甲特,12,0,12,亞東-新竹,2024-07-01,2184
2337,旺宏,11,0,11,亞東-新竹,2024-07-01,2184
00931B,統一美債20年,10,0,10,亞東-新竹,2024-07-01,2184
00857B,永豐20年美公債,10,0,10,亞東-新竹,2024-07-01,2184
6176,瑞儀,10,0,10,亞東-新竹,2024-07-01,2184
6269,台郡,10,0,10,亞東-新竹,2024-07-01,2184
6271,同欣電,10,0,10,亞東-新竹,2024-07-01,2184
4967,十銓,10,1,9,亞東-新竹,2024-07-01,2184
6285,啟��,9,0,9,亞東-新竹,2024-07-01,2184
2618,長榮航,9,0,9,亞東-新竹,2024-07-01,2184
00679B,元大美債20年,31,23,8,亞東-新竹,2024-07-01,2184
2359,所羅門,25,17,8,亞東-新竹,2024-07-01,2184
3498,陽程,8,0,8,亞東-新竹,2024-07-01,2184
3006,晶豪科,7,0,7,亞東-新竹,2024-07-01,2184
6753,龍德造船,7,0,7,亞東-新竹,2024-07-01,2184
2610,華航,12,5,7,亞東-新竹,2024-07-01,2184
2883,凱基金,7,0,7,亞東-新竹,2024-07-01,2184
8932,智通*,7,0,7,亞東-新竹,2024-07-01,2184
00905,FT臺灣Smart,6,0,6,亞東-新竹,2024-07-01,2184
2107,厚生,6,0,6,亞東-新竹,2024-07-01,2184
2449,京元電子,6,0,6,亞東-新竹,2024-07-01,2184
2867,三商壽,6,0,6,亞東-新竹,2024-07-01,2184
5225,東科-KY,6,0,6,亞東-新竹,2024-07-01,2184
6667,信紘科,13,7,6,亞東-新竹,2024-07-01,2184
00795B,中信美國公債20年,5,0,5,亞東-新竹,2024-07-01,2184
1440,南紡,5,0,5,亞東-新竹,2024-07-01,2184
1734,杏輝,5,0,5,亞東-新竹,2024-07-01,2184
1785,光洋科,15,10,5,亞東-新竹,2024-07-01,2184
2002,中鋼,5,0,5,亞東-新竹,2024-07-01,2184
2409,友達,5,0,5,亞東-新竹,2024-07-01,2184
00934,中信成長高股息,150,0,150,亞東-新竹,2024-07-02,2184
00680L,元大美債20正2,169,25,144,亞東-新竹,2024-07-02,2184
00929,復華台灣科技優息,103,4,99,亞東-新竹,2024-07-02,2184
2301,光寶科,97,0,97,亞東-新竹,2024-07-02,2184
2882,國泰金,89,3,86,亞東-新竹,2024-07-02,2184
2303,聯電,111,30,81,亞東-新竹,2024-07-02,2184
00937B,群益ESG投等債20,57,0,57,亞東-新竹,2024-07-02,2184
00673R,期元大S＆P原油反1,56,0,56,亞東-新竹,2024-07-02,2184
9105,泰金寶-DR,50,0,50,亞東-新竹,2024-07-02,2184
00940,元大台灣價值高息,33,0,33,亞東-新竹,2024-07-02,2184
00687B,國泰20年美債,31,0,31,亞東-新竹,2024-07-02,2184
1565,精華,31,0,31,亞東-新竹,2024-07-02,2184
00720B,元大投資級公司債,30,0,30,亞東-新竹,2024-07-02,2184
8107,大億金茂,29,0,29,亞東-新竹,2024-07-02,2184
00712,復華富時不動產,27,0,27,亞東-新竹,2024-07-02,2184
3374,精材,23,0,23,亞東-新竹,2024-07-02,2184
8086,宏捷科,21,0,21,亞東-新竹,2024-07-02,2184
2027,大成鋼,20,0,20,亞東-新竹,2024-07-02,2184
2353,宏��,20,1,19,亞東-新竹,2024-07-02,2184
00679B,元大美債20年,21,5,16,亞東-新竹,2024-07-02,2184
3705,永信,16,0,16,亞東-新竹,2024-07-02,2184
1718,中纖,15,0,15,亞東-新竹,2024-07-02,2184
2367,燿華,23,8,15,亞東-新竹,2024-07-02,2184
9904,寶成,16,1,15,亞東-新竹,2024-07-02,2184
0056,元大高股息,14,0,14,亞東-新竹,2024-07-02,2184
00795B,中信美國公債20年,13,0,13,亞東-新竹,2024-07-02,2184
1609,大亞,16,3,13,亞東-新竹,2024-07-02,2184
2515,中工,13,0,13,亞東-新竹,2024-07-02,2184
00931B,統一美債20年,12,0,12,亞東-新竹,2024-07-02,2184
00919,群益台灣精選高息,23,12,11,亞東-新竹,2024-07-02,2184
2897A,王道銀甲特,11,0,11,亞東-新竹,2024-07-02,2184
00915,凱基優選高股息30,10,0,10,亞東-新竹,2024-07-02,2184
2002,中鋼,13,3,10,亞東-新竹,2024-07-02,2184
00918,大華優利高填息30,10,0,10,亞東-新竹,2024-07-02,2184
1460,宏遠,10,0,10,亞東-新竹,2024-07-02,2184
2337,旺宏,10,0,10,亞東-新竹,2024-07-02,2184
2834,臺企銀,110,100,10,亞東-新竹,2024-07-02,2184
6176,瑞儀,10,0,10,亞東-新竹,2024-07-02,2184
00949,復華日本龍頭,9,0,9,亞東-新竹,2024-07-02,2184
3048,益登,14,5,9,亞東-新竹,2024-07-02,2184
6133,金橋,9,0,9,亞東-新竹,2024-07-02,2184
6239,力成,9,0,9,亞東-新竹,2024-07-02,2184
00751B,元大AAA至A公司債,8,0,8,亞東-新竹,2024-07-02,2184
5426,振發,10,2,8,亞東-新竹,2024-07-02,2184
5452,佶優,8,0,8,亞東-新竹,2024-07-02,2184
6182,合晶,8,0,8,亞東-新竹,2024-07-02,2184
2412,中華電,7,0,7,亞東-新竹,2024-07-02,2184
1326,台化,7,0,7,亞東-新竹,2024-07-02,2184
6213,聯茂,8,1,7,亞東-新竹,2024-07-02,2184
3481,群創,6,0,6,亞東-新竹,2024-07-02,2184
00680L,元大美債20正2,471,0,471,亞東-新竹,2024-07-03,2184
3576,聯合再生,308,3,305,亞東-新竹,2024-07-03,2184
2888,新光金,373,200,173,亞東-新竹,2024-07-03,2184
00934,中信成長高股息,131,0,131,亞東-新竹,2024-07-03,2184
00929,復華台灣科技優息,67,6,61,亞東-新竹,2024-07-03,2184
2882,國泰金,89,33,56,亞東-新竹,2024-07-03,2184
2367,燿華,74,32,42,亞東-新竹,2024-07-03,2184
2464,盟立,45,7,38,亞東-新竹,2024-07-03,2184
3060,銘異,30,0,30,亞東-新竹,2024-07-03,2184
9946,三發地產,25,0,25,亞東-新竹,2024-07-03,2184
2615,萬海,35,14,21,亞東-新竹,2024-07-03,2184
00857B,永豐20年美公債,20,0,20,亞東-新竹,2024-07-03,2184
2455,全新,25,5,20,亞東-新竹,2024-07-03,2184
2317,鴻海,35,16,19,亞東-新竹,2024-07-03,2184
00946,群益科技高息成長,15,0,15,亞東-新竹,2024-07-03,2184
00679B,元大美債20年,20,5,15,亞東-新竹,2024-07-03,2184
00927,群益半導體收益,15,0,15,亞東-新竹,2024-07-03,2184
00795B,中信美國公債20年,15,0,15,亞東-新竹,2024-07-03,2184
9105,泰金寶-DR,15,0,15,亞東-新竹,2024-07-03,2184
2337,旺宏,21,7,14,亞東-新竹,2024-07-03,2184
9904,寶成,16,2,14,亞東-新竹,2024-07-03,2184
00764B,群益25年美債,13,0,13,亞東-新竹,2024-07-03,2184
00687B,國泰20年美債,13,0,13,亞東-新竹,2024-07-03,2184
00696B,富邦美債20年,13,0,13,亞東-新竹,2024-07-03,2184
2344,華邦電,18,6,12,亞東-新竹,2024-07-03,2184
3705,永信,12,0,12,亞東-新竹,2024-07-03,2184
00936,台新永續高息中小,20,9,11,亞東-新竹,2024-07-03,2184
8107,大億金茂,11,0,11,亞東-新竹,2024-07-03,2184
00931B,統一美債20年,10,0,10,亞東-新竹,2024-07-03,2184
2607,榮運,10,0,10,亞東-新竹,2024-07-03,2184
3303,岱稜,10,0,10,亞東-新竹,2024-07-03,2184
3518,柏騰,10,0,10,亞東-新竹,2024-07-03,2184
4303,信立,11,1,10,亞東-新竹,2024-07-03,2184
3287,廣寰科,9,0,9,亞東-新竹,2024-07-03,2184
3591,艾笛森,9,0,9,亞東-新竹,2024-07-03,2184
8103,瀚荃,9,0,9,亞東-新竹,2024-07-03,2184
2201,裕隆,16,8,8,亞東-新竹,2024-07-03,2184
3294,英濟,7,0,7,亞東-新竹,2024-07-03,2184
6443,元晶,11,4,7,亞東-新竹,2024-07-03,2184
3034,聯詠,6,0,6,亞東-新竹,2024-07-03,2184
1565,精華,6,0,6,亞東-新竹,2024-07-03,2184
2354,鴻準,10,4,6,亞東-新竹,2024-07-03,2184
2409,友達,7,1,6,亞東-新竹,2024-07-03,2184
3234,光環,6,0,6,亞東-新竹,2024-07-03,2184
3499,環天科,6,0,6,亞東-新竹,2024-07-03,2184
6806,森崴能源,8,3,5,亞東-新竹,2024-07-03,2184
00655L,國泰中國A50正2,5,0,5,亞東-新竹,2024-07-03,2184
00712,復華富時不動產,5,0,5,亞東-新竹,2024-07-03,2184
2308,台達電,9,4,5,亞東-新竹,2024-07-03,2184
2374,佳能,5,0,5,亞東-新竹,2024-07-03,2184
2888,新光金,420,152,268,亞東-新竹,2024-07-04,2184
00632R,元大台灣50反1,125,0,125,亞東-新竹,2024-07-04,2184
2882,國泰金,86,0,86,亞東-新竹,2024-07-04,2184
00720B,元大投資級公司債,82,0,82,亞東-新竹,2024-07-04,2184
00929,復華台灣科技優息,64,14,50,亞東-新竹,2024-07-04,2184
00680L,元大美債20正2,66,20,46,亞東-新竹,2024-07-04,2184
2412,中華電,45,0,45,亞東-新竹,2024-07-04,2184
6443,元晶,45,3,42,亞東-新竹,2024-07-04,2184
2301,光寶科,45,8,37,亞東-新竹,2024-07-04,2184
00937B,群益ESG投等債20,34,0,34,亞東-新竹,2024-07-04,2184
6143,振曜,30,0,30,亞東-新竹,2024-07-04,2184
6477,安集,25,0,25,亞東-新竹,2024-07-04,2184
2406,國碩,20,0,20,亞東-新竹,2024-07-04,2184
3060,銘異,20,0,20,亞東-新竹,2024-07-04,2184
2317,鴻海,63,44,19,亞東-新竹,2024-07-04,2184
2812,台中銀,18,0,18,亞東-新竹,2024-07-04,2184
1409,新纖,20,2,18,亞東-新竹,2024-07-04,2184
2367,燿華,17,0,17,亞東-新竹,2024-07-04,2184
2329,華泰,15,0,15,亞東-新竹,2024-07-04,2184
3189,景碩,15,0,15,亞東-新竹,2024-07-04,2184
8054,安國,16,1,15,亞東-新竹,2024-07-04,2184
00675L,富邦臺灣加權正2,15,1,14,亞東-新竹,2024-07-04,2184
3374,精材,16,2,14,亞東-新竹,2024-07-04,2184
00918,大華優利高填息30,11,0,11,亞東-新竹,2024-07-04,2184
1611,中電,11,0,11,亞東-新竹,2024-07-04,2184
3149,正達,11,0,11,亞東-新竹,2024-07-04,2184
00655L,國泰中國A50正2,10,0,10,亞東-新竹,2024-07-04,2184
1447,力鵬,10,0,10,亞東-新竹,2024-07-04,2184
2809,京城銀,9,0,9,亞東-新竹,2024-07-04,2184
5371,中光電,10,1,9,亞東-新竹,2024-07-04,2184
00725B,國泰投資級公司債,8,0,8,亞東-新竹,2024-07-04,2184
6147,頎邦,7,0,7,亞東-新竹,2024-07-04,2184
4147,中裕,7,0,7,亞東-新竹,2024-07-04,2184
8104,錸寶,7,0,7,亞東-新竹,2024-07-04,2184
00934,中信成長高股息,11,5,6,亞東-新竹,2024-07-04,2184
3322,建舜電,6,0,6,亞東-新竹,2024-07-04,2184
3372,典範,11,5,6,亞東-新竹,2024-07-04,2184
5347,世界,7,1,6,亞東-新竹,2024-07-04,2184
6213,聯茂,6,0,6,亞東-新竹,2024-07-04,2184
6231,系微,7,1,6,亞東-新竹,2024-07-04,2184
6509,聚和,6,0,6,亞東-新竹,2024-07-04,2184
8096,擎亞,6,0,6,亞東-新竹,2024-07-04,2184
911608,明輝-DR,6,0,6,亞東-新竹,2024-07-04,2184
00687B,國泰20年美債,8,3,5,亞東-新竹,2024-07-04,2184
1316,上曜,5,0,5,亞東-新竹,2024-07-04,2184
1418,東華,5,0,5,亞東-新竹,2024-07-04,2184
1565,精華,5,0,5,亞東-新竹,2024-07-04,2184
1815,富喬,5,0,5,亞東-新竹,2024-07-04,2184
2417,圓剛,9,4,5,亞東-新竹,2024-07-04,2184
2440,太空梭,5,0,5,亞東-新竹,2024-07-04,2184
00687B,國泰20年美債,433,0,433,亞東-新竹,2024-07-05,2184
2618,長榮航,130,34,96,亞東-新竹,2024-07-05,2184
00637L,元大滬深300正2,35,0,35,亞東-新竹,2024-07-05,2184
4716,大立,35,0,35,亞東-新竹,2024-07-05,2184
1506,正道,30,0,30,亞東-新竹,2024-07-05,2184
5481,新華,29,0,29,亞東-新竹,2024-07-05,2184
3289,宜特,27,0,27,亞東-新竹,2024-07-05,2184
3374,精材,48,21,27,亞東-新竹,2024-07-05,2184
00720B,元大投資級公司債,23,0,23,亞東-新竹,2024-07-05,2184
2889,國票金,23,0,23,亞東-新竹,2024-07-05,2184
2607,榮運,20,0,20,亞東-新竹,2024-07-05,2184
00934,中信成長高股息,24,5,19,亞東-新竹,2024-07-05,2184
00882,中信中國高股息,18,0,18,亞東-新竹,2024-07-05,2184
2303,聯電,21,3,18,亞東-新竹,2024-07-05,2184
2344,華邦電,15,0,15,亞東-新竹,2024-07-05,2184
2482,連宇,13,0,13,亞東-新竹,2024-07-05,2184
6164,華興,12,0,12,亞東-新竹,2024-07-05,2184
00675L,富邦臺灣加權正2,11,0,11,亞東-新竹,2024-07-05,2184
2356,英業達,14,3,11,亞東-新竹,2024-07-05,2184
3711,日月光投控,11,0,11,亞東-新竹,2024-07-05,2184
3006,晶豪科,10,0,10,亞東-新竹,2024-07-05,2184
00632R,元大台灣50反1,10,0,10,亞東-新竹,2024-07-05,2184
00909,國泰數位支付服務,10,0,10,亞東-新竹,2024-07-05,2184
00679B,元大美債20年,10,0,10,亞東-新竹,2024-07-05,2184
00923,群益台ESG低碳50,10,0,10,亞東-新竹,2024-07-05,2184
1702,南僑,10,0,10,亞東-新竹,2024-07-05,2184
2201,裕隆,14,4,10,亞東-新竹,2024-07-05,2184
2543,皇昌,10,0,10,亞東-新竹,2024-07-05,2184
6277,宏正,10,0,10,亞東-新竹,2024-07-05,2184
8091,翔名,10,0,10,亞東-新竹,2024-07-05,2184
6120,達運,9,0,9,亞東-新竹,2024-07-05,2184
00937B,群益ESG投等債20,8,0,8,亞東-新竹,2024-07-05,2184
3260,威剛,8,0,8,亞東-新竹,2024-07-05,2184
1503,士電,7,0,7,亞東-新竹,2024-07-05,2184
3708,上緯投控,13,6,7,亞東-新竹,2024-07-05,2184
2363,矽統,28,21,7,亞東-新竹,2024-07-05,2184
2454,聯發科,6,0,6,亞東-新竹,2024-07-05,2184
6451,訊芯-KY,6,0,6,亞東-新竹,2024-07-05,2184
1102,亞泥,6,0,6,亞東-新竹,2024-07-05,2184
1303,南亞,6,0,6,亞東-新竹,2024-07-05,2184
2020,美亞,6,0,6,亞東-新竹,2024-07-05,2184
2369,菱生,6,0,6,亞東-新竹,2024-07-05,2184
3321,同泰,6,0,6,亞東-新竹,2024-07-05,2184
00753L,中信中國50正2,5,0,5,亞東-新竹,2024-07-05,2184
1314,中石化,5,0,5,亞東-新竹,2024-07-05,2184
1609,大亞,6,1,5,亞東-新竹,2024-07-05,2184
1809,中釉,5,0,5,亞東-新竹,2024-07-05,2184
2349,錸德,5,0,5,亞東-新竹,2024-07-05,2184
3234,光環,5,0,5,亞東-新竹,2024-07-05,2184
3450,聯鈞,11,6,5,亞東-新竹,2024-07-05,2184
00680L,元大美債20正2,350,0,350,亞東-新竹,2024-07-08,2184
2610,華航,215,10,205,亞東-新竹,2024-07-08,2184
00720B,元大投資級公司債,134,0,134,亞東-新竹,2024-07-08,2184
00751B,元大AAA至A公司債,94,0,94,亞東-新竹,2024-07-08,2184
2363,矽統,104,17,87,亞東-新竹,2024-07-08,2184
9904,寶成,51,0,51,亞東-新竹,2024-07-08,2184
00632R,元大台灣50反1,60,20,40,亞東-新竹,2024-07-08,2184
5309,系統電,35,0,35,亞東-新竹,2024-07-08,2184
2427,三商電,41,12,29,亞東-新竹,2024-07-08,2184
00934,中信成長高股息,29,5,24,亞東-新竹,2024-07-08,2184
00919,群益台灣精選高息,22,0,22,亞東-新竹,2024-07-08,2184
2412,中華電,21,0,21,亞東-新竹,2024-07-08,2184
00878,國泰永續高股息,22,2,20,亞東-新竹,2024-07-08,2184
00940,元大台灣價值高息,21,1,20,亞東-新竹,2024-07-08,2184
00895,富邦未來車,20,0,20,亞東-新竹,2024-07-08,2184
3652,精聯,18,0,18,亞東-新竹,2024-07-08,2184
2359,所羅門,23,7,16,亞東-新竹,2024-07-08,2184
2464,盟立,29,13,16,亞東-新竹,2024-07-08,2184
6168,宏齊,15,0,15,亞東-新竹,2024-07-08,2184
2354,鴻準,18,3,15,亞東-新竹,2024-07-08,2184
2353,宏��,16,2,14,亞東-新竹,2024-07-08,2184
3499,環天科,12,0,12,亞東-新竹,2024-07-08,2184
00712,復華富時不動產,11,0,11,亞東-新竹,2024-07-08,2184
00687B,國泰20年美債,11,0,11,亞東-新竹,2024-07-08,2184
1708,東鹼,11,0,11,亞東-新竹,2024-07-08,2184
3035,智原,11,0,11,亞東-新竹,2024-07-08,2184
2349,錸德,12,1,11,亞東-新竹,2024-07-08,2184
2618,長榮航,20,10,10,亞東-新竹,2024-07-08,2184
00945B,凱基美國非投等債,10,0,10,亞東-新竹,2024-07-08,2184
3380,明泰,10,0,10,亞東-新竹,2024-07-08,2184
3711,日月光投控,10,0,10,亞東-新竹,2024-07-08,2184
6443,元晶,10,0,10,亞東-新竹,2024-07-08,2184
8071,能率網通,10,0,10,亞東-新竹,2024-07-08,2184
00679B,元大美債20年,18,9,9,亞東-新竹,2024-07-08,2184
3211,順達,10,1,9,亞東-新竹,2024-07-08,2184
4526,東台,9,0,9,亞東-新竹,2024-07-08,2184
3703,欣陸,8,0,8,亞東-新竹,2024-07-08,2184
2337,旺宏,15,7,8,亞東-新竹,2024-07-08,2184
3025,星通,8,0,8,亞東-新竹,2024-07-08,2184
3062,建漢,9,1,8,亞東-新竹,2024-07-08,2184
6152,百一,8,0,8,亞東-新竹,2024-07-08,2184
1529,樂事綠能,7,0,7,亞東-新竹,2024-07-08,2184
1785,光洋科,16,9,7,亞東-新竹,2024-07-08,2184
2406,國碩,9,2,7,亞東-新竹,2024-07-08,2184
4976,佳凌,7,0,7,亞東-新竹,2024-07-08,2184
6706,惠特,13,6,7,亞東-新竹,2024-07-08,2184
3481,群創,9,2,7,亞東-新竹,2024-07-08,2184
6451,訊芯-KY,15,9,6,亞東-新竹,2024-07-08,2184
1316,上曜,6,0,6,亞東-新竹,2024-07-08,2184
1702,南僑,6,0,6,亞東-新竹,2024-07-08,2184
2883,凱基金,300,1,299,亞東-新竹,2024-07-09,2184
00720B,元大投資級公司債,188,19,169,亞東-新竹,2024-07-09,2184
2609,陽明,138,15,123,亞東-新竹,2024-07-09,2184
2882,國泰金,180,101,79,亞東-新竹,2024-07-09,2184
00929,復華台灣科技優息,44,8,36,亞東-新竹,2024-07-09,2184
2891,中信金,32,0,32,亞東-新竹,2024-07-09,2184
2367,燿華,54,24,30,亞東-新竹,2024-07-09,2184
2427,三商電,26,0,26,亞東-新竹,2024-07-09,2184
6770,力積電,52,28,24,亞東-新竹,2024-07-09,2184
1513,中興電,27,4,23,亞東-新竹,2024-07-09,2184
2402,毅嘉,20,0,20,亞東-新竹,2024-07-09,2184
2885,元大金,20,1,19,亞東-新竹,2024-07-09,2184
9103,美德醫療-DR,20,1,19,亞東-新竹,2024-07-09,2184
3673,TPK-KY,29,11,18,亞東-新竹,2024-07-09,2184
2409,友達,16,0,16,亞東-新竹,2024-07-09,2184
2618,長榮航,21,5,16,亞東-新竹,2024-07-09,2184
3047,訊舟,26,11,15,亞東-新竹,2024-07-09,2184
4105,東洋,15,1,14,亞東-新竹,2024-07-09,2184
5371,中光電,14,0,14,亞東-新竹,2024-07-09,2184
2201,裕隆,19,6,13,亞東-新竹,2024-07-09,2184
00905,FT臺灣Smart,12,0,12,亞東-新竹,2024-07-09,2184
2412,中華電,12,0,12,亞東-新竹,2024-07-09,2184
3034,聯詠,11,0,11,亞東-新竹,2024-07-09,2184
2002,中鋼,11,0,11,亞東-新竹,2024-07-09,2184
2374,佳能,21,10,11,亞東-新竹,2024-07-09,2184
3045,台灣大,11,0,11,亞東-新竹,2024-07-09,2184
3231,緯創,14,3,11,亞東-新竹,2024-07-09,2184
6263,普萊德,11,0,11,亞東-新竹,2024-07-09,2184
00632R,元大台灣50反1,10,0,10,亞東-新竹,2024-07-09,2184
00715L,期街口布蘭特正2,10,0,10,亞東-新竹,2024-07-09,2184
2845,遠東銀,30,20,10,亞東-新竹,2024-07-09,2184
2886,兆豐金,10,0,10,亞東-新竹,2024-07-09,2184
2887,台新金,20,10,10,亞東-新竹,2024-07-09,2184
3050,鈺德,10,0,10,亞東-新竹,2024-07-09,2184
5328,華容,10,0,10,亞東-新竹,2024-07-09,2184
3019,亞光,9,0,9,亞東-新竹,2024-07-09,2184
6901,鑽石投資,9,0,9,亞東-新竹,2024-07-09,2184
00713,元大台灣高息低波,8,0,8,亞東-新竹,2024-07-09,2184
3169,亞信,8,0,8,亞東-新竹,2024-07-09,2184
3287,廣寰科,8,0,8,亞東-新竹,2024-07-09,2184
2603,長榮,9,2,7,亞東-新竹,2024-07-09,2184
1301,台塑,7,0,7,亞東-新竹,2024-07-09,2184
2405,輔信,22,15,7,亞東-新竹,2024-07-09,2184
2834,臺企銀,209,202,7,亞東-新竹,2024-07-09,2184
5351,鈺創,6,0,6,亞東-新竹,2024-07-09,2184
1785,光洋科,16,10,6,亞東-新竹,2024-07-09,2184
00936,台新永續高息中小,6,0,6,亞東-新竹,2024-07-09,2184
1529,樂事綠能,9,3,6,亞東-新竹,2024-07-09,2184
2316,楠梓電,6,0,6,亞東-新竹,2024-07-09,2184
2337,旺宏,11,5,6,亞東-新竹,2024-07-09,2184
00680L,元大美債20正2,155,0,155,亞東-新竹,2024-07-10,2184
2882,國泰金,80,4,76,亞東-新竹,2024-07-10,2184
9946,三發地產,60,0,60,亞東-新竹,2024-07-10,2184
9904,寶成,51,0,51,亞東-新竹,2024-07-10,2184
6443,元晶,42,1,41,亞東-新竹,2024-07-10,2184
00949,復華日本龍頭,40,0,40,亞東-新竹,2024-07-10,2184
2455,全新,40,0,40,亞東-新竹,2024-07-10,2184
2867,三商壽,40,5,35,亞東-新竹,2024-07-10,2184
2329,華泰,30,2,28,亞東-新竹,2024-07-10,2184
8105,凌巨,30,6,24,亞東-新竹,2024-07-10,2184
00725B,國泰投資級公司債,23,0,23,亞東-新竹,2024-07-10,2184
2845,遠東銀,20,0,20,亞東-新竹,2024-07-10,2184
2371,大同,25,8,17,亞東-新竹,2024-07-10,2184
2374,佳能,30,13,17,亞東-新竹,2024-07-10,2184
4904,遠傳,16,1,15,亞東-新竹,2024-07-10,2184
5243,乙盛-KY,15,0,15,亞東-新竹,2024-07-10,2184
6277,宏正,15,0,15,亞東-新竹,2024-07-10,2184
2388,威盛,22,7,15,亞東-新竹,2024-07-10,2184
00720B,元大投資級公司債,14,0,14,亞東-新竹,2024-07-10,2184
00751B,元大AAA至A公司債,58,44,14,亞東-新竹,2024-07-10,2184
3522,御嵿,13,0,13,亞東-新竹,2024-07-10,2184
3710,連展投控,13,0,13,亞東-新竹,2024-07-10,2184
2002,中鋼,12,1,11,亞東-新竹,2024-07-10,2184
1513,中興電,73,62,11,亞東-新竹,2024-07-10,2184
2312,金寶,18,7,11,亞東-新竹,2024-07-10,2184
2609,陽明,19,8,11,亞東-新竹,2024-07-10,2184
3231,緯創,13,2,11,亞東-新竹,2024-07-10,2184
00937B,群益ESG投等債20,10,0,10,亞東-新竹,2024-07-10,2184
00795B,中信美國公債20年,12,2,10,亞東-新竹,2024-07-10,2184
00740B,富邦全球投等債,10,0,10,亞東-新竹,2024-07-10,2184
2344,華邦電,10,0,10,亞東-新竹,2024-07-10,2184
2489,瑞軒,10,0,10,亞東-新竹,2024-07-10,2184
2892,第一金,10,0,10,亞東-新竹,2024-07-10,2184
4533,協易機,10,0,10,亞東-新竹,2024-07-10,2184
4908,前鼎,12,2,10,亞東-新竹,2024-07-10,2184
3234,光環,9,0,9,亞東-新竹,2024-07-10,2184
5371,中光電,9,0,9,亞東-新竹,2024-07-10,2184
8028,昇陽半導體,13,4,9,亞東-新竹,2024-07-10,2184
00713,元大台灣高息低波,9,0,9,亞東-新竹,2024-07-10,2184
4105,東洋,8,0,8,亞東-新竹,2024-07-10,2184
2449,京元電子,10,2,8,亞東-新竹,2024-07-10,2184
3034,聯詠,7,0,7,亞東-新竹,2024-07-10,2184
2392,正崴,13,7,6,亞東-新竹,2024-07-10,2184
00934,中信成長高股息,16,10,6,亞東-新竹,2024-07-10,2184
2401,凌陽,6,0,6,亞東-新竹,2024-07-10,2184
2903,遠百,6,0,6,亞東-新竹,2024-07-10,2184
1314,中石化,5,0,5,亞東-新竹,2024-07-10,2184
1721,三晃,5,0,5,亞東-新竹,2024-07-10,2184
2101,南港,5,0,5,亞東-新竹,2024-07-10,2184
2481,強茂,5,0,5,亞東-新竹,2024-07-10,2184
00679B,元大美債20年,109,0,109,亞東-新竹,2024-07-11,2184
00937B,群益ESG投等債20,105,0,105,亞東-新竹,2024-07-11,2184
00632R,元大台灣50反1,95,0,95,亞東-新竹,2024-07-11,2184
00720B,元大投資級公司債,140,50,90,亞東-新竹,2024-07-11,2184
1718,中纖,63,0,63,亞東-新竹,2024-07-11,2184
00751B,元大AAA至A公司債,56,5,51,亞東-新竹,2024-07-11,2184
2834,臺企銀,50,0,50,亞東-新竹,2024-07-11,2184
2897,王道銀行,50,0,50,亞東-新竹,2024-07-11,2184
9945,潤泰新,50,3,47,亞東-新竹,2024-07-11,2184
00919,群益台灣精選高息,36,1,35,亞東-新竹,2024-07-11,2184
2888,新光金,97,65,32,亞東-新竹,2024-07-11,2184
1513,中興電,27,3,24,亞東-新竹,2024-07-11,2184
2405,輔信,23,2,21,亞東-新竹,2024-07-11,2184
2412,中華電,20,0,20,亞東-新竹,2024-07-11,2184
6770,力積電,25,5,20,亞東-新竹,2024-07-11,2184
2891,中信金,19,0,19,亞東-新竹,2024-07-11,2184
3711,日月光投控,21,2,19,亞東-新竹,2024-07-11,2184
00687B,國泰20年美債,18,0,18,亞東-新竹,2024-07-11,2184
4958,臻鼎-KY,29,11,18,亞東-新竹,2024-07-11,2184
00929,復華台灣科技優息,19,5,14,亞東-新竹,2024-07-11,2184
6187,萬潤,13,0,13,亞東-新竹,2024-07-11,2184
1611,中電,12,0,12,亞東-新竹,2024-07-11,2184
2360,致茂,12,0,12,亞東-新竹,2024-07-11,2184
3055,蔚華科,11,0,11,亞東-新竹,2024-07-11,2184
6462,神盾,12,1,11,亞東-新竹,2024-07-11,2184
00639,富邦深100,10,0,10,亞東-新竹,2024-07-11,2184
00882,中信中國高股息,10,0,10,亞東-新竹,2024-07-11,2184
00888,永豐台灣ESG,10,0,10,亞東-新竹,2024-07-11,2184
00740B,富邦全球投等債,10,0,10,亞東-新竹,2024-07-11,2184
1312,國喬,10,0,10,亞東-新竹,2024-07-11,2184
1325,恆大,10,0,10,亞東-新竹,2024-07-11,2184
1447,力鵬,10,0,10,亞東-新竹,2024-07-11,2184
1476,儒鴻,10,0,10,亞東-新竹,2024-07-11,2184
2374,佳能,10,0,10,亞東-新竹,2024-07-11,2184
2460,建通,10,0,10,亞東-新竹,2024-07-11,2184
2515,中工,10,0,10,亞東-新竹,2024-07-11,2184
2838,聯邦銀,10,0,10,亞東-新竹,2024-07-11,2184
2887,台新金,10,0,10,亞東-新竹,2024-07-11,2184
3323,加百裕,10,0,10,亞東-新竹,2024-07-11,2184
4960,誠美材,10,0,10,亞東-新竹,2024-07-11,2184
5534,長虹,10,0,10,亞東-新竹,2024-07-11,2184
9105,泰金寶-DR,9,0,9,亞東-新竹,2024-07-11,2184
2537,聯上發,10,2,8,亞東-新竹,2024-07-11,2184
5452,佶優,11,3,8,亞東-新竹,2024-07-11,2184
4545,銘鈺,7,0,7,亞東-新竹,2024-07-11,2184
4931,新盛力,7,0,7,亞東-新竹,2024-07-11,2184
00713,元大台灣高息低波,7,1,6,亞東-新竹,2024-07-11,2184
2449,京元電子,6,0,6,亞東-新竹,2024-07-11,2184
00725B,國泰投資級公司債,6,0,6,亞東-新竹,2024-07-11,2184
1618,合機,6,0,6,亞東-新竹,2024-07-11,2184
2883,凱基金,970,400,570,亞東-新竹,2024-07-12,2184
2610,華航,213,17,196,亞東-新竹,2024-07-12,2184
00929,復華台灣科技優息,173,46,127,亞東-新竹,2024-07-12,2184
2303,聯電,126,0,126,亞東-新竹,2024-07-12,2184
1714,和桐,100,0,100,亞東-新竹,2024-07-12,2184
00919,群益台灣精選高息,101,5,96,亞東-新竹,2024-07-12,2184
3576,聯合再生,76,0,76,亞東-新竹,2024-07-12,2184
00679B,元大美債20年,42,1,41,亞東-新竹,2024-07-12,2184
2834,臺企銀,40,0,40,亞東-新竹,2024-07-12,2184
5522,遠雄,40,0,40,亞東-新竹,2024-07-12,2184
0056,元大高股息,37,0,37,亞東-新竹,2024-07-12,2184
00935,野村臺灣新科技50,32,0,32,亞東-新竹,2024-07-12,2184
00751B,元大AAA至A公司債,37,5,32,亞東-新竹,2024-07-12,2184
1513,中興電,48,17,31,亞東-新竹,2024-07-12,2184
00632R,元大台灣50反1,35,10,25,亞東-新竹,2024-07-12,2184
2891,中信金,32,8,24,亞東-新竹,2024-07-12,2184
3711,日月光投控,22,0,22,亞東-新竹,2024-07-12,2184
00934,中信成長高股息,21,0,21,亞東-新竹,2024-07-12,2184
00949,復華日本龍頭,20,0,20,亞東-新竹,2024-07-12,2184
01001T,土銀富邦R1,20,0,20,亞東-新竹,2024-07-12,2184
2412,中華電,20,0,20,亞東-新竹,2024-07-12,2184
2330,台積電,49,30,19,亞東-新竹,2024-07-12,2184
2405,輔信,30,13,17,亞東-新竹,2024-07-12,2184
4571,鈞興-KY,17,0,17,亞東-新竹,2024-07-12,2184
1312,國喬,15,0,15,亞東-新竹,2024-07-12,2184
2743,山富,15,0,15,亞東-新竹,2024-07-12,2184
6257,矽格,14,0,14,亞東-新竹,2024-07-12,2184
8358,金居,12,0,12,亞東-新竹,2024-07-12,2184
00904,新光臺灣半導體30,11,0,11,亞東-新竹,2024-07-12,2184
1608,華榮,12,1,11,亞東-新竹,2024-07-12,2184
6806,森崴能源,19,8,11,亞東-新竹,2024-07-12,2184
1815,富喬,10,0,10,亞東-新竹,2024-07-12,2184
2367,燿華,15,5,10,亞東-新竹,2024-07-12,2184
3231,緯創,14,4,10,亞東-新竹,2024-07-12,2184
3388,崇越電,10,0,10,亞東-新竹,2024-07-12,2184
4960,誠美材,10,0,10,亞東-新竹,2024-07-12,2184
8906,花王,10,0,10,亞東-新竹,2024-07-12,2184
00757,統一FANG+,10,0,10,亞東-新竹,2024-07-12,2184
0050,元大台灣50,9,0,9,亞東-新竹,2024-07-12,2184
00905,FT臺灣Smart,9,0,9,亞東-新竹,2024-07-12,2184
00881,國泰台灣5G+,9,0,9,亞東-新竹,2024-07-12,2184
6645,金萬林-創,9,0,9,亞東-新竹,2024-07-12,2184
2317,鴻海,39,31,8,亞東-新竹,2024-07-12,2184
2349,錸德,12,4,8,亞東-新竹,2024-07-12,2184
2905,三商,10,2,8,亞東-新竹,2024-07-12,2184
3707,漢磊,8,0,8,亞東-新竹,2024-07-12,2184
6026,福邦證,8,0,8,亞東-新竹,2024-07-12,2184
6270,倍微,8,0,8,亞東-新竹,2024-07-12,2184
2809,京城銀,7,0,7,亞東-新竹,2024-07-12,2184
00712,復華富時不動產,7,0,7,亞東-新竹,2024-07-12,2184
00937B,群益ESG投等債20,81,0,81,亞東-新竹,2024-07-15,2184
5534,長虹,60,0,60,亞東-新竹,2024-07-15,2184
00720B,元大投資級公司債,56,0,56,亞東-新竹,2024-07-15,2184
00725B,國泰投資級公司債,50,0,50,亞東-新竹,2024-07-15,2184
2891,中信金,73,29,44,亞東-新竹,2024-07-15,2184
6177,達麗,45,5,40,亞東-新竹,2024-07-15,2184
1539,巨庭,38,0,38,亞東-新竹,2024-07-15,2184
2888,新光金,33,0,33,亞東-新竹,2024-07-15,2184
1460,宏遠,30,0,30,亞東-新竹,2024-07-15,2184
00929,復華台灣科技優息,28,2,26,亞東-新竹,2024-07-15,2184
00934,中信成長高股息,26,0,26,亞東-新竹,2024-07-15,2184
2845,遠東銀,25,0,25,亞東-新竹,2024-07-15,2184
4958,臻鼎-KY,25,0,25,亞東-新竹,2024-07-15,2184
4707,磐亞,23,0,23,亞東-新竹,2024-07-15,2184
2464,盟立,25,3,22,亞東-新竹,2024-07-15,2184
2027,大成鋼,24,4,20,亞東-新竹,2024-07-15,2184
2601,益航,21,1,20,亞東-新竹,2024-07-15,2184
2887,台新金,18,0,18,亞東-新竹,2024-07-15,2184
2492,華新科,16,0,16,亞東-新竹,2024-07-15,2184
6257,矽格,17,1,16,亞東-新竹,2024-07-15,2184
2405,輔信,15,0,15,亞東-新竹,2024-07-15,2184
2882,國泰金,14,0,14,亞東-新竹,2024-07-15,2184
2892,第一金,20,6,14,亞東-新竹,2024-07-15,2184
2108,南帝,12,1,11,亞東-新竹,2024-07-15,2184
3596,智易,11,0,11,亞東-新竹,2024-07-15,2184
2330,台積電,16,6,10,亞東-新竹,2024-07-15,2184
00788B,元大10年IG電能債,10,0,10,亞東-新竹,2024-07-15,2184
00687B,國泰20年美債,11,1,10,亞東-新竹,2024-07-15,2184
2406,國碩,10,0,10,亞東-新竹,2024-07-15,2184
2884,玉山金,10,0,10,亞東-新竹,2024-07-15,2184
3034,聯詠,10,0,10,亞東-新竹,2024-07-15,2184
3388,崇越電,10,0,10,亞東-新竹,2024-07-15,2184
3518,柏騰,10,0,10,亞東-新竹,2024-07-15,2184
4956,光鋐,10,0,10,亞東-新竹,2024-07-15,2184
9105,泰金寶-DR,10,0,10,亞東-新竹,2024-07-15,2184
2344,華邦電,11,2,9,亞東-新竹,2024-07-15,2184
2356,英業達,10,1,9,亞東-新竹,2024-07-15,2184
2610,華航,10,1,9,亞東-新竹,2024-07-15,2184
3035,智原,10,1,9,亞東-新竹,2024-07-15,2184
3321,同泰,9,0,9,亞東-新竹,2024-07-15,2184
5381,合正,11,2,9,亞東-新竹,2024-07-15,2184
8028,昇陽半導體,9,0,9,亞東-新竹,2024-07-15,2184
0056,元大高股息,8,0,8,亞東-新竹,2024-07-15,2184
3105,穩懋,8,0,8,亞東-新竹,2024-07-15,2184
3163,波若威,16,8,8,亞東-新竹,2024-07-15,2184
00940,元大台灣價值高息,30,23,7,亞東-新竹,2024-07-15,2184
2809,京城銀,8,1,7,亞東-新竹,2024-07-15,2184
00795B,中信美國公債20年,7,0,7,亞東-新竹,2024-07-15,2184
2427,三商電,7,0,7,亞東-新竹,2024-07-15,2184
3481,群創,7,0,7,亞東-新竹,2024-07-15,2184
2897,王道銀行,120,0,120,亞東-新竹,2024-07-16,2184
00940,元大台灣價值高息,91,0,91,亞東-新竹,2024-07-16,2184
00937B,群益ESG投等債20,94,7,87,亞東-新竹,2024-07-16,2184
2888,新光金,92,15,77,亞東-新竹,2024-07-16,2184
0056,元大高股息,64,2,62,亞東-新竹,2024-07-16,2184
9945,潤泰新,50,10,40,亞東-新竹,2024-07-16,2184
00878,國泰永續高股息,44,7,37,亞東-新竹,2024-07-16,2184
00687B,國泰20年美債,32,0,32,亞東-新竹,2024-07-16,2184
00936,台新永續高息中小,30,0,30,亞東-新竹,2024-07-16,2184
8011,台通,31,2,29,亞東-新竹,2024-07-16,2184
5534,長虹,30,2,28,亞東-新竹,2024-07-16,2184
2836,高雄銀,25,0,25,亞東-新竹,2024-07-16,2184
00919,群益台灣精選高息,24,2,22,亞東-新竹,2024-07-16,2184
1305,華夏,20,0,20,亞東-新竹,2024-07-16,2184
1727,中華化,20,0,20,亞東-新竹,2024-07-16,2184
2504,國產,25,5,20,亞東-新竹,2024-07-16,2184
5880,合庫金,20,0,20,亞東-新竹,2024-07-16,2184
8927,北基,20,0,20,亞東-新竹,2024-07-16,2184
00725B,國泰投資級公司債,19,0,19,亞東-新竹,2024-07-16,2184
2884,玉山金,20,1,19,亞東-新竹,2024-07-16,2184
00675L,富邦臺灣加權正2,20,2,18,亞東-新竹,2024-07-16,2184
2353,宏��,16,0,16,亞東-新竹,2024-07-16,2184
2377,微星,16,0,16,亞東-新竹,2024-07-16,2184
3652,精聯,21,5,16,亞東-新竹,2024-07-16,2184
2739,寒舍,15,0,15,亞東-新竹,2024-07-16,2184
2891,中信金,38,23,15,亞東-新竹,2024-07-16,2184
6589,台康生技,15,0,15,亞東-新竹,2024-07-16,2184
00713,元大台灣高息低波,14,0,14,亞東-新竹,2024-07-16,2184
00665L,富邦�琤肭磪囓�2,14,0,14,亞東-新竹,2024-07-16,2184
00905,FT臺灣Smart,13,0,13,亞東-新竹,2024-07-16,2184
1565,精華,13,0,13,亞東-新竹,2024-07-16,2184
5351,鈺創,11,0,11,亞東-新竹,2024-07-16,2184
2002,中鋼,11,0,11,亞東-新竹,2024-07-16,2184
2845,遠東銀,11,0,11,亞東-新竹,2024-07-16,2184
6443,元晶,11,0,11,亞東-新竹,2024-07-16,2184
9917,中保科,11,0,11,亞東-新竹,2024-07-16,2184
2885,元大金,10,0,10,亞東-新竹,2024-07-16,2184
6176,瑞儀,10,0,10,亞東-新竹,2024-07-16,2184
01001T,土銀富邦R1,10,0,10,亞東-新竹,2024-07-16,2184
00945B,凱基美國非投等債,10,0,10,亞東-新竹,2024-07-16,2184
00680L,元大美債20正2,10,0,10,亞東-新竹,2024-07-16,2184
00632R,元大台灣50反1,10,0,10,亞東-新竹,2024-07-16,2184
2601,益航,10,0,10,亞東-新竹,2024-07-16,2184
3388,崇越電,10,0,10,亞東-新竹,2024-07-16,2184
8926,台汽電,10,0,10,亞東-新竹,2024-07-16,2184
3227,原相,10,0,10,亞東-新竹,2024-07-16,2184
8114,振樺電,13,4,9,亞東-新竹,2024-07-16,2184
1608,華榮,10,2,8,亞東-新竹,2024-07-16,2184
2497,怡利電,8,0,8,亞東-新竹,2024-07-16,2184
6901,鑽石投資,8,0,8,亞東-新竹,2024-07-16,2184
00937B,群益ESG投等債20,265,0,265,亞東-新竹,2024-07-17,2184
2303,聯電,104,4,100,亞東-新竹,2024-07-17,2184
00919,群益台灣精選高息,90,0,90,亞東-新竹,2024-07-17,2184
2618,長榮航,56,3,53,亞東-新竹,2024-07-17,2184
2834,臺企銀,33,1,32,亞東-新竹,2024-07-17,2184
6443,元晶,31,0,31,亞東-新竹,2024-07-17,2184
0056,元大高股息,41,10,31,亞東-新竹,2024-07-17,2184
00715L,期街口布蘭特正2,30,0,30,亞東-新竹,2024-07-17,2184
2330,台積電,50,24,26,亞東-新竹,2024-07-17,2184
3034,聯詠,24,0,24,亞東-新竹,2024-07-17,2184
2371,大同,23,0,23,亞東-新竹,2024-07-17,2184
2356,英業達,26,4,22,亞東-新竹,2024-07-17,2184
1565,精華,21,0,21,亞東-新竹,2024-07-17,2184
00946,群益科技高息成長,20,0,20,亞東-新竹,2024-07-17,2184
3376,新日興,15,0,15,亞東-新竹,2024-07-17,2184
8028,昇陽半導體,13,0,13,亞東-新竹,2024-07-17,2184
2344,華邦電,12,0,12,亞東-新竹,2024-07-17,2184
00929,復華台灣科技優息,22,10,12,亞東-新竹,2024-07-17,2184
2412,中華電,11,0,11,亞東-新竹,2024-07-17,2184
00878,國泰永續高股息,10,0,10,亞東-新竹,2024-07-17,2184
00665L,富邦�琤肭磪囓�2,10,0,10,亞東-新竹,2024-07-17,2184
00681R,元大美債20反1,10,0,10,亞東-新竹,2024-07-17,2184
2359,所羅門,34,24,10,亞東-新竹,2024-07-17,2184
2538,基泰,10,0,10,亞東-新竹,2024-07-17,2184
2739,寒舍,10,0,10,亞東-新竹,2024-07-17,2184
3312,弘憶股,12,2,10,亞東-新竹,2024-07-17,2184
6117,迎廣,11,1,10,亞東-新竹,2024-07-17,2184
8104,錸寶,10,0,10,亞東-新竹,2024-07-17,2184
2845,遠東銀,9,0,9,亞東-新竹,2024-07-17,2184
1536,和大,19,10,9,亞東-新竹,2024-07-17,2184
3706,神達,12,3,9,亞東-新竹,2024-07-17,2184
8086,宏捷科,9,0,9,亞東-新竹,2024-07-17,2184
2891,中信金,8,0,8,亞東-新竹,2024-07-17,2184
4906,正文,10,2,8,亞東-新竹,2024-07-17,2184
6155,鈞寶,8,0,8,亞東-新竹,2024-07-17,2184
3231,緯創,7,0,7,亞東-新竹,2024-07-17,2184
1101,台泥,12,5,7,亞東-新竹,2024-07-17,2184
1609,大亞,11,4,7,亞東-新竹,2024-07-17,2184
6269,台郡,8,1,7,亞東-新竹,2024-07-17,2184
1402,遠東新,7,0,7,亞東-新竹,2024-07-17,2184
2603,長榮,6,0,6,亞東-新竹,2024-07-17,2184
00675L,富邦臺灣加權正2,6,0,6,亞東-新竹,2024-07-17,2184
2401,凌陽,6,0,6,亞東-新竹,2024-07-17,2184
2449,京元電子,6,0,6,亞東-新竹,2024-07-17,2184
3379,彬台,6,0,6,亞東-新竹,2024-07-17,2184
6220,岳豐,6,0,6,亞東-新竹,2024-07-17,2184
6257,矽格,6,0,6,亞東-新竹,2024-07-17,2184
00936,台新永續高息中小,5,0,5,亞東-新竹,2024-07-17,2184
00905,FT臺灣Smart,5,0,5,亞東-新竹,2024-07-17,2184
2357,華碩,5,0,5,亞東-新竹,2024-07-17,2184
2888,新光金,253,55,198,亞東-新竹,2024-07-18,2184
2610,華航,150,13,137,亞東-新竹,2024-07-18,2184
1402,遠東新,98,19,79,亞東-新竹,2024-07-18,2184
00919,群益台灣精選高息,127,61,66,亞東-新竹,2024-07-18,2184
00751B,元大AAA至A公司債,60,0,60,亞東-新竹,2024-07-18,2184
00937B,群益ESG投等債20,64,6,58,亞東-新竹,2024-07-18,2184
6770,力積電,64,8,56,亞東-新竹,2024-07-18,2184
5519,隆大,55,0,55,亞東-新竹,2024-07-18,2184
00929,復華台灣科技優息,62,20,42,亞東-新竹,2024-07-18,2184
00878,國泰永續高股息,34,1,33,亞東-新竹,2024-07-18,2184
0056,元大高股息,32,0,32,亞東-新竹,2024-07-18,2184
00715L,期街口布蘭特正2,30,0,30,亞東-新竹,2024-07-18,2184
2897,王道銀行,30,0,30,亞東-新竹,2024-07-18,2184
3105,穩懋,37,10,27,亞東-新竹,2024-07-18,2184
4303,信立,26,1,25,亞東-新竹,2024-07-18,2184
2330,台積電,40,16,24,亞東-新竹,2024-07-18,2184
00830,國泰費城半導體,18,0,18,亞東-新竹,2024-07-18,2184
3189,景碩,28,10,18,亞東-新竹,2024-07-18,2184
2891,中信金,19,3,16,亞東-新竹,2024-07-18,2184
2362,藍天,16,1,15,亞東-新竹,2024-07-18,2184
2881,富邦金,28,13,15,亞東-新竹,2024-07-18,2184
00923,群益台ESG低碳50,13,0,13,亞東-新竹,2024-07-18,2184
00927,群益半導體收益,18,5,13,亞東-新竹,2024-07-18,2184
2882,國泰金,13,0,13,亞東-新竹,2024-07-18,2184
6257,矽格,13,1,12,亞東-新竹,2024-07-18,2184
2356,英業達,14,2,12,亞東-新竹,2024-07-18,2184
2497,怡利電,12,0,12,亞東-新竹,2024-07-18,2184
5230,雷笛克光學,12,0,12,亞東-新竹,2024-07-18,2184
00941,中信上游半導體,11,0,11,亞東-新竹,2024-07-18,2184
1565,精華,11,0,11,亞東-新竹,2024-07-18,2184
1609,大亞,12,1,11,亞東-新竹,2024-07-18,2184
00631L,元大台灣50正2,26,16,10,亞東-新竹,2024-07-18,2184
3312,弘憶股,10,0,10,亞東-新竹,2024-07-18,2184
00795B,中信美國公債20年,10,0,10,亞東-新竹,2024-07-18,2184
00693U,期街口S＆P黃豆,10,0,10,亞東-新竹,2024-07-18,2184
1618,合機,10,0,10,亞東-新竹,2024-07-18,2184
2402,毅嘉,12,2,10,亞東-新竹,2024-07-18,2184
3217,優群,10,0,10,亞東-新竹,2024-07-18,2184
4916,事欣科,10,0,10,亞東-新竹,2024-07-18,2184
4960,誠美材,10,0,10,亞東-新竹,2024-07-18,2184
6138,茂達,10,0,10,亞東-新竹,2024-07-18,2184
6187,萬潤,16,6,10,亞東-新竹,2024-07-18,2184
6901,鑽石投資,10,0,10,亞東-新竹,2024-07-18,2184
2412,中華電,11,2,9,亞東-新竹,2024-07-18,2184
1815,富喬,9,1,8,亞東-新竹,2024-07-18,2184
2329,華泰,8,0,8,亞東-新竹,2024-07-18,2184
6462,神盾,16,8,8,亞東-新竹,2024-07-18,2184
00675L,富邦臺灣加權正2,8,0,8,亞東-新竹,2024-07-18,2184
2317,鴻海,28,21,7,亞東-新竹,2024-07-18,2184
2520,冠德,12,5,7,亞東-新竹,2024-07-18,2184
00937B,群益ESG投等債20,353,16,337,亞東-新竹,2024-07-19,2184
00679B,元大美債20年,200,53,147,亞東-新竹,2024-07-19,2184
2897,王道銀行,97,0,97,亞東-新竹,2024-07-19,2184
2888,新光金,95,10,85,亞東-新竹,2024-07-19,2184
2891,中信金,97,21,76,亞東-新竹,2024-07-19,2184
2867,三商壽,81,5,76,亞東-新竹,2024-07-19,2184
00919,群益台灣精選高息,72,5,67,亞東-新竹,2024-07-19,2184
3481,群創,87,21,66,亞東-新竹,2024-07-19,2184
00715L,期街口布蘭特正2,60,0,60,亞東-新竹,2024-07-19,2184
2401,凌陽,50,0,50,亞東-新竹,2024-07-19,2184
2882,國泰金,56,20,36,亞東-新竹,2024-07-19,2184
9904,寶成,35,0,35,亞東-新竹,2024-07-19,2184
2330,台積電,35,2,33,亞東-新竹,2024-07-19,2184
1460,宏遠,30,0,30,亞東-新竹,2024-07-19,2184
00940,元大台灣價值高息,68,40,28,亞東-新竹,2024-07-19,2184
00941,中信上游半導體,25,0,25,亞東-新竹,2024-07-19,2184
00878,國泰永續高股息,31,7,24,亞東-新竹,2024-07-19,2184
4153,鈺緯,22,0,22,亞東-新竹,2024-07-19,2184
8054,安國,26,5,21,亞東-新竹,2024-07-19,2184
2303,聯電,26,5,21,亞東-新竹,2024-07-19,2184
2337,旺宏,20,0,20,亞東-新竹,2024-07-19,2184
2485,兆赫,18,0,18,亞東-新竹,2024-07-19,2184
0050,元大台灣50,16,0,16,亞東-新竹,2024-07-19,2184
00706L,期元大S＆P日圓正2,15,0,15,亞東-新竹,2024-07-19,2184
3522,御嵿,15,0,15,亞東-新竹,2024-07-19,2184
1455,集盛,14,0,14,亞東-新竹,2024-07-19,2184
0056,元大高股息,30,17,13,亞東-新竹,2024-07-19,2184
1102,亞泥,14,1,13,亞東-新竹,2024-07-19,2184
2812,台中銀,13,0,13,亞東-新竹,2024-07-19,2184
00713,元大台灣高息低波,13,0,13,亞東-新竹,2024-07-19,2184
1301,台塑,12,0,12,亞東-新竹,2024-07-19,2184
1702,南僑,12,0,12,亞東-新竹,2024-07-19,2184
2881,富邦金,22,10,12,亞東-新竹,2024-07-19,2184
2610,華航,31,20,11,亞東-新竹,2024-07-19,2184
2108,南帝,11,0,11,亞東-新竹,2024-07-19,2184
2344,華邦電,11,0,11,亞東-新竹,2024-07-19,2184
9906,欣巴巴,11,0,11,亞東-新竹,2024-07-19,2184
2845,遠東銀,23,13,10,亞東-新竹,2024-07-19,2184
2204,中華,10,0,10,亞東-新竹,2024-07-19,2184
3037,欣興,11,1,10,亞東-新竹,2024-07-19,2184
3105,穩懋,10,0,10,亞東-新竹,2024-07-19,2184
6603,富強鑫,10,0,10,亞東-新竹,2024-07-19,2184
2412,中華電,11,2,9,亞東-新竹,2024-07-19,2184
2457,飛宏,9,0,9,亞東-新竹,2024-07-19,2184
3025,星通,9,0,9,亞東-新竹,2024-07-19,2184
00949,復華日本龍頭,10,2,8,亞東-新竹,2024-07-19,2184
1802,台玻,8,0,8,亞東-新竹,2024-07-19,2184
2468,華經,8,0,8,亞東-新竹,2024-07-19,2184
2606,裕民,8,0,8,亞東-新竹,2024-07-19,2184
5469,瀚宇博,8,0,8,亞東-新竹,2024-07-19,2184
2883,凱基金,829,323,506,亞東-新竹,2024-07-22,2184
00919,群益台灣精選高息,154,28,126,亞東-新竹,2024-07-22,2184
2888,新光金,116,30,86,亞東-新竹,2024-07-22,2184
00929,復華台灣科技優息,142,78,64,亞東-新竹,2024-07-22,2184
3481,群創,60,0,60,亞東-新竹,2024-07-22,2184
2409,友達,61,5,56,亞東-新竹,2024-07-22,2184
2610,華航,80,31,49,亞東-新竹,2024-07-22,2184
2401,凌陽,50,10,40,亞東-新竹,2024-07-22,2184
00940,元大台灣價值高息,30,0,30,亞東-新竹,2024-07-22,2184
1460,宏遠,30,0,30,亞東-新竹,2024-07-22,2184
2002,中鋼,25,1,24,亞東-新竹,2024-07-22,2184
2344,華邦電,24,0,24,亞東-新竹,2024-07-22,2184
3711,日月光投控,21,0,21,亞東-新竹,2024-07-22,2184
00715L,期街口布蘭特正2,20,0,20,亞東-新竹,2024-07-22,2184
00751B,元大AAA至A公司債,50,30,20,亞東-新竹,2024-07-22,2184
00946,群益科技高息成長,20,0,20,亞東-新竹,2024-07-22,2184
6603,富強鑫,20,0,20,亞東-新竹,2024-07-22,2184
3231,緯創,23,5,18,亞東-新竹,2024-07-22,2184
00934,中信成長高股息,18,0,18,亞東-新竹,2024-07-22,2184
00687B,國泰20年美債,42,25,17,亞東-新竹,2024-07-22,2184
0050,元大台灣50,15,0,15,亞東-新竹,2024-07-22,2184
00692,富邦公司治理,15,0,15,亞東-新竹,2024-07-22,2184
00680L,元大美債20正2,15,0,15,亞東-新竹,2024-07-22,2184
1513,中興電,15,1,14,亞東-新竹,2024-07-22,2184
2468,華經,14,0,14,亞東-新竹,2024-07-22,2184
2330,台積電,20,7,13,亞東-新竹,2024-07-22,2184
6257,矽格,13,0,13,亞東-新竹,2024-07-22,2184
1609,大亞,14,2,12,亞東-新竹,2024-07-22,2184
2515,中工,11,0,11,亞東-新竹,2024-07-22,2184
0056,元大高股息,56,46,10,亞東-新竹,2024-07-22,2184
2882,國泰金,21,11,10,亞東-新竹,2024-07-22,2184
3663,鑫科,12,2,10,亞東-新竹,2024-07-22,2184
8064,東捷,12,2,10,亞東-新竹,2024-07-22,2184
1785,光洋科,15,6,9,亞東-新竹,2024-07-22,2184
2023,燁輝,9,0,9,亞東-新竹,2024-07-22,2184
2427,三商電,10,1,9,亞東-新竹,2024-07-22,2184
4128,中天,10,1,9,亞東-新竹,2024-07-22,2184
3105,穩懋,8,0,8,亞東-新竹,2024-07-22,2184
3597,映興,8,0,8,亞東-新竹,2024-07-22,2184
6770,力積電,8,0,8,亞東-新竹,2024-07-22,2184
00631L,元大台灣50正2,19,12,7,亞東-新竹,2024-07-22,2184
1529,樂事綠能,7,0,7,亞東-新竹,2024-07-22,2184
1537,廣隆,7,0,7,亞東-新竹,2024-07-22,2184
2303,聯電,35,28,7,亞東-新竹,2024-07-22,2184
2485,兆赫,7,0,7,亞東-新竹,2024-07-22,2184
2812,台中銀,7,0,7,亞東-新竹,2024-07-22,2184
2881,富邦金,18,11,7,亞東-新竹,2024-07-22,2184
9105,泰金寶-DR,7,0,7,亞東-新竹,2024-07-22,2184
9906,欣巴巴,7,0,7,亞東-新竹,2024-07-22,2184
3037,欣興,6,0,6,亞東-新竹,2024-07-22,2184
2883,凱基金,1104,750,354,亞東-新竹,2024-07-23,2184
00937B,群益ESG投等債20,342,1,341,亞東-新竹,2024-07-23,2184
00929,復華台灣科技優息,91,4,87,亞東-新竹,2024-07-23,2184
6202,盛群,58,0,58,亞東-新竹,2024-07-23,2184
2002,中鋼,42,1,41,亞東-新竹,2024-07-23,2184
00680L,元大美債20正2,40,0,40,亞東-新竹,2024-07-23,2184
00632R,元大台灣50反1,40,3,37,亞東-新竹,2024-07-23,2184
4904,遠傳,35,0,35,亞東-新竹,2024-07-23,2184
1459,聯發,33,0,33,亞東-新竹,2024-07-23,2184
9945,潤泰新,48,15,33,亞東-新竹,2024-07-23,2184
00919,群益台灣精選高息,34,2,32,亞東-新竹,2024-07-23,2184
4303,信立,30,0,30,亞東-新竹,2024-07-23,2184
3583,辛耘,26,1,25,亞東-新竹,2024-07-23,2184
6147,頎邦,21,0,21,亞東-新竹,2024-07-23,2184
00900,富邦特選高股息30,20,0,20,亞東-新竹,2024-07-23,2184
00940,元大台灣價值高息,19,0,19,亞東-新竹,2024-07-23,2184
3663,鑫科,17,2,15,亞東-新竹,2024-07-23,2184
0056,元大高股息,19,5,14,亞東-新竹,2024-07-23,2184
2312,金寶,14,1,13,亞東-新竹,2024-07-23,2184
4967,十銓,11,0,11,亞東-新竹,2024-07-23,2184
1309,台達化,10,0,10,亞東-新竹,2024-07-23,2184
1101,台泥,10,0,10,亞東-新竹,2024-07-23,2184
2337,旺宏,10,0,10,亞東-新竹,2024-07-23,2184
3388,崇越電,10,0,10,亞東-新竹,2024-07-23,2184
5309,系統電,10,0,10,亞東-新竹,2024-07-23,2184
5452,佶優,10,0,10,亞東-新竹,2024-07-23,2184
5483,中美晶,10,0,10,亞東-新竹,2024-07-23,2184
5522,遠雄,25,15,10,亞東-新竹,2024-07-23,2184
6505,台塑化,10,0,10,亞東-新竹,2024-07-23,2184
8064,東捷,12,2,10,亞東-新竹,2024-07-23,2184
6901,鑽石投資,10,1,9,亞東-新竹,2024-07-23,2184
3481,群創,18,10,8,亞東-新竹,2024-07-23,2184
00878,國泰永續高股息,8,0,8,亞東-新竹,2024-07-23,2184
2887,台新金,7,0,7,亞東-新竹,2024-07-23,2184
00946,群益科技高息成長,6,0,6,亞東-新竹,2024-07-23,2184
3163,波若威,18,12,6,亞東-新竹,2024-07-23,2184
2330,台積電,11,6,5,亞東-新竹,2024-07-23,2184
6188,廣明,6,1,5,亞東-新竹,2024-07-23,2184
00692,富邦公司治理,5,0,5,亞東-新竹,2024-07-23,2184
00933B,國泰10Y+金融債,5,0,5,亞東-新竹,2024-07-23,2184
2537,聯上發,25,20,5,亞東-新竹,2024-07-23,2184
2645,長榮航太,5,0,5,亞東-新竹,2024-07-23,2184
3379,彬台,5,0,5,亞東-新竹,2024-07-23,2184
3694,海華,5,0,5,亞東-新竹,2024-07-23,2184
6488,環球晶,6,1,5,亞東-新竹,2024-07-23,2184
8446,華研,5,0,5,亞東-新竹,2024-07-23,2184
2365,昆盈,4,0,4,亞東-新竹,2024-07-23,2184
00751B,元大AAA至A公司債,4,0,4,亞東-新竹,2024-07-23,2184
00687B,國泰20年美債,4,0,4,亞東-新竹,2024-07-23,2184
1104,環泥,4,0,4,亞東-新竹,2024-07-23,2184
00937B,群益ESG投等債20,425,146,279,亞東-新竹,2024-07-26,2184
00751B,元大AAA至A公司債,75,0,75,亞東-新竹,2024-07-26,2184
3188,鑫龍騰,70,0,70,亞東-新竹,2024-07-26,2184
00878,國泰永續高股息,60,0,60,亞東-新竹,2024-07-26,2184
00679B,元大美債20年,58,0,58,亞東-新竹,2024-07-26,2184
00940,元大台灣價值高息,57,1,56,亞東-新竹,2024-07-26,2184
00715L,期街口布蘭特正2,70,30,40,亞東-新竹,2024-07-26,2184
00725B,國泰投資級公司債,40,0,40,亞東-新竹,2024-07-26,2184
2349,錸德,40,0,40,亞東-新竹,2024-07-26,2184
00905,FT臺灣Smart,30,0,30,亞東-新竹,2024-07-26,2184
2884,玉山金,34,4,30,亞東-新竹,2024-07-26,2184
00929,復華台灣科技優息,73,45,28,亞東-新竹,2024-07-26,2184
0056,元大高股息,26,0,26,亞東-新竹,2024-07-26,2184
00720B,元大投資級公司債,25,0,25,亞東-新竹,2024-07-26,2184
2301,光寶科,24,0,24,亞東-新竹,2024-07-26,2184
00795B,中信美國公債20年,22,0,22,亞東-新竹,2024-07-26,2184
00946,群益科技高息成長,22,0,22,亞東-新竹,2024-07-26,2184
2867,三商壽,20,0,20,亞東-新竹,2024-07-26,2184
6443,元晶,20,0,20,亞東-新竹,2024-07-26,2184
8105,凌巨,20,0,20,亞東-新竹,2024-07-26,2184
0050,元大台灣50,18,0,18,亞東-新竹,2024-07-26,2184
2330,台積電,20,2,18,亞東-新竹,2024-07-26,2184
00949,復華日本龍頭,16,0,16,亞東-新竹,2024-07-26,2184
1101,台泥,20,4,16,亞東-新竹,2024-07-26,2184
2382,廣達,18,3,15,亞東-新竹,2024-07-26,2184
00895,富邦未來車,15,0,15,亞東-新竹,2024-07-26,2184
2449,京元電子,15,0,15,亞東-新竹,2024-07-26,2184
2317,鴻海,19,5,14,亞東-新竹,2024-07-26,2184
1808,潤隆,25,11,14,亞東-新竹,2024-07-26,2184
00637L,元大滬深300正2,14,0,14,亞東-新竹,2024-07-26,2184
2610,華航,15,2,13,亞東-新竹,2024-07-26,2184
00687B,國泰20年美債,14,1,13,亞東-新竹,2024-07-26,2184
00665L,富邦�琤肭磪囓�2,12,0,12,亞東-新竹,2024-07-26,2184
2303,聯電,15,4,11,亞東-新竹,2024-07-26,2184
00680L,元大美債20正2,11,0,11,亞東-新竹,2024-07-26,2184
2356,英業達,10,0,10,亞東-新竹,2024-07-26,2184
2891,中信金,10,0,10,亞東-新竹,2024-07-26,2184
6147,頎邦,10,0,10,亞東-新竹,2024-07-26,2184
1215,卜蜂,10,0,10,亞東-新竹,2024-07-26,2184
1449,佳和,10,0,10,亞東-新竹,2024-07-26,2184
2337,旺宏,10,0,10,亞東-新竹,2024-07-26,2184
2344,華邦電,10,0,10,亞東-新竹,2024-07-26,2184
2504,國產,16,6,10,亞東-新竹,2024-07-26,2184
3231,緯創,13,4,9,亞東-新竹,2024-07-26,2184
1529,樂事綠能,9,0,9,亞東-新竹,2024-07-26,2184
2888,新光金,20,11,9,亞東-新竹,2024-07-26,2184
00692,富邦公司治理,8,0,8,亞東-新竹,2024-07-26,2184
00631L,元大台灣50正2,9,1,8,亞東-新竹,2024-07-26,2184
00941,中信上游半導體,8,0,8,亞東-新竹,2024-07-26,2184
00830,國泰費城半導體,9,2,7,亞東-新竹,2024-07-26,2184
2883,凱基金,1000,600,400,亞東-新竹,2024-07-29,2184
2884,玉山金,199,4,195,亞東-新竹,2024-07-29,2184
00919,群益台灣精選高息,101,8,93,亞東-新竹,2024-07-29,2184
00929,復華台灣科技優息,61,1,60,亞東-新竹,2024-07-29,2184
00715L,期街口布蘭特正2,81,30,51,亞東-新竹,2024-07-29,2184
3481,群創,50,0,50,亞東-新竹,2024-07-29,2184
6202,盛群,50,0,50,亞東-新竹,2024-07-29,2184
00878,國泰永續高股息,42,0,42,亞東-新竹,2024-07-29,2184
00679B,元大美債20年,41,0,41,亞東-新竹,2024-07-29,2184
5519,隆大,40,0,40,亞東-新竹,2024-07-29,2184
2409,友達,31,1,30,亞東-新竹,2024-07-29,2184
5522,遠雄,31,1,30,亞東-新竹,2024-07-29,2184
0056,元大高股息,29,0,29,亞東-新竹,2024-07-29,2184
00940,元大台灣價值高息,28,0,28,亞東-新竹,2024-07-29,2184
9946,三發地產,22,0,22,亞東-新竹,2024-07-29,2184
2356,英業達,26,5,21,亞東-新竹,2024-07-29,2184
1449,佳和,20,0,20,亞東-新竹,2024-07-29,2184
2427,三商電,20,0,20,亞東-新竹,2024-07-29,2184
2367,燿華,28,10,18,亞東-新竹,2024-07-29,2184
4128,中天,17,0,17,亞東-新竹,2024-07-29,2184
2867,三商壽,16,0,16,亞東-新竹,2024-07-29,2184
8054,安國,26,10,16,亞東-新竹,2024-07-29,2184
00706L,期元大S＆P日圓正2,15,0,15,亞東-新竹,2024-07-29,2184
1529,樂事綠能,15,3,12,亞東-新竹,2024-07-29,2184
8064,東捷,15,3,12,亞東-新竹,2024-07-29,2184
6177,達麗,11,0,11,亞東-新竹,2024-07-29,2184
6462,神盾,18,7,11,亞東-新竹,2024-07-29,2184
00795B,中信美國公債20年,10,0,10,亞東-新竹,2024-07-29,2184
2881,富邦金,10,0,10,亞東-新竹,2024-07-29,2184
3522,御嵿,10,0,10,亞東-新竹,2024-07-29,2184
6116,彩晶,10,0,10,亞東-新竹,2024-07-29,2184
6257,矽格,10,0,10,亞東-新竹,2024-07-29,2184
3231,緯創,17,8,9,亞東-新竹,2024-07-29,2184
3105,穩懋,9,0,9,亞東-新竹,2024-07-29,2184
3035,智原,10,2,8,亞東-新竹,2024-07-29,2184
1456,怡華,8,0,8,亞東-新竹,2024-07-29,2184
2344,華邦電,14,6,8,亞東-新竹,2024-07-29,2184
6220,岳豐,8,0,8,亞東-新竹,2024-07-29,2184
8403,盛弘,9,1,8,亞東-新竹,2024-07-29,2184
1513,中興電,15,8,7,亞東-新竹,2024-07-29,2184
2331,精英,7,0,7,亞東-新竹,2024-07-29,2184
8936,國統,7,0,7,亞東-新竹,2024-07-29,2184
2748,雲品,7,1,6,亞東-新竹,2024-07-29,2184
3260,威剛,6,0,6,亞東-新竹,2024-07-29,2184
2027,大成鋼,10,4,6,亞東-新竹,2024-07-29,2184
1785,光洋科,6,1,5,亞東-新竹,2024-07-29,2184
00936,台新永續高息中小,5,0,5,亞東-新竹,2024-07-29,2184
1808,潤隆,16,11,5,亞東-新竹,2024-07-29,2184
2353,宏��,8,3,5,亞東-新竹,2024-07-29,2184
3691,碩禾,6,1,5,亞東-新竹,2024-07-29,2184
00712,復華富時不動產,200,5,195,亞東-新竹,2024-07-30,2184
00878,國泰永續高股息,149,0,149,亞東-新竹,2024-07-30,2184
00919,群益台灣精選高息,125,12,113,亞東-新竹,2024-07-30,2184
1316,上曜,70,2,68,亞東-新竹,2024-07-30,2184
00706L,期元大S＆P日圓正2,60,0,60,亞東-新竹,2024-07-30,2184
0050,元大台灣50,55,0,55,亞東-新竹,2024-07-30,2184
00929,復華台灣科技優息,56,10,46,亞東-新竹,2024-07-30,2184
0056,元大高股息,34,0,34,亞東-新竹,2024-07-30,2184
3376,新日興,30,0,30,亞東-新竹,2024-07-30,2184
2308,台達電,31,3,28,亞東-新竹,2024-07-30,2184
00940,元大台灣價值高息,21,0,21,亞東-新竹,2024-07-30,2184
3037,欣興,21,0,21,亞東-新竹,2024-07-30,2184
6187,萬潤,18,0,18,亞東-新竹,2024-07-30,2184
2303,聯電,20,4,16,亞東-新竹,2024-07-30,2184
8104,錸寶,15,0,15,亞東-新竹,2024-07-30,2184
00637L,元大滬深300正2,11,0,11,亞東-新竹,2024-07-30,2184
00715L,期街口布蘭特正2,11,0,11,亞東-新竹,2024-07-30,2184
00687B,國泰20年美債,10,0,10,亞東-新竹,2024-07-30,2184
00795B,中信美國公債20年,10,0,10,亞東-新竹,2024-07-30,2184
00936,台新永續高息中小,11,1,10,亞東-新竹,2024-07-30,2184
1460,宏遠,10,0,10,亞東-新竹,2024-07-30,2184
1611,中電,10,0,10,亞東-新竹,2024-07-30,2184
2409,友達,11,1,10,亞東-新竹,2024-07-30,2184
2610,華航,14,4,10,亞東-新竹,2024-07-30,2184
1540,喬福,9,1,8,亞東-新竹,2024-07-30,2184
4109,加捷生醫,12,4,8,亞東-新竹,2024-07-30,2184
2881,富邦金,7,0,7,亞東-新竹,2024-07-30,2184
00946,群益科技高息成長,6,0,6,亞東-新竹,2024-07-30,2184
9105,泰金寶-DR,6,0,6,亞東-新竹,2024-07-30,2184
3443,創意,7,1,6,亞東-新竹,2024-07-30,2184
2301,光寶科,10,5,5,亞東-新竹,2024-07-30,2184
00934,中信成長高股息,6,1,5,亞東-新竹,2024-07-30,2184
00895,富邦未來車,5,0,5,亞東-新竹,2024-07-30,2184
01004T,土銀富邦R2,5,0,5,亞東-新竹,2024-07-30,2184
1459,聯發,5,0,5,亞東-新竹,2024-07-30,2184
2201,裕隆,9,4,5,亞東-新竹,2024-07-30,2184
3694,海華,5,0,5,亞東-新竹,2024-07-30,2184
6180,橘子,5,0,5,亞東-新竹,2024-07-30,2184
00947,台新臺灣IC設計,4,0,4,亞東-新竹,2024-07-30,2184
00935,野村臺灣新科技50,4,0,4,亞東-新竹,2024-07-30,2184
1503,士電,4,0,4,亞東-新竹,2024-07-30,2184
6462,神盾,4,0,4,亞東-新竹,2024-07-30,2184
2330,台積電,7,3,4,亞東-新竹,2024-07-30,2184
00830,國泰費城半導體,3,0,3,亞東-新竹,2024-07-30,2184
2812,台中銀,4,1,3,亞東-新竹,2024-07-30,2184
8299,群聯,3,0,3,亞東-新竹,2024-07-30,2184
00665L,富邦�琤肭磪囓�2,3,0,3,亞東-新竹,2024-07-30,2184
1529,樂事綠能,17,14,3,亞東-新竹,2024-07-30,2184
2332,友訊,3,0,3,亞東-新竹,2024-07-30,2184
2383,台光電,3,0,3,亞東-新竹,2024-07-30,2184
00919,群益台灣精選高息,75,0,75,亞東-新竹,2024-07-31,2184
00632R,元大台灣50反1,50,0,50,亞東-新竹,2024-07-31,2184
00688L,國泰20年美債正2,50,0,50,亞東-新竹,2024-07-31,2184
2409,友達,47,2,45,亞東-新竹,2024-07-31,2184
3481,群創,37,1,36,亞東-新竹,2024-07-31,2184
2542,興富發,30,0,30,亞東-新竹,2024-07-31,2184
00715L,期街口布蘭特正2,27,0,27,亞東-新竹,2024-07-31,2184
00929,復華台灣科技優息,27,0,27,亞東-新竹,2024-07-31,2184
3019,亞光,27,3,24,亞東-新竹,2024-07-31,2184
00940,元大台灣價值高息,22,0,22,亞東-新竹,2024-07-31,2184
3047,訊舟,22,1,21,亞東-新竹,2024-07-31,2184
3339,泰谷,20,0,20,亞東-新竹,2024-07-31,2184
3705,永信,20,0,20,亞東-新竹,2024-07-31,2184
00687B,國泰20年美債,18,0,18,亞東-新竹,2024-07-31,2184
6239,力成,15,0,15,亞東-新竹,2024-07-31,2184
3312,弘憶股,15,1,14,亞東-新竹,2024-07-31,2184
2539,櫻花建,12,0,12,亞東-新竹,2024-07-31,2184
3048,益登,11,0,11,亞東-新竹,2024-07-31,2184
00931B,統一美債20年,10,0,10,亞東-新竹,2024-07-31,2184
1316,上曜,11,1,10,亞東-新竹,2024-07-31,2184
1460,宏遠,10,0,10,亞東-新竹,2024-07-31,2184
2365,昆盈,10,0,10,亞東-新竹,2024-07-31,2184
2548,華固,10,0,10,亞東-新竹,2024-07-31,2184
5519,隆大,10,0,10,亞東-新竹,2024-07-31,2184
8927,北基,11,1,10,亞東-新竹,2024-07-31,2184
8028,昇陽半導體,14,5,9,亞東-新竹,2024-07-31,2184
1529,樂事綠能,12,4,8,亞東-新竹,2024-07-31,2184
3388,崇越電,8,0,8,亞東-新竹,2024-07-31,2184
6266,泰詠,7,0,7,亞東-新竹,2024-07-31,2184
8054,安國,7,0,7,亞東-新竹,2024-07-31,2184
00878,國泰永續高股息,7,0,7,亞東-新竹,2024-07-31,2184
3580,友威科,7,1,6,亞東-新竹,2024-07-31,2184
0056,元大高股息,5,0,5,亞東-新竹,2024-07-31,2184
00946,群益科技高息成長,5,0,5,亞東-新竹,2024-07-31,2184
00935,野村臺灣新科技50,5,0,5,亞東-新竹,2024-07-31,2184
00706L,期元大S＆P日圓正2,40,35,5,亞東-新竹,2024-07-31,2184
1720,生達,6,1,5,亞東-新竹,2024-07-31,2184
2458,義隆,5,0,5,亞東-新竹,2024-07-31,2184
2618,長榮航,6,1,5,亞東-新竹,2024-07-31,2184
1513,中興電,5,1,4,亞東-新竹,2024-07-31,2184
3037,欣興,9,5,4,亞東-新竹,2024-07-31,2184
3035,智原,6,2,4,亞東-新竹,2024-07-31,2184
6869,雲豹能源,9,5,4,亞東-新竹,2024-07-31,2184
9945,潤泰新,5,1,4,亞東-新竹,2024-07-31,2184
3105,穩懋,3,0,3,亞東-新竹,2024-07-31,2184
00830,國泰費城半導體,3,0,3,亞東-新竹,2024-07-31,2184
00870B,元大15年EM主權債,3,0,3,亞東-新竹,2024-07-31,2184
2634,漢翔,3,0,3,亞東-新竹,2024-07-31,2184
3050,鈺德,3,0,3,亞東-新竹,2024-07-31,2184
3131,弘塑,4,1,3,亞東-新竹,2024-07-31,2184
2883,凱基金,1120,600,520,亞東-新竹,2024-08-01,2184
9904,寶成,90,0,90,亞東-新竹,2024-08-01,2184
6757,台灣虎航,80,0,80,亞東-新竹,2024-08-01,2184
00712,復華富時不動產,50,0,50,亞東-新竹,2024-08-01,2184
00633L,富邦上証正2,32,0,32,亞東-新竹,2024-08-01,2184
2887,台新金,31,0,31,亞東-新竹,2024-08-01,2184
00940,元大台灣價值高息,51,20,31,亞東-新竹,2024-08-01,2184
2349,錸德,40,10,30,亞東-新竹,2024-08-01,2184
3024,憶聲,30,0,30,亞東-新竹,2024-08-01,2184
00929,復華台灣科技優息,38,10,28,亞東-新竹,2024-08-01,2184
2363,矽統,20,2,18,亞東-新竹,2024-08-01,2184
6187,萬潤,16,0,16,亞東-新竹,2024-08-01,2184
1722,台肥,14,0,14,亞東-新竹,2024-08-01,2184
2834,臺企銀,13,1,12,亞東-新竹,2024-08-01,2184
8096,擎亞,12,0,12,亞東-新竹,2024-08-01,2184
00947,台新臺灣IC設計,10,0,10,亞東-新竹,2024-08-01,2184
00687B,國泰20年美債,10,0,10,亞東-新竹,2024-08-01,2184
2308,台達電,14,4,10,亞東-新竹,2024-08-01,2184
0050,元大台灣50,11,4,7,亞東-新竹,2024-08-01,2184
00934,中信成長高股息,6,0,6,亞東-新竹,2024-08-01,2184
1216,統一,6,0,6,亞東-新竹,2024-08-01,2184
2374,佳能,7,1,6,亞東-新竹,2024-08-01,2184
2610,華航,6,0,6,亞東-新竹,2024-08-01,2184
6806,森崴能源,5,0,5,亞東-新竹,2024-08-01,2184
2884,玉山金,5,0,5,亞東-新竹,2024-08-01,2184
3033,威健,5,0,5,亞東-新竹,2024-08-01,2184
3605,宏致,5,0,5,亞東-新竹,2024-08-01,2184
8390,金益鼎,5,0,5,亞東-新竹,2024-08-01,2184
00905,FT臺灣Smart,5,0,5,亞東-新竹,2024-08-01,2184
2454,聯發科,7,2,5,亞東-新竹,2024-08-01,2184
00937B,群益ESG投等債20,14,10,4,亞東-新竹,2024-08-01,2184
2464,盟立,11,7,4,亞東-新竹,2024-08-01,2184
3580,友威科,9,5,4,亞東-新竹,2024-08-01,2184
4113,聯上,8,4,4,亞東-新竹,2024-08-01,2184
5206,坤悅,4,0,4,亞東-新竹,2024-08-01,2184
8028,昇陽半導體,10,6,4,亞東-新竹,2024-08-01,2184
00713,元大台灣高息低波,3,0,3,亞東-新竹,2024-08-01,2184
00919,群益台灣精選高息,20,17,3,亞東-新竹,2024-08-01,2184
2345,智邦,3,0,3,亞東-新竹,2024-08-01,2184
5522,遠雄,3,0,3,亞東-新竹,2024-08-01,2184
00892,富邦台灣半導體,2,0,2,亞東-新竹,2024-08-01,2184
1324,地球,2,0,2,亞東-新竹,2024-08-01,2184
2201,裕隆,4,2,2,亞東-新竹,2024-08-01,2184
2313,華通,2,0,2,亞東-新竹,2024-08-01,2184
2383,台光電,4,2,2,亞東-新竹,2024-08-01,2184
3056,富華新,2,0,2,亞東-新竹,2024-08-01,2184
3227,原相,2,0,2,亞東-新竹,2024-08-01,2184
3518,柏騰,3,1,2,亞東-新竹,2024-08-01,2184
3703,欣陸,2,0,2,亞東-新竹,2024-08-01,2184
4157,太景*-KY,2,0,2,亞東-新竹,2024-08-01,2184
00712,復華富時不動產,263,0,263,亞東-新竹,2024-08-02,2184
2836,高雄銀,200,0,200,亞東-新竹,2024-08-02,2184
00632R,元大台灣50反1,145,25,120,亞東-新竹,2024-08-02,2184
2308,台達電,107,16,91,亞東-新竹,2024-08-02,2184
00878,國泰永續高股息,101,10,91,亞東-新竹,2024-08-02,2184
00919,群益台灣精選高息,111,25,86,亞東-新竹,2024-08-02,2184
00940,元大台灣價值高息,79,0,79,亞東-新竹,2024-08-02,2184
2610,華航,65,10,55,亞東-新竹,2024-08-02,2184
00688L,國泰20年美債正2,50,3,47,亞東-新竹,2024-08-02,2184
2317,鴻海,50,4,46,亞東-新竹,2024-08-02,2184
0050,元大台灣50,43,0,43,亞東-新竹,2024-08-02,2184
00687B,國泰20年美債,42,1,41,亞東-新竹,2024-08-02,2184
2303,聯電,38,6,32,亞東-新竹,2024-08-02,2184
9945,潤泰新,30,4,26,亞東-新竹,2024-08-02,2184
00939,統一台灣高息動能,24,0,24,亞東-新竹,2024-08-02,2184
4533,協易機,24,1,23,亞東-新竹,2024-08-02,2184
1449,佳和,22,0,22,亞東-新竹,2024-08-02,2184
5481,新華,21,0,21,亞東-新竹,2024-08-02,2184
2330,台積電,26,6,20,亞東-新竹,2024-08-02,2184
00877,復華中國5G,20,0,20,亞東-新竹,2024-08-02,2184
1460,宏遠,20,0,20,亞東-新竹,2024-08-02,2184
3037,欣興,18,0,18,亞東-新竹,2024-08-02,2184
2882,國泰金,22,4,18,亞東-新竹,2024-08-02,2184
00949,復華日本龍頭,15,0,15,亞東-新竹,2024-08-02,2184
3188,鑫龍騰,20,5,15,亞東-新竹,2024-08-02,2184
0056,元大高股息,20,5,15,亞東-新竹,2024-08-02,2184
2427,三商電,15,1,14,亞東-新竹,2024-08-02,2184
00881,國泰台灣5G+,14,0,14,亞東-新竹,2024-08-02,2184
00935,野村臺灣新科技50,13,0,13,亞東-新竹,2024-08-02,2184
3231,緯創,16,3,13,亞東-新竹,2024-08-02,2184
2201,裕隆,16,4,12,亞東-新竹,2024-08-02,2184
2886,兆豐金,12,0,12,亞東-新竹,2024-08-02,2184
2301,光寶科,13,2,11,亞東-新竹,2024-08-02,2184
2884,玉山金,11,0,11,亞東-新竹,2024-08-02,2184
00680L,元大美債20正2,10,0,10,亞東-新竹,2024-08-02,2184
00715L,期街口布蘭特正2,10,0,10,亞東-新竹,2024-08-02,2184
00690,兆豐藍籌30,10,0,10,亞東-新竹,2024-08-02,2184
00933B,國泰10Y+金融債,10,0,10,亞東-新竹,2024-08-02,2184
5515,建國,10,0,10,亞東-新竹,2024-08-02,2184
6757,台灣虎航,10,0,10,亞東-新竹,2024-08-02,2184
00830,國泰費城半導體,9,0,9,亞東-新竹,2024-08-02,2184
1324,地球,9,0,9,亞東-新竹,2024-08-02,2184
3580,友威科,13,4,9,亞東-新竹,2024-08-02,2184
00947,台新臺灣IC設計,8,0,8,亞東-新竹,2024-08-02,2184
2515,中工,8,0,8,亞東-新竹,2024-08-02,2184
8054,安國,8,0,8,亞東-新竹,2024-08-02,2184
2891,中信金,28,20,8,亞東-新竹,2024-08-02,2184
00905,FT臺灣Smart,7,0,7,亞東-新竹,2024-08-02,2184
00937B,群益ESG投等債20,11,4,7,亞東-新竹,2024-08-02,2184
2834,臺企銀,10,3,7,亞東-新竹,2024-08-02,2184
00937B,群益ESG投等債20,326,50,276,亞東-新竹,2024-08-05,2184
00878,國泰永續高股息,211,0,211,亞東-新竹,2024-08-05,2184
00940,元大台灣價值高息,220,9,211,亞東-新竹,2024-08-05,2184
1714,和桐,200,0,200,亞東-新竹,2024-08-05,2184
00929,復華台灣科技優息,202,9,193,亞東-新竹,2024-08-05,2184
0050,元大台灣50,125,3,122,亞東-新竹,2024-08-05,2184
1460,宏遠,113,0,113,亞東-新竹,2024-08-05,2184
00680L,元大美債20正2,122,12,110,亞東-新竹,2024-08-05,2184
00712,復華富時不動產,99,0,99,亞東-新竹,2024-08-05,2184
2887,台新金,101,10,91,亞東-新竹,2024-08-05,2184
2888,新光金,100,10,90,亞東-新竹,2024-08-05,2184
2891,中信金,99,30,69,亞東-新竹,2024-08-05,2184
00715L,期街口布蘭特正2,56,0,56,亞東-新竹,2024-08-05,2184
2330,台積電,65,10,55,亞東-新竹,2024-08-05,2184
3576,聯合再生,51,0,51,亞東-新竹,2024-08-05,2184
2409,友達,56,7,49,亞東-新竹,2024-08-05,2184
2618,長榮航,38,2,36,亞東-新竹,2024-08-05,2184
00687B,國泰20年美債,47,11,36,亞東-新竹,2024-08-05,2184
2382,廣達,33,4,29,亞東-新竹,2024-08-05,2184
00631L,元大台灣50正2,33,6,27,亞東-新竹,2024-08-05,2184
1324,地球,24,0,24,亞東-新竹,2024-08-05,2184
1301,台塑,31,9,22,亞東-新竹,2024-08-05,2184
00945B,凱基美國非投等債,20,0,20,亞東-新竹,2024-08-05,2184
1449,佳和,20,0,20,亞東-新竹,2024-08-05,2184
1710,東聯,20,0,20,亞東-新竹,2024-08-05,2184
006208,富邦台50,42,22,20,亞東-新竹,2024-08-05,2184
2427,三商電,19,0,19,亞東-新竹,2024-08-05,2184
2303,聯電,31,13,18,亞東-新竹,2024-08-05,2184
00936,台新永續高息中小,17,1,16,亞東-新竹,2024-08-05,2184
2836,高雄銀,16,0,16,亞東-新竹,2024-08-05,2184
2867,三商壽,16,0,16,亞東-新竹,2024-08-05,2184
0056,元大高股息,43,27,16,亞東-新竹,2024-08-05,2184
6147,頎邦,15,0,15,亞東-新竹,2024-08-05,2184
1313,聯成,15,0,15,亞東-新竹,2024-08-05,2184
2881,富邦金,36,21,15,亞東-新竹,2024-08-05,2184
9941,裕融,14,0,14,亞東-新竹,2024-08-05,2184
00830,國泰費城半導體,14,1,13,亞東-新竹,2024-08-05,2184
00927,群益半導體收益,13,0,13,亞東-新竹,2024-08-05,2184
6770,力積電,13,0,13,亞東-新竹,2024-08-05,2184
2454,聯發科,13,1,12,亞東-新竹,2024-08-05,2184
2458,義隆,12,0,12,亞東-新竹,2024-08-05,2184
00949,復華日本龍頭,13,1,12,亞東-新竹,2024-08-05,2184
00679B,元大美債20年,13,1,12,亞東-新竹,2024-08-05,2184
00888,永豐台灣ESG,11,0,11,亞東-新竹,2024-08-05,2184
00946,群益科技高息成長,15,4,11,亞東-新竹,2024-08-05,2184
1102,亞泥,12,1,11,亞東-新竹,2024-08-05,2184
1304,台聚,11,0,11,亞東-新竹,2024-08-05,2184
3711,日月光投控,11,0,11,亞東-新竹,2024-08-05,2184
00932,兆豐永續高息等權,11,0,11,亞東-新竹,2024-08-05,2184
00690,兆豐藍籌30,10,0,10,亞東-新竹,2024-08-05,2184
00632R,元大台灣50反1,531,0,531,亞東-新竹,2024-08-06,2184
2449,京元電子,115,3,112,亞東-新竹,2024-08-06,2184
1714,和桐,100,0,100,亞東-新竹,2024-08-06,2184
00679B,元大美債20年,116,27,89,亞東-新竹,2024-08-06,2184
00751B,元大AAA至A公司債,64,0,64,亞東-新竹,2024-08-06,2184
9945,潤泰新,55,0,55,亞東-新竹,2024-08-06,2184
2317,鴻海,87,44,43,亞東-新竹,2024-08-06,2184
0056,元大高股息,38,3,35,亞東-新竹,2024-08-06,2184
6163,華電網,42,10,32,亞東-新竹,2024-08-06,2184
00706L,期元大S＆P日圓正2,40,10,30,亞東-新竹,2024-08-06,2184
2836,高雄銀,30,0,30,亞東-新竹,2024-08-06,2184
3047,訊舟,22,0,22,亞東-新竹,2024-08-06,2184
00881,國泰台灣5G+,20,1,19,亞東-新竹,2024-08-06,2184
6116,彩晶,19,0,19,亞東-新竹,2024-08-06,2184
4904,遠傳,20,1,19,亞東-新竹,2024-08-06,2184
2520,冠德,22,5,17,亞東-新竹,2024-08-06,2184
00878,國泰永續高股息,22,6,16,亞東-新竹,2024-08-06,2184
3293,鈊象,16,0,16,亞東-新竹,2024-08-06,2184
3653,健策,16,0,16,亞東-新竹,2024-08-06,2184
9105,泰金寶-DR,15,0,15,亞東-新竹,2024-08-06,2184
2845,遠東銀,13,0,13,亞東-新竹,2024-08-06,2184
3062,建漢,13,0,13,亞東-新竹,2024-08-06,2184
00708L,期元大S＆P黃金正2,12,0,12,亞東-新竹,2024-08-06,2184
3024,憶聲,12,0,12,亞東-新竹,2024-08-06,2184
3481,群創,12,0,12,亞東-新竹,2024-08-06,2184
8028,昇陽半導體,12,0,12,亞東-新竹,2024-08-06,2184
9904,寶成,12,0,12,亞東-新竹,2024-08-06,2184
3711,日月光投控,12,1,11,亞東-新竹,2024-08-06,2184
6147,頎邦,10,0,10,亞東-新竹,2024-08-06,2184
00944,野村趨勢動能高息,10,0,10,亞東-新竹,2024-08-06,2184
2888,新光金,60,50,10,亞東-新竹,2024-08-06,2184
3652,精聯,10,0,10,亞東-新竹,2024-08-06,2184
6239,力成,12,2,10,亞東-新竹,2024-08-06,2184
1324,地球,9,0,9,亞東-新竹,2024-08-06,2184
2460,建通,8,0,8,亞東-新竹,2024-08-06,2184
3163,波若威,8,0,8,亞東-新竹,2024-08-06,2184
2603,長榮,13,5,8,亞東-新竹,2024-08-06,2184
2409,友達,12,5,7,亞東-新竹,2024-08-06,2184
3522,御嵿,7,0,7,亞東-新竹,2024-08-06,2184
4714,永捷,19,12,7,亞東-新竹,2024-08-06,2184
8054,安國,9,2,7,亞東-新竹,2024-08-06,2184
1808,潤隆,8,2,6,亞東-新竹,2024-08-06,2184
00902,中信電池及儲能,6,0,6,亞東-新竹,2024-08-06,2184
2365,昆盈,31,25,6,亞東-新竹,2024-08-06,2184
4147,中裕,7,1,6,亞東-新竹,2024-08-06,2184
2610,華航,5,0,5,亞東-新竹,2024-08-06,2184
6125,廣運,5,0,5,亞東-新竹,2024-08-06,2184
00946,群益科技高息成長,5,0,5,亞東-新竹,2024-08-06,2184
1309,台達化,5,0,5,亞東-新竹,2024-08-06,2184
1460,宏遠,5,0,5,亞東-新竹,2024-08-06,2184
00632R,元大台灣50反1,233,0,233,亞東-新竹,2024-08-07,2184
00679B,元大美債20年,125,0,125,亞東-新竹,2024-08-07,2184
00712,復華富時不動產,100,0,100,亞東-新竹,2024-08-07,2184
00751B,元大AAA至A公司債,100,3,97,亞東-新竹,2024-08-07,2184
2317,鴻海,102,20,82,亞東-新竹,2024-08-07,2184
00715L,期街口布蘭特正2,76,0,76,亞東-新竹,2024-08-07,2184
00937B,群益ESG投等債20,119,45,74,亞東-新竹,2024-08-07,2184
00720B,元大投資級公司債,50,0,50,亞東-新竹,2024-08-07,2184
00680L,元大美債20正2,110,60,50,亞東-新竹,2024-08-07,2184
3481,群創,51,1,50,亞東-新竹,2024-08-07,2184
00706L,期元大S＆P日圓正2,58,30,28,亞東-新竹,2024-08-07,2184
2409,友達,24,0,24,亞東-新竹,2024-08-07,2184
2412,中華電,20,0,20,亞東-新竹,2024-08-07,2184
00878,國泰永續高股息,22,2,20,亞東-新竹,2024-08-07,2184
1324,地球,18,0,18,亞東-新竹,2024-08-07,2184
00675L,富邦臺灣加權正2,25,8,17,亞東-新竹,2024-08-07,2184
3045,台灣大,16,1,15,亞東-新竹,2024-08-07,2184
2360,致茂,15,0,15,亞東-新竹,2024-08-07,2184
2915,潤泰全,14,0,14,亞東-新竹,2024-08-07,2184
2834,臺企銀,11,0,11,亞東-新竹,2024-08-07,2184
00933B,國泰10Y+金融債,10,0,10,亞東-新竹,2024-08-07,2184
00830,國泰費城半導體,10,0,10,亞東-新竹,2024-08-07,2184
00795B,中信美國公債20年,10,0,10,亞東-新竹,2024-08-07,2184
1611,中電,10,0,10,亞東-新竹,2024-08-07,2184
1809,中釉,10,0,10,亞東-新竹,2024-08-07,2184
2489,瑞軒,10,0,10,亞東-新竹,2024-08-07,2184
4904,遠傳,10,0,10,亞東-新竹,2024-08-07,2184
5225,東科-KY,10,0,10,亞東-新竹,2024-08-07,2184
8936,國統,11,1,10,亞東-新竹,2024-08-07,2184
1312,國喬,10,0,10,亞東-新竹,2024-08-07,2184
9914,美利達,9,0,9,亞東-新竹,2024-08-07,2184
2618,長榮航,17,9,8,亞東-新竹,2024-08-07,2184
2887,台新金,8,0,8,亞東-新竹,2024-08-07,2184
6274,台燿,7,0,7,亞東-新竹,2024-08-07,2184
2408,南亞科,8,2,6,亞東-新竹,2024-08-07,2184
3583,辛耘,7,1,6,亞東-新竹,2024-08-07,2184
9945,潤泰新,6,0,6,亞東-新竹,2024-08-07,2184
00895,富邦未來車,5,0,5,亞東-新竹,2024-08-07,2184
1309,台達化,5,0,5,亞東-新竹,2024-08-07,2184
1418,東華,5,0,5,亞東-新竹,2024-08-07,2184
1720,生達,5,0,5,亞東-新竹,2024-08-07,2184
2356,英業達,5,0,5,亞東-新竹,2024-08-07,2184
2449,京元電子,5,0,5,亞東-新竹,2024-08-07,2184
4540,全球傳動,5,0,5,亞東-新竹,2024-08-07,2184
9105,泰金寶-DR,5,0,5,亞東-新竹,2024-08-07,2184
3034,聯詠,6,2,4,亞東-新竹,2024-08-07,2184
00940,元大台灣價值高息,23,19,4,亞東-新竹,2024-08-07,2184
6116,彩晶,20,16,4,亞東-新竹,2024-08-07,2184
6509,聚和,4,0,4,亞東-新竹,2024-08-07,2184
00692,富邦公司治理,4,1,3,亞東-新竹,2024-08-07,2184
00664R,國泰臺灣加權反1,259,0,259,亞東-新竹,2024-08-08,2184
00937B,群益ESG投等債20,173,12,161,亞東-新竹,2024-08-08,2184
00720B,元大投資級公司債,126,0,126,亞東-新竹,2024-08-08,2184
00679B,元大美債20年,124,0,124,亞東-新竹,2024-08-08,2184
00878,國泰永續高股息,129,10,119,亞東-新竹,2024-08-08,2184
00751B,元大AAA至A公司債,100,0,100,亞東-新竹,2024-08-08,2184
2886,兆豐金,82,2,80,亞東-新竹,2024-08-08,2184
00688L,國泰20年美債正2,51,0,51,亞東-新竹,2024-08-08,2184
2891,中信金,73,32,41,亞東-新竹,2024-08-08,2184
00680L,元大美債20正2,52,20,32,亞東-新竹,2024-08-08,2184
2489,瑞軒,25,0,25,亞東-新竹,2024-08-08,2184
00687B,國泰20年美債,22,0,22,亞東-新竹,2024-08-08,2184
00642U,期元大S＆P石油,21,0,21,亞東-新竹,2024-08-08,2184
2317,鴻海,32,15,17,亞東-新竹,2024-08-08,2184
00919,群益台灣精選高息,19,2,17,亞東-新竹,2024-08-08,2184
3580,友威科,18,3,15,亞東-新竹,2024-08-08,2184
00900,富邦特選高股息30,14,0,14,亞東-新竹,2024-08-08,2184
6239,力成,12,0,12,亞東-新竹,2024-08-08,2184
0050,元大台灣50,10,0,10,亞東-新竹,2024-08-08,2184
3481,群創,10,0,10,亞東-新竹,2024-08-08,2184
00933B,國泰10Y+金融債,10,0,10,亞東-新竹,2024-08-08,2184
2201,裕隆,23,13,10,亞東-新竹,2024-08-08,2184
2408,南亞科,12,2,10,亞東-新竹,2024-08-08,2184
2812,台中銀,10,0,10,亞東-新竹,2024-08-08,2184
2888,新光金,50,40,10,亞東-新竹,2024-08-08,2184
6138,茂達,10,0,10,亞東-新竹,2024-08-08,2184
1785,光洋科,9,0,9,亞東-新竹,2024-08-08,2184
00692,富邦公司治理,8,0,8,亞東-新竹,2024-08-08,2184
2615,萬海,13,5,8,亞東-新竹,2024-08-08,2184
3047,訊舟,8,0,8,亞東-新竹,2024-08-08,2184
4533,協易機,14,6,8,亞東-新竹,2024-08-08,2184
1324,地球,7,0,7,亞東-新竹,2024-08-08,2184
2002,中鋼,7,0,7,亞東-新竹,2024-08-08,2184
2362,藍天,7,0,7,亞東-新竹,2024-08-08,2184
2834,臺企銀,166,160,6,亞東-新竹,2024-08-08,2184
2382,廣達,10,5,5,亞東-新竹,2024-08-08,2184
2344,華邦電,14,9,5,亞東-新竹,2024-08-08,2184
1536,和大,32,27,5,亞東-新竹,2024-08-08,2184
1611,中電,5,0,5,亞東-新竹,2024-08-08,2184
2349,錸德,5,0,5,亞東-新竹,2024-08-08,2184
2359,所羅門,29,24,5,亞東-新竹,2024-08-08,2184
2610,華航,5,0,5,亞東-新竹,2024-08-08,2184
2618,長榮航,13,8,5,亞東-新竹,2024-08-08,2184
2836,高雄銀,5,0,5,亞東-新竹,2024-08-08,2184
2867,三商壽,5,0,5,亞東-新竹,2024-08-08,2184
4510,高鋒,23,18,5,亞東-新竹,2024-08-08,2184
2845,遠東銀,5,1,4,亞東-新竹,2024-08-08,2184
00685L,群益臺灣加權正2,4,0,4,亞東-新竹,2024-08-08,2184
1808,潤隆,6,2,4,亞東-新竹,2024-08-08,2184
2353,宏��,4,0,4,亞東-新竹,2024-08-08,2184
2882,國泰金,503,24,479,亞東-新竹,2024-08-09,2184
2883,凱基金,515,300,215,亞東-新竹,2024-08-09,2184
00632R,元大台灣50反1,172,0,172,亞東-新竹,2024-08-09,2184
2618,長榮航,125,10,115,亞東-新竹,2024-08-09,2184
00937B,群益ESG投等債20,110,3,107,亞東-新竹,2024-08-09,2184
2886,兆豐金,78,0,78,亞東-新竹,2024-08-09,2184
00679B,元大美債20年,75,3,72,亞東-新竹,2024-08-09,2184
00720B,元大投資級公司債,56,0,56,亞東-新竹,2024-08-09,2184
00948B,中信優息投資級債,50,0,50,亞東-新竹,2024-08-09,2184
00751B,元大AAA至A公司債,50,5,45,亞東-新竹,2024-08-09,2184
2542,興富發,41,0,41,亞東-新竹,2024-08-09,2184
6177,達麗,34,0,34,亞東-新竹,2024-08-09,2184
3024,憶聲,20,0,20,亞東-新竹,2024-08-09,2184
00687B,國泰20年美債,22,3,19,亞東-新竹,2024-08-09,2184
1609,大亞,24,6,18,亞東-新竹,2024-08-09,2184
2836,高雄銀,15,0,15,亞東-新竹,2024-08-09,2184
8936,國統,15,0,15,亞東-新竹,2024-08-09,2184
00795B,中信美國公債20年,18,5,13,亞東-新竹,2024-08-09,2184
00685L,群益臺灣加權正2,15,3,12,亞東-新竹,2024-08-09,2184
1720,生達,21,9,12,亞東-新竹,2024-08-09,2184
00878,國泰永續高股息,14,3,11,亞東-新竹,2024-08-09,2184
3260,威剛,12,1,11,亞東-新竹,2024-08-09,2184
00857B,永豐20年美公債,10,0,10,亞東-新竹,2024-08-09,2184
1312,國喬,10,0,10,亞東-新竹,2024-08-09,2184
1618,合機,10,0,10,亞東-新竹,2024-08-09,2184
2812,台中銀,10,0,10,亞東-新竹,2024-08-09,2184
6239,力成,11,2,9,亞東-新竹,2024-08-09,2184
00692,富邦公司治理,8,0,8,亞東-新竹,2024-08-09,2184
2615,萬海,26,18,8,亞東-新竹,2024-08-09,2184
4510,高鋒,10,2,8,亞東-新竹,2024-08-09,2184
1324,地球,7,0,7,亞東-新竹,2024-08-09,2184
00946,群益科技高息成長,7,1,6,亞東-新竹,2024-08-09,2184
2515,中工,6,0,6,亞東-新竹,2024-08-09,2184
4763,材料-KY,6,0,6,亞東-新竹,2024-08-09,2184
2603,長榮,7,1,6,亞東-新竹,2024-08-09,2184
00931B,統一美債20年,5,0,5,亞東-新竹,2024-08-09,2184
00934,中信成長高股息,5,0,5,亞東-新竹,2024-08-09,2184
1536,和大,25,20,5,亞東-新竹,2024-08-09,2184
2467,志聖,7,2,5,亞東-新竹,2024-08-09,2184
5534,長虹,5,0,5,亞東-新竹,2024-08-09,2184
3231,緯創,11,6,5,亞東-新竹,2024-08-09,2184
00941,中信上游半導體,6,2,4,亞東-新竹,2024-08-09,2184
2419,仲琦,4,0,4,亞東-新竹,2024-08-09,2184
2458,義隆,5,1,4,亞東-新竹,2024-08-09,2184
3293,鈊象,4,0,4,亞東-新竹,2024-08-09,2184
4768,晶呈科技,3,0,3,亞東-新竹,2024-08-09,2184
00940,元大台灣價值高息,15,12,3,亞東-新竹,2024-08-09,2184
00902,中信電池及儲能,3,0,3,亞東-新竹,2024-08-09,2184
00764B,群益25年美債,3,0,3,亞東-新竹,2024-08-09,2184
2308,台達電,4,1,3,亞東-新竹,2024-08-09,2184
2883,凱基金,321,0,321,亞東-新竹,2024-08-12,2184
00751B,元大AAA至A公司債,131,4,127,亞東-新竹,2024-08-12,2184
00679B,元大美債20年,83,0,83,亞東-新竹,2024-08-12,2184
2537,聯上發,31,1,30,亞東-新竹,2024-08-12,2184
1324,地球,21,0,21,亞東-新竹,2024-08-12,2184
2613,中櫃,17,0,17,亞東-新竹,2024-08-12,2184
00795B,中信美國公債20年,16,0,16,亞東-新竹,2024-08-12,2184
00687B,國泰20年美債,15,0,15,亞東-新竹,2024-08-12,2184
00685L,群益臺灣加權正2,15,1,14,亞東-新竹,2024-08-12,2184
2409,友達,15,1,14,亞東-新竹,2024-08-12,2184
4563,百德,17,3,14,亞東-新竹,2024-08-12,2184
00680L,元大美債20正2,12,0,12,亞東-新竹,2024-08-12,2184
3024,憶聲,11,0,11,亞東-新竹,2024-08-12,2184
8064,東捷,11,0,11,亞東-新竹,2024-08-12,2184
00933B,國泰10Y+金融債,10,0,10,亞東-新竹,2024-08-12,2184
00632R,元大台灣50反1,10,0,10,亞東-新竹,2024-08-12,2184
00675L,富邦臺灣加權正2,11,1,10,亞東-新竹,2024-08-12,2184
2912,統一超,10,0,10,亞東-新竹,2024-08-12,2184
2359,所羅門,25,17,8,亞東-新竹,2024-08-12,2184
2891,中信金,8,1,7,亞東-新竹,2024-08-12,2184
3711,日月光投控,10,3,7,亞東-新竹,2024-08-12,2184
00670L,富邦NASDAQ正2,6,0,6,亞東-新竹,2024-08-12,2184
2542,興富發,6,0,6,亞東-新竹,2024-08-12,2184
3163,波若威,6,0,6,亞東-新竹,2024-08-12,2184
8011,台通,6,0,6,亞東-新竹,2024-08-12,2184
00946,群益科技高息成長,5,0,5,亞東-新竹,2024-08-12,2184
00706L,期元大S＆P日圓正2,5,0,5,亞東-新竹,2024-08-12,2184
00688L,國泰20年美債正2,5,0,5,亞東-新竹,2024-08-12,2184
1321,大洋,5,0,5,亞東-新竹,2024-08-12,2184
1402,遠東新,5,0,5,亞東-新竹,2024-08-12,2184
2845,遠東銀,5,0,5,亞東-新竹,2024-08-12,2184
3581,博磊,6,1,5,亞東-新竹,2024-08-12,2184
6163,華電網,5,0,5,亞東-新竹,2024-08-12,2184
9914,美利達,5,0,5,亞東-新竹,2024-08-12,2184
2892,第一金,4,0,4,亞東-新竹,2024-08-12,2184
1720,生達,4,0,4,亞東-新竹,2024-08-12,2184
8092,建暐,4,0,4,亞東-新竹,2024-08-12,2184
00720B,元大投資級公司債,3,0,3,亞東-新竹,2024-08-12,2184
1326,台化,3,0,3,亞東-新竹,2024-08-12,2184
3032,偉訓,5,2,3,亞東-新竹,2024-08-12,2184
3419,譁裕,3,0,3,亞東-新竹,2024-08-12,2184
3518,柏騰,6,3,3,亞東-新竹,2024-08-12,2184
3535,晶彩科,4,1,3,亞東-新竹,2024-08-12,2184
6239,力成,7,4,3,亞東-新竹,2024-08-12,2184
2301,光寶科,3,0,3,亞東-新竹,2024-08-12,2184
6605,帝寶,2,0,2,亞東-新竹,2024-08-12,2184
00712,復華富時不動產,2,0,2,亞東-新竹,2024-08-12,2184
2317,鴻海,24,22,2,亞東-新竹,2024-08-12,2184
00850,元大臺灣ESG永續,2,0,2,亞東-新竹,2024-08-12,2184
1101,台泥,2,0,2,亞東-新竹,2024-08-12,2184
2615,萬海,97,9,88,亞東-新竹,2024-08-13,2184
00687B,國泰20年美債,88,2,86,亞東-新竹,2024-08-13,2184
00679B,元大美債20年,62,0,62,亞東-新竹,2024-08-13,2184
00632R,元大台灣50反1,45,0,45,亞東-新竹,2024-08-13,2184
00712,復華富時不動產,36,0,36,亞東-新竹,2024-08-13,2184
2834,臺企銀,30,0,30,亞東-新竹,2024-08-13,2184
00664R,國泰臺灣加權反1,30,0,30,亞東-新竹,2024-08-13,2184
2408,南亞科,31,1,30,亞東-新竹,2024-08-13,2184
3376,新日興,32,4,28,亞東-新竹,2024-08-13,2184
1326,台化,25,0,25,亞東-新竹,2024-08-13,2184
2070,精湛,24,0,24,亞東-新竹,2024-08-13,2184
1301,台塑,23,0,23,亞東-新竹,2024-08-13,2184
5443,均豪,20,3,17,亞東-新竹,2024-08-13,2184
00933B,國泰10Y+金融債,13,0,13,亞東-新竹,2024-08-13,2184
2301,光寶科,13,1,12,亞東-新竹,2024-08-13,2184
6163,華電網,12,0,12,亞東-新竹,2024-08-13,2184
2845,遠東銀,111,100,11,亞東-新竹,2024-08-13,2184
2891,中信金,11,0,11,亞東-新竹,2024-08-13,2184
00673R,期元大S＆P原油反1,10,0,10,亞東-新竹,2024-08-13,2184
00693U,期街口S＆P黃豆,10,0,10,亞東-新竹,2024-08-13,2184
6122,擎邦,10,0,10,亞東-新竹,2024-08-13,2184
2356,英業達,9,0,9,亞東-新竹,2024-08-13,2184
2603,長榮,38,29,9,亞東-新竹,2024-08-13,2184
2882,國泰金,11,2,9,亞東-新竹,2024-08-13,2184
3013,晟銘電,12,3,9,亞東-新竹,2024-08-13,2184
1808,潤隆,12,4,8,亞東-新竹,2024-08-13,2184
4714,永捷,8,0,8,亞東-新竹,2024-08-13,2184
2880,華南金,8,1,7,亞東-新竹,2024-08-13,2184
2406,國碩,7,0,7,亞東-新竹,2024-08-13,2184
6269,台郡,7,0,7,亞東-新竹,2024-08-13,2184
3231,緯創,12,6,6,亞東-新竹,2024-08-13,2184
2886,兆豐金,7,1,6,亞東-新竹,2024-08-13,2184
00675L,富邦臺灣加權正2,6,1,5,亞東-新竹,2024-08-13,2184
00929,復華台灣科技優息,5,0,5,亞東-新竹,2024-08-13,2184
2836,高雄銀,5,0,5,亞東-新竹,2024-08-13,2184
3289,宜特,5,0,5,亞東-新竹,2024-08-13,2184
6180,橘子,5,0,5,亞東-新竹,2024-08-13,2184
6274,台燿,5,0,5,亞東-新竹,2024-08-13,2184
6547,高端疫苗,5,0,5,亞東-新竹,2024-08-13,2184
1702,南僑,7,3,4,亞東-新竹,2024-08-13,2184
1795,美時,8,4,4,亞東-新竹,2024-08-13,2184
2201,裕隆,8,4,4,亞東-新竹,2024-08-13,2184
2365,昆盈,18,14,4,亞東-新竹,2024-08-13,2184
3062,建漢,29,25,4,亞東-新竹,2024-08-13,2184
3591,艾笛森,4,0,4,亞東-新竹,2024-08-13,2184
4513,福裕,5,1,4,亞東-新竹,2024-08-13,2184
5347,世界,4,0,4,亞東-新竹,2024-08-13,2184
8040,九暘,4,0,4,亞東-新竹,2024-08-13,2184
00919,群益台灣精選高息,3,0,3,亞東-新竹,2024-08-13,2184
1324,地球,3,0,3,亞東-新竹,2024-08-13,2184
00688L,國泰20年美債正2,160,0,160,亞東-新竹,2024-08-14,2184
9958,世紀鋼,30,0,30,亞東-新竹,2024-08-14,2184
2888,新光金,50,21,29,亞東-新竹,2024-08-14,2184
1101,台泥,26,1,25,亞東-新竹,2024-08-14,2184
2812,台中銀,20,0,20,亞東-新竹,2024-08-14,2184
5522,遠雄,21,1,20,亞東-新竹,2024-08-14,2184
3481,群創,21,2,19,亞東-新竹,2024-08-14,2184
2323,中環,15,0,15,亞東-新竹,2024-08-14,2184
1618,合機,13,0,13,亞東-新竹,2024-08-14,2184
2367,燿華,34,21,13,亞東-新竹,2024-08-14,2184
00632R,元大台灣50反1,12,0,12,亞東-新竹,2024-08-14,2184
00795B,中信美國公債20年,11,0,11,亞東-新竹,2024-08-14,2184
00937B,群益ESG投等債20,11,0,11,亞東-新竹,2024-08-14,2184
00936,台新永續高息中小,10,0,10,亞東-新竹,2024-08-14,2184
2455,全新,10,0,10,亞東-新竹,2024-08-14,2184
2845,遠東銀,20,10,10,亞東-新竹,2024-08-14,2184
3231,緯創,16,6,10,亞東-新竹,2024-08-14,2184
3363,上詮,10,0,10,亞東-新竹,2024-08-14,2184
3376,新日興,10,0,10,亞東-新竹,2024-08-14,2184
6269,台郡,10,0,10,亞東-新竹,2024-08-14,2184
2312,金寶,10,1,9,亞東-新竹,2024-08-14,2184
3048,益登,9,0,9,亞東-新竹,2024-08-14,2184
4563,百德,10,1,9,亞東-新竹,2024-08-14,2184
6451,訊芯-KY,13,4,9,亞東-新竹,2024-08-14,2184
3019,亞光,9,0,9,亞東-新竹,2024-08-14,2184
2409,友達,10,2,8,亞東-新竹,2024-08-14,2184
2610,華航,15,8,7,亞東-新竹,2024-08-14,2184
2891,中信金,8,1,7,亞東-新竹,2024-08-14,2184
6462,神盾,10,4,6,亞東-新竹,2024-08-14,2184
00878,國泰永續高股息,5,0,5,亞東-新竹,2024-08-14,2184
00933B,國泰10Y+金融債,5,0,5,亞東-新竹,2024-08-14,2184
00715L,期街口布蘭特正2,5,0,5,亞東-新竹,2024-08-14,2184
2516,新建,5,0,5,亞東-新竹,2024-08-14,2184
5864,致和證,5,0,5,亞東-新竹,2024-08-14,2184
6560,欣普羅,5,0,5,亞東-新竹,2024-08-14,2184
9105,泰金寶-DR,5,0,5,亞東-新竹,2024-08-14,2184
1785,光洋科,12,8,4,亞東-新竹,2024-08-14,2184
00675L,富邦臺灣加權正2,5,1,4,亞東-新竹,2024-08-14,2184
2464,盟立,7,3,4,亞東-新竹,2024-08-14,2184
2609,陽明,4,0,4,亞東-新竹,2024-08-14,2184
8054,安國,13,9,4,亞東-新竹,2024-08-14,2184
2002,中鋼,3,0,3,亞東-新竹,2024-08-14,2184
6414,樺漢,6,3,3,亞東-新竹,2024-08-14,2184
2345,智邦,3,0,3,亞東-新竹,2024-08-14,2184
2371,大同,4,1,3,亞東-新竹,2024-08-14,2184
2449,京元電子,4,1,3,亞東-新竹,2024-08-14,2184
4714,永捷,3,0,3,亞東-新竹,2024-08-14,2184
6151,晉倫,3,0,3,亞東-新竹,2024-08-14,2184
1513,中興電,4,2,2,亞東-新竹,2024-08-14,2184
00670L,富邦NASDAQ正2,2,0,2,亞東-新竹,2024-08-14,2184
00679B,元大美債20年,101,16,85,亞東-新竹,2024-08-15,2184
00687B,國泰20年美債,87,5,82,亞東-新竹,2024-08-15,2184
2349,錸德,70,0,70,亞東-新竹,2024-08-15,2184
2489,瑞軒,27,0,27,亞東-新竹,2024-08-15,2184
6016,康和證,25,0,25,亞東-新竹,2024-08-15,2184
00878,國泰永續高股息,17,0,17,亞東-新竹,2024-08-15,2184
00632R,元大台灣50反1,22,5,17,亞東-新竹,2024-08-15,2184
00933B,國泰10Y+金融債,15,0,15,亞東-新竹,2024-08-15,2184
1316,上曜,15,0,15,亞東-新竹,2024-08-15,2184
3645,達邁,21,6,15,亞東-新竹,2024-08-15,2184
9904,寶成,15,0,15,亞東-新竹,2024-08-15,2184
2303,聯電,19,5,14,亞東-新竹,2024-08-15,2184
2884,玉山金,15,4,11,亞東-新竹,2024-08-15,2184
00919,群益台灣精選高息,10,0,10,亞東-新竹,2024-08-15,2184
00706L,期元大S＆P日圓正2,10,0,10,亞東-新竹,2024-08-15,2184
1702,南僑,10,0,10,亞東-新竹,2024-08-15,2184
2204,中華,10,0,10,亞東-新竹,2024-08-15,2184
6005,群益證,10,0,10,亞東-新竹,2024-08-15,2184
6188,廣明,12,2,10,亞東-新竹,2024-08-15,2184
0056,元大高股息,9,0,9,亞東-新竹,2024-08-15,2184
4540,全球傳動,13,4,9,亞東-新竹,2024-08-15,2184
1536,和大,27,19,8,亞東-新竹,2024-08-15,2184
2903,遠百,8,0,8,亞東-新竹,2024-08-15,2184
2002,中鋼,10,3,7,亞東-新竹,2024-08-15,2184
00891,中信關鍵半導體,9,2,7,亞東-新竹,2024-08-15,2184
2891,中信金,6,0,6,亞東-新竹,2024-08-15,2184
1101,台泥,6,0,6,亞東-新竹,2024-08-15,2184
1324,地球,6,0,6,亞東-新竹,2024-08-15,2184
8096,擎亞,16,10,6,亞東-新竹,2024-08-15,2184
3483,力致,5,0,5,亞東-新竹,2024-08-15,2184
2834,臺企銀,5,0,5,亞東-新竹,2024-08-15,2184
2845,遠東銀,20,15,5,亞東-新竹,2024-08-15,2184
3231,緯創,7,2,5,亞東-新竹,2024-08-15,2184
5347,世界,5,0,5,亞東-新竹,2024-08-15,2184
2892,第一金,5,1,4,亞東-新竹,2024-08-15,2184
2801,彰銀,7,3,4,亞東-新竹,2024-08-15,2184
00881,國泰台灣5G+,5,1,4,亞東-新竹,2024-08-15,2184
1708,東鹼,4,0,4,亞東-新竹,2024-08-15,2184
2201,裕隆,8,4,4,亞東-新竹,2024-08-15,2184
2352,佳世達,4,0,4,亞東-新竹,2024-08-15,2184
2356,英業達,8,4,4,亞東-新竹,2024-08-15,2184
2406,國碩,4,0,4,亞東-新竹,2024-08-15,2184
2467,志聖,4,0,4,亞東-新竹,2024-08-15,2184
3128,昇銳,4,0,4,亞東-新竹,2024-08-15,2184
3580,友威科,8,4,4,亞東-新竹,2024-08-15,2184
3663,鑫科,7,3,4,亞東-新竹,2024-08-15,2184
4303,信立,4,0,4,亞東-新竹,2024-08-15,2184
3017,奇鋐,4,0,4,亞東-新竹,2024-08-15,2184
2317,鴻海,16,12,4,亞東-新竹,2024-08-15,2184
00904,新光臺灣半導體30,5,2,3,亞東-新竹,2024-08-15,2184
00687B,國泰20年美債,150,0,150,亞東-新竹,2024-08-16,2184
00948B,中信優息投資級債,99,0,99,亞東-新竹,2024-08-16,2184
2504,國產,44,6,38,亞東-新竹,2024-08-16,2184
2317,鴻海,47,17,30,亞東-新竹,2024-08-16,2184
3024,憶聲,23,0,23,亞東-新竹,2024-08-16,2184
00664R,國泰臺灣加權反1,20,0,20,亞東-新竹,2024-08-16,2184
00673R,期元大S＆P原油反1,20,0,20,亞東-新竹,2024-08-16,2184
3230,錦明,20,0,20,亞東-新竹,2024-08-16,2184
6122,擎邦,20,0,20,亞東-新竹,2024-08-16,2184
00929,復華台灣科技優息,39,20,19,亞東-新竹,2024-08-16,2184
00680L,元大美債20正2,18,0,18,亞東-新竹,2024-08-16,2184
00900,富邦特選高股息30,14,0,14,亞東-新竹,2024-08-16,2184
00795B,中信美國公債20年,13,0,13,亞東-新竹,2024-08-16,2184
1785,光洋科,23,10,13,亞東-新竹,2024-08-16,2184
2489,瑞軒,27,14,13,亞東-新竹,2024-08-16,2184
2002,中鋼,12,0,12,亞東-新竹,2024-08-16,2184
2025,千興,12,0,12,亞東-新竹,2024-08-16,2184
2367,燿華,20,10,10,亞東-新竹,2024-08-16,2184
3081,聯亞,10,0,10,亞東-新竹,2024-08-16,2184
3105,穩懋,10,0,10,亞東-新竹,2024-08-16,2184
5364,力麗店,10,0,10,亞東-新竹,2024-08-16,2184
6239,力成,11,1,10,亞東-新竹,2024-08-16,2184
00932,兆豐永續高息等權,9,0,9,亞東-新竹,2024-08-16,2184
1460,宏遠,9,0,9,亞東-新竹,2024-08-16,2184
3363,上詮,10,1,9,亞東-新竹,2024-08-16,2184
4562,穎漢,29,20,9,亞東-新竹,2024-08-16,2184
1316,上曜,8,0,8,亞東-新竹,2024-08-16,2184
1441,大東,7,0,7,亞東-新竹,2024-08-16,2184
8069,元太,8,1,7,亞東-新竹,2024-08-16,2184
9935,慶豐富,7,0,7,亞東-新竹,2024-08-16,2184
00675L,富邦臺灣加權正2,8,1,7,亞東-新竹,2024-08-16,2184
1324,地球,6,0,6,亞東-新竹,2024-08-16,2184
2312,金寶,6,0,6,亞東-新竹,2024-08-16,2184
5371,中光電,10,4,6,亞東-新竹,2024-08-16,2184
6147,頎邦,6,0,6,亞東-新竹,2024-08-16,2184
00706L,期元大S＆P日圓正2,10,5,5,亞東-新竹,2024-08-16,2184
00685L,群益臺灣加權正2,5,0,5,亞東-新竹,2024-08-16,2184
00921,兆豐龍頭等權重,5,0,5,亞東-新竹,2024-08-16,2184
1210,大成,5,0,5,亞東-新竹,2024-08-16,2184
2258,鴻華先進-創,5,0,5,亞東-新竹,2024-08-16,2184
3048,益登,6,1,5,亞東-新竹,2024-08-16,2184
6188,廣明,24,19,5,亞東-新竹,2024-08-16,2184
8096,擎亞,15,10,5,亞東-新竹,2024-08-16,2184
00882,中信中國高股息,4,0,4,亞東-新竹,2024-08-16,2184
00670L,富邦NASDAQ正2,4,0,4,亞東-新竹,2024-08-16,2184
1702,南僑,4,0,4,亞東-新竹,2024-08-16,2184
2103,台橡,4,0,4,亞東-新竹,2024-08-16,2184
2845,遠東銀,14,10,4,亞東-新竹,2024-08-16,2184
2376,技嘉,6,2,4,亞東-新竹,2024-08-16,2184
3706,神達,3,0,3,亞東-新竹,2024-08-16,2184
2883,凱基金,300,100,200,亞東-新竹,2024-08-19,2184
00687B,國泰20年美債,140,0,140,亞東-新竹,2024-08-19,2184
00751B,元大AAA至A公司債,89,0,89,亞東-新竹,2024-08-19,2184
2204,中華,30,0,30,亞東-新竹,2024-08-19,2184
6757,台灣虎航,30,0,30,亞東-新竹,2024-08-19,2184
00715L,期街口布蘭特正2,38,12,26,亞東-新竹,2024-08-19,2184
00679B,元大美債20年,26,0,26,亞東-新竹,2024-08-19,2184
6122,擎邦,22,0,22,亞東-新竹,2024-08-19,2184
8028,昇陽半導體,21,0,21,亞東-新竹,2024-08-19,2184
00632R,元大台灣50反1,20,0,20,亞東-新竹,2024-08-19,2184
2367,燿華,33,13,20,亞東-新竹,2024-08-19,2184
2408,南亞科,20,0,20,亞東-新竹,2024-08-19,2184
00929,復華台灣科技優息,23,4,19,亞東-新竹,2024-08-19,2184
2002,中鋼,23,4,19,亞東-新竹,2024-08-19,2184
3645,達邁,19,1,18,亞東-新竹,2024-08-19,2184
00935,野村臺灣新科技50,17,0,17,亞東-新竹,2024-08-19,2184
1102,亞泥,22,5,17,亞東-新竹,2024-08-19,2184
3006,晶豪科,16,0,16,亞東-新竹,2024-08-19,2184
6609,瀧澤科,21,5,16,亞東-新竹,2024-08-19,2184
00680L,元大美債20正2,14,0,14,亞東-新竹,2024-08-19,2184
3363,上詮,18,4,14,亞東-新竹,2024-08-19,2184
2317,鴻海,49,35,14,亞東-新竹,2024-08-19,2184
4930,燦星網,11,0,11,亞東-新竹,2024-08-19,2184
00675L,富邦臺灣加權正2,10,0,10,亞東-新竹,2024-08-19,2184
2359,所羅門,27,17,10,亞東-新竹,2024-08-19,2184
3047,訊舟,10,0,10,亞東-新竹,2024-08-19,2184
5306,桂盟,10,0,10,亞東-新竹,2024-08-19,2184
6547,高端疫苗,10,0,10,亞東-新竹,2024-08-19,2184
8027,鈦昇,10,0,10,亞東-新竹,2024-08-19,2184
00937B,群益ESG投等債20,9,0,9,亞東-新竹,2024-08-19,2184
1402,遠東新,14,5,9,亞東-新竹,2024-08-19,2184
2464,盟立,17,8,9,亞東-新竹,2024-08-19,2184
3551,世禾,9,0,9,亞東-新竹,2024-08-19,2184
5519,隆大,10,1,9,亞東-新竹,2024-08-19,2184
8069,元太,9,0,9,亞東-新竹,2024-08-19,2184
00940,元大台灣價值高息,15,9,6,亞東-新竹,2024-08-19,2184
00905,FT臺灣Smart,6,0,6,亞東-新竹,2024-08-19,2184
2881,富邦金,6,0,6,亞東-新竹,2024-08-19,2184
3024,憶聲,6,0,6,亞東-新竹,2024-08-19,2184
8021,尖點,6,0,6,亞東-新竹,2024-08-19,2184
2303,聯電,11,5,6,亞東-新竹,2024-08-19,2184
00712,復華富時不動產,5,0,5,亞東-新竹,2024-08-19,2184
00706L,期元大S＆P日圓正2,5,0,5,亞東-新竹,2024-08-19,2184
00891,中信關鍵半導體,5,0,5,亞東-新竹,2024-08-19,2184
1536,和大,23,18,5,亞東-新竹,2024-08-19,2184
1808,潤隆,5,0,5,亞東-新竹,2024-08-19,2184
2474,可成,6,1,5,亞東-新竹,2024-08-19,2184
2610,華航,5,0,5,亞東-新竹,2024-08-19,2184
2615,萬海,9,4,5,亞東-新竹,2024-08-19,2184
2882,國泰金,5,0,5,亞東-新竹,2024-08-19,2184
00948B,中信優息投資級債,50,0,50,亞東-新竹,2024-08-20,2184
6547,高端疫苗,44,0,44,亞東-新竹,2024-08-20,2184
00632R,元大台灣50反1,40,0,40,亞東-新竹,2024-08-20,2184
00706L,期元大S＆P日圓正2,35,0,35,亞東-新竹,2024-08-20,2184
00720B,元大投資級公司債,51,20,31,亞東-新竹,2024-08-20,2184
2349,錸德,30,0,30,亞東-新竹,2024-08-20,2184
00715L,期街口布蘭特正2,30,8,22,亞東-新竹,2024-08-20,2184
00687B,國泰20年美債,21,0,21,亞東-新竹,2024-08-20,2184
2317,鴻海,20,1,19,亞東-新竹,2024-08-20,2184
00929,復華台灣科技優息,26,7,19,亞東-新竹,2024-08-20,2184
1785,光洋科,34,16,18,亞東-新竹,2024-08-20,2184
9945,潤泰新,21,4,17,亞東-新竹,2024-08-20,2184
3324,雙鴻,16,0,16,亞東-新竹,2024-08-20,2184
1611,中電,15,0,15,亞東-新竹,2024-08-20,2184
3528,安馳,12,0,12,亞東-新竹,2024-08-20,2184
8028,昇陽半導體,36,24,12,亞東-新竹,2024-08-20,2184
1609,大亞,12,1,11,亞東-新竹,2024-08-20,2184
1102,亞泥,11,0,11,亞東-新竹,2024-08-20,2184
2367,燿華,16,5,11,亞東-新竹,2024-08-20,2184
6698,旭暉應材,22,11,11,亞東-新竹,2024-08-20,2184
8107,大億金茂,11,0,11,亞東-新竹,2024-08-20,2184
1618,合機,10,0,10,亞東-新竹,2024-08-20,2184
00934,中信成長高股息,10,0,10,亞東-新竹,2024-08-20,2184
1312,國喬,10,0,10,亞東-新竹,2024-08-20,2184
2405,輔信,10,0,10,亞東-新竹,2024-08-20,2184
2409,友達,10,0,10,亞東-新竹,2024-08-20,2184
3312,弘憶股,11,1,10,亞東-新竹,2024-08-20,2184
1324,地球,9,0,9,亞東-新竹,2024-08-20,2184
4303,信立,9,0,9,亞東-新竹,2024-08-20,2184
2882,國泰金,7,0,7,亞東-新竹,2024-08-20,2184
00904,新光臺灣半導體30,7,0,7,亞東-新竹,2024-08-20,2184
2368,金像電,7,0,7,亞東-新竹,2024-08-20,2184
3450,聯鈞,11,4,7,亞東-新竹,2024-08-20,2184
5443,均豪,15,8,7,亞東-新竹,2024-08-20,2184
00751B,元大AAA至A公司債,6,0,6,亞東-新竹,2024-08-20,2184
2543,皇昌,6,0,6,亞東-新竹,2024-08-20,2184
00795B,中信美國公債20年,5,0,5,亞東-新竹,2024-08-20,2184
00933B,國泰10Y+金融債,5,0,5,亞東-新竹,2024-08-20,2184
00679B,元大美債20年,5,0,5,亞東-新竹,2024-08-20,2184
1808,潤隆,5,0,5,亞東-新竹,2024-08-20,2184
2061,風青,5,0,5,亞東-新竹,2024-08-20,2184
3691,碩禾,5,0,5,亞東-新竹,2024-08-20,2184
4908,前鼎,24,19,5,亞東-新竹,2024-08-20,2184
4987,科誠,5,0,5,亞東-新竹,2024-08-20,2184
0056,元大高股息,4,0,4,亞東-新竹,2024-08-20,2184
1321,大洋,4,0,4,亞東-新竹,2024-08-20,2184
1702,南僑,4,0,4,亞東-新竹,2024-08-20,2184
6188,廣明,4,0,4,亞東-新竹,2024-08-20,2184
6530,創威,8,4,4,亞東-新竹,2024-08-20,2184
8039,台虹,4,0,4,亞東-新竹,2024-08-20,2184
2888,新光金,572,159,413,亞東-新竹,2024-08-21,2184
2891,中信金,276,32,244,亞東-新竹,2024-08-21,2184
00665L,富邦�琤肭磪囓�2,113,0,113,亞東-新竹,2024-08-21,2184
00919,群益台灣精選高息,37,0,37,亞東-新竹,2024-08-21,2184
00929,復華台灣科技優息,36,2,34,亞東-新竹,2024-08-21,2184
00935,野村臺灣新科技50,31,0,31,亞東-新竹,2024-08-21,2184
6462,神盾,17,0,17,亞東-新竹,2024-08-21,2184
6609,瀧澤科,15,0,15,亞東-新竹,2024-08-21,2184
8421,旭源,23,8,15,亞東-新竹,2024-08-21,2184
9958,世紀鋼,15,0,15,亞東-新竹,2024-08-21,2184
3587,閎康,15,0,15,亞東-新竹,2024-08-21,2184
2317,鴻海,15,1,14,亞東-新竹,2024-08-21,2184
1785,光洋科,23,9,14,亞東-新竹,2024-08-21,2184
2069,運錩,13,0,13,亞東-新竹,2024-08-21,2184
00692,富邦公司治理,12,1,11,亞東-新竹,2024-08-21,2184
2409,友達,10,0,10,亞東-新竹,2024-08-21,2184
6257,矽格,10,0,10,亞東-新竹,2024-08-21,2184
3483,力致,11,1,10,亞東-新竹,2024-08-21,2184
8054,安國,11,1,10,亞東-新竹,2024-08-21,2184
2887,台新金,10,1,9,亞東-新竹,2024-08-21,2184
4551,智伸科,9,0,9,亞東-新竹,2024-08-21,2184
1611,中電,8,0,8,亞東-新竹,2024-08-21,2184
2344,華邦電,7,0,7,亞東-新竹,2024-08-21,2184
2542,興富發,8,1,7,亞東-新竹,2024-08-21,2184
3535,晶彩科,14,7,7,亞東-新竹,2024-08-21,2184
2330,台積電,7,0,7,亞東-新竹,2024-08-21,2184
00891,中信關鍵半導體,6,0,6,亞東-新竹,2024-08-21,2184
00933B,國泰10Y+金融債,6,0,6,亞東-新竹,2024-08-21,2184
00675L,富邦臺灣加權正2,6,0,6,亞東-新竹,2024-08-21,2184
00715L,期街口布蘭特正2,10,4,6,亞東-新竹,2024-08-21,2184
4563,百德,7,1,6,亞東-新竹,2024-08-21,2184
00878,國泰永續高股息,6,0,6,亞東-新竹,2024-08-21,2184
00915,凱基優選高股息30,5,0,5,亞東-新竹,2024-08-21,2184
00904,新光臺灣半導體30,5,0,5,亞東-新竹,2024-08-21,2184
00764B,群益25年美債,5,0,5,亞東-新竹,2024-08-21,2184
00650L,復華香港正2,5,0,5,亞東-新竹,2024-08-21,2184
3052,夆典,5,0,5,亞東-新竹,2024-08-21,2184
3312,弘憶股,7,2,5,亞東-新竹,2024-08-21,2184
6901,鑽石投資,5,0,5,亞東-新竹,2024-08-21,2184
9945,潤泰新,5,0,5,亞東-新竹,2024-08-21,2184
0056,元大高股息,6,1,5,亞東-新竹,2024-08-21,2184
2376,技嘉,7,3,4,亞東-新竹,2024-08-21,2184
2427,三商電,4,0,4,亞東-新竹,2024-08-21,2184
3006,晶豪科,5,1,4,亞東-新竹,2024-08-21,2184
3189,景碩,6,2,4,亞東-新竹,2024-08-21,2184
00940,元大台灣價值高息,3,0,3,亞東-新竹,2024-08-21,2184
2002,中鋼,3,0,3,亞東-新竹,2024-08-21,2184
2313,華通,3,0,3,亞東-新竹,2024-08-21,2184
2359,所羅門,11,8,3,亞東-新竹,2024-08-21,2184
2603,長榮,3,0,3,亞東-新竹,2024-08-21,2184
00948B,中信優息投資級債,480,0,480,亞東-新竹,2024-08-22,2184
00882,中信中國高股息,310,0,310,亞東-新竹,2024-08-22,2184
2891,中信金,253,0,253,亞東-新竹,2024-08-22,2184
00715L,期街口布蘭特正2,106,6,100,亞東-新竹,2024-08-22,2184
4716,大立,54,0,54,亞東-新竹,2024-08-22,2184
0056,元大高股息,43,0,43,亞東-新竹,2024-08-22,2184
00919,群益台灣精選高息,35,0,35,亞東-新竹,2024-08-22,2184
2105,正新,25,0,25,亞東-新竹,2024-08-22,2184
1409,新纖,20,0,20,亞東-新竹,2024-08-22,2184
1449,佳和,20,0,20,亞東-新竹,2024-08-22,2184
4908,前鼎,30,10,20,亞東-新竹,2024-08-22,2184
3019,亞光,20,4,16,亞東-新竹,2024-08-22,2184
00632R,元大台灣50反1,20,5,15,亞東-新竹,2024-08-22,2184
2002,中鋼,40,26,14,亞東-新竹,2024-08-22,2184
2890,永豐金,16,2,14,亞東-新竹,2024-08-22,2184
00687B,國泰20年美債,12,0,12,亞東-新竹,2024-08-22,2184
2537,聯上發,12,1,11,亞東-新竹,2024-08-22,2184
00795B,中信美國公債20年,10,0,10,亞東-新竹,2024-08-22,2184
00642U,期元大S＆P石油,10,0,10,亞東-新竹,2024-08-22,2184
2476,鉅祥,10,0,10,亞東-新竹,2024-08-22,2184
9946,三發地產,10,0,10,亞東-新竹,2024-08-22,2184
3522,御嵿,8,0,8,亞東-新竹,2024-08-22,2184
5371,中光電,13,5,8,亞東-新竹,2024-08-22,2184
8028,昇陽半導體,17,9,8,亞東-新竹,2024-08-22,2184
2427,三商電,7,0,7,亞東-新竹,2024-08-22,2184
4909,新復興,9,2,7,亞東-新竹,2024-08-22,2184
6451,訊芯-KY,7,0,7,亞東-新竹,2024-08-22,2184
1514,亞力,8,2,6,亞東-新竹,2024-08-22,2184
00680L,元大美債20正2,5,0,5,亞東-新竹,2024-08-22,2184
2061,風青,5,0,5,亞東-新竹,2024-08-22,2184
2607,榮運,5,0,5,亞東-新竹,2024-08-22,2184
2610,華航,5,0,5,亞東-新竹,2024-08-22,2184
3188,鑫龍騰,5,0,5,亞東-新竹,2024-08-22,2184
5498,凱崴,5,0,5,亞東-新竹,2024-08-22,2184
6288,聯嘉,5,0,5,亞東-新竹,2024-08-22,2184
00878,國泰永續高股息,4,0,4,亞東-新竹,2024-08-22,2184
3587,閎康,5,1,4,亞東-新竹,2024-08-22,2184
00751B,元大AAA至A公司債,4,0,4,亞東-新竹,2024-08-22,2184
1529,樂事綠能,4,0,4,亞東-新竹,2024-08-22,2184
3413,京鼎,4,0,4,亞東-新竹,2024-08-22,2184
6188,廣明,4,0,4,亞東-新竹,2024-08-22,2184
3037,欣興,7,3,4,亞東-新竹,2024-08-22,2184
00940,元大台灣價值高息,3,0,3,亞東-新竹,2024-08-22,2184
2330,台積電,3,0,3,亞東-新竹,2024-08-22,2184
00936,台新永續高息中小,3,0,3,亞東-新竹,2024-08-22,2184
00830,國泰費城半導體,3,0,3,亞東-新竹,2024-08-22,2184
1513,中興電,5,2,3,亞東-新竹,2024-08-22,2184
1584,精剛,3,0,3,亞東-新竹,2024-08-22,2184
2382,廣達,4,1,3,亞東-新竹,2024-08-22,2184
3163,波若威,14,11,3,亞東-新竹,2024-08-22,2184
00687B,國泰20年美債,109,0,109,亞東-新竹,2024-08-23,2184
2891,中信金,96,4,92,亞東-新竹,2024-08-23,2184
00929,復華台灣科技優息,71,5,66,亞東-新竹,2024-08-23,2184
6151,晉倫,59,1,58,亞東-新竹,2024-08-23,2184
00751B,元大AAA至A公司債,55,0,55,亞東-新竹,2024-08-23,2184
00632R,元大台灣50反1,43,0,43,亞東-新竹,2024-08-23,2184
2442,新美齊,34,0,34,亞東-新竹,2024-08-23,2184
00680L,元大美債20正2,27,0,27,亞東-新竹,2024-08-23,2184
3006,晶豪科,26,0,26,亞東-新竹,2024-08-23,2184
1708,東鹼,55,30,25,亞東-新竹,2024-08-23,2184
2317,鴻海,30,6,24,亞東-新竹,2024-08-23,2184
00675L,富邦臺灣加權正2,22,0,22,亞東-新竹,2024-08-23,2184
2344,華邦電,20,0,20,亞東-新竹,2024-08-23,2184
00919,群益台灣精選高息,16,0,16,亞東-新竹,2024-08-23,2184
8064,東捷,20,4,16,亞東-新竹,2024-08-23,2184
00795B,中信美國公債20年,15,0,15,亞東-新竹,2024-08-23,2184
9938,百和,15,0,15,亞東-新竹,2024-08-23,2184
3587,閎康,17,3,14,亞東-新竹,2024-08-23,2184
00679B,元大美債20年,12,0,12,亞東-新竹,2024-08-23,2184
1711,永光,16,5,11,亞東-新竹,2024-08-23,2184
4909,新復興,12,1,11,亞東-新竹,2024-08-23,2184
2886,兆豐金,10,0,10,亞東-新竹,2024-08-23,2184
6133,金橋,10,0,10,亞東-新竹,2024-08-23,2184
6138,茂達,10,0,10,亞東-新竹,2024-08-23,2184
00881,國泰台灣5G+,9,0,9,亞東-新竹,2024-08-23,2184
3580,友威科,11,2,9,亞東-新竹,2024-08-23,2184
00936,台新永續高息中小,8,0,8,亞東-新竹,2024-08-23,2184
1301,台塑,7,0,7,亞東-新竹,2024-08-23,2184
2002,中鋼,7,0,7,亞東-新竹,2024-08-23,2184
3013,晟銘電,7,0,7,亞東-新竹,2024-08-23,2184
9946,三發地產,7,0,7,亞東-新竹,2024-08-23,2184
00940,元大台灣價值高息,6,0,6,亞東-新竹,2024-08-23,2184
3189,景碩,14,8,6,亞東-新竹,2024-08-23,2184
5443,均豪,61,55,6,亞東-新竹,2024-08-23,2184
6257,矽格,5,0,5,亞東-新竹,2024-08-23,2184
00857B,永豐20年美公債,5,0,5,亞東-新竹,2024-08-23,2184
01004T,土銀富邦R2,5,0,5,亞東-新竹,2024-08-23,2184
1441,大東,5,0,5,亞東-新竹,2024-08-23,2184
2303,聯電,11,6,5,亞東-新竹,2024-08-23,2184
2409,友達,5,0,5,亞東-新竹,2024-08-23,2184
2607,榮運,5,0,5,亞東-新竹,2024-08-23,2184
2880,華南金,5,0,5,亞東-新竹,2024-08-23,2184
5309,系統電,5,0,5,亞東-新竹,2024-08-23,2184
6209,今國光,5,0,5,亞東-新竹,2024-08-23,2184
2615,萬海,6,2,4,亞東-新竹,2024-08-23,2184
5234,達興材料,4,0,4,亞東-新竹,2024-08-23,2184
8021,尖點,5,1,4,亞東-新竹,2024-08-23,2184
00712,復華富時不動產,3,0,3,亞東-新竹,2024-08-23,2184
0056,元大高股息,3,0,3,亞東-新竹,2024-08-23,2184
00720B,元大投資級公司債,3,0,3,亞東-新竹,2024-08-23,2184
2883,凱基金,181,4,177,亞東-新竹,2024-08-26,2184
00687B,國泰20年美債,137,0,137,亞東-新竹,2024-08-26,2184
00751B,元大AAA至A公司債,52,0,52,亞東-新竹,2024-08-26,2184
00919,群益台灣精選高息,46,5,41,亞東-新竹,2024-08-26,2184
2349,錸德,40,1,39,亞東-新竹,2024-08-26,2184
2504,國產,34,4,30,亞東-新竹,2024-08-26,2184
6143,振曜,30,1,29,亞東-新竹,2024-08-26,2184
00929,復華台灣科技優息,44,20,24,亞東-新竹,2024-08-26,2184
00675L,富邦臺灣加權正2,21,0,21,亞東-新竹,2024-08-26,2184
6290,良維,20,0,20,亞東-新竹,2024-08-26,2184
2891,中信金,24,5,19,亞東-新竹,2024-08-26,2184
5871,中租-KY,20,2,18,亞東-新竹,2024-08-26,2184
4707,磐亞,17,0,17,亞東-新竹,2024-08-26,2184
2887,台新金,23,8,15,亞東-新竹,2024-08-26,2184
00795B,中信美國公債20年,14,0,14,亞東-新竹,2024-08-26,2184
00881,國泰台灣5G+,14,0,14,亞東-新竹,2024-08-26,2184
3481,群創,26,12,14,亞東-新竹,2024-08-26,2184
1720,生達,12,0,12,亞東-新竹,2024-08-26,2184
4109,加捷生醫,12,0,12,亞東-新竹,2024-08-26,2184
4967,十銓,14,3,11,亞東-新竹,2024-08-26,2184
8096,擎亞,18,7,11,亞東-新竹,2024-08-26,2184
00650L,復華香港正2,10,0,10,亞東-新竹,2024-08-26,2184
00673R,期元大S＆P原油反1,10,0,10,亞東-新竹,2024-08-26,2184
00680L,元大美債20正2,10,0,10,亞東-新竹,2024-08-26,2184
2368,金像電,10,0,10,亞東-新竹,2024-08-26,2184
3047,訊舟,10,0,10,亞東-新竹,2024-08-26,2184
3339,泰谷,10,0,10,亞東-新竹,2024-08-26,2184
5481,新華,10,0,10,亞東-新竹,2024-08-26,2184
6770,力積電,12,2,10,亞東-新竹,2024-08-26,2184
8028,昇陽半導體,25,15,10,亞東-新竹,2024-08-26,2184
4564,元翎,9,0,9,亞東-新竹,2024-08-26,2184
3583,辛耘,8,0,8,亞東-新竹,2024-08-26,2184
5225,東科-KY,8,0,8,亞東-新竹,2024-08-26,2184
2365,昆盈,15,8,7,亞東-新竹,2024-08-26,2184
5236,凌陽創新,7,0,7,亞東-新竹,2024-08-26,2184
00685L,群益臺灣加權正2,6,0,6,亞東-新竹,2024-08-26,2184
00679B,元大美債20年,6,0,6,亞東-新竹,2024-08-26,2184
2329,華泰,6,0,6,亞東-新竹,2024-08-26,2184
5263,智崴,6,0,6,亞東-新竹,2024-08-26,2184
6188,廣明,6,0,6,亞東-新竹,2024-08-26,2184
3019,亞光,14,9,5,亞東-新竹,2024-08-26,2184
1324,地球,5,0,5,亞東-新竹,2024-08-26,2184
00692,富邦公司治理,5,0,5,亞東-新竹,2024-08-26,2184
1441,大東,5,0,5,亞東-新竹,2024-08-26,2184
1527,鑽全,5,0,5,亞東-新竹,2024-08-26,2184
1785,光洋科,32,27,5,亞東-新竹,2024-08-26,2184
2412,中華電,5,0,5,亞東-新竹,2024-08-26,2184
4207,環泰,5,0,5,亞東-新竹,2024-08-26,2184
4908,前鼎,5,0,5,亞東-新竹,2024-08-26,2184
6177,達麗,5,0,5,亞東-新竹,2024-08-26,2184
2888,新光金,108,29,79,亞東-新竹,2024-08-27,2184
00688L,國泰20年美債正2,67,0,67,亞東-新竹,2024-08-27,2184
2891,中信金,41,2,39,亞東-新竹,2024-08-27,2184
00687B,國泰20年美債,37,0,37,亞東-新竹,2024-08-27,2184
2031,新光鋼,30,0,30,亞東-新竹,2024-08-27,2184
2317,鴻海,35,10,25,亞東-新竹,2024-08-27,2184
00929,復華台灣科技優息,23,0,23,亞東-新竹,2024-08-27,2184
00679B,元大美債20年,20,0,20,亞東-新竹,2024-08-27,2184
00933B,國泰10Y+金融債,20,0,20,亞東-新竹,2024-08-27,2184
1708,東鹼,20,0,20,亞東-新竹,2024-08-27,2184
2303,聯電,20,0,20,亞東-新竹,2024-08-27,2184
2349,錸德,20,0,20,亞東-新竹,2024-08-27,2184
3390,旭軟,20,2,18,亞東-新竹,2024-08-27,2184
8071,能率網通,18,0,18,亞東-新竹,2024-08-27,2184
2201,裕隆,19,2,17,亞東-新竹,2024-08-27,2184
6877,鏵友益,18,1,17,亞東-新竹,2024-08-27,2184
00795B,中信美國公債20年,16,0,16,亞東-新竹,2024-08-27,2184
00878,國泰永續高股息,15,0,15,亞東-新竹,2024-08-27,2184
2344,華邦電,15,0,15,亞東-新竹,2024-08-27,2184
00680L,元大美債20正2,14,0,14,亞東-新竹,2024-08-27,2184
1416,廣豐,25,11,14,亞東-新竹,2024-08-27,2184
1611,中電,12,0,12,亞東-新竹,2024-08-27,2184
4930,燦星網,12,0,12,亞東-新竹,2024-08-27,2184
00919,群益台灣精選高息,11,0,11,亞東-新竹,2024-08-27,2184
3580,友威科,12,1,11,亞東-新竹,2024-08-27,2184
4967,十銓,13,2,11,亞東-新竹,2024-08-27,2184
3587,閎康,11,0,11,亞東-新竹,2024-08-27,2184
00935,野村臺灣新科技50,10,0,10,亞東-新竹,2024-08-27,2184
00877,復華中國5G,10,0,10,亞東-新竹,2024-08-27,2184
00673R,期元大S＆P原油反1,10,0,10,亞東-新竹,2024-08-27,2184
00632R,元大台灣50反1,10,0,10,亞東-新竹,2024-08-27,2184
2467,志聖,11,2,9,亞東-新竹,2024-08-27,2184
2603,長榮,10,2,8,亞東-新竹,2024-08-27,2184
2330,台積電,9,1,8,亞東-新竹,2024-08-27,2184
2610,華航,27,20,7,亞東-新竹,2024-08-27,2184
2845,遠東銀,6,0,6,亞東-新竹,2024-08-27,2184
2882,國泰金,6,0,6,亞東-新竹,2024-08-27,2184
8033,雷虎,7,1,6,亞東-新竹,2024-08-27,2184
8937,合騏,6,0,6,亞東-新竹,2024-08-27,2184
9906,欣巴巴,6,0,6,亞東-新竹,2024-08-27,2184
0056,元大高股息,5,0,5,亞東-新竹,2024-08-27,2184
00706L,期元大S＆P日圓正2,5,0,5,亞東-新竹,2024-08-27,2184
1597,直得,7,2,5,亞東-新竹,2024-08-27,2184
2607,榮運,5,0,5,亞東-新竹,2024-08-27,2184
3163,波若威,5,0,5,亞東-新竹,2024-08-27,2184
3557,嘉威,5,0,5,亞東-新竹,2024-08-27,2184
4303,信立,8,3,5,亞東-新竹,2024-08-27,2184
1101,台泥,5,0,5,亞東-新竹,2024-08-27,2184
00751B,元大AAA至A公司債,4,0,4,亞東-新竹,2024-08-27,2184
1711,永光,25,21,4,亞東-新竹,2024-08-27,2184
00688L,國泰20年美債正2,135,0,135,亞東-新竹,2024-08-28,2184
2402,毅嘉,105,0,105,亞東-新竹,2024-08-28,2184
00680L,元大美債20正2,103,0,103,亞東-新竹,2024-08-28,2184
2476,鉅祥,80,0,80,亞東-新竹,2024-08-28,2184
00687B,國泰20年美債,70,0,70,亞東-新竹,2024-08-28,2184
00679B,元大美債20年,50,0,50,亞東-新竹,2024-08-28,2184
2891,中信金,34,4,30,亞東-新竹,2024-08-28,2184
2633,台灣高鐵,20,0,20,亞東-新竹,2024-08-28,2184
00929,復華台灣科技優息,17,0,17,亞東-新竹,2024-08-28,2184
00921,兆豐龍頭等權重,15,0,15,亞東-新竹,2024-08-28,2184
6163,華電網,15,0,15,亞東-新竹,2024-08-28,2184
9914,美利達,15,0,15,亞東-新竹,2024-08-28,2184
00891,中信關鍵半導體,14,0,14,亞東-新竹,2024-08-28,2184
0050,元大台灣50,12,0,12,亞東-新竹,2024-08-28,2184
00959B,大華投等美債15Y+,11,0,11,亞東-新竹,2024-08-28,2184
1708,東鹼,11,0,11,亞東-新竹,2024-08-28,2184
1776,展宇,11,0,11,亞東-新竹,2024-08-28,2184
00633L,富邦上証正2,10,0,10,亞東-新竹,2024-08-28,2184
00642U,期元大S＆P石油,10,0,10,亞東-新竹,2024-08-28,2184
00932,兆豐永續高息等權,10,0,10,亞東-新竹,2024-08-28,2184
1449,佳和,10,0,10,亞東-新竹,2024-08-28,2184
1584,精剛,10,0,10,亞東-新竹,2024-08-28,2184
3149,正達,10,0,10,亞東-新竹,2024-08-28,2184
6164,華興,10,0,10,亞東-新竹,2024-08-28,2184
6290,良維,10,0,10,亞東-新竹,2024-08-28,2184
2330,台積電,12,3,9,亞東-新竹,2024-08-28,2184
2367,燿華,11,3,8,亞東-新竹,2024-08-28,2184
1441,大東,7,0,7,亞東-新竹,2024-08-28,2184
6609,瀧澤科,12,5,7,亞東-新竹,2024-08-28,2184
8937,合騏,8,1,7,亞東-新竹,2024-08-28,2184
2867,三商壽,7,0,7,亞東-新竹,2024-08-28,2184
3587,閎康,6,0,6,亞東-新竹,2024-08-28,2184
00878,國泰永續高股息,11,5,6,亞東-新竹,2024-08-28,2184
3260,威剛,6,0,6,亞東-新竹,2024-08-28,2184
6188,廣明,8,2,6,亞東-新竹,2024-08-28,2184
1324,地球,5,0,5,亞東-新竹,2024-08-28,2184
00795B,中信美國公債20年,5,0,5,亞東-新竹,2024-08-28,2184
2002,中鋼,5,0,5,亞東-新竹,2024-08-28,2184
2365,昆盈,11,6,5,亞東-新竹,2024-08-28,2184
2609,陽明,5,0,5,亞東-新竹,2024-08-28,2184
2886,兆豐金,5,0,5,亞東-新竹,2024-08-28,2184
3163,波若威,8,3,5,亞東-新竹,2024-08-28,2184
3231,緯創,7,2,5,亞東-新竹,2024-08-28,2184
00830,國泰費城半導體,4,0,4,亞東-新竹,2024-08-28,2184
2312,金寶,4,0,4,亞東-新竹,2024-08-28,2184
2449,京元電子,4,0,4,亞東-新竹,2024-08-28,2184
2845,遠東銀,4,0,4,亞東-新竹,2024-08-28,2184
4562,穎漢,8,4,4,亞東-新竹,2024-08-28,2184
5236,凌陽創新,4,0,4,亞東-新竹,2024-08-28,2184
8039,台虹,7,3,4,亞東-新竹,2024-08-28,2184
00687B,國泰20年美債,207,0,207,亞東-新竹,2024-08-29,2184
2883,凱基金,200,100,100,亞東-新竹,2024-08-29,2184
2888,新光金,110,11,99,亞東-新竹,2024-08-29,2184
2891,中信金,95,0,95,亞東-新竹,2024-08-29,2184
4128,中天,70,2,68,亞東-新竹,2024-08-29,2184
4904,遠傳,50,0,50,亞東-新竹,2024-08-29,2184
4167,松瑞藥,40,0,40,亞東-新竹,2024-08-29,2184
00919,群益台灣精選高息,31,0,31,亞東-新竹,2024-08-29,2184
00680L,元大美債20正2,30,0,30,亞東-新竹,2024-08-29,2184
2845,遠東銀,26,0,26,亞東-新竹,2024-08-29,2184
4157,太景*-KY,25,0,25,亞東-新竹,2024-08-29,2184
00929,復華台灣科技優息,23,0,23,亞東-新竹,2024-08-29,2184
00948B,中信優息投資級債,20,0,20,亞東-新竹,2024-08-29,2184
00715L,期街口布蘭特正2,20,0,20,亞東-新竹,2024-08-29,2184
00688L,國泰20年美債正2,20,0,20,亞東-新竹,2024-08-29,2184
2303,聯電,32,13,19,亞東-新竹,2024-08-29,2184
4510,高鋒,29,10,19,亞東-新竹,2024-08-29,2184
2897,王道銀行,20,5,15,亞東-新竹,2024-08-29,2184
3015,全漢,15,0,15,亞東-新竹,2024-08-29,2184
2388,威盛,16,3,13,亞東-新竹,2024-08-29,2184
2317,鴻海,18,6,12,亞東-新竹,2024-08-29,2184
3019,亞光,23,11,12,亞東-新竹,2024-08-29,2184
00830,國泰費城半導體,11,0,11,亞東-新竹,2024-08-29,2184
2201,裕隆,13,2,11,亞東-新竹,2024-08-29,2184
3024,憶聲,11,0,11,亞東-新竹,2024-08-29,2184
1312,國喬,10,0,10,亞東-新竹,2024-08-29,2184
2812,台中銀,10,0,10,亞東-新竹,2024-08-29,2184
00959B,大華投等美債15Y+,10,0,10,亞東-新竹,2024-08-29,2184
00935,野村臺灣新科技50,10,0,10,亞東-新竹,2024-08-29,2184
00795B,中信美國公債20年,10,0,10,亞東-新竹,2024-08-29,2184
2492,華新科,10,0,10,亞東-新竹,2024-08-29,2184
4707,磐亞,10,0,10,亞東-新竹,2024-08-29,2184
8937,合騏,12,2,10,亞東-新竹,2024-08-29,2184
00690,兆豐藍籌30,9,0,9,亞東-新竹,2024-08-29,2184
3147,大綜,10,1,9,亞東-新竹,2024-08-29,2184
2301,光寶科,8,0,8,亞東-新竹,2024-08-29,2184
4908,前鼎,10,2,8,亞東-新竹,2024-08-29,2184
6405,悅城,8,0,8,亞東-新竹,2024-08-29,2184
00679B,元大美債20年,7,0,7,亞東-新竹,2024-08-29,2184
2330,台積電,13,5,8,亞東-新竹,2024-08-29,2184
00936,台新永續高息中小,7,0,7,亞東-新竹,2024-08-29,2184
00757,統一FANG+,6,0,6,亞東-新竹,2024-08-29,2184
00633L,富邦上証正2,7,1,6,亞東-新竹,2024-08-29,2184
6290,良維,6,0,6,亞東-新竹,2024-08-29,2184
6598,ABC-KY,6,0,6,亞東-新竹,2024-08-29,2184
1785,光洋科,5,0,5,亞東-新竹,2024-08-29,2184
00665L,富邦�琤肭磪囓�2,15,10,5,亞東-新竹,2024-08-29,2184
00692,富邦公司治理,5,0,5,亞東-新竹,2024-08-29,2184
1314,中石化,10,5,5,亞東-新竹,2024-08-29,2184
1529,樂事綠能,5,0,5,亞東-新竹,2024-08-29,2184
9945,潤泰新,50,3,47,亞東-新竹,2024-08-30,2184
00937B,群益ESG投等債20,36,0,36,亞東-新竹,2024-08-30,2184
00687B,國泰20年美債,46,11,35,亞東-新竹,2024-08-30,2184
00940,元大台灣價值高息,40,5,35,亞東-新竹,2024-08-30,2184
2303,聯電,54,22,32,亞東-新竹,2024-08-30,2184
6177,達麗,30,0,30,亞東-新竹,2024-08-30,2184
2845,遠東銀,28,1,27,亞東-新竹,2024-08-30,2184
00632R,元大台灣50反1,30,10,20,亞東-新竹,2024-08-30,2184
2880,華南金,16,2,14,亞東-新竹,2024-08-30,2184
00679B,元大美債20年,14,1,13,亞東-新竹,2024-08-30,2184
2867,三商壽,13,0,13,亞東-新竹,2024-08-30,2184
2888,新光金,13,0,13,亞東-新竹,2024-08-30,2184
00680L,元大美債20正2,12,0,12,亞東-新竹,2024-08-30,2184
2317,鴻海,12,0,12,亞東-新竹,2024-08-30,2184
3015,全漢,16,5,11,亞東-新竹,2024-08-30,2184
00675L,富邦臺灣加權正2,10,0,10,亞東-新竹,2024-08-30,2184
00933B,國泰10Y+金融債,10,0,10,亞東-新竹,2024-08-30,2184
2382,廣達,13,3,10,亞東-新竹,2024-08-30,2184
4109,加捷生醫,12,2,10,亞東-新竹,2024-08-30,2184
5443,均豪,27,17,10,亞東-新竹,2024-08-30,2184
1515,力山,9,0,9,亞東-新竹,2024-08-30,2184
3021,鴻名,9,0,9,亞東-新竹,2024-08-30,2184
2002,中鋼,10,2,8,亞東-新竹,2024-08-30,2184
6698,旭暉應材,8,0,8,亞東-新竹,2024-08-30,2184
00959B,大華投等美債15Y+,7,0,7,亞東-新竹,2024-08-30,2184
00929,復華台灣科技優息,7,0,7,亞東-新竹,2024-08-30,2184
8182,加高,7,0,7,亞東-新竹,2024-08-30,2184
00688L,國泰20年美債正2,6,0,6,亞東-新竹,2024-08-30,2184
00919,群益台灣精選高息,6,0,6,亞東-新竹,2024-08-30,2184
2464,盟立,6,0,6,亞東-新竹,2024-08-30,2184
4938,和碩,6,0,6,亞東-新竹,2024-08-30,2184
00878,國泰永續高股息,5,0,5,亞東-新竹,2024-08-30,2184
00650L,復華香港正2,5,0,5,亞東-新竹,2024-08-30,2184
00857B,永豐20年美公債,5,0,5,亞東-新竹,2024-08-30,2184
6104,創惟,5,0,5,亞東-新竹,2024-08-30,2184
6218,豪勉,5,0,5,亞東-新竹,2024-08-30,2184
6405,悅城,8,3,5,亞東-新竹,2024-08-30,2184
8070,長華*,5,0,5,亞東-新竹,2024-08-30,2184
3019,亞光,16,12,4,亞東-新竹,2024-08-30,2184
00931B,統一美債20年,4,0,4,亞東-新竹,2024-08-30,2184
1536,和大,8,4,4,亞東-新竹,2024-08-30,2184
2329,華泰,4,0,4,亞東-新竹,2024-08-30,2184
2356,英業達,4,0,4,亞東-新竹,2024-08-30,2184
2357,華碩,4,0,4,亞東-新竹,2024-08-30,2184
2365,昆盈,10,6,4,亞東-新竹,2024-08-30,2184
2442,新美齊,4,0,4,亞東-新竹,2024-08-30,2184
2542,興富發,6,2,4,亞東-新竹,2024-08-30,2184
4916,事欣科,4,0,4,亞東-新竹,2024-08-30,2184
5469,瀚宇博,4,0,4,亞東-新竹,2024-08-30,2184
6143,振曜,6,2,4,亞東-新竹,2024-08-30,2184
00688L,國泰20年美債正2,459,0,459,亞東-新竹,2024-09-02,2184
3673,TPK-KY,228,1,227,亞東-新竹,2024-09-02,2184
00751B,元大AAA至A公司債,91,0,91,亞東-新竹,2024-09-02,2184
00937B,群益ESG投等債20,72,0,72,亞東-新竹,2024-09-02,2184
3481,群創,70,1,69,亞東-新竹,2024-09-02,2184
2891,中信金,81,24,57,亞東-新竹,2024-09-02,2184
00680L,元大美債20正2,57,0,57,亞東-新竹,2024-09-02,2184
00720B,元大投資級公司債,53,0,53,亞東-新竹,2024-09-02,2184
00715L,期街口布蘭特正2,31,0,31,亞東-新竹,2024-09-02,2184
00665L,富邦�琤肭磪囓�2,50,20,30,亞東-新竹,2024-09-02,2184
6757,台灣虎航,30,0,30,亞東-新竹,2024-09-02,2184
2887,台新金,33,4,29,亞東-新竹,2024-09-02,2184
1402,遠東新,29,0,29,亞東-新竹,2024-09-02,2184
2476,鉅祥,30,2,28,亞東-新竹,2024-09-02,2184
2897,王道銀行,25,0,25,亞東-新竹,2024-09-02,2184
2317,鴻海,22,1,21,亞東-新竹,2024-09-02,2184
2368,金像電,21,0,21,亞東-新竹,2024-09-02,2184
2845,遠東銀,20,0,20,亞東-新竹,2024-09-02,2184
2537,聯上發,23,4,19,亞東-新竹,2024-09-02,2184
1314,中石化,26,9,17,亞東-新竹,2024-09-02,2184
2615,萬海,15,0,15,亞東-新竹,2024-09-02,2184
6530,創威,30,15,15,亞東-新竹,2024-09-02,2184
00795B,中信美國公債20年,14,0,14,亞東-新竹,2024-09-02,2184
2354,鴻準,15,1,14,亞東-新竹,2024-09-02,2184
00919,群益台灣精選高息,13,0,13,亞東-新竹,2024-09-02,2184
1785,光洋科,36,24,12,亞東-新竹,2024-09-02,2184
2609,陽明,12,0,12,亞東-新竹,2024-09-02,2184
00637L,元大滬深300正2,12,0,12,亞東-新竹,2024-09-02,2184
1416,廣豐,11,0,11,亞東-新竹,2024-09-02,2184
2486,一詮,11,0,11,亞東-新竹,2024-09-02,2184
00959B,大華投等美債15Y+,10,0,10,亞東-新竹,2024-09-02,2184
1808,潤隆,14,4,10,亞東-新竹,2024-09-02,2184
2607,榮運,10,0,10,亞東-新竹,2024-09-02,2184
4707,磐亞,10,0,10,亞東-新竹,2024-09-02,2184
6015,宏遠證,10,0,10,亞東-新竹,2024-09-02,2184
1527,鑽全,10,1,9,亞東-新竹,2024-09-02,2184
3583,辛耘,9,0,9,亞東-新竹,2024-09-02,2184
2002,中鋼,10,2,8,亞東-新竹,2024-09-02,2184
00931B,統一美債20年,8,0,8,亞東-新竹,2024-09-02,2184
2515,中工,8,0,8,亞東-新竹,2024-09-02,2184
3062,建漢,18,10,8,亞東-新竹,2024-09-02,2184
3163,波若威,12,4,8,亞東-新竹,2024-09-02,2184
4909,新復興,7,0,7,亞東-新竹,2024-09-02,2184
3708,上緯投控,6,0,6,亞東-新竹,2024-09-02,2184
00882,中信中國高股息,5,0,5,亞東-新竹,2024-09-02,2184
3484,崧騰,5,0,5,亞東-新竹,2024-09-02,2184
4510,高鋒,15,10,5,亞東-新竹,2024-09-02,2184
4555,氣立,5,0,5,亞東-新竹,2024-09-02,2184
9945,潤泰新,5,0,5,亞東-新竹,2024-09-02,2184
1219,福壽,4,0,4,亞東-新竹,2024-09-02,2184
00948B,中信優息投資級債,170,0,170,亞東-新竹,2024-09-03,2184
3673,TPK-KY,100,0,100,亞東-新竹,2024-09-03,2184
00929,復華台灣科技優息,88,1,87,亞東-新竹,2024-09-03,2184
00680L,元大美債20正2,51,0,51,亞東-新竹,2024-09-03,2184
00687B,國泰20年美債,50,0,50,亞東-新竹,2024-09-03,2184
4714,永捷,52,5,47,亞東-新竹,2024-09-03,2184
00915,凱基優選高股息30,44,0,44,亞東-新竹,2024-09-03,2184
1101,台泥,36,0,36,亞東-新竹,2024-09-03,2184
00713,元大台灣高息低波,26,0,26,亞東-新竹,2024-09-03,2184
00919,群益台灣精選高息,43,20,23,亞東-新竹,2024-09-03,2184
00637L,元大滬深300正2,20,0,20,亞東-新竹,2024-09-03,2184
6213,聯茂,19,2,17,亞東-新竹,2024-09-03,2184
00632R,元大台灣50反1,17,0,17,亞東-新竹,2024-09-03,2184
2344,華邦電,16,0,16,亞東-新竹,2024-09-03,2184
4908,前鼎,15,0,15,亞東-新竹,2024-09-03,2184
00679B,元大美債20年,14,0,14,亞東-新竹,2024-09-03,2184
2891,中信金,13,0,13,亞東-新竹,2024-09-03,2184
1785,光洋科,12,0,12,亞東-新竹,2024-09-03,2184
00933B,國泰10Y+金融債,11,0,11,亞東-新竹,2024-09-03,2184
00918,大華優利高填息30,10,0,10,亞東-新竹,2024-09-03,2184
1312,國喬,10,0,10,亞東-新竹,2024-09-03,2184
1314,中石化,15,5,10,亞東-新竹,2024-09-03,2184
2328,廣宇,10,0,10,亞東-新竹,2024-09-03,2184
2633,台灣高鐵,10,0,10,亞東-新竹,2024-09-03,2184
2897,王道銀行,10,0,10,亞東-新竹,2024-09-03,2184
6015,宏遠證,10,0,10,亞東-新竹,2024-09-03,2184
9945,潤泰新,10,0,10,亞東-新竹,2024-09-03,2184
00795B,中信美國公債20年,9,0,9,亞東-新竹,2024-09-03,2184
2002,中鋼,9,0,9,亞東-新竹,2024-09-03,2184
00878,國泰永續高股息,8,0,8,亞東-新竹,2024-09-03,2184
1309,台達化,8,0,8,亞東-新竹,2024-09-03,2184
2301,光寶科,8,0,8,亞東-新竹,2024-09-03,2184
2882,國泰金,8,0,8,亞東-新竹,2024-09-03,2184
2887,台新金,7,0,7,亞東-新竹,2024-09-03,2184
1449,佳和,7,0,7,亞東-新竹,2024-09-03,2184
00927,群益半導體收益,6,0,6,亞東-新竹,2024-09-03,2184
2515,中工,6,0,6,亞東-新竹,2024-09-03,2184
2867,三商壽,6,0,6,亞東-新竹,2024-09-03,2184
3580,友威科,6,0,6,亞東-新竹,2024-09-03,2184
3715,定穎投控,6,0,6,亞東-新竹,2024-09-03,2184
1609,大亞,5,0,5,亞東-新竹,2024-09-03,2184
1611,中電,5,0,5,亞東-新竹,2024-09-03,2184
2420,新巨,5,0,5,亞東-新竹,2024-09-03,2184
2427,三商電,5,0,5,亞東-新竹,2024-09-03,2184
2609,陽明,5,0,5,亞東-新竹,2024-09-03,2184
4303,信立,6,1,5,亞東-新竹,2024-09-03,2184
5351,鈺創,5,0,5,亞東-新竹,2024-09-03,2184
8043,蜜望實,6,1,5,亞東-新竹,2024-09-03,2184
2888,新光金,9,5,4,亞東-新竹,2024-09-03,2184
2363,矽統,5,1,4,亞東-新竹,2024-09-03,2184
00937B,群益ESG投等債20,381,50,331,亞東-新竹,2024-09-04,2184
00919,群益台灣精選高息,118,0,118,亞東-新竹,2024-09-04,2184
00878,國泰永續高股息,62,0,62,亞東-新竹,2024-09-04,2184
2891,中信金,62,3,59,亞東-新竹,2024-09-04,2184
3481,群創,57,0,57,亞東-新竹,2024-09-04,2184
6015,宏遠證,45,0,45,亞東-新竹,2024-09-04,2184
1314,中石化,54,12,42,亞東-新竹,2024-09-04,2184
00642U,期元大S＆P石油,40,0,40,亞東-新竹,2024-09-04,2184
2610,華航,35,0,35,亞東-新竹,2024-09-04,2184
00929,復華台灣科技優息,54,20,34,亞東-新竹,2024-09-04,2184
00715L,期街口布蘭特正2,74,40,34,亞東-新竹,2024-09-04,2184
0056,元大高股息,32,0,32,亞東-新竹,2024-09-04,2184
00915,凱基優選高股息30,30,0,30,亞東-新竹,2024-09-04,2184
00940,元大台灣價值高息,30,0,30,亞東-新竹,2024-09-04,2184
2897,王道銀行,40,10,30,亞東-新竹,2024-09-04,2184
6757,台灣虎航,60,30,30,亞東-新竹,2024-09-04,2184
2330,台積電,32,5,27,亞東-新竹,2024-09-04,2184
1301,台塑,28,1,27,亞東-新竹,2024-09-04,2184
2886,兆豐金,25,0,25,亞東-新竹,2024-09-04,2184
0050,元大台灣50,28,5,23,亞東-新竹,2024-09-04,2184
00679B,元大美債20年,22,0,22,亞東-新竹,2024-09-04,2184
00713,元大台灣高息低波,21,0,21,亞東-新竹,2024-09-04,2184
1723,中碳,20,0,20,亞東-新竹,2024-09-04,2184
2881,富邦金,17,0,17,亞東-新竹,2024-09-04,2184
2344,華邦電,16,1,15,亞東-新竹,2024-09-04,2184
00632R,元大台灣50反1,32,18,14,亞東-新竹,2024-09-04,2184
2867,三商壽,14,0,14,亞東-新竹,2024-09-04,2184
00918,大華優利高填息30,13,0,13,亞東-新竹,2024-09-04,2184
2812,台中銀,13,0,13,亞東-新竹,2024-09-04,2184
2845,遠東銀,13,0,13,亞東-新竹,2024-09-04,2184
2317,鴻海,21,8,13,亞東-新竹,2024-09-04,2184
2382,廣達,17,5,12,亞東-新竹,2024-09-04,2184
00927,群益半導體收益,12,0,12,亞東-新竹,2024-09-04,2184
2303,聯電,22,10,12,亞東-新竹,2024-09-04,2184
4714,永捷,15,3,12,亞東-新竹,2024-09-04,2184
2834,臺企銀,12,0,12,亞東-新竹,2024-09-04,2184
6116,彩晶,11,0,11,亞東-新竹,2024-09-04,2184
00946,群益科技高息成長,11,0,11,亞東-新竹,2024-09-04,2184
006208,富邦台50,11,0,11,亞東-新竹,2024-09-04,2184
1312,國喬,10,0,10,亞東-新竹,2024-09-04,2184
00680L,元大美債20正2,10,0,10,亞東-新竹,2024-09-04,2184
1795,美時,12,2,10,亞東-新竹,2024-09-04,2184
4908,前鼎,20,10,10,亞東-新竹,2024-09-04,2184
2801,彰銀,9,0,9,亞東-新竹,2024-09-04,2184
2883,凱基金,109,100,9,亞東-新竹,2024-09-04,2184
00637L,元大滬深300正2,8,0,8,亞東-新竹,2024-09-04,2184
2338,光罩,10,2,8,亞東-新竹,2024-09-04,2184
3037,欣興,8,0,8,亞東-新竹,2024-09-04,2184
4576,大銀微系統,10,2,8,亞東-新竹,2024-09-04,2184
2301,光寶科,7,0,7,亞東-新竹,2024-09-04,2184
00715L,期街口布蘭特正2,327,130,197,亞東-新竹,2024-09-05,2184
00940,元大台灣價值高息,101,4,97,亞東-新竹,2024-09-05,2184
00948B,中信優息投資級債,80,0,80,亞東-新竹,2024-09-05,2184
00919,群益台灣精選高息,53,0,53,亞東-新竹,2024-09-05,2184
00929,復華台灣科技優息,39,0,39,亞東-新竹,2024-09-05,2184
2367,燿華,42,4,38,亞東-新竹,2024-09-05,2184
2344,華邦電,49,12,37,亞東-新竹,2024-09-05,2184
2317,鴻海,36,2,34,亞東-新竹,2024-09-05,2184
2368,金像電,22,0,22,亞東-新竹,2024-09-05,2184
1303,南亞,22,0,22,亞東-新竹,2024-09-05,2184
00935,野村臺灣新科技50,21,0,21,亞東-新竹,2024-09-05,2184
4916,事欣科,21,0,21,亞東-新竹,2024-09-05,2184
00878,國泰永續高股息,26,6,20,亞東-新竹,2024-09-05,2184
4561,健椿,20,0,20,亞東-新竹,2024-09-05,2184
00632R,元大台灣50反1,17,0,17,亞東-新竹,2024-09-05,2184
2537,聯上發,15,0,15,亞東-新竹,2024-09-05,2184
00952,凱基台灣AI50,14,0,14,亞東-新竹,2024-09-05,2184
6770,力積電,21,9,12,亞東-新竹,2024-09-05,2184
00946,群益科技高息成長,12,1,11,亞東-新竹,2024-09-05,2184
2337,旺宏,11,0,11,亞東-新竹,2024-09-05,2184
2888,新光金,21,10,11,亞東-新竹,2024-09-05,2184
2812,台中銀,10,0,10,亞東-新竹,2024-09-05,2184
0056,元大高股息,10,0,10,亞東-新竹,2024-09-05,2184
2409,友達,10,0,10,亞東-新竹,2024-09-05,2184
3652,精聯,10,0,10,亞東-新竹,2024-09-05,2184
4908,前鼎,10,0,10,亞東-新竹,2024-09-05,2184
6016,康和證,10,0,10,亞東-新竹,2024-09-05,2184
0050,元大台灣50,14,5,9,亞東-新竹,2024-09-05,2184
3479,安勤,9,0,9,亞東-新竹,2024-09-05,2184
3035,智原,6,0,6,亞東-新竹,2024-09-05,2184
00918,大華優利高填息30,6,0,6,亞東-新竹,2024-09-05,2184
1314,中石化,6,0,6,亞東-新竹,2024-09-05,2184
1702,南僑,6,0,6,亞東-新竹,2024-09-05,2184
2356,英業達,10,4,6,亞東-新竹,2024-09-05,2184
2897,王道銀行,11,5,6,亞東-新竹,2024-09-05,2184
4153,鈺緯,6,0,6,亞東-新竹,2024-09-05,2184
2362,藍天,5,0,5,亞東-新竹,2024-09-05,2184
1584,精剛,5,0,5,亞東-新竹,2024-09-05,2184
3019,亞光,20,15,5,亞東-新竹,2024-09-05,2184
3557,嘉威,5,0,5,亞東-新竹,2024-09-05,2184
6290,良維,5,0,5,亞東-新竹,2024-09-05,2184
00944,野村趨勢動能高息,4,0,4,亞東-新竹,2024-09-05,2184
4109,加捷生醫,4,0,4,亞東-新竹,2024-09-05,2184
8027,鈦昇,6,2,4,亞東-新竹,2024-09-05,2184
8081,致新,4,0,4,亞東-新竹,2024-09-05,2184
00757,統一FANG+,3,0,3,亞東-新竹,2024-09-05,2184
2379,瑞昱,3,0,3,亞東-新竹,2024-09-05,2184
00712,復華富時不動產,3,0,3,亞東-新竹,2024-09-05,2184
6531,愛普*,3,0,3,亞東-新竹,2024-09-05,2184
00633L,富邦上証正2,6,3,3,亞東-新竹,2024-09-05,2184
00715L,期街口布蘭特正2,330,240,90,亞東-新竹,2024-09-06,2184
00948B,中信優息投資級債,70,0,70,亞東-新竹,2024-09-06,2184
00919,群益台灣精選高息,70,0,70,亞東-新竹,2024-09-06,2184
00680L,元大美債20正2,67,10,57,亞東-新竹,2024-09-06,2184
00688L,國泰20年美債正2,46,0,46,亞東-新竹,2024-09-06,2184
00929,復華台灣科技優息,47,4,43,亞東-新竹,2024-09-06,2184
00632R,元大台灣50反1,40,9,31,亞東-新竹,2024-09-06,2184
6168,宏齊,30,0,30,亞東-新竹,2024-09-06,2184
6757,台灣虎航,69,40,29,亞東-新竹,2024-09-06,2184
6770,力積電,30,3,27,亞東-新竹,2024-09-06,2184
2204,中華,20,0,20,亞東-新竹,2024-09-06,2184
6216,居易,21,1,20,亞東-新竹,2024-09-06,2184
2401,凌陽,16,0,16,亞東-新竹,2024-09-06,2184
00878,國泰永續高股息,15,0,15,亞東-新竹,2024-09-06,2184
2633,台灣高鐵,20,6,14,亞東-新竹,2024-09-06,2184
2888,新光金,15,3,12,亞東-新竹,2024-09-06,2184
3481,群創,12,0,12,亞東-新竹,2024-09-06,2184
00753L,中信中國50正2,10,0,10,亞東-新竹,2024-09-06,2184
1785,光洋科,18,8,10,亞東-新竹,2024-09-06,2184
2344,華邦電,10,0,10,亞東-新竹,2024-09-06,2184
2610,華航,10,0,10,亞東-新竹,2024-09-06,2184
2891,中信金,11,1,10,亞東-新竹,2024-09-06,2184
4538,大詠城,23,13,10,亞東-新竹,2024-09-06,2184
2337,旺宏,10,1,9,亞東-新竹,2024-09-06,2184
1324,地球,9,0,9,亞東-新竹,2024-09-06,2184
2328,廣宇,9,0,9,亞東-新竹,2024-09-06,2184
2489,瑞軒,9,0,9,亞東-新竹,2024-09-06,2184
6187,萬潤,11,2,9,亞東-新竹,2024-09-06,2184
2002,中鋼,8,0,8,亞東-新竹,2024-09-06,2184
5469,瀚宇博,7,0,7,亞東-新竹,2024-09-06,2184
00918,大華優利高填息30,6,0,6,亞東-新竹,2024-09-06,2184
1314,中石化,16,10,6,亞東-新竹,2024-09-06,2184
3324,雙鴻,5,0,5,亞東-新竹,2024-09-06,2184
00637L,元大滬深300正2,5,0,5,亞東-新竹,2024-09-06,2184
2316,楠梓電,5,0,5,亞東-新竹,2024-09-06,2184
4562,穎漢,13,8,5,亞東-新竹,2024-09-06,2184
4989,榮科,5,0,5,亞東-新竹,2024-09-06,2184
5258,虹堡,5,0,5,亞東-新竹,2024-09-06,2184
9941,裕融,4,0,4,亞東-新竹,2024-09-06,2184
2388,威盛,5,1,4,亞東-新竹,2024-09-06,2184
4714,永捷,4,0,4,亞東-新竹,2024-09-06,2184
6151,晉倫,11,7,4,亞東-新竹,2024-09-06,2184
0056,元大高股息,13,10,3,亞東-新竹,2024-09-06,2184
00936,台新永續高息中小,3,0,3,亞東-新竹,2024-09-06,2184
00679B,元大美債20年,3,0,3,亞東-新竹,2024-09-06,2184
1608,華榮,3,0,3,亞東-新竹,2024-09-06,2184
1711,永光,4,1,3,亞東-新竹,2024-09-06,2184
3062,建漢,3,0,3,亞東-新竹,2024-09-06,2184
4303,信立,10,7,3,亞東-新竹,2024-09-06,2184
4551,智伸科,3,0,3,亞東-新竹,2024-09-06,2184
00687B,國泰20年美債,136,2,134,亞東-新竹,2024-09-09,2184
6770,力積電,57,2,55,亞東-新竹,2024-09-09,2184
00937B,群益ESG投等債20,50,0,50,亞東-新竹,2024-09-09,2184
2401,凌陽,39,0,39,亞東-新竹,2024-09-09,2184
00919,群益台灣精選高息,29,0,29,亞東-新竹,2024-09-09,2184
2881,富邦金,30,2,28,亞東-新竹,2024-09-09,2184
0056,元大高股息,27,0,27,亞東-新竹,2024-09-09,2184
00929,復華台灣科技優息,37,10,27,亞東-新竹,2024-09-09,2184
00881,國泰台灣5G+,26,0,26,亞東-新竹,2024-09-09,2184
00680L,元大美債20正2,19,0,19,亞東-新竹,2024-09-09,2184
00751B,元大AAA至A公司債,18,0,18,亞東-新竹,2024-09-09,2184
2609,陽明,20,2,18,亞東-新竹,2024-09-09,2184
00679B,元大美債20年,17,0,17,亞東-新竹,2024-09-09,2184
00915,凱基優選高股息30,12,0,12,亞東-新竹,2024-09-09,2184
00918,大華優利高填息30,12,0,12,亞東-新竹,2024-09-09,2184
2882,國泰金,15,5,10,亞東-新竹,2024-09-09,2184
00665L,富邦�琤肭磪囓�2,60,50,10,亞東-新竹,2024-09-09,2184
1312,國喬,10,0,10,亞東-新竹,2024-09-09,2184
2897,王道銀行,15,5,10,亞東-新竹,2024-09-09,2184
4909,新復興,11,1,10,亞東-新竹,2024-09-09,2184
2317,鴻海,17,7,10,亞東-新竹,2024-09-09,2184
00830,國泰費城半導體,9,0,9,亞東-新竹,2024-09-09,2184
4958,臻鼎-KY,9,0,9,亞東-新竹,2024-09-09,2184
6274,台燿,12,3,9,亞東-新竹,2024-09-09,2184
2880,華南金,8,0,8,亞東-新竹,2024-09-09,2184
4571,鈞興-KY,9,1,8,亞東-新竹,2024-09-09,2184
8040,九暘,8,0,8,亞東-新竹,2024-09-09,2184
00947,台新臺灣IC設計,8,0,8,亞東-新竹,2024-09-09,2184
00632R,元大台灣50反1,44,37,7,亞東-新竹,2024-09-09,2184
00933B,國泰10Y+金融債,6,0,6,亞東-新竹,2024-09-09,2184
3260,威剛,6,0,6,亞東-新竹,2024-09-09,2184
4128,中天,6,0,6,亞東-新竹,2024-09-09,2184
4562,穎漢,26,20,6,亞東-新竹,2024-09-09,2184
2330,台積電,8,2,6,亞東-新竹,2024-09-09,2184
00935,野村臺灣新科技50,5,0,5,亞東-新竹,2024-09-09,2184
00941,中信上游半導體,5,0,5,亞東-新竹,2024-09-09,2184
00753L,中信中國50正2,5,0,5,亞東-新竹,2024-09-09,2184
00631L,元大台灣50正2,23,18,5,亞東-新竹,2024-09-09,2184
2409,友達,5,0,5,亞東-新竹,2024-09-09,2184
2606,裕民,5,0,5,亞東-新竹,2024-09-09,2184
4555,氣立,5,0,5,亞東-新竹,2024-09-09,2184
6651,全宇昕,5,0,5,亞東-新竹,2024-09-09,2184
0050,元大台灣50,7,2,5,亞東-新竹,2024-09-09,2184
00720B,元大投資級公司債,4,0,4,亞東-新竹,2024-09-09,2184
2883,凱基金,4,0,4,亞東-新竹,2024-09-09,2184
3663,鑫科,4,0,4,亞東-新竹,2024-09-09,2184
4420,光明,4,0,4,亞東-新竹,2024-09-09,2184
6763,綠界科技*,8,4,4,亞東-新竹,2024-09-09,2184
8064,東捷,4,0,4,亞東-新竹,2024-09-09,2184
00637L,元大滬深300正2,3,0,3,亞東-新竹,2024-09-09,2184
00929,復華台灣科技優息,137,0,137,亞東-新竹,2024-09-10,2184
2888,新光金,100,0,100,亞東-新竹,2024-09-10,2184
00715L,期街口布蘭特正2,93,0,93,亞東-新竹,2024-09-10,2184
0050,元大台灣50,70,0,70,亞東-新竹,2024-09-10,2184
00919,群益台灣精選高息,62,0,62,亞東-新竹,2024-09-10,2184
00706L,期元大S＆P日圓正2,60,2,58,亞東-新竹,2024-09-10,2184
00688L,國泰20年美債正2,63,6,57,亞東-新竹,2024-09-10,2184
1717,長興,57,0,57,亞東-新竹,2024-09-10,2184
2476,鉅祥,40,0,40,亞東-新竹,2024-09-10,2184
00680L,元大美債20正2,30,0,30,亞東-新竹,2024-09-10,2184
00937B,群益ESG投等債20,50,20,30,亞東-新竹,2024-09-10,2184
00918,大華優利高填息30,21,0,21,亞東-新竹,2024-09-10,2184
1326,台化,20,2,18,亞東-新竹,2024-09-10,2184
1301,台塑,21,5,16,亞東-新竹,2024-09-10,2184
6651,全宇昕,16,0,16,亞東-新竹,2024-09-10,2184
1416,廣豐,15,0,15,亞東-新竹,2024-09-10,2184
3551,世禾,15,0,15,亞東-新竹,2024-09-10,2184
0056,元大高股息,15,0,15,亞東-新竹,2024-09-10,2184
2891,中信金,15,1,14,亞東-新竹,2024-09-10,2184
00878,國泰永續高股息,14,0,14,亞東-新竹,2024-09-10,2184
2317,鴻海,16,2,14,亞東-新竹,2024-09-10,2184
1609,大亞,14,0,14,亞東-新竹,2024-09-10,2184
00952,凱基台灣AI50,13,0,13,亞東-新竹,2024-09-10,2184
1711,永光,13,0,13,亞東-新竹,2024-09-10,2184
2881,富邦金,15,2,13,亞東-新竹,2024-09-10,2184
6770,力積電,12,0,12,亞東-新竹,2024-09-10,2184
3062,建漢,31,19,12,亞東-新竹,2024-09-10,2184
00679B,元大美債20年,11,0,11,亞東-新竹,2024-09-10,2184
2382,廣達,10,0,10,亞東-新竹,2024-09-10,2184
2301,光寶科,10,0,10,亞東-新竹,2024-09-10,2184
00795B,中信美國公債20年,10,0,10,亞東-新竹,2024-09-10,2184
2303,聯電,10,0,10,亞東-新竹,2024-09-10,2184
2468,華經,10,0,10,亞東-新竹,2024-09-10,2184
3149,正達,10,0,10,亞東-新竹,2024-09-10,2184
4128,中天,11,1,10,亞東-新竹,2024-09-10,2184
2460,建通,8,0,8,亞東-新竹,2024-09-10,2184
3645,達邁,11,3,8,亞東-新竹,2024-09-10,2184
5871,中租-KY,8,0,8,亞東-新竹,2024-09-10,2184
6405,悅城,7,0,7,亞東-新竹,2024-09-10,2184
6763,綠界科技*,11,4,7,亞東-新竹,2024-09-10,2184
00637L,元大滬深300正2,9,3,6,亞東-新竹,2024-09-10,2184
4510,高鋒,63,57,6,亞東-新竹,2024-09-10,2184
4930,燦星網,6,0,6,亞東-新竹,2024-09-10,2184
6125,廣運,6,0,6,亞東-新竹,2024-09-10,2184
8011,台通,6,0,6,亞東-新竹,2024-09-10,2184
2002,中鋼,5,0,5,亞東-新竹,2024-09-10,2184
2337,旺宏,5,0,5,亞東-新竹,2024-09-10,2184
2338,光罩,5,0,5,亞東-新竹,2024-09-10,2184
2367,燿華,10,5,5,亞東-新竹,2024-09-10,2184
2606,裕民,5,0,5,亞東-新竹,2024-09-10,2184
00632R,元大台灣50反1,474,10,464,亞東-新竹,2024-09-11,2184
00715L,期街口布蘭特正2,281,120,161,亞東-新竹,2024-09-11,2184
00679B,元大美債20年,139,2,137,亞東-新竹,2024-09-11,2184
2317,鴻海,92,1,91,亞東-新竹,2024-09-11,2184
00937B,群益ESG投等債20,51,0,51,亞東-新竹,2024-09-11,2184
00687B,國泰20年美債,59,9,50,亞東-新竹,2024-09-11,2184
2891,中信金,42,0,42,亞東-新竹,2024-09-11,2184
2449,京元電子,40,1,39,亞東-新竹,2024-09-11,2184
00919,群益台灣精選高息,26,0,26,亞東-新竹,2024-09-11,2184
6757,台灣虎航,21,0,21,亞東-新竹,2024-09-11,2184
2867,三商壽,20,0,20,亞東-新竹,2024-09-11,2184
2881,富邦金,17,0,17,亞東-新竹,2024-09-11,2184
00918,大華優利高填息30,16,0,16,亞東-新竹,2024-09-11,2184
00665L,富邦�琤肭磪囓�2,50,35,15,亞東-新竹,2024-09-11,2184
6187,萬潤,15,0,15,亞東-新竹,2024-09-11,2184
2360,致茂,15,1,14,亞東-新竹,2024-09-11,2184
00929,復華台灣科技優息,13,0,13,亞東-新竹,2024-09-11,2184
2002,中鋼,22,10,12,亞東-新竹,2024-09-11,2184
00934,中信成長高股息,10,0,10,亞東-新竹,2024-09-11,2184
3312,弘憶股,10,0,10,亞東-新竹,2024-09-11,2184
2887,台新金,10,1,9,亞東-新竹,2024-09-11,2184
3551,世禾,8,0,8,亞東-新竹,2024-09-11,2184
6806,森崴能源,8,0,8,亞東-新竹,2024-09-11,2184
00878,國泰永續高股息,8,0,8,亞東-新竹,2024-09-11,2184
1324,地球,24,17,7,亞東-新竹,2024-09-11,2184
2388,威盛,7,0,7,亞東-新竹,2024-09-11,2184
4908,前鼎,7,0,7,亞東-新竹,2024-09-11,2184
5871,中租-KY,7,0,7,亞東-新竹,2024-09-11,2184
00882,中信中國高股息,6,0,6,亞東-新竹,2024-09-11,2184
1522,堤維西,6,0,6,亞東-新竹,2024-09-11,2184
1709,和益,6,0,6,亞東-新竹,2024-09-11,2184
2070,精湛,10,4,6,亞東-新竹,2024-09-11,2184
2884,玉山金,6,0,6,亞東-新竹,2024-09-11,2184
3037,欣興,9,3,6,亞東-新竹,2024-09-11,2184
5876,上海商銀,6,0,6,亞東-新竹,2024-09-11,2184
2409,友達,5,0,5,亞東-新竹,2024-09-11,2184
2421,建準,5,0,5,亞東-新竹,2024-09-11,2184
2903,遠百,5,0,5,亞東-新竹,2024-09-11,2184
3289,宜特,6,1,5,亞東-新竹,2024-09-11,2184
4974,亞泰,15,10,5,亞東-新竹,2024-09-11,2184
6191,精成科,5,0,5,亞東-新竹,2024-09-11,2184
6763,綠界科技*,5,0,5,亞東-新竹,2024-09-11,2184
8936,國統,5,0,5,亞東-新竹,2024-09-11,2184
9945,潤泰新,5,0,5,亞東-新竹,2024-09-11,2184
1618,合機,4,0,4,亞東-新竹,2024-09-11,2184
1702,南僑,4,0,4,亞東-新竹,2024-09-11,2184
3231,緯創,6,2,4,亞東-新竹,2024-09-11,2184
3523,迎輝,4,0,4,亞東-新竹,2024-09-11,2184
00633L,富邦上証正2,19,16,3,亞東-新竹,2024-09-11,2184
00941,中信上游半導體,3,0,3,亞東-新竹,2024-09-11,2184
00878,國泰永續高股息,70,5,65,亞東-新竹,2024-09-12,2184
1312,國喬,50,0,50,亞東-新竹,2024-09-12,2184
00680L,元大美債20正2,29,0,29,亞東-新竹,2024-09-12,2184
8070,長華*,30,5,25,亞東-新竹,2024-09-12,2184
00655L,國泰中國A50正2,20,0,20,亞東-新竹,2024-09-12,2184
00795B,中信美國公債20年,20,0,20,亞東-新竹,2024-09-12,2184
2412,中華電,20,0,20,亞東-新竹,2024-09-12,2184
6216,居易,20,0,20,亞東-新竹,2024-09-12,2184
2313,華通,20,0,20,亞東-新竹,2024-09-12,2184
6770,力積電,20,2,18,亞東-新竹,2024-09-12,2184
8039,台虹,16,0,16,亞東-新竹,2024-09-12,2184
2002,中鋼,15,0,15,亞東-新竹,2024-09-12,2184
3062,建漢,15,0,15,亞東-新竹,2024-09-12,2184
6274,台燿,25,10,15,亞東-新竹,2024-09-12,2184
9945,潤泰新,13,0,13,亞東-新竹,2024-09-12,2184
2887,台新金,10,0,10,亞東-新竹,2024-09-12,2184
00937B,群益ESG投等債20,10,0,10,亞東-新竹,2024-09-12,2184
2476,鉅祥,10,0,10,亞東-新竹,2024-09-12,2184
2492,華新科,10,0,10,亞東-新竹,2024-09-12,2184
3149,正達,13,3,10,亞東-新竹,2024-09-12,2184
5469,瀚宇博,10,0,10,亞東-新竹,2024-09-12,2184
00688L,國泰20年美債正2,10,1,9,亞東-新竹,2024-09-12,2184
1324,地球,7,0,7,亞東-新竹,2024-09-12,2184
00687B,國泰20年美債,24,17,7,亞東-新竹,2024-09-12,2184
9925,新保,7,0,7,亞東-新竹,2024-09-12,2184
0056,元大高股息,10,4,6,亞東-新竹,2024-09-12,2184
3664,安瑞-KY,6,0,6,亞東-新竹,2024-09-12,2184
4545,銘鈺,6,0,6,亞東-新竹,2024-09-12,2184
8028,昇陽半導體,6,1,5,亞東-新竹,2024-09-12,2184
00713,元大台灣高息低波,5,0,5,亞東-新竹,2024-09-12,2184
2353,宏��,6,1,5,亞東-新竹,2024-09-12,2184
1314,中石化,5,0,5,亞東-新竹,2024-09-12,2184
1570,力肯,5,0,5,亞東-新竹,2024-09-12,2184
1584,精剛,5,0,5,亞東-新竹,2024-09-12,2184
3227,原相,18,13,5,亞東-新竹,2024-09-12,2184
3691,碩禾,5,0,5,亞東-新竹,2024-09-12,2184
4576,大銀微系統,5,0,5,亞東-新竹,2024-09-12,2184
2891,中信金,58,54,4,亞東-新竹,2024-09-12,2184
8114,振樺電,5,1,4,亞東-新竹,2024-09-12,2184
2201,裕隆,3,0,3,亞東-新竹,2024-09-12,2184
2360,致茂,3,0,3,亞東-新竹,2024-09-12,2184
3362,先進光,3,0,3,亞東-新竹,2024-09-12,2184
3450,聯鈞,3,0,3,亞東-新竹,2024-09-12,2184
4933,友輝,3,0,3,亞東-新竹,2024-09-12,2184
2618,長榮航,2,0,2,亞東-新竹,2024-09-12,2184
3707,漢磊,5,3,2,亞東-新竹,2024-09-12,2184
00940,元大台灣價值高息,2,0,2,亞東-新竹,2024-09-12,2184
1604,聲寶,2,0,2,亞東-新竹,2024-09-12,2184
2101,南港,2,0,2,亞東-新竹,2024-09-12,2184
2383,台光電,4,2,2,亞東-新竹,2024-09-12,2184
00680L,元大美債20正2,166,10,156,亞東-新竹,2024-09-13,2184
2888,新光金,120,38,82,亞東-新竹,2024-09-13,2184
00687B,國泰20年美債,69,11,58,亞東-新竹,2024-09-13,2184
00720B,元大投資級公司債,50,0,50,亞東-新竹,2024-09-13,2184
00675L,富邦臺灣加權正2,35,0,35,亞東-新竹,2024-09-13,2184
1711,永光,30,0,30,亞東-新竹,2024-09-13,2184
6168,宏齊,21,0,21,亞東-新竹,2024-09-13,2184
1444,力麗,20,0,20,亞東-新竹,2024-09-13,2184
6270,倍微,20,0,20,亞東-新竹,2024-09-13,2184
2388,威盛,24,5,19,亞東-新竹,2024-09-13,2184
2002,中鋼,16,0,16,亞東-新竹,2024-09-13,2184
4510,高鋒,52,37,15,亞東-新竹,2024-09-13,2184
00679B,元大美債20年,23,9,14,亞東-新竹,2024-09-13,2184
2383,台光電,13,0,13,亞東-新竹,2024-09-13,2184
2337,旺宏,12,0,12,亞東-新竹,2024-09-13,2184
6274,台燿,13,2,11,亞東-新竹,2024-09-13,2184
00655L,國泰中國A50正2,10,0,10,亞東-新竹,2024-09-13,2184
00795B,中信美國公債20年,10,0,10,亞東-新竹,2024-09-13,2184
00934,中信成長高股息,10,0,10,亞東-新竹,2024-09-13,2184
6651,全宇昕,10,0,10,亞東-新竹,2024-09-13,2184
2303,聯電,10,2,8,亞東-新竹,2024-09-13,2184
3047,訊舟,9,1,8,亞東-新竹,2024-09-13,2184
4551,智伸科,8,0,8,亞東-新竹,2024-09-13,2184
00929,復華台灣科技優息,8,1,7,亞東-新竹,2024-09-13,2184
3664,安瑞-KY,7,0,7,亞東-新竹,2024-09-13,2184
6191,精成科,7,0,7,亞東-新竹,2024-09-13,2184
1795,美時,6,0,6,亞東-新竹,2024-09-13,2184
2241,艾姆勒,6,0,6,亞東-新竹,2024-09-13,2184
2317,鴻海,7,1,6,亞東-新竹,2024-09-13,2184
2324,仁寶,6,0,6,亞東-新竹,2024-09-13,2184
2883,凱基金,6,0,6,亞東-新竹,2024-09-13,2184
3019,亞光,12,6,6,亞東-新竹,2024-09-13,2184
4561,健椿,6,0,6,亞東-新竹,2024-09-13,2184
8936,國統,5,0,5,亞東-新竹,2024-09-13,2184
00713,元大台灣高息低波,5,0,5,亞東-新竹,2024-09-13,2184
00633L,富邦上証正2,14,9,5,亞東-新竹,2024-09-13,2184
2882,國泰金,5,0,5,亞東-新竹,2024-09-13,2184
3048,益登,5,0,5,亞東-新竹,2024-09-13,2184
3167,大量,6,1,5,亞東-新竹,2024-09-13,2184
3363,上詮,5,0,5,亞東-新竹,2024-09-13,2184
6451,訊芯-KY,15,10,5,亞東-新竹,2024-09-13,2184
1539,巨庭,4,0,4,亞東-新竹,2024-09-13,2184
2427,三商電,4,0,4,亞東-新竹,2024-09-13,2184
4526,東台,4,0,4,亞東-新竹,2024-09-13,2184
4958,臻鼎-KY,4,0,4,亞東-新竹,2024-09-13,2184
6208,日揚,4,0,4,亞東-新竹,2024-09-13,2184
1522,堤維西,4,0,4,亞東-新竹,2024-09-13,2184
1324,地球,3,0,3,亞東-新竹,2024-09-13,2184
00722B,群益投資級電信債,3,0,3,亞東-新竹,2024-09-13,2184
00933B,國泰10Y+金融債,3,0,3,亞東-新竹,2024-09-13,2184
00751B,元大AAA至A公司債,126,0,126,亞東-新竹,2024-09-16,2184
2888,新光金,120,1,119,亞東-新竹,2024-09-16,2184
00713,元大台灣高息低波,103,0,103,亞東-新竹,2024-09-16,2184
00687B,國泰20年美債,145,55,90,亞東-新竹,2024-09-16,2184
00945B,凱基美國非投等債,68,0,68,亞東-新竹,2024-09-16,2184
1711,永光,51,8,43,亞東-新竹,2024-09-16,2184
00688L,國泰20年美債正2,42,0,42,亞東-新竹,2024-09-16,2184
00795B,中信美國公債20年,40,0,40,亞東-新竹,2024-09-16,2184
2609,陽明,30,0,30,亞東-新竹,2024-09-16,2184
00933B,國泰10Y+金融債,13,0,13,亞東-新竹,2024-09-16,2184
2382,廣達,13,1,12,亞東-新竹,2024-09-16,2184
8039,台虹,12,0,12,亞東-新竹,2024-09-16,2184
1539,巨庭,19,8,11,亞東-新竹,2024-09-16,2184
2891,中信金,24,13,11,亞東-新竹,2024-09-16,2184
2340,台亞,10,0,10,亞東-新竹,2024-09-16,2184
2349,錸德,11,1,10,亞東-新竹,2024-09-16,2184
2537,聯上發,10,0,10,亞東-新竹,2024-09-16,2184
2610,華航,10,0,10,亞東-新竹,2024-09-16,2184
3062,建漢,10,0,10,亞東-新竹,2024-09-16,2184
3360,尚立,10,0,10,亞東-新竹,2024-09-16,2184
4306,炎洲,10,0,10,亞東-新竹,2024-09-16,2184
2313,華通,10,0,10,亞東-新竹,2024-09-16,2184
6191,精成科,8,0,8,亞東-新竹,2024-09-16,2184
2379,瑞昱,7,0,7,亞東-新竹,2024-09-16,2184
2399,映泰,7,0,7,亞東-新竹,2024-09-16,2184
00915,凱基優選高股息30,6,0,6,亞東-新竹,2024-09-16,2184
3450,聯鈞,9,3,6,亞東-新竹,2024-09-16,2184
6142,友勁,6,0,6,亞東-新竹,2024-09-16,2184
00882,中信中國高股息,5,0,5,亞東-新竹,2024-09-16,2184
2388,威盛,5,0,5,亞東-新竹,2024-09-16,2184
1324,地球,5,0,5,亞東-新竹,2024-09-16,2184
00929,復華台灣科技優息,5,0,5,亞東-新竹,2024-09-16,2184
00632R,元大台灣50反1,5,0,5,亞東-新竹,2024-09-16,2184
00679B,元大美債20年,5,0,5,亞東-新竹,2024-09-16,2184
00665L,富邦�琤肭磪囓�2,35,30,5,亞東-新竹,2024-09-16,2184
00773B,中信優先金融債,5,0,5,亞東-新竹,2024-09-16,2184
2882,國泰金,5,0,5,亞東-新竹,2024-09-16,2184
3048,益登,5,0,5,亞東-新竹,2024-09-16,2184
3577,泓格,5,0,5,亞東-新竹,2024-09-16,2184
4526,東台,5,0,5,亞東-新竹,2024-09-16,2184
4908,前鼎,5,0,5,亞東-新竹,2024-09-16,2184
6152,百一,5,0,5,亞東-新竹,2024-09-16,2184
8076,伍豐,5,0,5,亞東-新竹,2024-09-16,2184
9105,泰金寶-DR,5,0,5,亞東-新竹,2024-09-16,2184
00715L,期街口布蘭特正2,105,100,5,亞東-新竹,2024-09-16,2184
1528,恩德,4,0,4,亞東-新竹,2024-09-16,2184
2371,大同,4,0,4,亞東-新竹,2024-09-16,2184
2393,億光,4,0,4,亞東-新竹,2024-09-16,2184
2615,萬海,17,13,4,亞東-新竹,2024-09-16,2184
4109,加捷生醫,8,4,4,亞東-新竹,2024-09-16,2184
2883,凱基金,365,8,357,亞東-新竹,2024-09-18,2184
2888,新光金,437,120,317,亞東-新竹,2024-09-18,2184
00680L,元大美債20正2,58,0,58,亞東-新竹,2024-09-18,2184
00945B,凱基美國非投等債,67,10,57,亞東-新竹,2024-09-18,2184
1301,台塑,103,50,53,亞東-新竹,2024-09-18,2184
00687B,國泰20年美債,45,0,45,亞東-新竹,2024-09-18,2184
2412,中華電,31,0,31,亞東-新竹,2024-09-18,2184
00929,復華台灣科技優息,28,0,28,亞東-新竹,2024-09-18,2184
2867,三商壽,32,7,25,亞東-新竹,2024-09-18,2184
00713,元大台灣高息低波,23,0,23,亞東-新竹,2024-09-18,2184
5014,建錩,21,0,21,亞東-新竹,2024-09-18,2184
2367,燿華,20,0,20,亞東-新竹,2024-09-18,2184
3033,威健,15,0,15,亞東-新竹,2024-09-18,2184
2303,聯電,22,8,14,亞東-新竹,2024-09-18,2184
3034,聯詠,13,0,13,亞東-新竹,2024-09-18,2184
3062,建漢,11,0,11,亞東-新竹,2024-09-18,2184
00940,元大台灣價值高息,10,0,10,亞東-新竹,2024-09-18,2184
00900,富邦特選高股息30,10,0,10,亞東-新竹,2024-09-18,2184
2344,華邦電,10,0,10,亞東-新竹,2024-09-18,2184
2349,錸德,10,0,10,亞東-新竹,2024-09-18,2184
4545,銘鈺,10,0,10,亞東-新竹,2024-09-18,2184
6005,群益證,10,0,10,亞東-新竹,2024-09-18,2184
2382,廣達,17,8,9,亞東-新竹,2024-09-18,2184
0056,元大高股息,9,0,9,亞東-新竹,2024-09-18,2184
3550,聯穎,24,15,9,亞東-新竹,2024-09-18,2184
4306,炎洲,9,0,9,亞東-新竹,2024-09-18,2184
8111,立��,16,7,9,亞東-新竹,2024-09-18,2184
1449,佳和,7,0,7,亞東-新竹,2024-09-18,2184
2477,美隆電,9,2,7,亞東-新竹,2024-09-18,2184
3664,安瑞-KY,6,0,6,亞東-新竹,2024-09-18,2184
8110,華東,6,0,6,亞東-新竹,2024-09-18,2184
00878,國泰永續高股息,5,0,5,亞東-新竹,2024-09-18,2184
2887,台新金,5,0,5,亞東-新竹,2024-09-18,2184
00930,永豐ESG低碳高息,5,0,5,亞東-新竹,2024-09-18,2184
2359,所羅門,7,2,5,亞東-新竹,2024-09-18,2184
2427,三商電,5,0,5,亞東-新竹,2024-09-18,2184
3483,力致,5,0,5,亞東-新竹,2024-09-18,2184
4510,高鋒,49,44,5,亞東-新竹,2024-09-18,2184
9105,泰金寶-DR,5,0,5,亞東-新竹,2024-09-18,2184
2330,台積電,6,1,5,亞東-新竹,2024-09-18,2184
2317,鴻海,21,16,5,亞東-新竹,2024-09-18,2184
1536,和大,8,4,4,亞東-新竹,2024-09-18,2184
3623,富晶通,4,0,4,亞東-新竹,2024-09-18,2184
6274,台燿,5,1,4,亞東-新竹,2024-09-18,2184
8249,菱光,4,0,4,亞東-新竹,2024-09-18,2184
2454,聯發科,4,1,3,亞東-新竹,2024-09-18,2184
2308,台達電,5,2,3,亞東-新竹,2024-09-18,2184
2351,順德,4,1,3,亞東-新竹,2024-09-18,2184
4551,智伸科,3,0,3,亞東-新竹,2024-09-18,2184
4958,臻鼎-KY,3,0,3,亞東-新竹,2024-09-18,2184
2891,中信金,191,0,191,亞東-新竹,2024-09-19,2184
00937B,群益ESG投等債20,130,0,130,亞東-新竹,2024-09-19,2184
00687B,國泰20年美債,141,15,126,亞東-新竹,2024-09-19,2184
00680L,元大美債20正2,61,0,61,亞東-新竹,2024-09-19,2184
00679B,元大美債20年,62,1,61,亞東-新竹,2024-09-19,2184
2633,台灣高鐵,32,0,32,亞東-新竹,2024-09-19,2184
4306,炎洲,30,0,30,亞東-新竹,2024-09-19,2184
00675L,富邦臺灣加權正2,25,1,24,亞東-新竹,2024-09-19,2184
2845,遠東銀,21,0,21,亞東-新竹,2024-09-19,2184
5014,建錩,21,0,21,亞東-新竹,2024-09-19,2184
1301,台塑,20,0,20,亞東-新竹,2024-09-19,2184
6757,台灣虎航,20,0,20,亞東-新竹,2024-09-19,2184
1711,永光,50,31,19,亞東-新竹,2024-09-19,2184
00929,復華台灣科技優息,23,5,18,亞東-新竹,2024-09-19,2184
00706L,期元大S＆P日圓正2,15,0,15,亞東-新竹,2024-09-19,2184
00795B,中信美國公債20年,30,15,15,亞東-新竹,2024-09-19,2184
1539,巨庭,15,0,15,亞東-新竹,2024-09-19,2184
3062,建漢,15,0,15,亞東-新竹,2024-09-19,2184
4526,東台,15,0,15,亞東-新竹,2024-09-19,2184
2002,中鋼,14,0,14,亞東-新竹,2024-09-19,2184
00878,國泰永續高股息,15,2,13,亞東-新竹,2024-09-19,2184
2317,鴻海,17,4,13,亞東-新竹,2024-09-19,2184
3664,安瑞-KY,13,0,13,亞東-新竹,2024-09-19,2184
2426,鼎元,12,0,12,亞東-新竹,2024-09-19,2184
1312,國喬,10,0,10,亞東-新竹,2024-09-19,2184
1717,長興,10,0,10,亞東-新竹,2024-09-19,2184
2367,燿華,10,0,10,亞東-新竹,2024-09-19,2184
4157,太景*-KY,10,0,10,亞東-新竹,2024-09-19,2184
5488,松普,10,0,10,亞東-新竹,2024-09-19,2184
8070,長華*,10,0,10,亞東-新竹,2024-09-19,2184
2388,威盛,10,1,9,亞東-新竹,2024-09-19,2184
2344,華邦電,45,37,8,亞東-新竹,2024-09-19,2184
2412,中華電,8,0,8,亞東-新竹,2024-09-19,2184
3013,晟銘電,12,4,8,亞東-新竹,2024-09-19,2184
00918,大華優利高填息30,7,0,7,亞東-新竹,2024-09-19,2184
1784,訊聯,7,0,7,亞東-新竹,2024-09-19,2184
4510,高鋒,93,86,7,亞東-新竹,2024-09-19,2184
00713,元大台灣高息低波,6,0,6,亞東-新竹,2024-09-19,2184
00958B,永豐ESG銀行債15,6,0,6,亞東-新竹,2024-09-19,2184
3049,精金,8,2,6,亞東-新竹,2024-09-19,2184
3287,廣寰科,7,1,6,亞東-新竹,2024-09-19,2184
6151,晉倫,6,0,6,亞東-新竹,2024-09-19,2184
8936,國統,6,0,6,亞東-新竹,2024-09-19,2184
1309,台達化,5,0,5,亞東-新竹,2024-09-19,2184
4909,新復興,9,4,5,亞東-新竹,2024-09-19,2184
6122,擎邦,5,0,5,亞東-新竹,2024-09-19,2184
00931B,統一美債20年,4,0,4,亞東-新竹,2024-09-19,2184
00857B,永豐20年美公債,4,0,4,亞東-新竹,2024-09-19,2184
1324,地球,4,0,4,亞東-新竹,2024-09-19,2184
2303,聯電,16,12,4,亞東-新竹,2024-09-19,2184
2883,凱基金,600,5,595,亞東-新竹,2024-09-20,2184
00687B,國泰20年美債,124,0,124,亞東-新竹,2024-09-20,2184
00632R,元大台灣50反1,100,0,100,亞東-新竹,2024-09-20,2184
2888,新光金,145,61,84,亞東-新竹,2024-09-20,2184
1785,光洋科,65,9,56,亞東-新竹,2024-09-20,2184
00940,元大台灣價值高息,50,0,50,亞東-新竹,2024-09-20,2184
00679B,元大美債20年,44,0,44,亞東-新竹,2024-09-20,2184
1310,台苯,40,0,40,亞東-新竹,2024-09-20,2184
00857B,永豐20年美公債,41,5,36,亞東-新竹,2024-09-20,2184
6757,台灣虎航,30,0,30,亞東-新竹,2024-09-20,2184
1717,長興,35,7,28,亞東-新竹,2024-09-20,2184
0056,元大高股息,21,0,21,亞東-新竹,2024-09-20,2184
00958B,永豐ESG銀行債15,20,0,20,亞東-新竹,2024-09-20,2184
00706L,期元大S＆P日圓正2,20,0,20,亞東-新竹,2024-09-20,2184
00915,凱基優選高股息30,19,0,19,亞東-新竹,2024-09-20,2184
3588,通嘉,15,0,15,亞東-新竹,2024-09-20,2184
8932,智通*,14,0,14,亞東-新竹,2024-09-20,2184
3511,矽瑪,10,0,10,亞東-新竹,2024-09-20,2184
4974,亞泰,10,0,10,亞東-新竹,2024-09-20,2184
1808,潤隆,9,0,9,亞東-新竹,2024-09-20,2184
2367,燿華,11,2,9,亞東-新竹,2024-09-20,2184
2308,台達電,9,0,9,亞東-新竹,2024-09-20,2184
4968,立積,8,0,8,亞東-新竹,2024-09-20,2184
2845,遠東銀,8,0,8,亞東-新竹,2024-09-20,2184
2313,華通,8,1,7,亞東-新竹,2024-09-20,2184
2412,中華電,8,1,7,亞東-新竹,2024-09-20,2184
3005,神基,6,0,6,亞東-新竹,2024-09-20,2184
5272,笙科,6,0,6,亞東-新竹,2024-09-20,2184
00795B,中信美國公債20年,5,0,5,亞東-新竹,2024-09-20,2184
1102,亞泥,5,0,5,亞東-新竹,2024-09-20,2184
1314,中石化,20,15,5,亞東-新竹,2024-09-20,2184
2492,華新科,5,0,5,亞東-新竹,2024-09-20,2184
3040,遠見,5,0,5,亞東-新竹,2024-09-20,2184
4538,大詠城,5,0,5,亞東-新竹,2024-09-20,2184
4711,永純,5,0,5,亞東-新竹,2024-09-20,2184
4908,前鼎,5,0,5,亞東-新竹,2024-09-20,2184
5340,建榮,5,0,5,亞東-新竹,2024-09-20,2184
8039,台虹,5,0,5,亞東-新竹,2024-09-20,2184
6177,達麗,4,0,4,亞東-新竹,2024-09-20,2184
2101,南港,4,0,4,亞東-新竹,2024-09-20,2184
00931B,統一美債20年,4,0,4,亞東-新竹,2024-09-20,2184
2399,映泰,6,2,4,亞東-新竹,2024-09-20,2184
2427,三商電,4,0,4,亞東-新竹,2024-09-20,2184
2603,長榮,4,0,4,亞東-新竹,2024-09-20,2184
3202,樺晟,4,0,4,亞東-新竹,2024-09-20,2184
9941,裕融,4,0,4,亞東-新竹,2024-09-20,2184
00713,元大台灣高息低波,3,0,3,亞東-新竹,2024-09-20,2184
00633L,富邦上証正2,69,66,3,亞東-新竹,2024-09-20,2184
00725B,國泰投資級公司債,3,0,3,亞東-新竹,2024-09-20,2184
1721,三晃,4,1,3,亞東-新竹,2024-09-20,2184
2888,新光金,4100,229,3871,亞東-新竹,2024-09-23,2184
2883,凱基金,482,3,479,亞東-新竹,2024-09-23,2184
00679B,元大美債20年,108,0,108,亞東-新竹,2024-09-23,2184
00751B,元大AAA至A公司債,104,10,94,亞東-新竹,2024-09-23,2184
00720B,元大投資級公司債,53,0,53,亞東-新竹,2024-09-23,2184
1326,台化,50,0,50,亞東-新竹,2024-09-23,2184
2834,臺企銀,50,1,49,亞東-新竹,2024-09-23,2184
00915,凱基優選高股息30,40,4,36,亞東-新竹,2024-09-23,2184
3576,聯合再生,30,0,30,亞東-新竹,2024-09-23,2184
00706L,期元大S＆P日圓正2,25,0,25,亞東-新竹,2024-09-23,2184
4157,太景*-KY,25,0,25,亞東-新竹,2024-09-23,2184
1301,台塑,27,5,22,亞東-新竹,2024-09-23,2184
1711,永光,20,0,20,亞東-新竹,2024-09-23,2184
1735,日勝化,20,0,20,亞東-新竹,2024-09-23,2184
1785,光洋科,27,8,19,亞東-新竹,2024-09-23,2184
1314,中石化,17,0,17,亞東-新竹,2024-09-23,2184
00918,大華優利高填息30,17,0,17,亞東-新竹,2024-09-23,2184
2367,燿華,16,1,15,亞東-新竹,2024-09-23,2184
1721,三晃,13,1,12,亞東-新竹,2024-09-23,2184
4510,高鋒,38,26,12,亞東-新竹,2024-09-23,2184
2427,三商電,10,0,10,亞東-新竹,2024-09-23,2184
6126,信音,10,0,10,亞東-新竹,2024-09-23,2184
6757,台灣虎航,15,5,10,亞東-新竹,2024-09-23,2184
8421,旭源,10,0,10,亞東-新竹,2024-09-23,2184
00881,國泰台灣5G+,10,0,10,亞東-新竹,2024-09-23,2184
00929,復華台灣科技優息,10,1,9,亞東-新竹,2024-09-23,2184
00687B,國泰20年美債,12,3,9,亞東-新竹,2024-09-23,2184
00857B,永豐20年美公債,9,0,9,亞東-新竹,2024-09-23,2184
4714,永捷,9,0,9,亞東-新竹,2024-09-23,2184
3149,正達,11,3,8,亞東-新竹,2024-09-23,2184
3583,辛耘,9,1,8,亞東-新竹,2024-09-23,2184
4576,大銀微系統,8,0,8,亞東-新竹,2024-09-23,2184
4711,永純,8,0,8,亞東-新竹,2024-09-23,2184
3293,鈊象,7,0,7,亞東-新竹,2024-09-23,2184
4120,友華,7,0,7,亞東-新竹,2024-09-23,2184
00878,國泰永續高股息,6,0,6,亞東-新竹,2024-09-23,2184
3362,先進光,6,0,6,亞東-新竹,2024-09-23,2184
5243,乙盛-KY,6,0,6,亞東-新竹,2024-09-23,2184
5483,中美晶,8,2,6,亞東-新竹,2024-09-23,2184
6191,精成科,6,0,6,亞東-新竹,2024-09-23,2184
0056,元大高股息,5,0,5,亞東-新竹,2024-09-23,2184
00680L,元大美債20正2,5,0,5,亞東-新竹,2024-09-23,2184
0050,元大台灣50,5,0,5,亞東-新竹,2024-09-23,2184
1449,佳和,5,0,5,亞東-新竹,2024-09-23,2184
3167,大量,5,0,5,亞東-新竹,2024-09-23,2184
3664,安瑞-KY,5,0,5,亞東-新竹,2024-09-23,2184
3715,定穎投控,12,7,5,亞東-新竹,2024-09-23,2184
4919,新唐,5,0,5,亞東-新竹,2024-09-23,2184
4968,立積,5,0,5,亞東-新竹,2024-09-23,2184
5234,達興材料,5,0,5,亞東-新竹,2024-09-23,2184
00937B,群益ESG投等債20,91,0,91,亞東-新竹,2024-09-24,2184
00953B,群益優選非投等債,90,0,90,亞東-新竹,2024-09-24,2184
2891,中信金,62,10,52,亞東-新竹,2024-09-24,2184
00632R,元大台灣50反1,50,5,45,亞東-新竹,2024-09-24,2184
2884,玉山金,35,0,35,亞東-新竹,2024-09-24,2184
00687B,國泰20年美債,34,1,33,亞東-新竹,2024-09-24,2184
1735,日勝化,33,1,32,亞東-新竹,2024-09-24,2184
2344,華邦電,30,0,30,亞東-新竹,2024-09-24,2184
2609,陽明,59,30,29,亞東-新竹,2024-09-24,2184
00680L,元大美債20正2,25,0,25,亞東-新竹,2024-09-24,2184
00940,元大台灣價值高息,23,0,23,亞東-新竹,2024-09-24,2184
9958,世紀鋼,25,2,23,亞東-新竹,2024-09-24,2184
2633,台灣高鐵,22,0,22,亞東-新竹,2024-09-24,2184
6125,廣運,20,0,20,亞東-新竹,2024-09-24,2184
00929,復華台灣科技優息,17,0,17,亞東-新竹,2024-09-24,2184
4105,東洋,15,0,15,亞東-新竹,2024-09-24,2184
5398,慕康生醫,14,0,14,亞東-新竹,2024-09-24,2184
1720,生達,13,0,13,亞東-新竹,2024-09-24,2184
2881,富邦金,15,2,13,亞東-新竹,2024-09-24,2184
2317,鴻海,18,6,12,亞東-新竹,2024-09-24,2184
6156,松上,11,0,11,亞東-新竹,2024-09-24,2184
1314,中石化,10,0,10,亞東-新竹,2024-09-24,2184
2388,威盛,14,4,10,亞東-新竹,2024-09-24,2184
1326,台化,10,0,10,亞東-新竹,2024-09-24,2184
00795B,中信美國公債20年,10,0,10,亞東-新竹,2024-09-24,2184
1785,光洋科,15,5,10,亞東-新竹,2024-09-24,2184
1795,美時,10,0,10,亞東-新竹,2024-09-24,2184
2887,台新金,10,0,10,亞東-新竹,2024-09-24,2184
3024,憶聲,10,0,10,亞東-新竹,2024-09-24,2184
8916,光隆,10,0,10,亞東-新竹,2024-09-24,2184
6188,廣明,15,6,9,亞東-新竹,2024-09-24,2184
1727,中華化,9,0,9,亞東-新竹,2024-09-24,2184
6151,晉倫,9,0,9,亞東-新竹,2024-09-24,2184
2201,裕隆,8,0,8,亞東-新竹,2024-09-24,2184
2303,聯電,8,0,8,亞東-新竹,2024-09-24,2184
2613,中櫃,8,0,8,亞東-新竹,2024-09-24,2184
2890,永豐金,8,0,8,亞東-新竹,2024-09-24,2184
3062,建漢,11,3,8,亞東-新竹,2024-09-24,2184
00740B,富邦全球投等債,7,0,7,亞東-新竹,2024-09-24,2184
3605,宏致,7,0,7,亞東-新竹,2024-09-24,2184
00919,群益台灣精選高息,6,0,6,亞東-新竹,2024-09-24,2184
1460,宏遠,6,0,6,亞東-新竹,2024-09-24,2184
2539,櫻花建,6,0,6,亞東-新竹,2024-09-24,2184
4306,炎洲,6,0,6,亞東-新竹,2024-09-24,2184
6142,友勁,6,0,6,亞東-新竹,2024-09-24,2184
6649,台生材,6,0,6,亞東-新竹,2024-09-24,2184
8249,菱光,6,0,6,亞東-新竹,2024-09-24,2184
00712,復華富時不動產,5,0,5,亞東-新竹,2024-09-24,2184
00706L,期元大S＆P日圓正2,5,0,5,亞東-新竹,2024-09-24,2184
00882,中信中國高股息,5,0,5,亞東-新竹,2024-09-24,2184
00679B,元大美債20年,148,5,143,亞東-新竹,2024-09-25,2184
00751B,元大AAA至A公司債,55,0,55,亞東-新竹,2024-09-25,2184
1326,台化,50,0,50,亞東-新竹,2024-09-25,2184
1605,華新,53,4,49,亞東-新竹,2024-09-25,2184
00632R,元大台灣50反1,50,5,45,亞東-新竹,2024-09-25,2184
2353,宏��,30,0,30,亞東-新竹,2024-09-25,2184
00687B,國泰20年美債,27,0,27,亞東-新竹,2024-09-25,2184
3550,聯穎,30,7,23,亞東-新竹,2024-09-25,2184
6156,松上,23,0,23,亞東-新竹,2024-09-25,2184
3576,聯合再生,20,0,20,亞東-新竹,2024-09-25,2184
2603,長榮,48,29,19,亞東-新竹,2024-09-25,2184
00637L,元大滬深300正2,36,19,17,亞東-新竹,2024-09-25,2184
2363,矽統,16,0,16,亞東-新竹,2024-09-25,2184
8070,長華*,26,10,16,亞東-新竹,2024-09-25,2184
2383,台光電,15,0,15,亞東-新竹,2024-09-25,2184
2458,義隆,15,0,15,亞東-新竹,2024-09-25,2184
3707,漢磊,15,0,15,亞東-新竹,2024-09-25,2184
00933B,國泰10Y+金融債,13,0,13,亞東-新竹,2024-09-25,2184
5283,禾聯碩,12,0,12,亞東-新竹,2024-09-25,2184
00857B,永豐20年美公債,11,0,11,亞東-新竹,2024-09-25,2184
3711,日月光投控,11,0,11,亞東-新竹,2024-09-25,2184
8374,羅昇,11,0,11,亞東-新竹,2024-09-25,2184
2887,台新金,10,0,10,亞東-新竹,2024-09-25,2184
00947,台新臺灣IC設計,10,0,10,亞東-新竹,2024-09-25,2184
00953B,群益優選非投等債,10,0,10,亞東-新竹,2024-09-25,2184
1735,日勝化,10,0,10,亞東-新竹,2024-09-25,2184
2547,日勝生,10,0,10,亞東-新竹,2024-09-25,2184
4105,東洋,10,0,10,亞東-新竹,2024-09-25,2184
4526,東台,10,0,10,亞東-新竹,2024-09-25,2184
5438,東友,10,0,10,亞東-新竹,2024-09-25,2184
5469,瀚宇博,10,0,10,亞東-新竹,2024-09-25,2184
6462,神盾,22,12,10,亞東-新竹,2024-09-25,2184
6763,綠界科技*,10,0,10,亞東-新竹,2024-09-25,2184
2388,威盛,9,0,9,亞東-新竹,2024-09-25,2184
3596,智易,11,2,9,亞東-新竹,2024-09-25,2184
4714,永捷,9,0,9,亞東-新竹,2024-09-25,2184
2891,中信金,14,6,8,亞東-新竹,2024-09-25,2184
1808,潤隆,8,0,8,亞東-新竹,2024-09-25,2184
2049,上銀,9,1,8,亞東-新竹,2024-09-25,2184
00919,群益台灣精選高息,7,0,7,亞東-新竹,2024-09-25,2184
00712,復華富時不動產,6,0,6,亞東-新竹,2024-09-25,2184
2460,建通,6,0,6,亞東-新竹,2024-09-25,2184
00720B,元大投資級公司債,5,0,5,亞東-新竹,2024-09-25,2184
00795B,中信美國公債20年,5,0,5,亞東-新竹,2024-09-25,2184
2481,強茂,5,0,5,亞東-新竹,2024-09-25,2184
4538,大詠城,5,0,5,亞東-新竹,2024-09-25,2184
8421,旭源,5,0,5,亞東-新竹,2024-09-25,2184
00929,復華台灣科技優息,4,0,4,亞東-新竹,2024-09-25,2184
1795,美時,4,0,4,亞東-新竹,2024-09-25,2184
2399,映泰,4,0,4,亞東-新竹,2024-09-25,2184
00679B,元大美債20年,72,0,72,亞東-新竹,2024-09-26,2184
00937B,群益ESG投等債20,71,2,69,亞東-新竹,2024-09-26,2184
00948B,中信優息投資級債,62,0,62,亞東-新竹,2024-09-26,2184
00687B,國泰20年美債,62,10,52,亞東-新竹,2024-09-26,2184
00720B,元大投資級公司債,56,10,46,亞東-新竹,2024-09-26,2184
00922,國泰台灣領袖50,40,0,40,亞東-新竹,2024-09-26,2184
1326,台化,40,0,40,亞東-新竹,2024-09-26,2184
00706L,期元大S＆P日圓正2,35,0,35,亞東-新竹,2024-09-26,2184
00915,凱基優選高股息30,25,0,25,亞東-新竹,2024-09-26,2184
2890,永豐金,25,0,25,亞東-新竹,2024-09-26,2184
00929,復華台灣科技優息,22,0,22,亞東-新竹,2024-09-26,2184
00960,野村全球航運龍頭,160,138,22,亞東-新竹,2024-09-26,2184
00751B,元大AAA至A公司債,21,0,21,亞東-新竹,2024-09-26,2184
2867,三商壽,20,0,20,亞東-新竹,2024-09-26,2184
4157,太景*-KY,20,0,20,亞東-新竹,2024-09-26,2184
1785,光洋科,54,35,19,亞東-新竹,2024-09-26,2184
3019,亞光,20,2,18,亞東-新竹,2024-09-26,2184
2312,金寶,14,1,13,亞東-新竹,2024-09-26,2184
4716,大立,19,6,13,亞東-新竹,2024-09-26,2184
1735,日勝化,40,28,12,亞東-新竹,2024-09-26,2184
2915,潤泰全,12,0,12,亞東-新竹,2024-09-26,2184
8111,立��,37,25,12,亞東-新竹,2024-09-26,2184
3189,景碩,26,15,11,亞東-新竹,2024-09-26,2184
4714,永捷,11,0,11,亞東-新竹,2024-09-26,2184
00631L,元大台灣50正2,12,2,10,亞東-新竹,2024-09-26,2184
00919,群益台灣精選高息,10,0,10,亞東-新竹,2024-09-26,2184
00713,元大台灣高息低波,10,0,10,亞東-新竹,2024-09-26,2184
2458,義隆,10,0,10,亞東-新竹,2024-09-26,2184
2497,怡利電,10,0,10,亞東-新竹,2024-09-26,2184
4543,萬在,11,1,10,亞東-新竹,2024-09-26,2184
4961,天鈺,10,0,10,亞東-新竹,2024-09-26,2184
6257,矽格,10,0,10,亞東-新竹,2024-09-26,2184
6285,啟��,10,0,10,亞東-新竹,2024-09-26,2184
2367,燿華,20,11,9,亞東-新竹,2024-09-26,2184
3707,漢磊,8,0,8,亞東-新竹,2024-09-26,2184
4711,永純,8,0,8,亞東-新竹,2024-09-26,2184
8454,富邦媒,7,0,7,亞東-新竹,2024-09-26,2184
3583,辛耘,8,1,7,亞東-新竹,2024-09-26,2184
00931B,統一美債20年,6,0,6,亞東-新竹,2024-09-26,2184
1324,地球,6,0,6,亞東-新竹,2024-09-26,2184
2002,中鋼,6,0,6,亞東-新竹,2024-09-26,2184
2359,所羅門,13,7,6,亞東-新竹,2024-09-26,2184
5469,瀚宇博,6,0,6,亞東-新竹,2024-09-26,2184
1314,中石化,15,10,5,亞東-新竹,2024-09-26,2184
00795B,中信美國公債20年,5,0,5,亞東-新竹,2024-09-26,2184
1815,富喬,5,0,5,亞東-新竹,2024-09-26,2184
3037,欣興,12,7,5,亞東-新竹,2024-09-26,2184
3551,世禾,5,0,5,亞東-新竹,2024-09-26,2184
4105,東洋,5,0,5,亞東-新竹,2024-09-26,2184
4971,IET-KY,5,0,5,亞東-新竹,2024-09-26,2184
00960,野村全球航運龍頭,202,0,202,亞東-新竹,2024-09-27,2184
00679B,元大美債20年,136,5,131,亞東-新竹,2024-09-27,2184
00665L,富邦�琤肭磪囓�2,134,5,129,亞東-新竹,2024-09-27,2184
00720B,元大投資級公司債,105,10,95,亞東-新竹,2024-09-27,2184
00688L,國泰20年美債正2,114,26,88,亞東-新竹,2024-09-27,2184
3189,景碩,114,32,82,亞東-新竹,2024-09-27,2184
00948B,中信優息投資級債,55,0,55,亞東-新竹,2024-09-27,2184
00706L,期元大S＆P日圓正2,42,0,42,亞東-新竹,2024-09-27,2184
2633,台灣高鐵,41,0,41,亞東-新竹,2024-09-27,2184
3037,欣興,47,9,38,亞東-新竹,2024-09-27,2184
1711,永光,36,1,35,亞東-新竹,2024-09-27,2184
1605,華新,48,15,33,亞東-新竹,2024-09-27,2184
006205,富邦上証,32,0,32,亞東-新竹,2024-09-27,2184
2891,中信金,35,5,30,亞東-新竹,2024-09-27,2184
1326,台化,50,20,30,亞東-新竹,2024-09-27,2184
00953B,群益優選非投等債,30,0,30,亞東-新竹,2024-09-27,2184
00937B,群益ESG投等債20,44,15,29,亞東-新竹,2024-09-27,2184
00687B,國泰20年美債,26,0,26,亞東-新竹,2024-09-27,2184
00881,國泰台灣5G+,22,0,22,亞東-新竹,2024-09-27,2184
1314,中石化,61,40,21,亞東-新竹,2024-09-27,2184
2308,台達電,21,1,20,亞東-新竹,2024-09-27,2184
2105,正新,20,1,19,亞東-新竹,2024-09-27,2184
2029,盛餘,13,0,13,亞東-新竹,2024-09-27,2184
00632R,元大台灣50反1,10,0,10,亞東-新竹,2024-09-27,2184
00788B,元大10年IG電能債,10,0,10,亞東-新竹,2024-09-27,2184
00725B,國泰投資級公司債,10,0,10,亞東-新竹,2024-09-27,2184
5272,笙科,10,0,10,亞東-新竹,2024-09-27,2184
00715L,期街口布蘭特正2,9,0,9,亞東-新竹,2024-09-27,2184
2367,燿華,11,2,9,亞東-新竹,2024-09-27,2184
2382,廣達,12,4,8,亞東-新竹,2024-09-27,2184
00751B,元大AAA至A公司債,7,0,7,亞東-新竹,2024-09-27,2184
3363,上詮,7,0,7,亞東-新竹,2024-09-27,2184
4147,中裕,7,0,7,亞東-新竹,2024-09-27,2184
00795B,中信美國公債20年,6,0,6,亞東-新竹,2024-09-27,2184
00650L,復華香港正2,6,0,6,亞東-新竹,2024-09-27,2184
2542,興富發,6,0,6,亞東-新竹,2024-09-27,2184
2915,潤泰全,6,0,6,亞東-新竹,2024-09-27,2184
6492,生華科,11,5,6,亞東-新竹,2024-09-27,2184
8028,昇陽半導體,19,13,6,亞東-新竹,2024-09-27,2184
2609,陽明,8,3,5,亞東-新竹,2024-09-27,2184
3013,晟銘電,12,7,5,亞東-新竹,2024-09-27,2184
2388,威盛,8,3,5,亞東-新竹,2024-09-27,2184
00878,國泰永續高股息,5,0,5,亞東-新竹,2024-09-27,2184
3019,亞光,10,5,5,亞東-新竹,2024-09-27,2184
00929,復華台灣科技優息,5,0,5,亞東-新竹,2024-09-27,2184
1727,中華化,7,2,5,亞東-新竹,2024-09-27,2184
2801,彰銀,5,0,5,亞東-新竹,2024-09-27,2184
2885,元大金,5,0,5,亞東-新竹,2024-09-27,2184
2897,王道銀行,5,0,5,亞東-新竹,2024-09-27,2184
3564,其陽,5,0,5,亞東-新竹,2024-09-27,2184
1326,台化,161,1,160,亞東-新竹,2024-09-30,2184
00687B,國泰20年美債,97,1,96,亞東-新竹,2024-09-30,2184
00650L,復華香港正2,93,0,93,亞東-新竹,2024-09-30,2184
00937B,群益ESG投等債20,87,0,87,亞東-新竹,2024-09-30,2184
00633L,富邦上証正2,70,4,66,亞東-新竹,2024-09-30,2184
1735,日勝化,65,0,65,亞東-新竹,2024-09-30,2184
00922,國泰台灣領袖50,49,0,49,亞東-新竹,2024-09-30,2184
2344,華邦電,50,1,49,亞東-新竹,2024-09-30,2184
00929,復華台灣科技優息,34,1,33,亞東-新竹,2024-09-30,2184
00953B,群益優選非投等債,30,0,30,亞東-新竹,2024-09-30,2184
00795B,中信美國公債20年,22,0,22,亞東-新竹,2024-09-30,2184
2603,長榮,21,0,21,亞東-新竹,2024-09-30,2184
2303,聯電,20,0,20,亞東-新竹,2024-09-30,2184
2330,台積電,17,0,17,亞東-新竹,2024-09-30,2184
2317,鴻海,20,3,17,亞東-新竹,2024-09-30,2184
00679B,元大美債20年,16,0,16,亞東-新竹,2024-09-30,2184
2615,萬海,24,9,15,亞東-新竹,2024-09-30,2184
00753L,中信中國50正2,17,3,14,亞東-新竹,2024-09-30,2184
006205,富邦上証,12,0,12,亞東-新竹,2024-09-30,2184
0050,元大台灣50,12,1,11,亞東-新竹,2024-09-30,2184
00725B,國泰投資級公司債,11,0,11,亞東-新竹,2024-09-30,2184
2913,農林,11,0,11,亞東-新竹,2024-09-30,2184
00940,元大台灣價值高息,11,0,11,亞東-新竹,2024-09-30,2184
00751B,元大AAA至A公司債,10,0,10,亞東-新竹,2024-09-30,2184
00881,國泰台灣5G+,10,0,10,亞東-新竹,2024-09-30,2184
00933B,國泰10Y+金融債,10,0,10,亞東-新竹,2024-09-30,2184
1785,光洋科,10,0,10,亞東-新竹,2024-09-30,2184
4545,銘鈺,10,0,10,亞東-新竹,2024-09-30,2184
8415,大國鋼,10,0,10,亞東-新竹,2024-09-30,2184
3189,景碩,29,20,9,亞東-新竹,2024-09-30,2184
00905,FT臺灣Smart,8,0,8,亞東-新竹,2024-09-30,2184
1609,大亞,8,0,8,亞東-新竹,2024-09-30,2184
2014,中鴻,8,0,8,亞東-新竹,2024-09-30,2184
00919,群益台灣精選高息,38,30,8,亞東-新竹,2024-09-30,2184
00888,永豐台灣ESG,7,0,7,亞東-新竹,2024-09-30,2184
6257,矽格,6,0,6,亞東-新竹,2024-09-30,2184
2382,廣達,8,2,6,亞東-新竹,2024-09-30,2184
2845,遠東銀,7,1,6,亞東-新竹,2024-09-30,2184
2388,威盛,10,4,6,亞東-新竹,2024-09-30,2184
00634R,富邦上証反1,5,0,5,亞東-新竹,2024-09-30,2184
00631L,元大台灣50正2,5,0,5,亞東-新竹,2024-09-30,2184
00656R,國泰中國A50反1,5,0,5,亞東-新竹,2024-09-30,2184
2376,技嘉,5,0,5,亞東-新竹,2024-09-30,2184
2458,義隆,5,0,5,亞東-新竹,2024-09-30,2184
2515,中工,5,0,5,亞東-新竹,2024-09-30,2184
2884,玉山金,5,0,5,亞東-新竹,2024-09-30,2184
4543,萬在,5,0,5,亞東-新竹,2024-09-30,2184
6138,茂達,5,0,5,亞東-新竹,2024-09-30,2184
2605,新興,5,0,5,亞東-新竹,2024-09-30,2184
1101,台泥,10,6,4,亞東-新竹,2024-09-30,2184
0056,元大高股息,64,0,64,亞東-新竹,2024-10-01,2184
00929,復華台灣科技優息,53,0,53,亞東-新竹,2024-10-01,2184
1735,日勝化,51,0,51,亞東-新竹,2024-10-01,2184
00679B,元大美債20年,50,0,50,亞東-新竹,2024-10-01,2184
00675L,富邦臺灣加權正2,45,0,45,亞東-新竹,2024-10-01,2184
8046,南電,21,0,21,亞東-新竹,2024-10-01,2184
00887,永豐中國科技50大,20,0,20,亞東-新竹,2024-10-01,2184
2633,台灣高鐵,20,0,20,亞東-新竹,2024-10-01,2184
2888,新光金,47,30,17,亞東-新竹,2024-10-01,2184
2402,毅嘉,15,0,15,亞東-新竹,2024-10-01,2184
4153,鈺緯,15,0,15,亞東-新竹,2024-10-01,2184
2107,厚生,13,0,13,亞東-新竹,2024-10-01,2184
4909,新復興,11,0,11,亞東-新竹,2024-10-01,2184
2458,義隆,11,0,11,亞東-新竹,2024-10-01,2184
1314,中石化,15,5,10,亞東-新竹,2024-10-01,2184
00636,國泰中國A50,10,0,10,亞東-新竹,2024-10-01,2184
2317,鴻海,11,1,10,亞東-新竹,2024-10-01,2184
00915,凱基優選高股息30,9,0,9,亞東-新竹,2024-10-01,2184
2316,楠梓電,9,0,9,亞東-新竹,2024-10-01,2184
00878,國泰永續高股息,9,1,8,亞東-新竹,2024-10-01,2184
00882,中信中國高股息,10,2,8,亞東-新竹,2024-10-01,2184
2845,遠東銀,9,1,8,亞東-新竹,2024-10-01,2184
6469,大樹,8,0,8,亞東-新竹,2024-10-01,2184
2388,威盛,12,4,8,亞東-新竹,2024-10-01,2184
4147,中裕,7,0,7,亞東-新竹,2024-10-01,2184
00937B,群益ESG投等債20,6,0,6,亞東-新竹,2024-10-01,2184
1802,台玻,11,5,6,亞東-新竹,2024-10-01,2184
4545,銘鈺,6,0,6,亞東-新竹,2024-10-01,2184
00706L,期元大S＆P日圓正2,5,0,5,亞東-新竹,2024-10-01,2184
1605,華新,5,0,5,亞東-新竹,2024-10-01,2184
3062,建漢,5,0,5,亞東-新竹,2024-10-01,2184
3217,優群,5,0,5,亞東-新竹,2024-10-01,2184
3227,原相,7,2,5,亞東-新竹,2024-10-01,2184
4174,浩鼎,17,12,5,亞東-新竹,2024-10-01,2184
6414,樺漢,6,1,5,亞東-新竹,2024-10-01,2184
00713,元大台灣高息低波,4,0,4,亞東-新竹,2024-10-01,2184
5225,東科-KY,10,6,4,亞東-新竹,2024-10-01,2184
3443,創意,6,2,4,亞東-新竹,2024-10-01,2184
1324,地球,4,0,4,亞東-新竹,2024-10-01,2184
1609,大亞,4,0,4,亞東-新竹,2024-10-01,2184
1732,毛寶,8,4,4,亞東-新竹,2024-10-01,2184
2314,台揚,4,0,4,亞東-新竹,2024-10-01,2184
5483,中美晶,4,0,4,亞東-新竹,2024-10-01,2184
8089,康全電訊,4,0,4,亞東-新竹,2024-10-01,2184
8097,常珵,4,0,4,亞東-新竹,2024-10-01,2184
8112,至上,4,0,4,亞東-新竹,2024-10-01,2184
1513,中興電,3,0,3,亞東-新竹,2024-10-01,2184
2345,智邦,3,0,3,亞東-新竹,2024-10-01,2184
2363,矽統,6,3,3,亞東-新竹,2024-10-01,2184
2367,燿華,3,0,3,亞東-新竹,2024-10-01,2184
00940,元大台灣價值高息,151,4,147,亞東-新竹,2024-10-04,2184
6163,華電網,122,0,122,亞東-新竹,2024-10-04,2184
00679B,元大美債20年,78,30,48,亞東-新竹,2024-10-04,2184
00751B,元大AAA至A公司債,42,0,42,亞東-新竹,2024-10-04,2184
2633,台灣高鐵,40,0,40,亞東-新竹,2024-10-04,2184
2603,長榮,37,2,35,亞東-新竹,2024-10-04,2184
00650L,復華香港正2,33,0,33,亞東-新竹,2024-10-04,2184
00932,兆豐永續高息等權,30,0,30,亞東-新竹,2024-10-04,2184
1326,台化,30,0,30,亞東-新竹,2024-10-04,2184
4157,太景*-KY,30,0,30,亞東-新竹,2024-10-04,2184
2610,華航,27,0,27,亞東-新竹,2024-10-04,2184
00697B,元大美債7-10,39,13,26,亞東-新竹,2024-10-04,2184
00919,群益台灣精選高息,25,0,25,亞東-新竹,2024-10-04,2184
3374,精材,24,0,24,亞東-新竹,2024-10-04,2184
2615,萬海,27,5,22,亞東-新竹,2024-10-04,2184
2618,長榮航,21,0,21,亞東-新竹,2024-10-04,2184
00687B,國泰20年美債,18,0,18,亞東-新竹,2024-10-04,2184
1301,台塑,18,0,18,亞東-新竹,2024-10-04,2184
00646,元大S＆P500,37,20,17,亞東-新竹,2024-10-04,2184
006205,富邦上証,17,0,17,亞東-新竹,2024-10-04,2184
0056,元大高股息,17,1,16,亞東-新竹,2024-10-04,2184
2303,聯電,15,0,15,亞東-新竹,2024-10-04,2184
2891,中信金,22,7,15,亞東-新竹,2024-10-04,2184
3324,雙鴻,15,0,15,亞東-新竹,2024-10-04,2184
1402,遠東新,14,0,14,亞東-新竹,2024-10-04,2184
5871,中租-KY,13,0,13,亞東-新竹,2024-10-04,2184
2425,承啟,27,14,13,亞東-新竹,2024-10-04,2184
2867,三商壽,14,1,13,亞東-新竹,2024-10-04,2184
3037,欣興,15,2,13,亞東-新竹,2024-10-04,2184
2308,台達電,15,2,13,亞東-新竹,2024-10-04,2184
00878,國泰永續高股息,12,0,12,亞東-新竹,2024-10-04,2184
00753L,中信中國50正2,14,3,11,亞東-新竹,2024-10-04,2184
3062,建漢,20,9,11,亞東-新竹,2024-10-04,2184
00706L,期元大S＆P日圓正2,10,0,10,亞東-新竹,2024-10-04,2184
00939,統一台灣高息動能,10,0,10,亞東-新竹,2024-10-04,2184
3231,緯創,10,0,10,亞東-新竹,2024-10-04,2184
9921,巨大,10,0,10,亞東-新竹,2024-10-04,2184
2884,玉山金,9,0,9,亞東-新竹,2024-10-04,2184
2382,廣達,17,8,9,亞東-新竹,2024-10-04,2184
00680L,元大美債20正2,9,0,9,亞東-新竹,2024-10-04,2184
00931B,統一美債20年,9,0,9,亞東-新竹,2024-10-04,2184
5263,智崴,9,0,9,亞東-新竹,2024-10-04,2184
2609,陽明,15,7,8,亞東-新竹,2024-10-04,2184
00634R,富邦上証反1,8,0,8,亞東-新竹,2024-10-04,2184
3048,益登,8,0,8,亞東-新竹,2024-10-04,2184
2367,燿華,7,0,7,亞東-新竹,2024-10-04,2184
4119,旭富,7,0,7,亞東-新竹,2024-10-04,2184
00645,富邦日本,10,4,6,亞東-新竹,2024-10-04,2184
00636,國泰中國A50,13,7,6,亞東-新竹,2024-10-04,2184
6134,萬旭,13,7,6,亞東-新竹,2024-10-04,2184
2886,兆豐金,44,0,44,亞東-新竹,2024-10-07,2184
1314,中石化,51,10,41,亞東-新竹,2024-10-07,2184
00665L,富邦�琤肭磪囓�2,35,2,33,亞東-新竹,2024-10-07,2184
8111,立��,46,14,32,亞東-新竹,2024-10-07,2184
3189,景碩,35,5,30,亞東-新竹,2024-10-07,2184
00650L,復華香港正2,30,2,28,亞東-新竹,2024-10-07,2184
00753L,中信中國50正2,39,12,27,亞東-新竹,2024-10-07,2184
00881,國泰台灣5G+,26,0,26,亞東-新竹,2024-10-07,2184
00679B,元大美債20年,26,1,25,亞東-新竹,2024-10-07,2184
00712,復華富時不動產,24,1,23,亞東-新竹,2024-10-07,2184
006205,富邦上証,22,0,22,亞東-新竹,2024-10-07,2184
00751B,元大AAA至A公司債,20,0,20,亞東-新竹,2024-10-07,2184
2633,台灣高鐵,20,0,20,亞東-新竹,2024-10-07,2184
3037,欣興,21,1,20,亞東-新竹,2024-10-07,2184
5014,建錩,30,10,20,亞東-新竹,2024-10-07,2184
9105,泰金寶-DR,20,0,20,亞東-新竹,2024-10-07,2184
00680L,元大美債20正2,16,0,16,亞東-新竹,2024-10-07,2184
5871,中租-KY,14,1,13,亞東-新竹,2024-10-07,2184
2328,廣宇,12,0,12,亞東-新竹,2024-10-07,2184
2888,新光金,130,118,12,亞東-新竹,2024-10-07,2184
3615,安可,12,0,12,亞東-新竹,2024-10-07,2184
00687B,國泰20年美債,16,5,11,亞東-新竹,2024-10-07,2184
00943,兆豐電子高息等權,11,0,11,亞東-新竹,2024-10-07,2184
0056,元大高股息,10,0,10,亞東-新竹,2024-10-07,2184
00949,復華日本龍頭,10,0,10,亞東-新竹,2024-10-07,2184
00632R,元大台灣50反1,10,0,10,亞東-新竹,2024-10-07,2184
00725B,國泰投資級公司債,10,0,10,亞東-新竹,2024-10-07,2184
00706L,期元大S＆P日圓正2,10,0,10,亞東-新竹,2024-10-07,2184
2436,偉詮電,10,0,10,亞東-新竹,2024-10-07,2184
2537,聯上發,10,0,10,亞東-新竹,2024-10-07,2184
4545,銘鈺,10,0,10,亞東-新竹,2024-10-07,2184
5483,中美晶,10,0,10,亞東-新竹,2024-10-07,2184
3034,聯詠,9,0,9,亞東-新竹,2024-10-07,2184
2317,鴻海,22,13,9,亞東-新竹,2024-10-07,2184
00937B,群益ESG投等債20,9,1,8,亞東-新竹,2024-10-07,2184
00919,群益台灣精選高息,7,0,7,亞東-新竹,2024-10-07,2184
1102,亞泥,7,0,7,亞東-新竹,2024-10-07,2184
2425,承啟,20,13,7,亞東-新竹,2024-10-07,2184
3062,建漢,13,6,7,亞東-新竹,2024-10-07,2184
5340,建榮,7,0,7,亞東-新竹,2024-10-07,2184
00933B,國泰10Y+金融債,6,0,6,亞東-新竹,2024-10-07,2184
00940,元大台灣價值高息,6,0,6,亞東-新竹,2024-10-07,2184
5243,乙盛-KY,10,4,6,亞東-新竹,2024-10-07,2184
6125,廣運,6,0,6,亞東-新竹,2024-10-07,2184
6285,啟��,5,0,5,亞東-新竹,2024-10-07,2184
00795B,中信美國公債20年,5,0,5,亞東-新竹,2024-10-07,2184
00643,群益深証中小,5,0,5,亞東-新竹,2024-10-07,2184
1201,味全,5,0,5,亞東-新竹,2024-10-07,2184
2834,臺企銀,5,0,5,亞東-新竹,2024-10-07,2184
4207,環泰,5,0,5,亞東-新竹,2024-10-07,2184
00673R,期元大S＆P原油反1,400,202,198,亞東-新竹,2024-10-08,2184
00665L,富邦�琤肭磪囓�2,128,6,122,亞東-新竹,2024-10-08,2184
00915,凱基優選高股息30,105,0,105,亞東-新竹,2024-10-08,2184
00687B,國泰20年美債,103,0,103,亞東-新竹,2024-10-08,2184
00679B,元大美債20年,75,0,75,亞東-新竹,2024-10-08,2184
00751B,元大AAA至A公司債,72,0,72,亞東-新竹,2024-10-08,2184
00637L,元大滬深300正2,110,68,42,亞東-新竹,2024-10-08,2184
3209,全科,42,0,42,亞東-新竹,2024-10-08,2184
00680L,元大美債20正2,39,0,39,亞東-新竹,2024-10-08,2184
2883,凱基金,35,0,35,亞東-新竹,2024-10-08,2184
1314,中石化,30,0,30,亞東-新竹,2024-10-08,2184
5014,建錩,70,40,30,亞東-新竹,2024-10-08,2184
2845,遠東銀,37,9,28,亞東-新竹,2024-10-08,2184
2402,毅嘉,35,8,27,亞東-新竹,2024-10-08,2184
00631L,元大台灣50正2,22,0,22,亞東-新竹,2024-10-08,2184
2633,台灣高鐵,21,0,21,亞東-新竹,2024-10-08,2184
2881,富邦金,21,0,21,亞東-新竹,2024-10-08,2184
00712,復華富時不動產,20,0,20,亞東-新竹,2024-10-08,2184
1301,台塑,20,0,20,亞東-新竹,2024-10-08,2184
2204,中華,20,0,20,亞東-新竹,2024-10-08,2184
6505,台塑化,21,1,20,亞東-新竹,2024-10-08,2184
00922,國泰台灣領袖50,20,2,18,亞東-新竹,2024-10-08,2184
00937B,群益ESG投等債20,17,0,17,亞東-新竹,2024-10-08,2184
00882,中信中國高股息,19,3,16,亞東-新竹,2024-10-08,2184
4714,永捷,16,0,16,亞東-新竹,2024-10-08,2184
6207,雷科,16,3,13,亞東-新竹,2024-10-08,2184
00795B,中信美國公債20年,12,0,12,亞東-新竹,2024-10-08,2184
00929,復華台灣科技優息,31,20,11,亞東-新竹,2024-10-08,2184
8111,立��,24,13,11,亞東-新竹,2024-10-08,2184
00725B,國泰投資級公司債,10,0,10,亞東-新竹,2024-10-08,2184
2458,義隆,10,0,10,亞東-新竹,2024-10-08,2184
6585,鼎基,10,0,10,亞東-新竹,2024-10-08,2184
2002,中鋼,11,1,10,亞東-新竹,2024-10-08,2184
00720B,元大投資級公司債,59,50,9,亞東-新竹,2024-10-08,2184
2887,台新金,10,1,9,亞東-新竹,2024-10-08,2184
3019,亞光,9,0,9,亞東-新竹,2024-10-08,2184
3025,星通,15,6,9,亞東-新竹,2024-10-08,2184
00887,永豐中國科技50大,23,15,8,亞東-新竹,2024-10-08,2184
3227,原相,9,1,8,亞東-新竹,2024-10-08,2184
4303,信立,10,2,8,亞東-新竹,2024-10-08,2184
5469,瀚宇博,7,0,7,亞東-新竹,2024-10-08,2184
8040,九暘,7,0,7,亞東-新竹,2024-10-08,2184
0056,元大高股息,7,1,6,亞東-新竹,2024-10-08,2184
00655L,國泰中國A50正2,8,2,6,亞東-新竹,2024-10-08,2184
1721,三晃,6,0,6,亞東-新竹,2024-10-08,2184
4306,炎洲,6,0,6,亞東-新竹,2024-10-08,2184
5243,乙盛-KY,6,0,6,亞東-新竹,2024-10-08,2184
6134,萬旭,14,8,6,亞東-新竹,2024-10-08,2184
3324,雙鴻,8,2,6,亞東-新竹,2024-10-08,2184
00878,國泰永續高股息,15,10,5,亞東-新竹,2024-10-08,2184
2888,新光金,220,0,220,亞東-新竹,2024-10-09,2184
00680L,元大美債20正2,137,0,137,亞東-新竹,2024-10-09,2184
00712,復華富時不動產,105,0,105,亞東-新竹,2024-10-09,2184
00688L,國泰20年美債正2,112,10,102,亞東-新竹,2024-10-09,2184
00665L,富邦�琤肭磪囓�2,175,105,70,亞東-新竹,2024-10-09,2184
1735,日勝化,55,0,55,亞東-新竹,2024-10-09,2184
2610,華航,50,0,50,亞東-新竹,2024-10-09,2184
00687B,國泰20年美債,46,0,46,亞東-新竹,2024-10-09,2184
00937B,群益ESG投等債20,42,0,42,亞東-新竹,2024-10-09,2184
3209,全科,37,0,37,亞東-新竹,2024-10-09,2184
1314,中石化,28,0,28,亞東-新竹,2024-10-09,2184
2303,聯電,32,5,27,亞東-新竹,2024-10-09,2184
2002,中鋼,25,0,25,亞東-新竹,2024-10-09,2184
3481,群創,25,0,25,亞東-新竹,2024-10-09,2184
6015,宏遠證,25,1,24,亞東-新竹,2024-10-09,2184
6288,聯嘉,24,0,24,亞東-新竹,2024-10-09,2184
2603,長榮,20,0,20,亞東-新竹,2024-10-09,2184
6770,力積電,18,0,18,亞東-新竹,2024-10-09,2184
4153,鈺緯,16,0,16,亞東-新竹,2024-10-09,2184
1301,台塑,14,0,14,亞東-新竹,2024-10-09,2184
1324,地球,13,0,13,亞東-新竹,2024-10-09,2184
4576,大銀微系統,17,4,13,亞東-新竹,2024-10-09,2184
2344,華邦電,11,0,11,亞東-新竹,2024-10-09,2184
4105,東洋,11,0,11,亞東-新竹,2024-10-09,2184
6126,信音,11,0,11,亞東-新竹,2024-10-09,2184
00751B,元大AAA至A公司債,10,0,10,亞東-新竹,2024-10-09,2184
00725B,國泰投資級公司債,10,0,10,亞東-新竹,2024-10-09,2184
00795B,中信美國公債20年,10,0,10,亞東-新竹,2024-10-09,2184
00952,凱基台灣AI50,10,0,10,亞東-新竹,2024-10-09,2184
1102,亞泥,10,0,10,亞東-新竹,2024-10-09,2184
1721,三晃,10,0,10,亞東-新竹,2024-10-09,2184
1809,中釉,10,0,10,亞東-新竹,2024-10-09,2184
2491,吉祥全,10,0,10,亞東-新竹,2024-10-09,2184
2883,凱基金,10,0,10,亞東-新竹,2024-10-09,2184
4510,高鋒,18,8,10,亞東-新竹,2024-10-09,2184
4961,天鈺,10,0,10,亞東-新竹,2024-10-09,2184
8028,昇陽半導體,15,5,10,亞東-新竹,2024-10-09,2184
00915,凱基優選高股息30,9,0,9,亞東-新竹,2024-10-09,2184
2489,瑞軒,10,1,9,亞東-新竹,2024-10-09,2184
2376,技嘉,9,0,9,亞東-新竹,2024-10-09,2184
00633L,富邦上証正2,12,4,8,亞東-新竹,2024-10-09,2184
3596,智易,8,0,8,亞東-新竹,2024-10-09,2184
1609,大亞,7,0,7,亞東-新竹,2024-10-09,2184
2488,漢平,7,0,7,亞東-新竹,2024-10-09,2184
2542,興富發,7,0,7,亞東-新竹,2024-10-09,2184
2609,陽明,6,0,6,亞東-新竹,2024-10-09,2184
1536,和大,6,0,6,亞東-新竹,2024-10-09,2184
1808,潤隆,8,2,6,亞東-新竹,2024-10-09,2184
5225,東科-KY,6,0,6,亞東-新竹,2024-10-09,2184
0056,元大高股息,5,0,5,亞東-新竹,2024-10-09,2184
3380,明泰,194,0,194,亞東-新竹,2024-10-11,2184
00665L,富邦�琤肭磪囓�2,141,30,111,亞東-新竹,2024-10-11,2184
00687B,國泰20年美債,107,0,107,亞東-新竹,2024-10-11,2184
3576,聯合再生,80,0,80,亞東-新竹,2024-10-11,2184
00940,元大台灣價值高息,61,0,61,亞東-新竹,2024-10-11,2184
1402,遠東新,59,0,59,亞東-新竹,2024-10-11,2184
00637L,元大滬深300正2,172,113,59,亞東-新竹,2024-10-11,2184
2449,京元電子,56,11,45,亞東-新竹,2024-10-11,2184
2388,威盛,44,1,43,亞東-新竹,2024-10-11,2184
00679B,元大美債20年,41,0,41,亞東-新竹,2024-10-11,2184
00751B,元大AAA至A公司債,39,0,39,亞東-新竹,2024-10-11,2184
1721,三晃,36,0,36,亞東-新竹,2024-10-11,2184
6770,力積電,36,1,35,亞東-新竹,2024-10-11,2184
0056,元大高股息,33,0,33,亞東-新竹,2024-10-11,2184
00688L,國泰20年美債正2,30,0,30,亞東-新竹,2024-10-11,2184
9921,巨大,27,0,27,亞東-新竹,2024-10-11,2184
2867,三商壽,25,0,25,亞東-新竹,2024-10-11,2184
2344,華邦電,25,0,25,亞東-新竹,2024-10-11,2184
3149,正達,18,4,14,亞東-新竹,2024-10-11,2184
2382,廣達,18,4,14,亞東-新竹,2024-10-11,2184
00633L,富邦上証正2,13,1,12,亞東-新竹,2024-10-11,2184
00937B,群益ESG投等債20,14,2,12,亞東-新竹,2024-10-11,2184
2887,台新金,11,0,11,亞東-新竹,2024-10-11,2184
6220,岳豐,11,0,11,亞東-新竹,2024-10-11,2184
00922,國泰台灣領袖50,10,0,10,亞東-新竹,2024-10-11,2184
1609,大亞,10,0,10,亞東-新竹,2024-10-11,2184
2402,毅嘉,10,0,10,亞東-新竹,2024-10-11,2184
3037,欣興,9,0,9,亞東-新竹,2024-10-11,2184
3430,奇鈦科,16,7,9,亞東-新竹,2024-10-11,2184
3550,聯穎,44,35,9,亞東-新竹,2024-10-11,2184
00931B,統一美債20年,8,0,8,亞東-新竹,2024-10-11,2184
00915,凱基優選高股息30,7,0,7,亞東-新竹,2024-10-11,2184
2409,友達,7,0,7,亞東-新竹,2024-10-11,2184
4908,前鼎,7,0,7,亞東-新竹,2024-10-11,2184
00753L,中信中國50正2,6,0,6,亞東-新竹,2024-10-11,2184
00639,富邦深100,6,0,6,亞東-新竹,2024-10-11,2184
1301,台塑,6,0,6,亞東-新竹,2024-10-11,2184
3048,益登,6,0,6,亞東-新竹,2024-10-11,2184
4551,智伸科,6,0,6,亞東-新竹,2024-10-11,2184
6546,正基,5,0,5,亞東-新竹,2024-10-11,2184
5871,中租-KY,5,0,5,亞東-新竹,2024-10-11,2184
1584,精剛,5,0,5,亞東-新竹,2024-10-11,2184
2027,大成鋼,5,0,5,亞東-新竹,2024-10-11,2184
3189,景碩,10,5,5,亞東-新竹,2024-10-11,2184
5272,笙科,5,0,5,亞東-新竹,2024-10-11,2184
5483,中美晶,5,0,5,亞東-新竹,2024-10-11,2184
8111,立��,5,0,5,亞東-新竹,2024-10-11,2184
1808,潤隆,6,2,4,亞東-新竹,2024-10-11,2184
4128,中天,4,0,4,亞東-新竹,2024-10-11,2184
4958,臻鼎-KY,4,0,4,亞東-新竹,2024-10-11,2184
00687B,國泰20年美債,600,0,600,亞東-新竹,2024-10-14,2184
3380,明泰,116,0,116,亞東-新竹,2024-10-14,2184
00887,永豐中國科技50大,72,0,72,亞東-新竹,2024-10-14,2184
00751B,元大AAA至A公司債,72,0,72,亞東-新竹,2024-10-14,2184
00943,兆豐電子高息等權,70,3,67,亞東-新竹,2024-10-14,2184
00679B,元大美債20年,64,0,64,亞東-新竹,2024-10-14,2184
00632R,元大台灣50反1,60,0,60,亞東-新竹,2024-10-14,2184
00680L,元大美債20正2,54,0,54,亞東-新竹,2024-10-14,2184
00655L,國泰中國A50正2,40,0,40,亞東-新竹,2024-10-14,2184
00937B,群益ESG投等債20,35,0,35,亞東-新竹,2024-10-14,2184
00688L,國泰20年美債正2,31,0,31,亞東-新竹,2024-10-14,2184
00693U,期街口S＆P黃豆,30,0,30,亞東-新竹,2024-10-14,2184
00637L,元大滬深300正2,98,74,24,亞東-新竹,2024-10-14,2184
00636,國泰中國A50,20,0,20,亞東-新竹,2024-10-14,2184
006205,富邦上証,20,0,20,亞東-新竹,2024-10-14,2184
00713,元大台灣高息低波,16,0,16,亞東-新竹,2024-10-14,2184
00633L,富邦上証正2,33,17,16,亞東-新竹,2024-10-14,2184
6143,振曜,15,0,15,亞東-新竹,2024-10-14,2184
2888,新光金,122,110,12,亞東-新竹,2024-10-14,2184
00795B,中信美國公債20年,11,0,11,亞東-新竹,2024-10-14,2184
1569,濱川,11,0,11,亞東-新竹,2024-10-14,2184
1717,長興,10,0,10,亞東-新竹,2024-10-14,2184
3019,亞光,10,0,10,亞東-新竹,2024-10-14,2184
00720B,元大投資級公司債,10,0,10,亞東-新竹,2024-10-14,2184
1776,展宇,10,0,10,亞東-新竹,2024-10-14,2184
3550,聯穎,16,6,10,亞東-新竹,2024-10-14,2184
2317,鴻海,20,11,9,亞東-新竹,2024-10-14,2184
8155,博智,8,0,8,亞東-新竹,2024-10-14,2184
2038,海光,7,0,7,亞東-新竹,2024-10-14,2184
00915,凱基優選高股息30,6,0,6,亞東-新竹,2024-10-14,2184
3234,光環,6,0,6,亞東-新竹,2024-10-14,2184
6739,竹陞科技,6,0,6,亞東-新竹,2024-10-14,2184
1785,光洋科,10,5,5,亞東-新竹,2024-10-14,2184
00725B,國泰投資級公司債,5,0,5,亞東-新竹,2024-10-14,2184
1735,日勝化,5,0,5,亞東-新竹,2024-10-14,2184
2449,京元電子,9,4,5,亞東-新竹,2024-10-14,2184
2801,彰銀,5,0,5,亞東-新竹,2024-10-14,2184
6147,頎邦,5,0,5,亞東-新竹,2024-10-14,2184
6216,居易,5,0,5,亞東-新竹,2024-10-14,2184
00931B,統一美債20年,4,0,4,亞東-新竹,2024-10-14,2184
00960,野村全球航運龍頭,4,0,4,亞東-新竹,2024-10-14,2184
3265,台星科,5,1,4,亞東-新竹,2024-10-14,2184
4153,鈺緯,4,0,4,亞東-新竹,2024-10-14,2184
6179,亞通,4,0,4,亞東-新竹,2024-10-14,2184
2049,上銀,4,1,3,亞東-新竹,2024-10-14,2184
4979,華星光,25,22,3,亞東-新竹,2024-10-14,2184
00905,FT臺灣Smart,3,0,3,亞東-新竹,2024-10-14,2184
00634R,富邦上証反1,3,0,3,亞東-新竹,2024-10-14,2184
0056,元大高股息,3,0,3,亞東-新竹,2024-10-14,2184
1402,遠東新,3,0,3,亞東-新竹,2024-10-14,2184
00730,富邦臺灣優質高息,314,0,314,亞東-新竹,2024-10-15,2184
00679B,元大美債20年,65,0,65,亞東-新竹,2024-10-15,2184
2618,長榮航,53,1,52,亞東-新竹,2024-10-15,2184
00720B,元大投資級公司債,50,0,50,亞東-新竹,2024-10-15,2184
00665L,富邦�琤肭磪囓�2,65,30,35,亞東-新竹,2024-10-15,2184
00687B,國泰20年美債,31,0,31,亞東-新竹,2024-10-15,2184
00887,永豐中國科技50大,23,0,23,亞東-新竹,2024-10-15,2184
1609,大亞,26,3,23,亞東-新竹,2024-10-15,2184
0056,元大高股息,22,0,22,亞東-新竹,2024-10-15,2184
2633,台灣高鐵,21,0,21,亞東-新竹,2024-10-15,2184
3380,明泰,21,0,21,亞東-新竹,2024-10-15,2184
00919,群益台灣精選高息,20,0,20,亞東-新竹,2024-10-15,2184
3664,安瑞-KY,19,0,19,亞東-新竹,2024-10-15,2184
00937B,群益ESG投等債20,18,0,18,亞東-新竹,2024-10-15,2184
3017,奇鋐,18,1,17,亞東-新竹,2024-10-15,2184
00637L,元大滬深300正2,30,18,12,亞東-新竹,2024-10-15,2184
9958,世紀鋼,12,0,12,亞東-新竹,2024-10-15,2184
2405,輔信,12,0,12,亞東-新竹,2024-10-15,2184
6451,訊芯-KY,11,0,11,亞東-新竹,2024-10-15,2184
2388,威盛,12,1,11,亞東-新竹,2024-10-15,2184
00655L,國泰中國A50正2,10,0,10,亞東-新竹,2024-10-15,2184
00795B,中信美國公債20年,10,0,10,亞東-新竹,2024-10-15,2184
2030,彰源,10,0,10,亞東-新竹,2024-10-15,2184
3037,欣興,10,0,10,亞東-新竹,2024-10-15,2184
5014,建錩,20,10,10,亞東-新竹,2024-10-15,2184
9921,巨大,10,0,10,亞東-新竹,2024-10-15,2184
00960,野村全球航運龍頭,9,0,9,亞東-新竹,2024-10-15,2184
6462,神盾,14,5,9,亞東-新竹,2024-10-15,2184
1314,中石化,8,0,8,亞東-新竹,2024-10-15,2184
2241,艾姆勒,14,6,8,亞東-新竹,2024-10-15,2184
3013,晟銘電,9,1,8,亞東-新竹,2024-10-15,2184
1802,台玻,7,0,7,亞東-新竹,2024-10-15,2184
5225,東科-KY,7,0,7,亞東-新竹,2024-10-15,2184
5483,中美晶,7,0,7,亞東-新竹,2024-10-15,2184
4967,十銓,6,0,6,亞東-新竹,2024-10-15,2184
3162,精確,6,0,6,亞東-新竹,2024-10-15,2184
8039,台虹,6,0,6,亞東-新竹,2024-10-15,2184
9914,美利達,5,0,5,亞東-新竹,2024-10-15,2184
00878,國泰永續高股息,7,2,5,亞東-新竹,2024-10-15,2184
00715L,期街口布蘭特正2,10,5,5,亞東-新竹,2024-10-15,2184
1321,大洋,5,0,5,亞東-新竹,2024-10-15,2184
2368,金像電,5,0,5,亞東-新竹,2024-10-15,2184
2497,怡利電,5,0,5,亞東-新竹,2024-10-15,2184
3622,洋華,5,0,5,亞東-新竹,2024-10-15,2184
8032,光菱,5,0,5,亞東-新竹,2024-10-15,2184
9927,泰銘,5,0,5,亞東-新竹,2024-10-15,2184
00633L,富邦上証正2,34,30,4,亞東-新竹,2024-10-15,2184
00881,國泰台灣5G+,5,1,4,亞東-新竹,2024-10-15,2184
1536,和大,12,8,4,亞東-新竹,2024-10-15,2184
2359,所羅門,14,10,4,亞東-新竹,2024-10-15,2184
00679B,元大美債20年,59,0,59,亞東-新竹,2024-10-16,2184
6770,力積電,51,0,51,亞東-新竹,2024-10-16,2184
2344,華邦電,38,0,38,亞東-新竹,2024-10-16,2184
00931B,統一美債20年,40,5,35,亞東-新竹,2024-10-16,2184
00680L,元大美債20正2,35,0,35,亞東-新竹,2024-10-16,2184
00857B,永豐20年美公債,33,0,33,亞東-新竹,2024-10-16,2184
2337,旺宏,30,0,30,亞東-新竹,2024-10-16,2184
4919,新唐,30,0,30,亞東-新竹,2024-10-16,2184
2888,新光金,26,0,26,亞東-新竹,2024-10-16,2184
2881,富邦金,22,0,22,亞東-新竹,2024-10-16,2184
1569,濱川,21,0,21,亞東-新竹,2024-10-16,2184
3209,全科,25,4,21,亞東-新竹,2024-10-16,2184
3591,艾笛森,20,0,20,亞東-新竹,2024-10-16,2184
2426,鼎元,22,2,20,亞東-新竹,2024-10-16,2184
3037,欣興,17,1,16,亞東-新竹,2024-10-16,2184
3290,東浦,18,3,15,亞東-新竹,2024-10-16,2184
5388,中磊,15,0,15,亞東-新竹,2024-10-16,2184
1102,亞泥,14,0,14,亞東-新竹,2024-10-16,2184
00830,國泰費城半導體,13,0,13,亞東-新竹,2024-10-16,2184
2882,國泰金,13,0,13,亞東-新竹,2024-10-16,2184
0056,元大高股息,23,12,11,亞東-新竹,2024-10-16,2184
0050,元大台灣50,11,0,11,亞東-新竹,2024-10-16,2184
1314,中石化,11,0,11,亞東-新竹,2024-10-16,2184
00751B,元大AAA至A公司債,10,0,10,亞東-新竹,2024-10-16,2184
00715L,期街口布蘭特正2,10,0,10,亞東-新竹,2024-10-16,2184
3289,宜特,10,0,10,亞東-新竹,2024-10-16,2184
4971,IET-KY,10,0,10,亞東-新竹,2024-10-16,2184
5230,雷笛克光學,10,0,10,亞東-新竹,2024-10-16,2184
6138,茂達,10,0,10,亞東-新竹,2024-10-16,2184
00923,群益台ESG低碳50,10,1,9,亞東-新竹,2024-10-16,2184
2201,裕隆,9,0,9,亞東-新竹,2024-10-16,2184
4513,福裕,9,0,9,亞東-新竹,2024-10-16,2184
2023,燁輝,8,0,8,亞東-新竹,2024-10-16,2184
00637L,元大滬深300正2,13,6,7,亞東-新竹,2024-10-16,2184
00882,中信中國高股息,7,0,7,亞東-新竹,2024-10-16,2184
00713,元大台灣高息低波,10,4,6,亞東-新竹,2024-10-16,2184
00887,永豐中國科技50大,6,0,6,亞東-新竹,2024-10-16,2184
00919,群益台灣精選高息,6,0,6,亞東-新竹,2024-10-16,2184
00960,野村全球航運龍頭,7,1,6,亞東-新竹,2024-10-16,2184
2317,鴻海,12,6,6,亞東-新竹,2024-10-16,2184
0061,元大寶滬深,5,0,5,亞東-新竹,2024-10-16,2184
1595,川寶,10,5,5,亞東-新竹,2024-10-16,2184
2412,中華電,5,0,5,亞東-新竹,2024-10-16,2184
2801,彰銀,5,0,5,亞東-新竹,2024-10-16,2184
6188,廣明,5,0,5,亞東-新竹,2024-10-16,2184
2330,台積電,10,6,4,亞東-新竹,2024-10-16,2184
4979,華星光,6,2,4,亞東-新竹,2024-10-16,2184
00937B,群益ESG投等債20,4,0,4,亞東-新竹,2024-10-16,2184
1514,亞力,4,0,4,亞東-新竹,2024-10-16,2184
2365,昆盈,14,10,4,亞東-新竹,2024-10-16,2184
00673R,期元大S＆P原油反1,200,0,200,亞東-新竹,2024-10-17,2184
9105,泰金寶-DR,130,10,120,亞東-新竹,2024-10-17,2184
00713,元大台灣高息低波,71,0,71,亞東-新竹,2024-10-17,2184
2891,中信金,60,7,53,亞東-新竹,2024-10-17,2184
1569,濱川,39,0,39,亞東-新竹,2024-10-17,2184
1711,永光,31,0,31,亞東-新竹,2024-10-17,2184
3312,弘憶股,25,0,25,亞東-新竹,2024-10-17,2184
2633,台灣高鐵,20,0,20,亞東-新竹,2024-10-17,2184
1595,川寶,23,4,19,亞東-新竹,2024-10-17,2184
00905,FT臺灣Smart,17,0,17,亞東-新竹,2024-10-17,2184
00650L,復華香港正2,15,0,15,亞東-新竹,2024-10-17,2184
00637L,元大滬深300正2,36,22,14,亞東-新竹,2024-10-17,2184
5230,雷笛克光學,14,1,13,亞東-新竹,2024-10-17,2184
4958,臻鼎-KY,16,4,12,亞東-新竹,2024-10-17,2184
0056,元大高股息,11,0,11,亞東-新竹,2024-10-17,2184
4908,前鼎,10,0,10,亞東-新竹,2024-10-17,2184
5388,中磊,10,0,10,亞東-新竹,2024-10-17,2184
6151,晉倫,12,2,10,亞東-新竹,2024-10-17,2184
9921,巨大,10,0,10,亞東-新竹,2024-10-17,2184
3209,全科,9,0,9,亞東-新竹,2024-10-17,2184
4164,承業醫,17,8,9,亞東-新竹,2024-10-17,2184
4533,協易機,10,1,9,亞東-新竹,2024-10-17,2184
0050,元大台灣50,10,1,9,亞東-新竹,2024-10-17,2184
2330,台積電,13,4,9,亞東-新竹,2024-10-17,2184
3265,台星科,10,2,8,亞東-新竹,2024-10-17,2184
00687B,國泰20年美債,7,0,7,亞東-新竹,2024-10-17,2184
2482,連宇,7,0,7,亞東-新竹,2024-10-17,2184
5225,東科-KY,7,0,7,亞東-新竹,2024-10-17,2184
8021,尖點,7,0,7,亞東-新竹,2024-10-17,2184
2845,遠東銀,6,0,6,亞東-新竹,2024-10-17,2184
00633L,富邦上証正2,81,75,6,亞東-新竹,2024-10-17,2184
2388,威盛,7,1,6,亞東-新竹,2024-10-17,2184
2431,聯昌,6,0,6,亞東-新竹,2024-10-17,2184
3580,友威科,6,0,6,亞東-新竹,2024-10-17,2184
6698,旭暉應材,6,0,6,亞東-新竹,2024-10-17,2184
2379,瑞昱,5,0,5,亞東-新竹,2024-10-17,2184
2303,聯電,14,9,5,亞東-新竹,2024-10-17,2184
00715L,期街口布蘭特正2,5,0,5,亞東-新竹,2024-10-17,2184
00795B,中信美國公債20年,35,30,5,亞東-新竹,2024-10-17,2184
1527,鑽全,5,0,5,亞東-新竹,2024-10-17,2184
2363,矽統,17,12,5,亞東-新竹,2024-10-17,2184
6658,聯策,8,3,5,亞東-新竹,2024-10-17,2184
6670,復盛應用,5,0,5,亞東-新竹,2024-10-17,2184
8374,羅昇,9,4,5,亞東-新竹,2024-10-17,2184
00887,永豐中國科技50大,4,0,4,亞東-新竹,2024-10-17,2184
006205,富邦上証,4,0,4,亞東-新竹,2024-10-17,2184
2359,所羅門,18,14,4,亞東-新竹,2024-10-17,2184
3550,聯穎,4,0,4,亞東-新竹,2024-10-17,2184
3710,連展投控,4,0,4,亞東-新竹,2024-10-17,2184
6206,飛捷,4,0,4,亞東-新竹,2024-10-17,2184
00937B,群益ESG投等債20,176,13,163,亞東-新竹,2024-10-18,2184
00751B,元大AAA至A公司債,140,0,140,亞東-新竹,2024-10-18,2184
00679B,元大美債20年,139,0,139,亞東-新竹,2024-10-18,2184
00632R,元大台灣50反1,100,0,100,亞東-新竹,2024-10-18,2184
00959B,大華投等美債15Y+,100,0,100,亞東-新竹,2024-10-18,2184
00680L,元大美債20正2,69,0,69,亞東-新竹,2024-10-18,2184
2303,聯電,74,10,64,亞東-新竹,2024-10-18,2184
00687B,國泰20年美債,54,0,54,亞東-新竹,2024-10-18,2184
3481,群創,62,16,46,亞東-新竹,2024-10-18,2184
2312,金寶,42,3,39,亞東-新竹,2024-10-18,2184
9945,潤泰新,41,10,31,亞東-新竹,2024-10-18,2184
00688L,國泰20年美債正2,30,0,30,亞東-新竹,2024-10-18,2184
2633,台灣高鐵,40,10,30,亞東-新竹,2024-10-18,2184
00795B,中信美國公債20年,28,0,28,亞東-新竹,2024-10-18,2184
2867,三商壽,25,0,25,亞東-新竹,2024-10-18,2184
2603,長榮,21,0,21,亞東-新竹,2024-10-18,2184
2344,華邦電,30,10,20,亞東-新竹,2024-10-18,2184
00940,元大台灣價值高息,30,12,18,亞東-新竹,2024-10-18,2184
2301,光寶科,19,1,18,亞東-新竹,2024-10-18,2184
00931B,統一美債20年,17,0,17,亞東-新竹,2024-10-18,2184
4958,臻鼎-KY,16,0,16,亞東-新竹,2024-10-18,2184
2399,映泰,23,8,15,亞東-新竹,2024-10-18,2184
3209,全科,20,6,14,亞東-新竹,2024-10-18,2184
00637L,元大滬深300正2,25,13,12,亞東-新竹,2024-10-18,2184
2201,裕隆,12,0,12,亞東-新竹,2024-10-18,2184
0056,元大高股息,36,25,11,亞東-新竹,2024-10-18,2184
3006,晶豪科,10,0,10,亞東-新竹,2024-10-18,2184
00948B,中信優息投資級債,10,0,10,亞東-新竹,2024-10-18,2184
1312,國喬,10,0,10,亞東-新竹,2024-10-18,2184
1449,佳和,10,0,10,亞東-新竹,2024-10-18,2184
2881C,富邦金丙特,10,0,10,亞東-新竹,2024-10-18,2184
3691,碩禾,10,0,10,亞東-新竹,2024-10-18,2184
5443,均豪,16,6,10,亞東-新竹,2024-10-18,2184
00740B,富邦全球投等債,9,0,9,亞東-新竹,2024-10-18,2184
2371,大同,9,0,9,亞東-新竹,2024-10-18,2184
1785,光洋科,13,5,8,亞東-新竹,2024-10-18,2184
00753L,中信中國50正2,8,0,8,亞東-新竹,2024-10-18,2184
3380,明泰,8,0,8,亞東-新竹,2024-10-18,2184
6530,創威,9,1,8,亞東-新竹,2024-10-18,2184
8021,尖點,8,0,8,亞東-新竹,2024-10-18,2184
8033,雷虎,8,0,8,亞東-新竹,2024-10-18,2184
4164,承業醫,8,0,8,亞東-新竹,2024-10-18,2184
6234,高僑,7,0,7,亞東-新竹,2024-10-18,2184
00857B,永豐20年美公債,12,6,6,亞東-新竹,2024-10-18,2184
2374,佳能,7,1,6,亞東-新竹,2024-10-18,2184
5483,中美晶,6,0,6,亞東-新竹,2024-10-18,2184
00720B,元大投資級公司債,5,0,5,亞東-新竹,2024-10-18,2184
0061,元大寶滬深,5,0,5,亞東-新竹,2024-10-18,2184
00902,中信電池及儲能,5,0,5,亞東-新竹,2024-10-18,2184
00919,群益台灣精選高息,17,12,5,亞東-新竹,2024-10-18,2184
00937B,群益ESG投等債20,507,1,506,亞東-新竹,2024-10-21,2184
00687B,國泰20年美債,232,0,232,亞東-新竹,2024-10-21,2184
2883,凱基金,175,0,175,亞東-新竹,2024-10-21,2184
00751B,元大AAA至A公司債,81,0,81,亞東-新竹,2024-10-21,2184
00795B,中信美國公債20年,41,0,41,亞東-新竹,2024-10-21,2184
1326,台化,40,0,40,亞東-新竹,2024-10-21,2184
2881,富邦金,27,0,27,亞東-新竹,2024-10-21,2184
2882,國泰金,25,0,25,亞東-新竹,2024-10-21,2184
00650L,復華香港正2,25,0,25,亞東-新竹,2024-10-21,2184
00715L,期街口布蘭特正2,25,0,25,亞東-新竹,2024-10-21,2184
2867,三商壽,22,0,22,亞東-新竹,2024-10-21,2184
00688L,國泰20年美債正2,20,0,20,亞東-新竹,2024-10-21,2184
2313,華通,22,2,20,亞東-新竹,2024-10-21,2184
00720B,元大投資級公司債,19,0,19,亞東-新竹,2024-10-21,2184
00637L,元大滬深300正2,75,56,19,亞東-新竹,2024-10-21,2184
00929,復華台灣科技優息,19,0,19,亞東-新竹,2024-10-21,2184
00919,群益台灣精選高息,31,15,16,亞東-新竹,2024-10-21,2184
00680L,元大美債20正2,16,0,16,亞東-新竹,2024-10-21,2184
00719B,元大美債1-3,15,0,15,亞東-新竹,2024-10-21,2184
00633L,富邦上証正2,30,17,13,亞東-新竹,2024-10-21,2184
2891,中信金,13,0,13,亞東-新竹,2024-10-21,2184
2845,遠東銀,12,0,12,亞東-新竹,2024-10-21,2184
1711,永光,32,21,11,亞東-新竹,2024-10-21,2184
2482,連宇,11,0,11,亞東-新竹,2024-10-21,2184
00632R,元大台灣50反1,10,0,10,亞東-新竹,2024-10-21,2184
1102,亞泥,10,0,10,亞東-新竹,2024-10-21,2184
3027,盛達,10,0,10,亞東-新竹,2024-10-21,2184
3040,遠見,10,0,10,亞東-新竹,2024-10-21,2184
00740B,富邦全球投等債,9,0,9,亞東-新竹,2024-10-21,2184
3149,正達,16,7,9,亞東-新竹,2024-10-21,2184
00933B,國泰10Y+金融債,8,0,8,亞東-新竹,2024-10-21,2184
4908,前鼎,8,0,8,亞東-新竹,2024-10-21,2184
1569,濱川,15,8,7,亞東-新竹,2024-10-21,2184
2359,所羅門,19,12,7,亞東-新竹,2024-10-21,2184
0061,元大寶滬深,6,0,6,亞東-新竹,2024-10-21,2184
3011,今皓,6,0,6,亞東-新竹,2024-10-21,2184
3447,展達,6,0,6,亞東-新竹,2024-10-21,2184
00830,國泰費城半導體,5,0,5,亞東-新竹,2024-10-21,2184
00948B,中信優息投資級債,5,0,5,亞東-新竹,2024-10-21,2184
2402,毅嘉,5,0,5,亞東-新竹,2024-10-21,2184
4768,晶呈科技,5,0,5,亞東-新竹,2024-10-21,2184
6216,居易,5,0,5,亞東-新竹,2024-10-21,2184
2486,一詮,5,1,4,亞東-新竹,2024-10-21,2184
00895,富邦未來車,4,0,4,亞東-新竹,2024-10-21,2184
006205,富邦上証,4,0,4,亞東-新竹,2024-10-21,2184
1324,地球,4,0,4,亞東-新竹,2024-10-21,2184
3266,昇陽,4,0,4,亞東-新竹,2024-10-21,2184
4510,高鋒,10,6,4,亞東-新竹,2024-10-21,2184
4533,協易機,6,2,4,亞東-新竹,2024-10-21,2184
4123,晟德,3,0,3,亞東-新竹,2024-10-21,2184
00687B,國泰20年美債,259,100,159,亞東-新竹,2024-10-22,2184
00937B,群益ESG投等債20,102,6,96,亞東-新竹,2024-10-22,2184
2888,新光金,134,40,94,亞東-新竹,2024-10-22,2184
00751B,元大AAA至A公司債,71,0,71,亞東-新竹,2024-10-22,2184
00720B,元大投資級公司債,70,0,70,亞東-新竹,2024-10-22,2184
00680L,元大美債20正2,67,0,67,亞東-新竹,2024-10-22,2184
2344,華邦電,54,0,54,亞東-新竹,2024-10-22,2184
00679B,元大美債20年,49,0,49,亞東-新竹,2024-10-22,2184
2027,大成鋼,42,0,42,亞東-新竹,2024-10-22,2184
00959B,大華投等美債15Y+,30,0,30,亞東-新竹,2024-10-22,2184
5225,東科-KY,26,0,26,亞東-新竹,2024-10-22,2184
00725B,國泰投資級公司債,25,0,25,亞東-新竹,2024-10-22,2184
00706L,期元大S＆P日圓正2,20,0,20,亞東-新竹,2024-10-22,2184
1301,台塑,20,0,20,亞東-新竹,2024-10-22,2184
2328,廣宇,20,0,20,亞東-新竹,2024-10-22,2184
00795B,中信美國公債20年,17,0,17,亞東-新竹,2024-10-22,2184
00650L,復華香港正2,15,0,15,亞東-新竹,2024-10-22,2184
2301,光寶科,14,0,14,亞東-新竹,2024-10-22,2184
1721,三晃,13,0,13,亞東-新竹,2024-10-22,2184
6451,訊芯-KY,20,7,13,亞東-新竹,2024-10-22,2184
3380,明泰,12,0,12,亞東-新竹,2024-10-22,2184
1595,川寶,22,12,10,亞東-新竹,2024-10-22,2184
00948B,中信優息投資級債,8,0,8,亞東-新竹,2024-10-22,2184
00931B,統一美債20年,8,0,8,亞東-新竹,2024-10-22,2184
3290,東浦,8,0,8,亞東-新竹,2024-10-22,2184
5469,瀚宇博,11,3,8,亞東-新竹,2024-10-22,2184
1560,中砂,7,0,7,亞東-新竹,2024-10-22,2184
1312,國喬,7,0,7,亞東-新竹,2024-10-22,2184
6742,澤米,13,6,7,亞東-新竹,2024-10-22,2184
0050,元大台灣50,7,1,6,亞東-新竹,2024-10-22,2184
00688L,國泰20年美債正2,6,0,6,亞東-新竹,2024-10-22,2184
1326,台化,6,0,6,亞東-新竹,2024-10-22,2184
6698,旭暉應材,6,0,6,亞東-新竹,2024-10-22,2184
8027,鈦昇,13,7,6,亞東-新竹,2024-10-22,2184
8064,東捷,6,0,6,亞東-新竹,2024-10-22,2184
9935,慶豐富,6,0,6,亞東-新竹,2024-10-22,2184
00933B,國泰10Y+金融債,8,2,6,亞東-新竹,2024-10-22,2184
00632R,元大台灣50反1,5,0,5,亞東-新竹,2024-10-22,2184
1477,聚陽,5,0,5,亞東-新竹,2024-10-22,2184
2371,大同,5,0,5,亞東-新竹,2024-10-22,2184
2388,威盛,16,11,5,亞東-新竹,2024-10-22,2184
2457,飛宏,5,0,5,亞東-新竹,2024-10-22,2184
2834,臺企銀,5,0,5,亞東-新竹,2024-10-22,2184
2884,玉山金,5,0,5,亞東-新竹,2024-10-22,2184
4545,銘鈺,5,0,5,亞東-新竹,2024-10-22,2184
6142,友勁,5,0,5,亞東-新竹,2024-10-22,2184
9938,百和,5,0,5,亞東-新竹,2024-10-22,2184
1609,大亞,4,0,4,亞東-新竹,2024-10-22,2184
00958B,永豐ESG銀行債15,4,0,4,亞東-新竹,2024-10-22,2184
00929,復華台灣科技優息,4,0,4,亞東-新竹,2024-10-22,2184
00637L,元大滬深300正2,269,33,236,亞東-新竹,2024-10-23,2184
00937B,群益ESG投等債20,139,0,139,亞東-新竹,2024-10-23,2184
2891,中信金,101,0,101,亞東-新竹,2024-10-23,2184
2885,元大金,100,0,100,亞東-新竹,2024-10-23,2184
00650L,復華香港正2,65,0,65,亞東-新竹,2024-10-23,2184
00919,群益台灣精選高息,63,20,43,亞東-新竹,2024-10-23,2184
2303,聯電,48,10,38,亞東-新竹,2024-10-23,2184
00706L,期元大S＆P日圓正2,35,0,35,亞東-新竹,2024-10-23,2184
1569,濱川,25,0,25,亞東-新竹,2024-10-23,2184
00720B,元大投資級公司債,21,0,21,亞東-新竹,2024-10-23,2184
1102,亞泥,20,0,20,亞東-新竹,2024-10-23,2184
3024,憶聲,20,0,20,亞東-新竹,2024-10-23,2184
0056,元大高股息,19,0,19,亞東-新竹,2024-10-23,2184
9105,泰金寶-DR,20,2,18,亞東-新竹,2024-10-23,2184
00680L,元大美債20正2,15,0,15,亞東-新竹,2024-10-23,2184
2399,映泰,35,20,15,亞東-新竹,2024-10-23,2184
2884,玉山金,13,0,13,亞東-新竹,2024-10-23,2184
00751B,元大AAA至A公司債,12,0,12,亞東-新竹,2024-10-23,2184
4716,大立,10,0,10,亞東-新竹,2024-10-23,2184
4958,臻鼎-KY,10,0,10,亞東-新竹,2024-10-23,2184
9945,潤泰新,10,0,10,亞東-新竹,2024-10-23,2184
2834,臺企銀,9,0,9,亞東-新竹,2024-10-23,2184
00887,永豐中國科技50大,8,0,8,亞東-新竹,2024-10-23,2184
6241,易通展,8,0,8,亞東-新竹,2024-10-23,2184
8068,全達,8,0,8,亞東-新竹,2024-10-23,2184
00795B,中信美國公債20年,7,0,7,亞東-新竹,2024-10-23,2184
00857B,永豐20年美公債,7,0,7,亞東-新竹,2024-10-23,2184
1312,國喬,7,0,7,亞東-新竹,2024-10-23,2184
00878,國泰永續高股息,7,1,6,亞東-新竹,2024-10-23,2184
00713,元大台灣高息低波,6,0,6,亞東-新竹,2024-10-23,2184
00679B,元大美債20年,12,6,6,亞東-新竹,2024-10-23,2184
00918,大華優利高填息30,6,0,6,亞東-新竹,2024-10-23,2184
1466,聚隆,6,0,6,亞東-新竹,2024-10-23,2184
2352,佳世達,6,0,6,亞東-新竹,2024-10-23,2184
2371,大同,6,0,6,亞東-新竹,2024-10-23,2184
3481,群創,10,4,6,亞東-新竹,2024-10-23,2184
5488,松普,6,0,6,亞東-新竹,2024-10-23,2184
6895,宏碩系統,6,0,6,亞東-新竹,2024-10-23,2184
2542,興富發,5,0,5,亞東-新竹,2024-10-23,2184
00938,凱基優選30,5,0,5,亞東-新竹,2024-10-23,2184
2615,萬海,7,2,5,亞東-新竹,2024-10-23,2184
2845,遠東銀,5,0,5,亞東-新竹,2024-10-23,2184
3189,景碩,5,0,5,亞東-新竹,2024-10-23,2184
3202,樺晟,5,0,5,亞東-新竹,2024-10-23,2184
3564,其陽,5,0,5,亞東-新竹,2024-10-23,2184
4545,銘鈺,16,11,5,亞東-新竹,2024-10-23,2184
6285,啟��,5,0,5,亞東-新竹,2024-10-23,2184
8074,鉅橡,5,0,5,亞東-新竹,2024-10-23,2184
1524,耿鼎,5,0,5,亞東-新竹,2024-10-23,2184
2330,台積電,5,1,4,亞東-新竹,2024-10-23,2184
00753L,中信中國50正2,142,0,142,亞東-新竹,2024-10-24,2184
00680L,元大美債20正2,125,0,125,亞東-新竹,2024-10-24,2184
2344,華邦電,80,0,80,亞東-新竹,2024-10-24,2184
00948B,中信優息投資級債,50,0,50,亞東-新竹,2024-10-24,2184
6770,力積電,50,3,47,亞東-新竹,2024-10-24,2184
00919,群益台灣精選高息,56,16,40,亞東-新竹,2024-10-24,2184
00931B,統一美債20年,33,0,33,亞東-新竹,2024-10-24,2184
3024,憶聲,30,0,30,亞東-新竹,2024-10-24,2184
00937B,群益ESG投等債20,22,0,22,亞東-新竹,2024-10-24,2184
1711,永光,21,0,21,亞東-新竹,2024-10-24,2184
6451,訊芯-KY,20,0,20,亞東-新竹,2024-10-24,2184
1785,光洋科,19,1,18,亞東-新竹,2024-10-24,2184
00665L,富邦�琤肭磪囓�2,111,95,16,亞東-新竹,2024-10-24,2184
2329,華泰,16,0,16,亞東-新竹,2024-10-24,2184
3581,博磊,15,2,13,亞東-新竹,2024-10-24,2184
00795B,中信美國公債20年,12,0,12,亞東-新竹,2024-10-24,2184
2402,毅嘉,12,0,12,亞東-新竹,2024-10-24,2184
4540,全球傳動,12,0,12,亞東-新竹,2024-10-24,2184
2382,廣達,16,5,11,亞東-新竹,2024-10-24,2184
2388,威盛,18,8,10,亞東-新竹,2024-10-24,2184
1102,亞泥,10,0,10,亞東-新竹,2024-10-24,2184
00959B,大華投等美債15Y+,10,0,10,亞東-新竹,2024-10-24,2184
00951,台新日本半導體,10,0,10,亞東-新竹,2024-10-24,2184
2884,玉山金,10,0,10,亞東-新竹,2024-10-24,2184
3272,東碩,10,0,10,亞東-新竹,2024-10-24,2184
4908,前鼎,11,1,10,亞東-新竹,2024-10-24,2184
6288,聯嘉,10,0,10,亞東-新竹,2024-10-24,2184
3062,建漢,10,1,9,亞東-新竹,2024-10-24,2184
00943,兆豐電子高息等權,8,0,8,亞東-新竹,2024-10-24,2184
00918,大華優利高填息30,8,0,8,亞東-新竹,2024-10-24,2184
4164,承業醫,8,0,8,亞東-新竹,2024-10-24,2184
4303,信立,8,0,8,亞東-新竹,2024-10-24,2184
6140,訊達,8,0,8,亞東-新竹,2024-10-24,2184
6806,森崴能源,8,0,8,亞東-新竹,2024-10-24,2184
1560,中砂,11,4,7,亞東-新竹,2024-10-24,2184
00679B,元大美債20年,7,0,7,亞東-新竹,2024-10-24,2184
00688L,國泰20年美債正2,7,0,7,亞東-新竹,2024-10-24,2184
1459,聯發,7,0,7,亞東-新竹,2024-10-24,2184
00637L,元大滬深300正2,9,2,7,亞東-新竹,2024-10-24,2184
00929,復華台灣科技優息,7,0,7,亞東-新竹,2024-10-24,2184
3189,景碩,21,15,6,亞東-新竹,2024-10-24,2184
2891,中信金,6,0,6,亞東-新竹,2024-10-24,2184
3035,智原,6,0,6,亞東-新竹,2024-10-24,2184
00933B,國泰10Y+金融債,6,0,6,亞東-新竹,2024-10-24,2184
00687B,國泰20年美債,6,0,6,亞東-新竹,2024-10-24,2184
1609,大亞,6,0,6,亞東-新竹,2024-10-24,2184
2882,國泰金,7,1,6,亞東-新竹,2024-10-24,2184
3163,波若威,6,0,6,亞東-新竹,2024-10-24,2184
8074,鉅橡,6,0,6,亞東-新竹,2024-10-24,2184
2363,矽統,8,2,6,亞東-新竹,2024-10-24,2184
00687B,國泰20年美債,63,0,63,亞東-新竹,2024-10-25,2184
2610,華航,45,15,30,亞東-新竹,2024-10-25,2184
00795B,中信美國公債20年,26,0,26,亞東-新竹,2024-10-25,2184
2477,美隆電,25,1,24,亞東-新竹,2024-10-25,2184
2344,華邦電,24,3,21,亞東-新竹,2024-10-25,2184
2412,中華電,21,0,21,亞東-新竹,2024-10-25,2184
4123,晟德,20,0,20,亞東-新竹,2024-10-25,2184
2303,聯電,18,0,18,亞東-新竹,2024-10-25,2184
00937B,群益ESG投等債20,17,0,17,亞東-新竹,2024-10-25,2184
00712,復華富時不動產,14,0,14,亞東-新竹,2024-10-25,2184
2374,佳能,14,0,14,亞東-新竹,2024-10-25,2184
4207,環泰,14,0,14,亞東-新竹,2024-10-25,2184
00959B,大華投等美債15Y+,13,0,13,亞東-新竹,2024-10-25,2184
00919,群益台灣精選高息,13,1,12,亞東-新竹,2024-10-25,2184
00637L,元大滬深300正2,12,1,11,亞東-新竹,2024-10-25,2184
00933B,國泰10Y+金融債,10,0,10,亞東-新竹,2024-10-25,2184
2889,國票金,10,0,10,亞東-新竹,2024-10-25,2184
2891,中信金,10,0,10,亞東-新竹,2024-10-25,2184
3040,遠見,10,0,10,亞東-新竹,2024-10-25,2184
4716,大立,10,0,10,亞東-新竹,2024-10-25,2184
2884,玉山金,9,0,9,亞東-新竹,2024-10-25,2184
00713,元大台灣高息低波,9,0,9,亞東-新竹,2024-10-25,2184
6770,力積電,12,3,9,亞東-新竹,2024-10-25,2184
00887,永豐中國科技50大,10,2,8,亞東-新竹,2024-10-25,2184
3481,群創,8,0,8,亞東-新竹,2024-10-25,2184
00936,台新永續高息中小,7,0,7,亞東-新竹,2024-10-25,2184
00960,野村全球航運龍頭,7,0,7,亞東-新竹,2024-10-25,2184
00679B,元大美債20年,7,0,7,亞東-新竹,2024-10-25,2184
00725B,國泰投資級公司債,6,0,6,亞東-新竹,2024-10-25,2184
00680L,元大美債20正2,6,0,6,亞東-新竹,2024-10-25,2184
1711,永光,7,1,6,亞東-新竹,2024-10-25,2184
4540,全球傳動,6,0,6,亞東-新竹,2024-10-25,2184
2312,金寶,13,8,5,亞東-新竹,2024-10-25,2184
2369,菱生,5,0,5,亞東-新竹,2024-10-25,2184
4164,承業醫,5,0,5,亞東-新竹,2024-10-25,2184
9935,慶豐富,5,0,5,亞東-新竹,2024-10-25,2184
2405,輔信,12,8,4,亞東-新竹,2024-10-25,2184
2457,飛宏,4,0,4,亞東-新竹,2024-10-25,2184
2845,遠東銀,4,0,4,亞東-新竹,2024-10-25,2184
2867,三商壽,4,0,4,亞東-新竹,2024-10-25,2184
3062,建漢,4,0,4,亞東-新竹,2024-10-25,2184
6426,統新,4,0,4,亞東-新竹,2024-10-25,2184
6531,愛普*,5,1,4,亞東-新竹,2024-10-25,2184
2464,盟立,4,0,4,亞東-新竹,2024-10-25,2184
1312,國喬,3,0,3,亞東-新竹,2024-10-25,2184
1721,三晃,3,0,3,亞東-新竹,2024-10-25,2184
1795,美時,3,0,3,亞東-新竹,2024-10-25,2184
3024,憶聲,3,0,3,亞東-新竹,2024-10-25,2184
3535,晶彩科,3,0,3,亞東-新竹,2024-10-25,2184
3708,上緯投控,3,0,3,亞東-新竹,2024-10-25,2184
00687B,國泰20年美債,195,1,194,亞東-新竹,2024-10-28,2184
2883,凱基金,290,100,190,亞東-新竹,2024-10-28,2184
00937B,群益ESG投等債20,101,2,99,亞東-新竹,2024-10-28,2184
00715L,期街口布蘭特正2,89,0,89,亞東-新竹,2024-10-28,2184
00751B,元大AAA至A公司債,62,0,62,亞東-新竹,2024-10-28,2184
00679B,元大美債20年,51,0,51,亞東-新竹,2024-10-28,2184
00878,國泰永續高股息,45,0,45,亞東-新竹,2024-10-28,2184
00680L,元大美債20正2,39,0,39,亞東-新竹,2024-10-28,2184
2884,玉山金,26,0,26,亞東-新竹,2024-10-28,2184
00706L,期元大S＆P日圓正2,25,0,25,亞東-新竹,2024-10-28,2184
3055,蔚華科,26,1,25,亞東-新竹,2024-10-28,2184
2329,華泰,41,19,22,亞東-新竹,2024-10-28,2184
8074,鉅橡,18,1,17,亞東-新竹,2024-10-28,2184
4716,大立,16,0,16,亞東-新竹,2024-10-28,2184
6142,友勁,13,0,13,亞東-新竹,2024-10-28,2184
2303,聯電,42,30,12,亞東-新竹,2024-10-28,2184
00919,群益台灣精選高息,12,0,12,亞東-新竹,2024-10-28,2184
00720B,元大投資級公司債,11,0,11,亞東-新竹,2024-10-28,2184
00959B,大華投等美債15Y+,11,0,11,亞東-新竹,2024-10-28,2184
1514,亞力,11,0,11,亞東-新竹,2024-10-28,2184
6235,華孚,14,3,11,亞東-新竹,2024-10-28,2184
1785,光洋科,10,0,10,亞東-新竹,2024-10-28,2184
1324,地球,10,0,10,亞東-新竹,2024-10-28,2184
2801,彰銀,10,0,10,亞東-新竹,2024-10-28,2184
4109,加捷生醫,10,0,10,亞東-新竹,2024-10-28,2184
4167,松瑞藥,13,3,10,亞東-新竹,2024-10-28,2184
4545,銘鈺,10,0,10,亞東-新竹,2024-10-28,2184
6770,力積電,9,0,9,亞東-新竹,2024-10-28,2184
00795B,中信美國公債20年,9,0,9,亞東-新竹,2024-10-28,2184
2646,星宇航空,11,2,9,亞東-新竹,2024-10-28,2184
1459,聯發,8,0,8,亞東-新竹,2024-10-28,2184
3189,景碩,8,0,8,亞東-新竹,2024-10-28,2184
1609,大亞,8,1,7,亞東-新竹,2024-10-28,2184
2613,中櫃,11,4,7,亞東-新竹,2024-10-28,2184
2867,三商壽,7,0,7,亞東-新竹,2024-10-28,2184
00712,復華富時不動產,6,0,6,亞東-新竹,2024-10-28,2184
00713,元大台灣高息低波,6,0,6,亞東-新竹,2024-10-28,2184
00933B,國泰10Y+金融債,6,0,6,亞東-新竹,2024-10-28,2184
2834,臺企銀,6,0,6,亞東-新竹,2024-10-28,2184
00637L,元大滬深300正2,27,21,6,亞東-新竹,2024-10-28,2184
00929,復華台灣科技優息,5,0,5,亞東-新竹,2024-10-28,2184
1464,得力,5,0,5,亞東-新竹,2024-10-28,2184
1732,毛寶,5,0,5,亞東-新竹,2024-10-28,2184
1735,日勝化,5,0,5,亞東-新竹,2024-10-28,2184
3311,閎暉,5,0,5,亞東-新竹,2024-10-28,2184
4510,高鋒,25,20,5,亞東-新竹,2024-10-28,2184
6015,宏遠證,10,5,5,亞東-新竹,2024-10-28,2184
6206,飛捷,5,0,5,亞東-新竹,2024-10-28,2184
6757,台灣虎航,5,0,5,亞東-新竹,2024-10-28,2184
00931B,統一美債20年,4,0,4,亞東-新竹,2024-10-28,2184
2883,凱基金,272,150,122,亞東-新竹,2024-10-29,2184
00715L,期街口布蘭特正2,110,0,110,亞東-新竹,2024-10-29,2184
00687B,國泰20年美債,110,13,97,亞東-新竹,2024-10-29,2184
00688L,國泰20年美債正2,67,0,67,亞東-新竹,2024-10-29,2184
00919,群益台灣精選高息,51,2,49,亞東-新竹,2024-10-29,2184
0056,元大高股息,46,2,44,亞東-新竹,2024-10-29,2184
2303,聯電,45,3,42,亞東-新竹,2024-10-29,2184
00929,復華台灣科技優息,38,0,38,亞東-新竹,2024-10-29,2184
00878,國泰永續高股息,35,0,35,亞東-新竹,2024-10-29,2184
2312,金寶,30,0,30,亞東-新竹,2024-10-29,2184
0050,元大台灣50,15,0,15,亞東-新竹,2024-10-29,2184
00934,中信成長高股息,15,0,15,亞東-新竹,2024-10-29,2184
2399,映泰,15,0,15,亞東-新竹,2024-10-29,2184
1609,大亞,14,0,14,亞東-新竹,2024-10-29,2184
2609,陽明,14,0,14,亞東-新竹,2024-10-29,2184
8936,國統,14,0,14,亞東-新竹,2024-10-29,2184
4714,永捷,13,0,13,亞東-新竹,2024-10-29,2184
2376,技嘉,13,1,12,亞東-新竹,2024-10-29,2184
2884,玉山金,12,0,12,亞東-新竹,2024-10-29,2184
4916,事欣科,12,0,12,亞東-新竹,2024-10-29,2184
00680L,元大美債20正2,12,0,12,亞東-新竹,2024-10-29,2184
00713,元大台灣高息低波,11,0,11,亞東-新竹,2024-10-29,2184
4771,望隼,11,0,11,亞東-新竹,2024-10-29,2184
00795B,中信美國公債20年,11,0,11,亞東-新竹,2024-10-29,2184
1324,地球,11,0,11,亞東-新竹,2024-10-29,2184
6789,采鈺,10,0,10,亞東-新竹,2024-10-29,2184
006205,富邦上証,10,0,10,亞東-新竹,2024-10-29,2184
1312,國喬,10,0,10,亞東-新竹,2024-10-29,2184
1569,濱川,10,0,10,亞東-新竹,2024-10-29,2184
2409,友達,10,0,10,亞東-新竹,2024-10-29,2184
01004T,土銀富邦R2,9,0,9,亞東-新竹,2024-10-29,2184
3019,亞光,9,0,9,亞東-新竹,2024-10-29,2184
5603,陸海,9,0,9,亞東-新竹,2024-10-29,2184
1776,展宇,8,0,8,亞東-新竹,2024-10-29,2184
2613,中櫃,8,0,8,亞東-新竹,2024-10-29,2184
4716,大立,8,0,8,亞東-新竹,2024-10-29,2184
8404,百和興業-KY,8,0,8,亞東-新竹,2024-10-29,2184
2888,新光金,24,17,7,亞東-新竹,2024-10-29,2184
6191,精成科,7,0,7,亞東-新竹,2024-10-29,2184
2382,廣達,8,2,6,亞東-新竹,2024-10-29,2184
2367,燿華,6,0,6,亞東-新竹,2024-10-29,2184
4956,光鋐,6,0,6,亞東-新竹,2024-10-29,2184
3037,欣興,10,4,6,亞東-新竹,2024-10-29,2184
2618,長榮航,5,0,5,亞東-新竹,2024-10-29,2184
00631L,元大台灣50正2,20,15,5,亞東-新竹,2024-10-29,2184
3217,優群,6,1,5,亞東-新竹,2024-10-29,2184
00679B,元大美債20年,5,0,5,亞東-新竹,2024-10-29,2184
00940,元大台灣價值高息,5,0,5,亞東-新竹,2024-10-29,2184
1616,億泰,5,0,5,亞東-新竹,2024-10-29,2184
1618,合機,5,0,5,亞東-新竹,2024-10-29,2184
00688L,國泰20年美債正2,96,0,96,亞東-新竹,2024-10-30,2184
00687B,國泰20年美債,108,25,83,亞東-新竹,2024-10-30,2184
00929,復華台灣科技優息,58,0,58,亞東-新竹,2024-10-30,2184
1449,佳和,53,0,53,亞東-新竹,2024-10-30,2184
00881,國泰台灣5G+,47,0,47,亞東-新竹,2024-10-30,2184
2337,旺宏,31,0,31,亞東-新竹,2024-10-30,2184
00915,凱基優選高股息30,31,0,31,亞東-新竹,2024-10-30,2184
3037,欣興,32,1,31,亞東-新竹,2024-10-30,2184
6288,聯嘉,30,0,30,亞東-新竹,2024-10-30,2184
00919,群益台灣精選高息,23,0,23,亞東-新竹,2024-10-30,2184
2329,華泰,38,18,20,亞東-新竹,2024-10-30,2184
00940,元大台灣價值高息,17,0,17,亞東-新竹,2024-10-30,2184
2486,一詮,20,3,17,亞東-新竹,2024-10-30,2184
0056,元大高股息,14,0,14,亞東-新竹,2024-10-30,2184
1569,濱川,21,7,14,亞東-新竹,2024-10-30,2184
2646,星宇航空,13,0,13,亞東-新竹,2024-10-30,2184
4545,銘鈺,18,5,13,亞東-新竹,2024-10-30,2184
6191,精成科,12,0,12,亞東-新竹,2024-10-30,2184
1528,恩德,12,1,11,亞東-新竹,2024-10-30,2184
5438,東友,11,0,11,亞東-新竹,2024-10-30,2184
1312,國喬,10,0,10,亞東-新竹,2024-10-30,2184
00946,群益科技高息成長,10,0,10,亞東-新竹,2024-10-30,2184
2344,華邦電,10,0,10,亞東-新竹,2024-10-30,2184
2409,友達,10,0,10,亞東-新竹,2024-10-30,2184
2880,華南金,10,0,10,亞東-新竹,2024-10-30,2184
5225,東科-KY,10,0,10,亞東-新竹,2024-10-30,2184
00679B,元大美債20年,9,0,9,亞東-新竹,2024-10-30,2184
00693U,期街口S＆P黃豆,9,0,9,亞東-新竹,2024-10-30,2184
2887,台新金,7,0,7,亞東-新竹,2024-10-30,2184
6117,迎廣,8,1,7,亞東-新竹,2024-10-30,2184
00878,國泰永續高股息,7,1,6,亞東-新竹,2024-10-30,2184
00959B,大華投等美債15Y+,6,0,6,亞東-新竹,2024-10-30,2184
1603,華電,6,0,6,亞東-新竹,2024-10-30,2184
8011,台通,6,0,6,亞東-新竹,2024-10-30,2184
8043,蜜望實,6,0,6,亞東-新竹,2024-10-30,2184
9945,潤泰新,6,0,6,亞東-新竹,2024-10-30,2184
00712,復華富時不動產,6,0,6,亞東-新竹,2024-10-30,2184
00931B,統一美債20年,5,0,5,亞東-新竹,2024-10-30,2184
00887,永豐中國科技50大,5,0,5,亞東-新竹,2024-10-30,2184
1618,合機,5,0,5,亞東-新竹,2024-10-30,2184
2605,新興,5,0,5,亞東-新竹,2024-10-30,2184
3490,單井,5,0,5,亞東-新竹,2024-10-30,2184
4716,大立,5,0,5,亞東-新竹,2024-10-30,2184
5236,凌陽創新,5,0,5,亞東-新竹,2024-10-30,2184
6606,建德工業,5,0,5,亞東-新竹,2024-10-30,2184
6257,矽格,7,3,4,亞東-新竹,2024-10-30,2184
00633L,富邦上証正2,65,61,4,亞東-新竹,2024-10-30,2184
1609,大亞,4,0,4,亞東-新竹,2024-10-30,2184
1732,毛寶,4,0,4,亞東-新竹,2024-10-30,2184
2101,南港,4,0,4,亞東-新竹,2024-10-30,2184
00673R,期元大S＆P原油反1,70,0,70,亞東-新竹,2024-11-01,2184
00687B,國泰20年美債,70,5,65,亞東-新竹,2024-11-01,2184
2317,鴻海,60,6,54,亞東-新竹,2024-11-01,2184
6757,台灣虎航,50,0,50,亞東-新竹,2024-11-01,2184
2303,聯電,47,11,36,亞東-新竹,2024-11-01,2184
00929,復華台灣科技優息,41,5,36,亞東-新竹,2024-11-01,2184
00919,群益台灣精選高息,32,0,32,亞東-新竹,2024-11-01,2184
00878,國泰永續高股息,29,2,27,亞東-新竹,2024-11-01,2184
2354,鴻準,68,42,26,亞東-新竹,2024-11-01,2184
6589,台康生技,22,0,22,亞東-新竹,2024-11-01,2184
2881,富邦金,24,3,21,亞東-新竹,2024-11-01,2184
1301,台塑,20,0,20,亞東-新竹,2024-11-01,2184
00937B,群益ESG投等債20,20,0,20,亞東-新竹,2024-11-01,2184
1102,亞泥,18,0,18,亞東-新竹,2024-11-01,2184
6187,萬潤,19,1,18,亞東-新竹,2024-11-01,2184
00712,復華富時不動產,16,0,16,亞東-新竹,2024-11-01,2184
00757,統一FANG+,16,0,16,亞東-新竹,2024-11-01,2184
2308,台達電,16,0,16,亞東-新竹,2024-11-01,2184
2882,國泰金,16,0,16,亞東-新竹,2024-11-01,2184
2382,廣達,21,6,15,亞東-新竹,2024-11-01,2184
0056,元大高股息,24,10,14,亞東-新竹,2024-11-01,2184
2328,廣宇,13,0,13,亞東-新竹,2024-11-01,2184
0050,元大台灣50,23,11,12,亞東-新竹,2024-11-01,2184
00680L,元大美債20正2,11,0,11,亞東-新竹,2024-11-01,2184
00679B,元大美債20年,11,0,11,亞東-新竹,2024-11-01,2184
00887,永豐中國科技50大,10,0,10,亞東-新竹,2024-11-01,2184
2409,友達,10,0,10,亞東-新竹,2024-11-01,2184
3711,日月光投控,12,2,10,亞東-新竹,2024-11-01,2184
00830,國泰費城半導體,8,0,8,亞東-新竹,2024-11-01,2184
1815,富喬,8,0,8,亞東-新竹,2024-11-01,2184
2888,新光金,10,2,8,亞東-新竹,2024-11-01,2184
00905,FT臺灣Smart,7,0,7,亞東-新竹,2024-11-01,2184
00725B,國泰投資級公司債,7,0,7,亞東-新竹,2024-11-01,2184
00795B,中信美國公債20年,7,0,7,亞東-新竹,2024-11-01,2184
1321,大洋,7,0,7,亞東-新竹,2024-11-01,2184
4207,環泰,7,0,7,亞東-新竹,2024-11-01,2184
00692,富邦公司治理,6,0,6,亞東-新竹,2024-11-01,2184
3189,景碩,29,23,6,亞東-新竹,2024-11-01,2184
00931B,統一美債20年,5,0,5,亞東-新竹,2024-11-01,2184
1711,永光,6,1,5,亞東-新竹,2024-11-01,2184
2371,大同,5,0,5,亞東-新竹,2024-11-01,2184
2880,華南金,5,0,5,亞東-新竹,2024-11-01,2184
3545,敦泰,5,0,5,亞東-新竹,2024-11-01,2184
8028,昇陽半導體,9,4,5,亞東-新竹,2024-11-01,2184
8390,金益鼎,5,0,5,亞東-新竹,2024-11-01,2184
9921,巨大,5,0,5,亞東-新竹,2024-11-01,2184
1402,遠東新,5,0,5,亞東-新竹,2024-11-01,2184
1735,日勝化,4,0,4,亞東-新竹,2024-11-01,2184
1808,潤隆,39,35,4,亞東-新竹,2024-11-01,2184
3013,晟銘電,5,1,4,亞東-新竹,2024-11-01,2184
00712,復華富時不動產,222,0,222,亞東-新竹,2024-11-04,2184
00751B,元大AAA至A公司債,122,0,122,亞東-新竹,2024-11-04,2184
00753L,中信中國50正2,95,0,95,亞東-新竹,2024-11-04,2184
00687B,國泰20年美債,78,0,78,亞東-新竹,2024-11-04,2184
00937B,群益ESG投等債20,60,0,60,亞東-新竹,2024-11-04,2184
00943,兆豐電子高息等權,39,0,39,亞東-新竹,2024-11-04,2184
2915,潤泰全,38,0,38,亞東-新竹,2024-11-04,2184
2303,聯電,29,0,29,亞東-新竹,2024-11-04,2184
00679B,元大美債20年,27,0,27,亞東-新竹,2024-11-04,2184
2615,萬海,29,4,25,亞東-新竹,2024-11-04,2184
1312,國喬,20,0,20,亞東-新竹,2024-11-04,2184
00720B,元大投資級公司債,20,0,20,亞東-新竹,2024-11-04,2184
2409,友達,20,0,20,亞東-新竹,2024-11-04,2184
4919,新唐,16,0,16,亞東-新竹,2024-11-04,2184
6133,金橋,16,0,16,亞東-新竹,2024-11-04,2184
00795B,中信美國公債20年,15,0,15,亞東-新竹,2024-11-04,2184
2609,陽明,19,4,15,亞東-新竹,2024-11-04,2184
00881,國泰台灣5G+,14,0,14,亞東-新竹,2024-11-04,2184
00948B,中信優息投資級債,12,0,12,亞東-新竹,2024-11-04,2184
1324,地球,9,0,9,亞東-新竹,2024-11-04,2184
4716,大立,49,40,9,亞東-新竹,2024-11-04,2184
00878,國泰永續高股息,13,5,8,亞東-新竹,2024-11-04,2184
6108,競國,8,0,8,亞東-新竹,2024-11-04,2184
6197,佳必琪,7,0,7,亞東-新竹,2024-11-04,2184
00919,群益台灣精選高息,7,0,7,亞東-新竹,2024-11-04,2184
2359,所羅門,13,6,7,亞東-新竹,2024-11-04,2184
8111,立��,17,10,7,亞東-新竹,2024-11-04,2184
0056,元大高股息,8,2,6,亞東-新竹,2024-11-04,2184
2353,宏��,6,0,6,亞東-新竹,2024-11-04,2184
2646,星宇航空,7,1,6,亞東-新竹,2024-11-04,2184
2834,臺企銀,6,0,6,亞東-新竹,2024-11-04,2184
6443,元晶,6,0,6,亞東-新竹,2024-11-04,2184
00713,元大台灣高息低波,8,3,5,亞東-新竹,2024-11-04,2184
00757,統一FANG+,5,0,5,亞東-新竹,2024-11-04,2184
2431,聯昌,5,0,5,亞東-新竹,2024-11-04,2184
3189,景碩,21,16,5,亞東-新竹,2024-11-04,2184
4545,銘鈺,5,0,5,亞東-新竹,2024-11-04,2184
6116,彩晶,5,0,5,亞東-新竹,2024-11-04,2184
6425,易發,5,0,5,亞東-新竹,2024-11-04,2184
00633L,富邦上証正2,26,22,4,亞東-新竹,2024-11-04,2184
2329,華泰,16,12,4,亞東-新竹,2024-11-04,2184
4147,中裕,4,0,4,亞東-新竹,2024-11-04,2184
4510,高鋒,6,2,4,亞東-新竹,2024-11-04,2184
4938,和碩,4,0,4,亞東-新竹,2024-11-04,2184
5225,東科-KY,4,0,4,亞東-新竹,2024-11-04,2184
5508,永信建,4,0,4,亞東-新竹,2024-11-04,2184
8936,國統,4,0,4,亞東-新竹,2024-11-04,2184
1536,和大,6,3,3,亞東-新竹,2024-11-04,2184
2337,旺宏,3,0,3,亞東-新竹,2024-11-04,2184
2542,興富發,3,0,3,亞東-新竹,2024-11-04,2184
3049,精金,73,0,73,亞東-新竹,2024-11-05,2184
00650L,復華香港正2,60,0,60,亞東-新竹,2024-11-05,2184
00720B,元大投資級公司債,52,6,46,亞東-新竹,2024-11-05,2184
2303,聯電,41,0,41,亞東-新竹,2024-11-05,2184
00679B,元大美債20年,31,0,31,亞東-新竹,2024-11-05,2184
00943,兆豐電子高息等權,30,0,30,亞東-新竹,2024-11-05,2184
00706L,期元大S＆P日圓正2,25,0,25,亞東-新竹,2024-11-05,2184
2324,仁寶,27,5,22,亞東-新竹,2024-11-05,2184
00887,永豐中國科技50大,20,0,20,亞東-新竹,2024-11-05,2184
1459,聯發,18,0,18,亞東-新竹,2024-11-05,2184
2504,國產,17,0,17,亞東-新竹,2024-11-05,2184
9904,寶成,25,10,15,亞東-新竹,2024-11-05,2184
00680L,元大美債20正2,12,0,12,亞東-新竹,2024-11-05,2184
1449,佳和,11,0,11,亞東-新竹,2024-11-05,2184
00919,群益台灣精選高息,10,0,10,亞東-新竹,2024-11-05,2184
00795B,中信美國公債20年,10,0,10,亞東-新竹,2024-11-05,2184
2887,台新金,10,0,10,亞東-新竹,2024-11-05,2184
3580,友威科,11,1,10,亞東-新竹,2024-11-05,2184
2328,廣宇,8,0,8,亞東-新竹,2024-11-05,2184
6505,台塑化,8,0,8,亞東-新竹,2024-11-05,2184
8112,至上,8,0,8,亞東-新竹,2024-11-05,2184
00878,國泰永續高股息,7,0,7,亞東-新竹,2024-11-05,2184
00937B,群益ESG投等債20,10,3,7,亞東-新竹,2024-11-05,2184
1303,南亞,8,1,7,亞東-新竹,2024-11-05,2184
00757,統一FANG+,6,0,6,亞東-新竹,2024-11-05,2184
2401,凌陽,6,0,6,亞東-新竹,2024-11-05,2184
00687B,國泰20年美債,11,5,6,亞東-新竹,2024-11-05,2184
00712,復華富時不動產,5,0,5,亞東-新竹,2024-11-05,2184
3324,雙鴻,5,0,5,亞東-新竹,2024-11-05,2184
1326,台化,5,0,5,亞東-新竹,2024-11-05,2184
2646,星宇航空,5,0,5,亞東-新竹,2024-11-05,2184
3289,宜特,5,0,5,亞東-新竹,2024-11-05,2184
4716,大立,5,0,5,亞東-新竹,2024-11-05,2184
4807,日成-KY,5,0,5,亞東-新竹,2024-11-05,2184
4991,環宇-KY,12,7,5,亞東-新竹,2024-11-05,2184
0056,元大高股息,8,4,4,亞東-新竹,2024-11-05,2184
00940,元大台灣價值高息,7,3,4,亞東-新竹,2024-11-05,2184
1301,台塑,4,0,4,亞東-新竹,2024-11-05,2184
2385,群光,4,0,4,亞東-新竹,2024-11-05,2184
2486,一詮,11,7,4,亞東-新竹,2024-11-05,2184
4147,中裕,4,0,4,亞東-新竹,2024-11-05,2184
4919,新唐,6,2,4,亞東-新竹,2024-11-05,2184
5469,瀚宇博,4,0,4,亞東-新竹,2024-11-05,2184
6530,創威,9,5,4,亞東-新竹,2024-11-05,2184
2845,遠東銀,5,1,4,亞東-新竹,2024-11-05,2184
2603,長榮,4,0,4,亞東-新竹,2024-11-05,2184
2354,鴻準,43,40,3,亞東-新竹,2024-11-05,2184
1597,直得,4,1,3,亞東-新竹,2024-11-05,2184
1616,億泰,3,0,3,亞東-新竹,2024-11-05,2184
2347,聯強,3,0,3,亞東-新竹,2024-11-05,2184
2615,萬海,110,4,106,亞東-新竹,2024-11-06,2184
00679B,元大美債20年,184,105,79,亞東-新竹,2024-11-06,2184
00680L,元大美債20正2,79,0,79,亞東-新竹,2024-11-06,2184
00937B,群益ESG投等債20,78,1,77,亞東-新竹,2024-11-06,2184
2883,凱基金,355,279,76,亞東-新竹,2024-11-06,2184
00687B,國泰20年美債,75,0,75,亞東-新竹,2024-11-06,2184
00706L,期元大S＆P日圓正2,70,0,70,亞東-新竹,2024-11-06,2184
00795B,中信美國公債20年,59,2,57,亞東-新竹,2024-11-06,2184
4916,事欣科,57,0,57,亞東-新竹,2024-11-06,2184
1402,遠東新,51,0,51,亞東-新竹,2024-11-06,2184
00688L,國泰20年美債正2,43,0,43,亞東-新竹,2024-11-06,2184
00720B,元大投資級公司債,87,50,37,亞東-新竹,2024-11-06,2184
00943,兆豐電子高息等權,32,0,32,亞東-新竹,2024-11-06,2184
00948B,中信優息投資級債,30,0,30,亞東-新竹,2024-11-06,2184
6288,聯嘉,35,5,30,亞東-新竹,2024-11-06,2184
2353,宏��,30,1,29,亞東-新竹,2024-11-06,2184
1449,佳和,26,1,25,亞東-新竹,2024-11-06,2184
00878,國泰永續高股息,30,7,23,亞東-新竹,2024-11-06,2184
00693U,期街口S＆P黃豆,21,0,21,亞東-新竹,2024-11-06,2184
00934,中信成長高股息,17,0,17,亞東-新竹,2024-11-06,2184
8261,富鼎,15,0,15,亞東-新竹,2024-11-06,2184
6757,台灣虎航,14,0,14,亞東-新竹,2024-11-06,2184
2312,金寶,43,30,13,亞東-新竹,2024-11-06,2184
2382,廣達,18,5,13,亞東-新竹,2024-11-06,2184
1808,潤隆,12,2,10,亞東-新竹,2024-11-06,2184
2886,兆豐金,10,0,10,亞東-新竹,2024-11-06,2184
1721,三晃,11,2,9,亞東-新竹,2024-11-06,2184
00713,元大台灣高息低波,8,0,8,亞東-新竹,2024-11-06,2184
1316,上曜,8,0,8,亞東-新竹,2024-11-06,2184
3675,德微,8,0,8,亞東-新竹,2024-11-06,2184
1324,地球,7,0,7,亞東-新竹,2024-11-06,2184
1795,美時,7,0,7,亞東-新竹,2024-11-06,2184
00915,凱基優選高股息30,6,0,6,亞東-新竹,2024-11-06,2184
2317,鴻海,10,4,6,亞東-新竹,2024-11-06,2184
00918,大華優利高填息30,6,0,6,亞東-新竹,2024-11-06,2184
4533,協易機,8,2,6,亞東-新竹,2024-11-06,2184
00830,國泰費城半導體,5,0,5,亞東-新竹,2024-11-06,2184
00665L,富邦�琤肭磪囓�2,90,85,5,亞東-新竹,2024-11-06,2184
2204,中華,5,0,5,亞東-新竹,2024-11-06,2184
4164,承業醫,5,0,5,亞東-新竹,2024-11-06,2184
4545,銘鈺,6,1,5,亞東-新竹,2024-11-06,2184
4768,晶呈科技,5,0,5,亞東-新竹,2024-11-06,2184
8054,安國,5,0,5,亞東-新竹,2024-11-06,2184
8374,羅昇,9,4,5,亞東-新竹,2024-11-06,2184
2542,興富發,5,0,5,亞東-新竹,2024-11-06,2184
1735,日勝化,4,0,4,亞東-新竹,2024-11-06,2184
2455,全新,4,0,4,亞東-新竹,2024-11-06,2184
4716,大立,4,0,4,亞東-新竹,2024-11-06,2184
5469,瀚宇博,4,0,4,亞東-新竹,2024-11-06,2184
6290,良維,4,0,4,亞東-新竹,2024-11-06,2184
00887,永豐中國科技50大,210,0,210,亞東-新竹,2024-11-07,2184
2312,金寶,65,2,63,亞東-新竹,2024-11-07,2184
00753L,中信中國50正2,60,1,59,亞東-新竹,2024-11-07,2184
00632R,元大台灣50反1,55,0,55,亞東-新竹,2024-11-07,2184
00878,國泰永續高股息,54,0,54,亞東-新竹,2024-11-07,2184
1605,華新,46,0,46,亞東-新竹,2024-11-07,2184
6757,台灣虎航,47,4,43,亞東-新竹,2024-11-07,2184
9105,泰金寶-DR,43,0,43,亞東-新竹,2024-11-07,2184
3037,欣興,40,13,27,亞東-新竹,2024-11-07,2184
5225,東科-KY,34,13,21,亞東-新竹,2024-11-07,2184
00706L,期元大S＆P日圓正2,20,0,20,亞東-新竹,2024-11-07,2184
00670L,富邦NASDAQ正2,20,0,20,亞東-新竹,2024-11-07,2184
1402,遠東新,15,0,15,亞東-新竹,2024-11-07,2184
4538,大詠城,11,0,11,亞東-新竹,2024-11-07,2184
00899,FT潔淨能源,10,0,10,亞東-新竹,2024-11-07,2184
00680L,元大美債20正2,10,0,10,亞東-新竹,2024-11-07,2184
00940,元大台灣價值高息,10,0,10,亞東-新竹,2024-11-07,2184
3591,艾笛森,10,0,10,亞東-新竹,2024-11-07,2184
6443,元晶,10,0,10,亞東-新竹,2024-11-07,2184
00679B,元大美債20年,13,4,9,亞東-新竹,2024-11-07,2184
2892,第一金,8,0,8,亞東-新竹,2024-11-07,2184
00933B,國泰10Y+金融債,8,0,8,亞東-新竹,2024-11-07,2184
2464,盟立,10,2,8,亞東-新竹,2024-11-07,2184
3189,景碩,10,2,8,亞東-新竹,2024-11-07,2184
00948B,中信優息投資級債,7,0,7,亞東-新竹,2024-11-07,2184
00919,群益台灣精選高息,6,0,6,亞東-新竹,2024-11-07,2184
1307,三芳,9,3,6,亞東-新竹,2024-11-07,2184
1324,地球,6,0,6,亞東-新竹,2024-11-07,2184
4903,聯光通,15,9,6,亞東-新竹,2024-11-07,2184
6117,迎廣,7,1,6,亞東-新竹,2024-11-07,2184
00905,FT臺灣Smart,5,0,5,亞東-新竹,2024-11-07,2184
00931B,統一美債20年,5,0,5,亞東-新竹,2024-11-07,2184
1101,台泥,5,0,5,亞東-新竹,2024-11-07,2184
2028,威致,6,1,5,亞東-新竹,2024-11-07,2184
2377,微星,5,0,5,亞東-新竹,2024-11-07,2184
4105,東洋,5,0,5,亞東-新竹,2024-11-07,2184
6197,佳必琪,5,0,5,亞東-新竹,2024-11-07,2184
6530,創威,8,3,5,亞東-新竹,2024-11-07,2184
3014,聯陽,6,1,5,亞東-新竹,2024-11-07,2184
00932,兆豐永續高息等權,4,0,4,亞東-新竹,2024-11-07,2184
00687B,國泰20年美債,4,0,4,亞東-新竹,2024-11-07,2184
1216,統一,4,0,4,亞東-新竹,2024-11-07,2184
3552,同致,4,0,4,亞東-新竹,2024-11-07,2184
5011,久陽,4,0,4,亞東-新竹,2024-11-07,2184
6285,啟��,6,2,4,亞東-新竹,2024-11-07,2184
6873,泓德能源,4,0,4,亞東-新竹,2024-11-07,2184
2887,台新金,3,0,3,亞東-新竹,2024-11-07,2184
2014,中鴻,4,1,3,亞東-新竹,2024-11-07,2184
2327,國巨,3,0,3,亞東-新竹,2024-11-07,2184
2609,陽明,3,0,3,亞東-新竹,2024-11-07,2184
6757,台灣虎航,157,0,157,亞東-新竹,2024-11-08,2184
2883,凱基金,95,3,92,亞東-新竹,2024-11-08,2184
00929,復華台灣科技優息,55,0,55,亞東-新竹,2024-11-08,2184
2886,兆豐金,50,0,50,亞東-新竹,2024-11-08,2184
00637L,元大滬深300正2,142,100,42,亞東-新竹,2024-11-08,2184
00696B,富邦美債20年,32,0,32,亞東-新竹,2024-11-08,2184
1711,永光,26,0,26,亞東-新竹,2024-11-08,2184
2399,映泰,39,13,26,亞東-新竹,2024-11-08,2184
2615,萬海,60,35,25,亞東-新竹,2024-11-08,2184
1721,三晃,24,0,24,亞東-新竹,2024-11-08,2184
00665L,富邦�琤肭磪囓�2,30,10,20,亞東-新竹,2024-11-08,2184
4716,大立,20,0,20,亞東-新竹,2024-11-08,2184
6530,創威,18,5,13,亞東-新竹,2024-11-08,2184
1402,遠東新,14,1,13,亞東-新竹,2024-11-08,2184
1459,聯發,12,0,12,亞東-新竹,2024-11-08,2184
2489,瑞軒,11,0,11,亞東-新竹,2024-11-08,2184
2312,金寶,11,0,11,亞東-新竹,2024-11-08,2184
00919,群益台灣精選高息,11,0,11,亞東-新竹,2024-11-08,2184
00921,兆豐龍頭等權重,10,0,10,亞東-新竹,2024-11-08,2184
00715L,期街口布蘭特正2,10,0,10,亞東-新竹,2024-11-08,2184
00795B,中信美國公債20年,10,0,10,亞東-新竹,2024-11-08,2184
00673R,期元大S＆P原油反1,10,0,10,亞東-新竹,2024-11-08,2184
00932,兆豐永續高息等權,10,0,10,亞東-新竹,2024-11-08,2184
2354,鴻準,28,18,10,亞東-新竹,2024-11-08,2184
6443,元晶,10,0,10,亞東-新竹,2024-11-08,2184
6532,瑞耘,11,1,10,亞東-新竹,2024-11-08,2184
9105,泰金寶-DR,10,0,10,亞東-新竹,2024-11-08,2184
6505,台塑化,9,0,9,亞東-新竹,2024-11-08,2184
1702,南僑,9,0,9,亞東-新竹,2024-11-08,2184
2303,聯電,21,12,9,亞東-新竹,2024-11-08,2184
5243,乙盛-KY,9,0,9,亞東-新竹,2024-11-08,2184
6244,茂迪,10,2,8,亞東-新竹,2024-11-08,2184
8096,擎亞,8,0,8,亞東-新竹,2024-11-08,2184
6182,合晶,17,10,7,亞東-新竹,2024-11-08,2184
6234,高僑,7,0,7,亞東-新竹,2024-11-08,2184
00636,國泰中國A50,6,0,6,亞東-新竹,2024-11-08,2184
1735,日勝化,10,4,6,亞東-新竹,2024-11-08,2184
2359,所羅門,10,4,6,亞東-新竹,2024-11-08,2184
2613,中櫃,23,17,6,亞東-新竹,2024-11-08,2184
00882,中信中國高股息,8,3,5,亞東-新竹,2024-11-08,2184
1605,華新,6,1,5,亞東-新竹,2024-11-08,2184
2884,玉山金,5,0,5,亞東-新竹,2024-11-08,2184
3005,神基,10,5,5,亞東-新竹,2024-11-08,2184
3062,建漢,6,1,5,亞東-新竹,2024-11-08,2184
3260,威剛,5,0,5,亞東-新竹,2024-11-08,2184
4147,中裕,6,1,5,亞東-新竹,2024-11-08,2184
6269,台郡,5,0,5,亞東-新竹,2024-11-08,2184
8215,明基材,5,0,5,亞東-新竹,2024-11-08,2184
2353,宏��,4,0,4,亞東-新竹,2024-11-08,2184
2834,臺企銀,5,1,4,亞東-新竹,2024-11-08,2184
1402,遠東新,87,1,86,亞東-新竹,2024-11-11,2184
00679B,元大美債20年,84,5,79,亞東-新竹,2024-11-11,2184
2885,元大金,60,0,60,亞東-新竹,2024-11-11,2184
00696B,富邦美債20年,42,0,42,亞東-新竹,2024-11-11,2184
6770,力積電,50,12,38,亞東-新竹,2024-11-11,2184
00929,復華台灣科技優息,32,10,22,亞東-新竹,2024-11-11,2184
1301,台塑,20,0,20,亞東-新竹,2024-11-11,2184
1312,國喬,19,0,19,亞東-新竹,2024-11-11,2184
2328,廣宇,18,3,15,亞東-新竹,2024-11-11,2184
6768,志強-KY,13,0,13,亞東-新竹,2024-11-11,2184
00857B,永豐20年美公債,12,0,12,亞東-新竹,2024-11-11,2184
3005,神基,12,0,12,亞東-新竹,2024-11-11,2184
2646,星宇航空,12,1,11,亞東-新竹,2024-11-11,2184
00665L,富邦�琤肭磪囓�2,215,205,10,亞東-新竹,2024-11-11,2184
00878,國泰永續高股息,15,5,10,亞東-新竹,2024-11-11,2184
00932,兆豐永續高息等權,10,0,10,亞東-新竹,2024-11-11,2184
00943,兆豐電子高息等權,10,0,10,亞東-新竹,2024-11-11,2184
00921,兆豐龍頭等權重,10,0,10,亞東-新竹,2024-11-11,2184
00688L,國泰20年美債正2,10,0,10,亞東-新竹,2024-11-11,2184
00706L,期元大S＆P日圓正2,10,0,10,亞東-新竹,2024-11-11,2184
1569,濱川,10,0,10,亞東-新竹,2024-11-11,2184
2409,友達,10,0,10,亞東-新竹,2024-11-11,2184
2882,國泰金,10,0,10,亞東-新竹,2024-11-11,2184
2354,鴻準,63,54,9,亞東-新竹,2024-11-11,2184
2337,旺宏,10,3,7,亞東-新竹,2024-11-11,2184
2460,建通,7,0,7,亞東-新竹,2024-11-11,2184
6763,綠界科技*,20,13,7,亞東-新竹,2024-11-11,2184
00795B,中信美國公債20年,6,0,6,亞東-新竹,2024-11-11,2184
1735,日勝化,6,0,6,亞東-新竹,2024-11-11,2184
3062,建漢,6,0,6,亞東-新竹,2024-11-11,2184
4979,華星光,6,0,6,亞東-新竹,2024-11-11,2184
5225,東科-KY,21,15,6,亞東-新竹,2024-11-11,2184
6509,聚和,5,0,5,亞東-新竹,2024-11-11,2184
00713,元大台灣高息低波,7,2,5,亞東-新竹,2024-11-11,2184
8936,國統,5,0,5,亞東-新竹,2024-11-11,2184
2892,第一金,4,0,4,亞東-新竹,2024-11-11,2184
6290,良維,4,0,4,亞東-新竹,2024-11-11,2184
2468,華經,4,0,4,亞東-新竹,2024-11-11,2184
4207,環泰,4,0,4,亞東-新竹,2024-11-11,2184
6177,達麗,4,0,4,亞東-新竹,2024-11-11,2184
6191,精成科,4,0,4,亞東-新竹,2024-11-11,2184
8068,全達,4,0,4,亞東-新竹,2024-11-11,2184
8996,高力,7,3,4,亞東-新竹,2024-11-11,2184
1605,華新,3,0,3,亞東-新竹,2024-11-11,2184
3529,力旺,4,1,3,亞東-新竹,2024-11-11,2184
00918,大華優利高填息30,3,0,3,亞東-新竹,2024-11-11,2184
00633L,富邦上証正2,56,53,3,亞東-新竹,2024-11-11,2184
1227,佳格,3,0,3,亞東-新竹,2024-11-11,2184
2353,宏��,3,0,3,亞東-新竹,2024-11-11,2184
2363,矽統,3,0,3,亞東-新竹,2024-11-11,2184
00665L,富邦�琤肭磪囓�2,220,155,65,亞東-新竹,2024-11-12,2184
00878,國泰永續高股息,51,0,51,亞東-新竹,2024-11-12,2184
00929,復華台灣科技優息,44,2,42,亞東-新竹,2024-11-12,2184
2888,新光金,42,5,37,亞東-新竹,2024-11-12,2184
5871,中租-KY,35,1,34,亞東-新竹,2024-11-12,2184
9105,泰金寶-DR,30,0,30,亞東-新竹,2024-11-12,2184
2409,友達,23,0,23,亞東-新竹,2024-11-12,2184
00715L,期街口布蘭特正2,20,0,20,亞東-新竹,2024-11-12,2184
00943,兆豐電子高息等權,20,0,20,亞東-新竹,2024-11-12,2184
1312,國喬,20,0,20,亞東-新竹,2024-11-12,2184
4128,中天,19,0,19,亞東-新竹,2024-11-12,2184
2892,第一金,18,0,18,亞東-新竹,2024-11-12,2184
0056,元大高股息,17,0,17,亞東-新竹,2024-11-12,2184
00764B,群益25年美債,16,1,15,亞東-新竹,2024-11-12,2184
2317,鴻海,27,13,14,亞東-新竹,2024-11-12,2184
1808,潤隆,12,0,12,亞東-新竹,2024-11-12,2184
2354,鴻準,67,56,11,亞東-新竹,2024-11-12,2184
2883,凱基金,71,60,11,亞東-新竹,2024-11-12,2184
5225,東科-KY,25,14,11,亞東-新竹,2024-11-12,2184
00915,凱基優選高股息30,10,0,10,亞東-新竹,2024-11-12,2184
2344,華邦電,20,10,10,亞東-新竹,2024-11-12,2184
00921,兆豐龍頭等權重,10,0,10,亞東-新竹,2024-11-12,2184
00932,兆豐永續高息等權,10,0,10,亞東-新竹,2024-11-12,2184
00680L,元大美債20正2,10,0,10,亞東-新竹,2024-11-12,2184
00642U,期元大S＆P石油,10,0,10,亞東-新竹,2024-11-12,2184
00946,群益科技高息成長,10,0,10,亞東-新竹,2024-11-12,2184
3189,景碩,10,0,10,亞東-新竹,2024-11-12,2184
2887,台新金,9,0,9,亞東-新竹,2024-11-12,2184
00940,元大台灣價值高息,8,0,8,亞東-新竹,2024-11-12,2184
2356,英業達,11,3,8,亞東-新竹,2024-11-12,2184
2542,興富發,8,0,8,亞東-新竹,2024-11-12,2184
2884,玉山金,8,0,8,亞東-新竹,2024-11-12,2184
00631L,元大台灣50正2,7,0,7,亞東-新竹,2024-11-12,2184
00934,中信成長高股息,7,0,7,亞東-新竹,2024-11-12,2184
0050,元大台灣50,6,0,6,亞東-新竹,2024-11-12,2184
8028,昇陽半導體,8,2,6,亞東-新竹,2024-11-12,2184
1314,中石化,5,0,5,亞東-新竹,2024-11-12,2184
00675L,富邦臺灣加權正2,5,0,5,亞東-新竹,2024-11-12,2184
2882,國泰金,5,0,5,亞東-新竹,2024-11-12,2184
1795,美時,7,2,5,亞東-新竹,2024-11-12,2184
2834,臺企銀,5,0,5,亞東-新竹,2024-11-12,2184
3105,穩懋,5,0,5,亞東-新竹,2024-11-12,2184
3323,加百裕,5,0,5,亞東-新竹,2024-11-12,2184
4952,凌通,5,0,5,亞東-新竹,2024-11-12,2184
5438,東友,5,0,5,亞東-新竹,2024-11-12,2184
8086,宏捷科,5,0,5,亞東-新竹,2024-11-12,2184
8996,高力,7,2,5,亞東-新竹,2024-11-12,2184
5236,凌陽創新,4,0,4,亞東-新竹,2024-11-12,2184
2382,廣達,8,4,4,亞東-新竹,2024-11-12,2184
00919,群益台灣精選高息,4,0,4,亞東-新竹,2024-11-12,2184
00878,國泰永續高股息,77,0,77,亞東-新竹,2024-11-13,2184
00687B,國泰20年美債,64,0,64,亞東-新竹,2024-11-13,2184
00751B,元大AAA至A公司債,63,0,63,亞東-新竹,2024-11-13,2184
1603,華電,52,0,52,亞東-新竹,2024-11-13,2184
2002,中鋼,50,0,50,亞東-新竹,2024-11-13,2184
4968,立積,43,2,41,亞東-新竹,2024-11-13,2184
2882,國泰金,36,0,36,亞東-新竹,2024-11-13,2184
5488,松普,55,20,35,亞東-新竹,2024-11-13,2184
00720B,元大投資級公司債,52,20,32,亞東-新竹,2024-11-13,2184
1714,和桐,30,0,30,亞東-新竹,2024-11-13,2184
00680L,元大美債20正2,27,0,27,亞東-新竹,2024-11-13,2184
0056,元大高股息,23,0,23,亞東-新竹,2024-11-13,2184
00795B,中信美國公債20年,23,0,23,亞東-新竹,2024-11-13,2184
00929,復華台灣科技優息,23,0,23,亞東-新竹,2024-11-13,2184
00919,群益台灣精選高息,21,0,21,亞東-新竹,2024-11-13,2184
2344,華邦電,40,20,20,亞東-新竹,2024-11-13,2184
00932,兆豐永續高息等權,20,0,20,亞東-新竹,2024-11-13,2184
00632R,元大台灣50反1,20,0,20,亞東-新竹,2024-11-13,2184
00679B,元大美債20年,20,0,20,亞東-新竹,2024-11-13,2184
3576,聯合再生,20,0,20,亞東-新竹,2024-11-13,2184
00688L,國泰20年美債正2,18,0,18,亞東-新竹,2024-11-13,2184
2915,潤泰全,48,30,18,亞東-新竹,2024-11-13,2184
2427,三商電,17,0,17,亞東-新竹,2024-11-13,2184
2303,聯電,15,0,15,亞東-新竹,2024-11-13,2184
00933B,國泰10Y+金融債,15,0,15,亞東-新竹,2024-11-13,2184
2886,兆豐金,11,0,11,亞東-新竹,2024-11-13,2184
2891,中信金,11,0,11,亞東-新竹,2024-11-13,2184
2330,台積電,11,0,11,亞東-新竹,2024-11-13,2184
00712,復華富時不動產,10,0,10,亞東-新竹,2024-11-13,2184
00664R,國泰臺灣加權反1,10,0,10,亞東-新竹,2024-11-13,2184
00921,兆豐龍頭等權重,10,0,10,亞東-新竹,2024-11-13,2184
00900,富邦特選高股息30,10,0,10,亞東-新竹,2024-11-13,2184
1324,地球,10,0,10,亞東-新竹,2024-11-13,2184
3189,景碩,24,14,10,亞東-新竹,2024-11-13,2184
00915,凱基優選高股息30,9,0,9,亞東-新竹,2024-11-13,2184
1727,中華化,16,7,9,亞東-新竹,2024-11-13,2184
00937B,群益ESG投等債20,8,0,8,亞東-新竹,2024-11-13,2184
1449,佳和,8,0,8,亞東-新竹,2024-11-13,2184
2887,台新金,8,0,8,亞東-新竹,2024-11-13,2184
00725B,國泰投資級公司債,7,0,7,亞東-新竹,2024-11-13,2184
5880,合庫金,7,0,7,亞東-新竹,2024-11-13,2184
00930,永豐ESG低碳高息,6,0,6,亞東-新竹,2024-11-13,2184
00753L,中信中國50正2,6,0,6,亞東-新竹,2024-11-13,2184
2323,中環,6,0,6,亞東-新竹,2024-11-13,2184
2359,所羅門,10,4,6,亞東-新竹,2024-11-13,2184
2392,正崴,15,9,6,亞東-新竹,2024-11-13,2184
4916,事欣科,6,0,6,亞東-新竹,2024-11-13,2184
6425,易發,6,0,6,亞東-新竹,2024-11-13,2184
2363,矽統,5,0,5,亞東-新竹,2024-11-13,2184
0050,元大台灣50,5,0,5,亞東-新竹,2024-11-13,2184
00878,國泰永續高股息,198,1,197,亞東-新竹,2024-11-14,2184
00945B,凱基美國非投等債,132,0,132,亞東-新竹,2024-11-14,2184
00937B,群益ESG投等債20,137,22,115,亞東-新竹,2024-11-14,2184
00679B,元大美債20年,55,0,55,亞東-新竹,2024-11-14,2184
00929,復華台灣科技優息,39,0,39,亞東-新竹,2024-11-14,2184
0050,元大台灣50,30,0,30,亞東-新竹,2024-11-14,2184
2349,錸德,30,0,30,亞東-新竹,2024-11-14,2184
0056,元大高股息,28,0,28,亞東-新竹,2024-11-14,2184
1301,台塑,22,0,22,亞東-新竹,2024-11-14,2184
00680L,元大美債20正2,21,0,21,亞東-新竹,2024-11-14,2184
00706L,期元大S＆P日圓正2,20,0,20,亞東-新竹,2024-11-14,2184
2317,鴻海,16,0,16,亞東-新竹,2024-11-14,2184
2303,聯電,26,10,16,亞東-新竹,2024-11-14,2184
00933B,國泰10Y+金融債,15,0,15,亞東-新竹,2024-11-14,2184
2344,華邦電,13,0,13,亞東-新竹,2024-11-14,2184
2376,技嘉,13,0,13,亞東-新竹,2024-11-14,2184
4754,國碳科,12,0,12,亞東-新竹,2024-11-14,2184
6589,台康生技,14,3,11,亞東-新竹,2024-11-14,2184
2382,廣達,17,7,10,亞東-新竹,2024-11-14,2184
1313,聯成,10,0,10,亞東-新竹,2024-11-14,2184
00688L,國泰20年美債正2,10,0,10,亞東-新竹,2024-11-14,2184
00687B,國泰20年美債,10,0,10,亞東-新竹,2024-11-14,2184
00795B,中信美國公債20年,14,4,10,亞東-新竹,2024-11-14,2184
1312,國喬,10,0,10,亞東-新竹,2024-11-14,2184
00943,兆豐電子高息等權,10,0,10,亞東-新竹,2024-11-14,2184
2409,友達,10,0,10,亞東-新竹,2024-11-14,2184
5014,建錩,10,0,10,亞東-新竹,2024-11-14,2184
2892,第一金,12,2,10,亞東-新竹,2024-11-14,2184
8069,元太,10,1,9,亞東-新竹,2024-11-14,2184
1102,亞泥,8,0,8,亞東-新竹,2024-11-14,2184
2301,光寶科,8,0,8,亞東-新竹,2024-11-14,2184
2308,台達電,8,0,8,亞東-新竹,2024-11-14,2184
2427,三商電,8,0,8,亞東-新竹,2024-11-14,2184
8028,昇陽半導體,11,3,8,亞東-新竹,2024-11-14,2184
2330,台積電,12,5,7,亞東-新竹,2024-11-14,2184
00751B,元大AAA至A公司債,7,0,7,亞東-新竹,2024-11-14,2184
6451,訊芯-KY,6,0,6,亞東-新竹,2024-11-14,2184
1785,光洋科,6,0,6,亞東-新竹,2024-11-14,2184
2392,正崴,7,1,6,亞東-新竹,2024-11-14,2184
4938,和碩,17,11,6,亞東-新竹,2024-11-14,2184
00930,永豐ESG低碳高息,5,0,5,亞東-新竹,2024-11-14,2184
00950B,凱基A級公司債,5,0,5,亞東-新竹,2024-11-14,2184
2611,志信,5,0,5,亞東-新竹,2024-11-14,2184
2883,凱基金,212,207,5,亞東-新竹,2024-11-14,2184
3062,建漢,8,3,5,亞東-新竹,2024-11-14,2184
4916,事欣科,5,0,5,亞東-新竹,2024-11-14,2184
6147,頎邦,5,0,5,亞東-新竹,2024-11-14,2184
6770,力積電,5,0,5,亞東-新竹,2024-11-14,2184
9945,潤泰新,5,0,5,亞東-新竹,2024-11-14,2184
8349,�矬�,5,0,5,亞東-新竹,2024-11-14,2184
2618,長榮航,250,6,244,亞東-新竹,2024-11-15,2184
00878,國泰永續高股息,99,0,99,亞東-新竹,2024-11-15,2184
00751B,元大AAA至A公司債,50,0,50,亞東-新竹,2024-11-15,2184
2409,友達,50,0,50,亞東-新竹,2024-11-15,2184
00937B,群益ESG投等債20,44,0,44,亞東-新竹,2024-11-15,2184
1446,宏和,20,0,20,亞東-新竹,2024-11-15,2184
2371,大同,20,0,20,亞東-新竹,2024-11-15,2184
2504,國產,20,0,20,亞東-新竹,2024-11-15,2184
9904,寶成,20,0,20,亞東-新竹,2024-11-15,2184
00706L,期元大S＆P日圓正2,15,0,15,亞東-新竹,2024-11-15,2184
2427,三商電,15,0,15,亞東-新竹,2024-11-15,2184
2609,陽明,17,5,12,亞東-新竹,2024-11-15,2184
2317,鴻海,25,13,12,亞東-新竹,2024-11-15,2184
2382,廣達,19,8,11,亞東-新竹,2024-11-15,2184
00881,國泰台灣5G+,11,0,11,亞東-新竹,2024-11-15,2184
00953B,群益優選非投等債,11,0,11,亞東-新竹,2024-11-15,2184
00933B,國泰10Y+金融債,10,0,10,亞東-新竹,2024-11-15,2184
00664R,國泰臺灣加權反1,10,0,10,亞東-新竹,2024-11-15,2184
4931,新盛力,11,1,10,亞東-新竹,2024-11-15,2184
5309,系統電,12,2,10,亞東-新竹,2024-11-15,2184
00795B,中信美國公債20年,10,2,8,亞東-新竹,2024-11-15,2184
00712,復華富時不動產,7,0,7,亞東-新竹,2024-11-15,2184
00940,元大台灣價值高息,10,3,7,亞東-新竹,2024-11-15,2184
00725B,國泰投資級公司債,6,0,6,亞東-新竹,2024-11-15,2184
2328,廣宇,24,18,6,亞東-新竹,2024-11-15,2184
3501,維熹,6,0,6,亞東-新竹,2024-11-15,2184
0056,元大高股息,5,0,5,亞東-新竹,2024-11-15,2184
5871,中租-KY,5,0,5,亞東-新竹,2024-11-15,2184
0061,元大寶滬深,5,0,5,亞東-新竹,2024-11-15,2184
1402,遠東新,5,0,5,亞東-新竹,2024-11-15,2184
1464,得力,5,0,5,亞東-新竹,2024-11-15,2184
2401,凌陽,5,0,5,亞東-新竹,2024-11-15,2184
3037,欣興,5,0,5,亞東-新竹,2024-11-15,2184
3234,光環,5,0,5,亞東-新竹,2024-11-15,2184
3338,泰碩,26,21,5,亞東-新竹,2024-11-15,2184
5014,建錩,5,0,5,亞東-新竹,2024-11-15,2184
5483,中美晶,6,1,5,亞東-新竹,2024-11-15,2184
00692,富邦公司治理,4,0,4,亞東-新竹,2024-11-15,2184
1324,地球,4,0,4,亞東-新竹,2024-11-15,2184
1584,精剛,4,0,4,亞東-新竹,2024-11-15,2184
1795,美時,4,0,4,亞東-新竹,2024-11-15,2184
3013,晟銘電,5,1,4,亞東-新竹,2024-11-15,2184
3550,聯穎,4,0,4,亞東-新竹,2024-11-15,2184
00713,元大台灣高息低波,4,0,4,亞東-新竹,2024-11-15,2184
00932,兆豐永續高息等權,3,0,3,亞東-新竹,2024-11-15,2184
1449,佳和,3,0,3,亞東-新竹,2024-11-15,2184
3006,晶豪科,4,1,3,亞東-新竹,2024-11-15,2184
6288,聯嘉,3,0,3,亞東-新竹,2024-11-15,2184
6509,聚和,3,0,3,亞東-新竹,2024-11-15,2184
8070,長華*,3,0,3,亞東-新竹,2024-11-15,2184
2618,長榮航,189,19,170,亞東-新竹,2024-11-18,2184
00878,國泰永續高股息,78,0,78,亞東-新竹,2024-11-18,2184
2401,凌陽,50,0,50,亞東-新竹,2024-11-18,2184
2881,富邦金,48,0,48,亞東-新竹,2024-11-18,2184
1504,東元,38,0,38,亞東-新竹,2024-11-18,2184
9904,寶成,30,0,30,亞東-新竹,2024-11-18,2184
00929,復華台灣科技優息,23,2,21,亞東-新竹,2024-11-18,2184
2312,金寶,55,35,20,亞東-新竹,2024-11-18,2184
6163,華電網,20,0,20,亞東-新竹,2024-11-18,2184
2609,陽明,20,0,20,亞東-新竹,2024-11-18,2184
00891,中信關鍵半導體,19,0,19,亞東-新竹,2024-11-18,2184
1319,東陽,18,0,18,亞東-新竹,2024-11-18,2184
9105,泰金寶-DR,35,18,17,亞東-新竹,2024-11-18,2184
00943,兆豐電子高息等權,16,0,16,亞東-新竹,2024-11-18,2184
2354,鴻準,83,67,16,亞東-新竹,2024-11-18,2184
00715L,期街口布蘭特正2,15,0,15,亞東-新竹,2024-11-18,2184
00679B,元大美債20年,14,0,14,亞東-新竹,2024-11-18,2184
3062,建漢,12,0,12,亞東-新竹,2024-11-18,2184
00932,兆豐永續高息等權,20,10,10,亞東-新竹,2024-11-18,2184
00946,群益科技高息成長,10,0,10,亞東-新竹,2024-11-18,2184
00937B,群益ESG投等債20,10,0,10,亞東-新竹,2024-11-18,2184
00680L,元大美債20正2,10,0,10,亞東-新竹,2024-11-18,2184
00688L,國泰20年美債正2,10,0,10,亞東-新竹,2024-11-18,2184
2349,錸德,30,20,10,亞東-新竹,2024-11-18,2184
2409,友達,10,0,10,亞東-新竹,2024-11-18,2184
3363,上詮,9,0,9,亞東-新竹,2024-11-18,2184
3005,神基,8,0,8,亞東-新竹,2024-11-18,2184
0056,元大高股息,8,0,8,亞東-新竹,2024-11-18,2184
0050,元大台灣50,7,0,7,亞東-新竹,2024-11-18,2184
2317,鴻海,16,9,7,亞東-新竹,2024-11-18,2184
5243,乙盛-KY,6,0,6,亞東-新竹,2024-11-18,2184
6285,啟��,6,0,6,亞東-新竹,2024-11-18,2184
6425,易發,6,0,6,亞東-新竹,2024-11-18,2184
6757,台灣虎航,6,0,6,亞東-新竹,2024-11-18,2184
1785,光洋科,5,0,5,亞東-新竹,2024-11-18,2184
2101,南港,10,5,5,亞東-新竹,2024-11-18,2184
2329,華泰,6,1,5,亞東-新竹,2024-11-18,2184
2337,旺宏,5,0,5,亞東-新竹,2024-11-18,2184
2353,宏��,5,0,5,亞東-新竹,2024-11-18,2184
2359,所羅門,13,8,5,亞東-新竹,2024-11-18,2184
2880,華南金,5,0,5,亞東-新竹,2024-11-18,2184
3024,憶聲,5,0,5,亞東-新竹,2024-11-18,2184
3689,湧德,5,0,5,亞東-新竹,2024-11-18,2184
6670,復盛應用,5,0,5,亞東-新竹,2024-11-18,2184
6968,萬達寵物,5,0,5,亞東-新竹,2024-11-18,2184
8011,台通,5,0,5,亞東-新竹,2024-11-18,2184
8044,網家,9,4,5,亞東-新竹,2024-11-18,2184
3003,健和興,4,0,4,亞東-新竹,2024-11-18,2184
00665L,富邦�琤肭磪囓�2,5,1,4,亞東-新竹,2024-11-18,2184
2201,裕隆,4,0,4,亞東-新竹,2024-11-18,2184
2891,中信金,276,0,276,亞東-新竹,2024-11-19,2184
0050,元大台灣50,72,5,67,亞東-新竹,2024-11-19,2184
2353,宏��,26,0,26,亞東-新竹,2024-11-19,2184
3576,聯合再生,25,0,25,亞東-新竹,2024-11-19,2184
2330,台積電,22,1,21,亞東-新竹,2024-11-19,2184
00715L,期街口布蘭特正2,20,0,20,亞東-新竹,2024-11-19,2184
2882,國泰金,20,1,19,亞東-新竹,2024-11-19,2184
00932,兆豐永續高息等權,17,0,17,亞東-新竹,2024-11-19,2184
00881,國泰台灣5G+,15,0,15,亞東-新竹,2024-11-19,2184
00937B,群益ESG投等債20,15,0,15,亞東-新竹,2024-11-19,2184
2101,南港,20,5,15,亞東-新竹,2024-11-19,2184
2646,星宇航空,14,0,14,亞東-新竹,2024-11-19,2184
6757,台灣虎航,13,0,13,亞東-新竹,2024-11-19,2184
2382,廣達,21,9,12,亞東-新竹,2024-11-19,2184
5309,系統電,16,4,12,亞東-新竹,2024-11-19,2184
8249,菱光,19,8,11,亞東-新竹,2024-11-19,2184
00929,復華台灣科技優息,10,0,10,亞東-新竹,2024-11-19,2184
2727,王品,10,0,10,亞東-新竹,2024-11-19,2184
00713,元大台灣高息低波,10,0,10,亞東-新竹,2024-11-19,2184
00633L,富邦上証正2,9,0,9,亞東-新竹,2024-11-19,2184
2609,陽明,14,6,8,亞東-新竹,2024-11-19,2184
1102,亞泥,7,0,7,亞東-新竹,2024-11-19,2184
6246,臺龍,10,3,7,亞東-新竹,2024-11-19,2184
2388,威盛,7,1,6,亞東-新竹,2024-11-19,2184
0061,元大寶滬深,5,0,5,亞東-新竹,2024-11-19,2184
00918,大華優利高填息30,5,0,5,亞東-新竹,2024-11-19,2184
00943,兆豐電子高息等權,5,0,5,亞東-新竹,2024-11-19,2184
00852L,國泰美國道瓊正2,5,0,5,亞東-新竹,2024-11-19,2184
2427,三商電,5,0,5,亞東-新竹,2024-11-19,2184
4931,新盛力,5,0,5,亞東-新竹,2024-11-19,2184
2317,鴻海,8,4,4,亞東-新竹,2024-11-19,2184
00878,國泰永續高股息,4,0,4,亞東-新竹,2024-11-19,2184
00687B,國泰20年美債,4,0,4,亞東-新竹,2024-11-19,2184
1459,聯發,4,0,4,亞東-新竹,2024-11-19,2184
00720B,元大投資級公司債,4,0,4,亞東-新竹,2024-11-19,2184
3032,偉訓,7,3,4,亞東-新竹,2024-11-19,2184
5469,瀚宇博,4,0,4,亞東-新竹,2024-11-19,2184
1582,信錦,3,0,3,亞東-新竹,2024-11-19,2184
2392,正崴,7,4,3,亞東-新竹,2024-11-19,2184
6121,新普,3,0,3,亞東-新竹,2024-11-19,2184
8028,昇陽半導體,4,1,3,亞東-新竹,2024-11-19,2184
2903,遠百,4,2,2,亞東-新竹,2024-11-19,2184
1324,地球,2,0,2,亞東-新竹,2024-11-19,2184
00795B,中信美國公債20年,2,0,2,亞東-新竹,2024-11-19,2184
00757,統一FANG+,2,0,2,亞東-新竹,2024-11-19,2184
00740B,富邦全球投等債,2,0,2,亞東-新竹,2024-11-19,2184
00731,復華富時高息低波,2,0,2,亞東-新竹,2024-11-19,2184
00725B,國泰投資級公司債,2,0,2,亞東-新竹,2024-11-19,2184
00724B,群益投資級金融債,2,0,2,亞東-新竹,2024-11-19,2184
00690,兆豐藍籌30,2,0,2,亞東-新竹,2024-11-19,2184
2881,富邦金,85,0,85,亞東-新竹,2024-11-20,2184
00937B,群益ESG投等債20,75,0,75,亞東-新竹,2024-11-20,2184
2882,國泰金,70,5,65,亞東-新竹,2024-11-20,2184
00929,復華台灣科技優息,67,5,62,亞東-新竹,2024-11-20,2184
00915,凱基優選高股息30,30,0,30,亞東-新竹,2024-11-20,2184
00943,兆豐電子高息等權,30,0,30,亞東-新竹,2024-11-20,2184
2312,金寶,46,17,29,亞東-新竹,2024-11-20,2184
00679B,元大美債20年,27,0,27,亞東-新竹,2024-11-20,2184
00878,國泰永續高股息,26,0,26,亞東-新竹,2024-11-20,2184
2354,鴻準,94,72,22,亞東-新竹,2024-11-20,2184
00673R,期元大S＆P原油反1,20,0,20,亞東-新竹,2024-11-20,2184
00632R,元大台灣50反1,20,0,20,亞東-新竹,2024-11-20,2184
00932,兆豐永續高息等權,20,0,20,亞東-新竹,2024-11-20,2184
2353,宏��,20,0,20,亞東-新竹,2024-11-20,2184
2888,新光金,25,5,20,亞東-新竹,2024-11-20,2184
2330,台積電,12,0,12,亞東-新竹,2024-11-20,2184
2303,聯電,12,0,12,亞東-新竹,2024-11-20,2184
2609,陽明,28,17,11,亞東-新竹,2024-11-20,2184
3189,景碩,10,0,10,亞東-新竹,2024-11-20,2184
2444,兆勁,10,0,10,亞東-新竹,2024-11-20,2184
2615,萬海,34,26,8,亞東-新竹,2024-11-20,2184
4956,光鋐,9,1,8,亞東-新竹,2024-11-20,2184
3234,光環,7,0,7,亞東-新竹,2024-11-20,2184
00895,富邦未來車,6,0,6,亞東-新竹,2024-11-20,2184
00751B,元大AAA至A公司債,6,0,6,亞東-新竹,2024-11-20,2184
5243,乙盛-KY,6,0,6,亞東-新竹,2024-11-20,2184
2301,光寶科,5,0,5,亞東-新竹,2024-11-20,2184
2356,英業達,16,11,5,亞東-新竹,2024-11-20,2184
2401,凌陽,5,0,5,亞東-新竹,2024-11-20,2184
2603,長榮,6,1,5,亞東-新竹,2024-11-20,2184
3062,建漢,5,0,5,亞東-新竹,2024-11-20,2184
6670,復盛應用,5,0,5,亞東-新竹,2024-11-20,2184
0056,元大高股息,4,0,4,亞東-新竹,2024-11-20,2184
1324,地球,4,0,4,亞東-新竹,2024-11-20,2184
1808,潤隆,4,0,4,亞東-新竹,2024-11-20,2184
3323,加百裕,6,2,4,亞東-新竹,2024-11-20,2184
5225,東科-KY,4,0,4,亞東-新竹,2024-11-20,2184
6425,易發,4,0,4,亞東-新竹,2024-11-20,2184
6757,台灣虎航,34,30,4,亞東-新竹,2024-11-20,2184
00687B,國泰20年美債,4,0,4,亞東-新竹,2024-11-20,2184
2313,華通,3,0,3,亞東-新竹,2024-11-20,2184
3167,大量,4,1,3,亞東-新竹,2024-11-20,2184
3558,神準,3,0,3,亞東-新竹,2024-11-20,2184
5871,中租-KY,2,0,2,亞東-新竹,2024-11-20,2184
3450,聯鈞,6,4,2,亞東-新竹,2024-11-20,2184
00953B,群益優選非投等債,2,0,2,亞東-新竹,2024-11-20,2184
00740B,富邦全球投等債,2,0,2,亞東-新竹,2024-11-20,2184
00724B,群益投資級金融債,2,0,2,亞東-新竹,2024-11-20,2184
00692,富邦公司治理,2,0,2,亞東-新竹,2024-11-20,2184
00631L,元大台灣50正2,2,0,2,亞東-新竹,2024-11-20,2184
4931,新盛力,99,0,99,亞東-新竹,2024-11-21,2184
00751B,元大AAA至A公司債,73,0,73,亞東-新竹,2024-11-21,2184
2882,國泰金,63,0,63,亞東-新竹,2024-11-21,2184
2881,富邦金,48,0,48,亞東-新竹,2024-11-21,2184
2204,中華,55,7,48,亞東-新竹,2024-11-21,2184
2349,錸德,30,0,30,亞東-新竹,2024-11-21,2184
00937B,群益ESG投等債20,29,0,29,亞東-新竹,2024-11-21,2184
00881,國泰台灣5G+,20,0,20,亞東-新竹,2024-11-21,2184
1301,台塑,20,0,20,亞東-新竹,2024-11-21,2184
2886,兆豐金,20,0,20,亞東-新竹,2024-11-21,2184
1102,亞泥,19,0,19,亞東-新竹,2024-11-21,2184
2308,台達電,13,0,13,亞東-新竹,2024-11-21,2184
2303,聯電,12,0,12,亞東-新竹,2024-11-21,2184
0050,元大台灣50,11,0,11,亞東-新竹,2024-11-21,2184
2344,華邦電,10,0,10,亞東-新竹,2024-11-21,2184
2409,友達,10,0,10,亞東-新竹,2024-11-21,2184
3217,優群,10,0,10,亞東-新竹,2024-11-21,2184
1446,宏和,10,0,10,亞東-新竹,2024-11-21,2184
2317,鴻海,8,0,8,亞東-新竹,2024-11-21,2184
2330,台積電,7,0,7,亞東-新竹,2024-11-21,2184
4771,望隼,7,0,7,亞東-新竹,2024-11-21,2184
2609,陽明,18,11,7,亞東-新竹,2024-11-21,2184
0056,元大高股息,8,2,6,亞東-新竹,2024-11-21,2184
1459,聯發,5,0,5,亞東-新竹,2024-11-21,2184
2353,宏��,5,0,5,亞東-新竹,2024-11-21,2184
3702,大聯大,5,0,5,亞東-新竹,2024-11-21,2184
2392,正崴,4,0,4,亞東-新竹,2024-11-21,2184
4916,事欣科,4,0,4,亞東-新竹,2024-11-21,2184
1569,濱川,3,0,3,亞東-新竹,2024-11-21,2184
2027,大成鋼,3,0,3,亞東-新竹,2024-11-21,2184
2201,裕隆,9,6,3,亞東-新竹,2024-11-21,2184
2305,全友,7,4,3,亞東-新竹,2024-11-21,2184
2530,華建,3,0,3,亞東-新竹,2024-11-21,2184
2603,長榮,3,0,3,亞東-新竹,2024-11-21,2184
00631L,元大台灣50正2,2,0,2,亞東-新竹,2024-11-21,2184
006208,富邦台50,2,0,2,亞東-新竹,2024-11-21,2184
3131,弘塑,2,0,2,亞東-新竹,2024-11-21,2184
00933B,國泰10Y+金融債,2,0,2,亞東-新竹,2024-11-21,2184
1216,統一,2,0,2,亞東-新竹,2024-11-21,2184
00953B,群益優選非投等債,2,0,2,亞東-新竹,2024-11-21,2184
00679B,元大美債20年,2,0,2,亞東-新竹,2024-11-21,2184
00830,國泰費城半導體,2,0,2,亞東-新竹,2024-11-21,2184
2324,仁寶,2,0,2,亞東-新竹,2024-11-21,2184
2388,威盛,2,0,2,亞東-新竹,2024-11-21,2184
2605,新興,3,1,2,亞東-新竹,2024-11-21,2184
2731,雄獅,2,0,2,亞東-新竹,2024-11-21,2184
2884,玉山金,2,0,2,亞東-新竹,2024-11-21,2184
4952,凌通,2,0,2,亞東-新竹,2024-11-21,2184
4956,光鋐,2,0,2,亞東-新竹,2024-11-21,2184
5347,世界,2,0,2,亞東-新竹,2024-11-21,2184
00751B,元大AAA至A公司債,48,0,48,亞東-新竹,2024-11-22,2184
00953B,群益優選非投等債,33,0,33,亞東-新竹,2024-11-22,2184
9105,泰金寶-DR,63,32,31,亞東-新竹,2024-11-22,2184
3290,東浦,30,1,29,亞東-新竹,2024-11-22,2184
2867,三商壽,26,0,26,亞東-新竹,2024-11-22,2184
00929,復華台灣科技優息,26,4,22,亞東-新竹,2024-11-22,2184
4916,事欣科,22,0,22,亞東-新竹,2024-11-22,2184
5880,合庫金,21,0,21,亞東-新竹,2024-11-22,2184
3149,正達,16,0,16,亞東-新竹,2024-11-22,2184
00937B,群益ESG投等債20,15,0,15,亞東-新竹,2024-11-22,2184
3706,神達,60,46,14,亞東-新竹,2024-11-22,2184
00679B,元大美債20年,13,0,13,亞東-新竹,2024-11-22,2184
2615,萬海,17,5,12,亞東-新竹,2024-11-22,2184
00633L,富邦上証正2,73,62,11,亞東-新竹,2024-11-22,2184
00932,兆豐永續高息等權,10,0,10,亞東-新竹,2024-11-22,2184
00673R,期元大S＆P原油反1,10,0,10,亞東-新竹,2024-11-22,2184
2349,錸德,10,0,10,亞東-新竹,2024-11-22,2184
6821,聯寶,9,0,9,亞東-新竹,2024-11-22,2184
00671R,富邦NASDAQ反1,8,0,8,亞東-新竹,2024-11-22,2184
4128,中天,8,0,8,亞東-新竹,2024-11-22,2184
00878,國泰永續高股息,17,10,7,亞東-新竹,2024-11-22,2184
1324,地球,7,0,7,亞東-新竹,2024-11-22,2184
00687B,國泰20年美債,7,0,7,亞東-新竹,2024-11-22,2184
00753L,中信中國50正2,7,0,7,亞東-新竹,2024-11-22,2184
1582,信錦,7,0,7,亞東-新竹,2024-11-22,2184
2317,鴻海,9,2,7,亞東-新竹,2024-11-22,2184
2633,台灣高鐵,7,0,7,亞東-新竹,2024-11-22,2184
2882,國泰金,6,0,6,亞東-新竹,2024-11-22,2184
2609,陽明,8,2,6,亞東-新竹,2024-11-22,2184
3323,加百裕,15,9,6,亞東-新竹,2024-11-22,2184
3702,大聯大,6,0,6,亞東-新竹,2024-11-22,2184
00882,中信中國高股息,5,0,5,亞東-新竹,2024-11-22,2184
1102,亞泥,5,0,5,亞東-新竹,2024-11-22,2184
1506,正道,5,0,5,亞東-新竹,2024-11-22,2184
6589,台康生技,5,0,5,亞東-新竹,2024-11-22,2184
2834,臺企銀,5,1,4,亞東-新竹,2024-11-22,2184
2354,鴻準,45,41,4,亞東-新竹,2024-11-22,2184
4909,新復興,4,0,4,亞東-新竹,2024-11-22,2184
1449,佳和,3,0,3,亞東-新竹,2024-11-22,2184
00936,台新永續高息中小,3,0,3,亞東-新竹,2024-11-22,2184
1519,華城,3,0,3,亞東-新竹,2024-11-22,2184
1795,美時,4,1,3,亞東-新竹,2024-11-22,2184
2613,中櫃,3,0,3,亞東-新竹,2024-11-22,2184
3321,同泰,3,0,3,亞東-新竹,2024-11-22,2184
4930,燦星網,3,0,3,亞東-新竹,2024-11-22,2184
00637L,元大滬深300正2,14,11,3,亞東-新竹,2024-11-22,2184
00915,凱基優選高股息30,2,0,2,亞東-新竹,2024-11-22,2184
00912,中信臺灣智慧50,2,0,2,亞東-新竹,2024-11-22,2184
1591,駿吉-KY,2,0,2,亞東-新竹,2024-11-22,2184
1808,潤隆,6,4,2,亞東-新竹,2024-11-22,2184
2883,凱基金,100,1,99,亞東-新竹,2024-11-25,2184
00933B,國泰10Y+金融債,85,0,85,亞東-新竹,2024-11-25,2184
9105,泰金寶-DR,79,25,54,亞東-新竹,2024-11-25,2184
00919,群益台灣精選高息,49,0,49,亞東-新竹,2024-11-25,2184
8086,宏捷科,34,0,34,亞東-新竹,2024-11-25,2184
00918,大華優利高填息30,30,0,30,亞東-新竹,2024-11-25,2184
2615,萬海,41,14,27,亞東-新竹,2024-11-25,2184
2618,長榮航,26,0,26,亞東-新竹,2024-11-25,2184
00953B,群益優選非投等債,23,0,23,亞東-新竹,2024-11-25,2184
0061,元大寶滬深,20,0,20,亞東-新竹,2024-11-25,2184
1102,亞泥,20,0,20,亞東-新竹,2024-11-25,2184
2357,華碩,13,0,13,亞東-新竹,2024-11-25,2184
00937B,群益ESG投等債20,12,0,12,亞東-新竹,2024-11-25,2184
1524,耿鼎,11,0,11,亞東-新竹,2024-11-25,2184
4931,新盛力,16,5,11,亞東-新竹,2024-11-25,2184
00673R,期元大S＆P原油反1,10,0,10,亞東-新竹,2024-11-25,2184
1324,地球,10,0,10,亞東-新竹,2024-11-25,2184
1582,信錦,10,0,10,亞東-新竹,2024-11-25,2184
5871,中租-KY,10,0,10,亞東-新竹,2024-11-25,2184
9941,裕融,9,0,9,亞東-新竹,2024-11-25,2184
2344,華邦電,10,2,8,亞東-新竹,2024-11-25,2184
00940,元大台灣價值高息,12,5,7,亞東-新竹,2024-11-25,2184
2887,台新金,7,0,7,亞東-新竹,2024-11-25,2184
4968,立積,6,0,6,亞東-新竹,2024-11-25,2184
9914,美利達,6,0,6,亞東-新竹,2024-11-25,2184
2353,宏��,5,0,5,亞東-新竹,2024-11-25,2184
3105,穩懋,5,0,5,亞東-新竹,2024-11-25,2184
4538,大詠城,5,0,5,亞東-新竹,2024-11-25,2184
6425,易發,5,0,5,亞東-新竹,2024-11-25,2184
9904,寶成,5,0,5,亞東-新竹,2024-11-25,2184
00633L,富邦上証正2,103,99,4,亞東-新竹,2024-11-25,2184
2359,所羅門,10,6,4,亞東-新竹,2024-11-25,2184
3596,智易,4,0,4,亞東-新竹,2024-11-25,2184
6133,金橋,4,0,4,亞東-新竹,2024-11-25,2184
6191,精成科,4,0,4,亞東-新竹,2024-11-25,2184
6505,台塑化,4,0,4,亞東-新竹,2024-11-25,2184
8096,擎亞,8,4,4,亞東-新竹,2024-11-25,2184
2603,長榮,3,0,3,亞東-新竹,2024-11-25,2184
00852L,國泰美國道瓊正2,3,0,3,亞東-新竹,2024-11-25,2184
3043,科風,7,4,3,亞東-新竹,2024-11-25,2184
3234,光環,3,0,3,亞東-新竹,2024-11-25,2184
3558,神準,6,3,3,亞東-新竹,2024-11-25,2184
6274,台燿,3,0,3,亞東-新竹,2024-11-25,2184
00795B,中信美國公債20年,2,0,2,亞東-新竹,2024-11-25,2184
00751B,元大AAA至A公司債,2,0,2,亞東-新竹,2024-11-25,2184
1402,遠東新,2,0,2,亞東-新竹,2024-11-25,2184
1336,台翰,2,0,2,亞東-新竹,2024-11-25,2184
1101,台泥,2,0,2,亞東-新竹,2024-11-25,2184
00949,復華日本龍頭,2,0,2,亞東-新竹,2024-11-25,2184
2393,億光,2,0,2,亞東-新竹,2024-11-25,2184
00937B,群益ESG投等債20,120,0,120,亞東-新竹,2024-11-26,2184
1402,遠東新,108,0,108,亞東-新竹,2024-11-26,2184
6962,ITH-KY,43,6,37,亞東-新竹,2024-11-26,2184
2344,華邦電,30,0,30,亞東-新竹,2024-11-26,2184
4916,事欣科,25,0,25,亞東-新竹,2024-11-26,2184
2317,鴻海,26,2,24,亞東-新竹,2024-11-26,2184
0061,元大寶滬深,20,0,20,亞東-新竹,2024-11-26,2184
6288,聯嘉,20,0,20,亞東-新竹,2024-11-26,2184
2303,聯電,34,15,19,亞東-新竹,2024-11-26,2184
00731,復華富時高息低波,18,0,18,亞東-新竹,2024-11-26,2184
2887,台新金,22,4,18,亞東-新竹,2024-11-26,2184
00712,復華富時不動產,17,0,17,亞東-新竹,2024-11-26,2184
2881,富邦金,27,12,15,亞東-新竹,2024-11-26,2184
2349,錸德,14,0,14,亞東-新竹,2024-11-26,2184
2845,遠東銀,12,0,12,亞東-新竹,2024-11-26,2184
9105,泰金寶-DR,32,20,12,亞東-新竹,2024-11-26,2184
00881,國泰台灣5G+,11,0,11,亞東-新竹,2024-11-26,2184
9904,寶成,11,0,11,亞東-新竹,2024-11-26,2184
00918,大華優利高填息30,10,0,10,亞東-新竹,2024-11-26,2184
2357,華碩,10,0,10,亞東-新竹,2024-11-26,2184
3217,優群,10,0,10,亞東-新竹,2024-11-26,2184
5880,合庫金,10,0,10,亞東-新竹,2024-11-26,2184
0050,元大台灣50,8,0,8,亞東-新竹,2024-11-26,2184
2890,永豐金,8,0,8,亞東-新竹,2024-11-26,2184
4746,台耀,8,0,8,亞東-新竹,2024-11-26,2184
2330,台積電,9,1,8,亞東-新竹,2024-11-26,2184
6669,緯穎,7,0,7,亞東-新竹,2024-11-26,2184
1102,亞泥,7,0,7,亞東-新竹,2024-11-26,2184
6558,興能高,10,3,7,亞東-新竹,2024-11-26,2184
00680L,元大美債20正2,6,0,6,亞東-新竹,2024-11-26,2184
00687B,國泰20年美債,5,0,5,亞東-新竹,2024-11-26,2184
00919,群益台灣精選高息,5,0,5,亞東-新竹,2024-11-26,2184
1785,光洋科,5,0,5,亞東-新竹,2024-11-26,2184
2615,萬海,4,0,4,亞東-新竹,2024-11-26,2184
1324,地球,4,0,4,亞東-新竹,2024-11-26,2184
1569,濱川,4,0,4,亞東-新竹,2024-11-26,2184
1808,潤隆,4,0,4,亞東-新竹,2024-11-26,2184
2312,金寶,39,35,4,亞東-新竹,2024-11-26,2184
3591,艾笛森,4,0,4,亞東-新竹,2024-11-26,2184
3706,神達,30,26,4,亞東-新竹,2024-11-26,2184
00637L,元大滬深300正2,3,0,3,亞東-新竹,2024-11-26,2184
3017,奇鋐,3,0,3,亞東-新竹,2024-11-26,2184
2360,致茂,3,0,3,亞東-新竹,2024-11-26,2184
1582,信錦,3,0,3,亞東-新竹,2024-11-26,2184
2915,潤泰全,3,0,3,亞東-新竹,2024-11-26,2184
4147,中裕,5,2,3,亞東-新竹,2024-11-26,2184
6104,創惟,4,1,3,亞東-新竹,2024-11-26,2184
8054,安國,3,0,3,亞東-新竹,2024-11-26,2184
00713,元大台灣高息低波,2,0,2,亞東-新竹,2024-11-26,2184
6257,矽格,2,0,2,亞東-新竹,2024-11-26,2184
00918,大華優利高填息30,210,0,210,亞東-新竹,2024-11-27,2184
2838,聯邦銀,62,0,62,亞東-新竹,2024-11-27,2184
00878,國泰永續高股息,81,40,41,亞東-新竹,2024-11-27,2184
2882,國泰金,41,0,41,亞東-新竹,2024-11-27,2184
2317,鴻海,38,6,32,亞東-新竹,2024-11-27,2184
1402,遠東新,28,0,28,亞東-新竹,2024-11-27,2184
0056,元大高股息,18,0,18,亞東-新竹,2024-11-27,2184
00915,凱基優選高股息30,18,0,18,亞東-新竹,2024-11-27,2184
00919,群益台灣精選高息,18,0,18,亞東-新竹,2024-11-27,2184
1815,富喬,18,1,17,亞東-新竹,2024-11-27,2184
2357,華碩,13,0,13,亞東-新竹,2024-11-27,2184
1324,地球,12,0,12,亞東-新竹,2024-11-27,2184
3558,神準,11,0,11,亞東-新竹,2024-11-27,2184
4746,台耀,11,0,11,亞東-新竹,2024-11-27,2184
2344,華邦電,10,0,10,亞東-新竹,2024-11-27,2184
1717,長興,10,0,10,亞東-新竹,2024-11-27,2184
8039,台虹,10,0,10,亞東-新竹,2024-11-27,2184
9921,巨大,10,0,10,亞東-新竹,2024-11-27,2184
00713,元大台灣高息低波,10,0,10,亞東-新竹,2024-11-27,2184
0050,元大台灣50,10,0,10,亞東-新竹,2024-11-27,2184
6962,ITH-KY,13,4,9,亞東-新竹,2024-11-27,2184
00940,元大台灣價值高息,9,0,9,亞東-新竹,2024-11-27,2184
2374,佳能,17,8,9,亞東-新竹,2024-11-27,2184
2330,台積電,10,1,9,亞東-新竹,2024-11-27,2184
2888,新光金,15,7,8,亞東-新竹,2024-11-27,2184
00929,復華台灣科技優息,7,0,7,亞東-新竹,2024-11-27,2184
1102,亞泥,7,0,7,亞東-新竹,2024-11-27,2184
00905,FT臺灣Smart,7,0,7,亞東-新竹,2024-11-27,2184
2605,新興,7,0,7,亞東-新竹,2024-11-27,2184
2382,廣達,9,2,7,亞東-新竹,2024-11-27,2184
2615,萬海,8,2,6,亞東-新竹,2024-11-27,2184
2201,裕隆,6,0,6,亞東-新竹,2024-11-27,2184
3162,精確,7,1,6,亞東-新竹,2024-11-27,2184
4109,加捷生醫,6,0,6,亞東-新竹,2024-11-27,2184
5243,乙盛-KY,9,3,6,亞東-新竹,2024-11-27,2184
9105,泰金寶-DR,6,0,6,亞東-新竹,2024-11-27,2184
2204,中華,5,0,5,亞東-新竹,2024-11-27,2184
2376,技嘉,5,0,5,亞東-新竹,2024-11-27,2184
3711,日月光投控,5,0,5,亞東-新竹,2024-11-27,2184
2606,裕民,5,0,5,亞東-新竹,2024-11-27,2184
2613,中櫃,5,0,5,亞東-新竹,2024-11-27,2184
3712,永崴投控,5,0,5,亞東-新竹,2024-11-27,2184
6763,綠界科技*,9,4,5,亞東-新竹,2024-11-27,2184
2324,仁寶,4,0,4,亞東-新竹,2024-11-27,2184
3231,緯創,4,0,4,亞東-新竹,2024-11-27,2184
2809,京城銀,4,0,4,亞東-新竹,2024-11-27,2184
4562,穎漢,10,6,4,亞東-新竹,2024-11-27,2184
6191,精成科,4,0,4,亞東-新竹,2024-11-27,2184
00881,國泰台灣5G+,3,0,3,亞東-新竹,2024-11-27,2184
2356,英業達,3,0,3,亞東-新竹,2024-11-27,2184
2610,華航,100,0,100,亞東-新竹,2024-11-28,2184
2886,兆豐金,60,0,60,亞東-新竹,2024-11-28,2184
00929,復華台灣科技優息,38,0,38,亞東-新竹,2024-11-28,2184
5309,系統電,43,9,34,亞東-新竹,2024-11-28,2184
1402,遠東新,32,0,32,亞東-新竹,2024-11-28,2184
2312,金寶,35,4,31,亞東-新竹,2024-11-28,2184
6962,ITH-KY,31,1,30,亞東-新竹,2024-11-28,2184
00878,國泰永續高股息,28,0,28,亞東-新竹,2024-11-28,2184
0056,元大高股息,27,0,27,亞東-新竹,2024-11-28,2184
2303,聯電,29,4,25,亞東-新竹,2024-11-28,2184
00919,群益台灣精選高息,23,0,23,亞東-新竹,2024-11-28,2184
2888,新光金,27,5,22,亞東-新竹,2024-11-28,2184
2887,台新金,20,0,20,亞東-新竹,2024-11-28,2184
3032,偉訓,20,0,20,亞東-新竹,2024-11-28,2184
4714,永捷,22,2,20,亞東-新竹,2024-11-28,2184
2882,國泰金,14,0,14,亞東-新竹,2024-11-28,2184
00637L,元大滬深300正2,14,0,14,亞東-新竹,2024-11-28,2184
9105,泰金寶-DR,11,0,11,亞東-新竹,2024-11-28,2184
00900,富邦特選高股息30,10,0,10,亞東-新竹,2024-11-28,2184
1809,中釉,10,0,10,亞東-新竹,2024-11-28,2184
6548,長科*,10,0,10,亞東-新竹,2024-11-28,2184
5469,瀚宇博,9,0,9,亞東-新竹,2024-11-28,2184
00915,凱基優選高股息30,8,0,8,亞東-新竹,2024-11-28,2184
2317,鴻海,14,6,8,亞東-新竹,2024-11-28,2184
1802,台玻,7,0,7,亞東-新竹,2024-11-28,2184
2633,台灣高鐵,7,0,7,亞東-新竹,2024-11-28,2184
2834,臺企銀,7,0,7,亞東-新竹,2024-11-28,2184
00891,中信關鍵半導體,6,0,6,亞東-新竹,2024-11-28,2184
00648R,元大S＆P500反1,6,0,6,亞東-新竹,2024-11-28,2184
1785,光洋科,15,10,5,亞東-新竹,2024-11-28,2184
2357,華碩,5,0,5,亞東-新竹,2024-11-28,2184
2867,三商壽,5,0,5,亞東-新竹,2024-11-28,2184
5306,桂盟,5,0,5,亞東-新竹,2024-11-28,2184
8028,昇陽半導體,5,0,5,亞東-新竹,2024-11-28,2184
1513,中興電,9,5,4,亞東-新竹,2024-11-28,2184
2392,正崴,6,2,4,亞東-新竹,2024-11-28,2184
3712,永崴投控,4,0,4,亞東-新竹,2024-11-28,2184
4128,中天,6,2,4,亞東-新竹,2024-11-28,2184
4771,望隼,4,0,4,亞東-新竹,2024-11-28,2184
8032,光菱,5,1,4,亞東-新竹,2024-11-28,2184
8039,台虹,4,0,4,亞東-新竹,2024-11-28,2184
0050,元大台灣50,6,3,3,亞東-新竹,2024-11-28,2184
00631L,元大台灣50正2,3,0,3,亞東-新竹,2024-11-28,2184
1569,濱川,3,0,3,亞東-新竹,2024-11-28,2184
2027,大成鋼,3,0,3,亞東-新竹,2024-11-28,2184
2344,華邦電,3,0,3,亞東-新竹,2024-11-28,2184
3287,廣寰科,3,0,3,亞東-新竹,2024-11-28,2184
4952,凌通,4,1,3,亞東-新竹,2024-11-28,2184
8096,擎亞,4,1,3,亞東-新竹,2024-11-28,2184
8940,新天地,3,0,3,亞東-新竹,2024-11-28,2184
2882,國泰金,78,7,71,亞東-新竹,2024-11-29,2184
2542,興富發,61,0,61,亞東-新竹,2024-11-29,2184
1402,遠東新,43,3,40,亞東-新竹,2024-11-29,2184
00940,元大台灣價值高息,31,1,30,亞東-新竹,2024-11-29,2184
0056,元大高股息,28,2,26,亞東-新竹,2024-11-29,2184
00878,國泰永續高股息,23,1,22,亞東-新竹,2024-11-29,2184
00915,凱基優選高股息30,22,0,22,亞東-新竹,2024-11-29,2184
2101,南港,22,0,22,亞東-新竹,2024-11-29,2184
2303,聯電,21,0,21,亞東-新竹,2024-11-29,2184
1301,台塑,21,0,21,亞東-新竹,2024-11-29,2184
00918,大華優利高填息30,20,0,20,亞東-新竹,2024-11-29,2184
00679B,元大美債20年,20,0,20,亞東-新竹,2024-11-29,2184
4916,事欣科,20,0,20,亞東-新竹,2024-11-29,2184
5871,中租-KY,12,0,12,亞東-新竹,2024-11-29,2184
2888,新光金,16,5,11,亞東-新竹,2024-11-29,2184
5880,合庫金,11,0,11,亞東-新竹,2024-11-29,2184
00713,元大台灣高息低波,12,2,10,亞東-新竹,2024-11-29,2184
2887,台新金,10,0,10,亞東-新竹,2024-11-29,2184
2891,中信金,10,0,10,亞東-新竹,2024-11-29,2184
1795,美時,10,2,8,亞東-新竹,2024-11-29,2184
00919,群益台灣精選高息,8,0,8,亞東-新竹,2024-11-29,2184
2317,鴻海,15,8,7,亞東-新竹,2024-11-29,2184
00795B,中信美國公債20年,6,0,6,亞東-新竹,2024-11-29,2184
2312,金寶,23,17,6,亞東-新竹,2024-11-29,2184
3062,建漢,6,0,6,亞東-新竹,2024-11-29,2184
2890,永豐金,15,10,5,亞東-新竹,2024-11-29,2184
2002,中鋼,7,2,5,亞東-新竹,2024-11-29,2184
00933B,國泰10Y+金融債,5,0,5,亞東-新竹,2024-11-29,2184
2812,台中銀,5,0,5,亞東-新竹,2024-11-29,2184
2884,玉山金,5,0,5,亞東-新竹,2024-11-29,2184
4746,台耀,5,0,5,亞東-新竹,2024-11-29,2184
6530,創威,6,1,5,亞東-新竹,2024-11-29,2184
6962,ITH-KY,6,1,5,亞東-新竹,2024-11-29,2184
2615,萬海,4,1,3,亞東-新竹,2024-11-29,2184
1102,亞泥,3,0,3,亞東-新竹,2024-11-29,2184
2337,旺宏,3,0,3,亞東-新竹,2024-11-29,2184
2356,英業達,5,2,3,亞東-新竹,2024-11-29,2184
2426,鼎元,19,16,3,亞東-新竹,2024-11-29,2184
2885,元大金,3,0,3,亞東-新竹,2024-11-29,2184
3167,大量,3,0,3,亞東-新竹,2024-11-29,2184
4919,新唐,3,0,3,亞東-新竹,2024-11-29,2184
6191,精成科,3,0,3,亞東-新竹,2024-11-29,2184
2330,台積電,2,0,2,亞東-新竹,2024-11-29,2184
1708,東鹼,4,2,2,亞東-新竹,2024-11-29,2184
1449,佳和,2,0,2,亞東-新竹,2024-11-29,2184
2201,裕隆,2,0,2,亞東-新竹,2024-11-29,2184
2344,華邦電,2,0,2,亞東-新竹,2024-11-29,2184
2354,鴻準,22,20,2,亞東-新竹,2024-11-29,2184
2371,大同,3,1,2,亞東-新竹,2024-11-29,2184
2392,正崴,5,3,2,亞東-新竹,2024-11-29,2184
2883,凱基金,1105,0,1105,亞東-新竹,2024-12-02,2184
00953B,群益優選非投等債,300,2,298,亞東-新竹,2024-12-02,2184
00712,復華富時不動產,294,0,294,亞東-新竹,2024-12-02,2184
2368,金像電,200,0,200,亞東-新竹,2024-12-02,2184
00687B,國泰20年美債,105,25,80,亞東-新竹,2024-12-02,2184
6770,力積電,52,1,51,亞東-新竹,2024-12-02,2184
00918,大華優利高填息30,44,0,44,亞東-新竹,2024-12-02,2184
00915,凱基優選高股息30,40,0,40,亞東-新竹,2024-12-02,2184
2317,鴻海,38,4,34,亞東-新竹,2024-12-02,2184
3323,加百裕,99,66,33,亞東-新竹,2024-12-02,2184
1718,中纖,30,0,30,亞東-新竹,2024-12-02,2184
00905,FT臺灣Smart,29,0,29,亞東-新竹,2024-12-02,2184
6274,台燿,21,0,21,亞東-新竹,2024-12-02,2184
1402,遠東新,22,1,21,亞東-新竹,2024-12-02,2184
00713,元大台灣高息低波,20,0,20,亞東-新竹,2024-12-02,2184
5880,合庫金,20,0,20,亞東-新竹,2024-12-02,2184
00878,國泰永續高股息,32,16,16,亞東-新竹,2024-12-02,2184
0056,元大高股息,24,9,15,亞東-新竹,2024-12-02,2184
2033,佳大,13,0,13,亞東-新竹,2024-12-02,2184
1735,日勝化,12,0,12,亞東-新竹,2024-12-02,2184
5328,華容,12,0,12,亞東-新竹,2024-12-02,2184
2915,潤泰全,11,0,11,亞東-新竹,2024-12-02,2184
00919,群益台灣精選高息,50,40,10,亞東-新竹,2024-12-02,2184
2885,元大金,10,0,10,亞東-新竹,2024-12-02,2184
2888,新光金,25,15,10,亞東-新竹,2024-12-02,2184
1312,國喬,9,0,9,亞東-新竹,2024-12-02,2184
00670L,富邦NASDAQ正2,9,0,9,亞東-新竹,2024-12-02,2184
6589,台康生技,9,0,9,亞東-新竹,2024-12-02,2184
00900,富邦特選高股息30,8,0,8,亞東-新竹,2024-12-02,2184
4128,中天,8,0,8,亞東-新竹,2024-12-02,2184
2615,萬海,13,5,8,亞東-新竹,2024-12-02,2184
6962,ITH-KY,9,2,7,亞東-新竹,2024-12-02,2184
1324,地球,7,0,7,亞東-新竹,2024-12-02,2184
6116,彩晶,7,0,7,亞東-新竹,2024-12-02,2184
4545,銘鈺,6,0,6,亞東-新竹,2024-12-02,2184
6558,興能高,32,26,6,亞東-新竹,2024-12-02,2184
1785,光洋科,5,0,5,亞東-新竹,2024-12-02,2184
5864,致和證,5,0,5,亞東-新竹,2024-12-02,2184
1582,信錦,5,0,5,亞東-新竹,2024-12-02,2184
1714,和桐,5,0,5,亞東-新竹,2024-12-02,2184
2002,中鋼,5,0,5,亞東-新竹,2024-12-02,2184
2362,藍天,5,0,5,亞東-新竹,2024-12-02,2184
2606,裕民,5,0,5,亞東-新竹,2024-12-02,2184
4123,晟德,5,0,5,亞東-新竹,2024-12-02,2184
4768,晶呈科技,5,1,4,亞東-新竹,2024-12-02,2184
3013,晟銘電,7,3,4,亞東-新竹,2024-12-02,2184
6282,康舒,6,2,4,亞東-新竹,2024-12-02,2184
2887,台新金,4,0,4,亞東-新竹,2024-12-02,2184
1609,大亞,3,0,3,亞東-新竹,2024-12-02,2184
00795B,中信美國公債20年,3,0,3,亞東-新竹,2024-12-02,2184
00937B,群益ESG投等債20,100,1,99,亞東-新竹,2024-12-03,2184
00878,國泰永續高股息,85,28,57,亞東-新竹,2024-12-03,2184
00679B,元大美債20年,54,3,51,亞東-新竹,2024-12-03,2184
1402,遠東新,41,0,41,亞東-新竹,2024-12-03,2184
00919,群益台灣精選高息,45,6,39,亞東-新竹,2024-12-03,2184
3323,加百裕,62,32,30,亞東-新竹,2024-12-03,2184
00943,兆豐電子高息等權,25,0,25,亞東-新竹,2024-12-03,2184
2444,兆勁,22,0,22,亞東-新竹,2024-12-03,2184
00918,大華優利高填息30,16,0,16,亞東-新竹,2024-12-03,2184
00713,元大台灣高息低波,15,0,15,亞東-新竹,2024-12-03,2184
2353,宏��,14,2,12,亞東-新竹,2024-12-03,2184
0050,元大台灣50,17,6,11,亞東-新竹,2024-12-03,2184
1702,南僑,10,0,10,亞東-新竹,2024-12-03,2184
2033,佳大,10,0,10,亞東-新竹,2024-12-03,2184
6133,金橋,10,0,10,亞東-新竹,2024-12-03,2184
6589,台康生技,11,1,10,亞東-新竹,2024-12-03,2184
1815,富喬,10,1,9,亞東-新竹,2024-12-03,2184
3234,光環,10,1,9,亞東-新竹,2024-12-03,2184
6558,興能高,12,3,9,亞東-新竹,2024-12-03,2184
00900,富邦特選高股息30,8,0,8,亞東-新竹,2024-12-03,2184
3149,正達,8,0,8,亞東-新竹,2024-12-03,2184
3706,神達,40,33,7,亞東-新竹,2024-12-03,2184
8929,富堡,7,0,7,亞東-新竹,2024-12-03,2184
1324,地球,7,1,6,亞東-新竹,2024-12-03,2184
0056,元大高股息,7,2,5,亞東-新竹,2024-12-03,2184
3597,映興,5,0,5,亞東-新竹,2024-12-03,2184
3712,永崴投控,9,4,5,亞東-新竹,2024-12-03,2184
6499,益安,5,0,5,亞東-新竹,2024-12-03,2184
00915,凱基優選高股息30,5,1,4,亞東-新竹,2024-12-03,2184
00669R,國泰美國道瓊反1,4,0,4,亞東-新竹,2024-12-03,2184
2405,輔信,4,0,4,亞東-新竹,2024-12-03,2184
4534,慶騰,4,0,4,亞東-新竹,2024-12-03,2184
4958,臻鼎-KY,4,0,4,亞東-新竹,2024-12-03,2184
4968,立積,4,0,4,亞東-新竹,2024-12-03,2184
6191,精成科,4,0,4,亞東-新竹,2024-12-03,2184
6962,ITH-KY,7,4,3,亞東-新竹,2024-12-03,2184
00795B,中信美國公債20年,3,0,3,亞東-新竹,2024-12-03,2184
00930,永豐ESG低碳高息,3,0,3,亞東-新竹,2024-12-03,2184
00926,凱基全球菁英55,3,0,3,亞東-新竹,2024-12-03,2184
2360,致茂,3,0,3,亞東-新竹,2024-12-03,2184
2368,金像電,3,0,3,亞東-新竹,2024-12-03,2184
2413,環科,3,0,3,亞東-新竹,2024-12-03,2184
5353,台林,3,0,3,亞東-新竹,2024-12-03,2184
2357,華碩,2,0,2,亞東-新竹,2024-12-03,2184
00958B,永豐ESG銀行債15,2,0,2,亞東-新竹,2024-12-03,2184
00946,群益科技高息成長,2,0,2,亞東-新竹,2024-12-03,2184
00940,元大台灣價值高息,2,0,2,亞東-新竹,2024-12-03,2184
1808,潤隆,6,4,2,亞東-新竹,2024-12-03,2184
2337,旺宏,3,1,2,亞東-新竹,2024-12-03,2184
2359,所羅門,12,10,2,亞東-新竹,2024-12-03,2184
00937B,群益ESG投等債20,292,11,281,亞東-新竹,2024-12-04,2184
00679B,元大美債20年,153,11,142,亞東-新竹,2024-12-04,2184
00687B,國泰20年美債,100,0,100,亞東-新竹,2024-12-04,2184
5309,系統電,115,22,93,亞東-新竹,2024-12-04,2184
00712,復華富時不動產,91,0,91,亞東-新竹,2024-12-04,2184
00751B,元大AAA至A公司債,82,0,82,亞東-新竹,2024-12-04,2184
00959B,大華投等美債15Y+,60,0,60,亞東-新竹,2024-12-04,2184
00673R,期元大S＆P原油反1,50,0,50,亞東-新竹,2024-12-04,2184
1402,遠東新,42,1,41,亞東-新竹,2024-12-04,2184
5880,合庫金,30,0,30,亞東-新竹,2024-12-04,2184
3032,偉訓,25,4,21,亞東-新竹,2024-12-04,2184
1444,力麗,20,0,20,亞東-新竹,2024-12-04,2184
00688L,國泰20年美債正2,16,0,16,亞東-新竹,2024-12-04,2184
0056,元大高股息,15,0,15,亞東-新竹,2024-12-04,2184
00680L,元大美債20正2,15,0,15,亞東-新竹,2024-12-04,2184
2887,台新金,15,0,15,亞東-新竹,2024-12-04,2184
2395,研華,14,0,14,亞東-新竹,2024-12-04,2184
00918,大華優利高填息30,12,1,11,亞東-新竹,2024-12-04,2184
3558,神準,26,15,11,亞東-新竹,2024-12-04,2184
00940,元大台灣價值高息,50,40,10,亞東-新竹,2024-12-04,2184
6143,振曜,10,0,10,亞東-新竹,2024-12-04,2184
00924,復華S＆P500成長,10,0,10,亞東-新竹,2024-12-04,2184
00795B,中信美國公債20年,10,0,10,亞東-新竹,2024-12-04,2184
9105,泰金寶-DR,10,0,10,亞東-新竹,2024-12-04,2184
00725B,國泰投資級公司債,7,0,7,亞東-新竹,2024-12-04,2184
00720B,元大投資級公司債,7,0,7,亞東-新竹,2024-12-04,2184
00900,富邦特選高股息30,7,0,7,亞東-新竹,2024-12-04,2184
1609,大亞,7,0,7,亞東-新竹,2024-12-04,2184
2349,錸德,7,0,7,亞東-新竹,2024-12-04,2184
4147,中裕,15,8,7,亞東-新竹,2024-12-04,2184
00648R,元大S＆P500反1,6,0,6,亞東-新竹,2024-12-04,2184
1324,地球,6,0,6,亞東-新竹,2024-12-04,2184
1446,宏和,6,0,6,亞東-新竹,2024-12-04,2184
2354,鴻準,30,24,6,亞東-新竹,2024-12-04,2184
3550,聯穎,5,0,5,亞東-新竹,2024-12-04,2184
6134,萬旭,5,0,5,亞東-新竹,2024-12-04,2184
6214,精誠,5,0,5,亞東-新竹,2024-12-04,2184
6877,鏵友益,5,0,5,亞東-新竹,2024-12-04,2184
00931B,統一美債20年,4,0,4,亞東-新竹,2024-12-04,2184
1702,南僑,4,0,4,亞東-新竹,2024-12-04,2184
1808,潤隆,6,2,4,亞東-新竹,2024-12-04,2184
2464,盟立,6,2,4,亞東-新竹,2024-12-04,2184
2605,新興,4,0,4,亞東-新竹,2024-12-04,2184
4768,晶呈科技,4,0,4,亞東-新竹,2024-12-04,2184
8104,錸寶,7,3,4,亞東-新竹,2024-12-04,2184
8176,智捷,4,0,4,亞東-新竹,2024-12-04,2184
8215,明基材,5,1,4,亞東-新竹,2024-12-04,2184
2413,環科,3,0,3,亞東-新竹,2024-12-04,2184
2891,中信金,3,0,3,亞東-新竹,2024-12-04,2184
4968,立積,3,0,3,亞東-新竹,2024-12-04,2184
00937B,群益ESG投等債20,335,0,335,亞東-新竹,2024-12-05,2184
2845,遠東銀,206,0,206,亞東-新竹,2024-12-05,2184
4931,新盛力,57,16,41,亞東-新竹,2024-12-05,2184
1402,遠東新,42,2,40,亞東-新竹,2024-12-05,2184
2303,聯電,35,0,35,亞東-新竹,2024-12-05,2184
9105,泰金寶-DR,30,0,30,亞東-新竹,2024-12-05,2184
00953B,群益優選非投等債,27,0,27,亞東-新竹,2024-12-05,2184
1721,三晃,26,1,25,亞東-新竹,2024-12-05,2184
00712,復華富時不動產,23,0,23,亞東-新竹,2024-12-05,2184
4916,事欣科,23,0,23,亞東-新竹,2024-12-05,2184
3376,新日興,20,0,20,亞東-新竹,2024-12-05,2184
3090,日電貿,19,0,19,亞東-新竹,2024-12-05,2184
1815,富喬,21,5,16,亞東-新竹,2024-12-05,2184
2392,正崴,19,7,12,亞東-新竹,2024-12-05,2184
1312,國喬,10,0,10,亞東-新竹,2024-12-05,2184
00664R,國泰臺灣加權反1,10,0,10,亞東-新竹,2024-12-05,2184
2444,兆勁,10,0,10,亞東-新竹,2024-12-05,2184
5871,中租-KY,10,0,10,亞東-新竹,2024-12-05,2184
6143,振曜,10,0,10,亞東-新竹,2024-12-05,2184
6282,康舒,10,0,10,亞東-新竹,2024-12-05,2184
8044,網家,10,0,10,亞東-新竹,2024-12-05,2184
2070,精湛,9,0,9,亞東-新竹,2024-12-05,2184
00878,國泰永續高股息,8,0,8,亞東-新竹,2024-12-05,2184
3625,西勝,8,0,8,亞東-新竹,2024-12-05,2184
6962,ITH-KY,6,0,6,亞東-新竹,2024-12-05,2184
3231,緯創,7,1,6,亞東-新竹,2024-12-05,2184
1326,台化,6,0,6,亞東-新竹,2024-12-05,2184
1609,大亞,6,0,6,亞東-新竹,2024-12-05,2184
2317,鴻海,8,2,6,亞東-新竹,2024-12-05,2184
3558,神準,15,9,6,亞東-新竹,2024-12-05,2184
4513,福裕,6,0,6,亞東-新竹,2024-12-05,2184
00665L,富邦�琤肭磪囓�2,105,100,5,亞東-新竹,2024-12-05,2184
2337,旺宏,5,0,5,亞東-新竹,2024-12-05,2184
2607,榮運,5,0,5,亞東-新竹,2024-12-05,2184
3211,順達,10,5,5,亞東-新竹,2024-12-05,2184
3712,永崴投控,7,2,5,亞東-新竹,2024-12-05,2184
5328,華容,5,0,5,亞東-新竹,2024-12-05,2184
6530,創威,5,0,5,亞東-新竹,2024-12-05,2184
2891,中信金,4,0,4,亞東-新竹,2024-12-05,2184
1504,東元,4,0,4,亞東-新竹,2024-12-05,2184
00900,富邦特選高股息30,4,0,4,亞東-新竹,2024-12-05,2184
1702,南僑,4,0,4,亞東-新竹,2024-12-05,2184
2033,佳大,4,0,4,亞東-新竹,2024-12-05,2184
2349,錸德,4,0,4,亞東-新竹,2024-12-05,2184
2375,凱美,11,7,4,亞東-新竹,2024-12-05,2184
2457,飛宏,9,5,4,亞東-新竹,2024-12-05,2184
2633,台灣高鐵,4,0,4,亞東-新竹,2024-12-05,2184
4510,高鋒,6,2,4,亞東-新竹,2024-12-05,2184
6425,易發,4,0,4,亞東-新竹,2024-12-05,2184
2354,鴻準,60,57,3,亞東-新竹,2024-12-05,2184
00937B,群益ESG投等債20,271,0,271,亞東-新竹,2024-12-06,2184
3704,合勤控,151,2,149,亞東-新竹,2024-12-06,2184
00918,大華優利高填息30,82,1,81,亞東-新竹,2024-12-06,2184
1605,華新,52,0,52,亞東-新竹,2024-12-06,2184
2354,鴻準,83,58,25,亞東-新竹,2024-12-06,2184
00715L,期街口布蘭特正2,20,0,20,亞東-新竹,2024-12-06,2184
2603,長榮,19,0,19,亞東-新竹,2024-12-06,2184
3323,加百裕,15,0,15,亞東-新竹,2024-12-06,2184
00712,復華富時不動產,13,0,13,亞東-新竹,2024-12-06,2184
1815,富喬,13,1,12,亞東-新竹,2024-12-06,2184
1312,國喬,10,0,10,亞東-新竹,2024-12-06,2184
6257,矽格,10,0,10,亞東-新竹,2024-12-06,2184
6505,台塑化,10,0,10,亞東-新竹,2024-12-06,2184
9105,泰金寶-DR,10,0,10,亞東-新竹,2024-12-06,2184
1402,遠東新,12,2,10,亞東-新竹,2024-12-06,2184
00915,凱基優選高股息30,9,0,9,亞東-新竹,2024-12-06,2184
1785,光洋科,21,13,8,亞東-新竹,2024-12-06,2184
6187,萬潤,8,0,8,亞東-新竹,2024-12-06,2184
00671R,富邦NASDAQ反1,8,0,8,亞東-新竹,2024-12-06,2184
1459,聯發,8,0,8,亞東-新竹,2024-12-06,2184
6763,綠界科技*,10,3,7,亞東-新竹,2024-12-06,2184
2002,中鋼,6,0,6,亞東-新竹,2024-12-06,2184
00648R,元大S＆P500反1,6,0,6,亞東-新竹,2024-12-06,2184
1784,訊聯,6,0,6,亞東-新竹,2024-12-06,2184
3231,緯創,6,0,6,亞東-新竹,2024-12-06,2184
00878,國泰永續高股息,5,0,5,亞東-新竹,2024-12-06,2184
2356,英業達,5,0,5,亞東-新竹,2024-12-06,2184
3105,穩懋,5,0,5,亞東-新竹,2024-12-06,2184
3289,宜特,5,0,5,亞東-新竹,2024-12-06,2184
5309,系統電,5,0,5,亞東-新竹,2024-12-06,2184
6138,茂達,5,0,5,亞東-新竹,2024-12-06,2184
8069,元太,5,0,5,亞東-新竹,2024-12-06,2184
8176,智捷,5,0,5,亞東-新竹,2024-12-06,2184
8249,菱光,8,3,5,亞東-新竹,2024-12-06,2184
8261,富鼎,6,1,5,亞東-新竹,2024-12-06,2184
00933B,國泰10Y+金融債,4,0,4,亞東-新竹,2024-12-06,2184
2392,正崴,4,0,4,亞東-新竹,2024-12-06,2184
3265,台星科,4,0,4,亞東-新竹,2024-12-06,2184
006208,富邦台50,3,0,3,亞東-新竹,2024-12-06,2184
0056,元大高股息,5,2,3,亞東-新竹,2024-12-06,2184
00924,復華S＆P500成長,3,0,3,亞東-新竹,2024-12-06,2184
00907,永豐優息存股,3,0,3,亞東-新竹,2024-12-06,2184
2312,金寶,3,0,3,亞東-新竹,2024-12-06,2184
2613,中櫃,6,3,3,亞東-新竹,2024-12-06,2184
3563,牧德,3,0,3,亞東-新竹,2024-12-06,2184
4716,大立,3,0,3,亞東-新竹,2024-12-06,2184
4721,美琪瑪,4,1,3,亞東-新竹,2024-12-06,2184
6416,瑞祺電通,3,0,3,亞東-新竹,2024-12-06,2184
6530,創威,3,0,3,亞東-新竹,2024-12-06,2184
6913,鴻呈,3,0,3,亞東-新竹,2024-12-06,2184
2834,臺企銀,300,0,300,亞東-新竹,2024-12-09,2184
00937B,群益ESG投等債20,200,4,196,亞東-新竹,2024-12-09,2184
2324,仁寶,85,11,74,亞東-新竹,2024-12-09,2184
5876,上海商銀,60,0,60,亞東-新竹,2024-12-09,2184
1504,東元,50,4,46,亞東-新竹,2024-12-09,2184
00900,富邦特選高股息30,45,0,45,亞東-新竹,2024-12-09,2184
00915,凱基優選高股息30,34,0,34,亞東-新竹,2024-12-09,2184
6015,宏遠證,25,0,25,亞東-新竹,2024-12-09,2184
2230,泰茂,23,0,23,亞東-新竹,2024-12-09,2184
4931,新盛力,59,36,23,亞東-新竹,2024-12-09,2184
00679B,元大美債20年,19,5,14,亞東-新竹,2024-12-09,2184
1708,東鹼,12,0,12,亞東-新竹,2024-12-09,2184
2891,中信金,12,0,12,亞東-新竹,2024-12-09,2184
3062,建漢,11,0,11,亞東-新竹,2024-12-09,2184
3481,群創,11,0,11,亞東-新竹,2024-12-09,2184
1312,國喬,10,0,10,亞東-新竹,2024-12-09,2184
2915,潤泰全,10,0,10,亞東-新竹,2024-12-09,2184
3323,加百裕,10,0,10,亞東-新竹,2024-12-09,2184
6257,矽格,10,0,10,亞東-新竹,2024-12-09,2184
9105,泰金寶-DR,10,0,10,亞東-新竹,2024-12-09,2184
2317,鴻海,9,0,9,亞東-新竹,2024-12-09,2184
2413,環科,9,0,9,亞東-新竹,2024-12-09,2184
1402,遠東新,11,2,9,亞東-新竹,2024-12-09,2184
2371,大同,8,0,8,亞東-新竹,2024-12-09,2184
3576,聯合再生,8,0,8,亞東-新竹,2024-12-09,2184
3706,神達,14,6,8,亞東-新竹,2024-12-09,2184
3231,緯創,8,0,8,亞東-新竹,2024-12-09,2184
1459,聯發,7,0,7,亞東-新竹,2024-12-09,2184
1446,宏和,6,0,6,亞東-新竹,2024-12-09,2184
4513,福裕,6,0,6,亞東-新竹,2024-12-09,2184
00918,大華優利高填息30,5,0,5,亞東-新竹,2024-12-09,2184
1102,亞泥,5,0,5,亞東-新竹,2024-12-09,2184
1324,地球,5,0,5,亞東-新竹,2024-12-09,2184
1802,台玻,5,0,5,亞東-新竹,2024-12-09,2184
2376,技嘉,6,1,5,亞東-新竹,2024-12-09,2184
2618,長榮航,13,8,5,亞東-新竹,2024-12-09,2184
4109,加捷生醫,5,0,5,亞東-新竹,2024-12-09,2184
4908,前鼎,13,8,5,亞東-新竹,2024-12-09,2184
2646,星宇航空,6,2,4,亞東-新竹,2024-12-09,2184
1336,台翰,4,0,4,亞東-新竹,2024-12-09,2184
00929,復華台灣科技優息,5,1,4,亞東-新竹,2024-12-09,2184
1513,中興電,4,0,4,亞東-新竹,2024-12-09,2184
1582,信錦,4,0,4,亞東-新竹,2024-12-09,2184
1609,大亞,4,0,4,亞東-新竹,2024-12-09,2184
2312,金寶,10,6,4,亞東-新竹,2024-12-09,2184
2360,致茂,4,0,4,亞東-新竹,2024-12-09,2184
2449,京元電子,4,0,4,亞東-新竹,2024-12-09,2184
2867,三商壽,4,0,4,亞東-新竹,2024-12-09,2184
3078,僑威,4,0,4,亞東-新竹,2024-12-09,2184
3587,閎康,4,0,4,亞東-新竹,2024-12-09,2184
2883,凱基金,31,0,31,亞東-新竹,2024-12-10,2184
3706,神達,63,34,29,亞東-新竹,2024-12-10,2184
4931,新盛力,54,25,29,亞東-新竹,2024-12-10,2184
2353,宏��,25,1,24,亞東-新竹,2024-12-10,2184
4207,環泰,23,0,23,亞東-新竹,2024-12-10,2184
00919,群益台灣精選高息,22,0,22,亞東-新竹,2024-12-10,2184
9105,泰金寶-DR,17,0,17,亞東-新竹,2024-12-10,2184
00937B,群益ESG投等債20,18,2,16,亞東-新竹,2024-12-10,2184
6015,宏遠證,20,5,15,亞東-新竹,2024-12-10,2184
6188,廣明,31,16,15,亞東-新竹,2024-12-10,2184
00688L,國泰20年美債正2,12,0,12,亞東-新竹,2024-12-10,2184
00679B,元大美債20年,12,0,12,亞東-新竹,2024-12-10,2184
00680L,元大美債20正2,12,1,11,亞東-新竹,2024-12-10,2184
00795B,中信美國公債20年,11,0,11,亞東-新竹,2024-12-10,2184
6962,ITH-KY,11,0,11,亞東-新竹,2024-12-10,2184
2609,陽明,12,2,10,亞東-新竹,2024-12-10,2184
00900,富邦特選高股息30,10,0,10,亞東-新竹,2024-12-10,2184
00706L,期元大S＆P日圓正2,10,0,10,亞東-新竹,2024-12-10,2184
2303,聯電,10,0,10,亞東-新竹,2024-12-10,2184
4114,健喬,10,0,10,亞東-新竹,2024-12-10,2184
00751B,元大AAA至A公司債,9,0,9,亞東-新竹,2024-12-10,2184
00671R,富邦NASDAQ反1,8,0,8,亞東-新竹,2024-12-10,2184
00725B,國泰投資級公司債,8,0,8,亞東-新竹,2024-12-10,2184
1609,大亞,12,4,8,亞東-新竹,2024-12-10,2184
6282,康舒,8,0,8,亞東-新竹,2024-12-10,2184
8042,金山電,8,0,8,亞東-新竹,2024-12-10,2184
2646,星宇航空,7,0,7,亞東-新竹,2024-12-10,2184
3078,僑威,7,0,7,亞東-新竹,2024-12-10,2184
4916,事欣科,7,0,7,亞東-新竹,2024-12-10,2184
2317,鴻海,11,4,7,亞東-新竹,2024-12-10,2184
00940,元大台灣價值高息,6,0,6,亞東-新竹,2024-12-10,2184
3043,科風,6,0,6,亞東-新竹,2024-12-10,2184
3535,晶彩科,6,0,6,亞東-新竹,2024-12-10,2184
3037,欣興,5,0,5,亞東-新竹,2024-12-10,2184
00933B,國泰10Y+金融債,5,0,5,亞東-新竹,2024-12-10,2184
2888,新光金,15,10,5,亞東-新竹,2024-12-10,2184
3011,今皓,5,0,5,亞東-新竹,2024-12-10,2184
5907,大洋-KY,10,5,5,亞東-新竹,2024-12-10,2184
6877,鏵友益,5,0,5,亞東-新竹,2024-12-10,2184
1446,宏和,4,0,4,亞東-新竹,2024-12-10,2184
00687B,國泰20年美債,4,0,4,亞東-新竹,2024-12-10,2184
2392,正崴,5,1,4,亞東-新竹,2024-12-10,2184
3563,牧德,4,0,4,亞東-新竹,2024-12-10,2184
4513,福裕,4,0,4,亞東-新竹,2024-12-10,2184
4714,永捷,4,0,4,亞東-新竹,2024-12-10,2184
4908,前鼎,4,0,4,亞東-新竹,2024-12-10,2184
6451,訊芯-KY,9,5,4,亞東-新竹,2024-12-10,2184
1303,南亞,3,0,3,亞東-新竹,2024-12-10,2184
00927,群益半導體收益,3,0,3,亞東-新竹,2024-12-10,2184
1301,台塑,3,0,3,亞東-新竹,2024-12-10,2184
2610,華航,210,0,210,亞東-新竹,2024-12-11,2184
00937B,群益ESG投等債20,120,4,116,亞東-新竹,2024-12-11,2184
6770,力積電,52,0,52,亞東-新竹,2024-12-11,2184
00900,富邦特選高股息30,50,0,50,亞東-新竹,2024-12-11,2184
00679B,元大美債20年,42,0,42,亞東-新竹,2024-12-11,2184
9958,世紀鋼,40,0,40,亞東-新竹,2024-12-11,2184
00687B,國泰20年美債,28,0,28,亞東-新竹,2024-12-11,2184
2344,華邦電,25,0,25,亞東-新竹,2024-12-11,2184
4931,新盛力,44,19,25,亞東-新竹,2024-12-11,2184
6757,台灣虎航,25,0,25,亞東-新竹,2024-12-11,2184
1301,台塑,22,0,22,亞東-新竹,2024-12-11,2184
00680L,元大美債20正2,20,0,20,亞東-新竹,2024-12-11,2184
2646,星宇航空,20,0,20,亞東-新竹,2024-12-11,2184
2317,鴻海,25,6,19,亞東-新竹,2024-12-11,2184
00918,大華優利高填息30,16,0,16,亞東-新竹,2024-12-11,2184
00878,國泰永續高股息,26,10,16,亞東-新竹,2024-12-11,2184
4746,台耀,16,0,16,亞東-新竹,2024-12-11,2184
00915,凱基優選高股息30,15,0,15,亞東-新竹,2024-12-11,2184
1785,光洋科,20,5,15,亞東-新竹,2024-12-11,2184
2303,聯電,15,0,15,亞東-新竹,2024-12-11,2184
00688L,國泰20年美債正2,14,0,14,亞東-新竹,2024-12-11,2184
1459,聯發,13,0,13,亞東-新竹,2024-12-11,2184
1717,長興,12,0,12,亞東-新竹,2024-12-11,2184
6462,神盾,23,11,12,亞東-新竹,2024-12-11,2184
00706L,期元大S＆P日圓正2,10,0,10,亞東-新竹,2024-12-11,2184
2883B,凱基金乙特,10,0,10,亞東-新竹,2024-12-11,2184
5880,合庫金,10,0,10,亞東-新竹,2024-12-11,2184
6015,宏遠證,10,0,10,亞東-新竹,2024-12-11,2184
00795B,中信美國公債20年,9,0,9,亞東-新竹,2024-12-11,2184
2388,威盛,12,3,9,亞東-新竹,2024-12-11,2184
2605,新興,7,0,7,亞東-新竹,2024-12-11,2184
2371,大同,6,0,6,亞東-新竹,2024-12-11,2184
2915,潤泰全,6,0,6,亞東-新竹,2024-12-11,2184
3024,憶聲,6,0,6,亞東-新竹,2024-12-11,2184
1815,富喬,7,2,5,亞東-新竹,2024-12-11,2184
00632R,元大台灣50反1,10,5,5,亞東-新竹,2024-12-11,2184
2201,裕隆,5,0,5,亞東-新竹,2024-12-11,2184
2888,新光金,10,5,5,亞東-新竹,2024-12-11,2184
6215,和椿,5,0,5,亞東-新竹,2024-12-11,2184
00919,群益台灣精選高息,4,0,4,亞東-新竹,2024-12-11,2184
1326,台化,4,0,4,亞東-新竹,2024-12-11,2184
6288,聯嘉,4,0,4,亞東-新竹,2024-12-11,2184
6499,益安,4,0,4,亞東-新竹,2024-12-11,2184
6877,鏵友益,7,3,4,亞東-新竹,2024-12-11,2184
2382,廣達,4,1,3,亞東-新竹,2024-12-11,2184
2330,台積電,3,0,3,亞東-新竹,2024-12-11,2184
00753L,中信中國50正2,3,0,3,亞東-新竹,2024-12-11,2184
00725B,國泰投資級公司債,3,0,3,亞東-新竹,2024-12-11,2184
1605,華新,3,0,3,亞東-新竹,2024-12-11,2184
1708,東鹼,3,0,3,亞東-新竹,2024-12-11,2184
00679B,元大美債20年,637,5,632,亞東-新竹,2024-12-12,2184
00965,元大航太防衛科技,100,0,100,亞東-新竹,2024-12-12,2184
00751B,元大AAA至A公司債,83,0,83,亞東-新竹,2024-12-12,2184
1718,中纖,60,0,60,亞東-新竹,2024-12-12,2184
2002,中鋼,52,0,52,亞東-新竹,2024-12-12,2184
00673R,期元大S＆P原油反1,50,0,50,亞東-新竹,2024-12-12,2184
00688L,國泰20年美債正2,49,0,49,亞東-新竹,2024-12-12,2184
2609,陽明,36,0,36,亞東-新竹,2024-12-12,2184
2303,聯電,33,0,33,亞東-新竹,2024-12-12,2184
00680L,元大美債20正2,33,0,33,亞東-新竹,2024-12-12,2184
00712,復華富時不動產,32,0,32,亞東-新竹,2024-12-12,2184
2317,鴻海,37,7,30,亞東-新竹,2024-12-12,2184
0056,元大高股息,26,0,26,亞東-新竹,2024-12-12,2184
6163,華電網,22,0,22,亞東-新竹,2024-12-12,2184
00915,凱基優選高股息30,20,0,20,亞東-新竹,2024-12-12,2184
00795B,中信美國公債20年,19,0,19,亞東-新竹,2024-12-12,2184
00665L,富邦�琤肭磪囓�2,149,135,14,亞東-新竹,2024-12-12,2184
2337,旺宏,13,0,13,亞東-新竹,2024-12-12,2184
00931B,統一美債20年,12,0,12,亞東-新竹,2024-12-12,2184
3323,加百裕,12,0,12,亞東-新竹,2024-12-12,2184
2915,潤泰全,11,0,11,亞東-新竹,2024-12-12,2184
3689,湧德,12,1,11,亞東-新竹,2024-12-12,2184
00950B,凱基A級公司債,10,0,10,亞東-新竹,2024-12-12,2184
2344,華邦電,20,10,10,亞東-新竹,2024-12-12,2184
3447,展達,10,0,10,亞東-新竹,2024-12-12,2184
5880,合庫金,10,0,10,亞東-新竹,2024-12-12,2184
00918,大華優利高填息30,10,0,10,亞東-新竹,2024-12-12,2184
2395,研華,9,0,9,亞東-新竹,2024-12-12,2184
1702,南僑,8,0,8,亞東-新竹,2024-12-12,2184
2328,廣宇,8,0,8,亞東-新竹,2024-12-12,2184
3211,順達,10,2,8,亞東-新竹,2024-12-12,2184
1321,大洋,7,0,7,亞東-新竹,2024-12-12,2184
1326,台化,7,0,7,亞東-新竹,2024-12-12,2184
2354,鴻準,23,16,7,亞東-新竹,2024-12-12,2184
3231,緯創,7,1,6,亞東-新竹,2024-12-12,2184
4510,高鋒,6,0,6,亞東-新竹,2024-12-12,2184
00933B,國泰10Y+金融債,5,0,5,亞東-新竹,2024-12-12,2184
00919,群益台灣精選高息,5,0,5,亞東-新竹,2024-12-12,2184
2472,立隆電,5,0,5,亞東-新竹,2024-12-12,2184
2515,中工,5,0,5,亞東-新竹,2024-12-12,2184
4953,緯軟,8,3,5,亞東-新竹,2024-12-12,2184
5907,大洋-KY,5,0,5,亞東-新竹,2024-12-12,2184
2867,三商壽,4,0,4,亞東-新竹,2024-12-12,2184
1785,光洋科,5,1,4,亞東-新竹,2024-12-12,2184
1301,台塑,4,0,4,亞東-新竹,2024-12-12,2184
2352,佳世達,4,0,4,亞東-新竹,2024-12-12,2184
2374,佳能,4,0,4,亞東-新竹,2024-12-12,2184
2427,三商電,4,0,4,亞東-新竹,2024-12-12,2184
2468,華經,7,3,4,亞東-新竹,2024-12-12,2184
4513,福裕,4,0,4,亞東-新竹,2024-12-12,2184
1718,中纖,68,0,68,亞東-新竹,2024-12-13,2184
00751B,元大AAA至A公司債,66,0,66,亞東-新竹,2024-12-13,2184
2401,凌陽,50,0,50,亞東-新竹,2024-12-13,2184
3450,聯鈞,44,5,39,亞東-新竹,2024-12-13,2184
00918,大華優利高填息30,37,0,37,亞東-新竹,2024-12-13,2184
3706,神達,84,54,30,亞東-新竹,2024-12-13,2184
1301,台塑,30,0,30,亞東-新竹,2024-12-13,2184
00688L,國泰20年美債正2,27,0,27,亞東-新竹,2024-12-13,2184
00680L,元大美債20正2,27,0,27,亞東-新竹,2024-12-13,2184
6770,力積電,56,32,24,亞東-新竹,2024-12-13,2184
00915,凱基優選高股息30,22,0,22,亞東-新竹,2024-12-13,2184
2887,台新金,22,0,22,亞東-新竹,2024-12-13,2184
00959B,大華投等美債15Y+,20,0,20,亞東-新竹,2024-12-13,2184
6962,ITH-KY,20,0,20,亞東-新竹,2024-12-13,2184
00679B,元大美債20年,19,0,19,亞東-新竹,2024-12-13,2184
1702,南僑,19,0,19,亞東-新竹,2024-12-13,2184
2303,聯電,48,30,18,亞東-新竹,2024-12-13,2184
00878,國泰永續高股息,16,0,16,亞東-新竹,2024-12-13,2184
00919,群益台灣精選高息,16,0,16,亞東-新竹,2024-12-13,2184
1569,濱川,16,0,16,亞東-新竹,2024-12-13,2184
2427,三商電,16,0,16,亞東-新竹,2024-12-13,2184
00900,富邦特選高股息30,15,0,15,亞東-新竹,2024-12-13,2184
00940,元大台灣價值高息,12,0,12,亞東-新竹,2024-12-13,2184
00882,中信中國高股息,11,0,11,亞東-新竹,2024-12-13,2184
2301,光寶科,11,0,11,亞東-新竹,2024-12-13,2184
2317,鴻海,16,6,10,亞東-新竹,2024-12-13,2184
1312,國喬,10,0,10,亞東-新竹,2024-12-13,2184
3217,優群,10,0,10,亞東-新竹,2024-12-13,2184
6499,益安,10,0,10,亞東-新竹,2024-12-13,2184
5371,中光電,10,2,8,亞東-新竹,2024-12-13,2184
2888,新光金,13,5,8,亞東-新竹,2024-12-13,2184
3710,連展投控,8,0,8,亞東-新竹,2024-12-13,2184
2618,長榮航,9,2,7,亞東-新竹,2024-12-13,2184
00937B,群益ESG投等債20,7,0,7,亞東-新竹,2024-12-13,2184
2867,三商壽,7,0,7,亞東-新竹,2024-12-13,2184
6451,訊芯-KY,12,5,7,亞東-新竹,2024-12-13,2184
00795B,中信美國公債20年,6,0,6,亞東-新竹,2024-12-13,2184
4207,環泰,6,0,6,亞東-新竹,2024-12-13,2184
1609,大亞,5,0,5,亞東-新竹,2024-12-13,2184
3105,穩懋,5,0,5,亞東-新竹,2024-12-13,2184
3576,聯合再生,5,0,5,亞東-新竹,2024-12-13,2184
6015,宏遠證,5,0,5,亞東-新竹,2024-12-13,2184
8028,昇陽半導體,5,0,5,亞東-新竹,2024-12-13,2184
2408,南亞科,5,0,5,亞東-新竹,2024-12-13,2184
1785,光洋科,15,10,5,亞東-新竹,2024-12-13,2184
3037,欣興,4,0,4,亞東-新竹,2024-12-13,2184
00720B,元大投資級公司債,4,0,4,亞東-新竹,2024-12-13,2184
1449,佳和,4,0,4,亞東-新竹,2024-12-13,2184
2613,中櫃,4,0,4,亞東-新竹,2024-12-13,2184
3003,健和興,4,0,4,亞東-新竹,2024-12-13,2184
5880,合庫金,199,0,199,亞東-新竹,2024-12-16,2184
00673R,期元大S＆P原油反1,50,0,50,亞東-新竹,2024-12-16,2184
2317,鴻海,74,33,41,亞東-新竹,2024-12-16,2184
00918,大華優利高填息30,31,0,31,亞東-新竹,2024-12-16,2184
00937B,群益ESG投等債20,30,0,30,亞東-新竹,2024-12-16,2184
1434,福懋,30,0,30,亞東-新竹,2024-12-16,2184
00679B,元大美債20年,29,0,29,亞東-新竹,2024-12-16,2184
00631L,元大台灣50正2,31,3,28,亞東-新竹,2024-12-16,2184
6290,良維,26,0,26,亞東-新竹,2024-12-16,2184
00680L,元大美債20正2,21,0,21,亞東-新竹,2024-12-16,2184
00688L,國泰20年美債正2,21,0,21,亞東-新竹,2024-12-16,2184
00916,國泰全球品牌50,20,0,20,亞東-新竹,2024-12-16,2184
4714,永捷,20,0,20,亞東-新竹,2024-12-16,2184
6548,長科*,20,0,20,亞東-新竹,2024-12-16,2184
9105,泰金寶-DR,20,0,20,亞東-新竹,2024-12-16,2184
2486,一詮,18,0,18,亞東-新竹,2024-12-16,2184
1785,光洋科,16,0,16,亞東-新竹,2024-12-16,2184
1313,聯成,15,0,15,亞東-新竹,2024-12-16,2184
2354,鴻準,34,20,14,亞東-新竹,2024-12-16,2184
3062,建漢,14,2,12,亞東-新竹,2024-12-16,2184
3189,景碩,16,5,11,亞東-新竹,2024-12-16,2184
2603,長榮,10,0,10,亞東-新竹,2024-12-16,2184
00725B,國泰投資級公司債,10,0,10,亞東-新竹,2024-12-16,2184
00795B,中信美國公債20年,10,0,10,亞東-新竹,2024-12-16,2184
2006,東和鋼鐵,10,0,10,亞東-新竹,2024-12-16,2184
2409,友達,10,0,10,亞東-新竹,2024-12-16,2184
3122,笙泉,11,1,10,亞東-新竹,2024-12-16,2184
3323,加百裕,12,2,10,亞東-新竹,2024-12-16,2184
3712,永崴投控,10,0,10,亞東-新竹,2024-12-16,2184
5438,東友,32,22,10,亞東-新竹,2024-12-16,2184
3211,順達,9,0,9,亞東-新竹,2024-12-16,2184
5483,中美晶,10,1,9,亞東-新竹,2024-12-16,2184
6558,興能高,22,13,9,亞東-新竹,2024-12-16,2184
00915,凱基優選高股息30,8,0,8,亞東-新竹,2024-12-16,2184
00671R,富邦NASDAQ反1,8,0,8,亞東-新竹,2024-12-16,2184
2605,新興,8,0,8,亞東-新竹,2024-12-16,2184
4540,全球傳動,40,32,8,亞東-新竹,2024-12-16,2184
0056,元大高股息,18,10,8,亞東-新竹,2024-12-16,2184
3034,聯詠,6,0,6,亞東-新竹,2024-12-16,2184
2609,陽明,8,2,6,亞東-新竹,2024-12-16,2184
4109,加捷生醫,6,0,6,亞東-新竹,2024-12-16,2184
6412,群電,6,0,6,亞東-新竹,2024-12-16,2184
3014,聯陽,5,0,5,亞東-新竹,2024-12-16,2184
00878,國泰永續高股息,5,0,5,亞東-新竹,2024-12-16,2184
2344,華邦電,5,0,5,亞東-新竹,2024-12-16,2184
00687B,國泰20年美債,5,0,5,亞東-新竹,2024-12-16,2184
00959B,大華投等美債15Y+,5,0,5,亞東-新竹,2024-12-16,2184
2337,旺宏,5,0,5,亞東-新竹,2024-12-16,2184
3322,建舜電,5,0,5,亞東-新竹,2024-12-16,2184
5263,智崴,5,0,5,亞東-新竹,2024-12-16,2184
5880,合庫金,200,0,200,亞東-新竹,2024-12-17,2184
8047,星雲,200,0,200,亞東-新竹,2024-12-17,2184
00751B,元大AAA至A公司債,109,0,109,亞東-新竹,2024-12-17,2184
00937B,群益ESG投等債20,88,0,88,亞東-新竹,2024-12-17,2184
00918,大華優利高填息30,61,0,61,亞東-新竹,2024-12-17,2184
2882,國泰金,60,0,60,亞東-新竹,2024-12-17,2184
1718,中纖,40,0,40,亞東-新竹,2024-12-17,2184
2883,凱基金,237,210,27,亞東-新竹,2024-12-17,2184
4540,全球傳動,26,0,26,亞東-新竹,2024-12-17,2184
00915,凱基優選高股息30,22,0,22,亞東-新竹,2024-12-17,2184
2033,佳大,20,0,20,亞東-新竹,2024-12-17,2184
2646,星宇航空,20,0,20,亞東-新竹,2024-12-17,2184
3024,憶聲,20,0,20,亞東-新竹,2024-12-17,2184
00919,群益台灣精選高息,21,5,16,亞東-新竹,2024-12-17,2184
1402,遠東新,16,0,16,亞東-新竹,2024-12-17,2184
9921,巨大,12,0,12,亞東-新竹,2024-12-17,2184
4562,穎漢,11,0,11,亞東-新竹,2024-12-17,2184
00878,國泰永續高股息,15,5,10,亞東-新竹,2024-12-17,2184
00911,兆豐洲際半導體,10,0,10,亞東-新竹,2024-12-17,2184
00719B,元大美債1-3,10,0,10,亞東-新竹,2024-12-17,2184
00950B,凱基A級公司債,10,0,10,亞東-新竹,2024-12-17,2184
4510,高鋒,19,9,10,亞東-新竹,2024-12-17,2184
6548,長科*,10,0,10,亞東-新竹,2024-12-17,2184
00687B,國泰20年美債,9,0,9,亞東-新竹,2024-12-17,2184
1321,大洋,9,0,9,亞東-新竹,2024-12-17,2184
6214,精誠,9,0,9,亞東-新竹,2024-12-17,2184
2002,中鋼,8,0,8,亞東-新竹,2024-12-17,2184
1301,台塑,7,0,7,亞東-新竹,2024-12-17,2184
6558,興能高,7,0,7,亞東-新竹,2024-12-17,2184
1324,地球,6,0,6,亞東-新竹,2024-12-17,2184
1808,潤隆,6,0,6,亞東-新竹,2024-12-17,2184
3017,奇鋐,6,0,6,亞東-新竹,2024-12-17,2184
00713,元大台灣高息低波,6,0,6,亞東-新竹,2024-12-17,2184
1785,光洋科,10,5,5,亞東-新竹,2024-12-17,2184
1102,亞泥,5,0,5,亞東-新竹,2024-12-17,2184
2006,東和鋼鐵,5,0,5,亞東-新竹,2024-12-17,2184
2888,新光金,5,0,5,亞東-新竹,2024-12-17,2184
3706,神達,14,9,5,亞東-新竹,2024-12-17,2184
4714,永捷,5,0,5,亞東-新竹,2024-12-17,2184
6770,力積電,5,0,5,亞東-新竹,2024-12-17,2184
911608,明輝-DR,5,0,5,亞東-新竹,2024-12-17,2184
0056,元大高股息,7,2,5,亞東-新竹,2024-12-17,2184
00680L,元大美債20正2,4,0,4,亞東-新竹,2024-12-17,2184
00725B,國泰投資級公司債,4,0,4,亞東-新竹,2024-12-17,2184
00857B,永豐20年美公債,4,0,4,亞東-新竹,2024-12-17,2184
6290,良維,4,0,4,亞東-新竹,2024-12-17,2184
6885,全福生技,4,0,4,亞東-新竹,2024-12-17,2184
2881,富邦金,4,0,4,亞東-新竹,2024-12-17,2184
1326,台化,5,2,3,亞東-新竹,2024-12-17,2184
00795B,中信美國公債20年,3,0,3,亞東-新竹,2024-12-17,2184
2883,凱基金,250,10,240,亞東-新竹,2024-12-18,2184
5880,合庫金,221,0,221,亞東-新竹,2024-12-18,2184
00950B,凱基A級公司債,130,0,130,亞東-新竹,2024-12-18,2184
2884,玉山金,110,0,110,亞東-新竹,2024-12-18,2184
2891,中信金,65,3,62,亞東-新竹,2024-12-18,2184
2882,國泰金,55,2,53,亞東-新竹,2024-12-18,2184
00918,大華優利高填息30,48,0,48,亞東-新竹,2024-12-18,2184
2610,華航,103,55,48,亞東-新竹,2024-12-18,2184
6885,全福生技,41,0,41,亞東-新竹,2024-12-18,2184
6531,愛普*,24,4,20,亞東-新竹,2024-12-18,2184
00706L,期元大S＆P日圓正2,10,0,10,亞東-新竹,2024-12-18,2184
00967B,元大優息美債,10,0,10,亞東-新竹,2024-12-18,2184
1785,光洋科,10,1,9,亞東-新竹,2024-12-18,2184
2382,廣達,12,3,9,亞東-新竹,2024-12-18,2184
00933B,國泰10Y+金融債,7,0,7,亞東-新竹,2024-12-18,2184
2344,華邦電,44,37,7,亞東-新竹,2024-12-18,2184
2359,所羅門,20,13,7,亞東-新竹,2024-12-18,2184
2633,台灣高鐵,7,0,7,亞東-新竹,2024-12-18,2184
8069,元太,8,1,7,亞東-新竹,2024-12-18,2184
8249,菱光,10,3,7,亞東-新竹,2024-12-18,2184
3017,奇鋐,6,0,6,亞東-新竹,2024-12-18,2184
00891,中信關鍵半導體,10,4,6,亞東-新竹,2024-12-18,2184
6279,胡連,6,0,6,亞東-新竹,2024-12-18,2184
2002,中鋼,6,0,6,亞東-新竹,2024-12-18,2184
3041,揚智,12,7,5,亞東-新竹,2024-12-18,2184
2486,一詮,9,4,5,亞東-新竹,2024-12-18,2184
2834,臺企銀,5,0,5,亞東-新竹,2024-12-18,2184
00712,復華富時不動產,4,0,4,亞東-新竹,2024-12-18,2184
0050,元大台灣50,5,1,4,亞東-新竹,2024-12-18,2184
00931B,統一美債20年,4,0,4,亞東-新竹,2024-12-18,2184
00795B,中信美國公債20年,4,0,4,亞東-新竹,2024-12-18,2184
00725B,國泰投資級公司債,4,0,4,亞東-新竹,2024-12-18,2184
2634,漢翔,4,0,4,亞東-新竹,2024-12-18,2184
3211,順達,7,3,4,亞東-新竹,2024-12-18,2184
6214,精誠,4,0,4,亞東-新竹,2024-12-18,2184
6290,良維,4,0,4,亞東-新竹,2024-12-18,2184
00648R,元大S＆P500反1,3,0,3,亞東-新竹,2024-12-18,2184
00687B,國泰20年美債,3,0,3,亞東-新竹,2024-12-18,2184
1449,佳和,3,0,3,亞東-新竹,2024-12-18,2184
2328,廣宇,3,0,3,亞東-新竹,2024-12-18,2184
2427,三商電,12,9,3,亞東-新竹,2024-12-18,2184
2637,慧洋-KY,3,0,3,亞東-新竹,2024-12-18,2184
2731,雄獅,3,0,3,亞東-新竹,2024-12-18,2184
3147,大綜,3,0,3,亞東-新竹,2024-12-18,2184
4714,永捷,5,2,3,亞東-新竹,2024-12-18,2184
5263,智崴,3,0,3,亞東-新竹,2024-12-18,2184
5871,中租-KY,3,0,3,亞東-新竹,2024-12-18,2184
9950,萬國通,3,0,3,亞東-新竹,2024-12-18,2184
3661,世芯-KY,10,7,3,亞東-新竹,2024-12-18,2184
1303,南亞,2,0,2,亞東-新竹,2024-12-18,2184
00687B,國泰20年美債,400,0,400,亞東-新竹,2024-12-19,2184
00712,復華富時不動產,315,0,315,亞東-新竹,2024-12-19,2184
2883,凱基金,200,5,195,亞東-新竹,2024-12-19,2184
00937B,群益ESG投等債20,115,0,115,亞東-新竹,2024-12-19,2184
2882,國泰金,82,0,82,亞東-新竹,2024-12-19,2184
00751B,元大AAA至A公司債,57,0,57,亞東-新竹,2024-12-19,2184
00688L,國泰20年美債正2,46,0,46,亞東-新竹,2024-12-19,2184
00680L,元大美債20正2,45,0,45,亞東-新竹,2024-12-19,2184
00918,大華優利高填息30,42,0,42,亞東-新竹,2024-12-19,2184
2845,遠東銀,33,2,31,亞東-新竹,2024-12-19,2184
2367,燿華,30,0,30,亞東-新竹,2024-12-19,2184
2886,兆豐金,24,0,24,亞東-新竹,2024-12-19,2184
6962,ITH-KY,23,1,22,亞東-新竹,2024-12-19,2184
9907,統一實,21,0,21,亞東-新竹,2024-12-19,2184
00706L,期元大S＆P日圓正2,20,0,20,亞東-新竹,2024-12-19,2184
2881,富邦金,20,0,20,亞東-新竹,2024-12-19,2184
2888,新光金,20,0,20,亞東-新竹,2024-12-19,2184
2303,聯電,25,6,19,亞東-新竹,2024-12-19,2184
8047,星雲,17,0,17,亞東-新竹,2024-12-19,2184
00933B,國泰10Y+金融債,16,0,16,亞東-新竹,2024-12-19,2184
5880,合庫金,16,0,16,亞東-新竹,2024-12-19,2184
6176,瑞儀,15,0,15,亞東-新竹,2024-12-19,2184
2033,佳大,12,0,12,亞東-新竹,2024-12-19,2184
2887,台新金,12,0,12,亞東-新竹,2024-12-19,2184
1102,亞泥,12,0,12,亞東-新竹,2024-12-19,2184
00878,國泰永續高股息,11,0,11,亞東-新竹,2024-12-19,2184
6426,統新,11,0,11,亞東-新竹,2024-12-19,2184
00915,凱基優選高股息30,14,3,11,亞東-新竹,2024-12-19,2184
00930,永豐ESG低碳高息,10,0,10,亞東-新竹,2024-12-19,2184
00950B,凱基A級公司債,10,0,10,亞東-新竹,2024-12-19,2184
1710,東聯,10,0,10,亞東-新竹,2024-12-19,2184
2409,友達,10,0,10,亞東-新竹,2024-12-19,2184
2468,華經,16,6,10,亞東-新竹,2024-12-19,2184
3694,海華,15,5,10,亞東-新竹,2024-12-19,2184
2002,中鋼,8,0,8,亞東-新竹,2024-12-19,2184
6279,胡連,8,0,8,亞東-新竹,2024-12-19,2184
00830,國泰費城半導體,14,7,7,亞東-新竹,2024-12-19,2184
00795B,中信美國公債20年,7,0,7,亞東-新竹,2024-12-19,2184
2605,新興,7,0,7,亞東-新竹,2024-12-19,2184
4931,新盛力,44,37,7,亞東-新竹,2024-12-19,2184
6885,全福生技,7,0,7,亞東-新竹,2024-12-19,2184
1537,廣隆,7,0,7,亞東-新竹,2024-12-19,2184
1702,南僑,6,0,6,亞東-新竹,2024-12-19,2184
2884,玉山金,6,0,6,亞東-新竹,2024-12-19,2184
6558,興能高,31,25,6,亞東-新竹,2024-12-19,2184
2892,第一金,5,0,5,亞東-新竹,2024-12-19,2184
00940,元大台灣價值高息,5,0,5,亞東-新竹,2024-12-19,2184
1504,東元,5,0,5,亞東-新竹,2024-12-19,2184
1815,富喬,5,0,5,亞東-新竹,2024-12-19,2184
2313,華通,5,0,5,亞東-新竹,2024-12-19,2184
