Ticker,Name,buy,sell,diff,Branch,Date,Branch_Code
6282,康舒,100,1,99,新百王,2023-01-03,6210
3705,永信,55,1,54,新百王,2023-01-03,6210
1718,中纖,50,0,50,新百王,2023-01-03,6210
8171,天宇,40,4,36,新百王,2023-01-03,6210
00637L,元大滬深300正2,86,56,30,新百王,2023-01-03,6210
3479,安勤,35,11,24,新百王,2023-01-03,6210
6443,元晶,57,33,24,新百王,2023-01-03,6210
2867,三商壽,21,0,21,新百王,2023-01-03,6210
3027,盛達,67,46,21,新百王,2023-01-03,6210
1713,國化,35,17,18,新百王,2023-01-03,6210
6770,力積電,20,3,17,新百王,2023-01-03,6210
6535,順藥,16,0,16,新百王,2023-01-03,6210
5483,中美晶,17,2,15,新百王,2023-01-03,6210
00878,國泰永續高股息,23,10,13,新百王,2023-01-03,6210
2883,凱基金,37,26,11,新百王,2023-01-03,6210
00772B,中信高評級公司債,11,0,11,新百王,2023-01-03,6210
6508,惠光,11,0,11,新百王,2023-01-03,6210
1304,台聚,11,0,11,新百王,2023-01-03,6210
2607,榮運,10,0,10,新百王,2023-01-03,6210
6625,必應,31,21,10,新百王,2023-01-03,6210
2612,中航,10,0,10,新百王,2023-01-03,6210
1316,上曜,10,0,10,新百王,2023-01-03,6210
8033,雷虎,11,1,10,新百王,2023-01-03,6210
2061,風青,10,0,10,新百王,2023-01-03,6210
2886,兆豐金,14,5,9,新百王,2023-01-03,6210
2368,金像電,11,2,9,新百王,2023-01-03,6210
2614,東森,8,0,8,新百王,2023-01-03,6210
4167,松瑞藥,17,9,8,新百王,2023-01-03,6210
4171,瑞基,27,19,8,新百王,2023-01-03,6210
2409,友達,9,1,8,新百王,2023-01-03,6210
5439,高技,8,0,8,新百王,2023-01-03,6210
2634,漢翔,11,3,8,新百王,2023-01-03,6210
1342,八貫,19,13,6,新百王,2023-01-03,6210
6288,聯嘉,6,0,6,新百王,2023-01-03,6210
3162,精確,9,3,6,新百王,2023-01-03,6210
4934,太極,6,0,6,新百王,2023-01-03,6210
5481,新華,6,0,6,新百王,2023-01-03,6210
2480,敦陽科,7,1,6,新百王,2023-01-03,6210
00773B,中信優先金融債,5,0,5,新百王,2023-01-03,6210
2471,資通,5,0,5,新百王,2023-01-03,6210
3594,磐儀,5,0,5,新百王,2023-01-03,6210
4707,磐亞,5,0,5,新百王,2023-01-03,6210
2419,仲琦,5,0,5,新百王,2023-01-03,6210
3432,台端,5,0,5,新百王,2023-01-03,6210
00712,復華富時不動產,5,0,5,新百王,2023-01-03,6210
00673R,期元大S＆P原油反1,5,0,5,新百王,2023-01-03,6210
3236,千如,5,0,5,新百王,2023-01-03,6210
1605,華新,54,49,5,新百王,2023-01-03,6210
2891,中信金,105,100,5,新百王,2023-01-03,6210
2885,元大金,4,0,4,新百王,2023-01-03,6210
3712,永崴投控,179,21,158,新百王,2023-01-04,6210
00676R,富邦臺灣加權反1,100,0,100,新百王,2023-01-04,6210
2834,臺企銀,80,21,59,新百王,2023-01-04,6210
00679B,元大美債20年,48,0,48,新百王,2023-01-04,6210
00637L,元大滬深300正2,109,68,41,新百王,2023-01-04,6210
00632R,元大台灣50反1,55,20,35,新百王,2023-01-04,6210
2538,基泰,31,0,31,新百王,2023-01-04,6210
2609,陽明,28,1,27,新百王,2023-01-04,6210
00664R,國泰臺灣加權反1,25,0,25,新百王,2023-01-04,6210
4167,松瑞藥,54,32,22,新百王,2023-01-04,6210
2344,華邦電,22,0,22,新百王,2023-01-04,6210
3545,敦泰,22,2,20,新百王,2023-01-04,6210
6461,益得,20,0,20,新百王,2023-01-04,6210
9921,巨大,20,0,20,新百王,2023-01-04,6210
5608,四維航,25,6,19,新百王,2023-01-04,6210
1417,嘉裕,26,8,18,新百王,2023-01-04,6210
8171,天宇,45,28,17,新百王,2023-01-04,6210
2884,玉山金,16,0,16,新百王,2023-01-04,6210
1101,台泥,16,0,16,新百王,2023-01-04,6210
4743,合一,25,9,16,新百王,2023-01-04,6210
2498,宏達電,74,59,15,新百王,2023-01-04,6210
2867,三商壽,15,0,15,新百王,2023-01-04,6210
2444,兆勁,16,2,14,新百王,2023-01-04,6210
6438,迅得,13,0,13,新百王,2023-01-04,6210
2618,長榮航,21,8,13,新百王,2023-01-04,6210
2368,金像電,16,3,13,新百王,2023-01-04,6210
2634,漢翔,12,0,12,新百王,2023-01-04,6210
00772B,中信高評級公司債,12,0,12,新百王,2023-01-04,6210
00715L,期街口布蘭特正2,14,3,11,新百王,2023-01-04,6210
5905,南仁湖,11,0,11,新百王,2023-01-04,6210
2002,中鋼,11,1,10,新百王,2023-01-04,6210
2465,麗臺,42,32,10,新百王,2023-01-04,6210
2883,凱基金,10,0,10,新百王,2023-01-04,6210
5469,瀚宇博,10,0,10,新百王,2023-01-04,6210
1301,台塑,10,0,10,新百王,2023-01-04,6210
1342,八貫,18,8,10,新百王,2023-01-04,6210
6612,奈米醫材,9,0,9,新百王,2023-01-04,6210
2481,強茂,9,1,8,新百王,2023-01-04,6210
1504,東元,8,0,8,新百王,2023-01-04,6210
6806,森崴能源,48,40,8,新百王,2023-01-04,6210
8222,寶一,9,1,8,新百王,2023-01-04,6210
2317,鴻海,14,7,7,新百王,2023-01-04,6210
8937,合騏,7,0,7,新百王,2023-01-04,6210
00725B,國泰投資級公司債,7,0,7,新百王,2023-01-04,6210
2406,國碩,7,0,7,新百王,2023-01-04,6210
2851,中再保,7,0,7,新百王,2023-01-04,6210
3128,昇銳,8,1,7,新百王,2023-01-04,6210
1701,中化,39,32,7,新百王,2023-01-04,6210
2886,兆豐金,6,0,6,新百王,2023-01-04,6210
2425,承啟,6,0,6,新百王,2023-01-04,6210
00665L,富邦�琤肭磪囓�2,530,180,350,新百王,2023-01-05,6210
00753L,中信中國50正2,296,64,232,新百王,2023-01-05,6210
2460,建通,145,0,145,新百王,2023-01-05,6210
2834,臺企銀,90,0,90,新百王,2023-01-05,6210
5009,榮剛,71,14,57,新百王,2023-01-05,6210
4162,智擎,62,7,55,新百王,2023-01-05,6210
1504,東元,53,1,52,新百王,2023-01-05,6210
6443,元晶,78,32,46,新百王,2023-01-05,6210
1314,中石化,39,0,39,新百王,2023-01-05,6210
1444,力麗,36,0,36,新百王,2023-01-05,6210
00706L,期元大S＆P日圓正2,31,0,31,新百王,2023-01-05,6210
3479,安勤,36,11,25,新百王,2023-01-05,6210
00715L,期街口布蘭特正2,25,3,22,新百王,2023-01-05,6210
4744,皇將,23,2,21,新百王,2023-01-05,6210
2601,益航,20,0,20,新百王,2023-01-05,6210
8110,華東,20,0,20,新百王,2023-01-05,6210
2634,漢翔,26,6,20,新百王,2023-01-05,6210
2867,三商壽,30,12,18,新百王,2023-01-05,6210
2206,三陽工業,25,10,15,新百王,2023-01-05,6210
00632R,元大台灣50反1,156,142,14,新百王,2023-01-05,6210
1316,上曜,14,0,14,新百王,2023-01-05,6210
1736,喬山,39,25,14,新百王,2023-01-05,6210
1760,寶齡富錦,26,12,14,新百王,2023-01-05,6210
00679B,元大美債20年,15,2,13,新百王,2023-01-05,6210
2031,新光鋼,12,0,12,新百王,2023-01-05,6210
3037,欣興,44,33,11,新百王,2023-01-05,6210
4979,華星光,11,0,11,新百王,2023-01-05,6210
1522,堤維西,11,0,11,新百王,2023-01-05,6210
6182,合晶,12,2,10,新百王,2023-01-05,6210
1752,南光,36,26,10,新百王,2023-01-05,6210
8028,昇陽半導體,10,0,10,新百王,2023-01-05,6210
6234,高僑,10,0,10,新百王,2023-01-05,6210
00772B,中信高評級公司債,10,0,10,新百王,2023-01-05,6210
6570,維田,10,0,10,新百王,2023-01-05,6210
2882,國泰金,21,11,10,新百王,2023-01-05,6210
2009,第一銅,15,6,9,新百王,2023-01-05,6210
6109,亞元,9,0,9,新百王,2023-01-05,6210
1605,華新,59,50,9,新百王,2023-01-05,6210
4726,永昕,9,0,9,新百王,2023-01-05,6210
8222,寶一,22,13,9,新百王,2023-01-05,6210
4989,榮科,8,0,8,新百王,2023-01-05,6210
6477,安集,8,0,8,新百王,2023-01-05,6210
4167,松瑞藥,22,14,8,新百王,2023-01-05,6210
8358,金居,22,15,7,新百王,2023-01-05,6210
8069,元太,32,25,7,新百王,2023-01-05,6210
2340,台亞,7,0,7,新百王,2023-01-05,6210
2313,華通,7,0,7,新百王,2023-01-05,6210
5425,台半,14,7,7,新百王,2023-01-05,6210
4961,天鈺,12,5,7,新百王,2023-01-05,6210
6446,藥華藥,6,0,6,新百王,2023-01-05,6210
1815,富喬,210,0,210,新百王,2023-01-06,6210
2867,三商壽,215,7,208,新百王,2023-01-06,6210
4113,聯上,110,0,110,新百王,2023-01-06,6210
2834,臺企銀,60,0,60,新百王,2023-01-06,6210
00665L,富邦�琤肭磪囓�2,365,315,50,新百王,2023-01-06,6210
00795B,中信美國公債20年,50,0,50,新百王,2023-01-06,6210
2359,所羅門,52,7,45,新百王,2023-01-06,6210
00679B,元大美債20年,42,1,41,新百王,2023-01-06,6210
00881,國泰台灣5G+,31,0,31,新百王,2023-01-06,6210
00676R,富邦臺灣加權反1,30,0,30,新百王,2023-01-06,6210
1529,樂事綠能,154,130,24,新百王,2023-01-06,6210
2236,百達-KY,23,1,22,新百王,2023-01-06,6210
8171,天宇,61,39,22,新百王,2023-01-06,6210
6589,台康生技,49,27,22,新百王,2023-01-06,6210
3714,富采,25,4,21,新百王,2023-01-06,6210
3027,盛達,30,11,19,新百王,2023-01-06,6210
3594,磐儀,18,0,18,新百王,2023-01-06,6210
2618,長榮航,16,0,16,新百王,2023-01-06,6210
00720B,元大投資級公司債,13,0,13,新百王,2023-01-06,6210
5009,榮剛,11,0,11,新百王,2023-01-06,6210
3705,永信,16,5,11,新百王,2023-01-06,6210
3576,聯合再生,17,6,11,新百王,2023-01-06,6210
6770,力積電,19,8,11,新百王,2023-01-06,6210
2330,台積電,15,5,10,新百王,2023-01-06,6210
8110,華東,10,0,10,新百王,2023-01-06,6210
6411,晶焱,10,0,10,新百王,2023-01-06,6210
1611,中電,10,0,10,新百王,2023-01-06,6210
6125,廣運,10,0,10,新百王,2023-01-06,6210
00650L,復華香港正2,10,0,10,新百王,2023-01-06,6210
6139,亞翔,34,24,10,新百王,2023-01-06,6210
8289,泰藝,10,0,10,新百王,2023-01-06,6210
6118,建達,10,1,9,新百王,2023-01-06,6210
2317,鴻海,15,6,9,新百王,2023-01-06,6210
1519,華城,37,29,8,新百王,2023-01-06,6210
8150,南茂,8,0,8,新百王,2023-01-06,6210
2732,六角,8,0,8,新百王,2023-01-06,6210
1752,南光,91,83,8,新百王,2023-01-06,6210
2501,國建,7,0,7,新百王,2023-01-06,6210
6625,必應,7,0,7,新百王,2023-01-06,6210
3704,合勤控,25,18,7,新百王,2023-01-06,6210
2707,晶華,8,1,7,新百王,2023-01-06,6210
2313,華通,7,0,7,新百王,2023-01-06,6210
6235,華孚,6,0,6,新百王,2023-01-06,6210
4129,聯合,6,0,6,新百王,2023-01-06,6210
2609,陽明,14,8,6,新百王,2023-01-06,6210
6266,泰詠,6,0,6,新百王,2023-01-06,6210
5905,南仁湖,9,3,6,新百王,2023-01-06,6210
6186,新潤,6,0,6,新百王,2023-01-06,6210
1305,華夏,5,0,5,新百王,2023-01-06,6210
4989,榮科,5,0,5,新百王,2023-01-06,6210
3481,群創,439,42,397,新百王,2023-01-09,6210
00632R,元大台灣50反1,313,0,313,新百王,2023-01-09,6210
2867,三商壽,220,0,220,新百王,2023-01-09,6210
00878,國泰永續高股息,111,17,94,新百王,2023-01-09,6210
3013,晟銘電,90,8,82,新百王,2023-01-09,6210
00900,富邦特選高股息30,80,0,80,新百王,2023-01-09,6210
0061,元大寶滬深,60,0,60,新百王,2023-01-09,6210
2328,廣宇,61,1,60,新百王,2023-01-09,6210
3037,欣興,77,19,58,新百王,2023-01-09,6210
4960,誠美材,50,0,50,新百王,2023-01-09,6210
00637L,元大滬深300正2,125,89,36,新百王,2023-01-09,6210
5426,振發,35,0,35,新百王,2023-01-09,6210
5009,榮剛,44,15,29,新百王,2023-01-09,6210
2317,鴻海,43,15,28,新百王,2023-01-09,6210
00682U,期元大美元指數,28,0,28,新百王,2023-01-09,6210
2851,中再保,27,0,27,新百王,2023-01-09,6210
00631L,元大台灣50正2,35,8,27,新百王,2023-01-09,6210
00664R,國泰臺灣加權反1,25,0,25,新百王,2023-01-09,6210
6770,力積電,64,39,25,新百王,2023-01-09,6210
6109,亞元,71,48,23,新百王,2023-01-09,6210
6535,順藥,23,0,23,新百王,2023-01-09,6210
00680L,元大美債20正2,20,0,20,新百王,2023-01-09,6210
1447,力鵬,20,0,20,新百王,2023-01-09,6210
2929,淘帝-KY,30,10,20,新百王,2023-01-09,6210
4113,聯上,20,0,20,新百王,2023-01-09,6210
6125,廣運,20,0,20,新百王,2023-01-09,6210
6494,九齊,20,0,20,新百王,2023-01-09,6210
2369,菱生,20,0,20,新百王,2023-01-09,6210
2402,毅嘉,19,0,19,新百王,2023-01-09,6210
00881,國泰台灣5G+,21,3,18,新百王,2023-01-09,6210
4726,永昕,17,0,17,新百王,2023-01-09,6210
1810,和成,15,0,15,新百王,2023-01-09,6210
4919,新唐,23,8,15,新百王,2023-01-09,6210
6570,維田,26,12,14,新百王,2023-01-09,6210
2609,陽明,46,32,14,新百王,2023-01-09,6210
2376,技嘉,15,2,13,新百王,2023-01-09,6210
2208,台船,13,0,13,新百王,2023-01-09,6210
4106,雃博,15,2,13,新百王,2023-01-09,6210
2455,全新,23,10,13,新百王,2023-01-09,6210
2349,錸德,12,0,12,新百王,2023-01-09,6210
3022,威強電,12,0,12,新百王,2023-01-09,6210
8046,南電,14,3,11,新百王,2023-01-09,6210
2497,怡利電,10,0,10,新百王,2023-01-09,6210
2439,美律,26,16,10,新百王,2023-01-09,6210
1710,東聯,10,0,10,新百王,2023-01-09,6210
1815,富喬,10,0,10,新百王,2023-01-09,6210
3438,類比科,10,0,10,新百王,2023-01-09,6210
2601,益航,10,0,10,新百王,2023-01-09,6210
3059,華晶科,10,0,10,新百王,2023-01-09,6210
1760,寶齡富錦,34,25,9,新百王,2023-01-09,6210
00665L,富邦�琤肭磪囓�2,640,236,404,新百王,2023-01-10,6210
00687B,國泰20年美債,160,0,160,新百王,2023-01-10,6210
2851,中再保,68,12,56,新百王,2023-01-10,6210
4155,訊映,51,0,51,新百王,2023-01-10,6210
00632R,元大台灣50反1,173,123,50,新百王,2023-01-10,6210
2206,三陽工業,58,9,49,新百王,2023-01-10,6210
2482,連宇,59,27,32,新百王,2023-01-10,6210
2010,春源,31,0,31,新百王,2023-01-10,6210
00885,富邦越南,31,3,28,新百王,2023-01-10,6210
4113,聯上,21,0,21,新百王,2023-01-10,6210
00680L,元大美債20正2,21,0,21,新百王,2023-01-10,6210
2929,淘帝-KY,32,12,20,新百王,2023-01-10,6210
00919,群益台灣精選高息,20,0,20,新百王,2023-01-10,6210
8105,凌巨,40,20,20,新百王,2023-01-10,6210
00753L,中信中國50正2,280,260,20,新百王,2023-01-10,6210
6443,元晶,60,40,20,新百王,2023-01-10,6210
6806,森崴能源,22,5,17,新百王,2023-01-10,6210
4743,合一,16,0,16,新百王,2023-01-10,6210
6129,普誠,17,2,15,新百王,2023-01-10,6210
00715L,期街口布蘭特正2,18,5,13,新百王,2023-01-10,6210
3704,合勤控,33,20,13,新百王,2023-01-10,6210
4167,松瑞藥,12,0,12,新百王,2023-01-10,6210
4114,健喬,22,11,11,新百王,2023-01-10,6210
3265,台星科,11,0,11,新百王,2023-01-10,6210
1516,川飛,14,3,11,新百王,2023-01-10,6210
4763,材料-KY,56,45,11,新百王,2023-01-10,6210
2369,菱生,10,0,10,新百王,2023-01-10,6210
2537,聯上發,10,0,10,新百王,2023-01-10,6210
5321,美而快,19,9,10,新百王,2023-01-10,6210
2634,漢翔,10,0,10,新百王,2023-01-10,6210
2892,第一金,10,0,10,新百王,2023-01-10,6210
6508,惠光,10,0,10,新百王,2023-01-10,6210
00631L,元大台灣50正2,19,10,9,新百王,2023-01-10,6210
3624,光頡,15,6,9,新百王,2023-01-10,6210
2027,大成鋼,11,2,9,新百王,2023-01-10,6210
3685,元創精密,12,3,9,新百王,2023-01-10,6210
1760,寶齡富錦,47,38,9,新百王,2023-01-10,6210
2882,國泰金,11,2,9,新百王,2023-01-10,6210
00673R,期元大S＆P原油反1,8,0,8,新百王,2023-01-10,6210
4989,榮科,8,0,8,新百王,2023-01-10,6210
1560,中砂,29,21,8,新百王,2023-01-10,6210
2609,陽明,16,8,8,新百王,2023-01-10,6210
1736,喬山,60,53,7,新百王,2023-01-10,6210
1514,亞力,8,1,7,新百王,2023-01-10,6210
3022,威強電,7,0,7,新百王,2023-01-10,6210
3481,群創,12,5,7,新百王,2023-01-10,6210
5425,台半,18,11,7,新百王,2023-01-10,6210
6282,康舒,7,0,7,新百王,2023-01-10,6210
6274,台燿,26,19,7,新百王,2023-01-10,6210
8171,天宇,11,4,7,新百王,2023-01-10,6210
1444,力麗,100,0,100,新百王,2023-01-11,6210
2014,中鴻,92,0,92,新百王,2023-01-11,6210
4960,誠美材,70,0,70,新百王,2023-01-11,6210
4113,聯上,69,0,69,新百王,2023-01-11,6210
2607,榮運,64,4,60,新百王,2023-01-11,6210
2468,華經,48,12,36,新百王,2023-01-11,6210
2412,中華電,44,9,35,新百王,2023-01-11,6210
1752,南光,39,12,27,新百王,2023-01-11,6210
00664R,國泰臺灣加權反1,25,0,25,新百王,2023-01-11,6210
1457,宜進,23,0,23,新百王,2023-01-11,6210
2206,三陽工業,43,21,22,新百王,2023-01-11,6210
6186,新潤,45,23,22,新百王,2023-01-11,6210
4129,聯合,20,0,20,新百王,2023-01-11,6210
4979,華星光,32,12,20,新百王,2023-01-11,6210
0056,元大高股息,23,3,20,新百王,2023-01-11,6210
2482,連宇,20,2,18,新百王,2023-01-11,6210
1513,中興電,68,51,17,新百王,2023-01-11,6210
4904,遠傳,18,2,16,新百王,2023-01-11,6210
3591,艾笛森,16,0,16,新百王,2023-01-11,6210
2884,玉山金,17,2,15,新百王,2023-01-11,6210
2609,陽明,60,46,14,新百王,2023-01-11,6210
6649,台生材,14,0,14,新百王,2023-01-11,6210
5483,中美晶,15,1,14,新百王,2023-01-11,6210
00632R,元大台灣50反1,113,100,13,新百王,2023-01-11,6210
6770,力積電,15,3,12,新百王,2023-01-11,6210
6109,亞元,14,2,12,新百王,2023-01-11,6210
1591,駿吉-KY,12,0,12,新百王,2023-01-11,6210
4164,承業醫,11,0,11,新百王,2023-01-11,6210
00670L,富邦NASDAQ正2,11,0,11,新百王,2023-01-11,6210
4114,健喬,13,3,10,新百王,2023-01-11,6210
6754,匯僑設計,10,0,10,新百王,2023-01-11,6210
2812,台中銀,10,0,10,新百王,2023-01-11,6210
8032,光菱,10,0,10,新百王,2023-01-11,6210
3705,永信,10,0,10,新百王,2023-01-11,6210
00687B,國泰20年美債,10,0,10,新百王,2023-01-11,6210
8028,昇陽半導體,10,0,10,新百王,2023-01-11,6210
2601,益航,10,0,10,新百王,2023-01-11,6210
2313,華通,9,0,9,新百王,2023-01-11,6210
2105,正新,10,1,9,新百王,2023-01-11,6210
2707,晶華,9,0,9,新百王,2023-01-11,6210
1503,士電,15,6,9,新百王,2023-01-11,6210
5902,德記,8,0,8,新百王,2023-01-11,6210
6589,台康生技,12,4,8,新百王,2023-01-11,6210
6274,台燿,10,2,8,新百王,2023-01-11,6210
5439,高技,8,0,8,新百王,2023-01-11,6210
6788,華景電,8,1,7,新百王,2023-01-11,6210
2028,威致,12,5,7,新百王,2023-01-11,6210
3356,奇偶,7,0,7,新百王,2023-01-11,6210
6111,大宇資,8,1,7,新百王,2023-01-11,6210
3376,新日興,7,0,7,新百王,2023-01-11,6210
00665L,富邦�琤肭磪囓�2,557,70,487,新百王,2023-01-12,6210
00885,富邦越南,156,0,156,新百王,2023-01-12,6210
00753L,中信中國50正2,296,231,65,新百王,2023-01-12,6210
2607,榮運,61,0,61,新百王,2023-01-12,6210
00637L,元大滬深300正2,115,58,57,新百王,2023-01-12,6210
1314,中石化,48,0,48,新百王,2023-01-12,6210
2812,台中銀,40,0,40,新百王,2023-01-12,6210
6282,康舒,37,0,37,新百王,2023-01-12,6210
3093,港建*,30,0,30,新百王,2023-01-12,6210
4113,聯上,30,0,30,新百王,2023-01-12,6210
00687B,國泰20年美債,30,0,30,新百王,2023-01-12,6210
2852,第一保,28,0,28,新百王,2023-01-12,6210
8033,雷虎,27,0,27,新百王,2023-01-12,6210
4904,遠傳,27,1,26,新百王,2023-01-12,6210
3013,晟銘電,30,5,25,新百王,2023-01-12,6210
2498,宏達電,85,60,25,新百王,2023-01-12,6210
4977,眾達-KY,56,32,24,新百王,2023-01-12,6210
6649,台生材,19,0,19,新百王,2023-01-12,6210
1752,南光,32,14,18,新百王,2023-01-12,6210
6609,瀧澤科,38,20,18,新百王,2023-01-12,6210
2444,兆勁,18,0,18,新百王,2023-01-12,6210
2615,萬海,39,22,17,新百王,2023-01-12,6210
00642U,期元大S＆P石油,18,2,16,新百王,2023-01-12,6210
00673R,期元大S＆P原油反1,15,0,15,新百王,2023-01-12,6210
2929,淘帝-KY,25,10,15,新百王,2023-01-12,6210
3037,欣興,21,7,14,新百王,2023-01-12,6210
2317,鴻海,15,1,14,新百王,2023-01-12,6210
3594,磐儀,14,0,14,新百王,2023-01-12,6210
00720B,元大投資級公司債,16,3,13,新百王,2023-01-12,6210
1313,聯成,11,0,11,新百王,2023-01-12,6210
1612,宏泰,24,13,11,新百王,2023-01-12,6210
4114,健喬,15,4,11,新百王,2023-01-12,6210
2368,金像電,11,1,10,新百王,2023-01-12,6210
2601,益航,10,0,10,新百王,2023-01-12,6210
1304,台聚,10,0,10,新百王,2023-01-12,6210
2867,三商壽,10,0,10,新百王,2023-01-12,6210
1513,中興電,20,10,10,新百王,2023-01-12,6210
4960,誠美材,10,0,10,新百王,2023-01-12,6210
2029,盛餘,10,0,10,新百王,2023-01-12,6210
2412,中華電,19,9,10,新百王,2023-01-12,6210
2884,玉山金,16,7,9,新百王,2023-01-12,6210
6245,立端,31,23,8,新百王,2023-01-12,6210
5321,美而快,38,30,8,新百王,2023-01-12,6210
3701,大眾控,8,0,8,新百王,2023-01-12,6210
1584,精剛,36,28,8,新百王,2023-01-12,6210
9955,佳龍,8,0,8,新百王,2023-01-12,6210
8403,盛弘,8,0,8,新百王,2023-01-12,6210
2609,陽明,22,14,8,新百王,2023-01-12,6210
3293,鈊象,9,2,7,新百王,2023-01-12,6210
6509,聚和,7,0,7,新百王,2023-01-12,6210
2317,鴻海,286,1,285,新百王,2023-01-13,6210
00720B,元大投資級公司債,191,11,180,新百王,2023-01-13,6210
2206,三陽工業,119,30,89,新百王,2023-01-13,6210
00665L,富邦�琤肭磪囓�2,184,130,54,新百王,2023-01-13,6210
4904,遠傳,47,0,47,新百王,2023-01-13,6210
1909,榮成,53,6,47,新百王,2023-01-13,6210
2609,陽明,89,46,43,新百王,2023-01-13,6210
2812,台中銀,40,0,40,新百王,2023-01-13,6210
1718,中纖,40,1,39,新百王,2023-01-13,6210
00642U,期元大S＆P石油,36,0,36,新百王,2023-01-13,6210
6282,康舒,41,6,35,新百王,2023-01-13,6210
8105,凌巨,30,0,30,新百王,2023-01-13,6210
00682U,期元大美元指數,30,0,30,新百王,2023-01-13,6210
2852,第一保,28,0,28,新百王,2023-01-13,6210
8050,廣積,28,1,27,新百王,2023-01-13,6210
00654R,富邦印度反1,21,0,21,新百王,2023-01-13,6210
2388,威盛,23,2,21,新百王,2023-01-13,6210
2359,所羅門,21,0,21,新百王,2023-01-13,6210
6142,友勁,20,0,20,新百王,2023-01-13,6210
6770,力積電,20,1,19,新百王,2023-01-13,6210
00632R,元大台灣50反1,48,30,18,新百王,2023-01-13,6210
1316,上曜,18,0,18,新百王,2023-01-13,6210
00882,中信中國高股息,35,18,17,新百王,2023-01-13,6210
3624,光頡,20,4,16,新百王,2023-01-13,6210
2634,漢翔,15,0,15,新百王,2023-01-13,6210
4550,長佳,13,0,13,新百王,2023-01-13,6210
6109,亞元,12,0,12,新百王,2023-01-13,6210
6104,創惟,25,13,12,新百王,2023-01-13,6210
2886,兆豐金,17,5,12,新百王,2023-01-13,6210
00670L,富邦NASDAQ正2,14,3,11,新百王,2023-01-13,6210
5483,中美晶,23,12,11,新百王,2023-01-13,6210
4155,訊映,11,0,11,新百王,2023-01-13,6210
00725B,國泰投資級公司債,11,0,11,新百王,2023-01-13,6210
6443,元晶,15,4,11,新百王,2023-01-13,6210
2323,中環,17,6,11,新百王,2023-01-13,6210
1810,和成,12,2,10,新百王,2023-01-13,6210
00664R,國泰臺灣加權反1,10,0,10,新百王,2023-01-13,6210
1605,華新,36,26,10,新百王,2023-01-13,6210
2444,兆勁,10,0,10,新百王,2023-01-13,6210
00680L,元大美債20正2,10,0,10,新百王,2023-01-13,6210
2603,長榮,35,26,9,新百王,2023-01-13,6210
2014,中鴻,47,38,9,新百王,2023-01-13,6210
2465,麗臺,82,73,9,新百王,2023-01-13,6210
3105,穩懋,25,17,8,新百王,2023-01-13,6210
2063,世鎧,11,3,8,新百王,2023-01-13,6210
8420,明揚,16,8,8,新百王,2023-01-13,6210
00772B,中信高評級公司債,7,0,7,新百王,2023-01-13,6210
00773B,中信優先金融債,7,0,7,新百王,2023-01-13,6210
4106,雃博,7,0,7,新百王,2023-01-13,6210
00852L,國泰美國道瓊正2,6,0,6,新百王,2023-01-13,6210
00637L,元大滬深300正2,296,158,138,新百王,2023-01-16,6210
3481,群創,100,4,96,新百王,2023-01-16,6210
00882,中信中國高股息,109,16,93,新百王,2023-01-16,6210
2618,長榮航,68,2,66,新百王,2023-01-16,6210
2615,萬海,67,6,61,新百王,2023-01-16,6210
2852,第一保,56,0,56,新百王,2023-01-16,6210
1313,聯成,50,0,50,新百王,2023-01-16,6210
4726,永昕,45,1,44,新百王,2023-01-16,6210
5009,榮剛,44,0,44,新百王,2023-01-16,6210
2834,臺企銀,122,86,36,新百王,2023-01-16,6210
2014,中鴻,41,7,34,新百王,2023-01-16,6210
6282,康舒,32,1,31,新百王,2023-01-16,6210
00632R,元大台灣50反1,27,0,27,新百王,2023-01-16,6210
2369,菱生,25,0,25,新百王,2023-01-16,6210
00885,富邦越南,27,3,24,新百王,2023-01-16,6210
00878,國泰永續高股息,23,1,22,新百王,2023-01-16,6210
3704,合勤控,21,0,21,新百王,2023-01-16,6210
1909,榮成,20,0,20,新百王,2023-01-16,6210
8101,華冠,20,0,20,新百王,2023-01-16,6210
1316,上曜,20,0,20,新百王,2023-01-16,6210
00638R,元大滬深300反1,20,0,20,新百王,2023-01-16,6210
6741,91APP*-KY,28,9,19,新百王,2023-01-16,6210
4155,訊映,21,2,19,新百王,2023-01-16,6210
2317,鴻海,17,1,16,新百王,2023-01-16,6210
2616,山隆,15,0,15,新百王,2023-01-16,6210
00673R,期元大S＆P原油反1,15,0,15,新百王,2023-01-16,6210
3093,港建*,15,0,15,新百王,2023-01-16,6210
1907,永豐餘,14,0,14,新百王,2023-01-16,6210
3013,晟銘電,36,22,14,新百王,2023-01-16,6210
00679B,元大美債20年,14,0,14,新百王,2023-01-16,6210
3189,景碩,15,1,14,新百王,2023-01-16,6210
00720B,元大投資級公司債,13,0,13,新百王,2023-01-16,6210
2363,矽統,13,0,13,新百王,2023-01-16,6210
2328,廣宇,13,0,13,新百王,2023-01-16,6210
3624,光頡,16,4,12,新百王,2023-01-16,6210
00650L,復華香港正2,10,0,10,新百王,2023-01-16,6210
3419,譁裕,10,0,10,新百王,2023-01-16,6210
3037,欣興,25,15,10,新百王,2023-01-16,6210
1342,八貫,11,1,10,新百王,2023-01-16,6210
00772B,中信高評級公司債,10,0,10,新百王,2023-01-16,6210
3576,聯合再生,13,3,10,新百王,2023-01-16,6210
6625,必應,10,0,10,新百王,2023-01-16,6210
2888,新光金,12,2,10,新百王,2023-01-16,6210
4153,鈺緯,9,0,9,新百王,2023-01-16,6210
2603,長榮,21,12,9,新百王,2023-01-16,6210
6443,元晶,8,1,7,新百王,2023-01-16,6210
3484,崧騰,6,0,6,新百王,2023-01-16,6210
9945,潤泰新,6,0,6,新百王,2023-01-16,6210
4162,智擎,21,16,5,新百王,2023-01-16,6210
4979,華星光,5,0,5,新百王,2023-01-16,6210
00753L,中信中國50正2,220,5,215,新百王,2023-01-17,6210
00665L,富邦�琤肭磪囓�2,405,211,194,新百王,2023-01-17,6210
00720B,元大投資級公司債,151,17,134,新百王,2023-01-17,6210
00900,富邦特選高股息30,80,0,80,新百王,2023-01-17,6210
6244,茂迪,50,0,50,新百王,2023-01-17,6210
4726,永昕,49,0,49,新百王,2023-01-17,6210
2614,東森,51,2,49,新百王,2023-01-17,6210
3037,欣興,49,7,42,新百王,2023-01-17,6210
2481,強茂,36,1,35,新百王,2023-01-17,6210
2618,長榮航,45,10,35,新百王,2023-01-17,6210
1529,樂事綠能,49,16,33,新百王,2023-01-17,6210
2812,台中銀,30,0,30,新百王,2023-01-17,6210
2344,華邦電,33,3,30,新百王,2023-01-17,6210
1316,上曜,20,0,20,新百王,2023-01-17,6210
2610,華航,21,1,20,新百王,2023-01-17,6210
1609,大亞,20,0,20,新百王,2023-01-17,6210
3481,群創,119,101,18,新百王,2023-01-17,6210
1795,美時,42,24,18,新百王,2023-01-17,6210
2882,國泰金,20,3,17,新百王,2023-01-17,6210
2884,玉山金,25,8,17,新百王,2023-01-17,6210
00637L,元大滬深300正2,67,51,16,新百王,2023-01-17,6210
1584,精剛,15,0,15,新百王,2023-01-17,6210
00664R,國泰臺灣加權反1,15,0,15,新百王,2023-01-17,6210
6109,亞元,17,6,11,新百王,2023-01-17,6210
00772B,中信高評級公司債,10,0,10,新百王,2023-01-17,6210
6788,華景電,13,3,10,新百王,2023-01-17,6210
3419,譁裕,10,0,10,新百王,2023-01-17,6210
6231,系微,10,0,10,新百王,2023-01-17,6210
4130,健亞,10,0,10,新百王,2023-01-17,6210
2009,第一銅,10,0,10,新百王,2023-01-17,6210
6245,立端,12,2,10,新百王,2023-01-17,6210
1434,福懋,10,0,10,新百王,2023-01-17,6210
2883,凱基金,10,0,10,新百王,2023-01-17,6210
2354,鴻準,10,0,10,新百王,2023-01-17,6210
2359,所羅門,10,0,10,新百王,2023-01-17,6210
00671R,富邦NASDAQ反1,10,0,10,新百王,2023-01-17,6210
6477,安集,10,0,10,新百王,2023-01-17,6210
2888,新光金,10,0,10,新百王,2023-01-17,6210
2881,富邦金,10,1,9,新百王,2023-01-17,6210
6116,彩晶,9,0,9,新百王,2023-01-17,6210
1443,立益物流,9,0,9,新百王,2023-01-17,6210
2388,威盛,9,0,9,新百王,2023-01-17,6210
2412,中華電,14,6,8,新百王,2023-01-17,6210
6266,泰詠,8,0,8,新百王,2023-01-17,6210
2328,廣宇,8,0,8,新百王,2023-01-17,6210
4114,健喬,23,16,7,新百王,2023-01-17,6210
00673R,期元大S＆P原油反1,7,0,7,新百王,2023-01-17,6210
3293,鈊象,8,1,7,新百王,2023-01-17,6210
6155,鈞寶,6,0,6,新百王,2023-01-17,6210
8038,長園科,6,0,6,新百王,2023-01-17,6210
2891,中信金,225,13,212,新百王,2023-01-30,6210
00632R,元大台灣50反1,367,227,140,新百王,2023-01-30,6210
00720B,元大投資級公司債,74,0,74,新百王,2023-01-30,6210
2852,第一保,59,0,59,新百王,2023-01-30,6210
00633L,富邦上証正2,50,2,48,新百王,2023-01-30,6210
9934,成霖,42,0,42,新百王,2023-01-30,6210
2317,鴻海,44,4,40,新百王,2023-01-30,6210
2609,陽明,56,18,38,新百王,2023-01-30,6210
2851,中再保,41,4,37,新百王,2023-01-30,6210
4924,欣厚-KY,36,0,36,新百王,2023-01-30,6210
4979,華星光,73,41,32,新百王,2023-01-30,6210
00795B,中信美國公債20年,31,0,31,新百王,2023-01-30,6210
1809,中釉,30,0,30,新百王,2023-01-30,6210
2402,毅嘉,30,0,30,新百王,2023-01-30,6210
3617,碩天,28,0,28,新百王,2023-01-30,6210
3013,晟銘電,25,0,25,新百王,2023-01-30,6210
2601,益航,25,1,24,新百王,2023-01-30,6210
2423,固緯,22,0,22,新百王,2023-01-30,6210
2027,大成鋼,40,20,20,新百王,2023-01-30,6210
8038,長園科,20,0,20,新百王,2023-01-30,6210
4726,永昕,20,0,20,新百王,2023-01-30,6210
6649,台生材,20,0,20,新百王,2023-01-30,6210
00893,國泰智能電動車,36,17,19,新百王,2023-01-30,6210
00772B,中信高評級公司債,19,0,19,新百王,2023-01-30,6210
4147,中裕,18,0,18,新百王,2023-01-30,6210
4977,眾達-KY,30,13,17,新百王,2023-01-30,6210
1513,中興電,44,27,17,新百王,2023-01-30,6210
6024,群益期,15,0,15,新百王,2023-01-30,6210
8155,博智,15,0,15,新百王,2023-01-30,6210
4155,訊映,28,13,15,新百王,2023-01-30,6210
2616,山隆,15,0,15,新百王,2023-01-30,6210
3624,光頡,41,26,15,新百王,2023-01-30,6210
2023,燁輝,14,1,13,新百王,2023-01-30,6210
4114,健喬,20,8,12,新百王,2023-01-30,6210
8105,凌巨,14,2,12,新百王,2023-01-30,6210
1304,台聚,12,1,11,新百王,2023-01-30,6210
2105,正新,16,5,11,新百王,2023-01-30,6210
6109,亞元,22,11,11,新百王,2023-01-30,6210
00671R,富邦NASDAQ反1,10,0,10,新百王,2023-01-30,6210
2748,雲品,10,0,10,新百王,2023-01-30,6210
1905,華紙,10,0,10,新百王,2023-01-30,6210
6139,亞翔,10,0,10,新百王,2023-01-30,6210
00638R,元大滬深300反1,10,0,10,新百王,2023-01-30,6210
6532,瑞耘,10,0,10,新百王,2023-01-30,6210
3093,港建*,14,5,9,新百王,2023-01-30,6210
8996,高力,42,33,9,新百王,2023-01-30,6210
2028,威致,10,1,9,新百王,2023-01-30,6210
5536,聖暉*,10,2,8,新百王,2023-01-30,6210
3260,威剛,14,6,8,新百王,2023-01-30,6210
00673R,期元大S＆P原油反1,8,0,8,新百王,2023-01-30,6210
00665L,富邦�琤肭磪囓�2,250,40,210,新百王,2023-01-31,6210
2834,臺企銀,158,0,158,新百王,2023-01-31,6210
00671R,富邦NASDAQ反1,166,10,156,新百王,2023-01-31,6210
2330,台積電,105,5,100,新百王,2023-01-31,6210
1529,樂事綠能,90,10,80,新百王,2023-01-31,6210
00633L,富邦上証正2,61,0,61,新百王,2023-01-31,6210
2412,中華電,62,8,54,新百王,2023-01-31,6210
6182,合晶,54,3,51,新百王,2023-01-31,6210
1514,亞力,74,26,48,新百王,2023-01-31,6210
3706,神達,47,6,41,新百王,2023-01-31,6210
00637L,元大滬深300正2,54,20,34,新百王,2023-01-31,6210
1605,華新,126,93,33,新百王,2023-01-31,6210
1721,三晃,32,0,32,新百王,2023-01-31,6210
3712,永崴投控,30,0,30,新百王,2023-01-31,6210
1524,耿鼎,30,0,30,新百王,2023-01-31,6210
2852,第一保,29,0,29,新百王,2023-01-31,6210
00632R,元大台灣50反1,26,0,26,新百王,2023-01-31,6210
4743,合一,39,14,25,新百王,2023-01-31,6210
2884,玉山金,25,0,25,新百王,2023-01-31,6210
4106,雃博,24,0,24,新百王,2023-01-31,6210
1809,中釉,23,0,23,新百王,2023-01-31,6210
6414,樺漢,23,0,23,新百王,2023-01-31,6210
2616,山隆,22,0,22,新百王,2023-01-31,6210
00905,FT臺灣Smart,21,0,21,新百王,2023-01-31,6210
2014,中鴻,20,0,20,新百王,2023-01-31,6210
00650L,復華香港正2,30,10,20,新百王,2023-01-31,6210
5871,中租-KY,18,1,17,新百王,2023-01-31,6210
1304,台聚,16,0,16,新百王,2023-01-31,6210
2609,陽明,56,41,15,新百王,2023-01-31,6210
00751B,元大AAA至A公司債,15,0,15,新百王,2023-01-31,6210
5347,世界,19,4,15,新百王,2023-01-31,6210
2892,第一金,15,0,15,新百王,2023-01-31,6210
0050,元大台灣50,17,4,13,新百王,2023-01-31,6210
3013,晟銘電,15,2,13,新百王,2023-01-31,6210
1905,華紙,13,0,13,新百王,2023-01-31,6210
00878,國泰永續高股息,22,9,13,新百王,2023-01-31,6210
6603,富強鑫,12,0,12,新百王,2023-01-31,6210
4979,華星光,87,75,12,新百王,2023-01-31,6210
5009,榮剛,13,1,12,新百王,2023-01-31,6210
2881,富邦金,20,8,12,新百王,2023-01-31,6210
3217,優群,12,1,11,新百王,2023-01-31,6210
3141,晶宏,15,4,11,新百王,2023-01-31,6210
2408,南亞科,10,0,10,新百王,2023-01-31,6210
2886,兆豐金,10,0,10,新百王,2023-01-31,6210
5880,合庫金,10,0,10,新百王,2023-01-31,6210
2356,英業達,10,0,10,新百王,2023-01-31,6210
1441,大東,10,0,10,新百王,2023-01-31,6210
1515,力山,10,0,10,新百王,2023-01-31,6210
00703,台新MSCI中國,10,0,10,新百王,2023-01-31,6210
00830,國泰費城半導體,10,1,9,新百王,2023-01-31,6210
3481,群創,394,4,390,新百王,2023-02-01,6210
00632R,元大台灣50反1,280,0,280,新百王,2023-02-01,6210
00676R,富邦臺灣加權反1,200,0,200,新百王,2023-02-01,6210
2614,東森,125,3,122,新百王,2023-02-01,6210
00664R,國泰臺灣加權反1,100,0,100,新百王,2023-02-01,6210
1608,華榮,61,1,60,新百王,2023-02-01,6210
1309,台達化,54,2,52,新百王,2023-02-01,6210
3372,典範,30,0,30,新百王,2023-02-01,6210
9928,中視,28,0,28,新百王,2023-02-01,6210
1809,中釉,37,11,26,新百王,2023-02-01,6210
9904,寶成,27,3,24,新百王,2023-02-01,6210
6603,富強鑫,24,1,23,新百王,2023-02-01,6210
2206,三陽工業,29,6,23,新百王,2023-02-01,6210
2891,中信金,26,3,23,新百王,2023-02-01,6210
4904,遠傳,20,0,20,新百王,2023-02-01,6210
2014,中鴻,30,10,20,新百王,2023-02-01,6210
2201,裕隆,124,105,19,新百王,2023-02-01,6210
8033,雷虎,21,3,18,新百王,2023-02-01,6210
6649,台生材,17,0,17,新百王,2023-02-01,6210
2412,中華電,44,28,16,新百王,2023-02-01,6210
00720B,元大投資級公司債,16,0,16,新百王,2023-02-01,6210
00673R,期元大S＆P原油反1,15,0,15,新百王,2023-02-01,6210
2537,聯上發,15,0,15,新百王,2023-02-01,6210
2890,永豐金,14,0,14,新百王,2023-02-01,6210
2504,國產,14,0,14,新百王,2023-02-01,6210
6245,立端,15,2,13,新百王,2023-02-01,6210
2009,第一銅,118,105,13,新百王,2023-02-01,6210
6202,盛群,12,0,12,新百王,2023-02-01,6210
5425,台半,80,68,12,新百王,2023-02-01,6210
2884,玉山金,12,0,12,新百王,2023-02-01,6210
3035,智原,37,25,12,新百王,2023-02-01,6210
3455,由田,12,1,11,新百王,2023-02-01,6210
5536,聖暉*,18,7,11,新百王,2023-02-01,6210
2007,燁興,11,0,11,新百王,2023-02-01,6210
00885,富邦越南,10,0,10,新百王,2023-02-01,6210
2450,神腦,10,0,10,新百王,2023-02-01,6210
6182,合晶,16,6,10,新百王,2023-02-01,6210
3013,晟銘電,10,0,10,新百王,2023-02-01,6210
1108,幸福,10,0,10,新百王,2023-02-01,6210
2887,台新金,10,0,10,新百王,2023-02-01,6210
3265,台星科,14,4,10,新百王,2023-02-01,6210
1903,士紙,10,0,10,新百王,2023-02-01,6210
1304,台聚,10,0,10,新百王,2023-02-01,6210
00671R,富邦NASDAQ反1,10,0,10,新百王,2023-02-01,6210
1529,樂事綠能,14,4,10,新百王,2023-02-01,6210
2609,陽明,13,3,10,新百王,2023-02-01,6210
2883,凱基金,9,0,9,新百王,2023-02-01,6210
2482,連宇,20,11,9,新百王,2023-02-01,6210
9802,鈺齊-KY,10,1,9,新百王,2023-02-01,6210
1417,嘉裕,20,12,8,新百王,2023-02-01,6210
2317,鴻海,333,1,332,新百王,2023-02-02,6210
00665L,富邦�琤肭磪囓�2,670,466,204,新百王,2023-02-02,6210
00882,中信中國高股息,300,145,155,新百王,2023-02-02,6210
2324,仁寶,150,1,149,新百王,2023-02-02,6210
2610,華航,158,25,133,新百王,2023-02-02,6210
4979,華星光,123,20,103,新百王,2023-02-02,6210
00632R,元大台灣50反1,333,235,98,新百王,2023-02-02,6210
00885,富邦越南,111,20,91,新百王,2023-02-02,6210
00878,國泰永續高股息,99,12,87,新百王,2023-02-02,6210
00900,富邦特選高股息30,80,1,79,新百王,2023-02-02,6210
4114,健喬,85,13,72,新百王,2023-02-02,6210
2834,臺企銀,100,30,70,新百王,2023-02-02,6210
2618,長榮航,57,14,43,新百王,2023-02-02,6210
2323,中環,36,2,34,新百王,2023-02-02,6210
2929,淘帝-KY,93,62,31,新百王,2023-02-02,6210
2458,義隆,37,6,31,新百王,2023-02-02,6210
1314,中石化,64,35,29,新百王,2023-02-02,6210
1514,亞力,27,0,27,新百王,2023-02-02,6210
3706,神達,25,0,25,新百王,2023-02-02,6210
8440,綠電,23,0,23,新百王,2023-02-02,6210
2603,長榮,42,20,22,新百王,2023-02-02,6210
1605,華新,57,37,20,新百王,2023-02-02,6210
8112,至上,20,0,20,新百王,2023-02-02,6210
2607,榮運,30,10,20,新百王,2023-02-02,6210
00892,富邦台灣半導體,20,0,20,新百王,2023-02-02,6210
00715L,期街口布蘭特正2,19,0,19,新百王,2023-02-02,6210
3594,磐儀,26,8,18,新百王,2023-02-02,6210
2002,中鋼,35,17,18,新百王,2023-02-02,6210
2609,陽明,57,39,18,新百王,2023-02-02,6210
2891,中信金,36,20,16,新百王,2023-02-02,6210
8358,金居,27,11,16,新百王,2023-02-02,6210
3081,聯亞,16,1,15,新百王,2023-02-02,6210
2614,東森,26,11,15,新百王,2023-02-02,6210
00905,FT臺灣Smart,15,0,15,新百王,2023-02-02,6210
6207,雷科,14,0,14,新百王,2023-02-02,6210
6443,元晶,28,14,14,新百王,2023-02-02,6210
6282,康舒,52,39,13,新百王,2023-02-02,6210
1810,和成,12,0,12,新百王,2023-02-02,6210
2538,基泰,12,0,12,新百王,2023-02-02,6210
4906,正文,12,0,12,新百王,2023-02-02,6210
2486,一詮,16,4,12,新百王,2023-02-02,6210
2520,冠德,12,0,12,新百王,2023-02-02,6210
8105,凌巨,12,0,12,新百王,2023-02-02,6210
3163,波若威,12,0,12,新百王,2023-02-02,6210
2399,映泰,16,5,11,新百王,2023-02-02,6210
00679B,元大美債20年,16,5,11,新百王,2023-02-02,6210
1905,華紙,11,0,11,新百王,2023-02-02,6210
5215,科嘉-KY,10,0,10,新百王,2023-02-02,6210
1319,東陽,10,0,10,新百王,2023-02-02,6210
3016,嘉晶,10,0,10,新百王,2023-02-02,6210
00665L,富邦�琤肭磪囓�2,381,190,191,新百王,2023-02-03,6210
2891,中信金,159,2,157,新百王,2023-02-03,6210
1710,東聯,120,0,120,新百王,2023-02-03,6210
2834,臺企銀,120,18,102,新百王,2023-02-03,6210
00637L,元大滬深300正2,119,30,89,新百王,2023-02-03,6210
00753L,中信中國50正2,280,210,70,新百王,2023-02-03,6210
2014,中鴻,64,2,62,新百王,2023-02-03,6210
2388,威盛,87,29,58,新百王,2023-02-03,6210
5009,榮剛,79,24,55,新百王,2023-02-03,6210
00679B,元大美債20年,55,0,55,新百王,2023-02-03,6210
2442,新美齊,48,0,48,新百王,2023-02-03,6210
2206,三陽工業,42,4,38,新百王,2023-02-03,6210
2023,燁輝,30,0,30,新百王,2023-02-03,6210
00686R,群益臺灣加權反1,30,0,30,新百王,2023-02-03,6210
1611,中電,28,0,28,新百王,2023-02-03,6210
2538,基泰,26,0,26,新百王,2023-02-03,6210
2929,淘帝-KY,76,50,26,新百王,2023-02-03,6210
1216,統一,26,0,26,新百王,2023-02-03,6210
00885,富邦越南,27,2,25,新百王,2023-02-03,6210
6167,久正,24,0,24,新百王,2023-02-03,6210
6148,驊宏資,24,0,24,新百王,2023-02-03,6210
2324,仁寶,20,0,20,新百王,2023-02-03,6210
8033,雷虎,27,9,18,新百王,2023-02-03,6210
2885,元大金,16,0,16,新百王,2023-02-03,6210
4911,德英,15,0,15,新百王,2023-02-03,6210
2498,宏達電,202,187,15,新百王,2023-02-03,6210
2317,鴻海,15,1,14,新百王,2023-02-03,6210
2349,錸德,14,1,13,新百王,2023-02-03,6210
3294,英濟,13,0,13,新百王,2023-02-03,6210
1513,中興電,16,3,13,新百王,2023-02-03,6210
4915,致伸,13,0,13,新百王,2023-02-03,6210
4961,天鈺,23,10,13,新百王,2023-02-03,6210
00646,元大S＆P500,13,0,13,新百王,2023-02-03,6210
2888B,新光金乙特,12,0,12,新百王,2023-02-03,6210
00715L,期街口布蘭特正2,12,0,12,新百王,2023-02-03,6210
2727,王品,12,1,11,新百王,2023-02-03,6210
2634,漢翔,22,11,11,新百王,2023-02-03,6210
3706,神達,12,1,11,新百王,2023-02-03,6210
2376,技嘉,17,6,11,新百王,2023-02-03,6210
2367,燿華,11,0,11,新百王,2023-02-03,6210
2601,益航,16,5,11,新百王,2023-02-03,6210
5425,台半,30,19,11,新百王,2023-02-03,6210
6173,信昌電,22,11,11,新百王,2023-02-03,6210
2882,國泰金,12,1,11,新百王,2023-02-03,6210
3141,晶宏,46,36,10,新百王,2023-02-03,6210
1815,富喬,10,0,10,新百王,2023-02-03,6210
00650L,復華香港正2,20,10,10,新百王,2023-02-03,6210
5439,高技,11,1,10,新百王,2023-02-03,6210
8277,商丞,10,0,10,新百王,2023-02-03,6210
6116,彩晶,9,0,9,新百王,2023-02-03,6210
2891,中信金,117,21,96,新百王,2023-02-06,6210
2834,臺企銀,90,0,90,新百王,2023-02-06,6210
00753L,中信中國50正2,311,240,71,新百王,2023-02-06,6210
2330,台積電,76,5,71,新百王,2023-02-06,6210
2367,燿華,60,0,60,新百王,2023-02-06,6210
4903,聯光通,55,1,54,新百王,2023-02-06,6210
2328,廣宇,77,31,46,新百王,2023-02-06,6210
00642U,期元大S＆P石油,38,0,38,新百王,2023-02-06,6210
2303,聯電,46,11,35,新百王,2023-02-06,6210
4744,皇將,36,1,35,新百王,2023-02-06,6210
00715L,期街口布蘭特正2,35,0,35,新百王,2023-02-06,6210
00900,富邦特選高股息30,31,0,31,新百王,2023-02-06,6210
5009,榮剛,30,0,30,新百王,2023-02-06,6210
2206,三陽工業,30,0,30,新百王,2023-02-06,6210
3231,緯創,32,5,27,新百王,2023-02-06,6210
1444,力麗,26,0,26,新百王,2023-02-06,6210
00637L,元大滬深300正2,64,39,25,新百王,2023-02-06,6210
2609,陽明,64,39,25,新百王,2023-02-06,6210
2371,大同,24,0,24,新百王,2023-02-06,6210
2103,台橡,23,0,23,新百王,2023-02-06,6210
00665L,富邦�琤肭磪囓�2,162,140,22,新百王,2023-02-06,6210
6603,富強鑫,22,1,21,新百王,2023-02-06,6210
2481,強茂,21,1,20,新百王,2023-02-06,6210
2888,新光金,20,0,20,新百王,2023-02-06,6210
1316,上曜,20,0,20,新百王,2023-02-06,6210
0050,元大台灣50,43,24,19,新百王,2023-02-06,6210
00720B,元大投資級公司債,19,0,19,新百王,2023-02-06,6210
1731,美吾華,20,1,19,新百王,2023-02-06,6210
00895,富邦未來車,20,3,17,新百王,2023-02-06,6210
3037,欣興,24,9,15,新百王,2023-02-06,6210
6695,芯鼎,14,0,14,新百王,2023-02-06,6210
2408,南亞科,13,0,13,新百王,2023-02-06,6210
4726,永昕,14,1,13,新百王,2023-02-06,6210
6541,泰福-KY,26,13,13,新百王,2023-02-06,6210
00679B,元大美債20年,11,0,11,新百王,2023-02-06,6210
2897,王道銀行,11,0,11,新百王,2023-02-06,6210
6202,盛群,11,0,11,新百王,2023-02-06,6210
2354,鴻準,15,4,11,新百王,2023-02-06,6210
00878,國泰永續高股息,20,10,10,新百王,2023-02-06,6210
6282,康舒,79,69,10,新百王,2023-02-06,6210
3576,聯合再生,10,0,10,新百王,2023-02-06,6210
6552,易華電,10,0,10,新百王,2023-02-06,6210
00671R,富邦NASDAQ反1,10,0,10,新百王,2023-02-06,6210
8105,凌巨,12,2,10,新百王,2023-02-06,6210
6546,正基,10,1,9,新百王,2023-02-06,6210
5285,界霖,10,1,9,新百王,2023-02-06,6210
2358,廷鑫,8,0,8,新百王,2023-02-06,6210
5321,美而快,11,3,8,新百王,2023-02-06,6210
2614,東森,9,1,8,新百王,2023-02-06,6210
6138,茂達,10,2,8,新百王,2023-02-06,6210
3037,欣興,66,8,58,新百王,2023-02-07,6210
1514,亞力,53,1,52,新百王,2023-02-07,6210
4903,聯光通,50,0,50,新百王,2023-02-07,6210
4744,皇將,48,0,48,新百王,2023-02-07,6210
6120,達運,42,0,42,新百王,2023-02-07,6210
00772B,中信高評級公司債,40,0,40,新百王,2023-02-07,6210
6541,泰福-KY,38,2,36,新百王,2023-02-07,6210
6613,朋億*,33,0,33,新百王,2023-02-07,6210
2618,長榮航,32,0,32,新百王,2023-02-07,6210
6770,力積電,32,0,32,新百王,2023-02-07,6210
00715L,期街口布蘭特正2,35,5,30,新百王,2023-02-07,6210
1605,華新,58,29,29,新百王,2023-02-07,6210
2498,宏達電,99,71,28,新百王,2023-02-07,6210
4106,雃博,22,0,22,新百王,2023-02-07,6210
2867,三商壽,32,11,21,新百王,2023-02-07,6210
2317,鴻海,23,3,20,新百王,2023-02-07,6210
2103,台橡,20,0,20,新百王,2023-02-07,6210
00680L,元大美債20正2,20,0,20,新百王,2023-02-07,6210
4162,智擎,31,13,18,新百王,2023-02-07,6210
1217,愛之味,40,23,17,新百王,2023-02-07,6210
1584,精剛,17,1,16,新百王,2023-02-07,6210
4931,新盛力,17,1,16,新百王,2023-02-07,6210
1809,中釉,15,0,15,新百王,2023-02-07,6210
6649,台生材,15,0,15,新百王,2023-02-07,6210
2303,聯電,43,28,15,新百王,2023-02-07,6210
4979,華星光,29,15,14,新百王,2023-02-07,6210
00632R,元大台灣50反1,50,36,14,新百王,2023-02-07,6210
0050,元大台灣50,28,15,13,新百王,2023-02-07,6210
2891,中信金,17,5,12,新百王,2023-02-07,6210
2609,陽明,12,0,12,新百王,2023-02-07,6210
2736,富野,12,0,12,新百王,2023-02-07,6210
9941,裕融,12,1,11,新百王,2023-02-07,6210
2851,中再保,11,0,11,新百王,2023-02-07,6210
00669R,國泰美國道瓊反1,11,0,11,新百王,2023-02-07,6210
2887,台新金,11,0,11,新百王,2023-02-07,6210
00631L,元大台灣50正2,16,5,11,新百王,2023-02-07,6210
1795,美時,85,74,11,新百王,2023-02-07,6210
2007,燁興,11,0,11,新百王,2023-02-07,6210
3576,聯合再生,10,0,10,新百王,2023-02-07,6210
1905,華紙,10,0,10,新百王,2023-02-07,6210
00671R,富邦NASDAQ反1,10,0,10,新百王,2023-02-07,6210
3045,台灣大,10,0,10,新百王,2023-02-07,6210
1611,中電,10,0,10,新百王,2023-02-07,6210
2890,永豐金,10,0,10,新百王,2023-02-07,6210
1810,和成,10,0,10,新百王,2023-02-07,6210
1609,大亞,10,0,10,新百王,2023-02-07,6210
1733,五鼎,10,0,10,新百王,2023-02-07,6210
1218,泰山,9,0,9,新百王,2023-02-07,6210
1701,中化,10,1,9,新百王,2023-02-07,6210
5234,達興材料,9,0,9,新百王,2023-02-07,6210
00632R,元大台灣50反1,352,0,352,新百王,2023-02-08,6210
2317,鴻海,326,5,321,新百王,2023-02-08,6210
2884,玉山金,116,0,116,新百王,2023-02-08,6210
2344,華邦電,100,1,99,新百王,2023-02-08,6210
00878,國泰永續高股息,86,20,66,新百王,2023-02-08,6210
00665L,富邦�琤肭磪囓�2,224,160,64,新百王,2023-02-08,6210
2834,臺企銀,61,0,61,新百王,2023-02-08,6210
1217,愛之味,75,17,58,新百王,2023-02-08,6210
6266,泰詠,57,0,57,新百王,2023-02-08,6210
3169,亞信,55,0,55,新百王,2023-02-08,6210
00892,富邦台灣半導體,51,0,51,新百王,2023-02-08,6210
00683L,期元大美元指正2,48,0,48,新百王,2023-02-08,6210
8171,天宇,48,9,39,新百王,2023-02-08,6210
2916,滿心,35,0,35,新百王,2023-02-08,6210
00772B,中信高評級公司債,35,0,35,新百王,2023-02-08,6210
4903,聯光通,35,0,35,新百王,2023-02-08,6210
2359,所羅門,33,0,33,新百王,2023-02-08,6210
6282,康舒,181,149,32,新百王,2023-02-08,6210
3576,聯合再生,31,0,31,新百王,2023-02-08,6210
1905,華紙,30,0,30,新百王,2023-02-08,6210
2601,益航,30,0,30,新百王,2023-02-08,6210
2890,永豐金,29,0,29,新百王,2023-02-08,6210
3264,欣銓,46,18,28,新百王,2023-02-08,6210
4744,皇將,26,0,26,新百王,2023-02-08,6210
2867,三商壽,25,0,25,新百王,2023-02-08,6210
00680L,元大美債20正2,25,0,25,新百王,2023-02-08,6210
5608,四維航,25,0,25,新百王,2023-02-08,6210
2338,光罩,39,14,25,新百王,2023-02-08,6210
00679B,元大美債20年,24,0,24,新百王,2023-02-08,6210
3093,港建*,23,0,23,新百王,2023-02-08,6210
00673R,期元大S＆P原油反1,21,0,21,新百王,2023-02-08,6210
00676R,富邦臺灣加權反1,20,0,20,新百王,2023-02-08,6210
2329,華泰,49,30,19,新百王,2023-02-08,6210
2014,中鴻,20,2,18,新百王,2023-02-08,6210
6104,創惟,24,7,17,新百王,2023-02-08,6210
00637L,元大滬深300正2,41,24,17,新百王,2023-02-08,6210
00670L,富邦NASDAQ正2,17,0,17,新百王,2023-02-08,6210
6649,台生材,16,1,15,新百王,2023-02-08,6210
1733,五鼎,15,0,15,新百王,2023-02-08,6210
4114,健喬,65,51,14,新百王,2023-02-08,6210
6244,茂迪,14,0,14,新百王,2023-02-08,6210
2412,中華電,24,10,14,新百王,2023-02-08,6210
2371,大同,14,0,14,新百王,2023-02-08,6210
9945,潤泰新,16,2,14,新百王,2023-02-08,6210
2610,華航,65,52,13,新百王,2023-02-08,6210
2458,義隆,12,0,12,新百王,2023-02-08,6210
2897,王道銀行,11,0,11,新百王,2023-02-08,6210
3163,波若威,11,0,11,新百王,2023-02-08,6210
2353,宏��,11,0,11,新百王,2023-02-08,6210
5285,界霖,31,20,11,新百王,2023-02-08,6210
2884,玉山金,496,0,496,新百王,2023-02-09,6210
2359,所羅門,65,2,63,新百王,2023-02-09,6210
1514,亞力,61,2,59,新百王,2023-02-09,6210
3037,欣興,63,8,55,新百王,2023-02-09,6210
1529,樂事綠能,51,3,48,新百王,2023-02-09,6210
2388,威盛,123,78,45,新百王,2023-02-09,6210
2530,華建,41,6,35,新百王,2023-02-09,6210
2206,三陽工業,48,16,32,新百王,2023-02-09,6210
1432,大魯閣,31,0,31,新百王,2023-02-09,6210
00632R,元大台灣50反1,30,0,30,新百王,2023-02-09,6210
2888,新光金,30,0,30,新百王,2023-02-09,6210
5608,四維航,26,1,25,新百王,2023-02-09,6210
2344,華邦電,62,37,25,新百王,2023-02-09,6210
2349,錸德,24,0,24,新百王,2023-02-09,6210
9941,裕融,26,4,22,新百王,2023-02-09,6210
1905,華紙,20,0,20,新百王,2023-02-09,6210
3564,其陽,20,0,20,新百王,2023-02-09,6210
00751B,元大AAA至A公司債,20,0,20,新百王,2023-02-09,6210
00891,中信關鍵半導體,20,0,20,新百王,2023-02-09,6210
9105,泰金寶-DR,20,0,20,新百王,2023-02-09,6210
8105,凌巨,20,0,20,新百王,2023-02-09,6210
6245,立端,33,14,19,新百王,2023-02-09,6210
2498,宏達電,72,53,19,新百王,2023-02-09,6210
2002,中鋼,17,0,17,新百王,2023-02-09,6210
00720B,元大投資級公司債,37,20,17,新百王,2023-02-09,6210
2368,金像電,16,1,15,新百王,2023-02-09,6210
9802,鈺齊-KY,24,10,14,新百王,2023-02-09,6210
6109,亞元,16,2,14,新百王,2023-02-09,6210
1736,喬山,21,7,14,新百王,2023-02-09,6210
1795,美時,41,28,13,新百王,2023-02-09,6210
00878,國泰永續高股息,16,3,13,新百王,2023-02-09,6210
6603,富強鑫,13,0,13,新百王,2023-02-09,6210
8033,雷虎,13,1,12,新百王,2023-02-09,6210
2367,燿華,12,0,12,新百王,2023-02-09,6210
2313,華通,12,0,12,新百王,2023-02-09,6210
1443,立益物流,12,0,12,新百王,2023-02-09,6210
3041,揚智,12,0,12,新百王,2023-02-09,6210
3706,神達,12,1,11,新百王,2023-02-09,6210
2618,長榮航,11,0,11,新百王,2023-02-09,6210
3710,連展投控,17,6,11,新百王,2023-02-09,6210
3481,群創,187,177,10,新百王,2023-02-09,6210
2891,中信金,10,0,10,新百王,2023-02-09,6210
2103,台橡,10,0,10,新百王,2023-02-09,6210
5213,亞昕,10,0,10,新百王,2023-02-09,6210
00637L,元大滬深300正2,57,47,10,新百王,2023-02-09,6210
1742,台蠟,10,0,10,新百王,2023-02-09,6210
2069,運錩,10,0,10,新百王,2023-02-09,6210
5009,榮剛,10,1,9,新百王,2023-02-09,6210
9945,潤泰新,10,1,9,新百王,2023-02-09,6210
4977,眾達-KY,23,14,9,新百王,2023-02-09,6210
00632R,元大台灣50反1,601,193,408,新百王,2023-02-10,6210
3481,群創,401,11,390,新百王,2023-02-10,6210
2504,國產,220,0,220,新百王,2023-02-10,6210
3594,磐儀,214,50,164,新百王,2023-02-10,6210
3494,誠研,118,0,118,新百王,2023-02-10,6210
8069,元太,121,8,113,新百王,2023-02-10,6210
1217,愛之味,60,0,60,新百王,2023-02-10,6210
00665L,富邦�琤肭磪囓�2,237,179,58,新百王,2023-02-10,6210
5009,榮剛,69,14,55,新百王,2023-02-10,6210
00683L,期元大美元指正2,52,0,52,新百王,2023-02-10,6210
2851,中再保,42,0,42,新百王,2023-02-10,6210
00753L,中信中國50正2,320,278,42,新百王,2023-02-10,6210
00720B,元大投資級公司債,41,0,41,新百王,2023-02-10,6210
2453,凌群,64,23,41,新百王,2023-02-10,6210
00650L,復華香港正2,40,0,40,新百王,2023-02-10,6210
00701,國泰股利精選30,40,0,40,新百王,2023-02-10,6210
2344,華邦電,48,13,35,新百王,2023-02-10,6210
5426,振發,35,0,35,新百王,2023-02-10,6210
2201,裕隆,106,72,34,新百王,2023-02-10,6210
00676R,富邦臺灣加權反1,32,0,32,新百王,2023-02-10,6210
4931,新盛力,83,52,31,新百王,2023-02-10,6210
00669R,國泰美國道瓊反1,40,11,29,新百王,2023-02-10,6210
2610,華航,33,5,28,新百王,2023-02-10,6210
1309,台達化,27,0,27,新百王,2023-02-10,6210
00885,富邦越南,27,0,27,新百王,2023-02-10,6210
1210,大成,25,0,25,新百王,2023-02-10,6210
2888,新光金,24,0,24,新百王,2023-02-10,6210
4560,強信-KY,24,0,24,新百王,2023-02-10,6210
6282,康舒,108,85,23,新百王,2023-02-10,6210
2609,陽明,24,2,22,新百王,2023-02-10,6210
1781,合世,22,0,22,新百王,2023-02-10,6210
6180,橘子,24,3,21,新百王,2023-02-10,6210
6274,台燿,23,2,21,新百王,2023-02-10,6210
6024,群益期,21,0,21,新百王,2023-02-10,6210
6550,北極星藥業-KY,22,2,20,新百王,2023-02-10,6210
2010,春源,20,0,20,新百王,2023-02-10,6210
3715,定穎投控,30,10,20,新百王,2023-02-10,6210
1611,中電,20,0,20,新百王,2023-02-10,6210
2358,廷鑫,20,0,20,新百王,2023-02-10,6210
6767,台微醫,20,0,20,新百王,2023-02-10,6210
00751B,元大AAA至A公司債,18,0,18,新百王,2023-02-10,6210
5258,虹堡,32,14,18,新百王,2023-02-10,6210
00773B,中信優先金融債,15,0,15,新百王,2023-02-10,6210
2812,台中銀,15,0,15,新百王,2023-02-10,6210
6548,長科*,14,0,14,新百王,2023-02-10,6210
2338,光罩,17,4,13,新百王,2023-02-10,6210
4960,誠美材,13,0,13,新百王,2023-02-10,6210
3047,訊舟,12,0,12,新百王,2023-02-10,6210
6541,泰福-KY,13,1,12,新百王,2023-02-10,6210
6104,創惟,22,11,11,新百王,2023-02-10,6210
00664R,國泰臺灣加權反1,400,0,400,新百王,2023-02-13,6210
2801,彰銀,112,0,112,新百王,2023-02-13,6210
2303,聯電,111,18,93,新百王,2023-02-13,6210
2851,中再保,75,0,75,新百王,2023-02-13,6210
2330,台積電,79,13,66,新百王,2023-02-13,6210
6234,高僑,61,0,61,新百王,2023-02-13,6210
5009,榮剛,63,3,60,新百王,2023-02-13,6210
3312,弘憶股,55,0,55,新百王,2023-02-13,6210
2338,光罩,53,7,46,新百王,2023-02-13,6210
00903,富邦元宇宙,40,0,40,新百王,2023-02-13,6210
00679B,元大美債20年,38,0,38,新百王,2023-02-13,6210
6266,泰詠,127,89,38,新百王,2023-02-13,6210
8033,雷虎,43,15,28,新百王,2023-02-13,6210
2618,長榮航,28,0,28,新百王,2023-02-13,6210
00751B,元大AAA至A公司債,28,2,26,新百王,2023-02-13,6210
4979,華星光,62,36,26,新百王,2023-02-13,6210
2409,友達,45,20,25,新百王,2023-02-13,6210
2609,陽明,37,16,21,新百王,2023-02-13,6210
4114,健喬,58,38,20,新百王,2023-02-13,6210
2887,台新金,20,1,19,新百王,2023-02-13,6210
2852,第一保,19,0,19,新百王,2023-02-13,6210
1762,中化生,30,11,19,新百王,2023-02-13,6210
6768,志強-KY,19,0,19,新百王,2023-02-13,6210
6188,廣明,20,2,18,新百王,2023-02-13,6210
1513,中興電,47,31,16,新百王,2023-02-13,6210
6695,芯鼎,16,0,16,新百王,2023-02-13,6210
2023,燁輝,15,0,15,新百王,2023-02-13,6210
00893,國泰智能電動車,14,0,14,新百王,2023-02-13,6210
3481,群創,457,443,14,新百王,2023-02-13,6210
6443,元晶,18,5,13,新百王,2023-02-13,6210
1795,美時,80,68,12,新百王,2023-02-13,6210
9962,有益,12,0,12,新百王,2023-02-13,6210
00673R,期元大S＆P原油反1,12,0,12,新百王,2023-02-13,6210
00720B,元大投資級公司債,11,0,11,新百王,2023-02-13,6210
3710,連展投控,11,0,11,新百王,2023-02-13,6210
1524,耿鼎,11,0,11,新百王,2023-02-13,6210
2014,中鴻,11,0,11,新百王,2023-02-13,6210
5315,光聯,16,5,11,新百王,2023-02-13,6210
3189,景碩,14,4,10,新百王,2023-02-13,6210
2069,運錩,10,0,10,新百王,2023-02-13,6210
4560,強信-KY,10,0,10,新百王,2023-02-13,6210
3081,聯亞,10,0,10,新百王,2023-02-13,6210
1701,中化,17,7,10,新百王,2023-02-13,6210
4903,聯光通,10,0,10,新百王,2023-02-13,6210
2867,三商壽,20,10,10,新百王,2023-02-13,6210
8046,南電,10,0,10,新百王,2023-02-13,6210
1540,喬福,10,0,10,新百王,2023-02-13,6210
2610,華航,9,0,9,新百王,2023-02-13,6210
3479,安勤,13,5,8,新百王,2023-02-13,6210
2615,萬海,31,23,8,新百王,2023-02-13,6210
2867,三商壽,201,10,191,新百王,2023-02-14,6210
8069,元太,178,26,152,新百王,2023-02-14,6210
00632R,元大台灣50反1,477,330,147,新百王,2023-02-14,6210
00665L,富邦�琤肭磪囓�2,307,170,137,新百王,2023-02-14,6210
6122,擎邦,126,4,122,新百王,2023-02-14,6210
2884,玉山金,124,3,121,新百王,2023-02-14,6210
00878,國泰永續高股息,147,29,118,新百王,2023-02-14,6210
2852,第一保,100,0,100,新百王,2023-02-14,6210
4533,協易機,84,0,84,新百王,2023-02-14,6210
2834,臺企銀,60,0,60,新百王,2023-02-14,6210
00637L,元大滬深300正2,84,25,59,新百王,2023-02-14,6210
2375,凱美,45,1,44,新百王,2023-02-14,6210
4114,健喬,86,47,39,新百王,2023-02-14,6210
00753L,中信中國50正2,258,233,25,新百王,2023-02-14,6210
6188,廣明,21,0,21,新百王,2023-02-14,6210
1447,力鵬,21,0,21,新百王,2023-02-14,6210
2890,永豐金,21,0,21,新百王,2023-02-14,6210
1216,統一,21,1,20,新百王,2023-02-14,6210
4977,眾達-KY,24,5,19,新百王,2023-02-14,6210
2538,基泰,17,0,17,新百王,2023-02-14,6210
00673R,期元大S＆P原油反1,15,0,15,新百王,2023-02-14,6210
6165,浪凡,15,0,15,新百王,2023-02-14,6210
3083,網龍,15,1,14,新百王,2023-02-14,6210
6625,必應,13,0,13,新百王,2023-02-14,6210
6282,康舒,35,23,12,新百王,2023-02-14,6210
00683L,期元大美元指正2,12,0,12,新百王,2023-02-14,6210
00720B,元大投資級公司債,11,0,11,新百王,2023-02-14,6210
6142,友勁,11,0,11,新百王,2023-02-14,6210
1101,台泥,14,3,11,新百王,2023-02-14,6210
6541,泰福-KY,16,5,11,新百王,2023-02-14,6210
1440,南紡,10,0,10,新百王,2023-02-14,6210
2376,技嘉,11,1,10,新百王,2023-02-14,6210
2369,菱生,10,0,10,新百王,2023-02-14,6210
00701,國泰股利精選30,10,0,10,新百王,2023-02-14,6210
3362,先進光,11,1,10,新百王,2023-02-14,6210
6290,良維,46,36,10,新百王,2023-02-14,6210
00692,富邦公司治理,9,0,9,新百王,2023-02-14,6210
4147,中裕,10,1,9,新百王,2023-02-14,6210
6180,橘子,15,6,9,新百王,2023-02-14,6210
2883,凱基金,9,0,9,新百王,2023-02-14,6210
5425,台半,15,7,8,新百王,2023-02-14,6210
2405,輔信,8,0,8,新百王,2023-02-14,6210
4953,緯軟,11,3,8,新百王,2023-02-14,6210
2351,順德,21,13,8,新百王,2023-02-14,6210
2885,元大金,11,4,7,新百王,2023-02-14,6210
5203,訊連,7,0,7,新百王,2023-02-14,6210
8171,天宇,14,7,7,新百王,2023-02-14,6210
4979,華星光,28,21,7,新百王,2023-02-14,6210
6441,廣錠,7,0,7,新百王,2023-02-14,6210
4555,氣立,7,0,7,新百王,2023-02-14,6210
00878,國泰永續高股息,153,14,139,新百王,2023-02-15,6210
2852,第一保,100,0,100,新百王,2023-02-15,6210
1514,亞力,139,45,94,新百王,2023-02-15,6210
2885,元大金,62,0,62,新百王,2023-02-15,6210
2834,臺企銀,125,75,50,新百王,2023-02-15,6210
2610,華航,75,25,50,新百王,2023-02-15,6210
6443,元晶,51,7,44,新百王,2023-02-15,6210
2504,國產,35,0,35,新百王,2023-02-15,6210
4533,協易機,36,3,33,新百王,2023-02-15,6210
4555,氣立,34,2,32,新百王,2023-02-15,6210
0050,元大台灣50,54,23,31,新百王,2023-02-15,6210
1609,大亞,50,20,30,新百王,2023-02-15,6210
1217,愛之味,30,0,30,新百王,2023-02-15,6210
8069,元太,39,11,28,新百王,2023-02-15,6210
2607,榮運,30,2,28,新百王,2023-02-15,6210
4934,太極,28,0,28,新百王,2023-02-15,6210
00881,國泰台灣5G+,20,0,20,新百王,2023-02-15,6210
6176,瑞儀,20,0,20,新百王,2023-02-15,6210
3264,欣銓,59,40,19,新百王,2023-02-15,6210
00679B,元大美債20年,15,0,15,新百王,2023-02-15,6210
4114,健喬,39,24,15,新百王,2023-02-15,6210
2601,益航,15,0,15,新百王,2023-02-15,6210
2812,台中銀,15,0,15,新百王,2023-02-15,6210
00671R,富邦NASDAQ反1,12,0,12,新百王,2023-02-15,6210
3207,耀勝,19,7,12,新百王,2023-02-15,6210
6806,森崴能源,27,15,12,新百王,2023-02-15,6210
2323,中環,12,0,12,新百王,2023-02-15,6210
00631L,元大台灣50正2,18,7,11,新百王,2023-02-15,6210
2884,玉山金,31,20,11,新百王,2023-02-15,6210
2402,毅嘉,11,0,11,新百王,2023-02-15,6210
2413,環科,11,0,11,新百王,2023-02-15,6210
8046,南電,11,0,11,新百王,2023-02-15,6210
2889,國票金,10,0,10,新百王,2023-02-15,6210
6116,彩晶,12,2,10,新百王,2023-02-15,6210
2006,東和鋼鐵,10,0,10,新百王,2023-02-15,6210
6451,訊芯-KY,10,0,10,新百王,2023-02-15,6210
1522,堤維西,10,0,10,新百王,2023-02-15,6210
9904,寶成,11,1,10,新百王,2023-02-15,6210
5009,榮剛,25,15,10,新百王,2023-02-15,6210
00900,富邦特選高股息30,9,0,9,新百王,2023-02-15,6210
1504,東元,9,0,9,新百王,2023-02-15,6210
6266,泰詠,56,47,9,新百王,2023-02-15,6210
1783,和康生,10,1,9,新百王,2023-02-15,6210
1101,台泥,16,7,9,新百王,2023-02-15,6210
6625,必應,24,15,9,新百王,2023-02-15,6210
3221,台嘉碩,41,32,9,新百王,2023-02-15,6210
3594,磐儀,10,1,9,新百王,2023-02-15,6210
6024,群益期,15,6,9,新百王,2023-02-15,6210
2330,台積電,48,40,8,新百王,2023-02-15,6210
2395,研華,9,1,8,新百王,2023-02-15,6210
00878,國泰永續高股息,374,31,343,新百王,2023-02-16,6210
2867,三商壽,200,0,200,新百王,2023-02-16,6210
6122,擎邦,137,5,132,新百王,2023-02-16,6210
4744,皇將,75,5,70,新百王,2023-02-16,6210
2852,第一保,55,0,55,新百王,2023-02-16,6210
3058,立德,58,4,54,新百王,2023-02-16,6210
00664R,國泰臺灣加權反1,51,0,51,新百王,2023-02-16,6210
00751B,元大AAA至A公司債,50,0,50,新百王,2023-02-16,6210
2734,易飛網,50,0,50,新百王,2023-02-16,6210
6625,必應,34,0,34,新百王,2023-02-16,6210
1475,業旺,31,0,31,新百王,2023-02-16,6210
4763,材料-KY,40,10,30,新百王,2023-02-16,6210
00673R,期元大S＆P原油反1,30,0,30,新百王,2023-02-16,6210
6443,元晶,36,6,30,新百王,2023-02-16,6210
00679B,元大美債20年,36,7,29,新百王,2023-02-16,6210
00632R,元大台灣50反1,172,145,27,新百王,2023-02-16,6210
1522,堤維西,35,8,27,新百王,2023-02-16,6210
6235,華孚,57,31,26,新百王,2023-02-16,6210
2538,基泰,32,6,26,新百王,2023-02-16,6210
2884,玉山金,25,0,25,新百王,2023-02-16,6210
1605,華新,111,89,22,新百王,2023-02-16,6210
6589,台康生技,27,5,22,新百王,2023-02-16,6210
2063,世鎧,22,1,21,新百王,2023-02-16,6210
3169,亞信,20,0,20,新百王,2023-02-16,6210
6290,良維,62,42,20,新百王,2023-02-16,6210
6182,合晶,19,1,18,新百王,2023-02-16,6210
8358,金居,22,6,16,新百王,2023-02-16,6210
6142,友勁,15,0,15,新百王,2023-02-16,6210
4743,合一,20,5,15,新百王,2023-02-16,6210
2349,錸德,14,0,14,新百王,2023-02-16,6210
8234,新漢,23,10,13,新百王,2023-02-16,6210
5243,乙盛-KY,15,2,13,新百王,2023-02-16,6210
1736,喬山,22,10,12,新百王,2023-02-16,6210
1316,上曜,12,0,12,新百王,2023-02-16,6210
00712,復華富時不動產,12,0,12,新百王,2023-02-16,6210
6284,佳邦,30,18,12,新百王,2023-02-16,6210
2736,富野,11,0,11,新百王,2023-02-16,6210
00680L,元大美債20正2,11,0,11,新百王,2023-02-16,6210
4130,健亞,11,0,11,新百王,2023-02-16,6210
00631L,元大台灣50正2,16,6,10,新百王,2023-02-16,6210
2033,佳大,10,0,10,新百王,2023-02-16,6210
5309,系統電,10,0,10,新百王,2023-02-16,6210
4164,承業醫,9,0,9,新百王,2023-02-16,6210
2882,國泰金,12,3,9,新百王,2023-02-16,6210
2745,五福,11,2,9,新百王,2023-02-16,6210
1216,統一,9,0,9,新百王,2023-02-16,6210
4533,協易機,9,0,9,新百王,2023-02-16,6210
6767,台微醫,9,0,9,新百王,2023-02-16,6210
6188,廣明,11,2,9,新百王,2023-02-16,6210
3022,威強電,8,0,8,新百王,2023-02-16,6210
3711,日月光投控,277,10,267,新百王,2023-02-17,6210
2867,三商壽,235,0,235,新百王,2023-02-17,6210
00637L,元大滬深300正2,158,22,136,新百王,2023-02-17,6210
00671R,富邦NASDAQ反1,100,0,100,新百王,2023-02-17,6210
3037,欣興,83,28,55,新百王,2023-02-17,6210
00878,國泰永續高股息,57,5,52,新百王,2023-02-17,6210
00772B,中信高評級公司債,36,0,36,新百王,2023-02-17,6210
00751B,元大AAA至A公司債,35,0,35,新百王,2023-02-17,6210
2330,台積電,39,8,31,新百王,2023-02-17,6210
2885,元大金,30,0,30,新百王,2023-02-17,6210
4979,華星光,39,9,30,新百王,2023-02-17,6210
2498,宏達電,36,6,30,新百王,2023-02-17,6210
0050,元大台灣50,41,13,28,新百王,2023-02-17,6210
2884,玉山金,51,27,24,新百王,2023-02-17,6210
00862B,中信投資級公司債,20,0,20,新百王,2023-02-17,6210
4747,強生,24,4,20,新百王,2023-02-17,6210
3432,台端,22,2,20,新百王,2023-02-17,6210
6288,聯嘉,25,6,19,新百王,2023-02-17,6210
6245,立端,51,35,16,新百王,2023-02-17,6210
3128,昇銳,21,5,16,新百王,2023-02-17,6210
6188,廣明,18,2,16,新百王,2023-02-17,6210
3545,敦泰,26,11,15,新百王,2023-02-17,6210
6625,必應,17,3,14,新百王,2023-02-17,6210
2412,中華電,28,14,14,新百王,2023-02-17,6210
1437,勤益控,13,0,13,新百王,2023-02-17,6210
00893,國泰智能電動車,13,0,13,新百王,2023-02-17,6210
2471,資通,35,23,12,新百王,2023-02-17,6210
1316,上曜,15,3,12,新百王,2023-02-17,6210
1519,華城,18,7,11,新百王,2023-02-17,6210
00773B,中信優先金融債,13,2,11,新百王,2023-02-17,6210
2705,六福,27,16,11,新百王,2023-02-17,6210
2484,希華,11,0,11,新百王,2023-02-17,6210
2618,長榮航,152,142,10,新百王,2023-02-17,6210
4555,氣立,10,0,10,新百王,2023-02-17,6210
00895,富邦未來車,10,0,10,新百王,2023-02-17,6210
00753L,中信中國50正2,10,0,10,新百王,2023-02-17,6210
2472,立隆電,10,0,10,新百王,2023-02-17,6210
2457,飛宏,10,0,10,新百王,2023-02-17,6210
00680L,元大美債20正2,12,2,10,新百王,2023-02-17,6210
6271,同欣電,16,6,10,新百王,2023-02-17,6210
00670L,富邦NASDAQ正2,9,0,9,新百王,2023-02-17,6210
3224,三顧,10,1,9,新百王,2023-02-17,6210
00632R,元大台灣50反1,210,201,9,新百王,2023-02-17,6210
00679B,元大美債20年,9,0,9,新百王,2023-02-17,6210
5011,久陽,10,2,8,新百王,2023-02-17,6210
1475,業旺,8,0,8,新百王,2023-02-17,6210
2368,金像電,15,7,8,新百王,2023-02-17,6210
1325,恆大,11,3,8,新百王,2023-02-17,6210
2888,新光金,7,0,7,新百王,2023-02-17,6210
1783,和康生,9,2,7,新百王,2023-02-17,6210
3576,聯合再生,100,0,100,新百王,2023-02-20,6210
00632R,元大台灣50反1,199,100,99,新百王,2023-02-20,6210
3711,日月光投控,80,2,78,新百王,2023-02-20,6210
4526,東台,86,22,64,新百王,2023-02-20,6210
2852,第一保,55,0,55,新百王,2023-02-20,6210
2884,玉山金,72,17,55,新百王,2023-02-20,6210
2705,六福,62,10,52,新百王,2023-02-20,6210
1314,中石化,68,16,52,新百王,2023-02-20,6210
00890B,凱基ESG BBB債,50,0,50,新百王,2023-02-20,6210
3322,建舜電,42,0,42,新百王,2023-02-20,6210
2812,台中銀,41,5,36,新百王,2023-02-20,6210
2607,榮運,33,0,33,新百王,2023-02-20,6210
6116,彩晶,42,13,29,新百王,2023-02-20,6210
1437,勤益控,28,0,28,新百王,2023-02-20,6210
4956,光鋐,25,0,25,新百王,2023-02-20,6210
6285,啟��,27,3,24,新百王,2023-02-20,6210
4538,大詠城,24,0,24,新百王,2023-02-20,6210
0056,元大高股息,36,12,24,新百王,2023-02-20,6210
1504,東元,25,3,22,新百王,2023-02-20,6210
2601,益航,40,20,20,新百王,2023-02-20,6210
6541,泰福-KY,21,2,19,新百王,2023-02-20,6210
1795,美時,48,29,19,新百王,2023-02-20,6210
1519,華城,40,22,18,新百王,2023-02-20,6210
3027,盛達,33,17,16,新百王,2023-02-20,6210
5309,系統電,26,10,16,新百王,2023-02-20,6210
4979,華星光,45,29,16,新百王,2023-02-20,6210
2630,亞航,15,0,15,新百王,2023-02-20,6210
1529,樂事綠能,97,84,13,新百王,2023-02-20,6210
2882,國泰金,17,4,13,新百王,2023-02-20,6210
1752,南光,16,3,13,新百王,2023-02-20,6210
6266,泰詠,26,13,13,新百王,2023-02-20,6210
2492,華新科,12,0,12,新百王,2023-02-20,6210
3624,光頡,18,6,12,新百王,2023-02-20,6210
6138,茂達,14,2,12,新百王,2023-02-20,6210
3447,展達,12,0,12,新百王,2023-02-20,6210
6585,鼎基,11,0,11,新百王,2023-02-20,6210
2007,燁興,10,0,10,新百王,2023-02-20,6210
4164,承業醫,28,18,10,新百王,2023-02-20,6210
3390,旭軟,10,0,10,新百王,2023-02-20,6210
1444,力麗,10,0,10,新百王,2023-02-20,6210
00772B,中信高評級公司債,9,0,9,新百王,2023-02-20,6210
6691,洋基工程,9,0,9,新百王,2023-02-20,6210
2014,中鴻,9,0,9,新百王,2023-02-20,6210
8463,潤泰材,9,0,9,新百王,2023-02-20,6210
2495,普安,10,1,9,新百王,2023-02-20,6210
00878,國泰永續高股息,8,0,8,新百王,2023-02-20,6210
2349,錸德,15,7,8,新百王,2023-02-20,6210
3128,昇銳,10,2,8,新百王,2023-02-20,6210
2885,元大金,8,0,8,新百王,2023-02-20,6210
2104,國際中橡,8,0,8,新百王,2023-02-20,6210
2867,三商壽,317,45,272,新百王,2023-02-21,6210
00753L,中信中國50正2,146,10,136,新百王,2023-02-21,6210
2337,旺宏,110,2,108,新百王,2023-02-21,6210
4167,松瑞藥,93,12,81,新百王,2023-02-21,6210
2618,長榮航,50,0,50,新百王,2023-02-21,6210
6266,泰詠,101,53,48,新百王,2023-02-21,6210
2520,冠德,45,0,45,新百王,2023-02-21,6210
2615,萬海,67,29,38,新百王,2023-02-21,6210
2607,榮運,36,0,36,新百王,2023-02-21,6210
00725B,國泰投資級公司債,36,0,36,新百王,2023-02-21,6210
2885,元大金,36,0,36,新百王,2023-02-21,6210
8105,凌巨,37,2,35,新百王,2023-02-21,6210
2368,金像電,32,0,32,新百王,2023-02-21,6210
2888,新光金,29,0,29,新百王,2023-02-21,6210
6288,聯嘉,73,45,28,新百王,2023-02-21,6210
4934,太極,25,3,22,新百王,2023-02-21,6210
6171,大城地產,22,0,22,新百王,2023-02-21,6210
3520,華盈,21,0,21,新百王,2023-02-21,6210
4114,健喬,43,23,20,新百王,2023-02-21,6210
2634,漢翔,25,5,20,新百王,2023-02-21,6210
1268,漢來美食,20,0,20,新百王,2023-02-21,6210
5009,榮剛,20,0,20,新百王,2023-02-21,6210
4744,皇將,20,1,19,新百王,2023-02-21,6210
4979,華星光,65,46,19,新百王,2023-02-21,6210
8433,弘帆,18,0,18,新百王,2023-02-21,6210
2349,錸德,18,0,18,新百王,2023-02-21,6210
2601,益航,27,11,16,新百王,2023-02-21,6210
6285,啟��,21,5,16,新百王,2023-02-21,6210
8936,國統,52,36,16,新百王,2023-02-21,6210
3624,光頡,21,6,15,新百王,2023-02-21,6210
2701,萬企,15,0,15,新百王,2023-02-21,6210
0056,元大高股息,26,11,15,新百王,2023-02-21,6210
3013,晟銘電,15,1,14,新百王,2023-02-21,6210
00772B,中信高評級公司債,13,0,13,新百王,2023-02-21,6210
6129,普誠,13,0,13,新百王,2023-02-21,6210
6443,元晶,15,2,13,新百王,2023-02-21,6210
4584,君帆,13,0,13,新百王,2023-02-21,6210
6282,康舒,73,60,13,新百王,2023-02-21,6210
2367,燿華,17,5,12,新百王,2023-02-21,6210
1584,精剛,22,10,12,新百王,2023-02-21,6210
00902,中信電池及儲能,11,0,11,新百王,2023-02-21,6210
4147,中裕,11,0,11,新百王,2023-02-21,6210
1524,耿鼎,14,3,11,新百王,2023-02-21,6210
1609,大亞,11,1,10,新百王,2023-02-21,6210
2887,台新金,11,0,11,新百王,2023-02-21,6210
9802,鈺齊-KY,19,9,10,新百王,2023-02-21,6210
3264,欣銓,20,10,10,新百王,2023-02-21,6210
2481,強茂,10,0,10,新百王,2023-02-21,6210
4129,聯合,10,0,10,新百王,2023-02-21,6210
3088,艾訊,10,0,10,新百王,2023-02-21,6210
00671R,富邦NASDAQ反1,200,3,197,新百王,2023-02-22,6210
3711,日月光投控,158,13,145,新百王,2023-02-22,6210
00712,復華富時不動產,105,0,105,新百王,2023-02-22,6210
00725B,國泰投資級公司債,85,0,85,新百王,2023-02-22,6210
00900,富邦特選高股息30,81,0,81,新百王,2023-02-22,6210
6234,高僑,90,17,73,新百王,2023-02-22,6210
1268,漢來美食,47,0,47,新百王,2023-02-22,6210
4555,氣立,38,0,38,新百王,2023-02-22,6210
2618,長榮航,42,6,36,新百王,2023-02-22,6210
2208,台船,70,35,35,新百王,2023-02-22,6210
3058,立德,31,0,31,新百王,2023-02-22,6210
00890B,凱基ESG BBB債,30,0,30,新百王,2023-02-22,6210
00686R,群益臺灣加權反1,30,0,30,新百王,2023-02-22,6210
6282,康舒,140,111,29,新百王,2023-02-22,6210
2888,新光金,28,0,28,新百王,2023-02-22,6210
2538,基泰,26,0,26,新百王,2023-02-22,6210
00897,富邦基因免疫生技,25,0,25,新百王,2023-02-22,6210
4934,太極,40,15,25,新百王,2023-02-22,6210
00878,國泰永續高股息,35,10,25,新百王,2023-02-22,6210
2317,鴻海,28,4,24,新百王,2023-02-22,6210
00760B,復華新興企業債,24,0,24,新百王,2023-02-22,6210
6578,達邦蛋白,25,1,24,新百王,2023-02-22,6210
4168,醣聯,27,3,24,新百王,2023-02-22,6210
1513,中興電,68,47,21,新百王,2023-02-22,6210
6188,廣明,25,4,21,新百王,2023-02-22,6210
1336,台翰,24,3,21,新百王,2023-02-22,6210
3035,智原,41,21,20,新百王,2023-02-22,6210
2897,王道銀行,20,0,20,新百王,2023-02-22,6210
2457,飛宏,47,28,19,新百王,2023-02-22,6210
2615,萬海,69,50,19,新百王,2023-02-22,6210
2852,第一保,18,0,18,新百王,2023-02-22,6210
2303,聯電,51,35,16,新百王,2023-02-22,6210
3027,盛達,64,49,15,新百王,2023-02-22,6210
00680L,元大美債20正2,15,0,15,新百王,2023-02-22,6210
2355,敬鵬,16,1,15,新百王,2023-02-22,6210
0050,元大台灣50,60,47,13,新百王,2023-02-22,6210
8933,愛地雅,13,0,13,新百王,2023-02-22,6210
3715,定穎投控,18,5,13,新百王,2023-02-22,6210
4526,東台,13,0,13,新百王,2023-02-22,6210
4114,健喬,45,32,13,新百王,2023-02-22,6210
2610,華航,28,15,13,新百王,2023-02-22,6210
3705,永信,15,3,12,新百王,2023-02-22,6210
2705,六福,17,6,11,新百王,2023-02-22,6210
6116,彩晶,176,165,11,新百王,2023-02-22,6210
8289,泰藝,11,0,11,新百王,2023-02-22,6210
2883,凱基金,10,0,10,新百王,2023-02-22,6210
5512,力麒,10,0,10,新百王,2023-02-22,6210
00720B,元大投資級公司債,10,0,10,新百王,2023-02-22,6210
00652,富邦印度,10,0,10,新百王,2023-02-22,6210
2485,兆赫,10,0,10,新百王,2023-02-22,6210
00632R,元大台灣50反1,498,238,260,新百王,2023-02-23,6210
2867,三商壽,230,0,230,新百王,2023-02-23,6210
2308,台達電,121,0,121,新百王,2023-02-23,6210
00725B,國泰投資級公司債,87,0,87,新百王,2023-02-23,6210
00715L,期街口布蘭特正2,57,0,57,新百王,2023-02-23,6210
3252,海灣,71,14,57,新百王,2023-02-23,6210
2852,第一保,50,0,50,新百王,2023-02-23,6210
00637L,元大滬深300正2,61,15,46,新百王,2023-02-23,6210
5706,鳳凰,47,11,36,新百王,2023-02-23,6210
00885,富邦越南,33,0,33,新百王,2023-02-23,6210
00642U,期元大S＆P石油,32,0,32,新百王,2023-02-23,6210
1514,亞力,88,58,30,新百王,2023-02-23,6210
4555,氣立,31,6,25,新百王,2023-02-23,6210
2363,矽統,34,11,23,新百王,2023-02-23,6210
6122,擎邦,22,0,22,新百王,2023-02-23,6210
2845,遠東銀,20,0,20,新百王,2023-02-23,6210
3481,群創,31,11,20,新百王,2023-02-23,6210
8936,國統,68,48,20,新百王,2023-02-23,6210
8933,愛地雅,20,1,19,新百王,2023-02-23,6210
5512,力麒,91,73,18,新百王,2023-02-23,6210
1712,興農,15,0,15,新百王,2023-02-23,6210
2022,聚亨,15,0,15,新百王,2023-02-23,6210
6235,華孚,96,81,15,新百王,2023-02-23,6210
5258,虹堡,69,55,14,新百王,2023-02-23,6210
2748,雲品,49,35,14,新百王,2023-02-23,6210
5351,鈺創,15,1,14,新百王,2023-02-23,6210
3265,台星科,18,4,14,新百王,2023-02-23,6210
8046,南電,15,1,14,新百王,2023-02-23,6210
6578,達邦蛋白,14,0,14,新百王,2023-02-23,6210
2449,京元電子,14,0,14,新百王,2023-02-23,6210
2641,正德,16,2,14,新百王,2023-02-23,6210
1810,和成,26,13,13,新百王,2023-02-23,6210
8049,晶采,15,2,13,新百王,2023-02-23,6210
1584,精剛,44,31,13,新百王,2023-02-23,6210
1522,堤維西,15,2,13,新百王,2023-02-23,6210
8033,雷虎,52,40,12,新百王,2023-02-23,6210
00891,中信關鍵半導體,20,8,12,新百王,2023-02-23,6210
5426,振發,16,5,11,新百王,2023-02-23,6210
6125,廣運,11,0,11,新百王,2023-02-23,6210
4536,拓凱,12,1,11,新百王,2023-02-23,6210
2929,淘帝-KY,16,5,11,新百王,2023-02-23,6210
6138,茂達,13,2,11,新百王,2023-02-23,6210
2352,佳世達,11,0,11,新百王,2023-02-23,6210
4114,健喬,35,24,11,新百王,2023-02-23,6210
4927,泰鼎-KY,10,0,10,新百王,2023-02-23,6210
2888,新光金,10,0,10,新百王,2023-02-23,6210
4526,東台,10,0,10,新百王,2023-02-23,6210
3078,僑威,10,0,10,新百王,2023-02-23,6210
6560,欣普羅,10,0,10,新百王,2023-02-23,6210
2007,燁興,20,10,10,新百王,2023-02-23,6210
2867,三商壽,335,68,267,新百王,2023-02-24,6210
2601,益航,210,44,166,新百王,2023-02-24,6210
2609,陽明,93,13,80,新百王,2023-02-24,6210
2317,鴻海,81,6,75,新百王,2023-02-24,6210
8933,愛地雅,78,9,69,新百王,2023-02-24,6210
2885,元大金,63,0,63,新百王,2023-02-24,6210
2610,華航,101,41,60,新百王,2023-02-24,6210
3576,聯合再生,50,1,49,新百王,2023-02-24,6210
6165,浪凡,37,0,37,新百王,2023-02-24,6210
4417,金洲,33,0,33,新百王,2023-02-24,6210
4744,皇將,42,12,30,新百王,2023-02-24,6210
5210,寶碩,29,3,26,新百王,2023-02-24,6210
2881,富邦金,31,5,26,新百王,2023-02-24,6210
00890B,凱基ESG BBB債,25,0,25,新百王,2023-02-24,6210
8033,雷虎,59,35,24,新百王,2023-02-24,6210
2504,國產,22,0,22,新百王,2023-02-24,6210
2845,遠東銀,22,0,22,新百王,2023-02-24,6210
8069,元太,46,25,21,新百王,2023-02-24,6210
2477,美隆電,21,1,20,新百王,2023-02-24,6210
00724B,群益投資級金融債,20,0,20,新百王,2023-02-24,6210
00637L,元大滬深300正2,48,30,18,新百王,2023-02-24,6210
8383,千附,20,2,18,新百王,2023-02-24,6210
1806,冠軍,18,0,18,新百王,2023-02-24,6210
00725B,國泰投資級公司債,17,0,17,新百王,2023-02-24,6210
1314,中石化,20,5,15,新百王,2023-02-24,6210
2369,菱生,15,0,15,新百王,2023-02-24,6210
6266,泰詠,26,11,15,新百王,2023-02-24,6210
9945,潤泰新,19,4,15,新百王,2023-02-24,6210
2352,佳世達,14,0,14,新百王,2023-02-24,6210
4130,健亞,14,1,13,新百王,2023-02-24,6210
5236,凌陽創新,17,4,13,新百王,2023-02-24,6210
6235,華孚,41,28,13,新百王,2023-02-24,6210
3481,群創,64,51,13,新百王,2023-02-24,6210
00882,中信中國高股息,12,0,12,新百王,2023-02-24,6210
1519,華城,17,5,12,新百王,2023-02-24,6210
6234,高僑,12,0,12,新百王,2023-02-24,6210
6245,立端,28,16,12,新百王,2023-02-24,6210
8050,廣積,18,6,12,新百王,2023-02-24,6210
6282,康舒,30,19,11,新百王,2023-02-24,6210
8105,凌巨,11,0,11,新百王,2023-02-24,6210
4763,材料-KY,64,53,11,新百王,2023-02-24,6210
2425,承啟,33,22,11,新百王,2023-02-24,6210
3673,TPK-KY,11,0,11,新百王,2023-02-24,6210
00670L,富邦NASDAQ正2,11,1,10,新百王,2023-02-24,6210
5522,遠雄,10,0,10,新百王,2023-02-24,6210
2208,台船,12,2,10,新百王,2023-02-24,6210
1219,福壽,11,1,10,新百王,2023-02-24,6210
2468,華經,10,0,10,新百王,2023-02-24,6210
3520,華盈,15,5,10,新百王,2023-02-24,6210
4137,麗豐-KY,10,0,10,新百王,2023-02-24,6210
00632R,元大台灣50反1,416,15,401,新百王,2023-03-01,6210
2014,中鴻,241,6,235,新百王,2023-03-01,6210
5009,榮剛,154,14,140,新百王,2023-03-01,6210
5210,寶碩,81,7,74,新百王,2023-03-01,6210
8105,凌巨,60,0,60,新百王,2023-03-01,6210
00753L,中信中國50正2,63,3,60,新百王,2023-03-01,6210
2344,華邦電,61,11,50,新百王,2023-03-01,6210
6770,力積電,51,5,46,新百王,2023-03-01,6210
00751B,元大AAA至A公司債,32,0,32,新百王,2023-03-01,6210
1103,嘉泥,30,0,30,新百王,2023-03-01,6210
2867,三商壽,30,0,30,新百王,2023-03-01,6210
2888,新光金,30,1,29,新百王,2023-03-01,6210
2208,台船,22,0,22,新百王,2023-03-01,6210
00724B,群益投資級金融債,20,0,20,新百王,2023-03-01,6210
2010,春源,19,1,18,新百王,2023-03-01,6210
6165,浪凡,18,0,18,新百王,2023-03-01,6210
8936,國統,34,16,18,新百王,2023-03-01,6210
2359,所羅門,19,1,18,新百王,2023-03-01,6210
2881,富邦金,48,30,18,新百王,2023-03-01,6210
3706,神達,17,0,17,新百王,2023-03-01,6210
2634,漢翔,17,0,17,新百王,2023-03-01,6210
8050,廣積,20,4,16,新百王,2023-03-01,6210
6188,廣明,19,3,16,新百王,2023-03-01,6210
00673R,期元大S＆P原油反1,16,0,16,新百王,2023-03-01,6210
2637,慧洋-KY,48,32,16,新百王,2023-03-01,6210
2618,長榮航,39,24,15,新百王,2023-03-01,6210
2748,雲品,34,19,15,新百王,2023-03-01,6210
1210,大成,41,27,14,新百王,2023-03-01,6210
2605,新興,269,256,13,新百王,2023-03-01,6210
2457,飛宏,27,14,13,新百王,2023-03-01,6210
1701,中化,13,0,13,新百王,2023-03-01,6210
3430,奇鈦科,13,0,13,新百王,2023-03-01,6210
6776,展�眥篕�,13,0,13,新百王,2023-03-01,6210
2368,金像電,21,8,13,新百王,2023-03-01,6210
1215,卜蜂,14,1,13,新百王,2023-03-01,6210
2412,中華電,30,18,12,新百王,2023-03-01,6210
00720B,元大投資級公司債,12,0,12,新百王,2023-03-01,6210
5309,系統電,12,0,12,新百王,2023-03-01,6210
1605,華新,44,32,12,新百王,2023-03-01,6210
2885,元大金,12,0,12,新百王,2023-03-01,6210
6146,耕興,13,1,12,新百王,2023-03-01,6210
2408,南亞科,13,1,12,新百王,2023-03-01,6210
2371,大同,11,0,11,新百王,2023-03-01,6210
1720,生達,11,0,11,新百王,2023-03-01,6210
3673,TPK-KY,11,0,11,新百王,2023-03-01,6210
2105,正新,12,1,11,新百王,2023-03-01,6210
00680L,元大美債20正2,11,0,11,新百王,2023-03-01,6210
4153,鈺緯,11,0,11,新百王,2023-03-01,6210
00670L,富邦NASDAQ正2,10,0,10,新百王,2023-03-01,6210
6234,高僑,10,0,10,新百王,2023-03-01,6210
00632R,元大台灣50反1,462,131,331,新百王,2023-03-02,6210
00673R,期元大S＆P原油反1,81,0,81,新百王,2023-03-02,6210
2891,中信金,59,0,59,新百王,2023-03-02,6210
00878,國泰永續高股息,72,26,46,新百王,2023-03-02,6210
4541,晟田,51,8,43,新百王,2023-03-02,6210
00670L,富邦NASDAQ正2,29,0,29,新百王,2023-03-02,6210
2498,宏達電,59,32,27,新百王,2023-03-02,6210
2881,富邦金,35,11,24,新百王,2023-03-02,6210
2388,威盛,43,22,21,新百王,2023-03-02,6210
00680L,元大美債20正2,20,0,20,新百王,2023-03-02,6210
2888,新光金,40,20,20,新百王,2023-03-02,6210
2701,萬企,20,0,20,新百王,2023-03-02,6210
00852L,國泰美國道瓊正2,20,0,20,新百王,2023-03-02,6210
6165,浪凡,19,0,19,新百王,2023-03-02,6210
5210,寶碩,19,0,19,新百王,2023-03-02,6210
3481,群創,18,0,18,新百王,2023-03-02,6210
6188,廣明,19,2,17,新百王,2023-03-02,6210
00637L,元大滬深300正2,82,65,17,新百王,2023-03-02,6210
2884,玉山金,17,0,17,新百王,2023-03-02,6210
0050,元大台灣50,20,4,16,新百王,2023-03-02,6210
2886,兆豐金,16,0,16,新百王,2023-03-02,6210
1210,大成,25,10,15,新百王,2023-03-02,6210
2605,新興,368,353,15,新百王,2023-03-02,6210
4726,永昕,17,2,15,新百王,2023-03-02,6210
00712,復華富時不動產,15,0,15,新百王,2023-03-02,6210
3430,奇鈦科,14,0,14,新百王,2023-03-02,6210
2634,漢翔,20,6,14,新百王,2023-03-02,6210
6446,藥華藥,15,1,14,新百王,2023-03-02,6210
6494,九齊,13,0,13,新百王,2023-03-02,6210
3714,富采,14,1,13,新百王,2023-03-02,6210
8936,國統,82,70,12,新百王,2023-03-02,6210
3704,合勤控,28,16,12,新百王,2023-03-02,6210
00919,群益台灣精選高息,12,0,12,新百王,2023-03-02,6210
00715L,期街口布蘭特正2,32,20,12,新百王,2023-03-02,6210
00885,富邦越南,12,0,12,新百王,2023-03-02,6210
00720B,元大投資級公司債,11,0,11,新百王,2023-03-02,6210
2409,友達,56,45,11,新百王,2023-03-02,6210
3059,華晶科,11,0,11,新百王,2023-03-02,6210
2482,連宇,49,38,11,新百王,2023-03-02,6210
2845,遠東銀,11,0,11,新百王,2023-03-02,6210
3706,神達,21,11,10,新百王,2023-03-02,6210
00724B,群益投資級金融債,10,0,10,新百王,2023-03-02,6210
1316,上曜,10,0,10,新百王,2023-03-02,6210
3673,TPK-KY,10,0,10,新百王,2023-03-02,6210
1598,岱宇,10,0,10,新百王,2023-03-02,6210
00773B,中信優先金融債,9,0,9,新百王,2023-03-02,6210
5009,榮剛,10,1,9,新百王,2023-03-02,6210
1708,東鹼,20,11,9,新百王,2023-03-02,6210
2049,上銀,10,1,9,新百王,2023-03-02,6210
2211,長榮鋼,9,0,9,新百王,2023-03-02,6210
2834,臺企銀,278,66,212,新百王,2023-03-03,6210
4162,智擎,62,0,62,新百王,2023-03-03,6210
2332,友訊,60,0,60,新百王,2023-03-03,6210
2538,基泰,59,4,55,新百王,2023-03-03,6210
00751B,元大AAA至A公司債,51,0,51,新百王,2023-03-03,6210
3062,建漢,50,0,50,新百王,2023-03-03,6210
2442,新美齊,55,10,45,新百王,2023-03-03,6210
4510,高鋒,30,0,30,新百王,2023-03-03,6210
00712,復華富時不動產,27,0,27,新百王,2023-03-03,6210
8105,凌巨,50,26,24,新百王,2023-03-03,6210
2884,玉山金,22,0,22,新百王,2023-03-03,6210
2609,陽明,94,72,22,新百王,2023-03-03,6210
00680L,元大美債20正2,21,0,21,新百王,2023-03-03,6210
4979,華星光,21,0,21,新百王,2023-03-03,6210
2498,宏達電,48,28,20,新百王,2023-03-03,6210
5864,致和證,20,0,20,新百王,2023-03-03,6210
1701,中化,40,20,20,新百王,2023-03-03,6210
1451,年興,20,0,20,新百王,2023-03-03,6210
5009,榮剛,20,0,20,新百王,2023-03-03,6210
00715L,期街口布蘭特正2,20,0,20,新百王,2023-03-03,6210
9945,潤泰新,18,0,18,新百王,2023-03-03,6210
1806,冠軍,18,0,18,新百王,2023-03-03,6210
2891,中信金,18,0,18,新百王,2023-03-03,6210
4164,承業醫,28,11,17,新百王,2023-03-03,6210
00673R,期元大S＆P原油反1,17,0,17,新百王,2023-03-03,6210
5328,華容,16,0,16,新百王,2023-03-03,6210
4533,協易機,16,0,16,新百王,2023-03-03,6210
6165,浪凡,16,0,16,新百王,2023-03-03,6210
4934,太極,20,5,15,新百王,2023-03-03,6210
6234,高僑,15,0,15,新百王,2023-03-03,6210
6282,康舒,34,20,14,新百王,2023-03-03,6210
1605,華新,29,16,13,新百王,2023-03-03,6210
3029,零壹,15,2,13,新百王,2023-03-03,6210
00919,群益台灣精選高息,12,0,12,新百王,2023-03-03,6210
3221,台嘉碩,12,0,12,新百王,2023-03-03,6210
6024,群益期,12,0,12,新百王,2023-03-03,6210
2388,威盛,50,38,12,新百王,2023-03-03,6210
6188,廣明,13,1,12,新百王,2023-03-03,6210
1909,榮成,11,0,11,新百王,2023-03-03,6210
2812,台中銀,11,0,11,新百王,2023-03-03,6210
2883,凱基金,10,0,10,新百王,2023-03-03,6210
2330,台積電,13,3,10,新百王,2023-03-03,6210
4114,健喬,21,11,10,新百王,2023-03-03,6210
1742,台蠟,10,0,10,新百王,2023-03-03,6210
6451,訊芯-KY,12,2,10,新百王,2023-03-03,6210
00753L,中信中國50正2,83,73,10,新百王,2023-03-03,6210
1524,耿鼎,10,0,10,新百王,2023-03-03,6210
6237,驊訊,10,0,10,新百王,2023-03-03,6210
8421,旭源,10,0,10,新百王,2023-03-03,6210
2615,萬海,22,12,10,新百王,2023-03-03,6210
6245,立端,311,15,296,新百王,2023-03-06,6210
2867,三商壽,240,0,240,新百王,2023-03-06,6210
2486,一詮,181,37,144,新百王,2023-03-06,6210
2834,臺企銀,88,2,86,新百王,2023-03-06,6210
00673R,期元大S＆P原油反1,89,10,79,新百王,2023-03-06,6210
2358,廷鑫,70,0,70,新百王,2023-03-06,6210
4510,高鋒,60,0,60,新百王,2023-03-06,6210
2458,義隆,41,1,40,新百王,2023-03-06,6210
2845,遠東銀,47,9,38,新百王,2023-03-06,6210
00751B,元大AAA至A公司債,40,5,35,新百王,2023-03-06,6210
00631L,元大台灣50正2,45,11,34,新百王,2023-03-06,6210
2007,燁興,30,0,30,新百王,2023-03-06,6210
4114,健喬,33,3,30,新百王,2023-03-06,6210
6443,元晶,31,3,28,新百王,2023-03-06,6210
6290,良維,45,18,27,新百王,2023-03-06,6210
2352,佳世達,25,0,25,新百王,2023-03-06,6210
6244,茂迪,25,0,25,新百王,2023-03-06,6210
00919,群益台灣精選高息,25,1,24,新百王,2023-03-06,6210
2211,長榮鋼,22,0,22,新百王,2023-03-06,6210
8105,凌巨,22,0,22,新百王,2023-03-06,6210
00681R,元大美債20反1,22,0,22,新百王,2023-03-06,6210
3689,湧德,35,14,21,新百王,2023-03-06,6210
3673,TPK-KY,34,14,20,新百王,2023-03-06,6210
6235,華孚,51,31,20,新百王,2023-03-06,6210
1217,愛之味,20,0,20,新百王,2023-03-06,6210
00881,國泰台灣5G+,32,13,19,新百王,2023-03-06,6210
4979,華星光,28,12,16,新百王,2023-03-06,6210
2027,大成鋼,21,5,16,新百王,2023-03-06,6210
3356,奇偶,45,29,16,新百王,2023-03-06,6210
00905,FT臺灣Smart,15,0,15,新百王,2023-03-06,6210
2014,中鴻,15,0,15,新百王,2023-03-06,6210
2538,基泰,27,12,15,新百王,2023-03-06,6210
1513,中興電,19,5,14,新百王,2023-03-06,6210
3162,精確,21,7,14,新百王,2023-03-06,6210
2484,希華,27,13,14,新百王,2023-03-06,6210
2313,華通,14,0,14,新百王,2023-03-06,6210
1219,福壽,23,9,14,新百王,2023-03-06,6210
8927,北基,12,0,12,新百王,2023-03-06,6210
2375,凱美,15,3,12,新百王,2023-03-06,6210
6165,浪凡,12,0,12,新百王,2023-03-06,6210
1514,亞力,31,19,12,新百王,2023-03-06,6210
6683,雍智科技,11,0,11,新百王,2023-03-06,6210
1210,大成,18,7,11,新百王,2023-03-06,6210
3029,零壹,28,18,10,新百王,2023-03-06,6210
4406,新昕纖,10,0,10,新百王,2023-03-06,6210
6191,精成科,10,0,10,新百王,2023-03-06,6210
2243,宏旭-KY,10,0,10,新百王,2023-03-06,6210
1337,再生-KY,10,0,10,新百王,2023-03-06,6210
3576,聯合再生,10,0,10,新百王,2023-03-06,6210
9940,信義,10,0,10,新百王,2023-03-06,6210
00673R,期元大S＆P原油反1,114,0,114,新百王,2023-03-07,6210
00671R,富邦NASDAQ反1,101,0,101,新百王,2023-03-07,6210
1718,中纖,102,2,100,新百王,2023-03-07,6210
3362,先進光,142,45,97,新百王,2023-03-07,6210
1605,華新,189,98,91,新百王,2023-03-07,6210
3481,群創,121,41,80,新百王,2023-03-07,6210
2352,佳世達,59,6,53,新百王,2023-03-07,6210
8105,凌巨,82,36,46,新百王,2023-03-07,6210
6111,大宇資,37,0,37,新百王,2023-03-07,6210
2538,基泰,56,25,31,新百王,2023-03-07,6210
8176,智捷,30,0,30,新百王,2023-03-07,6210
2442,新美齊,45,17,28,新百王,2023-03-07,6210
2881,富邦金,31,4,27,新百王,2023-03-07,6210
4207,環泰,26,0,26,新百王,2023-03-07,6210
00637L,元大滬深300正2,83,57,26,新百王,2023-03-07,6210
4979,華星光,43,17,26,新百王,2023-03-07,6210
00772B,中信高評級公司債,22,0,22,新百王,2023-03-07,6210
6548,長科*,33,11,22,新百王,2023-03-07,6210
00753L,中信中國50正2,63,43,20,新百王,2023-03-07,6210
5258,虹堡,34,15,19,新百王,2023-03-07,6210
6125,廣運,20,1,19,新百王,2023-03-07,6210
3689,湧德,29,10,19,新百王,2023-03-07,6210
8222,寶一,40,22,18,新百王,2023-03-07,6210
1909,榮成,20,3,17,新百王,2023-03-07,6210
1529,樂事綠能,22,5,17,新百王,2023-03-07,6210
4977,眾達-KY,20,4,16,新百王,2023-03-07,6210
5328,華容,15,0,15,新百王,2023-03-07,6210
6290,良維,77,62,15,新百王,2023-03-07,6210
5483,中美晶,19,4,15,新百王,2023-03-07,6210
6165,浪凡,15,0,15,新百王,2023-03-07,6210
6488,環球晶,15,1,14,新百王,2023-03-07,6210
2834,臺企銀,60,47,13,新百王,2023-03-07,6210
2457,飛宏,59,46,13,新百王,2023-03-07,6210
5210,寶碩,13,0,13,新百王,2023-03-07,6210
6026,福邦證,13,0,13,新百王,2023-03-07,6210
2605,新興,43,30,13,新百王,2023-03-07,6210
00631L,元大台灣50正2,20,7,13,新百王,2023-03-07,6210
8069,元太,33,21,12,新百王,2023-03-07,6210
2630,亞航,12,0,12,新百王,2023-03-07,6210
1210,大成,34,22,12,新百王,2023-03-07,6210
3416,融程電,11,0,11,新百王,2023-03-07,6210
1451,年興,11,0,11,新百王,2023-03-07,6210
3576,聯合再生,11,0,11,新百王,2023-03-07,6210
2607,榮運,15,4,11,新百王,2023-03-07,6210
2332,友訊,10,0,10,新百王,2023-03-07,6210
5489,彩富,10,0,10,新百王,2023-03-07,6210
1465,偉全,10,0,10,新百王,2023-03-07,6210
00905,FT臺灣Smart,10,0,10,新百王,2023-03-07,6210
4406,新昕纖,10,0,10,新百王,2023-03-07,6210
2707,晶華,10,0,10,新百王,2023-03-07,6210
00665L,富邦�琤肭磪囓�2,388,40,348,新百王,2023-03-08,6210
4541,晟田,185,9,176,新百王,2023-03-08,6210
2344,華邦電,115,3,112,新百王,2023-03-08,6210
00712,復華富時不動產,111,0,111,新百王,2023-03-08,6210
00681R,元大美債20反1,102,0,102,新百王,2023-03-08,6210
00751B,元大AAA至A公司債,95,0,95,新百王,2023-03-08,6210
6164,華興,99,29,70,新百王,2023-03-08,6210
8933,愛地雅,71,17,54,新百王,2023-03-08,6210
2442,新美齊,62,9,53,新百王,2023-03-08,6210
2317,鴻海,60,14,46,新百王,2023-03-08,6210
2634,漢翔,162,116,46,新百王,2023-03-08,6210
6165,浪凡,45,0,45,新百王,2023-03-08,6210
6548,長科*,71,31,40,新百王,2023-03-08,6210
3552,同致,41,7,34,新百王,2023-03-08,6210
8069,元太,40,7,33,新百王,2023-03-08,6210
2498,宏達電,34,4,30,新百王,2023-03-08,6210
00664R,國泰臺灣加權反1,30,0,30,新百王,2023-03-08,6210
3349,寶德,28,0,28,新百王,2023-03-08,6210
9907,統一實,40,12,28,新百王,2023-03-08,6210
00683L,期元大美元指正2,100,73,27,新百王,2023-03-08,6210
2486,一詮,220,194,26,新百王,2023-03-08,6210
0050,元大台灣50,31,5,26,新百王,2023-03-08,6210
00719B,元大美債1-3,25,0,25,新百王,2023-03-08,6210
6122,擎邦,26,1,25,新百王,2023-03-08,6210
8163,達方,37,14,23,新百王,2023-03-08,6210
2243,宏旭-KY,22,0,22,新百王,2023-03-08,6210
5328,華容,22,0,22,新百王,2023-03-08,6210
2884,玉山金,24,2,22,新百王,2023-03-08,6210
00878,國泰永續高股息,21,0,21,新百王,2023-03-08,6210
00923,群益台ESG低碳50,21,0,21,新百王,2023-03-08,6210
00713,元大台灣高息低波,20,0,20,新百王,2023-03-08,6210
1708,東鹼,20,0,20,新百王,2023-03-08,6210
3576,聯合再生,30,10,20,新百王,2023-03-08,6210
4960,誠美材,20,0,20,新百王,2023-03-08,6210
9933,中鼎,30,10,20,新百王,2023-03-08,6210
8176,智捷,19,0,19,新百王,2023-03-08,6210
6446,藥華藥,18,0,18,新百王,2023-03-08,6210
2801,彰銀,18,0,18,新百王,2023-03-08,6210
9962,有益,19,1,18,新百王,2023-03-08,6210
2606,裕民,18,2,16,新百王,2023-03-08,6210
00715L,期街口布蘭特正2,24,8,16,新百王,2023-03-08,6210
0056,元大高股息,17,1,16,新百王,2023-03-08,6210
5608,四維航,27,11,16,新百王,2023-03-08,6210
5284,jpp-KY,23,8,15,新百王,2023-03-08,6210
6127,九豪,15,0,15,新百王,2023-03-08,6210
1524,耿鼎,19,4,15,新百王,2023-03-08,6210
3013,晟銘電,117,103,14,新百王,2023-03-08,6210
00738U,期元大道瓊白銀,14,0,14,新百王,2023-03-08,6210
00753L,中信中國50正2,90,77,13,新百王,2023-03-08,6210
4979,華星光,25,13,12,新百王,2023-03-08,6210
00632R,元大台灣50反1,900,200,700,新百王,2023-03-09,6210
6234,高僑,106,0,106,新百王,2023-03-09,6210
1612,宏泰,100,0,100,新百王,2023-03-09,6210
4541,晟田,91,1,90,新百王,2023-03-09,6210
6111,大宇資,91,4,87,新百王,2023-03-09,6210
00751B,元大AAA至A公司債,83,0,83,新百王,2023-03-09,6210
4903,聯光通,83,0,83,新百王,2023-03-09,6210
2344,華邦電,78,6,72,新百王,2023-03-09,6210
6116,彩晶,73,11,62,新百王,2023-03-09,6210
2851,中再保,61,0,61,新百王,2023-03-09,6210
2891,中信金,53,0,53,新百王,2023-03-09,6210
00637L,元大滬深300正2,113,61,52,新百王,2023-03-09,6210
4979,華星光,58,6,52,新百王,2023-03-09,6210
5328,華容,47,0,47,新百王,2023-03-09,6210
3189,景碩,44,1,43,新百王,2023-03-09,6210
3481,群創,93,51,42,新百王,2023-03-09,6210
2888,新光金,41,0,41,新百王,2023-03-09,6210
2442,新美齊,41,0,41,新百王,2023-03-09,6210
2313,華通,37,0,37,新百王,2023-03-09,6210
6548,長科*,90,54,36,新百王,2023-03-09,6210
00885,富邦越南,40,5,35,新百王,2023-03-09,6210
00878,國泰永續高股息,35,0,35,新百王,2023-03-09,6210
00772B,中信高評級公司債,33,0,33,新百王,2023-03-09,6210
8358,金居,31,0,31,新百王,2023-03-09,6210
8176,智捷,29,1,28,新百王,2023-03-09,6210
2538,基泰,28,0,28,新百王,2023-03-09,6210
00720B,元大投資級公司債,26,0,26,新百王,2023-03-09,6210
2317,鴻海,67,43,24,新百王,2023-03-09,6210
00753L,中信中國50正2,23,0,23,新百王,2023-03-09,6210
00665L,富邦�琤肭磪囓�2,312,290,22,新百王,2023-03-09,6210
1605,華新,28,7,21,新百王,2023-03-09,6210
5009,榮剛,96,75,21,新百王,2023-03-09,6210
2368,金像電,63,42,21,新百王,2023-03-09,6210
2352,佳世達,20,0,20,新百王,2023-03-09,6210
2883,凱基金,31,11,20,新百王,2023-03-09,6210
3689,湧德,20,0,20,新百王,2023-03-09,6210
3081,聯亞,20,0,20,新百王,2023-03-09,6210
2537,聯上發,20,0,20,新百王,2023-03-09,6210
2867,三商壽,20,0,20,新百王,2023-03-09,6210
9940,信義,20,0,20,新百王,2023-03-09,6210
3715,定穎投控,20,1,19,新百王,2023-03-09,6210
2618,長榮航,38,20,18,新百王,2023-03-09,6210
1314,中石化,18,0,18,新百王,2023-03-09,6210
2484,希華,18,0,18,新百王,2023-03-09,6210
1514,亞力,24,6,18,新百王,2023-03-09,6210
5388,中磊,17,1,16,新百王,2023-03-09,6210
00715L,期街口布蘭特正2,19,3,16,新百王,2023-03-09,6210
2363,矽統,15,0,15,新百王,2023-03-09,6210
8038,長園科,15,0,15,新百王,2023-03-09,6210
6290,良維,20,5,15,新百王,2023-03-09,6210
2891,中信金,263,0,263,新百王,2023-03-10,6210
3013,晟銘電,274,28,246,新百王,2023-03-10,6210
00712,復華富時不動產,129,17,112,新百王,2023-03-10,6210
00683L,期元大美元指正2,94,0,94,新百王,2023-03-10,6210
2610,華航,104,30,74,新百王,2023-03-10,6210
2344,華邦電,92,20,72,新百王,2023-03-10,6210
9941,裕融,66,1,65,新百王,2023-03-10,6210
2881,富邦金,79,16,63,新百王,2023-03-10,6210
4989,榮科,83,21,62,新百王,2023-03-10,6210
2885,元大金,60,0,60,新百王,2023-03-10,6210
3481,群創,142,82,60,新百王,2023-03-10,6210
6290,良維,56,0,56,新百王,2023-03-10,6210
2618,長榮航,57,2,55,新百王,2023-03-10,6210
2851,中再保,51,2,49,新百王,2023-03-10,6210
6443,元晶,52,12,40,新百王,2023-03-10,6210
2883,凱基金,33,0,33,新百王,2023-03-10,6210
2442,新美齊,49,17,32,新百王,2023-03-10,6210
2607,榮運,54,23,31,新百王,2023-03-10,6210
8176,智捷,31,0,31,新百王,2023-03-10,6210
4744,皇將,29,0,29,新百王,2023-03-10,6210
2313,華通,28,0,28,新百王,2023-03-10,6210
2615,萬海,146,119,27,新百王,2023-03-10,6210
2888,新光金,45,20,25,新百王,2023-03-10,6210
00637L,元大滬深300正2,77,52,25,新百王,2023-03-10,6210
2482,連宇,51,26,25,新百王,2023-03-10,6210
4977,眾達-KY,53,29,24,新百王,2023-03-10,6210
1802,台玻,24,0,24,新百王,2023-03-10,6210
00715L,期街口布蘭特正2,24,0,24,新百王,2023-03-10,6210
2208,台船,23,0,23,新百王,2023-03-10,6210
2063,世鎧,22,0,22,新百王,2023-03-10,6210
8171,天宇,39,18,21,新百王,2023-03-10,6210
6217,中探針,32,11,21,新百王,2023-03-10,6210
00669R,國泰美國道瓊反1,21,0,21,新百王,2023-03-10,6210
6592,和潤企業,20,0,20,新百王,2023-03-10,6210
1217,愛之味,20,0,20,新百王,2023-03-10,6210
9904,寶成,20,0,20,新百王,2023-03-10,6210
2498,宏達電,29,10,19,新百王,2023-03-10,6210
6180,橘子,24,5,19,新百王,2023-03-10,6210
2890,永豐金,19,1,18,新百王,2023-03-10,6210
5876,上海商銀,18,0,18,新百王,2023-03-10,6210
3033,威健,18,0,18,新百王,2023-03-10,6210
00923,群益台ESG低碳50,17,0,17,新百王,2023-03-10,6210
2453,凌群,77,60,17,新百王,2023-03-10,6210
2884,玉山金,19,3,16,新百王,2023-03-10,6210
2359,所羅門,38,22,16,新百王,2023-03-10,6210
00753L,中信中國50正2,27,11,16,新百王,2023-03-10,6210
6546,正基,16,1,15,新百王,2023-03-10,6210
9921,巨大,15,0,15,新百王,2023-03-10,6210
3520,華盈,16,1,15,新百王,2023-03-10,6210
2010,春源,15,0,15,新百王,2023-03-10,6210
00632R,元大台灣50反1,1283,491,792,新百王,2023-03-13,6210
3058,立德,155,0,155,新百王,2023-03-13,6210
2834,臺企銀,152,71,81,新百王,2023-03-13,6210
2486,一詮,76,4,72,新百王,2023-03-13,6210
6234,高僑,72,0,72,新百王,2023-03-13,6210
9955,佳龍,68,1,67,新百王,2023-03-13,6210
00878,國泰永續高股息,83,19,64,新百王,2023-03-13,6210
6516,勤崴國際,60,0,60,新百王,2023-03-13,6210
00680L,元大美債20正2,55,0,55,新百王,2023-03-13,6210
6770,力積電,51,0,51,新百王,2023-03-13,6210
8105,凌巨,50,0,50,新百王,2023-03-13,6210
2606,裕民,58,9,49,新百王,2023-03-13,6210
2812,台中銀,89,45,44,新百王,2023-03-13,6210
2851,中再保,39,0,39,新百王,2023-03-13,6210
6266,泰詠,46,10,36,新百王,2023-03-13,6210
911608,明輝-DR,33,0,33,新百王,2023-03-13,6210
2388,威盛,136,104,32,新百王,2023-03-13,6210
2402,毅嘉,37,10,27,新百王,2023-03-13,6210
00919,群益台灣精選高息,25,0,25,新百王,2023-03-13,6210
2888,新光金,33,9,24,新百王,2023-03-13,6210
0056,元大高股息,28,5,23,新百王,2023-03-13,6210
3236,千如,27,4,23,新百王,2023-03-13,6210
00753L,中信中國50正2,49,26,23,新百王,2023-03-13,6210
9921,巨大,26,3,23,新百王,2023-03-13,6210
2881,富邦金,45,23,22,新百王,2023-03-13,6210
1609,大亞,27,5,22,新百王,2023-03-13,6210
00720B,元大投資級公司債,21,0,21,新百王,2023-03-13,6210
6024,群益期,21,0,21,新百王,2023-03-13,6210
2313,華通,20,0,20,新百王,2023-03-13,6210
5905,南仁湖,20,0,20,新百王,2023-03-13,6210
2538,基泰,20,0,20,新百王,2023-03-13,6210
6165,浪凡,18,0,18,新百王,2023-03-13,6210
8033,雷虎,20,3,17,新百王,2023-03-13,6210
2884,玉山金,17,1,16,新百王,2023-03-13,6210
2442,新美齊,23,7,16,新百王,2023-03-13,6210
1513,中興電,26,11,15,新百王,2023-03-13,6210
3046,建��,74,59,15,新百王,2023-03-13,6210
1536,和大,14,0,14,新百王,2023-03-13,6210
2897,王道銀行,14,0,14,新百王,2023-03-13,6210
00712,復華富時不動產,13,0,13,新百王,2023-03-13,6210
2609,陽明,140,127,13,新百王,2023-03-13,6210
8933,愛地雅,13,0,13,新百王,2023-03-13,6210
00679B,元大美債20年,18,6,12,新百王,2023-03-13,6210
6443,元晶,16,4,12,新百王,2023-03-13,6210
00725B,國泰投資級公司債,13,1,12,新百王,2023-03-13,6210
3234,光環,20,9,11,新百王,2023-03-13,6210
5230,雷笛克光學,11,0,11,新百王,2023-03-13,6210
3059,華晶科,11,0,11,新百王,2023-03-13,6210
3689,湧德,26,15,11,新百王,2023-03-13,6210
2014,中鴻,11,0,11,新百王,2023-03-13,6210
2891,中信金,180,0,180,新百王,2023-03-14,6210
2834,臺企銀,158,30,128,新百王,2023-03-14,6210
00878,國泰永續高股息,148,21,127,新百王,2023-03-14,6210
2852,第一保,103,0,103,新百王,2023-03-14,6210
00772B,中信高評級公司債,102,0,102,新百王,2023-03-14,6210
00665L,富邦�琤肭磪囓�2,417,331,86,新百王,2023-03-14,6210
2610,華航,93,10,83,新百王,2023-03-14,6210
2618,長榮航,112,43,69,新百王,2023-03-14,6210
2344,華邦電,66,5,61,新百王,2023-03-14,6210
2888,新光金,114,54,60,新百王,2023-03-14,6210
00715L,期街口布蘭特正2,74,16,58,新百王,2023-03-14,6210
6244,茂迪,78,28,50,新百王,2023-03-14,6210
00664R,國泰臺灣加權反1,44,0,44,新百王,2023-03-14,6210
2881,富邦金,89,50,39,新百王,2023-03-14,6210
2845,遠東銀,35,0,35,新百王,2023-03-14,6210
2615,萬海,90,56,34,新百王,2023-03-14,6210
2303,聯電,48,15,33,新百王,2023-03-14,6210
2607,榮運,63,30,33,新百王,2023-03-14,6210
0056,元大高股息,30,0,30,新百王,2023-03-14,6210
2442,新美齊,31,2,29,新百王,2023-03-14,6210
2897,王道銀行,27,0,27,新百王,2023-03-14,6210
6101,寬魚國際,24,0,24,新百王,2023-03-14,6210
6111,大宇資,26,3,23,新百王,2023-03-14,6210
2201,裕隆,27,5,22,新百王,2023-03-14,6210
2812,台中銀,51,30,21,新百王,2023-03-14,6210
2883,凱基金,23,3,20,新百王,2023-03-14,6210
00919,群益台灣精選高息,20,0,20,新百王,2023-03-14,6210
1457,宜進,20,0,20,新百王,2023-03-14,6210
00713,元大台灣高息低波,20,1,19,新百王,2023-03-14,6210
00637L,元大滬深300正2,157,138,19,新百王,2023-03-14,6210
6266,泰詠,19,0,19,新百王,2023-03-14,6210
2332,友訊,18,0,18,新百王,2023-03-14,6210
3704,合勤控,19,1,18,新百王,2023-03-14,6210
6288,聯嘉,18,0,18,新百王,2023-03-14,6210
2388,威盛,56,38,18,新百王,2023-03-14,6210
9962,有益,18,0,18,新百王,2023-03-14,6210
0050,元大台灣50,47,31,16,新百王,2023-03-14,6210
00720B,元大投資級公司債,15,0,15,新百王,2023-03-14,6210
2605,新興,26,11,15,新百王,2023-03-14,6210
6589,台康生技,16,1,15,新百王,2023-03-14,6210
00712,復華富時不動產,14,0,14,新百王,2023-03-14,6210
8155,博智,18,4,14,新百王,2023-03-14,6210
6234,高僑,15,1,14,新百王,2023-03-14,6210
2609,陽明,131,118,13,新百王,2023-03-14,6210
00642U,期元大S＆P石油,13,0,13,新百王,2023-03-14,6210
00706L,期元大S＆P日圓正2,13,0,13,新百王,2023-03-14,6210
2867,三商壽,12,0,12,新百王,2023-03-14,6210
2498,宏達電,48,36,12,新百王,2023-03-14,6210
2885,元大金,11,0,11,新百王,2023-03-14,6210
2313,華通,11,0,11,新百王,2023-03-14,6210
2891,中信金,165,3,162,新百王,2023-03-15,6210
00715L,期街口布蘭特正2,143,3,140,新百王,2023-03-15,6210
4934,太極,131,5,126,新百王,2023-03-15,6210
8222,寶一,185,72,113,新百王,2023-03-15,6210
6164,華興,137,39,98,新百王,2023-03-15,6210
2897,王道銀行,90,0,90,新百王,2023-03-15,6210
00642U,期元大S＆P石油,65,0,65,新百王,2023-03-15,6210
2332,友訊,43,0,43,新百王,2023-03-15,6210
00671R,富邦NASDAQ反1,43,0,43,新百王,2023-03-15,6210
00664R,國泰臺灣加權反1,40,0,40,新百王,2023-03-15,6210
00680L,元大美債20正2,42,3,39,新百王,2023-03-15,6210
00772B,中信高評級公司債,38,0,38,新百王,2023-03-15,6210
2371,大同,90,55,35,新百王,2023-03-15,6210
2883,凱基金,49,17,32,新百王,2023-03-15,6210
1444,力麗,30,0,30,新百王,2023-03-15,6210
9904,寶成,26,0,26,新百王,2023-03-15,6210
2812,台中銀,80,55,25,新百王,2023-03-15,6210
6573,虹揚-KY,26,2,24,新百王,2023-03-15,6210
1216,統一,25,1,24,新百王,2023-03-15,6210
4550,長佳,24,1,23,新百王,2023-03-15,6210
2609,陽明,90,68,22,新百王,2023-03-15,6210
6248,沛波,21,0,21,新百王,2023-03-15,6210
00713,元大台灣高息低波,47,26,21,新百王,2023-03-15,6210
5481,新華,20,0,20,新百王,2023-03-15,6210
5475,德宏,20,0,20,新百王,2023-03-15,6210
5011,久陽,20,0,20,新百王,2023-03-15,6210
00740B,富邦全球投等債,20,0,20,新百王,2023-03-15,6210
2497,怡利電,23,4,19,新百王,2023-03-15,6210
2634,漢翔,66,48,18,新百王,2023-03-15,6210
2014,中鴻,16,0,16,新百王,2023-03-15,6210
8096,擎亞,15,0,15,新百王,2023-03-15,6210
2884,玉山金,26,12,14,新百王,2023-03-15,6210
5009,榮剛,49,35,14,新百王,2023-03-15,6210
1514,亞力,14,0,14,新百王,2023-03-15,6210
1712,興農,17,3,14,新百王,2023-03-15,6210
00712,復華富時不動產,16,2,14,新百王,2023-03-15,6210
2330,台積電,16,3,13,新百王,2023-03-15,6210
2881,富邦金,18,5,13,新百王,2023-03-15,6210
5426,振發,13,0,13,新百王,2023-03-15,6210
1504,東元,17,5,12,新百王,2023-03-15,6210
4510,高鋒,12,0,12,新百王,2023-03-15,6210
5425,台半,35,24,11,新百王,2023-03-15,6210
2402,毅嘉,31,20,11,新百王,2023-03-15,6210
00648R,元大S＆P500反1,11,0,11,新百王,2023-03-15,6210
2313,華通,14,3,11,新百王,2023-03-15,6210
4533,協易機,11,0,11,新百王,2023-03-15,6210
2618,長榮航,14,4,10,新百王,2023-03-15,6210
6488,環球晶,10,0,10,新百王,2023-03-15,6210
2352,佳世達,10,0,10,新百王,2023-03-15,6210
5522,遠雄,50,40,10,新百王,2023-03-15,6210
2891,中信金,331,52,279,新百王,2023-03-16,6210
6164,華興,218,0,218,新百王,2023-03-16,6210
3058,立德,195,20,175,新百王,2023-03-16,6210
4934,太極,141,11,130,新百王,2023-03-16,6210
00878,國泰永續高股息,116,21,95,新百王,2023-03-16,6210
00715L,期街口布蘭特正2,143,58,85,新百王,2023-03-16,6210
3703,欣陸,70,0,70,新百王,2023-03-16,6210
2371,大同,67,0,67,新百王,2023-03-16,6210
00642U,期元大S＆P石油,59,0,59,新百王,2023-03-16,6210
5009,榮剛,81,25,56,新百王,2023-03-16,6210
2442,新美齊,63,8,55,新百王,2023-03-16,6210
4555,氣立,55,0,55,新百王,2023-03-16,6210
2851,中再保,55,1,54,新百王,2023-03-16,6210
2645,長榮航太,49,1,48,新百王,2023-03-16,6210
6185,幃翔,41,0,41,新百王,2023-03-16,6210
2881,富邦金,65,27,38,新百王,2023-03-16,6210
2027,大成鋼,47,10,37,新百王,2023-03-16,6210
2498,宏達電,58,22,36,新百王,2023-03-16,6210
00632R,元大台灣50反1,170,134,36,新百王,2023-03-16,6210
0050,元大台灣50,63,27,36,新百王,2023-03-16,6210
2888,新光金,50,15,35,新百王,2023-03-16,6210
6165,浪凡,35,0,35,新百王,2023-03-16,6210
6163,華電網,77,42,35,新百王,2023-03-16,6210
00712,復華富時不動產,50,15,35,新百王,2023-03-16,6210
00713,元大台灣高息低波,38,5,33,新百王,2023-03-16,6210
2607,榮運,34,1,33,新百王,2023-03-16,6210
1457,宜進,30,0,30,新百王,2023-03-16,6210
2313,華通,45,16,29,新百王,2023-03-16,6210
3455,由田,52,24,28,新百王,2023-03-16,6210
2542,興富發,26,1,25,新百王,2023-03-16,6210
2603,長榮,89,64,25,新百王,2023-03-16,6210
2882,國泰金,27,6,21,新百王,2023-03-16,6210
00688L,國泰20年美債正2,21,0,21,新百王,2023-03-16,6210
2419,仲琦,20,0,20,新百王,2023-03-16,6210
6111,大宇資,27,7,20,新百王,2023-03-16,6210
00720B,元大投資級公司債,20,0,20,新百王,2023-03-16,6210
6290,良維,22,3,19,新百王,2023-03-16,6210
3264,欣銓,31,12,19,新百王,2023-03-16,6210
1314,中石化,28,10,18,新百王,2023-03-16,6210
6024,群益期,18,0,18,新百王,2023-03-16,6210
5465,富驊,20,3,17,新百王,2023-03-16,6210
2002,中鋼,16,0,16,新百王,2023-03-16,6210
3520,華盈,20,4,16,新百王,2023-03-16,6210
1609,大亞,15,0,15,新百王,2023-03-16,6210
2610,華航,35,20,15,新百王,2023-03-16,6210
6223,旺矽,17,2,15,新百王,2023-03-16,6210
2338,光罩,25,10,15,新百王,2023-03-16,6210
2605,新興,45,31,14,新百王,2023-03-16,6210
2601,益航,14,0,14,新百王,2023-03-16,6210
5515,建國,14,0,14,新百王,2023-03-16,6210
1529,樂事綠能,124,10,114,新百王,2023-03-17,6210
2867,三商壽,104,23,81,新百王,2023-03-17,6210
1504,東元,120,48,72,新百王,2023-03-17,6210
9962,有益,72,0,72,新百王,2023-03-17,6210
6185,幃翔,59,1,58,新百王,2023-03-17,6210
2891,中信金,57,6,51,新百王,2023-03-17,6210
1514,亞力,55,6,49,新百王,2023-03-17,6210
00631L,元大台灣50正2,48,6,42,新百王,2023-03-17,6210
2888,新光金,115,77,38,新百王,2023-03-17,6210
2412,中華電,39,3,36,新百王,2023-03-17,6210
3029,零壹,42,7,35,新百王,2023-03-17,6210
3231,緯創,37,2,35,新百王,2023-03-17,6210
2610,華航,45,10,35,新百王,2023-03-17,6210
2890,永豐金,33,0,33,新百王,2023-03-17,6210
2376,技嘉,40,8,32,新百王,2023-03-17,6210
2607,榮運,30,0,30,新百王,2023-03-17,6210
00885,富邦越南,29,1,28,新百王,2023-03-17,6210
5483,中美晶,36,11,25,新百王,2023-03-17,6210
5880,合庫金,25,0,25,新百王,2023-03-17,6210
5258,虹堡,34,11,23,新百王,2023-03-17,6210
2303,聯電,37,14,23,新百王,2023-03-17,6210
00671R,富邦NASDAQ反1,21,0,21,新百王,2023-03-17,6210
8499,鼎炫-KY,20,0,20,新百王,2023-03-17,6210
00726B,國泰新興投等債,20,0,20,新百王,2023-03-17,6210
00632R,元大台灣50反1,258,240,18,新百王,2023-03-17,6210
9904,寶成,23,5,18,新百王,2023-03-17,6210
6164,華興,102,85,17,新百王,2023-03-17,6210
8222,寶一,58,41,17,新百王,2023-03-17,6210
2534,宏盛,17,0,17,新百王,2023-03-17,6210
6548,長科*,21,4,17,新百王,2023-03-17,6210
6191,精成科,16,0,16,新百王,2023-03-17,6210
6770,力積電,20,4,16,新百王,2023-03-17,6210
6177,達麗,15,0,15,新百王,2023-03-17,6210
5876,上海商銀,15,0,15,新百王,2023-03-17,6210
2328,廣宇,15,0,15,新百王,2023-03-17,6210
4555,氣立,19,4,15,新百王,2023-03-17,6210
00878,國泰永續高股息,14,0,14,新百王,2023-03-17,6210
3520,華盈,17,3,14,新百王,2023-03-17,6210
2606,裕民,18,4,14,新百王,2023-03-17,6210
3707,漢磊,27,13,14,新百王,2023-03-17,6210
00720B,元大投資級公司債,14,1,13,新百王,2023-03-17,6210
6625,必應,13,0,13,新百王,2023-03-17,6210
2413,環科,22,9,13,新百王,2023-03-17,6210
1513,中興電,58,46,12,新百王,2023-03-17,6210
1444,力麗,12,0,12,新百王,2023-03-17,6210
00772B,中信高評級公司債,12,0,12,新百王,2023-03-17,6210
6122,擎邦,12,0,12,新百王,2023-03-17,6210
6282,康舒,33,21,12,新百王,2023-03-17,6210
00648R,元大S＆P500反1,11,0,11,新百王,2023-03-17,6210
1216,統一,11,0,11,新百王,2023-03-17,6210
00669R,國泰美國道瓊反1,175,36,139,新百王,2023-03-20,6210
00632R,元大台灣50反1,190,80,110,新百王,2023-03-20,6210
00665L,富邦�琤肭磪囓�2,370,265,105,新百王,2023-03-20,6210
00642U,期元大S＆P石油,78,1,77,新百王,2023-03-20,6210
6234,高僑,76,0,76,新百王,2023-03-20,6210
1460,宏遠,70,0,70,新百王,2023-03-20,6210
3058,立德,70,0,70,新百王,2023-03-20,6210
00637L,元大滬深300正2,157,90,67,新百王,2023-03-20,6210
2371,大同,92,34,58,新百王,2023-03-20,6210
3576,聯合再生,50,0,50,新百王,2023-03-20,6210
00891,中信關鍵半導體,50,0,50,新百王,2023-03-20,6210
00878,國泰永續高股息,52,5,47,新百王,2023-03-20,6210
3038,全台,40,1,39,新百王,2023-03-20,6210
1514,亞力,74,36,38,新百王,2023-03-20,6210
00753L,中信中國50正2,37,2,35,新百王,2023-03-20,6210
3094,聯傑,35,0,35,新百王,2023-03-20,6210
2014,中鴻,35,0,35,新百王,2023-03-20,6210
3024,憶聲,30,0,30,新百王,2023-03-20,6210
3035,智原,30,2,28,新百王,2023-03-20,6210
2882,國泰金,29,5,24,新百王,2023-03-20,6210
1605,華新,35,12,23,新百王,2023-03-20,6210
2413,環科,34,12,22,新百王,2023-03-20,6210
1513,中興電,32,12,20,新百王,2023-03-20,6210
00724B,群益投資級金融債,20,0,20,新百王,2023-03-20,6210
00751B,元大AAA至A公司債,20,0,20,新百王,2023-03-20,6210
2002,中鋼,20,0,20,新百王,2023-03-20,6210
00674R,期元大S＆P黃金反1,20,0,20,新百王,2023-03-20,6210
5009,榮剛,33,13,20,新百王,2023-03-20,6210
6185,幃翔,30,10,20,新百王,2023-03-20,6210
3088,艾訊,20,1,19,新百王,2023-03-20,6210
2402,毅嘉,22,4,18,新百王,2023-03-20,6210
2436,偉詮電,17,0,17,新百王,2023-03-20,6210
2359,所羅門,31,14,17,新百王,2023-03-20,6210
2481,強茂,30,13,17,新百王,2023-03-20,6210
5309,系統電,17,0,17,新百王,2023-03-20,6210
3264,欣銓,15,0,15,新百王,2023-03-20,6210
4541,晟田,16,1,15,新百王,2023-03-20,6210
2317,鴻海,21,6,15,新百王,2023-03-20,6210
00852L,國泰美國道瓊正2,14,0,14,新百王,2023-03-20,6210
6625,必應,14,0,14,新百王,2023-03-20,6210
6123,上奇,14,0,14,新百王,2023-03-20,6210
0050,元大台灣50,47,33,14,新百王,2023-03-20,6210
1524,耿鼎,16,3,13,新百王,2023-03-20,6210
6525,捷敏-KY,13,0,13,新百王,2023-03-20,6210
4977,眾達-KY,42,30,12,新百王,2023-03-20,6210
2230,泰茂,20,8,12,新百王,2023-03-20,6210
2891,中信金,11,1,10,新百王,2023-03-20,6210
8028,昇陽半導體,15,5,10,新百王,2023-03-20,6210
3036A,文曄甲特,10,0,10,新百王,2023-03-20,6210
1465,偉全,10,0,10,新百王,2023-03-20,6210
3312,弘憶股,202,0,202,新百王,2023-03-21,6210
00632R,元大台灣50反1,330,161,169,新百王,2023-03-21,6210
1504,東元,141,35,106,新百王,2023-03-21,6210
3481,群創,101,23,78,新百王,2023-03-21,6210
1709,和益,60,1,59,新百王,2023-03-21,6210
5469,瀚宇博,55,1,54,新百王,2023-03-21,6210
00885,富邦越南,44,0,44,新百王,2023-03-21,6210
5009,榮剛,51,12,39,新百王,2023-03-21,6210
2891,中信金,30,0,30,新百王,2023-03-21,6210
4142,國光生,30,1,29,新百王,2023-03-21,6210
5309,系統電,28,0,28,新百王,2023-03-21,6210
6182,合晶,31,5,26,新百王,2023-03-21,6210
6191,精成科,35,9,26,新百王,2023-03-21,6210
2328,廣宇,26,1,25,新百王,2023-03-21,6210
4157,太景*-KY,25,0,25,新百王,2023-03-21,6210
2801,彰銀,23,0,23,新百王,2023-03-21,6210
8112A,至上甲特,21,0,21,新百王,2023-03-21,6210
4541,晟田,20,0,20,新百王,2023-03-21,6210
2457,飛宏,89,69,20,新百王,2023-03-21,6210
3025,星通,20,0,20,新百王,2023-03-21,6210
5388,中磊,20,0,20,新百王,2023-03-21,6210
00669R,國泰美國道瓊反1,20,0,20,新百王,2023-03-21,6210
00674R,期元大S＆P黃金反1,20,0,20,新百王,2023-03-21,6210
6869,雲豹能源,20,0,20,新百王,2023-03-21,6210
6443,元晶,36,17,19,新百王,2023-03-21,6210
0050,元大台灣50,20,2,18,新百王,2023-03-21,6210
6546,正基,17,0,17,新百王,2023-03-21,6210
6288,聯嘉,43,27,16,新百王,2023-03-21,6210
3162,精確,42,26,16,新百王,2023-03-21,6210
6235,華孚,49,33,16,新百王,2023-03-21,6210
1598,岱宇,15,0,15,新百王,2023-03-21,6210
2442,新美齊,25,10,15,新百王,2023-03-21,6210
2388,威盛,52,37,15,新百王,2023-03-21,6210
2618,長榮航,15,1,14,新百王,2023-03-21,6210
2002,中鋼,13,0,13,新百王,2023-03-21,6210
00712,復華富時不動產,20,8,12,新百王,2023-03-21,6210
2408,南亞科,13,1,12,新百王,2023-03-21,6210
3624,光頡,23,11,12,新百王,2023-03-21,6210
4129,聯合,18,7,11,新百王,2023-03-21,6210
2409,友達,21,11,10,新百王,2023-03-21,6210
00720B,元大投資級公司債,10,0,10,新百王,2023-03-21,6210
00751B,元大AAA至A公司債,10,0,10,新百王,2023-03-21,6210
2601,益航,10,0,10,新百王,2023-03-21,6210
3322,建舜電,12,2,10,新百王,2023-03-21,6210
1616,億泰,10,0,10,新百王,2023-03-21,6210
00713,元大台灣高息低波,10,0,10,新百王,2023-03-21,6210
00688L,國泰20年美債正2,10,0,10,新百王,2023-03-21,6210
3024,憶聲,10,0,10,新百王,2023-03-21,6210
4960,誠美材,10,0,10,新百王,2023-03-21,6210
4729,熒茂,10,0,10,新百王,2023-03-21,6210
00751B,元大AAA至A公司債,206,0,206,新百王,2023-03-22,6210
00665L,富邦�琤肭磪囓�2,399,263,136,新百王,2023-03-22,6210
6234,高僑,100,1,99,新百王,2023-03-22,6210
3710,連展投控,78,4,74,新百王,2023-03-22,6210
6276,安鈦克,73,0,73,新百王,2023-03-22,6210
6443,元晶,93,28,65,新百王,2023-03-22,6210
6625,必應,61,0,61,新百王,2023-03-22,6210
6185,幃翔,63,13,50,新百王,2023-03-22,6210
3715,定穎投控,144,100,44,新百王,2023-03-22,6210
8222,寶一,56,13,43,新百王,2023-03-22,6210
2867,三商壽,40,0,40,新百王,2023-03-22,6210
00637L,元大滬深300正2,96,58,38,新百王,2023-03-22,6210
3481,群創,36,0,36,新百王,2023-03-22,6210
00664R,國泰臺灣加權反1,35,0,35,新百王,2023-03-22,6210
1314,中石化,32,0,32,新百王,2023-03-22,6210
4207,環泰,31,0,31,新百王,2023-03-22,6210
6733,博晟生醫,32,1,31,新百王,2023-03-22,6210
1514,亞力,33,5,28,新百王,2023-03-22,6210
8112A,至上甲特,27,0,27,新百王,2023-03-22,6210
9904,寶成,27,0,27,新百王,2023-03-22,6210
2442,新美齊,26,0,26,新百王,2023-03-22,6210
1321,大洋,24,0,24,新百王,2023-03-22,6210
3236,千如,23,0,23,新百王,2023-03-22,6210
2383,台光電,25,2,23,新百王,2023-03-22,6210
00878,國泰永續高股息,101,78,23,新百王,2023-03-22,6210
5469,瀚宇博,20,0,20,新百王,2023-03-22,6210
00753L,中信中國50正2,41,21,20,新百王,2023-03-22,6210
2065,世豐,20,0,20,新百王,2023-03-22,6210
00900,富邦特選高股息30,22,3,19,新百王,2023-03-22,6210
1709,和益,20,2,18,新百王,2023-03-22,6210
6122,擎邦,72,55,17,新百王,2023-03-22,6210
6414,樺漢,16,0,16,新百王,2023-03-22,6210
1524,耿鼎,40,24,16,新百王,2023-03-22,6210
6015,宏遠證,16,1,15,新百王,2023-03-22,6210
8097,常珵,15,0,15,新百王,2023-03-22,6210
2303,聯電,28,14,14,新百王,2023-03-22,6210
4977,眾達-KY,24,10,14,新百王,2023-03-22,6210
3290,東浦,15,2,13,新百王,2023-03-22,6210
00679B,元大美債20年,13,0,13,新百王,2023-03-22,6210
3356,奇偶,14,1,13,新百王,2023-03-22,6210
6233,旺玖,39,27,12,新百王,2023-03-22,6210
5009,榮剛,47,35,12,新百王,2023-03-22,6210
1319,東陽,12,0,12,新百王,2023-03-22,6210
3693,營邦,14,3,11,新百王,2023-03-22,6210
2891,中信金,13,3,10,新百王,2023-03-22,6210
3024,憶聲,15,5,10,新百王,2023-03-22,6210
3059,華晶科,23,13,10,新百王,2023-03-22,6210
1810,和成,10,0,10,新百王,2023-03-22,6210
6140,訊達,25,15,10,新百王,2023-03-22,6210
2903,遠百,10,0,10,新百王,2023-03-22,6210
00632R,元大台灣50反1,266,77,189,新百王,2023-03-23,6210
8069,元太,154,8,146,新百王,2023-03-23,6210
1529,樂事綠能,106,6,100,新百王,2023-03-23,6210
00671R,富邦NASDAQ反1,103,10,93,新百王,2023-03-23,6210
2449,京元電子,103,15,88,新百王,2023-03-23,6210
00885,富邦越南,68,3,65,新百王,2023-03-23,6210
2444,兆勁,66,3,63,新百王,2023-03-23,6210
5309,系統電,62,8,54,新百王,2023-03-23,6210
3481,群創,123,80,43,新百王,2023-03-23,6210
2049,上銀,41,1,40,新百王,2023-03-23,6210
00720B,元大投資級公司債,37,0,37,新百王,2023-03-23,6210
3290,東浦,36,1,35,新百王,2023-03-23,6210
3322,建舜電,62,28,34,新百王,2023-03-23,6210
00725B,國泰投資級公司債,34,0,34,新百王,2023-03-23,6210
2324,仁寶,59,27,32,新百王,2023-03-23,6210
9939,宏全,30,0,30,新百王,2023-03-23,6210
2332,友訊,30,0,30,新百王,2023-03-23,6210
00751B,元大AAA至A公司債,39,10,29,新百王,2023-03-23,6210
6276,安鈦克,31,2,29,新百王,2023-03-23,6210
00712,復華富時不動產,26,0,26,新百王,2023-03-23,6210
2834,臺企銀,21,0,21,新百王,2023-03-23,6210
3211,順達,20,0,20,新百王,2023-03-23,6210
3591,艾笛森,20,0,20,新百王,2023-03-23,6210
1519,華城,25,5,20,新百王,2023-03-23,6210
6462,神盾,20,0,20,新百王,2023-03-23,6210
2402,毅嘉,106,87,19,新百王,2023-03-23,6210
6266,泰詠,54,36,18,新百王,2023-03-23,6210
3504,揚明光,18,0,18,新百王,2023-03-23,6210
4207,環泰,17,0,17,新百王,2023-03-23,6210
2413,環科,21,4,17,新百王,2023-03-23,6210
4147,中裕,29,13,16,新百王,2023-03-23,6210
00900,富邦特選高股息30,19,3,16,新百王,2023-03-23,6210
2903,遠百,15,0,15,新百王,2023-03-23,6210
00852L,國泰美國道瓊正2,15,0,15,新百王,2023-03-23,6210
2886,兆豐金,15,0,15,新百王,2023-03-23,6210
5465,富驊,21,7,14,新百王,2023-03-23,6210
2323,中環,14,0,14,新百王,2023-03-23,6210
2442,新美齊,30,17,13,新百王,2023-03-23,6210
6244,茂迪,60,47,13,新百王,2023-03-23,6210
3188,鑫龍騰,13,0,13,新百王,2023-03-23,6210
2482,連宇,21,8,13,新百王,2023-03-23,6210
4995,晶達,13,0,13,新百王,2023-03-23,6210
5425,台半,100,88,12,新百王,2023-03-23,6210
2453,凌群,32,20,12,新百王,2023-03-23,6210
4114,健喬,25,14,11,新百王,2023-03-23,6210
2607,榮運,11,0,11,新百王,2023-03-23,6210
2368,金像電,11,1,10,新百王,2023-03-23,6210
1762,中化生,10,0,10,新百王,2023-03-23,6210
8210,勤誠,10,0,10,新百王,2023-03-23,6210
3673,TPK-KY,10,0,10,新百王,2023-03-23,6210
00632R,元大台灣50反1,501,155,346,新百王,2023-03-24,6210
00671R,富邦NASDAQ反1,103,0,103,新百王,2023-03-24,6210
6276,安鈦克,112,13,99,新百王,2023-03-24,6210
00665L,富邦�琤肭磪囓�2,476,394,82,新百王,2023-03-24,6210
4763,材料-KY,93,26,67,新百王,2023-03-24,6210
3093,港建*,62,1,61,新百王,2023-03-24,6210
6109,亞元,60,5,55,新百王,2023-03-24,6210
2834,臺企銀,50,5,45,新百王,2023-03-24,6210
3707,漢磊,45,0,45,新百王,2023-03-24,6210
00664R,國泰臺灣加權反1,42,0,42,新百王,2023-03-24,6210
9945,潤泰新,42,5,37,新百王,2023-03-24,6210
2303,聯電,57,22,35,新百王,2023-03-24,6210
1722,台肥,35,0,35,新百王,2023-03-24,6210
00683L,期元大美元指正2,31,0,31,新百王,2023-03-24,6210
6111,大宇資,49,20,29,新百王,2023-03-24,6210
4164,承業醫,41,13,28,新百王,2023-03-24,6210
6192,巨路,27,0,27,新百王,2023-03-24,6210
2645,長榮航太,27,0,27,新百王,2023-03-24,6210
2383,台光電,31,5,26,新百王,2023-03-24,6210
8234,新漢,41,16,25,新百王,2023-03-24,6210
00674R,期元大S＆P黃金反1,25,0,25,新百王,2023-03-24,6210
6245,立端,67,43,24,新百王,2023-03-24,6210
4977,眾達-KY,26,3,23,新百王,2023-03-24,6210
6122,擎邦,72,50,22,新百王,2023-03-24,6210
3546,宇峻,22,2,20,新百王,2023-03-24,6210
4207,環泰,20,0,20,新百王,2023-03-24,6210
3038,全台,20,2,18,新百王,2023-03-24,6210
2431,聯昌,18,0,18,新百王,2023-03-24,6210
9939,宏全,38,20,18,新百王,2023-03-24,6210
1524,耿鼎,23,6,17,新百王,2023-03-24,6210
00679B,元大美債20年,16,0,16,新百王,2023-03-24,6210
3625,西勝,16,0,16,新百王,2023-03-24,6210
2392,正崴,60,44,16,新百王,2023-03-24,6210
6443,元晶,44,28,16,新百王,2023-03-24,6210
6532,瑞耘,15,0,15,新百王,2023-03-24,6210
6226,光鼎,15,0,15,新百王,2023-03-24,6210
3088,艾訊,14,0,14,新百王,2023-03-24,6210
6244,茂迪,43,30,13,新百王,2023-03-24,6210
6233,旺玖,38,26,12,新百王,2023-03-24,6210
6462,神盾,12,0,12,新百王,2023-03-24,6210
2014,中鴻,12,0,12,新百王,2023-03-24,6210
4190,佐登-KY,14,2,12,新百王,2023-03-24,6210
6625,必應,12,0,12,新百王,2023-03-24,6210
2349,錸德,13,2,11,新百王,2023-03-24,6210
4541,晟田,11,0,11,新百王,2023-03-24,6210
4979,華星光,13,2,11,新百王,2023-03-24,6210
2388,威盛,168,157,11,新百王,2023-03-24,6210
8926,台汽電,18,7,11,新百王,2023-03-24,6210
2615,萬海,16,6,10,新百王,2023-03-24,6210
00725B,國泰投資級公司債,10,0,10,新百王,2023-03-24,6210
00632R,元大台灣50反1,545,181,364,新百王,2023-03-27,6210
00665L,富邦�琤肭磪囓�2,235,112,123,新百王,2023-03-27,6210
2330,台積電,73,15,58,新百王,2023-03-27,6210
3272,東碩,58,1,57,新百王,2023-03-27,6210
1504,東元,97,42,55,新百王,2023-03-27,6210
6122,擎邦,93,39,54,新百王,2023-03-27,6210
00680L,元大美債20正2,50,0,50,新百王,2023-03-27,6210
1718,中纖,50,0,50,新百王,2023-03-27,6210
2317,鴻海,53,4,49,新百王,2023-03-27,6210
2329,華泰,50,1,49,新百王,2023-03-27,6210
00773B,中信優先金融債,48,0,48,新百王,2023-03-27,6210
8222,寶一,94,56,38,新百王,2023-03-27,6210
5309,系統電,38,0,38,新百王,2023-03-27,6210
2461,光群雷,33,1,32,新百王,2023-03-27,6210
9934,成霖,30,0,30,新百王,2023-03-27,6210
1605,華新,57,27,30,新百王,2023-03-27,6210
3715,定穎投控,62,36,26,新百王,2023-03-27,6210
3264,欣銓,36,11,25,新百王,2023-03-27,6210
4919,新唐,26,2,24,新百王,2023-03-27,6210
2201,裕隆,26,3,23,新百王,2023-03-27,6210
00753L,中信中國50正2,26,4,22,新百王,2023-03-27,6210
5355,佳總,20,0,20,新百王,2023-03-27,6210
8234,新漢,31,11,20,新百王,2023-03-27,6210
2883,凱基金,40,21,19,新百王,2023-03-27,6210
6276,安鈦克,20,1,19,新百王,2023-03-27,6210
2834,臺企銀,39,21,18,新百王,2023-03-27,6210
6156,松上,18,0,18,新百王,2023-03-27,6210
6153,嘉聯益,21,3,18,新百王,2023-03-27,6210
3046,建��,70,52,18,新百王,2023-03-27,6210
5244,弘凱,20,2,18,新百王,2023-03-27,6210
6245,立端,26,8,18,新百王,2023-03-27,6210
2392,正崴,30,12,18,新百王,2023-03-27,6210
3029,零壹,20,3,17,新百王,2023-03-27,6210
6532,瑞耘,17,0,17,新百王,2023-03-27,6210
3105,穩懋,17,2,15,新百王,2023-03-27,6210
3576,聯合再生,14,0,14,新百王,2023-03-27,6210
2845,遠東銀,14,0,14,新百王,2023-03-27,6210
6841,長佳智能,18,6,12,新百王,2023-03-27,6210
3520,華盈,12,0,12,新百王,2023-03-27,6210
2323,中環,11,0,11,新百王,2023-03-27,6210
2610,華航,11,0,11,新百王,2023-03-27,6210
6109,亞元,12,1,11,新百王,2023-03-27,6210
2408,南亞科,23,12,11,新百王,2023-03-27,6210
9945,潤泰新,23,12,11,新百王,2023-03-27,6210
00637L,元大滬深300正2,74,63,11,新百王,2023-03-27,6210
6161,捷波,28,17,11,新百王,2023-03-27,6210
2002,中鋼,11,0,11,新百王,2023-03-27,6210
2105,正新,13,3,10,新百王,2023-03-27,6210
5465,富驊,11,1,10,新百王,2023-03-27,6210
2344,華邦電,24,14,10,新百王,2023-03-27,6210
2243,宏旭-KY,135,0,135,新百王,2023-03-28,6210
00680L,元大美債20正2,76,0,76,新百王,2023-03-28,6210
6167,久正,72,0,72,新百王,2023-03-28,6210
6290,良維,67,20,47,新百王,2023-03-28,6210
2206,三陽工業,47,0,47,新百王,2023-03-28,6210
2419,仲琦,40,0,40,新百王,2023-03-28,6210
3236,千如,43,4,39,新百王,2023-03-28,6210
3093,港建*,39,0,39,新百王,2023-03-28,6210
3481,群創,74,38,36,新百王,2023-03-28,6210
00679B,元大美債20年,35,0,35,新百王,2023-03-28,6210
3706,神達,31,1,30,新百王,2023-03-28,6210
00751B,元大AAA至A公司債,29,0,29,新百王,2023-03-28,6210
1504,東元,68,42,26,新百王,2023-03-28,6210
5011,久陽,36,11,25,新百王,2023-03-28,6210
4916,事欣科,24,0,24,新百王,2023-03-28,6210
2887,台新金,23,0,23,新百王,2023-03-28,6210
3492,長盛,23,0,23,新百王,2023-03-28,6210
2349,錸德,23,0,23,新百王,2023-03-28,6210
00857B,永豐20年美公債,23,0,23,新百王,2023-03-28,6210
6276,安鈦克,26,3,23,新百王,2023-03-28,6210
2340,台亞,42,21,21,新百王,2023-03-28,6210
6244,茂迪,51,30,21,新百王,2023-03-28,6210
1611,中電,21,0,21,新百王,2023-03-28,6210
5465,富驊,25,5,20,新百王,2023-03-28,6210
3037,欣興,34,14,20,新百王,2023-03-28,6210
0050,元大台灣50,30,11,19,新百王,2023-03-28,6210
5009,榮剛,53,34,19,新百王,2023-03-28,6210
6285,啟��,38,19,19,新百王,2023-03-28,6210
00772B,中信高評級公司債,18,0,18,新百王,2023-03-28,6210
8926,台汽電,22,4,18,新百王,2023-03-28,6210
00725B,國泰投資級公司債,20,3,17,新百王,2023-03-28,6210
6284,佳邦,20,3,17,新百王,2023-03-28,6210
6185,幃翔,56,39,17,新百王,2023-03-28,6210
6806,森崴能源,28,11,17,新百王,2023-03-28,6210
2409,友達,16,0,16,新百王,2023-03-28,6210
2371,大同,26,10,16,新百王,2023-03-28,6210
2303,聯電,16,1,15,新百王,2023-03-28,6210
2069,運錩,15,0,15,新百王,2023-03-28,6210
2388,威盛,98,84,14,新百王,2023-03-28,6210
8411,福貞-KY,14,0,14,新百王,2023-03-28,6210
3362,先進光,23,9,14,新百王,2023-03-28,6210
2867,三商壽,14,0,14,新百王,2023-03-28,6210
00720B,元大投資級公司債,19,6,13,新百王,2023-03-28,6210
4207,環泰,13,0,13,新百王,2023-03-28,6210
3714,富采,15,3,12,新百王,2023-03-28,6210
3062,建漢,12,0,12,新百王,2023-03-28,6210
6156,松上,12,0,12,新百王,2023-03-28,6210
00922,國泰台灣領袖50,12,0,12,新百王,2023-03-28,6210
00900,富邦特選高股息30,11,0,11,新百王,2023-03-28,6210
6245,立端,14,3,11,新百王,2023-03-28,6210
00665L,富邦�琤肭磪囓�2,387,246,141,新百王,2023-03-29,6210
1709,和益,100,0,100,新百王,2023-03-29,6210
2461,光群雷,88,0,88,新百王,2023-03-29,6210
8930,青鋼,83,0,83,新百王,2023-03-29,6210
00664R,國泰臺灣加權反1,80,0,80,新百王,2023-03-29,6210
00720B,元大投資級公司債,71,1,70,新百王,2023-03-29,6210
1609,大亞,101,43,58,新百王,2023-03-29,6210
00680L,元大美債20正2,55,0,55,新百王,2023-03-29,6210
2344,華邦電,51,0,51,新百王,2023-03-29,6210
3035,智原,78,34,44,新百王,2023-03-29,6210
00885,富邦越南,44,0,44,新百王,2023-03-29,6210
00882,中信中國高股息,35,0,35,新百王,2023-03-29,6210
2332,友訊,31,0,31,新百王,2023-03-29,6210
5309,系統電,32,2,30,新百王,2023-03-29,6210
2884,玉山金,31,1,30,新百王,2023-03-29,6210
2303,聯電,35,9,26,新百王,2023-03-29,6210
3447,展達,22,0,22,新百王,2023-03-29,6210
3290,東浦,22,0,22,新百王,2023-03-29,6210
4529,淳紳,20,0,20,新百王,2023-03-29,6210
4906,正文,19,1,18,新百王,2023-03-29,6210
6167,久正,18,0,18,新百王,2023-03-29,6210
4989,榮科,15,0,15,新百王,2023-03-29,6210
7402,邑錡,24,9,15,新百王,2023-03-29,6210
00900,富邦特選高股息30,15,1,14,新百王,2023-03-29,6210
00637L,元大滬深300正2,64,50,14,新百王,2023-03-29,6210
00632R,元大台灣50反1,14,0,14,新百王,2023-03-29,6210
5222,全訊,27,14,13,新百王,2023-03-29,6210
2455,全新,51,39,12,新百王,2023-03-29,6210
6276,安鈦克,12,0,12,新百王,2023-03-29,6210
4744,皇將,17,5,12,新百王,2023-03-29,6210
2610,華航,15,4,11,新百王,2023-03-29,6210
8249,菱光,11,0,11,新百王,2023-03-29,6210
2883,凱基金,12,1,11,新百王,2023-03-29,6210
1584,精剛,24,13,11,新百王,2023-03-29,6210
6140,訊達,12,1,11,新百王,2023-03-29,6210
2603,長榮,14,3,11,新百王,2023-03-29,6210
2457,飛宏,29,19,10,新百王,2023-03-29,6210
6152,百一,10,0,10,新百王,2023-03-29,6210
00643,群益深証中小,10,0,10,新百王,2023-03-29,6210
00706L,期元大S＆P日圓正2,10,0,10,新百王,2023-03-29,6210
4147,中裕,10,0,10,新百王,2023-03-29,6210
4107,邦特,10,0,10,新百王,2023-03-29,6210
8926,台汽電,21,11,10,新百王,2023-03-29,6210
1477,聚陽,10,0,10,新百王,2023-03-29,6210
2061,風青,10,0,10,新百王,2023-03-29,6210
00679B,元大美債20年,10,0,10,新百王,2023-03-29,6210
3714,富采,11,2,9,新百王,2023-03-29,6210
6233,旺玖,9,0,9,新百王,2023-03-29,6210
8050,廣積,14,5,9,新百王,2023-03-29,6210
4114,健喬,14,5,9,新百王,2023-03-29,6210
5907,大洋-KY,265,0,265,新百王,2023-03-30,6210
1524,耿鼎,79,2,77,新百王,2023-03-30,6210
6244,茂迪,74,14,60,新百王,2023-03-30,6210
1709,和益,60,0,60,新百王,2023-03-30,6210
2887,台新金,94,48,46,新百王,2023-03-30,6210
1522,堤維西,50,5,45,新百王,2023-03-30,6210
6133,金橋,52,15,37,新百王,2023-03-30,6210
2885,元大金,40,4,36,新百王,2023-03-30,6210
00673R,期元大S＆P原油反1,38,3,35,新百王,2023-03-30,6210
6443,元晶,44,10,34,新百王,2023-03-30,6210
00720B,元大投資級公司債,33,0,33,新百王,2023-03-30,6210
00679B,元大美債20年,31,0,31,新百王,2023-03-30,6210
6276,安鈦克,30,0,30,新百王,2023-03-30,6210
6163,華電網,30,0,30,新百王,2023-03-30,6210
4916,事欣科,30,1,29,新百王,2023-03-30,6210
3236,千如,28,0,28,新百王,2023-03-30,6210
3312,弘憶股,45,18,27,新百王,2023-03-30,6210
4979,華星光,57,30,27,新百王,2023-03-30,6210
2324,仁寶,52,25,27,新百王,2023-03-30,6210
3481,群創,30,5,25,新百王,2023-03-30,6210
00665L,富邦�琤肭磪囓�2,113,89,24,新百王,2023-03-30,6210
2610,華航,28,5,23,新百王,2023-03-30,6210
00664R,國泰臺灣加權反1,20,0,20,新百王,2023-03-30,6210
1722,台肥,19,0,19,新百王,2023-03-30,6210
2886,兆豐金,18,0,18,新百王,2023-03-30,6210
6156,松上,18,0,18,新百王,2023-03-30,6210
6248,沛波,18,0,18,新百王,2023-03-30,6210
00772B,中信高評級公司債,14,0,14,新百王,2023-03-30,6210
1762,中化生,28,15,13,新百王,2023-03-30,6210
2609,陽明,14,1,13,新百王,2023-03-30,6210
00680L,元大美債20正2,12,0,12,新百王,2023-03-30,6210
7402,邑錡,29,18,11,新百王,2023-03-30,6210
2328,廣宇,10,0,10,新百王,2023-03-30,6210
2612,中航,10,0,10,新百王,2023-03-30,6210
1444,力麗,10,0,10,新百王,2023-03-30,6210
2707,晶華,10,0,10,新百王,2023-03-30,6210
6282,康舒,11,1,10,新百王,2023-03-30,6210
00877,復華中國5G,10,0,10,新百王,2023-03-30,6210
2412,中華電,13,3,10,新百王,2023-03-30,6210
2882,國泰金,10,1,9,新百王,2023-03-30,6210
6125,廣運,10,1,9,新百王,2023-03-30,6210
2329,華泰,20,11,9,新百王,2023-03-30,6210
1473,台南,9,0,9,新百王,2023-03-30,6210
1605,華新,22,14,8,新百王,2023-03-30,6210
8046,南電,13,5,8,新百王,2023-03-30,6210
00683L,期元大美元指正2,8,0,8,新百王,2023-03-30,6210
1529,樂事綠能,8,0,8,新百王,2023-03-30,6210
4950,牧東,8,0,8,新百王,2023-03-30,6210
1220,台榮,8,0,8,新百王,2023-03-30,6210
6472,保瑞,16,9,7,新百王,2023-03-30,6210
00632R,元大台灣50反1,409,65,344,新百王,2023-03-31,6210
6245,立端,308,5,303,新百王,2023-03-31,6210
3047,訊舟,60,0,60,新百王,2023-03-31,6210
5907,大洋-KY,55,0,55,新百王,2023-03-31,6210
4555,氣立,47,10,37,新百王,2023-03-31,6210
6443,元晶,47,10,37,新百王,2023-03-31,6210
1504,東元,99,63,36,新百王,2023-03-31,6210
0056,元大高股息,53,18,35,新百王,2023-03-31,6210
2485,兆赫,34,0,34,新百王,2023-03-31,6210
1314,中石化,25,0,25,新百王,2023-03-31,6210
00679B,元大美債20年,26,2,24,新百王,2023-03-31,6210
4147,中裕,31,8,23,新百王,2023-03-31,6210
2105,正新,28,6,22,新百王,2023-03-31,6210
1528,恩德,20,0,20,新百王,2023-03-31,6210
00674R,期元大S＆P黃金反1,20,0,20,新百王,2023-03-31,6210
8048,德勝,20,0,20,新百王,2023-03-31,6210
9934,成霖,18,0,18,新百王,2023-03-31,6210
00683L,期元大美元指正2,18,0,18,新百王,2023-03-31,6210
9904,寶成,18,0,18,新百王,2023-03-31,6210
8028,昇陽半導體,31,13,18,新百王,2023-03-31,6210
6167,久正,18,0,18,新百王,2023-03-31,6210
2344,華邦電,114,98,16,新百王,2023-03-31,6210
00905,FT臺灣Smart,15,0,15,新百王,2023-03-31,6210
3088,艾訊,15,0,15,新百王,2023-03-31,6210
2707,晶華,14,0,14,新百王,2023-03-31,6210
2412,中華電,17,4,13,新百王,2023-03-31,6210
2442,新美齊,37,24,13,新百王,2023-03-31,6210
6248,沛波,12,0,12,新百王,2023-03-31,6210
2430,燦坤,12,0,12,新百王,2023-03-31,6210
3715,定穎投控,120,108,12,新百王,2023-03-31,6210
3236,千如,11,0,11,新百王,2023-03-31,6210
5388,中磊,12,1,11,新百王,2023-03-31,6210
2061,風青,11,0,11,新百王,2023-03-31,6210
4906,正文,12,1,11,新百王,2023-03-31,6210
9945,潤泰新,22,12,10,新百王,2023-03-31,6210
6733,博晟生醫,10,0,10,新百王,2023-03-31,6210
4167,松瑞藥,10,0,10,新百王,2023-03-31,6210
6152,百一,10,0,10,新百王,2023-03-31,6210
6288,聯嘉,14,4,10,新百王,2023-03-31,6210
00715L,期街口布蘭特正2,15,5,10,新百王,2023-03-31,6210
9105,泰金寶-DR,10,0,10,新百王,2023-03-31,6210
6290,良維,10,1,9,新百王,2023-03-31,6210
2356,英業達,10,1,9,新百王,2023-03-31,6210
6125,廣運,10,1,9,新百王,2023-03-31,6210
4973,廣穎,9,0,9,新百王,2023-03-31,6210
00673R,期元大S＆P原油反1,9,0,9,新百王,2023-03-31,6210
8050,廣積,49,40,9,新百王,2023-03-31,6210
5608,四維航,10,1,9,新百王,2023-03-31,6210
3711,日月光投控,46,37,9,新百王,2023-03-31,6210
9958,世紀鋼,10,2,8,新百王,2023-03-31,6210
00673R,期元大S＆P原油反1,168,0,168,新百王,2023-04-06,6210
00665L,富邦�琤肭磪囓�2,458,291,167,新百王,2023-04-06,6210
3189,景碩,86,0,86,新百王,2023-04-06,6210
00905,FT臺灣Smart,70,0,70,新百王,2023-04-06,6210
6185,幃翔,65,2,63,新百王,2023-04-06,6210
2618,長榮航,52,0,52,新百王,2023-04-06,6210
1618,合機,50,1,49,新百王,2023-04-06,6210
4541,晟田,45,0,45,新百王,2023-04-06,6210
00637L,元大滬深300正2,101,56,45,新百王,2023-04-06,6210
0050,元大台灣50,50,5,45,新百王,2023-04-06,6210
00888,永豐台灣ESG,40,0,40,新百王,2023-04-06,6210
2436,偉詮電,53,14,39,新百王,2023-04-06,6210
4931,新盛力,39,2,37,新百王,2023-04-06,6210
8110,華東,37,0,37,新百王,2023-04-06,6210
4550,長佳,41,5,36,新百王,2023-04-06,6210
00680L,元大美債20正2,38,3,35,新百王,2023-04-06,6210
2317,鴻海,48,14,34,新百王,2023-04-06,6210
8069,元太,65,36,29,新百王,2023-04-06,6210
2344,華邦電,113,85,28,新百王,2023-04-06,6210
5483,中美晶,39,13,26,新百王,2023-04-06,6210
00893,國泰智能電動車,27,1,26,新百王,2023-04-06,6210
2368,金像電,27,1,26,新百王,2023-04-06,6210
6163,華電網,35,9,26,新百王,2023-04-06,6210
9945,潤泰新,29,3,26,新百王,2023-04-06,6210
2748,雲品,25,3,22,新百王,2023-04-06,6210
6244,茂迪,22,0,22,新百王,2023-04-06,6210
2352,佳世達,42,20,22,新百王,2023-04-06,6210
4111,濟生,19,0,19,新百王,2023-04-06,6210
4967,十銓,35,19,16,新百王,2023-04-06,6210
2014,中鴻,15,0,15,新百王,2023-04-06,6210
3380,明泰,15,0,15,新百王,2023-04-06,6210
2104,國際中橡,15,0,15,新百王,2023-04-06,6210
9904,寶成,14,0,14,新百王,2023-04-06,6210
5009,榮剛,22,8,14,新百王,2023-04-06,6210
6770,力積電,13,0,13,新百王,2023-04-06,6210
6182,合晶,13,0,13,新百王,2023-04-06,6210
3481,群創,67,54,13,新百王,2023-04-06,6210
1609,大亞,33,20,13,新百王,2023-04-06,6210
6285,啟��,12,0,12,新百王,2023-04-06,6210
2886,兆豐金,13,1,12,新百王,2023-04-06,6210
2061,風青,12,0,12,新百王,2023-04-06,6210
6167,久正,12,0,12,新百王,2023-04-06,6210
2732,六角,12,0,12,新百王,2023-04-06,6210
2603,長榮,14,3,11,新百王,2023-04-06,6210
8050,廣積,13,2,11,新百王,2023-04-06,6210
6470,宇智,11,0,11,新百王,2023-04-06,6210
00878,國泰永續高股息,14,3,11,新百王,2023-04-06,6210
00882,中信中國高股息,10,0,10,新百王,2023-04-06,6210
5876,上海商銀,10,0,10,新百王,2023-04-06,6210
00919,群益台灣精選高息,10,0,10,新百王,2023-04-06,6210
3035,智原,140,24,116,新百王,2023-04-07,6210
00673R,期元大S＆P原油反1,32,0,32,新百王,2023-04-07,6210
9934,成霖,30,0,30,新百王,2023-04-07,6210
6142,友勁,30,0,30,新百王,2023-04-07,6210
00665L,富邦�琤肭磪囓�2,50,22,28,新百王,2023-04-07,6210
2356,英業達,41,16,25,新百王,2023-04-07,6210
2882,國泰金,22,0,22,新百王,2023-04-07,6210
2601,益航,25,5,20,新百王,2023-04-07,6210
00773B,中信優先金融債,20,0,20,新百王,2023-04-07,6210
2888,新光金,30,10,20,新百王,2023-04-07,6210
5309,系統電,56,36,20,新百王,2023-04-07,6210
0050,元大台灣50,18,1,17,新百王,2023-04-07,6210
2495,普安,17,0,17,新百王,2023-04-07,6210
00905,FT臺灣Smart,31,15,16,新百王,2023-04-07,6210
00772B,中信高評級公司債,16,0,16,新百王,2023-04-07,6210
2883,凱基金,42,27,15,新百王,2023-04-07,6210
2748,雲品,18,4,14,新百王,2023-04-07,6210
1529,樂事綠能,22,8,14,新百王,2023-04-07,6210
6111,大宇資,14,0,14,新百王,2023-04-07,6210
2409,友達,13,0,13,新百王,2023-04-07,6210
4916,事欣科,16,3,13,新百王,2023-04-07,6210
1504,東元,30,17,13,新百王,2023-04-07,6210
6461,益得,28,15,13,新百王,2023-04-07,6210
8028,昇陽半導體,29,16,13,新百王,2023-04-07,6210
8070,長華*,12,0,12,新百王,2023-04-07,6210
8069,元太,350,338,12,新百王,2023-04-07,6210
2208,台船,21,9,12,新百王,2023-04-07,6210
6235,華孚,61,50,11,新百王,2023-04-07,6210
00830,國泰費城半導體,11,0,11,新百王,2023-04-07,6210
1760,寶齡富錦,29,18,11,新百王,2023-04-07,6210
1817,凱撒衛,10,0,10,新百王,2023-04-07,6210
2489,瑞軒,10,0,10,新百王,2023-04-07,6210
00900,富邦特選高股息30,10,0,10,新百王,2023-04-07,6210
3032,偉訓,21,11,10,新百王,2023-04-07,6210
2376,技嘉,12,2,10,新百王,2023-04-07,6210
1709,和益,10,0,10,新百王,2023-04-07,6210
6548,長科*,11,1,10,新百王,2023-04-07,6210
2006,東和鋼鐵,10,0,10,新百王,2023-04-07,6210
8933,愛地雅,10,0,10,新百王,2023-04-07,6210
5230,雷笛克光學,10,0,10,新百王,2023-04-07,6210
4129,聯合,11,1,10,新百王,2023-04-07,6210
6101,寬魚國際,9,0,9,新百王,2023-04-07,6210
3025,星通,76,67,9,新百王,2023-04-07,6210
2302,麗正,9,0,9,新百王,2023-04-07,6210
6122,擎邦,15,6,9,新百王,2023-04-07,6210
2890,永豐金,9,0,9,新百王,2023-04-07,6210
2371,大同,15,6,9,新百王,2023-04-07,6210
2498,宏達電,70,61,9,新百王,2023-04-07,6210
3231,緯創,9,1,8,新百王,2023-04-07,6210
3537,堡達,8,0,8,新百王,2023-04-07,6210
00680L,元大美債20正2,247,0,247,新百王,2023-04-10,6210
6148,驊宏資,99,0,99,新百王,2023-04-10,6210
3264,欣銓,100,8,92,新百王,2023-04-10,6210
00673R,期元大S＆P原油反1,66,0,66,新百王,2023-04-10,6210
3035,智原,69,4,65,新百王,2023-04-10,6210
2442,新美齊,76,11,65,新百王,2023-04-10,6210
1108,幸福,66,13,53,新百王,2023-04-10,6210
3046,建��,70,29,41,新百王,2023-04-10,6210
00725B,國泰投資級公司債,40,0,40,新百王,2023-04-10,6210
1605,華新,40,1,39,新百王,2023-04-10,6210
5902,德記,30,0,30,新百王,2023-04-10,6210
1785,光洋科,27,0,27,新百王,2023-04-10,6210
1731,美吾華,25,0,25,新百王,2023-04-10,6210
2344,華邦電,193,169,24,新百王,2023-04-10,6210
2883,凱基金,26,4,22,新百王,2023-04-10,6210
2641,正德,21,0,21,新百王,2023-04-10,6210
00720B,元大投資級公司債,20,0,20,新百王,2023-04-10,6210
00724B,群益投資級金融債,20,0,20,新百王,2023-04-10,6210
00674R,期元大S＆P黃金反1,20,0,20,新百王,2023-04-10,6210
3673,TPK-KY,20,0,20,新百王,2023-04-10,6210
00751B,元大AAA至A公司債,20,0,20,新百王,2023-04-10,6210
6122,擎邦,44,24,20,新百王,2023-04-10,6210
1584,精剛,26,8,18,新百王,2023-04-10,6210
5521,工信,15,0,15,新百王,2023-04-10,6210
9105,泰金寶-DR,15,0,15,新百王,2023-04-10,6210
2312,金寶,15,0,15,新百王,2023-04-10,6210
1319,東陽,19,5,14,新百王,2023-04-10,6210
2243,宏旭-KY,15,1,14,新百王,2023-04-10,6210
2852,第一保,13,0,13,新百王,2023-04-10,6210
2615,萬海,28,16,12,新百王,2023-04-10,6210
5328,華容,12,0,12,新百王,2023-04-10,6210
2002,中鋼,12,0,12,新百王,2023-04-10,6210
6547,高端疫苗,12,0,12,新百王,2023-04-10,6210
2497,怡利電,16,4,12,新百王,2023-04-10,6210
00773B,中信優先金融債,13,2,11,新百王,2023-04-10,6210
6288,聯嘉,44,33,11,新百王,2023-04-10,6210
2634,漢翔,46,35,11,新百王,2023-04-10,6210
1101,台泥,11,0,11,新百王,2023-04-10,6210
5871,中租-KY,11,1,10,新百王,2023-04-10,6210
00679B,元大美債20年,10,0,10,新百王,2023-04-10,6210
00712,復華富時不動產,10,0,10,新百王,2023-04-10,6210
8936,國統,11,1,10,新百王,2023-04-10,6210
2408,南亞科,14,4,10,新百王,2023-04-10,6210
6140,訊達,12,2,10,新百王,2023-04-10,6210
4207,環泰,19,9,10,新百王,2023-04-10,6210
9907,統一實,9,0,9,新百王,2023-04-10,6210
3289,宜特,9,0,9,新百王,2023-04-10,6210
3447,展達,9,0,9,新百王,2023-04-10,6210
1796,金穎生技,15,6,9,新百王,2023-04-10,6210
3520,華盈,49,40,9,新百王,2023-04-10,6210
00632R,元大台灣50反1,485,200,285,新百王,2023-04-11,6210
00665L,富邦�琤肭磪囓�2,567,303,264,新百王,2023-04-11,6210
00720B,元大投資級公司債,90,0,90,新百王,2023-04-11,6210
6116,彩晶,118,62,56,新百王,2023-04-11,6210
6245,立端,55,3,52,新百王,2023-04-11,6210
3264,欣銓,50,0,50,新百王,2023-04-11,6210
00679B,元大美債20年,43,0,43,新百王,2023-04-11,6210
9907,統一實,51,8,43,新百王,2023-04-11,6210
6770,力積電,48,6,42,新百王,2023-04-11,6210
2352,佳世達,41,0,41,新百王,2023-04-11,6210
5309,系統電,43,2,41,新百王,2023-04-11,6210
2449,京元電子,41,0,41,新百王,2023-04-11,6210
4532,瑞智,40,0,40,新百王,2023-04-11,6210
2601,益航,37,0,37,新百王,2023-04-11,6210
2883,凱基金,40,3,37,新百王,2023-04-11,6210
00885,富邦越南,33,0,33,新百王,2023-04-11,6210
5315,光聯,31,0,31,新百王,2023-04-11,6210
6418,詠昇,30,0,30,新百王,2023-04-11,6210
1444,力麗,40,10,30,新百王,2023-04-11,6210
8905,裕國,30,0,30,新百王,2023-04-11,6210
6548,長科*,42,12,30,新百王,2023-04-11,6210
7402,邑錡,28,0,28,新百王,2023-04-11,6210
00772B,中信高評級公司債,27,0,27,新百王,2023-04-11,6210
5353,台林,37,10,27,新百王,2023-04-11,6210
6248,沛波,33,7,26,新百王,2023-04-11,6210
3481,群創,42,16,26,新百王,2023-04-11,6210
3715,定穎投控,146,123,23,新百王,2023-04-11,6210
1504,東元,98,76,22,新百王,2023-04-11,6210
0050,元大台灣50,21,0,21,新百王,2023-04-11,6210
2607,榮運,21,0,21,新百王,2023-04-11,6210
6288,聯嘉,26,6,20,新百王,2023-04-11,6210
2444,兆勁,20,0,20,新百王,2023-04-11,6210
4142,國光生,20,0,20,新百王,2023-04-11,6210
5608,四維航,20,0,20,新百王,2023-04-11,6210
00680L,元大美債20正2,19,0,19,新百王,2023-04-11,6210
3520,華盈,24,5,19,新百王,2023-04-11,6210
2409,友達,20,2,18,新百王,2023-04-11,6210
3516,亞帝歐,18,0,18,新百王,2023-04-11,6210
2634,漢翔,34,16,18,新百王,2023-04-11,6210
4744,皇將,17,0,17,新百王,2023-04-11,6210
1731,美吾華,17,0,17,新百王,2023-04-11,6210
2208,台船,16,0,16,新百王,2023-04-11,6210
00751B,元大AAA至A公司債,15,0,15,新百王,2023-04-11,6210
8050,廣積,22,9,13,新百王,2023-04-11,6210
3047,訊舟,13,0,13,新百王,2023-04-11,6210
3093,港建*,20,7,13,新百王,2023-04-11,6210
00670L,富邦NASDAQ正2,13,1,12,新百王,2023-04-11,6210
00773B,中信優先金融債,12,0,12,新百王,2023-04-11,6210
6209,今國光,26,14,12,新百王,2023-04-11,6210
3128,昇銳,21,10,11,新百王,2023-04-11,6210
00665L,富邦�琤肭磪囓�2,61,0,61,新百王,2023-04-12,6210
00680L,元大美債20正2,57,0,57,新百王,2023-04-12,6210
1504,東元,88,40,48,新百王,2023-04-12,6210
2614,東森,45,0,45,新百王,2023-04-12,6210
3481,群創,83,39,44,新百王,2023-04-12,6210
2442,新美齊,40,0,40,新百王,2023-04-12,6210
6240,松崗,50,10,40,新百王,2023-04-12,6210
00882,中信中國高股息,39,0,39,新百王,2023-04-12,6210
2413,環科,58,20,38,新百王,2023-04-12,6210
00673R,期元大S＆P原油反1,38,0,38,新百王,2023-04-12,6210
00720B,元大投資級公司債,35,0,35,新百王,2023-04-12,6210
2883,凱基金,40,7,33,新百王,2023-04-12,6210
8088,品安,56,24,32,新百王,2023-04-12,6210
4207,環泰,31,0,31,新百王,2023-04-12,6210
2845,遠東銀,30,0,30,新百王,2023-04-12,6210
00751B,元大AAA至A公司債,30,0,30,新百王,2023-04-12,6210
6218,豪勉,41,11,30,新百王,2023-04-12,6210
2618,長榮航,27,1,26,新百王,2023-04-12,6210
2498,宏達電,40,14,26,新百王,2023-04-12,6210
5388,中磊,26,0,26,新百王,2023-04-12,6210
4927,泰鼎-KY,25,0,25,新百王,2023-04-12,6210
4529,淳紳,24,0,24,新百王,2023-04-12,6210
2317,鴻海,34,11,23,新百王,2023-04-12,6210
5425,台半,44,21,23,新百王,2023-04-12,6210
2313,華通,23,0,23,新百王,2023-04-12,6210
6578,達邦蛋白,23,0,23,新百王,2023-04-12,6210
2312,金寶,25,4,21,新百王,2023-04-12,6210
1731,美吾華,20,0,20,新百王,2023-04-12,6210
00674R,期元大S＆P黃金反1,20,0,20,新百王,2023-04-12,6210
2402,毅嘉,23,6,17,新百王,2023-04-12,6210
2367,燿華,20,3,17,新百王,2023-04-12,6210
00637L,元大滬深300正2,136,119,17,新百王,2023-04-12,6210
00712,復華富時不動產,20,4,16,新百王,2023-04-12,6210
6122,擎邦,49,33,16,新百王,2023-04-12,6210
00772B,中信高評級公司債,15,0,15,新百王,2023-04-12,6210
2342,茂矽,17,2,15,新百王,2023-04-12,6210
00683L,期元大美元指正2,15,0,15,新百王,2023-04-12,6210
8046,南電,18,3,15,新百王,2023-04-12,6210
2363,矽統,15,0,15,新百王,2023-04-12,6210
5258,虹堡,22,8,14,新百王,2023-04-12,6210
6188,廣明,19,5,14,新百王,2023-04-12,6210
2349,錸德,13,0,13,新百王,2023-04-12,6210
00830,國泰費城半導體,15,2,13,新百王,2023-04-12,6210
6285,啟��,13,0,13,新百王,2023-04-12,6210
6274,台燿,35,23,12,新百王,2023-04-12,6210
6148,驊宏資,13,1,12,新百王,2023-04-12,6210
4550,長佳,12,0,12,新百王,2023-04-12,6210
3162,精確,16,5,11,新百王,2023-04-12,6210
2330,台積電,12,1,11,新百王,2023-04-12,6210
3005,神基,11,0,11,新百王,2023-04-12,6210
00632R,元大台灣50反1,1281,213,1068,新百王,2023-04-13,6210
3231,緯創,253,10,243,新百王,2023-04-13,6210
2515,中工,153,79,74,新百王,2023-04-13,6210
2867,三商壽,130,56,74,新百王,2023-04-13,6210
00673R,期元大S＆P原油反1,72,12,60,新百王,2023-04-13,6210
00664R,國泰臺灣加權反1,55,0,55,新百王,2023-04-13,6210
1528,恩德,55,0,55,新百王,2023-04-13,6210
00648R,元大S＆P500反1,50,0,50,新百王,2023-04-13,6210
00669R,國泰美國道瓊反1,50,0,50,新百王,2023-04-13,6210
3037,欣興,67,18,49,新百王,2023-04-13,6210
5009,榮剛,114,66,48,新百王,2023-04-13,6210
2358,廷鑫,52,4,48,新百王,2023-04-13,6210
3715,定穎投控,146,104,42,新百王,2023-04-13,6210
2330,台積電,43,4,39,新百王,2023-04-13,6210
6116,彩晶,60,30,30,新百王,2023-04-13,6210
3591,艾笛森,31,2,29,新百王,2023-04-13,6210
4147,中裕,87,60,27,新百王,2023-04-13,6210
3032,偉訓,26,0,26,新百王,2023-04-13,6210
3703,欣陸,40,15,25,新百王,2023-04-13,6210
1314,中石化,71,47,24,新百王,2023-04-13,6210
2603,長榮,52,29,23,新百王,2023-04-13,6210
2883,凱基金,29,7,22,新百王,2023-04-13,6210
4164,承業醫,35,13,22,新百王,2023-04-13,6210
4207,環泰,24,2,22,新百王,2023-04-13,6210
2610,華航,48,28,20,新百王,2023-04-13,6210
4804,大略-KY,20,0,20,新百王,2023-04-13,6210
2634,漢翔,68,48,20,新百王,2023-04-13,6210
2344,華邦電,29,9,20,新百王,2023-04-13,6210
2359,所羅門,24,4,20,新百王,2023-04-13,6210
2363,矽統,20,0,20,新百王,2023-04-13,6210
4939,亞電,20,0,20,新百王,2023-04-13,6210
3048,益登,20,0,20,新百王,2023-04-13,6210
6485,點序,31,12,19,新百王,2023-04-13,6210
6591,動力-KY,20,1,19,新百王,2023-04-13,6210
0050,元大台灣50,31,12,19,新百王,2023-04-13,6210
8046,南電,20,2,18,新百王,2023-04-13,6210
6133,金橋,18,0,18,新百王,2023-04-13,6210
1605,華新,27,9,18,新百王,2023-04-13,6210
2852,第一保,18,0,18,新百王,2023-04-13,6210
1513,中興電,75,57,18,新百王,2023-04-13,6210
00720B,元大投資級公司債,17,0,17,新百王,2023-04-13,6210
00877,復華中國5G,16,0,16,新百王,2023-04-13,6210
1810,和成,23,8,15,新百王,2023-04-13,6210
3264,欣銓,15,0,15,新百王,2023-04-13,6210
1321,大洋,15,0,15,新百王,2023-04-13,6210
2201,裕隆,127,112,15,新百王,2023-04-13,6210
9904,寶成,15,1,14,新百王,2023-04-13,6210
6285,啟��,17,3,14,新百王,2023-04-13,6210
1618,合機,15,1,14,新百王,2023-04-13,6210
8926,台汽電,17,4,13,新百王,2023-04-13,6210
00712,復華富時不動產,217,0,217,新百王,2023-04-14,6210
6168,宏齊,109,0,109,新百王,2023-04-14,6210
00687B,國泰20年美債,97,0,97,新百王,2023-04-14,6210
00900,富邦特選高股息30,80,0,80,新百王,2023-04-14,6210
2897,王道銀行,75,0,75,新百王,2023-04-14,6210
2634,漢翔,275,202,73,新百王,2023-04-14,6210
00725B,國泰投資級公司債,70,0,70,新百王,2023-04-14,6210
00679B,元大美債20年,69,0,69,新百王,2023-04-14,6210
00919,群益台灣精選高息,68,0,68,新百王,2023-04-14,6210
8936,國統,92,33,59,新百王,2023-04-14,6210
3058,立德,58,0,58,新百王,2023-04-14,6210
2367,燿華,56,0,56,新百王,2023-04-14,6210
2208,台船,214,172,42,新百王,2023-04-14,6210
6285,啟��,44,7,37,新百王,2023-04-14,6210
00637L,元大滬深300正2,156,124,32,新百王,2023-04-14,6210
8101,華冠,30,0,30,新百王,2023-04-14,6210
2358,廷鑫,35,5,30,新百王,2023-04-14,6210
6446,藥華藥,28,0,28,新百王,2023-04-14,6210
4555,氣立,44,17,27,新百王,2023-04-14,6210
2312,金寶,26,0,26,新百王,2023-04-14,6210
1504,東元,52,29,23,新百王,2023-04-14,6210
1731,美吾華,20,0,20,新百王,2023-04-14,6210
2107,厚生,20,0,20,新百王,2023-04-14,6210
2706,第一店,20,0,20,新百王,2023-04-14,6210
00674R,期元大S＆P黃金反1,20,0,20,新百王,2023-04-14,6210
1210,大成,20,0,20,新百王,2023-04-14,6210
1217,愛之味,20,0,20,新百王,2023-04-14,6210
6244,茂迪,73,53,20,新百王,2023-04-14,6210
4541,晟田,42,23,19,新百王,2023-04-14,6210
00680L,元大美債20正2,19,0,19,新百王,2023-04-14,6210
00877,復華中國5G,18,0,18,新百王,2023-04-14,6210
4916,事欣科,26,8,18,新百王,2023-04-14,6210
00751B,元大AAA至A公司債,17,0,17,新百王,2023-04-14,6210
3702,大聯大,17,0,17,新百王,2023-04-14,6210
3338,泰碩,17,0,17,新百王,2023-04-14,6210
6005,群益證,17,1,16,新百王,2023-04-14,6210
2457,飛宏,85,69,16,新百王,2023-04-14,6210
8926,台汽電,18,2,16,新百王,2023-04-14,6210
00772B,中信高評級公司債,16,0,16,新百王,2023-04-14,6210
2867,三商壽,20,5,15,新百王,2023-04-14,6210
00683L,期元大美元指正2,15,0,15,新百王,2023-04-14,6210
1444,力麗,15,0,15,新百王,2023-04-14,6210
00673R,期元大S＆P原油反1,15,0,15,新百王,2023-04-14,6210
6197,佳必琪,16,1,15,新百王,2023-04-14,6210
6548,長科*,15,0,15,新百王,2023-04-14,6210
4956,光鋐,14,0,14,新百王,2023-04-14,6210
3481,群創,75,62,13,新百王,2023-04-14,6210
8222,寶一,108,95,13,新百王,2023-04-14,6210
1618,合機,15,3,12,新百王,2023-04-14,6210
6248,沛波,33,21,12,新百王,2023-04-14,6210
3481,群創,222,71,151,新百王,2023-04-17,6210
6185,幃翔,210,63,147,新百王,2023-04-17,6210
00751B,元大AAA至A公司債,100,0,100,新百王,2023-04-17,6210
3029,零壹,149,52,97,新百王,2023-04-17,6210
00772B,中信高評級公司債,71,0,71,新百王,2023-04-17,6210
1101,台泥,70,3,67,新百王,2023-04-17,6210
2601,益航,100,41,59,新百王,2023-04-17,6210
1312,國喬,50,0,50,新百王,2023-04-17,6210
00712,復華富時不動產,51,3,48,新百王,2023-04-17,6210
00680L,元大美債20正2,47,0,47,新百王,2023-04-17,6210
4114,健喬,54,8,46,新百王,2023-04-17,6210
00679B,元大美債20年,45,0,45,新百王,2023-04-17,6210
1618,合機,47,4,43,新百王,2023-04-17,6210
00687B,國泰20年美債,40,0,40,新百王,2023-04-17,6210
6125,廣運,40,1,39,新百王,2023-04-17,6210
2515,中工,77,39,38,新百王,2023-04-17,6210
3356,奇偶,36,0,36,新百王,2023-04-17,6210
2885,元大金,40,5,35,新百王,2023-04-17,6210
1314,中石化,66,32,34,新百王,2023-04-17,6210
6443,元晶,54,23,31,新百王,2023-04-17,6210
3013,晟銘電,35,5,30,新百王,2023-04-17,6210
2314,台揚,31,1,30,新百王,2023-04-17,6210
2344,華邦電,30,0,30,新百王,2023-04-17,6210
4106,雃博,27,0,27,新百王,2023-04-17,6210
1589,永冠-KY,32,5,27,新百王,2023-04-17,6210
6235,華孚,214,188,26,新百王,2023-04-17,6210
00857B,永豐20年美公債,26,0,26,新百王,2023-04-17,6210
8996,高力,30,5,25,新百王,2023-04-17,6210
4939,亞電,36,12,24,新百王,2023-04-17,6210
2002,中鋼,40,19,21,新百王,2023-04-17,6210
2312,金寶,46,25,21,新百王,2023-04-17,6210
00665L,富邦�琤肭磪囓�2,269,248,21,新百王,2023-04-17,6210
3703,欣陸,50,30,20,新百王,2023-04-17,6210
1440,南紡,20,0,20,新百王,2023-04-17,6210
3363,上詮,20,1,19,新百王,2023-04-17,6210
4533,協易機,19,0,19,新百王,2023-04-17,6210
4513,福裕,19,0,19,新百王,2023-04-17,6210
6244,茂迪,27,8,19,新百王,2023-04-17,6210
2352,佳世達,18,0,18,新百王,2023-04-17,6210
2610,華航,39,22,17,新百王,2023-04-17,6210
1810,和成,19,2,17,新百王,2023-04-17,6210
2353,宏��,17,0,17,新百王,2023-04-17,6210
6248,沛波,31,16,15,新百王,2023-04-17,6210
00878,國泰永續高股息,15,0,15,新百王,2023-04-17,6210
6285,啟��,21,7,14,新百王,2023-04-17,6210
0050,元大台灣50,18,4,14,新百王,2023-04-17,6210
2323,中環,14,0,14,新百王,2023-04-17,6210
6284,佳邦,27,14,13,新百王,2023-04-17,6210
2413,環科,15,2,13,新百王,2023-04-17,6210
3047,訊舟,13,0,13,新百王,2023-04-17,6210
3013,晟銘電,109,10,99,新百王,2023-04-18,6210
6425,易發,96,0,96,新百王,2023-04-18,6210
00665L,富邦�琤肭磪囓�2,271,210,61,新百王,2023-04-18,6210
00751B,元大AAA至A公司債,59,0,59,新百王,2023-04-18,6210
1514,亞力,65,6,59,新百王,2023-04-18,6210
00720B,元大投資級公司債,53,0,53,新百王,2023-04-18,6210
1809,中釉,283,237,46,新百王,2023-04-18,6210
00680L,元大美債20正2,46,1,45,新百王,2023-04-18,6210
1718,中纖,42,0,42,新百王,2023-04-18,6210
00679B,元大美債20年,41,0,41,新百王,2023-04-18,6210
2367,燿華,40,0,40,新百王,2023-04-18,6210
00687B,國泰20年美債,38,0,38,新百王,2023-04-18,6210
6477,安集,61,25,36,新百王,2023-04-18,6210
1605,華新,38,7,31,新百王,2023-04-18,6210
6191,精成科,30,0,30,新百王,2023-04-18,6210
6741,91APP*-KY,44,14,30,新百王,2023-04-18,6210
1529,樂事綠能,71,41,30,新百王,2023-04-18,6210
4142,國光生,30,0,30,新百王,2023-04-18,6210
1301,台塑,30,0,30,新百王,2023-04-18,6210
3712,永崴投控,36,8,28,新百王,2023-04-18,6210
2634,漢翔,177,153,24,新百王,2023-04-18,6210
5009,榮剛,35,11,24,新百王,2023-04-18,6210
2884,玉山金,30,7,23,新百王,2023-04-18,6210
3481,群創,27,5,22,新百王,2023-04-18,6210
2330,台積電,21,0,21,新百王,2023-04-18,6210
5011,久陽,20,0,20,新百王,2023-04-18,6210
2305,全友,20,0,20,新百王,2023-04-18,6210
2867,三商壽,20,0,20,新百王,2023-04-18,6210
1817,凱撒衛,20,0,20,新百王,2023-04-18,6210
3419,譁裕,19,0,19,新百王,2023-04-18,6210
00877,復華中國5G,18,0,18,新百王,2023-04-18,6210
0050,元大台灣50,27,10,17,新百王,2023-04-18,6210
6470,宇智,19,2,17,新百王,2023-04-18,6210
1785,光洋科,20,3,17,新百王,2023-04-18,6210
3466,德晉,20,3,17,新百王,2023-04-18,6210
2344,華邦電,20,3,17,新百王,2023-04-18,6210
00712,復華富時不動產,22,6,16,新百王,2023-04-18,6210
00772B,中信高評級公司債,15,0,15,新百王,2023-04-18,6210
4533,協易機,15,0,15,新百王,2023-04-18,6210
6284,佳邦,21,6,15,新百王,2023-04-18,6210
8033,雷虎,255,240,15,新百王,2023-04-18,6210
6133,金橋,14,0,14,新百王,2023-04-18,6210
3005,神基,19,6,13,新百王,2023-04-18,6210
3624,光頡,33,20,13,新百王,2023-04-18,6210
6547,高端疫苗,23,11,12,新百王,2023-04-18,6210
8088,品安,12,0,12,新百王,2023-04-18,6210
3217,優群,28,16,12,新百王,2023-04-18,6210
2208,台船,67,55,12,新百王,2023-04-18,6210
2453,凌群,54,43,11,新百王,2023-04-18,6210
2883,凱基金,16,5,11,新百王,2023-04-18,6210
1718,中纖,100,0,100,新百王,2023-04-19,6210
3312,弘憶股,94,0,94,新百王,2023-04-19,6210
00888,永豐台灣ESG,73,0,73,新百王,2023-04-19,6210
2867,三商壽,110,40,70,新百王,2023-04-19,6210
8105,凌巨,54,0,54,新百王,2023-04-19,6210
4123,晟德,70,18,52,新百王,2023-04-19,6210
00665L,富邦�琤肭磪囓�2,264,223,41,新百王,2023-04-19,6210
3037,欣興,76,35,41,新百王,2023-04-19,6210
6282,康舒,79,40,39,新百王,2023-04-19,6210
2449,京元電子,37,0,37,新百王,2023-04-19,6210
2367,燿華,43,6,37,新百王,2023-04-19,6210
2313,華通,35,1,34,新百王,2023-04-19,6210
2609,陽明,45,11,34,新百王,2023-04-19,6210
5608,四維航,28,0,28,新百王,2023-04-19,6210
5483,中美晶,25,0,25,新百王,2023-04-19,6210
2342,茂矽,64,39,25,新百王,2023-04-19,6210
00753L,中信中國50正2,27,3,24,新百王,2023-04-19,6210
5704,老爺知,25,1,24,新百王,2023-04-19,6210
0050,元大台灣50,36,12,24,新百王,2023-04-19,6210
6116,彩晶,21,0,21,新百王,2023-04-19,6210
9962,有益,20,0,20,新百王,2023-04-19,6210
3466,德晉,28,8,20,新百王,2023-04-19,6210
2607,榮運,20,0,20,新百王,2023-04-19,6210
6865,偉康科技,24,4,20,新百王,2023-04-19,6210
2453,凌群,31,12,19,新百王,2023-04-19,6210
3704,合勤控,192,173,19,新百王,2023-04-19,6210
8034,榮群,19,0,19,新百王,2023-04-19,6210
2883,凱基金,19,0,19,新百王,2023-04-19,6210
2303,聯電,19,1,18,新百王,2023-04-19,6210
2002,中鋼,38,21,17,新百王,2023-04-19,6210
4109,加捷生醫,17,0,17,新百王,2023-04-19,6210
2330,台積電,33,16,17,新百王,2023-04-19,6210
2409,友達,67,51,16,新百王,2023-04-19,6210
6163,華電網,22,7,15,新百王,2023-04-19,6210
4114,健喬,17,2,15,新百王,2023-04-19,6210
00679B,元大美債20年,15,0,15,新百王,2023-04-19,6210
2504,國產,40,25,15,新百王,2023-04-19,6210
00712,復華富時不動產,15,0,15,新百王,2023-04-19,6210
5210,寶碩,15,0,15,新百王,2023-04-19,6210
3231,緯創,33,18,15,新百王,2023-04-19,6210
2402,毅嘉,27,13,14,新百王,2023-04-19,6210
00637L,元大滬深300正2,44,30,14,新百王,2023-04-19,6210
2845,遠東銀,14,0,14,新百王,2023-04-19,6210
1720,生達,22,8,14,新百王,2023-04-19,6210
2884,玉山金,13,0,13,新百王,2023-04-19,6210
4510,高鋒,23,10,13,新百王,2023-04-19,6210
2498,宏達電,13,0,13,新百王,2023-04-19,6210
2850,新產,20,7,13,新百王,2023-04-19,6210
2601,益航,25,13,12,新百王,2023-04-19,6210
8050,廣積,12,0,12,新百王,2023-04-19,6210
00665L,富邦�琤肭磪囓�2,294,117,177,新百王,2023-04-20,6210
2618,長榮航,110,1,109,新百王,2023-04-20,6210
00679B,元大美債20年,107,2,105,新百王,2023-04-20,6210
1709,和益,77,0,77,新百王,2023-04-20,6210
4716,大立,73,0,73,新百王,2023-04-20,6210
8105,凌巨,61,0,61,新百王,2023-04-20,6210
3312,弘憶股,56,0,56,新百王,2023-04-20,6210
3032,偉訓,62,7,55,新百王,2023-04-20,6210
00720B,元大投資級公司債,54,0,54,新百王,2023-04-20,6210
4747,強生,59,6,53,新百王,2023-04-20,6210
1718,中纖,51,0,51,新百王,2023-04-20,6210
00712,復華富時不動產,70,23,47,新百王,2023-04-20,6210
00637L,元大滬深300正2,109,67,42,新百王,2023-04-20,6210
4555,氣立,81,40,41,新百王,2023-04-20,6210
1104,環泥,36,0,36,新百王,2023-04-20,6210
8033,雷虎,75,41,34,新百王,2023-04-20,6210
6547,高端疫苗,70,37,33,新百王,2023-04-20,6210
3006,晶豪科,32,0,32,新百王,2023-04-20,6210
2371,大同,37,6,31,新百王,2023-04-20,6210
3078,僑威,59,28,31,新百王,2023-04-20,6210
3236,千如,30,0,30,新百王,2023-04-20,6210
2888,新光金,50,20,30,新百王,2023-04-20,6210
00655L,國泰中國A50正2,30,0,30,新百王,2023-04-20,6210
1907,永豐餘,39,10,29,新百王,2023-04-20,6210
3038,全台,28,2,26,新百王,2023-04-20,6210
1504,東元,49,23,26,新百王,2023-04-20,6210
2303,聯電,27,3,24,新百王,2023-04-20,6210
6443,元晶,56,32,24,新百王,2023-04-20,6210
6477,安集,42,19,23,新百王,2023-04-20,6210
4167,松瑞藥,28,5,23,新百王,2023-04-20,6210
6625,必應,22,0,22,新百王,2023-04-20,6210
8088,品安,30,9,21,新百王,2023-04-20,6210
00751B,元大AAA至A公司債,21,0,21,新百王,2023-04-20,6210
1471,首利,32,11,21,新百王,2023-04-20,6210
3576,聯合再生,22,1,21,新百王,2023-04-20,6210
00878,國泰永續高股息,21,0,21,新百王,2023-04-20,6210
2832,台產,20,0,20,新百王,2023-04-20,6210
00753L,中信中國50正2,23,3,20,新百王,2023-04-20,6210
3093,港建*,20,0,20,新百王,2023-04-20,6210
2515,中工,50,31,19,新百王,2023-04-20,6210
2615,萬海,33,14,19,新百王,2023-04-20,6210
00680L,元大美債20正2,18,0,18,新百王,2023-04-20,6210
2405,輔信,18,0,18,新百王,2023-04-20,6210
8222,寶一,42,25,17,新百王,2023-04-20,6210
2330,台積電,22,6,16,新百王,2023-04-20,6210
2884,玉山金,15,0,15,新百王,2023-04-20,6210
4979,華星光,61,46,15,新百王,2023-04-20,6210
2436,偉詮電,15,0,15,新百王,2023-04-20,6210
2104,國際中橡,15,0,15,新百王,2023-04-20,6210
3712,永崴投控,14,0,14,新百王,2023-04-20,6210
00632R,元大台灣50反1,200,45,155,新百王,2023-04-21,6210
1718,中纖,141,1,140,新百王,2023-04-21,6210
1101,台泥,147,19,128,新百王,2023-04-21,6210
00671R,富邦NASDAQ反1,108,0,108,新百王,2023-04-21,6210
1457,宜進,78,0,78,新百王,2023-04-21,6210
6244,茂迪,244,167,77,新百王,2023-04-21,6210
3032,偉訓,73,3,70,新百王,2023-04-21,6210
2607,榮運,46,5,41,新百王,2023-04-21,6210
1310,台苯,40,1,39,新百王,2023-04-21,6210
00665L,富邦�琤肭磪囓�2,40,3,37,新百王,2023-04-21,6210
2023,燁輝,32,0,32,新百王,2023-04-21,6210
2601,益航,31,0,31,新百王,2023-04-21,6210
3058,立德,60,30,30,新百王,2023-04-21,6210
2913,農林,61,34,27,新百王,2023-04-21,6210
2329,華泰,25,0,25,新百王,2023-04-21,6210
6285,啟��,27,3,24,新百王,2023-04-21,6210
3576,聯合再生,24,1,23,新百王,2023-04-21,6210
2603,長榮,30,8,22,新百王,2023-04-21,6210
2369,菱生,20,0,20,新百王,2023-04-21,6210
2007,燁興,20,0,20,新百王,2023-04-21,6210
6443,元晶,35,15,20,新百王,2023-04-21,6210
3312,弘憶股,20,0,20,新百王,2023-04-21,6210
00888,永豐台灣ESG,20,1,19,新百王,2023-04-21,6210
2312,金寶,19,0,19,新百王,2023-04-21,6210
2852,第一保,19,0,19,新百王,2023-04-21,6210
6550,北極星藥業-KY,28,9,19,新百王,2023-04-21,6210
3715,定穎投控,162,143,19,新百王,2023-04-21,6210
3264,欣銓,28,10,18,新百王,2023-04-21,6210
00877,復華中國5G,18,0,18,新百王,2023-04-21,6210
6288,聯嘉,19,2,17,新百王,2023-04-21,6210
4995,晶達,17,0,17,新百王,2023-04-21,6210
4931,新盛力,36,20,16,新百王,2023-04-21,6210
2609,陽明,17,2,15,新百王,2023-04-21,6210
8038,長園科,15,0,15,新百王,2023-04-21,6210
5009,榮剛,94,79,15,新百王,2023-04-21,6210
5426,振發,14,0,14,新百王,2023-04-21,6210
6282,康舒,266,254,12,新百王,2023-04-21,6210
6790,永豐實,15,3,12,新百王,2023-04-21,6210
3138,耀登,12,0,12,新百王,2023-04-21,6210
2634,漢翔,185,173,12,新百王,2023-04-21,6210
2382,廣達,11,0,11,新百王,2023-04-21,6210
00919,群益台灣精選高息,11,0,11,新百王,2023-04-21,6210
4916,事欣科,11,0,11,新百王,2023-04-21,6210
4111,濟生,11,0,11,新百王,2023-04-21,6210
2482,連宇,12,1,11,新百王,2023-04-21,6210
2201,裕隆,54,43,11,新百王,2023-04-21,6210
5355,佳總,11,0,11,新百王,2023-04-21,6210
2349,錸德,11,0,11,新百王,2023-04-21,6210
00789B,復華公司債A3,10,0,10,新百王,2023-04-21,6210
1760,寶齡富錦,50,40,10,新百王,2023-04-21,6210
00637L,元大滬深300正2,134,37,97,新百王,2023-04-24,6210
00665L,富邦�琤肭磪囓�2,132,45,87,新百王,2023-04-24,6210
00632R,元大台灣50反1,137,60,77,新百王,2023-04-24,6210
00655L,國泰中國A50正2,62,0,62,新百王,2023-04-24,6210
1108,幸福,55,0,55,新百王,2023-04-24,6210
1471,首利,50,0,50,新百王,2023-04-24,6210
00753L,中信中國50正2,95,49,46,新百王,2023-04-24,6210
2607,榮運,41,1,40,新百王,2023-04-24,6210
5490,同亨,40,0,40,新百王,2023-04-24,6210
2313,華通,39,4,35,新百王,2023-04-24,6210
0050,元大台灣50,37,4,33,新百王,2023-04-24,6210
5905,南仁湖,30,0,30,新百王,2023-04-24,6210
2442,新美齊,28,0,28,新百王,2023-04-24,6210
6234,高僑,31,4,27,新百王,2023-04-24,6210
4720,德淵,23,0,23,新百王,2023-04-24,6210
2850,新產,23,0,23,新百王,2023-04-24,6210
6770,力積電,23,0,23,新百王,2023-04-24,6210
1217,愛之味,22,0,22,新百王,2023-04-24,6210
00680L,元大美債20正2,22,1,21,新百王,2023-04-24,6210
00878,國泰永續高股息,42,22,20,新百王,2023-04-24,6210
00725B,國泰投資級公司債,20,0,20,新百王,2023-04-24,6210
00720B,元大投資級公司債,20,0,20,新百王,2023-04-24,6210
4147,中裕,29,9,20,新百王,2023-04-24,6210
00664R,國泰臺灣加權反1,20,0,20,新百王,2023-04-24,6210
00882,中信中國高股息,21,1,20,新百王,2023-04-24,6210
2461,光群雷,18,0,18,新百王,2023-04-24,6210
6271,同欣電,21,3,18,新百王,2023-04-24,6210
2324,仁寶,17,0,17,新百王,2023-04-24,6210
5328,華容,17,0,17,新百王,2023-04-24,6210
2027,大成鋼,22,5,17,新百王,2023-04-24,6210
2915,潤泰全,24,8,16,新百王,2023-04-24,6210
2382,廣達,16,0,16,新百王,2023-04-24,6210
00712,復華富時不動產,17,2,15,新百王,2023-04-24,6210
3481,群創,70,55,15,新百王,2023-04-24,6210
2457,飛宏,36,21,15,新百王,2023-04-24,6210
2208,台船,24,9,15,新百王,2023-04-24,6210
2007,燁興,15,0,15,新百王,2023-04-24,6210
2855,統一證,15,0,15,新百王,2023-04-24,6210
6443,元晶,25,10,15,新百王,2023-04-24,6210
2812,台中銀,13,0,13,新百王,2023-04-24,6210
8926,台汽電,13,0,13,新百王,2023-04-24,6210
2707,晶華,13,0,13,新百王,2023-04-24,6210
1609,大亞,13,0,13,新百王,2023-04-24,6210
4707,磐亞,12,0,12,新百王,2023-04-24,6210
6116,彩晶,11,0,11,新百王,2023-04-24,6210
2610,華航,21,10,11,新百王,2023-04-24,6210
00902,中信電池及儲能,11,0,11,新百王,2023-04-24,6210
0056,元大高股息,11,0,11,新百王,2023-04-24,6210
1789,神隆,10,0,10,新百王,2023-04-24,6210
3078,僑威,39,29,10,新百王,2023-04-24,6210
4207,環泰,161,0,161,新百王,2023-04-25,6210
00753L,中信中國50正2,223,86,137,新百王,2023-04-25,6210
00669R,國泰美國道瓊反1,130,0,130,新百王,2023-04-25,6210
1721,三晃,74,9,65,新百王,2023-04-25,6210
3032,偉訓,65,1,64,新百王,2023-04-25,6210
2607,榮運,64,0,64,新百王,2023-04-25,6210
6770,力積電,63,1,62,新百王,2023-04-25,6210
8240,華宏,57,0,57,新百王,2023-04-25,6210
6168,宏齊,50,0,50,新百王,2023-04-25,6210
2371,大同,105,56,49,新百王,2023-04-25,6210
2206,三陽工業,114,71,43,新百王,2023-04-25,6210
2891,中信金,51,11,40,新百王,2023-04-25,6210
0050,元大台灣50,52,13,39,新百王,2023-04-25,6210
00675L,富邦臺灣加權正2,37,0,37,新百王,2023-04-25,6210
2748,雲品,36,1,35,新百王,2023-04-25,6210
6625,必應,44,11,33,新百王,2023-04-25,6210
5009,榮剛,78,47,31,新百王,2023-04-25,6210
2104,國際中橡,30,0,30,新百王,2023-04-25,6210
3264,欣銓,40,12,28,新百王,2023-04-25,6210
0056,元大高股息,27,0,27,新百王,2023-04-25,6210
4958,臻鼎-KY,26,0,26,新百王,2023-04-25,6210
3037,欣興,27,3,24,新百王,2023-04-25,6210
4744,皇將,32,9,23,新百王,2023-04-25,6210
5880,合庫金,25,2,23,新百王,2023-04-25,6210
2388,威盛,25,3,22,新百王,2023-04-25,6210
2454,聯發科,27,5,22,新百王,2023-04-25,6210
00878,國泰永續高股息,22,1,21,新百王,2023-04-25,6210
3704,合勤控,20,0,20,新百王,2023-04-25,6210
00919,群益台灣精選高息,20,0,20,新百王,2023-04-25,6210
2449,京元電子,19,0,19,新百王,2023-04-25,6210
00637L,元大滬深300正2,81,62,19,新百王,2023-04-25,6210
2442,新美齊,23,4,19,新百王,2023-04-25,6210
6116,彩晶,27,8,19,新百王,2023-04-25,6210
2707,晶華,19,0,19,新百王,2023-04-25,6210
2027,大成鋼,20,2,18,新百王,2023-04-25,6210
4934,太極,18,0,18,新百王,2023-04-25,6210
4906,正文,18,0,18,新百王,2023-04-25,6210
4541,晟田,57,39,18,新百王,2023-04-25,6210
3035,智原,47,30,17,新百王,2023-04-25,6210
8927,北基,17,0,17,新百王,2023-04-25,6210
00712,復華富時不動產,17,0,17,新百王,2023-04-25,6210
1752,南光,17,0,17,新百王,2023-04-25,6210
2344,華邦電,15,0,15,新百王,2023-04-25,6210
2515,中工,14,0,14,新百王,2023-04-25,6210
00633L,富邦上証正2,13,0,13,新百王,2023-04-25,6210
2852,第一保,13,0,13,新百王,2023-04-25,6210
2303,聯電,20,7,13,新百王,2023-04-25,6210
6282,康舒,90,78,12,新百王,2023-04-25,6210
00881,國泰台灣5G+,12,0,12,新百王,2023-04-25,6210
2610,華航,21,9,12,新百王,2023-04-25,6210
1528,恩德,132,0,132,新百王,2023-04-26,6210
00712,復華富時不動產,59,3,56,新百王,2023-04-26,6210
2845,遠東銀,50,0,50,新百王,2023-04-26,6210
2344,華邦電,50,0,50,新百王,2023-04-26,6210
2352,佳世達,49,1,48,新百王,2023-04-26,6210
6148,驊宏資,52,9,43,新百王,2023-04-26,6210
2634,漢翔,245,202,43,新百王,2023-04-26,6210
00891,中信關鍵半導體,40,0,40,新百王,2023-04-26,6210
3035,智原,92,54,38,新百王,2023-04-26,6210
00720B,元大投資級公司債,32,1,31,新百王,2023-04-26,6210
3356,奇偶,31,0,31,新百王,2023-04-26,6210
4121,優盛,45,17,28,新百王,2023-04-26,6210
2607,榮運,24,0,24,新百王,2023-04-26,6210
2027,大成鋼,23,0,23,新百王,2023-04-26,6210
4147,中裕,107,85,22,新百王,2023-04-26,6210
2618,長榮航,26,5,21,新百王,2023-04-26,6210
1604,聲寶,21,0,21,新百王,2023-04-26,6210
00923,群益台ESG低碳50,20,0,20,新百王,2023-04-26,6210
3038,全台,20,0,20,新百王,2023-04-26,6210
00664R,國泰臺灣加權反1,20,0,20,新百王,2023-04-26,6210
4934,太極,17,0,17,新百王,2023-04-26,6210
5490,同亨,31,14,17,新百王,2023-04-26,6210
3711,日月光投控,20,4,16,新百王,2023-04-26,6210
2337,旺宏,66,52,14,新百王,2023-04-26,6210
6733,博晟生醫,14,0,14,新百王,2023-04-26,6210
1904,正隆,36,23,13,新百王,2023-04-26,6210
1503,士電,65,52,13,新百王,2023-04-26,6210
6244,茂迪,31,18,13,新百王,2023-04-26,6210
8088,品安,13,0,13,新百王,2023-04-26,6210
6125,廣運,12,0,12,新百王,2023-04-26,6210
2882,國泰金,12,0,12,新百王,2023-04-26,6210
1519,華城,18,7,11,新百王,2023-04-26,6210
0056,元大高股息,12,2,10,新百王,2023-04-26,6210
5880,合庫金,10,0,10,新百王,2023-04-26,6210
00877,復華中國5G,10,0,10,新百王,2023-04-26,6210
1584,精剛,10,0,10,新百王,2023-04-26,6210
2342,茂矽,15,5,10,新百王,2023-04-26,6210
00924,復華S＆P500成長,10,0,10,新百王,2023-04-26,6210
1710,東聯,15,5,10,新百王,2023-04-26,6210
2515,中工,10,0,10,新百王,2023-04-26,6210
1108,幸福,32,23,9,新百王,2023-04-26,6210
2436,偉詮電,13,4,9,新百王,2023-04-26,6210
8215,明基材,12,3,9,新百王,2023-04-26,6210
4958,臻鼎-KY,9,0,9,新百王,2023-04-26,6210
1560,中砂,11,2,9,新百王,2023-04-26,6210
6829,千附精密,30,21,9,新百王,2023-04-26,6210
2002,中鋼,9,1,8,新百王,2023-04-26,6210
6024,群益期,12,4,8,新百王,2023-04-26,6210
2534,宏盛,8,0,8,新百王,2023-04-26,6210
9941,裕融,9,2,7,新百王,2023-04-26,6210
3711,日月光投控,130,0,130,新百王,2023-04-27,6210
1711,永光,204,96,108,新百王,2023-04-27,6210
00632R,元大台灣50反1,106,4,102,新百王,2023-04-27,6210
1528,恩德,66,0,66,新百王,2023-04-27,6210
00751B,元大AAA至A公司債,65,0,65,新百王,2023-04-27,6210
00715L,期街口布蘭特正2,50,0,50,新百王,2023-04-27,6210
2328,廣宇,70,24,46,新百王,2023-04-27,6210
2891,中信金,35,0,35,新百王,2023-04-27,6210
4555,氣立,36,2,34,新百王,2023-04-27,6210
00881,國泰台灣5G+,30,0,30,新百王,2023-04-27,6210
2022,聚亨,30,0,30,新百王,2023-04-27,6210
2208,台船,30,1,29,新百王,2023-04-27,6210
2852,第一保,28,0,28,新百王,2023-04-27,6210
3481,群創,66,38,28,新百王,2023-04-27,6210
2449,京元電子,28,1,27,新百王,2023-04-27,6210
2002,中鋼,27,2,25,新百王,2023-04-27,6210
2609,陽明,24,0,24,新百王,2023-04-27,6210
1314,中石化,23,0,23,新百王,2023-04-27,6210
2603,長榮,26,5,21,新百王,2023-04-27,6210
1789,神隆,20,0,20,新百王,2023-04-27,6210
00918,大華優利高填息30,20,0,20,新百王,2023-04-27,6210
00688L,國泰20年美債正2,20,0,20,新百王,2023-04-27,6210
0050,元大台灣50,25,5,20,新百王,2023-04-27,6210
3356,奇偶,18,0,18,新百王,2023-04-27,6210
00664R,國泰臺灣加權反1,20,2,18,新百王,2023-04-27,6210
00712,復華富時不動產,18,0,18,新百王,2023-04-27,6210
3705,永信,18,0,18,新百王,2023-04-27,6210
8050,廣積,21,5,16,新百王,2023-04-27,6210
3665,貿聯-KY,15,0,15,新百王,2023-04-27,6210
2442,新美齊,40,25,15,新百王,2023-04-27,6210
2352,佳世達,22,7,15,新百王,2023-04-27,6210
6116,彩晶,40,25,15,新百王,2023-04-27,6210
6213,聯茂,15,0,15,新百王,2023-04-27,6210
1310,台苯,160,146,14,新百王,2023-04-27,6210
1720,生達,14,0,14,新百王,2023-04-27,6210
8086,宏捷科,15,2,13,新百王,2023-04-27,6210
00891,中信關鍵半導體,12,0,12,新百王,2023-04-27,6210
2409,友達,12,0,12,新百王,2023-04-27,6210
2888,新光金,10,0,10,新百王,2023-04-27,6210
00725B,國泰投資級公司債,10,0,10,新百王,2023-04-27,6210
2376,技嘉,25,15,10,新百王,2023-04-27,6210
1216,統一,15,5,10,新百王,2023-04-27,6210
9934,成霖,10,0,10,新百王,2023-04-27,6210
2812,台中銀,10,0,10,新百王,2023-04-27,6210
3704,合勤控,10,0,10,新百王,2023-04-27,6210
4934,太極,10,0,10,新百王,2023-04-27,6210
8261,富鼎,10,0,10,新百王,2023-04-27,6210
4744,皇將,9,0,9,新百王,2023-04-27,6210
00642U,期元大S＆P石油,9,0,9,新百王,2023-04-27,6210
00686R,群益臺灣加權反1,9,0,9,新百王,2023-04-27,6210
1714,和桐,198,0,198,新百王,2023-04-28,6210
3481,群創,130,9,121,新百王,2023-04-28,6210
00632R,元大台灣50反1,281,164,117,新百王,2023-04-28,6210
2890,永豐金,100,0,100,新百王,2023-04-28,6210
2897,王道銀行,100,0,100,新百王,2023-04-28,6210
1721,三晃,115,36,79,新百王,2023-04-28,6210
4417,金洲,64,0,64,新百王,2023-04-28,6210
1709,和益,65,6,59,新百王,2023-04-28,6210
2409,友達,78,20,58,新百王,2023-04-28,6210
4123,晟德,60,5,55,新百王,2023-04-28,6210
00907,永豐優息存股,50,0,50,新百王,2023-04-28,6210
8069,元太,50,5,45,新百王,2023-04-28,6210
9902,台火,35,0,35,新百王,2023-04-28,6210
6248,沛波,35,1,34,新百王,2023-04-28,6210
00680L,元大美債20正2,34,2,32,新百王,2023-04-28,6210
00751B,元大AAA至A公司債,32,0,32,新百王,2023-04-28,6210
3231,緯創,53,22,31,新百王,2023-04-28,6210
2444,兆勁,31,0,31,新百王,2023-04-28,6210
6799,來頡,35,5,30,新百王,2023-04-28,6210
3024,憶聲,30,0,30,新百王,2023-04-28,6210
6191,精成科,30,0,30,新百王,2023-04-28,6210
00715L,期街口布蘭特正2,35,6,29,新百王,2023-04-28,6210
1905,華紙,49,22,27,新百王,2023-04-28,6210
6266,泰詠,36,13,23,新百王,2023-04-28,6210
1701,中化,27,6,21,新百王,2023-04-28,6210
4102,永日,20,0,20,新百王,2023-04-28,6210
4533,協易機,20,0,20,新百王,2023-04-28,6210
00881,國泰台灣5G+,20,0,20,新百王,2023-04-28,6210
3029,零壹,41,22,19,新百王,2023-04-28,6210
2880,華南金,20,2,18,新百王,2023-04-28,6210
00631L,元大台灣50正2,27,9,18,新百王,2023-04-28,6210
3105,穩懋,19,3,16,新百王,2023-04-28,6210
6288,聯嘉,73,57,16,新百王,2023-04-28,6210
5469,瀚宇博,16,0,16,新百王,2023-04-28,6210
3081,聯亞,19,3,16,新百王,2023-04-28,6210
2369,菱生,15,0,15,新百王,2023-04-28,6210
00830,國泰費城半導體,15,0,15,新百王,2023-04-28,6210
3665,貿聯-KY,16,1,15,新百王,2023-04-28,6210
2601,益航,15,0,15,新百王,2023-04-28,6210
00878,國泰永續高股息,13,0,13,新百王,2023-04-28,6210
6282,康舒,55,42,13,新百王,2023-04-28,6210
00679B,元大美債20年,13,0,13,新百王,2023-04-28,6210
6116,彩晶,23,10,13,新百王,2023-04-28,6210
1522,堤維西,13,0,13,新百王,2023-04-28,6210
6477,安集,12,0,12,新百王,2023-04-28,6210
2208,台船,19,7,12,新百王,2023-04-28,6210
3576,聯合再生,15,3,12,新百王,2023-04-28,6210
4906,正文,12,0,12,新百王,2023-04-28,6210
2498,宏達電,23,12,11,新百王,2023-04-28,6210
1609,大亞,12,1,11,新百王,2023-04-28,6210
3712,永崴投控,221,24,197,新百王,2023-05-02,6210
00632R,元大台灣50反1,231,60,171,新百王,2023-05-02,6210
1514,亞力,201,43,158,新百王,2023-05-02,6210
1905,華紙,158,51,107,新百王,2023-05-02,6210
1417,嘉裕,99,0,99,新百王,2023-05-02,6210
00637L,元大滬深300正2,120,25,95,新百王,2023-05-02,6210
3711,日月光投控,92,0,92,新百王,2023-05-02,6210
00648R,元大S＆P500反1,85,0,85,新百王,2023-05-02,6210
2412,中華電,87,10,77,新百王,2023-05-02,6210
2206,三陽工業,76,15,61,新百王,2023-05-02,6210
4121,優盛,82,25,57,新百王,2023-05-02,6210
2444,兆勁,55,2,53,新百王,2023-05-02,6210
00900,富邦特選高股息30,51,0,51,新百王,2023-05-02,6210
5469,瀚宇博,46,0,46,新百王,2023-05-02,6210
4510,高鋒,50,4,46,新百王,2023-05-02,6210
00751B,元大AAA至A公司債,38,0,38,新百王,2023-05-02,6210
3363,上詮,133,99,34,新百王,2023-05-02,6210
6188,廣明,37,3,34,新百王,2023-05-02,6210
00688L,國泰20年美債正2,33,0,33,新百王,2023-05-02,6210
2603,長榮,53,20,33,新百王,2023-05-02,6210
9919,康那香,31,0,31,新百王,2023-05-02,6210
1528,恩德,37,7,30,新百王,2023-05-02,6210
2852,第一保,26,0,26,新百王,2023-05-02,6210
1519,華城,63,38,25,新百王,2023-05-02,6210
9907,統一實,40,15,25,新百王,2023-05-02,6210
1904,正隆,34,10,24,新百王,2023-05-02,6210
4114,健喬,24,1,23,新百王,2023-05-02,6210
4555,氣立,62,39,23,新百王,2023-05-02,6210
00680L,元大美債20正2,22,0,22,新百王,2023-05-02,6210
00706L,期元大S＆P日圓正2,20,0,20,新百王,2023-05-02,6210
3033,威健,20,0,20,新百王,2023-05-02,6210
1609,大亞,46,26,20,新百王,2023-05-02,6210
1809,中釉,31,11,20,新百王,2023-05-02,6210
3035,智原,30,11,19,新百王,2023-05-02,6210
1720,生達,22,3,19,新百王,2023-05-02,6210
00715L,期街口布蘭特正2,23,5,18,新百王,2023-05-02,6210
6282,康舒,71,53,18,新百王,2023-05-02,6210
2344,華邦電,110,93,17,新百王,2023-05-02,6210
4919,新唐,18,2,16,新百王,2023-05-02,6210
4127,天良,15,0,15,新百王,2023-05-02,6210
2855,統一證,15,0,15,新百王,2023-05-02,6210
1802,台玻,26,11,15,新百王,2023-05-02,6210
00772B,中信高評級公司債,15,1,14,新百王,2023-05-02,6210
5009,榮剛,35,21,14,新百王,2023-05-02,6210
4173,久裕,14,0,14,新百王,2023-05-02,6210
1524,耿鼎,14,0,14,新百王,2023-05-02,6210
2442,新美齊,15,2,13,新百王,2023-05-02,6210
5425,台半,15,2,13,新百王,2023-05-02,6210
2601,益航,13,0,13,新百王,2023-05-02,6210
2489,瑞軒,38,25,13,新百王,2023-05-02,6210
00632R,元大台灣50反1,390,130,260,新百王,2023-05-03,6210
3032,偉訓,112,2,110,新百王,2023-05-03,6210
3029,零壹,114,27,87,新百王,2023-05-03,6210
00878,國泰永續高股息,84,0,84,新百王,2023-05-03,6210
00720B,元大投資級公司債,69,2,67,新百王,2023-05-03,6210
2801,彰銀,60,0,60,新百王,2023-05-03,6210
2344,華邦電,63,4,59,新百王,2023-05-03,6210
00715L,期街口布蘭特正2,57,0,57,新百王,2023-05-03,6210
00712,復華富時不動產,59,3,56,新百王,2023-05-03,6210
2014,中鴻,55,0,55,新百王,2023-05-03,6210
00637L,元大滬深300正2,59,10,49,新百王,2023-05-03,6210
1417,嘉裕,45,0,45,新百王,2023-05-03,6210
1514,亞力,63,24,39,新百王,2023-05-03,6210
1314,中石化,36,0,36,新百王,2023-05-03,6210
3481,群創,203,170,33,新百王,2023-05-03,6210
00830,國泰費城半導體,30,0,30,新百王,2023-05-03,6210
1528,恩德,30,1,29,新百王,2023-05-03,6210
2482,連宇,31,3,28,新百王,2023-05-03,6210
5880,合庫金,25,0,25,新百王,2023-05-03,6210
3038,全台,24,0,24,新百王,2023-05-03,6210
2609,陽明,28,4,24,新百王,2023-05-03,6210
2603,長榮,55,32,23,新百王,2023-05-03,6210
2317,鴻海,27,4,23,新百王,2023-05-03,6210
4108,懷特,19,0,19,新百王,2023-05-03,6210
6179,亞通,37,18,19,新百王,2023-05-03,6210
00751B,元大AAA至A公司債,30,11,19,新百王,2023-05-03,6210
00713,元大台灣高息低波,17,0,17,新百王,2023-05-03,6210
5871,中租-KY,17,1,16,新百王,2023-05-03,6210
6282,康舒,55,39,16,新百王,2023-05-03,6210
2495,普安,19,3,16,新百王,2023-05-03,6210
2615,萬海,32,17,15,新百王,2023-05-03,6210
6248,沛波,15,0,15,新百王,2023-05-03,6210
2402,毅嘉,16,1,15,新百王,2023-05-03,6210
00679B,元大美債20年,15,1,14,新百王,2023-05-03,6210
2201,裕隆,23,9,14,新百王,2023-05-03,6210
2442,新美齊,13,1,12,新百王,2023-05-03,6210
3231,緯創,38,26,12,新百王,2023-05-03,6210
1904,正隆,28,16,12,新百王,2023-05-03,6210
6244,茂迪,19,7,12,新百王,2023-05-03,6210
6625,必應,51,40,11,新百王,2023-05-03,6210
00788B,元大10年IG電能債,11,0,11,新百王,2023-05-03,6210
4707,磐亞,11,0,11,新百王,2023-05-03,6210
3030,德律,12,1,11,新百王,2023-05-03,6210
0056,元大高股息,10,0,10,新百王,2023-05-03,6210
3037,欣興,45,35,10,新百王,2023-05-03,6210
6217,中探針,10,0,10,新百王,2023-05-03,6210
1711,永光,13,3,10,新百王,2023-05-03,6210
3017,奇鋐,14,4,10,新百王,2023-05-03,6210
8088,品安,11,1,10,新百王,2023-05-03,6210
00924,復華S＆P500成長,10,0,10,新百王,2023-05-03,6210
00632R,元大台灣50反1,234,30,204,新百王,2023-05-04,6210
2890,永豐金,201,0,201,新百王,2023-05-04,6210
00715L,期街口布蘭特正2,169,3,166,新百王,2023-05-04,6210
00679B,元大美債20年,153,7,146,新百王,2023-05-04,6210
00712,復華富時不動產,74,3,71,新百王,2023-05-04,6210
6234,高僑,95,39,56,新百王,2023-05-04,6210
2317,鴻海,49,2,47,新百王,2023-05-04,6210
2603,長榮,48,10,38,新百王,2023-05-04,6210
00642U,期元大S＆P石油,33,0,33,新百王,2023-05-04,6210
5469,瀚宇博,63,32,31,新百王,2023-05-04,6210
1528,恩德,30,0,30,新百王,2023-05-04,6210
2332,友訊,24,0,24,新百王,2023-05-04,6210
3027,盛達,28,5,23,新百王,2023-05-04,6210
4744,皇將,45,22,23,新百王,2023-05-04,6210
8349,�矬�,23,0,23,新百王,2023-05-04,6210
3029,零壹,118,96,22,新百王,2023-05-04,6210
1709,和益,22,0,22,新百王,2023-05-04,6210
3673,TPK-KY,33,13,20,新百王,2023-05-04,6210
2349,錸德,20,0,20,新百王,2023-05-04,6210
00674R,期元大S＆P黃金反1,20,0,20,新百王,2023-05-04,6210
2344,華邦電,21,1,20,新百王,2023-05-04,6210
00878,國泰永續高股息,33,14,19,新百王,2023-05-04,6210
6244,茂迪,62,43,19,新百王,2023-05-04,6210
3236,千如,22,3,19,新百王,2023-05-04,6210
0050,元大台灣50,19,2,17,新百王,2023-05-04,6210
3230,錦明,17,0,17,新百王,2023-05-04,6210
4121,優盛,25,9,16,新百王,2023-05-04,6210
2634,漢翔,131,116,15,新百王,2023-05-04,6210
1519,華城,42,27,15,新百王,2023-05-04,6210
3257,虹冠電,14,0,14,新百王,2023-05-04,6210
3048,益登,13,0,13,新百王,2023-05-04,6210
2809,京城銀,13,0,13,新百王,2023-05-04,6210
8121,越峰,12,0,12,新百王,2023-05-04,6210
6218,豪勉,14,2,12,新百王,2023-05-04,6210
6535,順藥,13,1,12,新百王,2023-05-04,6210
2457,飛宏,25,14,11,新百王,2023-05-04,6210
1524,耿鼎,11,0,11,新百王,2023-05-04,6210
00725B,國泰投資級公司債,10,0,10,新百王,2023-05-04,6210
1444,力麗,10,0,10,新百王,2023-05-04,6210
3093,港建*,12,2,10,新百王,2023-05-04,6210
1314,中石化,10,0,10,新百王,2023-05-04,6210
4106,雃博,19,9,10,新百王,2023-05-04,6210
1711,永光,13,3,10,新百王,2023-05-04,6210
1701,中化,10,0,10,新百王,2023-05-04,6210
2014,中鴻,10,0,10,新百王,2023-05-04,6210
00751B,元大AAA至A公司債,10,0,10,新百王,2023-05-04,6210
00924,復華S＆P500成長,10,0,10,新百王,2023-05-04,6210
5880,合庫金,10,0,10,新百王,2023-05-04,6210
8085,福華,30,20,10,新百王,2023-05-04,6210
6188,廣明,9,0,9,新百王,2023-05-04,6210
6191,精成科,111,18,93,新百王,2023-05-05,6210
00680L,元大美債20正2,91,10,81,新百王,2023-05-05,6210
3663,鑫科,71,3,68,新百王,2023-05-05,6210
2353,宏��,86,20,66,新百王,2023-05-05,6210
00632R,元大台灣50反1,315,256,59,新百王,2023-05-05,6210
4167,松瑞藥,50,0,50,新百王,2023-05-05,6210
1609,大亞,128,78,50,新百王,2023-05-05,6210
4114,健喬,95,46,49,新百王,2023-05-05,6210
3596,智易,52,5,47,新百王,2023-05-05,6210
00715L,期街口布蘭特正2,60,15,45,新百王,2023-05-05,6210
6625,必應,62,17,45,新百王,2023-05-05,6210
00751B,元大AAA至A公司債,43,0,43,新百王,2023-05-05,6210
1108,幸福,33,0,33,新百王,2023-05-05,6210
00878,國泰永續高股息,32,0,32,新百王,2023-05-05,6210
1504,東元,44,14,30,新百王,2023-05-05,6210
2317,鴻海,31,2,29,新百王,2023-05-05,6210
2897,王道銀行,31,3,28,新百王,2023-05-05,6210
6244,茂迪,89,62,27,新百王,2023-05-05,6210
4555,氣立,38,13,25,新百王,2023-05-05,6210
00679B,元大美債20年,34,12,22,新百王,2023-05-05,6210
1905,華紙,55,33,22,新百王,2023-05-05,6210
2359,所羅門,47,26,21,新百王,2023-05-05,6210
3481,群創,30,9,21,新百王,2023-05-05,6210
8049,晶采,21,0,21,新百王,2023-05-05,6210
2022,聚亨,21,0,21,新百王,2023-05-05,6210
00687B,國泰20年美債,20,0,20,新百王,2023-05-05,6210
2101,南港,20,0,20,新百王,2023-05-05,6210
3048,益登,19,0,19,新百王,2023-05-05,6210
00753L,中信中國50正2,41,23,18,新百王,2023-05-05,6210
8403,盛弘,41,23,18,新百王,2023-05-05,6210
2615,萬海,22,5,17,新百王,2023-05-05,6210
1514,亞力,25,9,16,新百王,2023-05-05,6210
3032,偉訓,19,4,15,新百王,2023-05-05,6210
3689,湧德,20,5,15,新百王,2023-05-05,6210
6550,北極星藥業-KY,37,22,15,新百王,2023-05-05,6210
2208,台船,14,0,14,新百王,2023-05-05,6210
00772B,中信高評級公司債,13,0,13,新百王,2023-05-05,6210
6188,廣明,13,0,13,新百王,2023-05-05,6210
4909,新復興,19,6,13,新百王,2023-05-05,6210
5905,南仁湖,13,0,13,新百王,2023-05-05,6210
1101,台泥,13,1,12,新百王,2023-05-05,6210
1734,杏輝,34,22,12,新百王,2023-05-05,6210
1529,樂事綠能,91,79,12,新百王,2023-05-05,6210
6282,康舒,24,12,12,新百王,2023-05-05,6210
2458,義隆,22,10,12,新百王,2023-05-05,6210
00665L,富邦�琤肭磪囓�2,394,383,11,新百王,2023-05-05,6210
00712,復華富時不動產,12,2,10,新百王,2023-05-05,6210
00713,元大台灣高息低波,10,0,10,新百王,2023-05-05,6210
00642U,期元大S＆P石油,10,0,10,新百王,2023-05-05,6210
2014,中鴻,10,0,10,新百王,2023-05-05,6210
00671R,富邦NASDAQ反1,100,0,100,新百王,2023-05-08,6210
5498,凱崴,107,18,89,新百王,2023-05-08,6210
1514,亞力,91,17,74,新百王,2023-05-08,6210
3712,永崴投控,61,0,61,新百王,2023-05-08,6210
00632R,元大台灣50反1,393,332,61,新百王,2023-05-08,6210
1529,樂事綠能,78,20,58,新百王,2023-05-08,6210
1608,華榮,60,3,57,新百王,2023-05-08,6210
2897,王道銀行,50,0,50,新百王,2023-05-08,6210
2892,第一金,45,0,45,新百王,2023-05-08,6210
1314,中石化,39,1,38,新百王,2023-05-08,6210
6248,沛波,47,10,37,新百王,2023-05-08,6210
6790,永豐實,37,0,37,新百王,2023-05-08,6210
5905,南仁湖,31,0,31,新百王,2023-05-08,6210
1218,泰山,41,14,27,新百王,2023-05-08,6210
00687B,國泰20年美債,26,0,26,新百王,2023-05-08,6210
2883,凱基金,107,82,25,新百王,2023-05-08,6210
00688L,國泰20年美債正2,25,0,25,新百王,2023-05-08,6210
2371,大同,26,2,24,新百王,2023-05-08,6210
00679B,元大美債20年,24,1,23,新百王,2023-05-08,6210
8299,群聯,26,3,23,新百王,2023-05-08,6210
6770,力積電,22,0,22,新百王,2023-05-08,6210
3027,盛達,41,20,21,新百王,2023-05-08,6210
3257,虹冠電,21,0,21,新百王,2023-05-08,6210
2412,中華電,53,32,21,新百王,2023-05-08,6210
00680L,元大美債20正2,20,0,20,新百王,2023-05-08,6210
00715L,期街口布蘭特正2,49,29,20,新百王,2023-05-08,6210
2317,鴻海,22,3,19,新百王,2023-05-08,6210
1605,華新,77,58,19,新百王,2023-05-08,6210
8930,青鋼,18,0,18,新百王,2023-05-08,6210
6547,高端疫苗,21,3,18,新百王,2023-05-08,6210
4541,晟田,55,37,18,新百王,2023-05-08,6210
00751B,元大AAA至A公司債,16,0,16,新百王,2023-05-08,6210
4533,協易機,15,0,15,新百王,2023-05-08,6210
1316,上曜,50,35,15,新百王,2023-05-08,6210
5426,振發,14,0,14,新百王,2023-05-08,6210
3013,晟銘電,15,1,14,新百王,2023-05-08,6210
00720B,元大投資級公司債,14,0,14,新百王,2023-05-08,6210
5309,系統電,14,1,13,新百王,2023-05-08,6210
4744,皇將,114,102,12,新百王,2023-05-08,6210
3230,錦明,12,0,12,新百王,2023-05-08,6210
8926,台汽電,52,40,12,新百王,2023-05-08,6210
5011,久陽,12,0,12,新百王,2023-05-08,6210
3380,明泰,12,0,12,新百王,2023-05-08,6210
2442,新美齊,13,1,12,新百王,2023-05-08,6210
2482,連宇,18,6,12,新百王,2023-05-08,6210
3017,奇鋐,51,40,11,新百王,2023-05-08,6210
1802,台玻,11,0,11,新百王,2023-05-08,6210
6223,旺矽,18,7,11,新百王,2023-05-08,6210
1727,中華化,11,0,11,新百王,2023-05-08,6210
2851,中再保,30,20,10,新百王,2023-05-08,6210
3029,零壹,166,18,148,新百王,2023-05-09,6210
00680L,元大美債20正2,89,1,88,新百王,2023-05-09,6210
3715,定穎投控,356,271,85,新百王,2023-05-09,6210
00679B,元大美債20年,86,1,85,新百王,2023-05-09,6210
6244,茂迪,71,15,56,新百王,2023-05-09,6210
6790,永豐實,55,7,48,新百王,2023-05-09,6210
1905,華紙,132,87,45,新百王,2023-05-09,6210
00688L,國泰20年美債正2,40,0,40,新百王,2023-05-09,6210
00753L,中信中國50正2,70,31,39,新百王,2023-05-09,6210
1616,億泰,39,0,39,新百王,2023-05-09,6210
3481,群創,89,51,38,新百王,2023-05-09,6210
6248,沛波,58,28,30,新百王,2023-05-09,6210
2537,聯上發,30,0,30,新百王,2023-05-09,6210
00885,富邦越南,28,2,26,新百王,2023-05-09,6210
5426,振發,35,10,25,新百王,2023-05-09,6210
2883,凱基金,50,25,25,新百王,2023-05-09,6210
00772B,中信高評級公司債,24,0,24,新百王,2023-05-09,6210
00751B,元大AAA至A公司債,23,0,23,新百王,2023-05-09,6210
3046,建��,84,61,23,新百王,2023-05-09,6210
00857B,永豐20年美公債,23,0,23,新百王,2023-05-09,6210
3576,聯合再生,23,0,23,新百王,2023-05-09,6210
00687B,國泰20年美債,22,0,22,新百王,2023-05-09,6210
4114,健喬,24,2,22,新百王,2023-05-09,6210
6443,元晶,42,21,21,新百王,2023-05-09,6210
2027,大成鋼,21,0,21,新百王,2023-05-09,6210
2371,大同,21,1,20,新百王,2023-05-09,6210
1303,南亞,20,0,20,新百王,2023-05-09,6210
8215,明基材,22,2,20,新百王,2023-05-09,6210
6770,力積電,21,2,19,新百王,2023-05-09,6210
00632R,元大台灣50反1,18,0,18,新百王,2023-05-09,6210
1516,川飛,18,0,18,新百王,2023-05-09,6210
1101,台泥,19,1,18,新百王,2023-05-09,6210
5009,榮剛,53,36,17,新百王,2023-05-09,6210
4529,淳紳,16,0,16,新百王,2023-05-09,6210
3591,艾笛森,28,12,16,新百王,2023-05-09,6210
2812,台中銀,15,0,15,新百王,2023-05-09,6210
6547,高端疫苗,17,3,14,新百王,2023-05-09,6210
3058,立德,15,1,14,新百王,2023-05-09,6210
2468,華經,15,1,14,新百王,2023-05-09,6210
00720B,元大投資級公司債,13,0,13,新百王,2023-05-09,6210
4744,皇將,149,136,13,新百王,2023-05-09,6210
8088,品安,13,0,13,新百王,2023-05-09,6210
8091,翔名,37,24,13,新百王,2023-05-09,6210
2851,中再保,12,0,12,新百王,2023-05-09,6210
2601,益航,17,5,12,新百王,2023-05-09,6210
2498,宏達電,17,5,12,新百王,2023-05-09,6210
3005,神基,30,18,12,新百王,2023-05-09,6210
9958,世紀鋼,18,7,11,新百王,2023-05-09,6210
2208,台船,11,0,11,新百王,2023-05-09,6210
5880,合庫金,10,0,10,新百王,2023-05-09,6210
00637L,元大滬深300正2,165,21,144,新百王,2023-05-10,6210
00680L,元大美債20正2,78,0,78,新百王,2023-05-10,6210
2412,中華電,73,5,68,新百王,2023-05-10,6210
00679B,元大美債20年,61,0,61,新百王,2023-05-10,6210
1514,亞力,57,7,50,新百王,2023-05-10,6210
1718,中纖,50,0,50,新百王,2023-05-10,6210
6191,精成科,66,19,47,新百王,2023-05-10,6210
4744,皇將,138,93,45,新百王,2023-05-10,6210
3715,定穎投控,256,217,39,新百王,2023-05-10,6210
4543,萬在,36,0,36,新百王,2023-05-10,6210
00830,國泰費城半導體,30,0,30,新百王,2023-05-10,6210
2887,台新金,30,0,30,新百王,2023-05-10,6210
2603,長榮,42,16,26,新百王,2023-05-10,6210
3005,神基,27,1,26,新百王,2023-05-10,6210
1905,華紙,32,7,25,新百王,2023-05-10,6210
00688L,國泰20年美債正2,25,0,25,新百王,2023-05-10,6210
00882,中信中國高股息,22,0,22,新百王,2023-05-10,6210
8050,廣積,22,0,22,新百王,2023-05-10,6210
00878,國泰永續高股息,22,0,22,新百王,2023-05-10,6210
2356,英業達,21,0,21,新百王,2023-05-10,6210
3202,樺晟,30,9,21,新百王,2023-05-10,6210
6112,邁達特,71,51,20,新百王,2023-05-10,6210
2515,中工,50,30,20,新百王,2023-05-10,6210
2890,永豐金,20,0,20,新百王,2023-05-10,6210
3704,合勤控,20,0,20,新百王,2023-05-10,6210
6276,安鈦克,36,16,20,新百王,2023-05-10,6210
00753L,中信中國50正2,20,2,18,新百王,2023-05-10,6210
00720B,元大投資級公司債,26,10,16,新百王,2023-05-10,6210
00687B,國泰20年美債,16,0,16,新百王,2023-05-10,6210
8349,�矬�,16,0,16,新百王,2023-05-10,6210
6234,高僑,57,42,15,新百王,2023-05-10,6210
00665L,富邦�琤肭磪囓�2,254,240,14,新百王,2023-05-10,6210
3712,永崴投控,27,15,12,新百王,2023-05-10,6210
3017,奇鋐,42,30,12,新百王,2023-05-10,6210
3014,聯陽,12,0,12,新百王,2023-05-10,6210
4977,眾達-KY,14,2,12,新百王,2023-05-10,6210
2630,亞航,22,11,11,新百王,2023-05-10,6210
3013,晟銘電,20,9,11,新百王,2023-05-10,6210
2881,富邦金,11,0,11,新百王,2023-05-10,6210
2030,彰源,11,0,11,新百王,2023-05-10,6210
0050,元大台灣50,33,22,11,新百王,2023-05-10,6210
2883,凱基金,20,10,10,新百王,2023-05-10,6210
00673R,期元大S＆P原油反1,10,0,10,新百王,2023-05-10,6210
6111,大宇資,10,0,10,新百王,2023-05-10,6210
1504,東元,16,6,10,新百王,2023-05-10,6210
1451,年興,10,0,10,新百王,2023-05-10,6210
5009,榮剛,39,30,9,新百王,2023-05-10,6210
2313,華通,12,3,9,新百王,2023-05-10,6210
5227,立凱-KY,10,1,9,新百王,2023-05-10,6210
2915,潤泰全,9,0,9,新百王,2023-05-10,6210
00665L,富邦�琤肭磪囓�2,245,0,245,新百王,2023-05-11,6210
2834,臺企銀,203,0,203,新百王,2023-05-11,6210
2867,三商壽,107,0,107,新百王,2023-05-11,6210
3481,群創,87,0,87,新百王,2023-05-11,6210
1718,中纖,82,0,82,新百王,2023-05-11,6210
6285,啟��,68,2,66,新百王,2023-05-11,6210
6116,彩晶,130,69,61,新百王,2023-05-11,6210
1608,華榮,66,5,61,新百王,2023-05-11,6210
2634,漢翔,137,81,56,新百王,2023-05-11,6210
2317,鴻海,53,3,50,新百王,2023-05-11,6210
00671R,富邦NASDAQ反1,36,0,36,新百王,2023-05-11,6210
1609,大亞,102,70,32,新百王,2023-05-11,6210
2851,中再保,51,20,31,新百王,2023-05-11,6210
2890,永豐金,30,0,30,新百王,2023-05-11,6210
9907,統一實,33,3,30,新百王,2023-05-11,6210
6276,安鈦克,38,12,26,新百王,2023-05-11,6210
2603,長榮,26,1,25,新百王,2023-05-11,6210
4958,臻鼎-KY,27,2,25,新百王,2023-05-11,6210
5426,振發,25,0,25,新百王,2023-05-11,6210
1314,中石化,24,1,23,新百王,2023-05-11,6210
2449,京元電子,24,1,23,新百王,2023-05-11,6210
4967,十銓,27,5,22,新百王,2023-05-11,6210
2457,飛宏,92,71,21,新百王,2023-05-11,6210
1101,台泥,21,0,21,新百王,2023-05-11,6210
9103,美德醫療-DR,20,0,20,新百王,2023-05-11,6210
2882,國泰金,23,3,20,新百王,2023-05-11,6210
8409,商之器,20,0,20,新百王,2023-05-11,6210
4130,健亞,20,0,20,新百王,2023-05-11,6210
2736,富野,23,5,18,新百王,2023-05-11,6210
5009,榮剛,56,38,18,新百王,2023-05-11,6210
1522,堤維西,25,8,17,新百王,2023-05-11,6210
8088,品安,19,3,16,新百王,2023-05-11,6210
3520,華盈,18,2,16,新百王,2023-05-11,6210
8059,凱碩,16,0,16,新百王,2023-05-11,6210
2329,華泰,15,0,15,新百王,2023-05-11,6210
6218,豪勉,19,4,15,新百王,2023-05-11,6210
3715,定穎投控,288,273,15,新百王,2023-05-11,6210
2601,益航,15,0,15,新百王,2023-05-11,6210
4550,長佳,16,1,15,新百王,2023-05-11,6210
8446,華研,18,4,14,新百王,2023-05-11,6210
00637L,元大滬深300正2,33,19,14,新百王,2023-05-11,6210
2104,國際中橡,22,8,14,新百王,2023-05-11,6210
2888,新光金,15,2,13,新百王,2023-05-11,6210
2355,敬鵬,13,0,13,新百王,2023-05-11,6210
0056,元大高股息,14,1,13,新百王,2023-05-11,6210
3257,虹冠電,13,0,13,新百王,2023-05-11,6210
5209,新鼎,28,15,13,新百王,2023-05-11,6210
2615,萬海,13,1,12,新百王,2023-05-11,6210
2312,金寶,12,0,12,新百王,2023-05-11,6210
2812,台中銀,12,0,12,新百王,2023-05-11,6210
4533,協易機,118,5,113,新百王,2023-05-12,6210
00671R,富邦NASDAQ反1,100,0,100,新百王,2023-05-12,6210
2834,臺企銀,104,5,99,新百王,2023-05-12,6210
2888,新光金,96,0,96,新百王,2023-05-12,6210
8940,新天地,79,2,77,新百王,2023-05-12,6210
2317,鴻海,74,1,73,新百王,2023-05-12,6210
00637L,元大滬深300正2,76,15,61,新百王,2023-05-12,6210
00655L,國泰中國A50正2,41,0,41,新百王,2023-05-12,6210
2882,國泰金,39,0,39,新百王,2023-05-12,6210
00675L,富邦臺灣加權正2,38,0,38,新百王,2023-05-12,6210
1905,華紙,116,85,31,新百王,2023-05-12,6210
5469,瀚宇博,31,0,31,新百王,2023-05-12,6210
00715L,期街口布蘭特正2,47,19,28,新百王,2023-05-12,6210
3712,永崴投控,28,0,28,新百王,2023-05-12,6210
2851,中再保,26,0,26,新百王,2023-05-12,6210
6191,精成科,26,2,24,新百王,2023-05-12,6210
2743,山富,35,13,22,新百王,2023-05-12,6210
4977,眾達-KY,22,1,21,新百王,2023-05-12,6210
3481,群創,71,51,20,新百王,2023-05-12,6210
6223,旺矽,32,12,20,新百王,2023-05-12,6210
1337,再生-KY,20,0,20,新百王,2023-05-12,6210
6128,上福,25,5,20,新百王,2023-05-12,6210
1101,台泥,20,1,19,新百王,2023-05-12,6210
2801,彰銀,18,0,18,新百王,2023-05-12,6210
3052,夆典,18,0,18,新百王,2023-05-12,6210
1736,喬山,23,7,16,新百王,2023-05-12,6210
00882,中信中國高股息,16,0,16,新百王,2023-05-12,6210
4743,合一,20,4,16,新百王,2023-05-12,6210
1503,士電,107,92,15,新百王,2023-05-12,6210
6550,北極星藥業-KY,18,5,13,新百王,2023-05-12,6210
00642U,期元大S＆P石油,12,0,12,新百王,2023-05-12,6210
2442,新美齊,14,2,12,新百王,2023-05-12,6210
3032,偉訓,38,27,11,新百王,2023-05-12,6210
6415,矽力*-KY,12,1,11,新百王,2023-05-12,6210
00888,永豐台灣ESG,10,0,10,新百王,2023-05-12,6210
00713,元大台灣高息低波,10,0,10,新百王,2023-05-12,6210
8420,明揚,10,0,10,新百王,2023-05-12,6210
1718,中纖,10,0,10,新百王,2023-05-12,6210
1451,年興,10,0,10,新百王,2023-05-12,6210
4175,杏一,39,29,10,新百王,2023-05-12,6210
2886,兆豐金,10,0,10,新百王,2023-05-12,6210
00924,復華S＆P500成長,10,0,10,新百王,2023-05-12,6210
1519,華城,68,58,10,新百王,2023-05-12,6210
6218,豪勉,121,111,10,新百王,2023-05-12,6210
2408,南亞科,11,1,10,新百王,2023-05-12,6210
4303,信立,10,0,10,新百王,2023-05-12,6210
6111,大宇資,10,0,10,新百王,2023-05-12,6210
5439,高技,10,0,10,新百王,2023-05-12,6210
8099,大世科,10,0,10,新百王,2023-05-12,6210
2027,大成鋼,10,1,9,新百王,2023-05-12,6210
2834,臺企銀,600,0,600,新百王,2023-05-15,6210
00680L,元大美債20正2,255,33,222,新百王,2023-05-15,6210
2890,永豐金,201,2,199,新百王,2023-05-15,6210
1314,中石化,113,1,112,新百王,2023-05-15,6210
1340,勝悅-KY,95,1,94,新百王,2023-05-15,6210
00715L,期街口布蘭特正2,57,5,52,新百王,2023-05-15,6210
00720B,元大投資級公司債,52,0,52,新百王,2023-05-15,6210
00655L,國泰中國A50正2,41,0,41,新百王,2023-05-15,6210
00637L,元大滬深300正2,43,11,32,新百王,2023-05-15,6210
2634,漢翔,38,13,25,新百王,2023-05-15,6210
2201,裕隆,24,0,24,新百王,2023-05-15,6210
00751B,元大AAA至A公司債,20,0,20,新百王,2023-05-15,6210
00688L,國泰20年美債正2,20,0,20,新百王,2023-05-15,6210
4147,中裕,28,9,19,新百王,2023-05-15,6210
2867,三商壽,18,0,18,新百王,2023-05-15,6210
2331,精英,20,3,17,新百王,2023-05-15,6210
00877,復華中國5G,17,0,17,新百王,2023-05-15,6210
3704,合勤控,17,0,17,新百王,2023-05-15,6210
3231,緯創,32,15,17,新百王,2023-05-15,6210
5871,中租-KY,22,6,16,新百王,2023-05-15,6210
1101,台泥,17,1,16,新百王,2023-05-15,6210
2356,英業達,23,10,13,新百王,2023-05-15,6210
2457,飛宏,37,24,13,新百王,2023-05-15,6210
6276,安鈦克,13,0,13,新百王,2023-05-15,6210
3202,樺晟,58,45,13,新百王,2023-05-15,6210
2498,宏達電,12,0,12,新百王,2023-05-15,6210
1785,光洋科,12,0,12,新百王,2023-05-15,6210
6516,勤崴國際,12,0,12,新百王,2023-05-15,6210
1304,台聚,15,3,12,新百王,2023-05-15,6210
0050,元大台灣50,22,10,12,新百王,2023-05-15,6210
5488,松普,11,0,11,新百王,2023-05-15,6210
1440,南紡,11,0,11,新百王,2023-05-15,6210
1795,美時,23,13,10,新百王,2023-05-15,6210
8234,新漢,10,0,10,新百王,2023-05-15,6210
5009,榮剛,13,3,10,新百王,2023-05-15,6210
5864,致和證,10,0,10,新百王,2023-05-15,6210
00900,富邦特選高股息30,10,0,10,新百王,2023-05-15,6210
2421,建準,18,8,10,新百王,2023-05-15,6210
8906,花王,10,0,10,新百王,2023-05-15,6210
5511,德昌,10,0,10,新百王,2023-05-15,6210
1451,年興,10,0,10,新百王,2023-05-15,6210
2317,鴻海,10,1,9,新百王,2023-05-15,6210
2610,華航,9,0,9,新百王,2023-05-15,6210
6548,長科*,9,0,9,新百王,2023-05-15,6210
2536,宏普,8,0,8,新百王,2023-05-15,6210
3520,華盈,8,0,8,新百王,2023-05-15,6210
2208,台船,9,1,8,新百王,2023-05-15,6210
8093,保銳,8,0,8,新百王,2023-05-15,6210
2887,台新金,8,0,8,新百王,2023-05-15,6210
1709,和益,10,2,8,新百王,2023-05-15,6210
00632R,元大台灣50反1,432,0,432,新百王,2023-05-16,6210
2834,臺企銀,234,28,206,新百王,2023-05-16,6210
00680L,元大美債20正2,187,20,167,新百王,2023-05-16,6210
1314,中石化,100,1,99,新百王,2023-05-16,6210
8930,青鋼,97,1,96,新百王,2023-05-16,6210
1709,和益,88,0,88,新百王,2023-05-16,6210
2317,鴻海,55,0,55,新百王,2023-05-16,6210
2903,遠百,50,0,50,新百王,2023-05-16,6210
8076,伍豐,96,51,45,新百王,2023-05-16,6210
2344,華邦電,50,6,44,新百王,2023-05-16,6210
1504,東元,79,37,42,新百王,2023-05-16,6210
1104,環泥,42,4,38,新百王,2023-05-16,6210
00688L,國泰20年美債正2,30,0,30,新百王,2023-05-16,6210
1514,亞力,31,5,26,新百王,2023-05-16,6210
1305,華夏,25,0,25,新百王,2023-05-16,6210
00665L,富邦�琤肭磪囓�2,230,207,23,新百王,2023-05-16,6210
2206,三陽工業,50,28,22,新百王,2023-05-16,6210
00751B,元大AAA至A公司債,21,0,21,新百王,2023-05-16,6210
1340,勝悅-KY,26,5,21,新百王,2023-05-16,6210
1307,三芳,20,0,20,新百王,2023-05-16,6210
3035,智原,28,8,20,新百王,2023-05-16,6210
2387,精元,19,0,19,新百王,2023-05-16,6210
2603,長榮,20,2,18,新百王,2023-05-16,6210
2313,華通,18,0,18,新百王,2023-05-16,6210
00687B,國泰20年美債,17,0,17,新百王,2023-05-16,6210
1605,華新,21,4,17,新百王,2023-05-16,6210
00720B,元大投資級公司債,16,1,15,新百王,2023-05-16,6210
3010,華立,16,1,15,新百王,2023-05-16,6210
1503,士電,42,28,14,新百王,2023-05-16,6210
00772B,中信高評級公司債,14,0,14,新百王,2023-05-16,6210
2323,中環,57,43,14,新百王,2023-05-16,6210
6550,北極星藥業-KY,13,0,13,新百王,2023-05-16,6210
6741,91APP*-KY,20,7,13,新百王,2023-05-16,6210
6276,安鈦克,12,0,12,新百王,2023-05-16,6210
5321,美而快,21,9,12,新百王,2023-05-16,6210
4533,協易機,12,0,12,新百王,2023-05-16,6210
2884,玉山金,15,3,12,新百王,2023-05-16,6210
4967,十銓,39,28,11,新百王,2023-05-16,6210
5498,凱崴,11,0,11,新百王,2023-05-16,6210
4977,眾達-KY,13,2,11,新百王,2023-05-16,6210
00786B,元大10年IG銀行債,10,0,10,新百王,2023-05-16,6210
00756B,群益投等新興公債,10,0,10,新百王,2023-05-16,6210
1471,首利,12,2,10,新百王,2023-05-16,6210
6568,宏觀,10,0,10,新百王,2023-05-16,6210
2371,大同,59,49,10,新百王,2023-05-16,6210
3078,僑威,22,12,10,新百王,2023-05-16,6210
5225,東科-KY,10,0,10,新百王,2023-05-16,6210
2442,新美齊,12,2,10,新百王,2023-05-16,6210
8210,勤誠,11,1,10,新百王,2023-05-16,6210
2412,中華電,22,12,10,新百王,2023-05-16,6210
00632R,元大台灣50反1,729,20,709,新百王,2023-05-17,6210
00687B,國泰20年美債,194,0,194,新百王,2023-05-17,6210
00665L,富邦�琤肭磪囓�2,167,47,120,新百王,2023-05-17,6210
00680L,元大美債20正2,141,27,114,新百王,2023-05-17,6210
2890,永豐金,100,1,99,新百王,2023-05-17,6210
3715,定穎投控,207,137,70,新百王,2023-05-17,6210
6234,高僑,72,6,66,新百王,2023-05-17,6210
5498,凱崴,81,25,56,新百王,2023-05-17,6210
3594,磐儀,50,0,50,新百王,2023-05-17,6210
1514,亞力,52,4,48,新百王,2023-05-17,6210
2363,矽統,45,0,45,新百王,2023-05-17,6210
2812,台中銀,103,68,35,新百王,2023-05-17,6210
6005,群益證,35,0,35,新百王,2023-05-17,6210
8076,伍豐,38,5,33,新百王,2023-05-17,6210
3052,夆典,30,0,30,新百王,2023-05-17,6210
4529,淳紳,30,0,30,新百王,2023-05-17,6210
6016,康和證,29,0,29,新百王,2023-05-17,6210
2402,毅嘉,41,13,28,新百王,2023-05-17,6210
2834,臺企銀,27,0,27,新百王,2023-05-17,6210
1305,華夏,25,0,25,新百王,2023-05-17,6210
00852L,國泰美國道瓊正2,25,0,25,新百王,2023-05-17,6210
2457,飛宏,74,49,25,新百王,2023-05-17,6210
6111,大宇資,28,5,23,新百王,2023-05-17,6210
5511,德昌,22,0,22,新百王,2023-05-17,6210
00688L,國泰20年美債正2,22,0,22,新百王,2023-05-17,6210
00715L,期街口布蘭特正2,42,21,21,新百王,2023-05-17,6210
2892,第一金,25,5,20,新百王,2023-05-17,6210
1307,三芳,20,0,20,新百王,2023-05-17,6210
3078,僑威,38,19,19,新百王,2023-05-17,6210
8446,華研,22,3,19,新百王,2023-05-17,6210
2913,農林,25,6,19,新百王,2023-05-17,6210
00878,國泰永續高股息,28,10,18,新百王,2023-05-17,6210
00712,復華富時不動產,16,0,16,新百王,2023-05-17,6210
1608,華榮,29,13,16,新百王,2023-05-17,6210
5324,士開,15,0,15,新百王,2023-05-17,6210
2104,國際中橡,15,0,15,新百王,2023-05-17,6210
00670L,富邦NASDAQ正2,14,1,13,新百王,2023-05-17,6210
6649,台生材,12,0,12,新百王,2023-05-17,6210
6285,啟��,14,2,12,新百王,2023-05-17,6210
2427,三商電,12,0,12,新百王,2023-05-17,6210
1513,中興電,14,3,11,新百王,2023-05-17,6210
1762,中化生,13,2,11,新百王,2023-05-17,6210
3022,威強電,62,51,11,新百王,2023-05-17,6210
3673,TPK-KY,13,2,11,新百王,2023-05-17,6210
6516,勤崴國際,10,0,10,新百王,2023-05-17,6210
1721,三晃,20,10,10,新百王,2023-05-17,6210
4555,氣立,15,5,10,新百王,2023-05-17,6210
2888,新光金,12,2,10,新百王,2023-05-17,6210
2630,亞航,20,10,10,新百王,2023-05-17,6210
3005,神基,20,10,10,新百王,2023-05-17,6210
00632R,元大台灣50反1,442,20,422,新百王,2023-05-18,6210
2442,新美齊,111,5,106,新百王,2023-05-18,6210
4555,氣立,97,5,92,新百王,2023-05-18,6210
00680L,元大美債20正2,77,0,77,新百王,2023-05-18,6210
00751B,元大AAA至A公司債,52,0,52,新百王,2023-05-18,6210
2891,中信金,55,12,43,新百王,2023-05-18,6210
8222,寶一,176,134,42,新百王,2023-05-18,6210
6218,豪勉,63,22,41,新百王,2023-05-18,6210
3594,磐儀,40,0,40,新百王,2023-05-18,6210
6112,邁達特,181,144,37,新百王,2023-05-18,6210
6596,寬宏藝術,39,5,34,新百王,2023-05-18,6210
1514,亞力,62,31,31,新百王,2023-05-18,6210
4533,協易機,41,11,30,新百王,2023-05-18,6210
00919,群益台灣精選高息,30,0,30,新百王,2023-05-18,6210
00891,中信關鍵半導體,30,0,30,新百王,2023-05-18,6210
6163,華電網,31,1,30,新百王,2023-05-18,6210
6176,瑞儀,42,15,27,新百王,2023-05-18,6210
6282,康舒,94,69,25,新百王,2023-05-18,6210
4931,新盛力,55,30,25,新百王,2023-05-18,6210
8930,青鋼,24,0,24,新百王,2023-05-18,6210
1471,首利,25,2,23,新百王,2023-05-18,6210
2402,毅嘉,86,67,19,新百王,2023-05-18,6210
00665L,富邦�琤肭磪囓�2,229,210,19,新百王,2023-05-18,6210
5258,虹堡,46,27,19,新百王,2023-05-18,6210
2615,萬海,19,3,16,新百王,2023-05-18,6210
00650L,復華香港正2,15,0,15,新百王,2023-05-18,6210
8069,元太,36,22,14,新百王,2023-05-18,6210
4908,前鼎,14,0,14,新百王,2023-05-18,6210
1101,台泥,14,0,14,新百王,2023-05-18,6210
2734,易飛網,17,4,13,新百王,2023-05-18,6210
6488,環球晶,14,1,13,新百王,2023-05-18,6210
6244,茂迪,44,31,13,新百王,2023-05-18,6210
6266,泰詠,18,6,12,新百王,2023-05-18,6210
00687B,國泰20年美債,11,0,11,新百王,2023-05-18,6210
1216,統一,16,5,11,新百王,2023-05-18,6210
2536,宏普,11,0,11,新百王,2023-05-18,6210
3038,全台,16,5,11,新百王,2023-05-18,6210
1337,再生-KY,11,0,11,新百王,2023-05-18,6210
3058,立德,11,0,11,新百王,2023-05-18,6210
5353,台林,13,2,11,新百王,2023-05-18,6210
00675L,富邦臺灣加權正2,11,0,11,新百王,2023-05-18,6210
8924,大田,10,0,10,新百王,2023-05-18,6210
5488,松普,10,0,10,新百王,2023-05-18,6210
3043,科風,10,0,10,新百王,2023-05-18,6210
00706L,期元大S＆P日圓正2,10,0,10,新百王,2023-05-18,6210
3056,富華新,10,0,10,新百王,2023-05-18,6210
5498,凱崴,15,5,10,新百王,2023-05-18,6210
5324,士開,10,0,10,新百王,2023-05-18,6210
00688L,國泰20年美債正2,10,0,10,新百王,2023-05-18,6210
6248,沛波,10,0,10,新百王,2023-05-18,6210
00753L,中信中國50正2,138,20,118,新百王,2023-05-19,6210
00665L,富邦�琤肭磪囓�2,272,154,118,新百王,2023-05-19,6210
5009,榮剛,104,10,94,新百王,2023-05-19,6210
4555,氣立,86,0,86,新百王,2023-05-19,6210
3594,磐儀,80,0,80,新百王,2023-05-19,6210
00637L,元大滬深300正2,112,32,80,新百王,2023-05-19,6210
6191,精成科,60,0,60,新百王,2023-05-19,6210
4533,協易機,48,0,48,新百王,2023-05-19,6210
2851,中再保,44,0,44,新百王,2023-05-19,6210
6509,聚和,44,7,37,新百王,2023-05-19,6210
3058,立德,37,0,37,新百王,2023-05-19,6210
5469,瀚宇博,30,2,28,新百王,2023-05-19,6210
00706L,期元大S＆P日圓正2,27,0,27,新百王,2023-05-19,6210
3715,定穎投控,224,197,27,新百王,2023-05-19,6210
1217,愛之味,25,0,25,新百王,2023-05-19,6210
00687B,國泰20年美債,24,0,24,新百王,2023-05-19,6210
1605,華新,42,19,23,新百王,2023-05-19,6210
8930,青鋼,23,0,23,新百王,2023-05-19,6210
3078,僑威,62,40,22,新百王,2023-05-19,6210
3576,聯合再生,24,3,21,新百王,2023-05-19,6210
2614,東森,20,0,20,新百王,2023-05-19,6210
2891,中信金,20,0,20,新百王,2023-05-19,6210
1608,華榮,19,0,19,新百王,2023-05-19,6210
5706,鳳凰,39,21,18,新百王,2023-05-19,6210
3682,亞太電,17,0,17,新百王,2023-05-19,6210
2884,玉山金,20,4,16,新百王,2023-05-19,6210
00701,國泰股利精選30,15,0,15,新百王,2023-05-19,6210
2010,春源,15,0,15,新百王,2023-05-19,6210
00725B,國泰投資級公司債,15,0,15,新百王,2023-05-19,6210
00891,中信關鍵半導體,15,0,15,新百王,2023-05-19,6210
6235,華孚,64,50,14,新百王,2023-05-19,6210
00632R,元大台灣50反1,62,48,14,新百王,2023-05-19,6210
00690,兆豐藍籌30,13,0,13,新百王,2023-05-19,6210
3363,上詮,62,49,13,新百王,2023-05-19,6210
1529,樂事綠能,25,12,13,新百王,2023-05-19,6210
00751B,元大AAA至A公司債,13,0,13,新百王,2023-05-19,6210
3025,星通,60,48,12,新百王,2023-05-19,6210
00882,中信中國高股息,12,0,12,新百王,2023-05-19,6210
2453,凌群,25,13,12,新百王,2023-05-19,6210
1905,華紙,59,47,12,新百王,2023-05-19,6210
1460,宏遠,12,0,12,新百王,2023-05-19,6210
3029,零壹,77,66,11,新百王,2023-05-19,6210
1513,中興電,26,15,11,新百王,2023-05-19,6210
3006,晶豪科,15,4,11,新百王,2023-05-19,6210
6488,環球晶,12,1,11,新百王,2023-05-19,6210
3624,光頡,11,0,11,新百王,2023-05-19,6210
2317,鴻海,15,5,10,新百王,2023-05-19,6210
00919,群益台灣精選高息,10,0,10,新百王,2023-05-19,6210
3545,敦泰,12,2,10,新百王,2023-05-19,6210
00924,復華S＆P500成長,10,0,10,新百王,2023-05-19,6210
4916,事欣科,246,21,225,新百王,2023-05-22,6210
1529,樂事綠能,214,26,188,新百王,2023-05-22,6210
00715L,期街口布蘭特正2,123,0,123,新百王,2023-05-22,6210
2412,中華電,115,9,106,新百王,2023-05-22,6210
2834,臺企銀,200,100,100,新百王,2023-05-22,6210
00687B,國泰20年美債,98,0,98,新百王,2023-05-22,6210
1201,味全,66,0,66,新百王,2023-05-22,6210
8930,青鋼,52,0,52,新百王,2023-05-22,6210
00862B,中信投資級公司債,45,0,45,新百王,2023-05-22,6210
1217,愛之味,60,15,45,新百王,2023-05-22,6210
4931,新盛力,37,0,37,新百王,2023-05-22,6210
6535,順藥,31,1,30,新百王,2023-05-22,6210
6509,聚和,30,1,29,新百王,2023-05-22,6210
00852L,國泰美國道瓊正2,29,0,29,新百王,2023-05-22,6210
2409,友達,31,3,28,新百王,2023-05-22,6210
2303,聯電,25,0,25,新百王,2023-05-22,6210
2745,五福,25,0,25,新百王,2023-05-22,6210
00751B,元大AAA至A公司債,23,0,23,新百王,2023-05-22,6210
1101,台泥,28,6,22,新百王,2023-05-22,6210
2427,三商電,80,58,22,新百王,2023-05-22,6210
1905,華紙,129,108,21,新百王,2023-05-22,6210
1795,美時,23,5,18,新百王,2023-05-22,6210
6223,旺矽,109,91,18,新百王,2023-05-22,6210
4714,永捷,18,0,18,新百王,2023-05-22,6210
4173,久裕,45,29,16,新百王,2023-05-22,6210
8046,南電,18,3,15,新百王,2023-05-22,6210
1440,南紡,15,0,15,新百王,2023-05-22,6210
5328,華容,15,0,15,新百王,2023-05-22,6210
3025,星通,78,64,14,新百王,2023-05-22,6210
6125,廣運,18,5,13,新百王,2023-05-22,6210
2206,三陽工業,59,47,12,新百王,2023-05-22,6210
8069,元太,26,14,12,新百王,2023-05-22,6210
2358,廷鑫,12,0,12,新百王,2023-05-22,6210
6488,環球晶,12,0,12,新百王,2023-05-22,6210
4726,永昕,11,0,11,新百王,2023-05-22,6210
1802,台玻,20,10,10,新百王,2023-05-22,6210
2438,翔耀,10,0,10,新百王,2023-05-22,6210
2337,旺宏,10,0,10,新百王,2023-05-22,6210
8277,商丞,10,0,10,新百王,2023-05-22,6210
00922,國泰台灣領袖50,20,10,10,新百王,2023-05-22,6210
1455,集盛,10,0,10,新百王,2023-05-22,6210
2313,華通,10,0,10,新百王,2023-05-22,6210
00712,復華富時不動產,11,2,9,新百王,2023-05-22,6210
3088,艾訊,12,3,9,新百王,2023-05-22,6210
6235,華孚,33,24,9,新百王,2023-05-22,6210
1591,駿吉-KY,9,0,9,新百王,2023-05-22,6210
9919,康那香,10,1,9,新百王,2023-05-22,6210
8446,華研,10,1,9,新百王,2023-05-22,6210
2382,廣達,30,22,8,新百王,2023-05-22,6210
00720B,元大投資級公司債,8,0,8,新百王,2023-05-22,6210
4916,事欣科,315,5,310,新百王,2023-05-23,6210
3594,磐儀,166,16,150,新百王,2023-05-23,6210
2323,中環,144,4,140,新百王,2023-05-23,6210
2409,友達,107,1,106,新百王,2023-05-23,6210
00637L,元大滬深300正2,94,20,74,新百王,2023-05-23,6210
2618,長榮航,240,167,73,新百王,2023-05-23,6210
00751B,元大AAA至A公司債,70,0,70,新百王,2023-05-23,6210
2897,王道銀行,60,0,60,新百王,2023-05-23,6210
3481,群創,76,17,59,新百王,2023-05-23,6210
2887,台新金,60,2,58,新百王,2023-05-23,6210
2888,新光金,50,0,50,新百王,2023-05-23,6210
2344,華邦電,51,3,48,新百王,2023-05-23,6210
1905,華紙,100,62,38,新百王,2023-05-23,6210
2313,華通,41,7,34,新百王,2023-05-23,6210
00893,國泰智能電動車,51,19,32,新百王,2023-05-23,6210
00688L,國泰20年美債正2,30,0,30,新百王,2023-05-23,6210
2739,寒舍,29,0,29,新百王,2023-05-23,6210
5905,南仁湖,37,9,28,新百王,2023-05-23,6210
00665L,富邦�琤肭磪囓�2,60,33,27,新百王,2023-05-23,6210
2328,廣宇,30,4,26,新百王,2023-05-23,6210
8930,青鋼,56,31,25,新百王,2023-05-23,6210
00670L,富邦NASDAQ正2,36,12,24,新百王,2023-05-23,6210
1513,中興電,72,50,22,新百王,2023-05-23,6210
1609,大亞,48,26,22,新百王,2023-05-23,6210
2801,彰銀,21,0,21,新百王,2023-05-23,6210
00680L,元大美債20正2,25,5,20,新百王,2023-05-23,6210
3706,神達,33,13,20,新百王,2023-05-23,6210
2745,五福,19,0,19,新百王,2023-05-23,6210
00679B,元大美債20年,19,1,18,新百王,2023-05-23,6210
1314,中石化,18,0,18,新百王,2023-05-23,6210
6203,海韻電,17,2,15,新百王,2023-05-23,6210
2331,精英,22,8,14,新百王,2023-05-23,6210
1337,再生-KY,19,6,13,新百王,2023-05-23,6210
1605,華新,14,1,13,新百王,2023-05-23,6210
1580,新麥,13,0,13,新百王,2023-05-23,6210
00857B,永豐20年美公債,12,0,12,新百王,2023-05-23,6210
2368,金像電,39,28,11,新百王,2023-05-23,6210
00852L,國泰美國道瓊正2,11,0,11,新百王,2023-05-23,6210
6218,豪勉,20,9,11,新百王,2023-05-23,6210
2610,華航,57,46,11,新百王,2023-05-23,6210
8097,常珵,12,1,11,新百王,2023-05-23,6210
1101,台泥,10,0,10,新百王,2023-05-23,6210
2536,宏普,14,4,10,新百王,2023-05-23,6210
6235,華孚,22,12,10,新百王,2023-05-23,6210
1608,華榮,21,11,10,新百王,2023-05-23,6210
6708,天擎,10,0,10,新百王,2023-05-23,6210
00712,復華富時不動產,15,6,9,新百王,2023-05-23,6210
2034,允強,9,0,9,新百王,2023-05-23,6210
5301,寶得利,10,1,9,新百王,2023-05-23,6210
2022,聚亨,10,1,9,新百王,2023-05-23,6210
00637L,元大滬深300正2,226,42,184,新百王,2023-05-24,6210
4916,事欣科,162,3,159,新百王,2023-05-24,6210
1201,味全,113,0,113,新百王,2023-05-24,6210
00753L,中信中國50正2,114,7,107,新百王,2023-05-24,6210
2834,臺企銀,100,2,98,新百王,2023-05-24,6210
2402,毅嘉,107,24,83,新百王,2023-05-24,6210
2888,新光金,77,7,70,新百王,2023-05-24,6210
00655L,國泰中國A50正2,52,0,52,新百王,2023-05-24,6210
2618,長榮航,213,162,51,新百王,2023-05-24,6210
8930,青鋼,50,1,49,新百王,2023-05-24,6210
00669R,國泰美國道瓊反1,48,0,48,新百王,2023-05-24,6210
2801,彰銀,44,0,44,新百王,2023-05-24,6210
2897,王道銀行,40,0,40,新百王,2023-05-24,6210
5301,寶得利,36,0,36,新百王,2023-05-24,6210
4931,新盛力,46,12,34,新百王,2023-05-24,6210
2371,大同,53,22,31,新百王,2023-05-24,6210
6171,大城地產,30,0,30,新百王,2023-05-24,6210
4533,協易機,30,0,30,新百王,2023-05-24,6210
2303,聯電,32,5,27,新百王,2023-05-24,6210
1432,大魯閣,34,9,25,新百王,2023-05-24,6210
2399,映泰,81,57,24,新百王,2023-05-24,6210
00795B,中信美國公債20年,23,0,23,新百王,2023-05-24,6210
3041,揚智,23,0,23,新百王,2023-05-24,6210
5009,榮剛,24,2,22,新百王,2023-05-24,6210
4564,元翎,22,0,22,新百王,2023-05-24,6210
1785,光洋科,44,23,21,新百王,2023-05-24,6210
4543,萬在,21,0,21,新百王,2023-05-24,6210
2887,台新金,20,0,20,新百王,2023-05-24,6210
1605,華新,19,0,19,新百王,2023-05-24,6210
2634,漢翔,70,51,19,新百王,2023-05-24,6210
1101,台泥,23,5,18,新百王,2023-05-24,6210
3528,安馳,18,0,18,新百王,2023-05-24,6210
8121,越峰,17,0,17,新百王,2023-05-24,6210
3704,合勤控,50,33,17,新百王,2023-05-24,6210
3522,御嵿,18,1,17,新百王,2023-05-24,6210
6282,康舒,52,35,17,新百王,2023-05-24,6210
2739,寒舍,18,2,16,新百王,2023-05-24,6210
3205,佰研,22,6,16,新百王,2023-05-24,6210
8418,捷必勝-KY,15,0,15,新百王,2023-05-24,6210
5371,中光電,15,1,14,新百王,2023-05-24,6210
00882,中信中國高股息,14,0,14,新百王,2023-05-24,6210
2457,飛宏,107,93,14,新百王,2023-05-24,6210
2376,技嘉,35,22,13,新百王,2023-05-24,6210
2701,萬企,18,6,12,新百王,2023-05-24,6210
00878,國泰永續高股息,11,0,11,新百王,2023-05-24,6210
00857B,永豐20年美公債,11,0,11,新百王,2023-05-24,6210
9958,世紀鋼,12,1,11,新百王,2023-05-24,6210
1219,福壽,10,0,10,新百王,2023-05-24,6210
4167,松瑞藥,10,0,10,新百王,2023-05-24,6210
3046,建��,28,18,10,新百王,2023-05-24,6210
00665L,富邦�琤肭磪囓�2,358,10,348,新百王,2023-05-25,6210
00632R,元大台灣50反1,178,60,118,新百王,2023-05-25,6210
00687B,國泰20年美債,78,0,78,新百王,2023-05-25,6210
2323,中環,96,21,75,新百王,2023-05-25,6210
00712,復華富時不動產,64,0,64,新百王,2023-05-25,6210
1460,宏遠,85,22,63,新百王,2023-05-25,6210
00753L,中信中國50正2,56,0,56,新百王,2023-05-25,6210
00637L,元大滬深300正2,58,5,53,新百王,2023-05-25,6210
2610,華航,53,8,45,新百王,2023-05-25,6210
6603,富強鑫,36,0,36,新百王,2023-05-25,6210
2371,大同,50,17,33,新百王,2023-05-25,6210
8418,捷必勝-KY,30,0,30,新百王,2023-05-25,6210
3050,鈺德,30,0,30,新百王,2023-05-25,6210
2888,新光金,30,0,30,新百王,2023-05-25,6210
6285,啟��,29,0,29,新百王,2023-05-25,6210
6531,愛普*,36,9,27,新百王,2023-05-25,6210
1440,南紡,23,0,23,新百王,2023-05-25,6210
6223,旺矽,68,46,22,新百王,2023-05-25,6210
2630,亞航,134,113,21,新百王,2023-05-25,6210
2739,寒舍,21,0,21,新百王,2023-05-25,6210
5864,致和證,31,10,21,新百王,2023-05-25,6210
2457,飛宏,66,46,20,新百王,2023-05-25,6210
3528,安馳,20,0,20,新百王,2023-05-25,6210
2891,中信金,20,0,20,新百王,2023-05-25,6210
1513,中興電,45,26,19,新百王,2023-05-25,6210
1589,永冠-KY,30,11,19,新百王,2023-05-25,6210
00670L,富邦NASDAQ正2,17,0,17,新百王,2023-05-25,6210
6625,必應,25,8,17,新百王,2023-05-25,6210
00852L,國泰美國道瓊正2,17,0,17,新百王,2023-05-25,6210
6116,彩晶,25,8,17,新百王,2023-05-25,6210
2634,漢翔,22,5,17,新百王,2023-05-25,6210
2603,長榮,18,2,16,新百王,2023-05-25,6210
8930,青鋼,16,0,16,新百王,2023-05-25,6210
8088,品安,16,0,16,新百王,2023-05-25,6210
1528,恩德,15,0,15,新百王,2023-05-25,6210
3041,揚智,16,1,15,新百王,2023-05-25,6210
00772B,中信高評級公司債,16,1,15,新百王,2023-05-25,6210
00680L,元大美債20正2,24,10,14,新百王,2023-05-25,6210
6118,建達,32,18,14,新百王,2023-05-25,6210
3029,零壹,45,31,14,新百王,2023-05-25,6210
2303,聯電,24,11,13,新百王,2023-05-25,6210
3027,盛達,13,0,13,新百王,2023-05-25,6210
3035,智原,54,42,12,新百王,2023-05-25,6210
3520,華盈,12,0,12,新百王,2023-05-25,6210
2002,中鋼,13,1,12,新百王,2023-05-25,6210
4114,健喬,12,0,12,新百王,2023-05-25,6210
1580,新麥,12,0,12,新百王,2023-05-25,6210
1605,華新,15,3,12,新百王,2023-05-25,6210
2801,彰銀,12,0,12,新百王,2023-05-25,6210
3591,艾笛森,12,1,11,新百王,2023-05-25,6210
2888,新光金,225,20,205,新百王,2023-05-26,6210
2887,台新金,250,61,189,新百王,2023-05-26,6210
00632R,元大台灣50反1,170,10,160,新百王,2023-05-26,6210
00712,復華富時不動產,99,2,97,新百王,2023-05-26,6210
4564,元翎,119,57,62,新百王,2023-05-26,6210
6126,信音,60,0,60,新百王,2023-05-26,6210
2409,友達,63,5,58,新百王,2023-05-26,6210
4726,永昕,57,0,57,新百王,2023-05-26,6210
2610,華航,99,42,57,新百王,2023-05-26,6210
00715L,期街口布蘭特正2,69,15,54,新百王,2023-05-26,6210
00907,永豐優息存股,52,0,52,新百王,2023-05-26,6210
6223,旺矽,103,58,45,新百王,2023-05-26,6210
6190,萬泰科,82,40,42,新百王,2023-05-26,6210
2453,凌群,67,31,36,新百王,2023-05-26,6210
4555,氣立,45,10,35,新百王,2023-05-26,6210
00753L,中信中國50正2,36,3,33,新百王,2023-05-26,6210
4979,華星光,45,12,33,新百王,2023-05-26,6210
3029,零壹,79,51,28,新百王,2023-05-26,6210
2883,凱基金,39,12,27,新百王,2023-05-26,6210
3209,全科,25,0,25,新百王,2023-05-26,6210
1514,亞力,27,2,25,新百王,2023-05-26,6210
8048,德勝,30,6,24,新百王,2023-05-26,6210
8033,雷虎,23,0,23,新百王,2023-05-26,6210
00891,中信關鍵半導體,23,0,23,新百王,2023-05-26,6210
2601,益航,22,0,22,新百王,2023-05-26,6210
3646,艾恩特,26,4,22,新百王,2023-05-26,6210
3035,智原,24,2,22,新百王,2023-05-26,6210
5258,虹堡,23,1,22,新百王,2023-05-26,6210
2332,友訊,21,0,21,新百王,2023-05-26,6210
00922,國泰台灣領袖50,21,0,21,新百王,2023-05-26,6210
6244,茂迪,21,2,19,新百王,2023-05-26,6210
2421,建準,95,76,19,新百王,2023-05-26,6210
8150,南茂,21,2,19,新百王,2023-05-26,6210
2427,三商電,20,2,18,新百王,2023-05-26,6210
3715,定穎投控,137,120,17,新百王,2023-05-26,6210
00882,中信中國高股息,16,0,16,新百王,2023-05-26,6210
3059,華晶科,16,0,16,新百王,2023-05-26,6210
6591,動力-KY,16,0,16,新百王,2023-05-26,6210
2317,鴻海,17,2,15,新百王,2023-05-26,6210
3078,僑威,20,5,15,新百王,2023-05-26,6210
1905,華紙,17,2,15,新百王,2023-05-26,6210
2884,玉山金,20,6,14,新百王,2023-05-26,6210
00679B,元大美債20年,13,0,13,新百王,2023-05-26,6210
3508,位速,13,0,13,新百王,2023-05-26,6210
2425,承啟,20,7,13,新百王,2023-05-26,6210
4162,智擎,13,1,12,新百王,2023-05-26,6210
4915,致伸,20,8,12,新百王,2023-05-26,6210
6754,匯僑設計,11,0,11,新百王,2023-05-26,6210
8088,品安,16,5,11,新百王,2023-05-26,6210
1589,永冠-KY,11,0,11,新百王,2023-05-26,6210
1514,亞力,146,30,116,新百王,2023-05-29,6210
1101,台泥,108,2,106,新百王,2023-05-29,6210
2412,中華電,95,37,58,新百王,2023-05-29,6210
4916,事欣科,57,0,57,新百王,2023-05-29,6210
00679B,元大美債20年,70,14,56,新百王,2023-05-29,6210
6116,彩晶,88,37,51,新百王,2023-05-29,6210
1609,大亞,124,76,48,新百王,2023-05-29,6210
2371,大同,66,18,48,新百王,2023-05-29,6210
6016,康和證,41,0,41,新百王,2023-05-29,6210
8069,元太,48,9,39,新百王,2023-05-29,6210
5483,中美晶,32,0,32,新百王,2023-05-29,6210
00637L,元大滬深300正2,36,5,31,新百王,2023-05-29,6210
0050,元大台灣50,44,14,30,新百王,2023-05-29,6210
2528,皇普,30,0,30,新百王,2023-05-29,6210
9934,成霖,30,0,30,新百王,2023-05-29,6210
2883,凱基金,50,20,30,新百王,2023-05-29,6210
1460,宏遠,40,12,28,新百王,2023-05-29,6210
00665L,富邦�琤肭磪囓�2,113,86,27,新百王,2023-05-29,6210
2382,廣達,36,9,27,新百王,2023-05-29,6210
1905,華紙,40,13,27,新百王,2023-05-29,6210
2324,仁寶,37,11,26,新百王,2023-05-29,6210
6218,豪勉,32,7,25,新百王,2023-05-29,6210
5310,天剛,25,0,25,新百王,2023-05-29,6210
2834,臺企銀,22,1,21,新百王,2023-05-29,6210
2498,宏達電,46,25,21,新百王,2023-05-29,6210
3703,欣陸,20,0,20,新百王,2023-05-29,6210
00862B,中信投資級公司債,20,0,20,新百王,2023-05-29,6210
2105,正新,20,0,20,新百王,2023-05-29,6210
00891,中信關鍵半導體,20,0,20,新百王,2023-05-29,6210
2360,致茂,24,5,19,新百王,2023-05-29,6210
4555,氣立,19,0,19,新百王,2023-05-29,6210
3711,日月光投控,37,19,18,新百王,2023-05-29,6210
2722,夏都,20,3,17,新百王,2023-05-29,6210
00857B,永豐20年美公債,16,0,16,新百王,2023-05-29,6210
2706,第一店,16,0,16,新百王,2023-05-29,6210
8927,北基,15,0,15,新百王,2023-05-29,6210
1110,東泥,15,0,15,新百王,2023-05-29,6210
00720B,元大投資級公司債,14,0,14,新百王,2023-05-29,6210
5439,高技,48,34,14,新百王,2023-05-29,6210
9941,裕融,14,1,13,新百王,2023-05-29,6210
3231,緯創,141,129,12,新百王,2023-05-29,6210
1809,中釉,13,1,12,新百王,2023-05-29,6210
2610,華航,169,157,12,新百王,2023-05-29,6210
3232,昱捷,12,0,12,新百王,2023-05-29,6210
2330,台積電,36,24,12,新百王,2023-05-29,6210
8046,南電,27,16,11,新百王,2023-05-29,6210
1608,華榮,96,85,11,新百王,2023-05-29,6210
5301,寶得利,11,0,11,新百王,2023-05-29,6210
2883B,凱基金乙特,11,0,11,新百王,2023-05-29,6210
3058,立德,13,2,11,新百王,2023-05-29,6210
00665L,富邦�琤肭磪囓�2,293,43,250,新百王,2023-05-30,6210
00753L,中信中國50正2,135,6,129,新百王,2023-05-30,6210
8059,凱碩,152,40,112,新百王,2023-05-30,6210
2834,臺企銀,93,0,93,新百王,2023-05-30,6210
1514,亞力,90,2,88,新百王,2023-05-30,6210
3032,偉訓,105,21,84,新百王,2023-05-30,6210
00687B,國泰20年美債,86,5,81,新百王,2023-05-30,6210
1460,宏遠,72,0,72,新百王,2023-05-30,6210
00632R,元大台灣50反1,69,5,64,新百王,2023-05-30,6210
6288,聯嘉,65,2,63,新百王,2023-05-30,6210
2329,華泰,60,0,60,新百王,2023-05-30,6210
4916,事欣科,55,1,54,新百王,2023-05-30,6210
3673,TPK-KY,52,1,51,新百王,2023-05-30,6210
2344,華邦電,74,26,48,新百王,2023-05-30,6210
1609,大亞,49,7,42,新百王,2023-05-30,6210
3481,群創,54,12,42,新百王,2023-05-30,6210
6770,力積電,30,1,29,新百王,2023-05-30,6210
3231,緯創,211,183,28,新百王,2023-05-30,6210
1524,耿鼎,31,4,27,新百王,2023-05-30,6210
00670L,富邦NASDAQ正2,26,0,26,新百王,2023-05-30,6210
00637L,元大滬深300正2,43,20,23,新百王,2023-05-30,6210
6244,茂迪,23,0,23,新百王,2023-05-30,6210
2105,正新,25,3,22,新百王,2023-05-30,6210
3576,聯合再生,21,0,21,新百王,2023-05-30,6210
1314,中石化,70,50,20,新百王,2023-05-30,6210
8085,福華,20,0,20,新百王,2023-05-30,6210
4744,皇將,31,11,20,新百王,2023-05-30,6210
2382,廣達,82,63,19,新百王,2023-05-30,6210
2457,飛宏,43,24,19,新百王,2023-05-30,6210
3149,正達,19,0,19,新百王,2023-05-30,6210
2884,玉山金,18,0,18,新百王,2023-05-30,6210
8930,青鋼,20,2,18,新百王,2023-05-30,6210
1519,華城,33,16,17,新百王,2023-05-30,6210
00857B,永豐20年美公債,17,0,17,新百王,2023-05-30,6210
2399,映泰,44,27,17,新百王,2023-05-30,6210
2324,仁寶,19,5,14,新百王,2023-05-30,6210
00762,元大全球AI,14,0,14,新百王,2023-05-30,6210
9907,統一實,14,0,14,新百王,2023-05-30,6210
8046,南電,25,12,13,新百王,2023-05-30,6210
6233,旺玖,16,3,13,新百王,2023-05-30,6210
3362,先進光,26,13,13,新百王,2023-05-30,6210
3163,波若威,14,2,12,新百王,2023-05-30,6210
3038,全台,13,1,12,新百王,2023-05-30,6210
00725B,國泰投資級公司債,12,0,12,新百王,2023-05-30,6210
2371,大同,32,21,11,新百王,2023-05-30,6210
5301,寶得利,20,9,11,新百王,2023-05-30,6210
2634,漢翔,14,3,11,新百王,2023-05-30,6210
00902,中信電池及儲能,15,4,11,新百王,2023-05-30,6210
1218,泰山,10,0,10,新百王,2023-05-30,6210
2363,矽統,10,0,10,新百王,2023-05-30,6210
00715L,期街口布蘭特正2,479,60,419,新百王,2023-05-31,6210
2610,華航,367,162,205,新百王,2023-05-31,6210
00753L,中信中國50正2,217,30,187,新百王,2023-05-31,6210
00637L,元大滬深300正2,154,5,149,新百王,2023-05-31,6210
5876,上海商銀,146,26,120,新百王,2023-05-31,6210
00642U,期元大S＆P石油,116,0,116,新百王,2023-05-31,6210
00665L,富邦�琤肭磪囓�2,80,15,65,新百王,2023-05-31,6210
1514,亞力,74,13,61,新百王,2023-05-31,6210
00655L,國泰中國A50正2,51,0,51,新百王,2023-05-31,6210
6288,聯嘉,43,1,42,新百王,2023-05-31,6210
2317,鴻海,56,14,42,新百王,2023-05-31,6210
6223,旺矽,62,21,41,新百王,2023-05-31,6210
00882,中信中國高股息,40,0,40,新百王,2023-05-31,6210
6770,力積電,37,0,37,新百王,2023-05-31,6210
3715,定穎投控,150,116,34,新百王,2023-05-31,6210
8930,青鋼,32,1,31,新百王,2023-05-31,6210
2105,正新,31,0,31,新百王,2023-05-31,6210
3032,偉訓,33,3,30,新百王,2023-05-31,6210
3380,明泰,37,8,29,新百王,2023-05-31,6210
2489,瑞軒,30,1,29,新百王,2023-05-31,6210
6139,亞翔,25,0,25,新百王,2023-05-31,6210
2867,三商壽,23,0,23,新百王,2023-05-31,6210
1444,力麗,20,0,20,新百王,2023-05-31,6210
3706,神達,54,34,20,新百王,2023-05-31,6210
00881,國泰台灣5G+,19,0,19,新百王,2023-05-31,6210
5392,能率,19,0,19,新百王,2023-05-31,6210
1304,台聚,18,0,18,新百王,2023-05-31,6210
2371,大同,43,25,18,新百王,2023-05-31,6210
2886,兆豐金,18,1,17,新百王,2023-05-31,6210
6456,GIS-KY,16,0,16,新百王,2023-05-31,6210
2329,華泰,18,2,16,新百王,2023-05-31,6210
00878,國泰永續高股息,16,1,15,新百王,2023-05-31,6210
00919,群益台灣精選高息,15,0,15,新百王,2023-05-31,6210
2884,玉山金,20,5,15,新百王,2023-05-31,6210
2382,廣達,88,74,14,新百王,2023-05-31,6210
1460,宏遠,14,0,14,新百王,2023-05-31,6210
00679B,元大美債20年,13,0,13,新百王,2023-05-31,6210
6412,群電,13,0,13,新百王,2023-05-31,6210
8940,新天地,13,1,12,新百王,2023-05-31,6210
4533,協易機,12,0,12,新百王,2023-05-31,6210
6271,同欣電,11,0,11,新百王,2023-05-31,6210
2356,英業達,46,35,11,新百王,2023-05-31,6210
0056,元大高股息,11,0,11,新百王,2023-05-31,6210
3232,昱捷,11,0,11,新百王,2023-05-31,6210
2913,農林,14,3,11,新百王,2023-05-31,6210
1440,南紡,10,0,10,新百王,2023-05-31,6210
3450,聯鈞,10,0,10,新百王,2023-05-31,6210
2328,廣宇,32,22,10,新百王,2023-05-31,6210
5498,凱崴,15,5,10,新百王,2023-05-31,6210
00885,富邦越南,10,0,10,新百王,2023-05-31,6210
00715L,期街口布蘭特正2,230,16,214,新百王,2023-06-01,6210
2444,兆勁,150,0,150,新百王,2023-06-01,6210
2359,所羅門,137,1,136,新百王,2023-06-01,6210
2412,中華電,119,2,117,新百王,2023-06-01,6210
2888,新光金,80,4,76,新百王,2023-06-01,6210
4533,協易機,67,3,64,新百王,2023-06-01,6210
1513,中興電,72,12,60,新百王,2023-06-01,6210
2701,萬企,60,1,59,新百王,2023-06-01,6210
2851,中再保,45,0,45,新百王,2023-06-01,6210
3706,神達,105,61,44,新百王,2023-06-01,6210
8050,廣積,42,0,42,新百王,2023-06-01,6210
2489,瑞軒,53,22,31,新百王,2023-06-01,6210
6016,康和證,31,1,30,新百王,2023-06-01,6210
2615,萬海,42,13,29,新百王,2023-06-01,6210
2882,國泰金,40,13,27,新百王,2023-06-01,6210
00882,中信中國高股息,26,0,26,新百王,2023-06-01,6210
2324,仁寶,29,3,26,新百王,2023-06-01,6210
1727,中華化,25,1,24,新百王,2023-06-01,6210
4129,聯合,91,68,23,新百王,2023-06-01,6210
8210,勤誠,40,18,22,新百王,2023-06-01,6210
4564,元翎,76,54,22,新百王,2023-06-01,6210
6134,萬旭,23,2,21,新百王,2023-06-01,6210
00706L,期元大S＆P日圓正2,20,0,20,新百王,2023-06-01,6210
9939,宏全,20,0,20,新百王,2023-06-01,6210
3094,聯傑,22,2,20,新百王,2023-06-01,6210
4529,淳紳,20,0,20,新百王,2023-06-01,6210
2317,鴻海,71,51,20,新百王,2023-06-01,6210
2408,南亞科,22,3,19,新百王,2023-06-01,6210
6441,廣錠,19,0,19,新百王,2023-06-01,6210
2303,聯電,30,12,18,新百王,2023-06-01,6210
1907,永豐餘,29,11,18,新百王,2023-06-01,6210
3062,建漢,18,0,18,新百王,2023-06-01,6210
2498,宏達電,29,11,18,新百王,2023-06-01,6210
00712,復華富時不動產,17,0,17,新百王,2023-06-01,6210
6215,和椿,24,7,17,新百王,2023-06-01,6210
5608,四維航,16,0,16,新百王,2023-06-01,6210
3406,玉晶光,16,0,16,新百王,2023-06-01,6210
3114,好德,15,0,15,新百王,2023-06-01,6210
00725B,國泰投資級公司債,15,0,15,新百王,2023-06-01,6210
00642U,期元大S＆P石油,18,3,15,新百王,2023-06-01,6210
2301,光寶科,16,2,14,新百王,2023-06-01,6210
6244,茂迪,14,0,14,新百王,2023-06-01,6210
6625,必應,41,28,13,新百王,2023-06-01,6210
4916,事欣科,16,4,12,新百王,2023-06-01,6210
4967,十銓,24,12,12,新百王,2023-06-01,6210
8215,明基材,13,1,12,新百王,2023-06-01,6210
1605,華新,14,2,12,新百王,2023-06-01,6210
2603,長榮,38,27,11,新百王,2023-06-01,6210
5706,鳳凰,83,72,11,新百王,2023-06-01,6210
5009,榮剛,17,6,11,新百王,2023-06-01,6210
00632R,元大台灣50反1,150,0,150,新百王,2023-06-02,6210
00919,群益台灣精選高息,84,0,84,新百王,2023-06-02,6210
6026,福邦證,81,1,80,新百王,2023-06-02,6210
00878,國泰永續高股息,104,28,76,新百王,2023-06-02,6210
2610,華航,397,331,66,新百王,2023-06-02,6210
2442,新美齊,85,20,65,新百王,2023-06-02,6210
2317,鴻海,67,9,58,新百王,2023-06-02,6210
6198,瑞築,50,0,50,新百王,2023-06-02,6210
00670L,富邦NASDAQ正2,45,2,43,新百王,2023-06-02,6210
00907,永豐優息存股,40,0,40,新百王,2023-06-02,6210
9904,寶成,40,0,40,新百王,2023-06-02,6210
4147,中裕,35,4,31,新百王,2023-06-02,6210
6164,華興,30,0,30,新百王,2023-06-02,6210
4533,協易機,31,2,29,新百王,2023-06-02,6210
1319,東陽,30,1,29,新百王,2023-06-02,6210
1905,華紙,125,96,29,新百王,2023-06-02,6210
00679B,元大美債20年,28,0,28,新百王,2023-06-02,6210
3363,上詮,34,7,27,新百王,2023-06-02,6210
2359,所羅門,45,19,26,新百王,2023-06-02,6210
2603,長榮,26,0,26,新百王,2023-06-02,6210
0056,元大高股息,26,1,25,新百王,2023-06-02,6210
2913,農林,34,11,23,新百王,2023-06-02,6210
2867,三商壽,33,11,22,新百王,2023-06-02,6210
6234,高僑,25,3,22,新百王,2023-06-02,6210
2607,榮運,20,0,20,新百王,2023-06-02,6210
00713,元大台灣高息低波,47,28,19,新百王,2023-06-02,6210
3306,鼎天,30,11,19,新百王,2023-06-02,6210
3231,緯創,181,163,18,新百王,2023-06-02,6210
0050,元大台灣50,37,22,15,新百王,2023-06-02,6210
2027,大成鋼,19,4,15,新百王,2023-06-02,6210
6112,邁達特,57,42,15,新百王,2023-06-02,6210
1806,冠軍,15,0,15,新百王,2023-06-02,6210
1608,華榮,92,78,14,新百王,2023-06-02,6210
3630,新鉅科,14,0,14,新百王,2023-06-02,6210
3032,偉訓,68,55,13,新百王,2023-06-02,6210
2371,大同,31,18,13,新百王,2023-06-02,6210
6163,華電網,13,0,13,新百王,2023-06-02,6210
5009,榮剛,22,9,13,新百王,2023-06-02,6210
1503,士電,37,25,12,新百王,2023-06-02,6210
3324,雙鴻,41,29,12,新百王,2023-06-02,6210
2313,華通,14,2,12,新百王,2023-06-02,6210
2889,國票金,30,18,12,新百王,2023-06-02,6210
8215,明基材,16,4,12,新百王,2023-06-02,6210
2369,菱生,12,0,12,新百王,2023-06-02,6210
8021,尖點,12,0,12,新百王,2023-06-02,6210
2881,富邦金,12,1,11,新百王,2023-06-02,6210
2449,京元電子,20,9,11,新百王,2023-06-02,6210
2444,兆勁,11,0,11,新百王,2023-06-02,6210
6125,廣運,18,7,11,新百王,2023-06-02,6210
00706L,期元大S＆P日圓正2,10,0,10,新百王,2023-06-02,6210
3481,群創,363,50,313,新百王,2023-06-05,6210
2359,所羅門,192,0,192,新百王,2023-06-05,6210
4916,事欣科,207,32,175,新百王,2023-06-05,6210
2610,華航,260,112,148,新百王,2023-06-05,6210
0056,元大高股息,163,16,147,新百王,2023-06-05,6210
5511,德昌,102,0,102,新百王,2023-06-05,6210
2867,三商壽,110,12,98,新百王,2023-06-05,6210
2618,長榮航,199,121,78,新百王,2023-06-05,6210
1905,華紙,90,14,76,新百王,2023-06-05,6210
1721,三晃,75,10,65,新百王,2023-06-05,6210
1806,冠軍,110,47,63,新百王,2023-06-05,6210
6016,康和證,105,45,60,新百王,2023-06-05,6210
00673R,期元大S＆P原油反1,56,0,56,新百王,2023-06-05,6210
2323,中環,67,12,55,新百王,2023-06-05,6210
00919,群益台灣精選高息,103,50,53,新百王,2023-06-05,6210
3706,神達,69,17,52,新百王,2023-06-05,6210
3564,其陽,51,0,51,新百王,2023-06-05,6210
6176,瑞儀,50,0,50,新百王,2023-06-05,6210
6005,群益證,86,40,46,新百王,2023-06-05,6210
1611,中電,51,10,41,新百王,2023-06-05,6210
3596,智易,40,1,39,新百王,2023-06-05,6210
2201,裕隆,58,21,37,新百王,2023-06-05,6210
2515,中工,40,3,37,新百王,2023-06-05,6210
00921,兆豐龍頭等權重,36,0,36,新百王,2023-06-05,6210
2344,華邦電,48,12,36,新百王,2023-06-05,6210
2377,微星,34,0,34,新百王,2023-06-05,6210
4979,華星光,60,26,34,新百王,2023-06-05,6210
2317,鴻海,73,39,34,新百王,2023-06-05,6210
1513,中興電,50,18,32,新百王,2023-06-05,6210
2634,漢翔,74,44,30,新百王,2023-06-05,6210
1799,易威,30,0,30,新百王,2023-06-05,6210
1795,美時,43,14,29,新百王,2023-06-05,6210
00713,元大台灣高息低波,29,0,29,新百王,2023-06-05,6210
1714,和桐,32,4,28,新百王,2023-06-05,6210
4744,皇將,50,22,28,新百王,2023-06-05,6210
3027,盛達,28,0,28,新百王,2023-06-05,6210
6456,GIS-KY,33,5,28,新百王,2023-06-05,6210
1762,中化生,27,0,27,新百王,2023-06-05,6210
2356,英業達,66,40,26,新百王,2023-06-05,6210
2442,新美齊,40,15,25,新百王,2023-06-05,6210
2603,長榮,33,8,25,新百王,2023-06-05,6210
2399,映泰,41,18,23,新百王,2023-06-05,6210
2353,宏��,46,24,22,新百王,2023-06-05,6210
8105,凌巨,30,10,20,新百王,2023-06-05,6210
00706L,期元大S＆P日圓正2,20,0,20,新百王,2023-06-05,6210
1467,南緯,20,0,20,新百王,2023-06-05,6210
6125,廣運,41,21,20,新百王,2023-06-05,6210
2855,統一證,45,26,19,新百王,2023-06-05,6210
2457,飛宏,53,35,18,新百王,2023-06-05,6210
1727,中華化,30,12,18,新百王,2023-06-05,6210
2442,新美齊,201,3,198,新百王,2023-06-06,6210
00632R,元大台灣50反1,240,90,150,新百王,2023-06-06,6210
3231,緯創,198,84,114,新百王,2023-06-06,6210
5864,致和證,75,8,67,新百王,2023-06-06,6210
8446,華研,69,7,62,新百王,2023-06-06,6210
00927,群益半導體收益,60,0,60,新百王,2023-06-06,6210
2427,三商電,63,19,44,新百王,2023-06-06,6210
6244,茂迪,39,0,39,新百王,2023-06-06,6210
4916,事欣科,41,4,37,新百王,2023-06-06,6210
6116,彩晶,202,165,37,新百王,2023-06-06,6210
1528,恩德,63,29,34,新百王,2023-06-06,6210
8096,擎亞,30,0,30,新百王,2023-06-06,6210
8088,品安,30,1,29,新百王,2023-06-06,6210
8064,東捷,29,0,29,新百王,2023-06-06,6210
2421,建準,120,93,27,新百王,2023-06-06,6210
2353,宏��,52,26,26,新百王,2023-06-06,6210
6223,旺矽,49,24,25,新百王,2023-06-06,6210
2812,台中銀,50,25,25,新百王,2023-06-06,6210
8358,金居,69,45,24,新百王,2023-06-06,6210
2461,光群雷,25,2,23,新百王,2023-06-06,6210
6101,寬魚國際,21,0,21,新百王,2023-06-06,6210
3564,其陽,21,1,20,新百王,2023-06-06,6210
3081,聯亞,19,0,19,新百王,2023-06-06,6210
6125,廣運,108,89,19,新百王,2023-06-06,6210
2402,毅嘉,62,43,19,新百王,2023-06-06,6210
4906,正文,25,7,18,新百王,2023-06-06,6210
5324,士開,18,0,18,新百王,2023-06-06,6210
1710,東聯,50,33,17,新百王,2023-06-06,6210
00679B,元大美債20年,22,6,16,新百王,2023-06-06,6210
2913,農林,22,6,16,新百王,2023-06-06,6210
2498,宏達電,24,8,16,新百王,2023-06-06,6210
1514,亞力,43,27,16,新百王,2023-06-06,6210
00631L,元大台灣50正2,21,5,16,新百王,2023-06-06,6210
2892,第一金,15,0,15,新百王,2023-06-06,6210
3363,上詮,27,12,15,新百王,2023-06-06,6210
4541,晟田,14,0,14,新百王,2023-06-06,6210
1609,大亞,351,338,13,新百王,2023-06-06,6210
8046,南電,24,11,13,新百王,2023-06-06,6210
4147,中裕,21,8,13,新百王,2023-06-06,6210
3481,群創,50,37,13,新百王,2023-06-06,6210
2634,漢翔,23,11,12,新百王,2023-06-06,6210
00882,中信中國高股息,12,0,12,新百王,2023-06-06,6210
6218,豪勉,14,2,12,新百王,2023-06-06,6210
3071,協禧,12,0,12,新百王,2023-06-06,6210
2317,鴻海,37,26,11,新百王,2023-06-06,6210
3715,定穎投控,161,150,11,新百王,2023-06-06,6210
2615,萬海,18,8,10,新百王,2023-06-06,6210
00670L,富邦NASDAQ正2,11,1,10,新百王,2023-06-06,6210
00921,兆豐龍頭等權重,10,0,10,新百王,2023-06-06,6210
4533,協易機,12,2,10,新百王,2023-06-06,6210
00632R,元大台灣50反1,160,0,160,新百王,2023-06-07,6210
2442,新美齊,156,25,131,新百王,2023-06-07,6210
00715L,期街口布蘭特正2,121,10,111,新百王,2023-06-07,6210
00927,群益半導體收益,111,5,106,新百王,2023-06-07,6210
1710,東聯,93,13,80,新百王,2023-06-07,6210
2888,新光金,88,9,79,新百王,2023-06-07,6210
00688L,國泰20年美債正2,50,0,50,新百王,2023-06-07,6210
2412,中華電,150,105,45,新百王,2023-06-07,6210
8404,百和興業-KY,45,0,45,新百王,2023-06-07,6210
2401,凌陽,104,63,41,新百王,2023-06-07,6210
6101,寬魚國際,38,0,38,新百王,2023-06-07,6210
8446,華研,43,9,34,新百王,2023-06-07,6210
6233,旺玖,40,7,33,新百王,2023-06-07,6210
6168,宏齊,30,0,30,新百王,2023-06-07,6210
2365,昆盈,30,0,30,新百王,2023-06-07,6210
3058,立德,27,1,26,新百王,2023-06-07,6210
8105,凌巨,24,1,23,新百王,2023-06-07,6210
2610,華航,108,85,23,新百王,2023-06-07,6210
00772B,中信高評級公司債,20,0,20,新百王,2023-06-07,6210
1612,宏泰,36,16,20,新百王,2023-06-07,6210
6161,捷波,22,2,20,新百王,2023-06-07,6210
2913,農林,23,3,20,新百王,2023-06-07,6210
1714,和桐,20,0,20,新百王,2023-06-07,6210
4716,大立,20,0,20,新百王,2023-06-07,6210
00706L,期元大S＆P日圓正2,20,0,20,新百王,2023-06-07,6210
6244,茂迪,24,5,19,新百王,2023-06-07,6210
2618,長榮航,94,75,19,新百王,2023-06-07,6210
8112,至上,21,3,18,新百王,2023-06-07,6210
3325,旭品,30,12,18,新百王,2023-06-07,6210
6125,廣運,81,64,17,新百王,2023-06-07,6210
8930,青鋼,44,27,17,新百王,2023-06-07,6210
2027,大成鋼,16,0,16,新百王,2023-06-07,6210
3257,虹冠電,17,1,16,新百王,2023-06-07,6210
2472,立隆電,15,0,15,新百王,2023-06-07,6210
00862B,中信投資級公司債,15,1,14,新百王,2023-06-07,6210
4138,曜亞,15,1,14,新百王,2023-06-07,6210
00665L,富邦�琤肭磪囓�2,389,376,13,新百王,2023-06-07,6210
6282,康舒,104,91,13,新百王,2023-06-07,6210
3032,偉訓,25,13,12,新百王,2023-06-07,6210
3025,星通,19,7,12,新百王,2023-06-07,6210
00713,元大台灣高息低波,26,14,12,新百王,2023-06-07,6210
6188,廣明,29,17,12,新百王,2023-06-07,6210
2609,陽明,18,6,12,新百王,2023-06-07,6210
8171,天宇,12,1,11,新百王,2023-06-07,6210
3564,其陽,11,0,11,新百王,2023-06-07,6210
2408,南亞科,11,0,11,新百王,2023-06-07,6210
2409,友達,13,2,11,新百王,2023-06-07,6210
00633L,富邦上証正2,16,5,11,新百王,2023-06-07,6210
5706,鳳凰,72,62,10,新百王,2023-06-07,6210
1416,廣豐,19,9,10,新百王,2023-06-07,6210
1605,華新,137,5,132,新百王,2023-06-08,6210
2419,仲琦,100,0,100,新百王,2023-06-08,6210
6016,康和證,79,3,76,新百王,2023-06-08,6210
8404,百和興業-KY,74,0,74,新百王,2023-06-08,6210
1513,中興電,123,58,65,新百王,2023-06-08,6210
1217,愛之味,62,0,62,新百王,2023-06-08,6210
3162,精確,56,0,56,新百王,2023-06-08,6210
00673R,期元大S＆P原油反1,60,5,55,新百王,2023-06-08,6210
6116,彩晶,58,11,47,新百王,2023-06-08,6210
00712,復華富時不動產,100,55,45,新百王,2023-06-08,6210
2888,新光金,44,0,44,新百王,2023-06-08,6210
00671R,富邦NASDAQ反1,41,0,41,新百王,2023-06-08,6210
2323,中環,57,16,41,新百王,2023-06-08,6210
3032,偉訓,48,10,38,新百王,2023-06-08,6210
00680L,元大美債20正2,46,10,36,新百王,2023-06-08,6210
1806,冠軍,40,5,35,新百王,2023-06-08,6210
2884,玉山金,40,7,33,新百王,2023-06-08,6210
2344,華邦電,51,19,32,新百王,2023-06-08,6210
6223,旺矽,57,27,30,新百王,2023-06-08,6210
00679B,元大美債20年,27,0,27,新百王,2023-06-08,6210
2409,友達,29,2,27,新百王,2023-06-08,6210
00690,兆豐藍籌30,26,0,26,新百王,2023-06-08,6210
5512,力麒,27,3,24,新百王,2023-06-08,6210
2408,南亞科,23,0,23,新百王,2023-06-08,6210
3346,麗清,29,7,22,新百王,2023-06-08,6210
1432,大魯閣,24,2,22,新百王,2023-06-08,6210
9941,裕融,21,1,20,新百王,2023-06-08,6210
2882,國泰金,20,0,20,新百王,2023-06-08,6210
00877,復華中國5G,20,0,20,新百王,2023-06-08,6210
2317,鴻海,22,3,19,新百王,2023-06-08,6210
3363,上詮,31,12,19,新百王,2023-06-08,6210
7402,邑錡,20,3,17,新百王,2023-06-08,6210
2851,中再保,17,0,17,新百王,2023-06-08,6210
00919,群益台灣精選高息,17,1,16,新百王,2023-06-08,6210
2881,富邦金,17,1,16,新百王,2023-06-08,6210
4744,皇將,30,14,16,新百王,2023-06-08,6210
3038,全台,21,5,16,新百王,2023-06-08,6210
8016,矽創,16,0,16,新百王,2023-06-08,6210
0050,元大台灣50,19,3,16,新百王,2023-06-08,6210
1514,亞力,34,19,15,新百王,2023-06-08,6210
00885,富邦越南,65,50,15,新百王,2023-06-08,6210
5009,榮剛,24,10,14,新百王,2023-06-08,6210
6203,海韻電,18,4,14,新百王,2023-06-08,6210
2308,台達電,16,2,14,新百王,2023-06-08,6210
6190,萬泰科,41,28,13,新百王,2023-06-08,6210
5227,立凱-KY,12,0,12,新百王,2023-06-08,6210
2022,聚亨,12,0,12,新百王,2023-06-08,6210
6791,虎門科技,12,0,12,新百王,2023-06-08,6210
2498,宏達電,23,11,12,新百王,2023-06-08,6210
1504,東元,14,3,11,新百王,2023-06-08,6210
00715L,期街口布蘭特正2,110,3,107,新百王,2023-06-09,6210
1609,大亞,322,216,106,新百王,2023-06-09,6210
0056,元大高股息,114,14,100,新百王,2023-06-09,6210
2888,新光金,120,27,93,新百王,2023-06-09,6210
00751B,元大AAA至A公司債,90,0,90,新百王,2023-06-09,6210
6016,康和證,90,1,89,新百王,2023-06-09,6210
00795B,中信美國公債20年,85,0,85,新百王,2023-06-09,6210
00929,復華台灣科技優息,83,6,77,新百王,2023-06-09,6210
2367,燿華,70,0,70,新百王,2023-06-09,6210
00919,群益台灣精選高息,67,1,66,新百王,2023-06-09,6210
4916,事欣科,72,8,64,新百王,2023-06-09,6210
8404,百和興業-KY,63,0,63,新百王,2023-06-09,6210
00632R,元大台灣50反1,141,90,51,新百王,2023-06-09,6210
00665L,富邦�琤肭磪囓�2,420,373,47,新百王,2023-06-09,6210
5864,致和證,44,5,39,新百王,2023-06-09,6210
2399,映泰,101,62,39,新百王,2023-06-09,6210
4533,協易機,37,0,37,新百王,2023-06-09,6210
1815,富喬,42,10,32,新百王,2023-06-09,6210
2414,精技,31,0,31,新百王,2023-06-09,6210
2851,中再保,30,0,30,新百王,2023-06-09,6210
6266,泰詠,35,7,28,新百王,2023-06-09,6210
6101,寬魚國際,30,2,28,新百王,2023-06-09,6210
2356,英業達,91,67,24,新百王,2023-06-09,6210
8171,天宇,31,7,24,新百王,2023-06-09,6210
3540,曜越,26,2,24,新百王,2023-06-09,6210
00675L,富邦臺灣加權正2,22,0,22,新百王,2023-06-09,6210
5009,榮剛,25,3,22,新百王,2023-06-09,6210
8446,華研,35,14,21,新百王,2023-06-09,6210
8038,長園科,21,0,21,新百王,2023-06-09,6210
1701,中化,20,0,20,新百王,2023-06-09,6210
1714,和桐,20,1,19,新百王,2023-06-09,6210
2353,宏��,28,9,19,新百王,2023-06-09,6210
2436,偉詮電,32,15,17,新百王,2023-06-09,6210
2357,華碩,15,0,15,新百王,2023-06-09,6210
1806,冠軍,15,0,15,新百王,2023-06-09,6210
5905,南仁湖,13,0,13,新百王,2023-06-09,6210
2610,華航,62,49,13,新百王,2023-06-09,6210
6625,必應,47,34,13,新百王,2023-06-09,6210
1560,中砂,17,5,12,新百王,2023-06-09,6210
6282,康舒,32,20,12,新百王,2023-06-09,6210
1785,光洋科,11,0,11,新百王,2023-06-09,6210
1314,中石化,11,0,11,新百王,2023-06-09,6210
4722,國精化,11,0,11,新百王,2023-06-09,6210
1504,東元,15,5,10,新百王,2023-06-09,6210
1722,台肥,10,0,10,新百王,2023-06-09,6210
2505,國揚,10,0,10,新百王,2023-06-09,6210
3188,鑫龍騰,10,0,10,新百王,2023-06-09,6210
8087,麗升能源,10,0,10,新百王,2023-06-09,6210
6477,安集,10,0,10,新百王,2023-06-09,6210
1217,愛之味,27,17,10,新百王,2023-06-09,6210
3231,緯創,365,85,280,新百王,2023-06-12,6210
2834,臺企銀,151,0,151,新百王,2023-06-12,6210
3481,群創,129,27,102,新百王,2023-06-12,6210
2412,中華電,94,4,90,新百王,2023-06-12,6210
2303,聯電,101,15,86,新百王,2023-06-12,6210
1101,台泥,99,16,83,新百王,2023-06-12,6210
2618,長榮航,144,64,80,新百王,2023-06-12,6210
3013,晟銘電,94,20,74,新百王,2023-06-12,6210
2356,英業達,96,31,65,新百王,2023-06-12,6210
00632R,元大台灣50反1,62,0,62,新百王,2023-06-12,6210
6821,聯寶,66,4,62,新百王,2023-06-12,6210
2423,固緯,50,0,50,新百王,2023-06-12,6210
2515,中工,50,0,50,新百王,2023-06-12,6210
8076,伍豐,47,2,45,新百王,2023-06-12,6210
3162,精確,47,2,45,新百王,2023-06-12,6210
4916,事欣科,43,1,42,新百王,2023-06-12,6210
6167,久正,43,2,41,新百王,2023-06-12,6210
3032,偉訓,52,11,41,新百王,2023-06-12,6210
8404,百和興業-KY,41,0,41,新百王,2023-06-12,6210
00919,群益台灣精選高息,53,13,40,新百王,2023-06-12,6210
6016,康和證,40,1,39,新百王,2023-06-12,6210
6244,茂迪,35,1,34,新百王,2023-06-12,6210
5009,榮剛,47,14,33,新百王,2023-06-12,6210
6125,廣運,63,32,31,新百王,2023-06-12,6210
2536,宏普,30,0,30,新百王,2023-06-12,6210
3356,奇偶,68,38,30,新百王,2023-06-12,6210
3033,威健,38,8,30,新百王,2023-06-12,6210
6176,瑞儀,28,0,28,新百王,2023-06-12,6210
2414,精技,25,0,25,新百王,2023-06-12,6210
1815,富喬,30,5,25,新百王,2023-06-12,6210
2705,六福,36,12,24,新百王,2023-06-12,6210
00929,復華台灣科技優息,39,18,21,新百王,2023-06-12,6210
6278,台表科,21,0,21,新百王,2023-06-12,6210
00712,復華富時不動產,23,3,20,新百王,2023-06-12,6210
8210,勤誠,37,17,20,新百王,2023-06-12,6210
2838,聯邦銀,25,5,20,新百王,2023-06-12,6210
0056,元大高股息,18,1,17,新百王,2023-06-12,6210
2358,廷鑫,32,15,17,新百王,2023-06-12,6210
4744,皇將,22,6,16,新百王,2023-06-12,6210
8358,金居,20,5,15,新百王,2023-06-12,6210
00645,富邦日本,15,0,15,新百王,2023-06-12,6210
1217,愛之味,40,25,15,新百王,2023-06-12,6210
1524,耿鼎,20,5,15,新百王,2023-06-12,6210
2495,普安,15,0,15,新百王,2023-06-12,6210
6122,擎邦,33,19,14,新百王,2023-06-12,6210
4157,太景*-KY,15,1,14,新百王,2023-06-12,6210
00713,元大台灣高息低波,13,0,13,新百王,2023-06-12,6210
2329,華泰,13,0,13,新百王,2023-06-12,6210
6203,海韻電,14,1,13,新百王,2023-06-12,6210
2201,裕隆,22,10,12,新百王,2023-06-12,6210
00632R,元大台灣50反1,271,10,261,新百王,2023-06-13,6210
00715L,期街口布蘭特正2,189,9,180,新百王,2023-06-13,6210
2883B,凱基金乙特,100,0,100,新百王,2023-06-13,6210
2442,新美齊,103,15,88,新百王,2023-06-13,6210
3162,精確,75,2,73,新百王,2023-06-13,6210
2312,金寶,65,0,65,新百王,2023-06-13,6210
3481,群創,189,131,58,新百王,2023-06-13,6210
1609,大亞,110,55,55,新百王,2023-06-13,6210
5009,榮剛,76,30,46,新百王,2023-06-13,6210
6016,康和證,42,0,42,新百王,2023-06-13,6210
4977,眾達-KY,64,25,39,新百王,2023-06-13,6210
4106,雃博,35,0,35,新百王,2023-06-13,6210
2838,聯邦銀,60,30,30,新百王,2023-06-13,6210
2888,新光金,58,30,28,新百王,2023-06-13,6210
00929,復華台灣科技優息,41,15,26,新百王,2023-06-13,6210
5871,中租-KY,27,1,26,新百王,2023-06-13,6210
2705,六福,40,15,25,新百王,2023-06-13,6210
2888B,新光金乙特,24,0,24,新百王,2023-06-13,6210
2401,凌陽,25,2,23,新百王,2023-06-13,6210
2882,國泰金,27,4,23,新百王,2023-06-13,6210
00670L,富邦NASDAQ正2,24,2,22,新百王,2023-06-13,6210
1514,亞力,27,6,21,新百王,2023-06-13,6210
2890,永豐金,20,0,20,新百王,2023-06-13,6210
00921,兆豐龍頭等權重,19,0,19,新百王,2023-06-13,6210
2104,國際中橡,25,7,18,新百王,2023-06-13,6210
00642U,期元大S＆P石油,17,0,17,新百王,2023-06-13,6210
2492,華新科,16,0,16,新百王,2023-06-13,6210
3046,建��,51,35,16,新百王,2023-06-13,6210
1513,中興電,25,9,16,新百王,2023-06-13,6210
00902,中信電池及儲能,25,9,16,新百王,2023-06-13,6210
1541,錩泰,17,1,16,新百王,2023-06-13,6210
6245,立端,20,5,15,新百王,2023-06-13,6210
5425,台半,99,85,14,新百王,2023-06-13,6210
1905,華紙,67,53,14,新百王,2023-06-13,6210
6205,詮欣,19,5,14,新百王,2023-06-13,6210
3178,公準,24,12,12,新百王,2023-06-13,6210
00882,中信中國高股息,22,10,12,新百王,2023-06-13,6210
8034,榮群,15,3,12,新百王,2023-06-13,6210
00919,群益台灣精選高息,26,14,12,新百王,2023-06-13,6210
6271,同欣電,12,1,11,新百王,2023-06-13,6210
2834,臺企銀,30,20,10,新百王,2023-06-13,6210
8069,元太,28,18,10,新百王,2023-06-13,6210
2109,華豐,10,0,10,新百王,2023-06-13,6210
1528,恩德,23,13,10,新百王,2023-06-13,6210
1611,中電,10,0,10,新百王,2023-06-13,6210
00922,國泰台灣領袖50,10,0,10,新百王,2023-06-13,6210
3037,欣興,47,37,10,新百王,2023-06-13,6210
2707,晶華,10,0,10,新百王,2023-06-13,6210
2324,仁寶,10,0,10,新百王,2023-06-13,6210
2891,中信金,11,1,10,新百王,2023-06-13,6210
2356,英業達,540,165,375,新百王,2023-06-14,6210
00712,復華富時不動產,154,40,114,新百王,2023-06-14,6210
1742,台蠟,110,3,107,新百王,2023-06-14,6210
1102,亞泥,105,0,105,新百王,2023-06-14,6210
4533,協易機,89,23,66,新百王,2023-06-14,6210
6024,群益期,67,9,58,新百王,2023-06-14,6210
2301,光寶科,76,21,55,新百王,2023-06-14,6210
5425,台半,59,7,52,新百王,2023-06-14,6210
00882,中信中國高股息,45,0,45,新百王,2023-06-14,6210
00680L,元大美債20正2,41,0,41,新百王,2023-06-14,6210
2468,華經,34,1,33,新百王,2023-06-14,6210
3033,威健,37,5,32,新百王,2023-06-14,6210
4106,雃博,31,0,31,新百王,2023-06-14,6210
2104,國際中橡,30,0,30,新百王,2023-06-14,6210
3652,精聯,40,18,22,新百王,2023-06-14,6210
00753L,中信中國50正2,40,18,22,新百王,2023-06-14,6210
2436,偉詮電,22,1,21,新百王,2023-06-14,6210
5864,致和證,20,0,20,新百王,2023-06-14,6210
2504,國產,20,0,20,新百王,2023-06-14,6210
00713,元大台灣高息低波,20,1,19,新百王,2023-06-14,6210
00679B,元大美債20年,19,0,19,新百王,2023-06-14,6210
2405,輔信,71,52,19,新百王,2023-06-14,6210
2427,三商電,30,11,19,新百王,2023-06-14,6210
2382,廣達,23,5,18,新百王,2023-06-14,6210
6016,康和證,18,0,18,新百王,2023-06-14,6210
8088,品安,24,7,17,新百王,2023-06-14,6210
1785,光洋科,18,1,17,新百王,2023-06-14,6210
00927,群益半導體收益,17,0,17,新百王,2023-06-14,6210
00670L,富邦NASDAQ正2,17,1,16,新百王,2023-06-14,6210
1789,神隆,16,0,16,新百王,2023-06-14,6210
9907,統一實,15,0,15,新百王,2023-06-14,6210
1904,正隆,18,3,15,新百王,2023-06-14,6210
2515,中工,15,0,15,新百王,2023-06-14,6210
6171,大城地產,15,0,15,新百王,2023-06-14,6210
6446,藥華藥,15,1,14,新百王,2023-06-14,6210
2705,六福,64,50,14,新百王,2023-06-14,6210
4958,臻鼎-KY,15,1,14,新百王,2023-06-14,6210
6517,保勝光學,37,24,13,新百王,2023-06-14,6210
1522,堤維西,186,173,13,新百王,2023-06-14,6210
2630,亞航,27,14,13,新百王,2023-06-14,6210
3454,晶睿,20,8,12,新百王,2023-06-14,6210
8050,廣積,26,14,12,新百王,2023-06-14,6210
2442,新美齊,12,0,12,新百王,2023-06-14,6210
2349,錸德,12,0,12,新百王,2023-06-14,6210
2634,漢翔,11,0,11,新百王,2023-06-14,6210
2743,山富,62,51,11,新百王,2023-06-14,6210
3363,上詮,14,3,11,新百王,2023-06-14,6210
00640L,富邦日本正2,14,3,11,新百王,2023-06-14,6210
8046,南電,12,1,11,新百王,2023-06-14,6210
6202,盛群,11,0,11,新百王,2023-06-14,6210
1709,和益,107,0,107,新百王,2023-06-15,6210
1528,恩德,158,53,105,新百王,2023-06-15,6210
2453,凌群,153,71,82,新百王,2023-06-15,6210
00632R,元大台灣50反1,79,10,69,新百王,2023-06-15,6210
2618,長榮航,292,230,62,新百王,2023-06-15,6210
3032,偉訓,65,10,55,新百王,2023-06-15,6210
6239,力成,51,1,50,新百王,2023-06-15,6210
5347,世界,46,0,46,新百王,2023-06-15,6210
00673R,期元大S＆P原油反1,45,2,43,新百王,2023-06-15,6210
00919,群益台灣精選高息,39,0,39,新百王,2023-06-15,6210
2317,鴻海,49,11,38,新百王,2023-06-15,6210
2027,大成鋼,41,3,38,新百王,2023-06-15,6210
1102,亞泥,35,0,35,新百王,2023-06-15,6210
2412,中華電,52,18,34,新百王,2023-06-15,6210
00713,元大台灣高息低波,31,0,31,新百王,2023-06-15,6210
2399,映泰,52,21,31,新百王,2023-06-15,6210
00680L,元大美債20正2,31,0,31,新百王,2023-06-15,6210
3013,晟銘電,109,78,31,新百王,2023-06-15,6210
6024,群益期,47,19,28,新百王,2023-06-15,6210
1806,冠軍,47,20,27,新百王,2023-06-15,6210
6016,康和證,72,46,26,新百王,2023-06-15,6210
00706L,期元大S＆P日圓正2,25,0,25,新百王,2023-06-15,6210
2359,所羅門,39,16,23,新百王,2023-06-15,6210
2344,華邦電,24,2,22,新百王,2023-06-15,6210
1522,堤維西,142,121,21,新百王,2023-06-15,6210
00671R,富邦NASDAQ反1,21,0,21,新百王,2023-06-15,6210
2707,晶華,20,0,20,新百王,2023-06-15,6210
4555,氣立,20,0,20,新百王,2023-06-15,6210
1611,中電,43,25,18,新百王,2023-06-15,6210
1785,光洋科,20,2,18,新百王,2023-06-15,6210
00882,中信中國高股息,18,0,18,新百王,2023-06-15,6210
4106,雃博,16,0,16,新百王,2023-06-15,6210
00902,中信電池及儲能,14,0,14,新百王,2023-06-15,6210
3062,建漢,15,1,14,新百王,2023-06-15,6210
3059,華晶科,14,1,13,新百王,2023-06-15,6210
3372,典範,13,0,13,新百王,2023-06-15,6210
6127,九豪,13,0,13,新百王,2023-06-15,6210
2038,海光,12,0,12,新百王,2023-06-15,6210
4916,事欣科,13,1,12,新百王,2023-06-15,6210
6244,茂迪,12,0,12,新百王,2023-06-15,6210
2395,研華,14,2,12,新百王,2023-06-15,6210
3287,廣寰科,12,0,12,新百王,2023-06-15,6210
00795B,中信美國公債20年,12,0,12,新百王,2023-06-15,6210
2449,京元電子,11,0,11,新百王,2023-06-15,6210
9904,寶成,12,1,11,新百王,2023-06-15,6210
2332,友訊,19,8,11,新百王,2023-06-15,6210
3025,星通,21,10,11,新百王,2023-06-15,6210
2498,宏達電,17,6,11,新百王,2023-06-15,6210
4938,和碩,15,4,11,新百王,2023-06-15,6210
2903,遠百,11,0,11,新百王,2023-06-15,6210
2890,永豐金,135,0,135,新百王,2023-06-16,6210
2618,長榮航,191,81,110,新百王,2023-06-16,6210
1217,愛之味,94,23,71,新百王,2023-06-16,6210
2610,華航,631,565,66,新百王,2023-06-16,6210
4904,遠傳,60,0,60,新百王,2023-06-16,6210
2301,光寶科,83,30,53,新百王,2023-06-16,6210
4916,事欣科,62,12,50,新百王,2023-06-16,6210
2834,臺企銀,58,8,50,新百王,2023-06-16,6210
3706,神達,121,76,45,新百王,2023-06-16,6210
6282,康舒,65,24,41,新百王,2023-06-16,6210
2882,國泰金,39,0,39,新百王,2023-06-16,6210
3346,麗清,63,25,38,新百王,2023-06-16,6210
00713,元大台灣高息低波,45,10,35,新百王,2023-06-16,6210
2809,京城銀,33,0,33,新百王,2023-06-16,6210
6147,頎邦,32,3,29,新百王,2023-06-16,6210
2409,友達,124,96,28,新百王,2023-06-16,6210
2883,凱基金,42,17,25,新百王,2023-06-16,6210
00683L,期元大美元指正2,25,0,25,新百王,2023-06-16,6210
3024,憶聲,25,0,25,新百王,2023-06-16,6210
2356,英業達,126,101,25,新百王,2023-06-16,6210
3032,偉訓,48,24,24,新百王,2023-06-16,6210
5864,致和證,24,1,23,新百王,2023-06-16,6210
00712,復華富時不動產,71,49,22,新百王,2023-06-16,6210
3035,智原,48,26,22,新百王,2023-06-16,6210
4977,眾達-KY,21,2,19,新百王,2023-06-16,6210
1457,宜進,19,0,19,新百王,2023-06-16,6210
9907,統一實,20,1,19,新百王,2023-06-16,6210
00929,復華台灣科技優息,19,0,19,新百王,2023-06-16,6210
2449,京元電子,19,0,19,新百王,2023-06-16,6210
2886,兆豐金,25,8,17,新百王,2023-06-16,6210
4931,新盛力,17,0,17,新百王,2023-06-16,6210
2881,富邦金,16,0,16,新百王,2023-06-16,6210
00640L,富邦日本正2,15,0,15,新百王,2023-06-16,6210
4915,致伸,15,0,15,新百王,2023-06-16,6210
5227,立凱-KY,15,0,15,新百王,2023-06-16,6210
2405,輔信,66,51,15,新百王,2023-06-16,6210
00632R,元大台灣50反1,40,25,15,新百王,2023-06-16,6210
4555,氣立,13,0,13,新百王,2023-06-16,6210
1605,華新,131,118,13,新百王,2023-06-16,6210
2739,寒舍,13,0,13,新百王,2023-06-16,6210
4906,正文,13,0,13,新百王,2023-06-16,6210
2109,華豐,16,4,12,新百王,2023-06-16,6210
2371,大同,104,92,12,新百王,2023-06-16,6210
1742,台蠟,12,0,12,新百王,2023-06-16,6210
1514,亞力,65,53,12,新百王,2023-06-16,6210
6005,群益證,38,26,12,新百王,2023-06-16,6210
0050,元大台灣50,15,4,11,新百王,2023-06-16,6210
00671R,富邦NASDAQ反1,11,0,11,新百王,2023-06-16,6210
2353,宏��,35,24,11,新百王,2023-06-16,6210
00895,富邦未來車,11,0,11,新百王,2023-06-16,6210
00665L,富邦�琤肭磪囓�2,497,230,267,新百王,2023-06-19,6210
6116,彩晶,190,64,126,新百王,2023-06-19,6210
00632R,元大台灣50反1,105,7,98,新百王,2023-06-19,6210
3037,欣興,105,10,95,新百王,2023-06-19,6210
6120,達運,186,97,89,新百王,2023-06-19,6210
2104,國際中橡,154,80,74,新百王,2023-06-19,6210
00673R,期元大S＆P原油反1,73,0,73,新百王,2023-06-19,6210
00712,復華富時不動產,87,24,63,新百王,2023-06-19,6210
6153,嘉聯益,73,10,63,新百王,2023-06-19,6210
1609,大亞,90,27,63,新百王,2023-06-19,6210
2324,仁寶,69,18,51,新百王,2023-06-19,6210
4533,協易機,47,0,47,新百王,2023-06-19,6210
1467,南緯,40,0,40,新百王,2023-06-19,6210
2312,金寶,91,56,35,新百王,2023-06-19,6210
3323,加百裕,35,0,35,新百王,2023-06-19,6210
1504,東元,44,9,35,新百王,2023-06-19,6210
6167,久正,34,0,34,新百王,2023-06-19,6210
2337,旺宏,33,0,33,新百王,2023-06-19,6210
00878,國泰永續高股息,39,7,32,新百王,2023-06-19,6210
3162,精確,36,6,30,新百王,2023-06-19,6210
3576,聯合再生,30,0,30,新百王,2023-06-19,6210
2356,英業達,79,49,30,新百王,2023-06-19,6210
5905,南仁湖,32,2,30,新百王,2023-06-19,6210
2609,陽明,49,19,30,新百王,2023-06-19,6210
2330,台積電,32,3,29,新百王,2023-06-19,6210
3032,偉訓,49,20,29,新百王,2023-06-19,6210
2739,寒舍,28,1,27,新百王,2023-06-19,6210
1815,富喬,32,7,25,新百王,2023-06-19,6210
3024,憶聲,30,5,25,新百王,2023-06-19,6210
6202,盛群,25,0,25,新百王,2023-06-19,6210
2014,中鴻,26,2,24,新百王,2023-06-19,6210
1713,國化,61,38,23,新百王,2023-06-19,6210
2498,宏達電,21,0,21,新百王,2023-06-19,6210
2882,國泰金,21,0,21,新百王,2023-06-19,6210
2887E,台新戊特,21,0,21,新百王,2023-06-19,6210
4934,太極,20,0,20,新百王,2023-06-19,6210
1417,嘉裕,25,5,20,新百王,2023-06-19,6210
1471,首利,18,0,18,新百王,2023-06-19,6210
8930,青鋼,17,0,17,新百王,2023-06-19,6210
00753L,中信中國50正2,29,12,17,新百王,2023-06-19,6210
5301,寶得利,16,0,16,新百王,2023-06-19,6210
2109,華豐,17,1,16,新百王,2023-06-19,6210
3520,華盈,16,0,16,新百王,2023-06-19,6210
3264,欣銓,22,7,15,新百王,2023-06-19,6210
1513,中興電,106,91,15,新百王,2023-06-19,6210
4729,熒茂,15,0,15,新百王,2023-06-19,6210
00713,元大台灣高息低波,16,2,14,新百王,2023-06-19,6210
2608,嘉里大榮,14,0,14,新百王,2023-06-19,6210
00687B,國泰20年美債,13,0,13,新百王,2023-06-19,6210
6446,藥華藥,13,0,13,新百王,2023-06-19,6210
00665L,富邦�琤肭磪囓�2,411,176,235,新百王,2023-06-20,6210
2618,長榮航,211,97,114,新百王,2023-06-20,6210
6153,嘉聯益,72,4,68,新百王,2023-06-20,6210
6120,達運,51,10,41,新百王,2023-06-20,6210
2414,精技,38,0,38,新百王,2023-06-20,6210
2409,友達,42,4,38,新百王,2023-06-20,6210
5512,力麒,81,43,38,新百王,2023-06-20,6210
6016,康和證,31,0,31,新百王,2023-06-20,6210
2634,漢翔,278,249,29,新百王,2023-06-20,6210
00882,中信中國高股息,28,3,25,新百王,2023-06-20,6210
1713,國化,52,27,25,新百王,2023-06-20,6210
9919,康那香,30,5,25,新百王,2023-06-20,6210
8105,凌巨,23,0,23,新百王,2023-06-20,6210
2421,建準,24,2,22,新百王,2023-06-20,6210
4114,健喬,26,5,21,新百王,2023-06-20,6210
2104,國際中橡,151,130,21,新百王,2023-06-20,6210
2427,三商電,41,20,21,新百王,2023-06-20,6210
00706L,期元大S＆P日圓正2,20,0,20,新百王,2023-06-20,6210
3013,晟銘電,21,2,19,新百王,2023-06-20,6210
1337,再生-KY,25,6,19,新百王,2023-06-20,6210
8210,勤誠,42,23,19,新百王,2023-06-20,6210
2458,義隆,18,0,18,新百王,2023-06-20,6210
5871,中租-KY,21,3,18,新百王,2023-06-20,6210
3481,群創,167,149,18,新百王,2023-06-20,6210
8222,寶一,47,30,17,新百王,2023-06-20,6210
6282,康舒,18,1,17,新百王,2023-06-20,6210
3035,智原,37,22,15,新百王,2023-06-20,6210
5009,榮剛,16,1,15,新百王,2023-06-20,6210
2883,凱基金,15,0,15,新百王,2023-06-20,6210
2515,中工,35,20,15,新百王,2023-06-20,6210
00640L,富邦日本正2,15,0,15,新百王,2023-06-20,6210
2609,陽明,17,2,15,新百王,2023-06-20,6210
6024,群益期,21,6,15,新百王,2023-06-20,6210
1734,杏輝,13,0,13,新百王,2023-06-20,6210
00929,復華台灣科技優息,14,1,13,新百王,2023-06-20,6210
3706,神達,26,13,13,新百王,2023-06-20,6210
3162,精確,13,0,13,新百王,2023-06-20,6210
3049,精金,13,0,13,新百王,2023-06-20,6210
2344,華邦電,14,1,13,新百王,2023-06-20,6210
0050,元大台灣50,24,12,12,新百王,2023-06-20,6210
1789,神隆,12,0,12,新百王,2023-06-20,6210
6122,擎邦,18,6,12,新百王,2023-06-20,6210
3071,協禧,13,2,11,新百王,2023-06-20,6210
2382,廣達,56,45,11,新百王,2023-06-20,6210
4106,雃博,16,5,11,新百王,2023-06-20,6210
4904,遠傳,19,8,11,新百王,2023-06-20,6210
2739,寒舍,23,13,10,新百王,2023-06-20,6210
1513,中興電,46,36,10,新百王,2023-06-20,6210
2723,美食-KY,11,1,10,新百王,2023-06-20,6210
2929,淘帝-KY,10,0,10,新百王,2023-06-20,6210
3706,神達,229,35,194,新百王,2023-06-21,6210
2610,華航,337,205,132,新百王,2023-06-21,6210
3049,精金,135,8,127,新百王,2023-06-21,6210
3037,欣興,139,34,105,新百王,2023-06-21,6210
3071,協禧,95,6,89,新百王,2023-06-21,6210
00665L,富邦�琤肭磪囓�2,209,132,77,新百王,2023-06-21,6210
1905,華紙,217,145,72,新百王,2023-06-21,6210
1609,大亞,98,27,71,新百王,2023-06-21,6210
00751B,元大AAA至A公司債,70,0,70,新百王,2023-06-21,6210
5469,瀚宇博,69,1,68,新百王,2023-06-21,6210
2409,友達,75,19,56,新百王,2023-06-21,6210
2442,新美齊,40,0,40,新百王,2023-06-21,6210
2358,廷鑫,34,0,34,新百王,2023-06-21,6210
00632R,元大台灣50反1,41,8,33,新百王,2023-06-21,6210
2344,華邦電,32,1,31,新百王,2023-06-21,6210
9919,康那香,30,0,30,新百王,2023-06-21,6210
2809,京城銀,56,32,24,新百王,2023-06-21,6210
2449,京元電子,25,1,24,新百王,2023-06-21,6210
2601,益航,23,0,23,新百王,2023-06-21,6210
00753L,中信中國50正2,42,20,22,新百王,2023-06-21,6210
6282,康舒,28,8,20,新百王,2023-06-21,6210
2887E,台新戊特,20,0,20,新百王,2023-06-21,6210
1444,力麗,20,0,20,新百王,2023-06-21,6210
2748,雲品,71,52,19,新百王,2023-06-21,6210
6550,北極星藥業-KY,20,1,19,新百王,2023-06-21,6210
2371,大同,88,69,19,新百王,2023-06-21,6210
4555,氣立,18,0,18,新百王,2023-06-21,6210
00675L,富邦臺灣加權正2,17,0,17,新百王,2023-06-21,6210
4114,健喬,26,10,16,新百王,2023-06-21,6210
3027,盛達,78,62,16,新百王,2023-06-21,6210
5258,虹堡,62,47,15,新百王,2023-06-21,6210
5512,力麒,16,2,14,新百王,2023-06-21,6210
3207,耀勝,13,0,13,新百王,2023-06-21,6210
4106,雃博,18,5,13,新百王,2023-06-21,6210
1471,首利,18,6,12,新百王,2023-06-21,6210
1513,中興電,43,31,12,新百王,2023-06-21,6210
5426,振發,18,6,12,新百王,2023-06-21,6210
2645,長榮航太,12,1,11,新百王,2023-06-21,6210
3105,穩懋,20,9,11,新百王,2023-06-21,6210
3481,群創,133,122,11,新百王,2023-06-21,6210
6425,易發,10,0,10,新百王,2023-06-21,6210
1217,愛之味,46,36,10,新百王,2023-06-21,6210
2504,國產,10,0,10,新百王,2023-06-21,6210
1314,中石化,10,0,10,新百王,2023-06-21,6210
00882,中信中國高股息,10,0,10,新百王,2023-06-21,6210
00688L,國泰20年美債正2,10,0,10,新百王,2023-06-21,6210
1734,杏輝,10,0,10,新百王,2023-06-21,6210
00669R,國泰美國道瓊反1,10,0,10,新百王,2023-06-21,6210
2892,第一金,10,0,10,新百王,2023-06-21,6210
3059,華晶科,10,0,10,新百王,2023-06-21,6210
2359,所羅門,351,0,351,新百王,2023-06-26,6210
00637L,元大滬深300正2,306,17,289,新百王,2023-06-26,6210
2412,中華電,131,36,95,新百王,2023-06-26,6210
3715,定穎投控,149,65,84,新百王,2023-06-26,6210
6695,芯鼎,85,3,82,新百王,2023-06-26,6210
2887E,台新戊特,69,0,69,新百王,2023-06-26,6210
6116,彩晶,67,0,67,新百王,2023-06-26,6210
3032,偉訓,90,23,67,新百王,2023-06-26,6210
6120,達運,149,83,66,新百王,2023-06-26,6210
2489,瑞軒,60,0,60,新百王,2023-06-26,6210
2812,台中銀,60,0,60,新百王,2023-06-26,6210
2609,陽明,66,11,55,新百王,2023-06-26,6210
6168,宏齊,50,0,50,新百王,2023-06-26,6210
6163,華電網,50,0,50,新百王,2023-06-26,6210
2427,三商電,144,95,49,新百王,2023-06-26,6210
00715L,期街口布蘭特正2,65,20,45,新百王,2023-06-26,6210
3481,群創,148,105,43,新百王,2023-06-26,6210
1471,首利,46,4,42,新百王,2023-06-26,6210
00675L,富邦臺灣加權正2,40,1,39,新百王,2023-06-26,6210
2382,廣達,80,46,34,新百王,2023-06-26,6210
2882,國泰金,34,0,34,新百王,2023-06-26,6210
00640L,富邦日本正2,33,0,33,新百王,2023-06-26,6210
1103,嘉泥,30,0,30,新百王,2023-06-26,6210
8105,凌巨,35,8,27,新百王,2023-06-26,6210
6244,茂迪,27,0,27,新百王,2023-06-26,6210
00706L,期元大S＆P日圓正2,26,0,26,新百王,2023-06-26,6210
1605,華新,25,0,25,新百王,2023-06-26,6210
2634,漢翔,94,69,25,新百王,2023-06-26,6210
1522,堤維西,50,25,25,新百王,2023-06-26,6210
2301,光寶科,59,35,24,新百王,2023-06-26,6210
5512,力麒,36,12,24,新百王,2023-06-26,6210
2601,益航,23,0,23,新百王,2023-06-26,6210
2332,友訊,30,8,22,新百王,2023-06-26,6210
2888,新光金,30,8,22,新百王,2023-06-26,6210
2515,中工,20,0,20,新百王,2023-06-26,6210
1460,宏遠,20,0,20,新百王,2023-06-26,6210
1219,福壽,20,0,20,新百王,2023-06-26,6210
8358,金居,24,4,20,新百王,2023-06-26,6210
5009,榮剛,36,16,20,新百王,2023-06-26,6210
2442,新美齊,19,0,19,新百王,2023-06-26,6210
6203,海韻電,49,30,19,新百王,2023-06-26,6210
2023,燁輝,20,1,19,新百王,2023-06-26,6210
1337,再生-KY,21,3,18,新百王,2023-06-26,6210
2303,聯電,29,11,18,新百王,2023-06-26,6210
6111,大宇資,38,20,18,新百王,2023-06-26,6210
00895,富邦未來車,17,0,17,新百王,2023-06-26,6210
6024,群益期,17,0,17,新百王,2023-06-26,6210
4157,太景*-KY,16,0,16,新百王,2023-06-26,6210
8016,矽創,16,0,16,新百王,2023-06-26,6210
00882,中信中國高股息,18,3,15,新百王,2023-06-26,6210
2356,英業達,558,19,539,新百王,2023-06-27,6210
2303,聯電,437,4,433,新百王,2023-06-27,6210
2618,長榮航,361,104,257,新百王,2023-06-27,6210
2610,華航,541,371,170,新百王,2023-06-27,6210
2890,永豐金,91,0,91,新百王,2023-06-27,6210
3032,偉訓,107,18,89,新百王,2023-06-27,6210
2340,台亞,125,41,84,新百王,2023-06-27,6210
1471,首利,94,12,82,新百王,2023-06-27,6210
2408,南亞科,82,1,81,新百王,2023-06-27,6210
3206,志豐,68,1,67,新百王,2023-06-27,6210
2891,中信金,58,0,58,新百王,2023-06-27,6210
2344,華邦電,56,3,53,新百王,2023-06-27,6210
00706L,期元大S＆P日圓正2,46,0,46,新百王,2023-06-27,6210
2883,凱基金,45,1,44,新百王,2023-06-27,6210
2882,國泰金,51,7,44,新百王,2023-06-27,6210
1742,台蠟,42,2,40,新百王,2023-06-27,6210
1605,華新,49,10,39,新百王,2023-06-27,6210
2104,國際中橡,53,15,38,新百王,2023-06-27,6210
2605,新興,39,2,37,新百王,2023-06-27,6210
3567,逸昌,31,0,31,新百王,2023-06-27,6210
2358,廷鑫,34,4,30,新百王,2023-06-27,6210
2206,三陽工業,45,17,28,新百王,2023-06-27,6210
6215,和椿,27,0,27,新百王,2023-06-27,6210
00895,富邦未來車,30,3,27,新百王,2023-06-27,6210
6207,雷科,26,0,26,新百王,2023-06-27,6210
6191,精成科,31,6,25,新百王,2023-06-27,6210
1734,杏輝,28,3,25,新百王,2023-06-27,6210
00715L,期街口布蘭特正2,85,60,25,新百王,2023-06-27,6210
2405,輔信,43,20,23,新百王,2023-06-27,6210
3481,群創,139,116,23,新百王,2023-06-27,6210
3093,港建*,22,0,22,新百王,2023-06-27,6210
00675L,富邦臺灣加權正2,21,0,21,新百王,2023-06-27,6210
4563,百德,26,5,21,新百王,2023-06-27,6210
5512,力麒,59,38,21,新百王,2023-06-27,6210
0056,元大高股息,36,15,21,新百王,2023-06-27,6210
1611,中電,20,0,20,新百王,2023-06-27,6210
1721,三晃,20,0,20,新百王,2023-06-27,6210
1529,樂事綠能,18,0,18,新百王,2023-06-27,6210
1612,宏泰,18,0,18,新百王,2023-06-27,6210
2414,精技,17,0,17,新百王,2023-06-27,6210
1514,亞力,28,11,17,新百王,2023-06-27,6210
2368,金像電,19,3,16,新百王,2023-06-27,6210
1789,神隆,17,2,15,新百王,2023-06-27,6210
00640L,富邦日本正2,15,0,15,新百王,2023-06-27,6210
3704,合勤控,14,0,14,新百王,2023-06-27,6210
1802,台玻,20,6,14,新百王,2023-06-27,6210
3011,今皓,13,0,13,新百王,2023-06-27,6210
4503,金雨,59,47,12,新百王,2023-06-27,6210
8088,品安,12,0,12,新百王,2023-06-27,6210
4726,永昕,13,1,12,新百王,2023-06-27,6210
2356,英業達,543,46,497,新百王,2023-06-28,6210
00715L,期街口布蘭特正2,267,5,262,新百王,2023-06-28,6210
4120,友華,105,10,95,新百王,2023-06-28,6210
3206,志豐,87,3,84,新百王,2023-06-28,6210
00751B,元大AAA至A公司債,95,20,75,新百王,2023-06-28,6210
4916,事欣科,73,2,71,新百王,2023-06-28,6210
1301,台塑,66,0,66,新百王,2023-06-28,6210
1605,華新,86,23,63,新百王,2023-06-28,6210
3032,偉訓,45,2,43,新百王,2023-06-28,6210
1471,首利,45,2,43,新百王,2023-06-28,6210
2536,宏普,34,1,33,新百王,2023-06-28,6210
4207,環泰,30,0,30,新百王,2023-06-28,6210
1789,神隆,32,3,29,新百王,2023-06-28,6210
3576,聯合再生,26,0,26,新百王,2023-06-28,6210
6191,精成科,26,0,26,新百王,2023-06-28,6210
1532,勤美,67,42,25,新百王,2023-06-28,6210
2609,陽明,39,15,24,新百王,2023-06-28,6210
6188,廣明,28,4,24,新百王,2023-06-28,6210
00929,復華台灣科技優息,26,2,24,新百王,2023-06-28,6210
4147,中裕,23,1,22,新百王,2023-06-28,6210
4977,眾達-KY,25,3,22,新百王,2023-06-28,6210
9904,寶成,20,0,20,新百王,2023-06-28,6210
1409,新纖,20,0,20,新百王,2023-06-28,6210
00675L,富邦臺灣加權正2,20,0,20,新百王,2023-06-28,6210
8034,榮群,18,0,18,新百王,2023-06-28,6210
00642U,期元大S＆P石油,17,0,17,新百王,2023-06-28,6210
6126,信音,15,0,15,新百王,2023-06-28,6210
2358,廷鑫,16,1,15,新百王,2023-06-28,6210
1504,東元,22,7,15,新百王,2023-06-28,6210
1802,台玻,17,2,15,新百王,2023-06-28,6210
2906,高林,20,6,14,新百王,2023-06-28,6210
3363,上詮,17,3,14,新百王,2023-06-28,6210
5469,瀚宇博,15,2,13,新百王,2023-06-28,6210
4106,雃博,30,17,13,新百王,2023-06-28,6210
6024,群益期,13,0,13,新百王,2023-06-28,6210
1444,力麗,12,0,12,新百王,2023-06-28,6210
1742,台蠟,12,0,12,新百王,2023-06-28,6210
1519,華城,21,9,12,新百王,2023-06-28,6210
8076,伍豐,19,7,12,新百王,2023-06-28,6210
2340,台亞,37,26,11,新百王,2023-06-28,6210
2337,旺宏,11,0,11,新百王,2023-06-28,6210
2425,承啟,11,0,11,新百王,2023-06-28,6210
1907,永豐餘,11,0,11,新百王,2023-06-28,6210
6244,茂迪,17,6,11,新百王,2023-06-28,6210
2634,漢翔,42,31,11,新百王,2023-06-28,6210
2884,玉山金,10,0,10,新百王,2023-06-28,6210
5371,中光電,13,3,10,新百王,2023-06-28,6210
6877,鏵友益,10,0,10,新百王,2023-06-28,6210
2013,中鋼構,10,0,10,新百王,2023-06-28,6210
00688L,國泰20年美債正2,10,0,10,新百王,2023-06-28,6210
1528,恩德,135,58,77,新百王,2023-06-29,6210
4414,如興,68,0,68,新百王,2023-06-29,6210
3481,群創,117,55,62,新百王,2023-06-29,6210
00751B,元大AAA至A公司債,76,23,53,新百王,2023-06-29,6210
1904,正隆,62,11,51,新百王,2023-06-29,6210
5381,合正,50,0,50,新百王,2023-06-29,6210
2618,長榮航,175,130,45,新百王,2023-06-29,6210
1504,東元,58,16,42,新百王,2023-06-29,6210
1219,福壽,42,0,42,新百王,2023-06-29,6210
2312,金寶,39,0,39,新百王,2023-06-29,6210
2610,華航,115,76,39,新百王,2023-06-29,6210
6191,精成科,42,3,39,新百王,2023-06-29,6210
2412,中華電,38,0,38,新百王,2023-06-29,6210
2317,鴻海,90,54,36,新百王,2023-06-29,6210
6446,藥華藥,38,4,34,新百王,2023-06-29,6210
00632R,元大台灣50反1,239,206,33,新百王,2023-06-29,6210
1802,台玻,31,0,31,新百王,2023-06-29,6210
3706,神達,31,1,30,新百王,2023-06-29,6210
8105,凌巨,30,0,30,新百王,2023-06-29,6210
8936,國統,33,5,28,新百王,2023-06-29,6210
00753L,中信中國50正2,28,3,25,新百王,2023-06-29,6210
3038,全台,89,65,24,新百王,2023-06-29,6210
00675L,富邦臺灣加權正2,23,0,23,新百王,2023-06-29,6210
2603,長榮,45,23,22,新百王,2023-06-29,6210
6005,群益證,38,15,23,新百王,2023-06-29,6210
6116,彩晶,76,54,22,新百王,2023-06-29,6210
6216,居易,22,0,22,新百王,2023-06-29,6210
2303,聯電,37,17,20,新百王,2023-06-29,6210
00882,中信中國高股息,20,0,20,新百王,2023-06-29,6210
2104,國際中橡,23,3,20,新百王,2023-06-29,6210
6790,永豐實,22,2,20,新百王,2023-06-29,6210
1313,聯成,20,1,19,新百王,2023-06-29,6210
2419,仲琦,164,145,19,新百王,2023-06-29,6210
1909,榮成,22,5,17,新百王,2023-06-29,6210
4555,氣立,17,0,17,新百王,2023-06-29,6210
4130,健亞,29,13,16,新百王,2023-06-29,6210
2609,陽明,22,7,15,新百王,2023-06-29,6210
00706L,期元大S＆P日圓正2,15,0,15,新百王,2023-06-29,6210
6242,立康,15,0,15,新百王,2023-06-29,6210
5512,力麒,35,20,15,新百王,2023-06-29,6210
8033,雷虎,16,2,14,新百王,2023-06-29,6210
8210,勤誠,45,32,13,新百王,2023-06-29,6210
4121,優盛,34,21,13,新百王,2023-06-29,6210
00680L,元大美債20正2,27,15,12,新百王,2023-06-29,6210
1463,強盛新,12,0,12,新百王,2023-06-29,6210
8093,保銳,12,0,12,新百王,2023-06-29,6210
4746,台耀,23,11,12,新百王,2023-06-29,6210
2352,佳世達,12,1,11,新百王,2023-06-29,6210
3715,定穎投控,169,158,11,新百王,2023-06-29,6210
1605,華新,22,11,11,新百王,2023-06-29,6210
00720B,元大投資級公司債,155,10,145,新百王,2023-06-30,6210
00680L,元大美債20正2,101,0,101,新百王,2023-06-30,6210
4207,環泰,100,0,100,新百王,2023-06-30,6210
6161,捷波,71,1,70,新百王,2023-06-30,6210
0056,元大高股息,66,11,55,新百王,2023-06-30,6210
8105,凌巨,45,0,45,新百王,2023-06-30,6210
1806,冠軍,42,0,42,新百王,2023-06-30,6210
6005,群益證,83,51,32,新百王,2023-06-30,6210
2601,益航,30,0,30,新百王,2023-06-30,6210
00673R,期元大S＆P原油反1,30,0,30,新百王,2023-06-30,6210
2607,榮運,68,41,27,新百王,2023-06-30,6210
1711,永光,27,0,27,新百王,2023-06-30,6210
2883,凱基金,45,20,25,新百王,2023-06-30,6210
3035,智原,41,16,25,新百王,2023-06-30,6210
2884,玉山金,25,2,23,新百王,2023-06-30,6210
3715,定穎投控,43,20,23,新百王,2023-06-30,6210
2845,遠東銀,22,0,22,新百王,2023-06-30,6210
6266,泰詠,25,3,22,新百王,2023-06-30,6210
3481,群創,31,9,22,新百王,2023-06-30,6210
00640L,富邦日本正2,21,0,21,新百王,2023-06-30,6210
2323,中環,21,0,21,新百王,2023-06-30,6210
0050,元大台灣50,35,15,20,新百王,2023-06-30,6210
1301,台塑,22,2,20,新百王,2023-06-30,6210
2023,燁輝,20,0,20,新百王,2023-06-30,6210
00688L,國泰20年美債正2,20,0,20,新百王,2023-06-30,6210
4147,中裕,26,6,20,新百王,2023-06-30,6210
6770,力積電,23,4,19,新百王,2023-06-30,6210
4977,眾達-KY,21,2,19,新百王,2023-06-30,6210
6116,彩晶,73,54,19,新百王,2023-06-30,6210
8234,新漢,18,0,18,新百王,2023-06-30,6210
2303,聯電,35,17,18,新百王,2023-06-30,6210
3356,奇偶,38,20,18,新百王,2023-06-30,6210
1736,喬山,20,2,18,新百王,2023-06-30,6210
00679B,元大美債20年,15,0,15,新百王,2023-06-30,6210
4175,杏一,27,12,15,新百王,2023-06-30,6210
9902,台火,15,0,15,新百王,2023-06-30,6210
00712,復華富時不動產,35,20,15,新百王,2023-06-30,6210
3078,僑威,29,14,15,新百王,2023-06-30,6210
2809,京城銀,15,0,15,新百王,2023-06-30,6210
4157,太景*-KY,43,29,14,新百王,2023-06-30,6210
4105,東洋,13,0,13,新百王,2023-06-30,6210
5009,榮剛,34,21,13,新百王,2023-06-30,6210
2882,國泰金,15,2,13,新百王,2023-06-30,6210
2344,華邦電,25,13,12,新百王,2023-06-30,6210
00631L,元大台灣50正2,19,7,12,新百王,2023-06-30,6210
00713,元大台灣高息低波,11,0,11,新百王,2023-06-30,6210
5289,宜鼎,14,3,11,新百王,2023-06-30,6210
2353,宏��,11,0,11,新百王,2023-06-30,6210
1605,華新,41,30,11,新百王,2023-06-30,6210
3580,友威科,11,0,11,新百王,2023-06-30,6210
00706L,期元大S＆P日圓正2,132,0,132,新百王,2023-07-03,6210
8105,凌巨,105,1,104,新百王,2023-07-03,6210
2356,英業達,111,30,81,新百王,2023-07-03,6210
00720B,元大投資級公司債,75,1,74,新百王,2023-07-03,6210
0056,元大高股息,95,21,74,新百王,2023-07-03,6210
00878,國泰永續高股息,73,12,61,新百王,2023-07-03,6210
2023,燁輝,60,0,60,新百王,2023-07-03,6210
2609,陽明,149,100,49,新百王,2023-07-03,6210
3596,智易,51,5,46,新百王,2023-07-03,6210
3481,群創,76,30,46,新百王,2023-07-03,6210
6239,力成,45,0,45,新百王,2023-07-03,6210
4532,瑞智,52,8,44,新百王,2023-07-03,6210
6161,捷波,58,15,43,新百王,2023-07-03,6210
8085,福華,41,0,41,新百王,2023-07-03,6210
2358,廷鑫,39,0,39,新百王,2023-07-03,6210
2312,金寶,35,3,32,新百王,2023-07-03,6210
4916,事欣科,42,11,31,新百王,2023-07-03,6210
00929,復華台灣科技優息,31,0,31,新百王,2023-07-03,6210
3356,奇偶,51,21,30,新百王,2023-07-03,6210
2601,益航,30,0,30,新百王,2023-07-03,6210
2211,長榮鋼,30,0,30,新百王,2023-07-03,6210
8936,國統,30,1,29,新百王,2023-07-03,6210
2324,仁寶,40,12,28,新百王,2023-07-03,6210
4157,太景*-KY,43,19,24,新百王,2023-07-03,6210
3338,泰碩,24,1,23,新百王,2023-07-03,6210
6446,藥華藥,23,0,23,新百王,2023-07-03,6210
6142,友勁,28,5,23,新百王,2023-07-03,6210
1304,台聚,51,29,22,新百王,2023-07-03,6210
1201,味全,22,0,22,新百王,2023-07-03,6210
1314,中石化,21,0,21,新百王,2023-07-03,6210
00673R,期元大S＆P原油反1,21,0,21,新百王,2023-07-03,6210
2303,聯電,28,8,20,新百王,2023-07-03,6210
1104,環泥,20,0,20,新百王,2023-07-03,6210
2723,美食-KY,20,0,20,新百王,2023-07-03,6210
1609,大亞,39,19,20,新百王,2023-07-03,6210
2405,輔信,19,0,19,新百王,2023-07-03,6210
1802,台玻,19,0,19,新百王,2023-07-03,6210
2486,一詮,32,14,18,新百王,2023-07-03,6210
2107,厚生,18,0,18,新百王,2023-07-03,6210
2368,金像電,39,23,16,新百王,2023-07-03,6210
6134,萬旭,16,0,16,新百王,2023-07-03,6210
1525,江申,16,0,16,新百王,2023-07-03,6210
2349,錸德,16,0,16,新百王,2023-07-03,6210
1905,華紙,63,48,15,新百王,2023-07-03,6210
4106,雃博,38,23,15,新百王,2023-07-03,6210
1795,美時,24,10,14,新百王,2023-07-03,6210
2035,唐榮,14,0,14,新百王,2023-07-03,6210
8926,台汽電,14,0,14,新百王,2023-07-03,6210
4927,泰鼎-KY,13,0,13,新百王,2023-07-03,6210
1789,神隆,14,1,13,新百王,2023-07-03,6210
3706,神達,235,61,174,新百王,2023-07-04,6210
2317,鴻海,182,33,149,新百王,2023-07-04,6210
2883,凱基金,162,35,127,新百王,2023-07-04,6210
6285,啟��,124,21,103,新百王,2023-07-04,6210
00671R,富邦NASDAQ反1,100,0,100,新百王,2023-07-04,6210
2359,所羅門,90,3,87,新百王,2023-07-04,6210
4157,太景*-KY,84,2,82,新百王,2023-07-04,6210
0056,元大高股息,96,29,67,新百王,2023-07-04,6210
00676R,富邦臺灣加權反1,60,0,60,新百王,2023-07-04,6210
2371,大同,85,28,57,新百王,2023-07-04,6210
00722B,群益投資級電信債,50,0,50,新百王,2023-07-04,6210
00632R,元大台灣50反1,55,15,40,新百王,2023-07-04,6210
2603,長榮,132,93,39,新百王,2023-07-04,6210
00679B,元大美債20年,37,0,37,新百王,2023-07-04,6210
9939,宏全,40,4,36,新百王,2023-07-04,6210
6161,捷波,36,1,35,新百王,2023-07-04,6210
00882,中信中國高股息,34,4,30,新百王,2023-07-04,6210
2884,玉山金,30,1,29,新百王,2023-07-04,6210
5512,力麒,57,28,29,新百王,2023-07-04,6210
8093,保銳,52,24,28,新百王,2023-07-04,6210
3481,群創,30,2,28,新百王,2023-07-04,6210
2888,新光金,27,0,27,新百王,2023-07-04,6210
1471,首利,30,4,26,新百王,2023-07-04,6210
2610,華航,61,35,26,新百王,2023-07-04,6210
00905,FT臺灣Smart,25,0,25,新百王,2023-07-04,6210
2002,中鋼,27,3,24,新百王,2023-07-04,6210
2449,京元電子,32,9,23,新百王,2023-07-04,6210
2520,冠德,23,0,23,新百王,2023-07-04,6210
2352,佳世達,23,1,22,新百王,2023-07-04,6210
1522,堤維西,78,56,22,新百王,2023-07-04,6210
2707,晶華,20,0,20,新百王,2023-07-04,6210
5009,榮剛,63,43,20,新百王,2023-07-04,6210
00753L,中信中國50正2,20,0,20,新百王,2023-07-04,6210
00680L,元大美債20正2,30,10,20,新百王,2023-07-04,6210
1605,華新,19,1,18,新百王,2023-07-04,6210
6112,邁達特,41,24,17,新百王,2023-07-04,6210
2107,厚生,16,0,16,新百王,2023-07-04,6210
6683,雍智科技,16,0,16,新百王,2023-07-04,6210
6176,瑞儀,20,4,16,新百王,2023-07-04,6210
3617,碩天,15,0,15,新百王,2023-07-04,6210
2880,華南金,14,0,14,新百王,2023-07-04,6210
00631L,元大台灣50正2,17,3,14,新百王,2023-07-04,6210
1617,榮星,13,0,13,新百王,2023-07-04,6210
2634,漢翔,16,3,13,新百王,2023-07-04,6210
1504,東元,49,37,12,新百王,2023-07-04,6210
6451,訊芯-KY,45,33,12,新百王,2023-07-04,6210
1907,永豐餘,17,5,12,新百王,2023-07-04,6210
1802,台玻,12,0,12,新百王,2023-07-04,6210
4906,正文,15,3,12,新百王,2023-07-04,6210
2809,京城銀,12,0,12,新百王,2023-07-04,6210
2867,三商壽,412,20,392,新百王,2023-07-05,6210
2618,長榮航,606,393,213,新百王,2023-07-05,6210
2609,陽明,220,77,143,新百王,2023-07-05,6210
00665L,富邦�琤肭磪囓�2,275,148,127,新百王,2023-07-05,6210
2356,英業達,233,136,97,新百王,2023-07-05,6210
00637L,元大滬深300正2,108,21,87,新百王,2023-07-05,6210
3078,僑威,108,33,75,新百王,2023-07-05,6210
6147,頎邦,67,0,67,新百王,2023-07-05,6210
2645,長榮航太,65,6,59,新百王,2023-07-05,6210
2317,鴻海,173,116,57,新百王,2023-07-05,6210
0056,元大高股息,57,6,51,新百王,2023-07-05,6210
3706,神達,129,81,48,新百王,2023-07-05,6210
00673R,期元大S＆P原油反1,40,0,40,新百王,2023-07-05,6210
4904,遠傳,40,2,38,新百王,2023-07-05,6210
2887E,台新戊特,34,0,34,新百王,2023-07-05,6210
2419,仲琦,68,37,31,新百王,2023-07-05,6210
1504,東元,33,3,30,新百王,2023-07-05,6210
8105,凌巨,30,0,30,新百王,2023-07-05,6210
2427,三商電,123,93,30,新百王,2023-07-05,6210
2486,一詮,35,6,29,新百王,2023-07-05,6210
00929,復華台灣科技優息,29,0,29,新百王,2023-07-05,6210
6282,康舒,146,119,27,新百王,2023-07-05,6210
3481,群創,27,0,27,新百王,2023-07-05,6210
4916,事欣科,26,0,26,新百王,2023-07-05,6210
2614,東森,30,5,25,新百王,2023-07-05,6210
1219,福壽,22,0,22,新百王,2023-07-05,6210
1762,中化生,21,1,20,新百王,2023-07-05,6210
1611,中電,54,35,19,新百王,2023-07-05,6210
6005,群益證,19,0,19,新百王,2023-07-05,6210
6171,大城地產,19,0,19,新百王,2023-07-05,6210
4526,東台,26,8,18,新百王,2023-07-05,6210
2436,偉詮電,20,2,18,新百王,2023-07-05,6210
3090,日電貿,18,0,18,新百王,2023-07-05,6210
3711,日月光投控,27,10,17,新百王,2023-07-05,6210
1789,神隆,16,0,16,新百王,2023-07-05,6210
1513,中興電,18,2,16,新百王,2023-07-05,6210
1477,聚陽,17,2,15,新百王,2023-07-05,6210
6609,瀧澤科,15,0,15,新百王,2023-07-05,6210
1522,堤維西,28,13,15,新百王,2023-07-05,6210
00706L,期元大S＆P日圓正2,15,0,15,新百王,2023-07-05,6210
00662,富邦NASDAQ,15,0,15,新百王,2023-07-05,6210
1709,和益,14,0,14,新百王,2023-07-05,6210
2023,燁輝,21,7,14,新百王,2023-07-05,6210
2312,金寶,30,17,13,新百王,2023-07-05,6210
1514,亞力,25,12,13,新百王,2023-07-05,6210
00753L,中信中國50正2,39,26,13,新百王,2023-07-05,6210
4960,誠美材,22,9,13,新百王,2023-07-05,6210
3047,訊舟,14,1,13,新百王,2023-07-05,6210
3715,定穎投控,372,359,13,新百王,2023-07-05,6210
2303,聯電,14,2,12,新百王,2023-07-05,6210
2890,永豐金,179,15,164,新百王,2023-07-06,6210
00665L,富邦�琤肭磪囓�2,181,30,151,新百王,2023-07-06,6210
6005,群益證,144,4,140,新百王,2023-07-06,6210
00890B,凱基ESG BBB債,135,0,135,新百王,2023-07-06,6210
00680L,元大美債20正2,156,23,133,新百王,2023-07-06,6210
00720B,元大投資級公司債,100,0,100,新百王,2023-07-06,6210
4414,如興,90,0,90,新百王,2023-07-06,6210
00650L,復華香港正2,70,0,70,新百王,2023-07-06,6210
2883,凱基金,125,59,66,新百王,2023-07-06,6210
4533,協易機,62,0,62,新百王,2023-07-06,6210
5009,榮剛,65,3,62,新百王,2023-07-06,6210
00753L,中信中國50正2,66,7,59,新百王,2023-07-06,6210
00919,群益台灣精選高息,55,4,51,新百王,2023-07-06,6210
0050,元大台灣50,64,15,49,新百王,2023-07-06,6210
2436,偉詮電,63,14,49,新百王,2023-07-06,6210
00878,國泰永續高股息,74,25,49,新百王,2023-07-06,6210
6116,彩晶,204,155,49,新百王,2023-07-06,6210
5864,致和證,62,14,48,新百王,2023-07-06,6210
00679B,元大美債20年,47,0,47,新百王,2023-07-06,6210
4566,時碩工業,57,18,39,新百王,2023-07-06,6210
2369,菱生,90,51,39,新百王,2023-07-06,6210
6275,元山,40,1,39,新百王,2023-07-06,6210
3032,偉訓,38,0,38,新百王,2023-07-06,6210
6223,旺矽,46,12,34,新百王,2023-07-06,6210
2618,長榮航,166,134,32,新百王,2023-07-06,6210
2317,鴻海,47,17,30,新百王,2023-07-06,6210
4916,事欣科,30,0,30,新百王,2023-07-06,6210
6153,嘉聯益,31,2,29,新百王,2023-07-06,6210
00757,統一FANG+,28,0,28,新百王,2023-07-06,6210
2002,中鋼,28,1,27,新百王,2023-07-06,6210
1611,中電,56,29,27,新百王,2023-07-06,6210
8011,台通,31,5,26,新百王,2023-07-06,6210
2891,中信金,45,20,25,新百王,2023-07-06,6210
3576,聯合再生,24,0,24,新百王,2023-07-06,6210
4744,皇將,30,6,24,新百王,2023-07-06,6210
00687B,國泰20年美債,22,0,22,新百王,2023-07-06,6210
00637L,元大滬深300正2,46,24,22,新百王,2023-07-06,6210
1609,大亞,58,37,21,新百王,2023-07-06,6210
4736,泰博,21,0,21,新百王,2023-07-06,6210
2884,玉山金,24,3,21,新百王,2023-07-06,6210
00673R,期元大S＆P原油反1,21,0,21,新百王,2023-07-06,6210
00722B,群益投資級電信債,20,0,20,新百王,2023-07-06,6210
2427,三商電,23,3,20,新百王,2023-07-06,6210
2303,聯電,30,10,20,新百王,2023-07-06,6210
2330,台積電,31,11,20,新百王,2023-07-06,6210
2880,華南金,19,0,19,新百王,2023-07-06,6210
3055,蔚華科,18,0,18,新百王,2023-07-06,6210
3689,湧德,46,28,18,新百王,2023-07-06,6210
1736,喬山,27,10,17,新百王,2023-07-06,6210
6285,啟��,35,18,17,新百王,2023-07-06,6210
00637L,元大滬深300正2,134,1,133,新百王,2023-07-07,6210
2380,虹光,111,0,111,新百王,2023-07-07,6210
3715,定穎投控,379,280,99,新百王,2023-07-07,6210
2104,國際中橡,60,4,56,新百王,2023-07-07,6210
00890B,凱基ESG BBB債,56,0,56,新百王,2023-07-07,6210
4533,協易機,87,42,45,新百王,2023-07-07,6210
2890,永豐金,41,0,41,新百王,2023-07-07,6210
3617,碩天,43,3,40,新百王,2023-07-07,6210
2301,光寶科,57,19,38,新百王,2023-07-07,6210
3521,鴻翊,41,4,37,新百王,2023-07-07,6210
1301,台塑,36,0,36,新百王,2023-07-07,6210
3481,群創,139,105,34,新百王,2023-07-07,6210
4108,懷特,34,1,33,新百王,2023-07-07,6210
1611,中電,42,11,31,新百王,2023-07-07,6210
6016,康和證,33,2,31,新百王,2023-07-07,6210
2340,台亞,80,50,30,新百王,2023-07-07,6210
4552,力達-KY,30,0,30,新百王,2023-07-07,6210
2371,大同,54,28,26,新百王,2023-07-07,6210
3207,耀勝,32,7,25,新百王,2023-07-07,6210
2419,仲琦,87,63,24,新百王,2023-07-07,6210
0050,元大台灣50,39,15,24,新百王,2023-07-07,6210
2328,廣宇,24,1,23,新百王,2023-07-07,6210
6116,彩晶,43,20,23,新百王,2023-07-07,6210
00929,復華台灣科技優息,22,0,22,新百王,2023-07-07,6210
00751B,元大AAA至A公司債,21,0,21,新百王,2023-07-07,6210
00688L,國泰20年美債正2,20,0,20,新百王,2023-07-07,6210
00673R,期元大S＆P原油反1,20,0,20,新百王,2023-07-07,6210
2344,華邦電,33,13,20,新百王,2023-07-07,6210
5388,中磊,26,6,20,新百王,2023-07-07,6210
5009,榮剛,55,35,20,新百王,2023-07-07,6210
4919,新唐,20,1,19,新百王,2023-07-07,6210
6120,達運,19,2,17,新百王,2023-07-07,6210
2880,華南金,17,0,17,新百王,2023-07-07,6210
00679B,元大美債20年,16,1,15,新百王,2023-07-07,6210
00712,復華富時不動產,56,42,14,新百王,2023-07-07,6210
3071,協禧,16,2,14,新百王,2023-07-07,6210
2834,臺企銀,14,0,14,新百王,2023-07-07,6210
1609,大亞,37,23,14,新百王,2023-07-07,6210
2468,華經,51,37,14,新百王,2023-07-07,6210
00665L,富邦�琤肭磪囓�2,14,0,14,新百王,2023-07-07,6210
2603,長榮,36,23,13,新百王,2023-07-07,6210
1219,福壽,13,0,13,新百王,2023-07-07,6210
2382,廣達,76,63,13,新百王,2023-07-07,6210
8086,宏捷科,32,19,13,新百王,2023-07-07,6210
4157,太景*-KY,30,17,13,新百王,2023-07-07,6210
8064,東捷,13,0,13,新百王,2023-07-07,6210
2412,中華電,13,0,13,新百王,2023-07-07,6210
6282,康舒,136,124,12,新百王,2023-07-07,6210
1218,泰山,12,0,12,新百王,2023-07-07,6210
00753L,中信中國50正2,35,23,12,新百王,2023-07-07,6210
2356,英業達,1389,10,1379,新百王,2023-07-10,6210
2885,元大金,450,0,450,新百王,2023-07-10,6210
2883,凱基金,172,13,159,新百王,2023-07-10,6210
00665L,富邦�琤肭磪囓�2,96,17,79,新百王,2023-07-10,6210
2441,超豐,74,0,74,新百王,2023-07-10,6210
2834,臺企銀,74,0,74,新百王,2023-07-10,6210
2023,燁輝,64,0,64,新百王,2023-07-10,6210
4533,協易機,74,14,60,新百王,2023-07-10,6210
00673R,期元大S＆P原油反1,71,25,46,新百王,2023-07-10,6210
6005,群益證,45,0,45,新百王,2023-07-10,6210
8076,伍豐,57,18,39,新百王,2023-07-10,6210
3521,鴻翊,40,1,39,新百王,2023-07-10,6210
3715,定穎投控,121,83,38,新百王,2023-07-10,6210
2601,益航,35,0,35,新百王,2023-07-10,6210
3024,憶聲,32,0,32,新百王,2023-07-10,6210
6016,康和證,46,14,32,新百王,2023-07-10,6210
00720B,元大投資級公司債,30,0,30,新百王,2023-07-10,6210
3558,神準,31,3,28,新百王,2023-07-10,6210
2369,菱生,55,27,28,新百王,2023-07-10,6210
1219,福壽,27,0,27,新百王,2023-07-10,6210
00640L,富邦日本正2,27,0,27,新百王,2023-07-10,6210
2414,精技,26,0,26,新百王,2023-07-10,6210
4977,眾達-KY,31,6,25,新百王,2023-07-10,6210
1736,喬山,28,3,25,新百王,2023-07-10,6210
3047,訊舟,25,0,25,新百王,2023-07-10,6210
2358,廷鑫,25,0,25,新百王,2023-07-10,6210
0050,元大台灣50,24,1,23,新百王,2023-07-10,6210
00688L,國泰20年美債正2,23,0,23,新百王,2023-07-10,6210
2324,仁寶,24,1,23,新百王,2023-07-10,6210
5864,致和證,30,7,23,新百王,2023-07-10,6210
2701,萬企,22,0,22,新百王,2023-07-10,6210
2888,新光金,20,0,20,新百王,2023-07-10,6210
5009,榮剛,27,8,19,新百王,2023-07-10,6210
2890,永豐金,94,76,18,新百王,2023-07-10,6210
3607,谷崧,18,0,18,新百王,2023-07-10,6210
6203,海韻電,19,3,16,新百王,2023-07-10,6210
3346,麗清,27,11,16,新百王,2023-07-10,6210
00751B,元大AAA至A公司債,16,0,16,新百王,2023-07-10,6210
5876,上海商銀,28,13,15,新百王,2023-07-10,6210
2489,瑞軒,16,1,15,新百王,2023-07-10,6210
3207,耀勝,16,1,15,新百王,2023-07-10,6210
2208,台船,15,0,15,新百王,2023-07-10,6210
6282,康舒,118,104,14,新百王,2023-07-10,6210
2425,承啟,15,1,14,新百王,2023-07-10,6210
6546,正基,14,0,14,新百王,2023-07-10,6210
6223,旺矽,21,8,13,新百王,2023-07-10,6210
00893,國泰智能電動車,13,0,13,新百王,2023-07-10,6210
00929,復華台灣科技優息,13,0,13,新百王,2023-07-10,6210
3450,聯鈞,14,1,13,新百王,2023-07-10,6210
1337,再生-KY,18,5,13,新百王,2023-07-10,6210
00632R,元大台灣50反1,250,25,225,新百王,2023-07-11,6210
2515,中工,107,0,107,新百王,2023-07-11,6210
00679B,元大美債20年,98,0,98,新百王,2023-07-11,6210
3189,景碩,66,5,61,新百王,2023-07-11,6210
8092,建暐,49,0,49,新百王,2023-07-11,6210
2929,淘帝-KY,40,0,40,新百王,2023-07-11,6210
1217,愛之味,66,26,40,新百王,2023-07-11,6210
2834,臺企銀,73,37,36,新百王,2023-07-11,6210
6288,聯嘉,49,15,34,新百王,2023-07-11,6210
2312,金寶,37,5,32,新百王,2023-07-11,6210
2601,益航,30,0,30,新百王,2023-07-11,6210
1618,合機,29,0,29,新百王,2023-07-11,6210
6285,啟��,72,44,28,新百王,2023-07-11,6210
0050,元大台灣50,38,10,28,新百王,2023-07-11,6210
2618,長榮航,94,67,27,新百王,2023-07-11,6210
6547,高端疫苗,35,8,27,新百王,2023-07-11,6210
6197,佳必琪,27,0,27,新百王,2023-07-11,6210
8210,勤誠,43,19,24,新百王,2023-07-11,6210
4939,亞電,24,0,24,新百王,2023-07-11,6210
2645,長榮航太,32,9,23,新百王,2023-07-11,6210
1609,大亞,48,26,22,新百王,2023-07-11,6210
2609,陽明,31,12,19,新百王,2023-07-11,6210
3521,鴻翊,19,0,19,新百王,2023-07-11,6210
2358,廷鑫,18,0,18,新百王,2023-07-11,6210
4555,氣立,18,0,18,新百王,2023-07-11,6210
4510,高鋒,30,12,18,新百王,2023-07-11,6210
3055,蔚華科,22,5,17,新百王,2023-07-11,6210
1785,光洋科,17,1,16,新百王,2023-07-11,6210
1802,台玻,20,5,15,新百王,2023-07-11,6210
2468,華經,15,0,15,新百王,2023-07-11,6210
8050,廣積,45,30,15,新百王,2023-07-11,6210
1504,東元,22,8,14,新百王,2023-07-11,6210
5876,上海商銀,13,0,13,新百王,2023-07-11,6210
6531,愛普*,21,8,13,新百王,2023-07-11,6210
1101,台泥,15,3,12,新百王,2023-07-11,6210
5009,榮剛,19,7,12,新百王,2023-07-11,6210
6756,威鋒電子,12,0,12,新百王,2023-07-11,6210
8048,德勝,12,0,12,新百王,2023-07-11,6210
1444,力麗,12,0,12,新百王,2023-07-11,6210
9962,有益,12,0,12,新百王,2023-07-11,6210
5243,乙盛-KY,14,3,11,新百王,2023-07-11,6210
4106,雃博,40,29,11,新百王,2023-07-11,6210
2444,兆勁,11,0,11,新百王,2023-07-11,6210
1604,聲寶,42,32,10,新百王,2023-07-11,6210
1108,幸福,10,0,10,新百王,2023-07-11,6210
8049,晶采,10,0,10,新百王,2023-07-11,6210
1736,喬山,16,6,10,新百王,2023-07-11,6210
4956,光鋐,10,0,10,新百王,2023-07-11,6210
3540,曜越,11,1,10,新百王,2023-07-11,6210
3034,聯詠,11,2,9,新百王,2023-07-11,6210
00673R,期元大S＆P原油反1,582,0,582,新百王,2023-07-12,6210
2312,金寶,204,11,193,新百王,2023-07-12,6210
2610,華航,338,151,187,新百王,2023-07-12,6210
6120,達運,163,54,109,新百王,2023-07-12,6210
3049,精金,108,0,108,新百王,2023-07-12,6210
4207,環泰,97,5,92,新百王,2023-07-12,6210
6116,彩晶,133,54,79,新百王,2023-07-12,6210
0056,元大高股息,93,15,78,新百王,2023-07-12,6210
00680L,元大美債20正2,61,0,61,新百王,2023-07-12,6210
5009,榮剛,63,10,53,新百王,2023-07-12,6210
6188,廣明,55,20,35,新百王,2023-07-12,6210
2834,臺企銀,35,1,34,新百王,2023-07-12,6210
4532,瑞智,113,80,33,新百王,2023-07-12,6210
3711,日月光投控,37,6,31,新百王,2023-07-12,6210
6244,茂迪,30,0,30,新百王,2023-07-12,6210
8011,台通,30,0,30,新百王,2023-07-12,6210
3052,夆典,30,0,30,新百王,2023-07-12,6210
2358,廷鑫,33,5,28,新百王,2023-07-12,6210
1611,中電,28,0,28,新百王,2023-07-12,6210
8105,凌巨,30,3,27,新百王,2023-07-12,6210
2409,友達,131,104,27,新百王,2023-07-12,6210
3217,優群,26,1,25,新百王,2023-07-12,6210
2303,聯電,48,24,24,新百王,2023-07-12,6210
2801,彰銀,24,0,24,新百王,2023-07-12,6210
4157,太景*-KY,23,0,23,新百王,2023-07-12,6210
2392,正崴,22,0,22,新百王,2023-07-12,6210
8176,智捷,22,0,22,新百王,2023-07-12,6210
3689,湧德,24,3,21,新百王,2023-07-12,6210
2419,仲琦,25,4,21,新百王,2023-07-12,6210
3492,長盛,20,0,20,新百王,2023-07-12,6210
00666R,富邦�琤肭磪齯�1,20,0,20,新百王,2023-07-12,6210
1465,偉全,20,0,20,新百王,2023-07-12,6210
2929,淘帝-KY,20,0,20,新百王,2023-07-12,6210
2365,昆盈,17,0,17,新百王,2023-07-12,6210
6182,合晶,18,2,16,新百王,2023-07-12,6210
3322,建舜電,30,15,15,新百王,2023-07-12,6210
5498,凱崴,15,0,15,新百王,2023-07-12,6210
3024,憶聲,20,5,15,新百王,2023-07-12,6210
6171,大城地產,15,0,15,新百王,2023-07-12,6210
3234,光環,16,2,14,新百王,2023-07-12,6210
5258,虹堡,108,94,14,新百王,2023-07-12,6210
2883,凱基金,15,2,13,新百王,2023-07-12,6210
6285,啟��,39,27,12,新百王,2023-07-12,6210
1529,樂事綠能,16,4,12,新百王,2023-07-12,6210
6118,建達,18,6,12,新百王,2023-07-12,6210
8088,品安,13,1,12,新百王,2023-07-12,6210
6531,愛普*,19,7,12,新百王,2023-07-12,6210
2539,櫻花建,11,0,11,新百王,2023-07-12,6210
3058,立德,11,0,11,新百王,2023-07-12,6210
2916,滿心,11,0,11,新百王,2023-07-12,6210
00673R,期元大S＆P原油反1,483,0,483,新百王,2023-07-13,6210
5009,榮剛,350,9,341,新百王,2023-07-13,6210
00632R,元大台灣50反1,421,173,248,新百王,2023-07-13,6210
2312,金寶,218,66,152,新百王,2023-07-13,6210
6016,康和證,120,3,117,新百王,2023-07-13,6210
6120,達運,164,66,98,新百王,2023-07-13,6210
3047,訊舟,90,0,90,新百王,2023-07-13,6210
1609,大亞,102,32,70,新百王,2023-07-13,6210
2353,宏��,90,23,67,新百王,2023-07-13,6210
2618,長榮航,112,47,65,新百王,2023-07-13,6210
2605,新興,64,0,64,新百王,2023-07-13,6210
2323,中環,76,16,60,新百王,2023-07-13,6210
00930,永豐ESG低碳高息,55,0,55,新百王,2023-07-13,6210
5864,致和證,75,20,55,新百王,2023-07-13,6210
2892,第一金,50,0,50,新百王,2023-07-13,6210
6244,茂迪,48,0,48,新百王,2023-07-13,6210
2610,華航,351,306,45,新百王,2023-07-13,6210
2603,長榮,56,11,45,新百王,2023-07-13,6210
00929,復華台灣科技優息,40,2,38,新百王,2023-07-13,6210
2515,中工,148,110,38,新百王,2023-07-13,6210
2601,益航,35,0,35,新百王,2023-07-13,6210
1444,力麗,32,0,32,新百王,2023-07-13,6210
2607,榮運,30,0,30,新百王,2023-07-13,6210
2453,凌群,31,2,29,新百王,2023-07-13,6210
6548,長科*,44,16,28,新百王,2023-07-13,6210
2367,燿華,35,7,28,新百王,2023-07-13,6210
8926,台汽電,36,10,26,新百王,2023-07-13,6210
2377,微星,27,1,26,新百王,2023-07-13,6210
2303,聯電,27,2,25,新百王,2023-07-13,6210
3515,華擎,57,33,24,新百王,2023-07-13,6210
00712,復華富時不動產,42,19,23,新百王,2023-07-13,6210
6182,合晶,23,0,23,新百王,2023-07-13,6210
1718,中纖,21,0,21,新百王,2023-07-13,6210
2030,彰源,20,0,20,新百王,2023-07-13,6210
3518,柏騰,29,10,19,新百王,2023-07-13,6210
3257,虹冠電,19,0,19,新百王,2023-07-13,6210
3231,緯創,102,83,19,新百王,2023-07-13,6210
2329,華泰,242,224,18,新百王,2023-07-13,6210
4552,力達-KY,18,0,18,新百王,2023-07-13,6210
3013,晟銘電,20,2,18,新百王,2023-07-13,6210
4432,銘旺實,18,0,18,新百王,2023-07-13,6210
6462,神盾,18,0,18,新百王,2023-07-13,6210
00680L,元大美債20正2,75,57,18,新百王,2023-07-13,6210
8021,尖點,19,1,18,新百王,2023-07-13,6210
1809,中釉,16,0,16,新百王,2023-07-13,6210
2208,台船,16,0,16,新百王,2023-07-13,6210
2498,宏達電,42,28,14,新百王,2023-07-13,6210
00683L,期元大美元指正2,14,0,14,新百王,2023-07-13,6210
6170,統振,14,0,14,新百王,2023-07-13,6210
8070,長華*,15,2,13,新百王,2023-07-13,6210
2618,長榮航,249,74,175,新百王,2023-07-14,6210
2353,宏��,210,50,160,新百王,2023-07-14,6210
2312,金寶,154,35,119,新百王,2023-07-14,6210
2610,華航,300,192,108,新百王,2023-07-14,6210
00673R,期元大S＆P原油反1,104,0,104,新百王,2023-07-14,6210
00632R,元大台灣50反1,238,150,88,新百王,2023-07-14,6210
2359,所羅門,122,43,79,新百王,2023-07-14,6210
2344,華邦電,75,1,74,新百王,2023-07-14,6210
00878,國泰永續高股息,79,6,73,新百王,2023-07-14,6210
2340,台亞,123,51,72,新百王,2023-07-14,6210
2408,南亞科,60,1,59,新百王,2023-07-14,6210
3037,欣興,83,25,58,新百王,2023-07-14,6210
2324,仁寶,115,58,57,新百王,2023-07-14,6210
00676R,富邦臺灣加權反1,50,0,50,新百王,2023-07-14,6210
4934,太極,52,4,48,新百王,2023-07-14,6210
00633L,富邦上証正2,40,0,40,新百王,2023-07-14,6210
3594,磐儀,45,5,40,新百王,2023-07-14,6210
6531,愛普*,43,7,36,新百王,2023-07-14,6210
2442,新美齊,30,0,30,新百王,2023-07-14,6210
2329,華泰,92,63,29,新百王,2023-07-14,6210
2323,中環,54,27,27,新百王,2023-07-14,6210
3231,緯創,42,17,25,新百王,2023-07-14,6210
3338,泰碩,30,6,24,新百王,2023-07-14,6210
2301,光寶科,158,135,23,新百王,2023-07-14,6210
2413,環科,22,0,22,新百王,2023-07-14,6210
4533,協易機,41,19,22,新百王,2023-07-14,6210
00720B,元大投資級公司債,24,2,22,新百王,2023-07-14,6210
2481,強茂,53,33,20,新百王,2023-07-14,6210
1314,中石化,20,0,20,新百王,2023-07-14,6210
2371,大同,115,96,19,新百王,2023-07-14,6210
2867,三商壽,26,7,19,新百王,2023-07-14,6210
6188,廣明,43,24,19,新百王,2023-07-14,6210
2208,台船,18,0,18,新百王,2023-07-14,6210
3372,典範,20,2,18,新百王,2023-07-14,6210
8105,凌巨,18,0,18,新百王,2023-07-14,6210
1802,台玻,18,0,18,新百王,2023-07-14,6210
3052,夆典,17,0,17,新百王,2023-07-14,6210
8926,台汽電,17,0,17,新百王,2023-07-14,6210
00679B,元大美債20年,17,1,16,新百王,2023-07-14,6210
2377,微星,17,2,15,新百王,2023-07-14,6210
1618,合機,31,16,15,新百王,2023-07-14,6210
1319,東陽,15,0,15,新百王,2023-07-14,6210
1517,利奇,14,0,14,新百王,2023-07-14,6210
00722B,群益投資級電信債,14,0,14,新百王,2023-07-14,6210
8028,昇陽半導體,20,6,14,新百王,2023-07-14,6210
4532,瑞智,32,18,14,新百王,2023-07-14,6210
0056,元大高股息,42,29,13,新百王,2023-07-14,6210
00929,復華台灣科技優息,75,62,13,新百王,2023-07-14,6210
00885,富邦越南,13,0,13,新百王,2023-07-14,6210
6116,彩晶,135,123,12,新百王,2023-07-14,6210
00637L,元大滬深300正2,283,0,283,新百王,2023-07-17,6210
00929,復華台灣科技優息,253,95,158,新百王,2023-07-17,6210
00632R,元大台灣50反1,197,55,142,新百王,2023-07-17,6210
2312,金寶,373,251,122,新百王,2023-07-17,6210
2888,新光金,160,46,114,新百王,2023-07-17,6210
3715,定穎投控,212,107,105,新百王,2023-07-17,6210
2515,中工,139,54,85,新百王,2023-07-17,6210
2392,正崴,94,14,80,新百王,2023-07-17,6210
0056,元大高股息,145,65,80,新百王,2023-07-17,6210
4960,誠美材,60,0,60,新百王,2023-07-17,6210
00894,中信小資高價30,52,0,52,新百王,2023-07-17,6210
2356,英業達,84,36,48,新百王,2023-07-17,6210
1402,遠東新,49,2,47,新百王,2023-07-17,6210
3052,夆典,46,3,43,新百王,2023-07-17,6210
1513,中興電,97,55,42,新百王,2023-07-17,6210
2618,長榮航,86,44,42,新百王,2023-07-17,6210
2324,仁寶,163,121,42,新百王,2023-07-17,6210
6202,盛群,42,1,41,新百王,2023-07-17,6210
6550,北極星藥業-KY,42,2,40,新百王,2023-07-17,6210
3481,群創,57,18,39,新百王,2023-07-17,6210
2371,大同,95,59,36,新百王,2023-07-17,6210
00650L,復華香港正2,35,0,35,新百王,2023-07-17,6210
2891,中信金,41,7,34,新百王,2023-07-17,6210
2461,光群雷,35,1,34,新百王,2023-07-17,6210
6290,良維,68,37,31,新百王,2023-07-17,6210
2323,中環,53,24,29,新百王,2023-07-17,6210
00665L,富邦�琤肭磪囓�2,29,0,29,新百王,2023-07-17,6210
3035,智原,114,86,28,新百王,2023-07-17,6210
2449,京元電子,51,23,28,新百王,2023-07-17,6210
2329,華泰,68,40,28,新百王,2023-07-17,6210
6120,達運,46,20,26,新百王,2023-07-17,6210
2421,建準,39,17,22,新百王,2023-07-17,6210
2498,宏達電,23,1,22,新百王,2023-07-17,6210
2382,廣達,75,53,22,新百王,2023-07-17,6210
5607,遠雄港,24,3,21,新百王,2023-07-17,6210
4167,松瑞藥,20,0,20,新百王,2023-07-17,6210
1457,宜進,20,0,20,新百王,2023-07-17,6210
00923,群益台ESG低碳50,20,0,20,新百王,2023-07-17,6210
3540,曜越,59,39,20,新百王,2023-07-17,6210
6182,合晶,25,6,19,新百王,2023-07-17,6210
00905,FT臺灣Smart,19,0,19,新百王,2023-07-17,6210
2340,台亞,49,31,18,新百王,2023-07-17,6210
8478,東哥遊艇,17,0,17,新百王,2023-07-17,6210
8071,能率網通,16,0,16,新百王,2023-07-17,6210
2867,三商壽,16,0,16,新百王,2023-07-17,6210
2317,鴻海,34,18,16,新百王,2023-07-17,6210
8011,台通,120,105,15,新百王,2023-07-17,6210
2892,第一金,15,0,15,新百王,2023-07-17,6210
2442,新美齊,15,0,15,新百王,2023-07-17,6210
2328,廣宇,25,11,14,新百王,2023-07-17,6210
00929,復華台灣科技優息,520,7,513,新百王,2023-07-18,6210
2888,新光金,410,2,408,新百王,2023-07-18,6210
2409,友達,356,0,356,新百王,2023-07-18,6210
6168,宏齊,301,0,301,新百王,2023-07-18,6210
2312,金寶,550,340,210,新百王,2023-07-18,6210
1514,亞力,168,30,138,新百王,2023-07-18,6210
00795B,中信美國公債20年,100,0,100,新百王,2023-07-18,6210
9105,泰金寶-DR,95,0,95,新百王,2023-07-18,6210
2883B,凱基金乙特,88,0,88,新百王,2023-07-18,6210
2890,永豐金,261,177,84,新百王,2023-07-18,6210
2359,所羅門,80,0,80,新百王,2023-07-18,6210
8201,無敵,71,4,67,新百王,2023-07-18,6210
00665L,富邦�琤肭磪囓�2,129,70,59,新百王,2023-07-18,6210
4938,和碩,107,49,58,新百王,2023-07-18,6210
3338,泰碩,68,13,55,新百王,2023-07-18,6210
1219,福壽,56,5,51,新百王,2023-07-18,6210
4714,永捷,52,2,50,新百王,2023-07-18,6210
2610,華航,265,220,45,新百王,2023-07-18,6210
6116,彩晶,72,30,42,新百王,2023-07-18,6210
2324,仁寶,179,138,41,新百王,2023-07-18,6210
3041,揚智,40,0,40,新百王,2023-07-18,6210
6282,康舒,294,255,39,新百王,2023-07-18,6210
2450,神腦,37,0,37,新百王,2023-07-18,6210
5009,榮剛,99,63,36,新百王,2023-07-18,6210
6462,神盾,35,2,33,新百王,2023-07-18,6210
2358,廷鑫,31,0,31,新百王,2023-07-18,6210
5258,虹堡,62,32,30,新百王,2023-07-18,6210
2465,麗臺,31,2,29,新百王,2023-07-18,6210
2449,京元電子,69,40,29,新百王,2023-07-18,6210
6176,瑞儀,28,0,28,新百王,2023-07-18,6210
1605,華新,29,1,28,新百王,2023-07-18,6210
2328,廣宇,63,35,28,新百王,2023-07-18,6210
1504,東元,31,5,26,新百王,2023-07-18,6210
3231,緯創,39,13,26,新百王,2023-07-18,6210
3432,台端,25,0,25,新百王,2023-07-18,6210
2881,富邦金,35,11,24,新百王,2023-07-18,6210
6207,雷科,24,0,24,新百王,2023-07-18,6210
2498,宏達電,29,6,23,新百王,2023-07-18,6210
4563,百德,22,0,22,新百王,2023-07-18,6210
8114,振樺電,21,0,21,新百王,2023-07-18,6210
2301,光寶科,120,99,21,新百王,2023-07-18,6210
8076,伍豐,22,2,20,新百王,2023-07-18,6210
3032,偉訓,53,33,20,新百王,2023-07-18,6210
1307,三芳,20,0,20,新百王,2023-07-18,6210
6248,沛波,20,0,20,新百王,2023-07-18,6210
2425,承啟,35,16,19,新百王,2023-07-18,6210
1611,中電,21,2,19,新百王,2023-07-18,6210
3232,昱捷,18,0,18,新百王,2023-07-18,6210
1471,首利,23,6,17,新百王,2023-07-18,6210
2886,兆豐金,20,4,16,新百王,2023-07-18,6210
2324,仁寶,2370,133,2237,新百王,2023-07-19,6210
6191,精成科,302,0,302,新百王,2023-07-19,6210
2888,新光金,303,2,301,新百王,2023-07-19,6210
2867,三商壽,247,1,246,新百王,2023-07-19,6210
2409,友達,416,176,240,新百王,2023-07-19,6210
3706,神達,335,110,225,新百王,2023-07-19,6210
5469,瀚宇博,132,2,130,新百王,2023-07-19,6210
9105,泰金寶-DR,145,20,125,新百王,2023-07-19,6210
0056,元大高股息,213,88,125,新百王,2023-07-19,6210
2618,長榮航,138,23,115,新百王,2023-07-19,6210
2317,鴻海,156,62,94,新百王,2023-07-19,6210
6116,彩晶,215,127,88,新百王,2023-07-19,6210
2834,臺企銀,90,20,70,新百王,2023-07-19,6210
2312,金寶,190,122,68,新百王,2023-07-19,6210
2359,所羅門,68,1,67,新百王,2023-07-19,6210
2607,榮運,60,0,60,新百王,2023-07-19,6210
1514,亞力,87,33,54,新百王,2023-07-19,6210
2330,台積電,54,3,51,新百王,2023-07-19,6210
4207,環泰,50,0,50,新百王,2023-07-19,6210
00929,復華台灣科技優息,47,0,47,新百王,2023-07-19,6210
2890,永豐金,396,351,45,新百王,2023-07-19,6210
3264,欣銓,62,23,39,新百王,2023-07-19,6210
6179,亞通,37,0,37,新百王,2023-07-19,6210
2353,宏��,74,43,31,新百王,2023-07-19,6210
3022,威強電,26,0,26,新百王,2023-07-19,6210
00713,元大台灣高息低波,26,0,26,新百王,2023-07-19,6210
5009,榮剛,82,58,24,新百王,2023-07-19,6210
00712,復華富時不動產,58,34,24,新百王,2023-07-19,6210
2929,淘帝-KY,24,0,24,新百王,2023-07-19,6210
00753L,中信中國50正2,23,0,23,新百王,2023-07-19,6210
2328,廣宇,35,13,22,新百王,2023-07-19,6210
3078,僑威,68,46,22,新百王,2023-07-19,6210
1402,遠東新,22,0,22,新百王,2023-07-19,6210
4906,正文,27,6,21,新百王,2023-07-19,6210
2358,廷鑫,21,0,21,新百王,2023-07-19,6210
00924,復華S＆P500成長,20,0,20,新百王,2023-07-19,6210
2303,聯電,20,0,20,新百王,2023-07-19,6210
1319,東陽,22,3,19,新百王,2023-07-19,6210
2615,萬海,20,2,18,新百王,2023-07-19,6210
6166,凌華,23,6,17,新百王,2023-07-19,6210
6741,91APP*-KY,17,1,16,新百王,2023-07-19,6210
00665L,富邦�琤肭磪囓�2,129,113,16,新百王,2023-07-19,6210
1809,中釉,15,0,15,新百王,2023-07-19,6210
2104,國際中橡,20,5,15,新百王,2023-07-19,6210
8050,廣積,16,2,14,新百王,2023-07-19,6210
2368,金像電,15,2,13,新百王,2023-07-19,6210
1313,聯成,13,0,13,新百王,2023-07-19,6210
6207,雷科,13,0,13,新百王,2023-07-19,6210
9910,豐泰,12,0,12,新百王,2023-07-19,6210
2201,裕隆,27,16,11,新百王,2023-07-19,6210
2324,仁寶,1082,179,903,新百王,2023-07-20,6210
5469,瀚宇博,362,0,362,新百王,2023-07-20,6210
2330,台積電,103,2,101,新百王,2023-07-20,6210
00751B,元大AAA至A公司債,100,0,100,新百王,2023-07-20,6210
4207,環泰,100,0,100,新百王,2023-07-20,6210
2002,中鋼,100,0,100,新百王,2023-07-20,6210
00720B,元大投資級公司債,103,10,93,新百王,2023-07-20,6210
2303,聯電,79,1,78,新百王,2023-07-20,6210
00929,復華台灣科技優息,71,0,71,新百王,2023-07-20,6210
00878,國泰永續高股息,76,12,64,新百王,2023-07-20,6210
4154,樂威科-KY,50,0,50,新百王,2023-07-20,6210
2316,楠梓電,110,61,49,新百王,2023-07-20,6210
2436,偉詮電,56,10,46,新百王,2023-07-20,6210
2885,元大金,48,4,44,新百王,2023-07-20,6210
2515,中工,42,0,42,新百王,2023-07-20,6210
2392,正崴,42,0,42,新百王,2023-07-20,6210
1618,合機,49,10,39,新百王,2023-07-20,6210
1104,環泥,53,15,38,新百王,2023-07-20,6210
6282,康舒,140,103,37,新百王,2023-07-20,6210
1102,亞泥,50,15,35,新百王,2023-07-20,6210
6215,和椿,35,0,35,新百王,2023-07-20,6210
2352,佳世達,73,39,34,新百王,2023-07-20,6210
00665L,富邦�琤肭磪囓�2,186,154,32,新百王,2023-07-20,6210
2634,漢翔,77,47,30,新百王,2023-07-20,6210
9105,泰金寶-DR,30,0,30,新百王,2023-07-20,6210
6191,精成科,29,0,29,新百王,2023-07-20,6210
2312,金寶,134,105,29,新百王,2023-07-20,6210
3037,欣興,57,29,28,新百王,2023-07-20,6210
4960,誠美材,27,0,27,新百王,2023-07-20,6210
8050,廣積,35,8,27,新百王,2023-07-20,6210
8215,明基材,42,16,26,新百王,2023-07-20,6210
3521,鴻翊,25,0,25,新百王,2023-07-20,6210
3264,欣銓,28,3,25,新百王,2023-07-20,6210
00675L,富邦臺灣加權正2,25,2,23,新百王,2023-07-20,6210
3372,典範,19,0,19,新百王,2023-07-20,6210
0056,元大高股息,34,16,18,新百王,2023-07-20,6210
6530,創威,32,14,18,新百王,2023-07-20,6210
2356,英業達,30,12,18,新百王,2023-07-20,6210
2359,所羅門,20,2,18,新百王,2023-07-20,6210
6223,旺矽,21,4,17,新百王,2023-07-20,6210
00680L,元大美債20正2,25,9,16,新百王,2023-07-20,6210
2618,長榮航,75,59,16,新百王,2023-07-20,6210
1444,力麗,15,0,15,新百王,2023-07-20,6210
3694,海華,32,17,15,新百王,2023-07-20,6210
2313,華通,16,1,15,新百王,2023-07-20,6210
2867,三商壽,20,6,14,新百王,2023-07-20,6210
3481,群創,32,19,13,新百王,2023-07-20,6210
2328,廣宇,23,10,13,新百王,2023-07-20,6210
1815,富喬,33,21,12,新百王,2023-07-20,6210
2495,普安,13,1,12,新百王,2023-07-20,6210
3049,精金,300,0,300,新百王,2023-07-21,6210
2515,中工,220,1,219,新百王,2023-07-21,6210
1102,亞泥,139,1,138,新百王,2023-07-21,6210
00929,復華台灣科技優息,108,5,103,新百王,2023-07-21,6210
2351,順德,75,13,62,新百王,2023-07-21,6210
6016,康和證,60,0,60,新百王,2023-07-21,6210
2603,長榮,59,2,57,新百王,2023-07-21,6210
2312,金寶,61,5,56,新百王,2023-07-21,6210
00715L,期街口布蘭特正2,50,3,47,新百王,2023-07-21,6210
8093,保銳,47,0,47,新百王,2023-07-21,6210
5009,榮剛,47,0,47,新百王,2023-07-21,6210
9945,潤泰新,42,0,42,新百王,2023-07-21,6210
2867,三商壽,40,0,40,新百王,2023-07-21,6210
3521,鴻翊,40,0,40,新百王,2023-07-21,6210
3706,神達,46,9,37,新百王,2023-07-21,6210
00905,FT臺灣Smart,36,0,36,新百王,2023-07-21,6210
00675L,富邦臺灣加權正2,35,0,35,新百王,2023-07-21,6210
2344,華邦電,34,2,32,新百王,2023-07-21,6210
1308,亞聚,30,0,30,新百王,2023-07-21,6210
00665L,富邦�琤肭磪囓�2,184,154,30,新百王,2023-07-21,6210
1513,中興電,114,84,30,新百王,2023-07-21,6210
3588,通嘉,31,1,30,新百王,2023-07-21,6210
2206,三陽工業,33,4,29,新百王,2023-07-21,6210
2382,廣達,151,122,29,新百王,2023-07-21,6210
3689,湧德,41,13,28,新百王,2023-07-21,6210
3583,辛耘,52,26,26,新百王,2023-07-21,6210
6112,邁達特,60,34,26,新百王,2023-07-21,6210
2890,永豐金,484,463,21,新百王,2023-07-21,6210
1605,華新,20,0,20,新百王,2023-07-21,6210
2501,國建,20,0,20,新百王,2023-07-21,6210
2359,所羅門,20,1,19,新百王,2023-07-21,6210
2425,承啟,24,6,18,新百王,2023-07-21,6210
5508,永信建,18,0,18,新百王,2023-07-21,6210
6188,廣明,38,21,17,新百王,2023-07-21,6210
2609,陽明,48,31,17,新百王,2023-07-21,6210
2371,大同,109,92,17,新百王,2023-07-21,6210
2330,台積電,20,4,16,新百王,2023-07-21,6210
8201,無敵,15,0,15,新百王,2023-07-21,6210
2880,華南金,15,0,15,新百王,2023-07-21,6210
1727,中華化,23,8,15,新百王,2023-07-21,6210
2812,台中銀,15,0,15,新百王,2023-07-21,6210
4960,誠美材,15,0,15,新百王,2023-07-21,6210
0050,元大台灣50,22,8,14,新百王,2023-07-21,6210
2328,廣宇,14,0,14,新百王,2023-07-21,6210
1314,中石化,25,11,14,新百王,2023-07-21,6210
4744,皇將,36,22,14,新百王,2023-07-21,6210
2887,台新金,14,0,14,新百王,2023-07-21,6210
2303,聯電,18,5,13,新百王,2023-07-21,6210
1504,東元,46,33,13,新百王,2023-07-21,6210
6120,達運,98,85,13,新百王,2023-07-21,6210
2890,永豐金,453,312,141,新百王,2023-07-24,6210
1513,中興電,208,118,90,新百王,2023-07-24,6210
1609,大亞,189,116,73,新百王,2023-07-24,6210
2328,廣宇,97,30,67,新百王,2023-07-24,6210
5469,瀚宇博,61,3,58,新百王,2023-07-24,6210
6548,長科*,55,1,54,新百王,2023-07-24,6210
2618,長榮航,79,27,52,新百王,2023-07-24,6210
2929,淘帝-KY,50,0,50,新百王,2023-07-24,6210
00753L,中信中國50正2,62,13,49,新百王,2023-07-24,6210
3037,欣興,85,39,46,新百王,2023-07-24,6210
2888,新光金,45,3,42,新百王,2023-07-24,6210
2356,英業達,59,21,38,新百王,2023-07-24,6210
1217,愛之味,61,26,35,新百王,2023-07-24,6210
00720B,元大投資級公司債,35,0,35,新百王,2023-07-24,6210
2427,三商電,30,0,30,新百王,2023-07-24,6210
6191,精成科,30,0,30,新百王,2023-07-24,6210
2834,臺企銀,30,0,30,新百王,2023-07-24,6210
2610,華航,110,84,26,新百王,2023-07-24,6210
00902,中信電池及儲能,25,0,25,新百王,2023-07-24,6210
1618,合機,25,1,24,新百王,2023-07-24,6210
5864,致和證,26,2,24,新百王,2023-07-24,6210
2352,佳世達,29,6,23,新百王,2023-07-24,6210
2369,菱生,24,2,22,新百王,2023-07-24,6210
6550,北極星藥業-KY,21,0,21,新百王,2023-07-24,6210
3588,通嘉,28,8,20,新百王,2023-07-24,6210
2353,宏��,72,54,18,新百王,2023-07-24,6210
4533,協易機,20,3,17,新百王,2023-07-24,6210
00670L,富邦NASDAQ正2,17,0,17,新百王,2023-07-24,6210
00679B,元大美債20年,18,1,17,新百王,2023-07-24,6210
2534,宏盛,16,0,16,新百王,2023-07-24,6210
3338,泰碩,106,90,16,新百王,2023-07-24,6210
2419,仲琦,64,48,16,新百王,2023-07-24,6210
00882,中信中國高股息,15,0,15,新百王,2023-07-24,6210
2316,楠梓電,15,0,15,新百王,2023-07-24,6210
1504,東元,62,47,15,新百王,2023-07-24,6210
6589,台康生技,15,0,15,新百王,2023-07-24,6210
4927,泰鼎-KY,15,0,15,新百王,2023-07-24,6210
1514,亞力,24,10,14,新百王,2023-07-24,6210
3032,偉訓,33,19,14,新百王,2023-07-24,6210
5508,永信建,14,0,14,新百王,2023-07-24,6210
4938,和碩,22,9,13,新百王,2023-07-24,6210
5474,聰泰,30,17,13,新百王,2023-07-24,6210
1736,喬山,24,11,13,新百王,2023-07-24,6210
2542,興富發,12,0,12,新百王,2023-07-24,6210
6284,佳邦,13,1,12,新百王,2023-07-24,6210
2461,光群雷,45,33,12,新百王,2023-07-24,6210
9945,潤泰新,12,0,12,新百王,2023-07-24,6210
2601,益航,12,0,12,新百王,2023-07-24,6210
2312,金寶,15,4,11,新百王,2023-07-24,6210
6290,良維,11,0,11,新百王,2023-07-24,6210
00632R,元大台灣50反1,371,159,212,新百王,2023-07-25,6210
2884,玉山金,104,2,102,新百王,2023-07-25,6210
00673R,期元大S＆P原油反1,106,10,96,新百王,2023-07-25,6210
5469,瀚宇博,63,2,61,新百王,2023-07-25,6210
4927,泰鼎-KY,60,0,60,新百王,2023-07-25,6210
6187,萬潤,72,13,59,新百王,2023-07-25,6210
2888,新光金,68,10,58,新百王,2023-07-25,6210
00676R,富邦臺灣加權反1,55,0,55,新百王,2023-07-25,6210
4154,樂威科-KY,50,0,50,新百王,2023-07-25,6210
00929,復華台灣科技優息,49,2,47,新百王,2023-07-25,6210
4726,永昕,47,4,43,新百王,2023-07-25,6210
2301,光寶科,212,175,37,新百王,2023-07-25,6210
00712,復華富時不動產,40,5,35,新百王,2023-07-25,6210
00795B,中信美國公債20年,30,0,30,新百王,2023-07-25,6210
00878,國泰永續高股息,114,84,30,新百王,2023-07-25,6210
6016,康和證,110,80,30,新百王,2023-07-25,6210
2349,錸德,30,0,30,新百王,2023-07-25,6210
6191,精成科,94,66,28,新百王,2023-07-25,6210
5864,致和證,28,2,26,新百王,2023-07-25,6210
1815,富喬,27,2,25,新百王,2023-07-25,6210
2340,台亞,39,15,24,新百王,2023-07-25,6210
5483,中美晶,35,12,23,新百王,2023-07-25,6210
1707,葡萄王,23,0,23,新百王,2023-07-25,6210
2421,建準,61,39,22,新百王,2023-07-25,6210
2383,台光電,32,10,22,新百王,2023-07-25,6210
1514,亞力,49,27,22,新百王,2023-07-25,6210
4543,萬在,24,3,21,新百王,2023-07-25,6210
2312,金寶,32,12,20,新百王,2023-07-25,6210
2402,毅嘉,21,1,20,新百王,2023-07-25,6210
2929,淘帝-KY,20,0,20,新百王,2023-07-25,6210
3501,維熹,24,5,19,新百王,2023-07-25,6210
2387,精元,17,0,17,新百王,2023-07-25,6210
2331,精英,17,0,17,新百王,2023-07-25,6210
2392,正崴,27,11,16,新百王,2023-07-25,6210
1736,喬山,27,12,15,新百王,2023-07-25,6210
00764B,群益25年美債,15,0,15,新百王,2023-07-25,6210
6166,凌華,22,8,14,新百王,2023-07-25,6210
3024,憶聲,15,1,14,新百王,2023-07-25,6210
2809,京城銀,13,0,13,新百王,2023-07-25,6210
00720B,元大投資級公司債,13,0,13,新百王,2023-07-25,6210
2436,偉詮電,12,0,12,新百王,2023-07-25,6210
6282,康舒,57,45,12,新百王,2023-07-25,6210
3046,建��,13,1,12,新百王,2023-07-25,6210
3169,亞信,12,0,12,新百王,2023-07-25,6210
00751B,元大AAA至A公司債,11,0,11,新百王,2023-07-25,6210
8358,金居,48,37,11,新百王,2023-07-25,6210
2324,仁寶,12,1,11,新百王,2023-07-25,6210
8390,金益鼎,13,2,11,新百王,2023-07-25,6210
8088,品安,10,0,10,新百王,2023-07-25,6210
1702,南僑,10,0,10,新百王,2023-07-25,6210
00929,復華台灣科技優息,202,0,202,新百王,2023-07-26,6210
3029,零壹,144,31,113,新百王,2023-07-26,6210
00665L,富邦�琤肭磪囓�2,278,197,81,新百王,2023-07-26,6210
6104,創惟,83,15,68,新百王,2023-07-26,6210
00720B,元大投資級公司債,63,0,63,新百王,2023-07-26,6210
5469,瀚宇博,61,3,58,新百王,2023-07-26,6210
2409,友達,85,28,57,新百王,2023-07-26,6210
4533,協易機,83,29,54,新百王,2023-07-26,6210
2392,正崴,54,1,53,新百王,2023-07-26,6210
00673R,期元大S＆P原油反1,50,0,50,新百王,2023-07-26,6210
8358,金居,88,43,45,新百王,2023-07-26,6210
00752,中信中國50,45,0,45,新百王,2023-07-26,6210
6550,北極星藥業-KY,46,3,43,新百王,2023-07-26,6210
3715,定穎投控,122,81,41,新百王,2023-07-26,6210
1513,中興電,88,49,39,新百王,2023-07-26,6210
00670L,富邦NASDAQ正2,34,2,32,新百王,2023-07-26,6210
1110,東泥,30,0,30,新百王,2023-07-26,6210
9105,泰金寶-DR,30,0,30,新百王,2023-07-26,6210
4927,泰鼎-KY,30,0,30,新百王,2023-07-26,6210
2855,統一證,30,0,30,新百王,2023-07-26,6210
3169,亞信,30,1,29,新百王,2023-07-26,6210
00795B,中信美國公債20年,28,0,28,新百王,2023-07-26,6210
4714,永捷,25,0,25,新百王,2023-07-26,6210
2601,益航,25,0,25,新百王,2023-07-26,6210
2303,聯電,26,2,24,新百王,2023-07-26,6210
6841,長佳智能,50,26,24,新百王,2023-07-26,6210
3044,健鼎,29,6,23,新百王,2023-07-26,6210
00637L,元大滬深300正2,62,39,23,新百王,2023-07-26,6210
2421,建準,76,54,22,新百王,2023-07-26,6210
2610,華航,108,87,21,新百王,2023-07-26,6210
3088,艾訊,28,8,20,新百王,2023-07-26,6210
6122,擎邦,20,0,20,新百王,2023-07-26,6210
3682,亞太電,20,0,20,新百王,2023-07-26,6210
1310,台苯,20,0,20,新百王,2023-07-26,6210
3035,智原,19,0,19,新百王,2023-07-26,6210
4147,中裕,22,5,17,新百王,2023-07-26,6210
3693,營邦,26,10,16,新百王,2023-07-26,6210
2425,承啟,39,23,16,新百王,2023-07-26,6210
3037,欣興,48,33,15,新百王,2023-07-26,6210
1471,首利,16,1,15,新百王,2023-07-26,6210
2201,裕隆,15,0,15,新百王,2023-07-26,6210
1504,東元,140,126,14,新百王,2023-07-26,6210
1514,亞力,26,12,14,新百王,2023-07-26,6210
2331,精英,72,58,14,新百王,2023-07-26,6210
2520,冠德,14,0,14,新百王,2023-07-26,6210
4744,皇將,20,6,14,新百王,2023-07-26,6210
2337,旺宏,20,7,13,新百王,2023-07-26,6210
1609,大亞,27,14,13,新百王,2023-07-26,6210
3013,晟銘電,35,23,12,新百王,2023-07-26,6210
00680L,元大美債20正2,12,0,12,新百王,2023-07-26,6210
3481,群創,1066,618,448,新百王,2023-07-27,6210
00632R,元大台灣50反1,449,285,164,新百王,2023-07-27,6210
9105,泰金寶-DR,100,0,100,新百王,2023-07-27,6210
3715,定穎投控,178,82,96,新百王,2023-07-27,6210
00929,復華台灣科技優息,74,2,72,新百王,2023-07-27,6210
00712,復華富時不動產,67,4,63,新百王,2023-07-27,6210
00878,國泰永續高股息,62,5,57,新百王,2023-07-27,6210
2888,新光金,155,100,55,新百王,2023-07-27,6210
2317,鴻海,81,27,54,新百王,2023-07-27,6210
3029,零壹,74,22,52,新百王,2023-07-27,6210
5388,中磊,50,0,50,新百王,2023-07-27,6210
2890,永豐金,54,5,49,新百王,2023-07-27,6210
8390,金益鼎,57,11,46,新百王,2023-07-27,6210
1907,永豐餘,60,20,40,新百王,2023-07-27,6210
1108,幸福,40,0,40,新百王,2023-07-27,6210
2603,長榮,88,48,40,新百王,2023-07-27,6210
6161,捷波,69,31,38,新百王,2023-07-27,6210
2324,仁寶,48,11,37,新百王,2023-07-27,6210
2312,金寶,35,0,35,新百王,2023-07-27,6210
3231,緯創,57,23,34,新百王,2023-07-27,6210
2359,所羅門,47,14,33,新百王,2023-07-27,6210
2601,益航,30,0,30,新百王,2023-07-27,6210
1609,大亞,32,3,29,新百王,2023-07-27,6210
2913,農林,43,15,28,新百王,2023-07-27,6210
8930,青鋼,32,5,27,新百王,2023-07-27,6210
2353,宏��,47,21,26,新百王,2023-07-27,6210
2887,台新金,50,25,25,新百王,2023-07-27,6210
5880,合庫金,25,0,25,新百王,2023-07-27,6210
00680L,元大美債20正2,25,0,25,新百王,2023-07-27,6210
1504,東元,32,7,25,新百王,2023-07-27,6210
2402,毅嘉,30,7,23,新百王,2023-07-27,6210
6282,康舒,90,70,20,新百王,2023-07-27,6210
2881,富邦金,25,4,21,新百王,2023-07-27,6210
6235,華孚,42,22,20,新百王,2023-07-27,6210
2358,廷鑫,20,0,20,新百王,2023-07-27,6210
00666R,富邦�琤肭磪齯�1,20,0,20,新百王,2023-07-27,6210
3037,欣興,69,50,19,新百王,2023-07-27,6210
3217,優群,19,0,19,新百王,2023-07-27,6210
5452,佶優,27,8,19,新百王,2023-07-27,6210
2609,陽明,40,21,19,新百王,2023-07-27,6210
00902,中信電池及儲能,18,0,18,新百王,2023-07-27,6210
1708,東鹼,18,0,18,新百王,2023-07-27,6210
1710,東聯,21,5,16,新百王,2023-07-27,6210
3450,聯鈞,16,0,16,新百王,2023-07-27,6210
2303,聯電,30,15,15,新百王,2023-07-27,6210
4123,晟德,16,1,15,新百王,2023-07-27,6210
6196,帆宣,19,4,15,新百王,2023-07-27,6210
4532,瑞智,16,2,14,新百王,2023-07-27,6210
3022,威強電,14,0,14,新百王,2023-07-27,6210
8114,振樺電,14,0,14,新百王,2023-07-27,6210
00929,復華台灣科技優息,357,62,295,新百王,2023-07-28,6210
2888,新光金,202,1,201,新百王,2023-07-28,6210
00632R,元大台灣50反1,426,235,191,新百王,2023-07-28,6210
00679B,元大美債20年,95,0,95,新百王,2023-07-28,6210
2303,聯電,116,31,85,新百王,2023-07-28,6210
00680L,元大美債20正2,77,0,77,新百王,2023-07-28,6210
00795B,中信美國公債20年,67,0,67,新百王,2023-07-28,6210
1802,台玻,109,43,66,新百王,2023-07-28,6210
00688L,國泰20年美債正2,64,0,64,新百王,2023-07-28,6210
2610,華航,71,10,61,新百王,2023-07-28,6210
00772B,中信高評級公司債,55,5,50,新百王,2023-07-28,6210
2515,中工,43,0,43,新百王,2023-07-28,6210
6015,宏遠證,40,0,40,新百王,2023-07-28,6210
00685L,群益臺灣加權正2,39,0,39,新百王,2023-07-28,6210
1313,聯成,36,0,36,新百王,2023-07-28,6210
2104,國際中橡,48,15,33,新百王,2023-07-28,6210
5469,瀚宇博,31,0,31,新百王,2023-07-28,6210
00751B,元大AAA至A公司債,34,4,30,新百王,2023-07-28,6210
00669R,國泰美國道瓊反1,30,0,30,新百王,2023-07-28,6210
00696B,富邦美債20年,30,0,30,新百王,2023-07-28,6210
3231,緯創,282,254,28,新百王,2023-07-28,6210
00720B,元大投資級公司債,27,1,26,新百王,2023-07-28,6210
6190,萬泰科,46,20,26,新百王,2023-07-28,6210
3049,精金,31,6,25,新百王,2023-07-28,6210
2317,鴻海,35,10,25,新百王,2023-07-28,6210
1904,正隆,40,16,24,新百王,2023-07-28,6210
2329,華泰,158,134,24,新百王,2023-07-28,6210
1305,華夏,24,3,21,新百王,2023-07-28,6210
2442,新美齊,55,34,21,新百王,2023-07-28,6210
00673R,期元大S＆P原油反1,20,0,20,新百王,2023-07-28,6210
00900,富邦特選高股息30,20,0,20,新百王,2023-07-28,6210
2340,台亞,21,1,20,新百王,2023-07-28,6210
1308,亞聚,20,0,20,新百王,2023-07-28,6210
2929,淘帝-KY,20,0,20,新百王,2023-07-28,6210
00687B,國泰20年美債,20,0,20,新百王,2023-07-28,6210
2753,八方雲集,20,0,20,新百王,2023-07-28,6210
3032,偉訓,22,3,19,新百王,2023-07-28,6210
4533,協易機,23,4,19,新百王,2023-07-28,6210
1785,光洋科,21,2,19,新百王,2023-07-28,6210
00722B,群益投資級電信債,18,0,18,新百王,2023-07-28,6210
5009,榮剛,18,0,18,新百王,2023-07-28,6210
2480,敦陽科,18,1,17,新百王,2023-07-28,6210
3289,宜特,31,14,17,新百王,2023-07-28,6210
2601,益航,16,0,16,新百王,2023-07-28,6210
6288,聯嘉,15,0,15,新百王,2023-07-28,6210
00773B,中信優先金融債,15,0,15,新百王,2023-07-28,6210
2358,廷鑫,25,10,15,新百王,2023-07-28,6210
6134,萬旭,15,0,15,新百王,2023-07-28,6210
00885,富邦越南,14,0,14,新百王,2023-07-28,6210
1905,華紙,222,208,14,新百王,2023-07-28,6210
2323,中環,120,0,120,新百王,2023-07-31,6210
2890,永豐金,106,0,106,新百王,2023-07-31,6210
00878,國泰永續高股息,258,160,98,新百王,2023-07-31,6210
2369,菱生,105,7,98,新百王,2023-07-31,6210
2330,台積電,90,5,85,新百王,2023-07-31,6210
2834,臺企銀,85,0,85,新百王,2023-07-31,6210
2897,王道銀行,62,0,62,新百王,2023-07-31,6210
2618,長榮航,66,8,58,新百王,2023-07-31,6210
1905,華紙,239,182,57,新百王,2023-07-31,6210
1319,東陽,113,60,53,新百王,2023-07-31,6210
2610,華航,86,33,53,新百王,2023-07-31,6210
6188,廣明,104,52,52,新百王,2023-07-31,6210
00680L,元大美債20正2,51,0,51,新百王,2023-07-31,6210
5533,皇鼎,50,0,50,新百王,2023-07-31,6210
4563,百德,46,1,45,新百王,2023-07-31,6210
5876,上海商銀,51,7,44,新百王,2023-07-31,6210
8069,元太,44,3,41,新百王,2023-07-31,6210
2359,所羅門,46,6,40,新百王,2023-07-31,6210
2851,中再保,90,50,40,新百王,2023-07-31,6210
00679B,元大美債20年,37,0,37,新百王,2023-07-31,6210
3231,緯創,194,157,37,新百王,2023-07-31,6210
2520,冠德,42,6,36,新百王,2023-07-31,6210
2458,義隆,36,1,35,新百王,2023-07-31,6210
2002,中鋼,39,6,33,新百王,2023-07-31,6210
2353,宏��,34,3,31,新百王,2023-07-31,6210
2006,東和鋼鐵,30,0,30,新百王,2023-07-31,6210
2338,光罩,32,2,30,新百王,2023-07-31,6210
8926,台汽電,32,2,30,新百王,2023-07-31,6210
2340,台亞,36,7,29,新百王,2023-07-31,6210
1514,亞力,35,7,28,新百王,2023-07-31,6210
0056,元大高股息,144,116,28,新百王,2023-07-31,6210
5531,鄉林,26,0,26,新百王,2023-07-31,6210
00706L,期元大S＆P日圓正2,25,0,25,新百王,2023-07-31,6210
4744,皇將,28,3,25,新百王,2023-07-31,6210
1591,駿吉-KY,25,0,25,新百王,2023-07-31,6210
2317,鴻海,32,8,24,新百王,2023-07-31,6210
4908,前鼎,33,9,24,新百王,2023-07-31,6210
2409,友達,20,0,20,新百王,2023-07-31,6210
1504,東元,33,13,20,新百王,2023-07-31,6210
1101B,台泥乙特,20,0,20,新百王,2023-07-31,6210
00905,FT臺灣Smart,32,13,19,新百王,2023-07-31,6210
2352,佳世達,24,5,19,新百王,2023-07-31,6210
2419,仲琦,27,8,19,新百王,2023-07-31,6210
2382,廣達,178,159,19,新百王,2023-07-31,6210
2208,台船,18,0,18,新百王,2023-07-31,6210
6125,廣運,42,25,17,新百王,2023-07-31,6210
6217,中探針,21,4,17,新百王,2023-07-31,6210
8442,威宏-KY,17,0,17,新百王,2023-07-31,6210
2329,華泰,170,153,17,新百王,2023-07-31,6210
3189,景碩,16,0,16,新百王,2023-07-31,6210
00929,復華台灣科技優息,408,2,406,新百王,2023-08-01,6210
2359,所羅門,120,0,120,新百王,2023-08-01,6210
2408,南亞科,89,3,86,新百王,2023-08-01,6210
3052,夆典,70,0,70,新百王,2023-08-01,6210
00680L,元大美債20正2,60,0,60,新百王,2023-08-01,6210
2489,瑞軒,60,0,60,新百王,2023-08-01,6210
3481,群創,96,39,57,新百王,2023-08-01,6210
2352,佳世達,59,10,49,新百王,2023-08-01,6210
00665L,富邦�琤肭磪囓�2,53,4,49,新百王,2023-08-01,6210
3013,晟銘電,47,7,40,新百王,2023-08-01,6210
00632R,元大台灣50反1,321,281,40,新百王,2023-08-01,6210
2312,金寶,41,3,38,新百王,2023-08-01,6210
6215,和椿,37,0,37,新百王,2023-08-01,6210
3325,旭品,46,10,36,新百王,2023-08-01,6210
1217,愛之味,30,2,28,新百王,2023-08-01,6210
1905,華紙,38,11,27,新百王,2023-08-01,6210
2890,永豐金,27,0,27,新百王,2023-08-01,6210
2382,廣達,136,110,26,新百王,2023-08-01,6210
00753L,中信中國50正2,78,53,25,新百王,2023-08-01,6210
2458,義隆,24,0,24,新百王,2023-08-01,6210
3032,偉訓,24,2,22,新百王,2023-08-01,6210
1504,東元,35,14,21,新百王,2023-08-01,6210
020033,統一�琤肮黕篾,20,0,20,新百王,2023-08-01,6210
8093,保銳,20,1,19,新百王,2023-08-01,6210
2929,淘帝-KY,19,0,19,新百王,2023-08-01,6210
00919,群益台灣精選高息,19,0,19,新百王,2023-08-01,6210
4716,大立,19,0,19,新百王,2023-08-01,6210
00712,復華富時不動產,20,2,18,新百王,2023-08-01,6210
2405,輔信,19,1,18,新百王,2023-08-01,6210
00673R,期元大S＆P原油反1,17,0,17,新百王,2023-08-01,6210
2515,中工,38,21,17,新百王,2023-08-01,6210
2301,光寶科,114,97,17,新百王,2023-08-01,6210
6218,豪勉,25,9,16,新百王,2023-08-01,6210
2329,華泰,18,2,16,新百王,2023-08-01,6210
2392,正崴,15,0,15,新百王,2023-08-01,6210
2534,宏盛,15,0,15,新百王,2023-08-01,6210
2358,廷鑫,20,5,15,新百王,2023-08-01,6210
2913,農林,47,32,15,新百王,2023-08-01,6210
00902,中信電池及儲能,15,0,15,新百王,2023-08-01,6210
2340,台亞,15,1,14,新百王,2023-08-01,6210
2206,三陽工業,15,1,14,新百王,2023-08-01,6210
2891,中信金,14,0,14,新百王,2023-08-01,6210
3033,威健,17,4,13,新百王,2023-08-01,6210
6153,嘉聯益,13,0,13,新百王,2023-08-01,6210
00733,富邦臺灣中小,13,0,13,新百王,2023-08-01,6210
1802,台玻,82,69,13,新百王,2023-08-01,6210
2201,裕隆,13,0,13,新百王,2023-08-01,6210
3580,友威科,20,7,13,新百王,2023-08-01,6210
6231,系微,23,10,13,新百王,2023-08-01,6210
3715,定穎投控,59,46,13,新百王,2023-08-01,6210
00929,復華台灣科技優息,221,4,217,新百王,2023-08-02,6210
00680L,元大美債20正2,182,15,167,新百王,2023-08-02,6210
3481,群創,243,119,124,新百王,2023-08-02,6210
2324,仁寶,107,2,105,新百王,2023-08-02,6210
00878,國泰永續高股息,173,86,87,新百王,2023-08-02,6210
2851,中再保,85,0,85,新百王,2023-08-02,6210
2460,建通,80,0,80,新百王,2023-08-02,6210
00679B,元大美債20年,76,0,76,新百王,2023-08-02,6210
6116,彩晶,73,0,73,新百王,2023-08-02,6210
1514,亞力,86,19,67,新百王,2023-08-02,6210
2317,鴻海,66,2,64,新百王,2023-08-02,6210
2618,長榮航,79,17,62,新百王,2023-08-02,6210
2890,永豐金,69,11,58,新百王,2023-08-02,6210
00637L,元大滬深300正2,70,12,58,新百王,2023-08-02,6210
3013,晟銘電,64,7,57,新百王,2023-08-02,6210
00687B,國泰20年美債,55,0,55,新百王,2023-08-02,6210
1611,中電,56,1,55,新百王,2023-08-02,6210
1605,華新,139,87,52,新百王,2023-08-02,6210
00720B,元大投資級公司債,51,0,51,新百王,2023-08-02,6210
2352,佳世達,61,10,51,新百王,2023-08-02,6210
6015,宏遠證,50,0,50,新百王,2023-08-02,6210
5533,皇鼎,50,0,50,新百王,2023-08-02,6210
2301,光寶科,115,73,42,新百王,2023-08-02,6210
2002,中鋼,43,5,38,新百王,2023-08-02,6210
3325,旭品,124,88,36,新百王,2023-08-02,6210
00665L,富邦�琤肭磪囓�2,35,0,35,新百王,2023-08-02,6210
00675L,富邦臺灣加權正2,33,1,32,新百王,2023-08-02,6210
00919,群益台灣精選高息,31,0,31,新百王,2023-08-02,6210
00795B,中信美國公債20年,30,0,30,新百王,2023-08-02,6210
00862B,中信投資級公司債,30,0,30,新百王,2023-08-02,6210
00706L,期元大S＆P日圓正2,29,0,29,新百王,2023-08-02,6210
3052,夆典,34,10,24,新百王,2023-08-02,6210
2867,三商壽,25,2,23,新百王,2023-08-02,6210
2312,金寶,63,41,22,新百王,2023-08-02,6210
6207,雷科,21,0,21,新百王,2023-08-02,6210
6125,廣運,57,37,20,新百王,2023-08-02,6210
00633L,富邦上証正2,20,0,20,新百王,2023-08-02,6210
00763U,期街口道瓊銅,20,0,20,新百王,2023-08-02,6210
2461,光群雷,20,0,20,新百王,2023-08-02,6210
2891,中信金,19,0,19,新百王,2023-08-02,6210
00631L,元大台灣50正2,20,1,19,新百王,2023-08-02,6210
2392,正崴,19,0,19,新百王,2023-08-02,6210
2409,友達,24,5,19,新百王,2023-08-02,6210
3596,智易,28,9,19,新百王,2023-08-02,6210
8926,台汽電,19,1,18,新百王,2023-08-02,6210
00885,富邦越南,23,5,18,新百王,2023-08-02,6210
2887,台新金,17,0,17,新百王,2023-08-02,6210
3055,蔚華科,17,0,17,新百王,2023-08-02,6210
00751B,元大AAA至A公司債,17,0,17,新百王,2023-08-02,6210
5009,榮剛,17,0,17,新百王,2023-08-02,6210
00862B,中信投資級公司債,246,0,246,新百王,2023-08-04,6210
00878,國泰永續高股息,234,61,173,新百王,2023-08-04,6210
00680L,元大美債20正2,196,40,156,新百王,2023-08-04,6210
1785,光洋科,96,12,84,新百王,2023-08-04,6210
00929,復華台灣科技優息,78,0,78,新百王,2023-08-04,6210
2891,中信金,65,0,65,新百王,2023-08-04,6210
2328,廣宇,62,0,62,新百王,2023-08-04,6210
1609,大亞,86,41,45,新百王,2023-08-04,6210
3325,旭品,68,24,44,新百王,2023-08-04,6210
6223,旺矽,57,14,43,新百王,2023-08-04,6210
2344,華邦電,43,3,40,新百王,2023-08-04,6210
5371,中光電,55,18,37,新百王,2023-08-04,6210
00688L,國泰20年美債正2,77,41,36,新百王,2023-08-04,6210
2010,春源,36,3,33,新百王,2023-08-04,6210
6015,宏遠證,30,0,30,新百王,2023-08-04,6210
00665L,富邦�琤肭磪囓�2,142,112,30,新百王,2023-08-04,6210
2834,臺企銀,30,0,30,新百王,2023-08-04,6210
00687B,國泰20年美債,24,0,24,新百王,2023-08-04,6210
1789,神隆,24,0,24,新百王,2023-08-04,6210
1319,東陽,35,13,22,新百王,2023-08-04,6210
2383,台光電,25,5,20,新百王,2023-08-04,6210
2340,台亞,22,2,20,新百王,2023-08-04,6210
00673R,期元大S＆P原油反1,20,0,20,新百王,2023-08-04,6210
1305,華夏,32,12,20,新百王,2023-08-04,6210
1432,大魯閣,20,0,20,新百王,2023-08-04,6210
00670L,富邦NASDAQ正2,19,1,18,新百王,2023-08-04,6210
2352,佳世達,64,47,17,新百王,2023-08-04,6210
4967,十銓,21,5,16,新百王,2023-08-04,6210
00923,群益台ESG低碳50,15,0,15,新百王,2023-08-04,6210
4716,大立,15,0,15,新百王,2023-08-04,6210
00772B,中信高評級公司債,15,0,15,新百王,2023-08-04,6210
1314,中石化,15,0,15,新百王,2023-08-04,6210
2498,宏達電,22,7,15,新百王,2023-08-04,6210
8150,南茂,16,1,15,新百王,2023-08-04,6210
2890,永豐金,15,0,15,新百王,2023-08-04,6210
00795B,中信美國公債20年,48,34,14,新百王,2023-08-04,6210
8028,昇陽半導體,15,2,13,新百王,2023-08-04,6210
2852,第一保,12,0,12,新百王,2023-08-04,6210
00882,中信中國高股息,12,0,12,新百王,2023-08-04,6210
4746,台耀,13,1,12,新百王,2023-08-04,6210
8021,尖點,11,0,11,新百王,2023-08-04,6210
3580,友威科,15,4,11,新百王,2023-08-04,6210
2313,華通,11,0,11,新百王,2023-08-04,6210
00900,富邦特選高股息30,11,0,11,新百王,2023-08-04,6210
1325,恆大,10,0,10,新百王,2023-08-04,6210
3711,日月光投控,20,10,10,新百王,2023-08-04,6210
3016,嘉晶,10,0,10,新百王,2023-08-04,6210
2029,盛餘,10,0,10,新百王,2023-08-04,6210
1734,杏輝,10,0,10,新百王,2023-08-04,6210
6152,百一,10,0,10,新百王,2023-08-04,6210
00862B,中信投資級公司債,116,0,116,新百王,2023-08-07,6210
8027,鈦昇,104,28,76,新百王,2023-08-07,6210
00900,富邦特選高股息30,74,6,68,新百王,2023-08-07,6210
2317,鴻海,88,27,61,新百王,2023-08-07,6210
00665L,富邦�琤肭磪囓�2,188,128,60,新百王,2023-08-07,6210
5009,榮剛,71,14,57,新百王,2023-08-07,6210
00637L,元大滬深300正2,76,20,56,新百王,2023-08-07,6210
8390,金益鼎,51,1,50,新百王,2023-08-07,6210
00632R,元大台灣50反1,43,0,43,新百王,2023-08-07,6210
2891,中信金,40,0,40,新百王,2023-08-07,6210
8940,新天地,38,0,38,新百王,2023-08-07,6210
00712,復華富時不動產,38,2,36,新百王,2023-08-07,6210
2630,亞航,43,7,36,新百王,2023-08-07,6210
2852,第一保,35,0,35,新百王,2023-08-07,6210
1305,華夏,35,0,35,新百王,2023-08-07,6210
0056,元大高股息,68,33,35,新百王,2023-08-07,6210
00919,群益台灣精選高息,31,0,31,新百王,2023-08-07,6210
1308,亞聚,30,0,30,新百王,2023-08-07,6210
00931B,統一美債20年,58,30,28,新百王,2023-08-07,6210
2303,聯電,29,2,27,新百王,2023-08-07,6210
00688L,國泰20年美債正2,41,15,26,新百王,2023-08-07,6210
2913,農林,81,56,25,新百王,2023-08-07,6210
2358,廷鑫,25,0,25,新百王,2023-08-07,6210
6116,彩晶,52,28,24,新百王,2023-08-07,6210
3715,定穎投控,155,133,22,新百王,2023-08-07,6210
1785,光洋科,32,10,22,新百王,2023-08-07,6210
8926,台汽電,26,5,21,新百王,2023-08-07,6210
00753L,中信中國50正2,21,0,21,新百王,2023-08-07,6210
6125,廣運,139,118,21,新百王,2023-08-07,6210
6223,旺矽,24,3,21,新百王,2023-08-07,6210
1104,環泥,20,0,20,新百王,2023-08-07,6210
3257,虹冠電,23,3,20,新百王,2023-08-07,6210
2204,中華,20,0,20,新百王,2023-08-07,6210
00679B,元大美債20年,40,21,19,新百王,2023-08-07,6210
3017,奇鋐,66,48,18,新百王,2023-08-07,6210
2328,廣宇,18,1,17,新百王,2023-08-07,6210
2409,友達,17,1,16,新百王,2023-08-07,6210
00687B,國泰20年美債,15,0,15,新百王,2023-08-07,6210
1446,宏和,15,0,15,新百王,2023-08-07,6210
5481,新華,14,0,14,新百王,2023-08-07,6210
1605,華新,15,1,14,新百王,2023-08-07,6210
3706,神達,120,106,14,新百王,2023-08-07,6210
2888,新光金,14,0,14,新百王,2023-08-07,6210
00654R,富邦印度反1,13,0,13,新百王,2023-08-07,6210
2882,國泰金,13,0,13,新百王,2023-08-07,6210
2402,毅嘉,20,8,12,新百王,2023-08-07,6210
00795B,中信美國公債20年,12,0,12,新百王,2023-08-07,6210
00772B,中信高評級公司債,11,0,11,新百王,2023-08-07,6210
5508,永信建,13,2,11,新百王,2023-08-07,6210
3051,力特,13,3,10,新百王,2023-08-07,6210
00687B,國泰20年美債,379,0,379,新百王,2023-08-08,6210
00900,富邦特選高股息30,281,1,280,新百王,2023-08-08,6210
2834,臺企銀,241,4,237,新百王,2023-08-08,6210
9934,成霖,180,0,180,新百王,2023-08-08,6210
020033,統一�琤肮黕篾,134,0,134,新百王,2023-08-08,6210
00878,國泰永續高股息,149,23,126,新百王,2023-08-08,6210
2363,矽統,130,21,109,新百王,2023-08-08,6210
00929,復華台灣科技優息,84,4,80,新百王,2023-08-08,6210
4927,泰鼎-KY,80,0,80,新百王,2023-08-08,6210
2883,凱基金,56,1,55,新百王,2023-08-08,6210
8027,鈦昇,88,33,55,新百王,2023-08-08,6210
00919,群益台灣精選高息,54,0,54,新百王,2023-08-08,6210
2888,新光金,61,10,51,新百王,2023-08-08,6210
2356,英業達,142,92,50,新百王,2023-08-08,6210
4207,環泰,50,0,50,新百王,2023-08-08,6210
2501,國建,42,0,42,新百王,2023-08-08,6210
3189,景碩,43,3,40,新百王,2023-08-08,6210
6015,宏遠證,40,0,40,新百王,2023-08-08,6210
5452,佶優,45,7,38,新百王,2023-08-08,6210
00894,中信小資高價30,35,0,35,新百王,2023-08-08,6210
2312,金寶,35,0,35,新百王,2023-08-08,6210
3038,全台,30,3,27,新百王,2023-08-08,6210
2542,興富發,27,3,24,新百王,2023-08-08,6210
5876,上海商銀,47,23,24,新百王,2023-08-08,6210
6016,康和證,22,0,22,新百王,2023-08-08,6210
2408,南亞科,24,2,22,新百王,2023-08-08,6210
2352,佳世達,50,29,21,新百王,2023-08-08,6210
9945,潤泰新,20,0,20,新百王,2023-08-08,6210
00706L,期元大S＆P日圓正2,20,0,20,新百王,2023-08-08,6210
2332,友訊,20,0,20,新百王,2023-08-08,6210
1589,永冠-KY,20,0,20,新百王,2023-08-08,6210
1101,台泥,19,0,19,新百王,2023-08-08,6210
2801,彰銀,18,0,18,新百王,2023-08-08,6210
3231,緯創,253,234,19,新百王,2023-08-08,6210
0050,元大台灣50,31,13,18,新百王,2023-08-08,6210
3706,神達,74,57,17,新百王,2023-08-08,6210
00675L,富邦臺灣加權正2,28,11,17,新百王,2023-08-08,6210
2609,陽明,17,0,17,新百王,2023-08-08,6210
1709,和益,16,0,16,新百王,2023-08-08,6210
00688L,國泰20年美債正2,16,0,16,新百王,2023-08-08,6210
00753L,中信中國50正2,25,10,15,新百王,2023-08-08,6210
3481,群創,25,10,15,新百王,2023-08-08,6210
2601,益航,15,0,15,新百王,2023-08-08,6210
6197,佳必琪,16,1,15,新百王,2023-08-08,6210
2338,光罩,15,0,15,新百王,2023-08-08,6210
2891,中信金,31,17,14,新百王,2023-08-08,6210
2913,農林,50,36,14,新百王,2023-08-08,6210
2344,華邦電,13,0,13,新百王,2023-08-08,6210
6134,萬旭,13,0,13,新百王,2023-08-08,6210
0056,元大高股息,54,42,12,新百王,2023-08-08,6210
00900,富邦特選高股息30,395,0,395,新百王,2023-08-09,6210
00687B,國泰20年美債,376,0,376,新百王,2023-08-09,6210
2645,長榮航太,86,2,84,新百王,2023-08-09,6210
6116,彩晶,56,0,56,新百王,2023-08-09,6210
1217,愛之味,82,28,54,新百王,2023-08-09,6210
2913,農林,66,14,52,新百王,2023-08-09,6210
2891,中信金,67,18,49,新百王,2023-08-09,6210
4744,皇將,54,10,44,新百王,2023-08-09,6210
00929,復華台灣科技優息,40,0,40,新百王,2023-08-09,6210
3325,旭品,47,12,35,新百王,2023-08-09,6210
3231,緯創,196,162,34,新百王,2023-08-09,6210
2414,精技,30,0,30,新百王,2023-08-09,6210
5519,隆大,28,0,28,新百王,2023-08-09,6210
2801,彰銀,26,0,26,新百王,2023-08-09,6210
1609,大亞,40,16,24,新百王,2023-08-09,6210
2328,廣宇,21,0,21,新百王,2023-08-09,6210
4919,新唐,23,2,21,新百王,2023-08-09,6210
020033,統一�琤肮黕篾,21,0,21,新百王,2023-08-09,6210
2352,佳世達,31,10,21,新百王,2023-08-09,6210
2506,太設,20,0,20,新百王,2023-08-09,6210
00919,群益台灣精選高息,17,0,17,新百王,2023-08-09,6210
2201,裕隆,32,16,16,新百王,2023-08-09,6210
2890,永豐金,99,83,16,新百王,2023-08-09,6210
2382,廣達,158,144,14,新百王,2023-08-09,6210
00720B,元大投資級公司債,14,0,14,新百王,2023-08-09,6210
6485,點序,13,0,13,新百王,2023-08-09,6210
6269,台郡,13,0,13,新百王,2023-08-09,6210
00923,群益台ESG低碳50,12,0,12,新百王,2023-08-09,6210
3034,聯詠,15,3,12,新百王,2023-08-09,6210
6122,擎邦,18,6,12,新百王,2023-08-09,6210
00733,富邦臺灣中小,18,6,12,新百王,2023-08-09,6210
2888,新光金,12,0,12,新百王,2023-08-09,6210
00665L,富邦�琤肭磪囓�2,51,40,11,新百王,2023-08-09,6210
1339,昭輝,11,0,11,新百王,2023-08-09,6210
2329,華泰,13,2,11,新百王,2023-08-09,6210
6218,豪勉,10,0,10,新百王,2023-08-09,6210
5498,凱崴,10,0,10,新百王,2023-08-09,6210
00680L,元大美債20正2,50,40,10,新百王,2023-08-09,6210
1103,嘉泥,10,0,10,新百王,2023-08-09,6210
2415,錩新,15,5,10,新百王,2023-08-09,6210
2358,廷鑫,10,0,10,新百王,2023-08-09,6210
6203,海韻電,11,1,10,新百王,2023-08-09,6210
00931B,統一美債20年,20,10,10,新百王,2023-08-09,6210
6288,聯嘉,10,0,10,新百王,2023-08-09,6210
3450,聯鈞,10,0,10,新百王,2023-08-09,6210
3583,辛耘,44,35,9,新百王,2023-08-09,6210
3264,欣銓,9,0,9,新百王,2023-08-09,6210
00772B,中信高評級公司債,15,6,9,新百王,2023-08-09,6210
3206,志豐,10,1,9,新百王,2023-08-09,6210
8086,宏捷科,11,2,9,新百王,2023-08-09,6210
00900,富邦特選高股息30,283,0,283,新百王,2023-08-10,6210
00679B,元大美債20年,134,1,133,新百王,2023-08-10,6210
2323,中環,75,1,74,新百王,2023-08-10,6210
2516,新建,84,10,74,新百王,2023-08-10,6210
00878,國泰永續高股息,117,49,68,新百王,2023-08-10,6210
2867,三商壽,62,8,54,新百王,2023-08-10,6210
00929,復華台灣科技優息,53,0,53,新百王,2023-08-10,6210
3481,群創,180,132,48,新百王,2023-08-10,6210
9945,潤泰新,51,4,47,新百王,2023-08-10,6210
6282,康舒,92,46,46,新百王,2023-08-10,6210
3032,偉訓,51,6,45,新百王,2023-08-10,6210
4934,太極,48,3,45,新百王,2023-08-10,6210
2023,燁輝,45,0,45,新百王,2023-08-10,6210
00706L,期元大S＆P日圓正2,35,0,35,新百王,2023-08-10,6210
00919,群益台灣精選高息,35,0,35,新百王,2023-08-10,6210
2520,冠德,35,1,34,新百王,2023-08-10,6210
1609,大亞,88,55,33,新百王,2023-08-10,6210
2887,台新金,32,0,32,新百王,2023-08-10,6210
1802,台玻,99,68,31,新百王,2023-08-10,6210
2929,淘帝-KY,31,0,31,新百王,2023-08-10,6210
6177,達麗,30,0,30,新百王,2023-08-10,6210
2601,益航,30,0,30,新百王,2023-08-10,6210
3581,博磊,37,12,25,新百王,2023-08-10,6210
2534,宏盛,25,0,25,新百王,2023-08-10,6210
8105,凌巨,25,0,25,新百王,2023-08-10,6210
2371,大同,49,24,25,新百王,2023-08-10,6210
5353,台林,41,16,25,新百王,2023-08-10,6210
2852,第一保,24,1,23,新百王,2023-08-10,6210
6269,台郡,23,0,23,新百王,2023-08-10,6210
2409,友達,22,0,22,新百王,2023-08-10,6210
2421,建準,24,2,22,新百王,2023-08-10,6210
00712,復華富時不動產,21,0,21,新百王,2023-08-10,6210
020033,統一�琤肮黕篾,21,0,21,新百王,2023-08-10,6210
2812,台中銀,21,0,21,新百王,2023-08-10,6210
2352,佳世達,50,30,20,新百王,2023-08-10,6210
00931B,統一美債20年,20,0,20,新百王,2023-08-10,6210
1440,南紡,20,0,20,新百王,2023-08-10,6210
00881,國泰台灣5G+,20,0,20,新百王,2023-08-10,6210
020038,元大ESG配息N,20,0,20,新百王,2023-08-10,6210
2312,金寶,19,0,19,新百王,2023-08-10,6210
4977,眾達-KY,18,0,18,新百王,2023-08-10,6210
00637L,元大滬深300正2,48,30,18,新百王,2023-08-10,6210
2340,台亞,19,1,18,新百王,2023-08-10,6210
6223,旺矽,23,5,18,新百王,2023-08-10,6210
4958,臻鼎-KY,18,1,17,新百王,2023-08-10,6210
3591,艾笛森,20,3,17,新百王,2023-08-10,6210
3715,定穎投控,131,115,16,新百王,2023-08-10,6210
9934,成霖,40,24,16,新百王,2023-08-10,6210
00675L,富邦臺灣加權正2,28,13,15,新百王,2023-08-10,6210
2002,中鋼,16,1,15,新百王,2023-08-10,6210
00900,富邦特選高股息30,278,0,278,新百王,2023-08-11,6210
00725B,國泰投資級公司債,107,0,107,新百王,2023-08-11,6210
00680L,元大美債20正2,103,1,102,新百王,2023-08-11,6210
2890,永豐金,109,11,98,新百王,2023-08-11,6210
6418,詠昇,113,28,85,新百王,2023-08-11,6210
2887,台新金,83,0,83,新百王,2023-08-11,6210
00637L,元大滬深300正2,134,57,77,新百王,2023-08-11,6210
2618,長榮航,121,47,74,新百王,2023-08-11,6210
00795B,中信美國公債20年,70,0,70,新百王,2023-08-11,6210
2412,中華電,76,10,66,新百王,2023-08-11,6210
6547,高端疫苗,95,30,65,新百王,2023-08-11,6210
1319,東陽,60,0,60,新百王,2023-08-11,6210
2330,台積電,55,2,53,新百王,2023-08-11,6210
00931B,統一美債20年,48,5,43,新百王,2023-08-11,6210
2359,所羅門,42,1,41,新百王,2023-08-11,6210
00679B,元大美債20年,41,0,41,新百王,2023-08-11,6210
00706L,期元大S＆P日圓正2,40,0,40,新百王,2023-08-11,6210
3029,零壹,39,1,38,新百王,2023-08-11,6210
00764B,群益25年美債,37,0,37,新百王,2023-08-11,6210
00687B,國泰20年美債,36,0,36,新百王,2023-08-11,6210
00929,復華台灣科技優息,37,2,35,新百王,2023-08-11,6210
2425,承啟,146,114,32,新百王,2023-08-11,6210
6167,久正,30,0,30,新百王,2023-08-11,6210
2465,麗臺,26,0,26,新百王,2023-08-11,6210
00878,國泰永續高股息,24,3,21,新百王,2023-08-11,6210
2516,新建,20,0,20,新百王,2023-08-11,6210
4113,聯上,20,0,20,新百王,2023-08-11,6210
00633L,富邦上証正2,21,1,20,新百王,2023-08-11,6210
2501,國建,20,0,20,新百王,2023-08-11,6210
3162,精確,20,0,20,新百王,2023-08-11,6210
2317,鴻海,19,0,19,新百王,2023-08-11,6210
4958,臻鼎-KY,16,0,16,新百王,2023-08-11,6210
1504,東元,19,3,16,新百王,2023-08-11,6210
8936,國統,17,1,16,新百王,2023-08-11,6210
1101B,台泥乙特,16,0,16,新百王,2023-08-11,6210
2838,聯邦銀,16,0,16,新百王,2023-08-11,6210
2601,益航,20,5,15,新百王,2023-08-11,6210
4303,信立,15,0,15,新百王,2023-08-11,6210
2801,彰銀,14,0,14,新百王,2023-08-11,6210
3483,力致,22,8,14,新百王,2023-08-11,6210
6285,啟��,65,52,13,新百王,2023-08-11,6210
2002,中鋼,13,0,13,新百王,2023-08-11,6210
4909,新復興,12,0,12,新百王,2023-08-11,6210
1514,亞力,14,3,11,新百王,2023-08-11,6210
2498,宏達電,11,0,11,新百王,2023-08-11,6210
2534,宏盛,10,0,10,新百王,2023-08-11,6210
2301,光寶科,72,62,10,新百王,2023-08-11,6210
00696B,富邦美債20年,10,0,10,新百王,2023-08-11,6210
2506,太設,10,0,10,新百王,2023-08-11,6210
2035,唐榮,10,0,10,新百王,2023-08-11,6210
00795B,中信美國公債20年,217,0,217,新百王,2023-08-14,6210
2610,華航,222,81,141,新百王,2023-08-14,6210
00900,富邦特選高股息30,141,0,141,新百王,2023-08-14,6210
00929,復華台灣科技優息,81,5,76,新百王,2023-08-14,6210
2834,臺企銀,65,0,65,新百王,2023-08-14,6210
00878,國泰永續高股息,64,9,55,新百王,2023-08-14,6210
2603,長榮,62,10,52,新百王,2023-08-14,6210
2607,榮運,50,4,46,新百王,2023-08-14,6210
2002,中鋼,37,1,36,新百王,2023-08-14,6210
2727,王品,38,2,36,新百王,2023-08-14,6210
2442,新美齊,46,10,36,新百王,2023-08-14,6210
00923,群益台ESG低碳50,36,0,36,新百王,2023-08-14,6210
1513,中興電,97,63,34,新百王,2023-08-14,6210
1709,和益,32,0,32,新百王,2023-08-14,6210
2412,中華電,31,1,30,新百王,2023-08-14,6210
3715,定穎投控,162,135,27,新百王,2023-08-14,6210
6695,芯鼎,26,0,26,新百王,2023-08-14,6210
2408,南亞科,28,3,25,新百王,2023-08-14,6210
3092,鴻碩,25,0,25,新百王,2023-08-14,6210
2329,華泰,24,2,22,新百王,2023-08-14,6210
2929,淘帝-KY,22,0,22,新百王,2023-08-14,6210
1444,力麗,32,10,22,新百王,2023-08-14,6210
2888,新光金,22,0,22,新百王,2023-08-14,6210
2605,新興,21,0,21,新百王,2023-08-14,6210
1785,光洋科,21,0,21,新百王,2023-08-14,6210
2851,中再保,22,1,21,新百王,2023-08-14,6210
2344,華邦電,24,3,21,新百王,2023-08-14,6210
00675L,富邦臺灣加權正2,25,5,20,新百王,2023-08-14,6210
00919,群益台灣精選高息,20,0,20,新百王,2023-08-14,6210
2414,精技,19,0,19,新百王,2023-08-14,6210
5009,榮剛,20,1,19,新百王,2023-08-14,6210
1713,國化,17,0,17,新百王,2023-08-14,6210
2891,中信金,16,0,16,新百王,2023-08-14,6210
6418,詠昇,17,1,16,新百王,2023-08-14,6210
2501,國建,15,0,15,新百王,2023-08-14,6210
9940,信義,15,0,15,新百王,2023-08-14,6210
2903,遠百,14,0,14,新百王,2023-08-14,6210
00631L,元大台灣50正2,14,0,14,新百王,2023-08-14,6210
00753L,中信中國50正2,13,0,13,新百王,2023-08-14,6210
4934,太極,18,5,13,新百王,2023-08-14,6210
1802,台玻,79,66,13,新百王,2023-08-14,6210
2882,國泰金,13,0,13,新百王,2023-08-14,6210
00665L,富邦�琤肭磪囓�2,72,60,12,新百王,2023-08-14,6210
3325,旭品,42,30,12,新百王,2023-08-14,6210
2421,建準,24,12,12,新百王,2023-08-14,6210
8916,光隆,12,0,12,新百王,2023-08-14,6210
1319,東陽,71,60,11,新百王,2023-08-14,6210
1609,大亞,24,13,11,新百王,2023-08-14,6210
6125,廣運,35,24,11,新百王,2023-08-14,6210
4541,晟田,10,0,10,新百王,2023-08-14,6210
2851,中再保,209,0,209,新百王,2023-08-15,6210
1102,亞泥,100,0,100,新百王,2023-08-15,6210
9105,泰金寶-DR,100,0,100,新百王,2023-08-15,6210
00929,復華台灣科技優息,72,1,71,新百王,2023-08-15,6210
2317,鴻海,71,1,70,新百王,2023-08-15,6210
00687B,國泰20年美債,67,0,67,新百王,2023-08-15,6210
00900,富邦特選高股息30,58,5,53,新百王,2023-08-15,6210
4707,磐亞,50,0,50,新百王,2023-08-15,6210
00923,群益台ESG低碳50,50,0,50,新百王,2023-08-15,6210
2801,彰銀,44,0,44,新百王,2023-08-15,6210
9934,成霖,49,6,43,新百王,2023-08-15,6210
2359,所羅門,62,23,39,新百王,2023-08-15,6210
2501,國建,30,0,30,新百王,2023-08-15,6210
1217,愛之味,29,0,29,新百王,2023-08-15,6210
2027,大成鋼,39,12,27,新百王,2023-08-15,6210
2887,台新金,27,0,27,新百王,2023-08-15,6210
2891,中信金,41,20,21,新百王,2023-08-15,6210
2412,中華電,21,0,21,新百王,2023-08-15,6210
00878,國泰永續高股息,33,12,21,新百王,2023-08-15,6210
00679B,元大美債20年,20,0,20,新百王,2023-08-15,6210
00859B,群益0-1年美債,20,0,20,新百王,2023-08-15,6210
2883,凱基金,22,3,19,新百王,2023-08-15,6210
2358,廷鑫,18,0,18,新百王,2023-08-15,6210
3706,神達,86,69,17,新百王,2023-08-15,6210
5353,台林,16,0,16,新百王,2023-08-15,6210
2344,華邦電,26,10,16,新百王,2023-08-15,6210
9945,潤泰新,15,0,15,新百王,2023-08-15,6210
4938,和碩,15,0,15,新百王,2023-08-15,6210
00756B,群益投等新興公債,15,0,15,新百王,2023-08-15,6210
2834,臺企銀,14,0,14,新百王,2023-08-15,6210
1802,台玻,111,97,14,新百王,2023-08-15,6210
2002,中鋼,15,2,13,新百王,2023-08-15,6210
6134,萬旭,12,0,12,新百王,2023-08-15,6210
0050,元大台灣50,21,9,12,新百王,2023-08-15,6210
8112A,至上甲特,11,0,11,新百王,2023-08-15,6210
00670L,富邦NASDAQ正2,11,0,11,新百王,2023-08-15,6210
1314,中石化,10,0,10,新百王,2023-08-15,6210
4401,東隆興,10,0,10,新百王,2023-08-15,6210
3231,緯創,136,127,9,新百王,2023-08-15,6210
2884,玉山金,9,0,9,新百王,2023-08-15,6210
2615,萬海,20,11,9,新百王,2023-08-15,6210
2880,華南金,9,0,9,新百王,2023-08-15,6210
5519,隆大,9,0,9,新百王,2023-08-15,6210
2460,建通,25,16,9,新百王,2023-08-15,6210
8038,長園科,10,1,9,新百王,2023-08-15,6210
3078,僑威,74,66,8,新百王,2023-08-15,6210
00722B,群益投資級電信債,8,0,8,新百王,2023-08-15,6210
00931B,統一美債20年,7,0,7,新百王,2023-08-15,6210
6116,彩晶,60,53,7,新百王,2023-08-15,6210
00907,永豐優息存股,6,0,6,新百王,2023-08-15,6210
2851,中再保,175,0,175,新百王,2023-08-16,6210
2610,華航,148,50,98,新百王,2023-08-16,6210
3481,群創,127,50,77,新百王,2023-08-16,6210
2002,中鋼,74,1,73,新百王,2023-08-16,6210
00929,復華台灣科技優息,119,47,72,新百王,2023-08-16,6210
9934,成霖,69,0,69,新百王,2023-08-16,6210
1609,大亞,112,45,67,新百王,2023-08-16,6210
2301,光寶科,104,42,62,新百王,2023-08-16,6210
4707,磐亞,60,0,60,新百王,2023-08-16,6210
2363,矽統,233,176,57,新百王,2023-08-16,6210
00878,國泰永續高股息,48,0,48,新百王,2023-08-16,6210
00753L,中信中國50正2,45,0,45,新百王,2023-08-16,6210
00923,群益台ESG低碳50,42,0,42,新百王,2023-08-16,6210
2836,高雄銀,37,0,37,新百王,2023-08-16,6210
1802,台玻,219,185,34,新百王,2023-08-16,6210
3035,智原,88,63,25,新百王,2023-08-16,6210
2303,聯電,25,1,24,新百王,2023-08-16,6210
2442,新美齊,32,8,24,新百王,2023-08-16,6210
3706,神達,48,26,22,新百王,2023-08-16,6210
00895,富邦未來車,20,0,20,新百王,2023-08-16,6210
2380,虹光,20,0,20,新百王,2023-08-16,6210
00665L,富邦�琤肭磪囓�2,284,264,20,新百王,2023-08-16,6210
8443,阿瘦,20,0,20,新百王,2023-08-16,6210
2027,大成鋼,35,15,20,新百王,2023-08-16,6210
4207,環泰,24,5,19,新百王,2023-08-16,6210
2880,華南金,19,0,19,新百王,2023-08-16,6210
00772B,中信高評級公司債,19,0,19,新百王,2023-08-16,6210
00919,群益台灣精選高息,18,0,18,新百王,2023-08-16,6210
2618,長榮航,147,129,18,新百王,2023-08-16,6210
1305,華夏,20,2,18,新百王,2023-08-16,6210
3276,宇環,16,0,16,新百王,2023-08-16,6210
00751B,元大AAA至A公司債,16,0,16,新百王,2023-08-16,6210
2313,華通,17,2,15,新百王,2023-08-16,6210
2884,玉山金,17,2,15,新百王,2023-08-16,6210
00900,富邦特選高股息30,14,0,14,新百王,2023-08-16,6210
00795B,中信美國公債20年,13,0,13,新百王,2023-08-16,6210
2886,兆豐金,13,0,13,新百王,2023-08-16,6210
6116,彩晶,17,4,13,新百王,2023-08-16,6210
00632R,元大台灣50反1,19,7,12,新百王,2023-08-16,6210
6418,詠昇,12,0,12,新百王,2023-08-16,6210
3071,協禧,17,5,12,新百王,2023-08-16,6210
2329,華泰,28,16,12,新百王,2023-08-16,6210
2883,凱基金,12,0,12,新百王,2023-08-16,6210
1471,首利,17,6,11,新百王,2023-08-16,6210
6754,匯僑設計,11,0,11,新百王,2023-08-16,6210
2852,第一保,22,11,11,新百王,2023-08-16,6210
6126,信音,10,0,10,新百王,2023-08-16,6210
4414,如興,10,0,10,新百王,2023-08-16,6210
2399,映泰,11,1,10,新百王,2023-08-16,6210
2888,新光金,9,0,9,新百王,2023-08-16,6210
2892,第一金,200,0,200,新百王,2023-08-17,6210
2883B,凱基金乙特,112,0,112,新百王,2023-08-17,6210
0056,元大高股息,73,3,70,新百王,2023-08-17,6210
00687B,國泰20年美債,64,0,64,新百王,2023-08-17,6210
4510,高鋒,60,0,60,新百王,2023-08-17,6210
2402,毅嘉,82,22,60,新百王,2023-08-17,6210
2412,中華電,65,10,55,新百王,2023-08-17,6210
2344,華邦電,56,6,50,新百王,2023-08-17,6210
4707,磐亞,50,0,50,新百王,2023-08-17,6210
2891,中信金,59,13,46,新百王,2023-08-17,6210
00931B,統一美債20年,50,5,45,新百王,2023-08-17,6210
00637L,元大滬深300正2,41,0,41,新百王,2023-08-17,6210
6418,詠昇,41,3,38,新百王,2023-08-17,6210
00862B,中信投資級公司債,36,0,36,新百王,2023-08-17,6210
2474,可成,29,0,29,新百王,2023-08-17,6210
6188,廣明,61,32,29,新百王,2023-08-17,6210
3044,健鼎,57,28,29,新百王,2023-08-17,6210
00706L,期元大S＆P日圓正2,25,0,25,新百王,2023-08-17,6210
00753L,中信中國50正2,35,11,24,新百王,2023-08-17,6210
1471,首利,26,3,23,新百王,2023-08-17,6210
5009,榮剛,36,14,22,新百王,2023-08-17,6210
00632R,元大台灣50反1,30,8,22,新百王,2023-08-17,6210
9907,統一實,19,0,19,新百王,2023-08-17,6210
3042,晶技,33,14,19,新百王,2023-08-17,6210
2371,大同,31,13,18,新百王,2023-08-17,6210
00929,復華台灣科技優息,55,38,17,新百王,2023-08-17,6210
2480,敦陽科,18,3,15,新百王,2023-08-17,6210
1789,神隆,15,0,15,新百王,2023-08-17,6210
00885,富邦越南,15,0,15,新百王,2023-08-17,6210
2486,一詮,16,1,15,新百王,2023-08-17,6210
2303,聯電,27,13,14,新百王,2023-08-17,6210
1504,東元,16,2,14,新百王,2023-08-17,6210
00795B,中信美國公債20年,14,0,14,新百王,2023-08-17,6210
00679B,元大美債20年,13,0,13,新百王,2023-08-17,6210
1101,台泥,13,0,13,新百王,2023-08-17,6210
00751B,元大AAA至A公司債,12,0,12,新百王,2023-08-17,6210
9945,潤泰新,12,0,12,新百王,2023-08-17,6210
00830,國泰費城半導體,12,0,12,新百王,2023-08-17,6210
6770,力積電,15,3,12,新百王,2023-08-17,6210
4909,新復興,12,0,12,新百王,2023-08-17,6210
2890,永豐金,14,2,12,新百王,2023-08-17,6210
2449,京元電子,13,2,11,新百王,2023-08-17,6210
3308,聯德,21,10,11,新百王,2023-08-17,6210
6197,佳必琪,10,0,10,新百王,2023-08-17,6210
1589,永冠-KY,10,0,10,新百王,2023-08-17,6210
3483,力致,54,44,10,新百王,2023-08-17,6210
2201,裕隆,15,5,10,新百王,2023-08-17,6210
2206,三陽工業,11,1,10,新百王,2023-08-17,6210
3325,旭品,35,25,10,新百王,2023-08-17,6210
5864,致和證,10,0,10,新百王,2023-08-17,6210
2851,中再保,428,0,428,新百王,2023-08-18,6210
2363,矽統,475,307,168,新百王,2023-08-18,6210
00753L,中信中國50正2,141,0,141,新百王,2023-08-18,6210
2887,台新金,118,2,116,新百王,2023-08-18,6210
2610,華航,219,103,116,新百王,2023-08-18,6210
00650L,復華香港正2,110,0,110,新百王,2023-08-18,6210
1609,大亞,111,25,86,新百王,2023-08-18,6210
2888,新光金,90,10,80,新百王,2023-08-18,6210
3231,緯創,202,125,77,新百王,2023-08-18,6210
00929,復華台灣科技優息,86,17,69,新百王,2023-08-18,6210
2382,廣達,227,161,66,新百王,2023-08-18,6210
3043,科風,75,11,64,新百王,2023-08-18,6210
9934,成霖,50,0,50,新百王,2023-08-18,6210
2323,中環,50,2,48,新百王,2023-08-18,6210
1217,愛之味,61,21,40,新百王,2023-08-18,6210
2516,新建,50,10,40,新百王,2023-08-18,6210
00882,中信中國高股息,39,0,39,新百王,2023-08-18,6210
4744,皇將,47,10,37,新百王,2023-08-18,6210
00679B,元大美債20年,36,0,36,新百王,2023-08-18,6210
6156,松上,30,0,30,新百王,2023-08-18,6210
2353,宏��,39,9,30,新百王,2023-08-18,6210
00688L,國泰20年美債正2,26,0,26,新百王,2023-08-18,6210
3163,波若威,45,22,23,新百王,2023-08-18,6210
2891,中信金,35,12,23,新百王,2023-08-18,6210
2301,光寶科,81,59,22,新百王,2023-08-18,6210
3706,神達,156,134,22,新百王,2023-08-18,6210
00665L,富邦�琤肭磪囓�2,157,137,20,新百王,2023-08-18,6210
2801,彰銀,20,0,20,新百王,2023-08-18,6210
3078,僑威,43,25,18,新百王,2023-08-18,6210
2852,第一保,19,1,18,新百王,2023-08-18,6210
2330,台積電,17,0,17,新百王,2023-08-18,6210
2409,友達,67,50,17,新百王,2023-08-18,6210
6741,91APP*-KY,15,0,15,新百王,2023-08-18,6210
6418,詠昇,20,5,15,新百王,2023-08-18,6210
2425,承啟,28,15,13,新百王,2023-08-18,6210
3189,景碩,36,23,13,新百王,2023-08-18,6210
6125,廣運,24,12,12,新百王,2023-08-18,6210
6547,高端疫苗,16,4,12,新百王,2023-08-18,6210
2027,大成鋼,28,16,12,新百王,2023-08-18,6210
6126,信音,12,1,11,新百王,2023-08-18,6210
2352,佳世達,36,25,11,新百王,2023-08-18,6210
2812,台中銀,21,10,11,新百王,2023-08-18,6210
6231,系微,17,6,11,新百王,2023-08-18,6210
5880,合庫金,10,0,10,新百王,2023-08-18,6210
2421,建準,62,52,10,新百王,2023-08-18,6210
1314,中石化,10,0,10,新百王,2023-08-18,6210
2313,華通,10,0,10,新百王,2023-08-18,6210
9105,泰金寶-DR,10,0,10,新百王,2023-08-18,6210
3042,晶技,33,23,10,新百王,2023-08-18,6210
00895,富邦未來車,10,0,10,新百王,2023-08-18,6210
2888,新光金,160,42,118,新百王,2023-08-21,6210
6418,詠昇,106,22,84,新百王,2023-08-21,6210
1808,潤隆,84,21,63,新百王,2023-08-21,6210
1802,台玻,194,144,50,新百王,2023-08-21,6210
2603,長榮,57,11,46,新百王,2023-08-21,6210
2412,中華電,65,25,40,新百王,2023-08-21,6210
6284,佳邦,42,6,36,新百王,2023-08-21,6210
00687B,國泰20年美債,35,0,35,新百王,2023-08-21,6210
2606,裕民,65,31,34,新百王,2023-08-21,6210
6443,元晶,31,0,31,新百王,2023-08-21,6210
8240,華宏,30,0,30,新百王,2023-08-21,6210
8171,天宇,30,0,30,新百王,2023-08-21,6210
2374,佳能,24,0,24,新百王,2023-08-21,6210
00637L,元大滬深300正2,39,16,23,新百王,2023-08-21,6210
1471,首利,23,0,23,新百王,2023-08-21,6210
00929,復華台灣科技優息,58,36,22,新百王,2023-08-21,6210
4906,正文,52,30,22,新百王,2023-08-21,6210
4909,新復興,20,0,20,新百王,2023-08-21,6210
9105,泰金寶-DR,20,0,20,新百王,2023-08-21,6210
6285,啟��,55,38,17,新百王,2023-08-21,6210
2402,毅嘉,27,11,16,新百王,2023-08-21,6210
2834,臺企銀,17,1,16,新百王,2023-08-21,6210
2890,永豐金,17,1,16,新百王,2023-08-21,6210
00631L,元大台灣50正2,24,8,16,新百王,2023-08-21,6210
00680L,元大美債20正2,15,0,15,新百王,2023-08-21,6210
3306,鼎天,36,21,15,新百王,2023-08-21,6210
2605,新興,65,50,15,新百王,2023-08-21,6210
2002,中鋼,16,3,13,新百王,2023-08-21,6210
2881,富邦金,16,3,13,新百王,2023-08-21,6210
2301,光寶科,29,16,13,新百王,2023-08-21,6210
2419,仲琦,13,0,13,新百王,2023-08-21,6210
3189,景碩,14,1,13,新百王,2023-08-21,6210
3029,零壹,13,0,13,新百王,2023-08-21,6210
2615,萬海,16,3,13,新百王,2023-08-21,6210
1301,台塑,12,0,12,新百王,2023-08-21,6210
3042,晶技,25,13,12,新百王,2023-08-21,6210
3285,微端,12,0,12,新百王,2023-08-21,6210
6108,競國,12,0,12,新百王,2023-08-21,6210
4919,新唐,12,0,12,新百王,2023-08-21,6210
3706,神達,38,27,11,新百王,2023-08-21,6210
5481,新華,11,0,11,新百王,2023-08-21,6210
1101,台泥,11,0,11,新百王,2023-08-21,6210
3276,宇環,10,0,10,新百王,2023-08-21,6210
00931B,統一美債20年,10,0,10,新百王,2023-08-21,6210
8409,商之器,10,0,10,新百王,2023-08-21,6210
3078,僑威,15,5,10,新百王,2023-08-21,6210
2520,冠德,9,0,9,新百王,2023-08-21,6210
5244,弘凱,9,0,9,新百王,2023-08-21,6210
00733,富邦臺灣中小,9,0,9,新百王,2023-08-21,6210
9919,康那香,9,0,9,新百王,2023-08-21,6210
00665L,富邦�琤肭磪囓�2,108,30,78,新百王,2023-08-22,6210
2002,中鋼,69,0,69,新百王,2023-08-22,6210
2324,仁寶,88,20,68,新百王,2023-08-22,6210
00862B,中信投資級公司債,55,0,55,新百王,2023-08-22,6210
2402,毅嘉,57,5,52,新百王,2023-08-22,6210
2332,友訊,111,63,48,新百王,2023-08-22,6210
8240,華宏,48,0,48,新百王,2023-08-22,6210
6116,彩晶,92,52,40,新百王,2023-08-22,6210
2852,第一保,37,2,35,新百王,2023-08-22,6210
6418,詠昇,39,5,34,新百王,2023-08-22,6210
2851,中再保,30,0,30,新百王,2023-08-22,6210
2401,凌陽,53,25,28,新百王,2023-08-22,6210
2340,台亞,27,1,26,新百王,2023-08-22,6210
2890,永豐金,30,4,26,新百王,2023-08-22,6210
2630,亞航,24,0,24,新百王,2023-08-22,6210
00637L,元大滬深300正2,36,12,24,新百王,2023-08-22,6210
6531,愛普*,32,9,23,新百王,2023-08-22,6210
9945,潤泰新,22,0,22,新百王,2023-08-22,6210
1217,愛之味,22,0,22,新百王,2023-08-22,6210
00929,復華台灣科技優息,22,1,21,新百王,2023-08-22,6210
1609,大亞,57,36,21,新百王,2023-08-22,6210
6548,長科*,21,1,20,新百王,2023-08-22,6210
5009,榮剛,20,1,19,新百王,2023-08-22,6210
2888,新光金,20,3,17,新百王,2023-08-22,6210
2881,富邦金,17,0,17,新百王,2023-08-22,6210
00687B,國泰20年美債,16,0,16,新百王,2023-08-22,6210
2412,中華電,40,24,16,新百王,2023-08-22,6210
2027,大成鋼,41,25,16,新百王,2023-08-22,6210
2891,中信金,17,1,16,新百王,2023-08-22,6210
4938,和碩,19,4,15,新百王,2023-08-22,6210
3163,波若威,58,44,14,新百王,2023-08-22,6210
5608,四維航,16,2,14,新百王,2023-08-22,6210
1605,華新,22,8,14,新百王,2023-08-22,6210
1513,中興電,16,3,13,新百王,2023-08-22,6210
3032,偉訓,15,2,13,新百王,2023-08-22,6210
6170,統振,20,7,13,新百王,2023-08-22,6210
5519,隆大,13,0,13,新百王,2023-08-22,6210
2356,英業達,57,46,11,新百王,2023-08-22,6210
2382,廣達,97,87,10,新百王,2023-08-22,6210
2885,元大金,10,0,10,新百王,2023-08-22,6210
8070,長華*,10,0,10,新百王,2023-08-22,6210
2929,淘帝-KY,10,0,10,新百王,2023-08-22,6210
6143,振曜,10,0,10,新百王,2023-08-22,6210
9105,泰金寶-DR,10,0,10,新百王,2023-08-22,6210
3078,僑威,22,12,10,新百王,2023-08-22,6210
1416,廣豐,9,0,9,新百王,2023-08-22,6210
2618,長榮航,48,39,9,新百王,2023-08-22,6210
00679B,元大美債20年,9,0,9,新百王,2023-08-22,6210
4979,華星光,41,32,9,新百王,2023-08-22,6210
3056,富華新,8,0,8,新百王,2023-08-22,6210
00857B,永豐20年美公債,165,0,165,新百王,2023-08-23,6210
2610,華航,246,117,129,新百王,2023-08-23,6210
2883B,凱基金乙特,100,0,100,新百王,2023-08-23,6210
3311,閎暉,114,47,67,新百王,2023-08-23,6210
4707,磐亞,61,0,61,新百王,2023-08-23,6210
2883,凱基金,40,0,40,新百王,2023-08-23,6210
8240,華宏,36,0,36,新百王,2023-08-23,6210
2615,萬海,48,22,26,新百王,2023-08-23,6210
2355,敬鵬,33,9,24,新百王,2023-08-23,6210
00795B,中信美國公債20年,24,0,24,新百王,2023-08-23,6210
6443,元晶,26,2,24,新百王,2023-08-23,6210
2618,長榮航,113,90,23,新百王,2023-08-23,6210
6415,矽力*-KY,22,0,22,新百王,2023-08-23,6210
3325,旭品,24,2,22,新百王,2023-08-23,6210
3264,欣銓,27,6,21,新百王,2023-08-23,6210
1737,臺鹽,22,2,20,新百王,2023-08-23,6210
2344,華邦電,25,5,20,新百王,2023-08-23,6210
4543,萬在,26,6,20,新百王,2023-08-23,6210
2428,興勤,20,0,20,新百王,2023-08-23,6210
8926,台汽電,20,0,20,新百王,2023-08-23,6210
6167,久正,71,52,19,新百王,2023-08-23,6210
5608,四維航,31,12,19,新百王,2023-08-23,6210
6282,康舒,35,18,17,新百王,2023-08-23,6210
3232,昱捷,18,1,17,新百王,2023-08-23,6210
3042,晶技,24,9,15,新百王,2023-08-23,6210
3231,緯創,76,63,13,新百王,2023-08-23,6210
00720B,元大投資級公司債,12,0,12,新百王,2023-08-23,6210
2605,新興,20,9,11,新百王,2023-08-23,6210
3163,波若威,101,90,11,新百王,2023-08-23,6210
00878,國泰永續高股息,20,10,10,新百王,2023-08-23,6210
8443,阿瘦,10,0,10,新百王,2023-08-23,6210
2358,廷鑫,10,0,10,新百王,2023-08-23,6210
3521,鴻翊,10,0,10,新百王,2023-08-23,6210
00907,永豐優息存股,10,0,10,新百王,2023-08-23,6210
3013,晟銘電,234,224,10,新百王,2023-08-23,6210
6418,詠昇,48,38,10,新百王,2023-08-23,6210
8409,商之器,10,0,10,新百王,2023-08-23,6210
9105,泰金寶-DR,10,0,10,新百王,2023-08-23,6210
2002,中鋼,9,0,9,新百王,2023-08-23,6210
2520,冠德,9,0,9,新百王,2023-08-23,6210
3257,虹冠電,8,0,8,新百王,2023-08-23,6210
8227,巨有科技,9,2,7,新百王,2023-08-23,6210
6753,龍德造船,7,0,7,新百王,2023-08-23,6210
3338,泰碩,7,0,7,新百王,2023-08-23,6210
2611,志信,7,0,7,新百王,2023-08-23,6210
00713,元大台灣高息低波,6,0,6,新百王,2023-08-23,6210
2882,國泰金,6,0,6,新百王,2023-08-23,6210
3689,湧德,16,10,6,新百王,2023-08-23,6210
5521,工信,6,0,6,新百王,2023-08-23,6210
6125,廣運,76,70,6,新百王,2023-08-23,6210
2324,仁寶,411,36,375,新百王,2023-08-24,6210
3231,緯創,388,228,160,新百王,2023-08-24,6210
2363,矽統,571,424,147,新百王,2023-08-24,6210
2883,凱基金,117,0,117,新百王,2023-08-24,6210
3521,鴻翊,96,0,96,新百王,2023-08-24,6210
00929,復華台灣科技優息,151,67,84,新百王,2023-08-24,6210
00795B,中信美國公債20年,93,10,83,新百王,2023-08-24,6210
2888,新光金,67,0,67,新百王,2023-08-24,6210
00751B,元大AAA至A公司債,66,0,66,新百王,2023-08-24,6210
3029,零壹,62,1,61,新百王,2023-08-24,6210
2312,金寶,61,6,55,新百王,2023-08-24,6210
9934,成霖,50,0,50,新百王,2023-08-24,6210
00857B,永豐20年美公債,50,0,50,新百王,2023-08-24,6210
3206,志豐,49,1,48,新百王,2023-08-24,6210
2607,榮運,40,0,40,新百王,2023-08-24,6210
00632R,元大台灣50反1,40,0,40,新百王,2023-08-24,6210
00688L,國泰20年美債正2,40,1,39,新百王,2023-08-24,6210
2603,長榮,66,29,37,新百王,2023-08-24,6210
00670L,富邦NASDAQ正2,34,0,34,新百王,2023-08-24,6210
2356,英業達,91,61,30,新百王,2023-08-24,6210
2890,永豐金,30,1,29,新百王,2023-08-24,6210
1217,愛之味,29,0,29,新百王,2023-08-24,6210
4207,環泰,30,5,25,新百王,2023-08-24,6210
00676R,富邦臺灣加權反1,25,0,25,新百王,2023-08-24,6210
8011,台通,26,2,24,新百王,2023-08-24,6210
2485,兆赫,72,48,24,新百王,2023-08-24,6210
2401,凌陽,26,5,21,新百王,2023-08-24,6210
2206,三陽工業,21,1,20,新百王,2023-08-24,6210
3325,旭品,25,5,20,新百王,2023-08-24,6210
5519,隆大,18,0,18,新百王,2023-08-24,6210
1609,大亞,40,24,16,新百王,2023-08-24,6210
6216,居易,15,0,15,新百王,2023-08-24,6210
8034,榮群,15,0,15,新百王,2023-08-24,6210
2615,萬海,46,32,14,新百王,2023-08-24,6210
2344,華邦電,21,7,14,新百王,2023-08-24,6210
9962,有益,14,0,14,新百王,2023-08-24,6210
6274,台燿,19,6,13,新百王,2023-08-24,6210
4908,前鼎,19,6,13,新百王,2023-08-24,6210
00923,群益台ESG低碳50,13,0,13,新百王,2023-08-24,6210
2419,仲琦,55,42,13,新百王,2023-08-24,6210
00665L,富邦�琤肭磪囓�2,12,0,12,新百王,2023-08-24,6210
5215,科嘉-KY,12,0,12,新百王,2023-08-24,6210
6125,廣運,51,39,12,新百王,2023-08-24,6210
2402,毅嘉,14,3,11,新百王,2023-08-24,6210
2462,良得電,11,0,11,新百王,2023-08-24,6210
4909,新復興,11,0,11,新百王,2023-08-24,6210
00753L,中信中國50正2,13,2,11,新百王,2023-08-24,6210
2834,臺企銀,10,0,10,新百王,2023-08-24,6210
2208,台船,12,2,10,新百王,2023-08-24,6210
2850,新產,10,0,10,新百王,2023-08-24,6210
9962,有益,128,0,128,新百王,2023-08-25,6210
2363,矽統,614,490,124,新百王,2023-08-25,6210
2701,萬企,100,0,100,新百王,2023-08-25,6210
2634,漢翔,211,113,98,新百王,2023-08-25,6210
8011,台通,123,29,94,新百王,2023-08-25,6210
2630,亞航,87,7,80,新百王,2023-08-25,6210
00878,國泰永續高股息,89,12,77,新百王,2023-08-25,6210
2412,中華電,84,14,70,新百王,2023-08-25,6210
4707,磐亞,67,0,67,新百王,2023-08-25,6210
1471,首利,65,0,65,新百王,2023-08-25,6210
2610,華航,123,63,60,新百王,2023-08-25,6210
2382,廣達,151,92,59,新百王,2023-08-25,6210
2890,永豐金,59,3,56,新百王,2023-08-25,6210
3231,緯創,193,139,54,新百王,2023-08-25,6210
00919,群益台灣精選高息,45,0,45,新百王,2023-08-25,6210
6418,詠昇,40,0,40,新百王,2023-08-25,6210
2888,新光金,40,7,33,新百王,2023-08-25,6210
2892,第一金,31,0,31,新百王,2023-08-25,6210
2324,仁寶,43,14,29,新百王,2023-08-25,6210
2329,華泰,40,19,21,新百王,2023-08-25,6210
00881,國泰台灣5G+,20,0,20,新百王,2023-08-25,6210
3044,健鼎,25,7,18,新百王,2023-08-25,6210
3078,僑威,22,4,18,新百王,2023-08-25,6210
2736,富野,27,11,16,新百王,2023-08-25,6210
3483,力致,20,4,16,新百王,2023-08-25,6210
6284,佳邦,32,17,15,新百王,2023-08-25,6210
2415,錩新,15,0,15,新百王,2023-08-25,6210
00900,富邦特選高股息30,15,0,15,新百王,2023-08-25,6210
0056,元大高股息,15,0,15,新百王,2023-08-25,6210
00670L,富邦NASDAQ正2,14,0,14,新百王,2023-08-25,6210
1504,東元,14,1,13,新百王,2023-08-25,6210
3325,旭品,19,6,13,新百王,2023-08-25,6210
8478,東哥遊艇,12,0,12,新百王,2023-08-25,6210
2303,聯電,13,2,11,新百王,2023-08-25,6210
1301,台塑,11,0,11,新百王,2023-08-25,6210
3004,豐達科,16,5,11,新百王,2023-08-25,6210
2449,京元電子,40,29,11,新百王,2023-08-25,6210
8927,北基,16,5,11,新百王,2023-08-25,6210
00637L,元大滬深300正2,16,5,11,新百王,2023-08-25,6210
4543,萬在,21,11,10,新百王,2023-08-25,6210
00680L,元大美債20正2,10,0,10,新百王,2023-08-25,6210
1710,東聯,10,0,10,新百王,2023-08-25,6210
00895,富邦未來車,10,0,10,新百王,2023-08-25,6210
00632R,元大台灣50反1,10,0,10,新百王,2023-08-25,6210
2607,榮運,10,0,10,新百王,2023-08-25,6210
2601,益航,10,0,10,新百王,2023-08-25,6210
5347,世界,11,2,9,新百王,2023-08-25,6210
1339,昭輝,12,3,9,新百王,2023-08-25,6210
3689,湧德,11,2,9,新百王,2023-08-25,6210
00830,國泰費城半導體,9,0,9,新百王,2023-08-25,6210
3481,群創,324,9,315,新百王,2023-08-28,6210
2610,華航,81,12,69,新百王,2023-08-28,6210
00929,復華台灣科技優息,70,5,65,新百王,2023-08-28,6210
2355,敬鵬,63,2,61,新百王,2023-08-28,6210
9962,有益,60,0,60,新百王,2023-08-28,6210
1609,大亞,80,21,59,新百王,2023-08-28,6210
5225,東科-KY,57,0,57,新百王,2023-08-28,6210
2365,昆盈,50,0,50,新百王,2023-08-28,6210
2392,正崴,153,106,47,新百王,2023-08-28,6210
2402,毅嘉,45,1,44,新百王,2023-08-28,6210
2886,兆豐金,50,7,43,新百王,2023-08-28,6210
3325,旭品,36,3,33,新百王,2023-08-28,6210
00706L,期元大S＆P日圓正2,30,0,30,新百王,2023-08-28,6210
3308,聯德,51,22,29,新百王,2023-08-28,6210
2852,第一保,46,18,28,新百王,2023-08-28,6210
6168,宏齊,36,10,26,新百王,2023-08-28,6210
2382,廣達,103,81,22,新百王,2023-08-28,6210
3264,欣銓,29,7,22,新百王,2023-08-28,6210
2603,長榮,31,9,22,新百王,2023-08-28,6210
1465,偉全,20,0,20,新百王,2023-08-28,6210
9105,泰金寶-DR,20,0,20,新百王,2023-08-28,6210
3521,鴻翊,20,0,20,新百王,2023-08-28,6210
00632R,元大台灣50反1,20,0,20,新百王,2023-08-28,6210
3305,昇貿,23,5,18,新百王,2023-08-28,6210
4906,正文,85,67,18,新百王,2023-08-28,6210
3206,志豐,16,0,16,新百王,2023-08-28,6210
4707,磐亞,41,25,16,新百王,2023-08-28,6210
2331,精英,83,67,16,新百王,2023-08-28,6210
2388,威盛,44,28,16,新百王,2023-08-28,6210
2401,凌陽,15,0,15,新百王,2023-08-28,6210
6125,廣運,33,19,14,新百王,2023-08-28,6210
3715,定穎投控,60,46,14,新百王,2023-08-28,6210
2340,台亞,15,1,14,新百王,2023-08-28,6210
2352,佳世達,13,0,13,新百王,2023-08-28,6210
6203,海韻電,11,0,11,新百王,2023-08-28,6210
3380,明泰,12,1,11,新百王,2023-08-28,6210
3041,揚智,10,0,10,新百王,2023-08-28,6210
2363,矽統,171,161,10,新百王,2023-08-28,6210
00795B,中信美國公債20年,10,0,10,新百王,2023-08-28,6210
2498,宏達電,11,1,10,新百王,2023-08-28,6210
2358,廷鑫,10,0,10,新百王,2023-08-28,6210
00751B,元大AAA至A公司債,10,0,10,新百王,2023-08-28,6210
2607,榮運,10,0,10,新百王,2023-08-28,6210
2605,新興,10,0,10,新百王,2023-08-28,6210
00753L,中信中國50正2,31,21,10,新百王,2023-08-28,6210
6244,茂迪,22,12,10,新百王,2023-08-28,6210
00713,元大台灣高息低波,10,1,9,新百王,2023-08-28,6210
2485,兆赫,26,17,9,新百王,2023-08-28,6210
1905,華紙,9,0,9,新百王,2023-08-28,6210
00878,國泰永續高股息,14,5,9,新百王,2023-08-28,6210
3481,群創,386,0,386,新百王,2023-08-29,6210
2363,矽統,688,585,103,新百王,2023-08-29,6210
4552,力達-KY,48,0,48,新百王,2023-08-29,6210
2601,益航,35,0,35,新百王,2023-08-29,6210
00929,復華台灣科技優息,44,11,33,新百王,2023-08-29,6210
2317,鴻海,34,7,27,新百王,2023-08-29,6210
2614,東森,25,0,25,新百王,2023-08-29,6210
2312,金寶,23,0,23,新百王,2023-08-29,6210
2615,萬海,39,17,22,新百王,2023-08-29,6210
2002,中鋼,26,4,22,新百王,2023-08-29,6210
00637L,元大滬深300正2,33,12,21,新百王,2023-08-29,6210
0056,元大高股息,51,30,21,新百王,2023-08-29,6210
2543,皇昌,20,0,20,新百王,2023-08-29,6210
00895,富邦未來車,20,0,20,新百王,2023-08-29,6210
00706L,期元大S＆P日圓正2,20,0,20,新百王,2023-08-29,6210
1444,力麗,30,10,20,新百王,2023-08-29,6210
8011,台通,27,7,20,新百王,2023-08-29,6210
2303,聯電,25,7,18,新百王,2023-08-29,6210
2816,旺旺保,35,18,17,新百王,2023-08-29,6210
2838,聯邦銀,17,0,17,新百王,2023-08-29,6210
4743,合一,15,0,15,新百王,2023-08-29,6210
4906,正文,46,31,15,新百王,2023-08-29,6210
00919,群益台灣精選高息,14,0,14,新百王,2023-08-29,6210
00675L,富邦臺灣加權正2,14,0,14,新百王,2023-08-29,6210
2383,台光電,16,3,13,新百王,2023-08-29,6210
3231,緯創,64,51,13,新百王,2023-08-29,6210
6517,保勝光學,11,0,11,新百王,2023-08-29,6210
2330,台積電,11,0,11,新百王,2023-08-29,6210
2484,希華,10,0,10,新百王,2023-08-29,6210
2022,聚亨,10,0,10,新百王,2023-08-29,6210
1736,喬山,10,0,10,新百王,2023-08-29,6210
1608,華榮,10,0,10,新百王,2023-08-29,6210
1319,東陽,11,1,10,新百王,2023-08-29,6210
5009,榮剛,11,1,10,新百王,2023-08-29,6210
6139,亞翔,14,4,10,新百王,2023-08-29,6210
6244,茂迪,10,0,10,新百王,2023-08-29,6210
3521,鴻翊,10,0,10,新百王,2023-08-29,6210
1737,臺鹽,10,2,8,新百王,2023-08-29,6210
4908,前鼎,15,7,8,新百王,2023-08-29,6210
1101,台泥,8,0,8,新百王,2023-08-29,6210
1907,永豐餘,8,0,8,新百王,2023-08-29,6210
1616,億泰,8,0,8,新百王,2023-08-29,6210
2889,國票金,8,0,8,新百王,2023-08-29,6210
6104,創惟,12,5,7,新百王,2023-08-29,6210
6443,元晶,22,15,7,新百王,2023-08-29,6210
2355,敬鵬,12,5,7,新百王,2023-08-29,6210
5371,中光電,9,2,7,新百王,2023-08-29,6210
5381,合正,23,17,6,新百王,2023-08-29,6210
00923,群益台ESG低碳50,6,0,6,新百王,2023-08-29,6210
2641,正德,6,0,6,新百王,2023-08-29,6210
3481,群創,1131,91,1040,新百王,2023-08-30,6210
00882,中信中國高股息,250,20,230,新百王,2023-08-30,6210
00637L,元大滬深300正2,129,4,125,新百王,2023-08-30,6210
2440,太空梭,120,0,120,新百王,2023-08-30,6210
2630,亞航,114,11,103,新百王,2023-08-30,6210
3264,欣銓,75,8,67,新百王,2023-08-30,6210
2618,長榮航,95,45,50,新百王,2023-08-30,6210
2838,聯邦銀,105,65,40,新百王,2023-08-30,6210
2324,仁寶,52,13,39,新百王,2023-08-30,6210
2610,華航,52,15,37,新百王,2023-08-30,6210
1609,大亞,38,1,37,新百王,2023-08-30,6210
2412,中華電,51,20,31,新百王,2023-08-30,6210
2816,旺旺保,44,17,27,新百王,2023-08-30,6210
1101,台泥,26,0,26,新百王,2023-08-30,6210
00665L,富邦�琤肭磪囓�2,55,29,26,新百王,2023-08-30,6210
00676R,富邦臺灣加權反1,25,0,25,新百王,2023-08-30,6210
4916,事欣科,22,0,22,新百王,2023-08-30,6210
4552,力達-KY,20,0,20,新百王,2023-08-30,6210
5880,合庫金,20,0,20,新百王,2023-08-30,6210
2892,第一金,20,0,20,新百王,2023-08-30,6210
3206,志豐,18,0,18,新百王,2023-08-30,6210
1471,首利,19,3,16,新百王,2023-08-30,6210
3051,力特,68,52,16,新百王,2023-08-30,6210
2485,兆赫,84,68,16,新百王,2023-08-30,6210
5351,鈺創,16,1,15,新百王,2023-08-30,6210
2497,怡利電,13,1,12,新百王,2023-08-30,6210
2353,宏��,20,9,11,新百王,2023-08-30,6210
2344,華邦電,19,8,11,新百王,2023-08-30,6210
2402,毅嘉,67,56,11,新百王,2023-08-30,6210
2609,陽明,30,20,10,新百王,2023-08-30,6210
4933,友輝,10,0,10,新百王,2023-08-30,6210
1907,永豐餘,10,0,10,新百王,2023-08-30,6210
00706L,期元大S＆P日圓正2,10,0,10,新百王,2023-08-30,6210
3583,辛耘,13,4,9,新百王,2023-08-30,6210
6190,萬泰科,9,0,9,新百王,2023-08-30,6210
2027,大成鋼,10,1,9,新百王,2023-08-30,6210
5381,合正,20,11,9,新百王,2023-08-30,6210
4960,誠美材,8,0,8,新百王,2023-08-30,6210
2371,大同,8,0,8,新百王,2023-08-30,6210
00878,國泰永續高股息,11,4,7,新百王,2023-08-30,6210
2332,友訊,7,0,7,新百王,2023-08-30,6210
3715,定穎投控,88,82,6,新百王,2023-08-30,6210
00680L,元大美債20正2,8,2,6,新百王,2023-08-30,6210
5546,永固-KY,6,0,6,新百王,2023-08-30,6210
6231,系微,12,6,6,新百王,2023-08-30,6210
3006,晶豪科,12,6,6,新百王,2023-08-30,6210
3706,神達,6,0,6,新百王,2023-08-30,6210
4541,晟田,11,5,6,新百王,2023-08-30,6210
3521,鴻翊,6,0,6,新百王,2023-08-30,6210
2428,興勤,11,5,6,新百王,2023-08-30,6210
2890,永豐金,174,0,174,新百王,2023-08-31,6210
2363,矽統,533,421,112,新百王,2023-08-31,6210
4934,太極,100,0,100,新百王,2023-08-31,6210
1802,台玻,222,163,59,新百王,2023-08-31,6210
2412,中華電,78,22,56,新百王,2023-08-31,6210
00665L,富邦�琤肭磪囓�2,85,29,56,新百王,2023-08-31,6210
1307,三芳,55,0,55,新百王,2023-08-31,6210
6126,信音,55,11,44,新百王,2023-08-31,6210
3481,群創,88,45,43,新百王,2023-08-31,6210
00637L,元大滬深300正2,41,0,41,新百王,2023-08-31,6210
2337,旺宏,93,53,40,新百王,2023-08-31,6210
8240,華宏,40,0,40,新百王,2023-08-31,6210
2880,華南金,45,10,35,新百王,2023-08-31,6210
2442,新美齊,30,0,30,新百王,2023-08-31,6210
5521,工信,30,0,30,新百王,2023-08-31,6210
2816,旺旺保,26,0,26,新百王,2023-08-31,6210
00900,富邦特選高股息30,26,0,26,新百王,2023-08-31,6210
2601,益航,25,1,24,新百王,2023-08-31,6210
3206,志豐,23,0,23,新百王,2023-08-31,6210
3715,定穎投控,69,47,22,新百王,2023-08-31,6210
2851,中再保,20,0,20,新百王,2023-08-31,6210
1904,正隆,21,1,20,新百王,2023-08-31,6210
6234,高僑,20,0,20,新百王,2023-08-31,6210
00878,國泰永續高股息,27,10,17,新百王,2023-08-31,6210
00712,復華富時不動產,20,3,17,新百王,2023-08-31,6210
3260,威剛,37,20,17,新百王,2023-08-31,6210
6156,松上,16,0,16,新百王,2023-08-31,6210
2618,長榮航,95,80,15,新百王,2023-08-31,6210
8916,光隆,14,0,14,新百王,2023-08-31,6210
5225,東科-KY,47,34,13,新百王,2023-08-31,6210
6806,森崴能源,23,10,13,新百王,2023-08-31,6210
3693,營邦,24,11,13,新百王,2023-08-31,6210
006208,富邦台50,11,0,11,新百王,2023-08-31,6210
6531,愛普*,20,9,11,新百王,2023-08-31,6210
2882,國泰金,11,0,11,新百王,2023-08-31,6210
2867,三商壽,11,0,11,新百王,2023-08-31,6210
2530,華建,10,0,10,新百王,2023-08-31,6210
5608,四維航,10,0,10,新百王,2023-08-31,6210
00632R,元大台灣50反1,10,0,10,新百王,2023-08-31,6210
2929,淘帝-KY,11,1,10,新百王,2023-08-31,6210
00753L,中信中國50正2,10,0,10,新百王,2023-08-31,6210
2312,金寶,10,0,10,新百王,2023-08-31,6210
2489,瑞軒,10,0,10,新百王,2023-08-31,6210
9105,泰金寶-DR,10,0,10,新百王,2023-08-31,6210
4147,中裕,25,15,10,新百王,2023-08-31,6210
6415,矽力*-KY,16,7,9,新百王,2023-08-31,6210
5481,新華,8,0,8,新百王,2023-08-31,6210
2369,菱生,10,2,8,新百王,2023-08-31,6210
6438,迅得,8,0,8,新百王,2023-08-31,6210
2883,凱基金,10,2,8,新百王,2023-08-31,6210
2442,新美齊,133,0,133,新百王,2023-09-01,6210
1514,亞力,82,12,70,新百王,2023-09-01,6210
2331,精英,90,32,58,新百王,2023-09-01,6210
4967,十銓,53,3,50,新百王,2023-09-01,6210
00637L,元大滬深300正2,125,75,50,新百王,2023-09-01,6210
2365,昆盈,50,0,50,新百王,2023-09-01,6210
1609,大亞,54,6,48,新百王,2023-09-01,6210
6418,詠昇,55,8,47,新百王,2023-09-01,6210
6234,高僑,42,0,42,新百王,2023-09-01,6210
2867,三商壽,42,0,42,新百王,2023-09-01,6210
2618,長榮航,115,73,42,新百王,2023-09-01,6210
4927,泰鼎-KY,37,1,36,新百王,2023-09-01,6210
1101,台泥,32,0,32,新百王,2023-09-01,6210
6548,長科*,31,0,31,新百王,2023-09-01,6210
9904,寶成,30,0,30,新百王,2023-09-01,6210
1504,東元,29,1,28,新百王,2023-09-01,6210
00919,群益台灣精選高息,27,0,27,新百王,2023-09-01,6210
2356,英業達,51,24,27,新百王,2023-09-01,6210
2485,兆赫,364,337,27,新百王,2023-09-01,6210
00878,國泰永續高股息,26,0,26,新百王,2023-09-01,6210
1513,中興電,28,6,22,新百王,2023-09-01,6210
2382,廣達,85,63,22,新百王,2023-09-01,6210
2834,臺企銀,22,0,22,新百王,2023-09-01,6210
5258,虹堡,26,4,22,新百王,2023-09-01,6210
3231,緯創,77,58,19,新百王,2023-09-01,6210
3206,志豐,18,0,18,新百王,2023-09-01,6210
6282,康舒,33,16,17,新百王,2023-09-01,6210
2329,華泰,37,21,16,新百王,2023-09-01,6210
3234,光環,17,1,16,新百王,2023-09-01,6210
00673R,期元大S＆P原油反1,15,0,15,新百王,2023-09-01,6210
6811,宏�硌穈T,15,0,15,新百王,2023-09-01,6210
8069,元太,18,4,14,新百王,2023-09-01,6210
1524,耿鼎,25,12,13,新百王,2023-09-01,6210
6005,群益證,20,7,13,新百王,2023-09-01,6210
4906,正文,43,30,13,新百王,2023-09-01,6210
6125,廣運,24,11,13,新百王,2023-09-01,6210
4909,新復興,39,26,13,新百王,2023-09-01,6210
2399,映泰,19,7,12,新百王,2023-09-01,6210
2497,怡利電,12,0,12,新百王,2023-09-01,6210
6134,萬旭,11,0,11,新百王,2023-09-01,6210
3059,華晶科,17,6,11,新百王,2023-09-01,6210
2891,中信金,24,14,10,新百王,2023-09-01,6210
2332,友訊,14,4,10,新百王,2023-09-01,6210
9934,成霖,40,30,10,新百王,2023-09-01,6210
3311,閎暉,45,35,10,新百王,2023-09-01,6210
2888,新光金,10,0,10,新百王,2023-09-01,6210
00932,兆豐永續高息等權,10,0,10,新百王,2023-09-01,6210
1727,中華化,11,1,10,新百王,2023-09-01,6210
2880,華南金,10,0,10,新百王,2023-09-01,6210
00751B,元大AAA至A公司債,10,0,10,新百王,2023-09-01,6210
3481,群創,208,10,198,新百王,2023-09-04,6210
00931B,統一美債20年,133,0,133,新百王,2023-09-04,6210
2332,友訊,139,20,119,新百王,2023-09-04,6210
1616,億泰,93,3,90,新百王,2023-09-04,6210
1513,中興電,94,26,68,新百王,2023-09-04,6210
2317,鴻海,69,10,59,新百王,2023-09-04,6210
00680L,元大美債20正2,56,0,56,新百王,2023-09-04,6210
2390,云辰,64,12,52,新百王,2023-09-04,6210
2340,台亞,48,5,43,新百王,2023-09-04,6210
00932,兆豐永續高息等權,42,0,42,新百王,2023-09-04,6210
1802,台玻,249,211,38,新百王,2023-09-04,6210
1609,大亞,78,41,37,新百王,2023-09-04,6210
1905,華紙,42,5,37,新百王,2023-09-04,6210
1447,力鵬,36,0,36,新百王,2023-09-04,6210
2485,兆赫,93,58,35,新百王,2023-09-04,6210
2363,矽統,196,169,27,新百王,2023-09-04,6210
00679B,元大美債20年,25,0,25,新百王,2023-09-04,6210
2409,友達,28,3,25,新百王,2023-09-04,6210
00919,群益台灣精選高息,24,0,24,新百王,2023-09-04,6210
5531,鄉林,23,0,23,新百王,2023-09-04,6210
3325,旭品,38,16,22,新百王,2023-09-04,6210
4162,智擎,21,0,21,新百王,2023-09-04,6210
2881,富邦金,21,0,21,新百王,2023-09-04,6210
2312,金寶,20,0,20,新百王,2023-09-04,6210
2634,漢翔,37,18,19,新百王,2023-09-04,6210
1471,首利,18,0,18,新百王,2023-09-04,6210
00772B,中信高評級公司債,17,0,17,新百王,2023-09-04,6210
3615,安可,15,0,15,新百王,2023-09-04,6210
00724B,群益投資級金融債,15,0,15,新百王,2023-09-04,6210
00720B,元大投資級公司債,15,0,15,新百王,2023-09-04,6210
4934,太極,19,4,15,新百王,2023-09-04,6210
2816,旺旺保,51,37,14,新百王,2023-09-04,6210
3622,洋華,19,5,14,新百王,2023-09-04,6210
00878,國泰永續高股息,14,0,14,新百王,2023-09-04,6210
2027,大成鋼,16,3,13,新百王,2023-09-04,6210
2402,毅嘉,82,69,13,新百王,2023-09-04,6210
2369,菱生,16,3,13,新百王,2023-09-04,6210
00764B,群益25年美債,12,0,12,新百王,2023-09-04,6210
9919,康那香,42,30,12,新百王,2023-09-04,6210
4147,中裕,16,4,12,新百王,2023-09-04,6210
3484,崧騰,11,0,11,新百王,2023-09-04,6210
9929,秋雨,11,0,11,新百王,2023-09-04,6210
6829,千附精密,11,0,11,新百王,2023-09-04,6210
2201,裕隆,78,68,10,新百王,2023-09-04,6210
00706L,期元大S＆P日圓正2,10,0,10,新百王,2023-09-04,6210
6248,沛波,10,0,10,新百王,2023-09-04,6210
3623,富晶通,10,0,10,新百王,2023-09-04,6210
1325,恆大,10,0,10,新百王,2023-09-04,6210
9934,成霖,40,30,10,新百王,2023-09-04,6210
1608,華榮,10,0,10,新百王,2023-09-04,6210
00919,群益台灣精選高息,439,2,437,新百王,2023-09-05,6210
00929,復華台灣科技優息,265,99,166,新百王,2023-09-05,6210
1307,三芳,102,1,101,新百王,2023-09-05,6210
2883,凱基金,104,3,101,新百王,2023-09-05,6210
00665L,富邦�琤肭磪囓�2,106,30,76,新百王,2023-09-05,6210
2852,第一保,66,0,66,新百王,2023-09-05,6210
2543,皇昌,60,0,60,新百王,2023-09-05,6210
2610,華航,131,85,46,新百王,2023-09-05,6210
2834,臺企銀,50,8,42,新百王,2023-09-05,6210
3706,神達,46,7,39,新百王,2023-09-05,6210
00637L,元大滬深300正2,38,0,38,新百王,2023-09-05,6210
00753L,中信中國50正2,43,6,37,新百王,2023-09-05,6210
2890,永豐金,52,15,37,新百王,2023-09-05,6210
6282,康舒,54,27,27,新百王,2023-09-05,6210
00706L,期元大S＆P日圓正2,27,0,27,新百王,2023-09-05,6210
8048,德勝,35,9,26,新百王,2023-09-05,6210
00857B,永豐20年美公債,25,0,25,新百王,2023-09-05,6210
4542,科嶠,23,0,23,新百王,2023-09-05,6210
4744,皇將,23,0,23,新百王,2023-09-05,6210
2888,新光金,21,0,21,新百王,2023-09-05,6210
2885,元大金,22,2,20,新百王,2023-09-05,6210
2630,亞航,22,2,20,新百王,2023-09-05,6210
6229,研通,20,0,20,新百王,2023-09-05,6210
6167,久正,20,0,20,新百王,2023-09-05,6210
00751B,元大AAA至A公司債,18,0,18,新百王,2023-09-05,6210
1101,台泥,18,0,18,新百王,2023-09-05,6210
1605,華新,21,5,16,新百王,2023-09-05,6210
4934,太極,15,0,15,新百王,2023-09-05,6210
9105,泰金寶-DR,15,0,15,新百王,2023-09-05,6210
6156,松上,15,0,15,新百王,2023-09-05,6210
2031,新光鋼,20,6,14,新百王,2023-09-05,6210
3231,緯創,49,36,13,新百王,2023-09-05,6210
2027,大成鋼,23,10,13,新百王,2023-09-05,6210
3715,定穎投控,109,97,12,新百王,2023-09-05,6210
00680L,元大美債20正2,15,3,12,新百王,2023-09-05,6210
5457,宣德,17,5,12,新百王,2023-09-05,6210
00878,國泰永續高股息,15,3,12,新百王,2023-09-05,6210
2881,富邦金,11,0,11,新百王,2023-09-05,6210
2312,金寶,37,26,11,新百王,2023-09-05,6210
1802,台玻,55,45,10,新百王,2023-09-05,6210
00676R,富邦臺灣加權反1,10,0,10,新百王,2023-09-05,6210
5381,合正,23,13,10,新百王,2023-09-05,6210
4909,新復興,17,7,10,新百王,2023-09-05,6210
3576,聯合再生,10,0,10,新百王,2023-09-05,6210
6234,高僑,10,0,10,新百王,2023-09-05,6210
4543,萬在,10,1,9,新百王,2023-09-05,6210
3094,聯傑,13,4,9,新百王,2023-09-05,6210
2850,新產,10,1,9,新百王,2023-09-05,6210
3704,合勤控,10,1,9,新百王,2023-09-05,6210
6547,高端疫苗,21,13,8,新百王,2023-09-05,6210
00632R,元大台灣50反1,160,0,160,新百王,2023-09-06,6210
00931B,統一美債20年,135,0,135,新百王,2023-09-06,6210
00919,群益台灣精選高息,108,22,86,新百王,2023-09-06,6210
2888,新光金,100,25,75,新百王,2023-09-06,6210
2812,台中銀,71,4,67,新百王,2023-09-06,6210
1802,台玻,152,94,58,新百王,2023-09-06,6210
1709,和益,50,0,50,新百王,2023-09-06,6210
9939,宏全,48,0,48,新百王,2023-09-06,6210
2891,中信金,46,0,46,新百王,2023-09-06,6210
2409,友達,47,2,45,新百王,2023-09-06,6210
3706,神達,52,10,42,新百王,2023-09-06,6210
3206,志豐,41,1,40,新百王,2023-09-06,6210
00637L,元大滬深300正2,38,0,38,新百王,2023-09-06,6210
00665L,富邦�琤肭磪囓�2,82,44,38,新百王,2023-09-06,6210
2618,長榮航,46,12,34,新百王,2023-09-06,6210
00680L,元大美債20正2,42,10,32,新百王,2023-09-06,6210
2412,中華電,80,49,31,新百王,2023-09-06,6210
1101,台泥,39,9,30,新百王,2023-09-06,6210
5381,合正,106,77,29,新百王,2023-09-06,6210
3481,群創,190,163,27,新百王,2023-09-06,6210
3013,晟銘電,45,20,25,新百王,2023-09-06,6210
00900,富邦特選高股息30,25,0,25,新百王,2023-09-06,6210
00706L,期元大S＆P日圓正2,25,0,25,新百王,2023-09-06,6210
00795B,中信美國公債20年,23,0,23,新百王,2023-09-06,6210
00753L,中信中國50正2,22,0,22,新百王,2023-09-06,6210
5469,瀚宇博,26,5,21,新百王,2023-09-06,6210
00907,永豐優息存股,22,1,21,新百王,2023-09-06,6210
4927,泰鼎-KY,20,0,20,新百王,2023-09-06,6210
2630,亞航,20,0,20,新百王,2023-09-06,6210
6147,頎邦,33,14,19,新百王,2023-09-06,6210
6414,樺漢,31,13,18,新百王,2023-09-06,6210
2402,毅嘉,47,29,18,新百王,2023-09-06,6210
2890,永豐金,61,44,17,新百王,2023-09-06,6210
2834,臺企銀,18,1,17,新百王,2023-09-06,6210
2303,聯電,21,4,17,新百王,2023-09-06,6210
3588,通嘉,18,2,16,新百王,2023-09-06,6210
2369,菱生,14,0,14,新百王,2023-09-06,6210
3043,科風,27,14,13,新百王,2023-09-06,6210
1616,億泰,12,0,12,新百王,2023-09-06,6210
00772B,中信高評級公司債,12,0,12,新百王,2023-09-06,6210
6016,康和證,12,0,12,新百王,2023-09-06,6210
00687B,國泰20年美債,11,0,11,新百王,2023-09-06,6210
3265,台星科,14,3,11,新百王,2023-09-06,6210
2355,敬鵬,16,5,11,新百王,2023-09-06,6210
8048,德勝,10,0,10,新百王,2023-09-06,6210
2444,兆勁,10,0,10,新百王,2023-09-06,6210
6108,競國,10,0,10,新百王,2023-09-06,6210
2886,兆豐金,10,0,10,新百王,2023-09-06,6210
3689,湧德,10,0,10,新百王,2023-09-06,6210
9904,寶成,10,0,10,新百王,2023-09-06,6210
00929,復華台灣科技優息,774,304,470,新百王,2023-09-07,6210
2409,友達,300,0,300,新百王,2023-09-07,6210
2312,金寶,55,0,55,新百王,2023-09-07,6210
2332,友訊,63,10,53,新百王,2023-09-07,6210
2610,華航,70,20,50,新百王,2023-09-07,6210
2601,益航,41,1,40,新百王,2023-09-07,6210
3706,神達,36,0,36,新百王,2023-09-07,6210
2630,亞航,43,8,35,新百王,2023-09-07,6210
00637L,元大滬深300正2,36,2,34,新百王,2023-09-07,6210
8358,金居,40,9,31,新百王,2023-09-07,6210
1524,耿鼎,35,8,27,新百王,2023-09-07,6210
2618,長榮航,38,12,26,新百王,2023-09-07,6210
6116,彩晶,26,0,26,新百王,2023-09-07,6210
2888,新光金,31,6,25,新百王,2023-09-07,6210
2485,兆赫,282,257,25,新百王,2023-09-07,6210
2313,華通,53,28,25,新百王,2023-09-07,6210
6415,矽力*-KY,25,1,24,新百王,2023-09-07,6210
2520,冠德,22,0,22,新百王,2023-09-07,6210
2436,偉詮電,59,38,21,新百王,2023-09-07,6210
1513,中興電,26,5,21,新百王,2023-09-07,6210
2498,宏達電,21,0,21,新百王,2023-09-07,6210
2486,一詮,50,30,20,新百王,2023-09-07,6210
2377,微星,20,0,20,新百王,2023-09-07,6210
5880,合庫金,20,0,20,新百王,2023-09-07,6210
6257,矽格,20,0,20,新百王,2023-09-07,6210
3588,通嘉,24,4,20,新百王,2023-09-07,6210
2481,強茂,19,0,19,新百王,2023-09-07,6210
1522,堤維西,41,22,19,新百王,2023-09-07,6210
6613,朋億*,23,5,18,新百王,2023-09-07,6210
2401,凌陽,22,4,18,新百王,2023-09-07,6210
4934,太極,39,22,17,新百王,2023-09-07,6210
3163,波若威,36,19,17,新百王,2023-09-07,6210
00915,凱基優選高股息30,17,0,17,新百王,2023-09-07,6210
00675L,富邦臺灣加權正2,17,0,17,新百王,2023-09-07,6210
2816,旺旺保,58,43,15,新百王,2023-09-07,6210
4147,中裕,24,10,14,新百王,2023-09-07,6210
3217,優群,37,23,14,新百王,2023-09-07,6210
3715,定穎投控,165,152,13,新百王,2023-09-07,6210
2881,富邦金,14,1,13,新百王,2023-09-07,6210
2002,中鋼,14,1,13,新百王,2023-09-07,6210
2408,南亞科,14,2,12,新百王,2023-09-07,6210
1307,三芳,42,30,12,新百王,2023-09-07,6210
2344,華邦電,11,0,11,新百王,2023-09-07,6210
1905,華紙,11,0,11,新百王,2023-09-07,6210
2349,錸德,11,0,11,新百王,2023-09-07,6210
4908,前鼎,18,7,11,新百王,2023-09-07,6210
1409,新纖,11,0,11,新百王,2023-09-07,6210
8478,東哥遊艇,12,1,11,新百王,2023-09-07,6210
8086,宏捷科,33,23,10,新百王,2023-09-07,6210
6118,建達,10,0,10,新百王,2023-09-07,6210
00919,群益台灣精選高息,414,0,414,新百王,2023-09-08,6210
2883B,凱基金乙特,140,0,140,新百王,2023-09-08,6210
2891,中信金,354,232,122,新百王,2023-09-08,6210
1102,亞泥,107,0,107,新百王,2023-09-08,6210
3029,零壹,61,1,60,新百王,2023-09-08,6210
5206,坤悅,50,0,50,新百王,2023-09-08,6210
3715,定穎投控,175,130,45,新百王,2023-09-08,6210
2615,萬海,46,2,44,新百王,2023-09-08,6210
6234,高僑,42,2,40,新百王,2023-09-08,6210
5009,榮剛,31,0,31,新百王,2023-09-08,6210
00673R,期元大S＆P原油反1,31,0,31,新百王,2023-09-08,6210
00753L,中信中國50正2,30,0,30,新百王,2023-09-08,6210
2457,飛宏,29,1,28,新百王,2023-09-08,6210
2382,廣達,77,50,27,新百王,2023-09-08,6210
2010,春源,25,0,25,新百王,2023-09-08,6210
00637L,元大滬深300正2,24,0,24,新百王,2023-09-08,6210
8110,華東,24,1,23,新百王,2023-09-08,6210
3706,神達,23,1,22,新百王,2023-09-08,6210
6446,藥華藥,29,9,20,新百王,2023-09-08,6210
1471,首利,43,24,19,新百王,2023-09-08,6210
2412,中華電,22,3,19,新百王,2023-09-08,6210
2618,長榮航,35,19,16,新百王,2023-09-08,6210
2486,一詮,45,30,15,新百王,2023-09-08,6210
6799,來頡,22,9,13,新百王,2023-09-08,6210
3693,營邦,38,26,12,新百王,2023-09-08,6210
2929,淘帝-KY,12,0,12,新百王,2023-09-08,6210
1616,億泰,11,0,11,新百王,2023-09-08,6210
4543,萬在,11,0,11,新百王,2023-09-08,6210
00896,中信綠能及電動車,10,0,10,新百王,2023-09-08,6210
2002,中鋼,10,0,10,新百王,2023-09-08,6210
00655L,國泰中國A50正2,10,0,10,新百王,2023-09-08,6210
3483,力致,48,38,10,新百王,2023-09-08,6210
5215,科嘉-KY,10,0,10,新百王,2023-09-08,6210
6243,迅杰,10,0,10,新百王,2023-09-08,6210
00706L,期元大S＆P日圓正2,10,0,10,新百王,2023-09-08,6210
00931B,統一美債20年,10,0,10,新百王,2023-09-08,6210
6472,保瑞,15,6,9,新百王,2023-09-08,6210
2610,華航,10,1,9,新百王,2023-09-08,6210
2317,鴻海,15,6,9,新百王,2023-09-08,6210
4934,太極,14,5,9,新百王,2023-09-08,6210
2402,毅嘉,45,36,9,新百王,2023-09-08,6210
3042,晶技,20,12,8,新百王,2023-09-08,6210
1712,興農,8,0,8,新百王,2023-09-08,6210
2239,英利-KY,8,0,8,新百王,2023-09-08,6210
2358,廷鑫,64,56,8,新百王,2023-09-08,6210
2020,美亞,8,0,8,新百王,2023-09-08,6210
00665L,富邦�琤肭磪囓�2,8,0,8,新百王,2023-09-08,6210
2353,宏��,21,14,7,新百王,2023-09-08,6210
3272,東碩,8,1,7,新百王,2023-09-08,6210
3588,通嘉,23,16,7,新百王,2023-09-08,6210
3481,群創,386,195,191,新百王,2023-09-11,6210
2883B,凱基金乙特,148,0,148,新百王,2023-09-11,6210
00929,復華台灣科技優息,282,144,138,新百王,2023-09-11,6210
3709,鑫聯大投控,132,0,132,新百王,2023-09-11,6210
1104,環泥,90,0,90,新百王,2023-09-11,6210
00919,群益台灣精選高息,99,34,65,新百王,2023-09-11,6210
00673R,期元大S＆P原油反1,78,20,58,新百王,2023-09-11,6210
2890,永豐金,129,71,58,新百王,2023-09-11,6210
2352,佳世達,64,24,40,新百王,2023-09-11,6210
2007,燁興,38,0,38,新百王,2023-09-11,6210
00751B,元大AAA至A公司債,37,0,37,新百王,2023-09-11,6210
2405,輔信,111,74,37,新百王,2023-09-11,6210
4967,十銓,95,62,33,新百王,2023-09-11,6210
2883,凱基金,38,6,32,新百王,2023-09-11,6210
2618,長榮航,55,27,28,新百王,2023-09-11,6210
2382,廣達,135,108,27,新百王,2023-09-11,6210
2610,華航,84,57,27,新百王,2023-09-11,6210
8070,長華*,26,0,26,新百王,2023-09-11,6210
3567,逸昌,40,15,25,新百王,2023-09-11,6210
2834,臺企銀,96,71,25,新百王,2023-09-11,6210
00740B,富邦全球投等債,22,0,22,新百王,2023-09-11,6210
6446,藥華藥,39,17,22,新百王,2023-09-11,6210
00878,國泰永續高股息,68,48,20,新百王,2023-09-11,6210
00675L,富邦臺灣加權正2,21,1,20,新百王,2023-09-11,6210
9951,皇田,20,0,20,新百王,2023-09-11,6210
6203,海韻電,28,10,18,新百王,2023-09-11,6210
00688L,國泰20年美債正2,18,0,18,新百王,2023-09-11,6210
00923,群益台ESG低碳50,17,0,17,新百王,2023-09-11,6210
2436,偉詮電,20,3,17,新百王,2023-09-11,6210
4934,太極,30,13,17,新百王,2023-09-11,6210
2002,中鋼,16,0,16,新百王,2023-09-11,6210
00680L,元大美債20正2,55,40,15,新百王,2023-09-11,6210
2354,鴻準,25,10,15,新百王,2023-09-11,6210
6216,居易,15,0,15,新百王,2023-09-11,6210
3704,合勤控,23,9,14,新百王,2023-09-11,6210
1618,合機,23,9,14,新百王,2023-09-11,6210
4744,皇將,21,7,14,新百王,2023-09-11,6210
6125,廣運,36,22,14,新百王,2023-09-11,6210
2457,飛宏,14,1,13,新百王,2023-09-11,6210
9919,康那香,13,0,13,新百王,2023-09-11,6210
3206,志豐,13,0,13,新百王,2023-09-11,6210
2376,技嘉,27,15,12,新百王,2023-09-11,6210
3163,波若威,40,28,12,新百王,2023-09-11,6210
2886,兆豐金,12,0,12,新百王,2023-09-11,6210
6547,高端疫苗,12,0,12,新百王,2023-09-11,6210
3711,日月光投控,27,15,12,新百王,2023-09-11,6210
2607,榮運,12,0,12,新百王,2023-09-11,6210
1504,東元,17,5,12,新百王,2023-09-11,6210
00915,凱基優選高股息30,13,2,11,新百王,2023-09-11,6210
1316,上曜,11,0,11,新百王,2023-09-11,6210
00919,群益台灣精選高息,156,0,156,新百王,2023-09-12,6210
1104,環泥,103,0,103,新百王,2023-09-12,6210
3709,鑫聯大投控,87,9,78,新百王,2023-09-12,6210
2515,中工,80,10,70,新百王,2023-09-12,6210
4945,陞達科技,68,5,63,新百王,2023-09-12,6210
2881,富邦金,59,0,59,新百王,2023-09-12,6210
6282,康舒,174,118,56,新百王,2023-09-12,6210
4916,事欣科,85,39,46,新百王,2023-09-12,6210
3322,建舜電,56,12,44,新百王,2023-09-12,6210
2606,裕民,41,0,41,新百王,2023-09-12,6210
6120,達運,42,3,39,新百王,2023-09-12,6210
1718,中纖,32,0,32,新百王,2023-09-12,6210
2369,菱生,30,0,30,新百王,2023-09-12,6210
2891,中信金,26,0,26,新百王,2023-09-12,6210
00637L,元大滬深300正2,26,0,26,新百王,2023-09-12,6210
00740B,富邦全球投等債,24,0,24,新百王,2023-09-12,6210
00929,復華台灣科技優息,56,33,23,新百王,2023-09-12,6210
2312,金寶,20,0,20,新百王,2023-09-12,6210
00706L,期元大S＆P日圓正2,20,0,20,新百王,2023-09-12,6210
2020,美亞,26,6,20,新百王,2023-09-12,6210
9907,統一實,20,0,20,新百王,2023-09-12,6210
5880,合庫金,20,0,20,新百王,2023-09-12,6210
2382,廣達,53,35,18,新百王,2023-09-12,6210
6689,伊雲谷,27,10,17,新百王,2023-09-12,6210
2892,第一金,20,4,16,新百王,2023-09-12,6210
8088,品安,15,0,15,新百王,2023-09-12,6210
6547,高端疫苗,16,2,14,新百王,2023-09-12,6210
1215,卜蜂,15,2,13,新百王,2023-09-12,6210
2007,燁興,12,0,12,新百王,2023-09-12,6210
2388,威盛,24,12,12,新百王,2023-09-12,6210
00680L,元大美債20正2,11,0,11,新百王,2023-09-12,6210
2359,所羅門,12,1,11,新百王,2023-09-12,6210
3545,敦泰,18,8,10,新百王,2023-09-12,6210
3231,緯創,85,75,10,新百王,2023-09-12,6210
2417,圓剛,20,10,10,新百王,2023-09-12,6210
2464,盟立,10,0,10,新百王,2023-09-12,6210
2105,正新,10,0,10,新百王,2023-09-12,6210
9951,皇田,10,0,10,新百王,2023-09-12,6210
00655L,國泰中國A50正2,10,0,10,新百王,2023-09-12,6210
5498,凱崴,10,0,10,新百王,2023-09-12,6210
00673R,期元大S＆P原油反1,10,0,10,新百王,2023-09-12,6210
3036,文曄,11,2,9,新百王,2023-09-12,6210
6188,廣明,8,0,8,新百王,2023-09-12,6210
5608,四維航,8,0,8,新百王,2023-09-12,6210
00877,復華中國5G,8,0,8,新百王,2023-09-12,6210
6244,茂迪,7,0,7,新百王,2023-09-12,6210
2002,中鋼,7,0,7,新百王,2023-09-12,6210
8110,華東,7,0,7,新百王,2023-09-12,6210
4933,友輝,7,0,7,新百王,2023-09-12,6210
2603,長榮,7,0,7,新百王,2023-09-12,6210
1101,台泥,134,14,120,新百王,2023-09-13,6210
1709,和益,87,0,87,新百王,2023-09-13,6210
2442,新美齊,66,0,66,新百王,2023-09-13,6210
2317,鴻海,60,0,60,新百王,2023-09-13,6210
2412,中華電,60,1,59,新百王,2023-09-13,6210
00665L,富邦�琤肭磪囓�2,99,42,57,新百王,2023-09-13,6210
2888,新光金,55,0,55,新百王,2023-09-13,6210
2485,兆赫,50,1,49,新百王,2023-09-13,6210
00637L,元大滬深300正2,84,39,45,新百王,2023-09-13,6210
6432,今展科,47,6,41,新百王,2023-09-13,6210
00706L,期元大S＆P日圓正2,29,0,29,新百王,2023-09-13,6210
2609,陽明,27,0,27,新百王,2023-09-13,6210
2497,怡利電,29,5,24,新百王,2023-09-13,6210
1339,昭輝,25,3,22,新百王,2023-09-13,6210
2892,第一金,21,0,21,新百王,2023-09-13,6210
6005,群益證,21,0,21,新百王,2023-09-13,6210
2367,燿華,20,0,20,新百王,2023-09-13,6210
2303,聯電,19,1,18,新百王,2023-09-13,6210
2371,大同,71,54,17,新百王,2023-09-13,6210
00882,中信中國高股息,16,0,16,新百王,2023-09-13,6210
3588,通嘉,27,11,16,新百王,2023-09-13,6210
3711,日月光投控,45,30,15,新百王,2023-09-13,6210
00673R,期元大S＆P原油反1,25,10,15,新百王,2023-09-13,6210
4529,淳紳,15,0,15,新百王,2023-09-13,6210
00878,國泰永續高股息,15,0,15,新百王,2023-09-13,6210
2538,基泰,18,4,14,新百王,2023-09-13,6210
6418,詠昇,14,1,13,新百王,2023-09-13,6210
3481,群創,15,2,13,新百王,2023-09-13,6210
00632R,元大台灣50反1,12,0,12,新百王,2023-09-13,6210
2634,漢翔,16,4,12,新百王,2023-09-13,6210
2601,益航,12,0,12,新百王,2023-09-13,6210
4909,新復興,16,5,11,新百王,2023-09-13,6210
3005,神基,26,15,11,新百王,2023-09-13,6210
2355,敬鵬,34,23,11,新百王,2023-09-13,6210
2352,佳世達,17,6,11,新百王,2023-09-13,6210
2615,萬海,12,1,11,新百王,2023-09-13,6210
6689,伊雲谷,17,6,11,新百王,2023-09-13,6210
2313,華通,13,3,10,新百王,2023-09-13,6210
3088,艾訊,10,0,10,新百王,2023-09-13,6210
00715L,期街口布蘭特正2,10,0,10,新百王,2023-09-13,6210
4306,炎洲,10,0,10,新百王,2023-09-13,6210
4931,新盛力,10,0,10,新百王,2023-09-13,6210
1605,華新,10,0,10,新百王,2023-09-13,6210
6182,合晶,10,0,10,新百王,2023-09-13,6210
8150,南茂,10,0,10,新百王,2023-09-13,6210
3056,富華新,9,0,9,新百王,2023-09-13,6210
4967,十銓,15,6,9,新百王,2023-09-13,6210
4533,協易機,9,0,9,新百王,2023-09-13,6210
2834,臺企銀,21,12,9,新百王,2023-09-13,6210
8048,德勝,17,9,8,新百王,2023-09-13,6210
00929,復華台灣科技優息,373,79,294,新百王,2023-09-14,6210
00919,群益台灣精選高息,208,115,93,新百王,2023-09-14,6210
00665L,富邦�琤肭磪囓�2,127,44,83,新百王,2023-09-14,6210
2485,兆赫,301,222,79,新百王,2023-09-14,6210
2374,佳能,66,0,66,新百王,2023-09-14,6210
2371,大同,104,49,55,新百王,2023-09-14,6210
00673R,期元大S＆P原油反1,45,0,45,新百王,2023-09-14,6210
2303,聯電,43,2,41,新百王,2023-09-14,6210
2615,萬海,45,12,33,新百王,2023-09-14,6210
1718,中纖,30,0,30,新百王,2023-09-14,6210
6220,岳豐,30,0,30,新百王,2023-09-14,6210
5905,南仁湖,30,0,30,新百王,2023-09-14,6210
2515,中工,28,0,28,新百王,2023-09-14,6210
2884,玉山金,30,5,25,新百王,2023-09-14,6210
2891,中信金,41,16,25,新百王,2023-09-14,6210
2332,友訊,21,0,21,新百王,2023-09-14,6210
2027,大成鋼,42,22,20,新百王,2023-09-14,6210
6591,動力-KY,20,0,20,新百王,2023-09-14,6210
2610,華航,82,62,20,新百王,2023-09-14,6210
2010,春源,20,0,20,新百王,2023-09-14,6210
00676R,富邦臺灣加權反1,20,0,20,新百王,2023-09-14,6210
2630,亞航,23,7,16,新百王,2023-09-14,6210
3264,欣銓,20,4,16,新百王,2023-09-14,6210
3213,茂訊,18,2,16,新百王,2023-09-14,6210
00923,群益台ESG低碳50,21,5,16,新百王,2023-09-14,6210
3715,定穎投控,72,57,15,新百王,2023-09-14,6210
00753L,中信中國50正2,15,0,15,新百王,2023-09-14,6210
8150,南茂,15,0,15,新百王,2023-09-14,6210
00852L,國泰美國道瓊正2,15,0,15,新百王,2023-09-14,6210
2641,正德,15,0,15,新百王,2023-09-14,6210
1612,宏泰,15,0,15,新百王,2023-09-14,6210
3037,欣興,24,10,14,新百王,2023-09-14,6210
00724B,群益投資級金融債,14,0,14,新百王,2023-09-14,6210
6158,禾昌,14,1,13,新百王,2023-09-14,6210
4739,康普,13,1,12,新百王,2023-09-14,6210
2344,華邦電,22,10,12,新百王,2023-09-14,6210
2449,京元電子,35,24,11,新百王,2023-09-14,6210
3051,力特,50,39,11,新百王,2023-09-14,6210
00633L,富邦上証正2,16,5,11,新百王,2023-09-14,6210
2603,長榮,21,10,11,新百王,2023-09-14,6210
9105,泰金寶-DR,10,0,10,新百王,2023-09-14,6210
6161,捷波,13,3,10,新百王,2023-09-14,6210
3673,TPK-KY,10,0,10,新百王,2023-09-14,6210
6418,詠昇,10,0,10,新百王,2023-09-14,6210
2427,三商電,16,6,10,新百王,2023-09-14,6210
00632R,元大台灣50反1,10,0,10,新百王,2023-09-14,6210
2645,長榮航太,10,0,10,新百王,2023-09-14,6210
2301,光寶科,30,20,10,新百王,2023-09-14,6210
2356,英業達,48,38,10,新百王,2023-09-14,6210
00706L,期元大S＆P日圓正2,10,0,10,新百王,2023-09-14,6210
00929,復華台灣科技優息,285,79,206,新百王,2023-09-15,6210
2363,矽統,434,328,106,新百王,2023-09-15,6210
5905,南仁湖,84,0,84,新百王,2023-09-15,6210
00637L,元大滬深300正2,124,47,77,新百王,2023-09-15,6210
2801,彰銀,71,0,71,新百王,2023-09-15,6210
1102,亞泥,99,38,61,新百王,2023-09-15,6210
2887,台新金,62,4,58,新百王,2023-09-15,6210
1718,中纖,50,0,50,新百王,2023-09-15,6210
00673R,期元大S＆P原油反1,53,5,48,新百王,2023-09-15,6210
2002,中鋼,51,4,47,新百王,2023-09-15,6210
2641,正德,153,109,44,新百王,2023-09-15,6210
5469,瀚宇博,44,1,43,新百王,2023-09-15,6210
00687B,國泰20年美債,39,0,39,新百王,2023-09-15,6210
2486,一詮,116,83,33,新百王,2023-09-15,6210
2303,聯電,37,5,32,新百王,2023-09-15,6210
00720B,元大投資級公司債,33,1,32,新百王,2023-09-15,6210
6220,岳豐,30,0,30,新百王,2023-09-15,6210
00706L,期元大S＆P日圓正2,30,0,30,新百王,2023-09-15,6210
00655L,國泰中國A50正2,50,22,28,新百王,2023-09-15,6210
2890,永豐金,28,0,28,新百王,2023-09-15,6210
6284,佳邦,71,46,25,新百王,2023-09-15,6210
1104,環泥,24,0,24,新百王,2023-09-15,6210
3715,定穎投控,152,129,23,新百王,2023-09-15,6210
00632R,元大台灣50反1,23,0,23,新百王,2023-09-15,6210
3481,群創,227,205,22,新百王,2023-09-15,6210
3209,全科,23,1,22,新百王,2023-09-15,6210
2884,玉山金,22,0,22,新百王,2023-09-15,6210
5388,中磊,24,2,22,新百王,2023-09-15,6210
1609,大亞,21,0,21,新百王,2023-09-15,6210
00633L,富邦上証正2,40,20,20,新百王,2023-09-15,6210
8150,南茂,20,0,20,新百王,2023-09-15,6210
2014,中鴻,19,0,19,新百王,2023-09-15,6210
4977,眾達-KY,17,0,17,新百王,2023-09-15,6210
3689,湧德,17,0,17,新百王,2023-09-15,6210
00631L,元大台灣50正2,30,14,16,新百王,2023-09-15,6210
00857B,永豐20年美公債,16,0,16,新百王,2023-09-15,6210
4714,永捷,16,0,16,新百王,2023-09-15,6210
00679B,元大美債20年,16,0,16,新百王,2023-09-15,6210
2867,三商壽,14,0,14,新百王,2023-09-15,6210
4916,事欣科,18,5,13,新百王,2023-09-15,6210
6125,廣運,19,7,12,新百王,2023-09-15,6210
2630,亞航,21,9,12,新百王,2023-09-15,6210
2436,偉詮電,28,16,12,新百王,2023-09-15,6210
00680L,元大美債20正2,12,0,12,新百王,2023-09-15,6210
2376,技嘉,26,15,11,新百王,2023-09-15,6210
2464,盟立,11,0,11,新百王,2023-09-15,6210
1810,和成,10,0,10,新百王,2023-09-15,6210
6451,訊芯-KY,29,19,10,新百王,2023-09-15,6210
5508,永信建,10,0,10,新百王,2023-09-15,6210
1802,台玻,30,20,10,新百王,2023-09-15,6210
00929,復華台灣科技優息,545,73,472,新百王,2023-09-18,6210
00665L,富邦�琤肭磪囓�2,247,77,170,新百王,2023-09-18,6210
2363,矽統,471,392,79,新百王,2023-09-18,6210
00931B,統一美債20年,77,0,77,新百王,2023-09-18,6210
00751B,元大AAA至A公司債,59,0,59,新百王,2023-09-18,6210
00919,群益台灣精選高息,71,20,51,新百王,2023-09-18,6210
00680L,元大美債20正2,61,10,51,新百王,2023-09-18,6210
3520,華盈,51,2,49,新百王,2023-09-18,6210
2324,仁寶,52,5,47,新百王,2023-09-18,6210
3588,通嘉,46,0,46,新百王,2023-09-18,6210
2436,偉詮電,55,12,43,新百王,2023-09-18,6210
6120,達運,46,5,41,新百王,2023-09-18,6210
3322,建舜電,41,0,41,新百王,2023-09-18,6210
00687B,國泰20年美債,36,0,36,新百王,2023-09-18,6210
5381,合正,36,0,36,新百王,2023-09-18,6210
3390,旭軟,36,0,36,新百王,2023-09-18,6210
2313,華通,229,194,35,新百王,2023-09-18,6210
2402,毅嘉,50,20,30,新百王,2023-09-18,6210
1584,精剛,31,2,29,新百王,2023-09-18,6210
3231,緯創,52,26,26,新百王,2023-09-18,6210
00764B,群益25年美債,25,0,25,新百王,2023-09-18,6210
2442,新美齊,25,0,25,新百王,2023-09-18,6210
00915,凱基優選高股息30,21,0,21,新百王,2023-09-18,6210
4120,友華,20,0,20,新百王,2023-09-18,6210
1339,昭輝,28,8,20,新百王,2023-09-18,6210
2302,麗正,20,0,20,新百王,2023-09-18,6210
2337,旺宏,20,0,20,新百王,2023-09-18,6210
00720B,元大投資級公司債,19,0,19,新百王,2023-09-18,6210
4401,東隆興,19,0,19,新百王,2023-09-18,6210
00631L,元大台灣50正2,19,1,18,新百王,2023-09-18,6210
2440,太空梭,18,0,18,新百王,2023-09-18,6210
2031,新光鋼,18,0,18,新百王,2023-09-18,6210
2352,佳世達,33,15,18,新百王,2023-09-18,6210
6125,廣運,18,0,18,新百王,2023-09-18,6210
2354,鴻準,39,22,17,新百王,2023-09-18,6210
2457,飛宏,17,0,17,新百王,2023-09-18,6210
2371,大同,21,4,17,新百王,2023-09-18,6210
3059,華晶科,16,0,16,新百王,2023-09-18,6210
2543,皇昌,32,16,16,新百王,2023-09-18,6210
00882,中信中國高股息,15,0,15,新百王,2023-09-18,6210
00688L,國泰20年美債正2,15,0,15,新百王,2023-09-18,6210
5905,南仁湖,18,3,15,新百王,2023-09-18,6210
2367,燿華,25,10,15,新百王,2023-09-18,6210
00753L,中信中國50正2,15,0,15,新百王,2023-09-18,6210
00830,國泰費城半導體,14,0,14,新百王,2023-09-18,6210
1504,東元,17,3,14,新百王,2023-09-18,6210
8210,勤誠,37,24,13,新百王,2023-09-18,6210
1513,中興電,14,1,13,新百王,2023-09-18,6210
2838,聯邦銀,13,0,13,新百王,2023-09-18,6210
00670L,富邦NASDAQ正2,12,0,12,新百王,2023-09-18,6210
6901,鑽石投資,140,13,127,新百王,2023-09-19,6210
2324,仁寶,100,0,100,新百王,2023-09-19,6210
2485,兆赫,111,26,85,新百王,2023-09-19,6210
2303,聯電,90,6,84,新百王,2023-09-19,6210
2312,金寶,200,132,68,新百王,2023-09-19,6210
3231,緯創,137,73,64,新百王,2023-09-19,6210
5905,南仁湖,60,0,60,新百王,2023-09-19,6210
8240,華宏,42,0,42,新百王,2023-09-19,6210
2634,漢翔,42,0,42,新百王,2023-09-19,6210
2885,元大金,45,5,40,新百王,2023-09-19,6210
00637L,元大滬深300正2,46,6,40,新百王,2023-09-19,6210
2302,麗正,40,0,40,新百王,2023-09-19,6210
3035,智原,58,23,35,新百王,2023-09-19,6210
1307,三芳,35,0,35,新百王,2023-09-19,6210
5381,合正,65,30,35,新百王,2023-09-19,6210
00919,群益台灣精選高息,39,4,35,新百王,2023-09-19,6210
2412,中華電,41,8,33,新百王,2023-09-19,6210
00650L,復華香港正2,30,0,30,新百王,2023-09-19,6210
1310,台苯,30,0,30,新百王,2023-09-19,6210
4927,泰鼎-KY,30,0,30,新百王,2023-09-19,6210
4979,華星光,59,31,28,新百王,2023-09-19,6210
2891,中信金,37,10,27,新百王,2023-09-19,6210
1313,聯成,25,0,25,新百王,2023-09-19,6210
3607,谷崧,23,0,23,新百王,2023-09-19,6210
00752,中信中國50,23,0,23,新百王,2023-09-19,6210
2010,春源,23,0,23,新百王,2023-09-19,6210
2340,台亞,25,2,23,新百王,2023-09-19,6210
2332,友訊,29,8,21,新百王,2023-09-19,6210
3481,群創,153,133,20,新百王,2023-09-19,6210
3308,聯德,17,0,17,新百王,2023-09-19,6210
4909,新復興,16,0,16,新百王,2023-09-19,6210
2330,台積電,17,1,16,新百王,2023-09-19,6210
2388,威盛,82,67,15,新百王,2023-09-19,6210
4744,皇將,15,0,15,新百王,2023-09-19,6210
5481,新華,15,0,15,新百王,2023-09-19,6210
3289,宜特,15,0,15,新百王,2023-09-19,6210
6116,彩晶,62,48,14,新百王,2023-09-19,6210
2359,所羅門,25,11,14,新百王,2023-09-19,6210
2637,慧洋-KY,21,8,13,新百王,2023-09-19,6210
3163,波若威,46,34,12,新百王,2023-09-19,6210
3390,旭軟,12,0,12,新百王,2023-09-19,6210
6284,佳邦,25,14,11,新百王,2023-09-19,6210
3059,華晶科,13,2,11,新百王,2023-09-19,6210
6269,台郡,11,0,11,新百王,2023-09-19,6210
2905,三商,11,0,11,新百王,2023-09-19,6210
6197,佳必琪,11,0,11,新百王,2023-09-19,6210
9105,泰金寶-DR,10,0,10,新百王,2023-09-19,6210
00706L,期元大S＆P日圓正2,10,0,10,新百王,2023-09-19,6210
2515,中工,10,0,10,新百王,2023-09-19,6210
2390,云辰,12,2,10,新百王,2023-09-19,6210
2324,仁寶,1401,0,1401,新百王,2023-09-20,6210
00665L,富邦�琤肭磪囓�2,157,65,92,新百王,2023-09-20,6210
00919,群益台灣精選高息,121,40,81,新百王,2023-09-20,6210
2834,臺企銀,80,0,80,新百王,2023-09-20,6210
1605,華新,101,25,76,新百王,2023-09-20,6210
00679B,元大美債20年,72,0,72,新百王,2023-09-20,6210
2409,友達,65,0,65,新百王,2023-09-20,6210
00687B,國泰20年美債,64,0,64,新百王,2023-09-20,6210
2412,中華電,50,2,48,新百王,2023-09-20,6210
2201,裕隆,49,3,46,新百王,2023-09-20,6210
2313,華通,207,164,43,新百王,2023-09-20,6210
4979,華星光,82,39,43,新百王,2023-09-20,6210
3231,緯創,177,136,41,新百王,2023-09-20,6210
2367,燿華,139,103,36,新百王,2023-09-20,6210
00673R,期元大S＆P原油反1,36,0,36,新百王,2023-09-20,6210
00929,復華台灣科技優息,281,249,32,新百王,2023-09-20,6210
2302,麗正,30,0,30,新百王,2023-09-20,6210
00706L,期元大S＆P日圓正2,30,0,30,新百王,2023-09-20,6210
2376,技嘉,62,37,25,新百王,2023-09-20,6210
8240,華宏,24,0,24,新百王,2023-09-20,6210
1609,大亞,24,2,22,新百王,2023-09-20,6210
00680L,元大美債20正2,22,0,22,新百王,2023-09-20,6210
3607,谷崧,20,0,20,新百王,2023-09-20,6210
5210,寶碩,20,0,20,新百王,2023-09-20,6210
1802,台玻,74,54,20,新百王,2023-09-20,6210
3576,聯合再生,20,0,20,新百王,2023-09-20,6210
8088,品安,75,55,20,新百王,2023-09-20,6210
3715,定穎投控,219,200,19,新百王,2023-09-20,6210
3706,神達,56,37,19,新百王,2023-09-20,6210
4162,智擎,18,0,18,新百王,2023-09-20,6210
5347,世界,18,0,18,新百王,2023-09-20,6210
2332,友訊,23,5,18,新百王,2023-09-20,6210
00753L,中信中國50正2,24,7,17,新百王,2023-09-20,6210
00632R,元大台灣50反1,20,3,17,新百王,2023-09-20,6210
3289,宜特,19,2,17,新百王,2023-09-20,6210
2352,佳世達,23,7,16,新百王,2023-09-20,6210
2605,新興,71,56,15,新百王,2023-09-20,6210
2486,一詮,18,3,15,新百王,2023-09-20,6210
4927,泰鼎-KY,15,0,15,新百王,2023-09-20,6210
3265,台星科,75,61,14,新百王,2023-09-20,6210
2618,長榮航,36,23,13,新百王,2023-09-20,6210
6116,彩晶,71,59,12,新百王,2023-09-20,6210
3122,笙泉,58,47,11,新百王,2023-09-20,6210
6153,嘉聯益,12,1,11,新百王,2023-09-20,6210
2442,新美齊,12,1,11,新百王,2023-09-20,6210
2609,陽明,28,17,11,新百王,2023-09-20,6210
2317,鴻海,14,4,10,新百王,2023-09-20,6210
2408,南亞科,11,1,10,新百王,2023-09-20,6210
3693,營邦,23,13,10,新百王,2023-09-20,6210
2440,太空梭,10,0,10,新百王,2023-09-20,6210
2890,永豐金,397,1,396,新百王,2023-09-21,6210
00632R,元大台灣50反1,240,68,172,新百王,2023-09-21,6210
6285,啟��,190,76,114,新百王,2023-09-21,6210
2883B,凱基金乙特,100,0,100,新百王,2023-09-21,6210
3264,欣銓,71,0,71,新百王,2023-09-21,6210
00665L,富邦�琤肭磪囓�2,131,66,65,新百王,2023-09-21,6210
1514,亞力,63,3,60,新百王,2023-09-21,6210
00637L,元大滬深300正2,60,1,59,新百王,2023-09-21,6210
2409,友達,62,3,59,新百王,2023-09-21,6210
3711,日月光投控,69,17,52,新百王,2023-09-21,6210
2905,三商,50,0,50,新百王,2023-09-21,6210
2412,中華電,48,0,48,新百王,2023-09-21,6210
00923,群益台ESG低碳50,47,0,47,新百王,2023-09-21,6210
8034,榮群,61,15,46,新百王,2023-09-21,6210
00680L,元大美債20正2,43,0,43,新百王,2023-09-21,6210
2836,高雄銀,42,0,42,新百王,2023-09-21,6210
2356,英業達,56,14,42,新百王,2023-09-21,6210
2312,金寶,101,62,39,新百王,2023-09-21,6210
2002,中鋼,56,20,36,新百王,2023-09-21,6210
4306,炎洲,36,0,36,新百王,2023-09-21,6210
2330,台積電,40,7,33,新百王,2023-09-21,6210
2204,中華,31,1,30,新百王,2023-09-21,6210
00753L,中信中國50正2,38,10,28,新百王,2023-09-21,6210
2891,中信金,227,200,27,新百王,2023-09-21,6210
00655L,國泰中國A50正2,46,20,26,新百王,2023-09-21,6210
2317,鴻海,26,0,26,新百王,2023-09-21,6210
2834,臺企銀,25,0,25,新百王,2023-09-21,6210
1104,環泥,25,0,25,新百王,2023-09-21,6210
5009,榮剛,25,0,25,新百王,2023-09-21,6210
1504,東元,30,6,24,新百王,2023-09-21,6210
00706L,期元大S＆P日圓正2,24,0,24,新百王,2023-09-21,6210
2301,光寶科,54,32,22,新百王,2023-09-21,6210
00633L,富邦上証正2,32,10,22,新百王,2023-09-21,6210
2618,長榮航,42,20,22,新百王,2023-09-21,6210
00675L,富邦臺灣加權正2,21,0,21,新百王,2023-09-21,6210
4958,臻鼎-KY,20,0,20,新百王,2023-09-21,6210
8088,品安,31,11,20,新百王,2023-09-21,6210
00688L,國泰20年美債正2,20,0,20,新百王,2023-09-21,6210
2382,廣達,86,67,19,新百王,2023-09-21,6210
00631L,元大台灣50正2,18,0,18,新百王,2023-09-21,6210
00687B,國泰20年美債,50,32,18,新百王,2023-09-21,6210
2601,益航,21,3,18,新百王,2023-09-21,6210
5880,合庫金,18,0,18,新百王,2023-09-21,6210
00671R,富邦NASDAQ反1,18,0,18,新百王,2023-09-21,6210
00919,群益台灣精選高息,18,0,18,新百王,2023-09-21,6210
2349,錸德,17,0,17,新百王,2023-09-21,6210
6120,達運,22,5,17,新百王,2023-09-21,6210
00932,兆豐永續高息等權,17,0,17,新百王,2023-09-21,6210
1809,中釉,66,49,17,新百王,2023-09-21,6210
6284,佳邦,51,34,17,新百王,2023-09-21,6210
00931B,統一美債20年,174,1,173,新百王,2023-09-22,6210
00929,復華台灣科技優息,252,130,122,新百王,2023-09-22,6210
2905,三商,122,6,116,新百王,2023-09-22,6210
00687B,國泰20年美債,120,10,110,新百王,2023-09-22,6210
00680L,元大美債20正2,109,0,109,新百王,2023-09-22,6210
1718,中纖,76,0,76,新百王,2023-09-22,6210
3036,文曄,123,56,67,新百王,2023-09-22,6210
2890,永豐金,116,60,56,新百王,2023-09-22,6210
00679B,元大美債20年,55,5,50,新百王,2023-09-22,6210
1609,大亞,51,2,49,新百王,2023-09-22,6210
4979,華星光,84,39,45,新百王,2023-09-22,6210
3149,正達,45,0,45,新百王,2023-09-22,6210
2460,建通,43,0,43,新百王,2023-09-22,6210
1307,三芳,40,0,40,新百王,2023-09-22,6210
3234,光環,40,8,32,新百王,2023-09-22,6210
2413,環科,30,0,30,新百王,2023-09-22,6210
1815,富喬,32,2,30,新百王,2023-09-22,6210
2891,中信金,30,0,30,新百王,2023-09-22,6210
6405,悅城,28,1,27,新百王,2023-09-22,6210
2834,臺企銀,37,13,24,新百王,2023-09-22,6210
00751B,元大AAA至A公司債,24,0,24,新百王,2023-09-22,6210
00919,群益台灣精選高息,22,0,22,新百王,2023-09-22,6210
2538,基泰,22,0,22,新百王,2023-09-22,6210
6168,宏齊,21,0,21,新百王,2023-09-22,6210
00720B,元大投資級公司債,20,0,20,新百王,2023-09-22,6210
1409,新纖,20,0,20,新百王,2023-09-22,6210
00900,富邦特選高股息30,19,0,19,新百王,2023-09-22,6210
3390,旭軟,18,0,18,新百王,2023-09-22,6210
4906,正文,20,3,17,新百王,2023-09-22,6210
2607,榮運,15,0,15,新百王,2023-09-22,6210
2883,凱基金,23,9,14,新百王,2023-09-22,6210
6190,萬泰科,16,2,14,新百王,2023-09-22,6210
2367,燿華,68,54,14,新百王,2023-09-22,6210
2356,英業達,48,35,13,新百王,2023-09-22,6210
2753,八方雲集,12,0,12,新百王,2023-09-22,6210
00715L,期街口布蘭特正2,12,1,11,新百王,2023-09-22,6210
00772B,中信高評級公司債,11,0,11,新百王,2023-09-22,6210
3588,通嘉,11,0,11,新百王,2023-09-22,6210
00895,富邦未來車,11,0,11,新百王,2023-09-22,6210
2601,益航,11,0,11,新百王,2023-09-22,6210
2303,聯電,17,6,11,新百王,2023-09-22,6210
2330,台積電,25,15,10,新百王,2023-09-22,6210
2332,友訊,10,0,10,新百王,2023-09-22,6210
5009,榮剛,10,0,10,新百王,2023-09-22,6210
2887,台新金,10,0,10,新百王,2023-09-22,6210
2612,中航,10,0,10,新百王,2023-09-22,6210
2392,正崴,10,0,10,新百王,2023-09-22,6210
2316,楠梓電,21,11,10,新百王,2023-09-22,6210
6101,寬魚國際,10,0,10,新百王,2023-09-22,6210
00642U,期元大S＆P石油,10,0,10,新百王,2023-09-22,6210
00632R,元大台灣50反1,180,16,164,新百王,2023-09-25,6210
9904,寶成,146,7,139,新百王,2023-09-25,6210
00882,中信中國高股息,100,0,100,新百王,2023-09-25,6210
00929,復華台灣科技優息,171,103,68,新百王,2023-09-25,6210
1324,地球,88,40,48,新百王,2023-09-25,6210
2601,益航,46,0,46,新百王,2023-09-25,6210
00927,群益半導體收益,43,0,43,新百王,2023-09-25,6210
3390,旭軟,42,0,42,新百王,2023-09-25,6210
8088,品安,62,27,35,新百王,2023-09-25,6210
3706,神達,67,35,32,新百王,2023-09-25,6210
2201,裕隆,85,53,32,新百王,2023-09-25,6210
2312,金寶,30,0,30,新百王,2023-09-25,6210
2421,建準,36,6,30,新百王,2023-09-25,6210
6101,寬魚國際,32,5,27,新百王,2023-09-25,6210
00665L,富邦�琤肭磪囓�2,109,86,23,新百王,2023-09-25,6210
00706L,期元大S＆P日圓正2,20,0,20,新百王,2023-09-25,6210
6288,聯嘉,19,0,19,新百王,2023-09-25,6210
3322,建舜電,41,23,18,新百王,2023-09-25,6210
00712,復華富時不動產,18,0,18,新百王,2023-09-25,6210
00671R,富邦NASDAQ反1,18,0,18,新百王,2023-09-25,6210
6405,悅城,18,0,18,新百王,2023-09-25,6210
1101,台泥,17,0,17,新百王,2023-09-25,6210
6120,達運,19,2,17,新百王,2023-09-25,6210
2412,中華電,16,0,16,新百王,2023-09-25,6210
6125,廣運,15,0,15,新百王,2023-09-25,6210
4927,泰鼎-KY,30,15,15,新百王,2023-09-25,6210
2867,三商壽,14,0,14,新百王,2023-09-25,6210
3325,旭品,14,0,14,新百王,2023-09-25,6210
00795B,中信美國公債20年,13,0,13,新百王,2023-09-25,6210
1524,耿鼎,24,11,13,新百王,2023-09-25,6210
6491,晶碩,14,1,13,新百王,2023-09-25,6210
2634,漢翔,17,5,12,新百王,2023-09-25,6210
00852L,國泰美國道瓊正2,12,0,12,新百王,2023-09-25,6210
2888,新光金,12,0,12,新百王,2023-09-25,6210
2208,台船,16,5,11,新百王,2023-09-25,6210
00751B,元大AAA至A公司債,10,0,10,新百王,2023-09-25,6210
3483,力致,10,0,10,新百王,2023-09-25,6210
2354,鴻準,13,3,10,新百王,2023-09-25,6210
3607,谷崧,10,0,10,新百王,2023-09-25,6210
9105,泰金寶-DR,10,0,10,新百王,2023-09-25,6210
3122,笙泉,10,0,10,新百王,2023-09-25,6210
2352,佳世達,11,2,9,新百王,2023-09-25,6210
1519,華城,15,6,9,新百王,2023-09-25,6210
6578,達邦蛋白,10,1,9,新百王,2023-09-25,6210
2358,廷鑫,21,12,9,新百王,2023-09-25,6210
00931B,統一美債20年,12,3,9,新百王,2023-09-25,6210
8271,宇瞻,8,0,8,新百王,2023-09-25,6210
3567,逸昌,14,6,8,新百王,2023-09-25,6210
4207,環泰,8,0,8,新百王,2023-09-25,6210
6274,台燿,51,43,8,新百王,2023-09-25,6210
00931B,統一美債20年,141,3,138,新百王,2023-09-26,6210
2836,高雄銀,100,0,100,新百王,2023-09-26,6210
00637L,元大滬深300正2,101,2,99,新百王,2023-09-26,6210
2634,漢翔,68,1,67,新百王,2023-09-26,6210
00665L,富邦�琤肭磪囓�2,78,21,57,新百王,2023-09-26,6210
00772B,中信高評級公司債,61,5,56,新百王,2023-09-26,6210
1324,地球,90,36,54,新百王,2023-09-26,6210
3322,建舜電,54,6,48,新百王,2023-09-26,6210
3711,日月光投控,48,2,46,新百王,2023-09-26,6210
2303,聯電,47,1,46,新百王,2023-09-26,6210
3715,定穎投控,121,80,41,新百王,2023-09-26,6210
00795B,中信美國公債20年,47,10,37,新百王,2023-09-26,6210
2851,中再保,37,2,35,新百王,2023-09-26,6210
2392,正崴,34,0,34,新百王,2023-09-26,6210
3036,文曄,51,21,30,新百王,2023-09-26,6210
1522,堤維西,107,78,29,新百王,2023-09-26,6210
1314,中石化,27,0,27,新百王,2023-09-26,6210
2330,台積電,41,17,24,新百王,2023-09-26,6210
6282,康舒,25,2,23,新百王,2023-09-26,6210
00655L,國泰中國A50正2,23,0,23,新百王,2023-09-26,6210
1817,凱撒衛,22,0,22,新百王,2023-09-26,6210
00919,群益台灣精選高息,30,8,22,新百王,2023-09-26,6210
2427,三商電,22,1,21,新百王,2023-09-26,6210
00706L,期元大S＆P日圓正2,20,0,20,新百王,2023-09-26,6210
2485,兆赫,29,9,20,新百王,2023-09-26,6210
6120,達運,31,15,16,新百王,2023-09-26,6210
2543,皇昌,15,0,15,新百王,2023-09-26,6210
00631L,元大台灣50正2,15,0,15,新百王,2023-09-26,6210
2442,新美齊,18,3,15,新百王,2023-09-26,6210
6116,彩晶,15,0,15,新百王,2023-09-26,6210
2607,榮運,15,0,15,新百王,2023-09-26,6210
3693,營邦,29,14,15,新百王,2023-09-26,6210
2382,廣達,39,24,15,新百王,2023-09-26,6210
2201,裕隆,18,5,13,新百王,2023-09-26,6210
6122,擎邦,34,21,13,新百王,2023-09-26,6210
2208,台船,13,0,13,新百王,2023-09-26,6210
00885,富邦越南,18,5,13,新百王,2023-09-26,6210
6285,啟��,59,46,13,新百王,2023-09-26,6210
00675L,富邦臺灣加權正2,12,0,12,新百王,2023-09-26,6210
00633L,富邦上証正2,12,0,12,新百王,2023-09-26,6210
2344,華邦電,21,10,11,新百王,2023-09-26,6210
2352,佳世達,11,0,11,新百王,2023-09-26,6210
2362,藍天,11,0,11,新百王,2023-09-26,6210
00712,復華富時不動產,11,0,11,新百王,2023-09-26,6210
4927,泰鼎-KY,20,10,10,新百王,2023-09-26,6210
2534,宏盛,10,0,10,新百王,2023-09-26,6210
2816,旺旺保,19,9,10,新百王,2023-09-26,6210
00673R,期元大S＆P原油反1,10,0,10,新百王,2023-09-26,6210
5009,榮剛,10,0,10,新百王,2023-09-26,6210
00753L,中信中國50正2,11,1,10,新百王,2023-09-26,6210
00632R,元大台灣50反1,570,234,336,新百王,2023-09-27,6210
2002,中鋼,232,44,188,新百王,2023-09-27,6210
00687B,國泰20年美債,92,0,92,新百王,2023-09-27,6210
6120,達運,71,0,71,新百王,2023-09-27,6210
3294,英濟,65,0,65,新百王,2023-09-27,6210
00751B,元大AAA至A公司債,48,4,44,新百王,2023-09-27,6210
3171,炎洲流通,40,0,40,新百王,2023-09-27,6210
00725B,國泰投資級公司債,48,16,32,新百王,2023-09-27,6210
8034,榮群,39,9,30,新百王,2023-09-27,6210
2460,建通,28,0,28,新百王,2023-09-27,6210
3149,正達,27,0,27,新百王,2023-09-27,6210
5519,隆大,25,0,25,新百王,2023-09-27,6210
00929,復華台灣科技優息,53,30,23,新百王,2023-09-27,6210
1802,台玻,36,13,23,新百王,2023-09-27,6210
3715,定穎投控,223,200,23,新百王,2023-09-27,6210
00679B,元大美債20年,58,38,20,新百王,2023-09-27,6210
8420,明揚,67,48,19,新百王,2023-09-27,6210
00671R,富邦NASDAQ反1,18,0,18,新百王,2023-09-27,6210
00665L,富邦�琤肭磪囓�2,61,43,18,新百王,2023-09-27,6210
4927,泰鼎-KY,16,0,16,新百王,2023-09-27,6210
00919,群益台灣精選高息,15,0,15,新百王,2023-09-27,6210
3078,僑威,15,0,15,新百王,2023-09-27,6210
4744,皇將,18,3,15,新百王,2023-09-27,6210
2362,藍天,14,0,14,新百王,2023-09-27,6210
8436,大江,14,0,14,新百王,2023-09-27,6210
3037,欣興,39,26,13,新百王,2023-09-27,6210
2337,旺宏,15,2,13,新百王,2023-09-27,6210
2392,正崴,13,0,13,新百王,2023-09-27,6210
00885,富邦越南,15,2,13,新百王,2023-09-27,6210
2303,聯電,11,0,11,新百王,2023-09-27,6210
2317,鴻海,10,0,10,新百王,2023-09-27,6210
3051,力特,14,4,10,新百王,2023-09-27,6210
2849,安泰銀,10,0,10,新百王,2023-09-27,6210
4944,兆遠,10,0,10,新百王,2023-09-27,6210
00655L,國泰中國A50正2,10,0,10,新百王,2023-09-27,6210
00673R,期元大S＆P原油反1,10,0,10,新百王,2023-09-27,6210
3707,漢磊,10,0,10,新百王,2023-09-27,6210
4919,新唐,10,0,10,新百王,2023-09-27,6210
1609,大亞,57,47,10,新百王,2023-09-27,6210
3548,兆利,26,17,9,新百王,2023-09-27,6210
00719B,元大美債1-3,9,0,9,新百王,2023-09-27,6210
3607,谷崧,8,0,8,新百王,2023-09-27,6210
1310,台苯,11,3,8,新百王,2023-09-27,6210
6266,泰詠,8,0,8,新百王,2023-09-27,6210
1560,中砂,15,7,8,新百王,2023-09-27,6210
4564,元翎,12,5,7,新百王,2023-09-27,6210
2542,興富發,7,0,7,新百王,2023-09-27,6210
00637L,元大滬深300正2,18,12,6,新百王,2023-09-27,6210
3689,湧德,6,0,6,新百王,2023-09-27,6210
4933,友輝,7,1,6,新百王,2023-09-27,6210
2002,中鋼,227,1,226,新百王,2023-09-28,6210
00665L,富邦�琤肭磪囓�2,160,0,160,新百王,2023-09-28,6210
00931B,統一美債20年,142,0,142,新百王,2023-09-28,6210
1616,億泰,91,0,91,新百王,2023-09-28,6210
00929,復華台灣科技優息,146,57,89,新百王,2023-09-28,6210
00795B,中信美國公債20年,88,0,88,新百王,2023-09-28,6210
2344,華邦電,82,0,82,新百王,2023-09-28,6210
6125,廣運,84,5,79,新百王,2023-09-28,6210
1514,亞力,69,14,55,新百王,2023-09-28,6210
6156,松上,46,0,46,新百王,2023-09-28,6210
00637L,元大滬深300正2,55,10,45,新百王,2023-09-28,6210
3122,笙泉,118,75,43,新百王,2023-09-28,6210
6116,彩晶,31,0,31,新百王,2023-09-28,6210
3704,合勤控,33,3,30,新百王,2023-09-28,6210
2610,華航,30,0,30,新百王,2023-09-28,6210
00712,復華富時不動產,29,0,29,新百王,2023-09-28,6210
2515,中工,25,0,25,新百王,2023-09-28,6210
8070,長華*,24,0,24,新百王,2023-09-28,6210
2359,所羅門,20,0,20,新百王,2023-09-28,6210
00633L,富邦上証正2,29,10,19,新百王,2023-09-28,6210
3567,逸昌,19,0,19,新百王,2023-09-28,6210
5324,士開,18,0,18,新百王,2023-09-28,6210
2408,南亞科,38,22,16,新百王,2023-09-28,6210
4744,皇將,18,2,16,新百王,2023-09-28,6210
2881,富邦金,15,0,15,新百王,2023-09-28,6210
00655L,國泰中國A50正2,15,0,15,新百王,2023-09-28,6210
3051,力特,15,0,15,新百王,2023-09-28,6210
2376,技嘉,41,26,15,新百王,2023-09-28,6210
00919,群益台灣精選高息,14,0,14,新百王,2023-09-28,6210
00715L,期街口布蘭特正2,16,2,14,新百王,2023-09-28,6210
3036,文曄,175,162,13,新百王,2023-09-28,6210
00687B,國泰20年美債,15,2,13,新百王,2023-09-28,6210
2615,萬海,15,3,12,新百王,2023-09-28,6210
00673R,期元大S＆P原油反1,17,5,12,新百王,2023-09-28,6210
3231,緯創,92,80,12,新百王,2023-09-28,6210
2609,陽明,22,10,12,新百王,2023-09-28,6210
2618,長榮航,26,14,12,新百王,2023-09-28,6210
2442,新美齊,13,1,12,新百王,2023-09-28,6210
2369,菱生,11,0,11,新百王,2023-09-28,6210
3026,禾伸堂,11,0,11,新百王,2023-09-28,6210
1802,台玻,45,35,10,新百王,2023-09-28,6210
00882,中信中國高股息,10,0,10,新百王,2023-09-28,6210
4706,大恭,10,0,10,新百王,2023-09-28,6210
2301,光寶科,35,25,10,新百王,2023-09-28,6210
2834,臺企銀,12,3,9,新百王,2023-09-28,6210
1101,台泥,9,0,9,新百王,2023-09-28,6210
2883B,凱基金乙特,9,0,9,新百王,2023-09-28,6210
3362,先進光,9,1,8,新百王,2023-09-28,6210
6451,訊芯-KY,15,7,8,新百王,2023-09-28,6210
3092,鴻碩,8,0,8,新百王,2023-09-28,6210
2313,華通,241,36,205,新百王,2023-10-02,6210
1815,富喬,125,14,111,新百王,2023-10-02,6210
2356,英業達,184,98,86,新百王,2023-10-02,6210
00929,復華台灣科技優息,114,38,76,新百王,2023-10-02,6210
1611,中電,70,0,70,新百王,2023-10-02,6210
5213,亞昕,63,0,63,新百王,2023-10-02,6210
2603,長榮,55,9,46,新百王,2023-10-02,6210
6156,松上,47,3,44,新百王,2023-10-02,6210
2610,華航,42,0,42,新百王,2023-10-02,6210
00772B,中信高評級公司債,56,15,41,新百王,2023-10-02,6210
00931B,統一美債20年,40,0,40,新百王,2023-10-02,6210
00706L,期元大S＆P日圓正2,37,0,37,新百王,2023-10-02,6210
8936,國統,39,6,33,新百王,2023-10-02,6210
2324,仁寶,50,19,31,新百王,2023-10-02,6210
5519,隆大,28,0,28,新百王,2023-10-02,6210
2542,興富發,28,0,28,新百王,2023-10-02,6210
4916,事欣科,28,0,28,新百王,2023-10-02,6210
2365,昆盈,30,2,28,新百王,2023-10-02,6210
9105,泰金寶-DR,26,0,26,新百王,2023-10-02,6210
00919,群益台灣精選高息,39,13,26,新百王,2023-10-02,6210
00680L,元大美債20正2,26,1,25,新百王,2023-10-02,6210
4162,智擎,28,4,24,新百王,2023-10-02,6210
2615,萬海,22,0,22,新百王,2023-10-02,6210
6191,精成科,25,4,21,新百王,2023-10-02,6210
2609,陽明,31,10,21,新百王,2023-10-02,6210
5452,佶優,34,14,20,新百王,2023-10-02,6210
00676R,富邦臺灣加權反1,20,0,20,新百王,2023-10-02,6210
1584,精剛,19,0,19,新百王,2023-10-02,6210
1603,華電,20,2,18,新百王,2023-10-02,6210
00670L,富邦NASDAQ正2,21,3,18,新百王,2023-10-02,6210
6418,詠昇,17,0,17,新百王,2023-10-02,6210
2027,大成鋼,17,0,17,新百王,2023-10-02,6210
00632R,元大台灣50反1,28,12,16,新百王,2023-10-02,6210
2867,三商壽,15,0,15,新百王,2023-10-02,6210
00719B,元大美債1-3,15,0,15,新百王,2023-10-02,6210
2641,正德,15,0,15,新百王,2023-10-02,6210
2605,新興,18,4,14,新百王,2023-10-02,6210
6576,逸達,15,1,14,新百王,2023-10-02,6210
2376,技嘉,45,31,14,新百王,2023-10-02,6210
6285,啟��,18,5,13,新百王,2023-10-02,6210
2329,華泰,25,12,13,新百王,2023-10-02,6210
2002,中鋼,24,12,12,新百王,2023-10-02,6210
2402,毅嘉,23,11,12,新百王,2023-10-02,6210
3564,其陽,12,0,12,新百王,2023-10-02,6210
8240,華宏,12,0,12,新百王,2023-10-02,6210
2515,中工,71,59,12,新百王,2023-10-02,6210
2723,美食-KY,11,0,11,新百王,2023-10-02,6210
00713,元大台灣高息低波,10,0,10,新百王,2023-10-02,6210
2637,慧洋-KY,10,0,10,新百王,2023-10-02,6210
00751B,元大AAA至A公司債,10,0,10,新百王,2023-10-02,6210
3481,群創,472,220,252,新百王,2023-10-03,6210
00929,復華台灣科技優息,190,42,148,新百王,2023-10-03,6210
2363,矽統,225,102,123,新百王,2023-10-03,6210
00931B,統一美債20年,110,0,110,新百王,2023-10-03,6210
2834,臺企銀,120,12,108,新百王,2023-10-03,6210
00637L,元大滬深300正2,76,0,76,新百王,2023-10-03,6210
2417,圓剛,77,5,72,新百王,2023-10-03,6210
00753L,中信中國50正2,53,0,53,新百王,2023-10-03,6210
3122,笙泉,51,3,48,新百王,2023-10-03,6210
00680L,元大美債20正2,43,0,43,新百王,2023-10-03,6210
00655L,國泰中國A50正2,43,0,43,新百王,2023-10-03,6210
00712,復華富時不動產,44,1,43,新百王,2023-10-03,6210
3715,定穎投控,126,85,41,新百王,2023-10-03,6210
00751B,元大AAA至A公司債,32,0,32,新百王,2023-10-03,6210
00795B,中信美國公債20年,31,0,31,新百王,2023-10-03,6210
00720B,元大投資級公司債,30,0,30,新百王,2023-10-03,6210
2601,益航,26,0,26,新百王,2023-10-03,6210
1802,台玻,128,102,26,新百王,2023-10-03,6210
00633L,富邦上証正2,26,0,26,新百王,2023-10-03,6210
0056,元大高股息,42,20,22,新百王,2023-10-03,6210
2002,中鋼,22,0,22,新百王,2023-10-03,6210
00687B,國泰20年美債,21,0,21,新百王,2023-10-03,6210
2352,佳世達,20,0,20,新百王,2023-10-03,6210
2891,中信金,220,201,19,新百王,2023-10-03,6210
2610,華航,20,2,18,新百王,2023-10-03,6210
3702,大聯大,18,0,18,新百王,2023-10-03,6210
2603,長榮,22,4,18,新百王,2023-10-03,6210
1504,東元,17,0,17,新百王,2023-10-03,6210
1324,地球,17,0,17,新百王,2023-10-03,6210
6156,松上,17,0,17,新百王,2023-10-03,6210
9946,三發地產,18,1,17,新百王,2023-10-03,6210
00905,FT臺灣Smart,17,0,17,新百王,2023-10-03,6210
3325,旭品,129,115,14,新百王,2023-10-03,6210
3078,僑威,15,1,14,新百王,2023-10-03,6210
6284,佳邦,15,2,13,新百王,2023-10-03,6210
00900,富邦特選高股息30,13,0,13,新百王,2023-10-03,6210
3689,湧德,14,1,13,新百王,2023-10-03,6210
00878,國泰永續高股息,12,0,12,新百王,2023-10-03,6210
5905,南仁湖,12,0,12,新百王,2023-10-03,6210
2367,燿華,12,0,12,新百王,2023-10-03,6210
2356,英業達,52,41,11,新百王,2023-10-03,6210
2317,鴻海,11,0,11,新百王,2023-10-03,6210
3264,欣銓,12,1,11,新百王,2023-10-03,6210
4979,華星光,22,11,11,新百王,2023-10-03,6210
3013,晟銘電,49,38,11,新百王,2023-10-03,6210
9105,泰金寶-DR,11,0,11,新百王,2023-10-03,6210
2421,建準,27,17,10,新百王,2023-10-03,6210
1611,中電,10,0,10,新百王,2023-10-03,6210
3234,光環,14,4,10,新百王,2023-10-03,6210
1104,環泥,10,0,10,新百王,2023-10-03,6210
2851,中再保,203,0,203,新百王,2023-10-04,6210
2405,輔信,149,0,149,新百王,2023-10-04,6210
2324,仁寶,127,0,127,新百王,2023-10-04,6210
9962,有益,127,0,127,新百王,2023-10-04,6210
00931B,統一美債20年,115,0,115,新百王,2023-10-04,6210
00665L,富邦�琤肭磪囓�2,108,0,108,新百王,2023-10-04,6210
5009,榮剛,93,2,91,新百王,2023-10-04,6210
2515,中工,143,73,70,新百王,2023-10-04,6210
00795B,中信美國公債20年,58,0,58,新百王,2023-10-04,6210
00712,復華富時不動產,58,1,57,新百王,2023-10-04,6210
0056,元大高股息,51,0,51,新百王,2023-10-04,6210
1104,環泥,43,0,43,新百王,2023-10-04,6210
6443,元晶,42,0,42,新百王,2023-10-04,6210
2607,榮運,33,0,33,新百王,2023-10-04,6210
3231,緯創,70,37,33,新百王,2023-10-04,6210
00719B,元大美債1-3,31,0,31,新百王,2023-10-04,6210
9934,成霖,31,0,31,新百王,2023-10-04,6210
2303,聯電,29,0,29,新百王,2023-10-04,6210
1605,華新,29,0,29,新百王,2023-10-04,6210
00720B,元大投資級公司債,27,0,27,新百王,2023-10-04,6210
2409,友達,57,32,25,新百王,2023-10-04,6210
1504,東元,30,5,25,新百王,2023-10-04,6210
2891,中信金,25,0,25,新百王,2023-10-04,6210
00687B,國泰20年美債,24,0,24,新百王,2023-10-04,6210
00753L,中信中國50正2,28,4,24,新百王,2023-10-04,6210
2904,匯僑,23,0,23,新百王,2023-10-04,6210
2002,中鋼,32,10,22,新百王,2023-10-04,6210
2352,佳世達,22,0,22,新百王,2023-10-04,6210
00922,國泰台灣領袖50,19,1,18,新百王,2023-10-04,6210
2845,遠東銀,18,0,18,新百王,2023-10-04,6210
00688L,國泰20年美債正2,18,0,18,新百王,2023-10-04,6210
1101,台泥,16,0,16,新百王,2023-10-04,6210
00637L,元大滬深300正2,18,2,16,新百王,2023-10-04,6210
00751B,元大AAA至A公司債,15,0,15,新百王,2023-10-04,6210
1524,耿鼎,16,2,14,新百王,2023-10-04,6210
2538,基泰,17,4,13,新百王,2023-10-04,6210
3322,建舜電,16,4,12,新百王,2023-10-04,6210
1301,台塑,11,0,11,新百王,2023-10-04,6210
2542,興富發,11,0,11,新百王,2023-10-04,6210
2353,宏��,19,8,11,新百王,2023-10-04,6210
5425,台半,11,0,11,新百王,2023-10-04,6210
2356,英業達,35,24,11,新百王,2023-10-04,6210
2388,威盛,32,21,11,新百王,2023-10-04,6210
4958,臻鼎-KY,11,0,11,新百王,2023-10-04,6210
00882,中信中國高股息,10,0,10,新百王,2023-10-04,6210
00895,富邦未來車,10,0,10,新百王,2023-10-04,6210
3576,聯合再生,10,0,10,新百王,2023-10-04,6210
2905,三商,10,0,10,新百王,2023-10-04,6210
9930,中聯資源,11,1,10,新百王,2023-10-04,6210
6799,來頡,24,14,10,新百王,2023-10-04,6210
8011,台通,211,1,210,新百王,2023-10-05,6210
00687B,國泰20年美債,135,1,134,新百王,2023-10-05,6210
6156,松上,118,2,116,新百王,2023-10-05,6210
2883,凱基金,101,0,101,新百王,2023-10-05,6210
9950,萬國通,105,5,100,新百王,2023-10-05,6210
00927,群益半導體收益,80,0,80,新百王,2023-10-05,6210
00712,復華富時不動產,72,0,72,新百王,2023-10-05,6210
1802,台玻,72,11,61,新百王,2023-10-05,6210
00715L,期街口布蘭特正2,58,0,58,新百王,2023-10-05,6210
2538,基泰,92,38,54,新百王,2023-10-05,6210
00773B,中信優先金融債,50,1,49,新百王,2023-10-05,6210
4927,泰鼎-KY,40,0,40,新百王,2023-10-05,6210
2618,長榮航,80,43,37,新百王,2023-10-05,6210
3704,合勤控,39,4,35,新百王,2023-10-05,6210
5272,笙科,35,4,31,新百王,2023-10-05,6210
00929,復華台灣科技優息,93,64,29,新百王,2023-10-05,6210
6285,啟��,47,18,29,新百王,2023-10-05,6210
2536,宏普,22,0,22,新百王,2023-10-05,6210
2888,新光金,22,0,22,新百王,2023-10-05,6210
2302,麗正,21,0,21,新百王,2023-10-05,6210
00720B,元大投資級公司債,20,1,19,新百王,2023-10-05,6210
5392,能率,27,8,19,新百王,2023-10-05,6210
2201,裕隆,22,4,18,新百王,2023-10-05,6210
2388,威盛,62,45,17,新百王,2023-10-05,6210
5508,永信建,17,0,17,新百王,2023-10-05,6210
2637,慧洋-KY,17,1,16,新百王,2023-10-05,6210
8940,新天地,16,0,16,新百王,2023-10-05,6210
2460,建通,25,9,16,新百王,2023-10-05,6210
4744,皇將,26,11,15,新百王,2023-10-05,6210
2104,國際中橡,13,0,13,新百王,2023-10-05,6210
2891,中信金,18,6,12,新百王,2023-10-05,6210
2359,所羅門,13,2,11,新百王,2023-10-05,6210
1522,堤維西,17,6,11,新百王,2023-10-05,6210
1817,凱撒衛,11,0,11,新百王,2023-10-05,6210
6244,茂迪,23,12,11,新百王,2023-10-05,6210
1609,大亞,13,3,10,新百王,2023-10-05,6210
2412,中華電,10,0,10,新百王,2023-10-05,6210
2312,金寶,10,0,10,新百王,2023-10-05,6210
9919,康那香,10,0,10,新百王,2023-10-05,6210
2892,第一金,10,0,10,新百王,2023-10-05,6210
2382,廣達,39,29,10,新百王,2023-10-05,6210
3036,文曄,112,104,8,新百王,2023-10-05,6210
3044,健鼎,12,4,8,新百王,2023-10-05,6210
2002,中鋼,26,19,7,新百王,2023-10-05,6210
2317,鴻海,11,4,7,新百王,2023-10-05,6210
2376,技嘉,18,11,7,新百王,2023-10-05,6210
00857B,永豐20年美公債,7,0,7,新百王,2023-10-05,6210
3362,先進光,22,15,7,新百王,2023-10-05,6210
3596,智易,14,7,7,新百王,2023-10-05,6210
1503,士電,13,7,6,新百王,2023-10-05,6210
2324,仁寶,532,12,520,新百王,2023-10-06,6210
00687B,國泰20年美債,193,0,193,新百王,2023-10-06,6210
8011,台通,140,0,140,新百王,2023-10-06,6210
00929,復華台灣科技優息,121,5,116,新百王,2023-10-06,6210
1102,亞泥,104,0,104,新百王,2023-10-06,6210
3481,群創,269,200,69,新百王,2023-10-06,6210
2329,華泰,95,27,68,新百王,2023-10-06,6210
2409,友達,56,0,56,新百王,2023-10-06,6210
4714,永捷,54,4,50,新百王,2023-10-06,6210
3264,欣銓,42,0,42,新百王,2023-10-06,6210
00712,復華富時不動產,37,0,37,新百王,2023-10-06,6210
00919,群益台灣精選高息,36,2,34,新百王,2023-10-06,6210
6684,安格,38,8,30,新百王,2023-10-06,6210
6156,松上,30,3,27,新百王,2023-10-06,6210
2520,冠德,33,7,26,新百王,2023-10-06,6210
6101,寬魚國際,22,0,22,新百王,2023-10-06,6210
00772B,中信高評級公司債,21,0,21,新百王,2023-10-06,6210
4543,萬在,39,19,20,新百王,2023-10-06,6210
00632R,元大台灣50反1,20,0,20,新百王,2023-10-06,6210
5519,隆大,20,0,20,新百王,2023-10-06,6210
1339,昭輝,54,35,19,新百王,2023-10-06,6210
5469,瀚宇博,19,1,18,新百王,2023-10-06,6210
00680L,元大美債20正2,17,0,17,新百王,2023-10-06,6210
6125,廣運,22,6,16,新百王,2023-10-06,6210
1504,東元,23,7,16,新百王,2023-10-06,6210
00665L,富邦�琤肭磪囓�2,32,16,16,新百王,2023-10-06,6210
2472,立隆電,14,0,14,新百王,2023-10-06,6210
6657,華安,14,0,14,新百王,2023-10-06,6210
4909,新復興,13,1,12,新百王,2023-10-06,6210
2538,基泰,18,6,12,新百王,2023-10-06,6210
3122,笙泉,51,39,12,新百王,2023-10-06,6210
00720B,元大投資級公司債,12,0,12,新百王,2023-10-06,6210
6799,來頡,16,5,11,新百王,2023-10-06,6210
1605,華新,20,9,11,新百王,2023-10-06,6210
2364,倫飛,11,0,11,新百王,2023-10-06,6210
8940,新天地,10,0,10,新百王,2023-10-06,6210
2355,敬鵬,10,0,10,新百王,2023-10-06,6210
2832,台產,9,0,9,新百王,2023-10-06,6210
8147,正淩,11,3,8,新百王,2023-10-06,6210
3701,大眾控,19,11,8,新百王,2023-10-06,6210
5531,鄉林,8,1,7,新百王,2023-10-06,6210
6432,今展科,7,0,7,新百王,2023-10-06,6210
1609,大亞,17,10,7,新百王,2023-10-06,6210
2356,英業達,21,15,6,新百王,2023-10-06,6210
3044,健鼎,9,3,6,新百王,2023-10-06,6210
3526,凡甲,8,2,6,新百王,2023-10-06,6210
3694,海華,13,7,6,新百王,2023-10-06,6210
3380,明泰,6,0,6,新百王,2023-10-06,6210
1460,宏遠,6,0,6,新百王,2023-10-06,6210
3276,宇環,42,36,6,新百王,2023-10-06,6210
2363,矽統,224,36,188,新百王,2023-10-11,6210
3231,緯創,203,90,113,新百王,2023-10-11,6210
2515,中工,83,20,63,新百王,2023-10-11,6210
2634,漢翔,56,5,51,新百王,2023-10-11,6210
00687B,國泰20年美債,111,60,51,新百王,2023-10-11,6210
1316,上曜,50,0,50,新百王,2023-10-11,6210
00725B,國泰投資級公司債,48,0,48,新百王,2023-10-11,6210
00642U,期元大S＆P石油,41,0,41,新百王,2023-10-11,6210
2356,英業達,63,22,41,新百王,2023-10-11,6210
00673R,期元大S＆P原油反1,37,0,37,新百王,2023-10-11,6210
6684,安格,41,8,33,新百王,2023-10-11,6210
2615,萬海,44,13,31,新百王,2023-10-11,6210
6120,達運,31,0,31,新百王,2023-10-11,6210
00919,群益台灣精選高息,30,0,30,新百王,2023-10-11,6210
00666R,富邦�琤肭磪齯�1,30,0,30,新百王,2023-10-11,6210
1504,東元,35,6,29,新百王,2023-10-11,6210
6127,九豪,27,0,27,新百王,2023-10-11,6210
2542,興富發,27,0,27,新百王,2023-10-11,6210
2536,宏普,26,0,26,新百王,2023-10-11,6210
2610,華航,25,0,25,新百王,2023-10-11,6210
6799,來頡,32,8,24,新百王,2023-10-11,6210
2376,技嘉,58,35,23,新百王,2023-10-11,6210
4714,永捷,22,0,22,新百王,2023-10-11,6210
6125,廣運,23,2,21,新百王,2023-10-11,6210
00706L,期元大S＆P日圓正2,20,0,20,新百王,2023-10-11,6210
1796,金穎生技,20,0,20,新百王,2023-10-11,6210
00795B,中信美國公債20年,20,0,20,新百王,2023-10-11,6210
4306,炎洲,18,0,18,新百王,2023-10-11,6210
2603,長榮,45,28,17,新百王,2023-10-11,6210
3715,定穎投控,137,121,16,新百王,2023-10-11,6210
2637,慧洋-KY,16,0,16,新百王,2023-10-11,6210
5519,隆大,15,0,15,新百王,2023-10-11,6210
9950,萬國通,17,2,15,新百王,2023-10-11,6210
3706,神達,18,4,14,新百王,2023-10-11,6210
6235,華孚,16,2,14,新百王,2023-10-11,6210
6101,寬魚國際,14,0,14,新百王,2023-10-11,6210
4744,皇將,16,2,14,新百王,2023-10-11,6210
2338,光罩,15,2,13,新百王,2023-10-11,6210
2601,益航,13,0,13,新百王,2023-10-11,6210
3693,營邦,21,9,12,新百王,2023-10-11,6210
00720B,元大投資級公司債,12,0,12,新百王,2023-10-11,6210
8940,新天地,12,0,12,新百王,2023-10-11,6210
3483,力致,21,9,12,新百王,2023-10-11,6210
2539,櫻花建,12,0,12,新百王,2023-10-11,6210
6197,佳必琪,14,3,11,新百王,2023-10-11,6210
5309,系統電,11,0,11,新百王,2023-10-11,6210
3701,大眾控,12,1,11,新百王,2023-10-11,6210
0056,元大高股息,49,38,11,新百王,2023-10-11,6210
2421,建準,33,23,10,新百王,2023-10-11,6210
5469,瀚宇博,24,13,11,新百王,2023-10-11,6210
2618,長榮航,257,33,224,新百王,2023-10-12,6210
00687B,國泰20年美債,127,15,112,新百王,2023-10-12,6210
2408,南亞科,76,23,53,新百王,2023-10-12,6210
00900,富邦特選高股息30,52,7,45,新百王,2023-10-12,6210
00720B,元大投資級公司債,36,0,36,新百王,2023-10-12,6210
4207,環泰,30,0,30,新百王,2023-10-12,6210
00706L,期元大S＆P日圓正2,30,0,30,新百王,2023-10-12,6210
2516,新建,30,0,30,新百王,2023-10-12,6210
3044,健鼎,31,4,27,新百王,2023-10-12,6210
5348,正能量智能,24,0,24,新百王,2023-10-12,6210
2610,華航,26,3,23,新百王,2023-10-12,6210
6120,達運,23,0,23,新百王,2023-10-12,6210
2427,三商電,50,28,22,新百王,2023-10-12,6210
00857B,永豐20年美公債,20,0,20,新百王,2023-10-12,6210
4927,泰鼎-KY,20,0,20,新百王,2023-10-12,6210
3483,力致,40,21,19,新百王,2023-10-12,6210
8183,精星,19,0,19,新百王,2023-10-12,6210
2313,華通,35,17,18,新百王,2023-10-12,6210
6108,競國,18,0,18,新百王,2023-10-12,6210
3037,欣興,22,5,17,新百王,2023-10-12,6210
00773B,中信優先金融債,16,0,16,新百王,2023-10-12,6210
2605,新興,16,0,16,新百王,2023-10-12,6210
9950,萬國通,23,7,16,新百王,2023-10-12,6210
3122,笙泉,47,31,16,新百王,2023-10-12,6210
1815,富喬,15,0,15,新百王,2023-10-12,6210
00919,群益台灣精選高息,15,0,15,新百王,2023-10-12,6210
1603,華電,53,38,15,新百王,2023-10-12,6210
3481,群創,26,12,14,新百王,2023-10-12,6210
00878,國泰永續高股息,13,0,13,新百王,2023-10-12,6210
8271,宇瞻,13,0,13,新百王,2023-10-12,6210
8105,凌巨,13,0,13,新百王,2023-10-12,6210
2352,佳世達,13,0,13,新百王,2023-10-12,6210
2883B,凱基金乙特,12,0,12,新百王,2023-10-12,6210
8093,保銳,12,0,12,新百王,2023-10-12,6210
8436,大江,13,1,12,新百王,2023-10-12,6210
2382,廣達,84,72,12,新百王,2023-10-12,6210
00864B,中信美國公債0-1,11,0,11,新百王,2023-10-12,6210
2601,益航,14,3,11,新百王,2023-10-12,6210
3607,谷崧,11,0,11,新百王,2023-10-12,6210
2412,中華電,15,5,10,新百王,2023-10-12,6210
6578,達邦蛋白,10,0,10,新百王,2023-10-12,6210
6689,伊雲谷,16,6,10,新百王,2023-10-12,6210
1453,大將,10,0,10,新百王,2023-10-12,6210
2607,榮運,10,0,10,新百王,2023-10-12,6210
00882,中信中國高股息,10,0,10,新百王,2023-10-12,6210
4933,友輝,10,0,10,新百王,2023-10-12,6210
2536,宏普,17,7,10,新百王,2023-10-12,6210
9938,百和,10,0,10,新百王,2023-10-12,6210
6244,茂迪,10,0,10,新百王,2023-10-12,6210
5434,崇越,9,0,9,新百王,2023-10-12,6210
2409,友達,307,5,302,新百王,2023-10-13,6210
00687B,國泰20年美債,113,2,111,新百王,2023-10-13,6210
2324,仁寶,129,22,107,新百王,2023-10-13,6210
00720B,元大投資級公司債,82,0,82,新百王,2023-10-13,6210
00637L,元大滬深300正2,74,6,68,新百王,2023-10-13,6210
00931B,統一美債20年,64,0,64,新百王,2023-10-13,6210
00795B,中信美國公債20年,60,0,60,新百王,2023-10-13,6210
4162,智擎,47,5,42,新百王,2023-10-13,6210
00632R,元大台灣50反1,42,0,42,新百王,2023-10-13,6210
2382,廣達,185,145,40,新百王,2023-10-13,6210
6284,佳邦,81,51,30,新百王,2023-10-13,6210
00878,國泰永續高股息,29,0,29,新百王,2023-10-13,6210
2363,矽統,627,598,29,新百王,2023-10-13,6210
2376,技嘉,56,30,26,新百王,2023-10-13,6210
2301,光寶科,56,31,25,新百王,2023-10-13,6210
2607,榮運,68,43,25,新百王,2023-10-13,6210
3715,定穎投控,110,86,24,新百王,2023-10-13,6210
1802,台玻,95,74,21,新百王,2023-10-13,6210
8940,新天地,28,8,20,新百王,2023-10-13,6210
3694,海華,22,2,20,新百王,2023-10-13,6210
00655L,國泰中國A50正2,19,0,19,新百王,2023-10-13,6210
5215,科嘉-KY,20,2,18,新百王,2023-10-13,6210
2618,長榮航,41,24,17,新百王,2023-10-13,6210
2439,美律,20,3,17,新百王,2023-10-13,6210
3217,優群,16,0,16,新百王,2023-10-13,6210
3231,緯創,78,62,16,新百王,2023-10-13,6210
2610,華航,16,0,16,新百王,2023-10-13,6210
3044,健鼎,17,2,15,新百王,2023-10-13,6210
1101,台泥,14,0,14,新百王,2023-10-13,6210
00633L,富邦上証正2,19,5,14,新百王,2023-10-13,6210
9105,泰金寶-DR,13,0,13,新百王,2023-10-13,6210
00712,復華富時不動產,13,0,13,新百王,2023-10-13,6210
6150,撼訊,14,1,13,新百王,2023-10-13,6210
3607,谷崧,12,0,12,新百王,2023-10-13,6210
1504,東元,18,6,12,新百王,2023-10-13,6210
6689,伊雲谷,19,8,11,新百王,2023-10-13,6210
00680L,元大美債20正2,26,15,11,新百王,2023-10-13,6210
2412,中華電,12,1,11,新百王,2023-10-13,6210
2605,新興,17,6,11,新百王,2023-10-13,6210
00864B,中信美國公債0-1,11,0,11,新百王,2023-10-13,6210
1524,耿鼎,25,15,10,新百王,2023-10-13,6210
2535,達欣工,10,0,10,新百王,2023-10-13,6210
00688L,國泰20年美債正2,10,0,10,新百王,2023-10-13,6210
00665L,富邦�琤肭磪囓�2,68,58,10,新百王,2023-10-13,6210
9919,康那香,10,0,10,新百王,2023-10-13,6210
2745,五福,10,0,10,新百王,2023-10-13,6210
00706L,期元大S＆P日圓正2,10,0,10,新百王,2023-10-13,6210
6216,居易,14,4,10,新百王,2023-10-13,6210
6788,華景電,11,1,10,新百王,2023-10-13,6210
2851,中再保,13,3,10,新百王,2023-10-13,6210
00929,復華台灣科技優息,495,6,489,新百王,2023-10-16,6210
00931B,統一美債20年,121,50,71,新百王,2023-10-16,6210
2324,仁寶,54,1,53,新百王,2023-10-16,6210
00772B,中信高評級公司債,51,5,46,新百王,2023-10-16,6210
2607,榮運,32,0,32,新百王,2023-10-16,6210
6237,驊訊,32,0,32,新百王,2023-10-16,6210
2887,台新金,30,0,30,新百王,2023-10-16,6210
1506,正道,30,0,30,新百王,2023-10-16,6210
5215,科嘉-KY,30,1,29,新百王,2023-10-16,6210
0056,元大高股息,27,2,25,新百王,2023-10-16,6210
00637L,元大滬深300正2,22,0,22,新百王,2023-10-16,6210
2014,中鴻,20,0,20,新百王,2023-10-16,6210
1101,台泥,22,2,20,新百王,2023-10-16,6210
4707,磐亞,20,0,20,新百王,2023-10-16,6210
3231,緯創,45,26,19,新百王,2023-10-16,6210
2382,廣達,126,108,18,新百王,2023-10-16,6210
00655L,國泰中國A50正2,20,2,18,新百王,2023-10-16,6210
2409,友達,17,0,17,新百王,2023-10-16,6210
2515,中工,108,91,17,新百王,2023-10-16,6210
6139,亞翔,25,9,16,新百王,2023-10-16,6210
1785,光洋科,47,31,16,新百王,2023-10-16,6210
1568,倉佑,15,0,15,新百王,2023-10-16,6210
2344,華邦電,90,75,15,新百王,2023-10-16,6210
8059,凱碩,15,0,15,新百王,2023-10-16,6210
00712,復華富時不動產,18,4,14,新百王,2023-10-16,6210
6788,華景電,14,0,14,新百王,2023-10-16,6210
3694,海華,15,2,13,新百王,2023-10-16,6210
2363,矽統,234,222,12,新百王,2023-10-16,6210
1702,南僑,12,0,12,新百王,2023-10-16,6210
00864B,中信美國公債0-1,11,0,11,新百王,2023-10-16,6210
6235,華孚,23,13,10,新百王,2023-10-16,6210
1701,中化,10,0,10,新百王,2023-10-16,6210
00633L,富邦上証正2,10,0,10,新百王,2023-10-16,6210
6405,悅城,10,0,10,新百王,2023-10-16,6210
2406,國碩,10,0,10,新百王,2023-10-16,6210
3264,欣銓,10,0,10,新百王,2023-10-16,6210
1605,華新,9,0,9,新百王,2023-10-16,6210
2201,裕隆,51,42,9,新百王,2023-10-16,6210
3483,力致,42,33,9,新百王,2023-10-16,6210
3037,欣興,26,17,9,新百王,2023-10-16,6210
4743,合一,10,2,8,新百王,2023-10-16,6210
00662,富邦NASDAQ,8,0,8,新百王,2023-10-16,6210
9105,泰金寶-DR,8,0,8,新百王,2023-10-16,6210
3607,谷崧,8,0,8,新百王,2023-10-16,6210
4908,前鼎,111,104,7,新百王,2023-10-16,6210
00665L,富邦�琤肭磪囓�2,55,48,7,新百王,2023-10-16,6210
3276,宇環,11,4,7,新百王,2023-10-16,6210
6530,創威,12,5,7,新百王,2023-10-16,6210
3715,定穎投控,90,83,7,新百王,2023-10-16,6210
00922,國泰台灣領袖50,6,0,6,新百王,2023-10-16,6210
00687B,國泰20年美債,133,0,133,新百王,2023-10-17,6210
00719B,元大美債1-3,80,0,80,新百王,2023-10-17,6210
1314,中石化,81,20,61,新百王,2023-10-17,6210
00720B,元大投資級公司債,61,0,61,新百王,2023-10-17,6210
2834,臺企銀,60,0,60,新百王,2023-10-17,6210
00795B,中信美國公債20年,60,1,59,新百王,2023-10-17,6210
3715,定穎投控,150,94,56,新百王,2023-10-17,6210
4744,皇將,50,0,50,新百王,2023-10-17,6210
4944,兆遠,50,0,50,新百王,2023-10-17,6210
2363,矽統,383,335,48,新百王,2023-10-17,6210
0056,元大高股息,43,0,43,新百王,2023-10-17,6210
8048,德勝,54,12,42,新百王,2023-10-17,6210
00929,復華台灣科技優息,506,465,41,新百王,2023-10-17,6210
2301,光寶科,141,105,36,新百王,2023-10-17,6210
2412,中華電,32,2,30,新百王,2023-10-17,6210
1504,東元,34,4,30,新百王,2023-10-17,6210
2352,佳世達,25,0,25,新百王,2023-10-17,6210
3682,亞太電,22,0,22,新百王,2023-10-17,6210
00680L,元大美債20正2,27,5,22,新百王,2023-10-17,6210
1609,大亞,22,1,21,新百王,2023-10-17,6210
3094,聯傑,31,10,21,新百王,2023-10-17,6210
2884,玉山金,21,0,21,新百王,2023-10-17,6210
3231,緯創,96,76,20,新百王,2023-10-17,6210
00931B,統一美債20年,26,6,20,新百王,2023-10-17,6210
4714,永捷,20,0,20,新百王,2023-10-17,6210
2401,凌陽,23,3,20,新百王,2023-10-17,6210
2515,中工,179,159,20,新百王,2023-10-17,6210
5880,合庫金,20,0,20,新百王,2023-10-17,6210
2356,英業達,53,34,19,新百王,2023-10-17,6210
2851,中再保,18,0,18,新百王,2023-10-17,6210
6788,華景電,17,0,17,新百王,2023-10-17,6210
2637,慧洋-KY,28,14,14,新百王,2023-10-17,6210
2498,宏達電,46,32,14,新百王,2023-10-17,6210
6104,創惟,27,14,13,新百王,2023-10-17,6210
6432,今展科,13,0,13,新百王,2023-10-17,6210
3481,群創,22,10,12,新百王,2023-10-17,6210
2201,裕隆,17,5,12,新百王,2023-10-17,6210
00919,群益台灣精選高息,26,15,11,新百王,2023-10-17,6210
2543,皇昌,16,5,11,新百王,2023-10-17,6210
4904,遠傳,12,1,11,新百王,2023-10-17,6210
4726,永昕,11,0,11,新百王,2023-10-17,6210
3483,力致,33,23,10,新百王,2023-10-17,6210
00650L,復華香港正2,10,0,10,新百王,2023-10-17,6210
00662,富邦NASDAQ,9,0,9,新百王,2023-10-17,6210
5347,世界,17,8,9,新百王,2023-10-17,6210
00637L,元大滬深300正2,20,11,9,新百王,2023-10-17,6210
1471,首利,12,3,9,新百王,2023-10-17,6210
6531,愛普*,18,9,9,新百王,2023-10-17,6210
1513,中興電,11,2,9,新百王,2023-10-17,6210
2313,華通,62,54,8,新百王,2023-10-17,6210
2605,新興,107,22,85,新百王,2023-10-18,6210
00929,復華台灣科技優息,89,7,82,新百王,2023-10-18,6210
00878,國泰永續高股息,83,2,81,新百王,2023-10-18,6210
6285,啟��,108,27,81,新百王,2023-10-18,6210
00687B,國泰20年美債,74,0,74,新百王,2023-10-18,6210
6237,驊訊,181,119,62,新百王,2023-10-18,6210
0056,元大高股息,84,27,57,新百王,2023-10-18,6210
00772B,中信高評級公司債,56,0,56,新百王,2023-10-18,6210
4944,兆遠,50,0,50,新百王,2023-10-18,6210
3363,上詮,57,16,41,新百王,2023-10-18,6210
2534,宏盛,40,0,40,新百王,2023-10-18,6210
2382,廣達,116,80,36,新百王,2023-10-18,6210
1101,台泥,32,0,32,新百王,2023-10-18,6210
00922,國泰台灣領袖50,31,0,31,新百王,2023-10-18,6210
2601,益航,29,0,29,新百王,2023-10-18,6210
5009,榮剛,28,0,28,新百王,2023-10-18,6210
4162,智擎,40,12,28,新百王,2023-10-18,6210
2809,京城銀,28,0,28,新百王,2023-10-18,6210
2353,宏��,34,6,28,新百王,2023-10-18,6210
00720B,元大投資級公司債,26,0,26,新百王,2023-10-18,6210
2408,南亞科,25,1,24,新百王,2023-10-18,6210
2352,佳世達,23,0,23,新百王,2023-10-18,6210
2412,中華電,36,14,22,新百王,2023-10-18,6210
00932,兆豐永續高息等權,22,0,22,新百王,2023-10-18,6210
3231,緯創,165,144,21,新百王,2023-10-18,6210
1524,耿鼎,38,17,21,新百王,2023-10-18,6210
2618,長榮航,43,22,21,新百王,2023-10-18,6210
1440,南紡,20,0,20,新百王,2023-10-18,6210
4927,泰鼎-KY,20,0,20,新百王,2023-10-18,6210
5215,科嘉-KY,24,5,19,新百王,2023-10-18,6210
3017,奇鋐,27,10,17,新百王,2023-10-18,6210
3272,東碩,17,0,17,新百王,2023-10-18,6210
2359,所羅門,16,0,16,新百王,2023-10-18,6210
2388,威盛,129,113,16,新百王,2023-10-18,6210
2340,台亞,20,5,15,新百王,2023-10-18,6210
4726,永昕,15,0,15,新百王,2023-10-18,6210
2409,友達,22,8,14,新百王,2023-10-18,6210
1314,中石化,20,7,13,新百王,2023-10-18,6210
3557,嘉威,13,0,13,新百王,2023-10-18,6210
2002,中鋼,20,8,12,新百王,2023-10-18,6210
2498,宏達電,14,2,12,新百王,2023-10-18,6210
8088,品安,16,4,12,新百王,2023-10-18,6210
6114,久威,12,0,12,新百王,2023-10-18,6210
8478,東哥遊艇,13,1,12,新百王,2023-10-18,6210
2884,玉山金,11,0,11,新百王,2023-10-18,6210
1736,喬山,11,0,11,新百王,2023-10-18,6210
1618,合機,11,0,11,新百王,2023-10-18,6210
5484,慧友,11,0,11,新百王,2023-10-18,6210
00864B,中信美國公債0-1,11,0,11,新百王,2023-10-18,6210
2362,藍天,11,0,11,新百王,2023-10-18,6210
2882,國泰金,169,9,160,新百王,2023-10-19,6210
00665L,富邦�琤肭磪囓�2,153,30,123,新百王,2023-10-19,6210
2883,凱基金,105,0,105,新百王,2023-10-19,6210
00929,復華台灣科技優息,118,16,102,新百王,2023-10-19,6210
00719B,元大美債1-3,98,0,98,新百王,2023-10-19,6210
0056,元大高股息,75,6,69,新百王,2023-10-19,6210
3322,建舜電,65,0,65,新百王,2023-10-19,6210
2409,友達,57,0,57,新百王,2023-10-19,6210
00687B,國泰20年美債,57,0,57,新百王,2023-10-19,6210
00720B,元大投資級公司債,60,5,55,新百王,2023-10-19,6210
00680L,元大美債20正2,57,3,54,新百王,2023-10-19,6210
00795B,中信美國公債20年,64,10,54,新百王,2023-10-19,6210
2834,臺企銀,68,15,53,新百王,2023-10-19,6210
00933B,國泰10Y+金融債,53,0,53,新百王,2023-10-19,6210
2880,華南金,51,0,51,新百王,2023-10-19,6210
00650L,復華香港正2,40,0,40,新百王,2023-10-19,6210
6158,禾昌,38,6,32,新百王,2023-10-19,6210
00655L,國泰中國A50正2,32,0,32,新百王,2023-10-19,6210
2317,鴻海,37,6,31,新百王,2023-10-19,6210
2399,映泰,30,0,30,新百王,2023-10-19,6210
1316,上曜,30,0,30,新百王,2023-10-19,6210
2353,宏��,32,2,30,新百王,2023-10-19,6210
2501,國建,28,0,28,新百王,2023-10-19,6210
2376,技嘉,32,5,27,新百王,2023-10-19,6210
2645,長榮航太,25,0,25,新百王,2023-10-19,6210
2027,大成鋼,25,0,25,新百王,2023-10-19,6210
1504,東元,26,1,25,新百王,2023-10-19,6210
00895,富邦未來車,23,0,23,新百王,2023-10-19,6210
2363,矽統,38,15,23,新百王,2023-10-19,6210
3363,上詮,24,3,21,新百王,2023-10-19,6210
1605,華新,17,0,17,新百王,2023-10-19,6210
00893,國泰智能電動車,17,0,17,新百王,2023-10-19,6210
2002,中鋼,17,1,16,新百王,2023-10-19,6210
00751B,元大AAA至A公司債,16,0,16,新百王,2023-10-19,6210
00712,復華富時不動產,17,2,15,新百王,2023-10-19,6210
1806,冠軍,15,0,15,新百王,2023-10-19,6210
2888,新光金,15,0,15,新百王,2023-10-19,6210
5215,科嘉-KY,14,0,14,新百王,2023-10-19,6210
6901,鑽石投資,17,4,13,新百王,2023-10-19,6210
00885,富邦越南,18,5,13,新百王,2023-10-19,6210
6282,康舒,35,22,13,新百王,2023-10-19,6210
3056,富華新,12,0,12,新百王,2023-10-19,6210
5425,台半,13,1,12,新百王,2023-10-19,6210
6203,海韻電,13,1,12,新百王,2023-10-19,6210
3032,偉訓,18,7,11,新百王,2023-10-19,6210
00670L,富邦NASDAQ正2,11,0,11,新百王,2023-10-19,6210
00722B,群益投資級電信債,10,0,10,新百王,2023-10-19,6210
00673R,期元大S＆P原油反1,10,0,10,新百王,2023-10-19,6210
00639,富邦深100,10,0,10,新百王,2023-10-19,6210
1710,東聯,10,0,10,新百王,2023-10-19,6210
2891,中信金,319,13,306,新百王,2023-10-20,6210
00632R,元大台灣50反1,200,14,186,新百王,2023-10-20,6210
2363,矽統,75,5,70,新百王,2023-10-20,6210
00772B,中信高評級公司債,53,0,53,新百王,2023-10-20,6210
2849,安泰銀,52,0,52,新百王,2023-10-20,6210
00712,復華富時不動產,47,0,47,新百王,2023-10-20,6210
00679B,元大美債20年,44,0,44,新百王,2023-10-20,6210
00929,復華台灣科技優息,68,27,41,新百王,2023-10-20,6210
2002,中鋼,39,5,34,新百王,2023-10-20,6210
6290,良維,41,7,34,新百王,2023-10-20,6210
2637,慧洋-KY,30,0,30,新百王,2023-10-20,6210
6237,驊訊,55,26,29,新百王,2023-10-20,6210
4744,皇將,37,9,28,新百王,2023-10-20,6210
00687B,國泰20年美債,77,50,27,新百王,2023-10-20,6210
3025,星通,127,102,25,新百王,2023-10-20,6210
6104,創惟,25,0,25,新百王,2023-10-20,6210
1324,地球,79,54,25,新百王,2023-10-20,6210
2204,中華,24,0,24,新百王,2023-10-20,6210
00665L,富邦�琤肭磪囓�2,23,0,23,新百王,2023-10-20,6210
2462,良得電,37,14,23,新百王,2023-10-20,6210
00919,群益台灣精選高息,23,1,22,新百王,2023-10-20,6210
00720B,元大投資級公司債,22,0,22,新百王,2023-10-20,6210
5531,鄉林,21,0,21,新百王,2023-10-20,6210
4927,泰鼎-KY,20,0,20,新百王,2023-10-20,6210
1314,中石化,20,0,20,新百王,2023-10-20,6210
1101,台泥,19,0,19,新百王,2023-10-20,6210
2317,鴻海,33,15,18,新百王,2023-10-20,6210
2515,中工,18,0,18,新百王,2023-10-20,6210
4552,力達-KY,24,6,18,新百王,2023-10-20,6210
6438,迅得,20,5,15,新百王,2023-10-20,6210
3709,鑫聯大投控,23,8,15,新百王,2023-10-20,6210
3272,東碩,34,20,14,新百王,2023-10-20,6210
3122,笙泉,181,168,13,新百王,2023-10-20,6210
1799,易威,12,0,12,新百王,2023-10-20,6210
1736,喬山,12,0,12,新百王,2023-10-20,6210
9938,百和,13,1,12,新百王,2023-10-20,6210
4958,臻鼎-KY,11,0,11,新百王,2023-10-20,6210
2645,長榮航太,11,0,11,新百王,2023-10-20,6210
6269,台郡,11,0,11,新百王,2023-10-20,6210
2887,台新金,13,2,11,新百王,2023-10-20,6210
00885,富邦越南,13,2,11,新百王,2023-10-20,6210
00713,元大台灣高息低波,17,7,10,新百王,2023-10-20,6210
2330,台積電,43,32,11,新百王,2023-10-20,6210
5871,中租-KY,30,20,10,新百王,2023-10-20,6210
1710,東聯,10,0,10,新百王,2023-10-20,6210
00631L,元大台灣50正2,10,0,10,新百王,2023-10-20,6210
8171,天宇,10,0,10,新百王,2023-10-20,6210
2442,新美齊,10,0,10,新百王,2023-10-20,6210
6578,達邦蛋白,10,0,10,新百王,2023-10-20,6210
1409,新纖,10,0,10,新百王,2023-10-20,6210
6237,驊訊,205,76,129,新百王,2023-10-23,6210
00687B,國泰20年美債,85,0,85,新百王,2023-10-23,6210
2890,永豐金,166,83,83,新百王,2023-10-23,6210
2881,富邦金,89,11,78,新百王,2023-10-23,6210
00929,復華台灣科技優息,84,10,74,新百王,2023-10-23,6210
00712,復華富時不動產,73,0,73,新百王,2023-10-23,6210
2409,友達,62,8,54,新百王,2023-10-23,6210
2317,鴻海,51,4,47,新百王,2023-10-23,6210
00882,中信中國高股息,50,3,47,新百王,2023-10-23,6210
2883B,凱基金乙特,39,0,39,新百王,2023-10-23,6210
2308,台達電,30,0,30,新百王,2023-10-23,6210
3078,僑威,62,32,30,新百王,2023-10-23,6210
2515,中工,126,98,28,新百王,2023-10-23,6210
3051,力特,107,81,26,新百王,2023-10-23,6210
00680L,元大美債20正2,25,0,25,新百王,2023-10-23,6210
3322,建舜電,27,2,25,新百王,2023-10-23,6210
4958,臻鼎-KY,24,0,24,新百王,2023-10-23,6210
1802,台玻,45,24,21,新百王,2023-10-23,6210
3711,日月光投控,22,4,18,新百王,2023-10-23,6210
2849,安泰銀,18,0,18,新百王,2023-10-23,6210
3666,光耀,18,0,18,新百王,2023-10-23,6210
00720B,元大投資級公司債,18,0,18,新百王,2023-10-23,6210
2399,映泰,38,21,17,新百王,2023-10-23,6210
00719B,元大美債1-3,16,0,16,新百王,2023-10-23,6210
00637L,元大滬深300正2,25,10,15,新百王,2023-10-23,6210
00933B,國泰10Y+金融債,14,0,14,新百王,2023-10-23,6210
2468,華經,28,15,13,新百王,2023-10-23,6210
2027,大成鋼,19,6,13,新百王,2023-10-23,6210
2382,廣達,54,42,12,新百王,2023-10-23,6210
00919,群益台灣精選高息,12,0,12,新百王,2023-10-23,6210
6418,詠昇,12,0,12,新百王,2023-10-23,6210
3032,偉訓,21,10,11,新百王,2023-10-23,6210
6901,鑽石投資,11,0,11,新百王,2023-10-23,6210
4927,泰鼎-KY,11,0,11,新百王,2023-10-23,6210
3025,星通,41,30,11,新百王,2023-10-23,6210
6269,台郡,11,0,11,新百王,2023-10-23,6210
6147,頎邦,13,2,11,新百王,2023-10-23,6210
00922,國泰台灣領袖50,20,10,10,新百王,2023-10-23,6210
2645,長榮航太,10,0,10,新百王,2023-10-23,6210
3325,旭品,12,2,10,新百王,2023-10-23,6210
00895,富邦未來車,10,0,10,新百王,2023-10-23,6210
6113,亞矽,20,11,9,新百王,2023-10-23,6210
2543,皇昌,15,6,9,新百王,2023-10-23,6210
2610,華航,21,12,9,新百王,2023-10-23,6210
8088,品安,11,2,9,新百王,2023-10-23,6210
2498,宏達電,11,3,8,新百王,2023-10-23,6210
00675L,富邦臺灣加權正2,8,0,8,新百王,2023-10-23,6210
6229,研通,8,0,8,新百王,2023-10-23,6210
6186,新潤,8,0,8,新百王,2023-10-23,6210
2401,凌陽,28,20,8,新百王,2023-10-23,6210
3041,揚智,360,135,225,新百王,2023-10-24,6210
00637L,元大滬深300正2,88,26,62,新百王,2023-10-24,6210
00753L,中信中國50正2,55,0,55,新百王,2023-10-24,6210
00712,復華富時不動產,53,0,53,新百王,2023-10-24,6210
00632R,元大台灣50反1,103,50,53,新百王,2023-10-24,6210
3322,建舜電,55,11,44,新百王,2023-10-24,6210
2834,臺企銀,51,12,39,新百王,2023-10-24,6210
2369,菱生,154,117,37,新百王,2023-10-24,6210
1609,大亞,40,5,35,新百王,2023-10-24,6210
2520,冠德,34,0,34,新百王,2023-10-24,6210
2317,鴻海,50,17,33,新百王,2023-10-24,6210
2352,佳世達,28,1,27,新百王,2023-10-24,6210
00687B,國泰20年美債,149,123,26,新百王,2023-10-24,6210
4743,合一,53,31,22,新百王,2023-10-24,6210
00882,中信中國高股息,20,0,20,新百王,2023-10-24,6210
2367,燿華,22,2,20,新百王,2023-10-24,6210
3122,笙泉,63,44,19,新百王,2023-10-24,6210
5213,亞昕,18,0,18,新百王,2023-10-24,6210
8048,德勝,25,8,17,新百王,2023-10-24,6210
3176,基亞,16,0,16,新百王,2023-10-24,6210
4958,臻鼎-KY,15,0,15,新百王,2023-10-24,6210
3372,典範,20,5,15,新百王,2023-10-24,6210
1795,美時,28,13,15,新百王,2023-10-24,6210
2468,華經,15,0,15,新百王,2023-10-24,6210
2408,南亞科,16,2,14,新百王,2023-10-24,6210
2645,長榮航太,15,1,14,新百王,2023-10-24,6210
00852L,國泰美國道瓊正2,13,0,13,新百王,2023-10-24,6210
1789,神隆,13,0,13,新百王,2023-10-24,6210
3032,偉訓,29,16,13,新百王,2023-10-24,6210
00929,復華台灣科技優息,18,6,12,新百王,2023-10-24,6210
4960,誠美材,34,22,12,新百王,2023-10-24,6210
00881,國泰台灣5G+,21,10,11,新百王,2023-10-24,6210
2849,安泰銀,11,0,11,新百王,2023-10-24,6210
00795B,中信美國公債20年,11,0,11,新百王,2023-10-24,6210
6592,和潤企業,11,0,11,新百王,2023-10-24,6210
4128,中天,12,1,11,新百王,2023-10-24,6210
2883,凱基金,16,5,11,新百王,2023-10-24,6210
2884,玉山金,11,1,10,新百王,2023-10-24,6210
2354,鴻準,10,0,10,新百王,2023-10-24,6210
2359,所羅門,10,0,10,新百王,2023-10-24,6210
00670L,富邦NASDAQ正2,10,0,10,新百王,2023-10-24,6210
3059,華晶科,10,0,10,新百王,2023-10-24,6210
5508,永信建,10,0,10,新百王,2023-10-24,6210
1457,宜進,10,0,10,新百王,2023-10-24,6210
00919,群益台灣精選高息,19,10,9,新百王,2023-10-24,6210
4746,台耀,10,1,9,新百王,2023-10-24,6210
6237,驊訊,18,9,9,新百王,2023-10-24,6210
2206,三陽工業,10,1,9,新百王,2023-10-24,6210
6231,系微,9,1,8,新百王,2023-10-24,6210
3705,永信,8,0,8,新百王,2023-10-24,6210
00632R,元大台灣50反1,163,10,153,新百王,2023-10-25,6210
9105,泰金寶-DR,108,0,108,新百王,2023-10-25,6210
00712,復華富時不動產,91,0,91,新百王,2023-10-25,6210
2849,安泰銀,70,0,70,新百王,2023-10-25,6210
1721,三晃,126,58,68,新百王,2023-10-25,6210
1609,大亞,57,1,56,新百王,2023-10-25,6210
2515,中工,188,146,42,新百王,2023-10-25,6210
00864B,中信美國公債0-1,36,0,36,新百王,2023-10-25,6210
2834,臺企銀,97,61,36,新百王,2023-10-25,6210
3025,星通,109,75,34,新百王,2023-10-25,6210
2543,皇昌,50,17,33,新百王,2023-10-25,6210
00687B,國泰20年美債,104,72,32,新百王,2023-10-25,6210
00724B,群益投資級金融債,32,0,32,新百王,2023-10-25,6210
00665L,富邦�琤肭磪囓�2,100,68,32,新百王,2023-10-25,6210
00772B,中信高評級公司債,82,52,30,新百王,2023-10-25,6210
1616,億泰,30,0,30,新百王,2023-10-25,6210
2412,中華電,35,12,23,新百王,2023-10-25,6210
6117,迎廣,35,14,21,新百王,2023-10-25,6210
5302,太欣,20,0,20,新百王,2023-10-25,6210
2809,京城銀,22,3,19,新百王,2023-10-25,6210
00929,復華台灣科技優息,37,20,17,新百王,2023-10-25,6210
4105,東洋,15,0,15,新百王,2023-10-25,6210
2337,旺宏,37,22,15,新百王,2023-10-25,6210
2427,三商電,94,79,15,新百王,2023-10-25,6210
3322,建舜電,77,63,14,新百王,2023-10-25,6210
4552,力達-KY,14,0,14,新百王,2023-10-25,6210
6216,居易,20,7,13,新百王,2023-10-25,6210
2308,台達電,12,1,11,新百王,2023-10-25,6210
00670L,富邦NASDAQ正2,11,1,10,新百王,2023-10-25,6210
4746,台耀,10,0,10,新百王,2023-10-25,6210
2441,超豐,10,0,10,新百王,2023-10-25,6210
2399,映泰,12,2,10,新百王,2023-10-25,6210
00655L,國泰中國A50正2,20,10,10,新百王,2023-10-25,6210
5215,科嘉-KY,13,3,10,新百王,2023-10-25,6210
5272,笙科,26,16,10,新百王,2023-10-25,6210
2832,台產,10,0,10,新百王,2023-10-25,6210
1524,耿鼎,168,159,9,新百王,2023-10-25,6210
5386,青雲,16,7,9,新百王,2023-10-25,6210
2634,漢翔,12,3,9,新百王,2023-10-25,6210
2363,矽統,14,5,9,新百王,2023-10-25,6210
2520,冠德,10,1,9,新百王,2023-10-25,6210
4908,前鼎,21,12,9,新百王,2023-10-25,6210
5009,榮剛,14,5,9,新百王,2023-10-25,6210
2615,萬海,9,0,9,新百王,2023-10-25,6210
8436,大江,8,0,8,新百王,2023-10-25,6210
1101,台泥,9,2,7,新百王,2023-10-25,6210
3122,笙泉,23,16,7,新百王,2023-10-25,6210
2886,兆豐金,11,4,7,新百王,2023-10-25,6210
00933B,國泰10Y+金融債,10,3,7,新百王,2023-10-25,6210
6197,佳必琪,28,21,7,新百王,2023-10-25,6210
6237,驊訊,137,37,100,新百王,2023-10-26,6210
8054,安國,102,6,96,新百王,2023-10-26,6210
1721,三晃,223,134,89,新百王,2023-10-26,6210
00665L,富邦�琤肭磪囓�2,246,163,83,新百王,2023-10-26,6210
00919,群益台灣精選高息,84,5,79,新百王,2023-10-26,6210
2344,華邦電,78,7,71,新百王,2023-10-26,6210
2883,凱基金,67,0,67,新百王,2023-10-26,6210
2303,聯電,75,12,63,新百王,2023-10-26,6210
00795B,中信美國公債20年,73,10,63,新百王,2023-10-26,6210
6120,達運,60,0,60,新百王,2023-10-26,6210
4552,力達-KY,65,9,56,新百王,2023-10-26,6210
2369,菱生,88,42,46,新百王,2023-10-26,6210
00712,復華富時不動產,63,20,43,新百王,2023-10-26,6210
1609,大亞,38,1,37,新百王,2023-10-26,6210
00929,復華台灣科技優息,152,116,36,新百王,2023-10-26,6210
4744,皇將,39,4,35,新百王,2023-10-26,6210
2405,輔信,34,0,34,新百王,2023-10-26,6210
9105,泰金寶-DR,31,0,31,新百王,2023-10-26,6210
2353,宏��,30,0,30,新百王,2023-10-26,6210
5905,南仁湖,25,0,25,新百王,2023-10-26,6210
3363,上詮,55,30,25,新百王,2023-10-26,6210
2515,中工,188,163,25,新百王,2023-10-26,6210
3037,欣興,58,34,24,新百王,2023-10-26,6210
00720B,元大投資級公司債,22,0,22,新百王,2023-10-26,6210
6741,91APP*-KY,22,1,21,新百王,2023-10-26,6210
00895,富邦未來車,21,0,21,新百王,2023-10-26,6210
00680L,元大美債20正2,20,0,20,新百王,2023-10-26,6210
4128,中天,23,3,20,新百王,2023-10-26,6210
0056,元大高股息,19,0,19,新百王,2023-10-26,6210
1799,易威,19,0,19,新百王,2023-10-26,6210
00881,國泰台灣5G+,23,5,18,新百王,2023-10-26,6210
00675L,富邦臺灣加權正2,18,0,18,新百王,2023-10-26,6210
2849,安泰銀,24,6,18,新百王,2023-10-26,6210
9946,三發地產,18,0,18,新百王,2023-10-26,6210
3055,蔚華科,18,1,17,新百王,2023-10-26,6210
6197,佳必琪,29,13,16,新百王,2023-10-26,6210
1101,台泥,15,0,15,新百王,2023-10-26,6210
00878,國泰永續高股息,25,10,15,新百王,2023-10-26,6210
6158,禾昌,16,1,15,新百王,2023-10-26,6210
00687B,國泰20年美債,66,52,14,新百王,2023-10-26,6210
2382,廣達,46,32,14,新百王,2023-10-26,6210
6168,宏齊,17,3,14,新百王,2023-10-26,6210
2412,中華電,13,0,13,新百王,2023-10-26,6210
2352,佳世達,15,2,13,新百王,2023-10-26,6210
00885,富邦越南,19,6,13,新百王,2023-10-26,6210
1504,東元,14,1,13,新百王,2023-10-26,6210
8358,金居,23,11,12,新百王,2023-10-26,6210
2376,技嘉,30,18,12,新百王,2023-10-26,6210
00631L,元大台灣50正2,22,11,11,新百王,2023-10-26,6210
2317,鴻海,16,6,10,新百王,2023-10-26,6210
3481,群創,385,7,378,新百王,2023-10-27,6210
2834,臺企銀,233,64,169,新百王,2023-10-27,6210
2365,昆盈,100,0,100,新百王,2023-10-27,6210
00632R,元大台灣50反1,124,60,64,新百王,2023-10-27,6210
00712,復華富時不動產,64,0,64,新百王,2023-10-27,6210
2515,中工,104,42,62,新百王,2023-10-27,6210
3171,炎洲流通,53,0,53,新百王,2023-10-27,6210
00753L,中信中國50正2,45,0,45,新百王,2023-10-27,6210
5521,工信,50,7,43,新百王,2023-10-27,6210
4909,新復興,40,0,40,新百王,2023-10-27,6210
2462,良得電,47,8,39,新百王,2023-10-27,6210
3025,星通,64,25,39,新百王,2023-10-27,6210
0056,元大高股息,61,29,32,新百王,2023-10-27,6210
8358,金居,42,12,30,新百王,2023-10-27,6210
2409,友達,331,303,28,新百王,2023-10-27,6210
00764B,群益25年美債,30,2,28,新百王,2023-10-27,6210
6243,迅杰,24,1,23,新百王,2023-10-27,6210
6223,旺矽,22,0,22,新百王,2023-10-27,6210
6189,豐藝,24,4,20,新百王,2023-10-27,6210
4726,永昕,22,2,20,新百王,2023-10-27,6210
2002,中鋼,24,4,20,新百王,2023-10-27,6210
3346,麗清,19,0,19,新百王,2023-10-27,6210
2849,安泰銀,24,6,18,新百王,2023-10-27,6210
2405,輔信,20,3,17,新百王,2023-10-27,6210
3264,欣銓,42,27,15,新百王,2023-10-27,6210
8033,雷虎,14,0,14,新百王,2023-10-27,6210
2486,一詮,18,4,14,新百王,2023-10-27,6210
4128,中天,25,11,14,新百王,2023-10-27,6210
1504,東元,14,0,14,新百王,2023-10-27,6210
2888,新光金,14,0,14,新百王,2023-10-27,6210
8131,福懋科,13,0,13,新百王,2023-10-27,6210
3231,緯創,154,141,13,新百王,2023-10-27,6210
3016,嘉晶,13,0,13,新百王,2023-10-27,6210
1708,東鹼,12,0,12,新百王,2023-10-27,6210
2363,矽統,30,18,12,新百王,2023-10-27,6210
2408,南亞科,12,0,12,新百王,2023-10-27,6210
2801,彰銀,11,0,11,新百王,2023-10-27,6210
2516,新建,11,0,11,新百王,2023-10-27,6210
2211,長榮鋼,12,1,11,新百王,2023-10-27,6210
5386,青雲,14,4,10,新百王,2023-10-27,6210
2897,王道銀行,10,0,10,新百王,2023-10-27,6210
4552,力達-KY,13,3,10,新百王,2023-10-27,6210
00864B,中信美國公債0-1,10,0,10,新百王,2023-10-27,6210
3217,優群,14,4,10,新百王,2023-10-27,6210
3257,虹冠電,10,0,10,新百王,2023-10-27,6210
1710,東聯,10,0,10,新百王,2023-10-27,6210
2303,聯電,54,44,10,新百王,2023-10-27,6210
1799,易威,10,0,10,新百王,2023-10-27,6210
8240,華宏,11,2,9,新百王,2023-10-27,6210
1324,地球,24,15,9,新百王,2023-10-27,6210
00687B,國泰20年美債,135,3,132,新百王,2023-10-30,6210
8054,安國,241,160,81,新百王,2023-10-30,6210
00795B,中信美國公債20年,64,0,64,新百王,2023-10-30,6210
00712,復華富時不動產,65,1,64,新百王,2023-10-30,6210
2891,中信金,64,1,63,新百王,2023-10-30,6210
3032,偉訓,83,26,57,新百王,2023-10-30,6210
00665L,富邦�琤肭磪囓�2,210,153,57,新百王,2023-10-30,6210
2836,高雄銀,42,0,42,新百王,2023-10-30,6210
2832,台產,60,18,42,新百王,2023-10-30,6210
00637L,元大滬深300正2,53,14,39,新百王,2023-10-30,6210
4529,淳紳,39,1,38,新百王,2023-10-30,6210
2390,云辰,80,49,31,新百王,2023-10-30,6210
2363,矽統,37,10,27,新百王,2023-10-30,6210
6442,光聖,40,17,23,新百王,2023-10-30,6210
1785,光洋科,57,34,23,新百王,2023-10-30,6210
00722B,群益投資級電信債,20,0,20,新百王,2023-10-30,6210
00891,中信關鍵半導體,20,0,20,新百王,2023-10-30,6210
2406,國碩,20,0,20,新百王,2023-10-30,6210
2610,華航,25,8,17,新百王,2023-10-30,6210
1802,台玻,30,15,15,新百王,2023-10-30,6210
6158,禾昌,15,0,15,新百王,2023-10-30,6210
4960,誠美材,29,15,14,新百王,2023-10-30,6210
2337,旺宏,18,4,14,新百王,2023-10-30,6210
1799,易威,14,0,14,新百王,2023-10-30,6210
1101,台泥,13,0,13,新百王,2023-10-30,6210
2851,中再保,12,0,12,新百王,2023-10-30,6210
2515,中工,152,140,12,新百王,2023-10-30,6210
2485,兆赫,93,82,11,新百王,2023-10-30,6210
2352,佳世達,11,0,11,新百王,2023-10-30,6210
6443,元晶,28,17,11,新百王,2023-10-30,6210
6191,精成科,10,0,10,新百王,2023-10-30,6210
9105,泰金寶-DR,10,0,10,新百王,2023-10-30,6210
1806,冠軍,10,0,10,新百王,2023-10-30,6210
2884,玉山金,10,0,10,新百王,2023-10-30,6210
2915,潤泰全,10,0,10,新百王,2023-10-30,6210
00864B,中信美國公債0-1,10,0,10,新百王,2023-10-30,6210
5426,振發,10,0,10,新百王,2023-10-30,6210
2618,長榮航,21,11,10,新百王,2023-10-30,6210
00933B,國泰10Y+金融債,9,0,9,新百王,2023-10-30,6210
2516,新建,11,2,9,新百王,2023-10-30,6210
2536,宏普,10,1,9,新百王,2023-10-30,6210
3169,亞信,9,0,9,新百王,2023-10-30,6210
2458,義隆,10,1,9,新百王,2023-10-30,6210
3092,鴻碩,10,1,9,新百王,2023-10-30,6210
8059,凱碩,8,0,8,新百王,2023-10-30,6210
00852L,國泰美國道瓊正2,8,0,8,新百王,2023-10-30,6210
2607,榮運,8,0,8,新百王,2023-10-30,6210
2886,兆豐金,7,0,7,新百王,2023-10-30,6210
1324,地球,27,20,7,新百王,2023-10-30,6210
4128,中天,27,20,7,新百王,2023-10-30,6210
00688L,國泰20年美債正2,643,0,643,新百王,2023-10-31,6210
00665L,富邦�琤肭磪囓�2,236,110,126,新百王,2023-10-31,6210
2883,凱基金,107,17,90,新百王,2023-10-31,6210
2301,光寶科,104,20,84,新百王,2023-10-31,6210
2002,中鋼,102,21,81,新百王,2023-10-31,6210
6116,彩晶,61,6,55,新百王,2023-10-31,6210
2367,燿華,61,11,50,新百王,2023-10-31,6210
1799,易威,46,0,46,新百王,2023-10-31,6210
2607,榮運,47,2,45,新百王,2023-10-31,6210
8054,安國,90,46,44,新百王,2023-10-31,6210
1718,中纖,43,0,43,新百王,2023-10-31,6210
4744,皇將,41,3,38,新百王,2023-10-31,6210
1504,東元,36,2,34,新百王,2023-10-31,6210
00919,群益台灣精選高息,36,3,33,新百王,2023-10-31,6210
00687B,國泰20年美債,34,1,33,新百王,2023-10-31,6210
2891,中信金,34,1,33,新百王,2023-10-31,6210
3122,笙泉,108,75,33,新百王,2023-10-31,6210
00675L,富邦臺灣加權正2,32,0,32,新百王,2023-10-31,6210
00632R,元大台灣50反1,120,88,32,新百王,2023-10-31,6210
2515,中工,228,197,31,新百王,2023-10-31,6210
9105,泰金寶-DR,30,0,30,新百王,2023-10-31,6210
00929,復華台灣科技優息,36,9,27,新百王,2023-10-31,6210
4529,淳紳,26,0,26,新百王,2023-10-31,6210
2382,廣達,69,45,24,新百王,2023-10-31,6210
3037,欣興,60,37,23,新百王,2023-10-31,6210
6104,創惟,23,1,22,新百王,2023-10-31,6210
00878,國泰永續高股息,26,5,21,新百王,2023-10-31,6210
5871,中租-KY,23,3,20,新百王,2023-10-31,6210
2204,中華,18,0,18,新百王,2023-10-31,6210
2832,台產,18,0,18,新百王,2023-10-31,6210
0056,元大高股息,17,0,17,新百王,2023-10-31,6210
6547,高端疫苗,21,5,16,新百王,2023-10-31,6210
3481,群創,18,2,16,新百王,2023-10-31,6210
3094,聯傑,62,47,15,新百王,2023-10-31,6210
2402,毅嘉,26,11,15,新百王,2023-10-31,6210
3189,景碩,17,3,14,新百王,2023-10-31,6210
2851,中再保,31,17,14,新百王,2023-10-31,6210
2303,聯電,35,21,14,新百王,2023-10-31,6210
4714,永捷,14,0,14,新百王,2023-10-31,6210
00631L,元大台灣50正2,13,0,13,新百王,2023-10-31,6210
00715L,期街口布蘭特正2,13,0,13,新百王,2023-10-31,6210
2201,裕隆,15,5,10,新百王,2023-10-31,6210
00706L,期元大S＆P日圓正2,10,0,10,新百王,2023-10-31,6210
3346,麗清,11,1,10,新百王,2023-10-31,6210
00637L,元大滬深300正2,20,10,10,新百王,2023-10-31,6210
2845,遠東銀,20,10,10,新百王,2023-10-31,6210
8437,大地-KY,10,0,10,新百王,2023-10-31,6210
5272,笙科,76,66,10,新百王,2023-10-31,6210
2353,宏��,10,0,10,新百王,2023-10-31,6210
00881,國泰台灣5G+,10,0,10,新百王,2023-10-31,6210
00679B,元大美債20年,360,2,358,新百王,2023-11-01,6210
00934,中信成長高股息,161,73,88,新百王,2023-11-01,6210
1314,中石化,91,18,73,新百王,2023-11-01,6210
5348,正能量智能,72,0,72,新百王,2023-11-01,6210
00665L,富邦�琤肭磪囓�2,137,75,62,新百王,2023-11-01,6210
00935,野村臺灣新科技50,53,0,53,新百王,2023-11-01,6210
8940,新天地,36,3,33,新百王,2023-11-01,6210
1806,冠軍,30,0,30,新百王,2023-11-01,6210
00688L,國泰20年美債正2,30,0,30,新百王,2023-11-01,6210
4915,致伸,39,10,29,新百王,2023-11-01,6210
2409,友達,27,0,27,新百王,2023-11-01,6210
00795B,中信美國公債20年,27,0,27,新百王,2023-11-01,6210
00753L,中信中國50正2,26,0,26,新百王,2023-11-01,6210
00929,復華台灣科技優息,36,11,25,新百王,2023-11-01,6210
2363,矽統,29,5,24,新百王,2023-11-01,6210
00878,國泰永續高股息,24,1,23,新百王,2023-11-01,6210
4543,萬在,21,0,21,新百王,2023-11-01,6210
3372,典範,19,1,18,新百王,2023-11-01,6210
8176,智捷,17,0,17,新百王,2023-11-01,6210
6284,佳邦,86,69,17,新百王,2023-11-01,6210
1785,光洋科,17,1,16,新百王,2023-11-01,6210
2420,新巨,15,0,15,新百王,2023-11-01,6210
4744,皇將,15,0,15,新百王,2023-11-01,6210
4960,誠美材,34,19,15,新百王,2023-11-01,6210
1799,易威,15,0,15,新百王,2023-11-01,6210
3704,合勤控,35,21,14,新百王,2023-11-01,6210
00720B,元大投資級公司債,16,3,13,新百王,2023-11-01,6210
5488,松普,12,0,12,新百王,2023-11-01,6210
1605,華新,12,0,12,新百王,2023-11-01,6210
2515,中工,131,120,11,新百王,2023-11-01,6210
2890,永豐金,39,29,10,新百王,2023-11-01,6210
8936,國統,12,2,10,新百王,2023-11-01,6210
8088,品安,11,1,10,新百王,2023-11-01,6210
6237,驊訊,10,0,10,新百王,2023-11-01,6210
3059,華晶科,10,0,10,新百王,2023-11-01,6210
6176,瑞儀,14,4,10,新百王,2023-11-01,6210
2867,三商壽,10,0,10,新百王,2023-11-01,6210
2442,新美齊,10,0,10,新百王,2023-11-01,6210
2353,宏��,10,0,10,新百王,2023-11-01,6210
00900,富邦特選高股息30,10,0,10,新百王,2023-11-01,6210
6139,亞翔,21,12,9,新百王,2023-11-01,6210
2457,飛宏,11,2,9,新百王,2023-11-01,6210
1532,勤美,9,0,9,新百王,2023-11-01,6210
6223,旺矽,9,0,9,新百王,2023-11-01,6210
3036,文曄,59,51,8,新百王,2023-11-01,6210
3032,偉訓,26,18,8,新百王,2023-11-01,6210
2542,興富發,8,1,7,新百王,2023-11-01,6210
6282,康舒,8,1,7,新百王,2023-11-01,6210
2201,裕隆,18,11,7,新百王,2023-11-01,6210
3189,景碩,7,0,7,新百王,2023-11-01,6210
00679B,元大美債20年,465,1,464,新百王,2023-11-02,6210
00934,中信成長高股息,139,10,129,新百王,2023-11-02,6210
00632R,元大台灣50反1,138,10,128,新百王,2023-11-02,6210
2891,中信金,60,12,48,新百王,2023-11-02,6210
00929,復華台灣科技優息,482,439,43,新百王,2023-11-02,6210
5348,正能量智能,48,5,43,新百王,2023-11-02,6210
6770,力積電,42,0,42,新百王,2023-11-02,6210
8054,安國,194,153,41,新百王,2023-11-02,6210
2834,臺企銀,40,0,40,新百王,2023-11-02,6210
00680L,元大美債20正2,55,16,39,新百王,2023-11-02,6210
00878,國泰永續高股息,37,1,36,新百王,2023-11-02,6210
6117,迎廣,43,13,30,新百王,2023-11-02,6210
2313,華通,50,21,29,新百王,2023-11-02,6210
4927,泰鼎-KY,22,0,22,新百王,2023-11-02,6210
00891,中信關鍵半導體,28,6,22,新百王,2023-11-02,6210
2743,山富,36,17,19,新百王,2023-11-02,6210
1314,中石化,20,3,17,新百王,2023-11-02,6210
9904,寶成,20,5,15,新百王,2023-11-02,6210
2382,廣達,49,36,13,新百王,2023-11-02,6210
9958,世紀鋼,40,28,12,新百王,2023-11-02,6210
3006,晶豪科,31,19,12,新百王,2023-11-02,6210
2539,櫻花建,24,12,12,新百王,2023-11-02,6210
1736,喬山,13,1,12,新百王,2023-11-02,6210
4552,力達-KY,12,0,12,新百王,2023-11-02,6210
6470,宇智,12,0,12,新百王,2023-11-02,6210
2002,中鋼,12,1,11,新百王,2023-11-02,6210
3682,亞太電,11,0,11,新百王,2023-11-02,6210
2465,麗臺,12,1,11,新百王,2023-11-02,6210
3032,偉訓,20,10,10,新百王,2023-11-02,6210
00706L,期元大S＆P日圓正2,15,5,10,新百王,2023-11-02,6210
00673R,期元大S＆P原油反1,10,0,10,新百王,2023-11-02,6210
2103,台橡,10,0,10,新百王,2023-11-02,6210
00935,野村臺灣新科技50,10,0,10,新百王,2023-11-02,6210
6589,台康生技,10,0,10,新百王,2023-11-02,6210
2845,遠東銀,10,0,10,新百王,2023-11-02,6210
9907,統一實,10,0,10,新百王,2023-11-02,6210
5213,亞昕,10,0,10,新百王,2023-11-02,6210
2883,凱基金,9,0,9,新百王,2023-11-02,6210
2504,國產,10,1,9,新百王,2023-11-02,6210
2809,京城銀,15,6,9,新百王,2023-11-02,6210
6550,北極星藥業-KY,8,0,8,新百王,2023-11-02,6210
2455,全新,12,4,8,新百王,2023-11-02,6210
1463,強盛新,12,4,8,新百王,2023-11-02,6210
1324,地球,10,2,8,新百王,2023-11-02,6210
6214,精誠,8,0,8,新百王,2023-11-02,6210
8210,勤誠,15,7,8,新百王,2023-11-02,6210
6274,台燿,26,18,8,新百王,2023-11-02,6210
3260,威剛,20,12,8,新百王,2023-11-02,6210
2543,皇昌,34,27,7,新百王,2023-11-02,6210
6492,生華科,17,10,7,新百王,2023-11-02,6210
00679B,元大美債20年,149,8,141,新百王,2023-11-03,6210
2363,矽統,291,155,136,新百王,2023-11-03,6210
6770,力積電,115,4,111,新百王,2023-11-03,6210
00934,中信成長高股息,201,103,98,新百王,2023-11-03,6210
2498,宏達電,127,57,70,新百王,2023-11-03,6210
5213,亞昕,55,0,55,新百王,2023-11-03,6210
2353,宏��,42,2,40,新百王,2023-11-03,6210
4927,泰鼎-KY,38,0,38,新百王,2023-11-03,6210
2405,輔信,37,1,36,新百王,2023-11-03,6210
3321,同泰,30,0,30,新百王,2023-11-03,6210
6285,啟��,116,89,27,新百王,2023-11-03,6210
2412,中華電,28,2,26,新百王,2023-11-03,6210
5347,世界,23,0,23,新百王,2023-11-03,6210
2891,中信金,40,17,23,新百王,2023-11-03,6210
2317,鴻海,32,9,23,新百王,2023-11-03,6210
00864B,中信美國公債0-1,22,0,22,新百王,2023-11-03,6210
8150,南茂,20,0,20,新百王,2023-11-03,6210
4909,新復興,22,2,20,新百王,2023-11-03,6210
5328,華容,20,0,20,新百王,2023-11-03,6210
2303,聯電,39,19,20,新百王,2023-11-03,6210
4906,正文,33,13,20,新百王,2023-11-03,6210
2371,大同,23,5,18,新百王,2023-11-03,6210
00753L,中信中國50正2,20,2,18,新百王,2023-11-03,6210
2007,燁興,16,0,16,新百王,2023-11-03,6210
5533,皇鼎,50,34,16,新百王,2023-11-03,6210
9105,泰金寶-DR,16,0,16,新百王,2023-11-03,6210
2881,富邦金,18,3,15,新百王,2023-11-03,6210
2610,華航,46,32,14,新百王,2023-11-03,6210
00885,富邦越南,17,4,13,新百王,2023-11-03,6210
6451,訊芯-KY,18,5,13,新百王,2023-11-03,6210
4552,力達-KY,12,0,12,新百王,2023-11-03,6210
1760,寶齡富錦,41,29,12,新百王,2023-11-03,6210
3014,聯陽,18,6,12,新百王,2023-11-03,6210
00900,富邦特選高股息30,12,0,12,新百王,2023-11-03,6210
1434,福懋,13,1,12,新百王,2023-11-03,6210
2063,世鎧,11,0,11,新百王,2023-11-03,6210
3444,利機,14,3,11,新百王,2023-11-03,6210
2851,中再保,11,0,11,新百王,2023-11-03,6210
6117,迎廣,50,40,10,新百王,2023-11-03,6210
2324,仁寶,12,2,10,新百王,2023-11-03,6210
00632R,元大台灣50反1,10,0,10,新百王,2023-11-03,6210
2515,中工,40,30,10,新百王,2023-11-03,6210
1304,台聚,10,0,10,新百王,2023-11-03,6210
3231,緯創,50,40,10,新百王,2023-11-03,6210
2542,興富發,9,0,9,新百王,2023-11-03,6210
2392,正崴,9,0,9,新百王,2023-11-03,6210
9904,寶成,11,3,8,新百王,2023-11-03,6210
1324,地球,16,8,8,新百王,2023-11-03,6210
1321,大洋,8,0,8,新百王,2023-11-03,6210
1799,易威,18,10,8,新百王,2023-11-03,6210
00664R,國泰臺灣加權反1,185,0,185,新百王,2023-11-06,6210
6139,亞翔,471,338,133,新百王,2023-11-06,6210
00632R,元大台灣50反1,126,1,125,新百王,2023-11-06,6210
00891,中信關鍵半導體,106,0,106,新百王,2023-11-06,6210
00900,富邦特選高股息30,81,1,80,新百王,2023-11-06,6210
3390,旭軟,78,0,78,新百王,2023-11-06,6210
00772B,中信高評級公司債,59,0,59,新百王,2023-11-06,6210
00935,野村臺灣新科技50,53,2,51,新百王,2023-11-06,6210
00934,中信成長高股息,52,3,49,新百王,2023-11-06,6210
00687B,國泰20年美債,156,108,48,新百王,2023-11-06,6210
2891,中信金,51,6,45,新百王,2023-11-06,6210
6171,大城地產,43,0,43,新百王,2023-11-06,6210
2002,中鋼,43,10,33,新百王,2023-11-06,6210
00878,國泰永續高股息,35,5,30,新百王,2023-11-06,6210
2486,一詮,43,13,30,新百王,2023-11-06,6210
4433,興采,29,0,29,新百王,2023-11-06,6210
00648R,元大S＆P500反1,29,0,29,新百王,2023-11-06,6210
3041,揚智,27,0,27,新百王,2023-11-06,6210
5469,瀚宇博,29,2,27,新百王,2023-11-06,6210
2365,昆盈,26,0,26,新百王,2023-11-06,6210
2882,國泰金,21,0,21,新百王,2023-11-06,6210
00666R,富邦�琤肭磪齯�1,20,0,20,新百王,2023-11-06,6210
2888,新光金,20,0,20,新百王,2023-11-06,6210
00720B,元大投資級公司債,34,16,18,新百王,2023-11-06,6210
2027,大成鋼,35,17,18,新百王,2023-11-06,6210
2206,三陽工業,21,3,18,新百王,2023-11-06,6210
2405,輔信,31,14,17,新百王,2023-11-06,6210
2363,矽統,236,220,16,新百王,2023-11-06,6210
4543,萬在,22,6,16,新百王,2023-11-06,6210
2427,三商電,23,7,16,新百王,2023-11-06,6210
2302,麗正,15,0,15,新百王,2023-11-06,6210
4714,永捷,20,5,15,新百王,2023-11-06,6210
1504,東元,17,3,14,新百王,2023-11-06,6210
00795B,中信美國公債20年,13,0,13,新百王,2023-11-06,6210
4927,泰鼎-KY,13,0,13,新百王,2023-11-06,6210
2388,威盛,142,129,13,新百王,2023-11-06,6210
6216,居易,14,2,12,新百王,2023-11-06,6210
9940,信義,12,0,12,新百王,2023-11-06,6210
2867,三商壽,12,1,11,新百王,2023-11-06,6210
6223,旺矽,20,9,11,新百王,2023-11-06,6210
00864B,中信美國公債0-1,11,0,11,新百王,2023-11-06,6210
4113,聯上,11,0,11,新百王,2023-11-06,6210
00642U,期元大S＆P石油,11,0,11,新百王,2023-11-06,6210
00931B,統一美債20年,10,0,10,新百王,2023-11-06,6210
00688L,國泰20年美債正2,10,0,10,新百王,2023-11-06,6210
9924,福興,10,0,10,新百王,2023-11-06,6210
5519,隆大,10,1,9,新百王,2023-11-06,6210
6442,光聖,16,7,9,新百王,2023-11-06,6210
6285,啟��,94,85,9,新百王,2023-11-06,6210
1815,富喬,55,46,9,新百王,2023-11-06,6210
00715L,期街口布蘭特正2,191,0,191,新百王,2023-11-07,6210
00665L,富邦�琤肭磪囓�2,190,28,162,新百王,2023-11-07,6210
00632R,元大台灣50反1,150,0,150,新百王,2023-11-07,6210
2515,中工,428,351,77,新百王,2023-11-07,6210
2890,永豐金,151,91,60,新百王,2023-11-07,6210
8358,金居,53,1,52,新百王,2023-11-07,6210
9934,成霖,110,63,47,新百王,2023-11-07,6210
2002,中鋼,55,12,43,新百王,2023-11-07,6210
8940,新天地,41,0,41,新百王,2023-11-07,6210
2905,三商,40,0,40,新百王,2023-11-07,6210
2498,宏達電,46,6,40,新百王,2023-11-07,6210
3390,旭軟,36,0,36,新百王,2023-11-07,6210
1449,佳和,46,15,31,新百王,2023-11-07,6210
9907,統一實,31,0,31,新百王,2023-11-07,6210
00637L,元大滬深300正2,31,0,31,新百王,2023-11-07,6210
2413,環科,30,0,30,新百王,2023-11-07,6210
2359,所羅門,33,5,28,新百王,2023-11-07,6210
2615,萬海,38,11,27,新百王,2023-11-07,6210
3704,合勤控,45,18,27,新百王,2023-11-07,6210
00773B,中信優先金融債,27,0,27,新百王,2023-11-07,6210
2409,友達,29,4,25,新百王,2023-11-07,6210
9935,慶豐富,23,0,23,新百王,2023-11-07,6210
6237,驊訊,23,1,22,新百王,2023-11-07,6210
2618,長榮航,38,17,21,新百王,2023-11-07,6210
4915,致伸,23,2,21,新百王,2023-11-07,6210
2883,凱基金,20,0,20,新百王,2023-11-07,6210
1504,東元,20,0,20,新百王,2023-11-07,6210
1568,倉佑,25,5,20,新百王,2023-11-07,6210
1718,中纖,20,0,20,新百王,2023-11-07,6210
2453,凌群,37,17,20,新百王,2023-11-07,6210
1220,台榮,19,0,19,新百王,2023-11-07,6210
3322,建舜電,45,26,19,新百王,2023-11-07,6210
2371,大同,36,17,19,新百王,2023-11-07,6210
2317,鴻海,19,1,18,新百王,2023-11-07,6210
3567,逸昌,23,5,18,新百王,2023-11-07,6210
2701,萬企,18,0,18,新百王,2023-11-07,6210
00929,復華台灣科技優息,46,29,17,新百王,2023-11-07,6210
00864B,中信美國公債0-1,17,0,17,新百王,2023-11-07,6210
2369,菱生,18,3,15,新百王,2023-11-07,6210
6139,亞翔,148,134,14,新百王,2023-11-07,6210
2745,五福,14,0,14,新百王,2023-11-07,6210
00680L,元大美債20正2,13,0,13,新百王,2023-11-07,6210
6442,光聖,23,11,12,新百王,2023-11-07,6210
2634,漢翔,17,5,12,新百王,2023-11-07,6210
2486,一詮,16,4,12,新百王,2023-11-07,6210
2501,國建,12,0,12,新百王,2023-11-07,6210
00919,群益台灣精選高息,12,0,12,新百王,2023-11-07,6210
2607,榮運,12,0,12,新百王,2023-11-07,6210
3588,通嘉,11,0,11,新百王,2023-11-07,6210
2610,華航,46,35,11,新百王,2023-11-07,6210
00936,台新永續高息中小,354,56,298,新百王,2023-11-08,6210
2618,長榮航,508,291,217,新百王,2023-11-08,6210
00679B,元大美債20年,110,0,110,新百王,2023-11-08,6210
2363,矽統,184,104,80,新百王,2023-11-08,6210
2538,基泰,65,0,65,新百王,2023-11-08,6210
3622,洋華,80,16,64,新百王,2023-11-08,6210
00671R,富邦NASDAQ反1,60,0,60,新百王,2023-11-08,6210
2002,中鋼,67,11,56,新百王,2023-11-08,6210
1809,中釉,49,0,49,新百王,2023-11-08,6210
00632R,元大台灣50反1,40,0,40,新百王,2023-11-08,6210
8034,榮群,49,10,39,新百王,2023-11-08,6210
3231,緯創,240,203,37,新百王,2023-11-08,6210
3390,旭軟,36,0,36,新百王,2023-11-08,6210
6244,茂迪,35,0,35,新百王,2023-11-08,6210
4744,皇將,35,2,33,新百王,2023-11-08,6210
00715L,期街口布蘭特正2,32,0,32,新百王,2023-11-08,6210
2488,漢平,49,18,31,新百王,2023-11-08,6210
1314,中石化,30,0,30,新百王,2023-11-08,6210
2515,中工,141,111,30,新百王,2023-11-08,6210
2610,華航,48,21,27,新百王,2023-11-08,6210
2303,聯電,39,14,25,新百王,2023-11-08,6210
00857B,永豐20年美公債,22,0,22,新百王,2023-11-08,6210
4167,松瑞藥,31,11,20,新百王,2023-11-08,6210
00665L,富邦�琤肭磪囓�2,127,107,20,新百王,2023-11-08,6210
6189,豐藝,42,23,19,新百王,2023-11-08,6210
2492,華新科,21,2,19,新百王,2023-11-08,6210
2851,中再保,20,1,19,新百王,2023-11-08,6210
2316,楠梓電,18,0,18,新百王,2023-11-08,6210
6109,亞元,18,0,18,新百王,2023-11-08,6210
3682,亞太電,18,0,18,新百王,2023-11-08,6210
0050,元大台灣50,34,16,18,新百王,2023-11-08,6210
2883,凱基金,22,5,17,新百王,2023-11-08,6210
2388,威盛,91,75,16,新百王,2023-11-08,6210
2356,英業達,47,31,16,新百王,2023-11-08,6210
2349,錸德,14,0,14,新百王,2023-11-08,6210
4561,健椿,14,0,14,新百王,2023-11-08,6210
1504,東元,15,1,14,新百王,2023-11-08,6210
1799,易威,13,0,13,新百王,2023-11-08,6210
00878,國泰永續高股息,13,0,13,新百王,2023-11-08,6210
6243,迅杰,20,7,13,新百王,2023-11-08,6210
00753L,中信中國50正2,20,7,13,新百王,2023-11-08,6210
1514,亞力,13,0,13,新百王,2023-11-08,6210
5321,美而快,55,43,12,新百王,2023-11-08,6210
2401,凌陽,16,4,12,新百王,2023-11-08,6210
3176,基亞,12,0,12,新百王,2023-11-08,6210
00642U,期元大S＆P石油,11,0,11,新百王,2023-11-08,6210
6290,良維,17,6,11,新百王,2023-11-08,6210
6122,擎邦,28,17,11,新百王,2023-11-08,6210
2887,台新金,10,0,10,新百王,2023-11-08,6210
5519,隆大,11,2,9,新百王,2023-11-08,6210
00929,復華台灣科技優息,445,99,346,新百王,2023-11-09,6210
2891,中信金,150,0,150,新百王,2023-11-09,6210
2363,矽統,289,163,126,新百王,2023-11-09,6210
2905,三商,100,0,100,新百王,2023-11-09,6210
2515,中工,295,200,95,新百王,2023-11-09,6210
6558,興能高,67,6,61,新百王,2023-11-09,6210
00878,國泰永續高股息,66,11,55,新百王,2023-11-09,6210
00919,群益台灣精選高息,54,0,54,新百王,2023-11-09,6210
4744,皇將,59,9,50,新百王,2023-11-09,6210
2329,華泰,184,137,47,新百王,2023-11-09,6210
2365,昆盈,40,0,40,新百王,2023-11-09,6210
00715L,期街口布蘭特正2,33,0,33,新百王,2023-11-09,6210
2486,一詮,65,34,31,新百王,2023-11-09,6210
2439,美律,35,6,29,新百王,2023-11-09,6210
2412,中華電,29,2,27,新百王,2023-11-09,6210
6120,達運,42,16,26,新百王,2023-11-09,6210
4967,十銓,36,14,22,新百王,2023-11-09,6210
3481,群創,21,0,21,新百王,2023-11-09,6210
4714,永捷,21,0,21,新百王,2023-11-09,6210
00724B,群益投資級金融債,20,0,20,新百王,2023-11-09,6210
00676R,富邦臺灣加權反1,20,0,20,新百王,2023-11-09,6210
3376,新日興,48,29,19,新百王,2023-11-09,6210
5272,笙科,24,6,18,新百王,2023-11-09,6210
6138,茂達,24,6,18,新百王,2023-11-09,6210
2337,旺宏,20,3,17,新百王,2023-11-09,6210
2427,三商電,22,5,17,新百王,2023-11-09,6210
2609,陽明,57,40,17,新百王,2023-11-09,6210
6591,動力-KY,16,0,16,新百王,2023-11-09,6210
8940,新天地,16,0,16,新百王,2023-11-09,6210
1504,東元,16,0,16,新百王,2023-11-09,6210
2539,櫻花建,16,0,16,新百王,2023-11-09,6210
2608,嘉里大榮,15,0,15,新百王,2023-11-09,6210
1795,美時,18,4,14,新百王,2023-11-09,6210
6112,邁達特,14,0,14,新百王,2023-11-09,6210
6189,豐藝,14,0,14,新百王,2023-11-09,6210
2371,大同,26,12,14,新百王,2023-11-09,6210
6485,點序,29,16,13,新百王,2023-11-09,6210
2002,中鋼,24,11,13,新百王,2023-11-09,6210
1711,永光,13,0,13,新百王,2023-11-09,6210
6284,佳邦,64,51,13,新百王,2023-11-09,6210
3390,旭軟,12,0,12,新百王,2023-11-09,6210
3682,亞太電,12,0,12,新百王,2023-11-09,6210
5347,世界,12,0,12,新百王,2023-11-09,6210
00753L,中信中國50正2,14,3,11,新百王,2023-11-09,6210
3346,麗清,11,0,11,新百王,2023-11-09,6210
6285,啟��,21,10,11,新百王,2023-11-09,6210
3227,原相,42,31,11,新百王,2023-11-09,6210
2313,華通,73,63,10,新百王,2023-11-09,6210
2250,IKKA-KY,10,0,10,新百王,2023-11-09,6210
3707,漢磊,10,0,10,新百王,2023-11-09,6210
00637L,元大滬深300正2,57,0,57,新百王,2023-11-10,6210
3588,通嘉,60,10,50,新百王,2023-11-10,6210
00665L,富邦�琤肭磪囓�2,151,106,45,新百王,2023-11-10,6210
2891,中信金,75,30,45,新百王,2023-11-10,6210
00688L,國泰20年美債正2,41,0,41,新百王,2023-11-10,6210
00712,復華富時不動產,39,0,39,新百王,2023-11-10,6210
00919,群益台灣精選高息,73,34,39,新百王,2023-11-10,6210
0056,元大高股息,36,0,36,新百王,2023-11-10,6210
6120,達運,36,0,36,新百王,2023-11-10,6210
3322,建舜電,52,17,35,新百王,2023-11-10,6210
2442,新美齊,34,0,34,新百王,2023-11-10,6210
8940,新天地,34,0,34,新百王,2023-11-10,6210
00680L,元大美債20正2,31,0,31,新百王,2023-11-10,6210
1440,南紡,28,0,28,新百王,2023-11-10,6210
2701,萬企,26,0,26,新百王,2023-11-10,6210
00878,國泰永續高股息,30,4,26,新百王,2023-11-10,6210
1524,耿鼎,33,8,25,新百王,2023-11-10,6210
4128,中天,70,48,22,新百王,2023-11-10,6210
1785,光洋科,21,0,21,新百王,2023-11-10,6210
2365,昆盈,21,0,21,新百王,2023-11-10,6210
6122,擎邦,48,27,21,新百王,2023-11-10,6210
4743,合一,89,69,20,新百王,2023-11-10,6210
2352,佳世達,24,4,20,新百王,2023-11-10,6210
00706L,期元大S＆P日圓正2,20,0,20,新百王,2023-11-10,6210
2006,東和鋼鐵,20,0,20,新百王,2023-11-10,6210
2332,友訊,20,0,20,新百王,2023-11-10,6210
2615,萬海,19,0,19,新百王,2023-11-10,6210
00933B,國泰10Y+金融債,22,4,18,新百王,2023-11-10,6210
00679B,元大美債20年,16,0,16,新百王,2023-11-10,6210
2007,燁興,16,0,16,新百王,2023-11-10,6210
2412,中華電,15,0,15,新百王,2023-11-10,6210
3231,緯創,126,110,16,新百王,2023-11-10,6210
2305,全友,16,1,15,新百王,2023-11-10,6210
2359,所羅門,15,0,15,新百王,2023-11-10,6210
1718,中纖,15,0,15,新百王,2023-11-10,6210
6111,大宇資,40,25,15,新百王,2023-11-10,6210
1909,榮成,15,0,15,新百王,2023-11-10,6210
2206,三陽工業,16,1,15,新百王,2023-11-10,6210
9914,美利達,15,0,15,新百王,2023-11-10,6210
2313,華通,164,149,15,新百王,2023-11-10,6210
8034,榮群,81,67,14,新百王,2023-11-10,6210
2106,建大,12,0,12,新百王,2023-11-10,6210
2201,裕隆,53,41,12,新百王,2023-11-10,6210
5871,中租-KY,11,0,11,新百王,2023-11-10,6210
8150,南茂,12,1,11,新百王,2023-11-10,6210
6243,迅杰,11,0,11,新百王,2023-11-10,6210
00936,台新永續高息中小,26,15,11,新百王,2023-11-10,6210
2387,精元,19,8,11,新百王,2023-11-10,6210
0050,元大台灣50,12,2,10,新百王,2023-11-10,6210
00671R,富邦NASDAQ反1,10,0,10,新百王,2023-11-10,6210
3390,旭軟,198,17,181,新百王,2023-11-13,6210
2851,中再保,140,9,131,新百王,2023-11-13,6210
00632R,元大台灣50反1,110,0,110,新百王,2023-11-13,6210
2852,第一保,100,0,100,新百王,2023-11-13,6210
2515,中工,135,40,95,新百王,2023-11-13,6210
00915,凱基優選高股息30,71,0,71,新百王,2023-11-13,6210
00665L,富邦�琤肭磪囓�2,125,60,65,新百王,2023-11-13,6210
1515,力山,68,7,61,新百王,2023-11-13,6210
2412,中華電,37,2,35,新百王,2023-11-13,6210
00878,國泰永續高股息,36,2,34,新百王,2023-11-13,6210
00680L,元大美債20正2,32,0,32,新百王,2023-11-13,6210
2382,廣達,89,58,31,新百王,2023-11-13,6210
00706L,期元大S＆P日圓正2,30,0,30,新百王,2023-11-13,6210
8936,國統,49,21,28,新百王,2023-11-13,6210
2377,微星,29,5,24,新百王,2023-11-13,6210
2409,友達,23,0,23,新百王,2023-11-13,6210
3702,大聯大,23,0,23,新百王,2023-11-13,6210
3557,嘉威,22,0,22,新百王,2023-11-13,6210
6547,高端疫苗,24,4,20,新百王,2023-11-13,6210
00891,中信關鍵半導體,30,10,20,新百王,2023-11-13,6210
6290,良維,37,20,17,新百王,2023-11-13,6210
8163,達方,22,6,16,新百王,2023-11-13,6210
00772B,中信高評級公司債,16,0,16,新百王,2023-11-13,6210
3078,僑威,18,3,15,新百王,2023-11-13,6210
4129,聯合,27,12,15,新百王,2023-11-13,6210
4714,永捷,14,0,14,新百王,2023-11-13,6210
1314,中石化,14,0,14,新百王,2023-11-13,6210
2063,世鎧,14,0,14,新百王,2023-11-13,6210
6189,豐藝,16,2,14,新百王,2023-11-13,6210
00764B,群益25年美債,14,0,14,新百王,2023-11-13,6210
9942,茂順,15,1,14,新百王,2023-11-13,6210
2353,宏��,21,8,13,新百王,2023-11-13,6210
2538,基泰,12,0,12,新百王,2023-11-13,6210
2882,國泰金,20,8,12,新百王,2023-11-13,6210
00633L,富邦上証正2,14,3,11,新百王,2023-11-13,6210
3036,文曄,29,19,10,新百王,2023-11-13,6210
00637L,元大滬深300正2,35,25,10,新百王,2023-11-13,6210
2539,櫻花建,10,0,10,新百王,2023-11-13,6210
0052,富邦科技,10,0,10,新百王,2023-11-13,6210
8176,智捷,10,0,10,新百王,2023-11-13,6210
5498,凱崴,10,0,10,新百王,2023-11-13,6210
1909,榮成,9,0,9,新百王,2023-11-13,6210
2884,玉山金,10,1,9,新百王,2023-11-13,6210
2103,台橡,8,0,8,新百王,2023-11-13,6210
2486,一詮,14,6,8,新百王,2023-11-13,6210
1802,台玻,18,10,8,新百王,2023-11-13,6210
1449,佳和,8,0,8,新百王,2023-11-13,6210
2442,新美齊,8,0,8,新百王,2023-11-13,6210
00671R,富邦NASDAQ反1,10,2,8,新百王,2023-11-13,6210
2618,長榮航,30,23,7,新百王,2023-11-13,6210
2206,三陽工業,71,1,70,新百王,2023-11-14,6210
00665L,富邦�琤肭磪囓�2,144,75,69,新百王,2023-11-14,6210
6116,彩晶,106,50,56,新百王,2023-11-14,6210
2849,安泰銀,50,0,50,新百王,2023-11-14,6210
1528,恩德,45,3,42,新百王,2023-11-14,6210
2313,華通,113,76,37,新百王,2023-11-14,6210
3147,大綜,32,2,30,新百王,2023-11-14,6210
00706L,期元大S＆P日圓正2,30,0,30,新百王,2023-11-14,6210
2204,中華,29,0,29,新百王,2023-11-14,6210
2002,中鋼,36,8,28,新百王,2023-11-14,6210
5512,力麒,25,0,25,新百王,2023-11-14,6210
00753L,中信中國50正2,27,2,25,新百王,2023-11-14,6210
3682,亞太電,21,0,21,新百王,2023-11-14,6210
2365,昆盈,20,0,20,新百王,2023-11-14,6210
2462,良得電,21,2,19,新百王,2023-11-14,6210
6108,競國,18,0,18,新百王,2023-11-14,6210
8446,華研,18,0,18,新百王,2023-11-14,6210
3078,僑威,34,17,17,新百王,2023-11-14,6210
00687B,國泰20年美債,18,1,17,新百王,2023-11-14,6210
2884,玉山金,16,0,16,新百王,2023-11-14,6210
2027,大成鋼,15,0,15,新百王,2023-11-14,6210
00900,富邦特選高股息30,15,1,14,新百王,2023-11-14,6210
5009,榮剛,13,0,13,新百王,2023-11-14,6210
2427,三商電,13,1,12,新百王,2023-11-14,6210
4912,聯德控股-KY,12,0,12,新百王,2023-11-14,6210
3715,定穎投控,13,1,12,新百王,2023-11-14,6210
00637L,元大滬深300正2,36,25,11,新百王,2023-11-14,6210
3689,湧德,28,17,11,新百王,2023-11-14,6210
00934,中信成長高股息,11,0,11,新百王,2023-11-14,6210
8088,品安,16,5,11,新百王,2023-11-14,6210
6127,九豪,11,0,11,新百王,2023-11-14,6210
3276,宇環,23,13,10,新百王,2023-11-14,6210
2358,廷鑫,10,0,10,新百王,2023-11-14,6210
2401,凌陽,11,1,10,新百王,2023-11-14,6210
1806,冠軍,10,0,10,新百王,2023-11-14,6210
2606,裕民,36,26,10,新百王,2023-11-14,6210
1108,幸福,10,0,10,新百王,2023-11-14,6210
6244,茂迪,10,0,10,新百王,2023-11-14,6210
3372,典範,13,3,10,新百王,2023-11-14,6210
2515,中工,50,41,9,新百王,2023-11-14,6210
2402,毅嘉,36,27,9,新百王,2023-11-14,6210
4744,皇將,10,1,9,新百王,2023-11-14,6210
1802,台玻,24,15,9,新百王,2023-11-14,6210
6122,擎邦,133,124,9,新百王,2023-11-14,6210
6171,大城地產,8,0,8,新百王,2023-11-14,6210
2913,農林,8,0,8,新百王,2023-11-14,6210
3530,晶相光,10,2,8,新百王,2023-11-14,6210
5386,青雲,9,2,7,新百王,2023-11-14,6210
1612,宏泰,7,0,7,新百王,2023-11-14,6210
3231,緯創,52,45,7,新百王,2023-11-14,6210
00632R,元大台灣50反1,396,77,319,新百王,2023-11-15,6210
00679B,元大美債20年,163,2,161,新百王,2023-11-15,6210
2906,高林,95,1,94,新百王,2023-11-15,6210
2607,榮運,63,12,51,新百王,2023-11-15,6210
3312,弘憶股,43,1,42,新百王,2023-11-15,6210
4720,德淵,36,0,36,新百王,2023-11-15,6210
00900,富邦特選高股息30,50,18,32,新百王,2023-11-15,6210
2353,宏��,33,2,31,新百王,2023-11-15,6210
2439,美律,30,0,30,新百王,2023-11-15,6210
00878,國泰永續高股息,41,15,26,新百王,2023-11-15,6210
2516,新建,25,0,25,新百王,2023-11-15,6210
6284,佳邦,121,96,25,新百王,2023-11-15,6210
00929,復華台灣科技優息,124,100,24,新百王,2023-11-15,6210
6122,擎邦,84,60,24,新百王,2023-11-15,6210
2884,玉山金,22,0,22,新百王,2023-11-15,6210
5314,世紀,21,0,21,新百王,2023-11-15,6210
4714,永捷,22,1,21,新百王,2023-11-15,6210
2867,三商壽,20,1,19,新百王,2023-11-15,6210
2609,陽明,25,6,19,新百王,2023-11-15,6210
2204,中華,25,6,19,新百王,2023-11-15,6210
3017,奇鋐,31,14,17,新百王,2023-11-15,6210
2462,良得電,61,45,16,新百王,2023-11-15,6210
2520,冠德,14,0,14,新百王,2023-11-15,6210
5386,青雲,26,12,14,新百王,2023-11-15,6210
2357,華碩,17,4,13,新百王,2023-11-15,6210
5258,虹堡,43,30,13,新百王,2023-11-15,6210
6274,台燿,28,15,13,新百王,2023-11-15,6210
4707,磐亞,12,0,12,新百王,2023-11-15,6210
3036,文曄,30,18,12,新百王,2023-11-15,6210
8110,華東,11,0,11,新百王,2023-11-15,6210
2442,新美齊,29,18,11,新百王,2023-11-15,6210
2371,大同,16,6,10,新百王,2023-11-15,6210
4533,協易機,10,0,10,新百王,2023-11-15,6210
3708,上緯投控,10,0,10,新百王,2023-11-15,6210
3689,湧德,14,4,10,新百王,2023-11-15,6210
6112,邁達特,10,0,10,新百王,2023-11-15,6210
2882,國泰金,21,11,10,新百王,2023-11-15,6210
6188,廣明,17,7,10,新百王,2023-11-15,6210
8176,智捷,10,0,10,新百王,2023-11-15,6210
1609,大亞,20,11,9,新百王,2023-11-15,6210
3450,聯鈞,14,5,9,新百王,2023-11-15,6210
2608,嘉里大榮,10,1,9,新百王,2023-11-15,6210
00637L,元大滬深300正2,71,62,9,新百王,2023-11-15,6210
6117,迎廣,50,41,9,新百王,2023-11-15,6210
3025,星通,37,29,8,新百王,2023-11-15,6210
00715L,期街口布蘭特正2,11,3,8,新百王,2023-11-15,6210
6136,富爾特,8,0,8,新百王,2023-11-15,6210
9927,泰銘,18,10,8,新百王,2023-11-15,6210
6187,萬潤,22,14,8,新百王,2023-11-15,6210
1102,亞泥,7,0,7,新百王,2023-11-15,6210
00632R,元大台灣50反1,321,60,261,新百王,2023-11-16,6210
2618,長榮航,535,298,237,新百王,2023-11-16,6210
00929,復華台灣科技優息,126,16,110,新百王,2023-11-16,6210
2887,台新金,102,0,102,新百王,2023-11-16,6210
2852,第一保,100,0,100,新百王,2023-11-16,6210
2313,華通,79,15,64,新百王,2023-11-16,6210
00680L,元大美債20正2,51,0,51,新百王,2023-11-16,6210
2515,中工,157,107,50,新百王,2023-11-16,6210
00665L,富邦�琤肭磪囓�2,246,198,48,新百王,2023-11-16,6210
3312,弘憶股,48,2,46,新百王,2023-11-16,6210
2344,華邦電,51,10,41,新百王,2023-11-16,6210
3362,先進光,42,7,35,新百王,2023-11-16,6210
3276,宇環,36,5,31,新百王,2023-11-16,6210
00715L,期街口布蘭特正2,35,6,29,新百王,2023-11-16,6210
6243,迅杰,33,4,29,新百王,2023-11-16,6210
00720B,元大投資級公司債,26,0,26,新百王,2023-11-16,6210
1220,台榮,25,0,25,新百王,2023-11-16,6210
2392,正崴,25,0,25,新百王,2023-11-16,6210
6112,邁達特,25,1,24,新百王,2023-11-16,6210
8940,新天地,29,5,24,新百王,2023-11-16,6210
1721,三晃,23,0,23,新百王,2023-11-16,6210
2851,中再保,23,1,22,新百王,2023-11-16,6210
2367,燿華,24,3,21,新百王,2023-11-16,6210
3036,文曄,36,14,22,新百王,2023-11-16,6210
2412,中華電,25,4,21,新百王,2023-11-16,6210
3402,漢科,35,14,21,新百王,2023-11-16,6210
4915,致伸,21,0,21,新百王,2023-11-16,6210
3356,奇偶,20,0,20,新百王,2023-11-16,6210
1309,台達化,20,1,19,新百王,2023-11-16,6210
2329,華泰,323,306,17,新百王,2023-11-16,6210
1524,耿鼎,47,31,16,新百王,2023-11-16,6210
00687B,國泰20年美債,16,0,16,新百王,2023-11-16,6210
4532,瑞智,15,0,15,新百王,2023-11-16,6210
5706,鳳凰,29,15,14,新百王,2023-11-16,6210
1339,昭輝,22,8,14,新百王,2023-11-16,6210
2607,榮運,14,0,14,新百王,2023-11-16,6210
2891,中信金,30,16,14,新百王,2023-11-16,6210
3264,欣銓,14,1,13,新百王,2023-11-16,6210
2387,精元,14,2,12,新百王,2023-11-16,6210
2731,雄獅,14,2,12,新百王,2023-11-16,6210
2351,順德,13,1,12,新百王,2023-11-16,6210
2204,中華,19,7,12,新百王,2023-11-16,6210
4906,正文,12,0,12,新百王,2023-11-16,6210
00637L,元大滬深300正2,25,14,11,新百王,2023-11-16,6210
3147,大綜,52,41,11,新百王,2023-11-16,6210
6290,良維,11,0,11,新百王,2023-11-16,6210
00882,中信中國高股息,11,0,11,新百王,2023-11-16,6210
00930,永豐ESG低碳高息,10,0,10,新百王,2023-11-16,6210
00706L,期元大S＆P日圓正2,10,0,10,新百王,2023-11-16,6210
6457,紘康,10,0,10,新百王,2023-11-16,6210
00929,復華台灣科技優息,268,10,258,新百王,2023-11-17,6210
1609,大亞,221,0,221,新百王,2023-11-17,6210
00637L,元大滬深300正2,182,20,162,新百王,2023-11-17,6210
00665L,富邦�琤肭磪囓�2,227,70,157,新百王,2023-11-17,6210
00632R,元大台灣50反1,142,10,132,新百王,2023-11-17,6210
00687B,國泰20年美債,109,0,109,新百王,2023-11-17,6210
3390,旭軟,60,0,60,新百王,2023-11-17,6210
2374,佳能,60,2,58,新百王,2023-11-17,6210
1506,正道,50,0,50,新百王,2023-11-17,6210
6284,佳邦,100,54,46,新百王,2023-11-17,6210
2412,中華電,41,1,40,新百王,2023-11-17,6210
00864B,中信美國公債0-1,40,0,40,新百王,2023-11-17,6210
00753L,中信中國50正2,49,11,38,新百王,2023-11-17,6210
5533,皇鼎,38,0,38,新百王,2023-11-17,6210
3312,弘憶股,36,0,36,新百王,2023-11-17,6210
2516,新建,36,0,36,新百王,2023-11-17,6210
2891,中信金,33,2,31,新百王,2023-11-17,6210
00642U,期元大S＆P石油,30,0,30,新百王,2023-11-17,6210
2838,聯邦銀,30,0,30,新百王,2023-11-17,6210
2063,世鎧,30,0,30,新百王,2023-11-17,6210
6443,元晶,30,0,30,新百王,2023-11-17,6210
2402,毅嘉,53,24,29,新百王,2023-11-17,6210
00679B,元大美債20年,28,0,28,新百王,2023-11-17,6210
2851,中再保,51,23,28,新百王,2023-11-17,6210
00878,國泰永續高股息,30,5,25,新百王,2023-11-17,6210
4714,永捷,25,0,25,新百王,2023-11-17,6210
2367,燿華,40,17,23,新百王,2023-11-17,6210
00712,復華富時不動產,57,34,23,新百王,2023-11-17,6210
2329,華泰,232,210,22,新百王,2023-11-17,6210
3702,大聯大,31,10,21,新百王,2023-11-17,6210
3217,優群,22,2,20,新百王,2023-11-17,6210
2501,國建,20,0,20,新百王,2023-11-17,6210
6112,邁達特,20,0,20,新百王,2023-11-17,6210
1515,力山,94,74,20,新百王,2023-11-17,6210
2609,陽明,55,36,19,新百王,2023-11-17,6210
1423,利華,18,0,18,新百王,2023-11-17,6210
2442,新美齊,47,29,18,新百王,2023-11-17,6210
2358,廷鑫,18,0,18,新百王,2023-11-17,6210
2705,六福,31,15,16,新百王,2023-11-17,6210
2344,華邦電,35,19,16,新百王,2023-11-17,6210
2204,中華,31,15,16,新百王,2023-11-17,6210
6158,禾昌,25,12,13,新百王,2023-11-17,6210
2369,菱生,30,17,13,新百王,2023-11-17,6210
2610,華航,17,5,12,新百王,2023-11-17,6210
6585,鼎基,21,9,12,新百王,2023-11-17,6210
1504,東元,25,13,12,新百王,2023-11-17,6210
3260,威剛,35,23,12,新百王,2023-11-17,6210
2409,友達,18,6,12,新百王,2023-11-17,6210
2356,英業達,23,12,11,新百王,2023-11-17,6210
6285,啟��,21,10,11,新百王,2023-11-17,6210
2618,長榮航,1688,1286,402,新百王,2023-11-20,6210
00632R,元大台灣50反1,205,10,195,新百王,2023-11-20,6210
5905,南仁湖,66,3,63,新百王,2023-11-20,6210
8111,立��,60,0,60,新百王,2023-11-20,6210
2363,矽統,158,116,42,新百王,2023-11-20,6210
2462,良得電,83,41,42,新百王,2023-11-20,6210
8034,榮群,57,15,42,新百王,2023-11-20,6210
2409,友達,35,1,34,新百王,2023-11-20,6210
00687B,國泰20年美債,35,3,32,新百王,2023-11-20,6210
2851,中再保,30,1,29,新百王,2023-11-20,6210
2547,日勝生,28,0,28,新百王,2023-11-20,6210
6418,詠昇,35,8,27,新百王,2023-11-20,6210
2393,億光,26,0,26,新百王,2023-11-20,6210
6807,峰源-KY,24,0,24,新百王,2023-11-20,6210
3712,永崴投控,24,0,24,新百王,2023-11-20,6210
4550,長佳,24,0,24,新百王,2023-11-20,6210
2002,中鋼,23,0,23,新百王,2023-11-20,6210
3682,亞太電,21,0,21,新百王,2023-11-20,6210
2888,新光金,21,0,21,新百王,2023-11-20,6210
6235,華孚,27,6,21,新百王,2023-11-20,6210
00706L,期元大S＆P日圓正2,26,5,21,新百王,2023-11-20,6210
00878,國泰永續高股息,20,0,20,新百王,2023-11-20,6210
9946,三發地產,20,0,20,新百王,2023-11-20,6210
6233,旺玖,35,17,18,新百王,2023-11-20,6210
1101,台泥,20,2,18,新百王,2023-11-20,6210
2739,寒舍,17,0,17,新百王,2023-11-20,6210
00712,復華富時不動產,22,5,17,新百王,2023-11-20,6210
2609,陽明,17,1,16,新百王,2023-11-20,6210
2405,輔信,30,14,16,新百王,2023-11-20,6210
6125,廣運,56,40,16,新百王,2023-11-20,6210
6284,佳邦,132,116,16,新百王,2023-11-20,6210
2439,美律,15,0,15,新百王,2023-11-20,6210
1702,南僑,15,0,15,新百王,2023-11-20,6210
2614,東森,15,0,15,新百王,2023-11-20,6210
4306,炎洲,15,0,15,新百王,2023-11-20,6210
9904,寶成,17,2,15,新百王,2023-11-20,6210
4912,聯德控股-KY,20,5,15,新百王,2023-11-20,6210
2401,凌陽,60,45,15,新百王,2023-11-20,6210
2344,華邦電,14,0,14,新百王,2023-11-20,6210
6197,佳必琪,17,4,13,新百王,2023-11-20,6210
3312,弘憶股,13,0,13,新百王,2023-11-20,6210
2890,永豐金,215,202,13,新百王,2023-11-20,6210
1709,和益,12,0,12,新百王,2023-11-20,6210
2472,立隆電,11,0,11,新百王,2023-11-20,6210
2497,怡利電,12,1,11,新百王,2023-11-20,6210
2351,順德,11,0,11,新百王,2023-11-20,6210
3094,聯傑,13,2,11,新百王,2023-11-20,6210
6163,華電網,11,0,11,新百王,2023-11-20,6210
6139,亞翔,58,47,11,新百王,2023-11-20,6210
00664R,國泰臺灣加權反1,10,0,10,新百王,2023-11-20,6210
2618,長榮航,1154,913,241,新百王,2023-11-21,6210
00632R,元大台灣50反1,258,40,218,新百王,2023-11-21,6210
2367,燿華,217,52,165,新百王,2023-11-21,6210
00687B,國泰20年美債,60,0,60,新百王,2023-11-21,6210
00683L,期元大美元指正2,55,0,55,新百王,2023-11-21,6210
2369,菱生,74,27,47,新百王,2023-11-21,6210
2852,第一保,46,0,46,新百王,2023-11-21,6210
1310,台苯,46,0,46,新百王,2023-11-21,6210
1432,大魯閣,44,0,44,新百王,2023-11-21,6210
5351,鈺創,112,69,43,新百王,2023-11-21,6210
5512,力麒,40,1,39,新百王,2023-11-21,6210
6282,康舒,63,25,38,新百王,2023-11-21,6210
00712,復華富時不動產,38,0,38,新百王,2023-11-21,6210
00673R,期元大S＆P原油反1,30,0,30,新百王,2023-11-21,6210
2883,凱基金,34,4,30,新百王,2023-11-21,6210
1217,愛之味,30,0,30,新百王,2023-11-21,6210
2355,敬鵬,98,71,27,新百王,2023-11-21,6210
5465,富驊,30,3,27,新百王,2023-11-21,6210
8940,新天地,26,0,26,新百王,2023-11-21,6210
6158,禾昌,34,8,26,新百王,2023-11-21,6210
2634,漢翔,27,1,26,新百王,2023-11-21,6210
8054,安國,74,49,25,新百王,2023-11-21,6210
6290,良維,36,13,23,新百王,2023-11-21,6210
2885,元大金,41,20,21,新百王,2023-11-21,6210
2358,廷鑫,20,0,20,新百王,2023-11-21,6210
00671R,富邦NASDAQ反1,20,0,20,新百王,2023-11-21,6210
00676R,富邦臺灣加權反1,20,0,20,新百王,2023-11-21,6210
1337,再生-KY,20,0,20,新百王,2023-11-21,6210
6284,佳邦,102,85,17,新百王,2023-11-21,6210
2313,華通,145,129,16,新百王,2023-11-21,6210
00679B,元大美債20年,66,50,16,新百王,2023-11-21,6210
2436,偉詮電,18,2,16,新百王,2023-11-21,6210
8234,新漢,15,0,15,新百王,2023-11-21,6210
00936,台新永續高息中小,14,0,14,新百王,2023-11-21,6210
1524,耿鼎,45,31,14,新百王,2023-11-21,6210
3041,揚智,93,79,14,新百王,2023-11-21,6210
3363,上詮,36,22,14,新百王,2023-11-21,6210
6799,來頡,34,21,13,新百王,2023-11-21,6210
00751B,元大AAA至A公司債,13,0,13,新百王,2023-11-21,6210
00724B,群益投資級金融債,15,3,12,新百王,2023-11-21,6210
2020,美亞,12,0,12,新百王,2023-11-21,6210
4729,熒茂,13,1,12,新百王,2023-11-21,6210
2888,新光金,11,0,11,新百王,2023-11-21,6210
2486,一詮,12,1,11,新百王,2023-11-21,6210
00664R,國泰臺灣加權反1,11,0,11,新百王,2023-11-21,6210
2383,台光電,11,0,11,新百王,2023-11-21,6210
3481,群創,11,0,11,新百王,2023-11-21,6210
6442,光聖,37,26,11,新百王,2023-11-21,6210
3703,欣陸,10,0,10,新百王,2023-11-21,6210
4174,浩鼎,10,0,10,新百王,2023-11-21,6210
1432,大魯閣,145,1,144,新百王,2023-11-22,6210
00919,群益台灣精選高息,137,3,134,新百王,2023-11-22,6210
00637L,元大滬深300正2,149,20,129,新百王,2023-11-22,6210
2382,廣達,154,31,123,新百王,2023-11-22,6210
2204,中華,109,0,109,新百王,2023-11-22,6210
2603,長榮,81,1,80,新百王,2023-11-22,6210
3706,神達,77,7,70,新百王,2023-11-22,6210
1313,聯成,60,0,60,新百王,2023-11-22,6210
2506,太設,55,0,55,新百王,2023-11-22,6210
3231,緯創,96,46,50,新百王,2023-11-22,6210
00795B,中信美國公債20年,44,0,44,新百王,2023-11-22,6210
2023,燁輝,62,18,44,新百王,2023-11-22,6210
2356,英業達,66,23,43,新百王,2023-11-22,6210
2883,凱基金,47,6,41,新百王,2023-11-22,6210
5351,鈺創,95,57,38,新百王,2023-11-22,6210
6108,競國,50,13,37,新百王,2023-11-22,6210
3712,永崴投控,36,1,35,新百王,2023-11-22,6210
00665L,富邦�琤肭磪囓�2,62,30,32,新百王,2023-11-22,6210
2849,安泰銀,30,0,30,新百王,2023-11-22,6210
6695,芯鼎,30,3,27,新百王,2023-11-22,6210
2301,光寶科,42,16,26,新百王,2023-11-22,6210
00929,復華台灣科技優息,101,75,26,新百王,2023-11-22,6210
4744,皇將,29,4,25,新百王,2023-11-22,6210
0056,元大高股息,25,0,25,新百王,2023-11-22,6210
3390,旭軟,24,0,24,新百王,2023-11-22,6210
3025,星通,46,23,23,新百王,2023-11-22,6210
5272,笙科,25,3,22,新百王,2023-11-22,6210
2851,中再保,22,0,22,新百王,2023-11-22,6210
2401,凌陽,45,23,22,新百王,2023-11-22,6210
00680L,元大美債20正2,26,5,21,新百王,2023-11-22,6210
2462,良得電,58,37,21,新百王,2023-11-22,6210
2701,萬企,60,41,19,新百王,2023-11-22,6210
00878,國泰永續高股息,36,18,18,新百王,2023-11-22,6210
5258,虹堡,86,69,17,新百王,2023-11-22,6210
2409,友達,20,4,16,新百王,2023-11-22,6210
4533,協易機,16,0,16,新百王,2023-11-22,6210
6148,驊宏資,19,3,16,新百王,2023-11-22,6210
2353,宏��,38,23,15,新百王,2023-11-22,6210
2897,王道銀行,15,0,15,新百王,2023-11-22,6210
4979,華星光,34,22,12,新百王,2023-11-22,6210
6191,精成科,14,2,12,新百王,2023-11-22,6210
6243,迅杰,32,20,12,新百王,2023-11-22,6210
5225,東科-KY,13,2,11,新百王,2023-11-22,6210
6197,佳必琪,28,17,11,新百王,2023-11-22,6210
00650L,復華香港正2,10,0,10,新百王,2023-11-22,6210
2890,永豐金,102,92,10,新百王,2023-11-22,6210
6411,晶焱,16,6,10,新百王,2023-11-22,6210
2020,美亞,10,0,10,新百王,2023-11-22,6210
4113,聯上,10,0,10,新百王,2023-11-22,6210
00676R,富邦臺灣加權反1,10,0,10,新百王,2023-11-22,6210
3122,笙泉,199,85,114,新百王,2023-11-23,6210
2867,三商壽,104,0,104,新百王,2023-11-23,6210
00919,群益台灣精選高息,69,0,69,新百王,2023-11-23,6210
1434,福懋,69,0,69,新百王,2023-11-23,6210
3041,揚智,78,18,60,新百王,2023-11-23,6210
2208,台船,58,0,58,新百王,2023-11-23,6210
1802,台玻,135,82,53,新百王,2023-11-23,6210
00665L,富邦�琤肭磪囓�2,125,73,52,新百王,2023-11-23,6210
1513,中興電,58,6,52,新百王,2023-11-23,6210
00637L,元大滬深300正2,71,20,51,新百王,2023-11-23,6210
2743,山富,61,11,50,新百王,2023-11-23,6210
3015,全漢,50,0,50,新百王,2023-11-23,6210
3437,榮創,60,11,49,新百王,2023-11-23,6210
4726,永昕,41,0,41,新百王,2023-11-23,6210
5009,榮剛,46,6,40,新百王,2023-11-23,6210
5533,皇鼎,35,0,35,新百王,2023-11-23,6210
8936,國統,36,3,33,新百王,2023-11-23,6210
3481,群創,32,1,31,新百王,2023-11-23,6210
2506,太設,30,0,30,新百王,2023-11-23,6210
3312,弘憶股,30,1,29,新百王,2023-11-23,6210
00712,復華富時不動產,30,2,28,新百王,2023-11-23,6210
2851,中再保,37,9,28,新百王,2023-11-23,6210
4714,永捷,22,0,22,新百王,2023-11-23,6210
4720,德淵,20,0,20,新百王,2023-11-23,6210
6203,海韻電,20,0,20,新百王,2023-11-23,6210
1711,永光,20,0,20,新百王,2023-11-23,6210
1506,正道,20,0,20,新百王,2023-11-23,6210
6187,萬潤,24,5,19,新百王,2023-11-23,6210
6213,聯茂,18,0,18,新百王,2023-11-23,6210
8054,安國,124,107,17,新百王,2023-11-23,6210
3557,嘉威,17,0,17,新百王,2023-11-23,6210
00933B,國泰10Y+金融債,15,0,15,新百王,2023-11-23,6210
2363,矽統,169,154,15,新百王,2023-11-23,6210
00753L,中信中國50正2,18,3,15,新百王,2023-11-23,6210
9105,泰金寶-DR,15,0,15,新百王,2023-11-23,6210
5351,鈺創,61,46,15,新百王,2023-11-23,6210
3169,亞信,16,1,15,新百王,2023-11-23,6210
4108,懷特,14,0,14,新百王,2023-11-23,6210
6117,迎廣,40,26,14,新百王,2023-11-23,6210
3231,緯創,27,14,13,新百王,2023-11-23,6210
2520,冠德,24,12,12,新百王,2023-11-23,6210
3715,定穎投控,78,66,12,新百王,2023-11-23,6210
2476,鉅祥,30,18,12,新百王,2023-11-23,6210
2405,輔信,46,34,12,新百王,2023-11-23,6210
5521,工信,33,21,12,新百王,2023-11-23,6210
3078,僑威,56,45,11,新百王,2023-11-23,6210
2495,普安,21,10,11,新百王,2023-11-23,6210
6274,台燿,23,12,11,新百王,2023-11-23,6210
6237,驊訊,179,168,11,新百王,2023-11-23,6210
00715L,期街口布蘭特正2,10,0,10,新百王,2023-11-23,6210
2515,中工,224,50,174,新百王,2023-11-24,6210
6237,驊訊,136,17,119,新百王,2023-11-24,6210
9919,康那香,115,0,115,新百王,2023-11-24,6210
00632R,元大台灣50反1,290,200,90,新百王,2023-11-24,6210
2444,兆勁,77,0,77,新百王,2023-11-24,6210
00795B,中信美國公債20年,66,0,66,新百王,2023-11-24,6210
2610,華航,92,40,52,新百王,2023-11-24,6210
6116,彩晶,50,0,50,新百王,2023-11-24,6210
2313,華通,146,100,46,新百王,2023-11-24,6210
2506,太設,45,0,45,新百王,2023-11-24,6210
5347,世界,111,71,40,新百王,2023-11-24,6210
1721,三晃,50,10,40,新百王,2023-11-24,6210
2002,中鋼,242,206,36,新百王,2023-11-24,6210
1608,華榮,30,0,30,新百王,2023-11-24,6210
3706,神達,45,16,29,新百王,2023-11-24,6210
6235,華孚,38,9,29,新百王,2023-11-24,6210
00680L,元大美債20正2,28,0,28,新百王,2023-11-24,6210
00637L,元大滬深300正2,99,73,26,新百王,2023-11-24,6210
2492,華新科,48,22,26,新百王,2023-11-24,6210
00891,中信關鍵半導體,30,5,25,新百王,2023-11-24,6210
00715L,期街口布蘭特正2,34,10,24,新百王,2023-11-24,6210
2408,南亞科,26,3,23,新百王,2023-11-24,6210
00864B,中信美國公債0-1,23,0,23,新百王,2023-11-24,6210
5512,力麒,20,0,20,新百王,2023-11-24,6210
2390,云辰,20,0,20,新百王,2023-11-24,6210
00936,台新永續高息中小,20,0,20,新百王,2023-11-24,6210
1307,三芳,20,0,20,新百王,2023-11-24,6210
2371,大同,32,13,19,新百王,2023-11-24,6210
2317,鴻海,19,2,17,新百王,2023-11-24,6210
2637,慧洋-KY,19,2,17,新百王,2023-11-24,6210
00919,群益台灣精選高息,17,0,17,新百王,2023-11-24,6210
2355,敬鵬,21,4,17,新百王,2023-11-24,6210
00933B,國泰10Y+金融債,26,10,16,新百王,2023-11-24,6210
6104,創惟,31,16,15,新百王,2023-11-24,6210
00706L,期元大S＆P日圓正2,15,0,15,新百王,2023-11-24,6210
2534,宏盛,15,0,15,新百王,2023-11-24,6210
2356,英業達,20,6,14,新百王,2023-11-24,6210
6835,圓裕,12,0,12,新百王,2023-11-24,6210
3078,僑威,25,13,12,新百王,2023-11-24,6210
5521,工信,43,31,12,新百王,2023-11-24,6210
6282,康舒,32,21,11,新百王,2023-11-24,6210
00930,永豐ESG低碳高息,11,0,11,新百王,2023-11-24,6210
00688L,國泰20年美債正2,11,0,11,新百王,2023-11-24,6210
00885,富邦越南,13,2,11,新百王,2023-11-24,6210
00878,國泰永續高股息,11,1,10,新百王,2023-11-24,6210
2891,中信金,10,0,10,新百王,2023-11-24,6210
1810,和成,21,11,10,新百王,2023-11-24,6210
4533,協易機,16,6,10,新百王,2023-11-24,6210
00671R,富邦NASDAQ反1,10,0,10,新百王,2023-11-24,6210
1709,和益,10,0,10,新百王,2023-11-24,6210
00929,復華台灣科技優息,199,75,124,新百王,2023-11-27,6210
2701,萬企,74,0,74,新百王,2023-11-27,6210
5347,世界,92,19,73,新百王,2023-11-27,6210
00665L,富邦�琤肭磪囓�2,122,50,72,新百王,2023-11-27,6210
1609,大亞,113,52,61,新百王,2023-11-27,6210
00936,台新永續高息中小,61,0,61,新百王,2023-11-27,6210
00919,群益台灣精選高息,57,6,51,新百王,2023-11-27,6210
2883,凱基金,78,30,48,新百王,2023-11-27,6210
2812,台中銀,76,30,46,新百王,2023-11-27,6210
2382,廣達,59,15,44,新百王,2023-11-27,6210
00680L,元大美債20正2,49,6,43,新百王,2023-11-27,6210
6127,九豪,74,35,39,新百王,2023-11-27,6210
2618,長榮航,55,24,31,新百王,2023-11-27,6210
3540,曜越,30,0,30,新百王,2023-11-27,6210
8086,宏捷科,56,28,28,新百王,2023-11-27,6210
2851,中再保,32,6,26,新百王,2023-11-27,6210
2809,京城銀,32,6,26,新百王,2023-11-27,6210
2355,敬鵬,30,5,25,新百王,2023-11-27,6210
3260,威剛,26,2,24,新百王,2023-11-27,6210
8111,立��,23,0,23,新百王,2023-11-27,6210
6284,佳邦,134,112,22,新百王,2023-11-27,6210
8088,品安,21,0,21,新百王,2023-11-27,6210
2884,玉山金,21,0,21,新百王,2023-11-27,6210
2344,華邦電,23,2,21,新百王,2023-11-27,6210
00900,富邦特選高股息30,20,0,20,新百王,2023-11-27,6210
2352,佳世達,37,17,20,新百王,2023-11-27,6210
2457,飛宏,65,45,20,新百王,2023-11-27,6210
3437,榮創,72,53,19,新百王,2023-11-27,6210
8011,台通,18,0,18,新百王,2023-11-27,6210
4167,松瑞藥,22,4,18,新百王,2023-11-27,6210
2634,漢翔,34,17,17,新百王,2023-11-27,6210
3531,先益,16,0,16,新百王,2023-11-27,6210
00688L,國泰20年美債正2,21,5,16,新百王,2023-11-27,6210
3205,佰研,18,2,16,新百王,2023-11-27,6210
2201,裕隆,15,0,15,新百王,2023-11-27,6210
1503,士電,25,10,15,新百王,2023-11-27,6210
2330,台積電,18,3,15,新百王,2023-11-27,6210
006208,富邦台50,14,0,14,新百王,2023-11-27,6210
00637L,元大滬深300正2,104,90,14,新百王,2023-11-27,6210
5009,榮剛,15,1,14,新百王,2023-11-27,6210
3041,揚智,20,6,14,新百王,2023-11-27,6210
1720,生達,16,2,14,新百王,2023-11-27,6210
2405,輔信,107,93,14,新百王,2023-11-27,6210
3705,永信,22,8,14,新百王,2023-11-27,6210
1584,精剛,15,2,13,新百王,2023-11-27,6210
2882,國泰金,13,0,13,新百王,2023-11-27,6210
6213,聯茂,14,1,13,新百王,2023-11-27,6210
8358,金居,13,0,13,新百王,2023-11-27,6210
2520,冠德,16,4,12,新百王,2023-11-27,6210
4102,永日,12,0,12,新百王,2023-11-27,6210
00687B,國泰20年美債,109,0,109,新百王,2023-11-28,6210
2606,裕民,149,62,87,新百王,2023-11-28,6210
00665L,富邦�琤肭磪囓�2,87,0,87,新百王,2023-11-28,6210
3704,合勤控,71,3,68,新百王,2023-11-28,6210
00632R,元大台灣50反1,550,490,60,新百王,2023-11-28,6210
00929,復華台灣科技優息,146,89,57,新百王,2023-11-28,6210
6147,頎邦,62,6,56,新百王,2023-11-28,6210
2412,中華電,56,4,52,新百王,2023-11-28,6210
9919,康那香,63,15,48,新百王,2023-11-28,6210
00891,中信關鍵半導體,50,3,47,新百王,2023-11-28,6210
5351,鈺創,148,101,47,新百王,2023-11-28,6210
5347,世界,48,2,46,新百王,2023-11-28,6210
3483,力致,45,2,43,新百王,2023-11-28,6210
2618,長榮航,59,26,33,新百王,2023-11-28,6210
4919,新唐,43,11,32,新百王,2023-11-28,6210
2897,王道銀行,30,0,30,新百王,2023-11-28,6210
00637L,元大滬深300正2,26,0,26,新百王,2023-11-28,6210
5876,上海商銀,26,0,26,新百王,2023-11-28,6210
00676R,富邦臺灣加權反1,25,0,25,新百王,2023-11-28,6210
00919,群益台灣精選高息,24,0,24,新百王,2023-11-28,6210
2401,凌陽,40,16,24,新百王,2023-11-28,6210
2352,佳世達,23,0,23,新百王,2023-11-28,6210
1701,中化,54,31,23,新百王,2023-11-28,6210
8289,泰藝,22,0,22,新百王,2023-11-28,6210
2888,新光金,21,0,21,新百王,2023-11-28,6210
00934,中信成長高股息,21,0,21,新百王,2023-11-28,6210
6122,擎邦,20,0,20,新百王,2023-11-28,6210
00643,群益深証中小,20,0,20,新百王,2023-11-28,6210
2444,兆勁,20,0,20,新百王,2023-11-28,6210
4707,磐亞,20,1,19,新百王,2023-11-28,6210
2303,聯電,24,5,19,新百王,2023-11-28,6210
2356,英業達,26,9,17,新百王,2023-11-28,6210
2745,五福,15,0,15,新百王,2023-11-28,6210
00639,富邦深100,15,0,15,新百王,2023-11-28,6210
2605,新興,59,44,15,新百王,2023-11-28,6210
4167,松瑞藥,34,20,14,新百王,2023-11-28,6210
4744,皇將,16,3,13,新百王,2023-11-28,6210
2812,台中銀,57,45,12,新百王,2023-11-28,6210
00650L,復華香港正2,15,3,12,新百王,2023-11-28,6210
1713,國化,25,13,12,新百王,2023-11-28,6210
9103,美德醫療-DR,12,0,12,新百王,2023-11-28,6210
3231,緯創,21,10,11,新百王,2023-11-28,6210
3374,精材,11,0,11,新百王,2023-11-28,6210
3081,聯亞,12,1,11,新百王,2023-11-28,6210
4128,中天,11,0,11,新百王,2023-11-28,6210
00720B,元大投資級公司債,12,1,11,新百王,2023-11-28,6210
3346,麗清,10,0,10,新百王,2023-11-28,6210
00664R,國泰臺灣加權反1,10,0,10,新百王,2023-11-28,6210
00655L,國泰中國A50正2,10,0,10,新百王,2023-11-28,6210
2399,映泰,25,15,10,新百王,2023-11-28,6210
00665L,富邦�琤肭磪囓�2,280,1,279,新百王,2023-11-29,6210
00632R,元大台灣50反1,610,390,220,新百王,2023-11-29,6210
3481,群創,189,0,189,新百王,2023-11-29,6210
2515,中工,272,153,119,新百王,2023-11-29,6210
00929,復華台灣科技優息,320,213,107,新百王,2023-11-29,6210
2603,長榮,88,2,86,新百王,2023-11-29,6210
2618,長榮航,80,10,70,新百王,2023-11-29,6210
2883,凱基金,99,30,69,新百王,2023-11-29,6210
8936,國統,73,5,68,新百王,2023-11-29,6210
00683L,期元大美元指正2,55,0,55,新百王,2023-11-29,6210
2444,兆勁,51,0,51,新百王,2023-11-29,6210
2615,萬海,50,2,48,新百王,2023-11-29,6210
00919,群益台灣精選高息,90,44,46,新百王,2023-11-29,6210
00934,中信成長高股息,41,0,41,新百王,2023-11-29,6210
00680L,元大美債20正2,65,24,41,新百王,2023-11-29,6210
8028,昇陽半導體,44,5,39,新百王,2023-11-29,6210
2375,凱美,41,4,37,新百王,2023-11-29,6210
00637L,元大滬深300正2,113,81,32,新百王,2023-11-29,6210
1609,大亞,112,82,30,新百王,2023-11-29,6210
2485,兆赫,40,10,30,新百王,2023-11-29,6210
2462,良得電,31,1,30,新百王,2023-11-29,6210
2610,華航,70,40,30,新百王,2023-11-29,6210
00650L,復華香港正2,30,0,30,新百王,2023-11-29,6210
00673R,期元大S＆P原油反1,28,0,28,新百王,2023-11-29,6210
3704,合勤控,50,24,26,新百王,2023-11-29,6210
8110,華東,26,0,26,新百王,2023-11-29,6210
00864B,中信美國公債0-1,25,0,25,新百王,2023-11-29,6210
00639,富邦深100,24,0,24,新百王,2023-11-29,6210
00882,中信中國高股息,20,0,20,新百王,2023-11-29,6210
2897,王道銀行,20,0,20,新百王,2023-11-29,6210
6244,茂迪,20,0,20,新百王,2023-11-29,6210
4442,竣邦-KY,20,0,20,新百王,2023-11-29,6210
3078,僑威,21,2,19,新百王,2023-11-29,6210
5439,高技,24,6,18,新百王,2023-11-29,6210
5876,上海商銀,44,26,18,新百王,2023-11-29,6210
5351,鈺創,219,202,17,新百王,2023-11-29,6210
2344,華邦電,33,17,16,新百王,2023-11-29,6210
00706L,期元大S＆P日圓正2,15,0,15,新百王,2023-11-29,6210
3545,敦泰,26,12,14,新百王,2023-11-29,6210
2409,友達,14,0,14,新百王,2023-11-29,6210
2891,中信金,13,0,13,新百王,2023-11-29,6210
4744,皇將,19,6,13,新百王,2023-11-29,6210
5381,合正,36,24,12,新百王,2023-11-29,6210
5512,力麒,15,3,12,新百王,2023-11-29,6210
1457,宜進,12,0,12,新百王,2023-11-29,6210
5534,長虹,12,0,12,新百王,2023-11-29,6210
5302,太欣,11,0,11,新百王,2023-11-29,6210
2369,菱生,66,55,11,新百王,2023-11-29,6210
1504,東元,12,1,11,新百王,2023-11-29,6210
6821,聯寶,10,0,10,新百王,2023-11-29,6210
2890,永豐金,740,53,687,新百王,2023-11-30,6210
1316,上曜,114,1,113,新百王,2023-11-30,6210
2885,元大金,112,0,112,新百王,2023-11-30,6210
00687B,國泰20年美債,86,1,85,新百王,2023-11-30,6210
00919,群益台灣精選高息,88,9,79,新百王,2023-11-30,6210
3682,亞太電,64,0,64,新百王,2023-11-30,6210
4714,永捷,92,38,54,新百王,2023-11-30,6210
2332,友訊,54,0,54,新百王,2023-11-30,6210
2313,華通,149,102,47,新百王,2023-11-30,6210
5876,上海商銀,100,59,41,新百王,2023-11-30,6210
4113,聯上,35,0,35,新百王,2023-11-30,6210
2317,鴻海,44,10,34,新百王,2023-11-30,6210
2412,中華電,33,0,33,新百王,2023-11-30,6210
00933B,國泰10Y+金融債,32,0,32,新百王,2023-11-30,6210
5309,系統電,71,40,31,新百王,2023-11-30,6210
6284,佳邦,97,67,30,新百王,2023-11-30,6210
2883B,凱基金乙特,30,0,30,新百王,2023-11-30,6210
6558,興能高,30,0,30,新百王,2023-11-30,6210
3122,笙泉,54,25,29,新百王,2023-11-30,6210
2492,華新科,36,9,27,新百王,2023-11-30,6210
3228,金麗科,26,0,26,新百王,2023-11-30,6210
00934,中信成長高股息,53,27,26,新百王,2023-11-30,6210
1432,大魯閣,26,0,26,新百王,2023-11-30,6210
00680L,元大美債20正2,103,78,25,新百王,2023-11-30,6210
4968,立積,33,8,25,新百王,2023-11-30,6210
2338,光罩,24,1,23,新百王,2023-11-30,6210
8936,國統,21,0,21,新百王,2023-11-30,6210
2337,旺宏,21,0,21,新百王,2023-11-30,6210
6451,訊芯-KY,28,8,20,新百王,2023-11-30,6210
2002,中鋼,21,1,20,新百王,2023-11-30,6210
6111,大宇資,47,28,19,新百王,2023-11-30,6210
6187,萬潤,26,7,19,新百王,2023-11-30,6210
2465,麗臺,25,6,19,新百王,2023-11-30,6210
00712,復華富時不動產,30,14,16,新百王,2023-11-30,6210
0056,元大高股息,22,6,16,新百王,2023-11-30,6210
00751B,元大AAA至A公司債,19,3,16,新百王,2023-11-30,6210
2329,華泰,226,210,16,新百王,2023-11-30,6210
6695,芯鼎,23,8,15,新百王,2023-11-30,6210
3059,華晶科,27,12,15,新百王,2023-11-30,6210
2427,三商電,15,0,15,新百王,2023-11-30,6210
8059,凱碩,15,0,15,新百王,2023-11-30,6210
00679B,元大美債20年,64,50,14,新百王,2023-11-30,6210
2609,陽明,46,32,14,新百王,2023-11-30,6210
6282,康舒,58,45,13,新百王,2023-11-30,6210
3317,尼克森,24,11,13,新百王,2023-11-30,6210
6274,台燿,24,11,13,新百王,2023-11-30,6210
2344,華邦電,47,34,13,新百王,2023-11-30,6210
8436,大江,12,0,12,新百王,2023-11-30,6210
3576,聯合再生,12,0,12,新百王,2023-11-30,6210
6139,亞翔,14,2,12,新百王,2023-11-30,6210
2890,永豐金,702,20,682,新百王,2023-12-01,6210
00680L,元大美債20正2,438,100,338,新百王,2023-12-01,6210
2506,太設,100,0,100,新百王,2023-12-01,6210
00919,群益台灣精選高息,101,6,95,新百王,2023-12-01,6210
5210,寶碩,79,1,78,新百王,2023-12-01,6210
00637L,元大滬深300正2,107,38,69,新百王,2023-12-01,6210
2606,裕民,276,207,69,新百王,2023-12-01,6210
2332,友訊,68,0,68,新百王,2023-12-01,6210
1608,華榮,70,5,65,新百王,2023-12-01,6210
2313,華通,155,91,64,新百王,2023-12-01,6210
6116,彩晶,63,0,63,新百王,2023-12-01,6210
00665L,富邦�琤肭磪囓�2,85,30,55,新百王,2023-12-01,6210
00929,復華台灣科技優息,83,29,54,新百王,2023-12-01,6210
2317,鴻海,55,2,53,新百王,2023-12-01,6210
2444,兆勁,60,9,51,新百王,2023-12-01,6210
2852,第一保,48,0,48,新百王,2023-12-01,6210
8096,擎亞,57,11,46,新百王,2023-12-01,6210
2543,皇昌,47,3,44,新百王,2023-12-01,6210
2885,元大金,43,0,43,新百王,2023-12-01,6210
1506,正道,40,0,40,新百王,2023-12-01,6210
3704,合勤控,64,26,38,新百王,2023-12-01,6210
00715L,期街口布蘭特正2,37,1,36,新百王,2023-12-01,6210
6271,同欣電,36,4,32,新百王,2023-12-01,6210
6625,必應,35,3,32,新百王,2023-12-01,6210
6799,來頡,46,15,31,新百王,2023-12-01,6210
2887,台新金,31,0,31,新百王,2023-12-01,6210
2312,金寶,30,0,30,新百王,2023-12-01,6210
9919,康那香,56,30,26,新百王,2023-12-01,6210
5009,榮剛,25,1,24,新百王,2023-12-01,6210
1514,亞力,48,24,24,新百王,2023-12-01,6210
6733,博晟生醫,25,2,23,新百王,2023-12-01,6210
3682,亞太電,21,0,21,新百王,2023-12-01,6210
2367,燿華,42,21,21,新百王,2023-12-01,6210
6578,達邦蛋白,20,0,20,新百王,2023-12-01,6210
00882,中信中國高股息,20,0,20,新百王,2023-12-01,6210
2330,台積電,26,8,18,新百王,2023-12-01,6210
8936,國統,24,6,18,新百王,2023-12-01,6210
1504,東元,18,0,18,新百王,2023-12-01,6210
4114,健喬,37,20,17,新百王,2023-12-01,6210
8110,華東,18,1,17,新百王,2023-12-01,6210
6108,競國,21,5,16,新百王,2023-12-01,6210
1457,宜進,15,0,15,新百王,2023-12-01,6210
00934,中信成長高股息,17,2,15,新百王,2023-12-01,6210
1432,大魯閣,14,0,14,新百王,2023-12-01,6210
3481,群創,17,4,13,新百王,2023-12-01,6210
6180,橘子,15,3,12,新百王,2023-12-01,6210
2888,新光金,21,10,11,新百王,2023-12-01,6210
00878,國泰永續高股息,11,0,11,新百王,2023-12-01,6210
9921,巨大,11,0,11,新百王,2023-12-01,6210
2527,宏璟,11,0,11,新百王,2023-12-01,6210
00706L,期元大S＆P日圓正2,311,114,197,新百王,2023-12-04,6210
00919,群益台灣精選高息,206,12,194,新百王,2023-12-04,6210
00715L,期街口布蘭特正2,244,94,150,新百王,2023-12-04,6210
2885,元大金,130,0,130,新百王,2023-12-04,6210
00751B,元大AAA至A公司債,70,4,66,新百王,2023-12-04,6210
3682,亞太電,64,0,64,新百王,2023-12-04,6210
00637L,元大滬深300正2,64,0,64,新百王,2023-12-04,6210
6245,立端,65,1,64,新百王,2023-12-04,6210
00665L,富邦�琤肭磪囓�2,60,0,60,新百王,2023-12-04,6210
00632R,元大台灣50反1,330,290,40,新百王,2023-12-04,6210
2457,飛宏,41,2,39,新百王,2023-12-04,6210
1101,台泥,37,0,37,新百王,2023-12-04,6210
1504,東元,36,0,36,新百王,2023-12-04,6210
3013,晟銘電,210,176,34,新百王,2023-12-04,6210
4561,健椿,44,12,32,新百王,2023-12-04,6210
8936,國統,46,16,30,新百王,2023-12-04,6210
8358,金居,30,0,30,新百王,2023-12-04,6210
2363,矽統,57,29,28,新百王,2023-12-04,6210
6535,順藥,27,0,27,新百王,2023-12-04,6210
3715,定穎投控,59,32,27,新百王,2023-12-04,6210
6799,來頡,35,9,26,新百王,2023-12-04,6210
1609,大亞,79,53,26,新百王,2023-12-04,6210
00679B,元大美債20年,26,0,26,新百王,2023-12-04,6210
1605,華新,52,26,26,新百王,2023-12-04,6210
3231,緯創,56,30,26,新百王,2023-12-04,6210
6451,訊芯-KY,27,3,24,新百王,2023-12-04,6210
3234,光環,25,2,23,新百王,2023-12-04,6210
00655L,國泰中國A50正2,20,0,20,新百王,2023-12-04,6210
2849,安泰銀,20,0,20,新百王,2023-12-04,6210
5871,中租-KY,20,0,20,新百王,2023-12-04,6210
2002,中鋼,58,39,19,新百王,2023-12-04,6210
4142,國光生,20,1,19,新百王,2023-12-04,6210
8054,安國,27,9,18,新百王,2023-12-04,6210
2243,宏旭-KY,18,1,17,新百王,2023-12-04,6210
2208,台船,30,13,17,新百王,2023-12-04,6210
2367,燿華,105,89,16,新百王,2023-12-04,6210
8183,精星,25,9,16,新百王,2023-12-04,6210
2506,太設,15,0,15,新百王,2023-12-04,6210
2515,中工,95,81,14,新百王,2023-12-04,6210
00895,富邦未來車,14,0,14,新百王,2023-12-04,6210
4108,懷特,13,0,13,新百王,2023-12-04,6210
2354,鴻準,13,0,13,新百王,2023-12-04,6210
1815,富喬,13,0,13,新百王,2023-12-04,6210
4744,皇將,15,2,13,新百王,2023-12-04,6210
2405,輔信,18,5,13,新百王,2023-12-04,6210
3078,僑威,12,0,12,新百王,2023-12-04,6210
2105,正新,14,2,12,新百王,2023-12-04,6210
1582,信錦,23,11,12,新百王,2023-12-04,6210
1795,美時,36,25,11,新百王,2023-12-04,6210
6244,茂迪,11,0,11,新百王,2023-12-04,6210
2611,志信,401,0,401,新百王,2023-12-05,6210
00937B,群益ESG投等債20,379,249,130,新百王,2023-12-05,6210
1314,中石化,76,0,76,新百王,2023-12-05,6210
00712,復華富時不動產,81,7,74,新百王,2023-12-05,6210
3481,群創,165,95,70,新百王,2023-12-05,6210
2408,南亞科,69,0,69,新百王,2023-12-05,6210
00650L,復華香港正2,56,0,56,新百王,2023-12-05,6210
2363,矽統,106,56,50,新百王,2023-12-05,6210
00637L,元大滬深300正2,84,43,41,新百王,2023-12-05,6210
5515,建國,40,0,40,新百王,2023-12-05,6210
00715L,期街口布蘭特正2,49,13,36,新百王,2023-12-05,6210
2606,裕民,211,177,34,新百王,2023-12-05,6210
5469,瀚宇博,43,12,31,新百王,2023-12-05,6210
2390,云辰,31,0,31,新百王,2023-12-05,6210
1734,杏輝,30,0,30,新百王,2023-12-05,6210
2618,長榮航,71,43,28,新百王,2023-12-05,6210
4167,松瑞藥,75,47,28,新百王,2023-12-05,6210
8940,新天地,26,0,26,新百王,2023-12-05,6210
1605,華新,36,11,25,新百王,2023-12-05,6210
3051,力特,34,10,24,新百王,2023-12-05,6210
9958,世紀鋼,35,13,22,新百王,2023-12-05,6210
5351,鈺創,33,12,21,新百王,2023-12-05,6210
8358,金居,21,0,21,新百王,2023-12-05,6210
5608,四維航,98,78,20,新百王,2023-12-05,6210
00688L,國泰20年美債正2,20,0,20,新百王,2023-12-05,6210
3004,豐達科,20,0,20,新百王,2023-12-05,6210
2883B,凱基金乙特,20,0,20,新百王,2023-12-05,6210
6916,華凌,22,2,20,新百王,2023-12-05,6210
2634,漢翔,20,1,19,新百王,2023-12-05,6210
0056,元大高股息,17,0,17,新百王,2023-12-05,6210
2849,安泰銀,16,0,16,新百王,2023-12-05,6210
3706,神達,16,1,15,新百王,2023-12-05,6210
2312,金寶,15,0,15,新百王,2023-12-05,6210
020033,統一�琤肮黕篾,15,0,15,新百王,2023-12-05,6210
3557,嘉威,25,10,15,新百王,2023-12-05,6210
6182,合晶,14,0,14,新百王,2023-12-05,6210
2891,中信金,15,1,14,新百王,2023-12-05,6210
1504,東元,33,20,13,新百王,2023-12-05,6210
8110,華東,13,0,13,新百王,2023-12-05,6210
6124,業強,13,0,13,新百王,2023-12-05,6210
3260,威剛,24,11,13,新百王,2023-12-05,6210
6806,森崴能源,20,8,12,新百王,2023-12-05,6210
1785,光洋科,16,5,11,新百王,2023-12-05,6210
00680L,元大美債20正2,121,110,11,新百王,2023-12-05,6210
2352,佳世達,11,0,11,新百王,2023-12-05,6210
2460,建通,11,1,10,新百王,2023-12-05,6210
4113,聯上,10,0,10,新百王,2023-12-05,6210
6112,邁達特,22,12,10,新百王,2023-12-05,6210
2929,淘帝-KY,10,0,10,新百王,2023-12-05,6210
00753L,中信中國50正2,26,16,10,新百王,2023-12-05,6210
2890,永豐金,985,0,985,新百王,2023-12-06,6210
2885,元大金,406,1,405,新百王,2023-12-06,6210
00937B,群益ESG投等債20,376,163,213,新百王,2023-12-06,6210
3041,揚智,280,94,186,新百王,2023-12-06,6210
00929,復華台灣科技優息,186,1,185,新百王,2023-12-06,6210
00632R,元大台灣50反1,331,200,131,新百王,2023-12-06,6210
00919,群益台灣精選高息,135,14,121,新百王,2023-12-06,6210
00679B,元大美債20年,131,23,108,新百王,2023-12-06,6210
2317,鴻海,97,0,97,新百王,2023-12-06,6210
2851,中再保,116,23,93,新百王,2023-12-06,6210
2459,敦吉,80,0,80,新百王,2023-12-06,6210
00637L,元大滬深300正2,95,17,78,新百王,2023-12-06,6210
2610,華航,76,0,76,新百王,2023-12-06,6210
3390,旭軟,92,31,61,新百王,2023-12-06,6210
2324,仁寶,73,15,58,新百王,2023-12-06,6210
00922,國泰台灣領袖50,44,0,44,新百王,2023-12-06,6210
2409,友達,43,0,43,新百王,2023-12-06,6210
2419,仲琦,71,34,37,新百王,2023-12-06,6210
2849,安泰銀,35,0,35,新百王,2023-12-06,6210
2303,聯電,35,2,33,新百王,2023-12-06,6210
6438,迅得,30,1,29,新百王,2023-12-06,6210
00687B,國泰20年美債,29,0,29,新百王,2023-12-06,6210
1524,耿鼎,29,1,28,新百王,2023-12-06,6210
2358,廷鑫,25,0,25,新百王,2023-12-06,6210
3515,華擎,25,2,23,新百王,2023-12-06,6210
00918,大華優利高填息30,32,10,22,新百王,2023-12-06,6210
2867,三商壽,25,3,22,新百王,2023-12-06,6210
2352,佳世達,21,0,21,新百王,2023-12-06,6210
3711,日月光投控,36,16,20,新百王,2023-12-06,6210
1608,華榮,20,0,20,新百王,2023-12-06,6210
2612,中航,225,205,20,新百王,2023-12-06,6210
5347,世界,29,9,20,新百王,2023-12-06,6210
6284,佳邦,45,26,19,新百王,2023-12-06,6210
2367,燿華,25,6,19,新百王,2023-12-06,6210
5351,鈺創,61,43,18,新百王,2023-12-06,6210
3615,安可,18,0,18,新百王,2023-12-06,6210
5426,振發,44,26,18,新百王,2023-12-06,6210
2344,華邦電,22,4,18,新百王,2023-12-06,6210
2891,中信金,37,20,17,新百王,2023-12-06,6210
4167,松瑞藥,65,48,17,新百王,2023-12-06,6210
1319,東陽,47,31,16,新百王,2023-12-06,6210
2482,連宇,16,0,16,新百王,2023-12-06,6210
2371,大同,16,0,16,新百王,2023-12-06,6210
4953,緯軟,45,30,15,新百王,2023-12-06,6210
2313,華通,121,106,15,新百王,2023-12-06,6210
4442,竣邦-KY,15,0,15,新百王,2023-12-06,6210
2457,飛宏,36,21,15,新百王,2023-12-06,6210
8940,新天地,14,0,14,新百王,2023-12-06,6210
1515,力山,39,26,13,新百王,2023-12-06,6210
3022,威強電,13,0,13,新百王,2023-12-06,6210
2101,南港,260,0,260,新百王,2023-12-07,6210
3481,群創,741,499,242,新百王,2023-12-07,6210
00706L,期元大S＆P日圓正2,200,20,180,新百王,2023-12-07,6210
2314,台揚,180,7,173,新百王,2023-12-07,6210
00688L,國泰20年美債正2,145,1,144,新百王,2023-12-07,6210
00712,復華富時不動產,124,0,124,新百王,2023-12-07,6210
8936,國統,125,7,118,新百王,2023-12-07,6210
00937B,群益ESG投等債20,167,59,108,新百王,2023-12-07,6210
00680L,元大美債20正2,191,86,105,新百王,2023-12-07,6210
2515,中工,170,70,100,新百王,2023-12-07,6210
2849,安泰銀,85,0,85,新百王,2023-12-07,6210
1434,福懋,71,0,71,新百王,2023-12-07,6210
1506,正道,70,0,70,新百王,2023-12-07,6210
00665L,富邦�琤肭磪囓�2,74,10,64,新百王,2023-12-07,6210
5244,弘凱,65,2,63,新百王,2023-12-07,6210
00933B,國泰10Y+金融債,57,1,56,新百王,2023-12-07,6210
2606,裕民,98,43,55,新百王,2023-12-07,6210
00637L,元大滬深300正2,358,307,51,新百王,2023-12-07,6210
1608,華榮,53,3,50,新百王,2023-12-07,6210
4726,永昕,50,0,50,新百王,2023-12-07,6210
00919,群益台灣精選高息,71,23,48,新百王,2023-12-07,6210
1611,中電,71,24,47,新百王,2023-12-07,6210
1618,合機,92,47,45,新百王,2023-12-07,6210
1605,華新,63,19,44,新百王,2023-12-07,6210
4967,十銓,62,22,40,新百王,2023-12-07,6210
2492,華新科,40,1,39,新百王,2023-12-07,6210
4906,正文,44,6,38,新百王,2023-12-07,6210
2330,台積電,62,25,37,新百王,2023-12-07,6210
00642U,期元大S＆P石油,33,0,33,新百王,2023-12-07,6210
2324,仁寶,33,1,32,新百王,2023-12-07,6210
2890,永豐金,31,1,30,新百王,2023-12-07,6210
00720B,元大投資級公司債,26,2,24,新百王,2023-12-07,6210
2399,映泰,39,15,24,新百王,2023-12-07,6210
3213,茂訊,28,5,23,新百王,2023-12-07,6210
2851,中再保,71,49,22,新百王,2023-12-07,6210
3014,聯陽,21,1,20,新百王,2023-12-07,6210
6005,群益證,20,0,20,新百王,2023-12-07,6210
1324,地球,23,3,20,新百王,2023-12-07,6210
9935,慶豐富,18,0,18,新百王,2023-12-07,6210
6108,競國,18,0,18,新百王,2023-12-07,6210
2367,燿華,132,114,18,新百王,2023-12-07,6210
00891,中信關鍵半導體,20,2,18,新百王,2023-12-07,6210
0056,元大高股息,17,0,17,新百王,2023-12-07,6210
2313,華通,176,160,16,新百王,2023-12-07,6210
2412,中華電,19,3,16,新百王,2023-12-07,6210
2358,廷鑫,16,0,16,新百王,2023-12-07,6210
00715L,期街口布蘭特正2,91,76,15,新百王,2023-12-07,6210
8089,康全電訊,15,0,15,新百王,2023-12-07,6210
2891,中信金,15,0,15,新百王,2023-12-07,6210
2303,聯電,16,1,15,新百王,2023-12-07,6210
00687B,國泰20年美債,512,115,397,新百王,2023-12-08,6210
2867,三商壽,230,24,206,新百王,2023-12-08,6210
00632R,元大台灣50反1,490,290,200,新百王,2023-12-08,6210
6222,上揚,111,0,111,新百王,2023-12-08,6210
2509,全坤建,109,0,109,新百王,2023-12-08,6210
3390,旭軟,112,32,80,新百王,2023-12-08,6210
1718,中纖,75,0,75,新百王,2023-12-08,6210
00937B,群益ESG投等債20,172,98,74,新百王,2023-12-08,6210
00722B,群益投資級電信債,69,0,69,新百王,2023-12-08,6210
6143,振曜,58,2,56,新百王,2023-12-08,6210
1506,正道,50,0,50,新百王,2023-12-08,6210
5009,榮剛,50,1,49,新百王,2023-12-08,6210
5351,鈺創,126,78,48,新百王,2023-12-08,6210
6116,彩晶,47,0,47,新百王,2023-12-08,6210
2376,技嘉,79,32,47,新百王,2023-12-08,6210
00933B,國泰10Y+金融債,43,0,43,新百王,2023-12-08,6210
4543,萬在,48,7,41,新百王,2023-12-08,6210
2363,矽統,93,57,36,新百王,2023-12-08,6210
5292,華懋,31,2,29,新百王,2023-12-08,6210
00919,群益台灣精選高息,39,11,28,新百王,2023-12-08,6210
4906,正文,36,11,25,新百王,2023-12-08,6210
00637L,元大滬深300正2,36,12,24,新百王,2023-12-08,6210
6243,迅杰,41,19,22,新百王,2023-12-08,6210
3147,大綜,35,14,21,新百王,2023-12-08,6210
1609,大亞,40,19,21,新百王,2023-12-08,6210
8112,至上,108,87,21,新百王,2023-12-08,6210
00680L,元大美債20正2,31,11,20,新百王,2023-12-08,6210
3059,華晶科,20,0,20,新百王,2023-12-08,6210
3372,典範,21,1,20,新百王,2023-12-08,6210
9105,泰金寶-DR,21,2,19,新百王,2023-12-08,6210
5244,弘凱,18,0,18,新百王,2023-12-08,6210
2413,環科,29,11,18,新百王,2023-12-08,6210
6284,佳邦,53,36,17,新百王,2023-12-08,6210
2852,第一保,22,6,16,新百王,2023-12-08,6210
2368,金像電,30,14,16,新百王,2023-12-08,6210
2409,友達,16,0,16,新百王,2023-12-08,6210
2412,中華電,18,3,15,新百王,2023-12-08,6210
4746,台耀,27,12,15,新百王,2023-12-08,6210
3540,曜越,15,1,14,新百王,2023-12-08,6210
3607,谷崧,14,0,14,新百王,2023-12-08,6210
2605,新興,76,63,13,新百王,2023-12-08,6210
00929,復華台灣科技優息,16,3,13,新百王,2023-12-08,6210
4726,永昕,13,0,13,新百王,2023-12-08,6210
1616,億泰,15,2,13,新百王,2023-12-08,6210
5515,建國,20,8,12,新百王,2023-12-08,6210
00720B,元大投資級公司債,26,14,12,新百王,2023-12-08,6210
8039,台虹,12,0,12,新百王,2023-12-08,6210
5521,工信,17,5,12,新百王,2023-12-08,6210
6668,中揚光,15,3,12,新百王,2023-12-08,6210
2441,超豐,12,1,11,新百王,2023-12-08,6210
00712,復華富時不動產,488,12,476,新百王,2023-12-11,6210
2611,志信,447,3,444,新百王,2023-12-11,6210
2515,中工,350,103,247,新百王,2023-12-11,6210
00929,復華台灣科技優息,193,3,190,新百王,2023-12-11,6210
00937B,群益ESG投等債20,145,10,135,新百王,2023-12-11,6210
00706L,期元大S＆P日圓正2,218,100,118,新百王,2023-12-11,6210
00934,中信成長高股息,100,2,98,新百王,2023-12-11,6210
2851,中再保,54,0,54,新百王,2023-12-11,6210
00919,群益台灣精選高息,77,26,51,新百王,2023-12-11,6210
00637L,元大滬深300正2,88,37,51,新百王,2023-12-11,6210
2867,三商壽,50,0,50,新百王,2023-12-11,6210
00882,中信中國高股息,44,0,44,新百王,2023-12-11,6210
2002,中鋼,46,3,43,新百王,2023-12-11,6210
1515,力山,84,41,43,新百王,2023-12-11,6210
2101,南港,40,0,40,新百王,2023-12-11,6210
00715L,期街口布蘭特正2,59,21,38,新百王,2023-12-11,6210
6598,ABC-KY,37,0,37,新百王,2023-12-11,6210
2329,華泰,62,28,34,新百王,2023-12-11,6210
00688L,國泰20年美債正2,30,0,30,新百王,2023-12-11,6210
8096,擎亞,41,11,30,新百王,2023-12-11,6210
2312,金寶,26,0,26,新百王,2023-12-11,6210
2402,毅嘉,50,25,25,新百王,2023-12-11,6210
1815,富喬,33,8,25,新百王,2023-12-11,6210
4503,金雨,27,3,24,新百王,2023-12-11,6210
2618,長榮航,36,14,22,新百王,2023-12-11,6210
4726,永昕,22,0,22,新百王,2023-12-11,6210
3481,群創,24,2,22,新百王,2023-12-11,6210
2313,華通,161,139,22,新百王,2023-12-11,6210
1609,大亞,72,50,22,新百王,2023-12-11,6210
1802,台玻,21,0,21,新百王,2023-12-11,6210
2412,中華電,29,8,21,新百王,2023-12-11,6210
00632R,元大台灣50反1,531,510,21,新百王,2023-12-11,6210
3526,凡甲,25,5,20,新百王,2023-12-11,6210
1324,地球,20,1,19,新百王,2023-12-11,6210
3033,威健,20,1,19,新百王,2023-12-11,6210
3540,曜越,18,0,18,新百王,2023-12-11,6210
2849,安泰銀,17,0,17,新百王,2023-12-11,6210
00687B,國泰20年美債,16,0,16,新百王,2023-12-11,6210
00679B,元大美債20年,16,0,16,新百王,2023-12-11,6210
6799,來頡,46,30,16,新百王,2023-12-11,6210
3694,海華,16,1,15,新百王,2023-12-11,6210
1524,耿鼎,87,72,15,新百王,2023-12-11,6210
6282,康舒,17,2,15,新百王,2023-12-11,6210
2204,中華,22,8,14,新百王,2023-12-11,6210
1733,五鼎,13,0,13,新百王,2023-12-11,6210
2358,廷鑫,52,41,11,新百王,2023-12-11,6210
5009,榮剛,80,69,11,新百王,2023-12-11,6210
3025,星通,11,0,11,新百王,2023-12-11,6210
3047,訊舟,11,0,11,新百王,2023-12-11,6210
2301,光寶科,35,24,11,新百王,2023-12-11,6210
00934,中信成長高股息,133,5,128,新百王,2023-12-12,6210
00632R,元大台灣50反1,421,300,121,新百王,2023-12-12,6210
1609,大亞,168,55,113,新百王,2023-12-12,6210
00929,復華台灣科技優息,133,22,111,新百王,2023-12-12,6210
00937B,群益ESG投等債20,97,10,87,新百王,2023-12-12,6210
00687B,國泰20年美債,85,0,85,新百王,2023-12-12,6210
00919,群益台灣精選高息,90,8,82,新百王,2023-12-12,6210
9105,泰金寶-DR,71,0,71,新百王,2023-12-12,6210
00933B,國泰10Y+金融債,62,0,62,新百王,2023-12-12,6210
4967,十銓,69,8,61,新百王,2023-12-12,6210
6116,彩晶,52,0,52,新百王,2023-12-12,6210
8068,全達,74,22,52,新百王,2023-12-12,6210
2409,友達,80,30,50,新百王,2023-12-12,6210
3231,緯創,63,15,48,新百王,2023-12-12,6210
6113,亞矽,71,24,47,新百王,2023-12-12,6210
1608,華榮,70,24,46,新百王,2023-12-12,6210
8096,擎亞,98,56,42,新百王,2023-12-12,6210
1618,合機,144,104,40,新百王,2023-12-12,6210
6598,ABC-KY,37,0,37,新百王,2023-12-12,6210
8112,至上,77,40,37,新百王,2023-12-12,6210
00688L,國泰20年美債正2,35,0,35,新百王,2023-12-12,6210
00637L,元大滬深300正2,57,22,35,新百王,2023-12-12,6210
4401,東隆興,35,0,35,新百王,2023-12-12,6210
4167,松瑞藥,31,0,31,新百王,2023-12-12,6210
2393,億光,30,0,30,新百王,2023-12-12,6210
2362,藍天,28,0,28,新百王,2023-12-12,6210
2002,中鋼,27,1,26,新百王,2023-12-12,6210
2515,中工,102,78,24,新百王,2023-12-12,6210
00918,大華優利高填息30,32,8,24,新百王,2023-12-12,6210
00680L,元大美債20正2,22,0,22,新百王,2023-12-12,6210
9950,萬國通,21,0,21,新百王,2023-12-12,6210
3515,華擎,22,1,21,新百王,2023-12-12,6210
5533,皇鼎,36,15,21,新百王,2023-12-12,6210
8088,品安,28,7,21,新百王,2023-12-12,6210
2883,凱基金,35,15,20,新百王,2023-12-12,6210
2313,華通,352,332,20,新百王,2023-12-12,6210
1612,宏泰,64,44,20,新百王,2023-12-12,6210
2891,中信金,20,0,20,新百王,2023-12-12,6210
5426,振發,67,47,20,新百王,2023-12-12,6210
6104,創惟,50,30,20,新百王,2023-12-12,6210
2344,華邦電,57,39,18,新百王,2023-12-12,6210
1432,大魯閣,30,13,17,新百王,2023-12-12,6210
3287,廣寰科,21,4,17,新百王,2023-12-12,6210
2851,中再保,17,0,17,新百王,2023-12-12,6210
2481,強茂,17,1,16,新百王,2023-12-12,6210
00882,中信中國高股息,15,0,15,新百王,2023-12-12,6210
2618,長榮航,30,16,14,新百王,2023-12-12,6210
3532,台勝科,16,2,14,新百王,2023-12-12,6210
2337,旺宏,16,3,13,新百王,2023-12-12,6210
1718,中纖,12,0,12,新百王,2023-12-12,6210
00919,群益台灣精選高息,428,20,408,新百王,2023-12-13,6210
00637L,元大滬深300正2,238,42,196,新百王,2023-12-13,6210
00929,復華台灣科技優息,198,16,182,新百王,2023-12-13,6210
00632R,元大台灣50反1,456,295,161,新百王,2023-12-13,6210
00715L,期街口布蘭特正2,147,27,120,新百王,2023-12-13,6210
00934,中信成長高股息,120,0,120,新百王,2023-12-13,6210
5351,鈺創,84,7,77,新百王,2023-12-13,6210
2867,三商壽,75,0,75,新百王,2023-12-13,6210
2890,永豐金,70,0,70,新百王,2023-12-13,6210
1909,榮成,68,0,68,新百王,2023-12-13,6210
00891,中信關鍵半導體,70,8,62,新百王,2023-12-13,6210
00712,復華富時不動產,50,1,49,新百王,2023-12-13,6210
5521,工信,116,69,47,新百王,2023-12-13,6210
2358,廷鑫,46,0,46,新百王,2023-12-13,6210
2405,輔信,110,67,43,新百王,2023-12-13,6210
00687B,國泰20年美債,43,0,43,新百王,2023-12-13,6210
00665L,富邦�琤肭磪囓�2,42,10,32,新百王,2023-12-13,6210
3715,定穎投控,58,28,30,新百王,2023-12-13,6210
1733,五鼎,30,0,30,新百王,2023-12-13,6210
3706,神達,109,80,29,新百王,2023-12-13,6210
6182,合晶,55,27,28,新百王,2023-12-13,6210
4306,炎洲,27,0,27,新百王,2023-12-13,6210
2002,中鋼,30,3,27,新百王,2023-12-13,6210
2701,萬企,26,0,26,新百王,2023-12-13,6210
3047,訊舟,21,0,21,新百王,2023-12-13,6210
00753L,中信中國50正2,21,0,21,新百王,2023-12-13,6210
2323,中環,22,1,21,新百王,2023-12-13,6210
2367,燿華,26,6,20,新百王,2023-12-13,6210
3036,文曄,22,2,20,新百王,2023-12-13,6210
2462,良得電,26,6,20,新百王,2023-12-13,6210
2634,漢翔,31,12,19,新百王,2023-12-13,6210
1907,永豐餘,32,13,19,新百王,2023-12-13,6210
6202,盛群,18,0,18,新百王,2023-12-13,6210
2851,中再保,26,8,18,新百王,2023-12-13,6210
2610,華航,18,0,18,新百王,2023-12-13,6210
00670L,富邦NASDAQ正2,21,3,18,新百王,2023-12-13,6210
3481,群創,16,0,16,新百王,2023-12-13,6210
2412,中華電,17,2,15,新百王,2023-12-13,6210
2887,台新金,15,0,15,新百王,2023-12-13,6210
2630,亞航,23,8,15,新百王,2023-12-13,6210
2465,麗臺,20,5,15,新百王,2023-12-13,6210
2332,友訊,15,0,15,新百王,2023-12-13,6210
6176,瑞儀,14,0,14,新百王,2023-12-13,6210
4976,佳凌,19,5,14,新百王,2023-12-13,6210
5439,高技,15,2,13,新百王,2023-12-13,6210
4939,亞電,25,12,13,新百王,2023-12-13,6210
2706,第一店,13,0,13,新百王,2023-12-13,6210
1326,台化,13,0,13,新百王,2023-12-13,6210
00882,中信中國高股息,12,0,12,新百王,2023-12-13,6210
2031,新光鋼,13,1,12,新百王,2023-12-13,6210
00687B,國泰20年美債,746,13,733,新百王,2023-12-14,6210
00632R,元大台灣50反1,732,0,732,新百王,2023-12-14,6210
2506,太設,157,3,154,新百王,2023-12-14,6210
00637L,元大滬深300正2,199,60,139,新百王,2023-12-14,6210
2867,三商壽,94,0,94,新百王,2023-12-14,6210
00937B,群益ESG投等債20,107,17,90,新百王,2023-12-14,6210
2412,中華電,69,4,65,新百王,2023-12-14,6210
1905,華紙,66,6,60,新百王,2023-12-14,6210
2641,正德,61,2,59,新百王,2023-12-14,6210
00900,富邦特選高股息30,55,0,55,新百王,2023-12-14,6210
3624,光頡,75,21,54,新百王,2023-12-14,6210
2515,中工,164,113,51,新百王,2023-12-14,6210
2897,王道銀行,60,10,50,新百王,2023-12-14,6210
2317,鴻海,181,133,48,新百王,2023-12-14,6210
2387,精元,60,17,43,新百王,2023-12-14,6210
2208,台船,40,0,40,新百王,2023-12-14,6210
00918,大華優利高填息30,46,6,40,新百王,2023-12-14,6210
2303,聯電,47,9,38,新百王,2023-12-14,6210
00669R,國泰美國道瓊反1,32,0,32,新百王,2023-12-14,6210
3390,旭軟,45,14,31,新百王,2023-12-14,6210
00931B,統一美債20年,30,0,30,新百王,2023-12-14,6210
8101,華冠,30,0,30,新百王,2023-12-14,6210
3047,訊舟,31,2,29,新百王,2023-12-14,6210
4167,松瑞藥,30,2,28,新百王,2023-12-14,6210
3576,聯合再生,52,25,27,新百王,2023-12-14,6210
2104,國際中橡,24,0,24,新百王,2023-12-14,6210
00773B,中信優先金融債,25,1,24,新百王,2023-12-14,6210
00934,中信成長高股息,27,5,22,新百王,2023-12-14,6210
6257,矽格,47,26,21,新百王,2023-12-14,6210
8940,新天地,21,0,21,新百王,2023-12-14,6210
2516,新建,35,14,21,新百王,2023-12-14,6210
1309,台達化,20,0,20,新百王,2023-12-14,6210
3645,達邁,20,0,20,新百王,2023-12-14,6210
3489,森寶,20,0,20,新百王,2023-12-14,6210
8068,全達,126,107,19,新百王,2023-12-14,6210
00633L,富邦上証正2,19,0,19,新百王,2023-12-14,6210
2462,良得電,20,1,19,新百王,2023-12-14,6210
00933B,國泰10Y+金融債,24,5,19,新百王,2023-12-14,6210
3207,耀勝,18,0,18,新百王,2023-12-14,6210
2520,冠德,19,1,18,新百王,2023-12-14,6210
3231,緯創,93,75,18,新百王,2023-12-14,6210
00764B,群益25年美債,17,0,17,新百王,2023-12-14,6210
2365,昆盈,86,69,17,新百王,2023-12-14,6210
5426,振發,128,113,15,新百王,2023-12-14,6210
1710,東聯,15,0,15,新百王,2023-12-14,6210
2020,美亞,15,0,15,新百王,2023-12-14,6210
00915,凱基優選高股息30,17,3,14,新百王,2023-12-14,6210
2329,華泰,27,13,14,新百王,2023-12-14,6210
5498,凱崴,14,0,14,新百王,2023-12-14,6210
1612,宏泰,17,3,14,新百王,2023-12-14,6210
00679B,元大美債20年,814,2,812,新百王,2023-12-15,6210
2363,矽統,459,183,276,新百王,2023-12-15,6210
00637L,元大滬深300正2,398,215,183,新百王,2023-12-15,6210
2605,新興,119,21,98,新百王,2023-12-15,6210
00712,復華富時不動產,131,38,93,新百王,2023-12-15,6210
00680L,元大美債20正2,304,222,82,新百王,2023-12-15,6210
6005,群益證,65,0,65,新百王,2023-12-15,6210
00918,大華優利高填息30,69,6,63,新百王,2023-12-15,6210
1605,華新,134,75,59,新百王,2023-12-15,6210
00929,復華台灣科技優息,751,692,59,新百王,2023-12-15,6210
3149,正達,58,2,56,新百王,2023-12-15,6210
2027,大成鋼,79,23,56,新百王,2023-12-15,6210
00936,台新永續高息中小,51,2,49,新百王,2023-12-15,6210
5009,榮剛,76,31,45,新百王,2023-12-15,6210
2412,中華電,40,2,38,新百王,2023-12-15,6210
00632R,元大台灣50反1,188,150,38,新百王,2023-12-15,6210
2516,新建,37,0,37,新百王,2023-12-15,6210
2201,裕隆,40,6,34,新百王,2023-12-15,6210
00713,元大台灣高息低波,35,1,34,新百王,2023-12-15,6210
6284,佳邦,126,93,33,新百王,2023-12-15,6210
2006,東和鋼鐵,33,2,31,新百王,2023-12-15,6210
2506,太設,30,0,30,新百王,2023-12-15,6210
2890,永豐金,30,1,29,新百王,2023-12-15,6210
2457,飛宏,29,0,29,新百王,2023-12-15,6210
2356,英業達,304,275,29,新百王,2023-12-15,6210
00706L,期元大S＆P日圓正2,25,0,25,新百王,2023-12-15,6210
2618,長榮航,36,13,23,新百王,2023-12-15,6210
6023,元大期,22,0,22,新百王,2023-12-15,6210
4968,立積,23,2,21,新百王,2023-12-15,6210
2009,第一銅,32,12,20,新百王,2023-12-15,6210
2388,威盛,89,69,20,新百王,2023-12-15,6210
6248,沛波,53,33,20,新百王,2023-12-15,6210
1524,耿鼎,24,4,20,新百王,2023-12-15,6210
1618,合機,21,2,19,新百王,2023-12-15,6210
2607,榮運,19,0,19,新百王,2023-12-15,6210
3052,夆典,18,0,18,新百王,2023-12-15,6210
1514,亞力,48,30,18,新百王,2023-12-15,6210
1609,大亞,39,22,17,新百王,2023-12-15,6210
5864,致和證,20,3,17,新百王,2023-12-15,6210
00864B,中信美國公債0-1,16,0,16,新百王,2023-12-15,6210
00764B,群益25年美債,15,0,15,新百王,2023-12-15,6210
1712,興農,15,0,15,新百王,2023-12-15,6210
1309,台達化,15,0,15,新百王,2023-12-15,6210
8358,金居,35,20,15,新百王,2023-12-15,6210
6202,盛群,15,1,14,新百王,2023-12-15,6210
3260,威剛,31,17,14,新百王,2023-12-15,6210
6111,大宇資,26,12,14,新百王,2023-12-15,6210
6535,順藥,13,0,13,新百王,2023-12-15,6210
8089,康全電訊,22,9,13,新百王,2023-12-15,6210
00720B,元大投資級公司債,14,1,13,新百王,2023-12-15,6210
00929,復華台灣科技優息,504,79,425,新百王,2023-12-18,6210
00687B,國泰20年美債,581,199,382,新百王,2023-12-18,6210
00688L,國泰20年美債正2,243,5,238,新百王,2023-12-18,6210
00753L,中信中國50正2,210,10,200,新百王,2023-12-18,6210
00937B,群益ESG投等債20,225,84,141,新百王,2023-12-18,6210
2903,遠百,107,0,107,新百王,2023-12-18,6210
00637L,元大滬深300正2,262,160,102,新百王,2023-12-18,6210
9105,泰金寶-DR,99,1,98,新百王,2023-12-18,6210
2897,王道銀行,100,20,80,新百王,2023-12-18,6210
00665L,富邦�琤肭磪囓�2,122,54,68,新百王,2023-12-18,6210
1409,新纖,60,0,60,新百王,2023-12-18,6210
6284,佳邦,113,60,53,新百王,2023-12-18,6210
00696B,富邦美債20年,51,0,51,新百王,2023-12-18,6210
2618,長榮航,80,33,47,新百王,2023-12-18,6210
2014,中鴻,195,150,45,新百王,2023-12-18,6210
2101,南港,42,0,42,新百王,2023-12-18,6210
00712,復華富時不動產,77,36,41,新百王,2023-12-18,6210
9907,統一實,40,0,40,新百王,2023-12-18,6210
6182,合晶,41,2,39,新百王,2023-12-18,6210
4714,永捷,38,0,38,新百王,2023-12-18,6210
2402,毅嘉,37,1,36,新百王,2023-12-18,6210
2022,聚亨,35,3,32,新百王,2023-12-18,6210
5521,工信,40,8,32,新百王,2023-12-18,6210
3014,聯陽,30,0,30,新百王,2023-12-18,6210
2641,正德,44,14,30,新百王,2023-12-18,6210
00710B,復華彭博非投等債,25,0,25,新百王,2023-12-18,6210
1432,大魯閣,24,0,24,新百王,2023-12-18,6210
5469,瀚宇博,29,5,24,新百王,2023-12-18,6210
1216,統一,23,1,22,新百王,2023-12-18,6210
9924,福興,21,0,21,新百王,2023-12-18,6210
00864B,中信美國公債0-1,20,0,20,新百王,2023-12-18,6210
5014,建錩,20,0,20,新百王,2023-12-18,6210
8054,安國,36,16,20,新百王,2023-12-18,6210
2030,彰源,24,5,19,新百王,2023-12-18,6210
2481,強茂,74,55,19,新百王,2023-12-18,6210
2610,華航,21,2,19,新百王,2023-12-18,6210
2201,裕隆,20,2,18,新百王,2023-12-18,6210
2388,威盛,62,44,18,新百王,2023-12-18,6210
3356,奇偶,23,5,18,新百王,2023-12-18,6210
2023,燁輝,210,193,17,新百王,2023-12-18,6210
00919,群益台灣精選高息,87,70,17,新百王,2023-12-18,6210
6111,大宇資,18,2,16,新百王,2023-12-18,6210
00720B,元大投資級公司債,16,0,16,新百王,2023-12-18,6210
6202,盛群,15,0,15,新百王,2023-12-18,6210
2459,敦吉,15,0,15,新百王,2023-12-18,6210
2356,英業達,66,52,14,新百王,2023-12-18,6210
2516,新建,14,0,14,新百王,2023-12-18,6210
00931B,統一美債20年,16,2,14,新百王,2023-12-18,6210
3004,豐達科,14,0,14,新百王,2023-12-18,6210
00885,富邦越南,13,0,13,新百王,2023-12-18,6210
2317,鴻海,317,68,249,新百王,2023-12-19,6210
00679B,元大美債20年,207,2,205,新百王,2023-12-19,6210
00688L,國泰20年美債正2,244,92,152,新百王,2023-12-19,6210
2038,海光,199,50,149,新百王,2023-12-19,6210
2101,南港,110,0,110,新百王,2023-12-19,6210
1325,恆大,101,4,97,新百王,2023-12-19,6210
00933B,國泰10Y+金融債,72,4,68,新百王,2023-12-19,6210
2412,中華電,55,0,55,新百王,2023-12-19,6210
2023,燁輝,59,9,50,新百王,2023-12-19,6210
5512,力麒,45,0,45,新百王,2023-12-19,6210
2344,華邦電,59,19,40,新百王,2023-12-19,6210
2459,敦吉,38,0,38,新百王,2023-12-19,6210
2816,旺旺保,52,15,37,新百王,2023-12-19,6210
00751B,元大AAA至A公司債,35,0,35,新百王,2023-12-19,6210
6116,彩晶,31,0,31,新百王,2023-12-19,6210
1312,國喬,30,0,30,新百王,2023-12-19,6210
4916,事欣科,30,0,30,新百王,2023-12-19,6210
2849,安泰銀,29,0,29,新百王,2023-12-19,6210
00722B,群益投資級電信債,50,22,28,新百王,2023-12-19,6210
00773B,中信優先金融債,27,0,27,新百王,2023-12-19,6210
2303,聯電,27,0,27,新百王,2023-12-19,6210
2605,新興,42,16,26,新百王,2023-12-19,6210
2882,國泰金,25,0,25,新百王,2023-12-19,6210
2031,新光鋼,28,3,25,新百王,2023-12-19,6210
1905,華紙,39,14,25,新百王,2023-12-19,6210
2332,友訊,23,0,23,新百王,2023-12-19,6210
6269,台郡,30,7,23,新百王,2023-12-19,6210
1217,愛之味,22,0,22,新百王,2023-12-19,6210
2006,東和鋼鐵,22,0,22,新百王,2023-12-19,6210
5351,鈺創,29,7,22,新百王,2023-12-19,6210
2903,遠百,21,0,21,新百王,2023-12-19,6210
1504,東元,28,7,21,新百王,2023-12-19,6210
2449,京元電子,22,1,21,新百王,2023-12-19,6210
00931B,統一美債20年,26,5,21,新百王,2023-12-19,6210
00891,中信關鍵半導體,28,8,20,新百王,2023-12-19,6210
2883B,凱基金乙特,20,0,20,新百王,2023-12-19,6210
2328,廣宇,21,2,19,新百王,2023-12-19,6210
2419,仲琦,23,4,19,新百王,2023-12-19,6210
3576,聯合再生,19,0,19,新百王,2023-12-19,6210
2324,仁寶,30,14,16,新百王,2023-12-19,6210
00715L,期街口布蘭特正2,31,15,16,新百王,2023-12-19,6210
2352,佳世達,15,0,15,新百王,2023-12-19,6210
6191,精成科,20,5,15,新百王,2023-12-19,6210
2515,中工,145,130,15,新百王,2023-12-19,6210
2888,新光金,15,0,15,新百王,2023-12-19,6210
2851,中再保,14,0,14,新百王,2023-12-19,6210
2890,永豐金,66,52,14,新百王,2023-12-19,6210
00665L,富邦�琤肭磪囓�2,19,5,14,新百王,2023-12-19,6210
0056,元大高股息,19,6,13,新百王,2023-12-19,6210
1618,合機,31,18,13,新百王,2023-12-19,6210
00679B,元大美債20年,463,14,449,新百王,2023-12-20,6210
00929,復華台灣科技優息,128,12,116,新百王,2023-12-20,6210
1718,中纖,101,2,99,新百王,2023-12-20,6210
2312,金寶,219,127,92,新百王,2023-12-20,6210
1218,泰山,79,0,79,新百王,2023-12-20,6210
2408,南亞科,75,1,74,新百王,2023-12-20,6210
2101,南港,70,0,70,新百王,2023-12-20,6210
00934,中信成長高股息,61,0,61,新百王,2023-12-20,6210
00937B,群益ESG投等債20,66,11,55,新百王,2023-12-20,6210
00936,台新永續高息中小,50,0,50,新百王,2023-12-20,6210
9924,福興,50,0,50,新百王,2023-12-20,6210
00933B,國泰10Y+金融債,40,0,40,新百王,2023-12-20,6210
00632R,元大台灣50反1,40,0,40,新百王,2023-12-20,6210
2356,英業達,328,290,38,新百王,2023-12-20,6210
4167,松瑞藥,35,0,35,新百王,2023-12-20,6210
00878,國泰永續高股息,56,24,32,新百王,2023-12-20,6210
00918,大華優利高填息30,42,12,30,新百王,2023-12-20,6210
00720B,元大投資級公司債,32,5,27,新百王,2023-12-20,6210
6598,ABC-KY,24,1,23,新百王,2023-12-20,6210
00715L,期街口布蘭特正2,35,13,22,新百王,2023-12-20,6210
8034,榮群,36,15,21,新百王,2023-12-20,6210
2888,新光金,20,0,20,新百王,2023-12-20,6210
1589,永冠-KY,20,0,20,新百王,2023-12-20,6210
00921,兆豐龍頭等權重,20,0,20,新百王,2023-12-20,6210
2331,精英,166,147,19,新百王,2023-12-20,6210
2618,長榮航,34,16,18,新百王,2023-12-20,6210
6140,訊達,22,4,18,新百王,2023-12-20,6210
6284,佳邦,81,65,16,新百王,2023-12-20,6210
2358,廷鑫,20,5,15,新百王,2023-12-20,6210
5371,中光電,15,2,13,新百王,2023-12-20,6210
3035,智原,32,19,13,新百王,2023-12-20,6210
2481,強茂,20,7,13,新百王,2023-12-20,6210
00864B,中信美國公債0-1,12,0,12,新百王,2023-12-20,6210
6244,茂迪,22,10,12,新百王,2023-12-20,6210
6531,愛普*,19,7,12,新百王,2023-12-20,6210
1733,五鼎,17,5,12,新百王,2023-12-20,6210
4906,正文,12,0,12,新百王,2023-12-20,6210
00670L,富邦NASDAQ正2,11,0,11,新百王,2023-12-20,6210
00923,群益台ESG低碳50,11,0,11,新百王,2023-12-20,6210
00665L,富邦�琤肭磪囓�2,50,39,11,新百王,2023-12-20,6210
1524,耿鼎,18,7,11,新百王,2023-12-20,6210
6248,沛波,11,0,11,新百王,2023-12-20,6210
2609,陽明,166,156,10,新百王,2023-12-20,6210
4543,萬在,10,0,10,新百王,2023-12-20,6210
2492,華新科,11,1,10,新百王,2023-12-20,6210
1608,華榮,10,0,10,新百王,2023-12-20,6210
1904,正隆,10,0,10,新百王,2023-12-20,6210
3228,金麗科,12,2,10,新百王,2023-12-20,6210
2498,宏達電,15,6,9,新百王,2023-12-20,6210
3010,華立,9,0,9,新百王,2023-12-20,6210
00680L,元大美債20正2,270,0,270,新百王,2023-12-21,6210
2641,正德,205,5,200,新百王,2023-12-21,6210
2392,正崴,163,1,162,新百王,2023-12-21,6210
1319,東陽,146,4,142,新百王,2023-12-21,6210
1314,中石化,297,201,96,新百王,2023-12-21,6210
00679B,元大美債20年,142,50,92,新百王,2023-12-21,6210
00878,國泰永續高股息,95,8,87,新百王,2023-12-21,6210
00937B,群益ESG投等債20,95,11,84,新百王,2023-12-21,6210
00687B,國泰20年美債,85,3,82,新百王,2023-12-21,6210
2317,鴻海,243,164,79,新百王,2023-12-21,6210
00637L,元大滬深300正2,390,312,78,新百王,2023-12-21,6210
6147,頎邦,66,1,65,新百王,2023-12-21,6210
8034,榮群,64,3,61,新百王,2023-12-21,6210
2324,仁寶,188,130,58,新百王,2023-12-21,6210
00933B,國泰10Y+金融債,41,0,41,新百王,2023-12-21,6210
1504,東元,35,0,35,新百王,2023-12-21,6210
6285,啟��,57,23,34,新百王,2023-12-21,6210
00929,復華台灣科技優息,49,19,30,新百王,2023-12-21,6210
2033,佳大,42,12,30,新百王,2023-12-21,6210
1731,美吾華,30,2,28,新百王,2023-12-21,6210
6284,佳邦,70,43,27,新百王,2023-12-21,6210
2377,微星,30,4,26,新百王,2023-12-21,6210
9919,康那香,97,71,26,新百王,2023-12-21,6210
5288,豐祥-KY,25,0,25,新百王,2023-12-21,6210
2388,威盛,32,9,23,新百王,2023-12-21,6210
5236,凌陽創新,23,1,22,新百王,2023-12-21,6210
00706L,期元大S＆P日圓正2,21,0,21,新百王,2023-12-21,6210
3005,神基,76,55,21,新百王,2023-12-21,6210
5533,皇鼎,20,0,20,新百王,2023-12-21,6210
3483,力致,20,0,20,新百王,2023-12-21,6210
3188,鑫龍騰,18,0,18,新百王,2023-12-21,6210
6111,大宇資,18,0,18,新百王,2023-12-21,6210
4919,新唐,18,1,17,新百王,2023-12-21,6210
1514,亞力,24,8,16,新百王,2023-12-21,6210
3034,聯詠,19,3,16,新百王,2023-12-21,6210
2412,中華電,19,3,16,新百王,2023-12-21,6210
00885,富邦越南,16,0,16,新百王,2023-12-21,6210
00675L,富邦臺灣加權正2,25,10,15,新百王,2023-12-21,6210
3704,合勤控,16,1,15,新百王,2023-12-21,6210
2455,全新,18,4,14,新百王,2023-12-21,6210
2358,廷鑫,25,11,14,新百王,2023-12-21,6210
5324,士開,15,2,13,新百王,2023-12-21,6210
2353,宏��,147,134,13,新百王,2023-12-21,6210
1522,堤維西,26,13,13,新百王,2023-12-21,6210
2323,中環,14,2,12,新百王,2023-12-21,6210
2801,彰銀,12,0,12,新百王,2023-12-21,6210
2636,台驊控股,45,33,12,新百王,2023-12-21,6210
2009,第一銅,12,0,12,新百王,2023-12-21,6210
3131,弘塑,12,0,12,新百王,2023-12-21,6210
3231,緯創,85,73,12,新百王,2023-12-21,6210
2641,正德,156,6,150,新百王,2023-12-22,6210
00680L,元大美債20正2,126,10,116,新百王,2023-12-22,6210
1718,中纖,114,0,114,新百王,2023-12-22,6210
00687B,國泰20年美債,100,6,94,新百王,2023-12-22,6210
2883,凱基金,81,0,81,新百王,2023-12-22,6210
2356,英業達,167,90,77,新百王,2023-12-22,6210
2412,中華電,70,0,70,新百王,2023-12-22,6210
2355,敬鵬,70,8,62,新百王,2023-12-22,6210
00665L,富邦�琤肭磪囓�2,118,56,62,新百王,2023-12-22,6210
6116,彩晶,106,56,50,新百王,2023-12-22,6210
9924,福興,50,0,50,新百王,2023-12-22,6210
1432,大魯閣,50,1,49,新百王,2023-12-22,6210
00670L,富邦NASDAQ正2,42,0,42,新百王,2023-12-22,6210
8054,安國,107,65,42,新百王,2023-12-22,6210
5512,力麒,81,40,41,新百王,2023-12-22,6210
00919,群益台灣精選高息,40,0,40,新百王,2023-12-22,6210
00650L,復華香港正2,62,22,40,新百王,2023-12-22,6210
6152,百一,37,0,37,新百王,2023-12-22,6210
9105,泰金寶-DR,42,12,30,新百王,2023-12-22,6210
5009,榮剛,83,53,30,新百王,2023-12-22,6210
00688L,國泰20年美債正2,64,34,30,新百王,2023-12-22,6210
5498,凱崴,29,0,29,新百王,2023-12-22,6210
8011,台通,29,0,29,新百王,2023-12-22,6210
2706,第一店,27,0,27,新百王,2023-12-22,6210
1314,中石化,26,0,26,新百王,2023-12-22,6210
2331,精英,41,16,25,新百王,2023-12-22,6210
1522,堤維西,25,1,24,新百王,2023-12-22,6210
6270,倍微,47,23,24,新百王,2023-12-22,6210
00679B,元大美債20年,25,1,24,新百王,2023-12-22,6210
00931B,統一美債20年,22,0,22,新百王,2023-12-22,6210
1605,華新,23,2,21,新百王,2023-12-22,6210
6133,金橋,21,0,21,新百王,2023-12-22,6210
00937B,群益ESG投等債20,97,76,21,新百王,2023-12-22,6210
00891,中信關鍵半導體,20,0,20,新百王,2023-12-22,6210
2852,第一保,21,1,20,新百王,2023-12-22,6210
8446,華研,20,0,20,新百王,2023-12-22,6210
2511,太子,20,0,20,新百王,2023-12-22,6210
00795B,中信美國公債20年,18,0,18,新百王,2023-12-22,6210
2515,中工,131,113,18,新百王,2023-12-22,6210
0056,元大高股息,20,2,18,新百王,2023-12-22,6210
2891,中信金,17,0,17,新百王,2023-12-22,6210
2344,華邦電,330,314,16,新百王,2023-12-22,6210
4746,台耀,16,0,16,新百王,2023-12-22,6210
2743,山富,16,0,16,新百王,2023-12-22,6210
2701,萬企,15,0,15,新百王,2023-12-22,6210
1440,南紡,15,0,15,新百王,2023-12-22,6210
1733,五鼎,21,6,15,新百王,2023-12-22,6210
1609,大亞,15,0,15,新百王,2023-12-22,6210
2392,正崴,14,0,14,新百王,2023-12-22,6210
2201,裕隆,18,5,13,新百王,2023-12-22,6210
2038,海光,691,407,284,新百王,2023-12-25,6210
00929,復華台灣科技優息,318,43,275,新百王,2023-12-25,6210
00919,群益台灣精選高息,99,2,97,新百王,2023-12-25,6210
2609,陽明,321,227,94,新百王,2023-12-25,6210
00687B,國泰20年美債,97,5,92,新百王,2023-12-25,6210
2498,宏達電,132,46,86,新百王,2023-12-25,6210
00864B,中信美國公債0-1,65,0,65,新百王,2023-12-25,6210
00751B,元大AAA至A公司債,64,0,64,新百王,2023-12-25,6210
2891,中信金,42,2,40,新百王,2023-12-25,6210
2353,宏��,149,109,40,新百王,2023-12-25,6210
8088,品安,64,26,38,新百王,2023-12-25,6210
3645,達邁,43,11,32,新百王,2023-12-25,6210
6152,百一,30,0,30,新百王,2023-12-25,6210
00933B,國泰10Y+金融債,27,0,27,新百王,2023-12-25,6210
2330,台積電,28,1,27,新百王,2023-12-25,6210
9924,福興,25,0,25,新百王,2023-12-25,6210
6111,大宇資,31,7,24,新百王,2023-12-25,6210
3694,海華,47,24,23,新百王,2023-12-25,6210
9105,泰金寶-DR,147,125,22,新百王,2023-12-25,6210
00720B,元大投資級公司債,22,0,22,新百王,2023-12-25,6210
6233,旺玖,31,9,22,新百王,2023-12-25,6210
3346,麗清,67,45,22,新百王,2023-12-25,6210
1514,亞力,37,16,21,新百王,2023-12-25,6210
00878,國泰永續高股息,24,3,21,新百王,2023-12-25,6210
4968,立積,21,1,20,新百王,2023-12-25,6210
00857B,永豐20年美公債,20,0,20,新百王,2023-12-25,6210
1717,長興,20,0,20,新百王,2023-12-25,6210
6285,啟��,70,50,20,新百王,2023-12-25,6210
3325,旭品,40,20,20,新百王,2023-12-25,6210
2903,遠百,20,0,20,新百王,2023-12-25,6210
2506,太設,85,66,19,新百王,2023-12-25,6210
5426,振發,16,0,16,新百王,2023-12-25,6210
2851,中再保,16,0,16,新百王,2023-12-25,6210
1702,南僑,16,0,16,新百王,2023-12-25,6210
1513,中興電,18,2,16,新百王,2023-12-25,6210
4529,淳紳,15,0,15,新百王,2023-12-25,6210
5009,榮剛,20,5,15,新百王,2023-12-25,6210
2014,中鴻,36,21,15,新百王,2023-12-25,6210
4533,協易機,15,0,15,新百王,2023-12-25,6210
1449,佳和,15,0,15,新百王,2023-12-25,6210
2610,華航,493,478,15,新百王,2023-12-25,6210
2606,裕民,47,33,14,新百王,2023-12-25,6210
00937B,群益ESG投等債20,14,0,14,新百王,2023-12-25,6210
00772B,中信高評級公司債,14,0,14,新百王,2023-12-25,6210
3576,聯合再生,14,0,14,新百王,2023-12-25,6210
00675L,富邦臺灣加權正2,14,0,14,新百王,2023-12-25,6210
2387,精元,14,1,13,新百王,2023-12-25,6210
9905,大華,12,0,12,新百王,2023-12-25,6210
3540,曜越,14,2,12,新百王,2023-12-25,6210
4167,松瑞藥,52,40,12,新百王,2023-12-25,6210
00919,群益台灣精選高息,167,1,166,新百王,2023-12-26,6210
00632R,元大台灣50反1,140,0,140,新百王,2023-12-26,6210
00929,復華台灣科技優息,135,19,116,新百王,2023-12-26,6210
2812,台中銀,74,0,74,新百王,2023-12-26,6210
00679B,元大美債20年,50,6,44,新百王,2023-12-26,6210
2634,漢翔,43,1,42,新百王,2023-12-26,6210
00680L,元大美債20正2,88,46,42,新百王,2023-12-26,6210
2359,所羅門,50,10,40,新百王,2023-12-26,6210
00933B,國泰10Y+金融債,40,0,40,新百王,2023-12-26,6210
00751B,元大AAA至A公司債,38,0,38,新百王,2023-12-26,6210
2358,廷鑫,35,0,35,新百王,2023-12-26,6210
2211,長榮鋼,40,5,35,新百王,2023-12-26,6210
00637L,元大滬深300正2,174,140,34,新百王,2023-12-26,6210
3481,群創,72,39,33,新百王,2023-12-26,6210
00676R,富邦臺灣加權反1,30,0,30,新百王,2023-12-26,6210
2607,榮運,30,0,30,新百王,2023-12-26,6210
00891,中信關鍵半導體,28,0,28,新百王,2023-12-26,6210
4726,永昕,28,0,28,新百王,2023-12-26,6210
5426,振發,29,2,27,新百王,2023-12-26,6210
1325,恆大,28,3,25,新百王,2023-12-26,6210
6191,精成科,25,1,24,新百王,2023-12-26,6210
00687B,國泰20年美債,22,0,22,新百王,2023-12-26,6210
3041,揚智,36,15,21,新百王,2023-12-26,6210
6806,森崴能源,21,0,21,新百王,2023-12-26,6210
00923,群益台ESG低碳50,20,0,20,新百王,2023-12-26,6210
2101,南港,20,0,20,新百王,2023-12-26,6210
00670L,富邦NASDAQ正2,17,0,17,新百王,2023-12-26,6210
6127,九豪,22,5,17,新百王,2023-12-26,6210
1582,信錦,21,5,16,新百王,2023-12-26,6210
00937B,群益ESG投等債20,15,0,15,新百王,2023-12-26,6210
1605,華新,17,2,15,新百王,2023-12-26,6210
3530,晶相光,19,5,14,新百王,2023-12-26,6210
2809,京城銀,17,3,14,新百王,2023-12-26,6210
00918,大華優利高填息30,38,24,14,新百王,2023-12-26,6210
1301,台塑,14,0,14,新百王,2023-12-26,6210
2038,海光,16,3,13,新百王,2023-12-26,6210
4968,立積,17,4,13,新百王,2023-12-26,6210
6196,帆宣,13,0,13,新百王,2023-12-26,6210
9941A,裕融甲特,12,0,12,新百王,2023-12-26,6210
4906,正文,13,1,12,新百王,2023-12-26,6210
2536,宏普,17,5,12,新百王,2023-12-26,6210
00662,富邦NASDAQ,11,0,11,新百王,2023-12-26,6210
2498,宏達電,35,25,10,新百王,2023-12-26,6210
6243,迅杰,21,11,10,新百王,2023-12-26,6210
5512,力麒,10,0,10,新百王,2023-12-26,6210
2618,長榮航,25,15,10,新百王,2023-12-26,6210
00674R,期元大S＆P黃金反1,10,0,10,新百王,2023-12-26,6210
2408,南亞科,12,2,10,新百王,2023-12-26,6210
00882,中信中國高股息,10,0,10,新百王,2023-12-26,6210
5521,工信,41,31,10,新百王,2023-12-26,6210
00937B,群益ESG投等債20,377,21,356,新百王,2023-12-27,6210
00632R,元大台灣50反1,290,0,290,新百王,2023-12-27,6210
3481,群創,287,31,256,新百王,2023-12-27,6210
6233,旺玖,292,127,165,新百王,2023-12-27,6210
00919,群益台灣精選高息,132,5,127,新百王,2023-12-27,6210
3390,旭軟,114,35,79,新百王,2023-12-27,6210
00929,復華台灣科技優息,92,15,77,新百王,2023-12-27,6210
2412,中華電,68,7,61,新百王,2023-12-27,6210
2101,南港,62,2,60,新百王,2023-12-27,6210
2618,長榮航,75,16,59,新百王,2023-12-27,6210
2890,永豐金,111,53,58,新百王,2023-12-27,6210
2849,安泰銀,55,0,55,新百王,2023-12-27,6210
1308,亞聚,43,0,43,新百王,2023-12-27,6210
2337,旺宏,50,19,31,新百王,2023-12-27,6210
00864B,中信美國公債0-1,30,0,30,新百王,2023-12-27,6210
00688L,國泰20年美債正2,28,2,26,新百王,2023-12-27,6210
2536,宏普,26,0,26,新百王,2023-12-27,6210
2359,所羅門,26,0,26,新百王,2023-12-27,6210
2889,國票金,25,0,25,新百王,2023-12-27,6210
2324,仁寶,252,230,22,新百王,2023-12-27,6210
3437,榮創,59,38,21,新百王,2023-12-27,6210
6179,亞通,37,16,21,新百王,2023-12-27,6210
9105,泰金寶-DR,20,0,20,新百王,2023-12-27,6210
2903,遠百,22,2,20,新百王,2023-12-27,6210
00665L,富邦�琤肭磪囓�2,20,0,20,新百王,2023-12-27,6210
2606,裕民,21,1,20,新百王,2023-12-27,6210
2605,新興,35,17,18,新百王,2023-12-27,6210
6222,上揚,16,0,16,新百王,2023-12-27,6210
6462,神盾,75,59,16,新百王,2023-12-27,6210
9934,成霖,15,0,15,新百王,2023-12-27,6210
6284,佳邦,94,81,13,新百王,2023-12-27,6210
2634,漢翔,15,2,13,新百王,2023-12-27,6210
3005,神基,19,7,12,新百王,2023-12-27,6210
3006,晶豪科,79,67,12,新百王,2023-12-27,6210
00936,台新永續高息中小,17,5,12,新百王,2023-12-27,6210
3694,海華,20,8,12,新百王,2023-12-27,6210
6443,元晶,12,0,12,新百王,2023-12-27,6210
5292,華懋,11,0,11,新百王,2023-12-27,6210
00933B,國泰10Y+金融債,11,0,11,新百王,2023-12-27,6210
6243,迅杰,44,33,11,新百王,2023-12-27,6210
00882,中信中國高股息,11,0,11,新百王,2023-12-27,6210
4720,德淵,10,0,10,新百王,2023-12-27,6210
2014,中鴻,11,1,10,新百王,2023-12-27,6210
4933,友輝,10,0,10,新百王,2023-12-27,6210
5272,笙科,19,9,10,新百王,2023-12-27,6210
5351,鈺創,12,2,10,新百王,2023-12-27,6210
1608,華榮,10,0,10,新百王,2023-12-27,6210
6152,百一,13,3,10,新百王,2023-12-27,6210
00753L,中信中國50正2,20,10,10,新百王,2023-12-27,6210
6129,普誠,13,3,10,新百王,2023-12-27,6210
00937B,群益ESG投等債20,257,0,257,新百王,2023-12-28,6210
2353,宏��,741,662,79,新百王,2023-12-28,6210
00687B,國泰20年美債,75,0,75,新百王,2023-12-28,6210
00715L,期街口布蘭特正2,67,0,67,新百王,2023-12-28,6210
00864B,中信美國公債0-1,65,0,65,新百王,2023-12-28,6210
2313,華通,79,22,57,新百王,2023-12-28,6210
00683L,期元大美元指正2,56,0,56,新百王,2023-12-28,6210
2323,中環,50,0,50,新百王,2023-12-28,6210
1718,中纖,50,0,50,新百王,2023-12-28,6210
00931B,統一美債20年,42,0,42,新百王,2023-12-28,6210
2344,華邦電,80,38,42,新百王,2023-12-28,6210
00929,復華台灣科技優息,68,35,33,新百王,2023-12-28,6210
2408,南亞科,39,6,33,新百王,2023-12-28,6210
3176,基亞,33,0,33,新百王,2023-12-28,6210
2303,聯電,185,152,33,新百王,2023-12-28,6210
3706,神達,224,197,27,新百王,2023-12-28,6210
2412,中華電,136,111,25,新百王,2023-12-28,6210
2352,佳世達,25,2,23,新百王,2023-12-28,6210
00919,群益台灣精選高息,46,24,22,新百王,2023-12-28,6210
2506,太設,21,0,21,新百王,2023-12-28,6210
1513,中興電,48,28,20,新百王,2023-12-28,6210
4961,天鈺,20,0,20,新百王,2023-12-28,6210
9924,福興,20,0,20,新百王,2023-12-28,6210
4967,十銓,22,2,20,新百王,2023-12-28,6210
2031,新光鋼,21,2,19,新百王,2023-12-28,6210
6125,廣運,24,6,18,新百王,2023-12-28,6210
6152,百一,18,0,18,新百王,2023-12-28,6210
2515,中工,17,0,17,新百王,2023-12-28,6210
2365,昆盈,225,209,16,新百王,2023-12-28,6210
6443,元晶,15,0,15,新百王,2023-12-28,6210
2358,廷鑫,15,0,15,新百王,2023-12-28,6210
6695,芯鼎,103,90,13,新百王,2023-12-28,6210
5351,鈺創,29,16,13,新百王,2023-12-28,6210
00673R,期元大S＆P原油反1,15,3,12,新百王,2023-12-28,6210
00722B,群益投資級電信債,12,0,12,新百王,2023-12-28,6210
3704,合勤控,14,2,12,新百王,2023-12-28,6210
5386,青雲,11,0,11,新百王,2023-12-28,6210
6189,豐藝,15,4,11,新百王,2023-12-28,6210
4973,廣穎,13,3,10,新百王,2023-12-28,6210
4167,松瑞藥,10,0,10,新百王,2023-12-28,6210
3624,光頡,10,0,10,新百王,2023-12-28,6210
2009,第一銅,112,102,10,新百王,2023-12-28,6210
1308,亞聚,20,10,10,新百王,2023-12-28,6210
00676R,富邦臺灣加權反1,10,0,10,新百王,2023-12-28,6210
1815,富喬,10,0,10,新百王,2023-12-28,6210
00772B,中信高評級公司債,10,0,10,新百王,2023-12-28,6210
8011,台通,37,28,9,新百王,2023-12-28,6210
2455,全新,16,7,9,新百王,2023-12-28,6210
6104,創惟,9,0,9,新百王,2023-12-28,6210
8054,安國,9,0,9,新百王,2023-12-28,6210
2317,鴻海,321,24,297,新百王,2023-12-29,6210
2007,燁興,260,1,259,新百王,2023-12-29,6210
00937B,群益ESG投等債20,282,77,205,新百王,2023-12-29,6210
00929,復華台灣科技優息,201,23,178,新百王,2023-12-29,6210
00688L,國泰20年美債正2,101,0,101,新百王,2023-12-29,6210
00934,中信成長高股息,86,1,85,新百王,2023-12-29,6210
6269,台郡,60,0,60,新百王,2023-12-29,6210
2885,元大金,50,0,50,新百王,2023-12-29,6210
00687B,國泰20年美債,50,0,50,新百王,2023-12-29,6210
00650L,復華香港正2,42,2,40,新百王,2023-12-29,6210
8011,台通,37,0,37,新百王,2023-12-29,6210
1308,亞聚,30,0,30,新百王,2023-12-29,6210
00712,復華富時不動產,30,0,30,新百王,2023-12-29,6210
2851,中再保,29,0,29,新百王,2023-12-29,6210
3483,力致,28,0,28,新百王,2023-12-29,6210
00933B,國泰10Y+金融債,28,0,28,新百王,2023-12-29,6210
00878,國泰永續高股息,52,25,27,新百王,2023-12-29,6210
5521,工信,104,78,26,新百王,2023-12-29,6210
3548,兆利,45,20,25,新百王,2023-12-29,6210
4967,十銓,34,9,25,新百王,2023-12-29,6210
2352,佳世達,103,79,24,新百王,2023-12-29,6210
6806,森崴能源,23,0,23,新百王,2023-12-29,6210
1217,愛之味,22,0,22,新百王,2023-12-29,6210
2331,精英,35,13,22,新百王,2023-12-29,6210
6182,合晶,23,1,22,新百王,2023-12-29,6210
00632R,元大台灣50反1,121,100,21,新百王,2023-12-29,6210
2101,南港,21,0,21,新百王,2023-12-29,6210
00751B,元大AAA至A公司債,22,1,21,新百王,2023-12-29,6210
4973,廣穎,25,5,20,新百王,2023-12-29,6210
2903,遠百,20,0,20,新百王,2023-12-29,6210
6188,廣明,25,5,20,新百王,2023-12-29,6210
9105,泰金寶-DR,20,0,20,新百王,2023-12-29,6210
00725B,國泰投資級公司債,20,0,20,新百王,2023-12-29,6210
2891,中信金,32,13,19,新百王,2023-12-29,6210
00715L,期街口布蘭特正2,66,50,16,新百王,2023-12-29,6210
1519,華城,64,49,15,新百王,2023-12-29,6210
8039,台虹,15,0,15,新百王,2023-12-29,6210
2618,長榮航,37,22,15,新百王,2023-12-29,6210
2409,友達,26,11,15,新百王,2023-12-29,6210
3024,憶聲,47,33,14,新百王,2023-12-29,6210
4726,永昕,14,0,14,新百王,2023-12-29,6210
3706,神達,63,49,14,新百王,2023-12-29,6210
0056,元大高股息,13,0,13,新百王,2023-12-29,6210
2421,建準,33,20,13,新百王,2023-12-29,6210
00680L,元大美債20正2,16,3,13,新百王,2023-12-29,6210
3450,聯鈞,16,4,12,新百王,2023-12-29,6210
2492,華新科,13,1,12,新百王,2023-12-29,6210
2324,仁寶,65,53,12,新百王,2023-12-29,6210
9924,福興,12,0,12,新百王,2023-12-29,6210
1514,亞力,51,40,11,新百王,2023-12-29,6210
00687B,國泰20年美債,1131,0,1131,新百王,2024-01-02,6210
00712,復華富時不動產,336,90,246,新百王,2024-01-02,6210
2007,燁興,200,1,199,新百王,2024-01-02,6210
00688L,國泰20年美債正2,190,3,187,新百王,2024-01-02,6210
2317,鴻海,131,8,123,新百王,2024-01-02,6210
00637L,元大滬深300正2,386,282,104,新百王,2024-01-02,6210
1216,統一,82,0,82,新百王,2024-01-02,6210
2501,國建,78,1,77,新百王,2024-01-02,6210
1609,大亞,62,5,57,新百王,2024-01-02,6210
00680L,元大美債20正2,77,21,56,新百王,2024-01-02,6210
6116,彩晶,100,50,50,新百王,2024-01-02,6210
5309,系統電,43,1,42,新百王,2024-01-02,6210
00929,復華台灣科技優息,92,55,37,新百王,2024-01-02,6210
2887,台新金,35,0,35,新百王,2024-01-02,6210
2514,龍邦,35,0,35,新百王,2024-01-02,6210
4162,智擎,39,4,35,新百王,2024-01-02,6210
2609,陽明,246,213,33,新百王,2024-01-02,6210
00751B,元大AAA至A公司債,32,0,32,新百王,2024-01-02,6210
00720B,元大投資級公司債,31,0,31,新百王,2024-01-02,6210
3706,神達,61,30,31,新百王,2024-01-02,6210
2303,聯電,32,3,29,新百王,2024-01-02,6210
3059,華晶科,27,1,26,新百王,2024-01-02,6210
4720,德淵,27,1,26,新百王,2024-01-02,6210
00936,台新永續高息中小,25,0,25,新百王,2024-01-02,6210
2356,英業達,36,11,25,新百王,2024-01-02,6210
2903,遠百,24,0,24,新百王,2024-01-02,6210
6182,合晶,23,0,23,新百王,2024-01-02,6210
9945,潤泰新,30,9,21,新百王,2024-01-02,6210
3484,崧騰,21,0,21,新百王,2024-01-02,6210
2516,新建,20,0,20,新百王,2024-01-02,6210
3313,斐成,20,0,20,新百王,2024-01-02,6210
2031,新光鋼,20,0,20,新百王,2024-01-02,6210
3321,同泰,20,0,20,新百王,2024-01-02,6210
00919,群益台灣精選高息,59,40,19,新百王,2024-01-02,6210
2101,南港,17,0,17,新百王,2024-01-02,6210
2352,佳世達,21,4,17,新百王,2024-01-02,6210
8271,宇瞻,17,0,17,新百王,2024-01-02,6210
2457,飛宏,18,2,16,新百王,2024-01-02,6210
00655L,國泰中國A50正2,15,0,15,新百王,2024-01-02,6210
00935,野村臺灣新科技50,13,0,13,新百王,2024-01-02,6210
1702,南僑,13,0,13,新百王,2024-01-02,6210
5210,寶碩,13,0,13,新百王,2024-01-02,6210
4919,新唐,12,0,12,新百王,2024-01-02,6210
4933,友輝,14,3,11,新百王,2024-01-02,6210
2301,光寶科,30,19,11,新百王,2024-01-02,6210
5011,久陽,11,0,11,新百王,2024-01-02,6210
6237,驊訊,12,1,11,新百王,2024-01-02,6210
4967,十銓,13,2,11,新百王,2024-01-02,6210
8011,台通,78,67,11,新百王,2024-01-02,6210
3231,緯創,84,73,11,新百王,2024-01-02,6210
00715L,期街口布蘭特正2,155,0,155,新百王,2024-01-03,6210
00712,復華富時不動產,153,63,90,新百王,2024-01-03,6210
2007,燁興,90,0,90,新百王,2024-01-03,6210
00927,群益半導體收益,87,0,87,新百王,2024-01-03,6210
00929,復華台灣科技優息,151,83,68,新百王,2024-01-03,6210
2353,宏��,103,35,68,新百王,2024-01-03,6210
2618,長榮航,140,79,61,新百王,2024-01-03,6210
2501,國建,60,1,59,新百王,2024-01-03,6210
00688L,國泰20年美債正2,54,0,54,新百王,2024-01-03,6210
9934,成霖,59,10,49,新百王,2024-01-03,6210
0056,元大高股息,50,6,44,新百王,2024-01-03,6210
3390,旭軟,174,132,42,新百王,2024-01-03,6210
2867,三商壽,41,0,41,新百王,2024-01-03,6210
00878,國泰永續高股息,46,7,39,新百王,2024-01-03,6210
2412,中華電,59,24,35,新百王,2024-01-03,6210
2888,新光金,43,10,33,新百王,2024-01-03,6210
2408,南亞科,37,4,33,新百王,2024-01-03,6210
3481,群創,32,1,31,新百王,2024-01-03,6210
2634,漢翔,30,0,30,新百王,2024-01-03,6210
2887,台新金,28,0,28,新百王,2024-01-03,6210
2405,輔信,35,7,28,新百王,2024-01-03,6210
00669R,國泰美國道瓊反1,27,0,27,新百王,2024-01-03,6210
2753,八方雲集,26,0,26,新百王,2024-01-03,6210
6275,元山,31,5,26,新百王,2024-01-03,6210
5512,力麒,25,0,25,新百王,2024-01-03,6210
9105,泰金寶-DR,25,0,25,新百王,2024-01-03,6210
00675L,富邦臺灣加權正2,25,0,25,新百王,2024-01-03,6210
6284,佳邦,75,53,22,新百王,2024-01-03,6210
00919,群益台灣精選高息,82,59,23,新百王,2024-01-03,6210
00934,中信成長高股息,22,0,22,新百王,2024-01-03,6210
1504,東元,23,1,22,新百王,2024-01-03,6210
00753L,中信中國50正2,21,0,21,新百王,2024-01-03,6210
6248,沛波,20,0,20,新百王,2024-01-03,6210
2498,宏達電,21,2,19,新百王,2024-01-03,6210
2610,華航,29,11,18,新百王,2024-01-03,6210
5210,寶碩,18,0,18,新百王,2024-01-03,6210
2890,永豐金,22,5,17,新百王,2024-01-03,6210
00679B,元大美債20年,20,3,17,新百王,2024-01-03,6210
00637L,元大滬深300正2,17,0,17,新百王,2024-01-03,6210
2454,聯發科,18,2,16,新百王,2024-01-03,6210
00633L,富邦上証正2,16,0,16,新百王,2024-01-03,6210
2455,全新,31,15,16,新百王,2024-01-03,6210
2486,一詮,130,115,15,新百王,2024-01-03,6210
2356,英業達,42,27,15,新百王,2024-01-03,6210
00680L,元大美債20正2,15,0,15,新百王,2024-01-03,6210
4720,德淵,15,0,15,新百王,2024-01-03,6210
3711,日月光投控,104,90,14,新百王,2024-01-03,6210
2515,中工,62,48,14,新百王,2024-01-03,6210
2912,統一超,13,0,13,新百王,2024-01-03,6210
8086,宏捷科,18,5,13,新百王,2024-01-03,6210
2038,海光,248,6,242,新百王,2024-01-04,6210
00937B,群益ESG投等債20,254,30,224,新百王,2024-01-04,6210
00929,復華台灣科技優息,216,27,189,新百王,2024-01-04,6210
9919,康那香,321,215,106,新百王,2024-01-04,6210
1216,統一,100,0,100,新百王,2024-01-04,6210
2883,凱基金,86,3,83,新百王,2024-01-04,6210
00712,復華富時不動產,85,5,80,新百王,2024-01-04,6210
00637L,元大滬深300正2,116,50,66,新百王,2024-01-04,6210
2367,燿華,54,0,54,新百王,2024-01-04,6210
00680L,元大美債20正2,64,20,44,新百王,2024-01-04,6210
3483,力致,44,3,41,新百王,2024-01-04,6210
1806,冠軍,50,12,38,新百王,2024-01-04,6210
00720B,元大投資級公司債,40,3,37,新百王,2024-01-04,6210
9925,新保,36,0,36,新百王,2024-01-04,6210
9934,成霖,70,34,36,新百王,2024-01-04,6210
4726,永昕,35,0,35,新百王,2024-01-04,6210
2392,正崴,33,0,33,新百王,2024-01-04,6210
2615,萬海,142,110,32,新百王,2024-01-04,6210
4967,十銓,60,31,29,新百王,2024-01-04,6210
3481,群創,22,0,22,新百王,2024-01-04,6210
00919,群益台灣精選高息,21,0,21,新百王,2024-01-04,6210
2344,華邦電,28,7,21,新百王,2024-01-04,6210
6265,方土昶,21,0,21,新百王,2024-01-04,6210
00706L,期元大S＆P日圓正2,20,0,20,新百王,2024-01-04,6210
8068,全達,20,0,20,新百王,2024-01-04,6210
2323,中環,21,1,20,新百王,2024-01-04,6210
2506,太設,40,20,20,新百王,2024-01-04,6210
00650L,復華香港正2,20,0,20,新百王,2024-01-04,6210
2891,中信金,20,1,19,新百王,2024-01-04,6210
0056,元大高股息,22,3,19,新百王,2024-01-04,6210
6185,幃翔,25,6,19,新百王,2024-01-04,6210
2641,正德,44,25,19,新百王,2024-01-04,6210
2324,仁寶,40,22,18,新百王,2024-01-04,6210
00751B,元大AAA至A公司債,21,3,18,新百王,2024-01-04,6210
1609,大亞,71,53,18,新百王,2024-01-04,6210
00881,國泰台灣5G+,17,0,17,新百王,2024-01-04,6210
2636,台驊控股,21,4,17,新百王,2024-01-04,6210
3706,神達,32,16,16,新百王,2024-01-04,6210
2882,國泰金,15,0,15,新百王,2024-01-04,6210
4188,安克,15,0,15,新百王,2024-01-04,6210
9912,偉聯,15,0,15,新百王,2024-01-04,6210
3576,聯合再生,15,0,15,新百王,2024-01-04,6210
2867,三商壽,15,0,15,新百王,2024-01-04,6210
5355,佳總,11,0,11,新百王,2024-01-04,6210
1466,聚隆,57,46,11,新百王,2024-01-04,6210
00934,中信成長高股息,11,0,11,新百王,2024-01-04,6210
2888,新光金,10,0,10,新百王,2024-01-04,6210
00725B,國泰投資級公司債,10,0,10,新百王,2024-01-04,6210
00688L,國泰20年美債正2,10,0,10,新百王,2024-01-04,6210
3479,安勤,10,0,10,新百王,2024-01-04,6210
2007,燁興,550,1,549,新百王,2024-01-05,6210
00929,復華台灣科技優息,76,20,56,新百王,2024-01-05,6210
00937B,群益ESG投等債20,78,30,48,新百王,2024-01-05,6210
00891,中信關鍵半導體,45,0,45,新百王,2024-01-05,6210
2344,華邦電,205,161,44,新百王,2024-01-05,6210
00688L,國泰20年美債正2,37,0,37,新百王,2024-01-05,6210
8112,至上,64,30,34,新百王,2024-01-05,6210
9945,潤泰新,30,0,30,新百王,2024-01-05,6210
00680L,元大美債20正2,29,0,29,新百王,2024-01-05,6210
00751B,元大AAA至A公司債,33,4,29,新百王,2024-01-05,6210
00712,復華富時不動產,44,15,29,新百王,2024-01-05,6210
2412,中華電,27,0,27,新百王,2024-01-05,6210
2543,皇昌,33,6,27,新百王,2024-01-05,6210
00931B,統一美債20年,27,0,27,新百王,2024-01-05,6210
2486,一詮,48,23,25,新百王,2024-01-05,6210
2353,宏��,103,78,25,新百王,2024-01-05,6210
2392,正崴,23,0,23,新百王,2024-01-05,6210
6191,精成科,20,0,20,新百王,2024-01-05,6210
1605,華新,20,0,20,新百王,2024-01-05,6210
00753L,中信中國50正2,20,0,20,新百王,2024-01-05,6210
6265,方土昶,21,1,20,新百王,2024-01-05,6210
00919,群益台灣精選高息,34,16,18,新百王,2024-01-05,6210
2489,瑞軒,48,30,18,新百王,2024-01-05,6210
2330,台積電,17,0,17,新百王,2024-01-05,6210
6108,競國,17,0,17,新百王,2024-01-05,6210
2610,華航,16,0,16,新百王,2024-01-05,6210
1514,亞力,43,28,15,新百王,2024-01-05,6210
2615,萬海,72,57,15,新百王,2024-01-05,6210
1618,合機,55,41,14,新百王,2024-01-05,6210
4720,德淵,15,1,14,新百王,2024-01-05,6210
6117,迎廣,32,18,14,新百王,2024-01-05,6210
2457,飛宏,15,2,13,新百王,2024-01-05,6210
3311,閎暉,12,0,12,新百王,2024-01-05,6210
0056,元大高股息,11,0,11,新百王,2024-01-05,6210
3037,欣興,15,4,11,新百王,2024-01-05,6210
1732,毛寶,48,37,11,新百王,2024-01-05,6210
2459,敦吉,11,0,11,新百王,2024-01-05,6210
6770,力積電,45,34,11,新百王,2024-01-05,6210
2206,三陽工業,11,1,10,新百王,2024-01-05,6210
3047,訊舟,10,0,10,新百王,2024-01-05,6210
2883,凱基金,10,0,10,新百王,2024-01-05,6210
3707,漢磊,11,1,10,新百王,2024-01-05,6210
5864,致和證,10,0,10,新百王,2024-01-05,6210
6593,台灣銘板,15,5,10,新百王,2024-01-05,6210
1504,東元,17,8,9,新百王,2024-01-05,6210
00706L,期元大S＆P日圓正2,9,0,9,新百王,2024-01-05,6210
3006,晶豪科,11,3,8,新百王,2024-01-05,6210
2515,中工,94,86,8,新百王,2024-01-05,6210
3673,TPK-KY,10,2,8,新百王,2024-01-05,6210
3484,崧騰,8,0,8,新百王,2024-01-05,6210
00637L,元大滬深300正2,327,46,281,新百王,2024-01-08,6210
00665L,富邦�琤肭磪囓�2,200,80,120,新百王,2024-01-08,6210
00632R,元大台灣50反1,432,320,112,新百王,2024-01-08,6210
00929,復華台灣科技優息,157,70,87,新百王,2024-01-08,6210
8011,台通,98,26,72,新百王,2024-01-08,6210
6005,群益證,63,0,63,新百王,2024-01-08,6210
2317,鴻海,88,37,51,新百王,2024-01-08,6210
00679B,元大美債20年,67,24,43,新百王,2024-01-08,6210
3041,揚智,52,12,40,新百王,2024-01-08,6210
3047,訊舟,60,20,40,新百王,2024-01-08,6210
3481,群創,60,25,35,新百王,2024-01-08,6210
00688L,國泰20年美債正2,32,0,32,新百王,2024-01-08,6210
3260,威剛,35,5,30,新百王,2024-01-08,6210
00715L,期街口布蘭特正2,35,7,28,新百王,2024-01-08,6210
00650L,復華香港正2,30,5,25,新百王,2024-01-08,6210
9105,泰金寶-DR,25,0,25,新百王,2024-01-08,6210
00937B,群益ESG投等債20,36,12,24,新百王,2024-01-08,6210
00670L,富邦NASDAQ正2,22,0,22,新百王,2024-01-08,6210
2888,新光金,60,39,21,新百王,2024-01-08,6210
2881,富邦金,55,34,21,新百王,2024-01-08,6210
2303,聯電,21,1,20,新百王,2024-01-08,6210
2355,敬鵬,20,0,20,新百王,2024-01-08,6210
2601,益航,20,0,20,新百王,2024-01-08,6210
8163,達方,20,0,20,新百王,2024-01-08,6210
2890,永豐金,20,0,20,新百王,2024-01-08,6210
2634,漢翔,29,9,20,新百王,2024-01-08,6210
00725B,國泰投資級公司債,38,20,18,新百王,2024-01-08,6210
3390,旭軟,29,11,18,新百王,2024-01-08,6210
00655L,國泰中國A50正2,18,0,18,新百王,2024-01-08,6210
3484,崧騰,18,0,18,新百王,2024-01-08,6210
3576,聯合再生,30,13,17,新百王,2024-01-08,6210
00927,群益半導體收益,16,0,16,新百王,2024-01-08,6210
3010,華立,14,0,14,新百王,2024-01-08,6210
00915,凱基優選高股息30,14,0,14,新百王,2024-01-08,6210
00753L,中信中國50正2,20,6,14,新百王,2024-01-08,6210
3311,閎暉,14,0,14,新百王,2024-01-08,6210
3042,晶技,14,2,12,新百王,2024-01-08,6210
2353,宏��,197,185,12,新百王,2024-01-08,6210
00885,富邦越南,12,0,12,新百王,2024-01-08,6210
00633L,富邦上証正2,14,2,12,新百王,2024-01-08,6210
2498,宏達電,39,27,12,新百王,2024-01-08,6210
6770,力積電,34,23,11,新百王,2024-01-08,6210
8227,巨有科技,19,8,11,新百王,2024-01-08,6210
5225,東科-KY,42,31,11,新百王,2024-01-08,6210
2362,藍天,61,50,11,新百王,2024-01-08,6210
1312,國喬,10,0,10,新百王,2024-01-08,6210
00935,野村臺灣新科技50,10,0,10,新百王,2024-01-08,6210
6189,豐藝,10,0,10,新百王,2024-01-08,6210
2440,太空梭,10,0,10,新百王,2024-01-08,6210
2459,敦吉,10,0,10,新百王,2024-01-08,6210
00929,復華台灣科技優息,134,13,121,新百王,2024-01-09,6210
2883,凱基金,95,0,95,新百王,2024-01-09,6210
2609,陽明,240,176,64,新百王,2024-01-09,6210
00919,群益台灣精選高息,100,41,59,新百王,2024-01-09,6210
2851,中再保,92,38,54,新百王,2024-01-09,6210
00937B,群益ESG投等債20,52,0,52,新百王,2024-01-09,6210
3047,訊舟,50,0,50,新百王,2024-01-09,6210
6116,彩晶,155,105,50,新百王,2024-01-09,6210
00715L,期街口布蘭特正2,47,0,47,新百王,2024-01-09,6210
00679B,元大美債20年,47,6,41,新百王,2024-01-09,6210
00673R,期元大S＆P原油反1,40,0,40,新百王,2024-01-09,6210
3702A,大聯大甲特,38,0,38,新百王,2024-01-09,6210
2461,光群雷,38,0,38,新百王,2024-01-09,6210
5512,力麒,36,0,36,新百王,2024-01-09,6210
00891,中信關鍵半導體,40,6,34,新百王,2024-01-09,6210
3622,洋華,39,6,33,新百王,2024-01-09,6210
00725B,國泰投資級公司債,32,0,32,新百王,2024-01-09,6210
2634,漢翔,36,5,31,新百王,2024-01-09,6210
1314,中石化,31,0,31,新百王,2024-01-09,6210
5521,工信,30,0,30,新百王,2024-01-09,6210
3260,威剛,30,3,27,新百王,2024-01-09,6210
2002,中鋼,26,0,26,新百王,2024-01-09,6210
00720B,元大投資級公司債,29,4,25,新百王,2024-01-09,6210
8163,達方,23,0,23,新百王,2024-01-09,6210
00648R,元大S＆P500反1,20,0,20,新百王,2024-01-09,6210
1708,東鹼,20,0,20,新百王,2024-01-09,6210
00675L,富邦臺灣加權正2,20,0,20,新百王,2024-01-09,6210
2313,華通,75,55,20,新百王,2024-01-09,6210
6223,旺矽,25,6,19,新百王,2024-01-09,6210
00670L,富邦NASDAQ正2,20,2,18,新百王,2024-01-09,6210
3311,閎暉,17,0,17,新百王,2024-01-09,6210
8446,華研,17,0,17,新百王,2024-01-09,6210
1434,福懋,20,4,16,新百王,2024-01-09,6210
6282,康舒,16,1,15,新百王,2024-01-09,6210
2816,旺旺保,18,3,15,新百王,2024-01-09,6210
3346,麗清,32,18,14,新百王,2024-01-09,6210
2324,仁寶,48,34,14,新百王,2024-01-09,6210
2606,裕民,14,0,14,新百王,2024-01-09,6210
3015,全漢,16,2,14,新百王,2024-01-09,6210
6284,佳邦,54,40,14,新百王,2024-01-09,6210
2457,飛宏,13,0,13,新百王,2024-01-09,6210
2340,台亞,13,0,13,新百王,2024-01-09,6210
8418,捷必勝-KY,13,0,13,新百王,2024-01-09,6210
9105,泰金寶-DR,12,0,12,新百王,2024-01-09,6210
2852,第一保,23,11,12,新百王,2024-01-09,6210
3265,台星科,16,5,11,新百王,2024-01-09,6210
00773B,中信優先金融債,10,0,10,新百王,2024-01-09,6210
3707,漢磊,10,0,10,新百王,2024-01-09,6210
2601,益航,10,0,10,新百王,2024-01-09,6210
5871,中租-KY,10,0,10,新百王,2024-01-09,6210
00679B,元大美債20年,1061,1,1060,新百王,2024-01-10,6210
2515,中工,233,37,196,新百王,2024-01-10,6210
00725B,國泰投資級公司債,163,8,155,新百王,2024-01-10,6210
00929,復華台灣科技優息,120,0,120,新百王,2024-01-10,6210
00675L,富邦臺灣加權正2,96,0,96,新百王,2024-01-10,6210
2883,凱基金,81,0,81,新百王,2024-01-10,6210
00795B,中信美國公債20年,60,0,60,新百王,2024-01-10,6210
2609,陽明,224,165,59,新百王,2024-01-10,6210
00665L,富邦�琤肭磪囓�2,50,0,50,新百王,2024-01-10,6210
2882,國泰金,49,1,48,新百王,2024-01-10,6210
2888,新光金,67,20,47,新百王,2024-01-10,6210
2498,宏達電,76,33,43,新百王,2024-01-10,6210
2543,皇昌,36,4,32,新百王,2024-01-10,6210
2101,南港,32,2,30,新百王,2024-01-10,6210
8936,國統,25,0,25,新百王,2024-01-10,6210
5347,世界,25,1,24,新百王,2024-01-10,6210
6235,華孚,23,1,22,新百王,2024-01-10,6210
8222,寶一,53,31,22,新百王,2024-01-10,6210
6120,達運,38,16,22,新百王,2024-01-10,6210
6239,力成,21,0,21,新百王,2024-01-10,6210
2534,宏盛,20,0,20,新百王,2024-01-10,6210
00882,中信中國高股息,19,0,19,新百王,2024-01-10,6210
00919,群益台灣精選高息,44,26,18,新百王,2024-01-10,6210
3481,群創,21,3,18,新百王,2024-01-10,6210
4744,皇將,25,7,18,新百王,2024-01-10,6210
00927,群益半導體收益,17,0,17,新百王,2024-01-10,6210
6285,啟��,22,5,17,新百王,2024-01-10,6210
2356,英業達,28,12,16,新百王,2024-01-10,6210
2204,中華,16,0,16,新百王,2024-01-10,6210
2618,長榮航,34,19,15,新百王,2024-01-10,6210
2605,新興,35,21,14,新百王,2024-01-10,6210
3707,漢磊,12,0,12,新百王,2024-01-10,6210
2243,宏旭-KY,11,0,11,新百王,2024-01-10,6210
8111,立��,47,36,11,新百王,2024-01-10,6210
2317,鴻海,14,3,11,新百王,2024-01-10,6210
2887,台新金,10,0,10,新百王,2024-01-10,6210
00918,大華優利高填息30,10,0,10,新百王,2024-01-10,6210
00936,台新永續高息中小,10,0,10,新百王,2024-01-10,6210
00937B,群益ESG投等債20,30,20,10,新百王,2024-01-10,6210
3202,樺晟,10,0,10,新百王,2024-01-10,6210
1440,南紡,10,0,10,新百王,2024-01-10,6210
2201,裕隆,22,13,9,新百王,2024-01-10,6210
2408,南亞科,10,1,9,新百王,2024-01-10,6210
2324,仁寶,63,54,9,新百王,2024-01-10,6210
3260,威剛,14,5,9,新百王,2024-01-10,6210
5351,鈺創,9,0,9,新百王,2024-01-10,6210
2331,精英,10,1,9,新百王,2024-01-10,6210
3015,全漢,8,0,8,新百王,2024-01-10,6210
6288,聯嘉,8,0,8,新百王,2024-01-10,6210
1101,台泥,9,1,8,新百王,2024-01-10,6210
00929,復華台灣科技優息,373,3,370,新百王,2024-01-11,6210
00632R,元大台灣50反1,160,0,160,新百王,2024-01-11,6210
2408,南亞科,98,10,88,新百王,2024-01-11,6210
00937B,群益ESG投等債20,86,1,85,新百王,2024-01-11,6210
1216,統一,73,0,73,新百王,2024-01-11,6210
6120,達運,171,100,71,新百王,2024-01-11,6210
5426,振發,80,9,71,新百王,2024-01-11,6210
8089,康全電訊,65,6,59,新百王,2024-01-11,6210
00927,群益半導體收益,58,0,58,新百王,2024-01-11,6210
1608,華榮,60,2,58,新百王,2024-01-11,6210
2867,三商壽,50,0,50,新百王,2024-01-11,6210
0050,元大台灣50,43,4,39,新百王,2024-01-11,6210
4909,新復興,47,12,35,新百王,2024-01-11,6210
00680L,元大美債20正2,35,0,35,新百王,2024-01-11,6210
9927,泰銘,34,0,34,新百王,2024-01-11,6210
00919,群益台灣精選高息,35,4,31,新百王,2024-01-11,6210
9924,福興,27,0,27,新百王,2024-01-11,6210
00891,中信關鍵半導體,45,18,27,新百王,2024-01-11,6210
00725B,國泰投資級公司債,25,0,25,新百王,2024-01-11,6210
1514,亞力,47,25,22,新百王,2024-01-11,6210
6113,亞矽,22,0,22,新百王,2024-01-11,6210
5288,豐祥-KY,22,0,22,新百王,2024-01-11,6210
00687B,國泰20年美債,23,2,21,新百王,2024-01-11,6210
3025,星通,44,24,20,新百王,2024-01-11,6210
00753L,中信中國50正2,20,0,20,新百王,2024-01-11,6210
1702,南僑,20,0,20,新百王,2024-01-11,6210
2882,國泰金,19,0,19,新百王,2024-01-11,6210
6244,茂迪,18,0,18,新百王,2024-01-11,6210
2358,廷鑫,20,2,18,新百王,2024-01-11,6210
2402,毅嘉,21,3,18,新百王,2024-01-11,6210
2890,永豐金,35,17,18,新百王,2024-01-11,6210
00715L,期街口布蘭特正2,67,50,17,新百王,2024-01-11,6210
6219,富旺,29,13,16,新百王,2024-01-11,6210
2603,長榮,40,24,16,新百王,2024-01-11,6210
1504,東元,28,12,16,新百王,2024-01-11,6210
2453,凌群,36,22,14,新百王,2024-01-11,6210
3147,大綜,14,0,14,新百王,2024-01-11,6210
00931B,統一美債20年,13,0,13,新百王,2024-01-11,6210
2605,新興,15,3,12,新百王,2024-01-11,6210
8034,榮群,28,16,12,新百王,2024-01-11,6210
2388,威盛,31,20,11,新百王,2024-01-11,6210
2401,凌陽,11,0,11,新百王,2024-01-11,6210
00706L,期元大S＆P日圓正2,11,0,11,新百王,2024-01-11,6210
4128,中天,11,0,11,新百王,2024-01-11,6210
1799,易威,11,0,11,新百王,2024-01-11,6210
6799,來頡,11,1,10,新百王,2024-01-11,6210
2204,中華,10,0,10,新百王,2024-01-11,6210
3051,力特,10,0,10,新百王,2024-01-11,6210
3287,廣寰科,121,111,10,新百王,2024-01-11,6210
2461,光群雷,10,0,10,新百王,2024-01-11,6210
00929,復華台灣科技優息,258,2,256,新百王,2024-01-12,6210
2208,台船,181,56,125,新百王,2024-01-12,6210
5211,蒙恬,103,5,98,新百王,2024-01-12,6210
00933B,國泰10Y+金融債,100,2,98,新百王,2024-01-12,6210
00937B,群益ESG投等債20,62,0,62,新百王,2024-01-12,6210
3622,洋華,87,37,50,新百王,2024-01-12,6210
4960,誠美材,56,12,44,新百王,2024-01-12,6210
5210,寶碩,60,20,40,新百王,2024-01-12,6210
00637L,元大滬深300正2,79,40,39,新百王,2024-01-12,6210
1216,統一,46,9,37,新百王,2024-01-12,6210
1503,士電,44,7,37,新百王,2024-01-12,6210
4956,光鋐,99,62,37,新百王,2024-01-12,6210
2356,英業達,103,69,34,新百王,2024-01-12,6210
2607,榮運,30,0,30,新百王,2024-01-12,6210
6116,彩晶,140,110,30,新百王,2024-01-12,6210
2358,廷鑫,38,10,28,新百王,2024-01-12,6210
00673R,期元大S＆P原油反1,27,0,27,新百王,2024-01-12,6210
8096,擎亞,202,178,24,新百王,2024-01-12,6210
9105,泰金寶-DR,20,0,20,新百王,2024-01-12,6210
3324,雙鴻,21,1,20,新百王,2024-01-12,6210
2816,旺旺保,22,4,18,新百王,2024-01-12,6210
6243,迅杰,26,8,18,新百王,2024-01-12,6210
2301,光寶科,36,20,16,新百王,2024-01-12,6210
6284,佳邦,20,4,16,新百王,2024-01-12,6210
6695,芯鼎,86,71,15,新百王,2024-01-12,6210
00687B,國泰20年美債,16,1,15,新百王,2024-01-12,6210
00858,永豐美國500大,13,0,13,新百王,2024-01-12,6210
2884,玉山金,24,12,12,新百王,2024-01-12,6210
1514,亞力,48,36,12,新百王,2024-01-12,6210
2206,三陽工業,12,0,12,新百王,2024-01-12,6210
2498,宏達電,16,5,11,新百王,2024-01-12,6210
2340,台亞,11,1,10,新百王,2024-01-12,6210
2204,中華,10,0,10,新百王,2024-01-12,6210
1785,光洋科,10,0,10,新百王,2024-01-12,6210
2009,第一銅,10,0,10,新百王,2024-01-12,6210
00665L,富邦�琤肭磪囓�2,120,110,10,新百王,2024-01-12,6210
5434,崇越,10,0,10,新百王,2024-01-12,6210
6231,系微,9,0,9,新百王,2024-01-12,6210
3576,聯合再生,9,0,9,新百王,2024-01-12,6210
6462,神盾,75,66,9,新百王,2024-01-12,6210
3266,昇陽,9,0,9,新百王,2024-01-12,6210
1609,大亞,26,17,9,新百王,2024-01-12,6210
4933,友輝,8,0,8,新百王,2024-01-12,6210
3339,泰谷,24,16,8,新百王,2024-01-12,6210
1702,南僑,10,2,8,新百王,2024-01-12,6210
4551,智伸科,8,0,8,新百王,2024-01-12,6210
4743,合一,15,7,8,新百王,2024-01-12,6210
1513,中興電,25,17,8,新百王,2024-01-12,6210
00927,群益半導體收益,7,0,7,新百王,2024-01-12,6210
3260,威剛,14,7,7,新百王,2024-01-12,6210
00929,復華台灣科技優息,321,14,307,新百王,2024-01-15,6210
00937B,群益ESG投等債20,113,0,113,新百王,2024-01-15,6210
00933B,國泰10Y+金融債,103,0,103,新百王,2024-01-15,6210
1528,恩德,136,42,94,新百王,2024-01-15,6210
2243,宏旭-KY,78,0,78,新百王,2024-01-15,6210
00665L,富邦�琤肭磪囓�2,157,89,68,新百王,2024-01-15,6210
00919,群益台灣精選高息,72,5,67,新百王,2024-01-15,6210
2412,中華電,84,19,65,新百王,2024-01-15,6210
2317,鴻海,68,4,64,新百王,2024-01-15,6210
2359,所羅門,65,6,59,新百王,2024-01-15,6210
2101,南港,57,0,57,新百王,2024-01-15,6210
2353,宏��,81,24,57,新百王,2024-01-15,6210
9105,泰金寶-DR,50,0,50,新百王,2024-01-15,6210
1444,力麗,50,0,50,新百王,2024-01-15,6210
00632R,元大台灣50反1,320,272,48,新百王,2024-01-15,6210
2816,旺旺保,83,38,45,新百王,2024-01-15,6210
6120,達運,114,70,44,新百王,2024-01-15,6210
4956,光鋐,189,148,41,新百王,2024-01-15,6210
2610,華航,43,3,40,新百王,2024-01-15,6210
2515,中工,79,40,39,新百王,2024-01-15,6210
3231,緯創,147,111,36,新百王,2024-01-15,6210
0056,元大高股息,37,1,36,新百王,2024-01-15,6210
00680L,元大美債20正2,33,0,33,新百王,2024-01-15,6210
6113,亞矽,30,0,30,新百王,2024-01-15,6210
5351,鈺創,62,35,27,新百王,2024-01-15,6210
3622,洋華,68,43,25,新百王,2024-01-15,6210
3715,定穎投控,55,30,25,新百王,2024-01-15,6210
2382,廣達,51,29,22,新百王,2024-01-15,6210
00770,國泰北美科技,27,6,21,新百王,2024-01-15,6210
2618,長榮航,39,18,21,新百王,2024-01-15,6210
1446,宏和,20,0,20,新百王,2024-01-15,6210
00858,永豐美國500大,20,0,20,新百王,2024-01-15,6210
2634,漢翔,49,29,20,新百王,2024-01-15,6210
3036,文曄,29,9,20,新百王,2024-01-15,6210
2356,英業達,41,23,18,新百王,2024-01-15,6210
6593,台灣銘板,43,25,18,新百王,2024-01-15,6210
00631L,元大台灣50正2,35,19,16,新百王,2024-01-15,6210
00927,群益半導體收益,15,0,15,新百王,2024-01-15,6210
3030,德律,16,1,15,新百王,2024-01-15,6210
00676R,富邦臺灣加權反1,15,0,15,新百王,2024-01-15,6210
6179,亞通,15,0,15,新百王,2024-01-15,6210
2888,新光金,15,1,14,新百王,2024-01-15,6210
00687B,國泰20年美債,13,0,13,新百王,2024-01-15,6210
1808,潤隆,13,0,13,新百王,2024-01-15,6210
2104,國際中橡,17,5,12,新百王,2024-01-15,6210
3055,蔚華科,11,0,11,新百王,2024-01-15,6210
2208,台船,30,19,11,新百王,2024-01-15,6210
5452,佶優,11,0,11,新百王,2024-01-15,6210
00857B,永豐20年美公債,10,0,10,新百王,2024-01-15,6210
3703,欣陸,10,0,10,新百王,2024-01-15,6210
3149,正達,205,0,205,新百王,2024-01-16,6210
0056,元大高股息,148,2,146,新百王,2024-01-16,6210
00665L,富邦�琤肭磪囓�2,184,44,140,新百王,2024-01-16,6210
8096,擎亞,230,128,102,新百王,2024-01-16,6210
00929,復華台灣科技優息,105,22,83,新百王,2024-01-16,6210
6120,達運,119,37,82,新百王,2024-01-16,6210
1216,統一,70,4,66,新百王,2024-01-16,6210
2353,宏��,199,137,62,新百王,2024-01-16,6210
8940,新天地,61,0,61,新百王,2024-01-16,6210
2101,南港,64,6,58,新百王,2024-01-16,6210
2883,凱基金,43,0,43,新百王,2024-01-16,6210
00637L,元大滬深300正2,93,52,41,新百王,2024-01-16,6210
00650L,復華香港正2,45,5,40,新百王,2024-01-16,6210
2887,台新金,37,0,37,新百王,2024-01-16,6210
2358,廷鑫,35,0,35,新百王,2024-01-16,6210
1570,力肯,34,0,34,新百王,2024-01-16,6210
2486,一詮,122,90,32,新百王,2024-01-16,6210
2882,國泰金,31,0,31,新百王,2024-01-16,6210
2308,台達電,31,1,30,新百王,2024-01-16,6210
00919,群益台灣精選高息,45,20,25,新百王,2024-01-16,6210
6187,萬潤,36,12,24,新百王,2024-01-16,6210
00937B,群益ESG投等債20,27,4,23,新百王,2024-01-16,6210
1504,東元,22,0,22,新百王,2024-01-16,6210
9945,潤泰新,22,0,22,新百王,2024-01-16,6210
2601,益航,22,0,22,新百王,2024-01-16,6210
2208,台船,23,1,22,新百王,2024-01-16,6210
2002,中鋼,22,1,21,新百王,2024-01-16,6210
2609,陽明,139,119,20,新百王,2024-01-16,6210
2301,光寶科,42,22,20,新百王,2024-01-16,6210
00927,群益半導體收益,20,0,20,新百王,2024-01-16,6210
1608,華榮,20,0,20,新百王,2024-01-16,6210
2329,華泰,65,46,19,新百王,2024-01-16,6210
2344,華邦電,26,7,19,新百王,2024-01-16,6210
2382,廣達,77,59,18,新百王,2024-01-16,6210
2520,冠德,20,2,18,新百王,2024-01-16,6210
00720B,元大投資級公司債,23,6,17,新百王,2024-01-16,6210
3147,大綜,17,0,17,新百王,2024-01-16,6210
2618,長榮航,30,14,16,新百王,2024-01-16,6210
00864B,中信美國公債0-1,16,0,16,新百王,2024-01-16,6210
3479,安勤,16,1,15,新百王,2024-01-16,6210
1101,台泥,14,0,14,新百王,2024-01-16,6210
1314,中石化,14,0,14,新百王,2024-01-16,6210
1326,台化,13,0,13,新百王,2024-01-16,6210
2610,華航,22,10,12,新百王,2024-01-16,6210
3324,雙鴻,20,8,12,新百王,2024-01-16,6210
2912,統一超,12,0,12,新百王,2024-01-16,6210
1795,美時,29,17,12,新百王,2024-01-16,6210
3703,欣陸,12,0,12,新百王,2024-01-16,6210
00733,富邦臺灣中小,11,0,11,新百王,2024-01-16,6210
4714,永捷,33,22,11,新百王,2024-01-16,6210
0056,元大高股息,111,0,111,新百王,2024-01-17,6210
00665L,富邦�琤肭磪囓�2,217,130,87,新百王,2024-01-17,6210
5210,寶碩,100,34,66,新百王,2024-01-17,6210
2353,宏��,96,33,63,新百王,2024-01-17,6210
8222,寶一,58,0,58,新百王,2024-01-17,6210
2303,聯電,94,41,53,新百王,2024-01-17,6210
00919,群益台灣精選高息,80,29,51,新百王,2024-01-17,6210
2838,聯邦銀,50,1,49,新百王,2024-01-17,6210
00680L,元大美債20正2,45,0,45,新百王,2024-01-17,6210
2344,華邦電,58,19,39,新百王,2024-01-17,6210
1731,美吾華,35,0,35,新百王,2024-01-17,6210
00937B,群益ESG投等債20,35,0,35,新百王,2024-01-17,6210
6667,信紘科,41,7,34,新百王,2024-01-17,6210
2520,冠德,32,0,32,新百王,2024-01-17,6210
8940,新天地,32,0,32,新百王,2024-01-17,6210
4714,永捷,39,9,30,新百王,2024-01-17,6210
00929,復華台灣科技優息,233,204,29,新百王,2024-01-17,6210
4726,永昕,29,0,29,新百王,2024-01-17,6210
1528,恩德,61,32,29,新百王,2024-01-17,6210
4915,致伸,30,1,29,新百王,2024-01-17,6210
006208,富邦台50,28,0,28,新百王,2024-01-17,6210
2887,台新金,27,0,27,新百王,2024-01-17,6210
00915,凱基優選高股息30,27,0,27,新百王,2024-01-17,6210
00882,中信中國高股息,26,0,26,新百王,2024-01-17,6210
2356,英業達,37,11,26,新百王,2024-01-17,6210
0050,元大台灣50,75,49,26,新百王,2024-01-17,6210
1326,台化,25,0,25,新百王,2024-01-17,6210
1506,正道,25,0,25,新百王,2024-01-17,6210
2609,陽明,128,104,24,新百王,2024-01-17,6210
00631L,元大台灣50正2,23,0,23,新百王,2024-01-17,6210
00679B,元大美債20年,25,2,23,新百王,2024-01-17,6210
8111,立��,37,14,23,新百王,2024-01-17,6210
2002,中鋼,22,1,21,新百王,2024-01-17,6210
3002,歐格,24,3,21,新百王,2024-01-17,6210
5211,蒙恬,21,0,21,新百王,2024-01-17,6210
00715L,期街口布蘭特正2,22,1,21,新百王,2024-01-17,6210
5871,中租-KY,20,0,20,新百王,2024-01-17,6210
5288,豐祥-KY,20,0,20,新百王,2024-01-17,6210
00650L,復華香港正2,20,0,20,新百王,2024-01-17,6210
2867,三商壽,25,5,20,新百王,2024-01-17,6210
2371,大同,22,3,19,新百王,2024-01-17,6210
2515,中工,48,30,18,新百王,2024-01-17,6210
00927,群益半導體收益,17,0,17,新百王,2024-01-17,6210
9945,潤泰新,18,2,16,新百王,2024-01-17,6210
2208,台船,16,0,16,新百王,2024-01-17,6210
5512,力麒,16,0,16,新百王,2024-01-17,6210
2408,南亞科,21,6,15,新百王,2024-01-17,6210
2880,華南金,15,0,15,新百王,2024-01-17,6210
2031,新光鋼,15,0,15,新百王,2024-01-17,6210
00687B,國泰20年美債,27,12,15,新百王,2024-01-17,6210
00632R,元大台灣50反1,561,80,481,新百王,2024-01-18,6210
3437,榮創,207,1,206,新百王,2024-01-18,6210
2884,玉山金,204,5,199,新百王,2024-01-18,6210
0056,元大高股息,113,33,80,新百王,2024-01-18,6210
00919,群益台灣精選高息,73,4,69,新百王,2024-01-18,6210
2313,華通,83,23,60,新百王,2024-01-18,6210
00882,中信中國高股息,50,0,50,新百王,2024-01-18,6210
1101,台泥,48,1,47,新百王,2024-01-18,6210
00712,復華富時不動產,48,2,46,新百王,2024-01-18,6210
4960,誠美材,45,4,41,新百王,2024-01-18,6210
3025,星通,131,90,41,新百王,2024-01-18,6210
5426,振發,333,295,38,新百王,2024-01-18,6210
2303,聯電,48,16,32,新百王,2024-01-18,6210
00878,國泰永續高股息,34,2,32,新百王,2024-01-18,6210
4979,華星光,33,4,29,新百王,2024-01-18,6210
1326,台化,32,5,27,新百王,2024-01-18,6210
9945,潤泰新,24,0,24,新百王,2024-01-18,6210
6285,啟��,30,7,23,新百王,2024-01-18,6210
2002,中鋼,22,0,22,新百王,2024-01-18,6210
2706,第一店,20,0,20,新百王,2024-01-18,6210
1528,恩德,32,13,19,新百王,2024-01-18,6210
2453,凌群,23,6,17,新百王,2024-01-18,6210
6533,晶心科,21,5,16,新百王,2024-01-18,6210
00706L,期元大S＆P日圓正2,15,0,15,新百王,2024-01-18,6210
4958,臻鼎-KY,16,1,15,新百王,2024-01-18,6210
9914,美利達,15,0,15,新百王,2024-01-18,6210
2208,台船,15,0,15,新百王,2024-01-18,6210
4746,台耀,61,47,14,新百王,2024-01-18,6210
6233,旺玖,44,31,13,新百王,2024-01-18,6210
00921,兆豐龍頭等權重,13,0,13,新百王,2024-01-18,6210
2358,廷鑫,45,33,12,新百王,2024-01-18,6210
2382,廣達,24,12,12,新百王,2024-01-18,6210
2324,仁寶,62,51,11,新百王,2024-01-18,6210
2816,旺旺保,11,0,11,新百王,2024-01-18,6210
00688L,國泰20年美債正2,11,0,11,新百王,2024-01-18,6210
3231,緯創,39,28,11,新百王,2024-01-18,6210
5347,世界,14,4,10,新百王,2024-01-18,6210
2368,金像電,12,2,10,新百王,2024-01-18,6210
00905,FT臺灣Smart,10,0,10,新百王,2024-01-18,6210
00671R,富邦NASDAQ反1,10,0,10,新百王,2024-01-18,6210
5519,隆大,10,0,10,新百王,2024-01-18,6210
00891,中信關鍵半導體,10,0,10,新百王,2024-01-18,6210
00715L,期街口布蘭特正2,10,0,10,新百王,2024-01-18,6210
3537,堡達,10,0,10,新百王,2024-01-18,6210
6770,力積電,11,1,10,新百王,2024-01-18,6210
3622,洋華,41,31,10,新百王,2024-01-18,6210
8096,擎亞,87,77,10,新百王,2024-01-18,6210
00864B,中信美國公債0-1,10,0,10,新百王,2024-01-18,6210
3006,晶豪科,12,2,10,新百王,2024-01-18,6210
6695,芯鼎,20,11,9,新百王,2024-01-18,6210
2002,中鋼,476,1,475,新百王,2024-01-19,6210
00680L,元大美債20正2,226,0,226,新百王,2024-01-19,6210
0056,元大高股息,211,9,202,新百王,2024-01-19,6210
00679B,元大美債20年,107,9,98,新百王,2024-01-19,6210
00688L,國泰20年美債正2,94,0,94,新百王,2024-01-19,6210
00733,富邦臺灣中小,85,0,85,新百王,2024-01-19,6210
00795B,中信美國公債20年,70,0,70,新百王,2024-01-19,6210
00753L,中信中國50正2,61,0,61,新百王,2024-01-19,6210
5426,振發,299,246,53,新百王,2024-01-19,6210
00929,復華台灣科技優息,116,65,51,新百王,2024-01-19,6210
1609,大亞,51,1,50,新百王,2024-01-19,6210
2609,陽明,149,107,42,新百王,2024-01-19,6210
2816,旺旺保,46,6,40,新百王,2024-01-19,6210
00878,國泰永續高股息,79,40,39,新百王,2024-01-19,6210
00720B,元大投資級公司債,38,0,38,新百王,2024-01-19,6210
8096,擎亞,111,76,35,新百王,2024-01-19,6210
6120,達運,102,68,34,新百王,2024-01-19,6210
2887,台新金,52,20,32,新百王,2024-01-19,6210
6285,啟��,86,54,32,新百王,2024-01-19,6210
6276,安鈦克,34,4,30,新百王,2024-01-19,6210
1608,華榮,30,0,30,新百王,2024-01-19,6210
2329,華泰,203,175,28,新百王,2024-01-19,6210
00919,群益台灣精選高息,25,0,25,新百王,2024-01-19,6210
00751B,元大AAA至A公司債,26,2,24,新百王,2024-01-19,6210
1101,台泥,25,1,24,新百王,2024-01-19,6210
00687B,國泰20年美債,23,0,23,新百王,2024-01-19,6210
2618,長榮航,68,46,22,新百王,2024-01-19,6210
00673R,期元大S＆P原油反1,21,0,21,新百王,2024-01-19,6210
2801,彰銀,21,0,21,新百王,2024-01-19,6210
5488,松普,26,6,20,新百王,2024-01-19,6210
1616,億泰,20,0,20,新百王,2024-01-19,6210
006206,元大上證50,20,0,20,新百王,2024-01-19,6210
00712,復華富時不動產,30,11,19,新百王,2024-01-19,6210
1528,恩德,27,8,19,新百王,2024-01-19,6210
2882,國泰金,18,0,18,新百王,2024-01-19,6210
6770,力積電,14,0,14,新百王,2024-01-19,6210
00882,中信中國高股息,19,5,14,新百王,2024-01-19,6210
2603,長榮,27,13,14,新百王,2024-01-19,6210
2834,臺企銀,13,0,13,新百王,2024-01-19,6210
4904,遠傳,27,15,12,新百王,2024-01-19,6210
4960,誠美材,19,7,12,新百王,2024-01-19,6210
00857B,永豐20年美公債,10,0,10,新百王,2024-01-19,6210
1762,中化生,10,0,10,新百王,2024-01-19,6210
4906,正文,10,0,10,新百王,2024-01-19,6210
00700,富邦�琤肭磪�,10,0,10,新百王,2024-01-19,6210
3032,偉訓,23,13,10,新百王,2024-01-19,6210
3490,單井,13,3,10,新百王,2024-01-19,6210
6443,元晶,10,0,10,新百王,2024-01-19,6210
3052,夆典,17,7,10,新百王,2024-01-19,6210
00931B,統一美債20年,9,0,9,新百王,2024-01-19,6210
00632R,元大台灣50反1,820,210,610,新百王,2024-01-22,6210
2890,永豐金,106,0,106,新百王,2024-01-22,6210
2317,鴻海,103,1,102,新百王,2024-01-22,6210
00753L,中信中國50正2,126,51,75,新百王,2024-01-22,6210
00878,國泰永續高股息,103,30,73,新百王,2024-01-22,6210
2618,長榮航,103,32,71,新百王,2024-01-22,6210
00715L,期街口布蘭特正2,53,0,53,新百王,2024-01-22,6210
0056,元大高股息,112,64,48,新百王,2024-01-22,6210
00933B,國泰10Y+金融債,48,0,48,新百王,2024-01-22,6210
00937B,群益ESG投等債20,51,8,43,新百王,2024-01-22,6210
2331,精英,42,0,42,新百王,2024-01-22,6210
4128,中天,55,13,42,新百王,2024-01-22,6210
2243,宏旭-KY,40,0,40,新百王,2024-01-22,6210
3390,旭軟,35,0,35,新百王,2024-01-22,6210
3231,緯創,229,196,33,新百王,2024-01-22,6210
2353,宏��,208,176,32,新百王,2024-01-22,6210
00650L,復華香港正2,30,0,30,新百王,2024-01-22,6210
2867,三商壽,30,0,30,新百王,2024-01-22,6210
2887,台新金,34,10,24,新百王,2024-01-22,6210
8034,榮群,46,22,24,新百王,2024-01-22,6210
1326,台化,43,20,23,新百王,2024-01-22,6210
2301,光寶科,98,77,21,新百王,2024-01-22,6210
00864B,中信美國公債0-1,20,0,20,新百王,2024-01-22,6210
2915,潤泰全,20,0,20,新百王,2024-01-22,6210
2816,旺旺保,39,19,20,新百王,2024-01-22,6210
2358,廷鑫,20,0,20,新百王,2024-01-22,6210
2002,中鋼,30,11,19,新百王,2024-01-22,6210
00882,中信中國高股息,18,0,18,新百王,2024-01-22,6210
00712,復華富時不動產,17,1,16,新百王,2024-01-22,6210
1609,大亞,51,36,15,新百王,2024-01-22,6210
6243,迅杰,21,6,15,新百王,2024-01-22,6210
00927,群益半導體收益,14,0,14,新百王,2024-01-22,6210
6668,中揚光,34,20,14,新百王,2024-01-22,6210
5355,佳總,14,0,14,新百王,2024-01-22,6210
6282,康舒,12,0,12,新百王,2024-01-22,6210
2723,美食-KY,14,2,12,新百王,2024-01-22,6210
2316,楠梓電,65,53,12,新百王,2024-01-22,6210
6120,達運,12,0,12,新百王,2024-01-22,6210
2408,南亞科,15,3,12,新百王,2024-01-22,6210
8011,台通,12,0,12,新百王,2024-01-22,6210
2409,友達,15,3,12,新百王,2024-01-22,6210
00720B,元大投資級公司債,12,1,11,新百王,2024-01-22,6210
3055,蔚華科,27,16,11,新百王,2024-01-22,6210
00918,大華優利高填息30,21,10,11,新百王,2024-01-22,6210
5443,均豪,18,7,11,新百王,2024-01-22,6210
020034,元大IC設計N,10,0,10,新百王,2024-01-22,6210
00885,富邦越南,10,0,10,新百王,2024-01-22,6210
1471,首利,10,0,10,新百王,2024-01-22,6210
1608,華榮,10,0,10,新百王,2024-01-22,6210
0050,元大台灣50,11,1,10,新百王,2024-01-22,6210
00712,復華富時不動產,235,0,235,新百王,2024-01-23,6210
00933B,國泰10Y+金融債,215,0,215,新百王,2024-01-23,6210
2886,兆豐金,180,0,180,新百王,2024-01-23,6210
00637L,元大滬深300正2,352,216,136,新百王,2024-01-23,6210
2409,友達,539,424,115,新百王,2024-01-23,6210
3059,華晶科,127,19,108,新百王,2024-01-23,6210
00632R,元大台灣50反1,131,60,71,新百王,2024-01-23,6210
2883,凱基金,63,11,52,新百王,2024-01-23,6210
6152,百一,42,0,42,新百王,2024-01-23,6210
00680L,元大美債20正2,40,0,40,新百王,2024-01-23,6210
00753L,中信中國50正2,40,4,36,新百王,2024-01-23,6210
00937B,群益ESG投等債20,34,0,34,新百王,2024-01-23,6210
2884,玉山金,35,1,34,新百王,2024-01-23,6210
4956,光鋐,61,34,27,新百王,2024-01-23,6210
6108,競國,27,1,26,新百王,2024-01-23,6210
2537,聯上發,30,5,25,新百王,2024-01-23,6210
0056,元大高股息,30,7,23,新百王,2024-01-23,6210
2609,陽明,44,21,23,新百王,2024-01-23,6210
2405,輔信,28,6,22,新百王,2024-01-23,6210
2316,楠梓電,23,3,20,新百王,2024-01-23,6210
2371,大同,36,16,20,新百王,2024-01-23,6210
6113,亞矽,27,8,19,新百王,2024-01-23,6210
00919,群益台灣精選高息,19,0,19,新百王,2024-01-23,6210
2329,華泰,41,23,18,新百王,2024-01-23,6210
2915,潤泰全,18,0,18,新百王,2024-01-23,6210
2002,中鋼,18,0,18,新百王,2024-01-23,6210
3032,偉訓,46,28,18,新百王,2024-01-23,6210
2890,永豐金,23,6,17,新百王,2024-01-23,6210
9927,泰銘,17,0,17,新百王,2024-01-23,6210
2887,台新金,17,0,17,新百王,2024-01-23,6210
3036,文曄,42,27,15,新百王,2024-01-23,6210
2356,英業達,217,202,15,新百王,2024-01-23,6210
4128,中天,20,5,15,新百王,2024-01-23,6210
2401,凌陽,30,17,13,新百王,2024-01-23,6210
3325,旭品,17,5,12,新百王,2024-01-23,6210
1319,東陽,22,11,11,新百王,2024-01-23,6210
2009,第一銅,11,0,11,新百王,2024-01-23,6210
2324,仁寶,21,11,10,新百王,2024-01-23,6210
1802,台玻,15,5,10,新百王,2024-01-23,6210
1608,華榮,10,0,10,新百王,2024-01-23,6210
00676R,富邦臺灣加權反1,10,0,10,新百王,2024-01-23,6210
00673R,期元大S＆P原油反1,10,0,10,新百王,2024-01-23,6210
6120,達運,48,38,10,新百王,2024-01-23,6210
00907,永豐優息存股,10,0,10,新百王,2024-01-23,6210
1536,和大,10,0,10,新百王,2024-01-23,6210
4714,永捷,20,10,10,新百王,2024-01-23,6210
2358,廷鑫,10,0,10,新百王,2024-01-23,6210
1440,南紡,10,0,10,新百王,2024-01-23,6210
3296,勝德,16,6,10,新百王,2024-01-23,6210
9924,福興,9,0,9,新百王,2024-01-23,6210
00687B,國泰20年美債,118,0,118,新百王,2024-01-24,6210
00937B,群益ESG投等債20,85,0,85,新百王,2024-01-24,6210
3481,群創,92,19,73,新百王,2024-01-24,6210
4904,遠傳,83,17,66,新百王,2024-01-24,6210
00795B,中信美國公債20年,62,0,62,新百王,2024-01-24,6210
6147,頎邦,65,3,62,新百王,2024-01-24,6210
2369,菱生,202,147,55,新百王,2024-01-24,6210
00632R,元大台灣50反1,111,60,51,新百王,2024-01-24,6210
00753L,中信中國50正2,70,20,50,新百王,2024-01-24,6210
6274,台燿,51,1,50,新百王,2024-01-24,6210
00680L,元大美債20正2,53,5,48,新百王,2024-01-24,6210
2891,中信金,57,10,47,新百王,2024-01-24,6210
00637L,元大滬深300正2,262,216,46,新百王,2024-01-24,6210
2884,玉山金,41,0,41,新百王,2024-01-24,6210
5234,達興材料,48,13,35,新百王,2024-01-24,6210
2409,友達,40,6,34,新百王,2024-01-24,6210
3005,神基,55,21,34,新百王,2024-01-24,6210
2371,大同,33,5,28,新百王,2024-01-24,6210
3055,蔚華科,77,52,25,新百王,2024-01-24,6210
00665L,富邦�琤肭磪囓�2,29,4,25,新百王,2024-01-24,6210
5521,工信,30,5,25,新百王,2024-01-24,6210
00650L,復華香港正2,24,0,24,新百王,2024-01-24,6210
8105,凌巨,36,13,23,新百王,2024-01-24,6210
6237,驊訊,82,61,21,新百王,2024-01-24,6210
1326,台化,21,0,21,新百王,2024-01-24,6210
1731,美吾華,20,0,20,新百王,2024-01-24,6210
5498,凱崴,25,5,20,新百王,2024-01-24,6210
2302,麗正,20,0,20,新百王,2024-01-24,6210
00929,復華台灣科技優息,81,64,17,新百王,2024-01-24,6210
00888,永豐台灣ESG,20,3,17,新百王,2024-01-24,6210
3032,偉訓,24,8,16,新百王,2024-01-24,6210
2374,佳能,20,4,16,新百王,2024-01-24,6210
3615,安可,38,22,16,新百王,2024-01-24,6210
00904,新光臺灣半導體30,16,2,14,新百王,2024-01-24,6210
6233,旺玖,38,25,13,新百王,2024-01-24,6210
2328,廣宇,13,0,13,新百王,2024-01-24,6210
2515,中工,13,0,13,新百王,2024-01-24,6210
1609,大亞,13,0,13,新百王,2024-01-24,6210
6799,來頡,28,16,12,新百王,2024-01-24,6210
8089,康全電訊,31,19,12,新百王,2024-01-24,6210
2890,永豐金,17,5,12,新百王,2024-01-24,6210
8034,榮群,42,30,12,新百王,2024-01-24,6210
00655L,國泰中國A50正2,12,0,12,新百王,2024-01-24,6210
3712,永崴投控,17,5,12,新百王,2024-01-24,6210
00907,永豐優息存股,10,0,10,新百王,2024-01-24,6210
3545,敦泰,34,24,10,新百王,2024-01-24,6210
3059,華晶科,11,1,10,新百王,2024-01-24,6210
1615,大山,10,0,10,新百王,2024-01-24,6210
6114,久威,10,0,10,新百王,2024-01-24,6210
00679B,元大美債20年,10,0,10,新百王,2024-01-24,6210
00712,復華富時不動產,154,2,152,新百王,2024-01-25,6210
5426,振發,167,77,90,新百王,2024-01-25,6210
00679B,元大美債20年,74,0,74,新百王,2024-01-25,6210
00688L,國泰20年美債正2,65,0,65,新百王,2024-01-25,6210
2890,永豐金,200,142,58,新百王,2024-01-25,6210
3483,力致,70,12,58,新百王,2024-01-25,6210
6274,台燿,56,5,51,新百王,2024-01-25,6210
6285,啟��,81,30,51,新百王,2024-01-25,6210
4909,新復興,145,106,39,新百王,2024-01-25,6210
00937B,群益ESG投等債20,38,4,34,新百王,2024-01-25,6210
2358,廷鑫,40,10,30,新百王,2024-01-25,6210
6113,亞矽,59,30,29,新百王,2024-01-25,6210
6167,久正,35,9,26,新百王,2024-01-25,6210
2104,國際中橡,22,0,22,新百王,2024-01-25,6210
00923,群益台ESG低碳50,30,8,22,新百王,2024-01-25,6210
2618,長榮航,32,10,22,新百王,2024-01-25,6210
8096,擎亞,206,184,22,新百王,2024-01-25,6210
1217,愛之味,20,0,20,新百王,2024-01-25,6210
00687B,國泰20年美債,76,57,19,新百王,2024-01-25,6210
9105,泰金寶-DR,50,31,19,新百王,2024-01-25,6210
4939,亞電,18,0,18,新百王,2024-01-25,6210
3531,先益,18,0,18,新百王,2024-01-25,6210
2515,中工,19,1,18,新百王,2024-01-25,6210
00720B,元大投資級公司債,17,0,17,新百王,2024-01-25,6210
2369,菱生,25,8,17,新百王,2024-01-25,6210
1808,潤隆,16,0,16,新百王,2024-01-25,6210
8047,星雲,15,0,15,新百王,2024-01-25,6210
8930,青鋼,16,1,15,新百王,2024-01-25,6210
2609,陽明,123,109,14,新百王,2024-01-25,6210
2486,一詮,22,9,13,新百王,2024-01-25,6210
2489,瑞軒,13,0,13,新百王,2024-01-25,6210
00919,群益台灣精選高息,22,9,13,新百王,2024-01-25,6210
4915,致伸,14,2,12,新百王,2024-01-25,6210
2527,宏璟,12,0,12,新百王,2024-01-25,6210
2812,台中銀,12,0,12,新百王,2024-01-25,6210
2356,英業達,147,135,12,新百王,2024-01-25,6210
00929,復華台灣科技優息,33,21,12,新百王,2024-01-25,6210
8086,宏捷科,17,6,11,新百王,2024-01-25,6210
6593,台灣銘板,15,4,11,新百王,2024-01-25,6210
6126,信音,10,0,10,新百王,2024-01-25,6210
2905,三商,10,0,10,新百王,2024-01-25,6210
4123,晟德,15,5,10,新百王,2024-01-25,6210
3691,碩禾,10,0,10,新百王,2024-01-25,6210
00857B,永豐20年美公債,10,0,10,新百王,2024-01-25,6210
2359,所羅門,10,0,10,新百王,2024-01-25,6210
4973,廣穎,10,0,10,新百王,2024-01-25,6210
3231,緯創,127,117,10,新百王,2024-01-25,6210
3504,揚明光,9,0,9,新百王,2024-01-25,6210
2344,華邦電,19,10,9,新百王,2024-01-25,6210
3580,友威科,23,14,9,新百王,2024-01-25,6210
2303,聯電,128,15,113,新百王,2024-01-26,6210
1314,中石化,100,0,100,新百王,2024-01-26,6210
00919,群益台灣精選高息,134,39,95,新百王,2024-01-26,6210
2313,華通,124,33,91,新百王,2024-01-26,6210
00878,國泰永續高股息,101,15,86,新百王,2024-01-26,6210
2892,第一金,73,10,63,新百王,2024-01-26,6210
2412,中華電,62,2,60,新百王,2024-01-26,6210
00929,復華台灣科技優息,135,80,55,新百王,2024-01-26,6210
2353,宏��,72,21,51,新百王,2024-01-26,6210
00937B,群益ESG投等債20,49,0,49,新百王,2024-01-26,6210
00632R,元大台灣50反1,105,60,45,新百王,2024-01-26,6210
00753L,中信中國50正2,65,21,44,新百王,2024-01-26,6210
00795B,中信美國公債20年,100,62,38,新百王,2024-01-26,6210
0056,元大高股息,37,2,35,新百王,2024-01-26,6210
2887,台新金,42,10,32,新百王,2024-01-26,6210
5483,中美晶,34,3,31,新百王,2024-01-26,6210
8110,華東,49,18,31,新百王,2024-01-26,6210
00655L,國泰中國A50正2,31,0,31,新百王,2024-01-26,6210
00665L,富邦�琤肭磪囓�2,30,0,30,新百王,2024-01-26,6210
00680L,元大美債20正2,26,0,26,新百王,2024-01-26,6210
3652,精聯,25,0,25,新百王,2024-01-26,6210
00637L,元大滬深300正2,53,30,23,新百王,2024-01-26,6210
2618,長榮航,35,12,23,新百王,2024-01-26,6210
2836,高雄銀,32,10,22,新百王,2024-01-26,6210
00757,統一FANG+,20,0,20,新百王,2024-01-26,6210
3694,海華,107,88,19,新百王,2024-01-26,6210
6239,力成,43,24,19,新百王,2024-01-26,6210
00687B,國泰20年美債,21,3,18,新百王,2024-01-26,6210
2851,中再保,21,3,18,新百王,2024-01-26,6210
3535,晶彩科,63,46,17,新百王,2024-01-26,6210
2401,凌陽,15,1,14,新百王,2024-01-26,6210
1319,東陽,36,23,13,新百王,2024-01-26,6210
5521,工信,37,24,13,新百王,2024-01-26,6210
3231,緯創,59,47,12,新百王,2024-01-26,6210
2369,菱生,17,5,12,新百王,2024-01-26,6210
6265,方土昶,55,43,12,新百王,2024-01-26,6210
00930,永豐ESG低碳高息,11,0,11,新百王,2024-01-26,6210
00712,復華富時不動產,16,5,11,新百王,2024-01-26,6210
2486,一詮,16,5,11,新百王,2024-01-26,6210
1609,大亞,11,0,11,新百王,2024-01-26,6210
00679B,元大美債20年,12,1,11,新百王,2024-01-26,6210
00673R,期元大S＆P原油反1,14,3,11,新百王,2024-01-26,6210
00733,富邦臺灣中小,10,0,10,新百王,2024-01-26,6210
3034,聯詠,10,0,10,新百王,2024-01-26,6210
8240,華宏,10,0,10,新百王,2024-01-26,6210
3296,勝德,16,6,10,新百王,2024-01-26,6210
2408,南亞科,12,2,10,新百王,2024-01-26,6210
00885,富邦越南,10,0,10,新百王,2024-01-26,6210
6235,華孚,23,13,10,新百王,2024-01-26,6210
2010,春源,10,0,10,新百王,2024-01-26,6210
2883,凱基金,500,1,499,新百王,2024-01-29,6210
6405,悅城,497,194,303,新百王,2024-01-29,6210
00687B,國泰20年美債,275,3,272,新百王,2024-01-29,6210
00937B,群益ESG投等債20,232,0,232,新百王,2024-01-29,6210
2303,聯電,200,10,190,新百王,2024-01-29,6210
2836,高雄銀,98,18,80,新百王,2024-01-29,6210
8112,至上,73,5,68,新百王,2024-01-29,6210
8096,擎亞,112,57,55,新百王,2024-01-29,6210
00688L,國泰20年美債正2,50,0,50,新百王,2024-01-29,6210
00632R,元大台灣50反1,95,45,50,新百王,2024-01-29,6210
00680L,元大美債20正2,34,0,34,新百王,2024-01-29,6210
00891,中信關鍵半導體,25,0,25,新百王,2024-01-29,6210
2610,華航,24,0,24,新百王,2024-01-29,6210
00665L,富邦�琤肭磪囓�2,25,2,23,新百王,2024-01-29,6210
6116,彩晶,27,5,22,新百王,2024-01-29,6210
00931B,統一美債20年,20,0,20,新百王,2024-01-29,6210
00885,富邦越南,20,0,20,新百王,2024-01-29,6210
1806,冠軍,20,0,20,新百王,2024-01-29,6210
2421,建準,135,117,18,新百王,2024-01-29,6210
3036,文曄,33,15,18,新百王,2024-01-29,6210
2442,新美齊,16,0,16,新百王,2024-01-29,6210
4909,新復興,18,3,15,新百王,2024-01-29,6210
8064,東捷,71,56,15,新百王,2024-01-29,6210
2356,英業達,80,66,14,新百王,2024-01-29,6210
8034,榮群,16,2,14,新百王,2024-01-29,6210
00673R,期元大S＆P原油反1,13,0,13,新百王,2024-01-29,6210
2603,長榮,19,6,13,新百王,2024-01-29,6210
2352,佳世達,24,12,12,新百王,2024-01-29,6210
6505,台塑化,12,0,12,新百王,2024-01-29,6210
00852L,國泰美國道瓊正2,11,0,11,新百王,2024-01-29,6210
3232,昱捷,14,3,11,新百王,2024-01-29,6210
2020,美亞,11,0,11,新百王,2024-01-29,6210
3623,富晶通,35,25,10,新百王,2024-01-29,6210
5512,力麒,10,0,10,新百王,2024-01-29,6210
5315,光聯,10,0,10,新百王,2024-01-29,6210
2520,冠德,10,0,10,新百王,2024-01-29,6210
2301,光寶科,24,14,10,新百王,2024-01-29,6210
1608,華榮,10,0,10,新百王,2024-01-29,6210
2331,精英,10,0,10,新百王,2024-01-29,6210
2801,彰銀,10,0,10,新百王,2024-01-29,6210
3033,威健,10,0,10,新百王,2024-01-29,6210
8047,星雲,10,0,10,新百王,2024-01-29,6210
4904,遠傳,9,0,9,新百王,2024-01-29,6210
0050,元大台灣50,10,1,9,新百王,2024-01-29,6210
3481,群創,9,0,9,新百王,2024-01-29,6210
00679B,元大美債20年,10,2,8,新百王,2024-01-29,6210
00918,大華優利高填息30,8,0,8,新百王,2024-01-29,6210
2344,華邦電,15,7,8,新百王,2024-01-29,6210
6023,元大期,10,3,7,新百王,2024-01-29,6210
3576,聯合再生,7,0,7,新百王,2024-01-29,6210
00637L,元大滬深300正2,325,87,238,新百王,2024-01-30,6210
00680L,元大美債20正2,227,63,164,新百王,2024-01-30,6210
00687B,國泰20年美債,123,7,116,新百王,2024-01-30,6210
5876,上海商銀,111,2,109,新百王,2024-01-30,6210
2412,中華電,59,0,59,新百王,2024-01-30,6210
00688L,國泰20年美債正2,100,43,57,新百王,2024-01-30,6210
00891,中信關鍵半導體,52,0,52,新百王,2024-01-30,6210
2867,三商壽,51,0,51,新百王,2024-01-30,6210
6285,啟��,52,1,51,新百王,2024-01-30,6210
2851,中再保,49,6,43,新百王,2024-01-30,6210
00753L,中信中國50正2,90,50,40,新百王,2024-01-30,6210
2421,建準,89,50,39,新百王,2024-01-30,6210
2511,太子,35,0,35,新百王,2024-01-30,6210
00712,復華富時不動產,35,0,35,新百王,2024-01-30,6210
3481,群創,39,6,33,新百王,2024-01-30,6210
2816,旺旺保,30,0,30,新百王,2024-01-30,6210
5469,瀚宇博,33,4,29,新百王,2024-01-30,6210
00665L,富邦�琤肭磪囓�2,27,0,27,新百王,2024-01-30,6210
3715,定穎投控,100,73,27,新百王,2024-01-30,6210
00937B,群益ESG投等債20,43,16,27,新百王,2024-01-30,6210
2883,凱基金,27,1,26,新百王,2024-01-30,6210
1808,潤隆,22,0,22,新百王,2024-01-30,6210
5512,力麒,21,0,21,新百王,2024-01-30,6210
2308,台達電,20,0,20,新百王,2024-01-30,6210
00929,復華台灣科技優息,29,9,20,新百王,2024-01-30,6210
4960,誠美材,36,16,20,新百王,2024-01-30,6210
5484,慧友,20,0,20,新百王,2024-01-30,6210
9105,泰金寶-DR,19,0,19,新百王,2024-01-30,6210
3231,緯創,80,61,19,新百王,2024-01-30,6210
3576,聯合再生,18,0,18,新百王,2024-01-30,6210
1503,士電,24,6,18,新百王,2024-01-30,6210
6282,康舒,27,9,18,新百王,2024-01-30,6210
2457,飛宏,17,0,17,新百王,2024-01-30,6210
00720B,元大投資級公司債,22,6,16,新百王,2024-01-30,6210
00679B,元大美債20年,20,5,15,新百王,2024-01-30,6210
6140,訊達,23,9,14,新百王,2024-01-30,6210
2542,興富發,14,0,14,新百王,2024-01-30,6210
8050,廣積,13,0,13,新百王,2024-01-30,6210
1514,亞力,37,24,13,新百王,2024-01-30,6210
5223,安力-KY,33,21,12,新百王,2024-01-30,6210
2344,華邦電,16,4,12,新百王,2024-01-30,6210
3036,文曄,32,20,12,新百王,2024-01-30,6210
4128,中天,11,0,11,新百王,2024-01-30,6210
2915,潤泰全,12,1,11,新百王,2024-01-30,6210
5347,世界,10,0,10,新百王,2024-01-30,6210
2607,榮運,10,0,10,新百王,2024-01-30,6210
2506,太設,20,10,10,新百王,2024-01-30,6210
2358,廷鑫,10,0,10,新百王,2024-01-30,6210
1446,宏和,10,0,10,新百王,2024-01-30,6210
1440,南紡,10,0,10,新百王,2024-01-30,6210
00688L,國泰20年美債正2,512,204,308,新百王,2024-01-31,6210
00929,復華台灣科技優息,217,26,191,新百王,2024-01-31,6210
00680L,元大美債20正2,179,15,164,新百王,2024-01-31,6210
00665L,富邦�琤肭磪囓�2,210,80,130,新百王,2024-01-31,6210
00753L,中信中國50正2,65,5,60,新百王,2024-01-31,6210
1713,國化,58,6,52,新百王,2024-01-31,6210
2303,聯電,53,2,51,新百王,2024-01-31,6210
00751B,元大AAA至A公司債,47,2,45,新百王,2024-01-31,6210
9927,泰銘,43,0,43,新百王,2024-01-31,6210
3622,洋華,63,23,40,新百王,2024-01-31,6210
6237,驊訊,89,52,37,新百王,2024-01-31,6210
2442,新美齊,36,0,36,新百王,2024-01-31,6210
6113,亞矽,127,92,35,新百王,2024-01-31,6210
3354,律勝,40,8,32,新百王,2024-01-31,6210
2390,云辰,32,1,31,新百王,2024-01-31,6210
00937B,群益ESG投等債20,42,13,29,新百王,2024-01-31,6210
3607,谷崧,26,0,26,新百王,2024-01-31,6210
00878,國泰永續高股息,31,6,25,新百王,2024-01-31,6210
6179,亞通,31,6,25,新百王,2024-01-31,6210
00720B,元大投資級公司債,25,4,21,新百王,2024-01-31,6210
00882,中信中國高股息,20,0,20,新百王,2024-01-31,6210
0056,元大高股息,22,2,20,新百王,2024-01-31,6210
00933B,國泰10Y+金融債,20,0,20,新百王,2024-01-31,6210
3058,立德,20,0,20,新百王,2024-01-31,6210
2356,英業達,79,60,19,新百王,2024-01-31,6210
3231,緯創,70,51,19,新百王,2024-01-31,6210
00679B,元大美債20年,34,16,18,新百王,2024-01-31,6210
2330,台積電,75,57,18,新百王,2024-01-31,6210
4915,致伸,18,0,18,新百王,2024-01-31,6210
00915,凱基優選高股息30,18,0,18,新百王,2024-01-31,6210
3535,晶彩科,33,15,18,新百王,2024-01-31,6210
2609,陽明,37,20,17,新百王,2024-01-31,6210
2484,希華,15,0,15,新百王,2024-01-31,6210
8047,星雲,15,0,15,新百王,2024-01-31,6210
1570,力肯,14,0,14,新百王,2024-01-31,6210
2369,菱生,66,52,14,新百王,2024-01-31,6210
2104,國際中橡,35,22,13,新百王,2024-01-31,6210
2308,台達電,12,0,12,新百王,2024-01-31,6210
00757,統一FANG+,12,0,12,新百王,2024-01-31,6210
00712,復華富時不動產,21,10,11,新百王,2024-01-31,6210
2465,麗臺,17,6,11,新百王,2024-01-31,6210
3360,尚立,41,30,11,新百王,2024-01-31,6210
4714,永捷,18,8,10,新百王,2024-01-31,6210
00852L,國泰美國道瓊正2,10,0,10,新百王,2024-01-31,6210
00650L,復華香港正2,10,0,10,新百王,2024-01-31,6210
6198,瑞築,10,0,10,新百王,2024-01-31,6210
00676R,富邦臺灣加權反1,10,0,10,新百王,2024-01-31,6210
6785,昱展新藥,10,0,10,新百王,2024-01-31,6210
6114,久威,10,0,10,新百王,2024-01-31,6210
2358,廷鑫,10,0,10,新百王,2024-01-31,6210
00929,復華台灣科技優息,289,15,274,新百王,2024-02-01,6210
00795B,中信美國公債20年,181,14,167,新百王,2024-02-01,6210
00712,復華富時不動產,242,150,92,新百王,2024-02-01,6210
2537,聯上發,70,2,68,新百王,2024-02-01,6210
2812,台中銀,280,219,61,新百王,2024-02-01,6210
6116,彩晶,78,20,58,新百王,2024-02-01,6210
3294,英濟,57,3,54,新百王,2024-02-01,6210
00878,國泰永續高股息,62,12,50,新百王,2024-02-01,6210
2313,華通,64,14,50,新百王,2024-02-01,6210
00680L,元大美債20正2,62,12,50,新百王,2024-02-01,6210
2421,建準,105,57,48,新百王,2024-02-01,6210
8011,台通,71,26,45,新百王,2024-02-01,6210
2890,永豐金,36,0,36,新百王,2024-02-01,6210
6127,九豪,35,0,35,新百王,2024-02-01,6210
00937B,群益ESG投等債20,36,5,31,新百王,2024-02-01,6210
2723,美食-KY,30,0,30,新百王,2024-02-01,6210
2104,國際中橡,25,0,25,新百王,2024-02-01,6210
6237,驊訊,51,29,22,新百王,2024-02-01,6210
3313,斐成,21,0,21,新百王,2024-02-01,6210
6530,創威,38,17,21,新百王,2024-02-01,6210
2369,菱生,22,2,20,新百王,2024-02-01,6210
8936,國統,144,124,20,新百王,2024-02-01,6210
5251,天鉞電,38,18,20,新百王,2024-02-01,6210
3530,晶相光,29,10,19,新百王,2024-02-01,6210
2303,聯電,41,22,19,新百王,2024-02-01,6210
3035,智原,29,11,18,新百王,2024-02-01,6210
00882,中信中國高股息,22,4,18,新百王,2024-02-01,6210
3483,力致,18,2,16,新百王,2024-02-01,6210
6785,昱展新藥,16,1,15,新百王,2024-02-01,6210
3715,定穎投控,28,14,14,新百王,2024-02-01,6210
00715L,期街口布蘭特正2,13,0,13,新百王,2024-02-01,6210
00753L,中信中國50正2,140,127,13,新百王,2024-02-01,6210
6284,佳邦,16,3,13,新百王,2024-02-01,6210
4303,信立,15,2,13,新百王,2024-02-01,6210
1733,五鼎,12,0,12,新百王,2024-02-01,6210
3029,零壹,13,1,12,新百王,2024-02-01,6210
5512,力麒,22,10,12,新百王,2024-02-01,6210
3607,谷崧,18,6,12,新百王,2024-02-01,6210
3297,杭特,25,13,12,新百王,2024-02-01,6210
3055,蔚華科,56,44,12,新百王,2024-02-01,6210
3041,揚智,40,28,12,新百王,2024-02-01,6210
6243,迅杰,80,69,11,新百王,2024-02-01,6210
5009,榮剛,10,0,10,新百王,2024-02-01,6210
6488,環球晶,10,0,10,新百王,2024-02-01,6210
2392,正崴,10,0,10,新百王,2024-02-01,6210
1531,高林股,10,0,10,新百王,2024-02-01,6210
3312,弘憶股,26,16,10,新百王,2024-02-01,6210
2358,廷鑫,10,0,10,新百王,2024-02-01,6210
3052,夆典,10,0,10,新百王,2024-02-01,6210
3105,穩懋,10,0,10,新百王,2024-02-01,6210
2537,聯上發,322,23,299,新百王,2024-02-02,6210
00933B,國泰10Y+金融債,199,8,191,新百王,2024-02-02,6210
00632R,元大台灣50反1,160,53,107,新百王,2024-02-02,6210
00637L,元大滬深300正2,293,191,102,新百王,2024-02-02,6210
00639,富邦深100,100,0,100,新百王,2024-02-02,6210
1528,恩德,116,26,90,新百王,2024-02-02,6210
00687B,國泰20年美債,143,55,88,新百王,2024-02-02,6210
4904,遠傳,83,4,79,新百王,2024-02-02,6210
2515,中工,84,8,76,新百王,2024-02-02,6210
00715L,期街口布蘭特正2,69,0,69,新百王,2024-02-02,6210
5243,乙盛-KY,63,0,63,新百王,2024-02-02,6210
2618,長榮航,73,10,63,新百王,2024-02-02,6210
2603,長榮,76,18,58,新百王,2024-02-02,6210
00929,復華台灣科技優息,113,55,58,新百王,2024-02-02,6210
2329,華泰,75,25,50,新百王,2024-02-02,6210
3050,鈺德,53,7,46,新百王,2024-02-02,6210
2816,旺旺保,42,0,42,新百王,2024-02-02,6210
5483,中美晶,40,0,40,新百王,2024-02-02,6210
6189,豐藝,34,0,34,新百王,2024-02-02,6210
1514,亞力,44,11,33,新百王,2024-02-02,6210
00918,大華優利高填息30,31,0,31,新百王,2024-02-02,6210
2104,國際中橡,30,0,30,新百王,2024-02-02,6210
6116,彩晶,80,50,30,新百王,2024-02-02,6210
2891,中信金,29,0,29,新百王,2024-02-02,6210
3055,蔚華科,53,25,28,新百王,2024-02-02,6210
2369,菱生,33,5,28,新百王,2024-02-02,6210
2313,華通,42,16,26,新百王,2024-02-02,6210
2007,燁興,25,0,25,新百王,2024-02-02,6210
1713,國化,24,0,24,新百王,2024-02-02,6210
1217,愛之味,24,0,24,新百王,2024-02-02,6210
2376,技嘉,62,38,24,新百王,2024-02-02,6210
2812,台中銀,21,0,21,新百王,2024-02-02,6210
2356,英業達,41,20,21,新百王,2024-02-02,6210
9924,福興,21,1,20,新百王,2024-02-02,6210
00690,兆豐藍籌30,17,0,17,新百王,2024-02-02,6210
6285,啟��,63,46,17,新百王,2024-02-02,6210
2353,宏��,28,12,16,新百王,2024-02-02,6210
6156,松上,21,5,16,新百王,2024-02-02,6210
8011,台通,19,4,15,新百王,2024-02-02,6210
00891,中信關鍵半導體,16,1,15,新百王,2024-02-02,6210
3167,大量,15,0,15,新百王,2024-02-02,6210
3615,安可,68,53,15,新百王,2024-02-02,6210
00633L,富邦上証正2,14,0,14,新百王,2024-02-02,6210
3041,揚智,39,25,14,新百王,2024-02-02,6210
006208,富邦台50,13,0,13,新百王,2024-02-02,6210
2915,潤泰全,18,5,13,新百王,2024-02-02,6210
4729,熒茂,17,4,13,新百王,2024-02-02,6210
2484,希華,12,0,12,新百王,2024-02-02,6210
00665L,富邦�琤肭磪囓�2,12,0,12,新百王,2024-02-02,6210
4958,臻鼎-KY,11,0,11,新百王,2024-02-02,6210
00650L,復華香港正2,1170,0,1170,新百王,2024-02-05,6210
00688L,國泰20年美債正2,169,0,169,新百王,2024-02-05,6210
00680L,元大美債20正2,211,70,141,新百王,2024-02-05,6210
00639,富邦深100,100,0,100,新百王,2024-02-05,6210
2890,永豐金,210,111,99,新百王,2024-02-05,6210
1609,大亞,101,6,95,新百王,2024-02-05,6210
1217,愛之味,90,0,90,新百王,2024-02-05,6210
00933B,國泰10Y+金融債,69,0,69,新百王,2024-02-05,6210
00715L,期街口布蘭特正2,71,2,69,新百王,2024-02-05,6210
5426,振發,89,24,65,新百王,2024-02-05,6210
3483,力致,84,25,59,新百王,2024-02-05,6210
00929,復華台灣科技優息,68,13,55,新百王,2024-02-05,6210
2609,陽明,78,31,47,新百王,2024-02-05,6210
2851,中再保,45,1,44,新百王,2024-02-05,6210
4904,遠傳,45,3,42,新百王,2024-02-05,6210
00878,國泰永續高股息,65,24,41,新百王,2024-02-05,6210
2211,長榮鋼,40,0,40,新百王,2024-02-05,6210
00706L,期元大S＆P日圓正2,36,0,36,新百王,2024-02-05,6210
1713,國化,35,0,35,新百王,2024-02-05,6210
6285,啟��,91,61,30,新百王,2024-02-05,6210
1540,喬福,30,0,30,新百王,2024-02-05,6210
2405,輔信,30,0,30,新百王,2024-02-05,6210
1806,冠軍,30,1,29,新百王,2024-02-05,6210
00937B,群益ESG投等債20,116,88,28,新百王,2024-02-05,6210
00913,兆豐台灣晶圓製造,27,0,27,新百王,2024-02-05,6210
00712,復華富時不動產,52,25,27,新百王,2024-02-05,6210
2367,燿華,50,25,25,新百王,2024-02-05,6210
2352,佳世達,26,3,23,新百王,2024-02-05,6210
6265,方土昶,33,10,23,新百王,2024-02-05,6210
00632R,元大台灣50反1,170,149,21,新百王,2024-02-05,6210
00679B,元大美債20年,48,28,20,新百王,2024-02-05,6210
1531,高林股,35,15,20,新百王,2024-02-05,6210
00753L,中信中國50正2,60,40,20,新百王,2024-02-05,6210
00864B,中信美國公債0-1,20,0,20,新百王,2024-02-05,6210
00665L,富邦�琤肭磪囓�2,20,0,20,新百王,2024-02-05,6210
00764B,群益25年美債,19,0,19,新百王,2024-02-05,6210
4916,事欣科,18,0,18,新百王,2024-02-05,6210
00882,中信中國高股息,64,46,18,新百王,2024-02-05,6210
2812,台中銀,17,0,17,新百王,2024-02-05,6210
5284,jpp-KY,39,23,16,新百王,2024-02-05,6210
3055,蔚華科,44,28,16,新百王,2024-02-05,6210
2104,國際中橡,18,3,15,新百王,2024-02-05,6210
00852L,國泰美國道瓊正2,15,0,15,新百王,2024-02-05,6210
6219,富旺,15,0,15,新百王,2024-02-05,6210
2537,聯上發,15,0,15,新百王,2024-02-05,6210
6684,安格,20,6,14,新百王,2024-02-05,6210
2358,廷鑫,35,21,14,新百王,2024-02-05,6210
6789,采鈺,15,1,14,新百王,2024-02-05,6210
6695,芯鼎,59,45,14,新百王,2024-02-05,6210
6111,大宇資,13,0,13,新百王,2024-02-05,6210
00680L,元大美債20正2,508,23,485,新百王,2024-02-15,6210
2618,長榮航,287,15,272,新百王,2024-02-15,6210
00688L,國泰20年美債正2,220,0,220,新百王,2024-02-15,6210
00687B,國泰20年美債,260,43,217,新百王,2024-02-15,6210
00937B,群益ESG投等債20,213,3,210,新百王,2024-02-15,6210
00679B,元大美債20年,138,12,126,新百王,2024-02-15,6210
2408,南亞科,92,5,87,新百王,2024-02-15,6210
00751B,元大AAA至A公司債,77,0,77,新百王,2024-02-15,6210
00712,復華富時不動產,106,34,72,新百王,2024-02-15,6210
00706L,期元大S＆P日圓正2,65,0,65,新百王,2024-02-15,6210
2412,中華電,72,10,62,新百王,2024-02-15,6210
00676R,富邦臺灣加權反1,60,0,60,新百王,2024-02-15,6210
2344,華邦電,57,2,55,新百王,2024-02-15,6210
00933B,國泰10Y+金融債,59,5,54,新百王,2024-02-15,6210
5426,振發,76,28,48,新百王,2024-02-15,6210
2101,南港,48,0,48,新百王,2024-02-15,6210
8996,高力,49,4,45,新百王,2024-02-15,6210
00772B,中信高評級公司債,40,0,40,新百王,2024-02-15,6210
00795B,中信美國公債20年,39,0,39,新百王,2024-02-15,6210
3481,群創,409,371,38,新百王,2024-02-15,6210
1325,恆大,37,0,37,新百王,2024-02-15,6210
6265,方土昶,41,5,36,新百王,2024-02-15,6210
6757,台灣虎航,35,0,35,新百王,2024-02-15,6210
6465,威潤,33,1,32,新百王,2024-02-15,6210
1809,中釉,46,16,30,新百王,2024-02-15,6210
1806,冠軍,30,0,30,新百王,2024-02-15,6210
00931B,統一美債20年,29,0,29,新百王,2024-02-15,6210
00919,群益台灣精選高息,38,9,29,新百王,2024-02-15,6210
8064,東捷,37,9,28,新百王,2024-02-15,6210
3483,力致,40,14,26,新百王,2024-02-15,6210
1808,潤隆,25,0,25,新百王,2024-02-15,6210
6416,瑞祺電通,60,36,24,新百王,2024-02-15,6210
2421,建準,39,15,24,新百王,2024-02-15,6210
3715,定穎投控,25,2,23,新百王,2024-02-15,6210
00891,中信關鍵半導體,60,38,22,新百王,2024-02-15,6210
3360,尚立,20,0,20,新百王,2024-02-15,6210
00694B,富邦美債1-3,19,0,19,新百王,2024-02-15,6210
00673R,期元大S＆P原油反1,19,0,19,新百王,2024-02-15,6210
00725B,國泰投資級公司債,18,0,18,新百王,2024-02-15,6210
2316,楠梓電,18,0,18,新百王,2024-02-15,6210
6530,創威,23,6,17,新百王,2024-02-15,6210
6425,易發,30,14,16,新百王,2024-02-15,6210
2301,光寶科,21,5,16,新百王,2024-02-15,6210
2603,長榮,23,7,16,新百王,2024-02-15,6210
00719B,元大美債1-3,16,0,16,新百王,2024-02-15,6210
2851,中再保,21,5,16,新百王,2024-02-15,6210
4968,立積,19,4,15,新百王,2024-02-15,6210
2610,華航,20,5,15,新百王,2024-02-15,6210
6246,臺龍,17,2,15,新百王,2024-02-15,6210
8054,安國,75,60,15,新百王,2024-02-15,6210
00687B,國泰20年美債,1259,5,1254,新百王,2024-02-16,6210
00688L,國泰20年美債正2,195,0,195,新百王,2024-02-16,6210
00933B,國泰10Y+金融債,166,0,166,新百王,2024-02-16,6210
00795B,中信美國公債20年,140,0,140,新百王,2024-02-16,6210
2515,中工,138,6,132,新百王,2024-02-16,6210
00878,國泰永續高股息,132,19,113,新百王,2024-02-16,6210
1216,統一,106,0,106,新百王,2024-02-16,6210
00673R,期元大S＆P原油反1,60,0,60,新百王,2024-02-16,6210
2897,王道銀行,60,0,60,新百王,2024-02-16,6210
2412,中華電,63,10,53,新百王,2024-02-16,6210
6139,亞翔,95,43,52,新百王,2024-02-16,6210
5521,工信,206,160,46,新百王,2024-02-16,6210
00712,復華富時不動產,45,0,45,新百王,2024-02-16,6210
6179,亞通,40,1,39,新百王,2024-02-16,6210
2812,台中銀,38,0,38,新百王,2024-02-16,6210
8933,愛地雅,36,0,36,新百王,2024-02-16,6210
3036,文曄,48,12,36,新百王,2024-02-16,6210
00669R,國泰美國道瓊反1,35,0,35,新百王,2024-02-16,6210
00694B,富邦美債1-3,36,1,35,新百王,2024-02-16,6210
00918,大華優利高填息30,30,0,30,新百王,2024-02-16,6210
2312,金寶,30,0,30,新百王,2024-02-16,6210
2527,宏璟,32,2,30,新百王,2024-02-16,6210
4417,金洲,29,0,29,新百王,2024-02-16,6210
6282,康舒,36,8,28,新百王,2024-02-16,6210
2884,玉山金,25,0,25,新百王,2024-02-16,6210
00751B,元大AAA至A公司債,26,2,24,新百王,2024-02-16,6210
9105,泰金寶-DR,25,1,24,新百王,2024-02-16,6210
2887,台新金,25,1,24,新百王,2024-02-16,6210
1101,台泥,22,0,22,新百王,2024-02-16,6210
6667,信紘科,32,10,22,新百王,2024-02-16,6210
00913,兆豐台灣晶圓製造,21,0,21,新百王,2024-02-16,6210
00706L,期元大S＆P日圓正2,20,0,20,新百王,2024-02-16,6210
3057,喬鼎,20,0,20,新百王,2024-02-16,6210
1532,勤美,22,2,20,新百王,2024-02-16,6210
8047,星雲,19,0,19,新百王,2024-02-16,6210
6405,悅城,24,5,19,新百王,2024-02-16,6210
3363,上詮,33,15,18,新百王,2024-02-16,6210
00931B,統一美債20年,17,0,17,新百王,2024-02-16,6210
3622,洋華,20,3,17,新百王,2024-02-16,6210
6108,競國,16,0,16,新百王,2024-02-16,6210
1316,上曜,86,70,16,新百王,2024-02-16,6210
2303,聯電,16,1,15,新百王,2024-02-16,6210
2387,精元,24,9,15,新百王,2024-02-16,6210
4968,立積,24,11,13,新百王,2024-02-16,6210
3390,旭軟,15,2,13,新百王,2024-02-16,6210
5251,天鉞電,21,8,13,新百王,2024-02-16,6210
6164,華興,29,16,13,新百王,2024-02-16,6210
2852,第一保,18,5,13,新百王,2024-02-16,6210
2382,廣達,51,38,13,新百王,2024-02-16,6210
3483,力致,33,21,12,新百王,2024-02-16,6210
2867,三商壽,216,0,216,新百王,2024-02-19,6210
00650L,復華香港正2,220,10,210,新百王,2024-02-19,6210
00687B,國泰20年美債,184,15,169,新百王,2024-02-19,6210
00937B,群益ESG投等債20,228,75,153,新百王,2024-02-19,6210
00665L,富邦�琤肭磪囓�2,124,20,104,新百王,2024-02-19,6210
00918,大華優利高填息30,79,0,79,新百王,2024-02-19,6210
00637L,元大滬深300正2,116,49,67,新百王,2024-02-19,6210
3005,神基,71,5,66,新百王,2024-02-19,6210
2884,玉山金,65,0,65,新百王,2024-02-19,6210
3025,星通,84,20,64,新百王,2024-02-19,6210
00919,群益台灣精選高息,68,6,62,新百王,2024-02-19,6210
3483,力致,71,9,62,新百王,2024-02-19,6210
2353,宏��,90,29,61,新百王,2024-02-19,6210
00933B,國泰10Y+金融債,77,20,57,新百王,2024-02-19,6210
2457,飛宏,61,5,56,新百王,2024-02-19,6210
3706,神達,56,1,55,新百王,2024-02-19,6210
1513,中興電,102,50,52,新百王,2024-02-19,6210
2834,臺企銀,49,0,49,新百王,2024-02-19,6210
1785,光洋科,45,4,41,新百王,2024-02-19,6210
6120,達運,61,21,40,新百王,2024-02-19,6210
00795B,中信美國公債20年,33,0,33,新百王,2024-02-19,6210
5488,松普,38,5,33,新百王,2024-02-19,6210
2365,昆盈,89,58,31,新百王,2024-02-19,6210
00688L,國泰20年美債正2,41,10,31,新百王,2024-02-19,6210
6116,彩晶,30,0,30,新百王,2024-02-19,6210
1815,富喬,58,28,30,新百王,2024-02-19,6210
2481,強茂,31,2,29,新百王,2024-02-19,6210
1806,冠軍,31,3,28,新百王,2024-02-19,6210
9934,成霖,33,6,27,新百王,2024-02-19,6210
2329,華泰,129,103,26,新百王,2024-02-19,6210
4533,協易機,26,0,26,新百王,2024-02-19,6210
6288,聯嘉,29,3,26,新百王,2024-02-19,6210
8096,擎亞,196,171,25,新百王,2024-02-19,6210
00673R,期元大S＆P原油反1,25,0,25,新百王,2024-02-19,6210
5251,天鉞電,24,0,24,新百王,2024-02-19,6210
3354,律勝,33,9,24,新百王,2024-02-19,6210
5443,均豪,70,47,23,新百王,2024-02-19,6210
5202,力新,23,0,23,新百王,2024-02-19,6210
3038,全台,25,3,22,新百王,2024-02-19,6210
1514,亞力,55,34,21,新百王,2024-02-19,6210
3437,榮創,60,39,21,新百王,2024-02-19,6210
00864B,中信美國公債0-1,20,0,20,新百王,2024-02-19,6210
3052,夆典,21,1,20,新百王,2024-02-19,6210
2369,菱生,103,83,20,新百王,2024-02-19,6210
00712,復華富時不動產,20,1,19,新百王,2024-02-19,6210
2506,太設,21,2,19,新百王,2024-02-19,6210
9105,泰金寶-DR,19,0,19,新百王,2024-02-19,6210
00720B,元大投資級公司債,18,0,18,新百王,2024-02-19,6210
00878,國泰永續高股息,38,20,18,新百王,2024-02-19,6210
2356,英業達,117,100,17,新百王,2024-02-19,6210
00650L,復華香港正2,820,330,490,新百王,2024-02-20,6210
00795B,中信美國公債20年,144,0,144,新百王,2024-02-20,6210
00665L,富邦�琤肭磪囓�2,126,30,96,新百王,2024-02-20,6210
00679B,元大美債20年,91,0,91,新百王,2024-02-20,6210
00688L,國泰20年美債正2,198,118,80,新百王,2024-02-20,6210
00632R,元大台灣50反1,80,0,80,新百王,2024-02-20,6210
3706,神達,89,10,79,新百王,2024-02-20,6210
00687B,國泰20年美債,78,0,78,新百王,2024-02-20,6210
00929,復華台灣科技優息,128,56,72,新百王,2024-02-20,6210
3041,揚智,133,79,54,新百王,2024-02-20,6210
5521,工信,71,17,54,新百王,2024-02-20,6210
00673R,期元大S＆P原油反1,51,0,51,新百王,2024-02-20,6210
1316,上曜,82,34,48,新百王,2024-02-20,6210
1815,富喬,54,7,47,新百王,2024-02-20,6210
00772B,中信高評級公司債,41,0,41,新百王,2024-02-20,6210
5009,榮剛,40,0,40,新百王,2024-02-20,6210
2367,燿華,83,43,40,新百王,2024-02-20,6210
4714,永捷,181,149,32,新百王,2024-02-20,6210
2062,橋椿,35,3,32,新百王,2024-02-20,6210
8240,華宏,30,0,30,新百王,2024-02-20,6210
00751B,元大AAA至A公司債,30,0,30,新百王,2024-02-20,6210
00633L,富邦上証正2,33,3,30,新百王,2024-02-20,6210
00857B,永豐20年美公債,30,0,30,新百王,2024-02-20,6210
6282,康舒,48,18,30,新百王,2024-02-20,6210
2412,中華電,60,34,26,新百王,2024-02-20,6210
2618,長榮航,285,260,25,新百王,2024-02-20,6210
00919,群益台灣精選高息,40,17,23,新百王,2024-02-20,6210
2355,敬鵬,23,0,23,新百王,2024-02-20,6210
2723,美食-KY,23,1,22,新百王,2024-02-20,6210
2312,金寶,22,0,22,新百王,2024-02-20,6210
3504,揚明光,21,0,21,新百王,2024-02-20,6210
2891,中信金,22,1,21,新百王,2024-02-20,6210
3231,緯創,55,35,20,新百王,2024-02-20,6210
3492,長盛,20,0,20,新百王,2024-02-20,6210
1307,三芳,20,0,20,新百王,2024-02-20,6210
2489,瑞軒,32,13,19,新百王,2024-02-20,6210
6514,芮特-KY,19,0,19,新百王,2024-02-20,6210
3321,同泰,19,0,19,新百王,2024-02-20,6210
00706L,期元大S＆P日圓正2,18,0,18,新百王,2024-02-20,6210
2836,高雄銀,18,0,18,新百王,2024-02-20,6210
6585,鼎基,18,1,17,新百王,2024-02-20,6210
00712,復華富時不動產,17,1,16,新百王,2024-02-20,6210
4909,新復興,22,6,16,新百王,2024-02-20,6210
3630,新鉅科,16,0,16,新百王,2024-02-20,6210
2834,臺企銀,19,3,16,新百王,2024-02-20,6210
00891,中信關鍵半導體,39,24,15,新百王,2024-02-20,6210
6667,信紘科,35,20,15,新百王,2024-02-20,6210
00753L,中信中國50正2,20,5,15,新百王,2024-02-20,6210
2371,大同,17,3,14,新百王,2024-02-20,6210
6284,佳邦,19,5,14,新百王,2024-02-20,6210
00929,復華台灣科技優息,287,3,284,新百王,2024-02-21,6210
2618,長榮航,289,34,255,新百王,2024-02-21,6210
00795B,中信美國公債20年,285,75,210,新百王,2024-02-21,6210
00937B,群益ESG投等債20,102,0,102,新百王,2024-02-21,6210
8940,新天地,69,0,69,新百王,2024-02-21,6210
2412,中華電,78,10,68,新百王,2024-02-21,6210
00679B,元大美債20年,58,0,58,新百王,2024-02-21,6210
00712,復華富時不動產,48,0,48,新百王,2024-02-21,6210
2609,陽明,66,21,45,新百王,2024-02-21,6210
2405,輔信,52,10,42,新百王,2024-02-21,6210
2369,菱生,50,12,38,新百王,2024-02-21,6210
5381,合正,63,28,35,新百王,2024-02-21,6210
00933B,國泰10Y+金融債,43,8,35,新百王,2024-02-21,6210
5512,力麒,47,12,35,新百王,2024-02-21,6210
5521,工信,137,104,33,新百王,2024-02-21,6210
00878,國泰永續高股息,59,30,29,新百王,2024-02-21,6210
6233,旺玖,87,58,29,新百王,2024-02-21,6210
3231,緯創,59,31,28,新百王,2024-02-21,6210
5443,均豪,109,81,28,新百王,2024-02-21,6210
2382,廣達,70,43,27,新百王,2024-02-21,6210
2617,台航,32,5,27,新百王,2024-02-21,6210
3321,同泰,26,1,25,新百王,2024-02-21,6210
1570,力肯,24,0,24,新百王,2024-02-21,6210
00687B,國泰20年美債,24,0,24,新百王,2024-02-21,6210
2884,玉山金,22,0,22,新百王,2024-02-21,6210
4908,前鼎,50,30,20,新百王,2024-02-21,6210
020033,統一�琤肮黕篾,20,0,20,新百王,2024-02-21,6210
6227,茂綸,23,3,20,新百王,2024-02-21,6210
3312,弘憶股,24,5,19,新百王,2024-02-21,6210
6514,芮特-KY,19,0,19,新百王,2024-02-21,6210
2109,華豐,18,0,18,新百王,2024-02-21,6210
2834,臺企銀,16,0,16,新百王,2024-02-21,6210
4303,信立,16,0,16,新百王,2024-02-21,6210
6578,達邦蛋白,22,7,15,新百王,2024-02-21,6210
6505,台塑化,16,1,15,新百王,2024-02-21,6210
00915,凱基優選高股息30,15,0,15,新百王,2024-02-21,6210
6122,擎邦,17,2,15,新百王,2024-02-21,6210
3047,訊舟,36,21,15,新百王,2024-02-21,6210
3027,盛達,14,0,14,新百王,2024-02-21,6210
3055,蔚華科,48,34,14,新百王,2024-02-21,6210
6126,信音,46,32,14,新百王,2024-02-21,6210
6120,達運,14,1,13,新百王,2024-02-21,6210
2882,國泰金,12,0,12,新百王,2024-02-21,6210
2303,聯電,13,1,12,新百王,2024-02-21,6210
6274,台燿,14,2,12,新百王,2024-02-21,6210
00891,中信關鍵半導體,30,19,11,新百王,2024-02-21,6210
3483,力致,13,2,11,新百王,2024-02-21,6210
00904,新光臺灣半導體30,11,0,11,新百王,2024-02-21,6210
5515,建國,11,0,11,新百王,2024-02-21,6210
00770,國泰北美科技,11,0,11,新百王,2024-02-21,6210
2890,永豐金,1080,18,1062,新百王,2024-02-22,6210
2885,元大金,401,0,401,新百王,2024-02-22,6210
00933B,國泰10Y+金融債,171,0,171,新百王,2024-02-22,6210
2358,廷鑫,128,34,94,新百王,2024-02-22,6210
00680L,元大美債20正2,87,0,87,新百王,2024-02-22,6210
6179,亞通,80,0,80,新百王,2024-02-22,6210
3689,湧德,119,64,55,新百王,2024-02-22,6210
00937B,群益ESG投等債20,54,0,54,新百王,2024-02-22,6210
8926,台汽電,51,2,49,新百王,2024-02-22,6210
2618,長榮航,94,47,47,新百王,2024-02-22,6210
2884,玉山金,44,0,44,新百王,2024-02-22,6210
2421,建準,43,9,34,新百王,2024-02-22,6210
8930,青鋼,32,0,32,新百王,2024-02-22,6210
00753L,中信中國50正2,60,30,30,新百王,2024-02-22,6210
8996,高力,40,11,29,新百王,2024-02-22,6210
3231,緯創,92,64,28,新百王,2024-02-22,6210
5443,均豪,44,17,27,新百王,2024-02-22,6210
00712,復華富時不動產,27,0,27,新百王,2024-02-22,6210
4303,信立,47,20,27,新百王,2024-02-22,6210
2353,宏��,39,14,25,新百王,2024-02-22,6210
6153,嘉聯益,25,0,25,新百王,2024-02-22,6210
2329,華泰,213,192,21,新百王,2024-02-22,6210
8289,泰藝,30,9,21,新百王,2024-02-22,6210
2376,技嘉,26,7,19,新百王,2024-02-22,6210
2883,凱基金,37,18,19,新百王,2024-02-22,6210
6514,芮特-KY,19,0,19,新百王,2024-02-22,6210
2356,英業達,40,21,19,新百王,2024-02-22,6210
2609,陽明,43,26,17,新百王,2024-02-22,6210
6233,旺玖,62,45,17,新百王,2024-02-22,6210
1702,南僑,24,8,16,新百王,2024-02-22,6210
2303,聯電,160,145,15,新百王,2024-02-22,6210
00706L,期元大S＆P日圓正2,15,0,15,新百王,2024-02-22,6210
3481,群創,15,0,15,新百王,2024-02-22,6210
2412,中華電,21,6,15,新百王,2024-02-22,6210
5202,力新,16,2,14,新百王,2024-02-22,6210
2031,新光鋼,14,0,14,新百王,2024-02-22,6210
3323,加百裕,14,0,14,新百王,2024-02-22,6210
2485,兆赫,14,0,14,新百王,2024-02-22,6210
2368,金像電,23,9,14,新百王,2024-02-22,6210
3234,光環,13,0,13,新百王,2024-02-22,6210
3288,點晶,13,0,13,新百王,2024-02-22,6210
00688L,國泰20年美債正2,12,0,12,新百王,2024-02-22,6210
3363,上詮,42,30,12,新百王,2024-02-22,6210
2369,菱生,57,45,12,新百王,2024-02-22,6210
3027,盛達,22,10,12,新百王,2024-02-22,6210
2363,矽統,12,0,12,新百王,2024-02-22,6210
00632R,元大台灣50反1,142,130,12,新百王,2024-02-22,6210
8086,宏捷科,29,18,11,新百王,2024-02-22,6210
00772B,中信高評級公司債,10,0,10,新百王,2024-02-22,6210
2543,皇昌,28,18,10,新百王,2024-02-22,6210
00665L,富邦�琤肭磪囓�2,268,50,218,新百王,2024-02-23,6210
6695,芯鼎,160,2,158,新百王,2024-02-23,6210
4904,遠傳,100,5,95,新百王,2024-02-23,6210
6274,台燿,110,23,87,新百王,2024-02-23,6210
1605,華新,84,0,84,新百王,2024-02-23,6210
00933B,國泰10Y+金融債,82,0,82,新百王,2024-02-23,6210
2888,新光金,80,0,80,新百王,2024-02-23,6210
1316,上曜,107,31,76,新百王,2024-02-23,6210
5521,工信,123,47,76,新百王,2024-02-23,6210
1217,愛之味,95,22,73,新百王,2024-02-23,6210
00795B,中信美國公債20年,65,0,65,新百王,2024-02-23,6210
00878,國泰永續高股息,110,46,64,新百王,2024-02-23,6210
1714,和桐,60,0,60,新百王,2024-02-23,6210
9105,泰金寶-DR,55,0,55,新百王,2024-02-23,6210
2358,廷鑫,89,44,45,新百王,2024-02-23,6210
00900,富邦特選高股息30,50,7,43,新百王,2024-02-23,6210
4968,立積,44,2,42,新百王,2024-02-23,6210
3689,湧德,66,25,41,新百王,2024-02-23,6210
2353,宏��,55,21,34,新百王,2024-02-23,6210
5469,瀚宇博,32,1,31,新百王,2024-02-23,6210
4726,永昕,29,0,29,新百王,2024-02-23,6210
3041,揚智,37,9,28,新百王,2024-02-23,6210
2329,華泰,276,248,28,新百王,2024-02-23,6210
6538,倉和,29,4,25,新百王,2024-02-23,6210
3484,崧騰,24,0,24,新百王,2024-02-23,6210
00919,群益台灣精選高息,69,46,23,新百王,2024-02-23,6210
00632R,元大台灣50反1,91,70,21,新百王,2024-02-23,6210
2882,國泰金,21,0,21,新百王,2024-02-23,6210
00688L,國泰20年美債正2,20,0,20,新百王,2024-02-23,6210
2023,燁輝,20,0,20,新百王,2024-02-23,6210
00864B,中信美國公債0-1,20,0,20,新百王,2024-02-23,6210
2355,敬鵬,21,2,19,新百王,2024-02-23,6210
3038,全台,22,3,19,新百王,2024-02-23,6210
2464,盟立,20,2,18,新百王,2024-02-23,6210
2382,廣達,24,7,17,新百王,2024-02-23,6210
00852L,國泰美國道瓊正2,17,0,17,新百王,2024-02-23,6210
8215,明基材,17,1,16,新百王,2024-02-23,6210
00895,富邦未來車,23,8,15,新百王,2024-02-23,6210
00679B,元大美債20年,15,0,15,新百王,2024-02-23,6210
4157,太景*-KY,15,0,15,新百王,2024-02-23,6210
2062,橋椿,17,2,15,新百王,2024-02-23,6210
2405,輔信,101,86,15,新百王,2024-02-23,6210
9945,潤泰新,15,0,15,新百王,2024-02-23,6210
2313,華通,186,172,14,新百王,2024-02-23,6210
1802,台玻,15,1,14,新百王,2024-02-23,6210
2371,大同,50,36,14,新百王,2024-02-23,6210
2612,中航,16,3,13,新百王,2024-02-23,6210
2206,三陽工業,13,0,13,新百王,2024-02-23,6210
2312,金寶,12,0,12,新百王,2024-02-23,6210
00637L,元大滬深300正2,65,53,12,新百王,2024-02-23,6210
00679B,元大美債20年,782,7,775,新百王,2024-02-26,6210
00673R,期元大S＆P原油反1,675,0,675,新百王,2024-02-26,6210
8064,東捷,190,12,178,新百王,2024-02-26,6210
2903,遠百,154,0,154,新百王,2024-02-26,6210
00632R,元大台灣50反1,203,100,103,新百王,2024-02-26,6210
2359,所羅門,100,0,100,新百王,2024-02-26,6210
00753L,中信中國50正2,100,0,100,新百王,2024-02-26,6210
00934,中信成長高股息,101,3,98,新百王,2024-02-26,6210
00878,國泰永續高股息,116,25,91,新百王,2024-02-26,6210
2890,永豐金,99,8,91,新百王,2024-02-26,6210
00937B,群益ESG投等債20,163,78,85,新百王,2024-02-26,6210
2886,兆豐金,77,1,76,新百王,2024-02-26,6210
00637L,元大滬深300正2,144,75,69,新百王,2024-02-26,6210
00715L,期街口布蘭特正2,67,2,65,新百王,2024-02-26,6210
00688L,國泰20年美債正2,146,83,63,新百王,2024-02-26,6210
1609,大亞,131,73,58,新百王,2024-02-26,6210
6141,柏承,50,0,50,新百王,2024-02-26,6210
4726,永昕,47,0,47,新百王,2024-02-26,6210
9105,泰金寶-DR,40,0,40,新百王,2024-02-26,6210
6189,豐藝,43,4,39,新百王,2024-02-26,6210
2852,第一保,38,0,38,新百王,2024-02-26,6210
1717,長興,39,4,35,新百王,2024-02-26,6210
9103,美德醫療-DR,33,1,32,新百王,2024-02-26,6210
1815,富喬,35,3,32,新百王,2024-02-26,6210
8240,華宏,30,0,30,新百王,2024-02-26,6210
5521,工信,30,0,30,新百王,2024-02-26,6210
6288,聯嘉,34,9,25,新百王,2024-02-26,6210
00633L,富邦上証正2,24,0,24,新百王,2024-02-26,6210
00655L,國泰中國A50正2,24,0,24,新百王,2024-02-26,6210
2476,鉅祥,27,4,23,新百王,2024-02-26,6210
2723,美食-KY,25,3,22,新百王,2024-02-26,6210
00722B,群益投資級電信債,22,0,22,新百王,2024-02-26,6210
2617,台航,20,0,20,新百王,2024-02-26,6210
1532,勤美,20,0,20,新百王,2024-02-26,6210
3081,聯亞,23,3,20,新百王,2024-02-26,6210
1504,東元,39,19,20,新百王,2024-02-26,6210
00706L,期元大S＆P日圓正2,20,0,20,新百王,2024-02-26,6210
6179,亞通,20,0,20,新百王,2024-02-26,6210
6274,台燿,38,19,19,新百王,2024-02-26,6210
3706,神達,22,3,19,新百王,2024-02-26,6210
2313,華通,82,64,18,新百王,2024-02-26,6210
3002,歐格,17,0,17,新百王,2024-02-26,6210
6285,啟��,25,8,17,新百王,2024-02-26,6210
00724B,群益投資級金融債,16,0,16,新百王,2024-02-26,6210
3689,湧德,61,45,16,新百王,2024-02-26,6210
1720,生達,20,4,16,新百王,2024-02-26,6210
5009,榮剛,16,0,16,新百王,2024-02-26,6210
2882,國泰金,16,0,16,新百王,2024-02-26,6210
2449,京元電子,27,12,15,新百王,2024-02-26,6210
2382,廣達,17,2,15,新百王,2024-02-26,6210
2890,永豐金,772,90,682,新百王,2024-02-27,6210
00687B,國泰20年美債,715,64,651,新百王,2024-02-27,6210
00937B,群益ESG投等債20,197,0,197,新百王,2024-02-27,6210
2885,元大金,175,0,175,新百王,2024-02-27,6210
5355,佳總,61,0,61,新百王,2024-02-27,6210
00680L,元大美債20正2,60,0,60,新百王,2024-02-27,6210
2442,新美齊,60,0,60,新百王,2024-02-27,6210
6116,彩晶,105,50,55,新百王,2024-02-27,6210
00931B,統一美債20年,51,0,51,新百王,2024-02-27,6210
00918,大華優利高填息30,51,0,51,新百王,2024-02-27,6210
00919,群益台灣精選高息,94,44,50,新百王,2024-02-27,6210
3516,亞帝歐,51,1,50,新百王,2024-02-27,6210
1711,永光,55,5,50,新百王,2024-02-27,6210
00712,復華富時不動產,50,2,48,新百王,2024-02-27,6210
2618,長榮航,52,10,42,新百王,2024-02-27,6210
6189,豐藝,55,14,41,新百王,2024-02-27,6210
00864B,中信美國公債0-1,40,0,40,新百王,2024-02-27,6210
3703,欣陸,40,0,40,新百王,2024-02-27,6210
00933B,國泰10Y+金融債,37,0,37,新百王,2024-02-27,6210
2358,廷鑫,37,0,37,新百王,2024-02-27,6210
00673R,期元大S＆P原油反1,45,10,35,新百王,2024-02-27,6210
4904,遠傳,33,0,33,新百王,2024-02-27,6210
2845,遠東銀,30,0,30,新百王,2024-02-27,6210
2408,南亞科,29,1,28,新百王,2024-02-27,6210
1785,光洋科,27,0,27,新百王,2024-02-27,6210
5488,松普,28,2,26,新百王,2024-02-27,6210
2329,華泰,56,30,26,新百王,2024-02-27,6210
2031,新光鋼,43,18,25,新百王,2024-02-27,6210
1532,勤美,30,5,25,新百王,2024-02-27,6210
3037,欣興,49,26,23,新百王,2024-02-27,6210
4915,致伸,24,1,23,新百王,2024-02-27,6210
3711,日月光投控,27,4,23,新百王,2024-02-27,6210
3481,群創,30,9,21,新百王,2024-02-27,6210
2851,中再保,20,0,20,新百王,2024-02-27,6210
00878,國泰永續高股息,89,70,19,新百王,2024-02-27,6210
6514,芮特-KY,19,0,19,新百王,2024-02-27,6210
4726,永昕,19,0,19,新百王,2024-02-27,6210
5272,笙科,28,9,19,新百王,2024-02-27,6210
3057,喬鼎,21,2,19,新百王,2024-02-27,6210
2301,光寶科,100,82,18,新百王,2024-02-27,6210
1609,大亞,51,33,18,新百王,2024-02-27,6210
2409,友達,18,1,17,新百王,2024-02-27,6210
3630,新鉅科,17,0,17,新百王,2024-02-27,6210
00857B,永豐20年美公債,16,0,16,新百王,2024-02-27,6210
4561,健椿,16,0,16,新百王,2024-02-27,6210
2027,大成鋼,16,0,16,新百王,2024-02-27,6210
6456,GIS-KY,15,0,15,新百王,2024-02-27,6210
00637L,元大滬深300正2,50,35,15,新百王,2024-02-27,6210
00934,中信成長高股息,15,0,15,新百王,2024-02-27,6210
2382,廣達,43,29,14,新百王,2024-02-27,6210
00937B,群益ESG投等債20,605,30,575,新百王,2024-02-29,6210
6179,亞通,168,2,166,新百王,2024-02-29,6210
00632R,元大台灣50反1,251,120,131,新百王,2024-02-29,6210
00650L,復華香港正2,136,20,116,新百王,2024-02-29,6210
00687B,國泰20年美債,107,1,106,新百王,2024-02-29,6210
00919,群益台灣精選高息,165,80,85,新百王,2024-02-29,6210
1714,和桐,65,0,65,新百王,2024-02-29,6210
5512,力麒,65,0,65,新百王,2024-02-29,6210
8040,九暘,69,6,63,新百王,2024-02-29,6210
3481,群創,125,68,57,新百王,2024-02-29,6210
6016,康和證,62,5,57,新百王,2024-02-29,6210
00931B,統一美債20年,66,10,56,新百王,2024-02-29,6210
2845,遠東銀,81,26,55,新百王,2024-02-29,6210
1101,台泥,53,0,53,新百王,2024-02-29,6210
2890,永豐金,102,50,52,新百王,2024-02-29,6210
4904,遠傳,66,18,48,新百王,2024-02-29,6210
8064,東捷,57,15,42,新百王,2024-02-29,6210
2885,元大金,37,0,37,新百王,2024-02-29,6210
2417,圓剛,44,7,37,新百王,2024-02-29,6210
2851,中再保,34,0,34,新百王,2024-02-29,6210
00712,復華富時不動產,32,0,32,新百王,2024-02-29,6210
00753L,中信中國50正2,70,40,30,新百王,2024-02-29,6210
00933B,國泰10Y+金融債,30,0,30,新百王,2024-02-29,6210
1727,中華化,54,27,27,新百王,2024-02-29,6210
6127,九豪,50,24,26,新百王,2024-02-29,6210
3372,典範,25,1,24,新百王,2024-02-29,6210
2888,新光金,25,3,22,新百王,2024-02-29,6210
2412,中華電,22,2,20,新百王,2024-02-29,6210
00757,統一FANG+,20,0,20,新百王,2024-02-29,6210
2353,宏��,26,6,20,新百王,2024-02-29,6210
2367,燿華,20,0,20,新百王,2024-02-29,6210
6514,芮特-KY,19,0,19,新百王,2024-02-29,6210
9103,美德醫療-DR,24,5,19,新百王,2024-02-29,6210
1522,堤維西,154,136,18,新百王,2024-02-29,6210
9945,潤泰新,19,1,18,新百王,2024-02-29,6210
6257,矽格,19,2,17,新百王,2024-02-29,6210
2492,華新科,20,3,17,新百王,2024-02-29,6210
1815,富喬,59,43,16,新百王,2024-02-29,6210
2020,美亞,16,0,16,新百王,2024-02-29,6210
6668,中揚光,22,6,16,新百王,2024-02-29,6210
00857B,永豐20年美公債,15,0,15,新百王,2024-02-29,6210
2547,日勝生,15,0,15,新百王,2024-02-29,6210
8473,山林水,22,8,14,新百王,2024-02-29,6210
3712,永崴投控,29,15,14,新百王,2024-02-29,6210
5225,東科-KY,17,3,14,新百王,2024-02-29,6210
3221,台嘉碩,15,2,13,新百王,2024-02-29,6210
2420,新巨,13,0,13,新百王,2024-02-29,6210
2371,大同,40,27,13,新百王,2024-02-29,6210
6282,康舒,19,6,13,新百王,2024-02-29,6210
2204,中華,13,1,12,新百王,2024-02-29,6210
00650L,復華香港正2,878,10,868,新百王,2024-03-01,6210
00673R,期元大S＆P原油反1,411,0,411,新百王,2024-03-01,6210
2317,鴻海,233,15,218,新百王,2024-03-01,6210
00918,大華優利高填息30,146,0,146,新百王,2024-03-01,6210
1609,大亞,213,80,133,新百王,2024-03-01,6210
00919,群益台灣精選高息,151,22,129,新百王,2024-03-01,6210
00937B,群益ESG投等債20,195,80,115,新百王,2024-03-01,6210
00687B,國泰20年美債,109,25,84,新百王,2024-03-01,6210
2002,中鋼,70,6,64,新百王,2024-03-01,6210
6005,群益證,67,10,57,新百王,2024-03-01,6210
5521,工信,56,0,56,新百王,2024-03-01,6210
00933B,國泰10Y+金融債,48,1,47,新百王,2024-03-01,6210
1503,士電,67,20,47,新百王,2024-03-01,6210
00706L,期元大S＆P日圓正2,40,0,40,新百王,2024-03-01,6210
2890,永豐金,50,13,37,新百王,2024-03-01,6210
8064,東捷,52,15,37,新百王,2024-03-01,6210
9945,潤泰新,34,1,33,新百王,2024-03-01,6210
1303,南亞,32,0,32,新百王,2024-03-01,6210
1717,長興,32,0,32,新百王,2024-03-01,6210
1909,榮成,30,0,30,新百王,2024-03-01,6210
00665L,富邦�琤肭磪囓�2,27,0,27,新百王,2024-03-01,6210
6122,擎邦,27,0,27,新百王,2024-03-01,6210
2369,菱生,53,28,25,新百王,2024-03-01,6210
2609,陽明,35,11,24,新百王,2024-03-01,6210
6284,佳邦,64,41,23,新百王,2024-03-01,6210
6505,台塑化,23,0,23,新百王,2024-03-01,6210
2313,華通,77,55,22,新百王,2024-03-01,6210
3036,文曄,47,25,22,新百王,2024-03-01,6210
3479,安勤,21,0,21,新百王,2024-03-01,6210
6116,彩晶,70,50,20,新百王,2024-03-01,6210
1611,中電,20,0,20,新百王,2024-03-01,6210
6514,芮特-KY,19,0,19,新百王,2024-03-01,6210
00679B,元大美債20年,23,4,19,新百王,2024-03-01,6210
1727,中華化,25,6,19,新百王,2024-03-01,6210
5355,佳總,19,0,19,新百王,2024-03-01,6210
6143,振曜,25,8,17,新百王,2024-03-01,6210
2405,輔信,17,0,17,新百王,2024-03-01,6210
00772B,中信高評級公司債,17,0,17,新百王,2024-03-01,6210
6668,中揚光,23,6,17,新百王,2024-03-01,6210
2330,台積電,30,13,17,新百王,2024-03-01,6210
2504,國產,17,1,16,新百王,2024-03-01,6210
2303,聯電,23,7,16,新百王,2024-03-01,6210
6829,千附精密,23,7,16,新百王,2024-03-01,6210
3041,揚智,40,24,16,新百王,2024-03-01,6210
3484,崧騰,15,0,15,新百王,2024-03-01,6210
2855,統一證,20,5,15,新百王,2024-03-01,6210
3694,海華,16,1,15,新百王,2024-03-01,6210
3071,協禧,14,0,14,新百王,2024-03-01,6210
6233,旺玖,18,4,14,新百王,2024-03-01,6210
6141,柏承,16,2,14,新百王,2024-03-01,6210
00687B,國泰20年美債,365,2,363,新百王,2024-03-04,6210
00632R,元大台灣50反1,482,240,242,新百王,2024-03-04,6210
00937B,群益ESG投等債20,162,3,159,新百王,2024-03-04,6210
2888,新光金,126,0,126,新百王,2024-03-04,6210
00688L,國泰20年美債正2,131,5,126,新百王,2024-03-04,6210
00664R,國泰臺灣加權反1,107,0,107,新百王,2024-03-04,6210
2324,仁寶,397,312,85,新百王,2024-03-04,6210
00933B,國泰10Y+金融債,84,1,83,新百王,2024-03-04,6210
00680L,元大美債20正2,120,53,67,新百王,2024-03-04,6210
00934,中信成長高股息,65,3,62,新百王,2024-03-04,6210
2358,廷鑫,71,10,61,新百王,2024-03-04,6210
2882,國泰金,52,0,52,新百王,2024-03-04,6210
2002,中鋼,72,21,51,新百王,2024-03-04,6210
2812,台中銀,176,133,43,新百王,2024-03-04,6210
00637L,元大滬深300正2,80,38,42,新百王,2024-03-04,6210
2409,友達,41,1,40,新百王,2024-03-04,6210
6284,佳邦,51,13,38,新百王,2024-03-04,6210
1909,榮成,56,19,37,新百王,2024-03-04,6210
2405,輔信,57,21,36,新百王,2024-03-04,6210
00857B,永豐20年美公債,36,0,36,新百王,2024-03-04,6210
3689,湧德,145,109,36,新百王,2024-03-04,6210
4968,立積,52,17,35,新百王,2024-03-04,6210
5388,中磊,39,4,35,新百王,2024-03-04,6210
6757,台灣虎航,35,0,35,新百王,2024-03-04,6210
2455,全新,52,17,35,新百王,2024-03-04,6210
6189,豐藝,37,3,34,新百王,2024-03-04,6210
2362,藍天,35,3,32,新百王,2024-03-04,6210
5512,力麒,46,16,30,新百王,2024-03-04,6210
4729,熒茂,28,3,25,新百王,2024-03-04,6210
00673R,期元大S＆P原油反1,22,0,22,新百王,2024-03-04,6210
8039,台虹,20,0,20,新百王,2024-03-04,6210
00915,凱基優選高股息30,20,0,20,新百王,2024-03-04,6210
9946,三發地產,20,0,20,新百王,2024-03-04,6210
5426,振發,24,6,18,新百王,2024-03-04,6210
3035,智原,47,30,17,新百王,2024-03-04,6210
8936,國統,18,1,17,新百王,2024-03-04,6210
8049,晶采,25,8,17,新百王,2024-03-04,6210
2543,皇昌,44,27,17,新百王,2024-03-04,6210
00712,復華富時不動產,40,24,16,新百王,2024-03-04,6210
3390,旭軟,17,1,16,新百王,2024-03-04,6210
3450,聯鈞,48,32,16,新百王,2024-03-04,6210
3434,哲固,18,3,15,新百王,2024-03-04,6210
2618,長榮航,17,2,15,新百王,2024-03-04,6210
9105,泰金寶-DR,15,0,15,新百王,2024-03-04,6210
3060,銘異,16,3,13,新百王,2024-03-04,6210
8926,台汽電,15,3,12,新百王,2024-03-04,6210
3005,神基,35,23,12,新百王,2024-03-04,6210
1303,南亞,12,0,12,新百王,2024-03-04,6210
2344,華邦電,64,52,12,新百王,2024-03-04,6210
5521,工信,22,10,12,新百王,2024-03-04,6210
00753L,中信中國50正2,229,40,189,新百王,2024-03-05,6210
2888,新光金,115,0,115,新百王,2024-03-05,6210
00919,群益台灣精選高息,222,113,109,新百王,2024-03-05,6210
00929,復華台灣科技優息,903,816,87,新百王,2024-03-05,6210
00712,復華富時不動產,86,0,86,新百王,2024-03-05,6210
00687B,國泰20年美債,107,40,67,新百王,2024-03-05,6210
00937B,群益ESG投等債20,61,0,61,新百王,2024-03-05,6210
6757,台灣虎航,60,0,60,新百王,2024-03-05,6210
1108,幸福,55,0,55,新百王,2024-03-05,6210
2002,中鋼,66,16,50,新百王,2024-03-05,6210
2883,凱基金,52,2,50,新百王,2024-03-05,6210
6109,亞元,70,21,49,新百王,2024-03-05,6210
00715L,期街口布蘭特正2,46,0,46,新百王,2024-03-05,6210
00857B,永豐20年美公債,43,0,43,新百王,2024-03-05,6210
4909,新復興,48,7,41,新百王,2024-03-05,6210
1605,華新,54,13,41,新百王,2024-03-05,6210
2355,敬鵬,46,5,41,新百王,2024-03-05,6210
8271,宇瞻,46,6,40,新百王,2024-03-05,6210
8086,宏捷科,70,36,34,新百王,2024-03-05,6210
3354,律勝,75,43,32,新百王,2024-03-05,6210
8054,安國,40,9,31,新百王,2024-03-05,6210
2206,三陽工業,46,15,31,新百王,2024-03-05,6210
00915,凱基優選高股息30,33,2,31,新百王,2024-03-05,6210
00757,統一FANG+,32,2,30,新百王,2024-03-05,6210
00632R,元大台灣50反1,251,223,28,新百王,2024-03-05,6210
2353,宏��,52,26,26,新百王,2024-03-05,6210
2605,新興,35,9,26,新百王,2024-03-05,6210
9945,潤泰新,32,7,25,新百王,2024-03-05,6210
00688L,國泰20年美債正2,38,13,25,新百王,2024-03-05,6210
3050,鈺德,25,0,25,新百王,2024-03-05,6210
006208,富邦台50,22,1,21,新百王,2024-03-05,6210
00918,大華優利高填息30,26,6,20,新百王,2024-03-05,6210
3479,安勤,20,0,20,新百王,2024-03-05,6210
2392,正崴,20,0,20,新百王,2024-03-05,6210
4939,亞電,20,1,19,新百王,2024-03-05,6210
3032,偉訓,36,20,16,新百王,2024-03-05,6210
3711,日月光投控,37,21,16,新百王,2024-03-05,6210
2887,台新金,16,0,16,新百王,2024-03-05,6210
1609,大亞,18,3,15,新百王,2024-03-05,6210
2367,燿華,206,191,15,新百王,2024-03-05,6210
1815,富喬,28,13,15,新百王,2024-03-05,6210
6163,華電網,41,28,13,新百王,2024-03-05,6210
1735,日勝化,13,0,13,新百王,2024-03-05,6210
2368,金像電,16,4,12,新百王,2024-03-05,6210
6416,瑞祺電通,15,3,12,新百王,2024-03-05,6210
2301,光寶科,34,22,12,新百王,2024-03-05,6210
3380,明泰,12,0,12,新百王,2024-03-05,6210
3264,欣銓,14,2,12,新百王,2024-03-05,6210
9105,泰金寶-DR,32,21,11,新百王,2024-03-05,6210
2402,毅嘉,11,0,11,新百王,2024-03-05,6210
2509,全坤建,155,0,155,新百王,2024-03-06,6210
2618,長榮航,95,0,95,新百王,2024-03-06,6210
00929,復華台灣科技優息,947,864,83,新百王,2024-03-06,6210
00632R,元大台灣50反1,336,256,80,新百王,2024-03-06,6210
2506,太設,80,0,80,新百王,2024-03-06,6210
1471,首利,75,7,68,新百王,2024-03-06,6210
2845,遠東銀,167,105,62,新百王,2024-03-06,6210
2002,中鋼,63,1,62,新百王,2024-03-06,6210
4123,晟德,61,0,61,新百王,2024-03-06,6210
6189,豐藝,73,20,53,新百王,2024-03-06,6210
6285,啟��,119,68,51,新百王,2024-03-06,6210
5426,振發,181,143,38,新百王,2024-03-06,6210
2206,三陽工業,73,36,37,新百王,2024-03-06,6210
1108,幸福,38,5,33,新百王,2024-03-06,6210
00937B,群益ESG投等債20,51,19,32,新百王,2024-03-06,6210
00680L,元大美債20正2,320,290,30,新百王,2024-03-06,6210
4303,信立,29,0,29,新百王,2024-03-06,6210
3481,群創,49,21,28,新百王,2024-03-06,6210
00918,大華優利高填息30,42,14,28,新百王,2024-03-06,6210
2329,華泰,34,7,27,新百王,2024-03-06,6210
2601,益航,27,0,27,新百王,2024-03-06,6210
00688L,國泰20年美債正2,56,30,26,新百王,2024-03-06,6210
5202,力新,34,8,26,新百王,2024-03-06,6210
1432,大魯閣,25,0,25,新百王,2024-03-06,6210
2609,陽明,43,18,25,新百王,2024-03-06,6210
1569,濱川,25,0,25,新百王,2024-03-06,6210
6548,長科*,25,0,25,新百王,2024-03-06,6210
2851,中再保,54,30,24,新百王,2024-03-06,6210
2353,宏��,25,1,24,新百王,2024-03-06,6210
3694,海華,31,8,23,新百王,2024-03-06,6210
6117,迎廣,132,110,22,新百王,2024-03-06,6210
3231,緯創,56,34,22,新百王,2024-03-06,6210
2486,一詮,103,82,21,新百王,2024-03-06,6210
00712,復華富時不動產,30,10,20,新百王,2024-03-06,6210
1909,榮成,20,0,20,新百王,2024-03-06,6210
2405,輔信,20,0,20,新百王,2024-03-06,6210
2344,華邦電,23,4,19,新百王,2024-03-06,6210
00894,中信小資高價30,17,0,17,新百王,2024-03-06,6210
4533,協易機,24,7,17,新百王,2024-03-06,6210
00757,統一FANG+,16,0,16,新百王,2024-03-06,6210
6125,廣運,74,58,16,新百王,2024-03-06,6210
00933B,國泰10Y+金融債,14,0,14,新百王,2024-03-06,6210
6194,育富,20,6,14,新百王,2024-03-06,6210
00927,群益半導體收益,32,18,14,新百王,2024-03-06,6210
1414,東和,14,0,14,新百王,2024-03-06,6210
6190,萬泰科,22,8,14,新百王,2024-03-06,6210
6799,來頡,42,29,13,新百王,2024-03-06,6210
6248,沛波,15,2,13,新百王,2024-03-06,6210
8054,安國,52,40,12,新百王,2024-03-06,6210
2020,美亞,12,0,12,新百王,2024-03-06,6210
00673R,期元大S＆P原油反1,501,0,501,新百王,2024-03-07,6210
2486,一詮,343,45,298,新百王,2024-03-07,6210
2324,仁寶,229,26,203,新百王,2024-03-07,6210
2885,元大金,201,5,196,新百王,2024-03-07,6210
00918,大華優利高填息30,182,5,177,新百王,2024-03-07,6210
5521,工信,167,14,153,新百王,2024-03-07,6210
3231,緯創,189,53,136,新百王,2024-03-07,6210
3481,群創,117,2,115,新百王,2024-03-07,6210
00919,群益台灣精選高息,255,150,105,新百王,2024-03-07,6210
00632R,元大台灣50反1,399,323,76,新百王,2024-03-07,6210
2101,南港,60,0,60,新百王,2024-03-07,6210
6274,台燿,81,23,58,新百王,2024-03-07,6210
00934,中信成長高股息,61,2,59,新百王,2024-03-07,6210
8011,台通,69,12,57,新百王,2024-03-07,6210
00665L,富邦�琤肭磪囓�2,97,47,50,新百王,2024-03-07,6210
1806,冠軍,50,1,49,新百王,2024-03-07,6210
3232,昱捷,55,6,49,新百王,2024-03-07,6210
2506,太設,55,10,45,新百王,2024-03-07,6210
00637L,元大滬深300正2,133,92,41,新百王,2024-03-07,6210
00679B,元大美債20年,52,11,41,新百王,2024-03-07,6210
6189,豐藝,53,15,38,新百王,2024-03-07,6210
6514,芮特-KY,36,0,36,新百王,2024-03-07,6210
3211,順達,40,6,34,新百王,2024-03-07,6210
2915,潤泰全,32,0,32,新百王,2024-03-07,6210
9945,潤泰新,33,1,32,新百王,2024-03-07,6210
2025,千興,31,0,31,新百王,2024-03-07,6210
2618,長榮航,54,24,30,新百王,2024-03-07,6210
2515,中工,138,109,29,新百王,2024-03-07,6210
1526,日馳,32,7,25,新百王,2024-03-07,6210
6285,啟��,102,77,25,新百王,2024-03-07,6210
00633L,富邦上証正2,27,2,25,新百王,2024-03-07,6210
3005,神基,61,37,24,新百王,2024-03-07,6210
1440,南紡,24,0,24,新百王,2024-03-07,6210
4128,中天,24,1,23,新百王,2024-03-07,6210
2903,遠百,22,0,22,新百王,2024-03-07,6210
3390,旭軟,22,1,21,新百王,2024-03-07,6210
8039,台虹,21,0,21,新百王,2024-03-07,6210
1605,華新,26,5,21,新百王,2024-03-07,6210
6016,康和證,27,6,21,新百王,2024-03-07,6210
3059,華晶科,20,0,20,新百王,2024-03-07,6210
6194,育富,20,0,20,新百王,2024-03-07,6210
00927,群益半導體收益,20,0,20,新百王,2024-03-07,6210
6269,台郡,20,0,20,新百王,2024-03-07,6210
1307,三芳,20,0,20,新百王,2024-03-07,6210
2385,群光,24,4,20,新百王,2024-03-07,6210
4306,炎洲,21,2,19,新百王,2024-03-07,6210
2421,建準,22,4,18,新百王,2024-03-07,6210
2104,國際中橡,29,11,18,新百王,2024-03-07,6210
00935,野村臺灣新科技50,19,1,18,新百王,2024-03-07,6210
1609,大亞,42,24,18,新百王,2024-03-07,6210
5498,凱崴,303,80,223,新百王,2024-03-08,6210
00919,群益台灣精選高息,352,139,213,新百王,2024-03-08,6210
2845,遠東銀,158,0,158,新百王,2024-03-08,6210
1909,榮成,150,0,150,新百王,2024-03-08,6210
2409,友達,106,6,100,新百王,2024-03-08,6210
6167,久正,81,0,81,新百王,2024-03-08,6210
00637L,元大滬深300正2,192,124,68,新百王,2024-03-08,6210
6695,芯鼎,62,0,62,新百王,2024-03-08,6210
6285,啟��,179,121,58,新百王,2024-03-08,6210
2025,千興,55,1,54,新百王,2024-03-08,6210
6514,芮特-KY,54,0,54,新百王,2024-03-08,6210
2915,潤泰全,50,0,50,新百王,2024-03-08,6210
9945,潤泰新,81,32,49,新百王,2024-03-08,6210
1326,台化,41,0,41,新百王,2024-03-08,6210
9105,泰金寶-DR,71,30,41,新百王,2024-03-08,6210
6125,廣運,66,30,36,新百王,2024-03-08,6210
4744,皇將,39,3,36,新百王,2024-03-08,6210
00706L,期元大S＆P日圓正2,40,5,35,新百王,2024-03-08,6210
3032,偉訓,35,0,35,新百王,2024-03-08,6210
4915,致伸,33,1,32,新百王,2024-03-08,6210
00712,復華富時不動產,40,9,31,新百王,2024-03-08,6210
00915,凱基優選高股息30,31,1,30,新百王,2024-03-08,6210
00687B,國泰20年美債,40,11,29,新百王,2024-03-08,6210
2352,佳世達,36,8,28,新百王,2024-03-08,6210
3607,谷崧,27,0,27,新百王,2024-03-08,6210
00918,大華優利高填息30,60,34,26,新百王,2024-03-08,6210
2836,高雄銀,110,84,26,新百王,2024-03-08,6210
6770,力積電,27,1,26,新百王,2024-03-08,6210
3711,日月光投控,54,30,24,新百王,2024-03-08,6210
6284,佳邦,68,45,23,新百王,2024-03-08,6210
5443,均豪,27,5,22,新百王,2024-03-08,6210
1466,聚隆,23,2,21,新百王,2024-03-08,6210
1440,南紡,30,10,20,新百王,2024-03-08,6210
8096,擎亞,67,48,19,新百王,2024-03-08,6210
6127,九豪,21,2,19,新百王,2024-03-08,6210
5483,中美晶,52,34,18,新百王,2024-03-08,6210
3372,典範,18,0,18,新百王,2024-03-08,6210
2108,南帝,18,0,18,新百王,2024-03-08,6210
8021,尖點,18,0,18,新百王,2024-03-08,6210
1513,中興電,52,34,18,新百王,2024-03-08,6210
2486,一詮,60,43,17,新百王,2024-03-08,6210
2344,華邦電,56,39,17,新百王,2024-03-08,6210
2889,國票金,16,0,16,新百王,2024-03-08,6210
4909,新復興,25,9,16,新百王,2024-03-08,6210
3481,群創,336,321,15,新百王,2024-03-08,6210
00730,富邦臺灣優質高息,15,0,15,新百王,2024-03-08,6210
2323,中環,15,0,15,新百王,2024-03-08,6210
3587,閎康,16,1,15,新百王,2024-03-08,6210
3390,旭軟,19,5,14,新百王,2024-03-08,6210
3029,零壹,13,0,13,新百王,2024-03-08,6210
00929,復華台灣科技優息,634,154,480,新百王,2024-03-11,6210
5498,凱崴,226,5,221,新百王,2024-03-11,6210
2317,鴻海,215,59,156,新百王,2024-03-11,6210
2367,燿華,136,20,116,新百王,2024-03-11,6210
1815,富喬,136,41,95,新百王,2024-03-11,6210
00706L,期元大S＆P日圓正2,95,0,95,新百王,2024-03-11,6210
00715L,期街口布蘭特正2,64,0,64,新百王,2024-03-11,6210
00753L,中信中國50正2,85,25,60,新百王,2024-03-11,6210
3669,圓展,69,10,59,新百王,2024-03-11,6210
2358,廷鑫,61,5,56,新百王,2024-03-11,6210
6190,萬泰科,51,0,51,新百王,2024-03-11,6210
1806,冠軍,50,0,50,新百王,2024-03-11,6210
2342,茂矽,78,29,49,新百王,2024-03-11,6210
5443,均豪,53,9,44,新百王,2024-03-11,6210
1316,上曜,66,26,40,新百王,2024-03-11,6210
2801,彰銀,33,1,32,新百王,2024-03-11,6210
6005,群益證,61,29,32,新百王,2024-03-11,6210
00712,復華富時不動產,56,25,31,新百王,2024-03-11,6210
1457,宜進,30,0,30,新百王,2024-03-11,6210
00688L,國泰20年美債正2,30,0,30,新百王,2024-03-11,6210
00757,統一FANG+,29,0,29,新百王,2024-03-11,6210
9105,泰金寶-DR,29,0,29,新百王,2024-03-11,6210
6695,芯鼎,29,0,29,新百王,2024-03-11,6210
00915,凱基優選高股息30,26,0,26,新百王,2024-03-11,6210
1440,南紡,26,0,26,新百王,2024-03-11,6210
2313,華通,90,66,24,新百王,2024-03-11,6210
2439,美律,26,3,23,新百王,2024-03-11,6210
9945,潤泰新,48,25,23,新百王,2024-03-11,6210
9934,成霖,26,4,22,新百王,2024-03-11,6210
2887,台新金,22,0,22,新百王,2024-03-11,6210
00937B,群益ESG投等債20,66,46,20,新百王,2024-03-11,6210
3338,泰碩,38,19,19,新百王,2024-03-11,6210
8112,至上,25,7,18,新百王,2024-03-11,6210
1514,亞力,31,13,18,新百王,2024-03-11,6210
00751B,元大AAA至A公司債,17,0,17,新百王,2024-03-11,6210
1909,榮成,17,0,17,新百王,2024-03-11,6210
2344,華邦電,27,10,17,新百王,2024-03-11,6210
8299,群聯,17,0,17,新百王,2024-03-11,6210
2382,廣達,69,52,17,新百王,2024-03-11,6210
3711,日月光投控,21,5,16,新百王,2024-03-11,6210
2441,超豐,21,5,16,新百王,2024-03-11,6210
8049,晶采,16,0,16,新百王,2024-03-11,6210
1517,利奇,15,0,15,新百王,2024-03-11,6210
6265,方土昶,18,3,15,新百王,2024-03-11,6210
00891,中信關鍵半導體,15,0,15,新百王,2024-03-11,6210
6163,華電網,15,0,15,新百王,2024-03-11,6210
2312,金寶,14,0,14,新百王,2024-03-11,6210
6414,樺漢,13,0,13,新百王,2024-03-11,6210
00933B,國泰10Y+金融債,26,13,13,新百王,2024-03-11,6210
2303,聯電,42,30,12,新百王,2024-03-11,6210
00679B,元大美債20年,1020,0,1020,新百王,2024-03-12,6210
00929,復華台灣科技優息,1011,24,987,新百王,2024-03-12,6210
00632R,元大台灣50反1,306,50,256,新百王,2024-03-12,6210
00712,復華富時不動產,205,22,183,新百王,2024-03-12,6210
00919,群益台灣精選高息,158,3,155,新百王,2024-03-12,6210
00688L,國泰20年美債正2,105,10,95,新百王,2024-03-12,6210
2353,宏��,144,67,77,新百王,2024-03-12,6210
3303,岱稜,64,0,64,新百王,2024-03-12,6210
2506,太設,60,0,60,新百王,2024-03-12,6210
6290,良維,64,7,57,新百王,2024-03-12,6210
00694B,富邦美債1-3,57,0,57,新百王,2024-03-12,6210
8096,擎亞,121,69,52,新百王,2024-03-12,6210
3032,偉訓,46,0,46,新百王,2024-03-12,6210
2897,王道銀行,40,0,40,新百王,2024-03-12,6210
6514,芮特-KY,36,0,36,新百王,2024-03-12,6210
00918,大華優利高填息30,34,0,34,新百王,2024-03-12,6210
2392,正崴,32,1,31,新百王,2024-03-12,6210
00921,兆豐龍頭等權重,30,0,30,新百王,2024-03-12,6210
3689,湧德,35,6,29,新百王,2024-03-12,6210
4939,亞電,26,0,26,新百王,2024-03-12,6210
2451,創見,25,0,25,新百王,2024-03-12,6210
2611,志信,79,55,24,新百王,2024-03-12,6210
00857B,永豐20年美公債,22,0,22,新百王,2024-03-12,6210
4726,永昕,22,0,22,新百王,2024-03-12,6210
1314,中石化,21,0,21,新百王,2024-03-12,6210
00676R,富邦臺灣加權反1,20,0,20,新百王,2024-03-12,6210
5469,瀚宇博,20,0,20,新百王,2024-03-12,6210
1316,上曜,49,31,18,新百王,2024-03-12,6210
2371,大同,31,13,18,新百王,2024-03-12,6210
2313,華通,170,152,18,新百王,2024-03-12,6210
1101,台泥,20,2,18,新百王,2024-03-12,6210
8054,安國,25,8,17,新百王,2024-03-12,6210
4714,永捷,24,8,16,新百王,2024-03-12,6210
1616,億泰,16,0,16,新百王,2024-03-12,6210
00904,新光臺灣半導體30,20,5,15,新百王,2024-03-12,6210
2867,三商壽,26,11,15,新百王,2024-03-12,6210
00645,富邦日本,15,0,15,新百王,2024-03-12,6210
3060,銘異,15,0,15,新百王,2024-03-12,6210
6274,台燿,50,36,14,新百王,2024-03-12,6210
3294,英濟,17,3,14,新百王,2024-03-12,6210
1307,三芳,15,1,14,新百王,2024-03-12,6210
2352,佳世達,21,8,13,新百王,2024-03-12,6210
3437,榮創,13,0,13,新百王,2024-03-12,6210
1102,亞泥,13,0,13,新百王,2024-03-12,6210
2344,華邦電,17,5,12,新百王,2024-03-12,6210
6462,神盾,15,3,12,新百王,2024-03-12,6210
2031,新光鋼,11,0,11,新百王,2024-03-12,6210
00885,富邦越南,12,1,11,新百王,2024-03-12,6210
3033,威健,11,0,11,新百王,2024-03-12,6210
9105,泰金寶-DR,11,0,11,新百王,2024-03-12,6210
00919,群益台灣精選高息,722,203,519,新百王,2024-03-13,6210
00929,復華台灣科技優息,598,236,362,新百王,2024-03-13,6210
00753L,中信中國50正2,260,21,239,新百王,2024-03-13,6210
2836,高雄銀,112,0,112,新百王,2024-03-13,6210
00864B,中信美國公債0-1,100,0,100,新百王,2024-03-13,6210
8222,寶一,72,0,72,新百王,2024-03-13,6210
6462,神盾,73,5,68,新百王,2024-03-13,6210
9945,潤泰新,79,13,66,新百王,2024-03-13,6210
6592,和潤企業,66,1,65,新百王,2024-03-13,6210
00688L,國泰20年美債正2,61,0,61,新百王,2024-03-13,6210
00679B,元大美債20年,60,8,52,新百王,2024-03-13,6210
00637L,元大滬深300正2,95,45,50,新百王,2024-03-13,6210
2890,永豐金,52,3,49,新百王,2024-03-13,6210
00857B,永豐20年美公債,49,0,49,新百王,2024-03-13,6210
1326,台化,42,0,42,新百王,2024-03-13,6210
4909,新復興,91,49,42,新百王,2024-03-13,6210
1524,耿鼎,55,16,39,新百王,2024-03-13,6210
3303,岱稜,39,0,39,新百王,2024-03-13,6210
2845,遠東銀,36,2,34,新百王,2024-03-13,6210
8940,新天地,33,0,33,新百王,2024-03-13,6210
00680L,元大美債20正2,42,10,32,新百王,2024-03-13,6210
4968,立積,32,2,30,新百王,2024-03-13,6210
5515,建國,30,0,30,新百王,2024-03-13,6210
2349,錸德,30,0,30,新百王,2024-03-13,6210
2607,榮運,47,18,29,新百王,2024-03-13,6210
2376,技嘉,37,9,28,新百王,2024-03-13,6210
2855,統一證,28,0,28,新百王,2024-03-13,6210
6116,彩晶,50,23,27,新百王,2024-03-13,6210
6125,廣運,90,63,27,新百王,2024-03-13,6210
3481,群創,24,0,24,新百王,2024-03-13,6210
00632R,元大台灣50反1,262,238,24,新百王,2024-03-13,6210
3691,碩禾,22,0,22,新百王,2024-03-13,6210
00931B,統一美債20年,22,0,22,新百王,2024-03-13,6210
00885,富邦越南,20,0,20,新百王,2024-03-13,6210
1806,冠軍,20,0,20,新百王,2024-03-13,6210
00921,兆豐龍頭等權重,20,0,20,新百王,2024-03-13,6210
3071,協禧,57,38,19,新百王,2024-03-13,6210
2867,三商壽,17,0,17,新百王,2024-03-13,6210
1440,南紡,27,10,17,新百王,2024-03-13,6210
3715,定穎投控,17,0,17,新百王,2024-03-13,6210
1316,上曜,48,32,16,新百王,2024-03-13,6210
2337,旺宏,16,0,16,新百王,2024-03-13,6210
9105,泰金寶-DR,16,0,16,新百王,2024-03-13,6210
00795B,中信美國公債20年,15,0,15,新百王,2024-03-13,6210
2753,八方雲集,30,15,15,新百王,2024-03-13,6210
9908,大台北,15,0,15,新百王,2024-03-13,6210
2377,微星,22,7,15,新百王,2024-03-13,6210
2371,大同,19,4,15,新百王,2024-03-13,6210
3622,洋華,17,2,15,新百王,2024-03-13,6210
6127,九豪,15,0,15,新百王,2024-03-13,6210
2002,中鋼,494,0,494,新百王,2024-03-14,6210
2890,永豐金,463,3,460,新百王,2024-03-14,6210
00753L,中信中國50正2,310,0,310,新百王,2024-03-14,6210
00857B,永豐20年美公債,229,0,229,新百王,2024-03-14,6210
00687B,國泰20年美債,186,1,185,新百王,2024-03-14,6210
2885,元大金,144,13,131,新百王,2024-03-14,6210
00795B,中信美國公債20年,111,0,111,新百王,2024-03-14,6210
2883,凱基金,119,55,64,新百王,2024-03-14,6210
3006,晶豪科,63,2,61,新百王,2024-03-14,6210
00680L,元大美債20正2,60,0,60,新百王,2024-03-14,6210
00637L,元大滬深300正2,107,53,54,新百王,2024-03-14,6210
00688L,國泰20年美債正2,51,0,51,新百王,2024-03-14,6210
00679B,元大美債20年,56,5,51,新百王,2024-03-14,6210
2834,臺企銀,104,54,50,新百王,2024-03-14,6210
2889,國票金,79,32,47,新百王,2024-03-14,6210
00918,大華優利高填息30,55,12,43,新百王,2024-03-14,6210
00915,凱基優選高股息30,54,13,41,新百王,2024-03-14,6210
00864B,中信美國公債0-1,40,0,40,新百王,2024-03-14,6210
1524,耿鼎,49,10,39,新百王,2024-03-14,6210
3702,大聯大,38,0,38,新百王,2024-03-14,6210
2915,潤泰全,42,8,34,新百王,2024-03-14,6210
3005,神基,45,13,32,新百王,2024-03-14,6210
1909,榮成,30,0,30,新百王,2024-03-14,6210
1503,士電,158,129,29,新百王,2024-03-14,6210
1529,樂事綠能,27,0,27,新百王,2024-03-14,6210
2303,聯電,37,10,27,新百王,2024-03-14,6210
2383,台光電,31,5,26,新百王,2024-03-14,6210
4968,立積,29,5,24,新百王,2024-03-14,6210
00712,復華富時不動產,60,36,24,新百王,2024-03-14,6210
3646,艾恩特,22,0,22,新百王,2024-03-14,6210
5521,工信,40,18,22,新百王,2024-03-14,6210
6139,亞翔,30,9,21,新百王,2024-03-14,6210
1609,大亞,82,61,21,新百王,2024-03-14,6210
4906,正文,24,3,21,新百王,2024-03-14,6210
00641R,富邦日本反1,20,0,20,新百王,2024-03-14,6210
1314,中石化,18,0,18,新百王,2024-03-14,6210
00751B,元大AAA至A公司債,21,5,16,新百王,2024-03-14,6210
3042,晶技,18,2,16,新百王,2024-03-14,6210
2618,長榮航,62,47,15,新百王,2024-03-14,6210
6592,和潤企業,15,0,15,新百王,2024-03-14,6210
2105,正新,18,3,15,新百王,2024-03-14,6210
00673R,期元大S＆P原油反1,14,0,14,新百王,2024-03-14,6210
00757,統一FANG+,14,1,13,新百王,2024-03-14,6210
2465,麗臺,15,2,13,新百王,2024-03-14,6210
2603,長榮,36,24,12,新百王,2024-03-14,6210
1802,台玻,47,35,12,新百王,2024-03-14,6210
4743,合一,16,4,12,新百王,2024-03-14,6210
6239,力成,16,5,11,新百王,2024-03-14,6210
9105,泰金寶-DR,11,0,11,新百王,2024-03-14,6210
00830,國泰費城半導體,12,2,10,新百王,2024-03-14,6210
2834,臺企銀,718,23,695,新百王,2024-03-15,6210
00937B,群益ESG投等債20,281,8,273,新百王,2024-03-15,6210
00941,中信上游半導體,206,0,206,新百王,2024-03-15,6210
00673R,期元大S＆P原油反1,217,18,199,新百王,2024-03-15,6210
00687B,國泰20年美債,213,50,163,新百王,2024-03-15,6210
00712,復華富時不動產,133,2,131,新百王,2024-03-15,6210
2618,長榮航,123,12,111,新百王,2024-03-15,6210
2903,遠百,96,2,94,新百王,2024-03-15,6210
00679B,元大美債20年,91,0,91,新百王,2024-03-15,6210
2344,華邦電,143,57,86,新百王,2024-03-15,6210
1909,榮成,81,0,81,新百王,2024-03-15,6210
00919,群益台灣精選高息,180,101,79,新百王,2024-03-15,6210
00688L,國泰20年美債正2,76,0,76,新百王,2024-03-15,6210
00680L,元大美債20正2,102,30,72,新百王,2024-03-15,6210
00915,凱基優選高股息30,62,0,62,新百王,2024-03-15,6210
00665L,富邦�琤肭磪囓�2,56,5,51,新百王,2024-03-15,6210
2816,旺旺保,43,0,43,新百王,2024-03-15,6210
1312,國喬,42,0,42,新百王,2024-03-15,6210
3628,盈正,52,10,42,新百王,2024-03-15,6210
4707,磐亞,40,0,40,新百王,2024-03-15,6210
2511,太子,40,0,40,新百王,2024-03-15,6210
00650L,復華香港正2,36,0,36,新百王,2024-03-15,6210
2641,正德,35,0,35,新百王,2024-03-15,6210
6505,台塑化,32,0,32,新百王,2024-03-15,6210
00751B,元大AAA至A公司債,30,0,30,新百王,2024-03-15,6210
2882,國泰金,41,11,30,新百王,2024-03-15,6210
1605,華新,32,4,28,新百王,2024-03-15,6210
2534,宏盛,25,0,25,新百王,2024-03-15,6210
2887,台新金,65,40,25,新百王,2024-03-15,6210
00706L,期元大S＆P日圓正2,25,0,25,新百王,2024-03-15,6210
1440,南紡,35,10,25,新百王,2024-03-15,6210
2889,國票金,43,18,25,新百王,2024-03-15,6210
2897,王道銀行,103,80,23,新百王,2024-03-15,6210
2845,遠東銀,38,15,23,新百王,2024-03-15,6210
2356,英業達,23,1,22,新百王,2024-03-15,6210
1802,台玻,21,0,21,新百王,2024-03-15,6210
6290,良維,24,3,21,新百王,2024-03-15,6210
2611,志信,41,21,20,新百王,2024-03-15,6210
1314,中石化,20,0,20,新百王,2024-03-15,6210
2542,興富發,20,0,20,新百王,2024-03-15,6210
1808,潤隆,29,9,20,新百王,2024-03-15,6210
00637L,元大滬深300正2,72,52,20,新百王,2024-03-15,6210
1815,富喬,20,0,20,新百王,2024-03-15,6210
00892,富邦台灣半導體,20,0,20,新百王,2024-03-15,6210
2915,潤泰全,20,0,20,新百王,2024-03-15,6210
5533,皇鼎,19,0,19,新百王,2024-03-15,6210
2313,華通,53,35,18,新百王,2024-03-15,6210
2354,鴻準,45,27,18,新百王,2024-03-15,6210
1513,中興電,98,81,17,新百王,2024-03-15,6210
2352,佳世達,18,1,17,新百王,2024-03-15,6210
00929,復華台灣科技優息,971,136,835,新百王,2024-03-18,6210
2834,臺企銀,235,42,193,新百王,2024-03-18,6210
2890,永豐金,312,125,187,新百王,2024-03-18,6210
00941,中信上游半導體,172,13,159,新百王,2024-03-18,6210
00919,群益台灣精選高息,156,17,139,新百王,2024-03-18,6210
00679B,元大美債20年,123,0,123,新百王,2024-03-18,6210
00795B,中信美國公債20年,90,0,90,新百王,2024-03-18,6210
2852,第一保,90,0,90,新百王,2024-03-18,6210
00687B,國泰20年美債,91,5,86,新百王,2024-03-18,6210
2897,王道銀行,90,10,80,新百王,2024-03-18,6210
00772B,中信高評級公司債,56,0,56,新百王,2024-03-18,6210
2883B,凱基金乙特,54,0,54,新百王,2024-03-18,6210
2104,國際中橡,65,19,46,新百王,2024-03-18,6210
00918,大華優利高填息30,50,4,46,新百王,2024-03-18,6210
00933B,國泰10Y+金融債,39,0,39,新百王,2024-03-18,6210
00688L,國泰20年美債正2,36,0,36,新百王,2024-03-18,6210
1605,華新,130,98,32,新百王,2024-03-18,6210
1524,耿鼎,40,10,30,新百王,2024-03-18,6210
2303,聯電,37,9,28,新百王,2024-03-18,6210
2317,鴻海,149,122,27,新百王,2024-03-18,6210
2547,日勝生,27,0,27,新百王,2024-03-18,6210
00931B,統一美債20年,27,0,27,新百王,2024-03-18,6210
9945,潤泰新,34,8,26,新百王,2024-03-18,6210
9105,泰金寶-DR,40,15,25,新百王,2024-03-18,6210
00641R,富邦日本反1,25,0,25,新百王,2024-03-18,6210
00857B,永豐20年美公債,25,0,25,新百王,2024-03-18,6210
2312,金寶,30,5,25,新百王,2024-03-18,6210
1808,潤隆,23,2,21,新百王,2024-03-18,6210
2002,中鋼,21,2,19,新百王,2024-03-18,6210
8940,新天地,19,0,19,新百王,2024-03-18,6210
2382,廣達,65,47,18,新百王,2024-03-18,6210
2528,皇普,18,0,18,新百王,2024-03-18,6210
2449,京元電子,56,38,18,新百王,2024-03-18,6210
00751B,元大AAA至A公司債,17,0,17,新百王,2024-03-18,6210
1522,堤維西,36,19,17,新百王,2024-03-18,6210
4503,金雨,39,23,16,新百王,2024-03-18,6210
1109,信大,16,0,16,新百王,2024-03-18,6210
1216,統一,15,0,15,新百王,2024-03-18,6210
2323,中環,67,52,15,新百王,2024-03-18,6210
00706L,期元大S＆P日圓正2,15,0,15,新百王,2024-03-18,6210
1457,宜進,15,0,15,新百王,2024-03-18,6210
00722B,群益投資級電信債,15,0,15,新百王,2024-03-18,6210
3706,神達,22,8,14,新百王,2024-03-18,6210
1532,勤美,14,0,14,新百王,2024-03-18,6210
8936,國統,43,30,13,新百王,2024-03-18,6210
3294,英濟,33,20,13,新百王,2024-03-18,6210
5521,工信,21,8,13,新百王,2024-03-18,6210
1609,大亞,37,25,12,新百王,2024-03-18,6210
5457,宣德,19,7,12,新百王,2024-03-18,6210
00937B,群益ESG投等債20,46,35,11,新百王,2024-03-18,6210
00919,群益台灣精選高息,277,62,215,新百王,2024-03-19,6210
1307,三芳,111,1,110,新百王,2024-03-19,6210
2359,所羅門,122,18,104,新百王,2024-03-19,6210
00937B,群益ESG投等債20,89,2,87,新百王,2024-03-19,6210
00706L,期元大S＆P日圓正2,81,0,81,新百王,2024-03-19,6210
00687B,國泰20年美債,70,0,70,新百王,2024-03-19,6210
2889,國票金,68,4,64,新百王,2024-03-19,6210
4714,永捷,61,2,59,新百王,2024-03-19,6210
2313,華通,85,26,59,新百王,2024-03-19,6210
5498,凱崴,55,0,55,新百王,2024-03-19,6210
2486,一詮,108,54,54,新百王,2024-03-19,6210
00857B,永豐20年美公債,53,0,53,新百王,2024-03-19,6210
00688L,國泰20年美債正2,50,0,50,新百王,2024-03-19,6210
00650L,復華香港正2,56,10,46,新百王,2024-03-19,6210
1605,華新,49,3,46,新百王,2024-03-19,6210
2890,永豐金,394,349,45,新百王,2024-03-19,6210
4904,遠傳,43,0,43,新百王,2024-03-19,6210
6189,豐藝,42,2,40,新百王,2024-03-19,6210
2328,廣宇,40,1,39,新百王,2024-03-19,6210
00753L,中信中國50正2,50,12,38,新百王,2024-03-19,6210
00679B,元大美債20年,38,0,38,新百王,2024-03-19,6210
1326,台化,35,0,35,新百王,2024-03-19,6210
2888,新光金,52,20,32,新百王,2024-03-19,6210
2405,輔信,30,0,30,新百王,2024-03-19,6210
00680L,元大美債20正2,28,0,28,新百王,2024-03-19,6210
00830,國泰費城半導體,30,3,27,新百王,2024-03-19,6210
6215,和椿,26,0,26,新百王,2024-03-19,6210
2027,大成鋼,30,5,25,新百王,2024-03-19,6210
00665L,富邦�琤肭磪囓�2,118,96,22,新百王,2024-03-19,6210
5443,均豪,33,12,21,新百王,2024-03-19,6210
00931B,統一美債20年,21,0,21,新百王,2024-03-19,6210
2887,台新金,20,0,20,新百王,2024-03-19,6210
3059,華晶科,20,0,20,新百王,2024-03-19,6210
2023,燁輝,20,0,20,新百王,2024-03-19,6210
00795B,中信美國公債20年,18,0,18,新百王,2024-03-19,6210
00673R,期元大S＆P原油反1,18,0,18,新百王,2024-03-19,6210
00921,兆豐龍頭等權重,18,3,15,新百王,2024-03-19,6210
00764B,群益25年美債,15,0,15,新百王,2024-03-19,6210
6581,鋼聯,15,0,15,新百王,2024-03-19,6210
6695,芯鼎,15,0,15,新百王,2024-03-19,6210
2845,遠東銀,15,0,15,新百王,2024-03-19,6210
00915,凱基優選高股息30,24,10,14,新百王,2024-03-19,6210
2816,旺旺保,14,0,14,新百王,2024-03-19,6210
6438,迅得,14,1,13,新百王,2024-03-19,6210
3005,神基,148,136,12,新百王,2024-03-19,6210
2498,宏達電,12,0,12,新百王,2024-03-19,6210
2912,統一超,12,0,12,新百王,2024-03-19,6210
5493,三聯,22,10,12,新百王,2024-03-19,6210
2371,大同,47,35,12,新百王,2024-03-19,6210
2230,泰茂,14,2,12,新百王,2024-03-19,6210
00939,統一台灣高息動能,1437,423,1014,新百王,2024-03-20,6210
00687B,國泰20年美債,131,0,131,新百王,2024-03-20,6210
00919,群益台灣精選高息,338,270,68,新百王,2024-03-20,6210
2897,王道銀行,90,30,60,新百王,2024-03-20,6210
1316,上曜,75,15,60,新百王,2024-03-20,6210
1440,南紡,54,0,54,新百王,2024-03-20,6210
2888,新光金,105,55,50,新百王,2024-03-20,6210
4938,和碩,100,51,49,新百王,2024-03-20,6210
00905,FT臺灣Smart,50,2,48,新百王,2024-03-20,6210
2313,華通,112,73,39,新百王,2024-03-20,6210
00937B,群益ESG投等債20,58,19,39,新百王,2024-03-20,6210
3147,大綜,38,6,32,新百王,2024-03-20,6210
2344,華邦電,37,7,30,新百王,2024-03-20,6210
00864B,中信美國公債0-1,30,0,30,新百王,2024-03-20,6210
1326,台化,32,3,29,新百王,2024-03-20,6210
6219,富旺,30,2,28,新百王,2024-03-20,6210
2461,光群雷,26,0,26,新百王,2024-03-20,6210
6215,和椿,65,39,26,新百王,2024-03-20,6210
2356,英業達,122,97,25,新百王,2024-03-20,6210
6462,神盾,50,25,25,新百王,2024-03-20,6210
00706L,期元大S＆P日圓正2,52,29,23,新百王,2024-03-20,6210
00857B,永豐20年美公債,356,334,22,新百王,2024-03-20,6210
2887,台新金,22,0,22,新百王,2024-03-20,6210
2603,長榮,64,43,21,新百王,2024-03-20,6210
1444,力麗,20,0,20,新百王,2024-03-20,6210
2323,中環,32,12,20,新百王,2024-03-20,6210
00679B,元大美債20年,19,0,19,新百王,2024-03-20,6210
00931B,統一美債20年,19,0,19,新百王,2024-03-20,6210
2354,鴻準,65,49,16,新百王,2024-03-20,6210
2618,長榮航,24,8,16,新百王,2024-03-20,6210
2453,凌群,42,27,15,新百王,2024-03-20,6210
4105,東洋,17,2,15,新百王,2024-03-20,6210
2547,日勝生,15,0,15,新百王,2024-03-20,6210
3272,東碩,15,0,15,新百王,2024-03-20,6210
2845,遠東銀,15,0,15,新百王,2024-03-20,6210
00753L,中信中國50正2,25,10,15,新百王,2024-03-20,6210
1101,台泥,27,12,15,新百王,2024-03-20,6210
2449,京元電子,166,152,14,新百王,2024-03-20,6210
6770,力積電,19,5,14,新百王,2024-03-20,6210
2880,華南金,14,0,14,新百王,2024-03-20,6210
00927,群益半導體收益,14,0,14,新百王,2024-03-20,6210
1808,潤隆,14,0,14,新百王,2024-03-20,6210
1513,中興電,51,37,14,新百王,2024-03-20,6210
2104,國際中橡,15,1,14,新百王,2024-03-20,6210
2329,華泰,44,31,13,新百王,2024-03-20,6210
5515,建國,15,2,13,新百王,2024-03-20,6210
00878,國泰永續高股息,12,0,12,新百王,2024-03-20,6210
1457,宜進,12,0,12,新百王,2024-03-20,6210
3294,英濟,14,2,12,新百王,2024-03-20,6210
8011,台通,23,11,12,新百王,2024-03-20,6210
00632R,元大台灣50反1,556,50,506,新百王,2024-03-21,6210
2486,一詮,336,74,262,新百王,2024-03-21,6210
00939,統一台灣高息動能,510,250,260,新百王,2024-03-21,6210
00929,復華台灣科技優息,341,88,253,新百王,2024-03-21,6210
2618,長榮航,157,11,146,新百王,2024-03-21,6210
00687B,國泰20年美債,137,0,137,新百王,2024-03-21,6210
2897,王道銀行,155,50,105,新百王,2024-03-21,6210
1457,宜進,90,10,80,新百王,2024-03-21,6210
2439,美律,83,6,77,新百王,2024-03-21,6210
00900,富邦特選高股息30,65,0,65,新百王,2024-03-21,6210
00676R,富邦臺灣加權反1,60,0,60,新百王,2024-03-21,6210
2867,三商壽,60,5,55,新百王,2024-03-21,6210
00715L,期街口布蘭特正2,54,1,53,新百王,2024-03-21,6210
2367,燿華,87,35,52,新百王,2024-03-21,6210
00933B,國泰10Y+金融債,51,0,51,新百王,2024-03-21,6210
1513,中興電,119,69,50,新百王,2024-03-21,6210
00679B,元大美債20年,46,0,46,新百王,2024-03-21,6210
3056,富華新,50,6,44,新百王,2024-03-21,6210
00688L,國泰20年美債正2,41,0,41,新百王,2024-03-21,6210
00891,中信關鍵半導體,40,0,40,新百王,2024-03-21,6210
2884,玉山金,40,8,32,新百王,2024-03-21,6210
2405,輔信,54,23,31,新百王,2024-03-21,6210
8271,宇瞻,33,2,31,新百王,2024-03-21,6210
2331,精英,30,0,30,新百王,2024-03-21,6210
00680L,元大美債20正2,31,2,29,新百王,2024-03-21,6210
00941,中信上游半導體,53,26,27,新百王,2024-03-21,6210
2020,美亞,25,0,25,新百王,2024-03-21,6210
00857B,永豐20年美公債,31,8,23,新百王,2024-03-21,6210
00795B,中信美國公債20年,21,0,21,新百王,2024-03-21,6210
8112,至上,30,9,21,新百王,2024-03-21,6210
6026,福邦證,20,0,20,新百王,2024-03-21,6210
5607,遠雄港,20,0,20,新百王,2024-03-21,6210
1440,南紡,20,0,20,新百王,2024-03-21,6210
00669R,國泰美國道瓊反1,20,0,20,新百王,2024-03-21,6210
9943,好樂迪,20,0,20,新百王,2024-03-21,6210
6443,元晶,106,87,19,新百王,2024-03-21,6210
00931B,統一美債20年,19,0,19,新百王,2024-03-21,6210
1608,華榮,20,1,19,新百王,2024-03-21,6210
4967,十銓,24,7,17,新百王,2024-03-21,6210
3231,緯創,44,27,17,新百王,2024-03-21,6210
1532,勤美,16,0,16,新百王,2024-03-21,6210
2002,中鋼,17,1,16,新百王,2024-03-21,6210
5243,乙盛-KY,17,1,16,新百王,2024-03-21,6210
4121,優盛,15,0,15,新百王,2024-03-21,6210
2484,希華,15,0,15,新百王,2024-03-21,6210
5483,中美晶,25,11,14,新百王,2024-03-21,6210
2612,中航,14,0,14,新百王,2024-03-21,6210
2605,新興,18,4,14,新百王,2024-03-21,6210
6462,神盾,20,6,14,新百王,2024-03-21,6210
6196,帆宣,15,1,14,新百王,2024-03-21,6210
00937B,群益ESG投等債20,391,60,331,新百王,2024-03-22,6210
00665L,富邦�琤肭磪囓�2,314,20,294,新百王,2024-03-22,6210
2890,永豐金,286,57,229,新百王,2024-03-22,6210
00929,復華台灣科技優息,265,89,176,新百王,2024-03-22,6210
2486,一詮,187,40,147,新百王,2024-03-22,6210
00753L,中信中國50正2,148,9,139,新百王,2024-03-22,6210
00679B,元大美債20年,131,18,113,新百王,2024-03-22,6210
00637L,元大滬深300正2,136,36,100,新百王,2024-03-22,6210
00650L,復華香港正2,100,0,100,新百王,2024-03-22,6210
2356,英業達,322,225,97,新百王,2024-03-22,6210
3058,立德,94,0,94,新百王,2024-03-22,6210
00687B,國泰20年美債,193,114,79,新百王,2024-03-22,6210
2367,燿華,97,45,52,新百王,2024-03-22,6210
1909,榮成,50,0,50,新百王,2024-03-22,6210
2515,中工,46,0,46,新百王,2024-03-22,6210
1540,喬福,43,0,43,新百王,2024-03-22,6210
00706L,期元大S＆P日圓正2,43,5,38,新百王,2024-03-22,6210
1618,合機,46,18,28,新百王,2024-03-22,6210
1319,東陽,28,2,26,新百王,2024-03-22,6210
00931B,統一美債20年,25,0,25,新百王,2024-03-22,6210
9904,寶成,24,0,24,新百王,2024-03-22,6210
3056,富華新,24,2,22,新百王,2024-03-22,6210
8110,華東,21,0,21,新百王,2024-03-22,6210
4714,永捷,34,13,21,新百王,2024-03-22,6210
2883,凱基金,23,2,21,新百王,2024-03-22,6210
3704,合勤控,53,32,21,新百王,2024-03-22,6210
6477,安集,22,2,20,新百王,2024-03-22,6210
4958,臻鼎-KY,23,3,20,新百王,2024-03-22,6210
4930,燦星網,19,0,19,新百王,2024-03-22,6210
2301,光寶科,47,28,19,新百王,2024-03-22,6210
2357,華碩,18,1,17,新百王,2024-03-22,6210
00941,中信上游半導體,70,54,16,新百王,2024-03-22,6210
5498,凱崴,15,0,15,新百王,2024-03-22,6210
3147,大綜,19,5,14,新百王,2024-03-22,6210
2354,鴻準,26,12,14,新百王,2024-03-22,6210
2603,長榮,54,40,14,新百王,2024-03-22,6210
2365,昆盈,13,0,13,新百王,2024-03-22,6210
2376,技嘉,66,53,13,新百王,2024-03-22,6210
3622,洋華,17,5,12,新百王,2024-03-22,6210
2303,聯電,25,13,12,新百王,2024-03-22,6210
8940,新天地,12,0,12,新百王,2024-03-22,6210
5521,工信,20,8,12,新百王,2024-03-22,6210
00673R,期元大S＆P原油反1,12,0,12,新百王,2024-03-22,6210
2413,環科,12,0,12,新百王,2024-03-22,6210
2464,盟立,42,30,12,新百王,2024-03-22,6210
1504,東元,24,12,12,新百王,2024-03-22,6210
3005,神基,59,48,11,新百王,2024-03-22,6210
6188,廣明,101,90,11,新百王,2024-03-22,6210
2881,富邦金,13,2,11,新百王,2024-03-22,6210
1514,亞力,34,23,11,新百王,2024-03-22,6210
00931B,統一美債20年,378,0,378,新百王,2024-03-25,6210
00929,復華台灣科技優息,359,40,319,新百王,2024-03-25,6210
2317,鴻海,365,151,214,新百王,2024-03-25,6210
00941,中信上游半導體,311,117,194,新百王,2024-03-25,6210
2356,英業達,225,44,181,新百王,2024-03-25,6210
00939,統一台灣高息動能,171,31,140,新百王,2024-03-25,6210
2344,華邦電,114,13,101,新百王,2024-03-25,6210
2323,中環,210,111,99,新百王,2024-03-25,6210
00937B,群益ESG投等債20,115,32,83,新百王,2024-03-25,6210
00679B,元大美債20年,82,1,81,新百王,2024-03-25,6210
00927,群益半導體收益,65,0,65,新百王,2024-03-25,6210
6285,啟��,51,0,51,新百王,2024-03-25,6210
3056,富華新,45,0,45,新百王,2024-03-25,6210
2537,聯上發,56,13,43,新百王,2024-03-25,6210
2313,華通,49,12,37,新百王,2024-03-25,6210
2486,一詮,96,61,35,新百王,2024-03-25,6210
2890,永豐金,93,60,33,新百王,2024-03-25,6210
4510,高鋒,32,0,32,新百王,2024-03-25,6210
00688L,國泰20年美債正2,71,40,31,新百王,2024-03-25,6210
1714,和桐,30,0,30,新百王,2024-03-25,6210
5443,均豪,33,4,29,新百王,2024-03-25,6210
2382,廣達,36,12,24,新百王,2024-03-25,6210
00687B,國泰20年美債,27,4,23,新百王,2024-03-25,6210
1522,堤維西,22,0,22,新百王,2024-03-25,6210
8473,山林水,22,1,21,新百王,2024-03-25,6210
6189,豐藝,36,18,18,新百王,2024-03-25,6210
1513,中興電,55,39,16,新百王,2024-03-25,6210
1608,華榮,36,20,16,新百王,2024-03-25,6210
1504,東元,32,18,14,新百王,2024-03-25,6210
2897,王道銀行,13,0,13,新百王,2024-03-25,6210
4540,全球傳動,13,0,13,新百王,2024-03-25,6210
3689,湧德,18,5,13,新百王,2024-03-25,6210
2330,台積電,19,6,13,新百王,2024-03-25,6210
6188,廣明,68,56,12,新百王,2024-03-25,6210
00795B,中信美國公債20年,12,0,12,新百王,2024-03-25,6210
3293,鈊象,13,1,12,新百王,2024-03-25,6210
3163,波若威,32,20,12,新百王,2024-03-25,6210
3708,上緯投控,17,5,12,新百王,2024-03-25,6210
3711,日月光投控,23,11,12,新百王,2024-03-25,6210
3035,智原,12,1,11,新百王,2024-03-25,6210
2597,潤弘,11,0,11,新百王,2024-03-25,6210
1460,宏遠,13,2,11,新百王,2024-03-25,6210
3390,旭軟,13,2,11,新百王,2024-03-25,6210
1611,中電,11,0,11,新百王,2024-03-25,6210
3481,群創,10,0,10,新百王,2024-03-25,6210
1582,信錦,17,7,10,新百王,2024-03-25,6210
00633L,富邦上証正2,10,0,10,新百王,2024-03-25,6210
1536,和大,10,0,10,新百王,2024-03-25,6210
2419,仲琦,10,0,10,新百王,2024-03-25,6210
8064,東捷,18,8,10,新百王,2024-03-25,6210
2344,華邦電,580,16,564,新百王,2024-03-26,6210
00939,統一台灣高息動能,628,302,326,新百王,2024-03-26,6210
2618,長榮航,286,10,276,新百王,2024-03-26,6210
6179,亞通,441,205,236,新百王,2024-03-26,6210
2897,王道銀行,120,0,120,新百王,2024-03-26,6210
00688L,國泰20年美債正2,128,20,108,新百王,2024-03-26,6210
2885,元大金,100,2,98,新百王,2024-03-26,6210
2317,鴻海,214,151,63,新百王,2024-03-26,6210
4960,誠美材,66,5,61,新百王,2024-03-26,6210
6215,和椿,74,14,60,新百王,2024-03-26,6210
1307,三芳,110,51,59,新百王,2024-03-26,6210
6274,台燿,73,21,52,新百王,2024-03-26,6210
1808,潤隆,52,2,50,新百王,2024-03-26,6210
00941,中信上游半導體,69,20,49,新百王,2024-03-26,6210
2313,華通,66,28,38,新百王,2024-03-26,6210
2331,精英,55,20,35,新百王,2024-03-26,6210
9105,泰金寶-DR,70,38,32,新百王,2024-03-26,6210
00679B,元大美債20年,31,0,31,新百王,2024-03-26,6210
1714,和桐,30,0,30,新百王,2024-03-26,6210
4167,松瑞藥,30,0,30,新百王,2024-03-26,6210
2417,圓剛,68,43,25,新百王,2024-03-26,6210
020023,元大櫃買半導體N,25,0,25,新百王,2024-03-26,6210
2486,一詮,76,52,24,新百王,2024-03-26,6210
8111,立��,25,2,23,新百王,2024-03-26,6210
8088,品安,22,0,22,新百王,2024-03-26,6210
2356,英業達,77,56,21,新百王,2024-03-26,6210
5607,遠雄港,21,0,21,新百王,2024-03-26,6210
1440,南紡,20,0,20,新百王,2024-03-26,6210
00753L,中信中國50正2,20,0,20,新百王,2024-03-26,6210
00650L,復華香港正2,60,40,20,新百王,2024-03-26,6210
020034,元大IC設計N,20,0,20,新百王,2024-03-26,6210
2382,廣達,64,45,19,新百王,2024-03-26,6210
2353,宏��,26,8,18,新百王,2024-03-26,6210
5483,中美晶,25,7,18,新百王,2024-03-26,6210
3231,緯創,79,62,17,新百王,2024-03-26,6210
2888,新光金,19,2,17,新百王,2024-03-26,6210
6163,華電網,28,11,17,新百王,2024-03-26,6210
00931B,統一美債20年,16,0,16,新百王,2024-03-26,6210
4726,永昕,16,0,16,新百王,2024-03-26,6210
4906,正文,17,1,16,新百王,2024-03-26,6210
00751B,元大AAA至A公司債,15,0,15,新百王,2024-03-26,6210
6284,佳邦,28,13,15,新百王,2024-03-26,6210
5880,合庫金,14,0,14,新百王,2024-03-26,6210
1713,國化,14,1,13,新百王,2024-03-26,6210
2611,志信,14,1,13,新百王,2024-03-26,6210
2354,鴻準,19,7,12,新百王,2024-03-26,6210
3055,蔚華科,15,3,12,新百王,2024-03-26,6210
3022,威強電,12,0,12,新百王,2024-03-26,6210
2610,華航,12,0,12,新百王,2024-03-26,6210
1528,恩德,12,0,12,新百王,2024-03-26,6210
1785,光洋科,192,21,171,新百王,2024-03-27,6210
00941,中信上游半導體,153,3,150,新百王,2024-03-27,6210
00919,群益台灣精選高息,158,55,103,新百王,2024-03-27,6210
2486,一詮,85,2,83,新百王,2024-03-27,6210
2002,中鋼,103,21,82,新百王,2024-03-27,6210
00665L,富邦�琤肭磪囓�2,120,49,71,新百王,2024-03-27,6210
3706,神達,148,81,67,新百王,2024-03-27,6210
2509,全坤建,62,0,62,新百王,2024-03-27,6210
2834,臺企銀,54,1,53,新百王,2024-03-27,6210
00929,復華台灣科技優息,272,221,51,新百王,2024-03-27,6210
1808,潤隆,74,24,50,新百王,2024-03-27,6210
2511,太子,52,3,49,新百王,2024-03-27,6210
00937B,群益ESG投等債20,48,1,47,新百王,2024-03-27,6210
2547,日勝生,42,0,42,新百王,2024-03-27,6210
2634,漢翔,65,24,41,新百王,2024-03-27,6210
00650L,復華香港正2,110,70,40,新百王,2024-03-27,6210
8111,立��,40,5,35,新百王,2024-03-27,6210
9105,泰金寶-DR,30,1,29,新百王,2024-03-27,6210
6179,亞通,71,43,28,新百王,2024-03-27,6210
2442,新美齊,25,0,25,新百王,2024-03-27,6210
00673R,期元大S＆P原油反1,22,0,22,新百王,2024-03-27,6210
2367,燿華,51,30,21,新百王,2024-03-27,6210
8374,羅昇,20,0,20,新百王,2024-03-27,6210
3512,皇龍,20,0,20,新百王,2024-03-27,6210
3005,神基,48,28,20,新百王,2024-03-27,6210
4533,協易機,39,20,19,新百王,2024-03-27,6210
1460,宏遠,19,0,19,新百王,2024-03-27,6210
3231,緯創,34,15,19,新百王,2024-03-27,6210
1605,華新,36,17,19,新百王,2024-03-27,6210
2885,元大金,19,1,18,新百王,2024-03-27,6210
1609,大亞,65,47,18,新百王,2024-03-27,6210
4961,天鈺,29,12,17,新百王,2024-03-27,6210
2884,玉山金,20,3,17,新百王,2024-03-27,6210
1582,信錦,16,0,16,新百王,2024-03-27,6210
5483,中美晶,21,6,15,新百王,2024-03-27,6210
2301,光寶科,33,18,15,新百王,2024-03-27,6210
00751B,元大AAA至A公司債,15,0,15,新百王,2024-03-27,6210
1586,和勤,15,0,15,新百王,2024-03-27,6210
2388,威盛,21,6,15,新百王,2024-03-27,6210
5324,士開,18,4,14,新百王,2024-03-27,6210
2344,華邦電,33,20,13,新百王,2024-03-27,6210
3051,力特,22,9,13,新百王,2024-03-27,6210
2542,興富發,24,11,13,新百王,2024-03-27,6210
00712,復華富時不動產,11,0,11,新百王,2024-03-27,6210
6505,台塑化,11,0,11,新百王,2024-03-27,6210
2601,益航,11,0,11,新百王,2024-03-27,6210
1514,亞力,54,44,10,新百王,2024-03-27,6210
00680L,元大美債20正2,10,0,10,新百王,2024-03-27,6210
2383,台光電,10,0,10,新百王,2024-03-27,6210
00757,統一FANG+,10,0,10,新百王,2024-03-27,6210
2883,凱基金,576,268,308,新百王,2024-03-28,6210
00929,復華台灣科技優息,230,50,180,新百王,2024-03-28,6210
00919,群益台灣精選高息,309,149,160,新百王,2024-03-28,6210
2014,中鴻,80,0,80,新百王,2024-03-28,6210
8121,越峰,74,3,71,新百王,2024-03-28,6210
1326,台化,69,0,69,新百王,2024-03-28,6210
00939,統一台灣高息動能,135,76,59,新百王,2024-03-28,6210
6179,亞通,68,19,49,新百王,2024-03-28,6210
00857B,永豐20年美公債,47,0,47,新百王,2024-03-28,6210
00941,中信上游半導體,84,41,43,新百王,2024-03-28,6210
00882,中信中國高股息,43,2,41,新百王,2024-03-28,6210
1540,喬福,40,0,40,新百王,2024-03-28,6210
1316,上曜,60,23,37,新百王,2024-03-28,6210
6285,啟��,62,27,35,新百王,2024-03-28,6210
8390,金益鼎,33,0,33,新百王,2024-03-28,6210
2845,遠東銀,33,0,33,新百王,2024-03-28,6210
2812,台中銀,33,0,33,新百王,2024-03-28,6210
6126,信音,34,1,33,新百王,2024-03-28,6210
3706,神達,52,19,33,新百王,2024-03-28,6210
2543,皇昌,40,11,29,新百王,2024-03-28,6210
4960,誠美材,27,0,27,新百王,2024-03-28,6210
00937B,群益ESG投等債20,34,8,26,新百王,2024-03-28,6210
2888,新光金,25,0,25,新百王,2024-03-28,6210
2301,光寶科,49,24,25,新百王,2024-03-28,6210
3062,建漢,114,89,25,新百王,2024-03-28,6210
1108,幸福,25,0,25,新百王,2024-03-28,6210
1460,宏遠,29,6,23,新百王,2024-03-28,6210
2328,廣宇,239,218,21,新百王,2024-03-28,6210
00679B,元大美債20年,23,3,20,新百王,2024-03-28,6210
5371,中光電,50,30,20,新百王,2024-03-28,6210
2371,大同,60,42,18,新百王,2024-03-28,6210
5243,乙盛-KY,41,23,18,新百王,2024-03-28,6210
4714,永捷,53,37,16,新百王,2024-03-28,6210
2208,台船,25,9,16,新百王,2024-03-28,6210
00722B,群益投資級電信債,15,0,15,新百王,2024-03-28,6210
2352,佳世達,24,9,15,新百王,2024-03-28,6210
1617,榮星,17,2,15,新百王,2024-03-28,6210
2002,中鋼,18,3,15,新百王,2024-03-28,6210
2330,台積電,20,6,14,新百王,2024-03-28,6210
6170,統振,14,0,14,新百王,2024-03-28,6210
00712,復華富時不動產,13,0,13,新百王,2024-03-28,6210
1723,中碳,13,0,13,新百王,2024-03-28,6210
5443,均豪,21,8,13,新百王,2024-03-28,6210
5512,力麒,38,25,13,新百王,2024-03-28,6210
2637,慧洋-KY,12,0,12,新百王,2024-03-28,6210
1785,光洋科,78,66,12,新百王,2024-03-28,6210
2442,新美齊,11,0,11,新百王,2024-03-28,6210
2369,菱生,12,1,11,新百王,2024-03-28,6210
1725,元禎,12,1,11,新百王,2024-03-28,6210
4113,聯上,10,0,10,新百王,2024-03-28,6210
2317,鴻海,300,107,193,新百王,2024-03-29,6210
4707,磐亞,150,0,150,新百王,2024-03-29,6210
2547,日勝生,100,0,100,新百王,2024-03-29,6210
2332,友訊,77,1,76,新百王,2024-03-29,6210
9105,泰金寶-DR,107,48,59,新百王,2024-03-29,6210
6116,彩晶,55,0,55,新百王,2024-03-29,6210
6443,元晶,71,21,50,新百王,2024-03-29,6210
2301,光寶科,93,44,49,新百王,2024-03-29,6210
00753L,中信中國50正2,45,2,43,新百王,2024-03-29,6210
00664R,國泰臺灣加權反1,40,0,40,新百王,2024-03-29,6210
00680L,元大美債20正2,52,20,32,新百王,2024-03-29,6210
00877,復華中國5G,30,0,30,新百王,2024-03-29,6210
6188,廣明,32,3,29,新百王,2024-03-29,6210
2105,正新,36,10,26,新百王,2024-03-29,6210
8933,愛地雅,25,0,25,新百王,2024-03-29,6210
2324,仁寶,69,45,24,新百王,2024-03-29,6210
3062,建漢,25,4,21,新百王,2024-03-29,6210
8111,立��,20,0,20,新百王,2024-03-29,6210
00650L,復華香港正2,20,0,20,新百王,2024-03-29,6210
2406,國碩,20,0,20,新百王,2024-03-29,6210
1440,南紡,20,0,20,新百王,2024-03-29,6210
4960,誠美材,19,0,19,新百王,2024-03-29,6210
1609,大亞,56,37,19,新百王,2024-03-29,6210
00941,中信上游半導體,30,12,18,新百王,2024-03-29,6210
00655L,國泰中國A50正2,34,16,18,新百王,2024-03-29,6210
5386,青雲,21,3,18,新百王,2024-03-29,6210
4526,東台,32,15,17,新百王,2024-03-29,6210
2354,鴻準,43,26,17,新百王,2024-03-29,6210
00937B,群益ESG投等債20,68,52,16,新百王,2024-03-29,6210
00751B,元大AAA至A公司債,20,4,16,新百王,2024-03-29,6210
020032,元大綠能N,15,0,15,新百王,2024-03-29,6210
00857B,永豐20年美公債,15,0,15,新百王,2024-03-29,6210
1540,喬福,15,0,15,新百王,2024-03-29,6210
2367,燿華,60,45,15,新百王,2024-03-29,6210
6605,帝寶,15,0,15,新百王,2024-03-29,6210
3025,星通,24,9,15,新百王,2024-03-29,6210
5309,系統電,26,12,14,新百王,2024-03-29,6210
8255,朋程,14,0,14,新百王,2024-03-29,6210
3005,神基,47,34,13,新百王,2024-03-29,6210
9924,福興,13,0,13,新百王,2024-03-29,6210
2834,臺企銀,68,55,13,新百王,2024-03-29,6210
8054,安國,71,59,12,新百王,2024-03-29,6210
2486,一詮,14,2,12,新百王,2024-03-29,6210
00757,統一FANG+,11,0,11,新百王,2024-03-29,6210
2543,皇昌,36,25,11,新百王,2024-03-29,6210
1529,樂事綠能,10,0,10,新百王,2024-03-29,6210
8996,高力,28,18,10,新百王,2024-03-29,6210
8085,福華,11,1,10,新百王,2024-03-29,6210
1528,恩德,10,0,10,新百王,2024-03-29,6210
00674R,期元大S＆P黃金反1,10,0,10,新百王,2024-03-29,6210
00940,元大台灣價值高息,825,47,778,新百王,2024-04-01,6210
00929,復華台灣科技優息,375,53,322,新百王,2024-04-01,6210
00632R,元大台灣50反1,291,80,211,新百王,2024-04-01,6210
00941,中信上游半導體,176,0,176,新百王,2024-04-01,6210
00937B,群益ESG投等債20,157,6,151,新百王,2024-04-01,6210
2890,永豐金,126,7,119,新百王,2024-04-01,6210
3036,文曄,98,3,95,新百王,2024-04-01,6210
3231,緯創,144,66,78,新百王,2024-04-01,6210
2486,一詮,97,21,76,新百王,2024-04-01,6210
2009,第一銅,83,10,73,新百王,2024-04-01,6210
1455,集盛,68,1,67,新百王,2024-04-01,6210
2891,中信金,58,2,56,新百王,2024-04-01,6210
3013,晟銘電,126,73,53,新百王,2024-04-01,6210
6269,台郡,51,0,51,新百王,2024-04-01,6210
8121,越峰,50,0,50,新百王,2024-04-01,6210
3711,日月光投控,117,75,42,新百王,2024-04-01,6210
2883,凱基金,40,0,40,新百王,2024-04-01,6210
00680L,元大美債20正2,45,5,40,新百王,2024-04-01,6210
2845,遠東銀,38,0,38,新百王,2024-04-01,6210
00878,國泰永續高股息,63,28,35,新百王,2024-04-01,6210
2603,長榮,61,29,32,新百王,2024-04-01,6210
2317,鴻海,151,121,30,新百王,2024-04-01,6210
3188,鑫龍騰,33,7,26,新百王,2024-04-01,6210
2611,志信,28,4,24,新百王,2024-04-01,6210
00900,富邦特選高股息30,23,0,23,新百王,2024-04-01,6210
00881,國泰台灣5G+,26,3,23,新百王,2024-04-01,6210
00895,富邦未來車,22,0,22,新百王,2024-04-01,6210
6605,帝寶,22,1,21,新百王,2024-04-01,6210
6244,茂迪,22,2,20,新百王,2024-04-01,6210
00877,復華中國5G,20,0,20,新百王,2024-04-01,6210
00664R,國泰臺灣加權反1,20,0,20,新百王,2024-04-01,6210
3059,華晶科,84,65,19,新百王,2024-04-01,6210
2382,廣達,47,29,18,新百王,2024-04-01,6210
00939,統一台灣高息動能,41,23,18,新百王,2024-04-01,6210
8111,立��,20,2,18,新百王,2024-04-01,6210
6219,富旺,28,10,18,新百王,2024-04-01,6210
5351,鈺創,30,13,17,新百王,2024-04-01,6210
5371,中光電,34,18,16,新百王,2024-04-01,6210
2204,中華,15,0,15,新百王,2024-04-01,6210
3034,聯詠,15,0,15,新百王,2024-04-01,6210
8933,愛地雅,15,0,15,新百王,2024-04-01,6210
5871,中租-KY,18,3,15,新百王,2024-04-01,6210
00764B,群益25年美債,15,0,15,新百王,2024-04-01,6210
2884,玉山金,15,0,15,新百王,2024-04-01,6210
2025,千興,15,0,15,新百王,2024-04-01,6210
1582,信錦,19,6,13,新百王,2024-04-01,6210
6443,元晶,23,10,13,新百王,2024-04-01,6210
2330,台積電,17,4,13,新百王,2024-04-01,6210
1609,大亞,36,24,12,新百王,2024-04-01,6210
1316,上曜,30,18,12,新百王,2024-04-01,6210
8064,東捷,588,23,565,新百王,2024-04-02,6210
00688L,國泰20年美債正2,504,0,504,新百王,2024-04-02,6210
00929,復華台灣科技優息,374,17,357,新百王,2024-04-02,6210
00680L,元大美債20正2,335,2,333,新百王,2024-04-02,6210
00940,元大台灣價值高息,259,24,235,新百王,2024-04-02,6210
00937B,群益ESG投等債20,215,42,173,新百王,2024-04-02,6210
00632R,元大台灣50反1,156,0,156,新百王,2024-04-02,6210
2890,永豐金,305,163,142,新百王,2024-04-02,6210
00941,中信上游半導體,130,21,109,新百王,2024-04-02,6210
00687B,國泰20年美債,116,45,71,新百王,2024-04-02,6210
9945,潤泰新,69,1,68,新百王,2024-04-02,6210
6179,亞通,71,11,60,新百王,2024-04-02,6210
00877,復華中國5G,60,0,60,新百王,2024-04-02,6210
00936,台新永續高息中小,60,0,60,新百王,2024-04-02,6210
3706,神達,56,8,48,新百王,2024-04-02,6210
5258,虹堡,47,3,44,新百王,2024-04-02,6210
00753L,中信中國50正2,60,20,40,新百王,2024-04-02,6210
00706L,期元大S＆P日圓正2,36,0,36,新百王,2024-04-02,6210
00637L,元大滬深300正2,79,44,35,新百王,2024-04-02,6210
3056,富華新,34,0,34,新百王,2024-04-02,6210
00919,群益台灣精選高息,38,5,33,新百王,2024-04-02,6210
00751B,元大AAA至A公司債,30,0,30,新百王,2024-04-02,6210
00891,中信關鍵半導體,30,0,30,新百王,2024-04-02,6210
00927,群益半導體收益,30,1,29,新百王,2024-04-02,6210
00720B,元大投資級公司債,28,0,28,新百王,2024-04-02,6210
6592,和潤企業,25,0,25,新百王,2024-04-02,6210
2465,麗臺,25,0,25,新百王,2024-04-02,6210
2467,志聖,36,12,24,新百王,2024-04-02,6210
00655L,國泰中國A50正2,35,12,23,新百王,2024-04-02,6210
5386,青雲,26,4,22,新百王,2024-04-02,6210
6120,達運,60,39,21,新百王,2024-04-02,6210
3013,晟銘電,43,22,21,新百王,2024-04-02,6210
3234,光環,26,5,21,新百王,2024-04-02,6210
1717,長興,27,7,20,新百王,2024-04-02,6210
2701,萬企,20,0,20,新百王,2024-04-02,6210
00788B,元大10年IG電能債,20,0,20,新百王,2024-04-02,6210
2845,遠東銀,20,0,20,新百王,2024-04-02,6210
00726B,國泰新興投等債,19,0,19,新百王,2024-04-02,6210
3707,漢磊,34,15,19,新百王,2024-04-02,6210
3402,漢科,22,3,19,新百王,2024-04-02,6210
00939,統一台灣高息動能,28,10,18,新百王,2024-04-02,6210
00712,復華富時不動產,19,1,18,新百王,2024-04-02,6210
00679B,元大美債20年,41,24,17,新百王,2024-04-02,6210
00931B,統一美債20年,17,0,17,新百王,2024-04-02,6210
2884,玉山金,18,1,17,新百王,2024-04-02,6210
2329,華泰,23,7,16,新百王,2024-04-02,6210
6127,九豪,16,0,16,新百王,2024-04-02,6210
3530,晶相光,17,1,16,新百王,2024-04-02,6210
2888,新光金,16,1,15,新百王,2024-04-02,6210
4113,聯上,15,0,15,新百王,2024-04-02,6210
00688L,國泰20年美債正2,432,5,427,新百王,2024-04-03,6210
6179,亞通,361,2,359,新百王,2024-04-03,6210
00929,復華台灣科技優息,250,0,250,新百王,2024-04-03,6210
00665L,富邦�琤肭磪囓�2,250,36,214,新百王,2024-04-03,6210
4526,東台,150,13,137,新百王,2024-04-03,6210
00937B,群益ESG投等債20,123,0,123,新百王,2024-04-03,6210
1434,福懋,110,0,110,新百王,2024-04-03,6210
00931B,統一美債20年,105,0,105,新百王,2024-04-03,6210
00720B,元大投資級公司債,77,0,77,新百王,2024-04-03,6210
00687B,國泰20年美債,79,3,76,新百王,2024-04-03,6210
2412,中華電,69,0,69,新百王,2024-04-03,6210
1524,耿鼎,73,4,69,新百王,2024-04-03,6210
00933B,國泰10Y+金融債,62,0,62,新百王,2024-04-03,6210
00940,元大台灣價值高息,72,10,62,新百王,2024-04-03,6210
6462,神盾,87,26,61,新百王,2024-04-03,6210
2701,萬企,60,0,60,新百王,2024-04-03,6210
3056,富華新,57,0,57,新百王,2024-04-03,6210
2031,新光鋼,58,8,50,新百王,2024-04-03,6210
2382,廣達,101,57,44,新百王,2024-04-03,6210
2887,台新金,42,1,41,新百王,2024-04-03,6210
00941,中信上游半導體,45,4,41,新百王,2024-04-03,6210
9946,三發地產,41,0,41,新百王,2024-04-03,6210
2486,一詮,176,136,40,新百王,2024-04-03,6210
2884,玉山金,39,2,37,新百王,2024-04-03,6210
00753L,中信中國50正2,37,0,37,新百王,2024-04-03,6210
00680L,元大美債20正2,36,0,36,新百王,2024-04-03,6210
2888,新光金,41,6,35,新百王,2024-04-03,6210
1326,台化,35,0,35,新百王,2024-04-03,6210
2515,中工,143,111,32,新百王,2024-04-03,6210
2317,鴻海,138,107,31,新百王,2024-04-03,6210
00905,FT臺灣Smart,30,0,30,新百王,2024-04-03,6210
3032,偉訓,42,15,27,新百王,2024-04-03,6210
3010,華立,37,11,26,新百王,2024-04-03,6210
2845,遠東銀,26,0,26,新百王,2024-04-03,6210
00857B,永豐20年美公債,27,2,25,新百王,2024-04-03,6210
2851,中再保,25,0,25,新百王,2024-04-03,6210
2547,日勝生,25,0,25,新百王,2024-04-03,6210
00919,群益台灣精選高息,44,20,24,新百王,2024-04-03,6210
2867,三商壽,31,10,21,新百王,2024-04-03,6210
1909,榮成,21,0,21,新百王,2024-04-03,6210
3545,敦泰,22,1,21,新百王,2024-04-03,6210
00795B,中信美國公債20年,25,5,20,新百王,2024-04-03,6210
00670L,富邦NASDAQ正2,20,0,20,新百王,2024-04-03,6210
00751B,元大AAA至A公司債,20,0,20,新百王,2024-04-03,6210
00830,國泰費城半導體,20,0,20,新百王,2024-04-03,6210
00676R,富邦臺灣加權反1,20,0,20,新百王,2024-04-03,6210
3450,聯鈞,46,26,20,新百王,2024-04-03,6210
4909,新復興,31,11,20,新百王,2024-04-03,6210
911608,明輝-DR,20,0,20,新百王,2024-04-03,6210
2883,凱基金,30,10,20,新百王,2024-04-03,6210
00929,復華台灣科技優息,281,10,271,新百王,2024-04-08,6210
00937B,群益ESG投等債20,241,0,241,新百王,2024-04-08,6210
00632R,元大台灣50反1,370,180,190,新百王,2024-04-08,6210
6120,達運,435,263,172,新百王,2024-04-08,6210
2486,一詮,322,164,158,新百王,2024-04-08,6210
00688L,國泰20年美債正2,150,0,150,新百王,2024-04-08,6210
00931B,統一美債20年,115,7,108,新百王,2024-04-08,6210
2852,第一保,106,0,106,新百王,2024-04-08,6210
00687B,國泰20年美債,130,38,92,新百王,2024-04-08,6210
00751B,元大AAA至A公司債,88,0,88,新百王,2024-04-08,6210
00680L,元大美債20正2,63,0,63,新百王,2024-04-08,6210
1108,幸福,110,51,59,新百王,2024-04-08,6210
00679B,元大美債20年,59,0,59,新百王,2024-04-08,6210
00712,復華富時不動產,50,0,50,新百王,2024-04-08,6210
1524,耿鼎,42,2,40,新百王,2024-04-08,6210
8064,東捷,51,14,37,新百王,2024-04-08,6210
00637L,元大滬深300正2,86,51,35,新百王,2024-04-08,6210
6462,神盾,64,32,32,新百王,2024-04-08,6210
2371,大同,45,17,28,新百王,2024-04-08,6210
00941,中信上游半導體,24,0,24,新百王,2024-04-08,6210
8926,台汽電,23,0,23,新百王,2024-04-08,6210
2374,佳能,61,38,23,新百王,2024-04-08,6210
3035,智原,22,0,22,新百王,2024-04-08,6210
00927,群益半導體收益,21,0,21,新百王,2024-04-08,6210
4561,健椿,25,4,21,新百王,2024-04-08,6210
5324,士開,22,2,20,新百王,2024-04-08,6210
2611,志信,35,16,19,新百王,2024-04-08,6210
1909,榮成,18,0,18,新百王,2024-04-08,6210
2618,長榮航,18,1,17,新百王,2024-04-08,6210
00720B,元大投資級公司債,16,0,16,新百王,2024-04-08,6210
9946,三發地產,16,0,16,新百王,2024-04-08,6210
2820,華票,16,0,16,新百王,2024-04-08,6210
2701,萬企,15,0,15,新百王,2024-04-08,6210
1802,台玻,15,0,15,新百王,2024-04-08,6210
6901,鑽石投資,15,0,15,新百王,2024-04-08,6210
5443,均豪,69,54,15,新百王,2024-04-08,6210
2393,億光,13,0,13,新百王,2024-04-08,6210
4109,加捷生醫,16,3,13,新百王,2024-04-08,6210
2014,中鴻,15,3,12,新百王,2024-04-08,6210
4958,臻鼎-KY,15,3,12,新百王,2024-04-08,6210
00795B,中信美國公債20年,12,0,12,新百王,2024-04-08,6210
00857B,永豐20年美公債,12,0,12,新百王,2024-04-08,6210
2881,富邦金,13,1,12,新百王,2024-04-08,6210
00940,元大台灣價值高息,101,90,11,新百王,2024-04-08,6210
2485,兆赫,11,0,11,新百王,2024-04-08,6210
4923,力士,11,0,11,新百王,2024-04-08,6210
3034,聯詠,12,1,11,新百王,2024-04-08,6210
2356,英業達,12,2,10,新百王,2024-04-08,6210
6189,豐藝,27,17,10,新百王,2024-04-08,6210
4953,緯軟,10,0,10,新百王,2024-04-08,6210
00937B,群益ESG投等債20,197,20,177,新百王,2024-04-09,6210
00753L,中信中國50正2,100,1,99,新百王,2024-04-09,6210
2884,玉山金,100,3,97,新百王,2024-04-09,6210
00637L,元大滬深300正2,101,20,81,新百王,2024-04-09,6210
8064,東捷,78,3,75,新百王,2024-04-09,6210
2467,志聖,84,18,66,新百王,2024-04-09,6210
2412,中華電,60,0,60,新百王,2024-04-09,6210
00676R,富邦臺灣加權反1,60,0,60,新百王,2024-04-09,6210
00940,元大台灣價值高息,119,60,59,新百王,2024-04-09,6210
00655L,國泰中國A50正2,57,0,57,新百王,2024-04-09,6210
6290,良維,55,2,53,新百王,2024-04-09,6210
6735,美達科技,44,0,44,新百王,2024-04-09,6210
3231,緯創,154,111,43,新百王,2024-04-09,6210
2030,彰源,44,6,38,新百王,2024-04-09,6210
9946,三發地產,45,7,38,新百王,2024-04-09,6210
3052,夆典,36,1,35,新百王,2024-04-09,6210
8437,大地-KY,30,0,30,新百王,2024-04-09,6210
2486,一詮,172,143,29,新百王,2024-04-09,6210
1609,大亞,154,127,27,新百王,2024-04-09,6210
00939,統一台灣高息動能,27,1,26,新百王,2024-04-09,6210
00733,富邦臺灣中小,27,2,25,新百王,2024-04-09,6210
00929,復華台灣科技優息,23,0,23,新百王,2024-04-09,6210
1617,榮星,22,0,22,新百王,2024-04-09,6210
1104,環泥,22,1,21,新百王,2024-04-09,6210
4923,力士,21,0,21,新百王,2024-04-09,6210
2855,統一證,28,7,21,新百王,2024-04-09,6210
6189,豐藝,51,31,20,新百王,2024-04-09,6210
6284,佳邦,40,20,20,新百王,2024-04-09,6210
2371,大同,56,36,20,新百王,2024-04-09,6210
6788,華景電,22,2,20,新百王,2024-04-09,6210
6578,達邦蛋白,38,18,20,新百王,2024-04-09,6210
2547,日勝生,18,0,18,新百王,2024-04-09,6210
2442,新美齊,18,0,18,新百王,2024-04-09,6210
2630,亞航,43,26,17,新百王,2024-04-09,6210
00679B,元大美債20年,17,0,17,新百王,2024-04-09,6210
3010,華立,21,5,16,新百王,2024-04-09,6210
2101,南港,31,15,16,新百王,2024-04-09,6210
3005,神基,41,25,16,新百王,2024-04-09,6210
2313,華通,45,29,16,新百王,2024-04-09,6210
5515,建國,16,0,16,新百王,2024-04-09,6210
5521,工信,31,15,16,新百王,2024-04-09,6210
1802,台玻,15,0,15,新百王,2024-04-09,6210
3163,波若威,35,20,15,新百王,2024-04-09,6210
2534,宏盛,15,0,15,新百王,2024-04-09,6210
6179,亞通,14,0,14,新百王,2024-04-09,6210
3481,群創,25,11,14,新百王,2024-04-09,6210
2317,鴻海,122,108,14,新百王,2024-04-09,6210
2498,宏達電,23,10,13,新百王,2024-04-09,6210
3622,洋華,32,19,13,新百王,2024-04-09,6210
6770,力積電,14,1,13,新百王,2024-04-09,6210
2464,盟立,210,49,161,新百王,2024-04-10,6210
2888,新光金,159,41,118,新百王,2024-04-10,6210
2890,永豐金,206,95,111,新百王,2024-04-10,6210
5521,工信,108,0,108,新百王,2024-04-10,6210
2363,矽統,307,199,108,新百王,2024-04-10,6210
00637L,元大滬深300正2,169,80,89,新百王,2024-04-10,6210
00929,復華台灣科技優息,139,52,87,新百王,2024-04-10,6210
00931B,統一美債20年,83,1,82,新百王,2024-04-10,6210
2101,南港,125,45,80,新百王,2024-04-10,6210
2547,日勝生,88,10,78,新百王,2024-04-10,6210
00795B,中信美國公債20年,77,5,72,新百王,2024-04-10,6210
00937B,群益ESG投等債20,53,0,53,新百王,2024-04-10,6210
1711,永光,47,2,45,新百王,2024-04-10,6210
2515,中工,81,38,43,新百王,2024-04-10,6210
3033,威健,55,16,39,新百王,2024-04-10,6210
2344,華邦電,72,34,38,新百王,2024-04-10,6210
2382,廣達,55,20,35,新百王,2024-04-10,6210
00918,大華優利高填息30,34,0,34,新百王,2024-04-10,6210
2753,八方雲集,34,0,34,新百王,2024-04-10,6210
2109,華豐,34,2,32,新百王,2024-04-10,6210
3701,大眾控,35,5,30,新百王,2024-04-10,6210
4545,銘鈺,30,0,30,新百王,2024-04-10,6210
2511,太子,30,0,30,新百王,2024-04-10,6210
3032,偉訓,32,2,30,新百王,2024-04-10,6210
1524,耿鼎,33,4,29,新百王,2024-04-10,6210
3260,威剛,71,44,27,新百王,2024-04-10,6210
00679B,元大美債20年,26,0,26,新百王,2024-04-10,6210
00706L,期元大S＆P日圓正2,25,0,25,新百王,2024-04-10,6210
4533,協易機,63,38,25,新百王,2024-04-10,6210
00733,富邦臺灣中小,22,0,22,新百王,2024-04-10,6210
3708,上緯投控,22,1,21,新百王,2024-04-10,6210
2634,漢翔,88,67,21,新百王,2024-04-10,6210
5381,合正,22,1,21,新百王,2024-04-10,6210
6016,康和證,22,1,21,新百王,2024-04-10,6210
00878,國泰永續高股息,22,1,21,新百王,2024-04-10,6210
1504,東元,27,7,20,新百王,2024-04-10,6210
2031,新光鋼,22,2,20,新百王,2024-04-10,6210
2885,元大金,21,1,20,新百王,2024-04-10,6210
1108,幸福,20,0,20,新百王,2024-04-10,6210
4927,泰鼎-KY,20,0,20,新百王,2024-04-10,6210
9105,泰金寶-DR,40,21,19,新百王,2024-04-10,6210
2884,玉山金,20,1,19,新百王,2024-04-10,6210
00919,群益台灣精選高息,25,8,17,新百王,2024-04-10,6210
6113,亞矽,20,3,17,新百王,2024-04-10,6210
1460,宏遠,16,0,16,新百王,2024-04-10,6210
1604,聲寶,16,0,16,新百王,2024-04-10,6210
8033,雷虎,27,12,15,新百王,2024-04-10,6210
2527,宏璟,14,0,14,新百王,2024-04-10,6210
3092,鴻碩,14,0,14,新百王,2024-04-10,6210
5425,台半,15,1,14,新百王,2024-04-10,6210
2002,中鋼,513,0,513,新百王,2024-04-11,6210
00688L,國泰20年美債正2,396,0,396,新百王,2024-04-11,6210
2885,元大金,213,0,213,新百王,2024-04-11,6210
00687B,國泰20年美債,164,0,164,新百王,2024-04-11,6210
3481,群創,273,110,163,新百王,2024-04-11,6210
00937B,群益ESG投等債20,335,220,115,新百王,2024-04-11,6210
00929,復華台灣科技優息,119,21,98,新百王,2024-04-11,6210
3036,文曄,143,48,95,新百王,2024-04-11,6210
1605,華新,103,25,78,新百王,2024-04-11,6210
00679B,元大美債20年,77,0,77,新百王,2024-04-11,6210
2534,宏盛,85,12,73,新百王,2024-04-11,6210
2486,一詮,75,2,73,新百王,2024-04-11,6210
00864B,中信美國公債0-1,97,27,70,新百王,2024-04-11,6210
2890,永豐金,351,285,66,新百王,2024-04-11,6210
2607,榮運,64,1,63,新百王,2024-04-11,6210
6116,彩晶,62,0,62,新百王,2024-04-11,6210
00933B,國泰10Y+金融債,119,60,59,新百王,2024-04-11,6210
3060,銘異,93,37,56,新百王,2024-04-11,6210
9946,三發地產,53,0,53,新百王,2024-04-11,6210
2514,龍邦,53,1,52,新百王,2024-04-11,6210
6266,泰詠,50,0,50,新百王,2024-04-11,6210
6127,九豪,45,0,45,新百王,2024-04-11,6210
00733,富邦臺灣中小,42,1,41,新百王,2024-04-11,6210
00712,復華富時不動產,51,10,41,新百王,2024-04-11,6210
00650L,復華香港正2,50,10,40,新百王,2024-04-11,6210
3171,炎洲流通,35,0,35,新百王,2024-04-11,6210
2888,新光金,30,0,30,新百王,2024-04-11,6210
2442,新美齊,40,10,30,新百王,2024-04-11,6210
2867,三商壽,30,0,30,新百王,2024-04-11,6210
00751B,元大AAA至A公司債,29,0,29,新百王,2024-04-11,6210
00720B,元大投資級公司債,28,0,28,新百王,2024-04-11,6210
2501,國建,33,8,25,新百王,2024-04-11,6210
1307,三芳,28,3,25,新百王,2024-04-11,6210
8088,品安,64,41,23,新百王,2024-04-11,6210
8096,擎亞,86,63,23,新百王,2024-04-11,6210
2610,華航,50,27,23,新百王,2024-04-11,6210
2887,台新金,22,0,22,新百王,2024-04-11,6210
00680L,元大美債20正2,36,14,22,新百王,2024-04-11,6210
3002,歐格,22,1,21,新百王,2024-04-11,6210
9907,統一實,20,0,20,新百王,2024-04-11,6210
2732,六角,20,0,20,新百王,2024-04-11,6210
3231,緯創,69,49,20,新百王,2024-04-11,6210
2493,揚博,21,1,20,新百王,2024-04-11,6210
5381,合正,21,2,19,新百王,2024-04-11,6210
1612,宏泰,22,3,19,新百王,2024-04-11,6210
2498,宏達電,18,0,18,新百王,2024-04-11,6210
6282,康舒,40,23,17,新百王,2024-04-11,6210
9945,潤泰新,19,3,16,新百王,2024-04-11,6210
3013,晟銘電,86,70,16,新百王,2024-04-11,6210
5521,工信,47,32,15,新百王,2024-04-11,6210
8064,東捷,974,33,941,新百王,2024-04-12,6210
00929,復華台灣科技優息,261,7,254,新百王,2024-04-12,6210
00753L,中信中國50正2,200,0,200,新百王,2024-04-12,6210
00665L,富邦�琤肭磪囓�2,244,48,196,新百王,2024-04-12,6210
4526,東台,211,19,192,新百王,2024-04-12,6210
00632R,元大台灣50反1,211,105,106,新百王,2024-04-12,6210
2897,王道銀行,194,90,104,新百王,2024-04-12,6210
00931B,統一美債20年,100,0,100,新百王,2024-04-12,6210
2867,三商壽,101,10,91,新百王,2024-04-12,6210
5512,力麒,93,4,89,新百王,2024-04-12,6210
1582,信錦,79,2,77,新百王,2024-04-12,6210
00937B,群益ESG投等債20,133,57,76,新百王,2024-04-12,6210
5381,合正,127,54,73,新百王,2024-04-12,6210
2405,輔信,79,7,72,新百王,2024-04-12,6210
8936,國統,80,17,63,新百王,2024-04-12,6210
00688L,國泰20年美債正2,56,0,56,新百王,2024-04-12,6210
00940,元大台灣價值高息,75,23,52,新百王,2024-04-12,6210
2009,第一銅,82,33,49,新百王,2024-04-12,6210
2618,長榮航,120,74,46,新百王,2024-04-12,6210
00864B,中信美國公債0-1,40,0,40,新百王,2024-04-12,6210
2610,華航,273,234,39,新百王,2024-04-12,6210
2534,宏盛,34,0,34,新百王,2024-04-12,6210
2845,遠東銀,32,0,32,新百王,2024-04-12,6210
00637L,元大滬深300正2,61,30,31,新百王,2024-04-12,6210
1611,中電,47,17,30,新百王,2024-04-12,6210
1904,正隆,30,0,30,新百王,2024-04-12,6210
2101,南港,30,1,29,新百王,2024-04-12,6210
00725B,國泰投資級公司債,29,0,29,新百王,2024-04-12,6210
2852,第一保,54,28,26,新百王,2024-04-12,6210
00650L,復華香港正2,25,0,25,新百王,2024-04-12,6210
1314,中石化,30,6,24,新百王,2024-04-12,6210
1307,三芳,30,6,24,新百王,2024-04-12,6210
8931,大汽電,23,0,23,新百王,2024-04-12,6210
6113,亞矽,22,0,22,新百王,2024-04-12,6210
2596,綠意,22,0,22,新百王,2024-04-12,6210
00881,國泰台灣5G+,22,0,22,新百王,2024-04-12,6210
2886,兆豐金,57,35,22,新百王,2024-04-12,6210
2887,台新金,21,0,21,新百王,2024-04-12,6210
00679B,元大美債20年,20,0,20,新百王,2024-04-12,6210
3481,群創,48,28,20,新百王,2024-04-12,6210
2608,嘉里大榮,20,0,20,新百王,2024-04-12,6210
6125,廣運,33,14,19,新百王,2024-04-12,6210
2501,國建,26,8,18,新百王,2024-04-12,6210
4744,皇將,24,6,18,新百王,2024-04-12,6210
1570,力肯,18,0,18,新百王,2024-04-12,6210
2888,新光金,20,3,17,新百王,2024-04-12,6210
00655L,國泰中國A50正2,16,0,16,新百王,2024-04-12,6210
6219,富旺,16,0,16,新百王,2024-04-12,6210
1101,台泥,20,4,16,新百王,2024-04-12,6210
9946,三發地產,15,0,15,新百王,2024-04-12,6210
00929,復華台灣科技優息,223,62,161,新百王,2024-04-15,6210
00927,群益半導體收益,155,0,155,新百王,2024-04-15,6210
1314,中石化,118,11,107,新百王,2024-04-15,6210
2002,中鋼,68,4,64,新百王,2024-04-15,6210
4526,東台,53,3,50,新百王,2024-04-15,6210
00733,富邦臺灣中小,60,15,45,新百王,2024-04-15,6210
4960,誠美材,65,20,45,新百王,2024-04-15,6210
8936,國統,56,11,45,新百王,2024-04-15,6210
0056,元大高股息,45,5,40,新百王,2024-04-15,6210
2356,英業達,58,23,35,新百王,2024-04-15,6210
6213,聯茂,64,29,35,新百王,2024-04-15,6210
6215,和椿,52,17,35,新百王,2024-04-15,6210
00937B,群益ESG投等債20,45,14,31,新百王,2024-04-15,6210
2331,精英,45,14,31,新百王,2024-04-15,6210
2888,新光金,32,1,31,新百王,2024-04-15,6210
00941,中信上游半導體,30,0,30,新百王,2024-04-15,6210
2618,長榮航,47,19,28,新百王,2024-04-15,6210
2883,凱基金,27,0,27,新百王,2024-04-15,6210
2367,燿華,65,39,26,新百王,2024-04-15,6210
1603,華電,106,80,26,新百王,2024-04-15,6210
1301,台塑,26,0,26,新百王,2024-04-15,6210
5443,均豪,40,16,24,新百王,2024-04-15,6210
3312,弘憶股,76,53,23,新百王,2024-04-15,6210
1611,中電,24,1,23,新百王,2024-04-15,6210
1513,中興電,116,95,21,新百王,2024-04-15,6210
00670L,富邦NASDAQ正2,21,1,20,新百王,2024-04-15,6210
1305,華夏,20,0,20,新百王,2024-04-15,6210
8064,東捷,36,17,19,新百王,2024-04-15,6210
3701,大眾控,18,0,18,新百王,2024-04-15,6210
5515,建國,19,1,18,新百王,2024-04-15,6210
2506,太設,17,0,17,新百王,2024-04-15,6210
8088,品安,19,3,16,新百王,2024-04-15,6210
2743,山富,23,7,16,新百王,2024-04-15,6210
2852,第一保,15,0,15,新百王,2024-04-15,6210
00650L,復華香港正2,35,20,15,新百王,2024-04-15,6210
3188,鑫龍騰,15,0,15,新百王,2024-04-15,6210
2208,台船,19,4,15,新百王,2024-04-15,6210
2329,華泰,45,30,15,新百王,2024-04-15,6210
00665L,富邦�琤肭磪囓�2,206,192,14,新百王,2024-04-15,6210
3231,緯創,54,40,14,新百王,2024-04-15,6210
2406,國碩,15,1,14,新百王,2024-04-15,6210
1785,光洋科,56,42,14,新百王,2024-04-15,6210
00940,元大台灣價值高息,56,42,14,新百王,2024-04-15,6210
1514,亞力,113,99,14,新百王,2024-04-15,6210
1618,合機,53,39,14,新百王,2024-04-15,6210
2467,志聖,13,0,13,新百王,2024-04-15,6210
1587,吉茂,13,0,13,新百王,2024-04-15,6210
8222,寶一,20,8,12,新百王,2024-04-15,6210
6770,力積電,12,0,12,新百王,2024-04-15,6210
00757,統一FANG+,12,0,12,新百王,2024-04-15,6210
2344,華邦電,1628,7,1621,新百王,2024-04-16,6210
00940,元大台灣價值高息,345,10,335,新百王,2024-04-16,6210
00937B,群益ESG投等債20,340,21,319,新百王,2024-04-16,6210
00929,復華台灣科技優息,329,26,303,新百王,2024-04-16,6210
00665L,富邦�琤肭磪囓�2,318,64,254,新百王,2024-04-16,6210
2897,王道銀行,231,0,231,新百王,2024-04-16,6210
2881,富邦金,214,7,207,新百王,2024-04-16,6210
2890,永豐金,364,161,203,新百王,2024-04-16,6210
2511,太子,120,0,120,新百王,2024-04-16,6210
2331,精英,113,1,112,新百王,2024-04-16,6210
2408,南亞科,107,0,107,新百王,2024-04-16,6210
2883B,凱基金乙特,100,0,100,新百王,2024-04-16,6210
00919,群益台灣精選高息,154,68,86,新百王,2024-04-16,6210
00688L,國泰20年美債正2,85,0,85,新百王,2024-04-16,6210
4716,大立,95,13,82,新百王,2024-04-16,6210
00931B,統一美債20年,77,0,77,新百王,2024-04-16,6210
00712,復華富時不動產,85,13,72,新百王,2024-04-16,6210
3711,日月光投控,77,13,64,新百王,2024-04-16,6210
1605,華新,93,32,61,新百王,2024-04-16,6210
00650L,復華香港正2,110,50,60,新百王,2024-04-16,6210
2534,宏盛,55,0,55,新百王,2024-04-16,6210
2610,華航,52,0,52,新百王,2024-04-16,6210
2605,新興,60,10,50,新百王,2024-04-16,6210
2753,八方雲集,50,2,48,新百王,2024-04-16,6210
00852L,國泰美國道瓊正2,48,1,47,新百王,2024-04-16,6210
3481,群創,126,81,45,新百王,2024-04-16,6210
6215,和椿,46,1,45,新百王,2024-04-16,6210
2884,玉山金,45,1,44,新百王,2024-04-16,6210
00753L,中信中國50正2,42,0,42,新百王,2024-04-16,6210
3231,緯創,94,52,42,新百王,2024-04-16,6210
2701,萬企,40,0,40,新百王,2024-04-16,6210
2618,長榮航,50,12,38,新百王,2024-04-16,6210
2317,鴻海,162,128,34,新百王,2024-04-16,6210
5009,榮剛,46,15,31,新百王,2024-04-16,6210
2887,台新金,47,16,31,新百王,2024-04-16,6210
2888,新光金,34,5,29,新百王,2024-04-16,6210
2515,中工,29,0,29,新百王,2024-04-16,6210
00680L,元大美債20正2,64,36,28,新百王,2024-04-16,6210
3706,神達,43,16,27,新百王,2024-04-16,6210
00885,富邦越南,28,1,27,新百王,2024-04-16,6210
1216,統一,24,0,24,新百王,2024-04-16,6210
2323,中環,24,0,24,新百王,2024-04-16,6210
00720B,元大投資級公司債,23,0,23,新百王,2024-04-16,6210
0056,元大高股息,58,35,23,新百王,2024-04-16,6210
1717,長興,22,0,22,新百王,2024-04-16,6210
9946,三發地產,27,6,21,新百王,2024-04-16,6210
1616,億泰,21,0,21,新百王,2024-04-16,6210
2883,凱基金,362,342,20,新百王,2024-04-16,6210
00671R,富邦NASDAQ反1,20,0,20,新百王,2024-04-16,6210
2498,宏達電,19,1,18,新百王,2024-04-16,6210
4526,東台,532,1,531,新百王,2024-04-17,6210
00632R,元大台灣50反1,345,80,265,新百王,2024-04-17,6210
2618,長榮航,254,6,248,新百王,2024-04-17,6210
2897,王道銀行,207,0,207,新百王,2024-04-17,6210
00688L,國泰20年美債正2,203,8,195,新百王,2024-04-17,6210
00665L,富邦�琤肭磪囓�2,168,64,104,新百王,2024-04-17,6210
3481,群創,102,5,97,新百王,2024-04-17,6210
00929,復華台灣科技優息,84,5,79,新百王,2024-04-17,6210
00712,復華富時不動產,77,10,67,新百王,2024-04-17,6210
2630,亞航,112,52,60,新百王,2024-04-17,6210
1108,幸福,60,1,59,新百王,2024-04-17,6210
00680L,元大美債20正2,57,0,57,新百王,2024-04-17,6210
2501,國建,62,6,56,新百王,2024-04-17,6210
2506,太設,56,0,56,新百王,2024-04-17,6210
00908,富邦入息REITs+,55,0,55,新百王,2024-04-17,6210
4726,永昕,53,1,52,新百王,2024-04-17,6210
2882,國泰金,51,0,51,新百王,2024-04-17,6210
1904,正隆,50,0,50,新百王,2024-04-17,6210
1540,喬福,52,2,50,新百王,2024-04-17,6210
3231,緯創,97,54,43,新百王,2024-04-17,6210
2884,玉山金,39,0,39,新百王,2024-04-17,6210
2881,富邦金,37,1,36,新百王,2024-04-17,6210
3027,盛達,68,33,35,新百王,2024-04-17,6210
00927,群益半導體收益,53,20,33,新百王,2024-04-17,6210
6274,台燿,44,12,32,新百王,2024-04-17,6210
3178,公準,45,13,32,新百王,2024-04-17,6210
8064,東捷,41,10,31,新百王,2024-04-17,6210
00857B,永豐20年美公債,30,0,30,新百王,2024-04-17,6210
00687B,國泰20年美債,30,0,30,新百王,2024-04-17,6210
9946,三發地產,30,0,30,新百王,2024-04-17,6210
1909,榮成,120,90,30,新百王,2024-04-17,6210
00931B,統一美債20年,47,18,29,新百王,2024-04-17,6210
00891,中信關鍵半導體,54,25,29,新百王,2024-04-17,6210
0056,元大高股息,40,11,29,新百王,2024-04-17,6210
1789,神隆,27,0,27,新百王,2024-04-17,6210
00733,富邦臺灣中小,34,8,26,新百王,2024-04-17,6210
00720B,元大投資級公司債,28,3,25,新百王,2024-04-17,6210
00650L,復華香港正2,25,0,25,新百王,2024-04-17,6210
2442,新美齊,25,0,25,新百王,2024-04-17,6210
2505,國揚,24,0,24,新百王,2024-04-17,6210
2353,宏��,31,8,23,新百王,2024-04-17,6210
00725B,國泰投資級公司債,22,0,22,新百王,2024-04-17,6210
8440,綠電,32,11,21,新百王,2024-04-17,6210
5371,中光電,37,17,20,新百王,2024-04-17,6210
6219,富旺,20,0,20,新百王,2024-04-17,6210
6182,合晶,34,16,18,新百王,2024-04-17,6210
8147,正淩,20,2,18,新百王,2024-04-17,6210
1810,和成,59,43,16,新百王,2024-04-17,6210
4916,事欣科,18,3,15,新百王,2024-04-17,6210
2867,三商壽,66,51,15,新百王,2024-04-17,6210
9105,泰金寶-DR,200,0,200,新百王,2024-04-18,6210
00753L,中信中國50正2,205,10,195,新百王,2024-04-18,6210
2897,王道銀行,100,0,100,新百王,2024-04-18,6210
8064,東捷,78,0,78,新百王,2024-04-18,6210
00637L,元大滬深300正2,118,46,72,新百王,2024-04-18,6210
3711,日月光投控,68,11,57,新百王,2024-04-18,6210
2367,燿華,87,33,54,新百王,2024-04-18,6210
00937B,群益ESG投等債20,74,20,54,新百王,2024-04-18,6210
2515,中工,138,84,54,新百王,2024-04-18,6210
1615,大山,85,32,53,新百王,2024-04-18,6210
2337,旺宏,50,0,50,新百王,2024-04-18,6210
2030,彰源,50,1,49,新百王,2024-04-18,6210
2610,華航,55,6,49,新百王,2024-04-18,6210
2371,大同,404,360,44,新百王,2024-04-18,6210
4510,高鋒,36,0,36,新百王,2024-04-18,6210
4532,瑞智,39,6,33,新百王,2024-04-18,6210
8085,福華,31,0,31,新百王,2024-04-18,6210
1104,環泥,29,1,28,新百王,2024-04-18,6210
1810,和成,34,6,28,新百王,2024-04-18,6210
8121,越峰,28,0,28,新百王,2024-04-18,6210
00941,中信上游半導體,56,29,27,新百王,2024-04-18,6210
2882,國泰金,32,5,27,新百王,2024-04-18,6210
2374,佳能,46,20,26,新百王,2024-04-18,6210
1540,喬福,32,7,25,新百王,2024-04-18,6210
6585,鼎基,22,0,22,新百王,2024-04-18,6210
1584,精剛,33,12,21,新百王,2024-04-18,6210
5443,均豪,20,0,20,新百王,2024-04-18,6210
1605,華新,373,354,19,新百王,2024-04-18,6210
00632R,元大台灣50反1,207,188,19,新百王,2024-04-18,6210
1785,光洋科,20,1,19,新百王,2024-04-18,6210
3437,榮創,15,0,15,新百王,2024-04-18,6210
2408,南亞科,17,2,15,新百王,2024-04-18,6210
00885,富邦越南,15,0,15,新百王,2024-04-18,6210
6806,森崴能源,24,9,15,新百王,2024-04-18,6210
2537,聯上發,21,7,14,新百王,2024-04-18,6210
9962,有益,12,0,12,新百王,2024-04-18,6210
00712,復華富時不動產,12,0,12,新百王,2024-04-18,6210
2344,華邦電,14,3,11,新百王,2024-04-18,6210
00931B,統一美債20年,11,0,11,新百王,2024-04-18,6210
9955,佳龍,28,17,11,新百王,2024-04-18,6210
6198,瑞築,12,1,11,新百王,2024-04-18,6210
2103,台橡,11,0,11,新百王,2024-04-18,6210
2427,三商電,97,86,11,新百王,2024-04-18,6210
9911,櫻花,11,0,11,新百王,2024-04-18,6210
6141,柏承,10,0,10,新百王,2024-04-18,6210
5864,致和證,10,0,10,新百王,2024-04-18,6210
5324,士開,10,0,10,新百王,2024-04-18,6210
2028,威致,12,2,10,新百王,2024-04-18,6210
2605,新興,12,2,10,新百王,2024-04-18,6210
6005,群益證,19,9,10,新百王,2024-04-18,6210
2882,國泰金,205,0,205,新百王,2024-04-19,6210
00937B,群益ESG投等債20,231,44,187,新百王,2024-04-19,6210
00665L,富邦�琤肭磪囓�2,302,124,178,新百王,2024-04-19,6210
3036,文曄,155,34,121,新百王,2024-04-19,6210
1326,台化,110,0,110,新百王,2024-04-19,6210
2881,富邦金,106,7,99,新百王,2024-04-19,6210
2618,長榮航,112,22,90,新百王,2024-04-19,6210
1905,華紙,103,21,82,新百王,2024-04-19,6210
2890,永豐金,420,348,72,新百王,2024-04-19,6210
2303,聯電,75,3,72,新百王,2024-04-19,6210
2317,鴻海,296,234,62,新百王,2024-04-19,6210
2439,美律,62,1,61,新百王,2024-04-19,6210
00941,中信上游半導體,62,1,61,新百王,2024-04-19,6210
2337,旺宏,57,0,57,新百王,2024-04-19,6210
00919,群益台灣精選高息,147,93,54,新百王,2024-04-19,6210
2371,大同,413,360,53,新百王,2024-04-19,6210
2030,彰源,50,0,50,新百王,2024-04-19,6210
2610,華航,55,5,50,新百王,2024-04-19,6210
0056,元大高股息,80,31,49,新百王,2024-04-19,6210
6488,環球晶,47,0,47,新百王,2024-04-19,6210
8936,國統,96,54,42,新百王,2024-04-19,6210
2852,第一保,42,1,41,新百王,2024-04-19,6210
9105,泰金寶-DR,40,0,40,新百王,2024-04-19,6210
2887,台新金,40,0,40,新百王,2024-04-19,6210
2367,燿華,60,21,39,新百王,2024-04-19,6210
3013,晟銘電,149,110,39,新百王,2024-04-19,6210
00918,大華優利高填息30,38,0,38,新百王,2024-04-19,6210
00715L,期街口布蘭特正2,91,54,37,新百王,2024-04-19,6210
9946,三發地產,52,16,36,新百王,2024-04-19,6210
8926,台汽電,43,8,35,新百王,2024-04-19,6210
2408,南亞科,36,2,34,新百王,2024-04-19,6210
2845,遠東銀,33,0,33,新百王,2024-04-19,6210
6443,元晶,94,62,32,新百王,2024-04-19,6210
3047,訊舟,30,0,30,新百王,2024-04-19,6210
00650L,復華香港正2,85,58,27,新百王,2024-04-19,6210
00940,元大台灣價值高息,207,180,27,新百王,2024-04-19,6210
00907,永豐優息存股,26,0,26,新百王,2024-04-19,6210
1612,宏泰,93,67,26,新百王,2024-04-19,6210
2101,南港,55,29,26,新百王,2024-04-19,6210
00637L,元大滬深300正2,25,0,25,新百王,2024-04-19,6210
2888,新光金,24,0,24,新百王,2024-04-19,6210
00915,凱基優選高股息30,24,0,24,新百王,2024-04-19,6210
1710,東聯,24,0,24,新百王,2024-04-19,6210
2501,國建,36,12,24,新百王,2024-04-19,6210
3714,富采,23,0,23,新百王,2024-04-19,6210
2891,中信金,22,0,22,新百王,2024-04-19,6210
00642U,期元大S＆P石油,20,0,20,新百王,2024-04-19,6210
4207,環泰,20,0,20,新百王,2024-04-19,6210
8420,明揚,20,0,20,新百王,2024-04-19,6210
1810,和成,24,5,19,新百王,2024-04-19,6210
00857B,永豐20年美公債,1197,0,1197,新百王,2024-04-22,6210
00940,元大台灣價值高息,373,9,364,新百王,2024-04-22,6210
0056,元大高股息,325,26,299,新百王,2024-04-22,6210
00688L,國泰20年美債正2,185,0,185,新百王,2024-04-22,6210
2362,藍天,128,0,128,新百王,2024-04-22,6210
3481,群創,90,0,90,新百王,2024-04-22,6210
00937B,群益ESG投等債20,74,1,73,新百王,2024-04-22,6210
6285,啟��,71,0,71,新百王,2024-04-22,6210
00795B,中信美國公債20年,98,35,63,新百王,2024-04-22,6210
2606,裕民,67,6,61,新百王,2024-04-22,6210
2867,三商壽,93,32,61,新百王,2024-04-22,6210
00680L,元大美債20正2,61,3,58,新百王,2024-04-22,6210
5533,皇鼎,52,0,52,新百王,2024-04-22,6210
2208,台船,50,0,50,新百王,2024-04-22,6210
00671R,富邦NASDAQ反1,50,6,44,新百王,2024-04-22,6210
2344,華邦電,46,4,42,新百王,2024-04-22,6210
9105,泰金寶-DR,40,0,40,新百王,2024-04-22,6210
5521,工信,125,92,33,新百王,2024-04-22,6210
5230,雷笛克光學,42,9,33,新百王,2024-04-22,6210
9945,潤泰新,41,9,32,新百王,2024-04-22,6210
1609,大亞,290,261,29,新百王,2024-04-22,6210
5512,力麒,94,66,28,新百王,2024-04-22,6210
5324,士開,30,2,28,新百王,2024-04-22,6210
2303,聯電,29,2,27,新百王,2024-04-22,6210
5009,榮剛,39,12,27,新百王,2024-04-22,6210
2546,根基,39,12,27,新百王,2024-04-22,6210
00939,統一台灣高息動能,29,2,27,新百王,2024-04-22,6210
2547,日勝生,96,70,26,新百王,2024-04-22,6210
6125,廣運,56,31,25,新百王,2024-04-22,6210
2618,長榮航,93,69,24,新百王,2024-04-22,6210
2030,彰源,30,7,23,新百王,2024-04-22,6210
2501,國建,135,112,23,新百王,2024-04-22,6210
3027,盛達,46,24,22,新百王,2024-04-22,6210
6219,富旺,21,0,21,新百王,2024-04-22,6210
1618,合機,39,19,20,新百王,2024-04-22,6210
4109,加捷生醫,20,0,20,新百王,2024-04-22,6210
1453,大將,20,0,20,新百王,2024-04-22,6210
3284,太普高,36,16,20,新百王,2024-04-22,6210
1805,寶徠,19,0,19,新百王,2024-04-22,6210
4726,永昕,19,2,17,新百王,2024-04-22,6210
1108,幸福,15,0,15,新百王,2024-04-22,6210
2605,新興,113,98,15,新百王,2024-04-22,6210
1540,喬福,15,0,15,新百王,2024-04-22,6210
9946,三發地產,32,17,15,新百王,2024-04-22,6210
2634,漢翔,23,9,14,新百王,2024-04-22,6210
1522,堤維西,14,1,13,新百王,2024-04-22,6210
2329,華泰,33,20,13,新百王,2024-04-22,6210
00941,中信上游半導體,13,0,13,新百王,2024-04-22,6210
8463,潤泰材,15,2,13,新百王,2024-04-22,6210
6207,雷科,13,0,13,新百王,2024-04-22,6210
00632R,元大台灣50反1,440,21,419,新百王,2024-04-23,6210
00753L,中信中國50正2,423,45,378,新百王,2024-04-23,6210
1314,中石化,134,32,102,新百王,2024-04-23,6210
2303,聯電,103,6,97,新百王,2024-04-23,6210
4904,遠傳,85,0,85,新百王,2024-04-23,6210
2511,太子,70,10,60,新百王,2024-04-23,6210
1101,台泥,53,1,52,新百王,2024-04-23,6210
3498,陽程,80,37,43,新百王,2024-04-23,6210
4726,永昕,58,19,39,新百王,2024-04-23,6210
00937B,群益ESG投等債20,35,0,35,新百王,2024-04-23,6210
2317,鴻海,103,71,32,新百王,2024-04-23,6210
2890,永豐金,37,9,28,新百王,2024-04-23,6210
2101,南港,44,18,26,新百王,2024-04-23,6210
1414,東和,34,9,25,新百王,2024-04-23,6210
2606,裕民,23,0,23,新百王,2024-04-23,6210
8936,國統,35,13,22,新百王,2024-04-23,6210
3024,憶聲,23,2,21,新百王,2024-04-23,6210
5521,工信,21,0,21,新百王,2024-04-23,6210
00670L,富邦NASDAQ正2,20,0,20,新百王,2024-04-23,6210
8092,建暐,117,97,20,新百王,2024-04-23,6210
8112,至上,18,0,18,新百王,2024-04-23,6210
00878,國泰永續高股息,17,0,17,新百王,2024-04-23,6210
2881,富邦金,18,1,17,新百王,2024-04-23,6210
2515,中工,31,14,17,新百王,2024-04-23,6210
2363,矽統,24,8,16,新百王,2024-04-23,6210
4916,事欣科,15,0,15,新百王,2024-04-23,6210
1540,喬福,15,0,15,新百王,2024-04-23,6210
2337,旺宏,14,0,14,新百王,2024-04-23,6210
2301,光寶科,22,10,12,新百王,2024-04-23,6210
1303,南亞,13,1,12,新百王,2024-04-23,6210
2359,所羅門,30,18,12,新百王,2024-04-23,6210
00885,富邦越南,12,0,12,新百王,2024-04-23,6210
2736,富野,11,0,11,新百王,2024-04-23,6210
1467,南緯,11,0,11,新百王,2024-04-23,6210
2367,燿華,11,0,11,新百王,2024-04-23,6210
5514,三豐,11,0,11,新百王,2024-04-23,6210
3715,定穎投控,17,7,10,新百王,2024-04-23,6210
3033,威健,10,0,10,新百王,2024-04-23,6210
2103,台橡,10,0,10,新百王,2024-04-23,6210
2204,中華,14,4,10,新百王,2024-04-23,6210
5355,佳總,10,0,10,新百王,2024-04-23,6210
2887,台新金,10,0,10,新百王,2024-04-23,6210
2211,長榮鋼,10,0,10,新百王,2024-04-23,6210
6546,正基,10,0,10,新百王,2024-04-23,6210
3708,上緯投控,36,28,8,新百王,2024-04-23,6210
1805,寶徠,8,0,8,新百王,2024-04-23,6210
1419,新紡,11,3,8,新百王,2024-04-23,6210
6578,達邦蛋白,8,0,8,新百王,2024-04-23,6210
1808,潤隆,15,7,8,新百王,2024-04-23,6210
3047,訊舟,8,0,8,新百王,2024-04-23,6210
2886,兆豐金,518,23,495,新百王,2024-04-24,6210
00929,復華台灣科技優息,321,6,315,新百王,2024-04-24,6210
3481,群創,227,36,191,新百王,2024-04-24,6210
00688L,國泰20年美債正2,181,20,161,新百王,2024-04-24,6210
5230,雷笛克光學,138,1,137,新百王,2024-04-24,6210
00632R,元大台灣50反1,839,705,134,新百王,2024-04-24,6210
4526,東台,110,10,100,新百王,2024-04-24,6210
6190,萬泰科,131,35,96,新百王,2024-04-24,6210
2890,永豐金,104,15,89,新百王,2024-04-24,6210
5512,力麒,110,26,84,新百王,2024-04-24,6210
3231,緯創,147,75,72,新百王,2024-04-24,6210
00919,群益台灣精選高息,81,14,67,新百王,2024-04-24,6210
9105,泰金寶-DR,65,0,65,新百王,2024-04-24,6210
6443,元晶,102,40,62,新百王,2024-04-24,6210
00878,國泰永續高股息,74,23,51,新百王,2024-04-24,6210
9946,三發地產,95,45,50,新百王,2024-04-24,6210
00680L,元大美債20正2,45,0,45,新百王,2024-04-24,6210
6116,彩晶,40,0,40,新百王,2024-04-24,6210
1440,南紡,91,51,40,新百王,2024-04-24,6210
2897A,王道銀甲特,40,0,40,新百王,2024-04-24,6210
6244,茂迪,45,5,40,新百王,2024-04-24,6210
2845,遠東銀,40,0,40,新百王,2024-04-24,6210
2101,南港,42,3,39,新百王,2024-04-24,6210
6215,和椿,70,31,39,新百王,2024-04-24,6210
1717,長興,33,0,33,新百王,2024-04-24,6210
00670L,富邦NASDAQ正2,38,6,32,新百王,2024-04-24,6210
2344,華邦電,35,4,31,新百王,2024-04-24,6210
00687B,國泰20年美債,30,0,30,新百王,2024-04-24,6210
00676R,富邦臺灣加權反1,30,0,30,新百王,2024-04-24,6210
00891,中信關鍵半導體,30,0,30,新百王,2024-04-24,6210
1605,華新,47,18,29,新百王,2024-04-24,6210
4916,事欣科,29,0,29,新百王,2024-04-24,6210
5508,永信建,31,3,28,新百王,2024-04-24,6210
2353,宏��,35,11,24,新百王,2024-04-24,6210
2542,興富發,23,0,23,新百王,2024-04-24,6210
4909,新復興,23,1,22,新百王,2024-04-24,6210
2606,裕民,23,2,21,新百王,2024-04-24,6210
2107,厚生,20,0,20,新百王,2024-04-24,6210
2605,新興,20,0,20,新百王,2024-04-24,6210
2504,國產,59,40,19,新百王,2024-04-24,6210
2543,皇昌,21,3,18,新百王,2024-04-24,6210
3024,憶聲,20,2,18,新百王,2024-04-24,6210
00885,富邦越南,37,20,17,新百王,2024-04-24,6210
1522,堤維西,18,1,17,新百王,2024-04-24,6210
3689,湧德,20,3,17,新百王,2024-04-24,6210
6757,台灣虎航,16,0,16,新百王,2024-04-24,6210
2506,太設,19,3,16,新百王,2024-04-24,6210
4160,訊聯基因,15,1,14,新百王,2024-04-24,6210
3686,達能,14,0,14,新百王,2024-04-24,6210
1216,統一,27,15,12,新百王,2024-04-24,6210
00929,復華台灣科技優息,285,30,255,新百王,2024-04-25,6210
9105,泰金寶-DR,180,0,180,新百王,2024-04-25,6210
2515,中工,244,121,123,新百王,2024-04-25,6210
00940,元大台灣價值高息,127,13,114,新百王,2024-04-25,6210
00878,國泰永續高股息,134,23,111,新百王,2024-04-25,6210
00795B,中信美國公債20年,102,0,102,新百王,2024-04-25,6210
2506,太設,103,17,86,新百王,2024-04-25,6210
2317,鴻海,170,87,83,新百王,2024-04-25,6210
2101,南港,179,106,73,新百王,2024-04-25,6210
2610,華航,100,32,68,新百王,2024-04-25,6210
4303,信立,79,18,61,新百王,2024-04-25,6210
6116,彩晶,80,20,60,新百王,2024-04-25,6210
3052,夆典,40,0,40,新百王,2024-04-25,6210
4167,松瑞藥,40,0,40,新百王,2024-04-25,6210
00857B,永豐20年美公債,43,5,38,新百王,2024-04-25,6210
2382,廣達,103,69,34,新百王,2024-04-25,6210
9946,三發地產,87,55,32,新百王,2024-04-25,6210
1301,台塑,32,0,32,新百王,2024-04-25,6210
8936,國統,39,8,31,新百王,2024-04-25,6210
00933B,國泰10Y+金融債,30,0,30,新百王,2024-04-25,6210
00687B,國泰20年美債,28,0,28,新百王,2024-04-25,6210
1108,幸福,25,0,25,新百王,2024-04-25,6210
00934,中信成長高股息,25,0,25,新百王,2024-04-25,6210
00688L,國泰20年美債正2,26,2,24,新百王,2024-04-25,6210
3013,晟銘電,73,49,24,新百王,2024-04-25,6210
2412,中華電,24,0,24,新百王,2024-04-25,6210
2618,長榮航,89,66,23,新百王,2024-04-25,6210
1326,台化,23,1,22,新百王,2024-04-25,6210
2520,冠德,46,25,21,新百王,2024-04-25,6210
8404,百和興業-KY,21,0,21,新百王,2024-04-25,6210
3312,弘憶股,35,15,20,新百王,2024-04-25,6210
00706L,期元大S＆P日圓正2,20,0,20,新百王,2024-04-25,6210
00712,復華富時不動產,20,1,19,新百王,2024-04-25,6210
8064,東捷,19,0,19,新百王,2024-04-25,6210
2367,燿華,19,0,19,新百王,2024-04-25,6210
1609,大亞,207,189,18,新百王,2024-04-25,6210
0056,元大高股息,18,0,18,新百王,2024-04-25,6210
4726,永昕,18,0,18,新百王,2024-04-25,6210
2617,台航,18,0,18,新百王,2024-04-25,6210
00919,群益台灣精選高息,18,1,17,新百王,2024-04-25,6210
8089,康全電訊,37,20,17,新百王,2024-04-25,6210
6207,雷科,31,14,17,新百王,2024-04-25,6210
2886,兆豐金,14,0,14,新百王,2024-04-25,6210
2542,興富發,21,7,14,新百王,2024-04-25,6210
2505,國揚,14,0,14,新百王,2024-04-25,6210
2890,永豐金,411,398,13,新百王,2024-04-25,6210
2002,中鋼,29,16,13,新百王,2024-04-25,6210
2442,新美齊,38,25,13,新百王,2024-04-25,6210
5251,天鉞電,14,1,13,新百王,2024-04-25,6210
00679B,元大美債20年,15,2,13,新百王,2024-04-25,6210
00632R,元大台灣50反1,397,122,275,新百王,2024-04-26,6210
8064,東捷,400,170,230,新百王,2024-04-26,6210
4526,東台,130,0,130,新百王,2024-04-26,6210
00688L,國泰20年美債正2,120,8,112,新百王,2024-04-26,6210
9105,泰金寶-DR,87,0,87,新百王,2024-04-26,6210
1455,集盛,80,0,80,新百王,2024-04-26,6210
2630,亞航,91,21,70,新百王,2024-04-26,6210
00937B,群益ESG投等債20,68,0,68,新百王,2024-04-26,6210
00687B,國泰20年美債,51,0,51,新百王,2024-04-26,6210
1312,國喬,50,0,50,新百王,2024-04-26,6210
2371,大同,227,180,47,新百王,2024-04-26,6210
2834,臺企銀,45,0,45,新百王,2024-04-26,6210
2375,凱美,45,0,45,新百王,2024-04-26,6210
1904,正隆,50,5,45,新百王,2024-04-26,6210
00679B,元大美債20年,40,0,40,新百王,2024-04-26,6210
2888,新光金,80,41,39,新百王,2024-04-26,6210
2534,宏盛,79,41,38,新百王,2024-04-26,6210
00795B,中信美國公債20年,35,0,35,新百王,2024-04-26,6210
8473,山林水,33,0,33,新百王,2024-04-26,6210
5230,雷笛克光學,55,24,31,新百王,2024-04-26,6210
2547,日勝生,50,21,29,新百王,2024-04-26,6210
2607,榮運,31,4,27,新百王,2024-04-26,6210
00712,復華富時不動產,24,0,24,新百王,2024-04-26,6210
9946,三發地產,27,6,21,新百王,2024-04-26,6210
1817,凱撒衛,20,0,20,新百王,2024-04-26,6210
2542,興富發,26,6,20,新百王,2024-04-26,6210
6177,達麗,36,17,19,新百王,2024-04-26,6210
1419,新紡,22,3,19,新百王,2024-04-26,6210
2543,皇昌,30,11,19,新百王,2024-04-26,6210
1101,台泥,22,3,19,新百王,2024-04-26,6210
6219,富旺,19,1,18,新百王,2024-04-26,6210
2363,矽統,19,1,18,新百王,2024-04-26,6210
2382,廣達,65,48,17,新百王,2024-04-26,6210
2359,所羅門,176,159,17,新百王,2024-04-26,6210
9945,潤泰新,45,29,16,新百王,2024-04-26,6210
2596,綠意,15,0,15,新百王,2024-04-26,6210
8131,福懋科,15,0,15,新百王,2024-04-26,6210
1307,三芳,15,0,15,新百王,2024-04-26,6210
1608,華榮,19,4,15,新百王,2024-04-26,6210
2009,第一銅,37,22,15,新百王,2024-04-26,6210
1220,台榮,15,0,15,新百王,2024-04-26,6210
2883,凱基金,15,0,15,新百王,2024-04-26,6210
2408,南亞科,20,6,14,新百王,2024-04-26,6210
1453,大將,15,1,14,新百王,2024-04-26,6210
3363,上詮,62,49,13,新百王,2024-04-26,6210
1909,榮成,13,1,12,新百王,2024-04-26,6210
4157,太景*-KY,12,0,12,新百王,2024-04-26,6210
6451,訊芯-KY,16,4,12,新百王,2024-04-26,6210
5871,中租-KY,12,1,11,新百王,2024-04-26,6210
00751B,元大AAA至A公司債,10,0,10,新百王,2024-04-26,6210
2515,中工,510,206,304,新百王,2024-04-29,6210
6219,富旺,189,0,189,新百王,2024-04-29,6210
00650L,復華香港正2,143,5,138,新百王,2024-04-29,6210
00632R,元大台灣50反1,360,226,134,新百王,2024-04-29,6210
2605,新興,97,25,72,新百王,2024-04-29,6210
1440,南紡,188,119,69,新百王,2024-04-29,6210
1438,三地開發,64,0,64,新百王,2024-04-29,6210
2618,長榮航,213,151,62,新百王,2024-04-29,6210
00918,大華優利高填息30,80,20,60,新百王,2024-04-29,6210
1108,幸福,65,5,60,新百王,2024-04-29,6210
2888,新光金,81,29,52,新百王,2024-04-29,6210
9946,三發地產,103,52,51,新百王,2024-04-29,6210
2363,矽統,167,120,47,新百王,2024-04-29,6210
2524,京城,46,0,46,新百王,2024-04-29,6210
4510,高鋒,46,0,46,新百王,2024-04-29,6210
00706L,期元大S＆P日圓正2,47,5,42,新百王,2024-04-29,6210
2520,冠德,171,131,40,新百王,2024-04-29,6210
4716,大立,39,0,39,新百王,2024-04-29,6210
6139,亞翔,92,54,38,新百王,2024-04-29,6210
00919,群益台灣精選高息,106,68,38,新百王,2024-04-29,6210
2883,凱基金,54,20,34,新百王,2024-04-29,6210
00878,國泰永續高股息,77,43,34,新百王,2024-04-29,6210
2323,中環,60,28,32,新百王,2024-04-29,6210
8933,愛地雅,25,0,25,新百王,2024-04-29,6210
2504,國產,26,2,24,新百王,2024-04-29,6210
1609,大亞,37,15,22,新百王,2024-04-29,6210
5512,力麒,28,7,21,新百王,2024-04-29,6210
6015,宏遠證,20,0,20,新百王,2024-04-29,6210
3013,晟銘電,67,47,20,新百王,2024-04-29,6210
6757,台灣虎航,18,0,18,新百王,2024-04-29,6210
2449,京元電子,26,8,18,新百王,2024-04-29,6210
5519,隆大,53,35,18,新百王,2024-04-29,6210
1527,鑽全,15,0,15,新百王,2024-04-29,6210
1471,首利,15,0,15,新百王,2024-04-29,6210
2017,官田鋼,15,0,15,新百王,2024-04-29,6210
2101,南港,27,13,14,新百王,2024-04-29,6210
2913,農林,30,16,14,新百王,2024-04-29,6210
1316,上曜,100,87,13,新百王,2024-04-29,6210
5469,瀚宇博,12,0,12,新百王,2024-04-29,6210
3557,嘉威,15,3,12,新百王,2024-04-29,6210
9962,有益,12,0,12,新百王,2024-04-29,6210
2889,國票金,46,34,12,新百王,2024-04-29,6210
00753L,中信中國50正2,11,0,11,新百王,2024-04-29,6210
0056,元大高股息,11,0,11,新百王,2024-04-29,6210
4907,富宇,11,0,11,新百王,2024-04-29,6210
1513,中興電,23,13,10,新百王,2024-04-29,6210
9940,信義,10,0,10,新百王,2024-04-29,6210
8068,全達,10,0,10,新百王,2024-04-29,6210
1737,臺鹽,10,0,10,新百王,2024-04-29,6210
2014,中鴻,10,0,10,新百王,2024-04-29,6210
00632R,元大台灣50反1,535,200,335,新百王,2024-04-30,6210
4526,東台,328,14,314,新百王,2024-04-30,6210
00650L,復華香港正2,140,10,130,新百王,2024-04-30,6210
00919,群益台灣精選高息,160,35,125,新百王,2024-04-30,6210
2884,玉山金,106,0,106,新百王,2024-04-30,6210
9945,潤泰新,159,57,102,新百王,2024-04-30,6210
2801,彰銀,100,0,100,新百王,2024-04-30,6210
6219,富旺,91,8,83,新百王,2024-04-30,6210
1438,三地開發,80,0,80,新百王,2024-04-30,6210
1416,廣豐,74,4,70,新百王,2024-04-30,6210
1314,中石化,557,490,67,新百王,2024-04-30,6210
2883,凱基金,79,17,62,新百王,2024-04-30,6210
2605,新興,89,32,57,新百王,2024-04-30,6210
5608,四維航,59,7,52,新百王,2024-04-30,6210
2317,鴻海,133,83,50,新百王,2024-04-30,6210
2542,興富發,60,11,49,新百王,2024-04-30,6210
2888,新光金,49,0,49,新百王,2024-04-30,6210
4707,磐亞,40,0,40,新百王,2024-04-30,6210
2838,聯邦銀,40,0,40,新百王,2024-04-30,6210
00929,復華台灣科技優息,40,1,39,新百王,2024-04-30,6210
4907,富宇,37,0,37,新百王,2024-04-30,6210
1905,華紙,32,0,32,新百王,2024-04-30,6210
5009,榮剛,48,21,27,新百王,2024-04-30,6210
2524,京城,32,8,24,新百王,2024-04-30,6210
2506,太設,25,1,24,新百王,2024-04-30,6210
5512,力麒,25,2,23,新百王,2024-04-30,6210
9105,泰金寶-DR,23,0,23,新百王,2024-04-30,6210
2601,益航,20,0,20,新百王,2024-04-30,6210
1409,新纖,33,13,20,新百王,2024-04-30,6210
8096,擎亞,57,37,20,新百王,2024-04-30,6210
6141,柏承,20,0,20,新百王,2024-04-30,6210
6207,雷科,25,5,20,新百王,2024-04-30,6210
2611,志信,58,38,20,新百王,2024-04-30,6210
1234,黑松,20,0,20,新百王,2024-04-30,6210
2705,六福,37,19,18,新百王,2024-04-30,6210
1216,統一,18,0,18,新百王,2024-04-30,6210
2882,國泰金,17,0,17,新百王,2024-04-30,6210
2108,南帝,15,0,15,新百王,2024-04-30,6210
4973,廣穎,15,0,15,新百王,2024-04-30,6210
1301,台塑,15,0,15,新百王,2024-04-30,6210
1605,華新,39,25,14,新百王,2024-04-30,6210
2880,華南金,14,0,14,新百王,2024-04-30,6210
2610,華航,38,25,13,新百王,2024-04-30,6210
9946,三發地產,17,4,13,新百王,2024-04-30,6210
2501,國建,83,71,12,新百王,2024-04-30,6210
00706L,期元大S＆P日圓正2,12,0,12,新百王,2024-04-30,6210
2537,聯上發,24,12,12,新百王,2024-04-30,6210
5347,世界,11,0,11,新百王,2024-04-30,6210
2547,日勝生,11,0,11,新百王,2024-04-30,6210
2515,中工,50,39,11,新百王,2024-04-30,6210
0056,元大高股息,199,0,199,新百王,2024-05-02,6210
6219,富旺,166,0,166,新百王,2024-05-02,6210
00929,復華台灣科技優息,148,6,142,新百王,2024-05-02,6210
4526,東台,127,8,119,新百王,2024-05-02,6210
3481,群創,343,231,112,新百王,2024-05-02,6210
00679B,元大美債20年,106,1,105,新百王,2024-05-02,6210
9105,泰金寶-DR,100,0,100,新百王,2024-05-02,6210
00665L,富邦�琤肭磪囓�2,323,231,92,新百王,2024-05-02,6210
2820,華票,88,3,85,新百王,2024-05-02,6210
00666R,富邦�琤肭磪齯�1,84,0,84,新百王,2024-05-02,6210
4927,泰鼎-KY,75,0,75,新百王,2024-05-02,6210
9946,三發地產,74,1,73,新百王,2024-05-02,6210
8064,東捷,80,13,67,新百王,2024-05-02,6210
2520,冠德,131,77,54,新百王,2024-05-02,6210
00932,兆豐永續高息等權,47,0,47,新百王,2024-05-02,6210
2527,宏璟,52,10,42,新百王,2024-05-02,6210
2913,農林,171,130,41,新百王,2024-05-02,6210
5864,致和證,39,0,39,新百王,2024-05-02,6210
1440,南紡,84,50,34,新百王,2024-05-02,6210
2891,中信金,33,4,29,新百王,2024-05-02,6210
1314,中石化,373,345,28,新百王,2024-05-02,6210
2617,台航,26,0,26,新百王,2024-05-02,6210
00919,群益台灣精選高息,27,1,26,新百王,2024-05-02,6210
5230,雷笛克光學,118,95,23,新百王,2024-05-02,6210
4907,富宇,22,0,22,新百王,2024-05-02,6210
3230,錦明,22,1,21,新百王,2024-05-02,6210
00882,中信中國高股息,20,0,20,新百王,2024-05-02,6210
5519,隆大,27,7,20,新百王,2024-05-02,6210
4113,聯上,18,0,18,新百王,2024-05-02,6210
2009,第一銅,23,5,18,新百王,2024-05-02,6210
2506,太設,62,44,18,新百王,2024-05-02,6210
5371,中光電,36,19,17,新百王,2024-05-02,6210
1609,大亞,45,28,17,新百王,2024-05-02,6210
6113,亞矽,24,8,16,新百王,2024-05-02,6210
1513,中興電,37,21,16,新百王,2024-05-02,6210
2605,新興,16,0,16,新百王,2024-05-02,6210
8933,愛地雅,16,0,16,新百王,2024-05-02,6210
2511,太子,52,36,16,新百王,2024-05-02,6210
6190,萬泰科,16,1,15,新百王,2024-05-02,6210
00688L,國泰20年美債正2,15,0,15,新百王,2024-05-02,6210
2324,仁寶,28,13,15,新百王,2024-05-02,6210
8131,福懋科,15,0,15,新百王,2024-05-02,6210
2330,台積電,29,14,15,新百王,2024-05-02,6210
2340,台亞,16,2,14,新百王,2024-05-02,6210
1457,宜進,16,2,14,新百王,2024-05-02,6210
2881,富邦金,18,4,14,新百王,2024-05-02,6210
00878,國泰永續高股息,18,4,14,新百王,2024-05-02,6210
5531,鄉林,16,3,13,新百王,2024-05-02,6210
2838,聯邦銀,13,0,13,新百王,2024-05-02,6210
5871,中租-KY,12,0,12,新百王,2024-05-02,6210
00939,統一台灣高息動能,481,0,481,新百王,2024-05-03,6210
00679B,元大美債20年,148,1,147,新百王,2024-05-03,6210
00929,復華台灣科技優息,215,83,132,新百王,2024-05-03,6210
00937B,群益ESG投等債20,127,0,127,新百王,2024-05-03,6210
6219,富旺,123,0,123,新百王,2024-05-03,6210
00665L,富邦�琤肭磪囓�2,157,52,105,新百王,2024-05-03,6210
3576,聯合再生,100,0,100,新百王,2024-05-03,6210
1609,大亞,142,43,99,新百王,2024-05-03,6210
2888,新光金,142,48,94,新百王,2024-05-03,6210
4417,金洲,92,0,92,新百王,2024-05-03,6210
00687B,國泰20年美債,82,0,82,新百王,2024-05-03,6210
4526,東台,83,1,82,新百王,2024-05-03,6210
00878,國泰永續高股息,83,10,73,新百王,2024-05-03,6210
6770,力積電,59,5,54,新百王,2024-05-03,6210
0056,元大高股息,50,0,50,新百王,2024-05-03,6210
2601,益航,50,0,50,新百王,2024-05-03,6210
6139,亞翔,44,0,44,新百王,2024-05-03,6210
00637L,元大滬深300正2,92,48,44,新百王,2024-05-03,6210
9105,泰金寶-DR,41,1,40,新百王,2024-05-03,6210
1316,上曜,170,131,39,新百王,2024-05-03,6210
2897,王道銀行,58,20,38,新百王,2024-05-03,6210
4714,永捷,69,38,31,新百王,2024-05-03,6210
00712,復華富時不動產,30,0,30,新百王,2024-05-03,6210
2371,大同,104,76,28,新百王,2024-05-03,6210
4906,正文,30,2,28,新百王,2024-05-03,6210
5469,瀚宇博,30,7,23,新百王,2024-05-03,6210
3231,緯創,34,13,21,新百王,2024-05-03,6210
2501,國建,141,120,21,新百王,2024-05-03,6210
9945,潤泰新,253,233,20,新百王,2024-05-03,6210
4167,松瑞藥,15,0,15,新百王,2024-05-03,6210
2351,順德,15,0,15,新百王,2024-05-03,6210
4927,泰鼎-KY,15,0,15,新百王,2024-05-03,6210
2363,矽統,115,101,14,新百王,2024-05-03,6210
3024,憶聲,14,0,14,新百王,2024-05-03,6210
6239,力成,18,4,14,新百王,2024-05-03,6210
2329,華泰,25,12,13,新百王,2024-05-03,6210
00932,兆豐永續高息等權,25,12,13,新百王,2024-05-03,6210
2369,菱生,13,0,13,新百王,2024-05-03,6210
00940,元大台灣價值高息,32,20,12,新百王,2024-05-03,6210
2347,聯強,13,1,12,新百王,2024-05-03,6210
4907,富宇,12,0,12,新百王,2024-05-03,6210
6127,九豪,12,0,12,新百王,2024-05-03,6210
5230,雷笛克光學,47,35,12,新百王,2024-05-03,6210
6026,福邦證,12,0,12,新百王,2024-05-03,6210
00650L,復華香港正2,17,5,12,新百王,2024-05-03,6210
6217,中探針,12,1,11,新百王,2024-05-03,6210
00936,台新永續高息中小,12,1,11,新百王,2024-05-03,6210
2611,志信,12,1,11,新百王,2024-05-03,6210
2880,華南金,13,2,11,新百王,2024-05-03,6210
2344,華邦電,22,11,11,新百王,2024-05-03,6210
00929,復華台灣科技優息,243,67,176,新百王,2024-05-06,6210
2618,長榮航,259,95,164,新百王,2024-05-06,6210
2527,宏璟,132,9,123,新百王,2024-05-06,6210
8096,擎亞,244,137,107,新百王,2024-05-06,6210
00680L,元大美債20正2,123,20,103,新百王,2024-05-06,6210
2514,龍邦,100,0,100,新百王,2024-05-06,6210
00650L,復華香港正2,95,6,89,新百王,2024-05-06,6210
9105,泰金寶-DR,80,0,80,新百王,2024-05-06,6210
1734,杏輝,80,0,80,新百王,2024-05-06,6210
5521,工信,49,1,48,新百王,2024-05-06,6210
2605,新興,46,0,46,新百王,2024-05-06,6210
4207,環泰,45,0,45,新百王,2024-05-06,6210
4722,國精化,40,0,40,新百王,2024-05-06,6210
1438,三地開發,39,0,39,新百王,2024-05-06,6210
3056,富華新,39,1,38,新百王,2024-05-06,6210
5512,力麒,47,9,38,新百王,2024-05-06,6210
00940,元大台灣價值高息,43,8,35,新百王,2024-05-06,6210
2884,玉山金,38,3,35,新百王,2024-05-06,6210
00751B,元大AAA至A公司債,40,6,34,新百王,2024-05-06,6210
9946,三發地產,43,13,30,新百王,2024-05-06,6210
00932,兆豐永續高息等權,54,27,27,新百王,2024-05-06,6210
6282,康舒,51,25,26,新百王,2024-05-06,6210
4561,健椿,26,0,26,新百王,2024-05-06,6210
00637L,元大滬深300正2,50,25,25,新百王,2024-05-06,6210
5534,長虹,38,13,25,新百王,2024-05-06,6210
2501,國建,43,19,24,新百王,2024-05-06,6210
2208,台船,22,0,22,新百王,2024-05-06,6210
6283,淳安,26,4,22,新百王,2024-05-06,6210
5469,瀚宇博,20,0,20,新百王,2024-05-06,6210
2014,中鴻,21,1,20,新百王,2024-05-06,6210
5498,凱崴,21,1,20,新百王,2024-05-06,6210
6152,百一,20,0,20,新百王,2024-05-06,6210
2834,臺企銀,24,4,20,新百王,2024-05-06,6210
9933,中鼎,28,9,19,新百王,2024-05-06,6210
00937B,群益ESG投等債20,49,31,18,新百王,2024-05-06,6210
4967,十銓,22,5,17,新百王,2024-05-06,6210
4919,新唐,44,28,16,新百王,2024-05-06,6210
2610,華航,41,25,16,新百王,2024-05-06,6210
2383,台光電,24,9,15,新百王,2024-05-06,6210
4938,和碩,17,2,15,新百王,2024-05-06,6210
2371,大同,46,31,15,新百王,2024-05-06,6210
6274,台燿,27,12,15,新百王,2024-05-06,6210
5871,中租-KY,15,1,14,新百王,2024-05-06,6210
2536,宏普,14,0,14,新百王,2024-05-06,6210
6288,聯嘉,14,0,14,新百王,2024-05-06,6210
2241,艾姆勒,24,10,14,新百王,2024-05-06,6210
1101,台泥,35,21,14,新百王,2024-05-06,6210
2367,燿華,44,30,14,新百王,2024-05-06,6210
6451,訊芯-KY,63,50,13,新百王,2024-05-06,6210
2328,廣宇,19,6,13,新百王,2024-05-06,6210
1718,中纖,460,0,460,新百王,2024-05-07,6210
2890,永豐金,350,7,343,新百王,2024-05-07,6210
00632R,元大台灣50反1,408,139,269,新百王,2024-05-07,6210
6219,富旺,295,80,215,新百王,2024-05-07,6210
2845,遠東銀,153,1,152,新百王,2024-05-07,6210
00929,復華台灣科技優息,146,20,126,新百王,2024-05-07,6210
9946,三發地產,116,14,102,新百王,2024-05-07,6210
2885,元大金,101,0,101,新百王,2024-05-07,6210
00882,中信中國高股息,107,15,92,新百王,2024-05-07,6210
1905,華紙,90,1,89,新百王,2024-05-07,6210
2527,宏璟,85,2,83,新百王,2024-05-07,6210
2641,正德,87,7,80,新百王,2024-05-07,6210
2892,第一金,80,0,80,新百王,2024-05-07,6210
00650L,復華香港正2,80,0,80,新百王,2024-05-07,6210
4726,永昕,78,4,74,新百王,2024-05-07,6210
9945,潤泰新,74,17,57,新百王,2024-05-07,6210
5512,力麒,75,31,44,新百王,2024-05-07,6210
6026,福邦證,42,0,42,新百王,2024-05-07,6210
00878,國泰永續高股息,45,4,41,新百王,2024-05-07,6210
00706L,期元大S＆P日圓正2,39,0,39,新百王,2024-05-07,6210
00919,群益台灣精選高息,42,3,39,新百王,2024-05-07,6210
2382,廣達,51,14,37,新百王,2024-05-07,6210
1909,榮成,37,0,37,新百王,2024-05-07,6210
6016,康和證,35,0,35,新百王,2024-05-07,6210
6163,華電網,35,0,35,新百王,2024-05-07,6210
2511,太子,35,1,34,新百王,2024-05-07,6210
3312,弘憶股,50,21,29,新百王,2024-05-07,6210
2464,盟立,39,10,29,新百王,2024-05-07,6210
1609,大亞,160,132,28,新百王,2024-05-07,6210
8936,國統,53,28,25,新百王,2024-05-07,6210
2363,矽統,58,34,24,新百王,2024-05-07,6210
3188,鑫龍騰,29,6,23,新百王,2024-05-07,6210
9105,泰金寶-DR,24,1,23,新百王,2024-05-07,6210
1101,台泥,24,1,23,新百王,2024-05-07,6210
6695,芯鼎,22,0,22,新百王,2024-05-07,6210
4113,聯上,29,8,21,新百王,2024-05-07,6210
2002,中鋼,52,32,20,新百王,2024-05-07,6210
1307,三芳,20,0,20,新百王,2024-05-07,6210
9940,信義,20,1,19,新百王,2024-05-07,6210
2888,新光金,28,10,18,新百王,2024-05-07,6210
3034,聯詠,18,1,17,新百王,2024-05-07,6210
5392,能率,21,4,17,新百王,2024-05-07,6210
00932,兆豐永續高息等權,62,46,16,新百王,2024-05-07,6210
6290,良維,16,0,16,新百王,2024-05-07,6210
8234,新漢,20,4,16,新百王,2024-05-07,6210
6282,康舒,15,0,15,新百王,2024-05-07,6210
3705,永信,19,4,15,新百王,2024-05-07,6210
5871,中租-KY,14,0,14,新百王,2024-05-07,6210
6806,森崴能源,15,1,14,新百王,2024-05-07,6210
3027,盛達,15,1,14,新百王,2024-05-07,6210
2897,王道銀行,160,59,101,新百王,2024-05-08,6210
6016,康和證,121,26,95,新百王,2024-05-08,6210
6026,福邦證,87,9,78,新百王,2024-05-08,6210
2883,凱基金,78,0,78,新百王,2024-05-08,6210
2542,興富發,85,17,68,新百王,2024-05-08,6210
1440,南紡,76,23,53,新百王,2024-05-08,6210
2514,龍邦,50,0,50,新百王,2024-05-08,6210
9105,泰金寶-DR,56,8,48,新百王,2024-05-08,6210
6207,雷科,75,27,48,新百王,2024-05-08,6210
6488,環球晶,41,1,40,新百王,2024-05-08,6210
1457,宜進,40,0,40,新百王,2024-05-08,6210
2606,裕民,237,198,39,新百王,2024-05-08,6210
1314,中石化,82,46,36,新百王,2024-05-08,6210
00919,群益台灣精選高息,42,8,34,新百王,2024-05-08,6210
1909,榮成,33,0,33,新百王,2024-05-08,6210
1402,遠東新,31,0,31,新百王,2024-05-08,6210
1815,富喬,33,3,30,新百王,2024-05-08,6210
8093,保銳,30,0,30,新百王,2024-05-08,6210
5871,中租-KY,31,2,29,新百王,2024-05-08,6210
00940,元大台灣價值高息,34,6,28,新百王,2024-05-08,6210
2317,鴻海,70,42,28,新百王,2024-05-08,6210
2613,中櫃,27,0,27,新百王,2024-05-08,6210
1514,亞力,39,13,26,新百王,2024-05-08,6210
2312,金寶,24,0,24,新百王,2024-05-08,6210
2618,長榮航,122,99,23,新百王,2024-05-08,6210
2527,宏璟,35,12,23,新百王,2024-05-08,6210
3188,鑫龍騰,44,21,23,新百王,2024-05-08,6210
2603,長榮,68,45,23,新百王,2024-05-08,6210
2349,錸德,21,0,21,新百王,2024-05-08,6210
2204,中華,21,1,20,新百王,2024-05-08,6210
3702,大聯大,21,1,20,新百王,2024-05-08,6210
8071,能率網通,20,0,20,新百王,2024-05-08,6210
00712,復華富時不動產,20,0,20,新百王,2024-05-08,6210
00933B,國泰10Y+金融債,20,1,19,新百王,2024-05-08,6210
6188,廣明,45,26,19,新百王,2024-05-08,6210
2472,立隆電,18,0,18,新百王,2024-05-08,6210
00941,中信上游半導體,20,3,17,新百王,2024-05-08,6210
2362,藍天,17,0,17,新百王,2024-05-08,6210
00882,中信中國高股息,27,10,17,新百王,2024-05-08,6210
9946,三發地產,34,17,17,新百王,2024-05-08,6210
2359,所羅門,73,56,17,新百王,2024-05-08,6210
2855,統一證,15,0,15,新百王,2024-05-08,6210
2108,南帝,14,0,14,新百王,2024-05-08,6210
1608,華榮,23,10,13,新百王,2024-05-08,6210
6117,迎廣,36,23,13,新百王,2024-05-08,6210
2367,燿華,70,57,13,新百王,2024-05-08,6210
2634,漢翔,24,11,13,新百王,2024-05-08,6210
2002,中鋼,40,27,13,新百王,2024-05-08,6210
5519,隆大,15,2,13,新百王,2024-05-08,6210
00932,兆豐永續高息等權,77,65,12,新百王,2024-05-08,6210
1440,南紡,195,20,175,新百王,2024-05-09,6210
00929,復華台灣科技優息,178,23,155,新百王,2024-05-09,6210
2888,新光金,155,20,135,新百王,2024-05-09,6210
2618,長榮航,370,265,105,新百王,2024-05-09,6210
2892,第一金,100,0,100,新百王,2024-05-09,6210
1314,中石化,125,30,95,新百王,2024-05-09,6210
5871,中租-KY,121,27,94,新百王,2024-05-09,6210
2887,台新金,92,1,91,新百王,2024-05-09,6210
2542,興富發,91,7,84,新百王,2024-05-09,6210
00937B,群益ESG投等債20,94,20,74,新百王,2024-05-09,6210
6488,環球晶,69,0,69,新百王,2024-05-09,6210
00882,中信中國高股息,71,3,68,新百王,2024-05-09,6210
00650L,復華香港正2,75,10,65,新百王,2024-05-09,6210
00932,兆豐永續高息等權,58,0,58,新百王,2024-05-09,6210
2317,鴻海,218,166,52,新百王,2024-05-09,6210
1457,宜進,51,1,50,新百王,2024-05-09,6210
2527,宏璟,50,2,48,新百王,2024-05-09,6210
6219,富旺,61,13,48,新百王,2024-05-09,6210
3188,鑫龍騰,48,1,47,新百王,2024-05-09,6210
6285,啟��,46,5,41,新百王,2024-05-09,6210
3041,揚智,40,2,38,新百王,2024-05-09,6210
2610,華航,34,0,34,新百王,2024-05-09,6210
2605,新興,176,142,34,新百王,2024-05-09,6210
2211,長榮鋼,34,1,33,新百王,2024-05-09,6210
3036,文曄,60,29,31,新百王,2024-05-09,6210
2449,京元電子,32,1,31,新百王,2024-05-09,6210
1101,台泥,47,17,30,新百王,2024-05-09,6210
1909,榮成,30,0,30,新百王,2024-05-09,6210
6189,豐藝,45,15,30,新百王,2024-05-09,6210
2330,台積電,37,8,29,新百王,2024-05-09,6210
00940,元大台灣價值高息,71,42,29,新百王,2024-05-09,6210
00946,群益科技高息成長,28,2,26,新百王,2024-05-09,6210
2889,國票金,25,0,25,新百王,2024-05-09,6210
3024,憶聲,24,0,24,新百王,2024-05-09,6210
2458,義隆,22,0,22,新百王,2024-05-09,6210
2520,冠德,104,84,20,新百王,2024-05-09,6210
3230,錦明,20,1,19,新百王,2024-05-09,6210
6125,廣運,21,3,18,新百王,2024-05-09,6210
1514,亞力,44,26,18,新百王,2024-05-09,6210
2486,一詮,69,51,18,新百王,2024-05-09,6210
8234,新漢,23,5,18,新百王,2024-05-09,6210
2408,南亞科,18,0,18,新百王,2024-05-09,6210
4113,聯上,18,0,18,新百王,2024-05-09,6210
6117,迎廣,78,61,17,新百王,2024-05-09,6210
6505,台塑化,16,0,16,新百王,2024-05-09,6210
8088,品安,16,0,16,新百王,2024-05-09,6210
00919,群益台灣精選高息,19,4,15,新百王,2024-05-09,6210
2834,臺企銀,16,1,15,新百王,2024-05-09,6210
1608,華榮,39,25,14,新百王,2024-05-09,6210
3231,緯創,54,40,14,新百王,2024-05-09,6210
2890,永豐金,515,42,473,新百王,2024-05-10,6210
2885,元大金,191,1,190,新百王,2024-05-10,6210
00929,復華台灣科技優息,383,211,172,新百王,2024-05-10,6210
2002,中鋼,170,4,166,新百王,2024-05-10,6210
00632R,元大台灣50反1,253,124,129,新百王,2024-05-10,6210
00940,元大台灣價值高息,126,32,94,新百王,2024-05-10,6210
4927,泰鼎-KY,90,0,90,新百王,2024-05-10,6210
2641,正德,117,32,85,新百王,2024-05-10,6210
00882,中信中國高股息,75,4,71,新百王,2024-05-10,6210
6757,台灣虎航,55,0,55,新百王,2024-05-10,6210
1108,幸福,53,0,53,新百王,2024-05-10,6210
00932,兆豐永續高息等權,92,42,50,新百王,2024-05-10,6210
2442,新美齊,49,3,46,新百王,2024-05-10,6210
9105,泰金寶-DR,70,30,40,新百王,2024-05-10,6210
1714,和桐,40,0,40,新百王,2024-05-10,6210
00878,國泰永續高股息,43,3,40,新百王,2024-05-10,6210
3260,威剛,70,31,39,新百王,2024-05-10,6210
2367,燿華,86,48,38,新百王,2024-05-10,6210
1524,耿鼎,47,10,37,新百王,2024-05-10,6210
1540,喬福,36,0,36,新百王,2024-05-10,6210
00946,群益科技高息成長,35,0,35,新百王,2024-05-10,6210
2313,華通,141,108,33,新百王,2024-05-10,6210
2363,矽統,50,19,31,新百王,2024-05-10,6210
00864B,中信美國公債0-1,31,0,31,新百王,2024-05-10,6210
00676R,富邦臺灣加權反1,30,0,30,新百王,2024-05-10,6210
00919,群益台灣精選高息,43,15,28,新百王,2024-05-10,6210
1905,華紙,28,0,28,新百王,2024-05-10,6210
2317,鴻海,93,66,27,新百王,2024-05-10,6210
3013,晟銘電,113,90,23,新百王,2024-05-10,6210
2611,志信,27,4,23,新百王,2024-05-10,6210
8936,國統,72,49,23,新百王,2024-05-10,6210
3188,鑫龍騰,39,18,21,新百王,2024-05-10,6210
6266,泰詠,20,0,20,新百王,2024-05-10,6210
4938,和碩,19,0,19,新百王,2024-05-10,6210
2607,榮運,36,17,19,新百王,2024-05-10,6210
6416,瑞祺電通,18,0,18,新百王,2024-05-10,6210
4967,十銓,40,23,17,新百王,2024-05-10,6210
2109,華豐,32,16,16,新百王,2024-05-10,6210
6546,正基,17,1,16,新百王,2024-05-10,6210
2617,台航,45,29,16,新百王,2024-05-10,6210
00664R,國泰臺灣加權反1,16,0,16,新百王,2024-05-10,6210
2527,宏璟,15,0,15,新百王,2024-05-10,6210
5355,佳總,15,0,15,新百王,2024-05-10,6210
00687B,國泰20年美債,27,12,15,新百王,2024-05-10,6210
8074,鉅橡,15,0,15,新百王,2024-05-10,6210
1605,華新,35,21,14,新百王,2024-05-10,6210
3060,銘異,18,4,14,新百王,2024-05-10,6210
00937B,群益ESG投等債20,23,10,13,新百王,2024-05-10,6210
1708,東鹼,21,8,13,新百王,2024-05-10,6210
5608,四維航,54,42,12,新百王,2024-05-10,6210
00939,統一台灣高息動能,481,14,467,新百王,2024-05-13,6210
3036,文曄,272,24,248,新百王,2024-05-13,6210
00929,復華台灣科技優息,465,252,213,新百王,2024-05-13,6210
2883B,凱基金乙特,100,0,100,新百王,2024-05-13,6210
2317,鴻海,190,91,99,新百王,2024-05-13,6210
00937B,群益ESG投等債20,91,0,91,新百王,2024-05-13,6210
9105,泰金寶-DR,91,0,91,新百王,2024-05-13,6210
2618,長榮航,144,58,86,新百王,2024-05-13,6210
1312,國喬,85,8,77,新百王,2024-05-13,6210
3702A,大聯大甲特,61,0,61,新百王,2024-05-13,6210
00946,群益科技高息成長,56,0,56,新百王,2024-05-13,6210
2883,凱基金,54,0,54,新百王,2024-05-13,6210
2897A,王道銀甲特,50,0,50,新百王,2024-05-13,6210
00650L,復華香港正2,67,24,43,新百王,2024-05-13,6210
5483,中美晶,43,5,38,新百王,2024-05-13,6210
8933,愛地雅,37,0,37,新百王,2024-05-13,6210
00679B,元大美債20年,47,11,36,新百王,2024-05-13,6210
2610,華航,203,168,35,新百王,2024-05-13,6210
6147,頎邦,34,1,33,新百王,2024-05-13,6210
00637L,元大滬深300正2,74,42,32,新百王,2024-05-13,6210
1446,宏和,32,1,31,新百王,2024-05-13,6210
5905,南仁湖,30,0,30,新百王,2024-05-13,6210
00919,群益台灣精選高息,39,11,28,新百王,2024-05-13,6210
2606,裕民,118,92,26,新百王,2024-05-13,6210
3188,鑫龍騰,49,24,25,新百王,2024-05-13,6210
2809,京城銀,42,17,25,新百王,2024-05-13,6210
3231,緯創,33,9,24,新百王,2024-05-13,6210
1714,和桐,29,6,23,新百王,2024-05-13,6210
2027,大成鋼,30,8,22,新百王,2024-05-13,6210
6189,豐藝,25,3,22,新百王,2024-05-13,6210
4903,聯光通,21,0,21,新百王,2024-05-13,6210
00712,復華富時不動產,20,0,20,新百王,2024-05-13,6210
2881,富邦金,21,1,20,新百王,2024-05-13,6210
2882,國泰金,32,12,20,新百王,2024-05-13,6210
6282,康舒,22,3,19,新百王,2024-05-13,6210
4908,前鼎,19,1,18,新百王,2024-05-13,6210
2891,中信金,17,0,17,新百王,2024-05-13,6210
00665L,富邦�琤肭磪囓�2,32,15,17,新百王,2024-05-13,6210
4561,健椿,32,16,16,新百王,2024-05-13,6210
1460,宏遠,16,0,16,新百王,2024-05-13,6210
4976,佳凌,16,1,15,新百王,2024-05-13,6210
2897,王道銀行,51,36,15,新百王,2024-05-13,6210
4927,泰鼎-KY,15,0,15,新百王,2024-05-13,6210
3052,夆典,25,10,15,新百王,2024-05-13,6210
1734,杏輝,15,0,15,新百王,2024-05-13,6210
6163,華電網,15,0,15,新百王,2024-05-13,6210
00680L,元大美債20正2,15,0,15,新百王,2024-05-13,6210
8069,元太,20,5,15,新百王,2024-05-13,6210
6538,倉和,16,3,13,新百王,2024-05-13,6210
2412,中華電,15,3,12,新百王,2024-05-13,6210
00632R,元大台灣50反1,477,189,288,新百王,2024-05-14,6210
5876,上海商銀,147,0,147,新百王,2024-05-14,6210
3702A,大聯大甲特,117,2,115,新百王,2024-05-14,6210
00936,台新永續高息中小,83,0,83,新百王,2024-05-14,6210
2610,華航,131,48,83,新百王,2024-05-14,6210
3188,鑫龍騰,76,17,59,新百王,2024-05-14,6210
2887,台新金,72,17,55,新百王,2024-05-14,6210
00937B,群益ESG投等債20,60,10,50,新百王,2024-05-14,6210
00929,復華台灣科技優息,106,61,45,新百王,2024-05-14,6210
5871,中租-KY,66,23,43,新百王,2024-05-14,6210
9945,潤泰新,66,27,39,新百王,2024-05-14,6210
1101,台泥,38,1,37,新百王,2024-05-14,6210
00882,中信中國高股息,46,10,36,新百王,2024-05-14,6210
00650L,復華香港正2,39,4,35,新百王,2024-05-14,6210
9105,泰金寶-DR,62,30,32,新百王,2024-05-14,6210
2618,長榮航,81,50,31,新百王,2024-05-14,6210
5905,南仁湖,30,0,30,新百王,2024-05-14,6210
3706,神達,87,61,26,新百王,2024-05-14,6210
8107,大億金茂,25,0,25,新百王,2024-05-14,6210
00665L,富邦�琤肭磪囓�2,25,0,25,新百王,2024-05-14,6210
2401,凌陽,41,17,24,新百王,2024-05-14,6210
2641,正德,50,28,22,新百王,2024-05-14,6210
2303,聯電,55,34,21,新百王,2024-05-14,6210
1446,宏和,18,0,18,新百王,2024-05-14,6210
6505,台塑化,18,0,18,新百王,2024-05-14,6210
00932,兆豐永續高息等權,17,0,17,新百王,2024-05-14,6210
3231,緯創,46,29,17,新百王,2024-05-14,6210
4113,聯上,20,3,17,新百王,2024-05-14,6210
2353,宏��,120,103,17,新百王,2024-05-14,6210
9946,三發地產,22,5,17,新百王,2024-05-14,6210
00637L,元大滬深300正2,34,17,17,新百王,2024-05-14,6210
5225,東科-KY,17,0,17,新百王,2024-05-14,6210
3356,奇偶,17,0,17,新百王,2024-05-14,6210
2472,立隆電,16,0,16,新百王,2024-05-14,6210
00753L,中信中國50正2,20,4,16,新百王,2024-05-14,6210
2527,宏璟,20,4,16,新百王,2024-05-14,6210
2371,大同,43,27,16,新百王,2024-05-14,6210
00664R,國泰臺灣加權反1,15,0,15,新百王,2024-05-14,6210
8096,擎亞,39,24,15,新百王,2024-05-14,6210
00878,國泰永續高股息,54,39,15,新百王,2024-05-14,6210
00679B,元大美債20年,14,0,14,新百王,2024-05-14,6210
1733,五鼎,16,2,14,新百王,2024-05-14,6210
2834,臺企銀,13,0,13,新百王,2024-05-14,6210
8039,台虹,13,0,13,新百王,2024-05-14,6210
2374,佳能,133,121,12,新百王,2024-05-14,6210
2612,中航,15,3,12,新百王,2024-05-14,6210
3047,訊舟,182,171,11,新百王,2024-05-14,6210
6835,圓裕,11,0,11,新百王,2024-05-14,6210
3057,喬鼎,11,0,11,新百王,2024-05-14,6210
5371,中光電,22,11,11,新百王,2024-05-14,6210
3036,文曄,321,1,320,新百王,2024-05-15,6210
00632R,元大台灣50反1,417,231,186,新百王,2024-05-15,6210
00933B,國泰10Y+金融債,183,1,182,新百王,2024-05-15,6210
3712,永崴投控,133,0,133,新百王,2024-05-15,6210
00937B,群益ESG投等債20,130,4,126,新百王,2024-05-15,6210
1609,大亞,129,9,120,新百王,2024-05-15,6210
3356,奇偶,113,9,104,新百王,2024-05-15,6210
00929,復華台灣科技優息,97,23,74,新百王,2024-05-15,6210
4903,聯光通,90,16,74,新百王,2024-05-15,6210
9105,泰金寶-DR,80,10,70,新百王,2024-05-15,6210
2365,昆盈,76,14,62,新百王,2024-05-15,6210
00712,復華富時不動產,76,15,61,新百王,2024-05-15,6210
1217,愛之味,51,0,51,新百王,2024-05-15,6210
2753,八方雲集,46,1,45,新百王,2024-05-15,6210
6207,雷科,54,14,40,新百王,2024-05-15,6210
1718,中纖,41,3,38,新百王,2024-05-15,6210
2405,輔信,95,61,34,新百王,2024-05-15,6210
2363,矽統,108,76,32,新百王,2024-05-15,6210
3287,廣寰科,32,2,30,新百王,2024-05-15,6210
2618,長榮航,50,20,30,新百王,2024-05-15,6210
2603,長榮,46,19,27,新百王,2024-05-15,6210
00665L,富邦�琤肭磪囓�2,27,0,27,新百王,2024-05-15,6210
00932,兆豐永續高息等權,27,0,27,新百王,2024-05-15,6210
1808,潤隆,26,0,26,新百王,2024-05-15,6210
5608,四維航,51,25,26,新百王,2024-05-15,6210
8210,勤誠,42,17,25,新百王,2024-05-15,6210
2374,佳能,68,44,24,新百王,2024-05-15,6210
2356,英業達,69,45,24,新百王,2024-05-15,6210
9946,三發地產,50,27,23,新百王,2024-05-15,6210
1101,台泥,24,2,22,新百王,2024-05-15,6210
1907,永豐餘,22,0,22,新百王,2024-05-15,6210
00940,元大台灣價值高息,67,46,21,新百王,2024-05-15,6210
5905,南仁湖,20,0,20,新百王,2024-05-15,6210
6113,亞矽,20,0,20,新百王,2024-05-15,6210
4927,泰鼎-KY,20,0,20,新百王,2024-05-15,6210
1457,宜進,20,0,20,新百王,2024-05-15,6210
2324,仁寶,34,15,19,新百王,2024-05-15,6210
2002,中鋼,23,4,19,新百王,2024-05-15,6210
3059,華晶科,26,7,19,新百王,2024-05-15,6210
8064,東捷,21,2,19,新百王,2024-05-15,6210
2885,元大金,20,1,19,新百王,2024-05-15,6210
00830,國泰費城半導體,17,0,17,新百王,2024-05-15,6210
00679B,元大美債20年,17,0,17,新百王,2024-05-15,6210
00715L,期街口布蘭特正2,19,3,16,新百王,2024-05-15,6210
3060,銘異,32,16,16,新百王,2024-05-15,6210
8163,達方,16,0,16,新百王,2024-05-15,6210
8054,安國,56,41,15,新百王,2024-05-15,6210
1314,中石化,15,0,15,新百王,2024-05-15,6210
6442,光聖,16,2,14,新百王,2024-05-15,6210
4543,萬在,18,4,14,新百王,2024-05-15,6210
3481,群創,355,98,257,新百王,2024-05-16,6210
00878,國泰永續高股息,228,16,212,新百王,2024-05-16,6210
2867,三商壽,245,59,186,新百王,2024-05-16,6210
1522,堤維西,385,266,119,新百王,2024-05-16,6210
2834,臺企銀,106,0,106,新百王,2024-05-16,6210
1217,愛之味,100,0,100,新百王,2024-05-16,6210
00931B,統一美債20年,100,0,100,新百王,2024-05-16,6210
00680L,元大美債20正2,116,41,75,新百王,2024-05-16,6210
1460,宏遠,75,0,75,新百王,2024-05-16,6210
00900,富邦特選高股息30,95,38,57,新百王,2024-05-16,6210
6219,富旺,45,0,45,新百王,2024-05-16,6210
3047,訊舟,110,65,45,新百王,2024-05-16,6210
2520,冠德,58,16,42,新百王,2024-05-16,6210
1444,力麗,40,0,40,新百王,2024-05-16,6210
9105,泰金寶-DR,80,40,40,新百王,2024-05-16,6210
2382,廣達,99,60,39,新百王,2024-05-16,6210
2609,陽明,317,281,36,新百王,2024-05-16,6210
3305,昇貿,36,7,29,新百王,2024-05-16,6210
00918,大華優利高填息30,28,0,28,新百王,2024-05-16,6210
5512,力麒,26,0,26,新百王,2024-05-16,6210
00891,中信關鍵半導體,24,0,24,新百王,2024-05-16,6210
6928,攸泰科技,24,1,23,新百王,2024-05-16,6210
4533,協易機,94,71,23,新百王,2024-05-16,6210
00937B,群益ESG投等債20,69,46,23,新百王,2024-05-16,6210
2353,宏��,33,11,22,新百王,2024-05-16,6210
5905,南仁湖,20,0,20,新百王,2024-05-16,6210
1457,宜進,20,0,20,新百王,2024-05-16,6210
2753,八方雲集,20,0,20,新百王,2024-05-16,6210
3231,緯創,54,34,20,新百王,2024-05-16,6210
2611,志信,22,3,19,新百王,2024-05-16,6210
8070,長華*,22,3,19,新百王,2024-05-16,6210
1718,中纖,20,1,19,新百王,2024-05-16,6210
2905,三商,18,0,18,新百王,2024-05-16,6210
2313,華通,34,17,17,新百王,2024-05-16,6210
2356,英業達,35,18,17,新百王,2024-05-16,6210
1907,永豐餘,43,27,16,新百王,2024-05-16,6210
2836,高雄銀,16,0,16,新百王,2024-05-16,6210
3024,憶聲,20,4,16,新百王,2024-05-16,6210
1305,華夏,15,0,15,新百王,2024-05-16,6210
8110,華東,17,3,14,新百王,2024-05-16,6210
2104,國際中橡,14,0,14,新百王,2024-05-16,6210
3705,永信,17,3,14,新百王,2024-05-16,6210
00650L,復華香港正2,17,3,14,新百王,2024-05-16,6210
3390,旭軟,13,0,13,新百王,2024-05-16,6210
3236,千如,13,0,13,新百王,2024-05-16,6210
00915,凱基優選高股息30,13,0,13,新百王,2024-05-16,6210
2897,王道銀行,40,27,13,新百王,2024-05-16,6210
8096,擎亞,107,95,12,新百王,2024-05-16,6210
5230,雷笛克光學,34,22,12,新百王,2024-05-16,6210
4113,聯上,12,0,12,新百王,2024-05-16,6210
2317,鴻海,355,85,270,新百王,2024-05-17,6210
00929,復華台灣科技優息,247,35,212,新百王,2024-05-17,6210
2897,王道銀行,228,20,208,新百王,2024-05-17,6210
2303,聯電,250,61,189,新百王,2024-05-17,6210
3059,華晶科,145,12,133,新百王,2024-05-17,6210
4927,泰鼎-KY,119,0,119,新百王,2024-05-17,6210
9105,泰金寶-DR,100,0,100,新百王,2024-05-17,6210
4538,大詠城,76,0,76,新百王,2024-05-17,6210
2727,王品,40,0,40,新百王,2024-05-17,6210
00632R,元大台灣50反1,167,127,40,新百王,2024-05-17,6210
00919,群益台灣精選高息,88,53,35,新百王,2024-05-17,6210
6227,茂綸,33,0,33,新百王,2024-05-17,6210
4707,磐亞,32,0,32,新百王,2024-05-17,6210
00680L,元大美債20正2,52,20,32,新百王,2024-05-17,6210
2609,陽明,35,5,30,新百王,2024-05-17,6210
2610,華航,308,279,29,新百王,2024-05-17,6210
5392,能率,67,40,27,新百王,2024-05-17,6210
2606,裕民,46,19,27,新百王,2024-05-17,6210
2489,瑞軒,69,45,24,新百王,2024-05-17,6210
2409,友達,23,0,23,新百王,2024-05-17,6210
00940,元大台灣價值高息,22,0,22,新百王,2024-05-17,6210
1584,精剛,21,0,21,新百王,2024-05-17,6210
00693U,期街口S＆P黃豆,21,0,21,新百王,2024-05-17,6210
6164,華興,20,0,20,新百王,2024-05-17,6210
8050,廣積,20,0,20,新百王,2024-05-17,6210
2352,佳世達,19,0,19,新百王,2024-05-17,6210
5443,均豪,21,2,19,新百王,2024-05-17,6210
2329,華泰,41,22,19,新百王,2024-05-17,6210
00712,復華富時不動產,22,4,18,新百王,2024-05-17,6210
2408,南亞科,20,2,18,新百王,2024-05-17,6210
2376,技嘉,39,21,18,新百王,2024-05-17,6210
1591,駿吉-KY,22,4,18,新百王,2024-05-17,6210
1101,台泥,23,6,17,新百王,2024-05-17,6210
2417,圓剛,36,19,17,新百王,2024-05-17,6210
1815,富喬,26,9,17,新百王,2024-05-17,6210
2543,皇昌,18,3,15,新百王,2024-05-17,6210
00877,復華中國5G,15,0,15,新百王,2024-05-17,6210
00857B,永豐20年美公債,15,0,15,新百王,2024-05-17,6210
00637L,元大滬深300正2,24,9,15,新百王,2024-05-17,6210
3024,憶聲,14,0,14,新百王,2024-05-17,6210
2324,仁寶,22,8,14,新百王,2024-05-17,6210
6591,動力-KY,16,2,14,新百王,2024-05-17,6210
3230,錦明,14,0,14,新百王,2024-05-17,6210
00650L,復華香港正2,14,0,14,新百王,2024-05-17,6210
00937B,群益ESG投等債20,14,1,13,新百王,2024-05-17,6210
1522,堤維西,17,4,13,新百王,2024-05-17,6210
2486,一詮,52,40,12,新百王,2024-05-17,6210
00918,大華優利高填息30,12,0,12,新百王,2024-05-17,6210
5498,凱崴,25,13,12,新百王,2024-05-17,6210
3481,群創,32,20,12,新百王,2024-05-17,6210
00929,復華台灣科技優息,389,20,369,新百王,2024-05-20,6210
2867,三商壽,239,23,216,新百王,2024-05-20,6210
00795B,中信美國公債20年,213,0,213,新百王,2024-05-20,6210
2317,鴻海,269,74,195,新百王,2024-05-20,6210
2888,新光金,165,20,145,新百王,2024-05-20,6210
2367,燿華,240,102,138,新百王,2024-05-20,6210
00665L,富邦�琤肭磪囓�2,114,5,109,新百王,2024-05-20,6210
00753L,中信中國50正2,100,11,89,新百王,2024-05-20,6210
3033,威健,88,4,84,新百王,2024-05-20,6210
1217,愛之味,105,30,75,新百王,2024-05-20,6210
2101,南港,73,7,66,新百王,2024-05-20,6210
2241,艾姆勒,78,19,59,新百王,2024-05-20,6210
2618,長榮航,75,22,53,新百王,2024-05-20,6210
8050,廣積,43,0,43,新百王,2024-05-20,6210
0050,元大台灣50,44,1,43,新百王,2024-05-20,6210
9105,泰金寶-DR,100,60,40,新百王,2024-05-20,6210
3188,鑫龍騰,41,1,40,新百王,2024-05-20,6210
9946,三發地產,43,3,40,新百王,2024-05-20,6210
00943,兆豐電子高息等權,39,0,39,新百王,2024-05-20,6210
5009,榮剛,47,10,37,新百王,2024-05-20,6210
00713,元大台灣高息低波,39,3,36,新百王,2024-05-20,6210
1312,國喬,35,0,35,新百王,2024-05-20,6210
3706,神達,84,50,34,新百王,2024-05-20,6210
6757,台灣虎航,33,0,33,新百王,2024-05-20,6210
2405,輔信,46,15,31,新百王,2024-05-20,6210
00918,大華優利高填息30,31,1,30,新百王,2024-05-20,6210
2515,中工,29,0,29,新百王,2024-05-20,6210
2211,長榮鋼,29,0,29,新百王,2024-05-20,6210
2353,宏��,30,1,29,新百王,2024-05-20,6210
00688L,國泰20年美債正2,25,0,25,新百王,2024-05-20,6210
6152,百一,25,0,25,新百王,2024-05-20,6210
2458,義隆,24,0,24,新百王,2024-05-20,6210
2382,廣達,54,31,23,新百王,2024-05-20,6210
00679B,元大美債20年,24,2,22,新百王,2024-05-20,6210
3231,緯創,30,9,21,新百王,2024-05-20,6210
4976,佳凌,57,36,21,新百王,2024-05-20,6210
9945,潤泰新,21,1,20,新百王,2024-05-20,6210
00930,永豐ESG低碳高息,20,0,20,新百王,2024-05-20,6210
1718,中纖,20,0,20,新百王,2024-05-20,6210
00664R,國泰臺灣加權反1,19,0,19,新百王,2024-05-20,6210
8926,台汽電,20,2,18,新百王,2024-05-20,6210
2607,榮運,18,0,18,新百王,2024-05-20,6210
4113,聯上,23,5,18,新百王,2024-05-20,6210
4543,萬在,36,18,18,新百王,2024-05-20,6210
2363,矽統,110,92,18,新百王,2024-05-20,6210
2605,新興,36,19,17,新百王,2024-05-20,6210
3047,訊舟,35,18,17,新百王,2024-05-20,6210
3230,錦明,17,1,16,新百王,2024-05-20,6210
2243,宏旭-KY,17,2,15,新百王,2024-05-20,6210
2601,益航,15,0,15,新百王,2024-05-20,6210
1312,國喬,200,0,200,新百王,2024-05-21,6210
00857B,永豐20年美公債,195,0,195,新百王,2024-05-21,6210
00712,復華富時不動產,130,1,129,新百王,2024-05-21,6210
2883,凱基金,104,0,104,新百王,2024-05-21,6210
1718,中纖,87,1,86,新百王,2024-05-21,6210
2897,王道銀行,123,40,83,新百王,2024-05-21,6210
1909,榮成,80,0,80,新百王,2024-05-21,6210
00936,台新永續高息中小,135,60,75,新百王,2024-05-21,6210
00937B,群益ESG投等債20,94,20,74,新百王,2024-05-21,6210
2610,華航,107,38,69,新百王,2024-05-21,6210
4545,銘鈺,67,3,64,新百王,2024-05-21,6210
8096,擎亞,103,45,58,新百王,2024-05-21,6210
00878,國泰永續高股息,57,3,54,新百王,2024-05-21,6210
2405,輔信,96,46,50,新百王,2024-05-21,6210
4526,東台,53,3,50,新百王,2024-05-21,6210
2365,昆盈,57,8,49,新百王,2024-05-21,6210
3005,神基,110,61,49,新百王,2024-05-21,6210
1522,堤維西,59,15,44,新百王,2024-05-21,6210
2020,美亞,40,0,40,新百王,2024-05-21,6210
9946,三發地產,62,24,38,新百王,2024-05-21,6210
8926,台汽電,35,0,35,新百王,2024-05-21,6210
2363,矽統,89,55,34,新百王,2024-05-21,6210
2915,潤泰全,33,0,33,新百王,2024-05-21,6210
6207,雷科,38,7,31,新百王,2024-05-21,6210
3419,譁裕,30,0,30,新百王,2024-05-21,6210
4909,新復興,35,6,29,新百王,2024-05-21,6210
2442,新美齊,54,25,29,新百王,2024-05-21,6210
00665L,富邦�琤肭磪囓�2,28,0,28,新百王,2024-05-21,6210
1314,中石化,27,0,27,新百王,2024-05-21,6210
1326,台化,25,0,25,新百王,2024-05-21,6210
2409,友達,25,0,25,新百王,2024-05-21,6210
1303,南亞,23,0,23,新百王,2024-05-21,6210
2464,盟立,80,59,21,新百王,2024-05-21,6210
00650L,復華香港正2,25,4,21,新百王,2024-05-21,6210
2211,長榮鋼,21,0,21,新百王,2024-05-21,6210
2374,佳能,133,114,19,新百王,2024-05-21,6210
3202,樺晟,20,1,19,新百王,2024-05-21,6210
00763U,期街口道瓊銅,18,0,18,新百王,2024-05-21,6210
2317,鴻海,79,62,17,新百王,2024-05-21,6210
6202,盛群,18,1,17,新百王,2024-05-21,6210
6552,易華電,17,1,16,新百王,2024-05-21,6210
4958,臻鼎-KY,16,0,16,新百王,2024-05-21,6210
2027,大成鋼,59,43,16,新百王,2024-05-21,6210
2509,全坤建,16,0,16,新百王,2024-05-21,6210
1217,愛之味,15,0,15,新百王,2024-05-21,6210
2023,燁輝,15,0,15,新百王,2024-05-21,6210
2701,萬企,15,0,15,新百王,2024-05-21,6210
0050,元大台灣50,24,9,15,新百王,2024-05-21,6210
3230,錦明,18,4,14,新百王,2024-05-21,6210
00830,國泰費城半導體,15,1,14,新百王,2024-05-21,6210
2002,中鋼,643,19,624,新百王,2024-05-22,6210
00715L,期街口布蘭特正2,385,0,385,新百王,2024-05-22,6210
00937B,群益ESG投等債20,311,10,301,新百王,2024-05-22,6210
1303,南亞,149,2,147,新百王,2024-05-22,6210
3047,訊舟,232,90,142,新百王,2024-05-22,6210
4526,東台,131,6,125,新百王,2024-05-22,6210
8092,建暐,110,0,110,新百王,2024-05-22,6210
1909,榮成,80,0,80,新百王,2024-05-22,6210
3059,華晶科,93,24,69,新百王,2024-05-22,6210
00712,復華富時不動產,80,14,66,新百王,2024-05-22,6210
00930,永豐ESG低碳高息,56,0,56,新百王,2024-05-22,6210
00632R,元大台灣50反1,197,141,56,新百王,2024-05-22,6210
3052,夆典,55,5,50,新百王,2024-05-22,6210
2610,華航,109,67,42,新百王,2024-05-22,6210
1708,東鹼,42,0,42,新百王,2024-05-22,6210
00676R,富邦臺灣加權反1,40,0,40,新百王,2024-05-22,6210
2520,冠德,41,3,38,新百王,2024-05-22,6210
5009,榮剛,42,5,37,新百王,2024-05-22,6210
00665L,富邦�琤肭磪囓�2,33,1,32,新百王,2024-05-22,6210
2915,潤泰全,32,0,32,新百王,2024-05-22,6210
9955,佳龍,50,19,31,新百王,2024-05-22,6210
8044,網家,45,14,31,新百王,2024-05-22,6210
00918,大華優利高填息30,40,10,30,新百王,2024-05-22,6210
2472,立隆電,28,0,28,新百王,2024-05-22,6210
6209,今國光,46,19,27,新百王,2024-05-22,6210
4533,協易機,52,25,27,新百王,2024-05-22,6210
6188,廣明,74,48,26,新百王,2024-05-22,6210
6190,萬泰科,145,119,26,新百王,2024-05-22,6210
3060,銘異,46,21,25,新百王,2024-05-22,6210
2356,英業達,84,60,24,新百王,2024-05-22,6210
8070,長華*,24,0,24,新百王,2024-05-22,6210
2609,陽明,27,4,23,新百王,2024-05-22,6210
2515,中工,23,0,23,新百王,2024-05-22,6210
3360,尚立,44,22,22,新百王,2024-05-22,6210
1446,宏和,22,0,22,新百王,2024-05-22,6210
8110,華東,41,20,21,新百王,2024-05-22,6210
2489,瑞軒,24,4,20,新百王,2024-05-22,6210
2020,美亞,20,0,20,新百王,2024-05-22,6210
8071,能率網通,32,12,20,新百王,2024-05-22,6210
2884,玉山金,21,2,19,新百王,2024-05-22,6210
3188,鑫龍騰,21,2,19,新百王,2024-05-22,6210
6213,聯茂,32,14,18,新百王,2024-05-22,6210
2009,第一銅,127,110,17,新百王,2024-05-22,6210
3689,湧德,22,5,17,新百王,2024-05-22,6210
6207,雷科,56,39,17,新百王,2024-05-22,6210
2615,萬海,25,9,16,新百王,2024-05-22,6210
2354,鴻準,20,4,16,新百王,2024-05-22,6210
00753L,中信中國50正2,21,6,15,新百王,2024-05-22,6210
2630,亞航,15,0,15,新百王,2024-05-22,6210
1752,南光,18,3,15,新百王,2024-05-22,6210
00632R,元大台灣50反1,619,183,436,新百王,2024-05-23,6210
00715L,期街口布蘭特正2,401,3,398,新百王,2024-05-23,6210
00929,復華台灣科技優息,316,107,209,新百王,2024-05-23,6210
9946,三發地產,179,3,176,新百王,2024-05-23,6210
8064,東捷,150,9,141,新百王,2024-05-23,6210
00650L,復華香港正2,120,0,120,新百王,2024-05-23,6210
00712,復華富時不動產,97,2,95,新百王,2024-05-23,6210
00665L,富邦�琤肭磪囓�2,93,0,93,新百王,2024-05-23,6210
2887,台新金,102,20,82,新百王,2024-05-23,6210
2883,凱基金,101,23,78,新百王,2024-05-23,6210
00937B,群益ESG投等債20,73,0,73,新百王,2024-05-23,6210
00637L,元大滬深300正2,92,25,67,新百王,2024-05-23,6210
3312,弘憶股,73,8,65,新百王,2024-05-23,6210
2420,新巨,67,3,64,新百王,2024-05-23,6210
2634,漢翔,113,52,61,新百王,2024-05-23,6210
2002,中鋼,65,6,59,新百王,2024-05-23,6210
00753L,中信中國50正2,61,8,53,新百王,2024-05-23,6210
3260,威剛,51,0,51,新百王,2024-05-23,6210
3188,鑫龍騰,51,1,50,新百王,2024-05-23,6210
8926,台汽電,47,0,47,新百王,2024-05-23,6210
00878,國泰永續高股息,49,4,45,新百王,2024-05-23,6210
00895,富邦未來車,40,0,40,新百王,2024-05-23,6210
1817,凱撒衛,40,0,40,新百王,2024-05-23,6210
1457,宜進,40,0,40,新百王,2024-05-23,6210
2337,旺宏,40,2,38,新百王,2024-05-23,6210
1718,中纖,37,0,37,新百王,2024-05-23,6210
2867,三商壽,37,1,36,新百王,2024-05-23,6210
2363,矽統,55,19,36,新百王,2024-05-23,6210
5230,雷笛克光學,38,4,34,新百王,2024-05-23,6210
2356,英業達,42,10,32,新百王,2024-05-23,6210
1417,嘉裕,30,0,30,新百王,2024-05-23,6210
2904,匯僑,30,0,30,新百王,2024-05-23,6210
00688L,國泰20年美債正2,30,0,30,新百王,2024-05-23,6210
3702A,大聯大甲特,30,0,30,新百王,2024-05-23,6210
2367,燿華,120,90,30,新百王,2024-05-23,6210
2409,友達,29,0,29,新百王,2024-05-23,6210
1314,中石化,28,0,28,新百王,2024-05-23,6210
4113,聯上,27,0,27,新百王,2024-05-23,6210
3564,其陽,57,31,26,新百王,2024-05-23,6210
2706,第一店,26,0,26,新百王,2024-05-23,6210
1536,和大,28,2,26,新百王,2024-05-23,6210
2465,麗臺,43,18,25,新百王,2024-05-23,6210
2359,所羅門,151,126,25,新百王,2024-05-23,6210
8933,愛地雅,24,0,24,新百王,2024-05-23,6210
2382,廣達,24,1,23,新百王,2024-05-23,6210
6530,創威,24,2,22,新百王,2024-05-23,6210
2607,榮運,27,5,22,新百王,2024-05-23,6210
5498,凱崴,85,63,22,新百王,2024-05-23,6210
5371,中光電,39,17,22,新百王,2024-05-23,6210
2348,海悅,21,0,21,新百王,2024-05-23,6210
8064,東捷,432,17,415,新百王,2024-05-24,6210
00712,復華富時不動產,327,1,326,新百王,2024-05-24,6210
00632R,元大台灣50反1,341,129,212,新百王,2024-05-24,6210
00929,復華台灣科技優息,214,45,169,新百王,2024-05-24,6210
5876,上海商銀,146,0,146,新百王,2024-05-24,6210
00937B,群益ESG投等債20,163,50,113,新百王,2024-05-24,6210
8092,建暐,80,0,80,新百王,2024-05-24,6210
2344,華邦電,81,2,79,新百王,2024-05-24,6210
00665L,富邦�琤肭磪囓�2,146,71,75,新百王,2024-05-24,6210
00753L,中信中國50正2,74,0,74,新百王,2024-05-24,6210
4526,東台,88,15,73,新百王,2024-05-24,6210
2883,凱基金,62,3,59,新百王,2024-05-24,6210
3363,上詮,119,63,56,新百王,2024-05-24,6210
2609,陽明,62,10,52,新百王,2024-05-24,6210
6207,雷科,56,8,48,新百王,2024-05-24,6210
2603,長榮,88,41,47,新百王,2024-05-24,6210
00650L,復華香港正2,45,1,44,新百王,2024-05-24,6210
4113,聯上,44,2,42,新百王,2024-05-24,6210
2409,友達,62,25,37,新百王,2024-05-24,6210
2002,中鋼,43,7,36,新百王,2024-05-24,6210
2104,國際中橡,34,0,34,新百王,2024-05-24,6210
2534,宏盛,33,0,33,新百王,2024-05-24,6210
1909,榮成,30,0,30,新百王,2024-05-24,6210
2486,一詮,138,108,30,新百王,2024-05-24,6210
00637L,元大滬深300正2,87,57,30,新百王,2024-05-24,6210
00919,群益台灣精選高息,48,22,26,新百王,2024-05-24,6210
8147,正淩,25,1,24,新百王,2024-05-24,6210
2354,鴻準,44,20,24,新百王,2024-05-24,6210
1609,大亞,43,21,22,新百王,2024-05-24,6210
5443,均豪,27,5,22,新百王,2024-05-24,6210
1217,愛之味,21,0,21,新百王,2024-05-24,6210
2615,萬海,35,14,21,新百王,2024-05-24,6210
00669R,國泰美國道瓊反1,20,0,20,新百王,2024-05-24,6210
2340,台亞,24,5,19,新百王,2024-05-24,6210
4173,久裕,20,2,18,新百王,2024-05-24,6210
6770,力積電,18,0,18,新百王,2024-05-24,6210
2359,所羅門,117,101,16,新百王,2024-05-24,6210
00915,凱基優選高股息30,15,0,15,新百王,2024-05-24,6210
2542,興富發,16,1,15,新百王,2024-05-24,6210
4908,前鼎,44,30,14,新百王,2024-05-24,6210
1802,台玻,15,2,13,新百王,2024-05-24,6210
4744,皇將,17,4,13,新百王,2024-05-24,6210
2236,百達-KY,13,0,13,新百王,2024-05-24,6210
2417,圓剛,13,0,13,新百王,2024-05-24,6210
2027,大成鋼,13,0,13,新百王,2024-05-24,6210
3706,神達,14,2,12,新百王,2024-05-24,6210
2891,中信金,10,0,10,新百王,2024-05-24,6210
2886,兆豐金,10,0,10,新百王,2024-05-24,6210
6288,聯嘉,10,0,10,新百王,2024-05-24,6210
1326,台化,10,0,10,新百王,2024-05-24,6210
2367,燿華,436,27,409,新百王,2024-05-27,6210
4526,東台,266,11,255,新百王,2024-05-27,6210
1314,中石化,200,0,200,新百王,2024-05-27,6210
2537,聯上發,111,0,111,新百王,2024-05-27,6210
9105,泰金寶-DR,189,84,105,新百王,2024-05-27,6210
1301,台塑,86,0,86,新百王,2024-05-27,6210
5230,雷笛克光學,102,19,83,新百王,2024-05-27,6210
2610,華航,81,11,70,新百王,2024-05-27,6210
1815,富喬,125,63,62,新百王,2024-05-27,6210
4113,聯上,54,0,54,新百王,2024-05-27,6210
00753L,中信中國50正2,54,0,54,新百王,2024-05-27,6210
00687B,國泰20年美債,58,10,48,新百王,2024-05-27,6210
2330,台積電,50,6,44,新百王,2024-05-27,6210
2609,陽明,77,33,44,新百王,2024-05-27,6210
2363,矽統,200,163,37,新百王,2024-05-27,6210
6219,富旺,36,0,36,新百王,2024-05-27,6210
2340,台亞,38,3,35,新百王,2024-05-27,6210
2915,潤泰全,45,11,34,新百王,2024-05-27,6210
2204,中華,35,2,33,新百王,2024-05-27,6210
1531,高林股,31,0,31,新百王,2024-05-27,6210
3483,力致,36,5,31,新百王,2024-05-27,6210
2412,中華電,30,0,30,新百王,2024-05-27,6210
6125,廣運,81,53,28,新百王,2024-05-27,6210
00919,群益台灣精選高息,113,85,28,新百王,2024-05-27,6210
3305,昇貿,30,3,27,新百王,2024-05-27,6210
2002,中鋼,26,0,26,新百王,2024-05-27,6210
4958,臻鼎-KY,31,5,26,新百王,2024-05-27,6210
1446,宏和,24,0,24,新百王,2024-05-27,6210
00665L,富邦�琤肭磪囓�2,34,10,24,新百王,2024-05-27,6210
2420,新巨,26,3,23,新百王,2024-05-27,6210
4714,永捷,37,15,22,新百王,2024-05-27,6210
00937B,群益ESG投等債20,42,21,21,新百王,2024-05-27,6210
2489,瑞軒,35,14,21,新百王,2024-05-27,6210
2897,王道銀行,82,62,20,新百王,2024-05-27,6210
2633,台灣高鐵,20,0,20,新百王,2024-05-27,6210
6147,頎邦,29,9,20,新百王,2024-05-27,6210
4909,新復興,19,0,19,新百王,2024-05-27,6210
6257,矽格,19,0,19,新百王,2024-05-27,6210
1416,廣豐,18,0,18,新百王,2024-05-27,6210
6117,迎廣,47,29,18,新百王,2024-05-27,6210
3034,聯詠,20,3,17,新百王,2024-05-27,6210
3033,威健,84,67,17,新百王,2024-05-27,6210
1514,亞力,42,26,16,新百王,2024-05-27,6210
2838,聯邦銀,15,0,15,新百王,2024-05-27,6210
00706L,期元大S＆P日圓正2,15,0,15,新百王,2024-05-27,6210
00885,富邦越南,15,0,15,新百王,2024-05-27,6210
3202,樺晟,42,27,15,新百王,2024-05-27,6210
2543,皇昌,17,3,14,新百王,2024-05-27,6210
2105,正新,20,7,13,新百王,2024-05-27,6210
3059,華晶科,86,73,13,新百王,2024-05-27,6210
00940,元大台灣價值高息,238,7,231,新百王,2024-05-28,6210
2618,長榮航,496,360,136,新百王,2024-05-28,6210
3490,單井,125,5,120,新百王,2024-05-28,6210
2891,中信金,133,24,109,新百王,2024-05-28,6210
00931B,統一美債20年,106,0,106,新百王,2024-05-28,6210
2367,燿華,108,37,71,新百王,2024-05-28,6210
2206,三陽工業,52,2,50,新百王,2024-05-28,6210
2363,矽統,196,154,42,新百王,2024-05-28,6210
6284,佳邦,57,16,41,新百王,2024-05-28,6210
4113,聯上,40,0,40,新百王,2024-05-28,6210
2601,益航,45,10,35,新百王,2024-05-28,6210
3002,歐格,30,0,30,新百王,2024-05-28,6210
00918,大華優利高填息30,40,10,30,新百王,2024-05-28,6210
00944,野村趨勢動能高息,30,0,30,新百王,2024-05-28,6210
00900,富邦特選高股息30,30,0,30,新百王,2024-05-28,6210
3372,典範,41,12,29,新百王,2024-05-28,6210
6269,台郡,28,1,27,新百王,2024-05-28,6210
1528,恩德,38,11,27,新百王,2024-05-28,6210
00637L,元大滬深300正2,63,36,27,新百王,2024-05-28,6210
00753L,中信中國50正2,42,20,22,新百王,2024-05-28,6210
2317,鴻海,45,23,22,新百王,2024-05-28,6210
00830,國泰費城半導體,20,0,20,新百王,2024-05-28,6210
3712,永崴投控,127,108,19,新百王,2024-05-28,6210
2537,聯上發,20,1,19,新百王,2024-05-28,6210
6591,動力-KY,32,13,19,新百王,2024-05-28,6210
5608,四維航,31,12,19,新百王,2024-05-28,6210
3356,奇偶,25,6,19,新百王,2024-05-28,6210
6188,廣明,95,77,18,新百王,2024-05-28,6210
00712,復華富時不動產,18,0,18,新百王,2024-05-28,6210
2596,綠意,18,0,18,新百王,2024-05-28,6210
1708,東鹼,18,0,18,新百王,2024-05-28,6210
6177,達麗,17,0,17,新百王,2024-05-28,6210
3705,永信,18,1,17,新百王,2024-05-28,6210
4958,臻鼎-KY,17,0,17,新百王,2024-05-28,6210
2324,仁寶,19,2,17,新百王,2024-05-28,6210
5426,振發,34,17,17,新百王,2024-05-28,6210
2607,榮運,17,1,16,新百王,2024-05-28,6210
1717,長興,16,0,16,新百王,2024-05-28,6210
5871,中租-KY,18,2,16,新百王,2024-05-28,6210
5371,中光電,44,29,15,新百王,2024-05-28,6210
3652,精聯,16,1,15,新百王,2024-05-28,6210
1611,中電,15,1,14,新百王,2024-05-28,6210
6275,元山,56,42,14,新百王,2024-05-28,6210
2486,一詮,29,15,14,新百王,2024-05-28,6210
2636,台驊控股,26,12,14,新百王,2024-05-28,6210
2436,偉詮電,13,0,13,新百王,2024-05-28,6210
8070,長華*,13,0,13,新百王,2024-05-28,6210
6164,華興,24,11,13,新百王,2024-05-28,6210
3005,神基,28,15,13,新百王,2024-05-28,6210
4532,瑞智,13,0,13,新百王,2024-05-28,6210
00680L,元大美債20正2,443,0,443,新百王,2024-05-29,6210
2867,三商壽,484,56,428,新百王,2024-05-29,6210
00937B,群益ESG投等債20,304,0,304,新百王,2024-05-29,6210
00857B,永豐20年美公債,203,0,203,新百王,2024-05-29,6210
2317,鴻海,227,70,157,新百王,2024-05-29,6210
3379,彬台,132,0,132,新百王,2024-05-29,6210
9946,三發地產,142,24,118,新百王,2024-05-29,6210
1303,南亞,116,11,105,新百王,2024-05-29,6210
2610,華航,162,57,105,新百王,2024-05-29,6210
00753L,中信中國50正2,100,4,96,新百王,2024-05-29,6210
2301,光寶科,113,23,90,新百王,2024-05-29,6210
00679B,元大美債20年,87,3,84,新百王,2024-05-29,6210
00688L,國泰20年美債正2,75,0,75,新百王,2024-05-29,6210
00712,復華富時不動產,80,10,70,新百王,2024-05-29,6210
2002,中鋼,69,0,69,新百王,2024-05-29,6210
00665L,富邦�琤肭磪囓�2,60,0,60,新百王,2024-05-29,6210
00919,群益台灣精選高息,108,51,57,新百王,2024-05-29,6210
2887,台新金,71,17,54,新百王,2024-05-29,6210
2206,三陽工業,53,0,53,新百王,2024-05-29,6210
2353,宏��,75,25,50,新百王,2024-05-29,6210
00795B,中信美國公債20年,72,22,50,新百王,2024-05-29,6210
4113,聯上,49,0,49,新百王,2024-05-29,6210
3047,訊舟,112,65,47,新百王,2024-05-29,6210
00650L,復華香港正2,46,0,46,新百王,2024-05-29,6210
00932,兆豐永續高息等權,40,2,38,新百王,2024-05-29,6210
8046,南電,37,4,33,新百王,2024-05-29,6210
00878,國泰永續高股息,68,36,32,新百王,2024-05-29,6210
4538,大詠城,31,0,31,新百王,2024-05-29,6210
2365,昆盈,37,6,31,新百王,2024-05-29,6210
1309,台達化,30,0,30,新百王,2024-05-29,6210
2897,王道銀行,112,82,30,新百王,2024-05-29,6210
00940,元大台灣價值高息,30,0,30,新百王,2024-05-29,6210
00946,群益科技高息成長,30,0,30,新百王,2024-05-29,6210
5272,笙科,31,1,30,新百王,2024-05-29,6210
6188,廣明,37,8,29,新百王,2024-05-29,6210
8401,白紗科,29,1,28,新百王,2024-05-29,6210
8096,擎亞,116,88,28,新百王,2024-05-29,6210
00713,元大台灣高息低波,31,5,26,新百王,2024-05-29,6210
2888,新光金,25,0,25,新百王,2024-05-29,6210
3630,新鉅科,24,0,24,新百王,2024-05-29,6210
2419,仲琦,36,12,24,新百王,2024-05-29,6210
3231,緯創,48,25,23,新百王,2024-05-29,6210
2417,圓剛,40,17,23,新百王,2024-05-29,6210
5426,振發,33,11,22,新百王,2024-05-29,6210
2363,矽統,55,34,21,新百王,2024-05-29,6210
1708,東鹼,20,0,20,新百王,2024-05-29,6210
2801,彰銀,20,0,20,新百王,2024-05-29,6210
00944,野村趨勢動能高息,20,0,20,新百王,2024-05-29,6210
4960,誠美材,20,0,20,新百王,2024-05-29,6210
5603,陸海,20,0,20,新百王,2024-05-29,6210
2892,第一金,240,0,240,新百王,2024-05-30,6210
00937B,群益ESG投等債20,251,120,131,新百王,2024-05-30,6210
4513,福裕,132,1,131,新百王,2024-05-30,6210
00680L,元大美債20正2,129,0,129,新百王,2024-05-30,6210
6290,良維,192,66,126,新百王,2024-05-30,6210
2515,中工,130,5,125,新百王,2024-05-30,6210
00712,復華富時不動產,124,0,124,新百王,2024-05-30,6210
2405,輔信,243,132,111,新百王,2024-05-30,6210
00857B,永豐20年美公債,101,0,101,新百王,2024-05-30,6210
2618,長榮航,175,84,91,新百王,2024-05-30,6210
3047,訊舟,164,90,74,新百王,2024-05-30,6210
4526,東台,70,0,70,新百王,2024-05-30,6210
00852L,國泰美國道瓊正2,67,3,64,新百王,2024-05-30,6210
00795B,中信美國公債20年,62,0,62,新百王,2024-05-30,6210
2610,華航,127,65,62,新百王,2024-05-30,6210
5347,世界,76,16,60,新百王,2024-05-30,6210
00753L,中信中國50正2,56,0,56,新百王,2024-05-30,6210
2002,中鋼,80,25,55,新百王,2024-05-30,6210
2489,瑞軒,74,28,46,新百王,2024-05-30,6210
8054,安國,71,29,42,新百王,2024-05-30,6210
9946,三發地產,44,2,42,新百王,2024-05-30,6210
00940,元大台灣價值高息,66,25,41,新百王,2024-05-30,6210
00665L,富邦�琤肭磪囓�2,60,20,40,新百王,2024-05-30,6210
2331,精英,50,11,39,新百王,2024-05-30,6210
00637L,元大滬深300正2,77,39,38,新百王,2024-05-30,6210
00929,復華台灣科技優息,114,76,38,新百王,2024-05-30,6210
00688L,國泰20年美債正2,46,10,36,新百王,2024-05-30,6210
2867,三商壽,36,1,35,新百王,2024-05-30,6210
2601,益航,30,0,30,新百王,2024-05-30,6210
2313,華通,42,13,29,新百王,2024-05-30,6210
6180,橘子,32,3,29,新百王,2024-05-30,6210
1447,力鵬,31,2,29,新百王,2024-05-30,6210
1815,富喬,176,148,28,新百王,2024-05-30,6210
2104,國際中橡,25,0,25,新百王,2024-05-30,6210
4533,協易機,61,36,25,新百王,2024-05-30,6210
2458,義隆,23,0,23,新百王,2024-05-30,6210
5443,均豪,26,5,21,新百王,2024-05-30,6210
1570,力肯,44,23,21,新百王,2024-05-30,6210
1326,台化,20,0,20,新百王,2024-05-30,6210
3481,群創,88,68,20,新百王,2024-05-30,6210
3390,旭軟,36,16,20,新百王,2024-05-30,6210
2353,宏��,53,35,18,新百王,2024-05-30,6210
3188,鑫龍騰,41,23,18,新百王,2024-05-30,6210
2609,陽明,30,13,17,新百王,2024-05-30,6210
2886,兆豐金,17,0,17,新百王,2024-05-30,6210
3313,斐成,46,29,17,新百王,2024-05-30,6210
2363,矽統,65,48,17,新百王,2024-05-30,6210
00650L,復華香港正2,21,4,17,新百王,2024-05-30,6210
00679B,元大美債20年,24,8,16,新百王,2024-05-30,6210
2330,台積電,37,22,15,新百王,2024-05-30,6210
00687B,國泰20年美債,1401,86,1315,新百王,2024-05-31,6210
00680L,元大美債20正2,739,0,739,新百王,2024-05-31,6210
9105,泰金寶-DR,120,0,120,新百王,2024-05-31,6210
4513,福裕,103,2,101,新百王,2024-05-31,6210
00929,復華台灣科技優息,141,44,97,新百王,2024-05-31,6210
3059,華晶科,131,59,72,新百王,2024-05-31,6210
00753L,中信中國50正2,70,0,70,新百王,2024-05-31,6210
00665L,富邦�琤肭磪囓�2,70,0,70,新百王,2024-05-31,6210
2609,陽明,290,233,57,新百王,2024-05-31,6210
9946,三發地產,58,3,55,新百王,2024-05-31,6210
2409,友達,42,0,42,新百王,2024-05-31,6210
1536,和大,59,19,40,新百王,2024-05-31,6210
2002,中鋼,39,0,39,新百王,2024-05-31,6210
3033,威健,82,45,37,新百王,2024-05-31,6210
2313,華通,43,10,33,新百王,2024-05-31,6210
2610,華航,103,72,31,新百王,2024-05-31,6210
00940,元大台灣價值高息,56,25,31,新百王,2024-05-31,6210
1531,高林股,30,0,30,新百王,2024-05-31,6210
2489,瑞軒,55,26,29,新百王,2024-05-31,6210
6243,迅杰,30,3,27,新百王,2024-05-31,6210
3312,弘憶股,150,123,27,新百王,2024-05-31,6210
2344,華邦電,27,2,25,新百王,2024-05-31,6210
1702,南僑,28,4,24,新百王,2024-05-31,6210
8070,長華*,57,33,24,新百王,2024-05-31,6210
2330,台積電,38,14,24,新百王,2024-05-31,6210
5871,中租-KY,36,14,22,新百王,2024-05-31,6210
00946,群益科技高息成長,21,0,21,新百王,2024-05-31,6210
6770,力積電,39,18,21,新百王,2024-05-31,6210
2241,艾姆勒,25,5,20,新百王,2024-05-31,6210
4960,誠美材,26,6,20,新百王,2024-05-31,6210
4714,永捷,21,1,20,新百王,2024-05-31,6210
2809,京城銀,21,2,19,新百王,2024-05-31,6210
3047,訊舟,69,50,19,新百王,2024-05-31,6210
3231,緯創,44,26,18,新百王,2024-05-31,6210
4726,永昕,36,18,18,新百王,2024-05-31,6210
9912,偉聯,17,0,17,新百王,2024-05-31,6210
0050,元大台灣50,31,16,15,新百王,2024-05-31,6210
4167,松瑞藥,15,0,15,新百王,2024-05-31,6210
00881,國泰台灣5G+,15,0,15,新百王,2024-05-31,6210
2425,承啟,34,19,15,新百王,2024-05-31,6210
00915,凱基優選高股息30,15,0,15,新百王,2024-05-31,6210
6695,芯鼎,142,127,15,新百王,2024-05-31,6210
2399,映泰,18,3,15,新百王,2024-05-31,6210
3055,蔚華科,35,21,14,新百王,2024-05-31,6210
2354,鴻準,106,92,14,新百王,2024-05-31,6210
2464,盟立,63,50,13,新百王,2024-05-31,6210
6443,元晶,13,0,13,新百王,2024-05-31,6210
2905,三商,15,2,13,新百王,2024-05-31,6210
4168,醣聯,14,1,13,新百王,2024-05-31,6210
2382,廣達,16,4,12,新百王,2024-05-31,6210
00715L,期街口布蘭特正2,391,1,390,新百王,2024-06-03,6210
2354,鴻準,396,113,283,新百王,2024-06-03,6210
2888,新光金,257,71,186,新百王,2024-06-03,6210
00632R,元大台灣50反1,537,429,108,新百王,2024-06-03,6210
00919,群益台灣精選高息,125,40,85,新百王,2024-06-03,6210
00918,大華優利高填息30,87,5,82,新百王,2024-06-03,6210
6219,富旺,80,0,80,新百王,2024-06-03,6210
2023,燁輝,72,0,72,新百王,2024-06-03,6210
2867,三商壽,95,26,69,新百王,2024-06-03,6210
3231,緯創,116,50,66,新百王,2024-06-03,6210
00929,復華台灣科技優息,133,76,57,新百王,2024-06-03,6210
9105,泰金寶-DR,65,10,55,新百王,2024-06-03,6210
2337,旺宏,52,1,51,新百王,2024-06-03,6210
6005,群益證,60,12,48,新百王,2024-06-03,6210
3372,典範,42,0,42,新百王,2024-06-03,6210
2515,中工,42,3,39,新百王,2024-06-03,6210
1536,和大,39,1,38,新百王,2024-06-03,6210
2520,冠德,38,0,38,新百王,2024-06-03,6210
2547,日勝生,45,12,33,新百王,2024-06-03,6210
1531,高林股,40,7,33,新百王,2024-06-03,6210
4533,協易機,74,43,31,新百王,2024-06-03,6210
2511,太子,30,0,30,新百王,2024-06-03,6210
1303,南亞,133,103,30,新百王,2024-06-03,6210
2615,萬海,137,108,29,新百王,2024-06-03,6210
2887,台新金,32,3,29,新百王,2024-06-03,6210
2353,宏��,45,18,27,新百王,2024-06-03,6210
6215,和椿,60,35,25,新百王,2024-06-03,6210
2641,正德,41,16,25,新百王,2024-06-03,6210
2313,華通,42,17,25,新百王,2024-06-03,6210
6770,力積電,27,2,25,新百王,2024-06-03,6210
2427,三商電,27,3,24,新百王,2024-06-03,6210
2538,基泰,27,4,23,新百王,2024-06-03,6210
2365,昆盈,25,2,23,新百王,2024-06-03,6210
2845,遠東銀,22,0,22,新百王,2024-06-03,6210
1605,華新,38,17,21,新百王,2024-06-03,6210
2303,聯電,36,16,20,新百王,2024-06-03,6210
2889,國票金,25,5,20,新百王,2024-06-03,6210
6173,信昌電,20,0,20,新百王,2024-06-03,6210
6164,華興,19,0,19,新百王,2024-06-03,6210
6163,華電網,20,2,18,新百王,2024-06-03,6210
2002,中鋼,22,4,18,新百王,2024-06-03,6210
6552,易華電,22,5,17,新百王,2024-06-03,6210
2881,富邦金,17,1,16,新百王,2024-06-03,6210
3437,榮創,30,14,16,新百王,2024-06-03,6210
4113,聯上,17,2,15,新百王,2024-06-03,6210
2409,友達,22,7,15,新百王,2024-06-03,6210
5880,合庫金,15,0,15,新百王,2024-06-03,6210
4127,天良,14,0,14,新百王,2024-06-03,6210
4561,健椿,15,1,14,新百王,2024-06-03,6210
00653L,富邦印度正2,13,0,13,新百王,2024-06-03,6210
00715L,期街口布蘭特正2,685,30,655,新百王,2024-06-04,6210
2317,鴻海,400,9,391,新百王,2024-06-04,6210
2888,新光金,140,10,130,新百王,2024-06-04,6210
2312,金寶,144,34,110,新百王,2024-06-04,6210
00929,復華台灣科技優息,137,40,97,新百王,2024-06-04,6210
9946,三發地產,99,2,97,新百王,2024-06-04,6210
4113,聯上,105,11,94,新百王,2024-06-04,6210
00753L,中信中國50正2,92,3,89,新百王,2024-06-04,6210
1528,恩德,88,0,88,新百王,2024-06-04,6210
3712,永崴投控,81,0,81,新百王,2024-06-04,6210
3481,群創,78,0,78,新百王,2024-06-04,6210
1314,中石化,66,4,62,新百王,2024-06-04,6210
2328,廣宇,67,18,49,新百王,2024-06-04,6210
4526,東台,57,11,46,新百王,2024-06-04,6210
2353,宏��,62,16,46,新百王,2024-06-04,6210
1802,台玻,226,182,44,新百王,2024-06-04,6210
2405,輔信,43,4,39,新百王,2024-06-04,6210
00713,元大台灣高息低波,39,4,35,新百王,2024-06-04,6210
6139,亞翔,35,1,34,新百王,2024-06-04,6210
5519,隆大,70,40,30,新百王,2024-06-04,6210
1313,聯成,30,0,30,新百王,2024-06-04,6210
1102,亞泥,30,0,30,新百王,2024-06-04,6210
3520,華盈,30,1,29,新百王,2024-06-04,6210
00936,台新永續高息中小,139,112,27,新百王,2024-06-04,6210
1326,台化,26,0,26,新百王,2024-06-04,6210
4927,泰鼎-KY,26,0,26,新百王,2024-06-04,6210
2537,聯上發,241,215,26,新百王,2024-06-04,6210
2109,華豐,29,4,25,新百王,2024-06-04,6210
2409,友達,25,0,25,新百王,2024-06-04,6210
6125,廣運,96,72,24,新百王,2024-06-04,6210
2363,矽統,71,49,22,新百王,2024-06-04,6210
00918,大華優利高填息30,31,10,21,新百王,2024-06-04,6210
3033,威健,22,1,21,新百王,2024-06-04,6210
2883,凱基金,21,0,21,新百王,2024-06-04,6210
2344,華邦電,21,0,21,新百王,2024-06-04,6210
00919,群益台灣精選高息,28,8,20,新百王,2024-06-04,6210
4127,天良,20,0,20,新百王,2024-06-04,6210
3356,奇偶,31,11,20,新百王,2024-06-04,6210
3231,緯創,38,20,18,新百王,2024-06-04,6210
2303,聯電,19,2,17,新百王,2024-06-04,6210
2603,長榮,33,16,17,新百王,2024-06-04,6210
4561,健椿,21,4,17,新百王,2024-06-04,6210
5426,振發,32,15,17,新百王,2024-06-04,6210
1904,正隆,15,0,15,新百王,2024-06-04,6210
0056,元大高股息,15,0,15,新百王,2024-06-04,6210
4976,佳凌,15,0,15,新百王,2024-06-04,6210
2880,華南金,14,0,14,新百王,2024-06-04,6210
2324,仁寶,32,18,14,新百王,2024-06-04,6210
6161,捷波,16,2,14,新百王,2024-06-04,6210
00878,國泰永續高股息,29,15,14,新百王,2024-06-04,6210
2515,中工,528,2,526,新百王,2024-06-05,6210
00753L,中信中國50正2,340,65,275,新百王,2024-06-05,6210
00929,復華台灣科技優息,194,1,193,新百王,2024-06-05,6210
2886,兆豐金,184,1,183,新百王,2024-06-05,6210
2888,新光金,150,0,150,新百王,2024-06-05,6210
00632R,元大台灣50反1,335,210,125,新百王,2024-06-05,6210
3014,聯陽,122,5,117,新百王,2024-06-05,6210
3712,永崴投控,115,0,115,新百王,2024-06-05,6210
2641,正德,124,19,105,新百王,2024-06-05,6210
6219,富旺,92,0,92,新百王,2024-06-05,6210
8096,擎亞,155,89,66,新百王,2024-06-05,6210
2867,三商壽,70,11,59,新百王,2024-06-05,6210
3048,益登,108,54,54,新百王,2024-06-05,6210
00942B,台新美A公司債20+,100,50,50,新百王,2024-06-05,6210
2337,旺宏,50,0,50,新百王,2024-06-05,6210
2427,三商電,59,11,48,新百王,2024-06-05,6210
2002,中鋼,46,0,46,新百王,2024-06-05,6210
2609,陽明,526,486,40,新百王,2024-06-05,6210
4113,聯上,38,0,38,新百王,2024-06-05,6210
6197,佳必琪,57,21,36,新百王,2024-06-05,6210
3033,威健,37,2,35,新百王,2024-06-05,6210
1734,杏輝,35,0,35,新百王,2024-06-05,6210
4127,天良,29,0,29,新百王,2024-06-05,6210
00878,國泰永續高股息,43,15,28,新百王,2024-06-05,6210
2303,聯電,52,26,26,新百王,2024-06-05,6210
00715L,期街口布蘭特正2,25,0,25,新百王,2024-06-05,6210
8147,正淩,29,5,24,新百王,2024-06-05,6210
5608,四維航,36,12,24,新百王,2024-06-05,6210
00712,復華富時不動產,39,16,23,新百王,2024-06-05,6210
2509,全坤建,20,0,20,新百王,2024-06-05,6210
3188,鑫龍騰,20,0,20,新百王,2024-06-05,6210
1785,光洋科,21,1,20,新百王,2024-06-05,6210
2104,國際中橡,20,0,20,新百王,2024-06-05,6210
2618,長榮航,150,132,18,新百王,2024-06-05,6210
2611,志信,83,66,17,新百王,2024-06-05,6210
3088,艾訊,37,21,16,新百王,2024-06-05,6210
3062,建漢,25,10,15,新百王,2024-06-05,6210
00637L,元大滬深300正2,43,28,15,新百王,2024-06-05,6210
2489,瑞軒,20,6,14,新百王,2024-06-05,6210
6449,鈺邦,18,4,14,新百王,2024-06-05,6210
3047,訊舟,54,40,14,新百王,2024-06-05,6210
00918,大華優利高填息30,14,0,14,新百王,2024-06-05,6210
2409,友達,15,2,13,新百王,2024-06-05,6210
4566,時碩工業,44,31,13,新百王,2024-06-05,6210
2527,宏璟,18,6,12,新百王,2024-06-05,6210
2348,海悅,13,1,12,新百王,2024-06-05,6210
2538,基泰,12,0,12,新百王,2024-06-05,6210
2352,佳世達,11,0,11,新百王,2024-06-05,6210
4938,和碩,11,0,11,新百王,2024-06-05,6210
4513,福裕,13,2,11,新百王,2024-06-05,6210
1314,中石化,824,1,823,新百王,2024-06-06,6210
00632R,元大台灣50反1,950,239,711,新百王,2024-06-06,6210
2002,中鋼,603,6,597,新百王,2024-06-06,6210
9105,泰金寶-DR,178,8,170,新百王,2024-06-06,6210
00929,復華台灣科技優息,167,5,162,新百王,2024-06-06,6210
00936,台新永續高息中小,156,13,143,新百王,2024-06-06,6210
2312,金寶,232,103,129,新百王,2024-06-06,6210
4562,穎漢,114,14,100,新百王,2024-06-06,6210
00940,元大台灣價值高息,108,10,98,新百王,2024-06-06,6210
6163,華電網,76,9,67,新百王,2024-06-06,6210
00680L,元大美債20正2,100,35,65,新百王,2024-06-06,6210
00918,大華優利高填息30,68,4,64,新百王,2024-06-06,6210
4726,永昕,63,2,61,新百王,2024-06-06,6210
5498,凱崴,56,1,55,新百王,2024-06-06,6210
6125,廣運,104,51,53,新百王,2024-06-06,6210
2520,冠德,76,30,46,新百王,2024-06-06,6210
3188,鑫龍騰,57,11,46,新百王,2024-06-06,6210
2367,燿華,130,87,43,新百王,2024-06-06,6210
2020,美亞,40,0,40,新百王,2024-06-06,6210
9946,三發地產,52,12,40,新百王,2024-06-06,6210
00864B,中信美國公債0-1,33,0,33,新百王,2024-06-06,6210
3231,緯創,58,26,32,新百王,2024-06-06,6210
2383,台光電,31,0,31,新百王,2024-06-06,6210
4909,新復興,33,4,29,新百王,2024-06-06,6210
6770,力積電,28,0,28,新百王,2024-06-06,6210
2101,南港,33,6,27,新百王,2024-06-06,6210
2382,廣達,45,18,27,新百王,2024-06-06,6210
00692,富邦公司治理,25,0,25,新百王,2024-06-06,6210
2881,富邦金,35,10,25,新百王,2024-06-06,6210
3481,群創,162,138,24,新百王,2024-06-06,6210
4967,十銓,80,56,24,新百王,2024-06-06,6210
00919,群益台灣精選高息,35,12,23,新百王,2024-06-06,6210
5871,中租-KY,37,15,22,新百王,2024-06-06,6210
2615,萬海,103,81,22,新百王,2024-06-06,6210
9945,潤泰新,90,69,21,新百王,2024-06-06,6210
6215,和椿,35,15,20,新百王,2024-06-06,6210
2885,元大金,21,1,20,新百王,2024-06-06,6210
2317,鴻海,169,150,19,新百王,2024-06-06,6210
2409,友達,32,13,19,新百王,2024-06-06,6210
2371,大同,19,2,17,新百王,2024-06-06,6210
4919,新唐,21,5,16,新百王,2024-06-06,6210
6170,統振,26,10,16,新百王,2024-06-06,6210
2913,農林,16,0,16,新百王,2024-06-06,6210
2486,一詮,43,28,15,新百王,2024-06-06,6210
1815,富喬,73,58,15,新百王,2024-06-06,6210
5302,太欣,16,1,15,新百王,2024-06-06,6210
2892,第一金,15,0,15,新百王,2024-06-06,6210
3712,永崴投控,14,0,14,新百王,2024-06-06,6210
3047,訊舟,111,97,14,新百王,2024-06-06,6210
2534,宏盛,15,1,14,新百王,2024-06-06,6210
2312,金寶,356,57,299,新百王,2024-06-07,6210
00936,台新永續高息中小,230,14,216,新百王,2024-06-07,6210
00637L,元大滬深300正2,144,28,116,新百王,2024-06-07,6210
4562,穎漢,117,63,54,新百王,2024-06-07,6210
2331,精英,76,23,53,新百王,2024-06-07,6210
2427,三商電,57,6,51,新百王,2024-06-07,6210
3231,緯創,69,19,50,新百王,2024-06-07,6210
00712,復華富時不動產,45,0,45,新百王,2024-06-07,6210
4967,十銓,88,48,40,新百王,2024-06-07,6210
8163,達方,39,0,39,新百王,2024-06-07,6210
00795B,中信美國公債20年,38,0,38,新百王,2024-06-07,6210
1609,大亞,69,33,36,新百王,2024-06-07,6210
2548,華固,46,10,36,新百王,2024-06-07,6210
2615,萬海,129,93,36,新百王,2024-06-07,6210
2353,宏��,47,12,35,新百王,2024-06-07,6210
00665L,富邦�琤肭磪囓�2,34,0,34,新百王,2024-06-07,6210
2534,宏盛,33,0,33,新百王,2024-06-07,6210
00655L,國泰中國A50正2,31,0,31,新百王,2024-06-07,6210
4113,聯上,115,85,30,新百王,2024-06-07,6210
2528,皇普,31,1,30,新百王,2024-06-07,6210
5512,力麒,39,9,30,新百王,2024-06-07,6210
4127,天良,29,0,29,新百王,2024-06-07,6210
5522,遠雄,34,6,28,新百王,2024-06-07,6210
6155,鈞寶,26,0,26,新百王,2024-06-07,6210
2489,瑞軒,85,61,24,新百王,2024-06-07,6210
00878,國泰永續高股息,23,0,23,新百王,2024-06-07,6210
3515,華擎,22,0,22,新百王,2024-06-07,6210
4167,松瑞藥,20,0,20,新百王,2024-06-07,6210
2605,新興,38,18,20,新百王,2024-06-07,6210
00918,大華優利高填息30,20,2,18,新百王,2024-06-07,6210
2509,全坤建,40,22,18,新百王,2024-06-07,6210
2421,建準,25,7,18,新百王,2024-06-07,6210
3047,訊舟,75,57,18,新百王,2024-06-07,6210
6418,詠昇,17,1,16,新百王,2024-06-07,6210
2351,順德,25,9,16,新百王,2024-06-07,6210
2382,廣達,20,4,16,新百王,2024-06-07,6210
3580,友威科,15,0,15,新百王,2024-06-07,6210
2613,中櫃,118,104,14,新百王,2024-06-07,6210
8222,寶一,14,0,14,新百王,2024-06-07,6210
6164,華興,14,0,14,新百王,2024-06-07,6210
2352,佳世達,13,0,13,新百王,2024-06-07,6210
3176,基亞,13,0,13,新百王,2024-06-07,6210
5871,中租-KY,29,16,13,新百王,2024-06-07,6210
6449,鈺邦,13,1,12,新百王,2024-06-07,6210
2515,中工,26,14,12,新百王,2024-06-07,6210
2002,中鋼,17,5,12,新百王,2024-06-07,6210
9940,信義,20,8,12,新百王,2024-06-07,6210
2406,國碩,15,4,11,新百王,2024-06-07,6210
3013,晟銘電,70,59,11,新百王,2024-06-07,6210
1529,樂事綠能,11,1,10,新百王,2024-06-07,6210
00680L,元大美債20正2,517,5,512,新百王,2024-06-11,6210
00687B,國泰20年美債,450,0,450,新百王,2024-06-11,6210
2801,彰銀,371,3,368,新百王,2024-06-11,6210
1314,中石化,411,146,265,新百王,2024-06-11,6210
00795B,中信美國公債20年,221,0,221,新百王,2024-06-11,6210
2834,臺企銀,175,10,165,新百王,2024-06-11,6210
00937B,群益ESG投等債20,190,53,137,新百王,2024-06-11,6210
2888,新光金,211,78,133,新百王,2024-06-11,6210
00931B,統一美債20年,111,2,109,新百王,2024-06-11,6210
2618,長榮航,162,53,109,新百王,2024-06-11,6210
3052,夆典,92,0,92,新百王,2024-06-11,6210
00936,台新永續高息中小,90,0,90,新百王,2024-06-11,6210
00929,復華台灣科技優息,128,42,86,新百王,2024-06-11,6210
2603,長榮,124,39,85,新百王,2024-06-11,6210
00679B,元大美債20年,112,30,82,新百王,2024-06-11,6210
3047,訊舟,198,116,82,新百王,2024-06-11,6210
00688L,國泰20年美債正2,77,0,77,新百王,2024-06-11,6210
9907,統一實,69,0,69,新百王,2024-06-11,6210
2002,中鋼,68,0,68,新百王,2024-06-11,6210
1815,富喬,95,31,64,新百王,2024-06-11,6210
2331,精英,60,1,59,新百王,2024-06-11,6210
9946,三發地產,105,50,55,新百王,2024-06-11,6210
2637,慧洋-KY,65,10,55,新百王,2024-06-11,6210
00712,復華富時不動產,56,2,54,新百王,2024-06-11,6210
3481,群創,152,103,49,新百王,2024-06-11,6210
1802,台玻,60,13,47,新百王,2024-06-11,6210
00919,群益台灣精選高息,81,35,46,新百王,2024-06-11,6210
2515,中工,46,3,43,新百王,2024-06-11,6210
00918,大華優利高填息30,42,0,42,新百王,2024-06-11,6210
3535,晶彩科,52,11,41,新百王,2024-06-11,6210
1416,廣豐,40,0,40,新百王,2024-06-11,6210
2634,漢翔,40,0,40,新百王,2024-06-11,6210
2897,王道銀行,89,50,39,新百王,2024-06-11,6210
2344,華邦電,37,0,37,新百王,2024-06-11,6210
2609,陽明,464,428,36,新百王,2024-06-11,6210
2511,太子,35,0,35,新百王,2024-06-11,6210
1446,宏和,35,1,34,新百王,2024-06-11,6210
2356,英業達,83,49,34,新百王,2024-06-11,6210
5608,四維航,79,48,31,新百王,2024-06-11,6210
00650L,復華香港正2,41,10,31,新百王,2024-06-11,6210
5522,遠雄,31,1,30,新百王,2024-06-11,6210
00655L,國泰中國A50正2,34,4,30,新百王,2024-06-11,6210
1612,宏泰,30,0,30,新百王,2024-06-11,6210
9940,信義,30,0,30,新百王,2024-06-11,6210
00632R,元大台灣50反1,271,243,28,新百王,2024-06-11,6210
00907,永豐優息存股,25,0,25,新百王,2024-06-11,6210
00933B,國泰10Y+金融債,87,62,25,新百王,2024-06-11,6210
6219,富旺,25,0,25,新百王,2024-06-11,6210
4127,天良,29,6,23,新百王,2024-06-11,6210
2312,金寶,107,84,23,新百王,2024-06-11,6210
00632R,元大台灣50反1,1168,222,946,新百王,2024-06-12,6210
2897,王道銀行,208,10,198,新百王,2024-06-12,6210
4127,天良,155,0,155,新百王,2024-06-12,6210
00712,復華富時不動產,120,0,120,新百王,2024-06-12,6210
00937B,群益ESG投等債20,112,2,110,新百王,2024-06-12,6210
00688L,國泰20年美債正2,125,30,95,新百王,2024-06-12,6210
00687B,國泰20年美債,95,6,89,新百王,2024-06-12,6210
2867,三商壽,95,14,81,新百王,2024-06-12,6210
6770,力積電,83,5,78,新百王,2024-06-12,6210
2002,中鋼,76,5,71,新百王,2024-06-12,6210
3047,訊舟,296,226,70,新百王,2024-06-12,6210
00919,群益台灣精選高息,70,0,70,新百王,2024-06-12,6210
2883,凱基金,92,38,54,新百王,2024-06-12,6210
00918,大華優利高填息30,71,20,51,新百王,2024-06-12,6210
2603,長榮,113,64,49,新百王,2024-06-12,6210
2542,興富發,54,5,49,新百王,2024-06-12,6210
2313,華通,53,7,46,新百王,2024-06-12,6210
6207,雷科,105,62,43,新百王,2024-06-12,6210
3048,益登,84,43,41,新百王,2024-06-12,6210
3625,西勝,40,0,40,新百王,2024-06-12,6210
00753L,中信中國50正2,35,0,35,新百王,2024-06-12,6210
1609,大亞,47,12,35,新百王,2024-06-12,6210
1514,亞力,59,25,34,新百王,2024-06-12,6210
6695,芯鼎,31,0,31,新百王,2024-06-12,6210
6290,良維,52,22,30,新百王,2024-06-12,6210
1446,宏和,30,1,29,新百王,2024-06-12,6210
4113,聯上,34,5,29,新百王,2024-06-12,6210
2610,華航,46,19,27,新百王,2024-06-12,6210
4167,松瑞藥,26,0,26,新百王,2024-06-12,6210
2323,中環,25,0,25,新百王,2024-06-12,6210
1218,泰山,25,0,25,新百王,2024-06-12,6210
2367,燿華,89,64,25,新百王,2024-06-12,6210
2888,新光金,40,17,23,新百王,2024-06-12,6210
2353,宏��,40,18,22,新百王,2024-06-12,6210
2887,台新金,42,20,22,新百王,2024-06-12,6210
2607,榮運,22,1,21,新百王,2024-06-12,6210
9946,三發地產,37,16,21,新百王,2024-06-12,6210
2641,正德,21,1,20,新百王,2024-06-12,6210
2406,國碩,21,1,20,新百王,2024-06-12,6210
3042,晶技,22,2,20,新百王,2024-06-12,6210
2344,華邦電,19,0,19,新百王,2024-06-12,6210
9945,潤泰新,42,23,19,新百王,2024-06-12,6210
3363,上詮,33,14,19,新百王,2024-06-12,6210
2851,中再保,18,0,18,新百王,2024-06-12,6210
6164,華興,47,29,18,新百王,2024-06-12,6210
2601,益航,17,0,17,新百王,2024-06-12,6210
8110,華東,17,0,17,新百王,2024-06-12,6210
3176,基亞,16,0,16,新百王,2024-06-12,6210
3188,鑫龍騰,37,21,16,新百王,2024-06-12,6210
5392,能率,24,8,16,新百王,2024-06-12,6210
00632R,元大台灣50反1,698,360,338,新百王,2024-06-13,6210
2312,金寶,112,5,107,新百王,2024-06-13,6210
00948B,中信優息投資級債,203,100,103,新百王,2024-06-13,6210
2618,長榮航,153,66,87,新百王,2024-06-13,6210
6125,廣運,91,31,60,新百王,2024-06-13,6210
00712,復華富時不動產,67,10,57,新百王,2024-06-13,6210
1217,愛之味,50,0,50,新百王,2024-06-13,6210
2615,萬海,126,83,43,新百王,2024-06-13,6210
8096,擎亞,66,26,40,新百王,2024-06-13,6210
00918,大華優利高填息30,52,15,37,新百王,2024-06-13,6210
2887,台新金,61,26,35,新百王,2024-06-13,6210
4127,天良,35,0,35,新百王,2024-06-13,6210
4909,新復興,51,16,35,新百王,2024-06-13,6210
2365,昆盈,74,41,33,新百王,2024-06-13,6210
2801,彰銀,170,138,32,新百王,2024-06-13,6210
0050,元大台灣50,31,5,26,新百王,2024-06-13,6210
2637,慧洋-KY,50,24,26,新百王,2024-06-13,6210
00664R,國泰臺灣加權反1,24,0,24,新百王,2024-06-13,6210
2897,王道銀行,93,70,23,新百王,2024-06-13,6210
3188,鑫龍騰,44,21,23,新百王,2024-06-13,6210
00753L,中信中國50正2,21,0,21,新百王,2024-06-13,6210
6190,萬泰科,35,14,21,新百王,2024-06-13,6210
2331,精英,27,6,21,新百王,2024-06-13,6210
2356,英業達,65,45,20,新百王,2024-06-13,6210
00937B,群益ESG投等債20,54,34,20,新百王,2024-06-13,6210
5210,寶碩,20,0,20,新百王,2024-06-13,6210
2329,華泰,22,2,20,新百王,2024-06-13,6210
6153,嘉聯益,25,7,18,新百王,2024-06-13,6210
9946,三發地產,19,2,17,新百王,2024-06-13,6210
00720B,元大投資級公司債,21,4,17,新百王,2024-06-13,6210
2392,正崴,118,101,17,新百王,2024-06-13,6210
2359,所羅門,138,121,17,新百王,2024-06-13,6210
2376,技嘉,23,7,16,新百王,2024-06-13,6210
4167,松瑞藥,56,41,15,新百王,2024-06-13,6210
2641,正德,19,4,15,新百王,2024-06-13,6210
2609,陽明,341,326,15,新百王,2024-06-13,6210
3694,海華,15,0,15,新百王,2024-06-13,6210
4726,永昕,19,4,15,新百王,2024-06-13,6210
6505,台塑化,15,0,15,新百王,2024-06-13,6210
5243,乙盛-KY,15,1,14,新百王,2024-06-13,6210
3356,奇偶,19,5,14,新百王,2024-06-13,6210
2890,永豐金,15,1,14,新百王,2024-06-13,6210
00665L,富邦�琤肭磪囓�2,14,0,14,新百王,2024-06-13,6210
2368,金像電,14,1,13,新百王,2024-06-13,6210
1815,富喬,21,8,13,新百王,2024-06-13,6210
2352,佳世達,13,0,13,新百王,2024-06-13,6210
2344,華邦電,18,5,13,新百王,2024-06-13,6210
1618,合機,12,0,12,新百王,2024-06-13,6210
6161,捷波,13,1,12,新百王,2024-06-13,6210
4109,加捷生醫,11,0,11,新百王,2024-06-13,6210
00942B,台新美A公司債20+,247,15,232,新百王,2024-06-14,6210
2371,大同,244,58,186,新百王,2024-06-14,6210
3013,晟銘電,221,39,182,新百王,2024-06-14,6210
2542,興富發,227,60,167,新百王,2024-06-14,6210
5876,上海商銀,163,13,150,新百王,2024-06-14,6210
9105,泰金寶-DR,445,318,127,新百王,2024-06-14,6210
3048,益登,190,98,92,新百王,2024-06-14,6210
00637L,元大滬深300正2,158,77,81,新百王,2024-06-14,6210
3062,建漢,97,20,77,新百王,2024-06-14,6210
9946,三發地產,61,0,61,新百王,2024-06-14,6210
6213,聯茂,81,22,59,新百王,2024-06-14,6210
2312,金寶,143,85,58,新百王,2024-06-14,6210
6216,居易,53,3,50,新百王,2024-06-14,6210
00918,大華優利高填息30,68,24,44,新百王,2024-06-14,6210
3006,晶豪科,52,10,42,新百王,2024-06-14,6210
00946,群益科技高息成長,40,0,40,新百王,2024-06-14,6210
2313,華通,37,4,33,新百王,2024-06-14,6210
8096,擎亞,75,42,33,新百王,2024-06-14,6210
2867,三商壽,29,0,29,新百王,2024-06-14,6210
4113,聯上,28,0,28,新百王,2024-06-14,6210
2363,矽統,125,98,27,新百王,2024-06-14,6210
00896,中信綠能及電動車,25,0,25,新百王,2024-06-14,6210
2002,中鋼,25,0,25,新百王,2024-06-14,6210
00919,群益台灣精選高息,31,7,24,新百王,2024-06-14,6210
1609,大亞,116,92,24,新百王,2024-06-14,6210
1785,光洋科,27,4,23,新百王,2024-06-14,6210
2330,台積電,27,5,22,新百王,2024-06-14,6210
2915,潤泰全,27,5,22,新百王,2024-06-14,6210
2611,志信,28,6,22,新百王,2024-06-14,6210
2913,農林,25,3,22,新百王,2024-06-14,6210
6505,台塑化,21,0,21,新百王,2024-06-14,6210
1795,美時,28,8,20,新百王,2024-06-14,6210
9945,潤泰新,28,8,20,新百王,2024-06-14,6210
2340,台亞,20,1,19,新百王,2024-06-14,6210
2537,聯上發,154,136,18,新百王,2024-06-14,6210
5508,永信建,22,4,18,新百王,2024-06-14,6210
3450,聯鈞,42,25,17,新百王,2024-06-14,6210
00933B,國泰10Y+金融債,16,0,16,新百王,2024-06-14,6210
6217,中探針,16,0,16,新百王,2024-06-14,6210
00936,台新永續高息中小,36,21,15,新百王,2024-06-14,6210
3231,緯創,42,27,15,新百王,2024-06-14,6210
6552,易華電,37,22,15,新百王,2024-06-14,6210
6418,詠昇,15,0,15,新百王,2024-06-14,6210
2353,宏��,80,66,14,新百王,2024-06-14,6210
6667,信紘科,15,1,14,新百王,2024-06-14,6210
5905,南仁湖,15,2,13,新百王,2024-06-14,6210
020037,元大金融高股息N,13,0,13,新百王,2024-06-14,6210
1447,力鵬,12,0,12,新百王,2024-06-14,6210
4513,福裕,15,3,12,新百王,2024-06-14,6210
3030,德律,12,0,12,新百王,2024-06-14,6210
2542,興富發,708,15,693,新百王,2024-06-17,6210
2312,金寶,248,38,210,新百王,2024-06-17,6210
00942B,台新美A公司債20+,200,0,200,新百王,2024-06-17,6210
00929,復華台灣科技優息,245,58,187,新百王,2024-06-17,6210
6156,松上,126,0,126,新百王,2024-06-17,6210
00918,大華優利高填息30,109,8,101,新百王,2024-06-17,6210
00948B,中信優息投資級債,81,0,81,新百王,2024-06-17,6210
2344,華邦電,87,11,76,新百王,2024-06-17,6210
2881,富邦金,72,3,69,新百王,2024-06-17,6210
1326,台化,65,0,65,新百王,2024-06-17,6210
00632R,元大台灣50反1,300,240,60,新百王,2024-06-17,6210
2897,王道銀行,129,72,57,新百王,2024-06-17,6210
3591,艾笛森,63,8,55,新百王,2024-06-17,6210
3481,群創,253,199,54,新百王,2024-06-17,6210
00946,群益科技高息成長,50,0,50,新百王,2024-06-17,6210
2002,中鋼,51,1,50,新百王,2024-06-17,6210
6266,泰詠,50,0,50,新百王,2024-06-17,6210
00936,台新永續高息中小,137,88,49,新百王,2024-06-17,6210
9105,泰金寶-DR,109,63,46,新百王,2024-06-17,6210
2887,台新金,178,133,45,新百王,2024-06-17,6210
6139,亞翔,51,14,37,新百王,2024-06-17,6210
4127,天良,35,0,35,新百王,2024-06-17,6210
2812,台中銀,49,15,34,新百王,2024-06-17,6210
2352,佳世達,32,0,32,新百王,2024-06-17,6210
3710,連展投控,32,0,32,新百王,2024-06-17,6210
1466,聚隆,40,10,30,新百王,2024-06-17,6210
3625,西勝,30,0,30,新百王,2024-06-17,6210
4167,松瑞藥,56,27,29,新百王,2024-06-17,6210
2609,陽明,297,271,26,新百王,2024-06-17,6210
00941,中信上游半導體,25,0,25,新百王,2024-06-17,6210
2883,凱基金,24,0,24,新百王,2024-06-17,6210
6695,芯鼎,22,0,22,新百王,2024-06-17,6210
00921,兆豐龍頭等權重,22,0,22,新百王,2024-06-17,6210
3188,鑫龍騰,21,0,21,新百王,2024-06-17,6210
911868,同方友友-DR,21,0,21,新百王,2024-06-17,6210
2606,裕民,20,0,20,新百王,2024-06-17,6210
00934,中信成長高股息,20,0,20,新百王,2024-06-17,6210
00753L,中信中國50正2,40,20,20,新百王,2024-06-17,6210
1110,東泥,20,0,20,新百王,2024-06-17,6210
2449,京元電子,42,23,19,新百王,2024-06-17,6210
2915,潤泰全,19,0,19,新百王,2024-06-17,6210
6472,保瑞,21,2,19,新百王,2024-06-17,6210
1618,合機,84,66,18,新百王,2024-06-17,6210
6416,瑞祺電通,18,0,18,新百王,2024-06-17,6210
2351,順德,33,15,18,新百王,2024-06-17,6210
6213,聯茂,29,11,18,新百王,2024-06-17,6210
1513,中興電,54,37,17,新百王,2024-06-17,6210
00885,富邦越南,17,0,17,新百王,2024-06-17,6210
2101,南港,17,1,16,新百王,2024-06-17,6210
1616,億泰,24,9,15,新百王,2024-06-17,6210
3481,群創,665,265,400,新百王,2024-06-18,6210
00918,大華優利高填息30,242,40,202,新百王,2024-06-18,6210
5490,同亨,215,15,200,新百王,2024-06-18,6210
1314,中石化,210,10,200,新百王,2024-06-18,6210
00753L,中信中國50正2,170,5,165,新百王,2024-06-18,6210
2887,台新金,135,1,134,新百王,2024-06-18,6210
1303,南亞,140,7,133,新百王,2024-06-18,6210
00632R,元大台灣50反1,477,348,129,新百王,2024-06-18,6210
911868,同方友友-DR,125,0,125,新百王,2024-06-18,6210
00942B,台新美A公司債20+,110,0,110,新百王,2024-06-18,6210
00940,元大台灣價值高息,124,18,106,新百王,2024-06-18,6210
00687B,國泰20年美債,113,9,104,新百王,2024-06-18,6210
3013,晟銘電,100,14,86,新百王,2024-06-18,6210
2314,台揚,90,10,80,新百王,2024-06-18,6210
2312,金寶,87,12,75,新百王,2024-06-18,6210
00936,台新永續高息中小,99,47,52,新百王,2024-06-18,6210
3047,訊舟,94,42,52,新百王,2024-06-18,6210
2353,宏��,61,11,50,新百王,2024-06-18,6210
1815,富喬,65,15,50,新百王,2024-06-18,6210
00688L,國泰20年美債正2,45,0,45,新百王,2024-06-18,6210
2801,彰銀,43,0,43,新百王,2024-06-18,6210
2363,矽統,73,32,41,新百王,2024-06-18,6210
912000,晨訊科-DR,44,3,41,新百王,2024-06-18,6210
00946,群益科技高息成長,40,0,40,新百王,2024-06-18,6210
3048,益登,69,30,39,新百王,2024-06-18,6210
2317,鴻海,87,49,38,新百王,2024-06-18,6210
00915,凱基優選高股息30,64,27,37,新百王,2024-06-18,6210
3312,弘憶股,37,0,37,新百王,2024-06-18,6210
2371,大同,78,41,37,新百王,2024-06-18,6210
4967,十銓,61,25,36,新百王,2024-06-18,6210
2515,中工,34,0,34,新百王,2024-06-18,6210
1446,宏和,35,1,34,新百王,2024-06-18,6210
00713,元大台灣高息低波,50,20,30,新百王,2024-06-18,6210
4127,天良,30,0,30,新百王,2024-06-18,6210
6488,環球晶,30,0,30,新百王,2024-06-18,6210
1612,宏泰,30,0,30,新百王,2024-06-18,6210
6219,富旺,30,2,28,新百王,2024-06-18,6210
3622,洋華,102,75,27,新百王,2024-06-18,6210
2465,麗臺,26,0,26,新百王,2024-06-18,6210
00650L,復華香港正2,25,0,25,新百王,2024-06-18,6210
6695,芯鼎,24,0,24,新百王,2024-06-18,6210
9103,美德醫療-DR,34,10,24,新百王,2024-06-18,6210
00907,永豐優息存股,25,2,23,新百王,2024-06-18,6210
00948B,中信優息投資級債,23,0,23,新百王,2024-06-18,6210
2509,全坤建,23,0,23,新百王,2024-06-18,6210
8064,東捷,78,57,21,新百王,2024-06-18,6210
6116,彩晶,20,0,20,新百王,2024-06-18,6210
00641R,富邦日本反1,20,0,20,新百王,2024-06-18,6210
3625,西勝,20,0,20,新百王,2024-06-18,6210
1471,首利,20,0,20,新百王,2024-06-18,6210
00673R,期元大S＆P原油反1,678,0,678,新百王,2024-06-19,6210
1314,中石化,415,14,401,新百王,2024-06-19,6210
00929,復華台灣科技優息,519,163,356,新百王,2024-06-19,6210
00632R,元大台灣50反1,497,230,267,新百王,2024-06-19,6210
00919,群益台灣精選高息,245,53,192,新百王,2024-06-19,6210
00712,復華富時不動產,163,24,139,新百王,2024-06-19,6210
00942B,台新美A公司債20+,100,0,100,新百王,2024-06-19,6210
00665L,富邦�琤肭磪囓�2,117,24,93,新百王,2024-06-19,6210
00936,台新永續高息中小,82,6,76,新百王,2024-06-19,6210
00881,國泰台灣5G+,75,12,63,新百王,2024-06-19,6210
00885,富邦越南,62,0,62,新百王,2024-06-19,6210
3188,鑫龍騰,54,2,52,新百王,2024-06-19,6210
2312,金寶,85,45,40,新百王,2024-06-19,6210
2353,宏��,58,19,39,新百王,2024-06-19,6210
3673,TPK-KY,63,25,38,新百王,2024-06-19,6210
3287,廣寰科,43,6,37,新百王,2024-06-19,6210
00686R,群益臺灣加權反1,36,0,36,新百王,2024-06-19,6210
1785,光洋科,222,186,36,新百王,2024-06-19,6210
1303,南亞,34,1,33,新百王,2024-06-19,6210
5521,工信,52,20,32,新百王,2024-06-19,6210
6695,芯鼎,50,18,32,新百王,2024-06-19,6210
2845,遠東銀,32,0,32,新百王,2024-06-19,6210
00946,群益科技高息成長,41,10,31,新百王,2024-06-19,6210
2615,萬海,134,103,31,新百王,2024-06-19,6210
2115,六暉-KY,28,0,28,新百王,2024-06-19,6210
8028,昇陽半導體,48,21,27,新百王,2024-06-19,6210
00927,群益半導體收益,26,1,25,新百王,2024-06-19,6210
8926,台汽電,24,0,24,新百王,2024-06-19,6210
00687B,國泰20年美債,24,0,24,新百王,2024-06-19,6210
9945,潤泰新,34,11,23,新百王,2024-06-19,6210
2867,三商壽,30,7,23,新百王,2024-06-19,6210
1513,中興電,33,11,22,新百王,2024-06-19,6210
3055,蔚華科,32,11,21,新百王,2024-06-19,6210
4726,永昕,23,2,21,新百王,2024-06-19,6210
2303,聯電,26,5,21,新百王,2024-06-19,6210
1609,大亞,36,17,19,新百王,2024-06-19,6210
8096,擎亞,65,46,19,新百王,2024-06-19,6210
00720B,元大投資級公司債,20,1,19,新百王,2024-06-19,6210
9933,中鼎,19,1,18,新百王,2024-06-19,6210
2641,正德,20,2,18,新百王,2024-06-19,6210
2367,燿華,24,8,16,新百王,2024-06-19,6210
2607,榮運,30,15,15,新百王,2024-06-19,6210
3013,晟銘電,29,14,15,新百王,2024-06-19,6210
6547,高端疫苗,23,8,15,新百王,2024-06-19,6210
00664R,國泰臺灣加權反1,14,0,14,新百王,2024-06-19,6210
1591,駿吉-KY,17,3,14,新百王,2024-06-19,6210
3356,奇偶,18,4,14,新百王,2024-06-19,6210
4306,炎洲,20,6,14,新百王,2024-06-19,6210
5243,乙盛-KY,13,0,13,新百王,2024-06-19,6210
1802,台玻,13,0,13,新百王,2024-06-19,6210
00665L,富邦�琤肭磪囓�2,575,30,545,新百王,2024-06-20,6210
2883B,凱基金乙特,346,0,346,新百王,2024-06-20,6210
2892,第一金,341,2,339,新百王,2024-06-20,6210
00679B,元大美債20年,174,20,154,新百王,2024-06-20,6210
2888,新光金,125,16,109,新百王,2024-06-20,6210
00936,台新永續高息中小,88,0,88,新百王,2024-06-20,6210
2801,彰銀,128,48,80,新百王,2024-06-20,6210
2618,長榮航,125,62,63,新百王,2024-06-20,6210
3048,益登,125,64,61,新百王,2024-06-20,6210
00929,復華台灣科技優息,127,67,60,新百王,2024-06-20,6210
6116,彩晶,70,15,55,新百王,2024-06-20,6210
3047,訊舟,214,161,53,新百王,2024-06-20,6210
00940,元大台灣價值高息,60,8,52,新百王,2024-06-20,6210
00946,群益科技高息成長,50,0,50,新百王,2024-06-20,6210
6269,台郡,56,6,50,新百王,2024-06-20,6210
00881,國泰台灣5G+,44,5,39,新百王,2024-06-20,6210
4967,十銓,50,14,36,新百王,2024-06-20,6210
6227,茂綸,37,3,34,新百王,2024-06-20,6210
8096,擎亞,36,3,33,新百王,2024-06-20,6210
8358,金居,37,6,31,新百王,2024-06-20,6210
3188,鑫龍騰,31,1,30,新百王,2024-06-20,6210
2353,宏��,58,29,29,新百王,2024-06-20,6210
1101,台泥,36,7,29,新百王,2024-06-20,6210
9904,寶成,28,0,28,新百王,2024-06-20,6210
00915,凱基優選高股息30,41,13,28,新百王,2024-06-20,6210
2401,凌陽,31,4,27,新百王,2024-06-20,6210
2312,金寶,40,13,27,新百王,2024-06-20,6210
00650L,復華香港正2,25,0,25,新百王,2024-06-20,6210
00632R,元大台灣50反1,416,392,24,新百王,2024-06-20,6210
2812,台中銀,34,10,24,新百王,2024-06-20,6210
1605,華新,23,0,23,新百王,2024-06-20,6210
00927,群益半導體收益,24,1,23,新百王,2024-06-20,6210
00908,富邦入息REITs+,23,0,23,新百王,2024-06-20,6210
5519,隆大,22,0,22,新百王,2024-06-20,6210
6140,訊達,26,5,21,新百王,2024-06-20,6210
1612,宏泰,20,0,20,新百王,2024-06-20,6210
8028,昇陽半導體,36,17,19,新百王,2024-06-20,6210
00941,中信上游半導體,26,7,19,新百王,2024-06-20,6210
6219,富旺,22,3,19,新百王,2024-06-20,6210
6776,展�眥篕�,19,0,19,新百王,2024-06-20,6210
00948B,中信優息投資級債,18,0,18,新百王,2024-06-20,6210
1720,生達,18,0,18,新百王,2024-06-20,6210
5371,中光電,19,2,17,新百王,2024-06-20,6210
00857B,永豐20年美公債,16,0,16,新百王,2024-06-20,6210
1514,亞力,112,96,16,新百王,2024-06-20,6210
00631L,元大台灣50正2,16,0,16,新百王,2024-06-20,6210
00933B,國泰10Y+金融債,15,0,15,新百王,2024-06-20,6210
6182,合晶,15,0,15,新百王,2024-06-20,6210
6194,育富,15,0,15,新百王,2024-06-20,6210
00830,國泰費城半導體,15,0,15,新百王,2024-06-20,6210
00673R,期元大S＆P原油反1,499,0,499,新百王,2024-06-21,6210
00948B,中信優息投資級債,352,20,332,新百王,2024-06-21,6210
00946,群益科技高息成長,210,1,209,新百王,2024-06-21,6210
00632R,元大台灣50反1,230,82,148,新百王,2024-06-21,6210
2317,鴻海,203,62,141,新百王,2024-06-21,6210
00929,復華台灣科技優息,135,10,125,新百王,2024-06-21,6210
1301,台塑,115,0,115,新百王,2024-06-21,6210
00688L,國泰20年美債正2,124,10,114,新百王,2024-06-21,6210
3481,群創,230,136,94,新百王,2024-06-21,6210
00706L,期元大S＆P日圓正2,90,0,90,新百王,2024-06-21,6210
6116,彩晶,158,70,88,新百王,2024-06-21,6210
00637L,元大滬深300正2,117,32,85,新百王,2024-06-21,6210
00937B,群益ESG投等債20,61,1,60,新百王,2024-06-21,6210
2408,南亞科,85,30,55,新百王,2024-06-21,6210
00936,台新永續高息中小,64,10,54,新百王,2024-06-21,6210
2801,彰銀,50,4,46,新百王,2024-06-21,6210
00864B,中信美國公債0-1,40,0,40,新百王,2024-06-21,6210
00881,國泰台灣5G+,39,0,39,新百王,2024-06-21,6210
00679B,元大美債20年,39,0,39,新百王,2024-06-21,6210
3062,建漢,118,82,36,新百王,2024-06-21,6210
00885,富邦越南,34,0,34,新百王,2024-06-21,6210
2329,華泰,53,21,32,新百王,2024-06-21,6210
2312,金寶,56,25,31,新百王,2024-06-21,6210
2897,王道銀行,41,10,31,新百王,2024-06-21,6210
2340,台亞,37,6,31,新百王,2024-06-21,6210
2609,陽明,102,71,31,新百王,2024-06-21,6210
2316,楠梓電,95,66,29,新百王,2024-06-21,6210
00753L,中信中國50正2,26,0,26,新百王,2024-06-21,6210
00907,永豐優息存股,25,0,25,新百王,2024-06-21,6210
0056,元大高股息,22,0,22,新百王,2024-06-21,6210
4707,磐亞,44,22,22,新百王,2024-06-21,6210
00933B,國泰10Y+金融債,20,0,20,新百王,2024-06-21,6210
1815,富喬,26,6,20,新百王,2024-06-21,6210
2867,三商壽,20,0,20,新百王,2024-06-21,6210
3706,神達,21,1,20,新百王,2024-06-21,6210
2498,宏達電,24,5,19,新百王,2024-06-21,6210
3059,華晶科,20,1,19,新百王,2024-06-21,6210
1303,南亞,21,2,19,新百王,2024-06-21,6210
3374,精材,19,1,18,新百王,2024-06-21,6210
6176,瑞儀,19,1,18,新百王,2024-06-21,6210
2420,新巨,24,6,18,新百王,2024-06-21,6210
00650L,復華香港正2,17,0,17,新百王,2024-06-21,6210
2542,興富發,38,21,17,新百王,2024-06-21,6210
2603,長榮,67,51,16,新百王,2024-06-21,6210
6185,幃翔,17,1,16,新百王,2024-06-21,6210
2442,新美齊,16,0,16,新百王,2024-06-21,6210
6901,鑽石投資,16,0,16,新百王,2024-06-21,6210
1416,廣豐,15,0,15,新百王,2024-06-21,6210
1786,科妍,26,12,14,新百王,2024-06-21,6210
3588,通嘉,22,8,14,新百王,2024-06-21,6210
3481,群創,1208,340,868,新百王,2024-06-24,6210
2542,興富發,520,50,470,新百王,2024-06-24,6210
2495,普安,253,19,234,新百王,2024-06-24,6210
2607,榮運,244,54,190,新百王,2024-06-24,6210
00929,復華台灣科技優息,210,28,182,新百王,2024-06-24,6210
2312,金寶,204,26,178,新百王,2024-06-24,6210
2615,萬海,272,111,161,新百王,2024-06-24,6210
3490,單井,203,44,159,新百王,2024-06-24,6210
00936,台新永續高息中小,157,0,157,新百王,2024-06-24,6210
1309,台達化,120,14,106,新百王,2024-06-24,6210
00934,中信成長高股息,105,1,104,新百王,2024-06-24,6210
6213,聯茂,103,1,102,新百王,2024-06-24,6210
00942B,台新美A公司債20+,100,0,100,新百王,2024-06-24,6210
2431,聯昌,61,0,61,新百王,2024-06-24,6210
2344,華邦電,60,4,56,新百王,2024-06-24,6210
00937B,群益ESG投等債20,74,19,55,新百王,2024-06-24,6210
2303,聯電,53,1,52,新百王,2024-06-24,6210
00680L,元大美債20正2,54,5,49,新百王,2024-06-24,6210
2317,鴻海,95,52,43,新百王,2024-06-24,6210
00946,群益科技高息成長,43,0,43,新百王,2024-06-24,6210
2369,菱生,64,21,43,新百王,2024-06-24,6210
1785,光洋科,136,96,40,新百王,2024-06-24,6210
2465,麗臺,36,0,36,新百王,2024-06-24,6210
9105,泰金寶-DR,38,2,36,新百王,2024-06-24,6210
2356,英業達,44,10,34,新百王,2024-06-24,6210
1101,台泥,34,1,33,新百王,2024-06-24,6210
2330,台積電,58,26,32,新百王,2024-06-24,6210
2618,長榮航,49,17,32,新百王,2024-06-24,6210
6284,佳邦,40,8,32,新百王,2024-06-24,6210
00933B,國泰10Y+金融債,31,0,31,新百王,2024-06-24,6210
6116,彩晶,34,4,30,新百王,2024-06-24,6210
2897,王道銀行,70,40,30,新百王,2024-06-24,6210
2401,凌陽,52,25,27,新百王,2024-06-24,6210
00753L,中信中國50正2,26,0,26,新百王,2024-06-24,6210
2489,瑞軒,28,3,25,新百王,2024-06-24,6210
00687B,國泰20年美債,24,1,23,新百王,2024-06-24,6210
2354,鴻準,28,5,23,新百王,2024-06-24,6210
2409,友達,90,67,23,新百王,2024-06-24,6210
2002,中鋼,32,10,22,新百王,2024-06-24,6210
2883,凱基金,24,2,22,新百王,2024-06-24,6210
3062,建漢,112,90,22,新百王,2024-06-24,6210
3036,文曄,29,8,21,新百王,2024-06-24,6210
3567,逸昌,20,0,20,新百王,2024-06-24,6210
1217,愛之味,30,11,19,新百王,2024-06-24,6210
2888,新光金,22,4,18,新百王,2024-06-24,6210
00935,野村臺灣新科技50,18,0,18,新百王,2024-06-24,6210
4433,興采,18,0,18,新百王,2024-06-24,6210
2420,新巨,18,0,18,新百王,2024-06-24,6210
00927,群益半導體收益,23,5,18,新百王,2024-06-24,6210
1314,中石化,52,35,17,新百王,2024-06-24,6210
3481,群創,443,98,345,新百王,2024-06-25,6210
2312,金寶,252,15,237,新百王,2024-06-25,6210
00929,復華台灣科技優息,132,15,117,新百王,2024-06-25,6210
00934,中信成長高股息,80,0,80,新百王,2024-06-25,6210
00937B,群益ESG投等債20,70,0,70,新百王,2024-06-25,6210
2002,中鋼,81,15,66,新百王,2024-06-25,6210
00679B,元大美債20年,76,12,64,新百王,2024-06-25,6210
2883,凱基金,99,40,59,新百王,2024-06-25,6210
2431,聯昌,49,0,49,新百王,2024-06-25,6210
2352,佳世達,60,11,49,新百王,2024-06-25,6210
3047,訊舟,108,59,49,新百王,2024-06-25,6210
2816,旺旺保,43,0,43,新百王,2024-06-25,6210
2812,台中銀,64,24,40,新百王,2024-06-25,6210
4909,新復興,41,3,38,新百王,2024-06-25,6210
00918,大華優利高填息30,33,0,33,新百王,2024-06-25,6210
9105,泰金寶-DR,33,1,32,新百王,2024-06-25,6210
00936,台新永續高息中小,56,25,31,新百王,2024-06-25,6210
8110,華東,39,8,31,新百王,2024-06-25,6210
00752,中信中國50,30,0,30,新百王,2024-06-25,6210
1305,華夏,30,0,30,新百王,2024-06-25,6210
6598,ABC-KY,30,0,30,新百王,2024-06-25,6210
2409,友達,92,63,29,新百王,2024-06-25,6210
00946,群益科技高息成長,29,0,29,新百王,2024-06-25,6210
1303,南亞,28,1,27,新百王,2024-06-25,6210
00947,台新臺灣IC設計,27,0,27,新百王,2024-06-25,6210
6197,佳必琪,39,13,26,新百王,2024-06-25,6210
1301,台塑,22,1,21,新百王,2024-06-25,6210
2408,南亞科,24,3,21,新百王,2024-06-25,6210
6282,康舒,29,8,21,新百王,2024-06-25,6210
3374,精材,24,4,20,新百王,2024-06-25,6210
6182,合晶,20,0,20,新百王,2024-06-25,6210
1815,富喬,33,14,19,新百王,2024-06-25,6210
2605,新興,20,1,19,新百王,2024-06-25,6210
1307,三芳,18,0,18,新百王,2024-06-25,6210
2367,燿華,30,12,18,新百王,2024-06-25,6210
2542,興富發,20,3,17,新百王,2024-06-25,6210
00637L,元大滬深300正2,20,3,17,新百王,2024-06-25,6210
3231,緯創,21,5,16,新百王,2024-06-25,6210
3059,華晶科,17,1,16,新百王,2024-06-25,6210
3312,弘憶股,25,9,16,新百王,2024-06-25,6210
2464,盟立,43,28,15,新百王,2024-06-25,6210
3006,晶豪科,64,49,15,新百王,2024-06-25,6210
00940,元大台灣價值高息,71,57,14,新百王,2024-06-25,6210
00905,FT臺灣Smart,13,0,13,新百王,2024-06-25,6210
2344,華邦電,14,1,13,新百王,2024-06-25,6210
1229,聯華,15,3,12,新百王,2024-06-25,6210
00933B,國泰10Y+金融債,12,0,12,新百王,2024-06-25,6210
00935,野村臺灣新科技50,11,0,11,新百王,2024-06-25,6210
2489,瑞軒,11,0,11,新百王,2024-06-25,6210
6127,九豪,12,1,11,新百王,2024-06-25,6210
2887,台新金,168,9,159,新百王,2024-06-26,6210
9136,巨騰-DR,136,0,136,新百王,2024-06-26,6210
2409,友達,130,9,121,新百王,2024-06-26,6210
00942B,台新美A公司債20+,220,100,120,新百王,2024-06-26,6210
2883B,凱基金乙特,102,0,102,新百王,2024-06-26,6210
2812,台中銀,101,0,101,新百王,2024-06-26,6210
00945B,凱基美國非投等債,100,0,100,新百王,2024-06-26,6210
2317,鴻海,140,56,84,新百王,2024-06-26,6210
3481,群創,256,176,80,新百王,2024-06-26,6210
00706L,期元大S＆P日圓正2,78,4,74,新百王,2024-06-26,6210
2516,新建,62,0,62,新百王,2024-06-26,6210
2312,金寶,122,62,60,新百王,2024-06-26,6210
2603,長榮,58,2,56,新百王,2024-06-26,6210
912000,晨訊科-DR,55,0,55,新百王,2024-06-26,6210
2883,凱基金,93,40,53,新百王,2024-06-26,6210
2495,普安,58,7,51,新百王,2024-06-26,6210
6901,鑽石投資,48,0,48,新百王,2024-06-26,6210
8027,鈦昇,73,32,41,新百王,2024-06-26,6210
00632R,元大台灣50反1,52,15,37,新百王,2024-06-26,6210
6219,富旺,37,1,36,新百王,2024-06-26,6210
00637L,元大滬深300正2,53,20,33,新百王,2024-06-26,6210
00937B,群益ESG投等債20,32,0,32,新百王,2024-06-26,6210
00712,復華富時不動產,32,0,32,新百王,2024-06-26,6210
3047,訊舟,134,103,31,新百王,2024-06-26,6210
00753L,中信中國50正2,30,0,30,新百王,2024-06-26,6210
00713,元大台灣高息低波,30,0,30,新百王,2024-06-26,6210
6257,矽格,30,3,27,新百王,2024-06-26,6210
5905,南仁湖,38,14,24,新百王,2024-06-26,6210
2354,鴻準,30,6,24,新百王,2024-06-26,6210
00927,群益半導體收益,24,1,23,新百王,2024-06-26,6210
2002,中鋼,24,2,22,新百王,2024-06-26,6210
5009,榮剛,22,0,22,新百王,2024-06-26,6210
3260,威剛,25,4,21,新百王,2024-06-26,6210
2641,正德,22,1,21,新百王,2024-06-26,6210
1326,台化,21,0,21,新百王,2024-06-26,6210
2867,三商壽,21,0,21,新百王,2024-06-26,6210
00936,台新永續高息中小,21,1,20,新百王,2024-06-26,6210
2609,陽明,26,6,20,新百王,2024-06-26,6210
2888,新光金,20,0,20,新百王,2024-06-26,6210
1303,南亞,22,2,20,新百王,2024-06-26,6210
00631L,元大台灣50正2,25,6,19,新百王,2024-06-26,6210
2392,正崴,30,11,19,新百王,2024-06-26,6210
9945,潤泰新,27,8,19,新百王,2024-06-26,6210
2301,光寶科,37,19,18,新百王,2024-06-26,6210
2353,宏��,29,12,17,新百王,2024-06-26,6210
2344,華邦電,17,0,17,新百王,2024-06-26,6210
6698,旭暉應材,18,1,17,新百王,2024-06-26,6210
2382,廣達,55,39,16,新百王,2024-06-26,6210
3188,鑫龍騰,16,0,16,新百王,2024-06-26,6210
8383,千附,17,2,15,新百王,2024-06-26,6210
00673R,期元大S＆P原油反1,787,0,787,新百王,2024-06-27,6210
00936,台新永續高息中小,375,1,374,新百王,2024-06-27,6210
00680L,元大美債20正2,248,5,243,新百王,2024-06-27,6210
1314,中石化,210,0,210,新百王,2024-06-27,6210
00948B,中信優息投資級債,202,40,162,新百王,2024-06-27,6210
00665L,富邦�琤肭磪囓�2,205,80,125,新百王,2024-06-27,6210
1319,東陽,106,1,105,新百王,2024-06-27,6210
3234,光環,95,1,94,新百王,2024-06-27,6210
00942B,台新美A公司債20+,394,300,94,新百王,2024-06-27,6210
00929,復華台灣科技優息,70,2,68,新百王,2024-06-27,6210
00650L,復華香港正2,80,15,65,新百王,2024-06-27,6210
6116,彩晶,70,5,65,新百王,2024-06-27,6210
1529,樂事綠能,65,1,64,新百王,2024-06-27,6210
2883,凱基金,60,1,59,新百王,2024-06-27,6210
3296,勝德,56,0,56,新百王,2024-06-27,6210
00688L,國泰20年美債正2,55,0,55,新百王,2024-06-27,6210
00937B,群益ESG投等債20,105,50,55,新百王,2024-06-27,6210
2409,友達,61,6,55,新百王,2024-06-27,6210
00939,統一台灣高息動能,54,0,54,新百王,2024-06-27,6210
8096,擎亞,67,14,53,新百王,2024-06-27,6210
00945B,凱基美國非投等債,50,0,50,新百王,2024-06-27,6210
00679B,元大美債20年,49,0,49,新百王,2024-06-27,6210
2312,金寶,47,1,46,新百王,2024-06-27,6210
00753L,中信中國50正2,43,0,43,新百王,2024-06-27,6210
2607,榮運,38,0,38,新百王,2024-06-27,6210
4977,眾達-KY,43,6,37,新百王,2024-06-27,6210
00720B,元大投資級公司債,36,0,36,新百王,2024-06-27,6210
2498,宏達電,34,1,33,新百王,2024-06-27,6210
00712,復華富時不動產,37,10,27,新百王,2024-06-27,6210
912000,晨訊科-DR,74,48,26,新百王,2024-06-27,6210
2885,元大金,58,33,25,新百王,2024-06-27,6210
2867,三商壽,28,3,25,新百王,2024-06-27,6210
9904,寶成,25,0,25,新百王,2024-06-27,6210
3027,盛達,32,9,23,新百王,2024-06-27,6210
1524,耿鼎,23,0,23,新百王,2024-06-27,6210
1605,華新,24,1,23,新百王,2024-06-27,6210
5371,中光電,23,0,23,新百王,2024-06-27,6210
2888,新光金,32,10,22,新百王,2024-06-27,6210
3490,單井,32,11,21,新百王,2024-06-27,6210
00934,中信成長高股息,21,0,21,新百王,2024-06-27,6210
00632R,元大台灣50反1,51,30,21,新百王,2024-06-27,6210
2897,王道銀行,50,30,20,新百王,2024-06-27,6210
00882,中信中國高股息,30,10,20,新百王,2024-06-27,6210
1457,宜進,20,0,20,新百王,2024-06-27,6210
00947,台新臺灣IC設計,20,0,20,新百王,2024-06-27,6210
3483,力致,45,26,19,新百王,2024-06-27,6210
6285,啟��,21,2,19,新百王,2024-06-27,6210
4967,十銓,22,3,19,新百王,2024-06-27,6210
00933B,國泰10Y+金融債,19,0,19,新百王,2024-06-27,6210
8011,台通,21,2,19,新百王,2024-06-27,6210
00673R,期元大S＆P原油反1,433,0,433,新百王,2024-06-28,6210
3050,鈺德,216,6,210,新百王,2024-06-28,6210
2542,興富發,177,6,171,新百王,2024-06-28,6210
00936,台新永續高息中小,165,0,165,新百王,2024-06-28,6210
5243,乙盛-KY,162,64,98,新百王,2024-06-28,6210
00687B,國泰20年美債,113,22,91,新百王,2024-06-28,6210
2887,台新金,89,10,79,新百王,2024-06-28,6210
2610,華航,171,101,70,新百王,2024-06-28,6210
6244,茂迪,146,82,64,新百王,2024-06-28,6210
5443,均豪,73,12,61,新百王,2024-06-28,6210
4533,協易機,109,54,55,新百王,2024-06-28,6210
00945B,凱基美國非投等債,50,0,50,新百王,2024-06-28,6210
2812,台中銀,159,113,46,新百王,2024-06-28,6210
2515,中工,42,0,42,新百王,2024-06-28,6210
2820,華票,38,0,38,新百王,2024-06-28,6210
2367,燿華,56,20,36,新百王,2024-06-28,6210
3481,群創,96,61,35,新百王,2024-06-28,6210
1513,中興電,39,7,32,新百王,2024-06-28,6210
2641,正德,31,0,31,新百王,2024-06-28,6210
8084,巨虹,30,0,30,新百王,2024-06-28,6210
4167,松瑞藥,67,38,29,新百王,2024-06-28,6210
2323,中環,42,13,29,新百王,2024-06-28,6210
1795,美時,35,7,28,新百王,2024-06-28,6210
3338,泰碩,73,46,27,新百王,2024-06-28,6210
3520,華盈,41,15,26,新百王,2024-06-28,6210
6219,富旺,40,15,25,新百王,2024-06-28,6210
1611,中電,65,40,25,新百王,2024-06-28,6210
6901,鑽石投資,46,22,24,新百王,2024-06-28,6210
2104,國際中橡,24,1,23,新百王,2024-06-28,6210
1609,大亞,33,11,22,新百王,2024-06-28,6210
00632R,元大台灣50反1,22,0,22,新百王,2024-06-28,6210
3057,喬鼎,21,0,21,新百王,2024-06-28,6210
6182,合晶,42,21,21,新百王,2024-06-28,6210
00939,統一台灣高息動能,35,15,20,新百王,2024-06-28,6210
00795B,中信美國公債20年,20,0,20,新百王,2024-06-28,6210
3605,宏致,25,5,20,新百王,2024-06-28,6210
6841,長佳智能,27,8,19,新百王,2024-06-28,6210
3149,正達,22,4,18,新百王,2024-06-28,6210
3048,益登,38,21,17,新百王,2024-06-28,6210
8027,鈦昇,33,16,17,新百王,2024-06-28,6210
2303,聯電,19,3,16,新百王,2024-06-28,6210
2406,國碩,103,87,16,新百王,2024-06-28,6210
1314,中石化,16,0,16,新百王,2024-06-28,6210
4726,永昕,23,8,15,新百王,2024-06-28,6210
2405,輔信,18,3,15,新百王,2024-06-28,6210
4111,濟生,15,0,15,新百王,2024-06-28,6210
1702,南僑,15,0,15,新百王,2024-06-28,6210
1734,杏輝,20,5,15,新百王,2024-06-28,6210
6215,和椿,21,6,15,新百王,2024-06-28,6210
4153,鈺緯,16,2,14,新百王,2024-06-28,6210
1314,中石化,470,35,435,新百王,2024-07-01,6210
00936,台新永續高息中小,319,11,308,新百王,2024-07-01,6210
2312,金寶,273,1,272,新百王,2024-07-01,6210
00687B,國泰20年美債,180,0,180,新百王,2024-07-01,6210
00937B,群益ESG投等債20,170,0,170,新百王,2024-07-01,6210
00688L,國泰20年美債正2,165,0,165,新百王,2024-07-01,6210
00942B,台新美A公司債20+,127,0,127,新百王,2024-07-01,6210
00948B,中信優息投資級債,278,200,78,新百王,2024-07-01,6210
00637L,元大滬深300正2,119,50,69,新百王,2024-07-01,6210
6127,九豪,68,1,67,新百王,2024-07-01,6210
2344,華邦電,91,30,61,新百王,2024-07-01,6210
00632R,元大台灣50反1,126,68,58,新百王,2024-07-01,6210
00933B,國泰10Y+金融債,45,0,45,新百王,2024-07-01,6210
2603,長榮,53,8,45,新百王,2024-07-01,6210
4967,十銓,51,7,44,新百王,2024-07-01,6210
2352,佳世達,196,152,44,新百王,2024-07-01,6210
1806,冠軍,56,14,42,新百王,2024-07-01,6210
4726,永昕,62,22,40,新百王,2024-07-01,6210
00931B,統一美債20年,40,0,40,新百王,2024-07-01,6210
9105,泰金寶-DR,41,1,40,新百王,2024-07-01,6210
2354,鴻準,52,14,38,新百王,2024-07-01,6210
6189,豐藝,57,19,38,新百王,2024-07-01,6210
2365,昆盈,169,131,38,新百王,2024-07-01,6210
2406,國碩,66,30,36,新百王,2024-07-01,6210
00753L,中信中國50正2,35,0,35,新百王,2024-07-01,6210
2867,三商壽,44,10,34,新百王,2024-07-01,6210
3296,勝德,37,3,34,新百王,2024-07-01,6210
6176,瑞儀,34,1,33,新百王,2024-07-01,6210
0056,元大高股息,32,0,32,新百王,2024-07-01,6210
4720,德淵,194,162,32,新百王,2024-07-01,6210
2615,萬海,185,155,30,新百王,2024-07-01,6210
2482,連宇,35,8,27,新百王,2024-07-01,6210
2313,華通,105,79,26,新百王,2024-07-01,6210
6227,茂綸,24,0,24,新百王,2024-07-01,6210
00680L,元大美債20正2,40,17,23,新百王,2024-07-01,6210
00720B,元大投資級公司債,23,1,22,新百王,2024-07-01,6210
4563,百德,23,2,21,新百王,2024-07-01,6210
2002,中鋼,24,3,21,新百王,2024-07-01,6210
6188,廣明,68,48,20,新百王,2024-07-01,6210
1789,神隆,20,0,20,新百王,2024-07-01,6210
2537,聯上發,25,5,20,新百王,2024-07-01,6210
2706,第一店,20,0,20,新百王,2024-07-01,6210
4934,太極,20,0,20,新百王,2024-07-01,6210
2485,兆赫,20,0,20,新百王,2024-07-01,6210
4303,信立,20,0,20,新百王,2024-07-01,6210
6282,康舒,19,0,19,新百王,2024-07-01,6210
2359,所羅門,88,71,17,新百王,2024-07-01,6210
2498,宏達電,17,0,17,新百王,2024-07-01,6210
2340,台亞,34,17,17,新百王,2024-07-01,6210
8163,達方,20,4,16,新百王,2024-07-01,6210
9105,泰金寶-DR,361,37,324,新百王,2024-07-02,6210
2317,鴻海,225,46,179,新百王,2024-07-02,6210
00679B,元大美債20年,160,20,140,新百王,2024-07-02,6210
2303,聯電,213,86,127,新百王,2024-07-02,6210
00942B,台新美A公司債20+,100,0,100,新百王,2024-07-02,6210
3490,單井,103,6,97,新百王,2024-07-02,6210
2812,台中銀,80,0,80,新百王,2024-07-02,6210
2885,元大金,78,0,78,新百王,2024-07-02,6210
8163,達方,74,3,71,新百王,2024-07-02,6210
2618,長榮航,179,114,65,新百王,2024-07-02,6210
3188,鑫龍騰,61,0,61,新百王,2024-07-02,6210
00936,台新永續高息中小,62,5,57,新百王,2024-07-02,6210
6901,鑽石投資,59,4,55,新百王,2024-07-02,6210
5443,均豪,154,100,54,新百王,2024-07-02,6210
6290,良維,59,5,54,新百王,2024-07-02,6210
2412,中華電,53,0,53,新百王,2024-07-02,6210
3312,弘憶股,120,75,45,新百王,2024-07-02,6210
00687B,國泰20年美債,44,0,44,新百王,2024-07-02,6210
4303,信立,42,0,42,新百王,2024-07-02,6210
1309,台達化,45,5,40,新百王,2024-07-02,6210
4167,松瑞藥,64,32,32,新百王,2024-07-02,6210
2464,盟立,47,15,32,新百王,2024-07-02,6210
2312,金寶,89,58,31,新百王,2024-07-02,6210
00673R,期元大S＆P原油反1,31,0,31,新百王,2024-07-02,6210
2498,宏達電,31,0,31,新百王,2024-07-02,6210
6156,松上,30,0,30,新百王,2024-07-02,6210
4720,德淵,30,0,30,新百王,2024-07-02,6210
912000,晨訊科-DR,35,5,30,新百王,2024-07-02,6210
00891,中信關鍵半導體,29,0,29,新百王,2024-07-02,6210
1314,中石化,27,0,27,新百王,2024-07-02,6210
1305,華夏,27,0,27,新百王,2024-07-02,6210
3520,華盈,100,73,27,新百王,2024-07-02,6210
00946,群益科技高息成長,26,0,26,新百王,2024-07-02,6210
2313,華通,55,30,25,新百王,2024-07-02,6210
00929,復華台灣科技優息,134,110,24,新百王,2024-07-02,6210
00918,大華優利高填息30,23,0,23,新百王,2024-07-02,6210
00720B,元大投資級公司債,23,0,23,新百王,2024-07-02,6210
2349,錸德,83,61,22,新百王,2024-07-02,6210
00712,復華富時不動產,27,5,22,新百王,2024-07-02,6210
2406,國碩,110,89,21,新百王,2024-07-02,6210
9902,台火,20,0,20,新百王,2024-07-02,6210
3583,辛耘,21,1,20,新百王,2024-07-02,6210
00940,元大台灣價值高息,22,2,20,新百王,2024-07-02,6210
00931B,統一美債20年,23,5,18,新百王,2024-07-02,6210
4906,正文,40,22,18,新百王,2024-07-02,6210
2353,宏��,47,30,17,新百王,2024-07-02,6210
3025,星通,23,6,17,新百王,2024-07-02,6210
2356,英業達,16,1,15,新百王,2024-07-02,6210
2002,中鋼,15,0,15,新百王,2024-07-02,6210
6139,亞翔,47,32,15,新百王,2024-07-02,6210
00680L,元大美債20正2,251,0,251,新百王,2024-07-03,6210
00929,復華台灣科技優息,229,32,197,新百王,2024-07-03,6210
3050,鈺德,205,26,179,新百王,2024-07-03,6210
9946,三發地產,178,1,177,新百王,2024-07-03,6210
00934,中信成長高股息,122,10,112,新百王,2024-07-03,6210
9105,泰金寶-DR,215,105,110,新百王,2024-07-03,6210
2887,台新金,272,166,106,新百王,2024-07-03,6210
2323,中環,145,39,106,新百王,2024-07-03,6210
2105,正新,101,1,100,新百王,2024-07-03,6210
3490,單井,148,49,99,新百王,2024-07-03,6210
2603,長榮,182,83,99,新百王,2024-07-03,6210
6244,茂迪,314,223,91,新百王,2024-07-03,6210
2317,鴻海,130,46,84,新百王,2024-07-03,6210
2495,普安,89,10,79,新百王,2024-07-03,6210
2605,新興,84,6,78,新百王,2024-07-03,6210
6213,聯茂,110,43,67,新百王,2024-07-03,6210
00632R,元大台灣50反1,81,15,66,新百王,2024-07-03,6210
2427,三商電,60,0,60,新百王,2024-07-03,6210
2915,潤泰全,60,2,58,新百王,2024-07-03,6210
3105,穩懋,60,9,51,新百王,2024-07-03,6210
6269,台郡,65,15,50,新百王,2024-07-03,6210
4207,環泰,48,0,48,新百王,2024-07-03,6210
2409,友達,54,7,47,新百王,2024-07-03,6210
4167,松瑞藥,46,0,46,新百王,2024-07-03,6210
3055,蔚華科,40,2,38,新百王,2024-07-03,6210
8104,錸寶,58,21,37,新百王,2024-07-03,6210
6290,良維,42,5,37,新百王,2024-07-03,6210
2002,中鋼,47,10,37,新百王,2024-07-03,6210
912000,晨訊科-DR,39,3,36,新百王,2024-07-03,6210
3047,訊舟,214,179,35,新百王,2024-07-03,6210
2637,慧洋-KY,38,3,35,新百王,2024-07-03,6210
3520,華盈,93,62,31,新百王,2024-07-03,6210
2609,陽明,46,16,30,新百王,2024-07-03,6210
00687B,國泰20年美債,28,0,28,新百王,2024-07-03,6210
5484,慧友,26,0,26,新百王,2024-07-03,6210
00688L,國泰20年美債正2,32,6,26,新百王,2024-07-03,6210
8163,達方,30,4,26,新百王,2024-07-03,6210
00637L,元大滬深300正2,46,20,26,新百王,2024-07-03,6210
3034,聯詠,28,3,25,新百王,2024-07-03,6210
00679B,元大美債20年,33,9,24,新百王,2024-07-03,6210
3027,盛達,64,40,24,新百王,2024-07-03,6210
3049,精金,22,0,22,新百王,2024-07-03,6210
2356,英業達,28,7,21,新百王,2024-07-03,6210
00940,元大台灣價值高息,33,13,20,新百王,2024-07-03,6210
3607,谷崧,20,0,20,新百王,2024-07-03,6210
6776,展�眥篕�,20,0,20,新百王,2024-07-03,6210
00946,群益科技高息成長,20,0,20,新百王,2024-07-03,6210
3188,鑫龍騰,21,1,20,新百王,2024-07-03,6210
2332,友訊,32,12,20,新百王,2024-07-03,6210
1785,光洋科,86,67,19,新百王,2024-07-03,6210
00937B,群益ESG投等債20,1105,90,1015,新百王,2024-07-04,6210
00665L,富邦�琤肭磪囓�2,1261,687,574,新百王,2024-07-04,6210
3591,艾笛森,241,1,240,新百王,2024-07-04,6210
9105,泰金寶-DR,232,0,232,新百王,2024-07-04,6210
4720,德淵,211,3,208,新百王,2024-07-04,6210
00680L,元大美債20正2,210,20,190,新百王,2024-07-04,6210
00929,復華台灣科技優息,126,31,95,新百王,2024-07-04,6210
3576,聯合再生,205,114,91,新百王,2024-07-04,6210
1806,冠軍,78,0,78,新百王,2024-07-04,6210
2888,新光金,112,35,77,新百王,2024-07-04,6210
3050,鈺德,82,12,70,新百王,2024-07-04,6210
6244,茂迪,88,18,70,新百王,2024-07-04,6210
6026,福邦證,60,0,60,新百王,2024-07-04,6210
00904,新光臺灣半導體30,55,0,55,新百王,2024-07-04,6210
2618,長榮航,72,18,54,新百王,2024-07-04,6210
00934,中信成長高股息,58,7,51,新百王,2024-07-04,6210
4510,高鋒,50,1,49,新百王,2024-07-04,6210
2027,大成鋼,54,6,48,新百王,2024-07-04,6210
3189,景碩,50,5,45,新百王,2024-07-04,6210
6290,良維,53,13,40,新百王,2024-07-04,6210
2915,潤泰全,48,9,39,新百王,2024-07-04,6210
9103,美德醫療-DR,35,0,35,新百王,2024-07-04,6210
2412,中華電,45,11,34,新百王,2024-07-04,6210
1101,台泥,32,1,31,新百王,2024-07-04,6210
9946,三發地產,30,3,27,新百王,2024-07-04,6210
4915,致伸,28,1,27,新百王,2024-07-04,6210
00795B,中信美國公債20年,26,0,26,新百王,2024-07-04,6210
00949,復華日本龍頭,26,0,26,新百王,2024-07-04,6210
4433,興采,25,0,25,新百王,2024-07-04,6210
8028,昇陽半導體,30,5,25,新百王,2024-07-04,6210
2371,大同,50,25,25,新百王,2024-07-04,6210
2603,長榮,29,5,24,新百王,2024-07-04,6210
2913,農林,27,3,24,新百王,2024-07-04,6210
3041,揚智,24,0,24,新百王,2024-07-04,6210
2883,凱基金,70,46,24,新百王,2024-07-04,6210
3622,洋華,28,5,23,新百王,2024-07-04,6210
2402,毅嘉,47,25,22,新百王,2024-07-04,6210
2885,元大金,21,0,21,新百王,2024-07-04,6210
1307,三芳,20,0,20,新百王,2024-07-04,6210
2606,裕民,21,1,20,新百王,2024-07-04,6210
2836,高雄銀,20,0,20,新百王,2024-07-04,6210
6901,鑽石投資,31,11,20,新百王,2024-07-04,6210
6215,和椿,46,28,18,新百王,2024-07-04,6210
1815,富喬,24,6,18,新百王,2024-07-04,6210
00946,群益科技高息成長,20,2,18,新百王,2024-07-04,6210
4109,加捷生醫,37,19,18,新百王,2024-07-04,6210
2352,佳世達,53,37,16,新百王,2024-07-04,6210
2609,陽明,40,24,16,新百王,2024-07-04,6210
3490,單井,24,8,16,新百王,2024-07-04,6210
6276,安鈦克,16,0,16,新百王,2024-07-04,6210
00937B,群益ESG投等債20,1062,1,1061,新百王,2024-07-05,6210
3050,鈺德,421,11,410,新百王,2024-07-05,6210
00929,復華台灣科技優息,238,10,228,新百王,2024-07-05,6210
00637L,元大滬深300正2,208,5,203,新百王,2024-07-05,6210
2317,鴻海,293,115,178,新百王,2024-07-05,6210
2392,正崴,104,1,103,新百王,2024-07-05,6210
3576,聯合再生,199,103,96,新百王,2024-07-05,6210
1806,冠軍,102,10,92,新百王,2024-07-05,6210
2897,王道銀行,239,151,88,新百王,2024-07-05,6210
9105,泰金寶-DR,119,32,87,新百王,2024-07-05,6210
2610,華航,74,1,73,新百王,2024-07-05,6210
6116,彩晶,65,1,64,新百王,2024-07-05,6210
2489,瑞軒,71,10,61,新百王,2024-07-05,6210
2301,光寶科,63,9,54,新百王,2024-07-05,6210
1314,中石化,200,152,48,新百王,2024-07-05,6210
00679B,元大美債20年,48,3,45,新百王,2024-07-05,6210
2323,中環,222,178,44,新百王,2024-07-05,6210
2543,皇昌,107,63,44,新百王,2024-07-05,6210
2603,長榮,51,10,41,新百王,2024-07-05,6210
3062,建漢,41,5,36,新百王,2024-07-05,6210
2618,長榮航,41,5,36,新百王,2024-07-05,6210
2887,台新金,72,37,35,新百王,2024-07-05,6210
3537,堡達,68,34,34,新百王,2024-07-05,6210
2303,聯電,40,8,32,新百王,2024-07-05,6210
00712,復華富時不動產,67,35,32,新百王,2024-07-05,6210
6207,雷科,78,48,30,新百王,2024-07-05,6210
00655L,國泰中國A50正2,30,0,30,新百王,2024-07-05,6210
2371,大同,47,18,29,新百王,2024-07-05,6210
1460,宏遠,28,0,28,新百王,2024-07-05,6210
6129,普誠,26,0,26,新百王,2024-07-05,6210
0056,元大高股息,36,10,26,新百王,2024-07-05,6210
00664R,國泰臺灣加權反1,25,0,25,新百王,2024-07-05,6210
5302,太欣,25,1,24,新百王,2024-07-05,6210
2845,遠東銀,21,0,21,新百王,2024-07-05,6210
3041,揚智,21,0,21,新百王,2024-07-05,6210
00650L,復華香港正2,35,14,21,新百王,2024-07-05,6210
4538,大詠城,21,0,21,新百王,2024-07-05,6210
6244,茂迪,29,8,21,新百王,2024-07-05,6210
4934,太極,21,0,21,新百王,2024-07-05,6210
3511,矽瑪,20,0,20,新百王,2024-07-05,6210
2360,致茂,20,0,20,新百王,2024-07-05,6210
1609,大亞,50,30,20,新百王,2024-07-05,6210
2851,中再保,20,0,20,新百王,2024-07-05,6210
3268,海德威,19,0,19,新百王,2024-07-05,6210
3037,欣興,19,1,18,新百王,2024-07-05,6210
4127,天良,18,0,18,新百王,2024-07-05,6210
6219,富旺,18,0,18,新百王,2024-07-05,6210
00942B,台新美A公司債20+,17,0,17,新百王,2024-07-05,6210
3338,泰碩,34,17,17,新百王,2024-07-05,6210
3520,華盈,32,15,17,新百王,2024-07-05,6210
2408,南亞科,153,1,152,新百王,2024-07-08,6210
1337,再生-KY,199,49,150,新百王,2024-07-08,6210
6117,迎廣,112,2,110,新百王,2024-07-08,6210
2484,希華,110,0,110,新百王,2024-07-08,6210
00934,中信成長高股息,106,8,98,新百王,2024-07-08,6210
6290,良維,85,15,70,新百王,2024-07-08,6210
00937B,群益ESG投等債20,74,10,64,新百王,2024-07-08,6210
1717,長興,65,2,63,新百王,2024-07-08,6210
3045,台灣大,63,1,62,新百王,2024-07-08,6210
8105,凌巨,60,0,60,新百王,2024-07-08,6210
1806,冠軍,67,7,60,新百王,2024-07-08,6210
2836,高雄銀,60,0,60,新百王,2024-07-08,6210
1312,國喬,60,0,60,新百王,2024-07-08,6210
2615,萬海,301,244,57,新百王,2024-07-08,6210
00632R,元大台灣50反1,61,5,56,新百王,2024-07-08,6210
4909,新復興,82,31,51,新百王,2024-07-08,6210
6153,嘉聯益,87,40,47,新百王,2024-07-08,6210
2427,三商電,71,25,46,新百王,2024-07-08,6210
2609,陽明,66,20,46,新百王,2024-07-08,6210
00929,復華台灣科技優息,131,86,45,新百王,2024-07-08,6210
1342,八貫,44,0,44,新百王,2024-07-08,6210
00679B,元大美債20年,43,0,43,新百王,2024-07-08,6210
4720,德淵,42,0,42,新百王,2024-07-08,6210
8111,立��,48,6,42,新百王,2024-07-08,6210
3540,曜越,43,1,42,新百王,2024-07-08,6210
00753L,中信中國50正2,41,0,41,新百王,2024-07-08,6210
00933B,國泰10Y+金融債,40,0,40,新百王,2024-07-08,6210
6125,廣運,43,3,40,新百王,2024-07-08,6210
3703,欣陸,40,1,39,新百王,2024-07-08,6210
4306,炎洲,50,13,37,新百王,2024-07-08,6210
2607,榮運,33,0,33,新百王,2024-07-08,6210
1815,富喬,58,27,31,新百王,2024-07-08,6210
3062,建漢,56,25,31,新百王,2024-07-08,6210
3576,聯合再生,31,1,30,新百王,2024-07-08,6210
2374,佳能,100,70,30,新百王,2024-07-08,6210
2020,美亞,30,0,30,新百王,2024-07-08,6210
5512,力麒,30,0,30,新百王,2024-07-08,6210
2453,凌群,36,7,29,新百王,2024-07-08,6210
6698,旭暉應材,29,0,29,新百王,2024-07-08,6210
5880,合庫金,29,0,29,新百王,2024-07-08,6210
6269,台郡,27,0,27,新百王,2024-07-08,6210
2367,燿華,97,71,26,新百王,2024-07-08,6210
8028,昇陽半導體,102,77,25,新百王,2024-07-08,6210
00712,復華富時不動產,25,0,25,新百王,2024-07-08,6210
00650L,復華香港正2,25,0,25,新百王,2024-07-08,6210
00882,中信中國高股息,27,2,25,新百王,2024-07-08,6210
5202,力新,25,1,24,新百王,2024-07-08,6210
6901,鑽石投資,26,3,23,新百王,2024-07-08,6210
4549,桓達,34,12,22,新百王,2024-07-08,6210
6173,信昌電,20,0,20,新百王,2024-07-08,6210
2867,三商壽,580,151,429,新百王,2024-07-09,6210
3712,永崴投控,309,41,268,新百王,2024-07-09,6210
00936,台新永續高息中小,422,199,223,新百王,2024-07-09,6210
00934,中信成長高股息,200,5,195,新百王,2024-07-09,6210
2618,長榮航,160,25,135,新百王,2024-07-09,6210
6117,迎廣,133,22,111,新百王,2024-07-09,6210
00712,復華富時不動產,110,0,110,新百王,2024-07-09,6210
5309,系統電,218,115,103,新百王,2024-07-09,6210
00940,元大台灣價值高息,102,3,99,新百王,2024-07-09,6210
4510,高鋒,107,12,95,新百王,2024-07-09,6210
6167,久正,61,0,61,新百王,2024-07-09,6210
2323,中環,58,0,58,新百王,2024-07-09,6210
5469,瀚宇博,113,55,58,新百王,2024-07-09,6210
4167,松瑞藥,79,23,56,新百王,2024-07-09,6210
1618,合機,82,27,55,新百王,2024-07-09,6210
2820,華票,51,0,51,新百王,2024-07-09,6210
00918,大華優利高填息30,88,37,51,新百王,2024-07-09,6210
2888,新光金,187,136,51,新百王,2024-07-09,6210
00632R,元大台灣50反1,101,51,50,新百王,2024-07-09,6210
2442,新美齊,55,10,45,新百王,2024-07-09,6210
00881,國泰台灣5G+,45,0,45,新百王,2024-07-09,6210
1806,冠軍,49,8,41,新百王,2024-07-09,6210
5328,華容,57,20,37,新百王,2024-07-09,6210
3050,鈺德,50,14,36,新百王,2024-07-09,6210
2405,輔信,116,80,36,新百王,2024-07-09,6210
8277,商丞,36,0,36,新百王,2024-07-09,6210
2607,榮運,32,0,32,新百王,2024-07-09,6210
5443,均豪,89,57,32,新百王,2024-07-09,6210
3047,訊舟,117,86,31,新百王,2024-07-09,6210
2331,精英,38,7,31,新百王,2024-07-09,6210
3055,蔚華科,33,3,30,新百王,2024-07-09,6210
1781,合世,30,0,30,新百王,2024-07-09,6210
1446,宏和,30,0,30,新百王,2024-07-09,6210
6698,旭暉應材,29,0,29,新百王,2024-07-09,6210
1611,中電,32,5,27,新百王,2024-07-09,6210
2367,燿華,280,253,27,新百王,2024-07-09,6210
2610,華航,55,29,26,新百王,2024-07-09,6210
3312,弘憶股,84,59,25,新百王,2024-07-09,6210
00878,國泰永續高股息,26,2,24,新百王,2024-07-09,6210
6127,九豪,26,2,24,新百王,2024-07-09,6210
1802,台玻,22,0,22,新百王,2024-07-09,6210
6217,中探針,27,6,21,新百王,2024-07-09,6210
3062,建漢,46,25,21,新百王,2024-07-09,6210
2891,中信金,20,0,20,新百王,2024-07-09,6210
6901,鑽石投資,20,0,20,新百王,2024-07-09,6210
4207,環泰,20,0,20,新百王,2024-07-09,6210
912000,晨訊科-DR,20,0,20,新百王,2024-07-09,6210
6443,元晶,41,21,20,新百王,2024-07-09,6210
3037,欣興,22,2,20,新百王,2024-07-09,6210
6578,達邦蛋白,20,0,20,新百王,2024-07-09,6210
00632R,元大台灣50反1,617,1,616,新百王,2024-07-10,6210
4904,遠傳,411,4,407,新百王,2024-07-10,6210
00929,復華台灣科技優息,400,21,379,新百王,2024-07-10,6210
2615,萬海,207,33,174,新百王,2024-07-10,6210
2312,金寶,169,30,139,新百王,2024-07-10,6210
00942B,台新美A公司債20+,100,0,100,新百王,2024-07-10,6210
00945B,凱基美國非投等債,100,0,100,新百王,2024-07-10,6210
1447,力鵬,85,8,77,新百王,2024-07-10,6210
6126,信音,88,24,64,新百王,2024-07-10,6210
00688L,國泰20年美債正2,58,0,58,新百王,2024-07-10,6210
2323,中環,58,0,58,新百王,2024-07-10,6210
4127,天良,50,0,50,新百王,2024-07-10,6210
3481,群創,257,207,50,新百王,2024-07-10,6210
2820,華票,43,0,43,新百王,2024-07-10,6210
1101,台泥,39,0,39,新百王,2024-07-10,6210
2885,元大金,39,2,37,新百王,2024-07-10,6210
2607,榮運,37,0,37,新百王,2024-07-10,6210
1342,八貫,34,0,34,新百王,2024-07-10,6210
6153,嘉聯益,31,1,30,新百王,2024-07-10,6210
2417,圓剛,43,14,29,新百王,2024-07-10,6210
00680L,元大美債20正2,27,0,27,新百王,2024-07-10,6210
6546,正基,33,9,24,新百王,2024-07-10,6210
1616,億泰,106,82,24,新百王,2024-07-10,6210
6163,華電網,25,3,22,新百王,2024-07-10,6210
5876,上海商銀,22,0,22,新百王,2024-07-10,6210
2641,正德,21,0,21,新百王,2024-07-10,6210
9908,大台北,20,0,20,新百王,2024-07-10,6210
2845,遠東銀,20,0,20,新百王,2024-07-10,6210
2353,宏��,73,54,19,新百王,2024-07-10,6210
1303,南亞,20,2,18,新百王,2024-07-10,6210
2317,鴻海,132,115,17,新百王,2024-07-10,6210
1809,中釉,26,9,17,新百王,2024-07-10,6210
4526,東台,16,0,16,新百王,2024-07-10,6210
3149,正達,17,1,16,新百王,2024-07-10,6210
2457,飛宏,16,0,16,新百王,2024-07-10,6210
00941,中信上游半導體,18,2,16,新百王,2024-07-10,6210
5493,三聯,17,1,16,新百王,2024-07-10,6210
8068,全達,17,1,16,新百王,2024-07-10,6210
2913,農林,16,1,15,新百王,2024-07-10,6210
4167,松瑞藥,25,10,15,新百王,2024-07-10,6210
00946,群益科技高息成長,15,0,15,新百王,2024-07-10,6210
6218,豪勉,32,17,15,新百王,2024-07-10,6210
4306,炎洲,15,0,15,新百王,2024-07-10,6210
2354,鴻準,59,44,15,新百王,2024-07-10,6210
1609,大亞,27,12,15,新百王,2024-07-10,6210
2352,佳世達,14,0,14,新百王,2024-07-10,6210
00934,中信成長高股息,14,0,14,新百王,2024-07-10,6210
2489,瑞軒,83,69,14,新百王,2024-07-10,6210
2408,南亞科,13,0,13,新百王,2024-07-10,6210
6443,元晶,13,0,13,新百王,2024-07-10,6210
00632R,元大台灣50反1,651,118,533,新百王,2024-07-11,6210
1314,中石化,253,40,213,新百王,2024-07-11,6210
2867,三商壽,147,9,138,新百王,2024-07-11,6210
5309,系統電,147,21,126,新百王,2024-07-11,6210
9946,三發地產,102,0,102,新百王,2024-07-11,6210
2542,興富發,99,15,84,新百王,2024-07-11,6210
4904,遠傳,76,2,74,新百王,2024-07-11,6210
2408,南亞科,92,18,74,新百王,2024-07-11,6210
2888,新光金,218,146,72,新百王,2024-07-11,6210
3033,威健,83,13,70,新百王,2024-07-11,6210
4720,德淵,69,0,69,新百王,2024-07-11,6210
00927,群益半導體收益,66,0,66,新百王,2024-07-11,6210
00929,復華台灣科技優息,63,1,62,新百王,2024-07-11,6210
2367,燿華,104,43,61,新百王,2024-07-11,6210
00946,群益科技高息成長,61,10,51,新百王,2024-07-11,6210
1718,中纖,50,0,50,新百王,2024-07-11,6210
9105,泰金寶-DR,99,50,49,新百王,2024-07-11,6210
4726,永昕,52,4,48,新百王,2024-07-11,6210
8277,商丞,45,0,45,新百王,2024-07-11,6210
2610,華航,88,43,45,新百王,2024-07-11,6210
6156,松上,42,0,42,新百王,2024-07-11,6210
6153,嘉聯益,43,2,41,新百王,2024-07-11,6210
6266,泰詠,40,0,40,新百王,2024-07-11,6210
0056,元大高股息,56,16,40,新百王,2024-07-11,6210
4958,臻鼎-KY,63,24,39,新百王,2024-07-11,6210
2243,宏旭-KY,45,7,38,新百王,2024-07-11,6210
00712,復華富時不動產,40,2,38,新百王,2024-07-11,6210
1806,冠軍,66,29,37,新百王,2024-07-11,6210
6290,良維,36,2,34,新百王,2024-07-11,6210
2509,全坤建,46,15,31,新百王,2024-07-11,6210
1309,台達化,61,32,29,新百王,2024-07-11,6210
2534,宏盛,27,2,25,新百王,2024-07-11,6210
1303,南亞,26,2,24,新百王,2024-07-11,6210
3455,由田,43,20,23,新百王,2024-07-11,6210
5876,上海商銀,22,0,22,新百王,2024-07-11,6210
2891,中信金,24,3,21,新百王,2024-07-11,6210
2362,藍天,52,32,20,新百王,2024-07-11,6210
2020,美亞,20,0,20,新百王,2024-07-11,6210
9905,大華,20,0,20,新百王,2024-07-11,6210
3596,智易,20,0,20,新百王,2024-07-11,6210
2382,廣達,27,8,19,新百王,2024-07-11,6210
2618,長榮航,32,13,19,新百王,2024-07-11,6210
3163,波若威,39,20,19,新百王,2024-07-11,6210
00679B,元大美債20年,28,9,19,新百王,2024-07-11,6210
2889,國票金,19,0,19,新百王,2024-07-11,6210
2344,華邦電,33,14,19,新百王,2024-07-11,6210
2323,中環,20,2,18,新百王,2024-07-11,6210
2816,旺旺保,17,1,16,新百王,2024-07-11,6210
8926,台汽電,16,0,16,新百王,2024-07-11,6210
1810,和成,15,0,15,新百王,2024-07-11,6210
9105,泰金寶-DR,477,24,453,新百王,2024-07-12,6210
2317,鴻海,502,90,412,新百王,2024-07-12,6210
00720B,元大投資級公司債,246,0,246,新百王,2024-07-12,6210
3050,鈺德,240,38,202,新百王,2024-07-12,6210
00929,復華台灣科技優息,255,60,195,新百王,2024-07-12,6210
2367,燿華,203,9,194,新百王,2024-07-12,6210
00665L,富邦�琤肭磪囓�2,200,24,176,新百王,2024-07-12,6210
00679B,元大美債20年,92,0,92,新百王,2024-07-12,6210
00934,中信成長高股息,206,120,86,新百王,2024-07-12,6210
00927,群益半導體收益,85,2,83,新百王,2024-07-12,6210
00936,台新永續高息中小,287,206,81,新百王,2024-07-12,6210
2431,聯昌,70,0,70,新百王,2024-07-12,6210
4127,天良,70,2,68,新百王,2024-07-12,6210
2618,長榮航,63,2,61,新百王,2024-07-12,6210
00688L,國泰20年美債正2,85,26,59,新百王,2024-07-12,6210
2905,三商,62,8,54,新百王,2024-07-12,6210
4533,協易機,63,13,50,新百王,2024-07-12,6210
2303,聯電,70,22,48,新百王,2024-07-12,6210
2489,瑞軒,72,27,45,新百王,2024-07-12,6210
6215,和椿,49,4,45,新百王,2024-07-12,6210
00725B,國泰投資級公司債,45,0,45,新百王,2024-07-12,6210
1617,榮星,58,14,44,新百王,2024-07-12,6210
00881,國泰台灣5G+,36,0,36,新百王,2024-07-12,6210
3596,智易,36,0,36,新百王,2024-07-12,6210
2610,華航,70,35,35,新百王,2024-07-12,6210
2498,宏達電,38,5,33,新百王,2024-07-12,6210
3489,森寶,33,3,30,新百王,2024-07-12,6210
3711,日月光投控,49,20,29,新百王,2024-07-12,6210
1785,光洋科,77,49,28,新百王,2024-07-12,6210
00891,中信關鍵半導體,26,0,26,新百王,2024-07-12,6210
1466,聚隆,26,0,26,新百王,2024-07-12,6210
9946,三發地產,26,0,26,新百王,2024-07-12,6210
00919,群益台灣精選高息,42,17,25,新百王,2024-07-12,6210
2816,旺旺保,24,0,24,新百王,2024-07-12,6210
2834,臺企銀,24,0,24,新百王,2024-07-12,6210
3380,明泰,23,0,23,新百王,2024-07-12,6210
3625,西勝,20,0,20,新百王,2024-07-12,6210
1440,南紡,20,0,20,新百王,2024-07-12,6210
00680L,元大美債20正2,20,0,20,新百王,2024-07-12,6210
2243,宏旭-KY,24,5,19,新百王,2024-07-12,6210
4726,永昕,23,5,18,新百王,2024-07-12,6210
6005,群益證,17,0,17,新百王,2024-07-12,6210
1609,大亞,60,43,17,新百王,2024-07-12,6210
3645,達邁,19,4,15,新百王,2024-07-12,6210
2392,正崴,111,96,15,新百王,2024-07-12,6210
6190,萬泰科,23,8,15,新百王,2024-07-12,6210
1337,再生-KY,15,0,15,新百王,2024-07-12,6210
4909,新復興,35,20,15,新百王,2024-07-12,6210
2884,玉山金,15,0,15,新百王,2024-07-12,6210
2603,長榮,18,3,15,新百王,2024-07-12,6210
00632R,元大台灣50反1,460,1,459,新百王,2024-07-15,6210
00665L,富邦�琤肭磪囓�2,198,20,178,新百王,2024-07-15,6210
2367,燿華,170,4,166,新百王,2024-07-15,6210
3625,西勝,128,0,128,新百王,2024-07-15,6210
2834,臺企銀,114,2,112,新百王,2024-07-15,6210
00909,國泰數位支付服務,105,2,103,新百王,2024-07-15,6210
1314,中石化,120,20,100,新百王,2024-07-15,6210
4720,德淵,100,1,99,新百王,2024-07-15,6210
00929,復華台灣科技優息,104,7,97,新百王,2024-07-15,6210
8028,昇陽半導體,87,3,84,新百王,2024-07-15,6210
2356,英業達,189,109,80,新百王,2024-07-15,6210
8076,伍豐,87,8,79,新百王,2024-07-15,6210
2897,王道銀行,127,50,77,新百王,2024-07-15,6210
2449,京元電子,78,5,73,新百王,2024-07-15,6210
4526,東台,80,10,70,新百王,2024-07-15,6210
2534,宏盛,84,15,69,新百王,2024-07-15,6210
8105,凌巨,74,12,62,新百王,2024-07-15,6210
4960,誠美材,74,14,60,新百王,2024-07-15,6210
00683L,期元大美元指正2,60,0,60,新百王,2024-07-15,6210
3481,群創,112,53,59,新百王,2024-07-15,6210
2492,華新科,70,14,56,新百王,2024-07-15,6210
2431,聯昌,50,0,50,新百王,2024-07-15,6210
3033,威健,56,6,50,新百王,2024-07-15,6210
00688L,國泰20年美債正2,58,13,45,新百王,2024-07-15,6210
8936,國統,55,11,44,新百王,2024-07-15,6210
2489,瑞軒,160,117,43,新百王,2024-07-15,6210
2905,三商,46,4,42,新百王,2024-07-15,6210
00937B,群益ESG投等債20,57,18,39,新百王,2024-07-15,6210
2618,長榮航,47,10,37,新百王,2024-07-15,6210
2610,華航,36,0,36,新百王,2024-07-15,6210
5381,合正,49,13,36,新百王,2024-07-15,6210
2484,希華,34,0,34,新百王,2024-07-15,6210
00932,兆豐永續高息等權,30,0,30,新百王,2024-07-15,6210
2887,台新金,30,0,30,新百王,2024-07-15,6210
8021,尖點,30,0,30,新百王,2024-07-15,6210
2607,榮運,27,0,27,新百王,2024-07-15,6210
00753L,中信中國50正2,27,0,27,新百王,2024-07-15,6210
5328,華容,48,21,27,新百王,2024-07-15,6210
3037,欣興,36,9,27,新百王,2024-07-15,6210
8437,大地-KY,26,0,26,新百王,2024-07-15,6210
00857B,永豐20年美公債,25,0,25,新百王,2024-07-15,6210
2408,南亞科,26,1,25,新百王,2024-07-15,6210
6462,神盾,39,15,24,新百王,2024-07-15,6210
2867,三商壽,28,5,23,新百王,2024-07-15,6210
2888,新光金,122,100,22,新百王,2024-07-15,6210
2891,中信金,53,32,21,新百王,2024-07-15,6210
2498,宏達電,21,0,21,新百王,2024-07-15,6210
8421,旭源,20,0,20,新百王,2024-07-15,6210
4128,中天,20,0,20,新百王,2024-07-15,6210
1466,聚隆,19,0,19,新百王,2024-07-15,6210
00632R,元大台灣50反1,996,299,697,新百王,2024-07-16,6210
00929,復華台灣科技優息,473,93,380,新百王,2024-07-16,6210
00934,中信成長高股息,376,41,335,新百王,2024-07-16,6210
2542,興富發,358,180,178,新百王,2024-07-16,6210
2801,彰銀,155,0,155,新百王,2024-07-16,6210
2392,正崴,115,13,102,新百王,2024-07-16,6210
00650L,復華香港正2,91,0,91,新百王,2024-07-16,6210
00927,群益半導體收益,165,80,85,新百王,2024-07-16,6210
1314,中石化,85,11,74,新百王,2024-07-16,6210
00905,FT臺灣Smart,76,10,66,新百王,2024-07-16,6210
6219,富旺,63,0,63,新百王,2024-07-16,6210
2834,臺企銀,73,15,58,新百王,2024-07-16,6210
9105,泰金寶-DR,80,22,58,新百王,2024-07-16,6210
3010,華立,50,0,50,新百王,2024-07-16,6210
1611,中電,50,2,48,新百王,2024-07-16,6210
00753L,中信中國50正2,47,0,47,新百王,2024-07-16,6210
00665L,富邦�琤肭磪囓�2,45,0,45,新百王,2024-07-16,6210
2888,新光金,178,134,44,新百王,2024-07-16,6210
3312,弘憶股,62,19,43,新百王,2024-07-16,6210
3481,群創,157,117,40,新百王,2024-07-16,6210
3702A,大聯大甲特,40,0,40,新百王,2024-07-16,6210
3594,磐儀,38,1,37,新百王,2024-07-16,6210
1514,亞力,35,2,33,新百王,2024-07-16,6210
2534,宏盛,32,0,32,新百王,2024-07-16,6210
3520,華盈,94,64,30,新百王,2024-07-16,6210
00919,群益台灣精選高息,35,6,29,新百王,2024-07-16,6210
1529,樂事綠能,40,12,28,新百王,2024-07-16,6210
4526,東台,28,0,28,新百王,2024-07-16,6210
00706L,期元大S＆P日圓正2,27,0,27,新百王,2024-07-16,6210
1513,中興電,59,32,27,新百王,2024-07-16,6210
4127,天良,26,0,26,新百王,2024-07-16,6210
1701,中化,26,0,26,新百王,2024-07-16,6210
2511,太子,25,0,25,新百王,2024-07-16,6210
2363,矽統,34,9,25,新百王,2024-07-16,6210
5328,華容,48,23,25,新百王,2024-07-16,6210
00690,兆豐藍籌30,25,0,25,新百王,2024-07-16,6210
1785,光洋科,44,19,25,新百王,2024-07-16,6210
2891,中信金,27,3,24,新百王,2024-07-16,6210
4720,德淵,24,0,24,新百王,2024-07-16,6210
1609,大亞,49,26,23,新百王,2024-07-16,6210
6603,富強鑫,25,3,22,新百王,2024-07-16,6210
6177,達麗,45,24,21,新百王,2024-07-16,6210
2356,英業達,40,19,21,新百王,2024-07-16,6210
8277,商丞,21,0,21,新百王,2024-07-16,6210
00909,國泰數位支付服務,21,1,20,新百王,2024-07-16,6210
2103,台橡,20,0,20,新百王,2024-07-16,6210
2889,國票金,20,0,20,新百王,2024-07-16,6210
6117,迎廣,38,19,19,新百王,2024-07-16,6210
00911,兆豐洲際半導體,20,1,19,新百王,2024-07-16,6210
2601,益航,20,1,19,新百王,2024-07-16,6210
00712,復華富時不動產,509,238,271,新百王,2024-07-17,6210
5876,上海商銀,254,3,251,新百王,2024-07-17,6210
4906,正文,250,6,244,新百王,2024-07-17,6210
1314,中石化,163,47,116,新百王,2024-07-17,6210
00927,群益半導體收益,122,9,113,新百王,2024-07-17,6210
2886,兆豐金,100,0,100,新百王,2024-07-17,6210
9946,三發地產,86,0,86,新百王,2024-07-17,6210
00665L,富邦�琤肭磪囓�2,103,20,83,新百王,2024-07-17,6210
1609,大亞,237,157,80,新百王,2024-07-17,6210
1806,冠軍,151,71,80,新百王,2024-07-17,6210
9907,統一實,79,0,79,新百王,2024-07-17,6210
3062,建漢,75,5,70,新百王,2024-07-17,6210
8011,台通,95,26,69,新百王,2024-07-17,6210
2489,瑞軒,180,122,58,新百王,2024-07-17,6210
6116,彩晶,70,12,58,新百王,2024-07-17,6210
3260,威剛,55,0,55,新百王,2024-07-17,6210
9105,泰金寶-DR,102,48,54,新百王,2024-07-17,6210
00688L,國泰20年美債正2,61,10,51,新百王,2024-07-17,6210
00918,大華優利高填息30,50,0,50,新百王,2024-07-17,6210
3033,威健,50,0,50,新百王,2024-07-17,6210
3312,弘憶股,101,52,49,新百王,2024-07-17,6210
00950B,凱基A級公司債,47,0,47,新百王,2024-07-17,6210
2514,龍邦,45,0,45,新百王,2024-07-17,6210
00650L,復華香港正2,45,0,45,新百王,2024-07-17,6210
2408,南亞科,41,1,40,新百王,2024-07-17,6210
00687B,國泰20年美債,61,21,40,新百王,2024-07-17,6210
0056,元大高股息,39,0,39,新百王,2024-07-17,6210
4720,德淵,42,3,39,新百王,2024-07-17,6210
2867,三商壽,54,17,37,新百王,2024-07-17,6210
2534,宏盛,50,15,35,新百王,2024-07-17,6210
2905,三商,39,5,34,新百王,2024-07-17,6210
00919,群益台灣精選高息,38,5,33,新百王,2024-07-17,6210
1569,濱川,36,4,32,新百王,2024-07-17,6210
1810,和成,73,43,30,新百王,2024-07-17,6210
2618,長榮航,37,7,30,新百王,2024-07-17,6210
2349,錸德,27,0,27,新百王,2024-07-17,6210
2317,鴻海,104,79,25,新百王,2024-07-17,6210
5905,南仁湖,49,24,25,新百王,2024-07-17,6210
00690,兆豐藍籌30,25,0,25,新百王,2024-07-17,6210
3535,晶彩科,24,1,23,新百王,2024-07-17,6210
2402,毅嘉,100,77,23,新百王,2024-07-17,6210
2538,基泰,51,28,23,新百王,2024-07-17,6210
00946,群益科技高息成長,21,0,21,新百王,2024-07-17,6210
2606,裕民,21,0,21,新百王,2024-07-17,6210
00934,中信成長高股息,20,0,20,新百王,2024-07-17,6210
6227,茂綸,28,8,20,新百王,2024-07-17,6210
1909,榮成,20,0,20,新百王,2024-07-17,6210
2542,興富發,105,86,19,新百王,2024-07-17,6210
2382,廣達,23,4,19,新百王,2024-07-17,6210
2884,玉山金,21,2,19,新百王,2024-07-17,6210
00927,群益半導體收益,426,153,273,新百王,2024-07-18,6210
9105,泰金寶-DR,191,41,150,新百王,2024-07-18,6210
00878,國泰永續高股息,133,4,129,新百王,2024-07-18,6210
00946,群益科技高息成長,132,10,122,新百王,2024-07-18,6210
9907,統一實,116,0,116,新百王,2024-07-18,6210
2614,東森,123,10,113,新百王,2024-07-18,6210
2514,龍邦,100,0,100,新百王,2024-07-18,6210
00688L,國泰20年美債正2,80,5,75,新百王,2024-07-18,6210
2891,中信金,78,11,67,新百王,2024-07-18,6210
4958,臻鼎-KY,68,4,64,新百王,2024-07-18,6210
2392,正崴,64,3,61,新百王,2024-07-18,6210
2444,兆勁,59,0,59,新百王,2024-07-18,6210
9946,三發地產,55,0,55,新百王,2024-07-18,6210
2610,華航,56,5,51,新百王,2024-07-18,6210
4909,新復興,156,107,49,新百王,2024-07-18,6210
1611,中電,130,83,47,新百王,2024-07-18,6210
2363,矽統,90,45,45,新百王,2024-07-18,6210
8105,凌巨,212,168,44,新百王,2024-07-18,6210
00650L,復華香港正2,67,23,44,新百王,2024-07-18,6210
1303,南亞,46,4,42,新百王,2024-07-18,6210
2520,冠德,75,35,40,新百王,2024-07-18,6210
00940,元大台灣價值高息,225,186,39,新百王,2024-07-18,6210
00937B,群益ESG投等債20,104,70,34,新百王,2024-07-18,6210
1101,台泥,39,7,32,新百王,2024-07-18,6210
6901,鑽石投資,30,0,30,新百王,2024-07-18,6210
2356,英業達,31,1,30,新百王,2024-07-18,6210
0050,元大台灣50,28,2,26,新百王,2024-07-18,6210
4952,凌通,26,0,26,新百王,2024-07-18,6210
00930,永豐ESG低碳高息,25,0,25,新百王,2024-07-18,6210
00753L,中信中國50正2,41,17,24,新百王,2024-07-18,6210
2458,義隆,24,0,24,新百王,2024-07-18,6210
1536,和大,32,10,22,新百王,2024-07-18,6210
00941,中信上游半導體,21,0,21,新百王,2024-07-18,6210
2641,正德,21,0,21,新百王,2024-07-18,6210
1709,和益,46,25,21,新百王,2024-07-18,6210
2365,昆盈,158,137,21,新百王,2024-07-18,6210
2427,三商電,20,0,20,新百王,2024-07-18,6210
2317,鴻海,59,39,20,新百王,2024-07-18,6210
1802,台玻,20,0,20,新百王,2024-07-18,6210
9919,康那香,20,0,20,新百王,2024-07-18,6210
3520,華盈,34,15,19,新百王,2024-07-18,6210
3015,全漢,19,0,19,新百王,2024-07-18,6210
6125,廣運,37,19,18,新百王,2024-07-18,6210
2419,仲琦,28,10,18,新百王,2024-07-18,6210
5871,中租-KY,19,2,17,新百王,2024-07-18,6210
2883,凱基金,23,6,17,新百王,2024-07-18,6210
3189,景碩,29,12,17,新百王,2024-07-18,6210
2338,光罩,19,2,17,新百王,2024-07-18,6210
1727,中華化,20,4,16,新百王,2024-07-18,6210
2330,台積電,68,52,16,新百王,2024-07-18,6210
00632R,元大台灣50反1,1320,579,741,新百王,2024-07-19,6210
00650L,復華香港正2,272,0,272,新百王,2024-07-19,6210
2834,臺企銀,304,63,241,新百王,2024-07-19,6210
2897,王道銀行,275,70,205,新百王,2024-07-19,6210
00934,中信成長高股息,218,15,203,新百王,2024-07-19,6210
2312,金寶,212,30,182,新百王,2024-07-19,6210
00665L,富邦�琤肭磪囓�2,132,0,132,新百王,2024-07-19,6210
2881,富邦金,121,4,117,新百王,2024-07-19,6210
2888,新光金,146,29,117,新百王,2024-07-19,6210
2542,興富發,200,110,90,新百王,2024-07-19,6210
00712,復華富時不動產,110,22,88,新百王,2024-07-19,6210
1785,光洋科,110,26,84,新百王,2024-07-19,6210
3481,群創,321,246,75,新百王,2024-07-19,6210
9105,泰金寶-DR,135,63,72,新百王,2024-07-19,6210
00946,群益科技高息成長,69,0,69,新百王,2024-07-19,6210
00919,群益台灣精選高息,84,16,68,新百王,2024-07-19,6210
2607,榮運,67,0,67,新百王,2024-07-19,6210
2323,中環,60,0,60,新百王,2024-07-19,6210
2356,英業達,68,13,55,新百王,2024-07-19,6210
1447,力鵬,116,64,52,新百王,2024-07-19,6210
2618,長榮航,49,2,47,新百王,2024-07-19,6210
3006,晶豪科,65,21,44,新百王,2024-07-19,6210
00878,國泰永續高股息,51,7,44,新百王,2024-07-19,6210
4714,永捷,41,0,41,新百王,2024-07-19,6210
6152,百一,40,0,40,新百王,2024-07-19,6210
9907,統一實,35,0,35,新百王,2024-07-19,6210
2338,光罩,36,1,35,新百王,2024-07-19,6210
2330,台積電,64,29,35,新百王,2024-07-19,6210
2408,南亞科,35,2,33,新百王,2024-07-19,6210
00753L,中信中國50正2,32,0,32,新百王,2024-07-19,6210
5871,中租-KY,32,0,32,新百王,2024-07-19,6210
1609,大亞,194,163,31,新百王,2024-07-19,6210
2484,希華,30,0,30,新百王,2024-07-19,6210
00945B,凱基美國非投等債,30,0,30,新百王,2024-07-19,6210
0056,元大高股息,30,0,30,新百王,2024-07-19,6210
2402,毅嘉,52,23,29,新百王,2024-07-19,6210
4526,東台,29,0,29,新百王,2024-07-19,6210
4538,大詠城,29,0,29,新百王,2024-07-19,6210
2409,友達,33,5,28,新百王,2024-07-19,6210
4113,聯上,27,1,26,新百王,2024-07-19,6210
2610,華航,35,9,26,新百王,2024-07-19,6210
0052,富邦科技,25,0,25,新百王,2024-07-19,6210
6197,佳必琪,25,0,25,新百王,2024-07-19,6210
6290,良維,29,6,23,新百王,2024-07-19,6210
2887,台新金,33,10,23,新百王,2024-07-19,6210
00713,元大台灣高息低波,25,4,21,新百王,2024-07-19,6210
4167,松瑞藥,46,25,21,新百王,2024-07-19,6210
3518,柏騰,37,16,21,新百王,2024-07-19,6210
1457,宜進,20,0,20,新百王,2024-07-19,6210
3059,華晶科,20,0,20,新百王,2024-07-19,6210
00632R,元大台灣50反1,460,132,328,新百王,2024-07-22,6210
2834,臺企銀,313,9,304,新百王,2024-07-22,6210
2881,富邦金,283,29,254,新百王,2024-07-22,6210
00650L,復華香港正2,210,10,200,新百王,2024-07-22,6210
1522,堤維西,232,41,191,新百王,2024-07-22,6210
00937B,群益ESG投等債20,132,4,128,新百王,2024-07-22,6210
3481,群創,124,4,120,新百王,2024-07-22,6210
2906,高林,109,0,109,新百王,2024-07-22,6210
2408,南亞科,95,4,91,新百王,2024-07-22,6210
4526,東台,83,1,82,新百王,2024-07-22,6210
5309,系統電,83,15,68,新百王,2024-07-22,6210
2409,友達,50,0,50,新百王,2024-07-22,6210
6127,九豪,54,4,50,新百王,2024-07-22,6210
6284,佳邦,53,3,50,新百王,2024-07-22,6210
4726,永昕,52,3,49,新百王,2024-07-22,6210
1785,光洋科,80,32,48,新百王,2024-07-22,6210
1314,中石化,62,15,47,新百王,2024-07-22,6210
00919,群益台灣精選高息,77,37,40,新百王,2024-07-22,6210
1447,力鵬,50,10,40,新百王,2024-07-22,6210
3050,鈺德,41,3,38,新百王,2024-07-22,6210
00934,中信成長高股息,45,10,35,新百王,2024-07-22,6210
2534,宏盛,41,8,33,新百王,2024-07-22,6210
4958,臻鼎-KY,38,5,33,新百王,2024-07-22,6210
3576,聯合再生,33,0,33,新百王,2024-07-22,6210
1101,台泥,32,0,32,新百王,2024-07-22,6210
3006,晶豪科,41,10,31,新百王,2024-07-22,6210
1444,力麗,30,0,30,新百王,2024-07-22,6210
1312,國喬,25,0,25,新百王,2024-07-22,6210
8473,山林水,85,61,24,新百王,2024-07-22,6210
9946,三發地產,25,2,23,新百王,2024-07-22,6210
8105,凌巨,38,16,22,新百王,2024-07-22,6210
2542,興富發,39,17,22,新百王,2024-07-22,6210
2607,榮運,21,0,21,新百王,2024-07-22,6210
6488,環球晶,20,0,20,新百王,2024-07-22,6210
4566,時碩工業,41,21,20,新百王,2024-07-22,6210
6244,茂迪,21,1,20,新百王,2024-07-22,6210
6776,展�眥篕�,20,0,20,新百王,2024-07-22,6210
2330,台積電,48,29,19,新百王,2024-07-22,6210
3052,夆典,20,1,19,新百王,2024-07-22,6210
00882,中信中國高股息,30,11,19,新百王,2024-07-22,6210
1303,南亞,23,4,19,新百王,2024-07-22,6210
3673,TPK-KY,32,13,19,新百王,2024-07-22,6210
00631L,元大台灣50正2,24,6,18,新百王,2024-07-22,6210
2897,王道銀行,126,108,18,新百王,2024-07-22,6210
2884,玉山金,27,9,18,新百王,2024-07-22,6210
8064,東捷,68,52,16,新百王,2024-07-22,6210
2515,中工,26,10,16,新百王,2024-07-22,6210
00670L,富邦NASDAQ正2,17,2,15,新百王,2024-07-22,6210
6005,群益證,15,0,15,新百王,2024-07-22,6210
3017,奇鋐,23,8,15,新百王,2024-07-22,6210
00680L,元大美債20正2,1004,17,987,新百王,2024-07-23,6210
3050,鈺德,292,0,292,新百王,2024-07-23,6210
00632R,元大台灣50反1,917,632,285,新百王,2024-07-23,6210
00929,復華台灣科技優息,227,97,130,新百王,2024-07-23,6210
00918,大華優利高填息30,100,0,100,新百王,2024-07-23,6210
6176,瑞儀,97,0,97,新百王,2024-07-23,6210
00688L,國泰20年美債正2,105,20,85,新百王,2024-07-23,6210
2520,冠德,93,10,83,新百王,2024-07-23,6210
4526,東台,83,2,81,新百王,2024-07-23,6210
00937B,群益ESG投等債20,84,10,74,新百王,2024-07-23,6210
2408,南亞科,79,6,73,新百王,2024-07-23,6210
00934,中信成長高股息,68,0,68,新百王,2024-07-23,6210
9945,潤泰新,121,60,61,新百王,2024-07-23,6210
00936,台新永續高息中小,53,0,53,新百王,2024-07-23,6210
00942B,台新美A公司債20+,50,0,50,新百王,2024-07-23,6210
2002,中鋼,44,0,44,新百王,2024-07-23,6210
3481,群創,77,34,43,新百王,2024-07-23,6210
1201,味全,38,0,38,新百王,2024-07-23,6210
00930,永豐ESG低碳高息,40,3,37,新百王,2024-07-23,6210
00687B,國泰20年美債,68,31,37,新百王,2024-07-23,6210
3703,欣陸,37,0,37,新百王,2024-07-23,6210
00923,群益台ESG低碳50,36,0,36,新百王,2024-07-23,6210
2609,陽明,41,7,34,新百王,2024-07-23,6210
6488,環球晶,35,1,34,新百王,2024-07-23,6210
2537,聯上發,93,60,33,新百王,2024-07-23,6210
2534,宏盛,34,5,29,新百王,2024-07-23,6210
3576,聯合再生,21,0,21,新百王,2024-07-23,6210
3234,光環,25,5,20,新百王,2024-07-23,6210
00753L,中信中國50正2,22,2,20,新百王,2024-07-23,6210
1110,東泥,26,6,20,新百王,2024-07-23,6210
3663,鑫科,42,22,20,新百王,2024-07-23,6210
4726,永昕,42,22,20,新百王,2024-07-23,6210
8032,光菱,20,0,20,新百王,2024-07-23,6210
6695,芯鼎,28,9,19,新百王,2024-07-23,6210
2867,三商壽,52,34,18,新百王,2024-07-23,6210
4916,事欣科,43,26,17,新百王,2024-07-23,6210
1316,上曜,28,11,17,新百王,2024-07-23,6210
4551,智伸科,18,1,17,新百王,2024-07-23,6210
00919,群益台灣精選高息,30,14,16,新百王,2024-07-23,6210
00676R,富邦臺灣加權反1,16,0,16,新百王,2024-07-23,6210
9938,百和,21,5,16,新百王,2024-07-23,6210
6869,雲豹能源,16,0,16,新百王,2024-07-23,6210
2528,皇普,15,1,14,新百王,2024-07-23,6210
9105,泰金寶-DR,84,70,14,新百王,2024-07-23,6210
3372,典範,24,10,14,新百王,2024-07-23,6210
5443,均豪,30,16,14,新百王,2024-07-23,6210
4128,中天,42,28,14,新百王,2024-07-23,6210
0056,元大高股息,13,0,13,新百王,2024-07-23,6210
3705,永信,13,0,13,新百王,2024-07-23,6210
2812,台中銀,13,0,13,新百王,2024-07-23,6210
2834,臺企銀,477,100,377,新百王,2024-07-26,6210
00712,復華富時不動產,162,13,149,新百王,2024-07-26,6210
00937B,群益ESG投等債20,139,10,129,新百王,2024-07-26,6210
00637L,元大滬深300正2,137,41,96,新百王,2024-07-26,6210
00665L,富邦�琤肭磪囓�2,141,48,93,新百王,2024-07-26,6210
00687B,國泰20年美債,167,85,82,新百王,2024-07-26,6210
2867,三商壽,74,0,74,新百王,2024-07-26,6210
00650L,復華香港正2,73,0,73,新百王,2024-07-26,6210
00919,群益台灣精選高息,95,30,65,新百王,2024-07-26,6210
2409,友達,138,78,60,新百王,2024-07-26,6210
2467,志聖,66,9,57,新百王,2024-07-26,6210
3006,晶豪科,61,4,57,新百王,2024-07-26,6210
3711,日月光投控,60,3,57,新百王,2024-07-26,6210
1701,中化,54,0,54,新百王,2024-07-26,6210
4526,東台,60,10,50,新百王,2024-07-26,6210
00941,中信上游半導體,49,0,49,新百王,2024-07-26,6210
00940,元大台灣價值高息,53,7,46,新百王,2024-07-26,6210
2317,鴻海,102,56,46,新百王,2024-07-26,6210
00934,中信成長高股息,187,145,42,新百王,2024-07-26,6210
5519,隆大,48,9,39,新百王,2024-07-26,6210
1101,台泥,41,3,38,新百王,2024-07-26,6210
00878,國泰永續高股息,57,22,35,新百王,2024-07-26,6210
00713,元大台灣高息低波,30,0,30,新百王,2024-07-26,6210
3406,玉晶光,33,3,30,新百王,2024-07-26,6210
2851,中再保,30,0,30,新百王,2024-07-26,6210
3535,晶彩科,29,0,29,新百王,2024-07-26,6210
1314,中石化,35,10,25,新百王,2024-07-26,6210
2356,英業達,25,1,24,新百王,2024-07-26,6210
00949,復華日本龍頭,24,0,24,新百王,2024-07-26,6210
2884,玉山金,37,14,23,新百王,2024-07-26,6210
3147,大綜,23,0,23,新百王,2024-07-26,6210
1586,和勤,23,0,23,新百王,2024-07-26,6210
0050,元大台灣50,36,13,23,新百王,2024-07-26,6210
2801,彰銀,25,3,22,新百王,2024-07-26,6210
00931B,統一美債20年,21,0,21,新百王,2024-07-26,6210
00675L,富邦臺灣加權正2,25,4,21,新百王,2024-07-26,6210
00950B,凱基A級公司債,21,0,21,新百王,2024-07-26,6210
6290,良維,21,1,20,新百王,2024-07-26,6210
00882,中信中國高股息,20,0,20,新百王,2024-07-26,6210
00918,大華優利高填息30,25,5,20,新百王,2024-07-26,6210
3050,鈺德,20,0,20,新百王,2024-07-26,6210
4720,德淵,20,0,20,新百王,2024-07-26,6210
00888,永豐台灣ESG,20,0,20,新百王,2024-07-26,6210
00946,群益科技高息成長,30,11,19,新百王,2024-07-26,6210
00923,群益台ESG低碳50,19,1,18,新百王,2024-07-26,6210
2002,中鋼,26,9,17,新百王,2024-07-26,6210
2352,佳世達,19,2,17,新百王,2024-07-26,6210
00685L,群益臺灣加權正2,17,0,17,新百王,2024-07-26,6210
00680L,元大美債20正2,17,0,17,新百王,2024-07-26,6210
6257,矽格,17,0,17,新百王,2024-07-26,6210
00929,復華台灣科技優息,144,4,140,新百王,2024-07-29,6210
2867,三商壽,128,1,127,新百王,2024-07-29,6210
2409,友達,122,0,122,新百王,2024-07-29,6210
00919,群益台灣精選高息,89,0,89,新百王,2024-07-29,6210
4720,德淵,80,0,80,新百王,2024-07-29,6210
00795B,中信美國公債20年,80,3,77,新百王,2024-07-29,6210
2467,志聖,77,3,74,新百王,2024-07-29,6210
3481,群創,100,41,59,新百王,2024-07-29,6210
9105,泰金寶-DR,78,20,58,新百王,2024-07-29,6210
2324,仁寶,59,3,56,新百王,2024-07-29,6210
00676R,富邦臺灣加權反1,50,0,50,新百王,2024-07-29,6210
9946,三發地產,183,139,44,新百王,2024-07-29,6210
6290,良維,61,18,43,新百王,2024-07-29,6210
6156,松上,42,0,42,新百王,2024-07-29,6210
5355,佳總,40,0,40,新百王,2024-07-29,6210
5443,均豪,106,67,39,新百王,2024-07-29,6210
00878,國泰永續高股息,38,0,38,新百王,2024-07-29,6210
8940,新天地,47,9,38,新百王,2024-07-29,6210
2349,錸德,43,9,34,新百王,2024-07-29,6210
2344,華邦電,44,10,34,新百王,2024-07-29,6210
5483,中美晶,31,1,30,新百王,2024-07-29,6210
2528,皇普,41,11,30,新百王,2024-07-29,6210
1314,中石化,130,100,30,新百王,2024-07-29,6210
6757,台灣虎航,28,0,28,新百王,2024-07-29,6210
6698,旭暉應材,28,0,28,新百王,2024-07-29,6210
0056,元大高股息,27,0,27,新百王,2024-07-29,6210
3050,鈺德,27,1,26,新百王,2024-07-29,6210
2356,英業達,32,7,25,新百王,2024-07-29,6210
5309,系統電,35,10,25,新百王,2024-07-29,6210
8213,志超,25,0,25,新百王,2024-07-29,6210
8054,安國,81,56,25,新百王,2024-07-29,6210
6189,豐藝,26,2,24,新百王,2024-07-29,6210
3376,新日興,27,3,24,新百王,2024-07-29,6210
2607,榮運,21,0,21,新百王,2024-07-29,6210
6284,佳邦,22,1,21,新百王,2024-07-29,6210
00642U,期元大S＆P石油,20,0,20,新百王,2024-07-29,6210
6776,展�眥篕�,20,0,20,新百王,2024-07-29,6210
00932,兆豐永續高息等權,20,0,20,新百王,2024-07-29,6210
2402,毅嘉,60,41,19,新百王,2024-07-29,6210
2353,宏��,23,5,18,新百王,2024-07-29,6210
00640L,富邦日本正2,18,0,18,新百王,2024-07-29,6210
2363,矽統,46,28,18,新百王,2024-07-29,6210
2610,華航,26,9,17,新百王,2024-07-29,6210
3013,晟銘電,24,7,17,新百王,2024-07-29,6210
2313,華通,20,4,16,新百王,2024-07-29,6210
8028,昇陽半導體,70,54,16,新百王,2024-07-29,6210
1785,光洋科,34,19,15,新百王,2024-07-29,6210
2534,宏盛,17,2,15,新百王,2024-07-29,6210
3380,明泰,15,0,15,新百王,2024-07-29,6210
1815,富喬,15,1,14,新百王,2024-07-29,6210
3686,達能,210,0,210,新百王,2024-07-30,6210
00936,台新永續高息中小,370,226,144,新百王,2024-07-30,6210
1102,亞泥,140,28,112,新百王,2024-07-30,6210
00934,中信成長高股息,118,16,102,新百王,2024-07-30,6210
2882,國泰金,104,5,99,新百王,2024-07-30,6210
00937B,群益ESG投等債20,99,10,89,新百王,2024-07-30,6210
00650L,復華香港正2,77,0,77,新百王,2024-07-30,6210
2504,國產,75,1,74,新百王,2024-07-30,6210
1314,中石化,70,10,60,新百王,2024-07-30,6210
00933B,國泰10Y+金融債,60,0,60,新百王,2024-07-30,6210
00885,富邦越南,56,0,56,新百王,2024-07-30,6210
2362,藍天,48,2,46,新百王,2024-07-30,6210
00940,元大台灣價值高息,68,30,38,新百王,2024-07-30,6210
00720B,元大投資級公司債,34,0,34,新百王,2024-07-30,6210
4167,松瑞藥,34,0,34,新百王,2024-07-30,6210
5014,建錩,32,0,32,新百王,2024-07-30,6210
00665L,富邦�琤肭磪囓�2,34,2,32,新百王,2024-07-30,6210
4564,元翎,35,5,30,新百王,2024-07-30,6210
00951,台新日本半導體,30,0,30,新百王,2024-07-30,6210
2534,宏盛,30,0,30,新百王,2024-07-30,6210
9105,泰金寶-DR,63,33,30,新百王,2024-07-30,6210
1529,樂事綠能,28,0,28,新百王,2024-07-30,6210
2867,三商壽,34,7,27,新百王,2024-07-30,6210
2316,楠梓電,26,0,26,新百王,2024-07-30,6210
2103,台橡,22,0,22,新百王,2024-07-30,6210
2891,中信金,21,0,21,新百王,2024-07-30,6210
00687B,國泰20年美債,57,36,21,新百王,2024-07-30,6210
5355,佳總,20,0,20,新百王,2024-07-30,6210
2020,美亞,20,0,20,新百王,2024-07-30,6210
2511,太子,20,0,20,新百王,2024-07-30,6210
4720,德淵,20,0,20,新百王,2024-07-30,6210
00878,國泰永續高股息,30,10,20,新百王,2024-07-30,6210
0056,元大高股息,25,5,20,新百王,2024-07-30,6210
4526,東台,56,37,19,新百王,2024-07-30,6210
2524,京城,56,38,18,新百王,2024-07-30,6210
4909,新復興,29,12,17,新百王,2024-07-30,6210
00679B,元大美債20年,22,5,17,新百王,2024-07-30,6210
8028,昇陽半導體,98,82,16,新百王,2024-07-30,6210
2376,技嘉,36,21,15,新百王,2024-07-30,6210
00919,群益台灣精選高息,22,8,14,新百王,2024-07-30,6210
5452,佶優,23,9,14,新百王,2024-07-30,6210
2061,風青,15,1,14,新百王,2024-07-30,6210
2886,兆豐金,13,0,13,新百王,2024-07-30,6210
6125,廣運,18,5,13,新百王,2024-07-30,6210
00944,野村趨勢動能高息,13,0,13,新百王,2024-07-30,6210
2303,聯電,12,0,12,新百王,2024-07-30,6210
6156,松上,12,0,12,新百王,2024-07-30,6210
6616,特昇-KY,12,0,12,新百王,2024-07-30,6210
8069,元太,14,2,12,新百王,2024-07-30,6210
00715L,期街口布蘭特正2,12,0,12,新百王,2024-07-30,6210
4510,高鋒,235,25,210,新百王,2024-07-31,6210
3481,群創,265,70,195,新百王,2024-07-31,6210
00715L,期街口布蘭特正2,148,2,146,新百王,2024-07-31,6210
00951,台新日本半導體,163,30,133,新百王,2024-07-31,6210
3024,憶聲,105,15,90,新百王,2024-07-31,6210
2897,王道銀行,91,10,81,新百王,2024-07-31,6210
00949,復華日本龍頭,80,0,80,新百王,2024-07-31,6210
00929,復華台灣科技優息,100,25,75,新百王,2024-07-31,6210
1314,中石化,74,0,74,新百王,2024-07-31,6210
00945B,凱基美國非投等債,70,0,70,新百王,2024-07-31,6210
2530,華建,68,4,64,新百王,2024-07-31,6210
5309,系統電,60,0,60,新百王,2024-07-31,6210
00885,富邦越南,61,3,58,新百王,2024-07-31,6210
9105,泰金寶-DR,61,4,57,新百王,2024-07-31,6210
1101,台泥,71,15,56,新百王,2024-07-31,6210
5443,均豪,194,138,56,新百王,2024-07-31,6210
2444,兆勁,50,0,50,新百王,2024-07-31,6210
00947,台新臺灣IC設計,49,0,49,新百王,2024-07-31,6210
2812,台中銀,50,1,49,新百王,2024-07-31,6210
2344,華邦電,47,5,42,新百王,2024-07-31,6210
1532,勤美,40,0,40,新百王,2024-07-31,6210
1466,聚隆,38,0,38,新百王,2024-07-31,6210
2409,友達,51,16,35,新百王,2024-07-31,6210
3712,永崴投控,50,15,35,新百王,2024-07-31,6210
4167,松瑞藥,34,0,34,新百王,2024-07-31,6210
00720B,元大投資級公司債,30,0,30,新百王,2024-07-31,6210
2867,三商壽,30,0,30,新百王,2024-07-31,6210
9907,統一實,24,0,24,新百王,2024-07-31,6210
9933,中鼎,23,0,23,新百王,2024-07-31,6210
6698,旭暉應材,22,0,22,新百王,2024-07-31,6210
2913,農林,21,0,21,新百王,2024-07-31,6210
2528,皇普,20,0,20,新百王,2024-07-31,6210
2461,光群雷,20,0,20,新百王,2024-07-31,6210
3052,夆典,21,1,20,新百王,2024-07-31,6210
912000,晨訊科-DR,20,0,20,新百王,2024-07-31,6210
00687B,國泰20年美債,36,17,19,新百王,2024-07-31,6210
9908,大台北,19,0,19,新百王,2024-07-31,6210
00680L,元大美債20正2,60,42,18,新百王,2024-07-31,6210
6239,力成,19,1,18,新百王,2024-07-31,6210
2031,新光鋼,17,0,17,新百王,2024-07-31,6210
3576,聯合再生,16,0,16,新百王,2024-07-31,6210
00918,大華優利高填息30,15,0,15,新百王,2024-07-31,6210
2104,國際中橡,15,0,15,新百王,2024-07-31,6210
00697B,元大美債7-10,15,0,15,新百王,2024-07-31,6210
00934,中信成長高股息,49,34,15,新百王,2024-07-31,6210
6869,雲豹能源,30,17,13,新百王,2024-07-31,6210
00927,群益半導體收益,15,2,13,新百王,2024-07-31,6210
2851,中再保,13,0,13,新百王,2024-07-31,6210
4113,聯上,18,5,13,新百王,2024-07-31,6210
00946,群益科技高息成長,12,0,12,新百王,2024-07-31,6210
00632R,元大台灣50反1,1082,6,1076,新百王,2024-08-01,6210
1101,台泥,245,0,245,新百王,2024-08-01,6210
2344,華邦電,215,2,213,新百王,2024-08-01,6210
00933B,國泰10Y+金融債,217,8,209,新百王,2024-08-01,6210
1718,中纖,251,56,195,新百王,2024-08-01,6210
00937B,群益ESG投等債20,856,675,181,新百王,2024-08-01,6210
00637L,元大滬深300正2,128,2,126,新百王,2024-08-01,6210
00673R,期元大S＆P原油反1,100,0,100,新百王,2024-08-01,6210
2834,臺企銀,101,3,98,新百王,2024-08-01,6210
5014,建錩,96,0,96,新百王,2024-08-01,6210
9105,泰金寶-DR,86,4,82,新百王,2024-08-01,6210
2337,旺宏,103,27,76,新百王,2024-08-01,6210
2610,華航,60,0,60,新百王,2024-08-01,6210
1314,中石化,69,13,56,新百王,2024-08-01,6210
5512,力麒,55,1,54,新百王,2024-08-01,6210
6770,力積電,54,0,54,新百王,2024-08-01,6210
2520,冠德,76,26,50,新百王,2024-08-01,6210
6101,寬魚國際,43,0,43,新百王,2024-08-01,6210
2527,宏璟,57,15,42,新百王,2024-08-01,6210
1734,杏輝,37,0,37,新百王,2024-08-01,6210
00753L,中信中國50正2,34,2,32,新百王,2024-08-01,6210
2317,鴻海,87,56,31,新百王,2024-08-01,6210
2486,一詮,66,35,31,新百王,2024-08-01,6210
2324,仁寶,33,2,31,新百王,2024-08-01,6210
2461,光群雷,30,0,30,新百王,2024-08-01,6210
5876,上海商銀,29,0,29,新百王,2024-08-01,6210
3024,憶聲,29,1,28,新百王,2024-08-01,6210
3050,鈺德,33,5,28,新百王,2024-08-01,6210
00948B,中信優息投資級債,26,0,26,新百王,2024-08-01,6210
3105,穩懋,33,9,24,新百王,2024-08-01,6210
00642U,期元大S＆P石油,24,0,24,新百王,2024-08-01,6210
00687B,國泰20年美債,25,2,23,新百王,2024-08-01,6210
1102,亞泥,153,131,22,新百王,2024-08-01,6210
2363,矽統,90,69,21,新百王,2024-08-01,6210
2509,全坤建,20,0,20,新百王,2024-08-01,6210
3663,鑫科,114,95,19,新百王,2024-08-01,6210
5483,中美晶,20,1,19,新百王,2024-08-01,6210
4933,友輝,18,0,18,新百王,2024-08-01,6210
2367,燿華,25,7,18,新百王,2024-08-01,6210
3686,達能,18,0,18,新百王,2024-08-01,6210
1711,永光,21,5,16,新百王,2024-08-01,6210
00697B,元大美債7-10,16,0,16,新百王,2024-08-01,6210
00690,兆豐藍籌30,16,0,16,新百王,2024-08-01,6210
1806,冠軍,36,21,15,新百王,2024-08-01,6210
00640L,富邦日本正2,15,0,15,新百王,2024-08-01,6210
1504,東元,20,5,15,新百王,2024-08-01,6210
6603,富強鑫,24,11,13,新百王,2024-08-01,6210
3037,欣興,41,28,13,新百王,2024-08-01,6210
6548,長科*,21,8,13,新百王,2024-08-01,6210
6177,達麗,20,7,13,新百王,2024-08-01,6210
00951,台新日本半導體,292,0,292,新百王,2024-08-02,6210
1522,堤維西,283,1,282,新百王,2024-08-02,6210
00919,群益台灣精選高息,260,0,260,新百王,2024-08-02,6210
00934,中信成長高股息,359,135,224,新百王,2024-08-02,6210
00929,復華台灣科技優息,242,41,201,新百王,2024-08-02,6210
00712,復華富時不動產,134,2,132,新百王,2024-08-02,6210
2897,王道銀行,219,110,109,新百王,2024-08-02,6210
00945B,凱基美國非投等債,102,0,102,新百王,2024-08-02,6210
2409,友達,107,6,101,新百王,2024-08-02,6210
0056,元大高股息,103,2,101,新百王,2024-08-02,6210
2542,興富發,95,2,93,新百王,2024-08-02,6210
00650L,復華香港正2,89,10,79,新百王,2024-08-02,6210
00878,國泰永續高股息,80,1,79,新百王,2024-08-02,6210
1217,愛之味,69,0,69,新百王,2024-08-02,6210
2610,華航,71,4,67,新百王,2024-08-02,6210
2317,鴻海,137,74,63,新百王,2024-08-02,6210
00937B,群益ESG投等債20,665,602,63,新百王,2024-08-02,6210
2801,彰銀,60,0,60,新百王,2024-08-02,6210
5880,合庫金,60,0,60,新百王,2024-08-02,6210
2867,三商壽,58,0,58,新百王,2024-08-02,6210
6101,寬魚國際,58,0,58,新百王,2024-08-02,6210
5531,鄉林,56,0,56,新百王,2024-08-02,6210
2408,南亞科,61,5,56,新百王,2024-08-02,6210
6126,信音,61,5,56,新百王,2024-08-02,6210
9907,統一實,53,0,53,新百王,2024-08-02,6210
4113,聯上,52,0,52,新百王,2024-08-02,6210
00665L,富邦�琤肭磪囓�2,108,56,52,新百王,2024-08-02,6210
1718,中纖,50,0,50,新百王,2024-08-02,6210
2020,美亞,50,0,50,新百王,2024-08-02,6210
2330,台積電,74,29,45,新百王,2024-08-02,6210
9908,大台北,45,0,45,新百王,2024-08-02,6210
3024,憶聲,68,24,44,新百王,2024-08-02,6210
5014,建錩,42,0,42,新百王,2024-08-02,6210
00642U,期元大S＆P石油,41,0,41,新百王,2024-08-02,6210
3052,夆典,44,4,40,新百王,2024-08-02,6210
00932,兆豐永續高息等權,40,0,40,新百王,2024-08-02,6210
2812,台中銀,39,0,39,新百王,2024-08-02,6210
6757,台灣虎航,36,0,36,新百王,2024-08-02,6210
00927,群益半導體收益,36,0,36,新百王,2024-08-02,6210
00918,大華優利高填息30,59,25,34,新百王,2024-08-02,6210
2851,中再保,32,0,32,新百王,2024-08-02,6210
00675L,富邦臺灣加權正2,44,12,32,新百王,2024-08-02,6210
2023,燁輝,30,0,30,新百王,2024-08-02,6210
1444,力麗,90,60,30,新百王,2024-08-02,6210
8926,台汽電,30,0,30,新百王,2024-08-02,6210
00940,元大台灣價值高息,30,0,30,新百王,2024-08-02,6210
6658,聯策,38,10,28,新百王,2024-08-02,6210
1101,台泥,35,8,27,新百王,2024-08-02,6210
2382,廣達,82,55,27,新百王,2024-08-02,6210
00753L,中信中國50正2,26,0,26,新百王,2024-08-02,6210
00715L,期街口布蘭特正2,939,3,936,新百王,2024-08-05,6210
1314,中石化,718,4,714,新百王,2024-08-05,6210
00929,復華台灣科技優息,734,197,537,新百王,2024-08-05,6210
0056,元大高股息,238,4,234,新百王,2024-08-05,6210
00680L,元大美債20正2,358,172,186,新百王,2024-08-05,6210
00923,群益台ESG低碳50,191,5,186,新百王,2024-08-05,6210
2607,榮運,124,0,124,新百王,2024-08-05,6210
2801,彰銀,123,0,123,新百王,2024-08-05,6210
00919,群益台灣精選高息,133,30,103,新百王,2024-08-05,6210
00936,台新永續高息中小,336,236,100,新百王,2024-08-05,6210
1101,台泥,103,13,90,新百王,2024-08-05,6210
00878,國泰永續高股息,162,72,90,新百王,2024-08-05,6210
2023,燁輝,80,0,80,新百王,2024-08-05,6210
2317,鴻海,151,71,80,新百王,2024-08-05,6210
2312,金寶,96,17,79,新百王,2024-08-05,6210
00688L,國泰20年美債正2,83,10,73,新百王,2024-08-05,6210
2887,台新金,69,0,69,新百王,2024-08-05,6210
00631L,元大台灣50正2,77,12,65,新百王,2024-08-05,6210
1701,中化,62,0,62,新百王,2024-08-05,6210
006208,富邦台50,73,11,62,新百王,2024-08-05,6210
2408,南亞科,64,3,61,新百王,2024-08-05,6210
4510,高鋒,323,264,59,新百王,2024-08-05,6210
4167,松瑞藥,60,4,56,新百王,2024-08-05,6210
00795B,中信美國公債20年,56,3,53,新百王,2024-08-05,6210
5880,合庫金,61,10,51,新百王,2024-08-05,6210
3014,聯陽,53,2,51,新百王,2024-08-05,6210
00942B,台新美A公司債20+,50,0,50,新百王,2024-08-05,6210
1305,華夏,50,0,50,新百王,2024-08-05,6210
2836,高雄銀,50,0,50,新百王,2024-08-05,6210
2701,萬企,45,0,45,新百王,2024-08-05,6210
1217,愛之味,72,27,45,新百王,2024-08-05,6210
6101,寬魚國際,45,0,45,新百王,2024-08-05,6210
3264,欣銓,50,5,45,新百王,2024-08-05,6210
2534,宏盛,45,2,43,新百王,2024-08-05,6210
9908,大台北,55,13,42,新百王,2024-08-05,6210
2409,友達,48,7,41,新百王,2024-08-05,6210
3596,智易,40,0,40,新百王,2024-08-05,6210
3413,京鼎,38,0,38,新百王,2024-08-05,6210
3703,欣陸,44,6,38,新百王,2024-08-05,6210
5871,中租-KY,37,0,37,新百王,2024-08-05,6210
2888,新光金,80,43,37,新百王,2024-08-05,6210
2867,三商壽,37,0,37,新百王,2024-08-05,6210
8086,宏捷科,36,0,36,新百王,2024-08-05,6210
2890,永豐金,73,37,36,新百王,2024-08-05,6210
2303,聯電,78,43,35,新百王,2024-08-05,6210
2883,凱基金,240,205,35,新百王,2024-08-05,6210
1785,光洋科,37,5,32,新百王,2024-08-05,6210
1909,榮成,52,20,32,新百王,2024-08-05,6210
4939,亞電,30,0,30,新百王,2024-08-05,6210
1312,國喬,35,6,29,新百王,2024-08-05,6210
00632R,元大台灣50反1,2176,517,1659,新百王,2024-08-06,6210
2888,新光金,565,45,520,新百王,2024-08-06,6210
00945B,凱基美國非投等債,120,0,120,新百王,2024-08-06,6210
3078,僑威,120,2,118,新百王,2024-08-06,6210
1314,中石化,111,13,98,新百王,2024-08-06,6210
00878,國泰永續高股息,145,56,89,新百王,2024-08-06,6210
00637L,元大滬深300正2,106,26,80,新百王,2024-08-06,6210
00929,復華台灣科技優息,146,72,74,新百王,2024-08-06,6210
2547,日勝生,72,22,50,新百王,2024-08-06,6210
00881,國泰台灣5G+,57,11,46,新百王,2024-08-06,6210
3481,群創,45,0,45,新百王,2024-08-06,6210
2812,台中銀,87,46,41,新百王,2024-08-06,6210
1447,力鵬,36,0,36,新百王,2024-08-06,6210
2208,台船,40,5,35,新百王,2024-08-06,6210
00937B,群益ESG投等債20,65,31,34,新百王,2024-08-06,6210
0056,元大高股息,39,5,34,新百王,2024-08-06,6210
00918,大華優利高填息30,66,33,33,新百王,2024-08-06,6210
4510,高鋒,427,395,32,新百王,2024-08-06,6210
1309,台達化,30,0,30,新百王,2024-08-06,6210
8383,千附,30,0,30,新百王,2024-08-06,6210
5905,南仁湖,42,12,30,新百王,2024-08-06,6210
2323,中環,29,0,29,新百王,2024-08-06,6210
00940,元大台灣價值高息,48,19,29,新百王,2024-08-06,6210
2801,彰銀,44,16,28,新百王,2024-08-06,6210
00665L,富邦�琤肭磪囓�2,28,0,28,新百王,2024-08-06,6210
2542,興富發,26,0,26,新百王,2024-08-06,6210
3537,堡達,26,0,26,新百王,2024-08-06,6210
00670L,富邦NASDAQ正2,31,5,26,新百王,2024-08-06,6210
6005,群益證,24,0,24,新百王,2024-08-06,6210
3535,晶彩科,43,19,24,新百王,2024-08-06,6210
5871,中租-KY,28,5,23,新百王,2024-08-06,6210
8213,志超,23,0,23,新百王,2024-08-06,6210
2104,國際中橡,41,20,21,新百王,2024-08-06,6210
2607,榮運,23,2,21,新百王,2024-08-06,6210
0050,元大台灣50,37,17,20,新百王,2024-08-06,6210
4903,聯光通,23,3,20,新百王,2024-08-06,6210
3006,晶豪科,63,43,20,新百王,2024-08-06,6210
2489,瑞軒,23,3,20,新百王,2024-08-06,6210
3025,星通,23,3,20,新百王,2024-08-06,6210
1909,榮成,35,15,20,新百王,2024-08-06,6210
2867,三商壽,20,0,20,新百王,2024-08-06,6210
00640L,富邦日本正2,20,0,20,新百王,2024-08-06,6210
6257,矽格,20,0,20,新百王,2024-08-06,6210
3380,明泰,20,0,20,新百王,2024-08-06,6210
2317,鴻海,147,128,19,新百王,2024-08-06,6210
3022,威強電,19,0,19,新百王,2024-08-06,6210
2834,臺企銀,107,88,19,新百王,2024-08-06,6210
1540,喬福,216,197,19,新百王,2024-08-06,6210
00753L,中信中國50正2,37,20,17,新百王,2024-08-06,6210
1569,濱川,18,1,17,新百王,2024-08-06,6210
00715L,期街口布蘭特正2,548,2,546,新百王,2024-08-07,6210
00679B,元大美債20年,234,22,212,新百王,2024-08-07,6210
00933B,國泰10Y+金融債,201,0,201,新百王,2024-08-07,6210
00937B,群益ESG投等債20,167,0,167,新百王,2024-08-07,6210
00945B,凱基美國非投等債,164,0,164,新百王,2024-08-07,6210
00940,元大台灣價值高息,254,173,81,新百王,2024-08-07,6210
2867,三商壽,75,0,75,新百王,2024-08-07,6210
00923,群益台ESG低碳50,71,1,70,新百王,2024-08-07,6210
4720,德淵,70,0,70,新百王,2024-08-07,6210
1314,中石化,103,34,69,新百王,2024-08-07,6210
00676R,富邦臺灣加權反1,65,0,65,新百王,2024-08-07,6210
2337,旺宏,65,5,60,新百王,2024-08-07,6210
2888,新光金,98,41,57,新百王,2024-08-07,6210
6257,矽格,59,3,56,新百王,2024-08-07,6210
00688L,國泰20年美債正2,76,28,48,新百王,2024-08-07,6210
00712,復華富時不動產,128,87,41,新百王,2024-08-07,6210
00936,台新永續高息中小,43,7,36,新百王,2024-08-07,6210
2329,華泰,45,9,36,新百王,2024-08-07,6210
9105,泰金寶-DR,42,7,35,新百王,2024-08-07,6210
2408,南亞科,43,10,33,新百王,2024-08-07,6210
3105,穩懋,31,0,31,新百王,2024-08-07,6210
5386,青雲,37,7,30,新百王,2024-08-07,6210
00918,大華優利高填息30,28,0,28,新百王,2024-08-07,6210
00795B,中信美國公債20年,27,0,27,新百王,2024-08-07,6210
3537,堡達,26,6,20,新百王,2024-08-07,6210
3701,大眾控,20,0,20,新百王,2024-08-07,6210
2316,楠梓電,20,0,20,新百王,2024-08-07,6210
2886,兆豐金,18,0,18,新百王,2024-08-07,6210
3711,日月光投控,46,28,18,新百王,2024-08-07,6210
00864B,中信美國公債0-1,20,2,18,新百王,2024-08-07,6210
5443,均豪,42,24,18,新百王,2024-08-07,6210
6505,台塑化,17,1,16,新百王,2024-08-07,6210
2887,台新金,78,64,14,新百王,2024-08-07,6210
2489,瑞軒,15,1,14,新百王,2024-08-07,6210
00929,復華台灣科技優息,77,64,13,新百王,2024-08-07,6210
00687B,國泰20年美債,140,127,13,新百王,2024-08-07,6210
00947,台新臺灣IC設計,12,0,12,新百王,2024-08-07,6210
1434,福懋,12,0,12,新百王,2024-08-07,6210
6215,和椿,24,12,12,新百王,2024-08-07,6210
8299,群聯,12,0,12,新百王,2024-08-07,6210
1514,亞力,18,6,12,新百王,2024-08-07,6210
2363,矽統,25,14,11,新百王,2024-08-07,6210
9919,康那香,11,0,11,新百王,2024-08-07,6210
2406,國碩,11,0,11,新百王,2024-08-07,6210
00951,台新日本半導體,41,30,11,新百王,2024-08-07,6210
00949,復華日本龍頭,10,0,10,新百王,2024-08-07,6210
2388,威盛,11,1,10,新百王,2024-08-07,6210
2885,元大金,10,0,10,新百王,2024-08-07,6210
3006,晶豪科,13,3,10,新百王,2024-08-07,6210
9958,世紀鋼,10,0,10,新百王,2024-08-07,6210
00679B,元大美債20年,203,1,202,新百王,2024-08-08,6210
6603,富強鑫,236,52,184,新百王,2024-08-08,6210
00680L,元大美債20正2,187,20,167,新百王,2024-08-08,6210
00936,台新永續高息中小,153,23,130,新百王,2024-08-08,6210
00937B,群益ESG投等債20,120,0,120,新百王,2024-08-08,6210
2317,鴻海,207,88,119,新百王,2024-08-08,6210
1314,中石化,120,18,102,新百王,2024-08-08,6210
00919,群益台灣精選高息,85,2,83,新百王,2024-08-08,6210
3050,鈺德,70,0,70,新百王,2024-08-08,6210
00795B,中信美國公債20年,68,0,68,新百王,2024-08-08,6210
2489,瑞軒,78,11,67,新百王,2024-08-08,6210
2356,英業達,73,12,61,新百王,2024-08-08,6210
2886,兆豐金,70,10,60,新百王,2024-08-08,6210
4526,東台,60,1,59,新百王,2024-08-08,6210
00712,復華富時不動產,62,7,55,新百王,2024-08-08,6210
00929,復華台灣科技優息,71,18,53,新百王,2024-08-08,6210
00878,國泰永續高股息,57,5,52,新百王,2024-08-08,6210
6101,寬魚國際,50,0,50,新百王,2024-08-08,6210
3481,群創,107,59,48,新百王,2024-08-08,6210
00934,中信成長高股息,47,0,47,新百王,2024-08-08,6210
00753L,中信中國50正2,71,29,42,新百王,2024-08-08,6210
2618,長榮航,54,13,41,新百王,2024-08-08,6210
00933B,國泰10Y+金融債,148,112,36,新百王,2024-08-08,6210
4510,高鋒,168,133,35,新百王,2024-08-08,6210
6005,群益證,157,123,34,新百王,2024-08-08,6210
5443,均豪,40,9,31,新百王,2024-08-08,6210
2376,技嘉,33,3,30,新百王,2024-08-08,6210
3376,新日興,41,12,29,新百王,2024-08-08,6210
00665L,富邦�琤肭磪囓�2,808,780,28,新百王,2024-08-08,6210
006208,富邦台50,29,2,27,新百王,2024-08-08,6210
0056,元大高股息,59,32,27,新百王,2024-08-08,6210
4958,臻鼎-KY,39,14,25,新百王,2024-08-08,6210
2520,冠德,27,3,24,新百王,2024-08-08,6210
00923,群益台ESG低碳50,23,0,23,新百王,2024-08-08,6210
8354,冠好,23,0,23,新百王,2024-08-08,6210
2409,友達,31,9,22,新百王,2024-08-08,6210
00687B,國泰20年美債,21,0,21,新百王,2024-08-08,6210
2031,新光鋼,21,0,21,新百王,2024-08-08,6210
00940,元大台灣價值高息,29,9,20,新百王,2024-08-08,6210
9904,寶成,20,0,20,新百王,2024-08-08,6210
0050,元大台灣50,22,3,19,新百王,2024-08-08,6210
2236,百達-KY,42,23,19,新百王,2024-08-08,6210
2892,第一金,19,0,19,新百王,2024-08-08,6210
2615,萬海,25,7,18,新百王,2024-08-08,6210
2515,中工,18,0,18,新百王,2024-08-08,6210
1785,光洋科,21,4,17,新百王,2024-08-08,6210
00864B,中信美國公債0-1,16,0,16,新百王,2024-08-08,6210
1102,亞泥,16,0,16,新百王,2024-08-08,6210
00932,兆豐永續高息等權,15,0,15,新百王,2024-08-08,6210
4564,元翎,15,0,15,新百王,2024-08-08,6210
2002,中鋼,513,10,503,新百王,2024-08-09,6210
00795B,中信美國公債20年,228,0,228,新百王,2024-08-09,6210
00679B,元大美債20年,198,21,177,新百王,2024-08-09,6210
2337,旺宏,192,21,171,新百王,2024-08-09,6210
2834,臺企銀,168,2,166,新百王,2024-08-09,6210
00945B,凱基美國非投等債,140,0,140,新百王,2024-08-09,6210
1314,中石化,141,20,121,新百王,2024-08-09,6210
6005,群益證,188,76,112,新百王,2024-08-09,6210
4720,德淵,90,0,90,新百王,2024-08-09,6210
2515,中工,93,3,90,新百王,2024-08-09,6210
00937B,群益ESG投等債20,86,0,86,新百王,2024-08-09,6210
3006,晶豪科,86,5,81,新百王,2024-08-09,6210
6285,啟��,76,4,72,新百王,2024-08-09,6210
00680L,元大美債20正2,74,2,72,新百王,2024-08-09,6210
9105,泰金寶-DR,74,11,63,新百王,2024-08-09,6210
2887,台新金,186,130,56,新百王,2024-08-09,6210
00929,復華台灣科技優息,99,43,56,新百王,2024-08-09,6210
1709,和益,51,0,51,新百王,2024-08-09,6210
00927,群益半導體收益,45,1,44,新百王,2024-08-09,6210
2489,瑞軒,81,38,43,新百王,2024-08-09,6210
00687B,國泰20年美債,73,30,43,新百王,2024-08-09,6210
00878,國泰永續高股息,42,0,42,新百王,2024-08-09,6210
5014,建錩,42,0,42,新百王,2024-08-09,6210
6152,百一,40,0,40,新百王,2024-08-09,6210
006208,富邦台50,43,4,39,新百王,2024-08-09,6210
2609,陽明,80,41,39,新百王,2024-08-09,6210
00632R,元大台灣50反1,168,130,38,新百王,2024-08-09,6210
2897A,王道銀甲特,30,0,30,新百王,2024-08-09,6210
2615,萬海,96,67,29,新百王,2024-08-09,6210
00891,中信關鍵半導體,29,0,29,新百王,2024-08-09,6210
00936,台新永續高息中小,39,11,28,新百王,2024-08-09,6210
1714,和桐,25,0,25,新百王,2024-08-09,6210
4540,全球傳動,26,1,25,新百王,2024-08-09,6210
6625,必應,25,0,25,新百王,2024-08-09,6210
5531,鄉林,23,0,23,新百王,2024-08-09,6210
6643,M31,32,10,22,新百王,2024-08-09,6210
2498,宏達電,21,0,21,新百王,2024-08-09,6210
00637L,元大滬深300正2,43,23,20,新百王,2024-08-09,6210
1701,中化,20,0,20,新百王,2024-08-09,6210
912000,晨訊科-DR,20,0,20,新百王,2024-08-09,6210
00933B,國泰10Y+金融債,21,1,20,新百王,2024-08-09,6210
2353,宏��,42,25,17,新百王,2024-08-09,6210
00665L,富邦�琤肭磪囓�2,17,0,17,新百王,2024-08-09,6210
00951,台新日本半導體,57,40,17,新百王,2024-08-09,6210
2062,橋椿,36,19,17,新百王,2024-08-09,6210
6414,樺漢,17,0,17,新百王,2024-08-09,6210
6443,元晶,27,10,17,新百王,2024-08-09,6210
4961,天鈺,16,0,16,新百王,2024-08-09,6210
00751B,元大AAA至A公司債,16,0,16,新百王,2024-08-09,6210
5519,隆大,20,4,16,新百王,2024-08-09,6210
00632R,元大台灣50反1,1252,140,1112,新百王,2024-08-12,6210
02001R,富邦蘋果反一N,314,0,314,新百王,2024-08-12,6210
6603,富強鑫,262,4,258,新百王,2024-08-12,6210
00927,群益半導體收益,220,45,175,新百王,2024-08-12,6210
2881,富邦金,204,66,138,新百王,2024-08-12,6210
1101,台泥,124,0,124,新百王,2024-08-12,6210
00688L,國泰20年美債正2,211,102,109,新百王,2024-08-12,6210
00687B,國泰20年美債,113,10,103,新百王,2024-08-12,6210
1314,中石化,113,10,103,新百王,2024-08-12,6210
00680L,元大美債20正2,166,93,73,新百王,2024-08-12,6210
9105,泰金寶-DR,60,1,59,新百王,2024-08-12,6210
00919,群益台灣精選高息,63,8,55,新百王,2024-08-12,6210
00933B,國泰10Y+金融債,50,0,50,新百王,2024-08-12,6210
4540,全球傳動,54,6,48,新百王,2024-08-12,6210
3481,群創,235,188,47,新百王,2024-08-12,6210
2312,金寶,71,32,39,新百王,2024-08-12,6210
2618,長榮航,52,15,37,新百王,2024-08-12,6210
00948B,中信優息投資級債,35,0,35,新百王,2024-08-12,6210
00946,群益科技高息成長,32,0,32,新百王,2024-08-12,6210
8354,冠好,30,0,30,新百王,2024-08-12,6210
1609,大亞,57,29,28,新百王,2024-08-12,6210
2349,錸德,41,17,24,新百王,2024-08-12,6210
6425,易發,23,0,23,新百王,2024-08-12,6210
2885,元大金,33,10,23,新百王,2024-08-12,6210
2109,華豐,23,0,23,新百王,2024-08-12,6210
2892,第一金,22,0,22,新百王,2024-08-12,6210
2002,中鋼,23,2,21,新百王,2024-08-12,6210
2528,皇普,35,15,20,新百王,2024-08-12,6210
2371,大同,20,2,18,新百王,2024-08-12,6210
1532,勤美,21,3,18,新百王,2024-08-12,6210
2906,高林,18,0,18,新百王,2024-08-12,6210
3376,新日興,19,2,17,新百王,2024-08-12,6210
00720B,元大投資級公司債,17,0,17,新百王,2024-08-12,6210
1102,亞泥,16,0,16,新百王,2024-08-12,6210
2834,臺企銀,75,60,15,新百王,2024-08-12,6210
00772B,中信高評級公司債,15,0,15,新百王,2024-08-12,6210
4167,松瑞藥,25,10,15,新百王,2024-08-12,6210
00936,台新永續高息中小,20,6,14,新百王,2024-08-12,6210
1597,直得,72,59,13,新百王,2024-08-12,6210
3024,憶聲,13,1,12,新百王,2024-08-12,6210
4562,穎漢,46,34,12,新百王,2024-08-12,6210
00637L,元大滬深300正2,17,5,12,新百王,2024-08-12,6210
3581,博磊,17,6,11,新百王,2024-08-12,6210
3518,柏騰,24,13,11,新百王,2024-08-12,6210
00733,富邦臺灣中小,11,0,11,新百王,2024-08-12,6210
9934,成霖,11,0,11,新百王,2024-08-12,6210
00951,台新日本半導體,10,0,10,新百王,2024-08-12,6210
9907,統一實,10,0,10,新百王,2024-08-12,6210
1316,上曜,16,6,10,新百王,2024-08-12,6210
1806,冠軍,12,2,10,新百王,2024-08-12,6210
00632R,元大台灣50反1,646,301,345,新百王,2024-08-13,6210
2834,臺企銀,250,0,250,新百王,2024-08-13,6210
6603,富強鑫,211,28,183,新百王,2024-08-13,6210
00919,群益台灣精選高息,147,0,147,新百王,2024-08-13,6210
00929,復華台灣科技優息,106,1,105,新百王,2024-08-13,6210
1314,中石化,103,1,102,新百王,2024-08-13,6210
00679B,元大美債20年,194,110,84,新百王,2024-08-13,6210
2886,兆豐金,71,4,67,新百王,2024-08-13,6210
00687B,國泰20年美債,54,2,52,新百王,2024-08-13,6210
6005,群益證,51,0,51,新百王,2024-08-13,6210
2880,華南金,256,209,47,新百王,2024-08-13,6210
3044,健鼎,47,0,47,新百王,2024-08-13,6210
00795B,中信美國公債20年,43,1,42,新百王,2024-08-13,6210
2615,萬海,85,44,41,新百王,2024-08-13,6210
2836,高雄銀,33,0,33,新百王,2024-08-13,6210
2609,陽明,62,30,32,新百王,2024-08-13,6210
2892,第一金,38,7,31,新百王,2024-08-13,6210
1701,中化,30,0,30,新百王,2024-08-13,6210
00940,元大台灣價值高息,28,0,28,新百王,2024-08-13,6210
1410,南染,28,0,28,新百王,2024-08-13,6210
2002,中鋼,27,0,27,新百王,2024-08-13,6210
2359,所羅門,162,135,27,新百王,2024-08-13,6210
00948B,中信優息投資級債,26,0,26,新百王,2024-08-13,6210
2367,燿華,42,18,24,新百王,2024-08-13,6210
00637L,元大滬深300正2,32,10,22,新百王,2024-08-13,6210
4566,時碩工業,65,43,22,新百王,2024-08-13,6210
2887,台新金,201,180,21,新百王,2024-08-13,6210
2362,藍天,33,14,19,新百王,2024-08-13,6210
2501,國建,20,1,19,新百王,2024-08-13,6210
5014,建錩,18,0,18,新百王,2024-08-13,6210
2208,台船,28,10,18,新百王,2024-08-13,6210
00642U,期元大S＆P石油,27,10,17,新百王,2024-08-13,6210
5443,均豪,51,34,17,新百王,2024-08-13,6210
1513,中興電,26,10,16,新百王,2024-08-13,6210
3450,聯鈞,41,25,16,新百王,2024-08-13,6210
2610,華航,22,6,16,新百王,2024-08-13,6210
00946,群益科技高息成長,15,0,15,新百王,2024-08-13,6210
00680L,元大美債20正2,45,30,15,新百王,2024-08-13,6210
8071,能率網通,38,24,14,新百王,2024-08-13,6210
1301,台塑,13,0,13,新百王,2024-08-13,6210
1718,中纖,26,13,13,新百王,2024-08-13,6210
6244,茂迪,13,0,13,新百王,2024-08-13,6210
2891,中信金,43,31,12,新百王,2024-08-13,6210
00713,元大台灣高息低波,13,1,12,新百王,2024-08-13,6210
2701,萬企,12,0,12,新百王,2024-08-13,6210
00673R,期元大S＆P原油反1,12,0,12,新百王,2024-08-13,6210
2883,凱基金,114,103,11,新百王,2024-08-13,6210
00936,台新永續高息中小,40,30,10,新百王,2024-08-13,6210
2332,友訊,10,0,10,新百王,2024-08-13,6210
2498,宏達電,17,7,10,新百王,2024-08-13,6210
00632R,元大台灣50反1,628,200,428,新百王,2024-08-14,6210
2888,新光金,217,52,165,新百王,2024-08-14,6210
00637L,元大滬深300正2,132,15,117,新百王,2024-08-14,6210
00937B,群益ESG投等債20,616,499,117,新百王,2024-08-14,6210
00687B,國泰20年美債,141,30,111,新百王,2024-08-14,6210
00934,中信成長高股息,150,69,81,新百王,2024-08-14,6210
1101,台泥,93,19,74,新百王,2024-08-14,6210
00795B,中信美國公債20年,71,0,71,新百王,2024-08-14,6210
2365,昆盈,154,89,65,新百王,2024-08-14,6210
1701,中化,55,0,55,新百王,2024-08-14,6210
3044,健鼎,74,20,54,新百王,2024-08-14,6210
00935,野村臺灣新科技50,50,5,45,新百王,2024-08-14,6210
8096,擎亞,97,53,44,新百王,2024-08-14,6210
2349,錸德,44,9,35,新百王,2024-08-14,6210
3062,建漢,39,7,32,新百王,2024-08-14,6210
2547,日勝生,30,0,30,新百王,2024-08-14,6210
9945,潤泰新,47,18,29,新百王,2024-08-14,6210
00680L,元大美債20正2,138,110,28,新百王,2024-08-14,6210
2701,萬企,27,0,27,新百王,2024-08-14,6210
4958,臻鼎-KY,27,0,27,新百王,2024-08-14,6210
1314,中石化,25,0,25,新百王,2024-08-14,6210
2851,中再保,25,0,25,新百王,2024-08-14,6210
3481,群創,36,13,23,新百王,2024-08-14,6210
2609,陽明,23,2,21,新百王,2024-08-14,6210
1714,和桐,20,0,20,新百王,2024-08-14,6210
3052,夆典,20,0,20,新百王,2024-08-14,6210
6190,萬泰科,20,0,20,新百王,2024-08-14,6210
00881,國泰台灣5G+,20,0,20,新百王,2024-08-14,6210
00679B,元大美債20年,69,50,19,新百王,2024-08-14,6210
0056,元大高股息,27,9,18,新百王,2024-08-14,6210
2401,凌陽,19,1,18,新百王,2024-08-14,6210
1569,濱川,18,1,17,新百王,2024-08-14,6210
4533,協易機,19,3,16,新百王,2024-08-14,6210
5521,工信,16,0,16,新百王,2024-08-14,6210
00753L,中信中國50正2,26,10,16,新百王,2024-08-14,6210
8076,伍豐,18,2,16,新百王,2024-08-14,6210
5512,力麒,16,0,16,新百王,2024-08-14,6210
1702,南僑,16,0,16,新百王,2024-08-14,6210
2603,長榮,40,25,15,新百王,2024-08-14,6210
00857B,永豐20年美公債,15,0,15,新百王,2024-08-14,6210
00900,富邦特選高股息30,17,2,15,新百王,2024-08-14,6210
3357,臺慶科,15,0,15,新百王,2024-08-14,6210
2615,萬海,49,35,14,新百王,2024-08-14,6210
2352,佳世達,135,121,14,新百王,2024-08-14,6210
3188,鑫龍騰,22,10,12,新百王,2024-08-14,6210
2324,仁寶,17,5,12,新百王,2024-08-14,6210
2607,榮運,86,74,12,新百王,2024-08-14,6210
6414,樺漢,12,1,11,新百王,2024-08-14,6210
2236,百達-KY,13,2,11,新百王,2024-08-14,6210
2069,運錩,11,0,11,新百王,2024-08-14,6210
00688L,國泰20年美債正2,534,40,494,新百王,2024-08-15,6210
00687B,國泰20年美債,343,50,293,新百王,2024-08-15,6210
2834,臺企銀,314,26,288,新百王,2024-08-15,6210
2349,錸德,278,14,264,新百王,2024-08-15,6210
00715L,期街口布蘭特正2,265,3,262,新百王,2024-08-15,6210
1321,大洋,227,0,227,新百王,2024-08-15,6210
2887,台新金,173,1,172,新百王,2024-08-15,6210
2317,鴻海,200,37,163,新百王,2024-08-15,6210
00680L,元大美債20正2,267,113,154,新百王,2024-08-15,6210
2886,兆豐金,151,0,151,新百王,2024-08-15,6210
1314,中石化,122,10,112,新百王,2024-08-15,6210
00795B,中信美國公債20年,197,90,107,新百王,2024-08-15,6210
2542,興富發,114,14,100,新百王,2024-08-15,6210
6603,富強鑫,90,11,79,新百王,2024-08-15,6210
00632R,元大台灣50反1,75,1,74,新百王,2024-08-15,6210
1101,台泥,90,16,74,新百王,2024-08-15,6210
1702,南僑,75,2,73,新百王,2024-08-15,6210
2607,榮運,70,0,70,新百王,2024-08-15,6210
00753L,中信中國50正2,75,9,66,新百王,2024-08-15,6210
00891,中信關鍵半導體,74,16,58,新百王,2024-08-15,6210
2867,三商壽,77,20,57,新百王,2024-08-15,6210
2884,玉山金,53,0,53,新百王,2024-08-15,6210
00878,國泰永續高股息,57,11,46,新百王,2024-08-15,6210
1301,台塑,45,8,37,新百王,2024-08-15,6210
00946,群益科技高息成長,36,0,36,新百王,2024-08-15,6210
4716,大立,36,0,36,新百王,2024-08-15,6210
3691,碩禾,35,0,35,新百王,2024-08-15,6210
2327,國巨,35,2,33,新百王,2024-08-15,6210
3019,亞光,133,100,33,新百王,2024-08-15,6210
3167,大量,40,7,33,新百王,2024-08-15,6210
00900,富邦特選高股息30,29,0,29,新百王,2024-08-15,6210
2489,瑞軒,60,31,29,新百王,2024-08-15,6210
2545,皇翔,88,60,28,新百王,2024-08-15,6210
8234,新漢,24,0,24,新百王,2024-08-15,6210
2851,中再保,24,0,24,新百王,2024-08-15,6210
2897,王道銀行,73,50,23,新百王,2024-08-15,6210
2515,中工,22,0,22,新百王,2024-08-15,6210
00864B,中信美國公債0-1,21,0,21,新百王,2024-08-15,6210
5386,青雲,26,5,21,新百王,2024-08-15,6210
1717,長興,20,0,20,新百王,2024-08-15,6210
2332,友訊,20,0,20,新百王,2024-08-15,6210
5498,凱崴,20,0,20,新百王,2024-08-15,6210
00650L,復華香港正2,35,15,20,新百王,2024-08-15,6210
6270,倍微,20,0,20,新百王,2024-08-15,6210
2606,裕民,20,0,20,新百王,2024-08-15,6210
1325,恆大,20,0,20,新百王,2024-08-15,6210
3663,鑫科,84,66,18,新百王,2024-08-15,6210
1303,南亞,17,0,17,新百王,2024-08-15,6210
2376,技嘉,30,13,17,新百王,2024-08-15,6210
6005,群益證,18,1,17,新百王,2024-08-15,6210
2002,中鋼,540,14,526,新百王,2024-08-16,6210
00687B,國泰20年美債,519,10,509,新百王,2024-08-16,6210
00632R,元大台灣50反1,913,420,493,新百王,2024-08-16,6210
2349,錸德,400,3,397,新百王,2024-08-16,6210
8028,昇陽半導體,425,32,393,新百王,2024-08-16,6210
00680L,元大美債20正2,442,150,292,新百王,2024-08-16,6210
00945B,凱基美國非投等債,230,0,230,新百王,2024-08-16,6210
3712,永崴投控,280,55,225,新百王,2024-08-16,6210
1522,堤維西,189,0,189,新百王,2024-08-16,6210
2323,中環,150,11,139,新百王,2024-08-16,6210
00919,群益台灣精選高息,134,2,132,新百王,2024-08-16,6210
1718,中纖,120,0,120,新百王,2024-08-16,6210
00934,中信成長高股息,114,0,114,新百王,2024-08-16,6210
00676R,富邦臺灣加權反1,110,0,110,新百王,2024-08-16,6210
00936,台新永續高息中小,100,0,100,新百王,2024-08-16,6210
00918,大華優利高填息30,103,7,96,新百王,2024-08-16,6210
2062,橋椿,156,67,89,新百王,2024-08-16,6210
1314,中石化,84,0,84,新百王,2024-08-16,6210
00927,群益半導體收益,157,77,80,新百王,2024-08-16,6210
00935,野村臺灣新科技50,70,5,65,新百王,2024-08-16,6210
9105,泰金寶-DR,60,0,60,新百王,2024-08-16,6210
1611,中電,58,17,41,新百王,2024-08-16,6210
2607,榮運,36,3,33,新百王,2024-08-16,6210
8027,鈦昇,33,3,30,新百王,2024-08-16,6210
3062,建漢,82,52,30,新百王,2024-08-16,6210
8110,華東,30,0,30,新百王,2024-08-16,6210
3078,僑威,30,0,30,新百王,2024-08-16,6210
00795B,中信美國公債20年,29,4,25,新百王,2024-08-16,6210
1702,南僑,25,1,24,新百王,2024-08-16,6210
00929,復華台灣科技優息,49,27,22,新百王,2024-08-16,6210
2301,光寶科,27,5,22,新百王,2024-08-16,6210
2363,矽統,60,39,21,新百王,2024-08-16,6210
8096,擎亞,153,133,20,新百王,2024-08-16,6210
8354,冠好,20,0,20,新百王,2024-08-16,6210
2324,仁寶,24,4,20,新百王,2024-08-16,6210
2374,佳能,27,7,20,新百王,2024-08-16,6210
2618,長榮航,24,4,20,新百王,2024-08-16,6210
9103,美德醫療-DR,30,10,20,新百王,2024-08-16,6210
2637,慧洋-KY,21,4,17,新百王,2024-08-16,6210
2603,長榮,34,19,15,新百王,2024-08-16,6210
8043,蜜望實,36,21,15,新百王,2024-08-16,6210
00710B,復華彭博非投等債,15,0,15,新百王,2024-08-16,6210
6244,茂迪,15,0,15,新百王,2024-08-16,6210
8927,北基,15,0,15,新百王,2024-08-16,6210
00631L,元大台灣50正2,25,12,13,新百王,2024-08-16,6210
6505,台塑化,15,4,11,新百王,2024-08-16,6210
3607,谷崧,11,0,11,新百王,2024-08-16,6210
6219,富旺,10,0,10,新百王,2024-08-16,6210
2472,立隆電,10,0,10,新百王,2024-08-16,6210
1714,和桐,15,5,10,新百王,2024-08-16,6210
00632R,元大台灣50反1,626,200,426,新百王,2024-08-19,6210
00937B,群益ESG投等債20,334,10,324,新百王,2024-08-19,6210
3535,晶彩科,307,12,295,新百王,2024-08-19,6210
1314,中石化,218,10,208,新百王,2024-08-19,6210
00687B,國泰20年美債,198,31,167,新百王,2024-08-19,6210
2886,兆豐金,130,0,130,新百王,2024-08-19,6210
00706L,期元大S＆P日圓正2,120,0,120,新百王,2024-08-19,6210
00715L,期街口布蘭特正2,107,4,103,新百王,2024-08-19,6210
00941,中信上游半導體,83,0,83,新百王,2024-08-19,6210
5392,能率,122,42,80,新百王,2024-08-19,6210
00945B,凱基美國非投等債,80,0,80,新百王,2024-08-19,6210
1611,中電,158,79,79,新百王,2024-08-19,6210
8028,昇陽半導體,155,76,79,新百王,2024-08-19,6210
00679B,元大美債20年,80,5,75,新百王,2024-08-19,6210
3047,訊舟,186,136,50,新百王,2024-08-19,6210
6274,台燿,50,1,49,新百王,2024-08-19,6210
1321,大洋,43,0,43,新百王,2024-08-19,6210
5452,佶優,51,15,36,新百王,2024-08-19,6210
4526,東台,47,11,36,新百王,2024-08-19,6210
2323,中環,35,3,32,新百王,2024-08-19,6210
1806,冠軍,31,0,31,新百王,2024-08-19,6210
8071,能率網通,37,8,29,新百王,2024-08-19,6210
3528,安馳,31,2,29,新百王,2024-08-19,6210
3625,西勝,26,0,26,新百王,2024-08-19,6210
1785,光洋科,43,18,25,新百王,2024-08-19,6210
6269,台郡,27,2,25,新百王,2024-08-19,6210
00907,永豐優息存股,23,0,23,新百王,2024-08-19,6210
3518,柏騰,39,16,23,新百王,2024-08-19,6210
3522,御嵿,23,1,22,新百王,2024-08-19,6210
2884,玉山金,20,1,19,新百王,2024-08-19,6210
9945,潤泰新,19,0,19,新百王,2024-08-19,6210
3105,穩懋,17,0,17,新百王,2024-08-19,6210
2887,台新金,61,45,16,新百王,2024-08-19,6210
2464,盟立,60,44,16,新百王,2024-08-19,6210
00864B,中信美國公債0-1,15,0,15,新百王,2024-08-19,6210
2365,昆盈,83,68,15,新百王,2024-08-19,6210
00795B,中信美國公債20年,18,5,13,新百王,2024-08-19,6210
8374,羅昇,40,27,13,新百王,2024-08-19,6210
2867,三商壽,25,12,13,新百王,2024-08-19,6210
6877,鏵友益,29,16,13,新百王,2024-08-19,6210
1609,大亞,27,15,12,新百王,2024-08-19,6210
8096,擎亞,61,49,12,新百王,2024-08-19,6210
5534,長虹,11,0,11,新百王,2024-08-19,6210
00931B,統一美債20年,11,0,11,新百王,2024-08-19,6210
1702,南僑,11,0,11,新百王,2024-08-19,6210
4967,十銓,15,4,11,新百王,2024-08-19,6210
9904,寶成,11,0,11,新百王,2024-08-19,6210
1101,台泥,11,0,11,新百王,2024-08-19,6210
00929,復華台灣科技優息,50,40,10,新百王,2024-08-19,6210
4306,炎洲,10,0,10,新百王,2024-08-19,6210
00919,群益台灣精選高息,471,202,269,新百王,2024-08-20,6210
2834,臺企銀,216,15,201,新百王,2024-08-20,6210
2317,鴻海,363,212,151,新百王,2024-08-20,6210
2062,橋椿,148,18,130,新百王,2024-08-20,6210
5521,工信,144,15,129,新百王,2024-08-20,6210
8028,昇陽半導體,196,79,117,新百王,2024-08-20,6210
1314,中石化,98,0,98,新百王,2024-08-20,6210
00795B,中信美國公債20年,89,0,89,新百王,2024-08-20,6210
00882,中信中國高股息,83,0,83,新百王,2024-08-20,6210
3050,鈺德,122,42,80,新百王,2024-08-20,6210
00929,復華台灣科技優息,111,41,70,新百王,2024-08-20,6210
3450,聯鈞,74,18,56,新百王,2024-08-20,6210
00923,群益台ESG低碳50,50,0,50,新百王,2024-08-20,6210
3686,達能,48,0,48,新百王,2024-08-20,6210
00637L,元大滬深300正2,55,10,45,新百王,2024-08-20,6210
2362,藍天,46,2,44,新百王,2024-08-20,6210
2392,正崴,49,6,43,新百王,2024-08-20,6210
2344,華邦電,56,15,41,新百王,2024-08-20,6210
00753L,中信中國50正2,43,4,39,新百王,2024-08-20,6210
1737,臺鹽,40,2,38,新百王,2024-08-20,6210
6177,達麗,47,12,35,新百王,2024-08-20,6210
1708,東鹼,36,4,32,新百王,2024-08-20,6210
2401,凌陽,43,12,31,新百王,2024-08-20,6210
1321,大洋,28,0,28,新百王,2024-08-20,6210
2609,陽明,30,3,27,新百王,2024-08-20,6210
2836,高雄銀,24,0,24,新百王,2024-08-20,6210
6625,必應,24,0,24,新百王,2024-08-20,6210
2888,新光金,505,482,23,新百王,2024-08-20,6210
2464,盟立,35,13,22,新百王,2024-08-20,6210
3312,弘憶股,47,26,21,新百王,2024-08-20,6210
1307,三芳,20,0,20,新百王,2024-08-20,6210
2892,第一金,30,10,20,新百王,2024-08-20,6210
00715L,期街口布蘭特正2,165,145,20,新百王,2024-08-20,6210
00642U,期元大S＆P石油,19,0,19,新百王,2024-08-20,6210
5519,隆大,19,0,19,新百王,2024-08-20,6210
2352,佳世達,16,0,16,新百王,2024-08-20,6210
4967,十銓,33,17,16,新百王,2024-08-20,6210
00665L,富邦�琤肭磪囓�2,20,5,15,新百王,2024-08-20,6210
6570,維田,15,0,15,新百王,2024-08-20,6210
00650L,復華香港正2,25,10,15,新百王,2024-08-20,6210
00720B,元大投資級公司債,15,0,15,新百王,2024-08-20,6210
2356,英業達,78,64,14,新百王,2024-08-20,6210
1513,中興電,18,4,14,新百王,2024-08-20,6210
1326,台化,14,0,14,新百王,2024-08-20,6210
2405,輔信,23,9,14,新百王,2024-08-20,6210
3528,安馳,13,0,13,新百王,2024-08-20,6210
6706,惠特,23,11,12,新百王,2024-08-20,6210
00864B,中信美國公債0-1,12,0,12,新百王,2024-08-20,6210
1584,精剛,65,53,12,新百王,2024-08-20,6210
1416,廣豐,12,0,12,新百王,2024-08-20,6210
00706L,期元大S＆P日圓正2,267,0,267,新百王,2024-08-21,6210
00946,群益科技高息成長,195,0,195,新百王,2024-08-21,6210
3050,鈺德,152,31,121,新百王,2024-08-21,6210
2542,興富發,119,10,109,新百王,2024-08-21,6210
2888,新光金,695,586,109,新百王,2024-08-21,6210
00891,中信關鍵半導體,101,4,97,新百王,2024-08-21,6210
2891,中信金,137,41,96,新百王,2024-08-21,6210
00937B,群益ESG投等債20,100,14,86,新百王,2024-08-21,6210
00679B,元大美債20年,71,10,61,新百王,2024-08-21,6210
00945B,凱基美國非投等債,56,0,56,新百王,2024-08-21,6210
1522,堤維西,203,148,55,新百王,2024-08-21,6210
1314,中石化,50,0,50,新百王,2024-08-21,6210
00753L,中信中國50正2,50,4,46,新百王,2024-08-21,6210
00715L,期街口布蘭特正2,94,50,44,新百王,2024-08-21,6210
2376,技嘉,81,39,42,新百王,2024-08-21,6210
2353,宏��,51,11,40,新百王,2024-08-21,6210
2371,大同,37,2,35,新百王,2024-08-21,6210
2330,台積電,41,7,34,新百王,2024-08-21,6210
8096,擎亞,67,34,33,新百王,2024-08-21,6210
5011,久陽,31,0,31,新百王,2024-08-21,6210
3032,偉訓,46,16,30,新百王,2024-08-21,6210
00650L,復華香港正2,30,0,30,新百王,2024-08-21,6210
8064,東捷,53,24,29,新百王,2024-08-21,6210
00935,野村臺灣新科技50,28,0,28,新百王,2024-08-21,6210
00929,復華台灣科技優息,43,18,25,新百王,2024-08-21,6210
00934,中信成長高股息,28,6,22,新百王,2024-08-21,6210
2317,鴻海,103,82,21,新百王,2024-08-21,6210
2618,長榮航,34,14,20,新百王,2024-08-21,6210
1530,亞崴,20,0,20,新百王,2024-08-21,6210
6869,雲豹能源,34,15,19,新百王,2024-08-21,6210
6163,華電網,18,0,18,新百王,2024-08-21,6210
2892,第一金,17,0,17,新百王,2024-08-21,6210
2883,凱基金,16,0,16,新百王,2024-08-21,6210
9105,泰金寶-DR,68,52,16,新百王,2024-08-21,6210
00953B,群益優選非投等債,20,5,15,新百王,2024-08-21,6210
6548,長科*,15,0,15,新百王,2024-08-21,6210
2109,華豐,14,0,14,新百王,2024-08-21,6210
00688L,國泰20年美債正2,137,123,14,新百王,2024-08-21,6210
3443,創意,13,1,12,新百王,2024-08-21,6210
3036,文曄,12,0,12,新百王,2024-08-21,6210
00687B,國泰20年美債,43,31,12,新百王,2024-08-21,6210
4513,福裕,18,7,11,新百王,2024-08-21,6210
2880,華南金,11,0,11,新百王,2024-08-21,6210
00712,復華富時不動產,10,0,10,新百王,2024-08-21,6210
1307,三芳,10,0,10,新百王,2024-08-21,6210
2201,裕隆,10,0,10,新百王,2024-08-21,6210
00905,FT臺灣Smart,10,0,10,新百王,2024-08-21,6210
1702,南僑,24,14,10,新百王,2024-08-21,6210
3234,光環,10,0,10,新百王,2024-08-21,6210
6016,康和證,10,0,10,新百王,2024-08-21,6210
2349,錸德,478,182,296,新百王,2024-08-22,6210
2890,永豐金,282,0,282,新百王,2024-08-22,6210
1522,堤維西,180,14,166,新百王,2024-08-22,6210
00715L,期街口布蘭特正2,129,0,129,新百王,2024-08-22,6210
2891,中信金,117,16,101,新百王,2024-08-22,6210
2834,臺企銀,98,1,97,新百王,2024-08-22,6210
00688L,國泰20年美債正2,101,5,96,新百王,2024-08-22,6210
00953B,群益優選非投等債,92,0,92,新百王,2024-08-22,6210
00937B,群益ESG投等債20,92,5,87,新百王,2024-08-22,6210
2317,鴻海,261,185,76,新百王,2024-08-22,6210
00650L,復華香港正2,90,20,70,新百王,2024-08-22,6210
2062,橋椿,103,42,61,新百王,2024-08-22,6210
1314,中石化,105,44,61,新百王,2024-08-22,6210
8033,雷虎,55,1,54,新百王,2024-08-22,6210
4906,正文,49,2,47,新百王,2024-08-22,6210
00683L,期元大美元指正2,46,0,46,新百王,2024-08-22,6210
00929,復華台灣科技優息,56,13,43,新百王,2024-08-22,6210
1785,光洋科,57,14,43,新百王,2024-08-22,6210
8039,台虹,41,2,39,新百王,2024-08-22,6210
00680L,元大美債20正2,43,5,38,新百王,2024-08-22,6210
8089,康全電訊,59,21,38,新百王,2024-08-22,6210
2897,王道銀行,46,10,36,新百王,2024-08-22,6210
00642U,期元大S＆P石油,32,0,32,新百王,2024-08-22,6210
5443,均豪,77,46,31,新百王,2024-08-22,6210
6133,金橋,33,4,29,新百王,2024-08-22,6210
00919,群益台灣精選高息,34,6,28,新百王,2024-08-22,6210
5521,工信,25,0,25,新百王,2024-08-22,6210
00918,大華優利高填息30,60,36,24,新百王,2024-08-22,6210
6215,和椿,41,17,24,新百王,2024-08-22,6210
1721,三晃,37,16,21,新百王,2024-08-22,6210
2528,皇普,21,0,21,新百王,2024-08-22,6210
2382,廣達,26,6,20,新百王,2024-08-22,6210
8927,北基,19,1,18,新百王,2024-08-22,6210
5371,中光電,28,11,17,新百王,2024-08-22,6210
6220,岳豐,17,0,17,新百王,2024-08-22,6210
00907,永豐優息存股,16,0,16,新百王,2024-08-22,6210
2881,富邦金,15,0,15,新百王,2024-08-22,6210
1709,和益,21,6,15,新百王,2024-08-22,6210
3047,訊舟,61,46,15,新百王,2024-08-22,6210
2243,宏旭-KY,25,10,15,新百王,2024-08-22,6210
6208,日揚,15,0,15,新百王,2024-08-22,6210
3019,亞光,92,78,14,新百王,2024-08-22,6210
6177,達麗,19,6,13,新百王,2024-08-22,6210
3528,安馳,18,5,13,新百王,2024-08-22,6210
5905,南仁湖,84,71,13,新百王,2024-08-22,6210
2421,建準,13,1,12,新百王,2024-08-22,6210
3032,偉訓,12,0,12,新百王,2024-08-22,6210
00934,中信成長高股息,12,0,12,新百王,2024-08-22,6210
2303,聯電,47,35,12,新百王,2024-08-22,6210
1713,國化,16,4,12,新百王,2024-08-22,6210
00688L,國泰20年美債正2,414,0,414,新百王,2024-08-23,6210
1314,中石化,419,185,234,新百王,2024-08-23,6210
2888,新光金,556,446,110,新百王,2024-08-23,6210
00680L,元大美債20正2,115,9,106,新百王,2024-08-23,6210
2030,彰源,100,0,100,新百王,2024-08-23,6210
00665L,富邦�琤肭磪囓�2,94,0,94,新百王,2024-08-23,6210
00706L,期元大S＆P日圓正2,79,0,79,新百王,2024-08-23,6210
2887,台新金,100,24,76,新百王,2024-08-23,6210
00936,台新永續高息中小,73,0,73,新百王,2024-08-23,6210
00948B,中信優息投資級債,70,0,70,新百王,2024-08-23,6210
00687B,國泰20年美債,53,0,53,新百王,2024-08-23,6210
2362,藍天,47,0,47,新百王,2024-08-23,6210
00918,大華優利高填息30,46,0,46,新百王,2024-08-23,6210
00951,台新日本半導體,46,1,45,新百王,2024-08-23,6210
00919,群益台灣精選高息,74,29,45,新百王,2024-08-23,6210
1570,力肯,49,7,42,新百王,2024-08-23,6210
1321,大洋,40,0,40,新百王,2024-08-23,6210
00751B,元大AAA至A公司債,50,10,40,新百王,2024-08-23,6210
00927,群益半導體收益,47,14,33,新百王,2024-08-23,6210
00673R,期元大S＆P原油反1,30,0,30,新百王,2024-08-23,6210
8064,東捷,117,87,30,新百王,2024-08-23,6210
00795B,中信美國公債20年,27,1,26,新百王,2024-08-23,6210
8089,康全電訊,29,3,26,新百王,2024-08-23,6210
00953B,群益優選非投等債,23,0,23,新百王,2024-08-23,6210
2062,橋椿,39,18,21,新百王,2024-08-23,6210
2891,中信金,40,19,21,新百王,2024-08-23,6210
00946,群益科技高息成長,19,0,19,新百王,2024-08-23,6210
3663,鑫科,59,40,19,新百王,2024-08-23,6210
1309,台達化,25,7,18,新百王,2024-08-23,6210
2208,台船,49,32,17,新百王,2024-08-23,6210
8213,志超,15,0,15,新百王,2024-08-23,6210
00937B,群益ESG投等債20,31,17,14,新百王,2024-08-23,6210
1806,冠軍,14,0,14,新百王,2024-08-23,6210
2542,興富發,14,0,14,新百王,2024-08-23,6210
006208,富邦台50,15,2,13,新百王,2024-08-23,6210
3047,訊舟,28,15,13,新百王,2024-08-23,6210
3715,定穎投控,18,5,13,新百王,2024-08-23,6210
1709,和益,12,0,12,新百王,2024-08-23,6210
3006,晶豪科,22,11,11,新百王,2024-08-23,6210
2892,第一金,11,0,11,新百王,2024-08-23,6210
4303,信立,22,11,11,新百王,2024-08-23,6210
3019,亞光,68,57,11,新百王,2024-08-23,6210
1721,三晃,50,39,11,新百王,2024-08-23,6210
00905,FT臺灣Smart,10,0,10,新百王,2024-08-23,6210
00893,國泰智能電動車,10,0,10,新百王,2024-08-23,6210
4113,聯上,10,0,10,新百王,2024-08-23,6210
2867,三商壽,25,15,10,新百王,2024-08-23,6210
1445,大宇,10,0,10,新百王,2024-08-23,6210
00954,中信日本半導體,10,0,10,新百王,2024-08-23,6210
9946,三發地產,10,0,10,新百王,2024-08-23,6210
2888,新光金,1254,665,589,新百王,2024-08-26,6210
2349,錸德,420,36,384,新百王,2024-08-26,6210
1314,中石化,247,87,160,新百王,2024-08-26,6210
00679B,元大美債20年,150,0,150,新百王,2024-08-26,6210
8064,東捷,202,82,120,新百王,2024-08-26,6210
2409,友達,228,115,113,新百王,2024-08-26,6210
2890,永豐金,112,9,103,新百王,2024-08-26,6210
00676R,富邦臺灣加權反1,100,0,100,新百王,2024-08-26,6210
6208,日揚,102,4,98,新百王,2024-08-26,6210
00948B,中信優息投資級債,75,0,75,新百王,2024-08-26,6210
00680L,元大美債20正2,83,10,73,新百王,2024-08-26,6210
4526,東台,116,57,59,新百王,2024-08-26,6210
00632R,元大台灣50反1,226,176,50,新百王,2024-08-26,6210
1810,和成,48,0,48,新百王,2024-08-26,6210
6133,金橋,40,4,36,新百王,2024-08-26,6210
00919,群益台灣精選高息,40,4,36,新百王,2024-08-26,6210
6116,彩晶,30,0,30,新百王,2024-08-26,6210
2312,金寶,35,5,30,新百王,2024-08-26,6210
1709,和益,30,1,29,新百王,2024-08-26,6210
8033,雷虎,35,7,28,新百王,2024-08-26,6210
3390,旭軟,27,2,25,新百王,2024-08-26,6210
2892,第一金,25,1,24,新百王,2024-08-26,6210
1711,永光,52,28,24,新百王,2024-08-26,6210
2851,中再保,23,0,23,新百王,2024-08-26,6210
4967,十銓,40,17,23,新百王,2024-08-26,6210
9955,佳龍,35,14,21,新百王,2024-08-26,6210
2429,銘旺科,21,0,21,新百王,2024-08-26,6210
2845,遠東銀,20,0,20,新百王,2024-08-26,6210
5481,新華,22,2,20,新百王,2024-08-26,6210
2889,國票金,20,0,20,新百王,2024-08-26,6210
6189,豐藝,20,0,20,新百王,2024-08-26,6210
3260,威剛,26,7,19,新百王,2024-08-26,6210
2891,中信金,35,17,18,新百王,2024-08-26,6210
1785,光洋科,35,19,16,新百王,2024-08-26,6210
00673R,期元大S＆P原油反1,16,0,16,新百王,2024-08-26,6210
00683L,期元大美元指正2,17,2,15,新百王,2024-08-26,6210
00940,元大台灣價值高息,35,20,15,新百王,2024-08-26,6210
2615,萬海,39,26,13,新百王,2024-08-26,6210
8021,尖點,26,13,13,新百王,2024-08-26,6210
9925,新保,12,0,12,新百王,2024-08-26,6210
9958,世紀鋼,26,14,12,新百王,2024-08-26,6210
5263,智崴,16,5,11,新百王,2024-08-26,6210
9945,潤泰新,13,2,11,新百王,2024-08-26,6210
1713,國化,11,0,11,新百王,2024-08-26,6210
3189,景碩,20,9,11,新百王,2024-08-26,6210
3518,柏騰,15,4,11,新百王,2024-08-26,6210
1445,大宇,11,0,11,新百王,2024-08-26,6210
6190,萬泰科,11,0,11,新百王,2024-08-26,6210
3356,奇偶,11,0,11,新百王,2024-08-26,6210
00712,復華富時不動產,11,0,11,新百王,2024-08-26,6210
00688L,國泰20年美債正2,277,1,276,新百王,2024-08-27,6210
2405,輔信,272,20,252,新百王,2024-08-27,6210
2834,臺企銀,218,18,200,新百王,2024-08-27,6210
2883,凱基金,413,300,113,新百王,2024-08-27,6210
00753L,中信中國50正2,117,4,113,新百王,2024-08-27,6210
00641R,富邦日本反1,90,0,90,新百王,2024-08-27,6210
2610,華航,111,37,74,新百王,2024-08-27,6210
4510,高鋒,191,121,70,新百王,2024-08-27,6210
2890,永豐金,149,82,67,新百王,2024-08-27,6210
00687B,國泰20年美債,56,0,56,新百王,2024-08-27,6210
00919,群益台灣精選高息,53,0,53,新百王,2024-08-27,6210
3481,群創,152,103,49,新百王,2024-08-27,6210
6015,宏遠證,49,0,49,新百王,2024-08-27,6210
4743,合一,45,0,45,新百王,2024-08-27,6210
2891,中信金,69,25,44,新百王,2024-08-27,6210
00937B,群益ESG投等債20,135,94,41,新百王,2024-08-27,6210
00680L,元大美債20正2,36,1,35,新百王,2024-08-27,6210
00918,大華優利高填息30,70,35,35,新百王,2024-08-27,6210
00948B,中信優息投資級債,35,1,34,新百王,2024-08-27,6210
1806,冠軍,34,0,34,新百王,2024-08-27,6210
0056,元大高股息,32,1,31,新百王,2024-08-27,6210
00936,台新永續高息中小,39,8,31,新百王,2024-08-27,6210
8033,雷虎,30,0,30,新百王,2024-08-27,6210
8027,鈦昇,46,20,26,新百王,2024-08-27,6210
1711,永光,113,87,26,新百王,2024-08-27,6210
2374,佳能,31,6,25,新百王,2024-08-27,6210
2330,台積電,29,5,24,新百王,2024-08-27,6210
2880,華南金,24,2,22,新百王,2024-08-27,6210
00632R,元大台灣50反1,243,221,22,新百王,2024-08-27,6210
6753,龍德造船,26,4,22,新百王,2024-08-27,6210
2887,台新金,112,90,22,新百王,2024-08-27,6210
8028,昇陽半導體,74,53,21,新百王,2024-08-27,6210
00673R,期元大S＆P原油反1,20,0,20,新百王,2024-08-27,6210
00665L,富邦�琤肭磪囓�2,30,10,20,新百王,2024-08-27,6210
2303,聯電,29,9,20,新百王,2024-08-27,6210
1727,中華化,25,9,16,新百王,2024-08-27,6210
1722,台肥,16,1,15,新百王,2024-08-27,6210
00953B,群益優選非投等債,15,0,15,新百王,2024-08-27,6210
2816,旺旺保,14,0,14,新百王,2024-08-27,6210
2337,旺宏,14,0,14,新百王,2024-08-27,6210
00670L,富邦NASDAQ正2,19,5,14,新百王,2024-08-27,6210
1457,宜進,12,0,12,新百王,2024-08-27,6210
2208,台船,20,8,12,新百王,2024-08-27,6210
1714,和桐,12,0,12,新百王,2024-08-27,6210
00751B,元大AAA至A公司債,12,0,12,新百王,2024-08-27,6210
3379,彬台,13,1,12,新百王,2024-08-27,6210
2344,華邦電,13,1,12,新百王,2024-08-27,6210
2609,陽明,12,1,11,新百王,2024-08-27,6210
2867,三商壽,15,4,11,新百王,2024-08-27,6210
2356,英業達,12,1,11,新百王,2024-08-27,6210
6603,富強鑫,563,41,522,新百王,2024-08-28,6210
2890,永豐金,327,18,309,新百王,2024-08-28,6210
1314,中石化,213,54,159,新百王,2024-08-28,6210
00688L,國泰20年美債正2,97,0,97,新百王,2024-08-28,6210
00637L,元大滬深300正2,91,11,80,新百王,2024-08-28,6210
00680L,元大美債20正2,120,45,75,新百王,2024-08-28,6210
00919,群益台灣精選高息,75,7,68,新百王,2024-08-28,6210
3265,台星科,67,3,64,新百王,2024-08-28,6210
00753L,中信中國50正2,68,7,61,新百王,2024-08-28,6210
1416,廣豐,60,0,60,新百王,2024-08-28,6210
2888,新光金,361,308,53,新百王,2024-08-28,6210
4958,臻鼎-KY,51,0,51,新百王,2024-08-28,6210
1806,冠軍,55,4,51,新百王,2024-08-28,6210
00937B,群益ESG投等債20,52,1,51,新百王,2024-08-28,6210
2834,臺企銀,94,52,42,新百王,2024-08-28,6210
2323,中環,88,48,40,新百王,2024-08-28,6210
3686,達能,36,0,36,新百王,2024-08-28,6210
00918,大華優利高填息30,40,5,35,新百王,2024-08-28,6210
5481,新華,39,10,29,新百王,2024-08-28,6210
00632R,元大台灣50反1,32,4,28,新百王,2024-08-28,6210
00665L,富邦�琤肭磪囓�2,28,0,28,新百王,2024-08-28,6210
00650L,復華香港正2,26,0,26,新百王,2024-08-28,6210
2376,技嘉,66,41,25,新百王,2024-08-28,6210
3050,鈺德,24,0,24,新百王,2024-08-28,6210
1815,富喬,28,5,23,新百王,2024-08-28,6210
00959B,大華投等美債15Y+,23,0,23,新百王,2024-08-28,6210
8033,雷虎,22,0,22,新百王,2024-08-28,6210
9105,泰金寶-DR,20,0,20,新百王,2024-08-28,6210
4564,元翎,21,3,18,新百王,2024-08-28,6210
3078,僑威,18,0,18,新百王,2024-08-28,6210
00878,國泰永續高股息,21,4,17,新百王,2024-08-28,6210
4555,氣立,36,19,17,新百王,2024-08-28,6210
3059,華晶科,16,0,16,新百王,2024-08-28,6210
2409,友達,37,21,16,新百王,2024-08-28,6210
6753,龍德造船,22,6,16,新百王,2024-08-28,6210
8039,台虹,33,17,16,新百王,2024-08-28,6210
2353,宏��,17,2,15,新百王,2024-08-28,6210
1528,恩德,32,17,15,新百王,2024-08-28,6210
00708L,期元大S＆P黃金正2,23,8,15,新百王,2024-08-28,6210
00679B,元大美債20年,18,4,14,新百王,2024-08-28,6210
4566,時碩工業,19,6,13,新百王,2024-08-28,6210
1734,杏輝,13,0,13,新百王,2024-08-28,6210
4729,熒茂,15,2,13,新百王,2024-08-28,6210
3481,群創,93,81,12,新百王,2024-08-28,6210
4535,至興,12,0,12,新百王,2024-08-28,6210
8446,華研,11,0,11,新百王,2024-08-28,6210
2812,台中銀,20,9,11,新百王,2024-08-28,6210
3673,TPK-KY,14,3,11,新百王,2024-08-28,6210
2402,毅嘉,53,42,11,新百王,2024-08-28,6210
3593,力銘,10,0,10,新百王,2024-08-28,6210
2323,中環,160,14,146,新百王,2024-08-29,6210
00937B,群益ESG投等債20,135,0,135,新百王,2024-08-29,6210
6156,松上,148,15,133,新百王,2024-08-29,6210
00688L,國泰20年美債正2,110,0,110,新百王,2024-08-29,6210
1314,中石化,175,86,89,新百王,2024-08-29,6210
00679B,元大美債20年,88,4,84,新百王,2024-08-29,6210
2888,新光金,375,298,77,新百王,2024-08-29,6210
3062,建漢,94,27,67,新百王,2024-08-29,6210
9907,統一實,90,25,65,新百王,2024-08-29,6210
2891,中信金,78,18,60,新百王,2024-08-29,6210
8064,東捷,87,29,58,新百王,2024-08-29,6210
1312,國喬,57,0,57,新百王,2024-08-29,6210
1709,和益,50,0,50,新百王,2024-08-29,6210
00919,群益台灣精選高息,111,61,50,新百王,2024-08-29,6210
00687B,國泰20年美債,47,0,47,新百王,2024-08-29,6210
2303,聯電,44,1,43,新百王,2024-08-29,6210
00715L,期街口布蘭特正2,64,23,41,新百王,2024-08-29,6210
6257,矽格,39,1,38,新百王,2024-08-29,6210
1445,大宇,38,0,38,新百王,2024-08-29,6210
00650L,復華香港正2,46,10,36,新百王,2024-08-29,6210
00795B,中信美國公債20年,36,3,33,新百王,2024-08-29,6210
00665L,富邦�琤肭磪囓�2,89,56,33,新百王,2024-08-29,6210
2313,華通,45,12,33,新百王,2024-08-29,6210
00637L,元大滬深300正2,42,10,32,新百王,2024-08-29,6210
1416,廣豐,30,0,30,新百王,2024-08-29,6210
2887,台新金,30,1,29,新百王,2024-08-29,6210
1309,台達化,30,3,27,新百王,2024-08-29,6210
6016,康和證,24,0,24,新百王,2024-08-29,6210
8028,昇陽半導體,37,13,24,新百王,2024-08-29,6210
3673,TPK-KY,25,1,24,新百王,2024-08-29,6210
1721,三晃,66,42,24,新百王,2024-08-29,6210
8927,北基,40,17,23,新百王,2024-08-29,6210
00895,富邦未來車,23,0,23,新百王,2024-08-29,6210
2609,陽明,25,3,22,新百王,2024-08-29,6210
1727,中華化,28,6,22,新百王,2024-08-29,6210
3441,聯一光,22,2,20,新百王,2024-08-29,6210
6126,信音,20,2,18,新百王,2024-08-29,6210
00936,台新永續高息中小,32,16,16,新百王,2024-08-29,6210
3481,群創,141,125,16,新百王,2024-08-29,6210
00918,大華優利高填息30,41,25,16,新百王,2024-08-29,6210
2464,盟立,29,13,16,新百王,2024-08-29,6210
00764B,群益25年美債,15,0,15,新百王,2024-08-29,6210
2444,兆勁,15,0,15,新百王,2024-08-29,6210
3047,訊舟,18,3,15,新百王,2024-08-29,6210
00934,中信成長高股息,95,80,15,新百王,2024-08-29,6210
2610,華航,14,0,14,新百王,2024-08-29,6210
3032,偉訓,17,4,13,新百王,2024-08-29,6210
8011,台通,15,2,13,新百王,2024-08-29,6210
3498,陽程,13,0,13,新百王,2024-08-29,6210
2362,藍天,13,0,13,新百王,2024-08-29,6210
00632R,元大台灣50反1,436,1,435,新百王,2024-08-30,6210
2349,錸德,256,0,256,新百王,2024-08-30,6210
00687B,國泰20年美債,166,0,166,新百王,2024-08-30,6210
1314,中石化,201,50,151,新百王,2024-08-30,6210
2867,三商壽,125,0,125,新百王,2024-08-30,6210
1312,國喬,107,0,107,新百王,2024-08-30,6210
2891,中信金,101,6,95,新百王,2024-08-30,6210
3481,群創,340,254,86,新百王,2024-08-30,6210
2834,臺企銀,88,6,82,新百王,2024-08-30,6210
1718,中纖,70,0,70,新百王,2024-08-30,6210
4906,正文,54,1,53,新百王,2024-08-30,6210
4510,高鋒,93,44,49,新百王,2024-08-30,6210
2367,燿華,91,43,48,新百王,2024-08-30,6210
6244,茂迪,40,0,40,新百王,2024-08-30,6210
1806,冠軍,40,3,37,新百王,2024-08-30,6210
00891,中信關鍵半導體,35,0,35,新百王,2024-08-30,6210
8027,鈦昇,39,5,34,新百王,2024-08-30,6210
00940,元大台灣價值高息,38,5,33,新百王,2024-08-30,6210
4707,磐亞,30,0,30,新百王,2024-08-30,6210
2887,台新金,74,44,30,新百王,2024-08-30,6210
2027,大成鋼,33,3,30,新百王,2024-08-30,6210
3450,聯鈞,76,47,29,新百王,2024-08-30,6210
00715L,期街口布蘭特正2,86,58,28,新百王,2024-08-30,6210
00937B,群益ESG投等債20,28,0,28,新百王,2024-08-30,6210
2382,廣達,46,22,24,新百王,2024-08-30,6210
3437,榮創,24,2,22,新百王,2024-08-30,6210
2323,中環,29,9,20,新百王,2024-08-30,6210
2397,友通,21,1,20,新百王,2024-08-30,6210
1466,聚隆,20,0,20,新百王,2024-08-30,6210
4729,熒茂,34,15,19,新百王,2024-08-30,6210
3645,達邁,29,10,19,新百王,2024-08-30,6210
1416,廣豐,20,1,19,新百王,2024-08-30,6210
6651,全宇昕,19,0,19,新百王,2024-08-30,6210
2402,毅嘉,109,90,19,新百王,2024-08-30,6210
4714,永捷,22,4,18,新百王,2024-08-30,6210
00918,大華優利高填息30,37,19,18,新百王,2024-08-30,6210
2606,裕民,33,16,17,新百王,2024-08-30,6210
1711,永光,77,60,17,新百王,2024-08-30,6210
3189,景碩,23,8,15,新百王,2024-08-30,6210
2317,鴻海,42,27,15,新百王,2024-08-30,6210
2347,聯強,24,10,14,新百王,2024-08-30,6210
3088,艾訊,14,0,14,新百王,2024-08-30,6210
3596,智易,14,0,14,新百王,2024-08-30,6210
00665L,富邦�琤肭磪囓�2,227,213,14,新百王,2024-08-30,6210
2425,承啟,38,25,13,新百王,2024-08-30,6210
2392,正崴,35,23,12,新百王,2024-08-30,6210
3037,欣興,41,30,11,新百王,2024-08-30,6210
4561,健椿,30,19,11,新百王,2024-08-30,6210
5534,長虹,13,2,11,新百王,2024-08-30,6210
00946,群益科技高息成長,21,10,11,新百王,2024-08-30,6210
00687B,國泰20年美債,239,3,236,新百王,2024-09-02,6210
00688L,國泰20年美債正2,208,0,208,新百王,2024-09-02,6210
2897,王道銀行,260,100,160,新百王,2024-09-02,6210
00680L,元大美債20正2,160,1,159,新百王,2024-09-02,6210
00665L,富邦�琤肭磪囓�2,147,5,142,新百王,2024-09-02,6210
3481,群創,278,141,137,新百王,2024-09-02,6210
00959B,大華投等美債15Y+,115,0,115,新百王,2024-09-02,6210
00715L,期街口布蘭特正2,153,42,111,新百王,2024-09-02,6210
2890,永豐金,125,15,110,新百王,2024-09-02,6210
1314,中石化,111,4,107,新百王,2024-09-02,6210
00637L,元大滬深300正2,111,20,91,新百王,2024-09-02,6210
00919,群益台灣精選高息,98,7,91,新百王,2024-09-02,6210
00650L,復華香港正2,76,0,76,新百王,2024-09-02,6210
00929,復華台灣科技優息,78,8,70,新百王,2024-09-02,6210
8011,台通,91,27,64,新百王,2024-09-02,6210
8033,雷虎,55,0,55,新百王,2024-09-02,6210
2834,臺企銀,63,11,52,新百王,2024-09-02,6210
2891,中信金,77,26,51,新百王,2024-09-02,6210
2409,友達,56,10,46,新百王,2024-09-02,6210
00753L,中信中國50正2,44,1,43,新百王,2024-09-02,6210
2607,榮運,37,0,37,新百王,2024-09-02,6210
2371,大同,35,5,30,新百王,2024-09-02,6210
00795B,中信美國公債20年,33,3,30,新百王,2024-09-02,6210
3376,新日興,48,19,29,新百王,2024-09-02,6210
2603,長榮,41,13,28,新百王,2024-09-02,6210
00679B,元大美債20年,30,2,28,新百王,2024-09-02,6210
6505,台塑化,32,5,27,新百王,2024-09-02,6210
2317,鴻海,153,127,26,新百王,2024-09-02,6210
4545,銘鈺,26,0,26,新百王,2024-09-02,6210
2323,中環,34,9,25,新百王,2024-09-02,6210
4729,熒茂,25,0,25,新百王,2024-09-02,6210
3580,友威科,40,15,25,新百王,2024-09-02,6210
5876,上海商銀,25,0,25,新百王,2024-09-02,6210
1815,富喬,29,5,24,新百王,2024-09-02,6210
2615,萬海,35,12,23,新百王,2024-09-02,6210
3051,力特,23,0,23,新百王,2024-09-02,6210
1710,東聯,22,0,22,新百王,2024-09-02,6210
00642U,期元大S＆P石油,21,0,21,新百王,2024-09-02,6210
2495,普安,35,14,21,新百王,2024-09-02,6210
4109,加捷生醫,21,0,21,新百王,2024-09-02,6210
3062,建漢,40,19,21,新百王,2024-09-02,6210
2609,陽明,20,0,20,新百王,2024-09-02,6210
2851,中再保,20,0,20,新百王,2024-09-02,6210
2905,三商,20,0,20,新百王,2024-09-02,6210
00948B,中信優息投資級債,20,0,20,新百王,2024-09-02,6210
1416,廣豐,20,0,20,新百王,2024-09-02,6210
6142,友勁,20,0,20,新百王,2024-09-02,6210
2801,彰銀,20,0,20,新百王,2024-09-02,6210
4510,高鋒,72,53,19,新百王,2024-09-02,6210
8105,凌巨,28,9,19,新百王,2024-09-02,6210
00687B,國泰20年美債,162,10,152,新百王,2024-09-03,6210
1314,中石化,157,10,147,新百王,2024-09-03,6210
00688L,國泰20年美債正2,134,0,134,新百王,2024-09-03,6210
00919,群益台灣精選高息,148,39,109,新百王,2024-09-03,6210
00937B,群益ESG投等債20,106,0,106,新百王,2024-09-03,6210
6213,聯茂,132,57,75,新百王,2024-09-03,6210
00945B,凱基美國非投等債,75,0,75,新百王,2024-09-03,6210
3062,建漢,124,52,72,新百王,2024-09-03,6210
1522,堤維西,80,10,70,新百王,2024-09-03,6210
00665L,富邦�琤肭磪囓�2,70,1,69,新百王,2024-09-03,6210
2883,凱基金,110,42,68,新百王,2024-09-03,6210
1303,南亞,68,3,65,新百王,2024-09-03,6210
2834,臺企銀,82,23,59,新百王,2024-09-03,6210
1702,南僑,55,0,55,新百王,2024-09-03,6210
1301,台塑,62,8,54,新百王,2024-09-03,6210
2464,盟立,97,45,52,新百王,2024-09-03,6210
6405,悅城,53,2,51,新百王,2024-09-03,6210
1785,光洋科,61,15,46,新百王,2024-09-03,6210
00680L,元大美債20正2,39,0,39,新百王,2024-09-03,6210
00915,凱基優選高股息30,35,0,35,新百王,2024-09-03,6210
3481,群創,74,40,34,新百王,2024-09-03,6210
2323,中環,40,9,31,新百王,2024-09-03,6210
3006,晶豪科,40,10,30,新百王,2024-09-03,6210
6531,愛普*,35,6,29,新百王,2024-09-03,6210
00918,大華優利高填息30,60,31,29,新百王,2024-09-03,6210
00951,台新日本半導體,29,0,29,新百王,2024-09-03,6210
2887,台新金,53,26,27,新百王,2024-09-03,6210
2897,王道銀行,56,30,26,新百王,2024-09-03,6210
00637L,元大滬深300正2,55,30,25,新百王,2024-09-03,6210
2609,陽明,40,16,24,新百王,2024-09-03,6210
00679B,元大美債20年,24,0,24,新百王,2024-09-03,6210
2062,橋椿,40,18,22,新百王,2024-09-03,6210
2402,毅嘉,88,67,21,新百王,2024-09-03,6210
2486,一詮,33,12,21,新百王,2024-09-03,6210
2618,長榮航,56,35,21,新百王,2024-09-03,6210
00753L,中信中國50正2,20,0,20,新百王,2024-09-03,6210
5443,均豪,59,40,19,新百王,2024-09-03,6210
8096,擎亞,32,15,17,新百王,2024-09-03,6210
2610,華航,39,22,17,新百王,2024-09-03,6210
00712,復華富時不動產,16,0,16,新百王,2024-09-03,6210
1416,廣豐,16,0,16,新百王,2024-09-03,6210
2330,台積電,25,9,16,新百王,2024-09-03,6210
3363,上詮,30,15,15,新百王,2024-09-03,6210
2903,遠百,15,0,15,新百王,2024-09-03,6210
3652,精聯,25,10,15,新百王,2024-09-03,6210
00655L,國泰中國A50正2,14,0,14,新百王,2024-09-03,6210
8076,伍豐,23,9,14,新百王,2024-09-03,6210
4538,大詠城,14,1,13,新百王,2024-09-03,6210
00772B,中信高評級公司債,13,0,13,新百王,2024-09-03,6210
6151,晉倫,17,4,13,新百王,2024-09-03,6210
00915,凱基優選高股息30,418,30,388,新百王,2024-09-04,6210
00680L,元大美債20正2,414,91,323,新百王,2024-09-04,6210
00715L,期街口布蘭特正2,307,11,296,新百王,2024-09-04,6210
00919,群益台灣精選高息,332,47,285,新百王,2024-09-04,6210
1314,中石化,149,17,132,新百王,2024-09-04,6210
2607,榮運,116,7,109,新百王,2024-09-04,6210
00679B,元大美債20年,138,40,98,新百王,2024-09-04,6210
00878,國泰永續高股息,115,27,88,新百王,2024-09-04,6210
00936,台新永續高息中小,226,150,76,新百王,2024-09-04,6210
00918,大華優利高填息30,80,16,64,新百王,2024-09-04,6210
2344,華邦電,55,0,55,新百王,2024-09-04,6210
1104,環泥,51,0,51,新百王,2024-09-04,6210
00955,中信日本商社,51,0,51,新百王,2024-09-04,6210
1540,喬福,120,70,50,新百王,2024-09-04,6210
2330,台積電,74,26,48,新百王,2024-09-04,6210
6488,環球晶,46,1,45,新百王,2024-09-04,6210
0056,元大高股息,59,16,43,新百王,2024-09-04,6210
9958,世紀鋼,43,2,41,新百王,2024-09-04,6210
2340,台亞,41,0,41,新百王,2024-09-04,6210
6116,彩晶,40,0,40,新百王,2024-09-04,6210
00637L,元大滬深300正2,46,10,36,新百王,2024-09-04,6210
00940,元大台灣價值高息,97,63,34,新百王,2024-09-04,6210
00946,群益科技高息成長,34,0,34,新百王,2024-09-04,6210
2701,萬企,32,0,32,新百王,2024-09-04,6210
2887,台新金,52,20,32,新百王,2024-09-04,6210
1313,聯成,29,0,29,新百王,2024-09-04,6210
2408,南亞科,28,0,28,新百王,2024-09-04,6210
00927,群益半導體收益,42,14,28,新百王,2024-09-04,6210
4729,熒茂,37,10,27,新百王,2024-09-04,6210
4510,高鋒,209,183,26,新百王,2024-09-04,6210
1303,南亞,27,1,26,新百王,2024-09-04,6210
6016,康和證,34,8,26,新百王,2024-09-04,6210
2885,元大金,24,0,24,新百王,2024-09-04,6210
2317,鴻海,128,104,24,新百王,2024-09-04,6210
9946,三發地產,23,0,23,新百王,2024-09-04,6210
3481,群創,52,31,21,新百王,2024-09-04,6210
6570,維田,22,1,21,新百王,2024-09-04,6210
3711,日月光投控,52,31,21,新百王,2024-09-04,6210
1301,台塑,30,10,20,新百王,2024-09-04,6210
5521,工信,42,22,20,新百王,2024-09-04,6210
3691,碩禾,21,1,20,新百王,2024-09-04,6210
2002,中鋼,33,13,20,新百王,2024-09-04,6210
2610,華航,20,0,20,新百王,2024-09-04,6210
1785,光洋科,58,39,19,新百王,2024-09-04,6210
8011,台通,22,3,19,新百王,2024-09-04,6210
0050,元大台灣50,32,13,19,新百王,2024-09-04,6210
00675L,富邦臺灣加權正2,38,20,18,新百王,2024-09-04,6210
2412,中華電,19,2,17,新百王,2024-09-04,6210
2354,鴻準,20,4,16,新百王,2024-09-04,6210
6505,台塑化,32,17,15,新百王,2024-09-04,6210
00715L,期街口布蘭特正2,1186,12,1174,新百王,2024-09-05,6210
00687B,國泰20年美債,348,58,290,新百王,2024-09-05,6210
00937B,群益ESG投等債20,217,26,191,新百王,2024-09-05,6210
2867,三商壽,272,100,172,新百王,2024-09-05,6210
00680L,元大美債20正2,517,357,160,新百王,2024-09-05,6210
1314,中石化,112,0,112,新百王,2024-09-05,6210
4956,光鋐,116,9,107,新百王,2024-09-05,6210
2344,華邦電,77,0,77,新百王,2024-09-05,6210
00664R,國泰臺灣加權反1,74,0,74,新百王,2024-09-05,6210
00946,群益科技高息成長,81,15,66,新百王,2024-09-05,6210
00665L,富邦�琤肭磪囓�2,63,0,63,新百王,2024-09-05,6210
2812,台中銀,90,30,60,新百王,2024-09-05,6210
1539,巨庭,89,33,56,新百王,2024-09-05,6210
00919,群益台灣精選高息,86,30,56,新百王,2024-09-05,6210
2317,鴻海,69,16,53,新百王,2024-09-05,6210
00708L,期元大S＆P黃金正2,51,0,51,新百王,2024-09-05,6210
00929,復華台灣科技優息,96,50,46,新百王,2024-09-05,6210
3006,晶豪科,53,8,45,新百王,2024-09-05,6210
00637L,元大滬深300正2,63,20,43,新百王,2024-09-05,6210
00951,台新日本半導體,40,0,40,新百王,2024-09-05,6210
2897,王道銀行,54,20,34,新百王,2024-09-05,6210
6770,力積電,38,5,33,新百王,2024-09-05,6210
1530,亞崴,32,0,32,新百王,2024-09-05,6210
3481,群創,27,2,25,新百王,2024-09-05,6210
5245,智晶,28,5,23,新百王,2024-09-05,6210
00915,凱基優選高股息30,36,15,21,新百王,2024-09-05,6210
2323,中環,21,0,21,新百王,2024-09-05,6210
1466,聚隆,20,0,20,新百王,2024-09-05,6210
2069,運錩,20,0,20,新百王,2024-09-05,6210
8938,明安,19,0,19,新百王,2024-09-05,6210
4729,熒茂,27,8,19,新百王,2024-09-05,6210
6488,環球晶,18,0,18,新百王,2024-09-05,6210
6776,展�眥篕�,17,0,17,新百王,2024-09-05,6210
5905,南仁湖,18,1,17,新百王,2024-09-05,6210
5876,上海商銀,15,0,15,新百王,2024-09-05,6210
2312,金寶,29,14,15,新百王,2024-09-05,6210
2371,大同,24,10,14,新百王,2024-09-05,6210
8996,高力,18,4,14,新百王,2024-09-05,6210
8374,羅昇,131,117,14,新百王,2024-09-05,6210
00952,凱基台灣AI50,13,0,13,新百王,2024-09-05,6210
2349,錸德,15,2,13,新百王,2024-09-05,6210
1718,中纖,15,2,13,新百王,2024-09-05,6210
00918,大華優利高填息30,41,29,12,新百王,2024-09-05,6210
00650L,復華香港正2,12,0,12,新百王,2024-09-05,6210
2547,日勝生,42,30,12,新百王,2024-09-05,6210
2809,京城銀,12,0,12,新百王,2024-09-05,6210
5460,同協,12,0,12,新百王,2024-09-05,6210
2402,毅嘉,32,20,12,新百王,2024-09-05,6210
00936,台新永續高息中小,11,0,11,新百王,2024-09-05,6210
3380,明泰,11,0,11,新百王,2024-09-05,6210
00715L,期街口布蘭特正2,625,157,468,新百王,2024-09-06,6210
00632R,元大台灣50反1,471,70,401,新百王,2024-09-06,6210
00680L,元大美債20正2,689,377,312,新百王,2024-09-06,6210
00664R,國泰臺灣加權反1,149,0,149,新百王,2024-09-06,6210
4956,光鋐,118,1,117,新百王,2024-09-06,6210
3714,富采,100,9,91,新百王,2024-09-06,6210
00687B,國泰20年美債,59,0,59,新百王,2024-09-06,6210
1314,中石化,58,0,58,新百王,2024-09-06,6210
00637L,元大滬深300正2,116,61,55,新百王,2024-09-06,6210
00951,台新日本半導體,50,0,50,新百王,2024-09-06,6210
3624,光頡,54,6,48,新百王,2024-09-06,6210
8150,南茂,42,0,42,新百王,2024-09-06,6210
4729,熒茂,34,0,34,新百王,2024-09-06,6210
5905,南仁湖,35,3,32,新百王,2024-09-06,6210
3290,東浦,30,0,30,新百王,2024-09-06,6210
00795B,中信美國公債20年,52,23,29,新百王,2024-09-06,6210
1785,光洋科,43,15,28,新百王,2024-09-06,6210
1806,冠軍,23,0,23,新百王,2024-09-06,6210
6215,和椿,114,94,20,新百王,2024-09-06,6210
2867,三商壽,20,0,20,新百王,2024-09-06,6210
2236,百達-KY,21,2,19,新百王,2024-09-06,6210
2464,盟立,30,12,18,新百王,2024-09-06,6210
2537,聯上發,17,0,17,新百王,2024-09-06,6210
5245,智晶,17,0,17,新百王,2024-09-06,6210
00679B,元大美債20年,40,25,15,新百王,2024-09-06,6210
2888,新光金,25,10,15,新百王,2024-09-06,6210
1734,杏輝,15,0,15,新百王,2024-09-06,6210
00642U,期元大S＆P石油,12,0,12,新百王,2024-09-06,6210
5519,隆大,12,0,12,新百王,2024-09-06,6210
00712,復華富時不動產,12,1,11,新百王,2024-09-06,6210
4563,百德,12,1,11,新百王,2024-09-06,6210
00934,中信成長高股息,11,0,11,新百王,2024-09-06,6210
00941,中信上游半導體,11,0,11,新百王,2024-09-06,6210
1519,華城,12,2,10,新百王,2024-09-06,6210
8011,台通,10,0,10,新百王,2024-09-06,6210
2317,鴻海,35,25,10,新百王,2024-09-06,6210
1466,聚隆,10,0,10,新百王,2024-09-06,6210
2354,鴻準,10,0,10,新百王,2024-09-06,6210
2323,中環,10,0,10,新百王,2024-09-06,6210
00948B,中信優息投資級債,20,10,10,新百王,2024-09-06,6210
00959B,大華投等美債15Y+,10,0,10,新百王,2024-09-06,6210
1309,台達化,10,0,10,新百王,2024-09-06,6210
5392,能率,11,1,10,新百王,2024-09-06,6210
8071,能率網通,15,5,10,新百王,2024-09-06,6210
6278,台表科,11,1,10,新百王,2024-09-06,6210
3230,錦明,21,11,10,新百王,2024-09-06,6210
00918,大華優利高填息30,9,0,9,新百王,2024-09-06,6210
3217,優群,9,0,9,新百王,2024-09-06,6210
6651,全宇昕,13,4,9,新百王,2024-09-06,6210
3047,訊舟,10,1,9,新百王,2024-09-06,6210
00671R,富邦NASDAQ反1,376,0,376,新百王,2024-09-09,6210
4956,光鋐,357,66,291,新百王,2024-09-09,6210
00688L,國泰20年美債正2,241,35,206,新百王,2024-09-09,6210
00637L,元大滬深300正2,132,17,115,新百王,2024-09-09,6210
00951,台新日本半導體,71,6,65,新百王,2024-09-09,6210
2881,富邦金,66,4,62,新百王,2024-09-09,6210
00948B,中信優息投資級債,60,0,60,新百王,2024-09-09,6210
00680L,元大美債20正2,170,110,60,新百王,2024-09-09,6210
5876,上海商銀,46,0,46,新百王,2024-09-09,6210
4729,熒茂,73,31,42,新百王,2024-09-09,6210
2891,中信金,48,10,38,新百王,2024-09-09,6210
2317,鴻海,51,14,37,新百王,2024-09-09,6210
3025,星通,38,2,36,新百王,2024-09-09,6210
006208,富邦台50,36,4,32,新百王,2024-09-09,6210
4933,友輝,37,7,30,新百王,2024-09-09,6210
00715L,期街口布蘭特正2,60,31,29,新百王,2024-09-09,6210
00631L,元大台灣50正2,73,44,29,新百王,2024-09-09,6210
5905,南仁湖,43,19,24,新百王,2024-09-09,6210
2885,元大金,22,0,22,新百王,2024-09-09,6210
2431,聯昌,22,0,22,新百王,2024-09-09,6210
00753L,中信中國50正2,30,8,22,新百王,2024-09-09,6210
2801,彰銀,21,0,21,新百王,2024-09-09,6210
00878,國泰永續高股息,41,21,20,新百王,2024-09-09,6210
1708,東鹼,25,5,20,新百王,2024-09-09,6210
1539,巨庭,60,40,20,新百王,2024-09-09,6210
3703,欣陸,30,10,20,新百王,2024-09-09,6210
8464,億豐,20,0,20,新百王,2024-09-09,6210
00952,凱基台灣AI50,20,0,20,新百王,2024-09-09,6210
2607,榮運,34,16,18,新百王,2024-09-09,6210
2883,凱基金,21,3,18,新百王,2024-09-09,6210
1785,光洋科,32,15,17,新百王,2024-09-09,6210
00915,凱基優選高股息30,21,4,17,新百王,2024-09-09,6210
5392,能率,18,1,17,新百王,2024-09-09,6210
00946,群益科技高息成長,16,0,16,新百王,2024-09-09,6210
2442,新美齊,15,0,15,新百王,2024-09-09,6210
2330,台積電,29,14,15,新百王,2024-09-09,6210
00940,元大台灣價值高息,14,0,14,新百王,2024-09-09,6210
00934,中信成長高股息,14,0,14,新百王,2024-09-09,6210
2062,橋椿,20,6,14,新百王,2024-09-09,6210
3230,錦明,38,24,14,新百王,2024-09-09,6210
2208,台船,12,0,12,新百王,2024-09-09,6210
6163,華電網,14,2,12,新百王,2024-09-09,6210
6505,台塑化,16,5,11,新百王,2024-09-09,6210
2236,百達-KY,23,12,11,新百王,2024-09-09,6210
2344,華邦電,26,15,11,新百王,2024-09-09,6210
6651,全宇昕,23,12,11,新百王,2024-09-09,6210
00655L,國泰中國A50正2,11,0,11,新百王,2024-09-09,6210
4958,臻鼎-KY,11,0,11,新百王,2024-09-09,6210
00919,群益台灣精選高息,61,50,11,新百王,2024-09-09,6210
0056,元大高股息,14,3,11,新百王,2024-09-09,6210
00934,中信成長高股息,158,0,158,新百王,2024-09-10,6210
00715L,期街口布蘭特正2,129,5,124,新百王,2024-09-10,6210
00915,凱基優選高股息30,120,0,120,新百王,2024-09-10,6210
00687B,國泰20年美債,93,1,92,新百王,2024-09-10,6210
1314,中石化,116,28,88,新百王,2024-09-10,6210
00948B,中信優息投資級債,110,25,85,新百王,2024-09-10,6210
00919,群益台灣精選高息,71,0,71,新百王,2024-09-10,6210
2897,王道銀行,89,20,69,新百王,2024-09-10,6210
2356,英業達,65,3,62,新百王,2024-09-10,6210
1584,精剛,61,2,59,新百王,2024-09-10,6210
4729,熒茂,67,11,56,新百王,2024-09-10,6210
1305,華夏,52,0,52,新百王,2024-09-10,6210
1806,冠軍,89,39,50,新百王,2024-09-10,6210
1326,台化,51,1,50,新百王,2024-09-10,6210
2327,國巨,47,0,47,新百王,2024-09-10,6210
00929,復華台灣科技優息,44,0,44,新百王,2024-09-10,6210
3209,全科,54,12,42,新百王,2024-09-10,6210
6163,華電網,42,4,38,新百王,2024-09-10,6210
0056,元大高股息,39,5,34,新百王,2024-09-10,6210
5905,南仁湖,35,2,33,新百王,2024-09-10,6210
2317,鴻海,50,18,32,新百王,2024-09-10,6210
4538,大詠城,35,6,29,新百王,2024-09-10,6210
00878,國泰永續高股息,38,10,28,新百王,2024-09-10,6210
1466,聚隆,24,0,24,新百王,2024-09-10,6210
4958,臻鼎-KY,62,39,23,新百王,2024-09-10,6210
4714,永捷,26,3,23,新百王,2024-09-10,6210
2891,中信金,27,7,20,新百王,2024-09-10,6210
2010,春源,19,0,19,新百王,2024-09-10,6210
2002,中鋼,32,13,19,新百王,2024-09-10,6210
4306,炎洲,18,0,18,新百王,2024-09-10,6210
2069,運錩,18,0,18,新百王,2024-09-10,6210
2382,廣達,55,38,17,新百王,2024-09-10,6210
1609,大亞,53,36,17,新百王,2024-09-10,6210
4956,光鋐,26,9,17,新百王,2024-09-10,6210
1336,台翰,17,0,17,新百王,2024-09-10,6210
00940,元大台灣價值高息,17,0,17,新百王,2024-09-10,6210
3625,西勝,16,0,16,新百王,2024-09-10,6210
00753L,中信中國50正2,31,15,16,新百王,2024-09-10,6210
3188,鑫龍騰,30,14,16,新百王,2024-09-10,6210
3025,星通,56,40,16,新百王,2024-09-10,6210
00648R,元大S＆P500反1,15,0,15,新百王,2024-09-10,6210
6127,九豪,15,0,15,新百王,2024-09-10,6210
00665L,富邦�琤肭磪囓�2,20,5,15,新百王,2024-09-10,6210
2867,三商壽,15,0,15,新百王,2024-09-10,6210
6125,廣運,28,14,14,新百王,2024-09-10,6210
1514,亞力,16,2,14,新百王,2024-09-10,6210
00654R,富邦印度反1,13,0,13,新百王,2024-09-10,6210
4979,華星光,60,48,12,新百王,2024-09-10,6210
00669R,國泰美國道瓊反1,12,0,12,新百王,2024-09-10,6210
2851,中再保,12,0,12,新百王,2024-09-10,6210
00929,復華台灣科技優息,352,7,345,新百王,2024-09-11,6210
2834,臺企銀,168,12,156,新百王,2024-09-11,6210
00715L,期街口布蘭特正2,158,27,131,新百王,2024-09-11,6210
00915,凱基優選高股息30,126,0,126,新百王,2024-09-11,6210
00632R,元大台灣50反1,130,41,89,新百王,2024-09-11,6210
2888B,新光金乙特,80,0,80,新百王,2024-09-11,6210
00957B,兆豐US優選投等債,76,0,76,新百王,2024-09-11,6210
4510,高鋒,176,107,69,新百王,2024-09-11,6210
00687B,國泰20年美債,107,40,67,新百王,2024-09-11,6210
4956,光鋐,73,13,60,新百王,2024-09-11,6210
00650L,復華香港正2,60,0,60,新百王,2024-09-11,6210
00680L,元大美債20正2,100,41,59,新百王,2024-09-11,6210
1314,中石化,79,21,58,新百王,2024-09-11,6210
1806,冠軍,75,20,55,新百王,2024-09-11,6210
2851,中再保,54,0,54,新百王,2024-09-11,6210
00959B,大華投等美債15Y+,50,0,50,新百王,2024-09-11,6210
6163,華電網,47,0,47,新百王,2024-09-11,6210
3625,西勝,38,0,38,新百王,2024-09-11,6210
9105,泰金寶-DR,38,0,38,新百王,2024-09-11,6210
2002,中鋼,47,10,37,新百王,2024-09-11,6210
00637L,元大滬深300正2,46,10,36,新百王,2024-09-11,6210
2884,玉山金,35,0,35,新百王,2024-09-11,6210
2317,鴻海,109,74,35,新百王,2024-09-11,6210
1539,巨庭,35,1,34,新百王,2024-09-11,6210
3707,漢磊,49,18,31,新百王,2024-09-11,6210
00665L,富邦�琤肭磪囓�2,30,0,30,新百王,2024-09-11,6210
2353,宏��,31,4,27,新百王,2024-09-11,6210
2892,第一金,25,0,25,新百王,2024-09-11,6210
1709,和益,25,2,23,新百王,2024-09-11,6210
2399,映泰,73,53,20,新百王,2024-09-11,6210
3686,達能,20,0,20,新百王,2024-09-11,6210
00919,群益台灣精選高息,18,0,18,新百王,2024-09-11,6210
1504,東元,27,12,15,新百王,2024-09-11,6210
2542,興富發,15,1,14,新百王,2024-09-11,6210
6757,台灣虎航,14,0,14,新百王,2024-09-11,6210
00753L,中信中國50正2,14,0,14,新百王,2024-09-11,6210
5381,合正,14,0,14,新百王,2024-09-11,6210
6148,驊宏資,17,3,14,新百王,2024-09-11,6210
2891,中信金,15,1,14,新百王,2024-09-11,6210
00713,元大台灣高息低波,14,1,13,新百王,2024-09-11,6210
00654R,富邦印度反1,13,0,13,新百王,2024-09-11,6210
00934,中信成長高股息,12,0,12,新百王,2024-09-11,6210
3209,全科,23,11,12,新百王,2024-09-11,6210
3360,尚立,29,17,12,新百王,2024-09-11,6210
3062,建漢,37,25,12,新百王,2024-09-11,6210
3013,晟銘電,27,16,11,新百王,2024-09-11,6210
5483,中美晶,11,0,11,新百王,2024-09-11,6210
1514,亞力,19,8,11,新百王,2024-09-11,6210
2809,京城銀,10,0,10,新百王,2024-09-11,6210
4535,至興,10,0,10,新百王,2024-09-11,6210
00632R,元大台灣50反1,804,312,492,新百王,2024-09-12,6210
00945B,凱基美國非投等債,250,0,250,新百王,2024-09-12,6210
00687B,國泰20年美債,215,21,194,新百王,2024-09-12,6210
00679B,元大美債20年,173,6,167,新百王,2024-09-12,6210
00688L,國泰20年美債正2,167,6,161,新百王,2024-09-12,6210
2888,新光金,239,119,120,新百王,2024-09-12,6210
2349,錸德,131,21,110,新百王,2024-09-12,6210
00931B,統一美債20年,100,0,100,新百王,2024-09-12,6210
3050,鈺德,100,0,100,新百王,2024-09-12,6210
2891,中信金,111,30,81,新百王,2024-09-12,6210
3290,東浦,60,0,60,新百王,2024-09-12,6210
4720,德淵,60,0,60,新百王,2024-09-12,6210
6163,華電網,64,11,53,新百王,2024-09-12,6210
2547,日勝生,53,0,53,新百王,2024-09-12,6210
1314,中石化,48,1,47,新百王,2024-09-12,6210
00715L,期街口布蘭特正2,85,42,43,新百王,2024-09-12,6210
00637L,元大滬深300正2,50,10,40,新百王,2024-09-12,6210
1806,冠軍,56,16,40,新百王,2024-09-12,6210
4763,材料-KY,76,37,39,新百王,2024-09-12,6210
2027,大成鋼,36,0,36,新百王,2024-09-12,6210
8213,志超,30,0,30,新百王,2024-09-12,6210
2062,橋椿,29,0,29,新百王,2024-09-12,6210
3617,碩天,29,2,27,新百王,2024-09-12,6210
1540,喬福,75,49,26,新百王,2024-09-12,6210
00795B,中信美國公債20年,26,0,26,新百王,2024-09-12,6210
4741,泓瀚,23,0,23,新百王,2024-09-12,6210
00857B,永豐20年美公債,22,0,22,新百王,2024-09-12,6210
5876,上海商銀,27,5,22,新百王,2024-09-12,6210
00753L,中信中國50正2,44,22,22,新百王,2024-09-12,6210
2851,中再保,24,2,22,新百王,2024-09-12,6210
6216,居易,23,2,21,新百王,2024-09-12,6210
00664R,國泰臺灣加權反1,20,0,20,新百王,2024-09-12,6210
4442,竣邦-KY,20,0,20,新百王,2024-09-12,6210
3686,達能,20,0,20,新百王,2024-09-12,6210
2540,愛山林,19,0,19,新百王,2024-09-12,6210
3481,群創,28,10,18,新百王,2024-09-12,6210
3047,訊舟,34,17,17,新百王,2024-09-12,6210
3230,錦明,20,3,17,新百王,2024-09-12,6210
2887,台新金,37,21,16,新百王,2024-09-12,6210
4306,炎洲,14,0,14,新百王,2024-09-12,6210
00915,凱基優選高股息30,13,0,13,新百王,2024-09-12,6210
00676R,富邦臺灣加權反1,13,0,13,新百王,2024-09-12,6210
2402,毅嘉,34,21,13,新百王,2024-09-12,6210
2477,美隆電,20,7,13,新百王,2024-09-12,6210
3303,岱稜,28,16,12,新百王,2024-09-12,6210
3049,精金,12,0,12,新百王,2024-09-12,6210
911622,泰聚亨-DR,12,0,12,新百王,2024-09-12,6210
6231,系微,17,5,12,新百王,2024-09-12,6210
4935,茂林-KY,15,4,11,新百王,2024-09-12,6210
4510,高鋒,263,252,11,新百王,2024-09-12,6210
00680L,元大美債20正2,661,106,555,新百王,2024-09-13,6210
6603,富強鑫,380,30,350,新百王,2024-09-13,6210
2888,新光金,367,56,311,新百王,2024-09-13,6210
3050,鈺德,242,11,231,新百王,2024-09-13,6210
2405,輔信,215,0,215,新百王,2024-09-13,6210
00687B,國泰20年美債,132,43,89,新百王,2024-09-13,6210
00753L,中信中國50正2,109,22,87,新百王,2024-09-13,6210
3290,東浦,85,0,85,新百王,2024-09-13,6210
2344,華邦電,64,0,64,新百王,2024-09-13,6210
4720,德淵,60,0,60,新百王,2024-09-13,6210
00637L,元大滬深300正2,54,0,54,新百王,2024-09-13,6210
2497,怡利電,152,102,50,新百王,2024-09-13,6210
2890,永豐金,44,0,44,新百王,2024-09-13,6210
00929,復華台灣科技優息,32,0,32,新百王,2024-09-13,6210
2349,錸德,82,51,31,新百王,2024-09-13,6210
6405,悅城,33,4,29,新百王,2024-09-13,6210
4510,高鋒,59,31,28,新百王,2024-09-13,6210
00919,群益台灣精選高息,28,0,28,新百王,2024-09-13,6210
1524,耿鼎,26,1,25,新百王,2024-09-13,6210
6570,維田,22,1,21,新百王,2024-09-13,6210
5905,南仁湖,22,1,21,新百王,2024-09-13,6210
2233,宇隆,25,5,20,新百王,2024-09-13,6210
1708,東鹼,24,5,19,新百王,2024-09-13,6210
8043,蜜望實,16,0,16,新百王,2024-09-13,6210
6152,百一,17,1,16,新百王,2024-09-13,6210
4113,聯上,15,0,15,新百王,2024-09-13,6210
00795B,中信美國公債20年,15,0,15,新百王,2024-09-13,6210
4714,永捷,15,0,15,新百王,2024-09-13,6210
4420,光明,16,1,15,新百王,2024-09-13,6210
6125,廣運,21,7,14,新百王,2024-09-13,6210
5876,上海商銀,14,0,14,新百王,2024-09-13,6210
00921,兆豐龍頭等權重,14,0,14,新百王,2024-09-13,6210
3706,神達,16,3,13,新百王,2024-09-13,6210
1795,美時,13,0,13,新百王,2024-09-13,6210
1307,三芳,29,16,13,新百王,2024-09-13,6210
3047,訊舟,32,19,13,新百王,2024-09-13,6210
2317,鴻海,39,27,12,新百王,2024-09-13,6210
6215,和椿,13,2,11,新百王,2024-09-13,6210
3019,亞光,35,25,10,新百王,2024-09-13,6210
00946,群益科技高息成長,10,0,10,新百王,2024-09-13,6210
6219,富旺,10,0,10,新百王,2024-09-13,6210
1336,台翰,10,0,10,新百王,2024-09-13,6210
3711,日月光投控,10,0,10,新百王,2024-09-13,6210
00633L,富邦上証正2,10,0,10,新百王,2024-09-13,6210
2883,凱基金,10,0,10,新百王,2024-09-13,6210
2515,中工,10,1,9,新百王,2024-09-13,6210
2420,新巨,13,4,9,新百王,2024-09-13,6210
00881,國泰台灣5G+,9,0,9,新百王,2024-09-13,6210
3289,宜特,11,4,7,新百王,2024-09-13,6210
00675L,富邦臺灣加權正2,15,8,7,新百王,2024-09-13,6210
00712,復華富時不動產,178,33,145,新百王,2024-09-16,6210
3050,鈺德,123,3,120,新百王,2024-09-16,6210
00687B,國泰20年美債,125,11,114,新百王,2024-09-16,6210
2349,錸德,129,22,107,新百王,2024-09-16,6210
1467,南緯,101,0,101,新百王,2024-09-16,6210
1806,冠軍,107,11,96,新百王,2024-09-16,6210
1909,榮成,98,7,91,新百王,2024-09-16,6210
00929,復華台灣科技優息,97,8,89,新百王,2024-09-16,6210
3607,谷崧,87,14,73,新百王,2024-09-16,6210
00948B,中信優息投資級債,70,0,70,新百王,2024-09-16,6210
00878,國泰永續高股息,70,7,63,新百王,2024-09-16,6210
3062,建漢,168,115,53,新百王,2024-09-16,6210
1309,台達化,61,10,51,新百王,2024-09-16,6210
00655L,國泰中國A50正2,50,0,50,新百王,2024-09-16,6210
00650L,復華香港正2,50,0,50,新百王,2024-09-16,6210
00680L,元大美債20正2,52,3,49,新百王,2024-09-16,6210
00715L,期街口布蘭特正2,83,34,49,新百王,2024-09-16,6210
2431,聯昌,61,13,48,新百王,2024-09-16,6210
5230,雷笛克光學,60,16,44,新百王,2024-09-16,6210
2062,橋椿,57,13,44,新百王,2024-09-16,6210
00753L,中信中國50正2,46,4,42,新百王,2024-09-16,6210
00633L,富邦上証正2,40,0,40,新百王,2024-09-16,6210
3149,正達,40,4,36,新百王,2024-09-16,6210
00764B,群益25年美債,31,0,31,新百王,2024-09-16,6210
00919,群益台灣精選高息,44,15,29,新百王,2024-09-16,6210
00934,中信成長高股息,32,3,29,新百王,2024-09-16,6210
1709,和益,27,0,27,新百王,2024-09-16,6210
1313,聯成,26,0,26,新百王,2024-09-16,6210
00637L,元大滬深300正2,36,12,24,新百王,2024-09-16,6210
1710,東聯,21,0,21,新百王,2024-09-16,6210
3714,富采,22,3,19,新百王,2024-09-16,6210
1711,永光,73,54,19,新百王,2024-09-16,6210
2891,中信金,20,2,18,新百王,2024-09-16,6210
3360,尚立,43,26,17,新百王,2024-09-16,6210
2845,遠東銀,17,0,17,新百王,2024-09-16,6210
4933,友輝,17,1,16,新百王,2024-09-16,6210
2399,映泰,43,27,16,新百王,2024-09-16,6210
4526,東台,16,2,14,新百王,2024-09-16,6210
00918,大華優利高填息30,14,0,14,新百王,2024-09-16,6210
8464,億豐,14,0,14,新百王,2024-09-16,6210
8249,菱光,18,5,13,新百王,2024-09-16,6210
1605,華新,16,3,13,新百王,2024-09-16,6210
00642U,期元大S＆P石油,13,0,13,新百王,2024-09-16,6210
1434,福懋,24,11,13,新百王,2024-09-16,6210
020023,元大櫃買半導體N,13,0,13,新百王,2024-09-16,6210
9105,泰金寶-DR,13,0,13,新百王,2024-09-16,6210
2374,佳能,28,16,12,新百王,2024-09-16,6210
3705,永信,19,8,11,新百王,2024-09-16,6210
4974,亞泰,35,24,11,新百王,2024-09-16,6210
3036A,文曄甲特,11,0,11,新百王,2024-09-16,6210
00937B,群益ESG投等債20,652,20,632,新百王,2024-09-18,6210
00929,復華台灣科技優息,480,2,478,新百王,2024-09-18,6210
2888,新光金,954,696,258,新百王,2024-09-18,6210
00945B,凱基美國非投等債,160,0,160,新百王,2024-09-18,6210
2313,華通,121,9,112,新百王,2024-09-18,6210
2317,鴻海,123,25,98,新百王,2024-09-18,6210
2349,錸德,111,47,64,新百王,2024-09-18,6210
1806,冠軍,60,0,60,新百王,2024-09-18,6210
00712,復華富時不動產,59,0,59,新百王,2024-09-18,6210
6416,瑞祺電通,67,9,58,新百王,2024-09-18,6210
2887,台新金,53,1,52,新百王,2024-09-18,6210
2327,國巨,54,2,52,新百王,2024-09-18,6210
00720B,元大投資級公司債,51,5,46,新百王,2024-09-18,6210
00680L,元大美債20正2,53,10,43,新百王,2024-09-18,6210
3234,光環,40,1,39,新百王,2024-09-18,6210
2838,聯邦銀,45,7,38,新百王,2024-09-18,6210
00919,群益台灣精選高息,66,30,36,新百王,2024-09-18,6210
00949,復華日本龍頭,35,0,35,新百王,2024-09-18,6210
2426,鼎元,74,39,35,新百王,2024-09-18,6210
4903,聯光通,57,24,33,新百王,2024-09-18,6210
3481,群創,57,24,33,新百王,2024-09-18,6210
6116,彩晶,43,10,33,新百王,2024-09-18,6210
00708L,期元大S＆P黃金正2,32,1,31,新百王,2024-09-18,6210
2845,遠東銀,39,10,29,新百王,2024-09-18,6210
00915,凱基優選高股息30,28,0,28,新百王,2024-09-18,6210
4977,眾達-KY,76,48,28,新百王,2024-09-18,6210
3617,碩天,26,0,26,新百王,2024-09-18,6210
00934,中信成長高股息,26,0,26,新百王,2024-09-18,6210
1301,台塑,64,40,24,新百王,2024-09-18,6210
2892,第一金,27,3,24,新百王,2024-09-18,6210
4958,臻鼎-KY,20,1,19,新百王,2024-09-18,6210
2033,佳大,28,10,18,新百王,2024-09-18,6210
3034,聯詠,30,13,17,新百王,2024-09-18,6210
00637L,元大滬深300正2,29,12,17,新百王,2024-09-18,6210
2497,怡利電,104,87,17,新百王,2024-09-18,6210
2477,美隆電,36,20,16,新百王,2024-09-18,6210
8011,台通,16,0,16,新百王,2024-09-18,6210
00713,元大台灣高息低波,16,0,16,新百王,2024-09-18,6210
4576,大銀微系統,16,1,15,新百王,2024-09-18,6210
9103,美德醫療-DR,15,0,15,新百王,2024-09-18,6210
4909,新復興,20,5,15,新百王,2024-09-18,6210
2542,興富發,46,32,14,新百王,2024-09-18,6210
3605,宏致,44,30,14,新百王,2024-09-18,6210
1466,聚隆,13,0,13,新百王,2024-09-18,6210
5213,亞昕,16,3,13,新百王,2024-09-18,6210
8437,大地-KY,13,0,13,新百王,2024-09-18,6210
020023,元大櫃買半導體N,13,0,13,新百王,2024-09-18,6210
6147,頎邦,12,0,12,新百王,2024-09-18,6210
3284,太普高,13,1,12,新百王,2024-09-18,6210
8374,羅昇,27,16,11,新百王,2024-09-18,6210
00632R,元大台灣50反1,288,1,287,新百王,2024-09-19,6210
00857B,永豐20年美公債,283,0,283,新百王,2024-09-19,6210
00687B,國泰20年美債,204,20,184,新百王,2024-09-19,6210
2610,華航,101,0,101,新百王,2024-09-19,6210
00918,大華優利高填息30,96,5,91,新百王,2024-09-19,6210
00795B,中信美國公債20年,78,3,75,新百王,2024-09-19,6210
2344,華邦電,58,0,58,新百王,2024-09-19,6210
2399,映泰,220,163,57,新百王,2024-09-19,6210
9907,統一實,56,3,53,新百王,2024-09-19,6210
4904,遠傳,50,0,50,新百王,2024-09-19,6210
5488,松普,58,8,50,新百王,2024-09-19,6210
1217,愛之味,50,0,50,新百王,2024-09-19,6210
4967,十銓,49,0,49,新百王,2024-09-19,6210
00929,復華台灣科技優息,88,41,47,新百王,2024-09-19,6210
00676R,富邦臺灣加權反1,50,3,47,新百王,2024-09-19,6210
3049,精金,59,12,47,新百王,2024-09-19,6210
2891,中信金,51,7,44,新百王,2024-09-19,6210
2104,國際中橡,32,0,32,新百王,2024-09-19,6210
2303,聯電,132,101,31,新百王,2024-09-19,6210
2903,遠百,40,10,30,新百王,2024-09-19,6210
3363,上詮,60,30,30,新百王,2024-09-19,6210
3006,晶豪科,35,6,29,新百王,2024-09-19,6210
2363,矽統,20,0,20,新百王,2024-09-19,6210
00959B,大華投等美債15Y+,20,0,20,新百王,2024-09-19,6210
2801,彰銀,20,2,18,新百王,2024-09-19,6210
3360,尚立,50,32,18,新百王,2024-09-19,6210
6269,台郡,18,2,16,新百王,2024-09-19,6210
3447,展達,14,0,14,新百王,2024-09-19,6210
6219,富旺,14,0,14,新百王,2024-09-19,6210
6698,旭暉應材,35,21,14,新百王,2024-09-19,6210
00679B,元大美債20年,85,72,13,新百王,2024-09-19,6210
4977,眾達-KY,112,99,13,新百王,2024-09-19,6210
00706L,期元大S＆P日圓正2,12,0,12,新百王,2024-09-19,6210
6830,汎銓,23,11,12,新百王,2024-09-19,6210
3260,威剛,11,0,11,新百王,2024-09-19,6210
6425,易發,11,0,11,新百王,2024-09-19,6210
00930,永豐ESG低碳高息,10,0,10,新百王,2024-09-19,6210
00751B,元大AAA至A公司債,10,0,10,新百王,2024-09-19,6210
00773B,中信優先金融債,10,0,10,新百王,2024-09-19,6210
2243,宏旭-KY,18,8,10,新百王,2024-09-19,6210
00931B,統一美債20年,10,0,10,新百王,2024-09-19,6210
00693U,期街口S＆P黃豆,10,0,10,新百王,2024-09-19,6210
4513,福裕,53,43,10,新百王,2024-09-19,6210
1541,錩泰,10,0,10,新百王,2024-09-19,6210
2883B,凱基金乙特,10,0,10,新百王,2024-09-19,6210
00948B,中信優息投資級債,10,0,10,新百王,2024-09-19,6210
1609,大亞,17,7,10,新百王,2024-09-19,6210
2486,一詮,20,10,10,新百王,2024-09-19,6210
3597,映興,10,0,10,新百王,2024-09-19,6210
2834,臺企銀,55,45,10,新百王,2024-09-19,6210
2888,新光金,663,156,507,新百王,2024-09-20,6210
00632R,元大台灣50反1,432,69,363,新百王,2024-09-20,6210
00919,群益台灣精選高息,339,71,268,新百王,2024-09-20,6210
2399,映泰,247,103,144,新百王,2024-09-20,6210
00680L,元大美債20正2,140,0,140,新百王,2024-09-20,6210
4720,德淵,130,12,118,新百王,2024-09-20,6210
00665L,富邦�琤肭磪囓�2,214,115,99,新百王,2024-09-20,6210
3607,谷崧,100,10,90,新百王,2024-09-20,6210
1806,冠軍,130,45,85,新百王,2024-09-20,6210
8070,長華*,129,46,83,新百王,2024-09-20,6210
00669R,國泰美國道瓊反1,71,0,71,新百王,2024-09-20,6210
00948B,中信優息投資級債,70,0,70,新百王,2024-09-20,6210
3481,群創,86,17,69,新百王,2024-09-20,6210
00687B,國泰20年美債,64,8,56,新百王,2024-09-20,6210
3663,鑫科,126,71,55,新百王,2024-09-20,6210
00946,群益科技高息成長,52,0,52,新百王,2024-09-20,6210
00927,群益半導體收益,50,0,50,新百王,2024-09-20,6210
3188,鑫龍騰,51,2,49,新百王,2024-09-20,6210
6177,達麗,53,6,47,新百王,2024-09-20,6210
1817,凱撒衛,45,2,43,新百王,2024-09-20,6210
00637L,元大滬深300正2,79,38,41,新百王,2024-09-20,6210
3290,東浦,50,12,38,新百王,2024-09-20,6210
2887,台新金,220,182,38,新百王,2024-09-20,6210
00679B,元大美債20年,43,7,36,新百王,2024-09-20,6210
3047,訊舟,48,12,36,新百王,2024-09-20,6210
2303,聯電,82,47,35,新百王,2024-09-20,6210
4903,聯光通,64,33,31,新百王,2024-09-20,6210
2312,金寶,32,2,30,新百王,2024-09-20,6210
00958B,永豐ESG銀行債15,25,0,25,新百王,2024-09-20,6210
2062,橋椿,26,3,23,新百王,2024-09-20,6210
3702,大聯大,25,2,23,新百王,2024-09-20,6210
00631L,元大台灣50正2,31,8,23,新百王,2024-09-20,6210
4306,炎洲,24,2,22,新百王,2024-09-20,6210
2915,潤泰全,25,3,22,新百王,2024-09-20,6210
00929,復華台灣科技優息,107,86,21,新百王,2024-09-20,6210
5519,隆大,38,17,21,新百王,2024-09-20,6210
9940,信義,20,0,20,新百王,2024-09-20,6210
4113,聯上,24,5,19,新百王,2024-09-20,6210
5876,上海商銀,20,1,19,新百王,2024-09-20,6210
6257,矽格,25,6,19,新百王,2024-09-20,6210
3390,旭軟,41,22,19,新百王,2024-09-20,6210
4956,光鋐,20,1,19,新百王,2024-09-20,6210
00764B,群益25年美債,18,0,18,新百王,2024-09-20,6210
3213,茂訊,27,9,18,新百王,2024-09-20,6210
2382,廣達,41,24,17,新百王,2024-09-20,6210
2845,遠東銀,17,0,17,新百王,2024-09-20,6210
2464,盟立,106,89,17,新百王,2024-09-20,6210
4526,東台,38,22,16,新百王,2024-09-20,6210
6698,旭暉應材,16,0,16,新百王,2024-09-20,6210
1527,鑽全,16,0,16,新百王,2024-09-20,6210
00957B,兆豐US優選投等債,200,0,200,新百王,2024-09-23,6210
4113,聯上,215,16,199,新百王,2024-09-23,6210
3607,谷崧,191,41,150,新百王,2024-09-23,6210
00632R,元大台灣50反1,123,10,113,新百王,2024-09-23,6210
3615,安可,151,39,112,新百王,2024-09-23,6210
00948B,中信優息投資級債,105,0,105,新百王,2024-09-23,6210
00712,復華富時不動產,101,1,100,新百王,2024-09-23,6210
8070,長華*,116,20,96,新百王,2024-09-23,6210
00919,群益台灣精選高息,100,13,87,新百王,2024-09-23,6210
00680L,元大美債20正2,81,0,81,新百王,2024-09-23,6210
6213,聯茂,80,4,76,新百王,2024-09-23,6210
00937B,群益ESG投等債20,63,0,63,新百王,2024-09-23,6210
1539,巨庭,82,22,60,新百王,2024-09-23,6210
4714,永捷,54,0,54,新百王,2024-09-23,6210
1711,永光,99,53,46,新百王,2024-09-23,6210
2464,盟立,70,25,45,新百王,2024-09-23,6210
00931B,統一美債20年,44,0,44,新百王,2024-09-23,6210
4716,大立,81,39,42,新百王,2024-09-23,6210
4538,大詠城,35,0,35,新百王,2024-09-23,6210
8096,擎亞,49,15,34,新百王,2024-09-23,6210
1709,和益,33,0,33,新百王,2024-09-23,6210
3290,東浦,31,0,31,新百王,2024-09-23,6210
00687B,國泰20年美債,55,25,30,新百王,2024-09-23,6210
3213,茂訊,43,14,29,新百王,2024-09-23,6210
3360,尚立,53,25,28,新百王,2024-09-23,6210
3673,TPK-KY,35,9,26,新百王,2024-09-23,6210
1785,光洋科,64,40,24,新百王,2024-09-23,6210
3188,鑫龍騰,28,5,23,新百王,2024-09-23,6210
2243,宏旭-KY,24,2,22,新百王,2024-09-23,6210
3149,正達,110,88,22,新百王,2024-09-23,6210
6405,悅城,54,32,22,新百王,2024-09-23,6210
2027,大成鋼,20,0,20,新百王,2024-09-23,6210
00688L,國泰20年美債正2,22,3,19,新百王,2024-09-23,6210
4931,新盛力,25,6,19,新百王,2024-09-23,6210
4540,全球傳動,20,2,18,新百王,2024-09-23,6210
00878,國泰永續高股息,16,1,15,新百王,2024-09-23,6210
2062,橋椿,31,16,15,新百王,2024-09-23,6210
9105,泰金寶-DR,15,0,15,新百王,2024-09-23,6210
8446,華研,19,4,15,新百王,2024-09-23,6210
3481,群創,124,110,14,新百王,2024-09-23,6210
1316,上曜,14,1,13,新百王,2024-09-23,6210
6186,新潤,14,1,13,新百王,2024-09-23,6210
2312,金寶,13,1,12,新百王,2024-09-23,6210
1540,喬福,13,1,12,新百王,2024-09-23,6210
2542,興富發,19,8,11,新百王,2024-09-23,6210
2206,三陽工業,11,0,11,新百王,2024-09-23,6210
3645,達邁,11,0,11,新百王,2024-09-23,6210
6117,迎廣,12,1,11,新百王,2024-09-23,6210
2442,新美齊,11,1,10,新百王,2024-09-23,6210
1721,三晃,88,78,10,新百王,2024-09-23,6210
2349,錸德,500,54,446,新百王,2024-09-24,6210
2609,陽明,291,168,123,新百王,2024-09-24,6210
1718,中纖,86,10,76,新百王,2024-09-24,6210
00680L,元大美債20正2,83,11,72,新百王,2024-09-24,6210
6405,悅城,69,13,56,新百王,2024-09-24,6210
3605,宏致,82,27,55,新百王,2024-09-24,6210
00953B,群益優選非投等債,50,0,50,新百王,2024-09-24,6210
3066,李洲,64,14,50,新百王,2024-09-24,6210
00706L,期元大S＆P日圓正2,50,0,50,新百王,2024-09-24,6210
00712,復華富時不動產,66,20,46,新百王,2024-09-24,6210
1584,精剛,65,19,46,新百王,2024-09-24,6210
3550,聯穎,97,53,44,新百王,2024-09-24,6210
00948B,中信優息投資級債,60,20,40,新百王,2024-09-24,6210
5488,松普,40,0,40,新百王,2024-09-24,6210
00687B,國泰20年美債,37,0,37,新百王,2024-09-24,6210
3163,波若威,33,3,30,新百王,2024-09-24,6210
00929,復華台灣科技優息,35,5,30,新百王,2024-09-24,6210
4729,熒茂,47,20,27,新百王,2024-09-24,6210
00795B,中信美國公債20年,27,0,27,新百王,2024-09-24,6210
4526,東台,35,10,25,新百王,2024-09-24,6210
6770,力積電,24,0,24,新百王,2024-09-24,6210
3006,晶豪科,24,2,22,新百王,2024-09-24,6210
2313,華通,23,1,22,新百王,2024-09-24,6210
1810,和成,21,0,21,新百王,2024-09-24,6210
8074,鉅橡,21,0,21,新百王,2024-09-24,6210
2892,第一金,20,0,20,新百王,2024-09-24,6210
2515,中工,18,0,18,新百王,2024-09-24,6210
3035,智原,17,0,17,新百王,2024-09-24,6210
2303,聯電,108,91,17,新百王,2024-09-24,6210
8021,尖點,19,3,16,新百王,2024-09-24,6210
00936,台新永續高息中小,20,5,15,新百王,2024-09-24,6210
00715L,期街口布蘭特正2,92,78,14,新百王,2024-09-24,6210
020023,元大櫃買半導體N,14,0,14,新百王,2024-09-24,6210
3715,定穎投控,62,49,13,新百王,2024-09-24,6210
6186,新潤,15,2,13,新百王,2024-09-24,6210
2344,華邦電,31,18,13,新百王,2024-09-24,6210
00664R,國泰臺灣加權反1,13,0,13,新百王,2024-09-24,6210
1708,東鹼,15,3,12,新百王,2024-09-24,6210
1514,亞力,15,3,12,新百王,2024-09-24,6210
00931B,統一美債20年,11,0,11,新百王,2024-09-24,6210
00857B,永豐20年美公債,11,0,11,新百王,2024-09-24,6210
3450,聯鈞,62,51,11,新百王,2024-09-24,6210
4442,竣邦-KY,11,0,11,新百王,2024-09-24,6210
2027,大成鋼,10,0,10,新百王,2024-09-24,6210
2537,聯上發,10,0,10,新百王,2024-09-24,6210
1316,上曜,10,0,10,新百王,2024-09-24,6210
2520,冠德,15,5,10,新百王,2024-09-24,6210
6197,佳必琪,30,21,9,新百王,2024-09-24,6210
3037,欣興,27,18,9,新百王,2024-09-24,6210
8011,台通,10,1,9,新百王,2024-09-24,6210
00632R,元大台灣50反1,849,157,692,新百王,2024-09-25,6210
00882,中信中國高股息,420,16,404,新百王,2024-09-25,6210
2883,凱基金,288,97,191,新百王,2024-09-25,6210
2610,華航,209,101,108,新百王,2024-09-25,6210
00676R,富邦臺灣加權反1,100,0,100,新百王,2024-09-25,6210
00688L,國泰20年美債正2,100,0,100,新百王,2024-09-25,6210
2070,精湛,99,2,97,新百王,2024-09-25,6210
00948B,中信優息投資級債,100,10,90,新百王,2024-09-25,6210
9105,泰金寶-DR,82,0,82,新百王,2024-09-25,6210
00945B,凱基美國非投等債,80,0,80,新百王,2024-09-25,6210
3615,安可,90,17,73,新百王,2024-09-25,6210
2891,中信金,97,25,72,新百王,2024-09-25,6210
8374,羅昇,85,15,70,新百王,2024-09-25,6210
00953B,群益優選非投等債,100,40,60,新百王,2024-09-25,6210
00679B,元大美債20年,92,40,52,新百王,2024-09-25,6210
00706L,期元大S＆P日圓正2,50,0,50,新百王,2024-09-25,6210
00929,復華台灣科技優息,96,56,40,新百王,2024-09-25,6210
1718,中纖,40,0,40,新百王,2024-09-25,6210
5488,松普,131,91,40,新百王,2024-09-25,6210
00753L,中信中國50正2,87,49,38,新百王,2024-09-25,6210
2607,榮運,42,5,37,新百王,2024-09-25,6210
3481,群創,36,0,36,新百王,2024-09-25,6210
00687B,國泰20年美債,83,50,33,新百王,2024-09-25,6210
2399,映泰,211,179,32,新百王,2024-09-25,6210
3714,富采,33,6,27,新百王,2024-09-25,6210
00713,元大台灣高息低波,26,0,26,新百王,2024-09-25,6210
1727,中華化,30,5,25,新百王,2024-09-25,6210
2884,玉山金,25,1,24,新百王,2024-09-25,6210
00712,復華富時不動產,20,0,20,新百王,2024-09-25,6210
6237,驊訊,21,1,20,新百王,2024-09-25,6210
4763,材料-KY,37,17,20,新百王,2024-09-25,6210
2515,中工,19,0,19,新百王,2024-09-25,6210
6505,台塑化,19,0,19,新百王,2024-09-25,6210
6698,旭暉應材,25,8,17,新百王,2024-09-25,6210
1710,東聯,15,0,15,新百王,2024-09-25,6210
1776,展宇,15,0,15,新百王,2024-09-25,6210
4535,至興,15,0,15,新百王,2024-09-25,6210
8074,鉅橡,15,0,15,新百王,2024-09-25,6210
2605,新興,15,2,13,新百王,2024-09-25,6210
1582,信錦,13,1,12,新百王,2024-09-25,6210
2401,凌陽,13,1,12,新百王,2024-09-25,6210
4571,鈞興-KY,24,12,12,新百王,2024-09-25,6210
1805,寶徠,12,0,12,新百王,2024-09-25,6210
00642U,期元大S＆P石油,11,0,11,新百王,2024-09-25,6210
2201,裕隆,12,1,11,新百王,2024-09-25,6210
2243,宏旭-KY,11,0,11,新百王,2024-09-25,6210
5398,慕康生醫,11,0,11,新百王,2024-09-25,6210
2888,新光金,282,272,10,新百王,2024-09-25,6210
4977,眾達-KY,16,6,10,新百王,2024-09-25,6210
00857B,永豐20年美公債,12,2,10,新百王,2024-09-25,6210
00715L,期街口布蘭特正2,277,63,214,新百王,2024-09-26,6210
00957B,兆豐US優選投等債,200,0,200,新百王,2024-09-26,6210
2607,榮運,213,91,122,新百王,2024-09-26,6210
00948B,中信優息投資級債,145,50,95,新百王,2024-09-26,6210
2891,中信金,101,20,81,新百王,2024-09-26,6210
00676R,富邦臺灣加權反1,80,0,80,新百王,2024-09-26,6210
8070,長華*,92,13,79,新百王,2024-09-26,6210
2344,華邦電,99,24,75,新百王,2024-09-26,6210
6237,驊訊,71,1,70,新百王,2024-09-26,6210
9105,泰金寶-DR,70,0,70,新百王,2024-09-26,6210
1808,潤隆,78,11,67,新百王,2024-09-26,6210
2070,精湛,65,3,62,新百王,2024-09-26,6210
2836,高雄銀,74,16,58,新百王,2024-09-26,6210
00795B,中信美國公債20年,58,1,57,新百王,2024-09-26,6210
00960,野村全球航運龍頭,90,35,55,新百王,2024-09-26,6210
6603,富強鑫,46,6,40,新百王,2024-09-26,6210
2451,創見,40,0,40,新百王,2024-09-26,6210
2637,慧洋-KY,41,4,37,新百王,2024-09-26,6210
1309,台達化,33,1,32,新百王,2024-09-26,6210
00688L,國泰20年美債正2,28,0,28,新百王,2024-09-26,6210
8927,北基,26,2,24,新百王,2024-09-26,6210
00706L,期元大S＆P日圓正2,22,0,22,新百王,2024-09-26,6210
3147,大綜,24,4,20,新百王,2024-09-26,6210
2323,中環,20,0,20,新百王,2024-09-26,6210
6739,竹陞科技,21,1,20,新百王,2024-09-26,6210
8121,越峰,20,0,20,新百王,2024-09-26,6210
2543,皇昌,41,21,20,新百王,2024-09-26,6210
00720B,元大投資級公司債,19,0,19,新百王,2024-09-26,6210
4540,全球傳動,19,0,19,新百王,2024-09-26,6210
4109,加捷生醫,19,0,19,新百王,2024-09-26,6210
00712,復華富時不動產,20,2,18,新百王,2024-09-26,6210
2464,盟立,24,6,18,新百王,2024-09-26,6210
6531,愛普*,22,5,17,新百王,2024-09-26,6210
2801,彰銀,16,0,16,新百王,2024-09-26,6210
4763,材料-KY,15,0,15,新百王,2024-09-26,6210
1584,精剛,31,16,15,新百王,2024-09-26,6210
2436,偉詮電,26,11,15,新百王,2024-09-26,6210
1540,喬福,67,53,14,新百王,2024-09-26,6210
4909,新復興,82,68,14,新百王,2024-09-26,6210
2243,宏旭-KY,15,1,14,新百王,2024-09-26,6210
9955,佳龍,23,10,13,新百王,2024-09-26,6210
0056,元大高股息,13,0,13,新百王,2024-09-26,6210
8213,志超,13,0,13,新百王,2024-09-26,6210
4526,東台,12,0,12,新百王,2024-09-26,6210
1314,中石化,23,11,12,新百王,2024-09-26,6210
3033,威健,16,4,12,新百王,2024-09-26,6210
3673,TPK-KY,14,2,12,新百王,2024-09-26,6210
4303,信立,12,0,12,新百王,2024-09-26,6210
2317,鴻海,96,85,11,新百王,2024-09-26,6210
00642U,期元大S＆P石油,11,0,11,新百王,2024-09-26,6210
2888,新光金,834,126,708,新百王,2024-09-27,6210
00960,野村全球航運龍頭,619,245,374,新百王,2024-09-27,6210
00687B,國泰20年美債,286,4,282,新百王,2024-09-27,6210
00753L,中信中國50正2,423,242,181,新百王,2024-09-27,6210
00715L,期街口布蘭特正2,169,8,161,新百王,2024-09-27,6210
2883,凱基金,400,250,150,新百王,2024-09-27,6210
2349,錸德,153,22,131,新百王,2024-09-27,6210
2891,中信金,146,16,130,新百王,2024-09-27,6210
1608,華榮,125,0,125,新百王,2024-09-27,6210
2313,華通,116,2,114,新百王,2024-09-27,6210
8213,志超,105,0,105,新百王,2024-09-27,6210
00679B,元大美債20年,141,38,103,新百王,2024-09-27,6210
2887,台新金,101,0,101,新百王,2024-09-27,6210
8111,立��,89,27,62,新百王,2024-09-27,6210
4903,聯光通,78,17,61,新百王,2024-09-27,6210
00945B,凱基美國非投等債,60,0,60,新百王,2024-09-27,6210
9105,泰金寶-DR,50,0,50,新百王,2024-09-27,6210
00764B,群益25年美債,50,0,50,新百王,2024-09-27,6210
00953B,群益優選非投等債,50,0,50,新百王,2024-09-27,6210
00948B,中信優息投資級債,70,20,50,新百王,2024-09-27,6210
3163,波若威,58,12,46,新百王,2024-09-27,6210
2881,富邦金,43,5,38,新百王,2024-09-27,6210
2884,玉山金,37,0,37,新百王,2024-09-27,6210
00935,野村臺灣新科技50,37,0,37,新百王,2024-09-27,6210
2641,正德,53,17,36,新百王,2024-09-27,6210
00950B,凱基A級公司債,35,0,35,新百王,2024-09-27,6210
4711,永純,37,2,35,新百王,2024-09-27,6210
00929,復華台灣科技優息,36,5,31,新百王,2024-09-27,6210
1806,冠軍,49,20,29,新百王,2024-09-27,6210
8240,華宏,24,0,24,新百王,2024-09-27,6210
00795B,中信美國公債20年,27,4,23,新百王,2024-09-27,6210
00931B,統一美債20年,28,5,23,新百王,2024-09-27,6210
00642U,期元大S＆P石油,23,1,22,新百王,2024-09-27,6210
4569,六方科-KY,20,0,20,新百王,2024-09-27,6210
2354,鴻準,27,7,20,新百王,2024-09-27,6210
6127,九豪,20,0,20,新百王,2024-09-27,6210
1605,華新,25,8,17,新百王,2024-09-27,6210
00757,統一FANG+,17,0,17,新百王,2024-09-27,6210
1708,東鹼,21,4,17,新百王,2024-09-27,6210
1539,巨庭,25,9,16,新百王,2024-09-27,6210
6505,台塑化,18,3,15,新百王,2024-09-27,6210
4306,炎洲,15,0,15,新百王,2024-09-27,6210
8039,台虹,16,2,14,新百王,2024-09-27,6210
3711,日月光投控,33,20,13,新百王,2024-09-27,6210
1785,光洋科,32,20,12,新百王,2024-09-27,6210
1307,三芳,15,3,12,新百王,2024-09-27,6210
2303,聯電,62,50,12,新百王,2024-09-27,6210
3363,上詮,49,37,12,新百王,2024-09-27,6210
2436,偉詮電,19,7,12,新百王,2024-09-27,6210
5876,上海商銀,11,0,11,新百王,2024-09-27,6210
00680L,元大美債20正2,537,211,326,新百王,2024-09-30,6210
00637L,元大滬深300正2,1727,1415,312,新百王,2024-09-30,6210
00688L,國泰20年美債正2,415,105,310,新百王,2024-09-30,6210
00948B,中信優息投資級債,267,40,227,新百王,2024-09-30,6210
00937B,群益ESG投等債20,226,0,226,新百王,2024-09-30,6210
00929,復華台灣科技優息,208,0,208,新百王,2024-09-30,6210
2610,華航,167,13,154,新百王,2024-09-30,6210
00665L,富邦�琤肭磪囓�2,314,215,99,新百王,2024-09-30,6210
2313,華通,117,30,87,新百王,2024-09-30,6210
2891,中信金,88,2,86,新百王,2024-09-30,6210
2317,鴻海,86,16,70,新百王,2024-09-30,6210
00931B,統一美債20年,65,3,62,新百王,2024-09-30,6210
8111,立��,146,86,60,新百王,2024-09-30,6210
2637,慧洋-KY,98,41,57,新百王,2024-09-30,6210
2845,遠東銀,57,0,57,新百王,2024-09-30,6210
00634R,富邦上証反1,55,0,55,新百王,2024-09-30,6210
00882,中信中國高股息,57,8,49,新百王,2024-09-30,6210
2836,高雄銀,48,0,48,新百王,2024-09-30,6210
0056,元大高股息,46,0,46,新百王,2024-09-30,6210
1326,台化,51,5,46,新百王,2024-09-30,6210
4123,晟德,45,0,45,新百王,2024-09-30,6210
00905,FT臺灣Smart,44,0,44,新百王,2024-09-30,6210
00918,大華優利高填息30,43,0,43,新百王,2024-09-30,6210
2892,第一金,41,1,40,新百王,2024-09-30,6210
1217,愛之味,40,0,40,新百王,2024-09-30,6210
00945B,凱基美國非投等債,40,0,40,新百王,2024-09-30,6210
3703,欣陸,40,0,40,新百王,2024-09-30,6210
2330,台積電,57,18,39,新百王,2024-09-30,6210
2897,王道銀行,69,30,39,新百王,2024-09-30,6210
2243,宏旭-KY,60,21,39,新百王,2024-09-30,6210
3715,定穎投控,56,24,32,新百王,2024-09-30,6210
00638R,元大滬深300反1,30,0,30,新百王,2024-09-30,6210
2897B,王道銀乙特,30,0,30,新百王,2024-09-30,6210
2609,陽明,51,23,28,新百王,2024-09-30,6210
5905,南仁湖,30,3,27,新百王,2024-09-30,6210
00919,群益台灣精選高息,26,0,26,新百王,2024-09-30,6210
00953B,群益優選非投等債,25,0,25,新百王,2024-09-30,6210
1785,光洋科,24,0,24,新百王,2024-09-30,6210
2382,廣達,69,47,22,新百王,2024-09-30,6210
00712,復華富時不動產,22,0,22,新百王,2024-09-30,6210
00946,群益科技高息成長,32,11,21,新百王,2024-09-30,6210
00923,群益台ESG低碳50,21,0,21,新百王,2024-09-30,6210
3615,安可,21,0,21,新百王,2024-09-30,6210
00651R,復華香港反1,20,0,20,新百王,2024-09-30,6210
2353,宏��,21,1,20,新百王,2024-09-30,6210
3711,日月光投控,31,13,18,新百王,2024-09-30,6210
00878,國泰永續高股息,15,0,15,新百王,2024-09-30,6210
1303,南亞,18,3,15,新百王,2024-09-30,6210
1309,台達化,32,17,15,新百王,2024-09-30,6210
6743,安普新,12,0,12,新百王,2024-09-30,6210
2888,新光金,795,420,375,新百王,2024-10-01,6210
00665L,富邦�琤肭磪囓�2,681,359,322,新百王,2024-10-01,6210
5876,上海商銀,234,0,234,新百王,2024-10-01,6210
00632R,元大台灣50反1,201,5,196,新百王,2024-10-01,6210
00687B,國泰20年美債,145,11,134,新百王,2024-10-01,6210
00934,中信成長高股息,100,5,95,新百王,2024-10-01,6210
00679B,元大美債20年,71,3,68,新百王,2024-10-01,6210
00919,群益台灣精選高息,68,0,68,新百王,2024-10-01,6210
2313,華通,65,5,60,新百王,2024-10-01,6210
00680L,元大美債20正2,55,0,55,新百王,2024-10-01,6210
00929,復華台灣科技優息,54,2,52,新百王,2024-10-01,6210
2883,凱基金,98,47,51,新百王,2024-10-01,6210
00638R,元大滬深300反1,50,0,50,新百王,2024-10-01,6210
2836,高雄銀,50,0,50,新百王,2024-10-01,6210
2317,鴻海,49,13,36,新百王,2024-10-01,6210
00634R,富邦上証反1,35,0,35,新百王,2024-10-01,6210
2897B,王道銀乙特,30,0,30,新百王,2024-10-01,6210
2399,映泰,95,65,30,新百王,2024-10-01,6210
00960,野村全球航運龍頭,45,20,25,新百王,2024-10-01,6210
020037,元大金融高股息N,24,0,24,新百王,2024-10-01,6210
1340,勝悅-KY,24,0,24,新百王,2024-10-01,6210
00795B,中信美國公債20年,35,12,23,新百王,2024-10-01,6210
3013,晟銘電,32,11,21,新百王,2024-10-01,6210
6188,廣明,22,1,21,新百王,2024-10-01,6210
00882,中信中國高股息,41,21,20,新百王,2024-10-01,6210
00937B,群益ESG投等債20,20,0,20,新百王,2024-10-01,6210
8048,德勝,20,0,20,新百王,2024-10-01,6210
9105,泰金寶-DR,20,0,20,新百王,2024-10-01,6210
00948B,中信優息投資級債,62,42,20,新百王,2024-10-01,6210
1540,喬福,29,10,19,新百王,2024-10-01,6210
2845,遠東銀,29,11,18,新百王,2024-10-01,6210
3580,友威科,21,3,18,新百王,2024-10-01,6210
8201,無敵,18,0,18,新百王,2024-10-01,6210
00878,國泰永續高股息,22,5,17,新百王,2024-10-01,6210
00688L,國泰20年美債正2,17,0,17,新百王,2024-10-01,6210
1907,永豐餘,17,0,17,新百王,2024-10-01,6210
4903,聯光通,41,25,16,新百王,2024-10-01,6210
3576,聯合再生,103,87,16,新百王,2024-10-01,6210
00713,元大台灣高息低波,16,0,16,新百王,2024-10-01,6210
0051,元大中型100,15,0,15,新百王,2024-10-01,6210
8028,昇陽半導體,19,4,15,新百王,2024-10-01,6210
3615,安可,17,3,14,新百王,2024-10-01,6210
2542,興富發,16,2,14,新百王,2024-10-01,6210
3499,環天科,14,0,14,新百王,2024-10-01,6210
2371,大同,41,27,14,新百王,2024-10-01,6210
00915,凱基優選高股息30,13,0,13,新百王,2024-10-01,6210
020032,元大綠能N,13,0,13,新百王,2024-10-01,6210
3234,光環,13,0,13,新百王,2024-10-01,6210
6869,雲豹能源,18,6,12,新百王,2024-10-01,6210
00706L,期元大S＆P日圓正2,12,0,12,新百王,2024-10-01,6210
00680L,元大美債20正2,555,0,555,新百王,2024-10-04,6210
2607,榮運,189,24,165,新百王,2024-10-04,6210
2610,華航,139,0,139,新百王,2024-10-04,6210
00937B,群益ESG投等債20,115,8,107,新百王,2024-10-04,6210
2887,台新金,103,0,103,新百王,2024-10-04,6210
00632R,元大台灣50反1,160,74,86,新百王,2024-10-04,6210
9907,統一實,131,59,72,新百王,2024-10-04,6210
4569,六方科-KY,71,4,67,新百王,2024-10-04,6210
2897,王道銀行,100,40,60,新百王,2024-10-04,6210
00651R,復華香港反1,60,0,60,新百王,2024-10-04,6210
00634R,富邦上証反1,60,0,60,新百王,2024-10-04,6210
2070,精湛,63,11,52,新百王,2024-10-04,6210
1808,潤隆,50,0,50,新百王,2024-10-04,6210
00638R,元大滬深300反1,50,0,50,新百王,2024-10-04,6210
5512,力麒,48,0,48,新百王,2024-10-04,6210
5014,建錩,45,0,45,新百王,2024-10-04,6210
0056,元大高股息,47,3,44,新百王,2024-10-04,6210
2884,玉山金,43,0,43,新百王,2024-10-04,6210
2303,聯電,43,0,43,新百王,2024-10-04,6210
2603,長榮,49,7,42,新百王,2024-10-04,6210
3045,台灣大,58,17,41,新百王,2024-10-04,6210
2062,橋椿,41,1,40,新百王,2024-10-04,6210
00929,復華台灣科技優息,42,2,40,新百王,2024-10-04,6210
00673R,期元大S＆P原油反1,35,0,35,新百王,2024-10-04,6210
2412,中華電,31,1,30,新百王,2024-10-04,6210
3062,建漢,36,7,29,新百王,2024-10-04,6210
00712,復華富時不動產,27,0,27,新百王,2024-10-04,6210
2489,瑞軒,27,0,27,新百王,2024-10-04,6210
2618,長榮航,39,13,26,新百王,2024-10-04,6210
1609,大亞,29,5,24,新百王,2024-10-04,6210
1742,台蠟,25,3,22,新百王,2024-10-04,6210
6163,華電網,22,0,22,新百王,2024-10-04,6210
4971,IET-KY,23,2,21,新百王,2024-10-04,6210
9927,泰銘,20,0,20,新百王,2024-10-04,6210
2897B,王道銀乙特,20,0,20,新百王,2024-10-04,6210
2836,高雄銀,20,0,20,新百王,2024-10-04,6210
2888B,新光金乙特,18,0,18,新百王,2024-10-04,6210
4903,聯光通,92,74,18,新百王,2024-10-04,6210
2609,陽明,55,39,16,新百王,2024-10-04,6210
00918,大華優利高填息30,15,0,15,新百王,2024-10-04,6210
00960,野村全球航運龍頭,16,1,15,新百王,2024-10-04,6210
6901,鑽石投資,15,0,15,新百王,2024-10-04,6210
00936,台新永續高息中小,19,5,14,新百王,2024-10-04,6210
3213,茂訊,15,1,14,新百王,2024-10-04,6210
8111,立��,64,50,14,新百王,2024-10-04,6210
1301,台塑,15,1,14,新百王,2024-10-04,6210
6443,元晶,14,0,14,新百王,2024-10-04,6210
2892,第一金,19,6,13,新百王,2024-10-04,6210
1727,中華化,34,21,13,新百王,2024-10-04,6210
8249,菱光,20,7,13,新百王,2024-10-04,6210
00632R,元大台灣50反1,1684,10,1674,新百王,2024-10-07,6210
00680L,元大美債20正2,441,128,313,新百王,2024-10-07,6210
00753L,中信中國50正2,659,424,235,新百王,2024-10-07,6210
00882,中信中國高股息,315,111,204,新百王,2024-10-07,6210
00929,復華台灣科技優息,167,2,165,新百王,2024-10-07,6210
2888,新光金,174,14,160,新百王,2024-10-07,6210
00688L,國泰20年美債正2,142,0,142,新百王,2024-10-07,6210
00637L,元大滬深300正2,264,122,142,新百王,2024-10-07,6210
2615,萬海,157,47,110,新百王,2024-10-07,6210
00687B,國泰20年美債,127,25,102,新百王,2024-10-07,6210
00665L,富邦�琤肭磪囓�2,314,221,93,新百王,2024-10-07,6210
5014,建錩,88,2,86,新百王,2024-10-07,6210
00752,中信中國50,100,15,85,新百王,2024-10-07,6210
00795B,中信美國公債20年,79,0,79,新百王,2024-10-07,6210
00919,群益台灣精選高息,77,0,77,新百王,2024-10-07,6210
2313,華通,82,8,74,新百王,2024-10-07,6210
00706L,期元大S＆P日圓正2,92,20,72,新百王,2024-10-07,6210
1303,南亞,73,11,62,新百王,2024-10-07,6210
00936,台新永續高息中小,66,7,59,新百王,2024-10-07,6210
6216,居易,64,7,57,新百王,2024-10-07,6210
9105,泰金寶-DR,51,0,51,新百王,2024-10-07,6210
5481,新華,50,0,50,新百王,2024-10-07,6210
3437,榮創,35,0,35,新百王,2024-10-07,6210
2892,第一金,35,0,35,新百王,2024-10-07,6210
4113,聯上,41,7,34,新百王,2024-10-07,6210
2317,鴻海,52,19,33,新百王,2024-10-07,6210
3213,茂訊,30,0,30,新百王,2024-10-07,6210
1201,味全,30,0,30,新百王,2024-10-07,6210
2897B,王道銀乙特,30,0,30,新百王,2024-10-07,6210
6530,創威,41,12,29,新百王,2024-10-07,6210
00651R,復華香港反1,26,0,26,新百王,2024-10-07,6210
00948B,中信優息投資級債,24,0,24,新百王,2024-10-07,6210
00887,永豐中國科技50大,59,36,23,新百王,2024-10-07,6210
6163,華電網,25,2,23,新百王,2024-10-07,6210
8111,立��,143,120,23,新百王,2024-10-07,6210
00946,群益科技高息成長,21,0,21,新百王,2024-10-07,6210
6244,茂迪,20,0,20,新百王,2024-10-07,6210
00664R,國泰臺灣加權反1,20,0,20,新百王,2024-10-07,6210
00725B,國泰投資級公司債,20,0,20,新百王,2024-10-07,6210
1402,遠東新,20,0,20,新百王,2024-10-07,6210
4109,加捷生醫,20,0,20,新百王,2024-10-07,6210
6257,矽格,20,0,20,新百王,2024-10-07,6210
2455,全新,35,16,19,新百王,2024-10-07,6210
8047,星雲,18,0,18,新百王,2024-10-07,6210
2845,遠東銀,20,3,17,新百王,2024-10-07,6210
1314,中石化,50,33,17,新百王,2024-10-07,6210
6118,建達,20,3,17,新百王,2024-10-07,6210
8411,福貞-KY,28,11,17,新百王,2024-10-07,6210
3615,安可,29,13,16,新百王,2024-10-07,6210
2353,宏��,29,13,16,新百王,2024-10-07,6210
00948B,中信優息投資級債,295,60,235,新百王,2024-10-08,6210
00882,中信中國高股息,482,301,181,新百王,2024-10-08,6210
00679B,元大美債20年,175,20,155,新百王,2024-10-08,6210
00918,大華優利高填息30,123,0,123,新百王,2024-10-08,6210
2888,新光金,315,195,120,新百王,2024-10-08,6210
4113,聯上,127,9,118,新百王,2024-10-08,6210
5876,上海商銀,114,0,114,新百王,2024-10-08,6210
2883,凱基金,310,204,106,新百王,2024-10-08,6210
00929,復華台灣科技優息,102,0,102,新百王,2024-10-08,6210
2101,南港,94,5,89,新百王,2024-10-08,6210
00688L,國泰20年美債正2,89,0,89,新百王,2024-10-08,6210
00937B,群益ESG投等債20,87,10,77,新百王,2024-10-08,6210
1718,中纖,75,0,75,新百王,2024-10-08,6210
1806,冠軍,69,1,68,新百王,2024-10-08,6210
00687B,國泰20年美債,136,73,63,新百王,2024-10-08,6210
2607,榮運,63,0,63,新百王,2024-10-08,6210
00936,台新永續高息中小,60,2,58,新百王,2024-10-08,6210
2399,映泰,403,346,57,新百王,2024-10-08,6210
1314,中石化,57,0,57,新百王,2024-10-08,6210
8105,凌巨,50,0,50,新百王,2024-10-08,6210
00940,元大台灣價值高息,49,0,49,新百王,2024-10-08,6210
2317,鴻海,79,32,47,新百王,2024-10-08,6210
2243,宏旭-KY,52,8,44,新百王,2024-10-08,6210
6770,力積電,41,2,39,新百王,2024-10-08,6210
00887,永豐中國科技50大,162,125,37,新百王,2024-10-08,6210
00878,國泰永續高股息,35,2,33,新百王,2024-10-08,6210
9105,泰金寶-DR,33,0,33,新百王,2024-10-08,6210
4716,大立,32,1,31,新百王,2024-10-08,6210
00680L,元大美債20正2,330,300,30,新百王,2024-10-08,6210
2402,毅嘉,57,29,28,新百王,2024-10-08,6210
00919,群益台灣精選高息,25,0,25,新百王,2024-10-08,6210
00923,群益台ESG低碳50,25,0,25,新百王,2024-10-08,6210
1514,亞力,25,0,25,新百王,2024-10-08,6210
5014,建錩,46,21,25,新百王,2024-10-08,6210
5386,青雲,26,2,24,新百王,2024-10-08,6210
1904,正隆,23,0,23,新百王,2024-10-08,6210
2353,宏��,25,2,23,新百王,2024-10-08,6210
00692,富邦公司治理,22,0,22,新百王,2024-10-08,6210
2851,中再保,21,0,21,新百王,2024-10-08,6210
2892,第一金,31,11,20,新百王,2024-10-08,6210
6104,創惟,28,8,20,新百王,2024-10-08,6210
9927,泰銘,20,0,20,新百王,2024-10-08,6210
1313,聯成,20,0,20,新百王,2024-10-08,6210
00950B,凱基A級公司債,20,0,20,新百王,2024-10-08,6210
3033,威健,25,5,20,新百王,2024-10-08,6210
2344,華邦電,19,0,19,新百王,2024-10-08,6210
8411,福貞-KY,19,1,18,新百王,2024-10-08,6210
2609,陽明,32,14,18,新百王,2024-10-08,6210
2425,承啟,71,54,17,新百王,2024-10-08,6210
0056,元大高股息,19,3,16,新百王,2024-10-08,6210
2002,中鋼,538,9,529,新百王,2024-10-09,6210
00632R,元大台灣50反1,813,286,527,新百王,2024-10-09,6210
3481,群創,719,219,500,新百王,2024-10-09,6210
2888,新光金,926,609,317,新百王,2024-10-09,6210
00680L,元大美債20正2,280,0,280,新百王,2024-10-09,6210
00637L,元大滬深300正2,683,450,233,新百王,2024-10-09,6210
2883,凱基金,210,20,190,新百王,2024-10-09,6210
00706L,期元大S＆P日圓正2,170,0,170,新百王,2024-10-09,6210
00882,中信中國高股息,323,153,170,新百王,2024-10-09,6210
00937B,群益ESG投等債20,142,0,142,新百王,2024-10-09,6210
00948B,中信優息投資級債,135,0,135,新百王,2024-10-09,6210
00753L,中信中國50正2,363,247,116,新百王,2024-10-09,6210
4113,聯上,110,0,110,新百王,2024-10-09,6210
2243,宏旭-KY,90,5,85,新百王,2024-10-09,6210
2313,華通,107,41,66,新百王,2024-10-09,6210
00687B,國泰20年美債,102,37,65,新百王,2024-10-09,6210
1904,正隆,65,0,65,新百王,2024-10-09,6210
3605,宏致,73,11,62,新百王,2024-10-09,6210
2412,中華電,62,1,61,新百王,2024-10-09,6210
2547,日勝生,111,50,61,新百王,2024-10-09,6210
1313,聯成,60,0,60,新百王,2024-10-09,6210
1806,冠軍,50,0,50,新百王,2024-10-09,6210
00679B,元大美債20年,42,0,42,新百王,2024-10-09,6210
00877,復華中國5G,41,0,41,新百王,2024-10-09,6210
5425,台半,41,1,40,新百王,2024-10-09,6210
00712,復華富時不動產,33,0,33,新百王,2024-10-09,6210
00650L,復華香港正2,54,21,33,新百王,2024-10-09,6210
1316,上曜,34,2,32,新百王,2024-10-09,6210
00665L,富邦�琤肭磪囓�2,255,223,32,新百王,2024-10-09,6210
1301,台塑,34,3,31,新百王,2024-10-09,6210
00655L,國泰中國A50正2,51,20,31,新百王,2024-10-09,6210
2890,永豐金,33,2,31,新百王,2024-10-09,6210
2701,萬企,30,0,30,新百王,2024-10-09,6210
2867,三商壽,30,0,30,新百王,2024-10-09,6210
5014,建錩,30,0,30,新百王,2024-10-09,6210
2887,台新金,49,20,29,新百王,2024-10-09,6210
3615,安可,75,47,28,新百王,2024-10-09,6210
2607,榮運,40,12,28,新百王,2024-10-09,6210
00688L,國泰20年美債正2,26,0,26,新百王,2024-10-09,6210
00936,台新永續高息中小,54,29,25,新百王,2024-10-09,6210
1514,亞力,33,8,25,新百王,2024-10-09,6210
2103,台橡,25,0,25,新百王,2024-10-09,6210
2382,廣達,81,57,24,新百王,2024-10-09,6210
6134,萬旭,41,18,23,新百王,2024-10-09,6210
5876,上海商銀,22,0,22,新百王,2024-10-09,6210
3305,昇貿,22,0,22,新百王,2024-10-09,6210
5288,豐祥-KY,22,0,22,新百王,2024-10-09,6210
5328,華容,34,12,22,新百王,2024-10-09,6210
5871,中租-KY,33,12,21,新百王,2024-10-09,6210
3234,光環,32,12,20,新百王,2024-10-09,6210
3481,群創,1019,54,965,新百王,2024-10-11,6210
00680L,元大美債20正2,642,32,610,新百王,2024-10-11,6210
3710,連展投控,234,0,234,新百王,2024-10-11,6210
2867,三商壽,150,0,150,新百王,2024-10-11,6210
1314,中石化,173,40,133,新百王,2024-10-11,6210
00637L,元大滬深300正2,299,178,121,新百王,2024-10-11,6210
00632R,元大台灣50反1,118,19,99,新百王,2024-10-11,6210
00688L,國泰20年美債正2,90,0,90,新百王,2024-10-11,6210
00877,復華中國5G,90,1,89,新百王,2024-10-11,6210
8034,榮群,98,20,78,新百王,2024-10-11,6210
5876,上海商銀,70,0,70,新百王,2024-10-11,6210
2889,國票金,82,21,61,新百王,2024-10-11,6210
4908,前鼎,63,3,60,新百王,2024-10-11,6210
2890,永豐金,120,62,58,新百王,2024-10-11,6210
1312,國喬,54,0,54,新百王,2024-10-11,6210
2317,鴻海,88,42,46,新百王,2024-10-11,6210
6290,良維,92,46,46,新百王,2024-10-11,6210
2897B,王道銀乙特,40,0,40,新百王,2024-10-11,6210
1904,正隆,40,0,40,新百王,2024-10-11,6210
5014,建錩,38,0,38,新百王,2024-10-11,6210
2892,第一金,79,42,37,新百王,2024-10-11,6210
00937B,群益ESG投等債20,36,0,36,新百王,2024-10-11,6210
9105,泰金寶-DR,41,5,36,新百王,2024-10-11,6210
3591,艾笛森,35,1,34,新百王,2024-10-11,6210
2069,運錩,31,0,31,新百王,2024-10-11,6210
2509,全坤建,31,0,31,新百王,2024-10-11,6210
4113,聯上,31,1,30,新百王,2024-10-11,6210
3149,正達,132,103,29,新百王,2024-10-11,6210
2388,威盛,51,24,27,新百王,2024-10-11,6210
2363,矽統,78,51,27,新百王,2024-10-11,6210
5871,中租-KY,26,2,24,新百王,2024-10-11,6210
2887,台新金,22,0,22,新百王,2024-10-11,6210
1711,永光,41,19,22,新百王,2024-10-11,6210
6770,力積電,21,0,21,新百王,2024-10-11,6210
2809,京城銀,23,2,21,新百王,2024-10-11,6210
3037,欣興,40,19,21,新百王,2024-10-11,6210
2449,京元電子,36,15,21,新百王,2024-10-11,6210
2412,中華電,20,0,20,新百王,2024-10-11,6210
00950B,凱基A級公司債,20,0,20,新百王,2024-10-11,6210
6284,佳邦,17,0,17,新百王,2024-10-11,6210
4967,十銓,20,4,16,新百王,2024-10-11,6210
1909,榮成,20,5,15,新百王,2024-10-11,6210
00929,復華台灣科技優息,17,2,15,新百王,2024-10-11,6210
2419,仲琦,25,11,14,新百王,2024-10-11,6210
00655L,國泰中國A50正2,14,1,13,新百王,2024-10-11,6210
1718,中纖,13,0,13,新百王,2024-10-11,6210
00915,凱基優選高股息30,16,4,12,新百王,2024-10-11,6210
4909,新復興,24,12,12,新百王,2024-10-11,6210
2637,慧洋-KY,12,0,12,新百王,2024-10-11,6210
6625,必應,16,4,12,新百王,2024-10-11,6210
00948B,中信優息投資級債,296,20,276,新百王,2024-10-14,6210
00931B,統一美債20年,264,0,264,新百王,2024-10-14,6210
00940,元大台灣價值高息,202,2,200,新百王,2024-10-14,6210
00937B,群益ESG投等債20,178,0,178,新百王,2024-10-14,6210
2888,新光金,435,282,153,新百王,2024-10-14,6210
00953B,群益優選非投等債,150,0,150,新百王,2024-10-14,6210
4113,聯上,106,8,98,新百王,2024-10-14,6210
00887,永豐中國科技50大,90,0,90,新百王,2024-10-14,6210
00632R,元大台灣50反1,293,211,82,新百王,2024-10-14,6210
00688L,國泰20年美債正2,81,0,81,新百王,2024-10-14,6210
9907,統一實,68,0,68,新百王,2024-10-14,6210
2426,鼎元,119,58,61,新百王,2024-10-14,6210
00712,復華富時不動產,56,0,56,新百王,2024-10-14,6210
00637L,元大滬深300正2,252,201,51,新百王,2024-10-14,6210
00929,復華台灣科技優息,53,3,50,新百王,2024-10-14,6210
00934,中信成長高股息,50,0,50,新百王,2024-10-14,6210
2412,中華電,42,2,40,新百王,2024-10-14,6210
00639,富邦深100,60,20,40,新百王,2024-10-14,6210
00687B,國泰20年美債,63,23,40,新百王,2024-10-14,6210
00733,富邦臺灣中小,36,0,36,新百王,2024-10-14,6210
3710,連展投控,167,134,33,新百王,2024-10-14,6210
00878,國泰永續高股息,32,4,28,新百王,2024-10-14,6210
006208,富邦台50,28,4,24,新百王,2024-10-14,6210
2002,中鋼,24,1,23,新百王,2024-10-14,6210
00751B,元大AAA至A公司債,22,0,22,新百王,2024-10-14,6210
00753L,中信中國50正2,70,50,20,新百王,2024-10-14,6210
8011,台通,25,6,19,新百王,2024-10-14,6210
3025,星通,26,7,19,新百王,2024-10-14,6210
00795B,中信美國公債20年,22,4,18,新百王,2024-10-14,6210
00950B,凱基A級公司債,15,0,15,新百王,2024-10-14,6210
8450,霹靂,15,0,15,新百王,2024-10-14,6210
6134,萬旭,17,2,15,新百王,2024-10-14,6210
3576,聯合再生,14,0,14,新百王,2024-10-14,6210
00715L,期街口布蘭特正2,31,18,13,新百王,2024-10-14,6210
5905,南仁湖,14,1,13,新百王,2024-10-14,6210
2312,金寶,19,7,12,新百王,2024-10-14,6210
6505,台塑化,12,0,12,新百王,2024-10-14,6210
6190,萬泰科,12,0,12,新百王,2024-10-14,6210
6163,華電網,16,4,12,新百王,2024-10-14,6210
2371,大同,14,3,11,新百王,2024-10-14,6210
4979,華星光,25,14,11,新百王,2024-10-14,6210
6117,迎廣,26,15,11,新百王,2024-10-14,6210
3231,緯創,31,21,10,新百王,2024-10-14,6210
4977,眾達-KY,45,35,10,新百王,2024-10-14,6210
1817,凱撒衛,10,0,10,新百王,2024-10-14,6210
8431,匯鑽科,10,0,10,新百王,2024-10-14,6210
2812,台中銀,13,3,10,新百王,2024-10-14,6210
4908,前鼎,13,3,10,新百王,2024-10-14,6210
6152,百一,10,0,10,新百王,2024-10-14,6210
6142,友勁,10,0,10,新百王,2024-10-14,6210
00688L,國泰20年美債正2,722,5,717,新百王,2024-10-15,6210
2897,王道銀行,204,0,204,新百王,2024-10-15,6210
00680L,元大美債20正2,199,0,199,新百王,2024-10-15,6210
00753L,中信中國50正2,181,11,170,新百王,2024-10-15,6210
2888,新光金,270,134,136,新百王,2024-10-15,6210
00637L,元大滬深300正2,180,45,135,新百王,2024-10-15,6210
00934,中信成長高股息,134,0,134,新百王,2024-10-15,6210
00632R,元大台灣50反1,456,331,125,新百王,2024-10-15,6210
00715L,期街口布蘭特正2,86,17,69,新百王,2024-10-15,6210
1314,中石化,185,120,65,新百王,2024-10-15,6210
1326,台化,58,0,58,新百王,2024-10-15,6210
3149,正達,148,91,57,新百王,2024-10-15,6210
2809,京城銀,47,1,46,新百王,2024-10-15,6210
00665L,富邦�琤肭磪囓�2,254,210,44,新百王,2024-10-15,6210
00650L,復華香港正2,41,0,41,新百王,2024-10-15,6210
2641,正德,40,0,40,新百王,2024-10-15,6210
8070,長華*,41,2,39,新百王,2024-10-15,6210
00687B,國泰20年美債,54,17,37,新百王,2024-10-15,6210
2891,中信金,43,13,30,新百王,2024-10-15,6210
9919,康那香,30,0,30,新百王,2024-10-15,6210
00676R,富邦臺灣加權反1,30,0,30,新百王,2024-10-15,6210
4956,光鋐,234,205,29,新百王,2024-10-15,6210
00725B,國泰投資級公司債,28,0,28,新百王,2024-10-15,6210
3290,東浦,36,9,27,新百王,2024-10-15,6210
2426,鼎元,28,4,24,新百王,2024-10-15,6210
6770,力積電,20,0,20,新百王,2024-10-15,6210
3305,昇貿,20,0,20,新百王,2024-10-15,6210
1815,富喬,20,0,20,新百王,2024-10-15,6210
5521,工信,19,0,19,新百王,2024-10-15,6210
2344,華邦電,21,3,18,新百王,2024-10-15,6210
8450,霹靂,16,0,16,新百王,2024-10-15,6210
5452,佶優,52,36,16,新百王,2024-10-15,6210
8099,大世科,18,2,16,新百王,2024-10-15,6210
1301,台塑,15,0,15,新百王,2024-10-15,6210
2509,全坤建,15,0,15,新百王,2024-10-15,6210
3013,晟銘電,68,54,14,新百王,2024-10-15,6210
9105,泰金寶-DR,53,39,14,新百王,2024-10-15,6210
3498,陽程,45,32,13,新百王,2024-10-15,6210
2399,映泰,40,28,12,新百王,2024-10-15,6210
2371,大同,22,10,12,新百王,2024-10-15,6210
00655L,國泰中國A50正2,11,0,11,新百王,2024-10-15,6210
3042,晶技,12,1,11,新百王,2024-10-15,6210
6706,惠特,53,42,11,新百王,2024-10-15,6210
3591,艾笛森,11,0,11,新百王,2024-10-15,6210
5230,雷笛克光學,24,13,11,新百王,2024-10-15,6210
4991,環宇-KY,14,3,11,新百王,2024-10-15,6210
00887,永豐中國科技50大,27,16,11,新百王,2024-10-15,6210
4903,聯光通,19,9,10,新百王,2024-10-15,6210
4113,聯上,10,0,10,新百王,2024-10-15,6210
2464,盟立,14,4,10,新百王,2024-10-15,6210
00665L,富邦�琤肭磪囓�2,692,28,664,新百王,2024-10-16,6210
00637L,元大滬深300正2,477,323,154,新百王,2024-10-16,6210
3615,安可,156,3,153,新百王,2024-10-16,6210
2888,新光金,156,21,135,新百王,2024-10-16,6210
00680L,元大美債20正2,150,25,125,新百王,2024-10-16,6210
2412,中華電,92,2,90,新百王,2024-10-16,6210
00712,復華富時不動產,98,10,88,新百王,2024-10-16,6210
2002,中鋼,319,232,87,新百王,2024-10-16,6210
00687B,國泰20年美債,89,4,85,新百王,2024-10-16,6210
2344,華邦電,74,2,72,新百王,2024-10-16,6210
4908,前鼎,110,57,53,新百王,2024-10-16,6210
2906,高林,53,0,53,新百王,2024-10-16,6210
00887,永豐中國科技50大,54,6,48,新百王,2024-10-16,6210
2845,遠東銀,38,0,38,新百王,2024-10-16,6210
2887,台新金,45,10,35,新百王,2024-10-16,6210
00922,國泰台灣領袖50,35,0,35,新百王,2024-10-16,6210
2426,鼎元,37,2,35,新百王,2024-10-16,6210
00948B,中信優息投資級債,138,106,32,新百王,2024-10-16,6210
1229,聯華,30,0,30,新百王,2024-10-16,6210
00753L,中信中國50正2,46,16,30,新百王,2024-10-16,6210
00929,復華台灣科技優息,31,2,29,新百王,2024-10-16,6210
2884,玉山金,30,2,28,新百王,2024-10-16,6210
00951,台新日本半導體,25,0,25,新百王,2024-10-16,6210
1416,廣豐,24,0,24,新百王,2024-10-16,6210
1314,中石化,36,13,23,新百王,2024-10-16,6210
1904,正隆,23,0,23,新百王,2024-10-16,6210
2812,台中銀,22,0,22,新百王,2024-10-16,6210
4526,東台,28,7,21,新百王,2024-10-16,6210
3591,艾笛森,42,21,21,新百王,2024-10-16,6210
0056,元大高股息,25,5,20,新百王,2024-10-16,6210
00715L,期街口布蘭特正2,23,3,20,新百王,2024-10-16,6210
1785,光洋科,26,6,20,新百王,2024-10-16,6210
6506,雙邦,20,0,20,新百王,2024-10-16,6210
2890,永豐金,59,40,19,新百王,2024-10-16,6210
1605,華新,19,1,18,新百王,2024-10-16,6210
00725B,國泰投資級公司債,18,0,18,新百王,2024-10-16,6210
4903,聯光通,32,14,18,新百王,2024-10-16,6210
2701,萬企,17,0,17,新百王,2024-10-16,6210
2439,美律,18,2,16,新百王,2024-10-16,6210
5481,新華,39,23,16,新百王,2024-10-16,6210
2421,建準,30,14,16,新百王,2024-10-16,6210
00679B,元大美債20年,17,3,14,新百王,2024-10-16,6210
2706,第一店,14,0,14,新百王,2024-10-16,6210
6530,創威,36,22,14,新百王,2024-10-16,6210
2371,大同,14,0,14,新百王,2024-10-16,6210
2883,凱基金,313,300,13,新百王,2024-10-16,6210
6126,信音,13,1,12,新百王,2024-10-16,6210
3042,晶技,14,2,12,新百王,2024-10-16,6210
00881,國泰台灣5G+,37,25,12,新百王,2024-10-16,6210
00960,野村全球航運龍頭,12,0,12,新百王,2024-10-16,6210
3591,艾笛森,224,24,200,新百王,2024-10-17,6210
00937B,群益ESG投等債20,318,130,188,新百王,2024-10-17,6210
3607,谷崧,132,0,132,新百王,2024-10-17,6210
3290,東浦,121,11,110,新百王,2024-10-17,6210
00940,元大台灣價值高息,100,0,100,新百王,2024-10-17,6210
9105,泰金寶-DR,95,11,84,新百王,2024-10-17,6210
00753L,中信中國50正2,80,1,79,新百王,2024-10-17,6210
2890,永豐金,83,4,79,新百王,2024-10-17,6210
00887,永豐中國科技50大,82,5,77,新百王,2024-10-17,6210
00637L,元大滬深300正2,276,205,71,新百王,2024-10-17,6210
1314,中石化,102,39,63,新百王,2024-10-17,6210
6213,聯茂,62,0,62,新百王,2024-10-17,6210
1528,恩德,86,29,57,新百王,2024-10-17,6210
2312,金寶,202,146,56,新百王,2024-10-17,6210
2303,聯電,52,1,51,新百王,2024-10-17,6210
6216,居易,55,5,50,新百王,2024-10-17,6210
2610,華航,75,26,49,新百王,2024-10-17,6210
2732,六角,45,0,45,新百王,2024-10-17,6210
2344,華邦電,40,1,39,新百王,2024-10-17,6210
4908,前鼎,54,15,39,新百王,2024-10-17,6210
2399,映泰,170,135,35,新百王,2024-10-17,6210
00877,復華中國5G,33,0,33,新百王,2024-10-17,6210
0056,元大高股息,31,0,31,新百王,2024-10-17,6210
00632R,元大台灣50反1,26,0,26,新百王,2024-10-17,6210
4526,東台,47,21,26,新百王,2024-10-17,6210
5230,雷笛克光學,63,39,24,新百王,2024-10-17,6210
00882,中信中國高股息,29,6,23,新百王,2024-10-17,6210
6179,亞通,24,1,23,新百王,2024-10-17,6210
4510,高鋒,60,38,22,新百王,2024-10-17,6210
00642U,期元大S＆P石油,21,0,21,新百王,2024-10-17,6210
9927,泰銘,21,0,21,新百王,2024-10-17,6210
00922,國泰台灣領袖50,24,3,21,新百王,2024-10-17,6210
00959B,大華投等美債15Y+,20,0,20,新百王,2024-10-17,6210
2330,台積電,33,13,20,新百王,2024-10-17,6210
00715L,期街口布蘭特正2,23,5,18,新百王,2024-10-17,6210
2884,玉山金,18,0,18,新百王,2024-10-17,6210
00941,中信上游半導體,17,0,17,新百王,2024-10-17,6210
00905,FT臺灣Smart,17,0,17,新百王,2024-10-17,6210
5521,工信,22,5,17,新百王,2024-10-17,6210
4956,光鋐,36,19,17,新百王,2024-10-17,6210
5481,新華,17,1,16,新百王,2024-10-17,6210
2615,萬海,43,28,15,新百王,2024-10-17,6210
1708,東鹼,16,1,15,新百王,2024-10-17,6210
2464,盟立,52,37,15,新百王,2024-10-17,6210
2809,京城銀,16,2,14,新百王,2024-10-17,6210
2412,中華電,20,6,14,新百王,2024-10-17,6210
6125,廣運,40,26,14,新百王,2024-10-17,6210
2609,陽明,42,28,14,新百王,2024-10-17,6210
6625,必應,13,0,13,新百王,2024-10-17,6210
2601,益航,51,38,13,新百王,2024-10-17,6210
4526,東台,271,21,250,新百王,2024-10-18,6210
00632R,元大台灣50反1,617,386,231,新百王,2024-10-18,6210
00679B,元大美債20年,182,0,182,新百王,2024-10-18,6210
00941,中信上游半導體,176,0,176,新百王,2024-10-18,6210
00688L,國泰20年美債正2,143,0,143,新百王,2024-10-18,6210
00937B,群益ESG投等債20,168,30,138,新百王,2024-10-18,6210
00795B,中信美國公債20年,83,0,83,新百王,2024-10-18,6210
2408,南亞科,67,2,65,新百王,2024-10-18,6210
3607,谷崧,64,2,62,新百王,2024-10-18,6210
2367,燿華,56,0,56,新百王,2024-10-18,6210
1466,聚隆,51,0,51,新百王,2024-10-18,6210
3703,欣陸,50,0,50,新百王,2024-10-18,6210
2402,毅嘉,95,49,46,新百王,2024-10-18,6210
2317,鴻海,134,92,42,新百王,2024-10-18,6210
2344,華邦電,42,4,38,新百王,2024-10-18,6210
2542,興富發,37,0,37,新百王,2024-10-18,6210
6770,力積電,72,41,31,新百王,2024-10-18,6210
00948B,中信優息投資級債,91,60,31,新百王,2024-10-18,6210
2845,遠東銀,29,0,29,新百王,2024-10-18,6210
00751B,元大AAA至A公司債,28,0,28,新百王,2024-10-18,6210
3615,安可,212,185,27,新百王,2024-10-18,6210
2312,金寶,213,188,25,新百王,2024-10-18,6210
2303,聯電,113,90,23,新百王,2024-10-18,6210
2374,佳能,53,30,23,新百王,2024-10-18,6210
1314,中石化,76,55,21,新百王,2024-10-18,6210
1785,光洋科,42,21,21,新百王,2024-10-18,6210
2732,六角,21,0,21,新百王,2024-10-18,6210
8210,勤誠,23,2,21,新百王,2024-10-18,6210
00720B,元大投資級公司債,20,0,20,新百王,2024-10-18,6210
2509,全坤建,20,0,20,新百王,2024-10-18,6210
00918,大華優利高填息30,42,22,20,新百王,2024-10-18,6210
2354,鴻準,18,0,18,新百王,2024-10-18,6210
3025,星通,38,21,17,新百王,2024-10-18,6210
3581,博磊,24,7,17,新百王,2024-10-18,6210
00931B,統一美債20年,41,25,16,新百王,2024-10-18,6210
3312,弘憶股,37,21,16,新百王,2024-10-18,6210
1710,東聯,16,0,16,新百王,2024-10-18,6210
6213,聯茂,41,25,16,新百王,2024-10-18,6210
2610,華航,95,81,14,新百王,2024-10-18,6210
1540,喬福,129,115,14,新百王,2024-10-18,6210
00653L,富邦印度正2,13,0,13,新百王,2024-10-18,6210
1721,三晃,20,7,13,新百王,2024-10-18,6210
2495,普安,19,6,13,新百王,2024-10-18,6210
00907,永豐優息存股,12,0,12,新百王,2024-10-18,6210
5014,建錩,12,0,12,新百王,2024-10-18,6210
3450,聯鈞,53,41,12,新百王,2024-10-18,6210
00929,復華台灣科技優息,34,22,12,新百王,2024-10-18,6210
00753L,中信中國50正2,37,26,11,新百王,2024-10-18,6210
1560,中砂,27,16,11,新百王,2024-10-18,6210
6451,訊芯-KY,21,10,11,新百王,2024-10-18,6210
4526,東台,492,16,476,新百王,2024-10-21,6210
00937B,群益ESG投等債20,362,0,362,新百王,2024-10-21,6210
3050,鈺德,340,2,338,新百王,2024-10-21,6210
2349,錸德,430,160,270,新百王,2024-10-21,6210
00637L,元大滬深300正2,523,320,203,新百王,2024-10-21,6210
3607,谷崧,206,9,197,新百王,2024-10-21,6210
3290,東浦,207,12,195,新百王,2024-10-21,6210
2891,中信金,111,2,109,新百王,2024-10-21,6210
2897,王道銀行,110,10,100,新百王,2024-10-21,6210
2884,玉山金,83,0,83,新百王,2024-10-21,6210
00715L,期街口布蘭特正2,93,15,78,新百王,2024-10-21,6210
1312,國喬,75,0,75,新百王,2024-10-21,6210
2421,建準,78,12,66,新百王,2024-10-21,6210
9105,泰金寶-DR,63,3,60,新百王,2024-10-21,6210
00687B,國泰20年美債,61,1,60,新百王,2024-10-21,6210
00948B,中信優息投資級債,151,92,59,新百王,2024-10-21,6210
6532,瑞耘,137,85,52,新百王,2024-10-21,6210
00679B,元大美債20年,59,9,50,新百王,2024-10-21,6210
2388,威盛,95,53,42,新百王,2024-10-21,6210
00931B,統一美債20年,41,0,41,新百王,2024-10-21,6210
6167,久正,38,5,33,新百王,2024-10-21,6210
2809,京城銀,47,16,31,新百王,2024-10-21,6210
00864B,中信美國公債0-1,29,0,29,新百王,2024-10-21,6210
2890,永豐金,44,17,27,新百王,2024-10-21,6210
6156,松上,62,36,26,新百王,2024-10-21,6210
00720B,元大投資級公司債,25,0,25,新百王,2024-10-21,6210
2610,華航,78,53,25,新百王,2024-10-21,6210
2419,仲琦,28,4,24,新百王,2024-10-21,6210
2498,宏達電,24,0,24,新百王,2024-10-21,6210
2836,高雄銀,23,0,23,新百王,2024-10-21,6210
2453,凌群,24,2,22,新百王,2024-10-21,6210
4540,全球傳動,70,50,20,新百王,2024-10-21,6210
4956,光鋐,21,1,20,新百王,2024-10-21,6210
3031,佰鴻,26,6,20,新百王,2024-10-21,6210
00665L,富邦�琤肭磪囓�2,109,90,19,新百王,2024-10-21,6210
2881,富邦金,18,0,18,新百王,2024-10-21,6210
1569,濱川,25,7,18,新百王,2024-10-21,6210
3036,文曄,21,4,17,新百王,2024-10-21,6210
6505,台塑化,17,0,17,新百王,2024-10-21,6210
5452,佶優,33,17,16,新百王,2024-10-21,6210
3481,群創,15,0,15,新百王,2024-10-21,6210
6405,悅城,16,1,15,新百王,2024-10-21,6210
6241,易通展,15,0,15,新百王,2024-10-21,6210
6026,福邦證,15,1,14,新百王,2024-10-21,6210
4716,大立,13,0,13,新百王,2024-10-21,6210
8111,立��,19,6,13,新百王,2024-10-21,6210
6185,幃翔,13,0,13,新百王,2024-10-21,6210
00795B,中信美國公債20年,11,0,11,新百王,2024-10-21,6210
6127,九豪,30,19,11,新百王,2024-10-21,6210
6136,富爾特,11,0,11,新百王,2024-10-21,6210
00688L,國泰20年美債正2,677,150,527,新百王,2024-10-22,6210
6603,富強鑫,453,0,453,新百王,2024-10-22,6210
00680L,元大美債20正2,685,268,417,新百王,2024-10-22,6210
00679B,元大美債20年,122,12,110,新百王,2024-10-22,6210
9105,泰金寶-DR,106,0,106,新百王,2024-10-22,6210
4720,德淵,100,0,100,新百王,2024-10-22,6210
5452,佶優,147,52,95,新百王,2024-10-22,6210
00929,復華台灣科技優息,107,13,94,新百王,2024-10-22,6210
5488,松普,80,0,80,新百王,2024-10-22,6210
4729,熒茂,77,21,56,新百王,2024-10-22,6210
00795B,中信美國公債20年,56,0,56,新百王,2024-10-22,6210
00950B,凱基A級公司債,50,0,50,新百王,2024-10-22,6210
00738U,期元大道瓊白銀,49,0,49,新百王,2024-10-22,6210
2495,普安,73,24,49,新百王,2024-10-22,6210
00720B,元大投資級公司債,43,0,43,新百王,2024-10-22,6210
1718,中纖,40,0,40,新百王,2024-10-22,6210
00664R,國泰臺灣加權反1,40,0,40,新百王,2024-10-22,6210
3290,東浦,53,13,40,新百王,2024-10-22,6210
2610,華航,75,35,40,新百王,2024-10-22,6210
00945B,凱基美國非投等債,35,0,35,新百王,2024-10-22,6210
00712,復華富時不動產,35,1,34,新百王,2024-10-22,6210
5498,凱崴,39,5,34,新百王,2024-10-22,6210
2388,威盛,47,15,32,新百王,2024-10-22,6210
00933B,國泰10Y+金融債,40,10,30,新百王,2024-10-22,6210
2498,宏達電,32,4,28,新百王,2024-10-22,6210
2363,矽統,112,84,28,新百王,2024-10-22,6210
8021,尖點,46,23,23,新百王,2024-10-22,6210
2482,連宇,21,0,21,新百王,2024-10-22,6210
2354,鴻準,24,4,20,新百王,2024-10-22,6210
00687B,國泰20年美債,99,80,19,新百王,2024-10-22,6210
1301,台塑,20,1,19,新百王,2024-10-22,6210
6216,居易,21,2,19,新百王,2024-10-22,6210
4933,友輝,20,1,19,新百王,2024-10-22,6210
2305,全友,18,0,18,新百王,2024-10-22,6210
00934,中信成長高股息,18,0,18,新百王,2024-10-22,6210
3066,李洲,40,22,18,新百王,2024-10-22,6210
2809,京城銀,32,14,18,新百王,2024-10-22,6210
4956,光鋐,22,5,17,新百王,2024-10-22,6210
2887,台新金,44,27,17,新百王,2024-10-22,6210
2236,百達-KY,22,6,16,新百王,2024-10-22,6210
4958,臻鼎-KY,15,0,15,新百王,2024-10-22,6210
9940,信義,15,0,15,新百王,2024-10-22,6210
00857B,永豐20年美公債,15,0,15,新百王,2024-10-22,6210
2903,遠百,15,0,15,新百王,2024-10-22,6210
5386,青雲,23,8,15,新百王,2024-10-22,6210
006208,富邦台50,17,3,14,新百王,2024-10-22,6210
3498,陽程,23,10,13,新百王,2024-10-22,6210
8027,鈦昇,21,8,13,新百王,2024-10-22,6210
3011,今皓,17,4,13,新百王,2024-10-22,6210
1605,華新,12,0,12,新百王,2024-10-22,6210
2002,中鋼,223,0,223,新百王,2024-10-23,6210
00937B,群益ESG投等債20,171,0,171,新百王,2024-10-23,6210
00959B,大華投等美債15Y+,150,0,150,新百王,2024-10-23,6210
5876,上海商銀,122,0,122,新百王,2024-10-23,6210
2890,永豐金,155,36,119,新百王,2024-10-23,6210
6505,台塑化,115,0,115,新百王,2024-10-23,6210
00950B,凱基A級公司債,115,0,115,新百王,2024-10-23,6210
2845,遠東銀,131,31,100,新百王,2024-10-23,6210
00907,永豐優息存股,100,1,99,新百王,2024-10-23,6210
00637L,元大滬深300正2,252,154,98,新百王,2024-10-23,6210
00945B,凱基美國非投等債,95,0,95,新百王,2024-10-23,6210
00878,國泰永續高股息,82,1,81,新百王,2024-10-23,6210
3290,東浦,68,12,56,新百王,2024-10-23,6210
2302,麗正,119,65,54,新百王,2024-10-23,6210
2887,台新金,50,0,50,新百王,2024-10-23,6210
00953B,群益優選非投等債,50,0,50,新百王,2024-10-23,6210
1723,中碳,48,0,48,新百王,2024-10-23,6210
00687B,國泰20年美債,446,400,46,新百王,2024-10-23,6210
3202,樺晟,42,0,42,新百王,2024-10-23,6210
9904,寶成,41,0,41,新百王,2024-10-23,6210
3532,台勝科,41,1,40,新百王,2024-10-23,6210
1809,中釉,40,1,39,新百王,2024-10-23,6210
3481,群創,444,406,38,新百王,2024-10-23,6210
2836,高雄銀,34,0,34,新百王,2024-10-23,6210
9940,信義,34,0,34,新百王,2024-10-23,6210
2317,鴻海,101,69,32,新百王,2024-10-23,6210
00712,復華富時不動產,30,0,30,新百王,2024-10-23,6210
1506,正道,30,0,30,新百王,2024-10-23,6210
4576,大銀微系統,29,0,29,新百王,2024-10-23,6210
1711,永光,75,47,28,新百王,2024-10-23,6210
1718,中纖,28,0,28,新百王,2024-10-23,6210
1314,中石化,28,1,27,新百王,2024-10-23,6210
0056,元大高股息,21,0,21,新百王,2024-10-23,6210
2382,廣達,22,1,21,新百王,2024-10-23,6210
2701,萬企,20,0,20,新百王,2024-10-23,6210
00881,國泰台灣5G+,22,2,20,新百王,2024-10-23,6210
6156,松上,85,65,20,新百王,2024-10-23,6210
00706L,期元大S＆P日圓正2,20,0,20,新百王,2024-10-23,6210
2316,楠梓電,20,1,19,新百王,2024-10-23,6210
2481,強茂,21,3,18,新百王,2024-10-23,6210
2618,長榮航,18,0,18,新百王,2024-10-23,6210
00752,中信中國50,16,0,16,新百王,2024-10-23,6210
5315,光聯,32,16,16,新百王,2024-10-23,6210
5460,同協,17,1,16,新百王,2024-10-23,6210
2329,華泰,41,25,16,新百王,2024-10-23,6210
00940,元大台灣價值高息,20,5,15,新百王,2024-10-23,6210
2812,台中銀,15,0,15,新百王,2024-10-23,6210
2105,正新,16,1,15,新百王,2024-10-23,6210
6151,晉倫,57,43,14,新百王,2024-10-23,6210
4510,高鋒,14,0,14,新百王,2024-10-23,6210
2317,鴻海,409,72,337,新百王,2024-10-24,6210
00715L,期街口布蘭特正2,333,8,325,新百王,2024-10-24,6210
0056,元大高股息,275,3,272,新百王,2024-10-24,6210
1313,聯成,200,0,200,新百王,2024-10-24,6210
00665L,富邦�琤肭磪囓�2,152,10,142,新百王,2024-10-24,6210
3615,安可,160,28,132,新百王,2024-10-24,6210
4729,熒茂,111,9,102,新百王,2024-10-24,6210
4526,東台,93,4,89,新百王,2024-10-24,6210
3489,森寶,85,0,85,新百王,2024-10-24,6210
6405,悅城,93,8,85,新百王,2024-10-24,6210
00637L,元大滬深300正2,137,63,74,新百王,2024-10-24,6210
1314,中石化,72,6,66,新百王,2024-10-24,6210
00680L,元大美債20正2,110,45,65,新百王,2024-10-24,6210
1802,台玻,101,37,64,新百王,2024-10-24,6210
00753L,中信中國50正2,308,254,54,新百王,2024-10-24,6210
00752,中信中國50,52,0,52,新百王,2024-10-24,6210
5876,上海商銀,49,0,49,新百王,2024-10-24,6210
2303,聯電,40,0,40,新百王,2024-10-24,6210
00950B,凱基A級公司債,135,100,35,新百王,2024-10-24,6210
1718,中纖,33,0,33,新百王,2024-10-24,6210
2344,華邦電,31,0,31,新百王,2024-10-24,6210
4956,光鋐,35,5,30,新百王,2024-10-24,6210
1598,岱宇,30,0,30,新百王,2024-10-24,6210
9105,泰金寶-DR,50,20,30,新百王,2024-10-24,6210
00945B,凱基美國非投等債,30,0,30,新百王,2024-10-24,6210
2906,高林,30,1,29,新百王,2024-10-24,6210
3498,陽程,41,13,28,新百王,2024-10-24,6210
5512,力麒,37,10,27,新百王,2024-10-24,6210
2382,廣達,58,33,25,新百王,2024-10-24,6210
00960,野村全球航運龍頭,25,0,25,新百王,2024-10-24,6210
2489,瑞軒,31,6,25,新百王,2024-10-24,6210
3550,聯穎,22,0,22,新百王,2024-10-24,6210
9925,新保,20,0,20,新百王,2024-10-24,6210
2436,偉詮電,23,3,20,新百王,2024-10-24,6210
00679B,元大美債20年,21,2,19,新百王,2024-10-24,6210
4919,新唐,115,96,19,新百王,2024-10-24,6210
2365,昆盈,41,23,18,新百王,2024-10-24,6210
1609,大亞,18,0,18,新百王,2024-10-24,6210
2405,輔信,29,11,18,新百王,2024-10-24,6210
00712,復華富時不動產,17,0,17,新百王,2024-10-24,6210
4977,眾達-KY,40,23,17,新百王,2024-10-24,6210
3257,虹冠電,16,0,16,新百王,2024-10-24,6210
4952,凌通,20,4,16,新百王,2024-10-24,6210
4123,晟德,26,10,16,新百王,2024-10-24,6210
2374,佳能,26,10,16,新百王,2024-10-24,6210
6658,聯策,33,18,15,新百王,2024-10-24,6210
00650L,復華香港正2,15,0,15,新百王,2024-10-24,6210
4908,前鼎,18,3,15,新百王,2024-10-24,6210
00940,元大台灣價值高息,20,6,14,新百王,2024-10-24,6210
00915,凱基優選高股息30,13,0,13,新百王,2024-10-24,6210
8249,菱光,262,66,196,新百王,2024-10-25,6210
2845,遠東銀,173,58,115,新百王,2024-10-25,6210
00680L,元大美債20正2,115,0,115,新百王,2024-10-25,6210
1467,南緯,109,0,109,新百王,2024-10-25,6210
2890,永豐金,305,204,101,新百王,2024-10-25,6210
00959B,大華投等美債15Y+,101,0,101,新百王,2024-10-25,6210
2303,聯電,71,0,71,新百王,2024-10-25,6210
00887,永豐中國科技50大,74,10,64,新百王,2024-10-25,6210
2646,星宇航空,208,148,60,新百王,2024-10-25,6210
00950B,凱基A級公司債,56,0,56,新百王,2024-10-25,6210
00687B,國泰20年美債,50,0,50,新百王,2024-10-25,6210
00688L,國泰20年美債正2,70,27,43,新百王,2024-10-25,6210
2836,高雄銀,41,0,41,新百王,2024-10-25,6210
1718,中纖,39,0,39,新百王,2024-10-25,6210
6505,台塑化,35,0,35,新百王,2024-10-25,6210
00940,元大台灣價值高息,37,3,34,新百王,2024-10-25,6210
00753L,中信中國50正2,225,192,33,新百王,2024-10-25,6210
2344,華邦電,68,37,31,新百王,2024-10-25,6210
00795B,中信美國公債20年,30,0,30,新百王,2024-10-25,6210
2405,輔信,38,12,26,新百王,2024-10-25,6210
4956,光鋐,28,2,26,新百王,2024-10-25,6210
8043,蜜望實,63,39,24,新百王,2024-10-25,6210
5202,力新,45,22,23,新百王,2024-10-25,6210
5351,鈺創,27,4,23,新百王,2024-10-25,6210
2312,金寶,67,44,23,新百王,2024-10-25,6210
5876,上海商銀,21,0,21,新百王,2024-10-25,6210
9105,泰金寶-DR,25,5,20,新百王,2024-10-25,6210
6443,元晶,20,1,19,新百王,2024-10-25,6210
3652,精聯,20,3,17,新百王,2024-10-25,6210
2906,高林,20,3,17,新百王,2024-10-25,6210
2542,興富發,16,0,16,新百王,2024-10-25,6210
6438,迅得,34,18,16,新百王,2024-10-25,6210
2637,慧洋-KY,20,6,14,新百王,2024-10-25,6210
2891,中信金,14,0,14,新百王,2024-10-25,6210
5403,中菲,14,0,14,新百王,2024-10-25,6210
2543,皇昌,29,16,13,新百王,2024-10-25,6210
020023,元大櫃買半導體N,13,0,13,新百王,2024-10-25,6210
6241,易通展,18,5,13,新百王,2024-10-25,6210
1802,台玻,13,0,13,新百王,2024-10-25,6210
6285,啟��,81,69,12,新百王,2024-10-25,6210
1301,台塑,13,1,12,新百王,2024-10-25,6210
9940,信義,12,0,12,新百王,2024-10-25,6210
2002,中鋼,20,9,11,新百王,2024-10-25,6210
00937B,群益ESG投等債20,11,0,11,新百王,2024-10-25,6210
3551,世禾,15,4,11,新百王,2024-10-25,6210
1806,冠軍,31,20,11,新百王,2024-10-25,6210
2330,台積電,18,8,10,新百王,2024-10-25,6210
2812,台中銀,10,0,10,新百王,2024-10-25,6210
6288,聯嘉,28,18,10,新百王,2024-10-25,6210
2608,嘉里大榮,10,0,10,新百王,2024-10-25,6210
00680L,元大美債20正2,550,0,550,新百王,2024-10-28,6210
0056,元大高股息,233,4,229,新百王,2024-10-28,6210
9105,泰金寶-DR,237,66,171,新百王,2024-10-28,6210
2890,永豐金,229,110,119,新百王,2024-10-28,6210
5488,松普,237,133,104,新百王,2024-10-28,6210
2317,鴻海,248,148,100,新百王,2024-10-28,6210
00637L,元大滬深300正2,188,95,93,新百王,2024-10-28,6210
00948B,中信優息投資級債,130,50,80,新百王,2024-10-28,6210
2436,偉詮電,70,2,68,新百王,2024-10-28,6210
00936,台新永續高息中小,56,0,56,新百王,2024-10-28,6210
00937B,群益ESG投等債20,72,23,49,新百王,2024-10-28,6210
6505,台塑化,42,1,41,新百王,2024-10-28,6210
00687B,國泰20年美債,42,2,40,新百王,2024-10-28,6210
2303,聯電,85,50,35,新百王,2024-10-28,6210
00688L,國泰20年美債正2,44,10,34,新百王,2024-10-28,6210
2312,金寶,66,36,30,新百王,2024-10-28,6210
2103,台橡,29,2,27,新百王,2024-10-28,6210
3232,昱捷,26,0,26,新百王,2024-10-28,6210
00795B,中信美國公債20年,38,12,26,新百王,2024-10-28,6210
00679B,元大美債20年,28,4,24,新百王,2024-10-28,6210
1785,光洋科,23,0,23,新百王,2024-10-28,6210
00857B,永豐20年美公債,23,0,23,新百王,2024-10-28,6210
00905,FT臺灣Smart,31,10,21,新百王,2024-10-28,6210
2330,台積電,31,10,21,新百王,2024-10-28,6210
5211,蒙恬,19,0,19,新百王,2024-10-28,6210
5512,力麒,57,39,18,新百王,2024-10-28,6210
3105,穩懋,18,1,17,新百王,2024-10-28,6210
2884,玉山金,17,0,17,新百王,2024-10-28,6210
1598,岱宇,16,0,16,新百王,2024-10-28,6210
4908,前鼎,16,0,16,新百王,2024-10-28,6210
3045,台灣大,18,3,15,新百王,2024-10-28,6210
6415,矽力*-KY,15,1,14,新百王,2024-10-28,6210
2344,華邦電,14,1,13,新百王,2024-10-28,6210
3231,緯創,14,1,13,新百王,2024-10-28,6210
6830,汎銓,12,0,12,新百王,2024-10-28,6210
2543,皇昌,52,40,12,新百王,2024-10-28,6210
8358,金居,12,0,12,新百王,2024-10-28,6210
2027,大成鋼,70,58,12,新百王,2024-10-28,6210
2374,佳能,28,16,12,新百王,2024-10-28,6210
00665L,富邦�琤肭磪囓�2,86,75,11,新百王,2024-10-28,6210
00720B,元大投資級公司債,11,0,11,新百王,2024-10-28,6210
1514,亞力,11,0,11,新百王,2024-10-28,6210
9958,世紀鋼,11,0,11,新百王,2024-10-28,6210
2354,鴻準,67,57,10,新百王,2024-10-28,6210
00958B,永豐ESG銀行債15,10,0,10,新百王,2024-10-28,6210
8034,榮群,10,0,10,新百王,2024-10-28,6210
2601,益航,10,0,10,新百王,2024-10-28,6210
1584,精剛,10,0,10,新百王,2024-10-28,6210
2028,威致,10,0,10,新百王,2024-10-28,6210
6216,居易,10,0,10,新百王,2024-10-28,6210
3481,群創,465,73,392,新百王,2024-10-29,6210
00715L,期街口布蘭特正2,285,19,266,新百王,2024-10-29,6210
2883,凱基金,149,1,148,新百王,2024-10-29,6210
00919,群益台灣精選高息,84,1,83,新百王,2024-10-29,6210
0056,元大高股息,83,4,79,新百王,2024-10-29,6210
00712,復華富時不動產,77,0,77,新百王,2024-10-29,6210
2303,聯電,60,2,58,新百王,2024-10-29,6210
00878,國泰永續高股息,60,2,58,新百王,2024-10-29,6210
8074,鉅橡,57,0,57,新百王,2024-10-29,6210
6015,宏遠證,50,0,50,新百王,2024-10-29,6210
2323,中環,44,0,44,新百王,2024-10-29,6210
00881,國泰台灣5G+,47,5,42,新百王,2024-10-29,6210
1806,冠軍,40,0,40,新百王,2024-10-29,6210
6505,台塑化,40,5,35,新百王,2024-10-29,6210
00948B,中信優息投資級債,45,10,35,新百王,2024-10-29,6210
6770,力積電,33,0,33,新百王,2024-10-29,6210
3550,聯穎,30,0,30,新百王,2024-10-29,6210
5521,工信,31,1,30,新百王,2024-10-29,6210
00708L,期元大S＆P黃金正2,33,6,27,新百王,2024-10-29,6210
2431,聯昌,185,158,27,新百王,2024-10-29,6210
2413,環科,27,2,25,新百王,2024-10-29,6210
2903,遠百,24,0,24,新百王,2024-10-29,6210
8183,精星,25,1,24,新百王,2024-10-29,6210
00922,國泰台灣領袖50,21,0,21,新百王,2024-10-29,6210
3035,智原,27,6,21,新百王,2024-10-29,6210
00923,群益台ESG低碳50,21,0,21,新百王,2024-10-29,6210
00725B,國泰投資級公司債,20,0,20,新百王,2024-10-29,6210
4956,光鋐,19,3,16,新百王,2024-10-29,6210
00713,元大台灣高息低波,19,4,15,新百王,2024-10-29,6210
00915,凱基優選高股息30,15,0,15,新百王,2024-10-29,6210
4935,茂林-KY,15,0,15,新百王,2024-10-29,6210
2607,榮運,15,0,15,新百王,2024-10-29,6210
8105,凌巨,15,0,15,新百王,2024-10-29,6210
6191,精成科,15,0,15,新百王,2024-10-29,6210
6227,茂綸,14,0,14,新百王,2024-10-29,6210
5488,松普,150,136,14,新百王,2024-10-29,6210
5351,鈺創,15,1,14,新百王,2024-10-29,6210
4527,方土霖,36,22,14,新百王,2024-10-29,6210
3715,定穎投控,23,10,13,新百王,2024-10-29,6210
00946,群益科技高息成長,13,0,13,新百王,2024-10-29,6210
2236,百達-KY,16,3,13,新百王,2024-10-29,6210
006208,富邦台50,15,3,12,新百王,2024-10-29,6210
3484,崧騰,24,12,12,新百王,2024-10-29,6210
9940,信義,11,0,11,新百王,2024-10-29,6210
00943,兆豐電子高息等權,11,0,11,新百王,2024-10-29,6210
00753L,中信中國50正2,30,19,11,新百王,2024-10-29,6210
5398,慕康生醫,11,0,11,新百王,2024-10-29,6210
0050,元大台灣50,14,4,10,新百王,2024-10-29,6210
00675L,富邦臺灣加權正2,11,1,10,新百王,2024-10-29,6210
00918,大華優利高填息30,10,0,10,新百王,2024-10-29,6210
00632R,元大台灣50反1,303,0,303,新百王,2024-10-30,6210
00665L,富邦�琤肭磪囓�2,278,0,278,新百王,2024-10-30,6210
3591,艾笛森,202,2,200,新百王,2024-10-30,6210
0056,元大高股息,160,4,156,新百王,2024-10-30,6210
2354,鴻準,475,332,143,新百王,2024-10-30,6210
00753L,中信中國50正2,115,5,110,新百王,2024-10-30,6210
00934,中信成長高股息,103,0,103,新百王,2024-10-30,6210
00637L,元大滬深300正2,189,103,86,新百王,2024-10-30,6210
00687B,國泰20年美債,109,23,86,新百王,2024-10-30,6210
00929,復華台灣科技優息,63,1,62,新百王,2024-10-30,6210
3481,群創,66,6,60,新百王,2024-10-30,6210
00650L,復華香港正2,60,0,60,新百王,2024-10-30,6210
00959B,大華投等美債15Y+,60,0,60,新百王,2024-10-30,6210
00712,復華富時不動產,56,0,56,新百王,2024-10-30,6210
2303,聯電,45,2,43,新百王,2024-10-30,6210
5452,佶優,35,0,35,新百王,2024-10-30,6210
00715L,期街口布蘭特正2,33,0,33,新百王,2024-10-30,6210
2317,鴻海,129,96,33,新百王,2024-10-30,6210
00882,中信中國高股息,32,0,32,新百王,2024-10-30,6210
4919,新唐,123,93,30,新百王,2024-10-30,6210
6603,富強鑫,30,0,30,新百王,2024-10-30,6210
00680L,元大美債20正2,50,20,30,新百王,2024-10-30,6210
5512,力麒,40,10,30,新百王,2024-10-30,6210
3520,華盈,31,2,29,新百王,2024-10-30,6210
9105,泰金寶-DR,62,36,26,新百王,2024-10-30,6210
2337,旺宏,23,0,23,新百王,2024-10-30,6210
8390,金益鼎,25,4,21,新百王,2024-10-30,6210
2328,廣宇,35,14,21,新百王,2024-10-30,6210
5521,工信,18,0,18,新百王,2024-10-30,6210
6109,亞元,33,15,18,新百王,2024-10-30,6210
1314,中石化,26,10,16,新百王,2024-10-30,6210
5371,中光電,16,0,16,新百王,2024-10-30,6210
2332,友訊,18,2,16,新百王,2024-10-30,6210
2405,輔信,15,0,15,新百王,2024-10-30,6210
2201,裕隆,13,0,13,新百王,2024-10-30,6210
3047,訊舟,16,3,13,新百王,2024-10-30,6210
6156,松上,26,14,12,新百王,2024-10-30,6210
3704,合勤控,28,17,11,新百王,2024-10-30,6210
2312,金寶,23,12,11,新百王,2024-10-30,6210
2515,中工,11,0,11,新百王,2024-10-30,6210
00946,群益科技高息成長,10,0,10,新百王,2024-10-30,6210
2492,華新科,13,3,10,新百王,2024-10-30,6210
1708,東鹼,10,0,10,新百王,2024-10-30,6210
2906,高林,10,0,10,新百王,2024-10-30,6210
5288,豐祥-KY,10,0,10,新百王,2024-10-30,6210
9940,信義,10,0,10,新百王,2024-10-30,6210
9914,美利達,9,0,9,新百王,2024-10-30,6210
6138,茂達,9,0,9,新百王,2024-10-30,6210
2472,立隆電,8,0,8,新百王,2024-10-30,6210
1609,大亞,10,2,8,新百王,2024-10-30,6210
00680L,元大美債20正2,268,17,251,新百王,2024-11-01,6210
00960,野村全球航運龍頭,225,0,225,新百王,2024-11-01,6210
5876,上海商銀,182,0,182,新百王,2024-11-01,6210
00945B,凱基美國非投等債,149,0,149,新百王,2024-11-01,6210
00936,台新永續高息中小,164,52,112,新百王,2024-11-01,6210
00953B,群益優選非投等債,102,0,102,新百王,2024-11-01,6210
00929,復華台灣科技優息,86,20,66,新百王,2024-11-01,6210
2354,鴻準,251,197,54,新百王,2024-11-01,6210
00948B,中信優息投資級債,173,120,53,新百王,2024-11-01,6210
00919,群益台灣精選高息,46,2,44,新百王,2024-11-01,6210
2303,聯電,71,27,44,新百王,2024-11-01,6210
00931B,統一美債20年,43,0,43,新百王,2024-11-01,6210
2906,高林,39,8,31,新百王,2024-11-01,6210
5014,建錩,30,0,30,新百王,2024-11-01,6210
00918,大華優利高填息30,30,0,30,新百王,2024-11-01,6210
2353,宏��,27,0,27,新百王,2024-11-01,6210
00878,國泰永續高股息,37,10,27,新百王,2024-11-01,6210
1785,光洋科,36,10,26,新百王,2024-11-01,6210
00937B,群益ESG投等債20,24,0,24,新百王,2024-11-01,6210
3419,譁裕,24,0,24,新百王,2024-11-01,6210
3035,智原,30,7,23,新百王,2024-11-01,6210
2337,旺宏,25,2,23,新百王,2024-11-01,6210
00941,中信上游半導體,22,0,22,新百王,2024-11-01,6210
2317,鴻海,49,27,22,新百王,2024-11-01,6210
00687B,國泰20年美債,30,10,20,新百王,2024-11-01,6210
1449,佳和,31,11,20,新百王,2024-11-01,6210
2801,彰銀,20,0,20,新百王,2024-11-01,6210
2367,燿華,20,2,18,新百王,2024-11-01,6210
3615,安可,17,0,17,新百王,2024-11-01,6210
6505,台塑化,18,1,17,新百王,2024-11-01,6210
3062,建漢,17,1,16,新百王,2024-11-01,6210
00830,國泰費城半導體,15,0,15,新百王,2024-11-01,6210
3016,嘉晶,17,2,15,新百王,2024-11-01,6210
3234,光環,20,5,15,新百王,2024-11-01,6210
1312,國喬,15,0,15,新百王,2024-11-01,6210
2392,正崴,18,3,15,新百王,2024-11-01,6210
2880,華南金,15,0,15,新百王,2024-11-01,6210
2867,三商壽,15,1,14,新百王,2024-11-01,6210
6288,聯嘉,13,0,13,新百王,2024-11-01,6210
6257,矽格,13,0,13,新百王,2024-11-01,6210
5398,慕康生醫,13,0,13,新百王,2024-11-01,6210
00713,元大台灣高息低波,16,3,13,新百王,2024-11-01,6210
2706,第一店,12,0,12,新百王,2024-11-01,6210
1464,得力,12,0,12,新百王,2024-11-01,6210
2431,聯昌,87,76,11,新百王,2024-11-01,6210
1301,台塑,13,2,11,新百王,2024-11-01,6210
2884,玉山金,11,0,11,新百王,2024-11-01,6210
4535,至興,11,0,11,新百王,2024-11-01,6210
4958,臻鼎-KY,11,0,11,新百王,2024-11-01,6210
6136,富爾特,11,0,11,新百王,2024-11-01,6210
00632R,元大台灣50反1,505,0,505,新百王,2024-11-04,6210
00687B,國泰20年美債,130,4,126,新百王,2024-11-04,6210
9105,泰金寶-DR,283,171,112,新百王,2024-11-04,6210
1528,恩德,154,56,98,新百王,2024-11-04,6210
00688L,國泰20年美債正2,70,0,70,新百王,2024-11-04,6210
00712,復華富時不動產,103,40,63,新百王,2024-11-04,6210
00934,中信成長高股息,60,0,60,新百王,2024-11-04,6210
00945B,凱基美國非投等債,60,0,60,新百王,2024-11-04,6210
00878,國泰永續高股息,56,1,55,新百王,2024-11-04,6210
2701,萬企,49,0,49,新百王,2024-11-04,6210
2706,第一店,44,0,44,新百王,2024-11-04,6210
00715L,期街口布蘭特正2,50,7,43,新百王,2024-11-04,6210
2303,聯電,51,10,41,新百王,2024-11-04,6210
00937B,群益ESG投等債20,41,0,41,新百王,2024-11-04,6210
1314,中石化,38,0,38,新百王,2024-11-04,6210
5512,力麒,60,30,30,新百王,2024-11-04,6210
00665L,富邦�琤肭磪囓�2,70,40,30,新百王,2024-11-04,6210
00650L,復華香港正2,30,0,30,新百王,2024-11-04,6210
2344,華邦電,30,3,27,新百王,2024-11-04,6210
6133,金橋,68,44,24,新百王,2024-11-04,6210
2458,義隆,23,1,22,新百王,2024-11-04,6210
8011,台通,43,23,20,新百王,2024-11-04,6210
2609,陽明,69,50,19,新百王,2024-11-04,6210
00637L,元大滬深300正2,38,19,19,新百王,2024-11-04,6210
3710,連展投控,20,1,19,新百王,2024-11-04,6210
2426,鼎元,21,3,18,新百王,2024-11-04,6210
1445,大宇,18,0,18,新百王,2024-11-04,6210
00933B,國泰10Y+金融債,20,3,17,新百王,2024-11-04,6210
3691,碩禾,15,0,15,新百王,2024-11-04,6210
3032,偉訓,15,0,15,新百王,2024-11-04,6210
2613,中櫃,76,61,15,新百王,2024-11-04,6210
4576,大銀微系統,15,1,14,新百王,2024-11-04,6210
6134,萬旭,26,13,13,新百王,2024-11-04,6210
2337,旺宏,14,2,12,新百王,2024-11-04,6210
00773B,中信優先金融債,12,0,12,新百王,2024-11-04,6210
00929,復華台灣科技優息,51,40,11,新百王,2024-11-04,6210
2524,京城,19,8,11,新百王,2024-11-04,6210
4207,環泰,11,0,11,新百王,2024-11-04,6210
3701,大眾控,13,2,11,新百王,2024-11-04,6210
2608,嘉里大榮,11,1,10,新百王,2024-11-04,6210
1312,國喬,20,10,10,新百王,2024-11-04,6210
6770,力積電,15,5,10,新百王,2024-11-04,6210
2887,台新金,10,0,10,新百王,2024-11-04,6210
2206,三陽工業,10,0,10,新百王,2024-11-04,6210
2027,大成鋼,20,10,10,新百王,2024-11-04,6210
00639,富邦深100,10,0,10,新百王,2024-11-04,6210
00753L,中信中國50正2,20,10,10,新百王,2024-11-04,6210
00642U,期元大S＆P石油,10,0,10,新百王,2024-11-04,6210
2399,映泰,54,44,10,新百王,2024-11-04,6210
3419,譁裕,10,0,10,新百王,2024-11-04,6210
00632R,元大台灣50反1,710,111,599,新百王,2024-11-05,6210
00715L,期街口布蘭特正2,170,27,143,新百王,2024-11-05,6210
3615,安可,144,15,129,新百王,2024-11-05,6210
00937B,群益ESG投等債20,100,0,100,新百王,2024-11-05,6210
5876,上海商銀,100,0,100,新百王,2024-11-05,6210
00753L,中信中國50正2,126,29,97,新百王,2024-11-05,6210
00887,永豐中國科技50大,113,20,93,新百王,2024-11-05,6210
2834,臺企銀,68,0,68,新百王,2024-11-05,6210
3290,東浦,60,0,60,新百王,2024-11-05,6210
00934,中信成長高股息,60,1,59,新百王,2024-11-05,6210
00936,台新永續高息中小,52,0,52,新百王,2024-11-05,6210
2489,瑞軒,55,3,52,新百王,2024-11-05,6210
00946,群益科技高息成長,50,0,50,新百王,2024-11-05,6210
2344,華邦電,47,0,47,新百王,2024-11-05,6210
4729,熒茂,44,0,44,新百王,2024-11-05,6210
9904,寶成,48,12,36,新百王,2024-11-05,6210
1466,聚隆,32,0,32,新百王,2024-11-05,6210
8163,達方,31,0,31,新百王,2024-11-05,6210
00679B,元大美債20年,27,0,27,新百王,2024-11-05,6210
2317,鴻海,45,18,27,新百王,2024-11-05,6210
4956,光鋐,81,59,22,新百王,2024-11-05,6210
6505,台塑化,22,0,22,新百王,2024-11-05,6210
8421,旭源,21,0,21,新百王,2024-11-05,6210
2027,大成鋼,54,33,21,新百王,2024-11-05,6210
00950B,凱基A級公司債,20,0,20,新百王,2024-11-05,6210
9105,泰金寶-DR,88,68,20,新百王,2024-11-05,6210
2062,橋椿,21,2,19,新百王,2024-11-05,6210
2303,聯電,30,12,18,新百王,2024-11-05,6210
5521,工信,18,0,18,新百王,2024-11-05,6210
1815,富喬,43,26,17,新百王,2024-11-05,6210
6134,萬旭,39,23,16,新百王,2024-11-05,6210
2809,京城銀,37,21,16,新百王,2024-11-05,6210
6550,北極星藥業-KY,16,0,16,新百王,2024-11-05,6210
00941,中信上游半導體,16,0,16,新百王,2024-11-05,6210
3711,日月光投控,29,14,15,新百王,2024-11-05,6210
1314,中石化,15,0,15,新百王,2024-11-05,6210
2431,聯昌,79,64,15,新百王,2024-11-05,6210
4526,東台,15,1,14,新百王,2024-11-05,6210
00637L,元大滬深300正2,244,230,14,新百王,2024-11-05,6210
00662,富邦NASDAQ,13,0,13,新百王,2024-11-05,6210
6231,系微,13,1,12,新百王,2024-11-05,6210
6719,力智,14,2,12,新百王,2024-11-05,6210
3013,晟銘電,36,24,12,新百王,2024-11-05,6210
6658,聯策,13,1,12,新百王,2024-11-05,6210
2354,鴻準,225,214,11,新百王,2024-11-05,6210
4903,聯光通,55,44,11,新百王,2024-11-05,6210
1316,上曜,11,0,11,新百王,2024-11-05,6210
3062,建漢,28,17,11,新百王,2024-11-05,6210
1445,大宇,11,0,11,新百王,2024-11-05,6210
6830,汎銓,12,1,11,新百王,2024-11-05,6210
00680L,元大美債20正2,1061,181,880,新百王,2024-11-06,6210
00688L,國泰20年美債正2,513,45,468,新百王,2024-11-06,6210
00665L,富邦�琤肭磪囓�2,235,37,198,新百王,2024-11-06,6210
2312,金寶,343,163,180,新百王,2024-11-06,6210
4526,東台,165,24,141,新百王,2024-11-06,6210
5876,上海商銀,106,16,90,新百王,2024-11-06,6210
00687B,國泰20年美債,161,91,70,新百王,2024-11-06,6210
00795B,中信美國公債20年,138,72,66,新百王,2024-11-06,6210
3036A,文曄甲特,61,0,61,新百王,2024-11-06,6210
00650L,復華香港正2,71,11,60,新百王,2024-11-06,6210
2344,華邦電,55,0,55,新百王,2024-11-06,6210
4956,光鋐,69,25,44,新百王,2024-11-06,6210
00788B,元大10年IG電能債,42,0,42,新百王,2024-11-06,6210
00753L,中信中國50正2,157,120,37,新百王,2024-11-06,6210
2838,聯邦銀,35,0,35,新百王,2024-11-06,6210
3045,台灣大,36,2,34,新百王,2024-11-06,6210
8249,菱光,130,97,33,新百王,2024-11-06,6210
2834,臺企銀,59,26,33,新百王,2024-11-06,6210
2883,凱基金,32,2,30,新百王,2024-11-06,6210
2317,鴻海,71,43,28,新百王,2024-11-06,6210
2615,萬海,45,18,27,新百王,2024-11-06,6210
9933,中鼎,26,0,26,新百王,2024-11-06,6210
1609,大亞,35,10,25,新百王,2024-11-06,6210
6279,胡連,24,0,24,新百王,2024-11-06,6210
2014,中鴻,34,13,21,新百王,2024-11-06,6210
2412,中華電,21,1,20,新百王,2024-11-06,6210
5438,東友,34,14,20,新百王,2024-11-06,6210
00939,統一台灣高息動能,20,0,20,新百王,2024-11-06,6210
6742,澤米,36,17,19,新百王,2024-11-06,6210
00712,復華富時不動產,19,1,18,新百王,2024-11-06,6210
3661,世芯-KY,24,8,16,新百王,2024-11-06,6210
2303,聯電,25,9,16,新百王,2024-11-06,6210
00713,元大台灣高息低波,15,0,15,新百王,2024-11-06,6210
2103,台橡,15,0,15,新百王,2024-11-06,6210
2882,國泰金,15,0,15,新百王,2024-11-06,6210
6216,居易,16,2,14,新百王,2024-11-06,6210
2027,大成鋼,26,12,14,新百王,2024-11-06,6210
2609,陽明,18,5,13,新百王,2024-11-06,6210
8070,長華*,15,3,12,新百王,2024-11-06,6210
8064,東捷,17,5,12,新百王,2024-11-06,6210
3317,尼克森,12,1,11,新百王,2024-11-06,6210
4545,銘鈺,12,1,11,新百王,2024-11-06,6210
9940,信義,11,0,11,新百王,2024-11-06,6210
00844B,新光15年IG金融債,11,0,11,新百王,2024-11-06,6210
6271,同欣電,12,2,10,新百王,2024-11-06,6210
00958B,永豐ESG銀行債15,10,0,10,新百王,2024-11-06,6210
2520,冠德,10,0,10,新百王,2024-11-06,6210
3520,華盈,10,0,10,新百王,2024-11-06,6210
9103,美德醫療-DR,10,0,10,新百王,2024-11-06,6210
2885,元大金,10,0,10,新百王,2024-11-06,6210
00688L,國泰20年美債正2,233,5,228,新百王,2024-11-07,6210
00680L,元大美債20正2,160,15,145,新百王,2024-11-07,6210
00687B,國泰20年美債,143,0,143,新百王,2024-11-07,6210
5014,建錩,100,5,95,新百王,2024-11-07,6210
2867,三商壽,87,0,87,新百王,2024-11-07,6210
3149,正達,119,42,77,新百王,2024-11-07,6210
2812,台中銀,65,5,60,新百王,2024-11-07,6210
00907,永豐優息存股,60,0,60,新百王,2024-11-07,6210
00943,兆豐電子高息等權,61,3,58,新百王,2024-11-07,6210
6770,力積電,50,1,49,新百王,2024-11-07,6210
1815,富喬,92,57,35,新百王,2024-11-07,6210
00679B,元大美債20年,49,16,33,新百王,2024-11-07,6210
4576,大銀微系統,29,1,28,新百王,2024-11-07,6210
1587,吉茂,25,0,25,新百王,2024-11-07,6210
2027,大成鋼,35,14,21,新百王,2024-11-07,6210
2615,萬海,60,40,20,新百王,2024-11-07,6210
2601,益航,20,0,20,新百王,2024-11-07,6210
4562,穎漢,25,5,20,新百王,2024-11-07,6210
6156,松上,18,0,18,新百王,2024-11-07,6210
2493,揚博,21,3,18,新百王,2024-11-07,6210
8111,立��,23,5,18,新百王,2024-11-07,6210
3062,建漢,55,38,17,新百王,2024-11-07,6210
2889,國票金,15,0,15,新百王,2024-11-07,6210
3701,大眾控,23,8,15,新百王,2024-11-07,6210
2892,第一金,23,8,15,新百王,2024-11-07,6210
00712,復華富時不動產,14,0,14,新百王,2024-11-07,6210
1464,得力,20,6,14,新百王,2024-11-07,6210
3663,鑫科,17,4,13,新百王,2024-11-07,6210
2637,慧洋-KY,18,6,12,新百王,2024-11-07,6210
2425,承啟,28,16,12,新百王,2024-11-07,6210
2305,全友,11,0,11,新百王,2024-11-07,6210
2845,遠東銀,10,0,10,新百王,2024-11-07,6210
00673R,期元大S＆P原油反1,10,0,10,新百王,2024-11-07,6210
1524,耿鼎,10,0,10,新百王,2024-11-07,6210
8150,南茂,10,0,10,新百王,2024-11-07,6210
2890,永豐金,10,0,10,新百王,2024-11-07,6210
2314,台揚,18,8,10,新百王,2024-11-07,6210
2548,華固,10,0,10,新百王,2024-11-07,6210
1101,台泥,10,0,10,新百王,2024-11-07,6210
6190,萬泰科,10,0,10,新百王,2024-11-07,6210
1714,和桐,10,0,10,新百王,2024-11-07,6210
006208,富邦台50,14,4,10,新百王,2024-11-07,6210
00713,元大台灣高息低波,9,0,9,新百王,2024-11-07,6210
6285,啟��,12,3,9,新百王,2024-11-07,6210
2816,旺旺保,9,0,9,新百王,2024-11-07,6210
1569,濱川,9,0,9,新百王,2024-11-07,6210
4977,眾達-KY,14,6,8,新百王,2024-11-07,6210
0056,元大高股息,8,0,8,新百王,2024-11-07,6210
00795B,中信美國公債20年,16,8,8,新百王,2024-11-07,6210
3545,敦泰,8,1,7,新百王,2024-11-07,6210
00887,永豐中國科技50大,229,4,225,新百王,2024-11-08,6210
9105,泰金寶-DR,540,327,213,新百王,2024-11-08,6210
1447,力鵬,180,0,180,新百王,2024-11-08,6210
00753L,中信中國50正2,174,40,134,新百王,2024-11-08,6210
2312,金寶,148,26,122,新百王,2024-11-08,6210
6505,台塑化,114,0,114,新百王,2024-11-08,6210
5876,上海商銀,105,0,105,新百王,2024-11-08,6210
3033,威健,100,0,100,新百王,2024-11-08,6210
00959B,大華投等美債15Y+,100,0,100,新百王,2024-11-08,6210
1718,中纖,95,0,95,新百王,2024-11-08,6210
2834,臺企銀,93,0,93,新百王,2024-11-08,6210
00929,復華台灣科技優息,90,15,75,新百王,2024-11-08,6210
00932,兆豐永續高息等權,67,1,66,新百王,2024-11-08,6210
8105,凌巨,61,0,61,新百王,2024-11-08,6210
1314,中石化,64,6,58,新百王,2024-11-08,6210
2302,麗正,70,15,55,新百王,2024-11-08,6210
2014,中鴻,47,0,47,新百王,2024-11-08,6210
00878,國泰永續高股息,46,2,44,新百王,2024-11-08,6210
00637L,元大滬深300正2,391,349,42,新百王,2024-11-08,6210
00665L,富邦�琤肭磪囓�2,282,241,41,新百王,2024-11-08,6210
6770,力積電,35,0,35,新百王,2024-11-08,6210
2392,正崴,78,44,34,新百王,2024-11-08,6210
2353,宏��,33,0,33,新百王,2024-11-08,6210
3284,太普高,32,0,32,新百王,2024-11-08,6210
5381,合正,31,0,31,新百王,2024-11-08,6210
00671R,富邦NASDAQ反1,30,0,30,新百王,2024-11-08,6210
3290,東浦,43,13,30,新百王,2024-11-08,6210
00638R,元大滬深300反1,30,0,30,新百王,2024-11-08,6210
6191,精成科,29,0,29,新百王,2024-11-08,6210
6706,惠特,35,6,29,新百王,2024-11-08,6210
2356,英業達,45,18,27,新百王,2024-11-08,6210
00943,兆豐電子高息等權,27,0,27,新百王,2024-11-08,6210
2388,威盛,33,7,26,新百王,2024-11-08,6210
00651R,復華香港反1,25,0,25,新百王,2024-11-08,6210
1531,高林股,40,15,25,新百王,2024-11-08,6210
3062,建漢,94,70,24,新百王,2024-11-08,6210
2610,華航,60,37,23,新百王,2024-11-08,6210
2317,鴻海,42,20,22,新百王,2024-11-08,6210
2851,中再保,22,0,22,新百王,2024-11-08,6210
2414,精技,22,0,22,新百王,2024-11-08,6210
3037,欣興,41,19,22,新百王,2024-11-08,6210
5512,力麒,71,50,21,新百王,2024-11-08,6210
00666R,富邦�琤肭磪齯�1,20,0,20,新百王,2024-11-08,6210
00656R,國泰中國A50反1,20,0,20,新百王,2024-11-08,6210
00634R,富邦上証反1,20,0,20,新百王,2024-11-08,6210
3312,弘憶股,33,13,20,新百王,2024-11-08,6210
00919,群益台灣精選高息,22,3,19,新百王,2024-11-08,6210
3588,通嘉,23,4,19,新百王,2024-11-08,6210
2303,聯電,74,55,19,新百王,2024-11-08,6210
2615,萬海,91,72,19,新百王,2024-11-08,6210
00680L,元大美債20正2,540,13,527,新百王,2024-11-11,6210
9105,泰金寶-DR,364,91,273,新百王,2024-11-11,6210
2312,金寶,136,24,112,新百王,2024-11-11,6210
00665L,富邦�琤肭磪囓�2,166,61,105,新百王,2024-11-11,6210
00753L,中信中國50正2,199,105,94,新百王,2024-11-11,6210
00688L,國泰20年美債正2,132,52,80,新百王,2024-11-11,6210
00637L,元大滬深300正2,186,127,59,新百王,2024-11-11,6210
00650L,復華香港正2,105,50,55,新百王,2024-11-11,6210
1314,中石化,48,0,48,新百王,2024-11-11,6210
4908,前鼎,46,1,45,新百王,2024-11-11,6210
2834,臺企銀,114,73,41,新百王,2024-11-11,6210
00948B,中信優息投資級債,106,65,41,新百王,2024-11-11,6210
2317,鴻海,72,32,40,新百王,2024-11-11,6210
00671R,富邦NASDAQ反1,30,0,30,新百王,2024-11-11,6210
00943,兆豐電子高息等權,27,0,27,新百王,2024-11-11,6210
1569,濱川,25,1,24,新百王,2024-11-11,6210
6180,橘子,26,2,24,新百王,2024-11-11,6210
5871,中租-KY,27,4,23,新百王,2024-11-11,6210
00919,群益台灣精選高息,26,5,21,新百王,2024-11-11,6210
0056,元大高股息,25,4,21,新百王,2024-11-11,6210
6133,金橋,23,2,21,新百王,2024-11-11,6210
00881,國泰台灣5G+,25,5,20,新百王,2024-11-11,6210
1445,大宇,20,0,20,新百王,2024-11-11,6210
5014,建錩,36,16,20,新百王,2024-11-11,6210
2206,三陽工業,24,5,19,新百王,2024-11-11,6210
3036A,文曄甲特,19,0,19,新百王,2024-11-11,6210
6416,瑞祺電通,18,1,17,新百王,2024-11-11,6210
3303,岱稜,35,18,17,新百王,2024-11-11,6210
2354,鴻準,111,95,16,新百王,2024-11-11,6210
6770,力積電,16,0,16,新百王,2024-11-11,6210
5243,乙盛-KY,20,5,15,新百王,2024-11-11,6210
2344,華邦電,29,15,14,新百王,2024-11-11,6210
2641,正德,15,1,14,新百王,2024-11-11,6210
2353,宏��,16,3,13,新百王,2024-11-11,6210
2753,八方雲集,13,0,13,新百王,2024-11-11,6210
2609,陽明,23,11,12,新百王,2024-11-11,6210
4971,IET-KY,12,0,12,新百王,2024-11-11,6210
4977,眾達-KY,19,7,12,新百王,2024-11-11,6210
5438,東友,63,51,12,新百王,2024-11-11,6210
1446,宏和,13,1,12,新百王,2024-11-11,6210
6177,達麗,12,0,12,新百王,2024-11-11,6210
2489,瑞軒,14,3,11,新百王,2024-11-11,6210
7584,樂意,11,0,11,新百王,2024-11-11,6210
1326,台化,11,0,11,新百王,2024-11-11,6210
6863,永道-KY,13,2,11,新百王,2024-11-11,6210
2330,台積電,22,11,11,新百王,2024-11-11,6210
1528,恩德,22,12,10,新百王,2024-11-11,6210
1785,光洋科,11,1,10,新百王,2024-11-11,6210
2488,漢平,11,1,10,新百王,2024-11-11,6210
0052,富邦科技,10,0,10,新百王,2024-11-11,6210
2002,中鋼,586,1,585,新百王,2024-11-12,6210
2888,新光金,250,22,228,新百王,2024-11-12,6210
2618,長榮航,256,29,227,新百王,2024-11-12,6210
3481,群創,242,27,215,新百王,2024-11-12,6210
00665L,富邦�琤肭磪囓�2,281,76,205,新百王,2024-11-12,6210
00715L,期街口布蘭特正2,164,8,156,新百王,2024-11-12,6210
2317,鴻海,136,20,116,新百王,2024-11-12,6210
00878,國泰永續高股息,108,5,103,新百王,2024-11-12,6210
2890,永豐金,122,20,102,新百王,2024-11-12,6210
00934,中信成長高股息,95,0,95,新百王,2024-11-12,6210
00936,台新永續高息中小,80,0,80,新百王,2024-11-12,6210
9105,泰金寶-DR,132,56,76,新百王,2024-11-12,6210
1314,中石化,96,24,72,新百王,2024-11-12,6210
5488,松普,85,15,70,新百王,2024-11-12,6210
5871,中租-KY,74,6,68,新百王,2024-11-12,6210
00680L,元大美債20正2,93,32,61,新百王,2024-11-12,6210
00676R,富邦臺灣加權反1,60,0,60,新百王,2024-11-12,6210
1708,東鹼,78,21,57,新百王,2024-11-12,6210
2615,萬海,90,38,52,新百王,2024-11-12,6210
00650L,復華香港正2,102,51,51,新百王,2024-11-12,6210
00752,中信中國50,50,0,50,新百王,2024-11-12,6210
1718,中纖,39,2,37,新百王,2024-11-12,6210
1301,台塑,37,2,35,新百王,2024-11-12,6210
2851,中再保,35,2,33,新百王,2024-11-12,6210
4979,華星光,40,7,33,新百王,2024-11-12,6210
00882,中信中國高股息,36,4,32,新百王,2024-11-12,6210
00664R,國泰臺灣加權反1,30,0,30,新百王,2024-11-12,6210
4960,誠美材,30,0,30,新百王,2024-11-12,6210
2354,鴻準,131,101,30,新百王,2024-11-12,6210
2332,友訊,34,5,29,新百王,2024-11-12,6210
2610,華航,61,34,27,新百王,2024-11-12,6210
00940,元大台灣價值高息,36,10,26,新百王,2024-11-12,6210
0056,元大高股息,29,4,25,新百王,2024-11-12,6210
2706,第一店,25,0,25,新百王,2024-11-12,6210
3712,永崴投控,65,40,25,新百王,2024-11-12,6210
2353,宏��,26,2,24,新百王,2024-11-12,6210
3045,台灣大,29,6,23,新百王,2024-11-12,6210
5438,東友,51,28,23,新百王,2024-11-12,6210
2607,榮運,44,21,23,新百王,2024-11-12,6210
00637L,元大滬深300正2,92,69,23,新百王,2024-11-12,6210
2014,中鴻,66,44,22,新百王,2024-11-12,6210
3515,華擎,23,1,22,新百王,2024-11-12,6210
00943,兆豐電子高息等權,31,10,21,新百王,2024-11-12,6210
00929,復華台灣科技優息,72,52,20,新百王,2024-11-12,6210
1785,光洋科,20,0,20,新百王,2024-11-12,6210
006208,富邦台50,27,7,20,新百王,2024-11-12,6210
3499,環天科,20,0,20,新百王,2024-11-12,6210
00922,國泰台灣領袖50,20,0,20,新百王,2024-11-12,6210
2069,運錩,20,0,20,新百王,2024-11-12,6210
00881,國泰台灣5G+,24,5,19,新百王,2024-11-12,6210
00688L,國泰20年美債正2,814,0,814,新百王,2024-11-13,6210
9105,泰金寶-DR,566,131,435,新百王,2024-11-13,6210
00948B,中信優息投資級債,112,0,112,新百王,2024-11-13,6210
00882,中信中國高股息,104,0,104,新百王,2024-11-13,6210
00753L,中信中國50正2,90,3,87,新百王,2024-11-13,6210
00887,永豐中國科技50大,90,16,74,新百王,2024-11-13,6210
2701,萬企,74,0,74,新百王,2024-11-13,6210
2349,錸德,193,119,74,新百王,2024-11-13,6210
2324,仁寶,133,62,71,新百王,2024-11-13,6210
00679B,元大美債20年,67,10,57,新百王,2024-11-13,6210
2883,凱基金,57,10,47,新百王,2024-11-13,6210
00665L,富邦�琤肭磪囓�2,85,39,46,新百王,2024-11-13,6210
2706,第一店,40,0,40,新百王,2024-11-13,6210
00929,復華台灣科技優息,33,0,33,新百王,2024-11-13,6210
00637L,元大滬深300正2,93,61,32,新百王,2024-11-13,6210
1785,光洋科,33,3,30,新百王,2024-11-13,6210
2488,漢平,31,1,30,新百王,2024-11-13,6210
2613,中櫃,33,3,30,新百王,2024-11-13,6210
2646,星宇航空,34,5,29,新百王,2024-11-13,6210
2882,國泰金,41,16,25,新百王,2024-11-13,6210
3706,神達,201,178,23,新百王,2024-11-13,6210
7584,樂意,22,0,22,新百王,2024-11-13,6210
1471,首利,22,0,22,新百王,2024-11-13,6210
1312,國喬,21,0,21,新百王,2024-11-13,6210
2609,陽明,30,9,21,新百王,2024-11-13,6210
00957B,兆豐US優選投等債,20,0,20,新百王,2024-11-13,6210
6177,達麗,20,0,20,新百王,2024-11-13,6210
3037,欣興,38,19,19,新百王,2024-11-13,6210
1815,富喬,30,11,19,新百王,2024-11-13,6210
2641,正德,25,7,18,新百王,2024-11-13,6210
2356,英業達,18,0,18,新百王,2024-11-13,6210
00795B,中信美國公債20年,17,0,17,新百王,2024-11-13,6210
2812,台中銀,17,0,17,新百王,2024-11-13,6210
6163,華電網,32,16,16,新百王,2024-11-13,6210
8112A,至上甲特,16,0,16,新百王,2024-11-13,6210
3049,精金,15,0,15,新百王,2024-11-13,6210
2903,遠百,14,0,14,新百王,2024-11-13,6210
8011,台通,49,36,13,新百王,2024-11-13,6210
2891,中信金,12,0,12,新百王,2024-11-13,6210
006206,元大上證50,12,0,12,新百王,2024-11-13,6210
1220,台榮,12,0,12,新百王,2024-11-13,6210
3419,譁裕,53,42,11,新百王,2024-11-13,6210
2915,潤泰全,14,3,11,新百王,2024-11-13,6210
2881,富邦金,11,1,10,新百王,2024-11-13,6210
00918,大華優利高填息30,10,0,10,新百王,2024-11-13,6210
00638R,元大滬深300反1,10,0,10,新百王,2024-11-13,6210
1717,長興,10,0,10,新百王,2024-11-13,6210
1473,台南,10,0,10,新百王,2024-11-13,6210
2897,王道銀行,10,0,10,新百王,2024-11-13,6210
3013,晟銘電,44,35,9,新百王,2024-11-13,6210
9105,泰金寶-DR,716,302,414,新百王,2024-11-14,6210
00878,國泰永續高股息,244,3,241,新百王,2024-11-14,6210
00936,台新永續高息中小,230,0,230,新百王,2024-11-14,6210
00943,兆豐電子高息等權,152,0,152,新百王,2024-11-14,6210
00948B,中信優息投資級債,150,0,150,新百王,2024-11-14,6210
2897,王道銀行,121,0,121,新百王,2024-11-14,6210
2883,凱基金,100,0,100,新百王,2024-11-14,6210
00665L,富邦�琤肭磪囓�2,125,30,95,新百王,2024-11-14,6210
00929,復華台灣科技優息,87,0,87,新百王,2024-11-14,6210
2613,中櫃,61,9,52,新百王,2024-11-14,6210
2317,鴻海,76,25,51,新百王,2024-11-14,6210
00924,復華S＆P500成長,50,0,50,新百王,2024-11-14,6210
2618,長榮航,87,54,33,新百王,2024-11-14,6210
0056,元大高股息,38,5,33,新百王,2024-11-14,6210
1314,中石化,43,11,32,新百王,2024-11-14,6210
8107,大億金茂,30,0,30,新百王,2024-11-14,6210
1466,聚隆,30,0,30,新百王,2024-11-14,6210
2382,廣達,76,47,29,新百王,2024-11-14,6210
8044,網家,29,0,29,新百王,2024-11-14,6210
2312,金寶,38,9,29,新百王,2024-11-14,6210
2701,萬企,28,0,28,新百王,2024-11-14,6210
2890,永豐金,67,40,27,新百王,2024-11-14,6210
006208,富邦台50,29,4,25,新百王,2024-11-14,6210
006206,元大上證50,25,0,25,新百王,2024-11-14,6210
3712,永崴投控,61,37,24,新百王,2024-11-14,6210
2615,萬海,39,15,24,新百王,2024-11-14,6210
0050,元大台灣50,25,2,23,新百王,2024-11-14,6210
00679B,元大美債20年,22,0,22,新百王,2024-11-14,6210
1301,台塑,21,0,21,新百王,2024-11-14,6210
00919,群益台灣精選高息,40,20,20,新百王,2024-11-14,6210
2405,輔信,27,7,20,新百王,2024-11-14,6210
2323,中環,20,0,20,新百王,2024-11-14,6210
2845,遠東銀,19,0,19,新百王,2024-11-14,6210
2344,華邦電,18,0,18,新百王,2024-11-14,6210
3037,欣興,41,23,18,新百王,2024-11-14,6210
2609,陽明,74,58,16,新百王,2024-11-14,6210
1569,濱川,31,15,16,新百王,2024-11-14,6210
1815,富喬,82,66,16,新百王,2024-11-14,6210
2881,富邦金,15,0,15,新百王,2024-11-14,6210
3576,聯合再生,15,0,15,新百王,2024-11-14,6210
3631,晟楠,15,0,15,新百王,2024-11-14,6210
2063,世鎧,17,3,14,新百王,2024-11-14,6210
1504,東元,22,8,14,新百王,2024-11-14,6210
5880,合庫金,13,0,13,新百王,2024-11-14,6210
2374,佳能,25,12,13,新百王,2024-11-14,6210
4919,新唐,31,18,13,新百王,2024-11-14,6210
5871,中租-KY,19,6,13,新百王,2024-11-14,6210
1785,光洋科,16,4,12,新百王,2024-11-14,6210
2303,聯電,15,3,12,新百王,2024-11-14,6210
2412,中華電,14,2,12,新百王,2024-11-14,6210
00687B,國泰20年美債,1310,29,1281,新百王,2024-11-15,6210
9105,泰金寶-DR,1071,393,678,新百王,2024-11-15,6210
00878,國泰永續高股息,443,5,438,新百王,2024-11-15,6210
00679B,元大美債20年,302,52,250,新百王,2024-11-15,6210
00948B,中信優息投資級債,175,0,175,新百王,2024-11-15,6210
00680L,元大美債20正2,151,0,151,新百王,2024-11-15,6210
2897,王道銀行,154,33,121,新百王,2024-11-15,6210
2353,宏��,99,2,97,新百王,2024-11-15,6210
00637L,元大滬深300正2,185,97,88,新百王,2024-11-15,6210
2615,萬海,103,36,67,新百王,2024-11-15,6210
2834,臺企銀,55,0,55,新百王,2024-11-15,6210
00632R,元大台灣50反1,73,21,52,新百王,2024-11-15,6210
2324,仁寶,55,4,51,新百王,2024-11-15,6210
00674R,期元大S＆P黃金反1,50,0,50,新百王,2024-11-15,6210
6443,元晶,42,0,42,新百王,2024-11-15,6210
3706,神達,135,94,41,新百王,2024-11-15,6210
3045,台灣大,41,7,34,新百王,2024-11-15,6210
3090,日電貿,44,13,31,新百王,2024-11-15,6210
1532,勤美,34,3,31,新百王,2024-11-15,6210
1522,堤維西,44,13,31,新百王,2024-11-15,6210
2069,運錩,30,0,30,新百王,2024-11-15,6210
6405,悅城,34,4,30,新百王,2024-11-15,6210
1708,東鹼,31,3,28,新百王,2024-11-15,6210
00753L,中信中國50正2,35,10,25,新百王,2024-11-15,6210
6706,惠特,27,2,25,新百王,2024-11-15,6210
2412,中華電,49,25,24,新百王,2024-11-15,6210
2382,廣達,95,72,23,新百王,2024-11-15,6210
2515,中工,27,4,23,新百王,2024-11-15,6210
2010,春源,22,0,22,新百王,2024-11-15,6210
00937B,群益ESG投等債20,45,24,21,新百王,2024-11-15,6210
6116,彩晶,20,5,15,新百王,2024-11-15,6210
3013,晟銘電,28,14,14,新百王,2024-11-15,6210
00882,中信中國高股息,15,1,14,新百王,2024-11-15,6210
00959B,大華投等美債15Y+,13,0,13,新百王,2024-11-15,6210
2646,星宇航空,15,4,11,新百王,2024-11-15,6210
1616,億泰,11,0,11,新百王,2024-11-15,6210
5398,慕康生醫,21,10,11,新百王,2024-11-15,6210
6505,台塑化,14,3,11,新百王,2024-11-15,6210
5871,中租-KY,28,17,11,新百王,2024-11-15,6210
00887,永豐中國科技50大,10,0,10,新百王,2024-11-15,6210
1308,亞聚,20,10,10,新百王,2024-11-15,6210
6770,力積電,10,0,10,新百王,2024-11-15,6210
8110,華東,20,10,10,新百王,2024-11-15,6210
2409,友達,10,0,10,新百王,2024-11-15,6210
00662,富邦NASDAQ,10,0,10,新百王,2024-11-15,6210
00725B,國泰投資級公司債,10,0,10,新百王,2024-11-15,6210
3228,金麗科,10,0,10,新百王,2024-11-15,6210
2204,中華,10,1,9,新百王,2024-11-15,6210
006208,富邦台50,17,7,10,新百王,2024-11-15,6210
3017,奇鋐,19,10,9,新百王,2024-11-15,6210
00665L,富邦�琤肭磪囓�2,666,13,653,新百王,2024-11-18,6210
9105,泰金寶-DR,673,102,571,新百王,2024-11-18,6210
00943,兆豐電子高息等權,134,0,134,新百王,2024-11-18,6210
2618,長榮航,136,25,111,新百王,2024-11-18,6210
2897,王道銀行,158,49,109,新百王,2024-11-18,6210
00930,永豐ESG低碳高息,107,0,107,新百王,2024-11-18,6210
00753L,中信中國50正2,106,11,95,新百王,2024-11-18,6210
00633L,富邦上証正2,90,0,90,新百王,2024-11-18,6210
00878,國泰永續高股息,74,5,69,新百王,2024-11-18,6210
1326,台化,73,5,68,新百王,2024-11-18,6210
2891,中信金,80,16,64,新百王,2024-11-18,6210
00929,復華台灣科技優息,65,5,60,新百王,2024-11-18,6210
2324,仁寶,69,13,56,新百王,2024-11-18,6210
6191,精成科,50,0,50,新百王,2024-11-18,6210
00679B,元大美債20年,54,5,49,新百王,2024-11-18,6210
2610,華航,155,116,39,新百王,2024-11-18,6210
2354,鴻準,255,219,36,新百王,2024-11-18,6210
4123,晟德,35,0,35,新百王,2024-11-18,6210
2332,友訊,36,2,34,新百王,2024-11-18,6210
2851,中再保,33,0,33,新百王,2024-11-18,6210
006208,富邦台50,36,3,33,新百王,2024-11-18,6210
3050,鈺德,38,9,29,新百王,2024-11-18,6210
2881,富邦金,25,0,25,新百王,2024-11-18,6210
2301,光寶科,29,4,25,新百王,2024-11-18,6210
6505,台塑化,27,2,25,新百王,2024-11-18,6210
8044,網家,68,46,22,新百王,2024-11-18,6210
1815,富喬,22,1,21,新百王,2024-11-18,6210
3005,神基,26,7,19,新百王,2024-11-18,6210
3014,聯陽,21,2,19,新百王,2024-11-18,6210
00915,凱基優選高股息30,17,0,17,新百王,2024-11-18,6210
3706,神達,103,86,17,新百王,2024-11-18,6210
0056,元大高股息,16,0,16,新百王,2024-11-18,6210
2601,益航,25,10,15,新百王,2024-11-18,6210
00712,復華富時不動產,15,0,15,新百王,2024-11-18,6210
8383,千附,15,0,15,新百王,2024-11-18,6210
1609,大亞,15,0,15,新百王,2024-11-18,6210
2439,美律,14,0,14,新百王,2024-11-18,6210
5315,光聯,14,1,13,新百王,2024-11-18,6210
2603,長榮,24,12,12,新百王,2024-11-18,6210
3625,西勝,12,0,12,新百王,2024-11-18,6210
00688L,國泰20年美債正2,12,0,12,新百王,2024-11-18,6210
3711,日月光投控,41,29,12,新百王,2024-11-18,6210
2312,金寶,81,70,11,新百王,2024-11-18,6210
00881,國泰台灣5G+,16,5,11,新百王,2024-11-18,6210
2489,瑞軒,11,0,11,新百王,2024-11-18,6210
3481,群創,23,13,10,新百王,2024-11-18,6210
5871,中租-KY,14,4,10,新百王,2024-11-18,6210
3015,全漢,11,1,10,新百王,2024-11-18,6210
3419,譁裕,10,0,10,新百王,2024-11-18,6210
00655L,國泰中國A50正2,10,0,10,新百王,2024-11-18,6210
9105,泰金寶-DR,464,152,312,新百王,2024-11-19,6210
00688L,國泰20年美債正2,203,0,203,新百王,2024-11-19,6210
00712,復華富時不動產,151,19,132,新百王,2024-11-19,6210
2890,永豐金,125,0,125,新百王,2024-11-19,6210
00637L,元大滬深300正2,217,107,110,新百王,2024-11-19,6210
00719B,元大美債1-3,100,0,100,新百王,2024-11-19,6210
00720B,元大投資級公司債,100,0,100,新百王,2024-11-19,6210
00751B,元大AAA至A公司債,100,0,100,新百王,2024-11-19,6210
00687B,國泰20年美債,118,40,78,新百王,2024-11-19,6210
2618,長榮航,84,11,73,新百王,2024-11-19,6210
00887,永豐中國科技50大,149,80,69,新百王,2024-11-19,6210
2329,華泰,64,5,59,新百王,2024-11-19,6210
00937B,群益ESG投等債20,55,3,52,新百王,2024-11-19,6210
2332,友訊,66,20,46,新百王,2024-11-19,6210
2317,鴻海,57,17,40,新百王,2024-11-19,6210
2392,正崴,55,24,31,新百王,2024-11-19,6210
5876,上海商銀,48,19,29,新百王,2024-11-19,6210
2884,玉山金,27,2,25,新百王,2024-11-19,6210
00918,大華優利高填息30,31,10,21,新百王,2024-11-19,6210
3032,偉訓,54,34,20,新百王,2024-11-19,6210
2908,特力,20,0,20,新百王,2024-11-19,6210
2891,中信金,16,1,15,新百王,2024-11-19,6210
00878,國泰永續高股息,15,0,15,新百王,2024-11-19,6210
2883,凱基金,97,83,14,新百王,2024-11-19,6210
6126,信音,13,0,13,新百王,2024-11-19,6210
6547,高端疫苗,13,0,13,新百王,2024-11-19,6210
2349,錸德,89,78,11,新百王,2024-11-19,6210
4577,達航科技,15,4,11,新百王,2024-11-19,6210
1301,台塑,19,8,11,新百王,2024-11-19,6210
00655L,國泰中國A50正2,10,0,10,新百王,2024-11-19,6210
3481,群創,10,0,10,新百王,2024-11-19,6210
00941,中信上游半導體,10,0,10,新百王,2024-11-19,6210
1528,恩德,20,10,10,新百王,2024-11-19,6210
4123,晟德,10,0,10,新百王,2024-11-19,6210
2905,三商,10,0,10,新百王,2024-11-19,6210
1584,精剛,10,0,10,新百王,2024-11-19,6210
9919,康那香,10,0,10,新百王,2024-11-19,6210
00764B,群益25年美債,10,0,10,新百王,2024-11-19,6210
2882,國泰金,9,0,9,新百王,2024-11-19,6210
2382,廣達,33,24,9,新百王,2024-11-19,6210
3062,建漢,15,6,9,新百王,2024-11-19,6210
6443,元晶,8,0,8,新百王,2024-11-19,6210
4303,信立,10,3,7,新百王,2024-11-19,6210
3037,欣興,17,10,7,新百王,2024-11-19,6210
6890,來億-KY,7,0,7,新百王,2024-11-19,6210
1303,南亞,10,3,7,新百王,2024-11-19,6210
2371,大同,10,3,7,新百王,2024-11-19,6210
8935,邦泰,7,0,7,新百王,2024-11-19,6210
1446,宏和,8,1,7,新百王,2024-11-19,6210
3005,神基,12,6,6,新百王,2024-11-19,6210
00680L,元大美債20正2,350,7,343,新百王,2024-11-20,6210
5876,上海商銀,134,22,112,新百王,2024-11-20,6210
8044,網家,94,7,87,新百王,2024-11-20,6210
00887,永豐中國科技50大,98,17,81,新百王,2024-11-20,6210
2344,華邦電,68,0,68,新百王,2024-11-20,6210
3706,神達,303,238,65,新百王,2024-11-20,6210
00937B,群益ESG投等債20,60,0,60,新百王,2024-11-20,6210
00665L,富邦�琤肭磪囓�2,50,0,50,新百王,2024-11-20,6210
00720B,元大投資級公司債,50,0,50,新百王,2024-11-20,6210
6191,精成科,50,0,50,新百王,2024-11-20,6210
2349,錸德,184,134,50,新百王,2024-11-20,6210
2332,友訊,85,39,46,新百王,2024-11-20,6210
00751B,元大AAA至A公司債,46,0,46,新百王,2024-11-20,6210
3050,鈺德,66,21,45,新百王,2024-11-20,6210
00930,永豐ESG低碳高息,59,20,39,新百王,2024-11-20,6210
1506,正道,30,0,30,新百王,2024-11-20,6210
00929,復華台灣科技優息,32,4,28,新百王,2024-11-20,6210
2330,台積電,28,1,27,新百王,2024-11-20,6210
3450,聯鈞,69,42,27,新百王,2024-11-20,6210
2897,王道銀行,76,50,26,新百王,2024-11-20,6210
3032,偉訓,34,9,25,新百王,2024-11-20,6210
2618,長榮航,38,14,24,新百王,2024-11-20,6210
2834,臺企銀,22,0,22,新百王,2024-11-20,6210
4577,達航科技,22,0,22,新百王,2024-11-20,6210
2399,映泰,24,4,20,新百王,2024-11-20,6210
00951,台新日本半導體,20,0,20,新百王,2024-11-20,6210
5521,工信,19,0,19,新百王,2024-11-20,6210
4113,聯上,17,0,17,新百王,2024-11-20,6210
00675L,富邦臺灣加權正2,18,2,16,新百王,2024-11-20,6210
00715L,期街口布蘭特正2,15,2,13,新百王,2024-11-20,6210
3323,加百裕,29,17,12,新百王,2024-11-20,6210
3447,展達,30,18,12,新百王,2024-11-20,6210
2356,英業達,17,5,12,新百王,2024-11-20,6210
2603,長榮,29,17,12,新百王,2024-11-20,6210
5871,中租-KY,15,4,11,新百王,2024-11-20,6210
1314,中石化,21,10,11,新百王,2024-11-20,6210
00712,復華富時不動產,11,0,11,新百王,2024-11-20,6210
6282,康舒,22,11,11,新百王,2024-11-20,6210
2539,櫻花建,10,0,10,新百王,2024-11-20,6210
2362,藍天,10,0,10,新百王,2024-11-20,6210
3037,欣興,28,18,10,新百王,2024-11-20,6210
5309,系統電,10,0,10,新百王,2024-11-20,6210
00652,富邦印度,10,0,10,新百王,2024-11-20,6210
2905,三商,10,0,10,新百王,2024-11-20,6210
00844B,新光15年IG金融債,10,0,10,新百王,2024-11-20,6210
5465,富驊,10,0,10,新百王,2024-11-20,6210
6558,興能高,10,1,9,新百王,2024-11-20,6210
00632R,元大台灣50反1,10,1,9,新百王,2024-11-20,6210
8929,富堡,16,7,9,新百王,2024-11-20,6210
5314,世紀,9,0,9,新百王,2024-11-20,6210
2317,鴻海,362,24,338,新百王,2024-11-21,6210
5876,上海商銀,231,0,231,新百王,2024-11-21,6210
00697B,元大美債7-10,200,0,200,新百王,2024-11-21,6210
00680L,元大美債20正2,160,0,160,新百王,2024-11-21,6210
9105,泰金寶-DR,353,209,144,新百王,2024-11-21,6210
00753L,中信中國50正2,200,100,100,新百王,2024-11-21,6210
00695B,富邦美債7-10,100,0,100,新百王,2024-11-21,6210
8044,網家,65,4,61,新百王,2024-11-21,6210
2312,金寶,153,95,58,新百王,2024-11-21,6210
4729,熒茂,78,23,55,新百王,2024-11-21,6210
2354,鴻準,87,59,28,新百王,2024-11-21,6210
6770,力積電,30,3,27,新百王,2024-11-21,6210
2313,華通,39,12,27,新百王,2024-11-21,6210
006208,富邦台50,30,4,26,新百王,2024-11-21,6210
00878,國泰永續高股息,28,2,26,新百王,2024-11-21,6210
2881,富邦金,25,0,25,新百王,2024-11-21,6210
2613,中櫃,45,20,25,新百王,2024-11-21,6210
5351,鈺創,25,0,25,新百王,2024-11-21,6210
2520,冠德,22,1,21,新百王,2024-11-21,6210
2882,國泰金,20,0,20,新百王,2024-11-21,6210
6456,GIS-KY,20,0,20,新百王,2024-11-21,6210
8104,錸寶,90,70,20,新百王,2024-11-21,6210
2356,英業達,46,27,19,新百王,2024-11-21,6210
2349,錸德,99,81,18,新百王,2024-11-21,6210
2883,凱基金,25,8,17,新百王,2024-11-21,6210
2002,中鋼,17,0,17,新百王,2024-11-21,6210
1301,台塑,17,0,17,新百王,2024-11-21,6210
00712,復華富時不動產,35,20,15,新百王,2024-11-21,6210
2413,環科,39,25,14,新百王,2024-11-21,6210
1434,福懋,13,0,13,新百王,2024-11-21,6210
00637L,元大滬深300正2,75,62,13,新百王,2024-11-21,6210
00675L,富邦臺灣加權正2,14,2,12,新百王,2024-11-21,6210
2330,台積電,22,10,12,新百王,2024-11-21,6210
6416,瑞祺電通,12,1,11,新百王,2024-11-21,6210
1504,東元,24,13,11,新百王,2024-11-21,6210
9904,寶成,17,6,11,新百王,2024-11-21,6210
00881,國泰台灣5G+,10,0,10,新百王,2024-11-21,6210
00951,台新日本半導體,10,0,10,新百王,2024-11-21,6210
00959B,大華投等美債15Y+,10,0,10,新百王,2024-11-21,6210
2204,中華,50,40,10,新百王,2024-11-21,6210
1708,東鹼,15,5,10,新百王,2024-11-21,6210
00652,富邦印度,10,0,10,新百王,2024-11-21,6210
00946,群益科技高息成長,10,0,10,新百王,2024-11-21,6210
6269,台郡,10,0,10,新百王,2024-11-21,6210
8935,邦泰,16,7,9,新百王,2024-11-21,6210
3520,華盈,8,0,8,新百王,2024-11-21,6210
00713,元大台灣高息低波,9,1,8,新百王,2024-11-21,6210
00937B,群益ESG投等債20,10,2,8,新百王,2024-11-21,6210
2363,矽統,8,0,8,新百王,2024-11-21,6210
00687B,國泰20年美債,61,53,8,新百王,2024-11-21,6210
00665L,富邦�琤肭磪囓�2,267,3,264,新百王,2024-11-22,6210
00632R,元大台灣50反1,190,20,170,新百王,2024-11-22,6210
00948B,中信優息投資級債,166,0,166,新百王,2024-11-22,6210
9105,泰金寶-DR,537,398,139,新百王,2024-11-22,6210
00887,永豐中國科技50大,220,90,130,新百王,2024-11-22,6210
2888,新光金,179,57,122,新百王,2024-11-22,6210
2897,王道銀行,123,13,110,新百王,2024-11-22,6210
00637L,元大滬深300正2,164,74,90,新百王,2024-11-22,6210
00950B,凱基A級公司債,75,0,75,新百王,2024-11-22,6210
00882,中信中國高股息,70,0,70,新百王,2024-11-22,6210
5876,上海商銀,57,0,57,新百王,2024-11-22,6210
2609,陽明,93,43,50,新百王,2024-11-22,6210
1301,台塑,46,4,42,新百王,2024-11-22,6210
2356,英業達,43,4,39,新百王,2024-11-22,6210
2883,凱基金,77,41,36,新百王,2024-11-22,6210
2891,中信金,36,0,36,新百王,2024-11-22,6210
2615,萬海,117,82,35,新百王,2024-11-22,6210
00679B,元大美債20年,31,0,31,新百王,2024-11-22,6210
2641,正德,30,0,30,新百王,2024-11-22,6210
2890,永豐金,50,20,30,新百王,2024-11-22,6210
2317,鴻海,39,19,20,新百王,2024-11-22,6210
00720B,元大投資級公司債,20,0,20,新百王,2024-11-22,6210
00695B,富邦美債7-10,20,0,20,新百王,2024-11-22,6210
00650L,復華香港正2,20,1,19,新百王,2024-11-22,6210
3481,群創,30,12,18,新百王,2024-11-22,6210
00930,永豐ESG低碳高息,20,3,17,新百王,2024-11-22,6210
00670L,富邦NASDAQ正2,18,2,16,新百王,2024-11-22,6210
2601,益航,15,0,15,新百王,2024-11-22,6210
5488,松普,35,20,15,新百王,2024-11-22,6210
3374,精材,16,2,14,新百王,2024-11-22,6210
1569,濱川,54,40,14,新百王,2024-11-22,6210
1449,佳和,53,39,14,新百王,2024-11-22,6210
2444,兆勁,19,6,13,新百王,2024-11-22,6210
5315,光聯,22,9,13,新百王,2024-11-22,6210
9938,百和,16,3,13,新百王,2024-11-22,6210
8070,長華*,20,8,12,新百王,2024-11-22,6210
6416,瑞祺電通,12,0,12,新百王,2024-11-22,6210
00655L,國泰中國A50正2,11,0,11,新百王,2024-11-22,6210
4510,高鋒,20,10,10,新百王,2024-11-22,6210
00909,國泰數位支付服務,10,0,10,新百王,2024-11-22,6210
1473,台南,10,0,10,新百王,2024-11-22,6210
2887,台新金,20,10,10,新百王,2024-11-22,6210
6890,來億-KY,10,0,10,新百王,2024-11-22,6210
3576,聯合再生,10,0,10,新百王,2024-11-22,6210
6547,高端疫苗,10,0,10,新百王,2024-11-22,6210
2606,裕民,10,0,10,新百王,2024-11-22,6210
3710,連展投控,10,0,10,新百王,2024-11-22,6210
1312,國喬,10,0,10,新百王,2024-11-22,6210
2547,日勝生,9,0,9,新百王,2024-11-22,6210
2405,輔信,17,8,9,新百王,2024-11-22,6210
00632R,元大台灣50反1,470,60,410,新百王,2024-11-25,6210
1101,台泥,363,118,245,新百王,2024-11-25,6210
00680L,元大美債20正2,202,10,192,新百王,2024-11-25,6210
2349,錸德,265,89,176,新百王,2024-11-25,6210
1313,聯成,150,0,150,新百王,2024-11-25,6210
00887,永豐中國科技50大,76,0,76,新百王,2024-11-25,6210
00882,中信中國高股息,70,3,67,新百王,2024-11-25,6210
00687B,國泰20年美債,66,2,64,新百王,2024-11-25,6210
2542,興富發,66,5,61,新百王,2024-11-25,6210
00650L,復華香港正2,60,0,60,新百王,2024-11-25,6210
00919,群益台灣精選高息,54,6,48,新百王,2024-11-25,6210
2603,長榮,59,16,43,新百王,2024-11-25,6210
8032,光菱,52,9,43,新百王,2024-11-25,6210
3032,偉訓,61,20,41,新百王,2024-11-25,6210
2014,中鴻,40,1,39,新百王,2024-11-25,6210
00878,國泰永續高股息,45,8,37,新百王,2024-11-25,6210
1466,聚隆,36,0,36,新百王,2024-11-25,6210
6005,群益證,34,0,34,新百王,2024-11-25,6210
2302,麗正,33,0,33,新百王,2024-11-25,6210
2891,中信金,35,2,33,新百王,2024-11-25,6210
4931,新盛力,33,1,32,新百王,2024-11-25,6210
2477,美隆電,34,2,32,新百王,2024-11-25,6210
2313,華通,35,3,32,新百王,2024-11-25,6210
2845,遠東銀,58,27,31,新百王,2024-11-25,6210
00953B,群益優選非投等債,30,0,30,新百王,2024-11-25,6210
0056,元大高股息,30,1,29,新百王,2024-11-25,6210
3290,東浦,26,2,24,新百王,2024-11-25,6210
2431,聯昌,23,0,23,新百王,2024-11-25,6210
6443,元晶,20,0,20,新百王,2024-11-25,6210
3049,精金,20,0,20,新百王,2024-11-25,6210
1524,耿鼎,37,19,18,新百王,2024-11-25,6210
2330,台積電,19,3,16,新百王,2024-11-25,6210
5202,力新,17,1,16,新百王,2024-11-25,6210
00664R,國泰臺灣加權反1,15,0,15,新百王,2024-11-25,6210
1314,中石化,55,41,14,新百王,2024-11-25,6210
3027,盛達,18,5,13,新百王,2024-11-25,6210
2371,大同,36,23,13,新百王,2024-11-25,6210
1303,南亞,13,0,13,新百王,2024-11-25,6210
2231,為升,13,1,12,新百王,2024-11-25,6210
3013,晟銘電,16,5,11,新百王,2024-11-25,6210
3050,鈺德,10,0,10,新百王,2024-11-25,6210
1618,合機,10,0,10,新百王,2024-11-25,6210
2605,新興,10,0,10,新百王,2024-11-25,6210
4303,信立,29,20,9,新百王,2024-11-25,6210
2441,超豐,9,0,9,新百王,2024-11-25,6210
2344,華邦電,9,1,8,新百王,2024-11-25,6210
2409,友達,8,0,8,新百王,2024-11-25,6210
4729,熒茂,53,45,8,新百王,2024-11-25,6210
5876,上海商銀,20,13,7,新百王,2024-11-25,6210
4571,鈞興-KY,8,1,7,新百王,2024-11-25,6210
00665L,富邦�琤肭磪囓�2,175,10,165,新百王,2024-11-26,6210
00887,永豐中國科技50大,152,0,152,新百王,2024-11-26,6210
00951,台新日本半導體,135,0,135,新百王,2024-11-26,6210
2317,鴻海,198,65,133,新百王,2024-11-26,6210
1815,富喬,242,117,125,新百王,2024-11-26,6210
2392,正崴,173,75,98,新百王,2024-11-26,6210
2618,長榮航,82,11,71,新百王,2024-11-26,6210
6962,ITH-KY,66,6,60,新百王,2024-11-26,6210
8044,網家,76,18,58,新百王,2024-11-26,6210
2344,華邦電,46,2,44,新百王,2024-11-26,6210
6141,柏承,35,0,35,新百王,2024-11-26,6210
2542,興富發,37,2,35,新百王,2024-11-26,6210
2915,潤泰全,33,0,33,新百王,2024-11-26,6210
2417,圓剛,33,0,33,新百王,2024-11-26,6210
00882,中信中國高股息,31,0,31,新百王,2024-11-26,6210
8033,雷虎,59,28,31,新百王,2024-11-26,6210
2515,中工,30,1,29,新百王,2024-11-26,6210
2444,兆勁,27,1,26,新百王,2024-11-26,6210
4931,新盛力,25,4,21,新百王,2024-11-26,6210
00940,元大台灣價值高息,22,1,21,新百王,2024-11-26,6210
2884,玉山金,31,10,21,新百王,2024-11-26,6210
00753L,中信中國50正2,24,4,20,新百王,2024-11-26,6210
6443,元晶,20,0,20,新百王,2024-11-26,6210
2498,宏達電,45,26,19,新百王,2024-11-26,6210
2363,矽統,20,1,19,新百王,2024-11-26,6210
2929,淘帝-KY,21,2,19,新百王,2024-11-26,6210
2330,台積電,19,2,17,新百王,2024-11-26,6210
2474,可成,113,96,17,新百王,2024-11-26,6210
8171,天宇,39,23,16,新百王,2024-11-26,6210
5309,系統電,128,113,15,新百王,2024-11-26,6210
00675L,富邦臺灣加權正2,18,3,15,新百王,2024-11-26,6210
6558,興能高,140,126,14,新百王,2024-11-26,6210
3105,穩懋,13,0,13,新百王,2024-11-26,6210
3231,緯創,30,18,12,新百王,2024-11-26,6210
00712,復華富時不動產,17,6,11,新百王,2024-11-26,6210
00881,國泰台灣5G+,11,0,11,新百王,2024-11-26,6210
00918,大華優利高填息30,22,11,11,新百王,2024-11-26,6210
2634,漢翔,11,0,11,新百王,2024-11-26,6210
00713,元大台灣高息低波,10,0,10,新百王,2024-11-26,6210
2630,亞航,25,15,10,新百王,2024-11-26,6210
5371,中光電,26,16,10,新百王,2024-11-26,6210
9904,寶成,15,5,10,新百王,2024-11-26,6210
2887,台新金,20,10,10,新百王,2024-11-26,6210
6770,力積電,15,5,10,新百王,2024-11-26,6210
00655L,國泰中國A50正2,10,0,10,新百王,2024-11-26,6210
2891,中信金,17,8,9,新百王,2024-11-26,6210
2002,中鋼,8,0,8,新百王,2024-11-26,6210
00900,富邦特選高股息30,8,0,8,新百王,2024-11-26,6210
2615,萬海,18,10,8,新百王,2024-11-26,6210
4976,佳凌,7,0,7,新百王,2024-11-26,6210
2392,正崴,344,141,203,新百王,2024-11-27,6210
2883,凱基金,153,0,153,新百王,2024-11-27,6210
00753L,中信中國50正2,105,1,104,新百王,2024-11-27,6210
00943,兆豐電子高息等權,103,0,103,新百王,2024-11-27,6210
1313,聯成,100,0,100,新百王,2024-11-27,6210
2887,台新金,95,0,95,新百王,2024-11-27,6210
00919,群益台灣精選高息,86,1,85,新百王,2024-11-27,6210
8044,網家,88,5,83,新百王,2024-11-27,6210
3090,日電貿,78,19,59,新百王,2024-11-27,6210
00878,國泰永續高股息,66,11,55,新百王,2024-11-27,6210
00948B,中信優息投資級債,53,0,53,新百王,2024-11-27,6210
2603,長榮,65,13,52,新百王,2024-11-27,6210
2609,陽明,88,48,40,新百王,2024-11-27,6210
2888,新光金,40,0,40,新百王,2024-11-27,6210
0056,元大高股息,43,4,39,新百王,2024-11-27,6210
5512,力麒,55,19,36,新百王,2024-11-27,6210
00679B,元大美債20年,54,19,35,新百王,2024-11-27,6210
3706,神達,179,144,35,新百王,2024-11-27,6210
2706,第一店,34,0,34,新百王,2024-11-27,6210
00882,中信中國高股息,32,0,32,新百王,2024-11-27,6210
00918,大華優利高填息30,47,15,32,新百王,2024-11-27,6210
1718,中纖,31,0,31,新百王,2024-11-27,6210
1712,興農,30,0,30,新百王,2024-11-27,6210
3338,泰碩,30,0,30,新百王,2024-11-27,6210
2489,瑞軒,27,0,27,新百王,2024-11-27,6210
00929,復華台灣科技優息,27,0,27,新百王,2024-11-27,6210
2615,萬海,51,26,25,新百王,2024-11-27,6210
2402,毅嘉,30,5,25,新百王,2024-11-27,6210
6456,GIS-KY,24,0,24,新百王,2024-11-27,6210
2610,華航,45,23,22,新百王,2024-11-27,6210
2884,玉山金,22,0,22,新百王,2024-11-27,6210
1536,和大,111,89,22,新百王,2024-11-27,6210
3231,緯創,32,11,21,新百王,2024-11-27,6210
00905,FT臺灣Smart,20,0,20,新百王,2024-11-27,6210
2488,漢平,21,1,20,新百王,2024-11-27,6210
2834,臺企銀,20,0,20,新百王,2024-11-27,6210
1815,富喬,77,58,19,新百王,2024-11-27,6210
2897,王道銀行,25,6,19,新百王,2024-11-27,6210
00675L,富邦臺灣加權正2,18,2,16,新百王,2024-11-27,6210
2636,台驊控股,16,0,16,新百王,2024-11-27,6210
2542,興富發,20,4,16,新百王,2024-11-27,6210
00938,凱基優選30,25,9,16,新百王,2024-11-27,6210
2903,遠百,16,0,16,新百王,2024-11-27,6210
5302,太欣,15,0,15,新百王,2024-11-27,6210
6271,同欣電,15,0,15,新百王,2024-11-27,6210
2617,台航,14,0,14,新百王,2024-11-27,6210
5531,鄉林,14,0,14,新百王,2024-11-27,6210
2882,國泰金,16,2,14,新百王,2024-11-27,6210
3296,勝德,14,0,14,新百王,2024-11-27,6210
3712,永崴投控,17,3,14,新百王,2024-11-27,6210
00665L,富邦�琤肭磪囓�2,662,5,657,新百王,2024-11-28,6210
00706L,期元大S＆P日圓正2,470,0,470,新百王,2024-11-28,6210
00753L,中信中國50正2,310,7,303,新百王,2024-11-28,6210
00712,復華富時不動產,325,41,284,新百王,2024-11-28,6210
00882,中信中國高股息,255,0,255,新百王,2024-11-28,6210
2312,金寶,392,236,156,新百王,2024-11-28,6210
6770,力積電,126,23,103,新百王,2024-11-28,6210
1314,中石化,81,0,81,新百王,2024-11-28,6210
9105,泰金寶-DR,125,47,78,新百王,2024-11-28,6210
4113,聯上,66,0,66,新百王,2024-11-28,6210
00878,國泰永續高股息,65,0,65,新百王,2024-11-28,6210
00943,兆豐電子高息等權,52,0,52,新百王,2024-11-28,6210
00940,元大台灣價值高息,52,0,52,新百王,2024-11-28,6210
00919,群益台灣精選高息,44,1,43,新百王,2024-11-28,6210
1604,聲寶,40,0,40,新百王,2024-11-28,6210
2392,正崴,77,43,34,新百王,2024-11-28,6210
2489,瑞軒,34,0,34,新百王,2024-11-28,6210
00939,統一台灣高息動能,32,0,32,新百王,2024-11-28,6210
00929,復華台灣科技優息,46,15,31,新百王,2024-11-28,6210
0056,元大高股息,28,0,28,新百王,2024-11-28,6210
2897,王道銀行,45,17,28,新百王,2024-11-28,6210
2070,精湛,62,36,26,新百王,2024-11-28,6210
5309,系統電,37,11,26,新百王,2024-11-28,6210
2887,台新金,35,10,25,新百王,2024-11-28,6210
2613,中櫃,34,11,23,新百王,2024-11-28,6210
2374,佳能,25,2,23,新百王,2024-11-28,6210
00637L,元大滬深300正2,62,41,21,新百王,2024-11-28,6210
8064,東捷,27,9,18,新百王,2024-11-28,6210
6175,立敦,19,1,18,新百王,2024-11-28,6210
6416,瑞祺電通,18,0,18,新百王,2024-11-28,6210
00930,永豐ESG低碳高息,17,1,16,新百王,2024-11-28,6210
00713,元大台灣高息低波,15,0,15,新百王,2024-11-28,6210
4931,新盛力,15,1,14,新百王,2024-11-28,6210
1536,和大,111,97,14,新百王,2024-11-28,6210
2882,國泰金,15,2,13,新百王,2024-11-28,6210
00918,大華優利高填息30,16,3,13,新百王,2024-11-28,6210
4510,高鋒,146,133,13,新百王,2024-11-28,6210
3481,群創,19,6,13,新百王,2024-11-28,6210
1609,大亞,17,5,12,新百王,2024-11-28,6210
3711,日月光投控,25,13,12,新百王,2024-11-28,6210
2344,華邦電,12,1,11,新百王,2024-11-28,6210
2063,世鎧,11,0,11,新百王,2024-11-28,6210
00932,兆豐永續高息等權,11,0,11,新百王,2024-11-28,6210
3231,緯創,24,13,11,新百王,2024-11-28,6210
00950B,凱基A級公司債,10,0,10,新百王,2024-11-28,6210
2905,三商,10,0,10,新百王,2024-11-28,6210
1446,宏和,11,1,10,新百王,2024-11-28,6210
1712,興農,10,0,10,新百王,2024-11-28,6210
1802,台玻,32,22,10,新百王,2024-11-28,6210
5426,振發,10,0,10,新百王,2024-11-28,6210
00753L,中信中國50正2,421,105,316,新百王,2024-11-29,6210
00664R,國泰臺灣加權反1,250,45,205,新百王,2024-11-29,6210
00706L,期元大S＆P日圓正2,132,18,114,新百王,2024-11-29,6210
3591,艾笛森,101,1,100,新百王,2024-11-29,6210
2615,萬海,79,9,70,新百王,2024-11-29,6210
2867,三商壽,69,0,69,新百王,2024-11-29,6210
2887,台新金,68,5,63,新百王,2024-11-29,6210
00950B,凱基A級公司債,50,0,50,新百王,2024-11-29,6210
00638R,元大滬深300反1,50,10,40,新百王,2024-11-29,6210
00878,國泰永續高股息,39,0,39,新百王,2024-11-29,6210
00656R,國泰中國A50反1,40,10,30,新百王,2024-11-29,6210
2890,永豐金,29,0,29,新百王,2024-11-29,6210
00918,大華優利高填息30,27,0,27,新百王,2024-11-29,6210
00919,群益台灣精選高息,50,24,26,新百王,2024-11-29,6210
6505,台塑化,25,1,24,新百王,2024-11-29,6210
006208,富邦台50,33,10,23,新百王,2024-11-29,6210
2302,麗正,32,10,22,新百王,2024-11-29,6210
1301,台塑,21,0,21,新百王,2024-11-29,6210
4510,高鋒,36,15,21,新百王,2024-11-29,6210
3024,憶聲,20,0,20,新百王,2024-11-29,6210
00795B,中信美國公債20年,30,10,20,新百王,2024-11-29,6210
2002,中鋼,16,0,16,新百王,2024-11-29,6210
4113,聯上,15,0,15,新百王,2024-11-29,6210
2354,鴻準,94,79,15,新百王,2024-11-29,6210
4919,新唐,20,5,15,新百王,2024-11-29,6210
3005,神基,15,1,14,新百王,2024-11-29,6210
2303,聯電,28,17,11,新百王,2024-11-29,6210
6530,創威,17,6,11,新百王,2024-11-29,6210
1326,台化,11,0,11,新百王,2024-11-29,6210
3032,偉訓,22,12,10,新百王,2024-11-29,6210
00712,復華富時不動產,15,5,10,新百王,2024-11-29,6210
3706,神達,193,183,10,新百王,2024-11-29,6210
2888,新光金,10,0,10,新百王,2024-11-29,6210
00687B,國泰20年美債,21,11,10,新百王,2024-11-29,6210
2618,長榮航,15,5,10,新百王,2024-11-29,6210
2520,冠德,10,0,10,新百王,2024-11-29,6210
6175,立敦,18,8,10,新百王,2024-11-29,6210
2613,中櫃,36,27,9,新百王,2024-11-29,6210
1717,長興,10,2,8,新百王,2024-11-29,6210
3576,聯合再生,8,0,8,新百王,2024-11-29,6210
3339,泰谷,8,0,8,新百王,2024-11-29,6210
4927,泰鼎-KY,27,19,8,新百王,2024-11-29,6210
2881,富邦金,13,6,7,新百王,2024-11-29,6210
6176,瑞儀,7,0,7,新百王,2024-11-29,6210
2610,華航,90,83,7,新百王,2024-11-29,6210
4903,聯光通,9,2,7,新百王,2024-11-29,6210
4991,環宇-KY,31,25,6,新百王,2024-11-29,6210
2706,第一店,6,0,6,新百王,2024-11-29,6210
3090,日電貿,109,103,6,新百王,2024-11-29,6210
5880,合庫金,6,0,6,新百王,2024-11-29,6210
00632R,元大台灣50反1,1514,101,1413,新百王,2024-12-02,6210
00637L,元大滬深300正2,599,138,461,新百王,2024-12-02,6210
00664R,國泰臺灣加權反1,311,13,298,新百王,2024-12-02,6210
2349,錸德,267,6,261,新百王,2024-12-02,6210
00753L,中信中國50正2,110,0,110,新百王,2024-12-02,6210
2897,王道銀行,108,5,103,新百王,2024-12-02,6210
00751B,元大AAA至A公司債,100,5,95,新百王,2024-12-02,6210
1314,中石化,130,49,81,新百王,2024-12-02,6210
2312,金寶,138,67,71,新百王,2024-12-02,6210
00679B,元大美債20年,80,17,63,新百王,2024-12-02,6210
3607,谷崧,55,0,55,新百王,2024-12-02,6210
00680L,元大美債20正2,50,1,49,新百王,2024-12-02,6210
5328,華容,56,18,38,新百王,2024-12-02,6210
1815,富喬,70,39,31,新百王,2024-12-02,6210
4113,聯上,33,3,30,新百王,2024-12-02,6210
5515,建國,31,2,29,新百王,2024-12-02,6210
4908,前鼎,24,1,23,新百王,2024-12-02,6210
3706,神達,79,56,23,新百王,2024-12-02,6210
00918,大華優利高填息30,20,0,20,新百王,2024-12-02,6210
1313,聯成,20,0,20,新百王,2024-12-02,6210
1802,台玻,32,13,19,新百王,2024-12-02,6210
2317,鴻海,37,18,19,新百王,2024-12-02,6210
00929,復華台灣科技優息,32,14,18,新百王,2024-12-02,6210
5309,系統電,85,67,18,新百王,2024-12-02,6210
5876,上海商銀,27,9,18,新百王,2024-12-02,6210
00715L,期街口布蘭特正2,31,13,18,新百王,2024-12-02,6210
2515,中工,16,0,16,新百王,2024-12-02,6210
5521,工信,16,0,16,新百王,2024-12-02,6210
6127,九豪,27,12,15,新百王,2024-12-02,6210
3090,日電貿,21,7,14,新百王,2024-12-02,6210
6505,台塑化,17,4,13,新百王,2024-12-02,6210
0056,元大高股息,20,7,13,新百王,2024-12-02,6210
2382,廣達,42,29,13,新百王,2024-12-02,6210
2344,華邦電,46,34,12,新百王,2024-12-02,6210
4906,正文,39,27,12,新百王,2024-12-02,6210
2613,中櫃,14,2,12,新百王,2024-12-02,6210
4931,新盛力,11,0,11,新百王,2024-12-02,6210
1609,大亞,12,1,11,新百王,2024-12-02,6210
2548,華固,11,0,11,新百王,2024-12-02,6210
2313,華通,12,1,11,新百王,2024-12-02,6210
00950B,凱基A級公司債,10,0,10,新百王,2024-12-02,6210
1524,耿鼎,10,0,10,新百王,2024-12-02,6210
2646,星宇航空,10,0,10,新百王,2024-12-02,6210
2888,新光金,10,0,10,新百王,2024-12-02,6210
00693U,期街口S＆P黃豆,10,0,10,新百王,2024-12-02,6210
2348,海悅,10,0,10,新百王,2024-12-02,6210
1718,中纖,10,0,10,新百王,2024-12-02,6210
5392,能率,10,0,10,新百王,2024-12-02,6210
00676R,富邦臺灣加權反1,10,0,10,新百王,2024-12-02,6210
5315,光聯,26,16,10,新百王,2024-12-02,6210
00919,群益台灣精選高息,185,0,185,新百王,2024-12-03,6210
2887,台新金,170,0,170,新百王,2024-12-03,6210
00959B,大華投等美債15Y+,100,0,100,新百王,2024-12-03,6210
2888,新光金,147,47,100,新百王,2024-12-03,6210
2312,金寶,219,126,93,新百王,2024-12-03,6210
00918,大華優利高填息30,62,0,62,新百王,2024-12-03,6210
00664R,國泰臺灣加權反1,59,0,59,新百王,2024-12-03,6210
2327,國巨,58,0,58,新百王,2024-12-03,6210
00950B,凱基A級公司債,52,0,52,新百王,2024-12-03,6210
00945B,凱基美國非投等債,50,0,50,新百王,2024-12-03,6210
2915,潤泰全,41,0,41,新百王,2024-12-03,6210
3045,台灣大,44,9,35,新百王,2024-12-03,6210
2374,佳能,34,1,33,新百王,2024-12-03,6210
2317,鴻海,65,35,30,新百王,2024-12-03,6210
3712,永崴投控,30,3,27,新百王,2024-12-03,6210
4113,聯上,25,0,25,新百王,2024-12-03,6210
2302,麗正,31,7,24,新百王,2024-12-03,6210
4303,信立,50,26,24,新百王,2024-12-03,6210
3706,神達,128,107,21,新百王,2024-12-03,6210
2405,輔信,39,18,21,新百王,2024-12-03,6210
00887,永豐中國科技50大,21,0,21,新百王,2024-12-03,6210
2301,光寶科,30,9,21,新百王,2024-12-03,6210
6175,立敦,29,9,20,新百王,2024-12-03,6210
00671R,富邦NASDAQ反1,16,0,16,新百王,2024-12-03,6210
2392,正崴,18,2,16,新百王,2024-12-03,6210
00726B,國泰新興投等債,15,0,15,新百王,2024-12-03,6210
00676R,富邦臺灣加權反1,15,0,15,新百王,2024-12-03,6210
9802,鈺齊-KY,14,0,14,新百王,2024-12-03,6210
00934,中信成長高股息,20,7,13,新百王,2024-12-03,6210
3032,偉訓,52,39,13,新百王,2024-12-03,6210
2637,慧洋-KY,16,3,13,新百王,2024-12-03,6210
2845,遠東銀,15,2,13,新百王,2024-12-03,6210
00930,永豐ESG低碳高息,12,0,12,新百王,2024-12-03,6210
2344,華邦電,13,1,12,新百王,2024-12-03,6210
2353,宏��,15,4,11,新百王,2024-12-03,6210
5481,新華,14,3,11,新百王,2024-12-03,6210
00715L,期街口布蘭特正2,13,2,11,新百王,2024-12-03,6210
6962,ITH-KY,11,1,10,新百王,2024-12-03,6210
3607,谷崧,10,0,10,新百王,2024-12-03,6210
1605,華新,22,12,10,新百王,2024-12-03,6210
1795,美時,10,0,10,新百王,2024-12-03,6210
3024,憶聲,10,0,10,新百王,2024-12-03,6210
8171,天宇,10,0,10,新百王,2024-12-03,6210
4513,福裕,10,0,10,新百王,2024-12-03,6210
3025,星通,17,7,10,新百王,2024-12-03,6210
3605,宏致,10,0,10,新百王,2024-12-03,6210
3625,西勝,11,1,10,新百王,2024-12-03,6210
4968,立積,22,13,9,新百王,2024-12-03,6210
00905,FT臺灣Smart,10,1,9,新百王,2024-12-03,6210
00712,復華富時不動產,8,0,8,新百王,2024-12-03,6210
00673R,期元大S＆P原油反1,509,0,509,新百王,2024-12-04,6210
00882,中信中國高股息,420,20,400,新百王,2024-12-04,6210
00945B,凱基美國非投等債,250,0,250,新百王,2024-12-04,6210
00959B,大華投等美債15Y+,343,100,243,新百王,2024-12-04,6210
00712,復華富時不動產,97,0,97,新百王,2024-12-04,6210
00953B,群益優選非投等債,69,0,69,新百王,2024-12-04,6210
6288,聯嘉,62,1,61,新百王,2024-12-04,6210
00795B,中信美國公債20年,46,0,46,新百王,2024-12-04,6210
00687B,國泰20年美債,130,87,43,新百王,2024-12-04,6210
00864B,中信美國公債0-1,40,0,40,新百王,2024-12-04,6210
00891,中信關鍵半導體,30,0,30,新百王,2024-12-04,6210
3234,光環,31,1,30,新百王,2024-12-04,6210
2891,中信金,27,2,25,新百王,2024-12-04,6210
2884,玉山金,23,0,23,新百王,2024-12-04,6210
6658,聯策,22,0,22,新百王,2024-12-04,6210
2883,凱基金,24,3,21,新百王,2024-12-04,6210
1504,東元,20,0,20,新百王,2024-12-04,6210
3138,耀登,20,0,20,新百王,2024-12-04,6210
1611,中電,20,0,20,新百王,2024-12-04,6210
2301,光寶科,31,12,19,新百王,2024-12-04,6210
2515,中工,19,0,19,新百王,2024-12-04,6210
2313,華通,26,8,18,新百王,2024-12-04,6210
5309,系統電,85,67,18,新百王,2024-12-04,6210
006208,富邦台50,18,1,17,新百王,2024-12-04,6210
1303,南亞,17,0,17,新百王,2024-12-04,6210
2464,盟立,22,5,17,新百王,2024-12-04,6210
6799,來頡,19,3,16,新百王,2024-12-04,6210
1569,濱川,18,3,15,新百王,2024-12-04,6210
2892,第一金,15,1,14,新百王,2024-12-04,6210
2405,輔信,51,37,14,新百王,2024-12-04,6210
2392,正崴,19,5,14,新百王,2024-12-04,6210
6505,台塑化,14,0,14,新百王,2024-12-04,6210
5426,振發,13,0,13,新百王,2024-12-04,6210
4526,東台,13,0,13,新百王,2024-12-04,6210
2890,永豐金,13,0,13,新百王,2024-12-04,6210
2646,星宇航空,13,0,13,新百王,2024-12-04,6210
4979,華星光,53,41,12,新百王,2024-12-04,6210
1609,大亞,12,0,12,新百王,2024-12-04,6210
1605,華新,12,0,12,新百王,2024-12-04,6210
00918,大華優利高填息30,11,0,11,新百王,2024-12-04,6210
3037,欣興,22,11,11,新百王,2024-12-04,6210
2888,新光金,89,78,11,新百王,2024-12-04,6210
3380,明泰,12,1,11,新百王,2024-12-04,6210
2472,立隆電,15,4,11,新百王,2024-12-04,6210
00679B,元大美債20年,64,53,11,新百王,2024-12-04,6210
2637,慧洋-KY,19,9,10,新百王,2024-12-04,6210
9105,泰金寶-DR,24,14,10,新百王,2024-12-04,6210
2886,兆豐金,10,0,10,新百王,2024-12-04,6210
00676R,富邦臺灣加權反1,10,0,10,新百王,2024-12-04,6210
2493,揚博,10,0,10,新百王,2024-12-04,6210
00637L,元大滬深300正2,219,21,198,新百王,2024-12-05,6210
00937B,群益ESG投等債20,183,3,180,新百王,2024-12-05,6210
00919,群益台灣精選高息,108,1,107,新百王,2024-12-05,6210
00753L,中信中國50正2,106,2,104,新百王,2024-12-05,6210
1904,正隆,91,0,91,新百王,2024-12-05,6210
00676R,富邦臺灣加權反1,100,20,80,新百王,2024-12-05,6210
2327,國巨,59,0,59,新百王,2024-12-05,6210
00715L,期街口布蘭特正2,58,2,56,新百王,2024-12-05,6210
6770,力積電,59,4,55,新百王,2024-12-05,6210
2515,中工,53,0,53,新百王,2024-12-05,6210
3481,群創,58,5,53,新百王,2024-12-05,6210
00650L,復華香港正2,74,28,46,新百王,2024-12-05,6210
1718,中纖,44,0,44,新百王,2024-12-05,6210
00665L,富邦�琤肭磪囓�2,61,20,41,新百王,2024-12-05,6210
1815,富喬,91,54,37,新百王,2024-12-05,6210
4113,聯上,35,0,35,新百王,2024-12-05,6210
5328,華容,136,104,32,新百王,2024-12-05,6210
3003,健和興,47,15,32,新百王,2024-12-05,6210
3045,台灣大,38,6,32,新百王,2024-12-05,6210
6278,台表科,31,0,31,新百王,2024-12-05,6210
1605,華新,30,0,30,新百王,2024-12-05,6210
2317,鴻海,48,20,28,新百王,2024-12-05,6210
3188,鑫龍騰,28,0,28,新百王,2024-12-05,6210
3450,聯鈞,60,34,26,新百王,2024-12-05,6210
1301,台塑,48,22,26,新百王,2024-12-05,6210
1795,美時,31,5,26,新百王,2024-12-05,6210
3625,西勝,27,2,25,新百王,2024-12-05,6210
5521,工信,35,14,21,新百王,2024-12-05,6210
00895,富邦未來車,20,0,20,新百王,2024-12-05,6210
6558,興能高,228,209,19,新百王,2024-12-05,6210
2897,王道銀行,19,0,19,新百王,2024-12-05,6210
2303,聯電,26,8,18,新百王,2024-12-05,6210
3236,千如,18,0,18,新百王,2024-12-05,6210
2405,輔信,27,9,18,新百王,2024-12-05,6210
3090,日電貿,104,86,18,新百王,2024-12-05,6210
3712,永崴投控,21,3,18,新百王,2024-12-05,6210
2313,華通,35,17,18,新百王,2024-12-05,6210
2316,楠梓電,17,0,17,新百王,2024-12-05,6210
2609,陽明,20,3,17,新百王,2024-12-05,6210
3580,友威科,15,0,15,新百王,2024-12-05,6210
6531,愛普*,16,1,15,新百王,2024-12-05,6210
1303,南亞,14,1,13,新百王,2024-12-05,6210
6191,精成科,16,3,13,新百王,2024-12-05,6210
4977,眾達-KY,41,29,12,新百王,2024-12-05,6210
2887Z1,台新己特,12,0,12,新百王,2024-12-05,6210
00915,凱基優選高股息30,12,0,12,新百王,2024-12-05,6210
00878,國泰永續高股息,17,5,12,新百王,2024-12-05,6210
2472,立隆電,26,15,11,新百王,2024-12-05,6210
2603,長榮,11,0,11,新百王,2024-12-05,6210
2915,潤泰全,42,31,11,新百王,2024-12-05,6210
00882,中信中國高股息,110,0,110,新百王,2024-12-06,6210
00687B,國泰20年美債,144,42,102,新百王,2024-12-06,6210
00937B,群益ESG投等債20,102,3,99,新百王,2024-12-06,6210
00915,凱基優選高股息30,90,1,89,新百王,2024-12-06,6210
00715L,期街口布蘭特正2,87,0,87,新百王,2024-12-06,6210
8044,網家,81,0,81,新百王,2024-12-06,6210
3591,艾笛森,76,8,68,新百王,2024-12-06,6210
00712,復華富時不動產,45,0,45,新百王,2024-12-06,6210
6757,台灣虎航,67,25,42,新百王,2024-12-06,6210
00927,群益半導體收益,41,0,41,新百王,2024-12-06,6210
2915,潤泰全,84,46,38,新百王,2024-12-06,6210
00950B,凱基A級公司債,40,3,37,新百王,2024-12-06,6210
00918,大華優利高填息30,37,0,37,新百王,2024-12-06,6210
0056,元大高股息,32,4,28,新百王,2024-12-06,6210
2542,興富發,32,7,25,新百王,2024-12-06,6210
1708,東鹼,25,0,25,新百王,2024-12-06,6210
2354,鴻準,122,97,25,新百王,2024-12-06,6210
2312,金寶,29,5,24,新百王,2024-12-06,6210
1504,東元,24,0,24,新百王,2024-12-06,6210
6416,瑞祺電通,24,1,23,新百王,2024-12-06,6210
00962,台新AI優息動能,23,0,23,新百王,2024-12-06,6210
2317,鴻海,77,55,22,新百王,2024-12-06,6210
00713,元大台灣高息低波,20,0,20,新百王,2024-12-06,6210
2330,台積電,24,5,19,新百王,2024-12-06,6210
2891,中信金,20,1,19,新百王,2024-12-06,6210
2348,海悅,29,11,18,新百王,2024-12-06,6210
8097,常珵,43,25,18,新百王,2024-12-06,6210
2472,立隆電,20,2,18,新百王,2024-12-06,6210
2442,新美齊,29,11,18,新百王,2024-12-06,6210
00795B,中信美國公債20年,20,3,17,新百王,2024-12-06,6210
1612,宏泰,15,0,15,新百王,2024-12-06,6210
00664R,國泰臺灣加權反1,15,0,15,新百王,2024-12-06,6210
2613,中櫃,17,3,14,新百王,2024-12-06,6210
2426,鼎元,22,10,12,新百王,2024-12-06,6210
2610,華航,30,18,12,新百王,2024-12-06,6210
2867,三商壽,15,3,12,新百王,2024-12-06,6210
3548,兆利,27,16,11,新百王,2024-12-06,6210
3605,宏致,10,0,10,新百王,2024-12-06,6210
3296,勝德,10,0,10,新百王,2024-12-06,6210
6127,九豪,12,2,10,新百王,2024-12-06,6210
2371,大同,12,2,10,新百王,2024-12-06,6210
3230,錦明,10,0,10,新百王,2024-12-06,6210
3521,鴻翊,9,0,9,新百王,2024-12-06,6210
6257,矽格,12,3,9,新百王,2024-12-06,6210
3189,景碩,14,5,9,新百王,2024-12-06,6210
2887Z1,台新己特,9,0,9,新百王,2024-12-06,6210
0050,元大台灣50,12,3,9,新百王,2024-12-06,6210
1611,中電,8,0,8,新百王,2024-12-06,6210
00922,國泰台灣領袖50,8,0,8,新百王,2024-12-06,6210
6156,松上,8,0,8,新百王,2024-12-06,6210
00665L,富邦�琤肭磪囓�2,460,19,441,新百王,2024-12-09,6210
00953B,群益優選非投等債,248,0,248,新百王,2024-12-09,6210
00680L,元大美債20正2,261,65,196,新百王,2024-12-09,6210
2883,凱基金,131,31,100,新百王,2024-12-09,6210
00664R,國泰臺灣加權反1,100,0,100,新百王,2024-12-09,6210
6443,元晶,71,0,71,新百王,2024-12-09,6210
00712,復華富時不動產,70,5,65,新百王,2024-12-09,6210
2834,臺企銀,64,0,64,新百王,2024-12-09,6210
2891,中信金,63,3,60,新百王,2024-12-09,6210
6127,九豪,55,0,55,新百王,2024-12-09,6210
4306,炎洲,48,0,48,新百王,2024-12-09,6210
2637,慧洋-KY,35,1,34,新百王,2024-12-09,6210
2402,毅嘉,34,1,33,新百王,2024-12-09,6210
4167,松瑞藥,32,0,32,新百王,2024-12-09,6210
1466,聚隆,31,0,31,新百王,2024-12-09,6210
00937B,群益ESG投等債20,40,9,31,新百王,2024-12-09,6210
2534,宏盛,30,0,30,新百王,2024-12-09,6210
2354,鴻準,81,52,29,新百王,2024-12-09,6210
6015,宏遠證,28,0,28,新百王,2024-12-09,6210
4113,聯上,26,0,26,新百王,2024-12-09,6210
3051,力特,27,1,26,新百王,2024-12-09,6210
6505,台塑化,26,2,24,新百王,2024-12-09,6210
00918,大華優利高填息30,23,0,23,新百王,2024-12-09,6210
2002,中鋼,33,10,23,新百王,2024-12-09,6210
3024,憶聲,26,5,21,新百王,2024-12-09,6210
2399,映泰,89,69,20,新百王,2024-12-09,6210
00948B,中信優息投資級債,20,0,20,新百王,2024-12-09,6210
00959B,大華投等美債15Y+,20,0,20,新百王,2024-12-09,6210
8084,巨虹,20,0,20,新百王,2024-12-09,6210
6112,邁達特,61,41,20,新百王,2024-12-09,6210
2449,京元電子,21,2,19,新百王,2024-12-09,6210
3019,亞光,24,6,18,新百王,2024-12-09,6210
3607,谷崧,23,5,18,新百王,2024-12-09,6210
2430,燦坤,15,0,15,新百王,2024-12-09,6210
1532,勤美,15,0,15,新百王,2024-12-09,6210
00919,群益台灣精選高息,23,9,14,新百王,2024-12-09,6210
6962,ITH-KY,15,1,14,新百王,2024-12-09,6210
1303,南亞,17,3,14,新百王,2024-12-09,6210
1609,大亞,14,0,14,新百王,2024-12-09,6210
6695,芯鼎,28,14,14,新百王,2024-12-09,6210
0056,元大高股息,14,1,13,新百王,2024-12-09,6210
00882,中信中國高股息,13,0,13,新百王,2024-12-09,6210
3234,光環,15,2,13,新百王,2024-12-09,6210
6220,岳豐,13,0,13,新百王,2024-12-09,6210
2615,萬海,57,44,13,新百王,2024-12-09,6210
020023,元大櫃買半導體N,13,0,13,新百王,2024-12-09,6210
1815,富喬,19,6,13,新百王,2024-12-09,6210
020035,元大上櫃ESG高息N,12,0,12,新百王,2024-12-09,6210
2303,聯電,28,17,11,新百王,2024-12-09,6210
4551,智伸科,11,0,11,新百王,2024-12-09,6210
00715L,期街口布蘭特正2,504,11,493,新百王,2024-12-10,6210
2834,臺企銀,134,28,106,新百王,2024-12-10,6210
2891,中信金,91,1,90,新百王,2024-12-10,6210
3706,神達,203,133,70,新百王,2024-12-10,6210
00950B,凱基A級公司債,70,0,70,新百王,2024-12-10,6210
2312,金寶,107,41,66,新百王,2024-12-10,6210
3481,群創,83,18,65,新百王,2024-12-10,6210
1101,台泥,60,2,58,新百王,2024-12-10,6210
00687B,國泰20年美債,62,9,53,新百王,2024-12-10,6210
5512,力麒,83,37,46,新百王,2024-12-10,6210
6248,沛波,44,0,44,新百王,2024-12-10,6210
2897,王道銀行,40,0,40,新百王,2024-12-10,6210
00937B,群益ESG投等債20,40,4,36,新百王,2024-12-10,6210
2882,國泰金,36,0,36,新百王,2024-12-10,6210
2303,聯電,39,3,36,新百王,2024-12-10,6210
1446,宏和,36,1,35,新百王,2024-12-10,6210
1815,富喬,91,57,34,新百王,2024-12-10,6210
1413,宏洲,34,0,34,新百王,2024-12-10,6210
1313,聯成,30,0,30,新百王,2024-12-10,6210
2887,台新金,30,0,30,新百王,2024-12-10,6210
2399,映泰,33,5,28,新百王,2024-12-10,6210
2390,云辰,27,0,27,新百王,2024-12-10,6210
4908,前鼎,34,10,24,新百王,2024-12-10,6210
2618,長榮航,26,3,23,新百王,2024-12-10,6210
2363,矽統,66,45,21,新百王,2024-12-10,6210
1449,佳和,32,12,20,新百王,2024-12-10,6210
8047,星雲,20,0,20,新百王,2024-12-10,6210
9105,泰金寶-DR,39,20,19,新百王,2024-12-10,6210
5302,太欣,17,0,17,新百王,2024-12-10,6210
2888,新光金,17,0,17,新百王,2024-12-10,6210
1609,大亞,26,10,16,新百王,2024-12-10,6210
2603,長榮,29,13,16,新百王,2024-12-10,6210
2344,華邦電,16,0,16,新百王,2024-12-10,6210
00664R,國泰臺灣加權反1,15,0,15,新百王,2024-12-10,6210
1504,東元,17,2,15,新百王,2024-12-10,6210
00675L,富邦臺灣加權正2,17,4,13,新百王,2024-12-10,6210
1785,光洋科,29,17,12,新百王,2024-12-10,6210
2231,為升,12,1,11,新百王,2024-12-10,6210
1201,味全,11,0,11,新百王,2024-12-10,6210
6180,橘子,11,0,11,新百王,2024-12-10,6210
00882,中信中國高股息,16,5,11,新百王,2024-12-10,6210
1717,長興,10,0,10,新百王,2024-12-10,6210
00945B,凱基美國非投等債,10,0,10,新百王,2024-12-10,6210
1457,宜進,10,0,10,新百王,2024-12-10,6210
4979,華星光,28,18,10,新百王,2024-12-10,6210
00953B,群益優選非投等債,10,0,10,新百王,2024-12-10,6210
4909,新復興,13,3,10,新百王,2024-12-10,6210
1817,凱撒衛,10,0,10,新百王,2024-12-10,6210
4967,十銓,10,0,10,新百王,2024-12-10,6210
2449,京元電子,16,6,10,新百王,2024-12-10,6210
00665L,富邦�琤肭磪囓�2,631,22,609,新百王,2024-12-11,6210
2891,中信金,263,17,246,新百王,2024-12-11,6210
1466,聚隆,177,0,177,新百王,2024-12-11,6210
2317,鴻海,158,65,93,新百王,2024-12-11,6210
00919,群益台灣精選高息,79,0,79,新百王,2024-12-11,6210
2401,凌陽,69,2,67,新百王,2024-12-11,6210
00918,大華優利高填息30,85,20,65,新百王,2024-12-11,6210
2897,王道銀行,59,0,59,新百王,2024-12-11,6210
2328,廣宇,60,3,57,新百王,2024-12-11,6210
6770,力積電,55,0,55,新百王,2024-12-11,6210
6005,群益證,56,5,51,新百王,2024-12-11,6210
00637L,元大滬深300正2,78,31,47,新百王,2024-12-11,6210
00664R,國泰臺灣加權反1,40,0,40,新百王,2024-12-11,6210
00915,凱基優選高股息30,33,0,33,新百王,2024-12-11,6210
6757,台灣虎航,29,0,29,新百王,2024-12-11,6210
2324,仁寶,31,3,28,新百王,2024-12-11,6210
6220,岳豐,20,0,20,新百王,2024-12-11,6210
2236,百達-KY,30,10,20,新百王,2024-12-11,6210
8033,雷虎,42,22,20,新百王,2024-12-11,6210
8044,網家,20,0,20,新百王,2024-12-11,6210
3481,群創,30,10,20,新百王,2024-12-11,6210
00937B,群益ESG投等債20,19,0,19,新百王,2024-12-11,6210
2344,華邦電,19,0,19,新百王,2024-12-11,6210
8054,安國,47,28,19,新百王,2024-12-11,6210
8097,常珵,22,4,18,新百王,2024-12-11,6210
2371,大同,32,14,18,新百王,2024-12-11,6210
2002,中鋼,27,10,17,新百王,2024-12-11,6210
2430,燦坤,16,0,16,新百王,2024-12-11,6210
2882,國泰金,16,0,16,新百王,2024-12-11,6210
2316,楠梓電,23,7,16,新百王,2024-12-11,6210
4953,緯軟,23,7,16,新百王,2024-12-11,6210
4931,新盛力,59,43,16,新百王,2024-12-11,6210
00753L,中信中國50正2,23,8,15,新百王,2024-12-11,6210
2834,臺企銀,130,115,15,新百王,2024-12-11,6210
2609,陽明,73,59,14,新百王,2024-12-11,6210
1815,富喬,43,30,13,新百王,2024-12-11,6210
2610,華航,28,15,13,新百王,2024-12-11,6210
020023,元大櫃買半導體N,13,0,13,新百王,2024-12-11,6210
6156,松上,15,3,12,新百王,2024-12-11,6210
6191,精成科,12,0,12,新百王,2024-12-11,6210
2615,萬海,22,10,12,新百王,2024-12-11,6210
1540,喬福,22,10,12,新百王,2024-12-11,6210
2337,旺宏,12,0,12,新百王,2024-12-11,6210
3037,欣興,16,5,11,新百王,2024-12-11,6210
00650L,復華香港正2,16,5,11,新百王,2024-12-11,6210
1817,凱撒衛,10,0,10,新百王,2024-12-11,6210
00887,永豐中國科技50大,12,2,10,新百王,2024-12-11,6210
2477,美隆電,20,10,10,新百王,2024-12-11,6210
2887Z1,台新己特,10,0,10,新百王,2024-12-11,6210
8043,蜜望實,10,0,10,新百王,2024-12-11,6210
00673R,期元大S＆P原油反1,1520,0,1520,新百王,2024-12-12,6210
00680L,元大美債20正2,509,0,509,新百王,2024-12-12,6210
00857B,永豐20年美公債,385,14,371,新百王,2024-12-12,6210
00688L,國泰20年美債正2,222,0,222,新百王,2024-12-12,6210
1718,中纖,148,0,148,新百王,2024-12-12,6210
4526,東台,137,19,118,新百王,2024-12-12,6210
00753L,中信中國50正2,135,20,115,新百王,2024-12-12,6210
00676R,富邦臺灣加權反1,100,0,100,新百王,2024-12-12,6210
8097,常珵,93,2,91,新百王,2024-12-12,6210
1314,中石化,70,0,70,新百王,2024-12-12,6210
1815,富喬,78,19,59,新百王,2024-12-12,6210
2430,燦坤,52,0,52,新百王,2024-12-12,6210
00918,大華優利高填息30,47,0,47,新百王,2024-12-12,6210
6757,台灣虎航,47,2,45,新百王,2024-12-12,6210
2354,鴻準,53,12,41,新百王,2024-12-12,6210
2374,佳能,80,41,39,新百王,2024-12-12,6210
2890,永豐金,39,0,39,新百王,2024-12-12,6210
00937B,群益ESG投等債20,38,0,38,新百王,2024-12-12,6210
9105,泰金寶-DR,72,38,34,新百王,2024-12-12,6210
5525,順天,32,0,32,新百王,2024-12-12,6210
2618,長榮航,32,1,31,新百王,2024-12-12,6210
1609,大亞,35,4,31,新百王,2024-12-12,6210
2615,萬海,44,14,30,新百王,2024-12-12,6210
1303,南亞,31,2,29,新百王,2024-12-12,6210
2609,陽明,80,51,29,新百王,2024-12-12,6210
3047,訊舟,26,0,26,新百王,2024-12-12,6210
2897,王道銀行,36,11,25,新百王,2024-12-12,6210
2489,瑞軒,25,0,25,新百王,2024-12-12,6210
2515,中工,23,0,23,新百王,2024-12-12,6210
1817,凱撒衛,20,0,20,新百王,2024-12-12,6210
6443,元晶,20,0,20,新百王,2024-12-12,6210
6120,達運,22,2,20,新百王,2024-12-12,6210
4976,佳凌,18,0,18,新百王,2024-12-12,6210
3029,零壹,42,24,18,新百王,2024-12-12,6210
00893,國泰智能電動車,17,1,16,新百王,2024-12-12,6210
1446,宏和,20,4,16,新百王,2024-12-12,6210
4561,健椿,21,5,16,新百王,2024-12-12,6210
2355,敬鵬,17,2,15,新百王,2024-12-12,6210
2313,華通,66,51,15,新百王,2024-12-12,6210
2236,百達-KY,16,1,15,新百王,2024-12-12,6210
2891,中信金,56,42,14,新百王,2024-12-12,6210
00795B,中信美國公債20年,18,4,14,新百王,2024-12-12,6210
020027,元大上櫃ESG成長N,14,0,14,新百王,2024-12-12,6210
2474,可成,20,6,14,新百王,2024-12-12,6210
2486,一詮,59,45,14,新百王,2024-12-12,6210
1301,台塑,49,36,13,新百王,2024-12-12,6210
1605,華新,13,0,13,新百王,2024-12-12,6210
2850,新產,12,0,12,新百王,2024-12-12,6210
1326,台化,12,0,12,新百王,2024-12-12,6210
00950B,凱基A級公司債,11,0,11,新百王,2024-12-12,6210
00637L,元大滬深300正2,211,70,141,新百王,2024-12-13,6210
2834,臺企銀,144,8,136,新百王,2024-12-13,6210
2883,凱基金,100,1,99,新百王,2024-12-13,6210
00915,凱基優選高股息30,97,0,97,新百王,2024-12-13,6210
2891,中信金,72,2,70,新百王,2024-12-13,6210
00688L,國泰20年美債正2,157,100,57,新百王,2024-12-13,6210
00650L,復華香港正2,60,10,50,新百王,2024-12-13,6210
3419,譁裕,50,0,50,新百王,2024-12-13,6210
1718,中纖,50,0,50,新百王,2024-12-13,6210
9105,泰金寶-DR,355,307,48,新百王,2024-12-13,6210
00918,大華優利高填息30,52,5,47,新百王,2024-12-13,6210
8104,錸寶,47,0,47,新百王,2024-12-13,6210
00687B,國泰20年美債,83,38,45,新百王,2024-12-13,6210
2845,遠東銀,42,0,42,新百王,2024-12-13,6210
2303,聯電,46,7,39,新百王,2024-12-13,6210
1609,大亞,41,2,39,新百王,2024-12-13,6210
5521,工信,39,1,38,新百王,2024-12-13,6210
00679B,元大美債20年,37,5,32,新百王,2024-12-13,6210
1466,聚隆,28,0,28,新百王,2024-12-13,6210
00713,元大台灣高息低波,29,3,26,新百王,2024-12-13,6210
2515,中工,22,0,22,新百王,2024-12-13,6210
00937B,群益ESG投等債20,41,21,20,新百王,2024-12-13,6210
00725B,國泰投資級公司債,20,0,20,新百王,2024-12-13,6210
2484,希華,20,0,20,新百王,2024-12-13,6210
3231,緯創,20,0,20,新百王,2024-12-13,6210
2070,精湛,20,0,20,新百王,2024-12-13,6210
4977,眾達-KY,41,22,19,新百王,2024-12-13,6210
6550,北極星藥業-KY,19,0,19,新百王,2024-12-13,6210
2498,宏達電,26,7,19,新百王,2024-12-13,6210
2312,金寶,21,2,19,新百王,2024-12-13,6210
00936,台新永續高息中小,18,1,17,新百王,2024-12-13,6210
6015,宏遠證,17,0,17,新百王,2024-12-13,6210
00919,群益台灣精選高息,17,0,17,新百王,2024-12-13,6210
1514,亞力,18,2,16,新百王,2024-12-13,6210
2313,華通,32,16,16,新百王,2024-12-13,6210
2317,鴻海,32,17,15,新百王,2024-12-13,6210
1301,台塑,72,58,14,新百王,2024-12-13,6210
4563,百德,15,1,14,新百王,2024-12-13,6210
00852L,國泰美國道瓊正2,13,0,13,新百王,2024-12-13,6210
1446,宏和,15,2,13,新百王,2024-12-13,6210
2340,台亞,13,0,13,新百王,2024-12-13,6210
4979,華星光,28,16,12,新百王,2024-12-13,6210
2363,矽統,19,8,11,新百王,2024-12-13,6210
2025,千興,10,0,10,新百王,2024-12-13,6210
6244,茂迪,10,0,10,新百王,2024-12-13,6210
3714,富采,10,0,10,新百王,2024-12-13,6210
5512,力麒,40,30,10,新百王,2024-12-13,6210
1815,富喬,23,13,10,新百王,2024-12-13,6210
2027,大成鋼,10,0,10,新百王,2024-12-13,6210
2607,榮運,10,0,10,新百王,2024-12-13,6210
00673R,期元大S＆P原油反1,1520,0,1520,新百王,2024-12-16,6210
00948B,中信優息投資級債,452,0,452,新百王,2024-12-16,6210
00688L,國泰20年美債正2,134,10,124,新百王,2024-12-16,6210
2104,國際中橡,90,11,79,新百王,2024-12-16,6210
5315,光聯,63,3,60,新百王,2024-12-16,6210
8097,常珵,55,2,53,新百王,2024-12-16,6210
00919,群益台灣精選高息,58,8,50,新百王,2024-12-16,6210
1785,光洋科,51,5,46,新百王,2024-12-16,6210
00753L,中信中國50正2,44,0,44,新百王,2024-12-16,6210
2615,萬海,67,24,43,新百王,2024-12-16,6210
2609,陽明,123,80,43,新百王,2024-12-16,6210
5439,高技,51,12,39,新百王,2024-12-16,6210
8104,錸寶,39,0,39,新百王,2024-12-16,6210
00637L,元大滬深300正2,93,56,37,新百王,2024-12-16,6210
00852L,國泰美國道瓊正2,34,0,34,新百王,2024-12-16,6210
2834,臺企銀,75,41,34,新百王,2024-12-16,6210
2474,可成,30,3,27,新百王,2024-12-16,6210
2392,正崴,50,27,23,新百王,2024-12-16,6210
00687B,國泰20年美債,54,32,22,新百王,2024-12-16,6210
2613,中櫃,24,2,22,新百王,2024-12-16,6210
00962,台新AI優息動能,22,0,22,新百王,2024-12-16,6210
2883,凱基金,30,10,20,新百王,2024-12-16,6210
2597,潤弘,20,1,19,新百王,2024-12-16,6210
1301,台塑,70,52,18,新百王,2024-12-16,6210
1446,宏和,21,4,17,新百王,2024-12-16,6210
4953,緯軟,26,10,16,新百王,2024-12-16,6210
2449,京元電子,28,12,16,新百王,2024-12-16,6210
2441,超豐,17,1,16,新百王,2024-12-16,6210
2617,台航,15,0,15,新百王,2024-12-16,6210
2337,旺宏,14,0,14,新百王,2024-12-16,6210
2027,大成鋼,13,0,13,新百王,2024-12-16,6210
3022,威強電,13,0,13,新百王,2024-12-16,6210
2882,國泰金,36,24,12,新百王,2024-12-16,6210
6163,華電網,12,0,12,新百王,2024-12-16,6210
00795B,中信美國公債20年,44,32,12,新百王,2024-12-16,6210
2545,皇翔,12,0,12,新百王,2024-12-16,6210
1514,亞力,14,2,12,新百王,2024-12-16,6210
3706,神達,106,95,11,新百王,2024-12-16,6210
00665L,富邦�琤肭磪囓�2,21,10,11,新百王,2024-12-16,6210
00650L,復華香港正2,21,10,11,新百王,2024-12-16,6210
00934,中信成長高股息,10,0,10,新百王,2024-12-16,6210
00751B,元大AAA至A公司債,10,0,10,新百王,2024-12-16,6210
2905,三商,10,0,10,新百王,2024-12-16,6210
1532,勤美,10,0,10,新百王,2024-12-16,6210
00662,富邦NASDAQ,10,0,10,新百王,2024-12-16,6210
2305,全友,10,0,10,新百王,2024-12-16,6210
1569,濱川,14,4,10,新百王,2024-12-16,6210
5202,力新,10,0,10,新百王,2024-12-16,6210
1444,力麗,10,0,10,新百王,2024-12-16,6210
2542,興富發,10,0,10,新百王,2024-12-16,6210
00937B,群益ESG投等債20,288,3,285,新百王,2024-12-17,6210
1314,中石化,151,87,64,新百王,2024-12-17,6210
2834,臺企銀,85,22,63,新百王,2024-12-17,6210
2474,可成,51,1,50,新百王,2024-12-17,6210
2374,佳能,234,192,42,新百王,2024-12-17,6210
3532,台勝科,40,0,40,新百王,2024-12-17,6210
6156,松上,36,0,36,新百王,2024-12-17,6210
2312,金寶,58,22,36,新百王,2024-12-17,6210
00693U,期街口S＆P黃豆,36,0,36,新百王,2024-12-17,6210
00915,凱基優選高股息30,36,0,36,新百王,2024-12-17,6210
00680L,元大美債20正2,35,0,35,新百王,2024-12-17,6210
00712,復華富時不動產,34,0,34,新百王,2024-12-17,6210
1101,台泥,31,0,31,新百王,2024-12-17,6210
6416,瑞祺電通,30,0,30,新百王,2024-12-17,6210
8044,網家,30,0,30,新百王,2024-12-17,6210
1609,大亞,28,0,28,新百王,2024-12-17,6210
2886,兆豐金,25,0,25,新百王,2024-12-17,6210
8097,常珵,28,3,25,新百王,2024-12-17,6210
2542,興富發,22,0,22,新百王,2024-12-17,6210
3712,永崴投控,26,5,21,新百王,2024-12-17,6210
6770,力積電,40,20,20,新百王,2024-12-17,6210
00676R,富邦臺灣加權反1,20,0,20,新百王,2024-12-17,6210
2888,新光金,20,0,20,新百王,2024-12-17,6210
00950B,凱基A級公司債,20,0,20,新百王,2024-12-17,6210
3515,華擎,20,0,20,新百王,2024-12-17,6210
4533,協易機,36,16,20,新百王,2024-12-17,6210
00687B,國泰20年美債,49,29,20,新百王,2024-12-17,6210
4953,緯軟,24,5,19,新百王,2024-12-17,6210
3481,群創,19,1,18,新百王,2024-12-17,6210
6547,高端疫苗,18,1,17,新百王,2024-12-17,6210
00918,大華優利高填息30,17,0,17,新百王,2024-12-17,6210
2609,陽明,77,61,16,新百王,2024-12-17,6210
00751B,元大AAA至A公司債,16,0,16,新百王,2024-12-17,6210
5425,台半,21,6,15,新百王,2024-12-17,6210
3631,晟楠,15,0,15,新百王,2024-12-17,6210
3528,安馳,15,0,15,新百王,2024-12-17,6210
1216,統一,15,0,15,新百王,2024-12-17,6210
6274,台燿,16,2,14,新百王,2024-12-17,6210
2883,凱基金,176,162,14,新百王,2024-12-17,6210
00688L,國泰20年美債正2,14,0,14,新百王,2024-12-17,6210
2408,南亞科,21,7,14,新百王,2024-12-17,6210
1466,聚隆,28,15,13,新百王,2024-12-17,6210
2882,國泰金,24,11,13,新百王,2024-12-17,6210
6215,和椿,62,50,12,新百王,2024-12-17,6210
1301,台塑,28,17,11,新百王,2024-12-17,6210
00959B,大華投等美債15Y+,11,0,11,新百王,2024-12-17,6210
1201,味全,10,0,10,新百王,2024-12-17,6210
00953B,群益優選非投等債,10,0,10,新百王,2024-12-17,6210
0056,元大高股息,19,9,10,新百王,2024-12-17,6210
2597,潤弘,9,0,9,新百王,2024-12-17,6210
2002,中鋼,587,0,587,新百王,2024-12-18,6210
2801,彰銀,458,0,458,新百王,2024-12-18,6210
2344,華邦電,208,9,199,新百王,2024-12-18,6210
00882,中信中國高股息,200,1,199,新百王,2024-12-18,6210
2888,新光金,198,0,198,新百王,2024-12-18,6210
00633L,富邦上証正2,110,1,109,新百王,2024-12-18,6210
2891,中信金,111,10,101,新百王,2024-12-18,6210
2605,新興,101,0,101,新百王,2024-12-18,6210
00919,群益台灣精選高息,175,76,99,新百王,2024-12-18,6210
3706,神達,298,213,85,新百王,2024-12-18,6210
2615,萬海,89,20,69,新百王,2024-12-18,6210
2408,南亞科,71,3,68,新百王,2024-12-18,6210
3481,群創,66,0,66,新百王,2024-12-18,6210
00933B,國泰10Y+金融債,60,0,60,新百王,2024-12-18,6210
00924,復華S＆P500成長,50,0,50,新百王,2024-12-18,6210
00918,大華優利高填息30,56,11,45,新百王,2024-12-18,6210
1785,光洋科,48,8,40,新百王,2024-12-18,6210
00953B,群益優選非投等債,33,0,33,新百王,2024-12-18,6210
1442,名軒,36,7,29,新百王,2024-12-18,6210
2603,長榮,31,2,29,新百王,2024-12-18,6210
6505,台塑化,31,5,26,新百王,2024-12-18,6210
3019,亞光,74,49,25,新百王,2024-12-18,6210
2884,玉山金,30,10,20,新百王,2024-12-18,6210
2509,全坤建,20,0,20,新百王,2024-12-18,6210
00680L,元大美債20正2,18,0,18,新百王,2024-12-18,6210
2886,兆豐金,17,0,17,新百王,2024-12-18,6210
00852L,國泰美國道瓊正2,20,4,16,新百王,2024-12-18,6210
0050,元大台灣50,15,1,14,新百王,2024-12-18,6210
2897,王道銀行,39,25,14,新百王,2024-12-18,6210
3037,欣興,19,6,13,新百王,2024-12-18,6210
8059,凱碩,13,0,13,新百王,2024-12-18,6210
2317,鴻海,21,8,13,新百王,2024-12-18,6210
00712,復華富時不動產,14,3,11,新百王,2024-12-18,6210
1316,上曜,18,7,11,新百王,2024-12-18,6210
8070,長華*,10,0,10,新百王,2024-12-18,6210
2027,大成鋼,10,0,10,新百王,2024-12-18,6210
1817,凱撒衛,10,0,10,新百王,2024-12-18,6210
2887,台新金,10,0,10,新百王,2024-12-18,6210
3483,力致,10,0,10,新百王,2024-12-18,6210
2104,國際中橡,20,10,10,新百王,2024-12-18,6210
00926,凱基全球菁英55,10,0,10,新百王,2024-12-18,6210
2014,中鴻,10,0,10,新百王,2024-12-18,6210
4906,正文,10,0,10,新百王,2024-12-18,6210
4577,達航科技,12,2,10,新百王,2024-12-18,6210
6163,華電網,10,0,10,新百王,2024-12-18,6210
6217,中探針,9,0,9,新百王,2024-12-18,6210
2515,中工,9,0,9,新百王,2024-12-18,6210
2542,興富發,10,1,9,新百王,2024-12-18,6210
0056,元大高股息,8,0,8,新百王,2024-12-18,6210
4540,全球傳動,87,79,8,新百王,2024-12-18,6210
00688L,國泰20年美債正2,344,0,344,新百王,2024-12-19,6210
2002,中鋼,173,0,173,新百王,2024-12-19,6210
00882,中信中國高股息,116,0,116,新百王,2024-12-19,6210
2883,凱基金,307,215,92,新百王,2024-12-19,6210
1102,亞泥,85,0,85,新百王,2024-12-19,6210
00632R,元大台灣50反1,300,216,84,新百王,2024-12-19,6210
3481,群創,79,0,79,新百王,2024-12-19,6210
2836,高雄銀,58,0,58,新百王,2024-12-19,6210
00679B,元大美債20年,62,9,53,新百王,2024-12-19,6210
2605,新興,51,0,51,新百王,2024-12-19,6210
00919,群益台灣精選高息,90,40,50,新百王,2024-12-19,6210
00937B,群益ESG投等債20,46,0,46,新百王,2024-12-19,6210
00953B,群益優選非投等債,46,0,46,新百王,2024-12-19,6210
00712,復華富時不動產,48,11,37,新百王,2024-12-19,6210
00680L,元大美債20正2,40,7,33,新百王,2024-12-19,6210
5521,工信,53,20,33,新百王,2024-12-19,6210
2882,國泰金,35,3,32,新百王,2024-12-19,6210
00918,大華優利高填息30,32,0,32,新百王,2024-12-19,6210
00720B,元大投資級公司債,30,0,30,新百王,2024-12-19,6210
2881,富邦金,28,0,28,新百王,2024-12-19,6210
2303,聯電,38,11,27,新百王,2024-12-19,6210
00857B,永豐20年美公債,25,0,25,新百王,2024-12-19,6210
00945B,凱基美國非投等債,25,0,25,新百王,2024-12-19,6210
2887,台新金,25,0,25,新百王,2024-12-19,6210
1101,台泥,23,0,23,新百王,2024-12-19,6210
2317,鴻海,31,9,22,新百王,2024-12-19,6210
00670L,富邦NASDAQ正2,25,4,21,新百王,2024-12-19,6210
1806,冠軍,21,0,21,新百王,2024-12-19,6210
2646,星宇航空,20,0,20,新百王,2024-12-19,6210
2484,希華,20,0,20,新百王,2024-12-19,6210
2542,興富發,28,10,18,新百王,2024-12-19,6210
8111,立��,62,44,18,新百王,2024-12-19,6210
00662,富邦NASDAQ,18,1,17,新百王,2024-12-19,6210
2886,兆豐金,17,0,17,新百王,2024-12-19,6210
00795B,中信美國公債20年,38,22,16,新百王,2024-12-19,6210
00915,凱基優選高股息30,15,0,15,新百王,2024-12-19,6210
3032,偉訓,20,5,15,新百王,2024-12-19,6210
3607,谷崧,15,0,15,新百王,2024-12-19,6210
00852L,國泰美國道瓊正2,19,5,14,新百王,2024-12-19,6210
00907,永豐優息存股,13,0,13,新百王,2024-12-19,6210
6770,力積電,33,20,13,新百王,2024-12-19,6210
2417,圓剛,23,10,13,新百王,2024-12-19,6210
6962,ITH-KY,15,2,13,新百王,2024-12-19,6210
2892,第一金,13,0,13,新百王,2024-12-19,6210
1815,富喬,18,5,13,新百王,2024-12-19,6210
1785,光洋科,12,0,12,新百王,2024-12-19,6210
3062,建漢,20,8,12,新百王,2024-12-19,6210
5439,高技,13,2,11,新百王,2024-12-19,6210
00905,FT臺灣Smart,11,0,11,新百王,2024-12-19,6210
2495,普安,11,0,11,新百王,2024-12-19,6210
