Ticker,Name,buy,sell,diff,Branch,Date,Branch_Code
00632R,元大台灣50反1,300,121,179,光和,2023-01-03,6380
1701,中化,116,4,112,光和,2023-01-03,6380
3705,永信,91,0,91,光和,2023-01-03,6380
2884,玉山金,46,0,46,光和,2023-01-03,6380
1718,中纖,35,1,34,光和,2023-01-03,6380
2634,漢翔,33,0,33,光和,2023-01-03,6380
1605,華新,38,12,26,光和,2023-01-03,6380
1514,亞力,25,2,23,光和,2023-01-03,6380
00637L,元大滬深300正2,26,3,23,光和,2023-01-03,6380
1217,愛之味,20,0,20,光和,2023-01-03,6380
00706L,期元大S＆P日圓正2,20,0,20,光和,2023-01-03,6380
2034,允強,20,1,19,光和,2023-01-03,6380
6111,大宇資,20,1,19,光和,2023-01-03,6380
00878,國泰永續高股息,19,0,19,光和,2023-01-03,6380
2359,所羅門,23,6,17,光和,2023-01-03,6380
2317,鴻海,27,10,17,光和,2023-01-03,6380
00674R,期元大S＆P黃金反1,15,0,15,光和,2023-01-03,6380
2547,日勝生,15,0,15,光和,2023-01-03,6380
6461,益得,14,0,14,光和,2023-01-03,6380
3564,其陽,13,0,13,光和,2023-01-03,6380
1447,力鵬,12,0,12,光和,2023-01-03,6380
1720,生達,11,0,11,光和,2023-01-03,6380
4114,健喬,22,11,11,光和,2023-01-03,6380
00885,富邦越南,10,0,10,光和,2023-01-03,6380
2340,台亞,10,0,10,光和,2023-01-03,6380
2441,超豐,10,0,10,光和,2023-01-03,6380
6806,森崴能源,11,1,10,光和,2023-01-03,6380
8935,邦泰,10,0,10,光和,2023-01-03,6380
6589,台康生技,11,2,9,光和,2023-01-03,6380
2308,台達電,9,0,9,光和,2023-01-03,6380
2352,佳世達,8,0,8,光和,2023-01-03,6380
2603,長榮,7,0,7,光和,2023-01-03,6380
3481,群創,11,4,7,光和,2023-01-03,6380
1529,樂事綠能,11,5,6,光和,2023-01-03,6380
2062,橋椿,11,5,6,光和,2023-01-03,6380
6282,康舒,9,3,6,光和,2023-01-03,6380
1101,台泥,6,0,6,光和,2023-01-03,6380
2029,盛餘,5,0,5,光和,2023-01-03,6380
00901,永豐智能車供應鏈,5,0,5,光和,2023-01-03,6380
00673R,期元大S＆P原油反1,5,0,5,光和,2023-01-03,6380
2615,萬海,8,3,5,光和,2023-01-03,6380
2707,晶華,5,0,5,光和,2023-01-03,6380
3338,泰碩,5,0,5,光和,2023-01-03,6380
4989,榮科,5,0,5,光和,2023-01-03,6380
5009,榮剛,6,1,5,光和,2023-01-03,6380
6118,建達,7,2,5,光和,2023-01-03,6380
6127,九豪,5,0,5,光和,2023-01-03,6380
2109,華豐,5,0,5,光和,2023-01-03,6380
0056,元大高股息,6,2,4,光和,2023-01-03,6380
3508,位速,6,2,4,光和,2023-01-03,6380
2201,裕隆,143,6,137,光和,2023-01-04,6380
2317,鴻海,45,4,41,光和,2023-01-04,6380
00893,國泰智能電動車,33,0,33,光和,2023-01-04,6380
5351,鈺創,31,2,29,光和,2023-01-04,6380
00632R,元大台灣50反1,30,5,25,光和,2023-01-04,6380
00715L,期街口布蘭特正2,22,0,22,光和,2023-01-04,6380
6168,宏齊,20,0,20,光和,2023-01-04,6380
1514,亞力,19,3,16,光和,2023-01-04,6380
2615,萬海,14,0,14,光和,2023-01-04,6380
1783,和康生,13,0,13,光和,2023-01-04,6380
0056,元大高股息,12,0,12,光和,2023-01-04,6380
2376,技嘉,12,0,12,光和,2023-01-04,6380
8227,巨有科技,12,1,11,光和,2023-01-04,6380
1718,中纖,10,0,10,光和,2023-01-04,6380
8171,天宇,11,2,9,光和,2023-01-04,6380
1314,中石化,10,2,8,光和,2023-01-04,6380
2886,兆豐金,8,0,8,光和,2023-01-04,6380
6770,力積電,11,3,8,光和,2023-01-04,6380
8050,廣積,8,0,8,光和,2023-01-04,6380
00902,中信電池及儲能,7,0,7,光和,2023-01-04,6380
2883,凱基金,6,0,6,光和,2023-01-04,6380
3025,星通,6,0,6,光和,2023-01-04,6380
3272,東碩,9,3,6,光和,2023-01-04,6380
8028,昇陽半導體,6,0,6,光和,2023-01-04,6380
00892,富邦台灣半導體,5,0,5,光和,2023-01-04,6380
00701,國泰股利精選30,5,0,5,光和,2023-01-04,6380
2002,中鋼,5,0,5,光和,2023-01-04,6380
2367,燿華,5,0,5,光和,2023-01-04,6380
2547,日勝生,5,0,5,光和,2023-01-04,6380
2607,榮運,5,0,5,光和,2023-01-04,6380
3048,益登,5,0,5,光和,2023-01-04,6380
4746,台耀,6,1,5,光和,2023-01-04,6380
6186,新潤,5,0,5,光和,2023-01-04,6380
6494,九齊,5,0,5,光和,2023-01-04,6380
6589,台康生技,5,0,5,光和,2023-01-04,6380
6768,志強-KY,5,0,5,光和,2023-01-04,6380
3037,欣興,12,8,4,光和,2023-01-04,6380
8046,南電,4,0,4,光和,2023-01-04,6380
2014,中鴻,4,0,4,光和,2023-01-04,6380
2030,彰源,5,1,4,光和,2023-01-04,6380
2641,正德,4,0,4,光和,2023-01-04,6380
2707,晶華,4,0,4,光和,2023-01-04,6380
3122,笙泉,4,0,4,光和,2023-01-04,6380
3494,誠研,5,1,4,光和,2023-01-04,6380
4931,新盛力,4,0,4,光和,2023-01-04,6380
5475,德宏,5,1,4,光和,2023-01-04,6380
6585,鼎基,4,0,4,光和,2023-01-04,6380
9802,鈺齊-KY,4,0,4,光和,2023-01-04,6380
2603,長榮,3,0,3,光和,2023-01-04,6380
00878,國泰永續高股息,3,0,3,光和,2023-01-04,6380
4155,訊映,96,0,96,光和,2023-01-05,6380
2515,中工,92,0,92,光和,2023-01-05,6380
2303,聯電,50,3,47,光和,2023-01-05,6380
2317,鴻海,44,4,40,光和,2023-01-05,6380
00632R,元大台灣50反1,40,0,40,光和,2023-01-05,6380
1513,中興電,47,16,31,光和,2023-01-05,6380
6111,大宇資,31,0,31,光和,2023-01-05,6380
2344,華邦電,21,1,20,光和,2023-01-05,6380
00642U,期元大S＆P石油,19,0,19,光和,2023-01-05,6380
1815,富喬,19,0,19,光和,2023-01-05,6380
3047,訊舟,20,1,19,光和,2023-01-05,6380
00715L,期街口布蘭特正2,18,0,18,光和,2023-01-05,6380
6443,元晶,22,6,16,光和,2023-01-05,6380
00830,國泰費城半導體,15,1,14,光和,2023-01-05,6380
2610,華航,15,1,14,光和,2023-01-05,6380
9945,潤泰新,13,0,13,光和,2023-01-05,6380
2465,麗臺,12,1,11,光和,2023-01-05,6380
4167,松瑞藥,16,5,11,光和,2023-01-05,6380
00679B,元大美債20年,10,0,10,光和,2023-01-05,6380
2812,台中銀,10,0,10,光和,2023-01-05,6380
1701,中化,11,1,10,光和,2023-01-05,6380
2607,榮運,10,0,10,光和,2023-01-05,6380
3048,益登,10,0,10,光和,2023-01-05,6380
2230,泰茂,9,0,9,光和,2023-01-05,6380
1760,寶齡富錦,8,0,8,光和,2023-01-05,6380
3686,達能,8,0,8,光和,2023-01-05,6380
4979,華星光,8,0,8,光和,2023-01-05,6380
4989,榮科,8,0,8,光和,2023-01-05,6380
1504,東元,7,0,7,光和,2023-01-05,6380
1444,力麗,9,2,7,光和,2023-01-05,6380
00885,富邦越南,31,24,7,光和,2023-01-05,6380
2376,技嘉,9,2,7,光和,2023-01-05,6380
3189,景碩,7,0,7,光和,2023-01-05,6380
6129,普誠,10,3,7,光和,2023-01-05,6380
1605,華新,32,26,6,光和,2023-01-05,6380
2062,橋椿,6,0,6,光和,2023-01-05,6380
4938,和碩,6,0,6,光和,2023-01-05,6380
5521,工信,6,0,6,光和,2023-01-05,6380
5531,鄉林,6,0,6,光和,2023-01-05,6380
6603,富強鑫,6,0,6,光和,2023-01-05,6380
6806,森崴能源,12,6,6,光和,2023-01-05,6380
00881,國泰台灣5G+,6,0,6,光和,2023-01-05,6380
8069,元太,11,6,5,光和,2023-01-05,6380
00896,中信綠能及電動車,5,0,5,光和,2023-01-05,6380
00905,FT臺灣Smart,5,0,5,光和,2023-01-05,6380
00878,國泰永續高股息,5,0,5,光和,2023-01-05,6380
00875,國泰網路資安,5,0,5,光和,2023-01-05,6380
2380,虹光,6,1,5,光和,2023-01-05,6380
2468,華經,5,0,5,光和,2023-01-05,6380
2520,冠德,5,0,5,光和,2023-01-05,6380
00632R,元大台灣50反1,307,0,307,光和,2023-01-06,6380
3576,聯合再生,101,0,101,光和,2023-01-06,6380
9962,有益,59,0,59,光和,2023-01-06,6380
2515,中工,40,0,40,光和,2023-01-06,6380
1519,華城,28,0,28,光和,2023-01-06,6380
3481,群創,52,28,24,光和,2023-01-06,6380
1714,和桐,20,0,20,光和,2023-01-06,6380
5351,鈺創,20,3,17,光和,2023-01-06,6380
6806,森崴能源,15,0,15,光和,2023-01-06,6380
2308,台達電,15,1,14,光和,2023-01-06,6380
2612,中航,15,1,14,光和,2023-01-06,6380
3027,盛達,16,4,12,光和,2023-01-06,6380
6589,台康生技,15,3,12,光和,2023-01-06,6380
4128,中天,11,0,11,光和,2023-01-06,6380
6186,新潤,11,0,11,光和,2023-01-06,6380
00830,國泰費城半導體,10,0,10,光和,2023-01-06,6380
00900,富邦特選高股息30,10,0,10,光和,2023-01-06,6380
1217,愛之味,10,0,10,光和,2023-01-06,6380
00751B,元大AAA至A公司債,10,0,10,光和,2023-01-06,6380
00679B,元大美債20年,10,0,10,光和,2023-01-06,6380
1618,合機,10,0,10,光和,2023-01-06,6380
2230,泰茂,12,2,10,光和,2023-01-06,6380
8222,寶一,10,0,10,光和,2023-01-06,6380
00858,永豐美國500大,7,0,7,光和,2023-01-06,6380
1752,南光,9,2,7,光和,2023-01-06,6380
2359,所羅門,16,9,7,光和,2023-01-06,6380
2542,興富發,7,0,7,光和,2023-01-06,6380
4167,松瑞藥,9,2,7,光和,2023-01-06,6380
9958,世紀鋼,7,0,7,光和,2023-01-06,6380
2358,廷鑫,8,2,6,光和,2023-01-06,6380
2419,仲琦,6,0,6,光和,2023-01-06,6380
00720B,元大投資級公司債,5,0,5,光和,2023-01-06,6380
1605,華新,22,17,5,光和,2023-01-06,6380
1701,中化,15,10,5,光和,2023-01-06,6380
2014,中鴻,6,1,5,光和,2023-01-06,6380
2611,志信,5,0,5,光和,2023-01-06,6380
3272,東碩,6,1,5,光和,2023-01-06,6380
3594,磐儀,10,5,5,光和,2023-01-06,6380
5009,榮剛,6,1,5,光和,2023-01-06,6380
5410,國眾,5,0,5,光和,2023-01-06,6380
6269,台郡,5,0,5,光和,2023-01-06,6380
6443,元晶,10,5,5,光和,2023-01-06,6380
6531,愛普*,5,0,5,光和,2023-01-06,6380
3231,緯創,4,0,4,光和,2023-01-06,6380
1444,力麗,6,2,4,光和,2023-01-06,6380
2547,日勝生,4,0,4,光和,2023-01-06,6380
2609,陽明,11,7,4,光和,2023-01-06,6380
3141,晶宏,6,2,4,光和,2023-01-06,6380
3406,玉晶光,4,0,4,光和,2023-01-06,6380
4163,鐿鈦,5,1,4,光和,2023-01-06,6380
00632R,元大台灣50反1,879,550,329,光和,2023-01-09,6380
00665L,富邦�琤肭磪囓�2,225,0,225,光和,2023-01-09,6380
6168,宏齊,70,0,70,光和,2023-01-09,6380
2359,所羅門,76,17,59,光和,2023-01-09,6380
1467,南緯,28,0,28,光和,2023-01-09,6380
2385,群光,25,0,25,光和,2023-01-09,6380
2354,鴻準,25,3,22,光和,2023-01-09,6380
00664R,國泰臺灣加權反1,20,0,20,光和,2023-01-09,6380
3038,全台,18,0,18,光和,2023-01-09,6380
2329,華泰,19,3,16,光和,2023-01-09,6380
4906,正文,16,0,16,光和,2023-01-09,6380
00674R,期元大S＆P黃金反1,15,0,15,光和,2023-01-09,6380
1519,華城,18,3,15,光和,2023-01-09,6380
8105,凌巨,15,1,14,光和,2023-01-09,6380
00713,元大台灣高息低波,14,1,13,光和,2023-01-09,6380
6494,九齊,13,0,13,光和,2023-01-09,6380
1217,愛之味,12,0,12,光和,2023-01-09,6380
1605,華新,32,20,12,光和,2023-01-09,6380
2014,中鴻,15,3,12,光和,2023-01-09,6380
2890,永豐金,15,3,12,光和,2023-01-09,6380
1752,南光,17,6,11,光和,2023-01-09,6380
2412,中華電,12,1,11,光和,2023-01-09,6380
6186,新潤,11,0,11,光和,2023-01-09,6380
3189,景碩,14,3,11,光和,2023-01-09,6380
00706L,期元大S＆P日圓正2,10,0,10,光和,2023-01-09,6380
00631L,元大台灣50正2,31,21,10,光和,2023-01-09,6380
1701,中化,12,2,10,光和,2023-01-09,6380
1714,和桐,10,0,10,光和,2023-01-09,6380
2610,華航,31,21,10,光和,2023-01-09,6380
6591,動力-KY,10,0,10,光和,2023-01-09,6380
00882,中信中國高股息,10,1,9,光和,2023-01-09,6380
2105,正新,10,1,9,光和,2023-01-09,6380
2376,技嘉,15,6,9,光和,2023-01-09,6380
3265,台星科,9,0,9,光和,2023-01-09,6380
2748,雲品,8,0,8,光和,2023-01-09,6380
1906,寶隆,7,0,7,光和,2023-01-09,6380
3207,耀勝,7,0,7,光和,2023-01-09,6380
1219,福壽,6,0,6,光和,2023-01-09,6380
2457,飛宏,6,0,6,光和,2023-01-09,6380
1708,東鹼,5,0,5,光和,2023-01-09,6380
2208,台船,5,0,5,光和,2023-01-09,6380
2312,金寶,6,1,5,光和,2023-01-09,6380
2707,晶華,5,0,5,光和,2023-01-09,6380
3027,盛達,8,3,5,光和,2023-01-09,6380
3046,建��,6,1,5,光和,2023-01-09,6380
3630,新鉅科,5,0,5,光和,2023-01-09,6380
5410,國眾,5,0,5,光和,2023-01-09,6380
5483,中美晶,5,0,5,光和,2023-01-09,6380
6174,安��,5,0,5,光和,2023-01-09,6380
8069,元太,6,1,5,光和,2023-01-09,6380
00632R,元大台灣50反1,137,40,97,光和,2023-01-10,6380
2027,大成鋼,64,1,63,光和,2023-01-10,6380
3094,聯傑,60,0,60,光和,2023-01-10,6380
3576,聯合再生,50,0,50,光和,2023-01-10,6380
3062,建漢,40,0,40,光和,2023-01-10,6380
1701,中化,37,4,33,光和,2023-01-10,6380
00885,富邦越南,32,0,32,光和,2023-01-10,6380
00882,中信中國高股息,31,0,31,光和,2023-01-10,6380
1514,亞力,37,7,30,光和,2023-01-10,6380
3535,晶彩科,30,0,30,光和,2023-01-10,6380
1906,寶隆,25,0,25,光和,2023-01-10,6380
1444,力麗,23,3,20,光和,2023-01-10,6380
00725B,國泰投資級公司債,20,0,20,光和,2023-01-10,6380
6591,動力-KY,20,0,20,光和,2023-01-10,6380
6443,元晶,26,8,18,光和,2023-01-10,6380
2609,陽明,19,2,17,光和,2023-01-10,6380
2367,燿華,21,6,15,光和,2023-01-10,6380
3577,泓格,15,0,15,光和,2023-01-10,6380
4743,合一,12,0,12,光和,2023-01-10,6380
3322,建舜電,11,0,11,光和,2023-01-10,6380
2313,華通,11,1,10,光和,2023-01-10,6380
2441,超豐,10,0,10,光和,2023-01-10,6380
2888,新光金,30,20,10,光和,2023-01-10,6380
3346,麗清,10,0,10,光和,2023-01-10,6380
3530,晶相光,10,0,10,光和,2023-01-10,6380
2468,華經,11,2,9,光和,2023-01-10,6380
4915,致伸,10,1,9,光和,2023-01-10,6380
00878,國泰永續高股息,8,0,8,光和,2023-01-10,6380
00715L,期街口布蘭特正2,8,0,8,光和,2023-01-10,6380
2444,兆勁,8,0,8,光和,2023-01-10,6380
4960,誠美材,10,2,8,光和,2023-01-10,6380
6589,台康生技,8,0,8,光和,2023-01-10,6380
8105,凌巨,21,13,8,光和,2023-01-10,6380
1752,南光,7,0,7,光和,2023-01-10,6380
2312,金寶,7,0,7,光和,2023-01-10,6380
8261,富鼎,6,0,6,光和,2023-01-10,6380
2034,允強,6,0,6,光和,2023-01-10,6380
3712,永崴投控,6,0,6,光和,2023-01-10,6380
1513,中興電,5,0,5,光和,2023-01-10,6380
1339,昭輝,5,0,5,光和,2023-01-10,6380
00713,元大台灣高息低波,5,0,5,光和,2023-01-10,6380
1708,東鹼,5,0,5,光和,2023-01-10,6380
1760,寶齡富錦,7,2,5,光和,2023-01-10,6380
2929,淘帝-KY,5,0,5,光和,2023-01-10,6380
3234,光環,5,0,5,光和,2023-01-10,6380
9919,康那香,5,0,5,光和,2023-01-10,6380
2887,台新金,5,0,5,光和,2023-01-10,6380
1605,華新,21,16,5,光和,2023-01-10,6380
2002,中鋼,5,1,4,光和,2023-01-10,6380
4114,健喬,4,0,4,光和,2023-01-10,6380
2027,大成鋼,472,10,462,光和,2023-01-11,6380
3682,亞太電,100,0,100,光和,2023-01-11,6380
1528,恩德,73,5,68,光和,2023-01-11,6380
2610,華航,43,4,39,光和,2023-01-11,6380
2208,台船,20,0,20,光和,2023-01-11,6380
1310,台苯,19,0,19,光和,2023-01-11,6380
2495,普安,18,0,18,光和,2023-01-11,6380
2618,長榮航,35,17,18,光和,2023-01-11,6380
3033,威健,15,0,15,光和,2023-01-11,6380
2388,威盛,13,0,13,光和,2023-01-11,6380
4979,華星光,13,0,13,光和,2023-01-11,6380
4931,新盛力,20,8,12,光和,2023-01-11,6380
00679B,元大美債20年,12,1,11,光和,2023-01-11,6380
1720,生達,11,0,11,光和,2023-01-11,6380
1219,福壽,10,0,10,光和,2023-01-11,6380
2313,華通,11,1,10,光和,2023-01-11,6380
3062,建漢,10,0,10,光和,2023-01-11,6380
8171,天宇,10,0,10,光和,2023-01-11,6380
8222,寶一,10,0,10,光和,2023-01-11,6380
4171,瑞基,9,0,9,光和,2023-01-11,6380
5009,榮剛,16,7,9,光和,2023-01-11,6380
2323,中環,7,0,7,光和,2023-01-11,6380
2887,台新金,7,0,7,光和,2023-01-11,6380
3705,永信,8,1,7,光和,2023-01-11,6380
1734,杏輝,6,0,6,光和,2023-01-11,6380
2515,中工,10,4,6,光和,2023-01-11,6380
8261,富鼎,6,0,6,光和,2023-01-11,6380
5880,合庫金,6,1,5,光和,2023-01-11,6380
2317,鴻海,6,1,5,光和,2023-01-11,6380
1560,中砂,8,3,5,光和,2023-01-11,6380
00713,元大台灣高息低波,5,0,5,光和,2023-01-11,6380
00632R,元大台灣50反1,5,0,5,光和,2023-01-11,6380
2022,聚亨,5,0,5,光和,2023-01-11,6380
2457,飛宏,7,2,5,光和,2023-01-11,6380
2603,長榮,11,6,5,光和,2023-01-11,6380
2607,榮運,5,0,5,光和,2023-01-11,6380
2867,三商壽,5,0,5,光和,2023-01-11,6380
3162,精確,5,0,5,光和,2023-01-11,6380
3264,欣銓,5,0,5,光和,2023-01-11,6380
4142,國光生,5,0,5,光和,2023-01-11,6380
1810,和成,4,0,4,光和,2023-01-11,6380
1909,榮成,4,0,4,光和,2023-01-11,6380
2014,中鴻,5,1,4,光和,2023-01-11,6380
2023,燁輝,4,0,4,光和,2023-01-11,6380
3044,健鼎,4,0,4,光和,2023-01-11,6380
4167,松瑞藥,5,1,4,光和,2023-01-11,6380
6533,晶心科,4,0,4,光和,2023-01-11,6380
6806,森崴能源,5,1,4,光和,2023-01-11,6380
8933,愛地雅,5,1,4,光和,2023-01-11,6380
00878,國泰永續高股息,11,7,4,光和,2023-01-11,6380
2610,華航,222,3,219,光和,2023-01-12,6380
00632R,元大台灣50反1,160,0,160,光和,2023-01-12,6380
00665L,富邦�琤肭磪囓�2,53,20,33,光和,2023-01-12,6380
1101,台泥,51,21,30,光和,2023-01-12,6380
2495,普安,28,0,28,光和,2023-01-12,6380
2317,鴻海,28,2,26,光和,2023-01-12,6380
6164,華興,22,0,22,光和,2023-01-12,6380
00637L,元大滬深300正2,20,0,20,光和,2023-01-12,6380
2312,金寶,20,0,20,光和,2023-01-12,6380
2458,義隆,20,0,20,光和,2023-01-12,6380
2609,陽明,24,5,19,光和,2023-01-12,6380
1314,中石化,16,0,16,光和,2023-01-12,6380
00713,元大台灣高息低波,15,0,15,光和,2023-01-12,6380
00673R,期元大S＆P原油反1,15,0,15,光和,2023-01-12,6380
2029,盛餘,15,0,15,光和,2023-01-12,6380
2388,威盛,15,0,15,光和,2023-01-12,6380
3481,群創,16,1,15,光和,2023-01-12,6380
5522,遠雄,15,0,15,光和,2023-01-12,6380
4904,遠傳,14,0,14,光和,2023-01-12,6380
00900,富邦特選高股息30,13,0,13,光和,2023-01-12,6380
1536,和大,12,0,12,光和,2023-01-12,6380
00878,國泰永續高股息,11,0,11,光和,2023-01-12,6380
2028,威致,10,0,10,光和,2023-01-12,6380
2801,彰銀,10,0,10,光和,2023-01-12,6380
6120,達運,10,0,10,光和,2023-01-12,6380
6456,GIS-KY,10,0,10,光和,2023-01-12,6380
6494,九齊,11,1,10,光和,2023-01-12,6380
6591,動力-KY,10,0,10,光和,2023-01-12,6380
6589,台康生技,11,1,10,光和,2023-01-12,6380
2812,台中銀,10,0,10,光和,2023-01-12,6380
2888,新光金,10,1,9,光和,2023-01-12,6380
3356,奇偶,19,10,9,光和,2023-01-12,6380
2358,廷鑫,13,5,8,光和,2023-01-12,6380
2409,友達,16,8,8,光和,2023-01-12,6380
2009,第一銅,14,6,8,光和,2023-01-12,6380
4162,智擎,8,1,7,光和,2023-01-12,6380
8438,昶昕,7,0,7,光和,2023-01-12,6380
8033,雷虎,7,1,6,光和,2023-01-12,6380
00642U,期元大S＆P石油,6,0,6,光和,2023-01-12,6380
2498,宏達電,17,11,6,光和,2023-01-12,6380
8213,志超,5,0,5,光和,2023-01-12,6380
6719,力智,5,0,5,光和,2023-01-12,6380
1734,杏輝,5,0,5,光和,2023-01-12,6380
00882,中信中國高股息,46,41,5,光和,2023-01-12,6380
2328,廣宇,5,0,5,光和,2023-01-12,6380
3044,健鼎,5,0,5,光和,2023-01-12,6380
3094,聯傑,5,0,5,光和,2023-01-12,6380
4190,佐登-KY,5,0,5,光和,2023-01-12,6380
6531,愛普*,5,0,5,光和,2023-01-12,6380
6770,力積電,10,5,5,光和,2023-01-12,6380
00632R,元大台灣50反1,151,1,150,光和,2023-01-13,6380
6443,元晶,110,3,107,光和,2023-01-13,6380
2027,大成鋼,100,50,50,光和,2023-01-13,6380
8933,愛地雅,35,1,34,光和,2023-01-13,6380
2402,毅嘉,27,0,27,光和,2023-01-13,6380
00665L,富邦�琤肭磪囓�2,30,5,25,光和,2023-01-13,6380
1714,和桐,20,0,20,光和,2023-01-13,6380
2885,元大金,19,0,19,光和,2023-01-13,6380
3027,盛達,20,1,19,光和,2023-01-13,6380
5347,世界,17,0,17,光和,2023-01-13,6380
2105,正新,22,5,17,光和,2023-01-13,6380
8171,天宇,25,10,15,光和,2023-01-13,6380
2376,技嘉,15,1,14,光和,2023-01-13,6380
3178,公準,13,0,13,光和,2023-01-13,6380
4906,正文,13,0,13,光和,2023-01-13,6380
4931,新盛力,21,8,13,光和,2023-01-13,6380
5443,均豪,13,0,13,光和,2023-01-13,6380
1514,亞力,11,0,11,光和,2023-01-13,6380
6548,長科*,20,9,11,光和,2023-01-13,6380
2641,正德,10,0,10,光和,2023-01-13,6380
3093,港建*,10,0,10,光和,2023-01-13,6380
3265,台星科,10,0,10,光和,2023-01-13,6380
3346,麗清,10,0,10,光和,2023-01-13,6380
2609,陽明,17,8,9,光和,2023-01-13,6380
2457,飛宏,9,0,9,光和,2023-01-13,6380
3209,全科,9,0,9,光和,2023-01-13,6380
3508,位速,8,0,8,光和,2023-01-13,6380
2884,玉山金,10,2,8,光和,2023-01-13,6380
8028,昇陽半導體,12,4,8,光和,2023-01-13,6380
1701,中化,10,3,7,光和,2023-01-13,6380
2498,宏達電,18,11,7,光和,2023-01-13,6380
3017,奇鋐,7,0,7,光和,2023-01-13,6380
6244,茂迪,7,0,7,光和,2023-01-13,6380
2317,鴻海,10,3,7,光和,2023-01-13,6380
1906,寶隆,6,0,6,光和,2023-01-13,6380
2034,允強,6,0,6,光和,2023-01-13,6380
6835,圓裕,6,0,6,光和,2023-01-13,6380
6589,台康生技,5,0,5,光和,2023-01-13,6380
5522,遠雄,5,0,5,光和,2023-01-13,6380
00882,中信中國高股息,5,0,5,光和,2023-01-13,6380
1752,南光,15,10,5,光和,2023-01-13,6380
2028,威致,5,0,5,光和,2023-01-13,6380
2109,華豐,5,0,5,光和,2023-01-13,6380
2516,新建,7,2,5,光和,2023-01-13,6380
2867,三商壽,5,0,5,光和,2023-01-13,6380
3105,穩懋,5,0,5,光和,2023-01-13,6380
3704,合勤控,15,10,5,光和,2023-01-13,6380
4915,致伸,6,1,5,光和,2023-01-13,6380
6148,驊宏資,5,0,5,光和,2023-01-13,6380
8261,富鼎,6,1,5,光和,2023-01-13,6380
2610,華航,136,4,132,光和,2023-01-16,6380
00632R,元大台灣50反1,135,30,105,光和,2023-01-16,6380
3682,亞太電,81,0,81,光和,2023-01-16,6380
9938,百和,69,2,67,光和,2023-01-16,6380
3587,閎康,50,0,50,光和,2023-01-16,6380
2317,鴻海,49,1,48,光和,2023-01-16,6380
2706,第一店,40,0,40,光和,2023-01-16,6380
2062,橋椿,38,6,32,光和,2023-01-16,6380
2867,三商壽,30,0,30,光和,2023-01-16,6380
2014,中鴻,27,8,19,光和,2023-01-16,6380
2303,聯電,25,7,18,光和,2023-01-16,6380
3033,威健,20,3,17,光和,2023-01-16,6380
2409,友達,19,2,17,光和,2023-01-16,6380
2609,陽明,29,15,14,光和,2023-01-16,6380
2888,新光金,21,9,12,光和,2023-01-16,6380
00713,元大台灣高息低波,11,0,11,光和,2023-01-16,6380
00770,國泰北美科技,11,0,11,光和,2023-01-16,6380
00756B,群益投等新興公債,10,0,10,光和,2023-01-16,6380
1612,宏泰,10,0,10,光和,2023-01-16,6380
2501,國建,10,0,10,光和,2023-01-16,6380
4916,事欣科,10,0,10,光和,2023-01-16,6380
5351,鈺創,10,1,9,光和,2023-01-16,6380
2392,正崴,9,0,9,光和,2023-01-16,6380
00679B,元大美債20年,8,0,8,光和,2023-01-16,6380
6153,嘉聯益,8,0,8,光和,2023-01-16,6380
3013,晟銘電,10,3,7,光和,2023-01-16,6380
3481,群創,10,3,7,光和,2023-01-16,6380
1783,和康生,7,0,7,光和,2023-01-16,6380
2812,台中銀,6,0,6,光和,2023-01-16,6380
00752,中信中國50,6,0,6,光和,2023-01-16,6380
6770,力積電,16,10,6,光和,2023-01-16,6380
6605,帝寶,5,0,5,光和,2023-01-16,6380
1309,台達化,5,0,5,光和,2023-01-16,6380
1463,強盛新,5,0,5,光和,2023-01-16,6380
2312,金寶,15,10,5,光和,2023-01-16,6380
2387,精元,5,0,5,光和,2023-01-16,6380
3265,台星科,5,0,5,光和,2023-01-16,6380
4162,智擎,9,4,5,光和,2023-01-16,6380
5210,寶碩,5,0,5,光和,2023-01-16,6380
6548,長科*,5,0,5,光和,2023-01-16,6380
6589,台康生技,5,0,5,光和,2023-01-16,6380
8068,全達,5,0,5,光和,2023-01-16,6380
8996,高力,5,0,5,光和,2023-01-16,6380
3006,晶豪科,5,1,4,光和,2023-01-16,6380
00885,富邦越南,4,0,4,光和,2023-01-16,6380
1605,華新,16,12,4,光和,2023-01-16,6380
2436,偉詮電,4,0,4,光和,2023-01-16,6380
2468,華經,4,0,4,光和,2023-01-16,6380
2486,一詮,4,0,4,光和,2023-01-16,6380
9904,寶成,4,0,4,光和,2023-01-16,6380
9938,百和,160,4,156,光和,2023-01-17,6380
2610,華航,134,1,133,光和,2023-01-17,6380
00648R,元大S＆P500反1,50,0,50,光和,2023-01-17,6380
1101,台泥,55,6,49,光和,2023-01-17,6380
2034,允強,60,24,36,光和,2023-01-17,6380
00632R,元大台灣50反1,35,0,35,光和,2023-01-17,6380
6547,高端疫苗,32,0,32,光和,2023-01-17,6380
2618,長榮航,24,0,24,光和,2023-01-17,6380
8111,立��,22,0,22,光和,2023-01-17,6380
2317,鴻海,21,3,18,光和,2023-01-17,6380
00673R,期元大S＆P原油反1,15,0,15,光和,2023-01-17,6380
2301,光寶科,11,0,11,光和,2023-01-17,6380
1309,台達化,10,0,10,光和,2023-01-17,6380
1220,台榮,10,0,10,光和,2023-01-17,6380
2888,新光金,10,0,10,光和,2023-01-17,6380
4108,懷特,10,0,10,光和,2023-01-17,6380
6155,鈞寶,10,0,10,光和,2023-01-17,6380
5211,蒙恬,8,0,8,光和,2023-01-17,6380
3481,群創,9,2,7,光和,2023-01-17,6380
1783,和康生,7,0,7,光和,2023-01-17,6380
2457,飛宏,6,0,6,光和,2023-01-17,6380
2612,中航,6,0,6,光和,2023-01-17,6380
2634,漢翔,7,1,6,光和,2023-01-17,6380
3013,晟銘電,6,0,6,光和,2023-01-17,6380
4162,智擎,6,0,6,光和,2023-01-17,6380
5236,凌陽創新,6,0,6,光和,2023-01-17,6380
5905,南仁湖,6,0,6,光和,2023-01-17,6380
0050,元大台灣50,5,0,5,光和,2023-01-17,6380
00902,中信電池及儲能,5,0,5,光和,2023-01-17,6380
1909,榮成,10,5,5,光和,2023-01-17,6380
2406,國碩,5,0,5,光和,2023-01-17,6380
2892,第一金,6,1,5,光和,2023-01-17,6380
4536,拓凱,5,0,5,光和,2023-01-17,6380
4938,和碩,5,0,5,光和,2023-01-17,6380
5525,順天,5,0,5,光和,2023-01-17,6380
6770,力積電,5,0,5,光和,2023-01-17,6380
8222,寶一,5,0,5,光和,2023-01-17,6380
8069,元太,18,14,4,光和,2023-01-17,6380
00881,國泰台灣5G+,4,0,4,光和,2023-01-17,6380
00907,永豐優息存股,4,0,4,光和,2023-01-17,6380
2062,橋椿,4,0,4,光和,2023-01-17,6380
2482,連宇,4,0,4,光和,2023-01-17,6380
2498,宏達電,5,1,4,光和,2023-01-17,6380
2867,三商壽,4,0,4,光和,2023-01-17,6380
5519,隆大,4,0,4,光和,2023-01-17,6380
2201,裕隆,31,28,3,光和,2023-01-17,6380
2002,中鋼,11,8,3,光和,2023-01-17,6380
5388,中磊,3,0,3,光和,2023-01-17,6380
00905,FT臺灣Smart,3,0,3,光和,2023-01-17,6380
2007,燁興,3,0,3,光和,2023-01-17,6380
2303,聯電,1433,166,1267,光和,2023-01-30,6380
00632R,元大台灣50反1,494,3,491,光和,2023-01-30,6380
5425,台半,302,36,266,光和,2023-01-30,6380
9938,百和,201,0,201,光和,2023-01-30,6380
3035,智原,120,9,111,光和,2023-01-30,6380
2317,鴻海,58,0,58,光和,2023-01-30,6380
6770,力積電,60,4,56,光和,2023-01-30,6380
2609,陽明,54,7,47,光和,2023-01-30,6380
2610,華航,53,12,41,光和,2023-01-30,6380
2353,宏��,40,12,28,光和,2023-01-30,6380
00654R,富邦印度反1,24,0,24,光和,2023-01-30,6380
2314,台揚,23,0,23,光和,2023-01-30,6380
1447,力鵬,22,0,22,光和,2023-01-30,6380
2330,台積電,56,35,21,光和,2023-01-30,6380
1220,台榮,20,0,20,光和,2023-01-30,6380
3622,洋華,20,0,20,光和,2023-01-30,6380
2419,仲琦,18,1,17,光和,2023-01-30,6380
1514,亞力,15,0,15,光和,2023-01-30,6380
00751B,元大AAA至A公司債,10,0,10,光和,2023-01-30,6380
00882,中信中國高股息,10,0,10,光和,2023-01-30,6380
00770,國泰北美科技,10,0,10,光和,2023-01-30,6380
00706L,期元大S＆P日圓正2,10,0,10,光和,2023-01-30,6380
1612,宏泰,10,0,10,光和,2023-01-30,6380
1714,和桐,10,0,10,光和,2023-01-30,6380
1783,和康生,12,2,10,光和,2023-01-30,6380
2547,日勝生,10,0,10,光和,2023-01-30,6380
3041,揚智,10,0,10,光和,2023-01-30,6380
6643,M31,10,0,10,光和,2023-01-30,6380
6668,中揚光,10,0,10,光和,2023-01-30,6380
2615,萬海,10,1,9,光和,2023-01-30,6380
6180,橘子,9,0,9,光和,2023-01-30,6380
5353,台林,8,0,8,光和,2023-01-30,6380
3044,健鼎,7,0,7,光和,2023-01-30,6380
9802,鈺齊-KY,7,0,7,光和,2023-01-30,6380
8069,元太,16,10,6,光和,2023-01-30,6380
1584,精剛,6,0,6,光和,2023-01-30,6380
2062,橋椿,23,17,6,光和,2023-01-30,6380
6535,順藥,7,1,6,光和,2023-01-30,6380
6768,志強-KY,6,0,6,光和,2023-01-30,6380
8050,廣積,9,3,6,光和,2023-01-30,6380
00903,富邦元宇宙,10,5,5,光和,2023-01-30,6380
2022,聚亨,5,0,5,光和,2023-01-30,6380
2313,華通,6,1,5,光和,2023-01-30,6380
2542,興富發,5,0,5,光和,2023-01-30,6380
2892,第一金,8,3,5,光和,2023-01-30,6380
3033,威健,7,2,5,光和,2023-01-30,6380
3189,景碩,7,2,5,光和,2023-01-30,6380
4726,永昕,5,0,5,光和,2023-01-30,6380
6127,九豪,5,0,5,光和,2023-01-30,6380
6568,宏觀,5,0,5,光和,2023-01-30,6380
4142,國光生,77,4,73,光和,2023-01-31,6380
4137,麗豐-KY,43,5,38,光和,2023-01-31,6380
2353,宏��,104,68,36,光和,2023-01-31,6380
2892,第一金,37,2,35,光和,2023-01-31,6380
00885,富邦越南,34,0,34,光和,2023-01-31,6380
00665L,富邦�琤肭磪囓�2,33,0,33,光和,2023-01-31,6380
00905,FT臺灣Smart,29,0,29,光和,2023-01-31,6380
00632R,元大台灣50反1,30,2,28,光和,2023-01-31,6380
3576,聯合再生,22,0,22,光和,2023-01-31,6380
3402,漢科,21,0,21,光和,2023-01-31,6380
00706L,期元大S＆P日圓正2,20,0,20,光和,2023-01-31,6380
00753L,中信中國50正2,20,0,20,光和,2023-01-31,6380
2010,春源,20,0,20,光和,2023-01-31,6380
2363,矽統,20,0,20,光和,2023-01-31,6380
6213,聯茂,20,0,20,光和,2023-01-31,6380
2330,台積電,20,1,19,光和,2023-01-31,6380
2412,中華電,18,0,18,光和,2023-01-31,6380
2347,聯強,18,0,18,光和,2023-01-31,6380
1101,台泥,20,2,18,光和,2023-01-31,6380
4931,新盛力,18,2,16,光和,2023-01-31,6380
8050,廣積,14,0,14,光和,2023-01-31,6380
3017,奇鋐,13,0,13,光和,2023-01-31,6380
00900,富邦特選高股息30,12,0,12,光和,2023-01-31,6380
6609,瀧澤科,12,0,12,光和,2023-01-31,6380
00712,復華富時不動產,11,0,11,光和,2023-01-31,6380
6285,啟��,11,0,11,光和,2023-01-31,6380
00919,群益台灣精選高息,10,0,10,光和,2023-01-31,6380
1905,華紙,10,0,10,光和,2023-01-31,6380
4702,中美實,10,0,10,光和,2023-01-31,6380
6266,泰詠,10,0,10,光和,2023-01-31,6380
6180,橘子,10,0,10,光和,2023-01-31,6380
2891,中信金,11,2,9,光和,2023-01-31,6380
2929,淘帝-KY,11,2,9,光和,2023-01-31,6380
4726,永昕,9,0,9,光和,2023-01-31,6380
6477,安集,10,1,9,光和,2023-01-31,6380
8105,凌巨,16,7,9,光和,2023-01-31,6380
1722,台肥,10,2,8,光和,2023-01-31,6380
3041,揚智,8,0,8,光和,2023-01-31,6380
4973,廣穎,8,0,8,光和,2023-01-31,6380
6548,長科*,11,3,8,光和,2023-01-31,6380
6698,旭暉應材,8,0,8,光和,2023-01-31,6380
1734,杏輝,8,0,8,光和,2023-01-31,6380
2002,中鋼,13,5,8,光和,2023-01-31,6380
1809,中釉,6,0,6,光和,2023-01-31,6380
2338,光罩,6,0,6,光和,2023-01-31,6380
4739,康普,6,0,6,光和,2023-01-31,6380
2618,長榮航,14,9,5,光和,2023-01-31,6380
00881,國泰台灣5G+,5,0,5,光和,2023-01-31,6380
00772B,中信高評級公司債,5,0,5,光和,2023-01-31,6380
00720B,元大投資級公司債,5,0,5,光和,2023-01-31,6380
2609,陽明,79,11,68,光和,2023-02-01,6380
2891,中信金,26,0,26,光和,2023-02-01,6380
2607,榮運,25,0,25,光和,2023-02-01,6380
6111,大宇資,25,0,25,光和,2023-02-01,6380
3037,欣興,28,5,23,光和,2023-02-01,6380
1582,信錦,22,0,22,光和,2023-02-01,6380
6116,彩晶,31,10,21,光和,2023-02-01,6380
00900,富邦特選高股息30,20,0,20,光和,2023-02-01,6380
1909,榮成,23,3,20,光和,2023-02-01,6380
1810,和成,22,4,18,光和,2023-02-01,6380
2376,技嘉,17,1,16,光和,2023-02-01,6380
1605,華新,41,26,15,光和,2023-02-01,6380
9904,寶成,15,0,15,光和,2023-02-01,6380
4114,健喬,14,0,14,光和,2023-02-01,6380
5475,德宏,14,0,14,光和,2023-02-01,6380
1701,中化,14,1,13,光和,2023-02-01,6380
2062,橋椿,13,0,13,光和,2023-02-01,6380
3624,光頡,45,32,13,光和,2023-02-01,6380
6153,嘉聯益,13,0,13,光和,2023-02-01,6380
00878,國泰永續高股息,14,2,12,光和,2023-02-01,6380
2885,元大金,11,0,11,光和,2023-02-01,6380
3035,智原,24,13,11,光和,2023-02-01,6380
3227,原相,11,0,11,光和,2023-02-01,6380
00897,富邦基因免疫生技,10,0,10,光和,2023-02-01,6380
00919,群益台灣精選高息,10,0,10,光和,2023-02-01,6380
1907,永豐餘,10,0,10,光和,2023-02-01,6380
2387,精元,10,0,10,光和,2023-02-01,6380
3479,安勤,11,1,10,光和,2023-02-01,6380
5443,均豪,10,0,10,光和,2023-02-01,6380
6234,高僑,10,0,10,光和,2023-02-01,6380
8234,新漢,10,0,10,光和,2023-02-01,6380
3711,日月光投控,10,0,10,光和,2023-02-01,6380
0056,元大高股息,10,1,9,光和,2023-02-01,6380
3047,訊舟,10,1,9,光和,2023-02-01,6380
5263,智崴,9,0,9,光和,2023-02-01,6380
00905,FT臺灣Smart,8,0,8,光和,2023-02-01,6380
1513,中興電,21,14,7,光和,2023-02-01,6380
2017,官田鋼,10,3,7,光和,2023-02-01,6380
2337,旺宏,7,0,7,光和,2023-02-01,6380
2409,友達,27,20,7,光和,2023-02-01,6380
4746,台耀,7,0,7,光和,2023-02-01,6380
6456,GIS-KY,7,0,7,光和,2023-02-01,6380
2412,中華電,6,0,6,光和,2023-02-01,6380
3706,神達,6,0,6,光和,2023-02-01,6380
00637L,元大滬深300正2,26,20,6,光和,2023-02-01,6380
1524,耿鼎,11,5,6,光和,2023-02-01,6380
2230,泰茂,6,0,6,光和,2023-02-01,6380
2323,中環,10,4,6,光和,2023-02-01,6380
8210,勤誠,8,2,6,光和,2023-02-01,6380
2614,東森,12,6,6,光和,2023-02-01,6380
2891,中信金,216,5,211,光和,2023-02-02,6380
2618,長榮航,146,5,141,光和,2023-02-02,6380
00885,富邦越南,91,0,91,光和,2023-02-02,6380
00882,中信中國高股息,90,0,90,光和,2023-02-02,6380
3710,連展投控,54,3,51,光和,2023-02-02,6380
1504,東元,41,0,41,光和,2023-02-02,6380
2034,允強,41,0,41,光和,2023-02-02,6380
2329,華泰,38,5,33,光和,2023-02-02,6380
00878,國泰永續高股息,28,5,23,光和,2023-02-02,6380
2888,新光金,31,10,21,光和,2023-02-02,6380
2312,金寶,26,6,20,光和,2023-02-02,6380
3704,合勤控,26,7,19,光和,2023-02-02,6380
2352,佳世達,20,1,19,光和,2023-02-02,6380
1608,華榮,18,0,18,光和,2023-02-02,6380
6234,高僑,17,0,17,光和,2023-02-02,6380
6111,大宇資,15,0,15,光和,2023-02-02,6380
6443,元晶,49,34,15,光和,2023-02-02,6380
6770,力積電,38,24,14,光和,2023-02-02,6380
3033,威健,18,5,13,光和,2023-02-02,6380
2492,華新科,14,1,13,光和,2023-02-02,6380
2412,中華電,14,2,12,光和,2023-02-02,6380
1513,中興電,28,16,12,光和,2023-02-02,6380
2062,橋椿,12,0,12,光和,2023-02-02,6380
3093,港建*,12,0,12,光和,2023-02-02,6380
1734,杏輝,11,0,11,光和,2023-02-02,6380
3481,群創,11,0,11,光和,2023-02-02,6380
2201,裕隆,26,15,11,光和,2023-02-02,6380
00674R,期元大S＆P黃金反1,10,0,10,光和,2023-02-02,6380
1522,堤維西,10,0,10,光和,2023-02-02,6380
2481,強茂,13,3,10,光和,2023-02-02,6380
4536,拓凱,10,0,10,光和,2023-02-02,6380
4906,正文,10,0,10,光和,2023-02-02,6380
8110,華東,10,0,10,光和,2023-02-02,6380
9907,統一實,10,0,10,光和,2023-02-02,6380
2892,第一金,10,1,9,光和,2023-02-02,6380
3090,日電貿,9,0,9,光和,2023-02-02,6380
8358,金居,9,0,9,光和,2023-02-02,6380
2323,中環,10,2,8,光和,2023-02-02,6380
3027,盛達,8,0,8,光和,2023-02-02,6380
6182,合晶,8,0,8,光和,2023-02-02,6380
8171,天宇,10,2,8,光和,2023-02-02,6380
2317,鴻海,28,21,7,光和,2023-02-02,6380
3059,華晶科,8,1,7,光和,2023-02-02,6380
9945,潤泰新,8,1,7,光和,2023-02-02,6380
00637L,元大滬深300正2,6,0,6,光和,2023-02-02,6380
3437,榮創,6,0,6,光和,2023-02-02,6380
3624,光頡,24,18,6,光和,2023-02-02,6380
00881,國泰台灣5G+,10,5,5,光和,2023-02-02,6380
00679B,元大美債20年,5,0,5,光和,2023-02-02,6380
1309,台達化,5,0,5,光和,2023-02-02,6380
2201,裕隆,131,5,126,光和,2023-02-03,6380
00882,中信中國高股息,107,0,107,光和,2023-02-03,6380
00632R,元大台灣50反1,82,0,82,光和,2023-02-03,6380
1708,東鹼,68,0,68,光和,2023-02-03,6380
00878,國泰永續高股息,64,0,64,光和,2023-02-03,6380
8215,明基材,54,1,53,光和,2023-02-03,6380
1101,台泥,59,25,34,光和,2023-02-03,6380
2888,新光金,32,0,32,光和,2023-02-03,6380
2882,國泰金,29,0,29,光和,2023-02-03,6380
1519,華城,28,0,28,光和,2023-02-03,6380
6226,光鼎,26,0,26,光和,2023-02-03,6380
00637L,元大滬深300正2,25,0,25,光和,2023-02-03,6380
2891,中信金,25,0,25,光和,2023-02-03,6380
2609,陽明,41,20,21,光和,2023-02-03,6380
1305,華夏,20,0,20,光和,2023-02-03,6380
2371,大同,20,0,20,光和,2023-02-03,6380
3535,晶彩科,20,0,20,光和,2023-02-03,6380
00665L,富邦�琤肭磪囓�2,29,10,19,光和,2023-02-03,6380
1513,中興電,34,18,16,光和,2023-02-03,6380
2002,中鋼,20,5,15,光和,2023-02-03,6380
2317,鴻海,24,9,15,光和,2023-02-03,6380
2337,旺宏,37,23,14,光和,2023-02-03,6380
2353,宏��,14,0,14,光和,2023-02-03,6380
2482,連宇,26,13,13,光和,2023-02-03,6380
2363,矽統,14,2,12,光和,2023-02-03,6380
4114,健喬,13,1,12,光和,2023-02-03,6380
2615,萬海,19,8,11,光和,2023-02-03,6380
5522,遠雄,11,0,11,光和,2023-02-03,6380
00902,中信電池及儲能,10,0,10,光和,2023-02-03,6380
00642U,期元大S＆P石油,10,0,10,光和,2023-02-03,6380
3037,欣興,14,4,10,光和,2023-02-03,6380
3682,亞太電,10,0,10,光和,2023-02-03,6380
8478,東哥遊艇,12,2,10,光和,2023-02-03,6380
8916,光隆,10,0,10,光和,2023-02-03,6380
00679B,元大美債20年,9,0,9,光和,2023-02-03,6380
1701,中化,13,4,9,光和,2023-02-03,6380
2376,技嘉,10,1,9,光和,2023-02-03,6380
3481,群創,9,0,9,光和,2023-02-03,6380
8046,南電,22,14,8,光和,2023-02-03,6380
2014,中鴻,11,3,8,光和,2023-02-03,6380
2476,鉅祥,9,1,8,光和,2023-02-03,6380
2834,臺企銀,8,0,8,光和,2023-02-03,6380
5009,榮剛,9,1,8,光和,2023-02-03,6380
8227,巨有科技,8,0,8,光和,2023-02-03,6380
2882A,國泰特,7,0,7,光和,2023-02-03,6380
2603,長榮,22,15,7,光和,2023-02-03,6380
2441,超豐,6,0,6,光和,2023-02-03,6380
5236,凌陽創新,6,0,6,光和,2023-02-03,6380
2484,希華,8,2,6,光和,2023-02-03,6380
2809,京城銀,6,0,6,光和,2023-02-03,6380
00878,國泰永續高股息,183,1,182,光和,2023-02-06,6380
2888,新光金,88,0,88,光和,2023-02-06,6380
00706L,期元大S＆P日圓正2,50,0,50,光和,2023-02-06,6380
00665L,富邦�琤肭磪囓�2,56,10,46,光和,2023-02-06,6380
00882,中信中國高股息,61,19,42,光和,2023-02-06,6380
00885,富邦越南,34,0,34,光和,2023-02-06,6380
2903,遠百,30,0,30,光和,2023-02-06,6380
1336,台翰,27,0,27,光和,2023-02-06,6380
2201,裕隆,32,7,25,光和,2023-02-06,6380
1708,東鹼,24,1,23,光和,2023-02-06,6380
8046,南電,22,0,22,光和,2023-02-06,6380
2883,凱基金,24,2,22,光和,2023-02-06,6380
00637L,元大滬深300正2,21,0,21,光和,2023-02-06,6380
3033,威健,20,0,20,光和,2023-02-06,6380
1313,聯成,20,0,20,光和,2023-02-06,6380
3189,景碩,23,3,20,光和,2023-02-06,6380
3257,虹冠電,20,0,20,光和,2023-02-06,6380
8171,天宇,24,6,18,光和,2023-02-06,6380
4108,懷特,17,0,17,光和,2023-02-06,6380
6589,台康生技,30,13,17,光和,2023-02-06,6380
8069,元太,37,20,17,光和,2023-02-06,6380
2337,旺宏,14,0,14,光和,2023-02-06,6380
2603,長榮,19,6,13,光和,2023-02-06,6380
00900,富邦特選高股息30,12,0,12,光和,2023-02-06,6380
5263,智崴,11,0,11,光和,2023-02-06,6380
6603,富強鑫,11,0,11,光和,2023-02-06,6380
1522,堤維西,11,0,11,光和,2023-02-06,6380
2609,陽明,26,15,11,光和,2023-02-06,6380
2615,萬海,13,2,11,光和,2023-02-06,6380
6494,九齊,11,0,11,光和,2023-02-06,6380
2002,中鋼,11,0,11,光和,2023-02-06,6380
1201,味全,10,0,10,光和,2023-02-06,6380
6116,彩晶,10,0,10,光和,2023-02-06,6380
6441,廣錠,10,0,10,光和,2023-02-06,6380
3056,富華新,9,0,9,光和,2023-02-06,6380
1477,聚陽,9,0,9,光和,2023-02-06,6380
2009,第一銅,10,1,9,光和,2023-02-06,6380
2883B,凱基金乙特,9,0,9,光和,2023-02-06,6380
3622,洋華,9,0,9,光和,2023-02-06,6380
5347,世界,10,1,9,光和,2023-02-06,6380
5371,中光電,11,2,9,光和,2023-02-06,6380
5608,四維航,10,1,9,光和,2023-02-06,6380
00715L,期街口布蘭特正2,8,0,8,光和,2023-02-06,6380
1906,寶隆,8,0,8,光和,2023-02-06,6380
6147,頎邦,8,0,8,光和,2023-02-06,6380
2882,國泰金,8,0,8,光和,2023-02-06,6380
6472,保瑞,12,4,8,光和,2023-02-06,6380
00642U,期元大S＆P石油,7,0,7,光和,2023-02-06,6380
2014,中鴻,7,0,7,光和,2023-02-06,6380
3205,佰研,10,3,7,光和,2023-02-06,6380
2891,中信金,78,0,78,光和,2023-02-07,6380
2352,佳世達,55,0,55,光和,2023-02-07,6380
2702,華園,50,0,50,光和,2023-02-07,6380
6782,視陽,50,0,50,光和,2023-02-07,6380
9958,世紀鋼,37,2,35,光和,2023-02-07,6380
00878,國泰永續高股息,34,2,32,光和,2023-02-07,6380
1605,華新,47,17,30,光和,2023-02-07,6380
2062,橋椿,26,0,26,光和,2023-02-07,6380
2105,正新,25,0,25,光和,2023-02-07,6380
2903,遠百,25,0,25,光和,2023-02-07,6380
6153,嘉聯益,21,0,21,光和,2023-02-07,6380
1701,中化,27,7,20,光和,2023-02-07,6380
3682,亞太電,20,0,20,光和,2023-02-07,6380
1720,生達,16,0,16,光和,2023-02-07,6380
2419,仲琦,15,0,15,光和,2023-02-07,6380
4528,江興鍛,15,0,15,光和,2023-02-07,6380
00637L,元大滬深300正2,16,3,13,光和,2023-02-07,6380
2888,新光金,12,0,12,光和,2023-02-07,6380
3209,全科,12,0,12,光和,2023-02-07,6380
2344,華邦電,12,1,11,光和,2023-02-07,6380
2882,國泰金,13,2,11,光和,2023-02-07,6380
6770,力積電,11,0,11,光和,2023-02-07,6380
2317,鴻海,14,3,11,光和,2023-02-07,6380
00738U,期元大道瓊白銀,10,0,10,光和,2023-02-07,6380
1524,耿鼎,10,0,10,光和,2023-02-07,6380
2547,日勝生,10,0,10,光和,2023-02-07,6380
2890,永豐金,10,0,10,光和,2023-02-07,6380
3037,欣興,10,0,10,光和,2023-02-07,6380
4114,健喬,26,16,10,光和,2023-02-07,6380
4167,松瑞藥,11,1,10,光和,2023-02-07,6380
1529,樂事綠能,33,24,9,光和,2023-02-07,6380
2027,大成鋼,9,0,9,光和,2023-02-07,6380
2498,宏達電,13,4,9,光和,2023-02-07,6380
4906,正文,10,1,9,光和,2023-02-07,6380
5608,四維航,11,2,9,光和,2023-02-07,6380
1513,中興電,21,14,7,光和,2023-02-07,6380
1906,寶隆,7,0,7,光和,2023-02-07,6380
2014,中鴻,11,4,7,光和,2023-02-07,6380
4536,拓凱,7,0,7,光和,2023-02-07,6380
5351,鈺創,7,0,7,光和,2023-02-07,6380
00679B,元大美債20年,7,0,7,光和,2023-02-07,6380
2884,玉山金,6,0,6,光和,2023-02-07,6380
00712,復華富時不動產,6,0,6,光和,2023-02-07,6380
00882,中信中國高股息,6,0,6,光和,2023-02-07,6380
2412,中華電,8,2,6,光和,2023-02-07,6380
2603,長榮,14,8,6,光和,2023-02-07,6380
4726,永昕,6,0,6,光和,2023-02-07,6380
2615,萬海,6,1,5,光和,2023-02-07,6380
1519,華城,5,0,5,光和,2023-02-07,6380
00772B,中信高評級公司債,5,0,5,光和,2023-02-07,6380
00632R,元大台灣50反1,365,3,362,光和,2023-02-08,6380
00885,富邦越南,152,30,122,光和,2023-02-08,6380
5371,中光電,61,2,59,光和,2023-02-08,6380
00637L,元大滬深300正2,38,0,38,光和,2023-02-08,6380
2801,彰銀,36,0,36,光和,2023-02-08,6380
00665L,富邦�琤肭磪囓�2,35,0,35,光和,2023-02-08,6380
2897,王道銀行,30,0,30,光和,2023-02-08,6380
9105,泰金寶-DR,27,0,27,光和,2023-02-08,6380
2354,鴻準,24,2,22,光和,2023-02-08,6380
1432,大魯閣,21,0,21,光和,2023-02-08,6380
2359,所羅門,20,1,19,光和,2023-02-08,6380
8171,天宇,24,5,19,光和,2023-02-08,6380
2323,中環,20,3,17,光和,2023-02-08,6380
00679B,元大美債20年,15,0,15,光和,2023-02-08,6380
2886,兆豐金,15,0,15,光和,2023-02-08,6380
2317,鴻海,16,1,15,光和,2023-02-08,6380
8046,南電,14,0,14,光和,2023-02-08,6380
1541,錩泰,14,0,14,光和,2023-02-08,6380
3713,新晶投控,13,0,13,光和,2023-02-08,6380
4114,健喬,31,19,12,光和,2023-02-08,6380
2340,台亞,10,0,10,光和,2023-02-08,6380
2371,大同,10,0,10,光和,2023-02-08,6380
4973,廣穎,10,0,10,光和,2023-02-08,6380
4129,聯合,10,0,10,光和,2023-02-08,6380
6282,康舒,14,4,10,光和,2023-02-08,6380
8933,愛地雅,10,0,10,光和,2023-02-08,6380
2401,凌陽,15,6,9,光和,2023-02-08,6380
2547,日勝生,9,0,9,光和,2023-02-08,6380
1101,台泥,10,1,9,光和,2023-02-08,6380
2610,華航,10,1,9,光和,2023-02-08,6380
6120,達運,11,2,9,光和,2023-02-08,6380
2883,凱基金,9,0,9,光和,2023-02-08,6380
2618,長榮航,8,0,8,光和,2023-02-08,6380
3141,晶宏,9,1,8,光和,2023-02-08,6380
8183,精星,8,0,8,光和,2023-02-08,6380
2603,長榮,8,1,7,光和,2023-02-08,6380
6770,力積電,10,3,7,光和,2023-02-08,6380
2609,陽明,13,6,7,光和,2023-02-08,6380
6274,台燿,7,0,7,光和,2023-02-08,6380
2888,新光金,7,0,7,光和,2023-02-08,6380
2352,佳世達,20,14,6,光和,2023-02-08,6380
3498,陽程,6,0,6,光和,2023-02-08,6380
1529,樂事綠能,6,0,6,光和,2023-02-08,6380
2062,橋椿,6,0,6,光和,2023-02-08,6380
2105,正新,6,0,6,光和,2023-02-08,6380
3176,基亞,6,0,6,光和,2023-02-08,6380
5464,霖宏,6,0,6,光和,2023-02-08,6380
2201,裕隆,6,1,5,光和,2023-02-08,6380
5512,力麒,5,0,5,光和,2023-02-08,6380
6243,迅杰,5,0,5,光和,2023-02-08,6380
2359,所羅門,98,3,95,光和,2023-02-09,6380
1101,台泥,71,1,70,光和,2023-02-09,6380
00878,國泰永續高股息,66,0,66,光和,2023-02-09,6380
8215,明基材,62,0,62,光和,2023-02-09,6380
2801,彰銀,51,0,51,光和,2023-02-09,6380
00885,富邦越南,45,0,45,光和,2023-02-09,6380
2352,佳世達,40,0,40,光和,2023-02-09,6380
2344,華邦電,38,6,32,光和,2023-02-09,6380
2701,萬企,30,0,30,光和,2023-02-09,6380
3363,上詮,30,0,30,光和,2023-02-09,6380
3710,連展投控,40,15,25,光和,2023-02-09,6380
6443,元晶,26,2,24,光和,2023-02-09,6380
2498,宏達電,35,14,21,光和,2023-02-09,6380
1416,廣豐,20,0,20,光和,2023-02-09,6380
1444,力麗,20,0,20,光和,2023-02-09,6380
8935,邦泰,20,0,20,光和,2023-02-09,6380
2062,橋椿,19,0,19,光和,2023-02-09,6380
8261,富鼎,18,0,18,光和,2023-02-09,6380
2888,新光金,18,1,17,光和,2023-02-09,6380
8046,南電,16,0,16,光和,2023-02-09,6380
2369,菱生,14,0,14,光和,2023-02-09,6380
2105,正新,14,1,13,光和,2023-02-09,6380
2883,凱基金,13,0,13,光和,2023-02-09,6380
2880,華南金,12,0,12,光和,2023-02-09,6380
1506,正道,12,0,12,光和,2023-02-09,6380
2401,凌陽,13,2,11,光和,2023-02-09,6380
2492,華新科,11,0,11,光和,2023-02-09,6380
8358,金居,14,3,11,光和,2023-02-09,6380
1605,華新,15,4,11,光和,2023-02-09,6380
1609,大亞,13,3,10,光和,2023-02-09,6380
1810,和成,10,0,10,光和,2023-02-09,6380
2388,威盛,18,8,10,光和,2023-02-09,6380
2611,志信,10,0,10,光和,2023-02-09,6380
4934,太極,10,0,10,光和,2023-02-09,6380
5443,均豪,10,0,10,光和,2023-02-09,6380
8104,錸寶,10,0,10,光和,2023-02-09,6380
4128,中天,20,11,9,光和,2023-02-09,6380
4726,永昕,16,7,9,光和,2023-02-09,6380
4968,立積,10,1,9,光和,2023-02-09,6380
2201,裕隆,20,12,8,光和,2023-02-09,6380
2208,台船,10,3,7,光和,2023-02-09,6380
2387,精元,7,0,7,光和,2023-02-09,6380
2497,怡利電,8,1,7,光和,2023-02-09,6380
2520,冠德,7,0,7,光和,2023-02-09,6380
2609,陽明,11,4,7,光和,2023-02-09,6380
3041,揚智,7,0,7,光和,2023-02-09,6380
3047,訊舟,8,1,7,光和,2023-02-09,6380
4906,正文,8,1,7,光和,2023-02-09,6380
6111,大宇資,7,0,7,光和,2023-02-09,6380
9938,百和,7,0,7,光和,2023-02-09,6380
4931,新盛力,76,8,68,光和,2023-02-10,6380
2105,正新,46,0,46,光和,2023-02-10,6380
2401,凌陽,42,0,42,光和,2023-02-10,6380
1714,和桐,40,2,38,光和,2023-02-10,6380
00878,國泰永續高股息,38,1,37,光和,2023-02-10,6380
5340,建榮,31,0,31,光和,2023-02-10,6380
2618,長榮航,31,1,30,光和,2023-02-10,6380
4960,誠美材,27,0,27,光和,2023-02-10,6380
2609,陽明,33,6,27,光和,2023-02-10,6380
1605,華新,37,13,24,光和,2023-02-10,6380
2409,友達,24,1,23,光和,2023-02-10,6380
3710,連展投控,23,0,23,光和,2023-02-10,6380
4114,健喬,33,11,22,光和,2023-02-10,6380
00885,富邦越南,21,0,21,光和,2023-02-10,6380
3006,晶豪科,21,0,21,光和,2023-02-10,6380
5488,松普,20,0,20,光和,2023-02-10,6380
2374,佳能,19,0,19,光和,2023-02-10,6380
6005,群益證,15,0,15,光和,2023-02-10,6380
0056,元大高股息,15,0,15,光和,2023-02-10,6380
6129,普誠,25,11,14,光和,2023-02-10,6380
2344,華邦電,15,2,13,光和,2023-02-10,6380
6649,台生材,13,0,13,光和,2023-02-10,6380
2614,東森,12,0,12,光和,2023-02-10,6380
3703,欣陸,18,6,12,光和,2023-02-10,6380
6120,達運,12,0,12,光和,2023-02-10,6380
6242,立康,12,0,12,光和,2023-02-10,6380
8299,群聯,12,0,12,光和,2023-02-10,6380
1541,錩泰,11,0,11,光和,2023-02-10,6380
1810,和成,25,14,11,光和,2023-02-10,6380
2208,台船,16,5,11,光和,2023-02-10,6380
6547,高端疫苗,12,1,11,光和,2023-02-10,6380
6796,晉弘,10,0,10,光和,2023-02-10,6380
00753L,中信中國50正2,10,0,10,光和,2023-02-10,6380
1325,恆大,10,0,10,光和,2023-02-10,6380
1337,再生-KY,10,0,10,光和,2023-02-10,6380
1708,東鹼,10,0,10,光和,2023-02-10,6380
2393,億光,10,0,10,光和,2023-02-10,6380
2412,中華電,10,0,10,光和,2023-02-10,6380
2852,第一保,10,0,10,光和,2023-02-10,6380
5603,陸海,10,0,10,光和,2023-02-10,6380
6190,萬泰科,10,0,10,光和,2023-02-10,6380
6770,力積電,12,2,10,光和,2023-02-10,6380
8171,天宇,10,0,10,光和,2023-02-10,6380
2201,裕隆,31,23,8,光和,2023-02-10,6380
1524,耿鼎,14,6,8,光和,2023-02-10,6380
3105,穩懋,8,0,8,光和,2023-02-10,6380
2891,中信金,10,2,8,光和,2023-02-10,6380
2314,台揚,7,0,7,光和,2023-02-10,6380
2834,臺企銀,7,0,7,光和,2023-02-10,6380
4130,健亞,9,2,7,光和,2023-02-10,6380
00878,國泰永續高股息,62,0,62,光和,2023-02-13,6380
2409,友達,61,3,58,光和,2023-02-13,6380
00885,富邦越南,64,10,54,光和,2023-02-13,6380
2358,廷鑫,36,0,36,光和,2023-02-13,6380
3576,聯合再生,55,21,34,光和,2023-02-13,6380
2352,佳世達,30,0,30,光和,2023-02-13,6380
2884,玉山金,30,1,29,光和,2023-02-13,6380
2610,華航,23,0,23,光和,2023-02-13,6380
2618,長榮航,34,11,23,光和,2023-02-13,6380
2017,官田鋼,20,0,20,光和,2023-02-13,6380
2903,遠百,20,0,20,光和,2023-02-13,6380
3017,奇鋐,20,0,20,光和,2023-02-13,6380
0056,元大高股息,19,1,18,光和,2023-02-13,6380
4106,雃博,18,0,18,光和,2023-02-13,6380
8033,雷虎,20,3,17,光和,2023-02-13,6380
1708,東鹼,26,10,16,光和,2023-02-13,6380
00712,復華富時不動產,15,0,15,光和,2023-02-13,6380
4931,新盛力,18,3,15,光和,2023-02-13,6380
2615,萬海,14,0,14,光和,2023-02-13,6380
2801,彰銀,12,0,12,光和,2023-02-13,6380
3189,景碩,12,0,12,光和,2023-02-13,6380
1605,華新,12,1,11,光和,2023-02-13,6380
8478,東哥遊艇,12,1,11,光和,2023-02-13,6380
1609,大亞,10,0,10,光和,2023-02-13,6380
2547,日勝生,10,0,10,光和,2023-02-13,6380
2880,華南金,10,0,10,光和,2023-02-13,6380
3338,泰碩,10,0,10,光和,2023-02-13,6380
3532,台勝科,10,0,10,光和,2023-02-13,6380
6234,高僑,10,0,10,光和,2023-02-13,6380
6494,九齊,10,0,10,光和,2023-02-13,6380
6625,必應,10,0,10,光和,2023-02-13,6380
3029,零壹,10,0,10,光和,2023-02-13,6380
2401,凌陽,10,1,9,光和,2023-02-13,6380
3027,盛達,14,5,9,光和,2023-02-13,6380
6129,普誠,12,3,9,光和,2023-02-13,6380
6834,天二科技,9,0,9,光和,2023-02-13,6380
8222,寶一,26,18,8,光和,2023-02-13,6380
2201,裕隆,23,15,8,光和,2023-02-13,6380
2609,陽明,27,19,8,光和,2023-02-13,6380
2344,華邦電,7,0,7,光和,2023-02-13,6380
2359,所羅門,7,0,7,光和,2023-02-13,6380
2520,冠德,7,0,7,光和,2023-02-13,6380
4739,康普,7,0,7,光和,2023-02-13,6380
00751B,元大AAA至A公司債,6,0,6,光和,2023-02-13,6380
2388,威盛,7,1,6,光和,2023-02-13,6380
2634,漢翔,6,0,6,光和,2023-02-13,6380
5347,世界,9,3,6,光和,2023-02-13,6380
1434,福懋,5,0,5,光和,2023-02-13,6380
2243,宏旭-KY,5,0,5,光和,2023-02-13,6380
2498,宏達電,11,6,5,光和,2023-02-13,6380
00665L,富邦�琤肭磪囓�2,111,20,91,光和,2023-02-14,6380
00632R,元大台灣50反1,98,25,73,光和,2023-02-14,6380
00737,國泰AI+Robo,39,0,39,光和,2023-02-14,6380
1101,台泥,43,8,35,光和,2023-02-14,6380
2892,第一金,50,22,28,光和,2023-02-14,6380
8033,雷虎,23,0,23,光和,2023-02-14,6380
2023,燁輝,21,0,21,光和,2023-02-14,6380
2884,玉山金,22,1,21,光和,2023-02-14,6380
8409,商之器,20,0,20,光和,2023-02-14,6380
8215,明基材,20,1,19,光和,2023-02-14,6380
2453,凌群,25,7,18,光和,2023-02-14,6380
0056,元大高股息,17,0,17,光和,2023-02-14,6380
00669R,國泰美國道瓊反1,15,0,15,光和,2023-02-14,6380
2368,金像電,16,1,15,光和,2023-02-14,6380
6266,泰詠,20,5,15,光和,2023-02-14,6380
2208,台船,14,0,14,光和,2023-02-14,6380
4746,台耀,18,4,14,光和,2023-02-14,6380
6142,友勁,14,0,14,光和,2023-02-14,6380
00637L,元大滬深300正2,22,9,13,光和,2023-02-14,6380
2486,一詮,15,3,12,光和,2023-02-14,6380
6282,康舒,14,2,12,光和,2023-02-14,6380
6649,台生材,12,0,12,光和,2023-02-14,6380
4114,健喬,26,14,12,光和,2023-02-14,6380
3481,群創,13,2,11,光和,2023-02-14,6380
1304,台聚,11,0,11,光和,2023-02-14,6380
2457,飛宏,11,0,11,光和,2023-02-14,6380
4906,正文,11,0,11,光和,2023-02-14,6380
4931,新盛力,25,14,11,光和,2023-02-14,6380
2425,承啟,10,0,10,光和,2023-02-14,6380
4904,遠傳,10,0,10,光和,2023-02-14,6380
5410,國眾,13,3,10,光和,2023-02-14,6380
4106,雃博,10,0,10,光和,2023-02-14,6380
5905,南仁湖,10,0,10,光和,2023-02-14,6380
2886,兆豐金,10,1,9,光和,2023-02-14,6380
6112,邁達特,10,1,9,光和,2023-02-14,6380
4919,新唐,16,8,8,光和,2023-02-14,6380
8936,國統,8,0,8,光和,2023-02-14,6380
8222,寶一,23,15,8,光和,2023-02-14,6380
00673R,期元大S＆P原油反1,7,0,7,光和,2023-02-14,6380
3035,智原,9,2,7,光和,2023-02-14,6380
2748,雲品,9,2,7,光和,2023-02-14,6380
2314,台揚,6,0,6,光和,2023-02-14,6380
2615,萬海,7,1,6,光和,2023-02-14,6380
2801,彰銀,6,0,6,光和,2023-02-14,6380
6443,元晶,11,5,6,光和,2023-02-14,6380
2498,宏達電,7,2,5,光和,2023-02-14,6380
1524,耿鼎,11,6,5,光和,2023-02-14,6380
1708,東鹼,5,0,5,光和,2023-02-14,6380
2022,聚亨,5,0,5,光和,2023-02-14,6380
2351,順德,5,0,5,光和,2023-02-14,6380
00878,國泰永續高股息,112,0,112,光和,2023-02-15,6380
00830,國泰費城半導體,100,8,92,光和,2023-02-15,6380
2888,新光金,50,1,49,光和,2023-02-15,6380
00885,富邦越南,30,0,30,光和,2023-02-15,6380
5347,世界,27,0,27,光和,2023-02-15,6380
2891,中信金,26,0,26,光和,2023-02-15,6380
00665L,富邦�琤肭磪囓�2,31,10,21,光和,2023-02-15,6380
3045,台灣大,21,0,21,光和,2023-02-15,6380
6494,九齊,21,0,21,光和,2023-02-15,6380
1608,華榮,20,0,20,光和,2023-02-15,6380
1529,樂事綠能,20,1,19,光和,2023-02-15,6380
2344,華邦電,20,1,19,光和,2023-02-15,6380
2618,長榮航,23,4,19,光和,2023-02-15,6380
2425,承啟,17,0,17,光和,2023-02-15,6380
6515,穎崴,17,0,17,光和,2023-02-15,6380
2330,台積電,18,1,17,光和,2023-02-15,6380
2376,技嘉,14,0,14,光和,2023-02-15,6380
1605,華新,32,19,13,光和,2023-02-15,6380
5706,鳳凰,12,0,12,光和,2023-02-15,6380
2027,大成鋼,11,0,11,光和,2023-02-15,6380
1101,台泥,22,11,11,光和,2023-02-15,6380
00679B,元大美債20年,10,0,10,光和,2023-02-15,6380
00706L,期元大S＆P日圓正2,10,0,10,光和,2023-02-15,6380
2109,華豐,10,0,10,光和,2023-02-15,6380
6269,台郡,10,0,10,光和,2023-02-15,6380
2610,華航,11,2,9,光和,2023-02-15,6380
2882,國泰金,10,1,9,光和,2023-02-15,6380
4974,亞泰,9,0,9,光和,2023-02-15,6380
2368,金像電,9,1,8,光和,2023-02-15,6380
2609,陽明,10,2,8,光和,2023-02-15,6380
3260,威剛,9,1,8,光和,2023-02-15,6380
3624,光頡,24,16,8,光和,2023-02-15,6380
6180,橘子,18,10,8,光和,2023-02-15,6380
6235,華孚,21,13,8,光和,2023-02-15,6380
2323,中環,7,0,7,光和,2023-02-15,6380
2867,三商壽,7,0,7,光和,2023-02-15,6380
5351,鈺創,7,0,7,光和,2023-02-15,6380
5371,中光電,7,0,7,光和,2023-02-15,6380
0050,元大台灣50,6,0,6,光和,2023-02-15,6380
2105,正新,6,0,6,光和,2023-02-15,6380
1410,南染,6,0,6,光和,2023-02-15,6380
2201,裕隆,11,5,6,光和,2023-02-15,6380
6547,高端疫苗,6,0,6,光和,2023-02-15,6380
8936,國統,6,0,6,光和,2023-02-15,6380
2748,雲品,5,0,5,光和,2023-02-15,6380
1338,廣華-KY,5,0,5,光和,2023-02-15,6380
1701,中化,5,0,5,光和,2023-02-15,6380
1907,永豐餘,5,0,5,光和,2023-02-15,6380
2736,富野,5,0,5,光和,2023-02-15,6380
3221,台嘉碩,5,0,5,光和,2023-02-15,6380
3675,德微,201,1,200,光和,2023-02-16,6380
3231,緯創,100,0,100,光和,2023-02-16,6380
2328,廣宇,48,1,47,光和,2023-02-16,6380
3624,光頡,57,16,41,光和,2023-02-16,6380
2061,風青,40,0,40,光和,2023-02-16,6380
3594,磐儀,40,0,40,光和,2023-02-16,6380
2610,華航,163,124,39,光和,2023-02-16,6380
00632R,元大台灣50反1,38,0,38,光和,2023-02-16,6380
4155,訊映,30,0,30,光和,2023-02-16,6380
1708,東鹼,27,0,27,光和,2023-02-16,6380
00706L,期元大S＆P日圓正2,25,0,25,光和,2023-02-16,6380
1569,濱川,20,0,20,光和,2023-02-16,6380
2884,玉山金,20,0,20,光和,2023-02-16,6380
2605,新興,30,11,19,光和,2023-02-16,6380
3035,智原,22,5,17,光和,2023-02-16,6380
6547,高端疫苗,17,1,16,光和,2023-02-16,6380
2484,希華,22,7,15,光和,2023-02-16,6380
00679B,元大美債20年,14,0,14,光和,2023-02-16,6380
4979,華星光,17,3,14,光和,2023-02-16,6380
5521,工信,13,0,13,光和,2023-02-16,6380
2201,裕隆,25,13,12,光和,2023-02-16,6380
3419,譁裕,12,0,12,光和,2023-02-16,6380
2302,麗正,11,0,11,光和,2023-02-16,6380
1519,華城,15,5,10,光和,2023-02-16,6380
3045,台灣大,10,0,10,光和,2023-02-16,6380
4906,正文,10,0,10,光和,2023-02-16,6380
6142,友勁,10,1,9,光和,2023-02-16,6380
1513,中興電,29,21,8,光和,2023-02-16,6380
2615,萬海,8,0,8,光和,2023-02-16,6380
2748,雲品,11,3,8,光和,2023-02-16,6380
4564,元翎,8,0,8,光和,2023-02-16,6380
2609,陽明,25,18,7,光和,2023-02-16,6380
5531,鄉林,7,0,7,光和,2023-02-16,6380
6235,華孚,15,8,7,光和,2023-02-16,6380
6443,元晶,15,8,7,光和,2023-02-16,6380
6589,台康生技,7,0,7,光和,2023-02-16,6380
8105,凌巨,7,0,7,光和,2023-02-16,6380
6770,力積電,10,3,7,光和,2023-02-16,6380
00878,國泰永續高股息,17,10,7,光和,2023-02-16,6380
00772B,中信高評級公司債,6,0,6,光和,2023-02-16,6380
2603,長榮,16,10,6,光和,2023-02-16,6380
5263,智崴,5,0,5,光和,2023-02-16,6380
1101,台泥,5,0,5,光和,2023-02-16,6380
1539,巨庭,6,1,5,光和,2023-02-16,6380
1514,亞力,6,1,5,光和,2023-02-16,6380
2007,燁興,5,0,5,光和,2023-02-16,6380
2030,彰源,5,0,5,光和,2023-02-16,6380
2369,菱生,6,1,5,光和,2023-02-16,6380
2472,立隆電,5,0,5,光和,2023-02-16,6380
2702,華園,10,5,5,光和,2023-02-16,6380
2034,允強,101,0,101,光和,2023-02-17,6380
00665L,富邦�琤肭磪囓�2,40,0,40,光和,2023-02-17,6380
00877,復華中國5G,40,0,40,光和,2023-02-17,6380
00893,國泰智能電動車,28,0,28,光和,2023-02-17,6380
5905,南仁湖,30,2,28,光和,2023-02-17,6380
5706,鳳凰,28,1,27,光和,2023-02-17,6380
2027,大成鋼,23,0,23,光和,2023-02-17,6380
3038,全台,22,0,22,光和,2023-02-17,6380
3033,威健,20,0,20,光和,2023-02-17,6380
6443,元晶,28,8,20,光和,2023-02-17,6380
1605,華新,43,25,18,光和,2023-02-17,6380
8358,金居,20,3,17,光和,2023-02-17,6380
2442,新美齊,15,0,15,光和,2023-02-17,6380
2634,漢翔,18,3,15,光和,2023-02-17,6380
3041,揚智,15,0,15,光和,2023-02-17,6380
00900,富邦特選高股息30,14,0,14,光和,2023-02-17,6380
0056,元大高股息,14,0,14,光和,2023-02-17,6380
9910,豐泰,21,8,13,光和,2023-02-17,6380
2492,華新科,14,2,12,光和,2023-02-17,6380
2884,玉山金,12,0,12,光和,2023-02-17,6380
6547,高端疫苗,12,0,12,光和,2023-02-17,6380
6517,保勝光學,13,2,11,光和,2023-02-17,6380
00753L,中信中國50正2,10,0,10,光和,2023-02-17,6380
1708,東鹼,10,0,10,光和,2023-02-17,6380
2605,新興,10,0,10,光和,2023-02-17,6380
2640,大車隊,10,0,10,光和,2023-02-17,6380
3703,欣陸,10,0,10,光和,2023-02-17,6380
4526,東台,12,2,10,光和,2023-02-17,6380
9904,寶成,10,0,10,光和,2023-02-17,6380
00679B,元大美債20年,11,2,9,光和,2023-02-17,6380
00632R,元大台灣50反1,10,1,9,光和,2023-02-17,6380
00830,國泰費城半導體,9,0,9,光和,2023-02-17,6380
2486,一詮,10,1,9,光和,2023-02-17,6380
3049,精金,10,1,9,光和,2023-02-17,6380
3594,磐儀,10,1,9,光和,2023-02-17,6380
8222,寶一,15,6,9,光和,2023-02-17,6380
00902,中信電池及儲能,8,0,8,光和,2023-02-17,6380
1810,和成,8,0,8,光和,2023-02-17,6380
2610,華航,80,72,8,光和,2023-02-17,6380
2330,台積電,14,6,8,光和,2023-02-17,6380
00772B,中信高評級公司債,7,0,7,光和,2023-02-17,6380
2606,裕民,7,0,7,光和,2023-02-17,6380
2867,三商壽,7,0,7,光和,2023-02-17,6380
3231,緯創,7,0,7,光和,2023-02-17,6380
3447,展達,7,0,7,光和,2023-02-17,6380
4958,臻鼎-KY,7,0,7,光和,2023-02-17,6380
6111,大宇資,7,0,7,光和,2023-02-17,6380
8403,盛弘,7,0,7,光和,2023-02-17,6380
00637L,元大滬深300正2,11,5,6,光和,2023-02-17,6380
2607,榮運,6,0,6,光和,2023-02-17,6380
2615,萬海,60,1,59,光和,2023-02-20,6380
2484,希華,56,1,55,光和,2023-02-20,6380
00878,國泰永續高股息,48,2,46,光和,2023-02-20,6380
2897,王道銀行,50,6,44,光和,2023-02-20,6380
2034,允強,45,2,43,光和,2023-02-20,6380
6180,橘子,72,30,42,光和,2023-02-20,6380
4108,懷特,50,10,40,光和,2023-02-20,6380
6733,博晟生醫,40,2,38,光和,2023-02-20,6380
2609,陽明,61,23,38,光和,2023-02-20,6380
2323,中環,37,0,37,光和,2023-02-20,6380
2033,佳大,30,0,30,光和,2023-02-20,6380
00728,第一金工業30,27,0,27,光和,2023-02-20,6380
5706,鳳凰,28,1,27,光和,2023-02-20,6380
3390,旭軟,26,0,26,光和,2023-02-20,6380
1714,和桐,30,5,25,光和,2023-02-20,6380
00692,富邦公司治理,21,0,21,光和,2023-02-20,6380
3481,群創,120,99,21,光和,2023-02-20,6380
1432,大魯閣,20,0,20,光和,2023-02-20,6380
2497,怡利電,20,0,20,光和,2023-02-20,6380
1528,恩德,20,1,19,光和,2023-02-20,6380
3025,星通,16,0,16,光和,2023-02-20,6380
0056,元大高股息,26,11,15,光和,2023-02-20,6380
2601,益航,15,0,15,光和,2023-02-20,6380
2867,三商壽,15,0,15,光和,2023-02-20,6380
4541,晟田,15,0,15,光和,2023-02-20,6380
1522,堤維西,14,0,14,光和,2023-02-20,6380
6741,91APP*-KY,15,1,14,光和,2023-02-20,6380
6235,華孚,23,10,13,光和,2023-02-20,6380
2353,宏��,12,0,12,光和,2023-02-20,6380
2515,中工,12,0,12,光和,2023-02-20,6380
2748,雲品,12,1,11,光和,2023-02-20,6380
2367,燿華,22,11,11,光和,2023-02-20,6380
4526,東台,12,1,11,光和,2023-02-20,6380
1216,統一,10,0,10,光和,2023-02-20,6380
00706L,期元大S＆P日圓正2,10,0,10,光和,2023-02-20,6380
1410,南染,10,0,10,光和,2023-02-20,6380
2405,輔信,10,0,10,光和,2023-02-20,6380
3049,精金,17,7,10,光和,2023-02-20,6380
3189,景碩,11,1,10,光和,2023-02-20,6380
3508,位速,10,0,10,光和,2023-02-20,6380
3686,達能,10,0,10,光和,2023-02-20,6380
5410,國眾,10,0,10,光和,2023-02-20,6380
5452,佶優,10,0,10,光和,2023-02-20,6380
6269,台郡,10,0,10,光和,2023-02-20,6380
6625,必應,10,0,10,光和,2023-02-20,6380
8358,金居,16,6,10,光和,2023-02-20,6380
5512,力麒,9,0,9,光和,2023-02-20,6380
2201,裕隆,10,2,8,光和,2023-02-20,6380
2368,金像電,9,1,8,光和,2023-02-20,6380
2753,八方雲集,8,0,8,光和,2023-02-20,6380
4155,訊映,112,0,112,光和,2023-02-21,6380
2897,王道銀行,80,0,80,光和,2023-02-21,6380
2641,正德,72,5,67,光和,2023-02-21,6380
2618,長榮航,59,0,59,光和,2023-02-21,6380
00878,國泰永續高股息,53,0,53,光和,2023-02-21,6380
2884,玉山金,55,3,52,光和,2023-02-21,6380
1708,東鹼,35,1,34,光和,2023-02-21,6380
1504,東元,32,0,32,光和,2023-02-21,6380
00903,富邦元宇宙,30,0,30,光和,2023-02-21,6380
6282,康舒,57,34,23,光和,2023-02-21,6380
6443,元晶,36,15,21,光和,2023-02-21,6380
5443,均豪,20,0,20,光和,2023-02-21,6380
3592,瑞鼎,20,1,19,光和,2023-02-21,6380
2017,官田鋼,20,2,18,光和,2023-02-21,6380
2457,飛宏,34,16,18,光和,2023-02-21,6380
2634,漢翔,20,3,17,光和,2023-02-21,6380
4804,大略-KY,17,0,17,光和,2023-02-21,6380
1524,耿鼎,19,3,16,光和,2023-02-21,6380
1710,東聯,16,0,16,光和,2023-02-21,6380
2314,台揚,17,1,16,光和,2023-02-21,6380
6547,高端疫苗,16,0,16,光和,2023-02-21,6380
00728,第一金工業30,14,0,14,光和,2023-02-21,6380
8105,凌巨,16,2,14,光和,2023-02-21,6380
2867,三商壽,23,10,13,光和,2023-02-21,6380
3346,麗清,13,0,13,光和,2023-02-21,6380
6026,福邦證,13,0,13,光和,2023-02-21,6380
0056,元大高股息,15,3,12,光和,2023-02-21,6380
00692,富邦公司治理,12,0,12,光和,2023-02-21,6380
1701,中化,16,4,12,光和,2023-02-21,6380
00902,中信電池及儲能,11,0,11,光和,2023-02-21,6380
6285,啟��,12,1,11,光和,2023-02-21,6380
8111,立��,13,2,11,光和,2023-02-21,6380
00905,FT臺灣Smart,10,0,10,光和,2023-02-21,6380
00893,國泰智能電動車,10,0,10,光和,2023-02-21,6380
1539,巨庭,11,1,10,光和,2023-02-21,6380
2029,盛餘,10,0,10,光和,2023-02-21,6380
3447,展達,10,0,10,光和,2023-02-21,6380
6190,萬泰科,10,0,10,光和,2023-02-21,6380
1605,華新,39,29,10,光和,2023-02-21,6380
1410,南染,9,0,9,光和,2023-02-21,6380
2486,一詮,9,0,9,光和,2023-02-21,6380
2906,高林,9,0,9,光和,2023-02-21,6380
6531,愛普*,13,4,9,光和,2023-02-21,6380
2492,華新科,8,0,8,光和,2023-02-21,6380
2498,宏達電,58,50,8,光和,2023-02-21,6380
3056,富華新,8,0,8,光和,2023-02-21,6380
4564,元翎,13,5,8,光和,2023-02-21,6380
4739,康普,8,0,8,光和,2023-02-21,6380
6806,森崴能源,8,0,8,光和,2023-02-21,6380
2453,凌群,8,1,7,光和,2023-02-21,6380
2618,長榮航,443,5,438,光和,2023-02-22,6380
3049,精金,51,5,46,光和,2023-02-22,6380
00712,復華富時不動產,44,0,44,光和,2023-02-22,6380
3481,群創,119,78,41,光和,2023-02-22,6380
6266,泰詠,40,0,40,光和,2023-02-22,6380
1522,堤維西,38,0,38,光和,2023-02-22,6380
2736,富野,33,1,32,光和,2023-02-22,6380
1101,台泥,30,0,30,光和,2023-02-22,6380
1605,華新,54,29,25,光和,2023-02-22,6380
6282,康舒,34,11,23,光和,2023-02-22,6380
2034,允強,22,0,22,光和,2023-02-22,6380
2702,華園,24,2,22,光和,2023-02-22,6380
4979,華星光,22,0,22,光和,2023-02-22,6380
00902,中信電池及儲能,21,0,21,光和,2023-02-22,6380
00669R,國泰美國道瓊反1,25,4,21,光和,2023-02-22,6380
6026,福邦證,21,0,21,光和,2023-02-22,6380
1513,中興電,45,24,21,光和,2023-02-22,6380
00665L,富邦�琤肭磪囓�2,30,10,20,光和,2023-02-22,6380
00897,富邦基因免疫生技,20,0,20,光和,2023-02-22,6380
00894,中信小資高價30,20,0,20,光和,2023-02-22,6380
2484,希華,20,0,20,光和,2023-02-22,6380
3447,展達,25,5,20,光和,2023-02-22,6380
3535,晶彩科,20,0,20,光和,2023-02-22,6380
6741,91APP*-KY,20,0,20,光和,2023-02-22,6380
9136,巨騰-DR,20,0,20,光和,2023-02-22,6380
6244,茂迪,20,1,19,光和,2023-02-22,6380
8033,雷虎,27,8,19,光和,2023-02-22,6380
6116,彩晶,32,15,17,光和,2023-02-22,6380
1108,幸福,16,0,16,光和,2023-02-22,6380
2314,台揚,16,0,16,光和,2023-02-22,6380
1504,東元,16,1,15,光和,2023-02-22,6380
00885,富邦越南,15,0,15,光和,2023-02-22,6380
2605,新興,15,0,15,光和,2023-02-22,6380
3037,欣興,16,1,15,光和,2023-02-22,6380
00893,國泰智能電動車,14,0,14,光和,2023-02-22,6380
2337,旺宏,14,0,14,光和,2023-02-22,6380
2498,宏達電,14,0,14,光和,2023-02-22,6380
2882,國泰金,14,0,14,光和,2023-02-22,6380
2883,凱基金,16,2,14,光和,2023-02-22,6380
5263,智崴,13,0,13,光和,2023-02-22,6380
5706,鳳凰,18,5,13,光和,2023-02-22,6380
6770,力積電,15,2,13,光和,2023-02-22,6380
2002,中鋼,17,4,13,光和,2023-02-22,6380
2363,矽統,15,4,11,光和,2023-02-22,6380
2881,富邦金,11,0,11,光和,2023-02-22,6380
2201,裕隆,13,3,10,光和,2023-02-22,6380
3035,智原,21,11,10,光和,2023-02-22,6380
1584,精剛,27,17,10,光和,2023-02-22,6380
2344,華邦電,13,3,10,光和,2023-02-22,6380
2906,高林,11,1,10,光和,2023-02-22,6380
2303,聯電,223,1,222,光和,2023-02-23,6380
00632R,元大台灣50反1,145,0,145,光和,2023-02-23,6380
1314,中石化,110,7,103,光和,2023-02-23,6380
00885,富邦越南,77,0,77,光和,2023-02-23,6380
2206,三陽工業,60,0,60,光和,2023-02-23,6380
2324,仁寶,101,43,58,光和,2023-02-23,6380
00882,中信中國高股息,50,0,50,光和,2023-02-23,6380
2618,長榮航,52,5,47,光和,2023-02-23,6380
3481,群創,69,24,45,光和,2023-02-23,6380
4934,太極,40,0,40,光和,2023-02-23,6380
2610,華航,84,47,37,光和,2023-02-23,6380
0056,元大高股息,49,13,36,光和,2023-02-23,6380
2027,大成鋼,40,5,35,光和,2023-02-23,6380
00728,第一金工業30,33,0,33,光和,2023-02-23,6380
1504,東元,34,1,33,光和,2023-02-23,6380
00715L,期街口布蘭特正2,32,0,32,光和,2023-02-23,6380
00637L,元大滬深300正2,30,0,30,光和,2023-02-23,6380
9136,巨騰-DR,30,0,30,光和,2023-02-23,6380
3037,欣興,35,5,30,光和,2023-02-23,6380
2883,凱基金,31,2,29,光和,2023-02-23,6380
00692,富邦公司治理,25,0,25,光和,2023-02-23,6380
2601,益航,25,0,25,光和,2023-02-23,6380
6547,高端疫苗,25,0,25,光和,2023-02-23,6380
3094,聯傑,25,3,22,光和,2023-02-23,6380
4113,聯上,21,0,21,光和,2023-02-23,6380
3033,威健,20,0,20,光和,2023-02-23,6380
00878,國泰永續高股息,50,31,19,光和,2023-02-23,6380
00642U,期元大S＆P石油,17,0,17,光和,2023-02-23,6380
6167,久正,17,0,17,光和,2023-02-23,6380
2409,友達,36,20,16,光和,2023-02-23,6380
2337,旺宏,17,1,16,光和,2023-02-23,6380
2371,大同,41,25,16,光和,2023-02-23,6380
2748,雲品,27,11,16,光和,2023-02-23,6380
3673,TPK-KY,17,1,16,光和,2023-02-23,6380
2368,金像電,17,2,15,光和,2023-02-23,6380
2641,正德,18,5,13,光和,2023-02-23,6380
6182,合晶,13,0,13,光和,2023-02-23,6380
00712,復華富時不動產,12,0,12,光和,2023-02-23,6380
00679B,元大美債20年,12,0,12,光和,2023-02-23,6380
5258,虹堡,22,10,12,光和,2023-02-23,6380
5905,南仁湖,13,1,12,光和,2023-02-23,6380
8064,東捷,12,0,12,光和,2023-02-23,6380
1701,中化,11,0,11,光和,2023-02-23,6380
2201,裕隆,13,2,11,光和,2023-02-23,6380
2888,新光金,17,6,11,光和,2023-02-23,6380
8150,南茂,11,0,11,光和,2023-02-23,6380
3537,堡達,10,0,10,光和,2023-02-23,6380
1305,華夏,10,0,10,光和,2023-02-23,6380
00665L,富邦�琤肭磪囓�2,20,10,10,光和,2023-02-23,6380
2630,亞航,10,0,10,光和,2023-02-23,6380
5512,力麒,147,11,136,光和,2023-02-24,6380
00637L,元大滬深300正2,131,8,123,光和,2023-02-24,6380
00632R,元大台灣50反1,118,0,118,光和,2023-02-24,6380
00878,國泰永續高股息,96,3,93,光和,2023-02-24,6380
00882,中信中國高股息,50,0,50,光和,2023-02-24,6380
2002,中鋼,42,1,41,光和,2023-02-24,6380
00665L,富邦�琤肭磪囓�2,76,43,33,光和,2023-02-24,6380
2887,台新金,43,10,33,光和,2023-02-24,6380
4440,宜新實業,30,0,30,光和,2023-02-24,6380
00692,富邦公司治理,30,0,30,光和,2023-02-24,6380
3710,連展投控,30,0,30,光和,2023-02-24,6380
00728,第一金工業30,27,0,27,光和,2023-02-24,6380
2701,萬企,27,0,27,光和,2023-02-24,6380
6770,力積電,28,1,27,光和,2023-02-24,6380
0056,元大高股息,26,1,25,光和,2023-02-24,6380
8033,雷虎,33,8,25,光和,2023-02-24,6380
2610,華航,24,0,24,光和,2023-02-24,6380
00680L,元大美債20正2,23,0,23,光和,2023-02-24,6380
1539,巨庭,23,0,23,光和,2023-02-24,6380
00885,富邦越南,22,0,22,光和,2023-02-24,6380
8215,明基材,23,1,22,光和,2023-02-24,6380
1513,中興電,27,6,21,光和,2023-02-24,6380
2371,大同,21,0,21,光和,2023-02-24,6380
6182,合晶,21,0,21,光和,2023-02-24,6380
6494,九齊,21,0,21,光和,2023-02-24,6380
2363,矽統,21,1,20,光和,2023-02-24,6380
6129,普誠,20,0,20,光和,2023-02-24,6380
00738U,期元大道瓊白銀,20,0,20,光和,2023-02-24,6380
3689,湧德,20,0,20,光和,2023-02-24,6380
4541,晟田,20,0,20,光和,2023-02-24,6380
9136,巨騰-DR,20,0,20,光和,2023-02-24,6380
2888,新光金,30,12,18,光和,2023-02-24,6380
3045,台灣大,17,0,17,光和,2023-02-24,6380
00901,永豐智能車供應鏈,15,0,15,光和,2023-02-24,6380
3037,欣興,21,7,14,光和,2023-02-24,6380
1584,精剛,15,2,13,光和,2023-02-24,6380
2618,長榮航,13,0,13,光和,2023-02-24,6380
3346,麗清,13,0,13,光和,2023-02-24,6380
2399,映泰,26,14,12,光和,2023-02-24,6380
2601,益航,25,13,12,光和,2023-02-24,6380
3162,精確,12,0,12,光和,2023-02-24,6380
2208,台船,11,0,11,光和,2023-02-24,6380
2344,華邦電,13,2,11,光和,2023-02-24,6380
2347,聯強,11,0,11,光和,2023-02-24,6380
2353,宏��,11,0,11,光和,2023-02-24,6380
2812,台中銀,11,0,11,光和,2023-02-24,6380
3703,欣陸,17,6,11,光和,2023-02-24,6380
6244,茂迪,11,0,11,光和,2023-02-24,6380
6285,啟��,13,2,11,光和,2023-02-24,6380
1101,台泥,15,4,11,光和,2023-02-24,6380
2888,新光金,77,0,77,光和,2023-03-01,6380
1605,華新,87,13,74,光和,2023-03-01,6380
5512,力麒,60,1,59,光和,2023-03-01,6380
00878,國泰永續高股息,59,0,59,光和,2023-03-01,6380
8936,國統,60,2,58,光和,2023-03-01,6380
2492,華新科,56,0,56,光和,2023-03-01,6380
4939,亞電,53,0,53,光和,2023-03-01,6380
4526,東台,50,0,50,光和,2023-03-01,6380
1314,中石化,42,0,42,光和,2023-03-01,6380
2002,中鋼,45,10,35,光和,2023-03-01,6380
1101,台泥,39,5,34,光和,2023-03-01,6380
6257,矽格,30,0,30,光和,2023-03-01,6380
4114,健喬,29,2,27,光和,2023-03-01,6380
4706,大恭,25,0,25,光和,2023-03-01,6380
3265,台星科,26,2,24,光和,2023-03-01,6380
3033,威健,20,0,20,光和,2023-03-01,6380
1218,泰山,76,56,20,光和,2023-03-01,6380
2618,長榮航,22,2,20,光和,2023-03-01,6380
3017,奇鋐,20,0,20,光和,2023-03-01,6380
4440,宜新實業,20,0,20,光和,2023-03-01,6380
5353,台林,20,0,20,光和,2023-03-01,6380
3706,神達,25,7,18,光和,2023-03-01,6380
6005,群益證,17,0,17,光和,2023-03-01,6380
5443,均豪,15,0,15,光和,2023-03-01,6380
00885,富邦越南,24,9,15,光和,2023-03-01,6380
2387,精元,15,0,15,光和,2023-03-01,6380
4923,力士,15,0,15,光和,2023-03-01,6380
2376,技嘉,14,0,14,光和,2023-03-01,6380
00713,元大台灣高息低波,13,0,13,光和,2023-03-01,6380
2890,永豐金,12,0,12,光和,2023-03-01,6380
3714,富采,11,0,11,光和,2023-03-01,6380
1219,福壽,16,5,11,光和,2023-03-01,6380
3715,定穎投控,11,0,11,光和,2023-03-01,6380
2412,中華電,14,4,10,光和,2023-03-01,6380
00830,國泰費城半導體,10,0,10,光和,2023-03-01,6380
00772B,中信高評級公司債,10,0,10,光和,2023-03-01,6380
1519,華城,13,3,10,光和,2023-03-01,6380
1584,精剛,11,1,10,光和,2023-03-01,6380
1762,中化生,10,0,10,光和,2023-03-01,6380
2034,允強,10,0,10,光和,2023-03-01,6380
2385,群光,10,0,10,光和,2023-03-01,6380
2867,三商壽,10,0,10,光和,2023-03-01,6380
3093,港建*,10,0,10,光和,2023-03-01,6380
3694,海華,10,0,10,光和,2023-03-01,6380
4157,太景*-KY,10,0,10,光和,2023-03-01,6380
4174,浩鼎,10,0,10,光和,2023-03-01,6380
5015,華祺,10,0,10,光和,2023-03-01,6380
6115,鎰勝,10,0,10,光和,2023-03-01,6380
1701,中化,9,0,9,光和,2023-03-01,6380
2337,旺宏,10,1,9,光和,2023-03-01,6380
00665L,富邦�琤肭磪囓�2,200,10,190,光和,2023-03-02,6380
2359,所羅門,109,2,107,光和,2023-03-02,6380
2303,聯電,91,1,90,光和,2023-03-02,6380
00885,富邦越南,70,0,70,光和,2023-03-02,6380
2610,華航,50,0,50,光和,2023-03-02,6380
00712,復華富時不動產,45,0,45,光和,2023-03-02,6380
5452,佶優,44,4,40,光和,2023-03-02,6380
1605,華新,67,38,29,光和,2023-03-02,6380
2430,燦坤,23,0,23,光和,2023-03-02,6380
2834,臺企銀,25,3,22,光和,2023-03-02,6380
2484,希華,22,1,21,光和,2023-03-02,6380
3447,展達,21,0,21,光和,2023-03-02,6380
4744,皇將,21,0,21,光和,2023-03-02,6380
2034,允強,20,0,20,光和,2023-03-02,6380
9136,巨騰-DR,20,0,20,光和,2023-03-02,6380
1714,和桐,20,0,20,光和,2023-03-02,6380
3265,台星科,18,0,18,光和,2023-03-02,6380
2905,三商,17,0,17,光和,2023-03-02,6380
00637L,元大滬深300正2,15,0,15,光和,2023-03-02,6380
2890,永豐金,13,0,13,光和,2023-03-02,6380
00772B,中信高評級公司債,13,0,13,光和,2023-03-02,6380
3027,盛達,28,15,13,光和,2023-03-02,6380
00878,國泰永續高股息,34,21,13,光和,2023-03-02,6380
2481,強茂,11,0,11,光和,2023-03-02,6380
2498,宏達電,16,5,11,光和,2023-03-02,6380
2886,兆豐金,10,0,10,光和,2023-03-02,6380
00893,國泰智能電動車,10,0,10,光和,2023-03-02,6380
1609,大亞,10,0,10,光和,2023-03-02,6380
3035,智原,26,16,10,光和,2023-03-02,6380
5443,均豪,10,0,10,光和,2023-03-02,6380
6116,彩晶,30,20,10,光和,2023-03-02,6380
6213,聯茂,10,0,10,光和,2023-03-02,6380
5508,永信建,9,0,9,光和,2023-03-02,6380
9958,世紀鋼,9,0,9,光和,2023-03-02,6380
3481,群創,26,18,8,光和,2023-03-02,6380
2748,雲品,8,0,8,光和,2023-03-02,6380
9945,潤泰新,8,0,8,光和,2023-03-02,6380
2062,橋椿,7,0,7,光和,2023-03-02,6380
1529,樂事綠能,8,1,7,光和,2023-03-02,6380
3029,零壹,7,0,7,光和,2023-03-02,6380
00679B,元大美債20年,6,0,6,光和,2023-03-02,6380
2611,志信,6,0,6,光和,2023-03-02,6380
2812,台中銀,6,0,6,光和,2023-03-02,6380
3362,先進光,11,5,6,光和,2023-03-02,6380
5512,力麒,6,0,6,光和,2023-03-02,6380
8033,雷虎,9,3,6,光和,2023-03-02,6380
3707,漢磊,6,1,5,光和,2023-03-02,6380
1210,大成,5,0,5,光和,2023-03-02,6380
00773B,中信優先金融債,5,0,5,光和,2023-03-02,6380
00902,中信電池及儲能,5,0,5,光和,2023-03-02,6380
2027,大成鋼,121,8,113,光和,2023-03-03,6380
00632R,元大台灣50反1,57,0,57,光和,2023-03-03,6380
2845,遠東銀,60,5,55,光和,2023-03-03,6380
00885,富邦越南,50,0,50,光和,2023-03-03,6380
8415,大國鋼,46,0,46,光和,2023-03-03,6380
2888,新光金,50,4,46,光和,2023-03-03,6380
5452,佶優,53,11,42,光和,2023-03-03,6380
1906,寶隆,38,0,38,光和,2023-03-03,6380
2801,彰銀,30,0,30,光和,2023-03-03,6380
00712,復華富時不動產,29,0,29,光和,2023-03-03,6380
2023,燁輝,25,1,24,光和,2023-03-03,6380
2834,臺企銀,33,11,22,光和,2023-03-03,6380
5371,中光電,20,0,20,光和,2023-03-03,6380
2498,宏達電,21,1,20,光和,2023-03-03,6380
0056,元大高股息,20,1,19,光和,2023-03-03,6380
1609,大亞,18,1,17,光和,2023-03-03,6380
3443,創意,20,4,16,光和,2023-03-03,6380
4706,大恭,15,0,15,光和,2023-03-03,6380
6188,廣明,15,0,15,光和,2023-03-03,6380
8401,白紗科,15,0,15,光和,2023-03-03,6380
2314,台揚,18,4,14,光和,2023-03-03,6380
2601,益航,14,0,14,光和,2023-03-03,6380
2891,中信金,14,0,14,光和,2023-03-03,6380
6531,愛普*,31,18,13,光和,2023-03-03,6380
2359,所羅門,18,5,13,光和,2023-03-03,6380
6160,欣技,13,0,13,光和,2023-03-03,6380
1514,亞力,12,1,11,光和,2023-03-03,6380
2371,大同,11,0,11,光和,2023-03-03,6380
2388,威盛,19,8,11,光和,2023-03-03,6380
2401,凌陽,14,3,11,光和,2023-03-03,6380
3081,聯亞,11,0,11,光和,2023-03-03,6380
6142,友勁,11,0,11,光和,2023-03-03,6380
00679B,元大美債20年,10,0,10,光和,2023-03-03,6380
3209,全科,10,0,10,光和,2023-03-03,6380
1457,宜進,10,0,10,光和,2023-03-03,6380
2485,兆赫,10,0,10,光和,2023-03-03,6380
2736,富野,10,0,10,光和,2023-03-03,6380
2867,三商壽,10,0,10,光和,2023-03-03,6380
2890,永豐金,10,0,10,光和,2023-03-03,6380
5706,鳳凰,10,0,10,光和,2023-03-03,6380
6235,華孚,16,6,10,光和,2023-03-03,6380
9136,巨騰-DR,10,0,10,光和,2023-03-03,6380
2404,漢唐,10,0,10,光和,2023-03-03,6380
00878,國泰永續高股息,9,0,9,光和,2023-03-03,6380
00720B,元大投資級公司債,9,0,9,光和,2023-03-03,6380
2610,華航,12,3,9,光和,2023-03-03,6380
4566,時碩工業,10,1,9,光和,2023-03-03,6380
1210,大成,8,0,8,光和,2023-03-03,6380
6278,台表科,8,0,8,光和,2023-03-03,6380
1584,精剛,10,2,8,光和,2023-03-03,6380
00632R,元大台灣50反1,142,7,135,光和,2023-03-06,6380
2609,陽明,148,15,133,光和,2023-03-06,6380
2610,華航,106,1,105,光和,2023-03-06,6380
3481,群創,191,128,63,光和,2023-03-06,6380
00637L,元大滬深300正2,51,0,51,光和,2023-03-06,6380
1460,宏遠,50,2,48,光和,2023-03-06,6380
6116,彩晶,62,20,42,光和,2023-03-06,6380
00712,復華富時不動產,41,0,41,光和,2023-03-06,6380
5213,亞昕,40,1,39,光和,2023-03-06,6380
5452,佶優,36,1,35,光和,2023-03-06,6380
2481,強茂,65,31,34,光和,2023-03-06,6380
3047,訊舟,37,3,34,光和,2023-03-06,6380
5443,均豪,30,1,29,光和,2023-03-06,6380
6182,合晶,30,3,27,光和,2023-03-06,6380
1783,和康生,27,1,26,光和,2023-03-06,6380
3390,旭軟,24,0,24,光和,2023-03-06,6380
6153,嘉聯益,21,0,21,光和,2023-03-06,6380
1707,葡萄王,20,0,20,光和,2023-03-06,6380
5608,四維航,34,15,19,光和,2023-03-06,6380
2605,新興,24,6,18,光和,2023-03-06,6380
8085,福華,18,0,18,光和,2023-03-06,6380
2340,台亞,17,0,17,光和,2023-03-06,6380
00673R,期元大S＆P原油反1,16,0,16,光和,2023-03-06,6380
3029,零壹,16,1,15,光和,2023-03-06,6380
6142,友勁,15,0,15,光和,2023-03-06,6380
2002,中鋼,15,1,14,光和,2023-03-06,6380
00753L,中信中國50正2,12,0,12,光和,2023-03-06,6380
4558,寶緯,23,11,12,光和,2023-03-06,6380
6698,旭暉應材,12,0,12,光和,2023-03-06,6380
8289,泰藝,13,1,12,光和,2023-03-06,6380
1605,華新,30,19,11,光和,2023-03-06,6380
2601,益航,23,12,11,光和,2023-03-06,6380
2618,長榮航,11,0,11,光和,2023-03-06,6380
3209,全科,11,0,11,光和,2023-03-06,6380
3706,神達,15,4,11,光和,2023-03-06,6380
4702,中美實,11,0,11,光和,2023-03-06,6380
9945,潤泰新,10,0,10,光和,2023-03-06,6380
1316,上曜,10,0,10,光和,2023-03-06,6380
1444,力麗,20,10,10,光和,2023-03-06,6380
2504,國產,10,0,10,光和,2023-03-06,6380
2892,第一金,10,0,10,光和,2023-03-06,6380
2905,三商,10,0,10,光和,2023-03-06,6380
3052,夆典,10,0,10,光和,2023-03-06,6380
6220,岳豐,10,0,10,光和,2023-03-06,6380
6796,晉弘,10,0,10,光和,2023-03-06,6380
8261,富鼎,10,0,10,光和,2023-03-06,6380
8271,宇瞻,10,0,10,光和,2023-03-06,6380
1604,聲寶,9,0,9,光和,2023-03-06,6380
2337,旺宏,71,62,9,光和,2023-03-06,6380
3265,台星科,9,0,9,光和,2023-03-06,6380
00632R,元大台灣50反1,186,3,183,光和,2023-03-07,6380
00673R,期元大S＆P原油反1,62,0,62,光和,2023-03-07,6380
3481,群創,54,14,40,光和,2023-03-07,6380
2359,所羅門,50,12,38,光和,2023-03-07,6380
2641,正德,41,3,38,光和,2023-03-07,6380
2405,輔信,26,1,25,光和,2023-03-07,6380
3537,堡達,22,0,22,光和,2023-03-07,6380
1529,樂事綠能,23,1,22,光和,2023-03-07,6380
8046,南電,23,2,21,光和,2023-03-07,6380
00830,國泰費城半導體,20,0,20,光和,2023-03-07,6380
00902,中信電池及儲能,20,0,20,光和,2023-03-07,6380
2476,鉅祥,20,0,20,光和,2023-03-07,6380
4952,凌通,20,0,20,光和,2023-03-07,6380
5512,力麒,21,2,19,光和,2023-03-07,6380
9945,潤泰新,21,2,19,光和,2023-03-07,6380
1783,和康生,17,0,17,光和,2023-03-07,6380
2105,正新,17,1,16,光和,2023-03-07,6380
1539,巨庭,15,0,15,光和,2023-03-07,6380
5258,虹堡,14,0,14,光和,2023-03-07,6380
2618,長榮航,17,4,13,光和,2023-03-07,6380
00885,富邦越南,64,51,13,光和,2023-03-07,6380
6517,保勝光學,15,2,13,光和,2023-03-07,6380
9136,巨騰-DR,13,0,13,光和,2023-03-07,6380
2482,連宇,13,1,12,光和,2023-03-07,6380
00637L,元大滬深300正2,13,2,11,光和,2023-03-07,6380
2342,茂矽,11,0,11,光和,2023-03-07,6380
2481,強茂,17,6,11,光和,2023-03-07,6380
2484,希華,20,9,11,光和,2023-03-07,6380
8050,廣積,11,0,11,光和,2023-03-07,6380
1410,南染,10,0,10,光和,2023-03-07,6380
2017,官田鋼,10,0,10,光和,2023-03-07,6380
2399,映泰,10,0,10,光和,2023-03-07,6380
3049,精金,10,0,10,光和,2023-03-07,6380
6156,松上,10,0,10,光和,2023-03-07,6380
6470,宇智,10,0,10,光和,2023-03-07,6380
3105,穩懋,33,24,9,光和,2023-03-07,6380
3535,晶彩科,10,1,9,光和,2023-03-07,6380
6235,華孚,17,8,9,光和,2023-03-07,6380
2303,聯電,9,1,8,光和,2023-03-07,6380
3189,景碩,8,0,8,光和,2023-03-07,6380
00679B,元大美債20年,7,0,7,光和,2023-03-07,6380
1476,儒鴻,8,1,7,光和,2023-03-07,6380
1701,中化,7,0,7,光和,2023-03-07,6380
2337,旺宏,7,0,7,光和,2023-03-07,6380
2388,威盛,14,7,7,光和,2023-03-07,6380
3162,精確,7,0,7,光和,2023-03-07,6380
5536,聖暉*,6,0,6,光和,2023-03-07,6380
6770,力積電,20,14,6,光和,2023-03-07,6380
1101,台泥,6,0,6,光和,2023-03-07,6380
6664,群翊,6,0,6,光和,2023-03-07,6380
00637L,元大滬深300正2,109,10,99,光和,2023-03-08,6380
00665L,富邦�琤肭磪囓�2,95,20,75,光和,2023-03-08,6380
1460,宏遠,71,1,70,光和,2023-03-08,6380
00885,富邦越南,68,0,68,光和,2023-03-08,6380
00712,復華富時不動產,61,0,61,光和,2023-03-08,6380
2609,陽明,68,12,56,光和,2023-03-08,6380
2454,聯發科,53,1,52,光和,2023-03-08,6380
3694,海華,50,0,50,光和,2023-03-08,6380
00632R,元大台灣50反1,52,4,48,光和,2023-03-08,6380
6174,安��,46,0,46,光和,2023-03-08,6380
1701,中化,42,2,40,光和,2023-03-08,6380
2329,華泰,33,0,33,光和,2023-03-08,6380
2888,新光金,44,12,32,光和,2023-03-08,6380
2201,裕隆,30,2,28,光和,2023-03-08,6380
2834,臺企銀,30,2,28,光和,2023-03-08,6380
3481,群創,63,37,26,光和,2023-03-08,6380
2641,正德,28,2,26,光和,2023-03-08,6380
9907,統一實,38,12,26,光和,2023-03-08,6380
00882,中信中國高股息,25,0,25,光和,2023-03-08,6380
1783,和康生,24,0,24,光和,2023-03-08,6380
00878,國泰永續高股息,35,13,22,光和,2023-03-08,6380
3706,神達,22,0,22,光和,2023-03-08,6380
6257,矽格,21,0,21,光和,2023-03-08,6380
1314,中石化,20,0,20,光和,2023-03-08,6380
1504,東元,30,10,20,光和,2023-03-08,6380
3372,典範,20,0,20,光和,2023-03-08,6380
2905,三商,18,0,18,光和,2023-03-08,6380
2886,兆豐金,20,3,17,光和,2023-03-08,6380
1605,華新,34,17,17,光和,2023-03-08,6380
2606,裕民,16,0,16,光和,2023-03-08,6380
1524,耿鼎,24,9,15,光和,2023-03-08,6380
3013,晟銘電,16,1,15,光和,2023-03-08,6380
6235,華孚,28,13,15,光和,2023-03-08,6380
00900,富邦特選高股息30,17,2,15,光和,2023-03-08,6380
6525,捷敏-KY,14,0,14,光和,2023-03-08,6380
1513,中興電,32,19,13,光和,2023-03-08,6380
1432,大魯閣,16,3,13,光和,2023-03-08,6380
2344,華邦電,17,4,13,光和,2023-03-08,6380
6548,長科*,23,10,13,光和,2023-03-08,6380
1102,亞泥,13,0,13,光和,2023-03-08,6380
8171,天宇,12,0,12,光和,2023-03-08,6380
0056,元大高股息,22,10,12,光和,2023-03-08,6380
2882,國泰金,11,0,11,光和,2023-03-08,6380
2884,玉山金,10,0,10,光和,2023-03-08,6380
1410,南染,10,0,10,光和,2023-03-08,6380
00901,永豐智能車供應鏈,10,0,10,光和,2023-03-08,6380
00738U,期元大道瓊白銀,10,0,10,光和,2023-03-08,6380
2337,旺宏,10,0,10,光和,2023-03-08,6380
2607,榮運,10,0,10,光和,2023-03-08,6380
5340,建榮,10,0,10,光和,2023-03-08,6380
2312,金寶,116,11,105,光和,2023-03-09,6380
3481,群創,96,21,75,光和,2023-03-09,6380
4746,台耀,73,0,73,光和,2023-03-09,6380
6266,泰詠,57,0,57,光和,2023-03-09,6380
2609,陽明,75,20,55,光和,2023-03-09,6380
2601,益航,52,0,52,光和,2023-03-09,6380
1701,中化,44,0,44,光和,2023-03-09,6380
2409,友達,49,6,43,光和,2023-03-09,6380
3706,神達,41,0,41,光和,2023-03-09,6380
6116,彩晶,45,10,35,光和,2023-03-09,6380
2905,三商,41,7,34,光和,2023-03-09,6380
3236,千如,30,0,30,光和,2023-03-09,6380
6443,元晶,49,19,30,光和,2023-03-09,6380
2347,聯強,32,5,27,光和,2023-03-09,6380
3209,全科,27,0,27,光和,2023-03-09,6380
1402,遠東新,26,1,25,光和,2023-03-09,6380
1605,華新,35,12,23,光和,2023-03-09,6380
3712,永崴投控,23,0,23,光和,2023-03-09,6380
2888,新光金,22,0,22,光和,2023-03-09,6380
3454,晶睿,23,1,22,光和,2023-03-09,6380
5210,寶碩,22,0,22,光和,2023-03-09,6380
1709,和益,21,0,21,光和,2023-03-09,6380
2353,宏��,39,18,21,光和,2023-03-09,6380
2454,聯發科,20,0,20,光和,2023-03-09,6380
2017,官田鋼,20,0,20,光和,2023-03-09,6380
2547,日勝生,20,0,20,光和,2023-03-09,6380
3308,聯德,20,0,20,光和,2023-03-09,6380
2027,大成鋼,20,1,19,光和,2023-03-09,6380
2413,環科,20,1,19,光和,2023-03-09,6380
00878,國泰永續高股息,25,7,18,光和,2023-03-09,6380
1718,中纖,24,6,18,光和,2023-03-09,6380
8046,南電,48,30,18,光和,2023-03-09,6380
8050,廣積,19,1,18,光和,2023-03-09,6380
3147,大綜,17,0,17,光和,2023-03-09,6380
1514,亞力,16,0,16,光和,2023-03-09,6380
4979,華星光,18,2,16,光和,2023-03-09,6380
2368,金像電,17,1,16,光和,2023-03-09,6380
8215,明基材,16,1,15,光和,2023-03-09,6380
2002,中鋼,15,0,15,光和,2023-03-09,6380
1217,愛之味,20,6,14,光和,2023-03-09,6380
6118,建達,19,5,14,光和,2023-03-09,6380
6005,群益證,13,0,13,光和,2023-03-09,6380
1603,華電,13,0,13,光和,2023-03-09,6380
5512,力麒,13,0,13,光和,2023-03-09,6380
6174,安��,13,0,13,光和,2023-03-09,6380
6257,矽格,15,2,13,光和,2023-03-09,6380
00715L,期街口布蘭特正2,12,0,12,光和,2023-03-09,6380
1513,中興電,24,12,12,光和,2023-03-09,6380
2352,佳世達,12,0,12,光和,2023-03-09,6380
3372,典範,12,0,12,光和,2023-03-09,6380
2312,金寶,140,0,140,光和,2023-03-10,6380
00878,國泰永續高股息,117,5,112,光和,2023-03-10,6380
3372,典範,111,0,111,光和,2023-03-10,6380
2888,新光金,94,0,94,光和,2023-03-10,6380
5309,系統電,78,10,68,光和,2023-03-10,6380
1701,中化,76,14,62,光和,2023-03-10,6380
6005,群益證,62,0,62,光和,2023-03-10,6380
1434,福懋,55,0,55,光和,2023-03-10,6380
2801,彰銀,72,20,52,光和,2023-03-10,6380
00712,復華富時不動產,48,0,48,光和,2023-03-10,6380
2882,國泰金,48,0,48,光和,2023-03-10,6380
2618,長榮航,48,1,47,光和,2023-03-10,6380
6116,彩晶,47,0,47,光和,2023-03-10,6380
2641,正德,62,20,42,光和,2023-03-10,6380
3209,全科,42,0,42,光和,2023-03-10,6380
3576,聯合再生,42,1,41,光和,2023-03-10,6380
00715L,期街口布蘭特正2,39,0,39,光和,2023-03-10,6380
1909,榮成,33,0,33,光和,2023-03-10,6380
2891,中信金,32,0,32,光和,2023-03-10,6380
2317,鴻海,32,2,30,光和,2023-03-10,6380
2344,華邦電,29,1,28,光和,2023-03-10,6380
6509,聚和,28,0,28,光和,2023-03-10,6380
00637L,元大滬深300正2,102,75,27,光和,2023-03-10,6380
2313,華通,26,0,26,光和,2023-03-10,6380
6153,嘉聯益,26,0,26,光和,2023-03-10,6380
1513,中興電,29,3,26,光和,2023-03-10,6380
2883,凱基金,28,3,25,光和,2023-03-10,6380
2330,台積電,25,1,24,光和,2023-03-10,6380
1616,億泰,24,0,24,光和,2023-03-10,6380
2034,允強,24,0,24,光和,2023-03-10,6380
2610,華航,73,50,23,光和,2023-03-10,6380
1605,華新,34,11,23,光和,2023-03-10,6380
2014,中鴻,23,0,23,光和,2023-03-10,6380
1783,和康生,23,1,22,光和,2023-03-10,6380
1708,東鹼,22,1,21,光和,2023-03-10,6380
2736,富野,21,0,21,光和,2023-03-10,6380
00923,群益台ESG低碳50,20,0,20,光和,2023-03-10,6380
1710,東聯,20,0,20,光和,2023-03-10,6380
2401,凌陽,20,0,20,光和,2023-03-10,6380
2515,中工,20,0,20,光和,2023-03-10,6380
2702,華園,20,0,20,光和,2023-03-10,6380
6547,高端疫苗,23,3,20,光和,2023-03-10,6380
1712,興農,20,0,20,光和,2023-03-10,6380
8046,南電,22,3,19,光和,2023-03-10,6380
3013,晟銘電,22,4,18,光和,2023-03-10,6380
3481,群創,65,47,18,光和,2023-03-10,6380
00692,富邦公司治理,17,0,17,光和,2023-03-10,6380
8033,雷虎,27,10,17,光和,2023-03-10,6380
2603,長榮,29,13,16,光和,2023-03-10,6380
5347,世界,16,0,16,光和,2023-03-10,6380
1314,中石化,93,0,93,光和,2023-03-13,6380
3264,欣銓,69,2,67,光和,2023-03-13,6380
00878,國泰永續高股息,71,5,66,光和,2023-03-13,6380
3290,東浦,60,2,58,光和,2023-03-13,6380
4440,宜新實業,50,0,50,光和,2023-03-13,6380
6116,彩晶,45,1,44,光和,2023-03-13,6380
2867,三商壽,40,0,40,光和,2023-03-13,6380
2324,仁寶,40,0,40,光和,2023-03-13,6380
00712,復華富時不動產,35,0,35,光和,2023-03-13,6380
1319,東陽,34,0,34,光和,2023-03-13,6380
5512,力麒,33,0,33,光和,2023-03-13,6380
3029,零壹,34,5,29,光和,2023-03-13,6380
6290,良維,30,2,28,光和,2023-03-13,6380
3481,群創,34,8,26,光和,2023-03-13,6380
00923,群益台ESG低碳50,24,0,24,光和,2023-03-13,6380
00669R,國泰美國道瓊反1,24,0,24,光和,2023-03-13,6380
2457,飛宏,41,17,24,光和,2023-03-13,6380
2610,華航,24,2,22,光和,2023-03-13,6380
6706,惠特,22,0,22,光和,2023-03-13,6380
8050,廣積,27,6,21,光和,2023-03-13,6380
00665L,富邦�琤肭磪囓�2,20,0,20,光和,2023-03-13,6380
5210,寶碩,20,0,20,光和,2023-03-13,6380
1707,葡萄王,20,0,20,光和,2023-03-13,6380
3356,奇偶,20,1,19,光和,2023-03-13,6380
6165,浪凡,19,0,19,光和,2023-03-13,6380
2884,玉山金,17,0,17,光和,2023-03-13,6380
4746,台耀,18,1,17,光和,2023-03-13,6380
2312,金寶,16,0,16,光和,2023-03-13,6380
6227,茂綸,16,0,16,光和,2023-03-13,6380
6235,華孚,24,8,16,光和,2023-03-13,6380
6248,沛波,16,0,16,光和,2023-03-13,6380
2891,中信金,15,0,15,光和,2023-03-13,6380
3265,台星科,15,0,15,光和,2023-03-13,6380
2801,彰銀,14,0,14,光和,2023-03-13,6380
2883,凱基金,13,0,13,光和,2023-03-13,6380
1504,東元,22,10,12,光和,2023-03-13,6380
2340,台亞,12,0,12,光和,2023-03-13,6380
2516,新建,12,0,12,光和,2023-03-13,6380
9136,巨騰-DR,12,0,12,光和,2023-03-13,6380
1101,台泥,12,1,11,光和,2023-03-13,6380
1432,大魯閣,12,1,11,光和,2023-03-13,6380
1519,華城,11,0,11,光和,2023-03-13,6380
3576,聯合再生,11,0,11,光和,2023-03-13,6380
2609,陽明,37,26,11,光和,2023-03-13,6380
00692,富邦公司治理,10,0,10,光和,2023-03-13,6380
8215,明基材,10,0,10,光和,2023-03-13,6380
1301,台塑,10,0,10,光和,2023-03-13,6380
020022,元大電動車N,10,0,10,光和,2023-03-13,6380
1524,耿鼎,22,12,10,光和,2023-03-13,6380
1529,樂事綠能,10,0,10,光和,2023-03-13,6380
2313,華通,104,1,103,光和,2023-03-14,6380
1314,中石化,107,10,97,光和,2023-03-14,6380
2342,茂矽,81,0,81,光和,2023-03-14,6380
00878,國泰永續高股息,85,7,78,光和,2023-03-14,6380
2303,聯電,80,3,77,光和,2023-03-14,6380
2609,陽明,123,58,65,光和,2023-03-14,6380
2615,萬海,56,3,53,光和,2023-03-14,6380
2610,華航,104,51,53,光和,2023-03-14,6380
00885,富邦越南,50,0,50,光和,2023-03-14,6380
4931,新盛力,51,1,50,光和,2023-03-14,6380
2618,長榮航,95,47,48,光和,2023-03-14,6380
2888,新光金,47,3,44,光和,2023-03-14,6380
00715L,期街口布蘭特正2,42,0,42,光和,2023-03-14,6380
2345,智邦,40,0,40,光和,2023-03-14,6380
2515,中工,50,12,38,光和,2023-03-14,6380
00712,復華富時不動產,46,8,38,光和,2023-03-14,6380
2605,新興,39,2,37,光和,2023-03-14,6380
2891,中信金,43,7,36,光和,2023-03-14,6380
00902,中信電池及儲能,32,0,32,光和,2023-03-14,6380
3035,智原,32,3,29,光和,2023-03-14,6380
00637L,元大滬深300正2,28,0,28,光和,2023-03-14,6380
2801,彰銀,27,0,27,光和,2023-03-14,6380
00642U,期元大S＆P石油,24,0,24,光和,2023-03-14,6380
2489,瑞軒,21,0,21,光和,2023-03-14,6380
1909,榮成,20,0,20,光和,2023-03-14,6380
2453,凌群,24,4,20,光和,2023-03-14,6380
3706,神達,20,0,20,光和,2023-03-14,6380
8046,南電,20,0,20,光和,2023-03-14,6380
8050,廣積,20,0,20,光和,2023-03-14,6380
2883,凱基金,21,2,19,光和,2023-03-14,6380
1467,南緯,17,0,17,光和,2023-03-14,6380
2867,三商壽,15,0,15,光和,2023-03-14,6380
2892,第一金,15,0,15,光和,2023-03-14,6380
4958,臻鼎-KY,15,0,15,光和,2023-03-14,6380
8112,至上,15,1,14,光和,2023-03-14,6380
2409,友達,14,0,14,光和,2023-03-14,6380
00830,國泰費城半導體,14,0,14,光和,2023-03-14,6380
2329,華泰,15,1,14,光和,2023-03-14,6380
2516,新建,13,0,13,光和,2023-03-14,6380
2884,玉山金,12,0,12,光和,2023-03-14,6380
5515,建國,12,0,12,光和,2023-03-14,6380
2344,華邦電,13,1,12,光和,2023-03-14,6380
2388,威盛,22,10,12,光和,2023-03-14,6380
6269,台郡,12,0,12,光和,2023-03-14,6380
1605,華新,14,2,12,光和,2023-03-14,6380
6180,橘子,12,1,11,光和,2023-03-14,6380
00893,國泰智能電動車,13,2,11,光和,2023-03-14,6380
2014,中鴻,11,0,11,光和,2023-03-14,6380
8215,明基材,11,0,11,光和,2023-03-14,6380
00671R,富邦NASDAQ反1,10,0,10,光和,2023-03-14,6380
6271,同欣電,250,0,250,光和,2023-03-15,6380
2312,金寶,150,0,150,光和,2023-03-15,6380
3682,亞太電,100,0,100,光和,2023-03-15,6380
5512,力麒,80,1,79,光和,2023-03-15,6380
2603,長榮,67,12,55,光和,2023-03-15,6380
2801,彰銀,52,0,52,光和,2023-03-15,6380
00712,復華富時不動產,50,0,50,光和,2023-03-15,6380
00715L,期街口布蘭特正2,47,0,47,光和,2023-03-15,6380
2630,亞航,46,0,46,光和,2023-03-15,6380
5608,四維航,39,1,38,光和,2023-03-15,6380
2342,茂矽,30,0,30,光和,2023-03-15,6380
2614,東森,30,0,30,光和,2023-03-15,6380
2892,第一金,31,5,26,光和,2023-03-15,6380
00637L,元大滬深300正2,33,8,25,光和,2023-03-15,6380
2888,新光金,39,15,24,光和,2023-03-15,6380
00632R,元大台灣50反1,20,0,20,光和,2023-03-15,6380
2413,環科,18,0,18,光和,2023-03-15,6380
2615,萬海,28,13,15,光和,2023-03-15,6380
1909,榮成,15,0,15,光和,2023-03-15,6380
4915,致伸,16,1,15,光和,2023-03-15,6380
2607,榮運,34,20,14,光和,2023-03-15,6380
2880,華南金,16,2,14,光和,2023-03-15,6380
2609,陽明,57,44,13,光和,2023-03-15,6380
2634,漢翔,16,3,13,光和,2023-03-15,6380
3029,零壹,22,9,13,光和,2023-03-15,6380
3019,亞光,12,0,12,光和,2023-03-15,6380
1432,大魯閣,11,0,11,光和,2023-03-15,6380
1314,中石化,17,6,11,光和,2023-03-15,6380
2352,佳世達,11,0,11,光和,2023-03-15,6380
8936,國統,28,17,11,光和,2023-03-15,6380
1219,福壽,10,0,10,光和,2023-03-15,6380
00642U,期元大S＆P石油,10,0,10,光和,2023-03-15,6380
2104,國際中橡,10,0,10,光和,2023-03-15,6380
2472,立隆電,10,0,10,光和,2023-03-15,6380
3356,奇偶,10,0,10,光和,2023-03-15,6380
3501,維熹,10,0,10,光和,2023-03-15,6380
3706,神達,10,0,10,光和,2023-03-15,6380
4123,晟德,10,0,10,光和,2023-03-15,6380
4958,臻鼎-KY,10,0,10,光和,2023-03-15,6380
6227,茂綸,10,0,10,光和,2023-03-15,6380
2327,國巨,9,0,9,光和,2023-03-15,6380
2891,中信金,8,0,8,光和,2023-03-15,6380
0056,元大高股息,8,0,8,光和,2023-03-15,6380
2017,官田鋼,8,0,8,光和,2023-03-15,6380
2105,正新,8,0,8,光和,2023-03-15,6380
9103,美德醫療-DR,8,0,8,光和,2023-03-15,6380
2542,興富發,8,0,8,光和,2023-03-15,6380
3128,昇銳,7,0,7,光和,2023-03-15,6380
1504,東元,9,3,6,光和,2023-03-15,6380
4923,力士,6,0,6,光和,2023-03-15,6380
3056,富華新,132,22,110,光和,2023-03-16,6380
2801,彰銀,68,0,68,光和,2023-03-16,6380
00878,國泰永續高股息,65,2,63,光和,2023-03-16,6380
2891,中信金,61,3,58,光和,2023-03-16,6380
00715L,期街口布蘭特正2,98,47,51,光和,2023-03-16,6380
2845,遠東銀,46,0,46,光和,2023-03-16,6380
2402,毅嘉,45,0,45,光和,2023-03-16,6380
2884,玉山金,44,0,44,光和,2023-03-16,6380
2603,長榮,78,38,40,光和,2023-03-16,6380
2313,華通,40,0,40,光和,2023-03-16,6380
5608,四維航,34,0,34,光和,2023-03-16,6380
3231,緯創,43,10,33,光和,2023-03-16,6380
2610,華航,34,4,30,光和,2023-03-16,6380
1101,台泥,29,0,29,光和,2023-03-16,6380
2888,新光金,63,35,28,光和,2023-03-16,6380
2883,凱基金,33,6,27,光和,2023-03-16,6380
2834,臺企銀,221,194,27,光和,2023-03-16,6380
3058,立德,25,0,25,光和,2023-03-16,6380
4123,晟德,23,0,23,光和,2023-03-16,6380
8933,愛地雅,22,0,22,光和,2023-03-16,6380
2302,麗正,21,0,21,光和,2023-03-16,6380
2515,中工,30,10,20,光和,2023-03-16,6380
3093,港建*,20,0,20,光和,2023-03-16,6380
6153,嘉聯益,20,0,20,光和,2023-03-16,6380
2885,元大金,24,6,18,光和,2023-03-16,6380
2609,陽明,48,31,17,光和,2023-03-16,6380
6167,久正,17,0,17,光和,2023-03-16,6380
2615,萬海,31,15,16,光和,2023-03-16,6380
2344,華邦電,26,10,16,光和,2023-03-16,6380
5512,力麒,16,0,16,光和,2023-03-16,6380
6443,元晶,22,6,16,光和,2023-03-16,6380
1337,再生-KY,15,0,15,光和,2023-03-16,6380
2880,華南金,16,1,15,光和,2023-03-16,6380
2882,國泰金,19,4,15,光和,2023-03-16,6380
00713,元大台灣高息低波,14,0,14,光和,2023-03-16,6380
00692,富邦公司治理,14,0,14,光和,2023-03-16,6380
1611,中電,30,16,14,光和,2023-03-16,6380
2105,正新,14,0,14,光和,2023-03-16,6380
2812,台中銀,13,0,13,光和,2023-03-16,6380
2034,允強,14,1,13,光和,2023-03-16,6380
1701,中化,13,0,13,光和,2023-03-16,6380
1710,東聯,13,0,13,光和,2023-03-16,6380
9103,美德醫療-DR,13,0,13,光和,2023-03-16,6380
00642U,期元大S＆P石油,12,0,12,光和,2023-03-16,6380
1504,東元,14,2,12,光和,2023-03-16,6380
2892,第一金,14,3,11,光和,2023-03-16,6380
2363,矽統,11,0,11,光和,2023-03-16,6380
00795B,中信美國公債20年,11,0,11,光和,2023-03-16,6380
1708,東鹼,15,4,11,光和,2023-03-16,6380
2017,官田鋼,11,0,11,光和,2023-03-16,6380
2618,長榮航,170,7,163,光和,2023-03-17,6380
2324,仁寶,105,1,104,光和,2023-03-17,6380
00632R,元大台灣50反1,120,30,90,光和,2023-03-17,6380
9904,寶成,59,0,59,光和,2023-03-17,6380
6643,M31,61,5,56,光和,2023-03-17,6380
2867,三商壽,37,0,37,光和,2023-03-17,6380
2891,中信金,32,2,30,光和,2023-03-17,6380
3491,昇達科,31,2,29,光和,2023-03-17,6380
2610,華航,28,2,26,光和,2023-03-17,6380
2812,台中銀,24,1,23,光和,2023-03-17,6380
2034,允強,23,1,22,光和,2023-03-17,6380
2453,凌群,23,1,22,光和,2023-03-17,6380
1504,東元,31,11,20,光和,2023-03-17,6380
6164,華興,20,0,20,光和,2023-03-17,6380
2888,新光金,21,4,17,光和,2023-03-17,6380
9945,潤泰新,27,10,17,光和,2023-03-17,6380
3093,港建*,20,3,17,光和,2023-03-17,6380
00878,國泰永續高股息,16,0,16,光和,2023-03-17,6380
00735,國泰臺韓科技,15,0,15,光和,2023-03-17,6380
3592,瑞鼎,13,0,13,光和,2023-03-17,6380
3209,全科,13,0,13,光和,2023-03-17,6380
00642U,期元大S＆P石油,12,0,12,光和,2023-03-17,6380
1783,和康生,12,0,12,光和,2023-03-17,6380
2851,中再保,12,0,12,光和,2023-03-17,6380
3706,神達,12,0,12,光和,2023-03-17,6380
00737,國泰AI+Robo,11,0,11,光和,2023-03-17,6380
1513,中興電,16,5,11,光和,2023-03-17,6380
2601,益航,11,0,11,光和,2023-03-17,6380
4763,材料-KY,12,1,11,光和,2023-03-17,6380
4952,凌通,10,0,10,光和,2023-03-17,6380
1410,南染,10,0,10,光和,2023-03-17,6380
1514,亞力,11,1,10,光和,2023-03-17,6380
1609,大亞,10,0,10,光和,2023-03-17,6380
1708,東鹼,10,0,10,光和,2023-03-17,6380
2023,燁輝,10,0,10,光和,2023-03-17,6380
2476,鉅祥,10,0,10,光和,2023-03-17,6380
6625,必應,10,0,10,光和,2023-03-17,6380
6841,長佳智能,10,0,10,光和,2023-03-17,6380
8433,弘帆,10,0,10,光和,2023-03-17,6380
2892,第一金,10,1,9,光和,2023-03-17,6380
2887,台新金,9,0,9,光和,2023-03-17,6380
2883,凱基金,14,5,9,光和,2023-03-17,6380
2027,大成鋼,10,1,9,光和,2023-03-17,6380
6125,廣運,8,0,8,光和,2023-03-17,6380
2609,陽明,12,4,8,光和,2023-03-17,6380
4974,亞泰,7,0,7,光和,2023-03-17,6380
8215,明基材,6,0,6,光和,2023-03-17,6380
1522,堤維西,18,12,6,光和,2023-03-17,6380
2347,聯強,6,0,6,光和,2023-03-17,6380
2367,燿華,6,0,6,光和,2023-03-17,6380
00637L,元大滬深300正2,125,30,95,光和,2023-03-20,6380
3093,港建*,85,0,85,光和,2023-03-20,6380
2801,彰銀,81,0,81,光和,2023-03-20,6380
00885,富邦越南,70,0,70,光和,2023-03-20,6380
2888,新光金,66,0,66,光和,2023-03-20,6380
00878,國泰永續高股息,61,1,60,光和,2023-03-20,6380
00715L,期街口布蘭特正2,66,9,57,光和,2023-03-20,6380
2891,中信金,50,8,42,光和,2023-03-20,6380
00720B,元大投資級公司債,40,0,40,光和,2023-03-20,6380
1101,台泥,40,0,40,光和,2023-03-20,6380
1907,永豐餘,36,0,36,光和,2023-03-20,6380
2406,國碩,33,1,32,光和,2023-03-20,6380
1218,泰山,50,20,30,光和,2023-03-20,6380
2882,國泰金,26,1,25,光和,2023-03-20,6380
2892,第一金,25,0,25,光和,2023-03-20,6380
3432,台端,21,0,21,光和,2023-03-20,6380
8112,至上,22,3,19,光和,2023-03-20,6380
8171,天宇,20,2,18,光和,2023-03-20,6380
00902,中信電池及儲能,16,0,16,光和,2023-03-20,6380
3231,緯創,22,8,14,光和,2023-03-20,6380
2603,長榮,14,2,12,光和,2023-03-20,6380
00650L,復華香港正2,11,0,11,光和,2023-03-20,6380
2481,強茂,16,5,11,光和,2023-03-20,6380
2867,三商壽,11,0,11,光和,2023-03-20,6380
4931,新盛力,12,1,11,光和,2023-03-20,6380
3033,威健,10,0,10,光和,2023-03-20,6380
1535,中宇,10,0,10,光和,2023-03-20,6380
6841,長佳智能,10,0,10,光和,2023-03-20,6380
0056,元大高股息,10,1,9,光和,2023-03-20,6380
2834,臺企銀,11,2,9,光和,2023-03-20,6380
1519,華城,19,10,9,光和,2023-03-20,6380
3028,增你強,8,0,8,光和,2023-03-20,6380
1609,大亞,12,4,8,光和,2023-03-20,6380
2605,新興,8,0,8,光和,2023-03-20,6380
3535,晶彩科,8,0,8,光和,2023-03-20,6380
8114,振樺電,8,0,8,光和,2023-03-20,6380
1316,上曜,15,8,7,光和,2023-03-20,6380
1410,南染,7,0,7,光和,2023-03-20,6380
2610,華航,10,3,7,光和,2023-03-20,6380
3704,合勤控,8,1,7,光和,2023-03-20,6380
9136,巨騰-DR,7,0,7,光和,2023-03-20,6380
3056,富華新,14,7,7,光和,2023-03-20,6380
00900,富邦特選高股息30,6,0,6,光和,2023-03-20,6380
1531,高林股,6,0,6,光和,2023-03-20,6380
1605,華新,18,12,6,光和,2023-03-20,6380
2105,正新,6,0,6,光和,2023-03-20,6380
2884,玉山金,7,1,6,光和,2023-03-20,6380
6244,茂迪,20,14,6,光和,2023-03-20,6380
6443,元晶,31,25,6,光和,2023-03-20,6380
9907,統一實,6,0,6,光和,2023-03-20,6380
3029,零壹,101,2,99,光和,2023-03-21,6380
3481,群創,102,11,91,光和,2023-03-21,6380
6160,欣技,70,0,70,光和,2023-03-21,6380
00885,富邦越南,68,0,68,光和,2023-03-21,6380
1519,華城,75,9,66,光和,2023-03-21,6380
00878,國泰永續高股息,54,6,48,光和,2023-03-21,6380
8033,雷虎,38,1,37,光和,2023-03-21,6380
9904,寶成,26,0,26,光和,2023-03-21,6380
2603,長榮,25,1,24,光和,2023-03-21,6380
8155,博智,24,0,24,光和,2023-03-21,6380
5608,四維航,23,0,23,光和,2023-03-21,6380
6116,彩晶,23,1,22,光和,2023-03-21,6380
6140,訊達,24,3,21,光和,2023-03-21,6380
3056,富華新,23,3,20,光和,2023-03-21,6380
3624,光頡,31,11,20,光和,2023-03-21,6380
6163,華電網,21,1,20,光和,2023-03-21,6380
8059,凱碩,20,0,20,光和,2023-03-21,6380
9945,潤泰新,21,1,20,光和,2023-03-21,6380
2455,全新,20,1,19,光和,2023-03-21,6380
1101,台泥,19,0,19,光和,2023-03-21,6380
00632R,元大台灣50反1,16,0,16,光和,2023-03-21,6380
00665L,富邦�琤肭磪囓�2,35,20,15,光和,2023-03-21,6380
1410,南染,14,0,14,光和,2023-03-21,6380
2353,宏��,22,8,14,光和,2023-03-21,6380
6274,台燿,18,4,14,光和,2023-03-21,6380
2609,陽明,17,4,13,光和,2023-03-21,6380
2890,永豐金,13,0,13,光和,2023-03-21,6380
1605,華新,18,5,13,光和,2023-03-21,6380
2739,寒舍,13,0,13,光和,2023-03-21,6380
6243,迅杰,12,0,12,光和,2023-03-21,6380
3036,文曄,11,0,11,光和,2023-03-21,6380
1718,中纖,10,0,10,光和,2023-03-21,6380
00689R,國泰20年美債反1,10,0,10,光和,2023-03-21,6380
00882,中信中國高股息,10,0,10,光和,2023-03-21,6380
3028,增你強,10,0,10,光和,2023-03-21,6380
3093,港建*,20,10,10,光和,2023-03-21,6380
6115,鎰勝,10,0,10,光和,2023-03-21,6380
6443,元晶,28,18,10,光和,2023-03-21,6380
8050,廣積,10,0,10,光和,2023-03-21,6380
6235,華孚,17,7,10,光和,2023-03-21,6380
2882,國泰金,9,0,9,光和,2023-03-21,6380
1402,遠東新,9,0,9,光和,2023-03-21,6380
3058,立德,14,5,9,光和,2023-03-21,6380
6015,宏遠證,9,0,9,光和,2023-03-21,6380
8176,智捷,9,0,9,光和,2023-03-21,6380
2105,正新,8,0,8,光和,2023-03-21,6380
2402,毅嘉,13,5,8,光和,2023-03-21,6380
2881,富邦金,8,0,8,光和,2023-03-21,6380
3432,台端,10,2,8,光和,2023-03-21,6380
5328,華容,8,0,8,光和,2023-03-21,6380
6282,康舒,144,23,121,光和,2023-03-22,6380
00632R,元大台灣50反1,203,101,102,光和,2023-03-22,6380
2883B,凱基金乙特,100,0,100,光和,2023-03-22,6380
3272,東碩,51,0,51,光和,2023-03-22,6380
8033,雷虎,52,9,43,光和,2023-03-22,6380
6164,華興,40,0,40,光和,2023-03-22,6380
3715,定穎投控,39,0,39,光和,2023-03-22,6380
6120,達運,36,0,36,光和,2023-03-22,6380
8105,凌巨,32,0,32,光和,2023-03-22,6380
2457,飛宏,66,35,31,光和,2023-03-22,6380
00712,復華富時不動產,30,0,30,光和,2023-03-22,6380
4157,太景*-KY,24,0,24,光和,2023-03-22,6380
1432,大魯閣,24,1,23,光和,2023-03-22,6380
2230,泰茂,23,2,21,光和,2023-03-22,6380
6788,華景電,21,0,21,光和,2023-03-22,6380
3029,零壹,22,2,20,光和,2023-03-22,6380
3265,台星科,20,0,20,光和,2023-03-22,6380
1605,華新,20,1,19,光和,2023-03-22,6380
3013,晟銘電,30,11,19,光和,2023-03-22,6380
00878,國泰永續高股息,24,6,18,光和,2023-03-22,6380
5351,鈺創,20,3,17,光和,2023-03-22,6380
6576,逸達,16,0,16,光和,2023-03-22,6380
1909,榮成,16,0,16,光和,2023-03-22,6380
1513,中興電,19,4,15,光和,2023-03-22,6380
2369,菱生,15,0,15,光和,2023-03-22,6380
2605,新興,25,10,15,光和,2023-03-22,6380
2882,國泰金,14,0,14,光和,2023-03-22,6380
3576,聯合再生,14,0,14,光和,2023-03-22,6380
9945,潤泰新,14,0,14,光和,2023-03-22,6380
1522,堤維西,14,1,13,光和,2023-03-22,6380
2617,台航,13,0,13,光和,2023-03-22,6380
2485,兆赫,13,1,12,光和,2023-03-22,6380
5258,虹堡,12,1,11,光和,2023-03-22,6380
2495,普安,32,21,11,光和,2023-03-22,6380
3056,富華新,13,2,11,光和,2023-03-22,6380
6140,訊達,21,10,11,光和,2023-03-22,6380
1504,東元,21,11,10,光和,2023-03-22,6380
1560,中砂,17,7,10,光和,2023-03-22,6380
2614,東森,10,0,10,光和,2023-03-22,6380
3406,玉晶光,10,0,10,光和,2023-03-22,6380
4746,台耀,10,0,10,光和,2023-03-22,6380
6205,詮欣,10,0,10,光和,2023-03-22,6380
8049,晶采,10,0,10,光和,2023-03-22,6380
2027,大成鋼,10,1,9,光和,2023-03-22,6380
1603,華電,11,2,9,光和,2023-03-22,6380
2388,威盛,11,2,9,光和,2023-03-22,6380
2883,凱基金,10,1,9,光和,2023-03-22,6380
1609,大亞,20,12,8,光和,2023-03-22,6380
6125,廣運,10,2,8,光和,2023-03-22,6380
8409,商之器,8,0,8,光和,2023-03-22,6380
00632R,元大台灣50反1,505,0,505,光和,2023-03-23,6380
3260,威剛,406,7,399,光和,2023-03-23,6380
6510,精測,50,0,50,光和,2023-03-23,6380
8033,雷虎,50,7,43,光和,2023-03-23,6380
8155,博智,40,1,39,光和,2023-03-23,6380
5608,四維航,31,0,31,光和,2023-03-23,6380
00712,復華富時不動產,30,0,30,光和,2023-03-23,6380
3025,星通,28,0,28,光和,2023-03-23,6380
4979,華星光,27,2,25,光和,2023-03-23,6380
8099,大世科,20,0,20,光和,2023-03-23,6380
6290,良維,19,0,19,光和,2023-03-23,6380
2302,麗正,20,2,18,光和,2023-03-23,6380
1909,榮成,19,1,18,光和,2023-03-23,6380
00665L,富邦�琤肭磪囓�2,20,5,15,光和,2023-03-23,6380
2606,裕民,15,0,15,光和,2023-03-23,6380
6733,博晟生醫,16,1,15,光和,2023-03-23,6380
2405,輔信,14,0,14,光和,2023-03-23,6380
2617,台航,17,3,14,光和,2023-03-23,6380
8215,明基材,14,0,14,光和,2023-03-23,6380
2062,橋椿,12,0,12,光和,2023-03-23,6380
6120,達運,12,0,12,光和,2023-03-23,6380
6589,台康生技,12,0,12,光和,2023-03-23,6380
2603,長榮,24,12,12,光和,2023-03-23,6380
2605,新興,11,0,11,光和,2023-03-23,6380
4934,太極,11,0,11,光和,2023-03-23,6380
2801,彰銀,10,0,10,光和,2023-03-23,6380
3577,泓格,10,0,10,光和,2023-03-23,6380
5425,台半,17,7,10,光和,2023-03-23,6380
6026,福邦證,10,0,10,光和,2023-03-23,6380
6156,松上,10,0,10,光和,2023-03-23,6380
00713,元大台灣高息低波,10,1,9,光和,2023-03-23,6380
1442,名軒,10,1,9,光和,2023-03-23,6380
2455,全新,10,1,9,光和,2023-03-23,6380
2731,雄獅,10,1,9,光和,2023-03-23,6380
2204,中華,7,0,7,光和,2023-03-23,6380
1529,樂事綠能,12,5,7,光和,2023-03-23,6380
00751B,元大AAA至A公司債,7,0,7,光和,2023-03-23,6380
1102,亞泥,7,0,7,光和,2023-03-23,6380
2313,華通,8,1,7,光和,2023-03-23,6380
1513,中興電,12,6,6,光和,2023-03-23,6380
2903,遠百,6,0,6,光和,2023-03-23,6380
3013,晟銘電,13,7,6,光和,2023-03-23,6380
3322,建舜電,15,9,6,光和,2023-03-23,6380
3545,敦泰,6,0,6,光和,2023-03-23,6380
3706,神達,6,0,6,光和,2023-03-23,6380
3713,新晶投控,6,0,6,光和,2023-03-23,6380
5203,訊連,7,1,6,光和,2023-03-23,6380
6202,盛群,6,0,6,光和,2023-03-23,6380
6282,康舒,7,1,6,光和,2023-03-23,6380
3093,港建*,5,0,5,光和,2023-03-23,6380
6143,振曜,705,0,705,光和,2023-03-24,6380
00632R,元大台灣50反1,542,320,222,光和,2023-03-24,6380
6282,康舒,104,2,102,光和,2023-03-24,6380
5475,德宏,101,1,100,光和,2023-03-24,6380
3715,定穎投控,81,6,75,光和,2023-03-24,6380
3260,威剛,75,8,67,光和,2023-03-24,6380
00637L,元大滬深300正2,53,1,52,光和,2023-03-24,6380
9904,寶成,27,0,27,光和,2023-03-24,6380
00712,復華富時不動產,22,0,22,光和,2023-03-24,6380
3231,緯創,28,7,21,光和,2023-03-24,6380
2329,華泰,21,1,20,光和,2023-03-24,6380
2401,凌陽,20,0,20,光和,2023-03-24,6380
2618,長榮航,23,3,20,光和,2023-03-24,6380
3029,零壹,21,2,19,光和,2023-03-24,6380
2404,漢唐,19,0,19,光和,2023-03-24,6380
8088,品安,19,1,18,光和,2023-03-24,6380
2367,燿華,15,0,15,光和,2023-03-24,6380
2457,飛宏,32,17,15,光和,2023-03-24,6380
6417,韋僑,25,10,15,光和,2023-03-24,6380
6770,力積電,16,1,15,光和,2023-03-24,6380
3013,晟銘電,46,33,13,光和,2023-03-24,6380
6026,福邦證,13,0,13,光和,2023-03-24,6380
6245,立端,15,2,13,光和,2023-03-24,6380
6188,廣明,14,2,12,光和,2023-03-24,6380
6485,點序,13,1,12,光和,2023-03-24,6380
2312,金寶,11,0,11,光和,2023-03-24,6380
2351,順德,16,5,11,光和,2023-03-24,6380
4979,華星光,12,1,11,光和,2023-03-24,6380
6443,元晶,17,6,11,光和,2023-03-24,6380
1718,中纖,10,0,10,光和,2023-03-24,6380
00885,富邦越南,10,0,10,光和,2023-03-24,6380
1524,耿鼎,10,0,10,光和,2023-03-24,6380
2206,三陽工業,10,0,10,光和,2023-03-24,6380
2393,億光,10,0,10,光和,2023-03-24,6380
2493,揚博,10,0,10,光和,2023-03-24,6380
3322,建舜電,10,0,10,光和,2023-03-24,6380
3441,聯一光,17,7,10,光和,2023-03-24,6380
3481,群創,12,2,10,光和,2023-03-24,6380
5353,台林,10,0,10,光和,2023-03-24,6380
5512,力麒,10,0,10,光和,2023-03-24,6380
9933,中鼎,10,0,10,光和,2023-03-24,6380
1101,台泥,11,2,9,光和,2023-03-24,6380
2331,精英,19,10,9,光和,2023-03-24,6380
2881,富邦金,9,0,9,光和,2023-03-24,6380
1215,卜蜂,8,0,8,光和,2023-03-24,6380
2324,仁寶,8,0,8,光和,2023-03-24,6380
2609,陽明,9,1,8,光和,2023-03-24,6380
2615,萬海,12,4,8,光和,2023-03-24,6380
4114,健喬,10,2,8,光和,2023-03-24,6380
8222,寶一,21,13,8,光和,2023-03-24,6380
00665L,富邦�琤肭磪囓�2,168,15,153,光和,2023-03-27,6380
3576,聯合再生,78,5,73,光和,2023-03-27,6380
00772B,中信高評級公司債,70,0,70,光和,2023-03-27,6380
00773B,中信優先金融債,50,0,50,光和,2023-03-27,6380
2317,鴻海,52,3,49,光和,2023-03-27,6380
4979,華星光,58,12,46,光和,2023-03-27,6380
2867,三商壽,41,0,41,光和,2023-03-27,6380
1605,華新,48,8,40,光和,2023-03-27,6380
2105,正新,54,22,32,光和,2023-03-27,6380
00882,中信中國高股息,30,0,30,光和,2023-03-27,6380
1611,中電,26,0,26,光和,2023-03-27,6380
2453,凌群,28,4,24,光和,2023-03-27,6380
1609,大亞,39,15,24,光和,2023-03-27,6380
00637L,元大滬深300正2,31,10,21,光和,2023-03-27,6380
1531,高林股,20,0,20,光和,2023-03-27,6380
3049,精金,20,0,20,光和,2023-03-27,6380
3479,安勤,21,1,20,光和,2023-03-27,6380
4157,太景*-KY,20,0,20,光和,2023-03-27,6380
6164,華興,40,20,20,光和,2023-03-27,6380
3706,神達,33,13,20,光和,2023-03-27,6380
4128,中天,18,0,18,光和,2023-03-27,6380
5203,訊連,19,1,18,光和,2023-03-27,6380
1529,樂事綠能,37,20,17,光和,2023-03-27,6380
2014,中鴻,17,0,17,光和,2023-03-27,6380
2302,麗正,23,7,16,光和,2023-03-27,6380
2371,大同,16,0,16,光和,2023-03-27,6380
3189,景碩,15,0,15,光和,2023-03-27,6380
2409,友達,12,0,12,光和,2023-03-27,6380
1612,宏泰,12,0,12,光和,2023-03-27,6380
4706,大恭,12,0,12,光和,2023-03-27,6380
2634,漢翔,22,10,12,光和,2023-03-27,6380
6133,金橋,11,0,11,光和,2023-03-27,6380
2347,聯強,10,0,10,光和,2023-03-27,6380
2880,華南金,10,0,10,光和,2023-03-27,6380
4106,雃博,10,0,10,光和,2023-03-27,6380
4532,瑞智,10,0,10,光和,2023-03-27,6380
6609,瀧澤科,10,0,10,光和,2023-03-27,6380
6142,友勁,12,3,9,光和,2023-03-27,6380
00753L,中信中國50正2,9,0,9,光和,2023-03-27,6380
2413,環科,10,1,9,光和,2023-03-27,6380
2610,華航,10,1,9,光和,2023-03-27,6380
3013,晟銘電,13,4,9,光和,2023-03-27,6380
6606,建德工業,10,1,9,光和,2023-03-27,6380
2892,第一金,10,1,9,光和,2023-03-27,6380
2208,台船,20,12,8,光和,2023-03-27,6380
3056,富華新,15,7,8,光和,2023-03-27,6380
1432,大魯閣,9,2,7,光和,2023-03-27,6380
2314,台揚,7,0,7,光和,2023-03-27,6380
2332,友訊,12,5,7,光和,2023-03-27,6380
2402,毅嘉,59,52,7,光和,2023-03-27,6380
5475,德宏,202,6,196,光和,2023-03-28,6380
8050,廣積,91,8,83,光和,2023-03-28,6380
5353,台林,81,1,80,光和,2023-03-28,6380
2883B,凱基金乙特,65,0,65,光和,2023-03-28,6380
00772B,中信高評級公司債,54,0,54,光和,2023-03-28,6380
00773B,中信優先金融債,54,0,54,光和,2023-03-28,6380
6176,瑞儀,45,1,44,光和,2023-03-28,6380
0056,元大高股息,33,0,33,光和,2023-03-28,6380
1605,華新,50,18,32,光和,2023-03-28,6380
2342,茂矽,37,5,32,光和,2023-03-28,6380
00878,國泰永續高股息,52,22,30,光和,2023-03-28,6380
8046,南電,32,6,26,光和,2023-03-28,6380
6770,力積電,24,0,24,光和,2023-03-28,6380
00728,第一金工業30,23,0,23,光和,2023-03-28,6380
2002,中鋼,22,0,22,光和,2023-03-28,6380
2329,華泰,21,0,21,光和,2023-03-28,6380
4976,佳凌,21,0,21,光和,2023-03-28,6380
00692,富邦公司治理,18,0,18,光和,2023-03-28,6380
3481,群創,22,4,18,光和,2023-03-28,6380
1101,台泥,19,2,17,光和,2023-03-28,6380
2609,陽明,21,4,17,光和,2023-03-28,6380
6182,合晶,22,5,17,光和,2023-03-28,6380
6733,博晟生醫,17,0,17,光和,2023-03-28,6380
1529,樂事綠能,16,1,15,光和,2023-03-28,6380
2105,正新,16,1,15,光和,2023-03-28,6380
2834,臺企銀,30,15,15,光和,2023-03-28,6380
4903,聯光通,15,0,15,光和,2023-03-28,6380
3272,東碩,16,2,14,光和,2023-03-28,6380
6168,宏齊,18,4,14,光和,2023-03-28,6380
6197,佳必琪,14,0,14,光和,2023-03-28,6380
1410,南染,13,0,13,光和,2023-03-28,6380
00882,中信中國高股息,12,0,12,光和,2023-03-28,6380
00922,國泰台灣領袖50,13,2,11,光和,2023-03-28,6380
6244,茂迪,13,2,11,光和,2023-03-28,6380
3037,欣興,33,23,10,光和,2023-03-28,6380
00900,富邦特選高股息30,10,0,10,光和,2023-03-28,6380
5425,台半,11,1,10,光和,2023-03-28,6380
00923,群益台ESG低碳50,10,0,10,光和,2023-03-28,6380
2547,日勝生,10,0,10,光和,2023-03-28,6380
2610,華航,32,22,10,光和,2023-03-28,6380
2731,雄獅,13,3,10,光和,2023-03-28,6380
3209,全科,10,0,10,光和,2023-03-28,6380
5351,鈺創,10,0,10,光和,2023-03-28,6380
8409,商之器,15,5,10,光和,2023-03-28,6380
911608,明輝-DR,10,0,10,光和,2023-03-28,6380
2388,威盛,48,39,9,光和,2023-03-28,6380
00679B,元大美債20年,9,0,9,光和,2023-03-28,6380
3047,訊舟,10,2,8,光和,2023-03-28,6380
6129,普誠,18,10,8,光和,2023-03-28,6380
2302,麗正,8,0,8,光和,2023-03-28,6380
3703,欣陸,101,0,101,光和,2023-03-29,6380
3272,東碩,107,14,93,光和,2023-03-29,6380
5512,力麒,90,3,87,光和,2023-03-29,6380
2371,大同,97,14,83,光和,2023-03-29,6380
1609,大亞,41,11,30,光和,2023-03-29,6380
2323,中環,30,0,30,光和,2023-03-29,6380
1718,中纖,25,0,25,光和,2023-03-29,6380
00669R,國泰美國道瓊反1,24,0,24,光和,2023-03-29,6380
5347,世界,24,0,24,光和,2023-03-29,6380
00713,元大台灣高息低波,21,0,21,光和,2023-03-29,6380
00772B,中信高評級公司債,20,0,20,光和,2023-03-29,6380
3607,谷崧,20,0,20,光和,2023-03-29,6380
2867,三商壽,20,1,19,光和,2023-03-29,6380
2388,威盛,18,0,18,光和,2023-03-29,6380
1101,台泥,18,1,17,光和,2023-03-29,6380
2453,凌群,22,5,17,光和,2023-03-29,6380
2460,建通,15,0,15,光和,2023-03-29,6380
2609,陽明,18,3,15,光和,2023-03-29,6380
3705,永信,15,1,14,光和,2023-03-29,6380
00900,富邦特選高股息30,14,0,14,光和,2023-03-29,6380
2481,強茂,20,6,14,光和,2023-03-29,6380
3447,展達,15,1,14,光和,2023-03-29,6380
2332,友訊,13,0,13,光和,2023-03-29,6380
1605,華新,23,10,13,光和,2023-03-29,6380
3062,建漢,14,1,13,光和,2023-03-29,6380
2883,凱基金,20,7,13,光和,2023-03-29,6380
3706,神達,12,0,12,光和,2023-03-29,6380
00922,國泰台灣領袖50,11,0,11,光和,2023-03-29,6380
2340,台亞,11,0,11,光和,2023-03-29,6380
3189,景碩,11,0,11,光和,2023-03-29,6380
4128,中天,11,0,11,光和,2023-03-29,6380
9945,潤泰新,11,0,11,光和,2023-03-29,6380
2303,聯電,15,5,10,光和,2023-03-29,6380
2535,達欣工,10,0,10,光和,2023-03-29,6380
2108,南帝,10,0,10,光和,2023-03-29,6380
3535,晶彩科,10,0,10,光和,2023-03-29,6380
4564,元翎,10,0,10,光和,2023-03-29,6380
6176,瑞儀,10,0,10,光和,2023-03-29,6380
8121,越峰,10,0,10,光和,2023-03-29,6380
2891,中信金,10,1,9,光和,2023-03-29,6380
3033,威健,10,1,9,光和,2023-03-29,6380
4706,大恭,9,0,9,光和,2023-03-29,6380
8249,菱光,9,0,9,光和,2023-03-29,6380
3035,智原,20,12,8,光和,2023-03-29,6380
5608,四維航,10,2,8,光和,2023-03-29,6380
3711,日月光投控,9,1,8,光和,2023-03-29,6380
00680L,元大美債20正2,7,0,7,光和,2023-03-29,6380
2344,華邦電,17,10,7,光和,2023-03-29,6380
6235,華孚,27,20,7,光和,2023-03-29,6380
2312,金寶,6,0,6,光和,2023-03-29,6380
3491,昇達科,153,3,150,光和,2023-03-30,6380
5475,德宏,127,0,127,光和,2023-03-30,6380
1101,台泥,37,0,37,光和,2023-03-30,6380
3576,聯合再生,31,5,26,光和,2023-03-30,6380
2340,台亞,25,0,25,光和,2023-03-30,6380
3588,通嘉,20,0,20,光和,2023-03-30,6380
6142,友勁,20,0,20,光和,2023-03-30,6380
2426,鼎元,19,0,19,光和,2023-03-30,6380
2329,華泰,18,0,18,光和,2023-03-30,6380
3265,台星科,15,0,15,光和,2023-03-30,6380
6244,茂迪,20,5,15,光和,2023-03-30,6380
2609,陽明,16,2,14,光和,2023-03-30,6380
3290,東浦,15,1,14,光和,2023-03-30,6380
1605,華新,18,5,13,光和,2023-03-30,6380
00882,中信中國高股息,11,0,11,光和,2023-03-30,6380
4128,中天,12,1,11,光和,2023-03-30,6380
6176,瑞儀,10,0,10,光和,2023-03-30,6380
00671R,富邦NASDAQ反1,10,0,10,光和,2023-03-30,6380
00772B,中信高評級公司債,10,0,10,光和,2023-03-30,6380
2313,華通,16,6,10,光和,2023-03-30,6380
3508,位速,10,0,10,光和,2023-03-30,6380
6278,台表科,10,0,10,光和,2023-03-30,6380
8112,至上,9,0,9,光和,2023-03-30,6380
00673R,期元大S＆P原油反1,9,0,9,光和,2023-03-30,6380
3706,神達,10,1,9,光和,2023-03-30,6380
4426,利勤,9,0,9,光和,2023-03-30,6380
5245,智晶,9,0,9,光和,2023-03-30,6380
6125,廣運,9,0,9,光和,2023-03-30,6380
00773B,中信優先金融債,8,0,8,光和,2023-03-30,6380
00751B,元大AAA至A公司債,8,0,8,光和,2023-03-30,6380
2002,中鋼,10,2,8,光和,2023-03-30,6380
3322,建舜電,8,0,8,光和,2023-03-30,6380
1584,精剛,8,1,7,光和,2023-03-30,6380
1618,合機,8,1,7,光和,2023-03-30,6380
1783,和康生,7,0,7,光和,2023-03-30,6380
2359,所羅門,11,4,7,光和,2023-03-30,6380
3058,立德,7,0,7,光和,2023-03-30,6380
3312,弘憶股,8,1,7,光和,2023-03-30,6380
3432,台端,16,9,7,光和,2023-03-30,6380
4114,健喬,7,0,7,光和,2023-03-30,6380
6282,康舒,13,6,7,光和,2023-03-30,6380
2419,仲琦,11,4,7,光和,2023-03-30,6380
00712,復華富時不動產,6,0,6,光和,2023-03-30,6380
5608,四維航,16,10,6,光和,2023-03-30,6380
1314,中石化,7,1,6,光和,2023-03-30,6380
2009,第一銅,6,0,6,光和,2023-03-30,6380
2520,冠德,6,0,6,光和,2023-03-30,6380
4706,大恭,6,0,6,光和,2023-03-30,6380
5371,中光電,6,0,6,光和,2023-03-30,6380
6288,聯嘉,10,4,6,光和,2023-03-30,6380
2371,大同,50,0,50,光和,2023-03-31,6380
3163,波若威,50,0,50,光和,2023-03-31,6380
3715,定穎投控,43,0,43,光和,2023-03-31,6380
2867,三商壽,42,0,42,光和,2023-03-31,6380
5347,世界,41,0,41,光和,2023-03-31,6380
2359,所羅門,30,0,30,光和,2023-03-31,6380
3682,亞太電,30,0,30,光和,2023-03-31,6380
00673R,期元大S＆P原油反1,25,0,25,光和,2023-03-31,6380
3025,星通,20,0,20,光和,2023-03-31,6380
1410,南染,19,0,19,光和,2023-03-31,6380
1785,光洋科,19,0,19,光和,2023-03-31,6380
2618,長榮航,20,1,19,光和,2023-03-31,6380
2739,寒舍,19,1,18,光和,2023-03-31,6380
5608,四維航,24,7,17,光和,2023-03-31,6380
2812,台中銀,21,5,16,光和,2023-03-31,6380
8088,品安,17,2,15,光和,2023-03-31,6380
2614,東森,15,0,15,光和,2023-03-31,6380
5475,德宏,14,0,14,光和,2023-03-31,6380
1504,東元,17,5,12,光和,2023-03-31,6380
2104,國際中橡,11,0,11,光和,2023-03-31,6380
2353,宏��,10,0,10,光和,2023-03-31,6380
2634,漢翔,10,0,10,光和,2023-03-31,6380
1471,首利,10,0,10,光和,2023-03-31,6380
3501,維熹,10,0,10,光和,2023-03-31,6380
5210,寶碩,10,0,10,光和,2023-03-31,6380
6753,龍德造船,10,0,10,光和,2023-03-31,6380
2027,大成鋼,10,0,10,光和,2023-03-31,6380
2603,長榮,12,3,9,光和,2023-03-31,6380
3047,訊舟,10,1,9,光和,2023-03-31,6380
8409,商之器,10,1,9,光和,2023-03-31,6380
6133,金橋,10,1,9,光和,2023-03-31,6380
2641,正德,8,0,8,光和,2023-03-31,6380
2337,旺宏,49,41,8,光和,2023-03-31,6380
1218,泰山,8,0,8,光和,2023-03-31,6380
3628,盈正,8,0,8,光和,2023-03-31,6380
6109,亞元,8,0,8,光和,2023-03-31,6380
3162,精確,8,1,7,光和,2023-03-31,6380
5522,遠雄,7,0,7,光和,2023-03-31,6380
6514,芮特-KY,7,0,7,光和,2023-03-31,6380
3455,由田,6,0,6,光和,2023-03-31,6380
1513,中興電,17,11,6,光和,2023-03-31,6380
1609,大亞,19,13,6,光和,2023-03-31,6380
2367,燿華,21,15,6,光和,2023-03-31,6380
2460,建通,6,0,6,光和,2023-03-31,6380
3035,智原,11,5,6,光和,2023-03-31,6380
8936,國統,6,0,6,光和,2023-03-31,6380
6770,力積電,8,3,5,光和,2023-03-31,6380
6125,廣運,6,1,5,光和,2023-03-31,6380
00642U,期元大S＆P石油,5,0,5,光和,2023-03-31,6380
3046,建��,6,1,5,光和,2023-03-31,6380
00720B,元大投資級公司債,140,0,140,光和,2023-04-06,6380
00897,富邦基因免疫生技,80,0,80,光和,2023-04-06,6380
2344,華邦電,52,1,51,光和,2023-04-06,6380
00665L,富邦�琤肭磪囓�2,42,6,36,光和,2023-04-06,6380
00637L,元大滬深300正2,59,24,35,光和,2023-04-06,6380
2618,長榮航,27,0,27,光和,2023-04-06,6380
1608,華榮,26,0,26,光和,2023-04-06,6380
1708,東鹼,24,0,24,光和,2023-04-06,6380
2027,大成鋼,22,0,22,光和,2023-04-06,6380
6770,力積電,22,0,22,光和,2023-04-06,6380
2208,台船,21,0,21,光和,2023-04-06,6380
6182,合晶,21,0,21,光和,2023-04-06,6380
00892,富邦台灣半導體,20,0,20,光和,2023-04-06,6380
2888,新光金,20,0,20,光和,2023-04-06,6380
4915,致伸,20,0,20,光和,2023-04-06,6380
2485,兆赫,20,2,18,光和,2023-04-06,6380
1218,泰山,20,2,18,光和,2023-04-06,6380
1440,南紡,18,0,18,光和,2023-04-06,6380
8069,元太,17,0,17,光和,2023-04-06,6380
4706,大恭,16,0,16,光和,2023-04-06,6380
8050,廣積,15,0,15,光和,2023-04-06,6380
1220,台榮,15,0,15,光和,2023-04-06,6380
1598,岱宇,15,0,15,光和,2023-04-06,6380
2002,中鋼,15,0,15,光和,2023-04-06,6380
6223,旺矽,15,0,15,光和,2023-04-06,6380
3481,群創,18,3,15,光和,2023-04-06,6380
00679B,元大美債20年,20,6,14,光和,2023-04-06,6380
2408,南亞科,15,1,14,光和,2023-04-06,6380
4543,萬在,14,0,14,光和,2023-04-06,6380
8112,至上,13,0,13,光和,2023-04-06,6380
1605,華新,32,19,13,光和,2023-04-06,6380
8046,南電,16,3,13,光和,2023-04-06,6380
5512,力麒,12,0,12,光和,2023-04-06,6380
6235,華孚,16,4,12,光和,2023-04-06,6380
6443,元晶,22,10,12,光和,2023-04-06,6380
2606,裕民,27,15,12,光和,2023-04-06,6380
2609,陽明,13,1,12,光和,2023-04-06,6380
00878,國泰永續高股息,13,3,10,光和,2023-04-06,6380
00900,富邦特選高股息30,10,0,10,光和,2023-04-06,6380
2329,華泰,10,0,10,光和,2023-04-06,6380
4960,誠美材,10,0,10,光和,2023-04-06,6380
5475,德宏,10,0,10,光和,2023-04-06,6380
2302,麗正,9,0,9,光和,2023-04-06,6380
3703,欣陸,8,0,8,光和,2023-04-06,6380
8215,明基材,8,0,8,光和,2023-04-06,6380
8440,綠電,10,2,8,光和,2023-04-06,6380
2368,金像電,9,2,7,光和,2023-04-06,6380
2484,希華,8,1,7,光和,2023-04-06,6380
4906,正文,14,7,7,光和,2023-04-06,6380
00830,國泰費城半導體,6,0,6,光和,2023-04-06,6380
00878,國泰永續高股息,109,0,109,光和,2023-04-07,6380
0056,元大高股息,65,1,64,光和,2023-04-07,6380
2867,三商壽,43,5,38,光和,2023-04-07,6380
006208,富邦台50,32,0,32,光和,2023-04-07,6380
2208,台船,33,4,29,光和,2023-04-07,6380
00728,第一金工業30,26,0,26,光和,2023-04-07,6380
00692,富邦公司治理,21,0,21,光和,2023-04-07,6380
00720B,元大投資級公司債,20,0,20,光和,2023-04-07,6380
1717,長興,20,0,20,光和,2023-04-07,6380
2359,所羅門,20,0,20,光和,2023-04-07,6380
3356,奇偶,20,0,20,光和,2023-04-07,6380
5475,德宏,20,0,20,光和,2023-04-07,6380
6133,金橋,20,0,20,光和,2023-04-07,6380
3231,緯創,20,3,17,光和,2023-04-07,6380
1218,泰山,40,23,17,光和,2023-04-07,6380
2472,立隆電,15,0,15,光和,2023-04-07,6380
1584,精剛,14,1,13,光和,2023-04-07,6380
3062,建漢,15,3,12,光和,2023-04-07,6380
3236,千如,12,0,12,光和,2023-04-07,6380
4961,天鈺,22,11,11,光和,2023-04-07,6380
1410,南染,11,0,11,光和,2023-04-07,6380
1708,東鹼,11,0,11,光和,2023-04-07,6380
2409,友達,111,100,11,光和,2023-04-07,6380
3189,景碩,11,0,11,光和,2023-04-07,6380
00673R,期元大S＆P原油反1,11,0,11,光和,2023-04-07,6380
1569,濱川,11,1,10,光和,2023-04-07,6380
2368,金像電,10,0,10,光和,2023-04-07,6380
3027,盛達,16,6,10,光和,2023-04-07,6380
3043,科風,10,0,10,光和,2023-04-07,6380
3257,虹冠電,10,0,10,光和,2023-04-07,6380
3293,鈊象,10,0,10,光和,2023-04-07,6380
3447,展達,10,0,10,光和,2023-04-07,6380
5512,力麒,10,0,10,光和,2023-04-07,6380
8222,寶一,11,1,10,光和,2023-04-07,6380
2641,正德,9,0,9,光和,2023-04-07,6380
6278,台表科,10,1,9,光和,2023-04-07,6380
6770,力積電,9,0,9,光和,2023-04-07,6380
6223,旺矽,13,5,8,光和,2023-04-07,6380
2442,新美齊,8,0,8,光和,2023-04-07,6380
2453,凌群,8,0,8,光和,2023-04-07,6380
1314,中石化,7,0,7,光和,2023-04-07,6380
4536,拓凱,7,0,7,光和,2023-04-07,6380
5315,光聯,7,0,7,光和,2023-04-07,6380
6290,良維,7,0,7,光和,2023-04-07,6380
8097,常珵,11,4,7,光和,2023-04-07,6380
00712,復華富時不動產,6,0,6,光和,2023-04-07,6380
2495,普安,6,0,6,光和,2023-04-07,6380
2516,新建,6,0,6,光和,2023-04-07,6380
5347,世界,6,0,6,光和,2023-04-07,6380
6461,益得,15,9,6,光和,2023-04-07,6380
00720B,元大投資級公司債,82,0,82,光和,2023-04-10,6380
2438,翔耀,62,0,62,光和,2023-04-10,6380
1101,台泥,62,0,62,光和,2023-04-10,6380
3049,精金,50,0,50,光和,2023-04-10,6380
4207,環泰,50,2,48,光和,2023-04-10,6380
020022,元大電動車N,50,4,46,光和,2023-04-10,6380
00772B,中信高評級公司債,30,0,30,光和,2023-04-10,6380
2427,三商電,29,0,29,光和,2023-04-10,6380
1514,亞力,32,4,28,光和,2023-04-10,6380
1504,東元,33,6,27,光和,2023-04-10,6380
6443,元晶,25,0,25,光和,2023-04-10,6380
00632R,元大台灣50反1,23,0,23,光和,2023-04-10,6380
6770,力積電,22,0,22,光和,2023-04-10,6380
00830,國泰費城半導體,22,0,22,光和,2023-04-10,6380
8050,廣積,21,0,21,光和,2023-04-10,6380
1313,聯成,20,0,20,光和,2023-04-10,6380
1529,樂事綠能,21,1,20,光和,2023-04-10,6380
2342,茂矽,21,1,20,光和,2023-04-10,6380
9907,統一實,20,0,20,光和,2023-04-10,6380
00673R,期元大S＆P原油反1,18,0,18,光和,2023-04-10,6380
1605,華新,18,0,18,光和,2023-04-10,6380
1783,和康生,17,0,17,光和,2023-04-10,6380
3707,漢磊,17,0,17,光和,2023-04-10,6380
6125,廣運,17,0,17,光和,2023-04-10,6380
2609,陽明,27,10,17,光和,2023-04-10,6380
2634,漢翔,19,4,15,光和,2023-04-10,6380
3646,艾恩特,15,0,15,光和,2023-04-10,6380
2314,台揚,15,1,14,光和,2023-04-10,6380
2399,映泰,14,0,14,光和,2023-04-10,6380
5347,世界,12,0,12,光和,2023-04-10,6380
6589,台康生技,16,4,12,光和,2023-04-10,6380
2344,華邦電,28,16,12,光和,2023-04-10,6380
2408,南亞科,13,2,11,光和,2023-04-10,6380
4934,太極,11,0,11,光和,2023-04-10,6380
2062,橋椿,11,0,11,光和,2023-04-10,6380
3664,安瑞-KY,12,1,11,光和,2023-04-10,6380
6156,松上,15,4,11,光和,2023-04-10,6380
1598,岱宇,10,0,10,光和,2023-04-10,6380
1802,台玻,10,0,10,光和,2023-04-10,6380
2030,彰源,10,0,10,光和,2023-04-10,6380
2352,佳世達,10,0,10,光和,2023-04-10,6380
2353,宏��,11,1,10,光和,2023-04-10,6380
2547,日勝生,10,0,10,光和,2023-04-10,6380
4968,立積,13,3,10,光和,2023-04-10,6380
5015,華祺,10,0,10,光和,2023-04-10,6380
6288,聯嘉,11,1,10,光和,2023-04-10,6380
1717,長興,8,0,8,光和,2023-04-10,6380
2388,威盛,8,0,8,光和,2023-04-10,6380
6477,安集,8,0,8,光和,2023-04-10,6380
2303,聯電,7,0,7,光和,2023-04-10,6380
00665L,富邦�琤肭磪囓�2,73,15,58,光和,2023-04-11,6380
00772B,中信高評級公司債,56,0,56,光和,2023-04-11,6380
00637L,元大滬深300正2,34,1,33,光和,2023-04-11,6380
00712,復華富時不動產,32,0,32,光和,2023-04-11,6380
00632R,元大台灣50反1,31,0,31,光和,2023-04-11,6380
1504,東元,44,13,31,光和,2023-04-11,6380
4935,茂林-KY,30,0,30,光和,2023-04-11,6380
6191,精成科,31,2,29,光和,2023-04-11,6380
00830,國泰費城半導體,30,5,25,光和,2023-04-11,6380
4527,方土霖,24,0,24,光和,2023-04-11,6380
2834,臺企銀,31,7,24,光和,2023-04-11,6380
00713,元大台灣高息低波,20,0,20,光和,2023-04-11,6380
6443,元晶,22,2,20,光和,2023-04-11,6380
1605,華新,33,15,18,光和,2023-04-11,6380
1783,和康生,17,0,17,光和,2023-04-11,6380
5011,久陽,17,0,17,光和,2023-04-11,6380
1210,大成,15,0,15,光和,2023-04-11,6380
2206,三陽工業,20,5,15,光和,2023-04-11,6380
3234,光環,15,0,15,光和,2023-04-11,6380
6275,元山,15,0,15,光和,2023-04-11,6380
2329,華泰,19,5,14,光和,2023-04-11,6380
3666,光耀,14,0,14,光和,2023-04-11,6380
6142,友勁,20,6,14,光和,2023-04-11,6380
6235,華孚,26,12,14,光和,2023-04-11,6380
6285,啟��,13,0,13,光和,2023-04-11,6380
2313,華通,13,0,13,光和,2023-04-11,6380
3046,建��,14,1,13,光和,2023-04-11,6380
2303,聯電,12,0,12,光和,2023-04-11,6380
00885,富邦越南,12,0,12,光和,2023-04-11,6380
2457,飛宏,24,13,11,光和,2023-04-11,6380
6770,力積電,17,6,11,光和,2023-04-11,6380
1215,卜蜂,10,0,10,光和,2023-04-11,6380
00888,永豐台灣ESG,10,0,10,光和,2023-04-11,6380
00671R,富邦NASDAQ反1,10,0,10,光和,2023-04-11,6380
2323,中環,10,0,10,光和,2023-04-11,6380
3022,威強電,10,0,10,光和,2023-04-11,6380
3713,新晶投控,10,0,10,光和,2023-04-11,6380
4916,事欣科,10,0,10,光和,2023-04-11,6380
6177,達麗,10,0,10,光和,2023-04-11,6380
1514,亞力,19,10,9,光和,2023-04-11,6380
2302,麗正,19,10,9,光和,2023-04-11,6380
6111,大宇資,11,2,9,光和,2023-04-11,6380
6125,廣運,9,0,9,光和,2023-04-11,6380
6531,愛普*,12,3,9,光和,2023-04-11,6380
2408,南亞科,21,12,9,光和,2023-04-11,6380
3707,漢磊,8,0,8,光和,2023-04-11,6380
8070,長華*,8,0,8,光和,2023-04-11,6380
2317,鴻海,8,0,8,光和,2023-04-11,6380
1611,中電,6,0,6,光和,2023-04-11,6380
2027,大成鋼,6,0,6,光和,2023-04-11,6380
1313,聯成,90,0,90,光和,2023-04-12,6380
2313,華通,70,0,70,光和,2023-04-12,6380
00673R,期元大S＆P原油反1,60,0,60,光和,2023-04-12,6380
0056,元大高股息,62,9,53,光和,2023-04-12,6380
00692,富邦公司治理,40,0,40,光和,2023-04-12,6380
8028,昇陽半導體,38,0,38,光和,2023-04-12,6380
1503,士電,36,2,34,光和,2023-04-12,6380
8033,雷虎,36,2,34,光和,2023-04-12,6380
3481,群創,51,20,31,光和,2023-04-12,6380
00712,復華富時不動產,31,0,31,光和,2023-04-12,6380
00878,國泰永續高股息,100,73,27,光和,2023-04-12,6380
1609,大亞,57,31,26,光和,2023-04-12,6380
3094,聯傑,23,0,23,光和,2023-04-12,6380
2801,彰銀,20,0,20,光和,2023-04-12,6380
4503,金雨,20,0,20,光和,2023-04-12,6380
3576,聯合再生,20,1,19,光和,2023-04-12,6380
6443,元晶,45,26,19,光和,2023-04-12,6380
3209,全科,18,0,18,光和,2023-04-12,6380
00637L,元大滬深300正2,21,4,17,光和,2023-04-12,6380
2317,鴻海,16,0,16,光和,2023-04-12,6380
3704,合勤控,18,2,16,光和,2023-04-12,6380
3545,敦泰,21,5,16,光和,2023-04-12,6380
6804,明係,15,0,15,光和,2023-04-12,6380
3272,東碩,14,0,14,光和,2023-04-12,6380
3686,達能,14,0,14,光和,2023-04-12,6380
6531,愛普*,30,17,13,光和,2023-04-12,6380
2883,凱基金,22,10,12,光和,2023-04-12,6380
6235,華孚,17,5,12,光和,2023-04-12,6380
6477,安集,25,13,12,光和,2023-04-12,6380
6589,台康生技,15,3,12,光和,2023-04-12,6380
3236,千如,17,5,12,光和,2023-04-12,6380
2034,允強,12,1,11,光和,2023-04-12,6380
2340,台亞,11,0,11,光和,2023-04-12,6380
2890,永豐金,11,0,11,光和,2023-04-12,6380
3178,公準,12,1,11,光和,2023-04-12,6380
6285,啟��,11,0,11,光和,2023-04-12,6380
6485,點序,12,1,11,光和,2023-04-12,6380
3006,晶豪科,29,18,11,光和,2023-04-12,6380
2330,台積電,12,2,10,光和,2023-04-12,6380
2363,矽統,10,0,10,光和,2023-04-12,6380
2405,輔信,10,0,10,光和,2023-04-12,6380
2455,全新,10,0,10,光和,2023-04-12,6380
2511,太子,10,0,10,光和,2023-04-12,6380
3479,安勤,10,0,10,光和,2023-04-12,6380
3706,神達,10,0,10,光和,2023-04-12,6380
5315,光聯,10,0,10,光和,2023-04-12,6380
1101,台泥,18,9,9,光和,2023-04-12,6380
2388,威盛,10,2,8,光和,2023-04-12,6380
3162,精確,8,0,8,光和,2023-04-12,6380
3713,新晶投控,8,0,8,光和,2023-04-12,6380
4155,訊映,110,0,110,光和,2023-04-13,6380
00712,復華富時不動產,87,0,87,光和,2023-04-13,6380
3576,聯合再生,59,8,51,光和,2023-04-13,6380
00673R,期元大S＆P原油反1,47,0,47,光和,2023-04-13,6380
2634,漢翔,67,21,46,光和,2023-04-13,6380
5009,榮剛,48,4,44,光和,2023-04-13,6380
3029,零壹,40,0,40,光和,2023-04-13,6380
00878,國泰永續高股息,49,16,33,光和,2023-04-13,6380
2025,千興,30,0,30,光和,2023-04-13,6380
1217,愛之味,30,2,28,光和,2023-04-13,6380
2313,華通,26,0,26,光和,2023-04-13,6380
8936,國統,48,22,26,光和,2023-04-13,6380
2317,鴻海,25,0,25,光和,2023-04-13,6380
1504,東元,46,22,24,光和,2023-04-13,6380
6443,元晶,23,0,23,光和,2023-04-13,6380
6485,點序,26,3,23,光和,2023-04-13,6380
2302,麗正,27,5,22,光和,2023-04-13,6380
1471,首利,20,0,20,光和,2023-04-13,6380
3356,奇偶,20,0,20,光和,2023-04-13,6380
5392,能率,20,0,20,光和,2023-04-13,6380
6294,智基,20,0,20,光和,2023-04-13,6380
3231,緯創,23,4,19,光和,2023-04-13,6380
6185,幃翔,20,1,19,光和,2023-04-13,6380
1514,亞力,35,16,19,光和,2023-04-13,6380
6122,擎邦,26,8,18,光和,2023-04-13,6380
8271,宇瞻,20,4,16,光和,2023-04-13,6380
1809,中釉,15,0,15,光和,2023-04-13,6380
6109,亞元,14,0,14,光和,2023-04-13,6380
2330,台積電,13,0,13,光和,2023-04-13,6380
00679B,元大美債20年,13,0,13,光和,2023-04-13,6380
3694,海華,13,0,13,光和,2023-04-13,6380
3056,富華新,14,2,12,光和,2023-04-13,6380
1522,堤維西,12,0,12,光和,2023-04-13,6380
2408,南亞科,12,0,12,光和,2023-04-13,6380
2605,新興,12,0,12,光和,2023-04-13,6380
00892,富邦台灣半導體,10,0,10,光和,2023-04-13,6380
00671R,富邦NASDAQ反1,10,0,10,光和,2023-04-13,6380
00632R,元大台灣50反1,10,0,10,光和,2023-04-13,6380
00761B,國泰A級公司債,10,0,10,光和,2023-04-13,6380
2204,中華,13,3,10,光和,2023-04-13,6380
4532,瑞智,10,0,10,光和,2023-04-13,6380
4934,太極,11,1,10,光和,2023-04-13,6380
5011,久陽,10,0,10,光和,2023-04-13,6380
6174,安��,10,0,10,光和,2023-04-13,6380
6496,科懋,10,0,10,光和,2023-04-13,6380
8171,天宇,12,2,10,光和,2023-04-13,6380
3711,日月光投控,9,0,9,光和,2023-04-13,6380
2645,長榮航太,15,6,9,光和,2023-04-13,6380
00922,國泰台灣領袖50,9,0,9,光和,2023-04-13,6380
1605,華新,18,9,9,光和,2023-04-13,6380
4155,訊映,110,0,110,光和,2023-04-14,6380
4526,東台,100,1,99,光和,2023-04-14,6380
1314,中石化,102,8,94,光和,2023-04-14,6380
2363,矽統,80,2,78,光和,2023-04-14,6380
00720B,元大投資級公司債,71,0,71,光和,2023-04-14,6380
2208,台船,77,10,67,光和,2023-04-14,6380
2634,漢翔,91,36,55,光和,2023-04-14,6380
00878,國泰永續高股息,87,37,50,光和,2023-04-14,6380
4744,皇將,50,1,49,光和,2023-04-14,6380
9105,泰金寶-DR,58,10,48,光和,2023-04-14,6380
00692,富邦公司治理,41,0,41,光和,2023-04-14,6380
1504,東元,60,19,41,光和,2023-04-14,6380
0056,元大高股息,43,4,39,光和,2023-04-14,6380
8121,越峰,51,16,35,光和,2023-04-14,6380
2888,新光金,61,28,33,光和,2023-04-14,6380
3025,星通,33,1,32,光和,2023-04-14,6380
6741,91APP*-KY,23,0,23,光和,2023-04-14,6380
00712,復華富時不動產,22,0,22,光和,2023-04-14,6380
00885,富邦越南,20,0,20,光和,2023-04-14,6380
3308,聯德,20,0,20,光和,2023-04-14,6380
8933,愛地雅,20,0,20,光和,2023-04-14,6380
2801,彰銀,20,1,19,光和,2023-04-14,6380
3576,聯合再生,21,3,18,光和,2023-04-14,6380
8046,南電,17,1,16,光和,2023-04-14,6380
00687B,國泰20年美債,15,0,15,光和,2023-04-14,6380
6282,康舒,18,3,15,光和,2023-04-14,6380
6443,元晶,18,3,15,光和,2023-04-14,6380
6234,高僑,14,0,14,光和,2023-04-14,6380
1522,堤維西,30,17,13,光和,2023-04-14,6380
2887,台新金,13,0,13,光和,2023-04-14,6380
3006,晶豪科,13,1,12,光和,2023-04-14,6380
6182,合晶,14,2,12,光和,2023-04-14,6380
00908,富邦入息REITs+,11,0,11,光和,2023-04-14,6380
3088,艾訊,11,0,11,光和,2023-04-14,6380
00674R,期元大S＆P黃金反1,10,0,10,光和,2023-04-14,6380
00673R,期元大S＆P原油反1,15,5,10,光和,2023-04-14,6380
1560,中砂,10,0,10,光和,2023-04-14,6380
1710,東聯,10,0,10,光和,2023-04-14,6380
3356,奇偶,10,0,10,光和,2023-04-14,6380
6217,中探針,11,1,10,光和,2023-04-14,6380
8086,宏捷科,10,0,10,光和,2023-04-14,6380
8110,華東,10,0,10,光和,2023-04-14,6380
1503,士電,19,9,10,光和,2023-04-14,6380
3033,威健,10,0,10,光和,2023-04-14,6380
2002,中鋼,9,0,9,光和,2023-04-14,6380
3037,欣興,9,0,9,光和,2023-04-14,6380
3071,協禧,9,0,9,光和,2023-04-14,6380
3545,敦泰,16,7,9,光和,2023-04-14,6380
2883,凱基金,18,9,9,光和,2023-04-14,6380
1526,日馳,8,0,8,光和,2023-04-14,6380
3390,旭軟,110,0,110,光和,2023-04-17,6380
2701,萬企,100,0,100,光和,2023-04-17,6380
2515,中工,91,3,88,光和,2023-04-17,6380
6547,高端疫苗,80,1,79,光和,2023-04-17,6380
00878,國泰永續高股息,77,4,73,光和,2023-04-17,6380
2618,長榮航,73,4,69,光和,2023-04-17,6380
2342,茂矽,61,1,60,光和,2023-04-17,6380
00712,復華富時不動產,59,5,54,光和,2023-04-17,6380
3715,定穎投控,47,4,43,光和,2023-04-17,6380
0056,元大高股息,42,2,40,光和,2023-04-17,6380
00692,富邦公司治理,40,0,40,光和,2023-04-17,6380
2206,三陽工業,76,43,33,光和,2023-04-17,6380
1605,華新,40,8,32,光和,2023-04-17,6380
00679B,元大美債20年,31,0,31,光和,2023-04-17,6380
00885,富邦越南,30,0,30,光和,2023-04-17,6380
1471,首利,30,0,30,光和,2023-04-17,6380
3548,兆利,25,0,25,光和,2023-04-17,6380
2324,仁寶,25,2,23,光和,2023-04-17,6380
2610,華航,28,5,23,光和,2023-04-17,6380
00673R,期元大S＆P原油反1,21,0,21,光和,2023-04-17,6380
2834,臺企銀,20,3,17,光和,2023-04-17,6380
2399,映泰,16,0,16,光和,2023-04-17,6380
1417,嘉裕,15,0,15,光和,2023-04-17,6380
1815,富喬,15,0,15,光和,2023-04-17,6380
2002,中鋼,16,1,15,光和,2023-04-17,6380
2641,正德,15,0,15,光和,2023-04-17,6380
4976,佳凌,20,5,15,光和,2023-04-17,6380
6015,宏遠證,16,1,15,光和,2023-04-17,6380
6603,富強鑫,15,0,15,光和,2023-04-17,6380
2867,三商壽,16,2,14,光和,2023-04-17,6380
4541,晟田,16,3,13,光和,2023-04-17,6380
2359,所羅門,14,1,13,光和,2023-04-17,6380
8358,金居,13,0,13,光和,2023-04-17,6380
1319,東陽,14,2,12,光和,2023-04-17,6380
1210,大成,15,3,12,光和,2023-04-17,6380
2440,太空梭,12,0,12,光和,2023-04-17,6380
2801,彰銀,11,0,11,光和,2023-04-17,6380
2388,威盛,12,1,11,光和,2023-04-17,6380
2409,友達,11,0,11,光和,2023-04-17,6380
3661,世芯-KY,11,0,11,光和,2023-04-17,6380
6282,康舒,20,9,11,光和,2023-04-17,6380
3033,威健,10,0,10,光和,2023-04-17,6380
00922,國泰台灣領袖50,10,0,10,光和,2023-04-17,6380
2312,金寶,31,21,10,光和,2023-04-17,6380
2371,大同,10,0,10,光和,2023-04-17,6380
2421,建準,11,1,10,光和,2023-04-17,6380
2820,華票,10,0,10,光和,2023-04-17,6380
2897,王道銀行,10,0,10,光和,2023-04-17,6380
4130,健亞,10,0,10,光和,2023-04-17,6380
5512,力麒,10,0,10,光和,2023-04-17,6380
2867,三商壽,230,0,230,光和,2023-04-18,6380
4155,訊映,100,0,100,光和,2023-04-18,6380
3481,群創,82,4,78,光和,2023-04-18,6380
00679B,元大美債20年,56,0,56,光和,2023-04-18,6380
3591,艾笛森,54,1,53,光和,2023-04-18,6380
5521,工信,48,0,48,光和,2023-04-18,6380
1529,樂事綠能,59,25,34,光和,2023-04-18,6380
4915,致伸,31,2,29,光和,2023-04-18,6380
2313,華通,28,0,28,光和,2023-04-18,6380
2701,萬企,27,0,27,光和,2023-04-18,6380
5347,世界,24,0,24,光和,2023-04-18,6380
00687B,國泰20年美債,23,0,23,光和,2023-04-18,6380
2601,益航,30,8,22,光和,2023-04-18,6380
1444,力麗,35,14,21,光和,2023-04-18,6380
2891,中信金,21,0,21,光和,2023-04-18,6380
2409,友達,21,1,20,光和,2023-04-18,6380
3356,奇偶,20,0,20,光和,2023-04-18,6380
4207,環泰,30,10,20,光和,2023-04-18,6380
4916,事欣科,20,0,20,光和,2023-04-18,6380
8183,精星,20,0,20,光和,2023-04-18,6380
0056,元大高股息,20,1,19,光和,2023-04-18,6380
1809,中釉,42,23,19,光和,2023-04-18,6380
2460,建通,17,0,17,光和,2023-04-18,6380
00720B,元大投資級公司債,16,0,16,光和,2023-04-18,6380
1609,大亞,28,12,16,光和,2023-04-18,6380
2208,台船,26,10,16,光和,2023-04-18,6380
3029,零壹,17,1,16,光和,2023-04-18,6380
3093,港建*,15,0,15,光和,2023-04-18,6380
2002,中鋼,16,1,15,光和,2023-04-18,6380
3149,正達,20,5,15,光和,2023-04-18,6380
3706,神達,15,0,15,光和,2023-04-18,6380
2204,中華,15,0,15,光和,2023-04-18,6380
00878,國泰永續高股息,25,10,15,光和,2023-04-18,6380
3260,威剛,14,0,14,光和,2023-04-18,6380
00772B,中信高評級公司債,13,0,13,光和,2023-04-18,6380
00893,國泰智能電動車,15,3,12,光和,2023-04-18,6380
3230,錦明,12,0,12,光和,2023-04-18,6380
4931,新盛力,12,0,12,光和,2023-04-18,6380
5371,中光電,14,2,12,光和,2023-04-18,6380
5465,富驊,24,12,12,光和,2023-04-18,6380
2105,正新,13,2,11,光和,2023-04-18,6380
2630,亞航,17,6,11,光和,2023-04-18,6380
5489,彩富,11,0,11,光和,2023-04-18,6380
6182,合晶,11,0,11,光和,2023-04-18,6380
6285,啟��,15,4,11,光和,2023-04-18,6380
00901,永豐智能車供應鏈,10,0,10,光和,2023-04-18,6380
2362,藍天,10,0,10,光和,2023-04-18,6380
2820,華票,10,0,10,光和,2023-04-18,6380
2880,華南金,10,0,10,光和,2023-04-18,6380
2897,王道銀行,10,0,10,光和,2023-04-18,6380
6606,建德工業,140,0,140,光和,2023-04-19,6380
00665L,富邦�琤肭磪囓�2,540,441,99,光和,2023-04-19,6380
4207,環泰,57,0,57,光和,2023-04-19,6380
1409,新纖,53,0,53,光和,2023-04-19,6380
2701,萬企,41,0,41,光和,2023-04-19,6380
1718,中纖,42,2,40,光和,2023-04-19,6380
00878,國泰永續高股息,40,3,37,光和,2023-04-19,6380
2444,兆勁,38,1,37,光和,2023-04-19,6380
00892,富邦台灣半導體,35,0,35,光和,2023-04-19,6380
1471,首利,34,0,34,光和,2023-04-19,6380
2302,麗正,25,0,25,光和,2023-04-19,6380
2329,華泰,25,0,25,光和,2023-04-19,6380
00637L,元大滬深300正2,24,0,24,光和,2023-04-19,6380
2313,華通,35,11,24,光和,2023-04-19,6380
2337,旺宏,26,3,23,光和,2023-04-19,6380
00712,復華富時不動產,22,0,22,光和,2023-04-19,6380
3481,群創,67,46,21,光和,2023-04-19,6380
2605,新興,21,0,21,光和,2023-04-19,6380
00692,富邦公司治理,20,0,20,光和,2023-04-19,6380
6257,矽格,20,0,20,光和,2023-04-19,6380
3029,零壹,21,1,20,光和,2023-04-19,6380
3356,奇偶,20,0,20,光和,2023-04-19,6380
1503,士電,20,1,19,光和,2023-04-19,6380
0056,元大高股息,20,2,18,光和,2023-04-19,6380
2002,中鋼,20,2,18,光和,2023-04-19,6380
2634,漢翔,52,35,17,光和,2023-04-19,6380
3390,旭軟,16,0,16,光和,2023-04-19,6380
2371,大同,17,1,16,光和,2023-04-19,6380
00679B,元大美債20年,15,0,15,光和,2023-04-19,6380
2425,承啟,15,0,15,光和,2023-04-19,6380
2363,矽統,15,0,15,光和,2023-04-19,6380
8046,南電,14,0,14,光和,2023-04-19,6380
3706,神達,13,0,13,光和,2023-04-19,6380
6182,合晶,15,2,13,光和,2023-04-19,6380
4116,明基醫,12,0,12,光和,2023-04-19,6380
5475,德宏,12,0,12,光和,2023-04-19,6380
8028,昇陽半導體,17,5,12,光和,2023-04-19,6380
8358,金居,16,4,12,光和,2023-04-19,6380
9945,潤泰新,12,0,12,光和,2023-04-19,6380
1444,力麗,15,4,11,光和,2023-04-19,6380
6770,力積電,20,9,11,光和,2023-04-19,6380
8059,凱碩,11,0,11,光和,2023-04-19,6380
2303,聯電,10,0,10,光和,2023-04-19,6380
00728,第一金工業30,10,0,10,光和,2023-04-19,6380
00901,永豐智能車供應鏈,10,0,10,光和,2023-04-19,6380
2890,永豐金,10,0,10,光和,2023-04-19,6380
2915,潤泰全,12,2,10,光和,2023-04-19,6380
4127,天良,10,0,10,光和,2023-04-19,6380
4129,聯合,10,0,10,光和,2023-04-19,6380
4306,炎洲,10,0,10,光和,2023-04-19,6380
00772B,中信高評級公司債,122,0,122,光和,2023-04-20,6380
00720B,元大投資級公司債,113,0,113,光和,2023-04-20,6380
3576,聯合再生,72,1,71,光和,2023-04-20,6380
3682,亞太電,70,0,70,光和,2023-04-20,6380
2867,三商壽,84,20,64,光和,2023-04-20,6380
00885,富邦越南,44,5,39,光和,2023-04-20,6380
00637L,元大滬深300正2,60,21,39,光和,2023-04-20,6380
6770,力積電,61,25,36,光和,2023-04-20,6380
2460,建通,33,0,33,光和,2023-04-20,6380
2701,萬企,32,0,32,光和,2023-04-20,6380
2313,華通,31,0,31,光和,2023-04-20,6380
2634,漢翔,32,1,31,光和,2023-04-20,6380
1611,中電,34,5,29,光和,2023-04-20,6380
00665L,富邦�琤肭磪囓�2,25,0,25,光和,2023-04-20,6380
4114,健喬,23,1,22,光和,2023-04-20,6380
1810,和成,28,7,21,光和,2023-04-20,6380
2605,新興,21,0,21,光和,2023-04-20,6380
3356,奇偶,21,0,21,光和,2023-04-20,6380
6443,元晶,36,15,21,光和,2023-04-20,6380
3006,晶豪科,21,1,20,光和,2023-04-20,6380
00902,中信電池及儲能,20,0,20,光和,2023-04-20,6380
1529,樂事綠能,20,0,20,光和,2023-04-20,6380
2314,台揚,19,1,18,光和,2023-04-20,6380
6220,岳豐,17,0,17,光和,2023-04-20,6380
2324,仁寶,17,1,16,光和,2023-04-20,6380
3548,兆利,16,0,16,光和,2023-04-20,6380
6134,萬旭,46,30,16,光和,2023-04-20,6380
1708,東鹼,15,0,15,光和,2023-04-20,6380
1783,和康生,25,10,15,光和,2023-04-20,6380
2481,強茂,15,0,15,光和,2023-04-20,6380
4128,中天,18,3,15,光和,2023-04-20,6380
8255,朋程,15,0,15,光和,2023-04-20,6380
00713,元大台灣高息低波,14,0,14,光和,2023-04-20,6380
2034,允強,15,1,14,光和,2023-04-20,6380
5347,世界,14,0,14,光和,2023-04-20,6380
3038,全台,27,14,13,光和,2023-04-20,6380
6411,晶焱,13,0,13,光和,2023-04-20,6380
00900,富邦特選高股息30,12,0,12,光和,2023-04-20,6380
2419,仲琦,12,0,12,光和,2023-04-20,6380
3290,東浦,13,1,12,光和,2023-04-20,6380
8028,昇陽半導體,12,0,12,光和,2023-04-20,6380
8383,千附,12,0,12,光和,2023-04-20,6380
8933,愛地雅,12,0,12,光和,2023-04-20,6380
2105,正新,11,0,11,光和,2023-04-20,6380
2610,華航,12,1,11,光和,2023-04-20,6380
5371,中光電,11,0,11,光和,2023-04-20,6380
2303,聯電,20,10,10,光和,2023-04-20,6380
2451,創見,10,0,10,光和,2023-04-20,6380
3032,偉訓,10,0,10,光和,2023-04-20,6380
00901,永豐智能車供應鏈,10,0,10,光和,2023-04-20,6380
00900,富邦特選高股息30,173,0,173,光和,2023-04-21,6380
1220,台榮,152,0,152,光和,2023-04-21,6380
4207,環泰,150,0,150,光和,2023-04-21,6380
2883B,凱基金乙特,70,0,70,光和,2023-04-21,6380
6163,華電網,86,25,61,光和,2023-04-21,6380
2027,大成鋼,62,3,59,光和,2023-04-21,6380
6770,力積電,72,13,59,光和,2023-04-21,6380
1101,台泥,65,21,44,光和,2023-04-21,6380
2062,橋椿,33,0,33,光和,2023-04-21,6380
2423,固緯,31,0,31,光和,2023-04-21,6380
2701,萬企,31,0,31,光和,2023-04-21,6380
6285,啟��,33,3,30,光和,2023-04-21,6380
3576,聯合再生,33,3,30,光和,2023-04-21,6380
2618,長榮航,25,0,25,光和,2023-04-21,6380
2615,萬海,36,12,24,光和,2023-04-21,6380
1905,華紙,22,0,22,光和,2023-04-21,6380
3605,宏致,21,0,21,光和,2023-04-21,6380
2022,聚亨,20,0,20,光和,2023-04-21,6380
2312,金寶,20,0,20,光和,2023-04-21,6380
2867,三商壽,17,0,17,光和,2023-04-21,6380
6417,韋僑,17,0,17,光和,2023-04-21,6380
4114,健喬,16,0,16,光和,2023-04-21,6380
1611,中電,66,50,16,光和,2023-04-21,6380
2034,允強,16,0,16,光和,2023-04-21,6380
2617,台航,16,0,16,光和,2023-04-21,6380
2104,國際中橡,15,0,15,光和,2023-04-21,6380
8271,宇瞻,15,0,15,光和,2023-04-21,6380
8409,商之器,14,0,14,光和,2023-04-21,6380
2812,台中銀,15,1,14,光和,2023-04-21,6380
2313,華通,17,4,13,光和,2023-04-21,6380
3481,群創,29,16,13,光和,2023-04-21,6380
6753,龍德造船,16,3,13,光和,2023-04-21,6380
1513,中興電,14,2,12,光和,2023-04-21,6380
3047,訊舟,12,0,12,光和,2023-04-21,6380
3390,旭軟,12,0,12,光和,2023-04-21,6380
4934,太極,12,0,12,光和,2023-04-21,6380
6547,高端疫苗,12,0,12,光和,2023-04-21,6380
6733,博晟生醫,19,7,12,光和,2023-04-21,6380
3707,漢磊,11,0,11,光和,2023-04-21,6380
1522,堤維西,11,0,11,光和,2023-04-21,6380
2409,友達,13,2,11,光和,2023-04-21,6380
3049,精金,11,0,11,光和,2023-04-21,6380
3703,欣陸,11,0,11,光和,2023-04-21,6380
6589,台康生技,13,2,11,光和,2023-04-21,6380
00892,富邦台灣半導體,10,0,10,光和,2023-04-21,6380
00922,國泰台灣領袖50,10,0,10,光和,2023-04-21,6380
00882,中信中國高股息,10,0,10,光和,2023-04-21,6380
00665L,富邦�琤肭磪囓�2,10,0,10,光和,2023-04-21,6380
2017,官田鋼,10,0,10,光和,2023-04-21,6380
2820,華票,10,0,10,光和,2023-04-21,6380
00680L,元大美債20正2,100,0,100,光和,2023-04-24,6380
6244,茂迪,29,1,28,光和,2023-04-24,6380
00637L,元大滬深300正2,73,51,22,光和,2023-04-24,6380
6770,力積電,19,1,18,光和,2023-04-24,6380
2303,聯電,20,2,18,光和,2023-04-24,6380
1907,永豐餘,19,2,17,光和,2023-04-24,6380
8099,大世科,16,0,16,光和,2023-04-24,6380
2732,六角,16,1,15,光和,2023-04-24,6380
2913,農林,29,15,14,光和,2023-04-24,6380
6122,擎邦,13,0,13,光和,2023-04-24,6380
6282,康舒,31,18,13,光和,2023-04-24,6380
1711,永光,25,13,12,光和,2023-04-24,6380
5704,老爺知,11,0,11,光和,2023-04-24,6380
1316,上曜,10,0,10,光和,2023-04-24,6380
00673R,期元大S＆P原油反1,10,0,10,光和,2023-04-24,6380
2313,華通,10,0,10,光和,2023-04-24,6380
2633,台灣高鐵,10,0,10,光和,2023-04-24,6380
2820,華票,10,0,10,光和,2023-04-24,6380
3339,泰谷,10,0,10,光和,2023-04-24,6380
3704,合勤控,10,0,10,光和,2023-04-24,6380
6015,宏遠證,10,0,10,光和,2023-04-24,6380
6606,建德工業,10,0,10,光和,2023-04-24,6380
2302,麗正,25,16,9,光和,2023-04-24,6380
2453,凌群,20,11,9,光和,2023-04-24,6380
3038,全台,17,8,9,光和,2023-04-24,6380
1786,科妍,8,0,8,光和,2023-04-24,6380
2634,漢翔,14,6,8,光和,2023-04-24,6380
5009,榮剛,12,4,8,光和,2023-04-24,6380
8222,寶一,10,3,7,光和,2023-04-24,6380
2324,仁寶,8,1,7,光和,2023-04-24,6380
5347,世界,9,2,7,光和,2023-04-24,6380
00720B,元大投資級公司債,6,0,6,光和,2023-04-24,6380
00902,中信電池及儲能,13,7,6,光和,2023-04-24,6380
00679B,元大美債20年,8,2,6,光和,2023-04-24,6380
2495,普安,9,3,6,光和,2023-04-24,6380
2605,新興,6,0,6,光和,2023-04-24,6380
6148,驊宏資,9,3,6,光和,2023-04-24,6380
2419,仲琦,6,0,6,光和,2023-04-24,6380
1313,聯成,10,5,5,光和,2023-04-24,6380
2108,南帝,5,0,5,光和,2023-04-24,6380
2867,三商壽,5,0,5,光和,2023-04-24,6380
2892,第一金,5,0,5,光和,2023-04-24,6380
3501,維熹,5,0,5,光和,2023-04-24,6380
5011,久陽,5,0,5,光和,2023-04-24,6380
6165,浪凡,5,0,5,光和,2023-04-24,6380
3661,世芯-KY,5,0,5,光和,2023-04-24,6380
1410,南染,4,0,4,光和,2023-04-24,6380
1611,中電,55,51,4,光和,2023-04-24,6380
2353,宏��,4,0,4,光和,2023-04-24,6380
2601,益航,5,1,4,光和,2023-04-24,6380
00900,富邦特選高股息30,139,0,139,光和,2023-04-25,6380
6770,力積電,68,1,67,光和,2023-04-25,6380
00665L,富邦�琤肭磪囓�2,73,9,64,光和,2023-04-25,6380
6163,華電網,66,19,47,光和,2023-04-25,6380
8069,元太,46,4,42,光和,2023-04-25,6380
1905,華紙,72,35,37,光和,2023-04-25,6380
6244,茂迪,34,0,34,光和,2023-04-25,6380
3548,兆利,32,0,32,光和,2023-04-25,6380
3029,零壹,29,0,29,光和,2023-04-25,6380
2208,台船,34,6,28,光和,2023-04-25,6380
2204,中華,28,0,28,光和,2023-04-25,6380
4566,時碩工業,35,9,26,光和,2023-04-25,6380
2368,金像電,25,0,25,光和,2023-04-25,6380
00902,中信電池及儲能,27,3,24,光和,2023-04-25,6380
2002,中鋼,23,0,23,光和,2023-04-25,6380
6153,嘉聯益,23,0,23,光和,2023-04-25,6380
3231,緯創,33,12,21,光和,2023-04-25,6380
2812,台中銀,20,0,20,光和,2023-04-25,6380
2820,華票,20,0,20,光和,2023-04-25,6380
00679B,元大美債20年,19,0,19,光和,2023-04-25,6380
2609,陽明,21,2,19,光和,2023-04-25,6380
1904,正隆,21,3,18,光和,2023-04-25,6380
1337,再生-KY,20,3,17,光和,2023-04-25,6380
2489,瑞軒,17,0,17,光和,2023-04-25,6380
6282,康舒,19,3,16,光和,2023-04-25,6380
6257,矽格,16,1,15,光和,2023-04-25,6380
3706,神達,15,0,15,光和,2023-04-25,6380
6457,紘康,15,0,15,光和,2023-04-25,6380
8271,宇瞻,15,0,15,光和,2023-04-25,6380
8478,東哥遊艇,15,0,15,光和,2023-04-25,6380
2303,聯電,14,0,14,光和,2023-04-25,6380
1504,東元,17,3,14,光和,2023-04-25,6380
1714,和桐,14,0,14,光和,2023-04-25,6380
1802,台玻,15,1,14,光和,2023-04-25,6380
2423,固緯,19,5,14,光和,2023-04-25,6380
2891,中信金,15,1,14,光和,2023-04-25,6380
2337,旺宏,260,247,13,光和,2023-04-25,6380
4706,大恭,13,0,13,光和,2023-04-25,6380
8171,天宇,13,0,13,光和,2023-04-25,6380
2867,三商壽,12,0,12,光和,2023-04-25,6380
1410,南染,11,0,11,光和,2023-04-25,6380
1605,華新,13,2,11,光和,2023-04-25,6380
2605,新興,11,0,11,光和,2023-04-25,6380
2618,長榮航,12,1,11,光和,2023-04-25,6380
4743,合一,15,4,11,光和,2023-04-25,6380
6109,亞元,11,0,11,光和,2023-04-25,6380
9904,寶成,11,0,11,光和,2023-04-25,6380
8091,翔名,10,0,10,光和,2023-04-25,6380
00680L,元大美債20正2,10,0,10,光和,2023-04-25,6380
00688L,國泰20年美債正2,10,0,10,光和,2023-04-25,6380
00885,富邦越南,75,1,74,光和,2023-04-26,6380
2515,中工,55,0,55,光和,2023-04-26,6380
8215,明基材,50,0,50,光和,2023-04-26,6380
2888,新光金,42,0,42,光和,2023-04-26,6380
2484,希華,40,0,40,光和,2023-04-26,6380
00715L,期街口布蘭特正2,35,0,35,光和,2023-04-26,6380
2002,中鋼,29,0,29,光和,2023-04-26,6380
4306,炎洲,30,1,29,光和,2023-04-26,6380
00712,復華富時不動產,27,0,27,光和,2023-04-26,6380
3363,上詮,30,3,27,光和,2023-04-26,6380
2303,聯電,27,1,26,光和,2023-04-26,6380
1108,幸福,27,4,23,光和,2023-04-26,6380
00900,富邦特選高股息30,22,0,22,光和,2023-04-26,6380
2359,所羅門,20,0,20,光和,2023-04-26,6380
2891,中信金,20,0,20,光和,2023-04-26,6380
2897,王道銀行,20,0,20,光和,2023-04-26,6380
5512,力麒,30,10,20,光和,2023-04-26,6380
6457,紘康,20,0,20,光和,2023-04-26,6380
2208,台船,25,6,19,光和,2023-04-26,6380
5392,能率,17,1,16,光和,2023-04-26,6380
6496,科懋,16,0,16,光和,2023-04-26,6380
2615,萬海,15,0,15,光和,2023-04-26,6380
9902,台火,15,0,15,光和,2023-04-26,6380
00878,國泰永續高股息,21,7,14,光和,2023-04-26,6380
3035,智原,14,1,13,光和,2023-04-26,6380
2609,陽明,12,0,12,光和,2023-04-26,6380
2340,台亞,21,9,12,光和,2023-04-26,6380
2337,旺宏,184,173,11,光和,2023-04-26,6380
00692,富邦公司治理,10,0,10,光和,2023-04-26,6380
1326,台化,10,0,10,光和,2023-04-26,6380
2017,官田鋼,10,0,10,光和,2023-04-26,6380
3548,兆利,13,3,10,光和,2023-04-26,6380
5203,訊連,10,0,10,光和,2023-04-26,6380
1783,和康生,10,1,9,光和,2023-04-26,6380
2344,華邦電,10,1,9,光和,2023-04-26,6380
2892,第一金,10,1,9,光和,2023-04-26,6380
8222,寶一,13,5,8,光和,2023-04-26,6380
1560,中砂,11,3,8,光和,2023-04-26,6380
1709,和益,8,0,8,光和,2023-04-26,6380
2105,正新,10,2,8,光和,2023-04-26,6380
2605,新興,11,3,8,光和,2023-04-26,6380
5245,智晶,8,0,8,光和,2023-04-26,6380
6770,力積電,14,6,8,光和,2023-04-26,6380
8072,陞泰,8,0,8,光和,2023-04-26,6380
2352,佳世達,12,5,7,光和,2023-04-26,6380
4121,優盛,7,0,7,光和,2023-04-26,6380
2913,農林,21,15,6,光和,2023-04-26,6380
00720B,元大投資級公司債,6,0,6,光和,2023-04-26,6380
1513,中興電,7,1,6,光和,2023-04-26,6380
1718,中纖,8,2,6,光和,2023-04-26,6380
00715L,期街口布蘭特正2,58,0,58,光和,2023-04-27,6380
5388,中磊,40,0,40,光和,2023-04-27,6380
6770,力積電,51,11,40,光和,2023-04-27,6380
2002,中鋼,34,1,33,光和,2023-04-27,6380
4960,誠美材,30,0,30,光和,2023-04-27,6380
1711,永光,62,34,28,光和,2023-04-27,6380
6148,驊宏資,35,7,28,光和,2023-04-27,6380
2609,陽明,30,3,27,光和,2023-04-27,6380
2883,凱基金,30,7,23,光和,2023-04-27,6380
2413,環科,21,1,20,光和,2023-04-27,6380
2344,華邦電,22,2,20,光和,2023-04-27,6380
2701,萬企,20,0,20,光和,2023-04-27,6380
6153,嘉聯益,20,0,20,光和,2023-04-27,6380
2603,長榮,20,1,19,光和,2023-04-27,6380
1217,愛之味,16,0,16,光和,2023-04-27,6380
1718,中纖,32,16,16,光和,2023-04-27,6380
1731,美吾華,20,4,16,光和,2023-04-27,6380
6282,康舒,18,2,16,光和,2023-04-27,6380
2317,鴻海,15,0,15,光和,2023-04-27,6380
00665L,富邦�琤肭磪囓�2,15,0,15,光和,2023-04-27,6380
2034,允強,15,0,15,光和,2023-04-27,6380
2353,宏��,20,5,15,光和,2023-04-27,6380
5392,能率,15,0,15,光和,2023-04-27,6380
6531,愛普*,46,32,14,光和,2023-04-27,6380
00878,國泰永續高股息,13,0,13,光和,2023-04-27,6380
1714,和桐,20,7,13,光和,2023-04-27,6380
2492,華新科,13,0,13,光和,2023-04-27,6380
1907,永豐餘,11,0,11,光和,2023-04-27,6380
2105,正新,12,1,11,光和,2023-04-27,6380
4123,晟德,11,0,11,光和,2023-04-27,6380
3048,益登,10,0,10,光和,2023-04-27,6380
00908,富邦入息REITs+,10,0,10,光和,2023-04-27,6380
1605,華新,17,7,10,光和,2023-04-27,6380
2461,光群雷,10,0,10,光和,2023-04-27,6380
9955,佳龍,10,0,10,光和,2023-04-27,6380
00712,復華富時不動產,9,0,9,光和,2023-04-27,6380
2820,華票,9,0,9,光和,2023-04-27,6380
2888,新光金,13,4,9,光和,2023-04-27,6380
8046,南電,11,2,9,光和,2023-04-27,6380
5009,榮剛,12,3,9,光和,2023-04-27,6380
00772B,中信高評級公司債,8,0,8,光和,2023-04-27,6380
2324,仁寶,10,2,8,光和,2023-04-27,6380
2455,全新,10,2,8,光和,2023-04-27,6380
8059,凱碩,8,0,8,光和,2023-04-27,6380
00679B,元大美債20年,7,0,7,光和,2023-04-27,6380
2014,中鴻,8,1,7,光和,2023-04-27,6380
00642U,期元大S＆P石油,7,0,7,光和,2023-04-27,6380
1909,榮成,7,0,7,光和,2023-04-27,6380
5263,智崴,7,0,7,光和,2023-04-27,6380
8409,商之器,7,0,7,光和,2023-04-27,6380
00632R,元大台灣50反1,338,31,307,光和,2023-04-28,6380
2495,普安,155,25,130,光和,2023-04-28,6380
3481,群創,126,13,113,光和,2023-04-28,6380
1711,永光,110,4,106,光和,2023-04-28,6380
2888,新光金,115,10,105,光和,2023-04-28,6380
4207,環泰,150,50,100,光和,2023-04-28,6380
2409,友達,77,0,77,光和,2023-04-28,6380
3715,定穎投控,41,0,41,光和,2023-04-28,6380
6148,驊宏資,36,0,36,光和,2023-04-28,6380
8222,寶一,53,25,28,光和,2023-04-28,6380
2880,華南金,36,9,27,光和,2023-04-28,6380
6266,泰詠,34,9,25,光和,2023-04-28,6380
4973,廣穎,23,1,22,光和,2023-04-28,6380
00679B,元大美債20年,21,0,21,光和,2023-04-28,6380
3704,合勤控,21,2,19,光和,2023-04-28,6380
1605,華新,20,2,18,光和,2023-04-28,6380
5009,榮剛,36,18,18,光和,2023-04-28,6380
1809,中釉,19,3,16,光和,2023-04-28,6380
2413,環科,16,0,16,光和,2023-04-28,6380
2707,晶華,15,0,15,光和,2023-04-28,6380
3548,兆利,15,0,15,光和,2023-04-28,6380
00882,中信中國高股息,14,0,14,光和,2023-04-28,6380
1721,三晃,15,2,13,光和,2023-04-28,6380
5351,鈺創,17,4,13,光和,2023-04-28,6380
1710,東聯,17,5,12,光和,2023-04-28,6380
2204,中華,20,8,12,光和,2023-04-28,6380
2002,中鋼,12,0,12,光和,2023-04-28,6380
1717,長興,11,0,11,光和,2023-04-28,6380
2388,威盛,11,0,11,光和,2023-04-28,6380
1727,中華化,54,44,10,光和,2023-04-28,6380
2610,華航,11,1,10,光和,2023-04-28,6380
2820,華票,10,0,10,光和,2023-04-28,6380
6770,力積電,17,7,10,光和,2023-04-28,6380
2303,聯電,14,5,9,光和,2023-04-28,6380
2344,華邦電,23,14,9,光和,2023-04-28,6380
3325,旭品,9,0,9,光和,2023-04-28,6380
8088,品安,10,1,9,光和,2023-04-28,6380
1731,美吾華,10,2,8,光和,2023-04-28,6380
6288,聯嘉,13,5,8,光和,2023-04-28,6380
8028,昇陽半導體,10,2,8,光和,2023-04-28,6380
9955,佳龍,8,0,8,光和,2023-04-28,6380
3711,日月光投控,8,0,8,光和,2023-04-28,6380
6443,元晶,6,0,6,光和,2023-04-28,6380
00900,富邦特選高股息30,6,0,6,光和,2023-04-28,6380
1810,和成,6,0,6,光和,2023-04-28,6380
2031,新光鋼,6,0,6,光和,2023-04-28,6380
2323,中環,6,0,6,光和,2023-04-28,6380
3447,展達,6,0,6,光和,2023-04-28,6380
3708,上緯投控,7,1,6,光和,2023-04-28,6380
4532,瑞智,6,0,6,光和,2023-04-28,6380
1314,中石化,129,1,128,光和,2023-05-02,6380
3481,群創,121,52,69,光和,2023-05-02,6380
1609,大亞,126,59,67,光和,2023-05-02,6380
0056,元大高股息,53,1,52,光和,2023-05-02,6380
2880,華南金,51,0,51,光和,2023-05-02,6380
00632R,元大台灣50反1,67,20,47,光和,2023-05-02,6380
00665L,富邦�琤肭磪囓�2,90,50,40,光和,2023-05-02,6380
00712,復華富時不動產,38,0,38,光和,2023-05-02,6380
4915,致伸,31,0,31,光和,2023-05-02,6380
1528,恩德,30,0,30,光和,2023-05-02,6380
2731,雄獅,31,1,30,光和,2023-05-02,6380
5371,中光電,33,4,29,光和,2023-05-02,6380
6443,元晶,29,4,25,光和,2023-05-02,6380
911868,同方友友-DR,25,0,25,光和,2023-05-02,6380
2022,聚亨,29,8,21,光和,2023-05-02,6380
3548,兆利,21,0,21,光和,2023-05-02,6380
00639,富邦深100,20,0,20,光和,2023-05-02,6380
00772B,中信高評級公司債,20,0,20,光和,2023-05-02,6380
3363,上詮,23,3,20,光和,2023-05-02,6380
2603,長榮,26,7,19,光和,2023-05-02,6380
2615,萬海,19,0,19,光和,2023-05-02,6380
6733,博晟生醫,20,1,19,光和,2023-05-02,6380
2027,大成鋼,20,3,17,光和,2023-05-02,6380
2482,連宇,20,3,17,光和,2023-05-02,6380
4706,大恭,17,0,17,光和,2023-05-02,6380
2412,中華電,15,0,15,光和,2023-05-02,6380
2609,陽明,16,2,14,光和,2023-05-02,6380
00878,國泰永續高股息,17,4,13,光和,2023-05-02,6380
00720B,元大投資級公司債,13,0,13,光和,2023-05-02,6380
2002,中鋼,14,1,13,光和,2023-05-02,6380
6531,愛普*,16,5,11,光和,2023-05-02,6380
2409,友達,14,3,11,光和,2023-05-02,6380
5009,榮剛,24,13,11,光和,2023-05-02,6380
2476,鉅祥,10,0,10,光和,2023-05-02,6380
2515,中工,20,10,10,光和,2023-05-02,6380
3048,益登,10,0,10,光和,2023-05-02,6380
8440,綠電,10,0,10,光和,2023-05-02,6380
1514,亞力,25,16,9,光和,2023-05-02,6380
3356,奇偶,9,0,9,光和,2023-05-02,6380
2516,新建,8,0,8,光和,2023-05-02,6380
3006,晶豪科,11,3,8,光和,2023-05-02,6380
3056,富華新,8,0,8,光和,2023-05-02,6380
3576,聯合再生,8,0,8,光和,2023-05-02,6380
4979,華星光,12,4,8,光和,2023-05-02,6380
1460,宏遠,8,1,7,光和,2023-05-02,6380
4566,時碩工業,8,1,7,光和,2023-05-02,6380
6190,萬泰科,9,2,7,光和,2023-05-02,6380
6470,宇智,7,0,7,光和,2023-05-02,6380
00679B,元大美債20年,6,0,6,光和,2023-05-02,6380
1310,台苯,6,0,6,光和,2023-05-02,6380
00632R,元大台灣50反1,312,0,312,光和,2023-05-03,6380
5475,德宏,234,0,234,光和,2023-05-03,6380
00712,復華富時不動產,88,0,88,光和,2023-05-03,6380
00878,國泰永續高股息,94,8,86,光和,2023-05-03,6380
00715L,期街口布蘭特正2,56,0,56,光和,2023-05-03,6380
3481,群創,62,11,51,光和,2023-05-03,6380
4706,大恭,46,4,42,光和,2023-05-03,6380
2615,萬海,41,5,36,光和,2023-05-03,6380
00637L,元大滬深300正2,35,0,35,光和,2023-05-03,6380
1514,亞力,37,2,35,光和,2023-05-03,6380
8222,寶一,35,3,32,光和,2023-05-03,6380
0056,元大高股息,31,1,30,光和,2023-05-03,6380
4111,濟生,31,1,30,光和,2023-05-03,6380
2603,長榮,54,25,29,光和,2023-05-03,6380
2027,大成鋼,30,2,28,光和,2023-05-03,6380
1314,中石化,22,0,22,光和,2023-05-03,6380
4541,晟田,27,6,21,光和,2023-05-03,6380
1711,永光,21,0,21,光和,2023-05-03,6380
2409,友達,20,0,20,光和,2023-05-03,6380
2801,彰銀,20,0,20,光和,2023-05-03,6380
1101,台泥,24,4,20,光和,2023-05-03,6380
3078,僑威,25,6,19,光和,2023-05-03,6380
2455,全新,20,2,18,光和,2023-05-03,6380
4129,聯合,17,0,17,光和,2023-05-03,6380
00665L,富邦�琤肭磪囓�2,13,0,13,光和,2023-05-03,6380
00753L,中信中國50正2,13,0,13,光和,2023-05-03,6380
6753,龍德造船,12,0,12,光和,2023-05-03,6380
3419,譁裕,54,43,11,光和,2023-05-03,6380
4979,華星光,16,5,11,光和,2023-05-03,6380
6163,華電網,15,4,11,光和,2023-05-03,6380
6269,台郡,11,0,11,光和,2023-05-03,6380
8086,宏捷科,11,0,11,光和,2023-05-03,6380
3231,緯創,30,19,11,光和,2023-05-03,6380
9907,統一實,10,0,10,光和,2023-05-03,6380
1326,台化,10,0,10,光和,2023-05-03,6380
00772B,中信高評級公司債,10,0,10,光和,2023-05-03,6380
2313,華通,10,0,10,光和,2023-05-03,6380
2329,華泰,10,0,10,光和,2023-05-03,6380
2349,錸德,10,0,10,光和,2023-05-03,6380
2887,台新金,10,0,10,光和,2023-05-03,6380
5309,系統電,10,0,10,光和,2023-05-03,6380
6799,來頡,10,0,10,光和,2023-05-03,6380
2516,新建,9,0,9,光和,2023-05-03,6380
5465,富驊,9,0,9,光和,2023-05-03,6380
00713,元大台灣高息低波,10,1,9,光和,2023-05-03,6380
00642U,期元大S＆P石油,8,0,8,光和,2023-05-03,6380
3715,定穎投控,9,1,8,光和,2023-05-03,6380
6244,茂迪,11,3,8,光和,2023-05-03,6380
3056,富華新,7,0,7,光和,2023-05-03,6380
2031,新光鋼,7,0,7,光和,2023-05-03,6380
00712,復華富時不動產,164,0,164,光和,2023-05-04,6380
00715L,期街口布蘭特正2,79,0,79,光和,2023-05-04,6380
5512,力麒,71,0,71,光和,2023-05-04,6380
3013,晟銘電,44,0,44,光和,2023-05-04,6380
00632R,元大台灣50反1,46,3,43,光和,2023-05-04,6380
4111,濟生,30,1,29,光和,2023-05-04,6380
3419,譁裕,38,12,26,光和,2023-05-04,6380
6550,北極星藥業-KY,29,3,26,光和,2023-05-04,6380
3325,旭品,25,0,25,光和,2023-05-04,6380
1905,華紙,40,17,23,光和,2023-05-04,6380
4744,皇將,24,2,22,光和,2023-05-04,6380
4906,正文,22,0,22,光和,2023-05-04,6380
1514,亞力,24,3,21,光和,2023-05-04,6380
6269,台郡,22,1,21,光和,2023-05-04,6380
3481,群創,32,13,19,光和,2023-05-04,6380
6284,佳邦,18,0,18,光和,2023-05-04,6380
2002,中鋼,16,0,16,光和,2023-05-04,6380
2801,彰銀,15,0,15,光和,2023-05-04,6380
3694,海華,14,0,14,光和,2023-05-04,6380
2317,鴻海,14,0,14,光和,2023-05-04,6380
2344,華邦電,17,5,12,光和,2023-05-04,6380
00642U,期元大S＆P石油,11,0,11,光和,2023-05-04,6380
6244,茂迪,12,1,11,光和,2023-05-04,6380
2538,基泰,10,0,10,光和,2023-05-04,6380
2609,陽明,10,0,10,光和,2023-05-04,6380
3128,昇銳,13,3,10,光和,2023-05-04,6380
1776,展宇,10,0,10,光和,2023-05-04,6380
1101,台泥,15,6,9,光和,2023-05-04,6380
00772B,中信高評級公司債,9,0,9,光和,2023-05-04,6380
2615,萬海,18,9,9,光和,2023-05-04,6380
3005,神基,12,3,9,光和,2023-05-04,6380
3231,緯創,38,30,8,光和,2023-05-04,6380
3588,通嘉,8,0,8,光和,2023-05-04,6380
4129,聯合,12,4,8,光和,2023-05-04,6380
4564,元翎,8,0,8,光和,2023-05-04,6380
6116,彩晶,18,10,8,光和,2023-05-04,6380
9919,康那香,13,5,8,光和,2023-05-04,6380
00877,復華中國5G,7,0,7,光和,2023-05-04,6380
2468,華經,10,3,7,光和,2023-05-04,6380
2484,希華,7,0,7,光和,2023-05-04,6380
2489,瑞軒,10,3,7,光和,2023-05-04,6380
4979,華星光,12,5,7,光和,2023-05-04,6380
5475,德宏,8,1,7,光和,2023-05-04,6380
8222,寶一,7,0,7,光和,2023-05-04,6380
2201,裕隆,6,0,6,光和,2023-05-04,6380
1529,樂事綠能,6,0,6,光和,2023-05-04,6380
1598,岱宇,6,0,6,光和,2023-05-04,6380
2302,麗正,6,0,6,光和,2023-05-04,6380
2457,飛宏,13,7,6,光和,2023-05-04,6380
3078,僑威,10,4,6,光和,2023-05-04,6380
00712,復華富時不動產,83,0,83,光和,2023-05-05,6380
2353,宏��,95,22,73,光和,2023-05-05,6380
1609,大亞,82,26,56,光和,2023-05-05,6380
3230,錦明,52,0,52,光和,2023-05-05,6380
6472,保瑞,51,2,49,光和,2023-05-05,6380
3591,艾笛森,48,6,42,光和,2023-05-05,6380
6531,愛普*,36,4,32,光和,2023-05-05,6380
2359,所羅門,32,0,32,光和,2023-05-05,6380
3231,緯創,33,2,31,光和,2023-05-05,6380
00885,富邦越南,30,0,30,光和,2023-05-05,6380
8215,明基材,28,1,27,光和,2023-05-05,6380
3481,群創,28,2,26,光和,2023-05-05,6380
6244,茂迪,24,0,24,光和,2023-05-05,6380
2891,中信金,27,5,22,光和,2023-05-05,6380
4111,濟生,20,0,20,光和,2023-05-05,6380
6226,光鼎,19,0,19,光和,2023-05-05,6380
1802,台玻,18,0,18,光和,2023-05-05,6380
2801,彰銀,20,2,18,光和,2023-05-05,6380
3006,晶豪科,17,0,17,光和,2023-05-05,6380
4968,立積,18,2,16,光和,2023-05-05,6380
2371,大同,15,0,15,光和,2023-05-05,6380
3047,訊舟,15,0,15,光和,2023-05-05,6380
3706,神達,15,0,15,光和,2023-05-05,6380
6527,明達醫,15,0,15,光和,2023-05-05,6380
8043,蜜望實,16,1,15,光和,2023-05-05,6380
1529,樂事綠能,21,7,14,光和,2023-05-05,6380
2204,中華,14,0,14,光和,2023-05-05,6380
6496,科懋,14,0,14,光和,2023-05-05,6380
1101,台泥,17,5,12,光和,2023-05-05,6380
2358,廷鑫,16,4,12,光和,2023-05-05,6380
2457,飛宏,19,8,11,光和,2023-05-05,6380
1104,環泥,11,0,11,光和,2023-05-05,6380
1718,中纖,11,0,11,光和,2023-05-05,6380
6112,邁達特,15,5,10,光和,2023-05-05,6380
1220,台榮,10,0,10,光和,2023-05-05,6380
0056,元大高股息,10,0,10,光和,2023-05-05,6380
00772B,中信高評級公司債,10,0,10,光和,2023-05-05,6380
2337,旺宏,10,0,10,光和,2023-05-05,6380
4168,醣聯,10,0,10,光和,2023-05-05,6380
6733,博晟生醫,12,2,10,光和,2023-05-05,6380
9930,中聯資源,10,0,10,光和,2023-05-05,6380
6550,北極星藥業-KY,10,0,10,光和,2023-05-05,6380
00720B,元大投資級公司債,9,0,9,光和,2023-05-05,6380
1314,中石化,9,0,9,光和,2023-05-05,6380
00756B,群益投等新興公債,14,5,9,光和,2023-05-05,6380
2610,華航,11,2,9,光和,2023-05-05,6380
4906,正文,11,2,9,光和,2023-05-05,6380
8093,保銳,9,0,9,光和,2023-05-05,6380
8088,品安,8,0,8,光和,2023-05-05,6380
00751B,元大AAA至A公司債,7,0,7,光和,2023-05-05,6380
2883,凱基金,163,51,112,光和,2023-05-08,6380
00897,富邦基因免疫生技,50,0,50,光和,2023-05-08,6380
1434,福懋,46,0,46,光和,2023-05-08,6380
00679B,元大美債20年,45,1,44,光和,2023-05-08,6380
1605,華新,85,42,43,光和,2023-05-08,6380
2605,新興,36,0,36,光和,2023-05-08,6380
4566,時碩工業,36,0,36,光和,2023-05-08,6380
5498,凱崴,49,14,35,光和,2023-05-08,6380
2609,陽明,40,5,35,光和,2023-05-08,6380
1451,年興,31,1,30,光和,2023-05-08,6380
1217,愛之味,30,0,30,光和,2023-05-08,6380
1711,永光,39,11,28,光和,2023-05-08,6380
6125,廣運,29,2,27,光和,2023-05-08,6380
2371,大同,42,17,25,光和,2023-05-08,6380
8926,台汽電,35,12,23,光和,2023-05-08,6380
3715,定穎投控,27,5,22,光和,2023-05-08,6380
3703,欣陸,20,0,20,光和,2023-05-08,6380
3706,神達,25,5,20,光和,2023-05-08,6380
2834,臺企銀,20,2,18,光和,2023-05-08,6380
00720B,元大投資級公司債,16,0,16,光和,2023-05-08,6380
1718,中纖,15,0,15,光和,2023-05-08,6380
1734,杏輝,17,2,15,光和,2023-05-08,6380
2353,宏��,19,4,15,光和,2023-05-08,6380
1314,中石化,14,0,14,光和,2023-05-08,6380
1584,精剛,13,0,13,光和,2023-05-08,6380
00632R,元大台灣50反1,12,0,12,光和,2023-05-08,6380
1710,東聯,19,7,12,光和,2023-05-08,6380
2408,南亞科,15,3,12,光和,2023-05-08,6380
2492,華新科,13,1,12,光和,2023-05-08,6380
3325,旭品,13,1,12,光和,2023-05-08,6380
3521,鴻翊,12,0,12,光和,2023-05-08,6380
6457,紘康,11,0,11,光和,2023-05-08,6380
8358,金居,11,0,11,光和,2023-05-08,6380
1609,大亞,33,22,11,光和,2023-05-08,6380
00751B,元大AAA至A公司債,10,0,10,光和,2023-05-08,6380
2033,佳大,10,0,10,光和,2023-05-08,6380
4102,永日,10,0,10,光和,2023-05-08,6380
5464,霖宏,10,0,10,光和,2023-05-08,6380
1215,卜蜂,10,0,10,光和,2023-05-08,6380
3043,科風,9,0,9,光和,2023-05-08,6380
4967,十銓,11,2,9,光和,2023-05-08,6380
3265,台星科,10,2,8,光和,2023-05-08,6380
2356,英業達,8,0,8,光和,2023-05-08,6380
2358,廷鑫,8,0,8,光和,2023-05-08,6380
3545,敦泰,9,1,8,光和,2023-05-08,6380
4755,三福化,8,0,8,光和,2023-05-08,6380
9955,佳龍,8,0,8,光和,2023-05-08,6380
2468,華經,11,4,7,光和,2023-05-08,6380
2482,連宇,16,9,7,光和,2023-05-08,6380
6418,詠昇,7,0,7,光和,2023-05-08,6380
1314,中石化,115,0,115,光和,2023-05-09,6380
1711,永光,57,0,57,光和,2023-05-09,6380
3029,零壹,59,9,50,光和,2023-05-09,6380
6244,茂迪,55,8,47,光和,2023-05-09,6380
6443,元晶,51,8,43,光和,2023-05-09,6380
2883,凱基金,41,0,41,光和,2023-05-09,6380
00882,中信中國高股息,62,25,37,光和,2023-05-09,6380
2387,精元,31,3,28,光和,2023-05-09,6380
2609,陽明,27,2,25,光和,2023-05-09,6380
2504,國產,24,0,24,光和,2023-05-09,6380
1513,中興電,27,5,22,光和,2023-05-09,6380
2812,台中銀,43,21,22,光和,2023-05-09,6380
1504,東元,24,3,21,光和,2023-05-09,6380
3325,旭品,21,1,20,光和,2023-05-09,6380
2501,國建,19,0,19,光和,2023-05-09,6380
3576,聯合再生,18,0,18,光和,2023-05-09,6380
1529,樂事綠能,17,0,17,光和,2023-05-09,6380
1609,大亞,22,5,17,光和,2023-05-09,6380
1718,中纖,17,0,17,光和,2023-05-09,6380
3715,定穎投控,36,19,17,光和,2023-05-09,6380
00687B,國泰20年美債,16,0,16,光和,2023-05-09,6380
3147,大綜,15,0,15,光和,2023-05-09,6380
6282,康舒,15,0,15,光和,2023-05-09,6380
1101,台泥,15,1,14,光和,2023-05-09,6380
2352,佳世達,25,11,14,光和,2023-05-09,6380
6116,彩晶,14,0,14,光和,2023-05-09,6380
00720B,元大投資級公司債,14,0,14,光和,2023-05-09,6380
1215,卜蜂,13,0,13,光和,2023-05-09,6380
3005,神基,13,0,13,光和,2023-05-09,6380
3706,神達,13,0,13,光和,2023-05-09,6380
00712,復華富時不動產,12,0,12,光和,2023-05-09,6380
1904,正隆,23,12,11,光和,2023-05-09,6380
00751B,元大AAA至A公司債,11,0,11,光和,2023-05-09,6380
0056,元大高股息,11,0,11,光和,2023-05-09,6380
1720,生達,12,1,11,光和,2023-05-09,6380
2204,中華,12,1,11,光和,2023-05-09,6380
6457,紘康,11,0,11,光和,2023-05-09,6380
6112,邁達特,15,4,11,光和,2023-05-09,6380
1701,中化,10,0,10,光和,2023-05-09,6380
2451,創見,10,0,10,光和,2023-05-09,6380
3058,立德,10,0,10,光和,2023-05-09,6380
5211,蒙恬,10,0,10,光和,2023-05-09,6380
8111,立��,10,0,10,光和,2023-05-09,6380
2359,所羅門,10,1,9,光和,2023-05-09,6380
6496,科懋,9,0,9,光和,2023-05-09,6380
2439,美律,8,0,8,光和,2023-05-09,6380
2634,漢翔,10,2,8,光和,2023-05-09,6380
3646,艾恩特,8,0,8,光和,2023-05-09,6380
6233,旺玖,8,0,8,光和,2023-05-09,6380
9933,中鼎,8,0,8,光和,2023-05-09,6380
00637L,元大滬深300正2,109,3,106,光和,2023-05-10,6380
1605,華新,108,5,103,光和,2023-05-10,6380
00878,國泰永續高股息,66,7,59,光和,2023-05-10,6380
00665L,富邦�琤肭磪囓�2,55,0,55,光和,2023-05-10,6380
1609,大亞,54,7,47,光和,2023-05-10,6380
1513,中興電,32,2,30,光和,2023-05-10,6380
1711,永光,30,1,29,光和,2023-05-10,6380
1905,華紙,27,2,25,光和,2023-05-10,6380
3231,緯創,24,2,22,光和,2023-05-10,6380
00680L,元大美債20正2,20,0,20,光和,2023-05-10,6380
4979,華星光,21,2,19,光和,2023-05-10,6380
8033,雷虎,22,4,18,光和,2023-05-10,6380
2342,茂矽,17,0,17,光和,2023-05-10,6380
2330,台積電,16,0,16,光和,2023-05-10,6380
1101,台泥,16,0,16,光和,2023-05-10,6380
2888,新光金,18,3,15,光和,2023-05-10,6380
6112,邁達特,21,6,15,光和,2023-05-10,6380
00679B,元大美債20年,13,0,13,光和,2023-05-10,6380
1529,樂事綠能,19,6,13,光和,2023-05-10,6380
1718,中纖,13,0,13,光和,2023-05-10,6380
2406,國碩,12,0,12,光和,2023-05-10,6380
6457,紘康,12,0,12,光和,2023-05-10,6380
2413,環科,12,1,11,光和,2023-05-10,6380
1802,台玻,11,0,11,光和,2023-05-10,6380
1444,力麗,10,0,10,光和,2023-05-10,6380
2867,三商壽,10,0,10,光和,2023-05-10,6380
3325,旭品,10,0,10,光和,2023-05-10,6380
3682,亞太電,10,0,10,光和,2023-05-10,6380
3715,定穎投控,11,1,10,光和,2023-05-10,6380
6806,森崴能源,12,2,10,光和,2023-05-10,6380
1314,中石化,11,2,9,光和,2023-05-10,6380
5355,佳總,9,0,9,光和,2023-05-10,6380
1907,永豐餘,8,0,8,光和,2023-05-10,6380
3703,欣陸,8,0,8,光和,2023-05-10,6380
5227,立凱-KY,8,0,8,光和,2023-05-10,6380
3455,由田,8,1,7,光和,2023-05-10,6380
00772B,中信高評級公司債,6,0,6,光和,2023-05-10,6380
1611,中電,7,1,6,光和,2023-05-10,6380
2812,台中銀,10,4,6,光和,2023-05-10,6380
2845,遠東銀,6,0,6,光和,2023-05-10,6380
2913,農林,7,1,6,光和,2023-05-10,6380
3481,群創,7,1,6,光和,2023-05-10,6380
6213,聯茂,6,0,6,光和,2023-05-10,6380
6231,系微,6,0,6,光和,2023-05-10,6380
6527,明達醫,6,0,6,光和,2023-05-10,6380
6712,長聖,6,0,6,光和,2023-05-10,6380
2344,華邦電,7,1,6,光和,2023-05-10,6380
2317,鴻海,6,1,5,光和,2023-05-10,6380
1316,上曜,5,0,5,光和,2023-05-10,6380
00687B,國泰20年美債,5,0,5,光和,2023-05-10,6380
1711,永光,151,0,151,光和,2023-05-11,6380
1447,力鵬,43,0,43,光和,2023-05-11,6380
1609,大亞,56,21,35,光和,2023-05-11,6380
1701,中化,31,0,31,光和,2023-05-11,6380
2883,凱基金,34,3,31,光和,2023-05-11,6380
8933,愛地雅,31,0,31,光和,2023-05-11,6380
1314,中石化,30,0,30,光和,2023-05-11,6380
4979,華星光,28,0,28,光和,2023-05-11,6380
2736,富野,26,0,26,光和,2023-05-11,6380
2609,陽明,29,5,24,光和,2023-05-11,6380
2504,國產,22,0,22,光和,2023-05-11,6380
1504,東元,26,4,22,光和,2023-05-11,6380
2359,所羅門,34,13,21,光和,2023-05-11,6380
00712,復華富時不動產,20,0,20,光和,2023-05-11,6380
4123,晟德,24,4,20,光和,2023-05-11,6380
2104,國際中橡,20,0,20,光和,2023-05-11,6380
2607,榮運,20,0,20,光和,2023-05-11,6380
4967,十銓,20,0,20,光和,2023-05-11,6380
2515,中工,19,0,19,光和,2023-05-11,6380
4503,金雨,18,0,18,光和,2023-05-11,6380
1513,中興電,17,1,16,光和,2023-05-11,6380
9907,統一實,16,0,16,光和,2023-05-11,6380
2106,建大,15,0,15,光和,2023-05-11,6380
1605,華新,17,3,14,光和,2023-05-11,6380
1718,中纖,14,0,14,光和,2023-05-11,6380
3047,訊舟,13,0,13,光和,2023-05-11,6380
6285,啟��,12,0,12,光和,2023-05-11,6380
1584,精剛,13,1,12,光和,2023-05-11,6380
1710,東聯,22,10,12,光和,2023-05-11,6380
3202,樺晟,13,1,12,光和,2023-05-11,6380
4915,致伸,25,13,12,光和,2023-05-11,6380
6589,台康生技,12,0,12,光和,2023-05-11,6380
8033,雷虎,12,0,12,光和,2023-05-11,6380
2610,華航,23,12,11,光和,2023-05-11,6380
2204,中華,21,10,11,光和,2023-05-11,6380
3325,旭品,11,0,11,光和,2023-05-11,6380
6160,欣技,14,3,11,光和,2023-05-11,6380
9944,新麗,11,0,11,光和,2023-05-11,6380
00772B,中信高評級公司債,10,0,10,光和,2023-05-11,6380
00632R,元大台灣50反1,10,0,10,光和,2023-05-11,6380
1220,台榮,10,0,10,光和,2023-05-11,6380
2412,中華電,10,0,10,光和,2023-05-11,6380
4744,皇將,13,3,10,光和,2023-05-11,6380
6284,佳邦,10,0,10,光和,2023-05-11,6380
9103,美德醫療-DR,10,0,10,光和,2023-05-11,6380
1569,濱川,9,0,9,光和,2023-05-11,6380
3056,富華新,9,0,9,光和,2023-05-11,6380
5353,台林,9,0,9,光和,2023-05-11,6380
8111,立��,10,1,9,光和,2023-05-11,6380
8403,盛弘,8,0,8,光和,2023-05-11,6380
2888,新光金,130,1,129,光和,2023-05-12,6380
1711,永光,80,3,77,光和,2023-05-12,6380
2317,鴻海,78,11,67,光和,2023-05-12,6380
2880,華南金,60,0,60,光和,2023-05-12,6380
2883,凱基金,65,5,60,光和,2023-05-12,6380
00637L,元大滬深300正2,46,0,46,光和,2023-05-12,6380
00878,國泰永續高股息,65,32,33,光和,2023-05-12,6380
2337,旺宏,31,0,31,光和,2023-05-12,6380
6126,信音,34,3,31,光和,2023-05-12,6380
2371,大同,44,17,27,光和,2023-05-12,6380
1337,再生-KY,24,0,24,光和,2023-05-12,6380
1314,中石化,24,1,23,光和,2023-05-12,6380
2882,國泰金,22,0,22,光和,2023-05-12,6380
3576,聯合再生,27,5,22,光和,2023-05-12,6380
00908,富邦入息REITs+,20,0,20,光和,2023-05-12,6380
3049,精金,20,0,20,光和,2023-05-12,6380
2409,友達,18,0,18,光和,2023-05-12,6380
1101,台泥,16,0,16,光和,2023-05-12,6380
1905,華紙,17,2,15,光和,2023-05-12,6380
1909,榮成,15,0,15,光和,2023-05-12,6380
2027,大成鋼,14,0,14,光和,2023-05-12,6380
4958,臻鼎-KY,14,0,14,光和,2023-05-12,6380
1718,中纖,12,0,12,光和,2023-05-12,6380
2890,永豐金,11,0,11,光和,2023-05-12,6380
2618,長榮航,23,12,11,光和,2023-05-12,6380
2732,六角,11,0,11,光和,2023-05-12,6380
3202,樺晟,14,3,11,光和,2023-05-12,6380
3481,群創,14,3,11,光和,2023-05-12,6380
00882,中信中國高股息,10,0,10,光和,2023-05-12,6380
1305,華夏,10,0,10,光和,2023-05-12,6380
2204,中華,10,0,10,光和,2023-05-12,6380
2344,華邦電,10,0,10,光和,2023-05-12,6380
2408,南亞科,10,0,10,光和,2023-05-12,6380
2468,華經,10,0,10,光和,2023-05-12,6380
6285,啟��,11,1,10,光和,2023-05-12,6380
6443,元晶,10,0,10,光和,2023-05-12,6380
6547,高端疫苗,10,0,10,光和,2023-05-12,6380
1307,三芳,9,0,9,光和,2023-05-12,6380
1783,和康生,11,2,9,光和,2023-05-12,6380
2610,華航,20,11,9,光和,2023-05-12,6380
2206,三陽工業,13,5,8,光和,2023-05-12,6380
2303,聯電,9,1,8,光和,2023-05-12,6380
1410,南染,8,0,8,光和,2023-05-12,6380
3712,永崴投控,8,0,8,光和,2023-05-12,6380
00642U,期元大S＆P石油,7,0,7,光和,2023-05-12,6380
2002,中鋼,7,0,7,光和,2023-05-12,6380
4440,宜新實業,7,0,7,光和,2023-05-12,6380
2308,台達電,7,0,7,光和,2023-05-12,6380
2884,玉山金,7,0,7,光和,2023-05-12,6380
1312,國喬,7,1,6,光和,2023-05-12,6380
00878,國泰永續高股息,121,8,113,光和,2023-05-15,6380
2504,國產,72,0,72,光和,2023-05-15,6380
2888,新光金,31,1,30,光和,2023-05-15,6380
3715,定穎投控,32,3,29,光和,2023-05-15,6380
3231,緯創,39,15,24,光和,2023-05-15,6380
6126,信音,24,0,24,光和,2023-05-15,6380
3325,旭品,21,0,21,光和,2023-05-15,6380
2208,台船,20,0,20,光和,2023-05-15,6380
2332,友訊,21,3,18,光和,2023-05-15,6380
4550,長佳,16,0,16,光和,2023-05-15,6380
2115,六暉-KY,15,0,15,光和,2023-05-15,6380
6122,擎邦,22,7,15,光和,2023-05-15,6380
4123,晟德,15,1,14,光和,2023-05-15,6380
1513,中興電,16,3,13,光和,2023-05-15,6380
00637L,元大滬深300正2,87,74,13,光和,2023-05-15,6380
2317,鴻海,22,9,13,光和,2023-05-15,6380
3029,零壹,13,0,13,光和,2023-05-15,6380
6191,精成科,13,0,13,光和,2023-05-15,6380
00882,中信中國高股息,12,0,12,光和,2023-05-15,6380
2303,聯電,12,0,12,光和,2023-05-15,6380
00687B,國泰20年美債,11,0,11,光和,2023-05-15,6380
2104,國際中橡,11,0,11,光和,2023-05-15,6380
1519,華城,14,4,10,光和,2023-05-15,6380
1711,永光,10,0,10,光和,2023-05-15,6380
4915,致伸,10,0,10,光和,2023-05-15,6380
5905,南仁湖,11,1,10,光和,2023-05-15,6380
6243,迅杰,10,0,10,光和,2023-05-15,6380
6264,富裔,10,0,10,光和,2023-05-15,6380
3202,樺晟,21,13,8,光和,2023-05-15,6380
3056,富華新,8,0,8,光和,2023-05-15,6380
3207,耀勝,8,0,8,光和,2023-05-15,6380
1101,台泥,18,11,7,光和,2023-05-15,6380
1539,巨庭,7,0,7,光和,2023-05-15,6380
2344,華邦電,8,1,7,光和,2023-05-15,6380
3078,僑威,10,3,7,光和,2023-05-15,6380
6234,高僑,7,0,7,光和,2023-05-15,6380
0056,元大高股息,6,0,6,光和,2023-05-15,6380
1609,大亞,9,3,6,光和,2023-05-15,6380
2471,資通,7,1,6,光和,2023-05-15,6380
2897,王道銀行,6,0,6,光和,2023-05-15,6380
3105,穩懋,7,1,6,光和,2023-05-15,6380
3221,台嘉碩,6,0,6,光和,2023-05-15,6380
4131,浩泰,6,0,6,光和,2023-05-15,6380
6279,胡連,6,0,6,光和,2023-05-15,6380
6589,台康生技,6,0,6,光和,2023-05-15,6380
00679B,元大美債20年,5,0,5,光和,2023-05-15,6380
2402,毅嘉,5,0,5,光和,2023-05-15,6380
00680L,元大美債20正2,5,0,5,光和,2023-05-15,6380
00715L,期街口布蘭特正2,5,0,5,光和,2023-05-15,6380
00713,元大台灣高息低波,5,0,5,光和,2023-05-15,6380
00878,國泰永續高股息,125,47,78,光和,2023-05-16,6380
2867,三商壽,60,0,60,光和,2023-05-16,6380
2317,鴻海,42,0,42,光和,2023-05-16,6380
00632R,元大台灣50反1,41,0,41,光和,2023-05-16,6380
2603,長榮,41,1,40,光和,2023-05-16,6380
8215,明基材,26,0,26,光和,2023-05-16,6380
00712,復華富時不動產,25,0,25,光和,2023-05-16,6380
1471,首利,21,0,21,光和,2023-05-16,6380
1529,樂事綠能,25,5,20,光和,2023-05-16,6380
1101,台泥,19,1,18,光和,2023-05-16,6380
2323,中環,18,0,18,光和,2023-05-16,6380
2337,旺宏,17,0,17,光和,2023-05-16,6380
2349,錸德,21,4,17,光和,2023-05-16,6380
4968,立積,19,2,17,光和,2023-05-16,6380
00751B,元大AAA至A公司債,15,0,15,光和,2023-05-16,6380
2392,正崴,15,0,15,光和,2023-05-16,6380
3548,兆利,15,0,15,光和,2023-05-16,6380
00720B,元大投資級公司債,14,0,14,光和,2023-05-16,6380
2630,亞航,19,5,14,光和,2023-05-16,6380
2634,漢翔,15,1,14,光和,2023-05-16,6380
2002,中鋼,12,0,12,光和,2023-05-16,6380
00888,永豐台灣ESG,11,0,11,光和,2023-05-16,6380
2313,華通,11,0,11,光和,2023-05-16,6380
6806,森崴能源,12,1,11,光和,2023-05-16,6380
1721,三晃,11,1,10,光和,2023-05-16,6380
5512,力麒,10,0,10,光和,2023-05-16,6380
8429,金麗-KY,10,0,10,光和,2023-05-16,6380
4503,金雨,11,2,9,光和,2023-05-16,6380
3624,光頡,8,0,8,光和,2023-05-16,6380
6712,長聖,9,2,7,光和,2023-05-16,6380
8011,台通,7,0,7,光和,2023-05-16,6380
8038,長園科,11,4,7,光和,2023-05-16,6380
1314,中石化,10,4,6,光和,2023-05-16,6380
2385,群光,6,0,6,光和,2023-05-16,6380
2409,友達,6,0,6,光和,2023-05-16,6380
2520,冠德,6,0,6,光和,2023-05-16,6380
5258,虹堡,16,10,6,光和,2023-05-16,6380
00671R,富邦NASDAQ反1,5,0,5,光和,2023-05-16,6380
1598,岱宇,5,0,5,光和,2023-05-16,6380
1709,和益,5,0,5,光和,2023-05-16,6380
2324,仁寶,5,0,5,光和,2023-05-16,6380
2367,燿華,5,0,5,光和,2023-05-16,6380
2457,飛宏,12,7,5,光和,2023-05-16,6380
2734,易飛網,5,0,5,光和,2023-05-16,6380
3046,建��,6,1,5,光和,2023-05-16,6380
3051,力特,5,0,5,光和,2023-05-16,6380
4541,晟田,5,0,5,光和,2023-05-16,6380
5243,乙盛-KY,5,0,5,光和,2023-05-16,6380
6811,宏�硌穈T,5,0,5,光和,2023-05-16,6380
2834,臺企銀,4,0,4,光和,2023-05-16,6380
2303,聯電,66,2,64,光和,2023-05-17,6380
2371,大同,59,2,57,光和,2023-05-17,6380
00908,富邦入息REITs+,50,0,50,光和,2023-05-17,6380
00665L,富邦�琤肭磪囓�2,46,0,46,光和,2023-05-17,6380
1314,中石化,43,3,40,光和,2023-05-17,6380
00632R,元大台灣50反1,342,302,40,光和,2023-05-17,6380
2344,華邦電,58,18,40,光和,2023-05-17,6380
00878,國泰永續高股息,53,19,34,光和,2023-05-17,6380
3715,定穎投控,32,3,29,光和,2023-05-17,6380
00637L,元大滬深300正2,25,4,21,光和,2023-05-17,6380
1569,濱川,20,0,20,光和,2023-05-17,6380
00720B,元大投資級公司債,17,0,17,光和,2023-05-17,6380
2603,長榮,18,2,16,光和,2023-05-17,6380
00712,復華富時不動產,16,0,16,光和,2023-05-17,6380
4190,佐登-KY,16,0,16,光和,2023-05-17,6380
2034,允強,15,0,15,光和,2023-05-17,6380
6153,嘉聯益,15,0,15,光和,2023-05-17,6380
6112,邁達特,24,9,15,光和,2023-05-17,6380
1608,華榮,18,5,13,光和,2023-05-17,6380
3583,辛耘,14,1,13,光和,2023-05-17,6380
00680L,元大美債20正2,12,0,12,光和,2023-05-17,6380
00882,中信中國高股息,12,0,12,光和,2023-05-17,6380
00687B,國泰20年美債,11,0,11,光和,2023-05-17,6380
00772B,中信高評級公司債,11,0,11,光和,2023-05-17,6380
2498,宏達電,14,3,11,光和,2023-05-17,6380
2340,台亞,10,0,10,光和,2023-05-17,6380
3511,矽瑪,10,0,10,光和,2023-05-17,6380
3520,華盈,10,0,10,光和,2023-05-17,6380
5512,力麒,10,0,10,光和,2023-05-17,6380
2617,台航,9,0,9,光和,2023-05-17,6380
1513,中興電,13,5,8,光和,2023-05-17,6380
2317,鴻海,9,1,8,光和,2023-05-17,6380
1526,日馳,8,0,8,光和,2023-05-17,6380
2302,麗正,8,0,8,光和,2023-05-17,6380
2609,陽明,12,4,8,光和,2023-05-17,6380
6147,頎邦,8,0,8,光和,2023-05-17,6380
6285,啟��,8,0,8,光和,2023-05-17,6380
2377,微星,7,0,7,光和,2023-05-17,6380
2402,毅嘉,11,4,7,光和,2023-05-17,6380
3003,健和興,8,1,7,光和,2023-05-17,6380
00679B,元大美債20年,6,0,6,光和,2023-05-17,6380
2731,雄獅,10,4,6,光和,2023-05-17,6380
1584,精剛,12,6,6,光和,2023-05-17,6380
2388,威盛,6,0,6,光和,2023-05-17,6380
2449,京元電子,6,0,6,光和,2023-05-17,6380
4554,橙的,6,0,6,光和,2023-05-17,6380
4967,十銓,7,1,6,光和,2023-05-17,6380
3029,零壹,6,1,5,光和,2023-05-17,6380
00673R,期元大S＆P原油反1,5,0,5,光和,2023-05-17,6380
00756B,群益投等新興公債,5,0,5,光和,2023-05-17,6380
4402,郡都開發,199,0,199,光和,2023-05-18,6380
2337,旺宏,105,4,101,光和,2023-05-18,6380
5324,士開,53,0,53,光和,2023-05-18,6380
8222,寶一,49,3,46,光和,2023-05-18,6380
2303,聯電,60,20,40,光和,2023-05-18,6380
2634,漢翔,50,21,29,光和,2023-05-18,6380
00665L,富邦�琤肭磪囓�2,58,30,28,光和,2023-05-18,6380
4973,廣穎,27,1,26,光和,2023-05-18,6380
6266,泰詠,27,2,25,光和,2023-05-18,6380
0056,元大高股息,33,12,21,光和,2023-05-18,6380
1810,和成,20,0,20,光和,2023-05-18,6380
1101,台泥,21,1,20,光和,2023-05-18,6380
1721,三晃,20,3,17,光和,2023-05-18,6380
5498,凱崴,17,0,17,光和,2023-05-18,6380
3049,精金,15,0,15,光和,2023-05-18,6380
6285,啟��,15,1,14,光和,2023-05-18,6380
00687B,國泰20年美債,13,0,13,光和,2023-05-18,6380
2495,普安,14,1,13,光和,2023-05-18,6380
4123,晟德,13,0,13,光和,2023-05-18,6380
3056,富華新,13,0,13,光和,2023-05-18,6380
3078,僑威,15,4,11,光和,2023-05-18,6380
4426,利勤,10,0,10,光和,2023-05-18,6380
00795B,中信美國公債20年,10,0,10,光和,2023-05-18,6380
2033,佳大,10,0,10,光和,2023-05-18,6380
2515,中工,11,1,10,光和,2023-05-18,6380
2748,雲品,10,0,10,光和,2023-05-18,6380
3535,晶彩科,10,0,10,光和,2023-05-18,6380
6218,豪勉,16,6,10,光和,2023-05-18,6380
6243,迅杰,13,3,10,光和,2023-05-18,6380
6446,藥華藥,10,0,10,光和,2023-05-18,6380
8176,智捷,10,0,10,光和,2023-05-18,6380
2615,萬海,10,1,9,光和,2023-05-18,6380
3202,樺晟,11,2,9,光和,2023-05-18,6380
2504,國產,8,0,8,光和,2023-05-18,6380
00637L,元大滬深300正2,38,30,8,光和,2023-05-18,6380
4977,眾達-KY,9,1,8,光和,2023-05-18,6380
6235,華孚,14,6,8,光和,2023-05-18,6380
00712,復華富時不動產,7,0,7,光和,2023-05-18,6380
3325,旭品,9,2,7,光和,2023-05-18,6380
3704,合勤控,21,14,7,光和,2023-05-18,6380
5608,四維航,12,5,7,光和,2023-05-18,6380
6112,邁達特,40,33,7,光和,2023-05-18,6380
6163,華電網,7,0,7,光和,2023-05-18,6380
00773B,中信優先金融債,6,0,6,光和,2023-05-18,6380
00720B,元大投資級公司債,6,0,6,光和,2023-05-18,6380
1714,和桐,6,0,6,光和,2023-05-18,6380
2025,千興,6,0,6,光和,2023-05-18,6380
2313,華通,6,0,6,光和,2023-05-18,6380
2377,微星,8,2,6,光和,2023-05-18,6380
3548,兆利,6,0,6,光和,2023-05-18,6380
2371,大同,196,6,190,光和,2023-05-19,6380
00878,國泰永續高股息,206,26,180,光和,2023-05-19,6380
1314,中石化,64,0,64,光和,2023-05-19,6380
3029,零壹,63,4,59,光和,2023-05-19,6380
00665L,富邦�琤肭磪囓�2,50,5,45,光和,2023-05-19,6380
5324,士開,37,3,34,光和,2023-05-19,6380
2337,旺宏,35,5,30,光和,2023-05-19,6380
9958,世紀鋼,30,1,29,光和,2023-05-19,6380
3056,富華新,28,1,27,光和,2023-05-19,6380
00712,復華富時不動產,30,3,27,光和,2023-05-19,6380
1584,精剛,29,2,27,光和,2023-05-19,6380
3035,智原,26,3,23,光和,2023-05-19,6380
00772B,中信高評級公司債,20,0,20,光和,2023-05-19,6380
2365,昆盈,20,0,20,光和,2023-05-19,6380
2630,亞航,22,2,20,光和,2023-05-19,6380
6122,擎邦,18,1,17,光和,2023-05-19,6380
2303,聯電,21,4,17,光和,2023-05-19,6380
2367,燿華,16,0,16,光和,2023-05-19,6380
3715,定穎投控,42,26,16,光和,2023-05-19,6380
1776,展宇,15,0,15,光和,2023-05-19,6380
2102,泰豐,15,0,15,光和,2023-05-19,6380
3308,聯德,14,0,14,光和,2023-05-19,6380
00687B,國泰20年美債,13,0,13,光和,2023-05-19,6380
2421,建準,35,22,13,光和,2023-05-19,6380
4915,致伸,12,0,12,光和,2023-05-19,6380
1504,東元,49,38,11,光和,2023-05-19,6380
00720B,元大投資級公司債,11,0,11,光和,2023-05-19,6380
00632R,元大台灣50反1,12,1,11,光和,2023-05-19,6380
00902,中信電池及儲能,11,0,11,光和,2023-05-19,6380
2705,六福,11,0,11,光和,2023-05-19,6380
2457,飛宏,18,8,10,光和,2023-05-19,6380
1220,台榮,10,0,10,光和,2023-05-19,6380
1718,中纖,12,2,10,光和,2023-05-19,6380
2471,資通,14,4,10,光和,2023-05-19,6380
3049,精金,10,0,10,光和,2023-05-19,6380
3163,波若威,14,4,10,光和,2023-05-19,6380
3202,樺晟,11,1,10,光和,2023-05-19,6380
3003,健和興,14,5,9,光和,2023-05-19,6380
3481,群創,10,1,9,光和,2023-05-19,6380
6112,邁達特,20,11,9,光和,2023-05-19,6380
2002,中鋼,10,2,8,光和,2023-05-19,6380
00637L,元大滬深300正2,158,150,8,光和,2023-05-19,6380
2453,凌群,12,4,8,光和,2023-05-19,6380
4190,佐登-KY,8,0,8,光和,2023-05-19,6380
8222,寶一,15,7,8,光和,2023-05-19,6380
00650L,復華香港正2,8,1,7,光和,2023-05-19,6380
2034,允強,7,0,7,光和,2023-05-19,6380
5464,霖宏,8,1,7,光和,2023-05-19,6380
6285,啟��,7,0,7,光和,2023-05-19,6380
6509,聚和,10,3,7,光和,2023-05-19,6380
00878,國泰永續高股息,126,8,118,光和,2023-05-22,6380
2303,聯電,104,0,104,光和,2023-05-22,6380
5608,四維航,100,0,100,光和,2023-05-22,6380
3481,群創,71,23,48,光和,2023-05-22,6380
4426,利勤,40,0,40,光和,2023-05-22,6380
2371,大同,34,2,32,光和,2023-05-22,6380
3591,艾笛森,31,0,31,光和,2023-05-22,6380
3363,上詮,36,7,29,光和,2023-05-22,6380
2884,玉山金,25,0,25,光和,2023-05-22,6380
3231,緯創,28,3,25,光和,2023-05-22,6380
6282,康舒,36,14,22,光和,2023-05-22,6380
1718,中纖,20,0,20,光和,2023-05-22,6380
2882,國泰金,25,5,20,光和,2023-05-22,6380
2891,中信金,21,1,20,光和,2023-05-22,6380
4102,永日,21,2,19,光和,2023-05-22,6380
8171,天宇,20,1,19,光和,2023-05-22,6380
4190,佐登-KY,15,0,15,光和,2023-05-22,6380
5704,老爺知,15,0,15,光和,2023-05-22,6380
6126,信音,15,0,15,光和,2023-05-22,6380
6185,幃翔,15,0,15,光和,2023-05-22,6380
00712,復華富時不動產,14,0,14,光和,2023-05-22,6380
3202,樺晟,15,1,14,光和,2023-05-22,6380
2412,中華電,15,2,13,光和,2023-05-22,6380
5371,中光電,13,0,13,光和,2023-05-22,6380
00679B,元大美債20年,11,0,11,光和,2023-05-22,6380
1337,再生-KY,11,0,11,光和,2023-05-22,6380
00715L,期街口布蘭特正2,11,0,11,光和,2023-05-22,6380
6531,愛普*,24,13,11,光和,2023-05-22,6380
1201,味全,10,0,10,光和,2023-05-22,6380
2206,三陽工業,17,7,10,光和,2023-05-22,6380
2340,台亞,10,0,10,光和,2023-05-22,6380
3094,聯傑,10,0,10,光和,2023-05-22,6380
4766,南寶,10,0,10,光和,2023-05-22,6380
1314,中石化,17,8,9,光和,2023-05-22,6380
1727,中華化,9,0,9,光和,2023-05-22,6380
4130,健亞,10,1,9,光和,2023-05-22,6380
5392,能率,9,0,9,光和,2023-05-22,6380
2615,萬海,9,1,8,光和,2023-05-22,6380
2748,雲品,8,0,8,光和,2023-05-22,6380
4967,十銓,8,0,8,光和,2023-05-22,6380
6223,旺矽,12,4,8,光和,2023-05-22,6380
00751B,元大AAA至A公司債,7,0,7,光和,2023-05-22,6380
00885,富邦越南,7,0,7,光和,2023-05-22,6380
00882,中信中國高股息,7,0,7,光和,2023-05-22,6380
2377,微星,7,0,7,光和,2023-05-22,6380
3022,威強電,7,0,7,光和,2023-05-22,6380
3025,星通,8,1,7,光和,2023-05-22,6380
3673,TPK-KY,13,6,7,光和,2023-05-22,6380
6229,研通,7,0,7,光和,2023-05-22,6380
3163,波若威,13,6,7,光和,2023-05-22,6380
00688L,國泰20年美債正2,50,0,50,光和,2023-05-23,6380
00637L,元大滬深300正2,50,0,50,光和,2023-05-23,6380
3481,群創,69,25,44,光和,2023-05-23,6380
2409,友達,44,1,43,光和,2023-05-23,6380
6288,聯嘉,35,0,35,光和,2023-05-23,6380
1513,中興電,37,5,32,光和,2023-05-23,6380
2371,大同,36,6,30,光和,2023-05-23,6380
2486,一詮,29,1,28,光和,2023-05-23,6380
1605,華新,26,7,19,光和,2023-05-23,6380
1528,恩德,15,0,15,光和,2023-05-23,6380
6470,宇智,19,6,13,光和,2023-05-23,6380
00882,中信中國高股息,12,0,12,光和,2023-05-23,6380
2380,虹光,12,0,12,光和,2023-05-23,6380
3013,晟銘電,20,8,12,光和,2023-05-23,6380
2702,華園,11,0,11,光和,2023-05-23,6380
3702,大聯大,11,0,11,光和,2023-05-23,6380
1609,大亞,12,2,10,光和,2023-05-23,6380
2027,大成鋼,11,1,10,光和,2023-05-23,6380
00680L,元大美債20正2,10,0,10,光和,2023-05-23,6380
1101,台泥,10,0,10,光和,2023-05-23,6380
2313,華通,10,0,10,光和,2023-05-23,6380
2515,中工,10,0,10,光和,2023-05-23,6380
5392,能率,10,0,10,光和,2023-05-23,6380
8403,盛弘,10,0,10,光和,2023-05-23,6380
2374,佳能,10,0,10,光和,2023-05-23,6380
00772B,中信高評級公司債,9,0,9,光和,2023-05-23,6380
2731,雄獅,14,5,9,光和,2023-05-23,6380
1504,東元,13,5,8,光和,2023-05-23,6380
2444,兆勁,8,0,8,光和,2023-05-23,6380
2489,瑞軒,8,0,8,光和,2023-05-23,6380
5464,霖宏,8,0,8,光和,2023-05-23,6380
00679B,元大美債20年,7,0,7,光和,2023-05-23,6380
0056,元大高股息,12,5,7,光和,2023-05-23,6380
00632R,元大台灣50反1,7,0,7,光和,2023-05-23,6380
2014,中鴻,7,0,7,光和,2023-05-23,6380
2105,正新,12,5,7,光和,2023-05-23,6380
6282,康舒,17,10,7,光和,2023-05-23,6380
00795B,中信美國公債20年,6,0,6,光和,2023-05-23,6380
3029,零壹,6,0,6,光和,2023-05-23,6380
3363,上詮,7,1,6,光和,2023-05-23,6380
4968,立積,7,1,6,光和,2023-05-23,6380
3380,明泰,5,0,5,光和,2023-05-23,6380
2636,台驊控股,5,0,5,光和,2023-05-23,6380
3664,安瑞-KY,6,1,5,光和,2023-05-23,6380
2745,五福,5,0,5,光和,2023-05-23,6380
2382,廣達,5,0,5,光和,2023-05-23,6380
1460,宏遠,5,0,5,光和,2023-05-23,6380
00712,復華富時不動產,5,0,5,光和,2023-05-23,6380
1786,科妍,5,0,5,光和,2023-05-23,6380
2324,仁寶,5,0,5,光和,2023-05-23,6380
00637L,元大滬深300正2,273,100,173,光和,2023-05-24,6380
00885,富邦越南,65,0,65,光和,2023-05-24,6380
2023,燁輝,54,1,53,光和,2023-05-24,6380
00680L,元大美債20正2,47,0,47,光和,2023-05-24,6380
00665L,富邦�琤肭磪囓�2,72,28,44,光和,2023-05-24,6380
5512,力麒,35,0,35,光和,2023-05-24,6380
3701,大眾控,33,0,33,光和,2023-05-24,6380
00882,中信中國高股息,21,0,21,光和,2023-05-24,6380
2888,新光金,20,0,20,光和,2023-05-24,6380
6770,力積電,20,0,20,光和,2023-05-24,6380
3013,晟銘電,40,21,19,光和,2023-05-24,6380
1513,中興電,32,14,18,光和,2023-05-24,6380
9904,寶成,15,0,15,光和,2023-05-24,6380
5258,虹堡,17,4,13,光和,2023-05-24,6380
5464,霖宏,21,8,13,光和,2023-05-24,6380
4114,健喬,15,3,12,光和,2023-05-24,6380
3312,弘憶股,11,0,11,光和,2023-05-24,6380
00878,國泰永續高股息,24,13,11,光和,2023-05-24,6380
00753L,中信中國50正2,11,0,11,光和,2023-05-24,6380
2409,友達,13,2,11,光和,2023-05-24,6380
3035,智原,12,1,11,光和,2023-05-24,6380
6753,龍德造船,11,0,11,光和,2023-05-24,6380
00639,富邦深100,10,0,10,光和,2023-05-24,6380
1504,東元,15,5,10,光和,2023-05-24,6380
2641,正德,10,0,10,光和,2023-05-24,6380
2701,萬企,10,0,10,光和,2023-05-24,6380
5301,寶得利,10,0,10,光和,2023-05-24,6380
2201,裕隆,11,1,10,光和,2023-05-24,6380
5905,南仁湖,13,4,9,光和,2023-05-24,6380
1519,華城,13,6,7,光和,2023-05-24,6380
2014,中鴻,7,0,7,光和,2023-05-24,6380
00650L,復華香港正2,7,0,7,光和,2023-05-24,6380
3363,上詮,12,5,7,光和,2023-05-24,6380
5243,乙盛-KY,7,0,7,光和,2023-05-24,6380
8222,寶一,14,7,7,光和,2023-05-24,6380
2630,亞航,18,11,7,光和,2023-05-24,6380
1101,台泥,6,0,6,光和,2023-05-24,6380
00673R,期元大S＆P原油反1,6,0,6,光和,2023-05-24,6380
1215,卜蜂,6,0,6,光和,2023-05-24,6380
2606,裕民,6,0,6,光和,2023-05-24,6380
2610,華航,13,7,6,光和,2023-05-24,6380
4162,智擎,6,0,6,光和,2023-05-24,6380
5531,鄉林,8,2,6,光和,2023-05-24,6380
6523,達爾膚,6,0,6,光和,2023-05-24,6380
2367,燿華,6,0,6,光和,2023-05-24,6380
00888,永豐台灣ESG,5,0,5,光和,2023-05-24,6380
2030,彰源,5,0,5,光和,2023-05-24,6380
2421,建準,8,3,5,光和,2023-05-24,6380
2704,國賓,5,0,5,光和,2023-05-24,6380
3207,耀勝,6,1,5,光和,2023-05-24,6380
2609,陽明,231,4,227,光和,2023-05-25,6380
00712,復華富時不動產,55,0,55,光和,2023-05-25,6380
2880,華南金,45,0,45,光和,2023-05-25,6380
00882,中信中國高股息,33,0,33,光和,2023-05-25,6380
8011,台通,46,15,31,光和,2023-05-25,6380
1608,華榮,41,15,26,光和,2023-05-25,6380
4934,太極,24,0,24,光和,2023-05-25,6380
2303,聯電,22,0,22,光和,2023-05-25,6380
2399,映泰,21,0,21,光和,2023-05-25,6380
2603,長榮,20,0,20,光和,2023-05-25,6380
2444,兆勁,20,0,20,光和,2023-05-25,6380
4716,大立,20,0,20,光和,2023-05-25,6380
2634,漢翔,21,1,20,光和,2023-05-25,6380
3207,耀勝,23,4,19,光和,2023-05-25,6380
00632R,元大台灣50反1,19,1,18,光和,2023-05-25,6380
2882,國泰金,17,0,17,光和,2023-05-25,6380
3209,全科,15,0,15,光和,2023-05-25,6380
00753L,中信中國50正2,15,0,15,光和,2023-05-25,6380
2881,富邦金,15,0,15,光和,2023-05-25,6380
4979,華星光,15,0,15,光和,2023-05-25,6380
00650L,復華香港正2,14,0,14,光和,2023-05-25,6380
00665L,富邦�琤肭磪囓�2,13,0,13,光和,2023-05-25,6380
00687B,國泰20年美債,13,0,13,光和,2023-05-25,6380
8150,南茂,12,0,12,光和,2023-05-25,6380
2630,亞航,37,25,12,光和,2023-05-25,6380
2702,華園,12,1,11,光和,2023-05-25,6380
00772B,中信高評級公司債,15,5,10,光和,2023-05-25,6380
1701,中化,10,0,10,光和,2023-05-25,6380
2030,彰源,10,0,10,光和,2023-05-25,6380
2542,興富發,10,0,10,光和,2023-05-25,6380
2611,志信,11,1,10,光和,2023-05-25,6380
3049,精金,10,0,10,光和,2023-05-25,6380
4130,健亞,10,0,10,光和,2023-05-25,6380
5876,上海商銀,10,0,10,光和,2023-05-25,6380
00857B,永豐20年美公債,8,0,8,光和,2023-05-25,6380
1905,華紙,18,10,8,光和,2023-05-25,6380
2606,裕民,8,0,8,光和,2023-05-25,6380
2809,京城銀,8,0,8,光和,2023-05-25,6380
3419,譁裕,14,6,8,光和,2023-05-25,6380
3682,亞太電,8,0,8,光和,2023-05-25,6380
3701,大眾控,8,0,8,光和,2023-05-25,6380
4741,泓瀚,8,0,8,光和,2023-05-25,6380
8222,寶一,12,4,8,光和,2023-05-25,6380
9904,寶成,9,1,8,光和,2023-05-25,6380
5222,全訊,8,0,8,光和,2023-05-25,6380
5258,虹堡,7,0,7,光和,2023-05-25,6380
00795B,中信美國公債20年,7,0,7,光和,2023-05-25,6380
3202,樺晟,10,3,7,光和,2023-05-25,6380
3234,光環,7,0,7,光和,2023-05-25,6380
3308,聯德,7,0,7,光和,2023-05-25,6380
00632R,元大台灣50反1,357,30,327,光和,2023-05-26,6380
00637L,元大滬深300正2,319,200,119,光和,2023-05-26,6380
1460,宏遠,73,1,72,光和,2023-05-26,6380
2883,凱基金,68,0,68,光和,2023-05-26,6380
00712,復華富時不動產,67,0,67,光和,2023-05-26,6380
1909,榮成,55,0,55,光和,2023-05-26,6380
6770,力積電,53,1,52,光和,2023-05-26,6380
00908,富邦入息REITs+,50,0,50,光和,2023-05-26,6380
2610,華航,47,10,37,光和,2023-05-26,6380
2356,英業達,51,15,36,光和,2023-05-26,6380
1314,中石化,32,1,31,光和,2023-05-26,6380
00688L,國泰20年美債正2,30,0,30,光和,2023-05-26,6380
2332,友訊,23,0,23,光和,2023-05-26,6380
3481,群創,55,33,22,光和,2023-05-26,6380
2453,凌群,23,2,21,光和,2023-05-26,6380
00715L,期街口布蘭特正2,20,0,20,光和,2023-05-26,6380
3149,正達,20,0,20,光和,2023-05-26,6380
00882,中信中國高股息,19,0,19,光和,2023-05-26,6380
2425,承啟,22,3,19,光和,2023-05-26,6380
3207,耀勝,20,1,19,光和,2023-05-26,6380
6164,華興,22,3,19,光和,2023-05-26,6380
2609,陽明,24,6,18,光和,2023-05-26,6380
3231,緯創,64,46,18,光和,2023-05-26,6380
2349,錸德,20,2,18,光和,2023-05-26,6380
5608,四維航,18,0,18,光和,2023-05-26,6380
2880,華南金,20,3,17,光和,2023-05-26,6380
2412,中華電,19,4,15,光和,2023-05-26,6380
3264,欣銓,23,8,15,光和,2023-05-26,6380
2323,中環,20,6,14,光和,2023-05-26,6380
1785,光洋科,16,2,14,光和,2023-05-26,6380
2208,台船,15,1,14,光和,2023-05-26,6380
2317,鴻海,19,6,13,光和,2023-05-26,6380
8112,至上,14,1,13,光和,2023-05-26,6380
1718,中纖,12,0,12,光和,2023-05-26,6380
1783,和康生,11,0,11,光和,2023-05-26,6380
2515,中工,11,0,11,光和,2023-05-26,6380
2606,裕民,16,5,11,光和,2023-05-26,6380
3588,通嘉,11,0,11,光和,2023-05-26,6380
3594,磐儀,12,1,11,光和,2023-05-26,6380
3673,TPK-KY,11,0,11,光和,2023-05-26,6380
4123,晟德,11,0,11,光和,2023-05-26,6380
3056,富華新,10,0,10,光和,2023-05-26,6380
2504,國產,10,0,10,光和,2023-05-26,6380
1524,耿鼎,10,0,10,光和,2023-05-26,6380
2201,裕隆,11,1,10,光和,2023-05-26,6380
2501,國建,10,0,10,光和,2023-05-26,6380
3325,旭品,23,13,10,光和,2023-05-26,6380
4190,佐登-KY,10,0,10,光和,2023-05-26,6380
4716,大立,10,0,10,光和,2023-05-26,6380
5284,jpp-KY,10,0,10,光和,2023-05-26,6380
3033,威健,100,0,100,光和,2023-05-29,6380
2371,大同,111,33,78,光和,2023-05-29,6380
1460,宏遠,83,10,73,光和,2023-05-29,6380
2880,華南金,50,1,49,光和,2023-05-29,6380
0056,元大高股息,52,7,45,光和,2023-05-29,6380
2002,中鋼,46,2,44,光和,2023-05-29,6380
1504,東元,47,5,42,光和,2023-05-29,6380
9802,鈺齊-KY,42,2,40,光和,2023-05-29,6380
00637L,元大滬深300正2,235,201,34,光和,2023-05-29,6380
6470,宇智,33,0,33,光和,2023-05-29,6380
00902,中信電池及儲能,32,0,32,光和,2023-05-29,6380
2425,承啟,50,21,29,光和,2023-05-29,6380
1101,台泥,26,2,24,光和,2023-05-29,6380
00772B,中信高評級公司債,23,0,23,光和,2023-05-29,6380
00720B,元大投資級公司債,23,0,23,光和,2023-05-29,6380
2401,凌陽,23,0,23,光和,2023-05-29,6380
3715,定穎投控,34,11,23,光和,2023-05-29,6380
00687B,國泰20年美債,22,0,22,光和,2023-05-29,6380
5328,華容,26,5,21,光和,2023-05-29,6380
2484,希華,20,0,20,光和,2023-05-29,6380
6190,萬泰科,27,7,20,光和,2023-05-29,6380
3325,旭品,39,20,19,光和,2023-05-29,6380
2352,佳世達,25,7,18,光和,2023-05-29,6380
00679B,元大美債20年,16,0,16,光和,2023-05-29,6380
00882,中信中國高股息,16,0,16,光和,2023-05-29,6380
3035,智原,35,20,15,光和,2023-05-29,6380
2313,華通,15,0,15,光和,2023-05-29,6380
2323,中環,24,9,15,光和,2023-05-29,6380
1103,嘉泥,12,0,12,光和,2023-05-29,6380
3576,聯合再生,11,0,11,光和,2023-05-29,6380
1524,耿鼎,10,0,10,光和,2023-05-29,6380
2103,台橡,10,0,10,光和,2023-05-29,6380
2331,精英,13,3,10,光和,2023-05-29,6380
3202,樺晟,10,0,10,光和,2023-05-29,6380
6016,康和證,10,0,10,光和,2023-05-29,6380
2349,錸德,10,1,9,光和,2023-05-29,6380
1304,台聚,10,1,9,光和,2023-05-29,6380
1314,中石化,16,7,9,光和,2023-05-29,6380
2515,中工,12,3,9,光和,2023-05-29,6380
6285,啟��,9,0,9,光和,2023-05-29,6380
2610,華航,34,25,9,光和,2023-05-29,6380
2034,允強,8,0,8,光和,2023-05-29,6380
4967,十銓,8,0,8,光和,2023-05-29,6380
2630,亞航,13,5,8,光和,2023-05-29,6380
1783,和康生,9,1,8,光和,2023-05-29,6380
1605,華新,13,6,7,光和,2023-05-29,6380
2520,冠德,10,3,7,光和,2023-05-29,6380
3006,晶豪科,16,9,7,光和,2023-05-29,6380
3265,台星科,30,23,7,光和,2023-05-29,6380
6589,台康生技,7,0,7,光和,2023-05-29,6380
2371,大同,154,39,115,光和,2023-05-30,6380
2609,陽明,102,3,99,光和,2023-05-30,6380
00878,國泰永續高股息,106,15,91,光和,2023-05-30,6380
3035,智原,47,6,41,光和,2023-05-30,6380
2356,英業達,45,5,40,光和,2023-05-30,6380
4543,萬在,31,0,31,光和,2023-05-30,6380
00902,中信電池及儲能,30,0,30,光和,2023-05-30,6380
1618,合機,30,0,30,光和,2023-05-30,6380
2458,義隆,30,0,30,光和,2023-05-30,6380
6164,華興,30,1,29,光和,2023-05-30,6380
00882,中信中國高股息,28,0,28,光和,2023-05-30,6380
00915,凱基優選高股息30,28,0,28,光和,2023-05-30,6380
00725B,國泰投資級公司債,27,0,27,光和,2023-05-30,6380
00753L,中信中國50正2,26,0,26,光和,2023-05-30,6380
3056,富華新,26,1,25,光和,2023-05-30,6380
3231,緯創,58,33,25,光和,2023-05-30,6380
00665L,富邦�琤肭磪囓�2,26,2,24,光和,2023-05-30,6380
2883,凱基金,23,0,23,光和,2023-05-30,6380
00712,復華富時不動產,22,0,22,光和,2023-05-30,6380
1701,中化,22,0,22,光和,2023-05-30,6380
2425,承啟,22,2,20,光和,2023-05-30,6380
2489,瑞軒,20,0,20,光和,2023-05-30,6380
3710,連展投控,20,0,20,光和,2023-05-30,6380
0056,元大高股息,24,5,19,光和,2023-05-30,6380
5425,台半,19,0,19,光和,2023-05-30,6380
2610,華航,109,90,19,光和,2023-05-30,6380
8033,雷虎,22,4,18,光和,2023-05-30,6380
1608,華榮,24,8,16,光和,2023-05-30,6380
3032,偉訓,21,5,16,光和,2023-05-30,6380
3419,譁裕,16,0,16,光和,2023-05-30,6380
3306,鼎天,15,0,15,光和,2023-05-30,6380
8110,華東,15,0,15,光和,2023-05-30,6380
1503,士電,15,1,14,光和,2023-05-30,6380
2388,威盛,26,12,14,光和,2023-05-30,6380
2882,國泰金,15,2,13,光和,2023-05-30,6380
8011,台通,13,0,13,光和,2023-05-30,6380
2331,精英,13,0,13,光和,2023-05-30,6380
1609,大亞,12,0,12,光和,2023-05-30,6380
2002,中鋼,13,1,12,光和,2023-05-30,6380
6244,茂迪,13,1,12,光和,2023-05-30,6380
2014,中鴻,11,0,11,光和,2023-05-30,6380
1108,幸福,10,0,10,光和,2023-05-30,6380
2204,中華,10,0,10,光和,2023-05-30,6380
2374,佳能,10,0,10,光和,2023-05-30,6380
2497,怡利電,10,0,10,光和,2023-05-30,6380
2913,農林,13,3,10,光和,2023-05-30,6380
3049,精金,10,0,10,光和,2023-05-30,6380
5009,榮剛,11,1,10,光和,2023-05-30,6380
5608,四維航,10,0,10,光和,2023-05-30,6380
6015,宏遠證,10,0,10,光和,2023-05-30,6380
2883,凱基金,341,0,341,光和,2023-05-31,6380
2888,新光金,96,13,83,光和,2023-05-31,6380
00637L,元大滬深300正2,78,0,78,光和,2023-05-31,6380
00715L,期街口布蘭特正2,46,0,46,光和,2023-05-31,6380
4714,永捷,45,0,45,光和,2023-05-31,6380
00882,中信中國高股息,37,0,37,光和,2023-05-31,6380
2329,華泰,32,0,32,光和,2023-05-31,6380
2359,所羅門,30,0,30,光和,2023-05-31,6380
2504,國產,29,0,29,光和,2023-05-31,6380
00642U,期元大S＆P石油,27,0,27,光和,2023-05-31,6380
2486,一詮,31,6,25,光和,2023-05-31,6380
2457,飛宏,36,13,23,光和,2023-05-31,6380
2356,英業達,24,1,23,光和,2023-05-31,6380
00679B,元大美債20年,22,0,22,光和,2023-05-31,6380
2371,大同,69,48,21,光和,2023-05-31,6380
2317,鴻海,21,0,21,光和,2023-05-31,6380
2609,陽明,27,7,20,光和,2023-05-31,6380
00720B,元大投資級公司債,20,0,20,光和,2023-05-31,6380
00772B,中信高評級公司債,20,0,20,光和,2023-05-31,6380
2340,台亞,20,0,20,光和,2023-05-31,6380
2458,義隆,21,1,20,光和,2023-05-31,6380
2913,農林,20,0,20,光和,2023-05-31,6380
3037,欣興,20,1,19,光和,2023-05-31,6380
911868,同方友友-DR,17,0,17,光和,2023-05-31,6380
3231,緯創,45,29,16,光和,2023-05-31,6380
2887,台新金,15,0,15,光和,2023-05-31,6380
6125,廣運,17,2,15,光和,2023-05-31,6380
8033,雷虎,14,0,14,光和,2023-05-31,6380
4961,天鈺,12,0,12,光和,2023-05-31,6380
2615,萬海,13,1,12,光和,2023-05-31,6380
3035,智原,12,1,11,光和,2023-05-31,6380
00892,富邦台灣半導體,10,0,10,光和,2023-05-31,6380
1101,台泥,20,10,10,光和,2023-05-31,6380
1701,中化,10,0,10,光和,2023-05-31,6380
3221,台嘉碩,10,0,10,光和,2023-05-31,6380
3265,台星科,14,4,10,光和,2023-05-31,6380
3535,晶彩科,10,0,10,光和,2023-05-31,6380
4133,亞諾法,10,0,10,光和,2023-05-31,6380
5533,皇鼎,10,0,10,光和,2023-05-31,6380
1314,中石化,14,5,9,光和,2023-05-31,6380
1514,亞力,11,2,9,光和,2023-05-31,6380
2206,三陽工業,15,6,9,光和,2023-05-31,6380
2489,瑞軒,9,0,9,光和,2023-05-31,6380
6496,科懋,9,0,9,光和,2023-05-31,6380
2382,廣達,20,11,9,光和,2023-05-31,6380
2313,華通,8,0,8,光和,2023-05-31,6380
3029,零壹,8,0,8,光和,2023-05-31,6380
1718,中纖,7,0,7,光和,2023-05-31,6380
2425,承啟,7,0,7,光和,2023-05-31,6380
3625,西勝,7,0,7,光和,2023-05-31,6380
2888,新光金,142,0,142,光和,2023-06-01,6380
2883,凱基金,65,1,64,光和,2023-06-01,6380
3706,神達,85,23,62,光和,2023-06-01,6380
00715L,期街口布蘭特正2,57,10,47,光和,2023-06-01,6380
4714,永捷,30,0,30,光和,2023-06-01,6380
9907,統一實,30,0,30,光和,2023-06-01,6380
2323,中環,51,24,27,光和,2023-06-01,6380
00882,中信中國高股息,26,0,26,光和,2023-06-01,6380
5465,富驊,24,1,23,光和,2023-06-01,6380
2515,中工,72,50,22,光和,2023-06-01,6380
6470,宇智,26,4,22,光和,2023-06-01,6380
00680L,元大美債20正2,20,0,20,光和,2023-06-01,6380
2611,志信,20,0,20,光和,2023-06-01,6380
3576,聯合再生,20,0,20,光和,2023-06-01,6380
6161,捷波,20,0,20,光和,2023-06-01,6380
00679B,元大美債20年,19,0,19,光和,2023-06-01,6380
00642U,期元大S＆P石油,18,0,18,光和,2023-06-01,6380
3260,威剛,23,6,17,光和,2023-06-01,6380
1516,川飛,16,0,16,光和,2023-06-01,6380
2302,麗正,17,2,15,光和,2023-06-01,6380
2801,彰銀,15,0,15,光和,2023-06-01,6380
6164,華興,15,0,15,光和,2023-06-01,6380
6531,愛普*,37,22,15,光和,2023-06-01,6380
2356,英業達,15,1,14,光和,2023-06-01,6380
2371,大同,50,36,14,光和,2023-06-01,6380
8112,至上,14,0,14,光和,2023-06-01,6380
1727,中華化,24,11,13,光和,2023-06-01,6380
1101,台泥,13,0,13,光和,2023-06-01,6380
1314,中石化,16,4,12,光和,2023-06-01,6380
2419,仲琦,12,0,12,光和,2023-06-01,6380
2444,兆勁,12,0,12,光和,2023-06-01,6380
6244,茂迪,12,1,11,光和,2023-06-01,6380
6282,康舒,15,4,11,光和,2023-06-01,6380
00772B,中信高評級公司債,10,0,10,光和,2023-06-01,6380
1215,卜蜂,10,0,10,光和,2023-06-01,6380
00885,富邦越南,10,0,10,光和,2023-06-01,6380
3013,晟銘電,17,7,10,光和,2023-06-01,6380
3209,全科,10,0,10,光和,2023-06-01,6380
5347,世界,10,0,10,光和,2023-06-01,6380
6229,研通,10,0,10,光和,2023-06-01,6380
6285,啟��,10,0,10,光和,2023-06-01,6380
6811,宏�硌穈T,10,0,10,光和,2023-06-01,6380
6443,元晶,11,1,10,光和,2023-06-01,6380
2609,陽明,13,4,9,光和,2023-06-01,6380
00919,群益台灣精選高息,9,0,9,光和,2023-06-01,6380
4137,麗豐-KY,9,0,9,光和,2023-06-01,6380
6125,廣運,12,3,9,光和,2023-06-01,6380
8277,商丞,10,1,9,光和,2023-06-01,6380
8420,明揚,9,0,9,光和,2023-06-01,6380
8905,裕國,10,1,9,光和,2023-06-01,6380
00632R,元大台灣50反1,171,0,171,光和,2023-06-02,6380
2883B,凱基金乙特,124,0,124,光和,2023-06-02,6380
1905,華紙,113,22,91,光和,2023-06-02,6380
2031,新光鋼,68,0,68,光和,2023-06-02,6380
4906,正文,50,0,50,光和,2023-06-02,6380
2701,萬企,50,1,49,光和,2023-06-02,6380
00919,群益台灣精選高息,36,2,34,光和,2023-06-02,6380
2913,農林,28,3,25,光和,2023-06-02,6380
1733,五鼎,35,11,24,光和,2023-06-02,6380
4102,永日,23,0,23,光和,2023-06-02,6380
3231,緯創,69,48,21,光和,2023-06-02,6380
3715,定穎投控,35,14,21,光和,2023-06-02,6380
2328,廣宇,30,10,20,光和,2023-06-02,6380
4716,大立,20,0,20,光和,2023-06-02,6380
2356,英業達,21,2,19,光和,2023-06-02,6380
00679B,元大美債20年,17,0,17,光和,2023-06-02,6380
00915,凱基優選高股息30,17,0,17,光和,2023-06-02,6380
3576,聯合再生,20,4,16,光和,2023-06-02,6380
6167,久正,32,16,16,光和,2023-06-02,6380
00642U,期元大S＆P石油,13,0,13,光和,2023-06-02,6380
2605,新興,12,0,12,光和,2023-06-02,6380
910322,康師傅-DR,12,0,12,光和,2023-06-02,6380
8046,南電,13,1,12,光和,2023-06-02,6380
2355,敬鵬,11,0,11,光和,2023-06-02,6380
1312,國喬,10,0,10,光和,2023-06-02,6380
1609,大亞,25,15,10,光和,2023-06-02,6380
2034,允強,10,0,10,光和,2023-06-02,6380
3694,海華,10,0,10,光和,2023-06-02,6380
4510,高鋒,10,0,10,光和,2023-06-02,6380
4915,致伸,10,0,10,光和,2023-06-02,6380
8403,盛弘,10,0,10,光和,2023-06-02,6380
911868,同方友友-DR,10,0,10,光和,2023-06-02,6380
3003,健和興,11,2,9,光和,2023-06-02,6380
6163,華電網,10,1,9,光和,2023-06-02,6380
2603,長榮,8,0,8,光和,2023-06-02,6380
3306,鼎天,9,1,8,光和,2023-06-02,6380
6470,宇智,9,1,8,光和,2023-06-02,6380
8150,南茂,8,0,8,光和,2023-06-02,6380
2376,技嘉,14,7,7,光和,2023-06-02,6380
00926,凱基全球菁英55,7,0,7,光和,2023-06-02,6380
1802,台玻,7,0,7,光和,2023-06-02,6380
3083,網龍,7,0,7,光和,2023-06-02,6380
3312,弘憶股,7,0,7,光和,2023-06-02,6380
3706,神達,41,34,7,光和,2023-06-02,6380
1314,中石化,9,3,6,光和,2023-06-02,6380
1516,川飛,6,0,6,光和,2023-06-02,6380
1608,華榮,11,5,6,光和,2023-06-02,6380
6285,啟��,6,0,6,光和,2023-06-02,6380
2327,國巨,6,0,6,光和,2023-06-02,6380
8271,宇瞻,14,9,5,光和,2023-06-02,6380
2883B,凱基金乙特,176,0,176,光和,2023-06-05,6380
2618,長榮航,107,45,62,光和,2023-06-05,6380
2609,陽明,75,18,57,光和,2023-06-05,6380
3231,緯創,130,74,56,光和,2023-06-05,6380
3049,精金,55,0,55,光和,2023-06-05,6380
00878,國泰永續高股息,44,4,40,光和,2023-06-05,6380
2353,宏��,94,54,40,光和,2023-06-05,6380
3706,神達,43,6,37,光和,2023-06-05,6380
2606,裕民,32,0,32,光和,2023-06-05,6380
2312,金寶,31,0,31,光和,2023-06-05,6380
6016,康和證,30,0,30,光和,2023-06-05,6380
8171,天宇,40,11,29,光和,2023-06-05,6380
2359,所羅門,30,7,23,光和,2023-06-05,6380
00673R,期元大S＆P原油反1,21,0,21,光和,2023-06-05,6380
00772B,中信高評級公司債,20,0,20,光和,2023-06-05,6380
1727,中華化,23,3,20,光和,2023-06-05,6380
3583,辛耘,20,0,20,光和,2023-06-05,6380
3207,耀勝,17,0,17,光和,2023-06-05,6380
6244,茂迪,16,1,15,光和,2023-06-05,6380
2323,中環,21,7,14,光和,2023-06-05,6380
6142,友勁,15,1,14,光和,2023-06-05,6380
00919,群益台灣精選高息,13,0,13,光和,2023-06-05,6380
1513,中興電,19,6,13,光和,2023-06-05,6380
5511,德昌,16,3,13,光和,2023-06-05,6380
2489,瑞軒,12,1,11,光和,2023-06-05,6380
2892,第一金,11,0,11,光和,2023-06-05,6380
8358,金居,13,2,11,光和,2023-06-05,6380
1101,台泥,30,20,10,光和,2023-06-05,6380
1447,力鵬,10,0,10,光和,2023-06-05,6380
1717,長興,10,0,10,光和,2023-06-05,6380
2038,海光,10,0,10,光和,2023-06-05,6380
2371,大同,17,7,10,光和,2023-06-05,6380
3024,憶聲,10,0,10,光和,2023-06-05,6380
6160,欣技,10,0,10,光和,2023-06-05,6380
6535,順藥,16,6,10,光和,2023-06-05,6380
6668,中揚光,10,0,10,光和,2023-06-05,6380
8076,伍豐,10,0,10,光和,2023-06-05,6380
6266,泰詠,10,0,10,光和,2023-06-05,6380
4960,誠美材,10,1,9,光和,2023-06-05,6380
3508,位速,9,0,9,光和,2023-06-05,6380
3703,欣陸,9,0,9,光和,2023-06-05,6380
5469,瀚宇博,9,0,9,光和,2023-06-05,6380
6125,廣運,21,12,9,光和,2023-06-05,6380
2498,宏達電,15,7,8,光和,2023-06-05,6380
3046,建��,8,0,8,光和,2023-06-05,6380
3564,其陽,7,0,7,光和,2023-06-05,6380
1905,華紙,23,16,7,光和,2023-06-05,6380
1503,士電,13,6,7,光和,2023-06-05,6380
1529,樂事綠能,14,7,7,光和,2023-06-05,6380
2834,臺企銀,10,3,7,光和,2023-06-05,6380
2402,毅嘉,90,4,86,光和,2023-06-06,6380
1218,泰山,71,0,71,光和,2023-06-06,6380
8011,台通,54,1,53,光和,2023-06-06,6380
00632R,元大台灣50反1,48,1,47,光和,2023-06-06,6380
2323,中環,59,19,40,光和,2023-06-06,6380
3231,緯創,55,20,35,光和,2023-06-06,6380
4714,永捷,33,0,33,光和,2023-06-06,6380
00919,群益台灣精選高息,25,0,25,光和,2023-06-06,6380
2388,威盛,26,1,25,光和,2023-06-06,6380
8105,凌巨,33,8,25,光和,2023-06-06,6380
9934,成霖,25,0,25,光和,2023-06-06,6380
00712,復華富時不動產,23,0,23,光和,2023-06-06,6380
1471,首利,22,0,22,光和,2023-06-06,6380
2601,益航,25,4,21,光和,2023-06-06,6380
6244,茂迪,21,0,21,光和,2023-06-06,6380
00679B,元大美債20年,20,0,20,光和,2023-06-06,6380
1522,堤維西,20,0,20,光和,2023-06-06,6380
1905,華紙,36,19,17,光和,2023-06-06,6380
2371,大同,48,32,16,光和,2023-06-06,6380
00795B,中信美國公債20年,18,3,15,光和,2023-06-06,6380
2331,精英,17,2,15,光和,2023-06-06,6380
5531,鄉林,15,0,15,光和,2023-06-06,6380
6275,元山,15,0,15,光和,2023-06-06,6380
00927,群益半導體收益,14,0,14,光和,2023-06-06,6380
3207,耀勝,14,0,14,光和,2023-06-06,6380
2515,中工,27,14,13,光和,2023-06-06,6380
3630,新鉅科,13,0,13,光和,2023-06-06,6380
2706,第一店,14,2,12,光和,2023-06-06,6380
0056,元大高股息,46,35,11,光和,2023-06-06,6380
1514,亞力,14,4,10,光和,2023-06-06,6380
2329,華泰,10,0,10,光和,2023-06-06,6380
2368,金像電,13,3,10,光和,2023-06-06,6380
2471,資通,10,0,10,光和,2023-06-06,6380
2633,台灣高鐵,10,0,10,光和,2023-06-06,6380
6532,瑞耘,11,1,10,光和,2023-06-06,6380
1503,士電,13,4,9,光和,2023-06-06,6380
1608,華榮,12,3,9,光和,2023-06-06,6380
1721,三晃,9,0,9,光和,2023-06-06,6380
2359,所羅門,10,1,9,光和,2023-06-06,6380
4979,華星光,25,16,9,光和,2023-06-06,6380
8097,常珵,9,0,9,光和,2023-06-06,6380
1731,美吾華,8,0,8,光和,2023-06-06,6380
2029,盛餘,8,0,8,光和,2023-06-06,6380
2603,長榮,21,13,8,光和,2023-06-06,6380
3013,晟銘電,8,0,8,光和,2023-06-06,6380
4543,萬在,10,2,8,光和,2023-06-06,6380
4977,眾達-KY,10,2,8,光和,2023-06-06,6380
6443,元晶,9,1,8,光和,2023-06-06,6380
8403,盛弘,22,14,8,光和,2023-06-06,6380
1444,力麗,23,16,7,光和,2023-06-06,6380
00878,國泰永續高股息,237,4,233,光和,2023-06-07,6380
3231,緯創,214,27,187,光和,2023-06-07,6380
00632R,元大台灣50反1,87,0,87,光和,2023-06-07,6380
2323,中環,82,26,56,光和,2023-06-07,6380
2359,所羅門,54,3,51,光和,2023-06-07,6380
2883B,凱基金乙特,50,0,50,光和,2023-06-07,6380
2605,新興,48,0,48,光和,2023-06-07,6380
2515,中工,42,2,40,光和,2023-06-07,6380
5324,士開,38,0,38,光和,2023-06-07,6380
9934,成霖,25,0,25,光和,2023-06-07,6380
2347,聯強,22,0,22,光和,2023-06-07,6380
00919,群益台灣精選高息,21,0,21,光和,2023-06-07,6380
2634,漢翔,23,3,20,光和,2023-06-07,6380
2352,佳世達,26,8,18,光和,2023-06-07,6380
2618,長榮航,44,27,17,光和,2023-06-07,6380
1605,華新,24,8,16,光和,2023-06-07,6380
2601,益航,15,0,15,光和,2023-06-07,6380
6443,元晶,18,3,15,光和,2023-06-07,6380
6770,力積電,22,7,15,光和,2023-06-07,6380
2885,元大金,20,5,15,光和,2023-06-07,6380
5706,鳳凰,15,1,14,光和,2023-06-07,6380
3056,富華新,19,5,14,光和,2023-06-07,6380
1795,美時,14,1,13,光和,2023-06-07,6380
2401,凌陽,22,9,13,光和,2023-06-07,6380
3055,蔚華科,17,4,13,光和,2023-06-07,6380
1314,中石化,12,0,12,光和,2023-06-07,6380
1514,亞力,18,6,12,光和,2023-06-07,6380
1608,華榮,24,12,12,光和,2023-06-07,6380
5531,鄉林,12,0,12,光和,2023-06-07,6380
2027,大成鋼,11,0,11,光和,2023-06-07,6380
2701,萬企,61,50,11,光和,2023-06-07,6380
2913,農林,11,0,11,光和,2023-06-07,6380
3021,鴻名,12,1,11,光和,2023-06-07,6380
3703,欣陸,11,0,11,光和,2023-06-07,6380
6125,廣運,24,13,11,光和,2023-06-07,6380
1618,合機,15,5,10,光和,2023-06-07,6380
2402,毅嘉,15,5,10,光和,2023-06-07,6380
2504,國產,10,0,10,光和,2023-06-07,6380
2801,彰銀,10,0,10,光和,2023-06-07,6380
3094,聯傑,10,0,10,光和,2023-06-07,6380
3694,海華,10,0,10,光和,2023-06-07,6380
5210,寶碩,10,0,10,光和,2023-06-07,6380
6438,迅得,13,3,10,光和,2023-06-07,6380
4564,元翎,9,0,9,光和,2023-06-07,6380
6235,華孚,11,2,9,光和,2023-06-07,6380
6457,紘康,9,0,9,光和,2023-06-07,6380
910322,康師傅-DR,9,0,9,光和,2023-06-07,6380
3207,耀勝,8,0,8,光和,2023-06-07,6380
3630,新鉅科,10,2,8,光和,2023-06-07,6380
4129,聯合,8,0,8,光和,2023-06-07,6380
6770,力積電,181,0,181,光和,2023-06-08,6380
1609,大亞,181,101,80,光和,2023-06-08,6380
0056,元大高股息,78,2,76,光和,2023-06-08,6380
3583,辛耘,95,23,72,光和,2023-06-08,6380
2344,華邦電,64,5,59,光和,2023-06-08,6380
1612,宏泰,57,2,55,光和,2023-06-08,6380
00919,群益台灣精選高息,47,0,47,光和,2023-06-08,6380
3325,旭品,45,0,45,光和,2023-06-08,6380
00915,凱基優選高股息30,38,0,38,光和,2023-06-08,6380
2888,新光金,41,5,36,光和,2023-06-08,6380
00878,國泰永續高股息,35,0,35,光和,2023-06-08,6380
00679B,元大美債20年,31,0,31,光和,2023-06-08,6380
00665L,富邦�琤肭磪囓�2,31,0,31,光和,2023-06-08,6380
00688L,國泰20年美債正2,30,0,30,光和,2023-06-08,6380
2890,永豐金,25,0,25,光和,2023-06-08,6380
1608,華榮,24,1,23,光和,2023-06-08,6380
9934,成霖,22,0,22,光和,2023-06-08,6380
6126,信音,25,3,22,光和,2023-06-08,6380
3037,欣興,29,8,21,光和,2023-06-08,6380
2457,飛宏,30,10,20,光和,2023-06-08,6380
2030,彰源,18,0,18,光和,2023-06-08,6380
2705,六福,18,0,18,光和,2023-06-08,6380
00795B,中信美國公債20年,16,0,16,光和,2023-06-08,6380
00680L,元大美債20正2,16,0,16,光和,2023-06-08,6380
3715,定穎投控,16,0,16,光和,2023-06-08,6380
5328,華容,16,1,15,光和,2023-06-08,6380
6129,普誠,15,0,15,光和,2023-06-08,6380
2413,環科,14,0,14,光和,2023-06-08,6380
2427,三商電,13,0,13,光和,2023-06-08,6380
4157,太景*-KY,13,0,13,光和,2023-06-08,6380
2347,聯強,13,0,13,光和,2023-06-08,6380
2399,映泰,26,14,12,光和,2023-06-08,6380
2611,志信,16,4,12,光和,2023-06-08,6380
2897,王道銀行,12,0,12,光和,2023-06-08,6380
4102,永日,12,0,12,光和,2023-06-08,6380
8028,昇陽半導體,13,1,12,光和,2023-06-08,6380
8234,新漢,13,1,12,光和,2023-06-08,6380
3078,僑威,27,15,12,光和,2023-06-08,6380
6282,康舒,12,1,11,光和,2023-06-08,6380
1717,長興,11,0,11,光和,2023-06-08,6380
1718,中纖,11,0,11,光和,2023-06-08,6380
2338,光罩,11,0,11,光和,2023-06-08,6380
4916,事欣科,12,1,11,光和,2023-06-08,6380
8936,國統,11,0,11,光和,2023-06-08,6380
1444,力麗,17,7,10,光和,2023-06-08,6380
2204,中華,13,3,10,光和,2023-06-08,6380
2301,光寶科,10,0,10,光和,2023-06-08,6380
3149,正達,10,0,10,光和,2023-06-08,6380
3532,台勝科,10,0,10,光和,2023-06-08,6380
4958,臻鼎-KY,10,0,10,光和,2023-06-08,6380
1314,中石化,168,0,168,光和,2023-06-09,6380
2701,萬企,120,0,120,光和,2023-06-09,6380
00929,復華台灣科技優息,120,1,119,光和,2023-06-09,6380
2888,新光金,110,1,109,光和,2023-06-09,6380
2883,凱基金,95,0,95,光和,2023-06-09,6380
2031,新光鋼,64,0,64,光和,2023-06-09,6380
2614,東森,60,0,60,光和,2023-06-09,6380
3202,樺晟,41,0,41,光和,2023-06-09,6380
2353,宏��,130,90,40,光和,2023-06-09,6380
1609,大亞,67,38,29,光和,2023-06-09,6380
00632R,元大台灣50反1,22,0,22,光和,2023-06-09,6380
1584,精剛,22,2,20,光和,2023-06-09,6380
00885,富邦越南,20,0,20,光和,2023-06-09,6380
00637L,元大滬深300正2,20,0,20,光和,2023-06-09,6380
3030,德律,20,0,20,光和,2023-06-09,6380
6153,嘉聯益,20,0,20,光和,2023-06-09,6380
1524,耿鼎,47,28,19,光和,2023-06-09,6380
2312,金寶,32,13,19,光和,2023-06-09,6380
1802,台玻,18,0,18,光和,2023-06-09,6380
2615,萬海,20,2,18,光和,2023-06-09,6380
2618,長榮航,22,4,18,光和,2023-06-09,6380
2834,臺企銀,20,2,18,光和,2023-06-09,6380
2356,英業達,50,32,18,光和,2023-06-09,6380
3583,辛耘,20,3,17,光和,2023-06-09,6380
1504,東元,35,20,15,光和,2023-06-09,6380
2610,華航,26,11,15,光和,2023-06-09,6380
5443,均豪,14,0,14,光和,2023-06-09,6380
3704,合勤控,14,1,13,光和,2023-06-09,6380
6770,力積電,15,2,13,光和,2023-06-09,6380
8926,台汽電,14,1,13,光和,2023-06-09,6380
3535,晶彩科,17,5,12,光和,2023-06-09,6380
4714,永捷,12,0,12,光和,2023-06-09,6380
2603,長榮,11,0,11,光和,2023-06-09,6380
1903,士紙,11,0,11,光和,2023-06-09,6380
2317,鴻海,10,0,10,光和,2023-06-09,6380
00671R,富邦NASDAQ反1,10,0,10,光和,2023-06-09,6380
00665L,富邦�琤肭磪囓�2,20,10,10,光和,2023-06-09,6380
1909,榮成,10,0,10,光和,2023-06-09,6380
2108,南帝,10,0,10,光和,2023-06-09,6380
2363,矽統,10,0,10,光和,2023-06-09,6380
2867,三商壽,10,0,10,光和,2023-06-09,6380
2905,三商,10,0,10,光和,2023-06-09,6380
3511,矽瑪,10,0,10,光和,2023-06-09,6380
3694,海華,10,0,10,光和,2023-06-09,6380
5426,振發,10,0,10,光和,2023-06-09,6380
2880,華南金,10,0,10,光和,2023-06-09,6380
2731,雄獅,21,12,9,光和,2023-06-09,6380
1708,東鹼,9,0,9,光和,2023-06-09,6380
2482,連宇,12,3,9,光和,2023-06-09,6380
3036A,文曄甲特,9,0,9,光和,2023-06-09,6380
3231,緯創,166,74,92,光和,2023-06-12,6380
00632R,元大台灣50反1,81,0,81,光和,2023-06-12,6380
1218,泰山,66,0,66,光和,2023-06-12,6380
6443,元晶,48,2,46,光和,2023-06-12,6380
2312,金寶,78,34,44,光和,2023-06-12,6380
1710,東聯,39,2,37,光和,2023-06-12,6380
2867,三商壽,37,0,37,光和,2023-06-12,6380
2031,新光鋼,42,6,36,光和,2023-06-12,6380
3207,耀勝,35,1,34,光和,2023-06-12,6380
5425,台半,46,13,33,光和,2023-06-12,6380
6122,擎邦,42,10,32,光和,2023-06-12,6380
2359,所羅門,33,3,30,光和,2023-06-12,6380
00712,復華富時不動產,26,0,26,光和,2023-06-12,6380
2603,長榮,32,6,26,光和,2023-06-12,6380
1504,東元,33,7,26,光和,2023-06-12,6380
6109,亞元,26,0,26,光和,2023-06-12,6380
6125,廣運,41,15,26,光和,2023-06-12,6380
1605,華新,27,2,25,光和,2023-06-12,6380
4979,華星光,27,3,24,光和,2023-06-12,6380
3576,聯合再生,26,3,23,光和,2023-06-12,6380
2701,萬企,21,0,21,光和,2023-06-12,6380
00919,群益台灣精選高息,20,1,19,光和,2023-06-12,6380
3209,全科,19,0,19,光和,2023-06-12,6380
3013,晟銘電,21,2,19,光和,2023-06-12,6380
8034,榮群,22,4,18,光和,2023-06-12,6380
1539,巨庭,17,0,17,光和,2023-06-12,6380
8926,台汽電,35,19,16,光和,2023-06-12,6380
0056,元大高股息,41,25,16,光和,2023-06-12,6380
1718,中纖,21,5,16,光和,2023-06-12,6380
2368,金像電,17,1,16,光和,2023-06-12,6380
2413,環科,16,0,16,光和,2023-06-12,6380
6282,康舒,18,2,16,光和,2023-06-12,6380
00715L,期街口布蘭特正2,15,0,15,光和,2023-06-12,6380
4102,永日,15,0,15,光和,2023-06-12,6380
6160,欣技,15,0,15,光和,2023-06-12,6380
6579,研揚,15,0,15,光和,2023-06-12,6380
8271,宇瞻,16,1,15,光和,2023-06-12,6380
1513,中興電,14,0,14,光和,2023-06-12,6380
2324,仁寶,14,0,14,光和,2023-06-12,6380
2401,凌陽,16,2,14,光和,2023-06-12,6380
8050,廣積,15,1,14,光和,2023-06-12,6380
3374,精材,21,7,14,光和,2023-06-12,6380
2706,第一店,12,0,12,光和,2023-06-12,6380
8938,明安,13,1,12,光和,2023-06-12,6380
00772B,中信高評級公司債,11,0,11,光和,2023-06-12,6380
2062,橋椿,11,0,11,光和,2023-06-12,6380
2736,富野,11,0,11,光和,2023-06-12,6380
3043,科風,11,0,11,光和,2023-06-12,6380
6288,聯嘉,32,21,11,光和,2023-06-12,6380
1609,大亞,23,12,11,光和,2023-06-12,6380
00637L,元大滬深300正2,195,1,194,光和,2023-06-13,6380
2888,新光金,133,20,113,光和,2023-06-13,6380
00897,富邦基因免疫生技,100,0,100,光和,2023-06-13,6380
00929,復華台灣科技優息,96,7,89,光和,2023-06-13,6380
2031,新光鋼,73,0,73,光和,2023-06-13,6380
6288,聯嘉,73,7,66,光和,2023-06-13,6380
9934,成霖,59,0,59,光和,2023-06-13,6380
00715L,期街口布蘭特正2,63,8,55,光和,2023-06-13,6380
3623,富晶通,52,0,52,光和,2023-06-13,6380
1215,卜蜂,30,0,30,光和,2023-06-13,6380
1522,堤維西,64,38,26,光和,2023-06-13,6380
2312,金寶,36,14,22,光和,2023-06-13,6380
4533,協易機,26,4,22,光和,2023-06-13,6380
2515,中工,21,0,21,光和,2023-06-13,6380
2436,偉詮電,20,0,20,光和,2023-06-13,6380
2897,王道銀行,20,0,20,光和,2023-06-13,6380
00632R,元大台灣50反1,19,0,19,光和,2023-06-13,6380
8033,雷虎,20,1,19,光和,2023-06-13,6380
00882,中信中國高股息,18,0,18,光和,2023-06-13,6380
00642U,期元大S＆P石油,17,0,17,光和,2023-06-13,6380
1524,耿鼎,17,0,17,光和,2023-06-13,6380
00919,群益台灣精選高息,17,0,17,光和,2023-06-13,6380
00720B,元大投資級公司債,15,0,15,光和,2023-06-13,6380
1314,中石化,15,0,15,光和,2023-06-13,6380
2883,凱基金,15,0,15,光和,2023-06-13,6380
5351,鈺創,16,1,15,光和,2023-06-13,6380
4543,萬在,14,1,13,光和,2023-06-13,6380
1605,華新,17,4,13,光和,2023-06-13,6380
2890,永豐金,13,0,13,光和,2023-06-13,6380
6443,元晶,15,2,13,光和,2023-06-13,6380
2062,橋椿,12,0,12,光和,2023-06-13,6380
4763,材料-KY,14,2,12,光和,2023-06-13,6380
6153,嘉聯益,12,0,12,光和,2023-06-13,6380
3481,群創,44,33,11,光和,2023-06-13,6380
2002,中鋼,11,0,11,光和,2023-06-13,6380
3374,精材,15,4,11,光和,2023-06-13,6380
8926,台汽電,18,7,11,光和,2023-06-13,6380
00753L,中信中國50正2,10,0,10,光和,2023-06-13,6380
00665L,富邦�琤肭磪囓�2,50,40,10,光和,2023-06-13,6380
1108,幸福,10,0,10,光和,2023-06-13,6380
1220,台榮,10,0,10,光和,2023-06-13,6380
1723,中碳,10,0,10,光和,2023-06-13,6380
2349,錸德,10,0,10,光和,2023-06-13,6380
3055,蔚華科,30,20,10,光和,2023-06-13,6380
3122,笙泉,10,0,10,光和,2023-06-13,6380
5880,合庫金,10,0,10,光和,2023-06-13,6380
6005,群益證,10,0,10,光和,2023-06-13,6380
6109,亞元,10,0,10,光和,2023-06-13,6380
6205,詮欣,11,1,10,光和,2023-06-13,6380
6244,茂迪,10,0,10,光和,2023-06-13,6380
4533,協易機,219,70,149,光和,2023-06-14,6380
6288,聯嘉,144,3,141,光和,2023-06-14,6380
2031,新光鋼,137,0,137,光和,2023-06-14,6380
5483,中美晶,131,0,131,光和,2023-06-14,6380
2888,新光金,77,2,75,光和,2023-06-14,6380
5608,四維航,73,4,69,光和,2023-06-14,6380
2356,英業達,73,28,45,光和,2023-06-14,6380
2834,臺企銀,52,10,42,光和,2023-06-14,6380
2323,中環,54,14,40,光和,2023-06-14,6380
1522,堤維西,89,49,40,光和,2023-06-14,6380
1605,華新,36,0,36,光和,2023-06-14,6380
1314,中石化,34,0,34,光和,2023-06-14,6380
1504,東元,40,6,34,光和,2023-06-14,6380
00712,復華富時不動產,31,0,31,光和,2023-06-14,6380
6282,康舒,38,8,30,光和,2023-06-14,6380
1718,中纖,27,0,27,光和,2023-06-14,6380
3308,聯德,27,0,27,光和,2023-06-14,6380
00679B,元大美債20年,24,0,24,光和,2023-06-14,6380
00680L,元大美債20正2,21,0,21,光和,2023-06-14,6380
3703,欣陸,21,0,21,光和,2023-06-14,6380
00688L,國泰20年美債正2,20,0,20,光和,2023-06-14,6380
1609,大亞,28,10,18,光和,2023-06-14,6380
2543,皇昌,19,1,18,光和,2023-06-14,6380
2705,六福,21,3,18,光和,2023-06-14,6380
2314,台揚,19,3,16,光和,2023-06-14,6380
1527,鑽全,15,0,15,光和,2023-06-14,6380
4564,元翎,17,2,15,光和,2023-06-14,6380
2491,吉祥全,14,0,14,光和,2023-06-14,6380
1338,廣華-KY,13,0,13,光和,2023-06-14,6380
2706,第一店,14,1,13,光和,2023-06-14,6380
00772B,中信高評級公司債,12,0,12,光和,2023-06-14,6380
1710,東聯,11,0,11,光和,2023-06-14,6380
2436,偉詮電,13,2,11,光和,2023-06-14,6380
2481,強茂,11,0,11,光和,2023-06-14,6380
2634,漢翔,12,2,10,光和,2023-06-14,6380
1565,精華,10,0,10,光和,2023-06-14,6380
1717,長興,10,0,10,光和,2023-06-14,6380
2342,茂矽,10,0,10,光和,2023-06-14,6380
2402,毅嘉,15,5,10,光和,2023-06-14,6380
9934,成霖,11,1,10,光和,2023-06-14,6380
8043,蜜望實,10,0,10,光和,2023-06-14,6380
1802,台玻,9,0,9,光和,2023-06-14,6380
2388,威盛,11,2,9,光和,2023-06-14,6380
2405,輔信,11,2,9,光和,2023-06-14,6380
6016,康和證,9,0,9,光和,2023-06-14,6380
3003,健和興,9,1,8,光和,2023-06-14,6380
1312,國喬,8,0,8,光和,2023-06-14,6380
1503,士電,11,3,8,光和,2023-06-14,6380
1514,亞力,10,2,8,光和,2023-06-14,6380
3019,亞光,11,3,8,光和,2023-06-14,6380
3231,緯創,359,21,338,光和,2023-06-15,6380
3576,聯合再生,108,1,107,光和,2023-06-15,6380
3013,晟銘電,56,6,50,光和,2023-06-15,6380
2618,長榮航,138,97,41,光和,2023-06-15,6380
00712,復華富時不動產,37,0,37,光和,2023-06-15,6380
00919,群益台灣精選高息,39,2,37,光和,2023-06-15,6380
00632R,元大台灣50反1,37,0,37,光和,2023-06-15,6380
1609,大亞,41,5,36,光和,2023-06-15,6380
3071,協禧,35,5,30,光和,2023-06-15,6380
00715L,期街口布蘭特正2,28,0,28,光和,2023-06-15,6380
2380,虹光,27,0,27,光和,2023-06-15,6380
2356,英業達,70,45,25,光和,2023-06-15,6380
2883,凱基金,23,2,21,光和,2023-06-15,6380
1314,中石化,25,4,21,光和,2023-06-15,6380
2401,凌陽,30,9,21,光和,2023-06-15,6380
00648R,元大S＆P500反1,20,0,20,光和,2023-06-15,6380
2023,燁輝,20,0,20,光和,2023-06-15,6380
2031,新光鋼,20,0,20,光和,2023-06-15,6380
2374,佳能,20,0,20,光和,2023-06-15,6380
2485,兆赫,20,0,20,光和,2023-06-15,6380
6288,聯嘉,27,7,20,光和,2023-06-15,6380
1504,東元,38,18,20,光和,2023-06-15,6380
5258,虹堡,21,2,19,光和,2023-06-15,6380
2354,鴻準,17,0,17,光和,2023-06-15,6380
1529,樂事綠能,25,9,16,光和,2023-06-15,6380
4533,協易機,23,8,15,光和,2023-06-15,6380
00642U,期元大S＆P石油,15,0,15,光和,2023-06-15,6380
4440,宜新實業,15,0,15,光和,2023-06-15,6380
9907,統一實,15,0,15,光和,2023-06-15,6380
3252,海灣,15,1,14,光和,2023-06-15,6380
2427,三商電,16,4,12,光和,2023-06-15,6380
3481,群創,19,7,12,光和,2023-06-15,6380
5426,振發,12,0,12,光和,2023-06-15,6380
6167,久正,12,0,12,光和,2023-06-15,6380
8201,無敵,12,0,12,光和,2023-06-15,6380
6733,博晟生醫,11,0,11,光和,2023-06-15,6380
00885,富邦越南,11,0,11,光和,2023-06-15,6380
2891,中信金,11,0,11,光和,2023-06-15,6380
2002,中鋼,11,0,11,光和,2023-06-15,6380
2363,矽統,11,1,10,光和,2023-06-15,6380
1710,東聯,10,0,10,光和,2023-06-15,6380
2855,統一證,10,0,10,光和,2023-06-15,6380
2892,第一金,10,0,10,光和,2023-06-15,6380
3046,建��,10,0,10,光和,2023-06-15,6380
4526,東台,10,0,10,光和,2023-06-15,6380
4768,晶呈科技,11,1,10,光和,2023-06-15,6380
6244,茂迪,12,2,10,光和,2023-06-15,6380
6405,悅城,10,0,10,光和,2023-06-15,6380
8105,凌巨,10,0,10,光和,2023-06-15,6380
9958,世紀鋼,10,0,10,光和,2023-06-15,6380
2610,華航,279,175,104,光和,2023-06-16,6380
2371,大同,103,19,84,光和,2023-06-16,6380
2489,瑞軒,66,0,66,光和,2023-06-16,6380
1531,高林股,58,0,58,光和,2023-06-16,6380
2301,光寶科,54,1,53,光和,2023-06-16,6380
3543,州巧,48,0,48,光和,2023-06-16,6380
2356,英業達,71,31,40,光和,2023-06-16,6380
1810,和成,40,5,35,光和,2023-06-16,6380
2618,長榮航,86,53,33,光和,2023-06-16,6380
4534,慶騰,30,0,30,光和,2023-06-16,6380
00919,群益台灣精選高息,31,5,26,光和,2023-06-16,6380
3022,威強電,25,0,25,光和,2023-06-16,6380
5443,均豪,24,0,24,光和,2023-06-16,6380
2801,彰銀,23,0,23,光和,2023-06-16,6380
2404,漢唐,24,2,22,光和,2023-06-16,6380
1447,力鵬,25,3,22,光和,2023-06-16,6380
1608,華榮,26,5,21,光和,2023-06-16,6380
1702,南僑,21,0,21,光和,2023-06-16,6380
2353,宏��,33,12,21,光和,2023-06-16,6380
5347,世界,21,0,21,光和,2023-06-16,6380
1612,宏泰,22,2,20,光和,2023-06-16,6380
1522,堤維西,54,35,19,光和,2023-06-16,6380
3071,協禧,20,1,19,光和,2023-06-16,6380
2340,台亞,21,4,17,光和,2023-06-16,6380
8201,無敵,27,10,17,光和,2023-06-16,6380
2347,聯強,16,0,16,光和,2023-06-16,6380
3338,泰碩,16,0,16,光和,2023-06-16,6380
2834,臺企銀,36,20,16,光和,2023-06-16,6380
8076,伍豐,16,1,15,光和,2023-06-16,6380
2331,精英,15,0,15,光和,2023-06-16,6380
6470,宇智,17,2,15,光和,2023-06-16,6380
6125,廣運,19,5,14,光和,2023-06-16,6380
3231,緯創,55,41,14,光和,2023-06-16,6380
2888,新光金,86,73,13,光和,2023-06-16,6380
2027,大成鋼,15,3,12,光和,2023-06-16,6380
3706,神達,38,26,12,光和,2023-06-16,6380
3055,蔚華科,11,0,11,光和,2023-06-16,6380
00882,中信中國高股息,11,0,11,光和,2023-06-16,6380
5425,台半,12,1,11,光和,2023-06-16,6380
6579,研揚,11,0,11,光和,2023-06-16,6380
00885,富邦越南,10,0,10,光和,2023-06-16,6380
00648R,元大S＆P500反1,10,0,10,光和,2023-06-16,6380
00679B,元大美債20年,10,0,10,光和,2023-06-16,6380
1506,正道,10,0,10,光和,2023-06-16,6380
2031,新光鋼,10,0,10,光和,2023-06-16,6380
2367,燿華,10,0,10,光和,2023-06-16,6380
3032,偉訓,15,5,10,光和,2023-06-16,6380
4956,光鋐,10,0,10,光和,2023-06-16,6380
6015,宏遠證,9,0,9,光和,2023-06-16,6380
9962,有益,9,0,9,光和,2023-06-16,6380
2312,金寶,185,43,142,光和,2023-06-19,6380
5483,中美晶,88,0,88,光和,2023-06-19,6380
6116,彩晶,85,10,75,光和,2023-06-19,6380
2353,宏��,75,0,75,光和,2023-06-19,6380
2515,中工,53,5,48,光和,2023-06-19,6380
5465,富驊,52,4,48,光和,2023-06-19,6380
2014,中鴻,52,7,45,光和,2023-06-19,6380
1609,大亞,44,3,41,光和,2023-06-19,6380
2615,萬海,37,2,35,光和,2023-06-19,6380
00679B,元大美債20年,33,0,33,光和,2023-06-19,6380
1710,東聯,35,3,32,光和,2023-06-19,6380
2356,英業達,42,13,29,光和,2023-06-19,6380
2344,華邦電,31,2,29,光和,2023-06-19,6380
6770,力積電,30,1,29,光和,2023-06-19,6380
00929,復華台灣科技優息,28,0,28,光和,2023-06-19,6380
3078,僑威,42,16,26,光和,2023-06-19,6380
2324,仁寶,25,3,22,光和,2023-06-19,6380
1605,華新,25,7,18,光和,2023-06-19,6380
2313,華通,20,2,18,光和,2023-06-19,6380
00673R,期元大S＆P原油反1,16,0,16,光和,2023-06-19,6380
2402,毅嘉,15,0,15,光和,2023-06-19,6380
1101,台泥,14,0,14,光和,2023-06-19,6380
2208,台船,15,1,14,光和,2023-06-19,6380
2478,大毅,14,0,14,光和,2023-06-19,6380
1503,士電,16,3,13,光和,2023-06-19,6380
5347,世界,13,0,13,光和,2023-06-19,6380
2609,陽明,23,10,13,光和,2023-06-19,6380
00712,復華富時不動產,13,0,13,光和,2023-06-19,6380
4960,誠美材,17,5,12,光和,2023-06-19,6380
3325,旭品,16,4,12,光和,2023-06-19,6380
3576,聯合再生,11,0,11,光和,2023-06-19,6380
6244,茂迪,11,0,11,光和,2023-06-19,6380
3231,緯創,37,26,11,光和,2023-06-19,6380
2705,六福,25,15,10,光和,2023-06-19,6380
1460,宏遠,10,0,10,光和,2023-06-19,6380
2331,精英,12,2,10,光和,2023-06-19,6380
2427,三商電,17,7,10,光和,2023-06-19,6380
6125,廣運,10,0,10,光和,2023-06-19,6380
2388,威盛,13,4,9,光和,2023-06-19,6380
1519,華城,14,5,9,光和,2023-06-19,6380
1584,精剛,19,10,9,光和,2023-06-19,6380
2204,中華,10,1,9,光和,2023-06-19,6380
6282,康舒,28,19,9,光和,2023-06-19,6380
2303,聯電,10,2,8,光和,2023-06-19,6380
1310,台苯,8,0,8,光和,2023-06-19,6380
00888,永豐台灣ESG,8,0,8,光和,2023-06-19,6380
2104,國際中橡,11,3,8,光和,2023-06-19,6380
3588,通嘉,8,0,8,光和,2023-06-19,6380
6163,華電網,10,2,8,光和,2023-06-19,6380
6470,宇智,8,0,8,光和,2023-06-19,6380
5483,中美晶,430,0,430,光和,2023-06-20,6380
00878,國泰永續高股息,126,18,108,光和,2023-06-20,6380
2634,漢翔,144,47,97,光和,2023-06-20,6380
1103,嘉泥,80,5,75,光和,2023-06-20,6380
2337,旺宏,83,21,62,光和,2023-06-20,6380
4534,慶騰,60,0,60,光和,2023-06-20,6380
1528,恩德,61,7,54,光和,2023-06-20,6380
2610,華航,97,45,52,光和,2023-06-20,6380
00897,富邦基因免疫生技,50,0,50,光和,2023-06-20,6380
2409,友達,46,11,35,光和,2023-06-20,6380
6770,力積電,36,3,33,光和,2023-06-20,6380
2356,英業達,53,22,31,光和,2023-06-20,6380
2880,華南金,30,0,30,光和,2023-06-20,6380
3390,旭軟,30,0,30,光和,2023-06-20,6380
1605,華新,30,2,28,光和,2023-06-20,6380
5465,富驊,31,3,28,光和,2023-06-20,6380
1513,中興電,40,16,24,光和,2023-06-20,6380
2801,彰銀,23,0,23,光和,2023-06-20,6380
3481,群創,37,14,23,光和,2023-06-20,6380
2885,元大金,22,0,22,光和,2023-06-20,6380
4123,晟德,21,0,21,光和,2023-06-20,6380
00919,群益台灣精選高息,20,0,20,光和,2023-06-20,6380
3056,富華新,21,1,20,光和,2023-06-20,6380
1447,力鵬,20,0,20,光和,2023-06-20,6380
1524,耿鼎,20,0,20,光和,2023-06-20,6380
2515,中工,20,0,20,光和,2023-06-20,6380
5876,上海商銀,20,0,20,光和,2023-06-20,6380
00712,復華富時不動產,19,0,19,光和,2023-06-20,6380
8171,天宇,20,3,17,光和,2023-06-20,6380
8234,新漢,22,5,17,光和,2023-06-20,6380
2427,三商電,20,4,16,光和,2023-06-20,6380
9904,寶成,15,0,15,光和,2023-06-20,6380
1101,台泥,15,0,15,光和,2023-06-20,6380
00877,復華中國5G,15,0,15,光和,2023-06-20,6380
2454,聯發科,16,2,14,光和,2023-06-20,6380
1785,光洋科,13,0,13,光和,2023-06-20,6380
6217,中探針,19,6,13,光和,2023-06-20,6380
00637L,元大滬深300正2,12,0,12,光和,2023-06-20,6380
00882,中信中國高股息,12,0,12,光和,2023-06-20,6380
1611,中電,12,0,12,光和,2023-06-20,6380
5443,均豪,12,0,12,光和,2023-06-20,6380
00929,復華台灣科技優息,11,0,11,光和,2023-06-20,6380
00900,富邦特選高股息30,11,0,11,光和,2023-06-20,6380
1529,樂事綠能,11,0,11,光和,2023-06-20,6380
2328,廣宇,11,0,11,光和,2023-06-20,6380
00671R,富邦NASDAQ反1,10,0,10,光和,2023-06-20,6380
1460,宏遠,10,0,10,光和,2023-06-20,6380
2028,威致,10,0,10,光和,2023-06-20,6380
2303,聯電,11,1,10,光和,2023-06-20,6380
2897,王道銀行,10,0,10,光和,2023-06-20,6380
2413,環科,136,5,131,光和,2023-06-21,6380
2495,普安,43,0,43,光和,2023-06-21,6380
2889,國票金,41,0,41,光和,2023-06-21,6380
2634,漢翔,175,135,40,光和,2023-06-21,6380
2707,晶華,40,0,40,光和,2023-06-21,6380
3013,晟銘電,52,14,38,光和,2023-06-21,6380
8358,金居,49,20,29,光和,2023-06-21,6380
1533,車王電,32,4,28,光和,2023-06-21,6380
4714,永捷,28,0,28,光和,2023-06-21,6380
1504,東元,32,9,23,光和,2023-06-21,6380
1802,台玻,23,1,22,光和,2023-06-21,6380
6185,幃翔,22,0,22,光和,2023-06-21,6380
8222,寶一,20,0,20,光和,2023-06-21,6380
00882,中信中國高股息,20,0,20,光和,2023-06-21,6380
1609,大亞,29,11,18,光和,2023-06-21,6380
2337,旺宏,18,0,18,光和,2023-06-21,6380
3056,富華新,23,6,17,光和,2023-06-21,6380
2486,一詮,19,2,17,光和,2023-06-21,6380
00665L,富邦�琤肭磪囓�2,17,1,16,光和,2023-06-21,6380
8933,愛地雅,16,0,16,光和,2023-06-21,6380
020022,元大電動車N,15,0,15,光和,2023-06-21,6380
6290,良維,19,4,15,光和,2023-06-21,6380
4108,懷特,13,0,13,光和,2023-06-21,6380
2812,台中銀,13,0,13,光和,2023-06-21,6380
00919,群益台灣精選高息,13,1,12,光和,2023-06-21,6380
3252,海灣,17,5,12,光和,2023-06-21,6380
5425,台半,18,6,12,光和,2023-06-21,6380
5465,富驊,15,3,12,光和,2023-06-21,6380
3006,晶豪科,12,0,12,光和,2023-06-21,6380
1103,嘉泥,40,29,11,光和,2023-06-21,6380
8105,凌巨,11,0,11,光和,2023-06-21,6380
1304,台聚,10,0,10,光和,2023-06-21,6380
2323,中環,16,6,10,光和,2023-06-21,6380
2439,美律,10,0,10,光和,2023-06-21,6380
2705,六福,23,13,10,光和,2023-06-21,6380
3588,通嘉,10,0,10,光和,2023-06-21,6380
3673,TPK-KY,16,6,10,光和,2023-06-21,6380
3694,海華,10,0,10,光和,2023-06-21,6380
4934,太極,11,1,10,光和,2023-06-21,6380
6016,康和證,10,0,10,光和,2023-06-21,6380
6470,宇智,10,0,10,光和,2023-06-21,6380
8277,商丞,10,0,10,光和,2023-06-21,6380
1905,華紙,19,10,9,光和,2023-06-21,6380
1721,三晃,9,0,9,光和,2023-06-21,6380
6770,力積電,11,2,9,光和,2023-06-21,6380
6275,元山,16,8,8,光和,2023-06-21,6380
1444,力麗,8,0,8,光和,2023-06-21,6380
2701,萬企,199,191,8,光和,2023-06-21,6380
2888,新光金,9,1,8,光和,2023-06-21,6380
3380,明泰,13,5,8,光和,2023-06-21,6380
6244,茂迪,145,0,145,光和,2023-06-26,6380
2413,環科,131,0,131,光和,2023-06-26,6380
2888,新光金,86,7,79,光和,2023-06-26,6380
2892,第一金,71,2,69,光和,2023-06-26,6380
00637L,元大滬深300正2,53,0,53,光和,2023-06-26,6380
2340,台亞,65,15,50,光和,2023-06-26,6380
3092,鴻碩,50,0,50,光和,2023-06-26,6380
00908,富邦入息REITs+,41,0,41,光和,2023-06-26,6380
1446,宏和,40,0,40,光和,2023-06-26,6380
2371,大同,65,27,38,光和,2023-06-26,6380
00882,中信中國高股息,34,0,34,光和,2023-06-26,6380
1471,首利,32,2,30,光和,2023-06-26,6380
1605,華新,38,9,29,光和,2023-06-26,6380
3032,偉訓,33,4,29,光和,2023-06-26,6380
6405,悅城,27,0,27,光和,2023-06-26,6380
2883,凱基金,33,6,27,光和,2023-06-26,6380
2367,燿華,26,0,26,光和,2023-06-26,6380
6120,達運,26,2,24,光和,2023-06-26,6380
1905,華紙,43,19,24,光和,2023-06-26,6380
00715L,期街口布蘭特正2,23,0,23,光和,2023-06-26,6380
3481,群創,26,3,23,光和,2023-06-26,6380
2880,華南金,20,0,20,光和,2023-06-26,6380
2701,萬企,20,0,20,光和,2023-06-26,6380
3252,海灣,30,10,20,光和,2023-06-26,6380
6125,廣運,36,17,19,光和,2023-06-26,6380
5347,世界,18,0,18,光和,2023-06-26,6380
2501,國建,16,0,16,光和,2023-06-26,6380
6112,邁達特,16,0,16,光和,2023-06-26,6380
6282,康舒,17,2,15,光和,2023-06-26,6380
1529,樂事綠能,21,6,15,光和,2023-06-26,6380
2312,金寶,21,6,15,光和,2023-06-26,6380
2337,旺宏,21,6,15,光和,2023-06-26,6380
2344,華邦電,21,6,15,光和,2023-06-26,6380
2358,廷鑫,15,0,15,光和,2023-06-26,6380
3260,威剛,15,0,15,光和,2023-06-26,6380
2618,長榮航,48,34,14,光和,2023-06-26,6380
2610,華航,49,36,13,光和,2023-06-26,6380
00929,復華台灣科技優息,13,0,13,光和,2023-06-26,6380
6217,中探針,13,0,13,光和,2023-06-26,6380
4915,致伸,12,0,12,光和,2023-06-26,6380
00642U,期元大S＆P石油,12,0,12,光和,2023-06-26,6380
5443,均豪,12,0,12,光和,2023-06-26,6380
3706,神達,33,21,12,光和,2023-06-26,6380
00900,富邦特選高股息30,11,0,11,光和,2023-06-26,6380
1612,宏泰,11,0,11,光和,2023-06-26,6380
2062,橋椿,11,0,11,光和,2023-06-26,6380
2331,精英,14,3,11,光和,2023-06-26,6380
3041,揚智,11,0,11,光和,2023-06-26,6380
6770,力積電,11,0,11,光和,2023-06-26,6380
8033,雷虎,11,0,11,光和,2023-06-26,6380
00632R,元大台灣50反1,280,6,274,光和,2023-06-27,6380
8936,國統,127,16,111,光和,2023-06-27,6380
00679B,元大美債20年,85,0,85,光和,2023-06-27,6380
2303,聯電,76,4,72,光和,2023-06-27,6380
1605,華新,68,10,58,光和,2023-06-27,6380
6770,力積電,56,0,56,光和,2023-06-27,6380
3481,群創,65,10,55,光和,2023-06-27,6380
3706,神達,59,6,53,光和,2023-06-27,6380
2409,友達,52,5,47,光和,2023-06-27,6380
2701,萬企,43,0,43,光和,2023-06-27,6380
2344,華邦電,41,0,41,光和,2023-06-27,6380
2609,陽明,35,2,33,光和,2023-06-27,6380
2362,藍天,30,0,30,光和,2023-06-27,6380
2888,新光金,31,1,30,光和,2023-06-27,6380
3607,谷崧,30,0,30,光和,2023-06-27,6380
2610,華航,100,71,29,光和,2023-06-27,6380
2027,大成鋼,28,0,28,光和,2023-06-27,6380
3252,海灣,25,3,22,光和,2023-06-27,6380
00687B,國泰20年美債,21,0,21,光和,2023-06-27,6380
1504,東元,24,4,20,光和,2023-06-27,6380
00897,富邦基因免疫生技,20,0,20,光和,2023-06-27,6380
2457,飛宏,22,2,20,光和,2023-06-27,6380
2611,志信,20,0,20,光和,2023-06-27,6380
4503,金雨,22,2,20,光和,2023-06-27,6380
1313,聯成,23,4,19,光和,2023-06-27,6380
2312,金寶,33,14,19,光和,2023-06-27,6380
1609,大亞,35,18,17,光和,2023-06-27,6380
2801,彰銀,20,3,17,光和,2023-06-27,6380
3017,奇鋐,20,3,17,光和,2023-06-27,6380
6509,聚和,17,0,17,光和,2023-06-27,6380
8234,新漢,18,1,17,光和,2023-06-27,6380
6180,橘子,21,5,16,光和,2023-06-27,6380
2618,長榮航,51,36,15,光和,2023-06-27,6380
1710,東聯,15,0,15,光和,2023-06-27,6380
2356,英業達,22,9,13,光和,2023-06-27,6380
2367,燿華,13,0,13,光和,2023-06-27,6380
1314,中石化,12,0,12,光和,2023-06-27,6380
3032,偉訓,18,6,12,光和,2023-06-27,6380
4938,和碩,12,0,12,光和,2023-06-27,6380
2883,凱基金,13,1,12,光和,2023-06-27,6380
00929,復華台灣科技優息,12,0,12,光和,2023-06-27,6380
2323,中環,38,27,11,光和,2023-06-27,6380
8403,盛弘,24,13,11,光和,2023-06-27,6380
4123,晟德,12,2,10,光和,2023-06-27,6380
1103,嘉泥,10,0,10,光和,2023-06-27,6380
1701,中化,10,0,10,光和,2023-06-27,6380
2062,橋椿,10,0,10,光和,2023-06-27,6380
2353,宏��,11,1,10,光和,2023-06-27,6380
2887,台新金,10,0,10,光和,2023-06-27,6380
3583,辛耘,10,0,10,光和,2023-06-27,6380
1605,華新,164,27,137,光和,2023-06-28,6380
00715L,期街口布蘭特正2,117,0,117,光和,2023-06-28,6380
3049,精金,54,0,54,光和,2023-06-28,6380
2609,陽明,52,3,49,光和,2023-06-28,6380
2888,新光金,37,0,37,光和,2023-06-28,6380
3264,欣銓,32,1,31,光和,2023-06-28,6380
3231,緯創,52,21,31,光和,2023-06-28,6380
2880,華南金,30,0,30,光和,2023-06-28,6380
2468,華經,29,0,29,光和,2023-06-28,6380
6770,力積電,29,2,27,光和,2023-06-28,6380
2618,長榮航,83,56,27,光和,2023-06-28,6380
00642U,期元大S＆P石油,26,0,26,光和,2023-06-28,6380
2340,台亞,26,1,25,光和,2023-06-28,6380
6142,友勁,23,0,23,光和,2023-06-28,6380
2457,飛宏,23,1,22,光和,2023-06-28,6380
00679B,元大美債20年,20,0,20,光和,2023-06-28,6380
1101,台泥,39,19,20,光和,2023-06-28,6380
2611,志信,20,0,20,光和,2023-06-28,6380
2883B,凱基金乙特,20,0,20,光和,2023-06-28,6380
5426,振發,20,0,20,光和,2023-06-28,6380
2409,友達,18,0,18,光和,2023-06-28,6380
00900,富邦特選高股息30,17,0,17,光和,2023-06-28,6380
2634,漢翔,26,10,16,光和,2023-06-28,6380
3583,辛耘,16,0,16,光和,2023-06-28,6380
3715,定穎投控,20,4,16,光和,2023-06-28,6380
6125,廣運,19,3,16,光和,2023-06-28,6380
3325,旭品,15,0,15,光和,2023-06-28,6380
6148,驊宏資,17,3,14,光和,2023-06-28,6380
8358,金居,14,0,14,光和,2023-06-28,6380
2344,華邦電,16,2,14,光和,2023-06-28,6380
1513,中興電,16,3,13,光和,2023-06-28,6380
2356,英業達,21,8,13,光和,2023-06-28,6380
6290,良維,23,10,13,光和,2023-06-28,6380
1609,大亞,13,1,12,光和,2023-06-28,6380
4128,中天,12,0,12,光和,2023-06-28,6380
4538,大詠城,12,0,12,光和,2023-06-28,6380
6182,合晶,22,11,11,光和,2023-06-28,6380
00687B,國泰20年美債,10,0,10,光和,2023-06-28,6380
00893,國泰智能電動車,10,0,10,光和,2023-06-28,6380
1611,中電,10,0,10,光和,2023-06-28,6380
1802,台玻,10,0,10,光和,2023-06-28,6380
1909,榮成,10,0,10,光和,2023-06-28,6380
2034,允強,10,0,10,光和,2023-06-28,6380
2617,台航,10,0,10,光和,2023-06-28,6380
2707,晶華,10,0,10,光和,2023-06-28,6380
3540,曜越,10,0,10,光和,2023-06-28,6380
3712,永崴投控,10,0,10,光和,2023-06-28,6380
5328,華容,10,0,10,光和,2023-06-28,6380
6276,安鈦克,13,3,10,光和,2023-06-28,6380
6807,峰源-KY,10,0,10,光和,2023-06-28,6380
4414,如興,101,2,99,光和,2023-06-29,6380
4746,台耀,71,6,65,光和,2023-06-29,6380
8446,華研,52,0,52,光和,2023-06-29,6380
2323,中環,44,2,42,光和,2023-06-29,6380
2419,仲琦,59,20,39,光和,2023-06-29,6380
1605,華新,44,5,39,光和,2023-06-29,6380
2303,聯電,45,14,31,光和,2023-06-29,6380
2618,長榮航,41,11,30,光和,2023-06-29,6380
2883B,凱基金乙特,30,0,30,光和,2023-06-29,6380
2468,華經,29,0,29,光和,2023-06-29,6380
2457,飛宏,28,0,28,光和,2023-06-29,6380
3703,欣陸,28,1,27,光和,2023-06-29,6380
2888,新光金,36,10,26,光和,2023-06-29,6380
2867,三商壽,22,0,22,光和,2023-06-29,6380
00882,中信中國高股息,21,0,21,光和,2023-06-29,6380
1446,宏和,20,0,20,光和,2023-06-29,6380
1733,五鼎,20,0,20,光和,2023-06-29,6380
2915,潤泰全,20,0,20,光和,2023-06-29,6380
6116,彩晶,40,20,20,光和,2023-06-29,6380
6167,久正,20,0,20,光和,2023-06-29,6380
2610,華航,30,11,19,光和,2023-06-29,6380
1527,鑽全,19,0,19,光和,2023-06-29,6380
2609,陽明,36,22,14,光和,2023-06-29,6380
00632R,元大台灣50反1,27,13,14,光和,2023-06-29,6380
2014,中鴻,15,1,14,光和,2023-06-29,6380
2634,漢翔,13,1,12,光和,2023-06-29,6380
00665L,富邦�琤肭磪囓�2,73,61,12,光和,2023-06-29,6380
4716,大立,12,0,12,光和,2023-06-29,6380
00893,國泰智能電動車,17,6,11,光和,2023-06-29,6380
2388,威盛,12,1,11,光和,2023-06-29,6380
3715,定穎投控,11,0,11,光和,2023-06-29,6380
4543,萬在,11,0,11,光和,2023-06-29,6380
6550,北極星藥業-KY,11,0,11,光和,2023-06-29,6380
2913,農林,10,0,10,光和,2023-06-29,6380
3027,盛達,15,5,10,光和,2023-06-29,6380
6496,科懋,10,0,10,光和,2023-06-29,6380
8110,華東,10,0,10,光和,2023-06-29,6380
3025,星通,11,2,9,光和,2023-06-29,6380
4207,環泰,9,0,9,光和,2023-06-29,6380
4526,東台,9,0,9,光和,2023-06-29,6380
2317,鴻海,10,2,8,光和,2023-06-29,6380
2409,友達,8,0,8,光和,2023-06-29,6380
5263,智崴,8,0,8,光和,2023-06-29,6380
1504,東元,7,0,7,光和,2023-06-29,6380
1609,大亞,10,3,7,光和,2023-06-29,6380
2022,聚亨,7,0,7,光和,2023-06-29,6380
5512,力麒,7,0,7,光和,2023-06-29,6380
4563,百德,10,3,7,光和,2023-06-29,6380
00919,群益台灣精選高息,6,0,6,光和,2023-06-29,6380
1752,南光,6,0,6,光和,2023-06-29,6380
2888,新光金,272,0,272,光和,2023-06-30,6380
2603,長榮,112,25,87,光和,2023-06-30,6380
00885,富邦越南,52,0,52,光和,2023-06-30,6380
2618,長榮航,53,13,40,光和,2023-06-30,6380
4533,協易機,41,3,38,光和,2023-06-30,6380
1313,聯成,30,0,30,光和,2023-06-30,6380
2886,兆豐金,30,0,30,光和,2023-06-30,6380
6185,幃翔,24,0,24,光和,2023-06-30,6380
2312,金寶,26,3,23,光和,2023-06-30,6380
2515,中工,23,0,23,光和,2023-06-30,6380
2344,華邦電,22,0,22,光和,2023-06-30,6380
8478,東哥遊艇,22,0,22,光和,2023-06-30,6380
8110,華東,21,0,21,光和,2023-06-30,6380
3704,合勤控,41,20,21,光和,2023-06-30,6380
1446,宏和,20,0,20,光和,2023-06-30,6380
2419,仲琦,22,3,19,光和,2023-06-30,6380
0056,元大高股息,21,2,19,光和,2023-06-30,6380
3071,協禧,27,9,18,光和,2023-06-30,6380
3450,聯鈞,20,2,18,光和,2023-06-30,6380
1605,華新,30,13,17,光和,2023-06-30,6380
1519,華城,16,0,16,光和,2023-06-30,6380
2880,華南金,16,0,16,光和,2023-06-30,6380
1215,卜蜂,15,0,15,光和,2023-06-30,6380
2610,華航,22,8,14,光和,2023-06-30,6380
6153,嘉聯益,17,4,13,光和,2023-06-30,6380
3711,日月光投控,15,3,12,光和,2023-06-30,6380
2002,中鋼,11,0,11,光和,2023-06-30,6380
2834,臺企銀,11,0,11,光和,2023-06-30,6380
00772B,中信高評級公司債,10,0,10,光和,2023-06-30,6380
00688L,國泰20年美債正2,10,0,10,光和,2023-06-30,6380
1789,神隆,10,0,10,光和,2023-06-30,6380
2104,國際中橡,10,0,10,光和,2023-06-30,6380
2915,潤泰全,10,0,10,光和,2023-06-30,6380
4116,明基醫,10,0,10,光和,2023-06-30,6380
4551,智伸科,10,0,10,光和,2023-06-30,6380
1752,南光,10,1,9,光和,2023-06-30,6380
4532,瑞智,30,21,9,光和,2023-06-30,6380
6285,啟��,9,0,9,光和,2023-06-30,6380
3356,奇偶,16,7,9,光和,2023-06-30,6380
2323,中環,16,8,8,光和,2023-06-30,6380
2408,南亞科,8,0,8,光和,2023-06-30,6380
2409,友達,9,1,8,光和,2023-06-30,6380
3014,聯陽,7,0,7,光和,2023-06-30,6380
3234,光環,8,1,7,光和,2023-06-30,6380
3260,威剛,9,2,7,光和,2023-06-30,6380
6874,倍力,7,0,7,光和,2023-06-30,6380
3034,聯詠,6,0,6,光和,2023-06-30,6380
00679B,元大美債20年,6,0,6,光和,2023-06-30,6380
1522,堤維西,6,0,6,光和,2023-06-30,6380
2885,元大金,6,0,6,光和,2023-06-30,6380
2888,新光金,158,0,158,光和,2023-07-03,6380
0056,元大高股息,128,9,119,光和,2023-07-03,6380
1605,華新,145,28,117,光和,2023-07-03,6380
1713,國化,100,0,100,光和,2023-07-03,6380
2312,金寶,75,1,74,光和,2023-07-03,6380
00885,富邦越南,62,0,62,光和,2023-07-03,6380
2356,英業達,76,33,43,光和,2023-07-03,6380
2323,中環,35,1,34,光和,2023-07-03,6380
2329,華泰,42,10,32,光和,2023-07-03,6380
6282,康舒,66,36,30,光和,2023-07-03,6380
4510,高鋒,30,0,30,光和,2023-07-03,6380
1218,泰山,61,34,27,光和,2023-07-03,6380
00679B,元大美債20年,27,0,27,光和,2023-07-03,6380
2409,友達,25,0,25,光和,2023-07-03,6380
2344,華邦電,28,3,25,光和,2023-07-03,6380
3231,緯創,51,28,23,光和,2023-07-03,6380
8358,金居,23,1,22,光和,2023-07-03,6380
3049,精金,20,0,20,光和,2023-07-03,6380
2882,國泰金,18,0,18,光和,2023-07-03,6380
2495,普安,18,0,18,光和,2023-07-03,6380
8033,雷虎,20,2,18,光和,2023-07-03,6380
00878,國泰永續高股息,129,112,17,光和,2023-07-03,6380
6015,宏遠證,15,0,15,光和,2023-07-03,6380
2801,彰銀,16,2,14,光和,2023-07-03,6380
8034,榮群,15,1,14,光和,2023-07-03,6380
3481,群創,23,10,13,光和,2023-07-03,6380
1217,愛之味,13,0,13,光和,2023-07-03,6380
2515,中工,24,11,13,光和,2023-07-03,6380
1609,大亞,23,10,13,光和,2023-07-03,6380
2610,華航,19,7,12,光和,2023-07-03,6380
2105,正新,12,0,12,光和,2023-07-03,6380
2208,台船,20,8,12,光和,2023-07-03,6380
5258,虹堡,13,1,12,光和,2023-07-03,6380
8936,國統,32,20,12,光和,2023-07-03,6380
2457,飛宏,13,2,11,光和,2023-07-03,6380
3006,晶豪科,11,0,11,光和,2023-07-03,6380
3207,耀勝,30,19,11,光和,2023-07-03,6380
5347,世界,11,0,11,光和,2023-07-03,6380
6546,正基,11,0,11,光和,2023-07-03,6380
00919,群益台灣精選高息,11,0,11,光和,2023-07-03,6380
1795,美時,10,0,10,光和,2023-07-03,6380
2441,超豐,10,0,10,光和,2023-07-03,6380
2491,吉祥全,10,0,10,光和,2023-07-03,6380
2501,國建,10,0,10,光和,2023-07-03,6380
2611,志信,10,0,10,光和,2023-07-03,6380
3540,曜越,10,0,10,光和,2023-07-03,6380
1513,中興電,19,9,10,光和,2023-07-03,6380
4938,和碩,9,0,9,光和,2023-07-03,6380
6125,廣運,8,0,8,光和,2023-07-03,6380
00907,永豐優息存股,8,0,8,光和,2023-07-03,6380
5880,合庫金,66,0,66,光和,2023-07-04,6380
4915,致伸,68,6,62,光和,2023-07-04,6380
2615,萬海,80,26,54,光和,2023-07-04,6380
1307,三芳,51,0,51,光和,2023-07-04,6380
00919,群益台灣精選高息,60,13,47,光和,2023-07-04,6380
2618,長榮航,114,72,42,光和,2023-07-04,6380
0056,元大高股息,46,10,36,光和,2023-07-04,6380
1314,中石化,34,0,34,光和,2023-07-04,6380
1513,中興電,33,1,32,光和,2023-07-04,6380
2489,瑞軒,40,10,30,光和,2023-07-04,6380
2888,新光金,31,1,30,光和,2023-07-04,6380
4716,大立,28,0,28,光和,2023-07-04,6380
2603,長榮,59,32,27,光和,2023-07-04,6380
6282,康舒,61,40,21,光和,2023-07-04,6380
1529,樂事綠能,21,0,21,光和,2023-07-04,6380
2883,凱基金,32,11,21,光和,2023-07-04,6380
00637L,元大滬深300正2,21,1,20,光和,2023-07-04,6380
2317,鴻海,36,16,20,光和,2023-07-04,6380
2867,三商壽,20,0,20,光和,2023-07-04,6380
2371,大同,23,4,19,光和,2023-07-04,6380
8110,華東,19,1,18,光和,2023-07-04,6380
2449,京元電子,17,1,16,光和,2023-07-04,6380
3231,緯創,31,15,16,光和,2023-07-04,6380
00929,復華台灣科技優息,15,0,15,光和,2023-07-04,6380
6168,宏齊,17,2,15,光和,2023-07-04,6380
3481,群創,21,7,14,光和,2023-07-04,6380
4746,台耀,14,0,14,光和,2023-07-04,6380
6770,力積電,12,0,12,光和,2023-07-04,6380
6279,胡連,12,0,12,光和,2023-07-04,6380
2324,仁寶,13,2,11,光和,2023-07-04,6380
2201,裕隆,12,1,11,光和,2023-07-04,6380
4543,萬在,15,4,11,光和,2023-07-04,6380
6546,正基,13,2,11,光和,2023-07-04,6380
2547,日勝生,10,0,10,光和,2023-07-04,6380
2641,正德,10,0,10,光和,2023-07-04,6380
2913,農林,10,0,10,光和,2023-07-04,6380
3694,海華,10,0,10,光和,2023-07-04,6380
5236,凌陽創新,10,0,10,光和,2023-07-04,6380
6112,邁達特,14,4,10,光和,2023-07-04,6380
6223,旺矽,13,3,10,光和,2023-07-04,6380
6625,必應,10,0,10,光和,2023-07-04,6380
910322,康師傅-DR,10,0,10,光和,2023-07-04,6380
3252,海灣,10,0,10,光和,2023-07-04,6380
1598,岱宇,10,1,9,光和,2023-07-04,6380
2331,精英,9,0,9,光和,2023-07-04,6380
3374,精材,16,7,9,光和,2023-07-04,6380
3380,明泰,19,10,9,光和,2023-07-04,6380
1708,東鹼,9,1,8,光和,2023-07-04,6380
2034,允強,10,2,8,光和,2023-07-04,6380
4906,正文,11,3,8,光和,2023-07-04,6380
8054,安國,185,0,185,光和,2023-07-05,6380
2371,大同,119,21,98,光和,2023-07-05,6380
8150,南茂,87,0,87,光和,2023-07-05,6380
2609,陽明,168,116,52,光和,2023-07-05,6380
4414,如興,50,0,50,光和,2023-07-05,6380
00665L,富邦�琤肭磪囓�2,47,0,47,光和,2023-07-05,6380
6282,康舒,85,44,41,光和,2023-07-05,6380
00878,國泰永續高股息,73,36,37,光和,2023-07-05,6380
1314,中石化,34,0,34,光和,2023-07-05,6380
4533,協易機,34,0,34,光和,2023-07-05,6380
00929,復華台灣科技優息,33,1,32,光和,2023-07-05,6380
2344,華邦電,32,0,32,光和,2023-07-05,6380
2303,聯電,31,1,30,光和,2023-07-05,6380
8071,能率網通,32,2,30,光和,2023-07-05,6380
2618,長榮航,98,72,26,光和,2023-07-05,6380
3260,威剛,30,6,24,光和,2023-07-05,6380
3481,群創,22,1,21,光和,2023-07-05,6380
6116,彩晶,20,0,20,光和,2023-07-05,6380
00673R,期元大S＆P原油反1,18,0,18,光和,2023-07-05,6380
2390,云辰,20,2,18,光和,2023-07-05,6380
5351,鈺創,17,0,17,光和,2023-07-05,6380
6589,台康生技,17,0,17,光和,2023-07-05,6380
3706,神達,20,5,15,光和,2023-07-05,6380
00712,復華富時不動產,15,0,15,光和,2023-07-05,6380
00632R,元大台灣50反1,20,5,15,光和,2023-07-05,6380
2610,華航,49,34,15,光和,2023-07-05,6380
5258,虹堡,15,0,15,光和,2023-07-05,6380
2883,凱基金,15,1,14,光和,2023-07-05,6380
3025,星通,17,3,14,光和,2023-07-05,6380
3576,聯合再生,14,0,14,光和,2023-07-05,6380
5347,世界,14,0,14,光和,2023-07-05,6380
6546,正基,14,0,14,光和,2023-07-05,6380
8050,廣積,19,5,14,光和,2023-07-05,6380
0056,元大高股息,45,32,13,光和,2023-07-05,6380
2329,華泰,29,16,13,光和,2023-07-05,6380
2486,一詮,15,2,13,光和,2023-07-05,6380
2634,漢翔,16,3,13,光和,2023-07-05,6380
1789,神隆,12,0,12,光和,2023-07-05,6380
2402,毅嘉,31,19,12,光和,2023-07-05,6380
6015,宏遠證,12,0,12,光和,2023-07-05,6380
4934,太極,37,25,12,光和,2023-07-05,6380
1471,首利,13,2,11,光和,2023-07-05,6380
2312,金寶,34,23,11,光和,2023-07-05,6380
5603,陸海,21,10,11,光和,2023-07-05,6380
2374,佳能,10,0,10,光和,2023-07-05,6380
2888,新光金,11,1,10,光和,2023-07-05,6380
3594,磐儀,10,0,10,光和,2023-07-05,6380
6506,雙邦,10,0,10,光和,2023-07-05,6380
9103,美德醫療-DR,10,0,10,光和,2023-07-05,6380
3056,富華新,9,0,9,光和,2023-07-05,6380
4533,協易機,159,76,83,光和,2023-07-06,6380
00688L,國泰20年美債正2,70,0,70,光和,2023-07-06,6380
00882,中信中國高股息,62,0,62,光和,2023-07-06,6380
1471,首利,64,3,61,光和,2023-07-06,6380
4755,三福化,52,0,52,光和,2023-07-06,6380
5521,工信,50,0,50,光和,2023-07-06,6380
6770,力積電,60,10,50,光和,2023-07-06,6380
0056,元大高股息,55,8,47,光和,2023-07-06,6380
2317,鴻海,50,7,43,光和,2023-07-06,6380
2618,長榮航,46,7,39,光和,2023-07-06,6380
00900,富邦特選高股息30,38,0,38,光和,2023-07-06,6380
4566,時碩工業,36,0,36,光和,2023-07-06,6380
6456,GIS-KY,35,0,35,光和,2023-07-06,6380
2882,國泰金,33,0,33,光和,2023-07-06,6380
00665L,富邦�琤肭磪囓�2,32,0,32,光和,2023-07-06,6380
8478,東哥遊艇,37,5,32,光和,2023-07-06,6380
8054,安國,30,0,30,光和,2023-07-06,6380
2323,中環,35,6,29,光和,2023-07-06,6380
00673R,期元大S＆P原油反1,29,0,29,光和,2023-07-06,6380
2609,陽明,67,38,29,光和,2023-07-06,6380
00680L,元大美債20正2,28,0,28,光和,2023-07-06,6380
4746,台耀,29,1,28,光和,2023-07-06,6380
1337,再生-KY,25,0,25,光和,2023-07-06,6380
2881,富邦金,25,0,25,光和,2023-07-06,6380
3049,精金,26,1,25,光和,2023-07-06,6380
2892,第一金,24,0,24,光和,2023-07-06,6380
3037,欣興,23,0,23,光和,2023-07-06,6380
2337,旺宏,26,3,23,光和,2023-07-06,6380
2344,華邦電,23,0,23,光和,2023-07-06,6380
2449,京元電子,29,6,23,光和,2023-07-06,6380
2883,凱基金,23,2,21,光和,2023-07-06,6380
1434,福懋,25,4,21,光和,2023-07-06,6380
00927,群益半導體收益,20,0,20,光和,2023-07-06,6380
3071,協禧,25,5,20,光和,2023-07-06,6380
5347,世界,20,0,20,光和,2023-07-06,6380
2885,元大金,19,0,19,光和,2023-07-06,6380
2356,英業達,33,15,18,光和,2023-07-06,6380
2867,三商壽,20,2,18,光和,2023-07-06,6380
6116,彩晶,19,1,18,光和,2023-07-06,6380
3041,揚智,19,2,17,光和,2023-07-06,6380
6016,康和證,18,1,17,光和,2023-07-06,6380
8215,明基材,19,2,17,光和,2023-07-06,6380
2002,中鋼,17,0,17,光和,2023-07-06,6380
2399,映泰,16,0,16,光和,2023-07-06,6380
6275,元山,16,0,16,光和,2023-07-06,6380
9934,成霖,16,0,16,光和,2023-07-06,6380
2457,飛宏,17,2,15,光和,2023-07-06,6380
2547,日勝生,15,0,15,光和,2023-07-06,6380
3078,僑威,16,2,14,光和,2023-07-06,6380
1905,華紙,15,1,14,光和,2023-07-06,6380
3481,群創,175,25,150,光和,2023-07-07,6380
2701,萬企,100,0,100,光和,2023-07-07,6380
00929,復華台灣科技優息,66,1,65,光和,2023-07-07,6380
6770,力積電,49,5,44,光和,2023-07-07,6380
2888,新光金,53,13,40,光和,2023-07-07,6380
1101,台泥,40,2,38,光和,2023-07-07,6380
3049,精金,40,3,37,光和,2023-07-07,6380
2344,華邦電,41,5,36,光和,2023-07-07,6380
00927,群益半導體收益,30,0,30,光和,2023-07-07,6380
2883,凱基金,34,6,28,光和,2023-07-07,6380
3078,僑威,26,1,25,光和,2023-07-07,6380
3071,協禧,24,0,24,光和,2023-07-07,6380
1471,首利,23,1,22,光和,2023-07-07,6380
4746,台耀,25,3,22,光和,2023-07-07,6380
0056,元大高股息,30,8,22,光和,2023-07-07,6380
1605,華新,21,0,21,光和,2023-07-07,6380
2340,台亞,31,10,21,光和,2023-07-07,6380
00878,國泰永續高股息,77,57,20,光和,2023-07-07,6380
00688L,國泰20年美債正2,20,0,20,光和,2023-07-07,6380
2390,云辰,20,0,20,光和,2023-07-07,6380
4510,高鋒,36,16,20,光和,2023-07-07,6380
3231,緯創,36,16,20,光和,2023-07-07,6380
5512,力麒,19,0,19,光和,2023-07-07,6380
2409,友達,16,0,16,光和,2023-07-07,6380
1504,東元,27,11,16,光和,2023-07-07,6380
3694,海華,16,0,16,光和,2023-07-07,6380
2208,台船,20,5,15,光和,2023-07-07,6380
6244,茂迪,15,0,15,光和,2023-07-07,6380
6457,紘康,16,1,15,光和,2023-07-07,6380
8358,金居,15,0,15,光和,2023-07-07,6380
3006,晶豪科,14,0,14,光和,2023-07-07,6380
1710,東聯,14,0,14,光和,2023-07-07,6380
00665L,富邦�琤肭磪囓�2,13,0,13,光和,2023-07-07,6380
00673R,期元大S＆P原油反1,13,0,13,光和,2023-07-07,6380
2331,精英,13,0,13,光和,2023-07-07,6380
6443,元晶,22,10,12,光和,2023-07-07,6380
2427,三商電,18,7,11,光和,2023-07-07,6380
5258,虹堡,17,6,11,光和,2023-07-07,6380
5864,致和證,11,0,11,光和,2023-07-07,6380
1218,泰山,11,1,10,光和,2023-07-07,6380
1626,艾美特-KY,10,0,10,光和,2023-07-07,6380
1701,中化,12,2,10,光和,2023-07-07,6380
2034,允強,10,0,10,光和,2023-07-07,6380
3029,零壹,10,0,10,光和,2023-07-07,6380
3055,蔚華科,10,0,10,光和,2023-07-07,6380
3059,華晶科,10,0,10,光和,2023-07-07,6380
3450,聯鈞,10,0,10,光和,2023-07-07,6380
4989,榮科,10,0,10,光和,2023-07-07,6380
5328,華容,10,0,10,光和,2023-07-07,6380
6275,元山,10,0,10,光和,2023-07-07,6380
9105,泰金寶-DR,90,0,90,光和,2023-07-10,6380
1909,榮成,82,0,82,光和,2023-07-10,6380
6282,康舒,77,14,63,光和,2023-07-10,6380
00688L,國泰20年美債正2,50,0,50,光和,2023-07-10,6380
4155,訊映,49,0,49,光和,2023-07-10,6380
00929,復華台灣科技優息,40,0,40,光和,2023-07-10,6380
2609,陽明,66,26,40,光和,2023-07-10,6380
2317,鴻海,34,6,28,光和,2023-07-10,6380
2356,英業達,32,4,28,光和,2023-07-10,6380
2312,金寶,39,12,27,光和,2023-07-10,6380
4503,金雨,27,0,27,光和,2023-07-10,6380
6015,宏遠證,26,0,26,光和,2023-07-10,6380
1314,中石化,37,12,25,光和,2023-07-10,6380
00882,中信中國高股息,25,1,24,光和,2023-07-10,6380
1513,中興電,25,1,24,光和,2023-07-10,6380
6266,泰詠,23,0,23,光和,2023-07-10,6380
3078,僑威,29,8,21,光和,2023-07-10,6380
2457,飛宏,20,0,20,光和,2023-07-10,6380
2890,永豐金,20,0,20,光和,2023-07-10,6380
4934,太極,29,9,20,光和,2023-07-10,6380
6168,宏齊,22,2,20,光和,2023-07-10,6380
8054,安國,30,10,20,光和,2023-07-10,6380
00680L,元大美債20正2,19,0,19,光和,2023-07-10,6380
3325,旭品,33,14,19,光和,2023-07-10,6380
00673R,期元大S＆P原油反1,18,0,18,光和,2023-07-10,6380
4532,瑞智,46,28,18,光和,2023-07-10,6380
00712,復華富時不動產,17,0,17,光和,2023-07-10,6380
1605,華新,21,5,16,光和,2023-07-10,6380
8069,元太,16,0,16,光和,2023-07-10,6380
00665L,富邦�琤肭磪囓�2,35,20,15,光和,2023-07-10,6380
2002,中鋼,14,0,14,光和,2023-07-10,6380
4564,元翎,14,0,14,光和,2023-07-10,6380
6153,嘉聯益,19,5,14,光和,2023-07-10,6380
6770,力積電,22,8,14,光和,2023-07-10,6380
8050,廣積,14,1,13,光和,2023-07-10,6380
2615,萬海,16,3,13,光和,2023-07-10,6380
00772B,中信高評級公司債,12,0,12,光和,2023-07-10,6380
3022,威強電,12,0,12,光和,2023-07-10,6380
6016,康和證,12,0,12,光和,2023-07-10,6380
2105,正新,18,7,11,光和,2023-07-10,6380
00671R,富邦NASDAQ反1,10,0,10,光和,2023-07-10,6380
1447,力鵬,10,0,10,光和,2023-07-10,6380
1611,中電,11,1,10,光和,2023-07-10,6380
2038,海光,10,0,10,光和,2023-07-10,6380
2363,矽統,10,0,10,光和,2023-07-10,6380
2515,中工,10,0,10,光和,2023-07-10,6380
3128,昇銳,10,0,10,光和,2023-07-10,6380
4102,永日,10,0,10,光和,2023-07-10,6380
8476,台境*,10,0,10,光和,2023-07-10,6380
9103,美德醫療-DR,10,0,10,光和,2023-07-10,6380
2881,富邦金,121,1,120,光和,2023-07-11,6380
2705,六福,73,1,72,光和,2023-07-11,6380
4746,台耀,58,2,56,光和,2023-07-11,6380
2457,飛宏,54,2,52,光和,2023-07-11,6380
00929,復華台灣科技優息,50,0,50,光和,2023-07-11,6380
6216,居易,38,0,38,光和,2023-07-11,6380
2481,強茂,53,18,35,光和,2023-07-11,6380
3694,海華,33,0,33,光和,2023-07-11,6380
1710,東聯,30,0,30,光和,2023-07-11,6380
3231,緯創,47,22,25,光和,2023-07-11,6380
5425,台半,30,6,24,光和,2023-07-11,6380
6015,宏遠證,27,3,24,光和,2023-07-11,6380
4162,智擎,23,0,23,光和,2023-07-11,6380
1471,首利,24,1,23,光和,2023-07-11,6380
1785,光洋科,23,1,22,光和,2023-07-11,6380
4543,萬在,22,1,21,光和,2023-07-11,6380
8933,愛地雅,21,0,21,光和,2023-07-11,6380
2371,大同,36,16,20,光和,2023-07-11,6380
4114,健喬,20,0,20,光和,2023-07-11,6380
6152,百一,20,0,20,光和,2023-07-11,6380
2867,三商壽,40,21,19,光和,2023-07-11,6380
6120,達運,43,24,19,光和,2023-07-11,6380
1101,台泥,18,0,18,光和,2023-07-11,6380
6166,凌華,18,0,18,光和,2023-07-11,6380
2312,金寶,24,6,18,光和,2023-07-11,6380
3049,精金,20,3,17,光和,2023-07-11,6380
00679B,元大美債20年,16,0,16,光和,2023-07-11,6380
1605,華新,17,1,16,光和,2023-07-11,6380
2634,漢翔,18,2,16,光和,2023-07-11,6380
00919,群益台灣精選高息,15,0,15,光和,2023-07-11,6380
2444,兆勁,18,4,14,光和,2023-07-11,6380
2883,凱基金,16,2,14,光和,2023-07-11,6380
2609,陽明,52,39,13,光和,2023-07-11,6380
1618,合機,15,2,13,光和,2023-07-11,6380
4916,事欣科,13,0,13,光和,2023-07-11,6380
1604,聲寶,13,0,13,光和,2023-07-11,6380
2313,華通,12,0,12,光和,2023-07-11,6380
2340,台亞,29,17,12,光和,2023-07-11,6380
8234,新漢,23,11,12,光和,2023-07-11,6380
8926,台汽電,25,13,12,光和,2023-07-11,6380
4532,瑞智,66,55,11,光和,2023-07-11,6380
1708,東鹼,11,0,11,光和,2023-07-11,6380
3661,世芯-KY,16,5,11,光和,2023-07-11,6380
6244,茂迪,11,0,11,光和,2023-07-11,6380
1737,臺鹽,12,2,10,光和,2023-07-11,6380
1802,台玻,10,0,10,光和,2023-07-11,6380
2062,橋椿,10,0,10,光和,2023-07-11,6380
2493,揚博,10,0,10,光和,2023-07-11,6380
2611,志信,10,0,10,光和,2023-07-11,6380
3047,訊舟,10,0,10,光和,2023-07-11,6380
9105,泰金寶-DR,500,0,500,光和,2023-07-12,6380
5483,中美晶,143,4,139,光和,2023-07-12,6380
2701,萬企,101,0,101,光和,2023-07-12,6380
2345,智邦,100,0,100,光和,2023-07-12,6380
2303,聯電,116,29,87,光和,2023-07-12,6380
2356,英業達,128,47,81,光和,2023-07-12,6380
2610,華航,138,58,80,光和,2023-07-12,6380
00878,國泰永續高股息,68,17,51,光和,2023-07-12,6380
2537,聯上發,45,0,45,光和,2023-07-12,6380
1522,堤維西,35,0,35,光和,2023-07-12,6380
2515,中工,30,1,29,光和,2023-07-12,6380
3252,海灣,30,2,28,光和,2023-07-12,6380
2609,陽明,72,49,23,光和,2023-07-12,6380
8033,雷虎,22,0,22,光和,2023-07-12,6380
2867,三商壽,31,10,21,光和,2023-07-12,6380
1584,精剛,21,1,20,光和,2023-07-12,6380
00712,復華富時不動產,29,10,19,光和,2023-07-12,6380
2023,燁輝,20,1,19,光和,2023-07-12,6380
3265,台星科,25,8,17,光和,2023-07-12,6380
00673R,期元大S＆P原油反1,18,2,16,光和,2023-07-12,6380
5439,高技,18,3,15,光和,2023-07-12,6380
1785,光洋科,19,4,15,光和,2023-07-12,6380
2324,仁寶,18,3,15,光和,2023-07-12,6380
4527,方土霖,24,9,15,光和,2023-07-12,6380
6116,彩晶,25,10,15,光和,2023-07-12,6380
6589,台康生技,15,0,15,光和,2023-07-12,6380
6133,金橋,14,0,14,光和,2023-07-12,6380
3025,星通,16,3,13,光和,2023-07-12,6380
3207,耀勝,16,3,13,光和,2023-07-12,6380
2340,台亞,18,6,12,光和,2023-07-12,6380
4934,太極,14,2,12,光和,2023-07-12,6380
6015,宏遠證,12,0,12,光和,2023-07-12,6380
2002,中鋼,15,4,11,光和,2023-07-12,6380
1783,和康生,11,0,11,光和,2023-07-12,6380
5608,四維航,11,0,11,光和,2023-07-12,6380
6285,啟��,13,2,11,光和,2023-07-12,6380
2834,臺企銀,11,0,11,光和,2023-07-12,6380
00919,群益台灣精選高息,10,0,10,光和,2023-07-12,6380
1471,首利,11,1,10,光和,2023-07-12,6380
2038,海光,10,0,10,光和,2023-07-12,6380
2204,中華,20,10,10,光和,2023-07-12,6380
2374,佳能,10,0,10,光和,2023-07-12,6380
2455,全新,10,0,10,光和,2023-07-12,6380
3532,台勝科,11,1,10,光和,2023-07-12,6380
3701,大眾控,10,0,10,光和,2023-07-12,6380
3714,富采,10,0,10,光和,2023-07-12,6380
4440,宜新實業,10,0,10,光和,2023-07-12,6380
2603,長榮,13,3,10,光和,2023-07-12,6380
6770,力積電,13,3,10,光和,2023-07-12,6380
1217,愛之味,9,0,9,光和,2023-07-12,6380
4533,協易機,302,63,239,光和,2023-07-13,6380
2618,長榮航,248,73,175,光和,2023-07-13,6380
3706,神達,181,66,115,光和,2023-07-13,6380
2897,王道銀行,80,0,80,光和,2023-07-13,6380
1609,大亞,74,5,69,光和,2023-07-13,6380
2481,強茂,64,6,58,光和,2023-07-13,6380
2402,毅嘉,46,1,45,光和,2023-07-13,6380
2303,聯電,60,20,40,光和,2023-07-13,6380
00712,復華富時不動產,48,10,38,光和,2023-07-13,6380
3711,日月光投控,41,6,35,光和,2023-07-13,6380
3380,明泰,39,5,34,光和,2023-07-13,6380
2324,仁寶,71,38,33,光和,2023-07-13,6380
4510,高鋒,32,0,32,光和,2023-07-13,6380
2337,旺宏,40,10,30,光和,2023-07-13,6380
8201,無敵,30,0,30,光和,2023-07-13,6380
6443,元晶,37,8,29,光和,2023-07-13,6380
6015,宏遠證,29,1,28,光和,2023-07-13,6380
00930,永豐ESG低碳高息,23,0,23,光和,2023-07-13,6380
6120,達運,46,25,21,光和,2023-07-13,6380
1710,東聯,20,1,19,光和,2023-07-13,6380
2353,宏��,98,79,19,光和,2023-07-13,6380
3035,智原,29,11,18,光和,2023-07-13,6380
8050,廣積,33,15,18,光和,2023-07-13,6380
1802,台玻,17,0,17,光和,2023-07-13,6380
00679B,元大美債20年,16,0,16,光和,2023-07-13,6380
6188,廣明,53,37,16,光和,2023-07-13,6380
2371,大同,23,9,14,光和,2023-07-13,6380
2603,長榮,27,14,13,光和,2023-07-13,6380
2376,技嘉,16,3,13,光和,2023-07-13,6380
1471,首利,22,10,12,光和,2023-07-13,6380
3062,建漢,12,0,12,光和,2023-07-13,6380
5328,華容,13,1,12,光和,2023-07-13,6380
2609,陽明,71,59,12,光和,2023-07-13,6380
2455,全新,12,0,12,光和,2023-07-13,6380
00673R,期元大S＆P原油反1,16,5,11,光和,2023-07-13,6380
2611,志信,11,0,11,光和,2023-07-13,6380
2701,萬企,11,0,11,光和,2023-07-13,6380
3234,光環,13,2,11,光和,2023-07-13,6380
00671R,富邦NASDAQ反1,10,0,10,光和,2023-07-13,6380
00687B,國泰20年美債,10,0,10,光和,2023-07-13,6380
00680L,元大美債20正2,10,0,10,光和,2023-07-13,6380
1220,台榮,10,0,10,光和,2023-07-13,6380
1517,利奇,10,0,10,光和,2023-07-13,6380
2038,海光,10,0,10,光和,2023-07-13,6380
2884,玉山金,20,10,10,光和,2023-07-13,6380
3059,華晶科,10,0,10,光和,2023-07-13,6380
3149,正達,10,0,10,光和,2023-07-13,6380
3325,旭品,30,20,10,光和,2023-07-13,6380
4566,時碩工業,10,0,10,光和,2023-07-13,6380
6790,永豐實,10,0,10,光和,2023-07-13,6380
1314,中石化,149,0,149,光和,2023-07-14,6380
2610,華航,209,71,138,光和,2023-07-14,6380
00929,復華台灣科技優息,86,4,82,光和,2023-07-14,6380
6282,康舒,89,13,76,光和,2023-07-14,6380
2329,華泰,106,36,70,光和,2023-07-14,6380
0056,元大高股息,110,48,62,光和,2023-07-14,6380
2344,華邦電,62,21,41,光和,2023-07-14,6380
2330,台積電,48,8,40,光和,2023-07-14,6380
6443,元晶,46,6,40,光和,2023-07-14,6380
2362,藍天,38,0,38,光和,2023-07-14,6380
3044,健鼎,30,0,30,光和,2023-07-14,6380
5483,中美晶,30,3,27,光和,2023-07-14,6380
3051,力特,25,2,23,光和,2023-07-14,6380
1609,大亞,35,14,21,光和,2023-07-14,6380
00712,復華富時不動產,20,0,20,光和,2023-07-14,6380
1714,和桐,20,0,20,光和,2023-07-14,6380
3049,精金,20,0,20,光和,2023-07-14,6380
3704,合勤控,31,12,19,光和,2023-07-14,6380
4915,致伸,21,2,19,光和,2023-07-14,6380
1503,士電,24,5,19,光和,2023-07-14,6380
2419,仲琦,37,18,19,光和,2023-07-14,6380
4931,新盛力,20,1,19,光和,2023-07-14,6380
2353,宏��,32,14,18,光和,2023-07-14,6380
00882,中信中國高股息,17,0,17,光和,2023-07-14,6380
3176,基亞,16,0,16,光和,2023-07-14,6380
2382,廣達,31,16,15,光和,2023-07-14,6380
00673R,期元大S＆P原油反1,15,0,15,光和,2023-07-14,6380
9904,寶成,15,0,15,光和,2023-07-14,6380
00632R,元大台灣50反1,64,50,14,光和,2023-07-14,6380
2030,彰源,14,0,14,光和,2023-07-14,6380
3032,偉訓,19,6,13,光和,2023-07-14,6380
6116,彩晶,29,16,13,光和,2023-07-14,6380
1718,中纖,11,0,11,光和,2023-07-14,6380
2867,三商壽,11,0,11,光和,2023-07-14,6380
3703,欣陸,11,0,11,光和,2023-07-14,6380
6185,幃翔,11,0,11,光和,2023-07-14,6380
1802,台玻,10,0,10,光和,2023-07-14,6380
2436,偉詮電,10,0,10,光和,2023-07-14,6380
3041,揚智,10,0,10,光和,2023-07-14,6380
3149,正達,10,0,10,光和,2023-07-14,6380
3325,旭品,21,11,10,光和,2023-07-14,6380
3646,艾恩特,10,0,10,光和,2023-07-14,6380
4543,萬在,10,0,10,光和,2023-07-14,6380
8011,台通,10,0,10,光和,2023-07-14,6380
2356,英業達,108,98,10,光和,2023-07-14,6380
6235,華孚,11,2,9,光和,2023-07-14,6380
4747,強生,9,0,9,光和,2023-07-14,6380
6015,宏遠證,9,0,9,光和,2023-07-14,6380
1304,台聚,10,2,8,光和,2023-07-14,6380
2359,所羅門,20,12,8,光和,2023-07-14,6380
00929,復華台灣科技優息,107,4,103,光和,2023-07-17,6380
00878,國泰永續高股息,111,27,84,光和,2023-07-17,6380
2614,東森,75,0,75,光和,2023-07-17,6380
8050,廣積,75,7,68,光和,2023-07-17,6380
4532,瑞智,75,11,64,光和,2023-07-17,6380
1314,中石化,60,12,48,光和,2023-07-17,6380
4906,正文,48,2,46,光和,2023-07-17,6380
2344,華邦電,54,11,43,光和,2023-07-17,6380
2025,千興,37,0,37,光和,2023-07-17,6380
8071,能率網通,34,0,34,光和,2023-07-17,6380
3706,神達,35,5,30,光和,2023-07-17,6380
6120,達運,30,0,30,光和,2023-07-17,6380
00637L,元大滬深300正2,25,1,24,光和,2023-07-17,6380
1815,富喬,23,0,23,光和,2023-07-17,6380
2314,台揚,27,4,23,光和,2023-07-17,6380
3057,喬鼎,22,0,22,光和,2023-07-17,6380
3325,旭品,24,2,22,光和,2023-07-17,6380
4116,明基醫,22,0,22,光和,2023-07-17,6380
00665L,富邦�琤肭磪囓�2,20,0,20,光和,2023-07-17,6380
6005,群益證,20,1,19,光和,2023-07-17,6380
3035,智原,31,12,19,光和,2023-07-17,6380
2867,三商壽,20,2,18,光和,2023-07-17,6380
1527,鑽全,17,0,17,光和,2023-07-17,6380
3032,偉訓,18,1,17,光和,2023-07-17,6380
3037,欣興,21,5,16,光和,2023-07-17,6380
2303,聯電,21,5,16,光和,2023-07-17,6380
2352,佳世達,21,5,16,光和,2023-07-17,6380
6235,華孚,18,2,16,光和,2023-07-17,6380
2302,麗正,15,0,15,光和,2023-07-17,6380
00930,永豐ESG低碳高息,14,0,14,光和,2023-07-17,6380
1711,永光,24,11,13,光和,2023-07-17,6380
2801,彰銀,13,0,13,光和,2023-07-17,6380
3047,訊舟,16,3,13,光和,2023-07-17,6380
1101,台泥,15,2,13,光和,2023-07-17,6380
2455,全新,12,0,12,光和,2023-07-17,6380
2359,所羅門,14,2,12,光和,2023-07-17,6380
4566,時碩工業,12,0,12,光和,2023-07-17,6380
6153,嘉聯益,12,0,12,光和,2023-07-17,6380
2382,廣達,19,8,11,光和,2023-07-17,6380
3231,緯創,23,12,11,光和,2023-07-17,6380
1103,嘉泥,11,0,11,光和,2023-07-17,6380
1313,聯成,30,19,11,光和,2023-07-17,6380
2515,中工,13,2,11,光和,2023-07-17,6380
3306,鼎天,15,4,11,光和,2023-07-17,6380
00680L,元大美債20正2,10,0,10,光和,2023-07-17,6380
3019,亞光,10,0,10,光和,2023-07-17,6380
3027,盛達,13,3,10,光和,2023-07-17,6380
3052,夆典,10,0,10,光和,2023-07-17,6380
8070,長華*,10,0,10,光和,2023-07-17,6380
8150,南茂,10,0,10,光和,2023-07-17,6380
2371,大同,153,17,136,光和,2023-07-18,6380
2312,金寶,215,80,135,光和,2023-07-18,6380
2353,宏��,168,89,79,光和,2023-07-18,6380
1101,台泥,67,1,66,光和,2023-07-18,6380
3706,神達,157,93,64,光和,2023-07-18,6380
2419,仲琦,86,25,61,光和,2023-07-18,6380
2356,英業達,124,63,61,光和,2023-07-18,6380
2324,仁寶,134,77,57,光和,2023-07-18,6380
2359,所羅門,70,16,54,光和,2023-07-18,6380
4716,大立,50,0,50,光和,2023-07-18,6380
1609,大亞,55,13,42,光和,2023-07-18,6380
00882,中信中國高股息,40,0,40,光和,2023-07-18,6380
3078,僑威,61,25,36,光和,2023-07-18,6380
2603,長榮,40,9,31,光和,2023-07-18,6380
6124,業強,27,1,26,光和,2023-07-18,6380
3071,協禧,33,8,25,光和,2023-07-18,6380
4915,致伸,25,1,24,光和,2023-07-18,6380
6015,宏遠證,25,1,24,光和,2023-07-18,6380
2888,新光金,129,106,23,光和,2023-07-18,6380
1527,鑽全,22,0,22,光和,2023-07-18,6380
5469,瀚宇博,23,1,22,光和,2023-07-18,6380
6419,京晨科,22,0,22,光和,2023-07-18,6380
8936,國統,21,0,21,光和,2023-07-18,6380
1539,巨庭,20,0,20,光和,2023-07-18,6380
2425,承啟,31,11,20,光和,2023-07-18,6380
5512,力麒,20,0,20,光和,2023-07-18,6380
8933,愛地雅,20,0,20,光和,2023-07-18,6380
1513,中興電,27,8,19,光和,2023-07-18,6380
2375,凱美,19,0,19,光和,2023-07-18,6380
3260,威剛,21,2,19,光和,2023-07-18,6380
4906,正文,23,4,19,光和,2023-07-18,6380
4123,晟德,20,2,18,光和,2023-07-18,6380
00720B,元大投資級公司債,18,0,18,光和,2023-07-18,6380
1710,東聯,18,0,18,光和,2023-07-18,6380
2913,農林,20,2,18,光和,2023-07-18,6380
3163,波若威,43,25,18,光和,2023-07-18,6380
2812,台中銀,29,11,18,光和,2023-07-18,6380
1605,華新,26,9,17,光和,2023-07-18,6380
1515,力山,17,0,17,光和,2023-07-18,6380
6290,良維,16,0,16,光和,2023-07-18,6380
8358,金居,16,0,16,光和,2023-07-18,6380
2382,廣達,29,13,16,光和,2023-07-18,6380
6188,廣明,22,7,15,光和,2023-07-18,6380
2883,凱基金,17,3,14,光和,2023-07-18,6380
4919,新唐,18,5,13,光和,2023-07-18,6380
1789,神隆,15,3,12,光和,2023-07-18,6380
2374,佳能,23,11,12,光和,2023-07-18,6380
2497,怡利電,12,0,12,光和,2023-07-18,6380
6244,茂迪,12,0,12,光和,2023-07-18,6380
1313,聯成,21,10,11,光和,2023-07-18,6380
1314,中石化,160,5,155,光和,2023-07-19,6380
2801,彰銀,93,1,92,光和,2023-07-19,6380
00882,中信中國高股息,101,20,81,光和,2023-07-19,6380
00665L,富邦�琤肭磪囓�2,72,10,62,光和,2023-07-19,6380
4173,久裕,60,0,60,光和,2023-07-19,6380
2317,鴻海,91,31,60,光和,2023-07-19,6380
00753L,中信中國50正2,52,0,52,光和,2023-07-19,6380
2324,仁寶,94,42,52,光和,2023-07-19,6380
1337,再生-KY,50,0,50,光和,2023-07-19,6380
2371,大同,52,5,47,光和,2023-07-19,6380
4938,和碩,42,8,34,光和,2023-07-19,6380
2303,聯電,31,0,31,光和,2023-07-19,6380
4714,永捷,31,0,31,光和,2023-07-19,6380
6235,華孚,48,20,28,光和,2023-07-19,6380
2206,三陽工業,29,1,28,光和,2023-07-19,6380
1101,台泥,22,0,22,光和,2023-07-19,6380
8050,廣積,39,18,21,光和,2023-07-19,6380
2027,大成鋼,20,0,20,光和,2023-07-19,6380
3583,辛耘,20,0,20,光和,2023-07-19,6380
00688L,國泰20年美債正2,20,0,20,光和,2023-07-19,6380
1905,華紙,22,2,20,光和,2023-07-19,6380
3265,台星科,23,3,20,光和,2023-07-19,6380
2368,金像電,20,1,19,光和,2023-07-19,6380
00639,富邦深100,20,2,18,光和,2023-07-19,6380
2603,長榮,22,4,18,光和,2023-07-19,6380
2913,農林,18,0,18,光和,2023-07-19,6380
2412,中華電,22,5,17,光和,2023-07-19,6380
2344,華邦電,16,0,16,光和,2023-07-19,6380
2610,華航,26,11,15,光和,2023-07-19,6380
4533,協易機,28,13,15,光和,2023-07-19,6380
9105,泰金寶-DR,20,5,15,光和,2023-07-19,6380
2329,華泰,55,40,15,光和,2023-07-19,6380
8176,智捷,14,0,14,光和,2023-07-19,6380
00679B,元大美債20年,13,0,13,光和,2023-07-19,6380
2883,凱基金,18,5,13,光和,2023-07-19,6380
1609,大亞,26,14,12,光和,2023-07-19,6380
1784,訊聯,12,0,12,光和,2023-07-19,6380
2867,三商壽,12,0,12,光和,2023-07-19,6380
3032,偉訓,19,7,12,光和,2023-07-19,6380
1584,精剛,12,0,12,光和,2023-07-19,6380
2618,長榮航,22,11,11,光和,2023-07-19,6380
00905,FT臺灣Smart,11,0,11,光和,2023-07-19,6380
3682,亞太電,11,0,11,光和,2023-07-19,6380
6188,廣明,20,9,11,光和,2023-07-19,6380
3707,漢磊,11,1,10,光和,2023-07-19,6380
2489,瑞軒,10,0,10,光和,2023-07-19,6380
1305,華夏,10,0,10,光和,2023-07-19,6380
1605,華新,20,10,10,光和,2023-07-19,6380
1802,台玻,10,0,10,光和,2023-07-19,6380
2312,金寶,71,61,10,光和,2023-07-19,6380
2303,聯電,109,2,107,光和,2023-07-20,6380
4173,久裕,70,0,70,光和,2023-07-20,6380
9105,泰金寶-DR,60,0,60,光和,2023-07-20,6380
00712,復華富時不動產,65,10,55,光和,2023-07-20,6380
2329,華泰,58,13,45,光和,2023-07-20,6380
6153,嘉聯益,43,1,42,光和,2023-07-20,6380
2610,華航,56,16,40,光和,2023-07-20,6380
1789,神隆,41,2,39,光和,2023-07-20,6380
2376,技嘉,32,2,30,光和,2023-07-20,6380
8409,商之器,30,0,30,光和,2023-07-20,6380
4123,晟德,49,19,30,光和,2023-07-20,6380
2352,佳世達,38,11,27,光和,2023-07-20,6380
4157,太景*-KY,22,0,22,光和,2023-07-20,6380
2313,華通,21,0,21,光和,2023-07-20,6380
4915,致伸,20,0,20,光和,2023-07-20,6380
00927,群益半導體收益,20,0,20,光和,2023-07-20,6380
1529,樂事綠能,22,2,20,光和,2023-07-20,6380
2104,國際中橡,20,0,20,光和,2023-07-20,6380
2338,光罩,20,0,20,光和,2023-07-20,6380
2340,台亞,74,54,20,光和,2023-07-20,6380
3176,基亞,20,0,20,光和,2023-07-20,6380
6244,茂迪,25,5,20,光和,2023-07-20,6380
6282,康舒,44,25,19,光和,2023-07-20,6380
5392,能率,37,19,18,光和,2023-07-20,6380
6120,達運,26,8,18,光和,2023-07-20,6380
1101,台泥,16,0,16,光和,2023-07-20,6380
00671R,富邦NASDAQ反1,15,0,15,光和,2023-07-20,6380
3037,欣興,21,6,15,光和,2023-07-20,6380
4938,和碩,26,11,15,光和,2023-07-20,6380
6531,愛普*,21,7,14,光和,2023-07-20,6380
00929,復華台灣科技優息,24,10,14,光和,2023-07-20,6380
2481,強茂,17,3,14,光和,2023-07-20,6380
6116,彩晶,15,1,14,光和,2023-07-20,6380
1102,亞泥,12,0,12,光和,2023-07-20,6380
2801,彰銀,22,10,12,光和,2023-07-20,6380
4968,立積,12,1,11,光和,2023-07-20,6380
8215,明基材,11,0,11,光和,2023-07-20,6380
2706,第一店,12,1,11,光和,2023-07-20,6380
3231,緯創,18,8,10,光和,2023-07-20,6380
1314,中石化,10,0,10,光和,2023-07-20,6380
00680L,元大美債20正2,10,0,10,光和,2023-07-20,6380
2641,正德,10,0,10,光和,2023-07-20,6380
2855,統一證,10,0,10,光和,2023-07-20,6380
3707,漢磊,10,0,10,光和,2023-07-20,6380
4426,利勤,10,0,10,光和,2023-07-20,6380
2399,映泰,22,13,9,光和,2023-07-20,6380
2630,亞航,12,3,9,光和,2023-07-20,6380
2913,農林,9,0,9,光和,2023-07-20,6380
4566,時碩工業,9,0,9,光和,2023-07-20,6380
2332,友訊,8,0,8,光和,2023-07-20,6380
1504,東元,101,19,82,光和,2023-07-21,6380
2382,廣達,76,21,55,光和,2023-07-21,6380
2312,金寶,75,26,49,光和,2023-07-21,6380
1101,台泥,48,2,46,光和,2023-07-21,6380
2303,聯電,46,4,42,光和,2023-07-21,6380
1402,遠東新,40,0,40,光和,2023-07-21,6380
2324,仁寶,44,13,31,光和,2023-07-21,6380
4973,廣穎,31,0,31,光和,2023-07-21,6380
00688L,國泰20年美債正2,30,0,30,光和,2023-07-21,6380
1513,中興電,61,34,27,光和,2023-07-21,6380
3481,群創,46,20,26,光和,2023-07-21,6380
4906,正文,26,0,26,光和,2023-07-21,6380
6120,達運,31,5,26,光和,2023-07-21,6380
3231,緯創,35,11,24,光和,2023-07-21,6380
00927,群益半導體收益,23,0,23,光和,2023-07-21,6380
1605,華新,29,7,22,光和,2023-07-21,6380
6443,元晶,23,2,21,光和,2023-07-21,6380
3024,憶聲,23,3,20,光和,2023-07-21,6380
4162,智擎,20,0,20,光和,2023-07-21,6380
8048,德勝,21,1,20,光和,2023-07-21,6380
1609,大亞,26,7,19,光和,2023-07-21,6380
2457,飛宏,20,1,19,光和,2023-07-21,6380
2353,宏��,41,23,18,光和,2023-07-21,6380
2867,三商壽,18,0,18,光和,2023-07-21,6380
1102,亞泥,16,0,16,光和,2023-07-21,6380
2880,華南金,16,0,16,光和,2023-07-21,6380
3032,偉訓,28,13,15,光和,2023-07-21,6380
3013,晟銘電,20,6,14,光和,2023-07-21,6380
3682,亞太電,14,0,14,光和,2023-07-21,6380
2883,凱基金,14,1,13,光和,2023-07-21,6380
3338,泰碩,33,20,13,光和,2023-07-21,6380
1905,華紙,13,1,12,光和,2023-07-21,6380
2419,仲琦,23,11,12,光和,2023-07-21,6380
2515,中工,12,0,12,光和,2023-07-21,6380
6770,力積電,14,2,12,光和,2023-07-21,6380
1301,台塑,11,0,11,光和,2023-07-21,6380
2201,裕隆,11,0,11,光和,2023-07-21,6380
00724B,群益投資級金融債,10,0,10,光和,2023-07-21,6380
1476,儒鴻,10,0,10,光和,2023-07-21,6380
1785,光洋科,10,0,10,光和,2023-07-21,6380
2344,華邦電,15,5,10,光和,2023-07-21,6380
2547,日勝生,10,0,10,光和,2023-07-21,6380
2634,漢翔,12,2,10,光和,2023-07-21,6380
3060,銘異,11,1,10,光和,2023-07-21,6380
3450,聯鈞,10,0,10,光和,2023-07-21,6380
3520,華盈,10,0,10,光和,2023-07-21,6380
3707,漢磊,10,0,10,光和,2023-07-21,6380
4426,利勤,10,0,10,光和,2023-07-21,6380
6133,金橋,10,0,10,光和,2023-07-21,6380
6284,佳邦,10,0,10,光和,2023-07-21,6380
2409,友達,126,0,126,光和,2023-07-24,6380
1504,東元,124,5,119,光和,2023-07-24,6380
1710,東聯,69,1,68,光和,2023-07-24,6380
2312,金寶,91,29,62,光和,2023-07-24,6380
2356,英業達,95,48,47,光和,2023-07-24,6380
2481,強茂,49,3,46,光和,2023-07-24,6380
6015,宏遠證,42,2,40,光和,2023-07-24,6380
3481,群創,48,10,38,光和,2023-07-24,6380
1314,中石化,36,0,36,光和,2023-07-24,6380
9934,成霖,36,0,36,光和,2023-07-24,6380
3706,神達,48,18,30,光和,2023-07-24,6380
2515,中工,47,18,29,光和,2023-07-24,6380
1609,大亞,50,22,28,光和,2023-07-24,6380
4426,利勤,30,5,25,光和,2023-07-24,6380
1905,華紙,48,24,24,光和,2023-07-24,6380
2352,佳世達,52,28,24,光和,2023-07-24,6380
2337,旺宏,31,8,23,光和,2023-07-24,6380
2303,聯電,27,5,22,光和,2023-07-24,6380
2405,輔信,36,14,22,光和,2023-07-24,6380
6282,康舒,40,18,22,光和,2023-07-24,6380
1515,力山,21,0,21,光和,2023-07-24,6380
00893,國泰智能電動車,20,0,20,光和,2023-07-24,6380
3071,協禧,38,19,19,光和,2023-07-24,6380
2880,華南金,17,0,17,光和,2023-07-24,6380
00929,復華台灣科技優息,16,0,16,光和,2023-07-24,6380
2340,台亞,16,1,15,光和,2023-07-24,6380
6218,豪勉,15,0,15,光和,2023-07-24,6380
8071,能率網通,15,0,15,光和,2023-07-24,6380
3062,建漢,14,0,14,光和,2023-07-24,6380
3264,欣銓,15,1,14,光和,2023-07-24,6380
5227,立凱-KY,14,0,14,光和,2023-07-24,6380
2353,宏��,51,37,14,光和,2023-07-24,6380
3051,力特,13,0,13,光和,2023-07-24,6380
4746,台耀,14,1,13,光和,2023-07-24,6380
6125,廣運,14,1,13,光和,2023-07-24,6380
2301,光寶科,31,19,12,光和,2023-07-24,6380
3707,漢磊,12,0,12,光和,2023-07-24,6380
4973,廣穎,12,0,12,光和,2023-07-24,6380
1402,遠東新,11,0,11,光和,2023-07-24,6380
2034,允強,11,0,11,光和,2023-07-24,6380
2457,飛宏,21,10,11,光和,2023-07-24,6380
3701,大眾控,11,0,11,光和,2023-07-24,6380
3715,定穎投控,11,0,11,光和,2023-07-24,6380
1513,中興電,28,18,10,光和,2023-07-24,6380
00665L,富邦�琤肭磪囓�2,30,20,10,光和,2023-07-24,6380
00927,群益半導體收益,10,0,10,光和,2023-07-24,6380
2547,日勝生,10,0,10,光和,2023-07-24,6380
2732,六角,11,1,10,光和,2023-07-24,6380
4109,加捷生醫,10,0,10,光和,2023-07-24,6380
5864,致和證,10,0,10,光和,2023-07-24,6380
2328,廣宇,132,2,130,光和,2023-07-25,6380
2888,新光金,100,10,90,光和,2023-07-25,6380
00919,群益台灣精選高息,84,0,84,光和,2023-07-25,6380
00878,國泰永續高股息,109,31,78,光和,2023-07-25,6380
00673R,期元大S＆P原油反1,38,0,38,光和,2023-07-25,6380
2449,京元電子,38,3,35,光和,2023-07-25,6380
6015,宏遠證,33,0,33,光和,2023-07-25,6380
1905,華紙,36,5,31,光和,2023-07-25,6380
3290,東浦,31,0,31,光和,2023-07-25,6380
00688L,國泰20年美債正2,30,0,30,光和,2023-07-25,6380
1701,中化,30,0,30,光和,2023-07-25,6380
2603,長榮,33,4,29,光和,2023-07-25,6380
2609,陽明,28,5,23,光和,2023-07-25,6380
2382,廣達,54,32,22,光和,2023-07-25,6380
1314,中石化,27,5,22,光和,2023-07-25,6380
4543,萬在,23,1,22,光和,2023-07-25,6380
00679B,元大美債20年,21,0,21,光和,2023-07-25,6380
3481,群創,23,2,21,光和,2023-07-25,6380
00696B,富邦美債20年,20,0,20,光和,2023-07-25,6380
9934,成霖,20,0,20,光和,2023-07-25,6380
1539,巨庭,18,0,18,光和,2023-07-25,6380
00720B,元大投資級公司債,17,0,17,光和,2023-07-25,6380
2464,盟立,16,0,16,光和,2023-07-25,6380
3071,協禧,33,18,15,光和,2023-07-25,6380
8059,凱碩,15,0,15,光和,2023-07-25,6380
1471,首利,15,1,14,光和,2023-07-25,6380
3037,欣興,24,11,13,光和,2023-07-25,6380
4908,前鼎,13,0,13,光和,2023-07-25,6380
3231,緯創,24,11,13,光和,2023-07-25,6380
2316,楠梓電,13,1,12,光和,2023-07-25,6380
00712,復華富時不動產,12,0,12,光和,2023-07-25,6380
3689,湧德,17,6,11,光和,2023-07-25,6380
3703,欣陸,11,0,11,光和,2023-07-25,6380
5438,東友,11,0,11,光和,2023-07-25,6380
6125,廣運,22,12,10,光和,2023-07-25,6380
8069,元太,12,2,10,光和,2023-07-25,6380
1103,嘉泥,10,0,10,光和,2023-07-25,6380
2506,太設,10,0,10,光和,2023-07-25,6380
2886,兆豐金,10,0,10,光和,2023-07-25,6380
5704,老爺知,10,0,10,光和,2023-07-25,6380
8926,台汽電,10,0,10,光和,2023-07-25,6380
9103,美德醫療-DR,10,0,10,光和,2023-07-25,6380
9941A,裕融甲特,10,0,10,光和,2023-07-25,6380
1907,永豐餘,10,0,10,光和,2023-07-25,6380
1612,宏泰,10,1,9,光和,2023-07-25,6380
2303,聯電,11,2,9,光和,2023-07-25,6380
8076,伍豐,14,5,9,光和,2023-07-25,6380
00923,群益台ESG低碳50,8,0,8,光和,2023-07-25,6380
4915,致伸,10,2,8,光和,2023-07-25,6380
6182,合晶,8,0,8,光和,2023-07-25,6380
2371,大同,110,6,104,光和,2023-07-26,6380
1301,台塑,64,0,64,光和,2023-07-26,6380
1471,首利,54,1,53,光和,2023-07-26,6380
1337,再生-KY,50,0,50,光和,2023-07-26,6380
3049,精金,50,2,48,光和,2023-07-26,6380
6120,達運,47,1,46,光和,2023-07-26,6380
1504,東元,107,63,44,光和,2023-07-26,6380
2329,華泰,122,86,36,光和,2023-07-26,6380
3044,健鼎,38,2,36,光和,2023-07-26,6380
2376,技嘉,32,4,28,光和,2023-07-26,6380
6182,合晶,26,0,26,光和,2023-07-26,6380
2913,農林,27,2,25,光和,2023-07-26,6380
1217,愛之味,27,5,22,光和,2023-07-26,6380
2618,長榮航,30,8,22,光和,2023-07-26,6380
2484,希華,20,0,20,光和,2023-07-26,6380
3060,銘異,20,0,20,光和,2023-07-26,6380
4114,健喬,20,0,20,光和,2023-07-26,6380
1618,合機,33,13,20,光和,2023-07-26,6380
1513,中興電,29,10,19,光和,2023-07-26,6380
2344,華邦電,29,10,19,光和,2023-07-26,6380
2317,鴻海,21,3,18,光和,2023-07-26,6380
1605,華新,22,4,18,光和,2023-07-26,6380
1784,訊聯,17,0,17,光和,2023-07-26,6380
6443,元晶,28,11,17,光和,2023-07-26,6380
3029,零壹,28,12,16,光和,2023-07-26,6380
5521,工信,16,0,16,光和,2023-07-26,6380
6153,嘉聯益,35,19,16,光和,2023-07-26,6380
00679B,元大美債20年,15,0,15,光和,2023-07-26,6380
6015,宏遠證,22,7,15,光和,2023-07-26,6380
8234,新漢,16,1,15,光和,2023-07-26,6380
2884,玉山金,15,0,15,光和,2023-07-26,6380
00929,復華台灣科技優息,14,0,14,光和,2023-07-26,6380
2014,中鴻,28,14,14,光和,2023-07-26,6380
5483,中美晶,14,0,14,光和,2023-07-26,6380
6207,雷科,15,1,14,光和,2023-07-26,6380
1104,環泥,13,0,13,光和,2023-07-26,6380
2890,永豐金,20,7,13,光和,2023-07-26,6380
2337,旺宏,14,1,13,光和,2023-07-26,6380
3046,建��,12,0,12,光和,2023-07-26,6380
2027,大成鋼,11,0,11,光和,2023-07-26,6380
1708,東鹼,13,2,11,光和,2023-07-26,6380
3450,聯鈞,12,1,11,光和,2023-07-26,6380
6419,京晨科,11,0,11,光和,2023-07-26,6380
3006,晶豪科,10,0,10,光和,2023-07-26,6380
1514,亞力,10,0,10,光和,2023-07-26,6380
00882,中信中國高股息,10,0,10,光和,2023-07-26,6380
1712,興農,10,0,10,光和,2023-07-26,6380
1785,光洋科,10,0,10,光和,2023-07-26,6380
4129,聯合,10,0,10,光和,2023-07-26,6380
6016,康和證,10,0,10,光和,2023-07-26,6380
2913,農林,266,21,245,光和,2023-07-27,6380
00878,國泰永續高股息,312,117,195,光和,2023-07-27,6380
2610,華航,167,48,119,光和,2023-07-27,6380
2371,大同,75,0,75,光和,2023-07-27,6380
4533,協易機,72,14,58,光和,2023-07-27,6380
2353,宏��,61,5,56,光和,2023-07-27,6380
1609,大亞,60,8,52,光和,2023-07-27,6380
2618,長榮航,67,23,44,光和,2023-07-27,6380
2340,台亞,43,3,40,光和,2023-07-27,6380
4414,如興,38,0,38,光和,2023-07-27,6380
2002,中鋼,36,3,33,光和,2023-07-27,6380
3037,欣興,32,6,26,光和,2023-07-27,6380
1907,永豐餘,36,11,25,光和,2023-07-27,6380
2359,所羅門,23,0,23,光和,2023-07-27,6380
2405,輔信,28,7,21,光和,2023-07-27,6380
3024,憶聲,21,0,21,光和,2023-07-27,6380
3189,景碩,23,2,21,光和,2023-07-27,6380
1903,士紙,21,1,20,光和,2023-07-27,6380
2367,燿華,21,1,20,光和,2023-07-27,6380
4915,致伸,20,0,20,光和,2023-07-27,6380
8033,雷虎,20,1,19,光和,2023-07-27,6380
1714,和桐,19,1,18,光和,2023-07-27,6380
8201,無敵,20,2,18,光和,2023-07-27,6380
6770,力積電,19,1,18,光和,2023-07-27,6380
00679B,元大美債20年,16,0,16,光和,2023-07-27,6380
2420,新巨,16,0,16,光和,2023-07-27,6380
2425,承啟,16,0,16,光和,2023-07-27,6380
3138,耀登,16,1,15,光和,2023-07-27,6380
8433,弘帆,17,2,15,光和,2023-07-27,6380
2014,中鴻,15,1,14,光和,2023-07-27,6380
2453,凌群,15,1,14,光和,2023-07-27,6380
3689,湧德,15,1,14,光和,2023-07-27,6380
1434,福懋,12,0,12,光和,2023-07-27,6380
2356,英業達,18,7,11,光和,2023-07-27,6380
2317,鴻海,12,1,11,光和,2023-07-27,6380
3450,聯鈞,13,2,11,光和,2023-07-27,6380
00900,富邦特選高股息30,10,0,10,光和,2023-07-27,6380
1103,嘉泥,10,0,10,光和,2023-07-27,6380
00923,群益台ESG低碳50,10,0,10,光和,2023-07-27,6380
2204,中華,10,0,10,光和,2023-07-27,6380
2460,建通,10,0,10,光和,2023-07-27,6380
2506,太設,10,0,10,光和,2023-07-27,6380
2542,興富發,10,0,10,光和,2023-07-27,6380
2606,裕民,11,1,10,光和,2023-07-27,6380
2809,京城銀,10,0,10,光和,2023-07-27,6380
3149,正達,10,0,10,光和,2023-07-27,6380
3664,安瑞-KY,10,0,10,光和,2023-07-27,6380
2382,廣達,26,16,10,光和,2023-07-27,6380
2337,旺宏,11,2,9,光和,2023-07-27,6380
6139,亞翔,9,0,9,光和,2023-07-27,6380
2371,大同,165,6,159,光和,2023-07-28,6380
00679B,元大美債20年,109,0,109,光和,2023-07-28,6380
2369,菱生,123,17,106,光和,2023-07-28,6380
2610,華航,112,7,105,光和,2023-07-28,6380
2323,中環,102,0,102,光和,2023-07-28,6380
2888,新光金,118,43,75,光和,2023-07-28,6380
1905,華紙,91,36,55,光和,2023-07-28,6380
00688L,國泰20年美債正2,50,0,50,光和,2023-07-28,6380
2812,台中銀,50,0,50,光和,2023-07-28,6380
00665L,富邦�琤肭磪囓�2,60,13,47,光和,2023-07-28,6380
2883,凱基金,46,0,46,光和,2023-07-28,6380
2317,鴻海,42,6,36,光和,2023-07-28,6380
2892,第一金,37,5,32,光和,2023-07-28,6380
3019,亞光,30,0,30,光和,2023-07-28,6380
2480,敦陽科,30,0,30,光和,2023-07-28,6380
4123,晟德,30,6,24,光和,2023-07-28,6380
00712,復華富時不動產,23,0,23,光和,2023-07-28,6380
6274,台燿,34,11,23,光和,2023-07-28,6380
00929,復華台灣科技優息,23,2,21,光和,2023-07-28,6380
1785,光洋科,24,3,21,光和,2023-07-28,6380
00720B,元大投資級公司債,20,0,20,光和,2023-07-28,6380
2867,三商壽,20,0,20,光和,2023-07-28,6380
3576,聯合再生,20,0,20,光和,2023-07-28,6380
1783,和康生,16,0,16,光和,2023-07-28,6380
2027,大成鋼,17,1,16,光和,2023-07-28,6380
5452,佶優,20,5,15,光和,2023-07-28,6380
4543,萬在,15,2,13,光和,2023-07-28,6380
4566,時碩工業,13,0,13,光和,2023-07-28,6380
2002,中鋼,13,1,12,光和,2023-07-28,6380
5880,合庫金,15,3,12,光和,2023-07-28,6380
00919,群益台灣精選高息,13,1,12,光和,2023-07-28,6380
2474,可成,12,0,12,光和,2023-07-28,6380
6550,北極星藥業-KY,12,0,12,光和,2023-07-28,6380
00680L,元大美債20正2,11,0,11,光和,2023-07-28,6380
1314,中石化,11,0,11,光和,2023-07-28,6380
3706,神達,16,5,11,光和,2023-07-28,6380
5443,均豪,15,4,11,光和,2023-07-28,6380
6443,元晶,12,1,11,光和,2023-07-28,6380
3231,緯創,56,46,10,光和,2023-07-28,6380
00882,中信中國高股息,20,10,10,光和,2023-07-28,6380
00669R,國泰美國道瓊反1,10,0,10,光和,2023-07-28,6380
1531,高林股,10,0,10,光和,2023-07-28,6380
2324,仁寶,15,5,10,光和,2023-07-28,6380
3714,富采,10,0,10,光和,2023-07-28,6380
4114,健喬,10,0,10,光和,2023-07-28,6380
6016,康和證,10,0,10,光和,2023-07-28,6380
6535,順藥,14,4,10,光和,2023-07-28,6380
8933,愛地雅,10,0,10,光和,2023-07-28,6380
1903,士紙,10,0,10,光和,2023-07-28,6380
2034,允強,9,0,9,光和,2023-07-28,6380
2312,金寶,139,51,88,光和,2023-07-31,6380
6026,福邦證,77,1,76,光和,2023-07-31,6380
00878,國泰永續高股息,307,249,58,光和,2023-07-31,6380
6269,台郡,51,2,49,光和,2023-07-31,6380
2603,長榮,60,20,40,光和,2023-07-31,6380
2609,陽明,70,31,39,光和,2023-07-31,6380
2329,華泰,106,70,36,光和,2023-07-31,6380
6770,力積電,34,1,33,光和,2023-07-31,6380
1905,華紙,72,46,26,光和,2023-07-31,6380
2382,廣達,33,8,25,光和,2023-07-31,6380
2303,聯電,28,4,24,光和,2023-07-31,6380
6153,嘉聯益,26,2,24,光和,2023-07-31,6380
1513,中興電,39,16,23,光和,2023-07-31,6380
2618,長榮航,24,2,22,光和,2023-07-31,6380
2834,臺企銀,20,0,20,光和,2023-07-31,6380
6182,合晶,21,1,20,光和,2023-07-31,6380
6470,宇智,22,2,20,光和,2023-07-31,6380
2457,飛宏,19,0,19,光和,2023-07-31,6380
2337,旺宏,29,10,19,光和,2023-07-31,6380
2316,楠梓電,21,3,18,光和,2023-07-31,6380
3037,欣興,21,3,18,光和,2023-07-31,6380
1783,和康生,18,1,17,光和,2023-07-31,6380
2323,中環,22,5,17,光和,2023-07-31,6380
5452,佶優,16,0,16,光和,2023-07-31,6380
2002,中鋼,22,6,16,光和,2023-07-31,6380
2330,台積電,17,2,15,光和,2023-07-31,6380
1785,光洋科,15,0,15,光和,2023-07-31,6380
2324,仁寶,21,6,15,光和,2023-07-31,6380
3481,群創,69,55,14,光和,2023-07-31,6380
3711,日月光投控,21,7,14,光和,2023-07-31,6380
3078,僑威,22,8,14,光和,2023-07-31,6380
00900,富邦特選高股息30,14,1,13,光和,2023-07-31,6380
6285,啟��,17,4,13,光和,2023-07-31,6380
8358,金居,26,14,12,光和,2023-07-31,6380
1609,大亞,26,14,12,光和,2023-07-31,6380
2402,毅嘉,16,4,12,光和,2023-07-31,6380
3221,台嘉碩,13,1,12,光和,2023-07-31,6380
6147,頎邦,12,0,12,光和,2023-07-31,6380
8028,昇陽半導體,12,0,12,光和,2023-07-31,6380
0056,元大高股息,50,39,11,光和,2023-07-31,6380
1714,和桐,11,0,11,光和,2023-07-31,6380
6443,元晶,11,0,11,光和,2023-07-31,6380
3092,鴻碩,15,5,10,光和,2023-07-31,6380
1708,東鹼,10,0,10,光和,2023-07-31,6380
3058,立德,10,0,10,光和,2023-07-31,6380
3704,合勤控,18,8,10,光和,2023-07-31,6380
4123,晟德,10,0,10,光和,2023-07-31,6380
8201,無敵,10,0,10,光和,2023-07-31,6380
1504,東元,10,0,10,光和,2023-07-31,6380
6188,廣明,17,8,9,光和,2023-07-31,6380
00929,復華台灣科技優息,194,27,167,光和,2023-08-01,6380
2363,矽統,80,28,52,光和,2023-08-01,6380
2312,金寶,83,34,49,光和,2023-08-01,6380
1337,再生-KY,40,0,40,光和,2023-08-01,6380
2460,建通,36,0,36,光和,2023-08-01,6380
5521,工信,34,0,34,光和,2023-08-01,6380
1905,華紙,52,25,27,光和,2023-08-01,6380
2301,光寶科,36,9,27,光和,2023-08-01,6380
3032,偉訓,25,0,25,光和,2023-08-01,6380
8390,金益鼎,25,0,25,光和,2023-08-01,6380
1301,台塑,21,0,21,光和,2023-08-01,6380
2353,宏��,33,12,21,光和,2023-08-01,6380
3703,欣陸,24,3,21,光和,2023-08-01,6380
2882,國泰金,40,19,21,光和,2023-08-01,6380
2105,正新,20,0,20,光和,2023-08-01,6380
4714,永捷,20,0,20,光和,2023-08-01,6380
2013,中鋼構,20,1,19,光和,2023-08-01,6380
5443,均豪,19,0,19,光和,2023-08-01,6380
6218,豪勉,19,0,19,光和,2023-08-01,6380
00882,中信中國高股息,17,0,17,光和,2023-08-01,6380
6282,康舒,72,56,16,光和,2023-08-01,6380
00673R,期元大S＆P原油反1,16,0,16,光和,2023-08-01,6380
3033,威健,15,0,15,光和,2023-08-01,6380
3051,力特,15,0,15,光和,2023-08-01,6380
6153,嘉聯益,25,12,13,光和,2023-08-01,6380
00923,群益台ESG低碳50,12,0,12,光和,2023-08-01,6380
6026,福邦證,12,0,12,光和,2023-08-01,6380
2892,第一金,13,2,11,光和,2023-08-01,6380
2425,承啟,12,2,10,光和,2023-08-01,6380
3576,聯合再生,10,0,10,光和,2023-08-01,6380
6111,大宇資,10,0,10,光和,2023-08-01,6380
6753,龍德造船,10,0,10,光和,2023-08-01,6380
1701,中化,10,1,9,光和,2023-08-01,6380
8289,泰藝,9,0,9,光和,2023-08-01,6380
2412,中華電,10,2,8,光和,2023-08-01,6380
1815,富喬,8,0,8,光和,2023-08-01,6380
1513,中興電,11,3,8,光和,2023-08-01,6380
2313,華通,9,1,8,光和,2023-08-01,6380
1904,正隆,7,0,7,光和,2023-08-01,6380
1514,亞力,7,0,7,光和,2023-08-01,6380
1605,華新,20,13,7,光和,2023-08-01,6380
1802,台玻,39,32,7,光和,2023-08-01,6380
2420,新巨,7,0,7,光和,2023-08-01,6380
2426,鼎元,7,0,7,光和,2023-08-01,6380
3324,雙鴻,9,2,7,光和,2023-08-01,6380
4417,金洲,7,0,7,光和,2023-08-01,6380
6202,盛群,7,0,7,光和,2023-08-01,6380
6234,高僑,7,0,7,光和,2023-08-01,6380
6417,韋僑,7,0,7,光和,2023-08-01,6380
3037,欣興,10,3,7,光和,2023-08-01,6380
2610,華航,379,86,293,光和,2023-08-02,6380
00665L,富邦�琤肭磪囓�2,171,16,155,光和,2023-08-02,6380
00878,國泰永續高股息,197,52,145,光和,2023-08-02,6380
0056,元大高股息,168,29,139,光和,2023-08-02,6380
2888,新光金,90,1,89,光和,2023-08-02,6380
2880,華南金,82,0,82,光和,2023-08-02,6380
00688L,國泰20年美債正2,70,0,70,光和,2023-08-02,6380
6282,康舒,84,19,65,光和,2023-08-02,6380
2812,台中銀,52,0,52,光和,2023-08-02,6380
00923,群益台ESG低碳50,47,0,47,光和,2023-08-02,6380
00712,復華富時不動產,41,0,41,光和,2023-08-02,6380
00900,富邦特選高股息30,40,0,40,光和,2023-08-02,6380
00679B,元大美債20年,39,0,39,光和,2023-08-02,6380
3231,緯創,68,30,38,光和,2023-08-02,6380
00637L,元大滬深300正2,37,0,37,光和,2023-08-02,6380
2892,第一金,34,0,34,光和,2023-08-02,6380
2382,廣達,53,22,31,光和,2023-08-02,6380
1337,再生-KY,30,0,30,光和,2023-08-02,6380
2409,友達,30,0,30,光和,2023-08-02,6380
5328,華容,31,1,30,光和,2023-08-02,6380
00720B,元大投資級公司債,28,0,28,光和,2023-08-02,6380
2603,長榮,26,1,25,光和,2023-08-02,6380
2002,中鋼,32,7,25,光和,2023-08-02,6380
5880,合庫金,24,0,24,光和,2023-08-02,6380
2329,華泰,50,28,22,光和,2023-08-02,6380
3078,僑威,24,2,22,光和,2023-08-02,6380
4960,誠美材,21,0,21,光和,2023-08-02,6380
6116,彩晶,26,5,21,光和,2023-08-02,6380
8033,雷虎,21,0,21,光和,2023-08-02,6380
1524,耿鼎,20,0,20,光和,2023-08-02,6380
5876,上海商銀,20,0,20,光和,2023-08-02,6380
9934,成霖,26,6,20,光和,2023-08-02,6380
3033,威健,19,0,19,光和,2023-08-02,6380
2337,旺宏,28,10,18,光和,2023-08-02,6380
3029,零壹,26,8,18,光和,2023-08-02,6380
2317,鴻海,18,1,17,光和,2023-08-02,6380
2498,宏達電,20,3,17,光和,2023-08-02,6380
2883,凱基金,17,0,17,光和,2023-08-02,6380
6770,力積電,27,10,17,光和,2023-08-02,6380
3714,富采,16,0,16,光和,2023-08-02,6380
4123,晟德,16,0,16,光和,2023-08-02,6380
00897,富邦基因免疫生技,15,0,15,光和,2023-08-02,6380
00772B,中信高評級公司債,15,0,15,光和,2023-08-02,6380
1612,宏泰,17,2,15,光和,2023-08-02,6380
4162,智擎,17,2,15,光和,2023-08-02,6380
4915,致伸,15,0,15,光和,2023-08-02,6380
1616,億泰,15,1,14,光和,2023-08-02,6380
2313,華通,20,6,14,光和,2023-08-02,6380
6182,合晶,15,1,14,光和,2023-08-02,6380
00881,國泰台灣5G+,15,2,13,光和,2023-08-02,6380
1605,華新,141,2,139,光和,2023-08-04,6380
2313,華通,117,0,117,光和,2023-08-04,6380
2891,中信金,114,0,114,光和,2023-08-04,6380
00929,復華台灣科技優息,96,0,96,光和,2023-08-04,6380
3231,緯創,154,62,92,光和,2023-08-04,6380
00687B,國泰20年美債,63,0,63,光和,2023-08-04,6380
6125,廣運,56,5,51,光和,2023-08-04,6380
2323,中環,51,0,51,光和,2023-08-04,6380
2344,華邦電,53,3,50,光和,2023-08-04,6380
00900,富邦特選高股息30,44,1,43,光和,2023-08-04,6380
00712,復華富時不動產,40,0,40,光和,2023-08-04,6380
2382,廣達,57,18,39,光和,2023-08-04,6380
00923,群益台ESG低碳50,36,0,36,光和,2023-08-04,6380
00679B,元大美債20年,34,2,32,光和,2023-08-04,6380
00680L,元大美債20正2,27,0,27,光和,2023-08-04,6380
3576,聯合再生,25,0,25,光和,2023-08-04,6380
8027,鈦昇,25,0,25,光和,2023-08-04,6380
00772B,中信高評級公司債,22,0,22,光和,2023-08-04,6380
2352,佳世達,27,5,22,光和,2023-08-04,6380
00927,群益半導體收益,20,0,20,光和,2023-08-04,6380
1609,大亞,34,16,18,光和,2023-08-04,6380
8028,昇陽半導體,19,1,18,光和,2023-08-04,6380
00720B,元大投資級公司債,17,0,17,光和,2023-08-04,6380
2014,中鴻,34,18,16,光和,2023-08-04,6380
1598,岱宇,15,0,15,光和,2023-08-04,6380
2105,正新,15,0,15,光和,2023-08-04,6380
2609,陽明,14,0,14,光和,2023-08-04,6380
6770,力積電,12,0,12,光和,2023-08-04,6380
00919,群益台灣精選高息,34,23,11,光和,2023-08-04,6380
8049,晶采,11,0,11,光和,2023-08-04,6380
2913,農林,36,25,11,光和,2023-08-04,6380
00722B,群益投資級電信債,11,0,11,光和,2023-08-04,6380
00857B,永豐20年美公債,11,0,11,光和,2023-08-04,6380
2034,允強,11,0,11,光和,2023-08-04,6380
2428,興勤,11,0,11,光和,2023-08-04,6380
2882,國泰金,12,1,11,光和,2023-08-04,6380
1905,華紙,50,40,10,光和,2023-08-04,6380
00881,國泰台灣5G+,10,0,10,光和,2023-08-04,6380
00897,富邦基因免疫生技,10,0,10,光和,2023-08-04,6380
2027,大成鋼,17,7,10,光和,2023-08-04,6380
2460,建通,10,0,10,光和,2023-08-04,6380
3588,通嘉,10,0,10,光和,2023-08-04,6380
5392,能率,10,0,10,光和,2023-08-04,6380
6026,福邦證,10,0,10,光和,2023-08-04,6380
6176,瑞儀,10,0,10,光和,2023-08-04,6380
8931,大汽電,10,0,10,光和,2023-08-04,6380
3044,健鼎,12,3,9,光和,2023-08-04,6380
5511,德昌,9,0,9,光和,2023-08-04,6380
8215,明基材,9,0,9,光和,2023-08-04,6380
1785,光洋科,13,5,8,光和,2023-08-04,6380
2610,華航,177,41,136,光和,2023-08-07,6380
00931B,統一美債20年,74,0,74,光和,2023-08-07,6380
1609,大亞,65,2,63,光和,2023-08-07,6380
2363,矽統,56,0,56,光和,2023-08-07,6380
2913,農林,59,4,55,光和,2023-08-07,6380
2618,長榮航,59,19,40,光和,2023-08-07,6380
6015,宏遠證,40,0,40,光和,2023-08-07,6380
2337,旺宏,34,0,34,光和,2023-08-07,6380
00900,富邦特選高股息30,40,8,32,光和,2023-08-07,6380
00929,復華台灣科技優息,42,10,32,光和,2023-08-07,6380
00687B,國泰20年美債,32,0,32,光和,2023-08-07,6380
2515,中工,30,0,30,光和,2023-08-07,6380
00720B,元大投資級公司債,29,0,29,光和,2023-08-07,6380
6026,福邦證,27,0,27,光和,2023-08-07,6380
3576,聯合再生,21,1,20,光和,2023-08-07,6380
2031,新光鋼,20,1,19,光和,2023-08-07,6380
1101,台泥,21,3,18,光和,2023-08-07,6380
6016,康和證,17,0,17,光和,2023-08-07,6380
4113,聯上,17,0,17,光和,2023-08-07,6380
00882,中信中國高股息,16,0,16,光和,2023-08-07,6380
2891,中信金,16,0,16,光和,2023-08-07,6380
00885,富邦越南,15,0,15,光和,2023-08-07,6380
00923,群益台ESG低碳50,15,0,15,光和,2023-08-07,6380
6770,力積電,15,0,15,光和,2023-08-07,6380
00637L,元大滬深300正2,13,0,13,光和,2023-08-07,6380
2603,長榮,13,0,13,光和,2023-08-07,6380
2034,允強,12,0,12,光和,2023-08-07,6380
6235,華孚,18,6,12,光和,2023-08-07,6380
3207,耀勝,11,0,11,光和,2023-08-07,6380
00712,復華富時不動產,10,0,10,光和,2023-08-07,6380
00696B,富邦美債20年,10,0,10,光和,2023-08-07,6380
00673R,期元大S＆P原油反1,10,0,10,光和,2023-08-07,6380
6274,台燿,16,6,10,光和,2023-08-07,6380
8403,盛弘,10,1,9,光和,2023-08-07,6380
1802,台玻,15,6,9,光和,2023-08-07,6380
2461,光群雷,10,1,9,光和,2023-08-07,6380
2332,友訊,9,0,9,光和,2023-08-07,6380
5880,合庫金,9,0,9,光和,2023-08-07,6380
00857B,永豐20年美公債,8,0,8,光和,2023-08-07,6380
2615,萬海,9,1,8,光和,2023-08-07,6380
6190,萬泰科,8,0,8,光和,2023-08-07,6380
6213,聯茂,9,1,8,光和,2023-08-07,6380
6776,展�眥篕�,8,0,8,光和,2023-08-07,6380
00907,永豐優息存股,8,1,7,光和,2023-08-07,6380
2425,承啟,8,1,7,光和,2023-08-07,6380
2458,義隆,9,2,7,光和,2023-08-07,6380
3308,聯德,10,3,7,光和,2023-08-07,6380
3715,定穎投控,7,0,7,光和,2023-08-07,6380
8201,無敵,7,0,7,光和,2023-08-07,6380
0056,元大高股息,14,8,6,光和,2023-08-07,6380
00665L,富邦�琤肭磪囓�2,125,30,95,光和,2023-08-08,6380
00900,富邦特選高股息30,87,0,87,光和,2023-08-08,6380
2349,錸德,64,0,64,光和,2023-08-08,6380
1337,再生-KY,50,0,50,光和,2023-08-08,6380
2801,彰銀,51,1,50,光和,2023-08-08,6380
00931B,統一美債20年,40,0,40,光和,2023-08-08,6380
2323,中環,36,3,33,光和,2023-08-08,6380
2880,華南金,30,0,30,光和,2023-08-08,6380
1718,中纖,34,4,30,光和,2023-08-08,6380
2356,英業達,95,67,28,光和,2023-08-08,6380
2883,凱基金,31,3,28,光和,2023-08-08,6380
00929,復華台灣科技優息,29,2,27,光和,2023-08-08,6380
00753L,中信中國50正2,25,0,25,光和,2023-08-08,6380
3714,富采,27,2,25,光和,2023-08-08,6380
2352,佳世達,30,6,24,光和,2023-08-08,6380
2425,承啟,25,2,23,光和,2023-08-08,6380
3209,全科,22,0,22,光和,2023-08-08,6380
6005,群益證,21,0,21,光和,2023-08-08,6380
2476,鉅祥,20,0,20,光和,2023-08-08,6380
3024,憶聲,20,0,20,光和,2023-08-08,6380
5328,華容,20,0,20,光和,2023-08-08,6380
2014,中鴻,20,1,19,光和,2023-08-08,6380
2303,聯電,18,0,18,光和,2023-08-08,6380
2382,廣達,49,32,17,光和,2023-08-08,6380
6182,合晶,22,5,17,光和,2023-08-08,6380
00882,中信中國高股息,16,0,16,光和,2023-08-08,6380
2834,臺企銀,16,0,16,光和,2023-08-08,6380
9927,泰銘,15,0,15,光和,2023-08-08,6380
2891,中信金,15,0,15,光和,2023-08-08,6380
2915,潤泰全,15,0,15,光和,2023-08-08,6380
2388,威盛,17,2,15,光和,2023-08-08,6380
3044,健鼎,17,3,14,光和,2023-08-08,6380
2367,燿華,14,0,14,光和,2023-08-08,6380
2444,兆勁,14,0,14,光和,2023-08-08,6380
2009,第一銅,13,0,13,光和,2023-08-08,6380
5347,世界,13,0,13,光和,2023-08-08,6380
6185,幃翔,13,0,13,光和,2023-08-08,6380
6770,力積電,15,3,12,光和,2023-08-08,6380
3189,景碩,12,0,12,光和,2023-08-08,6380
1802,台玻,11,0,11,光和,2023-08-08,6380
8234,新漢,13,2,11,光和,2023-08-08,6380
1432,大魯閣,10,0,10,光和,2023-08-08,6380
1727,中華化,10,0,10,光和,2023-08-08,6380
2022,聚亨,10,0,10,光和,2023-08-08,6380
2702,華園,10,0,10,光和,2023-08-08,6380
3380,明泰,16,6,10,光和,2023-08-08,6380
3694,海華,10,0,10,光和,2023-08-08,6380
3703,欣陸,10,0,10,光和,2023-08-08,6380
5488,松普,10,0,10,光和,2023-08-08,6380
6684,安格,10,0,10,光和,2023-08-08,6380
2371,大同,243,4,239,光和,2023-08-09,6380
2303,聯電,123,0,123,光和,2023-08-09,6380
2031,新光鋼,66,0,66,光和,2023-08-09,6380
2323,中環,61,1,60,光和,2023-08-09,6380
1802,台玻,66,10,56,光和,2023-08-09,6380
00929,復華台灣科技優息,59,7,52,光和,2023-08-09,6380
3231,緯創,98,55,43,光和,2023-08-09,6380
1710,東聯,40,0,40,光和,2023-08-09,6380
00900,富邦特選高股息30,40,8,32,光和,2023-08-09,6380
2356,英業達,58,26,32,光和,2023-08-09,6380
8358,金居,38,6,32,光和,2023-08-09,6380
00931B,統一美債20年,31,0,31,光和,2023-08-09,6380
1314,中石化,32,1,31,光和,2023-08-09,6380
00665L,富邦�琤肭磪囓�2,235,205,30,光和,2023-08-09,6380
1609,大亞,59,29,30,光和,2023-08-09,6380
1731,美吾華,30,0,30,光和,2023-08-09,6380
2867,三商壽,30,0,30,光和,2023-08-09,6380
2409,友達,36,7,29,光和,2023-08-09,6380
1337,再生-KY,29,0,29,光和,2023-08-09,6380
4102,永日,27,0,27,光和,2023-08-09,6380
1718,中纖,26,0,26,光和,2023-08-09,6380
1605,華新,28,3,25,光和,2023-08-09,6380
00637L,元大滬深300正2,155,131,24,光和,2023-08-09,6380
00927,群益半導體收益,21,0,21,光和,2023-08-09,6380
2344,華邦電,22,2,20,光和,2023-08-09,6380
2382,廣達,48,29,19,光和,2023-08-09,6380
2404,漢唐,38,19,19,光和,2023-08-09,6380
2412,中華電,18,0,18,光和,2023-08-09,6380
2884,玉山金,17,1,16,光和,2023-08-09,6380
2376,技嘉,21,7,14,光和,2023-08-09,6380
2002,中鋼,13,0,13,光和,2023-08-09,6380
6282,康舒,27,14,13,光和,2023-08-09,6380
2801,彰銀,12,0,12,光和,2023-08-09,6380
2913,農林,15,3,12,光和,2023-08-09,6380
3047,訊舟,12,0,12,光和,2023-08-09,6380
3209,全科,20,8,12,光和,2023-08-09,6380
1598,岱宇,11,0,11,光和,2023-08-09,6380
2034,允強,11,0,11,光和,2023-08-09,6380
00679B,元大美債20年,10,0,10,光和,2023-08-09,6380
00752,中信中國50,10,0,10,光和,2023-08-09,6380
1711,永光,10,0,10,光和,2023-08-09,6380
2359,所羅門,10,0,10,光和,2023-08-09,6380
3029,零壹,10,0,10,光和,2023-08-09,6380
3049,精金,10,0,10,光和,2023-08-09,6380
4960,誠美材,10,0,10,光和,2023-08-09,6380
2892,第一金,10,0,10,光和,2023-08-09,6380
2882,國泰金,9,0,9,光和,2023-08-09,6380
3051,力特,9,0,9,光和,2023-08-09,6380
3580,友威科,13,4,9,光和,2023-08-09,6380
6120,達運,9,0,9,光和,2023-08-09,6380
2610,華航,220,43,177,光和,2023-08-10,6380
2888,新光金,197,43,154,光和,2023-08-10,6380
2634,漢翔,117,13,104,光和,2023-08-10,6380
1609,大亞,112,14,98,光和,2023-08-10,6380
00878,國泰永續高股息,101,12,89,光和,2023-08-10,6380
00929,復華台灣科技優息,79,0,79,光和,2023-08-10,6380
00900,富邦特選高股息30,55,0,55,光和,2023-08-10,6380
2409,友達,49,0,49,光和,2023-08-10,6380
3481,群創,68,20,48,光和,2023-08-10,6380
6282,康舒,87,45,42,光和,2023-08-10,6380
1314,中石化,40,0,40,光和,2023-08-10,6380
2312,金寶,49,10,39,光和,2023-08-10,6380
00673R,期元大S＆P原油反1,38,0,38,光和,2023-08-10,6380
1612,宏泰,40,3,37,光和,2023-08-10,6380
6770,力積電,36,1,35,光和,2023-08-10,6380
8234,新漢,34,0,34,光和,2023-08-10,6380
3078,僑威,72,44,28,光和,2023-08-10,6380
1710,東聯,27,0,27,光和,2023-08-10,6380
3036,文曄,25,0,25,光和,2023-08-10,6380
3029,零壹,25,1,24,光和,2023-08-10,6380
00927,群益半導體收益,21,0,21,光和,2023-08-10,6380
00931B,統一美債20年,19,0,19,光和,2023-08-10,6380
00923,群益台ESG低碳50,18,0,18,光和,2023-08-10,6380
1605,華新,26,8,18,光和,2023-08-10,6380
2402,毅嘉,19,1,18,光和,2023-08-10,6380
8028,昇陽半導體,18,0,18,光和,2023-08-10,6380
2609,陽明,20,3,17,光和,2023-08-10,6380
2376,技嘉,20,4,16,光和,2023-08-10,6380
2009,第一銅,16,1,15,光和,2023-08-10,6380
8358,金居,20,5,15,光和,2023-08-10,6380
2002,中鋼,14,0,14,光和,2023-08-10,6380
2886,兆豐金,14,0,14,光和,2023-08-10,6380
2328,廣宇,15,1,14,光和,2023-08-10,6380
00881,國泰台灣5G+,12,0,12,光和,2023-08-10,6380
6128,上福,12,0,12,光和,2023-08-10,6380
6235,華孚,16,4,12,光和,2023-08-10,6380
5880,合庫金,12,1,11,光和,2023-08-10,6380
2324,仁寶,16,5,11,光和,2023-08-10,6380
6188,廣明,19,8,11,光和,2023-08-10,6380
2497,怡利電,11,0,11,光和,2023-08-10,6380
3010,華立,11,0,11,光和,2023-08-10,6380
3580,友威科,17,6,11,光和,2023-08-10,6380
4534,慶騰,11,0,11,光和,2023-08-10,6380
2301,光寶科,27,17,10,光和,2023-08-10,6380
3209,全科,10,0,10,光和,2023-08-10,6380
00696B,富邦美債20年,10,0,10,光和,2023-08-10,6380
00669R,國泰美國道瓊反1,10,0,10,光和,2023-08-10,6380
1455,集盛,10,0,10,光和,2023-08-10,6380
1608,華榮,10,0,10,光和,2023-08-10,6380
2323,中環,10,0,10,光和,2023-08-10,6380
2031,新光鋼,60,3,57,光和,2023-08-11,6380
00931B,統一美債20年,51,0,51,光和,2023-08-11,6380
3051,力特,37,0,37,光和,2023-08-11,6380
2356,英業達,46,14,32,光和,2023-08-11,6380
00878,國泰永續高股息,41,11,30,光和,2023-08-11,6380
00929,復華台灣科技優息,28,0,28,光和,2023-08-11,6380
2367,燿華,28,0,28,光和,2023-08-11,6380
2888,新光金,26,1,25,光和,2023-08-11,6380
2313,華通,23,0,23,光和,2023-08-11,6380
8234,新漢,23,0,23,光和,2023-08-11,6380
2312,金寶,55,34,21,光和,2023-08-11,6380
00881,國泰台灣5G+,20,0,20,光和,2023-08-11,6380
2634,漢翔,55,35,20,光和,2023-08-11,6380
2801,彰銀,22,2,20,光和,2023-08-11,6380
00900,富邦特選高股息30,18,0,18,光和,2023-08-11,6380
00923,群益台ESG低碳50,17,0,17,光和,2023-08-11,6380
2609,陽明,19,2,17,光和,2023-08-11,6380
3213,茂訊,16,0,16,光和,2023-08-11,6380
00680L,元大美債20正2,15,0,15,光和,2023-08-11,6380
2404,漢唐,15,0,15,光和,2023-08-11,6380
2892,第一金,14,0,14,光和,2023-08-11,6380
3209,全科,12,0,12,光和,2023-08-11,6380
2440,太空梭,14,2,12,光和,2023-08-11,6380
5706,鳳凰,12,0,12,光和,2023-08-11,6380
1609,大亞,14,3,11,光和,2023-08-11,6380
1304,台聚,11,0,11,光和,2023-08-11,6380
00637L,元大滬深300正2,21,10,11,光和,2023-08-11,6380
3071,協禧,11,0,11,光和,2023-08-11,6380
3483,力致,11,0,11,光和,2023-08-11,6380
4563,百德,11,0,11,光和,2023-08-11,6380
4958,臻鼎-KY,11,0,11,光和,2023-08-11,6380
3673,TPK-KY,12,2,10,光和,2023-08-11,6380
00673R,期元大S＆P原油反1,10,0,10,光和,2023-08-11,6380
00724B,群益投資級金融債,10,0,10,光和,2023-08-11,6380
00715L,期街口布蘭特正2,10,0,10,光和,2023-08-11,6380
2241,艾姆勒,10,0,10,光和,2023-08-11,6380
2645,長榮航太,10,0,10,光和,2023-08-11,6380
2883,凱基金,10,0,10,光和,2023-08-11,6380
3202,樺晟,10,0,10,光和,2023-08-11,6380
5285,界霖,10,0,10,光和,2023-08-11,6380
8076,伍豐,10,0,10,光和,2023-08-11,6380
8358,金居,16,6,10,光和,2023-08-11,6380
2886,兆豐金,9,0,9,光和,2023-08-11,6380
2027,大成鋼,9,0,9,光和,2023-08-11,6380
00713,元大台灣高息低波,12,3,9,光和,2023-08-11,6380
4939,亞電,9,0,9,光和,2023-08-11,6380
8069,元太,7,0,7,光和,2023-08-11,6380
2374,佳能,7,0,7,光和,2023-08-11,6380
2316,楠梓電,14,7,7,光和,2023-08-11,6380
2603,長榮,9,2,7,光和,2023-08-11,6380
2888,新光金,139,5,134,光和,2023-08-14,6380
2313,華通,114,0,114,光和,2023-08-14,6380
00929,復華台灣科技優息,100,0,100,光和,2023-08-14,6380
00878,國泰永續高股息,89,0,89,光和,2023-08-14,6380
2610,華航,76,13,63,光和,2023-08-14,6380
2363,矽統,76,16,60,光和,2023-08-14,6380
9934,成霖,60,0,60,光和,2023-08-14,6380
2880,華南金,40,1,39,光和,2023-08-14,6380
2408,南亞科,36,0,36,光和,2023-08-14,6380
1513,中興電,35,0,35,光和,2023-08-14,6380
2323,中環,37,2,35,光和,2023-08-14,6380
3231,緯創,63,31,32,光和,2023-08-14,6380
2356,英業達,76,47,29,光和,2023-08-14,6380
3622,洋華,32,4,28,光和,2023-08-14,6380
2301,光寶科,39,12,27,光和,2023-08-14,6380
1710,東聯,25,1,24,光和,2023-08-14,6380
2344,華邦電,24,0,24,光和,2023-08-14,6380
2412,中華電,24,0,24,光和,2023-08-14,6380
00882,中信中國高股息,28,4,24,光和,2023-08-14,6380
9103,美德醫療-DR,23,0,23,光和,2023-08-14,6380
2883,凱基金,26,4,22,光和,2023-08-14,6380
2034,允強,35,13,22,光和,2023-08-14,6380
2303,聯電,25,3,22,光和,2023-08-14,6380
2618,長榮航,42,21,21,光和,2023-08-14,6380
00927,群益半導體收益,20,0,20,光和,2023-08-14,6380
1618,合機,20,0,20,光和,2023-08-14,6380
4939,亞電,20,0,20,光和,2023-08-14,6380
2329,華泰,22,4,18,光和,2023-08-14,6380
2891,中信金,18,0,18,光和,2023-08-14,6380
00923,群益台ESG低碳50,17,0,17,光和,2023-08-14,6380
2014,中鴻,18,1,17,光和,2023-08-14,6380
00900,富邦特選高股息30,25,9,16,光和,2023-08-14,6380
6419,京晨科,16,0,16,光和,2023-08-14,6380
8105,凌巨,16,0,16,光和,2023-08-14,6380
2201,裕隆,15,0,15,光和,2023-08-14,6380
0056,元大高股息,16,2,14,光和,2023-08-14,6380
1815,富喬,21,7,14,光和,2023-08-14,6380
2206,三陽工業,16,2,14,光和,2023-08-14,6380
2409,友達,25,12,13,光和,2023-08-14,6380
1616,億泰,18,5,13,光和,2023-08-14,6380
2312,金寶,60,47,13,光和,2023-08-14,6380
3044,健鼎,13,0,13,光和,2023-08-14,6380
5392,能率,13,0,13,光和,2023-08-14,6380
2027,大成鋼,13,0,13,光和,2023-08-14,6380
2881,富邦金,13,0,13,光和,2023-08-14,6380
6770,力積電,14,2,12,光和,2023-08-14,6380
2402,毅嘉,12,0,12,光和,2023-08-14,6380
2492,華新科,12,0,12,光和,2023-08-14,6380
6589,台康生技,14,2,12,光和,2023-08-14,6380
6443,元晶,28,16,12,光和,2023-08-14,6380
00632R,元大台灣50反1,310,158,152,光和,2023-08-15,6380
4714,永捷,79,0,79,光和,2023-08-15,6380
2323,中環,68,0,68,光和,2023-08-15,6380
00665L,富邦�琤肭磪囓�2,60,15,45,光和,2023-08-15,6380
2317,鴻海,70,28,42,光和,2023-08-15,6380
3481,群創,54,12,42,光和,2023-08-15,6380
2421,建準,42,3,39,光和,2023-08-15,6380
00923,群益台ESG低碳50,40,1,39,光和,2023-08-15,6380
00673R,期元大S＆P原油反1,35,0,35,光和,2023-08-15,6380
8201,無敵,32,0,32,光和,2023-08-15,6380
00900,富邦特選高股息30,30,1,29,光和,2023-08-15,6380
00929,復華台灣科技優息,25,0,25,光和,2023-08-15,6380
2880,華南金,24,0,24,光和,2023-08-15,6380
2324,仁寶,140,116,24,光和,2023-08-15,6380
4536,拓凱,23,0,23,光和,2023-08-15,6380
1314,中石化,21,0,21,光和,2023-08-15,6380
00753L,中信中國50正2,20,0,20,光和,2023-08-15,6380
2801,彰銀,21,1,20,光和,2023-08-15,6380
3702,大聯大,20,2,18,光和,2023-08-15,6380
00637L,元大滬深300正2,33,15,18,光和,2023-08-15,6380
00907,永豐優息存股,17,0,17,光和,2023-08-15,6380
2891,中信金,20,3,17,光和,2023-08-15,6380
2890,永豐金,16,0,16,光和,2023-08-15,6380
00712,復華富時不動產,16,0,16,光和,2023-08-15,6380
3260,威剛,20,4,16,光和,2023-08-15,6380
1909,榮成,15,0,15,光和,2023-08-15,6380
2034,允強,15,0,15,光和,2023-08-15,6380
6770,力積電,15,1,14,光和,2023-08-15,6380
2542,興富發,13,0,13,光和,2023-08-15,6380
2408,南亞科,12,0,12,光和,2023-08-15,6380
2867,三商壽,12,0,12,光和,2023-08-15,6380
9938,百和,12,0,12,光和,2023-08-15,6380
1605,華新,12,1,11,光和,2023-08-15,6380
1301,台塑,11,0,11,光和,2023-08-15,6380
00882,中信中國高股息,11,0,11,光和,2023-08-15,6380
1504,東元,11,0,11,光和,2023-08-15,6380
1710,東聯,10,0,10,光和,2023-08-15,6380
2109,華豐,10,0,10,光和,2023-08-15,6380
4961,天鈺,10,0,10,光和,2023-08-15,6380
6510,精測,10,0,10,光和,2023-08-15,6380
2888,新光金,17,8,9,光和,2023-08-15,6380
2609,陽明,11,2,9,光和,2023-08-15,6380
2603,長榮,9,0,9,光和,2023-08-15,6380
1313,聯成,10,1,9,光和,2023-08-15,6380
4123,晟德,9,1,8,光和,2023-08-15,6380
2338,光罩,10,2,8,光和,2023-08-15,6380
2610,華航,26,18,8,光和,2023-08-15,6380
2618,長榮航,38,31,7,光和,2023-08-15,6380
00751B,元大AAA至A公司債,7,0,7,光和,2023-08-15,6380
2014,中鴻,7,0,7,光和,2023-08-15,6380
00878,國泰永續高股息,210,9,201,光和,2023-08-16,6380
3481,群創,115,20,95,光和,2023-08-16,6380
2303,聯電,93,6,87,光和,2023-08-16,6380
2371,大同,60,0,60,光和,2023-08-16,6380
2886,兆豐金,56,0,56,光和,2023-08-16,6380
2332,友訊,59,6,53,光和,2023-08-16,6380
00929,復華台灣科技優息,59,10,49,光和,2023-08-16,6380
2317,鴻海,44,1,43,光和,2023-08-16,6380
00720B,元大投資級公司債,43,0,43,光和,2023-08-16,6380
00712,復華富時不動產,43,0,43,光和,2023-08-16,6380
00882,中信中國高股息,41,0,41,光和,2023-08-16,6380
1710,東聯,37,0,37,光和,2023-08-16,6380
00772B,中信高評級公司債,32,0,32,光和,2023-08-16,6380
1434,福懋,30,0,30,光和,2023-08-16,6380
2890,永豐金,29,0,29,光和,2023-08-16,6380
3715,定穎投控,33,5,28,光和,2023-08-16,6380
2014,中鴻,27,0,27,光和,2023-08-16,6380
1609,大亞,26,1,25,光和,2023-08-16,6380
2344,華邦電,27,2,25,光和,2023-08-16,6380
1101,台泥,29,5,24,光和,2023-08-16,6380
6116,彩晶,21,0,21,光和,2023-08-16,6380
2313,華通,24,4,20,光和,2023-08-16,6380
3081,聯亞,20,0,20,光和,2023-08-16,6380
2312,金寶,70,52,18,光和,2023-08-16,6380
2460,建通,35,17,18,光和,2023-08-16,6380
2609,陽明,20,2,18,光和,2023-08-16,6380
00923,群益台ESG低碳50,20,2,18,光和,2023-08-16,6380
2324,仁寶,117,100,17,光和,2023-08-16,6380
1905,華紙,17,0,17,光和,2023-08-16,6380
5340,建榮,17,0,17,光和,2023-08-16,6380
2892,第一金,15,0,15,光和,2023-08-16,6380
2034,允強,14,0,14,光和,2023-08-16,6380
2049,上銀,14,0,14,光和,2023-08-16,6380
1304,台聚,12,0,12,光和,2023-08-16,6380
1540,喬福,12,0,12,光和,2023-08-16,6380
2002,中鋼,20,8,12,光和,2023-08-16,6380
2027,大成鋼,12,1,11,光和,2023-08-16,6380
00907,永豐優息存股,11,0,11,光和,2023-08-16,6380
1504,東元,12,1,11,光和,2023-08-16,6380
3051,力特,12,1,11,光和,2023-08-16,6380
3059,華晶科,11,0,11,光和,2023-08-16,6380
2880,華南金,10,0,10,光和,2023-08-16,6380
2408,南亞科,10,0,10,光和,2023-08-16,6380
6418,詠昇,10,0,10,光和,2023-08-16,6380
8107,大億金茂,10,0,10,光和,2023-08-16,6380
9934,成霖,10,0,10,光和,2023-08-16,6380
1210,大成,10,1,9,光和,2023-08-16,6380
4543,萬在,9,0,9,光和,2023-08-16,6380
6672,騰輝電子-KY,8,0,8,光和,2023-08-16,6380
2338,光罩,8,0,8,光和,2023-08-16,6380
2888,新光金,103,8,95,光和,2023-08-17,6380
00929,復華台灣科技優息,102,25,77,光和,2023-08-17,6380
00712,復華富時不動產,60,2,58,光和,2023-08-17,6380
4114,健喬,50,0,50,光和,2023-08-17,6380
2329,華泰,68,32,36,光和,2023-08-17,6380
1101,台泥,35,1,34,光和,2023-08-17,6380
3231,緯創,100,68,32,光和,2023-08-17,6380
00913,兆豐台灣晶圓製造,30,0,30,光和,2023-08-17,6380
2002,中鋼,31,1,30,光和,2023-08-17,6380
2913,農林,30,1,29,光和,2023-08-17,6380
00931B,統一美債20年,30,3,27,光和,2023-08-17,6380
2303,聯電,36,9,27,光和,2023-08-17,6380
00680L,元大美債20正2,26,0,26,光和,2023-08-17,6380
00772B,中信高評級公司債,25,0,25,光和,2023-08-17,6380
1301,台塑,22,0,22,光和,2023-08-17,6380
6470,宇智,22,0,22,光和,2023-08-17,6380
1909,榮成,21,0,21,光和,2023-08-17,6380
2915,潤泰全,21,0,21,光和,2023-08-17,6380
00665L,富邦�琤肭磪囓�2,20,0,20,光和,2023-08-17,6380
3019,亞光,20,0,20,光和,2023-08-17,6380
1528,恩德,18,0,18,光和,2023-08-17,6380
3056,富華新,24,6,18,光和,2023-08-17,6380
2409,友達,19,3,16,光和,2023-08-17,6380
1215,卜蜂,20,4,16,光和,2023-08-17,6380
6770,力積電,25,9,16,光和,2023-08-17,6380
00878,國泰永續高股息,16,1,15,光和,2023-08-17,6380
6282,康舒,30,15,15,光和,2023-08-17,6380
1314,中石化,18,3,15,光和,2023-08-17,6380
5483,中美晶,15,0,15,光和,2023-08-17,6380
1304,台聚,14,0,14,光和,2023-08-17,6380
1513,中興電,19,5,14,光和,2023-08-17,6380
4716,大立,15,1,14,光和,2023-08-17,6380
6443,元晶,15,1,14,光和,2023-08-17,6380
1471,首利,27,14,13,光和,2023-08-17,6380
00720B,元大投資級公司債,13,0,13,光和,2023-08-17,6380
00753L,中信中國50正2,13,0,13,光和,2023-08-17,6380
00751B,元大AAA至A公司債,12,0,12,光和,2023-08-17,6380
00795B,中信美國公債20年,12,0,12,光和,2023-08-17,6380
2421,建準,20,8,12,光和,2023-08-17,6380
1326,台化,11,0,11,光和,2023-08-17,6380
1711,永光,11,0,11,光和,2023-08-17,6380
3622,洋華,11,0,11,光和,2023-08-17,6380
00637L,元大滬深300正2,10,0,10,光和,2023-08-17,6380
00715L,期街口布蘭特正2,10,0,10,光和,2023-08-17,6380
1303,南亞,10,0,10,光和,2023-08-17,6380
1710,東聯,15,5,10,光和,2023-08-17,6380
2547,日勝生,10,0,10,光和,2023-08-17,6380
2801,彰銀,10,0,10,光和,2023-08-17,6380
6788,華景電,10,0,10,光和,2023-08-17,6380
8110,華東,10,0,10,光和,2023-08-17,6380
2324,仁寶,174,68,106,光和,2023-08-18,6380
2495,普安,87,1,86,光和,2023-08-18,6380
2851,中再保,70,0,70,光和,2023-08-18,6380
2323,中環,62,0,62,光和,2023-08-18,6380
2812,台中銀,51,0,51,光和,2023-08-18,6380
00897,富邦基因免疫生技,50,0,50,光和,2023-08-18,6380
3231,緯創,114,71,43,光和,2023-08-18,6380
3706,神達,82,40,42,光和,2023-08-18,6380
2421,建準,42,2,40,光和,2023-08-18,6380
2356,英業達,62,22,40,光和,2023-08-18,6380
8936,國統,49,17,32,光和,2023-08-18,6380
2382,廣達,67,35,32,光和,2023-08-18,6380
1101,台泥,37,6,31,光和,2023-08-18,6380
3715,定穎投控,43,13,30,光和,2023-08-18,6380
2329,華泰,87,57,30,光和,2023-08-18,6380
3325,旭品,42,13,29,光和,2023-08-18,6380
6443,元晶,27,0,27,光和,2023-08-18,6380
00712,復華富時不動產,26,0,26,光和,2023-08-18,6380
00929,復華台灣科技優息,25,0,25,光和,2023-08-18,6380
00878,國泰永續高股息,29,6,23,光和,2023-08-18,6380
2344,華邦電,25,2,23,光和,2023-08-18,6380
00900,富邦特選高股息30,21,0,21,光和,2023-08-18,6380
4716,大立,20,0,20,光和,2023-08-18,6380
2027,大成鋼,19,0,19,光和,2023-08-18,6380
2409,友達,29,10,19,光和,2023-08-18,6380
00720B,元大投資級公司債,18,0,18,光和,2023-08-18,6380
2610,華航,26,9,17,光和,2023-08-18,6380
2404,漢唐,15,0,15,光和,2023-08-18,6380
00673R,期元大S＆P原油反1,15,0,15,光和,2023-08-18,6380
2204,中華,15,0,15,光和,2023-08-18,6380
1471,首利,19,5,14,光和,2023-08-18,6380
3580,友威科,13,0,13,光和,2023-08-18,6380
2402,毅嘉,56,44,12,光和,2023-08-18,6380
2308,台達電,13,1,12,光和,2023-08-18,6380
2883,凱基金,13,1,12,光和,2023-08-18,6380
1528,恩德,11,0,11,光和,2023-08-18,6380
2303,聯電,14,3,11,光和,2023-08-18,6380
3038,全台,11,0,11,光和,2023-08-18,6380
6274,台燿,12,1,11,光和,2023-08-18,6380
2301,光寶科,15,4,11,光和,2023-08-18,6380
1504,東元,18,8,10,光和,2023-08-18,6380
2105,正新,10,0,10,光和,2023-08-18,6380
2352,佳世達,20,10,10,光和,2023-08-18,6380
4960,誠美材,10,0,10,光和,2023-08-18,6380
6163,華電網,22,12,10,光和,2023-08-18,6380
6203,海韻電,10,0,10,光和,2023-08-18,6380
8234,新漢,11,1,10,光和,2023-08-18,6380
2313,華通,20,11,9,光和,2023-08-18,6380
5340,建榮,10,1,9,光和,2023-08-18,6380
2002,中鋼,12,4,8,光和,2023-08-18,6380
00882,中信中國高股息,92,0,92,光和,2023-08-21,6380
1312,國喬,87,0,87,光和,2023-08-21,6380
2324,仁寶,168,101,67,光和,2023-08-21,6380
1471,首利,66,0,66,光和,2023-08-21,6380
2515,中工,57,0,57,光和,2023-08-21,6380
2495,普安,41,1,40,光和,2023-08-21,6380
00931B,統一美債20年,32,0,32,光和,2023-08-21,6380
2359,所羅門,30,0,30,光和,2023-08-21,6380
2323,中環,50,23,27,光和,2023-08-21,6380
2382,廣達,39,16,23,光和,2023-08-21,6380
4207,環泰,22,0,22,光和,2023-08-21,6380
8069,元太,22,0,22,光和,2023-08-21,6380
00897,富邦基因免疫生技,20,0,20,光和,2023-08-21,6380
2374,佳能,20,0,20,光和,2023-08-21,6380
9934,成霖,20,0,20,光和,2023-08-21,6380
1101,台泥,21,3,18,光和,2023-08-21,6380
2020,美亞,18,0,18,光和,2023-08-21,6380
1504,東元,17,0,17,光和,2023-08-21,6380
2313,華通,23,6,17,光和,2023-08-21,6380
2303,聯電,16,0,16,光和,2023-08-21,6380
6108,競國,16,0,16,光和,2023-08-21,6380
6457,紘康,15,0,15,光和,2023-08-21,6380
00772B,中信高評級公司債,14,0,14,光和,2023-08-21,6380
4906,正文,16,3,13,光和,2023-08-21,6380
5371,中光電,12,0,12,光和,2023-08-21,6380
2002,中鋼,11,0,11,光和,2023-08-21,6380
0056,元大高股息,11,0,11,光和,2023-08-21,6380
2615,萬海,11,0,11,光和,2023-08-21,6380
1218,泰山,11,0,11,光和,2023-08-21,6380
3693,營邦,14,4,10,光和,2023-08-21,6380
3056,富華新,18,8,10,光和,2023-08-21,6380
1303,南亞,10,0,10,光和,2023-08-21,6380
00712,復華富時不動產,10,0,10,光和,2023-08-21,6380
3052,夆典,10,0,10,光和,2023-08-21,6380
3686,達能,10,0,10,光和,2023-08-21,6380
6510,精測,10,0,10,光和,2023-08-21,6380
8105,凌巨,10,0,10,光和,2023-08-21,6380
8234,新漢,10,0,10,光和,2023-08-21,6380
2603,長榮,12,3,9,光和,2023-08-21,6380
2610,華航,19,10,9,光和,2023-08-21,6380
2618,長榮航,27,18,9,光和,2023-08-21,6380
3580,友威科,9,0,9,光和,2023-08-21,6380
6223,旺矽,11,2,9,光和,2023-08-21,6380
00923,群益台ESG低碳50,9,0,9,光和,2023-08-21,6380
3483,力致,16,8,8,光和,2023-08-21,6380
4763,材料-KY,10,2,8,光和,2023-08-21,6380
00885,富邦越南,15,7,8,光和,2023-08-21,6380
2617,台航,9,1,8,光和,2023-08-21,6380
3499,環天科,8,0,8,光和,2023-08-21,6380
6139,亞翔,21,13,8,光和,2023-08-21,6380
00878,國泰永續高股息,134,12,122,光和,2023-08-22,6380
1312,國喬,86,0,86,光和,2023-08-22,6380
2363,矽統,83,31,52,光和,2023-08-22,6380
00634R,富邦上証反1,50,0,50,光和,2023-08-22,6380
00915,凱基優選高股息30,48,0,48,光和,2023-08-22,6380
2329,華泰,64,18,46,光和,2023-08-22,6380
00929,復華台灣科技優息,41,0,41,光和,2023-08-22,6380
2460,建通,47,8,39,光和,2023-08-22,6380
2610,華航,45,8,37,光和,2023-08-22,6380
2913,農林,42,10,32,光和,2023-08-22,6380
2886,兆豐金,25,0,25,光和,2023-08-22,6380
3338,泰碩,41,16,25,光和,2023-08-22,6380
00650L,復華香港正2,25,1,24,光和,2023-08-22,6380
1605,華新,54,30,24,光和,2023-08-22,6380
00679B,元大美債20年,24,1,23,光和,2023-08-22,6380
00772B,中信高評級公司債,23,0,23,光和,2023-08-22,6380
2645,長榮航太,22,0,22,光和,2023-08-22,6380
4543,萬在,22,0,22,光和,2023-08-22,6380
2002,中鋼,20,0,20,光和,2023-08-22,6380
2374,佳能,20,0,20,光和,2023-08-22,6380
1101,台泥,20,1,19,光和,2023-08-22,6380
3078,僑威,28,10,18,光和,2023-08-22,6380
4906,正文,20,3,17,光和,2023-08-22,6380
2884,玉山金,16,0,16,光和,2023-08-22,6380
6120,達運,15,0,15,光和,2023-08-22,6380
00720B,元大投資級公司債,14,0,14,光和,2023-08-22,6380
2062,橋椿,13,0,13,光和,2023-08-22,6380
6282,康舒,32,19,13,光和,2023-08-22,6380
8936,國統,13,0,13,光和,2023-08-22,6380
00753L,中信中國50正2,12,0,12,光和,2023-08-22,6380
1905,華紙,12,0,12,光和,2023-08-22,6380
2020,美亞,12,0,12,光和,2023-08-22,6380
3306,鼎天,17,5,12,光和,2023-08-22,6380
3308,聯德,20,8,12,光和,2023-08-22,6380
4989,榮科,13,1,12,光和,2023-08-22,6380
6275,元山,14,2,12,光和,2023-08-22,6380
2303,聯電,10,0,10,光和,2023-08-22,6380
00638R,元大滬深300反1,10,0,10,光和,2023-08-22,6380
6457,紘康,10,0,10,光和,2023-08-22,6380
2812,台中銀,10,0,10,光和,2023-08-22,6380
4938,和碩,9,0,9,光和,2023-08-22,6380
2891,中信金,9,0,9,光和,2023-08-22,6380
1303,南亞,9,0,9,光和,2023-08-22,6380
2915,潤泰全,9,0,9,光和,2023-08-22,6380
1513,中興電,9,1,8,光和,2023-08-22,6380
1504,東元,18,10,8,光和,2023-08-22,6380
2883,凱基金,8,0,8,光和,2023-08-22,6380
3325,旭品,18,10,8,光和,2023-08-22,6380
3694,海華,10,2,8,光和,2023-08-22,6380
5371,中光電,8,0,8,光和,2023-08-22,6380
2324,仁寶,150,21,129,光和,2023-08-23,6380
2617,台航,57,0,57,光和,2023-08-23,6380
2886,兆豐金,47,0,47,光和,2023-08-23,6380
6282,康舒,132,89,43,光和,2023-08-23,6380
2208,台船,42,0,42,光和,2023-08-23,6380
1528,恩德,39,1,38,光和,2023-08-23,6380
2329,華泰,49,15,34,光和,2023-08-23,6380
2618,長榮航,52,19,33,光和,2023-08-23,6380
6116,彩晶,40,10,30,光和,2023-08-23,6380
2332,友訊,43,15,28,光和,2023-08-23,6380
1513,中興電,29,1,28,光和,2023-08-23,6380
2485,兆赫,31,6,25,光和,2023-08-23,6380
00929,復華台灣科技優息,28,7,21,光和,2023-08-23,6380
00632R,元大台灣50反1,21,0,21,光和,2023-08-23,6380
2331,精英,24,3,21,光和,2023-08-23,6380
2405,輔信,21,0,21,光和,2023-08-23,6380
00885,富邦越南,20,0,20,光和,2023-08-23,6380
2888,新光金,20,0,20,光和,2023-08-23,6380
6117,迎廣,19,3,16,光和,2023-08-23,6380
2630,亞航,16,0,16,光和,2023-08-23,6380
2382,廣達,17,2,15,光和,2023-08-23,6380
2486,一詮,26,11,15,光和,2023-08-23,6380
2881,富邦金,13,0,13,光和,2023-08-23,6380
1536,和大,12,0,12,光和,2023-08-23,6380
3264,欣銓,23,11,12,光和,2023-08-23,6380
8936,國統,12,0,12,光和,2023-08-23,6380
00712,復華富時不動產,11,0,11,光和,2023-08-23,6380
00637L,元大滬深300正2,62,51,11,光和,2023-08-23,6380
2020,美亞,11,0,11,光和,2023-08-23,6380
2887,台新金,11,0,11,光和,2023-08-23,6380
6120,達運,11,0,11,光和,2023-08-23,6380
1304,台聚,10,0,10,光和,2023-08-23,6380
2002,中鋼,10,0,10,光和,2023-08-23,6380
3016,嘉晶,10,0,10,光和,2023-08-23,6380
4207,環泰,10,0,10,光和,2023-08-23,6380
4766,南寶,10,0,10,光和,2023-08-23,6380
5381,合正,10,0,10,光和,2023-08-23,6380
6239,力成,12,2,10,光和,2023-08-23,6380
4916,事欣科,12,3,9,光和,2023-08-23,6380
6125,廣運,20,11,9,光和,2023-08-23,6380
9904,寶成,9,0,9,光和,2023-08-23,6380
6167,久正,20,11,9,光和,2023-08-23,6380
4960,誠美材,10,2,8,光和,2023-08-23,6380
00882,中信中國高股息,8,0,8,光和,2023-08-23,6380
00893,國泰智能電動車,8,0,8,光和,2023-08-23,6380
1515,力山,8,0,8,光和,2023-08-23,6380
2606,裕民,13,5,8,光和,2023-08-23,6380
2610,華航,14,6,8,光和,2023-08-23,6380
3325,旭品,15,7,8,光和,2023-08-23,6380
4543,萬在,8,0,8,光和,2023-08-23,6380
00632R,元大台灣50反1,412,0,412,光和,2023-08-24,6380
2324,仁寶,226,28,198,光和,2023-08-24,6380
3231,緯創,183,79,104,光和,2023-08-24,6380
2363,矽統,235,143,92,光和,2023-08-24,6380
00664R,國泰臺灣加權反1,80,0,80,光和,2023-08-24,6380
3071,協禧,60,0,60,光和,2023-08-24,6380
2913,農林,35,1,34,光和,2023-08-24,6380
2323,中環,40,11,29,光和,2023-08-24,6380
8358,金居,36,8,28,光和,2023-08-24,6380
00919,群益台灣精選高息,36,10,26,光和,2023-08-24,6380
2356,英業達,64,38,26,光和,2023-08-24,6380
2495,普安,26,0,26,光和,2023-08-24,6380
2615,萬海,25,0,25,光和,2023-08-24,6380
2609,陽明,28,5,23,光和,2023-08-24,6380
2002,中鋼,23,1,22,光和,2023-08-24,6380
4566,時碩工業,21,0,21,光和,2023-08-24,6380
1402,遠東新,22,2,20,光和,2023-08-24,6380
2538,基泰,20,2,18,光和,2023-08-24,6380
3078,僑威,21,3,18,光和,2023-08-24,6380
6443,元晶,17,0,17,光和,2023-08-24,6380
2618,長榮航,27,10,17,光和,2023-08-24,6380
2419,仲琦,39,23,16,光和,2023-08-24,6380
2617,台航,26,10,16,光和,2023-08-24,6380
2880,華南金,15,0,15,光和,2023-08-24,6380
4938,和碩,32,17,15,光和,2023-08-24,6380
2382,廣達,55,42,13,光和,2023-08-24,6380
2359,所羅門,15,2,13,光和,2023-08-24,6380
6457,紘康,13,0,13,光和,2023-08-24,6380
2634,漢翔,58,46,12,光和,2023-08-24,6380
2882,國泰金,12,0,12,光和,2023-08-24,6380
2020,美亞,12,0,12,光和,2023-08-24,6380
2605,新興,12,0,12,光和,2023-08-24,6380
00715L,期街口布蘭特正2,11,0,11,光和,2023-08-24,6380
2062,橋椿,11,0,11,光和,2023-08-24,6380
2399,映泰,20,9,11,光和,2023-08-24,6380
00930,永豐ESG低碳高息,10,0,10,光和,2023-08-24,6380
00885,富邦越南,10,0,10,光和,2023-08-24,6380
1515,力山,10,0,10,光和,2023-08-24,6380
3706,神達,26,16,10,光和,2023-08-24,6380
4931,新盛力,10,0,10,光和,2023-08-24,6380
6122,擎邦,10,0,10,光和,2023-08-24,6380
8046,南電,11,1,10,光和,2023-08-24,6380
2338,光罩,10,1,9,光和,2023-08-24,6380
00900,富邦特選高股息30,11,2,9,光和,2023-08-24,6380
3483,力致,10,2,8,光和,2023-08-24,6380
2017,官田鋼,8,0,8,光和,2023-08-24,6380
2884,玉山金,9,1,8,光和,2023-08-24,6380
2891,中信金,8,0,8,光和,2023-08-24,6380
3094,聯傑,15,7,8,光和,2023-08-24,6380
3666,光耀,8,0,8,光和,2023-08-24,6380
1220,台榮,152,0,152,光和,2023-08-25,6380
3231,緯創,137,55,82,光和,2023-08-25,6380
2353,宏��,55,2,53,光和,2023-08-25,6380
2618,長榮航,64,12,52,光和,2023-08-25,6380
2382,廣達,58,10,48,光和,2023-08-25,6380
00882,中信中國高股息,76,30,46,光和,2023-08-25,6380
00929,復華台灣科技優息,59,18,41,光和,2023-08-25,6380
6275,元山,35,0,35,光和,2023-08-25,6380
2485,兆赫,65,31,34,光和,2023-08-25,6380
2449,京元電子,43,10,33,光和,2023-08-25,6380
2344,華邦電,30,0,30,光和,2023-08-25,6380
00919,群益台灣精選高息,24,0,24,光和,2023-08-25,6380
3706,神達,36,16,20,光和,2023-08-25,6380
2516,新建,21,1,20,光和,2023-08-25,6380
00650L,復華香港正2,18,0,18,光和,2023-08-25,6380
2303,聯電,17,0,17,光和,2023-08-25,6380
3032,偉訓,13,1,12,光和,2023-08-25,6380
3227,原相,13,1,12,光和,2023-08-25,6380
3338,泰碩,12,0,12,光和,2023-08-25,6380
2014,中鴻,12,0,12,光和,2023-08-25,6380
00665L,富邦�琤肭磪囓�2,11,0,11,光和,2023-08-25,6380
2401,凌陽,13,2,11,光和,2023-08-25,6380
1216,統一,10,0,10,光和,2023-08-25,6380
1504,東元,10,0,10,光和,2023-08-25,6380
1707,葡萄王,10,0,10,光和,2023-08-25,6380
2302,麗正,10,0,10,光和,2023-08-25,6380
3694,海華,10,0,10,光和,2023-08-25,6380
4766,南寶,10,0,10,光和,2023-08-25,6380
6510,精測,10,0,10,光和,2023-08-25,6380
8926,台汽電,10,1,9,光和,2023-08-25,6380
0056,元大高股息,9,0,9,光和,2023-08-25,6380
6770,力積電,9,0,9,光和,2023-08-25,6380
8234,新漢,9,0,9,光和,2023-08-25,6380
2105,正新,8,0,8,光和,2023-08-25,6380
5371,中光電,8,0,8,光和,2023-08-25,6380
9103,美德醫療-DR,8,0,8,光和,2023-08-25,6380
3037,欣興,14,7,7,光和,2023-08-25,6380
2323,中環,27,20,7,光和,2023-08-25,6380
00877,復華中國5G,7,0,7,光和,2023-08-25,6380
00679B,元大美債20年,7,0,7,光和,2023-08-25,6380
1905,華紙,7,0,7,光和,2023-08-25,6380
2371,大同,28,21,7,光和,2023-08-25,6380
5608,四維航,7,0,7,光和,2023-08-25,6380
6443,元晶,9,2,7,光和,2023-08-25,6380
8222,寶一,9,2,7,光和,2023-08-25,6380
9904,寶成,7,0,7,光和,2023-08-25,6380
2002,中鋼,17,10,7,光和,2023-08-25,6380
2884,玉山金,6,0,6,光和,2023-08-25,6380
2376,技嘉,14,8,6,光和,2023-08-25,6380
00662,富邦NASDAQ,6,0,6,光和,2023-08-25,6380
00931B,統一美債20年,200,0,200,光和,2023-08-28,6380
00637L,元大滬深300正2,183,79,104,光和,2023-08-28,6380
2387,精元,70,0,70,光和,2023-08-28,6380
2618,長榮航,66,7,59,光和,2023-08-28,6380
00929,復華台灣科技優息,57,6,51,光和,2023-08-28,6380
3051,力特,48,0,48,光和,2023-08-28,6380
2460,建通,43,0,43,光和,2023-08-28,6380
3558,神準,34,0,34,光和,2023-08-28,6380
4906,正文,47,16,31,光和,2023-08-28,6380
2331,精英,37,7,30,光和,2023-08-28,6380
4714,永捷,30,1,29,光和,2023-08-28,6380
2634,漢翔,72,46,26,光和,2023-08-28,6380
2388,威盛,30,5,25,光和,2023-08-28,6380
00878,國泰永續高股息,28,5,23,光和,2023-08-28,6380
1471,首利,36,13,23,光和,2023-08-28,6380
2371,大同,54,31,23,光和,2023-08-28,6380
4960,誠美材,22,0,22,光和,2023-08-28,6380
6531,愛普*,20,0,20,光和,2023-08-28,6380
2801,彰銀,30,10,20,光和,2023-08-28,6380
2359,所羅門,18,0,18,光和,2023-08-28,6380
3234,光環,18,0,18,光和,2023-08-28,6380
2329,華泰,24,7,17,光和,2023-08-28,6380
00919,群益台灣精選高息,16,0,16,光和,2023-08-28,6380
1612,宏泰,15,0,15,光和,2023-08-28,6380
2441,超豐,14,0,14,光和,2023-08-28,6380
8358,金居,21,7,14,光和,2023-08-28,6380
2377,微星,12,0,12,光和,2023-08-28,6380
2014,中鴻,12,0,12,光和,2023-08-28,6380
2610,華航,12,0,12,光和,2023-08-28,6380
5009,榮剛,13,1,12,光和,2023-08-28,6380
1529,樂事綠能,12,1,11,光和,2023-08-28,6380
2344,華邦電,12,1,11,光和,2023-08-28,6380
2457,飛宏,11,0,11,光和,2023-08-28,6380
2603,長榮,16,5,11,光和,2023-08-28,6380
8234,新漢,12,1,11,光和,2023-08-28,6380
1313,聯成,10,0,10,光和,2023-08-28,6380
1785,光洋科,10,0,10,光和,2023-08-28,6380
2020,美亞,10,0,10,光和,2023-08-28,6380
2355,敬鵬,27,17,10,光和,2023-08-28,6380
2419,仲琦,10,0,10,光和,2023-08-28,6380
6156,松上,10,0,10,光和,2023-08-28,6380
1513,中興電,11,2,9,光和,2023-08-28,6380
2382,廣達,37,28,9,光和,2023-08-28,6380
0056,元大高股息,9,1,8,光和,2023-08-28,6380
00888,永豐台灣ESG,10,2,8,光和,2023-08-28,6380
1216,統一,8,0,8,光和,2023-08-28,6380
1584,精剛,8,0,8,光和,2023-08-28,6380
3704,合勤控,8,0,8,光和,2023-08-28,6380
6457,紘康,8,0,8,光和,2023-08-28,6380
2323,中環,8,1,7,光和,2023-08-28,6380
2002,中鋼,62,0,62,光和,2023-08-29,6380
2880,華南金,42,0,42,光和,2023-08-29,6380
2387,精元,40,0,40,光和,2023-08-29,6380
2312,金寶,192,152,40,光和,2023-08-29,6380
2363,矽統,75,44,31,光和,2023-08-29,6380
2884,玉山金,31,0,31,光和,2023-08-29,6380
6443,元晶,40,12,28,光和,2023-08-29,6380
8358,金居,29,3,26,光和,2023-08-29,6380
2317,鴻海,25,1,24,光和,2023-08-29,6380
00929,復華台灣科技優息,26,3,23,光和,2023-08-29,6380
9136,巨騰-DR,20,0,20,光和,2023-08-29,6380
6770,力積電,22,3,19,光和,2023-08-29,6380
4543,萬在,17,0,17,光和,2023-08-29,6380
1528,恩德,15,0,15,光和,2023-08-29,6380
3583,辛耘,16,1,15,光和,2023-08-29,6380
1471,首利,31,17,14,光和,2023-08-29,6380
00919,群益台灣精選高息,15,2,13,光和,2023-08-29,6380
1513,中興電,14,1,13,光和,2023-08-29,6380
2630,亞航,13,1,12,光和,2023-08-29,6380
1810,和成,13,1,12,光和,2023-08-29,6380
2020,美亞,11,0,11,光和,2023-08-29,6380
8222,寶一,13,2,11,光和,2023-08-29,6380
3622,洋華,10,0,10,光和,2023-08-29,6380
1612,宏泰,55,45,10,光和,2023-08-29,6380
2374,佳能,14,4,10,光和,2023-08-29,6380
6244,茂迪,19,9,10,光和,2023-08-29,6380
2615,萬海,9,0,9,光和,2023-08-29,6380
6168,宏齊,10,1,9,光和,2023-08-29,6380
2460,建通,15,7,8,光和,2023-08-29,6380
2634,漢翔,31,23,8,光和,2023-08-29,6380
4906,正文,13,5,8,光和,2023-08-29,6380
9904,寶成,6,0,6,光和,2023-08-29,6380
2485,兆赫,9,3,6,光和,2023-08-29,6380
3312,弘憶股,6,0,6,光和,2023-08-29,6380
3576,聯合再生,6,0,6,光和,2023-08-29,6380
5521,工信,6,0,6,光和,2023-08-29,6380
2353,宏��,5,0,5,光和,2023-08-29,6380
00795B,中信美國公債20年,5,0,5,光和,2023-08-29,6380
2062,橋椿,5,0,5,光和,2023-08-29,6380
2356,英業達,13,8,5,光和,2023-08-29,6380
2364,倫飛,5,0,5,光和,2023-08-29,6380
2419,仲琦,5,0,5,光和,2023-08-29,6380
3548,兆利,6,1,5,光和,2023-08-29,6380
4958,臻鼎-KY,5,0,5,光和,2023-08-29,6380
6139,亞翔,5,0,5,光和,2023-08-29,6380
8046,南電,8,4,4,光和,2023-08-29,6380
2377,微星,4,0,4,光和,2023-08-29,6380
2605,新興,4,0,4,光和,2023-08-29,6380
3234,光環,4,0,4,光和,2023-08-29,6380
4935,茂林-KY,4,0,4,光和,2023-08-29,6380
2337,旺宏,466,126,340,光和,2023-08-30,6380
2371,大同,36,3,33,光和,2023-08-30,6380
2014,中鴻,31,1,30,光和,2023-08-30,6380
00637L,元大滬深300正2,26,0,26,光和,2023-08-30,6380
3325,旭品,36,12,24,光和,2023-08-30,6380
3481,群創,55,33,22,光和,2023-08-30,6380
00673R,期元大S＆P原油反1,20,0,20,光和,2023-08-30,6380
5009,榮剛,39,20,19,光和,2023-08-30,6380
2618,長榮航,30,15,15,光和,2023-08-30,6380
5876,上海商銀,15,0,15,光和,2023-08-30,6380
1463,強盛新,14,0,14,光和,2023-08-30,6380
6443,元晶,16,3,13,光和,2023-08-30,6380
1326,台化,11,0,11,光和,2023-08-30,6380
00632R,元大台灣50反1,11,0,11,光和,2023-08-30,6380
6625,必應,11,0,11,光和,2023-08-30,6380
2891,中信金,10,0,10,光和,2023-08-30,6380
1605,華新,16,6,10,光和,2023-08-30,6380
2387,精元,10,0,10,光和,2023-08-30,6380
3390,旭軟,10,0,10,光和,2023-08-30,6380
3694,海華,10,0,10,光和,2023-08-30,6380
6282,康舒,13,3,10,光和,2023-08-30,6380
00650L,復華香港正2,11,2,9,光和,2023-08-30,6380
2020,美亞,9,0,9,光和,2023-08-30,6380
2353,宏��,12,3,9,光和,2023-08-30,6380
8234,新漢,9,0,9,光和,2023-08-30,6380
1301,台塑,8,0,8,光和,2023-08-30,6380
1612,宏泰,9,1,8,光和,2023-08-30,6380
2609,陽明,8,0,8,光和,2023-08-30,6380
3051,力特,30,22,8,光和,2023-08-30,6380
00919,群益台灣精選高息,17,10,7,光和,2023-08-30,6380
2063,世鎧,7,0,7,光和,2023-08-30,6380
2301,光寶科,13,6,7,光和,2023-08-30,6380
6120,達運,7,0,7,光和,2023-08-30,6380
2331,精英,11,5,6,光和,2023-08-30,6380
1339,昭輝,6,0,6,光和,2023-08-30,6380
3588,通嘉,6,0,6,光和,2023-08-30,6380
5258,虹堡,6,0,6,光和,2023-08-30,6380
6194,育富,6,0,6,光和,2023-08-30,6380
8050,廣積,7,1,6,光和,2023-08-30,6380
9945,潤泰新,8,2,6,光和,2023-08-30,6380
1217,愛之味,5,0,5,光和,2023-08-30,6380
1529,樂事綠能,7,2,5,光和,2023-08-30,6380
1711,永光,5,0,5,光和,2023-08-30,6380
2464,盟立,5,0,5,光和,2023-08-30,6380
2634,漢翔,10,5,5,光和,2023-08-30,6380
2812,台中銀,5,0,5,光和,2023-08-30,6380
8049,晶采,5,0,5,光和,2023-08-30,6380
911608,明輝-DR,5,0,5,光和,2023-08-30,6380
2887,台新金,5,1,4,光和,2023-08-30,6380
2412,中華電,5,1,4,光和,2023-08-30,6380
8112,至上,66,0,66,光和,2023-08-31,6380
1609,大亞,80,20,60,光和,2023-08-31,6380
2371,大同,36,0,36,光和,2023-08-31,6380
2880,華南金,32,0,32,光和,2023-08-31,6380
1402,遠東新,31,0,31,光和,2023-08-31,6380
3706,神達,52,22,30,光和,2023-08-31,6380
2337,旺宏,307,278,29,光和,2023-08-31,6380
2614,東森,29,0,29,光和,2023-08-31,6380
00929,復華台灣科技優息,29,5,24,光和,2023-08-31,6380
1101,台泥,23,0,23,光和,2023-08-31,6380
3078,僑威,47,24,23,光和,2023-08-31,6380
2324,仁寶,36,14,22,光和,2023-08-31,6380
00919,群益台灣精選高息,23,2,21,光和,2023-08-31,6380
00665L,富邦�琤肭磪囓�2,21,0,21,光和,2023-08-31,6380
2323,中環,41,20,21,光和,2023-08-31,6380
2206,三陽工業,20,0,20,光和,2023-08-31,6380
2885,元大金,20,0,20,光和,2023-08-31,6380
1216,統一,19,0,19,光和,2023-08-31,6380
3481,群創,21,5,16,光和,2023-08-31,6380
2390,云辰,15,2,13,光和,2023-08-31,6380
3483,力致,13,0,13,光和,2023-08-31,6380
2887,台新金,13,0,13,光和,2023-08-31,6380
00637L,元大滬深300正2,12,0,12,光和,2023-08-31,6380
2363,矽統,80,68,12,光和,2023-08-31,6380
5009,榮剛,16,4,12,光和,2023-08-31,6380
1802,台玻,18,8,10,光和,2023-08-31,6380
1810,和成,10,0,10,光和,2023-08-31,6380
2312,金寶,57,47,10,光和,2023-08-31,6380
3694,海華,10,0,10,光和,2023-08-31,6380
3715,定穎投控,15,5,10,光和,2023-08-31,6380
4207,環泰,11,1,10,光和,2023-08-31,6380
4933,友輝,21,11,10,光和,2023-08-31,6380
5371,中光電,10,0,10,光和,2023-08-31,6380
6015,宏遠證,10,0,10,光和,2023-08-31,6380
6282,康舒,12,2,10,光和,2023-08-31,6380
2617,台航,10,1,9,光和,2023-08-31,6380
8933,愛地雅,10,1,9,光和,2023-08-31,6380
2317,鴻海,10,2,8,光和,2023-08-31,6380
00888,永豐台灣ESG,8,0,8,光和,2023-08-31,6380
2618,長榮航,41,33,8,光和,2023-08-31,6380
2801,彰銀,8,0,8,光和,2023-08-31,6380
2881,富邦金,12,4,8,光和,2023-08-31,6380
2376,技嘉,22,15,7,光和,2023-08-31,6380
00878,國泰永續高股息,11,4,7,光和,2023-08-31,6380
2883,凱基金,7,0,7,光和,2023-08-31,6380
4906,正文,21,14,7,光和,2023-08-31,6380
9904,寶成,7,0,7,光和,2023-08-31,6380
00900,富邦特選高股息30,7,0,7,光和,2023-08-31,6380
1513,中興電,6,0,6,光和,2023-08-31,6380
2352,佳世達,6,0,6,光和,2023-08-31,6380
2363,矽統,293,120,173,光和,2023-09-01,6380
00919,群益台灣精選高息,93,0,93,光和,2023-09-01,6380
2329,華泰,128,39,89,光和,2023-09-01,6380
2485,兆赫,75,20,55,光和,2023-09-01,6380
3231,緯創,94,43,51,光和,2023-09-01,6380
4533,協易機,49,2,47,光和,2023-09-01,6380
00932,兆豐永續高息等權,42,0,42,光和,2023-09-01,6380
00673R,期元大S＆P原油反1,37,0,37,光和,2023-09-01,6380
1609,大亞,38,4,34,光和,2023-09-01,6380
2382,廣達,35,5,30,光和,2023-09-01,6380
8105,凌巨,29,0,29,光和,2023-09-01,6380
2618,長榮航,103,76,27,光和,2023-09-01,6380
2892,第一金,23,0,23,光和,2023-09-01,6380
3325,旭品,32,11,21,光和,2023-09-01,6380
2356,英業達,46,26,20,光和,2023-09-01,6380
2369,菱生,24,4,20,光和,2023-09-01,6380
6438,迅得,20,0,20,光和,2023-09-01,6380
2884,玉山金,19,0,19,光和,2023-09-01,6380
4716,大立,20,1,19,光和,2023-09-01,6380
5706,鳳凰,19,0,19,光和,2023-09-01,6380
2402,毅嘉,29,10,19,光和,2023-09-01,6380
1815,富喬,24,6,18,光和,2023-09-01,6380
00907,永豐優息存股,15,0,15,光和,2023-09-01,6380
2355,敬鵬,17,2,15,光和,2023-09-01,6380
3051,力特,37,22,15,光和,2023-09-01,6380
6547,高端疫苗,29,14,15,光和,2023-09-01,6380
2323,中環,13,0,13,光和,2023-09-01,6380
3308,聯德,23,10,13,光和,2023-09-01,6380
6282,康舒,14,1,13,光和,2023-09-01,6380
2324,仁寶,14,2,12,光和,2023-09-01,6380
3032,偉訓,13,1,12,光和,2023-09-01,6380
1513,中興電,16,5,11,光和,2023-09-01,6380
6116,彩晶,11,0,11,光和,2023-09-01,6380
8088,品安,10,0,10,光和,2023-09-01,6380
00882,中信中國高股息,10,0,10,光和,2023-09-01,6380
00665L,富邦�琤肭磪囓�2,10,0,10,光和,2023-09-01,6380
2399,映泰,10,0,10,光和,2023-09-01,6380
3005,神基,10,0,10,光和,2023-09-01,6380
5310,天剛,10,0,10,光和,2023-09-01,6380
5488,松普,12,2,10,光和,2023-09-01,6380
6026,福邦證,11,1,10,光和,2023-09-01,6380
2812,台中銀,10,0,10,光和,2023-09-01,6380
5880,合庫金,10,1,9,光和,2023-09-01,6380
0056,元大高股息,9,0,9,光和,2023-09-01,6380
2472,立隆電,9,0,9,光和,2023-09-01,6380
00900,富邦特選高股息30,9,0,9,光和,2023-09-01,6380
1409,新纖,8,0,8,光和,2023-09-01,6380
2027,大成鋼,8,0,8,光和,2023-09-01,6380
6147,頎邦,7,0,7,光和,2023-09-01,6380
6245,立端,7,0,7,光和,2023-09-01,6380
00919,群益台灣精選高息,227,0,227,光和,2023-09-04,6380
3231,緯創,126,12,114,光和,2023-09-04,6380
2371,大同,115,11,104,光和,2023-09-04,6380
6668,中揚光,102,0,102,光和,2023-09-04,6380
1802,台玻,131,76,55,光和,2023-09-04,6380
2323,中環,33,0,33,光和,2023-09-04,6380
2460,建通,32,0,32,光和,2023-09-04,6380
1216,統一,30,0,30,光和,2023-09-04,6380
2610,華航,39,9,30,光和,2023-09-04,6380
2363,矽統,48,20,28,光和,2023-09-04,6380
1471,首利,33,6,27,光和,2023-09-04,6380
3515,華擎,27,0,27,光和,2023-09-04,6380
00929,復華台灣科技優息,26,0,26,光和,2023-09-04,6380
1504,東元,26,2,24,光和,2023-09-04,6380
3031,佰鴻,20,0,20,光和,2023-09-04,6380
00665L,富邦�琤肭磪囓�2,30,12,18,光和,2023-09-04,6380
2402,毅嘉,26,8,18,光和,2023-09-04,6380
3432,台端,17,0,17,光和,2023-09-04,6380
5381,合正,44,27,17,光和,2023-09-04,6380
00679B,元大美債20年,16,0,16,光和,2023-09-04,6380
1101,台泥,16,0,16,光和,2023-09-04,6380
2374,佳能,20,4,16,光和,2023-09-04,6380
2881,富邦金,16,1,15,光和,2023-09-04,6380
2376,技嘉,17,2,15,光和,2023-09-04,6380
00673R,期元大S＆P原油反1,15,0,15,光和,2023-09-04,6380
4960,誠美材,15,0,15,光和,2023-09-04,6380
6418,詠昇,15,0,15,光和,2023-09-04,6380
00720B,元大投資級公司債,14,0,14,光和,2023-09-04,6380
2331,精英,17,3,14,光和,2023-09-04,6380
1528,恩德,16,3,13,光和,2023-09-04,6380
2329,華泰,27,14,13,光和,2023-09-04,6380
6443,元晶,13,0,13,光和,2023-09-04,6380
8049,晶采,13,0,13,光和,2023-09-04,6380
2845,遠東銀,12,0,12,光和,2023-09-04,6380
3325,旭品,17,5,12,光和,2023-09-04,6380
00931B,統一美債20年,12,0,12,光和,2023-09-04,6380
8222,寶一,14,3,11,光和,2023-09-04,6380
4768,晶呈科技,10,0,10,光和,2023-09-04,6380
00632R,元大台灣50反1,10,0,10,光和,2023-09-04,6380
1815,富喬,10,0,10,光和,2023-09-04,6380
1905,華紙,10,0,10,光和,2023-09-04,6380
2393,億光,10,0,10,光和,2023-09-04,6380
2906,高林,10,0,10,光和,2023-09-04,6380
6546,正基,10,0,10,光和,2023-09-04,6380
4763,材料-KY,14,4,10,光和,2023-09-04,6380
2888,新光金,25,15,10,光和,2023-09-04,6380
2542,興富發,10,0,10,光和,2023-09-04,6380
1609,大亞,9,0,9,光和,2023-09-04,6380
2356,英業達,12,3,9,光和,2023-09-04,6380
5608,四維航,10,1,9,光和,2023-09-04,6380
2610,華航,113,11,102,光和,2023-09-05,6380
00929,復華台灣科技優息,146,89,57,光和,2023-09-05,6380
00665L,富邦�琤肭磪囓�2,54,0,54,光和,2023-09-05,6380
00915,凱基優選高股息30,53,0,53,光和,2023-09-05,6380
1314,中石化,31,1,30,光和,2023-09-05,6380
4906,正文,30,0,30,光和,2023-09-05,6380
1101,台泥,25,0,25,光和,2023-09-05,6380
4716,大立,25,0,25,光和,2023-09-05,6380
1616,億泰,20,0,20,光和,2023-09-05,6380
6116,彩晶,20,0,20,光和,2023-09-05,6380
2409,友達,25,6,19,光和,2023-09-05,6380
2363,矽統,70,52,18,光和,2023-09-05,6380
3078,僑威,31,13,18,光和,2023-09-05,6380
3231,緯創,34,18,16,光和,2023-09-05,6380
2618,長榮航,16,0,16,光和,2023-09-05,6380
2906,高林,20,4,16,光和,2023-09-05,6380
5457,宣德,16,0,16,光和,2023-09-05,6380
00882,中信中國高股息,15,0,15,光和,2023-09-05,6380
2402,毅嘉,20,5,15,光和,2023-09-05,6380
5351,鈺創,21,6,15,光和,2023-09-05,6380
6026,福邦證,14,0,14,光和,2023-09-05,6380
6548,長科*,15,1,14,光和,2023-09-05,6380
8048,德勝,15,1,14,光和,2023-09-05,6380
2312,金寶,25,13,12,光和,2023-09-05,6380
6122,擎邦,29,18,11,光和,2023-09-05,6380
00637L,元大滬深300正2,12,1,11,光和,2023-09-05,6380
2323,中環,17,6,11,光和,2023-09-05,6380
4968,立積,11,0,11,光和,2023-09-05,6380
00650L,復華香港正2,11,1,10,光和,2023-09-05,6380
00632R,元大台灣50反1,10,0,10,光和,2023-09-05,6380
2332,友訊,22,12,10,光和,2023-09-05,6380
2419,仲琦,10,0,10,光和,2023-09-05,6380
2886,兆豐金,10,0,10,光和,2023-09-05,6380
3694,海華,10,0,10,光和,2023-09-05,6380
00919,群益台灣精選高息,15,5,10,光和,2023-09-05,6380
2376,技嘉,20,11,9,光和,2023-09-05,6380
3013,晟銘電,9,0,9,光和,2023-09-05,6380
3088,艾訊,15,6,9,光和,2023-09-05,6380
6190,萬泰科,11,2,9,光和,2023-09-05,6380
1301,台塑,9,1,8,光和,2023-09-05,6380
1339,昭輝,8,0,8,光和,2023-09-05,6380
2436,偉詮電,27,19,8,光和,2023-09-05,6380
2884,玉山金,8,0,8,光和,2023-09-05,6380
2020,美亞,7,0,7,光和,2023-09-05,6380
4162,智擎,7,0,7,光和,2023-09-05,6380
6168,宏齊,9,2,7,光和,2023-09-05,6380
6231,系微,8,1,7,光和,2023-09-05,6380
6419,京晨科,7,0,7,光和,2023-09-05,6380
2201,裕隆,10,3,7,光和,2023-09-05,6380
2457,飛宏,7,1,6,光和,2023-09-05,6380
00878,國泰永續高股息,246,10,236,光和,2023-09-06,6380
00929,復華台灣科技優息,134,17,117,光和,2023-09-06,6380
2610,華航,140,23,117,光和,2023-09-06,6380
2618,長榮航,90,1,89,光和,2023-09-06,6380
2409,友達,103,26,77,光和,2023-09-06,6380
3481,群創,82,20,62,光和,2023-09-06,6380
2801,彰銀,53,1,52,光和,2023-09-06,6380
3036,文曄,50,0,50,光和,2023-09-06,6380
00919,群益台灣精選高息,105,60,45,光和,2023-09-06,6380
2401,凌陽,41,3,38,光和,2023-09-06,6380
2323,中環,31,0,31,光和,2023-09-06,6380
00932,兆豐永續高息等權,30,0,30,光和,2023-09-06,6380
6282,康舒,31,1,30,光和,2023-09-06,6380
1471,首利,32,3,29,光和,2023-09-06,6380
2880,華南金,25,0,25,光和,2023-09-06,6380
00712,復華富時不動產,25,1,24,光和,2023-09-06,6380
3325,旭品,28,5,23,光和,2023-09-06,6380
00753L,中信中國50正2,21,0,21,光和,2023-09-06,6380
8027,鈦昇,21,0,21,光和,2023-09-06,6380
2376,技嘉,27,10,17,光和,2023-09-06,6380
00637L,元大滬深300正2,17,0,17,光和,2023-09-06,6380
2359,所羅門,20,3,17,光和,2023-09-06,6380
6026,福邦證,17,0,17,光和,2023-09-06,6380
5381,合正,43,27,16,光和,2023-09-06,6380
1612,宏泰,16,0,16,光和,2023-09-06,6380
2460,建通,16,0,16,光和,2023-09-06,6380
2363,矽統,60,44,16,光和,2023-09-06,6380
00918,大華優利高填息30,16,1,15,光和,2023-09-06,6380
4147,中裕,21,6,15,光和,2023-09-06,6380
1802,台玻,18,4,14,光和,2023-09-06,6380
00679B,元大美債20年,13,0,13,光和,2023-09-06,6380
2888,新光金,33,20,13,光和,2023-09-06,6380
00665L,富邦�琤肭磪囓�2,15,2,13,光和,2023-09-06,6380
2645,長榮航太,12,0,12,光和,2023-09-06,6380
2886,兆豐金,12,0,12,光和,2023-09-06,6380
3694,海華,12,0,12,光和,2023-09-06,6380
1314,中石化,11,0,11,光和,2023-09-06,6380
00923,群益台ESG低碳50,10,0,10,光和,2023-09-06,6380
00882,中信中國高股息,10,0,10,光和,2023-09-06,6380
2014,中鴻,10,0,10,光和,2023-09-06,6380
2374,佳能,10,0,10,光和,2023-09-06,6380
2425,承啟,11,1,10,光和,2023-09-06,6380
2606,裕民,10,0,10,光和,2023-09-06,6380
3043,科風,11,1,10,光和,2023-09-06,6380
3567,逸昌,15,5,10,光和,2023-09-06,6380
3689,湧德,10,0,10,光和,2023-09-06,6380
3706,神達,16,6,10,光和,2023-09-06,6380
6461,益得,10,0,10,光和,2023-09-06,6380
2891,中信金,9,0,9,光和,2023-09-06,6380
6274,台燿,12,3,9,光和,2023-09-06,6380
00919,群益台灣精選高息,98,1,97,光和,2023-09-07,6380
3706,神達,73,0,73,光和,2023-09-07,6380
00878,國泰永續高股息,59,17,42,光和,2023-09-07,6380
2409,友達,57,15,42,光和,2023-09-07,6380
00932,兆豐永續高息等權,39,0,39,光和,2023-09-07,6380
3715,定穎投控,54,23,31,光和,2023-09-07,6380
2485,兆赫,50,19,31,光和,2023-09-07,6380
2834,臺企銀,30,0,30,光和,2023-09-07,6380
2312,金寶,56,30,26,光和,2023-09-07,6380
00720B,元大投資級公司債,23,0,23,光和,2023-09-07,6380
2610,華航,59,37,22,光和,2023-09-07,6380
3481,群創,35,14,21,光和,2023-09-07,6380
9934,成霖,20,0,20,光和,2023-09-07,6380
00751B,元大AAA至A公司債,20,0,20,光和,2023-09-07,6380
5488,松普,20,0,20,光和,2023-09-07,6380
9136,巨騰-DR,20,0,20,光和,2023-09-07,6380
1314,中石化,18,0,18,光和,2023-09-07,6380
2371,大同,28,10,18,光和,2023-09-07,6380
4533,協易機,49,33,16,光和,2023-09-07,6380
00929,復華台灣科技優息,127,111,16,光和,2023-09-07,6380
00902,中信電池及儲能,16,0,16,光和,2023-09-07,6380
4147,中裕,16,0,16,光和,2023-09-07,6380
2324,仁寶,15,0,15,光和,2023-09-07,6380
2002,中鋼,14,0,14,光和,2023-09-07,6380
00673R,期元大S＆P原油反1,14,0,14,光和,2023-09-07,6380
00665L,富邦�琤肭磪囓�2,15,3,12,光和,2023-09-07,6380
1605,華新,15,3,12,光和,2023-09-07,6380
5347,世界,12,0,12,光和,2023-09-07,6380
5381,合正,32,21,11,光和,2023-09-07,6380
6209,今國光,11,1,10,光和,2023-09-07,6380
1101,台泥,17,7,10,光和,2023-09-07,6380
00927,群益半導體收益,10,0,10,光和,2023-09-07,6380
1102,亞泥,10,0,10,光和,2023-09-07,6380
3049,精金,10,0,10,光和,2023-09-07,6380
5302,太欣,10,0,10,光和,2023-09-07,6380
8027,鈦昇,11,1,10,光和,2023-09-07,6380
6125,廣運,13,3,10,光和,2023-09-07,6380
2317,鴻海,13,3,10,光和,2023-09-07,6380
00637L,元大滬深300正2,25,16,9,光和,2023-09-07,6380
8112,至上,12,3,9,光和,2023-09-07,6380
2887,台新金,8,0,8,光和,2023-09-07,6380
00918,大華優利高填息30,8,0,8,光和,2023-09-07,6380
1513,中興電,8,0,8,光和,2023-09-07,6380
1718,中纖,8,0,8,光和,2023-09-07,6380
3013,晟銘電,13,5,8,光和,2023-09-07,6380
3515,華擎,8,0,8,光和,2023-09-07,6380
8076,伍豐,8,0,8,光和,2023-09-07,6380
2330,台積電,7,0,7,光和,2023-09-07,6380
6173,信昌電,9,2,7,光和,2023-09-07,6380
00753L,中信中國50正2,7,0,7,光和,2023-09-07,6380
00919,群益台灣精選高息,125,6,119,光和,2023-09-08,6380
00931B,統一美債20年,121,30,91,光和,2023-09-08,6380
2606,裕民,90,6,84,光和,2023-09-08,6380
00929,復華台灣科技優息,57,3,54,光和,2023-09-08,6380
00679B,元大美債20年,47,0,47,光和,2023-09-08,6380
2834,臺企銀,41,0,41,光和,2023-09-08,6380
1810,和成,30,0,30,光和,2023-09-08,6380
5381,合正,31,3,28,光和,2023-09-08,6380
3227,原相,24,2,22,光和,2023-09-08,6380
3580,友威科,22,0,22,光和,2023-09-08,6380
2382,廣達,27,6,21,光和,2023-09-08,6380
1802,台玻,20,1,19,光和,2023-09-08,6380
6531,愛普*,21,3,18,光和,2023-09-08,6380
3213,茂訊,18,0,18,光和,2023-09-08,6380
3481,群創,28,11,17,光和,2023-09-08,6380
2374,佳能,16,0,16,光和,2023-09-08,6380
2618,長榮航,31,17,14,光和,2023-09-08,6380
6547,高端疫苗,16,2,14,光和,2023-09-08,6380
2313,華通,28,15,13,光和,2023-09-08,6380
3338,泰碩,34,21,13,光和,2023-09-08,6380
2323,中環,12,0,12,光和,2023-09-08,6380
00637L,元大滬深300正2,12,0,12,光和,2023-09-08,6380
3325,旭品,18,6,12,光和,2023-09-08,6380
4147,中裕,21,9,12,光和,2023-09-08,6380
8222,寶一,15,3,12,光和,2023-09-08,6380
5347,世界,11,0,11,光和,2023-09-08,6380
00882,中信中國高股息,11,0,11,光和,2023-09-08,6380
6005,群益證,12,1,11,光和,2023-09-08,6380
1609,大亞,11,1,10,光和,2023-09-08,6380
1324,地球,10,0,10,光和,2023-09-08,6380
1514,亞力,10,0,10,光和,2023-09-08,6380
1529,樂事綠能,10,0,10,光和,2023-09-08,6380
2409,友達,11,1,10,光和,2023-09-08,6380
2498,宏達電,12,2,10,光和,2023-09-08,6380
6202,盛群,10,0,10,光和,2023-09-08,6380
6770,力積電,10,0,10,光和,2023-09-08,6380
8936,國統,26,16,10,光和,2023-09-08,6380
9962,有益,10,0,10,光和,2023-09-08,6380
1524,耿鼎,10,0,10,光和,2023-09-08,6380
4123,晟德,10,0,10,光和,2023-09-08,6380
00902,中信電池及儲能,8,0,8,光和,2023-09-08,6380
2329,華泰,18,10,8,光和,2023-09-08,6380
2610,華航,11,4,7,光和,2023-09-08,6380
3046,建��,15,8,7,光和,2023-09-08,6380
3047,訊舟,7,0,7,光和,2023-09-08,6380
3515,華擎,7,0,7,光和,2023-09-08,6380
4533,協易機,9,2,7,光和,2023-09-08,6380
3014,聯陽,7,0,7,光和,2023-09-08,6380
2317,鴻海,7,0,7,光和,2023-09-08,6380
2344,華邦電,6,0,6,光和,2023-09-08,6380
00919,群益台灣精選高息,347,0,347,光和,2023-09-11,6380
0056,元大高股息,134,6,128,光和,2023-09-11,6380
00929,復華台灣科技優息,122,5,117,光和,2023-09-11,6380
00632R,元大台灣50反1,100,1,99,光和,2023-09-11,6380
2363,矽統,141,49,92,光和,2023-09-11,6380
00664R,國泰臺灣加權反1,90,0,90,光和,2023-09-11,6380
9105,泰金寶-DR,60,0,60,光和,2023-09-11,6380
2405,輔信,64,21,43,光和,2023-09-11,6380
1802,台玻,40,4,36,光和,2023-09-11,6380
2884,玉山金,36,0,36,光和,2023-09-11,6380
2312,金寶,99,66,33,光和,2023-09-11,6380
2025,千興,30,0,30,光和,2023-09-11,6380
2888,新光金,30,0,30,光和,2023-09-11,6380
1528,恩德,29,1,28,光和,2023-09-11,6380
2369,菱生,37,10,27,光和,2023-09-11,6380
2618,長榮航,27,1,26,光和,2023-09-11,6380
5392,能率,25,0,25,光和,2023-09-11,6380
2376,技嘉,35,12,23,光和,2023-09-11,6380
00712,復華富時不動產,22,0,22,光和,2023-09-11,6380
6443,元晶,22,0,22,光和,2023-09-11,6380
00882,中信中國高股息,21,0,21,光和,2023-09-11,6380
00931B,統一美債20年,21,0,21,光和,2023-09-11,6380
2630,亞航,23,3,20,光和,2023-09-11,6380
4768,晶呈科技,18,0,18,光和,2023-09-11,6380
6770,力積電,18,0,18,光和,2023-09-11,6380
2913,農林,25,7,18,光和,2023-09-11,6380
2486,一詮,26,9,17,光和,2023-09-11,6380
6531,愛普*,22,7,15,光和,2023-09-11,6380
00932,兆豐永續高息等權,15,0,15,光和,2023-09-11,6380
2368,金像電,17,2,15,光和,2023-09-11,6380
3049,精金,15,0,15,光和,2023-09-11,6380
3356,奇偶,15,0,15,光和,2023-09-11,6380
4763,材料-KY,19,4,15,光和,2023-09-11,6380
5452,佶優,15,0,15,光和,2023-09-11,6380
1216,統一,14,0,14,光和,2023-09-11,6380
1584,精剛,19,5,14,光和,2023-09-11,6380
00915,凱基優選高股息30,12,0,12,光和,2023-09-11,6380
8033,雷虎,14,2,12,光和,2023-09-11,6380
3231,緯創,36,25,11,光和,2023-09-11,6380
00751B,元大AAA至A公司債,11,0,11,光和,2023-09-11,6380
2353,宏��,34,23,11,光和,2023-09-11,6380
2356,英業達,26,16,10,光和,2023-09-11,6380
1612,宏泰,10,0,10,光和,2023-09-11,6380
2892,第一金,10,0,10,光和,2023-09-11,6380
3060,銘異,10,0,10,光和,2023-09-11,6380
3694,海華,10,0,10,光和,2023-09-11,6380
2606,裕民,9,0,9,光和,2023-09-11,6380
5371,中光電,14,5,9,光和,2023-09-11,6380
9950,萬國通,9,0,9,光和,2023-09-11,6380
2352,佳世達,10,2,8,光和,2023-09-11,6380
00632R,元大台灣50反1,280,0,280,光和,2023-09-12,6380
6282,康舒,118,6,112,光和,2023-09-12,6380
00929,復華台灣科技優息,115,34,81,光和,2023-09-12,6380
4714,永捷,70,0,70,光和,2023-09-12,6380
2883,凱基金,61,0,61,光和,2023-09-12,6380
6120,達運,58,7,51,光和,2023-09-12,6380
1307,三芳,50,0,50,光和,2023-09-12,6380
00919,群益台灣精選高息,38,1,37,光和,2023-09-12,6380
3338,泰碩,32,0,32,光和,2023-09-12,6380
2645,長榮航太,26,0,26,光和,2023-09-12,6380
2404,漢唐,35,10,25,光和,2023-09-12,6380
3715,定穎投控,28,4,24,光和,2023-09-12,6380
2374,佳能,21,0,21,光和,2023-09-12,6380
1809,中釉,21,0,21,光和,2023-09-12,6380
2460,建通,35,14,21,光和,2023-09-12,6380
8936,國統,21,0,21,光和,2023-09-12,6380
00664R,國泰臺灣加權反1,20,0,20,光和,2023-09-12,6380
2312,金寶,58,40,18,光和,2023-09-12,6380
2457,飛宏,17,0,17,光和,2023-09-12,6380
3264,欣銓,26,9,17,光和,2023-09-12,6380
2382,廣達,32,15,17,光和,2023-09-12,6380
1710,東聯,17,1,16,光和,2023-09-12,6380
2314,台揚,16,0,16,光和,2023-09-12,6380
00673R,期元大S＆P原油反1,15,0,15,光和,2023-09-12,6380
2834,臺企銀,20,5,15,光和,2023-09-12,6380
2331,精英,14,0,14,光和,2023-09-12,6380
1471,首利,21,8,13,光和,2023-09-12,6380
8358,金居,16,3,13,光和,2023-09-12,6380
2002,中鋼,13,1,12,光和,2023-09-12,6380
2356,英業達,22,10,12,光和,2023-09-12,6380
2368,金像電,14,2,12,光和,2023-09-12,6380
3363,上詮,14,2,12,光和,2023-09-12,6380
2323,中環,12,0,12,光和,2023-09-12,6380
4142,國光生,11,0,11,光和,2023-09-12,6380
6167,久正,11,0,11,光和,2023-09-12,6380
2884,玉山金,10,0,10,光和,2023-09-12,6380
00665L,富邦�琤肭磪囓�2,30,20,10,光和,2023-09-12,6380
00753L,中信中國50正2,10,0,10,光和,2023-09-12,6380
1319,東陽,21,11,10,光和,2023-09-12,6380
1609,大亞,11,1,10,光和,2023-09-12,6380
4161,聿新科,10,0,10,光和,2023-09-12,6380
4561,健椿,13,3,10,光和,2023-09-12,6380
1513,中興電,12,3,9,光和,2023-09-12,6380
1528,恩德,14,5,9,光和,2023-09-12,6380
2027,大成鋼,11,2,9,光和,2023-09-12,6380
5381,合正,15,6,9,光和,2023-09-12,6380
4916,事欣科,13,5,8,光和,2023-09-12,6380
2353,宏��,11,4,7,光和,2023-09-12,6380
2542,興富發,7,0,7,光和,2023-09-12,6380
6829,千附精密,7,0,7,光和,2023-09-12,6380
00637L,元大滬深300正2,182,1,181,光和,2023-09-13,6380
00919,群益台灣精選高息,154,0,154,光和,2023-09-13,6380
00929,復華台灣科技優息,106,21,85,光和,2023-09-13,6380
2883,凱基金,84,0,84,光和,2023-09-13,6380
2405,輔信,70,0,70,光和,2023-09-13,6380
00918,大華優利高填息30,62,0,62,光和,2023-09-13,6380
2369,菱生,39,0,39,光和,2023-09-13,6380
2025,千興,35,0,35,光和,2023-09-13,6380
2363,矽統,47,17,30,光和,2023-09-13,6380
00673R,期元大S＆P原油反1,30,0,30,光和,2023-09-13,6380
1416,廣豐,30,0,30,光和,2023-09-13,6380
1605,華新,26,0,26,光和,2023-09-13,6380
2329,華泰,39,17,22,光和,2023-09-13,6380
3704,合勤控,22,0,22,光和,2023-09-13,6380
3031,佰鴻,20,0,20,光和,2023-09-13,6380
2312,金寶,30,11,19,光和,2023-09-13,6380
00665L,富邦�琤肭磪囓�2,20,2,18,光和,2023-09-13,6380
2618,長榮航,27,10,17,光和,2023-09-13,6380
3231,緯創,30,15,15,光和,2023-09-13,6380
2374,佳能,15,0,15,光和,2023-09-13,6380
5009,榮剛,15,2,13,光和,2023-09-13,6380
5215,科嘉-KY,13,0,13,光和,2023-09-13,6380
2801,彰銀,12,0,12,光和,2023-09-13,6380
00902,中信電池及儲能,11,0,11,光和,2023-09-13,6380
00882,中信中國高股息,11,0,11,光和,2023-09-13,6380
1802,台玻,11,0,11,光和,2023-09-13,6380
3481,群創,14,3,11,光和,2023-09-13,6380
1210,大成,10,0,10,光和,2023-09-13,6380
00885,富邦越南,10,0,10,光和,2023-09-13,6380
00632R,元大台灣50反1,10,0,10,光和,2023-09-13,6380
1338,廣華-KY,10,0,10,光和,2023-09-13,6380
1718,中纖,10,0,10,光和,2023-09-13,6380
2002,中鋼,13,3,10,光和,2023-09-13,6380
2889,國票金,10,0,10,光和,2023-09-13,6380
3003,健和興,11,1,10,光和,2023-09-13,6380
2538,基泰,13,3,10,光和,2023-09-13,6380
3032,偉訓,9,0,9,光和,2023-09-13,6380
3591,艾笛森,10,1,9,光和,2023-09-13,6380
6120,達運,11,2,9,光和,2023-09-13,6380
6234,高僑,10,1,9,光和,2023-09-13,6380
2352,佳世達,14,6,8,光和,2023-09-13,6380
1434,福懋,7,0,7,光和,2023-09-13,6380
3545,敦泰,7,0,7,光和,2023-09-13,6380
6125,廣運,12,5,7,光和,2023-09-13,6380
2020,美亞,7,0,7,光和,2023-09-13,6380
2376,技嘉,15,8,7,光和,2023-09-13,6380
00706L,期元大S＆P日圓正2,6,0,6,光和,2023-09-13,6380
2324,仁寶,12,6,6,光和,2023-09-13,6380
2359,所羅門,6,0,6,光和,2023-09-13,6380
2457,飛宏,7,1,6,光和,2023-09-13,6380
00632R,元大台灣50反1,461,0,461,光和,2023-09-14,6380
00919,群益台灣精選高息,191,30,161,光和,2023-09-14,6380
2889,國票金,80,0,80,光和,2023-09-14,6380
00929,復華台灣科技優息,81,33,48,光和,2023-09-14,6380
2324,仁寶,50,3,47,光和,2023-09-14,6380
2303,聯電,61,24,37,光和,2023-09-14,6380
2369,菱生,55,18,37,光和,2023-09-14,6380
2323,中環,55,20,35,光和,2023-09-14,6380
2312,金寶,41,10,31,光和,2023-09-14,6380
2888,新光金,30,0,30,光和,2023-09-14,6380
1522,堤維西,48,20,28,光和,2023-09-14,6380
2618,長榮航,28,2,26,光和,2023-09-14,6380
2371,大同,29,3,26,光和,2023-09-14,6380
00665L,富邦�琤肭磪囓�2,20,0,20,光和,2023-09-14,6380
00664R,國泰臺灣加權反1,20,0,20,光和,2023-09-14,6380
6235,華孚,23,3,20,光和,2023-09-14,6380
2002,中鋼,21,2,19,光和,2023-09-14,6380
4533,協易機,19,0,19,光和,2023-09-14,6380
1471,首利,20,2,18,光和,2023-09-14,6380
2356,英業達,37,19,18,光和,2023-09-14,6380
00882,中信中國高股息,17,0,17,光和,2023-09-14,6380
4915,致伸,20,3,17,光和,2023-09-14,6380
3325,旭品,16,0,16,光和,2023-09-14,6380
3260,威剛,12,0,12,光和,2023-09-14,6380
4147,中裕,18,7,11,光和,2023-09-14,6380
5353,台林,11,0,11,光和,2023-09-14,6380
3576,聯合再生,10,0,10,光和,2023-09-14,6380
1338,廣華-KY,10,0,10,光和,2023-09-14,6380
3306,鼎天,11,1,10,光和,2023-09-14,6380
6419,京晨科,10,0,10,光和,2023-09-14,6380
8358,金居,10,0,10,光和,2023-09-14,6380
9105,泰金寶-DR,10,0,10,光和,2023-09-14,6380
1217,愛之味,9,0,9,光和,2023-09-14,6380
00637L,元大滬深300正2,32,24,8,光和,2023-09-14,6380
4953,緯軟,8,0,8,光和,2023-09-14,6380
9941,裕融,8,0,8,光和,2023-09-14,6380
3005,神基,7,0,7,光和,2023-09-14,6380
8048,德勝,13,6,7,光和,2023-09-14,6380
2313,華通,15,8,7,光和,2023-09-14,6380
2605,新興,25,18,7,光和,2023-09-14,6380
3685,元創精密,7,0,7,光和,2023-09-14,6380
1444,力麗,7,0,7,光和,2023-09-14,6380
4979,華星光,8,2,6,光和,2023-09-14,6380
2617,台航,10,4,6,光和,2023-09-14,6380
00687B,國泰20年美債,5,0,5,光和,2023-09-14,6380
2064,晉椿,5,0,5,光和,2023-09-14,6380
2332,友訊,10,5,5,光和,2023-09-14,6380
2355,敬鵬,6,1,5,光和,2023-09-14,6380
2425,承啟,5,0,5,光和,2023-09-14,6380
3356,奇偶,5,0,5,光和,2023-09-14,6380
00929,復華台灣科技優息,162,3,159,光和,2023-09-15,6380
2485,兆赫,113,2,111,光和,2023-09-15,6380
8054,安國,116,5,111,光和,2023-09-15,6380
00922,國泰台灣領袖50,92,0,92,光和,2023-09-15,6380
00919,群益台灣精選高息,205,124,81,光和,2023-09-15,6380
3390,旭軟,70,0,70,光和,2023-09-15,6380
1416,廣豐,62,0,62,光和,2023-09-15,6380
3013,晟銘電,58,1,57,光和,2023-09-15,6380
2002,中鋼,55,1,54,光和,2023-09-15,6380
5371,中光電,38,3,35,光和,2023-09-15,6380
2610,華航,36,4,32,光和,2023-09-15,6380
00673R,期元大S＆P原油反1,30,0,30,光和,2023-09-15,6380
006208,富邦台50,30,1,29,光和,2023-09-15,6380
3481,群創,33,5,28,光和,2023-09-15,6380
2317,鴻海,26,0,26,光和,2023-09-15,6380
6282,康舒,37,12,25,光和,2023-09-15,6380
2472,立隆電,24,0,24,光和,2023-09-15,6380
00931B,統一美債20年,23,0,23,光和,2023-09-15,6380
2460,建通,23,0,23,光和,2023-09-15,6380
2892,第一金,22,0,22,光和,2023-09-15,6380
2374,佳能,21,0,21,光和,2023-09-15,6380
2353,宏��,27,7,20,光和,2023-09-15,6380
2834,臺企銀,20,0,20,光和,2023-09-15,6380
2889,國票金,20,0,20,光和,2023-09-15,6380
2645,長榮航太,19,1,18,光和,2023-09-15,6380
00637L,元大滬深300正2,17,0,17,光和,2023-09-15,6380
1524,耿鼎,21,4,17,光和,2023-09-15,6380
1701,中化,17,0,17,光和,2023-09-15,6380
3049,精金,17,0,17,光和,2023-09-15,6380
4915,致伸,18,1,17,光和,2023-09-15,6380
2801,彰銀,27,10,17,光和,2023-09-15,6380
00918,大華優利高填息30,16,0,16,光和,2023-09-15,6380
2883,凱基金,15,0,15,光和,2023-09-15,6380
2025,千興,14,0,14,光和,2023-09-15,6380
2884,玉山金,14,0,14,光和,2023-09-15,6380
2486,一詮,30,17,13,光和,2023-09-15,6380
9935,慶豐富,12,0,12,光和,2023-09-15,6380
3567,逸昌,11,0,11,光和,2023-09-15,6380
00713,元大台灣高息低波,10,0,10,光和,2023-09-15,6380
1210,大成,10,0,10,光和,2023-09-15,6380
00900,富邦特選高股息30,11,1,10,光和,2023-09-15,6380
1301,台塑,10,0,10,光和,2023-09-15,6380
2365,昆盈,10,0,10,光和,2023-09-15,6380
2641,正德,14,4,10,光和,2023-09-15,6380
6026,福邦證,10,0,10,光和,2023-09-15,6380
1609,大亞,11,2,9,光和,2023-09-15,6380
1471,首利,9,0,9,光和,2023-09-15,6380
1905,華紙,9,0,9,光和,2023-09-15,6380
2331,精英,11,2,9,光和,2023-09-15,6380
00751B,元大AAA至A公司債,8,0,8,光和,2023-09-15,6380
00929,復華台灣科技優息,254,45,209,光和,2023-09-18,6380
00919,群益台灣精選高息,183,5,178,光和,2023-09-18,6380
8054,安國,172,1,171,光和,2023-09-18,6380
2363,矽統,184,26,158,光和,2023-09-18,6380
2387,精元,107,2,105,光和,2023-09-18,6380
2409,友達,44,0,44,光和,2023-09-18,6380
3706,神達,41,0,41,光和,2023-09-18,6380
2889,國票金,40,0,40,光和,2023-09-18,6380
00687B,國泰20年美債,28,0,28,光和,2023-09-18,6380
2618,長榮航,54,28,26,光和,2023-09-18,6380
2605,新興,27,3,24,光和,2023-09-18,6380
2323,中環,40,16,24,光和,2023-09-18,6380
00679B,元大美債20年,24,0,24,光和,2023-09-18,6380
00931B,統一美債20年,22,0,22,光和,2023-09-18,6380
2838,聯邦銀,22,0,22,光和,2023-09-18,6380
2608,嘉里大榮,20,0,20,光和,2023-09-18,6380
3078,僑威,22,2,20,光和,2023-09-18,6380
2356,英業達,27,10,17,光和,2023-09-18,6380
1616,億泰,17,0,17,光和,2023-09-18,6380
2353,宏��,18,1,17,光和,2023-09-18,6380
6257,矽格,19,2,17,光和,2023-09-18,6380
00680L,元大美債20正2,16,0,16,光和,2023-09-18,6380
2887,台新金,16,0,16,光和,2023-09-18,6380
2330,台積電,16,0,16,光和,2023-09-18,6380
2812,台中銀,16,0,16,光和,2023-09-18,6380
00878,國泰永續高股息,18,3,15,光和,2023-09-18,6380
2457,飛宏,17,2,15,光和,2023-09-18,6380
2601,益航,31,16,15,光和,2023-09-18,6380
2376,技嘉,26,11,15,光和,2023-09-18,6380
00915,凱基優選高股息30,13,0,13,光和,2023-09-18,6380
3013,晟銘電,12,0,12,光和,2023-09-18,6380
2382,廣達,17,6,11,光和,2023-09-18,6380
00882,中信中國高股息,11,0,11,光和,2023-09-18,6380
1618,合機,11,0,11,光和,2023-09-18,6380
1815,富喬,12,1,11,光和,2023-09-18,6380
2610,華航,11,0,11,光和,2023-09-18,6380
1210,大成,10,0,10,光和,2023-09-18,6380
1444,力麗,10,0,10,光和,2023-09-18,6380
1584,精剛,10,0,10,光和,2023-09-18,6380
2329,華泰,20,10,10,光和,2023-09-18,6380
2485,兆赫,10,0,10,光和,2023-09-18,6380
2634,漢翔,9,0,9,光和,2023-09-18,6380
3231,緯創,14,5,9,光和,2023-09-18,6380
5009,榮剛,18,9,9,光和,2023-09-18,6380
1301,台塑,8,0,8,光和,2023-09-18,6380
2617,台航,10,2,8,光和,2023-09-18,6380
3260,威剛,8,0,8,光和,2023-09-18,6380
0056,元大高股息,7,0,7,光和,2023-09-18,6380
9927,泰銘,7,0,7,光和,2023-09-18,6380
4944,兆遠,6,0,6,光和,2023-09-18,6380
00919,群益台灣精選高息,127,5,122,光和,2023-09-19,6380
00929,復華台灣科技優息,111,16,95,光和,2023-09-19,6380
00921,兆豐龍頭等權重,65,0,65,光和,2023-09-19,6380
1802,台玻,54,0,54,光和,2023-09-19,6380
2201,裕隆,67,13,54,光和,2023-09-19,6380
2340,台亞,52,3,49,光和,2023-09-19,6380
2485,兆赫,43,2,41,光和,2023-09-19,6380
6901,鑽石投資,38,2,36,光和,2023-09-19,6380
1504,東元,46,14,32,光和,2023-09-19,6380
00878,國泰永續高股息,32,0,32,光和,2023-09-19,6380
1210,大成,30,3,27,光和,2023-09-19,6380
3231,緯創,31,7,24,光和,2023-09-19,6380
6244,茂迪,26,2,24,光和,2023-09-19,6380
00753L,中信中國50正2,22,0,22,光和,2023-09-19,6380
00900,富邦特選高股息30,21,0,21,光和,2023-09-19,6380
1101,台泥,21,0,21,光和,2023-09-19,6380
1103,嘉泥,20,0,20,光和,2023-09-19,6380
3031,佰鴻,20,0,20,光和,2023-09-19,6380
4960,誠美材,20,0,20,光和,2023-09-19,6380
8936,國統,20,0,20,光和,2023-09-19,6380
4979,華星光,20,1,19,光和,2023-09-19,6380
00665L,富邦�琤肭磪囓�2,20,1,19,光和,2023-09-19,6380
00927,群益半導體收益,20,2,18,光和,2023-09-19,6380
5347,世界,18,0,18,光和,2023-09-19,6380
00679B,元大美債20年,15,0,15,光和,2023-09-19,6380
2303,聯電,14,0,14,光和,2023-09-19,6380
3059,華晶科,13,0,13,光和,2023-09-19,6380
3078,僑威,16,3,13,光和,2023-09-19,6380
3714,富采,13,0,13,光和,2023-09-19,6380
5009,榮剛,15,2,13,光和,2023-09-19,6380
6589,台康生技,13,0,13,光和,2023-09-19,6380
6150,撼訊,21,9,12,光和,2023-09-19,6380
6153,嘉聯益,30,18,12,光和,2023-09-19,6380
6531,愛普*,23,11,12,光和,2023-09-19,6380
6546,正基,11,0,11,光和,2023-09-19,6380
3062,建漢,13,2,11,光和,2023-09-19,6380
8183,精星,11,0,11,光和,2023-09-19,6380
00885,富邦越南,10,0,10,光和,2023-09-19,6380
1529,樂事綠能,10,0,10,光和,2023-09-19,6380
2405,輔信,10,0,10,光和,2023-09-19,6380
4934,太極,10,0,10,光和,2023-09-19,6380
2460,建通,9,0,9,光和,2023-09-19,6380
6116,彩晶,10,1,9,光和,2023-09-19,6380
6275,元山,10,1,9,光和,2023-09-19,6380
2034,允強,10,2,8,光和,2023-09-19,6380
2436,偉詮電,8,0,8,光和,2023-09-19,6380
2605,新興,8,0,8,光和,2023-09-19,6380
2887,台新金,10,2,8,光和,2023-09-19,6380
4123,晟德,10,2,8,光和,2023-09-19,6380
8086,宏捷科,10,2,8,光和,2023-09-19,6380
00929,復華台灣科技優息,310,59,251,光和,2023-09-20,6380
00919,群益台灣精選高息,158,25,133,光和,2023-09-20,6380
1457,宜進,100,0,100,光和,2023-09-20,6380
2883,凱基金,73,0,73,光和,2023-09-20,6380
00921,兆豐龍頭等權重,62,0,62,光和,2023-09-20,6380
2486,一詮,54,0,54,光和,2023-09-20,6380
2105,正新,46,3,43,光和,2023-09-20,6380
6257,矽格,42,2,40,光和,2023-09-20,6380
4915,致伸,44,10,34,光和,2023-09-20,6380
00932,兆豐永續高息等權,31,0,31,光和,2023-09-20,6380
00907,永豐優息存股,30,0,30,光和,2023-09-20,6380
2317,鴻海,31,2,29,光和,2023-09-20,6380
2618,長榮航,39,10,29,光和,2023-09-20,6380
3338,泰碩,29,3,26,光和,2023-09-20,6380
2882,國泰金,26,0,26,光和,2023-09-20,6380
2367,燿華,57,32,25,光和,2023-09-20,6380
1785,光洋科,24,0,24,光和,2023-09-20,6380
3060,銘異,21,0,21,光和,2023-09-20,6380
3481,群創,31,10,21,光和,2023-09-20,6380
2330,台積電,21,0,21,光和,2023-09-20,6380
2201,裕隆,21,1,20,光和,2023-09-20,6380
2404,漢唐,29,9,20,光和,2023-09-20,6380
5371,中光電,20,0,20,光和,2023-09-20,6380
2208,台船,18,0,18,光和,2023-09-20,6380
2402,毅嘉,18,0,18,光和,2023-09-20,6380
2344,華邦電,27,10,17,光和,2023-09-20,6380
2915,潤泰全,17,0,17,光和,2023-09-20,6380
1304,台聚,16,0,16,光和,2023-09-20,6380
1101,台泥,21,5,16,光和,2023-09-20,6380
00878,國泰永續高股息,20,5,15,光和,2023-09-20,6380
8088,品安,15,0,15,光和,2023-09-20,6380
1802,台玻,19,5,14,光和,2023-09-20,6380
5347,世界,14,0,14,光和,2023-09-20,6380
00753L,中信中國50正2,13,0,13,光和,2023-09-20,6380
2352,佳世達,12,0,12,光和,2023-09-20,6380
00679B,元大美債20年,13,1,12,光和,2023-09-20,6380
3078,僑威,13,1,12,光和,2023-09-20,6380
3163,波若威,20,8,12,光和,2023-09-20,6380
1618,合機,11,0,11,光和,2023-09-20,6380
4123,晟德,11,0,11,光和,2023-09-20,6380
00915,凱基優選高股息30,10,0,10,光和,2023-09-20,6380
00885,富邦越南,10,0,10,光和,2023-09-20,6380
00665L,富邦�琤肭磪囓�2,10,0,10,光和,2023-09-20,6380
1314,中石化,10,0,10,光和,2023-09-20,6380
1809,中釉,10,0,10,光和,2023-09-20,6380
2025,千興,10,0,10,光和,2023-09-20,6380
2401,凌陽,10,0,10,光和,2023-09-20,6380
2880,華南金,10,0,10,光和,2023-09-20,6380
2891,中信金,14,4,10,光和,2023-09-20,6380
3227,原相,10,0,10,光和,2023-09-20,6380
0056,元大高股息,130,0,130,光和,2023-09-21,6380
1457,宜進,100,0,100,光和,2023-09-21,6380
2801,彰銀,95,0,95,光和,2023-09-21,6380
00929,復華台灣科技優息,102,25,77,光和,2023-09-21,6380
00919,群益台灣精選高息,76,2,74,光和,2023-09-21,6380
00878,國泰永續高股息,70,1,69,光和,2023-09-21,6380
2002,中鋼,63,0,63,光和,2023-09-21,6380
2405,輔信,50,2,48,光和,2023-09-21,6380
2888,新光金,46,0,46,光和,2023-09-21,6380
1101,台泥,42,0,42,光和,2023-09-21,6380
2880,華南金,40,0,40,光和,2023-09-21,6380
2606,裕民,43,5,38,光和,2023-09-21,6380
6122,擎邦,38,0,38,光和,2023-09-21,6380
00637L,元大滬深300正2,34,0,34,光和,2023-09-21,6380
2201,裕隆,34,2,32,光和,2023-09-21,6380
00927,群益半導體收益,31,0,31,光和,2023-09-21,6380
3615,安可,28,0,28,光和,2023-09-21,6380
00932,兆豐永續高息等權,24,1,23,光和,2023-09-21,6380
2449,京元電子,24,1,23,光和,2023-09-21,6380
3706,神達,39,16,23,光和,2023-09-21,6380
00665L,富邦�琤肭磪囓�2,21,0,21,光和,2023-09-21,6380
2344,華邦電,22,1,21,光和,2023-09-21,6380
2889,國票金,20,0,20,光和,2023-09-21,6380
3703,欣陸,18,0,18,光和,2023-09-21,6380
3227,原相,18,0,18,光和,2023-09-21,6380
00753L,中信中國50正2,17,0,17,光和,2023-09-21,6380
2645,長榮航太,20,3,17,光和,2023-09-21,6380
2317,鴻海,20,3,17,光和,2023-09-21,6380
6257,矽格,17,1,16,光和,2023-09-21,6380
00922,國泰台灣領袖50,16,0,16,光和,2023-09-21,6380
2892,第一金,16,0,16,光和,2023-09-21,6380
00882,中信中國高股息,20,5,15,光和,2023-09-21,6380
1314,中石化,15,0,15,光和,2023-09-21,6380
2618,長榮航,15,2,13,光和,2023-09-21,6380
00751B,元大AAA至A公司債,13,0,13,光和,2023-09-21,6380
2887,台新金,13,0,13,光和,2023-09-21,6380
8054,安國,13,0,13,光和,2023-09-21,6380
3011,今皓,12,0,12,光和,2023-09-21,6380
5452,佶優,12,0,12,光和,2023-09-21,6380
2883,凱基金,12,0,12,光和,2023-09-21,6380
1301,台塑,11,0,11,光和,2023-09-21,6380
1434,福懋,12,1,11,光和,2023-09-21,6380
2208,台船,11,0,11,光和,2023-09-21,6380
6589,台康生技,13,2,11,光和,2023-09-21,6380
6202,盛群,10,0,10,光和,2023-09-21,6380
00720B,元大投資級公司債,13,3,10,光和,2023-09-21,6380
2340,台亞,10,0,10,光和,2023-09-21,6380
3031,佰鴻,10,0,10,光和,2023-09-21,6380
3078,僑威,15,5,10,光和,2023-09-21,6380
2353,宏��,9,0,9,光和,2023-09-21,6380
00931B,統一美債20年,50,0,50,光和,2023-09-22,6380
00919,群益台灣精選高息,35,4,31,光和,2023-09-22,6380
00712,復華富時不動產,31,1,30,光和,2023-09-22,6380
1584,精剛,43,14,29,光和,2023-09-22,6380
1101,台泥,29,1,28,光和,2023-09-22,6380
1815,富喬,25,0,25,光和,2023-09-22,6380
00679B,元大美債20年,59,34,25,光和,2023-09-22,6380
1513,中興電,32,8,24,光和,2023-09-22,6380
2313,華通,31,10,21,光和,2023-09-22,6380
3703,欣陸,21,0,21,光和,2023-09-22,6380
6122,擎邦,21,0,21,光和,2023-09-22,6380
00885,富邦越南,20,1,19,光和,2023-09-22,6380
2206,三陽工業,22,3,19,光和,2023-09-22,6380
2888,新光金,26,10,16,光和,2023-09-22,6380
3694,海華,15,0,15,光和,2023-09-22,6380
8011,台通,15,0,15,光和,2023-09-22,6380
2892,第一金,14,0,14,光和,2023-09-22,6380
00637L,元大滬深300正2,15,2,13,光和,2023-09-22,6380
2882,國泰金,12,0,12,光和,2023-09-22,6380
2303,聯電,11,0,11,光和,2023-09-22,6380
1314,中石化,11,0,11,光和,2023-09-22,6380
2641,正德,11,0,11,光和,2023-09-22,6380
8358,金居,12,1,11,光和,2023-09-22,6380
2634,漢翔,10,0,10,光和,2023-09-22,6380
00882,中信中國高股息,10,0,10,光和,2023-09-22,6380
00673R,期元大S＆P原油反1,10,0,10,光和,2023-09-22,6380
1802,台玻,10,0,10,光和,2023-09-22,6380
2358,廷鑫,10,0,10,光和,2023-09-22,6380
2417,圓剛,12,2,10,光和,2023-09-22,6380
2905,三商,10,0,10,光和,2023-09-22,6380
3060,銘異,10,0,10,光和,2023-09-22,6380
5371,中光電,10,0,10,光和,2023-09-22,6380
6005,群益證,10,0,10,光和,2023-09-22,6380
8064,東捷,10,0,10,光和,2023-09-22,6380
00751B,元大AAA至A公司債,9,0,9,光和,2023-09-22,6380
2330,台積電,9,0,9,光和,2023-09-22,6380
2353,宏��,12,3,9,光和,2023-09-22,6380
2359,所羅門,12,3,9,光和,2023-09-22,6380
1524,耿鼎,12,4,8,光和,2023-09-22,6380
2337,旺宏,197,189,8,光和,2023-09-22,6380
2485,兆赫,11,3,8,光和,2023-09-22,6380
6770,力積電,11,3,8,光和,2023-09-22,6380
1444,力麗,12,5,7,光和,2023-09-22,6380
2376,技嘉,17,10,7,光和,2023-09-22,6380
2618,長榮航,14,7,7,光和,2023-09-22,6380
00795B,中信美國公債20年,7,0,7,光和,2023-09-22,6380
2890,永豐金,7,0,7,光和,2023-09-22,6380
3051,力特,12,5,7,光和,2023-09-22,6380
6589,台康生技,7,0,7,光和,2023-09-22,6380
8110,華東,10,3,7,光和,2023-09-22,6380
2834,臺企銀,501,0,501,光和,2023-09-25,6380
00929,復華台灣科技優息,98,6,92,光和,2023-09-25,6380
2201,裕隆,70,8,62,光和,2023-09-25,6380
00919,群益台灣精選高息,55,0,55,光和,2023-09-25,6380
1101,台泥,53,0,53,光和,2023-09-25,6380
3706,神達,34,2,32,光和,2023-09-25,6380
00637L,元大滬深300正2,33,3,30,光和,2023-09-25,6380
00632R,元大台灣50反1,30,0,30,光和,2023-09-25,6380
2405,輔信,50,20,30,光和,2023-09-25,6380
2363,矽統,34,10,24,光和,2023-09-25,6380
3481,群創,26,2,24,光和,2023-09-25,6380
00713,元大台灣高息低波,20,0,20,光和,2023-09-25,6380
6418,詠昇,20,0,20,光和,2023-09-25,6380
1504,東元,21,2,19,光和,2023-09-25,6380
2618,長榮航,26,8,18,光和,2023-09-25,6380
00772B,中信高評級公司債,16,0,16,光和,2023-09-25,6380
3615,安可,21,6,15,光和,2023-09-25,6380
2303,聯電,13,1,12,光和,2023-09-25,6380
3051,力特,23,11,12,光和,2023-09-25,6380
2382,廣達,14,3,11,光和,2023-09-25,6380
00680L,元大美債20正2,11,0,11,光和,2023-09-25,6380
2317,鴻海,10,0,10,光和,2023-09-25,6380
00773B,中信優先金融債,10,0,10,光和,2023-09-25,6380
00932,兆豐永續高息等權,10,0,10,光和,2023-09-25,6380
2027,大成鋼,10,0,10,光和,2023-09-25,6380
2838,聯邦銀,10,0,10,光和,2023-09-25,6380
6116,彩晶,10,0,10,光和,2023-09-25,6380
2329,華泰,12,3,9,光和,2023-09-25,6380
2542,興富發,9,0,9,光和,2023-09-25,6380
3224,三顧,9,0,9,光和,2023-09-25,6380
6139,亞翔,20,11,9,光和,2023-09-25,6380
6282,康舒,15,6,9,光和,2023-09-25,6380
00902,中信電池及儲能,8,0,8,光和,2023-09-25,6380
2324,仁寶,19,11,8,光和,2023-09-25,6380
2905,三商,8,0,8,光和,2023-09-25,6380
2358,廷鑫,7,0,7,光和,2023-09-25,6380
2425,承啟,7,0,7,光和,2023-09-25,6380
3163,波若威,12,5,7,光和,2023-09-25,6380
4542,科嶠,7,0,7,光和,2023-09-25,6380
00679B,元大美債20年,6,0,6,光和,2023-09-25,6380
2409,友達,6,0,6,光和,2023-09-25,6380
8234,新漢,6,0,6,光和,2023-09-25,6380
912000,晨訊科-DR,6,0,6,光和,2023-09-25,6380
00931B,統一美債20年,5,0,5,光和,2023-09-25,6380
3532,台勝科,5,0,5,光和,2023-09-25,6380
2316,楠梓電,9,4,5,光和,2023-09-25,6380
2867,三商壽,5,0,5,光和,2023-09-25,6380
4908,前鼎,8,3,5,光和,2023-09-25,6380
8040,九暘,5,0,5,光和,2023-09-25,6380
8112,至上,7,2,5,光和,2023-09-25,6380
2801,彰銀,59,0,59,光和,2023-09-26,6380
2890,永豐金,50,1,49,光和,2023-09-26,6380
00712,復華富時不動產,49,0,49,光和,2023-09-26,6380
6770,力積電,33,0,33,光和,2023-09-26,6380
00919,群益台灣精選高息,31,0,31,光和,2023-09-26,6380
3481,群創,47,17,30,光和,2023-09-26,6380
1815,富喬,71,42,29,光和,2023-09-26,6380
00929,復華台灣科技優息,86,58,28,光和,2023-09-26,6380
6257,矽格,28,0,28,光和,2023-09-26,6380
00902,中信電池及儲能,25,0,25,光和,2023-09-26,6380
3444,利機,25,0,25,光和,2023-09-26,6380
2329,華泰,25,2,23,光和,2023-09-26,6380
1101,台泥,24,2,22,光和,2023-09-26,6380
00922,國泰台灣領袖50,20,0,20,光和,2023-09-26,6380
00882,中信中國高股息,20,0,20,光和,2023-09-26,6380
2880,華南金,19,0,19,光和,2023-09-26,6380
00679B,元大美債20年,29,10,19,光和,2023-09-26,6380
1522,堤維西,23,5,18,光和,2023-09-26,6380
2363,矽統,46,28,18,光和,2023-09-26,6380
5371,中光電,18,1,17,光和,2023-09-26,6380
2002,中鋼,17,0,17,光和,2023-09-26,6380
1701,中化,16,0,16,光和,2023-09-26,6380
2417,圓剛,16,0,16,光和,2023-09-26,6380
2303,聯電,17,2,15,光和,2023-09-26,6380
3338,泰碩,17,3,14,光和,2023-09-26,6380
6122,擎邦,14,0,14,光和,2023-09-26,6380
8048,德勝,14,0,14,光和,2023-09-26,6380
5880,合庫金,14,0,14,光和,2023-09-26,6380
00878,國泰永續高股息,15,3,12,光和,2023-09-26,6380
2460,建通,12,0,12,光和,2023-09-26,6380
2356,英業達,13,2,11,光和,2023-09-26,6380
3042,晶技,11,0,11,光和,2023-09-26,6380
2812,台中銀,11,1,10,光和,2023-09-26,6380
2020,美亞,10,0,10,光和,2023-09-26,6380
2313,華通,13,3,10,光和,2023-09-26,6380
2371,大同,13,3,10,光和,2023-09-26,6380
2408,南亞科,10,0,10,光和,2023-09-26,6380
3576,聯合再生,10,0,10,光和,2023-09-26,6380
3703,欣陸,10,0,10,光和,2023-09-26,6380
2317,鴻海,12,2,10,光和,2023-09-26,6380
2881,富邦金,10,0,10,光和,2023-09-26,6380
5347,世界,12,3,9,光和,2023-09-26,6380
00931B,統一美債20年,15,6,9,光和,2023-09-26,6380
00923,群益台ESG低碳50,9,0,9,光和,2023-09-26,6380
1584,精剛,22,13,9,光和,2023-09-26,6380
3163,波若威,16,7,9,光和,2023-09-26,6380
1337,再生-KY,8,0,8,光和,2023-09-26,6380
2332,友訊,8,0,8,光和,2023-09-26,6380
2485,兆赫,11,3,8,光和,2023-09-26,6380
2883,凱基金,8,0,8,光和,2023-09-26,6380
2002,中鋼,193,2,191,光和,2023-09-27,6380
00929,復華台灣科技優息,158,17,141,光和,2023-09-27,6380
00712,復華富時不動產,67,0,67,光和,2023-09-27,6380
00927,群益半導體收益,50,0,50,光和,2023-09-27,6380
2303,聯電,42,0,42,光和,2023-09-27,6380
00932,兆豐永續高息等權,36,0,36,光和,2023-09-27,6380
6510,精測,24,0,24,光和,2023-09-27,6380
2337,旺宏,41,21,20,光和,2023-09-27,6380
1618,合機,27,8,19,光和,2023-09-27,6380
2617,台航,15,0,15,光和,2023-09-27,6380
6122,擎邦,23,8,15,光和,2023-09-27,6380
00931B,統一美債20年,12,0,12,光和,2023-09-27,6380
2891,中信金,12,0,12,光和,2023-09-27,6380
1409,新纖,10,0,10,光和,2023-09-27,6380
5452,佶優,10,0,10,光和,2023-09-27,6380
6147,頎邦,10,0,10,光和,2023-09-27,6380
9933,中鼎,10,0,10,光和,2023-09-27,6380
2641,正德,12,3,9,光和,2023-09-27,6380
2892,第一金,9,0,9,光和,2023-09-27,6380
1718,中纖,8,0,8,光和,2023-09-27,6380
3481,群創,13,5,8,光和,2023-09-27,6380
1101,台泥,7,0,7,光和,2023-09-27,6380
00637L,元大滬深300正2,7,0,7,光和,2023-09-27,6380
1605,華新,11,4,7,光和,2023-09-27,6380
8088,品安,7,0,7,光和,2023-09-27,6380
8936,國統,22,15,7,光和,2023-09-27,6380
6223,旺矽,7,1,6,光和,2023-09-27,6380
00902,中信電池及儲能,6,0,6,光和,2023-09-27,6380
00679B,元大美債20年,6,0,6,光和,2023-09-27,6380
1785,光洋科,6,0,6,光和,2023-09-27,6380
2358,廷鑫,7,1,6,光和,2023-09-27,6380
3078,僑威,9,3,6,光和,2023-09-27,6380
3545,敦泰,7,1,6,光和,2023-09-27,6380
4906,正文,9,3,6,光和,2023-09-27,6380
4564,元翎,6,0,6,光和,2023-09-27,6380
2883,凱基金,5,0,5,光和,2023-09-27,6380
9802,鈺齊-KY,5,0,5,光和,2023-09-27,6380
00926,凱基全球菁英55,5,0,5,光和,2023-09-27,6380
00687B,國泰20年美債,5,0,5,光和,2023-09-27,6380
1710,東聯,5,0,5,光和,2023-09-27,6380
2014,中鴻,5,0,5,光和,2023-09-27,6380
2344,華邦電,7,2,5,光和,2023-09-27,6380
2882,國泰金,5,0,5,光和,2023-09-27,6380
8048,德勝,5,0,5,光和,2023-09-27,6380
5880,合庫金,5,0,5,光和,2023-09-27,6380
2349,錸德,5,0,5,光和,2023-09-27,6380
2301,光寶科,6,2,4,光和,2023-09-27,6380
4707,磐亞,4,0,4,光和,2023-09-27,6380
1219,福壽,4,0,4,光和,2023-09-27,6380
1301,台塑,4,0,4,光和,2023-09-27,6380
00929,復華台灣科技優息,217,92,125,光和,2023-09-28,6380
2002,中鋼,94,2,92,光和,2023-09-28,6380
1815,富喬,104,29,75,光和,2023-09-28,6380
3706,神達,72,14,58,光和,2023-09-28,6380
020022,元大電動車N,50,0,50,光和,2023-09-28,6380
00931B,統一美債20年,44,0,44,光和,2023-09-28,6380
3231,緯創,59,18,41,光和,2023-09-28,6380
2408,南亞科,33,0,33,光和,2023-09-28,6380
6116,彩晶,30,0,30,光和,2023-09-28,6380
2356,英業達,27,3,24,光和,2023-09-28,6380
5465,富驊,32,8,24,光和,2023-09-28,6380
00679B,元大美債20年,22,0,22,光和,2023-09-28,6380
3032,偉訓,27,5,22,光和,2023-09-28,6380
00932,兆豐永續高息等權,21,0,21,光和,2023-09-28,6380
00673R,期元大S＆P原油反1,21,0,21,光和,2023-09-28,6380
00637L,元大滬深300正2,103,83,20,光和,2023-09-28,6380
1605,華新,48,28,20,光和,2023-09-28,6380
1710,東聯,18,0,18,光和,2023-09-28,6380
6531,愛普*,23,6,17,光和,2023-09-28,6380
00772B,中信高評級公司債,16,0,16,光和,2023-09-28,6380
2801,彰銀,16,0,16,光和,2023-09-28,6380
1449,佳和,15,0,15,光和,2023-09-28,6380
2353,宏��,15,0,15,光和,2023-09-28,6380
2363,矽統,50,35,15,光和,2023-09-28,6380
3006,晶豪科,14,0,14,光和,2023-09-28,6380
2618,長榮航,14,0,14,光和,2023-09-28,6380
00919,群益台灣精選高息,13,0,13,光和,2023-09-28,6380
00712,復華富時不動產,33,20,13,光和,2023-09-28,6380
8046,南電,14,1,13,光和,2023-09-28,6380
00720B,元大投資級公司債,12,0,12,光和,2023-09-28,6380
2610,華航,13,1,12,光和,2023-09-28,6380
4934,太極,12,0,12,光和,2023-09-28,6380
2405,輔信,11,0,11,光和,2023-09-28,6380
2409,友達,11,0,11,光和,2023-09-28,6380
3363,上詮,15,4,11,光和,2023-09-28,6380
00753L,中信中國50正2,10,0,10,光和,2023-09-28,6380
2020,美亞,12,2,10,光和,2023-09-28,6380
2358,廷鑫,10,0,10,光和,2023-09-28,6380
3709,鑫聯大投控,10,0,10,光和,2023-09-28,6380
9934,成霖,10,0,10,光和,2023-09-28,6380
2317,鴻海,10,1,9,光和,2023-09-28,6380
00665L,富邦�琤肭磪囓�2,20,11,9,光和,2023-09-28,6380
5392,能率,9,0,9,光和,2023-09-28,6380
2106,建大,8,0,8,光和,2023-09-28,6380
3483,力致,8,0,8,光和,2023-09-28,6380
6579,研揚,8,0,8,光和,2023-09-28,6380
9904,寶成,8,0,8,光和,2023-09-28,6380
3481,群創,10,2,8,光和,2023-09-28,6380
6191,精成科,14,7,7,光和,2023-09-28,6380
2017,官田鋼,6,0,6,光和,2023-09-28,6380
00632R,元大台灣50反1,251,0,251,光和,2023-10-02,6380
1609,大亞,94,11,83,光和,2023-10-02,6380
2002,中鋼,62,3,59,光和,2023-10-02,6380
2363,矽統,73,26,47,光和,2023-10-02,6380
2367,燿華,48,11,37,光和,2023-10-02,6380
2888,新光金,37,0,37,光和,2023-10-02,6380
2356,英業達,78,42,36,光和,2023-10-02,6380
1605,華新,33,0,33,光和,2023-10-02,6380
3481,群創,37,7,30,光和,2023-10-02,6380
1618,合機,26,3,23,光和,2023-10-02,6380
6116,彩晶,22,0,22,光和,2023-10-02,6380
3450,聯鈞,32,11,21,光和,2023-10-02,6380
1304,台聚,20,0,20,光和,2023-10-02,6380
2618,長榮航,20,0,20,光和,2023-10-02,6380
2313,華通,29,11,18,光和,2023-10-02,6380
2034,允強,15,0,15,光和,2023-10-02,6380
2460,建通,14,0,14,光和,2023-10-02,6380
4768,晶呈科技,14,0,14,光和,2023-10-02,6380
3325,旭品,34,21,13,光和,2023-10-02,6380
5351,鈺創,14,1,13,光和,2023-10-02,6380
1101,台泥,13,1,12,光和,2023-10-02,6380
00772B,中信高評級公司債,12,0,12,光和,2023-10-02,6380
6419,京晨科,12,0,12,光和,2023-10-02,6380
1103,嘉泥,11,0,11,光和,2023-10-02,6380
2436,偉詮電,11,0,11,光和,2023-10-02,6380
00679B,元大美債20年,10,0,10,光和,2023-10-02,6380
1701,中化,10,0,10,光和,2023-10-02,6380
2617,台航,10,0,10,光和,2023-10-02,6380
4207,環泰,10,0,10,光和,2023-10-02,6380
4766,南寶,10,0,10,光和,2023-10-02,6380
6202,盛群,10,0,10,光和,2023-10-02,6380
9934,成霖,10,0,10,光和,2023-10-02,6380
1301,台塑,9,0,9,光和,2023-10-02,6380
3715,定穎投控,13,4,9,光和,2023-10-02,6380
2359,所羅門,12,3,9,光和,2023-10-02,6380
2371,大同,10,1,9,光和,2023-10-02,6380
5381,合正,10,1,9,光和,2023-10-02,6380
1307,三芳,8,0,8,光和,2023-10-02,6380
1710,東聯,8,0,8,光和,2023-10-02,6380
2409,友達,81,73,8,光和,2023-10-02,6380
00931B,統一美債20年,7,0,7,光和,2023-10-02,6380
2025,千興,7,0,7,光和,2023-10-02,6380
2208,台船,8,1,7,光和,2023-10-02,6380
2329,華泰,27,20,7,光和,2023-10-02,6380
5465,富驊,14,7,7,光和,2023-10-02,6380
6026,福邦證,7,0,7,光和,2023-10-02,6380
3081,聯亞,9,2,7,光和,2023-10-02,6380
00720B,元大投資級公司債,6,0,6,光和,2023-10-02,6380
1522,堤維西,7,1,6,光和,2023-10-02,6380
2637,慧洋-KY,6,0,6,光和,2023-10-02,6380
2888,新光金,170,0,170,光和,2023-10-03,6380
3013,晟銘電,123,8,115,光和,2023-10-03,6380
2409,友達,143,72,71,光和,2023-10-03,6380
1605,華新,68,0,68,光和,2023-10-03,6380
00922,國泰台灣領袖50,67,0,67,光和,2023-10-03,6380
00712,復華富時不動產,61,0,61,光和,2023-10-03,6380
1701,中化,61,0,61,光和,2023-10-03,6380
2337,旺宏,140,85,55,光和,2023-10-03,6380
00919,群益台灣精選高息,61,8,53,光和,2023-10-03,6380
2880,華南金,62,12,50,光和,2023-10-03,6380
2801,彰銀,41,0,41,光和,2023-10-03,6380
5225,東科-KY,30,0,30,光和,2023-10-03,6380
2402,毅嘉,30,1,29,光和,2023-10-03,6380
3231,緯創,52,24,28,光和,2023-10-03,6380
00929,復華台灣科技優息,32,5,27,光和,2023-10-03,6380
2363,矽統,41,14,27,光和,2023-10-03,6380
3481,群創,26,0,26,光和,2023-10-03,6380
4960,誠美材,25,0,25,光和,2023-10-03,6380
2002,中鋼,27,3,24,光和,2023-10-03,6380
1301,台塑,24,0,24,光和,2023-10-03,6380
3031,佰鴻,30,6,24,光和,2023-10-03,6380
2883,凱基金,23,0,23,光和,2023-10-03,6380
00679B,元大美債20年,23,1,22,光和,2023-10-03,6380
00882,中信中國高股息,22,0,22,光和,2023-10-03,6380
3338,泰碩,28,6,22,光和,2023-10-03,6380
6531,愛普*,25,3,22,光和,2023-10-03,6380
3390,旭軟,21,0,21,光和,2023-10-03,6380
3715,定穎投控,34,13,21,光和,2023-10-03,6380
2371,大同,28,12,16,光和,2023-10-03,6380
00902,中信電池及儲能,15,0,15,光和,2023-10-03,6380
1449,佳和,15,0,15,光和,2023-10-03,6380
3444,利機,15,0,15,光和,2023-10-03,6380
00751B,元大AAA至A公司債,13,0,13,光和,2023-10-03,6380
1303,南亞,12,0,12,光和,2023-10-03,6380
2323,中環,15,3,12,光和,2023-10-03,6380
2034,允強,11,0,11,光和,2023-10-03,6380
5009,榮剛,11,0,11,光和,2023-10-03,6380
2301,光寶科,14,4,10,光和,2023-10-03,6380
00930,永豐ESG低碳高息,10,0,10,光和,2023-10-03,6380
3356,奇偶,10,0,10,光和,2023-10-03,6380
3694,海華,10,0,10,光和,2023-10-03,6380
3714,富采,11,1,10,光和,2023-10-03,6380
4763,材料-KY,11,1,10,光和,2023-10-03,6380
4766,南寶,10,0,10,光和,2023-10-03,6380
5880,合庫金,10,0,10,光和,2023-10-03,6380
6418,詠昇,10,0,10,光和,2023-10-03,6380
2618,長榮航,32,23,9,光和,2023-10-03,6380
1216,統一,10,1,9,光和,2023-10-03,6380
1609,大亞,16,7,9,光和,2023-10-03,6380
9904,寶成,8,0,8,光和,2023-10-03,6380
2337,旺宏,83,0,83,光和,2023-10-04,6380
1909,榮成,68,0,68,光和,2023-10-04,6380
00712,復華富時不動產,66,0,66,光和,2023-10-04,6380
00713,元大台灣高息低波,63,0,63,光和,2023-10-04,6380
00679B,元大美債20年,59,0,59,光和,2023-10-04,6380
006208,富邦台50,49,0,49,光和,2023-10-04,6380
2201,裕隆,49,4,45,光和,2023-10-04,6380
00922,國泰台灣領袖50,40,0,40,光和,2023-10-04,6380
1609,大亞,40,1,39,光和,2023-10-04,6380
2891,中信金,36,0,36,光和,2023-10-04,6380
2888,新光金,34,0,34,光和,2023-10-04,6380
00919,群益台灣精選高息,32,0,32,光和,2023-10-04,6380
1216,統一,29,0,29,光和,2023-10-04,6380
2303,聯電,27,0,27,光和,2023-10-04,6380
3706,神達,31,6,25,光和,2023-10-04,6380
1802,台玻,23,0,23,光和,2023-10-04,6380
3481,群創,37,14,23,光和,2023-10-04,6380
8027,鈦昇,22,0,22,光和,2023-10-04,6380
1701,中化,21,0,21,光和,2023-10-04,6380
1710,東聯,21,0,21,光和,2023-10-04,6380
4714,永捷,20,0,20,光和,2023-10-04,6380
2887,台新金,19,0,19,光和,2023-10-04,6380
8936,國統,39,20,19,光和,2023-10-04,6380
5488,松普,17,0,17,光和,2023-10-04,6380
5880,合庫金,16,0,16,光和,2023-10-04,6380
00692,富邦公司治理,16,0,16,光和,2023-10-04,6380
2002,中鋼,18,2,16,光和,2023-10-04,6380
00637L,元大滬深300正2,15,0,15,光和,2023-10-04,6380
3231,緯創,30,16,14,光和,2023-10-04,6380
5009,榮剛,14,0,14,光和,2023-10-04,6380
1307,三芳,13,0,13,光和,2023-10-04,6380
00687B,國泰20年美債,13,0,13,光和,2023-10-04,6380
1618,合機,15,2,13,光和,2023-10-04,6380
6770,力積電,13,0,13,光和,2023-10-04,6380
2834,臺企銀,13,0,13,光和,2023-10-04,6380
00772B,中信高評級公司債,12,0,12,光和,2023-10-04,6380
2882,國泰金,22,10,12,光和,2023-10-04,6380
2883,凱基金,12,0,12,光和,2023-10-04,6380
2419,仲琦,13,2,11,光和,2023-10-04,6380
1612,宏泰,10,0,10,光和,2023-10-04,6380
2324,仁寶,10,0,10,光和,2023-10-04,6380
2371,大同,10,0,10,光和,2023-10-04,6380
2538,基泰,10,0,10,光和,2023-10-04,6380
8110,華東,10,0,10,光和,2023-10-04,6380
00931B,統一美債20年,10,0,10,光和,2023-10-04,6380
00878,國泰永續高股息,9,0,9,光和,2023-10-04,6380
3032,偉訓,13,4,9,光和,2023-10-04,6380
2618,長榮航,14,5,9,光和,2023-10-04,6380
2610,華航,14,6,8,光和,2023-10-04,6380
2603,長榮,8,0,8,光和,2023-10-04,6380
00712,復華富時不動產,104,10,94,光和,2023-10-05,6380
2312,金寶,55,0,55,光和,2023-10-05,6380
3715,定穎投控,64,28,36,光和,2023-10-05,6380
2801,彰銀,70,35,35,光和,2023-10-05,6380
2888,新光金,32,1,31,光和,2023-10-05,6380
1802,台玻,30,0,30,光和,2023-10-05,6380
4960,誠美材,25,1,24,光和,2023-10-05,6380
2883,凱基金,23,1,22,光和,2023-10-05,6380
1815,富喬,60,39,21,光和,2023-10-05,6380
2812,台中銀,21,0,21,光和,2023-10-05,6380
00753L,中信中國50正2,20,0,20,光和,2023-10-05,6380
1449,佳和,17,0,17,光和,2023-10-05,6380
00687B,國泰20年美債,15,0,15,光和,2023-10-05,6380
5009,榮剛,15,0,15,光和,2023-10-05,6380
1514,亞力,18,4,14,光和,2023-10-05,6380
00751B,元大AAA至A公司債,13,0,13,光和,2023-10-05,6380
2314,台揚,15,2,13,光和,2023-10-05,6380
2892,第一金,13,0,13,光和,2023-10-05,6380
3481,群創,23,11,12,光和,2023-10-05,6380
6153,嘉聯益,12,0,12,光和,2023-10-05,6380
8027,鈦昇,12,0,12,光和,2023-10-05,6380
8210,勤誠,12,0,12,光和,2023-10-05,6380
1101,台泥,12,1,11,光和,2023-10-05,6380
2606,裕民,11,0,11,光和,2023-10-05,6380
2417,圓剛,19,9,10,光和,2023-10-05,6380
00918,大華優利高填息30,10,0,10,光和,2023-10-05,6380
1216,統一,11,1,10,光和,2023-10-05,6380
1304,台聚,10,0,10,光和,2023-10-05,6380
00706L,期元大S＆P日圓正2,10,0,10,光和,2023-10-05,6380
00637L,元大滬深300正2,10,0,10,光和,2023-10-05,6380
00632R,元大台灣50反1,60,50,10,光和,2023-10-05,6380
6531,愛普*,33,23,10,光和,2023-10-05,6380
2409,友達,12,3,9,光和,2023-10-05,6380
5315,光聯,9,0,9,光和,2023-10-05,6380
6770,力積電,9,0,9,光和,2023-10-05,6380
8112,至上,14,5,9,光和,2023-10-05,6380
2634,漢翔,8,0,8,光和,2023-10-05,6380
5215,科嘉-KY,8,0,8,光和,2023-10-05,6380
6523,達爾膚,9,1,8,光和,2023-10-05,6380
2002,中鋼,13,5,8,光和,2023-10-05,6380
3044,健鼎,9,1,8,光和,2023-10-05,6380
2329,華泰,9,2,7,光和,2023-10-05,6380
3265,台星科,17,10,7,光和,2023-10-05,6380
2359,所羅門,7,0,7,光和,2023-10-05,6380
2412,中華電,6,0,6,光和,2023-10-05,6380
1524,耿鼎,10,4,6,光和,2023-10-05,6380
1603,華電,6,0,6,光和,2023-10-05,6380
3088,艾訊,6,0,6,光和,2023-10-05,6380
3234,光環,6,0,6,光和,2023-10-05,6380
2382,廣達,12,6,6,光和,2023-10-05,6380
00632R,元大台灣50反1,110,0,110,光和,2023-10-06,6380
2371,大同,75,0,75,光和,2023-10-06,6380
1802,台玻,60,2,58,光和,2023-10-06,6380
3481,群創,76,30,46,光和,2023-10-06,6380
8027,鈦昇,36,0,36,光和,2023-10-06,6380
1504,東元,40,10,30,光和,2023-10-06,6380
2618,長榮航,57,28,29,光和,2023-10-06,6380
00679B,元大美債20年,26,0,26,光和,2023-10-06,6380
2801,彰銀,24,0,24,光和,2023-10-06,6380
5347,世界,24,2,22,光和,2023-10-06,6380
2442,新美齊,21,0,21,光和,2023-10-06,6380
3356,奇偶,21,0,21,光和,2023-10-06,6380
00931B,統一美債20年,21,2,19,光和,2023-10-06,6380
1722,台肥,17,0,17,光和,2023-10-06,6380
6901,鑽石投資,25,8,17,光和,2023-10-06,6380
2323,中環,15,0,15,光和,2023-10-06,6380
9921,巨大,15,0,15,光和,2023-10-06,6380
2409,友達,14,0,14,光和,2023-10-06,6380
2206,三陽工業,17,4,13,光和,2023-10-06,6380
00715L,期街口布蘭特正2,13,0,13,光和,2023-10-06,6380
3338,泰碩,14,1,13,光和,2023-10-06,6380
6443,元晶,15,2,13,光和,2023-10-06,6380
2365,昆盈,14,2,12,光和,2023-10-06,6380
3081,聯亞,14,2,12,光和,2023-10-06,6380
8011,台通,11,0,11,光和,2023-10-06,6380
00706L,期元大S＆P日圓正2,10,0,10,光和,2023-10-06,6380
2312,金寶,20,10,10,光和,2023-10-06,6380
2313,華通,19,9,10,光和,2023-10-06,6380
2376,技嘉,12,2,10,光和,2023-10-06,6380
2419,仲琦,10,0,10,光和,2023-10-06,6380
2498,宏達電,10,0,10,光和,2023-10-06,6380
2812,台中銀,10,0,10,光和,2023-10-06,6380
2820,華票,10,0,10,光和,2023-10-06,6380
3163,波若威,10,0,10,光和,2023-10-06,6380
3444,利機,10,0,10,光和,2023-10-06,6380
4133,亞諾法,10,0,10,光和,2023-10-06,6380
4746,台耀,10,0,10,光和,2023-10-06,6380
4908,前鼎,11,1,10,光和,2023-10-06,6380
9105,泰金寶-DR,14,4,10,光和,2023-10-06,6380
3036,文曄,10,1,9,光和,2023-10-06,6380
00922,國泰台灣領袖50,9,0,9,光和,2023-10-06,6380
8050,廣積,8,0,8,光和,2023-10-06,6380
2617,台航,10,2,8,光和,2023-10-06,6380
3051,力特,21,13,8,光和,2023-10-06,6380
5315,光聯,8,0,8,光和,2023-10-06,6380
6531,愛普*,12,4,8,光和,2023-10-06,6380
00712,復華富時不動產,7,0,7,光和,2023-10-06,6380
1609,大亞,10,3,7,光和,2023-10-06,6380
2329,華泰,50,43,7,光和,2023-10-06,6380
5475,德宏,7,0,7,光和,2023-10-06,6380
3231,緯創,142,31,111,光和,2023-10-11,6380
3706,神達,89,27,62,光和,2023-10-11,6380
00632R,元大台灣50反1,61,0,61,光和,2023-10-11,6380
3481,群創,77,22,55,光和,2023-10-11,6380
2323,中環,56,2,54,光和,2023-10-11,6380
2312,金寶,81,30,51,光和,2023-10-11,6380
8936,國統,52,1,51,光和,2023-10-11,6380
6244,茂迪,100,50,50,光和,2023-10-11,6380
2801,彰銀,50,3,47,光和,2023-10-11,6380
3013,晟銘電,52,7,45,光和,2023-10-11,6380
2609,陽明,31,2,29,光和,2023-10-11,6380
8222,寶一,33,6,27,光和,2023-10-11,6380
2382,廣達,45,19,26,光和,2023-10-11,6380
1609,大亞,35,9,26,光和,2023-10-11,6380
6275,元山,25,1,24,光和,2023-10-11,6380
2603,長榮,33,11,22,光和,2023-10-11,6380
2618,長榮航,42,20,22,光和,2023-10-11,6380
8011,台通,22,0,22,光和,2023-10-11,6380
2634,漢翔,30,9,21,光和,2023-10-11,6380
00637L,元大滬深300正2,20,0,20,光和,2023-10-11,6380
2020,美亞,20,0,20,光和,2023-10-11,6380
2608,嘉里大榮,20,0,20,光和,2023-10-11,6380
6443,元晶,40,20,20,光和,2023-10-11,6380
9934,成霖,20,0,20,光和,2023-10-11,6380
2376,技嘉,27,8,19,光和,2023-10-11,6380
1449,佳和,18,0,18,光和,2023-10-11,6380
2025,千興,20,2,18,光和,2023-10-11,6380
2353,宏��,16,0,16,光和,2023-10-11,6380
00919,群益台灣精選高息,17,2,15,光和,2023-10-11,6380
1304,台聚,15,0,15,光和,2023-10-11,6380
00922,國泰台灣領袖50,15,0,15,光和,2023-10-11,6380
1471,首利,15,0,15,光和,2023-10-11,6380
2317,鴻海,21,6,15,光和,2023-10-11,6380
4542,科嶠,15,0,15,光和,2023-10-11,6380
2201,裕隆,17,3,14,光和,2023-10-11,6380
2444,兆勁,14,0,14,光和,2023-10-11,6380
2355,敬鵬,15,2,13,光和,2023-10-11,6380
6202,盛群,13,0,13,光和,2023-10-11,6380
0056,元大高股息,21,9,12,光和,2023-10-11,6380
2498,宏達電,14,2,12,光和,2023-10-11,6380
3094,聯傑,12,0,12,光和,2023-10-11,6380
6016,康和證,12,0,12,光和,2023-10-11,6380
2606,裕民,11,0,11,光和,2023-10-11,6380
3694,海華,11,0,11,光和,2023-10-11,6380
8027,鈦昇,12,1,11,光和,2023-10-11,6380
8210,勤誠,11,0,11,光和,2023-10-11,6380
00900,富邦特選高股息30,10,0,10,光和,2023-10-11,6380
00715L,期街口布蘭特正2,11,1,10,光和,2023-10-11,6380
2636,台驊控股,12,2,10,光和,2023-10-11,6380
3163,波若威,15,5,10,光和,2023-10-11,6380
2888,新光金,208,50,158,光和,2023-10-12,6380
00632R,元大台灣50反1,121,0,121,光和,2023-10-12,6380
2614,東森,40,0,40,光和,2023-10-12,6380
3481,群創,38,2,36,光和,2023-10-12,6380
1605,華新,37,9,28,光和,2023-10-12,6380
3207,耀勝,24,0,24,光和,2023-10-12,6380
2867,三商壽,20,0,20,光和,2023-10-12,6380
00706L,期元大S＆P日圓正2,20,0,20,光和,2023-10-12,6380
2352,佳世達,19,0,19,光和,2023-10-12,6380
2382,廣達,23,5,18,光和,2023-10-12,6380
6257,矽格,18,1,17,光和,2023-10-12,6380
00722B,群益投資級電信債,16,0,16,光和,2023-10-12,6380
2608,嘉里大榮,16,0,16,光和,2023-10-12,6380
4763,材料-KY,15,0,15,光和,2023-10-12,6380
6142,友勁,15,0,15,光和,2023-10-12,6380
2329,華泰,32,18,14,光和,2023-10-12,6380
2834,臺企銀,13,0,13,光和,2023-10-12,6380
00720B,元大投資級公司債,13,0,13,光和,2023-10-12,6380
4714,永捷,16,3,13,光和,2023-10-12,6380
3088,艾訊,12,0,12,光和,2023-10-12,6380
1522,堤維西,15,4,11,光和,2023-10-12,6380
5381,合正,16,5,11,光和,2023-10-12,6380
6005,群益證,11,0,11,光和,2023-10-12,6380
2313,華通,17,6,11,光和,2023-10-12,6380
1612,宏泰,10,0,10,光和,2023-10-12,6380
2359,所羅門,10,0,10,光和,2023-10-12,6380
2883B,凱基金乙特,10,0,10,光和,2023-10-12,6380
3583,辛耘,11,1,10,光和,2023-10-12,6380
6282,康舒,14,4,10,光和,2023-10-12,6380
8033,雷虎,11,1,10,光和,2023-10-12,6380
9921,巨大,10,0,10,光和,2023-10-12,6380
00642U,期元大S＆P石油,9,0,9,光和,2023-10-12,6380
1449,佳和,9,0,9,光和,2023-10-12,6380
1718,中纖,12,3,9,光和,2023-10-12,6380
2025,千興,10,1,9,光和,2023-10-12,6380
4566,時碩工業,9,0,9,光和,2023-10-12,6380
5321,美而快,8,0,8,光和,2023-10-12,6380
3032,偉訓,8,0,8,光和,2023-10-12,6380
2409,友達,8,1,7,光和,2023-10-12,6380
2449,京元電子,7,0,7,光和,2023-10-12,6380
2317,鴻海,11,4,7,光和,2023-10-12,6380
2498,宏達電,7,0,7,光和,2023-10-12,6380
3025,星通,13,6,7,光和,2023-10-12,6380
3037,欣興,7,0,7,光和,2023-10-12,6380
6148,驊宏資,7,0,7,光和,2023-10-12,6380
6153,嘉聯益,7,0,7,光和,2023-10-12,6380
8046,南電,7,0,7,光和,2023-10-12,6380
00772B,中信高評級公司債,6,0,6,光和,2023-10-12,6380
4564,元翎,6,0,6,光和,2023-10-12,6380
2885,元大金,7,1,6,光和,2023-10-12,6380
00919,群益台灣精選高息,65,0,65,光和,2023-10-13,6380
2888,新光金,52,3,49,光和,2023-10-13,6380
3231,緯創,75,27,48,光和,2023-10-13,6380
00712,復華富時不動產,54,10,44,光和,2023-10-13,6380
2382,廣達,52,11,41,光和,2023-10-13,6380
00931B,統一美債20年,36,0,36,光和,2023-10-13,6380
00929,復華台灣科技優息,37,7,30,光和,2023-10-13,6380
2812,台中銀,30,0,30,光和,2023-10-13,6380
8011,台通,30,0,30,光和,2023-10-13,6380
9934,成霖,30,0,30,光和,2023-10-13,6380
2323,中環,25,0,25,光和,2023-10-13,6380
2353,宏��,24,1,23,光和,2023-10-13,6380
6770,力積電,23,2,21,光和,2023-10-13,6380
00706L,期元大S＆P日圓正2,20,0,20,光和,2023-10-13,6380
00878,國泰永續高股息,32,12,20,光和,2023-10-13,6380
3325,旭品,45,26,19,光和,2023-10-13,6380
00637L,元大滬深300正2,17,0,17,光和,2023-10-13,6380
2498,宏達電,16,0,16,光和,2023-10-13,6380
00673R,期元大S＆P原油反1,15,0,15,光和,2023-10-13,6380
2002,中鋼,15,1,14,光和,2023-10-13,6380
1717,長興,13,0,13,光和,2023-10-13,6380
2618,長榮航,13,1,12,光和,2023-10-13,6380
2883,凱基金,16,4,12,光和,2023-10-13,6380
5381,合正,19,7,12,光和,2023-10-13,6380
2301,光寶科,13,1,12,光和,2023-10-13,6380
2376,技嘉,20,9,11,光和,2023-10-13,6380
2208,台船,11,0,11,光和,2023-10-13,6380
2329,華泰,44,33,11,光和,2023-10-13,6380
3032,偉訓,13,2,11,光和,2023-10-13,6380
3202,樺晟,10,0,10,光和,2023-10-13,6380
3583,辛耘,10,0,10,光和,2023-10-13,6380
5608,四維航,10,0,10,光和,2023-10-13,6380
2303,聯電,16,6,10,光和,2023-10-13,6380
2426,鼎元,12,3,9,光和,2023-10-13,6380
2610,華航,15,6,9,光和,2023-10-13,6380
2615,萬海,9,0,9,光和,2023-10-13,6380
2886,兆豐金,10,1,9,光和,2023-10-13,6380
8936,國統,10,1,9,光和,2023-10-13,6380
00857B,永豐20年美公債,8,0,8,光和,2023-10-13,6380
0056,元大高股息,7,0,7,光和,2023-10-13,6380
2358,廷鑫,7,0,7,光和,2023-10-13,6380
2453,凌群,7,0,7,光和,2023-10-13,6380
4906,正文,8,1,7,光和,2023-10-13,6380
6577,勁豐,7,0,7,光和,2023-10-13,6380
1513,中興電,7,0,7,光和,2023-10-13,6380
1319,東陽,9,2,7,光和,2023-10-13,6380
2609,陽明,7,1,6,光和,2023-10-13,6380
00642U,期元大S＆P石油,6,0,6,光和,2023-10-13,6380
1909,榮成,10,4,6,光和,2023-10-13,6380
3025,星通,11,5,6,光和,2023-10-13,6380
2323,中環,375,19,356,光和,2023-10-16,6380
2002,中鋼,256,0,256,光和,2023-10-16,6380
2888,新光金,112,0,112,光和,2023-10-16,6380
2344,華邦電,106,10,96,光和,2023-10-16,6380
2618,長榮航,74,0,74,光和,2023-10-16,6380
0056,元大高股息,78,17,61,光和,2023-10-16,6380
1605,華新,61,4,57,光和,2023-10-16,6380
00929,復華台灣科技優息,85,30,55,光和,2023-10-16,6380
3706,神達,60,16,44,光和,2023-10-16,6380
2515,中工,85,47,38,光和,2023-10-16,6380
00712,復華富時不動產,35,0,35,光和,2023-10-16,6380
00902,中信電池及儲能,32,0,32,光和,2023-10-16,6380
2812,台中銀,30,0,30,光和,2023-10-16,6380
5347,世界,30,0,30,光和,2023-10-16,6380
2610,華航,24,3,21,光和,2023-10-16,6380
00932,兆豐永續高息等權,20,0,20,光和,2023-10-16,6380
3083,網龍,20,1,19,光和,2023-10-16,6380
1905,華紙,45,27,18,光和,2023-10-16,6380
1616,億泰,17,0,17,光和,2023-10-16,6380
8011,台通,17,0,17,光和,2023-10-16,6380
8936,國統,19,2,17,光和,2023-10-16,6380
00919,群益台灣精選高息,18,2,16,光和,2023-10-16,6380
2371,大同,19,3,16,光和,2023-10-16,6380
6282,康舒,17,1,16,光和,2023-10-16,6380
3036,文曄,16,1,15,光和,2023-10-16,6380
2349,錸德,14,0,14,光和,2023-10-16,6380
3265,台星科,14,0,14,光和,2023-10-16,6380
3234,光環,14,1,13,光和,2023-10-16,6380
2105,正新,13,1,12,光和,2023-10-16,6380
2609,陽明,12,0,12,光和,2023-10-16,6380
9958,世紀鋼,12,0,12,光和,2023-10-16,6380
2201,裕隆,13,2,11,光和,2023-10-16,6380
3694,海華,11,0,11,光和,2023-10-16,6380
3450,聯鈞,11,1,10,光和,2023-10-16,6380
2880,華南金,10,0,10,光和,2023-10-16,6380
6126,信音,10,0,10,光和,2023-10-16,6380
9950,萬國通,10,0,10,光和,2023-10-16,6380
00922,國泰台灣領袖50,11,2,9,光和,2023-10-16,6380
2206,三陽工業,9,0,9,光和,2023-10-16,6380
2453,凌群,9,0,9,光和,2023-10-16,6380
2337,旺宏,62,54,8,光和,2023-10-16,6380
2340,台亞,9,1,8,光和,2023-10-16,6380
3481,群創,7,0,7,光和,2023-10-16,6380
3521,鴻翊,7,0,7,光和,2023-10-16,6380
9907,統一實,7,0,7,光和,2023-10-16,6380
1101,台泥,10,4,6,光和,2023-10-16,6380
00720B,元大投資級公司債,6,0,6,光和,2023-10-16,6380
2332,友訊,7,1,6,光和,2023-10-16,6380
2419,仲琦,6,0,6,光和,2023-10-16,6380
6120,達運,9,3,6,光和,2023-10-16,6380
1609,大亞,159,1,158,光和,2023-10-17,6380
00680L,元大美債20正2,100,0,100,光和,2023-10-17,6380
3234,光環,75,0,75,光和,2023-10-17,6380
1605,華新,69,2,67,光和,2023-10-17,6380
2002,中鋼,70,3,67,光和,2023-10-17,6380
00740B,富邦全球投等債,65,0,65,光和,2023-10-17,6380
00696B,富邦美債20年,55,0,55,光和,2023-10-17,6380
3481,群創,64,14,50,光和,2023-10-17,6380
3583,辛耘,53,3,50,光和,2023-10-17,6380
2618,長榮航,111,62,49,光和,2023-10-17,6380
3231,緯創,76,32,44,光和,2023-10-17,6380
2201,裕隆,35,0,35,光和,2023-10-17,6380
2323,中環,33,0,33,光和,2023-10-17,6380
2801,彰銀,23,0,23,光和,2023-10-17,6380
2425,承啟,26,6,20,光和,2023-10-17,6380
2880,華南金,20,0,20,光和,2023-10-17,6380
0056,元大高股息,17,0,17,光和,2023-10-17,6380
00720B,元大投資級公司債,17,0,17,光和,2023-10-17,6380
1101,台泥,16,0,16,光和,2023-10-17,6380
00687B,國泰20年美債,15,0,15,光和,2023-10-17,6380
2608,嘉里大榮,15,0,15,光和,2023-10-17,6380
3083,網龍,15,0,15,光和,2023-10-17,6380
5521,工信,14,1,13,光和,2023-10-17,6380
00919,群益台灣精選高息,21,8,13,光和,2023-10-17,6380
2603,長榮,13,0,13,光和,2023-10-17,6380
3032,偉訓,15,2,13,光和,2023-10-17,6380
6120,達運,13,0,13,光和,2023-10-17,6380
00715L,期街口布蘭特正2,12,1,11,光和,2023-10-17,6380
6016,康和證,11,0,11,光和,2023-10-17,6380
2337,旺宏,76,66,10,光和,2023-10-17,6380
3049,精金,10,0,10,光和,2023-10-17,6380
3363,上詮,13,3,10,光和,2023-10-17,6380
3686,達能,10,0,10,光和,2023-10-17,6380
6237,驊訊,14,4,10,光和,2023-10-17,6380
6418,詠昇,10,0,10,光和,2023-10-17,6380
8088,品安,14,4,10,光和,2023-10-17,6380
9933,中鼎,10,0,10,光和,2023-10-17,6380
9934,成霖,10,0,10,光和,2023-10-17,6380
4207,環泰,10,1,9,光和,2023-10-17,6380
5608,四維航,9,0,9,光和,2023-10-17,6380
00878,國泰永續高股息,14,5,9,光和,2023-10-17,6380
1802,台玻,8,0,8,光和,2023-10-17,6380
2401,凌陽,9,1,8,光和,2023-10-17,6380
8048,德勝,20,12,8,光和,2023-10-17,6380
2105,正新,8,0,8,光和,2023-10-17,6380
2352,佳世達,7,0,7,光和,2023-10-17,6380
2382,廣達,13,6,7,光和,2023-10-17,6380
2891,中信金,10,3,7,光和,2023-10-17,6380
2356,英業達,16,9,7,光和,2023-10-17,6380
3036,文曄,8,1,7,光和,2023-10-17,6380
0056,元大高股息,210,0,210,光和,2023-10-18,6380
2337,旺宏,141,11,130,光和,2023-10-18,6380
00929,復華台灣科技優息,126,3,123,光和,2023-10-18,6380
00715L,期街口布蘭特正2,100,8,92,光和,2023-10-18,6380
2323,中環,92,1,91,光和,2023-10-18,6380
00932,兆豐永續高息等權,82,0,82,光和,2023-10-18,6380
00878,國泰永續高股息,78,18,60,光和,2023-10-18,6380
2883,凱基金,71,12,59,光和,2023-10-18,6380
1101,台泥,60,6,54,光和,2023-10-18,6380
2371,大同,48,2,46,光和,2023-10-18,6380
00919,群益台灣精選高息,46,0,46,光和,2023-10-18,6380
1102,亞泥,43,0,43,光和,2023-10-18,6380
2344,華邦電,38,2,36,光和,2023-10-18,6380
1815,富喬,52,18,34,光和,2023-10-18,6380
3706,神達,51,18,33,光和,2023-10-18,6380
6168,宏齊,49,19,30,光和,2023-10-18,6380
2312,金寶,52,25,27,光和,2023-10-18,6380
00922,國泰台灣領袖50,24,0,24,光和,2023-10-18,6380
1504,東元,23,0,23,光和,2023-10-18,6380
5347,世界,23,0,23,光和,2023-10-18,6380
00720B,元大投資級公司債,22,0,22,光和,2023-10-18,6380
00637L,元大滬深300正2,21,0,21,光和,2023-10-18,6380
2317,鴻海,26,5,21,光和,2023-10-18,6380
2353,宏��,24,3,21,光和,2023-10-18,6380
2201,裕隆,21,1,20,光和,2023-10-18,6380
2618,長榮航,25,5,20,光和,2023-10-18,6380
1584,精剛,21,1,20,光和,2023-10-18,6380
2889,國票金,20,0,20,光和,2023-10-18,6380
00864B,中信美國公債0-1,18,0,18,光和,2023-10-18,6380
2002,中鋼,22,6,16,光和,2023-10-18,6380
00673R,期元大S＆P原油反1,16,0,16,光和,2023-10-18,6380
2363,矽統,51,36,15,光和,2023-10-18,6380
1710,東聯,15,0,15,光和,2023-10-18,6380
6823,濾能,15,0,15,光和,2023-10-18,6380
2374,佳能,14,0,14,光和,2023-10-18,6380
2425,承啟,13,0,13,光和,2023-10-18,6380
1304,台聚,18,6,12,光和,2023-10-18,6380
3032,偉訓,14,2,12,光和,2023-10-18,6380
3338,泰碩,13,1,12,光和,2023-10-18,6380
3432,台端,12,0,12,光和,2023-10-18,6380
6233,旺玖,12,0,12,光和,2023-10-18,6380
00712,復華富時不動產,11,0,11,光和,2023-10-18,6380
1802,台玻,11,0,11,光和,2023-10-18,6380
3047,訊舟,11,0,11,光和,2023-10-18,6380
6237,驊訊,14,3,11,光和,2023-10-18,6380
9928,中視,11,0,11,光和,2023-10-18,6380
2634,漢翔,37,27,10,光和,2023-10-18,6380
00696B,富邦美債20年,10,0,10,光和,2023-10-18,6380
1717,長興,10,0,10,光和,2023-10-18,6380
6120,達運,11,1,10,光和,2023-10-18,6380
0056,元大高股息,83,2,81,光和,2023-10-19,6380
1101,台泥,79,7,72,光和,2023-10-19,6380
2002,中鋼,63,1,62,光和,2023-10-19,6380
00637L,元大滬深300正2,165,110,55,光和,2023-10-19,6380
2880,華南金,51,2,49,光和,2023-10-19,6380
2816,旺旺保,51,3,48,光和,2023-10-19,6380
00665L,富邦�琤肭磪囓�2,45,0,45,光和,2023-10-19,6380
00712,復華富時不動產,34,0,34,光和,2023-10-19,6380
8210,勤誠,33,1,32,光和,2023-10-19,6380
00933B,國泰10Y+金融債,31,0,31,光和,2023-10-19,6380
2801,彰銀,31,0,31,光和,2023-10-19,6380
2883,凱基金,28,0,28,光和,2023-10-19,6380
00929,復華台灣科技優息,40,13,27,光和,2023-10-19,6380
00679B,元大美債20年,25,0,25,光和,2023-10-19,6380
2409,友達,28,5,23,光和,2023-10-19,6380
00753L,中信中國50正2,21,0,21,光和,2023-10-19,6380
2317,鴻海,20,0,20,光和,2023-10-19,6380
00648R,元大S＆P500反1,20,0,20,光和,2023-10-19,6380
1609,大亞,21,2,19,光和,2023-10-19,6380
1802,台玻,17,0,17,光和,2023-10-19,6380
6237,驊訊,19,3,16,光和,2023-10-19,6380
00912,中信臺灣智慧50,15,0,15,光和,2023-10-19,6380
00902,中信電池及儲能,15,0,15,光和,2023-10-19,6380
5880,合庫金,14,0,14,光和,2023-10-19,6380
00751B,元大AAA至A公司債,14,0,14,光和,2023-10-19,6380
00673R,期元大S＆P原油反1,14,0,14,光和,2023-10-19,6380
2201,裕隆,15,1,14,光和,2023-10-19,6380
2402,毅嘉,13,0,13,光和,2023-10-19,6380
3041,揚智,29,16,13,光和,2023-10-19,6380
3481,群創,57,45,12,光和,2023-10-19,6380
1795,美時,13,1,12,光和,2023-10-19,6380
00885,富邦越南,11,0,11,光和,2023-10-19,6380
1409,新纖,11,0,11,光和,2023-10-19,6380
3056,富華新,11,0,11,光和,2023-10-19,6380
3234,光環,11,0,11,光和,2023-10-19,6380
5381,合正,11,0,11,光和,2023-10-19,6380
6233,旺玖,18,7,11,光和,2023-10-19,6380
00720B,元大投資級公司債,10,0,10,光和,2023-10-19,6380
1217,愛之味,10,0,10,光和,2023-10-19,6380
00922,國泰台灣領袖50,10,0,10,光和,2023-10-19,6380
00696B,富邦美債20年,10,0,10,光和,2023-10-19,6380
1710,東聯,15,5,10,光和,2023-10-19,6380
5534,長虹,10,0,10,光和,2023-10-19,6380
00900,富邦特選高股息30,11,2,9,光和,2023-10-19,6380
00772B,中信高評級公司債,9,0,9,光和,2023-10-19,6380
2356,英業達,11,2,9,光和,2023-10-19,6380
4934,太極,9,0,9,光和,2023-10-19,6380
2353,宏��,8,0,8,光和,2023-10-19,6380
00931B,統一美債20年,8,0,8,光和,2023-10-19,6380
2891,中信金,7,0,7,光和,2023-10-19,6380
00933B,國泰10Y+金融債,76,0,76,光和,2023-10-20,6380
8131,福懋科,50,0,50,光和,2023-10-20,6380
00687B,國泰20年美債,43,0,43,光和,2023-10-20,6380
00679B,元大美債20年,40,0,40,光和,2023-10-20,6380
1710,東聯,36,0,36,光和,2023-10-20,6380
00637L,元大滬深300正2,30,0,30,光和,2023-10-20,6380
1101,台泥,29,4,25,光和,2023-10-20,6380
00878,國泰永續高股息,34,9,25,光和,2023-10-20,6380
1605,華新,57,33,24,光和,2023-10-20,6380
1909,榮成,22,0,22,光和,2023-10-20,6380
00648R,元大S＆P500反1,20,0,20,光和,2023-10-20,6380
00665L,富邦�琤肭磪囓�2,20,0,20,光和,2023-10-20,6380
1810,和成,20,0,20,光和,2023-10-20,6380
2371,大同,22,2,20,光和,2023-10-20,6380
4960,誠美材,18,0,18,光和,2023-10-20,6380
1303,南亞,16,0,16,光和,2023-10-20,6380
3122,笙泉,24,8,16,光和,2023-10-20,6380
1701,中化,15,0,15,光和,2023-10-20,6380
1513,中興電,16,3,13,光和,2023-10-20,6380
0056,元大高股息,18,5,13,光和,2023-10-20,6380
2369,菱生,37,24,13,光和,2023-10-20,6380
00922,國泰台灣領袖50,12,0,12,光和,2023-10-20,6380
2883,凱基金,13,1,12,光和,2023-10-20,6380
2892,第一金,12,0,12,光和,2023-10-20,6380
6235,華孚,13,1,12,光和,2023-10-20,6380
6288,聯嘉,13,1,12,光和,2023-10-20,6380
00753L,中信中國50正2,12,0,12,光和,2023-10-20,6380
00919,群益台灣精選高息,11,0,11,光和,2023-10-20,6380
00673R,期元大S＆P原油反1,11,0,11,光和,2023-10-20,6380
00885,富邦越南,11,0,11,光和,2023-10-20,6380
00882,中信中國高股息,11,0,11,光和,2023-10-20,6380
00720B,元大投資級公司債,11,0,11,光和,2023-10-20,6380
4927,泰鼎-KY,11,0,11,光和,2023-10-20,6380
9955,佳龍,20,9,11,光和,2023-10-20,6380
1815,富喬,15,5,10,光和,2023-10-20,6380
2497,怡利電,10,0,10,光和,2023-10-20,6380
3049,精金,10,0,10,光和,2023-10-20,6380
3202,樺晟,10,0,10,光和,2023-10-20,6380
4401,東隆興,10,0,10,光和,2023-10-20,6380
4908,前鼎,13,3,10,光和,2023-10-20,6380
1532,勤美,9,0,9,光和,2023-10-20,6380
2880,華南金,19,10,9,光和,2023-10-20,6380
3481,群創,27,18,9,光和,2023-10-20,6380
1304,台聚,8,0,8,光和,2023-10-20,6380
2201,裕隆,14,6,8,光和,2023-10-20,6380
4162,智擎,13,5,8,光和,2023-10-20,6380
2344,華邦電,10,2,8,光和,2023-10-20,6380
6282,康舒,14,6,8,光和,2023-10-20,6380
2891,中信金,8,1,7,光和,2023-10-20,6380
2317,鴻海,9,2,7,光和,2023-10-20,6380
00929,復華台灣科技優息,156,0,156,光和,2023-10-23,6380
00712,復華富時不動產,86,0,86,光和,2023-10-23,6380
2317,鴻海,82,5,77,光和,2023-10-23,6380
2402,毅嘉,68,4,64,光和,2023-10-23,6380
00933B,國泰10Y+金融債,58,0,58,光和,2023-10-23,6380
3481,群創,61,17,44,光和,2023-10-23,6380
2801,彰銀,37,0,37,光和,2023-10-23,6380
00679B,元大美債20年,41,5,36,光和,2023-10-23,6380
3234,光環,32,0,32,光和,2023-10-23,6380
6770,力積電,32,1,31,光和,2023-10-23,6380
3044,健鼎,28,0,28,光和,2023-10-23,6380
2881,富邦金,27,0,27,光和,2023-10-23,6380
3715,定穎投控,38,11,27,光和,2023-10-23,6380
2888,新光金,27,1,26,光和,2023-10-23,6380
00878,國泰永續高股息,25,0,25,光和,2023-10-23,6380
0056,元大高股息,24,2,22,光和,2023-10-23,6380
2606,裕民,21,0,21,光和,2023-10-23,6380
5452,佶優,21,0,21,光和,2023-10-23,6380
6443,元晶,21,0,21,光和,2023-10-23,6380
00648R,元大S＆P500反1,20,0,20,光和,2023-10-23,6380
2614,東森,20,0,20,光和,2023-10-23,6380
5347,世界,20,0,20,光和,2023-10-23,6380
2409,友達,30,10,20,光和,2023-10-23,6380
2883,凱基金,18,1,17,光和,2023-10-23,6380
1301,台塑,15,0,15,光和,2023-10-23,6380
2913,農林,15,0,15,光和,2023-10-23,6380
00720B,元大投資級公司債,14,0,14,光和,2023-10-23,6380
00772B,中信高評級公司債,13,0,13,光和,2023-10-23,6380
3051,力特,19,6,13,光和,2023-10-23,6380
2034,允強,13,1,12,光和,2023-10-23,6380
2303,聯電,29,17,12,光和,2023-10-23,6380
2834,臺企銀,11,0,11,光和,2023-10-23,6380
1101,台泥,10,0,10,光和,2023-10-23,6380
00922,國泰台灣領袖50,10,0,10,光和,2023-10-23,6380
2108,南帝,10,0,10,光和,2023-10-23,6380
2376,技嘉,15,5,10,光和,2023-10-23,6380
2867,三商壽,10,0,10,光和,2023-10-23,6380
2880,華南金,10,0,10,光和,2023-10-23,6380
3163,波若威,16,6,10,光和,2023-10-23,6380
4915,致伸,10,0,10,光和,2023-10-23,6380
6116,彩晶,10,0,10,光和,2023-10-23,6380
6214,精誠,10,0,10,光和,2023-10-23,6380
6901,鑽石投資,18,8,10,光和,2023-10-23,6380
8933,愛地雅,10,0,10,光和,2023-10-23,6380
6531,愛普*,10,1,9,光和,2023-10-23,6380
2323,中環,8,0,8,光和,2023-10-23,6380
2891,中信金,8,0,8,光和,2023-10-23,6380
8016,矽創,8,0,8,光和,2023-10-23,6380
2382,廣達,23,16,7,光和,2023-10-23,6380
1815,富喬,7,0,7,光和,2023-10-23,6380
00712,復華富時不動產,82,0,82,光和,2023-10-24,6380
2369,菱生,119,39,80,光和,2023-10-24,6380
2317,鴻海,74,18,56,光和,2023-10-24,6380
00929,復華台灣科技優息,58,3,55,光和,2023-10-24,6380
00897,富邦基因免疫生技,50,0,50,光和,2023-10-24,6380
8088,品安,36,1,35,光和,2023-10-24,6380
1101,台泥,35,0,35,光和,2023-10-24,6380
00878,國泰永續高股息,34,0,34,光和,2023-10-24,6380
2888,新光金,52,21,31,光和,2023-10-24,6380
2337,旺宏,55,28,27,光和,2023-10-24,6380
1909,榮成,22,0,22,光和,2023-10-24,6380
2002,中鋼,23,3,20,光和,2023-10-24,6380
2323,中環,20,0,20,光和,2023-10-24,6380
2201,裕隆,20,0,20,光和,2023-10-24,6380
6901,鑽石投資,20,0,20,光和,2023-10-24,6380
00919,群益台灣精選高息,18,0,18,光和,2023-10-24,6380
00637L,元大滬深300正2,28,10,18,光和,2023-10-24,6380
2883,凱基金,18,0,18,光和,2023-10-24,6380
3234,光環,17,0,17,光和,2023-10-24,6380
2834,臺企銀,16,0,16,光和,2023-10-24,6380
8054,安國,17,2,15,光和,2023-10-24,6380
2618,長榮航,21,8,13,光和,2023-10-24,6380
6150,撼訊,12,0,12,光和,2023-10-24,6380
6237,驊訊,14,3,11,光和,2023-10-24,6380
00687B,國泰20年美債,11,1,10,光和,2023-10-24,6380
00900,富邦特選高股息30,10,0,10,光和,2023-10-24,6380
1815,富喬,17,7,10,光和,2023-10-24,6380
2371,大同,16,6,10,光和,2023-10-24,6380
3287,廣寰科,10,0,10,光和,2023-10-24,6380
5347,世界,10,0,10,光和,2023-10-24,6380
3062,建漢,10,1,9,光和,2023-10-24,6380
3576,聯合再生,10,1,9,光和,2023-10-24,6380
6168,宏齊,13,4,9,光和,2023-10-24,6380
6443,元晶,11,2,9,光和,2023-10-24,6380
1301,台塑,8,0,8,光和,2023-10-24,6380
3032,偉訓,10,2,8,光和,2023-10-24,6380
6139,亞翔,15,7,8,光和,2023-10-24,6380
2489,瑞軒,8,0,8,光和,2023-10-24,6380
2468,華經,10,3,7,光和,2023-10-24,6380
4755,三福化,8,1,7,光和,2023-10-24,6380
1905,華紙,6,0,6,光和,2023-10-24,6380
4977,眾達-KY,6,0,6,光和,2023-10-24,6380
3260,威剛,6,0,6,光和,2023-10-24,6380
00669R,國泰美國道瓊反1,5,0,5,光和,2023-10-24,6380
3308,聯德,5,0,5,光和,2023-10-24,6380
5315,光聯,5,0,5,光和,2023-10-24,6380
6438,迅得,5,0,5,光和,2023-10-24,6380
8171,天宇,5,0,5,光和,2023-10-24,6380
6274,台燿,8,3,5,光和,2023-10-24,6380
2892,第一金,4,0,4,光和,2023-10-24,6380
2337,旺宏,393,23,370,光和,2023-10-25,6380
00919,群益台灣精選高息,111,0,111,光和,2023-10-25,6380
00632R,元大台灣50反1,85,10,75,光和,2023-10-25,6380
00929,復華台灣科技優息,59,2,57,光和,2023-10-25,6380
00712,復華富時不動產,54,0,54,光和,2023-10-25,6380
2882,國泰金,40,3,37,光和,2023-10-25,6380
2801,彰銀,30,0,30,光和,2023-10-25,6380
2332,友訊,24,0,24,光和,2023-10-25,6380
3481,群創,100,76,24,光和,2023-10-25,6380
3025,星通,25,3,22,光和,2023-10-25,6380
0056,元大高股息,23,2,21,光和,2023-10-25,6380
3325,旭品,41,20,21,光和,2023-10-25,6380
2913,農林,20,0,20,光和,2023-10-25,6380
4960,誠美材,20,0,20,光和,2023-10-25,6380
1522,堤維西,21,2,19,光和,2023-10-25,6380
00687B,國泰20年美債,19,0,19,光和,2023-10-25,6380
2460,建通,27,8,19,光和,2023-10-25,6380
2891,中信金,20,1,19,光和,2023-10-25,6380
00878,國泰永續高股息,33,15,18,光和,2023-10-25,6380
2883,凱基金,18,0,18,光和,2023-10-25,6380
00713,元大台灣高息低波,15,0,15,光和,2023-10-25,6380
1217,愛之味,15,0,15,光和,2023-10-25,6380
2425,承啟,40,25,15,光和,2023-10-25,6380
3078,僑威,17,2,15,光和,2023-10-25,6380
3189,景碩,17,2,15,光和,2023-10-25,6380
4536,拓凱,15,0,15,光和,2023-10-25,6380
2371,大同,23,9,14,光和,2023-10-25,6380
2834,臺企銀,14,0,14,光和,2023-10-25,6380
1612,宏泰,13,0,13,光和,2023-10-25,6380
2344,華邦電,12,0,12,光和,2023-10-25,6380
2402,毅嘉,24,12,12,光和,2023-10-25,6380
5880,合庫金,12,0,12,光和,2023-10-25,6380
6185,幃翔,12,0,12,光和,2023-10-25,6380
2317,鴻海,36,25,11,光和,2023-10-25,6380
1101,台泥,11,0,11,光和,2023-10-25,6380
2887,台新金,11,0,11,光和,2023-10-25,6380
4716,大立,11,0,11,光和,2023-10-25,6380
6443,元晶,10,0,10,光和,2023-10-25,6380
1316,上曜,10,0,10,光和,2023-10-25,6380
2888,新光金,15,5,10,光和,2023-10-25,6380
2905,三商,10,0,10,光和,2023-10-25,6380
6176,瑞儀,12,2,10,光和,2023-10-25,6380
6244,茂迪,10,0,10,光和,2023-10-25,6380
9955,佳龍,10,0,10,光和,2023-10-25,6380
2382,廣達,18,8,10,光和,2023-10-25,6380
00902,中信電池及儲能,8,0,8,光和,2023-10-25,6380
2351,順德,9,1,8,光和,2023-10-25,6380
2356,英業達,11,3,8,光和,2023-10-25,6380
3234,光環,8,0,8,光和,2023-10-25,6380
1609,大亞,8,1,7,光和,2023-10-25,6380
00885,富邦越南,357,0,357,光和,2023-10-26,6380
00929,復華台灣科技優息,114,0,114,光和,2023-10-26,6380
00712,復華富時不動產,82,0,82,光和,2023-10-26,6380
2317,鴻海,64,2,62,光和,2023-10-26,6380
00679B,元大美債20年,57,1,56,光和,2023-10-26,6380
8936,國統,56,7,49,光和,2023-10-26,6380
0056,元大高股息,49,0,49,光和,2023-10-26,6380
00919,群益台灣精選高息,46,0,46,光和,2023-10-26,6380
2816,旺旺保,46,0,46,光和,2023-10-26,6380
2303,聯電,47,2,45,光和,2023-10-26,6380
00922,國泰台灣領袖50,41,0,41,光和,2023-10-26,6380
00927,群益半導體收益,40,0,40,光和,2023-10-26,6380
00878,國泰永續高股息,46,10,36,光和,2023-10-26,6380
2344,華邦電,34,2,32,光和,2023-10-26,6380
2485,兆赫,28,0,28,光和,2023-10-26,6380
2883,凱基金,27,0,27,光和,2023-10-26,6380
1101,台泥,39,14,25,光和,2023-10-26,6380
5347,世界,25,0,25,光和,2023-10-26,6380
2888,新光金,24,0,24,光和,2023-10-26,6380
00687B,國泰20年美債,22,0,22,光和,2023-10-26,6380
2408,南亞科,22,0,22,光和,2023-10-26,6380
00902,中信電池及儲能,21,0,21,光和,2023-10-26,6380
00680L,元大美債20正2,20,0,20,光和,2023-10-26,6380
2371,大同,23,3,20,光和,2023-10-26,6380
2353,宏��,21,2,19,光和,2023-10-26,6380
2867,三商壽,20,3,17,光和,2023-10-26,6380
2801,彰銀,16,0,16,光和,2023-10-26,6380
6443,元晶,16,0,16,光和,2023-10-26,6380
2886,兆豐金,15,0,15,光和,2023-10-26,6380
2618,長榮航,19,4,15,光和,2023-10-26,6380
00931B,統一美債20年,15,0,15,光和,2023-10-26,6380
2402,毅嘉,14,0,14,光和,2023-10-26,6380
2633,台灣高鐵,14,0,14,光和,2023-10-26,6380
5880,合庫金,13,0,13,光和,2023-10-26,6380
2356,英業達,18,6,12,光和,2023-10-26,6380
2606,裕民,13,1,12,光和,2023-10-26,6380
2337,旺宏,21,10,11,光和,2023-10-26,6380
2347,聯強,11,0,11,光和,2023-10-26,6380
2460,建通,17,6,11,光和,2023-10-26,6380
3025,星通,16,5,11,光和,2023-10-26,6380
00753L,中信中國50正2,11,0,11,光和,2023-10-26,6380
00665L,富邦�琤肭磪囓�2,10,0,10,光和,2023-10-26,6380
00903,富邦元宇宙,10,0,10,光和,2023-10-26,6380
2305,全友,10,0,10,光和,2023-10-26,6380
2352,佳世達,10,0,10,光和,2023-10-26,6380
2905,三商,10,0,10,光和,2023-10-26,6380
4123,晟德,10,0,10,光和,2023-10-26,6380
4162,智擎,11,1,10,光和,2023-10-26,6380
2382,廣達,11,2,9,光和,2023-10-26,6380
00933B,國泰10Y+金融債,9,0,9,光和,2023-10-26,6380
2883,凱基金,76,0,76,光和,2023-10-27,6380
00720B,元大投資級公司債,60,0,60,光和,2023-10-27,6380
00885,富邦越南,60,0,60,光和,2023-10-27,6380
2317,鴻海,36,5,31,光和,2023-10-27,6380
2801,彰銀,31,0,31,光和,2023-10-27,6380
2405,輔信,31,1,30,光和,2023-10-27,6380
2460,建通,31,5,26,光和,2023-10-27,6380
2363,矽統,25,0,25,光和,2023-10-27,6380
2329,華泰,30,5,25,光和,2023-10-27,6380
00929,復華台灣科技優息,25,3,22,光和,2023-10-27,6380
1314,中石化,21,2,19,光和,2023-10-27,6380
2303,聯電,17,1,16,光和,2023-10-27,6380
0056,元大高股息,16,0,16,光和,2023-10-27,6380
2408,南亞科,15,0,15,光和,2023-10-27,6380
3432,台端,14,0,14,光和,2023-10-27,6380
8234,新漢,14,0,14,光和,2023-10-27,6380
3234,光環,13,1,12,光和,2023-10-27,6380
4908,前鼎,14,2,12,光和,2023-10-27,6380
00712,復華富時不動產,11,0,11,光和,2023-10-27,6380
2201,裕隆,11,0,11,光和,2023-10-27,6380
00927,群益半導體收益,10,0,10,光和,2023-10-27,6380
00696B,富邦美債20年,10,0,10,光和,2023-10-27,6380
00753L,中信中國50正2,10,0,10,光和,2023-10-27,6380
00740B,富邦全球投等債,10,0,10,光和,2023-10-27,6380
1907,永豐餘,10,0,10,光和,2023-10-27,6380
8070,長華*,10,0,10,光和,2023-10-27,6380
2369,菱生,19,11,8,光和,2023-10-27,6380
2002,中鋼,7,0,7,光和,2023-10-27,6380
2337,旺宏,80,73,7,光和,2023-10-27,6380
3041,揚智,7,0,7,光和,2023-10-27,6380
5272,笙科,8,1,7,光和,2023-10-27,6380
6451,訊芯-KY,11,4,7,光和,2023-10-27,6380
6244,茂迪,11,5,6,光和,2023-10-27,6380
1471,首利,6,0,6,光和,2023-10-27,6380
3163,波若威,6,0,6,光和,2023-10-27,6380
3287,廣寰科,6,0,6,光和,2023-10-27,6380
6282,康舒,6,0,6,光和,2023-10-27,6380
2383,台光電,5,0,5,光和,2023-10-27,6380
00633L,富邦上証正2,5,0,5,光和,2023-10-27,6380
1324,地球,5,0,5,光和,2023-10-27,6380
2312,金寶,5,0,5,光和,2023-10-27,6380
2606,裕民,5,0,5,光和,2023-10-27,6380
6156,松上,5,0,5,光和,2023-10-27,6380
6546,正基,5,0,5,光和,2023-10-27,6380
8050,廣積,5,0,5,光和,2023-10-27,6380
911608,明輝-DR,5,0,5,光和,2023-10-27,6380
3264,欣銓,6,1,5,光和,2023-10-27,6380
1513,中興電,4,0,4,光和,2023-10-27,6380
1301,台塑,4,0,4,光和,2023-10-27,6380
00642U,期元大S＆P石油,4,0,4,光和,2023-10-27,6380
1714,和桐,329,0,329,光和,2023-10-30,6380
2317,鴻海,116,45,71,光和,2023-10-30,6380
00712,復華富時不動產,49,0,49,光和,2023-10-30,6380
2888,新光金,35,0,35,光和,2023-10-30,6380
3706,神達,31,0,31,光和,2023-10-30,6380
2887,台新金,28,0,28,光和,2023-10-30,6380
00885,富邦越南,23,0,23,光和,2023-10-30,6380
2485,兆赫,30,8,22,光和,2023-10-30,6380
00715L,期街口布蘭特正2,20,0,20,光和,2023-10-30,6380
1314,中石化,20,1,19,光和,2023-10-30,6380
00632R,元大台灣50反1,20,1,19,光和,2023-10-30,6380
1795,美時,21,2,19,光和,2023-10-30,6380
2363,矽統,18,2,16,光和,2023-10-30,6380
2344,華邦電,20,5,15,光和,2023-10-30,6380
2618,長榮航,14,1,13,光和,2023-10-30,6380
3576,聯合再生,25,12,13,光和,2023-10-30,6380
5347,世界,13,0,13,光和,2023-10-30,6380
2303,聯電,17,4,13,光和,2023-10-30,6380
8110,華東,14,2,12,光和,2023-10-30,6380
2892,第一金,12,1,11,光和,2023-10-30,6380
00919,群益台灣精選高息,10,0,10,光和,2023-10-30,6380
2330,台積電,10,0,10,光和,2023-10-30,6380
4162,智擎,12,3,9,光和,2023-10-30,6380
4763,材料-KY,11,2,9,光和,2023-10-30,6380
5465,富驊,9,0,9,光和,2023-10-30,6380
6117,迎廣,15,6,9,光和,2023-10-30,6380
6244,茂迪,9,0,9,光和,2023-10-30,6380
7402,邑錡,9,0,9,光和,2023-10-30,6380
1524,耿鼎,10,2,8,光和,2023-10-30,6380
3062,建漢,10,2,8,光和,2023-10-30,6380
00878,國泰永續高股息,7,0,7,光和,2023-10-30,6380
2369,菱生,10,3,7,光和,2023-10-30,6380
2405,輔信,7,0,7,光和,2023-10-30,6380
2834,臺企銀,6,0,6,光和,2023-10-30,6380
2337,旺宏,138,132,6,光和,2023-10-30,6380
2201,裕隆,6,0,6,光和,2023-10-30,6380
3041,揚智,6,0,6,光和,2023-10-30,6380
6156,松上,11,5,6,光和,2023-10-30,6380
6684,安格,6,0,6,光和,2023-10-30,6380
1303,南亞,5,0,5,光和,2023-10-30,6380
2376,技嘉,9,4,5,光和,2023-10-30,6380
1410,南染,5,0,5,光和,2023-10-30,6380
2476,鉅祥,5,0,5,光和,2023-10-30,6380
2605,新興,5,0,5,光和,2023-10-30,6380
2883,凱基金,5,0,5,光和,2023-10-30,6380
3376,新日興,5,0,5,光和,2023-10-30,6380
3715,定穎投控,5,0,5,光和,2023-10-30,6380
5353,台林,5,0,5,光和,2023-10-30,6380
5469,瀚宇博,5,0,5,光和,2023-10-30,6380
2002,中鋼,15,10,5,光和,2023-10-30,6380
1714,和桐,340,0,340,光和,2023-10-31,6380
0056,元大高股息,66,1,65,光和,2023-10-31,6380
00929,復華台灣科技優息,58,3,55,光和,2023-10-31,6380
00885,富邦越南,53,0,53,光和,2023-10-31,6380
00932,兆豐永續高息等權,52,0,52,光和,2023-10-31,6380
00878,國泰永續高股息,57,9,48,光和,2023-10-31,6380
2408,南亞科,42,0,42,光和,2023-10-31,6380
2323,中環,52,15,37,光和,2023-10-31,6380
2344,華邦電,36,3,33,光和,2023-10-31,6380
00712,復華富時不動產,27,0,27,光和,2023-10-31,6380
00919,群益台灣精選高息,21,0,21,光和,2023-10-31,6380
2337,旺宏,40,20,20,光和,2023-10-31,6380
00648R,元大S＆P500反1,20,0,20,光和,2023-10-31,6380
1514,亞力,20,0,20,光和,2023-10-31,6380
4768,晶呈科技,20,0,20,光和,2023-10-31,6380
8213,志超,20,0,20,光和,2023-10-31,6380
5425,台半,18,0,18,光和,2023-10-31,6380
00715L,期街口布蘭特正2,17,0,17,光和,2023-10-31,6380
1815,富喬,28,13,15,光和,2023-10-31,6380
4960,誠美材,15,0,15,光和,2023-10-31,6380
3297,杭特,14,0,14,光和,2023-10-31,6380
2363,矽統,25,12,13,光和,2023-10-31,6380
1513,中興電,14,1,13,光和,2023-10-31,6380
2382,廣達,26,13,13,光和,2023-10-31,6380
2317,鴻海,20,7,13,光和,2023-10-31,6380
3481,群創,24,12,12,光和,2023-10-31,6380
5347,世界,12,0,12,光和,2023-10-31,6380
00713,元大台灣高息低波,11,0,11,光和,2023-10-31,6380
1905,華紙,11,0,11,光和,2023-10-31,6380
2425,承啟,13,2,11,光和,2023-10-31,6380
4934,太極,11,0,11,光和,2023-10-31,6380
2356,英業達,14,4,10,光和,2023-10-31,6380
00687B,國泰20年美債,10,0,10,光和,2023-10-31,6380
2405,輔信,10,0,10,光和,2023-10-31,6380
4766,南寶,10,0,10,光和,2023-10-31,6380
6235,華孚,13,3,10,光和,2023-10-31,6380
1524,耿鼎,19,10,9,光和,2023-10-31,6380
4564,元翎,9,0,9,光和,2023-10-31,6380
8027,鈦昇,9,0,9,光和,2023-10-31,6380
2301,光寶科,12,3,9,光和,2023-10-31,6380
2303,聯電,8,0,8,光和,2023-10-31,6380
3078,僑威,10,2,8,光和,2023-10-31,6380
3122,笙泉,19,11,8,光和,2023-10-31,6380
6153,嘉聯益,8,0,8,光和,2023-10-31,6380
8028,昇陽半導體,8,0,8,光和,2023-10-31,6380
8054,安國,10,2,8,光和,2023-10-31,6380
9105,泰金寶-DR,7,0,7,光和,2023-10-31,6380
3322,建舜電,10,3,7,光和,2023-10-31,6380
4755,三福化,7,0,7,光和,2023-10-31,6380
6269,台郡,7,0,7,光和,2023-10-31,6380
00934,中信成長高股息,179,0,179,光和,2023-11-01,6380
00878,國泰永續高股息,68,0,68,光和,2023-11-01,6380
00929,復華台灣科技優息,68,12,56,光和,2023-11-01,6380
3013,晟銘電,42,1,41,光和,2023-11-01,6380
00665L,富邦�琤肭磪囓�2,40,0,40,光和,2023-11-01,6380
00687B,國泰20年美債,44,5,39,光和,2023-11-01,6380
1714,和桐,39,0,39,光和,2023-11-01,6380
00679B,元大美債20年,34,0,34,光和,2023-11-01,6380
00935,野村臺灣新科技50,33,0,33,光和,2023-11-01,6380
2002,中鋼,35,2,33,光和,2023-11-01,6380
2317,鴻海,30,5,25,光和,2023-11-01,6380
2888,新光金,24,0,24,光和,2023-11-01,6380
0056,元大高股息,25,3,22,光和,2023-11-01,6380
2201,裕隆,22,0,22,光和,2023-11-01,6380
8033,雷虎,21,0,21,光和,2023-11-01,6380
00648R,元大S＆P500反1,20,0,20,光和,2023-11-01,6380
2338,光罩,20,1,19,光和,2023-11-01,6380
2610,華航,26,7,19,光和,2023-11-01,6380
6418,詠昇,18,0,18,光和,2023-11-01,6380
2485,兆赫,16,1,15,光和,2023-11-01,6380
2353,宏��,17,3,14,光和,2023-11-01,6380
8110,華東,15,1,14,光和,2023-11-01,6380
6168,宏齊,13,0,13,光和,2023-11-01,6380
2354,鴻準,13,1,12,光和,2023-11-01,6380
6125,廣運,12,0,12,光和,2023-11-01,6380
8054,安國,19,7,12,光和,2023-11-01,6380
1718,中纖,11,0,11,光和,2023-11-01,6380
00680L,元大美債20正2,10,0,10,光和,2023-11-01,6380
2371,大同,10,0,10,光和,2023-11-01,6380
2405,輔信,10,0,10,光和,2023-11-01,6380
2409,友達,11,1,10,光和,2023-11-01,6380
6443,元晶,30,20,10,光和,2023-11-01,6380
3481,群創,9,0,9,光和,2023-11-01,6380
2891,中信金,10,2,8,光和,2023-11-01,6380
2883,凱基金,8,0,8,光和,2023-11-01,6380
3047,訊舟,8,0,8,光和,2023-11-01,6380
3078,僑威,10,2,8,光和,2023-11-01,6380
6191,精成科,25,18,7,光和,2023-11-01,6380
2337,旺宏,23,16,7,光和,2023-11-01,6380
3231,緯創,20,13,7,光和,2023-11-01,6380
4716,大立,7,0,7,光和,2023-11-01,6380
3025,星通,8,2,6,光和,2023-11-01,6380
1101,台泥,12,6,6,光和,2023-11-01,6380
00712,復華富時不動產,6,0,6,光和,2023-11-01,6380
3265,台星科,6,0,6,光和,2023-11-01,6380
4960,誠美材,7,1,6,光和,2023-11-01,6380
1905,華紙,5,0,5,光和,2023-11-01,6380
1410,南染,5,0,5,光和,2023-11-01,6380
2605,新興,5,0,5,光和,2023-11-01,6380
3094,聯傑,5,0,5,光和,2023-11-01,6380
2888,新光金,308,176,132,光和,2023-11-02,6380
00632R,元大台灣50反1,94,0,94,光和,2023-11-02,6380
4960,誠美材,46,5,41,光和,2023-11-02,6380
2883,凱基金,38,0,38,光和,2023-11-02,6380
3706,神達,66,28,38,光和,2023-11-02,6380
00756B,群益投等新興公債,25,0,25,光和,2023-11-02,6380
2337,旺宏,111,87,24,光和,2023-11-02,6380
00919,群益台灣精選高息,22,0,22,光和,2023-11-02,6380
5351,鈺創,27,5,22,光和,2023-11-02,6380
2354,鴻準,20,0,20,光和,2023-11-02,6380
00934,中信成長高股息,21,1,20,光和,2023-11-02,6380
8927,北基,18,0,18,光和,2023-11-02,6380
2465,麗臺,22,5,17,光和,2023-11-02,6380
5392,能率,16,0,16,光和,2023-11-02,6380
8110,華東,15,0,15,光和,2023-11-02,6380
00929,復華台灣科技優息,26,13,13,光和,2023-11-02,6380
00935,野村臺灣新科技50,13,0,13,光和,2023-11-02,6380
1905,華紙,11,0,11,光和,2023-11-02,6380
2363,矽統,26,15,11,光和,2023-11-02,6380
3576,聯合再生,10,0,10,光和,2023-11-02,6380
00680L,元大美債20正2,21,11,10,光和,2023-11-02,6380
00888,永豐台灣ESG,10,0,10,光和,2023-11-02,6380
1313,聯成,10,0,10,光和,2023-11-02,6380
4162,智擎,11,1,10,光和,2023-11-02,6380
2313,華通,9,2,7,光和,2023-11-02,6380
6548,長科*,7,0,7,光和,2023-11-02,6380
6658,聯策,7,0,7,光和,2023-11-02,6380
8016,矽創,6,0,6,光和,2023-11-02,6380
1410,南染,5,0,5,光和,2023-11-02,6380
1717,長興,10,5,5,光和,2023-11-02,6380
2543,皇昌,5,0,5,光和,2023-11-02,6380
3363,上詮,5,0,5,光和,2023-11-02,6380
3675,德微,5,0,5,光和,2023-11-02,6380
4564,元翎,5,0,5,光和,2023-11-02,6380
6117,迎廣,5,0,5,光和,2023-11-02,6380
6477,安集,5,0,5,光和,2023-11-02,6380
3312,弘憶股,4,0,4,光和,2023-11-02,6380
2812,台中銀,4,0,4,光和,2023-11-02,6380
3380,明泰,5,1,4,光和,2023-11-02,6380
3548,兆利,7,3,4,光和,2023-11-02,6380
2610,華航,26,23,3,光和,2023-11-02,6380
1760,寶齡富錦,3,0,3,光和,2023-11-02,6380
2030,彰源,3,0,3,光和,2023-11-02,6380
2405,輔信,3,0,3,光和,2023-11-02,6380
2427,三商電,3,0,3,光和,2023-11-02,6380
6143,振曜,3,0,3,光和,2023-11-02,6380
6589,台康生技,3,0,3,光和,2023-11-02,6380
8105,凌巨,3,0,3,光和,2023-11-02,6380
2376,技嘉,11,9,2,光和,2023-11-02,6380
1218,泰山,2,0,2,光和,2023-11-02,6380
2618,長榮航,235,152,83,光和,2023-11-03,6380
2353,宏��,72,5,67,光和,2023-11-03,6380
00632R,元大台灣50反1,63,0,63,光和,2023-11-03,6380
2363,矽統,103,41,62,光和,2023-11-03,6380
3041,揚智,55,3,52,光和,2023-11-03,6380
2905,三商,50,0,50,光和,2023-11-03,6380
3322,建舜電,32,1,31,光和,2023-11-03,6380
1905,華紙,31,1,30,光和,2023-11-03,6380
00648R,元大S＆P500反1,30,0,30,光和,2023-11-03,6380
1528,恩德,30,1,29,光和,2023-11-03,6380
00935,野村臺灣新科技50,28,1,27,光和,2023-11-03,6380
2371,大同,25,0,25,光和,2023-11-03,6380
4157,太景*-KY,25,0,25,光和,2023-11-03,6380
5392,能率,20,0,20,光和,2023-11-03,6380
00878,國泰永續高股息,19,1,18,光和,2023-11-03,6380
00687B,國泰20年美債,14,0,14,光和,2023-11-03,6380
2344,華邦電,14,0,14,光和,2023-11-03,6380
2444,兆勁,13,0,13,光和,2023-11-03,6380
8150,南茂,12,0,12,光和,2023-11-03,6380
2331,精英,12,0,12,光和,2023-11-03,6380
2402,毅嘉,14,2,12,光和,2023-11-03,6380
00680L,元大美債20正2,10,0,10,光和,2023-11-03,6380
00715L,期街口布蘭特正2,10,0,10,光和,2023-11-03,6380
2312,金寶,11,1,10,光和,2023-11-03,6380
2380,虹光,10,0,10,光和,2023-11-03,6380
6589,台康生技,10,0,10,光和,2023-11-03,6380
5347,世界,9,0,9,光和,2023-11-03,6380
3122,笙泉,10,2,8,光和,2023-11-03,6380
5608,四維航,8,0,8,光和,2023-11-03,6380
6492,生華科,10,2,8,光和,2023-11-03,6380
6276,安鈦克,12,4,8,光和,2023-11-03,6380
2492,華新科,11,3,8,光和,2023-11-03,6380
1524,耿鼎,8,1,7,光和,2023-11-03,6380
2323,中環,7,0,7,光和,2023-11-03,6380
2883,凱基金,15,8,7,光和,2023-11-03,6380
4162,智擎,11,5,6,光和,2023-11-03,6380
5215,科嘉-KY,6,0,6,光和,2023-11-03,6380
2376,技嘉,14,9,5,光和,2023-11-03,6380
1609,大亞,10,5,5,光和,2023-11-03,6380
2337,旺宏,27,22,5,光和,2023-11-03,6380
2359,所羅門,5,0,5,光和,2023-11-03,6380
2460,建通,5,0,5,光和,2023-11-03,6380
5321,美而快,5,0,5,光和,2023-11-03,6380
9919,康那香,5,0,5,光和,2023-11-03,6380
3576,聯合再生,6,1,5,光和,2023-11-03,6380
8088,品安,5,1,4,光和,2023-11-03,6380
3051,力特,5,1,4,光和,2023-11-03,6380
6191,精成科,5,1,4,光和,2023-11-03,6380
6290,良維,4,0,4,光和,2023-11-03,6380
6658,聯策,4,0,4,光和,2023-11-03,6380
2618,長榮航,140,7,133,光和,2023-11-06,6380
4533,協易機,111,6,105,光和,2023-11-06,6380
3041,揚智,63,0,63,光和,2023-11-06,6380
00632R,元大台灣50反1,43,0,43,光和,2023-11-06,6380
1721,三晃,45,5,40,光和,2023-11-06,6380
2408,南亞科,29,2,27,光和,2023-11-06,6380
00715L,期街口布蘭特正2,18,0,18,光和,2023-11-06,6380
00679B,元大美債20年,19,2,17,光和,2023-11-06,6380
00687B,國泰20年美債,14,0,14,光和,2023-11-06,6380
3663,鑫科,14,0,14,光和,2023-11-06,6380
2603,長榮,13,0,13,光和,2023-11-06,6380
6712,長聖,12,0,12,光和,2023-11-06,6380
6418,詠昇,14,2,12,光和,2023-11-06,6380
2913,農林,15,4,11,光和,2023-11-06,6380
4167,松瑞藥,11,0,11,光和,2023-11-06,6380
6182,合晶,11,0,11,光和,2023-11-06,6380
6531,愛普*,15,5,10,光和,2023-11-06,6380
3036,文曄,12,2,10,光和,2023-11-06,6380
4916,事欣科,10,0,10,光和,2023-11-06,6380
6153,嘉聯益,10,0,10,光和,2023-11-06,6380
8176,智捷,10,0,10,光和,2023-11-06,6380
3260,威剛,12,3,9,光和,2023-11-06,6380
6276,安鈦克,9,0,9,光和,2023-11-06,6380
2388,威盛,19,12,7,光和,2023-11-06,6380
9950,萬國通,7,0,7,光和,2023-11-06,6380
4973,廣穎,9,2,7,光和,2023-11-06,6380
00934,中信成長高股息,7,1,6,光和,2023-11-06,6380
00933B,國泰10Y+金融債,7,1,6,光和,2023-11-06,6380
2390,云辰,6,0,6,光和,2023-11-06,6380
6122,擎邦,10,4,6,光和,2023-11-06,6380
3176,基亞,10,4,6,光和,2023-11-06,6380
0056,元大高股息,16,11,5,光和,2023-11-06,6380
1314,中石化,6,1,5,光和,2023-11-06,6380
2516,新建,5,0,5,光和,2023-11-06,6380
3038,全台,5,0,5,光和,2023-11-06,6380
3234,光環,5,0,5,光和,2023-11-06,6380
3443,創意,6,1,5,光和,2023-11-06,6380
4739,康普,5,0,5,光和,2023-11-06,6380
2610,華航,14,10,4,光和,2023-11-06,6380
3231,緯創,10,6,4,光和,2023-11-06,6380
2329,華泰,5,1,4,光和,2023-11-06,6380
2364,倫飛,4,0,4,光和,2023-11-06,6380
2465,麗臺,4,0,4,光和,2023-11-06,6380
3264,欣銓,4,0,4,光和,2023-11-06,6380
6026,福邦證,4,0,4,光和,2023-11-06,6380
6147,頎邦,5,1,4,光和,2023-11-06,6380
6457,紘康,5,1,4,光和,2023-11-06,6380
6477,安集,4,0,4,光和,2023-11-06,6380
6658,聯策,5,1,4,光和,2023-11-06,6380
8255,朋程,5,1,4,光和,2023-11-06,6380
2888,新光金,114,0,114,光和,2023-11-07,6380
2002,中鋼,105,1,104,光和,2023-11-07,6380
3041,揚智,59,24,35,光和,2023-11-07,6380
2883,凱基金,33,0,33,光和,2023-11-07,6380
2371,大同,36,4,32,光和,2023-11-07,6380
00929,復華台灣科技優息,31,3,28,光和,2023-11-07,6380
1101,台泥,27,1,26,光和,2023-11-07,6380
6669,緯穎,20,0,20,光和,2023-11-07,6380
3701,大眾控,18,0,18,光和,2023-11-07,6380
6244,茂迪,15,0,15,光和,2023-11-07,6380
8176,智捷,15,0,15,光和,2023-11-07,6380
2634,漢翔,16,2,14,光和,2023-11-07,6380
5392,能率,14,0,14,光和,2023-11-07,6380
1815,富喬,24,11,13,光和,2023-11-07,6380
2358,廷鑫,13,1,12,光和,2023-11-07,6380
2745,五福,12,0,12,光和,2023-11-07,6380
1304,台聚,10,0,10,光和,2023-11-07,6380
2855,統一證,10,0,10,光和,2023-11-07,6380
3265,台星科,11,1,10,光和,2023-11-07,6380
3450,聯鈞,10,0,10,光和,2023-11-07,6380
4167,松瑞藥,11,1,10,光和,2023-11-07,6380
2359,所羅門,10,1,9,光和,2023-11-07,6380
8163,達方,9,0,9,光和,2023-11-07,6380
1449,佳和,10,2,8,光和,2023-11-07,6380
2453,凌群,12,4,8,光和,2023-11-07,6380
2486,一詮,9,1,8,光和,2023-11-07,6380
6531,愛普*,12,4,8,光和,2023-11-07,6380
00679B,元大美債20年,12,5,7,光和,2023-11-07,6380
3234,光環,9,2,7,光和,2023-11-07,6380
6477,安集,12,5,7,光和,2023-11-07,6380
2317,鴻海,6,0,6,光和,2023-11-07,6380
3006,晶豪科,6,0,6,光和,2023-11-07,6380
3622,洋華,6,0,6,光和,2023-11-07,6380
8110,華東,8,2,6,光和,2023-11-07,6380
00878,國泰永續高股息,20,15,5,光和,2023-11-07,6380
2388,威盛,7,2,5,光和,2023-11-07,6380
8390,金益鼎,5,0,5,光和,2023-11-07,6380
4440,宜新實業,5,0,5,光和,2023-11-07,6380
2913,農林,5,0,5,光和,2023-11-07,6380
00934,中信成長高股息,5,0,5,光和,2023-11-07,6380
1604,聲寶,5,0,5,光和,2023-11-07,6380
2460,建通,5,0,5,光和,2023-11-07,6380
2838,聯邦銀,5,0,5,光和,2023-11-07,6380
3376,新日興,6,1,5,光和,2023-11-07,6380
6133,金橋,5,0,5,光和,2023-11-07,6380
6153,嘉聯益,5,0,5,光和,2023-11-07,6380
6197,佳必琪,9,4,5,光和,2023-11-07,6380
6579,研揚,7,2,5,光和,2023-11-07,6380
1303,南亞,5,0,5,光和,2023-11-07,6380
2748,雲品,4,0,4,光和,2023-11-07,6380
00632R,元大台灣50反1,200,15,185,光和,2023-11-08,6380
2888,新光金,102,0,102,光和,2023-11-08,6380
2618,長榮航,108,17,91,光和,2023-11-08,6380
00936,台新永續高息中小,67,0,67,光和,2023-11-08,6380
3041,揚智,59,0,59,光和,2023-11-08,6380
00929,復華台灣科技優息,90,40,50,光和,2023-11-08,6380
2317,鴻海,50,2,48,光和,2023-11-08,6380
2337,旺宏,90,51,39,光和,2023-11-08,6380
4128,中天,64,32,32,光和,2023-11-08,6380
00665L,富邦�琤肭磪囓�2,30,0,30,光和,2023-11-08,6380
1815,富喬,30,1,29,光和,2023-11-08,6380
2363,矽統,78,52,26,光和,2023-11-08,6380
00885,富邦越南,20,0,20,光和,2023-11-08,6380
00706L,期元大S＆P日圓正2,20,0,20,光和,2023-11-08,6380
1304,台聚,20,0,20,光和,2023-11-08,6380
1524,耿鼎,20,0,20,光和,2023-11-08,6380
2460,建通,20,0,20,光和,2023-11-08,6380
4157,太景*-KY,20,0,20,光和,2023-11-08,6380
2408,南亞科,20,1,19,光和,2023-11-08,6380
5347,世界,28,11,17,光和,2023-11-08,6380
4529,淳紳,15,0,15,光和,2023-11-08,6380
2002,中鋼,16,2,14,光和,2023-11-08,6380
3051,力特,13,0,13,光和,2023-11-08,6380
3706,神達,15,2,13,光和,2023-11-08,6380
1314,中石化,14,1,13,光和,2023-11-08,6380
6191,精成科,12,0,12,光和,2023-11-08,6380
2388,威盛,17,5,12,光和,2023-11-08,6380
5521,工信,19,7,12,光和,2023-11-08,6380
6531,愛普*,18,7,11,光和,2023-11-08,6380
00648R,元大S＆P500反1,10,0,10,光和,2023-11-08,6380
2880,華南金,10,0,10,光和,2023-11-08,6380
3504,揚明光,10,0,10,光和,2023-11-08,6380
6016,康和證,10,0,10,光和,2023-11-08,6380
6112,邁達特,10,0,10,光和,2023-11-08,6380
6185,幃翔,15,5,10,光和,2023-11-08,6380
6419,京晨科,10,0,10,光和,2023-11-08,6380
2312,金寶,10,1,9,光和,2023-11-08,6380
2488,漢平,10,1,9,光和,2023-11-08,6380
2605,新興,9,0,9,光和,2023-11-08,6380
2745,五福,10,1,9,光和,2023-11-08,6380
3450,聯鈞,12,3,9,光和,2023-11-08,6380
2883,凱基金,8,0,8,光和,2023-11-08,6380
2516,新建,7,0,7,光和,2023-11-08,6380
3339,泰谷,7,0,7,光和,2023-11-08,6380
5381,合正,7,0,7,光和,2023-11-08,6380
6443,元晶,9,2,7,光和,2023-11-08,6380
3376,新日興,7,1,6,光和,2023-11-08,6380
00642U,期元大S＆P石油,6,0,6,光和,2023-11-08,6380
1799,易威,6,0,6,光和,2023-11-08,6380
2436,偉詮電,7,1,6,光和,2023-11-08,6380
2329,華泰,116,21,95,光和,2023-11-09,6380
3013,晟銘電,102,10,92,光和,2023-11-09,6380
2408,南亞科,71,0,71,光和,2023-11-09,6380
2337,旺宏,58,1,57,光和,2023-11-09,6380
2409,友達,59,14,45,光和,2023-11-09,6380
2880,華南金,45,0,45,光和,2023-11-09,6380
00715L,期街口布蘭特正2,35,2,33,光和,2023-11-09,6380
00921,兆豐龍頭等權重,30,0,30,光和,2023-11-09,6380
6901,鑽石投資,37,8,29,光和,2023-11-09,6380
5347,世界,26,0,26,光和,2023-11-09,6380
00929,復華台灣科技優息,23,1,22,光和,2023-11-09,6380
4960,誠美材,21,0,21,光和,2023-11-09,6380
00648R,元大S＆P500反1,20,0,20,光和,2023-11-09,6380
3264,欣銓,20,3,17,光和,2023-11-09,6380
2323,中環,23,6,17,光和,2023-11-09,6380
2460,建通,16,0,16,光和,2023-11-09,6380
1471,首利,15,0,15,光和,2023-11-09,6380
2344,華邦電,17,2,15,光和,2023-11-09,6380
5381,合正,15,0,15,光和,2023-11-09,6380
6116,彩晶,15,0,15,光和,2023-11-09,6380
2905,三商,14,0,14,光和,2023-11-09,6380
6419,京晨科,14,0,14,光和,2023-11-09,6380
6457,紘康,14,0,14,光和,2023-11-09,6380
6477,安集,14,0,14,光和,2023-11-09,6380
00878,國泰永續高股息,18,5,13,光和,2023-11-09,6380
4162,智擎,17,4,13,光和,2023-11-09,6380
1314,中石化,17,5,12,光和,2023-11-09,6380
00642U,期元大S＆P石油,12,0,12,光和,2023-11-09,6380
00936,台新永續高息中小,20,9,11,光和,2023-11-09,6380
2610,華航,14,4,10,光和,2023-11-09,6380
00930,永豐ESG低碳高息,10,0,10,光和,2023-11-09,6380
00888,永豐台灣ESG,10,0,10,光和,2023-11-09,6380
0056,元大高股息,11,1,10,光和,2023-11-09,6380
3041,揚智,10,0,10,光和,2023-11-09,6380
3444,利機,10,0,10,光和,2023-11-09,6380
8110,華東,9,0,9,光和,2023-11-09,6380
4906,正文,9,0,9,光和,2023-11-09,6380
6182,合晶,9,0,9,光和,2023-11-09,6380
6770,力積電,12,3,9,光和,2023-11-09,6380
1522,堤維西,11,3,8,光和,2023-11-09,6380
4157,太景*-KY,10,2,8,光和,2023-11-09,6380
3260,威剛,9,2,7,光和,2023-11-09,6380
1815,富喬,9,2,7,光和,2023-11-09,6380
2338,光罩,7,0,7,光和,2023-11-09,6380
3176,基亞,8,2,6,光和,2023-11-09,6380
00712,復華富時不動產,6,0,6,光和,2023-11-09,6380
2816,旺旺保,6,0,6,光和,2023-11-09,6380
3680,家登,6,0,6,光和,2023-11-09,6380
3689,湧德,6,0,6,光和,2023-11-09,6380
4908,前鼎,8,2,6,光和,2023-11-09,6380
6016,康和證,129,0,129,光和,2023-11-10,6380
00936,台新永續高息中小,120,0,120,光和,2023-11-10,6380
8936,國統,102,13,89,光和,2023-11-10,6380
3013,晟銘電,69,2,67,光和,2023-11-10,6380
3704,合勤控,43,0,43,光和,2023-11-10,6380
00934,中信成長高股息,37,1,36,光和,2023-11-10,6380
6901,鑽石投資,42,6,36,光和,2023-11-10,6380
8940,新天地,36,0,36,光和,2023-11-10,6380
1815,富喬,31,2,29,光和,2023-11-10,6380
00712,復華富時不動產,26,0,26,光和,2023-11-10,6380
2425,承啟,26,0,26,光和,2023-11-10,6380
2408,南亞科,31,6,25,光和,2023-11-10,6380
2337,旺宏,25,1,24,光和,2023-11-10,6380
1717,長興,19,0,19,光和,2023-11-10,6380
2745,五福,19,0,19,光和,2023-11-10,6380
4157,太景*-KY,20,3,17,光和,2023-11-10,6380
00878,國泰永續高股息,16,0,16,光和,2023-11-10,6380
2606,裕民,16,0,16,光和,2023-11-10,6380
2476,鉅祥,15,0,15,光和,2023-11-10,6380
2305,全友,19,5,14,光和,2023-11-10,6380
2888,新光金,19,5,14,光和,2023-11-10,6380
00919,群益台灣精選高息,13,0,13,光和,2023-11-10,6380
00687B,國泰20年美債,13,0,13,光和,2023-11-10,6380
2610,華航,13,1,12,光和,2023-11-10,6380
2618,長榮航,17,5,12,光和,2023-11-10,6380
3706,神達,13,2,11,光和,2023-11-10,6380
3481,群創,11,0,11,光和,2023-11-10,6380
00679B,元大美債20年,10,0,10,光和,2023-11-10,6380
1904,正隆,10,0,10,光和,2023-11-10,6380
2371,大同,11,1,10,光和,2023-11-10,6380
2460,建通,10,0,10,光和,2023-11-10,6380
3231,緯創,20,10,10,光和,2023-11-10,6380
4967,十銓,11,1,10,光和,2023-11-10,6380
5512,力麒,10,0,10,光和,2023-11-10,6380
6125,廣運,11,1,10,光和,2023-11-10,6380
9935,慶豐富,10,0,10,光和,2023-11-10,6380
00891,中信關鍵半導體,10,1,9,光和,2023-11-10,6380
1524,耿鼎,10,1,9,光和,2023-11-10,6380
2204,中華,9,0,9,光和,2023-11-10,6380
2867,三商壽,9,0,9,光和,2023-11-10,6380
2887,台新金,8,0,8,光和,2023-11-10,6380
2353,宏��,8,1,7,光和,2023-11-10,6380
2601,益航,7,0,7,光和,2023-11-10,6380
4128,中天,29,22,7,光和,2023-11-10,6380
2369,菱生,6,0,6,光和,2023-11-10,6380
2390,云辰,6,0,6,光和,2023-11-10,6380
2884,玉山金,6,0,6,光和,2023-11-10,6380
3325,旭品,6,0,6,光和,2023-11-10,6380
5009,榮剛,6,0,6,光和,2023-11-10,6380
6530,創威,6,0,6,光和,2023-11-10,6380
4960,誠美材,130,6,124,光和,2023-11-13,6380
2618,長榮航,39,2,37,光和,2023-11-13,6380
5011,久陽,28,2,26,光和,2023-11-13,6380
2382,廣達,38,17,21,光和,2023-11-13,6380
1604,聲寶,20,0,20,光和,2023-11-13,6380
2014,中鴻,20,0,20,光和,2023-11-13,6380
2337,旺宏,35,15,20,光和,2023-11-13,6380
5519,隆大,20,0,20,光和,2023-11-13,6380
2363,矽統,25,6,19,光和,2023-11-13,6380
00679B,元大美債20年,18,0,18,光和,2023-11-13,6380
2883,凱基金,20,3,17,光和,2023-11-13,6380
2034,允強,16,0,16,光和,2023-11-13,6380
2610,華航,17,1,16,光和,2023-11-13,6380
2888,新光金,14,0,14,光和,2023-11-13,6380
2739,寒舍,16,2,14,光和,2023-11-13,6380
2834,臺企銀,14,0,14,光和,2023-11-13,6380
9946,三發地產,14,0,14,光和,2023-11-13,6380
2313,華通,22,9,13,光和,2023-11-13,6380
2359,所羅門,16,3,13,光和,2023-11-13,6380
8163,達方,13,0,13,光和,2023-11-13,6380
00878,國泰永續高股息,15,3,12,光和,2023-11-13,6380
1605,華新,12,0,12,光和,2023-11-13,6380
1815,富喬,12,0,12,光和,2023-11-13,6380
2314,台揚,12,0,12,光和,2023-11-13,6380
4147,中裕,12,0,12,光和,2023-11-13,6380
2884,玉山金,12,0,12,光和,2023-11-13,6380
3032,偉訓,11,0,11,光和,2023-11-13,6380
1101,台泥,12,2,10,光和,2023-11-13,6380
2340,台亞,10,0,10,光和,2023-11-13,6380
2816,旺旺保,10,0,10,光和,2023-11-13,6380
2867,三商壽,10,0,10,光和,2023-11-13,6380
2892,第一金,10,0,10,光和,2023-11-13,6380
3094,聯傑,19,9,10,光和,2023-11-13,6380
4157,太景*-KY,10,0,10,光和,2023-11-13,6380
6139,亞翔,24,14,10,光和,2023-11-13,6380
5483,中美晶,11,1,10,光和,2023-11-13,6380
2317,鴻海,11,2,9,光和,2023-11-13,6380
2485,兆赫,9,0,9,光和,2023-11-13,6380
3059,華晶科,8,0,8,光和,2023-11-13,6380
6282,康舒,11,3,8,光和,2023-11-13,6380
6290,良維,8,0,8,光和,2023-11-13,6380
1504,東元,7,0,7,光和,2023-11-13,6380
2353,宏��,7,0,7,光和,2023-11-13,6380
2468,華經,11,4,7,光和,2023-11-13,6380
6579,研揚,7,0,7,光和,2023-11-13,6380
4763,材料-KY,7,1,6,光和,2023-11-13,6380
1609,大亞,7,1,6,光和,2023-11-13,6380
2390,云辰,6,0,6,光和,2023-11-13,6380
2486,一詮,7,1,6,光和,2023-11-13,6380
2641,正德,6,0,6,光和,2023-11-13,6380
00632R,元大台灣50反1,201,0,201,光和,2023-11-14,6380
4960,誠美材,53,0,53,光和,2023-11-14,6380
1515,力山,52,2,50,光和,2023-11-14,6380
2034,允強,36,0,36,光和,2023-11-14,6380
9946,三發地產,30,0,30,光和,2023-11-14,6380
2618,長榮航,24,1,23,光和,2023-11-14,6380
6282,康舒,26,4,22,光和,2023-11-14,6380
00637L,元大滬深300正2,23,2,21,光和,2023-11-14,6380
2609,陽明,34,14,20,光和,2023-11-14,6380
2889,國票金,20,0,20,光和,2023-11-14,6380
5351,鈺創,20,1,19,光和,2023-11-14,6380
00919,群益台灣精選高息,21,2,19,光和,2023-11-14,6380
1815,富喬,24,6,18,光和,2023-11-14,6380
1504,東元,17,1,16,光和,2023-11-14,6380
2634,漢翔,18,2,16,光和,2023-11-14,6380
00929,復華台灣科技優息,68,54,14,光和,2023-11-14,6380
3035,智原,14,1,13,光和,2023-11-14,6380
2201,裕隆,11,0,11,光和,2023-11-14,6380
3078,僑威,18,7,11,光和,2023-11-14,6380
1605,華新,11,0,11,光和,2023-11-14,6380
3481,群創,13,2,11,光和,2023-11-14,6380
00692,富邦公司治理,10,0,10,光和,2023-11-14,6380
1101,台泥,19,9,10,光和,2023-11-14,6380
00894,中信小資高價30,10,0,10,光和,2023-11-14,6380
2382,廣達,14,4,10,光和,2023-11-14,6380
3380,明泰,10,0,10,光和,2023-11-14,6380
3686,達能,10,0,10,光和,2023-11-14,6380
8048,德勝,10,0,10,光和,2023-11-14,6380
9933,中鼎,10,0,10,光和,2023-11-14,6380
00878,國泰永續高股息,13,4,9,光和,2023-11-14,6380
3257,虹冠電,9,1,8,光和,2023-11-14,6380
6139,亞翔,8,0,8,光和,2023-11-14,6380
6185,幃翔,8,0,8,光和,2023-11-14,6380
2002,中鋼,8,1,7,光和,2023-11-14,6380
2364,倫飛,7,0,7,光和,2023-11-14,6380
2376,技嘉,8,1,7,光和,2023-11-14,6380
3338,泰碩,7,0,7,光和,2023-11-14,6380
3707,漢磊,6,0,6,光和,2023-11-14,6380
00935,野村臺灣新科技50,6,0,6,光和,2023-11-14,6380
3051,力特,6,0,6,光和,2023-11-14,6380
3306,鼎天,9,3,6,光和,2023-11-14,6380
6197,佳必琪,6,0,6,光和,2023-11-14,6380
8213,志超,6,0,6,光和,2023-11-14,6380
2313,華通,9,4,5,光和,2023-11-14,6380
00933B,國泰10Y+金融債,5,0,5,光和,2023-11-14,6380
00753L,中信中國50正2,5,0,5,光和,2023-11-14,6380
2476,鉅祥,5,0,5,光和,2023-11-14,6380
2606,裕民,6,1,5,光和,2023-11-14,6380
2882,國泰金,6,1,5,光和,2023-11-14,6380
3017,奇鋐,6,1,5,光和,2023-11-14,6380
00878,國泰永續高股息,141,19,122,光和,2023-11-15,6380
00648R,元大S＆P500反1,70,0,70,光和,2023-11-15,6380
2353,宏��,66,5,61,光和,2023-11-15,6380
3013,晟銘電,57,0,57,光和,2023-11-15,6380
00933B,國泰10Y+金融債,55,0,55,光和,2023-11-15,6380
2323,中環,97,50,47,光和,2023-11-15,6380
2608,嘉里大榮,37,0,37,光和,2023-11-15,6380
1815,富喬,34,1,33,光和,2023-11-15,6380
00637L,元大滬深300正2,31,2,29,光和,2023-11-15,6380
3706,神達,25,1,24,光和,2023-11-15,6380
1783,和康生,22,0,22,光和,2023-11-15,6380
2332,友訊,20,0,20,光和,2023-11-15,6380
1616,億泰,16,0,16,光和,2023-11-15,6380
2317,鴻海,20,5,15,光和,2023-11-15,6380
6156,松上,12,0,12,光和,2023-11-15,6380
2369,菱生,28,17,11,光和,2023-11-15,6380
3017,奇鋐,15,4,11,光和,2023-11-15,6380
9946,三發地產,11,0,11,光和,2023-11-15,6380
3041,揚智,23,12,11,光和,2023-11-15,6380
2349,錸德,11,0,11,光和,2023-11-15,6380
00679B,元大美債20年,10,0,10,光和,2023-11-15,6380
00882,中信中國高股息,20,10,10,光和,2023-11-15,6380
2601,益航,10,0,10,光和,2023-11-15,6380
2610,華航,10,0,10,光和,2023-11-15,6380
2867,三商壽,20,10,10,光和,2023-11-15,6380
2328,廣宇,10,0,10,光和,2023-11-15,6380
1103,嘉泥,9,0,9,光和,2023-11-15,6380
00632R,元大台灣50反1,8,0,8,光和,2023-11-15,6380
00923,群益台ESG低碳50,10,2,8,光和,2023-11-15,6380
2331,精英,8,0,8,光和,2023-11-15,6380
2401,凌陽,10,2,8,光和,2023-11-15,6380
8048,德勝,11,3,8,光和,2023-11-15,6380
2609,陽明,15,8,7,光和,2023-11-15,6380
6188,廣明,9,2,7,光和,2023-11-15,6380
6538,倉和,6,0,6,光和,2023-11-15,6380
1217,愛之味,5,0,5,光和,2023-11-15,6380
00892,富邦台灣半導體,5,0,5,光和,2023-11-15,6380
00919,群益台灣精選高息,6,1,5,光和,2023-11-15,6380
00633L,富邦上証正2,5,0,5,光和,2023-11-15,6380
4720,德淵,5,0,5,光和,2023-11-15,6380
6163,華電網,5,0,5,光和,2023-11-15,6380
6856,鑫傳,5,0,5,光和,2023-11-15,6380
8107,大億金茂,5,0,5,光和,2023-11-15,6380
8213,志超,5,0,5,光和,2023-11-15,6380
5483,中美晶,5,0,5,光和,2023-11-15,6380
2634,漢翔,5,1,4,光和,2023-11-15,6380
2312,金寶,15,11,4,光和,2023-11-15,6380
2314,台揚,4,0,4,光和,2023-11-15,6380
2355,敬鵬,4,0,4,光和,2023-11-15,6380
2426,鼎元,5,1,4,光和,2023-11-15,6380
00637L,元大滬深300正2,294,0,294,光和,2023-11-16,6380
00687B,國泰20年美債,95,0,95,光和,2023-11-16,6380
2329,華泰,117,66,51,光和,2023-11-16,6380
6231,系微,43,1,42,光和,2023-11-16,6380
2608,嘉里大榮,40,0,40,光和,2023-11-16,6380
3013,晟銘電,36,1,35,光和,2023-11-16,6380
2352,佳世達,32,0,32,光和,2023-11-16,6380
9933,中鼎,31,0,31,光和,2023-11-16,6380
2353,宏��,27,0,27,光和,2023-11-16,6380
00706L,期元大S＆P日圓正2,23,0,23,光和,2023-11-16,6380
1605,華新,24,2,22,光和,2023-11-16,6380
00679B,元大美債20年,18,0,18,光和,2023-11-16,6380
00891,中信關鍵半導體,20,4,16,光和,2023-11-16,6380
00673R,期元大S＆P原油反1,15,0,15,光和,2023-11-16,6380
2374,佳能,15,0,15,光和,2023-11-16,6380
1455,集盛,13,0,13,光和,2023-11-16,6380
1718,中纖,13,0,13,光和,2023-11-16,6380
2344,華邦電,53,40,13,光和,2023-11-16,6380
00933B,國泰10Y+金融債,10,0,10,光和,2023-11-16,6380
00671R,富邦NASDAQ反1,10,0,10,光和,2023-11-16,6380
00885,富邦越南,10,0,10,光和,2023-11-16,6380
1339,昭輝,10,0,10,光和,2023-11-16,6380
2419,仲琦,10,0,10,光和,2023-11-16,6380
00929,復華台灣科技優息,23,14,9,光和,2023-11-16,6380
1524,耿鼎,27,18,9,光和,2023-11-16,6380
2014,中鴻,10,1,9,光和,2023-11-16,6380
2504,國產,9,0,9,光和,2023-11-16,6380
2634,漢翔,20,11,9,光和,2023-11-16,6380
4157,太景*-KY,10,1,9,光和,2023-11-16,6380
4967,十銓,8,0,8,光和,2023-11-16,6380
6560,欣普羅,9,1,8,光和,2023-11-16,6380
00900,富邦特選高股息30,13,5,8,光和,2023-11-16,6380
6531,愛普*,11,4,7,光和,2023-11-16,6380
1101,台泥,10,3,7,光和,2023-11-16,6380
1721,三晃,7,0,7,光和,2023-11-16,6380
2380,虹光,7,0,7,光和,2023-11-16,6380
3041,揚智,42,35,7,光和,2023-11-16,6380
2331,精英,9,3,6,光和,2023-11-16,6380
2356,英業達,8,2,6,光和,2023-11-16,6380
2748,雲品,10,4,6,光和,2023-11-16,6380
5301,寶得利,6,0,6,光和,2023-11-16,6380
00786B,元大10年IG銀行債,5,0,5,光和,2023-11-16,6380
00715L,期街口布蘭特正2,5,0,5,光和,2023-11-16,6380
00633L,富邦上証正2,5,0,5,光和,2023-11-16,6380
00632R,元大台灣50反1,5,0,5,光和,2023-11-16,6380
00669R,國泰美國道瓊反1,5,0,5,光和,2023-11-16,6380
1785,光洋科,5,0,5,光和,2023-11-16,6380
2516,新建,5,0,5,光和,2023-11-16,6380
2882,國泰金,5,0,5,光和,2023-11-16,6380
3260,威剛,5,0,5,光和,2023-11-16,6380
3041,揚智,85,17,68,光和,2023-11-17,6380
00679B,元大美債20年,46,0,46,光和,2023-11-17,6380
00715L,期街口布蘭特正2,40,0,40,光和,2023-11-17,6380
2618,長榮航,80,43,37,光和,2023-11-17,6380
00882,中信中國高股息,33,0,33,光和,2023-11-17,6380
00637L,元大滬深300正2,30,0,30,光和,2023-11-17,6380
9933,中鼎,21,0,21,光和,2023-11-17,6380
2353,宏��,20,0,20,光和,2023-11-17,6380
3481,群創,22,4,18,光和,2023-11-17,6380
00929,復華台灣科技優息,64,47,17,光和,2023-11-17,6380
00932,兆豐永續高息等權,30,13,17,光和,2023-11-17,6380
1815,富喬,27,11,16,光和,2023-11-17,6380
00936,台新永續高息中小,15,0,15,光和,2023-11-17,6380
00753L,中信中國50正2,15,0,15,光和,2023-11-17,6380
00712,復華富時不動產,14,0,14,光和,2023-11-17,6380
2498,宏達電,21,8,13,光和,2023-11-17,6380
2425,承啟,13,0,13,光和,2023-11-17,6380
6127,九豪,18,5,13,光和,2023-11-17,6380
2344,華邦電,14,2,12,光和,2023-11-17,6380
3260,威剛,13,1,12,光和,2023-11-17,6380
2363,矽統,34,23,11,光和,2023-11-17,6380
5426,振發,11,0,11,光和,2023-11-17,6380
2027,大成鋼,12,2,10,光和,2023-11-17,6380
2029,盛餘,10,0,10,光和,2023-11-17,6380
4106,雃博,10,0,10,光和,2023-11-17,6380
6288,聯嘉,10,0,10,光和,2023-11-17,6380
2610,華航,26,16,10,光和,2023-11-17,6380
6669,緯穎,11,1,10,光和,2023-11-17,6380
1603,華電,9,0,9,光和,2023-11-17,6380
2409,友達,12,3,9,光和,2023-11-17,6380
6589,台康生技,9,0,9,光和,2023-11-17,6380
1524,耿鼎,12,4,8,光和,2023-11-17,6380
2106,建大,10,2,8,光和,2023-11-17,6380
3231,緯創,18,10,8,光和,2023-11-17,6380
6416,瑞祺電通,9,1,8,光和,2023-11-17,6380
00632R,元大台灣50反1,7,0,7,光和,2023-11-17,6380
1471,首利,7,0,7,光和,2023-11-17,6380
2023,燁輝,8,1,7,光和,2023-11-17,6380
2331,精英,12,5,7,光和,2023-11-17,6380
2607,榮運,8,1,7,光和,2023-11-17,6380
3715,定穎投控,11,4,7,光和,2023-11-17,6380
6269,台郡,10,3,7,光和,2023-11-17,6380
9946,三發地產,7,0,7,光和,2023-11-17,6380
2405,輔信,18,12,6,光和,2023-11-17,6380
2707,晶華,10,4,6,光和,2023-11-17,6380
3011,今皓,6,0,6,光和,2023-11-17,6380
1582,信錦,7,2,5,光和,2023-11-17,6380
2376,技嘉,5,0,5,光和,2023-11-17,6380
2745,五福,5,0,5,光和,2023-11-17,6380
00639,富邦深100,5,0,5,光和,2023-11-17,6380
00885,富邦越南,100,0,100,光和,2023-11-20,6380
00931B,統一美債20年,51,0,51,光和,2023-11-20,6380
2363,矽統,68,30,38,光和,2023-11-20,6380
2608,嘉里大榮,38,0,38,光和,2023-11-20,6380
2618,長榮航,40,3,37,光和,2023-11-20,6380
1101,台泥,38,4,34,光和,2023-11-20,6380
3481,群創,93,60,33,光和,2023-11-20,6380
4916,事欣科,31,0,31,光和,2023-11-20,6380
00673R,期元大S＆P原油反1,28,0,28,光和,2023-11-20,6380
6560,欣普羅,28,0,28,光和,2023-11-20,6380
5465,富驊,30,5,25,光和,2023-11-20,6380
2374,佳能,22,0,22,光和,2023-11-20,6380
6231,系微,25,4,21,光和,2023-11-20,6380
6112,邁達特,20,0,20,光和,2023-11-20,6380
3036,文曄,21,1,20,光和,2023-11-20,6380
2476,鉅祥,20,1,19,光和,2023-11-20,6380
00679B,元大美債20年,18,0,18,光和,2023-11-20,6380
2610,華航,20,2,18,光和,2023-11-20,6380
6589,台康生技,18,0,18,光和,2023-11-20,6380
2485,兆赫,16,1,15,光和,2023-11-20,6380
00929,復華台灣科技優息,132,118,14,光和,2023-11-20,6380
00712,復華富時不動產,16,3,13,光和,2023-11-20,6380
3035,智原,17,4,13,光和,2023-11-20,6380
3094,聯傑,15,2,13,光和,2023-11-20,6380
2603,長榮,12,0,12,光和,2023-11-20,6380
2736,富野,13,1,12,光和,2023-11-20,6380
3689,湧德,11,0,11,光和,2023-11-20,6380
3703,欣陸,11,0,11,光和,2023-11-20,6380
6168,宏齊,20,9,11,光和,2023-11-20,6380
1815,富喬,15,5,10,光和,2023-11-20,6380
2002,中鋼,11,1,10,光和,2023-11-20,6380
2312,金寶,10,0,10,光和,2023-11-20,6380
2880,華南金,10,0,10,光和,2023-11-20,6380
9904,寶成,10,0,10,光和,2023-11-20,6380
2329,華泰,29,20,9,光和,2023-11-20,6380
2344,華邦電,14,5,9,光和,2023-11-20,6380
1609,大亞,15,6,9,光和,2023-11-20,6380
2201,裕隆,9,0,9,光和,2023-11-20,6380
2436,偉詮電,9,0,9,光和,2023-11-20,6380
3163,波若威,10,1,9,光和,2023-11-20,6380
2382,廣達,35,26,9,光和,2023-11-20,6380
00878,國泰永續高股息,9,1,8,光和,2023-11-20,6380
2743,山富,7,0,7,光和,2023-11-20,6380
2317,鴻海,7,0,7,光和,2023-11-20,6380
3051,力特,7,0,7,光和,2023-11-20,6380
3376,新日興,7,0,7,光和,2023-11-20,6380
8034,榮群,10,3,7,光和,2023-11-20,6380
8261,富鼎,11,4,7,光和,2023-11-20,6380
00900,富邦特選高股息30,7,0,7,光和,2023-11-20,6380
2029,盛餘,6,0,6,光和,2023-11-20,6380
00632R,元大台灣50反1,457,0,457,光和,2023-11-21,6380
2401,凌陽,114,7,107,光和,2023-11-21,6380
00885,富邦越南,80,5,75,光和,2023-11-21,6380
3041,揚智,57,9,48,光和,2023-11-21,6380
00712,復華富時不動產,36,0,36,光和,2023-11-21,6380
2352,佳世達,31,1,30,光和,2023-11-21,6380
4916,事欣科,30,1,29,光和,2023-11-21,6380
3703,欣陸,27,0,27,光和,2023-11-21,6380
00923,群益台ESG低碳50,30,7,23,光和,2023-11-21,6380
1504,東元,23,0,23,光和,2023-11-21,6380
3276,宇環,21,0,21,光和,2023-11-21,6380
2608,嘉里大榮,20,0,20,光和,2023-11-21,6380
2745,五福,19,0,19,光和,2023-11-21,6380
1464,得力,17,0,17,光和,2023-11-21,6380
5351,鈺創,17,2,15,光和,2023-11-21,6380
5880,合庫金,15,1,14,光和,2023-11-21,6380
2062,橋椿,13,0,13,光和,2023-11-21,6380
6276,安鈦克,13,0,13,光和,2023-11-21,6380
3059,華晶科,14,2,12,光和,2023-11-21,6380
6104,創惟,13,1,12,光和,2023-11-21,6380
6125,廣運,13,2,11,光和,2023-11-21,6380
1268,漢來美食,10,0,10,光和,2023-11-21,6380
00931B,統一美債20年,10,0,10,光和,2023-11-21,6380
2618,長榮航,91,81,10,光和,2023-11-21,6380
3308,聯德,10,0,10,光和,2023-11-21,6380
4167,松瑞藥,10,0,10,光和,2023-11-21,6380
2002,中鋼,33,24,9,光和,2023-11-21,6380
2329,華泰,24,15,9,光和,2023-11-21,6380
6190,萬泰科,9,0,9,光和,2023-11-21,6380
2419,仲琦,10,2,8,光和,2023-11-21,6380
2897,王道銀行,9,1,8,光和,2023-11-21,6380
5471,松翰,10,2,8,光和,2023-11-21,6380
6185,幃翔,8,0,8,光和,2023-11-21,6380
2609,陽明,9,1,8,光和,2023-11-21,6380
1905,華紙,8,1,7,光和,2023-11-21,6380
2106,建大,8,1,7,光和,2023-11-21,6380
2364,倫飛,7,0,7,光和,2023-11-21,6380
3390,旭軟,19,12,7,光和,2023-11-21,6380
5211,蒙恬,7,0,7,光和,2023-11-21,6380
6191,精成科,7,0,7,光和,2023-11-21,6380
1582,信錦,6,0,6,光和,2023-11-21,6380
2913,農林,6,0,6,光和,2023-11-21,6380
4113,聯上,6,0,6,光和,2023-11-21,6380
4942,嘉彰,6,0,6,光和,2023-11-21,6380
4763,材料-KY,7,2,5,光和,2023-11-21,6380
020022,元大電動車N,5,0,5,光和,2023-11-21,6380
1471,首利,5,0,5,光和,2023-11-21,6380
1598,岱宇,5,0,5,光和,2023-11-21,6380
2355,敬鵬,10,5,5,光和,2023-11-21,6380
2417,圓剛,5,0,5,光和,2023-11-21,6380
3231,緯創,101,17,84,光和,2023-11-22,6380
2883,凱基金,99,17,82,光和,2023-11-22,6380
2353,宏��,78,10,68,光和,2023-11-22,6380
00930,永豐ESG低碳高息,38,0,38,光和,2023-11-22,6380
2352,佳世達,37,2,35,光和,2023-11-22,6380
2701,萬企,93,59,34,光和,2023-11-22,6380
2363,矽統,69,39,30,光和,2023-11-22,6380
2356,英業達,30,6,24,光和,2023-11-22,6380
00679B,元大美債20年,20,0,20,光和,2023-11-22,6380
3013,晟銘電,20,0,20,光和,2023-11-22,6380
6589,台康生技,20,0,20,光和,2023-11-22,6380
3308,聯德,18,0,18,光和,2023-11-22,6380
2314,台揚,17,0,17,光和,2023-11-22,6380
2405,輔信,21,6,15,光和,2023-11-22,6380
00905,FT臺灣Smart,14,0,14,光和,2023-11-22,6380
2365,昆盈,14,0,14,光和,2023-11-22,6380
2618,長榮航,99,85,14,光和,2023-11-22,6380
6156,松上,14,0,14,光和,2023-11-22,6380
00919,群益台灣精選高息,13,0,13,光和,2023-11-22,6380
2371,大同,17,4,13,光和,2023-11-22,6380
3706,神達,13,0,13,光和,2023-11-22,6380
1434,福懋,12,0,12,光和,2023-11-22,6380
00712,復華富時不動產,12,0,12,光和,2023-11-22,6380
2404,漢唐,12,0,12,光和,2023-11-22,6380
6026,福邦證,12,0,12,光和,2023-11-22,6380
3033,威健,11,0,11,光和,2023-11-22,6380
2889,國票金,11,0,11,光和,2023-11-22,6380
3576,聯合再生,11,0,11,光和,2023-11-22,6380
6695,芯鼎,15,4,11,光和,2023-11-22,6380
8240,華宏,11,0,11,光和,2023-11-22,6380
00878,國泰永續高股息,11,0,11,光和,2023-11-22,6380
1402,遠東新,10,0,10,光和,2023-11-22,6380
00888,永豐台灣ESG,10,0,10,光和,2023-11-22,6380
00639,富邦深100,10,0,10,光和,2023-11-22,6380
2358,廷鑫,10,0,10,光和,2023-11-22,6380
2707,晶華,10,0,10,光和,2023-11-22,6380
6190,萬泰科,10,0,10,光和,2023-11-22,6380
6288,聯嘉,10,0,10,光和,2023-11-22,6380
8933,愛地雅,10,0,10,光和,2023-11-22,6380
2301,光寶科,11,1,10,光和,2023-11-22,6380
4105,東洋,10,1,9,光和,2023-11-22,6380
6418,詠昇,9,0,9,光和,2023-11-22,6380
2516,新建,13,5,8,光和,2023-11-22,6380
2888,新光金,8,0,8,光和,2023-11-22,6380
3325,旭品,10,2,8,光和,2023-11-22,6380
4908,前鼎,14,6,8,光和,2023-11-22,6380
5521,工信,8,0,8,光和,2023-11-22,6380
2201,裕隆,7,0,7,光和,2023-11-22,6380
2460,建通,7,0,7,光和,2023-11-22,6380
2610,華航,9,2,7,光和,2023-11-22,6380
2363,矽統,98,24,74,光和,2023-11-23,6380
5452,佶優,58,0,58,光和,2023-11-23,6380
2888,新光金,50,0,50,光和,2023-11-23,6380
2801,彰銀,41,0,41,光和,2023-11-23,6380
2356,英業達,41,2,39,光和,2023-11-23,6380
4960,誠美材,36,0,36,光和,2023-11-23,6380
2887,台新金,33,0,33,光和,2023-11-23,6380
2610,華航,43,12,31,光和,2023-11-23,6380
00936,台新永續高息中小,30,1,29,光和,2023-11-23,6380
2605,新興,25,0,25,光和,2023-11-23,6380
1314,中石化,22,0,22,光和,2023-11-23,6380
00929,復華台灣科技優息,31,10,21,光和,2023-11-23,6380
1471,首利,23,2,21,光和,2023-11-23,6380
6125,廣運,24,4,20,光和,2023-11-23,6380
6443,元晶,23,3,20,光和,2023-11-23,6380
2516,新建,31,13,18,光和,2023-11-23,6380
2457,飛宏,33,16,17,光和,2023-11-23,6380
8277,商丞,17,0,17,光和,2023-11-23,6380
00878,國泰永續高股息,14,0,14,光和,2023-11-23,6380
1319,東陽,14,0,14,光和,2023-11-23,6380
2329,華泰,20,6,14,光和,2023-11-23,6380
00637L,元大滬深300正2,13,0,13,光和,2023-11-23,6380
2606,裕民,13,0,13,光和,2023-11-23,6380
3078,僑威,34,21,13,光和,2023-11-23,6380
5225,東科-KY,13,0,13,光和,2023-11-23,6380
00919,群益台灣精選高息,22,10,12,光和,2023-11-23,6380
2603,長榮,12,0,12,光和,2023-11-23,6380
5521,工信,26,15,11,光和,2023-11-23,6380
8068,全達,18,7,11,光和,2023-11-23,6380
3231,緯創,22,12,10,光和,2023-11-23,6380
00665L,富邦�琤肭磪囓�2,10,0,10,光和,2023-11-23,6380
1447,力鵬,10,0,10,光和,2023-11-23,6380
1584,精剛,10,0,10,光和,2023-11-23,6380
2488,漢平,10,0,10,光和,2023-11-23,6380
2498,宏達電,11,1,10,光和,2023-11-23,6380
4426,利勤,10,0,10,光和,2023-11-23,6380
6231,系微,12,2,10,光和,2023-11-23,6380
6658,聯策,10,0,10,光和,2023-11-23,6380
00669R,國泰美國道瓊反1,9,0,9,光和,2023-11-23,6380
3374,精材,22,13,9,光和,2023-11-23,6380
3715,定穎投控,48,39,9,光和,2023-11-23,6380
2382,廣達,14,6,8,光和,2023-11-23,6380
00905,FT臺灣Smart,8,0,8,光和,2023-11-23,6380
6112,邁達特,8,0,8,光和,2023-11-23,6380
2388,威盛,13,6,7,光和,2023-11-23,6380
1524,耿鼎,10,3,7,光和,2023-11-23,6380
3059,華晶科,15,8,7,光和,2023-11-23,6380
3338,泰碩,11,4,7,光和,2023-11-23,6380
3450,聯鈞,13,6,7,光和,2023-11-23,6380
6026,福邦證,7,0,7,光和,2023-11-23,6380
2618,長榮航,128,0,128,光和,2023-11-24,6380
00885,富邦越南,46,0,46,光和,2023-11-24,6380
3013,晟銘電,46,0,46,光和,2023-11-24,6380
1809,中釉,45,0,45,光和,2023-11-24,6380
5452,佶優,44,0,44,光和,2023-11-24,6380
1609,大亞,48,6,42,光和,2023-11-24,6380
1524,耿鼎,48,12,36,光和,2023-11-24,6380
00878,國泰永續高股息,33,1,32,光和,2023-11-24,6380
00919,群益台灣精選高息,30,0,30,光和,2023-11-24,6380
2867,三商壽,30,0,30,光和,2023-11-24,6380
3701,大眾控,18,0,18,光和,2023-11-24,6380
3706,神達,19,1,18,光和,2023-11-24,6380
5328,華容,18,0,18,光和,2023-11-24,6380
2329,華泰,20,3,17,光和,2023-11-24,6380
4953,緯軟,15,0,15,光和,2023-11-24,6380
00687B,國泰20年美債,12,1,11,光和,2023-11-24,6380
1815,富喬,22,11,11,光和,2023-11-24,6380
2425,承啟,32,21,11,光和,2023-11-24,6380
8040,九暘,12,1,11,光和,2023-11-24,6380
6290,良維,10,0,10,光和,2023-11-24,6380
00905,FT臺灣Smart,10,0,10,光和,2023-11-24,6380
00923,群益台ESG低碳50,10,0,10,光和,2023-11-24,6380
00713,元大台灣高息低波,10,0,10,光和,2023-11-24,6380
2701,萬企,10,0,10,光和,2023-11-24,6380
2915,潤泰全,10,0,10,光和,2023-11-24,6380
4113,聯上,10,0,10,光和,2023-11-24,6380
6234,高僑,10,0,10,光和,2023-11-24,6380
6494,九齊,10,0,10,光和,2023-11-24,6380
8054,安國,11,1,10,光和,2023-11-24,6380
2610,華航,9,0,9,光和,2023-11-24,6380
2812,台中銀,9,0,9,光和,2023-11-24,6380
6235,華孚,10,2,8,光和,2023-11-24,6380
2355,敬鵬,9,1,8,光和,2023-11-24,6380
3006,晶豪科,13,5,8,光和,2023-11-24,6380
3260,威剛,9,1,8,光和,2023-11-24,6380
5351,鈺創,12,4,8,光和,2023-11-24,6380
6560,欣普羅,8,0,8,光和,2023-11-24,6380
2313,華通,40,32,8,光和,2023-11-24,6380
5009,榮剛,13,6,7,光和,2023-11-24,6380
00720B,元大投資級公司債,7,0,7,光和,2023-11-24,6380
2344,華邦電,7,0,7,光和,2023-11-24,6380
2363,矽統,22,15,7,光和,2023-11-24,6380
2460,建通,7,0,7,光和,2023-11-24,6380
2615,萬海,7,0,7,光和,2023-11-24,6380
3094,聯傑,10,3,7,光和,2023-11-24,6380
3338,泰碩,11,4,7,光和,2023-11-24,6380
6026,福邦證,7,0,7,光和,2023-11-24,6380
2201,裕隆,12,5,7,光和,2023-11-24,6380
1598,岱宇,6,0,6,光和,2023-11-24,6380
2369,菱生,6,0,6,光和,2023-11-24,6380
5009,榮剛,176,0,176,光和,2023-11-27,6380
00919,群益台灣精選高息,78,0,78,光和,2023-11-27,6380
3322,建舜電,57,1,56,光和,2023-11-27,6380
5347,世界,63,7,56,光和,2023-11-27,6380
2889,國票金,51,0,51,光和,2023-11-27,6380
4960,誠美材,40,0,40,光和,2023-11-27,6380
2353,宏��,58,21,37,光和,2023-11-27,6380
00751B,元大AAA至A公司債,33,0,33,光和,2023-11-27,6380
00679B,元大美債20年,27,0,27,光和,2023-11-27,6380
2356,英業達,28,1,27,光和,2023-11-27,6380
3013,晟銘電,26,1,25,光和,2023-11-27,6380
00637L,元大滬深300正2,34,10,24,光和,2023-11-27,6380
6244,茂迪,24,0,24,光和,2023-11-27,6380
3308,聯德,22,0,22,光和,2023-11-27,6380
2382,廣達,38,16,22,光和,2023-11-27,6380
2492,華新科,21,0,21,光和,2023-11-27,6380
2329,華泰,52,31,21,光和,2023-11-27,6380
2634,漢翔,21,2,19,光和,2023-11-27,6380
00878,國泰永續高股息,19,0,19,光和,2023-11-27,6380
1337,再生-KY,20,1,19,光和,2023-11-27,6380
2883,凱基金,31,12,19,光和,2023-11-27,6380
2476,鉅祥,20,2,18,光和,2023-11-27,6380
3017,奇鋐,18,1,17,光和,2023-11-27,6380
2618,長榮航,20,3,17,光和,2023-11-27,6380
3234,光環,17,0,17,光和,2023-11-27,6380
5225,東科-KY,18,2,16,光和,2023-11-27,6380
3049,精金,15,0,15,光和,2023-11-27,6380
00929,復華台灣科技優息,44,29,15,光和,2023-11-27,6380
5381,合正,14,0,14,光和,2023-11-27,6380
3231,緯創,45,32,13,光和,2023-11-27,6380
2610,華航,13,0,13,光和,2023-11-27,6380
3701,大眾控,13,0,13,光和,2023-11-27,6380
00882,中信中國高股息,11,0,11,光和,2023-11-27,6380
1815,富喬,15,4,11,光和,2023-11-27,6380
2062,橋椿,17,6,11,光和,2023-11-27,6380
4126,太醫,11,0,11,光和,2023-11-27,6380
00680L,元大美債20正2,10,0,10,光和,2023-11-27,6380
00894,中信小資高價30,10,0,10,光和,2023-11-27,6380
00772B,中信高評級公司債,10,0,10,光和,2023-11-27,6380
1529,樂事綠能,10,0,10,光和,2023-11-27,6380
1532,勤美,10,0,10,光和,2023-11-27,6380
2882,國泰金,13,3,10,光和,2023-11-27,6380
2915,潤泰全,10,0,10,光和,2023-11-27,6380
6173,信昌電,10,0,10,光和,2023-11-27,6380
8403,盛弘,10,0,10,光和,2023-11-27,6380
8429,金麗-KY,10,0,10,光和,2023-11-27,6380
6136,富爾特,10,0,10,光和,2023-11-27,6380
2392,正崴,11,2,9,光和,2023-11-27,6380
3530,晶相光,9,0,9,光和,2023-11-27,6380
8054,安國,10,1,9,光和,2023-11-27,6380
2867,三商壽,70,0,70,光和,2023-11-28,6380
2353,宏��,61,0,61,光和,2023-11-28,6380
4114,健喬,41,2,39,光和,2023-11-28,6380
00712,復華富時不動產,35,0,35,光和,2023-11-28,6380
5347,世界,35,0,35,光和,2023-11-28,6380
1101,台泥,65,37,28,光和,2023-11-28,6380
2601,益航,28,0,28,光和,2023-11-28,6380
5309,系統電,30,3,27,光和,2023-11-28,6380
00894,中信小資高價30,25,0,25,光和,2023-11-28,6380
2363,矽統,44,19,25,光和,2023-11-28,6380
2355,敬鵬,23,0,23,光和,2023-11-28,6380
2888,新光金,21,0,21,光和,2023-11-28,6380
2371,大同,26,6,20,光和,2023-11-28,6380
6111,大宇資,22,2,20,光和,2023-11-28,6380
1701,中化,21,2,19,光和,2023-11-28,6380
3705,永信,14,0,14,光和,2023-11-28,6380
2323,中環,12,0,12,光和,2023-11-28,6380
00882,中信中國高股息,11,0,11,光和,2023-11-28,6380
3231,緯創,23,12,11,光和,2023-11-28,6380
1781,合世,11,0,11,光和,2023-11-28,6380
5315,光聯,11,0,11,光和,2023-11-28,6380
00665L,富邦�琤肭磪囓�2,10,0,10,光和,2023-11-28,6380
00720B,元大投資級公司債,10,0,10,光和,2023-11-28,6380
1529,樂事綠能,10,0,10,光和,2023-11-28,6380
2498,宏達電,10,0,10,光和,2023-11-28,6380
6026,福邦證,10,0,10,光和,2023-11-28,6380
6147,頎邦,15,5,10,光和,2023-11-28,6380
6153,嘉聯益,10,0,10,光和,2023-11-28,6380
6509,聚和,10,0,10,光和,2023-11-28,6380
911868,同方友友-DR,10,0,10,光和,2023-11-28,6380
00687B,國泰20年美債,9,0,9,光和,2023-11-28,6380
2352,佳世達,10,1,9,光和,2023-11-28,6380
3017,奇鋐,9,0,9,光和,2023-11-28,6380
4157,太景*-KY,14,5,9,光和,2023-11-28,6380
2605,新興,15,6,9,光和,2023-11-28,6380
00919,群益台灣精選高息,7,0,7,光和,2023-11-28,6380
2612,中航,9,2,7,光和,2023-11-28,6380
2630,亞航,7,0,7,光和,2023-11-28,6380
3260,威剛,11,4,7,光和,2023-11-28,6380
4171,瑞基,10,3,7,光和,2023-11-28,6380
9958,世紀鋼,7,0,7,光和,2023-11-28,6380
2383,台光電,8,1,7,光和,2023-11-28,6380
5272,笙科,29,22,7,光和,2023-11-28,6380
5351,鈺創,18,11,7,光和,2023-11-28,6380
1609,大亞,8,2,6,光和,2023-11-28,6380
2812,台中銀,6,0,6,光和,2023-11-28,6380
3094,聯傑,6,0,6,光和,2023-11-28,6380
3167,大量,6,0,6,光和,2023-11-28,6380
3530,晶相光,6,0,6,光和,2023-11-28,6380
4550,長佳,6,0,6,光和,2023-11-28,6380
1616,億泰,201,5,196,光和,2023-11-29,6380
00665L,富邦�琤肭磪囓�2,106,0,106,光和,2023-11-29,6380
2460,建通,83,0,83,光和,2023-11-29,6380
2618,長榮航,87,22,65,光和,2023-11-29,6380
2371,大同,34,0,34,光和,2023-11-29,6380
00919,群益台灣精選高息,57,24,33,光和,2023-11-29,6380
4114,健喬,25,0,25,光和,2023-11-29,6380
00712,復華富時不動產,24,0,24,光和,2023-11-29,6380
2888,新光金,24,0,24,光和,2023-11-29,6380
00882,中信中國高股息,22,0,22,光和,2023-11-29,6380
00632R,元大台灣50反1,22,0,22,光和,2023-11-29,6380
6026,福邦證,22,0,22,光和,2023-11-29,6380
3231,緯創,22,1,21,光和,2023-11-29,6380
00907,永豐優息存股,20,0,20,光和,2023-11-29,6380
00936,台新永續高息中小,21,1,20,光和,2023-11-29,6380
8110,華東,22,2,20,光和,2023-11-29,6380
3703,欣陸,19,0,19,光和,2023-11-29,6380
2610,華航,17,0,17,光和,2023-11-29,6380
6770,力積電,24,8,16,光和,2023-11-29,6380
2313,華通,34,18,16,光和,2023-11-29,6380
8429,金麗-KY,15,0,15,光和,2023-11-29,6380
3041,揚智,23,9,14,光和,2023-11-29,6380
1101,台泥,16,3,13,光和,2023-11-29,6380
4960,誠美材,12,0,12,光和,2023-11-29,6380
5880,合庫金,12,1,11,光和,2023-11-29,6380
2883,凱基金,22,11,11,光和,2023-11-29,6380
4113,聯上,11,0,11,光和,2023-11-29,6380
4744,皇將,11,0,11,光和,2023-11-29,6380
5258,虹堡,11,0,11,光和,2023-11-29,6380
00905,FT臺灣Smart,10,0,10,光和,2023-11-29,6380
00650L,復華香港正2,10,0,10,光和,2023-11-29,6380
1582,信錦,10,0,10,光和,2023-11-29,6380
1721,三晃,10,0,10,光和,2023-11-29,6380
2630,亞航,10,0,10,光和,2023-11-29,6380
4105,東洋,10,0,10,光和,2023-11-29,6380
6244,茂迪,15,5,10,光和,2023-11-29,6380
8183,精星,11,1,10,光和,2023-11-29,6380
2014,中鴻,9,0,9,光和,2023-11-29,6380
2399,映泰,33,24,9,光和,2023-11-29,6380
6282,康舒,10,1,9,光和,2023-11-29,6380
2405,輔信,10,1,9,光和,2023-11-29,6380
2002,中鋼,16,8,8,光和,2023-11-29,6380
2891,中信金,7,0,7,光和,2023-11-29,6380
6245,立端,7,0,7,光和,2023-11-29,6380
1609,大亞,7,1,6,光和,2023-11-29,6380
00715L,期街口布蘭特正2,6,0,6,光和,2023-11-29,6380
4916,事欣科,7,1,6,光和,2023-11-29,6380
6173,信昌電,12,6,6,光和,2023-11-29,6380
2357,華碩,6,0,6,光和,2023-11-29,6380
2023,燁輝,5,0,5,光和,2023-11-29,6380
1616,億泰,76,0,76,光和,2023-11-30,6380
2401,凌陽,72,1,71,光和,2023-11-30,6380
2371,大同,60,1,59,光和,2023-11-30,6380
9933,中鼎,50,1,49,光和,2023-11-30,6380
2106,建大,47,1,46,光和,2023-11-30,6380
2332,友訊,43,0,43,光和,2023-11-30,6380
00919,群益台灣精選高息,41,0,41,光和,2023-11-30,6380
00680L,元大美債20正2,40,0,40,光和,2023-11-30,6380
2353,宏��,32,6,26,光和,2023-11-30,6380
3338,泰碩,37,11,26,光和,2023-11-30,6380
3715,定穎投控,29,4,25,光和,2023-11-30,6380
00679B,元大美債20年,23,0,23,光和,2023-11-30,6380
2337,旺宏,60,40,20,光和,2023-11-30,6380
2369,菱生,24,4,20,光和,2023-11-30,6380
3051,力特,24,4,20,光和,2023-11-30,6380
5465,富驊,29,9,20,光和,2023-11-30,6380
00882,中信中國高股息,21,2,19,光和,2023-11-30,6380
3041,揚智,21,2,19,光和,2023-11-30,6380
2610,華航,38,20,18,光和,2023-11-30,6380
3231,緯創,22,7,15,光和,2023-11-30,6380
3450,聯鈞,18,4,14,光和,2023-11-30,6380
1325,恆大,14,0,14,光和,2023-11-30,6380
6257,矽格,19,5,14,光和,2023-11-30,6380
2603,長榮,11,0,11,光和,2023-11-30,6380
2618,長榮航,27,16,11,光和,2023-11-30,6380
6589,台康生技,11,0,11,光和,2023-11-30,6380
00673R,期元大S＆P原油反1,10,0,10,光和,2023-11-30,6380
00929,復華台灣科技優息,25,15,10,光和,2023-11-30,6380
1733,五鼎,10,0,10,光和,2023-11-30,6380
2104,國際中橡,10,0,10,光和,2023-11-30,6380
3432,台端,10,0,10,光和,2023-11-30,6380
3540,曜越,10,0,10,光和,2023-11-30,6380
4105,東洋,10,0,10,光和,2023-11-30,6380
6026,福邦證,10,0,10,光和,2023-11-30,6380
6147,頎邦,10,0,10,光和,2023-11-30,6380
6560,欣普羅,10,0,10,光和,2023-11-30,6380
1301,台塑,9,0,9,光和,2023-11-30,6380
2816,旺旺保,9,0,9,光和,2023-11-30,6380
5272,笙科,13,4,9,光和,2023-11-30,6380
6126,信音,9,0,9,光和,2023-11-30,6380
1718,中纖,8,0,8,光和,2023-11-30,6380
4908,前鼎,16,8,8,光和,2023-11-30,6380
8068,全達,9,1,8,光和,2023-11-30,6380
9919,康那香,24,16,8,光和,2023-11-30,6380
2492,華新科,15,7,8,光和,2023-11-30,6380
1701,中化,7,0,7,光和,2023-11-30,6380
2062,橋椿,7,0,7,光和,2023-11-30,6380
2258,鴻華先進-創,7,0,7,光和,2023-11-30,6380
5328,華容,85,78,7,光和,2023-11-30,6380
5521,工信,7,0,7,光和,2023-11-30,6380
2888,新光金,88,3,85,光和,2023-12-01,6380
3013,晟銘電,83,12,71,光和,2023-12-01,6380
5347,世界,61,8,53,光和,2023-12-01,6380
00919,群益台灣精選高息,45,0,45,光和,2023-12-01,6380
2401,凌陽,46,1,45,光和,2023-12-01,6380
00892,富邦台灣半導體,40,0,40,光和,2023-12-01,6380
3450,聯鈞,43,9,34,光和,2023-12-01,6380
2867,三商壽,50,18,32,光和,2023-12-01,6380
3706,神達,30,1,29,光和,2023-12-01,6380
2884,玉山金,27,0,27,光和,2023-12-01,6380
2367,燿華,53,27,26,光和,2023-12-01,6380
6770,力積電,35,9,26,光和,2023-12-01,6380
2618,長榮航,37,12,25,光和,2023-12-01,6380
3703,欣陸,25,0,25,光和,2023-12-01,6380
3710,連展投控,25,0,25,光和,2023-12-01,6380
2353,宏��,21,1,20,光和,2023-12-01,6380
00637L,元大滬深300正2,18,0,18,光和,2023-12-01,6380
1528,恩德,20,2,18,光和,2023-12-01,6380
6695,芯鼎,21,3,18,光和,2023-12-01,6380
00929,復華台灣科技優息,23,6,17,光和,2023-12-01,6380
00687B,國泰20年美債,16,0,16,光和,2023-12-01,6380
4550,長佳,16,0,16,光和,2023-12-01,6380
00932,兆豐永續高息等權,15,0,15,光和,2023-12-01,6380
3266,昇陽,15,0,15,光和,2023-12-01,6380
6589,台康生技,15,1,14,光和,2023-12-01,6380
5880,合庫金,11,0,11,光和,2023-12-01,6380
2886,兆豐金,11,0,11,光和,2023-12-01,6380
3122,笙泉,13,2,11,光和,2023-12-01,6380
3373,熱映,24,13,11,光和,2023-12-01,6380
4113,聯上,11,0,11,光和,2023-12-01,6380
8048,德勝,11,0,11,光和,2023-12-01,6380
00878,國泰永續高股息,10,0,10,光和,2023-12-01,6380
2880,華南金,11,1,10,光和,2023-12-01,6380
00891,中信關鍵半導體,10,0,10,光和,2023-12-01,6380
2838,聯邦銀,10,0,10,光和,2023-12-01,6380
3050,鈺德,12,2,10,光和,2023-12-01,6380
3287,廣寰科,10,0,10,光和,2023-12-01,6380
6016,康和證,10,0,10,光和,2023-12-01,6380
8936,國統,11,2,9,光和,2023-12-01,6380
2363,矽統,19,11,8,光和,2023-12-01,6380
2376,技嘉,10,2,8,光和,2023-12-01,6380
2488,漢平,9,1,8,光和,2023-12-01,6380
2617,台航,10,2,8,光和,2023-12-01,6380
2915,潤泰全,8,0,8,光和,2023-12-01,6380
5608,四維航,10,2,8,光和,2023-12-01,6380
2801,彰銀,7,0,7,光和,2023-12-01,6380
00720B,元大投資級公司債,7,0,7,光和,2023-12-01,6380
2009,第一銅,8,1,7,光和,2023-12-01,6380
2115,六暉-KY,7,0,7,光和,2023-12-01,6380
2364,倫飛,7,0,7,光和,2023-12-01,6380
3013,晟銘電,270,33,237,光和,2023-12-04,6380
00929,復華台灣科技優息,106,17,89,光和,2023-12-04,6380
2353,宏��,97,14,83,光和,2023-12-04,6380
2883,凱基金,77,4,73,光和,2023-12-04,6380
2601,益航,84,22,62,光和,2023-12-04,6380
6005,群益證,61,0,61,光和,2023-12-04,6380
2344,華邦電,80,27,53,光和,2023-12-04,6380
9919,康那香,62,13,49,光和,2023-12-04,6380
3041,揚智,46,3,43,光和,2023-12-04,6380
1605,華新,46,4,42,光和,2023-12-04,6380
3540,曜越,42,1,41,光和,2023-12-04,6380
2313,華通,46,5,41,光和,2023-12-04,6380
2329,華泰,74,40,34,光和,2023-12-04,6380
2888,新光金,30,0,30,光和,2023-12-04,6380
3264,欣銓,41,12,29,光和,2023-12-04,6380
6244,茂迪,29,0,29,光和,2023-12-04,6380
3481,群創,64,35,29,光和,2023-12-04,6380
6282,康舒,31,3,28,光和,2023-12-04,6380
1522,堤維西,28,2,26,光和,2023-12-04,6380
2867,三商壽,25,0,25,光和,2023-12-04,6380
2363,矽統,29,5,24,光和,2023-12-04,6380
00753L,中信中國50正2,23,0,23,光和,2023-12-04,6380
1524,耿鼎,23,0,23,光和,2023-12-04,6380
00919,群益台灣精選高息,22,0,22,光和,2023-12-04,6380
1319,東陽,21,1,20,光和,2023-12-04,6380
4960,誠美材,20,0,20,光和,2023-12-04,6380
6509,聚和,20,0,20,光和,2023-12-04,6380
2312,金寶,33,14,19,光和,2023-12-04,6380
2405,輔信,20,1,19,光和,2023-12-04,6380
00715L,期街口布蘭特正2,18,0,18,光和,2023-12-04,6380
4167,松瑞藥,22,5,17,光和,2023-12-04,6380
6191,精成科,33,19,14,光和,2023-12-04,6380
00642U,期元大S＆P石油,14,0,14,光和,2023-12-04,6380
8096,擎亞,14,0,14,光和,2023-12-04,6380
6122,擎邦,13,0,13,光和,2023-12-04,6380
2105,正新,14,1,13,光和,2023-12-04,6380
6443,元晶,25,12,13,光和,2023-12-04,6380
3317,尼克森,13,0,13,光和,2023-12-04,6380
2356,英業達,14,2,12,光和,2023-12-04,6380
2609,陽明,45,33,12,光和,2023-12-04,6380
6589,台康生技,12,0,12,光和,2023-12-04,6380
1314,中石化,11,0,11,光和,2023-12-04,6380
2610,華航,22,11,11,光和,2023-12-04,6380
5351,鈺創,13,2,11,光和,2023-12-04,6380
2421,建準,10,0,10,光和,2023-12-04,6380
2801,彰銀,10,0,10,光和,2023-12-04,6380
4121,優盛,10,0,10,光和,2023-12-04,6380
6026,福邦證,10,0,10,光和,2023-12-04,6380
9946,三發地產,10,0,10,光和,2023-12-04,6380
1504,東元,10,1,9,光和,2023-12-04,6380
1714,和桐,257,0,257,光和,2023-12-05,6380
5009,榮剛,140,0,140,光和,2023-12-05,6380
2610,華航,133,0,133,光和,2023-12-05,6380
3050,鈺德,99,1,98,光和,2023-12-05,6380
5347,世界,90,2,88,光和,2023-12-05,6380
00937B,群益ESG投等債20,86,1,85,光和,2023-12-05,6380
5608,四維航,131,52,79,光和,2023-12-05,6380
4960,誠美材,67,12,55,光和,2023-12-05,6380
00882,中信中國高股息,53,0,53,光和,2023-12-05,6380
00753L,中信中國50正2,53,0,53,光和,2023-12-05,6380
1605,華新,59,7,52,光和,2023-12-05,6380
5452,佶優,48,1,47,光和,2023-12-05,6380
2883,凱基金,45,6,39,光和,2023-12-05,6380
00878,國泰永續高股息,38,0,38,光和,2023-12-05,6380
00637L,元大滬深300正2,46,10,36,光和,2023-12-05,6380
2337,旺宏,30,0,30,光和,2023-12-05,6380
2353,宏��,28,0,28,光和,2023-12-05,6380
2888,新光金,27,0,27,光和,2023-12-05,6380
2356,英業達,28,3,25,光和,2023-12-05,6380
2462,良得電,22,0,22,光和,2023-12-05,6380
6125,廣運,23,1,22,光和,2023-12-05,6380
2601,益航,77,56,21,光和,2023-12-05,6380
1732,毛寶,20,0,20,光和,2023-12-05,6380
6598,ABC-KY,20,0,20,光和,2023-12-05,6380
8429,金麗-KY,20,0,20,光和,2023-12-05,6380
8086,宏捷科,33,13,20,光和,2023-12-05,6380
1815,富喬,24,5,19,光和,2023-12-05,6380
2344,華邦電,19,0,19,光和,2023-12-05,6380
3622,洋華,23,5,18,光和,2023-12-05,6380
6282,康舒,22,5,17,光和,2023-12-05,6380
3231,緯創,23,6,17,光和,2023-12-05,6380
6152,百一,16,0,16,光和,2023-12-05,6380
00673R,期元大S＆P原油反1,15,0,15,光和,2023-12-05,6380
1785,光洋科,15,0,15,光和,2023-12-05,6380
2606,裕民,55,41,14,光和,2023-12-05,6380
1524,耿鼎,14,0,14,光和,2023-12-05,6380
2103,台橡,13,0,13,光和,2023-12-05,6380
2105,正新,18,7,11,光和,2023-12-05,6380
00632R,元大台灣50反1,10,0,10,光和,2023-12-05,6380
00639,富邦深100,10,0,10,光和,2023-12-05,6380
00772B,中信高評級公司債,10,0,10,光和,2023-12-05,6380
1316,上曜,10,0,10,光和,2023-12-05,6380
2515,中工,10,0,10,光和,2023-12-05,6380
4564,元翎,10,0,10,光和,2023-12-05,6380
6509,聚和,10,0,10,光和,2023-12-05,6380
2409,友達,13,3,10,光和,2023-12-05,6380
1531,高林股,10,1,9,光和,2023-12-05,6380
2390,云辰,9,0,9,光和,2023-12-05,6380
2489,瑞軒,9,0,9,光和,2023-12-05,6380
2498,宏達電,10,1,9,光和,2023-12-05,6380
2867,三商壽,130,0,130,光和,2023-12-06,6380
00937B,群益ESG投等債20,119,1,118,光和,2023-12-06,6380
1714,和桐,118,0,118,光和,2023-12-06,6380
1455,集盛,110,0,110,光和,2023-12-06,6380
00688L,國泰20年美債正2,100,0,100,光和,2023-12-06,6380
3481,群創,98,6,92,光和,2023-12-06,6380
5009,榮剛,60,1,59,光和,2023-12-06,6380
2883,凱基金,80,26,54,光和,2023-12-06,6380
2845,遠東銀,50,1,49,光和,2023-12-06,6380
00712,復華富時不動產,47,2,45,光和,2023-12-06,6380
4961,天鈺,38,1,37,光和,2023-12-06,6380
2371,大同,41,8,33,光和,2023-12-06,6380
3260,威剛,38,8,30,光和,2023-12-06,6380
6233,旺玖,36,6,30,光和,2023-12-06,6380
00934,中信成長高股息,31,3,28,光和,2023-12-06,6380
5328,華容,43,18,25,光和,2023-12-06,6380
6443,元晶,28,5,23,光和,2023-12-06,6380
4906,正文,22,0,22,光和,2023-12-06,6380
6026,福邦證,22,0,22,光和,2023-12-06,6380
00933B,國泰10Y+金融債,21,0,21,光和,2023-12-06,6380
2412,中華電,21,0,21,光和,2023-12-06,6380
00665L,富邦�琤肭磪囓�2,20,0,20,光和,2023-12-06,6380
2010,春源,20,0,20,光和,2023-12-06,6380
4960,誠美材,20,0,20,光和,2023-12-06,6380
00878,國泰永續高股息,28,9,19,光和,2023-12-06,6380
3176,基亞,16,0,16,光和,2023-12-06,6380
5521,工信,20,4,16,光和,2023-12-06,6380
2409,友達,15,0,15,光和,2023-12-06,6380
3266,昇陽,15,0,15,光和,2023-12-06,6380
4766,南寶,15,0,15,光和,2023-12-06,6380
6770,力積電,15,0,15,光和,2023-12-06,6380
4915,致伸,16,2,14,光和,2023-12-06,6380
00919,群益台灣精選高息,15,2,13,光和,2023-12-06,6380
2303,聯電,13,0,13,光和,2023-12-06,6380
00637L,元大滬深300正2,33,20,13,光和,2023-12-06,6380
8048,德勝,13,0,13,光和,2023-12-06,6380
1513,中興電,17,5,12,光和,2023-12-06,6380
1522,堤維西,23,11,12,光和,2023-12-06,6380
1701,中化,12,0,12,光和,2023-12-06,6380
2354,鴻準,13,1,12,光和,2023-12-06,6380
6499,益安,12,0,12,光和,2023-12-06,6380
8215,明基材,12,0,12,光和,2023-12-06,6380
1616,億泰,13,2,11,光和,2023-12-06,6380
2355,敬鵬,26,15,11,光和,2023-12-06,6380
2611,志信,11,0,11,光和,2023-12-06,6380
00753L,中信中國50正2,10,0,10,光和,2023-12-06,6380
00888,永豐台灣ESG,10,0,10,光和,2023-12-06,6380
1215,卜蜂,10,0,10,光和,2023-12-06,6380
1789,神隆,10,0,10,光和,2023-12-06,6380
2062,橋椿,10,0,10,光和,2023-12-06,6380
00937B,群益ESG投等債20,119,4,115,光和,2023-12-07,6380
5009,榮剛,110,1,109,光和,2023-12-07,6380
00919,群益台灣精選高息,107,0,107,光和,2023-12-07,6380
2610,華航,111,19,92,光和,2023-12-07,6380
3013,晟銘電,130,56,74,光和,2023-12-07,6380
00712,復華富時不動產,68,2,66,光和,2023-12-07,6380
1609,大亞,76,20,56,光和,2023-12-07,6380
00680L,元大美債20正2,50,0,50,光和,2023-12-07,6380
00933B,國泰10Y+金融債,45,0,45,光和,2023-12-07,6380
3322,建舜電,44,0,44,光和,2023-12-07,6380
1522,堤維西,51,17,34,光和,2023-12-07,6380
1605,華新,46,14,32,光和,2023-12-07,6380
9946,三發地產,32,0,32,光和,2023-12-07,6380
2399,映泰,39,10,29,光和,2023-12-07,6380
00882,中信中國高股息,28,0,28,光和,2023-12-07,6380
4543,萬在,27,2,25,光和,2023-12-07,6380
5269,祥碩,25,0,25,光和,2023-12-07,6380
3041,揚智,114,91,23,光和,2023-12-07,6380
00897,富邦基因免疫生技,20,0,20,光和,2023-12-07,6380
4129,聯合,20,0,20,光和,2023-12-07,6380
1503,士電,29,10,19,光和,2023-12-07,6380
2641,正德,21,2,19,光和,2023-12-07,6380
2606,裕民,40,22,18,光和,2023-12-07,6380
2468,華經,19,2,17,光和,2023-12-07,6380
8936,國統,91,74,17,光和,2023-12-07,6380
2603,長榮,15,0,15,光和,2023-12-07,6380
6282,康舒,16,1,15,光和,2023-12-07,6380
8111,立��,15,0,15,光和,2023-12-07,6380
00715L,期街口布蘭特正2,19,5,14,光和,2023-12-07,6380
6695,芯鼎,14,0,14,光和,2023-12-07,6380
2313,華通,23,11,12,光和,2023-12-07,6380
00885,富邦越南,12,0,12,光和,2023-12-07,6380
1785,光洋科,12,0,12,光和,2023-12-07,6380
2612,中航,12,0,12,光和,2023-12-07,6380
4157,太景*-KY,12,0,12,光和,2023-12-07,6380
6112,邁達特,12,0,12,光和,2023-12-07,6380
6167,久正,12,0,12,光和,2023-12-07,6380
00878,國泰永續高股息,11,0,11,光和,2023-12-07,6380
1529,樂事綠能,21,10,11,光和,2023-12-07,6380
1568,倉佑,12,1,11,光和,2023-12-07,6380
2359,所羅門,12,1,11,光和,2023-12-07,6380
3027,盛達,12,1,11,光和,2023-12-07,6380
8163,達方,11,0,11,光和,2023-12-07,6380
2330,台積電,11,1,10,光和,2023-12-07,6380
3715,定穎投控,10,0,10,光和,2023-12-07,6380
4105,東洋,10,0,10,光和,2023-12-07,6380
3006,晶豪科,10,0,10,光和,2023-12-07,6380
1455,集盛,10,0,10,光和,2023-12-07,6380
1471,首利,10,0,10,光和,2023-12-07,6380
1504,東元,14,4,10,光和,2023-12-07,6380
00919,群益台灣精選高息,190,22,168,光和,2023-12-08,6380
00929,復華台灣科技優息,132,6,126,光和,2023-12-08,6380
2889,國票金,80,0,80,光和,2023-12-08,6380
2031,新光鋼,75,1,74,光和,2023-12-08,6380
00687B,國泰20年美債,69,5,64,光和,2023-12-08,6380
00655L,國泰中國A50正2,58,0,58,光和,2023-12-08,6380
3013,晟銘電,66,16,50,光和,2023-12-08,6380
6016,康和證,50,0,50,光和,2023-12-08,6380
00937B,群益ESG投等債20,60,11,49,光和,2023-12-08,6380
3390,旭軟,49,1,48,光和,2023-12-08,6380
00720B,元大投資級公司債,48,0,48,光和,2023-12-08,6380
4167,松瑞藥,40,0,40,光和,2023-12-08,6380
2363,矽統,52,14,38,光和,2023-12-08,6380
00882,中信中國高股息,37,2,35,光和,2023-12-08,6380
2888,新光金,34,0,34,光和,2023-12-08,6380
2365,昆盈,31,0,31,光和,2023-12-08,6380
2329,華泰,33,7,26,光和,2023-12-08,6380
2356,英業達,44,20,24,光和,2023-12-08,6380
1319,東陽,21,0,21,光和,2023-12-08,6380
2867,三商壽,21,0,21,光和,2023-12-08,6380
5452,佶優,21,0,21,光和,2023-12-08,6380
00679B,元大美債20年,18,0,18,光和,2023-12-08,6380
2641,正德,28,12,16,光和,2023-12-08,6380
6152,百一,16,0,16,光和,2023-12-08,6380
8049,晶采,16,0,16,光和,2023-12-08,6380
00753L,中信中國50正2,15,0,15,光和,2023-12-08,6380
4766,南寶,15,0,15,光和,2023-12-08,6380
2364,倫飛,19,5,14,光和,2023-12-08,6380
4961,天鈺,14,0,14,光和,2023-12-08,6380
9946,三發地產,14,0,14,光和,2023-12-08,6380
1514,亞力,26,12,14,光和,2023-12-08,6380
2605,新興,23,12,11,光和,2023-12-08,6380
1605,華新,19,8,11,光和,2023-12-08,6380
1609,大亞,23,12,11,光和,2023-12-08,6380
1714,和桐,11,0,11,光和,2023-12-08,6380
1303,南亞,10,0,10,光和,2023-12-08,6380
00935,野村臺灣新科技50,10,0,10,光和,2023-12-08,6380
00897,富邦基因免疫生技,10,0,10,光和,2023-12-08,6380
00725B,國泰投資級公司債,10,0,10,光和,2023-12-08,6380
00665L,富邦�琤肭磪囓�2,10,0,10,光和,2023-12-08,6380
00639,富邦深100,10,0,10,光和,2023-12-08,6380
1504,東元,10,0,10,光和,2023-12-08,6380
1701,中化,10,0,10,光和,2023-12-08,6380
1718,中纖,10,0,10,光和,2023-12-08,6380
1905,華紙,10,0,10,光和,2023-12-08,6380
2034,允強,10,0,10,光和,2023-12-08,6380
2482,連宇,10,0,10,光和,2023-12-08,6380
2612,中航,10,0,10,光和,2023-12-08,6380
3050,鈺德,10,0,10,光和,2023-12-08,6380
3062,建漢,10,0,10,光和,2023-12-08,6380
00632R,元大台灣50反1,350,0,350,光和,2023-12-11,6380
3013,晟銘電,221,18,203,光和,2023-12-11,6380
2888,新光金,168,23,145,光和,2023-12-11,6380
00919,群益台灣精選高息,119,10,109,光和,2023-12-11,6380
6208,日揚,75,0,75,光和,2023-12-11,6380
4960,誠美材,60,0,60,光和,2023-12-11,6380
5351,鈺創,60,9,51,光和,2023-12-11,6380
4114,健喬,47,0,47,光和,2023-12-11,6380
00687B,國泰20年美債,51,4,47,光和,2023-12-11,6380
00929,復華台灣科技優息,44,1,43,光和,2023-12-11,6380
2365,昆盈,41,2,39,光和,2023-12-11,6380
6284,佳邦,39,1,38,光和,2023-12-11,6380
2388,威盛,37,7,30,光和,2023-12-11,6380
00900,富邦特選高股息30,40,10,30,光和,2023-12-11,6380
00882,中信中國高股息,27,1,26,光和,2023-12-11,6380
3078,僑威,24,0,24,光和,2023-12-11,6380
2605,新興,26,3,23,光和,2023-12-11,6380
1471,首利,24,2,22,光和,2023-12-11,6380
2329,華泰,40,18,22,光和,2023-12-11,6380
6231,系微,37,16,21,光和,2023-12-11,6380
00706L,期元大S＆P日圓正2,20,0,20,光和,2023-12-11,6380
2612,中航,20,0,20,光和,2023-12-11,6380
2701,萬企,20,0,20,光和,2023-12-11,6380
5324,士開,20,0,20,光和,2023-12-11,6380
00753L,中信中國50正2,21,3,18,光和,2023-12-11,6380
2409,友達,22,4,18,光和,2023-12-11,6380
2615,萬海,23,5,18,光和,2023-12-11,6380
4967,十銓,25,7,18,光和,2023-12-11,6380
8936,國統,29,11,18,光和,2023-12-11,6380
6547,高端疫苗,17,0,17,光和,2023-12-11,6380
3615,安可,17,0,17,光和,2023-12-11,6380
5426,振發,34,17,17,光和,2023-12-11,6380
2609,陽明,18,3,15,光和,2023-12-11,6380
2891,中信金,14,0,14,光和,2023-12-11,6380
1101,台泥,15,1,14,光和,2023-12-11,6380
2314,台揚,18,4,14,光和,2023-12-11,6380
2392,正崴,25,11,14,光和,2023-12-11,6380
6806,森崴能源,14,1,13,光和,2023-12-11,6380
1714,和桐,12,0,12,光和,2023-12-11,6380
2323,中環,12,0,12,光和,2023-12-11,6380
00679B,元大美債20年,11,0,11,光和,2023-12-11,6380
3231,緯創,17,6,11,光和,2023-12-11,6380
2002,中鋼,11,0,11,光和,2023-12-11,6380
3062,建漢,12,1,11,光和,2023-12-11,6380
3444,利機,11,0,11,光和,2023-12-11,6380
00720B,元大投資級公司債,11,0,11,光和,2023-12-11,6380
1304,台聚,10,0,10,光和,2023-12-11,6380
1444,力麗,10,0,10,光和,2023-12-11,6380
6742,澤米,14,4,10,光和,2023-12-11,6380
1905,華紙,21,11,10,光和,2023-12-11,6380
00632R,元大台灣50反1,376,160,216,光和,2023-12-12,6380
00934,中信成長高股息,196,0,196,光和,2023-12-12,6380
4960,誠美材,110,0,110,光和,2023-12-12,6380
2002,中鋼,55,0,55,光和,2023-12-12,6380
2371,大同,62,8,54,光和,2023-12-12,6380
00687B,國泰20年美債,44,0,44,光和,2023-12-12,6380
2402,毅嘉,45,5,40,光和,2023-12-12,6380
8436,大江,38,1,37,光和,2023-12-12,6380
00918,大華優利高填息30,33,0,33,光和,2023-12-12,6380
3231,緯創,32,1,31,光和,2023-12-12,6380
2399,映泰,31,0,31,光和,2023-12-12,6380
00885,富邦越南,30,0,30,光和,2023-12-12,6380
8215,明基材,30,0,30,光和,2023-12-12,6380
2609,陽明,29,1,28,光和,2023-12-12,6380
1609,大亞,30,4,26,光和,2023-12-12,6380
00936,台新永續高息中小,25,1,24,光和,2023-12-12,6380
00679B,元大美債20年,21,0,21,光和,2023-12-12,6380
2034,允強,21,0,21,光和,2023-12-12,6380
3322,建舜電,21,0,21,光和,2023-12-12,6380
1449,佳和,20,0,20,光和,2023-12-12,6380
2606,裕民,21,1,20,光和,2023-12-12,6380
8213,志超,20,0,20,光和,2023-12-12,6380
8011,台通,52,33,19,光和,2023-12-12,6380
1522,堤維西,19,1,18,光和,2023-12-12,6380
1905,華紙,18,0,18,光和,2023-12-12,6380
5452,佶優,18,0,18,光和,2023-12-12,6380
1714,和桐,17,0,17,光和,2023-12-12,6380
2610,華航,21,4,17,光和,2023-12-12,6380
4420,光明,17,0,17,光和,2023-12-12,6380
00680L,元大美債20正2,15,0,15,光和,2023-12-12,6380
4114,健喬,15,0,15,光和,2023-12-12,6380
4909,新復興,16,3,13,光和,2023-12-12,6380
3450,聯鈞,15,3,12,光和,2023-12-12,6380
2363,矽統,25,14,11,光和,2023-12-12,6380
2611,志信,11,0,11,光和,2023-12-12,6380
3338,泰碩,19,8,11,光和,2023-12-12,6380
5355,佳總,12,1,11,光和,2023-12-12,6380
1305,華夏,10,0,10,光和,2023-12-12,6380
00725B,國泰投資級公司債,10,0,10,光和,2023-12-12,6380
1447,力鵬,11,1,10,光和,2023-12-12,6380
2328,廣宇,10,0,10,光和,2023-12-12,6380
2409,友達,10,0,10,光和,2023-12-12,6380
3013,晟銘電,12,2,10,光和,2023-12-12,6380
3607,谷崧,10,0,10,光和,2023-12-12,6380
4543,萬在,10,0,10,光和,2023-12-12,6380
6116,彩晶,10,0,10,光和,2023-12-12,6380
6282,康舒,10,0,10,光和,2023-12-12,6380
9912,偉聯,10,0,10,光和,2023-12-12,6380
9934,成霖,10,0,10,光和,2023-12-12,6380
1618,合機,29,20,9,光和,2023-12-12,6380
00929,復華台灣科技優息,157,45,112,光和,2023-12-13,6380
00934,中信成長高股息,104,0,104,光和,2023-12-13,6380
8936,國統,89,12,77,光和,2023-12-13,6380
2867,三商壽,75,0,75,光和,2023-12-13,6380
5309,系統電,54,1,53,光和,2023-12-13,6380
00680L,元大美債20正2,50,0,50,光和,2023-12-13,6380
2888,新光金,43,0,43,光和,2023-12-13,6380
2605,新興,43,6,37,光和,2023-12-13,6380
00918,大華優利高填息30,37,0,37,光和,2023-12-13,6380
2002,中鋼,34,1,33,光和,2023-12-13,6380
00882,中信中國高股息,31,0,31,光和,2023-12-13,6380
2020,美亞,30,0,30,光和,2023-12-13,6380
2367,燿華,27,0,27,光和,2023-12-13,6380
3481,群創,37,10,27,光和,2023-12-13,6380
2419,仲琦,33,7,26,光和,2023-12-13,6380
2344,華邦電,25,0,25,光和,2023-12-13,6380
6770,力積電,29,5,24,光和,2023-12-13,6380
8436,大江,24,0,24,光和,2023-12-13,6380
00715L,期街口布蘭特正2,32,10,22,光和,2023-12-13,6380
00738U,期元大道瓊白銀,20,0,20,光和,2023-12-13,6380
1582,信錦,20,0,20,光和,2023-12-13,6380
2855,統一證,20,0,20,光和,2023-12-13,6380
00687B,國泰20年美債,16,0,16,光和,2023-12-13,6380
2915,潤泰全,15,0,15,光和,2023-12-13,6380
8011,台通,26,11,15,光和,2023-12-13,6380
00642U,期元大S＆P石油,14,0,14,光和,2023-12-13,6380
6139,亞翔,17,3,14,光和,2023-12-13,6380
00933B,國泰10Y+金融債,13,0,13,光和,2023-12-13,6380
1303,南亞,13,0,13,光和,2023-12-13,6380
6588,東典光電,13,0,13,光和,2023-12-13,6380
2358,廷鑫,12,0,12,光和,2023-12-13,6380
2468,華經,13,1,12,光和,2023-12-13,6380
2486,一詮,13,1,12,光和,2023-12-13,6380
2363,矽統,22,11,11,光和,2023-12-13,6380
3390,旭軟,12,1,11,光和,2023-12-13,6380
4105,東洋,11,0,11,光和,2023-12-13,6380
6182,合晶,15,4,11,光和,2023-12-13,6380
2201,裕隆,10,0,10,光和,2023-12-13,6380
00885,富邦越南,10,0,10,光和,2023-12-13,6380
1402,遠東新,10,0,10,光和,2023-12-13,6380
1444,力麗,10,0,10,光和,2023-12-13,6380
1721,三晃,10,0,10,光和,2023-12-13,6380
1809,中釉,10,0,10,光和,2023-12-13,6380
2323,中環,10,0,10,光和,2023-12-13,6380
2615,萬海,10,0,10,光和,2023-12-13,6380
2701,萬企,10,0,10,光和,2023-12-13,6380
5465,富驊,10,0,10,光和,2023-12-13,6380
6282,康舒,23,13,10,光和,2023-12-13,6380
8215,明基材,10,0,10,光和,2023-12-13,6380
9912,偉聯,10,0,10,光和,2023-12-13,6380
4114,健喬,100,0,100,光和,2023-12-14,6380
00680L,元大美債20正2,63,1,62,光和,2023-12-14,6380
00648R,元大S＆P500反1,58,0,58,光和,2023-12-14,6380
4960,誠美材,58,0,58,光和,2023-12-14,6380
2365,昆盈,125,69,56,光和,2023-12-14,6380
00929,復華台灣科技優息,142,88,54,光和,2023-12-14,6380
00637L,元大滬深300正2,43,0,43,光和,2023-12-14,6380
00933B,國泰10Y+金融債,46,5,41,光和,2023-12-14,6380
2423,固緯,40,0,40,光和,2023-12-14,6380
2329,華泰,89,50,39,光和,2023-12-14,6380
2332,友訊,35,0,35,光和,2023-12-14,6380
00751B,元大AAA至A公司債,50,22,28,光和,2023-12-14,6380
2405,輔信,27,0,27,光和,2023-12-14,6380
2324,仁寶,45,19,26,光和,2023-12-14,6380
2352,佳世達,25,0,25,光和,2023-12-14,6380
2425,承啟,28,3,25,光和,2023-12-14,6380
1609,大亞,27,4,23,光和,2023-12-14,6380
00919,群益台灣精選高息,34,12,22,光和,2023-12-14,6380
1714,和桐,20,0,20,光和,2023-12-14,6380
3002,歐格,20,0,20,光和,2023-12-14,6380
5309,系統電,20,0,20,光和,2023-12-14,6380
00882,中信中國高股息,18,0,18,光和,2023-12-14,6380
2392,正崴,40,23,17,光和,2023-12-14,6380
2313,華通,26,10,16,光和,2023-12-14,6380
00934,中信成長高股息,16,0,16,光和,2023-12-14,6380
1101,台泥,16,0,16,光和,2023-12-14,6380
8011,台通,18,2,16,光和,2023-12-14,6380
2615,萬海,21,5,16,光和,2023-12-14,6380
00937B,群益ESG投等債20,15,0,15,光和,2023-12-14,6380
00903,富邦元宇宙,15,0,15,光和,2023-12-14,6380
2460,建通,13,0,13,光和,2023-12-14,6380
2498,宏達電,37,24,13,光和,2023-12-14,6380
4915,致伸,13,0,13,光和,2023-12-14,6380
5258,虹堡,13,0,13,光和,2023-12-14,6380
6916,華凌,13,0,13,光和,2023-12-14,6380
2002,中鋼,16,3,13,光和,2023-12-14,6380
2359,所羅門,14,2,12,光和,2023-12-14,6380
2369,菱生,12,0,12,光和,2023-12-14,6380
5521,工信,17,5,12,光和,2023-12-14,6380
2344,華邦電,23,12,11,光和,2023-12-14,6380
3055,蔚華科,11,0,11,光和,2023-12-14,6380
6770,力積電,15,4,11,光和,2023-12-14,6380
2883B,凱基金乙特,11,0,11,光和,2023-12-14,6380
00923,群益台ESG低碳50,10,0,10,光和,2023-12-14,6380
00673R,期元大S＆P原油反1,10,0,10,光和,2023-12-14,6380
00639,富邦深100,10,0,10,光和,2023-12-14,6380
00753L,中信中國50正2,10,0,10,光和,2023-12-14,6380
2066,世德,10,0,10,光和,2023-12-14,6380
4953,緯軟,11,1,10,光和,2023-12-14,6380
6122,擎邦,10,0,10,光和,2023-12-14,6380
2356,英業達,346,118,228,光和,2023-12-15,6380
2363,矽統,158,45,113,光和,2023-12-15,6380
00688L,國泰20年美債正2,100,0,100,光和,2023-12-15,6380
3231,緯創,67,1,66,光和,2023-12-15,6380
6005,群益證,60,0,60,光和,2023-12-15,6380
1718,中纖,49,0,49,光和,2023-12-15,6380
2352,佳世達,45,0,45,光和,2023-12-15,6380
00918,大華優利高填息30,34,0,34,光和,2023-12-15,6380
2801,彰銀,32,0,32,光和,2023-12-15,6380
00937B,群益ESG投等債20,32,2,30,光和,2023-12-15,6380
3047,訊舟,30,1,29,光和,2023-12-15,6380
5521,工信,29,0,29,光和,2023-12-15,6380
3041,揚智,35,7,28,光和,2023-12-15,6380
00679B,元大美債20年,39,14,25,光和,2023-12-15,6380
00934,中信成長高股息,25,0,25,光和,2023-12-15,6380
00932,兆豐永續高息等權,24,0,24,光和,2023-12-15,6380
2606,裕民,22,0,22,光和,2023-12-15,6380
2360,致茂,20,0,20,光和,2023-12-15,6380
6282,康舒,31,13,18,光和,2023-12-15,6380
00720B,元大投資級公司債,17,0,17,光和,2023-12-15,6380
3622,洋華,17,0,17,光和,2023-12-15,6380
3338,泰碩,36,20,16,光和,2023-12-15,6380
3036,文曄,15,0,15,光和,2023-12-15,6380
00637L,元大滬深300正2,18,4,14,光和,2023-12-15,6380
2359,所羅門,21,7,14,光和,2023-12-15,6380
6153,嘉聯益,18,4,14,光和,2023-12-15,6380
8436,大江,13,0,13,光和,2023-12-15,6380
1513,中興電,14,2,12,光和,2023-12-15,6380
2388,威盛,24,12,12,光和,2023-12-15,6380
3508,位速,12,0,12,光和,2023-12-15,6380
6147,頎邦,11,0,11,光和,2023-12-15,6380
6269,台郡,11,0,11,光和,2023-12-15,6380
2313,華通,17,7,10,光和,2023-12-15,6380
00639,富邦深100,10,0,10,光和,2023-12-15,6380
00671R,富邦NASDAQ反1,10,0,10,光和,2023-12-15,6380
1809,中釉,10,0,10,光和,2023-12-15,6380
2323,中環,10,0,10,光和,2023-12-15,6380
2417,圓剛,10,0,10,光和,2023-12-15,6380
2201,裕隆,10,1,9,光和,2023-12-15,6380
6789,采鈺,10,1,9,光和,2023-12-15,6380
2314,台揚,10,1,9,光和,2023-12-15,6380
2405,輔信,9,0,9,光和,2023-12-15,6380
2612,中航,9,0,9,光和,2023-12-15,6380
9945,潤泰新,28,19,9,光和,2023-12-15,6380
0056,元大高股息,21,13,8,光和,2023-12-15,6380
00922,國泰台灣領袖50,8,0,8,光和,2023-12-15,6380
00687B,國泰20年美債,12,4,8,光和,2023-12-15,6380
6111,大宇資,10,2,8,光和,2023-12-15,6380
3707,漢磊,13,5,8,光和,2023-12-15,6380
00931B,統一美債20年,10,3,7,光和,2023-12-15,6380
2610,華航,259,0,259,光和,2023-12-18,6380
2618,長榮航,116,0,116,光和,2023-12-18,6380
2356,英業達,123,21,102,光和,2023-12-18,6380
2801,彰銀,85,0,85,光和,2023-12-18,6380
2888,新光金,65,0,65,光和,2023-12-18,6380
00712,復華富時不動產,63,0,63,光和,2023-12-18,6380
3705,永信,50,0,50,光和,2023-12-18,6380
2615,萬海,52,14,38,光和,2023-12-18,6380
2363,矽統,44,10,34,光和,2023-12-18,6380
2371,大同,31,1,30,光和,2023-12-18,6380
2641,正德,32,2,30,光和,2023-12-18,6380
00679B,元大美債20年,29,3,26,光和,2023-12-18,6380
6284,佳邦,27,1,26,光和,2023-12-18,6380
4716,大立,25,0,25,光和,2023-12-18,6380
2352,佳世達,24,1,23,光和,2023-12-18,6380
00937B,群益ESG投等債20,27,5,22,光和,2023-12-18,6380
2436,偉詮電,22,0,22,光和,2023-12-18,6380
3607,谷崧,22,0,22,光和,2023-12-18,6380
6168,宏齊,21,0,21,光和,2023-12-18,6380
2025,千興,20,0,20,光和,2023-12-18,6380
2855,統一證,20,0,20,光和,2023-12-18,6380
5011,久陽,20,0,20,光和,2023-12-18,6380
00632R,元大台灣50反1,15,0,15,光和,2023-12-18,6380
2314,台揚,14,0,14,光和,2023-12-18,6380
5347,世界,15,1,14,光和,2023-12-18,6380
1905,華紙,20,7,13,光和,2023-12-18,6380
1714,和桐,13,0,13,光和,2023-12-18,6380
6182,合晶,15,2,13,光和,2023-12-18,6380
00918,大華優利高填息30,12,0,12,光和,2023-12-18,6380
2328,廣宇,12,0,12,光和,2023-12-18,6380
4915,致伸,22,10,12,光和,2023-12-18,6380
8201,無敵,14,2,12,光和,2023-12-18,6380
8213,志超,12,0,12,光和,2023-12-18,6380
2027,大成鋼,13,1,12,光和,2023-12-18,6380
00722B,群益投資級電信債,10,0,10,光和,2023-12-18,6380
1305,華夏,10,0,10,光和,2023-12-18,6380
00665L,富邦�琤肭磪囓�2,10,0,10,光和,2023-12-18,6380
00637L,元大滬深300正2,11,1,10,光和,2023-12-18,6380
1466,聚隆,13,3,10,光和,2023-12-18,6380
2612,中航,10,0,10,光和,2023-12-18,6380
2852,第一保,10,0,10,光和,2023-12-18,6380
4114,健喬,10,0,10,光和,2023-12-18,6380
6414,樺漢,11,1,10,光和,2023-12-18,6380
8933,愛地雅,10,0,10,光和,2023-12-18,6380
4131,浩泰,9,0,9,光和,2023-12-18,6380
00929,復華台灣科技優息,140,132,8,光和,2023-12-18,6380
2010,春源,8,0,8,光和,2023-12-18,6380
2387,精元,10,2,8,光和,2023-12-18,6380
3036,文曄,11,3,8,光和,2023-12-18,6380
6916,華凌,8,0,8,光和,2023-12-18,6380
2365,昆盈,102,0,102,光和,2023-12-19,6380
00919,群益台灣精選高息,101,3,98,光和,2023-12-19,6380
2356,英業達,98,16,82,光和,2023-12-19,6380
1314,中石化,80,1,79,光和,2023-12-19,6380
00929,復華台灣科技優息,106,29,77,光和,2023-12-19,6380
8201,無敵,82,6,76,光和,2023-12-19,6380
5347,世界,56,1,55,光和,2023-12-19,6380
00885,富邦越南,45,0,45,光和,2023-12-19,6380
8436,大江,42,0,42,光和,2023-12-19,6380
2888,新光金,37,0,37,光和,2023-12-19,6380
4420,光明,37,0,37,光和,2023-12-19,6380
00712,復華富時不動產,34,0,34,光和,2023-12-19,6380
2801,彰銀,33,0,33,光和,2023-12-19,6380
00680L,元大美債20正2,31,0,31,光和,2023-12-19,6380
00937B,群益ESG投等債20,47,21,26,光和,2023-12-19,6380
2353,宏��,124,100,24,光和,2023-12-19,6380
2344,華邦電,31,7,24,光和,2023-12-19,6380
3481,群創,23,0,23,光和,2023-12-19,6380
1524,耿鼎,85,64,21,光和,2023-12-19,6380
00932,兆豐永續高息等權,20,0,20,光和,2023-12-19,6380
1815,富喬,39,21,18,光和,2023-12-19,6380
00933B,國泰10Y+金融債,17,0,17,光和,2023-12-19,6380
00934,中信成長高股息,16,0,16,光和,2023-12-19,6380
2352,佳世達,16,0,16,光和,2023-12-19,6380
2062,橋椿,15,0,15,光和,2023-12-19,6380
2349,錸德,15,0,15,光和,2023-12-19,6380
1905,華紙,29,16,13,光和,2023-12-19,6380
2337,旺宏,13,0,13,光和,2023-12-19,6380
2610,華航,23,10,13,光和,2023-12-19,6380
2883,凱基金,13,0,13,光和,2023-12-19,6380
00679B,元大美債20年,11,0,11,光和,2023-12-19,6380
00637L,元大滬深300正2,11,0,11,光和,2023-12-19,6380
2303,聯電,18,7,11,光和,2023-12-19,6380
2409,友達,11,0,11,光和,2023-12-19,6380
1781,合世,10,0,10,光和,2023-12-19,6380
2038,海光,13,3,10,光和,2023-12-19,6380
2367,燿華,10,0,10,光和,2023-12-19,6380
2401,凌陽,10,0,10,光和,2023-12-19,6380
2855,統一證,10,0,10,光和,2023-12-19,6380
2913,農林,31,21,10,光和,2023-12-19,6380
3047,訊舟,10,0,10,光和,2023-12-19,6380
4564,元翎,10,0,10,光和,2023-12-19,6380
5328,華容,10,0,10,光和,2023-12-19,6380
8011,台通,10,0,10,光和,2023-12-19,6380
1339,昭輝,10,0,10,光和,2023-12-19,6380
2402,毅嘉,9,0,9,光和,2023-12-19,6380
2374,佳能,9,0,9,光和,2023-12-19,6380
2882,國泰金,9,0,9,光和,2023-12-19,6380
2388,威盛,15,7,8,光和,2023-12-19,6380
6116,彩晶,16,8,8,光和,2023-12-19,6380
00633L,富邦上証正2,150,1,149,光和,2023-12-20,6380
00919,群益台灣精選高息,148,0,148,光和,2023-12-20,6380
2888,新光金,81,0,81,光和,2023-12-20,6380
00929,復華台灣科技優息,58,0,58,光和,2023-12-20,6380
1718,中纖,60,5,55,光和,2023-12-20,6380
2618,長榮航,42,2,40,光和,2023-12-20,6380
2387,精元,44,5,39,光和,2023-12-20,6380
2867,三商壽,52,17,35,光和,2023-12-20,6380
3715,定穎投控,37,2,35,光和,2023-12-20,6380
6284,佳邦,37,6,31,光和,2023-12-20,6380
00934,中信成長高股息,29,0,29,光和,2023-12-20,6380
8436,大江,28,0,28,光和,2023-12-20,6380
00679B,元大美債20年,26,0,26,光和,2023-12-20,6380
1582,信錦,22,0,22,光和,2023-12-20,6380
1337,再生-KY,20,0,20,光和,2023-12-20,6380
9919,康那香,19,0,19,光和,2023-12-20,6380
3703,欣陸,17,0,17,光和,2023-12-20,6380
2891,中信金,17,0,17,光和,2023-12-20,6380
00937B,群益ESG投等債20,23,7,16,光和,2023-12-20,6380
2323,中環,29,13,16,光和,2023-12-20,6380
3686,達能,16,0,16,光和,2023-12-20,6380
2314,台揚,14,0,14,光和,2023-12-20,6380
2329,華泰,16,2,14,光和,2023-12-20,6380
4167,松瑞藥,14,0,14,光和,2023-12-20,6380
5410,國眾,14,1,13,光和,2023-12-20,6380
1905,華紙,12,0,12,光和,2023-12-20,6380
8076,伍豐,12,0,12,光和,2023-12-20,6380
3036,文曄,12,1,11,光和,2023-12-20,6380
5521,工信,13,2,11,光和,2023-12-20,6380
3450,聯鈞,11,1,10,光和,2023-12-20,6380
6136,富爾特,10,0,10,光和,2023-12-20,6380
8112,至上,10,0,10,光和,2023-12-20,6380
3673,TPK-KY,11,2,9,光和,2023-12-20,6380
1466,聚隆,13,5,8,光和,2023-12-20,6380
5321,美而快,11,3,8,光和,2023-12-20,6380
6153,嘉聯益,8,0,8,光和,2023-12-20,6380
00687B,國泰20年美債,7,0,7,光和,2023-12-20,6380
1721,三晃,7,0,7,光和,2023-12-20,6380
2010,春源,6,0,6,光和,2023-12-20,6380
2062,橋椿,6,0,6,光和,2023-12-20,6380
2402,毅嘉,6,0,6,光和,2023-12-20,6380
3032,偉訓,6,0,6,光和,2023-12-20,6380
5515,建國,6,0,6,光和,2023-12-20,6380
2603,長榮,6,1,5,光和,2023-12-20,6380
6282,康舒,5,0,5,光和,2023-12-20,6380
1513,中興電,8,3,5,光和,2023-12-20,6380
00673R,期元大S＆P原油反1,5,0,5,光和,2023-12-20,6380
1522,堤維西,5,0,5,光和,2023-12-20,6380
2337,旺宏,5,0,5,光和,2023-12-20,6380
3444,利機,5,0,5,光和,2023-12-20,6380
2408,南亞科,440,31,409,光和,2023-12-21,6380
00929,復華台灣科技優息,115,0,115,光和,2023-12-21,6380
2641,正德,125,15,110,光和,2023-12-21,6380
2506,太設,83,0,83,光和,2023-12-21,6380
2801,彰銀,65,1,64,光和,2023-12-21,6380
6016,康和證,70,20,50,光和,2023-12-21,6380
2610,華航,95,49,46,光和,2023-12-21,6380
9105,泰金寶-DR,61,16,45,光和,2023-12-21,6380
3131,弘塑,40,0,40,光和,2023-12-21,6380
00937B,群益ESG投等債20,40,1,39,光和,2023-12-21,6380
4960,誠美材,35,0,35,光和,2023-12-21,6380
3373,熱映,35,1,34,光和,2023-12-21,6380
00712,復華富時不動產,34,1,33,光和,2023-12-21,6380
2353,宏��,39,8,31,光和,2023-12-21,6380
00918,大華優利高填息30,26,0,26,光和,2023-12-21,6380
5371,中光電,25,0,25,光和,2023-12-21,6380
6284,佳邦,30,5,25,光和,2023-12-21,6380
8936,國統,21,0,21,光和,2023-12-21,6380
1584,精剛,20,0,20,光和,2023-12-21,6380
2007,燁興,20,0,20,光和,2023-12-21,6380
3450,聯鈞,19,0,19,光和,2023-12-21,6380
1618,合機,20,2,18,光和,2023-12-21,6380
8112,至上,19,1,18,光和,2023-12-21,6380
2038,海光,25,10,15,光和,2023-12-21,6380
3703,欣陸,15,0,15,光和,2023-12-21,6380
2404,漢唐,15,1,14,光和,2023-12-21,6380
6244,茂迪,14,0,14,光和,2023-12-21,6380
9919,康那香,31,18,13,光和,2023-12-21,6380
2331,精英,15,2,13,光和,2023-12-21,6380
1337,再生-KY,12,0,12,光和,2023-12-21,6380
2636,台驊控股,16,4,12,光和,2023-12-21,6380
2884,玉山金,12,0,12,光和,2023-12-21,6380
2201,裕隆,12,1,11,光和,2023-12-21,6380
2014,中鴻,34,23,11,光和,2023-12-21,6380
2542,興富發,11,0,11,光和,2023-12-21,6380
5521,工信,28,17,11,光和,2023-12-21,6380
2374,佳能,10,0,10,光和,2023-12-21,6380
2478,大毅,10,0,10,光和,2023-12-21,6380
2601,益航,10,0,10,光和,2023-12-21,6380
5328,華容,10,0,10,光和,2023-12-21,6380
6005,群益證,10,0,10,光和,2023-12-21,6380
6140,訊達,10,0,10,光和,2023-12-21,6380
1325,恆大,14,5,9,光和,2023-12-21,6380
2303,聯電,9,0,9,光和,2023-12-21,6380
2883,凱基金,41,32,9,光和,2023-12-21,6380
5347,世界,12,3,9,光和,2023-12-21,6380
6187,萬潤,9,0,9,光和,2023-12-21,6380
00642U,期元大S＆P石油,10,2,8,光和,2023-12-21,6380
1609,大亞,8,0,8,光和,2023-12-21,6380
6509,聚和,8,0,8,光和,2023-12-21,6380
5009,榮剛,157,11,146,光和,2023-12-22,6380
1314,中石化,68,8,60,光和,2023-12-22,6380
00919,群益台灣精選高息,53,0,53,光和,2023-12-22,6380
4306,炎洲,50,2,48,光和,2023-12-22,6380
2323,中環,49,8,41,光和,2023-12-22,6380
6679,鈺太,41,0,41,光和,2023-12-22,6380
9105,泰金寶-DR,38,0,38,光和,2023-12-22,6380
2609,陽明,143,106,37,光和,2023-12-22,6380
00937B,群益ESG投等債20,53,20,33,光和,2023-12-22,6380
2014,中鴻,29,0,29,光和,2023-12-22,6380
1905,華紙,29,1,28,光和,2023-12-22,6380
6233,旺玖,27,3,24,光和,2023-12-22,6380
2883,凱基金,22,0,22,光和,2023-12-22,6380
6005,群益證,22,0,22,光和,2023-12-22,6380
3673,TPK-KY,32,12,20,光和,2023-12-22,6380
00679B,元大美債20年,18,0,18,光和,2023-12-22,6380
1618,合機,17,0,17,光和,2023-12-22,6380
00772B,中信高評級公司債,16,0,16,光和,2023-12-22,6380
6285,啟��,20,4,16,光和,2023-12-22,6380
00720B,元大投資級公司債,15,0,15,光和,2023-12-22,6380
00687B,國泰20年美債,22,7,15,光和,2023-12-22,6380
00751B,元大AAA至A公司債,15,0,15,光和,2023-12-22,6380
00902,中信電池及儲能,15,0,15,光和,2023-12-22,6380
1718,中纖,15,0,15,光和,2023-12-22,6380
6139,亞翔,16,1,15,光和,2023-12-22,6380
8050,廣積,13,0,13,光和,2023-12-22,6380
2637,慧洋-KY,16,4,12,光和,2023-12-22,6380
00753L,中信中國50正2,12,0,12,光和,2023-12-22,6380
2516,新建,12,0,12,光和,2023-12-22,6380
00773B,中信優先金融債,11,0,11,光和,2023-12-22,6380
1104,環泥,13,2,11,光和,2023-12-22,6380
6182,合晶,13,2,11,光和,2023-12-22,6380
9910,豐泰,11,0,11,光和,2023-12-22,6380
00885,富邦越南,10,0,10,光和,2023-12-22,6380
2331,精英,11,1,10,光和,2023-12-22,6380
2371,大同,10,0,10,光和,2023-12-22,6380
2423,固緯,10,0,10,光和,2023-12-22,6380
2427,三商電,10,0,10,光和,2023-12-22,6380
2897,王道銀行,10,0,10,光和,2023-12-22,6380
6026,福邦證,10,0,10,光和,2023-12-22,6380
6173,信昌電,10,0,10,光和,2023-12-22,6380
6244,茂迪,10,0,10,光和,2023-12-22,6380
6509,聚和,10,0,10,光和,2023-12-22,6380
8436,大江,10,0,10,光和,2023-12-22,6380
9950,萬國通,10,0,10,光和,2023-12-22,6380
00713,元大台灣高息低波,11,1,10,光和,2023-12-22,6380
2356,英業達,53,43,10,光和,2023-12-22,6380
3051,力特,11,2,9,光和,2023-12-22,6380
3576,聯合再生,9,0,9,光和,2023-12-22,6380
2812,台中銀,8,0,8,光和,2023-12-22,6380
2610,華航,174,14,160,光和,2023-12-25,6380
3019,亞光,150,0,150,光和,2023-12-25,6380
2324,仁寶,168,81,87,光和,2023-12-25,6380
2609,陽明,127,43,84,光和,2023-12-25,6380
00919,群益台灣精選高息,77,6,71,光和,2023-12-25,6380
2365,昆盈,69,0,69,光和,2023-12-25,6380
1337,再生-KY,63,0,63,光和,2023-12-25,6380
00687B,國泰20年美債,49,2,47,光和,2023-12-25,6380
2331,精英,49,9,40,光和,2023-12-25,6380
3481,群創,42,9,33,光和,2023-12-25,6380
2034,允強,35,3,32,光和,2023-12-25,6380
8027,鈦昇,27,0,27,光和,2023-12-25,6380
2458,義隆,25,0,25,光和,2023-12-25,6380
00937B,群益ESG投等債20,24,1,23,光和,2023-12-25,6380
8936,國統,33,11,22,光和,2023-12-25,6380
2421,建準,22,0,22,光和,2023-12-25,6380
2801,彰銀,30,10,20,光和,2023-12-25,6380
5381,合正,19,0,19,光和,2023-12-25,6380
6244,茂迪,17,0,17,光和,2023-12-25,6380
8050,廣積,17,0,17,光和,2023-12-25,6380
1210,大成,15,0,15,光和,2023-12-25,6380
6163,華電網,15,0,15,光和,2023-12-25,6380
2401,凌陽,15,0,15,光和,2023-12-25,6380
1708,東鹼,14,0,14,光和,2023-12-25,6380
1733,五鼎,18,4,14,光和,2023-12-25,6380
2404,漢唐,15,1,14,光和,2023-12-25,6380
00900,富邦特選高股息30,13,0,13,光和,2023-12-25,6380
6164,華興,13,0,13,光和,2023-12-25,6380
2605,新興,26,14,12,光和,2023-12-25,6380
2641,正德,15,3,12,光和,2023-12-25,6380
3576,聯合再生,12,0,12,光和,2023-12-25,6380
2359,所羅門,12,1,11,光和,2023-12-25,6380
5452,佶優,11,0,11,光和,2023-12-25,6380
1783,和康生,10,0,10,光和,2023-12-25,6380
2014,中鴻,11,1,10,光和,2023-12-25,6380
2030,彰源,10,0,10,光和,2023-12-25,6380
3234,光環,10,0,10,光和,2023-12-25,6380
6668,中揚光,11,1,10,光和,2023-12-25,6380
8064,東捷,10,0,10,光和,2023-12-25,6380
9904,寶成,11,1,10,光和,2023-12-25,6380
2612,中航,10,0,10,光和,2023-12-25,6380
2038,海光,20,11,9,光和,2023-12-25,6380
2392,正崴,9,0,9,光和,2023-12-25,6380
6168,宏齊,10,1,9,光和,2023-12-25,6380
00933B,國泰10Y+金融債,8,0,8,光和,2023-12-25,6380
1314,中石化,8,0,8,光和,2023-12-25,6380
4906,正文,8,0,8,光和,2023-12-25,6380
1339,昭輝,8,1,7,光和,2023-12-25,6380
3041,揚智,29,22,7,光和,2023-12-25,6380
5009,榮剛,6,0,6,光和,2023-12-25,6380
00680L,元大美債20正2,200,0,200,光和,2023-12-26,6380
00919,群益台灣精選高息,100,16,84,光和,2023-12-26,6380
9105,泰金寶-DR,80,1,79,光和,2023-12-26,6380
00929,復華台灣科技優息,67,3,64,光和,2023-12-26,6380
2888,新光金,80,19,61,光和,2023-12-26,6380
4114,健喬,50,0,50,光和,2023-12-26,6380
00632R,元大台灣50反1,40,0,40,光和,2023-12-26,6380
00894,中信小資高價30,38,0,38,光和,2023-12-26,6380
5309,系統電,35,0,35,光和,2023-12-26,6380
00712,復華富時不動產,32,0,32,光和,2023-12-26,6380
2618,長榮航,33,1,32,光和,2023-12-26,6380
00937B,群益ESG投等債20,31,0,31,光和,2023-12-26,6380
2515,中工,31,3,28,光和,2023-12-26,6380
00679B,元大美債20年,30,3,27,光和,2023-12-26,6380
00933B,國泰10Y+金融債,25,0,25,光和,2023-12-26,6380
2363,矽統,27,3,24,光和,2023-12-26,6380
6163,華電網,22,0,22,光和,2023-12-26,6380
2014,中鴻,21,1,20,光和,2023-12-26,6380
1312,國喬,20,1,19,光和,2023-12-26,6380
5351,鈺創,19,0,19,光和,2023-12-26,6380
3264,欣銓,18,0,18,光和,2023-12-26,6380
5272,笙科,21,3,18,光和,2023-12-26,6380
6026,福邦證,18,0,18,光和,2023-12-26,6380
8996,高力,19,1,18,光和,2023-12-26,6380
2349,錸德,16,0,16,光和,2023-12-26,6380
8105,凌巨,16,0,16,光和,2023-12-26,6380
1434,福懋,13,0,13,光和,2023-12-26,6380
3036,文曄,13,0,13,光和,2023-12-26,6380
3094,聯傑,22,9,13,光和,2023-12-26,6380
5452,佶優,14,1,13,光和,2023-12-26,6380
8039,台虹,14,1,13,光和,2023-12-26,6380
2891,中信金,14,1,13,光和,2023-12-26,6380
6187,萬潤,11,0,11,光和,2023-12-26,6380
6441,廣錠,11,0,11,光和,2023-12-26,6380
00751B,元大AAA至A公司債,10,0,10,光和,2023-12-26,6380
1447,力鵬,10,0,10,光和,2023-12-26,6380
1616,億泰,10,0,10,光和,2023-12-26,6380
1909,榮成,10,0,10,光和,2023-12-26,6380
4564,元翎,10,0,10,光和,2023-12-26,6380
6016,康和證,10,0,10,光和,2023-12-26,6380
6589,台康生技,10,0,10,光和,2023-12-26,6380
8110,華東,10,0,10,光和,2023-12-26,6380
1609,大亞,10,1,9,光和,2023-12-26,6380
8426,紅木-KY,10,1,9,光和,2023-12-26,6380
1513,中興電,9,1,8,光和,2023-12-26,6380
3234,光環,8,0,8,光和,2023-12-26,6380
1519,華城,7,0,7,光和,2023-12-26,6380
2369,菱生,10,3,7,光和,2023-12-26,6380
3499,環天科,7,0,7,光和,2023-12-26,6380
4306,炎洲,7,0,7,光和,2023-12-26,6380
00919,群益台灣精選高息,682,1,681,光和,2023-12-27,6380
00937B,群益ESG投等債20,131,0,131,光和,2023-12-27,6380
6668,中揚光,119,9,110,光和,2023-12-27,6380
9919,康那香,106,1,105,光和,2023-12-27,6380
00632R,元大台灣50反1,97,0,97,光和,2023-12-27,6380
00929,復華台灣科技優息,103,29,74,光和,2023-12-27,6380
2405,輔信,66,15,51,光和,2023-12-27,6380
2353,宏��,88,45,43,光和,2023-12-27,6380
2362,藍天,41,1,40,光和,2023-12-27,6380
00679B,元大美債20年,59,20,39,光和,2023-12-27,6380
9934,成霖,31,0,31,光和,2023-12-27,6380
2323,中環,30,0,30,光和,2023-12-27,6380
3545,敦泰,25,0,25,光和,2023-12-27,6380
8064,東捷,21,0,21,光和,2023-12-27,6380
2014,中鴻,20,0,20,光和,2023-12-27,6380
1449,佳和,20,0,20,光和,2023-12-27,6380
2612,中航,20,0,20,光和,2023-12-27,6380
2324,仁寶,64,44,20,光和,2023-12-27,6380
2618,長榮航,60,41,19,光和,2023-12-27,6380
00642U,期元大S＆P石油,20,1,19,光和,2023-12-27,6380
6182,合晶,19,0,19,光和,2023-12-27,6380
6282,康舒,18,0,18,光和,2023-12-27,6380
1514,亞力,16,0,16,光和,2023-12-27,6380
00934,中信成長高股息,19,3,16,光和,2023-12-27,6380
00673R,期元大S＆P原油反1,20,5,15,光和,2023-12-27,6380
2915,潤泰全,15,0,15,光和,2023-12-27,6380
1504,東元,13,0,13,光和,2023-12-27,6380
3694,海華,14,1,13,光和,2023-12-27,6380
4979,華星光,15,3,12,光和,2023-12-27,6380
6026,福邦證,12,0,12,光和,2023-12-27,6380
00753L,中信中國50正2,10,0,10,光和,2023-12-27,6380
00696B,富邦美債20年,10,0,10,光和,2023-12-27,6380
1434,福懋,10,0,10,光和,2023-12-27,6380
1616,億泰,10,0,10,光和,2023-12-27,6380
1618,合機,10,0,10,光和,2023-12-27,6380
2605,新興,12,2,10,光和,2023-12-27,6380
3013,晟銘電,11,1,10,光和,2023-12-27,6380
3060,銘異,15,5,10,光和,2023-12-27,6380
5328,華容,10,0,10,光和,2023-12-27,6380
6112,邁達特,10,0,10,光和,2023-12-27,6380
2441,超豐,10,0,10,光和,2023-12-27,6380
2340,台亞,10,1,9,光和,2023-12-27,6380
4924,欣厚-KY,9,0,9,光和,2023-12-27,6380
6288,聯嘉,9,0,9,光和,2023-12-27,6380
00669R,國泰美國道瓊反1,8,0,8,光和,2023-12-27,6380
3265,台星科,8,0,8,光和,2023-12-27,6380
1337,再生-KY,10,3,7,光和,2023-12-27,6380
1708,東鹼,7,0,7,光和,2023-12-27,6380
5483,中美晶,12,5,7,光和,2023-12-27,6380
1810,和成,6,0,6,光和,2023-12-27,6380
00688L,國泰20年美債正2,200,0,200,光和,2023-12-28,6380
00679B,元大美債20年,100,0,100,光和,2023-12-28,6380
2369,菱生,100,8,92,光和,2023-12-28,6380
2365,昆盈,119,32,87,光和,2023-12-28,6380
00919,群益台灣精選高息,78,0,78,光和,2023-12-28,6380
00696B,富邦美債20年,57,0,57,光和,2023-12-28,6380
9105,泰金寶-DR,50,0,50,光和,2023-12-28,6380
2515,中工,54,6,48,光和,2023-12-28,6380
00937B,群益ESG投等債20,42,0,42,光和,2023-12-28,6380
1524,耿鼎,51,10,41,光和,2023-12-28,6380
2303,聯電,89,48,41,光和,2023-12-28,6380
2425,承啟,40,0,40,光和,2023-12-28,6380
2353,宏��,123,84,39,光和,2023-12-28,6380
3706,神達,93,55,38,光和,2023-12-28,6380
4906,正文,38,0,38,光和,2023-12-28,6380
2603,長榮,47,12,35,光和,2023-12-28,6380
00933B,國泰10Y+金融債,35,0,35,光和,2023-12-28,6380
2363,矽統,31,1,30,光和,2023-12-28,6380
00720B,元大投資級公司債,30,3,27,光和,2023-12-28,6380
2332,友訊,31,5,26,光和,2023-12-28,6380
2014,中鴻,23,0,23,光和,2023-12-28,6380
2467,志聖,23,0,23,光和,2023-12-28,6380
5521,工信,22,0,22,光和,2023-12-28,6380
2031,新光鋼,20,0,20,光和,2023-12-28,6380
3036,文曄,20,0,20,光和,2023-12-28,6380
5315,光聯,21,1,20,光和,2023-12-28,6380
1718,中纖,19,0,19,光和,2023-12-28,6380
8110,華東,19,0,19,光和,2023-12-28,6380
00935,野村臺灣新科技50,26,10,16,光和,2023-12-28,6380
00637L,元大滬深300正2,20,5,15,光和,2023-12-28,6380
4766,南寶,15,0,15,光和,2023-12-28,6380
2352,佳世達,15,1,14,光和,2023-12-28,6380
3231,緯創,21,7,14,光和,2023-12-28,6380
2606,裕民,14,1,13,光和,2023-12-28,6380
8070,長華*,13,0,13,光和,2023-12-28,6380
3481,群創,23,11,12,光和,2023-12-28,6380
2038,海光,20,8,12,光和,2023-12-28,6380
1231,聯華食,11,0,11,光和,2023-12-28,6380
3380,明泰,12,1,11,光和,2023-12-28,6380
00929,復華台灣科技優息,43,33,10,光和,2023-12-28,6380
00885,富邦越南,10,0,10,光和,2023-12-28,6380
2023,燁輝,10,0,10,光和,2023-12-28,6380
2105,正新,10,0,10,光和,2023-12-28,6380
2743,山富,10,0,10,光和,2023-12-28,6380
3047,訊舟,10,0,10,光和,2023-12-28,6380
3202,樺晟,10,0,10,光和,2023-12-28,6380
3322,建舜電,10,0,10,光和,2023-12-28,6380
4105,東洋,10,0,10,光和,2023-12-28,6380
6136,富爾特,10,0,10,光和,2023-12-28,6380
2405,輔信,16,7,9,光和,2023-12-28,6380
00937B,群益ESG投等債20,303,0,303,光和,2023-12-29,6380
2352,佳世達,320,76,244,光和,2023-12-29,6380
00929,復華台灣科技優息,90,7,83,光和,2023-12-29,6380
00919,群益台灣精選高息,80,0,80,光和,2023-12-29,6380
5355,佳總,40,0,40,光和,2023-12-29,6380
1514,亞力,42,6,36,光和,2023-12-29,6380
00680L,元大美債20正2,35,0,35,光和,2023-12-29,6380
4960,誠美材,35,0,35,光和,2023-12-29,6380
2356,英業達,64,31,33,光和,2023-12-29,6380
1608,華榮,30,0,30,光和,2023-12-29,6380
2888,新光金,27,0,27,光和,2023-12-29,6380
2606,裕民,23,1,22,光和,2023-12-29,6380
00933B,國泰10Y+金融債,21,0,21,光和,2023-12-29,6380
2365,昆盈,61,40,21,光和,2023-12-29,6380
2465,麗臺,21,0,21,光和,2023-12-29,6380
00931B,統一美債20年,20,0,20,光和,2023-12-29,6380
2014,中鴻,20,0,20,光和,2023-12-29,6380
8064,東捷,20,0,20,光和,2023-12-29,6380
3481,群創,22,3,19,光和,2023-12-29,6380
3036,文曄,16,0,16,光和,2023-12-29,6380
4915,致伸,20,4,16,光和,2023-12-29,6380
1314,中石化,15,0,15,光和,2023-12-29,6380
00918,大華優利高填息30,15,0,15,光和,2023-12-29,6380
2371,大同,18,3,15,光和,2023-12-29,6380
00632R,元大台灣50反1,14,0,14,光和,2023-12-29,6380
1449,佳和,13,0,13,光和,2023-12-29,6380
5315,光聯,12,0,12,光和,2023-12-29,6380
2303,聯電,18,7,11,光和,2023-12-29,6380
1513,中興電,13,2,11,光和,2023-12-29,6380
1718,中纖,11,0,11,光和,2023-12-29,6380
00637L,元大滬深300正2,13,3,10,光和,2023-12-29,6380
1605,華新,13,3,10,光和,2023-12-29,6380
1618,合機,10,0,10,光和,2023-12-29,6380
1702,南僑,10,0,10,光和,2023-12-29,6380
1785,光洋科,10,0,10,光和,2023-12-29,6380
2349,錸德,10,0,10,光和,2023-12-29,6380
2515,中工,24,14,10,光和,2023-12-29,6380
2605,新興,10,0,10,光和,2023-12-29,6380
2612,中航,10,0,10,光和,2023-12-29,6380
3202,樺晟,10,0,10,光和,2023-12-29,6380
3260,威剛,12,2,10,光和,2023-12-29,6380
3322,建舜電,10,0,10,光和,2023-12-29,6380
4529,淳紳,10,0,10,光和,2023-12-29,6380
4958,臻鼎-KY,10,0,10,光和,2023-12-29,6380
6113,亞矽,13,3,10,光和,2023-12-29,6380
6916,華凌,10,0,10,光和,2023-12-29,6380
2062,橋椿,9,0,9,光和,2023-12-29,6380
6231,系微,9,0,9,光和,2023-12-29,6380
8936,國統,20,11,9,光和,2023-12-29,6380
2915,潤泰全,10,2,8,光和,2023-12-29,6380
2352,佳世達,170,7,163,光和,2024-01-02,6380
2353,宏��,118,29,89,光和,2024-01-02,6380
3231,緯創,78,13,65,光和,2024-01-02,6380
00937B,群益ESG投等債20,56,0,56,光和,2024-01-02,6380
00929,復華台灣科技優息,89,34,55,光和,2024-01-02,6380
2609,陽明,78,41,37,光和,2024-01-02,6380
00919,群益台灣精選高息,52,16,36,光和,2024-01-02,6380
00687B,國泰20年美債,35,0,35,光和,2024-01-02,6380
00933B,國泰10Y+金融債,33,0,33,光和,2024-01-02,6380
00878,國泰永續高股息,60,28,32,光和,2024-01-02,6380
2363,矽統,33,2,31,光和,2024-01-02,6380
2323,中環,30,0,30,光和,2024-01-02,6380
1217,愛之味,30,2,28,光和,2024-01-02,6380
00632R,元大台灣50反1,25,0,25,光和,2024-01-02,6380
6770,力積電,24,0,24,光和,2024-01-02,6380
1337,再生-KY,22,0,22,光和,2024-01-02,6380
4716,大立,21,0,21,光和,2024-01-02,6380
5347,世界,21,0,21,光和,2024-01-02,6380
2103,台橡,20,0,20,光和,2024-01-02,6380
3202,樺晟,20,0,20,光和,2024-01-02,6380
2365,昆盈,20,1,19,光和,2024-01-02,6380
5521,工信,26,7,19,光和,2024-01-02,6380
00712,復華富時不動產,31,15,16,光和,2024-01-02,6380
2302,麗正,16,0,16,光和,2024-01-02,6380
2303,聯電,17,2,15,光和,2024-01-02,6380
1466,聚隆,15,0,15,光和,2024-01-02,6380
1702,南僑,18,3,15,光和,2024-01-02,6380
2515,中工,24,9,15,光和,2024-01-02,6380
2605,新興,19,4,15,光和,2024-01-02,6380
00918,大華優利高填息30,14,0,14,光和,2024-01-02,6380
00680L,元大美債20正2,13,0,13,光和,2024-01-02,6380
1434,福懋,13,0,13,光和,2024-01-02,6380
2062,橋椿,13,0,13,光和,2024-01-02,6380
2337,旺宏,14,2,12,光和,2024-01-02,6380
00923,群益台ESG低碳50,10,0,10,光和,2024-01-02,6380
2506,太設,10,0,10,光和,2024-01-02,6380
3006,晶豪科,10,0,10,光和,2024-01-02,6380
3016,嘉晶,10,0,10,光和,2024-01-02,6380
4746,台耀,11,1,10,光和,2024-01-02,6380
2382,廣達,15,5,10,光和,2024-01-02,6380
8054,安國,10,0,10,光和,2024-01-02,6380
0056,元大高股息,11,2,9,光和,2024-01-02,6380
00679B,元大美債20年,9,0,9,光和,2024-01-02,6380
1522,堤維西,10,1,9,光和,2024-01-02,6380
2392,正崴,9,0,9,光和,2024-01-02,6380
8070,長華*,9,0,9,光和,2024-01-02,6380
1733,五鼎,11,3,8,光和,2024-01-02,6380
2611,志信,10,2,8,光和,2024-01-02,6380
2891,中信金,8,0,8,光和,2024-01-02,6380
3306,鼎天,8,0,8,光和,2024-01-02,6380
00929,復華台灣科技優息,205,22,183,光和,2024-01-03,6380
00680L,元大美債20正2,111,0,111,光和,2024-01-03,6380
2405,輔信,98,8,90,光和,2024-01-03,6380
00937B,群益ESG投等債20,77,0,77,光和,2024-01-03,6380
00919,群益台灣精選高息,69,7,62,光和,2024-01-03,6380
2618,長榮航,67,6,61,光和,2024-01-03,6380
2883,凱基金,55,0,55,光和,2024-01-03,6380
1524,耿鼎,55,0,55,光和,2024-01-03,6380
3481,群創,55,11,44,光和,2024-01-03,6380
00878,國泰永續高股息,45,1,44,光和,2024-01-03,6380
2303,聯電,38,0,38,光和,2024-01-03,6380
5347,世界,36,3,33,光和,2024-01-03,6380
9934,成霖,34,4,30,光和,2024-01-03,6380
1905,華紙,30,1,29,光和,2024-01-03,6380
2352,佳世達,71,43,28,光和,2024-01-03,6380
2324,仁寶,31,3,28,光和,2024-01-03,6380
1609,大亞,26,1,25,光和,2024-01-03,6380
4167,松瑞藥,25,0,25,光和,2024-01-03,6380
2331,精英,35,12,23,光和,2024-01-03,6380
2356,英業達,33,11,22,光和,2024-01-03,6380
1608,華榮,22,0,22,光和,2024-01-03,6380
1618,合機,22,0,22,光和,2024-01-03,6380
2031,新光鋼,21,0,21,光和,2024-01-03,6380
2365,昆盈,21,0,21,光和,2024-01-03,6380
0056,元大高股息,25,4,21,光和,2024-01-03,6380
4114,健喬,20,0,20,光和,2024-01-03,6380
4960,誠美材,20,0,20,光和,2024-01-03,6380
00935,野村臺灣新科技50,19,0,19,光和,2024-01-03,6380
2323,中環,17,0,17,光和,2024-01-03,6380
2349,錸德,17,0,17,光和,2024-01-03,6380
6770,力積電,17,0,17,光和,2024-01-03,6380
00642U,期元大S＆P石油,16,0,16,光和,2024-01-03,6380
5315,光聯,16,0,16,光和,2024-01-03,6380
6142,友勁,16,0,16,光和,2024-01-03,6380
00751B,元大AAA至A公司債,15,0,15,光和,2024-01-03,6380
5355,佳總,15,0,15,光和,2024-01-03,6380
6163,華電網,20,5,15,光和,2024-01-03,6380
2801,彰銀,14,0,14,光和,2024-01-03,6380
2515,中工,18,4,14,光和,2024-01-03,6380
6695,芯鼎,39,25,14,光和,2024-01-03,6380
2884,玉山金,13,0,13,光和,2024-01-03,6380
2891,中信金,13,0,13,光和,2024-01-03,6380
00923,群益台ESG低碳50,12,0,12,光和,2024-01-03,6380
00930,永豐ESG低碳高息,12,0,12,光和,2024-01-03,6380
4956,光鋐,13,1,12,光和,2024-01-03,6380
00934,中信成長高股息,11,0,11,光和,2024-01-03,6380
1471,首利,11,0,11,光和,2024-01-03,6380
2344,華邦電,22,11,11,光和,2024-01-03,6380
6116,彩晶,11,0,11,光和,2024-01-03,6380
2363,矽統,34,24,10,光和,2024-01-03,6380
1466,聚隆,100,1,99,光和,2024-01-04,6380
00929,復華台灣科技優息,136,40,96,光和,2024-01-04,6380
2365,昆盈,67,2,65,光和,2024-01-04,6380
2883,凱基金,60,0,60,光和,2024-01-04,6380
00712,復華富時不動產,64,8,56,光和,2024-01-04,6380
00937B,群益ESG投等債20,54,0,54,光和,2024-01-04,6380
00919,群益台灣精選高息,59,9,50,光和,2024-01-04,6380
2353,宏��,54,13,41,光和,2024-01-04,6380
00927,群益半導體收益,41,0,41,光和,2024-01-04,6380
5521,工信,67,30,37,光和,2024-01-04,6380
2303,聯電,30,0,30,光和,2024-01-04,6380
3041,揚智,27,0,27,光和,2024-01-04,6380
2344,華邦電,52,26,26,光和,2024-01-04,6380
00933B,國泰10Y+金融債,22,0,22,光和,2024-01-04,6380
1710,東聯,21,0,21,光和,2024-01-04,6380
3321,同泰,21,0,21,光和,2024-01-04,6380
2106,建大,20,0,20,光和,2024-01-04,6380
3444,利機,20,0,20,光和,2024-01-04,6380
2409,友達,22,3,19,光和,2024-01-04,6380
2867,三商壽,18,0,18,光和,2024-01-04,6380
00931B,統一美債20年,16,0,16,光和,2024-01-04,6380
00751B,元大AAA至A公司債,16,0,16,光和,2024-01-04,6380
2312,金寶,16,0,16,光和,2024-01-04,6380
2356,英業達,31,15,16,光和,2024-01-04,6380
2405,輔信,16,0,16,光和,2024-01-04,6380
2399,映泰,15,0,15,光和,2024-01-04,6380
4924,欣厚-KY,15,0,15,光和,2024-01-04,6380
00878,國泰永續高股息,19,5,14,光和,2024-01-04,6380
00720B,元大投資級公司債,14,0,14,光和,2024-01-04,6380
3050,鈺德,14,0,14,光和,2024-01-04,6380
4167,松瑞藥,14,0,14,光和,2024-01-04,6380
2617,台航,13,0,13,光和,2024-01-04,6380
00687B,國泰20年美債,13,0,13,光和,2024-01-04,6380
6271,同欣電,13,0,13,光和,2024-01-04,6380
9919,康那香,47,34,13,光和,2024-01-04,6380
1514,亞力,19,7,12,光和,2024-01-04,6380
1732,毛寶,15,3,12,光和,2024-01-04,6380
2809,京城銀,12,0,12,光和,2024-01-04,6380
0056,元大高股息,11,0,11,光和,2024-01-04,6380
1444,力麗,11,0,11,光和,2024-01-04,6380
6414,樺漢,10,0,10,光和,2024-01-04,6380
2314,台揚,10,0,10,光和,2024-01-04,6380
2332,友訊,10,0,10,光和,2024-01-04,6380
3284,太普高,10,0,10,光和,2024-01-04,6380
3354,律勝,10,0,10,光和,2024-01-04,6380
2610,華航,10,1,9,光和,2024-01-04,6380
3712,永崴投控,9,0,9,光和,2024-01-04,6380
2882,國泰金,8,0,8,光和,2024-01-04,6380
3706,神達,12,4,8,光和,2024-01-04,6380
1101,台泥,9,1,8,光和,2024-01-04,6380
2883,凱基金,76,0,76,光和,2024-01-05,6380
2515,中工,57,1,56,光和,2024-01-05,6380
2365,昆盈,46,0,46,光和,2024-01-05,6380
00937B,群益ESG投等債20,40,0,40,光和,2024-01-05,6380
2610,華航,39,0,39,光和,2024-01-05,6380
2323,中環,47,10,37,光和,2024-01-05,6380
4956,光鋐,40,3,37,光和,2024-01-05,6380
00919,群益台灣精選高息,34,2,32,光和,2024-01-05,6380
3260,威剛,32,0,32,光和,2024-01-05,6380
2356,英業達,40,10,30,光和,2024-01-05,6380
2349,錸德,30,0,30,光和,2024-01-05,6380
3002,歐格,30,0,30,光和,2024-01-05,6380
00751B,元大AAA至A公司債,28,0,28,光和,2024-01-05,6380
00935,野村臺灣新科技50,25,0,25,光和,2024-01-05,6380
2637,慧洋-KY,27,3,24,光和,2024-01-05,6380
4716,大立,39,15,24,光和,2024-01-05,6380
8110,華東,23,0,23,光和,2024-01-05,6380
2331,精英,24,2,22,光和,2024-01-05,6380
1618,合機,21,0,21,光和,2024-01-05,6380
00927,群益半導體收益,20,0,20,光和,2024-01-05,6380
2618,長榮航,51,32,19,光和,2024-01-05,6380
8096,擎亞,31,12,19,光和,2024-01-05,6380
4114,健喬,15,0,15,光和,2024-01-05,6380
5011,久陽,15,0,15,光和,2024-01-05,6380
6239,力成,15,0,15,光和,2024-01-05,6380
00878,國泰永續高股息,17,2,15,光和,2024-01-05,6380
2303,聯電,25,12,13,光和,2024-01-05,6380
2329,華泰,15,2,13,光和,2024-01-05,6380
00687B,國泰20年美債,13,0,13,光和,2024-01-05,6380
2605,新興,21,8,13,光和,2024-01-05,6380
6588,東典光電,13,0,13,光和,2024-01-05,6380
9919,康那香,12,0,12,光和,2024-01-05,6380
00720B,元大投資級公司債,11,0,11,光和,2024-01-05,6380
8086,宏捷科,11,1,10,光和,2024-01-05,6380
2441,超豐,10,0,10,光和,2024-01-05,6380
3047,訊舟,11,1,10,光和,2024-01-05,6380
4766,南寶,10,0,10,光和,2024-01-05,6380
6138,茂達,11,1,10,光和,2024-01-05,6380
6173,信昌電,10,0,10,光和,2024-01-05,6380
6916,華凌,10,0,10,光和,2024-01-05,6380
2630,亞航,10,0,10,光和,2024-01-05,6380
8299,群聯,10,0,10,光和,2024-01-05,6380
00891,中信關鍵半導體,9,0,9,光和,2024-01-05,6380
2033,佳大,9,0,9,光和,2024-01-05,6380
2641,正德,17,8,9,光和,2024-01-05,6380
6026,福邦證,9,0,9,光和,2024-01-05,6380
1815,富喬,8,0,8,光和,2024-01-05,6380
2062,橋椿,8,0,8,光和,2024-01-05,6380
2636,台驊控股,9,1,8,光和,2024-01-05,6380
6147,頎邦,8,0,8,光和,2024-01-05,6380
2002,中鋼,141,2,139,光和,2024-01-08,6380
5355,佳總,110,1,109,光和,2024-01-08,6380
2801,彰銀,90,38,52,光和,2024-01-08,6380
6016,康和證,36,0,36,光和,2024-01-08,6380
00637L,元大滬深300正2,45,10,35,光和,2024-01-08,6380
00937B,群益ESG投等債20,34,0,34,光和,2024-01-08,6380
00665L,富邦�琤肭磪囓�2,30,0,30,光和,2024-01-08,6380
00919,群益台灣精選高息,30,0,30,光和,2024-01-08,6380
2313,華通,38,8,30,光和,2024-01-08,6380
2605,新興,29,3,26,光和,2024-01-08,6380
3017,奇鋐,26,0,26,光和,2024-01-08,6380
2489,瑞軒,25,0,25,光和,2024-01-08,6380
00931B,統一美債20年,24,0,24,光和,2024-01-08,6380
00929,復華台灣科技優息,73,50,23,光和,2024-01-08,6380
6695,芯鼎,23,0,23,光和,2024-01-08,6380
00882,中信中國高股息,22,0,22,光和,2024-01-08,6380
1815,富喬,22,0,22,光和,2024-01-08,6380
6770,力積電,40,18,22,光和,2024-01-08,6380
00751B,元大AAA至A公司債,21,0,21,光和,2024-01-08,6380
5608,四維航,22,2,20,光和,2024-01-08,6380
00632R,元大台灣50反1,20,0,20,光和,2024-01-08,6380
00679B,元大美債20年,19,0,19,光和,2024-01-08,6380
8085,福華,21,2,19,光和,2024-01-08,6380
6579,研揚,24,6,18,光和,2024-01-08,6380
2630,亞航,19,1,18,光和,2024-01-08,6380
2303,聯電,17,0,17,光和,2024-01-08,6380
2388,威盛,26,10,16,光和,2024-01-08,6380
6292,迅德,15,0,15,光和,2024-01-08,6380
00720B,元大投資級公司債,14,0,14,光和,2024-01-08,6380
00680L,元大美債20正2,13,0,13,光和,2024-01-08,6380
2062,橋椿,13,0,13,光和,2024-01-08,6380
8049,晶采,13,0,13,光和,2024-01-08,6380
2611,志信,12,0,12,光和,2024-01-08,6380
6215,和椿,12,0,12,光和,2024-01-08,6380
2352,佳世達,18,7,11,光和,2024-01-08,6380
2371,大同,19,8,11,光和,2024-01-08,6380
2897,王道銀行,11,0,11,光和,2024-01-08,6380
8436,大江,11,0,11,光和,2024-01-08,6380
00888,永豐台灣ESG,10,0,10,光和,2024-01-08,6380
1524,耿鼎,11,1,10,光和,2024-01-08,6380
1582,信錦,10,0,10,光和,2024-01-08,6380
1905,華紙,10,0,10,光和,2024-01-08,6380
2547,日勝生,10,0,10,光和,2024-01-08,6380
2887,台新金,10,0,10,光和,2024-01-08,6380
4119,旭富,10,0,10,光和,2024-01-08,6380
4528,江興鍛,10,0,10,光和,2024-01-08,6380
5011,久陽,10,0,10,光和,2024-01-08,6380
5512,力麒,10,0,10,光和,2024-01-08,6380
5521,工信,21,11,10,光和,2024-01-08,6380
912000,晨訊科-DR,10,0,10,光和,2024-01-08,6380
00919,群益台灣精選高息,176,5,171,光和,2024-01-09,6380
5355,佳總,100,0,100,光和,2024-01-09,6380
00929,復華台灣科技優息,109,16,93,光和,2024-01-09,6380
2609,陽明,107,27,80,光和,2024-01-09,6380
1314,中石化,64,0,64,光和,2024-01-09,6380
3481,群創,80,38,42,光和,2024-01-09,6380
2915,潤泰全,33,0,33,光和,2024-01-09,6380
00937B,群益ESG投等債20,30,0,30,光和,2024-01-09,6380
2062,橋椿,29,1,28,光和,2024-01-09,6380
2363,矽統,54,28,26,光和,2024-01-09,6380
1618,合機,25,0,25,光和,2024-01-09,6380
2023,燁輝,25,1,24,光和,2024-01-09,6380
2002,中鋼,23,0,23,光和,2024-01-09,6380
2891,中信金,21,0,21,光和,2024-01-09,6380
2645,長榮航太,20,0,20,光和,2024-01-09,6380
2352,佳世達,62,43,19,光和,2024-01-09,6380
2329,華泰,24,5,19,光和,2024-01-09,6380
00927,群益半導體收益,18,0,18,光和,2024-01-09,6380
2323,中環,27,9,18,光和,2024-01-09,6380
2617,台航,16,0,16,光和,2024-01-09,6380
1701,中化,15,0,15,光和,2024-01-09,6380
5011,久陽,15,0,15,光和,2024-01-09,6380
6112,邁達特,15,0,15,光和,2024-01-09,6380
2615,萬海,17,2,15,光和,2024-01-09,6380
00878,國泰永續高股息,17,3,14,光和,2024-01-09,6380
5521,工信,30,16,14,光和,2024-01-09,6380
8150,南茂,14,0,14,光和,2024-01-09,6380
2636,台驊控股,13,0,13,光和,2024-01-09,6380
3231,緯創,42,30,12,光和,2024-01-09,6380
2402,毅嘉,14,2,12,光和,2024-01-09,6380
4746,台耀,12,0,12,光和,2024-01-09,6380
6770,力積電,16,4,12,光和,2024-01-09,6380
2337,旺宏,11,0,11,光和,2024-01-09,6380
2405,輔信,20,9,11,光和,2024-01-09,6380
5309,系統電,15,4,11,光和,2024-01-09,6380
1101,台泥,10,0,10,光和,2024-01-09,6380
6196,帆宣,15,5,10,光和,2024-01-09,6380
1304,台聚,10,0,10,光和,2024-01-09,6380
00881,國泰台灣5G+,10,0,10,光和,2024-01-09,6380
2359,所羅門,13,3,10,光和,2024-01-09,6380
2377,微星,10,0,10,光和,2024-01-09,6380
4157,太景*-KY,10,0,10,光和,2024-01-09,6380
4960,誠美材,10,0,10,光和,2024-01-09,6380
6492,生華科,10,0,10,光和,2024-01-09,6380
8011,台通,11,1,10,光和,2024-01-09,6380
8131,福懋科,10,0,10,光和,2024-01-09,6380
1605,華新,15,7,8,光和,2024-01-09,6380
2736,富野,12,4,8,光和,2024-01-09,6380
6579,研揚,9,1,8,光和,2024-01-09,6380
2308,台達電,8,0,8,光和,2024-01-09,6380
00937B,群益ESG投等債20,118,25,93,光和,2024-01-10,6380
2618,長榮航,122,60,62,光和,2024-01-10,6380
00919,群益台灣精選高息,52,0,52,光和,2024-01-10,6380
2329,華泰,65,18,47,光和,2024-01-10,6380
2617,台航,52,10,42,光和,2024-01-10,6380
00929,復華台灣科技優息,67,30,37,光和,2024-01-10,6380
00885,富邦越南,31,0,31,光和,2024-01-10,6380
1710,東聯,31,0,31,光和,2024-01-10,6380
2352,佳世達,30,0,30,光和,2024-01-10,6380
2025,千興,30,0,30,光和,2024-01-10,6380
2344,華邦電,24,0,24,光和,2024-01-10,6380
2301,光寶科,28,5,23,光和,2024-01-10,6380
00679B,元大美債20年,22,0,22,光和,2024-01-10,6380
5498,凱崴,20,0,20,光和,2024-01-10,6380
5876,上海商銀,20,0,20,光和,2024-01-10,6380
2630,亞航,20,1,19,光和,2024-01-10,6380
5452,佶優,19,0,19,光和,2024-01-10,6380
2317,鴻海,19,1,18,光和,2024-01-10,6380
2609,陽明,57,41,16,光和,2024-01-10,6380
00918,大華優利高填息30,16,0,16,光和,2024-01-10,6380
1605,華新,36,20,16,光和,2024-01-10,6380
1314,中石化,13,0,13,光和,2024-01-10,6380
2409,友達,13,0,13,光和,2024-01-10,6380
2374,佳能,12,0,12,光和,2024-01-10,6380
2605,新興,12,0,12,光和,2024-01-10,6380
2312,金寶,11,0,11,光和,2024-01-10,6380
2460,建通,12,1,11,光和,2024-01-10,6380
3264,欣銓,11,0,11,光和,2024-01-10,6380
6112,邁達特,11,0,11,光和,2024-01-10,6380
8131,福懋科,11,0,11,光和,2024-01-10,6380
00878,國泰永續高股息,10,0,10,光和,2024-01-10,6380
1301,台塑,10,0,10,光和,2024-01-10,6380
00725B,國泰投資級公司債,10,0,10,光和,2024-01-10,6380
2023,燁輝,10,0,10,光和,2024-01-10,6380
3041,揚智,10,0,10,光和,2024-01-10,6380
3086,華義,17,7,10,光和,2024-01-10,6380
4113,聯上,10,0,10,光和,2024-01-10,6380
9919,康那香,10,0,10,光和,2024-01-10,6380
6292,迅德,9,0,9,光和,2024-01-10,6380
6223,旺矽,9,0,9,光和,2024-01-10,6380
3231,緯創,20,12,8,光和,2024-01-10,6380
1714,和桐,8,0,8,光和,2024-01-10,6380
2543,皇昌,8,0,8,光和,2024-01-10,6380
2891,中信金,8,0,8,光和,2024-01-10,6380
8086,宏捷科,8,0,8,光和,2024-01-10,6380
0056,元大高股息,9,2,7,光和,2024-01-10,6380
2353,宏��,54,47,7,光和,2024-01-10,6380
5425,台半,7,0,7,光和,2024-01-10,6380
1718,中纖,7,0,7,光和,2024-01-10,6380
1815,富喬,9,2,7,光和,2024-01-10,6380
2353,宏��,100,24,76,光和,2024-01-11,6380
00919,群益台灣精選高息,66,0,66,光和,2024-01-11,6380
00937B,群益ESG投等債20,55,0,55,光和,2024-01-11,6380
1301,台塑,60,21,39,光和,2024-01-11,6380
6239,力成,33,0,33,光和,2024-01-11,6380
00929,復華台灣科技優息,67,35,32,光和,2024-01-11,6380
4716,大立,30,0,30,光和,2024-01-11,6380
2408,南亞科,31,1,30,光和,2024-01-11,6380
2317,鴻海,22,0,22,光和,2024-01-11,6380
4714,永捷,22,0,22,光和,2024-01-11,6380
6116,彩晶,22,1,21,光和,2024-01-11,6380
6113,亞矽,16,0,16,光和,2024-01-11,6380
00927,群益半導體收益,15,0,15,光和,2024-01-11,6380
2359,所羅門,15,0,15,光和,2024-01-11,6380
2617,台航,15,0,15,光和,2024-01-11,6380
4960,誠美材,15,0,15,光和,2024-01-11,6380
6695,芯鼎,19,4,15,光和,2024-01-11,6380
2610,華航,30,16,14,光和,2024-01-11,6380
2105,正新,13,0,13,光和,2024-01-11,6380
5521,工信,17,4,13,光和,2024-01-11,6380
5483,中美晶,13,1,12,光和,2024-01-11,6380
6226,光鼎,12,0,12,光和,2024-01-11,6380
2388,威盛,12,1,11,光和,2024-01-11,6380
5452,佶優,11,0,11,光和,2024-01-11,6380
8222,寶一,12,1,11,光和,2024-01-11,6380
3521,鴻翊,10,0,10,光和,2024-01-11,6380
1444,力麗,10,0,10,光和,2024-01-11,6380
00922,國泰台灣領袖50,10,0,10,光和,2024-01-11,6380
00921,兆豐龍頭等權重,10,0,10,光和,2024-01-11,6380
1616,億泰,10,0,10,光和,2024-01-11,6380
1802,台玻,10,0,10,光和,2024-01-11,6380
2460,建通,10,0,10,光和,2024-01-11,6380
3499,環天科,10,0,10,光和,2024-01-11,6380
6153,嘉聯益,10,0,10,光和,2024-01-11,6380
00687B,國泰20年美債,10,0,10,光和,2024-01-11,6380
6120,達運,32,24,8,光和,2024-01-11,6380
2329,華泰,33,25,8,光和,2024-01-11,6380
5381,合正,10,2,8,光和,2024-01-11,6380
6596,寬宏藝術,8,0,8,光和,2024-01-11,6380
00715L,期街口布蘭特正2,10,3,7,光和,2024-01-11,6380
6770,力積電,7,0,7,光和,2024-01-11,6380
3481,群創,7,1,6,光和,2024-01-11,6380
1514,亞力,13,7,6,光和,2024-01-11,6380
2605,新興,6,0,6,光和,2024-01-11,6380
3234,光環,6,0,6,光和,2024-01-11,6380
3583,辛耘,6,0,6,光和,2024-01-11,6380
4746,台耀,6,0,6,光和,2024-01-11,6380
5469,瀚宇博,6,0,6,光和,2024-01-11,6380
6243,迅杰,6,0,6,光和,2024-01-11,6380
8096,擎亞,7,1,6,光和,2024-01-11,6380
00933B,國泰10Y+金融債,102,0,102,光和,2024-01-12,6380
5351,鈺創,72,0,72,光和,2024-01-12,6380
00929,復華台灣科技優息,69,0,69,光和,2024-01-12,6380
00919,群益台灣精選高息,63,3,60,光和,2024-01-12,6380
0056,元大高股息,56,1,55,光和,2024-01-12,6380
2353,宏��,67,18,49,光和,2024-01-12,6380
00897,富邦基因免疫生技,31,0,31,光和,2024-01-12,6380
2313,華通,46,17,29,光和,2024-01-12,6380
2408,南亞科,25,0,25,光和,2024-01-12,6380
2324,仁寶,35,11,24,光和,2024-01-12,6380
00882,中信中國高股息,20,0,20,光和,2024-01-12,6380
1618,合機,20,0,20,光和,2024-01-12,6380
2344,華邦電,29,10,19,光和,2024-01-12,6380
00937B,群益ESG投等債20,18,0,18,光和,2024-01-12,6380
00927,群益半導體收益,17,0,17,光和,2024-01-12,6380
5347,世界,15,0,15,光和,2024-01-12,6380
2356,英業達,30,16,14,光和,2024-01-12,6380
8034,榮群,15,2,13,光和,2024-01-12,6380
1314,中石化,13,0,13,光和,2024-01-12,6380
6026,福邦證,13,0,13,光和,2024-01-12,6380
1522,堤維西,11,0,11,光和,2024-01-12,6380
2329,華泰,18,7,11,光和,2024-01-12,6380
8176,智捷,10,0,10,光和,2024-01-12,6380
00932,兆豐永續高息等權,10,0,10,光和,2024-01-12,6380
00912,中信臺灣智慧50,10,0,10,光和,2024-01-12,6380
00907,永豐優息存股,10,0,10,光和,2024-01-12,6380
00673R,期元大S＆P原油反1,10,0,10,光和,2024-01-12,6380
2023,燁輝,10,0,10,光和,2024-01-12,6380
3714,富采,10,0,10,光和,2024-01-12,6380
4766,南寶,10,0,10,光和,2024-01-12,6380
4961,天鈺,10,0,10,光和,2024-01-12,6380
00713,元大台灣高息低波,9,0,9,光和,2024-01-12,6380
6505,台塑化,9,0,9,光和,2024-01-12,6380
00671R,富邦NASDAQ反1,9,0,9,光和,2024-01-12,6380
4967,十銓,9,0,9,光和,2024-01-12,6380
1301,台塑,8,0,8,光和,2024-01-12,6380
1319,東陽,11,3,8,光和,2024-01-12,6380
2303,聯電,8,0,8,光和,2024-01-12,6380
2331,精英,8,0,8,光和,2024-01-12,6380
1605,華新,7,0,7,光和,2024-01-12,6380
2610,華航,14,7,7,光和,2024-01-12,6380
3265,台星科,8,1,7,光和,2024-01-12,6380
4909,新復興,9,2,7,光和,2024-01-12,6380
1515,力山,6,0,6,光和,2024-01-12,6380
2365,昆盈,8,2,6,光和,2024-01-12,6380
6239,力成,6,0,6,光和,2024-01-12,6380
9919,康那香,6,0,6,光和,2024-01-12,6380
6164,華興,5,0,5,光和,2024-01-12,6380
6530,創威,8,3,5,光和,2024-01-12,6380
00679B,元大美債20年,5,0,5,光和,2024-01-12,6380
2883,凱基金,242,1,241,光和,2024-01-15,6380
00929,復華台灣科技優息,194,42,152,光和,2024-01-15,6380
00712,復華富時不動產,112,0,112,光和,2024-01-15,6380
2888,新光金,85,13,72,光和,2024-01-15,6380
00918,大華優利高填息30,52,0,52,光和,2024-01-15,6380
2353,宏��,53,13,40,光和,2024-01-15,6380
4716,大立,35,0,35,光和,2024-01-15,6380
2371,大同,70,38,32,光和,2024-01-15,6380
5351,鈺創,39,10,29,光和,2024-01-15,6380
2303,聯電,26,0,26,光和,2024-01-15,6380
6116,彩晶,26,0,26,光和,2024-01-15,6380
1605,華新,25,1,24,光和,2024-01-15,6380
8034,榮群,36,14,22,光和,2024-01-15,6380
3231,緯創,51,29,22,光和,2024-01-15,6380
1784,訊聯,21,0,21,光和,2024-01-15,6380
2855,統一證,20,0,20,光和,2024-01-15,6380
00632R,元大台灣50反1,20,0,20,光和,2024-01-15,6380
2356,英業達,28,10,18,光和,2024-01-15,6380
2610,華航,39,23,16,光和,2024-01-15,6380
3481,群創,18,2,16,光和,2024-01-15,6380
00937B,群益ESG投等債20,17,2,15,光和,2024-01-15,6380
8150,南茂,15,0,15,光和,2024-01-15,6380
2204,中華,14,0,14,光和,2024-01-15,6380
4909,新復興,18,5,13,光和,2024-01-15,6380
2867,三商壽,12,0,12,光和,2024-01-15,6380
6442,光聖,12,0,12,光和,2024-01-15,6380
1905,華紙,11,0,11,光和,2024-01-15,6380
00885,富邦越南,10,0,10,光和,2024-01-15,6380
2105,正新,10,0,10,光和,2024-01-15,6380
3715,定穎投控,10,0,10,光和,2024-01-15,6380
4161,聿新科,10,0,10,光和,2024-01-15,6380
4956,光鋐,10,0,10,光和,2024-01-15,6380
5398,慕康生醫,10,0,10,光和,2024-01-15,6380
6016,康和證,10,0,10,光和,2024-01-15,6380
2317,鴻海,10,0,10,光和,2024-01-15,6380
2436,偉詮電,10,1,9,光和,2024-01-15,6380
3017,奇鋐,9,0,9,光和,2024-01-15,6380
8222,寶一,11,2,9,光和,2024-01-15,6380
8096,擎亞,33,24,9,光和,2024-01-15,6380
6168,宏齊,8,0,8,光和,2024-01-15,6380
1514,亞力,14,6,8,光和,2024-01-15,6380
1616,億泰,7,0,7,光和,2024-01-15,6380
8038,長園科,7,0,7,光和,2024-01-15,6380
2634,漢翔,14,7,7,光和,2024-01-15,6380
2816,旺旺保,6,0,6,光和,2024-01-15,6380
3264,欣銓,6,0,6,光和,2024-01-15,6380
8110,華東,6,0,6,光和,2024-01-15,6380
00922,國泰台灣領袖50,5,0,5,光和,2024-01-15,6380
00915,凱基優選高股息30,5,0,5,光和,2024-01-15,6380
1217,愛之味,5,0,5,光和,2024-01-15,6380
00929,復華台灣科技優息,268,73,195,光和,2024-01-16,6380
0056,元大高股息,138,1,137,光和,2024-01-16,6380
1301,台塑,133,0,133,光和,2024-01-16,6380
2883,凱基金,127,0,127,光和,2024-01-16,6380
2888,新光金,68,1,67,光和,2024-01-16,6380
6016,康和證,66,3,63,光和,2024-01-16,6380
1609,大亞,55,0,55,光和,2024-01-16,6380
5347,世界,49,4,45,光和,2024-01-16,6380
00881,國泰台灣5G+,42,0,42,光和,2024-01-16,6380
8111,立��,35,0,35,光和,2024-01-16,6380
3702,大聯大,33,1,32,光和,2024-01-16,6380
6695,芯鼎,46,14,32,光和,2024-01-16,6380
1616,億泰,30,0,30,光和,2024-01-16,6380
1101,台泥,30,0,30,光和,2024-01-16,6380
2313,華通,35,6,29,光和,2024-01-16,6380
2887,台新金,29,0,29,光和,2024-01-16,6380
2406,國碩,28,0,28,光和,2024-01-16,6380
00927,群益半導體收益,25,0,25,光和,2024-01-16,6380
2486,一詮,35,13,22,光和,2024-01-16,6380
2401,凌陽,24,3,21,光和,2024-01-16,6380
00904,新光臺灣半導體30,20,0,20,光和,2024-01-16,6380
2317,鴻海,22,2,20,光和,2024-01-16,6380
5443,均豪,22,2,20,光和,2024-01-16,6380
1608,華榮,20,1,19,光和,2024-01-16,6380
5315,光聯,19,0,19,光和,2024-01-16,6380
2349,錸德,18,0,18,光和,2024-01-16,6380
00919,群益台灣精選高息,82,66,16,光和,2024-01-16,6380
2801,彰銀,16,0,16,光和,2024-01-16,6380
2889,國票金,16,0,16,光和,2024-01-16,6380
4188,安克,16,0,16,光和,2024-01-16,6380
2618,長榮航,24,8,16,光和,2024-01-16,6380
4716,大立,18,2,16,光和,2024-01-16,6380
00907,永豐優息存股,15,0,15,光和,2024-01-16,6380
4167,松瑞藥,15,0,15,光和,2024-01-16,6380
2610,華航,30,15,15,光和,2024-01-16,6380
2201,裕隆,14,1,13,光和,2024-01-16,6380
3576,聯合再生,12,0,12,光和,2024-01-16,6380
6698,旭暉應材,15,3,12,光和,2024-01-16,6380
2441,超豐,11,0,11,光和,2024-01-16,6380
00753L,中信中國50正2,11,0,11,光和,2024-01-16,6380
00937B,群益ESG投等債20,11,0,11,光和,2024-01-16,6380
1618,合機,12,1,11,光和,2024-01-16,6380
6026,福邦證,11,0,11,光和,2024-01-16,6380
3231,緯創,25,15,10,光和,2024-01-16,6380
00931B,統一美債20年,10,0,10,光和,2024-01-16,6380
1215,卜蜂,10,0,10,光和,2024-01-16,6380
2106,建大,10,0,10,光和,2024-01-16,6380
4729,熒茂,10,0,10,光和,2024-01-16,6380
5876,上海商銀,10,0,10,光和,2024-01-16,6380
6140,訊達,11,1,10,光和,2024-01-16,6380
00929,復華台灣科技優息,215,50,165,光和,2024-01-17,6380
00919,群益台灣精選高息,160,29,131,光和,2024-01-17,6380
00688L,國泰20年美債正2,103,0,103,光和,2024-01-17,6380
00633L,富邦上証正2,100,0,100,光和,2024-01-17,6380
1449,佳和,97,1,96,光和,2024-01-17,6380
2344,華邦電,121,28,93,光和,2024-01-17,6380
2618,長榮航,103,10,93,光和,2024-01-17,6380
00882,中信中國高股息,74,0,74,光和,2024-01-17,6380
00665L,富邦�琤肭磪囓�2,100,30,70,光和,2024-01-17,6380
00878,國泰永續高股息,70,16,54,光和,2024-01-17,6380
1609,大亞,49,0,49,光和,2024-01-17,6380
0056,元大高股息,64,24,40,光和,2024-01-17,6380
5488,松普,40,1,39,光和,2024-01-17,6380
00712,復華富時不動產,35,0,35,光和,2024-01-17,6380
2888,新光金,42,7,35,光和,2024-01-17,6380
2610,華航,64,30,34,光和,2024-01-17,6380
2303,聯電,58,24,34,光和,2024-01-17,6380
2317,鴻海,41,8,33,光和,2024-01-17,6380
2365,昆盈,30,0,30,光和,2024-01-17,6380
5347,世界,30,0,30,光和,2024-01-17,6380
2801,彰銀,29,0,29,光和,2024-01-17,6380
2882,國泰金,29,0,29,光和,2024-01-17,6380
2887,台新金,29,0,29,光和,2024-01-17,6380
5315,光聯,28,0,28,光和,2024-01-17,6380
6770,力積電,27,1,26,光和,2024-01-17,6380
1616,億泰,25,0,25,光和,2024-01-17,6380
2883,凱基金,32,7,25,光和,2024-01-17,6380
6156,松上,25,0,25,光和,2024-01-17,6380
1802,台玻,24,0,24,光和,2024-01-17,6380
2002,中鋼,37,13,24,光和,2024-01-17,6380
2337,旺宏,24,1,23,光和,2024-01-17,6380
2313,華通,23,0,23,光和,2024-01-17,6380
2884,玉山金,23,0,23,光和,2024-01-17,6380
2356,英業達,29,7,22,光和,2024-01-17,6380
00753L,中信中國50正2,20,0,20,光和,2024-01-17,6380
2025,千興,20,0,20,光和,2024-01-17,6380
2104,國際中橡,20,0,20,光和,2024-01-17,6380
5876,上海商銀,20,0,20,光和,2024-01-17,6380
8085,福華,20,0,20,光和,2024-01-17,6380
3041,揚智,43,24,19,光和,2024-01-17,6380
2408,南亞科,17,1,16,光和,2024-01-17,6380
6442,光聖,16,0,16,光和,2024-01-17,6380
00933B,國泰10Y+金融債,15,0,15,光和,2024-01-17,6380
1471,首利,16,1,15,光和,2024-01-17,6380
2329,華泰,33,18,15,光和,2024-01-17,6380
00937B,群益ESG投等債20,17,3,14,光和,2024-01-17,6380
1314,中石化,25,11,14,光和,2024-01-17,6380
4167,松瑞藥,14,0,14,光和,2024-01-17,6380
6215,和椿,14,0,14,光和,2024-01-17,6380
2609,陽明,25,11,14,光和,2024-01-17,6380
2313,華通,131,15,116,光和,2024-01-18,6380
2888,新光金,105,17,88,光和,2024-01-18,6380
00929,復華台灣科技優息,89,30,59,光和,2024-01-18,6380
00937B,群益ESG投等債20,58,0,58,光和,2024-01-18,6380
00633L,富邦上証正2,50,0,50,光和,2024-01-18,6380
00882,中信中國高股息,43,0,43,光和,2024-01-18,6380
2867,三商壽,41,0,41,光和,2024-01-18,6380
1314,中石化,36,1,35,光和,2024-01-18,6380
2303,聯電,44,10,34,光和,2024-01-18,6380
6531,愛普*,33,3,30,光和,2024-01-18,6380
2002,中鋼,32,3,29,光和,2024-01-18,6380
6770,力積電,27,0,27,光和,2024-01-18,6380
00637L,元大滬深300正2,29,2,27,光和,2024-01-18,6380
4714,永捷,23,0,23,光和,2024-01-18,6380
2027,大成鋼,21,0,21,光和,2024-01-18,6380
2371,大同,38,17,21,光和,2024-01-18,6380
2305,全友,20,0,20,光和,2024-01-18,6380
2427,三商電,20,0,20,光和,2024-01-18,6380
6668,中揚光,24,4,20,光和,2024-01-18,6380
8354,冠好,20,0,20,光和,2024-01-18,6380
2881,富邦金,19,0,19,光和,2024-01-18,6380
2887,台新金,18,0,18,光和,2024-01-18,6380
4960,誠美材,17,0,17,光和,2024-01-18,6380
1101,台泥,16,0,16,光和,2024-01-18,6380
2317,鴻海,17,1,16,光和,2024-01-18,6380
00918,大華優利高填息30,16,0,16,光和,2024-01-18,6380
2329,華泰,27,11,16,光和,2024-01-18,6380
4114,健喬,15,0,15,光和,2024-01-18,6380
3231,緯創,16,2,14,光和,2024-01-18,6380
9910,豐泰,13,0,13,光和,2024-01-18,6380
2374,佳能,12,0,12,光和,2024-01-18,6380
2633,台灣高鐵,12,0,12,光和,2024-01-18,6380
2885,元大金,11,0,11,光和,2024-01-18,6380
00687B,國泰20年美債,11,0,11,光和,2024-01-18,6380
2801,彰銀,11,0,11,光和,2024-01-18,6380
5315,光聯,11,0,11,光和,2024-01-18,6380
1701,中化,10,0,10,光和,2024-01-18,6380
2009,第一銅,10,0,10,光和,2024-01-18,6380
2103,台橡,10,0,10,光和,2024-01-18,6380
2359,所羅門,10,0,10,光和,2024-01-18,6380
3202,樺晟,10,0,10,光和,2024-01-18,6380
5011,久陽,10,0,10,光和,2024-01-18,6380
9105,泰金寶-DR,10,0,10,光和,2024-01-18,6380
2324,仁寶,13,4,9,光和,2024-01-18,6380
1712,興農,10,1,9,光和,2024-01-18,6380
2208,台船,9,0,9,光和,2024-01-18,6380
3706,神達,10,1,9,光和,2024-01-18,6380
6547,高端疫苗,9,0,9,光和,2024-01-18,6380
1609,大亞,32,24,8,光和,2024-01-18,6380
2409,友達,11,3,8,光和,2024-01-18,6380
00632R,元大台灣50反1,401,0,401,光和,2024-01-19,6380
00687B,國泰20年美債,169,0,169,光和,2024-01-19,6380
00664R,國泰臺灣加權反1,90,0,90,光和,2024-01-19,6380
00931B,統一美債20年,86,0,86,光和,2024-01-19,6380
2027,大成鋼,82,0,82,光和,2024-01-19,6380
2405,輔信,77,0,77,光和,2024-01-19,6380
00688L,國泰20年美債正2,52,0,52,光和,2024-01-19,6380
00929,復華台灣科技優息,61,11,50,光和,2024-01-19,6380
00937B,群益ESG投等債20,44,0,44,光和,2024-01-19,6380
2324,仁寶,60,20,40,光和,2024-01-19,6380
6163,華電網,40,0,40,光和,2024-01-19,6380
2002,中鋼,37,0,37,光和,2024-01-19,6380
2888,新光金,35,4,31,光和,2024-01-19,6380
4960,誠美材,30,2,28,光和,2024-01-19,6380
2801,彰銀,32,5,27,光和,2024-01-19,6380
2618,長榮航,26,0,26,光和,2024-01-19,6380
8436,大江,25,0,25,光和,2024-01-19,6380
1514,亞力,24,2,22,光和,2024-01-19,6380
2356,英業達,104,82,22,光和,2024-01-19,6380
6116,彩晶,22,0,22,光和,2024-01-19,6380
00897,富邦基因免疫生技,20,0,20,光和,2024-01-19,6380
1710,東聯,20,0,20,光和,2024-01-19,6380
2515,中工,20,2,18,光和,2024-01-19,6380
00680L,元大美債20正2,16,0,16,光和,2024-01-19,6380
5521,工信,20,4,16,光和,2024-01-19,6380
6285,啟��,19,4,15,光和,2024-01-19,6380
6695,芯鼎,30,15,15,光和,2024-01-19,6380
00679B,元大美債20年,18,4,14,光和,2024-01-19,6380
6120,達運,40,26,14,光和,2024-01-19,6380
00882,中信中國高股息,13,0,13,光和,2024-01-19,6380
1609,大亞,13,1,12,光和,2024-01-19,6380
2423,固緯,12,0,12,光和,2024-01-19,6380
6547,高端疫苗,12,1,11,光和,2024-01-19,6380
2603,長榮,12,1,11,光和,2024-01-19,6380
4528,江興鍛,11,0,11,光和,2024-01-19,6380
6443,元晶,11,0,11,光和,2024-01-19,6380
00662,富邦NASDAQ,10,0,10,光和,2024-01-19,6380
00673R,期元大S＆P原油反1,10,0,10,光和,2024-01-19,6380
00918,大華優利高填息30,10,0,10,光和,2024-01-19,6380
1444,力麗,10,0,10,光和,2024-01-19,6380
1907,永豐餘,10,0,10,光和,2024-01-19,6380
2444,兆勁,10,0,10,光和,2024-01-19,6380
2460,建通,14,4,10,光和,2024-01-19,6380
5880,合庫金,10,0,10,光和,2024-01-19,6380
6147,頎邦,10,0,10,光和,2024-01-19,6380
8111,立��,10,0,10,光和,2024-01-19,6380
9105,泰金寶-DR,10,0,10,光和,2024-01-19,6380
3622,洋華,9,0,9,光和,2024-01-19,6380
5315,光聯,9,0,9,光和,2024-01-19,6380
8176,智捷,10,1,9,光和,2024-01-19,6380
2353,宏��,216,70,146,光和,2024-01-22,6380
00680L,元大美債20正2,110,0,110,光和,2024-01-22,6380
5211,蒙恬,70,0,70,光和,2024-01-22,6380
2618,長榮航,77,9,68,光和,2024-01-22,6380
00632R,元大台灣50反1,51,0,51,光和,2024-01-22,6380
00664R,國泰臺灣加權反1,50,0,50,光和,2024-01-22,6380
3390,旭軟,47,0,47,光和,2024-01-22,6380
3481,群創,114,68,46,光和,2024-01-22,6380
00648R,元大S＆P500反1,38,0,38,光和,2024-01-22,6380
2609,陽明,40,4,36,光和,2024-01-22,6380
6695,芯鼎,41,7,34,光和,2024-01-22,6380
00752,中信中國50,30,0,30,光和,2024-01-22,6380
3041,揚智,30,0,30,光和,2024-01-22,6380
00878,國泰永續高股息,50,23,27,光和,2024-01-22,6380
2867,三商壽,26,0,26,光和,2024-01-22,6380
2316,楠梓電,24,0,24,光和,2024-01-22,6380
5521,工信,25,1,24,光和,2024-01-22,6380
6290,良維,23,0,23,光和,2024-01-22,6380
2002,中鋼,22,0,22,光和,2024-01-22,6380
9919,康那香,24,2,22,光和,2024-01-22,6380
3706,神達,30,9,21,光和,2024-01-22,6380
2324,仁寶,39,19,20,光和,2024-01-22,6380
3325,旭品,20,0,20,光和,2024-01-22,6380
00753L,中信中國50正2,19,0,19,光和,2024-01-22,6380
1449,佳和,20,2,18,光和,2024-01-22,6380
6116,彩晶,20,2,18,光和,2024-01-22,6380
6668,中揚光,35,17,18,光和,2024-01-22,6380
1909,榮成,18,1,17,光和,2024-01-22,6380
2317,鴻海,18,2,16,光和,2024-01-22,6380
3623,富晶通,16,0,16,光和,2024-01-22,6380
2344,華邦電,26,11,15,光和,2024-01-22,6380
2369,菱生,27,12,15,光和,2024-01-22,6380
8354,冠好,15,0,15,光和,2024-01-22,6380
00919,群益台灣精選高息,14,0,14,光和,2024-01-22,6380
00882,中信中國高股息,14,0,14,光和,2024-01-22,6380
2408,南亞科,14,0,14,光和,2024-01-22,6380
2883,凱基金,17,3,14,光和,2024-01-22,6380
2892,第一金,13,1,12,光和,2024-01-22,6380
00679B,元大美債20年,11,0,11,光和,2024-01-22,6380
1609,大亞,21,10,11,光和,2024-01-22,6380
2481,強茂,11,0,11,光和,2024-01-22,6380
2515,中工,12,1,11,光和,2024-01-22,6380
4938,和碩,11,0,11,光和,2024-01-22,6380
8358,金居,16,5,11,光和,2024-01-22,6380
8436,大江,11,0,11,光和,2024-01-22,6380
2025,千興,10,0,10,光和,2024-01-22,6380
2359,所羅門,10,0,10,光和,2024-01-22,6380
2438,翔耀,10,0,10,光和,2024-01-22,6380
3450,聯鈞,10,0,10,光和,2024-01-22,6380
4915,致伸,10,0,10,光和,2024-01-22,6380
00632R,元大台灣50反1,251,0,251,光和,2024-01-23,6380
00633L,富邦上証正2,150,0,150,光和,2024-01-23,6380
2610,華航,120,0,120,光和,2024-01-23,6380
1218,泰山,50,0,50,光和,2024-01-23,6380
2356,英業達,142,102,40,光和,2024-01-23,6380
00706L,期元大S＆P日圓正2,40,0,40,光和,2024-01-23,6380
00900,富邦特選高股息30,30,0,30,光和,2024-01-23,6380
4716,大立,30,0,30,光和,2024-01-23,6380
5426,振發,43,13,30,光和,2024-01-23,6380
2303,聯電,37,9,28,光和,2024-01-23,6380
00919,群益台灣精選高息,27,0,27,光和,2024-01-23,6380
3059,華晶科,35,8,27,光和,2024-01-23,6380
00712,復華富時不動產,26,0,26,光和,2024-01-23,6380
6215,和椿,22,0,22,光和,2024-01-23,6380
00937B,群益ESG投等債20,21,0,21,光和,2024-01-23,6380
0056,元大高股息,22,1,21,光和,2024-01-23,6380
00929,復華台灣科技優息,20,0,20,光和,2024-01-23,6380
00882,中信中國高股息,20,0,20,光和,2024-01-23,6380
00664R,國泰臺灣加權反1,20,0,20,光和,2024-01-23,6380
2486,一詮,19,0,19,光和,2024-01-23,6380
2609,陽明,35,17,18,光和,2024-01-23,6380
1708,東鹼,15,0,15,光和,2024-01-23,6380
2887,台新金,14,0,14,光和,2024-01-23,6380
1319,東陽,16,3,13,光和,2024-01-23,6380
2329,華泰,22,10,12,光和,2024-01-23,6380
2208,台船,12,0,12,光和,2024-01-23,6380
5468,凱鈺,12,0,12,光和,2024-01-23,6380
00679B,元大美債20年,11,0,11,光和,2024-01-23,6380
1522,堤維西,11,0,11,光和,2024-01-23,6380
2612,中航,11,0,11,光和,2024-01-23,6380
00933B,國泰10Y+金融債,10,0,10,光和,2024-01-23,6380
1101,台泥,11,1,10,光和,2024-01-23,6380
00907,永豐優息存股,10,0,10,光和,2024-01-23,6380
3231,緯創,41,31,10,光和,2024-01-23,6380
6418,詠昇,10,0,10,光和,2024-01-23,6380
8437,大地-KY,10,0,10,光和,2024-01-23,6380
1616,億泰,10,1,9,光和,2024-01-23,6380
2603,長榮,21,12,9,光和,2024-01-23,6380
3583,辛耘,9,1,8,光和,2024-01-23,6380
2365,昆盈,7,0,7,光和,2024-01-23,6380
3354,律勝,9,2,7,光和,2024-01-23,6380
8096,擎亞,56,50,6,光和,2024-01-23,6380
2010,春源,6,0,6,光和,2024-01-23,6380
3712,永崴投控,6,0,6,光和,2024-01-23,6380
00904,新光臺灣半導體30,5,0,5,光和,2024-01-23,6380
00673R,期元大S＆P原油反1,5,0,5,光和,2024-01-23,6380
2211,長榮鋼,5,0,5,光和,2024-01-23,6380
2331,精英,5,0,5,光和,2024-01-23,6380
2405,輔信,6,1,5,光和,2024-01-23,6380
2511,太子,5,0,5,光和,2024-01-23,6380
00937B,群益ESG投等債20,199,3,196,光和,2024-01-24,6380
2353,宏��,64,13,51,光和,2024-01-24,6380
2356,英業達,126,82,44,光和,2024-01-24,6380
2369,菱生,141,100,41,光和,2024-01-24,6380
8105,凌巨,33,1,32,光和,2024-01-24,6380
2884,玉山金,28,0,28,光和,2024-01-24,6380
3481,群創,115,89,26,光和,2024-01-24,6380
2409,友達,29,3,26,光和,2024-01-24,6380
2465,麗臺,26,1,25,光和,2024-01-24,6380
8936,國統,31,7,24,光和,2024-01-24,6380
2891,中信金,23,0,23,光和,2024-01-24,6380
2609,陽明,34,12,22,光和,2024-01-24,6380
00919,群益台灣精選高息,21,1,20,光和,2024-01-24,6380
00706L,期元大S＆P日圓正2,20,0,20,光和,2024-01-24,6380
1301,台塑,19,1,18,光和,2024-01-24,6380
00637L,元大滬深300正2,19,1,18,光和,2024-01-24,6380
2801,彰銀,20,2,18,光和,2024-01-24,6380
0056,元大高股息,24,7,17,光和,2024-01-24,6380
6770,力積電,22,5,17,光和,2024-01-24,6380
00679B,元大美債20年,16,0,16,光和,2024-01-24,6380
3583,辛耘,19,3,16,光和,2024-01-24,6380
3703,欣陸,15,0,15,光和,2024-01-24,6380
4909,新復興,21,6,15,光和,2024-01-24,6380
00878,國泰永續高股息,20,6,14,光和,2024-01-24,6380
00687B,國泰20年美債,14,1,13,光和,2024-01-24,6380
2605,新興,13,0,13,光和,2024-01-24,6380
1319,東陽,16,4,12,光和,2024-01-24,6380
00933B,國泰10Y+金融債,12,0,12,光和,2024-01-24,6380
2344,華邦電,25,13,12,光和,2024-01-24,6380
8034,榮群,14,2,12,光和,2024-01-24,6380
1514,亞力,13,2,11,光和,2024-01-24,6380
1522,堤維西,11,0,11,光和,2024-01-24,6380
3288,點晶,11,0,11,光和,2024-01-24,6380
00738U,期元大道瓊白銀,10,0,10,光和,2024-01-24,6380
00881,國泰台灣5G+,10,0,10,光和,2024-01-24,6380
1609,大亞,11,1,10,光和,2024-01-24,6380
1783,和康生,10,0,10,光和,2024-01-24,6380
2405,輔信,15,5,10,光和,2024-01-24,6380
2615,萬海,10,0,10,光和,2024-01-24,6380
3545,敦泰,11,1,10,光和,2024-01-24,6380
5210,寶碩,10,0,10,光和,2024-01-24,6380
5443,均豪,25,15,10,光和,2024-01-24,6380
6418,詠昇,10,0,10,光和,2024-01-24,6380
8489,三貝德,10,0,10,光和,2024-01-24,6380
2023,燁輝,9,0,9,光和,2024-01-24,6380
2301,光寶科,16,7,9,光和,2024-01-24,6380
6120,達運,9,0,9,光和,2024-01-24,6380
2404,漢唐,8,0,8,光和,2024-01-24,6380
3260,威剛,17,9,8,光和,2024-01-24,6380
3490,單井,11,3,8,光和,2024-01-24,6380
00665L,富邦�琤肭磪囓�2,502,100,402,光和,2024-01-25,6380
00632R,元大台灣50反1,81,0,81,光和,2024-01-25,6380
5426,振發,82,17,65,光和,2024-01-25,6380
00877,復華中國5G,70,8,62,光和,2024-01-25,6380
00937B,群益ESG投等債20,65,5,60,光和,2024-01-25,6380
00687B,國泰20年美債,41,0,41,光和,2024-01-25,6380
2313,華通,39,4,35,光和,2024-01-25,6380
2031,新光鋼,33,0,33,光和,2024-01-25,6380
00882,中信中國高股息,40,10,30,光和,2024-01-25,6380
3231,緯創,58,30,28,光和,2024-01-25,6380
00673R,期元大S＆P原油反1,25,0,25,光和,2024-01-25,6380
3339,泰谷,27,4,23,光和,2024-01-25,6380
3444,利機,20,0,20,光和,2024-01-25,6380
2460,建通,19,0,19,光和,2024-01-25,6380
00931B,統一美債20年,18,0,18,光和,2024-01-25,6380
6164,華興,17,0,17,光和,2024-01-25,6380
00919,群益台灣精選高息,18,2,16,光和,2024-01-25,6380
1616,億泰,15,0,15,光和,2024-01-25,6380
6244,茂迪,15,0,15,光和,2024-01-25,6380
00679B,元大美債20年,13,0,13,光和,2024-01-25,6380
00712,復華富時不動產,13,0,13,光和,2024-01-25,6380
8436,大江,13,0,13,光和,2024-01-25,6380
2421,建準,20,8,12,光和,2024-01-25,6380
2329,華泰,20,9,11,光和,2024-01-25,6380
2405,輔信,11,0,11,光和,2024-01-25,6380
8105,凌巨,12,1,11,光和,2024-01-25,6380
5880,合庫金,11,0,11,光和,2024-01-25,6380
3443,創意,14,3,11,光和,2024-01-25,6380
00891,中信關鍵半導體,10,0,10,光和,2024-01-25,6380
00680L,元大美債20正2,10,0,10,光和,2024-01-25,6380
00706L,期元大S＆P日圓正2,10,0,10,光和,2024-01-25,6380
1447,力鵬,10,0,10,光和,2024-01-25,6380
1815,富喬,10,0,10,光和,2024-01-25,6380
2332,友訊,10,0,10,光和,2024-01-25,6380
2390,云辰,10,0,10,光和,2024-01-25,6380
2609,陽明,14,4,10,光和,2024-01-25,6380
2610,華航,10,0,10,光和,2024-01-25,6380
4113,聯上,10,0,10,光和,2024-01-25,6380
4729,熒茂,10,0,10,光和,2024-01-25,6380
6116,彩晶,10,0,10,光和,2024-01-25,6380
6182,合晶,10,0,10,光和,2024-01-25,6380
1524,耿鼎,9,0,9,光和,2024-01-25,6380
4956,光鋐,25,16,9,光和,2024-01-25,6380
6026,福邦證,9,0,9,光和,2024-01-25,6380
3615,安可,15,7,8,光和,2024-01-25,6380
2884,玉山金,8,0,8,光和,2024-01-25,6380
00664R,國泰臺灣加權反1,7,0,7,光和,2024-01-25,6380
1582,信錦,7,0,7,光和,2024-01-25,6380
2369,菱生,41,34,7,光和,2024-01-25,6380
2374,佳能,7,0,7,光和,2024-01-25,6380
00665L,富邦�琤肭磪囓�2,120,0,120,光和,2024-01-26,6380
00642U,期元大S＆P石油,100,4,96,光和,2024-01-26,6380
2303,聯電,88,4,84,光和,2024-01-26,6380
2324,仁寶,80,23,57,光和,2024-01-26,6380
00687B,國泰20年美債,41,0,41,光和,2024-01-26,6380
00673R,期元大S＆P原油反1,42,5,37,光和,2024-01-26,6380
2329,華泰,38,2,36,光和,2024-01-26,6380
00877,復華中國5G,34,0,34,光和,2024-01-26,6380
1449,佳和,30,0,30,光和,2024-01-26,6380
3481,群創,80,50,30,光和,2024-01-26,6380
6116,彩晶,30,2,28,光和,2024-01-26,6380
00919,群益台灣精選高息,25,0,25,光和,2024-01-26,6380
00706L,期元大S＆P日圓正2,20,0,20,光和,2024-01-26,6380
2365,昆盈,62,43,19,光和,2024-01-26,6380
2313,華通,19,1,18,光和,2024-01-26,6380
6215,和椿,18,0,18,光和,2024-01-26,6380
8111,立��,24,6,18,光和,2024-01-26,6380
2301,光寶科,15,0,15,光和,2024-01-26,6380
1101,台泥,15,1,14,光和,2024-01-26,6380
3149,正達,14,0,14,光和,2024-01-26,6380
1609,大亞,12,0,12,光和,2024-01-26,6380
0056,元大高股息,14,3,11,光和,2024-01-26,6380
5381,合正,16,5,11,光和,2024-01-26,6380
5452,佶優,11,0,11,光和,2024-01-26,6380
8034,榮群,11,0,11,光和,2024-01-26,6380
00753L,中信中國50正2,10,0,10,光和,2024-01-26,6380
00680L,元大美債20正2,10,0,10,光和,2024-01-26,6380
1568,倉佑,10,0,10,光和,2024-01-26,6380
2340,台亞,10,0,10,光和,2024-01-26,6380
3535,晶彩科,18,8,10,光和,2024-01-26,6380
6282,康舒,10,0,10,光和,2024-01-26,6380
6509,聚和,10,0,10,光和,2024-01-26,6380
8110,華東,18,9,9,光和,2024-01-26,6380
2382,廣達,9,1,8,光和,2024-01-26,6380
2362,藍天,8,0,8,光和,2024-01-26,6380
3339,泰谷,8,0,8,光和,2024-01-26,6380
3354,律勝,18,10,8,光和,2024-01-26,6380
3623,富晶通,13,5,8,光和,2024-01-26,6380
3231,緯創,39,31,8,光和,2024-01-26,6380
2401,凌陽,7,0,7,光和,2024-01-26,6380
3583,辛耘,7,0,7,光和,2024-01-26,6380
6257,矽格,9,2,7,光和,2024-01-26,6380
2605,新興,6,0,6,光和,2024-01-26,6380
3032,偉訓,6,0,6,光和,2024-01-26,6380
6112,邁達特,6,0,6,光和,2024-01-26,6380
6182,合晶,8,2,6,光和,2024-01-26,6380
3360,尚立,19,13,6,光和,2024-01-26,6380
00937B,群益ESG投等債20,5,0,5,光和,2024-01-26,6380
1616,億泰,5,0,5,光和,2024-01-26,6380
2014,中鴻,5,0,5,光和,2024-01-26,6380
00877,復華中國5G,157,0,157,光和,2024-01-29,6380
00937B,群益ESG投等債20,131,0,131,光和,2024-01-29,6380
6116,彩晶,65,0,65,光和,2024-01-29,6380
1457,宜進,50,0,50,光和,2024-01-29,6380
00632R,元大台灣50反1,45,0,45,光和,2024-01-29,6380
1316,上曜,50,10,40,光和,2024-01-29,6380
3059,華晶科,37,1,36,光和,2024-01-29,6380
2362,藍天,34,0,34,光和,2024-01-29,6380
2337,旺宏,32,0,32,光和,2024-01-29,6380
2349,錸德,30,0,30,光和,2024-01-29,6380
2365,昆盈,27,0,27,光和,2024-01-29,6380
00679B,元大美債20年,20,0,20,光和,2024-01-29,6380
00673R,期元大S＆P原油反1,20,0,20,光和,2024-01-29,6380
00706L,期元大S＆P日圓正2,20,0,20,光和,2024-01-29,6380
2104,國際中橡,20,0,20,光和,2024-01-29,6380
5355,佳總,20,0,20,光和,2024-01-29,6380
6153,嘉聯益,19,0,19,光和,2024-01-29,6380
1301,台塑,18,0,18,光和,2024-01-29,6380
8111,立��,18,0,18,光和,2024-01-29,6380
2618,長榮航,42,26,16,光和,2024-01-29,6380
3622,洋華,15,0,15,光和,2024-01-29,6380
00687B,國泰20年美債,15,2,13,光和,2024-01-29,6380
6026,福邦證,12,0,12,光和,2024-01-29,6380
2409,友達,15,4,11,光和,2024-01-29,6380
5426,振發,12,1,11,光和,2024-01-29,6380
00753L,中信中國50正2,10,0,10,光和,2024-01-29,6380
2023,燁輝,10,0,10,光和,2024-01-29,6380
2405,輔信,10,0,10,光和,2024-01-29,6380
2460,建通,10,0,10,光和,2024-01-29,6380
3535,晶彩科,10,0,10,光和,2024-01-29,6380
5347,世界,10,0,10,光和,2024-01-29,6380
6016,康和證,10,0,10,光和,2024-01-29,6380
8222,寶一,10,0,10,光和,2024-01-29,6380
4956,光鋐,9,0,9,光和,2024-01-29,6380
6125,廣運,10,1,9,光和,2024-01-29,6380
8096,擎亞,24,15,9,光和,2024-01-29,6380
2492,華新科,8,0,8,光和,2024-01-29,6380
4528,江興鍛,8,0,8,光和,2024-01-29,6380
9105,泰金寶-DR,10,2,8,光和,2024-01-29,6380
5521,工信,7,0,7,光和,2024-01-29,6380
1515,力山,7,0,7,光和,2024-01-29,6380
3694,海華,9,3,6,光和,2024-01-29,6380
4113,聯上,10,4,6,光和,2024-01-29,6380
5211,蒙恬,6,0,6,光和,2024-01-29,6380
6167,久正,9,3,6,光和,2024-01-29,6380
6589,台康生技,22,16,6,光和,2024-01-29,6380
8011,台通,8,2,6,光和,2024-01-29,6380
8050,廣積,6,0,6,光和,2024-01-29,6380
2890,永豐金,5,0,5,光和,2024-01-29,6380
00933B,國泰10Y+金融債,5,0,5,光和,2024-01-29,6380
3481,群創,368,71,297,光和,2024-01-30,6380
00655L,國泰中國A50正2,500,250,250,光和,2024-01-30,6380
00937B,群益ESG投等債20,135,0,135,光和,2024-01-30,6380
00688L,國泰20年美債正2,100,0,100,光和,2024-01-30,6380
00687B,國泰20年美債,86,2,84,光和,2024-01-30,6380
2610,華航,77,0,77,光和,2024-01-30,6380
1457,宜進,50,0,50,光和,2024-01-30,6380
2369,菱生,70,23,47,光和,2024-01-30,6380
00933B,國泰10Y+金融債,36,0,36,光和,2024-01-30,6380
00712,復華富時不動產,30,3,27,光和,2024-01-30,6380
2344,華邦電,39,12,27,光和,2024-01-30,6380
5347,世界,25,0,25,光和,2024-01-30,6380
1101,台泥,24,0,24,光和,2024-01-30,6380
6116,彩晶,22,0,22,光和,2024-01-30,6380
00918,大華優利高填息30,20,0,20,光和,2024-01-30,6380
00680L,元大美債20正2,20,1,19,光和,2024-01-30,6380
4909,新復興,29,10,19,光和,2024-01-30,6380
6589,台康生技,20,2,18,光和,2024-01-30,6380
6531,愛普*,17,2,15,光和,2024-01-30,6380
2888,新光金,25,10,15,光和,2024-01-30,6380
4960,誠美材,20,5,15,光和,2024-01-30,6380
2337,旺宏,13,0,13,光和,2024-01-30,6380
5498,凱崴,22,9,13,光和,2024-01-30,6380
1513,中興電,12,0,12,光和,2024-01-30,6380
3715,定穎投控,18,6,12,光和,2024-01-30,6380
6462,神盾,23,12,11,光和,2024-01-30,6380
00637L,元大滬深300正2,11,0,11,光和,2024-01-30,6380
3483,力致,18,7,11,光和,2024-01-30,6380
8936,國統,22,11,11,光和,2024-01-30,6380
3230,錦明,11,0,11,光和,2024-01-30,6380
1215,卜蜂,10,0,10,光和,2024-01-30,6380
2023,燁輝,10,0,10,光和,2024-01-30,6380
2025,千興,10,0,10,光和,2024-01-30,6380
2314,台揚,10,0,10,光和,2024-01-30,6380
2359,所羅門,10,0,10,光和,2024-01-30,6380
2431,聯昌,10,0,10,光和,2024-01-30,6380
4154,樂威科-KY,10,0,10,光和,2024-01-30,6380
5364,力麗店,10,0,10,光和,2024-01-30,6380
6244,茂迪,10,0,10,光和,2024-01-30,6380
6278,台表科,10,0,10,光和,2024-01-30,6380
2368,金像電,13,4,9,光和,2024-01-30,6380
2892,第一金,8,0,8,光和,2024-01-30,6380
6239,力成,8,0,8,光和,2024-01-30,6380
5880,合庫金,7,0,7,光和,2024-01-30,6380
00900,富邦特選高股息30,7,0,7,光和,2024-01-30,6380
2356,英業達,46,39,7,光和,2024-01-30,6380
6202,盛群,7,0,7,光和,2024-01-30,6380
00679B,元大美債20年,6,0,6,光和,2024-01-30,6380
1722,台肥,12,6,6,光和,2024-01-30,6380
2388,威盛,11,5,6,光和,2024-01-30,6380
00919,群益台灣精選高息,305,10,295,光和,2024-01-31,6380
00680L,元大美債20正2,104,4,100,光和,2024-01-31,6380
2609,陽明,75,27,48,光和,2024-01-31,6380
2888,新光金,41,1,40,光和,2024-01-31,6380
2481,強茂,32,0,32,光和,2024-01-31,6380
3231,緯創,56,27,29,光和,2024-01-31,6380
00687B,國泰20年美債,41,12,29,光和,2024-01-31,6380
2356,英業達,33,8,25,光和,2024-01-31,6380
3041,揚智,34,10,24,光和,2024-01-31,6380
1301,台塑,21,0,21,光和,2024-01-31,6380
00878,國泰永續高股息,22,2,20,光和,2024-01-31,6380
4564,元翎,20,0,20,光和,2024-01-31,6380
8215,明基材,20,0,20,光和,2024-01-31,6380
00937B,群益ESG投等債20,21,2,19,光和,2024-01-31,6380
5452,佶優,20,1,19,光和,2024-01-31,6380
3360,尚立,35,17,18,光和,2024-01-31,6380
6462,神盾,32,15,17,光和,2024-01-31,6380
4960,誠美材,19,2,17,光和,2024-01-31,6380
8436,大江,17,0,17,光和,2024-01-31,6380
9919,康那香,23,6,17,光和,2024-01-31,6380
2382,廣達,17,2,15,光和,2024-01-31,6380
2303,聯電,16,1,15,光和,2024-01-31,6380
2468,華經,15,0,15,光和,2024-01-31,6380
6164,華興,15,0,15,光和,2024-01-31,6380
2330,台積電,15,1,14,光和,2024-01-31,6380
3710,連展投控,14,0,14,光和,2024-01-31,6380
3376,新日興,23,9,14,光和,2024-01-31,6380
00929,復華台灣科技優息,14,1,13,光和,2024-01-31,6380
0056,元大高股息,13,0,13,光和,2024-01-31,6380
1101,台泥,13,0,13,光和,2024-01-31,6380
00669R,國泰美國道瓊反1,13,0,13,光和,2024-01-31,6380
2344,華邦電,13,1,12,光和,2024-01-31,6380
2603,長榮,11,0,11,光和,2024-01-31,6380
3032,偉訓,13,2,11,光和,2024-01-31,6380
3597,映興,13,3,10,光和,2024-01-31,6380
5355,佳總,10,0,10,光和,2024-01-31,6380
8096,擎亞,13,3,10,光和,2024-01-31,6380
8111,立��,10,0,10,光和,2024-01-31,6380
8342,益張,10,0,10,光和,2024-01-31,6380
2883,凱基金,10,0,10,光和,2024-01-31,6380
1609,大亞,15,5,10,光和,2024-01-31,6380
00918,大華優利高填息30,9,0,9,光和,2024-01-31,6380
2034,允強,9,0,9,光和,2024-01-31,6380
2618,長榮航,9,0,9,光和,2024-01-31,6380
5487,通泰,9,0,9,光和,2024-01-31,6380
6153,嘉聯益,9,0,9,光和,2024-01-31,6380
3033,威健,8,0,8,光和,2024-01-31,6380
2812,台中銀,8,0,8,光和,2024-01-31,6380
2736,富野,8,0,8,光和,2024-01-31,6380
6589,台康生技,8,0,8,光和,2024-01-31,6380
2409,友達,66,1,65,光和,2024-02-01,6380
00712,復華富時不動產,61,2,59,光和,2024-02-01,6380
6695,芯鼎,55,11,44,光和,2024-02-01,6380
00687B,國泰20年美債,128,86,42,光和,2024-02-01,6380
1314,中石化,50,9,41,光和,2024-02-01,6380
00665L,富邦�琤肭磪囓�2,30,0,30,光和,2024-02-01,6380
2739,寒舍,23,0,23,光和,2024-02-01,6380
8104,錸寶,23,0,23,光和,2024-02-01,6380
6465,威潤,22,0,22,光和,2024-02-01,6380
3041,揚智,27,6,21,光和,2024-02-01,6380
8936,國統,89,68,21,光和,2024-02-01,6380
2356,英業達,22,5,17,光和,2024-02-01,6380
3059,華晶科,18,2,16,光和,2024-02-01,6380
4528,江興鍛,16,0,16,光和,2024-02-01,6380
2025,千興,15,0,15,光和,2024-02-01,6380
2303,聯電,16,1,15,光和,2024-02-01,6380
2353,宏��,17,2,15,光和,2024-02-01,6380
3712,永崴投控,15,0,15,光和,2024-02-01,6380
00937B,群益ESG投等債20,13,0,13,光和,2024-02-01,6380
2705,六福,12,0,12,光和,2024-02-01,6380
2885,元大金,12,0,12,光和,2024-02-01,6380
6116,彩晶,12,0,12,光和,2024-02-01,6380
6531,愛普*,21,9,12,光和,2024-02-01,6380
6770,力積電,13,1,12,光和,2024-02-01,6380
00929,復華台灣科技優息,12,0,12,光和,2024-02-01,6380
2404,漢唐,11,0,11,光和,2024-02-01,6380
00688L,國泰20年美債正2,10,0,10,光和,2024-02-01,6380
1809,中釉,10,0,10,光和,2024-02-01,6380
2359,所羅門,10,0,10,光和,2024-02-01,6380
2731,雄獅,10,0,10,光和,2024-02-01,6380
2748,雲品,10,0,10,光和,2024-02-01,6380
2836,高雄銀,10,0,10,光和,2024-02-01,6380
3306,鼎天,10,0,10,光和,2024-02-01,6380
3390,旭軟,10,0,10,光和,2024-02-01,6380
3437,榮創,10,0,10,光和,2024-02-01,6380
4116,明基醫,10,0,10,光和,2024-02-01,6380
5355,佳總,10,0,10,光和,2024-02-01,6380
5364,力麗店,10,0,10,光和,2024-02-01,6380
6456,GIS-KY,10,0,10,光和,2024-02-01,6380
8222,寶一,10,0,10,光和,2024-02-01,6380
6265,方土昶,32,22,10,光和,2024-02-01,6380
3535,晶彩科,9,0,9,光和,2024-02-01,6380
5251,天鉞電,9,0,9,光和,2024-02-01,6380
2367,燿華,10,2,8,光和,2024-02-01,6380
3060,銘異,8,0,8,光和,2024-02-01,6380
3207,耀勝,8,0,8,光和,2024-02-01,6380
3434,哲固,8,0,8,光和,2024-02-01,6380
5381,合正,8,0,8,光和,2024-02-01,6380
6164,華興,8,0,8,光和,2024-02-01,6380
6233,旺玖,8,0,8,光和,2024-02-01,6380
00632R,元大台灣50反1,61,0,61,光和,2024-02-02,6380
00688L,國泰20年美債正2,61,0,61,光和,2024-02-02,6380
00687B,國泰20年美債,92,34,58,光和,2024-02-02,6380
3481,群創,51,8,43,光和,2024-02-02,6380
00712,復華富時不動產,36,0,36,光和,2024-02-02,6380
2353,宏��,41,7,34,光和,2024-02-02,6380
2329,華泰,49,19,30,光和,2024-02-02,6380
4303,信立,33,3,30,光和,2024-02-02,6380
2603,長榮,28,3,25,光和,2024-02-02,6380
8111,立��,30,6,24,光和,2024-02-02,6380
3376,新日興,33,10,23,光和,2024-02-02,6380
5347,世界,23,1,22,光和,2024-02-02,6380
5487,通泰,22,0,22,光和,2024-02-02,6380
00936,台新永續高息中小,20,0,20,光和,2024-02-02,6380
1471,首利,20,0,20,光和,2024-02-02,6380
1536,和大,20,0,20,光和,2024-02-02,6380
8085,福華,20,0,20,光和,2024-02-02,6380
2609,陽明,19,0,19,光和,2024-02-02,6380
3059,華晶科,18,0,18,光和,2024-02-02,6380
4956,光鋐,18,0,18,光和,2024-02-02,6380
6770,力積電,17,1,16,光和,2024-02-02,6380
2457,飛宏,18,2,16,光和,2024-02-02,6380
3036,文曄,21,5,16,光和,2024-02-02,6380
3360,尚立,15,0,15,光和,2024-02-02,6380
3540,曜越,15,0,15,光和,2024-02-02,6380
00929,復華台灣科技優息,14,0,14,光和,2024-02-02,6380
3306,鼎天,15,1,14,光和,2024-02-02,6380
5210,寶碩,14,0,14,光和,2024-02-02,6380
3268,海德威,16,3,13,光和,2024-02-02,6380
2636,台驊控股,12,0,12,光和,2024-02-02,6380
3711,日月光投控,12,0,12,光和,2024-02-02,6380
6443,元晶,12,0,12,光和,2024-02-02,6380
2408,南亞科,16,5,11,光和,2024-02-02,6380
00933B,國泰10Y+金融債,11,0,11,光和,2024-02-02,6380
2615,萬海,11,0,11,光和,2024-02-02,6380
3313,斐成,11,0,11,光和,2024-02-02,6380
4529,淳紳,11,0,11,光和,2024-02-02,6380
6233,旺玖,17,6,11,光和,2024-02-02,6380
2359,所羅門,10,0,10,光和,2024-02-02,6380
2888,新光金,10,0,10,光和,2024-02-02,6380
3615,安可,12,2,10,光和,2024-02-02,6380
3703,欣陸,10,0,10,光和,2024-02-02,6380
3712,永崴投控,30,20,10,光和,2024-02-02,6380
4528,江興鍛,10,0,10,光和,2024-02-02,6380
6167,久正,10,0,10,光和,2024-02-02,6380
6916,華凌,10,0,10,光和,2024-02-02,6380
1319,東陽,9,0,9,光和,2024-02-02,6380
1514,亞力,11,2,9,光和,2024-02-02,6380
1605,華新,11,2,9,光和,2024-02-02,6380
1714,和桐,9,0,9,光和,2024-02-02,6380
00688L,國泰20年美債正2,260,0,260,光和,2024-02-05,6380
2329,華泰,189,20,169,光和,2024-02-05,6380
00706L,期元大S＆P日圓正2,121,0,121,光和,2024-02-05,6380
00937B,群益ESG投等債20,100,0,100,光和,2024-02-05,6380
00877,復華中國5G,100,0,100,光和,2024-02-05,6380
00712,復華富時不動產,97,7,90,光和,2024-02-05,6380
2439,美律,64,0,64,光和,2024-02-05,6380
00897,富邦基因免疫生技,50,0,50,光和,2024-02-05,6380
00929,復華台灣科技優息,48,2,46,光和,2024-02-05,6380
1528,恩德,48,10,38,光和,2024-02-05,6380
00679B,元大美債20年,38,0,38,光和,2024-02-05,6380
2303,聯電,46,9,37,光和,2024-02-05,6380
5426,振發,35,2,33,光和,2024-02-05,6380
1560,中砂,31,0,31,光和,2024-02-05,6380
1337,再生-KY,30,0,30,光和,2024-02-05,6380
1449,佳和,30,0,30,光和,2024-02-05,6380
6462,神盾,29,0,29,光和,2024-02-05,6380
4564,元翎,24,0,24,光和,2024-02-05,6380
00878,國泰永續高股息,23,0,23,光和,2024-02-05,6380
00918,大華優利高填息30,21,0,21,光和,2024-02-05,6380
2356,英業達,44,23,21,光和,2024-02-05,6380
3481,群創,26,5,21,光和,2024-02-05,6380
6695,芯鼎,30,9,21,光和,2024-02-05,6380
8936,國統,32,11,21,光和,2024-02-05,6380
2104,國際中橡,20,0,20,光和,2024-02-05,6380
2884,玉山金,19,0,19,光和,2024-02-05,6380
8111,立��,17,0,17,光和,2024-02-05,6380
00720B,元大投資級公司債,16,0,16,光和,2024-02-05,6380
2812,台中銀,16,0,16,光和,2024-02-05,6380
6698,旭暉應材,22,8,14,光和,2024-02-05,6380
2369,菱生,37,25,12,光和,2024-02-05,6380
2601,益航,12,0,12,光和,2024-02-05,6380
00715L,期街口布蘭特正2,11,0,11,光和,2024-02-05,6380
2885,元大金,11,0,11,光和,2024-02-05,6380
3530,晶相光,12,1,11,光和,2024-02-05,6380
00772B,中信高評級公司債,10,0,10,光和,2024-02-05,6380
1533,車王電,10,0,10,光和,2024-02-05,6380
2359,所羅門,10,0,10,光和,2024-02-05,6380
5381,合正,10,0,10,光和,2024-02-05,6380
5531,鄉林,10,0,10,光和,2024-02-05,6380
9907,統一實,10,0,10,光和,2024-02-05,6380
2405,輔信,9,0,9,光和,2024-02-05,6380
1514,亞力,10,2,8,光和,2024-02-05,6380
2305,全友,8,0,8,光和,2024-02-05,6380
2388,威盛,9,1,8,光和,2024-02-05,6380
3540,曜越,8,0,8,光和,2024-02-05,6380
8064,東捷,8,0,8,光和,2024-02-05,6380
2208,台船,7,0,7,光和,2024-02-05,6380
2617,台航,7,0,7,光和,2024-02-05,6380
6486,互動,7,0,7,光和,2024-02-05,6380
00687B,國泰20年美債,157,0,157,光和,2024-02-15,6380
2408,南亞科,133,1,132,光和,2024-02-15,6380
00937B,群益ESG投等債20,110,11,99,光和,2024-02-15,6380
00919,群益台灣精選高息,98,0,98,光和,2024-02-15,6380
00712,復華富時不動產,79,0,79,光和,2024-02-15,6380
2888,新光金,96,25,71,光和,2024-02-15,6380
3481,群創,86,20,66,光和,2024-02-15,6380
2344,華邦電,66,2,64,光和,2024-02-15,6380
2610,華航,114,52,62,光和,2024-02-15,6380
6125,廣運,66,12,54,光和,2024-02-15,6380
2356,英業達,134,82,52,光和,2024-02-15,6380
2317,鴻海,52,1,51,光和,2024-02-15,6380
00931B,統一美債20年,49,0,49,光和,2024-02-15,6380
00679B,元大美債20年,47,0,47,光和,2024-02-15,6380
00680L,元大美債20正2,45,0,45,光和,2024-02-15,6380
2439,美律,43,0,43,光和,2024-02-15,6380
6120,達運,42,1,41,光和,2024-02-15,6380
00933B,國泰10Y+金融債,36,0,36,光和,2024-02-15,6380
00673R,期元大S＆P原油反1,36,0,36,光和,2024-02-15,6380
00632R,元大台灣50反1,34,0,34,光和,2024-02-15,6380
4714,永捷,68,35,33,光和,2024-02-15,6380
2618,長榮航,33,0,33,光和,2024-02-15,6380
00706L,期元大S＆P日圓正2,25,1,24,光和,2024-02-15,6380
3059,華晶科,22,0,22,光和,2024-02-15,6380
00929,復華台灣科技優息,41,20,21,光和,2024-02-15,6380
2421,建準,23,3,20,光和,2024-02-15,6380
1513,中興電,22,2,20,光和,2024-02-15,6380
2891,中信金,22,4,18,光和,2024-02-15,6380
8936,國統,31,13,18,光和,2024-02-15,6380
2303,聯電,25,7,18,光和,2024-02-15,6380
3217,優群,21,4,17,光和,2024-02-15,6380
3706,神達,17,0,17,光和,2024-02-15,6380
3583,辛耘,20,5,15,光和,2024-02-15,6380
4716,大立,15,0,15,光和,2024-02-15,6380
5521,工信,20,5,15,光和,2024-02-15,6380
8436,大江,15,0,15,光和,2024-02-15,6380
1714,和桐,14,0,14,光和,2024-02-15,6380
2633,台灣高鐵,13,0,13,光和,2024-02-15,6380
3306,鼎天,13,0,13,光和,2024-02-15,6380
00738U,期元大道瓊白銀,12,0,12,光和,2024-02-15,6380
2359,所羅門,12,0,12,光和,2024-02-15,6380
4503,金雨,14,2,12,光和,2024-02-15,6380
00918,大華優利高填息30,11,0,11,光和,2024-02-15,6380
2736,富野,11,0,11,光和,2024-02-15,6380
00915,凱基優選高股息30,10,0,10,光和,2024-02-15,6380
6669,緯穎,10,0,10,光和,2024-02-15,6380
1536,和大,10,0,10,光和,2024-02-15,6380
2301,光寶科,12,2,10,光和,2024-02-15,6380
2374,佳能,10,0,10,光和,2024-02-15,6380
2892,第一金,10,0,10,光和,2024-02-15,6380
00937B,群益ESG投等債20,111,8,103,光和,2024-02-16,6380
00687B,國泰20年美債,103,2,101,光和,2024-02-16,6380
00633L,富邦上証正2,101,1,100,光和,2024-02-16,6380
8936,國統,123,33,90,光和,2024-02-16,6380
00929,復華台灣科技優息,71,19,52,光和,2024-02-16,6380
00680L,元大美債20正2,51,0,51,光和,2024-02-16,6380
2303,聯電,45,1,44,光和,2024-02-16,6380
4716,大立,40,0,40,光和,2024-02-16,6380
00740B,富邦全球投等債,35,0,35,光和,2024-02-16,6380
00673R,期元大S＆P原油反1,32,0,32,光和,2024-02-16,6380
6125,廣運,50,19,31,光和,2024-02-16,6380
00933B,國泰10Y+金融債,30,0,30,光和,2024-02-16,6380
2408,南亞科,30,1,29,光和,2024-02-16,6380
00931B,統一美債20年,28,0,28,光和,2024-02-16,6380
910861,神州-DR,28,0,28,光和,2024-02-16,6380
3002,歐格,32,5,27,光和,2024-02-16,6380
3372,典範,26,0,26,光和,2024-02-16,6380
00632R,元大台灣50反1,22,0,22,光和,2024-02-16,6380
2884,玉山金,40,19,21,光和,2024-02-16,6380
3032,偉訓,22,1,21,光和,2024-02-16,6380
00706L,期元大S＆P日圓正2,20,0,20,光和,2024-02-16,6380
2886,兆豐金,20,0,20,光和,2024-02-16,6380
4167,松瑞藥,20,0,20,光和,2024-02-16,6380
1218,泰山,20,1,19,光和,2024-02-16,6380
1314,中石化,21,2,19,光和,2024-02-16,6380
00679B,元大美債20年,19,0,19,光和,2024-02-16,6380
3231,緯創,37,19,18,光和,2024-02-16,6380
3036,文曄,22,3,19,光和,2024-02-16,6380
1514,亞力,19,3,16,光和,2024-02-16,6380
2748,雲品,16,0,16,光和,2024-02-16,6380
8401,白紗科,15,0,15,光和,2024-02-16,6380
2323,中環,15,0,15,光和,2024-02-16,6380
2324,仁寶,26,11,15,光和,2024-02-16,6380
2515,中工,17,2,15,光和,2024-02-16,6380
3704,合勤控,17,2,15,光和,2024-02-16,6380
3047,訊舟,16,2,14,光和,2024-02-16,6380
2382,廣達,33,21,12,光和,2024-02-16,6380
6531,愛普*,17,5,12,光和,2024-02-16,6380
2404,漢唐,11,0,11,光和,2024-02-16,6380
00696B,富邦美債20年,11,0,11,光和,2024-02-16,6380
3081,聯亞,11,0,11,光和,2024-02-16,6380
5521,工信,26,15,11,光和,2024-02-16,6380
2882,國泰金,10,0,10,光和,2024-02-16,6380
00664R,國泰臺灣加權反1,10,0,10,光和,2024-02-16,6380
3390,旭軟,15,5,10,光和,2024-02-16,6380
4552,力達-KY,10,0,10,光和,2024-02-16,6380
6668,中揚光,12,2,10,光和,2024-02-16,6380
6788,華景電,10,0,10,光和,2024-02-16,6380
1809,中釉,13,4,9,光和,2024-02-16,6380
2439,美律,9,0,9,光和,2024-02-16,6380
00655L,國泰中國A50正2,250,0,250,光和,2024-02-19,6380
2409,友達,200,2,198,光和,2024-02-19,6380
00919,群益台灣精選高息,134,9,125,光和,2024-02-19,6380
00687B,國泰20年美債,55,0,55,光和,2024-02-19,6380
00937B,群益ESG投等債20,55,0,55,光和,2024-02-19,6380
00878,國泰永續高股息,47,2,45,光和,2024-02-19,6380
00933B,國泰10Y+金融債,41,0,41,光和,2024-02-19,6380
00679B,元大美債20年,41,0,41,光和,2024-02-19,6380
2208,台船,35,0,35,光和,2024-02-19,6380
2365,昆盈,87,52,35,光和,2024-02-19,6380
4960,誠美材,106,72,34,光和,2024-02-19,6380
2801,彰銀,34,2,32,光和,2024-02-19,6380
6125,廣運,55,23,32,光和,2024-02-19,6380
6120,達運,30,0,30,光和,2024-02-19,6380
3147,大綜,28,0,28,光和,2024-02-19,6380
2515,中工,31,5,26,光和,2024-02-19,6380
8299,群聯,26,0,26,光和,2024-02-19,6380
2367,燿華,25,1,24,光和,2024-02-19,6380
3380,明泰,23,0,23,光和,2024-02-19,6380
4532,瑞智,22,0,22,光和,2024-02-19,6380
00712,復華富時不動產,20,0,20,光和,2024-02-19,6380
00753L,中信中國50正2,20,0,20,光和,2024-02-19,6380
3234,光環,21,1,20,光和,2024-02-19,6380
9911,櫻花,20,0,20,光和,2024-02-19,6380
2382,廣達,21,3,18,光和,2024-02-19,6380
2884,玉山金,18,0,18,光和,2024-02-19,6380
2308,台達電,19,2,17,光和,2024-02-19,6380
3583,辛耘,26,10,16,光和,2024-02-19,6380
3231,緯創,39,23,16,光和,2024-02-19,6380
4711,永純,15,0,15,光和,2024-02-19,6380
3535,晶彩科,17,4,13,光和,2024-02-19,6380
6188,廣明,13,0,13,光和,2024-02-19,6380
1608,華榮,12,0,12,光和,2024-02-19,6380
2374,佳能,14,2,12,光和,2024-02-19,6380
3576,聯合再生,15,3,12,光和,2024-02-19,6380
1714,和桐,11,0,11,光和,2024-02-19,6380
2442,新美齊,12,1,11,光和,2024-02-19,6380
3504,揚明光,11,0,11,光和,2024-02-19,6380
4164,承業醫,11,0,11,光和,2024-02-19,6380
4167,松瑞藥,11,0,11,光和,2024-02-19,6380
4908,前鼎,12,1,11,光和,2024-02-19,6380
00918,大華優利高填息30,12,2,10,光和,2024-02-19,6380
00632R,元大台灣50反1,10,0,10,光和,2024-02-19,6380
1417,嘉裕,10,0,10,光和,2024-02-19,6380
4956,光鋐,11,1,10,光和,2024-02-19,6380
5309,系統電,10,0,10,光和,2024-02-19,6380
6153,嘉聯益,10,0,10,光和,2024-02-19,6380
6180,橘子,10,0,10,光和,2024-02-19,6380
6788,華景電,10,0,10,光和,2024-02-19,6380
2356,英業達,25,16,9,光和,2024-02-19,6380
3221,台嘉碩,86,1,85,光和,2024-02-20,6380
00933B,國泰10Y+金融債,106,30,76,光和,2024-02-20,6380
00929,復華台灣科技優息,79,9,70,光和,2024-02-20,6380
1314,中石化,54,0,54,光和,2024-02-20,6380
00680L,元大美債20正2,51,0,51,光和,2024-02-20,6380
00688L,國泰20年美債正2,50,0,50,光和,2024-02-20,6380
4960,誠美材,46,0,46,光和,2024-02-20,6380
2405,輔信,103,58,45,光和,2024-02-20,6380
8936,國統,132,87,45,光和,2024-02-20,6380
2329,華泰,60,22,38,光和,2024-02-20,6380
2317,鴻海,42,4,38,光和,2024-02-20,6380
2371,大同,40,7,33,光和,2024-02-20,6380
9938,百和,30,0,30,光和,2024-02-20,6380
8110,華東,43,14,29,光和,2024-02-20,6380
6188,廣明,31,3,28,光和,2024-02-20,6380
3312,弘憶股,33,7,26,光和,2024-02-20,6380
6257,矽格,26,0,26,光和,2024-02-20,6380
1316,上曜,30,5,25,光和,2024-02-20,6380
3231,緯創,31,7,24,光和,2024-02-20,6380
2367,燿華,38,14,24,光和,2024-02-20,6380
3041,揚智,87,63,24,光和,2024-02-20,6380
2034,允強,32,10,22,光和,2024-02-20,6380
00687B,國泰20年美債,22,1,21,光和,2024-02-20,6380
2399,映泰,20,0,20,光和,2024-02-20,6380
4956,光鋐,20,0,20,光和,2024-02-20,6380
00878,國泰永續高股息,29,9,20,光和,2024-02-20,6380
00712,復華富時不動產,17,0,17,光和,2024-02-20,6380
1708,東鹼,15,0,15,光和,2024-02-20,6380
6116,彩晶,25,10,15,光和,2024-02-20,6380
6770,力積電,15,0,15,光和,2024-02-20,6380
4714,永捷,32,18,14,光和,2024-02-20,6380
00937B,群益ESG投等債20,13,0,13,光和,2024-02-20,6380
2618,長榮航,15,2,13,光和,2024-02-20,6380
4979,華星光,21,8,13,光和,2024-02-20,6380
6244,茂迪,13,0,13,光和,2024-02-20,6380
00679B,元大美債20年,12,0,12,光和,2024-02-20,6380
1455,集盛,12,0,12,光和,2024-02-20,6380
1514,亞力,13,1,12,光和,2024-02-20,6380
2353,宏��,20,8,12,光和,2024-02-20,6380
6125,廣運,45,33,12,光和,2024-02-20,6380
3481,群創,22,11,11,光和,2024-02-20,6380
3287,廣寰科,11,0,11,光和,2024-02-20,6380
3450,聯鈞,17,6,11,光和,2024-02-20,6380
6443,元晶,11,0,11,光和,2024-02-20,6380
00632R,元大台灣50反1,10,0,10,光和,2024-02-20,6380
1304,台聚,10,0,10,光和,2024-02-20,6380
2374,佳能,10,0,10,光和,2024-02-20,6380
3230,錦明,10,0,10,光和,2024-02-20,6380
5202,力新,10,0,10,光和,2024-02-20,6380
6160,欣技,10,0,10,光和,2024-02-20,6380
00632R,元大台灣50反1,370,0,370,光和,2024-02-21,6380
6125,廣運,134,36,98,光和,2024-02-21,6380
00878,國泰永續高股息,82,4,78,光和,2024-02-21,6380
00929,復華台灣科技優息,59,5,54,光和,2024-02-21,6380
1316,上曜,70,18,52,光和,2024-02-21,6380
2031,新光鋼,50,0,50,光和,2024-02-21,6380
00933B,國泰10Y+金融債,45,0,45,光和,2024-02-21,6380
00937B,群益ESG投等債20,44,0,44,光和,2024-02-21,6380
6770,力積電,42,2,40,光和,2024-02-21,6380
2547,日勝生,36,0,36,光和,2024-02-21,6380
2025,千興,45,10,35,光和,2024-02-21,6380
3002,歐格,32,0,32,光和,2024-02-21,6380
00650L,復華香港正2,35,4,31,光和,2024-02-21,6380
00752,中信中國50,30,0,30,光和,2024-02-21,6380
9938,百和,30,0,30,光和,2024-02-21,6380
6282,康舒,48,20,28,光和,2024-02-21,6380
2303,聯電,27,0,27,光和,2024-02-21,6380
3372,典範,34,7,27,光和,2024-02-21,6380
2323,中環,26,0,26,光和,2024-02-21,6380
00712,復華富時不動產,25,0,25,光和,2024-02-21,6380
1905,華紙,25,0,25,光和,2024-02-21,6380
6196,帆宣,22,0,22,光和,2024-02-21,6380
2880,華南金,22,1,21,光和,2024-02-21,6380
5347,世界,21,0,21,光和,2024-02-21,6380
2358,廷鑫,20,0,20,光和,2024-02-21,6380
9105,泰金寶-DR,31,12,19,光和,2024-02-21,6380
00687B,國泰20年美債,19,0,19,光和,2024-02-21,6380
2399,映泰,19,0,19,光和,2024-02-21,6380
2353,宏��,27,8,19,光和,2024-02-21,6380
00753L,中信中國50正2,20,2,18,光和,2024-02-21,6380
1718,中纖,20,3,17,光和,2024-02-21,6380
6116,彩晶,42,25,17,光和,2024-02-21,6380
6695,芯鼎,24,7,17,光和,2024-02-21,6380
910322,康師傅-DR,16,0,16,光和,2024-02-21,6380
3047,訊舟,23,8,15,光和,2024-02-21,6380
3321,同泰,15,0,15,光和,2024-02-21,6380
0056,元大高股息,13,0,13,光和,2024-02-21,6380
2388,威盛,15,2,13,光和,2024-02-21,6380
6588,東典光電,12,0,12,光和,2024-02-21,6380
8105,凌巨,12,0,12,光和,2024-02-21,6380
6257,矽格,12,0,12,光和,2024-02-21,6380
2884,玉山金,12,0,12,光和,2024-02-21,6380
2634,漢翔,11,0,11,光和,2024-02-21,6380
3062,建漢,11,0,11,光和,2024-02-21,6380
6916,華凌,11,0,11,光和,2024-02-21,6380
2382,廣達,17,7,10,光和,2024-02-21,6380
00928,中信上櫃ESG30,10,0,10,光和,2024-02-21,6380
2208,台船,10,0,10,光和,2024-02-21,6380
2477,美隆電,10,0,10,光和,2024-02-21,6380
2609,陽明,20,10,10,光和,2024-02-21,6380
00753L,中信中國50正2,665,44,621,光和,2024-02-22,6380
2547,日勝生,118,0,118,光和,2024-02-22,6380
6125,廣運,94,12,82,光和,2024-02-22,6380
00937B,群益ESG投等債20,60,0,60,光和,2024-02-22,6380
00933B,國泰10Y+金融債,48,0,48,光和,2024-02-22,6380
2618,長榮航,45,1,44,光和,2024-02-22,6380
1514,亞力,51,9,42,光和,2024-02-22,6380
910322,康師傅-DR,42,0,42,光和,2024-02-22,6380
1447,力鵬,40,2,38,光和,2024-02-22,6380
00679B,元大美債20年,37,0,37,光和,2024-02-22,6380
2356,英業達,53,16,37,光和,2024-02-22,6380
2303,聯電,37,1,36,光和,2024-02-22,6380
2353,宏��,58,26,32,光和,2024-02-22,6380
2208,台船,51,20,31,光和,2024-02-22,6380
3689,湧德,78,51,27,光和,2024-02-22,6380
2363,矽統,27,2,25,光和,2024-02-22,6380
4960,誠美材,24,0,24,光和,2024-02-22,6380
6789,采鈺,30,6,24,光和,2024-02-22,6380
9105,泰金寶-DR,36,13,23,光和,2024-02-22,6380
3231,緯創,49,26,23,光和,2024-02-22,6380
1785,光洋科,22,0,22,光和,2024-02-22,6380
5355,佳總,22,0,22,光和,2024-02-22,6380
00632R,元大台灣50反1,21,0,21,光和,2024-02-22,6380
3002,歐格,21,0,21,光和,2024-02-22,6380
3508,位速,20,0,20,光和,2024-02-22,6380
1314,中石化,19,1,18,光和,2024-02-22,6380
1609,大亞,26,9,17,光和,2024-02-22,6380
6547,高端疫苗,15,0,15,光和,2024-02-22,6380
2371,大同,37,22,15,光和,2024-02-22,6380
4540,全球傳動,15,0,15,光和,2024-02-22,6380
3481,群創,24,10,14,光和,2024-02-22,6380
6126,信音,16,2,14,光和,2024-02-22,6380
5488,松普,13,0,13,光和,2024-02-22,6380
00720B,元大投資級公司債,12,0,12,光和,2024-02-22,6380
00712,復華富時不動產,12,0,12,光和,2024-02-22,6380
2498,宏達電,12,0,12,光和,2024-02-22,6380
2610,華航,13,1,12,光和,2024-02-22,6380
3232,昱捷,19,7,12,光和,2024-02-22,6380
6116,彩晶,13,1,12,光和,2024-02-22,6380
6770,力積電,13,1,12,光和,2024-02-22,6380
911868,同方友友-DR,12,0,12,光和,2024-02-22,6380
5381,合正,20,9,11,光和,2024-02-22,6380
6136,富爾特,12,1,11,光和,2024-02-22,6380
3209,全科,10,0,10,光和,2024-02-22,6380
00934,中信成長高股息,10,0,10,光和,2024-02-22,6380
2867,三商壽,10,0,10,光和,2024-02-22,6380
3176,基亞,10,0,10,光和,2024-02-22,6380
3178,公準,10,0,10,光和,2024-02-22,6380
3444,利機,10,0,10,光和,2024-02-22,6380
4116,明基醫,10,0,10,光和,2024-02-22,6380
3078,僑威,207,9,198,光和,2024-02-23,6380
2363,矽統,203,34,169,光和,2024-02-23,6380
00929,復華台灣科技優息,199,46,153,光和,2024-02-23,6380
2883,凱基金,140,1,139,光和,2024-02-23,6380
00937B,群益ESG投等債20,138,6,132,光和,2024-02-23,6380
00933B,國泰10Y+金融債,110,0,110,光和,2024-02-23,6380
2489,瑞軒,119,21,98,光和,2024-02-23,6380
2888,新光金,85,1,84,光和,2024-02-23,6380
2014,中鴻,67,1,66,光和,2024-02-23,6380
00919,群益台灣精選高息,67,4,63,光和,2024-02-23,6380
1609,大亞,74,18,56,光和,2024-02-23,6380
00885,富邦越南,54,0,54,光和,2024-02-23,6380
6443,元晶,53,0,53,光和,2024-02-23,6380
00687B,國泰20年美債,50,0,50,光和,2024-02-23,6380
1316,上曜,71,21,50,光和,2024-02-23,6380
2706,第一店,50,0,50,光和,2024-02-23,6380
2353,宏��,92,44,48,光和,2024-02-23,6380
3580,友威科,47,1,46,光和,2024-02-23,6380
2618,長榮航,41,1,40,光和,2024-02-23,6380
3360,尚立,47,9,38,光和,2024-02-23,6380
3372,典範,45,8,37,光和,2024-02-23,6380
2439,美律,32,0,32,光和,2024-02-23,6380
2356,英業達,46,15,31,光和,2024-02-23,6380
2376,技嘉,41,10,31,光和,2024-02-23,6380
00712,復華富時不動產,29,0,29,光和,2024-02-23,6380
2303,聯電,34,5,29,光和,2024-02-23,6380
00632R,元大台灣50反1,23,0,23,光和,2024-02-23,6380
4906,正文,25,3,22,光和,2024-02-23,6380
8215,明基材,23,1,22,光和,2024-02-23,6380
00931B,統一美債20年,21,0,21,光和,2024-02-23,6380
3016,嘉晶,21,0,21,光和,2024-02-23,6380
2329,華泰,67,47,20,光和,2024-02-23,6380
00752,中信中國50,20,0,20,光和,2024-02-23,6380
00740B,富邦全球投等債,20,0,20,光和,2024-02-23,6380
1417,嘉裕,20,0,20,光和,2024-02-23,6380
2365,昆盈,21,2,19,光和,2024-02-23,6380
4716,大立,19,0,19,光和,2024-02-23,6380
6266,泰詠,20,1,19,光和,2024-02-23,6380
2317,鴻海,20,1,19,光和,2024-02-23,6380
2516,新建,20,2,18,光和,2024-02-23,6380
8096,擎亞,24,6,18,光和,2024-02-23,6380
2359,所羅門,15,0,15,光和,2024-02-23,6380
910322,康師傅-DR,15,0,15,光和,2024-02-23,6380
3306,鼎天,14,1,13,光和,2024-02-23,6380
6282,康舒,20,7,13,光和,2024-02-23,6380
2002,中鋼,13,0,13,光和,2024-02-23,6380
8936,國統,15,4,11,光和,2024-02-23,6380
1303,南亞,11,0,11,光和,2024-02-23,6380
2062,橋椿,13,2,11,光和,2024-02-23,6380
3049,精金,11,0,11,光和,2024-02-23,6380
00937B,群益ESG投等債20,357,0,357,光和,2024-02-26,6380
2618,長榮航,129,1,128,光和,2024-02-26,6380
2353,宏��,116,6,110,光和,2024-02-26,6380
00878,國泰永續高股息,93,7,86,光和,2024-02-26,6380
00885,富邦越南,57,0,57,光和,2024-02-26,6380
2371,大同,72,21,51,光和,2024-02-26,6380
1609,大亞,60,16,44,光和,2024-02-26,6380
4420,光明,35,0,35,光和,2024-02-26,6380
2882,國泰金,31,0,31,光和,2024-02-26,6380
1417,嘉裕,30,0,30,光和,2024-02-26,6380
6275,元山,30,0,30,光和,2024-02-26,6380
8085,福華,30,0,30,光和,2024-02-26,6380
3481,群創,38,12,26,光和,2024-02-26,6380
3071,協禧,25,0,25,光和,2024-02-26,6380
5347,世界,25,1,24,光和,2024-02-26,6380
5521,工信,26,3,23,光和,2024-02-26,6380
2344,華邦電,22,0,22,光和,2024-02-26,6380
3005,神基,23,1,22,光和,2024-02-26,6380
2834,臺企銀,21,0,21,光和,2024-02-26,6380
1447,力鵬,20,0,20,光和,2024-02-26,6380
00632R,元大台灣50反1,17,0,17,光和,2024-02-26,6380
5426,振發,19,2,17,光和,2024-02-26,6380
1529,樂事綠能,16,0,16,光和,2024-02-26,6380
2356,英業達,18,2,16,光和,2024-02-26,6380
1342,八貫,16,1,15,光和,2024-02-26,6380
3362,先進光,15,0,15,光和,2024-02-26,6380
3715,定穎投控,15,0,15,光和,2024-02-26,6380
00891,中信關鍵半導體,16,2,14,光和,2024-02-26,6380
3231,緯創,18,4,14,光和,2024-02-26,6380
00751B,元大AAA至A公司債,13,0,13,光和,2024-02-26,6380
1532,勤美,13,0,13,光和,2024-02-26,6380
2486,一詮,13,0,13,光和,2024-02-26,6380
4526,東台,13,0,13,光和,2024-02-26,6380
6170,統振,13,0,13,光和,2024-02-26,6380
2405,輔信,20,8,12,光和,2024-02-26,6380
3706,神達,15,3,12,光和,2024-02-26,6380
00637L,元大滬深300正2,11,0,11,光和,2024-02-26,6380
00712,復華富時不動產,12,1,11,光和,2024-02-26,6380
2023,燁輝,11,0,11,光和,2024-02-26,6380
00664R,國泰臺灣加權反1,10,0,10,光和,2024-02-26,6380
1312,國喬,10,0,10,光和,2024-02-26,6380
2382,廣達,20,10,10,光和,2024-02-26,6380
2460,建通,10,0,10,光和,2024-02-26,6380
2888,新光金,10,0,10,光和,2024-02-26,6380
3010,華立,10,0,10,光和,2024-02-26,6380
3264,欣銓,10,0,10,光和,2024-02-26,6380
3360,尚立,10,0,10,光和,2024-02-26,6380
8112,至上,10,0,10,光和,2024-02-26,6380
2392,正崴,9,0,9,光和,2024-02-26,6380
3703,欣陸,9,0,9,光和,2024-02-26,6380
00712,復華富時不動產,1501,0,1501,光和,2024-02-27,6380
00937B,群益ESG投等債20,1044,0,1044,光和,2024-02-27,6380
00632R,元大台灣50反1,220,0,220,光和,2024-02-27,6380
2438,翔耀,103,1,102,光和,2024-02-27,6380
00752,中信中國50,80,0,80,光和,2024-02-27,6380
6770,力積電,63,4,59,光和,2024-02-27,6380
8936,國統,63,8,55,光和,2024-02-27,6380
6443,元晶,45,0,45,光和,2024-02-27,6380
2904,匯僑,42,0,42,光和,2024-02-27,6380
2034,允強,43,2,41,光和,2024-02-27,6380
2888,新光金,51,10,41,光和,2024-02-27,6380
2834,臺企銀,50,10,40,光和,2024-02-27,6380
2515,中工,40,0,40,光和,2024-02-27,6380
1711,永光,50,16,34,光和,2024-02-27,6380
00918,大華優利高填息30,34,1,33,光和,2024-02-27,6380
2369,菱生,36,5,31,光和,2024-02-27,6380
1514,亞力,38,8,30,光和,2024-02-27,6380
2365,昆盈,32,2,30,光和,2024-02-27,6380
2887,台新金,31,3,28,光和,2024-02-27,6380
3583,辛耘,30,3,27,光和,2024-02-27,6380
2359,所羅門,32,5,27,光和,2024-02-27,6380
00878,國泰永續高股息,79,54,25,光和,2024-02-27,6380
2002,中鋼,25,0,25,光和,2024-02-27,6380
00753L,中信中國50正2,25,0,25,光和,2024-02-27,6380
3010,華立,25,0,25,光和,2024-02-27,6380
1815,富喬,28,4,24,光和,2024-02-27,6380
00933B,國泰10Y+金融債,23,0,23,光和,2024-02-27,6380
2547,日勝生,26,3,23,光和,2024-02-27,6380
2324,仁寶,39,17,22,光和,2024-02-27,6380
2353,宏��,43,23,20,光和,2024-02-27,6380
00680L,元大美債20正2,20,0,20,光和,2024-02-27,6380
3081,聯亞,33,13,20,光和,2024-02-27,6380
6695,芯鼎,26,6,20,光和,2024-02-27,6380
2363,矽統,233,214,19,光和,2024-02-27,6380
2467,志聖,20,1,19,光和,2024-02-27,6380
00687B,國泰20年美債,20,2,18,光和,2024-02-27,6380
4960,誠美材,20,2,18,光和,2024-02-27,6380
5425,台半,17,0,17,光和,2024-02-27,6380
2449,京元電子,19,2,17,光和,2024-02-27,6380
4967,十銓,18,1,17,光和,2024-02-27,6380
2301,光寶科,23,7,16,光和,2024-02-27,6380
2618,長榮航,18,2,16,光和,2024-02-27,6380
2883,凱基金,17,2,15,光和,2024-02-27,6380
1513,中興電,46,31,15,光和,2024-02-27,6380
4167,松瑞藥,15,0,15,光和,2024-02-27,6380
6116,彩晶,15,0,15,光和,2024-02-27,6380
1409,新纖,14,0,14,光和,2024-02-27,6380
2337,旺宏,14,0,14,光和,2024-02-27,6380
2425,承啟,14,0,14,光和,2024-02-27,6380
2344,華邦電,15,1,14,光和,2024-02-27,6380
00937B,群益ESG投等債20,516,1,515,光和,2024-02-29,6380
6125,廣運,193,23,170,光和,2024-02-29,6380
2353,宏��,107,2,105,光和,2024-02-29,6380
00919,群益台灣精選高息,98,2,96,光和,2024-02-29,6380
2329,華泰,80,12,68,光和,2024-02-29,6380
00712,復華富時不動產,67,0,67,光和,2024-02-29,6380
00929,復華台灣科技優息,89,37,52,光和,2024-02-29,6380
00878,國泰永續高股息,57,6,51,光和,2024-02-29,6380
6770,力積電,47,3,44,光和,2024-02-29,6380
3481,群創,48,8,40,光和,2024-02-29,6380
00933B,國泰10Y+金融債,36,0,36,光和,2024-02-29,6380
6288,聯嘉,50,16,34,光和,2024-02-29,6380
00680L,元大美債20正2,30,0,30,光和,2024-02-29,6380
2809,京城銀,30,0,30,光和,2024-02-29,6380
6443,元晶,29,0,29,光和,2024-02-29,6380
6116,彩晶,31,6,25,光和,2024-02-29,6380
00687B,國泰20年美債,24,0,24,光和,2024-02-29,6380
00752,中信中國50,20,0,20,光和,2024-02-29,6380
2104,國際中橡,20,0,20,光和,2024-02-29,6380
3624,光頡,20,0,20,光和,2024-02-29,6380
1710,東聯,21,1,20,光和,2024-02-29,6380
4147,中裕,19,1,18,光和,2024-02-29,6380
5487,通泰,18,0,18,光和,2024-02-29,6380
4543,萬在,23,5,18,光和,2024-02-29,6380
6163,華電網,20,3,17,光和,2024-02-29,6380
2317,鴻海,17,2,15,光和,2024-02-29,6380
1337,再生-KY,14,0,14,光和,2024-02-29,6380
2034,允強,17,3,14,光和,2024-02-29,6380
2405,輔信,14,0,14,光和,2024-02-29,6380
00679B,元大美債20年,13,0,13,光和,2024-02-29,6380
2324,仁寶,15,2,13,光和,2024-02-29,6380
2888,新光金,13,0,13,光和,2024-02-29,6380
5880,合庫金,13,0,13,光和,2024-02-29,6380
00881,國泰台灣5G+,12,0,12,光和,2024-02-29,6380
2409,友達,12,0,12,光和,2024-02-29,6380
3231,緯創,19,7,12,光和,2024-02-29,6380
00918,大華優利高填息30,11,0,11,光和,2024-02-29,6380
6120,達運,11,0,11,光和,2024-02-29,6380
00673R,期元大S＆P原油反1,10,0,10,光和,2024-02-29,6380
00930,永豐ESG低碳高息,10,0,10,光和,2024-02-29,6380
2413,環科,10,0,10,光和,2024-02-29,6380
2547,日勝生,10,0,10,光和,2024-02-29,6380
3081,聯亞,12,2,10,光和,2024-02-29,6380
4968,立積,10,0,10,光和,2024-02-29,6380
1301,台塑,9,0,9,光和,2024-02-29,6380
3010,華立,9,0,9,光和,2024-02-29,6380
4906,正文,11,2,9,光和,2024-02-29,6380
00885,富邦越南,8,0,8,光和,2024-02-29,6380
1732,毛寶,10,2,8,光和,2024-02-29,6380
2025,千興,12,4,8,光和,2024-02-29,6380
00919,群益台灣精選高息,302,57,245,光和,2024-03-01,6380
6005,群益證,239,0,239,光和,2024-03-01,6380
2371,大同,263,30,233,光和,2024-03-01,6380
1316,上曜,127,9,118,光和,2024-03-01,6380
2344,華邦電,100,3,97,光和,2024-03-01,6380
00918,大華優利高填息30,95,0,95,光和,2024-03-01,6380
00937B,群益ESG投等債20,95,0,95,光和,2024-03-01,6380
3689,湧德,129,49,80,光和,2024-03-01,6380
8936,國統,82,28,54,光和,2024-03-01,6380
00933B,國泰10Y+金融債,39,1,38,光和,2024-03-01,6380
2331,精英,36,0,36,光和,2024-03-01,6380
2408,南亞科,37,1,36,光和,2024-03-01,6380
4303,信立,41,5,36,光和,2024-03-01,6380
00679B,元大美債20年,36,3,33,光和,2024-03-01,6380
2399,映泰,32,1,31,光和,2024-03-01,6380
1216,統一,30,0,30,光和,2024-03-01,6380
6443,元晶,29,1,28,光和,2024-03-01,6380
4420,光明,25,0,25,光和,2024-03-01,6380
2104,國際中橡,23,0,23,光和,2024-03-01,6380
3360,尚立,49,26,23,光和,2024-03-01,6380
6282,康舒,32,9,23,光和,2024-03-01,6380
00878,國泰永續高股息,24,1,23,光和,2024-03-01,6380
4162,智擎,22,0,22,光和,2024-03-01,6380
5309,系統電,27,6,21,光和,2024-03-01,6380
00752,中信中國50,20,0,20,光和,2024-03-01,6380
2442,新美齊,20,0,20,光和,2024-03-01,6380
3308,聯德,20,0,20,光和,2024-03-01,6380
4716,大立,20,0,20,光和,2024-03-01,6380
6116,彩晶,20,0,20,光和,2024-03-01,6380
9105,泰金寶-DR,30,10,20,光和,2024-03-01,6380
3231,緯創,35,16,19,光和,2024-03-01,6380
2392,正崴,20,4,16,光和,2024-03-01,6380
1514,亞力,25,9,16,光和,2024-03-01,6380
1603,華電,15,0,15,光和,2024-03-01,6380
1714,和桐,15,0,15,光和,2024-03-01,6380
3712,永崴投控,16,1,15,光和,2024-03-01,6380
6770,力積電,18,3,15,光和,2024-03-01,6380
2317,鴻海,14,0,14,光和,2024-03-01,6380
2369,菱生,20,6,14,光和,2024-03-01,6380
00687B,國泰20年美債,13,0,13,光和,2024-03-01,6380
2355,敬鵬,13,0,13,光和,2024-03-01,6380
2313,華通,18,6,12,光和,2024-03-01,6380
2887,台新金,12,0,12,光和,2024-03-01,6380
3163,波若威,12,0,12,光和,2024-03-01,6380
4912,聯德控股-KY,12,0,12,光和,2024-03-01,6380
6603,富強鑫,12,0,12,光和,2024-03-01,6380
6505,台塑化,11,0,11,光和,2024-03-01,6380
3380,明泰,11,0,11,光和,2024-03-01,6380
6695,芯鼎,11,0,11,光和,2024-03-01,6380
00882,中信中國高股息,30,20,10,光和,2024-03-01,6380
00937B,群益ESG投等債20,216,0,216,光和,2024-03-04,6380
2329,華泰,163,17,146,光和,2024-03-04,6380
8926,台汽電,131,2,129,光和,2024-03-04,6380
00712,復華富時不動產,117,0,117,光和,2024-03-04,6380
00632R,元大台灣50反1,91,0,91,光和,2024-03-04,6380
2888,新光金,77,0,77,光和,2024-03-04,6380
2014,中鴻,68,0,68,光和,2024-03-04,6380
00897,富邦基因免疫生技,55,0,55,光和,2024-03-04,6380
00919,群益台灣精選高息,57,13,44,光和,2024-03-04,6380
1815,富喬,50,6,44,光和,2024-03-04,6380
00933B,國泰10Y+金融債,35,0,35,光和,2024-03-04,6380
2034,允強,34,0,34,光和,2024-03-04,6380
2356,英業達,64,32,32,光和,2024-03-04,6380
3013,晟銘電,46,15,31,光和,2024-03-04,6380
3041,揚智,30,0,30,光和,2024-03-04,6380
2399,映泰,29,1,28,光和,2024-03-04,6380
5452,佶優,26,0,26,光和,2024-03-04,6380
00918,大華優利高填息30,52,27,25,光和,2024-03-04,6380
2066,世德,28,4,24,光和,2024-03-04,6380
2344,華邦電,28,4,24,光和,2024-03-04,6380
00751B,元大AAA至A公司債,23,0,23,光和,2024-03-04,6380
2367,燿華,92,70,22,光和,2024-03-04,6380
2353,宏��,41,20,21,光和,2024-03-04,6380
3308,聯德,23,2,21,光和,2024-03-04,6380
4529,淳紳,22,1,21,光和,2024-03-04,6380
2002,中鋼,23,3,20,光和,2024-03-04,6380
2801,彰銀,20,0,20,光和,2024-03-04,6380
2104,國際中橡,22,2,20,光和,2024-03-04,6380
3430,奇鈦科,20,0,20,光和,2024-03-04,6380
00753L,中信中國50正2,19,0,19,光和,2024-03-04,6380
00673R,期元大S＆P原油反1,30,11,19,光和,2024-03-04,6380
3006,晶豪科,32,14,18,光和,2024-03-04,6380
2460,建通,17,0,17,光和,2024-03-04,6380
6218,豪勉,21,4,17,光和,2024-03-04,6380
3564,其陽,21,5,16,光和,2024-03-04,6380
2618,長榮航,17,3,14,光和,2024-03-04,6380
00922,國泰台灣領袖50,13,0,13,光和,2024-03-04,6380
00687B,國泰20年美債,43,30,13,光和,2024-03-04,6380
2834,臺企銀,13,0,13,光和,2024-03-04,6380
3005,神基,28,15,13,光和,2024-03-04,6380
00637L,元大滬深300正2,12,0,12,光和,2024-03-04,6380
2464,盟立,15,3,12,光和,2024-03-04,6380
6152,百一,12,0,12,光和,2024-03-04,6380
6789,采鈺,19,7,12,光和,2024-03-04,6380
2025,千興,11,0,11,光和,2024-03-04,6380
2365,昆盈,12,1,11,光和,2024-03-04,6380
2485,兆赫,14,3,11,光和,2024-03-04,6380
5258,虹堡,12,1,11,光和,2024-03-04,6380
5521,工信,11,0,11,光和,2024-03-04,6380
6770,力積電,13,2,11,光和,2024-03-04,6380
00632R,元大台灣50反1,216,0,216,光和,2024-03-05,6380
00937B,群益ESG投等債20,125,3,122,光和,2024-03-05,6380
2888,新光金,113,10,103,光和,2024-03-05,6380
00918,大華優利高填息30,103,0,103,光和,2024-03-05,6380
2331,精英,100,5,95,光和,2024-03-05,6380
00752,中信中國50,71,0,71,光和,2024-03-05,6380
3689,湧德,137,66,71,光和,2024-03-05,6380
00919,群益台灣精選高息,78,10,68,光和,2024-03-05,6380
4906,正文,74,16,58,光和,2024-03-05,6380
2316,楠梓電,43,4,39,光和,2024-03-05,6380
6026,福邦證,31,0,31,光和,2024-03-05,6380
6462,神盾,31,1,30,光和,2024-03-05,6380
00712,復華富時不動產,30,0,30,光和,2024-03-05,6380
1710,東聯,25,0,25,光和,2024-03-05,6380
5498,凱崴,58,33,25,光和,2024-03-05,6380
3041,揚智,24,0,24,光和,2024-03-05,6380
2439,美律,23,0,23,光和,2024-03-05,6380
6257,矽格,21,0,21,光和,2024-03-05,6380
6668,中揚光,22,1,21,光和,2024-03-05,6380
00882,中信中國高股息,20,0,20,光和,2024-03-05,6380
00679B,元大美債20年,20,0,20,光和,2024-03-05,6380
2405,輔信,20,0,20,光和,2024-03-05,6380
8085,福華,20,0,20,光和,2024-03-05,6380
6806,森崴能源,21,1,20,光和,2024-03-05,6380
2002,中鋼,21,1,20,光和,2024-03-05,6380
00662,富邦NASDAQ,20,0,20,光和,2024-03-05,6380
6116,彩晶,20,1,19,光和,2024-03-05,6380
6477,安集,19,0,19,光和,2024-03-05,6380
1609,大亞,22,6,16,光和,2024-03-05,6380
8150,南茂,19,3,16,光和,2024-03-05,6380
2344,華邦電,16,1,15,光和,2024-03-05,6380
4915,致伸,18,3,15,光和,2024-03-05,6380
2324,仁寶,15,1,14,光和,2024-03-05,6380
2881,富邦金,14,0,14,光和,2024-03-05,6380
3078,僑威,16,2,14,光和,2024-03-05,6380
6191,精成科,14,0,14,光和,2024-03-05,6380
6244,茂迪,15,1,14,光和,2024-03-05,6380
2408,南亞科,15,1,14,光和,2024-03-05,6380
1409,新纖,26,13,13,光和,2024-03-05,6380
1905,華紙,13,0,13,光和,2024-03-05,6380
2356,英業達,41,28,13,光和,2024-03-05,6380
00929,復華台灣科技優息,31,19,12,光和,2024-03-05,6380
2371,大同,17,5,12,光和,2024-03-05,6380
1301,台塑,11,0,11,光和,2024-03-05,6380
3707,漢磊,11,0,11,光和,2024-03-05,6380
1515,力山,11,0,11,光和,2024-03-05,6380
2365,昆盈,12,1,11,光和,2024-03-05,6380
2353,宏��,12,2,10,光和,2024-03-05,6380
00648R,元大S＆P500反1,10,0,10,光和,2024-03-05,6380
1785,光洋科,10,0,10,光和,2024-03-05,6380
00637L,元大滬深300正2,400,6,394,光和,2024-03-06,6380
2408,南亞科,118,0,118,光和,2024-03-06,6380
8163,達方,103,0,103,光和,2024-03-06,6380
00919,群益台灣精選高息,114,25,89,光和,2024-03-06,6380
00891,中信關鍵半導體,63,0,63,光和,2024-03-06,6380
00902,中信電池及儲能,60,0,60,光和,2024-03-06,6380
2605,新興,58,0,58,光和,2024-03-06,6380
00897,富邦基因免疫生技,53,0,53,光和,2024-03-06,6380
2881,富邦金,53,0,53,光和,2024-03-06,6380
00706L,期元大S＆P日圓正2,50,0,50,光和,2024-03-06,6380
00937B,群益ESG投等債20,48,8,40,光和,2024-03-06,6380
00665L,富邦�琤肭磪囓�2,40,0,40,光和,2024-03-06,6380
00752,中信中國50,50,10,40,光和,2024-03-06,6380
4716,大立,40,0,40,光和,2024-03-06,6380
00900,富邦特選高股息30,41,2,39,光和,2024-03-06,6380
3308,聯德,38,0,38,光和,2024-03-06,6380
3325,旭品,54,18,36,光和,2024-03-06,6380
2104,國際中橡,30,0,30,光和,2024-03-06,6380
3689,湧德,104,76,28,光和,2024-03-06,6380
2845,遠東銀,25,0,25,光和,2024-03-06,6380
6770,力積電,26,2,24,光和,2024-03-06,6380
5498,凱崴,29,6,23,光和,2024-03-06,6380
8936,國統,39,18,21,光和,2024-03-06,6380
6443,元晶,29,9,20,光和,2024-03-06,6380
6239,力成,30,10,20,光和,2024-03-06,6380
2034,允強,20,2,18,光和,2024-03-06,6380
2609,陽明,20,2,18,光和,2024-03-06,6380
6026,福邦證,18,0,18,光和,2024-03-06,6380
3481,群創,51,33,18,光和,2024-03-06,6380
3231,緯創,30,13,17,光和,2024-03-06,6380
3078,僑威,34,18,16,光和,2024-03-06,6380
9933,中鼎,59,44,15,光和,2024-03-06,6380
00632R,元大台灣50反1,25,10,15,光和,2024-03-06,6380
2520,冠德,15,0,15,光和,2024-03-06,6380
2618,長榮航,20,5,15,光和,2024-03-06,6380
2883,凱基金,19,4,15,光和,2024-03-06,6380
5515,建國,15,0,15,光和,2024-03-06,6380
2363,矽統,14,0,14,光和,2024-03-06,6380
4306,炎洲,34,20,14,光和,2024-03-06,6380
1303,南亞,14,1,13,光和,2024-03-06,6380
2464,盟立,15,2,13,光和,2024-03-06,6380
6016,康和證,16,3,13,光和,2024-03-06,6380
6799,來頡,13,0,13,光和,2024-03-06,6380
2615,萬海,12,0,12,光和,2024-03-06,6380
2014,中鴻,12,0,12,光和,2024-03-06,6380
2356,英業達,35,23,12,光和,2024-03-06,6380
6589,台康生技,12,0,12,光和,2024-03-06,6380
1609,大亞,89,77,12,光和,2024-03-06,6380
00679B,元大美債20年,11,0,11,光和,2024-03-06,6380
1905,華紙,11,0,11,光和,2024-03-06,6380
1815,富喬,285,51,234,光和,2024-03-07,6380
5521,工信,116,2,114,光和,2024-03-07,6380
8163,達方,100,0,100,光和,2024-03-07,6380
8034,榮群,78,2,76,光和,2024-03-07,6380
3481,群創,83,27,56,光和,2024-03-07,6380
00937B,群益ESG投等債20,101,50,51,光和,2024-03-07,6380
6418,詠昇,50,0,50,光和,2024-03-07,6380
4906,正文,51,2,49,光和,2024-03-07,6380
2367,燿華,67,19,48,光和,2024-03-07,6380
2331,精英,50,5,45,光和,2024-03-07,6380
2464,盟立,43,0,43,光和,2024-03-07,6380
2609,陽明,44,1,43,光和,2024-03-07,6380
1609,大亞,48,7,41,光和,2024-03-07,6380
2365,昆盈,46,5,41,光和,2024-03-07,6380
5452,佶優,41,0,41,光和,2024-03-07,6380
8936,國統,44,10,34,光和,2024-03-07,6380
3689,湧德,101,70,31,光和,2024-03-07,6380
6005,群益證,30,0,30,光和,2024-03-07,6380
2002,中鋼,29,1,28,光和,2024-03-07,6380
00687B,國泰20年美債,33,6,27,光和,2024-03-07,6380
1718,中纖,26,0,26,光和,2024-03-07,6380
00712,復華富時不動產,25,0,25,光和,2024-03-07,6380
1710,東聯,25,0,25,光和,2024-03-07,6380
2329,華泰,44,19,25,光和,2024-03-07,6380
2547,日勝生,25,1,24,光和,2024-03-07,6380
3081,聯亞,22,1,21,光和,2024-03-07,6380
2362,藍天,21,0,21,光和,2024-03-07,6380
2888,新光金,21,0,21,光和,2024-03-07,6380
2388,威盛,36,16,20,光和,2024-03-07,6380
1416,廣豐,24,5,19,光和,2024-03-07,6380
9907,統一實,19,0,19,光和,2024-03-07,6380
6271,同欣電,31,13,18,光和,2024-03-07,6380
3211,順達,18,1,17,光和,2024-03-07,6380
2845,遠東銀,17,1,16,光和,2024-03-07,6380
3049,精金,16,0,16,光和,2024-03-07,6380
6026,福邦證,14,0,14,光和,2024-03-07,6380
8940,新天地,15,1,14,光和,2024-03-07,6380
2481,強茂,14,1,13,光和,2024-03-07,6380
3059,華晶科,13,0,13,光和,2024-03-07,6380
6509,聚和,13,0,13,光和,2024-03-07,6380
1316,上曜,17,5,12,光和,2024-03-07,6380
6531,愛普*,20,9,11,光和,2024-03-07,6380
1409,新纖,13,2,11,光和,2024-03-07,6380
2892,第一金,11,0,11,光和,2024-03-07,6380
3444,利機,11,0,11,光和,2024-03-07,6380
6109,亞元,12,1,11,光和,2024-03-07,6380
6207,雷科,13,2,11,光和,2024-03-07,6380
00891,中信關鍵半導體,11,1,10,光和,2024-03-07,6380
00893,國泰智能電動車,10,0,10,光和,2024-03-07,6380
2109,華豐,10,0,10,光和,2024-03-07,6380
6005,群益證,299,2,297,光和,2024-03-08,6380
2109,華豐,91,0,91,光和,2024-03-08,6380
2329,華泰,87,25,62,光和,2024-03-08,6380
00937B,群益ESG投等債20,62,5,57,光和,2024-03-08,6380
2897,王道銀行,52,0,52,光和,2024-03-08,6380
3050,鈺德,50,0,50,光和,2024-03-08,6380
2408,南亞科,44,2,42,光和,2024-03-08,6380
2883,凱基金,52,11,41,光和,2024-03-08,6380
3481,群創,41,0,41,光和,2024-03-08,6380
2002,中鋼,43,3,40,光和,2024-03-08,6380
1815,富喬,52,13,39,光和,2024-03-08,6380
2317,鴻海,59,24,35,光和,2024-03-08,6380
00900,富邦特選高股息30,48,14,34,光和,2024-03-08,6380
1618,合機,33,0,33,光和,2024-03-08,6380
2609,陽明,47,15,32,光和,2024-03-08,6380
00918,大華優利高填息30,50,23,27,光和,2024-03-08,6380
8027,鈦昇,32,5,27,光和,2024-03-08,6380
5309,系統電,23,0,23,光和,2024-03-08,6380
3171,炎洲流通,21,0,21,光和,2024-03-08,6380
1304,台聚,20,0,20,光和,2024-03-08,6380
1312,國喬,20,0,20,光和,2024-03-08,6380
1409,新纖,20,0,20,光和,2024-03-08,6380
2915,潤泰全,18,0,18,光和,2024-03-08,6380
3711,日月光投控,17,1,16,光和,2024-03-08,6380
1434,福懋,16,0,16,光和,2024-03-08,6380
1471,首利,15,0,15,光和,2024-03-08,6380
6190,萬泰科,15,0,15,光和,2024-03-08,6380
1303,南亞,14,0,14,光和,2024-03-08,6380
8936,國統,16,2,14,光和,2024-03-08,6380
2449,京元電子,21,8,13,光和,2024-03-08,6380
1513,中興電,25,12,13,光和,2024-03-08,6380
2358,廷鑫,23,10,13,光和,2024-03-08,6380
3321,同泰,13,0,13,光和,2024-03-08,6380
6668,中揚光,14,1,13,光和,2024-03-08,6380
4162,智擎,12,0,12,光和,2024-03-08,6380
00934,中信成長高股息,14,2,12,光和,2024-03-08,6380
2436,偉詮電,13,1,12,光和,2024-03-08,6380
6274,台燿,22,10,12,光和,2024-03-08,6380
8050,廣積,13,1,12,光和,2024-03-08,6380
2498,宏達電,13,1,12,光和,2024-03-08,6380
1714,和桐,14,3,11,光和,2024-03-08,6380
2390,云辰,11,0,11,光和,2024-03-08,6380
2405,輔信,11,0,11,光和,2024-03-08,6380
3078,僑威,14,3,11,光和,2024-03-08,6380
00664R,國泰臺灣加權反1,10,0,10,光和,2024-03-08,6380
00751B,元大AAA至A公司債,10,0,10,光和,2024-03-08,6380
1515,力山,11,1,10,光和,2024-03-08,6380
1528,恩德,11,1,10,光和,2024-03-08,6380
2062,橋椿,36,26,10,光和,2024-03-08,6380
2349,錸德,10,0,10,光和,2024-03-08,6380
2371,大同,216,27,189,光和,2024-03-11,6380
2537,聯上發,150,0,150,光和,2024-03-11,6380
00937B,群益ESG投等債20,107,3,104,光和,2024-03-11,6380
00720B,元大投資級公司債,95,0,95,光和,2024-03-11,6380
00687B,國泰20年美債,84,3,81,光和,2024-03-11,6380
3078,僑威,61,0,61,光和,2024-03-11,6380
8110,華東,60,0,60,光和,2024-03-11,6380
2358,廷鑫,47,3,44,光和,2024-03-11,6380
2367,燿華,75,33,42,光和,2024-03-11,6380
4716,大立,40,0,40,光和,2024-03-11,6380
2618,長榮航,41,2,39,光和,2024-03-11,6380
1312,國喬,32,0,32,光和,2024-03-11,6380
2617,台航,33,1,32,光和,2024-03-11,6380
3062,建漢,32,4,28,光和,2024-03-11,6380
1815,富喬,28,2,26,光和,2024-03-11,6380
3689,湧德,31,5,26,光和,2024-03-11,6380
3576,聯合再生,22,1,21,光和,2024-03-11,6380
2301,光寶科,21,1,20,光和,2024-03-11,6380
5324,士開,20,0,20,光和,2024-03-11,6380
00919,群益台灣精選高息,108,90,18,光和,2024-03-11,6380
00918,大華優利高填息30,36,19,17,光和,2024-03-11,6380
1471,首利,17,0,17,光和,2024-03-11,6380
2376,技嘉,27,10,17,光和,2024-03-11,6380
9919,康那香,16,0,16,光和,2024-03-11,6380
1326,台化,15,0,15,光和,2024-03-11,6380
4943,康控-KY,15,0,15,光和,2024-03-11,6380
6589,台康生技,15,0,15,光和,2024-03-11,6380
00929,復華台灣科技優息,72,58,14,光和,2024-03-11,6380
1314,中石化,15,1,14,光和,2024-03-11,6380
1785,光洋科,14,0,14,光和,2024-03-11,6380
3707,漢磊,57,43,14,光和,2024-03-11,6380
8926,台汽電,12,0,12,光和,2024-03-11,6380
2344,華邦電,21,9,12,光和,2024-03-11,6380
00936,台新永續高息中小,11,0,11,光和,2024-03-11,6380
5880,合庫金,16,5,11,光和,2024-03-11,6380
8027,鈦昇,16,5,11,光和,2024-03-11,6380
1446,宏和,10,0,10,光和,2024-03-11,6380
3059,華晶科,10,0,10,光和,2024-03-11,6380
5347,世界,10,0,10,光和,2024-03-11,6380
6153,嘉聯益,10,0,10,光和,2024-03-11,6380
6282,康舒,10,0,10,光和,2024-03-11,6380
6788,華景電,10,0,10,光和,2024-03-11,6380
2034,允強,10,1,9,光和,2024-03-11,6380
2516,新建,11,2,9,光和,2024-03-11,6380
2913,農林,9,0,9,光和,2024-03-11,6380
5386,青雲,12,3,9,光和,2024-03-11,6380
1101,台泥,11,2,9,光和,2024-03-11,6380
2611,志信,23,15,8,光和,2024-03-11,6380
4167,松瑞藥,8,0,8,光和,2024-03-11,6380
5285,界霖,8,0,8,光和,2024-03-11,6380
00929,復華台灣科技優息,136,18,118,光和,2024-03-12,6380
1457,宜進,110,0,110,光和,2024-03-12,6380
00902,中信電池及儲能,100,6,94,光和,2024-03-12,6380
3689,湧德,150,92,58,光和,2024-03-12,6380
2371,大同,74,18,56,光和,2024-03-12,6380
8936,國統,61,12,49,光和,2024-03-12,6380
9933,中鼎,50,2,48,光和,2024-03-12,6380
2542,興富發,50,3,47,光和,2024-03-12,6380
00919,群益台灣精選高息,60,15,45,光和,2024-03-12,6380
2610,華航,45,2,43,光和,2024-03-12,6380
1815,富喬,48,9,39,光和,2024-03-12,6380
3036,文曄,39,1,38,光和,2024-03-12,6380
2409,友達,41,5,36,光和,2024-03-12,6380
2329,華泰,60,24,36,光和,2024-03-12,6380
00720B,元大投資級公司債,36,0,36,光和,2024-03-12,6380
00937B,群益ESG投等債20,35,0,35,光和,2024-03-12,6380
2408,南亞科,33,0,33,光和,2024-03-12,6380
00933B,國泰10Y+金融債,26,0,26,光和,2024-03-12,6380
00891,中信關鍵半導體,26,0,26,光和,2024-03-12,6380
00673R,期元大S＆P原油反1,25,0,25,光和,2024-03-12,6380
00885,富邦越南,25,0,25,光和,2024-03-12,6380
8096,擎亞,47,23,24,光和,2024-03-12,6380
2313,華通,41,18,23,光和,2024-03-12,6380
3325,旭品,38,17,21,光和,2024-03-12,6380
4160,訊聯基因,21,0,21,光和,2024-03-12,6380
00930,永豐ESG低碳高息,25,5,20,光和,2024-03-12,6380
00915,凱基優選高股息30,20,0,20,光和,2024-03-12,6380
00632R,元大台灣50反1,20,0,20,光和,2024-03-12,6380
2358,廷鑫,20,0,20,光和,2024-03-12,6380
4138,曜亞,21,2,19,光和,2024-03-12,6380
2641,正德,16,0,16,光和,2024-03-12,6380
6215,和椿,16,0,16,光和,2024-03-12,6380
2425,承啟,15,2,13,光和,2024-03-12,6380
1301,台塑,12,0,12,光和,2024-03-12,6380
3576,聯合再生,12,0,12,光和,2024-03-12,6380
5880,合庫金,12,0,12,光和,2024-03-12,6380
3711,日月光投控,11,0,11,光和,2024-03-12,6380
00712,復華富時不動產,11,0,11,光和,2024-03-12,6380
2449,京元電子,14,3,11,光和,2024-03-12,6380
2352,佳世達,14,3,11,光和,2024-03-12,6380
00936,台新永續高息中小,10,0,10,光和,2024-03-12,6380
00918,大華優利高填息30,73,63,10,光和,2024-03-12,6380
2892,第一金,12,2,10,光和,2024-03-12,6380
3005,神基,10,0,10,光和,2024-03-12,6380
3049,精金,10,0,10,光和,2024-03-12,6380
3663,鑫科,11,1,10,光和,2024-03-12,6380
3669,圓展,10,0,10,光和,2024-03-12,6380
4306,炎洲,10,0,10,光和,2024-03-12,6380
2324,仁寶,17,7,10,光和,2024-03-12,6380
2483,百容,9,0,9,光和,2024-03-12,6380
00919,群益台灣精選高息,390,61,329,光和,2024-03-13,6380
00655L,國泰中國A50正2,230,0,230,光和,2024-03-13,6380
2344,華邦電,85,5,80,光和,2024-03-13,6380
3689,湧德,81,7,74,光和,2024-03-13,6380
2460,建通,68,0,68,光和,2024-03-13,6380
1314,中石化,61,1,60,光和,2024-03-13,6380
2897,王道銀行,60,0,60,光和,2024-03-13,6380
00679B,元大美債20年,59,0,59,光和,2024-03-13,6380
2408,南亞科,57,1,56,光和,2024-03-13,6380
1101,台泥,58,6,52,光和,2024-03-13,6380
2881,富邦金,45,0,45,光和,2024-03-13,6380
00915,凱基優選高股息30,51,10,41,光和,2024-03-13,6380
00918,大華優利高填息30,52,11,41,光和,2024-03-13,6380
00933B,國泰10Y+金融債,40,0,40,光和,2024-03-13,6380
00632R,元大台灣50反1,40,0,40,光和,2024-03-13,6380
8085,福華,40,0,40,光和,2024-03-13,6380
2515,中工,37,0,37,光和,2024-03-13,6380
00650L,復華香港正2,36,3,33,光和,2024-03-13,6380
1815,富喬,35,2,33,光和,2024-03-13,6380
2367,燿華,53,21,32,光和,2024-03-13,6380
2392,正崴,30,0,30,光和,2024-03-13,6380
00637L,元大滬深300正2,28,1,27,光和,2024-03-13,6380
5211,蒙恬,23,0,23,光和,2024-03-13,6380
6770,力積電,38,15,23,光和,2024-03-13,6380
2365,昆盈,22,1,21,光和,2024-03-13,6380
2352,佳世達,30,10,20,光和,2024-03-13,6380
00665L,富邦�琤肭磪囓�2,20,0,20,光和,2024-03-13,6380
2331,精英,20,0,20,光和,2024-03-13,6380
2349,錸德,20,0,20,光和,2024-03-13,6380
6116,彩晶,20,0,20,光和,2024-03-13,6380
6125,廣運,33,13,20,光和,2024-03-13,6380
1218,泰山,64,45,19,光和,2024-03-13,6380
3663,鑫科,20,1,19,光和,2024-03-13,6380
6026,福邦證,21,3,18,光和,2024-03-13,6380
1303,南亞,18,1,17,光和,2024-03-13,6380
1802,台玻,21,5,16,光和,2024-03-13,6380
3049,精金,16,0,16,光和,2024-03-13,6380
6187,萬潤,16,0,16,光和,2024-03-13,6380
1514,亞力,34,19,15,光和,2024-03-13,6380
2609,陽明,21,6,15,光和,2024-03-13,6380
2892,第一金,15,0,15,光和,2024-03-13,6380
3372,典範,15,0,15,光和,2024-03-13,6380
2337,旺宏,14,0,14,光和,2024-03-13,6380
1524,耿鼎,19,5,14,光和,2024-03-13,6380
2301,光寶科,15,1,14,光和,2024-03-13,6380
5284,jpp-KY,17,3,14,光和,2024-03-13,6380
3231,緯創,65,52,13,光和,2024-03-13,6380
3092,鴻碩,12,0,12,光和,2024-03-13,6380
3588,通嘉,12,0,12,光和,2024-03-13,6380
6114,久威,12,0,12,光和,2024-03-13,6380
2883,凱基金,182,43,139,光和,2024-03-14,6380
00632R,元大台灣50反1,121,0,121,光和,2024-03-14,6380
1815,富喬,100,2,98,光和,2024-03-14,6380
2618,長榮航,132,43,89,光和,2024-03-14,6380
3050,鈺德,63,2,61,光和,2024-03-14,6380
00918,大華優利高填息30,68,10,58,光和,2024-03-14,6380
5347,世界,62,6,56,光和,2024-03-14,6380
00937B,群益ESG投等債20,58,4,54,光和,2024-03-14,6380
3540,曜越,50,0,50,光和,2024-03-14,6380
2025,千興,60,16,44,光和,2024-03-14,6380
00687B,國泰20年美債,51,9,42,光和,2024-03-14,6380
2889,國票金,38,0,38,光和,2024-03-14,6380
2884,玉山金,37,0,37,光和,2024-03-14,6380
2515,中工,31,1,30,光和,2024-03-14,6380
2331,精英,30,0,30,光和,2024-03-14,6380
2483,百容,30,0,30,光和,2024-03-14,6380
2460,建通,35,8,27,光和,2024-03-14,6380
6770,力積電,28,1,27,光和,2024-03-14,6380
1616,億泰,34,10,24,光和,2024-03-14,6380
4906,正文,24,0,24,光和,2024-03-14,6380
1609,大亞,112,92,20,光和,2024-03-14,6380
00931B,統一美債20年,20,0,20,光和,2024-03-14,6380
00908,富邦入息REITs+,20,0,20,光和,2024-03-14,6380
4716,大立,20,0,20,光和,2024-03-14,6380
00679B,元大美債20年,19,0,19,光和,2024-03-14,6380
1210,大成,20,1,19,光和,2024-03-14,6380
2408,南亞科,23,4,19,光和,2024-03-14,6380
2353,宏��,28,10,18,光和,2024-03-14,6380
2405,輔信,18,0,18,光和,2024-03-14,6380
00915,凱基優選高股息30,22,5,17,光和,2024-03-14,6380
2007,燁興,17,0,17,光和,2024-03-14,6380
00637L,元大滬深300正2,16,0,16,光和,2024-03-14,6380
4938,和碩,20,4,16,光和,2024-03-14,6380
2354,鴻準,22,6,16,光和,2024-03-14,6380
3266,昇陽,15,0,15,光和,2024-03-14,6380
2313,華通,20,5,15,光和,2024-03-14,6380
2603,長榮,21,7,14,光和,2024-03-14,6380
00655L,國泰中國A50正2,24,10,14,光和,2024-03-14,6380
1582,信錦,18,4,14,光和,2024-03-14,6380
6015,宏遠證,14,0,14,光和,2024-03-14,6380
2329,華泰,18,4,14,光和,2024-03-14,6380
2615,萬海,13,0,13,光和,2024-03-14,6380
2002,中鋼,12,0,12,光和,2024-03-14,6380
00935,野村臺灣新科技50,12,0,12,光和,2024-03-14,6380
00891,中信關鍵半導體,12,0,12,光和,2024-03-14,6380
2812,台中銀,12,0,12,光和,2024-03-14,6380
6465,威潤,12,0,12,光和,2024-03-14,6380
00882,中信中國高股息,21,10,11,光和,2024-03-14,6380
2301,光寶科,12,1,11,光和,2024-03-14,6380
2404,漢唐,11,0,11,光和,2024-03-14,6380
00941,中信上游半導體,274,0,274,光和,2024-03-15,6380
00919,群益台灣精選高息,314,76,238,光和,2024-03-15,6380
2834,臺企銀,214,23,191,光和,2024-03-15,6380
2618,長榮航,131,25,106,光和,2024-03-15,6380
00937B,群益ESG投等債20,95,0,95,光和,2024-03-15,6380
00882,中信中國高股息,60,0,60,光和,2024-03-15,6380
1337,再生-KY,54,0,54,光和,2024-03-15,6380
911868,同方友友-DR,50,0,50,光和,2024-03-15,6380
00922,國泰台灣領袖50,40,0,40,光和,2024-03-15,6380
3689,湧德,140,103,37,光和,2024-03-15,6380
1609,大亞,53,18,35,光和,2024-03-15,6380
2603,長榮,47,13,34,光和,2024-03-15,6380
2615,萬海,56,25,31,光和,2024-03-15,6380
00673R,期元大S＆P原油反1,30,0,30,光和,2024-03-15,6380
00752,中信中國50,30,0,30,光和,2024-03-15,6380
2881,富邦金,31,2,29,光和,2024-03-15,6380
2889,國票金,29,0,29,光和,2024-03-15,6380
2303,聯電,29,2,27,光和,2024-03-15,6380
2374,佳能,26,0,26,光和,2024-03-15,6380
1210,大成,27,2,25,光和,2024-03-15,6380
00929,復華台灣科技優息,62,38,24,光和,2024-03-15,6380
00720B,元大投資級公司債,24,0,24,光和,2024-03-15,6380
2506,太設,24,0,24,光和,2024-03-15,6380
1303,南亞,23,0,23,光和,2024-03-15,6380
2359,所羅門,23,1,22,光和,2024-03-15,6380
00679B,元大美債20年,20,0,20,光和,2024-03-15,6380
1710,東聯,20,0,20,光和,2024-03-15,6380
3050,鈺德,20,1,19,光和,2024-03-15,6380
2344,華邦電,19,1,18,光和,2024-03-15,6380
2609,陽明,41,24,17,光和,2024-03-15,6380
2328,廣宇,20,3,17,光和,2024-03-15,6380
2405,輔信,18,1,17,光和,2024-03-15,6380
6770,力積電,18,1,17,光和,2024-03-15,6380
2636,台驊控股,18,2,16,光和,2024-03-15,6380
5521,工信,19,3,16,光和,2024-03-15,6380
4306,炎洲,16,1,15,光和,2024-03-15,6380
4906,正文,14,0,14,光和,2024-03-15,6380
3338,泰碩,16,2,14,光和,2024-03-15,6380
8027,鈦昇,14,0,14,光和,2024-03-15,6380
2356,英業達,45,32,13,光和,2024-03-15,6380
3163,波若威,18,5,13,光和,2024-03-15,6380
2402,毅嘉,13,0,13,光和,2024-03-15,6380
00650L,復華香港正2,12,0,12,光和,2024-03-15,6380
5880,合庫金,12,0,12,光和,2024-03-15,6380
1513,中興電,16,5,11,光和,2024-03-15,6380
2301,光寶科,12,1,11,光和,2024-03-15,6380
3049,精金,11,0,11,光和,2024-03-15,6380
3189,景碩,11,0,11,光和,2024-03-15,6380
1815,富喬,12,2,10,光和,2024-03-15,6380
2349,錸德,10,0,10,光和,2024-03-15,6380
00919,群益台灣精選高息,269,4,265,光和,2024-03-18,6380
00712,復華富時不動產,166,4,162,光和,2024-03-18,6380
1609,大亞,126,31,95,光和,2024-03-18,6380
00941,中信上游半導體,67,4,63,光和,2024-03-18,6380
00720B,元大投資級公司債,57,0,57,光和,2024-03-18,6380
2618,長榮航,54,2,52,光和,2024-03-18,6380
2883,凱基金,68,17,51,光和,2024-03-18,6380
2801,彰銀,48,0,48,光和,2024-03-18,6380
3322,建舜電,36,2,34,光和,2024-03-18,6380
6126,信音,29,1,28,光和,2024-03-18,6380
3481,群創,27,0,27,光和,2024-03-18,6380
00937B,群益ESG投等債20,26,0,26,光和,2024-03-18,6380
2834,臺企銀,53,27,26,光和,2024-03-18,6380
00934,中信成長高股息,28,3,25,光和,2024-03-18,6380
00751B,元大AAA至A公司債,25,0,25,光和,2024-03-18,6380
2324,仁寶,28,3,25,光和,2024-03-18,6380
00679B,元大美債20年,22,0,22,光和,2024-03-18,6380
4714,永捷,22,0,22,光和,2024-03-18,6380
1514,亞力,37,16,21,光和,2024-03-18,6380
4960,誠美材,23,2,21,光和,2024-03-18,6380
00881,國泰台灣5G+,25,5,20,光和,2024-03-18,6380
2460,建通,20,0,20,光和,2024-03-18,6380
00687B,國泰20年美債,19,0,19,光和,2024-03-18,6380
2002,中鋼,19,0,19,光和,2024-03-18,6380
1471,首利,18,0,18,光和,2024-03-18,6380
2303,聯電,20,2,18,光和,2024-03-18,6380
2891,中信金,16,1,15,光和,2024-03-18,6380
00918,大華優利高填息30,16,1,15,光和,2024-03-18,6380
00931B,統一美債20年,15,0,15,光和,2024-03-18,6380
2025,千興,15,0,15,光和,2024-03-18,6380
3294,英濟,18,3,15,光和,2024-03-18,6380
00933B,國泰10Y+金融債,14,0,14,光和,2024-03-18,6380
2467,志聖,14,0,14,光和,2024-03-18,6380
8027,鈦昇,14,0,14,光和,2024-03-18,6380
00680L,元大美債20正2,13,0,13,光和,2024-03-18,6380
3715,定穎投控,13,1,12,光和,2024-03-18,6380
1101,台泥,13,1,12,光和,2024-03-18,6380
2376,技嘉,16,4,12,光和,2024-03-18,6380
2867,三商壽,12,0,12,光和,2024-03-18,6380
1326,台化,11,0,11,光和,2024-03-18,6380
2354,鴻準,11,0,11,光和,2024-03-18,6380
2409,友達,14,3,11,光和,2024-03-18,6380
2609,陽明,14,3,11,光和,2024-03-18,6380
5880,合庫金,18,7,11,光和,2024-03-18,6380
8064,東捷,13,2,11,光和,2024-03-18,6380
6153,嘉聯益,13,2,11,光和,2024-03-18,6380
00901,永豐智能車供應鏈,10,0,10,光和,2024-03-18,6380
00896,中信綠能及電動車,10,0,10,光和,2024-03-18,6380
1307,三芳,10,0,10,光和,2024-03-18,6380
1604,聲寶,10,0,10,光和,2024-03-18,6380
00712,復華富時不動產,941,0,941,光和,2024-03-19,6380
00665L,富邦�琤肭磪囓�2,350,0,350,光和,2024-03-19,6380
00637L,元大滬深300正2,150,1,149,光和,2024-03-19,6380
00661,元大日經225,98,0,98,光和,2024-03-19,6380
6239,力成,115,20,95,光和,2024-03-19,6380
2888,新光金,90,0,90,光和,2024-03-19,6380
00937B,群益ESG投等債20,91,5,86,光和,2024-03-19,6380
2353,宏��,62,0,62,光和,2024-03-19,6380
2834,臺企銀,53,1,52,光和,2024-03-19,6380
00919,群益台灣精選高息,105,60,45,光和,2024-03-19,6380
4716,大立,41,0,41,光和,2024-03-19,6380
00679B,元大美債20年,40,3,37,光和,2024-03-19,6380
2002,中鋼,33,0,33,光和,2024-03-19,6380
2460,建通,32,0,32,光和,2024-03-19,6380
3059,華晶科,31,0,31,光和,2024-03-19,6380
2881,富邦金,29,0,29,光和,2024-03-19,6380
1605,華新,44,16,28,光和,2024-03-19,6380
9105,泰金寶-DR,28,0,28,光和,2024-03-19,6380
2371,大同,30,3,27,光和,2024-03-19,6380
2208,台船,40,15,25,光和,2024-03-19,6380
00885,富邦越南,25,1,24,光和,2024-03-19,6380
00687B,國泰20年美債,35,11,24,光和,2024-03-19,6380
2486,一詮,29,5,24,光和,2024-03-19,6380
6288,聯嘉,30,8,22,光和,2024-03-19,6380
2867,三商壽,21,0,21,光和,2024-03-19,6380
2323,中環,23,2,21,光和,2024-03-19,6380
00941,中信上游半導體,20,0,20,光和,2024-03-19,6380
00673R,期元大S＆P原油反1,20,0,20,光和,2024-03-19,6380
00903,富邦元宇宙,20,0,20,光和,2024-03-19,6380
2610,華航,20,0,20,光和,2024-03-19,6380
5880,合庫金,19,0,19,光和,2024-03-19,6380
2329,華泰,29,11,18,光和,2024-03-19,6380
5443,均豪,24,6,18,光和,2024-03-19,6380
2376,技嘉,19,4,15,光和,2024-03-19,6380
2382,廣達,29,14,15,光和,2024-03-19,6380
3715,定穎投控,17,2,15,光和,2024-03-19,6380
1514,亞力,19,5,14,光和,2024-03-19,6380
3231,緯創,55,42,13,光和,2024-03-19,6380
2915,潤泰全,13,0,13,光和,2024-03-19,6380
2515,中工,17,4,13,光和,2024-03-19,6380
1503,士電,28,16,12,光和,2024-03-19,6380
2882,國泰金,12,0,12,光和,2024-03-19,6380
3025,星通,12,0,12,光和,2024-03-19,6380
4943,康控-KY,12,0,12,光和,2024-03-19,6380
6418,詠昇,12,0,12,光和,2024-03-19,6380
3481,群創,12,0,12,光和,2024-03-19,6380
3045,台灣大,11,0,11,光和,2024-03-19,6380
4503,金雨,17,6,11,光和,2024-03-19,6380
00897,富邦基因免疫生技,10,0,10,光和,2024-03-19,6380
2388,威盛,11,1,10,光和,2024-03-19,6380
00939,統一台灣高息動能,1101,0,1101,光和,2024-03-20,6380
8163,達方,260,0,260,光和,2024-03-20,6380
00712,復華富時不動產,127,0,127,光和,2024-03-20,6380
00661,元大日經225,96,0,96,光和,2024-03-20,6380
2888,新光金,103,18,85,光和,2024-03-20,6380
00919,群益台灣精選高息,274,194,80,光和,2024-03-20,6380
1609,大亞,75,1,74,光和,2024-03-20,6380
00929,復華台灣科技優息,177,112,65,光和,2024-03-20,6380
2312,金寶,74,21,53,光和,2024-03-20,6380
2834,臺企銀,65,13,52,光和,2024-03-20,6380
2356,英業達,58,14,44,光和,2024-03-20,6380
00882,中信中國高股息,40,0,40,光和,2024-03-20,6380
2340,台亞,36,0,36,光和,2024-03-20,6380
2354,鴻準,48,14,34,光和,2024-03-20,6380
2374,佳能,38,4,34,光和,2024-03-20,6380
1618,合機,31,1,30,光和,2024-03-20,6380
00679B,元大美債20年,28,0,28,光和,2024-03-20,6380
2344,華邦電,28,0,28,光和,2024-03-20,6380
2618,長榮航,27,1,26,光和,2024-03-20,6380
2460,建通,25,3,22,光和,2024-03-20,6380
3081,聯亞,21,0,21,光和,2024-03-20,6380
6005,群益證,21,0,21,光和,2024-03-20,6380
00665L,富邦�琤肭磪囓�2,20,0,20,光和,2024-03-20,6380
1303,南亞,19,0,19,光和,2024-03-20,6380
3481,群創,23,4,19,光和,2024-03-20,6380
1326,台化,18,0,18,光和,2024-03-20,6380
6278,台表科,18,0,18,光和,2024-03-20,6380
2371,大同,18,1,17,光和,2024-03-20,6380
4915,致伸,24,7,17,光和,2024-03-20,6380
6770,力積電,19,3,16,光和,2024-03-20,6380
1101,台泥,16,0,16,光和,2024-03-20,6380
6290,良維,17,1,16,光和,2024-03-20,6380
6664,群翊,16,0,16,光和,2024-03-20,6380
2449,京元電子,17,2,15,光和,2024-03-20,6380
3276,宇環,15,0,15,光和,2024-03-20,6380
2313,華通,33,19,14,光和,2024-03-20,6380
1513,中興電,21,7,14,光和,2024-03-20,6380
6015,宏遠證,14,1,13,光和,2024-03-20,6380
2367,燿華,20,7,13,光和,2024-03-20,6380
1514,亞力,13,1,12,光和,2024-03-20,6380
1815,富喬,16,4,12,光和,2024-03-20,6380
2890,永豐金,12,0,12,光和,2024-03-20,6380
2883,凱基金,24,13,11,光和,2024-03-20,6380
5880,合庫金,11,0,11,光和,2024-03-20,6380
00637L,元大滬深300正2,11,0,11,光和,2024-03-20,6380
2408,南亞科,11,0,11,光和,2024-03-20,6380
2542,興富發,11,0,11,光和,2024-03-20,6380
5351,鈺創,12,1,11,光和,2024-03-20,6380
6217,中探針,11,0,11,光和,2024-03-20,6380
3594,磐儀,14,3,11,光和,2024-03-20,6380
00632R,元大台灣50反1,427,0,427,光和,2024-03-21,6380
00661,元大日經225,200,0,200,光和,2024-03-21,6380
00939,統一台灣高息動能,234,38,196,光和,2024-03-21,6380
00687B,國泰20年美債,139,0,139,光和,2024-03-21,6380
2405,輔信,144,14,130,光和,2024-03-21,6380
00680L,元大美債20正2,50,0,50,光和,2024-03-21,6380
00937B,群益ESG投等債20,45,0,45,光和,2024-03-21,6380
00679B,元大美債20年,43,0,43,光和,2024-03-21,6380
2834,臺企銀,42,0,42,光和,2024-03-21,6380
2367,燿華,42,7,35,光和,2024-03-21,6380
00712,復華富時不動產,29,0,29,光和,2024-03-21,6380
3576,聯合再生,31,5,26,光和,2024-03-21,6380
6244,茂迪,39,15,24,光和,2024-03-21,6380
2369,菱生,29,6,23,光和,2024-03-21,6380
00929,復華台灣科技優息,23,3,20,光和,2024-03-21,6380
00706L,期元大S＆P日圓正2,20,0,20,光和,2024-03-21,6380
3041,揚智,22,2,20,光和,2024-03-21,6380
1905,華紙,20,1,19,光和,2024-03-21,6380
1101,台泥,20,5,15,光和,2024-03-21,6380
2323,中環,28,13,15,光和,2024-03-21,6380
6418,詠昇,15,0,15,光和,2024-03-21,6380
6239,力成,74,60,14,光和,2024-03-21,6380
1785,光洋科,26,13,13,光和,2024-03-21,6380
9950,萬國通,13,0,13,光和,2024-03-21,6380
1504,東元,27,15,12,光和,2024-03-21,6380
4960,誠美材,17,5,12,光和,2024-03-21,6380
2376,技嘉,12,1,11,光和,2024-03-21,6380
1314,中石化,11,0,11,光和,2024-03-21,6380
2449,京元電子,12,1,11,光和,2024-03-21,6380
1445,大宇,10,0,10,光和,2024-03-21,6380
2034,允強,10,0,10,光和,2024-03-21,6380
2399,映泰,10,0,10,光和,2024-03-21,6380
2401,凌陽,10,0,10,光和,2024-03-21,6380
2436,偉詮電,12,2,10,光和,2024-03-21,6380
3390,旭軟,10,0,10,光和,2024-03-21,6380
4766,南寶,10,0,10,光和,2024-03-21,6380
6141,柏承,10,0,10,光和,2024-03-21,6380
6770,力積電,14,4,10,光和,2024-03-21,6380
2330,台積電,26,16,10,光和,2024-03-21,6380
3005,神基,12,3,9,光和,2024-03-21,6380
2027,大成鋼,10,1,9,光和,2024-03-21,6380
2404,漢唐,9,1,8,光和,2024-03-21,6380
00900,富邦特選高股息30,11,3,8,光和,2024-03-21,6380
2329,華泰,9,1,8,光和,2024-03-21,6380
2377,微星,8,0,8,光和,2024-03-21,6380
2461,光群雷,8,0,8,光和,2024-03-21,6380
3339,泰谷,8,0,8,光和,2024-03-21,6380
5452,佶優,8,0,8,光和,2024-03-21,6380
2353,宏��,9,1,8,光和,2024-03-21,6380
6505,台塑化,7,0,7,光和,2024-03-21,6380
00939,統一台灣高息動能,202,18,184,光和,2024-03-22,6380
00937B,群益ESG投等債20,124,6,118,光和,2024-03-22,6380
00680L,元大美債20正2,110,2,108,光和,2024-03-22,6380
00753L,中信中國50正2,70,0,70,光和,2024-03-22,6380
2353,宏��,143,77,66,光和,2024-03-22,6380
00751B,元大AAA至A公司債,50,0,50,光和,2024-03-22,6380
00720B,元大投資級公司債,50,0,50,光和,2024-03-22,6380
5347,世界,51,2,49,光和,2024-03-22,6380
6015,宏遠證,43,0,43,光和,2024-03-22,6380
2025,千興,40,0,40,光和,2024-03-22,6380
00665L,富邦�琤肭磪囓�2,36,0,36,光和,2024-03-22,6380
2371,大同,42,9,33,光和,2024-03-22,6380
00679B,元大美債20年,58,26,32,光和,2024-03-22,6380
00637L,元大滬深300正2,39,7,32,光和,2024-03-22,6380
00687B,國泰20年美債,68,38,30,光和,2024-03-22,6380
00632R,元大台灣50反1,29,0,29,光和,2024-03-22,6380
2303,聯電,48,21,27,光和,2024-03-22,6380
2888,新光金,65,40,25,光和,2024-03-22,6380
2883,凱基金,27,2,25,光和,2024-03-22,6380
1101,台泥,26,2,24,光和,2024-03-22,6380
2405,輔信,91,67,24,光和,2024-03-22,6380
3706,神達,127,103,24,光和,2024-03-22,6380
00882,中信中國高股息,22,0,22,光和,2024-03-22,6380
2630,亞航,26,4,22,光和,2024-03-22,6380
00706L,期元大S＆P日圓正2,20,0,20,光和,2024-03-22,6380
1303,南亞,20,0,20,光和,2024-03-22,6380
1304,台聚,20,0,20,光和,2024-03-22,6380
2314,台揚,19,0,19,光和,2024-03-22,6380
6163,華電網,21,3,18,光和,2024-03-22,6380
1809,中釉,18,1,17,光和,2024-03-22,6380
9933,中鼎,16,0,16,光和,2024-03-22,6380
00931B,統一美債20年,15,0,15,光和,2024-03-22,6380
8033,雷虎,20,5,15,光和,2024-03-22,6380
2834,臺企銀,27,13,14,光和,2024-03-22,6380
00650L,復華香港正2,14,0,14,光和,2024-03-22,6380
1536,和大,14,0,14,光和,2024-03-22,6380
4716,大立,14,0,14,光和,2024-03-22,6380
2404,漢唐,12,0,12,光和,2024-03-22,6380
1611,中電,12,0,12,光和,2024-03-22,6380
2606,裕民,12,0,12,光和,2024-03-22,6380
3576,聯合再生,12,0,12,光和,2024-03-22,6380
6278,台表科,12,0,12,光和,2024-03-22,6380
9904,寶成,13,1,12,光和,2024-03-22,6380
00878,國泰永續高股息,22,11,11,光和,2024-03-22,6380
3059,華晶科,17,6,11,光和,2024-03-22,6380
8027,鈦昇,17,6,11,光和,2024-03-22,6380
1513,中興電,17,7,10,光和,2024-03-22,6380
00712,復華富時不動產,10,0,10,光和,2024-03-22,6380
00857B,永豐20年美公債,10,0,10,光和,2024-03-22,6380
1326,台化,10,0,10,光和,2024-03-22,6380
00941,中信上游半導體,302,5,297,光和,2024-03-25,6380
00937B,群益ESG投等債20,206,10,196,光和,2024-03-25,6380
1608,華榮,99,3,96,光和,2024-03-25,6380
00720B,元大投資級公司債,92,0,92,光和,2024-03-25,6380
2356,英業達,101,25,76,光和,2024-03-25,6380
2888,新光金,73,2,71,光和,2024-03-25,6380
4526,東台,70,3,67,光和,2024-03-25,6380
00687B,國泰20年美債,67,3,64,光和,2024-03-25,6380
00751B,元大AAA至A公司債,53,0,53,光和,2024-03-25,6380
1612,宏泰,52,1,51,光和,2024-03-25,6380
00632R,元大台灣50反1,50,0,50,光和,2024-03-25,6380
8085,福華,40,0,40,光和,2024-03-25,6380
00706L,期元大S＆P日圓正2,32,0,32,光和,2024-03-25,6380
3058,立德,31,0,31,光和,2024-03-25,6380
00679B,元大美債20年,30,2,28,光和,2024-03-25,6380
4960,誠美材,30,2,28,光和,2024-03-25,6380
6770,力積電,25,0,25,光和,2024-03-25,6380
6015,宏遠證,24,0,24,光和,2024-03-25,6380
00878,國泰永續高股息,35,11,24,光和,2024-03-25,6380
1522,堤維西,23,0,23,光和,2024-03-25,6380
00885,富邦越南,19,0,19,光和,2024-03-25,6380
2882,國泰金,18,0,18,光和,2024-03-25,6380
2596,綠意,17,0,17,光和,2024-03-25,6380
00665L,富邦�琤肭磪囓�2,20,5,15,光和,2024-03-25,6380
00753L,中信中國50正2,15,0,15,光和,2024-03-25,6380
2303,聯電,26,12,14,光和,2024-03-25,6380
1597,直得,15,1,14,光和,2024-03-25,6380
8936,國統,32,18,14,光和,2024-03-25,6380
2317,鴻海,34,20,14,光和,2024-03-25,6380
1304,台聚,23,10,13,光和,2024-03-25,6380
2352,佳世達,17,4,13,光和,2024-03-25,6380
3025,星通,15,2,13,光和,2024-03-25,6380
4915,致伸,25,12,13,光和,2024-03-25,6380
1227,佳格,12,0,12,光和,2024-03-25,6380
2402,毅嘉,13,1,12,光和,2024-03-25,6380
00915,凱基優選高股息30,11,0,11,光和,2024-03-25,6380
1536,和大,11,0,11,光和,2024-03-25,6380
2401,凌陽,13,2,11,光和,2024-03-25,6380
2515,中工,13,2,11,光和,2024-03-25,6380
4973,廣穎,11,0,11,光和,2024-03-25,6380
00857B,永豐20年美公債,10,0,10,光和,2024-03-25,6380
2406,國碩,10,0,10,光和,2024-03-25,6380
2425,承啟,10,0,10,光和,2024-03-25,6380
2834,臺企銀,11,1,10,光和,2024-03-25,6380
3056,富華新,10,0,10,光和,2024-03-25,6380
3622,洋華,10,0,10,光和,2024-03-25,6380
4564,元翎,10,0,10,光和,2024-03-25,6380
1104,環泥,10,0,10,光和,2024-03-25,6380
1515,力山,9,0,9,光和,2024-03-25,6380
2431,聯昌,9,0,9,光和,2024-03-25,6380
00939,統一台灣高息動能,133,15,118,光和,2024-03-26,6380
00919,群益台灣精選高息,156,70,86,光和,2024-03-26,6380
00679B,元大美債20年,48,3,45,光和,2024-03-26,6380
3576,聯合再生,42,0,42,光和,2024-03-26,6380
2303,聯電,46,4,42,光和,2024-03-26,6380
3231,緯創,62,24,38,光和,2024-03-26,6380
2329,華泰,34,4,30,光和,2024-03-26,6380
2417,圓剛,27,0,27,光和,2024-03-26,6380
6176,瑞儀,31,4,27,光和,2024-03-26,6380
4938,和碩,28,3,25,光和,2024-03-26,6380
2356,英業達,56,35,21,光和,2024-03-26,6380
00937B,群益ESG投等債20,21,0,21,光和,2024-03-26,6380
8936,國統,142,122,20,光和,2024-03-26,6380
00885,富邦越南,20,0,20,光和,2024-03-26,6380
00753L,中信中國50正2,20,0,20,光和,2024-03-26,6380
1536,和大,20,0,20,光和,2024-03-26,6380
1717,長興,20,0,20,光和,2024-03-26,6380
2208,台船,20,0,20,光和,2024-03-26,6380
2834,臺企銀,21,1,20,光和,2024-03-26,6380
6492,生華科,20,0,20,光和,2024-03-26,6380
8933,愛地雅,20,0,20,光和,2024-03-26,6380
5347,世界,22,3,19,光和,2024-03-26,6380
00706L,期元大S＆P日圓正2,18,0,18,光和,2024-03-26,6380
1513,中興電,47,29,18,光和,2024-03-26,6380
00941,中信上游半導體,48,31,17,光和,2024-03-26,6380
6505,台塑化,20,4,16,光和,2024-03-26,6380
1504,東元,31,15,16,光和,2024-03-26,6380
2388,威盛,27,12,15,光和,2024-03-26,6380
3260,威剛,16,2,14,光和,2024-03-26,6380
00632R,元大台灣50反1,20,7,13,光和,2024-03-26,6380
2344,華邦電,30,17,13,光和,2024-03-26,6380
6239,力成,58,45,13,光和,2024-03-26,6380
2020,美亞,12,0,12,光和,2024-03-26,6380
1227,佳格,18,6,12,光和,2024-03-26,6380
2340,台亞,12,0,12,光和,2024-03-26,6380
3059,華晶科,17,5,12,光和,2024-03-26,6380
6167,久正,12,0,12,光和,2024-03-26,6380
2611,志信,11,0,11,光和,2024-03-26,6380
6139,亞翔,14,3,11,光和,2024-03-26,6380
6282,康舒,13,2,11,光和,2024-03-26,6380
6788,華景電,11,0,11,光和,2024-03-26,6380
1301,台塑,10,0,10,光和,2024-03-26,6380
2010,春源,10,0,10,光和,2024-03-26,6380
2353,宏��,18,8,10,光和,2024-03-26,6380
2495,普安,10,0,10,光和,2024-03-26,6380
2618,長榮航,14,4,10,光和,2024-03-26,6380
4766,南寶,10,0,10,光和,2024-03-26,6380
6233,旺玖,10,0,10,光和,2024-03-26,6380
6770,力積電,16,6,10,光和,2024-03-26,6380
8401,白紗科,10,0,10,光和,2024-03-26,6380
00637L,元大滬深300正2,150,0,150,光和,2024-03-27,6380
00939,統一台灣高息動能,123,15,108,光和,2024-03-27,6380
1609,大亞,153,45,108,光和,2024-03-27,6380
2371,大同,175,98,77,光和,2024-03-27,6380
2495,普安,66,0,66,光和,2024-03-27,6380
2367,燿華,148,91,57,光和,2024-03-27,6380
3622,洋華,42,3,39,光和,2024-03-27,6380
8936,國統,48,11,37,光和,2024-03-27,6380
2913,農林,34,2,32,光和,2024-03-27,6380
3036,文曄,27,0,27,光和,2024-03-27,6380
2313,華通,31,4,27,光和,2024-03-27,6380
3231,緯創,33,8,25,光和,2024-03-27,6380
2392,正崴,24,0,24,光和,2024-03-27,6380
2834,臺企銀,21,0,21,光和,2024-03-27,6380
1618,合機,26,6,20,光和,2024-03-27,6380
2312,金寶,30,10,20,光和,2024-03-27,6380
4526,東台,22,2,20,光和,2024-03-27,6380
2303,聯電,23,6,17,光和,2024-03-27,6380
3576,聯合再生,16,0,16,光和,2024-03-27,6380
5521,工信,17,1,16,光和,2024-03-27,6380
00679B,元大美債20年,15,0,15,光和,2024-03-27,6380
00941,中信上游半導體,18,3,15,光和,2024-03-27,6380
1513,中興電,27,13,14,光和,2024-03-27,6380
1457,宜進,13,0,13,光和,2024-03-27,6380
1587,吉茂,13,0,13,光和,2024-03-27,6380
3013,晟銘電,15,3,12,光和,2024-03-27,6380
4960,誠美材,20,8,12,光和,2024-03-27,6380
1464,得力,11,0,11,光和,2024-03-27,6380
1808,潤隆,11,0,11,光和,2024-03-27,6380
5381,合正,16,5,11,光和,2024-03-27,6380
6207,雷科,14,3,11,光和,2024-03-27,6380
00918,大華優利高填息30,20,10,10,光和,2024-03-27,6380
00915,凱基優選高股息30,10,0,10,光和,2024-03-27,6380
1337,再生-KY,10,0,10,光和,2024-03-27,6380
2417,圓剛,11,1,10,光和,2024-03-27,6380
2630,亞航,14,4,10,光和,2024-03-27,6380
4303,信立,10,0,10,光和,2024-03-27,6380
4306,炎洲,10,0,10,光和,2024-03-27,6380
5392,能率,10,0,10,光和,2024-03-27,6380
6167,久正,10,0,10,光和,2024-03-27,6380
2634,漢翔,14,5,9,光和,2024-03-27,6380
2460,建通,8,0,8,光和,2024-03-27,6380
1504,東元,14,6,8,光和,2024-03-27,6380
2610,華航,13,5,8,光和,2024-03-27,6380
1612,宏泰,9,2,7,光和,2024-03-27,6380
1605,華新,15,8,7,光和,2024-03-27,6380
2882,國泰金,10,3,7,光和,2024-03-27,6380
1313,聯成,7,0,7,光和,2024-03-27,6380
1785,光洋科,9,2,7,光和,2024-03-27,6380
4113,聯上,7,0,7,光和,2024-03-27,6380
2883,凱基金,184,49,135,光和,2024-03-28,6380
5243,乙盛-KY,112,1,111,光和,2024-03-28,6380
2323,中環,120,21,99,光和,2024-03-28,6380
00632R,元大台灣50反1,100,15,85,光和,2024-03-28,6380
1609,大亞,120,44,76,光和,2024-03-28,6380
2888,新光金,73,0,73,光和,2024-03-28,6380
5347,世界,57,0,57,光和,2024-03-28,6380
00918,大華優利高填息30,45,4,41,光和,2024-03-28,6380
00939,統一台灣高息動能,50,9,41,光和,2024-03-28,6380
00882,中信中國高股息,32,0,32,光和,2024-03-28,6380
1618,合機,38,7,31,光和,2024-03-28,6380
2331,精英,31,0,31,光和,2024-03-28,6380
6770,力積電,47,19,28,光和,2024-03-28,6380
3706,神達,55,28,27,光和,2024-03-28,6380
1416,廣豐,24,0,24,光和,2024-03-28,6380
00919,群益台灣精選高息,41,18,23,光和,2024-03-28,6380
2417,圓剛,22,0,22,光和,2024-03-28,6380
00900,富邦特選高股息30,22,1,21,光和,2024-03-28,6380
4714,永捷,26,5,21,光和,2024-03-28,6380
2328,廣宇,57,37,20,光和,2024-03-28,6380
2634,漢翔,40,20,20,光和,2024-03-28,6380
1522,堤維西,37,18,19,光和,2024-03-28,6380
2356,英業達,29,12,17,光和,2024-03-28,6380
3576,聯合再生,20,3,17,光和,2024-03-28,6380
1608,華榮,25,9,16,光和,2024-03-28,6380
00937B,群益ESG投等債20,22,7,15,光和,2024-03-28,6380
4526,東台,17,2,15,光和,2024-03-28,6380
1303,南亞,15,1,14,光和,2024-03-28,6380
6116,彩晶,14,0,14,光和,2024-03-28,6380
2354,鴻準,95,82,13,光和,2024-03-28,6380
2495,普安,13,0,13,光和,2024-03-28,6380
6015,宏遠證,13,0,13,光和,2024-03-28,6380
6418,詠昇,13,0,13,光和,2024-03-28,6380
5258,虹堡,13,1,12,光和,2024-03-28,6380
5512,力麒,22,10,12,光和,2024-03-28,6380
1316,上曜,17,6,11,光和,2024-03-28,6380
9950,萬國通,11,0,11,光和,2024-03-28,6380
1301,台塑,10,0,10,光和,2024-03-28,6380
2388,威盛,11,1,10,光和,2024-03-28,6380
1503,士電,12,2,10,光和,2024-03-28,6380
2208,台船,10,0,10,光和,2024-03-28,6380
2415,錩新,10,0,10,光和,2024-03-28,6380
2547,日勝生,10,0,10,光和,2024-03-28,6380
2615,萬海,11,1,10,光和,2024-03-28,6380
4999,鑫禾,10,0,10,光和,2024-03-28,6380
5309,系統電,15,5,10,光和,2024-03-28,6380
5324,士開,10,0,10,光和,2024-03-28,6380
6156,松上,10,0,10,光和,2024-03-28,6380
2515,中工,20,10,10,光和,2024-03-28,6380
3231,緯創,24,14,10,光和,2024-03-28,6380
00655L,國泰中國A50正2,100,0,100,光和,2024-03-29,6380
2888,新光金,100,0,100,光和,2024-03-29,6380
2323,中環,70,1,69,光和,2024-03-29,6380
2354,鴻準,74,17,57,光和,2024-03-29,6380
2324,仁寶,81,25,56,光和,2024-03-29,6380
1618,合機,56,2,54,光和,2024-03-29,6380
00939,統一台灣高息動能,57,20,37,光和,2024-03-29,6380
2301,光寶科,48,18,30,光和,2024-03-29,6380
5309,系統電,27,1,26,光和,2024-03-29,6380
2312,金寶,61,40,21,光和,2024-03-29,6380
2468,華經,21,0,21,光和,2024-03-29,6380
1536,和大,20,0,20,光和,2024-03-29,6380
4714,永捷,39,20,19,光和,2024-03-29,6380
00635U,期元大S＆P黃金,18,0,18,光和,2024-03-29,6380
1522,堤維西,24,6,18,光和,2024-03-29,6380
2344,華邦電,31,13,18,光和,2024-03-29,6380
2356,英業達,101,83,18,光和,2024-03-29,6380
6257,矽格,19,2,17,光和,2024-03-29,6380
8096,擎亞,20,4,16,光和,2024-03-29,6380
2889,國票金,15,0,15,光和,2024-03-29,6380
2617,台航,15,0,15,光和,2024-03-29,6380
5512,力麒,21,6,15,光和,2024-03-29,6380
00919,群益台灣精選高息,29,16,13,光和,2024-03-29,6380
6443,元晶,17,5,12,光和,2024-03-29,6380
2382,廣達,38,27,11,光和,2024-03-29,6380
2303,聯電,55,44,11,光和,2024-03-29,6380
8033,雷虎,11,0,11,光和,2024-03-29,6380
00882,中信中國高股息,11,0,11,光和,2024-03-29,6380
3652,精聯,11,0,11,光和,2024-03-29,6380
5515,建國,11,0,11,光和,2024-03-29,6380
1714,和桐,10,0,10,光和,2024-03-29,6380
2417,圓剛,11,1,10,光和,2024-03-29,6380
3149,正達,10,0,10,光和,2024-03-29,6380
3325,旭品,14,4,10,光和,2024-03-29,6380
8047,星雲,10,0,10,光和,2024-03-29,6380
2328,廣宇,42,33,9,光和,2024-03-29,6380
00715L,期街口布蘭特正2,10,1,9,光和,2024-03-29,6380
1314,中石化,9,0,9,光和,2024-03-29,6380
2367,燿華,58,49,9,光和,2024-03-29,6380
2399,映泰,10,1,9,光和,2024-03-29,6380
8121,越峰,10,1,9,光和,2024-03-29,6380
2317,鴻海,87,78,9,光和,2024-03-29,6380
1504,東元,22,14,8,光和,2024-03-29,6380
6282,康舒,11,3,8,光和,2024-03-29,6380
2352,佳世達,9,2,7,光和,2024-03-29,6380
2401,凌陽,10,3,7,光和,2024-03-29,6380
6588,東典光電,7,0,7,光和,2024-03-29,6380
3005,神基,8,2,6,光和,2024-03-29,6380
00941,中信上游半導體,18,12,6,光和,2024-03-29,6380
1457,宜進,6,0,6,光和,2024-03-29,6380
00940,元大台灣價值高息,816,19,797,光和,2024-04-01,6380
3689,湧德,171,44,127,光和,2024-04-01,6380
00939,統一台灣高息動能,125,7,118,光和,2024-04-01,6380
2356,英業達,116,42,74,光和,2024-04-01,6380
3481,群創,75,12,63,光和,2024-04-01,6380
3605,宏致,50,0,50,光和,2024-04-01,6380
8111,立��,40,0,40,光和,2024-04-01,6380
2603,長榮,44,5,39,光和,2024-04-01,6380
2891,中信金,36,0,36,光和,2024-04-01,6380
3231,緯創,51,15,36,光和,2024-04-01,6380
2701,萬企,30,0,30,光和,2024-04-01,6380
5512,力麒,30,0,30,光和,2024-04-01,6380
00919,群益台灣精選高息,28,3,25,光和,2024-04-01,6380
1101,台泥,26,2,24,光和,2024-04-01,6380
8033,雷虎,30,7,23,光和,2024-04-01,6380
4303,信立,21,0,21,光和,2024-04-01,6380
1457,宜進,27,6,21,光和,2024-04-01,6380
2382,廣達,36,15,21,光和,2024-04-01,6380
4440,宜新實業,20,0,20,光和,2024-04-01,6380
6153,嘉聯益,20,0,20,光和,2024-04-01,6380
00679B,元大美債20年,22,3,19,光和,2024-04-01,6380
00937B,群益ESG投等債20,19,0,19,光和,2024-04-01,6380
0056,元大高股息,15,0,15,光和,2024-04-01,6380
2062,橋椿,44,29,15,光和,2024-04-01,6380
6589,台康生技,15,0,15,光和,2024-04-01,6380
6684,安格,14,0,14,光和,2024-04-01,6380
2303,聯電,53,40,13,光和,2024-04-01,6380
3360,尚立,13,0,13,光和,2024-04-01,6380
2836,高雄銀,12,0,12,光和,2024-04-01,6380
8150,南茂,12,0,12,光和,2024-04-01,6380
2365,昆盈,11,0,11,光和,2024-04-01,6380
6005,群益證,11,0,11,光和,2024-04-01,6380
6152,百一,11,0,11,光和,2024-04-01,6380
2610,華航,10,0,10,光和,2024-04-01,6380
1402,遠東新,10,0,10,光和,2024-04-01,6380
00885,富邦越南,10,0,10,光和,2024-04-01,6380
1714,和桐,10,0,10,光和,2024-04-01,6380
2596,綠意,10,0,10,光和,2024-04-01,6380
3356,奇偶,12,2,10,光和,2024-04-01,6380
6139,亞翔,13,3,10,光和,2024-04-01,6380
00878,國泰永續高股息,9,0,9,光和,2024-04-01,6380
1471,首利,9,0,9,光和,2024-04-01,6380
1785,光洋科,8,0,8,光和,2024-04-01,6380
1540,喬福,8,0,8,光和,2024-04-01,6380
6116,彩晶,10,2,8,光和,2024-04-01,6380
1504,東元,21,13,8,光和,2024-04-01,6380
2408,南亞科,9,2,7,光和,2024-04-01,6380
00687B,國泰20年美債,7,0,7,光和,2024-04-01,6380
5347,世界,7,0,7,光和,2024-04-01,6380
00933B,國泰10Y+金融債,10,4,6,光和,2024-04-01,6380
00940,元大台灣價值高息,620,5,615,光和,2024-04-02,6380
00632R,元大台灣50反1,263,4,259,光和,2024-04-02,6380
3673,TPK-KY,100,1,99,光和,2024-04-02,6380
00929,復華台灣科技優息,112,26,86,光和,2024-04-02,6380
2367,燿華,91,24,67,光和,2024-04-02,6380
1618,合機,61,0,61,光和,2024-04-02,6380
2495,普安,60,0,60,光和,2024-04-02,6380
2897,王道銀行,60,0,60,光和,2024-04-02,6380
00655L,國泰中國A50正2,50,0,50,光和,2024-04-02,6380
8064,東捷,42,8,34,光和,2024-04-02,6380
2371,大同,52,19,33,光和,2024-04-02,6380
00679B,元大美債20年,28,0,28,光和,2024-04-02,6380
00937B,群益ESG投等債20,27,0,27,光和,2024-04-02,6380
00939,統一台灣高息動能,38,12,26,光和,2024-04-02,6380
00941,中信上游半導體,27,2,25,光和,2024-04-02,6380
6015,宏遠證,24,0,24,光和,2024-04-02,6380
00712,復華富時不動產,23,0,23,光和,2024-04-02,6380
2352,佳世達,28,7,21,光和,2024-04-02,6380
2301,光寶科,25,4,21,光和,2024-04-02,6380
6695,芯鼎,21,0,21,光和,2024-04-02,6380
00680L,元大美債20正2,20,0,20,光和,2024-04-02,6380
1604,聲寶,20,0,20,光和,2024-04-02,6380
2362,藍天,20,0,20,光和,2024-04-02,6380
4440,宜新實業,20,0,20,光和,2024-04-02,6380
00933B,國泰10Y+金融債,19,1,18,光和,2024-04-02,6380
1608,華榮,20,3,17,光和,2024-04-02,6380
2020,美亞,19,2,17,光和,2024-04-02,6380
3171,炎洲流通,17,0,17,光和,2024-04-02,6380
2408,南亞科,20,3,17,光和,2024-04-02,6380
1457,宜進,16,0,16,光和,2024-04-02,6380
6016,康和證,15,0,15,光和,2024-04-02,6380
8011,台通,15,0,15,光和,2024-04-02,6380
911868,同方友友-DR,15,0,15,光和,2024-04-02,6380
2488,漢平,13,0,13,光和,2024-04-02,6380
2834,臺企銀,12,0,12,光和,2024-04-02,6380
1301,台塑,12,1,11,光和,2024-04-02,6380
00927,群益半導體收益,11,0,11,光和,2024-04-02,6380
1312,國喬,11,0,11,光和,2024-04-02,6380
5355,佳總,12,1,11,光和,2024-04-02,6380
8926,台汽電,13,2,11,光和,2024-04-02,6380
00665L,富邦�琤肭磪囓�2,10,0,10,光和,2024-04-02,6380
1582,信錦,17,7,10,光和,2024-04-02,6380
2511,太子,10,0,10,光和,2024-04-02,6380
2701,萬企,10,0,10,光和,2024-04-02,6380
3049,精金,10,0,10,光和,2024-04-02,6380
3206,志豐,10,0,10,光和,2024-04-02,6380
5258,虹堡,11,1,10,光和,2024-04-02,6380
5512,力麒,40,30,10,光和,2024-04-02,6380
6425,易發,16,6,10,光和,2024-04-02,6380
8933,愛地雅,10,0,10,光和,2024-04-02,6380
00637L,元大滬深300正2,304,0,304,光和,2024-04-03,6380
00929,復華台灣科技優息,281,17,264,光和,2024-04-03,6380
00940,元大台灣價值高息,223,3,220,光和,2024-04-03,6380
3481,群創,112,36,76,光和,2024-04-03,6380
00687B,國泰20年美債,68,0,68,光和,2024-04-03,6380
00679B,元大美債20年,63,0,63,光和,2024-04-03,6380
2371,大同,69,16,53,光和,2024-04-03,6380
00673R,期元大S＆P原油反1,51,0,51,光和,2024-04-03,6380
00941,中信上游半導體,51,0,51,光和,2024-04-03,6380
1618,合機,69,27,42,光和,2024-04-03,6380
8064,東捷,69,27,42,光和,2024-04-03,6380
2515,中工,89,49,40,光和,2024-04-03,6380
2374,佳能,52,13,39,光和,2024-04-03,6380
2014,中鴻,46,12,34,光和,2024-04-03,6380
1103,嘉泥,35,3,32,光和,2024-04-03,6380
0056,元大高股息,33,1,32,光和,2024-04-03,6380
4939,亞電,30,0,30,光和,2024-04-03,6380
2317,鴻海,52,23,29,光和,2024-04-03,6380
2881,富邦金,28,0,28,光和,2024-04-03,6380
2461,光群雷,25,0,25,光和,2024-04-03,6380
2888,新光金,25,0,25,光和,2024-04-03,6380
00939,統一台灣高息動能,27,5,22,光和,2024-04-03,6380
2495,普安,21,0,21,光和,2024-04-03,6380
2353,宏��,20,0,20,光和,2024-04-03,6380
3171,炎洲流通,20,0,20,光和,2024-04-03,6380
911868,同方友友-DR,20,0,20,光和,2024-04-03,6380
2301,光寶科,20,1,19,光和,2024-04-03,6380
00680L,元大美債20正2,22,4,18,光和,2024-04-03,6380
6112,邁達特,18,0,18,光和,2024-04-03,6380
1609,大亞,22,5,17,光和,2024-04-03,6380
00712,復華富時不動產,16,0,16,光和,2024-04-03,6380
2002,中鋼,20,4,16,光和,2024-04-03,6380
2880,華南金,16,0,16,光和,2024-04-03,6380
2481,強茂,14,0,14,光和,2024-04-03,6380
2409,友達,11,0,11,光和,2024-04-03,6380
2645,長榮航太,11,0,11,光和,2024-04-03,6380
5443,均豪,32,22,10,光和,2024-04-03,6380
00720B,元大投資級公司債,10,0,10,光和,2024-04-03,6380
1326,台化,10,0,10,光和,2024-04-03,6380
1714,和桐,10,0,10,光和,2024-04-03,6380
2027,大成鋼,10,0,10,光和,2024-04-03,6380
3059,華晶科,10,0,10,光和,2024-04-03,6380
3317,尼克森,10,0,10,光和,2024-04-03,6380
3704,合勤控,12,2,10,光和,2024-04-03,6380
6016,康和證,10,0,10,光和,2024-04-03,6380
6126,信音,10,0,10,光和,2024-04-03,6380
911608,明輝-DR,10,0,10,光和,2024-04-03,6380
6015,宏遠證,9,0,9,光和,2024-04-03,6380
2020,美亞,16,8,8,光和,2024-04-03,6380
2303,聯電,9,1,8,光和,2024-04-03,6380
00940,元大台灣價值高息,223,9,214,光和,2024-04-08,6380
00632R,元大台灣50反1,204,20,184,光和,2024-04-08,6380
00937B,群益ESG投等債20,133,0,133,光和,2024-04-08,6380
5521,工信,115,27,88,光和,2024-04-08,6380
00679B,元大美債20年,76,0,76,光和,2024-04-08,6380
00931B,統一美債20年,73,5,68,光和,2024-04-08,6380
00885,富邦越南,60,0,60,光和,2024-04-08,6380
00680L,元大美債20正2,53,0,53,光和,2024-04-08,6380
2356,英業達,63,13,50,光和,2024-04-08,6380
8121,越峰,50,3,47,光和,2024-04-08,6380
1609,大亞,84,38,46,光和,2024-04-08,6380
00929,復華台灣科技優息,59,17,42,光和,2024-04-08,6380
2371,大同,57,16,41,光和,2024-04-08,6380
2208,台船,39,0,39,光和,2024-04-08,6380
5443,均豪,43,5,38,光和,2024-04-08,6380
6120,達運,35,2,33,光和,2024-04-08,6380
2354,鴻準,38,7,31,光和,2024-04-08,6380
1710,東聯,31,0,31,光和,2024-04-08,6380
1457,宜進,38,8,30,光和,2024-04-08,6380
2014,中鴻,30,0,30,光和,2024-04-08,6380
2618,長榮航,30,3,27,光和,2024-04-08,6380
3014,聯陽,27,0,27,光和,2024-04-08,6380
1718,中纖,26,0,26,光和,2024-04-08,6380
6122,擎邦,24,0,24,光和,2024-04-08,6380
00637L,元大滬深300正2,24,0,24,光和,2024-04-08,6380
00919,群益台灣精選高息,28,6,22,光和,2024-04-08,6380
00927,群益半導體收益,21,0,21,光和,2024-04-08,6380
3036,文曄,20,0,20,光和,2024-04-08,6380
1701,中化,20,0,20,光和,2024-04-08,6380
6153,嘉聯益,20,0,20,光和,2024-04-08,6380
2324,仁寶,19,2,17,光和,2024-04-08,6380
00712,復華富時不動產,16,0,16,光和,2024-04-08,6380
2023,燁輝,15,0,15,光和,2024-04-08,6380
4939,亞電,15,0,15,光和,2024-04-08,6380
9105,泰金寶-DR,15,1,14,光和,2024-04-08,6380
2367,燿華,16,2,14,光和,2024-04-08,6380
2399,映泰,18,4,14,光和,2024-04-08,6380
4746,台耀,14,0,14,光和,2024-04-08,6380
1603,華電,15,2,13,光和,2024-04-08,6380
00635U,期元大S＆P黃金,12,0,12,光和,2024-04-08,6380
3234,光環,12,0,12,光和,2024-04-08,6380
00915,凱基優選高股息30,11,0,11,光和,2024-04-08,6380
2323,中環,15,4,11,光和,2024-04-08,6380
2353,宏��,19,8,11,光和,2024-04-08,6380
2374,佳能,20,9,11,光和,2024-04-08,6380
3702,大聯大,11,0,11,光和,2024-04-08,6380
00706L,期元大S＆P日圓正2,10,0,10,光和,2024-04-08,6380
00882,中信中國高股息,20,10,10,光和,2024-04-08,6380
1326,台化,10,0,10,光和,2024-04-08,6380
2355,敬鵬,10,0,10,光和,2024-04-08,6380
00927,群益半導體收益,103,0,103,光和,2024-04-09,6380
8121,越峰,71,0,71,光和,2024-04-09,6380
2337,旺宏,50,1,49,光和,2024-04-09,6380
3231,緯創,94,46,48,光和,2024-04-09,6380
00632R,元大台灣50反1,41,0,41,光和,2024-04-09,6380
2501,國建,36,4,32,光和,2024-04-09,6380
00637L,元大滬深300正2,31,0,31,光和,2024-04-09,6380
8112,至上,37,8,29,光和,2024-04-09,6380
3360,尚立,33,5,28,光和,2024-04-09,6380
00940,元大台灣價值高息,49,22,27,光和,2024-04-09,6380
2020,美亞,26,0,26,光和,2024-04-09,6380
00673R,期元大S＆P原油反1,25,0,25,光和,2024-04-09,6380
2371,大同,47,25,22,光和,2024-04-09,6380
9955,佳龍,24,3,21,光和,2024-04-09,6380
8085,福華,21,0,21,光和,2024-04-09,6380
3059,華晶科,24,4,20,光和,2024-04-09,6380
2352,佳世達,20,0,20,光和,2024-04-09,6380
6126,信音,20,0,20,光和,2024-04-09,6380
2417,圓剛,20,1,19,光和,2024-04-09,6380
1457,宜進,17,0,17,光和,2024-04-09,6380
2201,裕隆,17,0,17,光和,2024-04-09,6380
4303,信立,17,0,17,光和,2024-04-09,6380
1587,吉茂,40,24,16,光和,2024-04-09,6380
2382,廣達,18,2,16,光和,2024-04-09,6380
8936,國統,15,0,15,光和,2024-04-09,6380
1440,南紡,14,0,14,光和,2024-04-09,6380
2317,鴻海,52,38,14,光和,2024-04-09,6380
2313,華通,24,11,13,光和,2024-04-09,6380
2324,仁寶,25,12,13,光和,2024-04-09,6380
2356,英業達,35,22,13,光和,2024-04-09,6380
2027,大成鋼,30,17,13,光和,2024-04-09,6380
2102,泰豐,12,0,12,光和,2024-04-09,6380
2316,楠梓電,12,0,12,光和,2024-04-09,6380
2329,華泰,12,0,12,光和,2024-04-09,6380
2867,三商壽,12,0,12,光和,2024-04-09,6380
6189,豐藝,40,28,12,光和,2024-04-09,6380
2365,昆盈,14,2,12,光和,2024-04-09,6380
8050,廣積,11,0,11,光和,2024-04-09,6380
2038,海光,11,0,11,光和,2024-04-09,6380
2537,聯上發,12,1,11,光和,2024-04-09,6380
00753L,中信中國50正2,10,0,10,光和,2024-04-09,6380
1455,集盛,10,0,10,光和,2024-04-09,6380
2332,友訊,10,0,10,光和,2024-04-09,6380
2413,環科,10,0,10,光和,2024-04-09,6380
2511,太子,10,0,10,光和,2024-04-09,6380
6016,康和證,10,0,10,光和,2024-04-09,6380
911608,明輝-DR,10,0,10,光和,2024-04-09,6380
1603,華電,10,1,9,光和,2024-04-09,6380
2023,燁輝,10,1,9,光和,2024-04-09,6380
2323,中環,16,7,9,光和,2024-04-09,6380
6016,康和證,290,5,285,光和,2024-04-10,6380
00940,元大台灣價值高息,153,10,143,光和,2024-04-10,6380
2356,英業達,164,34,130,光和,2024-04-10,6380
2610,華航,51,1,50,光和,2024-04-10,6380
2020,美亞,49,1,48,光和,2024-04-10,6380
00637L,元大滬深300正2,73,30,43,光和,2024-04-10,6380
2014,中鴻,43,4,39,光和,2024-04-10,6380
2515,中工,69,32,37,光和,2024-04-10,6380
2354,鴻準,43,7,36,光和,2024-04-10,6380
1618,合機,45,15,30,光和,2024-04-10,6380
6113,亞矽,30,2,28,光和,2024-04-10,6380
8011,台通,32,4,28,光和,2024-04-10,6380
1815,富喬,25,0,25,光和,2024-04-10,6380
2905,三商,24,0,24,光和,2024-04-10,6380
2208,台船,28,5,23,光和,2024-04-10,6380
2323,中環,25,3,22,光和,2024-04-10,6380
2062,橋椿,26,6,20,光和,2024-04-10,6380
2353,宏��,38,19,19,光和,2024-04-10,6380
8033,雷虎,24,6,18,光和,2024-04-10,6380
2376,技嘉,47,30,17,光和,2024-04-10,6380
1313,聯成,20,3,17,光和,2024-04-10,6380
2501,國建,17,0,17,光和,2024-04-10,6380
2382,廣達,19,3,16,光和,2024-04-10,6380
2324,仁寶,21,5,16,光和,2024-04-10,6380
2472,立隆電,20,4,16,光和,2024-04-10,6380
1612,宏泰,15,0,15,光和,2024-04-10,6380
5009,榮剛,17,3,14,光和,2024-04-10,6380
2301,光寶科,18,5,13,光和,2024-04-10,6380
4945,陞達科技,13,0,13,光和,2024-04-10,6380
6189,豐藝,29,17,12,光和,2024-04-10,6380
2538,基泰,11,0,11,光和,2024-04-10,6380
8085,福華,12,1,11,光和,2024-04-10,6380
3707,漢磊,12,1,11,光和,2024-04-10,6380
00933B,國泰10Y+金融債,10,0,10,光和,2024-04-10,6380
1504,東元,12,2,10,光和,2024-04-10,6380
1604,聲寶,10,0,10,光和,2024-04-10,6380
2460,建通,10,0,10,光和,2024-04-10,6380
2641,正德,10,0,10,光和,2024-04-10,6380
4958,臻鼎-KY,12,2,10,光和,2024-04-10,6380
2834,臺企銀,10,0,10,光和,2024-04-10,6380
2383,台光電,10,0,10,光和,2024-04-10,6380
6117,迎廣,16,7,9,光和,2024-04-10,6380
8358,金居,10,1,9,光和,2024-04-10,6380
1409,新纖,9,0,9,光和,2024-04-10,6380
00929,復華台灣科技優息,32,24,8,光和,2024-04-10,6380
00927,群益半導體收益,8,0,8,光和,2024-04-10,6380
2486,一詮,15,7,8,光和,2024-04-10,6380
2913,農林,10,2,8,光和,2024-04-10,6380
5452,佶優,13,5,8,光和,2024-04-10,6380
2603,長榮,9,2,7,光和,2024-04-10,6380
00712,復華富時不動產,270,0,270,光和,2024-04-11,6380
3481,群創,192,79,113,光和,2024-04-11,6380
8011,台通,180,70,110,光和,2024-04-11,6380
4556,旭然,70,0,70,光和,2024-04-11,6380
00937B,群益ESG投等債20,99,30,69,光和,2024-04-11,6380
00680L,元大美債20正2,60,0,60,光和,2024-04-11,6380
2439,美律,54,0,54,光和,2024-04-11,6380
6016,康和證,58,4,54,光和,2024-04-11,6380
3059,華晶科,54,1,53,光和,2024-04-11,6380
00679B,元大美債20年,46,0,46,光和,2024-04-11,6380
2332,友訊,41,0,41,光和,2024-04-11,6380
00885,富邦越南,40,0,40,光和,2024-04-11,6380
6770,力積電,34,0,34,光和,2024-04-11,6380
00687B,國泰20年美債,64,32,32,光和,2024-04-11,6380
2460,建通,30,0,30,光和,2024-04-11,6380
3024,憶聲,30,0,30,光和,2024-04-11,6380
4960,誠美材,30,0,30,光和,2024-04-11,6380
2367,燿華,36,7,29,光和,2024-04-11,6380
2888,新光金,29,1,28,光和,2024-04-11,6380
1314,中石化,31,4,27,光和,2024-04-11,6380
2409,友達,39,12,27,光和,2024-04-11,6380
6462,神盾,27,0,27,光和,2024-04-11,6380
3049,精金,31,6,25,光和,2024-04-11,6380
2472,立隆電,22,0,22,光和,2024-04-11,6380
00929,復華台灣科技優息,46,25,21,光和,2024-04-11,6380
2542,興富發,21,0,21,光和,2024-04-11,6380
2006,東和鋼鐵,21,0,21,光和,2024-04-11,6380
2630,亞航,39,18,21,光和,2024-04-11,6380
2317,鴻海,92,71,21,光和,2024-04-11,6380
2417,圓剛,20,0,20,光和,2024-04-11,6380
2506,太設,29,9,20,光和,2024-04-11,6380
9911,櫻花,20,0,20,光和,2024-04-11,6380
3231,緯創,26,8,18,光和,2024-04-11,6380
1522,堤維西,16,0,16,光和,2024-04-11,6380
00753L,中信中國50正2,15,0,15,光和,2024-04-11,6380
2406,國碩,18,3,15,光和,2024-04-11,6380
3576,聯合再生,20,5,15,光和,2024-04-11,6380
1609,大亞,24,9,15,光和,2024-04-11,6380
00941,中信上游半導體,14,0,14,光和,2024-04-11,6380
00919,群益台灣精選高息,17,3,14,光和,2024-04-11,6380
1608,華榮,16,2,14,光和,2024-04-11,6380
5521,工信,41,27,14,光和,2024-04-11,6380
8050,廣積,14,0,14,光和,2024-04-11,6380
1524,耿鼎,13,0,13,光和,2024-04-11,6380
1714,和桐,12,0,12,光和,2024-04-11,6380
6163,華電網,12,0,12,光和,2024-04-11,6380
1304,台聚,11,0,11,光和,2024-04-11,6380
2634,漢翔,19,8,11,光和,2024-04-11,6380
2812,台中銀,11,0,11,光和,2024-04-11,6380
2882,國泰金,13,2,11,光和,2024-04-11,6380
00753L,中信中國50正2,423,0,423,光和,2024-04-12,6380
00712,復華富時不動產,221,0,221,光和,2024-04-12,6380
6016,康和證,101,1,100,光和,2024-04-12,6380
2618,長榮航,101,2,99,光和,2024-04-12,6380
2905,三商,80,0,80,光和,2024-04-12,6380
1815,富喬,102,30,72,光和,2024-04-12,6380
00665L,富邦�琤肭磪囓�2,68,0,68,光和,2024-04-12,6380
4306,炎洲,64,0,64,光和,2024-04-12,6380
2344,華邦電,51,0,51,光和,2024-04-12,6380
2371,大同,147,108,39,光和,2024-04-12,6380
00940,元大台灣價值高息,96,57,39,光和,2024-04-12,6380
00687B,國泰20年美債,37,1,36,光和,2024-04-12,6380
6789,采鈺,34,1,33,光和,2024-04-12,6380
2363,矽統,111,79,32,光和,2024-04-12,6380
2365,昆盈,31,1,30,光和,2024-04-12,6380
1714,和桐,27,0,27,光和,2024-04-12,6380
6285,啟��,26,0,26,光和,2024-04-12,6380
00937B,群益ESG投等債20,25,0,25,光和,2024-04-12,6380
6113,亞矽,25,0,25,光和,2024-04-12,6380
6770,力積電,24,0,24,光和,2024-04-12,6380
2020,美亞,24,0,24,光和,2024-04-12,6380
00680L,元大美債20正2,23,0,23,光和,2024-04-12,6380
00720B,元大投資級公司債,22,0,22,光和,2024-04-12,6380
2607,榮運,22,0,22,光和,2024-04-12,6380
3481,群創,115,94,21,光和,2024-04-12,6380
2374,佳能,28,7,21,光和,2024-04-12,6380
3363,上詮,22,1,21,光和,2024-04-12,6380
3231,緯創,27,7,20,光和,2024-04-12,6380
1718,中纖,20,0,20,光和,2024-04-12,6380
2349,錸德,20,0,20,光和,2024-04-12,6380
2329,華泰,20,4,16,光和,2024-04-12,6380
00751B,元大AAA至A公司債,16,0,16,光和,2024-04-12,6380
2002,中鋼,16,0,16,光和,2024-04-12,6380
2506,太設,16,1,15,光和,2024-04-12,6380
4127,天良,15,0,15,光和,2024-04-12,6380
2834,臺企銀,27,12,15,光和,2024-04-12,6380
1514,亞力,27,12,15,光和,2024-04-12,6380
2388,威盛,37,22,15,光和,2024-04-12,6380
2382,廣達,15,1,14,光和,2024-04-12,6380
3024,憶聲,14,0,14,光和,2024-04-12,6380
3339,泰谷,14,0,14,光和,2024-04-12,6380
8011,台通,21,7,14,光和,2024-04-12,6380
00679B,元大美債20年,13,0,13,光和,2024-04-12,6380
1314,中石化,13,0,13,光和,2024-04-12,6380
2376,技嘉,14,1,13,光和,2024-04-12,6380
2406,國碩,13,1,12,光和,2024-04-12,6380
2417,圓剛,12,0,12,光和,2024-04-12,6380
5521,工信,34,22,12,光和,2024-04-12,6380
8358,金居,28,16,12,光和,2024-04-12,6380
2354,鴻準,13,2,11,光和,2024-04-12,6380
00940,元大台灣價值高息,333,19,314,光和,2024-04-15,6380
00929,復華台灣科技優息,244,6,238,光和,2024-04-15,6380
00665L,富邦�琤肭磪囓�2,92,0,92,光和,2024-04-15,6380
4960,誠美材,115,31,84,光和,2024-04-15,6380
2371,大同,145,67,78,光和,2024-04-15,6380
00753L,中信中國50正2,72,0,72,光和,2024-04-15,6380
2538,基泰,58,0,58,光和,2024-04-15,6380
2344,華邦電,55,0,55,光和,2024-04-15,6380
0056,元大高股息,48,0,48,光和,2024-04-15,6380
4533,協易機,53,8,45,光和,2024-04-15,6380
6016,康和證,44,0,44,光和,2024-04-15,6380
2303,聯電,44,1,43,光和,2024-04-15,6380
2905,三商,42,0,42,光和,2024-04-15,6380
1101,台泥,42,5,37,光和,2024-04-15,6380
2002,中鋼,35,0,35,光和,2024-04-15,6380
5347,世界,37,2,35,光和,2024-04-15,6380
2317,鴻海,67,34,33,光和,2024-04-15,6380
2515,中工,35,3,32,光和,2024-04-15,6380
2014,中鴻,32,3,29,光和,2024-04-15,6380
1718,中纖,30,1,29,光和,2024-04-15,6380
1608,華榮,52,23,29,光和,2024-04-15,6380
2634,漢翔,71,43,28,光和,2024-04-15,6380
1513,中興電,56,30,26,光和,2024-04-15,6380
4306,炎洲,24,0,24,光和,2024-04-15,6380
6770,力積電,24,0,24,光和,2024-04-15,6380
1611,中電,25,3,22,光和,2024-04-15,6380
2009,第一銅,26,4,22,光和,2024-04-15,6380
3060,銘異,29,7,22,光和,2024-04-15,6380
3583,辛耘,21,0,21,光和,2024-04-15,6380
00927,群益半導體收益,24,3,21,光和,2024-04-15,6380
1524,耿鼎,21,0,21,光和,2024-04-15,6380
1605,華新,44,24,20,光和,2024-04-15,6380
2417,圓剛,20,0,20,光和,2024-04-15,6380
2618,長榮航,33,13,20,光和,2024-04-15,6380
2883,凱基金,20,1,19,光和,2024-04-15,6380
3059,華晶科,25,7,18,光和,2024-04-15,6380
2460,建通,17,0,17,光和,2024-04-15,6380
3706,神達,19,2,17,光和,2024-04-15,6380
00882,中信中國高股息,22,5,17,光和,2024-04-15,6380
5009,榮剛,17,2,15,光和,2024-04-15,6380
8931,大汽電,15,0,15,光和,2024-04-15,6380
00923,群益台ESG低碳50,17,3,14,光和,2024-04-15,6380
3481,群創,54,40,14,光和,2024-04-15,6380
2323,中環,15,1,14,光和,2024-04-15,6380
00939,統一台灣高息動能,18,5,13,光和,2024-04-15,6380
1612,宏泰,43,30,13,光和,2024-04-15,6380
1909,榮成,13,0,13,光和,2024-04-15,6380
2312,金寶,18,5,13,光和,2024-04-15,6380
2408,南亞科,13,0,13,光和,2024-04-15,6380
00712,復華富時不動產,12,0,12,光和,2024-04-15,6380
00940,元大台灣價值高息,589,11,578,光和,2024-04-16,6380
00885,富邦越南,151,0,151,光和,2024-04-16,6380
2402,毅嘉,118,0,118,光和,2024-04-16,6380
2344,華邦電,130,30,100,光和,2024-04-16,6380
00929,復華台灣科技優息,238,150,88,光和,2024-04-16,6380
4306,炎洲,82,0,82,光和,2024-04-16,6380
2888,新光金,148,71,77,光和,2024-04-16,6380
00939,統一台灣高息動能,124,53,71,光和,2024-04-16,6380
2020,美亞,70,0,70,光和,2024-04-16,6380
3481,群創,130,67,63,光和,2024-04-16,6380
9938,百和,52,0,52,光和,2024-04-16,6380
2408,南亞科,53,2,51,光和,2024-04-16,6380
3706,神達,54,5,49,光和,2024-04-16,6380
1609,大亞,83,34,49,光和,2024-04-16,6380
00937B,群益ESG投等債20,103,55,48,光和,2024-04-16,6380
2892,第一金,47,0,47,光和,2024-04-16,6380
3059,華晶科,53,6,47,光和,2024-04-16,6380
1314,中石化,59,15,44,光和,2024-04-16,6380
1815,富喬,43,0,43,光和,2024-04-16,6380
2353,宏��,61,19,42,光和,2024-04-16,6380
1710,東聯,41,0,41,光和,2024-04-16,6380
2367,燿華,57,16,41,光和,2024-04-16,6380
3231,緯創,59,19,40,光和,2024-04-16,6380
2618,長榮航,105,66,39,光和,2024-04-16,6380
00918,大華優利高填息30,38,0,38,光和,2024-04-16,6380
2472,立隆電,40,3,37,光和,2024-04-16,6380
4960,誠美材,38,1,37,光和,2024-04-16,6380
3047,訊舟,36,0,36,光和,2024-04-16,6380
2412,中華電,37,2,35,光和,2024-04-16,6380
2337,旺宏,35,0,35,光和,2024-04-16,6380
2905,三商,35,1,34,光和,2024-04-16,6380
2834,臺企銀,34,1,33,光和,2024-04-16,6380
00712,復華富時不動產,33,0,33,光和,2024-04-16,6380
1416,廣豐,32,0,32,光和,2024-04-16,6380
3033,威健,30,0,30,光和,2024-04-16,6380
4711,永純,30,0,30,光和,2024-04-16,6380
2439,美律,28,0,28,光和,2024-04-16,6380
2609,陽明,28,2,26,光和,2024-04-16,6380
5347,世界,28,3,25,光和,2024-04-16,6380
2330,台積電,25,0,25,光和,2024-04-16,6380
1616,億泰,24,0,24,光和,2024-04-16,6380
2371,大同,111,88,23,光和,2024-04-16,6380
3049,精金,23,0,23,光和,2024-04-16,6380
6163,華電網,24,1,23,光和,2024-04-16,6380
2883,凱基金,22,0,22,光和,2024-04-16,6380
0056,元大高股息,37,15,22,光和,2024-04-16,6380
1326,台化,22,0,22,光和,2024-04-16,6380
2331,精英,25,3,22,光和,2024-04-16,6380
2301,光寶科,36,14,22,光和,2024-04-16,6380
2303,聯電,52,30,22,光和,2024-04-16,6380
00637L,元大滬深300正2,310,0,310,光和,2024-04-17,6380
00937B,群益ESG投等債20,146,16,130,光和,2024-04-17,6380
00929,復華台灣科技優息,123,0,123,光和,2024-04-17,6380
2353,宏��,111,4,107,光和,2024-04-17,6380
2408,南亞科,93,3,90,光和,2024-04-17,6380
00931B,統一美債20年,84,0,84,光和,2024-04-17,6380
00753L,中信中國50正2,83,0,83,光和,2024-04-17,6380
2303,聯電,68,2,66,光和,2024-04-17,6380
0056,元大高股息,53,3,50,光和,2024-04-17,6380
6125,廣運,60,13,47,光和,2024-04-17,6380
3231,緯創,48,5,43,光和,2024-04-17,6380
00687B,國泰20年美債,46,4,42,光和,2024-04-17,6380
00712,復華富時不動產,78,40,38,光和,2024-04-17,6380
1605,華新,78,40,38,光和,2024-04-17,6380
3489,森寶,36,0,36,光和,2024-04-17,6380
00919,群益台灣精選高息,45,9,36,光和,2024-04-17,6380
6770,力積電,43,11,32,光和,2024-04-17,6380
00941,中信上游半導體,32,0,32,光和,2024-04-17,6380
00940,元大台灣價值高息,44,13,31,光和,2024-04-17,6380
4943,康控-KY,30,0,30,光和,2024-04-17,6380
2356,英業達,28,4,24,光和,2024-04-17,6380
8096,擎亞,22,1,21,光和,2024-04-17,6380
00740B,富邦全球投等債,20,0,20,光和,2024-04-17,6380
00665L,富邦�琤肭磪囓�2,20,0,20,光和,2024-04-17,6380
1718,中纖,20,0,20,光和,2024-04-17,6380
2897,王道銀行,20,0,20,光和,2024-04-17,6380
6288,聯嘉,20,0,20,光和,2024-04-17,6380
2457,飛宏,21,2,19,光和,2024-04-17,6380
3706,神達,24,5,19,光和,2024-04-17,6380
2834,臺企銀,22,4,18,光和,2024-04-17,6380
6285,啟��,17,0,17,光和,2024-04-17,6380
00720B,元大投資級公司債,16,0,16,光和,2024-04-17,6380
1909,榮成,15,0,15,光和,2024-04-17,6380
2801,彰銀,25,10,15,光和,2024-04-17,6380
2867,三商壽,56,41,15,光和,2024-04-17,6380
3005,神基,16,1,15,光和,2024-04-17,6380
3051,力特,15,1,14,光和,2024-04-17,6380
00878,國泰永續高股息,14,0,14,光和,2024-04-17,6380
2515,中工,29,16,13,光和,2024-04-17,6380
2886,兆豐金,13,1,12,光和,2024-04-17,6380
6505,台塑化,12,0,12,光和,2024-04-17,6380
00857B,永豐20年美公債,12,0,12,光和,2024-04-17,6380
1584,精剛,13,1,12,光和,2024-04-17,6380
2460,建通,12,0,12,光和,2024-04-17,6380
2845,遠東銀,12,0,12,光和,2024-04-17,6380
00905,FT臺灣Smart,11,0,11,光和,2024-04-17,6380
00632R,元大台灣50反1,11,0,11,光和,2024-04-17,6380
2610,華航,15,4,11,光和,2024-04-17,6380
3481,群創,12,2,10,光和,2024-04-17,6380
1326,台化,10,0,10,光和,2024-04-17,6380
2371,大同,385,109,276,光和,2024-04-18,6380
00632R,元大台灣50反1,265,30,235,光和,2024-04-18,6380
2501,國建,202,102,100,光和,2024-04-18,6380
3481,群創,82,6,76,光和,2024-04-18,6380
6125,廣運,87,11,76,光和,2024-04-18,6380
00929,復華台灣科技優息,74,0,74,光和,2024-04-18,6380
00940,元大台灣價值高息,84,11,73,光和,2024-04-18,6380
2312,金寶,76,10,66,光和,2024-04-18,6380
2867,三商壽,131,79,52,光和,2024-04-18,6380
00687B,國泰20年美債,40,1,39,光和,2024-04-18,6380
2439,美律,43,6,37,光和,2024-04-18,6380
8171,天宇,33,0,33,光和,2024-04-18,6380
00680L,元大美債20正2,30,0,30,光和,2024-04-18,6380
5529,鉅陞,30,0,30,光和,2024-04-18,6380
1504,東元,38,9,29,光和,2024-04-18,6380
00937B,群益ESG投等債20,39,10,29,光和,2024-04-18,6380
1617,榮星,30,1,29,光和,2024-04-18,6380
2630,亞航,37,10,27,光和,2024-04-18,6380
2515,中工,87,60,27,光和,2024-04-18,6380
2408,南亞科,26,0,26,光和,2024-04-18,6380
6770,力積電,43,17,26,光和,2024-04-18,6380
00939,統一台灣高息動能,25,0,25,光和,2024-04-18,6380
1312,國喬,25,0,25,光和,2024-04-18,6380
9904,寶成,27,2,25,光和,2024-04-18,6380
8121,越峰,26,1,25,光和,2024-04-18,6380
2009,第一銅,25,1,24,光和,2024-04-18,6380
2027,大成鋼,33,11,22,光和,2024-04-18,6380
6264,富裔,21,0,21,光和,2024-04-18,6380
2634,漢翔,33,14,19,光和,2024-04-18,6380
00712,復華富時不動產,17,0,17,光和,2024-04-18,6380
2014,中鴻,57,40,17,光和,2024-04-18,6380
2362,藍天,16,0,16,光和,2024-04-18,6380
4440,宜新實業,16,0,16,光和,2024-04-18,6380
8097,常珵,16,0,16,光和,2024-04-18,6380
3615,安可,15,0,15,光和,2024-04-18,6380
2303,聯電,26,11,15,光和,2024-04-18,6380
2329,華泰,29,15,14,光和,2024-04-18,6380
5515,建國,15,1,14,光和,2024-04-18,6380
0056,元大高股息,21,7,14,光和,2024-04-18,6380
8033,雷虎,24,11,13,光和,2024-04-18,6380
00919,群益台灣精選高息,16,4,12,光和,2024-04-18,6380
00941,中信上游半導體,18,6,12,光和,2024-04-18,6380
2537,聯上發,13,1,12,光和,2024-04-18,6380
3059,華晶科,12,0,12,光和,2024-04-18,6380
5522,遠雄,12,0,12,光和,2024-04-18,6380
4952,凌通,12,1,11,光和,2024-04-18,6380
1301,台塑,11,0,11,光和,2024-04-18,6380
00795B,中信美國公債20年,10,0,10,光和,2024-04-18,6380
2352,佳世達,13,3,10,光和,2024-04-18,6380
2417,圓剛,10,0,10,光和,2024-04-18,6380
00929,復華台灣科技優息,428,30,398,光和,2024-04-19,6380
00940,元大台灣價值高息,348,2,346,光和,2024-04-19,6380
6125,廣運,194,16,178,光和,2024-04-19,6380
00637L,元大滬深300正2,106,0,106,光和,2024-04-19,6380
00919,群益台灣精選高息,125,28,97,光和,2024-04-19,6380
5512,力麒,145,55,90,光和,2024-04-19,6380
8121,越峰,88,0,88,光和,2024-04-19,6380
00939,統一台灣高息動能,90,13,77,光和,2024-04-19,6380
2002,中鋼,70,1,69,光和,2024-04-19,6380
1815,富喬,74,9,65,光和,2024-04-19,6380
2460,建通,66,1,65,光和,2024-04-19,6380
2303,聯電,70,13,57,光和,2024-04-19,6380
5347,世界,53,0,53,光和,2024-04-19,6380
2330,台積電,57,6,51,光和,2024-04-19,6380
1220,台榮,50,0,50,光和,2024-04-19,6380
1504,東元,89,39,50,光和,2024-04-19,6380
00878,國泰永續高股息,62,14,48,光和,2024-04-19,6380
0056,元大高股息,57,14,43,光和,2024-04-19,6380
6770,力積電,50,9,41,光和,2024-04-19,6380
1609,大亞,126,86,40,光和,2024-04-19,6380
00687B,國泰20年美債,40,0,40,光和,2024-04-19,6380
00706L,期元大S＆P日圓正2,40,0,40,光和,2024-04-19,6380
3231,緯創,59,22,37,光和,2024-04-19,6380
4564,元翎,36,0,36,光和,2024-04-19,6380
3481,群創,66,31,35,光和,2024-04-19,6380
00753L,中信中國50正2,35,0,35,光和,2024-04-19,6380
00665L,富邦�琤肭磪囓�2,30,0,30,光和,2024-04-19,6380
1444,力麗,30,0,30,光和,2024-04-19,6380
6264,富裔,30,0,30,光和,2024-04-19,6380
2408,南亞科,29,1,28,光和,2024-04-19,6380
2062,橋椿,33,10,23,光和,2024-04-19,6380
4952,凌通,24,1,23,光和,2024-04-19,6380
1605,華新,62,41,21,光和,2024-04-19,6380
2439,美律,21,0,21,光和,2024-04-19,6380
8383,千附,24,3,21,光和,2024-04-19,6380
00673R,期元大S＆P原油反1,20,0,20,光和,2024-04-19,6380
2464,盟立,22,2,20,光和,2024-04-19,6380
2605,新興,78,58,20,光和,2024-04-19,6380
3078,僑威,20,0,20,光和,2024-04-19,6380
1612,宏泰,31,12,19,光和,2024-04-19,6380
3322,建舜電,21,2,19,光和,2024-04-19,6380
4976,佳凌,18,0,18,光和,2024-04-19,6380
4726,永昕,17,0,17,光和,2024-04-19,6380
5309,系統電,17,0,17,光和,2024-04-19,6380
2892,第一金,17,0,17,光和,2024-04-19,6380
2353,宏��,40,24,16,光和,2024-04-19,6380
3059,華晶科,16,0,16,光和,2024-04-19,6380
4157,太景*-KY,19,3,16,光和,2024-04-19,6380
2885,元大金,15,0,15,光和,2024-04-19,6380
00692,富邦公司治理,15,0,15,光和,2024-04-19,6380
00940,元大台灣價值高息,210,0,210,光和,2024-04-22,6380
00929,復華台灣科技優息,205,11,194,光和,2024-04-22,6380
2371,大同,262,105,157,光和,2024-04-22,6380
00918,大華優利高填息30,123,8,115,光和,2024-04-22,6380
00937B,群益ESG投等債20,92,0,92,光和,2024-04-22,6380
1618,合機,81,11,70,光和,2024-04-22,6380
00939,統一台灣高息動能,61,0,61,光和,2024-04-22,6380
4526,東台,82,27,55,光和,2024-04-22,6380
00919,群益台灣精選高息,60,6,54,光和,2024-04-22,6380
2408,南亞科,44,0,44,光和,2024-04-22,6380
1617,榮星,45,1,44,光和,2024-04-22,6380
2609,陽明,57,13,44,光和,2024-04-22,6380
2409,友達,43,1,42,光和,2024-04-22,6380
2605,新興,50,10,40,光和,2024-04-22,6380
5534,長虹,40,1,39,光和,2024-04-22,6380
2020,美亞,41,3,38,光和,2024-04-22,6380
1608,華榮,55,18,37,光和,2024-04-22,6380
2303,聯電,49,12,37,光和,2024-04-22,6380
5512,力麒,67,36,31,光和,2024-04-22,6380
3078,僑威,30,0,30,光和,2024-04-22,6380
2329,華泰,35,6,29,光和,2024-04-22,6380
3481,群創,58,29,29,光和,2024-04-22,6380
2405,輔信,29,2,27,光和,2024-04-22,6380
2353,宏��,27,2,25,光和,2024-04-22,6380
0056,元大高股息,36,14,22,光和,2024-04-22,6380
5548,安倉,21,0,21,光和,2024-04-22,6380
00931B,統一美債20年,20,0,20,光和,2024-04-22,6380
2511,太子,21,1,20,光和,2024-04-22,6380
3540,曜越,20,0,20,光和,2024-04-22,6380
4956,光鋐,20,0,20,光和,2024-04-22,6380
2344,華邦電,44,25,19,光和,2024-04-22,6380
2356,英業達,34,16,18,光和,2024-04-22,6380
3339,泰谷,20,2,18,光和,2024-04-22,6380
6239,力成,40,22,18,光和,2024-04-22,6380
8027,鈦昇,18,0,18,光和,2024-04-22,6380
3535,晶彩科,17,0,17,光和,2024-04-22,6380
6116,彩晶,18,1,17,光和,2024-04-22,6380
1513,中興電,37,21,16,光和,2024-04-22,6380
6163,華電網,20,4,16,光和,2024-04-22,6380
2324,仁寶,16,1,15,光和,2024-04-22,6380
5521,工信,198,183,15,光和,2024-04-22,6380
3036,文曄,16,1,15,光和,2024-04-22,6380
6425,易發,15,0,15,光和,2024-04-22,6380
3231,緯創,38,25,13,光和,2024-04-22,6380
1584,精剛,13,0,13,光和,2024-04-22,6380
4711,永純,13,0,13,光和,2024-04-22,6380
2317,鴻海,13,0,13,光和,2024-04-22,6380
2101,南港,14,2,12,光和,2024-04-22,6380
5347,世界,12,0,12,光和,2024-04-22,6380
00687B,國泰20年美債,11,0,11,光和,2024-04-22,6380
00637L,元大滬深300正2,371,200,171,光和,2024-04-23,6380
6264,富裔,52,0,52,光和,2024-04-23,6380
00940,元大台灣價值高息,43,0,43,光和,2024-04-23,6380
4157,太景*-KY,40,0,40,光和,2024-04-23,6380
00919,群益台灣精選高息,42,3,39,光和,2024-04-23,6380
2610,華航,46,15,31,光和,2024-04-23,6380
1504,東元,32,2,30,光和,2024-04-23,6380
3706,神達,111,81,30,光和,2024-04-23,6380
6770,力積電,27,3,24,光和,2024-04-23,6380
1618,合機,49,25,24,光和,2024-04-23,6380
00929,復華台灣科技優息,48,25,23,光和,2024-04-23,6380
2363,矽統,30,9,21,光和,2024-04-23,6380
5483,中美晶,21,0,21,光和,2024-04-23,6380
3231,緯創,24,4,20,光和,2024-04-23,6380
00897,富邦基因免疫生技,20,0,20,光和,2024-04-23,6380
1616,億泰,19,2,17,光和,2024-04-23,6380
5521,工信,32,15,17,光和,2024-04-23,6380
3059,華晶科,22,6,16,光和,2024-04-23,6380
2303,聯電,15,0,15,光和,2024-04-23,6380
5315,光聯,15,0,15,光和,2024-04-23,6380
00918,大華優利高填息30,14,0,14,光和,2024-04-23,6380
2374,佳能,38,24,14,光和,2024-04-23,6380
2460,建通,14,0,14,光和,2024-04-23,6380
6283,淳安,13,0,13,光和,2024-04-23,6380
1785,光洋科,12,0,12,光和,2024-04-23,6380
2885,元大金,12,0,12,光和,2024-04-23,6380
00679B,元大美債20年,11,0,11,光和,2024-04-23,6380
6244,茂迪,11,0,11,光和,2024-04-23,6380
00882,中信中國高股息,11,0,11,光和,2024-04-23,6380
00885,富邦越南,10,0,10,光和,2024-04-23,6380
2038,海光,10,0,10,光和,2024-04-23,6380
2867,三商壽,29,19,10,光和,2024-04-23,6380
3024,憶聲,15,5,10,光和,2024-04-23,6380
4766,南寶,10,0,10,光和,2024-04-23,6380
5498,凱崴,10,0,10,光和,2024-04-23,6380
6153,嘉聯益,10,0,10,光和,2024-04-23,6380
8050,廣積,10,0,10,光和,2024-04-23,6380
8097,常珵,10,0,10,光和,2024-04-23,6380
6120,達運,14,4,10,光和,2024-04-23,6380
2344,華邦電,9,0,9,光和,2024-04-23,6380
2367,燿華,39,30,9,光和,2024-04-23,6380
3715,定穎投控,29,20,9,光和,2024-04-23,6380
3006,晶豪科,9,1,8,光和,2024-04-23,6380
2449,京元電子,10,2,8,光和,2024-04-23,6380
2547,日勝生,11,3,8,光和,2024-04-23,6380
2317,鴻海,13,6,7,光和,2024-04-23,6380
2313,華通,7,0,7,光和,2024-04-23,6380
3078,僑威,7,0,7,光和,2024-04-23,6380
4711,永純,7,0,7,光和,2024-04-23,6380
2630,亞航,6,0,6,光和,2024-04-23,6380
00637L,元大滬深300正2,194,1,193,光和,2024-04-24,6380
2547,日勝生,100,11,89,光和,2024-04-24,6380
2312,金寶,50,0,50,光和,2024-04-24,6380
1304,台聚,44,0,44,光和,2024-04-24,6380
2303,聯電,48,5,43,光和,2024-04-24,6380
9105,泰金寶-DR,31,0,31,光和,2024-04-24,6380
6264,富裔,30,2,28,光和,2024-04-24,6380
3481,群創,29,6,23,光和,2024-04-24,6380
2014,中鴻,21,0,21,光和,2024-04-24,6380
2399,映泰,23,2,21,光和,2024-04-24,6380
3715,定穎投控,21,0,21,光和,2024-04-24,6380
00942B,台新美A公司債20+,20,0,20,光和,2024-04-24,6380
00680L,元大美債20正2,20,0,20,光和,2024-04-24,6380
2888,新光金,23,3,20,光和,2024-04-24,6380
00929,復華台灣科技優息,29,10,19,光和,2024-04-24,6380
00679B,元大美債20年,19,0,19,光和,2024-04-24,6380
2367,燿華,30,11,19,光和,2024-04-24,6380
1605,華新,41,23,18,光和,2024-04-24,6380
6603,富強鑫,17,0,17,光和,2024-04-24,6380
00632R,元大台灣50反1,16,0,16,光和,2024-04-24,6380
2501,國建,26,11,15,光和,2024-04-24,6380
6125,廣運,31,17,14,光和,2024-04-24,6380
2101,南港,16,2,14,光和,2024-04-24,6380
1612,宏泰,18,5,13,光和,2024-04-24,6380
6215,和椿,12,0,12,光和,2024-04-24,6380
3060,銘異,12,0,12,光和,2024-04-24,6380
2886,兆豐金,11,0,11,光和,2024-04-24,6380
00885,富邦越南,11,0,11,光和,2024-04-24,6380
00878,國泰永續高股息,11,0,11,光和,2024-04-24,6380
3583,辛耘,17,6,11,光和,2024-04-24,6380
1733,五鼎,10,0,10,光和,2024-04-24,6380
2409,友達,12,2,10,光和,2024-04-24,6380
2427,三商電,12,2,10,光和,2024-04-24,6380
2504,國產,10,0,10,光和,2024-04-24,6380
2836,高雄銀,10,0,10,光和,2024-04-24,6380
2882,國泰金,10,0,10,光和,2024-04-24,6380
3016,嘉晶,10,0,10,光和,2024-04-24,6380
4711,永純,10,0,10,光和,2024-04-24,6380
6153,嘉聯益,10,0,10,光和,2024-04-24,6380
8011,台通,71,61,10,光和,2024-04-24,6380
1108,幸福,10,1,9,光和,2024-04-24,6380
1504,東元,21,12,9,光和,2024-04-24,6380
3147,大綜,9,0,9,光和,2024-04-24,6380
5511,德昌,11,2,9,光和,2024-04-24,6380
6613,朋億*,9,0,9,光和,2024-04-24,6380
2105,正新,13,5,8,光和,2024-04-24,6380
2316,楠梓電,14,6,8,光和,2024-04-24,6380
2460,建通,8,0,8,光和,2024-04-24,6380
2891,中信金,22,15,7,光和,2024-04-24,6380
2034,允強,7,0,7,光和,2024-04-24,6380
8011,台通,101,22,79,光和,2024-04-25,6380
2547,日勝生,60,0,60,光和,2024-04-25,6380
2610,華航,69,10,59,光和,2024-04-25,6380
6770,力積電,58,0,58,光和,2024-04-25,6380
00929,復華台灣科技優息,55,2,53,光和,2024-04-25,6380
3481,群創,66,14,52,光和,2024-04-25,6380
2106,建大,47,1,46,光和,2024-04-25,6380
1618,合機,50,5,45,光和,2024-04-25,6380
2618,長榮航,58,14,44,光和,2024-04-25,6380
8097,常珵,33,1,32,光和,2024-04-25,6380
2303,聯電,34,3,31,光和,2024-04-25,6380
1304,台聚,31,0,31,光和,2024-04-25,6380
2014,中鴻,30,0,30,光和,2024-04-25,6380
8936,國統,35,6,29,光和,2024-04-25,6380
00937B,群益ESG投等債20,26,0,26,光和,2024-04-25,6380
2367,燿華,34,9,25,光和,2024-04-25,6380
00940,元大台灣價值高息,24,0,24,光和,2024-04-25,6380
00661,元大日經225,24,0,24,光和,2024-04-25,6380
2464,盟立,26,3,23,光和,2024-04-25,6380
2317,鴻海,32,10,22,光和,2024-04-25,6380
2354,鴻準,24,3,21,光和,2024-04-25,6380
5521,工信,27,6,21,光和,2024-04-25,6380
00942B,台新美A公司債20+,20,0,20,光和,2024-04-25,6380
00706L,期元大S＆P日圓正2,20,0,20,光和,2024-04-25,6380
2352,佳世達,20,0,20,光和,2024-04-25,6380
2867,三商壽,20,0,20,光和,2024-04-25,6380
4716,大立,30,10,20,光和,2024-04-25,6380
5347,世界,21,1,20,光和,2024-04-25,6380
2313,華通,18,1,17,光和,2024-04-25,6380
9933,中鼎,17,2,15,光和,2024-04-25,6380
0056,元大高股息,20,6,14,光和,2024-04-25,6380
2634,漢翔,21,7,14,光和,2024-04-25,6380
3689,湧德,13,0,13,光和,2024-04-25,6380
6282,康舒,13,0,13,光和,2024-04-25,6380
8104,錸寶,13,0,13,光和,2024-04-25,6380
1216,統一,12,0,12,光和,2024-04-25,6380
2359,所羅門,16,4,12,光和,2024-04-25,6380
00939,統一台灣高息動能,11,0,11,光和,2024-04-25,6380
3024,憶聲,12,1,11,光和,2024-04-25,6380
3704,合勤控,11,0,11,光和,2024-04-25,6380
00688L,國泰20年美債正2,10,0,10,光和,2024-04-25,6380
00795B,中信美國公債20年,10,0,10,光和,2024-04-25,6380
1326,台化,10,0,10,光和,2024-04-25,6380
1471,首利,11,1,10,光和,2024-04-25,6380
1731,美吾華,10,0,10,光和,2024-04-25,6380
2010,春源,10,0,10,光和,2024-04-25,6380
2605,新興,10,0,10,光和,2024-04-25,6380
5475,德宏,10,0,10,光和,2024-04-25,6380
5534,長虹,12,2,10,光和,2024-04-25,6380
00919,群益台灣精選高息,11,2,9,光和,2024-04-25,6380
00940,元大台灣價值高息,430,2,428,光和,2024-04-26,6380
2542,興富發,65,1,64,光和,2024-04-26,6380
3689,湧德,80,20,60,光和,2024-04-26,6380
2367,燿華,50,1,49,光和,2024-04-26,6380
2371,大同,75,29,46,光和,2024-04-26,6380
00929,復華台灣科技優息,55,10,45,光和,2024-04-26,6380
00632R,元大台灣50反1,41,1,40,光和,2024-04-26,6380
1457,宜進,42,7,35,光和,2024-04-26,6380
4543,萬在,35,1,34,光和,2024-04-26,6380
2106,建大,33,0,33,光和,2024-04-26,6380
2316,楠梓電,33,2,31,光和,2024-04-26,6380
00706L,期元大S＆P日圓正2,30,0,30,光和,2024-04-26,6380
00942B,台新美A公司債20+,30,0,30,光和,2024-04-26,6380
2412,中華電,30,0,30,光和,2024-04-26,6380
00937B,群益ESG投等債20,41,13,28,光和,2024-04-26,6380
1440,南紡,34,6,28,光和,2024-04-26,6380
00679B,元大美債20年,36,10,26,光和,2024-04-26,6380
1101,台泥,28,2,26,光和,2024-04-26,6380
1605,華新,43,18,25,光和,2024-04-26,6380
2405,輔信,25,0,25,光和,2024-04-26,6380
2515,中工,78,54,24,光和,2024-04-26,6380
2359,所羅門,27,6,21,光和,2024-04-26,6380
00751B,元大AAA至A公司債,20,0,20,光和,2024-04-26,6380
00795B,中信美國公債20年,20,0,20,光和,2024-04-26,6380
00712,復華富時不動產,20,0,20,光和,2024-04-26,6380
2897,王道銀行,20,0,20,光和,2024-04-26,6380
8096,擎亞,20,0,20,光和,2024-04-26,6380
2883,凱基金,26,6,20,光和,2024-04-26,6380
4566,時碩工業,20,2,18,光和,2024-04-26,6380
2365,昆盈,16,0,16,光和,2024-04-26,6380
2547,日勝生,19,3,16,光和,2024-04-26,6380
8936,國統,21,5,16,光和,2024-04-26,6380
1721,三晃,15,0,15,光和,2024-04-26,6380
3036,文曄,14,0,14,光和,2024-04-26,6380
2634,漢翔,16,3,13,光和,2024-04-26,6380
00687B,國泰20年美債,13,0,13,光和,2024-04-26,6380
2888,新光金,15,2,13,光和,2024-04-26,6380
5880,合庫金,12,0,12,光和,2024-04-26,6380
00939,統一台灣高息動能,12,0,12,光和,2024-04-26,6380
2641,正德,11,0,11,光和,2024-04-26,6380
6425,易發,12,1,11,光和,2024-04-26,6380
00635U,期元大S＆P黃金,10,0,10,光和,2024-04-26,6380
00680L,元大美債20正2,10,0,10,光和,2024-04-26,6380
00897,富邦基因免疫生技,10,0,10,光和,2024-04-26,6380
1760,寶齡富錦,10,0,10,光和,2024-04-26,6380
2349,錸德,10,0,10,光和,2024-04-26,6380
4716,大立,10,0,10,光和,2024-04-26,6380
4746,台耀,10,0,10,光和,2024-04-26,6380
6442,光聖,13,3,10,光和,2024-04-26,6380
2881,富邦金,12,3,9,光和,2024-04-26,6380
2363,矽統,164,33,131,光和,2024-04-29,6380
2618,長榮航,128,42,86,光和,2024-04-29,6380
6806,森崴能源,78,0,78,光和,2024-04-29,6380
00632R,元大台灣50反1,67,0,67,光和,2024-04-29,6380
00706L,期元大S＆P日圓正2,60,0,60,光和,2024-04-29,6380
2520,冠德,50,7,43,光和,2024-04-29,6380
1609,大亞,55,15,40,光和,2024-04-29,6380
2610,華航,61,22,39,光和,2024-04-29,6380
5230,雷笛克光學,36,4,32,光和,2024-04-29,6380
2515,中工,154,123,31,光和,2024-04-29,6380
00664R,國泰臺灣加權反1,30,0,30,光和,2024-04-29,6380
1440,南紡,35,7,28,光和,2024-04-29,6380
1316,上曜,37,15,22,光和,2024-04-29,6380
1618,合機,28,7,21,光和,2024-04-29,6380
2609,陽明,83,62,21,光和,2024-04-29,6380
2365,昆盈,20,0,20,光和,2024-04-29,6380
2867,三商壽,20,0,20,光和,2024-04-29,6380
6244,茂迪,19,0,19,光和,2024-04-29,6380
2374,佳能,32,14,18,光和,2024-04-29,6380
2371,大同,51,35,16,光和,2024-04-29,6380
5521,工信,29,14,15,光和,2024-04-29,6380
6215,和椿,18,3,15,光和,2024-04-29,6380
2897,王道銀行,14,0,14,光和,2024-04-29,6380
00915,凱基優選高股息30,15,2,13,光和,2024-04-29,6380
2506,太設,14,1,13,光和,2024-04-29,6380
00673R,期元大S＆P原油反1,12,0,12,光和,2024-04-29,6380
2101,南港,14,2,12,光和,2024-04-29,6380
2449,京元電子,17,5,12,光和,2024-04-29,6380
00919,群益台灣精選高息,14,3,11,光和,2024-04-29,6380
1504,東元,11,0,11,光和,2024-04-29,6380
3712,永崴投控,11,0,11,光和,2024-04-29,6380
2323,中環,18,7,11,光和,2024-04-29,6380
8930,青鋼,10,0,10,光和,2024-04-29,6380
1524,耿鼎,10,0,10,光和,2024-04-29,6380
1101,台泥,13,3,10,光和,2024-04-29,6380
00680L,元大美債20正2,10,0,10,光和,2024-04-29,6380
00897,富邦基因免疫生技,10,0,10,光和,2024-04-29,6380
1467,南緯,10,0,10,光和,2024-04-29,6380
3189,景碩,10,0,10,光和,2024-04-29,6380
3576,聯合再生,10,0,10,光和,2024-04-29,6380
3645,達邁,10,0,10,光和,2024-04-29,6380
4566,時碩工業,10,0,10,光和,2024-04-29,6380
6509,聚和,10,0,10,光和,2024-04-29,6380
8121,越峰,10,1,9,光和,2024-04-29,6380
6191,精成科,10,2,8,光和,2024-04-29,6380
8429,金麗-KY,8,0,8,光和,2024-04-29,6380
2399,映泰,7,0,7,光和,2024-04-29,6380
6274,台燿,8,1,7,光和,2024-04-29,6380
6443,元晶,7,0,7,光和,2024-04-29,6380
8110,華東,7,0,7,光和,2024-04-29,6380
1314,中石化,209,48,161,光和,2024-04-30,6380
00632R,元大台灣50反1,100,0,100,光和,2024-04-30,6380
1304,台聚,85,0,85,光和,2024-04-30,6380
1905,華紙,52,0,52,光和,2024-04-30,6380
2888,新光金,48,3,45,光和,2024-04-30,6380
5439,高技,41,0,41,光和,2024-04-30,6380
2317,鴻海,39,7,32,光和,2024-04-30,6380
2409,友達,60,30,30,光和,2024-04-30,6380
1316,上曜,33,4,29,光和,2024-04-30,6380
1609,大亞,54,30,24,光和,2024-04-30,6380
3481,群創,40,16,24,光和,2024-04-30,6380
00940,元大台灣價值高息,33,11,22,光和,2024-04-30,6380
2359,所羅門,23,1,22,光和,2024-04-30,6380
2006,東和鋼鐵,21,0,21,光和,2024-04-30,6380
2323,中環,27,6,21,光和,2024-04-30,6380
2515,中工,27,7,20,光和,2024-04-30,6380
2883,凱基金,21,2,19,光和,2024-04-30,6380
2501,國建,42,24,18,光和,2024-04-30,6380
5347,世界,18,1,17,光和,2024-04-30,6380
2609,陽明,44,27,17,光和,2024-04-30,6380
2618,長榮航,54,37,17,光和,2024-04-30,6380
0056,元大高股息,17,2,15,光和,2024-04-30,6380
6821,聯寶,15,0,15,光和,2024-04-30,6380
8011,台通,15,0,15,光和,2024-04-30,6380
6239,力成,34,20,14,光和,2024-04-30,6380
1605,華新,16,2,14,光和,2024-04-30,6380
00929,復華台灣科技優息,13,0,13,光和,2024-04-30,6380
2355,敬鵬,13,0,13,光和,2024-04-30,6380
5230,雷笛克光學,14,1,13,光和,2024-04-30,6380
2367,燿華,44,32,12,光和,2024-04-30,6380
5009,榮剛,13,1,12,光和,2024-04-30,6380
2363,矽統,66,54,12,光和,2024-04-30,6380
2547,日勝生,12,1,11,光和,2024-04-30,6380
2537,聯上發,11,0,11,光和,2024-04-30,6380
3490,單井,11,0,11,光和,2024-04-30,6380
3706,神達,11,0,11,光和,2024-04-30,6380
1217,愛之味,10,0,10,光和,2024-04-30,6380
2020,美亞,10,0,10,光和,2024-04-30,6380
2404,漢唐,10,0,10,光和,2024-04-30,6380
4716,大立,10,0,10,光和,2024-04-30,6380
5534,長虹,10,0,10,光和,2024-04-30,6380
6015,宏遠證,10,0,10,光和,2024-04-30,6380
6264,富裔,10,0,10,光和,2024-04-30,6380
8933,愛地雅,10,0,10,光和,2024-04-30,6380
6770,力積電,10,1,9,光和,2024-04-30,6380
6235,華孚,15,6,9,光和,2024-04-30,6380
2374,佳能,15,7,8,光和,2024-04-30,6380
8112,至上,10,2,8,光和,2024-04-30,6380
5531,鄉林,12,5,7,光和,2024-04-30,6380
6215,和椿,7,0,7,光和,2024-04-30,6380
00940,元大台灣價值高息,444,3,441,光和,2024-05-02,6380
00878,國泰永續高股息,91,0,91,光和,2024-05-02,6380
2409,友達,87,5,82,光和,2024-05-02,6380
2363,矽統,104,24,80,光和,2024-05-02,6380
00919,群益台灣精選高息,98,30,68,光和,2024-05-02,6380
6244,茂迪,40,0,40,光和,2024-05-02,6380
1314,中石化,117,83,34,光和,2024-05-02,6380
3481,群創,32,1,31,光和,2024-05-02,6380
5439,高技,31,0,31,光和,2024-05-02,6380
2367,燿華,34,4,30,光和,2024-05-02,6380
2542,興富發,53,24,29,光和,2024-05-02,6380
00929,復華台灣科技優息,29,0,29,光和,2024-05-02,6380
2101,南港,25,4,21,光和,2024-05-02,6380
2511,太子,21,0,21,光和,2024-05-02,6380
00632R,元大台灣50反1,20,0,20,光和,2024-05-02,6380
2514,龍邦,20,0,20,光和,2024-05-02,6380
2534,宏盛,20,0,20,光和,2024-05-02,6380
2906,高林,20,0,20,光和,2024-05-02,6380
6136,富爾特,20,0,20,光和,2024-05-02,6380
00665L,富邦�琤肭磪囓�2,20,1,19,光和,2024-05-02,6380
2353,宏��,19,0,19,光和,2024-05-02,6380
1605,華新,38,20,18,光和,2024-05-02,6380
1618,合機,21,3,18,光和,2024-05-02,6380
00937B,群益ESG投等債20,17,1,16,光和,2024-05-02,6380
2002,中鋼,17,3,14,光和,2024-05-02,6380
1440,南紡,13,0,13,光和,2024-05-02,6380
1457,宜進,13,0,13,光和,2024-05-02,6380
6015,宏遠證,13,0,13,光和,2024-05-02,6380
2609,陽明,28,16,12,光和,2024-05-02,6380
3163,波若威,13,1,12,光和,2024-05-02,6380
2330,台積電,14,2,12,光和,2024-05-02,6380
00939,統一台灣高息動能,11,0,11,光和,2024-05-02,6380
0056,元大高股息,14,3,11,光和,2024-05-02,6380
2006,東和鋼鐵,11,0,11,光和,2024-05-02,6380
2313,華通,11,0,11,光和,2024-05-02,6380
2641,正德,17,6,11,光和,2024-05-02,6380
2905,三商,11,0,11,光和,2024-05-02,6380
1737,臺鹽,10,0,10,光和,2024-05-02,6380
2451,創見,10,0,10,光和,2024-05-02,6380
2464,盟立,12,2,10,光和,2024-05-02,6380
3019,亞光,10,0,10,光和,2024-05-02,6380
5230,雷笛克光學,10,0,10,光和,2024-05-02,6380
2010,春源,10,0,10,光和,2024-05-02,6380
1909,榮成,10,0,10,光和,2024-05-02,6380
2892,第一金,11,1,10,光和,2024-05-02,6380
2605,新興,9,0,9,光和,2024-05-02,6380
3576,聯合再生,9,0,9,光和,2024-05-02,6380
2547,日勝生,11,2,9,光和,2024-05-02,6380
2401,凌陽,9,1,8,光和,2024-05-02,6380
2402,毅嘉,8,0,8,光和,2024-05-02,6380
1714,和桐,877,0,877,光和,2024-05-03,6380
5521,工信,130,17,113,光和,2024-05-03,6380
1423,利華,100,0,100,光和,2024-05-03,6380
6770,力積電,134,38,96,光和,2024-05-03,6380
1316,上曜,111,19,92,光和,2024-05-03,6380
00919,群益台灣精選高息,88,1,87,光和,2024-05-03,6380
5328,華容,75,2,73,光和,2024-05-03,6380
2891,中信金,64,9,55,光和,2024-05-03,6380
2374,佳能,49,2,47,光和,2024-05-03,6380
6257,矽格,48,2,46,光和,2024-05-03,6380
2316,楠梓電,81,37,44,光和,2024-05-03,6380
00725B,國泰投資級公司債,30,0,30,光和,2024-05-03,6380
1618,合機,39,11,28,光和,2024-05-03,6380
6264,富裔,25,0,25,光和,2024-05-03,6380
00937B,群益ESG投等債20,24,0,24,光和,2024-05-03,6380
00632R,元大台灣50反1,21,0,21,光和,2024-05-03,6380
2344,華邦電,25,4,21,光和,2024-05-03,6380
00687B,國泰20年美債,21,0,21,光和,2024-05-03,6380
2356,英業達,21,1,20,光和,2024-05-03,6380
00665L,富邦�琤肭磪囓�2,20,0,20,光和,2024-05-03,6380
00664R,國泰臺灣加權反1,20,0,20,光和,2024-05-03,6380
1457,宜進,20,0,20,光和,2024-05-03,6380
1101,台泥,21,2,19,光和,2024-05-03,6380
2371,大同,40,21,19,光和,2024-05-03,6380
6120,達運,20,1,19,光和,2024-05-03,6380
1711,永光,16,0,16,光和,2024-05-03,6380
3221,台嘉碩,16,1,15,光和,2024-05-03,6380
2867,三商壽,14,0,14,光和,2024-05-03,6380
2906,高林,14,0,14,光和,2024-05-03,6380
3231,緯創,22,9,13,光和,2024-05-03,6380
1514,亞力,23,10,13,光和,2024-05-03,6380
2009,第一銅,16,3,13,光和,2024-05-03,6380
00878,國泰永續高股息,18,6,12,光和,2024-05-03,6380
1402,遠東新,12,0,12,光和,2024-05-03,6380
4714,永捷,28,16,12,光和,2024-05-03,6380
6016,康和證,12,0,12,光和,2024-05-03,6380
1905,華紙,11,0,11,光和,2024-05-03,6380
1314,中石化,35,24,11,光和,2024-05-03,6380
2630,亞航,11,0,11,光和,2024-05-03,6380
5531,鄉林,13,2,11,光和,2024-05-03,6380
2383,台光電,12,1,11,光和,2024-05-03,6380
00933B,國泰10Y+金融債,10,0,10,光和,2024-05-03,6380
1529,樂事綠能,10,0,10,光和,2024-05-03,6380
2427,三商電,13,3,10,光和,2024-05-03,6380
2534,宏盛,10,0,10,光和,2024-05-03,6380
3027,盛達,10,0,10,光和,2024-05-03,6380
4976,佳凌,10,0,10,光和,2024-05-03,6380
5347,世界,11,1,10,光和,2024-05-03,6380
5439,高技,11,1,10,光和,2024-05-03,6380
2609,陽明,41,32,9,光和,2024-05-03,6380
1714,和桐,506,0,506,光和,2024-05-06,6380
2501,國建,137,12,125,光和,2024-05-06,6380
00929,復華台灣科技優息,99,0,99,光和,2024-05-06,6380
2409,友達,103,5,98,光和,2024-05-06,6380
8011,台通,84,15,69,光和,2024-05-06,6380
3706,神達,76,13,63,光和,2024-05-06,6380
1304,台聚,50,0,50,光和,2024-05-06,6380
2618,長榮航,68,25,43,光和,2024-05-06,6380
2883,凱基金,44,5,39,光和,2024-05-06,6380
00878,國泰永續高股息,46,9,37,光和,2024-05-06,6380
6257,矽格,35,2,33,光和,2024-05-06,6380
2349,錸德,32,0,32,光和,2024-05-06,6380
1584,精剛,30,2,28,光和,2024-05-06,6380
00940,元大台灣價值高息,32,5,27,光和,2024-05-06,6380
00632R,元大台灣50反1,23,0,23,光和,2024-05-06,6380
4303,信立,22,0,22,光和,2024-05-06,6380
2449,京元電子,28,6,22,光和,2024-05-06,6380
2006,東和鋼鐵,21,0,21,光和,2024-05-06,6380
00637L,元大滬深300正2,20,0,20,光和,2024-05-06,6380
2204,中華,20,0,20,光和,2024-05-06,6380
4108,懷特,20,0,20,光和,2024-05-06,6380
5521,工信,92,72,20,光和,2024-05-06,6380
2371,大同,44,26,18,光和,2024-05-06,6380
2352,佳世達,19,1,18,光和,2024-05-06,6380
9933,中鼎,20,3,17,光和,2024-05-06,6380
2905,三商,15,0,15,光和,2024-05-06,6380
3038,全台,15,0,15,光和,2024-05-06,6380
6451,訊芯-KY,24,9,15,光和,2024-05-06,6380
2313,華通,24,10,14,光和,2024-05-06,6380
6770,力積電,30,16,14,光和,2024-05-06,6380
1815,富喬,15,2,13,光和,2024-05-06,6380
2543,皇昌,16,3,13,光和,2024-05-06,6380
2201,裕隆,12,0,12,光和,2024-05-06,6380
2464,盟立,11,0,11,光和,2024-05-06,6380
3234,光環,12,1,11,光和,2024-05-06,6380
5498,凱崴,11,0,11,光和,2024-05-06,6380
5534,長虹,11,0,11,光和,2024-05-06,6380
3231,緯創,21,10,11,光和,2024-05-06,6380
4306,炎洲,31,20,11,光和,2024-05-06,6380
00664R,國泰臺灣加權反1,10,0,10,光和,2024-05-06,6380
00937B,群益ESG投等債20,10,0,10,光和,2024-05-06,6380
2323,中環,22,12,10,光和,2024-05-06,6380
2739,寒舍,13,3,10,光和,2024-05-06,6380
3712,永崴投控,10,0,10,光和,2024-05-06,6380
5386,青雲,10,0,10,光和,2024-05-06,6380
6669,緯穎,10,0,10,光和,2024-05-06,6380
1618,合機,15,6,9,光和,2024-05-06,6380
1326,台化,10,1,9,光和,2024-05-06,6380
3030,德律,12,3,9,光和,2024-05-06,6380
1314,中石化,31,23,8,光和,2024-05-06,6380
1714,和桐,869,1,868,光和,2024-05-07,6380
00878,國泰永續高股息,178,9,169,光和,2024-05-07,6380
2889,國票金,177,8,169,光和,2024-05-07,6380
2888,新光金,122,39,83,光和,2024-05-07,6380
2515,中工,80,13,67,光和,2024-05-07,6380
3703,欣陸,68,2,66,光和,2024-05-07,6380
00725B,國泰投資級公司債,55,0,55,光和,2024-05-07,6380
00929,復華台灣科技優息,64,10,54,光和,2024-05-07,6380
4306,炎洲,43,0,43,光和,2024-05-07,6380
5512,力麒,41,0,41,光和,2024-05-07,6380
2409,友達,41,1,40,光和,2024-05-07,6380
8936,國統,65,25,40,光和,2024-05-07,6380
1304,台聚,39,0,39,光和,2024-05-07,6380
00940,元大台灣價值高息,39,0,39,光和,2024-05-07,6380
1316,上曜,37,0,37,光和,2024-05-07,6380
00720B,元大投資級公司債,35,1,34,光和,2024-05-07,6380
2601,益航,30,0,30,光和,2024-05-07,6380
2020,美亞,27,0,27,光和,2024-05-07,6380
1608,華榮,52,25,27,光和,2024-05-07,6380
00939,統一台灣高息動能,25,2,23,光和,2024-05-07,6380
00919,群益台灣精選高息,23,3,20,光和,2024-05-07,6380
1605,華新,55,35,20,光和,2024-05-07,6380
6177,達麗,20,0,20,光和,2024-05-07,6380
9945,潤泰新,29,11,18,光和,2024-05-07,6380
2367,燿華,27,9,18,光和,2024-05-07,6380
2883,凱基金,29,11,18,光和,2024-05-07,6380
00680L,元大美債20正2,20,3,17,光和,2024-05-07,6380
2344,華邦電,20,3,17,光和,2024-05-07,6380
2362,藍天,22,5,17,光和,2024-05-07,6380
2025,千興,15,0,15,光和,2024-05-07,6380
8033,雷虎,17,3,14,光和,2024-05-07,6380
6005,群益證,24,10,14,光和,2024-05-07,6380
1905,華紙,14,0,14,光和,2024-05-07,6380
6284,佳邦,16,2,14,光和,2024-05-07,6380
2349,錸德,22,9,13,光和,2024-05-07,6380
3033,威健,17,4,13,光和,2024-05-07,6380
1609,大亞,31,18,13,光和,2024-05-07,6380
6531,愛普*,12,0,12,光和,2024-05-07,6380
2527,宏璟,11,0,11,光和,2024-05-07,6380
4976,佳凌,11,0,11,光和,2024-05-07,6380
00665L,富邦�琤肭磪囓�2,10,0,10,光和,2024-05-07,6380
00753L,中信中國50正2,20,10,10,光和,2024-05-07,6380
1467,南緯,10,0,10,光和,2024-05-07,6380
2023,燁輝,10,0,10,光和,2024-05-07,6380
2061,風青,11,1,10,光和,2024-05-07,6380
2486,一詮,31,21,10,光和,2024-05-07,6380
2530,華建,10,0,10,光和,2024-05-07,6380
6290,良維,15,5,10,光和,2024-05-07,6380
8299,群聯,10,0,10,光和,2024-05-07,6380
8933,愛地雅,10,0,10,光和,2024-05-07,6380
00632R,元大台灣50反1,410,0,410,光和,2024-05-08,6380
2609,陽明,157,62,95,光和,2024-05-08,6380
00919,群益台灣精選高息,96,2,94,光和,2024-05-08,6380
5014,建錩,58,0,58,光和,2024-05-08,6380
1815,富喬,105,50,55,光和,2024-05-08,6380
00885,富邦越南,50,0,50,光和,2024-05-08,6380
4306,炎洲,43,0,43,光和,2024-05-08,6380
6016,康和證,41,0,41,光和,2024-05-08,6380
2316,楠梓電,41,2,39,光和,2024-05-08,6380
2618,長榮航,68,33,35,光和,2024-05-08,6380
2606,裕民,36,3,33,光和,2024-05-08,6380
6005,群益證,30,1,29,光和,2024-05-08,6380
1101,台泥,34,5,29,光和,2024-05-08,6380
2641,正德,31,2,29,光和,2024-05-08,6380
3036,文曄,28,0,28,光和,2024-05-08,6380
00878,國泰永續高股息,31,4,27,光和,2024-05-08,6380
2374,佳能,55,29,26,光和,2024-05-08,6380
9945,潤泰新,32,7,25,光和,2024-05-08,6380
00940,元大台灣價值高息,25,2,23,光和,2024-05-08,6380
2605,新興,67,45,22,光和,2024-05-08,6380
6015,宏遠證,22,0,22,光和,2024-05-08,6380
1609,大亞,38,17,21,光和,2024-05-08,6380
00637L,元大滬深300正2,41,20,21,光和,2024-05-08,6380
4528,江興鍛,20,0,20,光和,2024-05-08,6380
4915,致伸,20,0,20,光和,2024-05-08,6380
8150,南茂,20,0,20,光和,2024-05-08,6380
00937B,群益ESG投等債20,19,0,19,光和,2024-05-08,6380
2421,建準,20,1,19,光和,2024-05-08,6380
00929,復華台灣科技優息,18,2,16,光和,2024-05-08,6380
2359,所羅門,20,4,16,光和,2024-05-08,6380
2603,長榮,19,3,16,光和,2024-05-08,6380
2376,技嘉,19,4,15,光和,2024-05-08,6380
2020,美亞,15,0,15,光和,2024-05-08,6380
2739,寒舍,16,1,15,光和,2024-05-08,6380
5512,力麒,16,1,15,光和,2024-05-08,6380
5880,合庫金,15,0,15,光和,2024-05-08,6380
1504,東元,17,3,14,光和,2024-05-08,6380
2329,華泰,15,1,14,光和,2024-05-08,6380
5608,四維航,13,0,13,光和,2024-05-08,6380
2303,聯電,16,3,13,光和,2024-05-08,6380
00882,中信中國高股息,32,20,12,光和,2024-05-08,6380
2913,農林,12,0,12,光和,2024-05-08,6380
4967,十銓,15,3,12,光和,2024-05-08,6380
5498,凱崴,14,2,12,光和,2024-05-08,6380
5871,中租-KY,12,1,11,光和,2024-05-08,6380
2547,日勝生,11,0,11,光和,2024-05-08,6380
2204,中華,11,0,11,光和,2024-05-08,6380
2317,鴻海,20,10,10,光和,2024-05-08,6380
00664R,國泰臺灣加權反1,10,0,10,光和,2024-05-08,6380
2331,精英,10,0,10,光和,2024-05-08,6380
4960,誠美材,506,44,462,光和,2024-05-09,6380
2888,新光金,202,83,119,光和,2024-05-09,6380
5347,世界,102,0,102,光和,2024-05-09,6380
2408,南亞科,87,0,87,光和,2024-05-09,6380
00937B,群益ESG投等債20,78,0,78,光和,2024-05-09,6380
5521,工信,70,3,67,光和,2024-05-09,6380
1605,華新,84,24,60,光和,2024-05-09,6380
1714,和桐,87,27,60,光和,2024-05-09,6380
5014,建錩,52,0,52,光和,2024-05-09,6380
00929,復華台灣科技優息,47,0,47,光和,2024-05-09,6380
00940,元大台灣價值高息,46,0,46,光和,2024-05-09,6380
6125,廣運,42,0,42,光和,2024-05-09,6380
1210,大成,40,0,40,光和,2024-05-09,6380
6016,康和證,40,0,40,光和,2024-05-09,6380
00944,野村趨勢動能高息,38,0,38,光和,2024-05-09,6380
2371,大同,43,5,38,光和,2024-05-09,6380
2618,長榮航,137,102,35,光和,2024-05-09,6380
00946,群益科技高息成長,35,0,35,光和,2024-05-09,6380
1314,中石化,36,2,34,光和,2024-05-09,6380
00878,國泰永續高股息,45,11,34,光和,2024-05-09,6380
3036,文曄,39,6,33,光和,2024-05-09,6380
1815,富喬,46,14,32,光和,2024-05-09,6380
2489,瑞軒,38,8,30,光和,2024-05-09,6380
2303,聯電,32,2,30,光和,2024-05-09,6380
2515,中工,30,2,28,光和,2024-05-09,6380
2344,華邦電,26,0,26,光和,2024-05-09,6380
2801,彰銀,25,0,25,光和,2024-05-09,6380
1609,大亞,46,24,22,光和,2024-05-09,6380
3041,揚智,31,11,20,光和,2024-05-09,6380
5512,力麒,20,0,20,光和,2024-05-09,6380
4967,十銓,19,1,18,光和,2024-05-09,6380
1313,聯成,16,0,16,光和,2024-05-09,6380
2605,新興,27,11,16,光和,2024-05-09,6380
8936,國統,41,26,15,光和,2024-05-09,6380
1304,台聚,14,0,14,光和,2024-05-09,6380
2359,所羅門,15,1,14,光和,2024-05-09,6380
2834,臺企銀,13,0,13,光和,2024-05-09,6380
3231,緯創,21,8,13,光和,2024-05-09,6380
1615,大山,12,0,12,光和,2024-05-09,6380
00933B,國泰10Y+金融債,11,0,11,光和,2024-05-09,6380
2331,精英,11,0,11,光和,2024-05-09,6380
2405,輔信,13,2,11,光和,2024-05-09,6380
3027,盛達,11,0,11,光和,2024-05-09,6380
3321,同泰,11,0,11,光和,2024-05-09,6380
6015,宏遠證,11,0,11,光和,2024-05-09,6380
6712,長聖,12,1,11,光和,2024-05-09,6380
8112,至上,11,0,11,光和,2024-05-09,6380
00740B,富邦全球投等債,10,0,10,光和,2024-05-09,6380
2010,春源,10,0,10,光和,2024-05-09,6380
2316,楠梓電,10,0,10,光和,2024-05-09,6380
4960,誠美材,1037,18,1019,光和,2024-05-10,6380
5608,四維航,162,1,161,光和,2024-05-10,6380
00929,復華台灣科技優息,143,10,133,光和,2024-05-10,6380
1609,大亞,119,37,82,光和,2024-05-10,6380
00919,群益台灣精選高息,85,10,75,光和,2024-05-10,6380
1313,聯成,62,0,62,光和,2024-05-10,6380
2610,華航,139,89,50,光和,2024-05-10,6380
1307,三芳,50,0,50,光和,2024-05-10,6380
2882,國泰金,74,25,49,光和,2024-05-10,6380
00946,群益科技高息成長,43,0,43,光和,2024-05-10,6380
00937B,群益ESG投等債20,45,5,40,光和,2024-05-10,6380
4306,炎洲,40,0,40,光和,2024-05-10,6380
2020,美亞,36,0,36,光和,2024-05-10,6380
2323,中環,35,0,35,光和,2024-05-10,6380
8936,國統,73,40,33,光和,2024-05-10,6380
00712,復華富時不動產,30,0,30,光和,2024-05-10,6380
2344,華邦電,40,12,28,光和,2024-05-10,6380
2313,華通,35,10,25,光和,2024-05-10,6380
2363,矽統,50,25,25,光和,2024-05-10,6380
00665L,富邦�琤肭磪囓�2,30,6,24,光和,2024-05-10,6380
8150,南茂,23,0,23,光和,2024-05-10,6380
3686,達能,21,0,21,光和,2024-05-10,6380
2601,益航,31,11,20,光和,2024-05-10,6380
5521,工信,21,2,19,光和,2024-05-10,6380
2888,新光金,40,23,17,光和,2024-05-10,6380
00680L,元大美債20正2,20,4,16,光和,2024-05-10,6380
00903,富邦元宇宙,15,0,15,光和,2024-05-10,6380
1785,光洋科,15,0,15,光和,2024-05-10,6380
2349,錸德,15,0,15,光和,2024-05-10,6380
2409,友達,24,9,15,光和,2024-05-10,6380
2303,聯電,20,6,14,光和,2024-05-10,6380
1714,和桐,25,11,14,光和,2024-05-10,6380
1815,富喬,33,19,14,光和,2024-05-10,6380
6026,福邦證,13,0,13,光和,2024-05-10,6380
2486,一詮,17,4,13,光和,2024-05-10,6380
3090,日電貿,12,0,12,光和,2024-05-10,6380
4967,十銓,15,3,12,光和,2024-05-10,6380
00850,元大臺灣ESG永續,11,0,11,光和,2024-05-10,6380
2457,飛宏,11,0,11,光和,2024-05-10,6380
3033,威健,14,3,11,光和,2024-05-10,6380
3036,文曄,14,3,11,光和,2024-05-10,6380
6163,華電網,11,0,11,光和,2024-05-10,6380
00939,統一台灣高息動能,10,0,10,光和,2024-05-10,6380
2371,大同,14,4,10,光和,2024-05-10,6380
2476,鉅祥,10,0,10,光和,2024-05-10,6380
2547,日勝生,10,0,10,光和,2024-05-10,6380
2739,寒舍,10,0,10,光和,2024-05-10,6380
2762,世界健身-KY,10,0,10,光和,2024-05-10,6380
3623,富晶通,10,0,10,光和,2024-05-10,6380
6270,倍微,10,0,10,光和,2024-05-10,6380
1609,大亞,199,7,192,光和,2024-05-13,6380
00929,復華台灣科技優息,128,0,128,光和,2024-05-13,6380
00637L,元大滬深300正2,107,0,107,光和,2024-05-13,6380
00878,國泰永續高股息,101,13,88,光和,2024-05-13,6380
2618,長榮航,79,29,50,光和,2024-05-13,6380
2439,美律,44,0,44,光和,2024-05-13,6380
2392,正崴,56,14,42,光和,2024-05-13,6380
6125,廣運,45,10,35,光和,2024-05-13,6380
3231,緯創,41,7,34,光和,2024-05-13,6380
00725B,國泰投資級公司債,29,0,29,光和,2024-05-13,6380
4306,炎洲,26,0,26,光和,2024-05-13,6380
2362,藍天,26,5,21,光和,2024-05-13,6380
00665L,富邦�琤肭磪囓�2,30,10,20,光和,2024-05-13,6380
00932,兆豐永續高息等權,20,0,20,光和,2024-05-13,6380
2409,友達,20,0,20,光和,2024-05-13,6380
2641,正德,58,38,20,光和,2024-05-13,6380
2812,台中銀,20,0,20,光和,2024-05-13,6380
2615,萬海,36,17,19,光和,2024-05-13,6380
2301,光寶科,19,1,18,光和,2024-05-13,6380
6462,神盾,18,0,18,光和,2024-05-13,6380
00937B,群益ESG投等債20,26,10,16,光和,2024-05-13,6380
1618,合機,19,4,15,光和,2024-05-13,6380
3260,威剛,16,1,15,光和,2024-05-13,6380
4551,智伸科,15,0,15,光和,2024-05-13,6380
00720B,元大投資級公司債,14,0,14,光和,2024-05-13,6380
00632R,元大台灣50反1,16,2,14,光和,2024-05-13,6380
00687B,國泰20年美債,14,0,14,光和,2024-05-13,6380
6191,精成科,13,0,13,光和,2024-05-13,6380
3013,晟銘電,15,3,12,光和,2024-05-13,6380
8234,新漢,12,0,12,光和,2024-05-13,6380
2609,陽明,58,47,11,光和,2024-05-13,6380
2545,皇翔,11,0,11,光和,2024-05-13,6380
2317,鴻海,21,10,11,光和,2024-05-13,6380
2891,中信金,11,0,11,光和,2024-05-13,6380
6112,邁達特,10,0,10,光和,2024-05-13,6380
6789,采鈺,10,0,10,光和,2024-05-13,6380
00664R,國泰臺灣加權反1,10,0,10,光和,2024-05-13,6380
00931B,統一美債20年,10,0,10,光和,2024-05-13,6380
2002,中鋼,10,0,10,光和,2024-05-13,6380
2312,金寶,10,0,10,光和,2024-05-13,6380
2468,華經,10,0,10,光和,2024-05-13,6380
2801,彰銀,10,0,10,光和,2024-05-13,6380
2905,三商,9,0,9,光和,2024-05-13,6380
2241,艾姆勒,9,0,9,光和,2024-05-13,6380
2329,華泰,10,2,8,光和,2024-05-13,6380
2356,英業達,12,4,8,光和,2024-05-13,6380
6156,松上,8,0,8,光和,2024-05-13,6380
1314,中石化,10,2,8,光和,2024-05-13,6380
1227,佳格,7,0,7,光和,2024-05-13,6380
1319,東陽,8,1,7,光和,2024-05-13,6380
5521,工信,212,0,212,光和,2024-05-14,6380
00632R,元大台灣50反1,210,2,208,光和,2024-05-14,6380
00937B,群益ESG投等債20,158,0,158,光和,2024-05-14,6380
1504,東元,150,0,150,光和,2024-05-14,6380
1609,大亞,132,8,124,光和,2024-05-14,6380
2406,國碩,162,69,93,光和,2024-05-14,6380
00929,復華台灣科技優息,70,2,68,光和,2024-05-14,6380
2365,昆盈,56,0,56,光和,2024-05-14,6380
1101,台泥,46,0,46,光和,2024-05-14,6380
2615,萬海,183,146,37,光和,2024-05-14,6380
00919,群益台灣精選高息,87,51,36,光和,2024-05-14,6380
2867,三商壽,28,0,28,光和,2024-05-14,6380
00878,國泰永續高股息,35,9,26,光和,2024-05-14,6380
2317,鴻海,41,16,25,光和,2024-05-14,6380
2915,潤泰全,26,1,25,光和,2024-05-14,6380
1524,耿鼎,28,5,23,光和,2024-05-14,6380
2312,金寶,83,61,22,光和,2024-05-14,6380
1605,華新,25,4,21,光和,2024-05-14,6380
2405,輔信,30,9,21,光和,2024-05-14,6380
00885,富邦越南,20,0,20,光和,2024-05-14,6380
2027,大成鋼,20,1,19,光和,2024-05-14,6380
4961,天鈺,20,1,19,光和,2024-05-14,6380
2316,楠梓電,48,30,18,光和,2024-05-14,6380
00933B,國泰10Y+金融債,16,0,16,光和,2024-05-14,6380
2353,宏��,34,19,15,光和,2024-05-14,6380
1615,大山,15,0,15,光和,2024-05-14,6380
2352,佳世達,14,0,14,光和,2024-05-14,6380
2547,日勝生,13,0,13,光和,2024-05-14,6380
2206,三陽工業,12,0,12,光和,2024-05-14,6380
6823,濾能,12,0,12,光和,2024-05-14,6380
00679B,元大美債20年,11,0,11,光和,2024-05-14,6380
2891,中信金,17,6,11,光和,2024-05-14,6380
2913,農林,11,0,11,光和,2024-05-14,6380
3006,晶豪科,15,4,11,光和,2024-05-14,6380
6015,宏遠證,11,0,11,光和,2024-05-14,6380
00725B,國泰投資級公司債,10,0,10,光和,2024-05-14,6380
00664R,國泰臺灣加權反1,10,0,10,光和,2024-05-14,6380
00650L,復華香港正2,10,0,10,光和,2024-05-14,6380
2349,錸德,10,0,10,光和,2024-05-14,6380
3666,光耀,10,0,10,光和,2024-05-14,6380
6770,力積電,13,4,9,光和,2024-05-14,6380
2834,臺企銀,11,2,9,光和,2024-05-14,6380
9945,潤泰新,16,7,9,光和,2024-05-14,6380
2324,仁寶,72,64,8,光和,2024-05-14,6380
2460,建通,8,0,8,光和,2024-05-14,6380
2905,三商,8,0,8,光和,2024-05-14,6380
2892,第一金,8,0,8,光和,2024-05-14,6380
2359,所羅門,12,5,7,光和,2024-05-14,6380
00637L,元大滬深300正2,7,0,7,光和,2024-05-14,6380
1527,鑽全,7,0,7,光和,2024-05-14,6380
00632R,元大台灣50反1,181,0,181,光和,2024-05-15,6380
00937B,群益ESG投等債20,144,0,144,光和,2024-05-15,6380
00940,元大台灣價值高息,111,13,98,光和,2024-05-15,6380
2356,英業達,129,41,88,光和,2024-05-15,6380
00919,群益台灣精選高息,89,4,85,光和,2024-05-15,6380
00929,復華台灣科技優息,76,17,59,光和,2024-05-15,6380
3481,群創,52,0,52,光和,2024-05-15,6380
3356,奇偶,50,0,50,光和,2024-05-15,6380
2349,錸德,69,25,44,光和,2024-05-15,6380
6125,廣運,51,11,40,光和,2024-05-15,6380
2353,宏��,127,88,39,光和,2024-05-15,6380
2449,京元電子,38,0,38,光和,2024-05-15,6380
1718,中纖,42,6,36,光和,2024-05-15,6380
1605,華新,45,11,34,光和,2024-05-15,6380
6257,矽格,37,7,30,光和,2024-05-15,6380
2363,矽統,48,20,28,光和,2024-05-15,6380
2547,日勝生,28,0,28,光和,2024-05-15,6380
2801,彰銀,30,3,27,光和,2024-05-15,6380
1711,永光,26,0,26,光和,2024-05-15,6380
2618,長榮航,41,17,24,光和,2024-05-15,6380
1301,台塑,27,6,21,光和,2024-05-15,6380
00933B,國泰10Y+金融債,20,0,20,光和,2024-05-15,6380
6213,聯茂,20,0,20,光和,2024-05-15,6380
1312,國喬,28,9,19,光和,2024-05-15,6380
6531,愛普*,19,1,18,光和,2024-05-15,6380
6770,力積電,27,9,18,光和,2024-05-15,6380
2603,長榮,33,17,16,光和,2024-05-15,6380
00637L,元大滬深300正2,16,0,16,光和,2024-05-15,6380
5309,系統電,16,0,16,光和,2024-05-15,6380
2324,仁寶,78,63,15,光和,2024-05-15,6380
3038,全台,15,0,15,光和,2024-05-15,6380
3047,訊舟,31,16,15,光和,2024-05-15,6380
1609,大亞,26,12,14,光和,2024-05-15,6380
3689,湧德,59,45,14,光和,2024-05-15,6380
2406,國碩,14,1,13,光和,2024-05-15,6380
6116,彩晶,21,8,13,光和,2024-05-15,6380
2352,佳世達,12,0,12,光和,2024-05-15,6380
4711,永純,12,0,12,光和,2024-05-15,6380
2331,精英,25,13,12,光和,2024-05-15,6380
2630,亞航,16,5,11,光和,2024-05-15,6380
00664R,國泰臺灣加權反1,10,0,10,光和,2024-05-15,6380
1316,上曜,11,1,10,光和,2024-05-15,6380
1710,東聯,10,0,10,光和,2024-05-15,6380
2371,大同,31,21,10,光和,2024-05-15,6380
2855,統一證,10,0,10,光和,2024-05-15,6380
3494,誠研,10,0,10,光和,2024-05-15,6380
3576,聯合再生,13,3,10,光和,2024-05-15,6380
4558,寶緯,10,0,10,光和,2024-05-15,6380
6187,萬潤,10,0,10,光和,2024-05-15,6380
00679B,元大美債20年,10,1,9,光和,2024-05-15,6380
00637L,元大滬深300正2,250,0,250,光和,2024-05-16,6380
00929,復華台灣科技優息,275,42,233,光和,2024-05-16,6380
9945,潤泰新,93,21,72,光和,2024-05-16,6380
2352,佳世達,62,2,60,光和,2024-05-16,6380
00632R,元大台灣50反1,50,0,50,光和,2024-05-16,6380
1444,力麗,30,0,30,光和,2024-05-16,6380
4960,誠美材,30,0,30,光和,2024-05-16,6380
2915,潤泰全,30,2,28,光和,2024-05-16,6380
6015,宏遠證,27,0,27,光和,2024-05-16,6380
8096,擎亞,29,5,24,光和,2024-05-16,6380
2367,燿華,68,44,24,光和,2024-05-16,6380
2363,矽統,56,35,21,光和,2024-05-16,6380
2323,中環,24,3,21,光和,2024-05-16,6380
00945B,凱基美國非投等債,20,0,20,光和,2024-05-16,6380
00857B,永豐20年美公債,21,1,20,光和,2024-05-16,6380
1464,得力,20,0,20,光和,2024-05-16,6380
6125,廣運,28,9,19,光和,2024-05-16,6380
2382,廣達,26,9,17,光和,2024-05-16,6380
1711,永光,19,2,17,光和,2024-05-16,6380
8234,新漢,17,0,17,光和,2024-05-16,6380
3694,海華,18,2,16,光和,2024-05-16,6380
3231,緯創,22,8,14,光和,2024-05-16,6380
3060,銘異,16,2,14,光和,2024-05-16,6380
3530,晶相光,13,0,13,光和,2024-05-16,6380
3623,富晶通,13,0,13,光和,2024-05-16,6380
6167,久正,13,0,13,光和,2024-05-16,6380
5443,均豪,15,3,12,光和,2024-05-16,6380
00878,國泰永續高股息,132,121,11,光和,2024-05-16,6380
2312,金寶,147,136,11,光和,2024-05-16,6380
5392,能率,14,3,11,光和,2024-05-16,6380
6233,旺玖,13,2,11,光和,2024-05-16,6380
6505,台塑化,11,0,11,光和,2024-05-16,6380
2356,英業達,135,124,11,光和,2024-05-16,6380
8033,雷虎,13,3,10,光和,2024-05-16,6380
00664R,國泰臺灣加權反1,10,0,10,光和,2024-05-16,6380
00686R,群益臺灣加權反1,10,0,10,光和,2024-05-16,6380
2305,全友,10,0,10,光和,2024-05-16,6380
2929,淘帝-KY,10,0,10,光和,2024-05-16,6380
3294,英濟,10,0,10,光和,2024-05-16,6380
4551,智伸科,10,0,10,光和,2024-05-16,6380
6112,邁達特,10,0,10,光和,2024-05-16,6380
8064,東捷,11,1,10,光和,2024-05-16,6380
2353,宏��,13,4,9,光和,2024-05-16,6380
3036,文曄,9,0,9,光和,2024-05-16,6380
6215,和椿,11,2,9,光和,2024-05-16,6380
1319,東陽,9,0,9,光和,2024-05-16,6380
2527,宏璟,9,0,9,光和,2024-05-16,6380
2641,正德,10,1,9,光和,2024-05-16,6380
1314,中石化,20,12,8,光和,2024-05-16,6380
2020,美亞,8,0,8,光和,2024-05-16,6380
00929,復華台灣科技優息,95,1,94,光和,2024-05-17,6380
2618,長榮航,146,53,93,光和,2024-05-17,6380
00937B,群益ESG投等債20,91,17,74,光和,2024-05-17,6380
1785,光洋科,73,1,72,光和,2024-05-17,6380
6257,矽格,65,1,64,光和,2024-05-17,6380
00919,群益台灣精選高息,70,12,58,光和,2024-05-17,6380
6770,力積電,74,17,57,光和,2024-05-17,6380
00679B,元大美債20年,52,0,52,光和,2024-05-17,6380
1531,高林股,49,0,49,光和,2024-05-17,6380
2515,中工,66,19,47,光和,2024-05-17,6380
3706,神達,43,0,43,光和,2024-05-17,6380
2408,南亞科,40,2,38,光和,2024-05-17,6380
2352,佳世達,50,12,38,光和,2024-05-17,6380
2316,楠梓電,37,0,37,光和,2024-05-17,6380
2020,美亞,35,0,35,光和,2024-05-17,6380
00878,國泰永續高股息,39,7,32,光和,2024-05-17,6380
2204,中華,27,0,27,光和,2024-05-17,6380
2317,鴻海,50,25,25,光和,2024-05-17,6380
1101,台泥,58,36,22,光和,2024-05-17,6380
1447,力鵬,21,1,20,光和,2024-05-17,6380
2439,美律,21,1,20,光和,2024-05-17,6380
1618,合機,23,4,19,光和,2024-05-17,6380
6589,台康生技,19,0,19,光和,2024-05-17,6380
3338,泰碩,18,0,18,光和,2024-05-17,6380
6015,宏遠證,17,0,17,光和,2024-05-17,6380
6207,雷科,23,6,17,光和,2024-05-17,6380
2337,旺宏,20,4,16,光和,2024-05-17,6380
6161,捷波,15,0,15,光和,2024-05-17,6380
00850,元大臺灣ESG永續,14,0,14,光和,2024-05-17,6380
9924,福興,14,0,14,光和,2024-05-17,6380
2417,圓剛,14,1,13,光和,2024-05-17,6380
2331,精英,13,1,12,光和,2024-05-17,6380
2409,友達,13,1,12,光和,2024-05-17,6380
2537,聯上發,12,0,12,光和,2024-05-17,6380
2062,橋椿,18,7,11,光和,2024-05-17,6380
2606,裕民,11,0,11,光和,2024-05-17,6380
8163,達方,15,4,11,光和,2024-05-17,6380
1402,遠東新,10,0,10,光和,2024-05-17,6380
3047,訊舟,17,7,10,光和,2024-05-17,6380
3372,典範,10,0,10,光和,2024-05-17,6380
8240,華宏,10,0,10,光和,2024-05-17,6380
3265,台星科,10,1,9,光和,2024-05-17,6380
2312,金寶,98,89,9,光和,2024-05-17,6380
1608,華榮,19,10,9,光和,2024-05-17,6380
2745,五福,8,0,8,光和,2024-05-17,6380
2301,光寶科,9,2,7,光和,2024-05-17,6380
2915,潤泰全,7,0,7,光和,2024-05-17,6380
6425,易發,7,0,7,光和,2024-05-17,6380
3264,欣銓,7,0,7,光和,2024-05-17,6380
2472,立隆電,6,0,6,光和,2024-05-17,6380
00929,復華台灣科技優息,168,7,161,光和,2024-05-20,6380
00679B,元大美債20年,74,0,74,光和,2024-05-20,6380
2610,華航,141,71,70,光和,2024-05-20,6380
2618,長榮航,88,19,69,光和,2024-05-20,6380
2515,中工,65,1,64,光和,2024-05-20,6380
3689,湧德,73,14,59,光和,2024-05-20,6380
2314,台揚,52,4,48,光和,2024-05-20,6380
3294,英濟,46,0,46,光和,2024-05-20,6380
3313,斐成,41,0,41,光和,2024-05-20,6380
2367,燿華,92,52,40,光和,2024-05-20,6380
2881,富邦金,31,0,31,光和,2024-05-20,6380
2867,三商壽,154,124,30,光和,2024-05-20,6380
6176,瑞儀,30,0,30,光和,2024-05-20,6380
2913,農林,32,2,30,光和,2024-05-20,6380
4109,加捷生醫,30,0,30,光和,2024-05-20,6380
6116,彩晶,27,2,25,光和,2024-05-20,6380
2905,三商,24,0,24,光和,2024-05-20,6380
00850,元大臺灣ESG永續,23,0,23,光和,2024-05-20,6380
6125,廣運,37,17,20,光和,2024-05-20,6380
6163,華電網,20,0,20,光和,2024-05-20,6380
6264,富裔,20,0,20,光和,2024-05-20,6380
8071,能率網通,24,4,20,光和,2024-05-20,6380
1616,億泰,21,2,19,光和,2024-05-20,6380
2834,臺企銀,22,4,18,光和,2024-05-20,6380
2363,矽統,39,22,17,光和,2024-05-20,6380
00937B,群益ESG投等債20,17,0,17,光和,2024-05-20,6380
2317,鴻海,21,4,17,光和,2024-05-20,6380
2634,漢翔,36,20,16,光和,2024-05-20,6380
6126,信音,17,1,16,光和,2024-05-20,6380
6425,易發,22,6,16,光和,2024-05-20,6380
3231,緯創,26,11,15,光和,2024-05-20,6380
00919,群益台灣精選高息,21,7,14,光和,2024-05-20,6380
2312,金寶,31,17,14,光和,2024-05-20,6380
5452,佶優,13,0,13,光和,2024-05-20,6380
2641,正德,11,0,11,光和,2024-05-20,6380
00931B,統一美債20年,11,0,11,光和,2024-05-20,6380
1711,永光,11,0,11,光和,2024-05-20,6380
4533,協易機,28,17,11,光和,2024-05-20,6380
1529,樂事綠能,11,1,10,光和,2024-05-20,6380
2028,威致,10,0,10,光和,2024-05-20,6380
2915,潤泰全,11,1,10,光和,2024-05-20,6380
5351,鈺創,12,2,10,光和,2024-05-20,6380
6209,今國光,10,0,10,光和,2024-05-20,6380
6477,安集,10,0,10,光和,2024-05-20,6380
4108,懷特,10,0,10,光和,2024-05-20,6380
4571,鈞興-KY,10,0,10,光和,2024-05-20,6380
2439,美律,9,0,9,光和,2024-05-20,6380
6016,康和證,9,0,9,光和,2024-05-20,6380
00915,凱基優選高股息30,9,1,8,光和,2024-05-20,6380
1316,上曜,8,0,8,光和,2024-05-20,6380
00637L,元大滬深300正2,300,10,290,光和,2024-05-21,6380
1605,華新,266,20,246,光和,2024-05-21,6380
5521,工信,200,5,195,光和,2024-05-21,6380
00919,群益台灣精選高息,68,0,68,光和,2024-05-21,6380
1304,台聚,65,0,65,光和,2024-05-21,6380
1815,富喬,110,45,65,光和,2024-05-21,6380
00929,復華台灣科技優息,62,0,62,光和,2024-05-21,6380
2618,長榮航,72,14,58,光和,2024-05-21,6380
6126,信音,53,0,53,光和,2024-05-21,6380
2515,中工,63,11,52,光和,2024-05-21,6380
6016,康和證,50,0,50,光和,2024-05-21,6380
00679B,元大美債20年,48,0,48,光和,2024-05-21,6380
2374,佳能,51,6,45,光和,2024-05-21,6380
2881,富邦金,46,8,38,光和,2024-05-21,6380
1612,宏泰,39,1,38,光和,2024-05-21,6380
2367,燿華,95,58,37,光和,2024-05-21,6380
00878,國泰永續高股息,57,21,36,光和,2024-05-21,6380
2409,友達,34,0,34,光和,2024-05-21,6380
2905,三商,28,0,28,光和,2024-05-21,6380
2020,美亞,27,0,27,光和,2024-05-21,6380
6116,彩晶,22,0,22,光和,2024-05-21,6380
00937B,群益ESG投等債20,22,0,22,光和,2024-05-21,6380
8033,雷虎,25,3,22,光和,2024-05-21,6380
00931B,統一美債20年,20,0,20,光和,2024-05-21,6380
4766,南寶,20,0,20,光和,2024-05-21,6380
5469,瀚宇博,20,0,20,光和,2024-05-21,6380
2316,楠梓電,40,21,19,光和,2024-05-21,6380
6283,淳安,16,0,16,光和,2024-05-21,6380
6290,良維,17,1,16,光和,2024-05-21,6380
2204,中華,16,1,15,光和,2024-05-21,6380
2880,華南金,15,0,15,光和,2024-05-21,6380
2317,鴻海,20,6,14,光和,2024-05-21,6380
2891,中信金,20,8,12,光和,2024-05-21,6380
2607,榮運,12,0,12,光和,2024-05-21,6380
2641,正德,13,1,12,光和,2024-05-21,6380
6425,易發,12,0,12,光和,2024-05-21,6380
2834,臺企銀,18,6,12,光和,2024-05-21,6380
2025,千興,11,0,11,光和,2024-05-21,6380
4306,炎洲,11,0,11,光和,2024-05-21,6380
6292,迅德,11,0,11,光和,2024-05-21,6380
6505,台塑化,11,0,11,光和,2024-05-21,6380
2887,台新金,11,0,11,光和,2024-05-21,6380
2344,華邦電,34,24,10,光和,2024-05-21,6380
00933B,國泰10Y+金融債,10,0,10,光和,2024-05-21,6380
3050,鈺德,10,0,10,光和,2024-05-21,6380
6111,大宇資,10,0,10,光和,2024-05-21,6380
6264,富裔,10,0,10,光和,2024-05-21,6380
2603,長榮,13,3,10,光和,2024-05-21,6380
2605,新興,9,0,9,光和,2024-05-21,6380
3481,群創,64,55,9,光和,2024-05-21,6380
00712,復華富時不動產,900,2,898,光和,2024-05-22,6380
00632R,元大台灣50反1,152,0,152,光和,2024-05-22,6380
2867,三商壽,124,0,124,光和,2024-05-22,6380
00929,復華台灣科技優息,112,26,86,光和,2024-05-22,6380
00937B,群益ESG投等債20,66,0,66,光和,2024-05-22,6380
2002,中鋼,55,0,55,光和,2024-05-22,6380
00945B,凱基美國非投等債,50,0,50,光和,2024-05-22,6380
2881,富邦金,50,4,46,光和,2024-05-22,6380
2515,中工,44,2,42,光和,2024-05-22,6380
6125,廣運,52,11,41,光和,2024-05-22,6380
00679B,元大美債20年,41,0,41,光和,2024-05-22,6380
1303,南亞,40,0,40,光和,2024-05-22,6380
1702,南僑,40,0,40,光和,2024-05-22,6380
2610,華航,126,86,40,光和,2024-05-22,6380
2027,大成鋼,52,14,38,光和,2024-05-22,6380
3059,華晶科,43,7,36,光和,2024-05-22,6380
1582,信錦,35,0,35,光和,2024-05-22,6380
1616,億泰,31,0,31,光和,2024-05-22,6380
3207,耀勝,25,0,25,光和,2024-05-22,6380
1608,華榮,34,12,22,光和,2024-05-22,6380
5381,合正,22,0,22,光和,2024-05-22,6380
1609,大亞,38,17,21,光和,2024-05-22,6380
2349,錸德,20,0,20,光和,2024-05-22,6380
6215,和椿,23,5,18,光和,2024-05-22,6380
2354,鴻準,29,11,18,光和,2024-05-22,6380
3338,泰碩,27,10,17,光和,2024-05-22,6380
2367,燿華,52,36,16,光和,2024-05-22,6380
5392,能率,68,52,16,光和,2024-05-22,6380
2834,臺企銀,16,0,16,光和,2024-05-22,6380
2449,京元電子,22,6,16,光和,2024-05-22,6380
4543,萬在,17,2,15,光和,2024-05-22,6380
2314,台揚,22,7,15,光和,2024-05-22,6380
3689,湧德,14,0,14,光和,2024-05-22,6380
3013,晟銘電,67,54,13,光和,2024-05-22,6380
2204,中華,13,0,13,光和,2024-05-22,6380
8358,金居,13,0,13,光和,2024-05-22,6380
00753L,中信中國50正2,16,4,12,光和,2024-05-22,6380
1447,力鵬,12,0,12,光和,2024-05-22,6380
2313,華通,19,7,12,光和,2024-05-22,6380
2537,聯上發,12,0,12,光和,2024-05-22,6380
3260,威剛,12,0,12,光和,2024-05-22,6380
3710,連展投控,12,0,12,光和,2024-05-22,6380
1708,東鹼,11,0,11,光和,2024-05-22,6380
2390,云辰,11,0,11,光和,2024-05-22,6380
2547,日勝生,11,0,11,光和,2024-05-22,6380
3209,全科,17,6,11,光和,2024-05-22,6380
1712,興農,10,0,10,光和,2024-05-22,6380
00931B,統一美債20年,10,0,10,光和,2024-05-22,6380
00864B,中信美國公債0-1,10,0,10,光和,2024-05-22,6380
00760B,復華新興企業債,10,0,10,光和,2024-05-22,6380
00712,復華富時不動產,423,0,423,光和,2024-05-23,6380
00632R,元大台灣50反1,225,0,225,光和,2024-05-23,6380
911868,同方友友-DR,191,0,191,光和,2024-05-23,6380
2329,華泰,104,11,93,光和,2024-05-23,6380
1609,大亞,80,18,62,光和,2024-05-23,6380
1314,中石化,77,15,62,光和,2024-05-23,6380
2867,三商壽,77,15,62,光和,2024-05-23,6380
2888,新光金,63,5,58,光和,2024-05-23,6380
00937B,群益ESG投等債20,55,0,55,光和,2024-05-23,6380
1304,台聚,51,0,51,光和,2024-05-23,6380
3712,永崴投控,50,10,40,光和,2024-05-23,6380
00637L,元大滬深300正2,67,30,37,光和,2024-05-23,6380
5443,均豪,46,10,36,光和,2024-05-23,6380
2610,華航,77,43,34,光和,2024-05-23,6380
3059,華晶科,49,15,34,光和,2024-05-23,6380
2409,友達,37,4,33,光和,2024-05-23,6380
00919,群益台灣精選高息,52,21,31,光和,2024-05-23,6380
2106,建大,31,0,31,光和,2024-05-23,6380
2356,英業達,27,1,26,光和,2024-05-23,6380
2002,中鋼,29,5,24,光和,2024-05-23,6380
6266,泰詠,20,0,20,光和,2024-05-23,6380
5014,建錩,20,0,20,光和,2024-05-23,6380
6016,康和證,20,0,20,光和,2024-05-23,6380
5498,凱崴,31,12,19,光和,2024-05-23,6380
6234,高僑,19,0,19,光和,2024-05-23,6380
9924,福興,20,1,19,光和,2024-05-23,6380
1313,聯成,17,0,17,光和,2024-05-23,6380
6147,頎邦,18,1,17,光和,2024-05-23,6380
6197,佳必琪,18,1,17,光和,2024-05-23,6380
3176,基亞,18,2,16,光和,2024-05-23,6380
00885,富邦越南,16,0,16,光和,2024-05-23,6380
3715,定穎投控,15,0,15,光和,2024-05-23,6380
00940,元大台灣價值高息,70,56,14,光和,2024-05-23,6380
1810,和成,17,3,14,光和,2024-05-23,6380
8048,德勝,14,0,14,光和,2024-05-23,6380
8070,長華*,14,0,14,光和,2024-05-23,6380
1326,台化,13,0,13,光和,2024-05-23,6380
00850,元大臺灣ESG永續,13,0,13,光和,2024-05-23,6380
2009,第一銅,16,3,13,光和,2024-05-23,6380
2439,美律,13,0,13,光和,2024-05-23,6380
2882,國泰金,18,5,13,光和,2024-05-23,6380
9904,寶成,15,2,13,光和,2024-05-23,6380
1301,台塑,12,0,12,光和,2024-05-23,6380
1721,三晃,12,0,12,光和,2024-05-23,6380
2501,國建,12,0,12,光和,2024-05-23,6380
4533,協易機,59,48,11,光和,2024-05-23,6380
2034,允強,11,0,11,光和,2024-05-23,6380
2313,華通,22,11,11,光和,2024-05-23,6380
3207,耀勝,12,1,11,光和,2024-05-23,6380
3234,光環,12,1,11,光和,2024-05-23,6380
00712,復華富時不動產,483,1,482,光和,2024-05-24,6380
00937B,群益ESG投等債20,227,110,117,光和,2024-05-24,6380
00680L,元大美債20正2,100,0,100,光和,2024-05-24,6380
6125,廣運,103,9,94,光和,2024-05-24,6380
8150,南茂,74,0,74,光和,2024-05-24,6380
5347,世界,69,2,67,光和,2024-05-24,6380
2515,中工,55,2,53,光和,2024-05-24,6380
00637L,元大滬深300正2,346,300,46,光和,2024-05-24,6380
3221,台嘉碩,49,5,44,光和,2024-05-24,6380
1605,華新,48,5,43,光和,2024-05-24,6380
1304,台聚,30,1,29,光和,2024-05-24,6380
2542,興富發,30,1,29,光和,2024-05-24,6380
00919,群益台灣精選高息,42,15,27,光和,2024-05-24,6380
3706,神達,28,1,27,光和,2024-05-24,6380
6147,頎邦,24,0,24,光和,2024-05-24,6380
1303,南亞,22,0,22,光和,2024-05-24,6380
1809,中釉,23,1,22,光和,2024-05-24,6380
1326,台化,21,0,21,光和,2024-05-24,6380
3703,欣陸,21,0,21,光和,2024-05-24,6380
1618,合機,23,2,21,光和,2024-05-24,6380
2834,臺企銀,21,0,21,光和,2024-05-24,6380
2547,日勝生,20,0,20,光和,2024-05-24,6380
6117,迎廣,29,10,19,光和,2024-05-24,6380
5309,系統電,31,13,18,光和,2024-05-24,6380
6770,力積電,31,13,18,光和,2024-05-24,6380
2392,正崴,21,4,17,光和,2024-05-24,6380
00679B,元大美債20年,17,0,17,光和,2024-05-24,6380
3036,文曄,17,1,16,光和,2024-05-24,6380
1301,台塑,15,0,15,光和,2024-05-24,6380
2313,華通,19,4,15,光和,2024-05-24,6380
2610,華航,19,6,13,光和,2024-05-24,6380
1313,聯成,13,0,13,光和,2024-05-24,6380
2352,佳世達,13,1,12,光和,2024-05-24,6380
9904,寶成,14,2,12,光和,2024-05-24,6380
2406,國碩,12,0,12,光和,2024-05-24,6380
8110,華東,11,0,11,光和,2024-05-24,6380
2002,中鋼,10,0,10,光和,2024-05-24,6380
00945B,凱基美國非投等債,10,0,10,光和,2024-05-24,6380
1319,東陽,10,0,10,光和,2024-05-24,6380
2023,燁輝,10,0,10,光和,2024-05-24,6380
2324,仁寶,34,24,10,光和,2024-05-24,6380
2409,友達,15,5,10,光和,2024-05-24,6380
2801,彰銀,10,0,10,光和,2024-05-24,6380
3005,神基,11,1,10,光和,2024-05-24,6380
3356,奇偶,11,1,10,光和,2024-05-24,6380
3360,尚立,10,0,10,光和,2024-05-24,6380
4766,南寶,10,0,10,光和,2024-05-24,6380
5381,合正,10,0,10,光和,2024-05-24,6380
5880,合庫金,10,0,10,光和,2024-05-24,6380
3033,威健,22,12,10,光和,2024-05-24,6380
2002,中鋼,252,1,251,光和,2024-05-27,6380
00931B,統一美債20年,133,0,133,光和,2024-05-27,6380
1815,富喬,109,12,97,光和,2024-05-27,6380
2867,三商壽,61,0,61,光和,2024-05-27,6380
00712,復華富時不動產,55,2,53,光和,2024-05-27,6380
2609,陽明,69,17,52,光和,2024-05-27,6380
9105,泰金寶-DR,82,31,51,光和,2024-05-27,6380
1447,力鵬,51,4,47,光和,2024-05-27,6380
00882,中信中國高股息,46,1,45,光和,2024-05-27,6380
2353,宏��,102,61,41,光和,2024-05-27,6380
00946,群益科技高息成長,41,0,41,光和,2024-05-27,6380
3002,歐格,33,0,33,光和,2024-05-27,6380
5531,鄉林,30,1,29,光和,2024-05-27,6380
00753L,中信中國50正2,42,15,27,光和,2024-05-27,6380
3047,訊舟,34,7,27,光和,2024-05-27,6380
1303,南亞,23,0,23,光和,2024-05-27,6380
1340,勝悅-KY,30,7,23,光和,2024-05-27,6380
3231,緯創,32,11,21,光和,2024-05-27,6380
1708,東鹼,21,0,21,光和,2024-05-27,6380
3703,欣陸,21,0,21,光和,2024-05-27,6380
00713,元大台灣高息低波,20,0,20,光和,2024-05-27,6380
00945B,凱基美國非投等債,20,0,20,光和,2024-05-27,6380
4123,晟德,20,0,20,光和,2024-05-27,6380
8150,南茂,20,0,20,光和,2024-05-27,6380
2324,仁寶,27,9,18,光和,2024-05-27,6380
1314,中石化,37,20,17,光和,2024-05-27,6380
3234,光環,19,2,17,光和,2024-05-27,6380
4908,前鼎,19,2,17,光和,2024-05-27,6380
6425,易發,18,1,17,光和,2024-05-27,6380
6239,力成,17,1,16,光和,2024-05-27,6380
5498,凱崴,19,3,16,光和,2024-05-27,6380
00679B,元大美債20年,14,0,14,光和,2024-05-27,6380
2438,翔耀,14,0,14,光和,2024-05-27,6380
2890,永豐金,21,7,14,光和,2024-05-27,6380
3499,環天科,15,1,14,光和,2024-05-27,6380
3706,神達,17,3,14,光和,2024-05-27,6380
3715,定穎投控,16,3,13,光和,2024-05-27,6380
2882,國泰金,15,2,13,光和,2024-05-27,6380
2905,三商,13,0,13,光和,2024-05-27,6380
2367,燿華,26,14,12,光和,2024-05-27,6380
006208,富邦台50,12,0,12,光和,2024-05-27,6380
1785,光洋科,12,0,12,光和,2024-05-27,6380
4906,正文,35,23,12,光和,2024-05-27,6380
3338,泰碩,15,3,12,光和,2024-05-27,6380
3576,聯合再生,12,1,11,光和,2024-05-27,6380
2801,彰銀,11,0,11,光和,2024-05-27,6380
5880,合庫金,13,2,11,光和,2024-05-27,6380
2406,國碩,11,0,11,光和,2024-05-27,6380
00885,富邦越南,10,0,10,光和,2024-05-27,6380
00665L,富邦�琤肭磪囓�2,10,0,10,光和,2024-05-27,6380
2354,鴻準,236,39,197,光和,2024-05-28,6380
00937B,群益ESG投等債20,153,1,152,光和,2024-05-28,6380
00940,元大台灣價值高息,121,9,112,光和,2024-05-28,6380
2363,矽統,97,3,94,光和,2024-05-28,6380
00712,復華富時不動產,52,0,52,光和,2024-05-28,6380
2353,宏��,76,27,49,光和,2024-05-28,6380
1447,力鵬,50,6,44,光和,2024-05-28,6380
2324,仁寶,107,68,39,光和,2024-05-28,6380
1101,台泥,40,3,37,光和,2024-05-28,6380
2891,中信金,44,10,34,光和,2024-05-28,6380
3706,神達,35,3,32,光和,2024-05-28,6380
4167,松瑞藥,31,0,31,光和,2024-05-28,6380
4157,太景*-KY,30,0,30,光和,2024-05-28,6380
8096,擎亞,32,5,27,光和,2024-05-28,6380
2609,陽明,47,20,27,光和,2024-05-28,6380
00632R,元大台灣50反1,26,0,26,光和,2024-05-28,6380
2317,鴻海,35,11,24,光和,2024-05-28,6380
9945,潤泰新,27,4,23,光和,2024-05-28,6380
2890,永豐金,22,0,22,光和,2024-05-28,6380
3202,樺晟,32,10,22,光和,2024-05-28,6380
00919,群益台灣精選高息,26,6,20,光和,2024-05-28,6380
00931B,統一美債20年,20,0,20,光和,2024-05-28,6380
1316,上曜,26,6,20,光和,2024-05-28,6380
3450,聯鈞,40,20,20,光和,2024-05-28,6380
3516,亞帝歐,20,0,20,光和,2024-05-28,6380
9105,泰金寶-DR,28,8,20,光和,2024-05-28,6380
00946,群益科技高息成長,18,0,18,光和,2024-05-28,6380
3060,銘異,24,6,18,光和,2024-05-28,6380
3287,廣寰科,18,0,18,光和,2024-05-28,6380
8064,東捷,25,7,18,光和,2024-05-28,6380
2313,華通,18,1,17,光和,2024-05-28,6380
3002,歐格,17,0,17,光和,2024-05-28,6380
2486,一詮,32,16,16,光和,2024-05-28,6380
2905,三商,16,0,16,光和,2024-05-28,6380
3122,笙泉,22,6,16,光和,2024-05-28,6380
1609,大亞,22,7,15,光和,2024-05-28,6380
2301,光寶科,25,11,14,光和,2024-05-28,6380
2633,台灣高鐵,13,0,13,光和,2024-05-28,6380
4949,有成精密,13,0,13,光和,2024-05-28,6380
2464,盟立,17,5,12,光和,2024-05-28,6380
00929,復華台灣科技優息,40,28,12,光和,2024-05-28,6380
1531,高林股,15,3,12,光和,2024-05-28,6380
1795,美時,15,3,12,光和,2024-05-28,6380
3260,威剛,14,2,12,光和,2024-05-28,6380
2401,凌陽,16,5,11,光和,2024-05-28,6380
6207,雷科,23,12,11,光和,2024-05-28,6380
00679B,元大美債20年,17,7,10,光和,2024-05-28,6380
2352,佳世達,11,1,10,光和,2024-05-28,6380
00850,元大臺灣ESG永續,10,0,10,光和,2024-05-28,6380
00673R,期元大S＆P原油反1,10,0,10,光和,2024-05-28,6380
00937B,群益ESG投等債20,209,0,209,光和,2024-05-29,6380
5521,工信,158,6,152,光和,2024-05-29,6380
2106,建大,93,0,93,光和,2024-05-29,6380
9945,潤泰新,85,0,85,光和,2024-05-29,6380
2867,三商壽,219,135,84,光和,2024-05-29,6380
1447,力鵬,83,1,82,光和,2024-05-29,6380
2801,彰銀,72,0,72,光和,2024-05-29,6380
00929,復華台灣科技優息,101,34,67,光和,2024-05-29,6380
2027,大成鋼,60,0,60,光和,2024-05-29,6380
2888,新光金,99,43,56,光和,2024-05-29,6380
2353,宏��,79,25,54,光和,2024-05-29,6380
00878,國泰永續高股息,41,0,41,光和,2024-05-29,6380
2515,中工,47,7,40,光和,2024-05-29,6380
1718,中纖,40,1,39,光和,2024-05-29,6380
2401,凌陽,72,33,39,光和,2024-05-29,6380
00931B,統一美債20年,35,0,35,光和,2024-05-29,6380
2834,臺企銀,34,0,34,光和,2024-05-29,6380
2363,矽統,56,25,31,光和,2024-05-29,6380
00679B,元大美債20年,63,33,30,光和,2024-05-29,6380
00942B,台新美A公司債20+,30,0,30,光和,2024-05-29,6380
3231,緯創,32,4,28,光和,2024-05-29,6380
2882,國泰金,27,0,27,光和,2024-05-29,6380
2618,長榮航,40,13,27,光和,2024-05-29,6380
00940,元大台灣價值高息,37,11,26,光和,2024-05-29,6380
2614,東森,25,0,25,光和,2024-05-29,6380
1303,南亞,26,2,24,光和,2024-05-29,6380
5608,四維航,48,24,24,光和,2024-05-29,6380
2633,台灣高鐵,22,0,22,光和,2024-05-29,6380
3202,樺晟,25,3,22,光和,2024-05-29,6380
3689,湧德,33,11,22,光和,2024-05-29,6380
2371,大同,25,4,21,光和,2024-05-29,6380
2317,鴻海,44,24,20,光和,2024-05-29,6380
00632R,元大台灣50反1,20,0,20,光和,2024-05-29,6380
00665L,富邦�琤肭磪囓�2,20,0,20,光和,2024-05-29,6380
2812,台中銀,20,0,20,光和,2024-05-29,6380
5498,凱崴,20,2,18,光和,2024-05-29,6380
00946,群益科技高息成長,17,0,17,光和,2024-05-29,6380
2883,凱基金,16,0,16,光和,2024-05-29,6380
00756B,群益投等新興公債,15,0,15,光和,2024-05-29,6380
2340,台亞,15,0,15,光和,2024-05-29,6380
2409,友達,15,0,15,光和,2024-05-29,6380
2344,華邦電,16,1,15,光和,2024-05-29,6380
2002,中鋼,20,6,14,光和,2024-05-29,6380
00857B,永豐20年美公債,14,0,14,光和,2024-05-29,6380
3207,耀勝,14,0,14,光和,2024-05-29,6380
2349,錸德,50,37,13,光和,2024-05-29,6380
00720B,元大投資級公司債,13,0,13,光和,2024-05-29,6380
3372,典範,14,1,13,光和,2024-05-29,6380
3481,群創,94,81,13,光和,2024-05-29,6380
4714,永捷,19,6,13,光和,2024-05-29,6380
2888,新光金,220,16,204,光和,2024-05-30,6380
1815,富喬,346,233,113,光和,2024-05-30,6380
1303,南亞,113,1,112,光和,2024-05-30,6380
2867,三商壽,112,0,112,光和,2024-05-30,6380
9945,潤泰新,78,4,74,光和,2024-05-30,6380
00929,復華台灣科技優息,70,5,65,光和,2024-05-30,6380
1304,台聚,60,2,58,光和,2024-05-30,6380
2353,宏��,78,23,55,光和,2024-05-30,6380
2356,英業達,45,0,45,光和,2024-05-30,6380
1447,力鵬,51,9,42,光和,2024-05-30,6380
2892,第一金,35,0,35,光和,2024-05-30,6380
2002,中鋼,36,4,32,光和,2024-05-30,6380
2834,臺企銀,31,0,31,光和,2024-05-30,6380
1722,台肥,30,0,30,光和,2024-05-30,6380
4109,加捷生醫,30,0,30,光和,2024-05-30,6380
2014,中鴻,30,5,25,光和,2024-05-30,6380
8064,東捷,27,3,24,光和,2024-05-30,6380
2344,華邦電,36,13,23,光和,2024-05-30,6380
4533,協易機,29,6,23,光和,2024-05-30,6380
6257,矽格,25,2,23,光和,2024-05-30,6380
1616,億泰,22,0,22,光和,2024-05-30,6380
2324,仁寶,36,15,21,光和,2024-05-30,6380
1711,永光,21,0,21,光和,2024-05-30,6380
3706,神達,41,20,21,光和,2024-05-30,6380
00679B,元大美債20年,20,0,20,光和,2024-05-30,6380
2405,輔信,36,16,20,光和,2024-05-30,6380
1605,華新,38,18,20,光和,2024-05-30,6380
2017,官田鋼,20,0,20,光和,2024-05-30,6380
2020,美亞,30,10,20,光和,2024-05-30,6380
2468,華經,20,0,20,光和,2024-05-30,6380
3231,緯創,24,4,20,光和,2024-05-30,6380
2641,正德,26,7,19,光和,2024-05-30,6380
4157,太景*-KY,19,0,19,光和,2024-05-30,6380
5498,凱崴,18,0,18,光和,2024-05-30,6380
2354,鴻準,31,13,18,光和,2024-05-30,6380
00940,元大台灣價值高息,28,10,18,光和,2024-05-30,6380
6505,台塑化,17,0,17,光和,2024-05-30,6380
2401,凌陽,31,14,17,光和,2024-05-30,6380
2329,華泰,23,7,16,光和,2024-05-30,6380
1710,東聯,16,0,16,光和,2024-05-30,6380
6116,彩晶,16,0,16,光和,2024-05-30,6380
6770,力積電,29,13,16,光和,2024-05-30,6380
1101,台泥,15,0,15,光和,2024-05-30,6380
2439,美律,16,1,15,光和,2024-05-30,6380
8383,千附,15,0,15,光和,2024-05-30,6380
2610,華航,48,33,15,光和,2024-05-30,6380
6125,廣運,36,22,14,光和,2024-05-30,6380
00720B,元大投資級公司債,14,0,14,光和,2024-05-30,6380
00687B,國泰20年美債,14,0,14,光和,2024-05-30,6380
2349,錸德,38,25,13,光和,2024-05-30,6380
2609,陽明,298,103,195,光和,2024-05-31,6380
00929,復華台灣科技優息,90,1,89,光和,2024-05-31,6380
3312,弘憶股,99,28,71,光和,2024-05-31,6380
2317,鴻海,78,12,66,光和,2024-05-31,6380
2353,宏��,60,17,43,光和,2024-05-31,6380
2405,輔信,38,2,36,光和,2024-05-31,6380
6239,力成,32,0,32,光和,2024-05-31,6380
00878,國泰永續高股息,34,2,32,光和,2024-05-31,6380
2002,中鋼,35,5,30,光和,2024-05-31,6380
00937B,群益ESG投等債20,29,1,28,光和,2024-05-31,6380
1101,台泥,30,3,27,光和,2024-05-31,6380
00712,復華富時不動產,30,5,25,光和,2024-05-31,6380
6177,達麗,25,1,24,光和,2024-05-31,6380
2344,華邦電,25,2,23,光和,2024-05-31,6380
6209,今國光,23,1,22,光和,2024-05-31,6380
00940,元大台灣價值高息,21,0,21,光和,2024-05-31,6380
2367,燿華,54,33,21,光和,2024-05-31,6380
5309,系統電,21,0,21,光和,2024-05-31,6380
00897,富邦基因免疫生技,20,0,20,光和,2024-05-31,6380
2027,大成鋼,20,0,20,光和,2024-05-31,6380
2409,友達,23,3,20,光和,2024-05-31,6380
2610,華航,56,36,20,光和,2024-05-31,6380
5706,鳳凰,20,1,19,光和,2024-05-31,6380
3231,緯創,27,8,19,光和,2024-05-31,6380
6257,矽格,29,11,18,光和,2024-05-31,6380
1447,力鵬,19,2,17,光和,2024-05-31,6380
3689,湧德,16,0,16,光和,2024-05-31,6380
1227,佳格,15,0,15,光和,2024-05-31,6380
2886,兆豐金,15,0,15,光和,2024-05-31,6380
4549,桓達,15,0,15,光和,2024-05-31,6380
2303,聯電,14,0,14,光和,2024-05-31,6380
00939,統一台灣高息動能,14,0,14,光和,2024-05-31,6380
1536,和大,15,1,14,光和,2024-05-31,6380
2527,宏璟,14,0,14,光和,2024-05-31,6380
2615,萬海,12,0,12,光和,2024-05-31,6380
00946,群益科技高息成長,12,0,12,光和,2024-05-31,6380
2449,京元電子,12,0,12,光和,2024-05-31,6380
2356,英業達,12,0,12,光和,2024-05-31,6380
2301,光寶科,20,9,11,光和,2024-05-31,6380
2323,中環,15,4,11,光和,2024-05-31,6380
2481,強茂,15,4,11,光和,2024-05-31,6380
3308,聯德,12,1,11,光和,2024-05-31,6380
4906,正文,19,8,11,光和,2024-05-31,6380
8234,新漢,11,0,11,光和,2024-05-31,6380
1710,東聯,10,0,10,光和,2024-05-31,6380
2362,藍天,11,1,10,光和,2024-05-31,6380
4976,佳凌,10,0,10,光和,2024-05-31,6380
5471,松翰,13,3,10,光和,2024-05-31,6380
6127,九豪,10,0,10,光和,2024-05-31,6380
2330,台積電,10,1,9,光和,2024-05-31,6380
6209,今國光,137,5,132,光和,2024-06-03,6380
2618,長榮航,137,11,126,光和,2024-06-03,6380
2867,三商壽,198,100,98,光和,2024-06-03,6380
00919,群益台灣精選高息,96,0,96,光和,2024-06-03,6380
1457,宜進,70,0,70,光和,2024-06-03,6380
1815,富喬,83,20,63,光和,2024-06-03,6380
2382,廣達,61,2,59,光和,2024-06-03,6380
2438,翔耀,47,4,43,光和,2024-06-03,6380
9940,信義,40,0,40,光和,2024-06-03,6380
5521,工信,38,0,38,光和,2024-06-03,6380
2489,瑞軒,41,4,37,光和,2024-06-03,6380
2354,鴻準,66,32,34,光和,2024-06-03,6380
5347,世界,33,0,33,光和,2024-06-03,6380
2605,新興,29,2,27,光和,2024-06-03,6380
00637L,元大滬深300正2,30,5,25,光和,2024-06-03,6380
2401,凌陽,30,5,25,光和,2024-06-03,6380
2353,宏��,25,2,23,光和,2024-06-03,6380
6139,亞翔,26,4,22,光和,2024-06-03,6380
8215,明基材,22,0,22,光和,2024-06-03,6380
2303,聯電,24,3,21,光和,2024-06-03,6380
00937B,群益ESG投等債20,20,0,20,光和,2024-06-03,6380
6770,力積電,30,10,20,光和,2024-06-03,6380
3059,華晶科,27,8,19,光和,2024-06-03,6380
2002,中鋼,20,1,19,光和,2024-06-03,6380
3305,昇貿,20,1,19,光和,2024-06-03,6380
3481,群創,89,70,19,光和,2024-06-03,6380
1301,台塑,19,0,19,光和,2024-06-03,6380
1717,長興,18,0,18,光和,2024-06-03,6380
2367,燿華,27,9,18,光和,2024-06-03,6380
1313,聯成,17,0,17,光和,2024-06-03,6380
1603,華電,17,0,17,光和,2024-06-03,6380
1522,堤維西,26,10,16,光和,2024-06-03,6380
2323,中環,20,4,16,光和,2024-06-03,6380
4562,穎漢,16,0,16,光和,2024-06-03,6380
00712,復華富時不動產,15,0,15,光和,2024-06-03,6380
1605,華新,24,9,15,光和,2024-06-03,6380
2349,錸德,15,1,14,光和,2024-06-03,6380
2409,友達,14,0,14,光和,2024-06-03,6380
5880,合庫金,14,0,14,光和,2024-06-03,6380
2317,鴻海,36,23,13,光和,2024-06-03,6380
1326,台化,13,0,13,光和,2024-06-03,6380
2889,國票金,13,0,13,光和,2024-06-03,6380
3490,單井,17,4,13,光和,2024-06-03,6380
00715L,期街口布蘭特正2,12,0,12,光和,2024-06-03,6380
1303,南亞,12,0,12,光和,2024-06-03,6380
1611,中電,12,0,12,光和,2024-06-03,6380
4533,協易機,28,16,12,光和,2024-06-03,6380
2641,正德,14,3,11,光和,2024-06-03,6380
3036,文曄,11,0,11,光和,2024-06-03,6380
6282,康舒,11,0,11,光和,2024-06-03,6380
2888,新光金,443,19,424,光和,2024-06-04,6380
00936,台新永續高息中小,181,0,181,光和,2024-06-04,6380
00918,大華優利高填息30,160,0,160,光和,2024-06-04,6380
00940,元大台灣價值高息,158,7,151,光和,2024-06-04,6380
00919,群益台灣精選高息,146,0,146,光和,2024-06-04,6380
2344,華邦電,99,1,98,光和,2024-06-04,6380
1802,台玻,89,3,86,光和,2024-06-04,6380
3372,典範,67,9,58,光和,2024-06-04,6380
2317,鴻海,59,11,48,光和,2024-06-04,6380
2618,長榮航,44,1,43,光和,2024-06-04,6380
1457,宜進,40,0,40,光和,2024-06-04,6380
2312,金寶,205,167,38,光和,2024-06-04,6380
2014,中鴻,35,0,35,光和,2024-06-04,6380
2354,鴻準,40,7,33,光和,2024-06-04,6380
2363,矽統,58,27,31,光和,2024-06-04,6380
2801,彰銀,31,1,30,光和,2024-06-04,6380
2812,台中銀,29,0,29,光和,2024-06-04,6380
2405,輔信,27,2,25,光和,2024-06-04,6380
4526,東台,25,0,25,光和,2024-06-04,6380
2329,華泰,26,1,25,光和,2024-06-04,6380
1301,台塑,33,10,23,光和,2024-06-04,6380
00715L,期街口布蘭特正2,22,0,22,光和,2024-06-04,6380
6531,愛普*,25,4,21,光和,2024-06-04,6380
6770,力積電,21,1,20,光和,2024-06-04,6380
00671R,富邦NASDAQ反1,20,0,20,光和,2024-06-04,6380
2468,華經,20,0,20,光和,2024-06-04,6380
5521,工信,22,2,20,光和,2024-06-04,6380
8064,東捷,20,0,20,光和,2024-06-04,6380
2002,中鋼,22,3,19,光和,2024-06-04,6380
6125,廣運,38,20,18,光和,2024-06-04,6380
2401,凌陽,22,5,17,光和,2024-06-04,6380
2409,友達,17,0,17,光和,2024-06-04,6380
1326,台化,16,0,16,光和,2024-06-04,6380
2367,燿華,47,31,16,光和,2024-06-04,6380
5471,松翰,16,0,16,光和,2024-06-04,6380
6215,和椿,17,1,16,光和,2024-06-04,6380
00878,國泰永續高股息,40,25,15,光和,2024-06-04,6380
6505,台塑化,15,0,15,光和,2024-06-04,6380
1603,華電,16,1,15,光和,2024-06-04,6380
2515,中工,42,27,15,光和,2024-06-04,6380
3432,台端,15,0,15,光和,2024-06-04,6380
3623,富晶通,15,0,15,光和,2024-06-04,6380
6163,華電網,19,4,15,光和,2024-06-04,6380
00907,永豐優息存股,14,0,14,光和,2024-06-04,6380
5410,國眾,14,0,14,光和,2024-06-04,6380
6015,宏遠證,14,0,14,光和,2024-06-04,6380
2301,光寶科,15,1,14,光和,2024-06-04,6380
00850,元大臺灣ESG永續,13,0,13,光和,2024-06-04,6380
2408,南亞科,12,0,12,光和,2024-06-04,6380
2537,聯上發,22,10,12,光和,2024-06-04,6380
00919,群益台灣精選高息,545,1,544,光和,2024-06-05,6380
00918,大華優利高填息30,345,0,345,光和,2024-06-05,6380
2888,新光金,125,31,94,光和,2024-06-05,6380
4726,永昕,86,2,84,光和,2024-06-05,6380
00885,富邦越南,73,0,73,光和,2024-06-05,6380
4108,懷特,70,0,70,光和,2024-06-05,6380
00936,台新永續高息中小,78,12,66,光和,2024-06-05,6380
2401,凌陽,58,0,58,光和,2024-06-05,6380
2515,中工,58,2,56,光和,2024-06-05,6380
3689,湧德,83,31,52,光和,2024-06-05,6380
3712,永崴投控,51,0,51,光和,2024-06-05,6380
00878,國泰永續高股息,51,3,48,光和,2024-06-05,6380
2417,圓剛,49,2,47,光和,2024-06-05,6380
6257,矽格,46,0,46,光和,2024-06-05,6380
2105,正新,46,1,45,光和,2024-06-05,6380
6182,合晶,42,0,42,光和,2024-06-05,6380
2867,三商壽,40,4,36,光和,2024-06-05,6380
1457,宜進,35,0,35,光和,2024-06-05,6380
1609,大亞,38,8,30,光和,2024-06-05,6380
00679B,元大美債20年,30,4,26,光和,2024-06-05,6380
00939,統一台灣高息動能,26,0,26,光和,2024-06-05,6380
2324,仁寶,24,2,22,光和,2024-06-05,6380
2303,聯電,21,1,20,光和,2024-06-05,6380
00931B,統一美債20年,20,0,20,光和,2024-06-05,6380
00680L,元大美債20正2,20,0,20,光和,2024-06-05,6380
3706,神達,40,20,20,光和,2024-06-05,6380
8110,華東,21,1,20,光和,2024-06-05,6380
2331,精英,26,8,18,光和,2024-06-05,6380
3048,益登,22,5,17,光和,2024-06-05,6380
8046,南電,17,0,17,光和,2024-06-05,6380
00712,復華富時不動產,22,5,17,光和,2024-06-05,6380
3059,華晶科,23,6,17,光和,2024-06-05,6380
5471,松翰,17,0,17,光和,2024-06-05,6380
2062,橋椿,16,0,16,光和,2024-06-05,6380
4906,正文,16,0,16,光和,2024-06-05,6380
3231,緯創,16,1,15,光和,2024-06-05,6380
1710,東聯,15,0,15,光和,2024-06-05,6380
2352,佳世達,16,1,15,光和,2024-06-05,6380
2313,華通,18,5,13,光和,2024-06-05,6380
1616,億泰,13,0,13,光和,2024-06-05,6380
6163,華電網,14,1,13,光和,2024-06-05,6380
1301,台塑,14,1,13,光和,2024-06-05,6380
3372,典範,21,10,11,光和,2024-06-05,6380
6147,頎邦,12,1,11,光和,2024-06-05,6380
2905,三商,10,0,10,光和,2024-06-05,6380
00942B,台新美A公司債20+,10,0,10,光和,2024-06-05,6380
00753L,中信中國50正2,10,0,10,光和,2024-06-05,6380
00751B,元大AAA至A公司債,10,0,10,光和,2024-06-05,6380
00665L,富邦�琤肭磪囓�2,10,0,10,光和,2024-06-05,6380
1529,樂事綠能,10,0,10,光和,2024-06-05,6380
00918,大華優利高填息30,196,0,196,光和,2024-06-06,6380
2405,輔信,100,2,98,光和,2024-06-06,6380
2371,大同,72,3,69,光和,2024-06-06,6380
2609,陽明,307,238,69,光和,2024-06-06,6380
3062,建漢,56,2,54,光和,2024-06-06,6380
00632R,元大台灣50反1,54,1,53,光和,2024-06-06,6380
1815,富喬,81,33,48,光和,2024-06-06,6380
2460,建通,34,0,34,光和,2024-06-06,6380
3014,聯陽,30,0,30,光和,2024-06-06,6380
3059,華晶科,32,2,30,光和,2024-06-06,6380
8234,新漢,32,2,30,光和,2024-06-06,6380
5392,能率,45,16,29,光和,2024-06-06,6380
2353,宏��,28,2,26,光和,2024-06-06,6380
2417,圓剛,28,2,26,光和,2024-06-06,6380
00936,台新永續高息中小,26,2,24,光和,2024-06-06,6380
3689,湧德,30,6,24,光和,2024-06-06,6380
6770,力積電,23,0,23,光和,2024-06-06,6380
4958,臻鼎-KY,23,0,23,光和,2024-06-06,6380
2317,鴻海,68,46,22,光和,2024-06-06,6380
2105,正新,21,0,21,光和,2024-06-06,6380
2331,精英,31,10,21,光和,2024-06-06,6380
2002,中鋼,20,0,20,光和,2024-06-06,6380
2613,中櫃,30,12,18,光和,2024-06-06,6380
5302,太欣,21,3,18,光和,2024-06-06,6380
1303,南亞,17,0,17,光和,2024-06-06,6380
1464,得力,17,0,17,光和,2024-06-06,6380
1802,台玻,100,83,17,光和,2024-06-06,6380
5371,中光電,20,3,17,光和,2024-06-06,6380
2374,佳能,20,5,15,光和,2024-06-06,6380
00878,國泰永續高股息,23,8,15,光和,2024-06-06,6380
2489,瑞軒,34,20,14,光和,2024-06-06,6380
2634,漢翔,14,0,14,光和,2024-06-06,6380
00929,復華台灣科技優息,16,3,13,光和,2024-06-06,6380
2354,鴻準,24,12,12,光和,2024-06-06,6380
2641,正德,21,9,12,光和,2024-06-06,6380
00919,群益台灣精選高息,26,14,12,光和,2024-06-06,6380
00637L,元大滬深300正2,11,0,11,光和,2024-06-06,6380
2349,錸德,21,10,11,光和,2024-06-06,6380
6443,元晶,11,0,11,光和,2024-06-06,6380
6244,茂迪,10,0,10,光和,2024-06-06,6380
2017,官田鋼,10,0,10,光和,2024-06-06,6380
1717,長興,10,0,10,光和,2024-06-06,6380
00650L,復華香港正2,10,0,10,光和,2024-06-06,6380
2025,千興,10,0,10,光和,2024-06-06,6380
2033,佳大,10,0,10,光和,2024-06-06,6380
2070,精湛,10,0,10,光和,2024-06-06,6380
2367,燿華,51,41,10,光和,2024-06-06,6380
2399,映泰,10,0,10,光和,2024-06-06,6380
2886,兆豐金,10,0,10,光和,2024-06-06,6380
3714,富采,10,0,10,光和,2024-06-06,6380
00937B,群益ESG投等債20,312,28,284,光和,2024-06-07,6380
2867,三商壽,170,52,118,光和,2024-06-07,6380
00936,台新永續高息中小,113,1,112,光和,2024-06-07,6380
1457,宜進,100,0,100,光和,2024-06-07,6380
1609,大亞,116,34,82,光和,2024-06-07,6380
00637L,元大滬深300正2,57,0,57,光和,2024-06-07,6380
3706,神達,51,0,51,光和,2024-06-07,6380
00918,大華優利高填息30,43,0,43,光和,2024-06-07,6380
3231,緯創,62,20,42,光和,2024-06-07,6380
2482,連宇,50,10,40,光和,2024-06-07,6380
2352,佳世達,39,0,39,光和,2024-06-07,6380
5371,中光電,27,1,26,光和,2024-06-07,6380
8234,新漢,21,0,21,光和,2024-06-07,6380
2439,美律,18,0,18,光和,2024-06-07,6380
00919,群益台灣精選高息,24,7,17,光和,2024-06-07,6380
2615,萬海,35,18,17,光和,2024-06-07,6380
2105,正新,16,0,16,光和,2024-06-07,6380
6125,廣運,17,1,16,光和,2024-06-07,6380
1303,南亞,15,0,15,光和,2024-06-07,6380
00929,復華台灣科技優息,43,29,14,光和,2024-06-07,6380
6668,中揚光,11,0,11,光和,2024-06-07,6380
4906,正文,10,0,10,光和,2024-06-07,6380
00850,元大臺灣ESG永續,10,0,10,光和,2024-06-07,6380
00882,中信中國高股息,12,2,10,光和,2024-06-07,6380
4804,大略-KY,10,0,10,光和,2024-06-07,6380
5302,太欣,17,7,10,光和,2024-06-07,6380
8033,雷虎,13,3,10,光和,2024-06-07,6380
2609,陽明,79,70,9,光和,2024-06-07,6380
2002,中鋼,15,6,9,光和,2024-06-07,6380
3356,奇偶,9,0,9,光和,2024-06-07,6380
3047,訊舟,14,5,9,光和,2024-06-07,6380
4956,光鋐,11,3,8,光和,2024-06-07,6380
2368,金像電,9,2,7,光和,2024-06-07,6380
2421,建準,8,1,7,光和,2024-06-07,6380
6155,鈞寶,7,0,7,光和,2024-06-07,6380
1301,台塑,6,0,6,光和,2024-06-07,6380
2328,廣宇,9,3,6,光和,2024-06-07,6380
00946,群益科技高息成長,6,0,6,光和,2024-06-07,6380
2014,中鴻,6,0,6,光和,2024-06-07,6380
2034,允強,6,0,6,光和,2024-06-07,6380
2313,華通,11,5,6,光和,2024-06-07,6380
00878,國泰永續高股息,15,10,5,光和,2024-06-07,6380
1535,中宇,5,0,5,光和,2024-06-07,6380
1905,華紙,5,0,5,光和,2024-06-07,6380
2374,佳能,5,0,5,光和,2024-06-07,6380
2905,三商,5,0,5,光和,2024-06-07,6380
4540,全球傳動,5,0,5,光和,2024-06-07,6380
6206,飛捷,6,1,5,光和,2024-06-07,6380
6285,啟��,5,0,5,光和,2024-06-07,6380
8054,安國,7,2,5,光和,2024-06-07,6380
2888,新光金,319,58,261,光和,2024-06-11,6380
2867,三商壽,429,199,230,光和,2024-06-11,6380
2002,中鋼,96,1,95,光和,2024-06-11,6380
00929,復華台灣科技優息,93,1,92,光和,2024-06-11,6380
2515,中工,96,9,87,光和,2024-06-11,6380
00918,大華優利高填息30,80,0,80,光和,2024-06-11,6380
00679B,元大美債20年,59,0,59,光和,2024-06-11,6380
2603,長榮,59,2,57,光和,2024-06-11,6380
1815,富喬,138,81,57,光和,2024-06-11,6380
4167,松瑞藥,64,8,56,光和,2024-06-11,6380
00936,台新永續高息中小,57,4,53,光和,2024-06-11,6380
2610,華航,162,115,47,光和,2024-06-11,6380
2374,佳能,56,13,43,光和,2024-06-11,6380
00637L,元大滬深300正2,38,0,38,光和,2024-06-11,6380
00919,群益台灣精選高息,38,1,37,光和,2024-06-11,6380
2542,興富發,36,0,36,光和,2024-06-11,6380
2609,陽明,275,240,35,光和,2024-06-11,6380
00687B,國泰20年美債,33,0,33,光和,2024-06-11,6380
3231,緯創,44,13,31,光和,2024-06-11,6380
2329,華泰,32,3,29,光和,2024-06-11,6380
2611,志信,30,1,29,光和,2024-06-11,6380
2062,橋椿,35,7,28,光和,2024-06-11,6380
2356,英業達,28,1,27,光和,2024-06-11,6380
2009,第一銅,39,15,24,光和,2024-06-11,6380
3059,華晶科,24,0,24,光和,2024-06-11,6380
8234,新漢,24,0,24,光和,2024-06-11,6380
00937B,群益ESG投等債20,115,92,23,光和,2024-06-11,6380
2353,宏��,57,35,22,光和,2024-06-11,6380
1582,信錦,25,4,21,光和,2024-06-11,6380
1457,宜進,20,0,20,光和,2024-06-11,6380
6264,富裔,20,0,20,光和,2024-06-11,6380
5347,世界,30,11,19,光和,2024-06-11,6380
4956,光鋐,20,1,19,光和,2024-06-11,6380
2354,鴻準,26,8,18,光和,2024-06-11,6380
2314,台揚,16,0,16,光和,2024-06-11,6380
00940,元大台灣價值高息,20,5,15,光和,2024-06-11,6380
6026,福邦證,14,0,14,光和,2024-06-11,6380
6215,和椿,17,3,14,光和,2024-06-11,6380
3024,憶聲,13,0,13,光和,2024-06-11,6380
6538,倉和,13,0,13,光和,2024-06-11,6380
8277,商丞,13,0,13,光和,2024-06-11,6380
2537,聯上發,13,1,12,光和,2024-06-11,6380
4566,時碩工業,12,0,12,光和,2024-06-11,6380
4967,十銓,19,7,12,光和,2024-06-11,6380
2801,彰銀,12,0,12,光和,2024-06-11,6380
1301,台塑,12,0,12,光和,2024-06-11,6380
2388,威盛,11,0,11,光和,2024-06-11,6380
00650L,復華香港正2,11,0,11,光和,2024-06-11,6380
2105,正新,11,0,11,光和,2024-06-11,6380
2605,新興,20,9,11,光和,2024-06-11,6380
2867,三商壽,467,117,350,光和,2024-06-12,6380
2888,新光金,341,148,193,光和,2024-06-12,6380
00948B,中信優息投資級債,149,0,149,光和,2024-06-12,6380
00918,大華優利高填息30,85,1,84,光和,2024-06-12,6380
9945,潤泰新,90,7,83,光和,2024-06-12,6380
00919,群益台灣精選高息,83,0,83,光和,2024-06-12,6380
5351,鈺創,51,2,49,光和,2024-06-12,6380
1101,台泥,41,1,40,光和,2024-06-12,6380
00878,國泰永續高股息,37,0,37,光和,2024-06-12,6380
5608,四維航,37,1,36,光和,2024-06-12,6380
00679B,元大美債20年,45,13,32,光和,2024-06-12,6380
00947,台新臺灣IC設計,30,0,30,光和,2024-06-12,6380
1457,宜進,30,0,30,光和,2024-06-12,6380
00687B,國泰20年美債,24,0,24,光和,2024-06-12,6380
2353,宏��,22,1,21,光和,2024-06-12,6380
2801,彰銀,22,1,21,光和,2024-06-12,6380
00673R,期元大S＆P原油反1,20,0,20,光和,2024-06-12,6380
2633,台灣高鐵,20,0,20,光和,2024-06-12,6380
3231,緯創,32,13,19,光和,2024-06-12,6380
1514,亞力,28,9,19,光和,2024-06-12,6380
00882,中信中國高股息,20,1,19,光和,2024-06-12,6380
2883,凱基金,49,30,19,光和,2024-06-12,6380
2002,中鋼,19,1,18,光和,2024-06-12,6380
3022,威強電,20,2,18,光和,2024-06-12,6380
00712,復華富時不動產,17,0,17,光和,2024-06-12,6380
00929,復華台灣科技優息,20,4,16,光和,2024-06-12,6380
2615,萬海,35,19,16,光和,2024-06-12,6380
6189,豐藝,18,2,16,光和,2024-06-12,6380
2605,新興,23,8,15,光和,2024-06-12,6380
00632R,元大台灣50反1,25,10,15,光和,2024-06-12,6380
2515,中工,15,0,15,光和,2024-06-12,6380
2617,台航,15,0,15,光和,2024-06-12,6380
3176,基亞,17,2,15,光和,2024-06-12,6380
2344,華邦電,17,4,13,光和,2024-06-12,6380
3576,聯合再生,13,0,13,光和,2024-06-12,6380
2409,友達,13,0,13,光和,2024-06-12,6380
4306,炎洲,15,2,13,光和,2024-06-12,6380
2905,三商,13,0,13,光和,2024-06-12,6380
2303,聯電,13,1,12,光和,2024-06-12,6380
2356,英業達,20,8,12,光和,2024-06-12,6380
1708,東鹼,12,0,12,光和,2024-06-12,6380
2371,大同,12,0,12,光和,2024-06-12,6380
2630,亞航,11,0,11,光和,2024-06-12,6380
3036,文曄,11,0,11,光和,2024-06-12,6380
00665L,富邦�琤肭磪囓�2,10,0,10,光和,2024-06-12,6380
2417,圓剛,10,0,10,光和,2024-06-12,6380
3014,聯陽,10,0,10,光和,2024-06-12,6380
3715,定穎投控,10,0,10,光和,2024-06-12,6380
4720,德淵,20,10,10,光和,2024-06-12,6380
4930,燦星網,10,0,10,光和,2024-06-12,6380
2867,三商壽,237,0,237,光和,2024-06-13,6380
2888,新光金,170,37,133,光和,2024-06-13,6380
00687B,國泰20年美債,125,11,114,光和,2024-06-13,6380
00936,台新永續高息中小,115,2,113,光和,2024-06-13,6380
3712,永崴投控,76,1,75,光和,2024-06-13,6380
2801,彰銀,68,0,68,光和,2024-06-13,6380
3029,零壹,52,1,51,光和,2024-06-13,6380
2618,長榮航,49,2,47,光和,2024-06-13,6380
00929,復華台灣科技優息,80,37,43,光和,2024-06-13,6380
2883B,凱基金乙特,40,0,40,光和,2024-06-13,6380
00915,凱基優選高股息30,39,0,39,光和,2024-06-13,6380
00948B,中信優息投資級債,39,0,39,光和,2024-06-13,6380
1609,大亞,48,11,37,光和,2024-06-13,6380
2464,盟立,46,13,33,光和,2024-06-13,6380
00692,富邦公司治理,30,2,28,光和,2024-06-13,6380
2836,高雄銀,25,0,25,光和,2024-06-13,6380
00632R,元大台灣50反1,48,24,24,光和,2024-06-13,6380
00919,群益台灣精選高息,25,2,23,光和,2024-06-13,6380
3059,華晶科,28,6,22,光和,2024-06-13,6380
2002,中鋼,25,3,22,光和,2024-06-13,6380
00947,台新臺灣IC設計,21,0,21,光和,2024-06-13,6380
5608,四維航,20,0,20,光和,2024-06-13,6380
6264,富裔,20,0,20,光和,2024-06-13,6380
3231,緯創,39,20,19,光和,2024-06-13,6380
6834,天二科技,19,0,19,光和,2024-06-13,6380
8110,華東,19,1,18,光和,2024-06-13,6380
4906,正文,19,1,18,光和,2024-06-13,6380
1815,富喬,34,17,17,光和,2024-06-13,6380
2354,鴻準,22,6,16,光和,2024-06-13,6380
6282,康舒,16,0,16,光和,2024-06-13,6380
1522,堤維西,16,2,14,光和,2024-06-13,6380
3373,熱映,14,0,14,光和,2024-06-13,6380
3576,聯合再生,13,0,13,光和,2024-06-13,6380
8011,台通,16,3,13,光和,2024-06-13,6380
1314,中石化,18,5,13,光和,2024-06-13,6380
2368,金像電,14,2,12,光和,2024-06-13,6380
1616,億泰,11,0,11,光和,2024-06-13,6380
2348A,海悅甲特,11,0,11,光和,2024-06-13,6380
2606,裕民,12,1,11,光和,2024-06-13,6380
2613,中櫃,15,4,11,光和,2024-06-13,6380
5251,天鉞電,11,0,11,光和,2024-06-13,6380
8234,新漢,11,0,11,光和,2024-06-13,6380
2611,志信,10,0,10,光和,2024-06-13,6380
6505,台塑化,10,0,10,光和,2024-06-13,6380
00673R,期元大S＆P原油反1,10,0,10,光和,2024-06-13,6380
00665L,富邦�琤肭磪囓�2,10,0,10,光和,2024-06-13,6380
00664R,國泰臺灣加權反1,10,0,10,光和,2024-06-13,6380
00941,中信上游半導體,11,1,10,光和,2024-06-13,6380
2007,燁興,10,0,10,光和,2024-06-13,6380
2885,元大金,10,0,10,光和,2024-06-13,6380
2867,三商壽,308,79,229,光和,2024-06-14,6380
2855,統一證,185,0,185,光和,2024-06-14,6380
00929,復華台灣科技優息,136,31,105,光和,2024-06-14,6380
2371,大同,123,57,66,光和,2024-06-14,6380
5347,世界,64,1,63,光和,2024-06-14,6380
5608,四維航,52,1,51,光和,2024-06-14,6380
00918,大華優利高填息30,46,0,46,光和,2024-06-14,6380
00946,群益科技高息成長,43,0,43,光和,2024-06-14,6380
2324,仁寶,43,8,35,光和,2024-06-14,6380
6116,彩晶,34,0,34,光和,2024-06-14,6380
00752,中信中國50,32,0,32,光和,2024-06-14,6380
2460,建通,30,0,30,光和,2024-06-14,6380
2886,兆豐金,30,1,29,光和,2024-06-14,6380
2105,正新,28,2,26,光和,2024-06-14,6380
2836,高雄銀,25,0,25,光和,2024-06-14,6380
2392,正崴,28,5,23,光和,2024-06-14,6380
2464,盟立,26,4,22,光和,2024-06-14,6380
6770,力積電,47,25,22,光和,2024-06-14,6380
00948B,中信優息投資級債,19,0,19,光和,2024-06-14,6380
2611,志信,33,14,19,光和,2024-06-14,6380
6209,今國光,19,0,19,光和,2024-06-14,6380
2002,中鋼,20,1,19,光和,2024-06-14,6380
2027,大成鋼,16,0,16,光和,2024-06-14,6380
2883B,凱基金乙特,16,0,16,光和,2024-06-14,6380
2401,凌陽,15,0,15,光和,2024-06-14,6380
5905,南仁湖,14,0,14,光和,2024-06-14,6380
2363,矽統,18,4,14,光和,2024-06-14,6380
2369,菱生,14,1,13,光和,2024-06-14,6380
1301,台塑,12,0,12,光和,2024-06-14,6380
2481,強茂,12,0,12,光和,2024-06-14,6380
6125,廣運,16,4,12,光和,2024-06-14,6380
3048,益登,21,10,11,光和,2024-06-14,6380
2801,彰銀,11,0,11,光和,2024-06-14,6380
8028,昇陽半導體,35,24,11,光和,2024-06-14,6380
2353,宏��,11,0,11,光和,2024-06-14,6380
00665L,富邦�琤肭磪囓�2,10,0,10,光和,2024-06-14,6380
00654R,富邦印度反1,10,0,10,光和,2024-06-14,6380
1717,長興,10,0,10,光和,2024-06-14,6380
2106,建大,10,0,10,光和,2024-06-14,6380
2890,永豐金,10,1,9,光和,2024-06-14,6380
2034,允強,9,0,9,光和,2024-06-14,6380
2492,華新科,12,3,9,光和,2024-06-14,6380
2641,正德,11,2,9,光和,2024-06-14,6380
4766,南寶,10,1,9,光和,2024-06-14,6380
2351,順德,8,0,8,光和,2024-06-14,6380
1587,吉茂,11,3,8,光和,2024-06-14,6380
2388,威盛,14,6,8,光和,2024-06-14,6380
3056,富華新,8,0,8,光和,2024-06-14,6380
3062,建漢,15,7,8,光和,2024-06-14,6380
3356,奇偶,9,1,8,光和,2024-06-14,6380
911868,同方友友-DR,324,0,324,光和,2024-06-17,6380
2371,大同,209,93,116,光和,2024-06-17,6380
00929,復華台灣科技優息,141,26,115,光和,2024-06-17,6380
9105,泰金寶-DR,104,10,94,光和,2024-06-17,6380
4123,晟德,108,15,93,光和,2024-06-17,6380
3710,連展投控,80,0,80,光和,2024-06-17,6380
3083,網龍,68,0,68,光和,2024-06-17,6380
6257,矽格,54,0,54,光和,2024-06-17,6380
2867,三商壽,54,0,54,光和,2024-06-17,6380
1618,合機,90,41,49,光和,2024-06-17,6380
00680L,元大美債20正2,45,1,44,光和,2024-06-17,6380
00864B,中信美國公債0-1,42,0,42,光和,2024-06-17,6380
2609,陽明,50,11,39,光和,2024-06-17,6380
2615,萬海,61,26,35,光和,2024-06-17,6380
00937B,群益ESG投等債20,39,5,34,光和,2024-06-17,6380
00940,元大台灣價值高息,43,13,30,光和,2024-06-17,6380
2515,中工,29,0,29,光和,2024-06-17,6380
1605,華新,45,19,26,光和,2024-06-17,6380
1316,上曜,24,0,24,光和,2024-06-17,6380
1514,亞力,32,8,24,光和,2024-06-17,6380
1503,士電,24,3,21,光和,2024-06-17,6380
2354,鴻準,23,3,20,光和,2024-06-17,6380
2897A,王道銀甲特,20,0,20,光和,2024-06-17,6380
3028,增你強,20,0,20,光和,2024-06-17,6380
4711,永純,20,0,20,光和,2024-06-17,6380
4967,十銓,18,0,18,光和,2024-06-17,6380
2915,潤泰全,18,0,18,光和,2024-06-17,6380
1711,永光,20,3,17,光和,2024-06-17,6380
3029,零壹,23,6,17,光和,2024-06-17,6380
2618,長榮航,20,3,17,光和,2024-06-17,6380
2634,漢翔,16,0,16,光和,2024-06-17,6380
00632R,元大台灣50反1,15,0,15,光和,2024-06-17,6380
2356,英業達,21,6,15,光和,2024-06-17,6380
3252,海灣,15,0,15,光和,2024-06-17,6380
2363,矽統,30,16,14,光和,2024-06-17,6380
00692,富邦公司治理,14,0,14,光和,2024-06-17,6380
2901,欣欣,13,0,13,光和,2024-06-17,6380
00881,國泰台灣5G+,12,0,12,光和,2024-06-17,6380
5905,南仁湖,13,1,12,光和,2024-06-17,6380
6269,台郡,12,0,12,光和,2024-06-17,6380
00885,富邦越南,11,0,11,光和,2024-06-17,6380
00882,中信中國高股息,11,0,11,光和,2024-06-17,6380
1905,華紙,11,0,11,光和,2024-06-17,6380
2607,榮運,11,0,11,光和,2024-06-17,6380
2801,彰銀,11,0,11,光和,2024-06-17,6380
6505,台塑化,10,0,10,光和,2024-06-17,6380
00637L,元大滬深300正2,10,0,10,光和,2024-06-17,6380
1457,宜進,10,0,10,光和,2024-06-17,6380
3037,欣興,11,1,10,光和,2024-06-17,6380
3202,樺晟,10,0,10,光和,2024-06-17,6380
4123,晟德,219,14,205,光和,2024-06-18,6380
00936,台新永續高息中小,158,0,158,光和,2024-06-18,6380
1815,富喬,131,26,105,光和,2024-06-18,6380
00934,中信成長高股息,75,0,75,光和,2024-06-18,6380
00687B,國泰20年美債,69,1,68,光和,2024-06-18,6380
6180,橘子,69,3,66,光和,2024-06-18,6380
2801,彰銀,60,1,59,光和,2024-06-18,6380
2371,大同,83,35,48,光和,2024-06-18,6380
00632R,元大台灣50反1,42,0,42,光和,2024-06-18,6380
00673R,期元大S＆P原油反1,40,0,40,光和,2024-06-18,6380
2464,盟立,42,3,39,光和,2024-06-18,6380
2353,宏��,38,0,38,光和,2024-06-18,6380
2034,允強,31,0,31,光和,2024-06-18,6380
1301,台塑,61,30,31,光和,2024-06-18,6380
6770,力積電,39,8,31,光和,2024-06-18,6380
2613,中櫃,29,0,29,光和,2024-06-18,6380
00919,群益台灣精選高息,49,22,27,光和,2024-06-18,6380
1708,東鹼,25,0,25,光和,2024-06-18,6380
2025,千興,23,0,23,光和,2024-06-18,6380
00692,富邦公司治理,20,0,20,光和,2024-06-18,6380
00946,群益科技高息成長,20,0,20,光和,2024-06-18,6380
1504,東元,20,0,20,光和,2024-06-18,6380
00947,台新臺灣IC設計,18,0,18,光和,2024-06-18,6380
2367,燿華,24,6,18,光和,2024-06-18,6380
8096,擎亞,70,53,17,光和,2024-06-18,6380
2515,中工,17,3,14,光和,2024-06-18,6380
00937B,群益ESG投等債20,26,12,14,光和,2024-06-18,6380
1314,中石化,15,1,14,光和,2024-06-18,6380
1905,華紙,14,0,14,光和,2024-06-18,6380
4711,永純,13,0,13,光和,2024-06-18,6380
6188,廣明,14,1,13,光和,2024-06-18,6380
5443,均豪,19,7,12,光和,2024-06-18,6380
3041,揚智,11,0,11,光和,2024-06-18,6380
5392,能率,12,1,11,光和,2024-06-18,6380
2317,鴻海,28,17,11,光和,2024-06-18,6380
2314,台揚,10,0,10,光和,2024-06-18,6380
00918,大華優利高填息30,34,24,10,光和,2024-06-18,6380
00671R,富邦NASDAQ反1,10,0,10,光和,2024-06-18,6380
00664R,國泰臺灣加權反1,10,0,10,光和,2024-06-18,6380
1711,永光,10,0,10,光和,2024-06-18,6380
2506,太設,10,0,10,光和,2024-06-18,6380
4968,立積,13,3,10,光和,2024-06-18,6380
6591,動力-KY,10,0,10,光和,2024-06-18,6380
8940,新天地,10,0,10,光和,2024-06-18,6380
6163,華電網,10,1,9,光和,2024-06-18,6380
6190,萬泰科,13,4,9,光和,2024-06-18,6380
00662,富邦NASDAQ,8,0,8,光和,2024-06-18,6380
00915,凱基優選高股息30,8,0,8,光和,2024-06-18,6380
00948B,中信優息投資級債,8,0,8,光和,2024-06-18,6380
2324,仁寶,13,5,8,光和,2024-06-18,6380
00948B,中信優息投資級債,210,0,210,光和,2024-06-19,6380
00940,元大台灣價值高息,229,27,202,光和,2024-06-19,6380
4123,晟德,134,0,134,光和,2024-06-19,6380
00665L,富邦�琤肭磪囓�2,105,0,105,光和,2024-06-19,6380
2344,華邦電,121,21,100,光和,2024-06-19,6380
2365,昆盈,236,139,97,光和,2024-06-19,6380
00936,台新永續高息中小,93,9,84,光和,2024-06-19,6380
00946,群益科技高息成長,54,0,54,光和,2024-06-19,6380
00679B,元大美債20年,44,0,44,光和,2024-06-19,6380
1616,億泰,41,0,41,光和,2024-06-19,6380
00673R,期元大S＆P原油反1,39,0,39,光和,2024-06-19,6380
1532,勤美,36,0,36,光和,2024-06-19,6380
6834,天二科技,34,0,34,光和,2024-06-19,6380
1301,台塑,33,0,33,光和,2024-06-19,6380
6658,聯策,33,2,31,光和,2024-06-19,6380
00937B,群益ESG投等債20,29,0,29,光和,2024-06-19,6380
3481,群創,42,18,24,光和,2024-06-19,6380
00918,大華優利高填息30,33,10,23,光和,2024-06-19,6380
00947,台新臺灣IC設計,22,0,22,光和,2024-06-19,6380
00915,凱基優選高股息30,22,0,22,光和,2024-06-19,6380
3231,緯創,56,35,21,光和,2024-06-19,6380
1326,台化,21,0,21,光和,2024-06-19,6380
2464,盟立,23,2,21,光和,2024-06-19,6380
2915,潤泰全,21,0,21,光和,2024-06-19,6380
1210,大成,20,0,20,光和,2024-06-19,6380
2801,彰銀,20,0,20,光和,2024-06-19,6380
3202,樺晟,21,1,20,光和,2024-06-19,6380
6546,正基,20,0,20,光和,2024-06-19,6380
1708,東鹼,20,1,19,光和,2024-06-19,6380
6706,惠特,24,5,19,光和,2024-06-19,6380
2634,漢翔,23,5,18,光和,2024-06-19,6380
3576,聯合再生,18,0,18,光和,2024-06-19,6380
1815,富喬,41,24,17,光和,2024-06-19,6380
3483,力致,17,0,17,光和,2024-06-19,6380
1802,台玻,29,13,16,光和,2024-06-19,6380
2353,宏��,33,17,16,光和,2024-06-19,6380
3715,定穎投控,16,0,16,光和,2024-06-19,6380
6425,易發,15,0,15,光和,2024-06-19,6380
6505,台塑化,14,0,14,光和,2024-06-19,6380
3029,零壹,15,1,14,光和,2024-06-19,6380
8064,東捷,27,13,14,光和,2024-06-19,6380
2330,台積電,17,4,13,光和,2024-06-19,6380
1504,東元,13,0,13,光和,2024-06-19,6380
2303,聯電,24,12,12,光和,2024-06-19,6380
6807,峰源-KY,12,0,12,光和,2024-06-19,6380
1905,華紙,11,0,11,光和,2024-06-19,6380
2460,建通,11,0,11,光和,2024-06-19,6380
4167,松瑞藥,11,0,11,光和,2024-06-19,6380
4968,立積,15,4,11,光和,2024-06-19,6380
5490,同亨,10,0,10,光和,2024-06-19,6380
00712,復華富時不動產,372,2,370,光和,2024-06-20,6380
0056,元大高股息,240,4,236,光和,2024-06-20,6380
00664R,國泰臺灣加權反1,150,0,150,光和,2024-06-20,6380
00632R,元大台灣50反1,123,0,123,光和,2024-06-20,6380
4123,晟德,129,19,110,光和,2024-06-20,6380
00891,中信關鍵半導體,101,0,101,光和,2024-06-20,6380
00927,群益半導體收益,100,10,90,光和,2024-06-20,6380
00929,復華台灣科技優息,88,7,81,光和,2024-06-20,6380
2365,昆盈,72,25,47,光和,2024-06-20,6380
00936,台新永續高息中小,52,7,45,光和,2024-06-20,6380
2356,英業達,76,31,45,光和,2024-06-20,6380
8096,擎亞,34,1,33,光和,2024-06-20,6380
1605,華新,58,27,31,光和,2024-06-20,6380
00940,元大台灣價值高息,145,114,31,光和,2024-06-20,6380
4766,南寶,29,0,29,光和,2024-06-20,6380
00937B,群益ESG投等債20,26,0,26,光和,2024-06-20,6380
00687B,國泰20年美債,20,0,20,光和,2024-06-20,6380
1532,勤美,19,0,19,光和,2024-06-20,6380
3583,辛耘,33,14,19,光和,2024-06-20,6380
2353,宏��,29,10,19,光和,2024-06-20,6380
5471,松翰,16,0,16,光和,2024-06-20,6380
6140,訊達,22,6,16,光和,2024-06-20,6380
1810,和成,15,0,15,光和,2024-06-20,6380
3048,益登,17,2,15,光和,2024-06-20,6380
2888,新光金,25,10,15,光和,2024-06-20,6380
2887,台新金,15,1,14,光和,2024-06-20,6380
2382,廣達,28,14,14,光和,2024-06-20,6380
2615,萬海,26,12,14,光和,2024-06-20,6380
2034,允強,14,1,13,光和,2024-06-20,6380
2405,輔信,15,2,13,光和,2024-06-20,6380
2498,宏達電,20,7,13,光和,2024-06-20,6380
6244,茂迪,13,0,13,光和,2024-06-20,6380
3339,泰谷,12,0,12,光和,2024-06-20,6380
1785,光洋科,20,8,12,光和,2024-06-20,6380
1301,台塑,11,0,11,光和,2024-06-20,6380
2460,建通,11,0,11,光和,2024-06-20,6380
3703,欣陸,11,0,11,光和,2024-06-20,6380
00665L,富邦�琤肭磪囓�2,10,0,10,光和,2024-06-20,6380
00753L,中信中國50正2,10,0,10,光和,2024-06-20,6380
00942B,台新美A公司債20+,10,0,10,光和,2024-06-20,6380
1702,南僑,10,0,10,光和,2024-06-20,6380
4958,臻鼎-KY,11,1,10,光和,2024-06-20,6380
6227,茂綸,11,1,10,光和,2024-06-20,6380
8112,至上,15,5,10,光和,2024-06-20,6380
6163,華電網,10,1,9,光和,2024-06-20,6380
4306,炎洲,9,0,9,光和,2024-06-20,6380
8011,台通,12,3,9,光和,2024-06-20,6380
2464,盟立,16,7,9,光和,2024-06-20,6380
1514,亞力,18,10,8,光和,2024-06-20,6380
1210,大成,10,2,8,光和,2024-06-20,6380
5315,光聯,251,0,251,光和,2024-06-21,6380
1605,華新,178,0,178,光和,2024-06-21,6380
0056,元大高股息,127,2,125,光和,2024-06-21,6380
00706L,期元大S＆P日圓正2,100,0,100,光和,2024-06-21,6380
2801,彰銀,68,3,65,光和,2024-06-21,6380
4123,晟德,55,2,53,光和,2024-06-21,6380
2317,鴻海,68,15,53,光和,2024-06-21,6380
8096,擎亞,51,0,51,光和,2024-06-21,6380
00929,復華台灣科技優息,77,28,49,光和,2024-06-21,6380
00936,台新永續高息中小,43,0,43,光和,2024-06-21,6380
00632R,元大台灣50反1,60,20,40,光和,2024-06-21,6380
2707,晶華,40,0,40,光和,2024-06-21,6380
3706,神達,41,1,40,光和,2024-06-21,6380
5347,世界,35,1,34,光和,2024-06-21,6380
4956,光鋐,56,23,33,光和,2024-06-21,6380
1517,利奇,30,0,30,光和,2024-06-21,6380
3062,建漢,45,16,29,光和,2024-06-21,6380
1532,勤美,28,0,28,光和,2024-06-21,6380
00637L,元大滬深300正2,29,3,26,光和,2024-06-21,6380
2609,陽明,98,72,26,光和,2024-06-21,6380
00753L,中信中國50正2,25,0,25,光和,2024-06-21,6380
2365,昆盈,32,7,25,光和,2024-06-21,6380
1802,台玻,23,0,23,光和,2024-06-21,6380
00882,中信中國高股息,22,0,22,光和,2024-06-21,6380
00679B,元大美債20年,32,10,22,光和,2024-06-21,6380
1301,台塑,27,6,21,光和,2024-06-21,6380
2607,榮運,20,0,20,光和,2024-06-21,6380
00650L,復華香港正2,20,1,19,光和,2024-06-21,6380
1609,大亞,24,5,19,光和,2024-06-21,6380
6901,鑽石投資,21,2,19,光和,2024-06-21,6380
2027,大成鋼,22,4,18,光和,2024-06-21,6380
2382,廣達,23,6,17,光和,2024-06-21,6380
2603,長榮,18,2,16,光和,2024-06-21,6380
2498,宏達電,42,26,16,光和,2024-06-21,6380
2608,嘉里大榮,17,1,16,光和,2024-06-21,6380
9945,潤泰新,16,0,16,光和,2024-06-21,6380
00878,國泰永續高股息,18,3,15,光和,2024-06-21,6380
6788,華景電,15,0,15,光和,2024-06-21,6380
2031,新光鋼,14,0,14,光和,2024-06-21,6380
00881,國泰台灣5G+,14,0,14,光和,2024-06-21,6380
2353,宏��,23,10,13,光和,2024-06-21,6380
00891,中信關鍵半導體,12,0,12,光和,2024-06-21,6380
1303,南亞,11,0,11,光和,2024-06-21,6380
00933B,國泰10Y+金融債,11,0,11,光和,2024-06-21,6380
00712,復華富時不動產,19,8,11,光和,2024-06-21,6380
00902,中信電池及儲能,11,0,11,光和,2024-06-21,6380
2867,三商壽,11,0,11,光和,2024-06-21,6380
4909,新復興,13,2,11,光和,2024-06-21,6380
6264,富裔,11,0,11,光和,2024-06-21,6380
6770,力積電,20,9,11,光和,2024-06-21,6380
00919,群益台灣精選高息,278,60,218,光和,2024-06-24,6380
1447,力鵬,200,0,200,光和,2024-06-24,6380
3481,群創,403,205,198,光和,2024-06-24,6380
00940,元大台灣價值高息,219,36,183,光和,2024-06-24,6380
00878,國泰永續高股息,136,10,126,光和,2024-06-24,6380
00706L,期元大S＆P日圓正2,125,0,125,光和,2024-06-24,6380
8011,台通,100,1,99,光和,2024-06-24,6380
00936,台新永續高息中小,80,0,80,光和,2024-06-24,6380
2344,華邦電,74,6,68,光和,2024-06-24,6380
1101,台泥,63,0,63,光和,2024-06-24,6380
4123,晟德,55,1,54,光和,2024-06-24,6380
00929,復華台灣科技優息,89,42,47,光和,2024-06-24,6380
00712,復華富時不動產,70,27,43,光和,2024-06-24,6380
2615,萬海,45,5,40,光和,2024-06-24,6380
2438,翔耀,38,0,38,光和,2024-06-24,6380
6257,矽格,35,0,35,光和,2024-06-24,6380
8374,羅昇,35,1,34,光和,2024-06-24,6380
2369,菱生,39,6,33,光和,2024-06-24,6380
6770,力積電,32,0,32,光和,2024-06-24,6380
2611,志信,31,0,31,光和,2024-06-24,6380
3689,湧德,31,0,31,光和,2024-06-24,6380
2408,南亞科,42,12,30,光和,2024-06-24,6380
2353,宏��,29,0,29,光和,2024-06-24,6380
1609,大亞,27,2,25,光和,2024-06-24,6380
3029,零壹,30,8,22,光和,2024-06-24,6380
2409,友達,24,2,22,光和,2024-06-24,6380
3062,建漢,66,44,22,光和,2024-06-24,6380
6180,橘子,22,0,22,光和,2024-06-24,6380
4989,榮科,21,0,21,光和,2024-06-24,6380
6188,廣明,23,2,21,光和,2024-06-24,6380
0056,元大高股息,25,5,20,光和,2024-06-24,6380
2468,華經,20,0,20,光和,2024-06-24,6380
2607,榮運,20,0,20,光和,2024-06-24,6380
5315,光聯,20,0,20,光和,2024-06-24,6380
5515,建國,20,0,20,光和,2024-06-24,6380
1785,光洋科,27,7,20,光和,2024-06-24,6380
00947,台新臺灣IC設計,19,0,19,光和,2024-06-24,6380
2106,建大,20,1,19,光和,2024-06-24,6380
00905,FT臺灣Smart,19,0,19,光和,2024-06-24,6380
5328,華容,23,5,18,光和,2024-06-24,6380
3703,欣陸,16,0,16,光和,2024-06-24,6380
1303,南亞,15,0,15,光和,2024-06-24,6380
00650L,復華香港正2,15,0,15,光和,2024-06-24,6380
2382,廣達,23,8,15,光和,2024-06-24,6380
2324,仁寶,14,0,14,光和,2024-06-24,6380
2355,敬鵬,30,16,14,光和,2024-06-24,6380
00881,國泰台灣5G+,13,0,13,光和,2024-06-24,6380
1319,東陽,13,0,13,光和,2024-06-24,6380
3260,威剛,14,1,13,光和,2024-06-24,6380
3321,同泰,13,0,13,光和,2024-06-24,6380
3481,群創,353,93,260,光和,2024-06-25,6380
2406,國碩,132,4,128,光和,2024-06-25,6380
00919,群益台灣精選高息,130,30,100,光和,2024-06-25,6380
2344,華邦電,100,6,94,光和,2024-06-25,6380
2409,友達,71,1,70,光和,2024-06-25,6380
3312,弘憶股,64,2,62,光和,2024-06-25,6380
5347,世界,49,0,49,光和,2024-06-25,6380
00929,復華台灣科技優息,68,22,46,光和,2024-06-25,6380
00673R,期元大S＆P原油反1,42,0,42,光和,2024-06-25,6380
00885,富邦越南,41,0,41,光和,2024-06-25,6380
00936,台新永續高息中小,33,0,33,光和,2024-06-25,6380
5439,高技,31,0,31,光和,2024-06-25,6380
9933,中鼎,30,0,30,光和,2024-06-25,6380
2303,聯電,48,19,29,光和,2024-06-25,6380
2438,翔耀,29,0,29,光和,2024-06-25,6380
2002,中鋼,27,0,27,光和,2024-06-25,6380
2489,瑞軒,25,0,25,光和,2024-06-25,6380
6770,力積電,27,2,25,光和,2024-06-25,6380
5009,榮剛,24,1,23,光和,2024-06-25,6380
00713,元大台灣高息低波,24,2,22,光和,2024-06-25,6380
8110,華東,27,5,22,光和,2024-06-25,6380
2352,佳世達,35,15,20,光和,2024-06-25,6380
2369,菱生,24,5,19,光和,2024-06-25,6380
3305,昇貿,19,0,19,光和,2024-06-25,6380
4958,臻鼎-KY,19,2,17,光和,2024-06-25,6380
0056,元大高股息,21,5,16,光和,2024-06-25,6380
3615,安可,17,1,16,光和,2024-06-25,6380
00939,統一台灣高息動能,15,0,15,光和,2024-06-25,6380
1711,永光,12,0,12,光和,2024-06-25,6380
2610,華航,12,0,12,光和,2024-06-25,6380
8064,東捷,22,10,12,光和,2024-06-25,6380
5452,佶優,13,1,12,光和,2024-06-25,6380
2313,華通,11,0,11,光和,2024-06-25,6380
5328,華容,13,2,11,光和,2024-06-25,6380
6449,鈺邦,11,1,10,光和,2024-06-25,6380
1307,三芳,10,0,10,光和,2024-06-25,6380
1532,勤美,10,0,10,光和,2024-06-25,6380
1584,精剛,10,0,10,光和,2024-06-25,6380
1603,華電,10,0,10,光和,2024-06-25,6380
2025,千興,10,0,10,光和,2024-06-25,6380
2338,光罩,10,0,10,光和,2024-06-25,6380
6834,天二科技,10,0,10,光和,2024-06-25,6380
9950,萬國通,10,0,10,光和,2024-06-25,6380
6788,華景電,10,0,10,光和,2024-06-25,6380
2324,仁寶,10,0,10,光和,2024-06-25,6380
3037,欣興,9,0,9,光和,2024-06-25,6380
3580,友威科,13,4,9,光和,2024-06-25,6380
2330,台積電,11,3,8,光和,2024-06-25,6380
3048,益登,14,5,9,光和,2024-06-25,6380
00940,元大台灣價值高息,43,35,8,光和,2024-06-25,6380
2409,友達,70,2,68,光和,2024-06-26,6380
00937B,群益ESG投等債20,57,0,57,光和,2024-06-26,6380
4123,晟德,56,2,54,光和,2024-06-26,6380
1303,南亞,44,0,44,光和,2024-06-26,6380
00940,元大台灣價值高息,40,0,40,光和,2024-06-26,6380
00919,群益台灣精選高息,43,11,32,光和,2024-06-26,6380
2002,中鋼,31,1,30,光和,2024-06-26,6380
1532,勤美,26,0,26,光和,2024-06-26,6380
3576,聯合再生,28,5,23,光和,2024-06-26,6380
2615,萬海,30,7,23,光和,2024-06-26,6380
1301,台塑,22,0,22,光和,2024-06-26,6380
1909,榮成,22,0,22,光和,2024-06-26,6380
2312,金寶,41,20,21,光和,2024-06-26,6380
00946,群益科技高息成長,20,0,20,光和,2024-06-26,6380
00936,台新永續高息中小,19,0,19,光和,2024-06-26,6380
3686,達能,20,1,19,光和,2024-06-26,6380
00752,中信中國50,18,0,18,光和,2024-06-26,6380
2603,長榮,19,2,17,光和,2024-06-26,6380
2371,大同,23,7,16,光和,2024-06-26,6380
6425,易發,20,4,16,光和,2024-06-26,6380
2890,永豐金,36,20,16,光和,2024-06-26,6380
2317,鴻海,33,17,16,光和,2024-06-26,6380
2303,聯電,18,3,15,光和,2024-06-26,6380
1618,合機,16,1,15,光和,2024-06-26,6380
2607,榮運,15,0,15,光和,2024-06-26,6380
4967,十銓,22,7,15,光和,2024-06-26,6380
8150,南茂,15,0,15,光和,2024-06-26,6380
5469,瀚宇博,14,0,14,光和,2024-06-26,6380
6244,茂迪,14,0,14,光和,2024-06-26,6380
6579,研揚,14,0,14,光和,2024-06-26,6380
1540,喬福,15,2,13,光和,2024-06-26,6380
2204,中華,13,0,13,光和,2024-06-26,6380
3715,定穎投控,13,0,13,光和,2024-06-26,6380
2344,華邦電,12,0,12,光和,2024-06-26,6380
00929,復華台灣科技優息,20,8,12,光和,2024-06-26,6380
00882,中信中國高股息,12,0,12,光和,2024-06-26,6380
2610,華航,17,5,12,光和,2024-06-26,6380
6182,合晶,12,0,12,光和,2024-06-26,6380
2353,宏��,11,0,11,光和,2024-06-26,6380
3163,波若威,16,5,11,光和,2024-06-26,6380
0056,元大高股息,14,3,11,光和,2024-06-26,6380
1304,台聚,21,10,11,光和,2024-06-26,6380
3713,新晶投控,11,0,11,光和,2024-06-26,6380
1905,華紙,10,0,10,光和,2024-06-26,6380
2515,中工,10,0,10,光和,2024-06-26,6380
5452,佶優,10,0,10,光和,2024-06-26,6380
8104,錸寶,10,0,10,光和,2024-06-26,6380
00881,國泰台灣5G+,9,0,9,光和,2024-06-26,6380
2374,佳能,15,6,9,光和,2024-06-26,6380
6695,芯鼎,10,1,9,光和,2024-06-26,6380
00929,復華台灣科技優息,121,1,120,光和,2024-06-27,6380
3481,群創,129,13,116,光和,2024-06-27,6380
00936,台新永續高息中小,70,0,70,光和,2024-06-27,6380
00933B,國泰10Y+金融債,60,0,60,光和,2024-06-27,6380
00665L,富邦�琤肭磪囓�2,51,0,51,光和,2024-06-27,6380
1708,東鹼,50,0,50,光和,2024-06-27,6380
00940,元大台灣價值高息,49,0,49,光和,2024-06-27,6380
00937B,群益ESG投等債20,45,0,45,光和,2024-06-27,6380
1785,光洋科,46,4,42,光和,2024-06-27,6380
00679B,元大美債20年,38,0,38,光和,2024-06-27,6380
4938,和碩,38,0,38,光和,2024-06-27,6380
1605,華新,70,35,35,光和,2024-06-27,6380
5347,世界,33,2,31,光和,2024-06-27,6380
00882,中信中國高股息,30,0,30,光和,2024-06-27,6380
2344,華邦電,38,8,30,光和,2024-06-27,6380
4953,緯軟,28,0,28,光和,2024-06-27,6380
912000,晨訊科-DR,27,0,27,光和,2024-06-27,6380
2363,矽統,30,4,26,光和,2024-06-27,6380
00706L,期元大S＆P日圓正2,25,0,25,光和,2024-06-27,6380
2464,盟立,30,5,25,光和,2024-06-27,6380
3029,零壹,29,4,25,光和,2024-06-27,6380
2885,元大金,34,10,24,光和,2024-06-27,6380
2888,新光金,27,3,24,光和,2024-06-27,6380
00919,群益台灣精選高息,24,1,23,光和,2024-06-27,6380
2106,建大,23,0,23,光和,2024-06-27,6380
9945,潤泰新,27,4,23,光和,2024-06-27,6380
00948B,中信優息投資級債,21,0,21,光和,2024-06-27,6380
00878,國泰永續高股息,21,0,21,光和,2024-06-27,6380
00687B,國泰20年美債,20,0,20,光和,2024-06-27,6380
00752,中信中國50,20,0,20,光和,2024-06-27,6380
1434,福懋,20,0,20,光和,2024-06-27,6380
6015,宏遠證,20,0,20,光和,2024-06-27,6380
2867,三商壽,23,4,19,光和,2024-06-27,6380
3455,由田,20,1,19,光和,2024-06-27,6380
2883,凱基金,19,1,18,光和,2024-06-27,6380
2354,鴻準,22,5,17,光和,2024-06-27,6380
00918,大華優利高填息30,16,0,16,光和,2024-06-27,6380
00939,統一台灣高息動能,16,0,16,光和,2024-06-27,6380
6834,天二科技,16,0,16,光和,2024-06-27,6380
00650L,復華香港正2,14,0,14,光和,2024-06-27,6380
2371,大同,15,1,14,光和,2024-06-27,6380
2641,正德,15,1,14,光和,2024-06-27,6380
5443,均豪,21,7,14,光和,2024-06-27,6380
6147,頎邦,14,0,14,光和,2024-06-27,6380
00947,台新臺灣IC設計,13,0,13,光和,2024-06-27,6380
2324,仁寶,14,1,13,光和,2024-06-27,6380
3047,訊舟,20,7,13,光和,2024-06-27,6380
3450,聯鈞,44,31,13,光和,2024-06-27,6380
0056,元大高股息,13,0,13,光和,2024-06-27,6380
6806,森崴能源,23,11,12,光和,2024-06-27,6380
0056,元大高股息,126,0,126,光和,2024-06-28,6380
00712,復華富時不動產,84,0,84,光和,2024-06-28,6380
3712,永崴投控,80,0,80,光和,2024-06-28,6380
1781,合世,66,0,66,光和,2024-06-28,6380
3481,群創,204,152,52,光和,2024-06-28,6380
00752,中信中國50,50,0,50,光和,2024-06-28,6380
3312,弘憶股,72,22,50,光和,2024-06-28,6380
1712,興農,50,5,45,光和,2024-06-28,6380
6116,彩晶,51,16,35,光和,2024-06-28,6380
00632R,元大台灣50反1,30,0,30,光和,2024-06-28,6380
2352,佳世達,30,0,30,光和,2024-06-28,6380
00936,台新永續高息中小,28,0,28,光和,2024-06-28,6380
2106,建大,28,0,28,光和,2024-06-28,6380
2101,南港,26,1,25,光和,2024-06-28,6380
00706L,期元大S＆P日圓正2,25,0,25,光和,2024-06-28,6380
6182,合晶,25,0,25,光和,2024-06-28,6380
2301,光寶科,27,3,24,光和,2024-06-28,6380
1718,中纖,30,7,23,光和,2024-06-28,6380
3038,全台,21,0,21,光和,2024-06-28,6380
3078,僑威,21,0,21,光和,2024-06-28,6380
3576,聯合再生,78,58,20,光和,2024-06-28,6380
00929,復華台灣科技優息,21,1,20,光和,2024-06-28,6380
00933B,國泰10Y+金融債,20,0,20,光和,2024-06-28,6380
00673R,期元大S＆P原油反1,20,0,20,光和,2024-06-28,6380
3432,台端,20,0,20,光和,2024-06-28,6380
2406,國碩,47,27,20,光和,2024-06-28,6380
3689,湧德,21,3,18,光和,2024-06-28,6380
2337,旺宏,35,21,14,光和,2024-06-28,6380
1532,勤美,13,0,13,光和,2024-06-28,6380
1809,中釉,13,0,13,光和,2024-06-28,6380
2324,仁寶,15,2,13,光和,2024-06-28,6380
3508,位速,14,1,13,光和,2024-06-28,6380
00679B,元大美債20年,18,6,12,光和,2024-06-28,6380
2009,第一銅,12,0,12,光和,2024-06-28,6380
00946,群益科技高息成長,11,0,11,光和,2024-06-28,6380
00687B,國泰20年美債,11,0,11,光和,2024-06-28,6380
6274,台燿,12,1,11,光和,2024-06-28,6380
00664R,國泰臺灣加權反1,10,0,10,光和,2024-06-28,6380
1905,華紙,10,0,10,光和,2024-06-28,6380
2362,藍天,10,0,10,光和,2024-06-28,6380
2884,玉山金,11,1,10,光和,2024-06-28,6380
3504,揚明光,10,0,10,光和,2024-06-28,6380
4129,聯合,13,3,10,光和,2024-06-28,6380
4714,永捷,10,0,10,光和,2024-06-28,6380
6290,良維,15,5,10,光和,2024-06-28,6380
6668,中揚光,11,1,10,光和,2024-06-28,6380
1319,東陽,9,0,9,光和,2024-06-28,6380
2515,中工,20,11,9,光和,2024-06-28,6380
2887,台新金,20,11,9,光和,2024-06-28,6380
3260,威剛,10,1,9,光和,2024-06-28,6380
00937B,群益ESG投等債20,191,20,171,光和,2024-07-01,6380
00936,台新永續高息中小,70,2,68,光和,2024-07-01,6380
00687B,國泰20年美債,64,0,64,光和,2024-07-01,6380
2316,楠梓電,53,2,51,光和,2024-07-01,6380
2337,旺宏,67,18,49,光和,2024-07-01,6380
2349,錸德,57,8,49,光和,2024-07-01,6380
00933B,國泰10Y+金融債,47,0,47,光和,2024-07-01,6380
00949,復華日本龍頭,44,0,44,光和,2024-07-01,6380
00679B,元大美債20年,60,19,41,光和,2024-07-01,6380
00918,大華優利高填息30,40,0,40,光和,2024-07-01,6380
2417,圓剛,40,6,34,光和,2024-07-01,6380
2883,凱基金,33,0,33,光和,2024-07-01,6380
3715,定穎投控,33,1,32,光和,2024-07-01,6380
00948B,中信優息投資級債,31,0,31,光和,2024-07-01,6380
00929,復華台灣科技優息,99,68,31,光和,2024-07-01,6380
2605,新興,31,0,31,光和,2024-07-01,6380
1584,精剛,30,0,30,光和,2024-07-01,6380
6153,嘉聯益,30,0,30,光和,2024-07-01,6380
0056,元大高股息,28,0,28,光和,2024-07-01,6380
2313,華通,52,25,27,光和,2024-07-01,6380
1101,台泥,29,4,25,光和,2024-07-01,6380
00706L,期元大S＆P日圓正2,25,0,25,光和,2024-07-01,6380
4167,松瑞藥,23,0,23,光和,2024-07-01,6380
3576,聯合再生,26,3,23,光和,2024-07-01,6380
3038,全台,21,0,21,光和,2024-07-01,6380
3520,華盈,23,2,21,光和,2024-07-01,6380
2031,新光鋼,20,0,20,光和,2024-07-01,6380
2484,希華,20,0,20,光和,2024-07-01,6380
6129,普誠,20,0,20,光和,2024-07-01,6380
2515,中工,31,12,19,光和,2024-07-01,6380
00720B,元大投資級公司債,18,0,18,光和,2024-07-01,6380
4967,十銓,20,2,18,光和,2024-07-01,6380
5498,凱崴,25,7,18,光和,2024-07-01,6380
00671R,富邦NASDAQ反1,17,0,17,光和,2024-07-01,6380
3372,典範,15,0,15,光和,2024-07-01,6380
3498,陽程,15,0,15,光和,2024-07-01,6380
2609,陽明,39,24,15,光和,2024-07-01,6380
2324,仁寶,14,0,14,光和,2024-07-01,6380
2351,順德,14,0,14,光和,2024-07-01,6380
3260,威剛,13,0,13,光和,2024-07-01,6380
4714,永捷,13,0,13,光和,2024-07-01,6380
6215,和椿,34,21,13,光和,2024-07-01,6380
2882,國泰金,13,0,13,光和,2024-07-01,6380
2002,中鋼,12,0,12,光和,2024-07-01,6380
1809,中釉,14,2,12,光和,2024-07-01,6380
2607,榮運,12,0,12,光和,2024-07-01,6380
3512,皇龍,12,0,12,光和,2024-07-01,6380
3105,穩懋,14,2,12,光和,2024-07-01,6380
3535,晶彩科,13,2,11,光和,2024-07-01,6380
1587,吉茂,14,3,11,光和,2024-07-01,6380
2303,聯電,194,12,182,光和,2024-07-02,6380
00934,中信成長高股息,185,9,176,光和,2024-07-02,6380
00937B,群益ESG投等債20,112,0,112,光和,2024-07-02,6380
2317,鴻海,79,5,74,光和,2024-07-02,6380
1608,華榮,66,2,64,光和,2024-07-02,6380
00936,台新永續高息中小,55,0,55,光和,2024-07-02,6380
00929,復華台灣科技優息,133,78,55,光和,2024-07-02,6380
2208,台船,52,0,52,光和,2024-07-02,6380
3481,群創,51,4,47,光和,2024-07-02,6380
3312,弘憶股,69,30,39,光和,2024-07-02,6380
9105,泰金寶-DR,44,5,39,光和,2024-07-02,6380
00687B,國泰20年美債,38,0,38,光和,2024-07-02,6380
2002,中鋼,36,1,35,光和,2024-07-02,6380
0056,元大高股息,32,0,32,光和,2024-07-02,6380
00679B,元大美債20年,30,0,30,光和,2024-07-02,6380
3702,大聯大,28,0,28,光和,2024-07-02,6380
3715,定穎投控,27,0,27,光和,2024-07-02,6380
00712,復華富時不動產,27,0,27,光和,2024-07-02,6380
00940,元大台灣價值高息,28,2,26,光和,2024-07-02,6380
1301,台塑,26,0,26,光和,2024-07-02,6380
00949,復華日本龍頭,26,0,26,光和,2024-07-02,6380
1785,光洋科,34,8,26,光和,2024-07-02,6380
00931B,統一美債20年,25,0,25,光和,2024-07-02,6380
2417,圓剛,27,2,25,光和,2024-07-02,6380
4746,台耀,25,0,25,光和,2024-07-02,6380
5452,佶優,26,1,25,光和,2024-07-02,6380
2637,慧洋-KY,24,2,22,光和,2024-07-02,6380
2464,盟立,29,8,21,光和,2024-07-02,6380
5315,光聯,21,0,21,光和,2024-07-02,6380
2365,昆盈,62,42,20,光和,2024-07-02,6380
00673R,期元大S＆P原油反1,20,0,20,光和,2024-07-02,6380
2489,瑞軒,20,0,20,光和,2024-07-02,6380
3202,樺晟,20,0,20,光和,2024-07-02,6380
3432,台端,20,0,20,光和,2024-07-02,6380
1532,勤美,19,0,19,光和,2024-07-02,6380
6188,廣明,22,3,19,光和,2024-07-02,6380
1303,南亞,19,1,18,光和,2024-07-02,6380
2324,仁寶,18,1,17,光和,2024-07-02,6380
6285,啟��,17,0,17,光和,2024-07-02,6380
3231,緯創,19,2,17,光和,2024-07-02,6380
1584,精剛,16,0,16,光和,2024-07-02,6380
1304,台聚,15,0,15,光和,2024-07-02,6380
2609,陽明,59,44,15,光和,2024-07-02,6380
6153,嘉聯益,20,5,15,光和,2024-07-02,6380
2451,創見,14,0,14,光和,2024-07-02,6380
2891,中信金,15,1,14,光和,2024-07-02,6380
3622,洋華,14,0,14,光和,2024-07-02,6380
00680L,元大美債20正2,13,0,13,光和,2024-07-02,6380
2883,凱基金,13,0,13,光和,2024-07-02,6380
00948B,中信優息投資級債,13,0,13,光和,2024-07-02,6380
00632R,元大台灣50反1,331,0,331,光和,2024-07-03,6380
1447,力鵬,101,16,85,光和,2024-07-03,6380
2323,中環,114,31,83,光和,2024-07-03,6380
00680L,元大美債20正2,60,0,60,光和,2024-07-03,6380
3689,湧德,60,1,59,光和,2024-07-03,6380
2402,毅嘉,58,5,53,光和,2024-07-03,6380
00934,中信成長高股息,45,0,45,光和,2024-07-03,6380
2317,鴻海,40,2,38,光和,2024-07-03,6380
00687B,國泰20年美債,37,0,37,光和,2024-07-03,6380
0056,元大高股息,46,11,35,光和,2024-07-03,6380
2489,瑞軒,36,1,35,光和,2024-07-03,6380
3376,新日興,35,0,35,光和,2024-07-03,6380
2356,英業達,43,12,31,光和,2024-07-03,6380
2484,希華,30,0,30,光和,2024-07-03,6380
2105,正新,27,0,27,光和,2024-07-03,6380
1605,華新,22,0,22,光和,2024-07-03,6380
8064,東捷,25,3,22,光和,2024-07-03,6380
1609,大亞,29,8,21,光和,2024-07-03,6380
3062,建漢,26,5,21,光和,2024-07-03,6380
00671R,富邦NASDAQ反1,20,0,20,光和,2024-07-03,6380
00753L,中信中國50正2,20,0,20,光和,2024-07-03,6380
2352,佳世達,27,7,20,光和,2024-07-03,6380
4123,晟德,40,20,20,光和,2024-07-03,6380
4906,正文,29,9,20,光和,2024-07-03,6380
1718,中纖,21,1,20,光和,2024-07-03,6380
2609,陽明,59,40,19,光和,2024-07-03,6380
5347,世界,21,2,19,光和,2024-07-03,6380
3305,昇貿,19,1,18,光和,2024-07-03,6380
3576,聯合再生,121,104,17,光和,2024-07-03,6380
2374,佳能,22,5,17,光和,2024-07-03,6380
4711,永純,16,0,16,光和,2024-07-03,6380
5471,松翰,16,0,16,光和,2024-07-03,6380
3029,零壹,47,32,15,光和,2024-07-03,6380
3059,華晶科,16,1,15,光和,2024-07-03,6380
1504,東元,14,0,14,光和,2024-07-03,6380
00929,復華台灣科技優息,20,7,13,光和,2024-07-03,6380
2495,普安,23,10,13,光和,2024-07-03,6380
2891,中信金,15,2,13,光和,2024-07-03,6380
3686,達能,14,1,13,光和,2024-07-03,6380
3703,欣陸,13,0,13,光和,2024-07-03,6380
3060,銘異,16,3,13,光和,2024-07-03,6380
1802,台玻,13,0,13,光和,2024-07-03,6380
1608,華榮,15,2,13,光和,2024-07-03,6380
2303,聯電,29,17,12,光和,2024-07-03,6380
00949,復華日本龍頭,12,0,12,光和,2024-07-03,6380
00679B,元大美債20年,12,0,12,光和,2024-07-03,6380
6285,啟��,13,2,11,光和,2024-07-03,6380
6443,元晶,61,50,11,光和,2024-07-03,6380
2208,台船,10,0,10,光和,2024-07-03,6380
00706L,期元大S＆P日圓正2,10,0,10,光和,2024-07-03,6380
00632R,元大台灣50反1,313,100,213,光和,2024-07-04,6380
5347,世界,98,2,96,光和,2024-07-04,6380
00934,中信成長高股息,93,0,93,光和,2024-07-04,6380
2405,輔信,88,34,54,光和,2024-07-04,6380
3576,聯合再生,51,16,35,光和,2024-07-04,6380
2412,中華電,39,4,35,光和,2024-07-04,6380
2609,陽明,55,21,34,光和,2024-07-04,6380
2324,仁寶,34,2,32,光和,2024-07-04,6380
6531,愛普*,39,8,31,光和,2024-07-04,6380
1454,台富,30,0,30,光和,2024-07-04,6380
1815,富喬,60,30,30,光和,2024-07-04,6380
3189,景碩,27,0,27,光和,2024-07-04,6380
2618,長榮航,32,9,23,光和,2024-07-04,6380
6142,友勁,25,2,23,光和,2024-07-04,6380
00949,復華日本龍頭,22,0,22,光和,2024-07-04,6380
6147,頎邦,22,0,22,光和,2024-07-04,6380
2527,宏璟,21,0,21,光和,2024-07-04,6380
00679B,元大美債20年,21,1,20,光和,2024-07-04,6380
4711,永純,20,0,20,光和,2024-07-04,6380
8104,錸寶,28,9,19,光和,2024-07-04,6380
4956,光鋐,21,3,18,光和,2024-07-04,6380
2354,鴻準,36,19,17,光和,2024-07-04,6380
1101,台泥,20,4,16,光和,2024-07-04,6380
1595,川寶,16,0,16,光和,2024-07-04,6380
2495,普安,30,14,16,光和,2024-07-04,6380
6179,亞通,19,3,16,光和,2024-07-04,6380
00903,富邦元宇宙,15,0,15,光和,2024-07-04,6380
2356,英業達,20,5,15,光和,2024-07-04,6380
3059,華晶科,19,4,15,光和,2024-07-04,6380
2367,燿華,15,1,14,光和,2024-07-04,6380
6182,合晶,15,1,14,光和,2024-07-04,6380
6288,聯嘉,18,4,14,光和,2024-07-04,6380
1905,華紙,13,0,13,光和,2024-07-04,6380
3047,訊舟,20,7,13,光和,2024-07-04,6380
3689,湧德,84,71,13,光和,2024-07-04,6380
5309,系統電,13,0,13,光和,2024-07-04,6380
5471,松翰,15,2,13,光和,2024-07-04,6380
2332,友訊,12,0,12,光和,2024-07-04,6380
2344,華邦電,27,15,12,光和,2024-07-04,6380
3049,精金,12,0,12,光和,2024-07-04,6380
8271,宇瞻,12,0,12,光和,2024-07-04,6380
2889,國票金,12,0,12,光和,2024-07-04,6380
3663,鑫科,20,9,11,光和,2024-07-04,6380
3615,安可,24,13,11,光和,2024-07-04,6380
4109,加捷生醫,14,3,11,光和,2024-07-04,6380
2349,錸德,17,7,10,光和,2024-07-04,6380
00945B,凱基美國非投等債,10,0,10,光和,2024-07-04,6380
2337,旺宏,20,10,10,光和,2024-07-04,6380
2371,大同,55,45,10,光和,2024-07-04,6380
2515,中工,10,0,10,光和,2024-07-04,6380
3048,益登,328,39,289,光和,2024-07-05,6380
8935,邦泰,149,1,148,光和,2024-07-05,6380
00934,中信成長高股息,136,0,136,光和,2024-07-05,6380
2405,輔信,102,33,69,光和,2024-07-05,6380
00692,富邦公司治理,50,0,50,光和,2024-07-05,6380
2106,建大,50,0,50,光和,2024-07-05,6380
2349,錸德,53,6,47,光和,2024-07-05,6380
00929,復華台灣科技優息,46,2,44,光和,2024-07-05,6380
00937B,群益ESG投等債20,42,0,42,光和,2024-07-05,6380
8234,新漢,37,1,36,光和,2024-07-05,6380
1609,大亞,42,9,33,光和,2024-07-05,6380
8171,天宇,31,0,31,光和,2024-07-05,6380
2312,金寶,36,6,30,光和,2024-07-05,6380
2542,興富發,30,1,29,光和,2024-07-05,6380
2365,昆盈,36,8,28,光和,2024-07-05,6380
00637L,元大滬深300正2,27,0,27,光和,2024-07-05,6380
2610,華航,104,78,26,光和,2024-07-05,6380
8421,旭源,26,0,26,光和,2024-07-05,6380
00673R,期元大S＆P原油反1,25,0,25,光和,2024-07-05,6380
2324,仁寶,28,3,25,光和,2024-07-05,6380
2618,長榮航,24,0,24,光和,2024-07-05,6380
1326,台化,22,0,22,光和,2024-07-05,6380
2329,華泰,25,3,22,光和,2024-07-05,6380
6142,友勁,31,10,21,光和,2024-07-05,6380
2344,華邦電,39,19,20,光和,2024-07-05,6380
9934,成霖,20,0,20,光和,2024-07-05,6380
2603,長榮,22,3,19,光和,2024-07-05,6380
2323,中環,34,15,19,光和,2024-07-05,6380
2353,宏��,24,5,19,光和,2024-07-05,6380
2484,希華,20,1,19,光和,2024-07-05,6380
5230,雷笛克光學,21,2,19,光和,2024-07-05,6380
2867,三商壽,78,60,18,光和,2024-07-05,6380
2609,陽明,69,52,17,光和,2024-07-05,6380
3219,倚強科,17,0,17,光和,2024-07-05,6380
1314,中石化,18,1,17,光和,2024-07-05,6380
3260,威剛,19,3,16,光和,2024-07-05,6380
00936,台新永續高息中小,15,0,15,光和,2024-07-05,6380
2915,潤泰全,15,0,15,光和,2024-07-05,6380
4561,健椿,15,1,14,光和,2024-07-05,6380
00712,復華富時不動產,14,0,14,光和,2024-07-05,6380
6282,康舒,17,4,13,光和,2024-07-05,6380
6016,康和證,12,0,12,光和,2024-07-05,6380
6770,力積電,13,1,12,光和,2024-07-05,6380
2002,中鋼,18,6,12,光和,2024-07-05,6380
2887,台新金,12,1,11,光和,2024-07-05,6380
00915,凱基優選高股息30,10,0,10,光和,2024-07-05,6380
00753L,中信中國50正2,10,0,10,光和,2024-07-05,6380
00665L,富邦�琤肭磪囓�2,10,0,10,光和,2024-07-05,6380
5392,能率,21,11,10,光和,2024-07-05,6380
8092,建暐,10,0,10,光和,2024-07-05,6380
00632R,元大台灣50反1,270,0,270,光和,2024-07-08,6380
00937B,群益ESG投等債20,147,2,145,光和,2024-07-08,6380
2365,昆盈,182,39,143,光和,2024-07-08,6380
2867,三商壽,114,0,114,光和,2024-07-08,6380
00933B,國泰10Y+金融債,100,1,99,光和,2024-07-08,6380
2409,友達,106,14,92,光和,2024-07-08,6380
2464,盟立,83,11,72,光和,2024-07-08,6380
00934,中信成長高股息,55,0,55,光和,2024-07-08,6380
8935,邦泰,52,1,51,光和,2024-07-08,6380
6153,嘉聯益,53,10,43,光和,2024-07-08,6380
1714,和桐,42,0,42,光和,2024-07-08,6380
3455,由田,40,2,38,光和,2024-07-08,6380
1326,台化,38,1,37,光和,2024-07-08,6380
2331,精英,35,0,35,光和,2024-07-08,6380
2323,中環,46,16,30,光和,2024-07-08,6380
2468,華經,30,0,30,光和,2024-07-08,6380
3689,湧德,48,18,30,光和,2024-07-08,6380
00940,元大台灣價值高息,36,6,30,光和,2024-07-08,6380
2603,長榮,34,5,29,光和,2024-07-08,6380
5452,佶優,42,13,29,光和,2024-07-08,6380
6217,中探針,30,1,29,光和,2024-07-08,6380
2354,鴻準,38,11,27,光和,2024-07-08,6380
6160,欣技,32,5,27,光和,2024-07-08,6380
1785,光洋科,45,19,26,光和,2024-07-08,6380
2405,輔信,36,11,25,光和,2024-07-08,6380
3713,新晶投控,25,0,25,光和,2024-07-08,6380
2618,長榮航,25,1,24,光和,2024-07-08,6380
2014,中鴻,22,0,22,光和,2024-07-08,6380
8092,建暐,22,0,22,光和,2024-07-08,6380
00881,國泰台灣5G+,22,1,21,光和,2024-07-08,6380
5512,力麒,20,0,20,光和,2024-07-08,6380
2427,三商電,20,2,18,光和,2024-07-08,6380
1605,華新,18,1,17,光和,2024-07-08,6380
2915,潤泰全,17,0,17,光和,2024-07-08,6380
4711,永純,17,0,17,光和,2024-07-08,6380
1718,中纖,20,4,16,光和,2024-07-08,6380
2913,農林,20,4,16,光和,2024-07-08,6380
8358,金居,16,0,16,光和,2024-07-08,6380
5272,笙科,26,11,15,光和,2024-07-08,6380
6264,富裔,15,0,15,光和,2024-07-08,6380
3048,益登,30,15,15,光和,2024-07-08,6380
2359,所羅門,18,4,14,光和,2024-07-08,6380
2020,美亞,14,0,14,光和,2024-07-08,6380
5443,均豪,23,9,14,光和,2024-07-08,6380
1454,台富,16,2,14,光和,2024-07-08,6380
6152,百一,14,0,14,光和,2024-07-08,6380
0056,元大高股息,15,2,13,光和,2024-07-08,6380
6505,台塑化,17,4,13,光和,2024-07-08,6380
00687B,國泰20年美債,14,1,13,光和,2024-07-08,6380
3703,欣陸,13,0,13,光和,2024-07-08,6380
2353,宏��,140,16,124,光和,2024-07-09,6380
2834,臺企銀,112,30,82,光和,2024-07-09,6380
2888,新光金,250,185,65,光和,2024-07-09,6380
00934,中信成長高股息,47,0,47,光和,2024-07-09,6380
00650L,復華香港正2,46,0,46,光和,2024-07-09,6380
8071,能率網通,42,1,41,光和,2024-07-09,6380
2317,鴻海,61,21,40,光和,2024-07-09,6380
8473,山林水,40,1,39,光和,2024-07-09,6380
2324,仁寶,43,6,37,光和,2024-07-09,6380
3710,連展投控,35,0,35,光和,2024-07-09,6380
6770,力積電,33,0,33,光和,2024-07-09,6380
1582,信錦,32,0,32,光和,2024-07-09,6380
5471,松翰,32,0,32,光和,2024-07-09,6380
4960,誠美材,47,16,31,光和,2024-07-09,6380
3078,僑威,30,0,30,光和,2024-07-09,6380
3713,新晶投控,30,0,30,光和,2024-07-09,6380
2618,長榮航,27,2,25,光和,2024-07-09,6380
2495,普安,34,9,25,光和,2024-07-09,6380
1319,東陽,24,0,24,光和,2024-07-09,6380
3047,訊舟,56,32,24,光和,2024-07-09,6380
8935,邦泰,27,3,24,光和,2024-07-09,6380
3260,威剛,24,1,23,光和,2024-07-09,6380
1304,台聚,22,0,22,光和,2024-07-09,6380
3231,緯創,45,23,22,光和,2024-07-09,6380
2344,華邦電,40,19,21,光和,2024-07-09,6380
1611,中電,20,0,20,光和,2024-07-09,6380
2617,台航,19,0,19,光和,2024-07-09,6380
1301,台塑,19,1,18,光和,2024-07-09,6380
4533,協易機,23,5,18,光和,2024-07-09,6380
00940,元大台灣價值高息,39,21,18,光和,2024-07-09,6380
1457,宜進,18,0,18,光和,2024-07-09,6380
2913,農林,18,0,18,光和,2024-07-09,6380
9105,泰金寶-DR,109,91,18,光和,2024-07-09,6380
2002,中鋼,19,3,16,光和,2024-07-09,6380
1434,福懋,20,4,16,光和,2024-07-09,6380
2405,輔信,84,68,16,光和,2024-07-09,6380
6603,富強鑫,16,0,16,光和,2024-07-09,6380
00881,國泰台灣5G+,20,5,15,光和,2024-07-09,6380
00895,富邦未來車,15,0,15,光和,2024-07-09,6380
2884,玉山金,15,0,15,光和,2024-07-09,6380
6264,富裔,15,0,15,光和,2024-07-09,6380
1605,華新,15,1,14,光和,2024-07-09,6380
2354,鴻準,25,11,14,光和,2024-07-09,6380
2109,華豐,13,0,13,光和,2024-07-09,6380
6282,康舒,13,0,13,光和,2024-07-09,6380
2412,中華電,12,0,12,光和,2024-07-09,6380
00882,中信中國高股息,12,0,12,光和,2024-07-09,6380
3706,神達,66,54,12,光和,2024-07-09,6380
6217,中探針,12,0,12,光和,2024-07-09,6380
8234,新漢,12,0,12,光和,2024-07-09,6380
00934,中信成長高股息,150,1,149,光和,2024-07-10,6380
3481,群創,100,27,73,光和,2024-07-10,6380
8271,宇瞻,59,2,57,光和,2024-07-10,6380
2353,宏��,108,54,54,光和,2024-07-10,6380
00945B,凱基美國非投等債,40,0,40,光和,2024-07-10,6380
1325,恆大,40,0,40,光和,2024-07-10,6380
1618,合機,44,5,39,光和,2024-07-10,6380
2489,瑞軒,61,22,39,光和,2024-07-10,6380
2317,鴻海,37,3,34,光和,2024-07-10,6380
8085,福華,34,1,33,光和,2024-07-10,6380
6443,元晶,35,3,32,光和,2024-07-10,6380
6153,嘉聯益,30,0,30,光和,2024-07-10,6380
2405,輔信,51,22,29,光和,2024-07-10,6380
1304,台聚,29,1,28,光和,2024-07-10,6380
00712,復華富時不動產,27,0,27,光和,2024-07-10,6380
00881,國泰台灣5G+,24,1,23,光和,2024-07-10,6380
2367,燿華,42,19,23,光和,2024-07-10,6380
4720,德淵,23,0,23,光和,2024-07-10,6380
2609,陽明,99,78,21,光和,2024-07-10,6380
2834,臺企銀,20,0,20,光和,2024-07-10,6380
2312,金寶,27,9,18,光和,2024-07-10,6380
00895,富邦未來車,16,0,16,光和,2024-07-10,6380
2105,正新,16,0,16,光和,2024-07-10,6380
4976,佳凌,17,1,16,光和,2024-07-10,6380
2392,正崴,24,8,16,光和,2024-07-10,6380
2882,國泰金,15,0,15,光和,2024-07-10,6380
5876,上海商銀,15,0,15,光和,2024-07-10,6380
6233,旺玖,15,0,15,光和,2024-07-10,6380
8935,邦泰,15,0,15,光和,2024-07-10,6380
00878,國泰永續高股息,14,1,13,光和,2024-07-10,6380
2406,國碩,14,1,13,光和,2024-07-10,6380
00891,中信關鍵半導體,12,0,12,光和,2024-07-10,6380
00936,台新永續高息中小,12,0,12,光和,2024-07-10,6380
1336,台翰,12,0,12,光和,2024-07-10,6380
1515,力山,13,1,12,光和,2024-07-10,6380
2401,凌陽,12,0,12,光和,2024-07-10,6380
5512,力麒,12,0,12,光和,2024-07-10,6380
1617,榮星,11,0,11,光和,2024-07-10,6380
3287,廣寰科,11,0,11,光和,2024-07-10,6380
5230,雷笛克光學,12,1,11,光和,2024-07-10,6380
2337,旺宏,11,0,11,光和,2024-07-10,6380
2344,華邦電,30,19,11,光和,2024-07-10,6380
2888,新光金,187,176,11,光和,2024-07-10,6380
6139,亞翔,10,0,10,光和,2024-07-10,6380
4904,遠傳,10,0,10,光和,2024-07-10,6380
00650L,復華香港正2,31,21,10,光和,2024-07-10,6380
00706L,期元大S＆P日圓正2,10,0,10,光和,2024-07-10,6380
1101,台泥,10,0,10,光和,2024-07-10,6380
1612,宏泰,10,0,10,光和,2024-07-10,6380
2108,南帝,10,0,10,光和,2024-07-10,6380
00632R,元大台灣50反1,612,40,572,光和,2024-07-11,6380
2344,華邦電,144,40,104,光和,2024-07-11,6380
1718,中纖,89,0,89,光和,2024-07-11,6380
2316,楠梓電,105,25,80,光和,2024-07-11,6380
00934,中信成長高股息,89,10,79,光和,2024-07-11,6380
2365,昆盈,98,20,78,光和,2024-07-11,6380
2888,新光金,200,127,73,光和,2024-07-11,6380
00936,台新永續高息中小,66,0,66,光和,2024-07-11,6380
9105,泰金寶-DR,100,41,59,光和,2024-07-11,6380
2464,盟立,62,10,52,光和,2024-07-11,6380
2002,中鋼,42,0,42,光和,2024-07-11,6380
2408,南亞科,38,1,37,光和,2024-07-11,6380
3576,聯合再生,36,0,36,光和,2024-07-11,6380
00882,中信中國高股息,35,0,35,光和,2024-07-11,6380
1532,勤美,35,0,35,光和,2024-07-11,6380
2641,正德,34,1,33,光和,2024-07-11,6380
3689,湧德,84,53,31,光和,2024-07-11,6380
00740B,富邦全球投等債,30,0,30,光和,2024-07-11,6380
3029,零壹,38,8,30,光和,2024-07-11,6380
3048,益登,35,8,27,光和,2024-07-11,6380
2323,中環,46,21,25,光和,2024-07-11,6380
1303,南亞,24,0,24,光和,2024-07-11,6380
2460,建通,27,3,24,光和,2024-07-11,6380
00679B,元大美債20年,23,0,23,光和,2024-07-11,6380
00929,復華台灣科技優息,34,12,22,光和,2024-07-11,6380
00712,復華富時不動產,132,110,22,光和,2024-07-11,6380
3050,鈺德,22,0,22,光和,2024-07-11,6380
5512,力麒,22,0,22,光和,2024-07-11,6380
1447,力鵬,21,0,21,光和,2024-07-11,6380
1504,東元,21,0,21,光和,2024-07-11,6380
1325,恆大,20,0,20,光和,2024-07-11,6380
2031,新光鋼,20,0,20,光和,2024-07-11,6380
4167,松瑞藥,20,0,20,光和,2024-07-11,6380
3260,威剛,20,0,20,光和,2024-07-11,6380
2362,藍天,30,11,19,光和,2024-07-11,6380
2468,華經,20,2,18,光和,2024-07-11,6380
6530,創威,23,6,17,光和,2024-07-11,6380
1795,美時,17,0,17,光和,2024-07-11,6380
1609,大亞,25,9,16,光和,2024-07-11,6380
3024,憶聲,15,0,15,光和,2024-07-11,6380
2317,鴻海,21,6,15,光和,2024-07-11,6380
00673R,期元大S＆P原油反1,14,0,14,光和,2024-07-11,6380
1101,台泥,14,0,14,光和,2024-07-11,6380
3713,新晶投控,16,2,14,光和,2024-07-11,6380
2834,臺企銀,14,0,14,光和,2024-07-11,6380
2303,聯電,22,8,14,光和,2024-07-11,6380
2405,輔信,26,13,13,光和,2024-07-11,6380
6806,森崴能源,14,2,12,光和,2024-07-11,6380
2355,敬鵬,13,2,11,光和,2024-07-11,6380
2515,中工,11,0,11,光和,2024-07-11,6380
2867,三商壽,206,71,135,光和,2024-07-12,6380
00929,復華台灣科技優息,120,1,119,光和,2024-07-12,6380
00919,群益台灣精選高息,111,0,111,光和,2024-07-12,6380
2408,南亞科,93,4,89,光和,2024-07-12,6380
4123,晟德,77,1,76,光和,2024-07-12,6380
2317,鴻海,86,19,67,光和,2024-07-12,6380
00934,中信成長高股息,59,0,59,光和,2024-07-12,6380
2303,聯電,65,8,57,光和,2024-07-12,6380
00881,國泰台灣5G+,50,2,48,光和,2024-07-12,6380
00927,群益半導體收益,46,0,46,光和,2024-07-12,6380
3689,湧德,42,0,42,光和,2024-07-12,6380
9105,泰金寶-DR,58,18,40,光和,2024-07-12,6380
8234,新漢,38,0,38,光和,2024-07-12,6380
6811,宏�硌穈T,35,0,35,光和,2024-07-12,6380
2353,宏��,31,3,28,光和,2024-07-12,6380
00878,國泰永續高股息,28,1,27,光和,2024-07-12,6380
2618,長榮航,33,6,27,光和,2024-07-12,6380
00937B,群益ESG投等債20,37,14,23,光和,2024-07-12,6380
1529,樂事綠能,31,8,23,光和,2024-07-12,6380
006208,富邦台50,23,1,22,光和,2024-07-12,6380
2331,精英,21,0,21,光和,2024-07-12,6380
2801,彰銀,34,13,21,光和,2024-07-12,6380
00719B,元大美債1-3,20,0,20,光和,2024-07-12,6380
00942B,台新美A公司債20+,20,0,20,光和,2024-07-12,6380
00891,中信關鍵半導體,18,0,18,光和,2024-07-12,6380
00905,FT臺灣Smart,19,2,17,光和,2024-07-12,6380
00687B,國泰20年美債,16,0,16,光和,2024-07-12,6380
2605,新興,17,1,16,光和,2024-07-12,6380
3607,谷崧,17,1,16,光和,2024-07-12,6380
1305,華夏,20,5,15,光和,2024-07-12,6380
9942,茂順,15,0,15,光和,2024-07-12,6380
2392,正崴,19,5,14,光和,2024-07-12,6380
3047,訊舟,14,0,14,光和,2024-07-12,6380
0056,元大高股息,13,0,13,光和,2024-07-12,6380
2363,矽統,15,2,13,光和,2024-07-12,6380
5347,世界,17,4,13,光和,2024-07-12,6380
2027,大成鋼,20,8,12,光和,2024-07-12,6380
00940,元大台灣價值高息,30,18,12,光和,2024-07-12,6380
2313,華通,22,10,12,光和,2024-07-12,6380
2354,鴻準,14,2,12,光和,2024-07-12,6380
3037,欣興,31,19,12,光和,2024-07-12,6380
2603,長榮,13,2,11,光和,2024-07-12,6380
1504,東元,11,0,11,光和,2024-07-12,6380
4711,永純,11,0,11,光和,2024-07-12,6380
4958,臻鼎-KY,11,0,11,光和,2024-07-12,6380
5475,德宏,11,0,11,光和,2024-07-12,6380
6270,倍微,11,0,11,光和,2024-07-12,6380
6274,台燿,11,0,11,光和,2024-07-12,6380
6834,天二科技,11,0,11,光和,2024-07-12,6380
8936,國統,63,52,11,光和,2024-07-12,6380
2888,新光金,200,7,193,光和,2024-07-15,6380
00929,復華台灣科技優息,120,7,113,光和,2024-07-15,6380
2316,楠梓電,76,0,76,光和,2024-07-15,6380
00919,群益台灣精選高息,72,0,72,光和,2024-07-15,6380
2891,中信金,77,5,72,光和,2024-07-15,6380
2356,英業達,85,24,61,光和,2024-07-15,6380
9945,潤泰新,64,10,54,光和,2024-07-15,6380
3481,群創,76,28,48,光和,2024-07-15,6380
1815,富喬,48,2,46,光和,2024-07-15,6380
1608,華榮,68,22,46,光和,2024-07-15,6380
2883,凱基金,48,2,46,光和,2024-07-15,6380
6770,力積電,45,0,45,光和,2024-07-15,6380
00937B,群益ESG投等債20,44,0,44,光和,2024-07-15,6380
00931B,統一美債20年,42,0,42,光和,2024-07-15,6380
2464,盟立,50,8,42,光和,2024-07-15,6380
5328,華容,41,0,41,光和,2024-07-15,6380
2409,友達,54,13,41,光和,2024-07-15,6380
2801,彰銀,41,1,40,光和,2024-07-15,6380
2324,仁寶,47,8,39,光和,2024-07-15,6380
1569,濱川,32,1,31,光和,2024-07-15,6380
2610,華航,31,1,30,光和,2024-07-15,6380
8234,新漢,30,0,30,光和,2024-07-15,6380
4503,金雨,30,1,29,光和,2024-07-15,6380
3189,景碩,34,6,28,光和,2024-07-15,6380
00934,中信成長高股息,48,20,28,光和,2024-07-15,6380
0056,元大高股息,26,0,26,光和,2024-07-15,6380
2353,宏��,27,4,23,光和,2024-07-15,6380
2312,金寶,92,70,22,光和,2024-07-15,6380
4960,誠美材,22,0,22,光和,2024-07-15,6380
4971,IET-KY,22,0,22,光和,2024-07-15,6380
00905,FT臺灣Smart,21,0,21,光和,2024-07-15,6380
8096,擎亞,21,0,21,光和,2024-07-15,6380
00719B,元大美債1-3,20,0,20,光和,2024-07-15,6380
3289,宜特,20,0,20,光和,2024-07-15,6380
5426,振發,20,0,20,光和,2024-07-15,6380
4306,炎洲,20,0,20,光和,2024-07-15,6380
2618,長榮航,30,12,18,光和,2024-07-15,6380
2365,昆盈,47,29,18,光和,2024-07-15,6380
2489,瑞軒,67,50,17,光和,2024-07-15,6380
2344,華邦電,17,0,17,光和,2024-07-15,6380
3047,訊舟,21,4,17,光和,2024-07-15,6380
5452,佶優,17,0,17,光和,2024-07-15,6380
2363,矽統,29,13,16,光和,2024-07-15,6380
4930,燦星網,16,0,16,光和,2024-07-15,6380
6153,嘉聯益,16,0,16,光和,2024-07-15,6380
6026,福邦證,30,15,15,光和,2024-07-15,6380
00725B,國泰投資級公司債,15,0,15,光和,2024-07-15,6380
1802,台玻,15,0,15,光和,2024-07-15,6380
00692,富邦公司治理,14,0,14,光和,2024-07-15,6380
2405,輔信,21,7,14,光和,2024-07-15,6380
00632R,元大台灣50反1,271,10,261,光和,2024-07-16,6380
00929,復華台灣科技優息,124,10,114,光和,2024-07-16,6380
00937B,群益ESG投等債20,114,50,64,光和,2024-07-16,6380
4526,東台,61,2,59,光和,2024-07-16,6380
2392,正崴,62,3,59,光和,2024-07-16,6380
00919,群益台灣精選高息,71,13,58,光和,2024-07-16,6380
2408,南亞科,77,19,58,光和,2024-07-16,6380
2641,正德,51,0,51,光和,2024-07-16,6380
1608,華榮,87,46,41,光和,2024-07-16,6380
2356,英業達,55,22,33,光和,2024-07-16,6380
2412,中華電,32,2,30,光和,2024-07-16,6380
8234,新漢,29,0,29,光和,2024-07-16,6380
2449,京元電子,30,1,29,光和,2024-07-16,6380
2109,華豐,28,0,28,光和,2024-07-16,6380
00905,FT臺灣Smart,27,0,27,光和,2024-07-16,6380
2002,中鋼,59,33,26,光和,2024-07-16,6380
00687B,國泰20年美債,26,0,26,光和,2024-07-16,6380
00878,國泰永續高股息,25,0,25,光和,2024-07-16,6380
5474,聰泰,24,0,24,光和,2024-07-16,6380
1785,光洋科,70,47,23,光和,2024-07-16,6380
4903,聯光通,23,0,23,光和,2024-07-16,6380
00712,復華富時不動產,25,3,22,光和,2024-07-16,6380
2891,中信金,27,5,22,光和,2024-07-16,6380
2344,華邦電,23,1,22,光和,2024-07-16,6380
2353,宏��,46,24,22,光和,2024-07-16,6380
2104,國際中橡,21,0,21,光和,2024-07-16,6380
2834,臺企銀,21,1,20,光和,2024-07-16,6380
1340,勝悅-KY,20,0,20,光和,2024-07-16,6380
2610,華航,126,106,20,光和,2024-07-16,6380
4711,永純,20,0,20,光和,2024-07-16,6380
4306,炎洲,25,6,19,光和,2024-07-16,6380
00949,復華日本龍頭,18,0,18,光和,2024-07-16,6380
2867,三商壽,22,5,17,光和,2024-07-16,6380
2913,農林,20,3,17,光和,2024-07-16,6380
3713,新晶投控,19,2,17,光和,2024-07-16,6380
2317,鴻海,24,7,17,光和,2024-07-16,6380
0056,元大高股息,16,0,16,光和,2024-07-16,6380
3686,達能,16,0,16,光和,2024-07-16,6380
2633,台灣高鐵,17,1,16,光和,2024-07-16,6380
2313,華通,19,4,15,光和,2024-07-16,6380
2462,良得電,15,0,15,光和,2024-07-16,6380
6257,矽格,20,5,15,光和,2024-07-16,6380
00882,中信中國高股息,23,9,14,光和,2024-07-16,6380
1513,中興電,21,7,14,光和,2024-07-16,6380
2609,陽明,29,16,13,光和,2024-07-16,6380
5371,中光電,16,3,13,光和,2024-07-16,6380
00946,群益科技高息成長,13,1,12,光和,2024-07-16,6380
1616,億泰,20,8,12,光和,2024-07-16,6380
6163,華電網,11,0,11,光和,2024-07-16,6380
6443,元晶,12,1,11,光和,2024-07-16,6380
2344,華邦電,129,3,126,光和,2024-07-17,6380
00929,復華台灣科技優息,97,7,90,光和,2024-07-17,6380
2316,楠梓電,95,19,76,光和,2024-07-17,6380
2489,瑞軒,122,48,74,光和,2024-07-17,6380
2537,聯上發,74,4,70,光和,2024-07-17,6380
6770,力積電,78,11,67,光和,2024-07-17,6380
00919,群益台灣精選高息,92,27,65,光和,2024-07-17,6380
6188,廣明,59,1,58,光和,2024-07-17,6380
00937B,群益ESG投等債20,50,2,48,光和,2024-07-17,6380
00927,群益半導體收益,38,0,38,光和,2024-07-17,6380
00650L,復華香港正2,32,0,32,光和,2024-07-17,6380
00934,中信成長高股息,30,3,27,光和,2024-07-17,6380
2845,遠東銀,23,0,23,光和,2024-07-17,6380
1101,台泥,27,5,22,光和,2024-07-17,6380
2108,南帝,22,0,22,光和,2024-07-17,6380
4306,炎洲,42,20,22,光和,2024-07-17,6380
00931B,統一美債20年,22,0,22,光和,2024-07-17,6380
1517,利奇,20,0,20,光和,2024-07-17,6380
3715,定穎投控,25,5,20,光和,2024-07-17,6380
2353,宏��,22,4,18,光和,2024-07-17,6380
4906,正文,19,2,17,光和,2024-07-17,6380
2371,大同,30,14,16,光和,2024-07-17,6380
00878,國泰永續高股息,24,8,16,光和,2024-07-17,6380
2888,新光金,25,9,16,光和,2024-07-17,6380
5452,佶優,19,3,16,光和,2024-07-17,6380
9136,巨騰-DR,16,0,16,光和,2024-07-17,6380
2356,英業達,32,16,16,光和,2024-07-17,6380
2603,長榮,15,0,15,光和,2024-07-17,6380
00905,FT臺灣Smart,15,0,15,光和,2024-07-17,6380
1582,信錦,15,0,15,光和,2024-07-17,6380
3455,由田,15,0,15,光和,2024-07-17,6380
00936,台新永續高息中小,14,0,14,光和,2024-07-17,6380
2618,長榮航,18,4,14,光和,2024-07-17,6380
6531,愛普*,14,0,14,光和,2024-07-17,6380
2330,台積電,15,1,14,光和,2024-07-17,6380
2834,臺企銀,13,0,13,光和,2024-07-17,6380
4561,健椿,13,0,13,光和,2024-07-17,6380
8064,東捷,13,0,13,光和,2024-07-17,6380
00882,中信中國高股息,13,0,13,光和,2024-07-17,6380
0056,元大高股息,13,1,12,光和,2024-07-17,6380
2609,陽明,38,26,12,光和,2024-07-17,6380
2303,聯電,18,6,12,光和,2024-07-17,6380
3059,華晶科,14,2,12,光和,2024-07-17,6380
1301,台塑,15,4,11,光和,2024-07-17,6380
2324,仁寶,12,1,11,光和,2024-07-17,6380
2501,國建,15,4,11,光和,2024-07-17,6380
3712,永崴投控,17,6,11,光和,2024-07-17,6380
6651,全宇昕,11,0,11,光和,2024-07-17,6380
8358,金居,15,4,11,光和,2024-07-17,6380
006208,富邦台50,11,0,11,光和,2024-07-17,6380
2547,日勝生,200,0,200,光和,2024-07-18,6380
00929,復華台灣科技優息,147,47,100,光和,2024-07-18,6380
00919,群益台灣精選高息,107,21,86,光和,2024-07-18,6380
2317,鴻海,83,16,67,光和,2024-07-18,6380
2356,英業達,81,19,62,光和,2024-07-18,6380
2610,華航,88,27,61,光和,2024-07-18,6380
00934,中信成長高股息,60,0,60,光和,2024-07-18,6380
2392,正崴,60,1,59,光和,2024-07-18,6380
6770,力積電,50,3,47,光和,2024-07-18,6380
2489,瑞軒,95,58,37,光和,2024-07-18,6380
3047,訊舟,31,0,31,光和,2024-07-18,6380
00927,群益半導體收益,30,0,30,光和,2024-07-18,6380
4958,臻鼎-KY,39,10,29,光和,2024-07-18,6380
2882,國泰金,25,0,25,光和,2024-07-18,6380
2344,華邦電,35,10,25,光和,2024-07-18,6380
00878,國泰永續高股息,40,15,25,光和,2024-07-18,6380
00935,野村臺灣新科技50,24,0,24,光和,2024-07-18,6380
2891,中信金,23,0,23,光和,2024-07-18,6380
3059,華晶科,23,0,23,光和,2024-07-18,6380
8234,新漢,22,0,22,光和,2024-07-18,6380
1612,宏泰,21,0,21,光和,2024-07-18,6380
2634,漢翔,27,6,21,光和,2024-07-18,6380
00918,大華優利高填息30,38,17,21,光和,2024-07-18,6380
2204,中華,21,0,21,光和,2024-07-18,6380
2401,凌陽,21,0,21,光和,2024-07-18,6380
2515,中工,20,0,20,光和,2024-07-18,6380
1608,華榮,21,1,20,光和,2024-07-18,6380
2468,華經,20,0,20,光和,2024-07-18,6380
2618,長榮航,20,0,20,光和,2024-07-18,6380
3037,欣興,39,19,20,光和,2024-07-18,6380
5452,佶優,50,31,19,光和,2024-07-18,6380
9955,佳龍,20,1,19,光和,2024-07-18,6380
2449,京元電子,26,8,18,光和,2024-07-18,6380
9945,潤泰新,25,7,18,光和,2024-07-18,6380
2363,矽統,28,11,17,光和,2024-07-18,6380
8473,山林水,27,10,17,光和,2024-07-18,6380
3686,達能,17,0,17,光和,2024-07-18,6380
3712,永崴投控,19,3,16,光和,2024-07-18,6380
3711,日月光投控,18,3,15,光和,2024-07-18,6380
00687B,國泰20年美債,16,1,15,光和,2024-07-18,6380
2061,風青,15,0,15,光和,2024-07-18,6380
6257,矽格,16,1,15,光和,2024-07-18,6380
2303,聯電,26,11,15,光和,2024-07-18,6380
00896,中信綠能及電動車,15,2,13,光和,2024-07-18,6380
2313,華通,18,5,13,光和,2024-07-18,6380
4128,中天,15,2,13,光和,2024-07-18,6380
6244,茂迪,14,1,13,光和,2024-07-18,6380
00905,FT臺灣Smart,12,0,12,光和,2024-07-18,6380
2362,藍天,27,15,12,光和,2024-07-18,6380
2867,三商壽,14,2,12,光和,2024-07-18,6380
3481,群創,583,141,442,光和,2024-07-19,6380
2344,華邦電,262,1,261,光和,2024-07-19,6380
2408,南亞科,251,0,251,光和,2024-07-19,6380
00919,群益台灣精選高息,139,24,115,光和,2024-07-19,6380
00929,復華台灣科技優息,89,27,62,光和,2024-07-19,6380
2002,中鋼,116,59,57,光和,2024-07-19,6380
00940,元大台灣價值高息,65,13,52,光和,2024-07-19,6380
00934,中信成長高股息,50,0,50,光和,2024-07-19,6380
00905,FT臺灣Smart,40,0,40,光和,2024-07-19,6380
00878,國泰永續高股息,38,0,38,光和,2024-07-19,6380
3231,緯創,39,4,35,光和,2024-07-19,6380
0056,元大高股息,46,15,31,光和,2024-07-19,6380
4526,東台,40,10,30,光和,2024-07-19,6380
00931B,統一美債20年,30,0,30,光和,2024-07-19,6380
2867,三商壽,33,3,30,光和,2024-07-19,6380
1337,再生-KY,30,1,29,光和,2024-07-19,6380
2353,宏��,29,0,29,光和,2024-07-19,6380
2330,台積電,32,3,29,光和,2024-07-19,6380
2104,國際中橡,28,0,28,光和,2024-07-19,6380
6217,中探針,28,0,28,光和,2024-07-19,6380
2618,長榮航,39,12,27,光和,2024-07-19,6380
1210,大成,26,0,26,光和,2024-07-19,6380
6116,彩晶,26,0,26,光和,2024-07-19,6380
6770,力積電,26,0,26,光和,2024-07-19,6380
00939,統一台灣高息動能,25,0,25,光和,2024-07-19,6380
2603,長榮,29,4,25,光和,2024-07-19,6380
00936,台新永續高息中小,24,0,24,光和,2024-07-19,6380
4128,中天,24,0,24,光和,2024-07-19,6380
3455,由田,23,1,22,光和,2024-07-19,6380
2356,英業達,36,14,22,光和,2024-07-19,6380
1609,大亞,45,24,21,光和,2024-07-19,6380
00933B,國泰10Y+金融債,21,0,21,光和,2024-07-19,6380
1785,光洋科,43,22,21,光和,2024-07-19,6380
2371,大同,35,14,21,光和,2024-07-19,6380
2836,高雄銀,20,0,20,光和,2024-07-19,6380
4167,松瑞藥,20,0,20,光和,2024-07-19,6380
6136,富爾特,20,0,20,光和,2024-07-19,6380
2882,國泰金,30,12,18,光和,2024-07-19,6380
6264,富裔,21,3,18,光和,2024-07-19,6380
2317,鴻海,57,39,18,光和,2024-07-19,6380
2481,強茂,23,6,17,光和,2024-07-19,6380
2312,金寶,27,12,15,光和,2024-07-19,6380
2607,榮運,15,0,15,光和,2024-07-19,6380
2609,陽明,34,19,15,光和,2024-07-19,6380
2617,台航,15,0,15,光和,2024-07-19,6380
3049,精金,17,2,15,光和,2024-07-19,6380
2419,仲琦,24,10,14,光和,2024-07-19,6380
2460,建通,14,0,14,光和,2024-07-19,6380
2329,華泰,15,1,14,光和,2024-07-19,6380
2834,臺企銀,13,0,13,光和,2024-07-19,6380
00929,復華台灣科技優息,228,85,143,光和,2024-07-22,6380
00919,群益台灣精選高息,181,51,130,光和,2024-07-22,6380
00878,國泰永續高股息,148,19,129,光和,2024-07-22,6380
2801,彰銀,108,10,98,光和,2024-07-22,6380
2408,南亞科,85,0,85,光和,2024-07-22,6380
3481,群創,96,26,70,光和,2024-07-22,6380
1609,大亞,83,16,67,光和,2024-07-22,6380
00946,群益科技高息成長,42,0,42,光和,2024-07-22,6380
00937B,群益ESG投等債20,47,9,38,光和,2024-07-22,6380
2883,凱基金,38,0,38,光和,2024-07-22,6380
1314,中石化,86,52,34,光和,2024-07-22,6380
6016,康和證,31,0,31,光和,2024-07-22,6380
2888,新光金,50,20,30,光和,2024-07-22,6380
4956,光鋐,30,0,30,光和,2024-07-22,6380
9105,泰金寶-DR,31,2,29,光和,2024-07-22,6380
2344,華邦電,28,0,28,光和,2024-07-22,6380
8110,華東,28,0,28,光和,2024-07-22,6380
3576,聯合再生,27,0,27,光和,2024-07-22,6380
1301,台塑,24,0,24,光和,2024-07-22,6380
2303,聯電,34,12,22,光和,2024-07-22,6380
00885,富邦越南,21,0,21,光和,2024-07-22,6380
2542,興富發,31,10,21,光和,2024-07-22,6380
2884,玉山金,23,2,21,光和,2024-07-22,6380
4714,永捷,21,0,21,光和,2024-07-22,6380
00882,中信中國高股息,20,0,20,光和,2024-07-22,6380
9945,潤泰新,25,5,20,光和,2024-07-22,6380
2603,長榮,27,9,18,光和,2024-07-22,6380
3231,緯創,28,10,18,光和,2024-07-22,6380
2609,陽明,33,15,18,光和,2024-07-22,6380
5512,力麒,22,4,18,光和,2024-07-22,6380
1785,光洋科,19,2,17,光和,2024-07-22,6380
2913,農林,20,3,17,光和,2024-07-22,6380
2409,友達,18,2,16,光和,2024-07-22,6380
8358,金居,16,0,16,光和,2024-07-22,6380
00936,台新永續高息中小,18,3,15,光和,2024-07-22,6380
2489,瑞軒,32,17,15,光和,2024-07-22,6380
6275,元山,15,0,15,光和,2024-07-22,6380
1611,中電,15,1,14,光和,2024-07-22,6380
2610,華航,119,106,13,光和,2024-07-22,6380
2630,亞航,14,1,13,光和,2024-07-22,6380
0056,元大高股息,50,37,13,光和,2024-07-22,6380
2356,英業達,18,6,12,光和,2024-07-22,6380
6153,嘉聯益,13,1,12,光和,2024-07-22,6380
3037,欣興,13,1,12,光和,2024-07-22,6380
3450,聯鈞,13,2,11,光和,2024-07-22,6380
4931,新盛力,11,0,11,光和,2024-07-22,6380
00935,野村臺灣新科技50,11,0,11,光和,2024-07-22,6380
2915,潤泰全,10,0,10,光和,2024-07-22,6380
00939,統一台灣高息動能,11,1,10,光和,2024-07-22,6380
1336,台翰,10,0,10,光和,2024-07-22,6380
00937B,群益ESG投等債20,349,0,349,光和,2024-07-23,6380
2408,南亞科,150,2,148,光和,2024-07-23,6380
3481,群創,248,110,138,光和,2024-07-23,6380
00929,復華台灣科技優息,108,1,107,光和,2024-07-23,6380
00632R,元大台灣50反1,100,0,100,光和,2024-07-23,6380
3706,神達,51,4,47,光和,2024-07-23,6380
6770,力積電,34,0,34,光和,2024-07-23,6380
00918,大華優利高填息30,31,0,31,光和,2024-07-23,6380
00919,群益台灣精選高息,45,14,31,光和,2024-07-23,6380
00725B,國泰投資級公司債,30,0,30,光和,2024-07-23,6380
2344,華邦電,45,19,26,光和,2024-07-23,6380
00881,國泰台灣5G+,24,0,24,光和,2024-07-23,6380
00679B,元大美債20年,24,0,24,光和,2024-07-23,6380
00713,元大台灣高息低波,20,0,20,光和,2024-07-23,6380
00931B,統一美債20年,20,0,20,光和,2024-07-23,6380
3713,新晶投控,21,2,19,光和,2024-07-23,6380
2812,台中銀,22,3,19,光和,2024-07-23,6380
9105,泰金寶-DR,20,3,17,光和,2024-07-23,6380
00934,中信成長高股息,16,0,16,光和,2024-07-23,6380
2537,聯上發,20,4,16,光和,2024-07-23,6380
6661,威健生技,16,0,16,光和,2024-07-23,6380
2634,漢翔,16,1,15,光和,2024-07-23,6380
6244,茂迪,15,0,15,光和,2024-07-23,6380
2365,昆盈,39,25,14,光和,2024-07-23,6380
0056,元大高股息,20,6,14,光和,2024-07-23,6380
2303,聯電,17,3,14,光和,2024-07-23,6380
2409,友達,19,5,14,光和,2024-07-23,6380
3533,嘉澤,15,1,14,光和,2024-07-23,6380
00671R,富邦NASDAQ反1,13,0,13,光和,2024-07-23,6380
2618,長榮航,16,3,13,光和,2024-07-23,6380
3498,陽程,13,0,13,光和,2024-07-23,6380
3712,永崴投控,19,6,13,光和,2024-07-23,6380
8935,邦泰,13,0,13,光和,2024-07-23,6380
911608,明輝-DR,13,0,13,光和,2024-07-23,6380
00692,富邦公司治理,12,0,12,光和,2024-07-23,6380
2338,光罩,12,0,12,光和,2024-07-23,6380
2515,中工,13,1,12,光和,2024-07-23,6380
00637L,元大滬深300正2,11,0,11,光和,2024-07-23,6380
00751B,元大AAA至A公司債,11,0,11,光和,2024-07-23,6380
00850,元大臺灣ESG永續,11,0,11,光和,2024-07-23,6380
6116,彩晶,11,0,11,光和,2024-07-23,6380
2464,盟立,14,4,10,光和,2024-07-23,6380
2882,國泰金,18,8,10,光和,2024-07-23,6380
3049,精金,10,0,10,光和,2024-07-23,6380
4956,光鋐,10,0,10,光和,2024-07-23,6380
6177,達麗,12,2,10,光和,2024-07-23,6380
6546,正基,10,0,10,光和,2024-07-23,6380
8085,福華,10,0,10,光和,2024-07-23,6380
6443,元晶,10,0,10,光和,2024-07-23,6380
6257,矽格,10,0,10,光和,2024-07-23,6380
00919,群益台灣精選高息,280,0,280,光和,2024-07-26,6380
2845,遠東銀,202,10,192,光和,2024-07-26,6380
1449,佳和,104,1,103,光和,2024-07-26,6380
2344,華邦電,77,0,77,光和,2024-07-26,6380
00937B,群益ESG投等債20,60,0,60,光和,2024-07-26,6380
00940,元大台灣價值高息,55,7,48,光和,2024-07-26,6380
00878,國泰永續高股息,50,5,45,光和,2024-07-26,6380
1304,台聚,45,0,45,光和,2024-07-26,6380
00725B,國泰投資級公司債,40,0,40,光和,2024-07-26,6380
2883,凱基金,42,2,40,光和,2024-07-26,6380
3580,友威科,32,0,32,光和,2024-07-26,6380
2408,南亞科,34,2,32,光和,2024-07-26,6380
2801,彰銀,31,1,30,光和,2024-07-26,6380
00637L,元大滬深300正2,29,0,29,光和,2024-07-26,6380
2317,鴻海,49,21,28,光和,2024-07-26,6380
00934,中信成長高股息,27,0,27,光和,2024-07-26,6380
0056,元大高股息,27,3,24,光和,2024-07-26,6380
00946,群益科技高息成長,23,0,23,光和,2024-07-26,6380
00712,復華富時不動產,22,0,22,光和,2024-07-26,6380
2330,台積電,24,2,22,光和,2024-07-26,6380
2888,新光金,42,20,22,光和,2024-07-26,6380
2034,允強,25,3,22,光和,2024-07-26,6380
00935,野村臺灣新科技50,21,0,21,光和,2024-07-26,6380
6015,宏遠證,21,0,21,光和,2024-07-26,6380
00881,國泰台灣5G+,23,5,18,光和,2024-07-26,6380
2382,廣達,18,1,17,光和,2024-07-26,6380
6457,紘康,16,0,16,光和,2024-07-26,6380
2002,中鋼,15,0,15,光和,2024-07-26,6380
1313,聯成,15,0,15,光和,2024-07-26,6380
00772B,中信高評級公司債,14,0,14,光和,2024-07-26,6380
2109,華豐,14,0,14,光和,2024-07-26,6380
2409,友達,22,8,14,光和,2024-07-26,6380
00900,富邦特選高股息30,13,0,13,光和,2024-07-26,6380
3715,定穎投控,13,0,13,光和,2024-07-26,6380
3711,日月光投控,13,0,13,光和,2024-07-26,6380
4526,東台,12,0,12,光和,2024-07-26,6380
00753L,中信中國50正2,12,0,12,光和,2024-07-26,6380
00680L,元大美債20正2,12,0,12,光和,2024-07-26,6380
2812,台中銀,13,1,12,光和,2024-07-26,6380
6153,嘉聯益,12,0,12,光和,2024-07-26,6380
2884,玉山金,13,2,11,光和,2024-07-26,6380
2867,三商壽,14,3,11,光和,2024-07-26,6380
4714,永捷,11,0,11,光和,2024-07-26,6380
8926,台汽電,15,4,11,光和,2024-07-26,6380
3033,威健,15,5,10,光和,2024-07-26,6380
00905,FT臺灣Smart,10,0,10,光和,2024-07-26,6380
00665L,富邦�琤肭磪囓�2,10,0,10,光和,2024-07-26,6380
00936,台新永續高息中小,11,1,10,光和,2024-07-26,6380
1210,大成,10,0,10,光和,2024-07-26,6380
2373,震旦行,10,0,10,光和,2024-07-26,6380
00632R,元大台灣50反1,326,196,130,光和,2024-07-29,6380
1314,中石化,128,1,127,光和,2024-07-29,6380
2845,遠東銀,100,0,100,光和,2024-07-29,6380
00919,群益台灣精選高息,102,10,92,光和,2024-07-29,6380
00929,復華台灣科技優息,106,24,82,光和,2024-07-29,6380
2888,新光金,75,5,70,光和,2024-07-29,6380
00878,國泰永續高股息,63,4,59,光和,2024-07-29,6380
3481,群創,112,56,56,光和,2024-07-29,6380
2356,英業達,74,28,46,光和,2024-07-29,6380
00934,中信成長高股息,42,1,41,光和,2024-07-29,6380
0056,元大高股息,43,3,40,光和,2024-07-29,6380
6457,紘康,35,0,35,光和,2024-07-29,6380
00940,元大台灣價值高息,33,0,33,光和,2024-07-29,6380
00946,群益科技高息成長,33,0,33,光和,2024-07-29,6380
00947,台新臺灣IC設計,32,0,32,光和,2024-07-29,6380
6136,富爾特,30,0,30,光和,2024-07-29,6380
2409,友達,31,1,30,光和,2024-07-29,6380
2363,矽統,43,15,28,光和,2024-07-29,6380
6806,森崴能源,27,1,26,光和,2024-07-29,6380
1210,大成,24,0,24,光和,2024-07-29,6380
1609,大亞,50,26,24,光和,2024-07-29,6380
1717,長興,22,0,22,光和,2024-07-29,6380
6269,台郡,23,3,20,光和,2024-07-29,6380
6603,富強鑫,20,0,20,光和,2024-07-29,6380
2367,燿華,26,7,19,光和,2024-07-29,6380
2883,凱基金,19,1,18,光和,2024-07-29,6380
5009,榮剛,18,0,18,光和,2024-07-29,6380
4564,元翎,16,0,16,光和,2024-07-29,6380
8064,東捷,26,10,16,光和,2024-07-29,6380
3035,智原,15,1,14,光和,2024-07-29,6380
4167,松瑞藥,14,0,14,光和,2024-07-29,6380
2401,凌陽,13,0,13,光和,2024-07-29,6380
6153,嘉聯益,17,4,13,光和,2024-07-29,6380
6213,聯茂,13,0,13,光和,2024-07-29,6380
2834,臺企銀,12,0,12,光和,2024-07-29,6380
00637L,元大滬深300正2,11,0,11,光和,2024-07-29,6380
3346,麗清,11,0,11,光和,2024-07-29,6380
3713,新晶投控,14,3,11,光和,2024-07-29,6380
4714,永捷,11,0,11,光和,2024-07-29,6380
9945,潤泰新,18,7,11,光和,2024-07-29,6380
2905,三商,10,0,10,光和,2024-07-29,6380
2913,農林,10,0,10,光和,2024-07-29,6380
3014,聯陽,10,0,10,光和,2024-07-29,6380
4956,光鋐,10,0,10,光和,2024-07-29,6380
9105,泰金寶-DR,10,0,10,光和,2024-07-29,6380
3231,緯創,14,4,10,光和,2024-07-29,6380
2344,華邦電,10,1,9,光和,2024-07-29,6380
2061,風青,10,1,9,光和,2024-07-29,6380
2527,宏璟,9,0,9,光和,2024-07-29,6380
6182,合晶,10,1,9,光和,2024-07-29,6380
00929,復華台灣科技優息,153,42,111,光和,2024-07-30,6380
2888,新光金,98,30,68,光和,2024-07-30,6380
4123,晟德,64,0,64,光和,2024-07-30,6380
00940,元大台灣價值高息,80,22,58,光和,2024-07-30,6380
2349,錸德,54,8,46,光和,2024-07-30,6380
2408,南亞科,44,0,44,光和,2024-07-30,6380
00946,群益科技高息成長,34,0,34,光和,2024-07-30,6380
00919,群益台灣精選高息,72,40,32,光和,2024-07-30,6380
00937B,群益ESG投等債20,32,1,31,光和,2024-07-30,6380
1312,國喬,34,3,31,光和,2024-07-30,6380
00878,國泰永續高股息,45,17,28,光和,2024-07-30,6380
2883,凱基金,33,8,25,光和,2024-07-30,6380
00934,中信成長高股息,36,12,24,光和,2024-07-30,6380
2867,三商壽,46,24,22,光和,2024-07-30,6380
2303,聯電,21,0,21,光和,2024-07-30,6380
2401,凌陽,24,3,21,光和,2024-07-30,6380
3048,益登,22,1,21,光和,2024-07-30,6380
00692,富邦公司治理,20,0,20,光和,2024-07-30,6380
00939,統一台灣高息動能,20,0,20,光和,2024-07-30,6380
1815,富喬,30,10,20,光和,2024-07-30,6380
5309,系統電,25,6,19,光和,2024-07-30,6380
00936,台新永續高息中小,18,0,18,光和,2024-07-30,6380
8064,東捷,29,13,16,光和,2024-07-30,6380
1304,台聚,20,5,15,光和,2024-07-30,6380
2365,昆盈,40,25,15,光和,2024-07-30,6380
3047,訊舟,15,0,15,光和,2024-07-30,6380
5475,德宏,15,0,15,光和,2024-07-30,6380
5515,建國,15,0,15,光和,2024-07-30,6380
4167,松瑞藥,14,0,14,光和,2024-07-30,6380
2329,華泰,14,1,13,光和,2024-07-30,6380
2882,國泰金,13,0,13,光和,2024-07-30,6380
00947,台新臺灣IC設計,12,0,12,光和,2024-07-30,6380
3189,景碩,22,10,12,光和,2024-07-30,6380
0056,元大高股息,21,10,11,光和,2024-07-30,6380
1210,大成,11,0,11,光和,2024-07-30,6380
2376,技嘉,18,7,11,光和,2024-07-30,6380
3024,憶聲,13,2,11,光和,2024-07-30,6380
3713,新晶投控,14,3,11,光和,2024-07-30,6380
9105,泰金寶-DR,11,0,11,光和,2024-07-30,6380
2062,橋椿,13,2,11,光和,2024-07-30,6380
0050,元大台灣50,10,0,10,光和,2024-07-30,6380
00902,中信電池及儲能,10,0,10,光和,2024-07-30,6380
00882,中信中國高股息,10,0,10,光和,2024-07-30,6380
1612,宏泰,10,0,10,光和,2024-07-30,6380
2324,仁寶,10,0,10,光和,2024-07-30,6380
2371,大同,11,1,10,光和,2024-07-30,6380
2913,農林,10,0,10,光和,2024-07-30,6380
3014,聯陽,10,0,10,光和,2024-07-30,6380
6016,康和證,10,0,10,光和,2024-07-30,6380
8436,大江,10,0,10,光和,2024-07-30,6380
2409,友達,134,9,125,光和,2024-07-31,6380
2337,旺宏,143,40,103,光和,2024-07-31,6380
2344,華邦電,107,8,99,光和,2024-07-31,6380
00937B,群益ESG投等債20,93,0,93,光和,2024-07-31,6380
3481,群創,132,60,72,光和,2024-07-31,6380
1815,富喬,70,2,68,光和,2024-07-31,6380
4123,晟德,60,0,60,光和,2024-07-31,6380
3712,永崴投控,60,2,58,光和,2024-07-31,6380
00919,群益台灣精選高息,46,0,46,光和,2024-07-31,6380
00936,台新永續高息中小,44,0,44,光和,2024-07-31,6380
1609,大亞,43,2,41,光和,2024-07-31,6380
00929,復華台灣科技優息,49,10,39,光和,2024-07-31,6380
00878,國泰永續高股息,38,0,38,光和,2024-07-31,6380
00934,中信成長高股息,36,0,36,光和,2024-07-31,6380
00940,元大台灣價值高息,35,0,35,光和,2024-07-31,6380
3703,欣陸,32,3,29,光和,2024-07-31,6380
00946,群益科技高息成長,27,0,27,光和,2024-07-31,6380
6182,合晶,25,0,25,光和,2024-07-31,6380
2365,昆盈,25,4,21,光和,2024-07-31,6380
2020,美亞,20,1,19,光和,2024-07-31,6380
2362,藍天,26,8,18,光和,2024-07-31,6380
0056,元大高股息,18,1,17,光和,2024-07-31,6380
2489,瑞軒,24,7,17,光和,2024-07-31,6380
2359,所羅門,23,9,14,光和,2024-07-31,6380
2401,凌陽,14,0,14,光和,2024-07-31,6380
3231,緯創,21,7,14,光和,2024-07-31,6380
3047,訊舟,30,17,13,光和,2024-07-31,6380
4564,元翎,14,1,13,光和,2024-07-31,6380
6244,茂迪,23,10,13,光和,2024-07-31,6380
8054,安國,14,1,13,光和,2024-07-31,6380
1457,宜進,11,0,11,光和,2024-07-31,6380
4534,慶騰,11,0,11,光和,2024-07-31,6380
00935,野村臺灣新科技50,10,0,10,光和,2024-07-31,6380
1905,華紙,10,0,10,光和,2024-07-31,6380
2641,正德,10,0,10,光和,2024-07-31,6380
2905,三商,10,0,10,光和,2024-07-31,6380
2913,農林,10,0,10,光和,2024-07-31,6380
4968,立積,11,1,10,光和,2024-07-31,6380
5515,建國,10,0,10,光和,2024-07-31,6380
2371,大同,10,1,9,光和,2024-07-31,6380
8936,國統,10,1,9,光和,2024-07-31,6380
4303,信立,13,4,9,光和,2024-07-31,6380
2881,富邦金,10,2,8,光和,2024-07-31,6380
3518,柏騰,10,2,8,光和,2024-07-31,6380
4967,十銓,27,19,8,光和,2024-07-31,6380
5009,榮剛,8,0,8,光和,2024-07-31,6380
2002,中鋼,7,0,7,光和,2024-07-31,6380
3037,欣興,10,3,7,光和,2024-07-31,6380
00712,復華富時不動產,56,49,7,光和,2024-07-31,6380
1795,美時,7,0,7,光和,2024-07-31,6380
00919,群益台灣精選高息,291,15,276,光和,2024-08-01,6380
2344,華邦電,97,17,80,光和,2024-08-01,6380
00937B,群益ESG投等債20,64,0,64,光和,2024-08-01,6380
00712,復華富時不動產,82,20,62,光和,2024-08-01,6380
00637L,元大滬深300正2,32,0,32,光和,2024-08-01,6380
2349,錸德,48,20,28,光和,2024-08-01,6380
2888,新光金,41,14,27,光和,2024-08-01,6380
3481,群創,62,36,26,光和,2024-08-01,6380
2337,旺宏,183,158,25,光和,2024-08-01,6380
8011,台通,27,2,25,光和,2024-08-01,6380
2801,彰銀,25,0,25,光和,2024-08-01,6380
2614,東森,24,0,24,光和,2024-08-01,6380
00878,國泰永續高股息,32,10,22,光和,2024-08-01,6380
00923,群益台ESG低碳50,20,0,20,光和,2024-08-01,6380
4503,金雨,19,0,19,光和,2024-08-01,6380
8064,東捷,32,14,18,光和,2024-08-01,6380
5309,系統電,18,0,18,光和,2024-08-01,6380
2363,矽統,30,12,18,光和,2024-08-01,6380
2884,玉山金,18,2,16,光和,2024-08-01,6380
4545,銘鈺,16,0,16,光和,2024-08-01,6380
00756B,群益投等新興公債,15,0,15,光和,2024-08-01,6380
2409,友達,15,2,13,光和,2024-08-01,6380
2834,臺企銀,13,0,13,光和,2024-08-01,6380
2412,中華電,12,0,12,光和,2024-08-01,6380
2417,圓剛,12,0,12,光和,2024-08-01,6380
00922,國泰台灣領袖50,11,0,11,光和,2024-08-01,6380
00933B,國泰10Y+金融債,11,0,11,光和,2024-08-01,6380
00948B,中信優息投資級債,11,0,11,光和,2024-08-01,6380
3231,緯創,29,18,11,光和,2024-08-01,6380
00951,台新日本半導體,10,0,10,光和,2024-08-01,6380
1303,南亞,10,0,10,光和,2024-08-01,6380
00882,中信中國高股息,10,0,10,光和,2024-08-01,6380
00679B,元大美債20年,14,4,10,光和,2024-08-01,6380
2609,陽明,13,3,10,光和,2024-08-01,6380
2906,高林,10,0,10,光和,2024-08-01,6380
3014,聯陽,10,0,10,光和,2024-08-01,6380
3128,昇銳,10,0,10,光和,2024-08-01,6380
1799,易威,9,0,9,光和,2024-08-01,6380
2329,華泰,10,1,9,光和,2024-08-01,6380
2486,一詮,14,5,9,光和,2024-08-01,6380
3189,景碩,18,9,9,光和,2024-08-01,6380
2419,仲琦,10,2,8,光和,2024-08-01,6380
2606,裕民,10,2,8,光和,2024-08-01,6380
2393,億光,8,1,7,光和,2024-08-01,6380
6152,百一,7,0,7,光和,2024-08-01,6380
3443,創意,6,0,6,光和,2024-08-01,6380
1444,力麗,6,0,6,光和,2024-08-01,6380
3105,穩懋,7,1,6,光和,2024-08-01,6380
4968,立積,6,0,6,光和,2024-08-01,6380
00680L,元大美債20正2,5,0,5,光和,2024-08-01,6380
2337,旺宏,240,51,189,光和,2024-08-02,6380
00878,國泰永續高股息,147,0,147,光和,2024-08-02,6380
2317,鴻海,147,11,136,光和,2024-08-02,6380
00680L,元大美債20正2,172,40,132,光和,2024-08-02,6380
00929,復華台灣科技優息,137,5,132,光和,2024-08-02,6380
00712,復華富時不動產,128,26,102,光和,2024-08-02,6380
6116,彩晶,91,0,91,光和,2024-08-02,6380
00940,元大台灣價值高息,115,29,86,光和,2024-08-02,6380
00919,群益台灣精選高息,82,2,80,光和,2024-08-02,6380
2408,南亞科,79,1,78,光和,2024-08-02,6380
1711,永光,62,2,60,光和,2024-08-02,6380
4306,炎洲,60,0,60,光和,2024-08-02,6380
1304,台聚,59,1,58,光和,2024-08-02,6380
2801,彰銀,57,0,57,光和,2024-08-02,6380
3081,聯亞,52,1,51,光和,2024-08-02,6380
00934,中信成長高股息,62,14,48,光和,2024-08-02,6380
00937B,群益ESG投等債20,113,72,41,光和,2024-08-02,6380
0056,元大高股息,50,10,40,光和,2024-08-02,6380
00951,台新日本半導體,34,0,34,光和,2024-08-02,6380
2834,臺企銀,34,0,34,光和,2024-08-02,6380
00949,復華日本龍頭,31,0,31,光和,2024-08-02,6380
6264,富裔,31,0,31,光和,2024-08-02,6380
1605,華新,28,0,28,光和,2024-08-02,6380
2409,友達,32,6,26,光和,2024-08-02,6380
00881,國泰台灣5G+,25,0,25,光和,2024-08-02,6380
3037,欣興,28,4,24,光和,2024-08-02,6380
6239,力成,26,3,23,光和,2024-08-02,6380
3703,欣陸,26,3,23,光和,2024-08-02,6380
8150,南茂,25,2,23,光和,2024-08-02,6380
3481,群創,144,122,22,光和,2024-08-02,6380
2349,錸德,36,15,21,光和,2024-08-02,6380
2481,強茂,21,0,21,光和,2024-08-02,6380
2330,台積電,28,7,21,光和,2024-08-02,6380
00692,富邦公司治理,20,0,20,光和,2024-08-02,6380
00885,富邦越南,20,0,20,光和,2024-08-02,6380
4563,百德,21,1,20,光和,2024-08-02,6380
6016,康和證,20,0,20,光和,2024-08-02,6380
2356,英業達,24,5,19,光和,2024-08-02,6380
00753L,中信中國50正2,18,0,18,光和,2024-08-02,6380
3321,同泰,20,2,18,光和,2024-08-02,6380
1710,東聯,17,0,17,光和,2024-08-02,6380
2353,宏��,23,6,17,光和,2024-08-02,6380
1609,大亞,20,4,16,光和,2024-08-02,6380
1316,上曜,18,3,15,光和,2024-08-02,6380
00830,國泰費城半導體,15,0,15,光和,2024-08-02,6380
00933B,國泰10Y+金融債,15,0,15,光和,2024-08-02,6380
2417,圓剛,15,0,15,光和,2024-08-02,6380
0050,元大台灣50,14,0,14,光和,2024-08-02,6380
00941,中信上游半導體,14,0,14,光和,2024-08-02,6380
6244,茂迪,14,0,14,光和,2024-08-02,6380
00929,復華台灣科技優息,455,105,350,光和,2024-08-05,6380
00878,國泰永續高股息,241,28,213,光和,2024-08-05,6380
00919,群益台灣精選高息,213,15,198,光和,2024-08-05,6380
00940,元大台灣價值高息,297,109,188,光和,2024-08-05,6380
00680L,元大美債20正2,220,35,185,光和,2024-08-05,6380
2409,友達,164,5,159,光和,2024-08-05,6380
2610,華航,147,11,136,光和,2024-08-05,6380
2801,彰銀,147,15,132,光和,2024-08-05,6380
00885,富邦越南,100,0,100,光和,2024-08-05,6380
1449,佳和,100,0,100,光和,2024-08-05,6380
00945B,凱基美國非投等債,79,0,79,光和,2024-08-05,6380
2317,鴻海,100,21,79,光和,2024-08-05,6380
2867,三商壽,127,57,70,光和,2024-08-05,6380
00676R,富邦臺灣加權反1,60,0,60,光和,2024-08-05,6380
2888,新光金,82,22,60,光和,2024-08-05,6380
1314,中石化,104,45,59,光和,2024-08-05,6380
00946,群益科技高息成長,48,0,48,光和,2024-08-05,6380
3029,零壹,46,3,43,光和,2024-08-05,6380
2542,興富發,41,0,41,光和,2024-08-05,6380
2905,三商,40,0,40,光和,2024-08-05,6380
2515,中工,40,3,37,光和,2024-08-05,6380
0056,元大高股息,51,15,36,光和,2024-08-05,6380
2062,橋椿,39,3,36,光和,2024-08-05,6380
2312,金寶,40,6,34,光和,2024-08-05,6380
3481,群創,163,132,31,光和,2024-08-05,6380
2845,遠東銀,31,0,31,光和,2024-08-05,6380
2354,鴻準,31,0,31,光和,2024-08-05,6380
00753L,中信中國50正2,29,0,29,光和,2024-08-05,6380
2883,凱基金,69,41,28,光和,2024-08-05,6380
1609,大亞,69,41,28,光和,2024-08-05,6380
00712,復華富時不動產,38,10,28,光和,2024-08-05,6380
4123,晟德,38,10,28,光和,2024-08-05,6380
1802,台玻,27,0,27,光和,2024-08-05,6380
2002,中鋼,28,1,27,光和,2024-08-05,6380
1304,台聚,26,0,26,光和,2024-08-05,6380
9105,泰金寶-DR,26,0,26,光和,2024-08-05,6380
00881,國泰台灣5G+,24,0,24,光和,2024-08-05,6380
1612,宏泰,21,0,21,光和,2024-08-05,6380
0050,元大台灣50,22,1,21,光和,2024-08-05,6380
2618,長榮航,42,21,21,光和,2024-08-05,6380
2603,長榮,24,3,21,光和,2024-08-05,6380
00795B,中信美國公債20年,20,0,20,光和,2024-08-05,6380
1711,永光,20,0,20,光和,2024-08-05,6380
2417,圓剛,20,0,20,光和,2024-08-05,6380
4306,炎洲,20,0,20,光和,2024-08-05,6380
6275,元山,20,0,20,光和,2024-08-05,6380
2330,台積電,57,37,20,光和,2024-08-05,6380
2464,盟立,19,0,19,光和,2024-08-05,6380
00902,中信電池及儲能,17,0,17,光和,2024-08-05,6380
00951,台新日本半導體,17,0,17,光和,2024-08-05,6380
2888,新光金,356,36,320,光和,2024-08-06,6380
2317,鴻海,156,52,104,光和,2024-08-06,6380
00940,元大台灣價值高息,107,17,90,光和,2024-08-06,6380
2409,友達,116,31,85,光和,2024-08-06,6380
6770,力積電,73,2,71,光和,2024-08-06,6380
2515,中工,63,0,63,光和,2024-08-06,6380
4915,致伸,61,0,61,光和,2024-08-06,6380
4564,元翎,43,0,43,光和,2024-08-06,6380
00945B,凱基美國非投等債,40,0,40,光和,2024-08-06,6380
00929,復華台灣科技優息,73,34,39,光和,2024-08-06,6380
4114,健喬,39,0,39,光和,2024-08-06,6380
00878,國泰永續高股息,49,11,38,光和,2024-08-06,6380
3078,僑威,35,0,35,光和,2024-08-06,6380
00680L,元大美債20正2,64,30,34,光和,2024-08-06,6380
2542,興富發,34,0,34,光和,2024-08-06,6380
00946,群益科技高息成長,36,3,33,光和,2024-08-06,6380
1449,佳和,30,0,30,光和,2024-08-06,6380
2109,華豐,30,0,30,光和,2024-08-06,6380
6811,宏�硌穈T,28,0,28,光和,2024-08-06,6380
1710,東聯,27,2,25,光和,2024-08-06,6380
1569,濱川,24,0,24,光和,2024-08-06,6380
9904,寶成,24,3,21,光和,2024-08-06,6380
00881,國泰台灣5G+,20,0,20,光和,2024-08-06,6380
00665L,富邦�琤肭磪囓�2,30,10,20,光和,2024-08-06,6380
1612,宏泰,20,0,20,光和,2024-08-06,6380
6120,達運,20,0,20,光和,2024-08-06,6380
2356,英業達,34,16,18,光和,2024-08-06,6380
3623,富晶通,18,0,18,光和,2024-08-06,6380
0056,元大高股息,29,12,17,光和,2024-08-06,6380
00939,統一台灣高息動能,17,2,15,光和,2024-08-06,6380
00753L,中信中國50正2,55,40,15,光和,2024-08-06,6380
2402,毅嘉,15,0,15,光和,2024-08-06,6380
5521,工信,15,0,15,光和,2024-08-06,6380
00637L,元大滬深300正2,24,10,14,光和,2024-08-06,6380
1810,和成,15,1,14,光和,2024-08-06,6380
5309,系統電,14,0,14,光和,2024-08-06,6380
00720B,元大投資級公司債,13,0,13,光和,2024-08-06,6380
1802,台玻,13,0,13,光和,2024-08-06,6380
1101,台泥,16,3,13,光和,2024-08-06,6380
2108,南帝,17,5,12,光和,2024-08-06,6380
2892,第一金,12,1,11,光和,2024-08-06,6380
3673,TPK-KY,12,1,11,光和,2024-08-06,6380
911608,明輝-DR,15,4,11,光和,2024-08-06,6380
2905,三商,13,2,11,光和,2024-08-06,6380
2486,一詮,11,1,10,光和,2024-08-06,6380
2316,楠梓電,10,0,10,光和,2024-08-06,6380
1104,環泥,10,0,10,光和,2024-08-06,6380
2031,新光鋼,10,0,10,光和,2024-08-06,6380
2349,錸德,33,23,10,光和,2024-08-06,6380
2417,圓剛,10,0,10,光和,2024-08-06,6380
00632R,元大台灣50反1,920,30,890,光和,2024-08-07,6380
00937B,群益ESG投等債20,121,6,115,光和,2024-08-07,6380
2409,友達,73,3,70,光和,2024-08-07,6380
00878,國泰永續高股息,63,3,60,光和,2024-08-07,6380
00680L,元大美債20正2,58,0,58,光和,2024-08-07,6380
3481,群創,113,58,55,光和,2024-08-07,6380
00929,復華台灣科技優息,56,11,45,光和,2024-08-07,6380
2317,鴻海,82,39,43,光和,2024-08-07,6380
2834,臺企銀,40,0,40,光和,2024-08-07,6380
00706L,期元大S＆P日圓正2,30,0,30,光和,2024-08-07,6380
2892,第一金,31,1,30,光和,2024-08-07,6380
2408,南亞科,39,13,26,光和,2024-08-07,6380
2633,台灣高鐵,25,0,25,光和,2024-08-07,6380
2887,台新金,25,0,25,光和,2024-08-07,6380
00641R,富邦日本反1,23,0,23,光和,2024-08-07,6380
00692,富邦公司治理,22,0,22,光和,2024-08-07,6380
2905,三商,21,0,21,光和,2024-08-07,6380
00946,群益科技高息成長,20,1,19,光和,2024-08-07,6380
3189,景碩,41,22,19,光和,2024-08-07,6380
4128,中天,19,0,19,光和,2024-08-07,6380
00940,元大台灣價值高息,39,21,18,光和,2024-08-07,6380
00679B,元大美債20年,17,1,16,光和,2024-08-07,6380
6274,台燿,13,0,13,光和,2024-08-07,6380
00934,中信成長高股息,18,6,12,光和,2024-08-07,6380
2845,遠東銀,11,0,11,光和,2024-08-07,6380
3013,晟銘電,15,4,11,光和,2024-08-07,6380
2449,京元電子,41,31,10,光和,2024-08-07,6380
1711,永光,10,0,10,光和,2024-08-07,6380
2340,台亞,10,0,10,光和,2024-08-07,6380
2634,漢翔,10,0,10,光和,2024-08-07,6380
2890,永豐金,10,0,10,光和,2024-08-07,6380
3032,偉訓,10,0,10,光和,2024-08-07,6380
4108,懷特,10,0,10,光和,2024-08-07,6380
4804,大略-KY,10,0,10,光和,2024-08-07,6380
6952,大武山,10,0,10,光和,2024-08-07,6380
9945,潤泰新,10,0,10,光和,2024-08-07,6380
2363,矽統,14,5,9,光和,2024-08-07,6380
1312,國喬,10,1,9,光和,2024-08-07,6380
2371,大同,10,1,9,光和,2024-08-07,6380
3037,欣興,12,3,9,光和,2024-08-07,6380
2382,廣達,12,4,8,光和,2024-08-07,6380
00941,中信上游半導體,8,0,8,光和,2024-08-07,6380
1608,華榮,11,3,8,光和,2024-08-07,6380
00715L,期街口布蘭特正2,7,0,7,光和,2024-08-07,6380
5902,德記,7,0,7,光和,2024-08-07,6380
6189,豐藝,9,2,7,光和,2024-08-07,6380
6770,力積電,11,4,7,光和,2024-08-07,6380
2886,兆豐金,9,2,7,光和,2024-08-07,6380
3711,日月光投控,8,2,6,光和,2024-08-07,6380
1582,信錦,6,0,6,光和,2024-08-07,6380
00929,復華台灣科技優息,104,1,103,光和,2024-08-08,6380
2886,兆豐金,83,1,82,光和,2024-08-08,6380
2834,臺企銀,83,6,77,光和,2024-08-08,6380
2317,鴻海,84,28,56,光和,2024-08-08,6380
00878,國泰永續高股息,53,0,53,光和,2024-08-08,6380
00937B,群益ESG投等債20,52,0,52,光和,2024-08-08,6380
00687B,國泰20年美債,41,0,41,光和,2024-08-08,6380
2481,強茂,39,0,39,光和,2024-08-08,6380
4564,元翎,42,3,39,光和,2024-08-08,6380
2515,中工,37,1,36,光和,2024-08-08,6380
2892,第一金,30,0,30,光和,2024-08-08,6380
2031,新光鋼,28,1,27,光和,2024-08-08,6380
00679B,元大美債20年,21,0,21,光和,2024-08-08,6380
2641,正德,24,3,21,光和,2024-08-08,6380
2891,中信金,21,1,20,光和,2024-08-08,6380
00665L,富邦�琤肭磪囓�2,20,0,20,光和,2024-08-08,6380
6213,聯茂,25,5,20,光和,2024-08-08,6380
2408,南亞科,22,3,19,光和,2024-08-08,6380
00637L,元大滬深300正2,20,1,19,光和,2024-08-08,6380
0056,元大高股息,23,4,19,光和,2024-08-08,6380
2062,橋椿,18,0,18,光和,2024-08-08,6380
00795B,中信美國公債20年,17,0,17,光和,2024-08-08,6380
00891,中信關鍵半導體,17,0,17,光和,2024-08-08,6380
2607,榮運,17,0,17,光和,2024-08-08,6380
2323,中環,19,4,15,光和,2024-08-08,6380
2353,宏��,14,0,14,光和,2024-08-08,6380
2610,華航,14,0,14,光和,2024-08-08,6380
2356,英業達,19,6,13,光和,2024-08-08,6380
2409,友達,26,14,12,光和,2024-08-08,6380
3024,憶聲,13,1,12,光和,2024-08-08,6380
8021,尖點,12,0,12,光和,2024-08-08,6380
2382,廣達,15,4,11,光和,2024-08-08,6380
1304,台聚,13,2,11,光和,2024-08-08,6380
2329,華泰,11,0,11,光和,2024-08-08,6380
00919,群益台灣精選高息,11,0,11,光和,2024-08-08,6380
00680L,元大美債20正2,10,0,10,光和,2024-08-08,6380
00772B,中信高評級公司債,10,0,10,光和,2024-08-08,6380
1785,光洋科,17,7,10,光和,2024-08-08,6380
2373,震旦行,10,0,10,光和,2024-08-08,6380
2388,威盛,10,0,10,光和,2024-08-08,6380
2609,陽明,21,11,10,光和,2024-08-08,6380
3029,零壹,13,3,10,光和,2024-08-08,6380
3032,偉訓,10,0,10,光和,2024-08-08,6380
4108,懷特,10,0,10,光和,2024-08-08,6380
4915,致伸,10,0,10,光和,2024-08-08,6380
6235,華孚,11,1,10,光和,2024-08-08,6380
6244,茂迪,10,0,10,光和,2024-08-08,6380
2417,圓剛,11,2,9,光和,2024-08-08,6380
2365,昆盈,63,55,8,光和,2024-08-08,6380
00940,元大台灣價值高息,16,8,8,光和,2024-08-08,6380
00632R,元大台灣50反1,1041,0,1041,光和,2024-08-09,6380
00937B,群益ESG投等債20,277,51,226,光和,2024-08-09,6380
2609,陽明,171,34,137,光和,2024-08-09,6380
00680L,元大美債20正2,104,0,104,光和,2024-08-09,6380
00679B,元大美債20年,62,2,60,光和,2024-08-09,6380
3481,群創,130,76,54,光和,2024-08-09,6380
3576,聯合再生,45,0,45,光和,2024-08-09,6380
00929,復華台灣科技優息,48,6,42,光和,2024-08-09,6380
2615,萬海,85,45,40,光和,2024-08-09,6380
00706L,期元大S＆P日圓正2,40,0,40,光和,2024-08-09,6380
2349,錸德,40,9,31,光和,2024-08-09,6380
2031,新光鋼,36,7,29,光和,2024-08-09,6380
9105,泰金寶-DR,33,15,18,光和,2024-08-09,6380
2506,太設,20,3,17,光和,2024-08-09,6380
2368,金像電,37,21,16,光和,2024-08-09,6380
6443,元晶,15,0,15,光和,2024-08-09,6380
2353,宏��,29,15,14,光和,2024-08-09,6380
3686,達能,14,0,14,光和,2024-08-09,6380
3231,緯創,43,29,14,光和,2024-08-09,6380
00936,台新永續高息中小,21,8,13,光和,2024-08-09,6380
2365,昆盈,54,41,13,光和,2024-08-09,6380
2352,佳世達,12,0,12,光和,2024-08-09,6380
3715,定穎投控,18,6,12,光和,2024-08-09,6380
00687B,國泰20年美債,11,0,11,光和,2024-08-09,6380
1785,光洋科,17,6,11,光和,2024-08-09,6380
4561,健椿,28,17,11,光和,2024-08-09,6380
8050,廣積,10,0,10,光和,2024-08-09,6380
2374,佳能,10,0,10,光和,2024-08-09,6380
2520,冠德,10,0,10,光和,2024-08-09,6380
2547,日勝生,10,0,10,光和,2024-08-09,6380
2845,遠東銀,10,0,10,光和,2024-08-09,6380
2883,凱基金,35,25,10,光和,2024-08-09,6380
3047,訊舟,26,16,10,光和,2024-08-09,6380
3230,錦明,10,0,10,光和,2024-08-09,6380
6117,迎廣,11,1,10,光和,2024-08-09,6380
6244,茂迪,10,0,10,光和,2024-08-09,6380
1314,中石化,11,1,10,光和,2024-08-09,6380
00945B,凱基美國非投等債,10,1,9,光和,2024-08-09,6380
2301,光寶科,11,2,9,光和,2024-08-09,6380
2354,鴻準,12,3,9,光和,2024-08-09,6380
2371,大同,19,10,9,光和,2024-08-09,6380
3057,喬鼎,9,0,9,光和,2024-08-09,6380
6276,安鈦克,9,0,9,光和,2024-08-09,6380
00948B,中信優息投資級債,8,0,8,光和,2024-08-09,6380
1616,億泰,8,0,8,光和,2024-08-09,6380
2834,臺企銀,15,7,8,光和,2024-08-09,6380
1714,和桐,7,0,7,光和,2024-08-09,6380
3189,景碩,7,0,7,光和,2024-08-09,6380
5484,慧友,7,0,7,光和,2024-08-09,6380
00933B,國泰10Y+金融債,6,0,6,光和,2024-08-09,6380
00632R,元大台灣50反1,1066,406,660,光和,2024-08-12,6380
00680L,元大美債20正2,252,2,250,光和,2024-08-12,6380
2883,凱基金,200,18,182,光和,2024-08-12,6380
00712,復華富時不動產,91,10,81,光和,2024-08-12,6380
00664R,國泰臺灣加權反1,80,0,80,光和,2024-08-12,6380
1101,台泥,76,1,75,光和,2024-08-12,6380
3481,群創,176,108,68,光和,2024-08-12,6380
00676R,富邦臺灣加權反1,50,0,50,光和,2024-08-12,6380
00929,復華台灣科技優息,68,19,49,光和,2024-08-12,6380
2062,橋椿,48,20,28,光和,2024-08-12,6380
00878,國泰永續高股息,31,3,28,光和,2024-08-12,6380
2312,金寶,65,38,27,光和,2024-08-12,6380
6215,和椿,33,7,26,光和,2024-08-12,6380
1314,中石化,21,0,21,光和,2024-08-12,6380
2409,友達,21,0,21,光和,2024-08-12,6380
3673,TPK-KY,20,0,20,光和,2024-08-12,6380
00882,中信中國高股息,20,0,20,光和,2024-08-12,6380
1785,光洋科,23,4,19,光和,2024-08-12,6380
2506,太設,19,1,18,光和,2024-08-12,6380
2891,中信金,18,0,18,光和,2024-08-12,6380
2359,所羅門,21,4,17,光和,2024-08-12,6380
00751B,元大AAA至A公司債,16,0,16,光和,2024-08-12,6380
3024,憶聲,16,0,16,光和,2024-08-12,6380
1218,泰山,15,0,15,光和,2024-08-12,6380
3706,神達,19,5,14,光和,2024-08-12,6380
4967,十銓,14,0,14,光和,2024-08-12,6380
3663,鑫科,19,6,13,光和,2024-08-12,6380
8358,金居,15,2,13,光和,2024-08-12,6380
2031,新光鋼,12,0,12,光和,2024-08-12,6380
00688L,國泰20年美債正2,12,0,12,光和,2024-08-12,6380
1597,直得,13,1,12,光和,2024-08-12,6380
2605,新興,12,0,12,光和,2024-08-12,6380
3535,晶彩科,17,5,12,光和,2024-08-12,6380
2888,新光金,66,54,12,光和,2024-08-12,6380
2610,華航,14,3,11,光和,2024-08-12,6380
3260,威剛,10,0,10,光和,2024-08-12,6380
2108,南帝,10,0,10,光和,2024-08-12,6380
2324,仁寶,10,0,10,光和,2024-08-12,6380
4111,濟生,10,0,10,光和,2024-08-12,6380
1316,上曜,10,0,10,光和,2024-08-12,6380
3293,鈊象,11,1,10,光和,2024-08-12,6380
2511,太子,10,1,9,光和,2024-08-12,6380
1447,力鵬,8,0,8,光和,2024-08-12,6380
3167,大量,23,15,8,光和,2024-08-12,6380
6187,萬潤,12,4,8,光和,2024-08-12,6380
2363,矽統,10,3,7,光和,2024-08-12,6380
2369,菱生,10,3,7,光和,2024-08-12,6380
3047,訊舟,13,6,7,光和,2024-08-12,6380
5381,合正,7,0,7,光和,2024-08-12,6380
8085,福華,7,0,7,光和,2024-08-12,6380
3481,群創,221,77,144,光和,2024-08-13,6380
2609,陽明,124,22,102,光和,2024-08-13,6380
00929,復華台灣科技優息,73,1,72,光和,2024-08-13,6380
00936,台新永續高息中小,70,0,70,光和,2024-08-13,6380
2615,萬海,70,6,64,光和,2024-08-13,6380
00676R,富邦臺灣加權反1,50,0,50,光和,2024-08-13,6380
2867,三商壽,50,0,50,光和,2024-08-13,6380
2208,台船,57,11,46,光和,2024-08-13,6380
2801,彰銀,45,0,45,光和,2024-08-13,6380
00679B,元大美債20年,40,0,40,光和,2024-08-13,6380
2880,華南金,26,0,26,光和,2024-08-13,6380
00940,元大台灣價值高息,27,2,25,光和,2024-08-13,6380
1101,台泥,27,4,23,光和,2024-08-13,6380
2913,農林,20,0,20,光和,2024-08-13,6380
2317,鴻海,61,43,18,光和,2024-08-13,6380
00951,台新日本半導體,18,0,18,光和,2024-08-13,6380
2891,中信金,15,0,15,光和,2024-08-13,6380
4540,全球傳動,21,6,15,光和,2024-08-13,6380
00907,永豐優息存股,15,0,15,光和,2024-08-13,6380
1301,台塑,15,0,15,光和,2024-08-13,6380
1799,易威,15,0,15,光和,2024-08-13,6380
2610,華航,149,134,15,光和,2024-08-13,6380
2603,長榮,20,5,15,光和,2024-08-13,6380
2537,聯上發,15,1,14,光和,2024-08-13,6380
3356,奇偶,18,4,14,光和,2024-08-13,6380
5905,南仁湖,14,0,14,光和,2024-08-13,6380
6505,台塑化,13,0,13,光和,2024-08-13,6380
00946,群益科技高息成長,13,0,13,光和,2024-08-13,6380
3691,碩禾,13,0,13,光和,2024-08-13,6380
1513,中興電,18,6,12,光和,2024-08-13,6380
00904,新光臺灣半導體30,12,0,12,光和,2024-08-13,6380
2031,新光鋼,12,0,12,光和,2024-08-13,6380
4961,天鈺,12,0,12,光和,2024-08-13,6380
0056,元大高股息,11,0,11,光和,2024-08-13,6380
2845,遠東銀,11,0,11,光和,2024-08-13,6380
2892,第一金,11,0,11,光和,2024-08-13,6380
2887,台新金,10,0,10,光和,2024-08-13,6380
00795B,中信美國公債20年,10,0,10,光和,2024-08-13,6380
00673R,期元大S＆P原油反1,10,0,10,光和,2024-08-13,6380
00706L,期元大S＆P日圓正2,10,0,10,光和,2024-08-13,6380
2007,燁興,10,0,10,光和,2024-08-13,6380
2453,凌群,11,1,10,光和,2024-08-13,6380
3686,達能,10,0,10,光和,2024-08-13,6380
6187,萬潤,11,1,10,光和,2024-08-13,6380
4306,炎洲,9,0,9,光和,2024-08-13,6380
6244,茂迪,9,0,9,光和,2024-08-13,6380
00935,野村臺灣新科技50,8,0,8,光和,2024-08-13,6380
00687B,國泰20年美債,8,0,8,光和,2024-08-13,6380
1303,南亞,8,0,8,光和,2024-08-13,6380
1802,台玻,8,0,8,光和,2024-08-13,6380
3481,群創,225,52,173,光和,2024-08-14,6380
00688L,國泰20年美債正2,150,0,150,光和,2024-08-14,6380
1101,台泥,45,0,45,光和,2024-08-14,6380
2356,英業達,84,41,43,光和,2024-08-14,6380
8150,南茂,36,0,36,光和,2024-08-14,6380
2605,新興,34,0,34,光和,2024-08-14,6380
6116,彩晶,33,0,33,光和,2024-08-14,6380
2208,台船,43,11,32,光和,2024-08-14,6380
00882,中信中國高股息,31,0,31,光和,2024-08-14,6380
00918,大華優利高填息30,30,0,30,光和,2024-08-14,6380
2323,中環,30,1,29,光和,2024-08-14,6380
00936,台新永續高息中小,30,3,27,光和,2024-08-14,6380
1616,億泰,21,0,21,光和,2024-08-14,6380
2615,萬海,26,6,20,光和,2024-08-14,6380
3535,晶彩科,23,4,19,光和,2024-08-14,6380
2801,彰銀,29,12,17,光和,2024-08-14,6380
3686,達能,20,4,16,光和,2024-08-14,6380
2402,毅嘉,16,0,16,光和,2024-08-14,6380
2354,鴻準,15,0,15,光和,2024-08-14,6380
4564,元翎,20,5,15,光和,2024-08-14,6380
00679B,元大美債20年,13,0,13,光和,2024-08-14,6380
2061,風青,13,0,13,光和,2024-08-14,6380
1532,勤美,12,0,12,光和,2024-08-14,6380
2543,皇昌,13,1,12,光和,2024-08-14,6380
4534,慶騰,12,0,12,光和,2024-08-14,6380
00637L,元大滬深300正2,11,0,11,光和,2024-08-14,6380
2352,佳世達,11,0,11,光和,2024-08-14,6380
00665L,富邦�琤肭磪囓�2,10,0,10,光和,2024-08-14,6380
00664R,國泰臺灣加權反1,10,0,10,光和,2024-08-14,6380
00650L,復華香港正2,10,0,10,光和,2024-08-14,6380
2880,華南金,22,12,10,光和,2024-08-14,6380
3050,鈺德,10,0,10,光和,2024-08-14,6380
3202,樺晟,10,0,10,光和,2024-08-14,6380
3265,台星科,10,0,10,光和,2024-08-14,6380
8064,東捷,10,0,10,光和,2024-08-14,6380
00929,復華台灣科技優息,16,7,9,光和,2024-08-14,6380
1799,易威,9,0,9,光和,2024-08-14,6380
6505,台塑化,10,1,9,光和,2024-08-14,6380
00712,復華富時不動產,8,0,8,光和,2024-08-14,6380
2417,圓剛,10,2,8,光和,2024-08-14,6380
2382,廣達,29,21,8,光和,2024-08-14,6380
1714,和桐,11,3,8,光和,2024-08-14,6380
2405,輔信,8,0,8,光和,2024-08-14,6380
3019,亞光,15,7,8,光和,2024-08-14,6380
5452,佶優,9,1,8,光和,2024-08-14,6380
6811,宏�硌穈T,8,0,8,光和,2024-08-14,6380
8054,安國,8,0,8,光和,2024-08-14,6380
00941,中信上游半導體,7,0,7,光和,2024-08-14,6380
2367,燿華,23,16,7,光和,2024-08-14,6380
3374,精材,15,8,7,光和,2024-08-14,6380
00929,復華台灣科技優息,136,0,136,光和,2024-08-15,6380
00878,國泰永續高股息,117,17,100,光和,2024-08-15,6380
2801,彰銀,75,15,60,光和,2024-08-15,6380
4566,時碩工業,60,3,57,光和,2024-08-15,6380
00687B,國泰20年美債,54,4,50,光和,2024-08-15,6380
00900,富邦特選高股息30,46,0,46,光和,2024-08-15,6380
2014,中鴻,44,2,42,光和,2024-08-15,6380
00680L,元大美債20正2,36,0,36,光和,2024-08-15,6380
2883,凱基金,35,0,35,光和,2024-08-15,6380
00936,台新永續高息中小,53,20,33,光和,2024-08-15,6380
1101,台泥,31,0,31,光和,2024-08-15,6380
2892,第一金,32,1,31,光和,2024-08-15,6380
1569,濱川,23,0,23,光和,2024-08-15,6380
1457,宜進,20,0,20,光和,2024-08-15,6380
2371,大同,21,1,20,光和,2024-08-15,6380
2405,輔信,20,0,20,光和,2024-08-15,6380
6603,富強鑫,21,1,20,光和,2024-08-15,6380
3535,晶彩科,21,2,19,光和,2024-08-15,6380
2002,中鋼,33,14,19,光和,2024-08-15,6380
1314,中石化,22,4,18,光和,2024-08-15,6380
2317,鴻海,32,14,18,光和,2024-08-15,6380
1301,台塑,16,0,16,光和,2024-08-15,6380
00919,群益台灣精選高息,15,0,15,光和,2024-08-15,6380
1616,億泰,15,0,15,光和,2024-08-15,6380
00933B,國泰10Y+金融債,14,0,14,光和,2024-08-15,6380
00881,國泰台灣5G+,23,9,14,光和,2024-08-15,6380
5202,力新,13,0,13,光和,2024-08-15,6380
2834,臺企銀,11,0,11,光和,2024-08-15,6380
3202,樺晟,11,0,11,光和,2024-08-15,6380
00891,中信關鍵半導體,11,0,11,光和,2024-08-15,6380
00706L,期元大S＆P日圓正2,10,0,10,光和,2024-08-15,6380
00951,台新日本半導體,10,0,10,光和,2024-08-15,6380
2365,昆盈,13,3,10,光和,2024-08-15,6380
2543,皇昌,15,5,10,光和,2024-08-15,6380
6016,康和證,10,0,10,光和,2024-08-15,6380
6244,茂迪,10,0,10,光和,2024-08-15,6380
8064,東捷,10,0,10,光和,2024-08-15,6380
8374,羅昇,16,6,10,光和,2024-08-15,6380
0056,元大高股息,12,3,9,光和,2024-08-15,6380
1321,大洋,9,0,9,光和,2024-08-15,6380
4540,全球傳動,11,2,9,光和,2024-08-15,6380
2312,金寶,33,25,8,光和,2024-08-15,6380
3105,穩懋,8,0,8,光和,2024-08-15,6380
00650L,復華香港正2,29,22,7,光和,2024-08-15,6380
5371,中光電,10,3,7,光和,2024-08-15,6380
1701,中化,6,0,6,光和,2024-08-15,6380
1733,五鼎,6,0,6,光和,2024-08-15,6380
2545,皇翔,7,1,6,光和,2024-08-15,6380
2880,華南金,13,7,6,光和,2024-08-15,6380
3019,亞光,21,15,6,光和,2024-08-15,6380
00632R,元大台灣50反1,547,200,347,光和,2024-08-16,6380
00680L,元大美債20正2,221,0,221,光和,2024-08-16,6380
2409,友達,141,89,52,光和,2024-08-16,6380
2313,華通,61,10,51,光和,2024-08-16,6380
1609,大亞,45,4,41,光和,2024-08-16,6380
00706L,期元大S＆P日圓正2,40,0,40,光和,2024-08-16,6380
2867,三商壽,51,15,36,光和,2024-08-16,6380
00664R,國泰臺灣加權反1,30,0,30,光和,2024-08-16,6380
2489,瑞軒,31,3,28,光和,2024-08-16,6380
2006,東和鋼鐵,21,0,21,光和,2024-08-16,6380
2884,玉山金,23,2,21,光和,2024-08-16,6380
00712,復華富時不動產,20,0,20,光和,2024-08-16,6380
1457,宜進,20,0,20,光和,2024-08-16,6380
2027,大成鋼,20,0,20,光和,2024-08-16,6380
2323,中環,64,44,20,光和,2024-08-16,6380
2331,精英,20,0,20,光和,2024-08-16,6380
3686,達能,20,0,20,光和,2024-08-16,6380
3706,神達,31,12,19,光和,2024-08-16,6380
2356,英業達,20,2,18,光和,2024-08-16,6380
2888,新光金,43,26,17,光和,2024-08-16,6380
00878,國泰永續高股息,19,3,16,光和,2024-08-16,6380
2347,聯強,21,5,16,光和,2024-08-16,6380
4534,慶騰,21,5,16,光和,2024-08-16,6380
8043,蜜望實,24,8,16,光和,2024-08-16,6380
00929,復華台灣科技優息,55,40,15,光和,2024-08-16,6380
2609,陽明,26,12,14,光和,2024-08-16,6380
00940,元大台灣價值高息,22,11,11,光和,2024-08-16,6380
00946,群益科技高息成長,15,4,11,光和,2024-08-16,6380
6603,富強鑫,11,0,11,光和,2024-08-16,6380
2002,中鋼,11,1,10,光和,2024-08-16,6380
1708,東鹼,10,0,10,光和,2024-08-16,6380
2401,凌陽,11,1,10,光和,2024-08-16,6380
2429,銘旺科,10,0,10,光和,2024-08-16,6380
3591,艾笛森,10,0,10,光和,2024-08-16,6380
1584,精剛,10,0,10,光和,2024-08-16,6380
2020,美亞,9,0,9,光和,2024-08-16,6380
2371,大同,11,2,9,光和,2024-08-16,6380
2462,良得電,9,0,9,光和,2024-08-16,6380
5202,力新,11,2,9,光和,2024-08-16,6380
00900,富邦特選高股息30,13,5,8,光和,2024-08-16,6380
1565,精華,8,0,8,光和,2024-08-16,6380
3048,益登,11,3,8,光和,2024-08-16,6380
3498,陽程,11,3,8,光和,2024-08-16,6380
6505,台塑化,8,0,8,光和,2024-08-16,6380
6443,元晶,7,0,7,光和,2024-08-16,6380
1210,大成,6,0,6,光和,2024-08-16,6380
2241,艾姆勒,6,0,6,光和,2024-08-16,6380
2352,佳世達,7,1,6,光和,2024-08-16,6380
2497,怡利電,6,0,6,光和,2024-08-16,6380
3022,威強電,6,0,6,光和,2024-08-16,6380
00632R,元大台灣50反1,301,0,301,光和,2024-08-19,6380
2027,大成鋼,82,0,82,光和,2024-08-19,6380
2489,瑞軒,108,32,76,光和,2024-08-19,6380
2888,新光金,128,58,70,光和,2024-08-19,6380
00919,群益台灣精選高息,56,4,52,光和,2024-08-19,6380
00687B,國泰20年美債,52,3,49,光和,2024-08-19,6380
4526,東台,47,2,45,光和,2024-08-19,6380
2603,長榮,35,2,33,光和,2024-08-19,6380
1101,台泥,33,2,31,光和,2024-08-19,6380
2365,昆盈,82,53,29,光和,2024-08-19,6380
2002,中鋼,29,0,29,光和,2024-08-19,6380
6125,廣運,30,5,25,光和,2024-08-19,6380
1569,濱川,36,12,24,光和,2024-08-19,6380
2367,燿華,28,5,23,光和,2024-08-19,6380
4534,慶騰,26,3,23,光和,2024-08-19,6380
1609,大亞,29,8,21,光和,2024-08-19,6380
1616,億泰,20,0,20,光和,2024-08-19,6380
8438,昶昕,20,0,20,光和,2024-08-19,6380
00680L,元大美債20正2,37,19,18,光和,2024-08-19,6380
00929,復華台灣科技優息,20,3,17,光和,2024-08-19,6380
2880,華南金,18,1,17,光和,2024-08-19,6380
00907,永豐優息存股,16,0,16,光和,2024-08-19,6380
3047,訊舟,22,6,16,光和,2024-08-19,6380
8070,長華*,17,1,16,光和,2024-08-19,6380
2359,所羅門,20,5,15,光和,2024-08-19,6380
3036,文曄,16,2,14,光和,2024-08-19,6380
3498,陽程,19,5,14,光和,2024-08-19,6380
4566,時碩工業,15,1,14,光和,2024-08-19,6380
5452,佶優,15,1,14,光和,2024-08-19,6380
2371,大同,37,23,14,光和,2024-08-19,6380
2354,鴻準,18,5,13,光和,2024-08-19,6380
2883,凱基金,14,1,13,光和,2024-08-19,6380
6156,松上,15,2,13,光和,2024-08-19,6380
6177,達麗,15,2,13,光和,2024-08-19,6380
00933B,國泰10Y+金融債,12,0,12,光和,2024-08-19,6380
2062,橋椿,30,18,12,光和,2024-08-19,6380
2453,凌群,12,0,12,光和,2024-08-19,6380
2483,百容,12,0,12,光和,2024-08-19,6380
00712,復華富時不動產,11,0,11,光和,2024-08-19,6380
00948B,中信優息投資級債,10,0,10,光和,2024-08-19,6380
00937B,群益ESG投等債20,10,0,10,光和,2024-08-19,6380
1802,台玻,10,0,10,光和,2024-08-19,6380
2399,映泰,10,0,10,光和,2024-08-19,6380
3050,鈺德,10,0,10,光和,2024-08-19,6380
3576,聯合再生,10,0,10,光和,2024-08-19,6380
5880,合庫金,10,0,10,光和,2024-08-19,6380
00915,凱基優選高股息30,9,0,9,光和,2024-08-19,6380
2243,宏旭-KY,10,1,9,光和,2024-08-19,6380
2610,華航,11,2,9,光和,2024-08-19,6380
2892,第一金,10,1,9,光和,2024-08-19,6380
2406,國碩,107,0,107,光和,2024-08-20,6380
00687B,國泰20年美債,68,5,63,光和,2024-08-20,6380
00948B,中信優息投資級債,52,0,52,光和,2024-08-20,6380
00951,台新日本半導體,50,0,50,光和,2024-08-20,6380
2609,陽明,58,8,50,光和,2024-08-20,6380
2615,萬海,48,0,48,光和,2024-08-20,6380
2356,英業達,47,4,43,光和,2024-08-20,6380
2812,台中銀,33,0,33,光和,2024-08-20,6380
00715L,期街口布蘭特正2,32,0,32,光和,2024-08-20,6380
00632R,元大台灣50反1,31,0,31,光和,2024-08-20,6380
00679B,元大美債20年,45,14,31,光和,2024-08-20,6380
00929,復華台灣科技優息,44,13,31,光和,2024-08-20,6380
1449,佳和,25,0,25,光和,2024-08-20,6380
2002,中鋼,27,2,25,光和,2024-08-20,6380
2352,佳世達,26,1,25,光和,2024-08-20,6380
2367,燿華,28,4,24,光和,2024-08-20,6380
00907,永豐優息存股,24,0,24,光和,2024-08-20,6380
2515,中工,23,0,23,光和,2024-08-20,6380
00945B,凱基美國非投等債,22,0,22,光和,2024-08-20,6380
00933B,國泰10Y+金融債,22,0,22,光和,2024-08-20,6380
3029,零壹,42,20,22,光和,2024-08-20,6380
2317,鴻海,36,15,21,光和,2024-08-20,6380
1569,濱川,21,0,21,光和,2024-08-20,6380
2365,昆盈,38,17,21,光和,2024-08-20,6380
00671R,富邦NASDAQ反1,20,0,20,光和,2024-08-20,6380
00664R,國泰臺灣加權反1,20,0,20,光和,2024-08-20,6380
00955,中信日本商社,20,0,20,光和,2024-08-20,6380
2399,映泰,20,0,20,光和,2024-08-20,6380
3312,弘憶股,30,10,20,光和,2024-08-20,6380
5521,工信,20,0,20,光和,2024-08-20,6380
6264,富裔,20,0,20,光和,2024-08-20,6380
5443,均豪,21,2,19,光和,2024-08-20,6380
5484,慧友,23,4,19,光和,2024-08-20,6380
2483,百容,17,0,17,光和,2024-08-20,6380
6770,力積電,27,10,17,光和,2024-08-20,6380
1303,南亞,15,0,15,光和,2024-08-20,6380
2374,佳能,19,4,15,光和,2024-08-20,6380
6591,動力-KY,15,0,15,光和,2024-08-20,6380
2330,台積電,17,2,15,光和,2024-08-20,6380
4976,佳凌,14,0,14,光和,2024-08-20,6380
6156,松上,17,3,14,光和,2024-08-20,6380
2520,冠德,13,0,13,光和,2024-08-20,6380
8043,蜜望實,19,6,13,光和,2024-08-20,6380
00637L,元大滬深300正2,12,0,12,光和,2024-08-20,6380
2401,凌陽,12,0,12,光和,2024-08-20,6380
2501,國建,12,0,12,光和,2024-08-20,6380
3576,聯合再生,12,0,12,光和,2024-08-20,6380
4960,誠美材,12,0,12,光和,2024-08-20,6380
6133,金橋,13,1,12,光和,2024-08-20,6380
1785,光洋科,29,17,12,光和,2024-08-20,6380
2891,中信金,108,4,104,光和,2024-08-21,6380
3518,柏騰,65,1,64,光和,2024-08-21,6380
4109,加捷生醫,47,0,47,光和,2024-08-21,6380
00940,元大台灣價值高息,64,21,43,光和,2024-08-21,6380
8438,昶昕,31,0,31,光和,2024-08-21,6380
00687B,國泰20年美債,30,2,28,光和,2024-08-21,6380
00919,群益台灣精選高息,28,0,28,光和,2024-08-21,6380
00953B,群益優選非投等債,27,0,27,光和,2024-08-21,6380
00936,台新永續高息中小,25,0,25,光和,2024-08-21,6380
2312,金寶,55,30,25,光和,2024-08-21,6380
2537,聯上發,25,0,25,光和,2024-08-21,6380
3167,大量,28,3,25,光和,2024-08-21,6380
4555,氣立,27,4,23,光和,2024-08-21,6380
2356,英業達,22,1,21,光和,2024-08-21,6380
00929,復華台灣科技優息,36,16,20,光和,2024-08-21,6380
2317,鴻海,30,10,20,光和,2024-08-21,6380
00946,群益科技高息成長,20,0,20,光和,2024-08-21,6380
00955,中信日本商社,20,0,20,光和,2024-08-21,6380
2409,友達,19,0,19,光和,2024-08-21,6380
2354,鴻準,25,8,17,光和,2024-08-21,6380
00878,國泰永續高股息,14,1,13,光和,2024-08-21,6380
2515,中工,12,0,12,光和,2024-08-21,6380
6156,松上,12,0,12,光和,2024-08-21,6380
8440,綠電,15,3,12,光和,2024-08-21,6380
00907,永豐優息存股,12,1,11,光和,2024-08-21,6380
8234,新漢,11,0,11,光和,2024-08-21,6380
00945B,凱基美國非投等債,10,0,10,光和,2024-08-21,6380
00931B,統一美債20年,10,0,10,光和,2024-08-21,6380
00882,中信中國高股息,10,0,10,光和,2024-08-21,6380
00650L,復華香港正2,21,11,10,光和,2024-08-21,6380
2017,官田鋼,10,0,10,光和,2024-08-21,6380
3686,達能,10,0,10,光和,2024-08-21,6380
3713,新晶投控,10,0,10,光和,2024-08-21,6380
4534,慶騰,10,0,10,光和,2024-08-21,6380
5347,世界,16,6,10,光和,2024-08-21,6380
2359,所羅門,12,3,9,光和,2024-08-21,6380
9945,潤泰新,11,2,9,光和,2024-08-21,6380
2462,良得電,9,0,9,光和,2024-08-21,6380
3056,富華新,9,0,9,光和,2024-08-21,6380
3663,鑫科,12,3,9,光和,2024-08-21,6380
4563,百德,11,2,9,光和,2024-08-21,6380
8358,金居,9,0,9,光和,2024-08-21,6380
00712,復華富時不動產,8,0,8,光和,2024-08-21,6380
00915,凱基優選高股息30,8,1,7,光和,2024-08-21,6380
2609,陽明,87,80,7,光和,2024-08-21,6380
00918,大華優利高填息30,7,0,7,光和,2024-08-21,6380
2241,艾姆勒,8,1,7,光和,2024-08-21,6380
2886,兆豐金,7,0,7,光和,2024-08-21,6380
8064,東捷,26,19,7,光和,2024-08-21,6380
8089,康全電訊,9,2,7,光和,2024-08-21,6380
00953B,群益優選非投等債,140,0,140,光和,2024-08-22,6380
2340,台亞,51,0,51,光和,2024-08-22,6380
2349,錸德,146,96,50,光和,2024-08-22,6380
9945,潤泰新,41,0,41,光和,2024-08-22,6380
2836,高雄銀,40,0,40,光和,2024-08-22,6380
3047,訊舟,43,3,40,光和,2024-08-22,6380
00940,元大台灣價值高息,38,0,38,光和,2024-08-22,6380
4716,大立,40,4,36,光和,2024-08-22,6380
1584,精剛,36,5,31,光和,2024-08-22,6380
2890,永豐金,28,0,28,光和,2024-08-22,6380
00878,國泰永續高股息,33,5,28,光和,2024-08-22,6380
4526,東台,28,2,26,光和,2024-08-22,6380
00919,群益台灣精選高息,23,0,23,光和,2024-08-22,6380
2537,聯上發,23,0,23,光和,2024-08-22,6380
6609,瀧澤科,29,6,23,光和,2024-08-22,6380
5512,力麒,20,0,20,光和,2024-08-22,6380
4707,磐亞,24,5,19,光和,2024-08-22,6380
00715L,期街口布蘭特正2,18,0,18,光和,2024-08-22,6380
2062,橋椿,31,14,17,光和,2024-08-22,6380
2344,華邦電,20,5,15,光和,2024-08-22,6380
3019,亞光,23,8,15,光和,2024-08-22,6380
2891,中信金,15,1,14,光和,2024-08-22,6380
2615,萬海,29,15,14,光和,2024-08-22,6380
8043,蜜望實,34,20,14,光和,2024-08-22,6380
5905,南仁湖,23,10,13,光和,2024-08-22,6380
3029,零壹,12,0,12,光和,2024-08-22,6380
3073,天方能源,14,2,12,光和,2024-08-22,6380
3663,鑫科,27,16,11,光和,2024-08-22,6380
2881,富邦金,13,3,10,光和,2024-08-22,6380
6139,亞翔,12,2,10,光和,2024-08-22,6380
00905,FT臺灣Smart,10,0,10,光和,2024-08-22,6380
1714,和桐,10,0,10,光和,2024-08-22,6380
1717,長興,18,8,10,光和,2024-08-22,6380
2367,燿華,15,5,10,光和,2024-08-22,6380
2402,毅嘉,13,3,10,光和,2024-08-22,6380
2495,普安,20,10,10,光和,2024-08-22,6380
2645,長榮航太,10,0,10,光和,2024-08-22,6380
4167,松瑞藥,15,5,10,光和,2024-08-22,6380
4960,誠美材,10,0,10,光和,2024-08-22,6380
2363,矽統,20,11,9,光和,2024-08-22,6380
00687B,國泰20年美債,12,3,9,光和,2024-08-22,6380
2438,翔耀,10,1,9,光和,2024-08-22,6380
2208,台船,12,4,8,光和,2024-08-22,6380
2515,中工,12,4,8,光和,2024-08-22,6380
6505,台塑化,8,0,8,光和,2024-08-22,6380
8028,昇陽半導體,14,6,8,光和,2024-08-22,6380
00881,國泰台灣5G+,7,0,7,光和,2024-08-22,6380
1785,光洋科,9,2,7,光和,2024-08-22,6380
2312,金寶,65,58,7,光和,2024-08-22,6380
3049,精金,7,0,7,光和,2024-08-22,6380
1721,三晃,208,2,206,光和,2024-08-23,6380
1711,永光,201,64,137,光和,2024-08-23,6380
00687B,國泰20年美債,104,5,99,光和,2024-08-23,6380
1314,中石化,69,18,51,光和,2024-08-23,6380
2349,錸德,88,46,42,光和,2024-08-23,6380
00937B,群益ESG投等債20,40,4,36,光和,2024-08-23,6380
2208,台船,43,7,36,光和,2024-08-23,6380
2836,高雄銀,40,4,36,光和,2024-08-23,6380
1449,佳和,40,5,35,光和,2024-08-23,6380
2367,燿華,40,8,32,光和,2024-08-23,6380
2887,台新金,32,3,29,光和,2024-08-23,6380
00919,群益台灣精選高息,29,0,29,光和,2024-08-23,6380
2845,遠東銀,28,0,28,光和,2024-08-23,6380
6215,和椿,27,2,25,光和,2024-08-23,6380
2891,中信金,26,1,25,光和,2024-08-23,6380
6770,力積電,25,1,24,光和,2024-08-23,6380
2609,陽明,30,7,23,光和,2024-08-23,6380
8043,蜜望實,34,11,23,光和,2024-08-23,6380
00878,國泰永續高股息,20,0,20,光和,2024-08-23,6380
2615,萬海,21,1,20,光和,2024-08-23,6380
4763,材料-KY,20,0,20,光和,2024-08-23,6380
3312,弘憶股,33,14,19,光和,2024-08-23,6380
8104,錸寶,20,1,19,光和,2024-08-23,6380
6125,廣運,23,5,18,光和,2024-08-23,6380
8071,能率網通,18,2,16,光和,2024-08-23,6380
00951,台新日本半導體,15,0,15,光和,2024-08-23,6380
00940,元大台灣價值高息,25,10,15,光和,2024-08-23,6380
8374,羅昇,30,15,15,光和,2024-08-23,6380
2313,華通,14,0,14,光和,2024-08-23,6380
1727,中華化,18,5,13,光和,2024-08-23,6380
00929,復華台灣科技優息,47,35,12,光和,2024-08-23,6380
3029,零壹,12,0,12,光和,2024-08-23,6380
1301,台塑,12,1,11,光和,2024-08-23,6380
1532,勤美,11,0,11,光和,2024-08-23,6380
2883,凱基金,20,9,11,光和,2024-08-23,6380
4903,聯光通,11,0,11,光和,2024-08-23,6380
2010,春源,10,0,10,光和,2024-08-23,6380
2312,金寶,44,34,10,光和,2024-08-23,6380
4558,寶緯,11,1,10,光和,2024-08-23,6380
9105,泰金寶-DR,13,3,10,光和,2024-08-23,6380
2603,長榮,9,0,9,光和,2024-08-23,6380
3260,威剛,10,1,9,光和,2024-08-23,6380
3663,鑫科,13,4,9,光和,2024-08-23,6380
4906,正文,10,1,9,光和,2024-08-23,6380
1326,台化,8,0,8,光和,2024-08-23,6380
4513,福裕,25,17,8,光和,2024-08-23,6380
2317,鴻海,13,6,7,光和,2024-08-23,6380
2890,永豐金,10,3,7,光和,2024-08-23,6380
00715L,期街口布蘭特正2,7,0,7,光和,2024-08-23,6380
2405,輔信,10,3,7,光和,2024-08-23,6380
2888,新光金,546,281,265,光和,2024-08-26,6380
8438,昶昕,71,1,70,光和,2024-08-26,6380
4915,致伸,70,0,70,光和,2024-08-26,6380
00919,群益台灣精選高息,52,0,52,光和,2024-08-26,6380
2349,錸德,55,7,48,光和,2024-08-26,6380
00632R,元大台灣50反1,54,10,44,光和,2024-08-26,6380
2537,聯上發,44,0,44,光和,2024-08-26,6380
2891,中信金,44,0,44,光和,2024-08-26,6380
1711,永光,68,26,42,光和,2024-08-26,6380
2883B,凱基金乙特,40,0,40,光和,2024-08-26,6380
00937B,群益ESG投等債20,36,0,36,光和,2024-08-26,6380
00751B,元大AAA至A公司債,35,0,35,光和,2024-08-26,6380
00679B,元大美債20年,31,1,30,光和,2024-08-26,6380
1609,大亞,39,11,28,光和,2024-08-26,6380
2409,友達,70,44,26,光和,2024-08-26,6380
00951,台新日本半導體,25,0,25,光和,2024-08-26,6380
00687B,國泰20年美債,26,1,25,光和,2024-08-26,6380
00637L,元大滬深300正2,24,0,24,光和,2024-08-26,6380
00664R,國泰臺灣加權反1,20,0,20,光和,2024-08-26,6380
2323,中環,18,0,18,光和,2024-08-26,6380
4526,東台,23,7,16,光和,2024-08-26,6380
4960,誠美材,40,25,15,光和,2024-08-26,6380
2408,南亞科,13,0,13,光和,2024-08-26,6380
5452,佶優,16,4,12,光和,2024-08-26,6380
1799,易威,11,0,11,光和,2024-08-26,6380
8028,昇陽半導體,16,5,11,光和,2024-08-26,6380
3645,達邁,11,0,11,光和,2024-08-26,6380
00715L,期街口布蘭特正2,11,1,10,光和,2024-08-26,6380
00953B,群益優選非投等債,10,0,10,光和,2024-08-26,6380
1524,耿鼎,10,0,10,光和,2024-08-26,6380
1616,億泰,10,0,10,光和,2024-08-26,6380
3019,亞光,14,5,9,光和,2024-08-26,6380
00936,台新永續高息中小,8,0,8,光和,2024-08-26,6380
6152,百一,8,0,8,光和,2024-08-26,6380
3024,憶聲,7,0,7,光和,2024-08-26,6380
4555,氣立,7,0,7,光和,2024-08-26,6380
2890,永豐金,6,0,6,光和,2024-08-26,6380
00795B,中信美國公債20年,6,0,6,光和,2024-08-26,6380
1416,廣豐,6,0,6,光和,2024-08-26,6380
5347,世界,8,2,6,光和,2024-08-26,6380
6207,雷科,15,9,6,光和,2024-08-26,6380
8358,金居,6,0,6,光和,2024-08-26,6380
3450,聯鈞,8,2,6,光和,2024-08-26,6380
00673R,期元大S＆P原油反1,5,0,5,光和,2024-08-26,6380
1529,樂事綠能,5,0,5,光和,2024-08-26,6380
2359,所羅門,14,9,5,光和,2024-08-26,6380
2382,廣達,9,4,5,光和,2024-08-26,6380
3188,鑫龍騰,5,0,5,光和,2024-08-26,6380
3294,英濟,5,0,5,光和,2024-08-26,6380
4903,聯光通,5,0,5,光和,2024-08-26,6380
00937B,群益ESG投等債20,104,0,104,光和,2024-08-27,6380
2867,三商壽,84,12,72,光和,2024-08-27,6380
2891,中信金,67,2,65,光和,2024-08-27,6380
2609,陽明,72,10,62,光和,2024-08-27,6380
00919,群益台灣精選高息,61,0,61,光和,2024-08-27,6380
6016,康和證,54,0,54,光和,2024-08-27,6380
3702,大聯大,49,0,49,光和,2024-08-27,6380
00687B,國泰20年美債,42,0,42,光和,2024-08-27,6380
00878,國泰永續高股息,35,0,35,光和,2024-08-27,6380
3481,群創,84,51,33,光和,2024-08-27,6380
00940,元大台灣價值高息,31,0,31,光和,2024-08-27,6380
2615,萬海,33,3,30,光和,2024-08-27,6380
5471,松翰,30,0,30,光和,2024-08-27,6380
3036,文曄,26,5,21,光和,2024-08-27,6380
00679B,元大美債20年,20,0,20,光和,2024-08-27,6380
1587,吉茂,20,0,20,光和,2024-08-27,6380
2537,聯上發,20,0,20,光和,2024-08-27,6380
4915,致伸,20,0,20,光和,2024-08-27,6380
6285,啟��,21,1,20,光和,2024-08-27,6380
2883,凱基金,21,3,18,光和,2024-08-27,6380
2882,國泰金,19,2,17,光和,2024-08-27,6380
2880,華南金,18,1,17,光和,2024-08-27,6380
00673R,期元大S＆P原油反1,16,0,16,光和,2024-08-27,6380
6770,力積電,15,0,15,光和,2024-08-27,6380
1313,聯成,15,0,15,光和,2024-08-27,6380
2323,中環,16,1,15,光和,2024-08-27,6380
2233,宇隆,14,0,14,光和,2024-08-27,6380
2349,錸德,16,2,14,光和,2024-08-27,6380
3325,旭品,14,0,14,光和,2024-08-27,6380
8064,東捷,19,6,13,光和,2024-08-27,6380
00918,大華優利高填息30,12,0,12,光和,2024-08-27,6380
2408,南亞科,12,0,12,光和,2024-08-27,6380
5443,均豪,26,14,12,光和,2024-08-27,6380
00637L,元大滬深300正2,10,0,10,光和,2024-08-27,6380
00953B,群益優選非投等債,10,0,10,光和,2024-08-27,6380
1616,億泰,10,0,10,光和,2024-08-27,6380
1718,中纖,10,0,10,光和,2024-08-27,6380
3073,天方能源,14,4,10,光和,2024-08-27,6380
6274,台燿,10,0,10,光和,2024-08-27,6380
1210,大成,10,1,9,光和,2024-08-27,6380
1304,台聚,9,0,9,光和,2024-08-27,6380
2208,台船,9,0,9,光和,2024-08-27,6380
8027,鈦昇,14,5,9,光和,2024-08-27,6380
8071,能率網通,10,1,9,光和,2024-08-27,6380
8111,立��,9,0,9,光和,2024-08-27,6380
1310,台苯,8,0,8,光和,2024-08-27,6380
2504,國產,8,0,8,光和,2024-08-27,6380
3006,晶豪科,8,0,8,光和,2024-08-27,6380
8028,昇陽半導體,18,10,8,光和,2024-08-27,6380
8070,長華*,17,9,8,光和,2024-08-27,6380
00688L,國泰20年美債正2,103,0,103,光和,2024-08-28,6380
2867,三商壽,116,17,99,光和,2024-08-28,6380
00712,復華富時不動產,97,0,97,光和,2024-08-28,6380
00680L,元大美債20正2,90,0,90,光和,2024-08-28,6380
3481,群創,116,62,54,光和,2024-08-28,6380
2891,中信金,45,2,43,光和,2024-08-28,6380
2836,高雄銀,30,0,30,光和,2024-08-28,6380
2062,橋椿,46,17,29,光和,2024-08-28,6380
3062,建漢,27,5,22,光和,2024-08-28,6380
1303,南亞,22,0,22,光和,2024-08-28,6380
2349,錸德,24,3,21,光和,2024-08-28,6380
00953B,群益優選非投等債,20,0,20,光和,2024-08-28,6380
2408,南亞科,20,2,18,光和,2024-08-28,6380
1609,大亞,33,16,17,光和,2024-08-28,6380
2890,永豐金,16,0,16,光和,2024-08-28,6380
00665L,富邦�琤肭磪囓�2,16,0,16,光和,2024-08-28,6380
4714,永捷,46,31,15,光和,2024-08-28,6380
6116,彩晶,17,2,15,光和,2024-08-28,6380
00715L,期街口布蘭特正2,14,0,14,光和,2024-08-28,6380
2880,華南金,14,1,13,光和,2024-08-28,6380
1708,東鹼,12,0,12,光和,2024-08-28,6380
8039,台虹,24,12,12,光和,2024-08-28,6380
3010,華立,13,2,11,光和,2024-08-28,6380
2374,佳能,13,2,11,光和,2024-08-28,6380
2402,毅嘉,22,11,11,光和,2024-08-28,6380
2020,美亞,10,0,10,光和,2024-08-28,6380
1326,台化,10,0,10,光和,2024-08-28,6380
2106,建大,10,0,10,光和,2024-08-28,6380
2601,益航,10,0,10,光和,2024-08-28,6380
3163,波若威,16,6,10,光和,2024-08-28,6380
3535,晶彩科,18,8,10,光和,2024-08-28,6380
3686,達能,10,0,10,光和,2024-08-28,6380
4956,光鋐,10,0,10,光和,2024-08-28,6380
6239,力成,10,0,10,光和,2024-08-28,6380
6244,茂迪,10,0,10,光和,2024-08-28,6380
8111,立��,14,4,10,光和,2024-08-28,6380
6531,愛普*,13,3,10,光和,2024-08-28,6380
00878,國泰永續高股息,12,2,10,光和,2024-08-28,6380
3036,文曄,10,1,9,光和,2024-08-28,6380
8021,尖點,9,0,9,光和,2024-08-28,6380
2603,長榮,12,3,9,光和,2024-08-28,6380
00919,群益台灣精選高息,8,0,8,光和,2024-08-28,6380
2405,輔信,21,13,8,光和,2024-08-28,6380
2458,義隆,8,0,8,光和,2024-08-28,6380
3219,倚強科,8,0,8,光和,2024-08-28,6380
6153,嘉聯益,10,2,8,光和,2024-08-28,6380
6188,廣明,8,0,8,光和,2024-08-28,6380
3498,陽程,10,3,7,光和,2024-08-28,6380
4915,致伸,7,0,7,光和,2024-08-28,6380
9945,潤泰新,10,3,7,光和,2024-08-28,6380
2888,新光金,343,40,303,光和,2024-08-29,6380
00937B,群益ESG投等債20,134,0,134,光和,2024-08-29,6380
2706,第一店,65,0,65,光和,2024-08-29,6380
00929,復華台灣科技優息,65,7,58,光和,2024-08-29,6380
00679B,元大美債20年,49,0,49,光和,2024-08-29,6380
1449,佳和,41,0,41,光和,2024-08-29,6380
6598,ABC-KY,40,0,40,光和,2024-08-29,6380
4510,高鋒,46,14,32,光和,2024-08-29,6380
00687B,國泰20年美債,31,0,31,光和,2024-08-29,6380
3580,友威科,40,11,29,光和,2024-08-29,6380
2891,中信金,40,12,28,光和,2024-08-29,6380
9945,潤泰新,25,0,25,光和,2024-08-29,6380
3481,群創,86,61,25,光和,2024-08-29,6380
8404,百和興業-KY,24,0,24,光和,2024-08-29,6380
2537,聯上發,24,2,22,光和,2024-08-29,6380
2010,春源,20,0,20,光和,2024-08-29,6380
8043,蜜望實,22,3,19,光和,2024-08-29,6380
2062,橋椿,18,0,18,光和,2024-08-29,6380
00830,國泰費城半導體,18,0,18,光和,2024-08-29,6380
2405,輔信,19,1,18,光和,2024-08-29,6380
2801,彰銀,18,0,18,光和,2024-08-29,6380
00680L,元大美債20正2,16,0,16,光和,2024-08-29,6380
00919,群益台灣精選高息,22,6,16,光和,2024-08-29,6380
5381,合正,15,0,15,光和,2024-08-29,6380
2892,第一金,14,0,14,光和,2024-08-29,6380
00959B,大華投等美債15Y+,14,0,14,光和,2024-08-29,6380
00930,永豐ESG低碳高息,13,0,13,光和,2024-08-29,6380
2881,富邦金,13,0,13,光和,2024-08-29,6380
2880,華南金,13,0,13,光和,2024-08-29,6380
1609,大亞,15,2,13,光和,2024-08-29,6380
2402,毅嘉,16,4,12,光和,2024-08-29,6380
00753L,中信中國50正2,11,0,11,光和,2024-08-29,6380
2233,宇隆,11,0,11,光和,2024-08-29,6380
2515,中工,11,0,11,光和,2024-08-29,6380
3047,訊舟,18,7,11,光和,2024-08-29,6380
5315,光聯,11,0,11,光和,2024-08-29,6380
8096,擎亞,14,3,11,光和,2024-08-29,6380
8936,國統,11,0,11,光和,2024-08-29,6380
00632R,元大台灣50反1,100,90,10,光和,2024-08-29,6380
00954,中信日本半導體,10,0,10,光和,2024-08-29,6380
2020,美亞,10,0,10,光和,2024-08-29,6380
2337,旺宏,10,0,10,光和,2024-08-29,6380
2477,美隆電,10,0,10,光和,2024-08-29,6380
3437,榮創,16,6,10,光和,2024-08-29,6380
3540,曜越,10,0,10,光和,2024-08-29,6380
4534,慶騰,10,0,10,光和,2024-08-29,6380
6156,松上,10,0,10,光和,2024-08-29,6380
6257,矽格,12,2,10,光和,2024-08-29,6380
4526,東台,26,18,8,光和,2024-08-29,6380
1513,中興電,7,0,7,光和,2024-08-29,6380
3481,群創,203,15,188,光和,2024-08-30,6380
1711,永光,214,53,161,光和,2024-08-30,6380
00632R,元大台灣50反1,70,0,70,光和,2024-08-30,6380
2409,友達,53,3,50,光和,2024-08-30,6380
6257,矽格,47,0,47,光和,2024-08-30,6380
1314,中石化,55,12,43,光和,2024-08-30,6380
1609,大亞,45,8,37,光和,2024-08-30,6380
1449,佳和,43,6,37,光和,2024-08-30,6380
00878,國泰永續高股息,42,6,36,光和,2024-08-30,6380
00687B,國泰20年美債,31,0,31,光和,2024-08-30,6380
00918,大華優利高填息30,30,0,30,光和,2024-08-30,6380
2323,中環,35,8,27,光和,2024-08-30,6380
8404,百和興業-KY,26,0,26,光和,2024-08-30,6380
2408,南亞科,26,1,25,光和,2024-08-30,6380
2504,國產,25,1,24,光和,2024-08-30,6380
2349,錸德,22,0,22,光和,2024-08-30,6380
2312,金寶,38,17,21,光和,2024-08-30,6380
3535,晶彩科,24,5,19,光和,2024-08-30,6380
00929,復華台灣科技優息,23,4,19,光和,2024-08-30,6380
1540,喬福,19,2,17,光和,2024-08-30,6380
1584,精剛,21,5,16,光和,2024-08-30,6380
2020,美亞,15,0,15,光和,2024-08-30,6380
00679B,元大美債20年,14,0,14,光和,2024-08-30,6380
2367,燿華,58,44,14,光和,2024-08-30,6380
2365,昆盈,23,10,13,光和,2024-08-30,6380
2610,華航,25,12,13,光和,2024-08-30,6380
2363,矽統,13,0,13,光和,2024-08-30,6380
00937B,群益ESG投等債20,13,0,13,光和,2024-08-30,6380
2706,第一店,12,0,12,光和,2024-08-30,6380
00936,台新永續高息中小,11,0,11,光和,2024-08-30,6380
00933B,國泰10Y+金融債,11,0,11,光和,2024-08-30,6380
3167,大量,12,1,11,光和,2024-08-30,6380
3645,達邁,15,4,11,光和,2024-08-30,6380
4915,致伸,11,0,11,光和,2024-08-30,6380
6133,金橋,11,0,11,光和,2024-08-30,6380
3019,亞光,16,5,11,光和,2024-08-30,6380
2243,宏旭-KY,15,5,10,光和,2024-08-30,6380
2359,所羅門,24,14,10,光和,2024-08-30,6380
2374,佳能,11,1,10,光和,2024-08-30,6380
2535,達欣工,10,0,10,光和,2024-08-30,6380
3048,益登,10,0,10,光和,2024-08-30,6380
4906,正文,10,0,10,光和,2024-08-30,6380
6598,ABC-KY,10,0,10,光和,2024-08-30,6380
6770,力積電,11,1,10,光和,2024-08-30,6380
8085,福華,15,5,10,光和,2024-08-30,6380
3518,柏騰,12,3,9,光和,2024-08-30,6380
6213,聯茂,15,6,9,光和,2024-08-30,6380
4526,東台,46,38,8,光和,2024-08-30,6380
3047,訊舟,8,1,7,光和,2024-08-30,6380
3715,定穎投控,7,0,7,光和,2024-08-30,6380
2609,陽明,75,0,75,光和,2024-09-02,6380
00680L,元大美債20正2,73,0,73,光和,2024-09-02,6380
2891,中信金,68,1,67,光和,2024-09-02,6380
00679B,元大美債20年,55,1,54,光和,2024-09-02,6380
00687B,國泰20年美債,54,0,54,光和,2024-09-02,6380
1711,永光,54,3,51,光和,2024-09-02,6380
00655L,國泰中國A50正2,47,0,47,光和,2024-09-02,6380
4306,炎洲,51,4,47,光和,2024-09-02,6380
2615,萬海,49,3,46,光和,2024-09-02,6380
00665L,富邦�琤肭磪囓�2,40,0,40,光和,2024-09-02,6380
00936,台新永續高息中小,35,1,34,光和,2024-09-02,6380
8070,長華*,36,2,34,光和,2024-09-02,6380
9902,台火,30,0,30,光和,2024-09-02,6380
3260,威剛,23,0,23,光和,2024-09-02,6380
6830,汎銓,27,6,21,光和,2024-09-02,6380
00882,中信中國高股息,20,0,20,光和,2024-09-02,6380
2520,冠德,21,1,20,光和,2024-09-02,6380
00929,復華台灣科技優息,20,2,18,光和,2024-09-02,6380
2330,台積電,19,2,17,光和,2024-09-02,6380
2367,燿華,25,9,16,光和,2024-09-02,6380
1540,喬福,17,2,15,光和,2024-09-02,6380
00715L,期街口布蘭特正2,22,8,14,光和,2024-09-02,6380
3062,建漢,17,3,14,光和,2024-09-02,6380
6770,力積電,14,0,14,光和,2024-09-02,6380
00959B,大華投等美債15Y+,13,0,13,光和,2024-09-02,6380
2801,彰銀,16,3,13,光和,2024-09-02,6380
8043,蜜望實,18,5,13,光和,2024-09-02,6380
00919,群益台灣精選高息,16,4,12,光和,2024-09-02,6380
3019,亞光,13,1,12,光和,2024-09-02,6380
6257,矽格,12,0,12,光和,2024-09-02,6380
2409,友達,14,2,12,光和,2024-09-02,6380
1514,亞力,16,5,11,光和,2024-09-02,6380
00688L,國泰20年美債正2,10,0,10,光和,2024-09-02,6380
00632R,元大台灣50反1,10,0,10,光和,2024-09-02,6380
1218,泰山,10,0,10,光和,2024-09-02,6380
4513,福裕,11,1,10,光和,2024-09-02,6380
4960,誠美材,10,0,10,光和,2024-09-02,6380
6187,萬潤,13,3,10,光和,2024-09-02,6380
6288,聯嘉,10,0,10,光和,2024-09-02,6380
8933,愛地雅,10,0,10,光和,2024-09-02,6380
6016,康和證,10,0,10,光和,2024-09-02,6380
00642U,期元大S＆P石油,9,0,9,光和,2024-09-02,6380
3312,弘憶股,11,2,9,光和,2024-09-02,6380
5443,均豪,28,19,9,光和,2024-09-02,6380
6282,康舒,10,1,9,光和,2024-09-02,6380
2881,富邦金,12,3,9,光和,2024-09-02,6380
1717,長興,8,0,8,光和,2024-09-02,6380
2349,錸德,18,10,8,光和,2024-09-02,6380
2374,佳能,8,0,8,光和,2024-09-02,6380
6139,亞翔,10,2,8,光和,2024-09-02,6380
00687B,國泰20年美債,83,0,83,光和,2024-09-03,6380
00937B,群益ESG投等債20,92,12,80,光和,2024-09-03,6380
00919,群益台灣精選高息,77,6,71,光和,2024-09-03,6380
2402,毅嘉,58,0,58,光和,2024-09-03,6380
2609,陽明,54,0,54,光和,2024-09-03,6380
00918,大華優利高填息30,51,0,51,光和,2024-09-03,6380
00951,台新日本半導體,45,0,45,光和,2024-09-03,6380
2356,英業達,43,0,43,光和,2024-09-03,6380
00954,中信日本半導體,40,0,40,光和,2024-09-03,6380
00665L,富邦�琤肭磪囓�2,40,0,40,光和,2024-09-03,6380
00679B,元大美債20年,35,0,35,光和,2024-09-03,6380
9105,泰金寶-DR,29,0,29,光和,2024-09-03,6380
2020,美亞,26,0,26,光和,2024-09-03,6380
2486,一詮,32,8,24,光和,2024-09-03,6380
2892,第一金,24,0,24,光和,2024-09-03,6380
1316,上曜,24,3,21,光和,2024-09-03,6380
2367,燿華,24,3,21,光和,2024-09-03,6380
2634,漢翔,21,0,21,光和,2024-09-03,6380
4960,誠美材,21,0,21,光和,2024-09-03,6380
00706L,期元大S＆P日圓正2,20,0,20,光和,2024-09-03,6380
2610,華航,21,2,19,光和,2024-09-03,6380
00915,凱基優選高股息30,17,0,17,光和,2024-09-03,6380
1609,大亞,21,4,17,光和,2024-09-03,6380
2323,中環,35,20,15,光和,2024-09-03,6380
2801,彰銀,15,0,15,光和,2024-09-03,6380
6213,聯茂,27,12,15,光和,2024-09-03,6380
00878,國泰永續高股息,17,2,15,光和,2024-09-03,6380
00882,中信中國高股息,13,0,13,光和,2024-09-03,6380
6531,愛普*,16,3,13,光和,2024-09-03,6380
1314,中石化,13,0,13,光和,2024-09-03,6380
2349,錸德,28,15,13,光和,2024-09-03,6380
1711,永光,31,19,12,光和,2024-09-03,6380
2845,遠東銀,12,0,12,光和,2024-09-03,6380
00930,永豐ESG低碳高息,11,0,11,光和,2024-09-03,6380
00650L,復華香港正2,31,20,11,光和,2024-09-03,6380
2408,南亞科,11,1,10,光和,2024-09-03,6380
00680L,元大美債20正2,10,0,10,光和,2024-09-03,6380
2241,艾姆勒,10,0,10,光和,2024-09-03,6380
2331,精英,10,0,10,光和,2024-09-03,6380
2352,佳世達,10,0,10,光和,2024-09-03,6380
2520,冠德,10,0,10,光和,2024-09-03,6380
3050,鈺德,10,0,10,光和,2024-09-03,6380
6226,光鼎,10,0,10,光和,2024-09-03,6380
6603,富強鑫,10,0,10,光和,2024-09-03,6380
6712,長聖,10,0,10,光和,2024-09-03,6380
6770,力積電,10,0,10,光和,2024-09-03,6380
00946,群益科技高息成長,9,0,9,光和,2024-09-03,6380
2002,中鋼,12,3,9,光和,2024-09-03,6380
6609,瀧澤科,10,1,9,光和,2024-09-03,6380
8404,百和興業-KY,9,0,9,光和,2024-09-03,6380
00919,群益台灣精選高息,273,8,265,光和,2024-09-04,6380
00878,國泰永續高股息,162,6,156,光和,2024-09-04,6380
00940,元大台灣價值高息,165,25,140,光和,2024-09-04,6380
3230,錦明,105,0,105,光和,2024-09-04,6380
00918,大華優利高填息30,90,0,90,光和,2024-09-04,6380
00951,台新日本半導體,83,0,83,光和,2024-09-04,6380
1303,南亞,90,10,80,光和,2024-09-04,6380
1785,光洋科,66,2,64,光和,2024-09-04,6380
00954,中信日本半導體,60,0,60,光和,2024-09-04,6380
2801,彰銀,57,0,57,光和,2024-09-04,6380
0056,元大高股息,61,13,48,光和,2024-09-04,6380
00715L,期街口布蘭特正2,42,0,42,光和,2024-09-04,6380
3518,柏騰,32,0,32,光和,2024-09-04,6380
00946,群益科技高息成長,30,0,30,光和,2024-09-04,6380
00664R,國泰臺灣加權反1,30,0,30,光和,2024-09-04,6380
1783,和康生,30,0,30,光和,2024-09-04,6380
2002,中鋼,30,0,30,光和,2024-09-04,6380
2330,台積電,32,2,30,光和,2024-09-04,6380
1326,台化,30,1,29,光和,2024-09-04,6380
1301,台塑,27,1,26,光和,2024-09-04,6380
1314,中石化,47,21,26,光和,2024-09-04,6380
2317,鴻海,42,17,25,光和,2024-09-04,6380
2323,中環,27,3,24,光和,2024-09-04,6380
1618,合機,23,0,23,光和,2024-09-04,6380
6015,宏遠證,23,0,23,光和,2024-09-04,6380
2883,凱基金,23,0,23,光和,2024-09-04,6380
2408,南亞科,24,2,22,光和,2024-09-04,6380
1569,濱川,22,0,22,光和,2024-09-04,6380
2609,陽明,38,16,22,光和,2024-09-04,6380
1714,和桐,21,0,21,光和,2024-09-04,6380
2603,長榮,25,4,21,光和,2024-09-04,6380
3231,緯創,23,3,20,光和,2024-09-04,6380
2303,聯電,34,15,19,光和,2024-09-04,6380
00830,國泰費城半導體,19,0,19,光和,2024-09-04,6380
3312,弘憶股,27,8,19,光和,2024-09-04,6380
00679B,元大美債20年,35,17,18,光和,2024-09-04,6380
00642U,期元大S＆P石油,18,0,18,光和,2024-09-04,6380
3686,達能,18,0,18,光和,2024-09-04,6380
2208,台船,16,0,16,光和,2024-09-04,6380
3006,晶豪科,29,13,16,光和,2024-09-04,6380
4534,慶騰,17,1,16,光和,2024-09-04,6380
9945,潤泰新,19,3,16,光和,2024-09-04,6380
2881,富邦金,15,0,15,光和,2024-09-04,6380
3260,威剛,15,0,15,光和,2024-09-04,6380
5452,佶優,15,0,15,光和,2024-09-04,6380
2515,中工,15,0,15,光和,2024-09-04,6380
1609,大亞,22,8,14,光和,2024-09-04,6380
6235,華孚,19,5,14,光和,2024-09-04,6380
2834,臺企銀,19,5,14,光和,2024-09-04,6380
6213,聯茂,21,8,13,光和,2024-09-04,6380
2344,華邦電,97,16,81,光和,2024-09-05,6380
00952,凱基台灣AI50,76,0,76,光和,2024-09-05,6380
00919,群益台灣精選高息,68,6,62,光和,2024-09-05,6380
00878,國泰永續高股息,64,10,54,光和,2024-09-05,6380
00954,中信日本半導體,50,0,50,光和,2024-09-05,6380
00940,元大台灣價值高息,49,4,45,光和,2024-09-05,6380
00715L,期街口布蘭特正2,44,0,44,光和,2024-09-05,6380
00951,台新日本半導體,40,0,40,光和,2024-09-05,6380
6257,矽格,29,0,29,光和,2024-09-05,6380
3481,群創,59,31,28,光和,2024-09-05,6380
2002,中鋼,26,0,26,光和,2024-09-05,6380
2374,佳能,36,12,24,光和,2024-09-05,6380
2409,友達,27,3,24,光和,2024-09-05,6380
00679B,元大美債20年,31,8,23,光和,2024-09-05,6380
2706,第一店,23,0,23,光和,2024-09-05,6380
2337,旺宏,23,0,23,光和,2024-09-05,6380
00946,群益科技高息成長,22,0,22,光和,2024-09-05,6380
2486,一詮,38,16,22,光和,2024-09-05,6380
2317,鴻海,43,23,20,光和,2024-09-05,6380
00665L,富邦�琤肭磪囓�2,20,0,20,光和,2024-09-05,6380
00929,復華台灣科技優息,47,28,19,光和,2024-09-05,6380
2363,矽統,21,2,19,光和,2024-09-05,6380
4526,東台,21,2,19,光和,2024-09-05,6380
8104,錸寶,19,0,19,光和,2024-09-05,6380
2867,三商壽,20,3,17,光和,2024-09-05,6380
1210,大成,20,5,15,光和,2024-09-05,6380
2329,華泰,15,0,15,光和,2024-09-05,6380
1314,中石化,16,1,15,光和,2024-09-05,6380
00642U,期元大S＆P石油,13,0,13,光和,2024-09-05,6380
4532,瑞智,15,2,13,光和,2024-09-05,6380
8064,東捷,13,0,13,光和,2024-09-05,6380
1303,南亞,23,10,13,光和,2024-09-05,6380
3374,精材,20,7,13,光和,2024-09-05,6380
00637L,元大滬深300正2,12,0,12,光和,2024-09-05,6380
3013,晟銘電,14,2,12,光和,2024-09-05,6380
4979,華星光,14,2,12,光和,2024-09-05,6380
1722,台肥,11,0,11,光和,2024-09-05,6380
3062,建漢,20,9,11,光和,2024-09-05,6380
6505,台塑化,11,0,11,光和,2024-09-05,6380
0056,元大高股息,11,1,10,光和,2024-09-05,6380
00881,國泰台灣5G+,10,0,10,光和,2024-09-05,6380
00753L,中信中國50正2,10,0,10,光和,2024-09-05,6380
1312,國喬,10,0,10,光和,2024-09-05,6380
1455,集盛,10,0,10,光和,2024-09-05,6380
3019,亞光,13,3,10,光和,2024-09-05,6380
4711,永純,12,2,10,光和,2024-09-05,6380
4915,致伸,11,1,10,光和,2024-09-05,6380
8438,昶昕,10,0,10,光和,2024-09-05,6380
9935,慶豐富,10,0,10,光和,2024-09-05,6380
3356,奇偶,11,1,10,光和,2024-09-05,6380
00687B,國泰20年美債,150,21,129,光和,2024-09-06,6380
00632R,元大台灣50反1,120,51,69,光和,2024-09-06,6380
00954,中信日本半導體,50,0,50,光和,2024-09-06,6380
2537,聯上發,50,0,50,光和,2024-09-06,6380
1711,永光,70,25,45,光和,2024-09-06,6380
2845,遠東銀,45,0,45,光和,2024-09-06,6380
2887,台新金,45,1,44,光和,2024-09-06,6380
3706,神達,41,0,41,光和,2024-09-06,6380
3481,群創,74,35,39,光和,2024-09-06,6380
00680L,元大美債20正2,74,37,37,光和,2024-09-06,6380
1618,合機,37,0,37,光和,2024-09-06,6380
00937B,群益ESG投等債20,63,31,32,光和,2024-09-06,6380
1785,光洋科,25,1,24,光和,2024-09-06,6380
00919,群益台灣精選高息,27,4,23,光和,2024-09-06,6380
1316,上曜,22,0,22,光和,2024-09-06,6380
6257,矽格,22,1,21,光和,2024-09-06,6380
00951,台新日本半導體,20,0,20,光和,2024-09-06,6380
4711,永純,20,0,20,光和,2024-09-06,6380
1444,力麗,20,1,19,光和,2024-09-06,6380
00688L,國泰20年美債正2,19,2,17,光和,2024-09-06,6380
00637L,元大滬深300正2,18,1,17,光和,2024-09-06,6380
2344,華邦電,16,0,16,光和,2024-09-06,6380
2836,高雄銀,16,0,16,光和,2024-09-06,6380
2314,台揚,15,0,15,光和,2024-09-06,6380
4915,致伸,15,0,15,光和,2024-09-06,6380
6443,元晶,15,0,15,光和,2024-09-06,6380
8111,立��,15,0,15,光和,2024-09-06,6380
00878,國泰永續高股息,48,34,14,光和,2024-09-06,6380
3047,訊舟,14,0,14,光和,2024-09-06,6380
3511,矽瑪,14,0,14,光和,2024-09-06,6380
4510,高鋒,31,17,14,光和,2024-09-06,6380
2464,盟立,18,5,13,光和,2024-09-06,6380
6770,力積電,13,0,13,光和,2024-09-06,6380
00830,國泰費城半導體,14,1,13,光和,2024-09-06,6380
2892,第一金,12,0,12,光和,2024-09-06,6380
1605,華新,28,17,11,光和,2024-09-06,6380
1616,億泰,11,0,11,光和,2024-09-06,6380
2337,旺宏,11,0,11,光和,2024-09-06,6380
2354,鴻準,11,0,11,光和,2024-09-06,6380
9902,台火,11,0,11,光和,2024-09-06,6380
2881,富邦金,17,6,11,光和,2024-09-06,6380
2002,中鋼,11,1,10,光和,2024-09-06,6380
00664R,國泰臺灣加權反1,10,0,10,光和,2024-09-06,6380
00935,野村臺灣新科技50,10,0,10,光和,2024-09-06,6380
00948B,中信優息投資級債,10,0,10,光和,2024-09-06,6380
1314,中石化,11,1,10,光和,2024-09-06,6380
1326,台化,12,2,10,光和,2024-09-06,6380
2401,凌陽,10,0,10,光和,2024-09-06,6380
2511,太子,10,0,10,光和,2024-09-06,6380
5009,榮剛,10,0,10,光和,2024-09-06,6380
00919,群益台灣精選高息,156,3,153,光和,2024-09-09,6380
00680L,元大美債20正2,116,0,116,光和,2024-09-09,6380
00687B,國泰20年美債,126,17,109,光和,2024-09-09,6380
00688L,國泰20年美債正2,110,24,86,光和,2024-09-09,6380
00929,復華台灣科技優息,89,21,68,光和,2024-09-09,6380
00878,國泰永續高股息,54,3,51,光和,2024-09-09,6380
3663,鑫科,50,5,45,光和,2024-09-09,6380
2002,中鋼,43,0,43,光和,2024-09-09,6380
00637L,元大滬深300正2,35,3,32,光和,2024-09-09,6380
2356,英業達,34,3,31,光和,2024-09-09,6380
2317,鴻海,35,4,31,光和,2024-09-09,6380
00940,元大台灣價值高息,53,25,28,光和,2024-09-09,6380
4729,熒茂,25,0,25,光和,2024-09-09,6380
00951,台新日本半導體,55,31,24,光和,2024-09-09,6380
2883,凱基金,23,0,23,光和,2024-09-09,6380
2845,遠東銀,22,0,22,光和,2024-09-09,6380
4711,永純,39,18,21,光和,2024-09-09,6380
00882,中信中國高股息,20,0,20,光和,2024-09-09,6380
3511,矽瑪,23,3,20,光和,2024-09-09,6380
00918,大華優利高填息30,17,0,17,光和,2024-09-09,6380
00715L,期街口布蘭特正2,16,0,16,光和,2024-09-09,6380
6770,力積電,20,4,16,光和,2024-09-09,6380
3202,樺晟,15,0,15,光和,2024-09-09,6380
1609,大亞,14,0,14,光和,2024-09-09,6380
1540,喬福,22,8,14,光和,2024-09-09,6380
2801,彰銀,16,2,14,光和,2024-09-09,6380
0056,元大高股息,14,0,14,光和,2024-09-09,6380
2881,富邦金,13,0,13,光和,2024-09-09,6380
00753L,中信中國50正2,13,0,13,光和,2024-09-09,6380
2408,南亞科,12,0,12,光和,2024-09-09,6380
2330,台積電,12,0,12,光和,2024-09-09,6380
00915,凱基優選高股息30,15,3,12,光和,2024-09-09,6380
00712,復華富時不動產,11,0,11,光和,2024-09-09,6380
2402,毅嘉,23,12,11,光和,2024-09-09,6380
4563,百德,11,0,11,光和,2024-09-09,6380
6194,育富,14,3,11,光和,2024-09-09,6380
6215,和椿,13,2,11,光和,2024-09-09,6380
2891,中信金,10,0,10,光和,2024-09-09,6380
00664R,國泰臺灣加權反1,10,0,10,光和,2024-09-09,6380
00948B,中信優息投資級債,10,0,10,光和,2024-09-09,6380
3413,京鼎,10,0,10,光和,2024-09-09,6380
00830,國泰費城半導體,10,1,9,光和,2024-09-09,6380
4510,高鋒,32,23,9,光和,2024-09-09,6380
3231,緯創,11,2,9,光和,2024-09-09,6380
00720B,元大投資級公司債,8,0,8,光和,2024-09-09,6380
1314,中石化,18,10,8,光和,2024-09-09,6380
1785,光洋科,9,1,8,光和,2024-09-09,6380
3715,定穎投控,17,10,7,光和,2024-09-09,6380
00946,群益科技高息成長,7,0,7,光和,2024-09-09,6380
2010,春源,7,0,7,光和,2024-09-09,6380
00940,元大台灣價值高息,130,20,110,光和,2024-09-10,6380
00632R,元大台灣50反1,105,10,95,光和,2024-09-10,6380
2027,大成鋼,82,0,82,光和,2024-09-10,6380
00929,復華台灣科技優息,70,6,64,光和,2024-09-10,6380
00918,大華優利高填息30,58,0,58,光和,2024-09-10,6380
3047,訊舟,47,3,44,光和,2024-09-10,6380
2317,鴻海,45,5,40,光和,2024-09-10,6380
3535,晶彩科,38,5,33,光和,2024-09-10,6380
2801,彰銀,35,3,32,光和,2024-09-10,6380
1618,合機,32,0,32,光和,2024-09-10,6380
1513,中興電,25,0,25,光和,2024-09-10,6380
0056,元大高股息,29,6,23,光和,2024-09-10,6380
00878,國泰永續高股息,30,7,23,光和,2024-09-10,6380
2537,聯上發,21,0,21,光和,2024-09-10,6380
2303,聯電,21,1,20,光和,2024-09-10,6380
6830,汎銓,20,0,20,光和,2024-09-10,6380
00959B,大華投等美債15Y+,20,1,19,光和,2024-09-10,6380
3294,英濟,20,1,19,光和,2024-09-10,6380
4711,永純,19,0,19,光和,2024-09-10,6380
2002,中鋼,25,8,17,光和,2024-09-10,6380
2062,橋椿,20,3,17,光和,2024-09-10,6380
2382,廣達,33,16,17,光和,2024-09-10,6380
00713,元大台灣高息低波,16,0,16,光和,2024-09-10,6380
2313,華通,39,23,16,光和,2024-09-10,6380
2323,中環,16,0,16,光和,2024-09-10,6380
00948B,中信優息投資級債,15,0,15,光和,2024-09-10,6380
1785,光洋科,24,9,15,光和,2024-09-10,6380
2356,英業達,21,6,15,光和,2024-09-10,6380
6651,全宇昕,15,0,15,光和,2024-09-10,6380
6531,愛普*,15,1,14,光和,2024-09-10,6380
1471,首利,21,8,13,光和,2024-09-10,6380
1609,大亞,15,2,13,光和,2024-09-10,6380
2316,楠梓電,12,0,12,光和,2024-09-10,6380
00712,復華富時不動產,12,0,12,光和,2024-09-10,6380
3050,鈺德,12,0,12,光和,2024-09-10,6380
00919,群益台灣精選高息,14,2,12,光和,2024-09-10,6380
3481,群創,29,18,11,光和,2024-09-10,6380
1301,台塑,12,1,11,光和,2024-09-10,6380
2367,燿華,13,2,11,光和,2024-09-10,6380
2392,正崴,11,0,11,光和,2024-09-10,6380
00687B,國泰20年美債,27,17,10,光和,2024-09-10,6380
00753L,中信中國50正2,10,0,10,光和,2024-09-10,6380
1904,正隆,10,0,10,光和,2024-09-10,6380
2609,陽明,25,15,10,光和,2024-09-10,6380
2836,高雄銀,10,0,10,光和,2024-09-10,6380
2885,元大金,10,0,10,光和,2024-09-10,6380
3346,麗清,10,0,10,光和,2024-09-10,6380
4714,永捷,10,0,10,光和,2024-09-10,6380
6505,台塑化,10,0,10,光和,2024-09-10,6380
2324,仁寶,11,2,9,光和,2024-09-10,6380
00680L,元大美債20正2,205,11,194,光和,2024-09-11,6380
00948B,中信優息投資級債,94,0,94,光和,2024-09-11,6380
00688L,國泰20年美債正2,300,250,50,光和,2024-09-11,6380
00715L,期街口布蘭特正2,47,3,44,光和,2024-09-11,6380
00929,復華台灣科技優息,43,5,38,光和,2024-09-11,6380
0056,元大高股息,35,0,35,光和,2024-09-11,6380
00940,元大台灣價值高息,37,2,35,光和,2024-09-11,6380
00878,國泰永續高股息,31,1,30,光和,2024-09-11,6380
00665L,富邦�琤肭磪囓�2,30,0,30,光和,2024-09-11,6380
00753L,中信中國50正2,28,0,28,光和,2024-09-11,6380
00918,大華優利高填息30,26,0,26,光和,2024-09-11,6380
2836,高雄銀,26,0,26,光和,2024-09-11,6380
1522,堤維西,24,0,24,光和,2024-09-11,6380
2887,台新金,22,0,22,光和,2024-09-11,6380
00637L,元大滬深300正2,21,0,21,光和,2024-09-11,6380
2881,富邦金,20,0,20,光和,2024-09-11,6380
4915,致伸,20,0,20,光和,2024-09-11,6380
00959B,大華投等美債15Y+,20,1,19,光和,2024-09-11,6380
1540,喬福,22,3,19,光和,2024-09-11,6380
2883,凱基金,19,0,19,光和,2024-09-11,6380
00679B,元大美債20年,25,7,18,光和,2024-09-11,6380
3511,矽瑪,19,3,16,光和,2024-09-11,6380
4711,永純,20,5,15,光和,2024-09-11,6380
9945,潤泰新,15,0,15,光和,2024-09-11,6380
1101,台泥,13,0,13,光和,2024-09-11,6380
2867,三商壽,15,3,12,光和,2024-09-11,6380
00935,野村臺灣新科技50,12,0,12,光和,2024-09-11,6380
3047,訊舟,14,2,12,光和,2024-09-11,6380
2520,冠德,11,0,11,光和,2024-09-11,6380
2002,中鋼,11,0,11,光和,2024-09-11,6380
2801,彰銀,16,5,11,光和,2024-09-11,6380
00930,永豐ESG低碳高息,10,0,10,光和,2024-09-11,6380
00945B,凱基美國非投等債,10,0,10,光和,2024-09-11,6380
6016,康和證,10,0,10,光和,2024-09-11,6380
4566,時碩工業,11,2,9,光和,2024-09-11,6380
6112,邁達特,10,1,9,光和,2024-09-11,6380
6151,晉倫,11,2,9,光和,2024-09-11,6380
6609,瀧澤科,9,0,9,光和,2024-09-11,6380
00830,國泰費城半導體,8,0,8,光和,2024-09-11,6380
6187,萬潤,8,1,7,光和,2024-09-11,6380
2891,中信金,7,0,7,光和,2024-09-11,6380
3252,海灣,7,0,7,光和,2024-09-11,6380
2905,三商,7,1,6,光和,2024-09-11,6380
00720B,元大投資級公司債,6,0,6,光和,2024-09-11,6380
1218,泰山,6,0,6,光和,2024-09-11,6380
1409,新纖,6,0,6,光和,2024-09-11,6380
2390,云辰,6,0,6,光和,2024-09-11,6380
2412,中華電,8,2,6,光和,2024-09-11,6380
3031,佰鴻,6,0,6,光和,2024-09-11,6380
4971,IET-KY,11,5,6,光和,2024-09-11,6380
00632R,元大台灣50反1,408,0,408,光和,2024-09-12,6380
00927,群益半導體收益,215,0,215,光和,2024-09-12,6380
2371,大同,140,7,133,光和,2024-09-12,6380
00937B,群益ESG投等債20,48,10,38,光和,2024-09-12,6380
2002,中鋼,32,4,28,光和,2024-09-12,6380
3481,群創,30,3,27,光和,2024-09-12,6380
4915,致伸,27,0,27,光和,2024-09-12,6380
2344,華邦電,26,0,26,光和,2024-09-12,6380
00664R,國泰臺灣加權反1,25,0,25,光和,2024-09-12,6380
2399,映泰,24,0,24,光和,2024-09-12,6380
1709,和益,22,2,20,光和,2024-09-12,6380
8069,元太,22,2,20,光和,2024-09-12,6380
00687B,國泰20年美債,28,9,19,光和,2024-09-12,6380
3715,定穎投控,17,1,16,光和,2024-09-12,6380
2891,中信金,20,5,15,光和,2024-09-12,6380
6215,和椿,27,12,15,光和,2024-09-12,6380
3031,佰鴻,20,6,14,光和,2024-09-12,6380
2382,廣達,29,16,13,光和,2024-09-12,6380
9105,泰金寶-DR,13,0,13,光和,2024-09-12,6380
2409,友達,22,10,12,光和,2024-09-12,6380
2915,潤泰全,12,0,12,光和,2024-09-12,6380
1710,東聯,14,3,11,光和,2024-09-12,6380
2605,新興,11,0,11,光和,2024-09-12,6380
4563,百德,14,3,11,光和,2024-09-12,6380
4958,臻鼎-KY,12,1,11,光和,2024-09-12,6380
1810,和成,10,0,10,光和,2024-09-12,6380
2520,冠德,10,0,10,光和,2024-09-12,6380
3021,鴻名,10,0,10,光和,2024-09-12,6380
3290,東浦,10,0,10,光和,2024-09-12,6380
6606,建德工業,10,0,10,光和,2024-09-12,6380
4977,眾達-KY,19,10,9,光和,2024-09-12,6380
00943,兆豐電子高息等權,8,0,8,光和,2024-09-12,6380
1218,泰山,8,0,8,光和,2024-09-12,6380
2027,大成鋼,11,3,8,光和,2024-09-12,6380
3707,漢磊,7,0,7,光和,2024-09-12,6380
00918,大華優利高填息30,7,0,7,光和,2024-09-12,6380
1522,堤維西,7,0,7,光和,2024-09-12,6380
5347,世界,6,0,6,光和,2024-09-12,6380
1718,中纖,6,0,6,光和,2024-09-12,6380
2481,強茂,6,0,6,光和,2024-09-12,6380
3025,星通,7,1,6,光和,2024-09-12,6380
4807,日成-KY,6,0,6,光和,2024-09-12,6380
5309,系統電,6,0,6,光和,2024-09-12,6380
5531,鄉林,6,0,6,光和,2024-09-12,6380
6284,佳邦,6,0,6,光和,2024-09-12,6380
5443,均豪,9,4,5,光和,2024-09-12,6380
2314,台揚,5,0,5,光和,2024-09-12,6380
2461,光群雷,5,0,5,光和,2024-09-12,6380
2472,立隆電,5,0,5,光和,2024-09-12,6380
2545,皇翔,5,0,5,光和,2024-09-12,6380
00948B,中信優息投資級債,300,0,300,光和,2024-09-13,6380
00632R,元大台灣50反1,100,0,100,光和,2024-09-13,6380
00637L,元大滬深300正2,102,11,91,光和,2024-09-13,6380
8011,台通,75,5,70,光和,2024-09-13,6380
2371,大同,64,3,61,光和,2024-09-13,6380
1314,中石化,57,1,56,光和,2024-09-13,6380
00936,台新永續高息中小,51,0,51,光和,2024-09-13,6380
2497,怡利電,36,1,35,光和,2024-09-13,6380
00712,復華富時不動產,30,0,30,光和,2024-09-13,6380
00687B,國泰20年美債,29,2,27,光和,2024-09-13,6380
2888,新光金,31,6,25,光和,2024-09-13,6380
00878,國泰永續高股息,23,0,23,光和,2024-09-13,6380
4510,高鋒,29,8,21,光和,2024-09-13,6380
5880,合庫金,20,0,20,光和,2024-09-13,6380
3481,群創,22,3,19,光和,2024-09-13,6380
0056,元大高股息,17,0,17,光和,2024-09-13,6380
5309,系統電,16,0,16,光和,2024-09-13,6380
6153,嘉聯益,15,0,15,光和,2024-09-13,6380
1795,美時,15,1,14,光和,2024-09-13,6380
00679B,元大美債20年,12,0,12,光和,2024-09-13,6380
1522,堤維西,12,0,12,光和,2024-09-13,6380
6763,綠界科技*,11,0,11,光和,2024-09-13,6380
3707,漢磊,10,0,10,光和,2024-09-13,6380
00665L,富邦�琤肭磪囓�2,10,0,10,光和,2024-09-13,6380
00881,國泰台灣5G+,10,0,10,光和,2024-09-13,6380
5381,合正,10,0,10,光和,2024-09-13,6380
3413,京鼎,10,1,9,光和,2024-09-13,6380
4566,時碩工業,17,8,9,光和,2024-09-13,6380
1532,勤美,8,0,8,光和,2024-09-13,6380
6770,力積電,10,2,8,光和,2024-09-13,6380
00919,群益台灣精選高息,15,7,8,光和,2024-09-13,6380
2329,華泰,8,1,7,光和,2024-09-13,6380
8249,菱光,8,1,7,光和,2024-09-13,6380
00713,元大台灣高息低波,6,0,6,光和,2024-09-13,6380
6111,大宇資,6,0,6,光和,2024-09-13,6380
1709,和益,6,0,6,光和,2024-09-13,6380
2408,南亞科,6,0,6,光和,2024-09-13,6380
3374,精材,11,5,6,光和,2024-09-13,6380
4551,智伸科,7,1,6,光和,2024-09-13,6380
4561,健椿,7,1,6,光和,2024-09-13,6380
6133,金橋,9,3,6,光和,2024-09-13,6380
2317,鴻海,12,7,5,光和,2024-09-13,6380
1477,聚陽,5,0,5,光和,2024-09-13,6380
2312,金寶,7,2,5,光和,2024-09-13,6380
2313,華通,7,2,5,光和,2024-09-13,6380
2323,中環,5,0,5,光和,2024-09-13,6380
2402,毅嘉,6,1,5,光和,2024-09-13,6380
2605,新興,6,1,5,光和,2024-09-13,6380
4538,大詠城,5,0,5,光和,2024-09-13,6380
4562,穎漢,6,1,5,光和,2024-09-13,6380
2371,大同,247,5,242,光和,2024-09-16,6380
00932,兆豐永續高息等權,100,0,100,光和,2024-09-16,6380
00919,群益台灣精選高息,84,3,81,光和,2024-09-16,6380
2706,第一店,80,0,80,光和,2024-09-16,6380
00637L,元大滬深300正2,75,0,75,光和,2024-09-16,6380
2349,錸德,83,16,67,光和,2024-09-16,6380
2344,華邦電,66,1,65,光和,2024-09-16,6380
1714,和桐,56,0,56,光和,2024-09-16,6380
1721,三晃,70,28,42,光和,2024-09-16,6380
3059,華晶科,38,0,38,光和,2024-09-16,6380
00632R,元大台灣50反1,30,0,30,光和,2024-09-16,6380
00955,中信日本商社,30,0,30,光和,2024-09-16,6380
00937B,群益ESG投等債20,48,20,28,光和,2024-09-16,6380
1605,華新,31,5,26,光和,2024-09-16,6380
2801,彰銀,26,0,26,光和,2024-09-16,6380
3312,弘憶股,24,0,24,光和,2024-09-16,6380
1532,勤美,24,0,24,光和,2024-09-16,6380
1301,台塑,22,2,20,光和,2024-09-16,6380
00688L,國泰20年美債正2,20,0,20,光和,2024-09-16,6380
00915,凱基優選高股息30,19,0,19,光和,2024-09-16,6380
2867,三商壽,22,3,19,光和,2024-09-16,6380
00929,復華台灣科技優息,18,0,18,光和,2024-09-16,6380
00923,群益台ESG低碳50,18,0,18,光和,2024-09-16,6380
2312,金寶,20,3,17,光和,2024-09-16,6380
3167,大量,28,11,17,光和,2024-09-16,6380
4549,桓達,18,1,17,光和,2024-09-16,6380
1709,和益,16,0,16,光和,2024-09-16,6380
00687B,國泰20年美債,28,13,15,光和,2024-09-16,6380
2365,昆盈,16,3,13,光和,2024-09-16,6380
2208,台船,13,0,13,光和,2024-09-16,6380
00679B,元大美債20年,30,18,12,光和,2024-09-16,6380
00713,元大台灣高息低波,12,0,12,光和,2024-09-16,6380
1303,南亞,12,0,12,光和,2024-09-16,6380
8112,至上,13,1,12,光和,2024-09-16,6380
00918,大華優利高填息30,11,0,11,光和,2024-09-16,6380
3360,尚立,15,4,11,光和,2024-09-16,6380
1312,國喬,10,0,10,光和,2024-09-16,6380
1527,鑽全,10,0,10,光和,2024-09-16,6380
3002,歐格,10,0,10,光和,2024-09-16,6380
5014,建錩,10,0,10,光和,2024-09-16,6380
8358,金居,12,2,10,光和,2024-09-16,6380
3652,精聯,10,0,10,光和,2024-09-16,6380
2313,華通,11,2,9,光和,2024-09-16,6380
2356,英業達,10,1,9,光和,2024-09-16,6380
3374,精材,11,2,9,光和,2024-09-16,6380
8096,擎亞,16,7,9,光和,2024-09-16,6380
3029,零壹,14,6,8,光和,2024-09-16,6380
2480,敦陽科,8,0,8,光和,2024-09-16,6380
2882,國泰金,8,0,8,光和,2024-09-16,6380
5230,雷笛克光學,15,7,8,光和,2024-09-16,6380
00929,復華台灣科技優息,107,0,107,光和,2024-09-18,6380
00680L,元大美債20正2,130,25,105,光和,2024-09-18,6380
1714,和桐,56,1,55,光和,2024-09-18,6380
2317,鴻海,60,6,54,光和,2024-09-18,6380
00919,群益台灣精選高息,107,55,52,光和,2024-09-18,6380
2887,台新金,56,13,43,光和,2024-09-18,6380
00955,中信日本商社,40,0,40,光和,2024-09-18,6380
00878,國泰永續高股息,40,0,40,光和,2024-09-18,6380
1709,和益,45,10,35,光和,2024-09-18,6380
2323,中環,25,0,25,光和,2024-09-18,6380
00936,台新永續高息中小,24,0,24,光和,2024-09-18,6380
2313,華通,46,23,23,光和,2024-09-18,6380
00933B,國泰10Y+金融債,22,0,22,光和,2024-09-18,6380
1540,喬福,25,3,22,光和,2024-09-18,6380
2515,中工,22,0,22,光和,2024-09-18,6380
00915,凱基優選高股息30,21,0,21,光和,2024-09-18,6380
2344,華邦電,20,0,20,光和,2024-09-18,6380
6120,達運,20,0,20,光和,2024-09-18,6380
6116,彩晶,21,2,19,光和,2024-09-18,6380
2426,鼎元,21,3,18,光和,2024-09-18,6380
3498,陽程,21,4,17,光和,2024-09-18,6380
0056,元大高股息,16,0,16,光和,2024-09-18,6380
3481,群創,45,29,16,光和,2024-09-18,6380
1711,永光,32,16,16,光和,2024-09-18,6380
3437,榮創,16,0,16,光和,2024-09-18,6380
2303,聯電,17,2,15,光和,2024-09-18,6380
2374,佳能,26,12,14,光和,2024-09-18,6380
2477,美隆電,18,4,14,光和,2024-09-18,6380
1605,華新,13,0,13,光和,2024-09-18,6380
3390,旭軟,16,3,13,光和,2024-09-18,6380
3715,定穎投控,13,0,13,光和,2024-09-18,6380
00934,中信成長高股息,13,0,13,光和,2024-09-18,6380
00918,大華優利高填息30,16,4,12,光和,2024-09-18,6380
2467,志聖,13,1,12,光和,2024-09-18,6380
2324,仁寶,12,0,12,光和,2024-09-18,6380
1532,勤美,11,0,11,光和,2024-09-18,6380
2481,強茂,20,9,11,光和,2024-09-18,6380
8111,立��,14,3,11,光和,2024-09-18,6380
8215,明基材,11,0,11,光和,2024-09-18,6380
00957B,兆豐US優選投等債,10,0,10,光和,2024-09-18,6380
2547,日勝生,10,0,10,光和,2024-09-18,6380
3708,上緯投控,10,0,10,光和,2024-09-18,6380
6005,群益證,10,0,10,光和,2024-09-18,6380
6589,台康生技,10,0,10,光和,2024-09-18,6380
8039,台虹,22,12,10,光和,2024-09-18,6380
6187,萬潤,11,1,10,光和,2024-09-18,6380
4551,智伸科,10,1,9,光和,2024-09-18,6380
4561,健椿,12,3,9,光和,2024-09-18,6380
4903,聯光通,18,9,9,光和,2024-09-18,6380
8064,東捷,9,0,9,光和,2024-09-18,6380
00632R,元大台灣50反1,383,0,383,光和,2024-09-19,6380
2888,新光金,257,56,201,光和,2024-09-19,6380
2317,鴻海,125,2,123,光和,2024-09-19,6380
00680L,元大美債20正2,97,0,97,光和,2024-09-19,6380
00679B,元大美債20年,61,0,61,光和,2024-09-19,6380
2801,彰銀,63,4,59,光和,2024-09-19,6380
00706L,期元大S＆P日圓正2,40,0,40,光和,2024-09-19,6380
2836,高雄銀,40,0,40,光和,2024-09-19,6380
3049,精金,64,29,35,光和,2024-09-19,6380
2504,國產,32,0,32,光和,2024-09-19,6380
00929,復華台灣科技優息,44,13,31,光和,2024-09-19,6380
00688L,國泰20年美債正2,30,0,30,光和,2024-09-19,6380
00937B,群益ESG投等債20,29,0,29,光和,2024-09-19,6380
00687B,國泰20年美債,27,0,27,光和,2024-09-19,6380
2344,華邦電,23,0,23,光和,2024-09-19,6380
4958,臻鼎-KY,22,0,22,光和,2024-09-19,6380
00664R,國泰臺灣加權反1,20,0,20,光和,2024-09-19,6380
00933B,國泰10Y+金融債,20,3,17,光和,2024-09-19,6380
4716,大立,25,8,17,光和,2024-09-19,6380
2002,中鋼,16,0,16,光和,2024-09-19,6380
3481,群創,25,10,15,光和,2024-09-19,6380
2457,飛宏,15,0,15,光和,2024-09-19,6380
1710,東聯,13,0,13,光和,2024-09-19,6380
2367,燿華,15,2,13,光和,2024-09-19,6380
5309,系統電,13,0,13,光和,2024-09-19,6380
00915,凱基優選高股息30,11,0,11,光和,2024-09-19,6380
8096,擎亞,15,4,11,光和,2024-09-19,6380
00907,永豐優息存股,10,0,10,光和,2024-09-19,6380
00958B,永豐ESG銀行債15,10,0,10,光和,2024-09-19,6380
6269,台郡,10,0,10,光和,2024-09-19,6380
2349,錸德,19,11,8,光和,2024-09-19,6380
4956,光鋐,8,0,8,光和,2024-09-19,6380
6215,和椿,8,0,8,光和,2024-09-19,6380
1711,永光,26,19,7,光和,2024-09-19,6380
2426,鼎元,8,1,7,光和,2024-09-19,6380
8150,南茂,7,0,7,光和,2024-09-19,6380
00927,群益半導體收益,6,0,6,光和,2024-09-19,6380
00919,群益台灣精選高息,69,63,6,光和,2024-09-19,6380
00878,國泰永續高股息,6,0,6,光和,2024-09-19,6380
3710,連展投控,6,0,6,光和,2024-09-19,6380
6126,信音,6,0,6,光和,2024-09-19,6380
6285,啟��,6,0,6,光和,2024-09-19,6380
2467,志聖,5,0,5,光和,2024-09-19,6380
0056,元大高股息,7,2,5,光和,2024-09-19,6380
00720B,元大投資級公司債,5,0,5,光和,2024-09-19,6380
2038,海光,5,0,5,光和,2024-09-19,6380
3511,矽瑪,7,2,5,光和,2024-09-19,6380
3664,安瑞-KY,5,0,5,光和,2024-09-19,6380
4167,松瑞藥,5,0,5,光和,2024-09-19,6380
6509,聚和,5,0,5,光和,2024-09-19,6380
00919,群益台灣精選高息,337,33,304,光和,2024-09-20,6380
00632R,元大台灣50反1,383,100,283,光和,2024-09-20,6380
2888,新光金,290,31,259,光和,2024-09-20,6380
1721,三晃,152,20,132,光和,2024-09-20,6380
00637L,元大滬深300正2,90,0,90,光和,2024-09-20,6380
3062,建漢,59,8,51,光和,2024-09-20,6380
00917,中信特選金融,50,0,50,光和,2024-09-20,6380
1712,興農,50,0,50,光和,2024-09-20,6380
3078,僑威,50,0,50,光和,2024-09-20,6380
1711,永光,277,236,41,光和,2024-09-20,6380
2405,輔信,40,0,40,光和,2024-09-20,6380
6264,富裔,30,0,30,光和,2024-09-20,6380
2867,三商壽,33,5,28,光和,2024-09-20,6380
00688L,國泰20年美債正2,27,0,27,光和,2024-09-20,6380
3049,精金,27,0,27,光和,2024-09-20,6380
2515,中工,26,1,25,光和,2024-09-20,6380
2915,潤泰全,29,4,25,光和,2024-09-20,6380
00940,元大台灣價值高息,39,16,23,光和,2024-09-20,6380
2504,國產,22,1,21,光和,2024-09-20,6380
00795B,中信美國公債20年,20,0,20,光和,2024-09-20,6380
2812,台中銀,20,0,20,光和,2024-09-20,6380
1316,上曜,18,0,18,光和,2024-09-20,6380
1540,喬福,19,1,18,光和,2024-09-20,6380
2836,高雄銀,20,2,18,光和,2024-09-20,6380
4729,熒茂,21,3,18,光和,2024-09-20,6380
2540,愛山林,17,0,17,光和,2024-09-20,6380
2542,興富發,17,1,16,光和,2024-09-20,6380
2481,強茂,16,0,16,光和,2024-09-20,6380
9105,泰金寶-DR,16,0,16,光和,2024-09-20,6380
4909,新復興,17,1,16,光和,2024-09-20,6380
2002,中鋼,18,3,15,光和,2024-09-20,6380
1570,力肯,15,0,15,光和,2024-09-20,6380
1101,台泥,14,0,14,光和,2024-09-20,6380
4526,東台,18,5,13,光和,2024-09-20,6380
00929,復華台灣科技優息,22,10,12,光和,2024-09-20,6380
00915,凱基優選高股息30,15,3,12,光和,2024-09-20,6380
1314,中石化,19,7,12,光和,2024-09-20,6380
2618,長榮航,22,10,12,光和,2024-09-20,6380
5864,致和證,12,0,12,光和,2024-09-20,6380
4903,聯光通,12,0,12,光和,2024-09-20,6380
1446,宏和,11,0,11,光和,2024-09-20,6380
00673R,期元大S＆P原油反1,10,0,10,光和,2024-09-20,6380
00664R,國泰臺灣加權反1,10,0,10,光和,2024-09-20,6380
00958B,永豐ESG銀行債15,10,0,10,光和,2024-09-20,6380
1609,大亞,15,5,10,光和,2024-09-20,6380
1709,和益,10,0,10,光和,2024-09-20,6380
2913,農林,10,0,10,光和,2024-09-20,6380
3372,典範,11,1,10,光和,2024-09-20,6380
3706,神達,20,10,10,光和,2024-09-20,6380
8070,長華*,17,7,10,光和,2024-09-20,6380
00632R,元大台灣50反1,275,0,275,光和,2024-09-23,6380
00680L,元大美債20正2,165,0,165,光和,2024-09-23,6380
3481,群創,95,9,86,光和,2024-09-23,6380
1536,和大,82,0,82,光和,2024-09-23,6380
00937B,群益ESG投等債20,66,3,63,光和,2024-09-23,6380
00917,中信特選金融,50,0,50,光和,2024-09-23,6380
00725B,國泰投資級公司債,50,0,50,光和,2024-09-23,6380
1711,永光,104,59,45,光和,2024-09-23,6380
00687B,國泰20年美債,36,2,34,光和,2024-09-23,6380
00706L,期元大S＆P日圓正2,30,0,30,光和,2024-09-23,6380
2836,高雄銀,30,0,30,光和,2024-09-23,6380
2313,華通,30,3,27,光和,2024-09-23,6380
6869,雲豹能源,27,1,26,光和,2024-09-23,6380
2312,金寶,24,1,23,光和,2024-09-23,6380
3049,精金,26,3,23,光和,2024-09-23,6380
8111,立��,23,1,22,光和,2024-09-23,6380
3588,通嘉,23,2,21,光和,2024-09-23,6380
2438,翔耀,20,0,20,光和,2024-09-23,6380
3062,建漢,19,0,19,光和,2024-09-23,6380
9945,潤泰新,17,2,15,光和,2024-09-23,6380
1710,東聯,15,0,15,光和,2024-09-23,6380
2883,凱基金,15,0,15,光和,2024-09-23,6380
4989,榮科,18,6,12,光和,2024-09-23,6380
00650L,復華香港正2,11,0,11,光和,2024-09-23,6380
1721,三晃,38,27,11,光和,2024-09-23,6380
00671R,富邦NASDAQ反1,10,0,10,光和,2024-09-23,6380
1524,耿鼎,12,2,10,光和,2024-09-23,6380
1727,中華化,16,6,10,光和,2024-09-23,6380
1810,和成,10,0,10,光和,2024-09-23,6380
2388,威盛,11,1,10,光和,2024-09-23,6380
3623,富晶通,12,2,10,光和,2024-09-23,6380
4729,熒茂,10,0,10,光和,2024-09-23,6380
4909,新復興,10,0,10,光和,2024-09-23,6380
4915,致伸,10,0,10,光和,2024-09-23,6380
6269,台郡,10,0,10,光和,2024-09-23,6380
1336,台翰,13,4,9,光和,2024-09-23,6380
1784,訊聯,10,1,9,光和,2024-09-23,6380
3050,鈺德,10,1,9,光和,2024-09-23,6380
4707,磐亞,9,0,9,光和,2024-09-23,6380
2464,盟立,11,3,8,光和,2024-09-23,6380
4906,正文,8,0,8,光和,2024-09-23,6380
5905,南仁湖,8,0,8,光和,2024-09-23,6380
6151,晉倫,10,2,8,光和,2024-09-23,6380
8039,台虹,10,2,8,光和,2024-09-23,6380
1799,易威,7,0,7,光和,2024-09-23,6380
3645,達邁,7,0,7,光和,2024-09-23,6380
4562,穎漢,7,0,7,光和,2024-09-23,6380
2449,京元電子,7,1,6,光和,2024-09-23,6380
2362,藍天,6,0,6,光和,2024-09-23,6380
3047,訊舟,6,0,6,光和,2024-09-23,6380
2317,鴻海,357,25,332,光和,2024-09-24,6380
00632R,元大台灣50反1,395,140,255,光和,2024-09-24,6380
2888,新光金,124,24,100,光和,2024-09-24,6380
00953B,群益優選非投等債,100,0,100,光和,2024-09-24,6380
00679B,元大美債20年,101,4,97,光和,2024-09-24,6380
00919,群益台灣精選高息,68,2,66,光和,2024-09-24,6380
00688L,國泰20年美債正2,50,0,50,光和,2024-09-24,6380
00680L,元大美債20正2,45,0,45,光和,2024-09-24,6380
00960,野村全球航運龍頭,32,0,32,光和,2024-09-24,6380
00940,元大台灣價值高息,27,0,27,光和,2024-09-24,6380
3149,正達,51,27,24,光和,2024-09-24,6380
2344,華邦電,25,4,21,光和,2024-09-24,6380
2537,聯上發,21,0,21,光和,2024-09-24,6380
00712,復華富時不動產,21,0,21,光和,2024-09-24,6380
2399,映泰,27,8,19,光和,2024-09-24,6380
2809,京城銀,20,1,19,光和,2024-09-24,6380
8039,台虹,25,7,18,光和,2024-09-24,6380
4711,永純,20,3,17,光和,2024-09-24,6380
2520,冠德,15,0,15,光和,2024-09-24,6380
3257,虹冠電,15,0,15,光和,2024-09-24,6380
4513,福裕,15,0,15,光和,2024-09-24,6380
5272,笙科,15,2,13,光和,2024-09-24,6380
3029,零壹,12,0,12,光和,2024-09-24,6380
5371,中光電,26,14,12,光和,2024-09-24,6380
6770,力積電,12,0,12,光和,2024-09-24,6380
00951,台新日本半導體,11,0,11,光和,2024-09-24,6380
2313,華通,14,3,11,光和,2024-09-24,6380
2233,宇隆,11,0,11,光和,2024-09-24,6380
0056,元大高股息,11,0,11,光和,2024-09-24,6380
00954,中信日本半導體,10,0,10,光和,2024-09-24,6380
00706L,期元大S＆P日圓正2,10,0,10,光和,2024-09-24,6380
2062,橋椿,18,8,10,光和,2024-09-24,6380
2312,金寶,10,0,10,光和,2024-09-24,6380
2337,旺宏,10,0,10,光和,2024-09-24,6380
2505,國揚,10,0,10,光和,2024-09-24,6380
2605,新興,15,5,10,光和,2024-09-24,6380
6127,九豪,10,0,10,光和,2024-09-24,6380
8064,東捷,11,1,10,光和,2024-09-24,6380
3481,群創,17,7,10,光和,2024-09-24,6380
2891,中信金,12,2,10,光和,2024-09-24,6380
3037,欣興,8,0,8,光和,2024-09-24,6380
2388,威盛,14,6,8,光和,2024-09-24,6380
1727,中華化,19,11,8,光和,2024-09-24,6380
2460,建通,8,0,8,光和,2024-09-24,6380
2883,凱基金,15,7,8,光和,2024-09-24,6380
3605,宏致,9,1,8,光和,2024-09-24,6380
6290,良維,10,2,8,光和,2024-09-24,6380
2409,友達,10,3,7,光和,2024-09-24,6380
3049,精金,7,0,7,光和,2024-09-24,6380
3673,TPK-KY,10,3,7,光和,2024-09-24,6380
00632R,元大台灣50反1,506,0,506,光和,2024-09-25,6380
2888,新光金,289,21,268,光和,2024-09-25,6380
2317,鴻海,276,117,159,光和,2024-09-25,6380
00687B,國泰20年美債,133,0,133,光和,2024-09-25,6380
3481,群創,77,3,74,光和,2024-09-25,6380
9105,泰金寶-DR,83,10,73,光和,2024-09-25,6380
2106,建大,65,0,65,光和,2024-09-25,6380
00887,永豐中國科技50大,30,0,30,光和,2024-09-25,6380
2913,農林,30,0,30,光和,2024-09-25,6380
3550,聯穎,47,21,26,光和,2024-09-25,6380
2891,中信金,25,0,25,光和,2024-09-25,6380
2388,威盛,28,3,25,光和,2024-09-25,6380
2349,錸德,36,12,24,光和,2024-09-25,6380
2399,映泰,32,9,23,光和,2024-09-25,6380
00679B,元大美債20年,22,0,22,光和,2024-09-25,6380
00650L,復華香港正2,21,0,21,光和,2024-09-25,6380
1584,精剛,21,0,21,光和,2024-09-25,6380
00676R,富邦臺灣加權反1,20,0,20,光和,2024-09-25,6380
2537,聯上發,20,0,20,光和,2024-09-25,6380
3105,穩懋,19,0,19,光和,2024-09-25,6380
00933B,國泰10Y+金融債,18,0,18,光和,2024-09-25,6380
3050,鈺德,15,0,15,光和,2024-09-25,6380
3661,世芯-KY,17,3,14,光和,2024-09-25,6380
2613,中櫃,13,1,12,光和,2024-09-25,6380
00937B,群益ESG投等債20,11,0,11,光和,2024-09-25,6380
3581,博磊,17,6,11,光和,2024-09-25,6380
3066,李洲,13,2,11,光和,2024-09-25,6380
00664R,國泰臺灣加權反1,10,0,10,光和,2024-09-25,6380
00960,野村全球航運龍頭,10,0,10,光和,2024-09-25,6380
1522,堤維西,10,0,10,光和,2024-09-25,6380
1709,和益,10,0,10,光和,2024-09-25,6380
2472,立隆電,10,0,10,光和,2024-09-25,6380
4563,百德,10,0,10,光和,2024-09-25,6380
4711,永純,10,0,10,光和,2024-09-25,6380
5371,中光電,10,0,10,光和,2024-09-25,6380
3588,通嘉,10,0,10,光和,2024-09-25,6380
1477,聚陽,9,0,9,光和,2024-09-25,6380
2883,凱基金,10,1,9,光和,2024-09-25,6380
3049,精金,12,3,9,光和,2024-09-25,6380
4526,東台,16,8,8,光和,2024-09-25,6380
00637L,元大滬深300正2,50,42,8,光和,2024-09-25,6380
2495,普安,11,3,8,光和,2024-09-25,6380
3272,東碩,11,3,8,光和,2024-09-25,6380
4534,慶騰,10,2,8,光和,2024-09-25,6380
1524,耿鼎,9,1,8,光和,2024-09-25,6380
2062,橋椿,7,0,7,光和,2024-09-25,6380
00713,元大台灣高息低波,7,0,7,光和,2024-09-25,6380
2542,興富發,8,1,7,光和,2024-09-25,6380
3021,鴻名,7,0,7,光和,2024-09-25,6380
5272,笙科,8,1,7,光和,2024-09-25,6380
00632R,元大台灣50反1,387,0,387,光和,2024-09-26,6380
2317,鴻海,112,16,96,光和,2024-09-26,6380
00937B,群益ESG投等債20,87,13,74,光和,2024-09-26,6380
2365,昆盈,75,12,63,光和,2024-09-26,6380
00680L,元大美債20正2,56,0,56,光和,2024-09-26,6380
00687B,國泰20年美債,57,2,55,光和,2024-09-26,6380
1314,中石化,62,10,52,光和,2024-09-26,6380
2312,金寶,33,0,33,光和,2024-09-26,6380
00948B,中信優息投資級債,30,0,30,光和,2024-09-26,6380
4526,東台,30,0,30,光和,2024-09-26,6380
2609,陽明,114,85,29,光和,2024-09-26,6380
2801,彰銀,28,2,26,光和,2024-09-26,6380
2408,南亞科,32,7,25,光和,2024-09-26,6380
4123,晟德,31,6,25,光和,2024-09-26,6380
00688L,國泰20年美債正2,23,0,23,光和,2024-09-26,6380
3019,亞光,41,18,23,光和,2024-09-26,6380
3050,鈺德,22,0,22,光和,2024-09-26,6380
1540,喬福,22,1,21,光和,2024-09-26,6380
2344,華邦電,41,20,21,光和,2024-09-26,6380
6182,合晶,20,0,20,光和,2024-09-26,6380
2062,橋椿,29,12,17,光和,2024-09-26,6380
6589,台康生技,17,0,17,光和,2024-09-26,6380
1711,永光,21,5,16,光和,2024-09-26,6380
00947,台新臺灣IC設計,15,0,15,光和,2024-09-26,6380
2349,錸德,20,5,15,光和,2024-09-26,6380
2497,怡利電,17,3,14,光和,2024-09-26,6380
3272,東碩,15,1,14,光和,2024-09-26,6380
1536,和大,13,0,13,光和,2024-09-26,6380
8039,台虹,18,5,13,光和,2024-09-26,6380
8070,長華*,33,21,12,光和,2024-09-26,6380
00877,復華中國5G,12,0,12,光和,2024-09-26,6380
2481,強茂,12,0,12,光和,2024-09-26,6380
3605,宏致,16,4,12,光和,2024-09-26,6380
4716,大立,29,17,12,光和,2024-09-26,6380
2515,中工,12,0,12,光和,2024-09-26,6380
3673,TPK-KY,15,4,11,光和,2024-09-26,6380
00881,國泰台灣5G+,10,0,10,光和,2024-09-26,6380
00756B,群益投等新興公債,10,0,10,光和,2024-09-26,6380
00725B,國泰投資級公司債,10,0,10,光和,2024-09-26,6380
1539,巨庭,10,0,10,光和,2024-09-26,6380
2613,中櫃,32,22,10,光和,2024-09-26,6380
5498,凱崴,10,0,10,光和,2024-09-26,6380
8103,瀚荃,10,0,10,光和,2024-09-26,6380
1795,美時,9,0,9,光和,2024-09-26,6380
3149,正達,16,7,9,光和,2024-09-26,6380
4561,健椿,10,1,9,光和,2024-09-26,6380
6188,廣明,15,6,9,光和,2024-09-26,6380
8110,華東,11,2,9,光和,2024-09-26,6380
6125,廣運,9,1,8,光和,2024-09-26,6380
1477,聚陽,8,0,8,光和,2024-09-26,6380
2344,華邦電,245,8,237,光和,2024-09-27,6380
2406,國碩,131,2,129,光和,2024-09-27,6380
00687B,國泰20年美債,92,0,92,光和,2024-09-27,6380
00919,群益台灣精選高息,68,9,59,光和,2024-09-27,6380
2801,彰銀,57,1,56,光和,2024-09-27,6380
00948B,中信優息投資級債,45,0,45,光和,2024-09-27,6380
2867,三商壽,48,3,45,光和,2024-09-27,6380
3019,亞光,45,4,41,光和,2024-09-27,6380
00934,中信成長高股息,37,0,37,光和,2024-09-27,6380
2399,映泰,36,2,34,光和,2024-09-27,6380
3149,正達,38,9,29,光和,2024-09-27,6380
00680L,元大美債20正2,22,0,22,光和,2024-09-27,6380
00715L,期街口布蘭特正2,20,0,20,光和,2024-09-27,6380
00706L,期元大S＆P日圓正2,20,0,20,光和,2024-09-27,6380
1540,喬福,20,0,20,光和,2024-09-27,6380
2023,燁輝,21,2,19,光和,2024-09-27,6380
00918,大華優利高填息30,20,1,19,光和,2024-09-27,6380
2882,國泰金,20,5,15,光和,2024-09-27,6380
00664R,國泰臺灣加權反1,15,0,15,光和,2024-09-27,6380
2367,燿華,15,1,14,光和,2024-09-27,6380
4903,聯光通,19,5,14,光和,2024-09-27,6380
2891,中信金,18,5,13,光和,2024-09-27,6380
00940,元大台灣價值高息,21,8,13,光和,2024-09-27,6380
00960,野村全球航運龍頭,13,0,13,光和,2024-09-27,6380
3041,揚智,14,1,13,光和,2024-09-27,6380
3530,晶相光,13,0,13,光和,2024-09-27,6380
3189,景碩,21,8,13,光和,2024-09-27,6380
00725B,國泰投資級公司債,12,0,12,光和,2024-09-27,6380
2641,正德,12,0,12,光和,2024-09-27,6380
00712,復華富時不動產,11,0,11,光和,2024-09-27,6380
3715,定穎投控,21,10,11,光和,2024-09-27,6380
4958,臻鼎-KY,12,1,11,光和,2024-09-27,6380
6152,百一,16,5,11,光和,2024-09-27,6380
2881,富邦金,12,1,11,光和,2024-09-27,6380
00671R,富邦NASDAQ反1,20,10,10,光和,2024-09-27,6380
6005,群益證,10,0,10,光和,2024-09-27,6380
6573,虹揚-KY,10,0,10,光和,2024-09-27,6380
6589,台康生技,10,0,10,光和,2024-09-27,6380
00756B,群益投等新興公債,9,0,9,光和,2024-09-27,6380
2419,仲琦,13,5,8,光和,2024-09-27,6380
3257,虹冠電,11,3,8,光和,2024-09-27,6380
4952,凌通,10,2,8,光和,2024-09-27,6380
4979,華星光,17,9,8,光和,2024-09-27,6380
00642U,期元大S＆P石油,7,0,7,光和,2024-09-27,6380
3025,星通,7,0,7,光和,2024-09-27,6380
8054,安國,7,0,7,光和,2024-09-27,6380
2388,威盛,9,3,6,光和,2024-09-27,6380
00931B,統一美債20年,6,0,6,光和,2024-09-27,6380
00951,台新日本半導體,6,0,6,光和,2024-09-27,6380
1808,潤隆,6,0,6,光和,2024-09-27,6380
00669R,國泰美國道瓊反1,300,0,300,光和,2024-09-30,6380
00687B,國泰20年美債,167,0,167,光和,2024-09-30,6380
4123,晟德,147,0,147,光和,2024-09-30,6380
00960,野村全球航運龍頭,140,14,126,光和,2024-09-30,6380
00720B,元大投資級公司債,100,2,98,光和,2024-09-30,6380
00919,群益台灣精選高息,90,0,90,光和,2024-09-30,6380
2317,鴻海,84,8,76,光和,2024-09-30,6380
00940,元大台灣價值高息,72,0,72,光和,2024-09-30,6380
0056,元大高股息,65,1,64,光和,2024-09-30,6380
00929,復華台灣科技優息,74,10,64,光和,2024-09-30,6380
00712,復華富時不動產,48,0,48,光和,2024-09-30,6380
4526,東台,41,0,41,光和,2024-09-30,6380
00679B,元大美債20年,39,0,39,光和,2024-09-30,6380
4956,光鋐,36,0,36,光和,2024-09-30,6380
00948B,中信優息投資級債,34,0,34,光和,2024-09-30,6380
6257,矽格,34,4,30,光和,2024-09-30,6380
2913,農林,30,0,30,光和,2024-09-30,6380
00878,國泰永續高股息,28,1,27,光和,2024-09-30,6380
00680L,元大美債20正2,24,0,24,光和,2024-09-30,6380
00665L,富邦�琤肭磪囓�2,72,50,22,光和,2024-09-30,6380
2891,中信金,22,2,20,光和,2024-09-30,6380
1584,精剛,21,1,20,光和,2024-09-30,6380
3622,洋華,21,1,20,光和,2024-09-30,6380
2615,萬海,42,22,20,光和,2024-09-30,6380
00918,大華優利高填息30,18,0,18,光和,2024-09-30,6380
2905,三商,17,0,17,光和,2024-09-30,6380
3062,建漢,18,2,16,光和,2024-09-30,6380
4711,永純,22,6,16,光和,2024-09-30,6380
2731,雄獅,15,0,15,光和,2024-09-30,6380
2489,瑞軒,16,3,13,光和,2024-09-30,6380
3499,環天科,13,0,13,光和,2024-09-30,6380
00907,永豐優息存股,12,0,12,光和,2024-09-30,6380
00945B,凱基美國非投等債,12,0,12,光和,2024-09-30,6380
2330,台積電,22,10,12,光和,2024-09-30,6380
3037,欣興,10,0,10,光和,2024-09-30,6380
00939,統一台灣高息動能,10,0,10,光和,2024-09-30,6380
6505,台塑化,12,2,10,光和,2024-09-30,6380
2605,新興,28,18,10,光和,2024-09-30,6380
2897B,王道銀乙特,10,0,10,光和,2024-09-30,6380
4960,誠美材,10,0,10,光和,2024-09-30,6380
6182,合晶,10,0,10,光和,2024-09-30,6380
6207,雷科,10,0,10,光和,2024-09-30,6380
2603,長榮,11,1,10,光和,2024-09-30,6380
2243,宏旭-KY,13,4,9,光和,2024-09-30,6380
2408,南亞科,11,2,9,光和,2024-09-30,6380
5340,建榮,9,0,9,光和,2024-09-30,6380
2464,盟立,11,3,8,光和,2024-09-30,6380
2353,宏��,8,0,8,光和,2024-09-30,6380
3056,富華新,8,0,8,光和,2024-09-30,6380
4906,正文,8,0,8,光和,2024-09-30,6380
00753L,中信中國50正2,367,24,343,光和,2024-10-01,6380
2615,萬海,273,36,237,光和,2024-10-01,6380
00706L,期元大S＆P日圓正2,200,0,200,光和,2024-10-01,6380
2801,彰銀,158,0,158,光和,2024-10-01,6380
00937B,群益ESG投等債20,115,11,104,光和,2024-10-01,6380
2836,高雄銀,100,0,100,光和,2024-10-01,6380
9907,統一實,85,5,80,光和,2024-10-01,6380
00687B,國泰20年美債,75,0,75,光和,2024-10-01,6380
00929,復華台灣科技優息,54,0,54,光和,2024-10-01,6380
00679B,元大美債20年,48,1,47,光和,2024-10-01,6380
2609,陽明,67,23,44,光和,2024-10-01,6380
2812,台中銀,36,0,36,光和,2024-10-01,6380
00680L,元大美債20正2,31,0,31,光和,2024-10-01,6380
3661,世芯-KY,27,2,25,光和,2024-10-01,6380
00878,國泰永續高股息,24,0,24,光和,2024-10-01,6380
0056,元大高股息,26,5,21,光和,2024-10-01,6380
2537,聯上發,20,0,20,光和,2024-10-01,6380
2317,鴻海,19,0,19,光和,2024-10-01,6380
00935,野村臺灣新科技50,20,1,19,光和,2024-10-01,6380
6505,台塑化,24,6,18,光和,2024-10-01,6380
2455,全新,24,7,17,光和,2024-10-01,6380
2392,正崴,18,1,17,光和,2024-10-01,6380
00922,國泰台灣領袖50,17,0,17,光和,2024-10-01,6380
00882,中信中國高股息,40,24,16,光和,2024-10-01,6380
2382,廣達,21,6,15,光和,2024-10-01,6380
4306,炎洲,15,0,15,光和,2024-10-01,6380
2330,台積電,19,4,15,光和,2024-10-01,6380
4526,東台,127,113,14,光和,2024-10-01,6380
3550,聯穎,14,0,14,光和,2024-10-01,6380
3443,創意,12,0,12,光和,2024-10-01,6380
2731,雄獅,12,0,12,光和,2024-10-01,6380
3622,洋華,12,0,12,光和,2024-10-01,6380
2233,宇隆,12,0,12,光和,2024-10-01,6380
3591,艾笛森,11,0,11,光和,2024-10-01,6380
5340,建榮,11,0,11,光和,2024-10-01,6380
00713,元大台灣高息低波,10,0,10,光和,2024-10-01,6380
1904,正隆,12,2,10,光和,2024-10-01,6380
00936,台新永續高息中小,10,0,10,光和,2024-10-01,6380
00927,群益半導體收益,10,0,10,光和,2024-10-01,6380
1528,恩德,10,0,10,光和,2024-10-01,6380
1563,巧新,10,0,10,光和,2024-10-01,6380
1609,大亞,10,0,10,光和,2024-10-01,6380
2436,偉詮電,16,6,10,光和,2024-10-01,6380
2820,華票,10,0,10,光和,2024-10-01,6380
6667,信紘科,10,0,10,光和,2024-10-01,6380
2913,農林,10,0,10,光和,2024-10-01,6380
3149,正達,11,2,9,光和,2024-10-01,6380
00636,國泰中國A50,8,0,8,光和,2024-10-01,6380
1540,喬福,13,5,8,光和,2024-10-01,6380
2612,中航,8,0,8,光和,2024-10-01,6380
2609,陽明,775,33,742,光和,2024-10-04,6380
00940,元大台灣價值高息,674,0,674,光和,2024-10-04,6380
2820,華票,236,0,236,光和,2024-10-04,6380
2615,萬海,244,10,234,光和,2024-10-04,6380
2603,長榮,161,14,147,光和,2024-10-04,6380
00929,復華台灣科技優息,85,1,84,光和,2024-10-04,6380
2801,彰銀,60,0,60,光和,2024-10-04,6380
2303,聯電,57,0,57,光和,2024-10-04,6380
00919,群益台灣精選高息,89,35,54,光和,2024-10-04,6380
2610,華航,51,0,51,光和,2024-10-04,6380
0056,元大高股息,59,8,51,光和,2024-10-04,6380
00712,復華富時不動產,50,0,50,光和,2024-10-04,6380
2618,長榮航,48,1,47,光和,2024-10-04,6380
00687B,國泰20年美債,54,10,44,光和,2024-10-04,6380
00680L,元大美債20正2,44,0,44,光和,2024-10-04,6380
2062,橋椿,52,9,43,光和,2024-10-04,6380
00960,野村全球航運龍頭,33,0,33,光和,2024-10-04,6380
4526,東台,157,126,31,光和,2024-10-04,6380
00673R,期元大S＆P原油反1,30,0,30,光和,2024-10-04,6380
00679B,元大美債20年,27,0,27,光和,2024-10-04,6380
00937B,群益ESG投等債20,44,20,24,光和,2024-10-04,6380
8064,東捷,24,0,24,光和,2024-10-04,6380
2731,雄獅,23,0,23,光和,2024-10-04,6380
9921,巨大,23,0,23,光和,2024-10-04,6380
2605,新興,27,5,22,光和,2024-10-04,6380
00922,國泰台灣領袖50,21,0,21,光和,2024-10-04,6380
1618,合機,21,0,21,光和,2024-10-04,6380
00706L,期元大S＆P日圓正2,20,0,20,光和,2024-10-04,6380
2537,聯上發,20,0,20,光和,2024-10-04,6380
4711,永純,20,0,20,光和,2024-10-04,6380
8105,凌巨,20,0,20,光和,2024-10-04,6380
2108,南帝,18,0,18,光和,2024-10-04,6380
8039,台虹,24,6,18,光和,2024-10-04,6380
2867,三商壽,17,0,17,光和,2024-10-04,6380
5347,世界,17,0,17,光和,2024-10-04,6380
2887,台新金,16,0,16,光和,2024-10-04,6380
00946,群益科技高息成長,15,0,15,光和,2024-10-04,6380
2836,高雄銀,15,0,15,光和,2024-10-04,6380
2538,基泰,14,0,14,光和,2024-10-04,6380
3443,創意,14,0,14,光和,2024-10-04,6380
5392,能率,14,0,14,光和,2024-10-04,6380
00878,國泰永續高股息,17,4,13,光和,2024-10-04,6380
2515,中工,12,0,12,光和,2024-10-04,6380
8249,菱光,12,0,12,光和,2024-10-04,6380
1101,台泥,11,0,11,光和,2024-10-04,6380
1815,富喬,11,0,11,光和,2024-10-04,6380
6152,百一,11,0,11,光和,2024-10-04,6380
3663,鑫科,11,0,11,光和,2024-10-04,6380
1785,光洋科,21,10,11,光和,2024-10-04,6380
2353,宏��,11,0,11,光和,2024-10-04,6380
00665L,富邦�琤肭磪囓�2,483,58,425,光和,2024-10-07,6380
00632R,元大台灣50反1,266,0,266,光和,2024-10-07,6380
00712,復華富時不動產,116,0,116,光和,2024-10-07,6380
1314,中石化,146,46,100,光和,2024-10-07,6380
2356,英業達,117,22,95,光和,2024-10-07,6380
8249,菱光,160,67,93,光和,2024-10-07,6380
00679B,元大美債20年,65,5,60,光和,2024-10-07,6380
00687B,國泰20年美債,61,1,60,光和,2024-10-07,6380
00706L,期元大S＆P日圓正2,58,0,58,光和,2024-10-07,6380
00919,群益台灣精選高息,79,30,49,光和,2024-10-07,6380
2812,台中銀,45,1,44,光和,2024-10-07,6380
5864,致和證,35,0,35,光和,2024-10-07,6380
5438,東友,35,0,35,光和,2024-10-07,6380
6669,緯穎,33,0,33,光和,2024-10-07,6380
2601,益航,40,7,33,光和,2024-10-07,6380
00655L,國泰中國A50正2,30,0,30,光和,2024-10-07,6380
4523,永彰,36,6,30,光和,2024-10-07,6380
8011,台通,30,1,29,光和,2024-10-07,6380
2317,鴻海,53,25,28,光和,2024-10-07,6380
2515,中工,36,9,27,光和,2024-10-07,6380
00753L,中信中國50正2,29,4,25,光和,2024-10-07,6380
2408,南亞科,21,1,20,光和,2024-10-07,6380
00680L,元大美債20正2,30,10,20,光和,2024-10-07,6380
0061,元大寶滬深,20,0,20,光和,2024-10-07,6380
00650L,復華香港正2,20,0,20,光和,2024-10-07,6380
2303,聯電,22,2,20,光和,2024-10-07,6380
2313,華通,23,3,20,光和,2024-10-07,6380
2344,華邦電,19,1,18,光和,2024-10-07,6380
1711,永光,18,1,17,光和,2024-10-07,6380
8043,蜜望實,15,0,15,光和,2024-10-07,6380
2801,彰銀,15,0,15,光和,2024-10-07,6380
2399,映泰,17,3,14,光和,2024-10-07,6380
6218,豪勉,15,2,13,光和,2024-10-07,6380
8105,凌巨,13,0,13,光和,2024-10-07,6380
2062,橋椿,20,8,12,光和,2024-10-07,6380
2613,中櫃,12,0,12,光和,2024-10-07,6380
2820,華票,12,0,12,光和,2024-10-07,6380
3715,定穎投控,20,8,12,光和,2024-10-07,6380
8097,常珵,12,0,12,光和,2024-10-07,6380
00887,永豐中國科技50大,13,2,11,光和,2024-10-07,6380
6274,台燿,10,0,10,光和,2024-10-07,6380
00651R,復華香港反1,10,0,10,光和,2024-10-07,6380
00943,兆豐電子高息等權,10,0,10,光和,2024-10-07,6380
1733,五鼎,10,0,10,光和,2024-10-07,6380
2641,正德,20,10,10,光和,2024-10-07,6380
6875,國邑*,10,1,9,光和,2024-10-07,6380
6188,廣明,12,3,9,光和,2024-10-07,6380
00636,國泰中國A50,8,0,8,光和,2024-10-07,6380
2486,一詮,14,6,8,光和,2024-10-07,6380
2929,淘帝-KY,61,53,8,光和,2024-10-07,6380
2609,陽明,271,6,265,光和,2024-10-08,6380
00679B,元大美債20年,122,0,122,光和,2024-10-08,6380
1742,台蠟,100,0,100,光和,2024-10-08,6380
00753L,中信中國50正2,275,194,81,光和,2024-10-08,6380
00673R,期元大S＆P原油反1,60,0,60,光和,2024-10-08,6380
00665L,富邦�琤肭磪囓�2,64,8,56,光和,2024-10-08,6380
0056,元大高股息,47,0,47,光和,2024-10-08,6380
00919,群益台灣精選高息,47,0,47,光和,2024-10-08,6380
2801,彰銀,77,30,47,光和,2024-10-08,6380
00929,復華台灣科技優息,47,1,46,光和,2024-10-08,6380
00712,復華富時不動產,41,0,41,光和,2024-10-08,6380
00680L,元大美債20正2,40,0,40,光和,2024-10-08,6380
00687B,國泰20年美債,34,0,34,光和,2024-10-08,6380
2101,南港,32,0,32,光和,2024-10-08,6380
2489,瑞軒,32,2,30,光和,2024-10-08,6380
2408,南亞科,30,1,29,光和,2024-10-08,6380
2108,南帝,28,0,28,光和,2024-10-08,6380
00937B,群益ESG投等債20,46,20,26,光和,2024-10-08,6380
4711,永純,24,0,24,光和,2024-10-08,6380
00939,統一台灣高息動能,22,0,22,光和,2024-10-08,6380
00756B,群益投等新興公債,22,0,22,光和,2024-10-08,6380
1721,三晃,22,0,22,光和,2024-10-08,6380
00878,國泰永續高股息,27,6,21,光和,2024-10-08,6380
2007,燁興,21,0,21,光和,2024-10-08,6380
2353,宏��,20,0,20,光和,2024-10-08,6380
2836,高雄銀,20,0,20,光和,2024-10-08,6380
3050,鈺德,20,0,20,光和,2024-10-08,6380
6136,富爾特,20,0,20,光和,2024-10-08,6380
1304,台聚,19,0,19,光和,2024-10-08,6380
1815,富喬,33,14,19,光和,2024-10-08,6380
6415,矽力*-KY,21,3,18,光和,2024-10-08,6380
2014,中鴻,24,7,17,光和,2024-10-08,6380
3481,群創,17,0,17,光和,2024-10-08,6380
3591,艾笛森,16,0,16,光和,2024-10-08,6380
2615,萬海,42,26,16,光和,2024-10-08,6380
00922,國泰台灣領袖50,15,0,15,光和,2024-10-08,6380
00725B,國泰投資級公司債,15,0,15,光和,2024-10-08,6380
2356,英業達,160,145,15,光和,2024-10-08,6380
2809,京城銀,15,0,15,光和,2024-10-08,6380
6269,台郡,14,0,14,光和,2024-10-08,6380
2062,橋椿,26,12,14,光和,2024-10-08,6380
3037,欣興,13,0,13,光和,2024-10-08,6380
1609,大亞,13,0,13,光和,2024-10-08,6380
5225,東科-KY,13,0,13,光和,2024-10-08,6380
2467,志聖,13,1,12,光和,2024-10-08,6380
1727,中華化,33,21,12,光和,2024-10-08,6380
5230,雷笛克光學,12,0,12,光和,2024-10-08,6380
2363,矽統,48,38,10,光和,2024-10-08,6380
1722,台肥,10,0,10,光和,2024-10-08,6380
2613,中櫃,10,0,10,光和,2024-10-08,6380
00753L,中信中國50正2,635,84,551,光和,2024-10-09,6380
00665L,富邦�琤肭磪囓�2,267,40,227,光和,2024-10-09,6380
2615,萬海,209,10,199,光和,2024-10-09,6380
00632R,元大台灣50反1,152,0,152,光和,2024-10-09,6380
2603,長榮,166,18,148,光和,2024-10-09,6380
00937B,群益ESG投等債20,131,1,130,光和,2024-10-09,6380
2340,台亞,82,0,82,光和,2024-10-09,6380
2609,陽明,88,17,71,光和,2024-10-09,6380
1314,中石化,84,22,62,光和,2024-10-09,6380
2401,凌陽,61,0,61,光和,2024-10-09,6380
1618,合機,52,0,52,光和,2024-10-09,6380
00940,元大台灣價值高息,50,0,50,光和,2024-10-09,6380
2601,益航,52,6,46,光和,2024-10-09,6380
0056,元大高股息,41,6,35,光和,2024-10-09,6380
5347,世界,35,1,34,光和,2024-10-09,6380
2014,中鴻,32,5,27,光和,2024-10-09,6380
1718,中纖,27,0,27,光和,2024-10-09,6380
2367,燿華,27,0,27,光和,2024-10-09,6380
00887,永豐中國科技50大,42,16,26,光和,2024-10-09,6380
00637L,元大滬深300正2,51,25,26,光和,2024-10-09,6380
1710,東聯,26,0,26,光和,2024-10-09,6380
3622,洋華,37,12,25,光和,2024-10-09,6380
00639,富邦深100,29,5,24,光和,2024-10-09,6380
3511,矽瑪,37,13,24,光和,2024-10-09,6380
1605,華新,29,6,23,光和,2024-10-09,6380
2409,友達,22,0,22,光和,2024-10-09,6380
00919,群益台灣精選高息,22,1,21,光和,2024-10-09,6380
4564,元翎,25,4,21,光和,2024-10-09,6380
1721,三晃,20,0,20,光和,2024-10-09,6380
2408,南亞科,21,1,20,光和,2024-10-09,6380
2062,橋椿,50,32,18,光和,2024-10-09,6380
2605,新興,21,3,18,光和,2024-10-09,6380
1316,上曜,17,0,17,光和,2024-10-09,6380
2399,映泰,60,43,17,光和,2024-10-09,6380
2402,毅嘉,21,4,17,光和,2024-10-09,6380
2515,中工,16,0,16,光和,2024-10-09,6380
1742,台蠟,15,0,15,光和,2024-10-09,6380
5880,合庫金,15,0,15,光和,2024-10-09,6380
00687B,國泰20年美債,14,0,14,光和,2024-10-09,6380
3049,精金,20,6,14,光和,2024-10-09,6380
2892,第一金,13,0,13,光和,2024-10-09,6380
2374,佳能,13,0,13,光和,2024-10-09,6380
1727,中華化,18,5,13,光和,2024-10-09,6380
3715,定穎投控,16,3,13,光和,2024-10-09,6380
6530,創威,27,14,13,光和,2024-10-09,6380
2002,中鋼,17,4,13,光和,2024-10-09,6380
3284,太普高,13,1,12,光和,2024-10-09,6380
6770,力積電,13,2,11,光和,2024-10-09,6380
00943,兆豐電子高息等權,11,0,11,光和,2024-10-09,6380
1301,台塑,11,0,11,光和,2024-10-09,6380
2615,萬海,215,4,211,光和,2024-10-11,6380
2609,陽明,203,2,201,光和,2024-10-11,6380
00655L,國泰中國A50正2,200,0,200,光和,2024-10-11,6380
00637L,元大滬深300正2,361,180,181,光和,2024-10-11,6380
2812,台中銀,181,0,181,光和,2024-10-11,6380
00937B,群益ESG投等債20,125,1,124,光和,2024-10-11,6380
3481,群創,113,2,111,光和,2024-10-11,6380
2105,正新,113,3,110,光和,2024-10-11,6380
2027,大成鋼,107,0,107,光和,2024-10-11,6380
2883,凱基金,109,27,82,光和,2024-10-11,6380
00753L,中信中國50正2,61,2,59,光和,2024-10-11,6380
00639,富邦深100,46,0,46,光和,2024-10-11,6380
3591,艾笛森,46,2,44,光和,2024-10-11,6380
1314,中石化,35,2,33,光和,2024-10-11,6380
1104,環泥,30,1,29,光和,2024-10-11,6380
1742,台蠟,28,0,28,光和,2024-10-11,6380
1711,永光,29,7,22,光和,2024-10-11,6380
00680L,元大美債20正2,21,0,21,光和,2024-10-11,6380
2887,台新金,20,0,20,光和,2024-10-11,6380
2630,亞航,19,0,19,光和,2024-10-11,6380
3511,矽瑪,20,2,18,光和,2024-10-11,6380
00882,中信中國高股息,21,4,17,光和,2024-10-11,6380
2363,矽統,30,13,17,光和,2024-10-11,6380
8043,蜜望實,17,0,17,光和,2024-10-11,6380
3033,威健,18,2,16,光和,2024-10-11,6380
3011,今皓,15,0,15,光和,2024-10-11,6380
4551,智伸科,15,1,14,光和,2024-10-11,6380
6152,百一,15,1,14,光和,2024-10-11,6380
9904,寶成,14,0,14,光和,2024-10-11,6380
00673R,期元大S＆P原油反1,12,0,12,光和,2024-10-11,6380
1527,鑽全,12,0,12,光和,2024-10-11,6380
2408,南亞科,12,0,12,光和,2024-10-11,6380
3047,訊舟,13,1,12,光和,2024-10-11,6380
2344,華邦電,14,2,12,光和,2024-10-11,6380
8111,立��,17,6,11,光和,2024-10-11,6380
8358,金居,11,0,11,光和,2024-10-11,6380
1802,台玻,14,4,10,光和,2024-10-11,6380
2109,華豐,10,0,10,光和,2024-10-11,6380
2472,立隆電,10,0,10,光和,2024-10-11,6380
2481,強茂,10,0,10,光和,2024-10-11,6380
2537,聯上發,10,0,10,光和,2024-10-11,6380
2809,京城銀,10,0,10,光和,2024-10-11,6380
4563,百德,12,2,10,光和,2024-10-11,6380
5484,慧友,10,0,10,光和,2024-10-11,6380
6112,邁達特,10,0,10,光和,2024-10-11,6380
8064,東捷,10,0,10,光和,2024-10-11,6380
00915,凱基優選高股息30,18,8,10,光和,2024-10-11,6380
1609,大亞,10,1,9,光和,2024-10-11,6380
2392,正崴,10,1,9,光和,2024-10-11,6380
3234,光環,12,3,9,光和,2024-10-11,6380
2615,萬海,182,4,178,光和,2024-10-14,6380
1721,三晃,70,1,69,光和,2024-10-14,6380
2611,志信,50,0,50,光和,2024-10-14,6380
00665L,富邦�琤肭磪囓�2,52,5,47,光和,2024-10-14,6380
2312,金寶,102,57,45,光和,2024-10-14,6380
00679B,元大美債20年,36,0,36,光和,2024-10-14,6380
00887,永豐中國科技50大,36,0,36,光和,2024-10-14,6380
00882,中信中國高股息,35,1,34,光和,2024-10-14,6380
2887,台新金,28,0,28,光和,2024-10-14,6380
6869,雲豹能源,27,1,26,光和,2024-10-14,6380
00919,群益台灣精選高息,28,2,26,光和,2024-10-14,6380
2892,第一金,24,0,24,光和,2024-10-14,6380
1312,國喬,23,0,23,光和,2024-10-14,6380
1314,中石化,22,0,22,光和,2024-10-14,6380
6156,松上,23,1,22,光和,2024-10-14,6380
2520,冠德,21,1,20,光和,2024-10-14,6380
3580,友威科,20,0,20,光和,2024-10-14,6380
00878,國泰永續高股息,20,3,17,光和,2024-10-14,6380
1785,光洋科,19,3,16,光和,2024-10-14,6380
8011,台通,21,6,15,光和,2024-10-14,6380
4903,聯光通,16,1,15,光和,2024-10-14,6380
00877,復華中國5G,15,2,13,光和,2024-10-14,6380
2867,三商壽,16,3,13,光和,2024-10-14,6380
3066,李洲,14,1,13,光和,2024-10-14,6380
00960,野村全球航運龍頭,12,0,12,光和,2024-10-14,6380
1569,濱川,17,5,12,光和,2024-10-14,6380
2356,英業達,17,5,12,光和,2024-10-14,6380
3661,世芯-KY,12,0,12,光和,2024-10-14,6380
00915,凱基優選高股息30,11,0,11,光和,2024-10-14,6380
0056,元大高股息,24,13,11,光和,2024-10-14,6380
00632R,元大台灣50反1,11,0,11,光和,2024-10-14,6380
1570,力肯,11,0,11,光和,2024-10-14,6380
2630,亞航,11,0,11,光和,2024-10-14,6380
3234,光環,14,3,11,光和,2024-10-14,6380
1727,中華化,18,8,10,光和,2024-10-14,6380
00706L,期元大S＆P日圓正2,10,0,10,光和,2024-10-14,6380
2014,中鴻,13,3,10,光和,2024-10-14,6380
2303,聯電,10,0,10,光和,2024-10-14,6380
2537,聯上發,10,0,10,光和,2024-10-14,6380
2812,台中銀,10,0,10,光和,2024-10-14,6380
3591,艾笛森,11,1,10,光和,2024-10-14,6380
4566,時碩工業,11,1,10,光和,2024-10-14,6380
6967,汎瑋材料,10,0,10,光和,2024-10-14,6380
2618,長榮航,9,0,9,光和,2024-10-14,6380
5234,達興材料,9,0,9,光和,2024-10-14,6380
6139,亞翔,9,0,9,光和,2024-10-14,6380
2243,宏旭-KY,8,0,8,光和,2024-10-14,6380
2344,華邦電,13,5,8,光和,2024-10-14,6380
00756B,群益投等新興公債,7,0,7,光和,2024-10-14,6380
2497,怡利電,6,0,6,光和,2024-10-14,6380
00753L,中信中國50正2,292,0,292,光和,2024-10-15,6380
2615,萬海,220,10,210,光和,2024-10-15,6380
2105,正新,151,0,151,光和,2024-10-15,6380
00665L,富邦�琤肭磪囓�2,115,0,115,光和,2024-10-15,6380
00637L,元大滬深300正2,273,180,93,光和,2024-10-15,6380
0056,元大高股息,113,21,92,光和,2024-10-15,6380
3230,錦明,70,0,70,光和,2024-10-15,6380
1314,中石化,105,45,60,光和,2024-10-15,6380
00632R,元大台灣50反1,49,0,49,光和,2024-10-15,6380
5225,東科-KY,47,1,46,光和,2024-10-15,6380
2417,圓剛,40,0,40,光和,2024-10-15,6380
00887,永豐中國科技50大,37,0,37,光和,2024-10-15,6380
2106,建大,36,1,35,光和,2024-10-15,6380
2399,映泰,44,12,32,光和,2024-10-15,6380
00915,凱基優選高股息30,23,0,23,光和,2024-10-15,6380
2402,毅嘉,24,2,22,光和,2024-10-15,6380
4711,永純,21,0,21,光和,2024-10-15,6380
2520,冠德,20,0,20,光和,2024-10-15,6380
00679B,元大美債20年,20,0,20,光和,2024-10-15,6380
6005,群益證,20,0,20,光和,2024-10-15,6380
00662,富邦NASDAQ,19,0,19,光和,2024-10-15,6380
3149,正達,38,20,18,光和,2024-10-15,6380
1449,佳和,17,0,17,光和,2024-10-15,6380
3591,艾笛森,22,5,17,光和,2024-10-15,6380
1447,力鵬,16,0,16,光和,2024-10-15,6380
4956,光鋐,46,30,16,光和,2024-10-15,6380
2313,華通,16,1,15,光和,2024-10-15,6380
1711,永光,15,1,14,光和,2024-10-15,6380
4513,福裕,15,1,14,光和,2024-10-15,6380
1304,台聚,13,0,13,光和,2024-10-15,6380
00712,復華富時不動產,12,0,12,光和,2024-10-15,6380
00715L,期街口布蘭特正2,12,0,12,光和,2024-10-15,6380
3049,精金,14,2,12,光和,2024-10-15,6380
6770,力積電,12,1,11,光和,2024-10-15,6380
1718,中纖,11,0,11,光和,2024-10-15,6380
00900,富邦特選高股息30,10,0,10,光和,2024-10-15,6380
00937B,群益ESG投等債20,10,0,10,光和,2024-10-15,6380
00664R,國泰臺灣加權反1,10,0,10,光和,2024-10-15,6380
00634R,富邦上証反1,10,0,10,光和,2024-10-15,6380
1595,川寶,10,0,10,光和,2024-10-15,6380
2809,京城銀,10,0,10,光和,2024-10-15,6380
3071,協禧,10,0,10,光和,2024-10-15,6380
5880,合庫金,10,0,10,光和,2024-10-15,6380
6125,廣運,10,0,10,光和,2024-10-15,6380
6167,久正,10,0,10,光和,2024-10-15,6380
6706,惠特,10,0,10,光和,2024-10-15,6380
1101,台泥,11,2,9,光和,2024-10-15,6380
3167,大量,9,0,9,光和,2024-10-15,6380
4510,高鋒,11,2,9,光和,2024-10-15,6380
2486,一詮,12,4,8,光和,2024-10-15,6380
00943,兆豐電子高息等權,209,0,209,光和,2024-10-16,6380
00753L,中信中國50正2,291,130,161,光和,2024-10-16,6380
00687B,國泰20年美債,155,1,154,光和,2024-10-16,6380
00887,永豐中國科技50大,113,0,113,光和,2024-10-16,6380
0056,元大高股息,127,15,112,光和,2024-10-16,6380
2014,中鴻,59,0,59,光和,2024-10-16,6380
00665L,富邦�琤肭磪囓�2,71,20,51,光和,2024-10-16,6380
00637L,元大滬深300正2,269,230,39,光和,2024-10-16,6380
00948B,中信優息投資級債,40,10,30,光和,2024-10-16,6380
2408,南亞科,26,0,26,光和,2024-10-16,6380
1101,台泥,23,1,22,光和,2024-10-16,6380
6505,台塑化,22,0,22,光和,2024-10-16,6380
8436,大江,22,0,22,光和,2024-10-16,6380
2344,華邦電,22,0,22,光和,2024-10-16,6380
2464,盟立,26,5,21,光和,2024-10-16,6380
00679B,元大美債20年,20,0,20,光和,2024-10-16,6380
2340,台亞,20,0,20,光和,2024-10-16,6380
6005,群益證,20,0,20,光和,2024-10-16,6380
2303,聯電,18,0,18,光和,2024-10-16,6380
2481,強茂,23,5,18,光和,2024-10-16,6380
00662,富邦NASDAQ,16,0,16,光和,2024-10-16,6380
3019,亞光,13,0,13,光和,2024-10-16,6380
1314,中石化,26,13,13,光和,2024-10-16,6380
3013,晟銘電,16,4,12,光和,2024-10-16,6380
00960,野村全球航運龍頭,11,0,11,光和,2024-10-16,6380
1304,台聚,11,0,11,光和,2024-10-16,6380
1618,合機,11,0,11,光和,2024-10-16,6380
2887,台新金,11,0,11,光和,2024-10-16,6380
00878,國泰永續高股息,10,0,10,光和,2024-10-16,6380
00882,中信中國高股息,12,2,10,光和,2024-10-16,6380
00712,復華富時不動產,10,0,10,光和,2024-10-16,6380
00634R,富邦上証反1,10,0,10,光和,2024-10-16,6380
1569,濱川,10,0,10,光和,2024-10-16,6380
3710,連展投控,13,3,10,光和,2024-10-16,6380
4711,永純,10,0,10,光和,2024-10-16,6380
6168,宏齊,10,0,10,光和,2024-10-16,6380
00922,國泰台灣領袖50,9,0,9,光和,2024-10-16,6380
2323,中環,10,1,9,光和,2024-10-16,6380
3450,聯鈞,18,9,9,光和,2024-10-16,6380
4526,東台,9,1,8,光和,2024-10-16,6380
1785,光洋科,8,0,8,光和,2024-10-16,6380
00934,中信成長高股息,10,2,8,光和,2024-10-16,6380
2363,矽統,17,9,8,光和,2024-10-16,6380
2455,全新,9,1,8,光和,2024-10-16,6380
2801,彰銀,8,0,8,光和,2024-10-16,6380
3591,艾笛森,11,3,8,光和,2024-10-16,6380
6789,采鈺,8,0,8,光和,2024-10-16,6380
6546,正基,7,0,7,光和,2024-10-16,6380
00919,群益台灣精選高息,7,0,7,光和,2024-10-16,6380
00912,中信臺灣智慧50,7,0,7,光和,2024-10-16,6380
2344,華邦電,81,4,77,光和,2024-10-17,6380
00887,永豐中國科技50大,74,0,74,光和,2024-10-17,6380
6125,廣運,55,8,47,光和,2024-10-17,6380
4526,東台,35,3,32,光和,2024-10-17,6380
2399,映泰,63,32,31,光和,2024-10-17,6380
1528,恩德,30,1,29,光和,2024-10-17,6380
2801,彰銀,29,0,29,光和,2024-10-17,6380
00937B,群益ESG投等債20,38,10,28,光和,2024-10-17,6380
3661,世芯-KY,30,2,28,光和,2024-10-17,6380
3209,全科,29,2,27,光和,2024-10-17,6380
00632R,元大台灣50反1,21,0,21,光和,2024-10-17,6380
5452,佶優,25,5,20,光和,2024-10-17,6380
6016,康和證,18,0,18,光和,2024-10-17,6380
0056,元大高股息,22,5,17,光和,2024-10-17,6380
00919,群益台灣精選高息,18,2,16,光和,2024-10-17,6380
00951,台新日本半導體,16,0,16,光和,2024-10-17,6380
00753L,中信中國50正2,117,102,15,光和,2024-10-17,6380
8111,立��,17,3,14,光和,2024-10-17,6380
2365,昆盈,25,11,14,光和,2024-10-17,6380
2388,威盛,13,0,13,光和,2024-10-17,6380
8086,宏捷科,12,0,12,光和,2024-10-17,6380
2363,矽統,30,18,12,光和,2024-10-17,6380
2061,風青,12,0,12,光和,2024-10-17,6380
9938,百和,15,4,11,光和,2024-10-17,6380
2330,台積電,12,2,10,光和,2024-10-17,6380
00725B,國泰投資級公司債,10,0,10,光和,2024-10-17,6380
00912,中信臺灣智慧50,10,0,10,光和,2024-10-17,6380
00665L,富邦�琤肭磪囓�2,11,1,10,光和,2024-10-17,6380
00955,中信日本商社,10,0,10,光和,2024-10-17,6380
2915,潤泰全,10,0,10,光和,2024-10-17,6380
3037,欣興,13,3,10,光和,2024-10-17,6380
3339,泰谷,11,1,10,光和,2024-10-17,6380
4720,德淵,10,0,10,光和,2024-10-17,6380
5014,建錩,10,0,10,光和,2024-10-17,6380
2404,漢唐,10,0,10,光和,2024-10-17,6380
0061,元大寶滬深,9,0,9,光和,2024-10-17,6380
4956,光鋐,9,1,8,光和,2024-10-17,6380
3029,零壹,13,5,8,光和,2024-10-17,6380
5202,力新,11,3,8,光和,2024-10-17,6380
8150,南茂,8,0,8,光和,2024-10-17,6380
2303,聯電,8,1,7,光和,2024-10-17,6380
00715L,期街口布蘭特正2,7,0,7,光和,2024-10-17,6380
3049,精金,15,8,7,光和,2024-10-17,6380
3607,谷崧,7,0,7,光和,2024-10-17,6380
4979,華星光,10,3,7,光和,2024-10-17,6380
6451,訊芯-KY,13,6,7,光和,2024-10-17,6380
00922,國泰台灣領袖50,6,0,6,光和,2024-10-17,6380
8374,羅昇,9,3,6,光和,2024-10-17,6380
00650L,復華香港正2,6,0,6,光和,2024-10-17,6380
1504,東元,6,0,6,光和,2024-10-17,6380
2615,萬海,357,92,265,光和,2024-10-18,6380
00687B,國泰20年美債,133,0,133,光和,2024-10-18,6380
00753L,中信中國50正2,156,26,130,光和,2024-10-18,6380
2402,毅嘉,92,1,91,光和,2024-10-18,6380
00632R,元大台灣50反1,78,0,78,光和,2024-10-18,6380
00948B,中信優息投資級債,74,0,74,光和,2024-10-18,6380
2105,正新,72,1,71,光和,2024-10-18,6380
2867,三商壽,71,1,70,光和,2024-10-18,6380
3049,精金,61,3,58,光和,2024-10-18,6380
00878,國泰永續高股息,60,4,56,光和,2024-10-18,6380
00679B,元大美債20年,51,2,49,光和,2024-10-18,6380
2303,聯電,46,2,44,光和,2024-10-18,6380
00951,台新日本半導體,41,0,41,光和,2024-10-18,6380
00955,中信日本商社,30,0,30,光和,2024-10-18,6380
0056,元大高股息,29,3,26,光和,2024-10-18,6380
00933B,國泰10Y+金融債,22,0,22,光和,2024-10-18,6380
00680L,元大美債20正2,21,0,21,光和,2024-10-18,6380
2374,佳能,22,2,20,光和,2024-10-18,6380
00664R,國泰臺灣加權反1,20,0,20,光和,2024-10-18,6380
1815,富喬,20,0,20,光和,2024-10-18,6380
2515,中工,20,0,20,光和,2024-10-18,6380
3715,定穎投控,19,0,19,光和,2024-10-18,6380
1605,華新,17,0,17,光和,2024-10-18,6380
3149,正達,31,15,16,光和,2024-10-18,6380
00905,FT臺灣Smart,20,4,16,光和,2024-10-18,6380
3025,星通,22,7,15,光和,2024-10-18,6380
00887,永豐中國科技50大,15,0,15,光和,2024-10-18,6380
00915,凱基優選高股息30,15,0,15,光和,2024-10-18,6380
4960,誠美材,15,0,15,光和,2024-10-18,6380
2845,遠東銀,14,0,14,光和,2024-10-18,6380
00919,群益台灣精選高息,19,6,13,光和,2024-10-18,6380
2399,映泰,27,14,13,光和,2024-10-18,6380
6274,台燿,13,0,13,光和,2024-10-18,6380
3013,晟銘電,18,6,12,光和,2024-10-18,6380
00665L,富邦�琤肭磪囓�2,32,21,11,光和,2024-10-18,6380
00637L,元大滬深300正2,114,103,11,光和,2024-10-18,6380
00795B,中信美國公債20年,11,0,11,光和,2024-10-18,6380
6770,力積電,14,3,11,光和,2024-10-18,6380
00712,復華富時不動產,11,0,11,光和,2024-10-18,6380
8039,台虹,10,0,10,光和,2024-10-18,6380
1721,三晃,17,7,10,光和,2024-10-18,6380
1776,展宇,10,0,10,光和,2024-10-18,6380
2472,立隆電,10,0,10,光和,2024-10-18,6380
2495,普安,12,2,10,光和,2024-10-18,6380
2610,華航,10,0,10,光和,2024-10-18,6380
4540,全球傳動,13,3,10,光和,2024-10-18,6380
8215,明基材,10,0,10,光和,2024-10-18,6380
9934,成霖,10,0,10,光和,2024-10-18,6380
2449,京元電子,12,2,10,光和,2024-10-18,6380
2520,冠德,9,0,9,光和,2024-10-18,6380
2105,正新,323,0,323,光和,2024-10-21,6380
00632R,元大台灣50反1,206,0,206,光和,2024-10-21,6380
2106,建大,137,10,127,光和,2024-10-21,6380
00637L,元大滬深300正2,232,132,100,光和,2024-10-21,6380
2867,三商壽,100,0,100,光和,2024-10-21,6380
2303,聯電,99,4,95,光和,2024-10-21,6380
00937B,群益ESG投等債20,82,0,82,光和,2024-10-21,6380
1815,富喬,103,27,76,光和,2024-10-21,6380
9105,泰金寶-DR,78,2,76,光和,2024-10-21,6380
5347,世界,63,1,62,光和,2024-10-21,6380
1742,台蠟,57,0,57,光和,2024-10-21,6380
2882,國泰金,56,5,51,光和,2024-10-21,6380
6191,精成科,50,0,50,光和,2024-10-21,6380
2836,高雄銀,40,0,40,光和,2024-10-21,6380
3481,群創,49,11,38,光和,2024-10-21,6380
00715L,期街口布蘭特正2,31,0,31,光和,2024-10-21,6380
2323,中環,31,0,31,光和,2024-10-21,6380
6016,康和證,30,0,30,光和,2024-10-21,6380
00687B,國泰20年美債,29,0,29,光和,2024-10-21,6380
4549,桓達,30,1,29,光和,2024-10-21,6380
6026,福邦證,30,1,29,光和,2024-10-21,6380
6770,力積電,31,2,29,光和,2024-10-21,6380
2409,友達,31,5,26,光和,2024-10-21,6380
2855,統一證,24,0,24,光和,2024-10-21,6380
2881,富邦金,24,0,24,光和,2024-10-21,6380
2883,凱基金,23,1,22,光和,2024-10-21,6380
5230,雷笛克光學,21,0,21,光和,2024-10-21,6380
6715,嘉基,20,0,20,光和,2024-10-21,6380
4510,高鋒,40,21,19,光和,2024-10-21,6380
00933B,國泰10Y+金融債,17,0,17,光和,2024-10-21,6380
6155,鈞寶,16,0,16,光和,2024-10-21,6380
2891,中信金,24,9,15,光和,2024-10-21,6380
00955,中信日本商社,15,0,15,光和,2024-10-21,6380
3703,欣陸,15,0,15,光和,2024-10-21,6380
4526,東台,33,18,15,光和,2024-10-21,6380
2520,冠德,14,0,14,光和,2024-10-21,6380
2540,愛山林,17,3,14,光和,2024-10-21,6380
2401,凌陽,13,0,13,光和,2024-10-21,6380
3312,弘憶股,15,2,13,光和,2024-10-21,6380
00650L,復華香港正2,13,1,12,光和,2024-10-21,6380
00679B,元大美債20年,11,0,11,光和,2024-10-21,6380
00927,群益半導體收益,21,10,11,光和,2024-10-21,6380
1528,恩德,11,0,11,光和,2024-10-21,6380
2426,鼎元,11,0,11,光和,2024-10-21,6380
3041,揚智,11,0,11,光和,2024-10-21,6380
3576,聯合再生,11,0,11,光和,2024-10-21,6380
3707,漢磊,11,0,11,光和,2024-10-21,6380
8436,大江,11,0,11,光和,2024-10-21,6380
00725B,國泰投資級公司債,10,0,10,光和,2024-10-21,6380
00752,中信中國50,10,0,10,光和,2024-10-21,6380
2888,新光金,318,3,315,光和,2024-10-22,6380
2609,陽明,346,58,288,光和,2024-10-22,6380
00937B,群益ESG投等債20,205,29,176,光和,2024-10-22,6380
2106,建大,121,0,121,光和,2024-10-22,6380
00687B,國泰20年美債,112,5,107,光和,2024-10-22,6380
2105,正新,106,0,106,光和,2024-10-22,6380
00679B,元大美債20年,86,1,85,光和,2024-10-22,6380
2615,萬海,169,104,65,光和,2024-10-22,6380
00933B,國泰10Y+金融債,60,0,60,光和,2024-10-22,6380
00688L,國泰20年美債正2,50,0,50,光和,2024-10-22,6380
6168,宏齊,49,1,48,光和,2024-10-22,6380
00951,台新日本半導體,42,0,42,光和,2024-10-22,6380
00665L,富邦�琤肭磪囓�2,30,0,30,光和,2024-10-22,6380
00954,中信日本半導體,30,0,30,光和,2024-10-22,6380
2332,友訊,30,0,30,光和,2024-10-22,6380
3703,欣陸,23,0,23,光和,2024-10-22,6380
2312,金寶,30,9,21,光和,2024-10-22,6380
1314,中石化,20,0,20,光和,2024-10-22,6380
1721,三晃,23,3,20,光和,2024-10-22,6380
3149,正達,45,27,18,光和,2024-10-22,6380
3049,精金,23,6,17,光和,2024-10-22,6380
00900,富邦特選高股息30,17,0,17,光和,2024-10-22,6380
00725B,國泰投資級公司債,16,0,16,光和,2024-10-22,6380
1477,聚陽,16,0,16,光和,2024-10-22,6380
2388,威盛,19,3,16,光和,2024-10-22,6380
5443,均豪,18,2,16,光和,2024-10-22,6380
2887,台新金,15,0,15,光和,2024-10-22,6380
00948B,中信優息投資級債,15,0,15,光和,2024-10-22,6380
2374,佳能,14,0,14,光和,2024-10-22,6380
00905,FT臺灣Smart,13,0,13,光和,2024-10-22,6380
00887,永豐中國科技50大,13,0,13,光和,2024-10-22,6380
2515,中工,14,1,13,光和,2024-10-22,6380
3290,東浦,19,6,13,光和,2024-10-22,6380
2303,聯電,12,0,12,光和,2024-10-22,6380
00936,台新永續高息中小,11,0,11,光和,2024-10-22,6380
1312,國喬,11,0,11,光和,2024-10-22,6380
1449,佳和,11,0,11,光和,2024-10-22,6380
4903,聯光通,13,2,11,光和,2024-10-22,6380
00929,復華台灣科技優息,10,0,10,光和,2024-10-22,6380
00756B,群益投等新興公債,10,0,10,光和,2024-10-22,6380
00960,野村全球航運龍頭,10,0,10,光和,2024-10-22,6380
1303,南亞,12,2,10,光和,2024-10-22,6380
1905,華紙,10,0,10,光和,2024-10-22,6380
2913,農林,10,0,10,光和,2024-10-22,6380
3530,晶相光,10,0,10,光和,2024-10-22,6380
4535,至興,10,0,10,光和,2024-10-22,6380
6418,詠昇,10,0,10,光和,2024-10-22,6380
2441,超豐,10,1,9,光和,2024-10-22,6380
2477,美隆電,15,6,9,光和,2024-10-22,6380
2547,日勝生,9,0,9,光和,2024-10-22,6380
2855,統一證,105,0,105,光和,2024-10-23,6380
2801,彰銀,102,0,102,光和,2024-10-23,6380
2905,三商,81,0,81,光和,2024-10-23,6380
2105,正新,90,20,70,光和,2024-10-23,6380
9105,泰金寶-DR,62,0,62,光和,2024-10-23,6380
6167,久正,62,2,60,光和,2024-10-23,6380
1608,華榮,50,0,50,光和,2024-10-23,6380
2106,建大,40,0,40,光和,2024-10-23,6380
2303,聯電,39,1,38,光和,2024-10-23,6380
6770,力積電,40,5,35,光和,2024-10-23,6380
00937B,群益ESG投等債20,33,0,33,光和,2024-10-23,6380
2515,中工,40,8,32,光和,2024-10-23,6380
2317,鴻海,34,3,31,光和,2024-10-23,6380
1742,台蠟,29,0,29,光和,2024-10-23,6380
00936,台新永續高息中小,31,3,28,光和,2024-10-23,6380
00948B,中信優息投資級債,28,0,28,光和,2024-10-23,6380
6651,全宇昕,26,0,26,光和,2024-10-23,6380
2809,京城銀,25,0,25,光和,2024-10-23,6380
00687B,國泰20年美債,24,0,24,光和,2024-10-23,6380
2363,矽統,36,12,24,光和,2024-10-23,6380
2812,台中銀,24,0,24,光和,2024-10-23,6380
1605,華新,23,2,21,光和,2024-10-23,6380
00954,中信日本半導體,20,0,20,光和,2024-10-23,6380
00955,中信日本商社,20,0,20,光和,2024-10-23,6380
00878,國泰永續高股息,23,3,20,光和,2024-10-23,6380
00940,元大台灣價值高息,33,15,18,光和,2024-10-23,6380
3013,晟銘電,19,1,18,光和,2024-10-23,6380
2329,華泰,25,9,16,光和,2024-10-23,6380
6156,松上,24,8,16,光和,2024-10-23,6380
0056,元大高股息,17,2,15,光和,2024-10-23,6380
1711,永光,21,7,14,光和,2024-10-23,6380
1101,台泥,16,3,13,光和,2024-10-23,6380
2472,立隆電,13,0,13,光和,2024-10-23,6380
2540,愛山林,12,0,12,光和,2024-10-23,6380
2369,菱生,18,7,11,光和,2024-10-23,6380
2453,凌群,15,4,11,光和,2024-10-23,6380
9904,寶成,12,1,11,光和,2024-10-23,6380
3031,佰鴻,13,2,11,光和,2024-10-23,6380
3481,群創,105,94,11,光和,2024-10-23,6380
3231,緯創,13,3,10,光和,2024-10-23,6380
00756B,群益投等新興公債,10,0,10,光和,2024-10-23,6380
00673R,期元大S＆P原油反1,10,0,10,光和,2024-10-23,6380
00951,台新日本半導體,10,0,10,光和,2024-10-23,6380
2034,允強,10,0,10,光和,2024-10-23,6380
2441,超豐,10,0,10,光和,2024-10-23,6380
2606,裕民,10,0,10,光和,2024-10-23,6380
2889,國票金,10,0,10,光和,2024-10-23,6380
3276,宇環,10,0,10,光和,2024-10-23,6380
3511,矽瑪,15,5,10,光和,2024-10-23,6380
4746,台耀,10,0,10,光和,2024-10-23,6380
00753L,中信中國50正2,475,20,455,光和,2024-10-24,6380
2615,萬海,146,24,122,光和,2024-10-24,6380
00665L,富邦�琤肭磪囓�2,110,0,110,光和,2024-10-24,6380
00637L,元大滬深300正2,90,0,90,光和,2024-10-24,6380
3060,銘異,72,0,72,光和,2024-10-24,6380
2609,陽明,125,56,69,光和,2024-10-24,6380
2105,正新,53,0,53,光和,2024-10-24,6380
2303,聯電,51,11,40,光和,2024-10-24,6380
1528,恩德,46,7,39,光和,2024-10-24,6380
2388,威盛,37,4,33,光和,2024-10-24,6380
0056,元大高股息,39,6,33,光和,2024-10-24,6380
2106,建大,35,3,32,光和,2024-10-24,6380
3481,群創,97,66,31,光和,2024-10-24,6380
00955,中信日本商社,30,0,30,光和,2024-10-24,6380
00937B,群益ESG投等債20,29,0,29,光和,2024-10-24,6380
2905,三商,29,0,29,光和,2024-10-24,6380
00929,復華台灣科技優息,33,5,28,光和,2024-10-24,6380
00878,國泰永續高股息,29,2,27,光和,2024-10-24,6380
00680L,元大美債20正2,24,0,24,光和,2024-10-24,6380
00940,元大台灣價值高息,23,0,23,光和,2024-10-24,6380
2363,矽統,59,36,23,光和,2024-10-24,6380
2034,允強,21,0,21,光和,2024-10-24,6380
1909,榮成,20,0,20,光和,2024-10-24,6380
6770,力積電,25,5,20,光和,2024-10-24,6380
3231,緯創,29,9,20,光和,2024-10-24,6380
2399,映泰,43,24,19,光和,2024-10-24,6380
3149,正達,36,17,19,光和,2024-10-24,6380
2317,鴻海,22,4,18,光和,2024-10-24,6380
1717,長興,18,0,18,光和,2024-10-24,6380
00887,永豐中國科技50大,23,6,17,光和,2024-10-24,6380
2409,友達,24,7,17,光和,2024-10-24,6380
3167,大量,17,0,17,光和,2024-10-24,6380
3520,華盈,21,4,17,光和,2024-10-24,6380
2489,瑞軒,30,14,16,光和,2024-10-24,6380
4566,時碩工業,16,0,16,光和,2024-10-24,6380
1540,喬福,17,2,15,光和,2024-10-24,6380
2481,強茂,15,0,15,光和,2024-10-24,6380
8277,商丞,15,0,15,光和,2024-10-24,6380
4716,大立,16,2,14,光和,2024-10-24,6380
00907,永豐優息存股,13,0,13,光和,2024-10-24,6380
8097,常珵,15,2,13,光和,2024-10-24,6380
00687B,國泰20年美債,18,6,12,光和,2024-10-24,6380
2402,毅嘉,46,34,12,光和,2024-10-24,6380
4746,台耀,12,0,12,光和,2024-10-24,6380
2809,京城銀,11,0,11,光和,2024-10-24,6380
3019,亞光,12,1,11,光和,2024-10-24,6380
00882,中信中國高股息,11,0,11,光和,2024-10-24,6380
2382,廣達,14,4,10,光和,2024-10-24,6380
00952,凱基台灣AI50,10,0,10,光和,2024-10-24,6380
1727,中華化,10,0,10,光和,2024-10-24,6380
2646,星宇航空,190,32,158,光和,2024-10-25,6380
3029,零壹,43,0,43,光和,2024-10-25,6380
6770,力積電,49,7,42,光和,2024-10-25,6380
2106,建大,40,0,40,光和,2024-10-25,6380
3663,鑫科,40,8,32,光和,2024-10-25,6380
00650L,復華香港正2,30,0,30,光和,2024-10-25,6380
00937B,群益ESG投等債20,31,4,27,光和,2024-10-25,6380
1742,台蠟,23,0,23,光和,2024-10-25,6380
2537,聯上發,23,0,23,光和,2024-10-25,6380
2614,東森,22,1,21,光和,2024-10-25,6380
00887,永豐中國科技50大,21,0,21,光和,2024-10-25,6380
2303,聯電,21,0,21,光和,2024-10-25,6380
6283,淳安,21,0,21,光和,2024-10-25,6380
2701,萬企,20,0,20,光和,2024-10-25,6380
3715,定穎投控,22,5,17,光和,2024-10-25,6380
4562,穎漢,13,0,13,光和,2024-10-25,6380
2399,映泰,17,4,13,光和,2024-10-25,6380
3710,連展投控,13,0,13,光和,2024-10-25,6380
6715,嘉基,13,0,13,光和,2024-10-25,6380
2344,華邦電,18,6,12,光和,2024-10-25,6380
1785,光洋科,11,0,11,光和,2024-10-25,6380
2365,昆盈,13,2,11,光和,2024-10-25,6380
2867,三商壽,11,0,11,光和,2024-10-25,6380
2905,三商,11,0,11,光和,2024-10-25,6380
4716,大立,11,0,11,光和,2024-10-25,6380
6126,信音,11,0,11,光和,2024-10-25,6380
6288,聯嘉,20,10,10,光和,2024-10-25,6380
2243,宏旭-KY,10,0,10,光和,2024-10-25,6380
2332,友訊,10,0,10,光和,2024-10-25,6380
2369,菱生,11,1,10,光和,2024-10-25,6380
2489,瑞軒,13,3,10,光和,2024-10-25,6380
8043,蜜望實,27,18,9,光和,2024-10-25,6380
9105,泰金寶-DR,13,4,9,光和,2024-10-25,6380
5443,均豪,10,1,9,光和,2024-10-25,6380
00900,富邦特選高股息30,10,2,8,光和,2024-10-25,6380
5452,佶優,8,0,8,光和,2024-10-25,6380
6282,康舒,10,2,8,光和,2024-10-25,6380
00919,群益台灣精選高息,8,1,7,光和,2024-10-25,6380
2809,京城銀,7,0,7,光和,2024-10-25,6380
3356,奇偶,7,0,7,光和,2024-10-25,6380
8249,菱光,18,12,6,光和,2024-10-25,6380
00909,國泰數位支付服務,6,0,6,光和,2024-10-25,6380
1710,東聯,6,0,6,光和,2024-10-25,6380
2351,順德,8,2,6,光和,2024-10-25,6380
3031,佰鴻,6,0,6,光和,2024-10-25,6380
3149,正達,6,0,6,光和,2024-10-25,6380
3272,東碩,16,10,6,光和,2024-10-25,6380
3615,安可,14,8,6,光和,2024-10-25,6380
6148,驊宏資,6,0,6,光和,2024-10-25,6380
6609,瀧澤科,6,0,6,光和,2024-10-25,6380
00937B,群益ESG投等債20,274,0,274,光和,2024-10-28,6380
00712,復華富時不動產,113,0,113,光和,2024-10-28,6380
00637L,元大滬深300正2,295,200,95,光和,2024-10-28,6380
2646,星宇航空,90,15,75,光和,2024-10-28,6380
2820,華票,64,0,64,光和,2024-10-28,6380
2105,正新,50,0,50,光和,2024-10-28,6380
4526,東台,48,0,48,光和,2024-10-28,6380
3455,由田,47,0,47,光和,2024-10-28,6380
00919,群益台灣精選高息,49,5,44,光和,2024-10-28,6380
00903,富邦元宇宙,40,0,40,光和,2024-10-28,6380
00929,復華台灣科技優息,34,0,34,光和,2024-10-28,6380
3551,世禾,34,1,33,光和,2024-10-28,6380
00948B,中信優息投資級債,32,0,32,光和,2024-10-28,6380
00679B,元大美債20年,28,0,28,光和,2024-10-28,6380
00665L,富邦�琤肭磪囓�2,35,10,25,光和,2024-10-28,6380
2905,三商,25,0,25,光和,2024-10-28,6380
2374,佳能,23,0,23,光和,2024-10-28,6380
2834,臺企銀,22,0,22,光和,2024-10-28,6380
6770,力積電,33,12,21,光和,2024-10-28,6380
00900,富邦特選高股息30,20,0,20,光和,2024-10-28,6380
2884,玉山金,18,0,18,光和,2024-10-28,6380
8043,蜜望實,23,6,17,光和,2024-10-28,6380
00715L,期街口布蘭特正2,26,10,16,光和,2024-10-28,6380
3049,精金,16,1,15,光和,2024-10-28,6380
0056,元大高股息,17,3,14,光和,2024-10-28,6380
1815,富喬,14,0,14,光和,2024-10-28,6380
5907,大洋-KY,14,0,14,光和,2024-10-28,6380
3040,遠見,12,0,12,光和,2024-10-28,6380
2317,鴻海,52,41,11,光和,2024-10-28,6380
2354,鴻準,24,13,11,光和,2024-10-28,6380
1101,台泥,11,0,11,光和,2024-10-28,6380
00959B,大華投等美債15Y+,11,0,11,光和,2024-10-28,6380
2034,允強,11,0,11,光和,2024-10-28,6380
2369,菱生,11,0,11,光和,2024-10-28,6380
2867,三商壽,11,0,11,光和,2024-10-28,6380
3715,定穎投控,33,22,11,光和,2024-10-28,6380
00642U,期元大S＆P石油,10,0,10,光和,2024-10-28,6380
00907,永豐優息存股,10,0,10,光和,2024-10-28,6380
3661,世芯-KY,23,13,10,光和,2024-10-28,6380
5483,中美晶,10,0,10,光和,2024-10-28,6380
2303,聯電,21,11,10,光和,2024-10-28,6380
00918,大華優利高填息30,9,0,9,光和,2024-10-28,6380
1609,大亞,10,1,9,光和,2024-10-28,6380
8404,百和興業-KY,10,1,9,光和,2024-10-28,6380
2313,華通,19,11,8,光和,2024-10-28,6380
8097,常珵,11,3,8,光和,2024-10-28,6380
6288,聯嘉,15,8,7,光和,2024-10-28,6380
1785,光洋科,7,0,7,光和,2024-10-28,6380
3234,光環,7,0,7,光和,2024-10-28,6380
3162,精確,7,0,7,光和,2024-10-28,6380
2609,陽明,435,6,429,光和,2024-10-29,6380
2615,萬海,201,3,198,光和,2024-10-29,6380
2888,新光金,133,10,123,光和,2024-10-29,6380
00919,群益台灣精選高息,97,6,91,光和,2024-10-29,6380
2892,第一金,86,0,86,光和,2024-10-29,6380
00929,復華台灣科技優息,79,0,79,光和,2024-10-29,6380
00753L,中信中國50正2,116,41,75,光和,2024-10-29,6380
00878,國泰永續高股息,79,6,73,光和,2024-10-29,6380
0056,元大高股息,62,3,59,光和,2024-10-29,6380
2801,彰銀,60,3,57,光和,2024-10-29,6380
2836,高雄銀,60,3,57,光和,2024-10-29,6380
00940,元大台灣價值高息,78,22,56,光和,2024-10-29,6380
00937B,群益ESG投等債20,77,25,52,光和,2024-10-29,6380
1314,中石化,50,0,50,光和,2024-10-29,6380
00712,復華富時不動產,44,0,44,光和,2024-10-29,6380
2105,正新,40,0,40,光和,2024-10-29,6380
2618,長榮航,40,0,40,光和,2024-10-29,6380
6486,互動,38,0,38,光和,2024-10-29,6380
00715L,期街口布蘭特正2,31,0,31,光和,2024-10-29,6380
00650L,復華香港正2,80,50,30,光和,2024-10-29,6380
2106,建大,30,0,30,光和,2024-10-29,6380
4711,永純,30,0,30,光和,2024-10-29,6380
00907,永豐優息存股,29,0,29,光和,2024-10-29,6380
6770,力積電,25,0,25,光和,2024-10-29,6380
2344,華邦電,25,0,25,光和,2024-10-29,6380
2303,聯電,26,2,24,光和,2024-10-29,6380
2506,太設,21,0,21,光和,2024-10-29,6380
1303,南亞,20,0,20,光和,2024-10-29,6380
5225,東科-KY,20,0,20,光和,2024-10-29,6380
1605,華新,38,20,18,光和,2024-10-29,6380
1717,長興,18,0,18,光和,2024-10-29,6380
2034,允強,22,4,18,光和,2024-10-29,6380
8064,東捷,22,5,17,光和,2024-10-29,6380
2905,三商,16,0,16,光和,2024-10-29,6380
1471,首利,16,0,16,光和,2024-10-29,6380
3715,定穎投控,19,3,16,光和,2024-10-29,6380
00713,元大台灣高息低波,15,0,15,光和,2024-10-29,6380
2355,敬鵬,12,0,12,光和,2024-10-29,6380
2614,東森,12,0,12,光和,2024-10-29,6380
00946,群益科技高息成長,11,0,11,光和,2024-10-29,6380
2243,宏旭-KY,11,0,11,光和,2024-10-29,6380
2481,強茂,11,0,11,光和,2024-10-29,6380
6274,台燿,11,0,11,光和,2024-10-29,6380
1312,國喬,10,0,10,光和,2024-10-29,6380
3162,精確,10,0,10,光和,2024-10-29,6380
3325,旭品,10,0,10,光和,2024-10-29,6380
5452,佶優,11,1,10,光和,2024-10-29,6380
5475,德宏,10,0,10,光和,2024-10-29,6380
6269,台郡,10,0,10,光和,2024-10-29,6380
8021,尖點,11,1,10,光和,2024-10-29,6380
2615,萬海,452,151,301,光和,2024-10-30,6380
3481,群創,142,17,125,光和,2024-10-30,6380
2609,陽明,283,167,116,光和,2024-10-30,6380
2344,華邦電,63,4,59,光和,2024-10-30,6380
6257,矽格,53,1,52,光和,2024-10-30,6380
2337,旺宏,45,0,45,光和,2024-10-30,6380
00878,國泰永續高股息,55,14,41,光和,2024-10-30,6380
2303,聯電,41,0,41,光和,2024-10-30,6380
1528,恩德,66,31,35,光和,2024-10-30,6380
4915,致伸,30,0,30,光和,2024-10-30,6380
6770,力積電,37,12,25,光和,2024-10-30,6380
00637L,元大滬深300正2,60,36,24,光和,2024-10-30,6380
1314,中石化,24,0,24,光和,2024-10-30,6380
2409,友達,23,0,23,光和,2024-10-30,6380
0056,元大高股息,29,8,21,光和,2024-10-30,6380
2891,中信金,18,0,18,光和,2024-10-30,6380
2388,威盛,20,2,18,光和,2024-10-30,6380
6669,緯穎,19,1,18,光和,2024-10-30,6380
1568,倉佑,17,0,17,光和,2024-10-30,6380
2605,新興,17,0,17,光和,2024-10-30,6380
00940,元大台灣價值高息,36,20,16,光和,2024-10-30,6380
00715L,期街口布蘭特正2,16,0,16,光和,2024-10-30,6380
2905,三商,16,0,16,光和,2024-10-30,6380
00712,復華富時不動產,25,10,15,光和,2024-10-30,6380
00915,凱基優選高股息30,15,0,15,光和,2024-10-30,6380
1605,華新,36,21,15,光和,2024-10-30,6380
2332,友訊,15,0,15,光和,2024-10-30,6380
3264,欣銓,14,0,14,光和,2024-10-30,6380
6235,華孚,15,2,13,光和,2024-10-30,6380
8070,長華*,15,2,13,光和,2024-10-30,6380
00720B,元大投資級公司債,12,0,12,光和,2024-10-30,6380
3060,銘異,13,1,12,光和,2024-10-30,6380
6742,澤米,13,1,12,光和,2024-10-30,6380
00665L,富邦�琤肭磪囓�2,11,0,11,光和,2024-10-30,6380
3031,佰鴻,11,0,11,光和,2024-10-30,6380
4711,永純,11,0,11,光和,2024-10-30,6380
8112,至上,11,0,11,光和,2024-10-30,6380
1905,華紙,10,0,10,光和,2024-10-30,6380
2701,萬企,10,0,10,光和,2024-10-30,6380
5227,立凱-KY,10,0,10,光和,2024-10-30,6380
6133,金橋,12,2,10,光和,2024-10-30,6380
9914,美利達,10,0,10,光和,2024-10-30,6380
2425,承啟,10,1,9,光和,2024-10-30,6380
3029,零壹,13,4,9,光和,2024-10-30,6380
6191,精成科,13,4,9,光和,2024-10-30,6380
00675L,富邦臺灣加權正2,8,0,8,光和,2024-10-30,6380
2243,宏旭-KY,18,10,8,光和,2024-10-30,6380
6288,聯嘉,10,2,8,光和,2024-10-30,6380
2520,冠德,7,0,7,光和,2024-10-30,6380
3360,尚立,7,0,7,光和,2024-10-30,6380
5880,合庫金,241,0,241,光和,2024-11-01,6380
2317,鴻海,129,35,94,光和,2024-11-01,6380
2887,台新金,82,0,82,光和,2024-11-01,6380
2303,聯電,71,3,68,光和,2024-11-01,6380
00712,復華富時不動產,57,0,57,光和,2024-11-01,6380
00951,台新日本半導體,58,1,57,光和,2024-11-01,6380
00919,群益台灣精選高息,55,1,54,光和,2024-11-01,6380
00878,國泰永續高股息,52,3,49,光和,2024-11-01,6380
00954,中信日本半導體,50,1,49,光和,2024-11-01,6380
00929,復華台灣科技優息,35,6,29,光和,2024-11-01,6380
1449,佳和,28,4,24,光和,2024-11-01,6380
2105,正新,30,10,20,光和,2024-11-01,6380
6598,ABC-KY,20,0,20,光和,2024-11-01,6380
2329,華泰,20,0,20,光和,2024-11-01,6380
2353,宏��,20,1,19,光和,2024-11-01,6380
3167,大量,16,0,16,光和,2024-11-01,6380
2301,光寶科,16,1,15,光和,2024-11-01,6380
1618,合機,15,0,15,光和,2024-11-01,6380
4114,健喬,15,0,15,光和,2024-11-01,6380
6669,緯穎,21,6,15,光和,2024-11-01,6380
00940,元大台灣價值高息,14,0,14,光和,2024-11-01,6380
2646,星宇航空,16,2,14,光和,2024-11-01,6380
00930,永豐ESG低碳高息,13,0,13,光和,2024-11-01,6380
2890,永豐金,12,0,12,光和,2024-11-01,6380
2408,南亞科,11,0,11,光和,2024-11-01,6380
0056,元大高股息,10,0,10,光和,2024-11-01,6380
2337,旺宏,18,8,10,光和,2024-11-01,6380
00756B,群益投等新興公債,10,0,10,光和,2024-11-01,6380
00673R,期元大S＆P原油反1,10,0,10,光和,2024-11-01,6380
2867,三商壽,10,0,10,光和,2024-11-01,6380
3498,陽程,10,0,10,光和,2024-11-01,6380
00670L,富邦NASDAQ正2,9,0,9,光和,2024-11-01,6380
2606,裕民,9,0,9,光和,2024-11-01,6380
2313,華通,9,1,8,光和,2024-11-01,6380
6213,聯茂,12,4,8,光和,2024-11-01,6380
6283,淳安,8,0,8,光和,2024-11-01,6380
9904,寶成,18,10,8,光和,2024-11-01,6380
00830,國泰費城半導體,8,0,8,光和,2024-11-01,6380
00948B,中信優息投資級債,7,0,7,光和,2024-11-01,6380
00960,野村全球航運龍頭,7,0,7,光和,2024-11-01,6380
2314,台揚,7,0,7,光和,2024-11-01,6380
2537,聯上發,7,0,7,光和,2024-11-01,6380
4139,馬光-KY,7,0,7,光和,2024-11-01,6380
6593,台灣銘板,7,0,7,光和,2024-11-01,6380
6789,采鈺,7,0,7,光和,2024-11-01,6380
2354,鴻準,60,53,7,光和,2024-11-01,6380
5871,中租-KY,6,0,6,光和,2024-11-01,6380
6274,台燿,6,0,6,光和,2024-11-01,6380
00959B,大華投等美債15Y+,6,0,6,光和,2024-11-01,6380
2801,彰銀,10,4,6,光和,2024-11-01,6380
2609,陽明,460,14,446,光和,2024-11-04,6380
2615,萬海,330,63,267,光和,2024-11-04,6380
2303,聯電,87,10,77,光和,2024-11-04,6380
2409,友達,76,0,76,光和,2024-11-04,6380
00679B,元大美債20年,72,0,72,光和,2024-11-04,6380
8088,品安,60,1,59,光和,2024-11-04,6380
00712,復華富時不動產,53,0,53,光和,2024-11-04,6380
00930,永豐ESG低碳高息,40,0,40,光和,2024-11-04,6380
00637L,元大滬深300正2,37,0,37,光和,2024-11-04,6380
4707,磐亞,31,0,31,光和,2024-11-04,6380
00687B,國泰20年美債,31,0,31,光和,2024-11-04,6380
00665L,富邦�琤肭磪囓�2,30,0,30,光和,2024-11-04,6380
1531,高林股,28,0,28,光和,2024-11-04,6380
3481,群創,30,3,27,光和,2024-11-04,6380
4207,環泰,25,0,25,光和,2024-11-04,6380
6257,矽格,25,1,24,光和,2024-11-04,6380
00937B,群益ESG投等債20,20,0,20,光和,2024-11-04,6380
2331,精英,20,0,20,光和,2024-11-04,6380
2890,永豐金,30,10,20,光和,2024-11-04,6380
2337,旺宏,23,4,19,光和,2024-11-04,6380
00918,大華優利高填息30,18,0,18,光和,2024-11-04,6380
2426,鼎元,20,3,17,光和,2024-11-04,6380
2431,聯昌,18,3,15,光和,2024-11-04,6380
6598,ABC-KY,15,0,15,光和,2024-11-04,6380
2646,星宇航空,16,3,13,光和,2024-11-04,6380
00720B,元大投資級公司債,12,0,12,光和,2024-11-04,6380
2413,環科,12,0,12,光和,2024-11-04,6380
2489,瑞軒,15,3,12,光和,2024-11-04,6380
2887,台新金,12,0,12,光和,2024-11-04,6380
0056,元大高股息,13,1,12,光和,2024-11-04,6380
00900,富邦特選高股息30,11,0,11,光和,2024-11-04,6380
8032,光菱,12,2,10,光和,2024-11-04,6380
00946,群益科技高息成長,10,0,10,光和,2024-11-04,6380
2332,友訊,10,0,10,光和,2024-11-04,6380
2374,佳能,10,0,10,光和,2024-11-04,6380
2537,聯上發,10,0,10,光和,2024-11-04,6380
3019,亞光,12,2,10,光和,2024-11-04,6380
4711,永純,10,0,10,光和,2024-11-04,6380
6167,久正,10,0,10,光和,2024-11-04,6380
6180,橘子,10,0,10,光和,2024-11-04,6380
6244,茂迪,10,0,10,光和,2024-11-04,6380
6443,元晶,10,0,10,光和,2024-11-04,6380
8111,立��,15,5,10,光和,2024-11-04,6380
3605,宏致,11,2,9,光和,2024-11-04,6380
8070,長華*,15,6,9,光和,2024-11-04,6380
3189,景碩,8,0,8,光和,2024-11-04,6380
00725B,國泰投資級公司債,8,0,8,光和,2024-11-04,6380
1815,富喬,8,0,8,光和,2024-11-04,6380
6248,沛波,8,0,8,光和,2024-11-04,6380
1702,南僑,8,0,8,光和,2024-11-04,6380
3490,單井,103,2,101,光和,2024-11-05,6380
2303,聯電,116,48,68,光和,2024-11-05,6380
00936,台新永續高息中小,62,0,62,光和,2024-11-05,6380
4711,永純,38,0,38,光和,2024-11-05,6380
00680L,元大美債20正2,33,0,33,光和,2024-11-05,6380
00919,群益台灣精選高息,41,12,29,光和,2024-11-05,6380
6669,緯穎,24,0,24,光和,2024-11-05,6380
2888,新光金,22,0,22,光和,2024-11-05,6380
1531,高林股,20,0,20,光和,2024-11-05,6380
2014,中鴻,19,0,19,光和,2024-11-05,6380
4549,桓達,20,1,19,光和,2024-11-05,6380
00932,兆豐永續高息等權,18,0,18,光和,2024-11-05,6380
6598,ABC-KY,15,0,15,光和,2024-11-05,6380
3047,訊舟,14,0,14,光和,2024-11-05,6380
2328,廣宇,14,0,14,光和,2024-11-05,6380
2646,星宇航空,18,5,13,光和,2024-11-05,6380
3443,創意,12,0,12,光和,2024-11-05,6380
6235,華孚,12,0,12,光和,2024-11-05,6380
5880,合庫金,12,0,12,光和,2024-11-05,6380
00946,群益科技高息成長,11,0,11,光和,2024-11-05,6380
6197,佳必琪,13,2,11,光和,2024-11-05,6380
6838,台新藥,13,2,11,光和,2024-11-05,6380
00878,國泰永續高股息,15,5,10,光和,2024-11-05,6380
00933B,國泰10Y+金融債,10,0,10,光和,2024-11-05,6380
2413,環科,10,0,10,光和,2024-11-05,6380
3437,榮創,10,0,10,光和,2024-11-05,6380
5876,上海商銀,10,0,10,光和,2024-11-05,6380
9935,慶豐富,10,0,10,光和,2024-11-05,6380
00635U,期元大S＆P黃金,9,0,9,光和,2024-11-05,6380
3062,建漢,13,4,9,光和,2024-11-05,6380
6770,力積電,15,6,9,光和,2024-11-05,6380
2344,華邦電,8,0,8,光和,2024-11-05,6380
4915,致伸,9,1,8,光和,2024-11-05,6380
00929,復華台灣科技優息,47,39,8,光和,2024-11-05,6380
2354,鴻準,62,54,8,光和,2024-11-05,6380
2465,麗臺,8,1,7,光和,2024-11-05,6380
00692,富邦公司治理,7,0,7,光和,2024-11-05,6380
2887,台新金,7,0,7,光和,2024-11-05,6380
00930,永豐ESG低碳高息,6,0,6,光和,2024-11-05,6380
4938,和碩,6,0,6,光和,2024-11-05,6380
6125,廣運,7,1,6,光和,2024-11-05,6380
8070,長華*,7,1,6,光和,2024-11-05,6380
8088,品安,6,0,6,光和,2024-11-05,6380
2351,順德,5,0,5,光和,2024-11-05,6380
2363,矽統,10,5,5,光和,2024-11-05,6380
00850,元大臺灣ESG永續,5,0,5,光和,2024-11-05,6380
00673R,期元大S＆P原油反1,5,0,5,光和,2024-11-05,6380
1314,中石化,5,0,5,光和,2024-11-05,6380
1326,台化,5,0,5,光和,2024-11-05,6380
1718,中纖,5,0,5,光和,2024-11-05,6380
2615,萬海,531,135,396,光和,2024-11-06,6380
2609,陽明,412,87,325,光和,2024-11-06,6380
00632R,元大台灣50反1,278,72,206,光和,2024-11-06,6380
2105,正新,191,0,191,光和,2024-11-06,6380
00753L,中信中國50正2,164,50,114,光和,2024-11-06,6380
00637L,元大滬深300正2,199,90,109,光和,2024-11-06,6380
2317,鴻海,107,19,88,光和,2024-11-06,6380
00679B,元大美債20年,90,4,86,光和,2024-11-06,6380
00936,台新永續高息中小,84,0,84,光和,2024-11-06,6380
1316,上曜,80,0,80,光和,2024-11-06,6380
00687B,國泰20年美債,70,0,70,光和,2024-11-06,6380
2303,聯電,69,16,53,光和,2024-11-06,6380
2337,旺宏,50,0,50,光和,2024-11-06,6380
2801,彰銀,40,0,40,光和,2024-11-06,6380
00680L,元大美債20正2,29,0,29,光和,2024-11-06,6380
1301,台塑,27,1,26,光和,2024-11-06,6380
2834,臺企銀,21,0,21,光和,2024-11-06,6380
1314,中石化,20,0,20,光和,2024-11-06,6380
2836,高雄銀,20,0,20,光和,2024-11-06,6380
2892,第一金,20,0,20,光和,2024-11-06,6380
5880,合庫金,20,0,20,光和,2024-11-06,6380
2489,瑞軒,20,1,19,光和,2024-11-06,6380
2354,鴻準,42,23,19,光和,2024-11-06,6380
1711,永光,20,1,19,光和,2024-11-06,6380
3033,威健,15,0,15,光和,2024-11-06,6380
3149,正達,20,6,14,光和,2024-11-06,6380
1528,恩德,14,1,13,光和,2024-11-06,6380
2402,毅嘉,13,0,13,光和,2024-11-06,6380
6235,華孚,16,3,13,光和,2024-11-06,6380
1708,東鹼,12,0,12,光和,2024-11-06,6380
2351,順德,15,3,12,光和,2024-11-06,6380
2613,中櫃,12,0,12,光和,2024-11-06,6380
00795B,中信美國公債20年,11,0,11,光和,2024-11-06,6380
2880,華南金,11,0,11,光和,2024-11-06,6380
6156,松上,13,2,11,光和,2024-11-06,6380
00919,群益台灣精選高息,10,0,10,光和,2024-11-06,6380
00756B,群益投等新興公債,10,0,10,光和,2024-11-06,6380
2031,新光鋼,10,0,10,光和,2024-11-06,6380
2390,云辰,10,0,10,光和,2024-11-06,6380
2397,友通,10,0,10,光和,2024-11-06,6380
2413,環科,10,0,10,光和,2024-11-06,6380
2540,愛山林,10,0,10,光和,2024-11-06,6380
2913,農林,10,0,10,光和,2024-11-06,6380
3059,華晶科,10,0,10,光和,2024-11-06,6380
5227,立凱-KY,10,0,10,光和,2024-11-06,6380
8039,台虹,10,0,10,光和,2024-11-06,6380
9921,巨大,10,0,10,光和,2024-11-06,6380
8107,大億金茂,9,0,9,光和,2024-11-06,6380
00882,中信中國高股息,9,0,9,光和,2024-11-06,6380
2515,中工,9,0,9,光和,2024-11-06,6380
00878,國泰永續高股息,127,8,119,光和,2024-11-07,6380
00887,永豐中國科技50大,118,0,118,光和,2024-11-07,6380
2615,萬海,186,80,106,光和,2024-11-07,6380
6026,福邦證,103,1,102,光和,2024-11-07,6380
2014,中鴻,103,11,92,光和,2024-11-07,6380
2888,新光金,90,0,90,光和,2024-11-07,6380
3490,單井,67,4,63,光和,2024-11-07,6380
6016,康和證,58,10,48,光和,2024-11-07,6380
2454,聯發科,34,1,33,光和,2024-11-07,6380
2498,宏達電,32,1,31,光和,2024-11-07,6380
00948B,中信優息投資級債,30,0,30,光和,2024-11-07,6380
4306,炎洲,22,0,22,光和,2024-11-07,6380
2812,台中銀,21,0,21,光和,2024-11-07,6380
00680L,元大美債20正2,20,0,20,光和,2024-11-07,6380
1711,永光,35,15,20,光和,2024-11-07,6380
9105,泰金寶-DR,190,170,20,光和,2024-11-07,6380
9935,慶豐富,20,0,20,光和,2024-11-07,6380
2328,廣宇,23,4,19,光和,2024-11-07,6380
2885,元大金,17,1,16,光和,2024-11-07,6380
1808,潤隆,15,1,14,光和,2024-11-07,6380
2419,仲琦,22,9,13,光和,2024-11-07,6380
6244,茂迪,12,0,12,光和,2024-11-07,6380
9933,中鼎,12,0,12,光和,2024-11-07,6380
1595,川寶,14,3,11,光和,2024-11-07,6380
2365,昆盈,13,2,11,光和,2024-11-07,6380
6156,松上,11,0,11,光和,2024-11-07,6380
2603,長榮,31,21,10,光和,2024-11-07,6380
00634R,富邦上証反1,10,0,10,光和,2024-11-07,6380
2405,輔信,10,0,10,光和,2024-11-07,6380
2540,愛山林,10,0,10,光和,2024-11-07,6380
2906,高林,11,1,10,光和,2024-11-07,6380
5603,陸海,11,1,10,光和,2024-11-07,6380
6153,嘉聯益,20,10,10,光和,2024-11-07,6380
6180,橘子,20,10,10,光和,2024-11-07,6380
2356,英業達,23,14,9,光和,2024-11-07,6380
2388,威盛,10,1,9,光和,2024-11-07,6380
3062,建漢,27,18,9,光和,2024-11-07,6380
3213,茂訊,9,0,9,光和,2024-11-07,6380
2374,佳能,10,2,8,光和,2024-11-07,6380
2399,映泰,20,12,8,光和,2024-11-07,6380
3450,聯鈞,11,3,8,光和,2024-11-07,6380
00687B,國泰20年美債,18,10,8,光和,2024-11-07,6380
3701,大眾控,12,5,7,光和,2024-11-07,6380
1473,台南,6,0,6,光和,2024-11-07,6380
2426,鼎元,6,0,6,光和,2024-11-07,6380
2867,三商壽,6,0,6,光和,2024-11-07,6380
3518,柏騰,6,0,6,光和,2024-11-07,6380
6202,盛群,7,1,6,光和,2024-11-07,6380
8261,富鼎,9,3,6,光和,2024-11-07,6380
1101,台泥,6,0,6,光和,2024-11-07,6380
00753L,中信中國50正2,371,0,371,光和,2024-11-08,6380
00637L,元大滬深300正2,431,101,330,光和,2024-11-08,6380
6026,福邦證,113,0,113,光和,2024-11-08,6380
00929,復華台灣科技優息,108,33,75,光和,2024-11-08,6380
9105,泰金寶-DR,84,18,66,光和,2024-11-08,6380
2888,新光金,65,5,60,光和,2024-11-08,6380
2312,金寶,59,10,49,光和,2024-11-08,6380
00946,群益科技高息成長,45,0,45,光和,2024-11-08,6380
8043,蜜望實,43,0,43,光和,2024-11-08,6380
1301,台塑,41,0,41,光和,2024-11-08,6380
6016,康和證,40,0,40,光和,2024-11-08,6380
2388,威盛,44,5,39,光和,2024-11-08,6380
2409,友達,39,3,36,光和,2024-11-08,6380
2454,聯發科,35,0,35,光和,2024-11-08,6380
3029,零壹,32,0,32,光和,2024-11-08,6380
2836,高雄銀,30,0,30,光和,2024-11-08,6380
4167,松瑞藥,30,0,30,光和,2024-11-08,6380
4711,永純,30,0,30,光和,2024-11-08,6380
00945B,凱基美國非投等債,25,0,25,光和,2024-11-08,6380
3062,建漢,31,6,25,光和,2024-11-08,6380
00878,國泰永續高股息,36,12,24,光和,2024-11-08,6380
00919,群益台灣精選高息,53,32,21,光和,2024-11-08,6380
3321,同泰,20,0,20,光和,2024-11-08,6380
3481,群創,20,1,19,光和,2024-11-08,6380
3019,亞光,17,0,17,光和,2024-11-08,6380
9938,百和,17,0,17,光和,2024-11-08,6380
2313,華通,19,3,16,光和,2024-11-08,6380
6505,台塑化,16,0,16,光和,2024-11-08,6380
2515,中工,15,0,15,光和,2024-11-08,6380
8150,南茂,15,0,15,光和,2024-11-08,6380
2399,映泰,22,7,15,光和,2024-11-08,6380
2303,聯電,17,4,13,光和,2024-11-08,6380
6134,萬旭,13,0,13,光和,2024-11-08,6380
00940,元大台灣價值高息,22,10,12,光和,2024-11-08,6380
2314,台揚,14,2,12,光和,2024-11-08,6380
8064,東捷,17,5,12,光和,2024-11-08,6380
00638R,元大滬深300反1,191,180,11,光和,2024-11-08,6380
1609,大亞,11,0,11,光和,2024-11-08,6380
3073,天方能源,11,0,11,光和,2024-11-08,6380
3622,洋華,11,0,11,光和,2024-11-08,6380
5907,大洋-KY,11,0,11,光和,2024-11-08,6380
6530,創威,17,6,11,光和,2024-11-08,6380
8107,大億金茂,11,0,11,光和,2024-11-08,6380
2731,雄獅,10,0,10,光和,2024-11-08,6380
2633,台灣高鐵,10,0,10,光和,2024-11-08,6380
2324,仁寶,11,1,10,光和,2024-11-08,6380
2497,怡利電,10,0,10,光和,2024-11-08,6380
2929,淘帝-KY,10,0,10,光和,2024-11-08,6380
8039,台虹,10,0,10,光和,2024-11-08,6380
2354,鴻準,52,43,9,光和,2024-11-08,6380
3481,群創,84,3,81,光和,2024-11-11,6380
2885,元大金,50,0,50,光和,2024-11-11,6380
00887,永豐中國科技50大,50,10,40,光和,2024-11-11,6380
00943,兆豐電子高息等權,39,0,39,光和,2024-11-11,6380
00929,復華台灣科技優息,35,2,33,光和,2024-11-11,6380
2801,彰銀,32,0,32,光和,2024-11-11,6380
00665L,富邦�琤肭磪囓�2,41,10,31,光和,2024-11-11,6380
2882,國泰金,30,1,29,光和,2024-11-11,6380
2881,富邦金,26,0,26,光和,2024-11-11,6380
8110,華東,26,0,26,光和,2024-11-11,6380
1605,華新,25,0,25,光和,2024-11-11,6380
6257,矽格,26,1,25,光和,2024-11-11,6380
2891,中信金,28,4,24,光和,2024-11-11,6380
2337,旺宏,23,1,22,光和,2024-11-11,6380
2454,聯發科,22,1,21,光和,2024-11-11,6380
1304,台聚,20,0,20,光和,2024-11-11,6380
00919,群益台灣精選高息,19,0,19,光和,2024-11-11,6380
00637L,元大滬深300正2,218,200,18,光和,2024-11-11,6380
2731,雄獅,18,0,18,光和,2024-11-11,6380
3622,洋華,20,2,18,光和,2024-11-11,6380
00753L,中信中國50正2,27,10,17,光和,2024-11-11,6380
2312,金寶,28,11,17,光和,2024-11-11,6380
2392,正崴,36,19,17,光和,2024-11-11,6380
2614,東森,17,0,17,光和,2024-11-11,6380
3011,今皓,20,3,17,光和,2024-11-11,6380
00878,國泰永續高股息,20,3,17,光和,2024-11-11,6380
8390,金益鼎,16,0,16,光和,2024-11-11,6380
00937B,群益ESG投等債20,32,17,15,光和,2024-11-11,6380
2344,華邦電,15,0,15,光和,2024-11-11,6380
1710,東聯,14,0,14,光和,2024-11-11,6380
00930,永豐ESG低碳高息,13,0,13,光和,2024-11-11,6380
8936,國統,16,3,13,光和,2024-11-11,6380
00650L,復華香港正2,12,0,12,光和,2024-11-11,6380
6235,華孚,14,2,12,光和,2024-11-11,6380
8097,常珵,12,0,12,光和,2024-11-11,6380
3231,緯創,28,17,11,光和,2024-11-11,6380
00945B,凱基美國非投等債,12,1,11,光和,2024-11-11,6380
2609,陽明,75,64,11,光和,2024-11-11,6380
6869,雲豹能源,11,0,11,光和,2024-11-11,6380
00946,群益科技高息成長,10,0,10,光和,2024-11-11,6380
00634R,富邦上証反1,10,0,10,光和,2024-11-11,6380
2462,良得電,10,0,10,光和,2024-11-11,6380
2880,華南金,10,0,10,光和,2024-11-11,6380
4903,聯光通,10,0,10,光和,2024-11-11,6380
6215,和椿,10,0,10,光和,2024-11-11,6380
8064,東捷,16,6,10,光和,2024-11-11,6380
2303,聯電,12,2,10,光和,2024-11-11,6380
2408,南亞科,9,0,9,光和,2024-11-11,6380
1310,台苯,9,0,9,光和,2024-11-11,6380
2323,中環,10,1,9,光和,2024-11-11,6380
2615,萬海,364,15,349,光和,2024-11-12,6380
2801,彰銀,250,0,250,光和,2024-11-12,6380
00878,國泰永續高股息,236,0,236,光和,2024-11-12,6380
2892,第一金,85,0,85,光和,2024-11-12,6380
00753L,中信中國50正2,68,0,68,光和,2024-11-12,6380
2409,友達,54,0,54,光和,2024-11-12,6380
2356,英業達,80,33,47,光和,2024-11-12,6380
1314,中石化,46,0,46,光和,2024-11-12,6380
9105,泰金寶-DR,47,2,45,光和,2024-11-12,6380
2887,台新金,41,0,41,光和,2024-11-12,6380
2542,興富發,38,0,38,光和,2024-11-12,6380
2014,中鴻,38,0,38,光和,2024-11-12,6380
2609,陽明,76,39,37,光和,2024-11-12,6380
00929,復華台灣科技優息,37,0,37,光和,2024-11-12,6380
6116,彩晶,40,5,35,光和,2024-11-12,6380
5871,中租-KY,35,0,35,光和,2024-11-12,6380
0056,元大高股息,35,5,30,光和,2024-11-12,6380
00940,元大台灣價值高息,29,0,29,光和,2024-11-12,6380
5309,系統電,26,0,26,光和,2024-11-12,6380
1513,中興電,24,0,24,光和,2024-11-12,6380
00665L,富邦�琤肭磪囓�2,41,20,21,光和,2024-11-12,6380
1326,台化,21,0,21,光和,2024-11-12,6380
1712,興農,21,1,20,光和,2024-11-12,6380
1802,台玻,20,0,20,光和,2024-11-12,6380
2617,台航,20,0,20,光和,2024-11-12,6380
4533,協易機,20,0,20,光和,2024-11-12,6380
4566,時碩工業,20,0,20,光和,2024-11-12,6380
2002,中鋼,20,0,20,光和,2024-11-12,6380
00945B,凱基美國非投等債,20,1,19,光和,2024-11-12,6380
00930,永豐ESG低碳高息,18,0,18,光和,2024-11-12,6380
2834,臺企銀,18,0,18,光和,2024-11-12,6380
3576,聯合再生,28,10,18,光和,2024-11-12,6380
00915,凱基優選高股息30,17,0,17,光和,2024-11-12,6380
2031,新光鋼,17,0,17,光和,2024-11-12,6380
2301,光寶科,20,3,17,光和,2024-11-12,6380
5443,均豪,37,20,17,光和,2024-11-12,6380
6202,盛群,19,2,17,光和,2024-11-12,6380
2883,凱基金,16,0,16,光和,2024-11-12,6380
2332,友訊,16,0,16,光和,2024-11-12,6380
3622,洋華,16,0,16,光和,2024-11-12,6380
6288,聯嘉,22,6,16,光和,2024-11-12,6380
6592,和潤企業,15,0,15,光和,2024-11-12,6380
00919,群益台灣精選高息,39,25,14,光和,2024-11-12,6380
3234,光環,14,0,14,光和,2024-11-12,6380
2030,彰源,14,0,14,光和,2024-11-12,6380
2359,所羅門,14,0,14,光和,2024-11-12,6380
2884,玉山金,14,0,14,光和,2024-11-12,6380
3029,零壹,15,1,14,光和,2024-11-12,6380
4933,友輝,14,0,14,光和,2024-11-12,6380
00650L,復華香港正2,15,2,13,光和,2024-11-12,6380
00887,永豐中國科技50大,221,1,220,光和,2024-11-13,6380
00878,國泰永續高股息,215,6,209,光和,2024-11-13,6380
2615,萬海,113,9,104,光和,2024-11-13,6380
2834,臺企銀,114,10,104,光和,2024-11-13,6380
2105,正新,295,211,84,光和,2024-11-13,6380
00937B,群益ESG投等債20,74,0,74,光和,2024-11-13,6380
2609,陽明,68,5,63,光和,2024-11-13,6380
0056,元大高股息,61,0,61,光和,2024-11-13,6380
4909,新復興,53,1,52,光和,2024-11-13,6380
00942B,台新美A公司債20+,50,0,50,光和,2024-11-13,6380
00725B,國泰投資級公司債,40,0,40,光和,2024-11-13,6380
2014,中鴻,38,0,38,光和,2024-11-13,6380
4526,東台,34,0,34,光和,2024-11-13,6380
00919,群益台灣精選高息,32,0,32,光和,2024-11-13,6380
00931B,統一美債20年,30,0,30,光和,2024-11-13,6380
00957B,兆豐US優選投等債,30,0,30,光和,2024-11-13,6380
1307,三芳,30,0,30,光和,2024-11-13,6380
2349,錸德,52,25,27,光和,2024-11-13,6380
00720B,元大投資級公司債,25,0,25,光和,2024-11-13,6380
1101,台泥,24,0,24,光和,2024-11-13,6380
2303,聯電,26,2,24,光和,2024-11-13,6380
2409,友達,25,1,24,光和,2024-11-13,6380
00952,凱基台灣AI50,20,0,20,光和,2024-11-13,6380
2520,冠德,20,0,20,光和,2024-11-13,6380
00679B,元大美債20年,17,0,17,光和,2024-11-13,6380
1449,佳和,24,7,17,光和,2024-11-13,6380
00915,凱基優選高股息30,16,0,16,光和,2024-11-13,6380
00953B,群益優選非投等債,15,0,15,光和,2024-11-13,6380
2328,廣宇,20,5,15,光和,2024-11-13,6380
3312,弘憶股,15,0,15,光和,2024-11-13,6380
4956,光鋐,17,2,15,光和,2024-11-13,6380
6770,力積電,17,2,15,光和,2024-11-13,6380
00945B,凱基美國非投等債,14,0,14,光和,2024-11-13,6380
2034,允強,14,0,14,光和,2024-11-13,6380
2356,英業達,18,4,14,光和,2024-11-13,6380
2497,怡利電,14,0,14,光和,2024-11-13,6380
00932,兆豐永續高息等權,13,0,13,光和,2024-11-13,6380
2344,華邦電,18,5,13,光和,2024-11-13,6380
00882,中信中國高股息,18,5,13,光和,2024-11-13,6380
00715L,期街口布蘭特正2,13,0,13,光和,2024-11-13,6380
6505,台塑化,15,3,12,光和,2024-11-13,6380
2106,建大,12,0,12,光和,2024-11-13,6380
3189,景碩,12,1,11,光和,2024-11-13,6380
3481,群創,13,2,11,光和,2024-11-13,6380
00948B,中信優息投資級債,10,0,10,光和,2024-11-13,6380
2408,南亞科,11,1,10,光和,2024-11-13,6380
2891,中信金,10,0,10,光和,2024-11-13,6380
1712,興農,10,0,10,光和,2024-11-13,6380
6116,彩晶,10,0,10,光和,2024-11-13,6380
6125,廣運,12,2,10,光和,2024-11-13,6380
00878,國泰永續高股息,309,19,290,光和,2024-11-14,6380
3481,群創,142,5,137,光和,2024-11-14,6380
2337,旺宏,108,0,108,光和,2024-11-14,6380
2303,聯電,93,2,91,光和,2024-11-14,6380
00951,台新日本半導體,62,0,62,光和,2024-11-14,6380
0056,元大高股息,57,4,53,光和,2024-11-14,6380
2409,友達,53,2,51,光和,2024-11-14,6380
6016,康和證,55,4,51,光和,2024-11-14,6380
00954,中信日本半導體,50,0,50,光和,2024-11-14,6380
6026,福邦證,50,0,50,光和,2024-11-14,6380
1471,首利,43,2,41,光和,2024-11-14,6380
1785,光洋科,42,1,41,光和,2024-11-14,6380
2027,大成鋼,36,1,35,光和,2024-11-14,6380
3581,博磊,36,2,34,光和,2024-11-14,6380
00932,兆豐永續高息等權,33,0,33,光和,2024-11-14,6380
2892,第一金,33,0,33,光和,2024-11-14,6380
00929,復華台灣科技優息,32,0,32,光和,2024-11-14,6380
2344,華邦電,44,13,31,光和,2024-11-14,6380
00933B,國泰10Y+金融債,30,0,30,光和,2024-11-14,6380
2911,麗嬰房,30,0,30,光和,2024-11-14,6380
00915,凱基優選高股息30,28,0,28,光和,2024-11-14,6380
2374,佳能,28,1,27,光和,2024-11-14,6380
4938,和碩,28,1,27,光和,2024-11-14,6380
2408,南亞科,26,1,25,光和,2024-11-14,6380
2034,允強,28,4,24,光和,2024-11-14,6380
00679B,元大美債20年,24,0,24,光和,2024-11-14,6380
2312,金寶,41,18,23,光和,2024-11-14,6380
3062,建漢,36,14,22,光和,2024-11-14,6380
2101,南港,25,4,21,光和,2024-11-14,6380
00957B,兆豐US優選投等債,20,0,20,光和,2024-11-14,6380
2317,鴻海,22,2,20,光和,2024-11-14,6380
00919,群益台灣精選高息,19,0,19,光和,2024-11-14,6380
00931B,統一美債20年,20,2,18,光和,2024-11-14,6380
5871,中租-KY,19,1,18,光和,2024-11-14,6380
1810,和成,18,0,18,光和,2024-11-14,6380
1326,台化,17,0,17,光和,2024-11-14,6380
1312,國喬,16,0,16,光和,2024-11-14,6380
3032,偉訓,15,0,15,光和,2024-11-14,6380
00937B,群益ESG投等債20,29,15,14,光和,2024-11-14,6380
2609,陽明,17,4,13,光和,2024-11-14,6380
8110,華東,13,0,13,光和,2024-11-14,6380
2603,長榮,16,4,12,光和,2024-11-14,6380
6505,台塑化,12,0,12,光和,2024-11-14,6380
2515,中工,12,0,12,光和,2024-11-14,6380
1301,台塑,14,3,11,光和,2024-11-14,6380
2605,新興,11,0,11,光和,2024-11-14,6380
2880,華南金,11,0,11,光和,2024-11-14,6380
4564,元翎,11,0,11,光和,2024-11-14,6380
6548,長科*,11,0,11,光和,2024-11-14,6380
8358,金居,13,2,11,光和,2024-11-14,6380
2317,鴻海,207,13,194,光和,2024-11-15,6380
00887,永豐中國科技50大,143,0,143,光和,2024-11-15,6380
2371,大同,150,24,126,光和,2024-11-15,6380
00878,國泰永續高股息,99,0,99,光和,2024-11-15,6380
2106,建大,105,7,98,光和,2024-11-15,6380
2615,萬海,241,167,74,光和,2024-11-15,6380
2885,元大金,111,56,55,光和,2024-11-15,6380
2382,廣達,59,5,54,光和,2024-11-15,6380
1528,恩德,51,1,50,光和,2024-11-15,6380
00937B,群益ESG投等債20,33,0,33,光和,2024-11-15,6380
2880,華南金,32,0,32,光和,2024-11-15,6380
3231,緯創,29,5,24,光和,2024-11-15,6380
2324,仁寶,34,11,23,光和,2024-11-15,6380
2316,楠梓電,21,0,21,光和,2024-11-15,6380
4960,誠美材,20,0,20,光和,2024-11-15,6380
2605,新興,21,2,19,光和,2024-11-15,6380
00934,中信成長高股息,17,0,17,光和,2024-11-15,6380
2809,京城銀,16,0,16,光和,2024-11-15,6380
00953B,群益優選非投等債,15,0,15,光和,2024-11-15,6380
0056,元大高股息,17,3,14,光和,2024-11-15,6380
3706,神達,41,28,13,光和,2024-11-15,6380
1449,佳和,12,0,12,光和,2024-11-15,6380
8064,東捷,12,0,12,光和,2024-11-15,6380
1605,華新,11,0,11,光和,2024-11-15,6380
00933B,國泰10Y+金融債,11,0,11,光和,2024-11-15,6380
00637L,元大滬深300正2,16,5,11,光和,2024-11-15,6380
2027,大成鋼,11,0,11,光和,2024-11-15,6380
8033,雷虎,11,0,11,光和,2024-11-15,6380
8107,大億金茂,11,0,11,光和,2024-11-15,6380
00696B,富邦美債20年,10,0,10,光和,2024-11-15,6380
2390,云辰,10,0,10,光和,2024-11-15,6380
2397,友通,10,0,10,光和,2024-11-15,6380
6763,綠界科技*,10,0,10,光和,2024-11-15,6380
00929,復華台灣科技優息,31,22,9,光和,2024-11-15,6380
1471,首利,10,1,9,光和,2024-11-15,6380
2472,立隆電,10,1,9,光和,2024-11-15,6380
2882,國泰金,10,1,9,光和,2024-11-15,6380
3293,鈊象,8,0,8,光和,2024-11-15,6380
2303,聯電,10,2,8,光和,2024-11-15,6380
1532,勤美,8,0,8,光和,2024-11-15,6380
5258,虹堡,8,0,8,光和,2024-11-15,6380
3090,日電貿,9,2,7,光和,2024-11-15,6380
2402,毅嘉,8,1,7,光和,2024-11-15,6380
00675L,富邦臺灣加權正2,7,0,7,光和,2024-11-15,6380
1785,光洋科,7,0,7,光和,2024-11-15,6380
6150,撼訊,7,0,7,光和,2024-11-15,6380
00930,永豐ESG低碳高息,6,0,6,光和,2024-11-15,6380
00713,元大台灣高息低波,6,0,6,光和,2024-11-15,6380
00692,富邦公司治理,8,2,6,光和,2024-11-15,6380
2332,友訊,9,3,6,光和,2024-11-15,6380
00878,國泰永續高股息,101,3,98,光和,2024-11-18,6380
2618,長榮航,72,6,66,光和,2024-11-18,6380
00932,兆豐永續高息等權,36,0,36,光和,2024-11-18,6380
00915,凱基優選高股息30,35,0,35,光和,2024-11-18,6380
2312,金寶,47,12,35,光和,2024-11-18,6380
2354,鴻準,43,9,34,光和,2024-11-18,6380
2881,富邦金,32,0,32,光和,2024-11-18,6380
4526,東台,30,0,30,光和,2024-11-18,6380
2929,淘帝-KY,29,0,29,光和,2024-11-18,6380
2356,英業達,35,7,28,光和,2024-11-18,6380
8064,東捷,27,1,26,光和,2024-11-18,6380
0056,元大高股息,25,0,25,光和,2024-11-18,6380
3689,湧德,26,1,25,光和,2024-11-18,6380
2392,正崴,32,7,25,光和,2024-11-18,6380
2034,允強,23,0,23,光和,2024-11-18,6380
9105,泰金寶-DR,63,40,23,光和,2024-11-18,6380
00679B,元大美債20年,25,4,21,光和,2024-11-18,6380
00948B,中信優息投資級債,21,0,21,光和,2024-11-18,6380
00795B,中信美國公債20年,21,0,21,光和,2024-11-18,6380
2883,凱基金,21,0,21,光和,2024-11-18,6380
8383,千附,21,0,21,光和,2024-11-18,6380
6005,群益證,20,0,20,光和,2024-11-18,6380
00918,大華優利高填息30,20,0,20,光和,2024-11-18,6380
2371,大同,19,0,19,光和,2024-11-18,6380
8183,精星,19,0,19,光和,2024-11-18,6380
00953B,群益優選非投等債,15,0,15,光和,2024-11-18,6380
3202,樺晟,15,0,15,光和,2024-11-18,6380
6246,臺龍,15,0,15,光和,2024-11-18,6380
00943,兆豐電子高息等權,14,0,14,光和,2024-11-18,6380
2316,楠梓電,14,1,13,光和,2024-11-18,6380
2344,華邦電,13,0,13,光和,2024-11-18,6380
00930,永豐ESG低碳高息,12,0,12,光和,2024-11-18,6380
00639,富邦深100,12,0,12,光和,2024-11-18,6380
1528,恩德,12,0,12,光和,2024-11-18,6380
3024,憶聲,16,4,12,光和,2024-11-18,6380
1785,光洋科,12,1,11,光和,2024-11-18,6380
4533,協易機,11,0,11,光和,2024-11-18,6380
5355,佳總,11,0,11,光和,2024-11-18,6380
5603,陸海,11,0,11,光和,2024-11-18,6380
00945B,凱基美國非投等債,10,0,10,光和,2024-11-18,6380
2603,長榮,10,0,10,光和,2024-11-18,6380
00665L,富邦�琤肭磪囓�2,10,0,10,光和,2024-11-18,6380
00715L,期街口布蘭特正2,10,0,10,光和,2024-11-18,6380
3481,群創,15,5,10,光和,2024-11-18,6380
6152,百一,10,0,10,光和,2024-11-18,6380
6244,茂迪,10,0,10,光和,2024-11-18,6380
9935,慶豐富,10,0,10,光和,2024-11-18,6380
00713,元大台灣高息低波,8,0,8,光和,2024-11-18,6380
3231,緯創,9,1,8,光和,2024-11-18,6380
2359,所羅門,8,0,8,光和,2024-11-18,6380
00637L,元大滬深300正2,335,210,125,光和,2024-11-19,6380
00878,國泰永續高股息,48,4,44,光和,2024-11-19,6380
3481,群創,34,3,31,光和,2024-11-19,6380
2382,廣達,28,1,27,光和,2024-11-19,6380
3231,緯創,26,3,23,光和,2024-11-19,6380
2349,錸德,55,33,22,光和,2024-11-19,6380
2316,楠梓電,21,0,21,光和,2024-11-19,6380
2317,鴻海,37,20,17,光和,2024-11-19,6380
00753L,中信中國50正2,15,0,15,光和,2024-11-19,6380
00665L,富邦�琤肭磪囓�2,15,0,15,光和,2024-11-19,6380
2363,矽統,17,3,14,光和,2024-11-19,6380
8111,立��,13,0,13,光和,2024-11-19,6380
4909,新復興,12,0,12,光和,2024-11-19,6380
3024,憶聲,11,0,11,光和,2024-11-19,6380
8929,富堡,11,0,11,光和,2024-11-19,6380
00930,永豐ESG低碳高息,10,0,10,光和,2024-11-19,6380
1603,華電,10,0,10,光和,2024-11-19,6380
2441,超豐,10,0,10,光和,2024-11-19,6380
3306,鼎天,10,0,10,光和,2024-11-19,6380
4904,遠傳,10,0,10,光和,2024-11-19,6380
6005,群益證,10,0,10,光和,2024-11-19,6380
8374,羅昇,10,0,10,光和,2024-11-19,6380
9105,泰金寶-DR,51,42,9,光和,2024-11-19,6380
00877,復華中國5G,9,0,9,光和,2024-11-19,6380
2303,聯電,10,1,9,光和,2024-11-19,6380
00864B,中信美國公債0-1,8,0,8,光和,2024-11-19,6380
2314,台揚,8,0,8,光和,2024-11-19,6380
2498,宏達電,8,0,8,光和,2024-11-19,6380
2929,淘帝-KY,10,2,8,光和,2024-11-19,6380
5880,合庫金,9,1,8,光和,2024-11-19,6380
6505,台塑化,8,0,8,光和,2024-11-19,6380
9921,巨大,8,0,8,光和,2024-11-19,6380
1532,勤美,7,0,7,光和,2024-11-19,6380
2034,允強,7,0,7,光和,2024-11-19,6380
2449,京元電子,8,1,7,光和,2024-11-19,6380
2480,敦陽科,7,0,7,光和,2024-11-19,6380
5347,世界,7,0,7,光和,2024-11-19,6380
8249,菱光,15,8,7,光和,2024-11-19,6380
1711,永光,13,7,6,光和,2024-11-19,6380
2884,玉山金,6,0,6,光和,2024-11-19,6380
8215,明基材,6,0,6,光和,2024-11-19,6380
0056,元大高股息,5,0,5,光和,2024-11-19,6380
00915,凱基優選高股息30,5,0,5,光和,2024-11-19,6380
3006,晶豪科,6,1,5,光和,2024-11-19,6380
2312,金寶,49,44,5,光和,2024-11-19,6380
00675L,富邦臺灣加權正2,5,0,5,光和,2024-11-19,6380
1710,東聯,5,0,5,光和,2024-11-19,6380
2324,仁寶,7,2,5,光和,2024-11-19,6380
2426,鼎元,5,0,5,光和,2024-11-19,6380
2527,宏璟,5,0,5,光和,2024-11-19,6380
2354,鴻準,138,19,119,光和,2024-11-20,6380
2303,聯電,134,16,118,光和,2024-11-20,6380
00632R,元大台灣50反1,100,0,100,光和,2024-11-20,6380
3015,全漢,68,10,58,光和,2024-11-20,6380
2356,英業達,39,9,30,光和,2024-11-20,6380
1612,宏泰,30,0,30,光和,2024-11-20,6380
2312,金寶,26,2,24,光和,2024-11-20,6380
3706,神達,49,27,22,光和,2024-11-20,6380
00878,國泰永續高股息,23,2,21,光和,2024-11-20,6380
00936,台新永續高息中小,20,0,20,光和,2024-11-20,6380
00919,群益台灣精選高息,30,10,20,光和,2024-11-20,6380
00918,大華優利高填息30,20,0,20,光和,2024-11-20,6380
3716,中化控股,20,1,19,光和,2024-11-20,6380
2349,錸德,27,10,17,光和,2024-11-20,6380
2408,南亞科,17,0,17,光和,2024-11-20,6380
2317,鴻海,23,6,17,光和,2024-11-20,6380
4960,誠美材,16,0,16,光和,2024-11-20,6380
1584,精剛,15,0,15,光和,2024-11-20,6380
3036,文曄,14,0,14,光和,2024-11-20,6380
00679B,元大美債20年,14,3,11,光和,2024-11-20,6380
1449,佳和,12,1,11,光和,2024-11-20,6380
1477,聚陽,11,1,10,光和,2024-11-20,6380
1710,東聯,10,0,10,光和,2024-11-20,6380
2413,環科,13,3,10,光和,2024-11-20,6380
2801,彰銀,10,0,10,光和,2024-11-20,6380
3006,晶豪科,10,0,10,光和,2024-11-20,6380
6244,茂迪,10,0,10,光和,2024-11-20,6380
2034,允強,9,0,9,光和,2024-11-20,6380
2401,凌陽,9,0,9,光和,2024-11-20,6380
2426,鼎元,10,1,9,光和,2024-11-20,6380
4533,協易機,10,1,9,光和,2024-11-20,6380
2449,京元電子,9,0,9,光和,2024-11-20,6380
00930,永豐ESG低碳高息,8,0,8,光和,2024-11-20,6380
2062,橋椿,8,0,8,光和,2024-11-20,6380
3450,聯鈞,9,1,8,光和,2024-11-20,6380
00929,復華台灣科技優息,16,9,7,光和,2024-11-20,6380
1611,中電,7,0,7,光和,2024-11-20,6380
2419,仲琦,7,0,7,光和,2024-11-20,6380
2929,淘帝-KY,7,0,7,光和,2024-11-20,6380
6770,力積電,7,0,7,光和,2024-11-20,6380
3013,晟銘電,7,0,7,光和,2024-11-20,6380
9105,泰金寶-DR,36,29,7,光和,2024-11-20,6380
3715,定穎投控,7,1,6,光和,2024-11-20,6380
2454,聯發科,12,6,6,光和,2024-11-20,6380
1532,勤美,6,0,6,光和,2024-11-20,6380
1802,台玻,6,0,6,光和,2024-11-20,6380
3227,原相,6,0,6,光和,2024-11-20,6380
5243,乙盛-KY,6,0,6,光和,2024-11-20,6380
2371,大同,5,0,5,光和,2024-11-20,6380
2633,台灣高鐵,5,0,5,光和,2024-11-20,6380
2317,鴻海,104,2,102,光和,2024-11-21,6380
2204,中華,74,6,68,光和,2024-11-21,6380
2515,中工,60,0,60,光和,2024-11-21,6380
8249,菱光,75,17,58,光和,2024-11-21,6380
2106,建大,52,0,52,光和,2024-11-21,6380
912000,晨訊科-DR,50,0,50,光和,2024-11-21,6380
00878,國泰永續高股息,48,0,48,光和,2024-11-21,6380
2354,鴻準,81,41,40,光和,2024-11-21,6380
2332,友訊,50,11,39,光和,2024-11-21,6380
3481,群創,21,1,20,光和,2024-11-21,6380
6282,康舒,29,9,20,光和,2024-11-21,6380
1528,恩德,21,1,20,光和,2024-11-21,6380
2406,國碩,20,0,20,光和,2024-11-21,6380
2867,三商壽,50,30,20,光和,2024-11-21,6380
3447,展達,24,4,20,光和,2024-11-21,6380
2344,華邦電,18,0,18,光和,2024-11-21,6380
9105,泰金寶-DR,69,53,16,光和,2024-11-21,6380
3015,全漢,15,1,14,光和,2024-11-21,6380
6669,緯穎,31,18,13,光和,2024-11-21,6380
00887,永豐中國科技50大,12,0,12,光和,2024-11-21,6380
1446,宏和,12,0,12,光和,2024-11-21,6380
5603,陸海,12,0,12,光和,2024-11-21,6380
2330,台積電,12,0,12,光和,2024-11-21,6380
1301,台塑,11,0,11,光和,2024-11-21,6380
00937B,群益ESG投等債20,11,0,11,光和,2024-11-21,6380
00930,永豐ESG低碳高息,11,0,11,光和,2024-11-21,6380
2007,燁興,10,0,10,光和,2024-11-21,6380
2884,玉山金,10,0,10,光和,2024-11-21,6380
3209,全科,10,0,10,光和,2024-11-21,6380
006208,富邦台50,10,0,10,光和,2024-11-21,6380
1584,精剛,10,1,9,光和,2024-11-21,6380
2905,三商,9,0,9,光和,2024-11-21,6380
00919,群益台灣精選高息,40,32,8,光和,2024-11-21,6380
0056,元大高股息,8,0,8,光和,2024-11-21,6380
00927,群益半導體收益,8,0,8,光和,2024-11-21,6380
00940,元大台灣價值高息,8,0,8,光和,2024-11-21,6380
3013,晟銘電,9,1,8,光和,2024-11-21,6380
1711,永光,27,20,7,光和,2024-11-21,6380
1718,中纖,8,1,7,光和,2024-11-21,6380
2353,宏��,7,0,7,光和,2024-11-21,6380
3047,訊舟,7,0,7,光和,2024-11-21,6380
2891,中信金,7,0,7,光和,2024-11-21,6380
2646,星宇航空,10,4,6,光和,2024-11-21,6380
1449,佳和,10,4,6,光和,2024-11-21,6380
2474,可成,6,0,6,光和,2024-11-21,6380
3540,曜越,6,0,6,光和,2024-11-21,6380
2890,永豐金,5,0,5,光和,2024-11-21,6380
00637L,元大滬深300正2,5,0,5,光和,2024-11-21,6380
1605,華新,5,0,5,光和,2024-11-21,6380
1810,和成,5,0,5,光和,2024-11-21,6380
2615,萬海,710,4,706,光和,2024-11-22,6380
00632R,元大台灣50反1,240,100,140,光和,2024-11-22,6380
911868,同方友友-DR,104,0,104,光和,2024-11-22,6380
00637L,元大滬深300正2,298,210,88,光和,2024-11-22,6380
9105,泰金寶-DR,137,77,60,光和,2024-11-22,6380
00753L,中信中國50正2,40,0,40,光和,2024-11-22,6380
6134,萬旭,45,6,39,光和,2024-11-22,6380
2609,陽明,64,32,32,光和,2024-11-22,6380
6770,力積電,28,1,27,光和,2024-11-22,6380
1540,喬福,30,4,26,光和,2024-11-22,6380
3625,西勝,26,0,26,光和,2024-11-22,6380
6282,康舒,23,0,23,光和,2024-11-22,6380
00945B,凱基美國非投等債,20,0,20,光和,2024-11-22,6380
1612,宏泰,20,0,20,光和,2024-11-22,6380
3031,佰鴻,18,0,18,光和,2024-11-22,6380
2867,三商壽,17,0,17,光和,2024-11-22,6380
2353,宏��,16,0,16,光和,2024-11-22,6380
1603,華電,15,0,15,光和,2024-11-22,6380
2633,台灣高鐵,15,0,15,光和,2024-11-22,6380
2356,英業達,20,6,14,光和,2024-11-22,6380
3323,加百裕,17,3,14,光和,2024-11-22,6380
00885,富邦越南,12,0,12,光和,2024-11-22,6380
2524,京城,12,0,12,光和,2024-11-22,6380
00915,凱基優選高股息30,11,0,11,光和,2024-11-22,6380
00935,野村臺灣新科技50,10,0,10,光和,2024-11-22,6380
00665L,富邦�琤肭磪囓�2,10,0,10,光和,2024-11-22,6380
3062,建漢,12,2,10,光和,2024-11-22,6380
3360,尚立,10,0,10,光和,2024-11-22,6380
3535,晶彩科,10,0,10,光和,2024-11-22,6380
1710,東聯,9,0,9,光和,2024-11-22,6380
1735,日勝化,9,0,9,光和,2024-11-22,6380
4903,聯光通,13,4,9,光和,2024-11-22,6380
2062,橋椿,11,3,8,光和,2024-11-22,6380
4720,德淵,8,0,8,光和,2024-11-22,6380
4956,光鋐,9,1,8,光和,2024-11-22,6380
2324,仁寶,10,3,7,光和,2024-11-22,6380
2344,華邦電,10,3,7,光和,2024-11-22,6380
3702,大聯大,7,0,7,光和,2024-11-22,6380
3551,世禾,7,1,6,光和,2024-11-22,6380
1536,和大,8,2,6,光和,2024-11-22,6380
2208,台船,6,0,6,光和,2024-11-22,6380
2646,星宇航空,7,1,6,光和,2024-11-22,6380
3447,展達,14,8,6,光和,2024-11-22,6380
4139,馬光-KY,6,0,6,光和,2024-11-22,6380
00673R,期元大S＆P原油反1,5,0,5,光和,2024-11-22,6380
0056,元大高股息,8,3,5,光和,2024-11-22,6380
1584,精剛,5,0,5,光和,2024-11-22,6380
1616,億泰,6,1,5,光和,2024-11-22,6380
2349,錸德,20,15,5,光和,2024-11-22,6380
2377,微星,5,0,5,光和,2024-11-22,6380
2615,萬海,470,3,467,光和,2024-11-25,6380
2312,金寶,240,57,183,光和,2024-11-25,6380
00632R,元大台灣50反1,111,0,111,光和,2024-11-25,6380
00919,群益台灣精選高息,110,5,105,光和,2024-11-25,6380
1815,富喬,137,36,101,光和,2024-11-25,6380
00945B,凱基美國非投等債,100,0,100,光和,2024-11-25,6380
2371,大同,99,7,92,光和,2024-11-25,6380
2106,建大,150,70,80,光和,2024-11-25,6380
9105,泰金寶-DR,274,200,74,光和,2024-11-25,6380
00887,永豐中國科技50大,59,2,57,光和,2024-11-25,6380
00637L,元大滬深300正2,331,298,33,光和,2024-11-25,6380
00753L,中信中國50正2,30,0,30,光和,2024-11-25,6380
8096,擎亞,31,4,27,光和,2024-11-25,6380
6770,力積電,24,0,24,光和,2024-11-25,6380
2618,長榮航,24,2,22,光和,2024-11-25,6380
00953B,群益優選非投等債,20,0,20,光和,2024-11-25,6380
2316,楠梓電,20,0,20,光和,2024-11-25,6380
2609,陽明,43,23,20,光和,2024-11-25,6380
4157,太景*-KY,20,0,20,光和,2024-11-25,6380
1314,中石化,45,29,16,光和,2024-11-25,6380
1569,濱川,16,1,15,光和,2024-11-25,6380
1720,生達,15,0,15,光和,2024-11-25,6380
00673R,期元大S＆P原油反1,14,0,14,光和,2024-11-25,6380
5347,世界,14,0,14,光和,2024-11-25,6380
5426,振發,15,1,14,光和,2024-11-25,6380
1563,巧新,17,5,12,光和,2024-11-25,6380
3033,威健,12,0,12,光和,2024-11-25,6380
3689,湧德,15,3,12,光和,2024-11-25,6380
6153,嘉聯益,12,0,12,光和,2024-11-25,6380
8111,立��,15,3,12,光和,2024-11-25,6380
00650L,復華香港正2,10,0,10,光和,2024-11-25,6380
1809,中釉,12,2,10,光和,2024-11-25,6380
2388,威盛,14,4,10,光和,2024-11-25,6380
2405,輔信,11,1,10,光和,2024-11-25,6380
4746,台耀,10,0,10,光和,2024-11-25,6380
5512,力麒,10,0,10,光和,2024-11-25,6380
8249,菱光,12,2,10,光和,2024-11-25,6380
00940,元大台灣價值高息,20,11,9,光和,2024-11-25,6380
1301,台塑,10,1,9,光和,2024-11-25,6380
2449,京元電子,14,6,8,光和,2024-11-25,6380
6139,亞翔,17,9,8,光和,2024-11-25,6380
2330,台積電,9,1,8,光和,2024-11-25,6380
2603,長榮,12,5,7,光和,2024-11-25,6380
00877,復華中國5G,7,0,7,光和,2024-11-25,6380
1449,佳和,14,7,7,光和,2024-11-25,6380
2344,華邦電,9,2,7,光和,2024-11-25,6380
2646,星宇航空,6,0,6,光和,2024-11-25,6380
1618,合機,6,0,6,光和,2024-11-25,6380
3030,德律,6,0,6,光和,2024-11-25,6380
3031,佰鴻,6,0,6,光和,2024-11-25,6380
2615,萬海,163,7,156,光和,2024-11-26,6380
2317,鴻海,164,10,154,光和,2024-11-26,6380
00878,國泰永續高股息,126,2,124,光和,2024-11-26,6380
00953B,群益優選非投等債,57,0,57,光和,2024-11-26,6380
0056,元大高股息,57,3,54,光和,2024-11-26,6380
1802,台玻,53,1,52,光和,2024-11-26,6380
9105,泰金寶-DR,66,15,51,光和,2024-11-26,6380
1618,合機,42,2,40,光和,2024-11-26,6380
2316,楠梓電,41,3,38,光和,2024-11-26,6380
00919,群益台灣精選高息,38,1,37,光和,2024-11-26,6380
3231,緯創,43,10,33,光和,2024-11-26,6380
2312,金寶,52,20,32,光和,2024-11-26,6380
1528,恩德,29,0,29,光和,2024-11-26,6380
00712,復華富時不動產,30,3,27,光和,2024-11-26,6380
2106,建大,26,0,26,光和,2024-11-26,6380
2498,宏達電,37,14,23,光和,2024-11-26,6380
2646,星宇航空,17,0,17,光和,2024-11-26,6380
3706,神達,34,17,17,光和,2024-11-26,6380
6558,興能高,20,4,16,光和,2024-11-26,6380
1809,中釉,15,0,15,光和,2024-11-26,6380
2884,玉山金,15,0,15,光和,2024-11-26,6380
2371,大同,17,3,14,光和,2024-11-26,6380
2344,華邦電,15,2,13,光和,2024-11-26,6380
2801,彰銀,13,0,13,光和,2024-11-26,6380
2464,盟立,16,4,12,光和,2024-11-26,6380
2105,正新,12,0,12,光和,2024-11-26,6380
00673R,期元大S＆P原油反1,20,9,11,光和,2024-11-26,6380
2605,新興,12,1,11,光和,2024-11-26,6380
3511,矽瑪,15,4,11,光和,2024-11-26,6380
00639,富邦深100,10,0,10,光和,2024-11-26,6380
2880,華南金,10,0,10,光和,2024-11-26,6380
2881,富邦金,11,1,10,光和,2024-11-26,6380
2883,凱基金,10,0,10,光和,2024-11-26,6380
2887,台新金,10,0,10,光和,2024-11-26,6380
2929,淘帝-KY,10,0,10,光和,2024-11-26,6380
3597,映興,20,10,10,光和,2024-11-26,6380
6016,康和證,10,0,10,光和,2024-11-26,6380
2392,正崴,16,6,10,光和,2024-11-26,6380
2408,南亞科,9,0,9,光和,2024-11-26,6380
4903,聯光通,9,0,9,光和,2024-11-26,6380
9904,寶成,9,0,9,光和,2024-11-26,6380
2547,日勝生,10,2,8,光和,2024-11-26,6380
2609,陽明,24,16,8,光和,2024-11-26,6380
3322,建舜電,8,0,8,光和,2024-11-26,6380
3625,西勝,9,1,8,光和,2024-11-26,6380
4576,大銀微系統,8,0,8,光和,2024-11-26,6380
00905,FT臺灣Smart,7,0,7,光和,2024-11-26,6380
00938,凱基優選30,6,0,6,光和,2024-11-26,6380
1717,長興,6,0,6,光和,2024-11-26,6380
3078,僑威,6,0,6,光和,2024-11-26,6380
00878,國泰永續高股息,354,30,324,光和,2024-11-27,6380
0056,元大高股息,189,1,188,光和,2024-11-27,6380
2615,萬海,77,13,64,光和,2024-11-27,6380
00887,永豐中國科技50大,65,4,61,光和,2024-11-27,6380
1307,三芳,54,0,54,光和,2024-11-27,6380
00961,FT臺灣永續高息,50,0,50,光和,2024-11-27,6380
2106,建大,50,0,50,光和,2024-11-27,6380
2426,鼎元,48,1,47,光和,2024-11-27,6380
3231,緯創,50,4,46,光和,2024-11-27,6380
2312,金寶,108,67,41,光和,2024-11-27,6380
6770,力積電,39,1,38,光和,2024-11-27,6380
2317,鴻海,42,6,36,光和,2024-11-27,6380
00953B,群益優選非投等債,35,0,35,光和,2024-11-27,6380
00940,元大台灣價值高息,30,0,30,光和,2024-11-27,6380
2515,中工,30,0,30,光和,2024-11-27,6380
2344,華邦電,117,88,29,光和,2024-11-27,6380
3323,加百裕,44,20,24,光和,2024-11-27,6380
1712,興農,23,0,23,光和,2024-11-27,6380
4526,東台,29,7,22,光和,2024-11-27,6380
00753L,中信中國50正2,20,0,20,光和,2024-11-27,6380
2472,立隆電,20,0,20,光和,2024-11-27,6380
9935,慶豐富,20,0,20,光和,2024-11-27,6380
2002,中鋼,19,0,19,光和,2024-11-27,6380
1536,和大,44,27,17,光和,2024-11-27,6380
6962,ITH-KY,17,0,17,光和,2024-11-27,6380
9945,潤泰新,17,0,17,光和,2024-11-27,6380
2881,富邦金,15,0,15,光和,2024-11-27,6380
1720,生達,15,0,15,光和,2024-11-27,6380
3419,譁裕,15,0,15,光和,2024-11-27,6380
3511,矽瑪,22,7,15,光和,2024-11-27,6380
2332,友訊,38,24,14,光和,2024-11-27,6380
3033,威健,14,0,14,光和,2024-11-27,6380
00915,凱基優選高股息30,15,2,13,光和,2024-11-27,6380
00930,永豐ESG低碳高息,13,0,13,光和,2024-11-27,6380
2605,新興,13,0,13,光和,2024-11-27,6380
2330,台積電,12,0,12,光和,2024-11-27,6380
1605,華新,12,0,12,光和,2024-11-27,6380
6505,台塑化,12,0,12,光和,2024-11-27,6380
1711,永光,12,0,12,光和,2024-11-27,6380
2349,錸德,14,2,12,光和,2024-11-27,6380
1326,台化,11,0,11,光和,2024-11-27,6380
2888,新光金,20,9,11,光和,2024-11-27,6380
3105,穩懋,11,0,11,光和,2024-11-27,6380
5309,系統電,33,22,11,光和,2024-11-27,6380
5907,大洋-KY,11,0,11,光和,2024-11-27,6380
8054,安國,11,0,11,光和,2024-11-27,6380
6669,緯穎,18,8,10,光和,2024-11-27,6380
1434,福懋,10,0,10,光和,2024-11-27,6380
2034,允強,10,0,10,光和,2024-11-27,6380
2316,楠梓電,10,0,10,光和,2024-11-27,6380
00878,國泰永續高股息,121,2,119,光和,2024-11-28,6380
2312,金寶,156,38,118,光和,2024-11-28,6380
2106,建大,100,0,100,光和,2024-11-28,6380
3031,佰鴻,70,0,70,光和,2024-11-28,6380
2332,友訊,71,10,61,光和,2024-11-28,6380
00919,群益台灣精選高息,60,2,58,光和,2024-11-28,6380
00929,復華台灣科技優息,49,3,46,光和,2024-11-28,6380
00922,國泰台灣領袖50,43,0,43,光和,2024-11-28,6380
0056,元大高股息,48,13,35,光和,2024-11-28,6380
1605,華新,33,0,33,光和,2024-11-28,6380
4510,高鋒,56,25,31,光和,2024-11-28,6380
00637L,元大滬深300正2,330,300,30,光和,2024-11-28,6380
2344,華邦電,82,55,27,光和,2024-11-28,6380
00675L,富邦臺灣加權正2,30,8,22,光和,2024-11-28,6380
1612,宏泰,20,0,20,光和,2024-11-28,6380
2030,彰源,20,0,20,光和,2024-11-28,6380
3419,譁裕,23,3,20,光和,2024-11-28,6380
9935,慶豐富,20,0,20,光和,2024-11-28,6380
2354,鴻準,44,25,19,光和,2024-11-28,6380
00915,凱基優選高股息30,20,2,18,光和,2024-11-28,6380
2891,中信金,18,0,18,光和,2024-11-28,6380
1301,台塑,18,1,17,光和,2024-11-28,6380
2883,凱基金,20,4,16,光和,2024-11-28,6380
3211,順達,16,0,16,光和,2024-11-28,6380
1402,遠東新,15,0,15,光和,2024-11-28,6380
00961,FT臺灣永續高息,14,0,14,光和,2024-11-28,6380
1710,東聯,14,0,14,光和,2024-11-28,6380
3312,弘憶股,14,1,13,光和,2024-11-28,6380
2408,南亞科,13,0,13,光和,2024-11-28,6380
1513,中興電,15,3,12,光和,2024-11-28,6380
00940,元大台灣價值高息,12,0,12,光和,2024-11-28,6380
1314,中石化,13,1,12,光和,2024-11-28,6380
3231,緯創,34,22,12,光和,2024-11-28,6380
00692,富邦公司治理,11,0,11,光和,2024-11-28,6380
6156,松上,11,0,11,光和,2024-11-28,6380
6770,力積電,13,2,11,光和,2024-11-28,6380
3003,健和興,10,0,10,光和,2024-11-28,6380
1312,國喬,10,0,10,光和,2024-11-28,6380
2382,廣達,10,0,10,光和,2024-11-28,6380
2881,富邦金,10,0,10,光和,2024-11-28,6380
4533,協易機,10,0,10,光和,2024-11-28,6380
6558,興能高,32,22,10,光和,2024-11-28,6380
8150,南茂,12,2,10,光和,2024-11-28,6380
8249,菱光,14,4,10,光和,2024-11-28,6380
3706,神達,46,37,9,光和,2024-11-28,6380
6505,台塑化,9,0,9,光和,2024-11-28,6380
3520,華盈,9,0,9,光和,2024-11-28,6380
3625,西勝,8,0,8,光和,2024-11-28,6380
9910,豐泰,7,0,7,光和,2024-11-28,6380
2915,潤泰全,7,0,7,光和,2024-11-28,6380
2706,第一店,100,0,100,光和,2024-11-29,6380
1301,台塑,126,50,76,光和,2024-11-29,6380
2801,彰銀,82,8,74,光和,2024-11-29,6380
1201,味全,50,0,50,光和,2024-11-29,6380
00946,群益科技高息成長,46,0,46,光和,2024-11-29,6380
2867,三商壽,46,0,46,光和,2024-11-29,6380
00887,永豐中國科技50大,50,10,40,光和,2024-11-29,6380
3231,緯創,28,5,23,光和,2024-11-29,6380
2834,臺企銀,21,0,21,光和,2024-11-29,6380
00878,國泰永續高股息,26,11,15,光和,2024-11-29,6380
2609,陽明,34,19,15,光和,2024-11-29,6380
2883,凱基金,15,0,15,光和,2024-11-29,6380
00915,凱基優選高股息30,15,0,15,光和,2024-11-29,6380
0056,元大高股息,16,1,15,光和,2024-11-29,6380
1314,中石化,24,10,14,光和,2024-11-29,6380
4510,高鋒,22,8,14,光和,2024-11-29,6380
9105,泰金寶-DR,25,11,14,光和,2024-11-29,6380
2317,鴻海,19,6,13,光和,2024-11-29,6380
6530,創威,14,2,12,光和,2024-11-29,6380
6589,台康生技,12,0,12,光和,2024-11-29,6380
2002,中鋼,29,18,11,光和,2024-11-29,6380
2633,台灣高鐵,11,0,11,光和,2024-11-29,6380
00881,國泰台灣5G+,10,0,10,光和,2024-11-29,6380
4306,炎洲,10,0,10,光和,2024-11-29,6380
8044,網家,10,0,10,光和,2024-11-29,6380
1303,南亞,62,53,9,光和,2024-11-29,6380
3032,偉訓,12,3,9,光和,2024-11-29,6380
2303,聯電,11,3,8,光和,2024-11-29,6380
6669,緯穎,8,0,8,光和,2024-11-29,6380
2344,華邦電,62,54,8,光和,2024-11-29,6380
00932,兆豐永續高息等權,7,0,7,光和,2024-11-29,6380
8042,金山電,12,5,7,光和,2024-11-29,6380
8097,常珵,7,0,7,光和,2024-11-29,6380
2890,永豐金,7,0,7,光和,2024-11-29,6380
2603,長榮,15,9,6,光和,2024-11-29,6380
00929,復華台灣科技優息,9,3,6,光和,2024-11-29,6380
00940,元大台灣價值高息,6,0,6,光和,2024-11-29,6380
1605,華新,6,0,6,光和,2024-11-29,6380
2889,國票金,6,0,6,光和,2024-11-29,6380
3290,東浦,6,0,6,光和,2024-11-29,6380
3615,安可,6,0,6,光和,2024-11-29,6380
2330,台積電,6,1,5,光和,2024-11-29,6380
00918,大華優利高填息30,5,0,5,光和,2024-11-29,6380
00675L,富邦臺灣加權正2,6,1,5,光和,2024-11-29,6380
1304,台聚,5,0,5,光和,2024-11-29,6380
2105,正新,5,0,5,光和,2024-11-29,6380
2313,華通,5,0,5,光和,2024-11-29,6380
2641,正德,5,0,5,光和,2024-11-29,6380
2892,第一金,5,0,5,光和,2024-11-29,6380
4108,懷特,5,0,5,光和,2024-11-29,6380
00632R,元大台灣50反1,129,0,129,光和,2024-12-02,6380
1815,富喬,123,18,105,光和,2024-12-02,6380
2344,華邦電,108,42,66,光和,2024-12-02,6380
2312,金寶,84,36,48,光和,2024-12-02,6380
6770,力積電,42,0,42,光和,2024-12-02,6380
2371,大同,31,0,31,光和,2024-12-02,6380
00918,大華優利高填息30,25,2,23,光和,2024-12-02,6380
3231,緯創,23,2,21,光和,2024-12-02,6380
1717,長興,21,0,21,光和,2024-12-02,6380
1201,味全,20,1,19,光和,2024-12-02,6380
5864,致和證,17,0,17,光和,2024-12-02,6380
2426,鼎元,16,1,15,光和,2024-12-02,6380
4968,立積,16,2,14,光和,2024-12-02,6380
3071,協禧,14,0,14,光和,2024-12-02,6380
3481,群創,31,17,14,光和,2024-12-02,6380
6139,亞翔,20,7,13,光和,2024-12-02,6380
2317,鴻海,15,2,13,光和,2024-12-02,6380
2354,鴻準,23,11,12,光和,2024-12-02,6380
00882,中信中國高股息,10,0,10,光和,2024-12-02,6380
3048,益登,10,0,10,光和,2024-12-02,6380
3078,僑威,10,0,10,光和,2024-12-02,6380
3419,譁裕,10,0,10,光和,2024-12-02,6380
3645,達邁,10,0,10,光和,2024-12-02,6380
5328,華容,11,1,10,光和,2024-12-02,6380
6278,台表科,10,0,10,光和,2024-12-02,6380
6284,佳邦,10,0,10,光和,2024-12-02,6380
6669,緯穎,19,9,10,光和,2024-12-02,6380
2316,楠梓電,9,0,9,光和,2024-12-02,6380
4123,晟德,10,2,8,光和,2024-12-02,6380
5340,建榮,8,0,8,光和,2024-12-02,6380
2337,旺宏,7,0,7,光和,2024-12-02,6380
8033,雷虎,9,2,7,光和,2024-12-02,6380
5309,系統電,21,15,6,光和,2024-12-02,6380
00680L,元大美債20正2,11,5,6,光和,2024-12-02,6380
2905,三商,6,0,6,光和,2024-12-02,6380
5907,大洋-KY,16,10,6,光和,2024-12-02,6380
6558,興能高,37,31,6,光和,2024-12-02,6380
8021,尖點,6,0,6,光和,2024-12-02,6380
8107,大億金茂,6,0,6,光和,2024-12-02,6380
3323,加百裕,22,17,5,光和,2024-12-02,6380
2392,正崴,8,3,5,光和,2024-12-02,6380
1569,濱川,5,0,5,光和,2024-12-02,6380
1584,精剛,5,0,5,光和,2024-12-02,6380
1710,東聯,5,0,5,光和,2024-12-02,6380
2397,友通,5,0,5,光和,2024-12-02,6380
2889,國票金,5,0,5,光和,2024-12-02,6380
6015,宏遠證,5,0,5,光和,2024-12-02,6380
6134,萬旭,7,2,5,光和,2024-12-02,6380
6651,全宇昕,5,0,5,光和,2024-12-02,6380
6962,ITH-KY,5,0,5,光和,2024-12-02,6380
00953B,群益優選非投等債,1045,0,1045,光和,2024-12-03,6380
00632R,元大台灣50反1,534,411,123,光和,2024-12-03,6380
00919,群益台灣精選高息,50,2,48,光和,2024-12-03,6380
1305,華夏,48,0,48,光和,2024-12-03,6380
3013,晟銘電,39,1,38,光和,2024-12-03,6380
1210,大成,30,1,29,光和,2024-12-03,6380
2630,亞航,29,0,29,光和,2024-12-03,6380
1605,華新,38,10,28,光和,2024-12-03,6380
2888,新光金,27,1,26,光和,2024-12-03,6380
3031,佰鴻,22,0,22,光和,2024-12-03,6380
00959B,大華投等美債15Y+,20,0,20,光和,2024-12-03,6380
2444,兆勁,18,0,18,光和,2024-12-03,6380
8436,大江,18,0,18,光和,2024-12-03,6380
2027,大成鋼,16,0,16,光和,2024-12-03,6380
2426,鼎元,17,2,15,光和,2024-12-03,6380
6116,彩晶,15,0,15,光和,2024-12-03,6380
2034,允強,12,0,12,光和,2024-12-03,6380
2609,陽明,29,17,12,光和,2024-12-03,6380
4303,信立,20,8,12,光和,2024-12-03,6380
00915,凱基優選高股息30,11,0,11,光和,2024-12-03,6380
00887,永豐中國科技50大,15,4,11,光和,2024-12-03,6380
2375,凱美,12,1,11,光和,2024-12-03,6380
3024,憶聲,13,2,11,光和,2024-12-03,6380
2312,金寶,28,17,11,光和,2024-12-03,6380
00715L,期街口布蘭特正2,10,0,10,光和,2024-12-03,6380
1466,聚隆,10,0,10,光和,2024-12-03,6380
1815,富喬,25,15,10,光和,2024-12-03,6380
2397,友通,10,0,10,光和,2024-12-03,6380
3219,倚強科,10,0,10,光和,2024-12-03,6380
1905,華紙,11,2,9,光和,2024-12-03,6380
3005,神基,10,1,9,光和,2024-12-03,6380
3231,緯創,12,3,9,光和,2024-12-03,6380
1528,恩德,8,0,8,光和,2024-12-03,6380
5371,中光電,11,3,8,光和,2024-12-03,6380
4915,致伸,10,3,7,光和,2024-12-03,6380
3583,辛耘,8,1,7,光和,2024-12-03,6380
8028,昇陽半導體,7,0,7,光和,2024-12-03,6380
0056,元大高股息,8,2,6,光和,2024-12-03,6380
2014,中鴻,6,0,6,光和,2024-12-03,6380
2313,華通,7,1,6,光和,2024-12-03,6380
2476,鉅祥,6,0,6,光和,2024-12-03,6380
3550,聯穎,6,0,6,光和,2024-12-03,6380
6026,福邦證,6,0,6,光和,2024-12-03,6380
6277,宏正,6,0,6,光和,2024-12-03,6380
8107,大億金茂,6,0,6,光和,2024-12-03,6380
2344,華邦電,41,35,6,光和,2024-12-03,6380
2618,長榮航,21,16,5,光和,2024-12-03,6380
2882,國泰金,17,12,5,光和,2024-12-03,6380
1714,和桐,5,0,5,光和,2024-12-03,6380
2365,昆盈,5,0,5,光和,2024-12-03,6380
2337,旺宏,157,1,156,光和,2024-12-04,6380
2610,華航,106,4,102,光和,2024-12-04,6380
00940,元大台灣價值高息,50,14,36,光和,2024-12-04,6380
2303,聯電,35,2,33,光和,2024-12-04,6380
3591,艾笛森,36,5,31,光和,2024-12-04,6380
8069,元太,30,0,30,光和,2024-12-04,6380
2706,第一店,28,0,28,光和,2024-12-04,6380
1304,台聚,26,0,26,光和,2024-12-04,6380
2929,淘帝-KY,26,5,21,光和,2024-12-04,6380
6284,佳邦,21,0,21,光和,2024-12-04,6380
2349,錸德,20,0,20,光和,2024-12-04,6380
6153,嘉聯益,20,0,20,光和,2024-12-04,6380
6505,台塑化,19,0,19,光和,2024-12-04,6380
1477,聚陽,17,0,17,光和,2024-12-04,6380
2312,金寶,17,2,15,光和,2024-12-04,6380
2344,華邦電,60,45,15,光和,2024-12-04,6380
9105,泰金寶-DR,38,23,15,光和,2024-12-04,6380
1326,台化,15,1,14,光和,2024-12-04,6380
2880,華南金,24,10,14,光和,2024-12-04,6380
00918,大華優利高填息30,13,0,13,光和,2024-12-04,6380
00953B,群益優選非投等債,13,0,13,光和,2024-12-04,6380
3625,西勝,13,0,13,光和,2024-12-04,6380
1316,上曜,14,2,12,光和,2024-12-04,6380
2353,宏��,12,0,12,光和,2024-12-04,6380
3162,精確,12,0,12,光和,2024-12-04,6380
2419,仲琦,12,1,11,光和,2024-12-04,6380
3040,遠見,12,1,11,光和,2024-12-04,6380
3071,協禧,11,0,11,光和,2024-12-04,6380
6757,台灣虎航,12,1,11,光和,2024-12-04,6380
1605,華新,21,11,10,光和,2024-12-04,6380
00715L,期街口布蘭特正2,11,1,10,光和,2024-12-04,6380
00959B,大華投等美債15Y+,10,0,10,光和,2024-12-04,6380
1714,和桐,10,0,10,光和,2024-12-04,6380
2104,國際中橡,10,0,10,光和,2024-12-04,6380
2630,亞航,10,0,10,光和,2024-12-04,6380
2634,漢翔,10,0,10,光和,2024-12-04,6380
3047,訊舟,10,0,10,光和,2024-12-04,6380
4726,永昕,10,0,10,光和,2024-12-04,6380
8043,蜜望實,17,7,10,光和,2024-12-04,6380
2476,鉅祥,10,1,9,光和,2024-12-04,6380
4142,國光生,9,0,9,光和,2024-12-04,6380
6173,信昌電,32,23,9,光和,2024-12-04,6380
2382,廣達,8,0,8,光和,2024-12-04,6380
1582,信錦,10,2,8,光和,2024-12-04,6380
2027,大成鋼,8,0,8,光和,2024-12-04,6380
3609,三一東林,8,0,8,光和,2024-12-04,6380
4903,聯光通,18,10,8,光和,2024-12-04,6380
2204,中華,7,0,7,光和,2024-12-04,6380
1301,台塑,8,1,7,光和,2024-12-04,6380
1802,台玻,10,3,7,光和,2024-12-04,6380
00918,大華優利高填息30,122,1,121,光和,2024-12-05,6380
2312,金寶,112,29,83,光和,2024-12-05,6380
1815,富喬,99,51,48,光和,2024-12-05,6380
1301,台塑,38,0,38,光和,2024-12-05,6380
8069,元太,30,0,30,光和,2024-12-05,6380
3450,聯鈞,30,2,28,光和,2024-12-05,6380
1611,中電,28,1,27,光和,2024-12-05,6380
3712,永崴投控,26,0,26,光和,2024-12-05,6380
6770,力積電,24,1,23,光和,2024-12-05,6380
6558,興能高,44,22,22,光和,2024-12-05,6380
2106,建大,21,0,21,光和,2024-12-05,6380
00955,中信日本商社,20,0,20,光和,2024-12-05,6380
1201,味全,20,0,20,光和,2024-12-05,6380
2537,聯上發,20,0,20,光和,2024-12-05,6380
6015,宏遠證,20,1,19,光和,2024-12-05,6380
2392,正崴,35,18,17,光和,2024-12-05,6380
3049,精金,17,0,17,光和,2024-12-05,6380
3323,加百裕,22,7,15,光和,2024-12-05,6380
1326,台化,15,0,15,光和,2024-12-05,6380
3264,欣銓,15,0,15,光和,2024-12-05,6380
9105,泰金寶-DR,17,2,15,光和,2024-12-05,6380
3090,日電貿,18,5,13,光和,2024-12-05,6380
2317,鴻海,14,2,12,光和,2024-12-05,6380
4931,新盛力,19,8,11,光和,2024-12-05,6380
1783,和康生,10,0,10,光和,2024-12-05,6380
2409,友達,10,0,10,光和,2024-12-05,6380
2605,新興,10,0,10,光和,2024-12-05,6380
3234,光環,10,0,10,光和,2024-12-05,6380
3591,艾笛森,10,0,10,光和,2024-12-05,6380
5443,均豪,11,1,10,光和,2024-12-05,6380
6163,華電網,10,0,10,光和,2024-12-05,6380
2363,矽統,12,3,9,光和,2024-12-05,6380
6505,台塑化,9,0,9,光和,2024-12-05,6380
2472,立隆電,14,5,9,光和,2024-12-05,6380
2474,可成,9,0,9,光和,2024-12-05,6380
3257,虹冠電,10,1,9,光和,2024-12-05,6380
2002,中鋼,8,0,8,光和,2024-12-05,6380
2419,仲琦,11,3,8,光和,2024-12-05,6380
3625,西勝,8,0,8,光和,2024-12-05,6380
4977,眾達-KY,26,18,8,光和,2024-12-05,6380
5309,系統電,13,6,7,光和,2024-12-05,6380
1540,喬福,7,0,7,光和,2024-12-05,6380
5452,佶優,7,0,7,光和,2024-12-05,6380
00926,凱基全球菁英55,6,0,6,光和,2024-12-05,6380
2615,萬海,6,0,6,光和,2024-12-05,6380
5864,致和證,6,0,6,光和,2024-12-05,6380
6278,台表科,6,0,6,光和,2024-12-05,6380
8105,凌巨,6,0,6,光和,2024-12-05,6380
00919,群益台灣精選高息,8,3,5,光和,2024-12-05,6380
2303,聯電,21,16,5,光和,2024-12-05,6380
00953B,群益優選非投等債,183,4,179,光和,2024-12-06,6380
1605,華新,103,1,102,光和,2024-12-06,6380
2312,金寶,85,5,80,光和,2024-12-06,6380
00962,台新AI優息動能,70,0,70,光和,2024-12-06,6380
1802,台玻,53,4,49,光和,2024-12-06,6380
00918,大華優利高填息30,48,1,47,光和,2024-12-06,6380
2426,鼎元,51,16,35,光和,2024-12-06,6380
3024,憶聲,45,13,32,光和,2024-12-06,6380
00919,群益台灣精選高息,33,2,31,光和,2024-12-06,6380
00713,元大台灣高息低波,29,0,29,光和,2024-12-06,6380
1303,南亞,24,0,24,光和,2024-12-06,6380
1532,勤美,25,1,24,光和,2024-12-06,6380
2317,鴻海,34,11,23,光和,2024-12-06,6380
3625,西勝,22,1,21,光和,2024-12-06,6380
00955,中信日本商社,20,0,20,光和,2024-12-06,6380
1477,聚陽,18,0,18,光和,2024-12-06,6380
2204,中華,17,0,17,光和,2024-12-06,6380
6560,欣普羅,18,2,16,光和,2024-12-06,6380
2354,鴻準,67,51,16,光和,2024-12-06,6380
00965,元大航太防衛科技,15,0,15,光和,2024-12-06,6380
5309,系統電,19,4,15,光和,2024-12-06,6380
9105,泰金寶-DR,19,6,13,光和,2024-12-06,6380
00915,凱基優選高股息30,12,0,12,光和,2024-12-06,6380
4743,合一,14,3,11,光和,2024-12-06,6380
00715L,期街口布蘭特正2,11,0,11,光和,2024-12-06,6380
1301,台塑,61,50,11,光和,2024-12-06,6380
4510,高鋒,18,7,11,光和,2024-12-06,6380
00954,中信日本半導體,10,0,10,光和,2024-12-06,6380
2441,超豐,10,0,10,光和,2024-12-06,6380
2929,淘帝-KY,10,0,10,光和,2024-12-06,6380
3050,鈺德,10,0,10,光和,2024-12-06,6380
3202,樺晟,10,0,10,光和,2024-12-06,6380
6140,訊達,10,0,10,光和,2024-12-06,6380
2515,中工,10,0,10,光和,2024-12-06,6380
8261,富鼎,9,0,9,光和,2024-12-06,6380
2105,正新,10,1,9,光和,2024-12-06,6380
3041,揚智,10,1,9,光和,2024-12-06,6380
912000,晨訊科-DR,9,0,9,光和,2024-12-06,6380
00951,台新日本半導體,8,0,8,光和,2024-12-06,6380
3317,尼克森,8,0,8,光和,2024-12-06,6380
6270,倍微,8,0,8,光和,2024-12-06,6380
00945B,凱基美國非投等債,7,0,7,光和,2024-12-06,6380
2241,艾姆勒,7,0,7,光和,2024-12-06,6380
5443,均豪,8,1,7,光和,2024-12-06,6380
6163,華電網,10,3,7,光和,2024-12-06,6380
8028,昇陽半導體,11,4,7,光和,2024-12-06,6380
2884,玉山金,6,0,6,光和,2024-12-06,6380
3049,精金,6,0,6,光和,2024-12-06,6380
4157,太景*-KY,6,0,6,光和,2024-12-06,6380
4566,時碩工業,6,0,6,光和,2024-12-06,6380
2836,高雄銀,140,0,140,光和,2024-12-09,6380
2615,萬海,143,56,87,光和,2024-12-09,6380
00887,永豐中國科技50大,60,2,58,光和,2024-12-09,6380
2344,華邦電,73,15,58,光和,2024-12-09,6380
5202,力新,56,2,54,光和,2024-12-09,6380
1802,台玻,42,0,42,光和,2024-12-09,6380
00954,中信日本半導體,40,0,40,光和,2024-12-09,6380
6265,方土昶,40,0,40,光和,2024-12-09,6380
00951,台新日本半導體,31,0,31,光和,2024-12-09,6380
00915,凱基優選高股息30,29,0,29,光和,2024-12-09,6380
2317,鴻海,33,5,28,光和,2024-12-09,6380
5907,大洋-KY,27,0,27,光和,2024-12-09,6380
2646,星宇航空,28,2,26,光和,2024-12-09,6380
00637L,元大滬深300正2,24,0,24,光和,2024-12-09,6380
00932,兆豐永續高息等權,23,0,23,光和,2024-12-09,6380
1708,東鹼,25,2,23,光和,2024-12-09,6380
2312,金寶,31,8,23,光和,2024-12-09,6380
1303,南亞,23,0,23,光和,2024-12-09,6380
2337,旺宏,22,0,22,光和,2024-12-09,6380
2002,中鋼,20,0,20,光和,2024-12-09,6380
00918,大華優利高填息30,20,0,20,光和,2024-12-09,6380
2409,友達,20,0,20,光和,2024-12-09,6380
8040,九暘,20,0,20,光和,2024-12-09,6380
3481,群創,22,4,18,光和,2024-12-09,6380
2354,鴻準,26,9,17,光和,2024-12-09,6380
00930,永豐ESG低碳高息,15,0,15,光和,2024-12-09,6380
1532,勤美,14,0,14,光和,2024-12-09,6380
1815,富喬,21,7,14,光和,2024-12-09,6380
2613,中櫃,14,0,14,光和,2024-12-09,6380
6806,森崴能源,14,0,14,光和,2024-12-09,6380
1471,首利,13,0,13,光和,2024-12-09,6380
2367,燿華,17,4,13,光和,2024-12-09,6380
3088,艾訊,13,0,13,光和,2024-12-09,6380
2027,大成鋼,12,0,12,光和,2024-12-09,6380
3033,威健,12,0,12,光和,2024-12-09,6380
4746,台耀,12,0,12,光和,2024-12-09,6380
6603,富強鑫,12,0,12,光和,2024-12-09,6380
6770,力積電,17,5,12,光和,2024-12-09,6380
4931,新盛力,13,2,11,光和,2024-12-09,6380
00715L,期街口布蘭特正2,11,0,11,光和,2024-12-09,6380
1524,耿鼎,13,2,11,光和,2024-12-09,6380
2641,正德,11,0,11,光和,2024-12-09,6380
9105,泰金寶-DR,28,17,11,光和,2024-12-09,6380
2498,宏達電,16,6,10,光和,2024-12-09,6380
00953B,群益優選非投等債,10,0,10,光和,2024-12-09,6380
1464,得力,10,0,10,光和,2024-12-09,6380
1565,精華,11,1,10,光和,2024-12-09,6380
2314,台揚,10,0,10,光和,2024-12-09,6380
2497,怡利電,10,0,10,光和,2024-12-09,6380
2601,益航,10,0,10,光和,2024-12-09,6380
00918,大華優利高填息30,158,0,158,光和,2024-12-10,6380
2317,鴻海,80,0,80,光和,2024-12-10,6380
1708,東鹼,51,0,51,光和,2024-12-10,6380
00665L,富邦�琤肭磪囓�2,56,11,45,光和,2024-12-10,6380
00753L,中信中國50正2,81,41,40,光和,2024-12-10,6380
3511,矽瑪,33,2,31,光和,2024-12-10,6380
2611,志信,30,0,30,光和,2024-12-10,6380
00915,凱基優選高股息30,27,1,26,光和,2024-12-10,6380
9105,泰金寶-DR,66,40,26,光和,2024-12-10,6380
1802,台玻,27,3,24,光和,2024-12-10,6380
3706,神達,59,38,21,光和,2024-12-10,6380
3522,御嵿,21,0,21,光和,2024-12-10,6380
0056,元大高股息,21,1,20,光和,2024-12-10,6380
2367,燿華,22,2,20,光和,2024-12-10,6380
2888,新光金,80,60,20,光和,2024-12-10,6380
00878,國泰永續高股息,21,1,20,光和,2024-12-10,6380
6180,橘子,20,2,18,光和,2024-12-10,6380
6770,力積電,31,14,17,光和,2024-12-10,6380
2409,友達,20,4,16,光和,2024-12-10,6380
2547,日勝生,18,3,15,光和,2024-12-10,6380
2618,長榮航,16,1,15,光和,2024-12-10,6380
3071,協禧,15,0,15,光和,2024-12-10,6380
5202,力新,14,1,13,光和,2024-12-10,6380
2486,一詮,13,0,13,光和,2024-12-10,6380
3050,鈺德,20,7,13,光和,2024-12-10,6380
5438,東友,13,0,13,光和,2024-12-10,6380
3607,谷崧,12,0,12,光和,2024-12-10,6380
2609,陽明,41,30,11,光和,2024-12-10,6380
2891,中信金,11,0,11,光和,2024-12-10,6380
8249,菱光,11,0,11,光和,2024-12-10,6380
2354,鴻準,32,21,11,光和,2024-12-10,6380
00919,群益台灣精選高息,10,0,10,光和,2024-12-10,6380
00752,中信中國50,15,5,10,光和,2024-12-10,6380
2515,中工,10,0,10,光和,2024-12-10,6380
2836,高雄銀,10,0,10,光和,2024-12-10,6380
6016,康和證,10,0,10,光和,2024-12-10,6380
6443,元晶,10,0,10,光和,2024-12-10,6380
8176,智捷,10,0,10,光和,2024-12-10,6380
1609,大亞,11,1,10,光和,2024-12-10,6380
00962,台新AI優息動能,9,0,9,光和,2024-12-10,6380
00882,中信中國高股息,10,1,9,光和,2024-12-10,6380
2062,橋椿,18,10,8,光和,2024-12-10,6380
00679B,元大美債20年,8,0,8,光和,2024-12-10,6380
2312,金寶,9,1,8,光和,2024-12-10,6380
2353,宏��,9,1,8,光和,2024-12-10,6380
4303,信立,11,3,8,光和,2024-12-10,6380
1449,佳和,14,7,7,光和,2024-12-10,6380
2646,星宇航空,7,0,7,光和,2024-12-10,6380
4931,新盛力,10,3,7,光和,2024-12-10,6380
3017,奇鋐,8,1,7,光和,2024-12-10,6380
2515,中工,70,0,70,光和,2024-12-11,6380
2615,萬海,60,2,58,光和,2024-12-11,6380
2317,鴻海,70,13,57,光和,2024-12-11,6380
00753L,中信中國50正2,46,0,46,光和,2024-12-11,6380
2609,陽明,47,5,42,光和,2024-12-11,6380
6770,力積電,51,12,39,光和,2024-12-11,6380
2344,華邦電,37,2,35,光和,2024-12-11,6380
2610,華航,35,1,34,光和,2024-12-11,6380
1449,佳和,33,0,33,光和,2024-12-11,6380
00918,大華優利高填息30,29,0,29,光和,2024-12-11,6380
2002,中鋼,28,0,28,光和,2024-12-11,6380
1708,東鹼,23,0,23,光和,2024-12-11,6380
2201,裕隆,22,0,22,光和,2024-12-11,6380
2303,聯電,40,20,20,光和,2024-12-11,6380
00665L,富邦�琤肭磪囓�2,20,0,20,光和,2024-12-11,6380
00637L,元大滬深300正2,40,20,20,光和,2024-12-11,6380
2323,中環,20,0,20,光和,2024-12-11,6380
2618,長榮航,33,13,20,光和,2024-12-11,6380
00919,群益台灣精選高息,19,0,19,光和,2024-12-11,6380
00940,元大台灣價值高息,26,7,19,光和,2024-12-11,6380
3234,光環,18,0,18,光和,2024-12-11,6380
2312,金寶,21,4,17,光和,2024-12-11,6380
2646,星宇航空,19,2,17,光和,2024-12-11,6380
00915,凱基優選高股息30,16,0,16,光和,2024-12-11,6380
2332,友訊,15,1,14,光和,2024-12-11,6380
3062,建漢,14,0,14,光和,2024-12-11,6380
00878,國泰永續高股息,13,0,13,光和,2024-12-11,6380
1815,富喬,18,5,13,光和,2024-12-11,6380
4303,信立,15,2,13,光和,2024-12-11,6380
6558,興能高,20,7,13,光和,2024-12-11,6380
0056,元大高股息,15,3,12,光和,2024-12-11,6380
00633L,富邦上証正2,12,0,12,光和,2024-12-11,6380
9105,泰金寶-DR,16,5,11,光和,2024-12-11,6380
1513,中興電,12,2,10,光和,2024-12-11,6380
3533,嘉澤,10,0,10,光和,2024-12-11,6380
1304,台聚,10,0,10,光和,2024-12-11,6380
1464,得力,10,0,10,光和,2024-12-11,6380
1712,興農,10,0,10,光和,2024-12-11,6380
2408,南亞科,21,11,10,光和,2024-12-11,6380
3162,精確,10,0,10,光和,2024-12-11,6380
3607,谷崧,10,0,10,光和,2024-12-11,6380
2330,台積電,10,1,9,光和,2024-12-11,6380
1303,南亞,14,5,9,光和,2024-12-11,6380
2365,昆盈,9,0,9,光和,2024-12-11,6380
2401,凌陽,13,4,9,光和,2024-12-11,6380
3447,展達,10,1,9,光和,2024-12-11,6380
6589,台康生技,10,1,9,光和,2024-12-11,6380
2363,矽統,9,1,8,光和,2024-12-11,6380
2520,冠德,8,0,8,光和,2024-12-11,6380
1710,東聯,8,0,8,光和,2024-12-11,6380
2615,萬海,131,34,97,光和,2024-12-12,6380
1303,南亞,99,3,96,光和,2024-12-12,6380
1802,台玻,76,10,66,光和,2024-12-12,6380
2303,聯電,75,13,62,光和,2024-12-12,6380
00887,永豐中國科技50大,61,1,60,光和,2024-12-12,6380
1301,台塑,104,50,54,光和,2024-12-12,6380
2002,中鋼,40,0,40,光和,2024-12-12,6380
00665L,富邦�琤肭磪囓�2,50,10,40,光和,2024-12-12,6380
2312,金寶,40,7,33,光和,2024-12-12,6380
00919,群益台灣精選高息,31,0,31,光和,2024-12-12,6380
2867,三商壽,30,0,30,光和,2024-12-12,6380
2317,鴻海,60,36,24,光和,2024-12-12,6380
3071,協禧,23,0,23,光和,2024-12-12,6380
1815,富喬,34,12,22,光和,2024-12-12,6380
8390,金益鼎,22,0,22,光和,2024-12-12,6380
00679B,元大美債20年,20,0,20,光和,2024-12-12,6380
6589,台康生技,20,0,20,光和,2024-12-12,6380
00937B,群益ESG投等債20,28,10,18,光和,2024-12-12,6380
00940,元大台灣價值高息,20,3,17,光和,2024-12-12,6380
2520,冠德,17,0,17,光和,2024-12-12,6380
3231,緯創,17,1,16,光和,2024-12-12,6380
00918,大華優利高填息30,15,0,15,光和,2024-12-12,6380
6108,競國,15,0,15,光和,2024-12-12,6380
00712,復華富時不動產,14,0,14,光和,2024-12-12,6380
2537,聯上發,14,0,14,光和,2024-12-12,6380
3710,連展投控,14,0,14,光和,2024-12-12,6380
1718,中纖,12,0,12,光和,2024-12-12,6380
2344,華邦電,48,36,12,光和,2024-12-12,6380
00878,國泰永續高股息,12,1,11,光和,2024-12-12,6380
1714,和桐,11,0,11,光和,2024-12-12,6380
4933,友輝,11,0,11,光和,2024-12-12,6380
5907,大洋-KY,11,0,11,光和,2024-12-12,6380
00945B,凱基美國非投等債,10,0,10,光和,2024-12-12,6380
2362,藍天,10,0,10,光和,2024-12-12,6380
4968,立積,10,0,10,光和,2024-12-12,6380
6112,邁達特,11,1,10,光和,2024-12-12,6380
6690,安�硌穈T,10,0,10,光和,2024-12-12,6380
00687B,國泰20年美債,9,0,9,光和,2024-12-12,6380
2884,玉山金,10,1,9,光和,2024-12-12,6380
2354,鴻準,19,11,8,光和,2024-12-12,6380
00710B,復華彭博非投等債,8,0,8,光和,2024-12-12,6380
00950B,凱基A級公司債,8,0,8,光和,2024-12-12,6380
2371,大同,8,0,8,光和,2024-12-12,6380
4977,眾達-KY,9,1,8,光和,2024-12-12,6380
6443,元晶,13,5,8,光和,2024-12-12,6380
8042,金山電,10,2,8,光和,2024-12-12,6380
0056,元大高股息,8,1,7,光和,2024-12-12,6380
1304,台聚,10,3,7,光和,2024-12-12,6380
3033,威健,7,0,7,光和,2024-12-12,6380
4162,智擎,7,0,7,光和,2024-12-12,6380
00953B,群益優選非投等債,114,0,114,光和,2024-12-13,6380
2836,高雄銀,80,0,80,光和,2024-12-13,6380
00937B,群益ESG投等債20,68,0,68,光和,2024-12-13,6380
00918,大華優利高填息30,58,0,58,光和,2024-12-13,6380
3003,健和興,58,0,58,光和,2024-12-13,6380
00637L,元大滬深300正2,53,0,53,光和,2024-12-13,6380
3481,群創,48,0,48,光和,2024-12-13,6380
2317,鴻海,48,1,47,光和,2024-12-13,6380
1449,佳和,42,2,40,光和,2024-12-13,6380
8933,愛地雅,40,0,40,光和,2024-12-13,6380
00961,FT臺灣永續高息,36,0,36,光和,2024-12-13,6380
0056,元大高股息,35,0,35,光和,2024-12-13,6380
3019,亞光,45,12,33,光和,2024-12-13,6380
2353,宏��,33,1,32,光和,2024-12-13,6380
2520,冠德,30,0,30,光和,2024-12-13,6380
3706,神達,45,16,29,光和,2024-12-13,6380
2867,三商壽,63,37,26,光和,2024-12-13,6380
2313,華通,27,3,24,光和,2024-12-13,6380
2323,中環,23,0,23,光和,2024-12-13,6380
00753L,中信中國50正2,22,0,22,光和,2024-12-13,6380
2618,長榮航,33,12,21,光和,2024-12-13,6380
00951,台新日本半導體,20,0,20,光和,2024-12-13,6380
4566,時碩工業,18,1,17,光和,2024-12-13,6380
2887,台新金,22,5,17,光和,2024-12-13,6380
00940,元大台灣價值高息,16,0,16,光和,2024-12-13,6380
2303,聯電,34,18,16,光和,2024-12-13,6380
3591,艾笛森,16,1,15,光和,2024-12-13,6380
1312,國喬,14,0,14,光和,2024-12-13,6380
00919,群益台灣精選高息,35,22,13,光和,2024-12-13,6380
3231,緯創,15,2,13,光和,2024-12-13,6380
1710,東聯,13,0,13,光和,2024-12-13,6380
2344,華邦電,28,15,13,光和,2024-12-13,6380
6443,元晶,13,0,13,光和,2024-12-13,6380
00878,國泰永續高股息,19,6,13,光和,2024-12-13,6380
1477,聚陽,12,0,12,光和,2024-12-13,6380
3260,威剛,12,0,12,光和,2024-12-13,6380
5498,凱崴,12,0,12,光和,2024-12-13,6380
2515,中工,22,11,11,光和,2024-12-13,6380
00932,兆豐永續高息等權,13,2,11,光和,2024-12-13,6380
2610,華航,12,1,11,光和,2024-12-13,6380
5340,建榮,11,0,11,光和,2024-12-13,6380
00713,元大台灣高息低波,11,0,11,光和,2024-12-13,6380
2002,中鋼,10,0,10,光和,2024-12-13,6380
00712,復華富時不動產,10,0,10,光和,2024-12-13,6380
2367,燿華,15,5,10,光和,2024-12-13,6380
2374,佳能,10,0,10,光和,2024-12-13,6380
2408,南亞科,10,0,10,光和,2024-12-13,6380
3041,揚智,10,0,10,光和,2024-12-13,6380
8039,台虹,10,0,10,光和,2024-12-13,6380
8390,金益鼎,10,0,10,光和,2024-12-13,6380
00919,群益台灣精選高息,112,5,107,光和,2024-12-16,6380
00918,大華優利高填息30,83,0,83,光和,2024-12-16,6380
2867,三商壽,70,0,70,光和,2024-12-16,6380
00921,兆豐龍頭等權重,60,0,60,光和,2024-12-16,6380
00712,復華富時不動產,59,0,59,光和,2024-12-16,6380
00679B,元大美債20年,55,0,55,光和,2024-12-16,6380
00953B,群益優選非投等債,52,0,52,光和,2024-12-16,6380
00937B,群益ESG投等債20,44,0,44,光和,2024-12-16,6380
00680L,元大美債20正2,39,0,39,光和,2024-12-16,6380
3706,神達,48,21,27,光和,2024-12-16,6380
2317,鴻海,35,9,26,光和,2024-12-16,6380
2002,中鋼,25,0,25,光和,2024-12-16,6380
00633L,富邦上証正2,25,0,25,光和,2024-12-16,6380
3019,亞光,46,24,22,光和,2024-12-16,6380
3231,緯創,30,9,21,光和,2024-12-16,6380
00955,中信日本商社,20,0,20,光和,2024-12-16,6380
1532,勤美,30,10,20,光和,2024-12-16,6380
00756B,群益投等新興公債,19,0,19,光和,2024-12-16,6380
2363,矽統,19,1,18,光和,2024-12-16,6380
5328,華容,18,0,18,光和,2024-12-16,6380
1316,上曜,17,1,16,光和,2024-12-16,6380
00878,國泰永續高股息,16,1,15,光和,2024-12-16,6380
00673R,期元大S＆P原油反1,15,0,15,光和,2024-12-16,6380
00936,台新永續高息中小,15,0,15,光和,2024-12-16,6380
1710,東聯,15,0,15,光和,2024-12-16,6380
3234,光環,16,1,15,光和,2024-12-16,6380
1605,華新,26,12,14,光和,2024-12-16,6380
2344,華邦電,35,21,14,光和,2024-12-16,6380
00934,中信成長高股息,18,5,13,光和,2024-12-16,6380
00637L,元大滬深300正2,19,6,13,光和,2024-12-16,6380
6163,華電網,13,0,13,光和,2024-12-16,6380
1101,台泥,12,0,12,光和,2024-12-16,6380
2486,一詮,11,0,11,光和,2024-12-16,6380
00887,永豐中國科技50大,13,2,11,光和,2024-12-16,6380
00962,台新AI優息動能,11,0,11,光和,2024-12-16,6380
1795,美時,11,0,11,光和,2024-12-16,6380
5443,均豪,11,0,11,光和,2024-12-16,6380
8390,金益鼎,11,0,11,光和,2024-12-16,6380
2354,鴻準,18,7,11,光和,2024-12-16,6380
00665L,富邦�琤肭磪囓�2,10,0,10,光和,2024-12-16,6380
00753L,中信中國50正2,10,0,10,光和,2024-12-16,6380
00945B,凱基美國非投等債,10,0,10,光和,2024-12-16,6380
1815,富喬,19,9,10,光和,2024-12-16,6380
3716,中化控股,10,0,10,光和,2024-12-16,6380
5347,世界,10,0,10,光和,2024-12-16,6380
6668,中揚光,10,0,10,光和,2024-12-16,6380
8401,白紗科,10,0,10,光和,2024-12-16,6380
3017,奇鋐,9,0,9,光和,2024-12-16,6380
00725B,國泰投資級公司債,9,0,9,光和,2024-12-16,6380
1717,長興,9,0,9,光和,2024-12-16,6380
00687B,國泰20年美債,180,1,179,光和,2024-12-17,6380
2801,彰銀,128,5,123,光和,2024-12-17,6380
3481,群創,105,0,105,光和,2024-12-17,6380
00953B,群益優選非投等債,90,0,90,光和,2024-12-17,6380
2834,臺企銀,89,0,89,光和,2024-12-17,6380
2409,友達,62,0,62,光和,2024-12-17,6380
2867,三商壽,60,0,60,光和,2024-12-17,6380
4711,永純,47,0,47,光和,2024-12-17,6380
00937B,群益ESG投等債20,43,0,43,光和,2024-12-17,6380
00915,凱基優選高股息30,41,0,41,光和,2024-12-17,6380
2520,冠德,38,0,38,光和,2024-12-17,6380
00919,群益台灣精選高息,58,28,30,光和,2024-12-17,6380
8374,羅昇,37,7,30,光和,2024-12-17,6380
00795B,中信美國公債20年,25,0,25,光和,2024-12-17,6380
00713,元大台灣高息低波,22,0,22,光和,2024-12-17,6380
00753L,中信中國50正2,20,0,20,光和,2024-12-17,6380
1802,台玻,20,0,20,光和,2024-12-17,6380
00918,大華優利高填息30,34,15,19,光和,2024-12-17,6380
8086,宏捷科,19,1,18,光和,2024-12-17,6380
2609,陽明,36,19,17,光和,2024-12-17,6380
2408,南亞科,67,51,16,光和,2024-12-17,6380
5355,佳總,16,0,16,光和,2024-12-17,6380
1402,遠東新,15,0,15,光和,2024-12-17,6380
2344,華邦電,21,6,15,光和,2024-12-17,6380
6689,伊雲谷,18,3,15,光和,2024-12-17,6380
6770,力積電,17,3,14,光和,2024-12-17,6380
2883,凱基金,14,0,14,光和,2024-12-17,6380
00756B,群益投等新興公債,15,1,14,光和,2024-12-17,6380
3019,亞光,30,17,13,光和,2024-12-17,6380
1440,南紡,12,0,12,光和,2024-12-17,6380
0056,元大高股息,12,0,12,光和,2024-12-17,6380
4577,達航科技,11,0,11,光和,2024-12-17,6380
00665L,富邦�琤肭磪囓�2,10,0,10,光和,2024-12-17,6380
2374,佳能,44,34,10,光和,2024-12-17,6380
3049,精金,10,0,10,光和,2024-12-17,6380
6116,彩晶,10,0,10,光和,2024-12-17,6380
1301,台塑,12,2,10,光和,2024-12-17,6380
2382,廣達,11,2,9,光和,2024-12-17,6380
2481,強茂,9,0,9,光和,2024-12-17,6380
3689,湧德,11,2,9,光和,2024-12-17,6380
6530,創威,9,0,9,光和,2024-12-17,6380
6125,廣運,8,0,8,光和,2024-12-17,6380
9945,潤泰新,8,0,8,光和,2024-12-17,6380
2886,兆豐金,8,0,8,光和,2024-12-17,6380
2354,鴻準,10,2,8,光和,2024-12-17,6380
6127,九豪,7,0,7,光和,2024-12-17,6380
00921,兆豐龍頭等權重,6,0,6,光和,2024-12-17,6380
2453,凌群,6,0,6,光和,2024-12-17,6380
6122,擎邦,6,0,6,光和,2024-12-17,6380
2317,鴻海,16,11,5,光和,2024-12-17,6380
00918,大華優利高填息30,130,0,130,光和,2024-12-18,6380
00687B,國泰20年美債,70,0,70,光和,2024-12-18,6380
5880,合庫金,45,0,45,光和,2024-12-18,6380
2801,彰銀,31,0,31,光和,2024-12-18,6380
00955,中信日本商社,30,0,30,光和,2024-12-18,6380
2002,中鋼,28,0,28,光和,2024-12-18,6380
3551,世禾,28,2,26,光和,2024-12-18,6380
2547,日勝生,24,0,24,光和,2024-12-18,6380
4306,炎洲,21,0,21,光和,2024-12-18,6380
1464,得力,20,0,20,光和,2024-12-18,6380
1785,光洋科,19,1,18,光和,2024-12-18,6380
3481,群創,20,2,18,光和,2024-12-18,6380
2344,華邦電,36,19,17,光和,2024-12-18,6380
1449,佳和,26,10,16,光和,2024-12-18,6380
00712,復華富時不動產,15,0,15,光和,2024-12-18,6380
2303,聯電,49,35,14,光和,2024-12-18,6380
1326,台化,13,0,13,光和,2024-12-18,6380
2609,陽明,15,2,13,光和,2024-12-18,6380
910322,康師傅-DR,12,0,12,光和,2024-12-18,6380
00725B,國泰投資級公司債,10,0,10,光和,2024-12-18,6380
1802,台玻,10,0,10,光和,2024-12-18,6380
2836,高雄銀,10,0,10,光和,2024-12-18,6380
2897,王道銀行,10,0,10,光和,2024-12-18,6380
3008,大立光,10,0,10,光和,2024-12-18,6380
5351,鈺創,10,0,10,光和,2024-12-18,6380
2371,大同,10,1,9,光和,2024-12-18,6380
5347,世界,16,7,9,光和,2024-12-18,6380
6191,精成科,10,1,9,光和,2024-12-18,6380
00713,元大台灣高息低波,11,3,8,光和,2024-12-18,6380
3078,僑威,13,5,8,光和,2024-12-18,6380
6589,台康生技,8,0,8,光和,2024-12-18,6380
2891,中信金,8,0,8,光和,2024-12-18,6380
00915,凱基優選高股息30,7,0,7,光和,2024-12-18,6380
3264,欣銓,8,1,7,光和,2024-12-18,6380
6165,浪凡,7,0,7,光和,2024-12-18,6380
00922,國泰台灣領袖50,6,0,6,光和,2024-12-18,6380
00921,兆豐龍頭等權重,6,0,6,光和,2024-12-18,6380
1314,中石化,7,1,6,光和,2024-12-18,6380
2603,長榮,8,2,6,光和,2024-12-18,6380
2605,新興,6,0,6,光和,2024-12-18,6380
2881,富邦金,6,0,6,光和,2024-12-18,6380
4974,亞泰,11,5,6,光和,2024-12-18,6380
6548,長科*,6,0,6,光和,2024-12-18,6380
1301,台塑,12,6,6,光和,2024-12-18,6380
1303,南亞,10,5,5,光和,2024-12-18,6380
2201,裕隆,5,0,5,光和,2024-12-18,6380
2359,所羅門,15,10,5,光和,2024-12-18,6380
2884,玉山金,6,1,5,光和,2024-12-18,6380
3025,星通,8,3,5,光和,2024-12-18,6380
4952,凌通,7,2,5,光和,2024-12-18,6380
2801,彰銀,284,0,284,光和,2024-12-19,6380
00953B,群益優選非投等債,115,0,115,光和,2024-12-19,6380
00918,大華優利高填息30,100,7,93,光和,2024-12-19,6380
00687B,國泰20年美債,73,1,72,光和,2024-12-19,6380
00937B,群益ESG投等債20,69,1,68,光和,2024-12-19,6380
2615,萬海,56,0,56,光和,2024-12-19,6380
00955,中信日本商社,50,0,50,光和,2024-12-19,6380
5452,佶優,50,0,50,光和,2024-12-19,6380
2317,鴻海,55,11,44,光和,2024-12-19,6380
3481,群創,44,3,41,光和,2024-12-19,6380
5483,中美晶,40,0,40,光和,2024-12-19,6380
2887,台新金,39,0,39,光和,2024-12-19,6380
00712,復華富時不動產,67,30,37,光和,2024-12-19,6380
2834,臺企銀,33,0,33,光和,2024-12-19,6380
2409,友達,32,1,31,光和,2024-12-19,6380
2641,正德,30,0,30,光和,2024-12-19,6380
2867,三商壽,30,0,30,光和,2024-12-19,6380
00948B,中信優息投資級債,25,0,25,光和,2024-12-19,6380
00680L,元大美債20正2,35,10,25,光和,2024-12-19,6380
00930,永豐ESG低碳高息,25,0,25,光和,2024-12-19,6380
00878,國泰永續高股息,43,21,22,光和,2024-12-19,6380
00679B,元大美債20年,21,0,21,光和,2024-12-19,6380
1303,南亞,30,10,20,光和,2024-12-19,6380
2303,聯電,24,4,20,光和,2024-12-19,6380
2836,高雄銀,20,0,20,光和,2024-12-19,6380
00915,凱基優選高股息30,18,0,18,光和,2024-12-19,6380
2609,陽明,28,11,17,光和,2024-12-19,6380
2736,富野,57,40,17,光和,2024-12-19,6380
1612,宏泰,16,0,16,光和,2024-12-19,6380
00756B,群益投等新興公債,15,0,15,光和,2024-12-19,6380
00933B,國泰10Y+金融債,15,0,15,光和,2024-12-19,6380
00950B,凱基A級公司債,15,0,15,光和,2024-12-19,6380
2706,第一店,15,0,15,光和,2024-12-19,6380
2547,日勝生,14,0,14,光和,2024-12-19,6380
6215,和椿,24,10,14,光和,2024-12-19,6380
2882,國泰金,14,0,14,光和,2024-12-19,6380
5880,合庫金,13,0,13,光和,2024-12-19,6380
2881,富邦金,13,0,13,光和,2024-12-19,6380
00713,元大台灣高息低波,13,0,13,光和,2024-12-19,6380
00959B,大華投等美債15Y+,12,0,12,光和,2024-12-19,6380
006208,富邦台50,12,0,12,光和,2024-12-19,6380
2408,南亞科,18,7,11,光和,2024-12-19,6380
00720B,元大投資級公司債,11,0,11,光和,2024-12-19,6380
00633L,富邦上証正2,10,0,10,光和,2024-12-19,6380
1314,中石化,14,4,10,光和,2024-12-19,6380
2101,南港,10,0,10,光和,2024-12-19,6380
2401,凌陽,10,0,10,光和,2024-12-19,6380
2495,普安,10,0,10,光和,2024-12-19,6380
3041,揚智,12,2,10,光和,2024-12-19,6380
6112,邁達特,10,0,10,光和,2024-12-19,6380
