Ticker,Name,buy,sell,diff,Branch,Date,Branch_Code
3481,群創,3128,831,2297,摩根大通,2023-01-03,8440
1513,中興電,2341,930,1411,摩根大通,2023-01-03,8440
3034,聯詠,1432,131,1301,摩根大通,2023-01-03,8440
8069,元太,1231,125,1106,摩根大通,2023-01-03,8440
4961,天鈺,929,98,831,摩根大通,2023-01-03,8440
1536,和大,675,34,641,摩根大通,2023-01-03,8440
2376,技嘉,735,156,579,摩根大通,2023-01-03,8440
2027,大成鋼,739,167,572,摩根大通,2023-01-03,8440
8171,天宇,531,54,477,摩根大通,2023-01-03,8440
3037,欣興,629,172,457,摩根大通,2023-01-03,8440
2498,宏達電,888,437,451,摩根大通,2023-01-03,8440
6589,台康生技,545,97,448,摩根大通,2023-01-03,8440
6472,保瑞,517,76,441,摩根大通,2023-01-03,8440
2353,宏��,668,254,414,摩根大通,2023-01-03,8440
1529,樂事綠能,642,246,396,摩根大通,2023-01-03,8440
6282,康舒,409,33,376,摩根大通,2023-01-03,8440
2618,長榮航,706,356,350,摩根大通,2023-01-03,8440
1701,中化,957,608,349,摩根大通,2023-01-03,8440
2359,所羅門,383,64,319,摩根大通,2023-01-03,8440
1477,聚陽,464,170,294,摩根大通,2023-01-03,8440
4960,誠美材,278,3,275,摩根大通,2023-01-03,8440
3035,智原,494,219,275,摩根大通,2023-01-03,8440
2444,兆勁,446,172,274,摩根大通,2023-01-03,8440
4919,新唐,287,17,270,摩根大通,2023-01-03,8440
1752,南光,630,360,270,摩根大通,2023-01-03,8440
3128,昇銳,287,20,267,摩根大通,2023-01-03,8440
2610,華航,807,541,266,摩根大通,2023-01-03,8440
8016,矽創,265,7,258,摩根大通,2023-01-03,8440
6533,晶心科,323,67,256,摩根大通,2023-01-03,8440
2338,光罩,417,162,255,摩根大通,2023-01-03,8440
3708,上緯投控,424,176,248,摩根大通,2023-01-03,8440
2368,金像電,216,14,202,摩根大通,2023-01-03,8440
2367,燿華,237,40,197,摩根大通,2023-01-03,8440
4763,材料-KY,263,83,180,摩根大通,2023-01-03,8440
3515,華擎,372,194,178,摩根大通,2023-01-03,8440
2454,聯發科,974,796,178,摩根大通,2023-01-03,8440
2486,一詮,180,4,176,摩根大通,2023-01-03,8440
00830,國泰費城半導體,175,0,175,摩根大通,2023-01-03,8440
3592,瑞鼎,192,20,172,摩根大通,2023-01-03,8440
2303,聯電,1560,1394,166,摩根大通,2023-01-03,8440
9945,潤泰新,541,376,165,摩根大通,2023-01-03,8440
4130,健亞,232,79,153,摩根大通,2023-01-03,8440
6806,森崴能源,280,130,150,摩根大通,2023-01-03,8440
9802,鈺齊-KY,259,109,150,摩根大通,2023-01-03,8440
3014,聯陽,151,3,148,摩根大通,2023-01-03,8440
1584,精剛,160,14,146,摩根大通,2023-01-03,8440
1795,美時,244,110,134,摩根大通,2023-01-03,8440
3105,穩懋,228,96,132,摩根大通,2023-01-03,8440
6456,GIS-KY,225,95,130,摩根大通,2023-01-03,8440
0056,元大高股息,130,0,130,摩根大通,2023-01-03,8440
1605,華新,12996,5835,7161,摩根大通,2023-01-04,8440
3481,群創,5047,1166,3881,摩根大通,2023-01-04,8440
2409,友達,3377,1663,1714,摩根大通,2023-01-04,8440
9904,寶成,1564,228,1336,摩根大通,2023-01-04,8440
1909,榮成,1070,110,960,摩根大通,2023-01-04,8440
2408,南亞科,921,95,826,摩根大通,2023-01-04,8440
1513,中興電,2740,1990,750,摩根大通,2023-01-04,8440
3704,合勤控,1327,641,686,摩根大通,2023-01-04,8440
2317,鴻海,1905,1358,547,摩根大通,2023-01-04,8440
2886,兆豐金,1066,543,523,摩根大通,2023-01-04,8440
2892,第一金,945,425,520,摩根大通,2023-01-04,8440
2603,長榮,885,378,507,摩根大通,2023-01-04,8440
5871,中租-KY,628,147,481,摩根大通,2023-01-04,8440
6180,橘子,513,43,470,摩根大通,2023-01-04,8440
2881,富邦金,667,244,423,摩根大通,2023-01-04,8440
6282,康舒,454,49,405,摩根大通,2023-01-04,8440
5009,榮剛,484,81,403,摩根大通,2023-01-04,8440
8044,網家,617,217,400,摩根大通,2023-01-04,8440
2890,永豐金,860,495,365,摩根大通,2023-01-04,8440
1514,亞力,749,398,351,摩根大通,2023-01-04,8440
2465,麗臺,518,175,343,摩根大通,2023-01-04,8440
6143,振曜,456,113,343,摩根大通,2023-01-04,8440
1314,中石化,361,28,333,摩根大通,2023-01-04,8440
8358,金居,556,258,298,摩根大通,2023-01-04,8440
2903,遠百,325,32,293,摩根大通,2023-01-04,8440
8033,雷虎,376,92,284,摩根大通,2023-01-04,8440
2382,廣達,477,210,267,摩根大通,2023-01-04,8440
6547,高端疫苗,339,82,257,摩根大通,2023-01-04,8440
3708,上緯投控,329,86,243,摩根大通,2023-01-04,8440
1444,力麗,481,243,238,摩根大通,2023-01-04,8440
6517,保勝光學,243,6,237,摩根大通,2023-01-04,8440
4961,天鈺,479,245,234,摩根大通,2023-01-04,8440
2723,美食-KY,273,44,229,摩根大通,2023-01-04,8440
2474,可成,500,274,226,摩根大通,2023-01-04,8440
5351,鈺創,286,80,206,摩根大通,2023-01-04,8440
3406,玉晶光,329,124,205,摩根大通,2023-01-04,8440
4906,正文,242,48,194,摩根大通,2023-01-04,8440
1305,華夏,190,6,184,摩根大通,2023-01-04,8440
3056,富華新,183,2,181,摩根大通,2023-01-04,8440
2308,台達電,328,152,176,摩根大通,2023-01-04,8440
6223,旺矽,282,111,171,摩根大通,2023-01-04,8440
3714,富采,170,4,166,摩根大通,2023-01-04,8440
2492,華新科,180,15,165,摩根大通,2023-01-04,8440
2230,泰茂,176,20,156,摩根大通,2023-01-04,8440
1590,亞德客-KY,184,29,155,摩根大通,2023-01-04,8440
1907,永豐餘,155,0,155,摩根大通,2023-01-04,8440
2482,連宇,190,35,155,摩根大通,2023-01-04,8440
6244,茂迪,201,49,152,摩根大通,2023-01-04,8440
5269,祥碩,179,36,143,摩根大通,2023-01-04,8440
3231,緯創,573,435,138,摩根大通,2023-01-04,8440
2317,鴻海,4930,286,4644,摩根大通,2023-01-05,8440
2888,新光金,4471,330,4141,摩根大通,2023-01-05,8440
2330,台積電,4914,1275,3639,摩根大通,2023-01-05,8440
3037,欣興,3522,250,3272,摩根大通,2023-01-05,8440
3481,群創,2552,228,2324,摩根大通,2023-01-05,8440
2303,聯電,2222,323,1899,摩根大通,2023-01-05,8440
2885,元大金,1867,111,1756,摩根大通,2023-01-05,8440
2887,台新金,2039,457,1582,摩根大通,2023-01-05,8440
1519,華城,2353,892,1461,摩根大通,2023-01-05,8440
2409,友達,1793,427,1366,摩根大通,2023-01-05,8440
2881,富邦金,1685,330,1355,摩根大通,2023-01-05,8440
1101,台泥,1934,694,1240,摩根大通,2023-01-05,8440
3714,富采,1282,64,1218,摩根大通,2023-01-05,8440
8044,網家,1508,291,1217,摩根大通,2023-01-05,8440
4968,立積,1689,477,1212,摩根大通,2023-01-05,8440
2482,連宇,1438,312,1126,摩根大通,2023-01-05,8440
2412,中華電,1341,306,1035,摩根大通,2023-01-05,8440
8046,南電,1176,241,935,摩根大通,2023-01-05,8440
2883,凱基金,1079,170,909,摩根大通,2023-01-05,8440
2337,旺宏,857,105,752,摩根大通,2023-01-05,8440
1909,榮成,1913,1178,735,摩根大通,2023-01-05,8440
4167,松瑞藥,775,78,697,摩根大通,2023-01-05,8440
3034,聯詠,856,185,671,摩根大通,2023-01-05,8440
5347,世界,782,154,628,摩根大通,2023-01-05,8440
8171,天宇,1032,418,614,摩根大通,2023-01-05,8440
2886,兆豐金,1562,957,605,摩根大通,2023-01-05,8440
2324,仁寶,1045,443,602,摩根大通,2023-01-05,8440
3704,合勤控,1170,590,580,摩根大通,2023-01-05,8440
1314,中石化,541,6,535,摩根大通,2023-01-05,8440
2408,南亞科,812,292,520,摩根大通,2023-01-05,8440
2748,雲品,687,174,513,摩根大通,2023-01-05,8440
2353,宏��,851,342,509,摩根大通,2023-01-05,8440
2308,台達電,891,417,474,摩根大通,2023-01-05,8440
2498,宏達電,1383,911,472,摩根大通,2023-01-05,8440
5258,虹堡,498,55,443,摩根大通,2023-01-05,8440
8112,至上,474,40,434,摩根大通,2023-01-05,8440
2890,永豐金,827,427,400,摩根大通,2023-01-05,8440
2892,第一金,1360,970,390,摩根大通,2023-01-05,8440
5371,中光電,402,19,383,摩根大通,2023-01-05,8440
3594,磐儀,376,27,349,摩根大通,2023-01-05,8440
8033,雷虎,633,291,342,摩根大通,2023-01-05,8440
2344,華邦電,585,249,336,摩根大通,2023-01-05,8440
2014,中鴻,540,233,307,摩根大通,2023-01-05,8440
5351,鈺創,486,180,306,摩根大通,2023-01-05,8440
1529,樂事綠能,866,569,297,摩根大通,2023-01-05,8440
6414,樺漢,330,53,277,摩根大通,2023-01-05,8440
1605,華新,840,566,274,摩根大通,2023-01-05,8440
3479,安勤,367,95,272,摩根大通,2023-01-05,8440
2108,南帝,277,20,257,摩根大通,2023-01-05,8440
2903,遠百,346,93,253,摩根大通,2023-01-05,8440
2409,友達,5235,39,5196,摩根大通,2023-01-06,8440
5347,世界,5397,551,4846,摩根大通,2023-01-06,8440
2303,聯電,4191,351,3840,摩根大通,2023-01-06,8440
3711,日月光投控,3344,129,3215,摩根大通,2023-01-06,8440
3481,群創,2858,378,2480,摩根大通,2023-01-06,8440
2330,台積電,2174,537,1637,摩根大通,2023-01-06,8440
1605,華新,3720,2121,1599,摩根大通,2023-01-06,8440
3037,欣興,2198,685,1513,摩根大通,2023-01-06,8440
6770,力積電,1421,63,1358,摩根大通,2023-01-06,8440
2337,旺宏,1132,0,1132,摩根大通,2023-01-06,8440
6116,彩晶,962,16,946,摩根大通,2023-01-06,8440
2458,義隆,902,47,855,摩根大通,2023-01-06,8440
2881,富邦金,1044,253,791,摩根大通,2023-01-06,8440
8044,網家,956,213,743,摩根大通,2023-01-06,8440
4961,天鈺,1134,392,742,摩根大通,2023-01-06,8440
2885,元大金,928,209,719,摩根大通,2023-01-06,8440
2313,華通,788,125,663,摩根大通,2023-01-06,8440
3105,穩懋,663,72,591,摩根大通,2023-01-06,8440
1909,榮成,789,204,585,摩根大通,2023-01-06,8440
2317,鴻海,1110,534,576,摩根大通,2023-01-06,8440
2834,臺企銀,593,21,572,摩根大通,2023-01-06,8440
8046,南電,875,315,560,摩根大通,2023-01-06,8440
2327,國巨,679,120,559,摩根大通,2023-01-06,8440
2201,裕隆,1109,576,533,摩根大通,2023-01-06,8440
1101,台泥,996,470,526,摩根大通,2023-01-06,8440
8358,金居,640,119,521,摩根大通,2023-01-06,8440
2882,國泰金,805,415,390,摩根大通,2023-01-06,8440
3034,聯詠,577,213,364,摩根大通,2023-01-06,8440
2308,台達電,576,214,362,摩根大通,2023-01-06,8440
2880,華南金,475,135,340,摩根大通,2023-01-06,8440
1802,台玻,452,133,319,摩根大通,2023-01-06,8440
2344,華邦電,332,15,317,摩根大通,2023-01-06,8440
6550,北極星藥業-KY,318,2,316,摩根大通,2023-01-06,8440
2354,鴻準,368,57,311,摩根大通,2023-01-06,8440
8105,凌巨,380,83,297,摩根大通,2023-01-06,8440
8069,元太,801,508,293,摩根大通,2023-01-06,8440
3260,威剛,294,1,293,摩根大通,2023-01-06,8440
6182,合晶,310,26,284,摩根大通,2023-01-06,8440
3545,敦泰,555,278,277,摩根大通,2023-01-06,8440
1303,南亞,305,29,276,摩根大通,2023-01-06,8440
2801,彰銀,341,67,274,摩根大通,2023-01-06,8440
1102,亞泥,412,139,273,摩根大通,2023-01-06,8440
6789,采鈺,247,7,240,摩根大通,2023-01-06,8440
2027,大成鋼,263,24,239,摩根大通,2023-01-06,8440
2338,光罩,333,94,239,摩根大通,2023-01-06,8440
1409,新纖,232,0,232,摩根大通,2023-01-06,8440
8215,明基材,232,0,232,摩根大通,2023-01-06,8440
2105,正新,275,44,231,摩根大通,2023-01-06,8440
2618,長榮航,239,9,230,摩根大通,2023-01-06,8440
3707,漢磊,231,1,230,摩根大通,2023-01-06,8440
2884,玉山金,7460,123,7337,摩根大通,2023-01-09,8440
2303,聯電,7455,645,6810,摩根大通,2023-01-09,8440
2891,中信金,7655,1347,6308,摩根大通,2023-01-09,8440
2330,台積電,6690,1374,5316,摩根大通,2023-01-09,8440
2834,臺企銀,4891,216,4675,摩根大通,2023-01-09,8440
2886,兆豐金,4224,561,3663,摩根大通,2023-01-09,8440
2892,第一金,3345,151,3194,摩根大通,2023-01-09,8440
3711,日月光投控,3893,1060,2833,摩根大通,2023-01-09,8440
2887,台新金,2765,21,2744,摩根大通,2023-01-09,8440
5880,合庫金,2734,179,2555,摩根大通,2023-01-09,8440
2888,新光金,3445,903,2542,摩根大通,2023-01-09,8440
2883,凱基金,2665,439,2226,摩根大通,2023-01-09,8440
2881,富邦金,2876,656,2220,摩根大通,2023-01-09,8440
3231,緯創,2494,294,2200,摩根大通,2023-01-09,8440
6770,力積電,3390,1471,1919,摩根大通,2023-01-09,8440
2002,中鋼,2005,268,1737,摩根大通,2023-01-09,8440
1216,統一,1729,58,1671,摩根大通,2023-01-09,8440
2885,元大金,1630,39,1591,摩根大通,2023-01-09,8440
1101,台泥,1553,212,1341,摩根大通,2023-01-09,8440
2324,仁寶,1410,89,1321,摩根大通,2023-01-09,8440
2880,華南金,1325,96,1229,摩根大通,2023-01-09,8440
1301,台塑,1302,192,1110,摩根大通,2023-01-09,8440
1102,亞泥,1201,161,1040,摩根大通,2023-01-09,8440
6443,元晶,1054,26,1028,摩根大通,2023-01-09,8440
2356,英業達,1150,160,990,摩根大通,2023-01-09,8440
1303,南亞,1241,262,979,摩根大通,2023-01-09,8440
2382,廣達,1033,69,964,摩根大通,2023-01-09,8440
3454,晶睿,1175,298,877,摩根大通,2023-01-09,8440
2308,台達電,1216,346,870,摩根大通,2023-01-09,8440
2327,國巨,1008,139,869,摩根大通,2023-01-09,8440
2845,遠東銀,886,28,858,摩根大通,2023-01-09,8440
2344,華邦電,1796,982,814,摩根大通,2023-01-09,8440
2337,旺宏,996,208,788,摩根大通,2023-01-09,8440
2301,光寶科,1130,358,772,摩根大通,2023-01-09,8440
5871,中租-KY,1350,586,764,摩根大通,2023-01-09,8440
3714,富采,864,132,732,摩根大通,2023-01-09,8440
2890,永豐金,1753,1056,697,摩根大通,2023-01-09,8440
4938,和碩,719,57,662,摩根大通,2023-01-09,8440
5876,上海商銀,748,130,618,摩根大通,2023-01-09,8440
2618,長榮航,707,110,597,摩根大通,2023-01-09,8440
3293,鈊象,676,108,568,摩根大通,2023-01-09,8440
1314,中石化,656,94,562,摩根大通,2023-01-09,8440
2105,正新,623,84,539,摩根大通,2023-01-09,8440
1513,中興電,896,359,537,摩根大通,2023-01-09,8440
2882,國泰金,1883,1380,503,摩根大通,2023-01-09,8440
6005,群益證,505,19,486,摩根大通,2023-01-09,8440
5347,世界,1576,1096,480,摩根大通,2023-01-09,8440
2633,台灣高鐵,543,64,479,摩根大通,2023-01-09,8440
1326,台化,620,148,472,摩根大通,2023-01-09,8440
2481,強茂,474,19,455,摩根大通,2023-01-09,8440
3481,群創,6732,266,6466,摩根大通,2023-01-10,8440
2303,聯電,6952,1681,5271,摩根大通,2023-01-10,8440
2409,友達,4456,343,4113,摩根大通,2023-01-10,8440
2344,華邦電,2013,175,1838,摩根大通,2023-01-10,8440
2883,凱基金,1954,197,1757,摩根大通,2023-01-10,8440
4961,天鈺,2018,267,1751,摩根大通,2023-01-10,8440
3037,欣興,1234,82,1152,摩根大通,2023-01-10,8440
2408,南亞科,1355,286,1069,摩根大通,2023-01-10,8440
0050,元大台灣50,1025,0,1025,摩根大通,2023-01-10,8440
2892,第一金,1839,847,992,摩根大通,2023-01-10,8440
3231,緯創,1349,385,964,摩根大通,2023-01-10,8440
3034,聯詠,1000,79,921,摩根大通,2023-01-10,8440
2330,台積電,2221,1313,908,摩根大通,2023-01-10,8440
2317,鴻海,990,95,895,摩根大通,2023-01-10,8440
6770,力積電,1176,317,859,摩根大通,2023-01-10,8440
2301,光寶科,1075,255,820,摩根大通,2023-01-10,8440
3711,日月光投控,888,69,819,摩根大通,2023-01-10,8440
5880,合庫金,927,110,817,摩根大通,2023-01-10,8440
9904,寶成,1041,238,803,摩根大通,2023-01-10,8440
2376,技嘉,858,82,776,摩根大通,2023-01-10,8440
8069,元太,1390,637,753,摩根大通,2023-01-10,8440
2337,旺宏,763,18,745,摩根大通,2023-01-10,8440
3105,穩懋,1333,589,744,摩根大通,2023-01-10,8440
8358,金居,1001,284,717,摩根大通,2023-01-10,8440
2353,宏��,955,267,688,摩根大通,2023-01-10,8440
1314,中石化,667,26,641,摩根大通,2023-01-10,8440
5871,中租-KY,781,142,639,摩根大通,2023-01-10,8440
2327,國巨,772,148,624,摩根大通,2023-01-10,8440
3708,上緯投控,574,26,548,摩根大通,2023-01-10,8440
2812,台中銀,693,151,542,摩根大通,2023-01-10,8440
1513,中興電,899,358,541,摩根大通,2023-01-10,8440
1909,榮成,593,76,517,摩根大通,2023-01-10,8440
2885,元大金,793,278,515,摩根大通,2023-01-10,8440
2454,聯發科,719,260,459,摩根大通,2023-01-10,8440
2888,新光金,2387,1954,433,摩根大通,2023-01-10,8440
2801,彰銀,716,286,430,摩根大通,2023-01-10,8440
2455,全新,718,289,429,摩根大通,2023-01-10,8440
1701,中化,580,162,418,摩根大通,2023-01-10,8440
1305,華夏,970,559,411,摩根大通,2023-01-10,8440
2308,台達電,808,405,403,摩根大通,2023-01-10,8440
3042,晶技,537,157,380,摩根大通,2023-01-10,8440
2481,強茂,458,98,360,摩根大通,2023-01-10,8440
2449,京元電子,398,57,341,摩根大通,2023-01-10,8440
4919,新唐,379,49,330,摩根大通,2023-01-10,8440
2382,廣達,403,116,287,摩根大通,2023-01-10,8440
4763,材料-KY,1009,727,282,摩根大通,2023-01-10,8440
8049,晶采,267,0,267,摩根大通,2023-01-10,8440
2428,興勤,449,202,247,摩根大通,2023-01-10,8440
6153,嘉聯益,234,13,221,摩根大通,2023-01-10,8440
4950,牧東,219,2,217,摩根大通,2023-01-10,8440
2303,聯電,7804,768,7036,摩根大通,2023-01-11,8440
3481,群創,7006,196,6810,摩根大通,2023-01-11,8440
2409,友達,6839,522,6317,摩根大通,2023-01-11,8440
2317,鴻海,2848,601,2247,摩根大通,2023-01-11,8440
3231,緯創,2270,234,2036,摩根大通,2023-01-11,8440
2408,南亞科,2128,297,1831,摩根大通,2023-01-11,8440
2886,兆豐金,2078,538,1540,摩根大通,2023-01-11,8440
3711,日月光投控,1499,221,1278,摩根大通,2023-01-11,8440
1605,華新,1964,793,1171,摩根大通,2023-01-11,8440
2885,元大金,1367,198,1169,摩根大通,2023-01-11,8440
5871,中租-KY,1218,102,1116,摩根大通,2023-01-11,8440
5483,中美晶,1109,2,1107,摩根大通,2023-01-11,8440
2330,台積電,1635,537,1098,摩根大通,2023-01-11,8440
2888,新光金,1595,501,1094,摩根大通,2023-01-11,8440
2454,聯發科,1355,279,1076,摩根大通,2023-01-11,8440
2883,凱基金,1324,261,1063,摩根大通,2023-01-11,8440
1303,南亞,1080,212,868,摩根大通,2023-01-11,8440
2412,中華電,1410,580,830,摩根大通,2023-01-11,8440
2891,中信金,1218,412,806,摩根大通,2023-01-11,8440
2382,廣達,1013,243,770,摩根大通,2023-01-11,8440
3037,欣興,916,236,680,摩根大通,2023-01-11,8440
2014,中鴻,928,285,643,摩根大通,2023-01-11,8440
2845,遠東銀,619,5,614,摩根大通,2023-01-11,8440
3034,聯詠,1102,545,557,摩根大通,2023-01-11,8440
2308,台達電,785,237,548,摩根大通,2023-01-11,8440
2337,旺宏,544,94,450,摩根大通,2023-01-11,8440
1326,台化,446,22,424,摩根大通,2023-01-11,8440
5014,建錩,421,0,421,摩根大通,2023-01-11,8440
4763,材料-KY,1072,655,417,摩根大通,2023-01-11,8440
2356,英業達,1154,742,412,摩根大通,2023-01-11,8440
2324,仁寶,1636,1228,408,摩根大通,2023-01-11,8440
6147,頎邦,461,56,405,摩根大通,2023-01-11,8440
2301,光寶科,973,575,398,摩根大通,2023-01-11,8440
2354,鴻準,430,42,388,摩根大通,2023-01-11,8440
5876,上海商銀,452,81,371,摩根大通,2023-01-11,8440
5371,中光電,365,2,363,摩根大通,2023-01-11,8440
3013,晟銘電,413,58,355,摩根大通,2023-01-11,8440
1802,台玻,359,27,332,摩根大通,2023-01-11,8440
2884,玉山金,1415,1083,332,摩根大通,2023-01-11,8440
2458,義隆,391,59,332,摩根大通,2023-01-11,8440
2344,華邦電,583,264,319,摩根大通,2023-01-11,8440
6285,啟��,299,5,294,摩根大通,2023-01-11,8440
2353,宏��,419,130,289,摩根大通,2023-01-11,8440
2610,華航,307,21,286,摩根大通,2023-01-11,8440
8358,金居,425,142,283,摩根大通,2023-01-11,8440
1402,遠東新,1312,1030,282,摩根大通,2023-01-11,8440
2357,華碩,408,128,280,摩根大通,2023-01-11,8440
9945,潤泰新,625,353,272,摩根大通,2023-01-11,8440
2812,台中銀,261,0,261,摩根大通,2023-01-11,8440
6415,矽力*-KY,461,210,251,摩根大通,2023-01-11,8440
2303,聯電,3143,867,2276,摩根大通,2023-01-12,8440
3711,日月光投控,2319,274,2045,摩根大通,2023-01-12,8440
1584,精剛,1910,66,1844,摩根大通,2023-01-12,8440
2409,友達,2669,837,1832,摩根大通,2023-01-12,8440
2002,中鋼,2479,805,1674,摩根大通,2023-01-12,8440
1101,台泥,1977,763,1214,摩根大通,2023-01-12,8440
2886,兆豐金,1780,573,1207,摩根大通,2023-01-12,8440
5880,合庫金,1843,645,1198,摩根大通,2023-01-12,8440
2356,英業達,1750,717,1033,摩根大通,2023-01-12,8440
2880,華南金,1721,772,949,摩根大通,2023-01-12,8440
1752,南光,811,47,764,摩根大通,2023-01-12,8440
2201,裕隆,938,198,740,摩根大通,2023-01-12,8440
2897,王道銀行,890,185,705,摩根大通,2023-01-12,8440
4167,松瑞藥,719,41,678,摩根大通,2023-01-12,8440
2885,元大金,1779,1106,673,摩根大通,2023-01-12,8440
1612,宏泰,840,210,630,摩根大通,2023-01-12,8440
2618,長榮航,669,39,630,摩根大通,2023-01-12,8440
2027,大成鋼,554,14,540,摩根大通,2023-01-12,8440
2330,台積電,1750,1245,505,摩根大通,2023-01-12,8440
2892,第一金,2030,1537,493,摩根大通,2023-01-12,8440
2882,國泰金,769,302,467,摩根大通,2023-01-12,8440
1216,統一,964,538,426,摩根大通,2023-01-12,8440
1313,聯成,390,13,377,摩根大通,2023-01-12,8440
4961,天鈺,730,365,365,摩根大通,2023-01-12,8440
2324,仁寶,1233,901,332,摩根大通,2023-01-12,8440
6533,晶心科,402,80,322,摩根大通,2023-01-12,8440
3545,敦泰,354,36,318,摩根大通,2023-01-12,8440
2603,長榮,993,676,317,摩根大通,2023-01-12,8440
5871,中租-KY,316,14,302,摩根大通,2023-01-12,8440
1718,中纖,323,41,282,摩根大通,2023-01-12,8440
2454,聯發科,615,334,281,摩根大通,2023-01-12,8440
3034,聯詠,661,391,270,摩根大通,2023-01-12,8440
1514,亞力,277,14,263,摩根大通,2023-01-12,8440
2031,新光鋼,294,49,245,摩根大通,2023-01-12,8440
2337,旺宏,282,44,238,摩根大通,2023-01-12,8440
2344,華邦電,793,558,235,摩根大通,2023-01-12,8440
2358,廷鑫,1224,1002,222,摩根大通,2023-01-12,8440
2723,美食-KY,281,71,210,摩根大通,2023-01-12,8440
6139,亞翔,289,83,206,摩根大通,2023-01-12,8440
5263,智崴,332,136,196,摩根大通,2023-01-12,8440
2301,光寶科,490,299,191,摩根大通,2023-01-12,8440
3293,鈊象,266,77,189,摩根大通,2023-01-12,8440
2515,中工,233,50,183,摩根大通,2023-01-12,8440
3665,貿聯-KY,190,18,172,摩根大通,2023-01-12,8440
3680,家登,200,28,172,摩根大通,2023-01-12,8440
1802,台玻,389,222,167,摩根大通,2023-01-12,8440
8046,南電,221,62,159,摩根大通,2023-01-12,8440
2404,漢唐,173,14,159,摩根大通,2023-01-12,8440
6531,愛普*,164,15,149,摩根大通,2023-01-12,8440
2347,聯強,468,320,148,摩根大通,2023-01-12,8440
2330,台積電,11976,1335,10641,摩根大通,2023-01-13,8440
2891,中信金,5991,781,5210,摩根大通,2023-01-13,8440
2618,長榮航,5182,102,5080,摩根大通,2023-01-13,8440
2303,聯電,4902,831,4071,摩根大通,2023-01-13,8440
2002,中鋼,3012,91,2921,摩根大通,2023-01-13,8440
2884,玉山金,2294,13,2281,摩根大通,2023-01-13,8440
2887,台新金,2352,289,2063,摩根大通,2023-01-13,8440
9904,寶成,2202,154,2048,摩根大通,2023-01-13,8440
3037,欣興,2358,484,1874,摩根大通,2023-01-13,8440
5880,合庫金,1797,56,1741,摩根大通,2023-01-13,8440
2409,友達,2062,451,1611,摩根大通,2023-01-13,8440
2888,新光金,1618,103,1515,摩根大通,2023-01-13,8440
1101,台泥,1931,419,1512,摩根大通,2023-01-13,8440
2301,光寶科,1465,34,1431,摩根大通,2023-01-13,8440
2338,光罩,1522,302,1220,摩根大通,2023-01-13,8440
0056,元大高股息,1101,7,1094,摩根大通,2023-01-13,8440
3231,緯創,1126,69,1057,摩根大通,2023-01-13,8440
6770,力積電,1764,738,1026,摩根大通,2023-01-13,8440
2812,台中銀,1058,45,1013,摩根大通,2023-01-13,8440
2834,臺企銀,974,0,974,摩根大通,2023-01-13,8440
2880,華南金,1352,403,949,摩根大通,2023-01-13,8440
2610,華航,954,26,928,摩根大通,2023-01-13,8440
2633,台灣高鐵,934,11,923,摩根大通,2023-01-13,8440
2881,富邦金,1125,227,898,摩根大通,2023-01-13,8440
1402,遠東新,1089,220,869,摩根大通,2023-01-13,8440
5009,榮剛,768,33,735,摩根大通,2023-01-13,8440
1783,和康生,874,228,646,摩根大通,2023-01-13,8440
2885,元大金,1055,472,583,摩根大通,2023-01-13,8440
2605,新興,628,73,555,摩根大通,2023-01-13,8440
3034,聯詠,875,322,553,摩根大通,2023-01-13,8440
4961,天鈺,755,238,517,摩根大通,2023-01-13,8440
2324,仁寶,708,200,508,摩根大通,2023-01-13,8440
2851,中再保,538,45,493,摩根大通,2023-01-13,8440
2892,第一金,976,509,467,摩根大通,2023-01-13,8440
2889,國票金,542,94,448,摩根大通,2023-01-13,8440
2358,廷鑫,1453,1018,435,摩根大通,2023-01-13,8440
1308,亞聚,440,22,418,摩根大通,2023-01-13,8440
2408,南亞科,656,254,402,摩根大通,2023-01-13,8440
2845,遠東銀,331,0,331,摩根大通,2023-01-13,8440
1216,統一,368,48,320,摩根大通,2023-01-13,8440
2105,正新,477,179,298,摩根大通,2023-01-13,8440
2347,聯強,311,15,296,摩根大通,2023-01-13,8440
6180,橘子,319,24,295,摩根大通,2023-01-13,8440
2201,裕隆,546,258,288,摩根大通,2023-01-13,8440
1326,台化,307,31,276,摩根大通,2023-01-13,8440
2606,裕民,386,116,270,摩根大通,2023-01-13,8440
2412,中華電,273,3,270,摩根大通,2023-01-13,8440
2027,大成鋼,309,50,259,摩根大通,2023-01-13,8440
2886,兆豐金,273,31,242,摩根大通,2023-01-13,8440
9938,百和,311,69,242,摩根大通,2023-01-13,8440
2881,富邦金,2541,276,2265,摩根大通,2023-01-16,8440
2834,臺企銀,2249,0,2249,摩根大通,2023-01-16,8440
2412,中華電,2011,210,1801,摩根大通,2023-01-16,8440
2886,兆豐金,1664,176,1488,摩根大通,2023-01-16,8440
2891,中信金,2607,1170,1437,摩根大通,2023-01-16,8440
2890,永豐金,2095,714,1381,摩根大通,2023-01-16,8440
2884,玉山金,3023,1659,1364,摩根大通,2023-01-16,8440
2330,台積電,3082,1930,1152,摩根大通,2023-01-16,8440
2301,光寶科,1125,220,905,摩根大通,2023-01-16,8440
2885,元大金,1667,835,832,摩根大通,2023-01-16,8440
2892,第一金,981,246,735,摩根大通,2023-01-16,8440
8069,元太,866,152,714,摩根大通,2023-01-16,8440
0056,元大高股息,776,139,637,摩根大通,2023-01-16,8440
5880,合庫金,878,246,632,摩根大通,2023-01-16,8440
2882,國泰金,1828,1229,599,摩根大通,2023-01-16,8440
1326,台化,556,9,547,摩根大通,2023-01-16,8440
2454,聯發科,669,156,513,摩根大通,2023-01-16,8440
8996,高力,693,189,504,摩根大通,2023-01-16,8440
4162,智擎,501,63,438,摩根大通,2023-01-16,8440
4977,眾達-KY,450,17,433,摩根大通,2023-01-16,8440
1102,亞泥,489,57,432,摩根大通,2023-01-16,8440
8478,東哥遊艇,585,167,418,摩根大通,2023-01-16,8440
3105,穩懋,642,239,403,摩根大通,2023-01-16,8440
1701,中化,700,306,394,摩根大通,2023-01-16,8440
4167,松瑞藥,496,105,391,摩根大通,2023-01-16,8440
2376,技嘉,462,81,381,摩根大通,2023-01-16,8440
2383,台光電,514,137,377,摩根大通,2023-01-16,8440
3443,創意,417,43,374,摩根大通,2023-01-16,8440
8150,南茂,375,1,374,摩根大通,2023-01-16,8440
4155,訊映,395,26,369,摩根大通,2023-01-16,8440
1319,東陽,373,6,367,摩根大通,2023-01-16,8440
1303,南亞,429,69,360,摩根大通,2023-01-16,8440
8046,南電,382,23,359,摩根大通,2023-01-16,8440
3037,欣興,1620,1268,352,摩根大通,2023-01-16,8440
1417,嘉裕,377,28,349,摩根大通,2023-01-16,8440
2308,台達電,519,174,345,摩根大通,2023-01-16,8440
2929,淘帝-KY,412,70,342,摩根大通,2023-01-16,8440
1514,亞力,346,8,338,摩根大通,2023-01-16,8440
3045,台灣大,411,76,335,摩根大通,2023-01-16,8440
2382,廣達,587,252,335,摩根大通,2023-01-16,8440
1810,和成,344,15,329,摩根大通,2023-01-16,8440
3189,景碩,391,71,320,摩根大通,2023-01-16,8440
5258,虹堡,343,34,309,摩根大通,2023-01-16,8440
4968,立積,310,5,305,摩根大通,2023-01-16,8440
2201,裕隆,709,406,303,摩根大通,2023-01-16,8440
2880,華南金,649,352,297,摩根大通,2023-01-16,8440
4763,材料-KY,546,250,296,摩根大通,2023-01-16,8440
1802,台玻,367,79,288,摩根大通,2023-01-16,8440
6643,M31,287,11,276,摩根大通,2023-01-16,8440
8033,雷虎,267,0,267,摩根大通,2023-01-16,8440
2303,聯電,5863,519,5344,摩根大通,2023-01-17,8440
2883,凱基金,5851,711,5140,摩根大通,2023-01-17,8440
2881,富邦金,4620,360,4260,摩根大通,2023-01-17,8440
2317,鴻海,4804,1046,3758,摩根大通,2023-01-17,8440
3576,聯合再生,4325,876,3449,摩根大通,2023-01-17,8440
2888,新光金,3364,209,3155,摩根大通,2023-01-17,8440
1101,台泥,1686,257,1429,摩根大通,2023-01-17,8440
2301,光寶科,1490,170,1320,摩根大通,2023-01-17,8440
6244,茂迪,1494,203,1291,摩根大通,2023-01-17,8440
5880,合庫金,1479,215,1264,摩根大通,2023-01-17,8440
2885,元大金,1583,497,1086,摩根大通,2023-01-17,8440
2609,陽明,1241,170,1071,摩根大通,2023-01-17,8440
8996,高力,1949,932,1017,摩根大通,2023-01-17,8440
2880,華南金,1134,180,954,摩根大通,2023-01-17,8440
2891,中信金,2861,1912,949,摩根大通,2023-01-17,8440
1303,南亞,905,22,883,摩根大通,2023-01-17,8440
9945,潤泰新,939,133,806,摩根大通,2023-01-17,8440
1216,統一,829,60,769,摩根大通,2023-01-17,8440
3105,穩懋,885,121,764,摩根大通,2023-01-17,8440
2308,台達電,1049,372,677,摩根大通,2023-01-17,8440
1102,亞泥,754,78,676,摩根大通,2023-01-17,8440
2890,永豐金,1502,874,628,摩根大通,2023-01-17,8440
2892,第一金,767,183,584,摩根大通,2023-01-17,8440
5009,榮剛,666,107,559,摩根大通,2023-01-17,8440
4743,合一,608,56,552,摩根大通,2023-01-17,8440
3027,盛達,564,33,531,摩根大通,2023-01-17,8440
8046,南電,594,78,516,摩根大通,2023-01-17,8440
1313,聯成,515,12,503,摩根大通,2023-01-17,8440
2002,中鋼,1475,986,489,摩根大通,2023-01-17,8440
1605,華新,935,452,483,摩根大通,2023-01-17,8440
2356,英業達,557,94,463,摩根大通,2023-01-17,8440
2748,雲品,699,249,450,摩根大通,2023-01-17,8440
2324,仁寶,453,16,437,摩根大通,2023-01-17,8440
3231,緯創,500,87,413,摩根大通,2023-01-17,8440
1802,台玻,474,67,407,摩根大通,2023-01-17,8440
8086,宏捷科,417,44,373,摩根大通,2023-01-17,8440
2014,中鴻,546,183,363,摩根大通,2023-01-17,8440
4746,台耀,422,65,357,摩根大通,2023-01-17,8440
2330,台積電,1846,1500,346,摩根大通,2023-01-17,8440
2353,宏��,646,328,318,摩根大通,2023-01-17,8440
1701,中化,528,215,313,摩根大通,2023-01-17,8440
0056,元大高股息,308,0,308,摩根大通,2023-01-17,8440
2344,華邦電,606,302,304,摩根大通,2023-01-17,8440
2028,威致,312,10,302,摩根大通,2023-01-17,8440
2382,廣達,331,33,298,摩根大通,2023-01-17,8440
2027,大成鋼,310,14,296,摩根大通,2023-01-17,8440
2031,新光鋼,319,25,294,摩根大通,2023-01-17,8440
4904,遠傳,351,63,288,摩根大通,2023-01-17,8440
1477,聚陽,321,36,285,摩根大通,2023-01-17,8440
6533,晶心科,335,54,281,摩根大通,2023-01-17,8440
2303,聯電,18235,5753,12482,摩根大通,2023-01-30,8440
1605,華新,6994,1361,5633,摩根大通,2023-01-30,8440
2409,友達,5761,427,5334,摩根大通,2023-01-30,8440
3481,群創,7681,2749,4932,摩根大通,2023-01-30,8440
2885,元大金,6322,1771,4551,摩根大通,2023-01-30,8440
2618,長榮航,4219,306,3913,摩根大通,2023-01-30,8440
3231,緯創,3799,371,3428,摩根大通,2023-01-30,8440
6770,力積電,3945,681,3264,摩根大通,2023-01-30,8440
2890,永豐金,4885,2060,2825,摩根大通,2023-01-30,8440
2498,宏達電,3068,307,2761,摩根大通,2023-01-30,8440
2449,京元電子,2689,188,2501,摩根大通,2023-01-30,8440
2344,華邦電,3023,593,2430,摩根大通,2023-01-30,8440
2408,南亞科,2569,317,2252,摩根大通,2023-01-30,8440
2887,台新金,3860,1694,2166,摩根大通,2023-01-30,8440
2337,旺宏,2622,559,2063,摩根大通,2023-01-30,8440
2882,國泰金,2649,683,1966,摩根大通,2023-01-30,8440
6505,台塑化,1833,99,1734,摩根大通,2023-01-30,8440
6282,康舒,1766,319,1447,摩根大通,2023-01-30,8440
2888,新光金,3292,1868,1424,摩根大通,2023-01-30,8440
2023,燁輝,1309,50,1259,摩根大通,2023-01-30,8440
2482,連宇,1489,299,1190,摩根大通,2023-01-30,8440
2610,華航,1287,124,1163,摩根大通,2023-01-30,8440
2801,彰銀,1824,672,1152,摩根大通,2023-01-30,8440
2352,佳世達,978,36,942,摩根大通,2023-01-30,8440
3105,穩懋,1323,397,926,摩根大通,2023-01-30,8440
1802,台玻,1175,260,915,摩根大通,2023-01-30,8440
2327,國巨,1493,604,889,摩根大通,2023-01-30,8440
5009,榮剛,1039,152,887,摩根大通,2023-01-30,8440
1314,中石化,954,71,883,摩根大通,2023-01-30,8440
5425,台半,1136,253,883,摩根大通,2023-01-30,8440
5347,世界,1406,580,826,摩根大通,2023-01-30,8440
5871,中租-KY,1264,444,820,摩根大通,2023-01-30,8440
6116,彩晶,966,162,804,摩根大通,2023-01-30,8440
1584,精剛,929,141,788,摩根大通,2023-01-30,8440
3027,盛達,1115,330,785,摩根大通,2023-01-30,8440
8046,南電,1394,615,779,摩根大通,2023-01-30,8440
6550,北極星藥業-KY,804,26,778,摩根大通,2023-01-30,8440
3454,晶睿,1036,277,759,摩根大通,2023-01-30,8440
2867,三商壽,946,189,757,摩根大通,2023-01-30,8440
2454,聯發科,2095,1352,743,摩根大通,2023-01-30,8440
2412,中華電,2185,1478,707,摩根大通,2023-01-30,8440
1303,南亞,1225,525,700,摩根大通,2023-01-30,8440
2347,聯強,1024,338,686,摩根大通,2023-01-30,8440
1701,中化,757,95,662,摩根大通,2023-01-30,8440
2345,智邦,876,218,658,摩根大通,2023-01-30,8440
6180,橘子,761,128,633,摩根大通,2023-01-30,8440
5258,虹堡,846,213,633,摩根大通,2023-01-30,8440
1402,遠東新,1500,896,604,摩根大通,2023-01-30,8440
2204,中華,977,378,599,摩根大通,2023-01-30,8440
2382,廣達,887,294,593,摩根大通,2023-01-30,8440
1605,華新,7579,2726,4853,摩根大通,2023-01-31,8440
2618,長榮航,4305,492,3813,摩根大通,2023-01-31,8440
6282,康舒,2821,585,2236,摩根大通,2023-01-31,8440
2498,宏達電,2383,302,2081,摩根大通,2023-01-31,8440
9904,寶成,2211,214,1997,摩根大通,2023-01-31,8440
2201,裕隆,3225,1327,1898,摩根大通,2023-01-31,8440
5258,虹堡,2132,379,1753,摩根大通,2023-01-31,8440
2002,中鋼,2314,605,1709,摩根大通,2023-01-31,8440
6770,力積電,1886,313,1573,摩根大通,2023-01-31,8440
2610,華航,1781,305,1476,摩根大通,2023-01-31,8440
1513,中興電,2092,753,1339,摩根大通,2023-01-31,8440
3702,大聯大,1306,182,1124,摩根大通,2023-01-31,8440
2888,新光金,1454,348,1106,摩根大通,2023-01-31,8440
1609,大亞,1538,640,898,摩根大通,2023-01-31,8440
2347,聯強,974,136,838,摩根大通,2023-01-31,8440
9945,潤泰新,936,161,775,摩根大通,2023-01-31,8440
2324,仁寶,1567,795,772,摩根大通,2023-01-31,8440
2023,燁輝,956,202,754,摩根大通,2023-01-31,8440
8105,凌巨,1263,550,713,摩根大通,2023-01-31,8440
2027,大成鋼,786,99,687,摩根大通,2023-01-31,8440
2014,中鴻,850,189,661,摩根大通,2023-01-31,8440
1718,中纖,702,49,653,摩根大通,2023-01-31,8440
2542,興富發,909,271,638,摩根大通,2023-01-31,8440
2371,大同,659,24,635,摩根大通,2023-01-31,8440
2301,光寶科,1032,401,631,摩根大通,2023-01-31,8440
1216,統一,647,36,611,摩根大通,2023-01-31,8440
1314,中石化,610,53,557,摩根大通,2023-01-31,8440
8215,明基材,578,49,529,摩根大通,2023-01-31,8440
8261,富鼎,647,147,500,摩根大通,2023-01-31,8440
2605,新興,559,71,488,摩根大通,2023-01-31,8440
1802,台玻,1419,942,477,摩根大通,2023-01-31,8440
8046,南電,799,376,423,摩根大通,2023-01-31,8440
2352,佳世達,485,70,415,摩根大通,2023-01-31,8440
9105,泰金寶-DR,430,20,410,摩根大通,2023-01-31,8440
1514,亞力,450,47,403,摩根大通,2023-01-31,8440
3207,耀勝,428,28,400,摩根大通,2023-01-31,8440
2327,國巨,488,94,394,摩根大通,2023-01-31,8440
2382,廣達,1125,732,393,摩根大通,2023-01-31,8440
2308,台達電,600,207,393,摩根大通,2023-01-31,8440
1308,亞聚,388,3,385,摩根大通,2023-01-31,8440
6244,茂迪,578,202,376,摩根大通,2023-01-31,8440
2609,陽明,595,239,356,摩根大通,2023-01-31,8440
1304,台聚,527,171,356,摩根大通,2023-01-31,8440
5371,中光電,366,10,356,摩根大通,2023-01-31,8440
2328,廣宇,428,74,354,摩根大通,2023-01-31,8440
2353,宏��,1239,891,348,摩根大通,2023-01-31,8440
1102,亞泥,486,142,344,摩根大通,2023-01-31,8440
6116,彩晶,1836,1494,342,摩根大通,2023-01-31,8440
1303,南亞,390,59,331,摩根大通,2023-01-31,8440
2323,中環,436,116,320,摩根大通,2023-01-31,8440
2618,長榮航,3069,109,2960,摩根大通,2023-02-01,8440
1605,華新,4454,2238,2216,摩根大通,2023-02-01,8440
6770,力積電,2363,150,2213,摩根大通,2023-02-01,8440
2201,裕隆,2500,343,2157,摩根大通,2023-02-01,8440
2633,台灣高鐵,1389,75,1314,摩根大通,2023-02-01,8440
1513,中興電,1526,320,1206,摩根大通,2023-02-01,8440
5425,台半,1640,546,1094,摩根大通,2023-02-01,8440
6443,元晶,1446,395,1051,摩根大通,2023-02-01,8440
4915,致伸,1049,86,963,摩根大通,2023-02-01,8440
2498,宏達電,1186,261,925,摩根大通,2023-02-01,8440
6239,力成,1035,161,874,摩根大通,2023-02-01,8440
3162,精確,866,97,769,摩根大通,2023-02-01,8440
5871,中租-KY,1194,427,767,摩根大通,2023-02-01,8440
2371,大同,783,26,757,摩根大通,2023-02-01,8440
2449,京元電子,786,38,748,摩根大通,2023-02-01,8440
8358,金居,881,186,695,摩根大通,2023-02-01,8440
8046,南電,1196,531,665,摩根大通,2023-02-01,8440
1504,東元,828,225,603,摩根大通,2023-02-01,8440
8069,元太,739,145,594,摩根大通,2023-02-01,8440
2614,東森,775,213,562,摩根大通,2023-02-01,8440
2606,裕民,638,87,551,摩根大通,2023-02-01,8440
1524,耿鼎,635,100,535,摩根大通,2023-02-01,8440
3712,永崴投控,537,21,516,摩根大通,2023-02-01,8440
2474,可成,716,208,508,摩根大通,2023-02-01,8440
2615,萬海,604,120,484,摩根大通,2023-02-01,8440
2605,新興,550,76,474,摩根大通,2023-02-01,8440
2208,台船,495,43,452,摩根大通,2023-02-01,8440
6118,建達,466,40,426,摩根大通,2023-02-01,8440
3711,日月光投控,515,95,420,摩根大通,2023-02-01,8440
2867,三商壽,649,234,415,摩根大通,2023-02-01,8440
2345,智邦,487,76,411,摩根大通,2023-02-01,8440
6415,矽力*-KY,543,139,404,摩根大通,2023-02-01,8440
9958,世紀鋼,746,348,398,摩根大通,2023-02-01,8440
2482,連宇,1115,721,394,摩根大通,2023-02-01,8440
3264,欣銓,418,40,378,摩根大通,2023-02-01,8440
3289,宜特,439,61,378,摩根大通,2023-02-01,8440
5258,虹堡,955,600,355,摩根大通,2023-02-01,8440
8215,明基材,374,21,353,摩根大通,2023-02-01,8440
3290,東浦,412,67,345,摩根大通,2023-02-01,8440
2347,聯強,446,105,341,摩根大通,2023-02-01,8440
3037,欣興,926,589,337,摩根大通,2023-02-01,8440
2851,中再保,344,12,332,摩根大通,2023-02-01,8440
6274,台燿,363,46,317,摩根大通,2023-02-01,8440
2492,華新科,514,202,312,摩根大通,2023-02-01,8440
1785,光洋科,418,122,296,摩根大通,2023-02-01,8440
6180,橘子,299,30,269,摩根大通,2023-02-01,8440
6182,合晶,482,219,263,摩根大通,2023-02-01,8440
3596,智易,271,13,258,摩根大通,2023-02-01,8440
3189,景碩,445,195,250,摩根大通,2023-02-01,8440
1312,國喬,261,18,243,摩根大通,2023-02-01,8440
2882,國泰金,5221,1530,3691,摩根大通,2023-02-02,8440
2344,華邦電,4111,1686,2425,摩根大通,2023-02-02,8440
2449,京元電子,1493,121,1372,摩根大通,2023-02-02,8440
0050,元大台灣50,1321,0,1321,摩根大通,2023-02-02,8440
2867,三商壽,1619,361,1258,摩根大通,2023-02-02,8440
2897,王道銀行,1012,10,1002,摩根大通,2023-02-02,8440
2337,旺宏,1171,198,973,摩根大通,2023-02-02,8440
2408,南亞科,1169,286,883,摩根大通,2023-02-02,8440
2313,華通,1098,215,883,摩根大通,2023-02-02,8440
1609,大亞,1486,611,875,摩根大通,2023-02-02,8440
2498,宏達電,1038,204,834,摩根大通,2023-02-02,8440
2303,聯電,3067,2233,834,摩根大通,2023-02-02,8440
2633,台灣高鐵,981,246,735,摩根大通,2023-02-02,8440
2208,台船,795,73,722,摩根大通,2023-02-02,8440
2329,華泰,1037,349,688,摩根大通,2023-02-02,8440
1584,精剛,802,158,644,摩根大通,2023-02-02,8440
3035,智原,825,184,641,摩根大通,2023-02-02,8440
5371,中光電,722,126,596,摩根大通,2023-02-02,8440
3707,漢磊,644,58,586,摩根大通,2023-02-02,8440
2354,鴻準,734,172,562,摩根大通,2023-02-02,8440
4919,新唐,1062,503,559,摩根大通,2023-02-02,8440
2345,智邦,693,141,552,摩根大通,2023-02-02,8440
3017,奇鋐,800,264,536,摩根大通,2023-02-02,8440
6116,彩晶,1019,501,518,摩根大通,2023-02-02,8440
8215,明基材,639,145,494,摩根大通,2023-02-02,8440
8933,愛地雅,483,0,483,摩根大通,2023-02-02,8440
2371,大同,800,329,471,摩根大通,2023-02-02,8440
5351,鈺創,794,343,451,摩根大通,2023-02-02,8440
3454,晶睿,483,36,447,摩根大通,2023-02-02,8440
2368,金像電,569,129,440,摩根大通,2023-02-02,8440
9105,泰金寶-DR,513,87,426,摩根大通,2023-02-02,8440
3711,日月光投控,651,226,425,摩根大通,2023-02-02,8440
2606,裕民,438,15,423,摩根大通,2023-02-02,8440
2102,泰豐,415,0,415,摩根大通,2023-02-02,8440
2801,彰銀,838,433,405,摩根大通,2023-02-02,8440
2481,強茂,436,38,398,摩根大通,2023-02-02,8440
2347,聯強,777,381,396,摩根大通,2023-02-02,8440
6257,矽格,419,27,392,摩根大通,2023-02-02,8440
6104,創惟,510,123,387,摩根大通,2023-02-02,8440
3228,金麗科,431,47,384,摩根大通,2023-02-02,8440
1102,亞泥,676,306,370,摩根大通,2023-02-02,8440
6282,康舒,1096,727,369,摩根大通,2023-02-02,8440
6415,矽力*-KY,463,102,361,摩根大通,2023-02-02,8440
3006,晶豪科,671,324,347,摩根大通,2023-02-02,8440
2312,金寶,496,152,344,摩根大通,2023-02-02,8440
3265,台星科,351,10,341,摩根大通,2023-02-02,8440
2486,一詮,492,161,331,摩根大通,2023-02-02,8440
5258,虹堡,634,304,330,摩根大通,2023-02-02,8440
1789,神隆,320,1,319,摩根大通,2023-02-02,8440
3027,盛達,510,200,310,摩根大通,2023-02-02,8440
2498,宏達電,6455,2180,4275,摩根大通,2023-02-03,8440
2330,台積電,4497,648,3849,摩根大通,2023-02-03,8440
2303,聯電,3651,596,3055,摩根大通,2023-02-03,8440
3481,群創,3318,441,2877,摩根大通,2023-02-03,8440
2603,長榮,1705,282,1423,摩根大通,2023-02-03,8440
2890,永豐金,1479,179,1300,摩根大通,2023-02-03,8440
3711,日月光投控,1568,384,1184,摩根大通,2023-02-03,8440
2884,玉山金,1309,196,1113,摩根大通,2023-02-03,8440
5258,虹堡,1943,871,1072,摩根大通,2023-02-03,8440
3035,智原,1565,497,1068,摩根大通,2023-02-03,8440
2208,台船,1129,68,1061,摩根大通,2023-02-03,8440
2882,國泰金,1630,668,962,摩根大通,2023-02-03,8440
3034,聯詠,1221,347,874,摩根大通,2023-02-03,8440
3013,晟銘電,1179,356,823,摩根大通,2023-02-03,8440
2317,鴻海,1601,832,769,摩根大通,2023-02-03,8440
6244,茂迪,786,59,727,摩根大通,2023-02-03,8440
2482,連宇,1563,837,726,摩根大通,2023-02-03,8440
4919,新唐,1196,481,715,摩根大通,2023-02-03,8440
6443,元晶,887,228,659,摩根大通,2023-02-03,8440
3702,大聯大,702,68,634,摩根大通,2023-02-03,8440
3293,鈊象,682,52,630,摩根大通,2023-02-03,8440
2337,旺宏,1146,524,622,摩根大通,2023-02-03,8440
3706,神達,572,1,571,摩根大通,2023-02-03,8440
2542,興富發,586,72,514,摩根大通,2023-02-03,8440
2634,漢翔,515,2,513,摩根大通,2023-02-03,8440
2449,京元電子,562,117,445,摩根大通,2023-02-03,8440
1467,南緯,476,34,442,摩根大通,2023-02-03,8440
2897,王道銀行,611,181,430,摩根大通,2023-02-03,8440
2633,台灣高鐵,701,275,426,摩根大通,2023-02-03,8440
2344,華邦電,1207,784,423,摩根大通,2023-02-03,8440
3023,信邦,483,78,405,摩根大通,2023-02-03,8440
2413,環科,549,162,387,摩根大通,2023-02-03,8440
1802,台玻,456,69,387,摩根大通,2023-02-03,8440
1313,聯成,379,2,377,摩根大通,2023-02-03,8440
6005,群益證,394,18,376,摩根大通,2023-02-03,8440
2385,群光,467,94,373,摩根大通,2023-02-03,8440
2903,遠百,371,11,360,摩根大通,2023-02-03,8440
1102,亞泥,524,195,329,摩根大通,2023-02-03,8440
2401,凌陽,388,105,283,摩根大通,2023-02-03,8440
1305,華夏,420,150,270,摩根大通,2023-02-03,8440
2887,台新金,543,275,268,摩根大通,2023-02-03,8440
2915,潤泰全,294,28,266,摩根大通,2023-02-03,8440
6138,茂達,485,225,260,摩根大通,2023-02-03,8440
2308,台達電,512,257,255,摩根大通,2023-02-03,8440
8150,南茂,280,32,248,摩根大通,2023-02-03,8440
2834,臺企銀,485,239,246,摩根大通,2023-02-03,8440
2352,佳世達,281,40,241,摩根大通,2023-02-03,8440
2809,京城銀,261,23,238,摩根大通,2023-02-03,8440
4960,誠美材,234,9,225,摩根大通,2023-02-03,8440
2883,凱基金,228,4,224,摩根大通,2023-02-03,8440
2303,聯電,11968,3934,8034,摩根大通,2023-02-06,8440
2313,華通,2497,13,2484,摩根大通,2023-02-06,8440
2498,宏達電,2690,1522,1168,摩根大通,2023-02-06,8440
2542,興富發,1316,213,1103,摩根大通,2023-02-06,8440
2634,漢翔,1170,81,1089,摩根大通,2023-02-06,8440
6282,康舒,1187,287,900,摩根大通,2023-02-06,8440
2324,仁寶,2107,1285,822,摩根大通,2023-02-06,8440
2867,三商壽,1173,439,734,摩根大通,2023-02-06,8440
3454,晶睿,750,67,683,摩根大通,2023-02-06,8440
2317,鴻海,2970,2348,622,摩根大通,2023-02-06,8440
2618,長榮航,1077,523,554,摩根大通,2023-02-06,8440
4938,和碩,886,345,541,摩根大通,2023-02-06,8440
2731,雄獅,607,129,478,摩根大通,2023-02-06,8440
1305,華夏,625,151,474,摩根大通,2023-02-06,8440
2328,廣宇,662,207,455,摩根大通,2023-02-06,8440
1802,台玻,722,302,420,摩根大通,2023-02-06,8440
3702,大聯大,918,505,413,摩根大通,2023-02-06,8440
2454,聯發科,931,521,410,摩根大通,2023-02-06,8440
3231,緯創,1011,617,394,摩根大通,2023-02-06,8440
2359,所羅門,411,25,386,摩根大通,2023-02-06,8440
2382,廣達,820,443,377,摩根大通,2023-02-06,8440
1789,神隆,374,15,359,摩根大通,2023-02-06,8440
1477,聚陽,375,32,343,摩根大通,2023-02-06,8440
6120,達運,427,88,339,摩根大通,2023-02-06,8440
1304,台聚,400,81,319,摩根大通,2023-02-06,8440
1524,耿鼎,626,332,294,摩根大通,2023-02-06,8440
3023,信邦,499,214,285,摩根大通,2023-02-06,8440
1783,和康生,1192,915,277,摩根大通,2023-02-06,8440
4114,健喬,305,37,268,摩根大通,2023-02-06,8440
2376,技嘉,354,102,252,摩根大通,2023-02-06,8440
2736,富野,259,14,245,摩根大通,2023-02-06,8440
2402,毅嘉,275,36,239,摩根大通,2023-02-06,8440
2392,正崴,241,4,237,摩根大通,2023-02-06,8440
1714,和桐,241,9,232,摩根大通,2023-02-06,8440
1560,中砂,246,17,229,摩根大通,2023-02-06,8440
8996,高力,449,220,229,摩根大通,2023-02-06,8440
2354,鴻準,467,244,223,摩根大通,2023-02-06,8440
1701,中化,648,426,222,摩根大通,2023-02-06,8440
3128,昇銳,231,10,221,摩根大通,2023-02-06,8440
6712,長聖,305,96,209,摩根大通,2023-02-06,8440
1503,士電,208,0,208,摩根大通,2023-02-06,8440
6603,富強鑫,225,23,202,摩根大通,2023-02-06,8440
6669,緯穎,232,32,200,摩根大通,2023-02-06,8440
2915,潤泰全,234,42,192,摩根大通,2023-02-06,8440
2633,台灣高鐵,650,460,190,摩根大通,2023-02-06,8440
1312,國喬,192,8,184,摩根大通,2023-02-06,8440
1519,華城,230,49,181,摩根大通,2023-02-06,8440
6472,保瑞,253,78,175,摩根大通,2023-02-06,8440
8049,晶采,180,9,171,摩根大通,2023-02-06,8440
6109,亞元,174,6,168,摩根大通,2023-02-06,8440
3481,群創,11627,4775,6852,摩根大通,2023-02-07,8440
2888,新光金,2456,1035,1421,摩根大通,2023-02-07,8440
2882,國泰金,1738,455,1283,摩根大通,2023-02-07,8440
5880,合庫金,1513,392,1121,摩根大通,2023-02-07,8440
2308,台達電,1240,152,1088,摩根大通,2023-02-07,8440
2409,友達,5622,4552,1070,摩根大通,2023-02-07,8440
2313,華通,1084,16,1068,摩根大通,2023-02-07,8440
6282,康舒,3706,2687,1019,摩根大通,2023-02-07,8440
2880,華南金,1173,392,781,摩根大通,2023-02-07,8440
2353,宏��,877,116,761,摩根大通,2023-02-07,8440
2402,毅嘉,843,91,752,摩根大通,2023-02-07,8440
3545,敦泰,655,50,605,摩根大通,2023-02-07,8440
2883,凱基金,896,316,580,摩根大通,2023-02-07,8440
1584,精剛,681,121,560,摩根大通,2023-02-07,8440
2376,技嘉,886,329,557,摩根大通,2023-02-07,8440
2884,玉山金,967,460,507,摩根大通,2023-02-07,8440
6116,彩晶,586,92,494,摩根大通,2023-02-07,8440
2481,強茂,509,19,490,摩根大通,2023-02-07,8440
4114,健喬,731,284,447,摩根大通,2023-02-07,8440
6182,合晶,478,82,396,摩根大通,2023-02-07,8440
6472,保瑞,644,291,353,摩根大通,2023-02-07,8440
3264,欣銓,391,41,350,摩根大通,2023-02-07,8440
4128,中天,478,132,346,摩根大通,2023-02-07,8440
2903,遠百,357,12,345,摩根大通,2023-02-07,8440
2014,中鴻,429,86,343,摩根大通,2023-02-07,8440
2454,聯發科,445,123,322,摩根大通,2023-02-07,8440
5876,上海商銀,473,152,321,摩根大通,2023-02-07,8440
3706,神達,358,39,319,摩根大通,2023-02-07,8440
2413,環科,403,91,312,摩根大通,2023-02-07,8440
6235,華孚,968,666,302,摩根大通,2023-02-07,8440
6509,聚和,308,21,287,摩根大通,2023-02-07,8440
3558,神準,319,40,279,摩根大通,2023-02-07,8440
2345,智邦,627,351,276,摩根大通,2023-02-07,8440
2504,國產,275,0,275,摩根大通,2023-02-07,8440
2609,陽明,291,18,273,摩根大通,2023-02-07,8440
8069,元太,402,140,262,摩根大通,2023-02-07,8440
6669,緯穎,329,67,262,摩根大通,2023-02-07,8440
2344,華邦電,338,76,262,摩根大通,2023-02-07,8440
6217,中探針,319,59,260,摩根大通,2023-02-07,8440
3479,安勤,267,11,256,摩根大通,2023-02-07,8440
4961,天鈺,256,23,233,摩根大通,2023-02-07,8440
2023,燁輝,247,14,233,摩根大通,2023-02-07,8440
6223,旺矽,370,145,225,摩根大通,2023-02-07,8440
2486,一詮,224,0,224,摩根大通,2023-02-07,8440
2385,群光,325,102,223,摩根大通,2023-02-07,8440
3011,今皓,227,5,222,摩根大通,2023-02-07,8440
2356,英業達,921,708,213,摩根大通,2023-02-07,8440
9938,百和,245,38,207,摩根大通,2023-02-07,8440
3045,台灣大,329,125,204,摩根大通,2023-02-07,8440
5425,台半,298,100,198,摩根大通,2023-02-07,8440
2888,新光金,4523,312,4211,摩根大通,2023-02-08,8440
3481,群創,8285,4124,4161,摩根大通,2023-02-08,8440
2330,台積電,4898,770,4128,摩根大通,2023-02-08,8440
2409,友達,4369,1191,3178,摩根大通,2023-02-08,8440
6235,華孚,3230,998,2232,摩根大通,2023-02-08,8440
1101,台泥,2089,76,2013,摩根大通,2023-02-08,8440
1409,新纖,1844,10,1834,摩根大通,2023-02-08,8440
2882,國泰金,1563,162,1401,摩根大通,2023-02-08,8440
6138,茂達,1248,187,1061,摩根大通,2023-02-08,8440
2615,萬海,1141,211,930,摩根大通,2023-02-08,8440
4960,誠美材,1040,118,922,摩根大通,2023-02-08,8440
1795,美時,1070,194,876,摩根大通,2023-02-08,8440
6770,力積電,1107,374,733,摩根大通,2023-02-08,8440
2634,漢翔,728,0,728,摩根大通,2023-02-08,8440
3706,神達,864,162,702,摩根大通,2023-02-08,8440
2454,聯發科,791,99,692,摩根大通,2023-02-08,8440
6147,頎邦,790,144,646,摩根大通,2023-02-08,8440
3704,合勤控,706,93,613,摩根大通,2023-02-08,8440
3037,欣興,929,321,608,摩根大通,2023-02-08,8440
5309,系統電,651,49,602,摩根大通,2023-02-08,8440
2337,旺宏,650,136,514,摩根大通,2023-02-08,8440
2108,南帝,554,49,505,摩根大通,2023-02-08,8440
3231,緯創,861,405,456,摩根大通,2023-02-08,8440
1303,南亞,490,55,435,摩根大通,2023-02-08,8440
2912,統一超,455,45,410,摩根大通,2023-02-08,8440
3661,世芯-KY,573,167,406,摩根大通,2023-02-08,8440
5483,中美晶,448,47,401,摩根大通,2023-02-08,8440
2851,中再保,402,21,381,摩根大通,2023-02-08,8440
6533,晶心科,559,184,375,摩根大通,2023-02-08,8440
3228,金麗科,375,55,320,摩根大通,2023-02-08,8440
6116,彩晶,302,7,295,摩根大通,2023-02-08,8440
4961,天鈺,435,153,282,摩根大通,2023-02-08,8440
2345,智邦,414,133,281,摩根大通,2023-02-08,8440
6202,盛群,386,109,277,摩根大通,2023-02-08,8440
2352,佳世達,324,52,272,摩根大通,2023-02-08,8440
2353,宏��,487,215,272,摩根大通,2023-02-08,8440
4743,合一,404,142,262,摩根大通,2023-02-08,8440
2891,中信金,473,218,255,摩根大通,2023-02-08,8440
1720,生達,253,3,250,摩根大通,2023-02-08,8440
2103,台橡,411,165,246,摩根大通,2023-02-08,8440
2609,陽明,329,85,244,摩根大通,2023-02-08,8440
2412,中華電,585,345,240,摩根大通,2023-02-08,8440
4726,永昕,261,29,232,摩根大通,2023-02-08,8440
2393,億光,234,7,227,摩根大通,2023-02-08,8440
1907,永豐餘,279,54,225,摩根大通,2023-02-08,8440
1701,中化,361,138,223,摩根大通,2023-02-08,8440
2236,百達-KY,236,15,221,摩根大通,2023-02-08,8440
2007,燁興,218,0,218,摩根大通,2023-02-08,8440
3592,瑞鼎,240,23,217,摩根大通,2023-02-08,8440
8150,南茂,212,3,209,摩根大通,2023-02-08,8440
2409,友達,7661,1199,6462,摩根大通,2023-02-09,8440
1101,台泥,1550,61,1489,摩根大通,2023-02-09,8440
1584,精剛,1419,77,1342,摩根大通,2023-02-09,8440
2330,台積電,2552,1351,1201,摩根大通,2023-02-09,8440
1513,中興電,1683,688,995,摩根大通,2023-02-09,8440
6235,華孚,3628,2664,964,摩根大通,2023-02-09,8440
3231,緯創,1611,837,774,摩根大通,2023-02-09,8440
2883,凱基金,750,82,668,摩根大通,2023-02-09,8440
2338,光罩,689,60,629,摩根大通,2023-02-09,8440
4904,遠傳,651,25,626,摩根大通,2023-02-09,8440
5425,台半,899,280,619,摩根大通,2023-02-09,8440
3479,安勤,827,215,612,摩根大通,2023-02-09,8440
5871,中租-KY,590,28,562,摩根大通,2023-02-09,8440
6472,保瑞,729,214,515,摩根大通,2023-02-09,8440
6245,立端,972,462,510,摩根大通,2023-02-09,8440
2412,中華電,692,245,447,摩根大通,2023-02-09,8440
9904,寶成,1177,756,421,摩根大通,2023-02-09,8440
2324,仁寶,534,115,419,摩根大通,2023-02-09,8440
3013,晟銘電,557,140,417,摩根大通,2023-02-09,8440
2727,王品,563,149,414,摩根大通,2023-02-09,8440
8150,南茂,423,32,391,摩根大通,2023-02-09,8440
8358,金居,393,27,366,摩根大通,2023-02-09,8440
5880,合庫金,363,0,363,摩根大通,2023-02-09,8440
6182,合晶,456,103,353,摩根大通,2023-02-09,8440
3128,昇銳,429,77,352,摩根大通,2023-02-09,8440
3594,磐儀,363,24,339,摩根大通,2023-02-09,8440
2634,漢翔,524,188,336,摩根大通,2023-02-09,8440
1519,華城,379,76,303,摩根大通,2023-02-09,8440
2337,旺宏,350,57,293,摩根大通,2023-02-09,8440
1342,八貫,450,179,271,摩根大通,2023-02-09,8440
3704,合勤控,370,110,260,摩根大通,2023-02-09,8440
3680,家登,428,172,256,摩根大通,2023-02-09,8440
2892,第一金,1095,841,254,摩根大通,2023-02-09,8440
1760,寶齡富錦,550,300,250,摩根大通,2023-02-09,8440
2317,鴻海,860,612,248,摩根大通,2023-02-09,8440
3290,東浦,254,18,236,摩根大通,2023-02-09,8440
8289,泰藝,255,28,227,摩根大通,2023-02-09,8440
1319,東陽,282,59,223,摩根大通,2023-02-09,8440
2027,大成鋼,273,51,222,摩根大通,2023-02-09,8440
6282,康舒,1569,1348,221,摩根大通,2023-02-09,8440
4931,新盛力,502,284,218,摩根大通,2023-02-09,8440
2457,飛宏,298,82,216,摩根大通,2023-02-09,8440
6741,91APP*-KY,224,11,213,摩根大通,2023-02-09,8440
2208,台船,336,123,213,摩根大通,2023-02-09,8440
3088,艾訊,212,4,208,摩根大通,2023-02-09,8440
2402,毅嘉,214,9,205,摩根大通,2023-02-09,8440
2885,元大金,209,20,189,摩根大通,2023-02-09,8440
6188,廣明,282,95,187,摩根大通,2023-02-09,8440
2408,南亞科,345,158,187,摩根大通,2023-02-09,8440
2891,中信金,346,160,186,摩根大通,2023-02-09,8440
2330,台積電,5854,538,5316,摩根大通,2023-02-10,8440
2409,友達,6251,3115,3136,摩根大通,2023-02-10,8440
5347,世界,2608,127,2481,摩根大通,2023-02-10,8440
2303,聯電,4963,2634,2329,摩根大通,2023-02-10,8440
6235,華孚,2268,1065,1203,摩根大通,2023-02-10,8440
3481,群創,1294,347,947,摩根大通,2023-02-10,8440
4743,合一,868,83,785,摩根大通,2023-02-10,8440
1504,東元,790,13,777,摩根大通,2023-02-10,8440
8358,金居,761,78,683,摩根大通,2023-02-10,8440
2892,第一金,694,94,600,摩根大通,2023-02-10,8440
3035,智原,821,222,599,摩根大通,2023-02-10,8440
2317,鴻海,1839,1249,590,摩根大通,2023-02-10,8440
1810,和成,1079,531,548,摩根大通,2023-02-10,8440
4960,誠美材,703,156,547,摩根大通,2023-02-10,8440
2886,兆豐金,613,69,544,摩根大通,2023-02-10,8440
4919,新唐,640,105,535,摩根大通,2023-02-10,8440
1304,台聚,618,105,513,摩根大通,2023-02-10,8440
2884,玉山金,703,204,499,摩根大通,2023-02-10,8440
2606,裕民,563,65,498,摩根大通,2023-02-10,8440
2891,中信金,978,490,488,摩根大通,2023-02-10,8440
1402,遠東新,519,43,476,摩根大通,2023-02-10,8440
2344,華邦電,1455,979,476,摩根大通,2023-02-10,8440
3105,穩懋,594,150,444,摩根大通,2023-02-10,8440
2883,凱基金,634,207,427,摩根大通,2023-02-10,8440
2880,華南金,494,68,426,摩根大通,2023-02-10,8440
1101,台泥,414,12,402,摩根大通,2023-02-10,8440
2881,富邦金,458,61,397,摩根大通,2023-02-10,8440
3706,神達,473,97,376,摩根大通,2023-02-10,8440
2882,國泰金,520,171,349,摩根大通,2023-02-10,8440
2609,陽明,862,530,332,摩根大通,2023-02-10,8440
6472,保瑞,603,277,326,摩根大通,2023-02-10,8440
6266,泰詠,812,500,312,摩根大通,2023-02-10,8440
3037,欣興,688,384,304,摩根大通,2023-02-10,8440
2474,可成,323,23,300,摩根大通,2023-02-10,8440
2897,王道銀行,305,7,298,摩根大通,2023-02-10,8440
2845,遠東銀,280,0,280,摩根大通,2023-02-10,8440
1305,華夏,414,136,278,摩根大通,2023-02-10,8440
2312,金寶,293,18,275,摩根大通,2023-02-10,8440
1720,生達,273,3,270,摩根大通,2023-02-10,8440
2834,臺企銀,458,194,264,摩根大通,2023-02-10,8440
2204,中華,279,17,262,摩根大通,2023-02-10,8440
3264,欣銓,269,10,259,摩根大通,2023-02-10,8440
2615,萬海,468,210,258,摩根大通,2023-02-10,8440
3712,永崴投控,348,97,251,摩根大通,2023-02-10,8440
3704,合勤控,407,175,232,摩根大通,2023-02-10,8440
6116,彩晶,672,442,230,摩根大通,2023-02-10,8440
6741,91APP*-KY,303,76,227,摩根大通,2023-02-10,8440
2354,鴻準,538,328,210,摩根大通,2023-02-10,8440
8227,巨有科技,275,71,204,摩根大通,2023-02-10,8440
1701,中化,539,342,197,摩根大通,2023-02-10,8440
2834,臺企銀,2790,54,2736,摩根大通,2023-02-13,8440
2884,玉山金,1833,167,1666,摩根大通,2023-02-13,8440
3231,緯創,2241,602,1639,摩根大通,2023-02-13,8440
2881,富邦金,1851,264,1587,摩根大通,2023-02-13,8440
2882,國泰金,2174,588,1586,摩根大通,2023-02-13,8440
2887,台新金,2240,667,1573,摩根大通,2023-02-13,8440
2890,永豐金,1972,681,1291,摩根大通,2023-02-13,8440
2886,兆豐金,1408,515,893,摩根大通,2023-02-13,8440
2880,華南金,957,85,872,摩根大通,2023-02-13,8440
8050,廣積,761,13,748,摩根大通,2023-02-13,8440
1605,華新,1246,498,748,摩根大通,2023-02-13,8440
2883,凱基金,865,182,683,摩根大通,2023-02-13,8440
2409,友達,3748,3073,675,摩根大通,2023-02-13,8440
2330,台積電,3114,2580,534,摩根大通,2023-02-13,8440
3207,耀勝,560,57,503,摩根大通,2023-02-13,8440
8222,寶一,2002,1512,490,摩根大通,2023-02-13,8440
5880,合庫金,547,62,485,摩根大通,2023-02-13,8440
2891,中信金,1157,683,474,摩根大通,2023-02-13,8440
6188,廣明,479,17,462,摩根大通,2023-02-13,8440
2208,台船,525,70,455,摩根大通,2023-02-13,8440
2332,友訊,764,337,427,摩根大通,2023-02-13,8440
2889,國票金,423,0,423,摩根大通,2023-02-13,8440
4904,遠傳,503,85,418,摩根大通,2023-02-13,8440
2867,三商壽,570,164,406,摩根大通,2023-02-13,8440
8996,高力,803,417,386,摩根大通,2023-02-13,8440
3045,台灣大,467,96,371,摩根大通,2023-02-13,8440
5425,台半,408,44,364,摩根大通,2023-02-13,8440
4977,眾達-KY,382,23,359,摩根大通,2023-02-13,8440
2888,新光金,448,103,345,摩根大通,2023-02-13,8440
1802,台玻,373,38,335,摩根大通,2023-02-13,8440
4114,健喬,459,139,320,摩根大通,2023-02-13,8440
1519,華城,426,110,316,摩根大通,2023-02-13,8440
3704,合勤控,735,420,315,摩根大通,2023-02-13,8440
2801,彰銀,310,24,286,摩根大通,2023-02-13,8440
3491,昇達科,326,42,284,摩根大通,2023-02-13,8440
4919,新唐,770,506,264,摩根大通,2023-02-13,8440
5388,中磊,264,2,262,摩根大通,2023-02-13,8440
6488,環球晶,271,12,259,摩根大通,2023-02-13,8440
2515,中工,333,76,257,摩根大通,2023-02-13,8440
6290,良維,376,125,251,摩根大通,2023-02-13,8440
6274,台燿,325,93,232,摩根大通,2023-02-13,8440
2388,威盛,272,44,228,摩根大通,2023-02-13,8440
4167,松瑞藥,334,107,227,摩根大通,2023-02-13,8440
2314,台揚,238,21,217,摩根大通,2023-02-13,8440
4938,和碩,1291,1080,211,摩根大通,2023-02-13,8440
9933,中鼎,221,11,210,摩根大通,2023-02-13,8440
3290,東浦,206,6,200,摩根大通,2023-02-13,8440
6472,保瑞,289,91,198,摩根大通,2023-02-13,8440
4157,太景*-KY,205,11,194,摩根大通,2023-02-13,8440
8234,新漢,200,7,193,摩根大通,2023-02-13,8440
2409,友達,5213,178,5035,摩根大通,2023-02-14,8440
3481,群創,1801,142,1659,摩根大通,2023-02-14,8440
2609,陽明,1137,0,1137,摩根大通,2023-02-14,8440
2882,國泰金,1514,467,1047,摩根大通,2023-02-14,8440
2867,三商壽,995,132,863,摩根大通,2023-02-14,8440
2610,華航,819,66,753,摩根大通,2023-02-14,8440
2408,南亞科,821,78,743,摩根大通,2023-02-14,8440
1504,東元,690,9,681,摩根大通,2023-02-14,8440
1718,中纖,646,32,614,摩根大通,2023-02-14,8440
2881,富邦金,834,237,597,摩根大通,2023-02-14,8440
2324,仁寶,620,36,584,摩根大通,2023-02-14,8440
9904,寶成,592,33,559,摩根大通,2023-02-14,8440
4763,材料-KY,604,99,505,摩根大通,2023-02-14,8440
2303,聯電,601,114,487,摩根大通,2023-02-14,8440
1326,台化,521,41,480,摩根大通,2023-02-14,8440
3711,日月光投控,850,378,472,摩根大通,2023-02-14,8440
5009,榮剛,469,2,467,摩根大通,2023-02-14,8440
2618,長榮航,483,37,446,摩根大通,2023-02-14,8440
2353,宏��,567,138,429,摩根大通,2023-02-14,8440
6180,橘子,610,205,405,摩根大通,2023-02-14,8440
6120,達運,406,9,397,摩根大通,2023-02-14,8440
2890,永豐金,410,30,380,摩根大通,2023-02-14,8440
6770,力積電,406,27,379,摩根大通,2023-02-14,8440
6142,友勁,576,223,353,摩根大通,2023-02-14,8440
6605,帝寶,431,82,349,摩根大通,2023-02-14,8440
2889,國票金,407,60,347,摩根大通,2023-02-14,8440
2412,中華電,413,67,346,摩根大通,2023-02-14,8440
1402,遠東新,435,98,337,摩根大通,2023-02-14,8440
2886,兆豐金,671,345,326,摩根大通,2023-02-14,8440
2379,瑞昱,431,109,322,摩根大通,2023-02-14,8440
5483,中美晶,320,5,315,摩根大通,2023-02-14,8440
3260,威剛,322,14,308,摩根大通,2023-02-14,8440
6235,華孚,706,429,277,摩根大通,2023-02-14,8440
1802,台玻,282,7,275,摩根大通,2023-02-14,8440
9962,有益,297,22,275,摩根大通,2023-02-14,8440
2605,新興,278,12,266,摩根大通,2023-02-14,8440
2732,六角,416,156,260,摩根大通,2023-02-14,8440
8150,南茂,311,66,245,摩根大通,2023-02-14,8440
5880,合庫金,370,128,242,摩根大通,2023-02-14,8440
2337,旺宏,341,113,228,摩根大通,2023-02-14,8440
3324,雙鴻,317,90,227,摩根大通,2023-02-14,8440
2603,長榮,420,195,225,摩根大通,2023-02-14,8440
2743,山富,243,31,212,摩根大通,2023-02-14,8440
2338,光罩,272,65,207,摩根大通,2023-02-14,8440
2736,富野,205,0,205,摩根大通,2023-02-14,8440
1308,亞聚,219,14,205,摩根大通,2023-02-14,8440
2883,凱基金,329,128,201,摩根大通,2023-02-14,8440
3034,聯詠,313,114,199,摩根大通,2023-02-14,8440
3024,憶聲,202,4,198,摩根大通,2023-02-14,8440
2454,聯發科,232,35,197,摩根大通,2023-02-14,8440
3481,群創,7520,1550,5970,摩根大通,2023-02-15,8440
2409,友達,5257,1672,3585,摩根大通,2023-02-15,8440
1605,華新,2833,272,2561,摩根大通,2023-02-15,8440
3037,欣興,3200,665,2535,摩根大通,2023-02-15,8440
3711,日月光投控,2602,452,2150,摩根大通,2023-02-15,8440
2449,京元電子,2000,170,1830,摩根大通,2023-02-15,8440
2890,永豐金,2335,781,1554,摩根大通,2023-02-15,8440
2498,宏達電,1440,230,1210,摩根大通,2023-02-15,8440
2303,聯電,2174,1004,1170,摩根大通,2023-02-15,8440
2884,玉山金,1743,657,1086,摩根大通,2023-02-15,8440
1513,中興電,1879,905,974,摩根大通,2023-02-15,8440
3231,緯創,1433,524,909,摩根大通,2023-02-15,8440
5905,南仁湖,994,92,902,摩根大通,2023-02-15,8440
2201,裕隆,925,109,816,摩根大通,2023-02-15,8440
1718,中纖,1002,229,773,摩根大通,2023-02-15,8440
2886,兆豐金,1495,764,731,摩根大通,2023-02-15,8440
2379,瑞昱,828,102,726,摩根大通,2023-02-15,8440
1609,大亞,1028,316,712,摩根大通,2023-02-15,8440
1504,東元,925,259,666,摩根大通,2023-02-15,8440
2332,友訊,597,97,500,摩根大通,2023-02-15,8440
2353,宏��,983,488,495,摩根大通,2023-02-15,8440
2731,雄獅,915,442,473,摩根大通,2023-02-15,8440
2885,元大金,1009,540,469,摩根大通,2023-02-15,8440
3027,盛達,912,446,466,摩根大通,2023-02-15,8440
8215,明基材,463,2,461,摩根大通,2023-02-15,8440
3013,晟銘電,628,194,434,摩根大通,2023-02-15,8440
1514,亞力,814,389,425,摩根大通,2023-02-15,8440
3710,連展投控,560,161,399,摩根大通,2023-02-15,8440
2887,台新金,812,422,390,摩根大通,2023-02-15,8440
2371,大同,736,367,369,摩根大通,2023-02-15,8440
2002,中鋼,1082,730,352,摩根大通,2023-02-15,8440
2317,鴻海,1072,723,349,摩根大通,2023-02-15,8440
8171,天宇,440,111,329,摩根大通,2023-02-15,8440
4960,誠美材,490,163,327,摩根大通,2023-02-15,8440
6531,愛普*,360,37,323,摩根大通,2023-02-15,8440
1312,國喬,425,105,320,摩根大通,2023-02-15,8440
3029,零壹,314,4,310,摩根大通,2023-02-15,8440
8081,致新,344,36,308,摩根大通,2023-02-15,8440
2324,仁寶,960,667,293,摩根大通,2023-02-15,8440
1417,嘉裕,314,32,282,摩根大通,2023-02-15,8440
6285,啟��,435,163,272,摩根大通,2023-02-15,8440
4915,致伸,385,114,271,摩根大通,2023-02-15,8440
6605,帝寶,385,141,244,摩根大通,2023-02-15,8440
6142,友勁,392,151,241,摩根大通,2023-02-15,8440
6603,富強鑫,247,10,237,摩根大通,2023-02-15,8440
3624,光頡,317,96,221,摩根大通,2023-02-15,8440
2891,中信金,1807,1588,219,摩根大通,2023-02-15,8440
1584,精剛,311,102,209,摩根大通,2023-02-15,8440
8076,伍豐,211,4,207,摩根大通,2023-02-15,8440
2609,陽明,436,229,207,摩根大通,2023-02-15,8440
2610,華航,27697,1370,26327,摩根大通,2023-02-16,8440
2618,長榮航,20568,117,20451,摩根大通,2023-02-16,8440
2330,台積電,6817,865,5952,摩根大通,2023-02-16,8440
3481,群創,8129,3013,5116,摩根大通,2023-02-16,8440
2409,友達,5093,1918,3175,摩根大通,2023-02-16,8440
2303,聯電,4386,1973,2413,摩根大通,2023-02-16,8440
1605,華新,3220,1551,1669,摩根大通,2023-02-16,8440
2324,仁寶,1964,300,1664,摩根大通,2023-02-16,8440
1101,台泥,1643,81,1562,摩根大通,2023-02-16,8440
6116,彩晶,1420,84,1336,摩根大通,2023-02-16,8440
8069,元太,1658,358,1300,摩根大通,2023-02-16,8440
2890,永豐金,1251,3,1248,摩根大通,2023-02-16,8440
5425,台半,1676,515,1161,摩根大通,2023-02-16,8440
2344,華邦電,1164,18,1146,摩根大通,2023-02-16,8440
2867,三商壽,1011,25,986,摩根大通,2023-02-16,8440
5371,中光電,973,12,961,摩根大通,2023-02-16,8440
2884,玉山金,1204,288,916,摩根大通,2023-02-16,8440
2891,中信金,1645,738,907,摩根大通,2023-02-16,8440
2014,中鴻,966,137,829,摩根大通,2023-02-16,8440
5880,合庫金,1113,330,783,摩根大通,2023-02-16,8440
2887,台新金,790,120,670,摩根大通,2023-02-16,8440
2457,飛宏,819,166,653,摩根大通,2023-02-16,8440
1504,東元,691,97,594,摩根大通,2023-02-16,8440
1216,統一,591,14,577,摩根大通,2023-02-16,8440
2317,鴻海,848,283,565,摩根大通,2023-02-16,8440
2885,元大金,604,62,542,摩根大通,2023-02-16,8440
2882,國泰金,624,91,533,摩根大通,2023-02-16,8440
2888,新光金,636,112,524,摩根大通,2023-02-16,8440
2886,兆豐金,616,104,512,摩根大通,2023-02-16,8440
1795,美時,585,95,490,摩根大通,2023-02-16,8440
3013,晟銘電,490,11,479,摩根大通,2023-02-16,8440
9904,寶成,518,72,446,摩根大通,2023-02-16,8440
2449,京元電子,1219,783,436,摩根大通,2023-02-16,8440
3006,晶豪科,479,51,428,摩根大通,2023-02-16,8440
1402,遠東新,536,123,413,摩根大通,2023-02-16,8440
3661,世芯-KY,467,55,412,摩根大通,2023-02-16,8440
3062,建漢,405,9,396,摩根大通,2023-02-16,8440
2880,華南金,588,196,392,摩根大通,2023-02-16,8440
4979,華星光,725,340,385,摩根大通,2023-02-16,8440
2634,漢翔,510,130,380,摩根大通,2023-02-16,8440
6285,啟��,426,48,378,摩根大通,2023-02-16,8440
2834,臺企銀,423,45,378,摩根大通,2023-02-16,8440
5388,中磊,412,49,363,摩根大通,2023-02-16,8440
6143,振曜,811,448,363,摩根大通,2023-02-16,8440
2492,華新科,439,79,360,摩根大通,2023-02-16,8440
3704,合勤控,519,159,360,摩根大通,2023-02-16,8440
4938,和碩,359,19,340,摩根大通,2023-02-16,8440
2327,國巨,491,157,334,摩根大通,2023-02-16,8440
2889,國票金,329,0,329,摩根大通,2023-02-16,8440
2605,新興,347,38,309,摩根大通,2023-02-16,8440
3481,群創,29010,1759,27251,摩根大通,2023-02-17,8440
2409,友達,15251,1450,13801,摩根大通,2023-02-17,8440
2883,凱基金,2397,29,2368,摩根大通,2023-02-17,8440
2881,富邦金,2098,193,1905,摩根大通,2023-02-17,8440
2412,中華電,1437,98,1339,摩根大通,2023-02-17,8440
2208,台船,1383,78,1305,摩根大通,2023-02-17,8440
2014,中鴻,1295,59,1236,摩根大通,2023-02-17,8440
2801,彰銀,1874,714,1160,摩根大通,2023-02-17,8440
6116,彩晶,1826,730,1096,摩根大通,2023-02-17,8440
2002,中鋼,1315,251,1064,摩根大通,2023-02-17,8440
2891,中信金,1092,153,939,摩根大通,2023-02-17,8440
6245,立端,1058,130,928,摩根大通,2023-02-17,8440
1314,中石化,879,4,875,摩根大通,2023-02-17,8440
2887,台新金,877,5,872,摩根大通,2023-02-17,8440
5371,中光電,953,143,810,摩根大通,2023-02-17,8440
1795,美時,1200,394,806,摩根大通,2023-02-17,8440
3022,威強電,845,63,782,摩根大通,2023-02-17,8440
2892,第一金,1317,573,744,摩根大通,2023-02-17,8440
1519,華城,1317,672,645,摩根大通,2023-02-17,8440
2884,玉山金,1722,1118,604,摩根大通,2023-02-17,8440
1513,中興電,954,400,554,摩根大通,2023-02-17,8440
2399,映泰,523,0,523,摩根大通,2023-02-17,8440
8215,明基材,519,4,515,摩根大通,2023-02-17,8440
6120,達運,520,26,494,摩根大通,2023-02-17,8440
6143,振曜,598,108,490,摩根大通,2023-02-17,8440
6142,友勁,522,36,486,摩根大通,2023-02-17,8440
8936,國統,484,9,475,摩根大通,2023-02-17,8440
1303,南亞,563,95,468,摩根大通,2023-02-17,8440
2034,允強,466,6,460,摩根大通,2023-02-17,8440
5905,南仁湖,437,7,430,摩根大通,2023-02-17,8440
2834,臺企銀,419,0,419,摩根大通,2023-02-17,8440
1529,樂事綠能,519,104,415,摩根大通,2023-02-17,8440
1514,亞力,752,349,403,摩根大通,2023-02-17,8440
1218,泰山,471,74,397,摩根大通,2023-02-17,8440
2890,永豐金,1291,902,389,摩根大通,2023-02-17,8440
2007,燁興,382,1,381,摩根大通,2023-02-17,8440
2102,泰豐,407,39,368,摩根大通,2023-02-17,8440
1447,力鵬,374,7,367,摩根大通,2023-02-17,8440
4904,遠傳,459,102,357,摩根大通,2023-02-17,8440
2867,三商壽,820,464,356,摩根大通,2023-02-17,8440
3045,台灣大,523,171,352,摩根大通,2023-02-17,8440
9933,中鼎,414,66,348,摩根大通,2023-02-17,8440
4541,晟田,363,20,343,摩根大通,2023-02-17,8440
2017,官田鋼,366,28,338,摩根大通,2023-02-17,8440
1467,南緯,347,16,331,摩根大通,2023-02-17,8440
6284,佳邦,349,19,330,摩根大通,2023-02-17,8440
2727,王品,586,261,325,摩根大通,2023-02-17,8440
3049,精金,313,3,310,摩根大通,2023-02-17,8440
1503,士電,447,142,305,摩根大通,2023-02-17,8440
3141,晶宏,357,63,294,摩根大通,2023-02-17,8440
2618,長榮航,4694,116,4578,摩根大通,2023-02-20,8440
2883,凱基金,3672,415,3257,摩根大通,2023-02-20,8440
2330,台積電,3346,710,2636,摩根大通,2023-02-20,8440
2002,中鋼,2347,364,1983,摩根大通,2023-02-20,8440
2891,中信金,2256,392,1864,摩根大通,2023-02-20,8440
1584,精剛,1923,78,1845,摩根大通,2023-02-20,8440
1314,中石化,1710,104,1606,摩根大通,2023-02-20,8440
2014,中鴻,1600,80,1520,摩根大通,2023-02-20,8440
2323,中環,1515,40,1475,摩根大通,2023-02-20,8440
2881,富邦金,1512,249,1263,摩根大通,2023-02-20,8440
2888,新光金,1377,232,1145,摩根大通,2023-02-20,8440
6180,橘子,1229,102,1127,摩根大通,2023-02-20,8440
4979,華星光,1750,627,1123,摩根大通,2023-02-20,8440
8033,雷虎,979,10,969,摩根大通,2023-02-20,8440
1504,東元,1516,551,965,摩根大通,2023-02-20,8440
2887,台新金,1177,263,914,摩根大通,2023-02-20,8440
2812,台中銀,992,91,901,摩根大通,2023-02-20,8440
2313,華通,963,72,891,摩根大通,2023-02-20,8440
1605,華新,1808,923,885,摩根大通,2023-02-20,8440
2892,第一金,946,104,842,摩根大通,2023-02-20,8440
4968,立積,787,144,643,摩根大通,2023-02-20,8440
3027,盛達,1148,512,636,摩根大通,2023-02-20,8440
5876,上海商銀,678,81,597,摩根大通,2023-02-20,8440
4960,誠美材,1310,764,546,摩根大通,2023-02-20,8440
2405,輔信,550,10,540,摩根大通,2023-02-20,8440
6142,友勁,512,13,499,摩根大通,2023-02-20,8440
9910,豐泰,532,68,464,摩根大通,2023-02-20,8440
2317,鴻海,713,251,462,摩根大通,2023-02-20,8440
3045,台灣大,571,110,461,摩根大通,2023-02-20,8440
6147,頎邦,465,7,458,摩根大通,2023-02-20,8440
3207,耀勝,507,54,453,摩根大通,2023-02-20,8440
5258,虹堡,931,504,427,摩根大通,2023-02-20,8440
9958,世紀鋼,610,185,425,摩根大通,2023-02-20,8440
1810,和成,482,65,417,摩根大通,2023-02-20,8440
2897,王道銀行,434,27,407,摩根大通,2023-02-20,8440
2504,國產,413,9,404,摩根大通,2023-02-20,8440
2379,瑞昱,542,149,393,摩根大通,2023-02-20,8440
3346,麗清,406,15,391,摩根大通,2023-02-20,8440
4961,天鈺,677,297,380,摩根大通,2023-02-20,8440
2022,聚亨,379,0,379,摩根大通,2023-02-20,8440
2457,飛宏,876,504,372,摩根大通,2023-02-20,8440
2867,三商壽,422,51,371,摩根大通,2023-02-20,8440
2633,台灣高鐵,417,47,370,摩根大通,2023-02-20,8440
1304,台聚,382,20,362,摩根大通,2023-02-20,8440
8016,矽創,360,11,349,摩根大通,2023-02-20,8440
1802,台玻,430,85,345,摩根大通,2023-02-20,8440
1342,八貫,412,77,335,摩根大通,2023-02-20,8440
1217,愛之味,321,0,321,摩根大通,2023-02-20,8440
3011,今皓,401,83,318,摩根大通,2023-02-20,8440
9904,寶成,425,110,315,摩根大通,2023-02-20,8440
3481,群創,17935,596,17339,摩根大通,2023-02-21,8440
2409,友達,5561,910,4651,摩根大通,2023-02-21,8440
1605,華新,4755,1253,3502,摩根大通,2023-02-21,8440
2002,中鋼,2278,327,1951,摩根大通,2023-02-21,8440
1513,中興電,2455,1040,1415,摩根大通,2023-02-21,8440
2834,臺企銀,1925,582,1343,摩根大通,2023-02-21,8440
1519,華城,1515,405,1110,摩根大通,2023-02-21,8440
6290,良維,1165,114,1051,摩根大通,2023-02-21,8440
2330,台積電,2052,1105,947,摩根大通,2023-02-21,8440
1514,亞力,984,118,866,摩根大通,2023-02-21,8440
4919,新唐,698,117,581,摩根大通,2023-02-21,8440
3045,台灣大,734,178,556,摩根大通,2023-02-21,8440
6205,詮欣,764,214,550,摩根大通,2023-02-21,8440
2201,裕隆,777,233,544,摩根大通,2023-02-21,8440
1101,台泥,571,123,448,摩根大通,2023-02-21,8440
1802,台玻,491,65,426,摩根大通,2023-02-21,8440
3624,光頡,462,37,425,摩根大通,2023-02-21,8440
2457,飛宏,1604,1250,354,摩根大通,2023-02-21,8440
6235,華孚,631,288,343,摩根大通,2023-02-21,8440
8050,廣積,1037,699,338,摩根大通,2023-02-21,8440
3290,東浦,339,20,319,摩根大通,2023-02-21,8440
6116,彩晶,796,491,305,摩根大通,2023-02-21,8440
8016,矽創,498,194,304,摩根大通,2023-02-21,8440
1522,堤維西,430,131,299,摩根大通,2023-02-21,8440
2371,大同,581,300,281,摩根大通,2023-02-21,8440
3264,欣銓,302,22,280,摩根大通,2023-02-21,8440
2327,國巨,328,50,278,摩根大通,2023-02-21,8440
2301,光寶科,401,125,276,摩根大通,2023-02-21,8440
2332,友訊,272,7,265,摩根大通,2023-02-21,8440
2609,陽明,401,137,264,摩根大通,2023-02-21,8440
2436,偉詮電,283,22,261,摩根大通,2023-02-21,8440
4938,和碩,374,116,258,摩根大通,2023-02-21,8440
2049,上銀,499,243,256,摩根大通,2023-02-21,8440
1102,亞泥,357,104,253,摩根大通,2023-02-21,8440
2886,兆豐金,385,140,245,摩根大通,2023-02-21,8440
2023,燁輝,329,85,244,摩根大通,2023-02-21,8440
6278,台表科,254,10,244,摩根大通,2023-02-21,8440
2344,華邦電,652,415,237,摩根大通,2023-02-21,8440
2605,新興,227,2,225,摩根大通,2023-02-21,8440
3209,全科,214,4,210,摩根大通,2023-02-21,8440
2105,正新,304,98,206,摩根大通,2023-02-21,8440
5880,合庫金,336,131,205,摩根大通,2023-02-21,8440
3013,晟銘電,270,66,204,摩根大通,2023-02-21,8440
2885,元大金,383,179,204,摩根大通,2023-02-21,8440
1701,中化,228,26,202,摩根大通,2023-02-21,8440
1503,士電,365,167,198,摩根大通,2023-02-21,8440
2606,裕民,215,19,196,摩根大通,2023-02-21,8440
2360,致茂,203,10,193,摩根大通,2023-02-21,8440
2888,新光金,233,47,186,摩根大通,2023-02-21,8440
5371,中光電,270,87,183,摩根大通,2023-02-21,8440
2834,臺企銀,5228,745,4483,摩根大通,2023-02-22,8440
2891,中信金,4331,1319,3012,摩根大通,2023-02-22,8440
2330,台積電,3949,1545,2404,摩根大通,2023-02-22,8440
8033,雷虎,1891,311,1580,摩根大通,2023-02-22,8440
6116,彩晶,1629,181,1448,摩根大通,2023-02-22,8440
2892,第一金,1722,533,1189,摩根大通,2023-02-22,8440
3027,盛達,1540,364,1176,摩根大通,2023-02-22,8440
2208,台船,1461,666,795,摩根大通,2023-02-22,8440
6147,頎邦,844,52,792,摩根大通,2023-02-22,8440
3594,磐儀,1169,410,759,摩根大通,2023-02-22,8440
2845,遠東銀,740,71,669,摩根大通,2023-02-22,8440
5905,南仁湖,689,49,640,摩根大通,2023-02-22,8440
1342,八貫,1094,474,620,摩根大通,2023-02-22,8440
5880,合庫金,1030,439,591,摩根大通,2023-02-22,8440
1810,和成,730,165,565,摩根大通,2023-02-22,8440
2634,漢翔,619,117,502,摩根大通,2023-02-22,8440
5371,中光電,536,48,488,摩根大通,2023-02-22,8440
8222,寶一,647,212,435,摩根大通,2023-02-22,8440
1584,精剛,1302,868,434,摩根大通,2023-02-22,8440
2610,華航,1472,1040,432,摩根大通,2023-02-22,8440
2412,中華電,1036,613,423,摩根大通,2023-02-22,8440
1314,中石化,505,93,412,摩根大通,2023-02-22,8440
1783,和康生,547,149,398,摩根大通,2023-02-22,8440
4960,誠美材,417,43,374,摩根大通,2023-02-22,8440
2002,中鋼,899,527,372,摩根大通,2023-02-22,8440
6125,廣運,546,217,329,摩根大通,2023-02-22,8440
2484,希華,342,25,317,摩根大通,2023-02-22,8440
9938,百和,326,17,309,摩根大通,2023-02-22,8440
1217,愛之味,302,0,302,摩根大通,2023-02-22,8440
1476,儒鴻,316,22,294,摩根大通,2023-02-22,8440
2345,智邦,493,200,293,摩根大通,2023-02-22,8440
6142,友勁,299,7,292,摩根大通,2023-02-22,8440
1304,台聚,339,50,289,摩根大通,2023-02-22,8440
6443,元晶,365,88,277,摩根大通,2023-02-22,8440
6176,瑞儀,281,4,277,摩根大通,2023-02-22,8440
4536,拓凱,367,97,270,摩根大通,2023-02-22,8440
2606,裕民,422,158,264,摩根大通,2023-02-22,8440
3443,創意,415,154,261,摩根大通,2023-02-22,8440
2489,瑞軒,284,22,262,摩根大通,2023-02-22,8440
6120,達運,314,55,259,摩根大通,2023-02-22,8440
1218,泰山,282,27,255,摩根大通,2023-02-22,8440
2206,三陽工業,319,64,255,摩根大通,2023-02-22,8440
1305,華夏,334,80,254,摩根大通,2023-02-22,8440
2034,允強,267,15,252,摩根大通,2023-02-22,8440
2436,偉詮電,275,25,250,摩根大通,2023-02-22,8440
1701,中化,367,147,220,摩根大通,2023-02-22,8440
9958,世紀鋼,315,96,219,摩根大通,2023-02-22,8440
8215,明基材,242,24,218,摩根大通,2023-02-22,8440
3162,精確,234,20,214,摩根大通,2023-02-22,8440
8105,凌巨,220,6,214,摩根大通,2023-02-22,8440
1101,台泥,4514,299,4215,摩根大通,2023-02-23,8440
2891,中信金,5560,1462,4098,摩根大通,2023-02-23,8440
2330,台積電,4331,1361,2970,摩根大通,2023-02-23,8440
5880,合庫金,1781,268,1513,摩根大通,2023-02-23,8440
2885,元大金,1750,260,1490,摩根大通,2023-02-23,8440
3231,緯創,1515,125,1390,摩根大通,2023-02-23,8440
2890,永豐金,1353,21,1332,摩根大通,2023-02-23,8440
2888,新光金,1424,129,1295,摩根大通,2023-02-23,8440
2308,台達電,1876,592,1284,摩根大通,2023-02-23,8440
2609,陽明,1509,228,1281,摩根大通,2023-02-23,8440
3290,東浦,1250,34,1216,摩根大通,2023-02-23,8440
3035,智原,1328,126,1202,摩根大通,2023-02-23,8440
2882,國泰金,1241,40,1201,摩根大通,2023-02-23,8440
2892,第一金,1540,468,1072,摩根大通,2023-02-23,8440
2603,長榮,1144,86,1058,摩根大通,2023-02-23,8440
2887,台新金,1690,713,977,摩根大通,2023-02-23,8440
2601,益航,1080,136,944,摩根大通,2023-02-23,8440
2883,凱基金,2269,1331,938,摩根大通,2023-02-23,8440
2880,華南金,1256,334,922,摩根大通,2023-02-23,8440
2886,兆豐金,1113,196,917,摩根大通,2023-02-23,8440
1513,中興電,1252,342,910,摩根大通,2023-02-23,8440
2633,台灣高鐵,962,136,826,摩根大通,2023-02-23,8440
2344,華邦電,973,151,822,摩根大通,2023-02-23,8440
3661,世芯-KY,958,137,821,摩根大通,2023-02-23,8440
9945,潤泰新,894,98,796,摩根大通,2023-02-23,8440
2002,中鋼,1878,1092,786,摩根大通,2023-02-23,8440
2881,富邦金,1135,358,777,摩根大通,2023-02-23,8440
2637,慧洋-KY,1277,501,776,摩根大通,2023-02-23,8440
2845,遠東銀,900,126,774,摩根大通,2023-02-23,8440
1402,遠東新,812,66,746,摩根大通,2023-02-23,8440
6147,頎邦,779,35,744,摩根大通,2023-02-23,8440
1102,亞泥,880,190,690,摩根大通,2023-02-23,8440
2615,萬海,758,97,661,摩根大通,2023-02-23,8440
2382,廣達,720,59,661,摩根大通,2023-02-23,8440
3711,日月光投控,663,29,634,摩根大通,2023-02-23,8440
1701,中化,766,136,630,摩根大通,2023-02-23,8440
2412,中華電,680,53,627,摩根大通,2023-02-23,8440
2605,新興,1168,543,625,摩根大通,2023-02-23,8440
1802,台玻,623,22,601,摩根大通,2023-02-23,8440
2449,京元電子,1191,640,551,摩根大通,2023-02-23,8440
3045,台灣大,651,117,534,摩根大通,2023-02-23,8440
5347,世界,798,298,500,摩根大通,2023-02-23,8440
2454,聯發科,632,139,493,摩根大通,2023-02-23,8440
6770,力積電,538,46,492,摩根大通,2023-02-23,8440
2323,中環,490,0,490,摩根大通,2023-02-23,8440
2105,正新,538,64,474,摩根大通,2023-02-23,8440
5876,上海商銀,608,163,445,摩根大通,2023-02-23,8440
6005,群益證,477,60,417,摩根大通,2023-02-23,8440
8478,東哥遊艇,670,258,412,摩根大通,2023-02-23,8440
1303,南亞,663,254,409,摩根大通,2023-02-23,8440
2884,玉山金,29038,2508,26530,摩根大通,2023-02-24,8440
2892,第一金,23941,3204,20737,摩根大通,2023-02-24,8440
2834,臺企銀,13909,135,13774,摩根大通,2023-02-24,8440
1101,台泥,14916,4235,10681,摩根大通,2023-02-24,8440
2885,元大金,5768,690,5078,摩根大通,2023-02-24,8440
5009,榮剛,5870,843,5027,摩根大通,2023-02-24,8440
2301,光寶科,5136,1070,4066,摩根大通,2023-02-24,8440
2353,宏��,3297,49,3248,摩根大通,2023-02-24,8440
4114,健喬,4095,909,3186,摩根大通,2023-02-24,8440
3231,緯創,2987,249,2738,摩根大通,2023-02-24,8440
2637,慧洋-KY,2938,646,2292,摩根大通,2023-02-24,8440
8996,高力,2277,115,2162,摩根大通,2023-02-24,8440
2388,威盛,2947,1207,1740,摩根大通,2023-02-24,8440
2610,華航,2373,682,1691,摩根大通,2023-02-24,8440
2891,中信金,8093,6491,1602,摩根大通,2023-02-24,8440
2605,新興,2081,607,1474,摩根大通,2023-02-24,8440
5608,四維航,1911,530,1381,摩根大通,2023-02-24,8440
2609,陽明,2322,985,1337,摩根大通,2023-02-24,8440
2515,中工,1376,57,1319,摩根大通,2023-02-24,8440
3711,日月光投控,1963,654,1309,摩根大通,2023-02-24,8440
5347,世界,1536,339,1197,摩根大通,2023-02-24,8440
2382,廣達,1429,335,1094,摩根大通,2023-02-24,8440
1605,華新,1737,703,1034,摩根大通,2023-02-24,8440
2376,技嘉,1123,116,1007,摩根大通,2023-02-24,8440
6266,泰詠,1009,59,950,摩根大通,2023-02-24,8440
2317,鴻海,3559,2617,942,摩根大通,2023-02-24,8440
1216,統一,2108,1199,909,摩根大通,2023-02-24,8440
8150,南茂,1068,181,887,摩根大通,2023-02-24,8440
2368,金像電,940,142,798,摩根大通,2023-02-24,8440
2332,友訊,1070,369,701,摩根大通,2023-02-24,8440
3454,晶睿,690,35,655,摩根大通,2023-02-24,8440
2601,益航,1925,1277,648,摩根大通,2023-02-24,8440
2208,台船,725,93,632,摩根大通,2023-02-24,8440
6446,藥華藥,669,60,609,摩根大通,2023-02-24,8440
2882,國泰金,3784,3184,600,摩根大通,2023-02-24,8440
3703,欣陸,582,15,567,摩根大通,2023-02-24,8440
3706,神達,680,122,558,摩根大通,2023-02-24,8440
4960,誠美材,653,100,553,摩根大通,2023-02-24,8440
2492,華新科,710,173,537,摩根大通,2023-02-24,8440
3209,全科,557,23,534,摩根大通,2023-02-24,8440
2206,三陽工業,578,44,534,摩根大通,2023-02-24,8440
2017,官田鋼,587,54,533,摩根大通,2023-02-24,8440
2607,榮運,542,23,519,摩根大通,2023-02-24,8440
4763,材料-KY,1059,564,495,摩根大通,2023-02-24,8440
5876,上海商銀,1388,907,481,摩根大通,2023-02-24,8440
8938,明安,572,94,478,摩根大通,2023-02-24,8440
3035,智原,794,327,467,摩根大通,2023-02-24,8440
6782,視陽,632,170,462,摩根大通,2023-02-24,8440
2356,英業達,892,431,461,摩根大通,2023-02-24,8440
2449,京元電子,550,98,452,摩根大通,2023-02-24,8440
2303,聯電,12229,1600,10629,摩根大通,2023-03-01,8440
2330,台積電,7423,3427,3996,摩根大通,2023-03-01,8440
2834,臺企銀,4285,391,3894,摩根大通,2023-03-01,8440
2880,華南金,4021,1224,2797,摩根大通,2023-03-01,8440
2890,永豐金,3259,723,2536,摩根大通,2023-03-01,8440
2891,中信金,3286,1194,2092,摩根大通,2023-03-01,8440
2887,台新金,2396,406,1990,摩根大通,2023-03-01,8440
5880,合庫金,2780,881,1899,摩根大通,2023-03-01,8440
5876,上海商銀,1694,421,1273,摩根大通,2023-03-01,8440
2886,兆豐金,2502,1555,947,摩根大通,2023-03-01,8440
2317,鴻海,2705,1761,944,摩根大通,2023-03-01,8440
5871,中租-KY,1322,519,803,摩根大通,2023-03-01,8440
2897,王道銀行,790,0,790,摩根大通,2023-03-01,8440
2313,華通,805,30,775,摩根大通,2023-03-01,8440
2329,華泰,769,11,758,摩根大通,2023-03-01,8440
2634,漢翔,752,60,692,摩根大通,2023-03-01,8440
2201,裕隆,1001,316,685,摩根大通,2023-03-01,8440
2801,彰銀,827,145,682,摩根大通,2023-03-01,8440
6188,廣明,682,6,676,摩根大通,2023-03-01,8440
6282,康舒,781,140,641,摩根大通,2023-03-01,8440
6147,頎邦,637,3,634,摩根大通,2023-03-01,8440
9904,寶成,682,129,553,摩根大通,2023-03-01,8440
2049,上銀,771,228,543,摩根大通,2023-03-01,8440
8996,高力,851,370,481,摩根大通,2023-03-01,8440
3454,晶睿,525,52,473,摩根大通,2023-03-01,8440
3661,世芯-KY,619,158,461,摩根大通,2023-03-01,8440
2006,東和鋼鐵,668,212,456,摩根大通,2023-03-01,8440
2888,新光金,1519,1072,447,摩根大通,2023-03-01,8440
2376,技嘉,513,76,437,摩根大通,2023-03-01,8440
9910,豐泰,431,20,411,摩根大通,2023-03-01,8440
3293,鈊象,386,1,385,摩根大通,2023-03-01,8440
3162,精確,415,33,382,摩根大通,2023-03-01,8440
6415,矽力*-KY,492,133,359,摩根大通,2023-03-01,8440
3228,金麗科,395,43,352,摩根大通,2023-03-01,8440
2454,聯發科,987,637,350,摩根大通,2023-03-01,8440
2353,宏��,689,348,341,摩根大通,2023-03-01,8440
6257,矽格,342,2,340,摩根大通,2023-03-01,8440
2482,連宇,419,117,302,摩根大通,2023-03-01,8440
4958,臻鼎-KY,460,158,302,摩根大通,2023-03-01,8440
2359,所羅門,367,70,297,摩根大通,2023-03-01,8440
8112,至上,338,42,296,摩根大通,2023-03-01,8440
2328,廣宇,356,63,293,摩根大通,2023-03-01,8440
5347,世界,580,287,293,摩根大通,2023-03-01,8440
3005,神基,334,49,285,摩根大通,2023-03-01,8440
2206,三陽工業,318,35,283,摩根大通,2023-03-01,8440
5351,鈺創,285,3,282,摩根大通,2023-03-01,8440
2356,英業達,689,409,280,摩根大通,2023-03-01,8440
3207,耀勝,405,126,279,摩根大通,2023-03-01,8440
2882,國泰金,1039,763,276,摩根大通,2023-03-01,8440
6531,愛普*,355,83,272,摩根大通,2023-03-01,8440
2344,華邦電,14627,761,13866,摩根大通,2023-03-02,8440
2317,鴻海,8585,195,8390,摩根大通,2023-03-02,8440
2603,長榮,4326,159,4167,摩根大通,2023-03-02,8440
3037,欣興,1987,114,1873,摩根大通,2023-03-02,8440
2609,陽明,1878,127,1751,摩根大通,2023-03-02,8440
3711,日月光投控,1623,132,1491,摩根大通,2023-03-02,8440
2419,仲琦,1367,86,1281,摩根大通,2023-03-02,8440
2881,富邦金,1469,342,1127,摩根大通,2023-03-02,8440
2014,中鴻,1229,188,1041,摩根大通,2023-03-02,8440
2615,萬海,1012,37,975,摩根大通,2023-03-02,8440
2332,友訊,1092,151,941,摩根大通,2023-03-02,8440
2330,台積電,1954,1118,836,摩根大通,2023-03-02,8440
3380,明泰,935,129,806,摩根大通,2023-03-02,8440
8171,天宇,907,146,761,摩根大通,2023-03-02,8440
2887,台新金,821,154,667,摩根大通,2023-03-02,8440
2606,裕民,877,256,621,摩根大通,2023-03-02,8440
2634,漢翔,789,183,606,摩根大通,2023-03-02,8440
3481,群創,3355,2754,601,摩根大通,2023-03-02,8440
3576,聯合再生,662,102,560,摩根大通,2023-03-02,8440
2345,智邦,579,55,524,摩根大通,2023-03-02,8440
1319,東陽,528,8,520,摩根大通,2023-03-02,8440
5608,四維航,704,197,507,摩根大通,2023-03-02,8440
2601,益航,1029,540,489,摩根大通,2023-03-02,8440
5009,榮剛,543,59,484,摩根大通,2023-03-02,8440
2412,中華電,483,39,444,摩根大通,2023-03-02,8440
8112,至上,646,202,444,摩根大通,2023-03-02,8440
6142,友勁,459,25,434,摩根大通,2023-03-02,8440
2637,慧洋-KY,1104,698,406,摩根大通,2023-03-02,8440
3704,合勤控,470,98,372,摩根大通,2023-03-02,8440
2385,群光,404,35,369,摩根大通,2023-03-02,8440
2617,台航,460,101,359,摩根大通,2023-03-02,8440
2449,京元電子,480,123,357,摩根大通,2023-03-02,8440
8069,元太,428,75,353,摩根大通,2023-03-02,8440
2913,農林,331,0,331,摩根大通,2023-03-02,8440
2885,元大金,420,91,329,摩根大通,2023-03-02,8440
8046,南電,366,37,329,摩根大通,2023-03-02,8440
9962,有益,349,21,328,摩根大通,2023-03-02,8440
6245,立端,361,37,324,摩根大通,2023-03-02,8440
1712,興農,343,28,315,摩根大通,2023-03-02,8440
2208,台船,373,68,305,摩根大通,2023-03-02,8440
2641,正德,555,269,286,摩根大通,2023-03-02,8440
1718,中纖,276,0,276,摩根大通,2023-03-02,8440
8299,群聯,294,28,266,摩根大通,2023-03-02,8440
1752,南光,353,91,262,摩根大通,2023-03-02,8440
2882,國泰金,423,161,262,摩根大通,2023-03-02,8440
3346,麗清,285,30,255,摩根大通,2023-03-02,8440
2027,大成鋼,280,28,252,摩根大通,2023-03-02,8440
1701,中化,352,105,247,摩根大通,2023-03-02,8440
4142,國光生,311,68,243,摩根大通,2023-03-02,8440
2413,環科,352,113,239,摩根大通,2023-03-02,8440
3481,群創,6392,2346,4046,摩根大通,2023-03-03,8440
2603,長榮,4244,490,3754,摩根大通,2023-03-03,8440
3037,欣興,2587,278,2309,摩根大通,2023-03-03,8440
6116,彩晶,2324,286,2038,摩根大通,2023-03-03,8440
2449,京元電子,1977,218,1759,摩根大通,2023-03-03,8440
2409,友達,2081,441,1640,摩根大通,2023-03-03,8440
2317,鴻海,1503,19,1484,摩根大通,2023-03-03,8440
2332,友訊,1456,53,1403,摩根大通,2023-03-03,8440
2609,陽明,2080,897,1183,摩根大通,2023-03-03,8440
5608,四維航,1971,895,1076,摩根大通,2023-03-03,8440
2402,毅嘉,1052,27,1025,摩根大通,2023-03-03,8440
2324,仁寶,1392,425,967,摩根大通,2023-03-03,8440
6188,廣明,854,21,833,摩根大通,2023-03-03,8440
2303,聯電,1551,756,795,摩根大通,2023-03-03,8440
2634,漢翔,795,3,792,摩根大通,2023-03-03,8440
2605,新興,1238,448,790,摩根大通,2023-03-03,8440
3714,富采,901,112,789,摩根大通,2023-03-03,8440
3006,晶豪科,930,157,773,摩根大通,2023-03-03,8440
3005,神基,860,92,768,摩根大通,2023-03-03,8440
8150,南茂,741,8,733,摩根大通,2023-03-03,8440
8936,國統,731,25,706,摩根大通,2023-03-03,8440
3264,欣銓,711,12,699,摩根大通,2023-03-03,8440
1217,愛之味,728,52,676,摩根大通,2023-03-03,8440
6245,立端,1024,351,673,摩根大通,2023-03-03,8440
8105,凌巨,723,57,666,摩根大通,2023-03-03,8440
3704,合勤控,702,52,650,摩根大通,2023-03-03,8440
1314,中石化,649,0,649,摩根大通,2023-03-03,8440
3034,聯詠,745,141,604,摩根大通,2023-03-03,8440
8215,明基材,602,2,600,摩根大通,2023-03-03,8440
3231,緯創,937,350,587,摩根大通,2023-03-03,8440
1783,和康生,677,99,578,摩根大通,2023-03-03,8440
8088,品安,533,10,523,摩根大通,2023-03-03,8440
3362,先進光,784,271,513,摩根大通,2023-03-03,8440
8358,金居,558,51,507,摩根大通,2023-03-03,8440
2617,台航,657,157,500,摩根大通,2023-03-03,8440
3265,台星科,505,7,498,摩根大通,2023-03-03,8440
2323,中環,514,32,482,摩根大通,2023-03-03,8440
2313,華通,609,128,481,摩根大通,2023-03-03,8440
1513,中興電,853,376,477,摩根大通,2023-03-03,8440
3088,艾訊,459,7,452,摩根大通,2023-03-03,8440
3024,憶聲,468,24,444,摩根大通,2023-03-03,8440
3162,精確,525,85,440,摩根大通,2023-03-03,8440
2337,旺宏,796,365,431,摩根大通,2023-03-03,8440
6147,頎邦,435,6,429,摩根大通,2023-03-03,8440
2385,群光,426,13,413,摩根大通,2023-03-03,8440
3027,盛達,458,47,411,摩根大通,2023-03-03,8440
2515,中工,391,0,391,摩根大通,2023-03-03,8440
2329,華泰,454,77,377,摩根大通,2023-03-03,8440
6770,力積電,568,215,353,摩根大通,2023-03-03,8440
6533,晶心科,393,42,351,摩根大通,2023-03-03,8440
2409,友達,5789,2082,3707,摩根大通,2023-03-06,8440
1605,華新,2634,246,2388,摩根大通,2023-03-06,8440
2324,仁寶,2700,771,1929,摩根大通,2023-03-06,8440
2449,京元電子,2014,213,1801,摩根大通,2023-03-06,8440
2882,國泰金,1530,3,1527,摩根大通,2023-03-06,8440
2330,台積電,2010,663,1347,摩根大通,2023-03-06,8440
2356,英業達,1272,93,1179,摩根大通,2023-03-06,8440
2633,台灣高鐵,1233,62,1171,摩根大通,2023-03-06,8440
1305,華夏,1042,35,1007,摩根大通,2023-03-06,8440
4961,天鈺,1133,209,924,摩根大通,2023-03-06,8440
2887,台新金,1076,207,869,摩根大通,2023-03-06,8440
2881,富邦金,2088,1256,832,摩根大通,2023-03-06,8440
2888,新光金,1060,262,798,摩根大通,2023-03-06,8440
2892,第一金,948,162,786,摩根大通,2023-03-06,8440
6770,力積電,990,205,785,摩根大通,2023-03-06,8440
2885,元大金,743,0,743,摩根大通,2023-03-06,8440
2492,華新科,717,15,702,摩根大通,2023-03-06,8440
1718,中纖,613,0,613,摩根大通,2023-03-06,8440
2889,國票金,825,256,569,摩根大通,2023-03-06,8440
3714,富采,708,145,563,摩根大通,2023-03-06,8440
2353,宏��,585,33,552,摩根大通,2023-03-06,8440
2376,技嘉,681,146,535,摩根大通,2023-03-06,8440
2317,鴻海,628,109,519,摩根大通,2023-03-06,8440
3231,緯創,1150,668,482,摩根大通,2023-03-06,8440
3059,華晶科,480,27,453,摩根大通,2023-03-06,8440
3005,神基,498,49,449,摩根大通,2023-03-06,8440
4114,健喬,559,111,448,摩根大通,2023-03-06,8440
2332,友訊,1020,634,386,摩根大通,2023-03-06,8440
5483,中美晶,443,80,363,摩根大通,2023-03-06,8440
6443,元晶,382,26,356,摩根大通,2023-03-06,8440
1710,東聯,341,3,338,摩根大通,2023-03-06,8440
1609,大亞,398,63,335,摩根大通,2023-03-06,8440
8069,元太,355,22,333,摩根大通,2023-03-06,8440
4967,十銓,572,243,329,摩根大通,2023-03-06,8440
2360,致茂,352,25,327,摩根大通,2023-03-06,8440
3038,全台,372,47,325,摩根大通,2023-03-06,8440
4979,華星光,389,85,304,摩根大通,2023-03-06,8440
8215,明基材,573,273,300,摩根大通,2023-03-06,8440
2609,陽明,911,627,284,摩根大通,2023-03-06,8440
1326,台化,299,19,280,摩根大通,2023-03-06,8440
6143,振曜,292,15,277,摩根大通,2023-03-06,8440
2884,玉山金,844,576,268,摩根大通,2023-03-06,8440
1760,寶齡富錦,361,106,255,摩根大通,2023-03-06,8440
3704,合勤控,396,146,250,摩根大通,2023-03-06,8440
1434,福懋,302,53,249,摩根大通,2023-03-06,8440
1314,中石化,246,2,244,摩根大通,2023-03-06,8440
2412,中華電,294,53,241,摩根大通,2023-03-06,8440
1303,南亞,251,13,238,摩根大通,2023-03-06,8440
6706,惠特,268,32,236,摩根大通,2023-03-06,8440
1309,台達化,243,13,230,摩根大通,2023-03-06,8440
2883,凱基金,3599,376,3223,摩根大通,2023-03-07,8440
5425,台半,3174,290,2884,摩根大通,2023-03-07,8440
2890,永豐金,1946,343,1603,摩根大通,2023-03-07,8440
6235,華孚,2138,573,1565,摩根大通,2023-03-07,8440
2881,富邦金,1764,236,1528,摩根大通,2023-03-07,8440
1605,華新,1769,706,1063,摩根大通,2023-03-07,8440
2308,台達電,1677,714,963,摩根大通,2023-03-07,8440
1609,大亞,1187,242,945,摩根大通,2023-03-07,8440
2867,三商壽,934,1,933,摩根大通,2023-03-07,8440
2882,國泰金,1077,178,899,摩根大通,2023-03-07,8440
2834,臺企銀,901,5,896,摩根大通,2023-03-07,8440
2889,國票金,1058,239,819,摩根大通,2023-03-07,8440
1718,中纖,798,47,751,摩根大通,2023-03-07,8440
1314,中石化,748,0,748,摩根大通,2023-03-07,8440
2495,普安,796,70,726,摩根大通,2023-03-07,8440
3481,群創,2472,1750,722,摩根大通,2023-03-07,8440
2027,大成鋼,683,15,668,摩根大通,2023-03-07,8440
2382,廣達,639,1,638,摩根大通,2023-03-07,8440
2897,王道銀行,626,4,622,摩根大通,2023-03-07,8440
2609,陽明,646,31,615,摩根大通,2023-03-07,8440
2615,萬海,709,123,586,摩根大通,2023-03-07,8440
2641,正德,626,43,583,摩根大通,2023-03-07,8440
1514,亞力,623,66,557,摩根大通,2023-03-07,8440
2371,大同,536,2,534,摩根大通,2023-03-07,8440
6285,啟��,595,70,525,摩根大通,2023-03-07,8440
2330,台積電,1318,797,521,摩根大通,2023-03-07,8440
2888,新光金,1174,690,484,摩根大通,2023-03-07,8440
3380,明泰,582,100,482,摩根大通,2023-03-07,8440
4938,和碩,1103,650,453,摩根大通,2023-03-07,8440
2332,友訊,438,0,438,摩根大通,2023-03-07,8440
2356,英業達,662,226,436,摩根大通,2023-03-07,8440
3362,先進光,536,103,433,摩根大通,2023-03-07,8440
2023,燁輝,429,3,426,摩根大通,2023-03-07,8440
5009,榮剛,915,491,424,摩根大通,2023-03-07,8440
4763,材料-KY,651,231,420,摩根大通,2023-03-07,8440
3576,聯合再生,444,49,395,摩根大通,2023-03-07,8440
3714,富采,427,33,394,摩根大通,2023-03-07,8440
2368,金像電,402,33,369,摩根大通,2023-03-07,8440
2606,裕民,677,315,362,摩根大通,2023-03-07,8440
2014,中鴻,371,30,341,摩根大通,2023-03-07,8440
6443,元晶,614,273,341,摩根大通,2023-03-07,8440
3558,神準,474,152,322,摩根大通,2023-03-07,8440
1447,力鵬,328,13,315,摩根大通,2023-03-07,8440
1444,力麗,316,2,314,摩根大通,2023-03-07,8440
2812,台中銀,368,59,309,摩根大通,2023-03-07,8440
1522,堤維西,309,3,306,摩根大通,2023-03-07,8440
3047,訊舟,334,29,305,摩根大通,2023-03-07,8440
1313,聯成,299,0,299,摩根大通,2023-03-07,8440
3005,神基,575,281,294,摩根大通,2023-03-07,8440
2885,元大金,471,179,292,摩根大通,2023-03-07,8440
2303,聯電,6665,1098,5567,摩根大通,2023-03-08,8440
2408,南亞科,2332,113,2219,摩根大通,2023-03-08,8440
2888,新光金,3321,1203,2118,摩根大通,2023-03-08,8440
2317,鴻海,3057,1145,1912,摩根大通,2023-03-08,8440
2634,漢翔,1616,157,1459,摩根大通,2023-03-08,8440
2615,萬海,1606,198,1408,摩根大通,2023-03-08,8440
2371,大同,1440,125,1315,摩根大通,2023-03-08,8440
2359,所羅門,1404,226,1178,摩根大通,2023-03-08,8440
1101,台泥,1561,428,1133,摩根大通,2023-03-08,8440
2457,飛宏,1585,590,995,摩根大通,2023-03-08,8440
3231,緯創,1914,983,931,摩根大通,2023-03-08,8440
6282,康舒,1814,960,854,摩根大通,2023-03-08,8440
2413,環科,841,16,825,摩根大通,2023-03-08,8440
2881,富邦金,1829,1078,751,摩根大通,2023-03-08,8440
2889,國票金,804,131,673,摩根大通,2023-03-08,8440
3005,神基,769,135,634,摩根大通,2023-03-08,8440
3714,富采,704,73,631,摩根大通,2023-03-08,8440
2419,仲琦,666,40,626,摩根大通,2023-03-08,8440
5388,中磊,767,150,617,摩根大通,2023-03-08,8440
3290,東浦,666,59,607,摩根大通,2023-03-08,8440
2027,大成鋼,650,102,548,摩根大通,2023-03-08,8440
2897,王道銀行,559,22,537,摩根大通,2023-03-08,8440
2352,佳世達,717,190,527,摩根大通,2023-03-08,8440
3034,聯詠,523,45,478,摩根大通,2023-03-08,8440
2618,長榮航,819,345,474,摩根大通,2023-03-08,8440
4979,華星光,578,105,473,摩根大通,2023-03-08,8440
5425,台半,900,437,463,摩根大通,2023-03-08,8440
6269,台郡,534,87,447,摩根大通,2023-03-08,8440
2332,友訊,474,54,420,摩根大通,2023-03-08,8440
8163,達方,628,214,414,摩根大通,2023-03-08,8440
1609,大亞,1139,732,407,摩根大通,2023-03-08,8440
6443,元晶,486,89,397,摩根大通,2023-03-08,8440
2495,普安,444,55,389,摩根大通,2023-03-08,8440
1513,中興電,1042,660,382,摩根大通,2023-03-08,8440
2641,正德,473,98,375,摩根大通,2023-03-08,8440
1522,堤維西,379,11,368,摩根大通,2023-03-08,8440
4976,佳凌,719,359,360,摩根大通,2023-03-08,8440
3211,順達,367,9,358,摩根大通,2023-03-08,8440
4960,誠美材,371,29,342,摩根大通,2023-03-08,8440
6147,頎邦,342,4,338,摩根大通,2023-03-08,8440
5483,中美晶,349,27,322,摩根大通,2023-03-08,8440
2409,友達,963,656,307,摩根大通,2023-03-08,8440
5258,虹堡,479,173,306,摩根大通,2023-03-08,8440
8105,凌巨,324,25,299,摩根大通,2023-03-08,8440
5309,系統電,298,3,295,摩根大通,2023-03-08,8440
2472,立隆電,338,48,290,摩根大通,2023-03-08,8440
3374,精材,317,35,282,摩根大通,2023-03-08,8440
4977,眾達-KY,419,137,282,摩根大通,2023-03-08,8440
2402,毅嘉,353,74,279,摩根大通,2023-03-08,8440
2014,中鴻,565,287,278,摩根大通,2023-03-08,8440
2303,聯電,11582,2921,8661,摩根大通,2023-03-09,8440
2330,台積電,7774,1117,6657,摩根大通,2023-03-09,8440
2457,飛宏,3099,765,2334,摩根大通,2023-03-09,8440
2359,所羅門,2489,626,1863,摩根大通,2023-03-09,8440
2317,鴻海,1844,336,1508,摩根大通,2023-03-09,8440
6147,頎邦,1488,7,1481,摩根大通,2023-03-09,8440
2834,臺企銀,1812,403,1409,摩根大通,2023-03-09,8440
2615,萬海,1305,89,1216,摩根大通,2023-03-09,8440
9904,寶成,1239,137,1102,摩根大通,2023-03-09,8440
6770,力積電,1300,324,976,摩根大通,2023-03-09,8440
2449,京元電子,2210,1332,878,摩根大通,2023-03-09,8440
5388,中磊,1202,327,875,摩根大通,2023-03-09,8440
2897,王道銀行,1016,144,872,摩根大通,2023-03-09,8440
2454,聯發科,981,138,843,摩根大通,2023-03-09,8440
2324,仁寶,1105,309,796,摩根大通,2023-03-09,8440
4977,眾達-KY,1094,333,761,摩根大通,2023-03-09,8440
2634,漢翔,845,108,737,摩根大通,2023-03-09,8440
2027,大成鋼,818,139,679,摩根大通,2023-03-09,8440
3711,日月光投控,713,165,548,摩根大通,2023-03-09,8440
2617,台航,579,79,500,摩根大通,2023-03-09,8440
1701,中化,474,0,474,摩根大通,2023-03-09,8440
6505,台塑化,573,105,468,摩根大通,2023-03-09,8440
2609,陽明,1005,553,452,摩根大通,2023-03-09,8440
2845,遠東銀,438,15,423,摩根大通,2023-03-09,8440
2603,長榮,799,385,414,摩根大通,2023-03-09,8440
3038,全台,432,24,408,摩根大通,2023-03-09,8440
3596,智易,376,1,375,摩根大通,2023-03-09,8440
5871,中租-KY,588,240,348,摩根大通,2023-03-09,8440
1477,聚陽,351,4,347,摩根大通,2023-03-09,8440
2382,廣達,532,200,332,摩根大通,2023-03-09,8440
5371,中光電,361,29,332,摩根大通,2023-03-09,8440
2332,友訊,347,18,329,摩根大通,2023-03-09,8440
5483,中美晶,731,413,318,摩根大通,2023-03-09,8440
4958,臻鼎-KY,411,102,309,摩根大通,2023-03-09,8440
2014,中鴻,324,37,287,摩根大通,2023-03-09,8440
6288,聯嘉,309,25,284,摩根大通,2023-03-09,8440
4119,旭富,313,32,281,摩根大通,2023-03-09,8440
2408,南亞科,902,630,272,摩根大通,2023-03-09,8440
6202,盛群,270,7,263,摩根大通,2023-03-09,8440
2515,中工,248,0,248,摩根大通,2023-03-09,8440
3093,港建*,347,100,247,摩根大通,2023-03-09,8440
2458,義隆,442,197,245,摩根大通,2023-03-09,8440
1304,台聚,240,0,240,摩根大通,2023-03-09,8440
2206,三陽工業,272,35,237,摩根大通,2023-03-09,8440
2912,統一超,277,41,236,摩根大通,2023-03-09,8440
6547,高端疫苗,331,97,234,摩根大通,2023-03-09,8440
6274,台燿,418,187,231,摩根大通,2023-03-09,8440
2472,立隆電,323,102,221,摩根大通,2023-03-09,8440
3023,信邦,244,25,219,摩根大通,2023-03-09,8440
4904,遠傳,332,122,210,摩根大通,2023-03-09,8440
2324,仁寶,5316,2403,2913,摩根大通,2023-03-10,8440
2615,萬海,2770,308,2462,摩根大通,2023-03-10,8440
2882,國泰金,4540,2164,2376,摩根大通,2023-03-10,8440
2457,飛宏,2635,556,2079,摩根大通,2023-03-10,8440
2382,廣達,2021,539,1482,摩根大通,2023-03-10,8440
2609,陽明,3679,2519,1160,摩根大通,2023-03-10,8440
2352,佳世達,1157,21,1136,摩根大通,2023-03-10,8440
2356,英業達,2158,1042,1116,摩根大通,2023-03-10,8440
2317,鴻海,2518,1769,749,摩根大通,2023-03-10,8440
2027,大成鋼,794,73,721,摩根大通,2023-03-10,8440
2731,雄獅,736,60,676,摩根大通,2023-03-10,8440
2637,慧洋-KY,701,28,673,摩根大通,2023-03-10,8440
6188,廣明,575,54,521,摩根大通,2023-03-10,8440
1909,榮成,523,26,497,摩根大通,2023-03-10,8440
5425,台半,649,156,493,摩根大通,2023-03-10,8440
5009,榮剛,749,279,470,摩根大通,2023-03-10,8440
2748,雲品,520,59,461,摩根大通,2023-03-10,8440
3005,神基,703,245,458,摩根大通,2023-03-10,8440
2353,宏��,1016,562,454,摩根大通,2023-03-10,8440
3704,合勤控,524,72,452,摩根大通,2023-03-10,8440
2377,微星,559,112,447,摩根大通,2023-03-10,8440
2402,毅嘉,839,401,438,摩根大通,2023-03-10,8440
8936,國統,535,107,428,摩根大通,2023-03-10,8440
1319,東陽,442,35,407,摩根大通,2023-03-10,8440
2413,環科,802,413,389,摩根大通,2023-03-10,8440
8150,南茂,512,160,352,摩根大通,2023-03-10,8440
2504,國產,437,103,334,摩根大通,2023-03-10,8440
5371,中光電,370,55,315,摩根大通,2023-03-10,8440
2345,智邦,445,154,291,摩根大通,2023-03-10,8440
3038,全台,362,78,284,摩根大通,2023-03-10,8440
3033,威健,297,29,268,摩根大通,2023-03-10,8440
1304,台聚,291,25,266,摩根大通,2023-03-10,8440
5315,光聯,278,19,259,摩根大通,2023-03-10,8440
2017,官田鋼,321,69,252,摩根大通,2023-03-10,8440
8227,巨有科技,409,158,251,摩根大通,2023-03-10,8440
3024,憶聲,253,4,249,摩根大通,2023-03-10,8440
2606,裕民,384,135,249,摩根大通,2023-03-10,8440
2388,威盛,502,256,246,摩根大通,2023-03-10,8440
8105,凌巨,314,73,241,摩根大通,2023-03-10,8440
2890,永豐金,2086,1854,232,摩根大通,2023-03-10,8440
2915,潤泰全,269,40,229,摩根大通,2023-03-10,8440
3545,敦泰,287,62,225,摩根大通,2023-03-10,8440
2727,王品,275,57,218,摩根大通,2023-03-10,8440
3624,光頡,316,102,214,摩根大通,2023-03-10,8440
6239,力成,325,115,210,摩根大通,2023-03-10,8440
2393,億光,221,14,207,摩根大通,2023-03-10,8440
8436,大江,217,12,205,摩根大通,2023-03-10,8440
6548,長科*,229,41,188,摩根大通,2023-03-10,8440
3592,瑞鼎,190,3,187,摩根大通,2023-03-10,8440
2419,仲琦,195,10,185,摩根大通,2023-03-10,8440
2303,聯電,5205,1761,3444,摩根大通,2023-03-13,8440
2324,仁寶,4485,1201,3284,摩根大通,2023-03-13,8440
0056,元大高股息,2772,0,2772,摩根大通,2023-03-13,8440
2882,國泰金,2944,422,2522,摩根大通,2023-03-13,8440
3231,緯創,2819,642,2177,摩根大通,2023-03-13,8440
2027,大成鋼,1754,108,1646,摩根大通,2023-03-13,8440
2449,京元電子,2012,550,1462,摩根大通,2023-03-13,8440
6282,康舒,1432,69,1363,摩根大通,2023-03-13,8440
2002,中鋼,1503,199,1304,摩根大通,2023-03-13,8440
2636,台驊控股,1334,142,1192,摩根大通,2023-03-13,8440
1605,華新,1235,262,973,摩根大通,2023-03-13,8440
2353,宏��,999,79,920,摩根大通,2023-03-13,8440
2352,佳世達,945,203,742,摩根大通,2023-03-13,8440
1609,大亞,877,140,737,摩根大通,2023-03-13,8440
4979,華星光,823,117,706,摩根大通,2023-03-13,8440
6245,立端,659,63,596,摩根大通,2023-03-13,8440
3702,大聯大,694,99,595,摩根大通,2023-03-13,8440
6443,元晶,595,14,581,摩根大通,2023-03-13,8440
2330,台積電,910,333,577,摩根大通,2023-03-13,8440
9904,寶成,689,123,566,摩根大通,2023-03-13,8440
3704,合勤控,706,164,542,摩根大通,2023-03-13,8440
2886,兆豐金,579,55,524,摩根大通,2023-03-13,8440
5880,合庫金,538,53,485,摩根大通,2023-03-13,8440
2892,第一金,650,175,475,摩根大通,2023-03-13,8440
2482,連宇,788,314,474,摩根大通,2023-03-13,8440
6239,力成,474,13,461,摩根大通,2023-03-13,8440
2377,微星,443,23,420,摩根大通,2023-03-13,8440
1305,華夏,466,46,420,摩根大通,2023-03-13,8440
2881,富邦金,471,60,411,摩根大通,2023-03-13,8440
6147,頎邦,583,178,405,摩根大通,2023-03-13,8440
1584,精剛,400,15,385,摩根大通,2023-03-13,8440
2332,友訊,391,9,382,摩根大通,2023-03-13,8440
8150,南茂,565,190,375,摩根大通,2023-03-13,8440
2727,王品,652,309,343,摩根大通,2023-03-13,8440
4961,天鈺,667,326,341,摩根大通,2023-03-13,8440
2601,益航,401,84,317,摩根大通,2023-03-13,8440
6188,廣明,325,20,305,摩根大通,2023-03-13,8440
2345,智邦,409,106,303,摩根大通,2023-03-13,8440
2356,英業達,996,694,302,摩根大通,2023-03-13,8440
2542,興富發,313,13,300,摩根大通,2023-03-13,8440
2103,台橡,362,70,292,摩根大通,2023-03-13,8440
2834,臺企銀,312,34,278,摩根大通,2023-03-13,8440
6005,群益證,337,60,277,摩根大通,2023-03-13,8440
1513,中興電,581,307,274,摩根大通,2023-03-13,8440
5388,中磊,332,59,273,摩根大通,2023-03-13,8440
4915,致伸,319,50,269,摩根大通,2023-03-13,8440
3005,神基,736,469,267,摩根大通,2023-03-13,8440
3088,艾訊,344,87,257,摩根大通,2023-03-13,8440
3380,明泰,469,215,254,摩根大通,2023-03-13,8440
4162,智擎,252,2,250,摩根大通,2023-03-13,8440
2449,京元電子,3058,275,2783,摩根大通,2023-03-14,8440
1216,統一,2301,589,1712,摩根大通,2023-03-14,8440
1609,大亞,1409,240,1169,摩根大通,2023-03-14,8440
5388,中磊,1148,127,1021,摩根大通,2023-03-14,8440
4934,太極,906,14,892,摩根大通,2023-03-14,8440
5371,中光電,887,20,867,摩根大通,2023-03-14,8440
1504,東元,1136,348,788,摩根大通,2023-03-14,8440
3231,緯創,984,331,653,摩根大通,2023-03-14,8440
8926,台汽電,572,6,566,摩根大通,2023-03-14,8440
3711,日月光投控,1057,514,543,摩根大通,2023-03-14,8440
3162,精確,605,92,513,摩根大通,2023-03-14,8440
5425,台半,843,344,499,摩根大通,2023-03-14,8440
2006,東和鋼鐵,592,110,482,摩根大通,2023-03-14,8440
2634,漢翔,624,161,463,摩根大通,2023-03-14,8440
9904,寶成,705,250,455,摩根大通,2023-03-14,8440
6235,華孚,661,224,437,摩根大通,2023-03-14,8440
1314,中石化,550,114,436,摩根大通,2023-03-14,8440
5009,榮剛,678,252,426,摩根大通,2023-03-14,8440
6213,聯茂,385,17,368,摩根大通,2023-03-14,8440
2641,正德,446,80,366,摩根大通,2023-03-14,8440
1319,東陽,514,175,339,摩根大通,2023-03-14,8440
2498,宏達電,472,151,321,摩根大通,2023-03-14,8440
1467,南緯,317,11,306,摩根大通,2023-03-14,8440
2637,慧洋-KY,326,27,299,摩根大通,2023-03-14,8440
3044,健鼎,316,50,266,摩根大通,2023-03-14,8440
2201,裕隆,438,182,256,摩根大通,2023-03-14,8440
1229,聯華,336,87,249,摩根大通,2023-03-14,8440
4164,承業醫,315,93,222,摩根大通,2023-03-14,8440
2371,大同,323,108,215,摩根大通,2023-03-14,8440
0056,元大高股息,214,0,214,摩根大通,2023-03-14,8440
3443,創意,301,107,194,摩根大通,2023-03-14,8440
3596,智易,181,4,177,摩根大通,2023-03-14,8440
6125,廣運,192,18,174,摩根大通,2023-03-14,8440
2812,台中銀,640,480,160,摩根大通,2023-03-14,8440
2413,環科,426,271,155,摩根大通,2023-03-14,8440
6191,精成科,175,32,143,摩根大通,2023-03-14,8440
3706,神達,247,106,141,摩根大通,2023-03-14,8440
6443,元晶,272,136,136,摩根大通,2023-03-14,8440
8933,愛地雅,165,34,131,摩根大通,2023-03-14,8440
6472,保瑞,204,75,129,摩根大通,2023-03-14,8440
2617,台航,196,73,123,摩根大通,2023-03-14,8440
6104,創惟,141,18,123,摩根大通,2023-03-14,8440
2401,凌陽,122,2,120,摩根大通,2023-03-14,8440
3078,僑威,124,4,120,摩根大通,2023-03-14,8440
2382,廣達,619,499,120,摩根大通,2023-03-14,8440
1909,榮成,142,26,116,摩根大通,2023-03-14,8440
3049,精金,132,16,116,摩根大通,2023-03-14,8440
2393,億光,116,0,116,摩根大通,2023-03-14,8440
1217,愛之味,119,3,116,摩根大通,2023-03-14,8440
2313,華通,445,331,114,摩根大通,2023-03-14,8440
2330,台積電,5617,1661,3956,摩根大通,2023-03-15,8440
2303,聯電,4237,1215,3022,摩根大通,2023-03-15,8440
3027,盛達,1452,199,1253,摩根大通,2023-03-15,8440
2204,中華,1331,253,1078,摩根大通,2023-03-15,8440
6244,茂迪,1115,38,1077,摩根大通,2023-03-15,8440
2515,中工,1171,96,1075,摩根大通,2023-03-15,8440
6125,廣運,1028,122,906,摩根大通,2023-03-15,8440
6443,元晶,889,19,870,摩根大通,2023-03-15,8440
6282,康舒,1004,161,843,摩根大通,2023-03-15,8440
3711,日月光投控,1352,615,737,摩根大通,2023-03-15,8440
3264,欣銓,720,13,707,摩根大通,2023-03-15,8440
2345,智邦,932,261,671,摩根大通,2023-03-15,8440
9904,寶成,976,318,658,摩根大通,2023-03-15,8440
2542,興富發,971,314,657,摩根大通,2023-03-15,8440
2455,全新,689,36,653,摩根大通,2023-03-15,8440
2882,國泰金,1074,447,627,摩根大通,2023-03-15,8440
1605,華新,935,316,619,摩根大通,2023-03-15,8440
8069,元太,490,45,445,摩根大通,2023-03-15,8440
4934,太極,737,295,442,摩根大通,2023-03-15,8440
2634,漢翔,467,26,441,摩根大通,2023-03-15,8440
2401,凌陽,425,4,421,摩根大通,2023-03-15,8440
3576,聯合再生,428,26,402,摩根大通,2023-03-15,8440
2421,建準,467,109,358,摩根大通,2023-03-15,8440
6505,台塑化,360,29,331,摩根大通,2023-03-15,8440
3011,今皓,366,44,322,摩根大通,2023-03-15,8440
3093,港建*,322,4,318,摩根大通,2023-03-15,8440
2605,新興,656,346,310,摩根大通,2023-03-15,8440
1216,統一,561,255,306,摩根大通,2023-03-15,8440
1316,上曜,347,46,301,摩根大通,2023-03-15,8440
1752,南光,264,0,264,摩根大通,2023-03-15,8440
6477,安集,255,13,242,摩根大通,2023-03-15,8440
6133,金橋,297,55,242,摩根大通,2023-03-15,8440
2406,國碩,295,59,236,摩根大通,2023-03-15,8440
1701,中化,253,17,236,摩根大通,2023-03-15,8440
4119,旭富,305,72,233,摩根大通,2023-03-15,8440
2637,慧洋-KY,281,49,232,摩根大通,2023-03-15,8440
6182,合晶,237,6,231,摩根大通,2023-03-15,8440
6550,北極星藥業-KY,275,57,218,摩根大通,2023-03-15,8440
8926,台汽電,411,198,213,摩根大通,2023-03-15,8440
1101,台泥,571,360,211,摩根大通,2023-03-15,8440
6533,晶心科,303,97,206,摩根大通,2023-03-15,8440
2002,中鋼,929,726,203,摩根大通,2023-03-15,8440
1303,南亞,531,334,197,摩根大通,2023-03-15,8440
2888,新光金,3821,3626,195,摩根大通,2023-03-15,8440
1442,名軒,200,14,186,摩根大通,2023-03-15,8440
6770,力積電,313,133,180,摩根大通,2023-03-15,8440
1102,亞泥,412,237,175,摩根大通,2023-03-15,8440
3035,智原,335,165,170,摩根大通,2023-03-15,8440
2495,普安,209,40,169,摩根大通,2023-03-15,8440
3047,訊舟,185,17,168,摩根大通,2023-03-15,8440
2356,英業達,2919,794,2125,摩根大通,2023-03-16,8440
2303,聯電,2106,220,1886,摩根大通,2023-03-16,8440
9945,潤泰新,2258,905,1353,摩根大通,2023-03-16,8440
2412,中華電,1331,0,1331,摩根大通,2023-03-16,8440
2884,玉山金,1853,696,1157,摩根大通,2023-03-16,8440
0056,元大高股息,1105,0,1105,摩根大通,2023-03-16,8440
3056,富華新,1168,193,975,摩根大通,2023-03-16,8440
1513,中興電,1025,147,878,摩根大通,2023-03-16,8440
2457,飛宏,1124,322,802,摩根大通,2023-03-16,8440
2353,宏��,1106,306,800,摩根大通,2023-03-16,8440
2614,東森,916,184,732,摩根大通,2023-03-16,8440
3231,緯創,716,67,649,摩根大通,2023-03-16,8440
2377,微星,710,72,638,摩根大通,2023-03-16,8440
6116,彩晶,631,16,615,摩根大通,2023-03-16,8440
8358,金居,757,166,591,摩根大通,2023-03-16,8440
1701,中化,507,51,456,摩根大通,2023-03-16,8440
5871,中租-KY,847,411,436,摩根大通,2023-03-16,8440
8933,愛地雅,507,77,430,摩根大通,2023-03-16,8440
2308,台達電,475,65,410,摩根大通,2023-03-16,8440
3033,威健,410,0,410,摩根大通,2023-03-16,8440
9904,寶成,547,147,400,摩根大通,2023-03-16,8440
6290,良維,381,7,374,摩根大通,2023-03-16,8440
2201,裕隆,455,86,369,摩根大通,2023-03-16,8440
6235,華孚,782,444,338,摩根大通,2023-03-16,8440
2455,全新,341,4,337,摩根大通,2023-03-16,8440
2427,三商電,357,24,333,摩根大通,2023-03-16,8440
2330,台積電,648,332,316,摩根大通,2023-03-16,8440
3013,晟銘電,329,20,309,摩根大通,2023-03-16,8440
1218,泰山,353,65,288,摩根大通,2023-03-16,8440
3704,合勤控,544,265,279,摩根大通,2023-03-16,8440
8112,至上,413,135,278,摩根大通,2023-03-16,8440
2449,京元電子,482,216,266,摩根大通,2023-03-16,8440
8299,群聯,278,14,264,摩根大通,2023-03-16,8440
2897,王道銀行,282,25,257,摩根大通,2023-03-16,8440
2454,聯發科,338,81,257,摩根大通,2023-03-16,8440
2376,技嘉,331,79,252,摩根大通,2023-03-16,8440
1314,中石化,849,604,245,摩根大通,2023-03-16,8440
3217,優群,250,8,242,摩根大通,2023-03-16,8440
4953,緯軟,239,0,239,摩根大通,2023-03-16,8440
3045,台灣大,270,33,237,摩根大通,2023-03-16,8440
1216,統一,343,111,232,摩根大通,2023-03-16,8440
2887,台新金,912,681,231,摩根大通,2023-03-16,8440
6147,頎邦,267,39,228,摩根大通,2023-03-16,8440
1326,台化,271,43,228,摩根大通,2023-03-16,8440
2748,雲品,271,44,227,摩根大通,2023-03-16,8440
1305,華夏,310,84,226,摩根大通,2023-03-16,8440
5258,虹堡,283,59,224,摩根大通,2023-03-16,8440
2453,凌群,261,40,221,摩根大通,2023-03-16,8440
4966,譜瑞-KY,217,5,212,摩根大通,2023-03-16,8440
2889,國票金,293,82,211,摩根大通,2023-03-16,8440
2409,友達,10561,2885,7676,摩根大通,2023-03-17,8440
6550,北極星藥業-KY,8667,1657,7010,摩根大通,2023-03-17,8440
2889,國票金,10270,3287,6983,摩根大通,2023-03-17,8440
2636,台驊控股,7894,1733,6161,摩根大通,2023-03-17,8440
3576,聯合再生,6109,610,5499,摩根大通,2023-03-17,8440
6443,元晶,5975,648,5327,摩根大通,2023-03-17,8440
5876,上海商銀,5451,1974,3477,摩根大通,2023-03-17,8440
8112,至上,4463,1061,3402,摩根大通,2023-03-17,8440
6770,力積電,3839,475,3364,摩根大通,2023-03-17,8440
2609,陽明,4440,1221,3219,摩根大通,2023-03-17,8440
2317,鴻海,6846,3711,3135,摩根大通,2023-03-17,8440
1101,台泥,4971,2041,2930,摩根大通,2023-03-17,8440
2455,全新,3026,213,2813,摩根大通,2023-03-17,8440
4114,健喬,3747,993,2754,摩根大通,2023-03-17,8440
6789,采鈺,2994,580,2414,摩根大通,2023-03-17,8440
6244,茂迪,2798,494,2304,摩根大通,2023-03-17,8440
2371,大同,3166,1115,2051,摩根大通,2023-03-17,8440
2618,長榮航,3339,1310,2029,摩根大通,2023-03-17,8440
6472,保瑞,2524,527,1997,摩根大通,2023-03-17,8440
2303,聯電,8934,6951,1983,摩根大通,2023-03-17,8440
2885,元大金,3451,1553,1898,摩根大通,2023-03-17,8440
3056,富華新,2252,417,1835,摩根大通,2023-03-17,8440
8016,矽創,2439,610,1829,摩根大通,2023-03-17,8440
6005,群益證,2123,393,1730,摩根大通,2023-03-17,8440
5347,世界,1917,275,1642,摩根大通,2023-03-17,8440
9904,寶成,2715,1091,1624,摩根大通,2023-03-17,8440
2610,華航,3283,1724,1559,摩根大通,2023-03-17,8440
2353,宏��,6436,5081,1355,摩根大通,2023-03-17,8440
0056,元大高股息,1329,0,1329,摩根大通,2023-03-17,8440
2330,台積電,3937,2636,1301,摩根大通,2023-03-17,8440
8996,高力,1307,8,1299,摩根大通,2023-03-17,8440
3034,聯詠,1703,457,1246,摩根大通,2023-03-17,8440
2457,飛宏,2371,1181,1190,摩根大通,2023-03-17,8440
2603,長榮,1626,479,1147,摩根大通,2023-03-17,8440
3027,盛達,1610,492,1118,摩根大通,2023-03-17,8440
3035,智原,1062,201,861,摩根大通,2023-03-17,8440
1522,堤維西,903,132,771,摩根大通,2023-03-17,8440
2504,國產,985,224,761,摩根大通,2023-03-17,8440
2449,京元電子,1545,826,719,摩根大通,2023-03-17,8440
4958,臻鼎-KY,988,308,680,摩根大通,2023-03-17,8440
2454,聯發科,1010,336,674,摩根大通,2023-03-17,8440
2357,華碩,1426,771,655,摩根大通,2023-03-17,8440
3264,欣銓,706,89,617,摩根大通,2023-03-17,8440
1760,寶齡富錦,829,231,598,摩根大通,2023-03-17,8440
5009,榮剛,1057,468,589,摩根大通,2023-03-17,8440
2451,創見,572,16,556,摩根大通,2023-03-17,8440
6469,大樹,876,324,552,摩根大通,2023-03-17,8440
2344,華邦電,3142,2614,528,摩根大通,2023-03-17,8440
6121,新普,719,196,523,摩根大通,2023-03-17,8440
3691,碩禾,625,121,504,摩根大通,2023-03-17,8440
2891,中信金,4002,1007,2995,摩根大通,2023-03-20,8440
2338,光罩,1987,57,1930,摩根大通,2023-03-20,8440
3481,群創,1634,238,1396,摩根大通,2023-03-20,8440
6244,茂迪,3017,1645,1372,摩根大通,2023-03-20,8440
6005,群益證,1567,202,1365,摩根大通,2023-03-20,8440
2867,三商壽,1652,294,1358,摩根大通,2023-03-20,8440
2885,元大金,1431,301,1130,摩根大通,2023-03-20,8440
3711,日月光投控,1059,32,1027,摩根大通,2023-03-20,8440
1529,樂事綠能,1298,273,1025,摩根大通,2023-03-20,8440
2457,飛宏,1778,784,994,摩根大通,2023-03-20,8440
2324,仁寶,1006,137,869,摩根大通,2023-03-20,8440
3231,緯創,1225,379,846,摩根大通,2023-03-20,8440
2330,台積電,707,73,634,摩根大通,2023-03-20,8440
2498,宏達電,631,3,628,摩根大通,2023-03-20,8440
9945,潤泰新,1563,964,599,摩根大通,2023-03-20,8440
8358,金居,576,3,573,摩根大通,2023-03-20,8440
2327,國巨,559,3,556,摩根大通,2023-03-20,8440
6235,華孚,918,365,553,摩根大通,2023-03-20,8440
3017,奇鋐,614,78,536,摩根大通,2023-03-20,8440
6531,愛普*,672,157,515,摩根大通,2023-03-20,8440
1589,永冠-KY,608,101,507,摩根大通,2023-03-20,8440
8436,大江,435,29,406,摩根大通,2023-03-20,8440
2201,裕隆,401,18,383,摩根大通,2023-03-20,8440
2308,台達電,364,25,339,摩根大通,2023-03-20,8440
6182,合晶,336,2,334,摩根大通,2023-03-20,8440
8171,天宇,334,9,325,摩根大通,2023-03-20,8440
1522,堤維西,518,235,283,摩根大通,2023-03-20,8440
6550,北極星藥業-KY,277,0,277,摩根大通,2023-03-20,8440
2890,永豐金,941,667,274,摩根大通,2023-03-20,8440
3236,千如,277,24,253,摩根大通,2023-03-20,8440
3324,雙鴻,274,23,251,摩根大通,2023-03-20,8440
3576,聯合再生,339,89,250,摩根大通,2023-03-20,8440
2356,英業達,375,132,243,摩根大通,2023-03-20,8440
3047,訊舟,240,0,240,摩根大通,2023-03-20,8440
5425,台半,269,31,238,摩根大通,2023-03-20,8440
3264,欣銓,255,25,230,摩根大通,2023-03-20,8440
1314,中石化,244,16,228,摩根大通,2023-03-20,8440
1785,光洋科,223,10,213,摩根大通,2023-03-20,8440
3046,建��,311,104,207,摩根大通,2023-03-20,8440
3661,世芯-KY,301,117,184,摩根大通,2023-03-20,8440
2401,凌陽,187,4,183,摩根大通,2023-03-20,8440
6191,精成科,196,13,183,摩根大通,2023-03-20,8440
5340,建榮,185,3,182,摩根大通,2023-03-20,8440
2748,雲品,391,212,179,摩根大通,2023-03-20,8440
2354,鴻準,260,81,179,摩根大通,2023-03-20,8440
2486,一詮,198,21,177,摩根大通,2023-03-20,8440
8936,國統,393,216,177,摩根大通,2023-03-20,8440
3029,零壹,324,150,174,摩根大通,2023-03-20,8440
2409,友達,243,71,172,摩根大通,2023-03-20,8440
3691,碩禾,162,10,152,摩根大通,2023-03-20,8440
3231,緯創,5944,1893,4051,摩根大通,2023-03-21,8440
2882,國泰金,3311,359,2952,摩根大通,2023-03-21,8440
2867,三商壽,2559,146,2413,摩根大通,2023-03-21,8440
3037,欣興,1771,186,1585,摩根大通,2023-03-21,8440
2353,宏��,1635,421,1214,摩根大通,2023-03-21,8440
4938,和碩,1217,92,1125,摩根大通,2023-03-21,8440
2324,仁寶,1203,101,1102,摩根大通,2023-03-21,8440
6244,茂迪,2003,1009,994,摩根大通,2023-03-21,8440
1584,精剛,1043,134,909,摩根大通,2023-03-21,8440
3013,晟銘電,892,80,812,摩根大通,2023-03-21,8440
1513,中興電,935,211,724,摩根大通,2023-03-21,8440
1514,亞力,754,91,663,摩根大通,2023-03-21,8440
2204,中華,839,198,641,摩根大通,2023-03-21,8440
6282,康舒,851,236,615,摩根大通,2023-03-21,8440
3324,雙鴻,646,48,598,摩根大通,2023-03-21,8440
3162,精確,968,371,597,摩根大通,2023-03-21,8440
2359,所羅門,690,95,595,摩根大通,2023-03-21,8440
2303,聯電,1494,914,580,摩根大通,2023-03-21,8440
2409,友達,1473,899,574,摩根大通,2023-03-21,8440
6223,旺矽,573,12,561,摩根大通,2023-03-21,8440
2402,毅嘉,762,235,527,摩根大通,2023-03-21,8440
3017,奇鋐,690,192,498,摩根大通,2023-03-21,8440
8112,至上,552,63,489,摩根大通,2023-03-21,8440
1467,南緯,612,144,468,摩根大通,2023-03-21,8440
2345,智邦,726,260,466,摩根大通,2023-03-21,8440
8926,台汽電,714,250,464,摩根大通,2023-03-21,8440
1522,堤維西,563,103,460,摩根大通,2023-03-21,8440
2888,新光金,1956,1525,431,摩根大通,2023-03-21,8440
4958,臻鼎-KY,465,41,424,摩根大通,2023-03-21,8440
2892,第一金,504,81,423,摩根大通,2023-03-21,8440
4934,太極,759,343,416,摩根大通,2023-03-21,8440
5876,上海商銀,456,73,383,摩根大通,2023-03-21,8440
3322,建舜電,395,14,381,摩根大通,2023-03-21,8440
1524,耿鼎,510,131,379,摩根大通,2023-03-21,8440
6120,達運,462,94,368,摩根大通,2023-03-21,8440
1589,永冠-KY,581,216,365,摩根大通,2023-03-21,8440
2897,王道銀行,480,123,357,摩根大通,2023-03-21,8440
1519,華城,524,176,348,摩根大通,2023-03-21,8440
9945,潤泰新,1311,966,345,摩根大通,2023-03-21,8440
2845,遠東銀,402,62,340,摩根大通,2023-03-21,8440
6005,群益證,437,112,325,摩根大通,2023-03-21,8440
3236,千如,355,51,304,摩根大通,2023-03-21,8440
5353,台林,503,202,301,摩根大通,2023-03-21,8440
2886,兆豐金,616,317,299,摩根大通,2023-03-21,8440
3078,僑威,301,6,295,摩根大通,2023-03-21,8440
3047,訊舟,310,20,290,摩根大通,2023-03-21,8440
2368,金像電,286,1,285,摩根大通,2023-03-21,8440
3011,今皓,399,119,280,摩根大通,2023-03-21,8440
2484,希華,288,10,278,摩根大通,2023-03-21,8440
2201,裕隆,649,375,274,摩根大通,2023-03-21,8440
2330,台積電,9438,629,8809,摩根大通,2023-03-22,8440
3231,緯創,6146,1460,4686,摩根大通,2023-03-22,8440
2890,永豐金,1945,155,1790,摩根大通,2023-03-22,8440
2324,仁寶,1693,64,1629,摩根大通,2023-03-22,8440
2402,毅嘉,1957,349,1608,摩根大通,2023-03-22,8440
2884,玉山金,1305,147,1158,摩根大通,2023-03-22,8440
2356,英業達,2371,1241,1130,摩根大通,2023-03-22,8440
8478,東哥遊艇,1230,138,1092,摩根大通,2023-03-22,8440
2867,三商壽,1502,540,962,摩根大通,2023-03-22,8440
6005,群益證,842,46,796,摩根大通,2023-03-22,8440
2368,金像電,920,136,784,摩根大通,2023-03-22,8440
3711,日月光投控,971,236,735,摩根大通,2023-03-22,8440
2462,良得電,668,0,668,摩根大通,2023-03-22,8440
1522,堤維西,730,64,666,摩根大通,2023-03-22,8440
5880,合庫金,1359,705,654,摩根大通,2023-03-22,8440
4960,誠美材,641,10,631,摩根大通,2023-03-22,8440
1524,耿鼎,1077,451,626,摩根大通,2023-03-22,8440
2886,兆豐金,860,290,570,摩根大通,2023-03-22,8440
2887,台新金,736,204,532,摩根大通,2023-03-22,8440
1504,東元,868,341,527,摩根大通,2023-03-22,8440
2455,全新,509,18,491,摩根大通,2023-03-22,8440
3059,華晶科,582,98,484,摩根大通,2023-03-22,8440
2482,連宇,1844,1401,443,摩根大通,2023-03-22,8440
3715,定穎投控,866,427,439,摩根大通,2023-03-22,8440
2615,萬海,503,76,427,摩根大通,2023-03-22,8440
3217,優群,514,100,414,摩根大通,2023-03-22,8440
3356,奇偶,416,23,393,摩根大通,2023-03-22,8440
2355,敬鵬,337,0,337,摩根大通,2023-03-22,8440
3260,威剛,339,4,335,摩根大通,2023-03-22,8440
3479,安勤,409,76,333,摩根大通,2023-03-22,8440
2387,精元,394,71,323,摩根大通,2023-03-22,8440
2303,聯電,1520,1197,323,摩根大通,2023-03-22,8440
1314,中石化,683,372,311,摩根大通,2023-03-22,8440
2412,中華電,363,53,310,摩根大通,2023-03-22,8440
3710,連展投控,382,81,301,摩根大通,2023-03-22,8440
2485,兆赫,284,0,284,摩根大通,2023-03-22,8440
1709,和益,313,30,283,摩根大通,2023-03-22,8440
3592,瑞鼎,321,42,279,摩根大通,2023-03-22,8440
6121,新普,269,0,269,摩根大通,2023-03-22,8440
2105,正新,317,54,263,摩根大通,2023-03-22,8440
1326,台化,280,20,260,摩根大通,2023-03-22,8440
6244,茂迪,695,438,257,摩根大通,2023-03-22,8440
3714,富采,312,55,257,摩根大通,2023-03-22,8440
6741,91APP*-KY,260,8,252,摩根大通,2023-03-22,8440
2353,宏��,1416,1165,251,摩根大通,2023-03-22,8440
3027,盛達,347,103,244,摩根大通,2023-03-22,8440
2520,冠德,240,0,240,摩根大通,2023-03-22,8440
3045,台灣大,396,161,235,摩根大通,2023-03-22,8440
2891,中信金,809,576,233,摩根大通,2023-03-22,8440
2376,技嘉,258,25,233,摩根大通,2023-03-22,8440
2324,仁寶,3684,277,3407,摩根大通,2023-03-23,8440
3231,緯創,4345,1818,2527,摩根大通,2023-03-23,8440
2884,玉山金,2279,200,2079,摩根大通,2023-03-23,8440
1504,東元,2192,302,1890,摩根大通,2023-03-23,8440
2402,毅嘉,3720,1909,1811,摩根大通,2023-03-23,8440
2885,元大金,1610,17,1593,摩根大通,2023-03-23,8440
2882,國泰金,1615,180,1435,摩根大通,2023-03-23,8440
2890,永豐金,1067,42,1025,摩根大通,2023-03-23,8440
6143,振曜,1282,262,1020,摩根大通,2023-03-23,8440
2382,廣達,1012,95,917,摩根大通,2023-03-23,8440
2887,台新金,971,143,828,摩根大通,2023-03-23,8440
6005,群益證,822,34,788,摩根大通,2023-03-23,8440
3711,日月光投控,861,98,763,摩根大通,2023-03-23,8440
3047,訊舟,796,49,747,摩根大通,2023-03-23,8440
3022,威強電,725,6,719,摩根大通,2023-03-23,8440
2002,中鋼,837,214,623,摩根大通,2023-03-23,8440
3005,神基,576,59,517,摩根大通,2023-03-23,8440
1303,南亞,479,12,467,摩根大通,2023-03-23,8440
3481,群創,986,542,444,摩根大通,2023-03-23,8440
3260,威剛,591,148,443,摩根大通,2023-03-23,8440
2412,中華電,476,57,419,摩根大通,2023-03-23,8440
2353,宏��,714,297,417,摩根大通,2023-03-23,8440
2421,建準,426,23,403,摩根大通,2023-03-23,8440
2892,第一金,840,447,393,摩根大通,2023-03-23,8440
4919,新唐,459,74,385,摩根大通,2023-03-23,8440
4147,中裕,483,98,385,摩根大通,2023-03-23,8440
1605,華新,411,30,381,摩根大通,2023-03-23,8440
6160,欣技,550,179,371,摩根大通,2023-03-23,8440
3056,富華新,446,78,368,摩根大通,2023-03-23,8440
2889,國票金,1334,981,353,摩根大通,2023-03-23,8440
2497,怡利電,353,0,353,摩根大通,2023-03-23,8440
2845,遠東銀,381,41,340,摩根大通,2023-03-23,8440
3045,台灣大,370,45,325,摩根大通,2023-03-23,8440
2485,兆赫,322,0,322,摩根大通,2023-03-23,8440
6122,擎邦,396,85,311,摩根大通,2023-03-23,8440
3419,譁裕,299,0,299,摩根大通,2023-03-23,8440
5475,德宏,320,23,297,摩根大通,2023-03-23,8440
2301,光寶科,383,93,290,摩根大通,2023-03-23,8440
9958,世紀鋼,293,4,289,摩根大通,2023-03-23,8440
6176,瑞儀,297,13,284,摩根大通,2023-03-23,8440
2014,中鴻,285,10,275,摩根大通,2023-03-23,8440
2515,中工,283,9,274,摩根大通,2023-03-23,8440
2834,臺企銀,431,158,273,摩根大通,2023-03-23,8440
2368,金像電,410,147,263,摩根大通,2023-03-23,8440
1216,統一,260,11,249,摩根大通,2023-03-23,8440
4938,和碩,250,8,242,摩根大通,2023-03-23,8440
2330,台積電,2063,1822,241,摩根大通,2023-03-23,8440
2340,台亞,241,1,240,摩根大通,2023-03-23,8440
3653,健策,269,31,238,摩根大通,2023-03-23,8440
2357,華碩,240,4,236,摩根大通,2023-03-23,8440
2303,聯電,5167,289,4878,摩根大通,2023-03-24,8440
2317,鴻海,5354,833,4521,摩根大通,2023-03-24,8440
3231,緯創,6934,2859,4075,摩根大通,2023-03-24,8440
3714,富采,2647,164,2483,摩根大通,2023-03-24,8440
2344,華邦電,3043,794,2249,摩根大通,2023-03-24,8440
2409,友達,2105,232,1873,摩根大通,2023-03-24,8440
3481,群創,1834,16,1818,摩根大通,2023-03-24,8440
2330,台積電,2673,1027,1646,摩根大通,2023-03-24,8440
3037,欣興,2027,528,1499,摩根大通,2023-03-24,8440
2402,毅嘉,2350,1175,1175,摩根大通,2023-03-24,8440
2308,台達電,1035,34,1001,摩根大通,2023-03-24,8440
3711,日月光投控,968,65,903,摩根大通,2023-03-24,8440
4147,中裕,942,157,785,摩根大通,2023-03-24,8440
1504,東元,1792,1012,780,摩根大通,2023-03-24,8440
2382,廣達,1357,591,766,摩根大通,2023-03-24,8440
2890,永豐金,1683,939,744,摩根大通,2023-03-24,8440
6770,力積電,729,59,670,摩根大通,2023-03-24,8440
3704,合勤控,675,28,647,摩根大通,2023-03-24,8440
6188,廣明,643,18,625,摩根大通,2023-03-24,8440
8299,群聯,618,0,618,摩根大通,2023-03-24,8440
2332,友訊,668,60,608,摩根大通,2023-03-24,8440
2354,鴻準,656,73,583,摩根大通,2023-03-24,8440
2353,宏��,1316,741,575,摩根大通,2023-03-24,8440
2408,南亞科,1558,1024,534,摩根大通,2023-03-24,8440
1605,華新,877,345,532,摩根大通,2023-03-24,8440
1301,台塑,529,8,521,摩根大通,2023-03-24,8440
2377,微星,537,29,508,摩根大通,2023-03-24,8440
1216,統一,650,152,498,摩根大通,2023-03-24,8440
3035,智原,729,264,465,摩根大通,2023-03-24,8440
2349,錸德,441,11,430,摩根大通,2023-03-24,8440
2301,光寶科,726,311,415,摩根大通,2023-03-24,8440
2379,瑞昱,523,115,408,摩根大通,2023-03-24,8440
2313,華通,405,10,395,摩根大通,2023-03-24,8440
2356,英業達,1127,734,393,摩根大通,2023-03-24,8440
4743,合一,396,14,382,摩根大通,2023-03-24,8440
3380,明泰,397,23,374,摩根大通,2023-03-24,8440
3051,力特,501,135,366,摩根大通,2023-03-24,8440
6269,台郡,421,56,365,摩根大通,2023-03-24,8440
3088,艾訊,373,26,347,摩根大通,2023-03-24,8440
4906,正文,390,49,341,摩根大通,2023-03-24,8440
6202,盛群,376,38,338,摩根大通,2023-03-24,8440
3081,聯亞,465,135,330,摩根大通,2023-03-24,8440
2208,台船,422,95,327,摩根大通,2023-03-24,8440
2633,台灣高鐵,325,4,321,摩根大通,2023-03-24,8440
3049,精金,314,0,314,摩根大通,2023-03-24,8440
6472,保瑞,483,169,314,摩根大通,2023-03-24,8440
2355,敬鵬,313,0,313,摩根大通,2023-03-24,8440
3017,奇鋐,417,131,286,摩根大通,2023-03-24,8440
2324,仁寶,1726,1441,285,摩根大通,2023-03-24,8440
8478,東哥遊艇,327,54,273,摩根大通,2023-03-24,8440
2324,仁寶,3042,387,2655,摩根大通,2023-03-27,8440
2888,新光金,2006,0,2006,摩根大通,2023-03-27,8440
2330,台積電,2405,448,1957,摩根大通,2023-03-27,8440
3481,群創,1524,26,1498,摩根大通,2023-03-27,8440
2356,英業達,1559,179,1380,摩根大通,2023-03-27,8440
2353,宏��,1252,241,1011,摩根大通,2023-03-27,8440
2301,光寶科,958,42,916,摩根大通,2023-03-27,8440
2637,慧洋-KY,887,9,878,摩根大通,2023-03-27,8440
3037,欣興,945,124,821,摩根大通,2023-03-27,8440
8033,雷虎,754,14,740,摩根大通,2023-03-27,8440
2834,臺企銀,692,29,663,摩根大通,2023-03-27,8440
2409,友達,648,50,598,摩根大通,2023-03-27,8440
2885,元大金,637,77,560,摩根大通,2023-03-27,8440
2313,華通,598,79,519,摩根大通,2023-03-27,8440
2317,鴻海,1243,728,515,摩根大通,2023-03-27,8440
2412,中華電,516,8,508,摩根大通,2023-03-27,8440
1907,永豐餘,492,0,492,摩根大通,2023-03-27,8440
4128,中天,488,0,488,摩根大通,2023-03-27,8440
4746,台耀,488,1,487,摩根大通,2023-03-27,8440
1609,大亞,1093,608,485,摩根大通,2023-03-27,8440
1513,中興電,488,40,448,摩根大通,2023-03-27,8440
1584,精剛,1439,998,441,摩根大通,2023-03-27,8440
8255,朋程,454,46,408,摩根大通,2023-03-27,8440
8112,至上,431,25,406,摩根大通,2023-03-27,8440
2312,金寶,386,0,386,摩根大通,2023-03-27,8440
2890,永豐金,527,162,365,摩根大通,2023-03-27,8440
6285,啟��,393,31,362,摩根大通,2023-03-27,8440
6147,頎邦,425,69,356,摩根大通,2023-03-27,8440
6290,良維,336,2,334,摩根大通,2023-03-27,8440
4915,致伸,338,11,327,摩根大通,2023-03-27,8440
4906,正文,324,11,313,摩根大通,2023-03-27,8440
1342,八貫,661,350,311,摩根大通,2023-03-27,8440
2367,燿華,338,27,311,摩根大通,2023-03-27,8440
2603,長榮,378,68,310,摩根大通,2023-03-27,8440
6550,北極星藥業-KY,311,7,304,摩根大通,2023-03-27,8440
2349,錸德,319,18,301,摩根大通,2023-03-27,8440
2354,鴻準,344,44,300,摩根大通,2023-03-27,8440
2368,金像電,299,5,294,摩根大通,2023-03-27,8440
6005,群益證,285,0,285,摩根大通,2023-03-27,8440
2351,順德,287,15,272,摩根大通,2023-03-27,8440
2340,台亞,566,300,266,摩根大通,2023-03-27,8440
4938,和碩,265,4,261,摩根大通,2023-03-27,8440
1312,國喬,262,1,261,摩根大通,2023-03-27,8440
2633,台灣高鐵,257,0,257,摩根大通,2023-03-27,8440
2887,台新金,335,81,254,摩根大通,2023-03-27,8440
8086,宏捷科,348,96,252,摩根大通,2023-03-27,8440
2606,裕民,275,28,247,摩根大通,2023-03-27,8440
4541,晟田,329,87,242,摩根大通,2023-03-27,8440
1217,愛之味,237,0,237,摩根大通,2023-03-27,8440
6220,岳豐,225,0,225,摩根大通,2023-03-27,8440
2356,英業達,4244,556,3688,摩根大通,2023-03-28,8440
2888,新光金,2905,9,2896,摩根大通,2023-03-28,8440
2301,光寶科,3145,522,2623,摩根大通,2023-03-28,8440
3231,緯創,5109,2644,2465,摩根大通,2023-03-28,8440
3481,群創,2333,854,1479,摩根大通,2023-03-28,8440
2002,中鋼,3305,2074,1231,摩根大通,2023-03-28,8440
2610,華航,1041,79,962,摩根大通,2023-03-28,8440
4904,遠傳,1008,186,822,摩根大通,2023-03-28,8440
5009,榮剛,1194,403,791,摩根大通,2023-03-28,8440
1513,中興電,1077,294,783,摩根大通,2023-03-28,8440
2376,技嘉,1103,325,778,摩根大通,2023-03-28,8440
1216,統一,870,151,719,摩根大通,2023-03-28,8440
6188,廣明,715,20,695,摩根大通,2023-03-28,8440
2353,宏��,1235,580,655,摩根大通,2023-03-28,8440
2882,國泰金,726,71,655,摩根大通,2023-03-28,8440
2352,佳世達,736,97,639,摩根大通,2023-03-28,8440
4906,正文,621,23,598,摩根大通,2023-03-28,8440
8046,南電,718,138,580,摩根大通,2023-03-28,8440
4938,和碩,643,171,472,摩根大通,2023-03-28,8440
6147,頎邦,537,72,465,摩根大通,2023-03-28,8440
6191,精成科,501,39,462,摩根大通,2023-03-28,8440
3105,穩懋,681,225,456,摩根大通,2023-03-28,8440
1319,東陽,461,13,448,摩根大通,2023-03-28,8440
4128,中天,471,31,440,摩根大通,2023-03-28,8440
1301,台塑,492,69,423,摩根大通,2023-03-28,8440
5371,中光電,434,12,422,摩根大通,2023-03-28,8440
2890,永豐金,481,62,419,摩根大通,2023-03-28,8440
2812,台中銀,400,0,400,摩根大通,2023-03-28,8440
6282,康舒,441,42,399,摩根大通,2023-03-28,8440
2731,雄獅,430,35,395,摩根大通,2023-03-28,8440
2449,京元電子,422,30,392,摩根大通,2023-03-28,8440
2457,飛宏,463,92,371,摩根大通,2023-03-28,8440
2412,中華電,494,127,367,摩根大通,2023-03-28,8440
2367,燿華,378,13,365,摩根大通,2023-03-28,8440
6257,矽格,476,121,355,摩根大通,2023-03-28,8440
2892,第一金,981,626,355,摩根大通,2023-03-28,8440
2867,三商壽,1044,698,346,摩根大通,2023-03-28,8440
9907,統一實,347,8,339,摩根大通,2023-03-28,8440
3380,明泰,451,114,337,摩根大通,2023-03-28,8440
2313,華通,377,41,336,摩根大通,2023-03-28,8440
3005,神基,391,61,330,摩根大通,2023-03-28,8440
1718,中纖,365,37,328,摩根大通,2023-03-28,8440
2880,華南金,395,67,328,摩根大通,2023-03-28,8440
2897,王道銀行,320,0,320,摩根大通,2023-03-28,8440
3024,憶聲,316,4,312,摩根大通,2023-03-28,8440
8171,天宇,317,8,309,摩根大通,2023-03-28,8440
2883,凱基金,1060,765,295,摩根大通,2023-03-28,8440
6488,環球晶,333,52,281,摩根大通,2023-03-28,8440
3545,敦泰,334,55,279,摩根大通,2023-03-28,8440
6244,茂迪,463,190,273,摩根大通,2023-03-28,8440
1504,東元,6406,1191,5215,摩根大通,2023-03-29,8440
3231,緯創,4843,982,3861,摩根大通,2023-03-29,8440
2330,台積電,4278,1355,2923,摩根大通,2023-03-29,8440
2610,華航,3005,123,2882,摩根大通,2023-03-29,8440
2353,宏��,2850,472,2378,摩根大通,2023-03-29,8440
2356,英業達,3431,1267,2164,摩根大通,2023-03-29,8440
2324,仁寶,2361,290,2071,摩根大通,2023-03-29,8440
2882,國泰金,2629,664,1965,摩根大通,2023-03-29,8440
2892,第一金,2250,516,1734,摩根大通,2023-03-29,8440
2354,鴻準,1950,272,1678,摩根大通,2023-03-29,8440
2888,新光金,3248,1583,1665,摩根大通,2023-03-29,8440
2409,友達,2467,924,1543,摩根大通,2023-03-29,8440
2883,凱基金,2737,1287,1450,摩根大通,2023-03-29,8440
1609,大亞,1526,161,1365,摩根大通,2023-03-29,8440
1216,統一,1857,497,1360,摩根大通,2023-03-29,8440
3481,群創,1986,708,1278,摩根大通,2023-03-29,8440
2301,光寶科,1429,172,1257,摩根大通,2023-03-29,8440
2731,雄獅,1289,73,1216,摩根大通,2023-03-29,8440
2890,永豐金,1911,733,1178,摩根大通,2023-03-29,8440
2884,玉山金,1878,736,1142,摩根大通,2023-03-29,8440
2412,中華電,1302,236,1066,摩根大通,2023-03-29,8440
2382,廣達,1438,375,1063,摩根大通,2023-03-29,8440
9945,潤泰新,1182,191,991,摩根大通,2023-03-29,8440
3005,神基,1289,320,969,摩根大通,2023-03-29,8440
2317,鴻海,2287,1337,950,摩根大通,2023-03-29,8440
1319,東陽,947,8,939,摩根大通,2023-03-29,8440
5009,榮剛,948,13,935,摩根大通,2023-03-29,8440
4114,健喬,925,7,918,摩根大通,2023-03-29,8440
5388,中磊,1119,233,886,摩根大通,2023-03-29,8440
4904,遠傳,1061,201,860,摩根大通,2023-03-29,8440
4977,眾達-KY,968,127,841,摩根大通,2023-03-29,8440
3037,欣興,1098,312,786,摩根大通,2023-03-29,8440
4938,和碩,827,83,744,摩根大通,2023-03-29,8440
1802,台玻,806,63,743,摩根大通,2023-03-29,8440
1513,中興電,734,14,720,摩根大通,2023-03-29,8440
2845,遠東銀,677,12,665,摩根大通,2023-03-29,8440
2889,國票金,986,330,656,摩根大通,2023-03-29,8440
2006,東和鋼鐵,751,132,619,摩根大通,2023-03-29,8440
2618,長榮航,735,141,594,摩根大通,2023-03-29,8440
5876,上海商銀,900,328,572,摩根大通,2023-03-29,8440
2633,台灣高鐵,604,71,533,摩根大通,2023-03-29,8440
2454,聯發科,721,209,512,摩根大通,2023-03-29,8440
2881,富邦金,807,331,476,摩根大通,2023-03-29,8440
4979,華星光,621,166,455,摩根大通,2023-03-29,8440
1102,亞泥,614,166,448,摩根大通,2023-03-29,8440
2504,國產,427,6,421,摩根大通,2023-03-29,8440
6269,台郡,412,2,410,摩根大通,2023-03-29,8440
2812,台中銀,412,3,409,摩根大通,2023-03-29,8440
4128,中天,407,0,407,摩根大通,2023-03-29,8440
4746,台耀,430,27,403,摩根大通,2023-03-29,8440
3037,欣興,5848,339,5509,摩根大通,2023-03-30,8440
2884,玉山金,4160,28,4132,摩根大通,2023-03-30,8440
2330,台積電,5304,2662,2642,摩根大通,2023-03-30,8440
2883,凱基金,2612,65,2547,摩根大通,2023-03-30,8440
2303,聯電,2407,213,2194,摩根大通,2023-03-30,8440
2324,仁寶,2404,247,2157,摩根大通,2023-03-30,8440
2376,技嘉,1654,61,1593,摩根大通,2023-03-30,8440
2885,元大金,1307,95,1212,摩根大通,2023-03-30,8440
2353,宏��,1387,338,1049,摩根大通,2023-03-30,8440
2892,第一金,1082,43,1039,摩根大通,2023-03-30,8440
2337,旺宏,1057,27,1030,摩根大通,2023-03-30,8440
1402,遠東新,1066,43,1023,摩根大通,2023-03-30,8440
2354,鴻準,926,48,878,摩根大通,2023-03-30,8440
2890,永豐金,1475,602,873,摩根大通,2023-03-30,8440
3711,日月光投控,1006,228,778,摩根大通,2023-03-30,8440
2889,國票金,1174,401,773,摩根大通,2023-03-30,8440
6288,聯嘉,834,69,765,摩根大通,2023-03-30,8440
2301,光寶科,788,62,726,摩根大通,2023-03-30,8440
4938,和碩,859,137,722,摩根大通,2023-03-30,8440
2886,兆豐金,694,51,643,摩根大通,2023-03-30,8440
2313,華通,699,66,633,摩根大通,2023-03-30,8440
2344,華邦電,1498,892,606,摩根大通,2023-03-30,8440
2881,富邦金,734,152,582,摩根大通,2023-03-30,8440
5880,合庫金,749,168,581,摩根大通,2023-03-30,8440
8069,元太,631,79,552,摩根大通,2023-03-30,8440
1102,亞泥,568,93,475,摩根大通,2023-03-30,8440
6147,頎邦,484,12,472,摩根大通,2023-03-30,8440
5439,高技,467,5,462,摩根大通,2023-03-30,8440
4904,遠傳,682,224,458,摩根大通,2023-03-30,8440
4906,正文,494,37,457,摩根大通,2023-03-30,8440
1301,台塑,513,59,454,摩根大通,2023-03-30,8440
1303,南亞,518,69,449,摩根大通,2023-03-30,8440
4746,台耀,508,65,443,摩根大通,2023-03-30,8440
8050,廣積,503,74,429,摩根大通,2023-03-30,8440
5309,系統電,698,285,413,摩根大通,2023-03-30,8440
2457,飛宏,798,398,400,摩根大通,2023-03-30,8440
3056,富華新,524,128,396,摩根大通,2023-03-30,8440
3005,神基,563,187,376,摩根大通,2023-03-30,8440
6239,力成,386,15,371,摩根大通,2023-03-30,8440
2880,華南金,483,133,350,摩根大通,2023-03-30,8440
2408,南亞科,926,578,348,摩根大通,2023-03-30,8440
2388,威盛,345,1,344,摩根大通,2023-03-30,8440
2903,遠百,339,0,339,摩根大通,2023-03-30,8440
2454,聯發科,443,104,339,摩根大通,2023-03-30,8440
2379,瑞昱,431,95,336,摩根大通,2023-03-30,8440
1752,南光,329,0,329,摩根大通,2023-03-30,8440
9945,潤泰新,468,141,327,摩根大通,2023-03-30,8440
2201,裕隆,325,3,322,摩根大通,2023-03-30,8440
2603,長榮,399,78,321,摩根大通,2023-03-30,8440
1326,台化,341,28,313,摩根大通,2023-03-30,8440
3481,群創,3607,358,3249,摩根大通,2023-03-31,8440
2356,英業達,3372,309,3063,摩根大通,2023-03-31,8440
2317,鴻海,3018,385,2633,摩根大通,2023-03-31,8440
2883,凱基金,2627,32,2595,摩根大通,2023-03-31,8440
2344,華邦電,3867,1343,2524,摩根大通,2023-03-31,8440
2303,聯電,2933,773,2160,摩根大通,2023-03-31,8440
2882,國泰金,2132,108,2024,摩根大通,2023-03-31,8440
2888,新光金,2221,321,1900,摩根大通,2023-03-31,8440
0050,元大台灣50,1809,0,1809,摩根大通,2023-03-31,8440
2884,玉山金,2014,270,1744,摩根大通,2023-03-31,8440
2353,宏��,1606,165,1441,摩根大通,2023-03-31,8440
6235,華孚,1967,551,1416,摩根大通,2023-03-31,8440
1303,南亞,1356,23,1333,摩根大通,2023-03-31,8440
2892,第一金,1314,13,1301,摩根大通,2023-03-31,8440
3711,日月光投控,1954,731,1223,摩根大通,2023-03-31,8440
2618,長榮航,1433,229,1204,摩根大通,2023-03-31,8440
2324,仁寶,1757,601,1156,摩根大通,2023-03-31,8440
3231,緯創,2187,1199,988,摩根大通,2023-03-31,8440
2880,華南金,1082,94,988,摩根大通,2023-03-31,8440
4938,和碩,1038,69,969,摩根大通,2023-03-31,8440
2886,兆豐金,902,5,897,摩根大通,2023-03-31,8440
5880,合庫金,875,8,867,摩根大通,2023-03-31,8440
2354,鴻準,860,1,859,摩根大通,2023-03-31,8440
2885,元大金,911,120,791,摩根大通,2023-03-31,8440
5347,世界,749,17,732,摩根大通,2023-03-31,8440
6147,頎邦,725,2,723,摩根大通,2023-03-31,8440
8150,南茂,1013,308,705,摩根大通,2023-03-31,8440
2376,技嘉,718,35,683,摩根大通,2023-03-31,8440
1504,東元,936,270,666,摩根大通,2023-03-31,8440
3034,聯詠,776,150,626,摩根大通,2023-03-31,8440
6548,長科*,733,109,624,摩根大通,2023-03-31,8440
3479,安勤,790,213,577,摩根大通,2023-03-31,8440
2337,旺宏,1509,935,574,摩根大通,2023-03-31,8440
1710,東聯,628,54,574,摩根大通,2023-03-31,8440
9907,統一實,670,111,559,摩根大通,2023-03-31,8440
2301,光寶科,627,94,533,摩根大通,2023-03-31,8440
1101,台泥,781,248,533,摩根大通,2023-03-31,8440
2633,台灣高鐵,534,9,525,摩根大通,2023-03-31,8440
2454,聯發科,675,153,522,摩根大通,2023-03-31,8440
2887,台新金,2475,1961,514,摩根大通,2023-03-31,8440
3260,威剛,773,272,501,摩根大通,2023-03-31,8440
3056,富華新,603,103,500,摩根大通,2023-03-31,8440
2388,威盛,581,86,495,摩根大通,2023-03-31,8440
2105,正新,580,120,460,摩根大通,2023-03-31,8440
1301,台塑,602,146,456,摩根大通,2023-03-31,8440
2890,永豐金,817,372,445,摩根大通,2023-03-31,8440
2881,富邦金,542,98,444,摩根大通,2023-03-31,8440
4968,立積,458,14,444,摩根大通,2023-03-31,8440
2897,王道銀行,447,7,440,摩根大通,2023-03-31,8440
2474,可成,468,46,422,摩根大通,2023-03-31,8440
2834,臺企銀,3951,218,3733,摩根大通,2023-04-06,8440
2888,新光金,3873,146,3727,摩根大通,2023-04-06,8440
2330,台積電,4511,1435,3076,摩根大通,2023-04-06,8440
2352,佳世達,2313,15,2298,摩根大通,2023-04-06,8440
2356,英業達,2792,613,2179,摩根大通,2023-04-06,8440
2887,台新金,2268,115,2153,摩根大通,2023-04-06,8440
3711,日月光投控,2407,901,1506,摩根大通,2023-04-06,8440
1609,大亞,1385,45,1340,摩根大通,2023-04-06,8440
2313,華通,1371,40,1331,摩根大通,2023-04-06,8440
2845,遠東銀,1256,78,1178,摩根大通,2023-04-06,8440
2890,永豐金,1547,447,1100,摩根大通,2023-04-06,8440
2317,鴻海,1462,366,1096,摩根大通,2023-04-06,8440
2301,光寶科,1335,281,1054,摩根大通,2023-04-06,8440
4128,中天,938,4,934,摩根大通,2023-04-06,8440
4938,和碩,1003,78,925,摩根大通,2023-04-06,8440
2903,遠百,900,0,900,摩根大通,2023-04-06,8440
2892,第一金,1388,527,861,摩根大通,2023-04-06,8440
6116,彩晶,940,104,836,摩根大通,2023-04-06,8440
2883,凱基金,2257,1460,797,摩根大通,2023-04-06,8440
2498,宏達電,701,24,677,摩根大通,2023-04-06,8440
3481,群創,1406,764,642,摩根大通,2023-04-06,8440
2606,裕民,867,228,639,摩根大通,2023-04-06,8440
1513,中興電,661,35,626,摩根大通,2023-04-06,8440
2495,普安,817,192,625,摩根大通,2023-04-06,8440
2449,京元電子,875,250,625,摩根大通,2023-04-06,8440
2412,中華電,785,192,593,摩根大通,2023-04-06,8440
2882,國泰金,1035,475,560,摩根大通,2023-04-06,8440
2897,王道銀行,765,215,550,摩根大通,2023-04-06,8440
6550,北極星藥業-KY,525,22,503,摩根大通,2023-04-06,8440
6278,台表科,458,0,458,摩根大通,2023-04-06,8440
1217,愛之味,536,87,449,摩根大通,2023-04-06,8440
6142,友勁,438,4,434,摩根大通,2023-04-06,8440
4164,承業醫,516,83,433,摩根大通,2023-04-06,8440
3035,智原,425,12,413,摩根大通,2023-04-06,8440
2867,三商壽,572,169,403,摩根大通,2023-04-06,8440
1402,遠東新,616,218,398,摩根大通,2023-04-06,8440
2436,偉詮電,538,142,396,摩根大通,2023-04-06,8440
1477,聚陽,398,18,380,摩根大通,2023-04-06,8440
1760,寶齡富錦,368,4,364,摩根大通,2023-04-06,8440
2353,宏��,703,367,336,摩根大通,2023-04-06,8440
3005,神基,513,185,328,摩根大通,2023-04-06,8440
6415,矽力*-KY,338,18,320,摩根大通,2023-04-06,8440
6269,台郡,386,69,317,摩根大通,2023-04-06,8440
2457,飛宏,323,30,293,摩根大通,2023-04-06,8440
9958,世紀鋼,317,30,287,摩根大通,2023-04-06,8440
5425,台半,290,6,284,摩根大通,2023-04-06,8440
4977,眾達-KY,446,167,279,摩根大通,2023-04-06,8440
6220,岳豐,278,0,278,摩根大通,2023-04-06,8440
3046,建��,423,156,267,摩根大通,2023-04-06,8440
5465,富驊,387,121,266,摩根大通,2023-04-06,8440
2408,南亞科,5625,707,4918,摩根大通,2023-04-07,8440
2883,凱基金,3119,0,3119,摩根大通,2023-04-07,8440
2888,新光金,3076,25,3051,摩根大通,2023-04-07,8440
2882,國泰金,2993,51,2942,摩根大通,2023-04-07,8440
2603,長榮,1956,17,1939,摩根大通,2023-04-07,8440
2867,三商壽,2033,210,1823,摩根大通,2023-04-07,8440
3481,群創,1372,0,1372,摩根大通,2023-04-07,8440
3711,日月光投控,1490,188,1302,摩根大通,2023-04-07,8440
4968,立積,1232,152,1080,摩根大通,2023-04-07,8440
2206,三陽工業,1046,52,994,摩根大通,2023-04-07,8440
2337,旺宏,1357,375,982,摩根大通,2023-04-07,8440
1760,寶齡富錦,1030,53,977,摩根大通,2023-04-07,8440
2610,華航,792,73,719,摩根大通,2023-04-07,8440
2317,鴻海,697,32,665,摩根大通,2023-04-07,8440
2457,飛宏,1313,654,659,摩根大通,2023-04-07,8440
3545,敦泰,725,76,649,摩根大通,2023-04-07,8440
6116,彩晶,647,15,632,摩根大通,2023-04-07,8440
4967,十銓,1150,528,622,摩根大通,2023-04-07,8440
6477,安集,757,245,512,摩根大通,2023-04-07,8440
2881,富邦金,510,4,506,摩根大通,2023-04-07,8440
6191,精成科,489,0,489,摩根大通,2023-04-07,8440
2812,台中銀,448,0,448,摩根大通,2023-04-07,8440
2301,光寶科,501,53,448,摩根大通,2023-04-07,8440
1319,東陽,439,0,439,摩根大通,2023-04-07,8440
4977,眾達-KY,687,257,430,摩根大通,2023-04-07,8440
2606,裕民,443,25,418,摩根大通,2023-04-07,8440
2313,華通,530,112,418,摩根大通,2023-04-07,8440
6220,岳豐,403,2,401,摩根大通,2023-04-07,8440
1504,東元,696,297,399,摩根大通,2023-04-07,8440
1216,統一,407,11,396,摩根大通,2023-04-07,8440
6177,達麗,403,13,390,摩根大通,2023-04-07,8440
1308,亞聚,420,50,370,摩根大通,2023-04-07,8440
2002,中鋼,403,41,362,摩根大通,2023-04-07,8440
3034,聯詠,376,17,359,摩根大通,2023-04-07,8440
2637,慧洋-KY,376,19,357,摩根大通,2023-04-07,8440
2376,技嘉,422,68,354,摩根大通,2023-04-07,8440
2889,國票金,413,65,348,摩根大通,2023-04-07,8440
6550,北極星藥業-KY,365,27,338,摩根大通,2023-04-07,8440
2353,宏��,450,115,335,摩根大通,2023-04-07,8440
4541,晟田,373,60,313,摩根大通,2023-04-07,8440
5880,合庫金,316,18,298,摩根大通,2023-04-07,8440
2634,漢翔,425,134,291,摩根大通,2023-04-07,8440
1907,永豐餘,304,17,287,摩根大通,2023-04-07,8440
6156,松上,316,37,279,摩根大通,2023-04-07,8440
2402,毅嘉,390,114,276,摩根大通,2023-04-07,8440
6237,驊訊,294,19,275,摩根大通,2023-04-07,8440
3231,緯創,1305,1031,274,摩根大通,2023-04-07,8440
6266,泰詠,291,35,256,摩根大通,2023-04-07,8440
1710,東聯,275,29,246,摩根大通,2023-04-07,8440
2605,新興,274,35,239,摩根大通,2023-04-07,8440
1513,中興電,3552,285,3267,摩根大通,2023-04-10,8440
2883,凱基金,2898,677,2221,摩根大通,2023-04-10,8440
2603,長榮,2113,24,2089,摩根大通,2023-04-10,8440
2867,三商壽,2475,586,1889,摩根大通,2023-04-10,8440
2890,永豐金,1672,26,1646,摩根大通,2023-04-10,8440
3711,日月光投控,2033,458,1575,摩根大通,2023-04-10,8440
2882,國泰金,1297,67,1230,摩根大通,2023-04-10,8440
2301,光寶科,1281,98,1183,摩根大通,2023-04-10,8440
2888,新光金,1173,39,1134,摩根大通,2023-04-10,8440
2208,台船,1141,28,1113,摩根大通,2023-04-10,8440
3231,緯創,4239,3137,1102,摩根大通,2023-04-10,8440
9958,世紀鋼,991,92,899,摩根大通,2023-04-10,8440
2618,長榮航,764,34,730,摩根大通,2023-04-10,8440
2498,宏達電,2050,1350,700,摩根大通,2023-04-10,8440
2412,中華電,659,0,659,摩根大通,2023-04-10,8440
1101,台泥,662,25,637,摩根大通,2023-04-10,8440
2313,華通,714,92,622,摩根大通,2023-04-10,8440
5425,台半,693,101,592,摩根大通,2023-04-10,8440
1504,東元,820,250,570,摩根大通,2023-04-10,8440
2353,宏��,996,435,561,摩根大通,2023-04-10,8440
1402,遠東新,579,32,547,摩根大通,2023-04-10,8440
2368,金像電,500,0,500,摩根大通,2023-04-10,8440
2455,全新,520,40,480,摩根大通,2023-04-10,8440
1710,東聯,475,0,475,摩根大通,2023-04-10,8440
2881,富邦金,515,42,473,摩根大通,2023-04-10,8440
2492,華新科,563,94,469,摩根大通,2023-04-10,8440
3011,今皓,561,94,467,摩根大通,2023-04-10,8440
1301,台塑,446,2,444,摩根大通,2023-04-10,8440
2356,英業達,470,32,438,摩根大通,2023-04-10,8440
2880,華南金,481,92,389,摩根大通,2023-04-10,8440
3380,明泰,398,11,387,摩根大通,2023-04-10,8440
2206,三陽工業,720,337,383,摩根大通,2023-04-10,8440
3441,聯一光,473,102,371,摩根大通,2023-04-10,8440
6116,彩晶,353,1,352,摩根大通,2023-04-10,8440
2887,台新金,434,94,340,摩根大通,2023-04-10,8440
2892,第一金,393,53,340,摩根大通,2023-04-10,8440
9904,寶成,505,173,332,摩根大通,2023-04-10,8440
2352,佳世達,387,65,322,摩根大通,2023-04-10,8440
2610,華航,322,6,316,摩根大通,2023-04-10,8440
2891,中信金,878,578,300,摩根大通,2023-04-10,8440
1714,和桐,299,0,299,摩根大通,2023-04-10,8440
3037,欣興,304,8,296,摩根大通,2023-04-10,8440
3236,千如,292,0,292,摩根大通,2023-04-10,8440
6005,群益證,291,0,291,摩根大通,2023-04-10,8440
1102,亞泥,316,35,281,摩根大通,2023-04-10,8440
3049,精金,329,49,280,摩根大通,2023-04-10,8440
1218,泰山,293,21,272,摩根大通,2023-04-10,8440
8222,寶一,397,145,252,摩根大通,2023-04-10,8440
5439,高技,249,0,249,摩根大通,2023-04-10,8440
5871,中租-KY,266,23,243,摩根大通,2023-04-10,8440
2834,臺企銀,7077,740,6337,摩根大通,2023-04-11,8440
2883,凱基金,2976,82,2894,摩根大通,2023-04-11,8440
1513,中興電,3450,755,2695,摩根大通,2023-04-11,8440
2801,彰銀,2071,95,1976,摩根大通,2023-04-11,8440
2313,華通,1771,32,1739,摩根大通,2023-04-11,8440
1216,統一,1816,171,1645,摩根大通,2023-04-11,8440
2352,佳世達,1542,0,1542,摩根大通,2023-04-11,8440
2317,鴻海,1553,102,1451,摩根大通,2023-04-11,8440
2812,台中銀,1441,0,1441,摩根大通,2023-04-11,8440
2880,華南金,1380,56,1324,摩根大通,2023-04-11,8440
1303,南亞,1337,39,1298,摩根大通,2023-04-11,8440
1102,亞泥,1302,11,1291,摩根大通,2023-04-11,8440
3006,晶豪科,1360,230,1130,摩根大通,2023-04-11,8440
2892,第一金,1081,31,1050,摩根大通,2023-04-11,8440
2337,旺宏,1046,8,1038,摩根大通,2023-04-11,8440
2331,精英,1063,74,989,摩根大通,2023-04-11,8440
2206,三陽工業,1931,970,961,摩根大通,2023-04-11,8440
1301,台塑,962,41,921,摩根大通,2023-04-11,8440
9904,寶成,2380,1462,918,摩根大通,2023-04-11,8440
3715,定穎投控,939,52,887,摩根大通,2023-04-11,8440
2353,宏��,1209,350,859,摩根大通,2023-04-11,8440
2344,華邦電,1315,466,849,摩根大通,2023-04-11,8440
1402,遠東新,906,74,832,摩根大通,2023-04-11,8440
1514,亞力,1675,845,830,摩根大通,2023-04-11,8440
4960,誠美材,794,0,794,摩根大通,2023-04-11,8440
3481,群創,1472,695,777,摩根大通,2023-04-11,8440
2515,中工,775,9,766,摩根大通,2023-04-11,8440
4967,十銓,1436,688,748,摩根大通,2023-04-11,8440
2409,友達,927,205,722,摩根大通,2023-04-11,8440
3545,敦泰,849,161,688,摩根大通,2023-04-11,8440
6005,群益證,686,6,680,摩根大通,2023-04-11,8440
2886,兆豐金,759,90,669,摩根大通,2023-04-11,8440
6122,擎邦,678,15,663,摩根大通,2023-04-11,8440
6266,泰詠,1263,623,640,摩根大通,2023-04-11,8440
1907,永豐餘,619,11,608,摩根大通,2023-04-11,8440
2308,台達電,610,14,596,摩根大通,2023-04-11,8440
2324,仁寶,1119,564,555,摩根大通,2023-04-11,8440
2634,漢翔,1413,882,531,摩根大通,2023-04-11,8440
3005,神基,702,180,522,摩根大通,2023-04-11,8440
9907,統一實,514,2,512,摩根大通,2023-04-11,8440
1108,幸福,656,144,512,摩根大通,2023-04-11,8440
2368,金像電,707,201,506,摩根大通,2023-04-11,8440
5351,鈺創,475,5,470,摩根大通,2023-04-11,8440
8088,品安,584,115,469,摩根大通,2023-04-11,8440
3034,聯詠,480,26,454,摩根大通,2023-04-11,8440
4306,炎洲,440,0,440,摩根大通,2023-04-11,8440
6278,台表科,447,12,435,摩根大通,2023-04-11,8440
3025,星通,517,85,432,摩根大通,2023-04-11,8440
1710,東聯,428,0,428,摩根大通,2023-04-11,8440
2615,萬海,479,51,428,摩根大通,2023-04-11,8440
2883,凱基金,9153,511,8642,摩根大通,2023-04-12,8440
2002,中鋼,4453,595,3858,摩根大通,2023-04-12,8440
3231,緯創,4868,1541,3327,摩根大通,2023-04-12,8440
2867,三商壽,3384,74,3310,摩根大通,2023-04-12,8440
3711,日月光投控,3065,89,2976,摩根大通,2023-04-12,8440
2208,台船,2898,7,2891,摩根大通,2023-04-12,8440
2834,臺企銀,2999,392,2607,摩根大通,2023-04-12,8440
2353,宏��,2745,302,2443,摩根大通,2023-04-12,8440
9904,寶成,2691,266,2425,摩根大通,2023-04-12,8440
2888,新光金,3087,802,2285,摩根大通,2023-04-12,8440
2884,玉山金,2410,327,2083,摩根大通,2023-04-12,8440
2634,漢翔,2462,386,2076,摩根大通,2023-04-12,8440
2885,元大金,2109,132,1977,摩根大通,2023-04-12,8440
2891,中信金,2329,427,1902,摩根大通,2023-04-12,8440
9958,世紀鋼,2453,575,1878,摩根大通,2023-04-12,8440
2382,廣達,4631,2867,1764,摩根大通,2023-04-12,8440
1584,精剛,1764,257,1507,摩根大通,2023-04-12,8440
2892,第一金,1649,254,1395,摩根大通,2023-04-12,8440
4938,和碩,1444,58,1386,摩根大通,2023-04-12,8440
2887,台新金,1759,455,1304,摩根大通,2023-04-12,8440
2633,台灣高鐵,1218,14,1204,摩根大通,2023-04-12,8440
2603,長榮,1227,28,1199,摩根大通,2023-04-12,8440
2882,國泰金,1301,119,1182,摩根大通,2023-04-12,8440
2352,佳世達,1171,34,1137,摩根大通,2023-04-12,8440
1514,亞力,1649,512,1137,摩根大通,2023-04-12,8440
2105,正新,965,6,959,摩根大通,2023-04-12,8440
1301,台塑,910,59,851,摩根大通,2023-04-12,8440
2880,華南金,864,47,817,摩根大通,2023-04-12,8440
6770,力積電,787,30,757,摩根大通,2023-04-12,8440
1519,華城,860,116,744,摩根大通,2023-04-12,8440
2812,台中銀,680,0,680,摩根大通,2023-04-12,8440
1102,亞泥,1023,361,662,摩根大通,2023-04-12,8440
2329,華泰,1128,467,661,摩根大通,2023-04-12,8440
2347,聯強,653,37,616,摩根大通,2023-04-12,8440
2609,陽明,1252,641,611,摩根大通,2023-04-12,8440
2515,中工,2725,2140,585,摩根大通,2023-04-12,8440
2881,富邦金,1111,533,578,摩根大通,2023-04-12,8440
2368,金像電,1301,726,575,摩根大通,2023-04-12,8440
2006,東和鋼鐵,598,45,553,摩根大通,2023-04-12,8440
1312,國喬,534,9,525,摩根大通,2023-04-12,8440
4128,中天,527,4,523,摩根大通,2023-04-12,8440
2308,台達電,528,22,506,摩根大通,2023-04-12,8440
2312,金寶,555,50,505,摩根大通,2023-04-12,8440
8215,明基材,497,6,491,摩根大通,2023-04-12,8440
6142,友勁,547,61,486,摩根大通,2023-04-12,8440
2301,光寶科,1270,788,482,摩根大通,2023-04-12,8440
2323,中環,478,0,478,摩根大通,2023-04-12,8440
8222,寶一,1159,697,462,摩根大通,2023-04-12,8440
1513,中興電,1813,1354,459,摩根大通,2023-04-12,8440
5009,榮剛,994,550,444,摩根大通,2023-04-12,8440
2867,三商壽,10904,247,10657,摩根大通,2023-04-13,8440
3231,緯創,5629,1569,4060,摩根大通,2023-04-13,8440
2409,友達,11519,7792,3727,摩根大通,2023-04-13,8440
2887,台新金,3411,195,3216,摩根大通,2023-04-13,8440
2356,英業達,4021,832,3189,摩根大通,2023-04-13,8440
2610,華航,3508,842,2666,摩根大通,2023-04-13,8440
2882,國泰金,2645,4,2641,摩根大通,2023-04-13,8440
1218,泰山,2590,378,2212,摩根大通,2023-04-13,8440
2890,永豐金,2591,530,2061,摩根大通,2023-04-13,8440
6770,力積電,2890,1143,1747,摩根大通,2023-04-13,8440
9904,寶成,1845,218,1627,摩根大通,2023-04-13,8440
2888,新光金,1641,31,1610,摩根大通,2023-04-13,8440
3380,明泰,1754,282,1472,摩根大通,2023-04-13,8440
2845,遠東銀,1494,71,1423,摩根大通,2023-04-13,8440
2402,毅嘉,1952,627,1325,摩根大通,2023-04-13,8440
1314,中石化,1754,493,1261,摩根大通,2023-04-13,8440
3704,合勤控,1361,172,1189,摩根大通,2023-04-13,8440
2892,第一金,1438,372,1066,摩根大通,2023-04-13,8440
2412,中華電,1505,491,1014,摩根大通,2023-04-13,8440
2603,長榮,1073,61,1012,摩根大通,2023-04-13,8440
2313,華通,1367,370,997,摩根大通,2023-04-13,8440
6282,康舒,1201,245,956,摩根大通,2023-04-13,8440
2891,中信金,2285,1331,954,摩根大通,2023-04-13,8440
2897,王道銀行,900,0,900,摩根大通,2023-04-13,8440
2881,富邦金,1062,176,886,摩根大通,2023-04-13,8440
2324,仁寶,1094,220,874,摩根大通,2023-04-13,8440
2634,漢翔,1319,447,872,摩根大通,2023-04-13,8440
2633,台灣高鐵,831,60,771,摩根大通,2023-04-13,8440
5880,合庫金,936,214,722,摩根大通,2023-04-13,8440
2353,宏��,1040,337,703,摩根大通,2023-04-13,8440
3049,精金,679,16,663,摩根大通,2023-04-13,8440
2201,裕隆,1079,423,656,摩根大通,2023-04-13,8440
8110,華東,852,249,603,摩根大通,2023-04-13,8440
2884,玉山金,806,203,603,摩根大通,2023-04-13,8440
3022,威強電,709,134,575,摩根大通,2023-04-13,8440
2607,榮運,635,68,567,摩根大通,2023-04-13,8440
2915,潤泰全,1209,656,553,摩根大通,2023-04-13,8440
4123,晟德,525,5,520,摩根大通,2023-04-13,8440
2405,輔信,561,43,518,摩根大通,2023-04-13,8440
2413,環科,694,178,516,摩根大通,2023-04-13,8440
2834,臺企銀,515,39,476,摩根大通,2023-04-13,8440
8383,千附,620,161,459,摩根大通,2023-04-13,8440
2392,正崴,825,368,457,摩根大通,2023-04-13,8440
6605,帝寶,527,77,450,摩根大通,2023-04-13,8440
2812,台中銀,449,0,449,摩根大通,2023-04-13,8440
1752,南光,877,430,447,摩根大通,2023-04-13,8440
4979,華星光,895,457,438,摩根大通,2023-04-13,8440
3005,神基,513,77,436,摩根大通,2023-04-13,8440
3479,安勤,508,84,424,摩根大通,2023-04-13,8440
2886,兆豐金,429,9,420,摩根大通,2023-04-13,8440
3231,緯創,5866,380,5486,摩根大通,2023-04-14,8440
2317,鴻海,4295,55,4240,摩根大通,2023-04-14,8440
1605,華新,3930,64,3866,摩根大通,2023-04-14,8440
2634,漢翔,4819,1924,2895,摩根大通,2023-04-14,8440
2883,凱基金,3167,488,2679,摩根大通,2023-04-14,8440
3481,群創,4163,2108,2055,摩根大通,2023-04-14,8440
2409,友達,2253,210,2043,摩根大通,2023-04-14,8440
1529,樂事綠能,2077,483,1594,摩根大通,2023-04-14,8440
6235,華孚,2278,723,1555,摩根大通,2023-04-14,8440
2882,國泰金,1613,100,1513,摩根大通,2023-04-14,8440
2498,宏達電,1347,11,1336,摩根大通,2023-04-14,8440
2890,永豐金,1268,33,1235,摩根大通,2023-04-14,8440
2897,王道銀行,1197,0,1197,摩根大通,2023-04-14,8440
2887,台新金,1526,386,1140,摩根大通,2023-04-14,8440
2884,玉山金,1546,424,1122,摩根大通,2023-04-14,8440
2888,新光金,1182,87,1095,摩根大通,2023-04-14,8440
2892,第一金,1413,451,962,摩根大通,2023-04-14,8440
3013,晟銘電,1130,193,937,摩根大通,2023-04-14,8440
2615,萬海,992,63,929,摩根大通,2023-04-14,8440
2382,廣達,1081,184,897,摩根大通,2023-04-14,8440
2881,富邦金,952,56,896,摩根大通,2023-04-14,8440
2327,國巨,971,90,881,摩根大通,2023-04-14,8440
2801,彰銀,984,134,850,摩根大通,2023-04-14,8440
2886,兆豐金,909,80,829,摩根大通,2023-04-14,8440
2610,華航,2056,1256,800,摩根大通,2023-04-14,8440
2324,仁寶,3452,2718,734,摩根大通,2023-04-14,8440
2353,宏��,888,169,719,摩根大通,2023-04-14,8440
6806,森崴能源,1090,372,718,摩根大通,2023-04-14,8440
2308,台達電,1148,489,659,摩根大通,2023-04-14,8440
3289,宜特,805,164,641,摩根大通,2023-04-14,8440
6120,達運,618,9,609,摩根大通,2023-04-14,8440
1313,聯成,604,0,604,摩根大通,2023-04-14,8440
1101,台泥,679,83,596,摩根大通,2023-04-14,8440
4906,正文,583,8,575,摩根大通,2023-04-14,8440
3704,合勤控,573,6,567,摩根大通,2023-04-14,8440
5880,合庫金,1005,454,551,摩根大通,2023-04-14,8440
2449,京元電子,708,186,522,摩根大通,2023-04-14,8440
6176,瑞儀,798,279,519,摩根大通,2023-04-14,8440
2301,光寶科,641,123,518,摩根大通,2023-04-14,8440
6116,彩晶,605,87,518,摩根大通,2023-04-14,8440
1102,亞泥,598,100,498,摩根大通,2023-04-14,8440
1907,永豐餘,487,1,486,摩根大通,2023-04-14,8440
2377,微星,508,26,482,摩根大通,2023-04-14,8440
9105,泰金寶-DR,470,0,470,摩根大通,2023-04-14,8440
2356,英業達,1385,920,465,摩根大通,2023-04-14,8440
1301,台塑,505,47,458,摩根大通,2023-04-14,8440
6188,廣明,446,0,446,摩根大通,2023-04-14,8440
2392,正崴,435,27,408,摩根大通,2023-04-14,8440
2453,凌群,425,26,399,摩根大通,2023-04-14,8440
6547,高端疫苗,545,153,392,摩根大通,2023-04-14,8440
1605,華新,7225,736,6489,摩根大通,2023-04-17,8440
2883,凱基金,5397,391,5006,摩根大通,2023-04-17,8440
2891,中信金,2301,34,2267,摩根大通,2023-04-17,8440
2457,飛宏,2256,116,2140,摩根大通,2023-04-17,8440
2324,仁寶,4552,2513,2039,摩根大通,2023-04-17,8440
8926,台汽電,2292,301,1991,摩根大通,2023-04-17,8440
2317,鴻海,2556,670,1886,摩根大通,2023-04-17,8440
2882,國泰金,1534,30,1504,摩根大通,2023-04-17,8440
2353,宏��,1694,371,1323,摩根大通,2023-04-17,8440
2356,英業達,1583,319,1264,摩根大通,2023-04-17,8440
2887,台新金,1525,264,1261,摩根大通,2023-04-17,8440
2301,光寶科,1079,30,1049,摩根大通,2023-04-17,8440
2880,華南金,1574,603,971,摩根大通,2023-04-17,8440
2330,台積電,1677,918,759,摩根大通,2023-04-17,8440
2834,臺企銀,995,268,727,摩根大通,2023-04-17,8440
2885,元大金,775,75,700,摩根大通,2023-04-17,8440
3419,譁裕,825,125,700,摩根大通,2023-04-17,8440
9904,寶成,782,97,685,摩根大通,2023-04-17,8440
1101,台泥,884,222,662,摩根大通,2023-04-17,8440
3078,僑威,675,116,559,摩根大通,2023-04-17,8440
6443,元晶,611,55,556,摩根大通,2023-04-17,8440
3017,奇鋐,628,76,552,摩根大通,2023-04-17,8440
2890,永豐金,759,213,546,摩根大通,2023-04-17,8440
2208,台船,844,356,488,摩根大通,2023-04-17,8440
2867,三商壽,1482,1000,482,摩根大通,2023-04-17,8440
2498,宏達電,474,0,474,摩根大通,2023-04-17,8440
5880,合庫金,596,134,462,摩根大通,2023-04-17,8440
1301,台塑,473,14,459,摩根大通,2023-04-17,8440
2352,佳世達,454,2,452,摩根大通,2023-04-17,8440
2347,聯強,453,2,451,摩根大通,2023-04-17,8440
4114,健喬,513,69,444,摩根大通,2023-04-17,8440
2412,中華電,735,316,419,摩根大通,2023-04-17,8440
3005,神基,484,87,397,摩根大通,2023-04-17,8440
2201,裕隆,427,53,374,摩根大通,2023-04-17,8440
6282,康舒,552,181,371,摩根大通,2023-04-17,8440
2481,強茂,365,5,360,摩根大通,2023-04-17,8440
1312,國喬,364,17,347,摩根大通,2023-04-17,8440
8069,元太,475,133,342,摩根大通,2023-04-17,8440
2637,慧洋-KY,338,1,337,摩根大通,2023-04-17,8440
2462,良得電,336,0,336,摩根大通,2023-04-17,8440
2888,新光金,825,491,334,摩根大通,2023-04-17,8440
1608,華榮,318,0,318,摩根大通,2023-04-17,8440
1210,大成,337,27,310,摩根大通,2023-04-17,8440
6239,力成,322,23,299,摩根大通,2023-04-17,8440
9907,統一實,300,1,299,摩根大通,2023-04-17,8440
6244,茂迪,336,42,294,摩根大通,2023-04-17,8440
5452,佶優,294,12,282,摩根大通,2023-04-17,8440
8215,明基材,444,169,275,摩根大通,2023-04-17,8440
6770,力積電,267,0,267,摩根大通,2023-04-17,8440
1102,亞泥,340,73,267,摩根大通,2023-04-17,8440
2882,國泰金,4988,1310,3678,摩根大通,2023-04-18,8440
2883,凱基金,2631,236,2395,摩根大通,2023-04-18,8440
2884,玉山金,2516,137,2379,摩根大通,2023-04-18,8440
2317,鴻海,2366,691,1675,摩根大通,2023-04-18,8440
2201,裕隆,1929,370,1559,摩根大通,2023-04-18,8440
2897,王道銀行,1577,35,1542,摩根大通,2023-04-18,8440
3231,緯創,2321,787,1534,摩根大通,2023-04-18,8440
2412,中華電,2186,747,1439,摩根大通,2023-04-18,8440
2303,聯電,2499,1164,1335,摩根大通,2023-04-18,8440
2014,中鴻,1170,6,1164,摩根大通,2023-04-18,8440
2344,華邦電,1587,450,1137,摩根大通,2023-04-18,8440
2886,兆豐金,1202,129,1073,摩根大通,2023-04-18,8440
2887,台新金,1120,81,1039,摩根大通,2023-04-18,8440
2356,英業達,1207,223,984,摩根大通,2023-04-18,8440
2382,廣達,1046,81,965,摩根大通,2023-04-18,8440
3704,合勤控,1090,152,938,摩根大通,2023-04-18,8440
2885,元大金,834,0,834,摩根大通,2023-04-18,8440
2880,華南金,867,46,821,摩根大通,2023-04-18,8440
1513,中興電,825,106,719,摩根大通,2023-04-18,8440
1907,永豐餘,756,39,717,摩根大通,2023-04-18,8440
2603,長榮,1157,447,710,摩根大通,2023-04-18,8440
6719,力智,799,153,646,摩根大通,2023-04-18,8440
3576,聯合再生,644,28,616,摩根大通,2023-04-18,8440
2890,永豐金,889,298,591,摩根大通,2023-04-18,8440
6116,彩晶,646,71,575,摩根大通,2023-04-18,8440
2888,新光金,634,100,534,摩根大通,2023-04-18,8440
2353,宏��,582,70,512,摩根大通,2023-04-18,8440
6125,廣運,535,38,497,摩根大通,2023-04-18,8440
6016,康和證,483,0,483,摩根大通,2023-04-18,8440
6129,普誠,486,8,478,摩根大通,2023-04-18,8440
4977,眾達-KY,614,137,477,摩根大通,2023-04-18,8440
6770,力積電,988,515,473,摩根大通,2023-04-18,8440
2504,國產,440,0,440,摩根大通,2023-04-18,8440
8222,寶一,572,145,427,摩根大通,2023-04-18,8440
2498,宏達電,508,96,412,摩根大通,2023-04-18,8440
2723,美食-KY,435,43,392,摩根大通,2023-04-18,8440
2363,矽統,396,9,387,摩根大通,2023-04-18,8440
2402,毅嘉,527,142,385,摩根大通,2023-04-18,8440
1752,南光,407,38,369,摩根大通,2023-04-18,8440
2542,興富發,364,3,361,摩根大通,2023-04-18,8440
2313,華通,704,353,351,摩根大通,2023-04-18,8440
1301,台塑,578,234,344,摩根大通,2023-04-18,8440
1312,國喬,547,206,341,摩根大通,2023-04-18,8440
3592,瑞鼎,335,9,326,摩根大通,2023-04-18,8440
1314,中石化,401,77,324,摩根大通,2023-04-18,8440
0056,元大高股息,318,0,318,摩根大通,2023-04-18,8440
2801,彰銀,415,98,317,摩根大通,2023-04-18,8440
2330,台積電,1448,1144,304,摩根大通,2023-04-18,8440
2867,三商壽,1403,1113,290,摩根大通,2023-04-18,8440
6509,聚和,297,9,288,摩根大通,2023-04-18,8440
3231,緯創,10019,1940,8079,摩根大通,2023-04-19,8440
3704,合勤控,4877,348,4529,摩根大通,2023-04-19,8440
2324,仁寶,4913,2272,2641,摩根大通,2023-04-19,8440
2382,廣達,3174,610,2564,摩根大通,2023-04-19,8440
2353,宏��,2620,844,1776,摩根大通,2023-04-19,8440
3576,聯合再生,2002,439,1563,摩根大通,2023-04-19,8440
6806,森崴能源,2503,1099,1404,摩根大通,2023-04-19,8440
3005,神基,1444,414,1030,摩根大通,2023-04-19,8440
3481,群創,5888,4960,928,摩根大通,2023-04-19,8440
2880,華南金,2280,1379,901,摩根大通,2023-04-19,8440
6235,華孚,1271,417,854,摩根大通,2023-04-19,8440
1810,和成,1857,1052,805,摩根大通,2023-04-19,8440
2618,長榮航,1357,557,800,摩根大通,2023-04-19,8440
4114,健喬,726,20,706,摩根大通,2023-04-19,8440
4979,華星光,1271,571,700,摩根大通,2023-04-19,8440
6443,元晶,2270,1592,678,摩根大通,2023-04-19,8440
6244,茂迪,799,123,676,摩根大通,2023-04-19,8440
3260,威剛,681,26,655,摩根大通,2023-04-19,8440
5347,世界,759,146,613,摩根大通,2023-04-19,8440
2356,英業達,1707,1120,587,摩根大通,2023-04-19,8440
2308,台達電,1096,525,571,摩根大通,2023-04-19,8440
1584,精剛,602,35,567,摩根大通,2023-04-19,8440
6477,安集,910,371,539,摩根大通,2023-04-19,8440
3675,德微,528,1,527,摩根大通,2023-04-19,8440
3044,健鼎,503,17,486,摩根大通,2023-04-19,8440
4906,正文,475,11,464,摩根大通,2023-04-19,8440
1301,台塑,1204,758,446,摩根大通,2023-04-19,8440
2515,中工,733,298,435,摩根大通,2023-04-19,8440
1720,生達,634,205,429,摩根大通,2023-04-19,8440
3322,建舜電,434,5,429,摩根大通,2023-04-19,8440
1907,永豐餘,560,132,428,摩根大通,2023-04-19,8440
1417,嘉裕,496,96,400,摩根大通,2023-04-19,8440
4123,晟德,488,101,387,摩根大通,2023-04-19,8440
1304,台聚,400,49,351,摩根大通,2023-04-19,8440
2392,正崴,471,137,334,摩根大通,2023-04-19,8440
3049,精金,450,118,332,摩根大通,2023-04-19,8440
3017,奇鋐,358,27,331,摩根大通,2023-04-19,8440
1608,華榮,492,162,330,摩根大通,2023-04-19,8440
0056,元大高股息,318,0,318,摩根大通,2023-04-19,8440
6415,矽力*-KY,375,67,308,摩根大通,2023-04-19,8440
4743,合一,312,5,307,摩根大通,2023-04-19,8440
1513,中興電,456,154,302,摩根大通,2023-04-19,8440
2323,中環,325,23,302,摩根大通,2023-04-19,8440
2723,美食-KY,418,117,301,摩根大通,2023-04-19,8440
6005,群益證,856,557,299,摩根大通,2023-04-19,8440
3047,訊舟,708,411,297,摩根大通,2023-04-19,8440
6470,宇智,595,299,296,摩根大通,2023-04-19,8440
6122,擎邦,378,85,293,摩根大通,2023-04-19,8440
9919,康那香,365,73,292,摩根大通,2023-04-19,8440
6026,福邦證,320,29,291,摩根大通,2023-04-19,8440
2324,仁寶,4639,1718,2921,摩根大通,2023-04-20,8440
2356,英業達,2556,287,2269,摩根大通,2023-04-20,8440
2457,飛宏,2446,491,1955,摩根大通,2023-04-20,8440
2317,鴻海,2585,667,1918,摩根大通,2023-04-20,8440
3037,欣興,1943,286,1657,摩根大通,2023-04-20,8440
2412,中華電,1487,274,1213,摩根大通,2023-04-20,8440
2891,中信金,1480,446,1034,摩根大通,2023-04-20,8440
3045,台灣大,1015,20,995,摩根大通,2023-04-20,8440
1760,寶齡富錦,1806,840,966,摩根大通,2023-04-20,8440
1907,永豐餘,1259,334,925,摩根大通,2023-04-20,8440
1314,中石化,1081,170,911,摩根大通,2023-04-20,8440
2882,國泰金,1297,392,905,摩根大通,2023-04-20,8440
2330,台積電,1274,540,734,摩根大通,2023-04-20,8440
2402,毅嘉,927,259,668,摩根大通,2023-04-20,8440
2885,元大金,821,228,593,摩根大通,2023-04-20,8440
2887,台新金,750,163,587,摩根大通,2023-04-20,8440
2382,廣達,675,104,571,摩根大通,2023-04-20,8440
2006,東和鋼鐵,570,0,570,摩根大通,2023-04-20,8440
2897,王道銀行,573,24,549,摩根大通,2023-04-20,8440
2031,新光鋼,603,109,494,摩根大通,2023-04-20,8440
2454,聯發科,682,198,484,摩根大通,2023-04-20,8440
5243,乙盛-KY,632,187,445,摩根大通,2023-04-20,8440
2812,台中銀,448,35,413,摩根大通,2023-04-20,8440
2634,漢翔,1031,621,410,摩根大通,2023-04-20,8440
2204,中華,1431,1025,406,摩根大通,2023-04-20,8440
2915,潤泰全,482,85,397,摩根大通,2023-04-20,8440
5880,合庫金,513,119,394,摩根大通,2023-04-20,8440
2002,中鋼,820,451,369,摩根大通,2023-04-20,8440
2301,光寶科,442,80,362,摩根大通,2023-04-20,8440
2360,致茂,364,34,330,摩根大通,2023-04-20,8440
6167,久正,396,66,330,摩根大通,2023-04-20,8440
4934,太極,451,123,328,摩根大通,2023-04-20,8440
4979,華星光,707,380,327,摩根大通,2023-04-20,8440
2308,台達電,466,143,323,摩根大通,2023-04-20,8440
1101,台泥,561,238,323,摩根大通,2023-04-20,8440
2618,長榮航,758,460,298,摩根大通,2023-04-20,8440
2482,連宇,304,14,290,摩根大通,2023-04-20,8440
6116,彩晶,322,36,286,摩根大通,2023-04-20,8440
2880,華南金,535,252,283,摩根大通,2023-04-20,8440
2379,瑞昱,311,39,272,摩根大通,2023-04-20,8440
2368,金像電,339,85,254,摩根大通,2023-04-20,8440
3380,明泰,402,158,244,摩根大通,2023-04-20,8440
3702,大聯大,243,0,243,摩根大通,2023-04-20,8440
6026,福邦證,333,94,239,摩根大通,2023-04-20,8440
2645,長榮航太,388,153,235,摩根大通,2023-04-20,8440
2302,麗正,236,6,230,摩根大通,2023-04-20,8440
3025,星通,260,31,229,摩根大通,2023-04-20,8440
1301,台塑,416,187,229,摩根大通,2023-04-20,8440
1304,台聚,239,15,224,摩根大通,2023-04-20,8440
2421,建準,249,31,218,摩根大通,2023-04-20,8440
3231,緯創,13005,1550,11455,摩根大通,2023-04-21,8440
2317,鴻海,5356,363,4993,摩根大通,2023-04-21,8440
2324,仁寶,6725,1752,4973,摩根大通,2023-04-21,8440
2330,台積電,5746,2939,2807,摩根大通,2023-04-21,8440
9958,世紀鋼,4588,2220,2368,摩根大通,2023-04-21,8440
2353,宏��,3062,705,2357,摩根大通,2023-04-21,8440
2409,友達,2499,243,2256,摩根大通,2023-04-21,8440
2891,中信金,2655,594,2061,摩根大通,2023-04-21,8440
2884,玉山金,2027,193,1834,摩根大通,2023-04-21,8440
6443,元晶,2282,556,1726,摩根大通,2023-04-21,8440
2885,元大金,1669,27,1642,摩根大通,2023-04-21,8440
2887,台新金,1781,259,1522,摩根大通,2023-04-21,8440
2881,富邦金,1428,91,1337,摩根大通,2023-04-21,8440
3481,群創,3690,2410,1280,摩根大通,2023-04-21,8440
2303,聯電,2571,1335,1236,摩根大通,2023-04-21,8440
2882,國泰金,1311,211,1100,摩根大通,2023-04-21,8440
2356,英業達,1661,673,988,摩根大通,2023-04-21,8440
2892,第一金,1026,43,983,摩根大通,2023-04-21,8440
1102,亞泥,945,56,889,摩根大通,2023-04-21,8440
1101,台泥,1408,558,850,摩根大通,2023-04-21,8440
2883,凱基金,1255,421,834,摩根大通,2023-04-21,8440
6288,聯嘉,966,138,828,摩根大通,2023-04-21,8440
1513,中興電,815,62,753,摩根大通,2023-04-21,8440
3715,定穎投控,757,21,736,摩根大通,2023-04-21,8440
2337,旺宏,955,224,731,摩根大通,2023-04-21,8440
5425,台半,729,30,699,摩根大通,2023-04-21,8440
2886,兆豐金,788,117,671,摩根大通,2023-04-21,8440
2344,華邦電,751,95,656,摩根大通,2023-04-21,8440
2880,華南金,704,67,637,摩根大通,2023-04-21,8440
2615,萬海,725,115,610,摩根大通,2023-04-21,8440
3078,僑威,1008,406,602,摩根大通,2023-04-21,8440
4906,正文,674,76,598,摩根大通,2023-04-21,8440
2889,國票金,599,13,586,摩根大通,2023-04-21,8440
2014,中鴻,601,45,556,摩根大通,2023-04-21,8440
2360,致茂,573,27,546,摩根大通,2023-04-21,8440
2609,陽明,749,207,542,摩根大通,2023-04-21,8440
2449,京元電子,566,33,533,摩根大通,2023-04-21,8440
2382,廣達,863,336,527,摩根大通,2023-04-21,8440
3017,奇鋐,675,151,524,摩根大通,2023-04-21,8440
2368,金像電,545,36,509,摩根大通,2023-04-21,8440
3005,神基,515,36,479,摩根大通,2023-04-21,8440
2352,佳世達,1549,1081,468,摩根大通,2023-04-21,8440
2890,永豐金,797,344,453,摩根大通,2023-04-21,8440
6235,華孚,1140,692,448,摩根大通,2023-04-21,8440
2201,裕隆,491,77,414,摩根大通,2023-04-21,8440
1519,華城,472,60,412,摩根大通,2023-04-21,8440
4979,華星光,1332,929,403,摩根大通,2023-04-21,8440
5522,遠雄,405,5,400,摩根大通,2023-04-21,8440
8069,元太,571,180,391,摩根大通,2023-04-21,8440
6116,彩晶,385,8,377,摩根大通,2023-04-21,8440
3231,緯創,4395,1926,2469,摩根大通,2023-04-24,8440
2317,鴻海,2542,239,2303,摩根大通,2023-04-24,8440
2382,廣達,1795,43,1752,摩根大通,2023-04-24,8440
3481,群創,1920,210,1710,摩根大通,2023-04-24,8440
2356,英業達,2214,629,1585,摩根大通,2023-04-24,8440
2884,玉山金,1484,0,1484,摩根大通,2023-04-24,8440
2609,陽明,1305,67,1238,摩根大通,2023-04-24,8440
2885,元大金,1258,81,1177,摩根大通,2023-04-24,8440
5425,台半,1189,90,1099,摩根大通,2023-04-24,8440
4958,臻鼎-KY,1076,103,973,摩根大通,2023-04-24,8440
4123,晟德,1042,89,953,摩根大通,2023-04-24,8440
2727,王品,971,104,867,摩根大通,2023-04-24,8440
2454,聯發科,951,203,748,摩根大通,2023-04-24,8440
2614,東森,741,0,741,摩根大通,2023-04-24,8440
2881,富邦金,775,40,735,摩根大通,2023-04-24,8440
2915,潤泰全,794,72,722,摩根大通,2023-04-24,8440
2337,旺宏,803,102,701,摩根大通,2023-04-24,8440
2504,國產,680,2,678,摩根大通,2023-04-24,8440
2892,第一金,796,131,665,摩根大通,2023-04-24,8440
1102,亞泥,720,56,664,摩根大通,2023-04-24,8440
2615,萬海,839,226,613,摩根大通,2023-04-24,8440
4114,健喬,632,33,599,摩根大通,2023-04-24,8440
5522,遠雄,579,18,561,摩根大通,2023-04-24,8440
2891,中信金,702,157,545,摩根大通,2023-04-24,8440
2449,京元電子,656,126,530,摩根大通,2023-04-24,8440
3013,晟銘電,709,186,523,摩根大通,2023-04-24,8440
1709,和益,839,335,504,摩根大通,2023-04-24,8440
6147,頎邦,488,0,488,摩根大通,2023-04-24,8440
1710,東聯,764,281,483,摩根大通,2023-04-24,8440
4904,遠傳,605,174,431,摩根大通,2023-04-24,8440
2888,新光金,1217,797,420,摩根大通,2023-04-24,8440
2606,裕民,413,3,410,摩根大通,2023-04-24,8440
2889,國票金,407,0,407,摩根大通,2023-04-24,8440
5880,合庫金,488,81,407,摩根大通,2023-04-24,8440
2014,中鴻,461,61,400,摩根大通,2023-04-24,8440
2105,正新,384,2,382,摩根大通,2023-04-24,8440
3711,日月光投控,443,69,374,摩根大通,2023-04-24,8440
1216,統一,465,92,373,摩根大通,2023-04-24,8440
1313,聯成,357,0,357,摩根大通,2023-04-24,8440
2368,金像電,529,182,347,摩根大通,2023-04-24,8440
2355,敬鵬,430,90,340,摩根大通,2023-04-24,8440
2887,台新金,342,10,332,摩根大通,2023-04-24,8440
1101,台泥,971,640,331,摩根大通,2023-04-24,8440
2897,王道銀行,348,21,327,摩根大通,2023-04-24,8440
2618,長榮航,347,25,322,摩根大通,2023-04-24,8440
2834,臺企銀,328,20,308,摩根大通,2023-04-24,8440
2402,毅嘉,398,98,300,摩根大通,2023-04-24,8440
3045,台灣大,302,6,296,摩根大通,2023-04-24,8440
1905,華紙,979,687,292,摩根大通,2023-04-24,8440
1104,環泥,284,0,284,摩根大通,2023-04-24,8440
2892,第一金,4779,668,4111,摩根大通,2023-04-25,8440
3231,緯創,6932,3286,3646,摩根大通,2023-04-25,8440
2317,鴻海,3883,1401,2482,摩根大通,2023-04-25,8440
2515,中工,2033,61,1972,摩根大通,2023-04-25,8440
2891,中信金,2882,1402,1480,摩根大通,2023-04-25,8440
2303,聯電,2298,1100,1198,摩根大通,2023-04-25,8440
2884,玉山金,1953,845,1108,摩根大通,2023-04-25,8440
1504,東元,1288,278,1010,摩根大通,2023-04-25,8440
5880,合庫金,1730,720,1010,摩根大通,2023-04-25,8440
1301,台塑,1565,578,987,摩根大通,2023-04-25,8440
2609,陽明,1517,631,886,摩根大通,2023-04-25,8440
2353,宏��,1791,928,863,摩根大通,2023-04-25,8440
2408,南亞科,1193,413,780,摩根大通,2023-04-25,8440
5425,台半,1170,396,774,摩根大通,2023-04-25,8440
2812,台中銀,760,2,758,摩根大通,2023-04-25,8440
3481,群創,2528,1814,714,摩根大通,2023-04-25,8440
5522,遠雄,723,9,714,摩根大通,2023-04-25,8440
2105,正新,813,121,692,摩根大通,2023-04-25,8440
3702,大聯大,907,225,682,摩根大通,2023-04-25,8440
2449,京元電子,662,83,579,摩根大通,2023-04-25,8440
6770,力積電,944,366,578,摩根大通,2023-04-25,8440
1102,亞泥,1032,509,523,摩根大通,2023-04-25,8440
2201,裕隆,647,125,522,摩根大通,2023-04-25,8440
2885,元大金,1304,798,506,摩根大通,2023-04-25,8440
6163,華電網,857,391,466,摩根大通,2023-04-25,8440
3037,欣興,1298,837,461,摩根大通,2023-04-25,8440
2615,萬海,576,129,447,摩根大通,2023-04-25,8440
1216,統一,806,376,430,摩根大通,2023-04-25,8440
6239,力成,438,11,427,摩根大通,2023-04-25,8440
6244,茂迪,579,184,395,摩根大通,2023-04-25,8440
6147,頎邦,459,72,387,摩根大通,2023-04-25,8440
1314,中石化,1585,1211,374,摩根大通,2023-04-25,8440
1402,遠東新,772,403,369,摩根大通,2023-04-25,8440
2618,長榮航,760,395,365,摩根大通,2023-04-25,8440
1304,台聚,388,32,356,摩根大通,2023-04-25,8440
2881,富邦金,876,530,346,摩根大通,2023-04-25,8440
3005,神基,482,143,339,摩根大通,2023-04-25,8440
3032,偉訓,550,214,336,摩根大通,2023-04-25,8440
6531,愛普*,385,53,332,摩根大通,2023-04-25,8440
2606,裕民,387,60,327,摩根大通,2023-04-25,8440
2882,國泰金,1735,1418,317,摩根大通,2023-04-25,8440
6446,藥華藥,530,219,311,摩根大通,2023-04-25,8440
3324,雙鴻,299,8,291,摩根大通,2023-04-25,8440
1312,國喬,434,146,288,摩根大通,2023-04-25,8440
2388,威盛,340,58,282,摩根大通,2023-04-25,8440
3661,世芯-KY,370,92,278,摩根大通,2023-04-25,8440
8105,凌巨,261,10,251,摩根大通,2023-04-25,8440
1717,長興,272,23,249,摩根大通,2023-04-25,8440
2880,華南金,812,564,248,摩根大通,2023-04-25,8440
5347,世界,310,62,248,摩根大通,2023-04-25,8440
2892,第一金,4925,366,4559,摩根大通,2023-04-26,8440
2884,玉山金,4742,804,3938,摩根大通,2023-04-26,8440
2317,鴻海,4372,1248,3124,摩根大通,2023-04-26,8440
2330,台積電,4965,2264,2701,摩根大通,2023-04-26,8440
3231,緯創,3694,1494,2200,摩根大通,2023-04-26,8440
2890,永豐金,3265,1162,2103,摩根大通,2023-04-26,8440
2891,中信金,3003,933,2070,摩根大通,2023-04-26,8440
8222,寶一,2337,460,1877,摩根大通,2023-04-26,8440
2887,台新金,2322,461,1861,摩根大通,2023-04-26,8440
2457,飛宏,1651,27,1624,摩根大通,2023-04-26,8440
2867,三商壽,1821,246,1575,摩根大通,2023-04-26,8440
1907,永豐餘,1764,241,1523,摩根大通,2023-04-26,8440
2353,宏��,2922,1433,1489,摩根大通,2023-04-26,8440
2886,兆豐金,2110,663,1447,摩根大通,2023-04-26,8440
3037,欣興,2098,869,1229,摩根大通,2023-04-26,8440
1909,榮成,1012,21,991,摩根大通,2023-04-26,8440
2105,正新,1041,79,962,摩根大通,2023-04-26,8440
3045,台灣大,1020,130,890,摩根大通,2023-04-26,8440
2412,中華電,1288,460,828,摩根大通,2023-04-26,8440
1216,統一,959,144,815,摩根大通,2023-04-26,8440
2002,中鋼,1589,858,731,摩根大通,2023-04-26,8440
3189,景碩,733,16,717,摩根大通,2023-04-26,8440
2313,華通,1261,556,705,摩根大通,2023-04-26,8440
2014,中鴻,824,130,694,摩根大通,2023-04-26,8440
1101,台泥,1041,416,625,摩根大通,2023-04-26,8440
5522,遠雄,624,14,610,摩根大通,2023-04-26,8440
2303,聯電,1647,1043,604,摩根大通,2023-04-26,8440
2352,佳世達,689,92,597,摩根大通,2023-04-26,8440
5347,世界,624,27,597,摩根大通,2023-04-26,8440
1722,台肥,617,24,593,摩根大通,2023-04-26,8440
2634,漢翔,739,188,551,摩根大通,2023-04-26,8440
2324,仁寶,2277,1750,527,摩根大通,2023-04-26,8440
5876,上海商銀,650,124,526,摩根大通,2023-04-26,8440
2453,凌群,629,157,472,摩根大通,2023-04-26,8440
2881,富邦金,1254,789,465,摩根大通,2023-04-26,8440
1519,華城,642,193,449,摩根大通,2023-04-26,8440
2885,元大金,787,339,448,摩根大通,2023-04-26,8440
4967,十銓,537,129,408,摩根大通,2023-04-26,8440
2880,華南金,807,404,403,摩根大通,2023-04-26,8440
3078,僑威,573,179,394,摩根大通,2023-04-26,8440
1312,國喬,398,22,376,摩根大通,2023-04-26,8440
2449,京元電子,379,23,356,摩根大通,2023-04-26,8440
2610,華航,809,481,328,摩根大通,2023-04-26,8440
5009,榮剛,441,114,327,摩根大通,2023-04-26,8440
4919,新唐,473,165,308,摩根大通,2023-04-26,8440
2376,技嘉,351,46,305,摩根大通,2023-04-26,8440
2618,長榮航,626,321,305,摩根大通,2023-04-26,8440
2382,廣達,392,87,305,摩根大通,2023-04-26,8440
3711,日月光投控,1388,1085,303,摩根大通,2023-04-26,8440
6446,藥華藥,421,141,280,摩根大通,2023-04-26,8440
3231,緯創,13659,2919,10740,摩根大通,2023-04-27,8440
2330,台積電,7417,2097,5320,摩根大通,2023-04-27,8440
2867,三商壽,2807,206,2601,摩根大通,2023-04-27,8440
2337,旺宏,2617,149,2468,摩根大通,2023-04-27,8440
2356,英業達,3610,1154,2456,摩根大通,2023-04-27,8440
2449,京元電子,1855,368,1487,摩根大通,2023-04-27,8440
3711,日月光投控,1914,622,1292,摩根大通,2023-04-27,8440
2317,鴻海,2831,1746,1085,摩根大通,2023-04-27,8440
2353,宏��,4621,3572,1049,摩根大通,2023-04-27,8440
6147,頎邦,1040,22,1018,摩根大通,2023-04-27,8440
3706,神達,941,53,888,摩根大通,2023-04-27,8440
6412,群電,740,43,697,摩根大通,2023-04-27,8440
2801,彰銀,1590,916,674,摩根大通,2023-04-27,8440
5522,遠雄,674,32,642,摩根大通,2023-04-27,8440
6288,聯嘉,676,45,631,摩根大通,2023-04-27,8440
2881,富邦金,903,290,613,摩根大通,2023-04-27,8440
1312,國喬,759,152,607,摩根大通,2023-04-27,8440
2610,華航,802,241,561,摩根大通,2023-04-27,8440
6770,力積電,1213,702,511,摩根大通,2023-04-27,8440
2530,華建,604,104,500,摩根大通,2023-04-27,8440
2634,漢翔,1658,1162,496,摩根大通,2023-04-27,8440
2609,陽明,1184,717,467,摩根大通,2023-04-27,8440
1905,華紙,1139,683,456,摩根大通,2023-04-27,8440
6282,康舒,589,142,447,摩根大通,2023-04-27,8440
2615,萬海,1188,781,407,摩根大通,2023-04-27,8440
6741,91APP*-KY,555,207,348,摩根大通,2023-04-27,8440
3338,泰碩,344,13,331,摩根大通,2023-04-27,8440
2457,飛宏,503,182,321,摩根大通,2023-04-27,8440
9919,康那香,568,253,315,摩根大通,2023-04-27,8440
9934,成霖,302,0,302,摩根大通,2023-04-27,8440
2345,智邦,354,56,298,摩根大通,2023-04-27,8440
2408,南亞科,388,92,296,摩根大通,2023-04-27,8440
6239,力成,803,521,282,摩根大通,2023-04-27,8440
6121,新普,286,6,280,摩根大通,2023-04-27,8440
2105,正新,428,167,261,摩根大通,2023-04-27,8440
4906,正文,275,22,253,摩根大通,2023-04-27,8440
4960,誠美材,303,54,249,摩根大通,2023-04-27,8440
1714,和桐,256,9,247,摩根大通,2023-04-27,8440
3583,辛耘,243,4,239,摩根大通,2023-04-27,8440
3045,台灣大,325,94,231,摩根大通,2023-04-27,8440
2471,資通,457,230,227,摩根大通,2023-04-27,8440
1467,南緯,269,49,220,摩根大通,2023-04-27,8440
1304,台聚,232,12,220,摩根大通,2023-04-27,8440
2382,廣達,577,367,210,摩根大通,2023-04-27,8440
2486,一詮,294,84,210,摩根大通,2023-04-27,8440
2387,精元,208,1,207,摩根大通,2023-04-27,8440
3715,定穎投控,220,21,199,摩根大通,2023-04-27,8440
1416,廣豐,198,0,198,摩根大通,2023-04-27,8440
2915,潤泰全,257,61,196,摩根大通,2023-04-27,8440
3380,明泰,307,112,195,摩根大通,2023-04-27,8440
3037,欣興,7016,473,6543,摩根大通,2023-04-28,8440
2353,宏��,6375,1351,5024,摩根大通,2023-04-28,8440
2801,彰銀,3365,250,3115,摩根大通,2023-04-28,8440
2887,台新金,3732,660,3072,摩根大通,2023-04-28,8440
2891,中信金,3262,574,2688,摩根大通,2023-04-28,8440
2890,永豐金,3031,534,2497,摩根大通,2023-04-28,8440
2317,鴻海,2481,675,1806,摩根大通,2023-04-28,8440
2881,富邦金,2134,386,1748,摩根大通,2023-04-28,8440
2885,元大金,2657,1045,1612,摩根大通,2023-04-28,8440
2883,凱基金,2849,1378,1471,摩根大通,2023-04-28,8440
2845,遠東銀,1238,59,1179,摩根大通,2023-04-28,8440
2360,致茂,1202,156,1046,摩根大通,2023-04-28,8440
5880,合庫金,1508,524,984,摩根大通,2023-04-28,8440
2408,南亞科,1319,387,932,摩根大通,2023-04-28,8440
2352,佳世達,1051,142,909,摩根大通,2023-04-28,8440
2324,仁寶,2394,1561,833,摩根大通,2023-04-28,8440
2889,國票金,724,9,715,摩根大通,2023-04-28,8440
1504,東元,1085,421,664,摩根大通,2023-04-28,8440
2834,臺企銀,1009,399,610,摩根大通,2023-04-28,8440
6288,聯嘉,785,176,609,摩根大通,2023-04-28,8440
2888,新光金,1157,560,597,摩根大通,2023-04-28,8440
6005,群益證,617,20,597,摩根大通,2023-04-28,8440
2002,中鋼,1456,870,586,摩根大通,2023-04-28,8440
3231,緯創,1963,1383,580,摩根大通,2023-04-28,8440
9945,潤泰新,611,92,519,摩根大通,2023-04-28,8440
2484,希華,510,1,509,摩根大通,2023-04-28,8440
2489,瑞軒,547,44,503,摩根大通,2023-04-28,8440
4114,健喬,499,9,490,摩根大通,2023-04-28,8440
1701,中化,584,150,434,摩根大通,2023-04-28,8440
3094,聯傑,434,0,434,摩根大通,2023-04-28,8440
3419,譁裕,487,56,431,摩根大通,2023-04-28,8440
3029,零壹,534,123,411,摩根大通,2023-04-28,8440
2618,長榮航,1969,1559,410,摩根大通,2023-04-28,8440
1727,中華化,390,0,390,摩根大通,2023-04-28,8440
3005,神基,511,135,376,摩根大通,2023-04-28,8440
4306,炎洲,365,11,354,摩根大通,2023-04-28,8440
3006,晶豪科,385,31,354,摩根大通,2023-04-28,8440
2633,台灣高鐵,460,122,338,摩根大通,2023-04-28,8440
2812,台中銀,659,333,326,摩根大通,2023-04-28,8440
6160,欣技,366,44,322,摩根大通,2023-04-28,8440
1104,環泥,358,38,320,摩根大通,2023-04-28,8440
3714,富采,574,288,286,摩根大通,2023-04-28,8440
2486,一詮,401,122,279,摩根大通,2023-04-28,8440
4130,健亞,277,0,277,摩根大通,2023-04-28,8440
2492,華新科,338,61,277,摩根大通,2023-04-28,8440
2454,聯發科,609,355,254,摩根大通,2023-04-28,8440
6161,捷波,252,0,252,摩根大通,2023-04-28,8440
2453,凌群,523,274,249,摩根大通,2023-04-28,8440
2023,燁輝,257,8,249,摩根大通,2023-04-28,8440
2867,三商壽,530,285,245,摩根大通,2023-04-28,8440
3231,緯創,8624,3916,4708,摩根大通,2023-05-02,8440
2382,廣達,4404,107,4297,摩根大通,2023-05-02,8440
5880,合庫金,3532,85,3447,摩根大通,2023-05-02,8440
2883,凱基金,3313,177,3136,摩根大通,2023-05-02,8440
2324,仁寶,3342,454,2888,摩根大通,2023-05-02,8440
2888,新光金,3024,277,2747,摩根大通,2023-05-02,8440
8069,元太,3129,571,2558,摩根大通,2023-05-02,8440
1609,大亞,2573,20,2553,摩根大通,2023-05-02,8440
2002,中鋼,2223,372,1851,摩根大通,2023-05-02,8440
1504,東元,1980,139,1841,摩根大通,2023-05-02,8440
1101,台泥,2965,1138,1827,摩根大通,2023-05-02,8440
2884,玉山金,1674,141,1533,摩根大通,2023-05-02,8440
2892,第一金,1491,27,1464,摩根大通,2023-05-02,8440
2353,宏��,1341,3,1338,摩根大通,2023-05-02,8440
2303,聯電,3219,1896,1323,摩根大通,2023-05-02,8440
3037,欣興,1685,421,1264,摩根大通,2023-05-02,8440
3711,日月光投控,1196,213,983,摩根大通,2023-05-02,8440
2882,國泰金,1977,1138,839,摩根大通,2023-05-02,8440
4746,台耀,895,143,752,摩根大通,2023-05-02,8440
4541,晟田,977,274,703,摩根大通,2023-05-02,8440
2812,台中銀,819,130,689,摩根大通,2023-05-02,8440
2023,燁輝,687,9,678,摩根大通,2023-05-02,8440
2457,飛宏,997,319,678,摩根大通,2023-05-02,8440
2449,京元電子,750,93,657,摩根大通,2023-05-02,8440
3479,安勤,865,232,633,摩根大通,2023-05-02,8440
3712,永崴投控,653,50,603,摩根大通,2023-05-02,8440
6285,啟��,624,43,581,摩根大通,2023-05-02,8440
2618,長榮航,731,165,566,摩根大通,2023-05-02,8440
1710,東聯,625,77,548,摩根大通,2023-05-02,8440
6148,驊宏資,1337,793,544,摩根大通,2023-05-02,8440
00878,國泰永續高股息,526,0,526,摩根大通,2023-05-02,8440
2317,鴻海,691,189,502,摩根大通,2023-05-02,8440
1460,宏遠,504,10,494,摩根大通,2023-05-02,8440
4121,優盛,947,464,483,摩根大通,2023-05-02,8440
2454,聯發科,672,195,477,摩根大通,2023-05-02,8440
2610,華航,408,15,393,摩根大通,2023-05-02,8440
6282,康舒,459,67,392,摩根大通,2023-05-02,8440
2891,中信金,727,361,366,摩根大通,2023-05-02,8440
2330,台積電,877,522,355,摩根大通,2023-05-02,8440
2444,兆勁,353,0,353,摩根大通,2023-05-02,8440
6770,力積電,439,110,329,摩根大通,2023-05-02,8440
6234,高僑,377,64,313,摩根大通,2023-05-02,8440
4938,和碩,317,8,309,摩根大通,2023-05-02,8440
2880,華南金,729,440,289,摩根大通,2023-05-02,8440
3481,群創,1472,1184,288,摩根大通,2023-05-02,8440
4157,太景*-KY,277,0,277,摩根大通,2023-05-02,8440
4142,國光生,278,2,276,摩根大通,2023-05-02,8440
1795,美時,452,178,274,摩根大通,2023-05-02,8440
2371,大同,289,20,269,摩根大通,2023-05-02,8440
4968,立積,530,264,266,摩根大通,2023-05-02,8440
2353,宏��,2077,398,1679,摩根大通,2023-05-03,8440
4746,台耀,1823,217,1606,摩根大通,2023-05-03,8440
2890,永豐金,1492,25,1467,摩根大通,2023-05-03,8440
2454,聯發科,1078,227,851,摩根大通,2023-05-03,8440
2313,華通,1272,454,818,摩根大通,2023-05-03,8440
2883,凱基金,2539,1740,799,摩根大通,2023-05-03,8440
2888,新光金,988,228,760,摩根大通,2023-05-03,8440
2317,鴻海,1911,1156,755,摩根大通,2023-05-03,8440
1605,華新,762,36,726,摩根大通,2023-05-03,8440
2515,中工,818,99,719,摩根大通,2023-05-03,8440
2382,廣達,1412,704,708,摩根大通,2023-05-03,8440
2409,友達,693,84,609,摩根大通,2023-05-03,8440
3711,日月光投控,1044,500,544,摩根大通,2023-05-03,8440
5347,世界,703,200,503,摩根大通,2023-05-03,8440
3033,威健,566,78,488,摩根大通,2023-05-03,8440
2880,華南金,471,17,454,摩根大通,2023-05-03,8440
1802,台玻,634,184,450,摩根大通,2023-05-03,8440
6005,群益證,450,54,396,摩根大通,2023-05-03,8440
2408,南亞科,397,40,357,摩根大通,2023-05-03,8440
2618,長榮航,377,45,332,摩根大通,2023-05-03,8440
3037,欣興,518,229,289,摩根大通,2023-05-03,8440
2356,英業達,294,10,284,摩根大通,2023-05-03,8440
2455,全新,352,77,275,摩根大通,2023-05-03,8440
2331,精英,451,182,269,摩根大通,2023-05-03,8440
2385,群光,275,7,268,摩根大通,2023-05-03,8440
2498,宏達電,321,54,267,摩根大通,2023-05-03,8440
1710,東聯,457,206,251,摩根大通,2023-05-03,8440
1216,統一,266,15,251,摩根大通,2023-05-03,8440
3532,台勝科,252,3,249,摩根大通,2023-05-03,8440
8112,至上,248,0,248,摩根大通,2023-05-03,8440
2449,京元電子,264,21,243,摩根大通,2023-05-03,8440
1467,南緯,243,8,235,摩根大通,2023-05-03,8440
2476,鉅祥,264,36,228,摩根大通,2023-05-03,8440
2834,臺企銀,335,109,226,摩根大通,2023-05-03,8440
1477,聚陽,276,51,225,摩根大通,2023-05-03,8440
1444,力麗,198,0,198,摩根大通,2023-05-03,8440
2535,達欣工,194,0,194,摩根大通,2023-05-03,8440
8121,越峰,423,236,187,摩根大通,2023-05-03,8440
1218,泰山,208,25,183,摩根大通,2023-05-03,8440
6741,91APP*-KY,718,537,181,摩根大通,2023-05-03,8440
5475,德宏,221,46,175,摩根大通,2023-05-03,8440
3714,富采,189,15,174,摩根大通,2023-05-03,8440
1210,大成,177,4,173,摩根大通,2023-05-03,8440
2481,強茂,176,4,172,摩根大通,2023-05-03,8440
4147,中裕,199,27,172,摩根大通,2023-05-03,8440
6415,矽力*-KY,174,4,170,摩根大通,2023-05-03,8440
1504,東元,389,233,156,摩根大通,2023-05-03,8440
1460,宏遠,161,6,155,摩根大通,2023-05-03,8440
2461,光群雷,158,4,154,摩根大通,2023-05-03,8440
3703,欣陸,170,20,150,摩根大通,2023-05-03,8440
1609,大亞,7747,1005,6742,摩根大通,2023-05-04,8440
2890,永豐金,4123,383,3740,摩根大通,2023-05-04,8440
1907,永豐餘,2268,313,1955,摩根大通,2023-05-04,8440
3481,群創,2615,1134,1481,摩根大通,2023-05-04,8440
4147,中裕,1390,0,1390,摩根大通,2023-05-04,8440
2892,第一金,1725,395,1330,摩根大通,2023-05-04,8440
2105,正新,1297,27,1270,摩根大通,2023-05-04,8440
2884,玉山金,1146,16,1130,摩根大通,2023-05-04,8440
1605,華新,1155,107,1048,摩根大通,2023-05-04,8440
2330,台積電,1600,598,1002,摩根大通,2023-05-04,8440
2515,中工,831,19,812,摩根大通,2023-05-04,8440
2382,廣達,847,79,768,摩根大通,2023-05-04,8440
2881,富邦金,980,249,731,摩根大通,2023-05-04,8440
1513,中興電,768,46,722,摩根大通,2023-05-04,8440
2883,凱基金,898,222,676,摩根大通,2023-05-04,8440
2313,華通,1114,458,656,摩根大通,2023-05-04,8440
2880,華南金,945,305,640,摩根大通,2023-05-04,8440
5347,世界,858,227,631,摩根大通,2023-05-04,8440
2345,智邦,727,108,619,摩根大通,2023-05-04,8440
1904,正隆,763,152,611,摩根大通,2023-05-04,8440
2633,台灣高鐵,514,2,512,摩根大通,2023-05-04,8440
0050,元大台灣50,500,0,500,摩根大通,2023-05-04,8440
2356,英業達,572,105,467,摩根大通,2023-05-04,8440
2801,彰銀,582,181,401,摩根大通,2023-05-04,8440
2912,統一超,374,7,367,摩根大通,2023-05-04,8440
3702,大聯大,519,152,367,摩根大通,2023-05-04,8440
2371,大同,392,32,360,摩根大通,2023-05-04,8440
2492,華新科,356,4,352,摩根大通,2023-05-04,8440
1301,台塑,431,87,344,摩根大通,2023-05-04,8440
1519,華城,594,251,343,摩根大通,2023-05-04,8440
3045,台灣大,547,207,340,摩根大通,2023-05-04,8440
2331,精英,372,62,310,摩根大通,2023-05-04,8440
5388,中磊,287,0,287,摩根大通,2023-05-04,8440
4164,承業醫,380,118,262,摩根大通,2023-05-04,8440
3673,TPK-KY,369,110,259,摩根大通,2023-05-04,8440
3033,威健,410,173,237,摩根大通,2023-05-04,8440
1795,美時,524,289,235,摩根大通,2023-05-04,8440
4904,遠傳,280,50,230,摩根大通,2023-05-04,8440
1701,中化,407,198,209,摩根大通,2023-05-04,8440
2206,三陽工業,753,549,204,摩根大通,2023-05-04,8440
4157,太景*-KY,198,0,198,摩根大通,2023-05-04,8440
1477,聚陽,238,41,197,摩根大通,2023-05-04,8440
5439,高技,233,44,189,摩根大通,2023-05-04,8440
4919,新唐,225,36,189,摩根大通,2023-05-04,8440
3703,欣陸,185,0,185,摩根大通,2023-05-04,8440
2352,佳世達,374,190,184,摩根大通,2023-05-04,8440
6239,力成,216,44,172,摩根大通,2023-05-04,8440
2442,新美齊,165,0,165,摩根大通,2023-05-04,8440
2504,國產,164,0,164,摩根大通,2023-05-04,8440
2337,旺宏,224,62,162,摩根大通,2023-05-04,8440
2880,華南金,2046,1,2045,摩根大通,2023-05-05,8440
2492,華新科,2153,205,1948,摩根大通,2023-05-05,8440
2891,中信金,2237,506,1731,摩根大通,2023-05-05,8440
2888,新光金,1404,0,1404,摩根大通,2023-05-05,8440
1504,東元,1558,450,1108,摩根大通,2023-05-05,8440
2409,友達,1199,136,1063,摩根大通,2023-05-05,8440
2887,台新金,1036,6,1030,摩根大通,2023-05-05,8440
2382,廣達,1010,114,896,摩根大通,2023-05-05,8440
6274,台燿,954,64,890,摩根大通,2023-05-05,8440
1519,華城,1028,185,843,摩根大通,2023-05-05,8440
2313,華通,949,108,841,摩根大通,2023-05-05,8440
9955,佳龍,1105,291,814,摩根大通,2023-05-05,8440
3703,欣陸,809,30,779,摩根大通,2023-05-05,8440
2834,臺企銀,813,61,752,摩根大通,2023-05-05,8440
2885,元大金,993,242,751,摩根大通,2023-05-05,8440
2002,中鋼,973,297,676,摩根大通,2023-05-05,8440
2801,彰銀,697,39,658,摩根大通,2023-05-05,8440
6111,大宇資,1119,476,643,摩根大通,2023-05-05,8440
2301,光寶科,824,204,620,摩根大通,2023-05-05,8440
8390,金益鼎,644,54,590,摩根大通,2023-05-05,8440
2368,金像電,584,1,583,摩根大通,2023-05-05,8440
3014,聯陽,593,14,579,摩根大通,2023-05-05,8440
2356,英業達,647,91,556,摩根大通,2023-05-05,8440
3017,奇鋐,927,381,546,摩根大通,2023-05-05,8440
2352,佳世達,608,84,524,摩根大通,2023-05-05,8440
6589,台康生技,657,139,518,摩根大通,2023-05-05,8440
1907,永豐餘,1054,543,511,摩根大通,2023-05-05,8440
2912,統一超,658,167,491,摩根大通,2023-05-05,8440
2812,台中銀,465,2,463,摩根大通,2023-05-05,8440
1785,光洋科,468,22,446,摩根大通,2023-05-05,8440
1319,東陽,410,16,394,摩根大通,2023-05-05,8440
2892,第一金,498,104,394,摩根大通,2023-05-05,8440
4915,致伸,540,156,384,摩根大通,2023-05-05,8440
2903,遠百,392,64,328,摩根大通,2023-05-05,8440
1605,華新,612,285,327,摩根大通,2023-05-05,8440
2314,台揚,411,91,320,摩根大通,2023-05-05,8440
8150,南茂,398,92,306,摩根大通,2023-05-05,8440
2889,國票金,297,1,296,摩根大通,2023-05-05,8440
2883,凱基金,915,620,295,摩根大通,2023-05-05,8440
1227,佳格,292,0,292,摩根大通,2023-05-05,8440
3037,欣興,448,171,277,摩根大通,2023-05-05,8440
3591,艾笛森,425,164,261,摩根大通,2023-05-05,8440
1503,士電,410,155,255,摩根大通,2023-05-05,8440
3715,定穎投控,401,148,253,摩根大通,2023-05-05,8440
2360,致茂,388,135,253,摩根大通,2023-05-05,8440
2105,正新,380,131,249,摩根大通,2023-05-05,8440
2884,玉山金,323,76,247,摩根大通,2023-05-05,8440
4744,皇將,597,359,238,摩根大通,2023-05-05,8440
2881,富邦金,321,93,228,摩根大通,2023-05-05,8440
2330,台積電,1005,789,216,摩根大通,2023-05-05,8440
2890,永豐金,4039,3,4036,摩根大通,2023-05-08,8440
2891,中信金,3581,465,3116,摩根大通,2023-05-08,8440
3037,欣興,4087,993,3094,摩根大通,2023-05-08,8440
2356,英業達,3017,175,2842,摩根大通,2023-05-08,8440
2421,建準,3115,1125,1990,摩根大通,2023-05-08,8440
2880,華南金,1666,32,1634,摩根大通,2023-05-08,8440
2883,凱基金,2449,898,1551,摩根大通,2023-05-08,8440
2801,彰銀,1333,53,1280,摩根大通,2023-05-08,8440
2881,富邦金,2009,730,1279,摩根大通,2023-05-08,8440
2371,大同,1323,47,1276,摩根大通,2023-05-08,8440
2885,元大金,1320,70,1250,摩根大通,2023-05-08,8440
3715,定穎投控,1820,605,1215,摩根大通,2023-05-08,8440
2027,大成鋼,1074,42,1032,摩根大通,2023-05-08,8440
1101,台泥,1088,58,1030,摩根大通,2023-05-08,8440
2888,新光金,1146,165,981,摩根大通,2023-05-08,8440
3017,奇鋐,1057,94,963,摩根大通,2023-05-08,8440
3189,景碩,740,3,737,摩根大通,2023-05-08,8440
2324,仁寶,1460,740,720,摩根大通,2023-05-08,8440
2892,第一金,948,239,709,摩根大通,2023-05-08,8440
5880,合庫金,653,42,611,摩根大通,2023-05-08,8440
2408,南亞科,652,112,540,摩根大通,2023-05-08,8440
1907,永豐餘,582,47,535,摩根大通,2023-05-08,8440
2303,聯電,1194,689,505,摩根大通,2023-05-08,8440
1513,中興電,1086,599,487,摩根大通,2023-05-08,8440
6741,91APP*-KY,603,139,464,摩根大通,2023-05-08,8440
1303,南亞,489,43,446,摩根大通,2023-05-08,8440
2104,國際中橡,454,8,446,摩根大通,2023-05-08,8440
3056,富華新,446,6,440,摩根大通,2023-05-08,8440
2313,華通,457,28,429,摩根大通,2023-05-08,8440
2633,台灣高鐵,448,27,421,摩根大通,2023-05-08,8440
2337,旺宏,458,47,411,摩根大通,2023-05-08,8440
1102,亞泥,818,424,394,摩根大通,2023-05-08,8440
4958,臻鼎-KY,395,11,384,摩根大通,2023-05-08,8440
2412,中華電,404,54,350,摩根大通,2023-05-08,8440
8069,元太,549,207,342,摩根大通,2023-05-08,8440
2884,玉山金,465,124,341,摩根大通,2023-05-08,8440
1210,大成,485,155,330,摩根大通,2023-05-08,8440
3596,智易,348,28,320,摩根大通,2023-05-08,8440
6147,頎邦,323,10,313,摩根大通,2023-05-08,8440
3071,協禧,340,33,307,摩根大通,2023-05-08,8440
1504,東元,912,621,291,摩根大通,2023-05-08,8440
2454,聯發科,326,35,291,摩根大通,2023-05-08,8440
2542,興富發,356,66,290,摩根大通,2023-05-08,8440
2301,光寶科,388,100,288,摩根大通,2023-05-08,8440
2468,華經,446,171,275,摩根大通,2023-05-08,8440
2383,台光電,287,38,249,摩根大通,2023-05-08,8440
2474,可成,264,18,246,摩根大通,2023-05-08,8440
2471,資通,347,110,237,摩根大通,2023-05-08,8440
1721,三晃,230,0,230,摩根大通,2023-05-08,8440
8996,高力,307,78,229,摩根大通,2023-05-08,8440
2324,仁寶,5706,1132,4574,摩根大通,2023-05-09,8440
2888,新光金,2877,196,2681,摩根大通,2023-05-09,8440
1907,永豐餘,2982,502,2480,摩根大通,2023-05-09,8440
2515,中工,1860,89,1771,摩根大通,2023-05-09,8440
2353,宏��,2980,1219,1761,摩根大通,2023-05-09,8440
2317,鴻海,2160,454,1706,摩根大通,2023-05-09,8440
2356,英業達,2033,380,1653,摩根大通,2023-05-09,8440
2330,台積電,2710,1131,1579,摩根大通,2023-05-09,8440
2880,華南金,1798,264,1534,摩根大通,2023-05-09,8440
3481,群創,1920,559,1361,摩根大通,2023-05-09,8440
1101,台泥,1549,197,1352,摩根大通,2023-05-09,8440
2890,永豐金,1434,119,1315,摩根大通,2023-05-09,8440
2882,國泰金,2824,1547,1277,摩根大通,2023-05-09,8440
2801,彰銀,1377,112,1265,摩根大通,2023-05-09,8440
2352,佳世達,1615,357,1258,摩根大通,2023-05-09,8440
2610,華航,1155,109,1046,摩根大通,2023-05-09,8440
2409,友達,1938,938,1000,摩根大通,2023-05-09,8440
2344,華邦電,1057,92,965,摩根大通,2023-05-09,8440
2881,富邦金,1067,171,896,摩根大通,2023-05-09,8440
2382,廣達,1163,298,865,摩根大通,2023-05-09,8440
3017,奇鋐,1101,260,841,摩根大通,2023-05-09,8440
1303,南亞,790,12,778,摩根大通,2023-05-09,8440
3037,欣興,1617,841,776,摩根大通,2023-05-09,8440
8046,南電,769,13,756,摩根大通,2023-05-09,8440
5880,合庫金,909,180,729,摩根大通,2023-05-09,8440
2376,技嘉,769,59,710,摩根大通,2023-05-09,8440
2885,元大金,980,293,687,摩根大通,2023-05-09,8440
2313,華通,606,4,602,摩根大通,2023-05-09,8440
2887,台新金,1185,585,600,摩根大通,2023-05-09,8440
6139,亞翔,673,126,547,摩根大通,2023-05-09,8440
2105,正新,541,0,541,摩根大通,2023-05-09,8440
2891,中信金,1432,957,475,摩根大通,2023-05-09,8440
2449,京元電子,472,1,471,摩根大通,2023-05-09,8440
3711,日月光投控,623,167,456,摩根大通,2023-05-09,8440
1722,台肥,504,50,454,摩根大通,2023-05-09,8440
3045,台灣大,967,553,414,摩根大通,2023-05-09,8440
1514,亞力,768,363,405,摩根大通,2023-05-09,8440
2884,玉山金,759,356,403,摩根大通,2023-05-09,8440
3189,景碩,403,15,388,摩根大通,2023-05-09,8440
2402,毅嘉,882,510,372,摩根大通,2023-05-09,8440
2027,大成鋼,448,77,371,摩根大通,2023-05-09,8440
1301,台塑,446,96,350,摩根大通,2023-05-09,8440
4968,立積,481,148,333,摩根大通,2023-05-09,8440
2383,台光電,348,16,332,摩根大通,2023-05-09,8440
3046,建��,914,587,327,摩根大通,2023-05-09,8440
1326,台化,334,26,308,摩根大通,2023-05-09,8440
6415,矽力*-KY,314,13,301,摩根大通,2023-05-09,8440
0056,元大高股息,300,0,300,摩根大通,2023-05-09,8440
2618,長榮航,365,73,292,摩根大通,2023-05-09,8440
6806,森崴能源,364,75,289,摩根大通,2023-05-09,8440
2884,玉山金,5984,429,5555,摩根大通,2023-05-10,8440
2618,長榮航,3358,478,2880,摩根大通,2023-05-10,8440
2886,兆豐金,1866,198,1668,摩根大通,2023-05-10,8440
1609,大亞,3079,1682,1397,摩根大通,2023-05-10,8440
6139,亞翔,1237,133,1104,摩根大通,2023-05-10,8440
2867,三商壽,1324,365,959,摩根大通,2023-05-10,8440
2352,佳世達,1345,399,946,摩根大通,2023-05-10,8440
2330,台積電,2652,1710,942,摩根大通,2023-05-10,8440
2353,宏��,1958,1221,737,摩根大通,2023-05-10,8440
2885,元大金,772,93,679,摩根大通,2023-05-10,8440
2880,華南金,980,371,609,摩根大通,2023-05-10,8440
6005,群益證,672,93,579,摩根大通,2023-05-10,8440
1503,士電,810,236,574,摩根大通,2023-05-10,8440
3017,奇鋐,862,353,509,摩根大通,2023-05-10,8440
2903,遠百,511,14,497,摩根大通,2023-05-10,8440
2731,雄獅,635,149,486,摩根大通,2023-05-10,8440
2317,鴻海,818,358,460,摩根大通,2023-05-10,8440
1504,東元,707,282,425,摩根大通,2023-05-10,8440
2344,華邦電,445,26,419,摩根大通,2023-05-10,8440
2356,英業達,935,519,416,摩根大通,2023-05-10,8440
2301,光寶科,678,282,396,摩根大通,2023-05-10,8440
2883,凱基金,1610,1224,386,摩根大通,2023-05-10,8440
2845,遠東銀,436,52,384,摩根大通,2023-05-10,8440
2515,中工,576,203,373,摩根大通,2023-05-10,8440
2421,建準,905,555,350,摩根大通,2023-05-10,8440
3704,合勤控,404,61,343,摩根大通,2023-05-10,8440
4958,臻鼎-KY,430,91,339,摩根大通,2023-05-10,8440
6276,安鈦克,617,288,329,摩根大通,2023-05-10,8440
2498,宏達電,343,20,323,摩根大通,2023-05-10,8440
2881,富邦金,585,264,321,摩根大通,2023-05-10,8440
2393,億光,316,0,316,摩根大通,2023-05-10,8440
2606,裕民,405,90,315,摩根大通,2023-05-10,8440
2889,國票金,314,1,313,摩根大通,2023-05-10,8440
3661,世芯-KY,654,347,307,摩根大通,2023-05-10,8440
2337,旺宏,484,180,304,摩根大通,2023-05-10,8440
2801,彰銀,664,361,303,摩根大通,2023-05-10,8440
2504,國產,356,57,299,摩根大通,2023-05-10,8440
6288,聯嘉,304,9,295,摩根大通,2023-05-10,8440
3481,群創,310,18,292,摩根大通,2023-05-10,8440
1513,中興電,622,333,289,摩根大通,2023-05-10,8440
6190,萬泰科,291,2,289,摩根大通,2023-05-10,8440
2637,慧洋-KY,284,0,284,摩根大通,2023-05-10,8440
2603,長榮,359,85,274,摩根大通,2023-05-10,8440
8112,至上,353,81,272,摩根大通,2023-05-10,8440
5871,中租-KY,557,286,271,摩根大通,2023-05-10,8440
2542,興富發,381,126,255,摩根大通,2023-05-10,8440
6116,彩晶,343,89,254,摩根大通,2023-05-10,8440
3189,景碩,266,12,254,摩根大通,2023-05-10,8440
3005,神基,266,16,250,摩根大通,2023-05-10,8440
6239,力成,286,37,249,摩根大通,2023-05-10,8440
2330,台積電,2729,993,1736,摩根大通,2023-05-11,8440
2371,大同,1767,45,1722,摩根大通,2023-05-11,8440
2887,台新金,1545,179,1366,摩根大通,2023-05-11,8440
2317,鴻海,1530,240,1290,摩根大通,2023-05-11,8440
2882,國泰金,4507,3250,1257,摩根大通,2023-05-11,8440
2880,華南金,1195,29,1166,摩根大通,2023-05-11,8440
3189,景碩,1221,75,1146,摩根大通,2023-05-11,8440
2881,富邦金,2848,1768,1080,摩根大通,2023-05-11,8440
2393,億光,1009,14,995,摩根大通,2023-05-11,8440
2618,長榮航,2975,2025,950,摩根大通,2023-05-11,8440
2801,彰銀,1127,309,818,摩根大通,2023-05-11,8440
2542,興富發,1427,639,788,摩根大通,2023-05-11,8440
5388,中磊,806,28,778,摩根大通,2023-05-11,8440
2834,臺企銀,1217,510,707,摩根大通,2023-05-11,8440
2303,聯電,1201,574,627,摩根大通,2023-05-11,8440
2634,漢翔,708,131,577,摩根大通,2023-05-11,8440
2457,飛宏,765,210,555,摩根大通,2023-05-11,8440
2206,三陽工業,715,226,489,摩根大通,2023-05-11,8440
1504,東元,1016,528,488,摩根大通,2023-05-11,8440
5880,合庫金,772,294,478,摩根大通,2023-05-11,8440
2449,京元電子,571,96,475,摩根大通,2023-05-11,8440
3006,晶豪科,740,273,467,摩根大通,2023-05-11,8440
2892,第一金,591,136,455,摩根大通,2023-05-11,8440
2495,普安,504,54,450,摩根大通,2023-05-11,8440
3715,定穎投控,511,83,428,摩根大通,2023-05-11,8440
2903,遠百,420,0,420,摩根大通,2023-05-11,8440
2382,廣達,1038,622,416,摩根大通,2023-05-11,8440
2888,新光金,661,248,413,摩根大通,2023-05-11,8440
1710,東聯,495,97,398,摩根大通,2023-05-11,8440
6139,亞翔,739,341,398,摩根大通,2023-05-11,8440
2385,群光,411,17,394,摩根大通,2023-05-11,8440
2515,中工,640,248,392,摩根大通,2023-05-11,8440
4938,和碩,385,4,381,摩根大通,2023-05-11,8440
2912,統一超,419,66,353,摩根大通,2023-05-11,8440
8358,金居,351,36,315,摩根大通,2023-05-11,8440
6005,群益證,481,173,308,摩根大通,2023-05-11,8440
4503,金雨,679,371,308,摩根大通,2023-05-11,8440
1101,台泥,908,607,301,摩根大通,2023-05-11,8440
3596,智易,311,26,285,摩根大通,2023-05-11,8440
2723,美食-KY,374,97,277,摩根大通,2023-05-11,8440
3363,上詮,339,85,254,摩根大通,2023-05-11,8440
8112,至上,334,81,253,摩根大通,2023-05-11,8440
6133,金橋,275,27,248,摩根大通,2023-05-11,8440
1618,合機,272,28,244,摩根大通,2023-05-11,8440
3035,智原,237,0,237,摩根大通,2023-05-11,8440
2471,資通,265,38,227,摩根大通,2023-05-11,8440
3673,TPK-KY,245,21,224,摩根大通,2023-05-11,8440
6799,來頡,225,2,223,摩根大通,2023-05-11,8440
1605,華新,281,61,220,摩根大通,2023-05-11,8440
4162,智擎,220,1,219,摩根大通,2023-05-11,8440
3231,緯創,19075,7664,11411,摩根大通,2023-05-12,8440
2371,大同,7316,137,7179,摩根大通,2023-05-12,8440
2353,宏��,7139,1911,5228,摩根大通,2023-05-12,8440
2324,仁寶,3459,870,2589,摩根大通,2023-05-12,8440
2618,長榮航,2039,252,1787,摩根大通,2023-05-12,8440
2884,玉山金,1583,262,1321,摩根大通,2023-05-12,8440
1609,大亞,1376,145,1231,摩根大通,2023-05-12,8440
2382,廣達,2367,1170,1197,摩根大通,2023-05-12,8440
4919,新唐,1141,36,1105,摩根大通,2023-05-12,8440
2330,台積電,2932,2083,849,摩根大通,2023-05-12,8440
2801,彰銀,1720,942,778,摩根大通,2023-05-12,8440
2880,華南金,1078,342,736,摩根大通,2023-05-12,8440
2377,微星,899,196,703,摩根大通,2023-05-12,8440
2402,毅嘉,765,67,698,摩根大通,2023-05-12,8440
6005,群益證,893,260,633,摩根大通,2023-05-12,8440
3029,零壹,588,0,588,摩根大通,2023-05-12,8440
1519,華城,910,324,586,摩根大通,2023-05-12,8440
2515,中工,595,22,573,摩根大通,2023-05-12,8440
2356,英業達,1980,1521,459,摩根大通,2023-05-12,8440
2206,三陽工業,941,520,421,摩根大通,2023-05-12,8440
2498,宏達電,487,77,410,摩根大通,2023-05-12,8440
2376,技嘉,444,43,401,摩根大通,2023-05-12,8440
8112,至上,464,65,399,摩根大通,2023-05-12,8440
2453,凌群,506,114,392,摩根大通,2023-05-12,8440
3715,定穎投控,622,246,376,摩根大通,2023-05-12,8440
3540,曜越,491,117,374,摩根大通,2023-05-12,8440
3006,晶豪科,408,49,359,摩根大通,2023-05-12,8440
2609,陽明,481,126,355,摩根大通,2023-05-12,8440
6414,樺漢,471,118,353,摩根大通,2023-05-12,8440
2201,裕隆,372,24,348,摩根大通,2023-05-12,8440
6245,立端,359,15,344,摩根大通,2023-05-12,8440
2457,飛宏,457,130,327,摩根大通,2023-05-12,8440
6741,91APP*-KY,463,144,319,摩根大通,2023-05-12,8440
8081,致新,325,13,312,摩根大通,2023-05-12,8440
2634,漢翔,326,16,310,摩根大通,2023-05-12,8440
2337,旺宏,511,209,302,摩根大通,2023-05-12,8440
6415,矽力*-KY,372,73,299,摩根大通,2023-05-12,8440
3056,富華新,343,47,296,摩根大通,2023-05-12,8440
2105,正新,407,118,289,摩根大通,2023-05-12,8440
6122,擎邦,343,65,278,摩根大通,2023-05-12,8440
2352,佳世達,420,143,277,摩根大通,2023-05-12,8440
8011,台通,304,27,277,摩根大通,2023-05-12,8440
3037,欣興,536,268,268,摩根大通,2023-05-12,8440
2454,聯發科,457,193,264,摩根大通,2023-05-12,8440
8044,網家,280,21,259,摩根大通,2023-05-12,8440
5227,立凱-KY,285,32,253,摩根大通,2023-05-12,8440
2883,凱基金,1580,1331,249,摩根大通,2023-05-12,8440
2338,光罩,249,5,244,摩根大通,2023-05-12,8440
3324,雙鴻,323,82,241,摩根大通,2023-05-12,8440
3376,新日興,248,11,237,摩根大通,2023-05-12,8440
2353,宏��,3241,373,2868,摩根大通,2023-05-15,8440
3481,群創,1973,42,1931,摩根大通,2023-05-15,8440
2891,中信金,1874,183,1691,摩根大通,2023-05-15,8440
2883,凱基金,1795,260,1535,摩根大通,2023-05-15,8440
2633,台灣高鐵,1194,15,1179,摩根大通,2023-05-15,8440
2382,廣達,2560,1399,1161,摩根大通,2023-05-15,8440
2371,大同,3729,2597,1132,摩根大通,2023-05-15,8440
2888,新光金,1321,264,1057,摩根大通,2023-05-15,8440
3037,欣興,1434,552,882,摩根大通,2023-05-15,8440
2357,華碩,954,81,873,摩根大通,2023-05-15,8440
2330,台積電,2202,1333,869,摩根大通,2023-05-15,8440
2884,玉山金,798,58,740,摩根大通,2023-05-15,8440
2313,華通,633,0,633,摩根大通,2023-05-15,8440
2801,彰銀,776,187,589,摩根大通,2023-05-15,8440
2002,中鋼,564,44,520,摩根大通,2023-05-15,8440
2885,元大金,657,188,469,摩根大通,2023-05-15,8440
3046,建��,849,385,464,摩根大通,2023-05-15,8440
1101,台泥,759,296,463,摩根大通,2023-05-15,8440
2377,微星,561,104,457,摩根大通,2023-05-15,8440
6712,長聖,643,206,437,摩根大通,2023-05-15,8440
5876,上海商銀,443,30,413,摩根大通,2023-05-15,8440
1303,南亞,416,18,398,摩根大通,2023-05-15,8440
2105,正新,412,26,386,摩根大通,2023-05-15,8440
2892,第一金,488,125,363,摩根大通,2023-05-15,8440
4919,新唐,383,21,362,摩根大通,2023-05-15,8440
2881,富邦金,598,244,354,摩根大通,2023-05-15,8440
4904,遠傳,396,54,342,摩根大通,2023-05-15,8440
6806,森崴能源,366,43,323,摩根大通,2023-05-15,8440
1314,中石化,480,189,291,摩根大通,2023-05-15,8440
2308,台達電,402,114,288,摩根大通,2023-05-15,8440
1218,泰山,277,1,276,摩根大通,2023-05-15,8440
8112,至上,275,11,264,摩根大通,2023-05-15,8440
1229,聯華,272,16,256,摩根大通,2023-05-15,8440
1104,環泥,277,27,250,摩根大通,2023-05-15,8440
2347,聯強,393,148,245,摩根大通,2023-05-15,8440
3711,日月光投控,551,313,238,摩根大通,2023-05-15,8440
3673,TPK-KY,252,19,233,摩根大通,2023-05-15,8440
6005,群益證,808,577,231,摩根大通,2023-05-15,8440
2743,山富,300,75,225,摩根大通,2023-05-15,8440
2383,台光電,234,17,217,摩根大通,2023-05-15,8440
1710,東聯,220,14,206,摩根大通,2023-05-15,8440
3202,樺晟,771,568,203,摩根大通,2023-05-15,8440
3265,台星科,204,13,191,摩根大通,2023-05-15,8440
2615,萬海,188,0,188,摩根大通,2023-05-15,8440
2504,國產,251,63,188,摩根大通,2023-05-15,8440
8358,金居,194,6,188,摩根大通,2023-05-15,8440
2889,國票金,215,60,155,摩根大通,2023-05-15,8440
3017,奇鋐,277,131,146,摩根大通,2023-05-15,8440
2605,新興,144,2,142,摩根大通,2023-05-15,8440
2301,光寶科,341,201,140,摩根大通,2023-05-15,8440
2382,廣達,3932,890,3042,摩根大通,2023-05-16,8440
2317,鴻海,4385,1453,2932,摩根大通,2023-05-16,8440
3037,欣興,2299,504,1795,摩根大通,2023-05-16,8440
2618,長榮航,1811,517,1294,摩根大通,2023-05-16,8440
2610,華航,1107,2,1105,摩根大通,2023-05-16,8440
2891,中信金,2729,1636,1093,摩根大通,2023-05-16,8440
2105,正新,1239,187,1052,摩根大通,2023-05-16,8440
2324,仁寶,1370,421,949,摩根大通,2023-05-16,8440
3481,群創,932,5,927,摩根大通,2023-05-16,8440
8069,元太,945,42,903,摩根大通,2023-05-16,8440
2884,玉山金,2543,1710,833,摩根大通,2023-05-16,8440
2352,佳世達,854,70,784,摩根大通,2023-05-16,8440
1519,華城,1017,362,655,摩根大通,2023-05-16,8440
2880,華南金,699,47,652,摩根大通,2023-05-16,8440
1303,南亞,654,10,644,摩根大通,2023-05-16,8440
3715,定穎投控,1473,846,627,摩根大通,2023-05-16,8440
2201,裕隆,705,116,589,摩根大通,2023-05-16,8440
2888,新光金,1371,803,568,摩根大通,2023-05-16,8440
2498,宏達電,558,9,549,摩根大通,2023-05-16,8440
2353,宏��,1279,734,545,摩根大通,2023-05-16,8440
4958,臻鼎-KY,650,108,542,摩根大通,2023-05-16,8440
2615,萬海,562,34,528,摩根大通,2023-05-16,8440
3702,大聯大,480,16,464,摩根大通,2023-05-16,8440
1609,大亞,547,83,464,摩根大通,2023-05-16,8440
2368,金像電,526,79,447,摩根大通,2023-05-16,8440
3022,威強電,628,199,429,摩根大通,2023-05-16,8440
2457,飛宏,526,112,414,摩根大通,2023-05-16,8440
2376,技嘉,880,514,366,摩根大通,2023-05-16,8440
6223,旺矽,408,46,362,摩根大通,2023-05-16,8440
2402,毅嘉,636,286,350,摩根大通,2023-05-16,8440
2308,台達電,328,15,313,摩根大通,2023-05-16,8440
6558,興能高,362,59,303,摩根大通,2023-05-16,8440
6214,精誠,318,27,291,摩根大通,2023-05-16,8440
2377,微星,441,162,279,摩根大通,2023-05-16,8440
6770,力積電,316,38,278,摩根大通,2023-05-16,8440
2887,台新金,521,246,275,摩根大通,2023-05-16,8440
2408,南亞科,314,51,263,摩根大通,2023-05-16,8440
3189,景碩,261,25,236,摩根大通,2023-05-16,8440
8050,廣積,228,0,228,摩根大通,2023-05-16,8440
4919,新唐,246,18,228,摩根大通,2023-05-16,8440
2101,南港,245,18,227,摩根大通,2023-05-16,8440
1301,台塑,336,109,227,摩根大通,2023-05-16,8440
8927,北基,252,26,226,摩根大通,2023-05-16,8440
4743,合一,228,4,224,摩根大通,2023-05-16,8440
2515,中工,286,68,218,摩根大通,2023-05-16,8440
4904,遠傳,365,149,216,摩根大通,2023-05-16,8440
6414,樺漢,222,14,208,摩根大通,2023-05-16,8440
3006,晶豪科,380,174,206,摩根大通,2023-05-16,8440
6160,欣技,345,139,206,摩根大通,2023-05-16,8440
1905,華紙,221,16,205,摩根大通,2023-05-16,8440
2317,鴻海,6525,841,5684,摩根大通,2023-05-17,8440
2883,凱基金,5120,23,5097,摩根大通,2023-05-17,8440
3037,欣興,4874,319,4555,摩根大通,2023-05-17,8440
2303,聯電,5114,1034,4080,摩根大通,2023-05-17,8440
2888,新光金,3576,408,3168,摩根大通,2023-05-17,8440
2884,玉山金,4119,996,3123,摩根大通,2023-05-17,8440
2002,中鋼,3239,214,3025,摩根大通,2023-05-17,8440
2885,元大金,2996,46,2950,摩根大通,2023-05-17,8440
2834,臺企銀,2823,70,2753,摩根大通,2023-05-17,8440
2887,台新金,3017,440,2577,摩根大通,2023-05-17,8440
2201,裕隆,2511,95,2416,摩根大通,2023-05-17,8440
3673,TPK-KY,2430,23,2407,摩根大通,2023-05-17,8440
2801,彰銀,2519,137,2382,摩根大通,2023-05-17,8440
2881,富邦金,2336,60,2276,摩根大通,2023-05-17,8440
2408,南亞科,2261,71,2190,摩根大通,2023-05-17,8440
1301,台塑,2357,272,2085,摩根大通,2023-05-17,8440
2330,台積電,4888,3023,1865,摩根大通,2023-05-17,8440
2880,華南金,2349,495,1854,摩根大通,2023-05-17,8440
1303,南亞,1826,39,1787,摩根大通,2023-05-17,8440
2886,兆豐金,2200,473,1727,摩根大通,2023-05-17,8440
2633,台灣高鐵,1786,172,1614,摩根大通,2023-05-17,8440
2324,仁寶,2150,559,1591,摩根大通,2023-05-17,8440
5880,合庫金,2055,594,1461,摩根大通,2023-05-17,8440
2892,第一金,2257,825,1432,摩根大通,2023-05-17,8440
8069,元太,1345,88,1257,摩根大通,2023-05-17,8440
4938,和碩,1276,68,1208,摩根大通,2023-05-17,8440
2897,王道銀行,963,2,961,摩根大通,2023-05-17,8440
3711,日月光投控,2004,1080,924,摩根大通,2023-05-17,8440
5243,乙盛-KY,941,20,921,摩根大通,2023-05-17,8440
2353,宏��,1326,438,888,摩根大通,2023-05-17,8440
2412,中華電,1072,196,876,摩根大通,2023-05-17,8440
1795,美時,1147,315,832,摩根大通,2023-05-17,8440
2368,金像電,915,86,829,摩根大通,2023-05-17,8440
6505,台塑化,819,43,776,摩根大通,2023-05-17,8440
2515,中工,770,0,770,摩根大通,2023-05-17,8440
2812,台中銀,880,136,744,摩根大通,2023-05-17,8440
2845,遠東銀,811,101,710,摩根大通,2023-05-17,8440
2206,三陽工業,1024,316,708,摩根大通,2023-05-17,8440
2498,宏達電,723,19,704,摩根大通,2023-05-17,8440
2618,長榮航,1353,656,697,摩根大通,2023-05-17,8440
2615,萬海,692,33,659,摩根大通,2023-05-17,8440
2882,國泰金,2080,1476,604,摩根大通,2023-05-17,8440
2891,中信金,3891,3287,604,摩根大通,2023-05-17,8440
2308,台達電,717,117,600,摩根大通,2023-05-17,8440
2409,友達,1435,877,558,摩根大通,2023-05-17,8440
2352,佳世達,884,336,548,摩根大通,2023-05-17,8440
2889,國票金,652,114,538,摩根大通,2023-05-17,8440
5876,上海商銀,690,199,491,摩根大通,2023-05-17,8440
1710,東聯,517,40,477,摩根大通,2023-05-17,8440
6770,力積電,819,342,477,摩根大通,2023-05-17,8440
2330,台積電,10013,1759,8254,摩根大通,2023-05-18,8440
2317,鴻海,6765,533,6232,摩根大通,2023-05-18,8440
3037,欣興,6073,436,5637,摩根大通,2023-05-18,8440
2618,長榮航,5721,883,4838,摩根大通,2023-05-18,8440
2344,華邦電,5080,469,4611,摩根大通,2023-05-18,8440
2891,中信金,5002,1329,3673,摩根大通,2023-05-18,8440
2884,玉山金,4011,721,3290,摩根大通,2023-05-18,8440
2303,聯電,3359,443,2916,摩根大通,2023-05-18,8440
2880,華南金,2955,39,2916,摩根大通,2023-05-18,8440
3231,緯創,3911,1155,2756,摩根大通,2023-05-18,8440
2885,元大金,2494,11,2483,摩根大通,2023-05-18,8440
2002,中鋼,2727,310,2417,摩根大通,2023-05-18,8440
2888,新光金,3564,1167,2397,摩根大通,2023-05-18,8440
2886,兆豐金,2489,252,2237,摩根大通,2023-05-18,8440
2323,中環,2352,199,2153,摩根大通,2023-05-18,8440
2882,國泰金,2404,263,2141,摩根大通,2023-05-18,8440
3481,群創,1787,1,1786,摩根大通,2023-05-18,8440
1795,美時,2019,337,1682,摩根大通,2023-05-18,8440
2881,富邦金,1942,260,1682,摩根大通,2023-05-18,8440
2883,凱基金,2161,500,1661,摩根大通,2023-05-18,8440
2892,第一金,2273,710,1563,摩根大通,2023-05-18,8440
3711,日月光投控,2026,555,1471,摩根大通,2023-05-18,8440
2801,彰銀,1504,42,1462,摩根大通,2023-05-18,8440
6282,康舒,1447,55,1392,摩根大通,2023-05-18,8440
1303,南亞,1358,39,1319,摩根大通,2023-05-18,8440
1101,台泥,1375,70,1305,摩根大通,2023-05-18,8440
2409,友達,1553,480,1073,摩根大通,2023-05-18,8440
6005,群益證,1044,0,1044,摩根大通,2023-05-18,8440
2308,台達電,1101,80,1021,摩根大通,2023-05-18,8440
5880,合庫金,1871,870,1001,摩根大通,2023-05-18,8440
2610,華航,1226,229,997,摩根大通,2023-05-18,8440
2887,台新金,2156,1199,957,摩根大通,2023-05-18,8440
2368,金像電,1117,183,934,摩根大通,2023-05-18,8440
2356,英業達,1521,596,925,摩根大通,2023-05-18,8440
5876,上海商銀,933,55,878,摩根大通,2023-05-18,8440
2834,臺企銀,1078,274,804,摩根大通,2023-05-18,8440
1605,華新,938,155,783,摩根大通,2023-05-18,8440
1301,台塑,877,117,760,摩根大通,2023-05-18,8440
3078,僑威,894,202,692,摩根大通,2023-05-18,8440
1609,大亞,958,268,690,摩根大通,2023-05-18,8440
2412,中華電,961,312,649,摩根大通,2023-05-18,8440
6770,力積電,637,19,618,摩根大通,2023-05-18,8440
2903,遠百,619,5,614,摩根大通,2023-05-18,8440
1504,東元,1828,1214,614,摩根大通,2023-05-18,8440
3706,神達,639,33,606,摩根大通,2023-05-18,8440
8069,元太,1374,784,590,摩根大通,2023-05-18,8440
1402,遠東新,1021,441,580,摩根大通,2023-05-18,8440
2208,台船,568,5,563,摩根大通,2023-05-18,8440
2324,仁寶,1194,663,531,摩根大通,2023-05-18,8440
1326,台化,672,157,515,摩根大通,2023-05-18,8440
2618,長榮航,15184,2109,13075,摩根大通,2023-05-19,8440
2330,台積電,7694,333,7361,摩根大通,2023-05-19,8440
6282,康舒,5202,689,4513,摩根大通,2023-05-19,8440
2610,華航,4758,349,4409,摩根大通,2023-05-19,8440
2382,廣達,6132,1892,4240,摩根大通,2023-05-19,8440
2884,玉山金,2711,52,2659,摩根大通,2023-05-19,8440
2324,仁寶,2695,84,2611,摩根大通,2023-05-19,8440
2344,華邦電,3379,840,2539,摩根大通,2023-05-19,8440
2801,彰銀,2459,139,2320,摩根大通,2023-05-19,8440
3706,神達,2174,484,1690,摩根大通,2023-05-19,8440
1301,台塑,1754,78,1676,摩根大通,2023-05-19,8440
3037,欣興,1843,199,1644,摩根大通,2023-05-19,8440
2421,建準,2243,659,1584,摩根大通,2023-05-19,8440
5880,合庫金,1736,205,1531,摩根大通,2023-05-19,8440
2887,台新金,2352,829,1523,摩根大通,2023-05-19,8440
2880,華南金,1520,34,1486,摩根大通,2023-05-19,8440
2542,興富發,1561,84,1477,摩根大通,2023-05-19,8440
2353,宏��,1806,490,1316,摩根大通,2023-05-19,8440
2886,兆豐金,1306,4,1302,摩根大通,2023-05-19,8440
2412,中華電,1391,116,1275,摩根大通,2023-05-19,8440
2883,凱基金,2563,1310,1253,摩根大通,2023-05-19,8440
2303,聯電,3214,1986,1228,摩根大通,2023-05-19,8440
2888,新光金,1666,442,1224,摩根大通,2023-05-19,8440
2408,南亞科,1373,228,1145,摩根大通,2023-05-19,8440
2356,英業達,1171,79,1092,摩根大通,2023-05-19,8440
2002,中鋼,1521,446,1075,摩根大通,2023-05-19,8440
1402,遠東新,1189,174,1015,摩根大通,2023-05-19,8440
2442,新美齊,1167,176,991,摩根大通,2023-05-19,8440
2867,三商壽,1152,170,982,摩根大通,2023-05-19,8440
3038,全台,1025,58,967,摩根大通,2023-05-19,8440
2882,國泰金,1766,815,951,摩根大通,2023-05-19,8440
2834,臺企銀,1616,668,948,摩根大通,2023-05-19,8440
3702,大聯大,916,18,898,摩根大通,2023-05-19,8440
1101,台泥,927,33,894,摩根大通,2023-05-19,8440
2352,佳世達,1084,258,826,摩根大通,2023-05-19,8440
2615,萬海,913,106,807,摩根大通,2023-05-19,8440
4938,和碩,821,72,749,摩根大通,2023-05-19,8440
0050,元大台灣50,730,0,730,摩根大通,2023-05-19,8440
1303,南亞,882,215,667,摩根大通,2023-05-19,8440
2368,金像電,885,235,650,摩根大通,2023-05-19,8440
6505,台塑化,665,34,631,摩根大通,2023-05-19,8440
6235,華孚,757,150,607,摩根大通,2023-05-19,8440
3163,波若威,731,126,605,摩根大通,2023-05-19,8440
3481,群創,863,261,602,摩根大通,2023-05-19,8440
5876,上海商銀,679,108,571,摩根大通,2023-05-19,8440
5243,乙盛-KY,807,254,553,摩根大通,2023-05-19,8440
8069,元太,711,165,546,摩根大通,2023-05-19,8440
2812,台中銀,530,0,530,摩根大通,2023-05-19,8440
2308,台達電,603,80,523,摩根大通,2023-05-19,8440
3711,日月光投控,1069,599,470,摩根大通,2023-05-19,8440
2883,凱基金,5129,367,4762,摩根大通,2023-05-22,8440
2002,中鋼,4391,188,4203,摩根大通,2023-05-22,8440
2890,永豐金,3692,215,3477,摩根大通,2023-05-22,8440
3481,群創,2818,70,2748,摩根大通,2023-05-22,8440
2324,仁寶,3573,987,2586,摩根大通,2023-05-22,8440
3711,日月光投控,2865,446,2419,摩根大通,2023-05-22,8440
2317,鴻海,2745,470,2275,摩根大通,2023-05-22,8440
2618,長榮航,8332,6097,2235,摩根大通,2023-05-22,8440
2353,宏��,2623,594,2029,摩根大通,2023-05-22,8440
2382,廣達,1803,223,1580,摩根大通,2023-05-22,8440
2886,兆豐金,1692,152,1540,摩根大通,2023-05-22,8440
0050,元大台灣50,1508,0,1508,摩根大通,2023-05-22,8440
2356,英業達,1987,662,1325,摩根大通,2023-05-22,8440
2610,華航,3428,2167,1261,摩根大通,2023-05-22,8440
2330,台積電,2762,1565,1197,摩根大通,2023-05-22,8440
2897,王道銀行,1175,57,1118,摩根大通,2023-05-22,8440
2027,大成鋼,1119,1,1118,摩根大通,2023-05-22,8440
2542,興富發,1083,27,1056,摩根大通,2023-05-22,8440
2104,國際中橡,936,0,936,摩根大通,2023-05-22,8440
2867,三商壽,1292,362,930,摩根大通,2023-05-22,8440
1513,中興電,2011,1138,873,摩根大通,2023-05-22,8440
2402,毅嘉,974,107,867,摩根大通,2023-05-22,8440
2634,漢翔,904,85,819,摩根大通,2023-05-22,8440
1609,大亞,1009,246,763,摩根大通,2023-05-22,8440
2884,玉山金,1271,528,743,摩根大通,2023-05-22,8440
2427,三商電,1172,465,707,摩根大通,2023-05-22,8440
2368,金像電,1632,933,699,摩根大通,2023-05-22,8440
2882,國泰金,1417,719,698,摩根大通,2023-05-22,8440
2409,友達,2418,1826,592,摩根大通,2023-05-22,8440
3078,僑威,578,9,569,摩根大通,2023-05-22,8440
6282,康舒,2254,1696,558,摩根大通,2023-05-22,8440
4927,泰鼎-KY,573,24,549,摩根大通,2023-05-22,8440
2883B,凱基金乙特,537,0,537,摩根大通,2023-05-22,8440
1907,永豐餘,580,60,520,摩根大通,2023-05-22,8440
2888,新光金,774,267,507,摩根大通,2023-05-22,8440
2892,第一金,1329,824,505,摩根大通,2023-05-22,8440
8926,台汽電,500,3,497,摩根大通,2023-05-22,8440
2504,國產,516,33,483,摩根大通,2023-05-22,8440
2891,中信金,1190,739,451,摩根大通,2023-05-22,8440
2881,富邦金,501,61,440,摩根大通,2023-05-22,8440
1319,東陽,444,12,432,摩根大通,2023-05-22,8440
2492,華新科,428,3,425,摩根大通,2023-05-22,8440
6163,華電網,438,14,424,摩根大通,2023-05-22,8440
2834,臺企銀,491,95,396,摩根大通,2023-05-22,8440
1605,華新,524,137,387,摩根大通,2023-05-22,8440
1227,佳格,383,4,379,摩根大通,2023-05-22,8440
1785,光洋科,409,41,368,摩根大通,2023-05-22,8440
3715,定穎投控,402,35,367,摩根大通,2023-05-22,8440
2399,映泰,672,309,363,摩根大通,2023-05-22,8440
1589,永冠-KY,392,37,355,摩根大通,2023-05-22,8440
2618,長榮航,7602,2847,4755,摩根大通,2023-05-23,8440
2883,凱基金,3921,33,3888,摩根大通,2023-05-23,8440
2317,鴻海,3151,94,3057,摩根大通,2023-05-23,8440
2344,華邦電,2525,225,2300,摩根大通,2023-05-23,8440
2002,中鋼,2102,191,1911,摩根大通,2023-05-23,8440
2402,毅嘉,1935,44,1891,摩根大通,2023-05-23,8440
1907,永豐餘,2042,214,1828,摩根大通,2023-05-23,8440
2330,台積電,2828,1062,1766,摩根大通,2023-05-23,8440
2324,仁寶,3317,1617,1700,摩根大通,2023-05-23,8440
0050,元大台灣50,1683,0,1683,摩根大通,2023-05-23,8440
6282,康舒,1944,578,1366,摩根大通,2023-05-23,8440
2889,國票金,1195,4,1191,摩根大通,2023-05-23,8440
2031,新光鋼,1150,0,1150,摩根大通,2023-05-23,8440
2867,三商壽,1199,53,1146,摩根大通,2023-05-23,8440
2884,玉山金,1161,68,1093,摩根大通,2023-05-23,8440
3231,緯創,2399,1356,1043,摩根大通,2023-05-23,8440
2610,華航,2011,1037,974,摩根大通,2023-05-23,8440
2888,新光金,1281,355,926,摩根大通,2023-05-23,8440
2027,大成鋼,909,78,831,摩根大通,2023-05-23,8440
2881,富邦金,848,152,696,摩根大通,2023-05-23,8440
2408,南亞科,1204,535,669,摩根大通,2023-05-23,8440
6223,旺矽,641,2,639,摩根大通,2023-05-23,8440
2377,微星,689,66,623,摩根大通,2023-05-23,8440
2882,國泰金,1552,949,603,摩根大通,2023-05-23,8440
2542,興富發,690,90,600,摩根大通,2023-05-23,8440
3037,欣興,589,61,528,摩根大通,2023-05-23,8440
2323,中環,808,291,517,摩根大通,2023-05-23,8440
2457,飛宏,599,82,517,摩根大通,2023-05-23,8440
2103,台橡,471,0,471,摩根大通,2023-05-23,8440
6274,台燿,693,233,460,摩根大通,2023-05-23,8440
1301,台塑,516,57,459,摩根大通,2023-05-23,8440
2886,兆豐金,853,403,450,摩根大通,2023-05-23,8440
6122,擎邦,475,35,440,摩根大通,2023-05-23,8440
3702,大聯大,652,217,435,摩根大通,2023-05-23,8440
1303,南亞,616,191,425,摩根大通,2023-05-23,8440
1785,光洋科,429,5,424,摩根大通,2023-05-23,8440
3481,群創,869,494,375,摩根大通,2023-05-23,8440
2201,裕隆,640,269,371,摩根大通,2023-05-23,8440
1314,中石化,645,293,352,摩根大通,2023-05-23,8440
6005,群益證,366,14,352,摩根大通,2023-05-23,8440
2357,華碩,554,215,339,摩根大通,2023-05-23,8440
6233,旺玖,355,20,335,摩根大通,2023-05-23,8440
3005,神基,415,81,334,摩根大通,2023-05-23,8440
2371,大同,504,179,325,摩根大通,2023-05-23,8440
2486,一詮,317,2,315,摩根大通,2023-05-23,8440
6288,聯嘉,389,77,312,摩根大通,2023-05-23,8440
3705,永信,307,0,307,摩根大通,2023-05-23,8440
3591,艾笛森,534,236,298,摩根大通,2023-05-23,8440
2633,台灣高鐵,338,56,282,摩根大通,2023-05-23,8440
1589,永冠-KY,313,40,273,摩根大通,2023-05-23,8440
2618,長榮航,3479,531,2948,摩根大通,2023-05-24,8440
2317,鴻海,2401,320,2081,摩根大通,2023-05-24,8440
0050,元大台灣50,1652,0,1652,摩根大通,2023-05-24,8440
2891,中信金,2193,735,1458,摩根大通,2023-05-24,8440
2889,國票金,1453,8,1445,摩根大通,2023-05-24,8440
2883,凱基金,1740,305,1435,摩根大通,2023-05-24,8440
2402,毅嘉,1188,251,937,摩根大通,2023-05-24,8440
2330,台積電,1849,965,884,摩根大通,2023-05-24,8440
3037,欣興,1070,195,875,摩根大通,2023-05-24,8440
2323,中環,920,106,814,摩根大通,2023-05-24,8440
2812,台中銀,847,68,779,摩根大通,2023-05-24,8440
3715,定穎投控,807,45,762,摩根大通,2023-05-24,8440
6282,康舒,902,152,750,摩根大通,2023-05-24,8440
5483,中美晶,726,39,687,摩根大通,2023-05-24,8440
1909,榮成,615,9,606,摩根大通,2023-05-24,8440
5469,瀚宇博,612,10,602,摩根大通,2023-05-24,8440
1785,光洋科,675,82,593,摩根大通,2023-05-24,8440
2382,廣達,1227,659,568,摩根大通,2023-05-24,8440
2610,華航,763,212,551,摩根大通,2023-05-24,8440
2208,台船,535,49,486,摩根大通,2023-05-24,8440
2347,聯強,671,189,482,摩根大通,2023-05-24,8440
2458,義隆,495,17,478,摩根大通,2023-05-24,8440
2515,中工,440,0,440,摩根大通,2023-05-24,8440
5512,力麒,629,189,440,摩根大通,2023-05-24,8440
1809,中釉,508,86,422,摩根大通,2023-05-24,8440
1907,永豐餘,544,132,412,摩根大通,2023-05-24,8440
1717,長興,422,11,411,摩根大通,2023-05-24,8440
2344,華邦電,766,364,402,摩根大通,2023-05-24,8440
2537,聯上發,379,0,379,摩根大通,2023-05-24,8440
2371,大同,639,271,368,摩根大通,2023-05-24,8440
1310,台苯,513,163,350,摩根大通,2023-05-24,8440
2393,億光,475,130,345,摩根大通,2023-05-24,8440
2399,映泰,683,347,336,摩根大通,2023-05-24,8440
4950,牧東,346,15,331,摩根大通,2023-05-24,8440
2504,國產,318,0,318,摩根大通,2023-05-24,8440
1710,東聯,311,0,311,摩根大通,2023-05-24,8440
6244,茂迪,310,5,305,摩根大通,2023-05-24,8440
2408,南亞科,1031,727,304,摩根大通,2023-05-24,8440
1503,士電,428,128,300,摩根大通,2023-05-24,8440
8996,高力,360,65,295,摩根大通,2023-05-24,8440
8927,北基,304,25,279,摩根大通,2023-05-24,8440
2609,陽明,319,44,275,摩根大通,2023-05-24,8440
6191,精成科,309,40,269,摩根大通,2023-05-24,8440
2486,一詮,277,14,263,摩根大通,2023-05-24,8440
1815,富喬,255,3,252,摩根大通,2023-05-24,8440
2027,大成鋼,250,2,248,摩根大通,2023-05-24,8440
2308,台達電,367,129,238,摩根大通,2023-05-24,8440
2368,金像電,245,16,229,摩根大通,2023-05-24,8440
1519,華城,384,155,229,摩根大通,2023-05-24,8440
1714,和桐,222,0,222,摩根大通,2023-05-24,8440
2330,台積電,8236,1251,6985,摩根大通,2023-05-25,8440
3037,欣興,4123,632,3491,摩根大通,2023-05-25,8440
2408,南亞科,3603,750,2853,摩根大通,2023-05-25,8440
6125,廣運,1514,17,1497,摩根大通,2023-05-25,8440
2353,宏��,2191,752,1439,摩根大通,2023-05-25,8440
0050,元大台灣50,1434,0,1434,摩根大通,2023-05-25,8440
2889,國票金,1468,163,1305,摩根大通,2023-05-25,8440
3443,創意,998,134,864,摩根大通,2023-05-25,8440
2376,技嘉,1189,346,843,摩根大通,2023-05-25,8440
2371,大同,2192,1417,775,摩根大通,2023-05-25,8440
5469,瀚宇博,663,40,623,摩根大通,2023-05-25,8440
8046,南電,959,359,600,摩根大通,2023-05-25,8440
2382,廣達,1076,478,598,摩根大通,2023-05-25,8440
3013,晟銘電,1010,414,596,摩根大通,2023-05-25,8440
2368,金像電,872,295,577,摩根大通,2023-05-25,8440
3702,大聯大,756,217,539,摩根大通,2023-05-25,8440
2383,台光電,764,236,528,摩根大通,2023-05-25,8440
2327,國巨,576,73,503,摩根大通,2023-05-25,8440
1101,台泥,546,55,491,摩根大通,2023-05-25,8440
5706,鳳凰,961,476,485,摩根大通,2023-05-25,8440
3044,健鼎,456,15,441,摩根大通,2023-05-25,8440
9958,世紀鋼,398,18,380,摩根大通,2023-05-25,8440
2313,華通,377,8,369,摩根大通,2023-05-25,8440
3029,零壹,420,86,334,摩根大通,2023-05-25,8440
1402,遠東新,766,440,326,摩根大通,2023-05-25,8440
3587,閎康,329,13,316,摩根大通,2023-05-25,8440
2312,金寶,309,11,298,摩根大通,2023-05-25,8440
2486,一詮,302,8,294,摩根大通,2023-05-25,8440
2722,夏都,538,248,290,摩根大通,2023-05-25,8440
6288,聯嘉,396,109,287,摩根大通,2023-05-25,8440
2328,廣宇,419,133,286,摩根大通,2023-05-25,8440
2208,台船,320,55,265,摩根大通,2023-05-25,8440
2492,華新科,298,35,263,摩根大通,2023-05-25,8440
4147,中裕,301,48,253,摩根大通,2023-05-25,8440
1608,華榮,620,374,246,摩根大通,2023-05-25,8440
1717,長興,278,34,244,摩根大通,2023-05-25,8440
6239,力成,290,54,236,摩根大通,2023-05-25,8440
6121,新普,223,0,223,摩根大通,2023-05-25,8440
2103,台橡,228,6,222,摩根大通,2023-05-25,8440
2349,錸德,382,161,221,摩根大通,2023-05-25,8440
4915,致伸,445,228,217,摩根大通,2023-05-25,8440
2409,友達,224,8,216,摩根大通,2023-05-25,8440
2892,第一金,400,188,212,摩根大通,2023-05-25,8440
2027,大成鋼,279,72,207,摩根大通,2023-05-25,8440
8155,博智,233,26,207,摩根大通,2023-05-25,8440
2395,研華,199,3,196,摩根大通,2023-05-25,8440
3338,泰碩,232,37,195,摩根大通,2023-05-25,8440
6191,精成科,304,112,192,摩根大通,2023-05-25,8440
8011,台通,249,57,192,摩根大通,2023-05-25,8440
2399,映泰,748,558,190,摩根大通,2023-05-25,8440
2330,台積電,8717,2699,6018,摩根大通,2023-05-26,8440
3037,欣興,5417,660,4757,摩根大通,2023-05-26,8440
2888,新光金,4222,847,3375,摩根大通,2023-05-26,8440
2886,兆豐金,3893,894,2999,摩根大通,2023-05-26,8440
2324,仁寶,5136,2792,2344,摩根大通,2023-05-26,8440
2382,廣達,2509,729,1780,摩根大通,2023-05-26,8440
2353,宏��,1811,261,1550,摩根大通,2023-05-26,8440
2454,聯發科,2267,832,1435,摩根大通,2023-05-26,8440
2449,京元電子,1291,76,1215,摩根大通,2023-05-26,8440
8069,元太,1374,218,1156,摩根大通,2023-05-26,8440
2371,大同,2096,1005,1091,摩根大通,2023-05-26,8440
4938,和碩,1282,202,1080,摩根大通,2023-05-26,8440
0050,元大台灣50,958,0,958,摩根大通,2023-05-26,8440
2412,中華電,1062,151,911,摩根大通,2023-05-26,8440
2421,建準,1688,824,864,摩根大通,2023-05-26,8440
2345,智邦,907,157,750,摩根大通,2023-05-26,8440
2323,中環,3692,2952,740,摩根大通,2023-05-26,8440
3481,群創,1161,469,692,摩根大通,2023-05-26,8440
2892,第一金,1196,552,644,摩根大通,2023-05-26,8440
3661,世芯-KY,672,53,619,摩根大通,2023-05-26,8440
2376,技嘉,1687,1116,571,摩根大通,2023-05-26,8440
2383,台光電,878,314,564,摩根大通,2023-05-26,8440
2337,旺宏,965,430,535,摩根大通,2023-05-26,8440
2308,台達電,987,464,523,摩根大通,2023-05-26,8440
2206,三陽工業,578,62,516,摩根大通,2023-05-26,8440
2455,全新,518,52,466,摩根大通,2023-05-26,8440
2885,元大金,1140,702,438,摩根大通,2023-05-26,8440
2492,華新科,416,40,376,摩根大通,2023-05-26,8440
2441,超豐,443,86,357,摩根大通,2023-05-26,8440
2313,華通,430,75,355,摩根大通,2023-05-26,8440
1519,華城,543,199,344,摩根大通,2023-05-26,8440
4979,華星光,513,212,301,摩根大通,2023-05-26,8440
2360,致茂,631,334,297,摩根大通,2023-05-26,8440
3013,晟銘電,407,111,296,摩根大通,2023-05-26,8440
6147,頎邦,266,1,265,摩根大通,2023-05-26,8440
6669,緯穎,515,260,255,摩根大通,2023-05-26,8440
8150,南茂,252,11,241,摩根大通,2023-05-26,8440
6026,福邦證,294,53,241,摩根大通,2023-05-26,8440
6191,精成科,434,202,232,摩根大通,2023-05-26,8440
2393,億光,236,12,224,摩根大通,2023-05-26,8440
2395,研華,252,35,217,摩根大通,2023-05-26,8440
6112,邁達特,241,30,211,摩根大通,2023-05-26,8440
2408,南亞科,1363,1159,204,摩根大通,2023-05-26,8440
2897,王道銀行,218,16,202,摩根大通,2023-05-26,8440
6016,康和證,208,14,194,摩根大通,2023-05-26,8440
6197,佳必琪,259,72,187,摩根大通,2023-05-26,8440
6535,順藥,267,81,186,摩根大通,2023-05-26,8440
2486,一詮,368,183,185,摩根大通,2023-05-26,8440
2317,鴻海,1379,1215,164,摩根大通,2023-05-26,8440
9943,好樂迪,176,13,163,摩根大通,2023-05-26,8440
2330,台積電,10567,1426,9141,摩根大通,2023-05-29,8440
2888,新光金,6289,56,6233,摩根大通,2023-05-29,8440
2317,鴻海,5007,108,4899,摩根大通,2023-05-29,8440
2886,兆豐金,5054,859,4195,摩根大通,2023-05-29,8440
2324,仁寶,4001,1482,2519,摩根大通,2023-05-29,8440
3481,群創,4960,2483,2477,摩根大通,2023-05-29,8440
2882,國泰金,4346,2014,2332,摩根大通,2023-05-29,8440
0050,元大台灣50,2187,0,2187,摩根大通,2023-05-29,8440
2610,華航,4243,2377,1866,摩根大通,2023-05-29,8440
2412,中華電,2073,417,1656,摩根大通,2023-05-29,8440
2344,華邦電,3054,1751,1303,摩根大通,2023-05-29,8440
2409,友達,1409,135,1274,摩根大通,2023-05-29,8440
2408,南亞科,1224,207,1017,摩根大通,2023-05-29,8440
2327,國巨,1003,44,959,摩根大通,2023-05-29,8440
3715,定穎投控,958,2,956,摩根大通,2023-05-29,8440
5347,世界,1034,88,946,摩根大通,2023-05-29,8440
2353,宏��,1325,418,907,摩根大通,2023-05-29,8440
2892,第一金,1636,752,884,摩根大通,2023-05-29,8440
2328,廣宇,897,57,840,摩根大通,2023-05-29,8440
2498,宏達電,886,54,832,摩根大通,2023-05-29,8440
1101,台泥,1633,822,811,摩根大通,2023-05-29,8440
1905,華紙,798,0,798,摩根大通,2023-05-29,8440
3264,欣銓,795,104,691,摩根大通,2023-05-29,8440
2603,長榮,670,41,629,摩根大通,2023-05-29,8440
3029,零壹,667,38,629,摩根大通,2023-05-29,8440
5876,上海商銀,917,317,600,摩根大通,2023-05-29,8440
2885,元大金,978,410,568,摩根大通,2023-05-29,8440
3338,泰碩,581,31,550,摩根大通,2023-05-29,8440
2457,飛宏,810,267,543,摩根大通,2023-05-29,8440
6125,廣運,747,210,537,摩根大通,2023-05-29,8440
2913,農林,533,10,523,摩根大通,2023-05-29,8440
2634,漢翔,558,38,520,摩根大通,2023-05-29,8440
3013,晟銘電,639,122,517,摩根大通,2023-05-29,8440
2312,金寶,512,0,512,摩根大通,2023-05-29,8440
2471,資通,533,30,503,摩根大通,2023-05-29,8440
2891,中信金,1049,548,501,摩根大通,2023-05-29,8440
2383,台光電,766,275,491,摩根大通,2023-05-29,8440
4958,臻鼎-KY,641,153,488,摩根大通,2023-05-29,8440
2884,玉山金,692,215,477,摩根大通,2023-05-29,8440
3701,大眾控,469,5,464,摩根大通,2023-05-29,8440
6160,欣技,569,113,456,摩根大通,2023-05-29,8440
2027,大成鋼,459,10,449,摩根大通,2023-05-29,8440
1605,華新,419,8,411,摩根大通,2023-05-29,8440
5351,鈺創,418,11,407,摩根大通,2023-05-29,8440
5498,凱崴,409,10,399,摩根大通,2023-05-29,8440
1514,亞力,396,1,395,摩根大通,2023-05-29,8440
2486,一詮,394,5,389,摩根大通,2023-05-29,8440
8936,國統,364,5,359,摩根大通,2023-05-29,8440
6188,廣明,488,131,357,摩根大通,2023-05-29,8440
2492,華新科,370,21,349,摩根大通,2023-05-29,8440
2618,長榮航,10529,2741,7788,摩根大通,2023-05-30,8440
2376,技嘉,3202,89,3113,摩根大通,2023-05-30,8440
2317,鴻海,5844,3617,2227,摩根大通,2023-05-30,8440
2301,光寶科,3355,1177,2178,摩根大通,2023-05-30,8440
0050,元大台灣50,1419,0,1419,摩根大通,2023-05-30,8440
3013,晟銘電,1339,227,1112,摩根大通,2023-05-30,8440
2801,彰銀,1488,395,1093,摩根大通,2023-05-30,8440
2888,新光金,1527,505,1022,摩根大通,2023-05-30,8440
2313,華通,1024,57,967,摩根大通,2023-05-30,8440
2324,仁寶,1049,158,891,摩根大通,2023-05-30,8440
3711,日月光投控,1220,374,846,摩根大通,2023-05-30,8440
2382,廣達,1682,920,762,摩根大通,2023-05-30,8440
2610,華航,4348,3689,659,摩根大通,2023-05-30,8440
4979,華星光,1292,687,605,摩根大通,2023-05-30,8440
1504,東元,830,231,599,摩根大通,2023-05-30,8440
2360,致茂,642,79,563,摩根大通,2023-05-30,8440
2371,大同,1765,1206,559,摩根大通,2023-05-30,8440
2812,台中銀,545,0,545,摩根大通,2023-05-30,8440
2345,智邦,754,222,532,摩根大通,2023-05-30,8440
8046,南電,766,252,514,摩根大通,2023-05-30,8440
2383,台光電,709,205,504,摩根大通,2023-05-30,8440
2454,聯發科,1596,1144,452,摩根大通,2023-05-30,8440
3025,星通,837,392,445,摩根大通,2023-05-30,8440
3037,欣興,1517,1087,430,摩根大通,2023-05-30,8440
2885,元大金,1649,1222,427,摩根大通,2023-05-30,8440
2353,宏��,1347,943,404,摩根大通,2023-05-30,8440
2492,華新科,411,20,391,摩根大通,2023-05-30,8440
3264,欣銓,400,23,377,摩根大通,2023-05-30,8440
4938,和碩,507,142,365,摩根大通,2023-05-30,8440
2408,南亞科,901,541,360,摩根大通,2023-05-30,8440
2402,毅嘉,401,55,346,摩根大通,2023-05-30,8440
2457,飛宏,530,187,343,摩根大通,2023-05-30,8440
8210,勤誠,658,331,327,摩根大通,2023-05-30,8440
5483,中美晶,306,0,306,摩根大通,2023-05-30,8440
6005,群益證,457,171,286,摩根大通,2023-05-30,8440
2328,廣宇,295,13,282,摩根大通,2023-05-30,8440
2362,藍天,293,16,277,摩根大通,2023-05-30,8440
6016,康和證,318,52,266,摩根大通,2023-05-30,8440
6116,彩晶,543,281,262,摩根大通,2023-05-30,8440
8011,台通,494,238,256,摩根大通,2023-05-30,8440
6239,力成,319,66,253,摩根大通,2023-05-30,8440
1717,長興,332,91,241,摩根大通,2023-05-30,8440
4968,立積,372,136,236,摩根大通,2023-05-30,8440
6643,M31,234,12,222,摩根大通,2023-05-30,8440
2385,群光,418,204,214,摩根大通,2023-05-30,8440
3406,玉晶光,231,20,211,摩根大通,2023-05-30,8440
2498,宏達電,336,127,209,摩根大通,2023-05-30,8440
6535,順藥,337,132,205,摩根大通,2023-05-30,8440
2606,裕民,298,95,203,摩根大通,2023-05-30,8440
2352,佳世達,297,95,202,摩根大通,2023-05-30,8440
3231,緯創,72148,50933,21215,摩根大通,2023-05-31,8440
2880,華南金,38987,20654,18333,摩根大通,2023-05-31,8440
2882,國泰金,21923,11423,10500,摩根大通,2023-05-31,8440
2801,彰銀,11901,5541,6360,摩根大通,2023-05-31,8440
2883,凱基金,18122,13094,5028,摩根大通,2023-05-31,8440
2610,華航,8959,4039,4920,摩根大通,2023-05-31,8440
2457,飛宏,4910,1208,3702,摩根大通,2023-05-31,8440
2618,長榮航,11863,8189,3674,摩根大通,2023-05-31,8440
1503,士電,3626,501,3125,摩根大通,2023-05-31,8440
6235,華孚,2630,342,2288,摩根大通,2023-05-31,8440
2834,臺企銀,4695,2417,2278,摩根大通,2023-05-31,8440
2633,台灣高鐵,4212,1960,2252,摩根大通,2023-05-31,8440
1609,大亞,2296,88,2208,摩根大通,2023-05-31,8440
3037,欣興,4721,2543,2178,摩根大通,2023-05-31,8440
1519,華城,2952,851,2101,摩根大通,2023-05-31,8440
2105,正新,4975,3179,1796,摩根大通,2023-05-31,8440
2308,台達電,2626,844,1782,摩根大通,2023-05-31,8440
3704,合勤控,2301,816,1485,摩根大通,2023-05-31,8440
3443,創意,2260,1023,1237,摩根大通,2023-05-31,8440
3260,威剛,1179,306,873,摩根大通,2023-05-31,8440
2329,華泰,905,40,865,摩根大通,2023-05-31,8440
2727,王品,1036,221,815,摩根大通,2023-05-31,8440
2492,華新科,863,80,783,摩根大通,2023-05-31,8440
5009,榮剛,893,141,752,摩根大通,2023-05-31,8440
6446,藥華藥,838,137,701,摩根大通,2023-05-31,8440
1905,華紙,744,60,684,摩根大通,2023-05-31,8440
5512,力麒,624,0,624,摩根大通,2023-05-31,8440
2356,英業達,2845,2274,571,摩根大通,2023-05-31,8440
6282,康舒,1179,626,553,摩根大通,2023-05-31,8440
2867,三商壽,984,439,545,摩根大通,2023-05-31,8440
2449,京元電子,1554,1023,531,摩根大通,2023-05-31,8440
2328,廣宇,550,35,515,摩根大通,2023-05-31,8440
5388,中磊,723,210,513,摩根大通,2023-05-31,8440
4979,華星光,900,395,505,摩根大通,2023-05-31,8440
2349,錸德,517,28,489,摩根大通,2023-05-31,8440
2345,智邦,978,492,486,摩根大通,2023-05-31,8440
4129,聯合,498,26,472,摩根大通,2023-05-31,8440
8210,勤誠,602,147,455,摩根大通,2023-05-31,8440
3673,TPK-KY,477,24,453,摩根大通,2023-05-31,8440
0050,元大台灣50,448,0,448,摩根大通,2023-05-31,8440
2705,六福,465,46,419,摩根大通,2023-05-31,8440
5864,致和證,420,7,413,摩根大通,2023-05-31,8440
3006,晶豪科,534,147,387,摩根大通,2023-05-31,8440
4743,合一,424,47,377,摩根大通,2023-05-31,8440
5511,德昌,364,0,364,摩根大通,2023-05-31,8440
6548,長科*,753,390,363,摩根大通,2023-05-31,8440
2888,新光金,3828,3473,355,摩根大通,2023-05-31,8440
2495,普安,419,85,334,摩根大通,2023-05-31,8440
2542,興富發,804,487,317,摩根大通,2023-05-31,8440
5498,凱崴,310,10,300,摩根大通,2023-05-31,8440
2610,華航,7311,403,6908,摩根大通,2023-06-01,8440
2353,宏��,2824,429,2395,摩根大通,2023-06-01,8440
2457,飛宏,4015,1741,2274,摩根大通,2023-06-01,8440
1905,華紙,2624,499,2125,摩根大通,2023-06-01,8440
2884,玉山金,3086,975,2111,摩根大通,2023-06-01,8440
2886,兆豐金,2398,339,2059,摩根大通,2023-06-01,8440
2328,廣宇,2280,318,1962,摩根大通,2023-06-01,8440
2329,華泰,1330,55,1275,摩根大通,2023-06-01,8440
2412,中華電,1289,49,1240,摩根大通,2023-06-01,8440
9919,康那香,1232,5,1227,摩根大通,2023-06-01,8440
2201,裕隆,1545,478,1067,摩根大通,2023-06-01,8440
2330,台積電,2620,1713,907,摩根大通,2023-06-01,8440
2382,廣達,2381,1478,903,摩根大通,2023-06-01,8440
2324,仁寶,1388,530,858,摩根大通,2023-06-01,8440
1504,東元,827,154,673,摩根大通,2023-06-01,8440
2349,錸德,689,45,644,摩根大通,2023-06-01,8440
2486,一詮,1059,438,621,摩根大通,2023-06-01,8440
2881,富邦金,810,199,611,摩根大通,2023-06-01,8440
6026,福邦證,603,1,602,摩根大通,2023-06-01,8440
2489,瑞軒,881,282,599,摩根大通,2023-06-01,8440
2332,友訊,578,0,578,摩根大通,2023-06-01,8440
2354,鴻準,622,57,565,摩根大通,2023-06-01,8440
3005,神基,644,84,560,摩根大通,2023-06-01,8440
4129,聯合,920,394,526,摩根大通,2023-06-01,8440
2377,微星,894,374,520,摩根大通,2023-06-01,8440
2867,三商壽,500,10,490,摩根大通,2023-06-01,8440
6188,廣明,770,322,448,摩根大通,2023-06-01,8440
2880,華南金,646,232,414,摩根大通,2023-06-01,8440
6190,萬泰科,514,106,408,摩根大通,2023-06-01,8440
1514,亞力,502,111,391,摩根大通,2023-06-01,8440
1618,合機,388,0,388,摩根大通,2023-06-01,8440
5469,瀚宇博,372,3,369,摩根大通,2023-06-01,8440
2444,兆勁,395,56,339,摩根大通,2023-06-01,8440
2360,致茂,430,99,331,摩根大通,2023-06-01,8440
2376,技嘉,552,230,322,摩根大通,2023-06-01,8440
6191,精成科,337,17,320,摩根大通,2023-06-01,8440
2327,國巨,363,56,307,摩根大通,2023-06-01,8440
4938,和碩,441,146,295,摩根大通,2023-06-01,8440
6016,康和證,286,0,286,摩根大通,2023-06-01,8440
6733,博晟生醫,430,148,282,摩根大通,2023-06-01,8440
3034,聯詠,378,110,268,摩根大通,2023-06-01,8440
2308,台達電,472,206,266,摩根大通,2023-06-01,8440
4979,華星光,687,421,266,摩根大通,2023-06-01,8440
5465,富驊,267,5,262,摩根大通,2023-06-01,8440
3056,富華新,260,1,259,摩根大通,2023-06-01,8440
2458,義隆,266,23,243,摩根大通,2023-06-01,8440
2211,長榮鋼,239,0,239,摩根大通,2023-06-01,8440
6015,宏遠證,238,0,238,摩根大通,2023-06-01,8440
3163,波若威,247,17,230,摩根大通,2023-06-01,8440
6185,幃翔,322,95,227,摩根大通,2023-06-01,8440
2886,兆豐金,8392,71,8321,摩根大通,2023-06-02,8440
2344,華邦電,6298,46,6252,摩根大通,2023-06-02,8440
2618,長榮航,8017,4433,3584,摩根大通,2023-06-02,8440
2353,宏��,5987,2501,3486,摩根大通,2023-06-02,8440
2330,台積電,3855,1089,2766,摩根大通,2023-06-02,8440
2887,台新金,2879,375,2504,摩根大通,2023-06-02,8440
4938,和碩,2491,48,2443,摩根大通,2023-06-02,8440
0050,元大台灣50,2404,40,2364,摩根大通,2023-06-02,8440
2884,玉山金,2355,29,2326,摩根大通,2023-06-02,8440
2323,中環,4931,3039,1892,摩根大通,2023-06-02,8440
2880,華南金,2060,397,1663,摩根大通,2023-06-02,8440
2382,廣達,1828,224,1604,摩根大通,2023-06-02,8440
2801,彰銀,1544,9,1535,摩根大通,2023-06-02,8440
1101,台泥,1487,33,1454,摩根大通,2023-06-02,8440
2371,大同,1919,528,1391,摩根大通,2023-06-02,8440
2892,第一金,1968,622,1346,摩根大通,2023-06-02,8440
2457,飛宏,3056,1717,1339,摩根大通,2023-06-02,8440
2409,友達,2635,1299,1336,摩根大通,2023-06-02,8440
2412,中華電,1406,119,1287,摩根大通,2023-06-02,8440
1216,統一,1204,28,1176,摩根大通,2023-06-02,8440
2368,金像電,1692,562,1130,摩根大通,2023-06-02,8440
2891,中信金,2044,928,1116,摩根大通,2023-06-02,8440
3078,僑威,1128,129,999,摩根大通,2023-06-02,8440
2349,錸德,987,84,903,摩根大通,2023-06-02,8440
6185,幃翔,1130,232,898,摩根大通,2023-06-02,8440
3045,台灣大,884,24,860,摩根大通,2023-06-02,8440
5880,合庫金,1235,379,856,摩根大通,2023-06-02,8440
2331,精英,1336,493,843,摩根大通,2023-06-02,8440
2867,三商壽,810,0,810,摩根大通,2023-06-02,8440
2376,技嘉,1193,402,791,摩根大通,2023-06-02,8440
1477,聚陽,770,1,769,摩根大通,2023-06-02,8440
1513,中興電,1632,894,738,摩根大通,2023-06-02,8440
2377,微星,1067,355,712,摩根大通,2023-06-02,8440
2633,台灣高鐵,716,6,710,摩根大通,2023-06-02,8440
1503,士電,944,243,701,摩根大通,2023-06-02,8440
3013,晟銘電,945,244,701,摩根大通,2023-06-02,8440
1717,長興,715,49,666,摩根大通,2023-06-02,8440
3037,欣興,763,119,644,摩根大通,2023-06-02,8440
1605,華新,755,153,602,摩根大通,2023-06-02,8440
2201,裕隆,961,365,596,摩根大通,2023-06-02,8440
9945,潤泰新,709,166,543,摩根大通,2023-06-02,8440
2881,富邦金,1161,620,541,摩根大通,2023-06-02,8440
8478,東哥遊艇,606,66,540,摩根大通,2023-06-02,8440
8069,元太,705,169,536,摩根大通,2023-06-02,8440
6005,群益證,526,7,519,摩根大通,2023-06-02,8440
6505,台塑化,543,38,505,摩根大通,2023-06-02,8440
9917,中保科,504,0,504,摩根大通,2023-06-02,8440
1310,台苯,541,42,499,摩根大通,2023-06-02,8440
2332,友訊,798,304,494,摩根大通,2023-06-02,8440
2354,鴻準,575,84,491,摩根大通,2023-06-02,8440
2888,新光金,10165,4209,5956,摩根大通,2023-06-05,8440
2409,友達,6039,421,5618,摩根大通,2023-06-05,8440
2887,台新金,5321,208,5113,摩根大通,2023-06-05,8440
2883,凱基金,6957,2277,4680,摩根大通,2023-06-05,8440
2886,兆豐金,5681,1315,4366,摩根大通,2023-06-05,8440
2884,玉山金,4912,637,4275,摩根大通,2023-06-05,8440
1907,永豐餘,4168,262,3906,摩根大通,2023-06-05,8440
2356,英業達,3924,386,3538,摩根大通,2023-06-05,8440
2801,彰銀,3771,386,3385,摩根大通,2023-06-05,8440
2353,宏��,4997,2208,2789,摩根大通,2023-06-05,8440
2882,國泰金,3818,1387,2431,摩根大通,2023-06-05,8440
2867,三商壽,1946,5,1941,摩根大通,2023-06-05,8440
2027,大成鋼,2027,150,1877,摩根大通,2023-06-05,8440
3037,欣興,2374,502,1872,摩根大通,2023-06-05,8440
1314,中石化,1667,0,1667,摩根大通,2023-06-05,8440
2891,中信金,2952,1318,1634,摩根大通,2023-06-05,8440
1514,亞力,2626,1044,1582,摩根大通,2023-06-05,8440
2880,華南金,1678,145,1533,摩根大通,2023-06-05,8440
5880,合庫金,1862,366,1496,摩根大通,2023-06-05,8440
2498,宏達電,1829,390,1439,摩根大通,2023-06-05,8440
2382,廣達,2656,1328,1328,摩根大通,2023-06-05,8440
0050,元大台灣50,1294,0,1294,摩根大通,2023-06-05,8440
2308,台達電,2045,898,1147,摩根大通,2023-06-05,8440
2349,錸德,1213,138,1075,摩根大通,2023-06-05,8440
2812,台中銀,1107,46,1061,摩根大通,2023-06-05,8440
2615,萬海,1095,110,985,摩根大通,2023-06-05,8440
2324,仁寶,1644,667,977,摩根大通,2023-06-05,8440
3035,智原,965,0,965,摩根大通,2023-06-05,8440
3078,僑威,1120,165,955,摩根大通,2023-06-05,8440
3058,立德,1078,156,922,摩根大通,2023-06-05,8440
2892,第一金,1798,902,896,摩根大通,2023-06-05,8440
3049,精金,901,15,886,摩根大通,2023-06-05,8440
2301,光寶科,1612,729,883,摩根大通,2023-06-05,8440
2412,中華電,913,55,858,摩根大通,2023-06-05,8440
1710,東聯,850,1,849,摩根大通,2023-06-05,8440
6235,華孚,1256,422,834,摩根大通,2023-06-05,8440
2425,承啟,1024,207,817,摩根大通,2023-06-05,8440
6026,福邦證,791,10,781,摩根大通,2023-06-05,8440
2206,三陽工業,1166,472,694,摩根大通,2023-06-05,8440
2609,陽明,1122,431,691,摩根大通,2023-06-05,8440
5876,上海商銀,877,199,678,摩根大通,2023-06-05,8440
6122,擎邦,691,22,669,摩根大通,2023-06-05,8440
9945,潤泰新,1066,398,668,摩根大通,2023-06-05,8440
1310,台苯,656,15,641,摩根大通,2023-06-05,8440
2377,微星,872,251,621,摩根大通,2023-06-05,8440
2104,國際中橡,612,0,612,摩根大通,2023-06-05,8440
2408,南亞科,665,56,609,摩根大通,2023-06-05,8440
6005,群益證,591,5,586,摩根大通,2023-06-05,8440
6218,豪勉,662,92,570,摩根大通,2023-06-05,8440
2359,所羅門,693,166,527,摩根大通,2023-06-05,8440
2618,長榮航,7713,496,7217,摩根大通,2023-06-06,8440
2409,友達,7003,14,6989,摩根大通,2023-06-06,8440
1609,大亞,7892,3006,4886,摩根大通,2023-06-06,8440
2891,中信金,4987,1115,3872,摩根大通,2023-06-06,8440
3481,群創,4502,1018,3484,摩根大通,2023-06-06,8440
3711,日月光投控,4443,964,3479,摩根大通,2023-06-06,8440
1907,永豐餘,4289,874,3415,摩根大通,2023-06-06,8440
2317,鴻海,3949,1174,2775,摩根大通,2023-06-06,8440
2330,台積電,2966,431,2535,摩根大通,2023-06-06,8440
2303,聯電,2506,464,2042,摩根大通,2023-06-06,8440
2884,玉山金,1867,172,1695,摩根大通,2023-06-06,8440
2885,元大金,1948,474,1474,摩根大通,2023-06-06,8440
2002,中鋼,1671,263,1408,摩根大通,2023-06-06,8440
2344,華邦電,1522,201,1321,摩根大通,2023-06-06,8440
2890,永豐金,1233,94,1139,摩根大通,2023-06-06,8440
2323,中環,1633,525,1108,摩根大通,2023-06-06,8440
2324,仁寶,1349,270,1079,摩根大通,2023-06-06,8440
6125,廣運,1499,462,1037,摩根大通,2023-06-06,8440
2382,廣達,1144,146,998,摩根大通,2023-06-06,8440
1710,東聯,1006,25,981,摩根大通,2023-06-06,8440
3017,奇鋐,1068,154,914,摩根大通,2023-06-06,8440
2412,中華電,912,52,860,摩根大通,2023-06-06,8440
2615,萬海,1121,274,847,摩根大通,2023-06-06,8440
1301,台塑,1013,167,846,摩根大通,2023-06-06,8440
5880,合庫金,1015,172,843,摩根大通,2023-06-06,8440
1504,東元,978,146,832,摩根大通,2023-06-06,8440
8069,元太,820,18,802,摩根大通,2023-06-06,8440
1605,華新,894,95,799,摩根大通,2023-06-06,8440
2201,裕隆,748,9,739,摩根大通,2023-06-06,8440
2027,大成鋼,859,132,727,摩根大通,2023-06-06,8440
1314,中石化,798,116,682,摩根大通,2023-06-06,8440
2634,漢翔,804,138,666,摩根大通,2023-06-06,8440
6005,群益證,646,0,646,摩根大通,2023-06-06,8440
2892,第一金,1125,488,637,摩根大通,2023-06-06,8440
2886,兆豐金,3132,2500,632,摩根大通,2023-06-06,8440
1303,南亞,664,34,630,摩根大通,2023-06-06,8440
2880,華南金,988,361,627,摩根大通,2023-06-06,8440
2376,技嘉,852,253,599,摩根大通,2023-06-06,8440
2308,台達電,615,51,564,摩根大通,2023-06-06,8440
1460,宏遠,586,30,556,摩根大通,2023-06-06,8440
9904,寶成,643,92,551,摩根大通,2023-06-06,8440
1102,亞泥,584,34,550,摩根大通,2023-06-06,8440
2331,精英,535,8,527,摩根大通,2023-06-06,8440
4979,華星光,722,222,500,摩根大通,2023-06-06,8440
2393,億光,492,2,490,摩根大通,2023-06-06,8440
4938,和碩,520,39,481,摩根大通,2023-06-06,8440
2329,華泰,428,7,421,摩根大通,2023-06-06,8440
4904,遠傳,477,69,408,摩根大通,2023-06-06,8440
2312,金寶,557,161,396,摩根大通,2023-06-06,8440
3034,聯詠,404,19,385,摩根大通,2023-06-06,8440
2409,友達,4788,1809,2979,摩根大通,2023-06-07,8440
2886,兆豐金,2912,142,2770,摩根大通,2023-06-07,8440
3481,群創,3327,694,2633,摩根大通,2023-06-07,8440
2330,台積電,3200,734,2466,摩根大通,2023-06-07,8440
1609,大亞,2608,285,2323,摩根大通,2023-06-07,8440
1301,台塑,1797,257,1540,摩根大通,2023-06-07,8440
2353,宏��,2476,988,1488,摩根大通,2023-06-07,8440
4123,晟德,1479,111,1368,摩根大通,2023-06-07,8440
2892,第一金,1342,0,1342,摩根大通,2023-06-07,8440
2885,元大金,1264,0,1264,摩根大通,2023-06-07,8440
3711,日月光投控,2785,1535,1250,摩根大通,2023-06-07,8440
2308,台達電,1226,46,1180,摩根大通,2023-06-07,8440
2634,漢翔,1121,43,1078,摩根大通,2023-06-07,8440
2324,仁寶,1590,576,1014,摩根大通,2023-06-07,8440
2317,鴻海,1395,418,977,摩根大通,2023-06-07,8440
2884,玉山金,1505,537,968,摩根大通,2023-06-07,8440
2880,華南金,1148,187,961,摩根大通,2023-06-07,8440
2890,永豐金,1042,108,934,摩根大通,2023-06-07,8440
5880,合庫金,1042,110,932,摩根大通,2023-06-07,8440
4533,協易機,965,48,917,摩根大通,2023-06-07,8440
2206,三陽工業,1005,99,906,摩根大通,2023-06-07,8440
2834,臺企銀,893,0,893,摩根大通,2023-06-07,8440
1907,永豐餘,1224,347,877,摩根大通,2023-06-07,8440
5876,上海商銀,1036,215,821,摩根大通,2023-06-07,8440
2356,英業達,1299,521,778,摩根大通,2023-06-07,8440
0050,元大台灣50,774,0,774,摩根大通,2023-06-07,8440
2393,億光,771,2,769,摩根大通,2023-06-07,8440
2002,中鋼,1293,533,760,摩根大通,2023-06-07,8440
6505,台塑化,807,79,728,摩根大通,2023-06-07,8440
1605,華新,756,70,686,摩根大通,2023-06-07,8440
2504,國產,733,52,681,摩根大通,2023-06-07,8440
2027,大成鋼,760,79,681,摩根大通,2023-06-07,8440
2883,凱基金,1655,987,668,摩根大通,2023-06-07,8440
3034,聯詠,676,57,619,摩根大通,2023-06-07,8440
2388,威盛,809,213,596,摩根大通,2023-06-07,8440
2301,光寶科,1266,686,580,摩根大通,2023-06-07,8440
2882,國泰金,1140,568,572,摩根大通,2023-06-07,8440
3483,力致,569,5,564,摩根大通,2023-06-07,8440
1785,光洋科,756,214,542,摩根大通,2023-06-07,8440
1904,正隆,536,8,528,摩根大通,2023-06-07,8440
1303,南亞,601,81,520,摩根大通,2023-06-07,8440
5864,致和證,519,21,498,摩根大通,2023-06-07,8440
1101,台泥,643,150,493,摩根大通,2023-06-07,8440
4938,和碩,523,41,482,摩根大通,2023-06-07,8440
2349,錸德,504,23,481,摩根大通,2023-06-07,8440
5340,建榮,526,67,459,摩根大通,2023-06-07,8440
2412,中華電,595,138,457,摩根大通,2023-06-07,8440
3105,穩懋,530,82,448,摩根大通,2023-06-07,8440
8086,宏捷科,489,47,442,摩根大通,2023-06-07,8440
2615,萬海,1041,607,434,摩根大通,2023-06-07,8440
2886,兆豐金,4095,29,4066,摩根大通,2023-06-08,8440
2891,中信金,5066,1155,3911,摩根大通,2023-06-08,8440
2618,長榮航,3862,1177,2685,摩根大通,2023-06-08,8440
2330,台積電,3491,1058,2433,摩根大通,2023-06-08,8440
2887,台新金,2431,30,2401,摩根大通,2023-06-08,8440
2356,英業達,2377,240,2137,摩根大通,2023-06-08,8440
2603,長榮,1571,93,1478,摩根大通,2023-06-08,8440
2801,彰銀,1364,9,1355,摩根大通,2023-06-08,8440
2027,大成鋼,1342,16,1326,摩根大通,2023-06-08,8440
3481,群創,1417,170,1247,摩根大通,2023-06-08,8440
3046,建��,1421,334,1087,摩根大通,2023-06-08,8440
2892,第一金,1084,6,1078,摩根大通,2023-06-08,8440
2308,台達電,1188,112,1076,摩根大通,2023-06-08,8440
2883,凱基金,1430,433,997,摩根大通,2023-06-08,8440
2882,國泰金,1512,549,963,摩根大通,2023-06-08,8440
2634,漢翔,918,66,852,摩根大通,2023-06-08,8440
2880,華南金,917,85,832,摩根大通,2023-06-08,8440
2324,仁寶,1533,714,819,摩根大通,2023-06-08,8440
2609,陽明,918,127,791,摩根大通,2023-06-08,8440
2615,萬海,1041,264,777,摩根大通,2023-06-08,8440
1904,正隆,773,8,765,摩根大通,2023-06-08,8440
5880,合庫金,810,49,761,摩根大通,2023-06-08,8440
3105,穩懋,1092,351,741,摩根大通,2023-06-08,8440
2371,大同,827,108,719,摩根大通,2023-06-08,8440
2610,華航,1405,689,716,摩根大通,2023-06-08,8440
1907,永豐餘,992,295,697,摩根大通,2023-06-08,8440
2489,瑞軒,920,247,673,摩根大通,2023-06-08,8440
2329,華泰,652,16,636,摩根大通,2023-06-08,8440
6116,彩晶,860,226,634,摩根大通,2023-06-08,8440
2312,金寶,632,7,625,摩根大通,2023-06-08,8440
4938,和碩,624,24,600,摩根大通,2023-06-08,8440
1301,台塑,664,85,579,摩根大通,2023-06-08,8440
4904,遠傳,641,75,566,摩根大通,2023-06-08,8440
1102,亞泥,574,10,564,摩根大通,2023-06-08,8440
2211,長榮鋼,553,8,545,摩根大通,2023-06-08,8440
3596,智易,977,434,543,摩根大通,2023-06-08,8440
3037,欣興,1058,537,521,摩根大通,2023-06-08,8440
1710,東聯,668,153,515,摩根大通,2023-06-08,8440
2204,中華,531,20,511,摩根大通,2023-06-08,8440
5009,榮剛,466,33,433,摩根大通,2023-06-08,8440
3673,TPK-KY,550,138,412,摩根大通,2023-06-08,8440
6733,博晟生醫,410,26,384,摩根大通,2023-06-08,8440
2412,中華電,356,2,354,摩根大通,2023-06-08,8440
2352,佳世達,682,343,339,摩根大通,2023-06-08,8440
1104,環泥,376,39,337,摩根大通,2023-06-08,8440
2353,宏��,1496,1160,336,摩根大通,2023-06-08,8440
4968,立積,501,190,311,摩根大通,2023-06-08,8440
3715,定穎投控,567,257,310,摩根大通,2023-06-08,8440
1815,富喬,310,22,288,摩根大通,2023-06-08,8440
2006,東和鋼鐵,335,50,285,摩根大通,2023-06-08,8440
2887,台新金,5103,314,4789,摩根大通,2023-06-09,8440
2303,聯電,3527,825,2702,摩根大通,2023-06-09,8440
2891,中信金,3585,1179,2406,摩根大通,2023-06-09,8440
2353,宏��,3764,1376,2388,摩根大通,2023-06-09,8440
2344,華邦電,2505,372,2133,摩根大通,2023-06-09,8440
2886,兆豐金,1999,104,1895,摩根大通,2023-06-09,8440
2312,金寶,1683,31,1652,摩根大通,2023-06-09,8440
2610,華航,1881,333,1548,摩根大通,2023-06-09,8440
2317,鴻海,1472,71,1401,摩根大通,2023-06-09,8440
2323,中環,2126,759,1367,摩根大通,2023-06-09,8440
2834,臺企銀,1481,204,1277,摩根大通,2023-06-09,8440
2634,漢翔,1238,41,1197,摩根大通,2023-06-09,8440
2515,中工,1466,270,1196,摩根大通,2023-06-09,8440
2324,仁寶,1317,213,1104,摩根大通,2023-06-09,8440
2801,彰銀,1089,1,1088,摩根大通,2023-06-09,8440
2206,三陽工業,1638,564,1074,摩根大通,2023-06-09,8440
2890,永豐金,1535,552,983,摩根大通,2023-06-09,8440
2376,技嘉,1284,367,917,摩根大通,2023-06-09,8440
3231,緯創,5722,4828,894,摩根大通,2023-06-09,8440
4938,和碩,910,28,882,摩根大通,2023-06-09,8440
1907,永豐餘,1273,392,881,摩根大通,2023-06-09,8440
3715,定穎投控,926,138,788,摩根大通,2023-06-09,8440
2371,大同,961,175,786,摩根大通,2023-06-09,8440
2382,廣達,1505,763,742,摩根大通,2023-06-09,8440
8069,元太,957,239,718,摩根大通,2023-06-09,8440
3033,威健,773,76,697,摩根大通,2023-06-09,8440
3037,欣興,1088,409,679,摩根大通,2023-06-09,8440
8234,新漢,705,26,679,摩根大通,2023-06-09,8440
2630,亞航,903,239,664,摩根大通,2023-06-09,8440
4979,華星光,1056,401,655,摩根大通,2023-06-09,8440
2723,美食-KY,663,55,608,摩根大通,2023-06-09,8440
1815,富喬,726,132,594,摩根大通,2023-06-09,8440
5880,合庫金,617,24,593,摩根大通,2023-06-09,8440
8926,台汽電,810,222,588,摩根大通,2023-06-09,8440
2105,正新,623,46,577,摩根大通,2023-06-09,8440
1104,環泥,637,66,571,摩根大通,2023-06-09,8440
2027,大成鋼,896,327,569,摩根大通,2023-06-09,8440
2892,第一金,885,320,565,摩根大通,2023-06-09,8440
2332,友訊,559,0,559,摩根大通,2023-06-09,8440
1710,東聯,832,294,538,摩根大通,2023-06-09,8440
2885,元大金,913,388,525,摩根大通,2023-06-09,8440
3027,盛達,538,33,505,摩根大通,2023-06-09,8440
1301,台塑,533,35,498,摩根大通,2023-06-09,8440
2457,飛宏,605,110,495,摩根大通,2023-06-09,8440
8085,福華,491,4,487,摩根大通,2023-06-09,8440
2002,中鋼,653,184,469,摩根大通,2023-06-09,8440
5706,鳳凰,625,164,461,摩根大通,2023-06-09,8440
3706,神達,527,91,436,摩根大通,2023-06-09,8440
2388,威盛,554,128,426,摩根大通,2023-06-09,8440
1102,亞泥,521,105,416,摩根大通,2023-06-09,8440
2382,廣達,5978,1986,3992,摩根大通,2023-06-12,8440
2618,長榮航,6133,2191,3942,摩根大通,2023-06-12,8440
2353,宏��,4628,1050,3578,摩根大通,2023-06-12,8440
2330,台積電,3050,345,2705,摩根大通,2023-06-12,8440
0050,元大台灣50,2187,0,2187,摩根大通,2023-06-12,8440
2317,鴻海,3762,1622,2140,摩根大通,2023-06-12,8440
2515,中工,1990,116,1874,摩根大通,2023-06-12,8440
2308,台達電,2661,899,1762,摩根大通,2023-06-12,8440
2887,台新金,2328,695,1633,摩根大通,2023-06-12,8440
3481,群創,2195,673,1522,摩根大通,2023-06-12,8440
2834,臺企銀,1321,144,1177,摩根大通,2023-06-12,8440
8926,台汽電,1403,226,1177,摩根大通,2023-06-12,8440
6235,華孚,1400,487,913,摩根大通,2023-06-12,8440
2324,仁寶,1220,337,883,摩根大通,2023-06-12,8440
2890,永豐金,932,54,878,摩根大通,2023-06-12,8440
2344,華邦電,1575,704,871,摩根大通,2023-06-12,8440
3017,奇鋐,925,141,784,摩根大通,2023-06-12,8440
2886,兆豐金,1995,1226,769,摩根大通,2023-06-12,8440
3715,定穎投控,930,163,767,摩根大通,2023-06-12,8440
2105,正新,801,87,714,摩根大通,2023-06-12,8440
2892,第一金,1772,1070,702,摩根大通,2023-06-12,8440
2880,華南金,702,9,693,摩根大通,2023-06-12,8440
3037,欣興,925,280,645,摩根大通,2023-06-12,8440
2801,彰銀,827,243,584,摩根大通,2023-06-12,8440
2204,中華,573,26,547,摩根大通,2023-06-12,8440
6505,台塑化,560,15,545,摩根大通,2023-06-12,8440
1905,華紙,626,106,520,摩根大通,2023-06-12,8440
2388,威盛,1143,627,516,摩根大通,2023-06-12,8440
1104,環泥,613,129,484,摩根大通,2023-06-12,8440
4938,和碩,800,338,462,摩根大通,2023-06-12,8440
3711,日月光投控,836,393,443,摩根大通,2023-06-12,8440
2349,錸德,657,221,436,摩根大通,2023-06-12,8440
3025,星通,552,118,434,摩根大通,2023-06-12,8440
2323,中環,904,486,418,摩根大通,2023-06-12,8440
5880,合庫金,787,376,411,摩根大通,2023-06-12,8440
2377,微星,456,50,406,摩根大通,2023-06-12,8440
1522,堤維西,549,157,392,摩根大通,2023-06-12,8440
1314,中石化,501,124,377,摩根大通,2023-06-12,8440
3346,麗清,692,319,373,摩根大通,2023-06-12,8440
2449,京元電子,429,57,372,摩根大通,2023-06-12,8440
2101,南港,368,9,359,摩根大通,2023-06-12,8440
6016,康和證,468,115,353,摩根大通,2023-06-12,8440
5465,富驊,819,470,349,摩根大通,2023-06-12,8440
6120,達運,340,2,338,摩根大通,2023-06-12,8440
2812,台中銀,342,16,326,摩根大通,2023-06-12,8440
3680,家登,349,40,309,摩根大通,2023-06-12,8440
6116,彩晶,455,148,307,摩根大通,2023-06-12,8440
3706,神達,314,7,307,摩根大通,2023-06-12,8440
2329,華泰,359,57,302,摩根大通,2023-06-12,8440
2371,大同,790,490,300,摩根大通,2023-06-12,8440
2330,台積電,10636,1965,8671,摩根大通,2023-06-13,8440
3231,緯創,5785,1661,4124,摩根大通,2023-06-13,8440
2409,友達,4724,2900,1824,摩根大通,2023-06-13,8440
2880,華南金,2097,280,1817,摩根大通,2023-06-13,8440
3078,僑威,2369,625,1744,摩根大通,2023-06-13,8440
2618,長榮航,5530,3787,1743,摩根大通,2023-06-13,8440
2891,中信金,3780,2263,1517,摩根大通,2023-06-13,8440
3037,欣興,1904,475,1429,摩根大通,2023-06-13,8440
2610,華航,1911,555,1356,摩根大通,2023-06-13,8440
2515,中工,1815,568,1247,摩根大通,2023-06-13,8440
2886,兆豐金,1401,154,1247,摩根大通,2023-06-13,8440
1522,堤維西,1662,564,1098,摩根大通,2023-06-13,8440
2344,華邦電,1482,444,1038,摩根大通,2023-06-13,8440
3264,欣銓,1041,59,982,摩根大通,2023-06-13,8440
2337,旺宏,1093,149,944,摩根大通,2023-06-13,8440
2356,英業達,3454,2531,923,摩根大通,2023-06-13,8440
0050,元大台灣50,920,0,920,摩根大通,2023-06-13,8440
2421,建準,1138,282,856,摩根大通,2023-06-13,8440
2890,永豐金,1361,547,814,摩根大通,2023-06-13,8440
2303,聯電,1203,443,760,摩根大通,2023-06-13,8440
5258,虹堡,827,78,749,摩根大通,2023-06-13,8440
2359,所羅門,771,28,743,摩根大通,2023-06-13,8440
8069,元太,925,240,685,摩根大通,2023-06-13,8440
3481,群創,1661,1028,633,摩根大通,2023-06-13,8440
5880,合庫金,949,331,618,摩根大通,2023-06-13,8440
2329,華泰,734,116,618,摩根大通,2023-06-13,8440
2105,正新,771,193,578,摩根大通,2023-06-13,8440
2457,飛宏,669,102,567,摩根大通,2023-06-13,8440
5465,富驊,922,356,566,摩根大通,2023-06-13,8440
2388,威盛,574,11,563,摩根大通,2023-06-13,8440
6235,華孚,1040,507,533,摩根大通,2023-06-13,8440
5864,致和證,535,14,521,摩根大通,2023-06-13,8440
3033,威健,589,70,519,摩根大通,2023-06-13,8440
2634,漢翔,541,42,499,摩根大通,2023-06-13,8440
1802,台玻,525,34,491,摩根大通,2023-06-13,8440
3045,台灣大,506,18,488,摩根大通,2023-06-13,8440
5351,鈺創,509,21,488,摩根大通,2023-06-13,8440
4938,和碩,596,138,458,摩根大通,2023-06-13,8440
5905,南仁湖,469,12,457,摩根大通,2023-06-13,8440
1608,華榮,480,33,447,摩根大通,2023-06-13,8440
8028,昇陽半導體,517,97,420,摩根大通,2023-06-13,8440
2913,農林,533,118,415,摩根大通,2023-06-13,8440
1104,環泥,624,211,413,摩根大通,2023-06-13,8440
1560,中砂,541,149,392,摩根大通,2023-06-13,8440
3715,定穎投控,545,178,367,摩根大通,2023-06-13,8440
2867,三商壽,366,0,366,摩根大通,2023-06-13,8440
8114,振樺電,497,149,348,摩根大通,2023-06-13,8440
2308,台達電,792,445,347,摩根大通,2023-06-13,8440
3265,台星科,348,6,342,摩根大通,2023-06-13,8440
2301,光寶科,650,326,324,摩根大通,2023-06-13,8440
6770,力積電,10782,18,10764,摩根大通,2023-06-14,8440
2610,華航,7453,2797,4656,摩根大通,2023-06-14,8440
2891,中信金,3268,629,2639,摩根大通,2023-06-14,8440
3231,緯創,3515,919,2596,摩根大通,2023-06-14,8440
2376,技嘉,2172,156,2016,摩根大通,2023-06-14,8440
2330,台積電,3251,1238,2013,摩根大通,2023-06-14,8440
2324,仁寶,2008,116,1892,摩根大通,2023-06-14,8440
2886,兆豐金,1988,130,1858,摩根大通,2023-06-14,8440
2603,長榮,1638,41,1597,摩根大通,2023-06-14,8440
2845,遠東銀,1225,3,1222,摩根大通,2023-06-14,8440
2303,聯電,1274,61,1213,摩根大通,2023-06-14,8440
2421,建準,1573,388,1185,摩根大通,2023-06-14,8440
2317,鴻海,1891,800,1091,摩根大通,2023-06-14,8440
2337,旺宏,1189,164,1025,摩根大通,2023-06-14,8440
3058,立德,1072,135,937,摩根大通,2023-06-14,8440
6166,凌華,907,42,865,摩根大通,2023-06-14,8440
3264,欣銓,878,17,861,摩根大通,2023-06-14,8440
8076,伍豐,875,71,804,摩根大通,2023-06-14,8440
3037,欣興,788,102,686,摩根大通,2023-06-14,8440
8112,至上,664,0,664,摩根大通,2023-06-14,8440
1802,台玻,1164,507,657,摩根大通,2023-06-14,8440
5443,均豪,643,10,633,摩根大通,2023-06-14,8440
2345,智邦,668,49,619,摩根大通,2023-06-14,8440
4533,協易機,1573,970,603,摩根大通,2023-06-14,8440
2308,台達電,815,277,538,摩根大通,2023-06-14,8440
8926,台汽電,916,383,533,摩根大通,2023-06-14,8440
5258,虹堡,750,227,523,摩根大通,2023-06-14,8440
3056,富華新,542,21,521,摩根大通,2023-06-14,8440
2354,鴻準,514,22,492,摩根大通,2023-06-14,8440
2609,陽明,630,145,485,摩根大通,2023-06-14,8440
2449,京元電子,863,384,479,摩根大通,2023-06-14,8440
6122,擎邦,768,296,472,摩根大通,2023-06-14,8440
6026,福邦證,489,18,471,摩根大通,2023-06-14,8440
2105,正新,507,53,454,摩根大通,2023-06-14,8440
2453,凌群,561,108,453,摩根大通,2023-06-14,8440
2352,佳世達,765,314,451,摩根大通,2023-06-14,8440
2359,所羅門,459,16,443,摩根大通,2023-06-14,8440
2371,大同,478,37,441,摩根大通,2023-06-14,8440
2344,華邦電,721,287,434,摩根大通,2023-06-14,8440
5871,中租-KY,482,66,416,摩根大通,2023-06-14,8440
3702,大聯大,522,114,408,摩根大通,2023-06-14,8440
6285,啟��,518,112,406,摩根大通,2023-06-14,8440
2913,農林,565,179,386,摩根大通,2023-06-14,8440
2408,南亞科,621,238,383,摩根大通,2023-06-14,8440
3715,定穎投控,370,4,366,摩根大通,2023-06-14,8440
2329,華泰,715,355,360,摩根大通,2023-06-14,8440
0050,元大台灣50,410,50,360,摩根大通,2023-06-14,8440
2482,連宇,874,515,359,摩根大通,2023-06-14,8440
2880,華南金,338,11,327,摩根大通,2023-06-14,8440
3356,奇偶,347,21,326,摩根大通,2023-06-14,8440
2610,華航,19593,3804,15789,摩根大通,2023-06-15,8440
2618,長榮航,12309,6742,5567,摩根大通,2023-06-15,8440
3231,緯創,7013,3115,3898,摩根大通,2023-06-15,8440
2324,仁寶,3635,127,3508,摩根大通,2023-06-15,8440
2603,長榮,2481,249,2232,摩根大通,2023-06-15,8440
2886,兆豐金,2427,224,2203,摩根大通,2023-06-15,8440
1802,台玻,2176,58,2118,摩根大通,2023-06-15,8440
2027,大成鋼,1743,46,1697,摩根大通,2023-06-15,8440
2376,技嘉,1658,214,1444,摩根大通,2023-06-15,8440
2337,旺宏,1848,594,1254,摩根大通,2023-06-15,8440
5258,虹堡,1335,94,1241,摩根大通,2023-06-15,8440
1101,台泥,1213,85,1128,摩根大通,2023-06-15,8440
1522,堤維西,1357,465,892,摩根大通,2023-06-15,8440
3706,神達,1337,454,883,摩根大通,2023-06-15,8440
3715,定穎投控,880,31,849,摩根大通,2023-06-15,8440
0050,元大台灣50,750,0,750,摩根大通,2023-06-15,8440
2368,金像電,831,127,704,摩根大通,2023-06-15,8440
2101,南港,614,4,610,摩根大通,2023-06-15,8440
2204,中華,586,0,586,摩根大通,2023-06-15,8440
2312,金寶,629,43,586,摩根大通,2023-06-15,8440
3037,欣興,635,67,568,摩根大通,2023-06-15,8440
3056,富華新,547,21,526,摩根大通,2023-06-15,8440
2049,上銀,630,116,514,摩根大通,2023-06-15,8440
6127,九豪,502,0,502,摩根大通,2023-06-15,8440
6125,廣運,539,72,467,摩根大通,2023-06-15,8440
1503,士電,594,131,463,摩根大通,2023-06-15,8440
2371,大同,1390,943,447,摩根大通,2023-06-15,8440
3024,憶聲,430,0,430,摩根大通,2023-06-15,8440
1608,華榮,444,51,393,摩根大通,2023-06-15,8440
3325,旭品,392,3,389,摩根大通,2023-06-15,8440
4938,和碩,1159,784,375,摩根大通,2023-06-15,8440
2377,微星,473,102,371,摩根大通,2023-06-15,8440
2468,華經,757,397,360,摩根大通,2023-06-15,8440
1605,華新,369,9,360,摩根大通,2023-06-15,8440
1815,富喬,613,258,355,摩根大通,2023-06-15,8440
3702,大聯大,390,48,342,摩根大通,2023-06-15,8440
1102,亞泥,462,124,338,摩根大通,2023-06-15,8440
1611,中電,719,387,332,摩根大通,2023-06-15,8440
2453,凌群,2733,2406,327,摩根大通,2023-06-15,8440
2313,華通,381,54,327,摩根大通,2023-06-15,8440
5483,中美晶,326,0,326,摩根大通,2023-06-15,8440
3105,穩懋,453,136,317,摩根大通,2023-06-15,8440
2359,所羅門,455,152,303,摩根大通,2023-06-15,8440
2515,中工,439,136,303,摩根大通,2023-06-15,8440
1402,遠東新,358,60,298,摩根大通,2023-06-15,8440
2347,聯強,495,226,269,摩根大通,2023-06-15,8440
2892,第一金,647,381,266,摩根大通,2023-06-15,8440
8085,福華,280,17,263,摩根大通,2023-06-15,8440
8110,華東,260,0,260,摩根大通,2023-06-15,8440
6274,台燿,306,48,258,摩根大通,2023-06-15,8440
2610,華航,23157,9061,14096,摩根大通,2023-06-16,8440
2337,旺宏,9612,451,9161,摩根大通,2023-06-16,8440
2888,新光金,15432,7765,7667,摩根大通,2023-06-16,8440
3231,緯創,9719,3276,6443,摩根大通,2023-06-16,8440
2312,金寶,6673,777,5896,摩根大通,2023-06-16,8440
1802,台玻,5443,1388,4055,摩根大通,2023-06-16,8440
2332,友訊,4804,1469,3335,摩根大通,2023-06-16,8440
3380,明泰,3423,725,2698,摩根大通,2023-06-16,8440
2303,聯電,5902,3312,2590,摩根大通,2023-06-16,8440
2382,廣達,4880,2693,2187,摩根大通,2023-06-16,8440
9917,中保科,2777,835,1942,摩根大通,2023-06-16,8440
2603,長榮,2033,228,1805,摩根大通,2023-06-16,8440
2887,台新金,6615,4885,1730,摩根大通,2023-06-16,8440
2324,仁寶,6198,4583,1615,摩根大通,2023-06-16,8440
0050,元大台灣50,1493,0,1493,摩根大通,2023-06-16,8440
3260,威剛,1516,71,1445,摩根大通,2023-06-16,8440
6214,精誠,1987,550,1437,摩根大通,2023-06-16,8440
3481,群創,6420,5094,1326,摩根大通,2023-06-16,8440
3576,聯合再生,1218,3,1215,摩根大通,2023-06-16,8440
2884,玉山金,4557,3350,1207,摩根大通,2023-06-16,8440
2104,國際中橡,1379,177,1202,摩根大通,2023-06-16,8440
2885,元大金,4305,3133,1172,摩根大通,2023-06-16,8440
6550,北極星藥業-KY,1272,116,1156,摩根大通,2023-06-16,8440
2356,英業達,4256,3182,1074,摩根大通,2023-06-16,8440
3034,聯詠,1261,206,1055,摩根大通,2023-06-16,8440
2408,南亞科,1478,476,1002,摩根大通,2023-06-16,8440
6005,群益證,980,16,964,摩根大通,2023-06-16,8440
1522,堤維西,1968,1018,950,摩根大通,2023-06-16,8440
2105,正新,1623,751,872,摩根大通,2023-06-16,8440
2618,長榮航,7140,6272,868,摩根大通,2023-06-16,8440
5531,鄉林,924,75,849,摩根大通,2023-06-16,8440
2449,京元電子,1358,545,813,摩根大通,2023-06-16,8440
2867,三商壽,945,134,811,摩根大通,2023-06-16,8440
2354,鴻準,908,114,794,摩根大通,2023-06-16,8440
3037,欣興,958,171,787,摩根大通,2023-06-16,8440
1504,東元,2881,2145,736,摩根大通,2023-06-16,8440
3013,晟銘電,1527,792,735,摩根大通,2023-06-16,8440
2049,上銀,1442,764,678,摩根大通,2023-06-16,8440
1513,中興電,861,209,652,摩根大通,2023-06-16,8440
2352,佳世達,852,213,639,摩根大通,2023-06-16,8440
3711,日月光投控,2499,1906,593,摩根大通,2023-06-16,8440
2362,藍天,721,129,592,摩根大通,2023-06-16,8440
4979,華星光,1350,761,589,摩根大通,2023-06-16,8440
1216,統一,1711,1135,576,摩根大通,2023-06-16,8440
1714,和桐,568,0,568,摩根大通,2023-06-16,8440
2395,研華,757,203,554,摩根大通,2023-06-16,8440
2748,雲品,673,125,548,摩根大通,2023-06-16,8440
2027,大成鋼,1214,685,529,摩根大通,2023-06-16,8440
1789,神隆,569,45,524,摩根大通,2023-06-16,8440
2421,建準,1065,543,522,摩根大通,2023-06-16,8440
3481,群創,27150,2505,24645,摩根大通,2023-06-19,8440
2610,華航,9152,1679,7473,摩根大通,2023-06-19,8440
2337,旺宏,7807,376,7431,摩根大通,2023-06-19,8440
1802,台玻,8022,707,7315,摩根大通,2023-06-19,8440
2618,長榮航,7159,598,6561,摩根大通,2023-06-19,8440
2409,友達,7620,4178,3442,摩根大通,2023-06-19,8440
1513,中興電,3769,567,3202,摩根大通,2023-06-19,8440
2887,台新金,2582,418,2164,摩根大通,2023-06-19,8440
2371,大同,1973,176,1797,摩根大通,2023-06-19,8440
3017,奇鋐,1845,200,1645,摩根大通,2023-06-19,8440
2834,臺企銀,2245,694,1551,摩根大通,2023-06-19,8440
2330,台積電,2076,953,1123,摩根大通,2023-06-19,8440
2603,長榮,2167,1125,1042,摩根大通,2023-06-19,8440
4916,事欣科,1182,194,988,摩根大通,2023-06-19,8440
2515,中工,983,122,861,摩根大通,2023-06-19,8440
2303,聯電,2294,1467,827,摩根大通,2023-06-19,8440
2376,技嘉,761,26,735,摩根大通,2023-06-19,8440
3011,今皓,725,22,703,摩根大通,2023-06-19,8440
2385,群光,811,126,685,摩根大通,2023-06-19,8440
2340,台亞,778,102,676,摩根大通,2023-06-19,8440
2453,凌群,795,129,666,摩根大通,2023-06-19,8440
3264,欣銓,783,127,656,摩根大通,2023-06-19,8440
3071,協禧,649,37,612,摩根大通,2023-06-19,8440
8064,東捷,605,33,572,摩根大通,2023-06-19,8440
1477,聚陽,1282,711,571,摩根大通,2023-06-19,8440
2913,農林,666,125,541,摩根大通,2023-06-19,8440
2208,台船,569,42,527,摩根大通,2023-06-19,8440
6203,海韻電,524,6,518,摩根大通,2023-06-19,8440
2317,鴻海,1172,694,478,摩根大通,2023-06-19,8440
8033,雷虎,446,0,446,摩根大通,2023-06-19,8440
6148,驊宏資,849,404,445,摩根大通,2023-06-19,8440
2360,致茂,460,27,433,摩根大通,2023-06-19,8440
1608,華榮,493,61,432,摩根大通,2023-06-19,8440
5465,富驊,454,74,380,摩根大通,2023-06-19,8440
6288,聯嘉,405,32,373,摩根大通,2023-06-19,8440
8105,凌巨,375,17,358,摩根大通,2023-06-19,8440
2748,雲品,492,144,348,摩根大通,2023-06-19,8440
3714,富采,426,79,347,摩根大通,2023-06-19,8440
3049,精金,372,27,345,摩根大通,2023-06-19,8440
3207,耀勝,377,36,341,摩根大通,2023-06-19,8440
1528,恩德,522,188,334,摩根大通,2023-06-19,8440
4938,和碩,787,454,333,摩根大通,2023-06-19,8440
9919,康那香,599,267,332,摩根大通,2023-06-19,8440
3702,大聯大,347,46,301,摩根大通,2023-06-19,8440
6271,同欣電,352,69,283,摩根大通,2023-06-19,8440
1809,中釉,280,0,280,摩根大通,2023-06-19,8440
2204,中華,388,108,280,摩根大通,2023-06-19,8440
2457,飛宏,301,39,262,摩根大通,2023-06-19,8440
1301,台塑,437,176,261,摩根大通,2023-06-19,8440
2377,微星,322,63,259,摩根大通,2023-06-19,8440
2618,長榮航,9765,787,8978,摩根大通,2023-06-20,8440
3231,緯創,8893,2168,6725,摩根大通,2023-06-20,8440
2610,華航,8855,3319,5536,摩根大通,2023-06-20,8440
2337,旺宏,4761,1217,3544,摩根大通,2023-06-20,8440
2356,英業達,4657,1505,3152,摩根大通,2023-06-20,8440
2888,新光金,4523,2205,2318,摩根大通,2023-06-20,8440
2324,仁寶,2533,428,2105,摩根大通,2023-06-20,8440
2887,台新金,2405,837,1568,摩根大通,2023-06-20,8440
2371,大同,2055,612,1443,摩根大通,2023-06-20,8440
2308,台達電,1772,341,1431,摩根大通,2023-06-20,8440
2412,中華電,1599,202,1397,摩根大通,2023-06-20,8440
1504,東元,2002,621,1381,摩根大通,2023-06-20,8440
6120,達運,1675,476,1199,摩根大通,2023-06-20,8440
2603,長榮,1431,245,1186,摩根大通,2023-06-20,8440
2405,輔信,1254,189,1065,摩根大通,2023-06-20,8440
00878,國泰永續高股息,1000,0,1000,摩根大通,2023-06-20,8440
2323,中環,1637,651,986,摩根大通,2023-06-20,8440
2344,華邦電,1555,592,963,摩根大通,2023-06-20,8440
2409,友達,5772,4817,955,摩根大通,2023-06-20,8440
2301,光寶科,1328,603,725,摩根大通,2023-06-20,8440
4916,事欣科,1040,346,694,摩根大通,2023-06-20,8440
2376,技嘉,905,290,615,摩根大通,2023-06-20,8440
3017,奇鋐,679,118,561,摩根大通,2023-06-20,8440
2883,凱基金,1040,519,521,摩根大通,2023-06-20,8440
2489,瑞軒,549,35,514,摩根大通,2023-06-20,8440
1802,台玻,3645,3151,494,摩根大通,2023-06-20,8440
2352,佳世達,670,181,489,摩根大通,2023-06-20,8440
2002,中鋼,758,279,479,摩根大通,2023-06-20,8440
2357,華碩,475,21,454,摩根大通,2023-06-20,8440
4934,太極,428,22,406,摩根大通,2023-06-20,8440
9919,康那香,403,62,341,摩根大通,2023-06-20,8440
8936,國統,419,79,340,摩根大通,2023-06-20,8440
8222,寶一,371,40,331,摩根大通,2023-06-20,8440
8234,新漢,465,142,323,摩根大通,2023-06-20,8440
6239,力成,396,85,311,摩根大通,2023-06-20,8440
1314,中石化,317,10,307,摩根大通,2023-06-20,8440
2882,國泰金,376,78,298,摩根大通,2023-06-20,8440
5388,中磊,328,34,294,摩根大通,2023-06-20,8440
3702,大聯大,385,98,287,摩根大通,2023-06-20,8440
3045,台灣大,287,2,285,摩根大通,2023-06-20,8440
6278,台表科,268,0,268,摩根大通,2023-06-20,8440
8150,南茂,294,30,264,摩根大通,2023-06-20,8440
2017,官田鋼,278,28,250,摩根大通,2023-06-20,8440
6182,合晶,297,53,244,摩根大通,2023-06-20,8440
1608,華榮,456,219,237,摩根大通,2023-06-20,8440
6271,同欣電,251,14,237,摩根大通,2023-06-20,8440
2468,華經,762,527,235,摩根大通,2023-06-20,8440
3011,今皓,458,230,228,摩根大通,2023-06-20,8440
4979,華星光,630,413,217,摩根大通,2023-06-20,8440
2206,三陽工業,733,525,208,摩根大通,2023-06-20,8440
1802,台玻,8571,769,7802,摩根大通,2023-06-21,8440
0050,元大台灣50,7271,381,6890,摩根大通,2023-06-21,8440
2887,台新金,5030,163,4867,摩根大通,2023-06-21,8440
2409,友達,5465,2409,3056,摩根大通,2023-06-21,8440
2324,仁寶,3078,535,2543,摩根大通,2023-06-21,8440
2885,元大金,3455,1208,2247,摩根大通,2023-06-21,8440
2454,聯發科,2744,912,1832,摩根大通,2023-06-21,8440
2337,旺宏,3539,1830,1709,摩根大通,2023-06-21,8440
1101,台泥,1993,334,1659,摩根大通,2023-06-21,8440
6116,彩晶,1721,171,1550,摩根大通,2023-06-21,8440
2892,第一金,1801,328,1473,摩根大通,2023-06-21,8440
2105,正新,1422,61,1361,摩根大通,2023-06-21,8440
2610,華航,7760,6796,964,摩根大通,2023-06-21,8440
2331,精英,1083,170,913,摩根大通,2023-06-21,8440
2371,大同,1717,878,839,摩根大通,2023-06-21,8440
6182,合晶,829,42,787,摩根大通,2023-06-21,8440
2427,三商電,787,99,688,摩根大通,2023-06-21,8440
2027,大成鋼,766,80,686,摩根大通,2023-06-21,8440
3483,力致,653,58,595,摩根大通,2023-06-21,8440
2615,萬海,653,74,579,摩根大通,2023-06-21,8440
3017,奇鋐,694,122,572,摩根大通,2023-06-21,8440
2382,廣達,1697,1128,569,摩根大通,2023-06-21,8440
1904,正隆,570,8,562,摩根大通,2023-06-21,8440
2206,三陽工業,651,92,559,摩根大通,2023-06-21,8440
2359,所羅門,652,108,544,摩根大通,2023-06-21,8440
1514,亞力,640,151,489,摩根大通,2023-06-21,8440
2301,光寶科,590,123,467,摩根大通,2023-06-21,8440
2457,飛宏,575,110,465,摩根大通,2023-06-21,8440
1216,統一,781,338,443,摩根大通,2023-06-21,8440
3702,大聯大,456,22,434,摩根大通,2023-06-21,8440
2412,中華電,552,131,421,摩根大通,2023-06-21,8440
3202,樺晟,429,15,414,摩根大通,2023-06-21,8440
2834,臺企銀,436,28,408,摩根大通,2023-06-21,8440
8358,金居,782,380,402,摩根大通,2023-06-21,8440
1402,遠東新,474,78,396,摩根大通,2023-06-21,8440
6219,富旺,434,46,388,摩根大通,2023-06-21,8440
2357,華碩,448,79,369,摩根大通,2023-06-21,8440
1217,愛之味,429,67,362,摩根大通,2023-06-21,8440
2515,中工,482,133,349,摩根大通,2023-06-21,8440
3661,世芯-KY,386,42,344,摩根大通,2023-06-21,8440
2801,彰銀,466,128,338,摩根大通,2023-06-21,8440
2377,微星,494,169,325,摩根大通,2023-06-21,8440
6415,矽力*-KY,390,72,318,摩根大通,2023-06-21,8440
2489,瑞軒,608,294,314,摩根大通,2023-06-21,8440
4938,和碩,425,118,307,摩根大通,2023-06-21,8440
6223,旺矽,331,30,301,摩根大通,2023-06-21,8440
3037,欣興,778,483,295,摩根大通,2023-06-21,8440
6271,同欣電,330,38,292,摩根大通,2023-06-21,8440
3711,日月光投控,448,160,288,摩根大通,2023-06-21,8440
8926,台汽電,324,45,279,摩根大通,2023-06-21,8440
2317,鴻海,15362,525,14837,摩根大通,2023-06-26,8440
1802,台玻,9674,691,8983,摩根大通,2023-06-26,8440
2603,長榮,5421,265,5156,摩根大通,2023-06-26,8440
2324,仁寶,4915,260,4655,摩根大通,2023-06-26,8440
2337,旺宏,4791,188,4603,摩根大通,2023-06-26,8440
2356,英業達,3900,517,3383,摩根大通,2023-06-26,8440
2409,友達,4549,1924,2625,摩根大通,2023-06-26,8440
2887,台新金,3567,1104,2463,摩根大通,2023-06-26,8440
2884,玉山金,2497,704,1793,摩根大通,2023-06-26,8440
2618,長榮航,3541,1841,1700,摩根大通,2023-06-26,8440
1102,亞泥,1790,180,1610,摩根大通,2023-06-26,8440
2371,大同,3679,2264,1415,摩根大通,2023-06-26,8440
2801,彰銀,2512,1109,1403,摩根大通,2023-06-26,8440
1904,正隆,1899,624,1275,摩根大通,2023-06-26,8440
2408,南亞科,1262,29,1233,摩根大通,2023-06-26,8440
2002,中鋼,2227,1184,1043,摩根大通,2023-06-26,8440
3017,奇鋐,1147,176,971,摩根大通,2023-06-26,8440
2882,國泰金,1473,833,640,摩根大通,2023-06-26,8440
1785,光洋科,666,55,611,摩根大通,2023-06-26,8440
8069,元太,867,327,540,摩根大通,2023-06-26,8440
5009,榮剛,498,14,484,摩根大通,2023-06-26,8440
2332,友訊,514,36,478,摩根大通,2023-06-26,8440
1609,大亞,577,113,464,摩根大通,2023-06-26,8440
6271,同欣電,444,1,443,摩根大通,2023-06-26,8440
2812,台中銀,436,21,415,摩根大通,2023-06-26,8440
2349,錸德,422,41,381,摩根大通,2023-06-26,8440
1909,榮成,358,0,358,摩根大通,2023-06-26,8440
1608,華榮,379,26,353,摩根大通,2023-06-26,8440
2385,群光,553,201,352,摩根大通,2023-06-26,8440
1529,樂事綠能,394,43,351,摩根大通,2023-06-26,8440
2393,億光,429,88,341,摩根大通,2023-06-26,8440
1503,士電,429,91,338,摩根大通,2023-06-26,8440
2105,正新,461,134,327,摩根大通,2023-06-26,8440
3702,大聯大,414,90,324,摩根大通,2023-06-26,8440
8150,南茂,315,0,315,摩根大通,2023-06-26,8440
5388,中磊,464,153,311,摩根大通,2023-06-26,8440
2867,三商壽,646,351,295,摩根大通,2023-06-26,8440
2211,長榮鋼,303,15,288,摩根大通,2023-06-26,8440
3356,奇偶,349,73,276,摩根大通,2023-06-26,8440
5706,鳳凰,298,23,275,摩根大通,2023-06-26,8440
1519,華城,321,56,265,摩根大通,2023-06-26,8440
2449,京元電子,490,246,244,摩根大通,2023-06-26,8440
4503,金雨,387,146,241,摩根大通,2023-06-26,8440
2023,燁輝,445,207,238,摩根大通,2023-06-26,8440
9914,美利達,248,16,232,摩根大通,2023-06-26,8440
3038,全台,470,242,228,摩根大通,2023-06-26,8440
4157,太景*-KY,225,0,225,摩根大通,2023-06-26,8440
2206,三陽工業,567,342,225,摩根大通,2023-06-26,8440
3596,智易,225,1,224,摩根大通,2023-06-26,8440
1513,中興電,806,585,221,摩根大通,2023-06-26,8440
2618,長榮航,7018,2325,4693,摩根大通,2023-06-27,8440
2610,華航,9260,6895,2365,摩根大通,2023-06-27,8440
2356,英業達,2123,215,1908,摩根大通,2023-06-27,8440
1471,首利,1835,276,1559,摩根大通,2023-06-27,8440
4904,遠傳,2480,1033,1447,摩根大通,2023-06-27,8440
2412,中華電,1708,274,1434,摩根大通,2023-06-27,8440
2603,長榮,1433,146,1287,摩根大通,2023-06-27,8440
2352,佳世達,1338,57,1281,摩根大通,2023-06-27,8440
6120,達運,1170,0,1170,摩根大通,2023-06-27,8440
2801,彰銀,1374,204,1170,摩根大通,2023-06-27,8440
2330,台積電,2387,1252,1135,摩根大通,2023-06-27,8440
2002,中鋼,2001,948,1053,摩根大通,2023-06-27,8440
2376,技嘉,1373,356,1017,摩根大通,2023-06-27,8440
4979,華星光,1208,239,969,摩根大通,2023-06-27,8440
2105,正新,1047,93,954,摩根大通,2023-06-27,8440
5880,合庫金,1281,440,841,摩根大通,2023-06-27,8440
2206,三陽工業,1048,235,813,摩根大通,2023-06-27,8440
2308,台達電,1279,517,762,摩根大通,2023-06-27,8440
2887,台新金,958,198,760,摩根大通,2023-06-27,8440
2385,群光,831,72,759,摩根大通,2023-06-27,8440
2890,永豐金,1168,426,742,摩根大通,2023-06-27,8440
2331,精英,878,139,739,摩根大通,2023-06-27,8440
8105,凌巨,735,11,724,摩根大通,2023-06-27,8440
1102,亞泥,796,115,681,摩根大通,2023-06-27,8440
2368,金像電,691,49,642,摩根大通,2023-06-27,8440
2324,仁寶,932,309,623,摩根大通,2023-06-27,8440
3011,今皓,680,57,623,摩根大通,2023-06-27,8440
2449,京元電子,713,143,570,摩根大通,2023-06-27,8440
2880,華南金,761,195,566,摩根大通,2023-06-27,8440
2421,建準,578,88,490,摩根大通,2023-06-27,8440
6179,亞通,543,54,489,摩根大通,2023-06-27,8440
5706,鳳凰,760,276,484,摩根大通,2023-06-27,8440
3049,精金,658,177,481,摩根大通,2023-06-27,8440
2312,金寶,832,351,481,摩根大通,2023-06-27,8440
2408,南亞科,560,83,477,摩根大通,2023-06-27,8440
8936,國統,507,31,476,摩根大通,2023-06-27,8440
2884,玉山金,743,283,460,摩根大通,2023-06-27,8440
2883,凱基金,877,420,457,摩根大通,2023-06-27,8440
3033,威健,465,9,456,摩根大通,2023-06-27,8440
3058,立德,460,17,443,摩根大通,2023-06-27,8440
9919,康那香,440,10,430,摩根大通,2023-06-27,8440
3013,晟銘電,442,49,393,摩根大通,2023-06-27,8440
1229,聯華,404,20,384,摩根大通,2023-06-27,8440
3078,僑威,375,5,370,摩根大通,2023-06-27,8440
2104,國際中橡,365,3,362,摩根大通,2023-06-27,8440
2885,元大金,643,319,324,摩根大通,2023-06-27,8440
1904,正隆,562,257,305,摩根大通,2023-06-27,8440
8299,群聯,315,25,290,摩根大通,2023-06-27,8440
4746,台耀,363,86,277,摩根大通,2023-06-27,8440
5483,中美晶,289,14,275,摩根大通,2023-06-27,8440
2618,長榮航,12238,1724,10514,摩根大通,2023-06-28,8440
2449,京元電子,2299,4,2295,摩根大通,2023-06-28,8440
2324,仁寶,2892,916,1976,摩根大通,2023-06-28,8440
2371,大同,3534,1650,1884,摩根大通,2023-06-28,8440
4746,台耀,2482,613,1869,摩根大通,2023-06-28,8440
2353,宏��,2975,1155,1820,摩根大通,2023-06-28,8440
2332,友訊,1248,307,941,摩根大通,2023-06-28,8440
2002,中鋼,2632,1743,889,摩根大通,2023-06-28,8440
4157,太景*-KY,898,70,828,摩根大通,2023-06-28,8440
8069,元太,1277,452,825,摩根大通,2023-06-28,8440
2352,佳世達,811,24,787,摩根大通,2023-06-28,8440
5469,瀚宇博,924,159,765,摩根大通,2023-06-28,8440
5009,榮剛,773,11,762,摩根大通,2023-06-28,8440
8105,凌巨,762,0,762,摩根大通,2023-06-28,8440
8213,志超,739,0,739,摩根大通,2023-06-28,8440
5388,中磊,1299,579,720,摩根大通,2023-06-28,8440
6190,萬泰科,814,139,675,摩根大通,2023-06-28,8440
2489,瑞軒,614,0,614,摩根大通,2023-06-28,8440
4155,訊映,625,43,582,摩根大通,2023-06-28,8440
2610,華航,2057,1487,570,摩根大通,2023-06-28,8440
1710,東聯,600,57,543,摩根大通,2023-06-28,8440
6147,頎邦,562,61,501,摩根大通,2023-06-28,8440
6142,友勁,500,11,489,摩根大通,2023-06-28,8440
2812,台中銀,506,19,487,摩根大通,2023-06-28,8440
2104,國際中橡,463,7,456,摩根大通,2023-06-28,8440
2385,群光,557,110,447,摩根大通,2023-06-28,8440
6191,精成科,512,85,427,摩根大通,2023-06-28,8440
2331,精英,728,305,423,摩根大通,2023-06-28,8440
2344,華邦電,1169,748,421,摩根大通,2023-06-28,8440
2323,中環,856,494,362,摩根大通,2023-06-28,8440
2801,彰銀,1452,1091,361,摩根大通,2023-06-28,8440
2368,金像電,515,163,352,摩根大通,2023-06-28,8440
6125,廣運,332,2,330,摩根大通,2023-06-28,8440
3033,威健,315,0,315,摩根大通,2023-06-28,8440
2609,陽明,565,256,309,摩根大通,2023-06-28,8440
4174,浩鼎,309,10,299,摩根大通,2023-06-28,8440
6197,佳必琪,394,107,287,摩根大通,2023-06-28,8440
3032,偉訓,385,100,285,摩根大通,2023-06-28,8440
2313,華通,280,0,280,摩根大通,2023-06-28,8440
3260,威剛,482,203,279,摩根大通,2023-06-28,8440
2312,金寶,487,213,274,摩根大通,2023-06-28,8440
1444,力麗,1076,804,272,摩根大通,2023-06-28,8440
1795,美時,313,48,265,摩根大通,2023-06-28,8440
2010,春源,389,126,263,摩根大通,2023-06-28,8440
8936,國統,376,116,260,摩根大通,2023-06-28,8440
2405,輔信,484,245,239,摩根大通,2023-06-28,8440
6112,邁達特,256,18,238,摩根大通,2023-06-28,8440
3205,佰研,262,25,237,摩根大通,2023-06-28,8440
2906,高林,475,239,236,摩根大通,2023-06-28,8440
9907,統一實,238,4,234,摩根大通,2023-06-28,8440
2324,仁寶,7029,1593,5436,摩根大通,2023-06-29,8440
2618,長榮航,8738,3550,5188,摩根大通,2023-06-29,8440
2353,宏��,3148,446,2702,摩根大通,2023-06-29,8440
3704,合勤控,1754,146,1608,摩根大通,2023-06-29,8440
2371,大同,2929,1404,1525,摩根大通,2023-06-29,8440
3260,威剛,1503,168,1335,摩根大通,2023-06-29,8440
1905,華紙,1278,4,1274,摩根大通,2023-06-29,8440
2382,廣達,1917,761,1156,摩根大通,2023-06-29,8440
2331,精英,1111,11,1100,摩根大通,2023-06-29,8440
1460,宏遠,1066,19,1047,摩根大通,2023-06-29,8440
2419,仲琦,1852,943,909,摩根大通,2023-06-29,8440
2489,瑞軒,854,47,807,摩根大通,2023-06-29,8440
4157,太景*-KY,1310,607,703,摩根大通,2023-06-29,8440
6285,啟��,882,202,680,摩根大通,2023-06-29,8440
2332,友訊,928,272,656,摩根大通,2023-06-29,8440
6153,嘉聯益,1255,607,648,摩根大通,2023-06-29,8440
3032,偉訓,648,7,641,摩根大通,2023-06-29,8440
1907,永豐餘,801,238,563,摩根大通,2023-06-29,8440
3013,晟銘電,703,152,551,摩根大通,2023-06-29,8440
4164,承業醫,603,63,540,摩根大通,2023-06-29,8440
2206,三陽工業,687,174,513,摩根大通,2023-06-29,8440
2454,聯發科,1024,528,496,摩根大通,2023-06-29,8440
2376,技嘉,1153,689,464,摩根大通,2023-06-29,8440
2515,中工,483,22,461,摩根大通,2023-06-29,8440
2449,京元電子,570,130,440,摩根大通,2023-06-29,8440
2402,毅嘉,440,5,435,摩根大通,2023-06-29,8440
1904,正隆,559,134,425,摩根大通,2023-06-29,8440
5469,瀚宇博,523,102,421,摩根大通,2023-06-29,8440
2312,金寶,564,145,419,摩根大通,2023-06-29,8440
8110,華東,435,17,418,摩根大通,2023-06-29,8440
2610,華航,2168,1753,415,摩根大通,2023-06-29,8440
2352,佳世達,683,272,411,摩根大通,2023-06-29,8440
3702,大聯大,417,9,408,摩根大通,2023-06-29,8440
2385,群光,499,108,391,摩根大通,2023-06-29,8440
1736,喬山,414,25,389,摩根大通,2023-06-29,8440
5351,鈺創,383,5,378,摩根大通,2023-06-29,8440
1514,亞力,401,23,378,摩根大通,2023-06-29,8440
3596,智易,581,211,370,摩根大通,2023-06-29,8440
2301,光寶科,928,560,368,摩根大通,2023-06-29,8440
6547,高端疫苗,364,5,359,摩根大通,2023-06-29,8440
4155,訊映,469,115,354,摩根大通,2023-06-29,8440
6125,廣運,335,0,335,摩根大通,2023-06-29,8440
4106,雃博,426,95,331,摩根大通,2023-06-29,8440
3483,力致,319,10,309,摩根大通,2023-06-29,8440
3035,智原,349,42,307,摩根大通,2023-06-29,8440
6214,精誠,327,24,303,摩根大通,2023-06-29,8440
8271,宇瞻,356,85,271,摩根大通,2023-06-29,8440
5439,高技,273,7,266,摩根大通,2023-06-29,8440
2405,輔信,325,60,265,摩根大通,2023-06-29,8440
4532,瑞智,264,0,264,摩根大通,2023-06-29,8440
4906,正文,3026,1,3025,摩根大通,2023-06-30,8440
2609,陽明,3085,415,2670,摩根大通,2023-06-30,8440
3704,合勤控,3043,423,2620,摩根大通,2023-06-30,8440
2371,大同,3540,1393,2147,摩根大通,2023-06-30,8440
9958,世紀鋼,1861,19,1842,摩根大通,2023-06-30,8440
1609,大亞,1407,42,1365,摩根大通,2023-06-30,8440
2812,台中銀,970,10,960,摩根大通,2023-06-30,8440
4157,太景*-KY,1090,164,926,摩根大通,2023-06-30,8440
2331,精英,850,69,781,摩根大通,2023-06-30,8440
4979,華星光,1648,945,703,摩根大通,2023-06-30,8440
2312,金寶,748,63,685,摩根大通,2023-06-30,8440
2449,京元電子,791,123,668,摩根大通,2023-06-30,8440
1460,宏遠,744,90,654,摩根大通,2023-06-30,8440
5483,中美晶,702,78,624,摩根大通,2023-06-30,8440
2301,光寶科,1153,550,603,摩根大通,2023-06-30,8440
2208,台船,861,282,579,摩根大通,2023-06-30,8440
8936,國統,649,78,571,摩根大通,2023-06-30,8440
4973,廣穎,549,3,546,摩根大通,2023-06-30,8440
3202,樺晟,539,5,534,摩根大通,2023-06-30,8440
3483,力致,567,36,531,摩根大通,2023-06-30,8440
6188,廣明,574,48,526,摩根大通,2023-06-30,8440
3380,明泰,659,146,513,摩根大通,2023-06-30,8440
5009,榮剛,512,26,486,摩根大通,2023-06-30,8440
8069,元太,783,311,472,摩根大通,2023-06-30,8440
2338,光罩,479,13,466,摩根大通,2023-06-30,8440
2603,長榮,1064,641,423,摩根大通,2023-06-30,8440
3025,星通,808,389,419,摩根大通,2023-06-30,8440
3346,麗清,409,3,406,摩根大通,2023-06-30,8440
1907,永豐餘,477,72,405,摩根大通,2023-06-30,8440
2399,映泰,402,0,402,摩根大通,2023-06-30,8440
1319,東陽,473,94,379,摩根大通,2023-06-30,8440
6112,邁達特,444,80,364,摩根大通,2023-06-30,8440
4164,承業醫,481,118,363,摩根大通,2023-06-30,8440
1514,亞力,500,148,352,摩根大通,2023-06-30,8440
1589,永冠-KY,436,85,351,摩根大通,2023-06-30,8440
2313,華通,495,155,340,摩根大通,2023-06-30,8440
6125,廣運,336,0,336,摩根大通,2023-06-30,8440
3032,偉訓,456,123,333,摩根大通,2023-06-30,8440
2419,仲琦,603,286,317,摩根大通,2023-06-30,8440
3702,大聯大,399,88,311,摩根大通,2023-06-30,8440
6276,安鈦克,390,94,296,摩根大通,2023-06-30,8440
6841,長佳智能,307,15,292,摩根大通,2023-06-30,8440
3324,雙鴻,335,51,284,摩根大通,2023-06-30,8440
6166,凌華,287,35,252,摩根大通,2023-06-30,8440
4123,晟德,281,34,247,摩根大通,2023-06-30,8440
4532,瑞智,302,59,243,摩根大通,2023-06-30,8440
2345,智邦,384,143,241,摩根大通,2023-06-30,8440
6806,森崴能源,360,120,240,摩根大通,2023-06-30,8440
2393,億光,221,1,220,摩根大通,2023-06-30,8440
6485,點序,266,49,217,摩根大通,2023-06-30,8440
2402,毅嘉,2826,356,2470,摩根大通,2023-07-03,8440
2323,中環,2355,589,1766,摩根大通,2023-07-03,8440
8050,廣積,1836,84,1752,摩根大通,2023-07-03,8440
2885,元大金,1906,163,1743,摩根大通,2023-07-03,8440
2330,台積電,2077,613,1464,摩根大通,2023-07-03,8440
1905,華紙,2889,1587,1302,摩根大通,2023-07-03,8440
2515,中工,1264,17,1247,摩根大通,2023-07-03,8440
2324,仁寶,1274,297,977,摩根大通,2023-07-03,8440
3704,合勤控,1116,169,947,摩根大通,2023-07-03,8440
2317,鴻海,1624,797,827,摩根大通,2023-07-03,8440
6285,啟��,902,122,780,摩根大通,2023-07-03,8440
5009,榮剛,865,129,736,摩根大通,2023-07-03,8440
6122,擎邦,669,0,669,摩根大通,2023-07-03,8440
3706,神達,668,41,627,摩根大通,2023-07-03,8440
2427,三商電,751,155,596,摩根大通,2023-07-03,8440
4938,和碩,639,64,575,摩根大通,2023-07-03,8440
3711,日月光投控,755,190,565,摩根大通,2023-07-03,8440
2002,中鋼,832,297,535,摩根大通,2023-07-03,8440
3702,大聯大,566,52,514,摩根大通,2023-07-03,8440
3032,偉訓,618,114,504,摩根大通,2023-07-03,8440
2880,華南金,709,235,474,摩根大通,2023-07-03,8440
1711,永光,489,20,469,摩根大通,2023-07-03,8440
2886,兆豐金,575,116,459,摩根大通,2023-07-03,8440
2887,台新金,590,135,455,摩根大通,2023-07-03,8440
5439,高技,509,58,451,摩根大通,2023-07-03,8440
6188,廣明,734,283,451,摩根大通,2023-07-03,8440
2636,台驊控股,476,36,440,摩根大通,2023-07-03,8440
2329,華泰,826,400,426,摩根大通,2023-07-03,8440
2457,飛宏,443,28,415,摩根大通,2023-07-03,8440
1304,台聚,561,147,414,摩根大通,2023-07-03,8440
3017,奇鋐,604,196,408,摩根大通,2023-07-03,8440
2347,聯強,429,23,406,摩根大通,2023-07-03,8440
6282,康舒,1605,1247,358,摩根大通,2023-07-03,8440
2812,台中銀,358,1,357,摩根大通,2023-07-03,8440
1402,遠東新,370,15,355,摩根大通,2023-07-03,8440
1584,精剛,331,0,331,摩根大通,2023-07-03,8440
6548,長科*,334,5,329,摩根大通,2023-07-03,8440
2482,連宇,331,10,321,摩根大通,2023-07-03,8440
2327,國巨,390,70,320,摩根大通,2023-07-03,8440
3013,晟銘電,318,3,315,摩根大通,2023-07-03,8440
1504,東元,518,205,313,摩根大通,2023-07-03,8440
3338,泰碩,323,11,312,摩根大通,2023-07-03,8440
2892,第一金,678,369,309,摩根大通,2023-07-03,8440
2349,錸德,307,0,307,摩根大通,2023-07-03,8440
9941,裕融,298,0,298,摩根大通,2023-07-03,8440
2455,全新,295,21,274,摩根大通,2023-07-03,8440
2353,宏��,408,137,271,摩根大通,2023-07-03,8440
3071,協禧,313,43,270,摩根大通,2023-07-03,8440
2345,智邦,371,102,269,摩根大通,2023-07-03,8440
2605,新興,301,33,268,摩根大通,2023-07-03,8440
2356,英業達,4518,1771,2747,摩根大通,2023-07-04,8440
6282,康舒,2098,573,1525,摩根大通,2023-07-04,8440
1907,永豐餘,1347,119,1228,摩根大通,2023-07-04,8440
3702,大聯大,1180,93,1087,摩根大通,2023-07-04,8440
4927,泰鼎-KY,1089,95,994,摩根大通,2023-07-04,8440
2312,金寶,1538,612,926,摩根大通,2023-07-04,8440
2352,佳世達,977,143,834,摩根大通,2023-07-04,8440
3264,欣銓,791,38,753,摩根大通,2023-07-04,8440
3704,合勤控,1501,824,677,摩根大通,2023-07-04,8440
6438,迅得,705,106,599,摩根大通,2023-07-04,8440
2206,三陽工業,608,105,503,摩根大通,2023-07-04,8440
3356,奇偶,602,104,498,摩根大通,2023-07-04,8440
1584,精剛,604,145,459,摩根大通,2023-07-04,8440
3013,晟銘電,918,469,449,摩根大通,2023-07-04,8440
2340,台亞,549,124,425,摩根大通,2023-07-04,8440
3363,上詮,510,107,403,摩根大通,2023-07-04,8440
6288,聯嘉,438,53,385,摩根大通,2023-07-04,8440
6274,台燿,384,4,380,摩根大通,2023-07-04,8440
3665,貿聯-KY,506,127,379,摩根大通,2023-07-04,8440
3346,麗清,429,55,374,摩根大通,2023-07-04,8440
6470,宇智,619,273,346,摩根大通,2023-07-04,8440
2002,中鋼,1455,1117,338,摩根大通,2023-07-04,8440
3673,TPK-KY,336,2,334,摩根大通,2023-07-04,8440
3260,威剛,568,246,322,摩根大通,2023-07-04,8440
3306,鼎天,335,20,315,摩根大通,2023-07-04,8440
3035,智原,735,423,312,摩根大通,2023-07-04,8440
1605,華新,547,245,302,摩根大通,2023-07-04,8440
3071,協禧,352,64,288,摩根大通,2023-07-04,8440
2353,宏��,655,369,286,摩根大通,2023-07-04,8440
2208,台船,365,81,284,摩根大通,2023-07-04,8440
6548,長科*,292,9,283,摩根大通,2023-07-04,8440
8210,勤誠,428,156,272,摩根大通,2023-07-04,8440
6166,凌華,313,55,258,摩根大通,2023-07-04,8440
1210,大成,263,15,248,摩根大通,2023-07-04,8440
3564,其陽,289,50,239,摩根大通,2023-07-04,8440
3047,訊舟,246,12,234,摩根大通,2023-07-04,8440
1304,台聚,238,6,232,摩根大通,2023-07-04,8440
2357,華碩,326,94,232,摩根大通,2023-07-04,8440
6515,穎崴,266,36,230,摩根大通,2023-07-04,8440
2495,普安,239,16,223,摩根大通,2023-07-04,8440
2413,環科,271,53,218,摩根大通,2023-07-04,8440
2395,研華,402,188,214,摩根大通,2023-07-04,8440
2889,國票金,209,0,209,摩根大通,2023-07-04,8440
9941,裕融,208,1,207,摩根大通,2023-07-04,8440
6285,啟��,428,223,205,摩根大通,2023-07-04,8440
2405,輔信,205,1,204,摩根大通,2023-07-04,8440
8085,福華,223,22,201,摩根大通,2023-07-04,8440
2308,台達電,647,446,201,摩根大通,2023-07-04,8440
2201,裕隆,320,120,200,摩根大通,2023-07-04,8440
6111,大宇資,241,41,200,摩根大通,2023-07-04,8440
2609,陽明,3509,1616,1893,摩根大通,2023-07-05,8440
2323,中環,2363,594,1769,摩根大通,2023-07-05,8440
2603,長榮,2052,350,1702,摩根大通,2023-07-05,8440
3481,群創,4212,2667,1545,摩根大通,2023-07-05,8440
3715,定穎投控,2035,608,1427,摩根大通,2023-07-05,8440
2324,仁寶,1642,520,1122,摩根大通,2023-07-05,8440
2313,華通,1119,211,908,摩根大通,2023-07-05,8440
2515,中工,1020,146,874,摩根大通,2023-07-05,8440
2457,飛宏,927,118,809,摩根大通,2023-07-05,8440
4123,晟德,799,35,764,摩根大通,2023-07-05,8440
3035,智原,1206,516,690,摩根大通,2023-07-05,8440
2486,一詮,741,165,576,摩根大通,2023-07-05,8440
4938,和碩,845,375,470,摩根大通,2023-07-05,8440
6166,凌華,598,130,468,摩根大通,2023-07-05,8440
2809,京城銀,482,20,462,摩根大通,2023-07-05,8440
6244,茂迪,526,69,457,摩根大通,2023-07-05,8440
4960,誠美材,572,126,446,摩根大通,2023-07-05,8440
6415,矽力*-KY,596,164,432,摩根大通,2023-07-05,8440
1618,合機,399,9,390,摩根大通,2023-07-05,8440
2371,大同,372,0,372,摩根大通,2023-07-05,8440
2352,佳世達,398,30,368,摩根大通,2023-07-05,8440
4526,東台,382,17,365,摩根大通,2023-07-05,8440
6414,樺漢,420,74,346,摩根大通,2023-07-05,8440
2395,研華,460,129,331,摩根大通,2023-07-05,8440
3701,大眾控,374,47,327,摩根大通,2023-07-05,8440
3022,威強電,335,23,312,摩根大通,2023-07-05,8440
4763,材料-KY,405,98,307,摩根大通,2023-07-05,8440
6451,訊芯-KY,337,32,305,摩根大通,2023-07-05,8440
3702,大聯大,409,110,299,摩根大通,2023-07-05,8440
6285,啟��,686,391,295,摩根大通,2023-07-05,8440
5452,佶優,337,51,286,摩根大通,2023-07-05,8440
2332,友訊,286,0,286,摩根大通,2023-07-05,8440
2355,敬鵬,278,0,278,摩根大通,2023-07-05,8440
5009,榮剛,447,184,263,摩根大通,2023-07-05,8440
4155,訊映,489,238,251,摩根大通,2023-07-05,8440
6257,矽格,333,93,240,摩根大通,2023-07-05,8440
2338,光罩,380,141,239,摩根大通,2023-07-05,8440
4566,時碩工業,314,81,233,摩根大通,2023-07-05,8440
1444,力麗,226,0,226,摩根大通,2023-07-05,8440
1560,中砂,246,22,224,摩根大通,2023-07-05,8440
6548,長科*,252,30,222,摩根大通,2023-07-05,8440
2886,兆豐金,1605,1388,217,摩根大通,2023-07-05,8440
1718,中纖,234,20,214,摩根大通,2023-07-05,8440
5289,宜鼎,228,18,210,摩根大通,2023-07-05,8440
6223,旺矽,209,7,202,摩根大通,2023-07-05,8440
3078,僑威,366,165,201,摩根大通,2023-07-05,8440
3673,TPK-KY,206,6,200,摩根大通,2023-07-05,8440
6274,台燿,292,93,199,摩根大通,2023-07-05,8440
1611,中電,642,447,195,摩根大通,2023-07-05,8440
2495,普安,200,10,190,摩根大通,2023-07-05,8440
2610,華航,3109,1132,1977,摩根大通,2023-07-06,8440
2634,漢翔,1719,285,1434,摩根大通,2023-07-06,8440
3715,定穎投控,2467,1093,1374,摩根大通,2023-07-06,8440
8086,宏捷科,1256,79,1177,摩根大通,2023-07-06,8440
1809,中釉,1027,87,940,摩根大通,2023-07-06,8440
3265,台星科,949,104,845,摩根大通,2023-07-06,8440
2340,台亞,1230,458,772,摩根大通,2023-07-06,8440
8936,國統,878,133,745,摩根大通,2023-07-06,8440
6016,康和證,827,84,743,摩根大通,2023-07-06,8440
2312,金寶,888,186,702,摩根大通,2023-07-06,8440
3163,波若威,810,115,695,摩根大通,2023-07-06,8440
4934,太極,1378,716,662,摩根大通,2023-07-06,8440
2356,英業達,2116,1456,660,摩根大通,2023-07-06,8440
2371,大同,927,307,620,摩根大通,2023-07-06,8440
6285,啟��,686,121,565,摩根大通,2023-07-06,8440
8046,南電,599,95,504,摩根大通,2023-07-06,8440
6116,彩晶,1130,629,501,摩根大通,2023-07-06,8440
3033,威健,487,9,478,摩根大通,2023-07-06,8440
3105,穩懋,823,400,423,摩根大通,2023-07-06,8440
6546,正基,423,24,399,摩根大通,2023-07-06,8440
2105,正新,1178,812,366,摩根大通,2023-07-06,8440
6138,茂達,508,145,363,摩根大通,2023-07-06,8440
3702,大聯大,425,77,348,摩根大通,2023-07-06,8440
2405,輔信,343,16,327,摩根大通,2023-07-06,8440
2206,三陽工業,396,78,318,摩根大通,2023-07-06,8440
3346,麗清,330,26,304,摩根大通,2023-07-06,8440
3037,欣興,966,665,301,摩根大通,2023-07-06,8440
4960,誠美材,375,81,294,摩根大通,2023-07-06,8440
1785,光洋科,294,2,292,摩根大通,2023-07-06,8440
3008,大立光,394,106,288,摩根大通,2023-07-06,8440
4906,正文,594,307,287,摩根大通,2023-07-06,8440
3034,聯詠,670,383,287,摩根大通,2023-07-06,8440
2393,億光,340,56,284,摩根大通,2023-07-06,8440
6142,友勁,303,20,283,摩根大通,2023-07-06,8440
8112,至上,346,65,281,摩根大通,2023-07-06,8440
4526,東台,271,14,257,摩根大通,2023-07-06,8440
6191,精成科,284,32,252,摩根大通,2023-07-06,8440
3019,亞光,255,12,243,摩根大通,2023-07-06,8440
4968,立積,260,22,238,摩根大通,2023-07-06,8440
6538,倉和,309,73,236,摩根大通,2023-07-06,8440
6190,萬泰科,240,10,230,摩根大通,2023-07-06,8440
3406,玉晶光,428,201,227,摩根大通,2023-07-06,8440
8163,達方,233,7,226,摩根大通,2023-07-06,8440
2426,鼎元,239,13,226,摩根大通,2023-07-06,8440
8105,凌巨,243,18,225,摩根大通,2023-07-06,8440
3521,鴻翊,227,3,224,摩根大通,2023-07-06,8440
2515,中工,485,263,222,摩根大通,2023-07-06,8440
4532,瑞智,511,289,222,摩根大通,2023-07-06,8440
8110,華東,239,19,220,摩根大通,2023-07-06,8440
2332,友訊,253,34,219,摩根大通,2023-07-06,8440
2610,華航,2854,905,1949,摩根大通,2023-07-07,8440
6016,康和證,1815,146,1669,摩根大通,2023-07-07,8440
3035,智原,1218,296,922,摩根大通,2023-07-07,8440
2368,金像電,942,54,888,摩根大通,2023-07-07,8440
2356,英業達,1745,878,867,摩根大通,2023-07-07,8440
2332,友訊,756,113,643,摩根大通,2023-07-07,8440
2323,中環,905,270,635,摩根大通,2023-07-07,8440
1609,大亞,943,342,601,摩根大通,2023-07-07,8440
6026,福邦證,560,1,559,摩根大通,2023-07-07,8440
3346,麗清,557,35,522,摩根大通,2023-07-07,8440
2449,京元電子,730,229,501,摩根大通,2023-07-07,8440
6274,台燿,652,173,479,摩根大通,2023-07-07,8440
6111,大宇資,558,105,453,摩根大通,2023-07-07,8440
2352,佳世達,614,170,444,摩根大通,2023-07-07,8440
2457,飛宏,506,76,430,摩根大通,2023-07-07,8440
2359,所羅門,612,184,428,摩根大通,2023-07-07,8440
2360,致茂,472,50,422,摩根大通,2023-07-07,8440
5388,中磊,640,225,415,摩根大通,2023-07-07,8440
6015,宏遠證,387,0,387,摩根大通,2023-07-07,8440
3702,大聯大,569,184,385,摩根大通,2023-07-07,8440
2371,大同,1197,813,384,摩根大通,2023-07-07,8440
2419,仲琦,1242,864,378,摩根大通,2023-07-07,8440
1809,中釉,586,228,358,摩根大通,2023-07-07,8440
2634,漢翔,433,95,338,摩根大通,2023-07-07,8440
3078,僑威,387,53,334,摩根大通,2023-07-07,8440
2436,偉詮電,454,132,322,摩根大通,2023-07-07,8440
2313,華通,441,125,316,摩根大通,2023-07-07,8440
6282,康舒,882,580,302,摩根大通,2023-07-07,8440
3033,威健,419,133,286,摩根大通,2023-07-07,8440
3576,聯合再生,376,104,272,摩根大通,2023-07-07,8440
2603,長榮,948,677,271,摩根大通,2023-07-07,8440
2312,金寶,1048,777,271,摩根大通,2023-07-07,8440
3362,先進光,788,519,269,摩根大通,2023-07-07,8440
2855,統一證,365,99,266,摩根大通,2023-07-07,8440
1444,力麗,326,66,260,摩根大通,2023-07-07,8440
1503,士電,402,145,257,摩根大通,2023-07-07,8440
5439,高技,288,42,246,摩根大通,2023-07-07,8440
2027,大成鋼,398,160,238,摩根大通,2023-07-07,8440
3013,晟銘電,240,2,238,摩根大通,2023-07-07,8440
3025,星通,493,262,231,摩根大通,2023-07-07,8440
2705,六福,280,51,229,摩根大通,2023-07-07,8440
8210,勤誠,266,47,219,摩根大通,2023-07-07,8440
3380,明泰,700,482,218,摩根大通,2023-07-07,8440
2206,三陽工業,531,322,209,摩根大通,2023-07-07,8440
2458,義隆,266,57,209,摩根大通,2023-07-07,8440
2630,亞航,249,40,209,摩根大通,2023-07-07,8440
2421,建準,508,305,203,摩根大通,2023-07-07,8440
6142,友勁,234,38,196,摩根大通,2023-07-07,8440
6547,高端疫苗,207,14,193,摩根大通,2023-07-07,8440
2328,廣宇,248,62,186,摩根大通,2023-07-07,8440
2618,長榮航,9955,1054,8901,摩根大通,2023-07-10,8440
2353,宏��,3451,698,2753,摩根大通,2023-07-10,8440
2332,友訊,1346,41,1305,摩根大通,2023-07-10,8440
3711,日月光投控,2312,1009,1303,摩根大通,2023-07-10,8440
2409,友達,3242,2209,1033,摩根大通,2023-07-10,8440
2206,三陽工業,1204,286,918,摩根大通,2023-07-10,8440
2329,華泰,1298,394,904,摩根大通,2023-07-10,8440
2421,建準,1034,222,812,摩根大通,2023-07-10,8440
6285,啟��,868,82,786,摩根大通,2023-07-10,8440
1785,光洋科,782,0,782,摩根大通,2023-07-10,8440
2356,英業達,1434,655,779,摩根大通,2023-07-10,8440
1809,中釉,812,65,747,摩根大通,2023-07-10,8440
1444,力麗,690,29,661,摩根大通,2023-07-10,8440
1609,大亞,693,69,624,摩根大通,2023-07-10,8440
3596,智易,766,195,571,摩根大通,2023-07-10,8440
3706,神達,620,80,540,摩根大通,2023-07-10,8440
2481,強茂,559,31,528,摩根大通,2023-07-10,8440
5469,瀚宇博,576,116,460,摩根大通,2023-07-10,8440
8105,凌巨,468,34,434,摩根大通,2023-07-10,8440
5483,中美晶,537,109,428,摩根大通,2023-07-10,8440
2542,興富發,444,37,407,摩根大通,2023-07-10,8440
2610,華航,493,90,403,摩根大通,2023-07-10,8440
6443,元晶,456,53,403,摩根大通,2023-07-10,8440
3016,嘉晶,389,24,365,摩根大通,2023-07-10,8440
8234,新漢,408,54,354,摩根大通,2023-07-10,8440
6126,信音,374,24,350,摩根大通,2023-07-10,8440
2402,毅嘉,372,31,341,摩根大通,2023-07-10,8440
6550,北極星藥業-KY,377,39,338,摩根大通,2023-07-10,8440
5388,中磊,524,191,333,摩根大通,2023-07-10,8440
1815,富喬,327,5,322,摩根大通,2023-07-10,8440
9958,世紀鋼,512,207,305,摩根大通,2023-07-10,8440
6168,宏齊,381,77,304,摩根大通,2023-07-10,8440
3515,華擎,344,50,294,摩根大通,2023-07-10,8440
4746,台耀,420,136,284,摩根大通,2023-07-10,8440
2426,鼎元,295,13,282,摩根大通,2023-07-10,8440
2312,金寶,581,304,277,摩根大通,2023-07-10,8440
2357,華碩,440,182,258,摩根大通,2023-07-10,8440
2392,正崴,292,35,257,摩根大通,2023-07-10,8440
2371,大同,655,401,254,摩根大通,2023-07-10,8440
2395,研華,377,135,242,摩根大通,2023-07-10,8440
4906,正文,386,154,232,摩根大通,2023-07-10,8440
4977,眾達-KY,305,81,224,摩根大通,2023-07-10,8440
2377,微星,425,202,223,摩根大通,2023-07-10,8440
2485,兆赫,269,57,212,摩根大通,2023-07-10,8440
3027,盛達,251,41,210,摩根大通,2023-07-10,8440
2489,瑞軒,888,682,206,摩根大通,2023-07-10,8440
2705,六福,213,8,205,摩根大通,2023-07-10,8440
6139,亞翔,222,19,203,摩根大通,2023-07-10,8440
1219,福壽,217,19,198,摩根大通,2023-07-10,8440
1710,東聯,310,116,194,摩根大通,2023-07-10,8440
2610,華航,5253,1978,3275,摩根大通,2023-07-11,8440
3231,緯創,4388,1803,2585,摩根大通,2023-07-11,8440
3481,群創,3042,519,2523,摩根大通,2023-07-11,8440
2887,台新金,1557,175,1382,摩根大通,2023-07-11,8440
6116,彩晶,1519,169,1350,摩根大通,2023-07-11,8440
2801,彰銀,1525,267,1258,摩根大通,2023-07-11,8440
2886,兆豐金,1402,162,1240,摩根大通,2023-07-11,8440
2409,友達,4531,3375,1156,摩根大通,2023-07-11,8440
2353,宏��,1645,510,1135,摩根大通,2023-07-11,8440
2885,元大金,1587,491,1096,摩根大通,2023-07-11,8440
2388,威盛,1340,277,1063,摩根大通,2023-07-11,8440
2890,永豐金,1252,204,1048,摩根大通,2023-07-11,8440
6005,群益證,876,9,867,摩根大通,2023-07-11,8440
2834,臺企銀,1011,221,790,摩根大通,2023-07-11,8440
2481,強茂,1428,666,762,摩根大通,2023-07-11,8440
2368,金像電,1073,319,754,摩根大通,2023-07-11,8440
6016,康和證,726,12,714,摩根大通,2023-07-11,8440
1722,台肥,728,19,709,摩根大通,2023-07-11,8440
8255,朋程,795,90,705,摩根大通,2023-07-11,8440
6274,台燿,923,236,687,摩根大通,2023-07-11,8440
2419,仲琦,719,90,629,摩根大通,2023-07-11,8440
3362,先進光,667,57,610,摩根大通,2023-07-11,8440
5871,中租-KY,666,58,608,摩根大通,2023-07-11,8440
5425,台半,611,50,561,摩根大通,2023-07-11,8440
1618,合機,571,69,502,摩根大通,2023-07-11,8440
2489,瑞軒,737,238,499,摩根大通,2023-07-11,8440
2323,中環,1538,1104,434,摩根大通,2023-07-11,8440
5439,高技,484,60,424,摩根大通,2023-07-11,8440
2542,興富發,419,5,414,摩根大通,2023-07-11,8440
2867,三商壽,571,163,408,摩根大通,2023-07-11,8440
2313,華通,425,29,396,摩根大通,2023-07-11,8440
2002,中鋼,699,312,387,摩根大通,2023-07-11,8440
2891,中信金,778,395,383,摩根大通,2023-07-11,8440
5457,宣德,409,35,374,摩根大通,2023-07-11,8440
3033,威健,373,0,373,摩根大通,2023-07-11,8440
4968,立積,535,179,356,摩根大通,2023-07-11,8440
2888,新光金,1927,1577,350,摩根大通,2023-07-11,8440
8028,昇陽半導體,352,8,344,摩根大通,2023-07-11,8440
3346,麗清,400,62,338,摩根大通,2023-07-11,8440
2498,宏達電,369,33,336,摩根大通,2023-07-11,8440
8105,凌巨,405,75,330,摩根大通,2023-07-11,8440
3189,景碩,325,0,325,摩根大通,2023-07-11,8440
2884,玉山金,602,279,323,摩根大通,2023-07-11,8440
6111,大宇資,413,91,322,摩根大通,2023-07-11,8440
2344,華邦電,496,182,314,摩根大通,2023-07-11,8440
2352,佳世達,570,257,313,摩根大通,2023-07-11,8440
1503,士電,363,69,294,摩根大通,2023-07-11,8440
1216,統一,550,264,286,摩根大通,2023-07-11,8440
3052,夆典,314,30,284,摩根大通,2023-07-11,8440
1101,台泥,600,316,284,摩根大通,2023-07-11,8440
2610,華航,6882,1775,5107,摩根大通,2023-07-12,8440
2885,元大金,4745,738,4007,摩根大通,2023-07-12,8440
2344,華邦電,3548,462,3086,摩根大通,2023-07-12,8440
3706,神達,2531,419,2112,摩根大通,2023-07-12,8440
2618,長榮航,2690,623,2067,摩根大通,2023-07-12,8440
2388,威盛,2421,611,1810,摩根大通,2023-07-12,8440
2382,廣達,2584,802,1782,摩根大通,2023-07-12,8440
2891,中信金,2641,1109,1532,摩根大通,2023-07-12,8440
2887,台新金,2177,846,1331,摩根大通,2023-07-12,8440
2328,廣宇,1734,433,1301,摩根大通,2023-07-12,8440
6139,亞翔,1360,290,1070,摩根大通,2023-07-12,8440
6120,達運,1398,376,1022,摩根大通,2023-07-12,8440
6285,啟��,1035,50,985,摩根大通,2023-07-12,8440
2324,仁寶,1616,701,915,摩根大通,2023-07-12,8440
2027,大成鋼,995,82,913,摩根大通,2023-07-12,8440
1605,華新,1208,364,844,摩根大通,2023-07-12,8440
2206,三陽工業,910,80,830,摩根大通,2023-07-12,8440
2892,第一金,1555,752,803,摩根大通,2023-07-12,8440
2312,金寶,1014,367,647,摩根大通,2023-07-12,8440
2352,佳世達,807,160,647,摩根大通,2023-07-12,8440
1216,統一,1174,558,616,摩根大通,2023-07-12,8440
2359,所羅門,815,200,615,摩根大通,2023-07-12,8440
2356,英業達,805,224,581,摩根大通,2023-07-12,8440
2353,宏��,745,177,568,摩根大通,2023-07-12,8440
4915,致伸,569,33,536,摩根大通,2023-07-12,8440
2371,大同,1022,523,499,摩根大通,2023-07-12,8440
2204,中華,584,103,481,摩根大通,2023-07-12,8440
3032,偉訓,532,52,480,摩根大通,2023-07-12,8440
2705,六福,479,12,467,摩根大通,2023-07-12,8440
2105,正新,620,176,444,摩根大通,2023-07-12,8440
2376,技嘉,808,371,437,摩根大通,2023-07-12,8440
3033,威健,433,6,427,摩根大通,2023-07-12,8440
1609,大亞,523,100,423,摩根大通,2023-07-12,8440
1504,東元,586,175,411,摩根大通,2023-07-12,8440
2630,亞航,412,11,401,摩根大通,2023-07-12,8440
3363,上詮,450,63,387,摩根大通,2023-07-12,8440
6550,北極星藥業-KY,389,10,379,摩根大通,2023-07-12,8440
4526,東台,387,11,376,摩根大通,2023-07-12,8440
2323,中環,973,606,367,摩根大通,2023-07-12,8440
5483,中美晶,608,246,362,摩根大通,2023-07-12,8440
5706,鳳凰,380,24,356,摩根大通,2023-07-12,8440
3058,立德,394,39,355,摩根大通,2023-07-12,8440
8358,金居,369,23,346,摩根大通,2023-07-12,8440
5871,中租-KY,390,56,334,摩根大通,2023-07-12,8440
2329,華泰,414,81,333,摩根大通,2023-07-12,8440
2542,興富發,379,49,330,摩根大通,2023-07-12,8440
2890,永豐金,1098,792,306,摩根大通,2023-07-12,8440
3038,全台,393,93,300,摩根大通,2023-07-12,8440
5457,宣德,628,329,299,摩根大通,2023-07-12,8440
2736,富野,294,2,292,摩根大通,2023-07-12,8440
2388,威盛,6101,839,5262,摩根大通,2023-07-13,8440
2330,台積電,5338,263,5075,摩根大通,2023-07-13,8440
6116,彩晶,2783,43,2740,摩根大通,2023-07-13,8440
2885,元大金,2766,67,2699,摩根大通,2023-07-13,8440
0050,元大台灣50,2597,0,2597,摩根大通,2023-07-13,8440
2888,新光金,3021,467,2554,摩根大通,2023-07-13,8440
3481,群創,3119,788,2331,摩根大通,2023-07-13,8440
2356,英業達,3525,1345,2180,摩根大通,2023-07-13,8440
2887,台新金,1952,72,1880,摩根大通,2023-07-13,8440
2891,中信金,1919,84,1835,摩根大通,2023-07-13,8440
2312,金寶,2172,509,1663,摩根大通,2023-07-13,8440
2884,玉山金,1723,78,1645,摩根大通,2023-07-13,8440
2344,華邦電,1554,35,1519,摩根大通,2023-07-13,8440
2892,第一金,1475,24,1451,摩根大通,2023-07-13,8440
3037,欣興,1798,414,1384,摩根大通,2023-07-13,8440
2801,彰銀,1395,99,1296,摩根大通,2023-07-13,8440
2002,中鋼,1281,39,1242,摩根大通,2023-07-13,8440
2323,中環,1507,292,1215,摩根大通,2023-07-13,8440
2890,永豐金,1233,20,1213,摩根大通,2023-07-13,8440
2882,國泰金,1329,196,1133,摩根大通,2023-07-13,8440
2328,廣宇,1324,245,1079,摩根大通,2023-07-13,8440
6288,聯嘉,1050,3,1047,摩根大通,2023-07-13,8440
2301,光寶科,1995,1083,912,摩根大通,2023-07-13,8440
2886,兆豐金,1257,348,909,摩根大通,2023-07-13,8440
2340,台亞,940,65,875,摩根大通,2023-07-13,8440
2317,鴻海,1231,371,860,摩根大通,2023-07-13,8440
6285,啟��,1040,264,776,摩根大通,2023-07-13,8440
6235,華孚,801,78,723,摩根大通,2023-07-13,8440
3325,旭品,701,16,685,摩根大通,2023-07-13,8440
5871,中租-KY,786,109,677,摩根大通,2023-07-13,8440
3264,欣銓,658,1,657,摩根大通,2023-07-13,8440
4938,和碩,797,167,630,摩根大通,2023-07-13,8440
1216,統一,721,114,607,摩根大通,2023-07-13,8440
5439,高技,902,302,600,摩根大通,2023-07-13,8440
8155,博智,905,333,572,摩根大通,2023-07-13,8440
3105,穩懋,558,14,544,摩根大通,2023-07-13,8440
2880,華南金,604,63,541,摩根大通,2023-07-13,8440
8936,國統,726,219,507,摩根大通,2023-07-13,8440
2347,聯強,596,89,507,摩根大通,2023-07-13,8440
1560,中砂,549,61,488,摩根大通,2023-07-13,8440
8358,金居,484,6,478,摩根大通,2023-07-13,8440
6274,台燿,1237,767,470,摩根大通,2023-07-13,8440
3078,僑威,661,196,465,摩根大通,2023-07-13,8440
2206,三陽工業,554,89,465,摩根大通,2023-07-13,8440
6218,豪勉,462,16,446,摩根大通,2023-07-13,8440
3702,大聯大,442,5,437,摩根大通,2023-07-13,8440
3380,明泰,487,80,407,摩根大通,2023-07-13,8440
6161,捷波,409,51,358,摩根大通,2023-07-13,8440
6223,旺矽,375,18,357,摩根大通,2023-07-13,8440
2313,華通,438,84,354,摩根大通,2023-07-13,8440
3231,緯創,5597,413,5184,摩根大通,2023-07-14,8440
2618,長榮航,4040,304,3736,摩根大通,2023-07-14,8440
2886,兆豐金,3196,39,3157,摩根大通,2023-07-14,8440
2317,鴻海,2835,255,2580,摩根大通,2023-07-14,8440
2885,元大金,2506,65,2441,摩根大通,2023-07-14,8440
2449,京元電子,3089,684,2405,摩根大通,2023-07-14,8440
2888,新光金,2390,383,2007,摩根大通,2023-07-14,8440
2323,中環,1937,43,1894,摩根大通,2023-07-14,8440
2330,台積電,2793,1094,1699,摩根大通,2023-07-14,8440
2884,玉山金,1920,296,1624,摩根大通,2023-07-14,8440
3711,日月光投控,1647,586,1061,摩根大通,2023-07-14,8440
6120,達運,1194,165,1029,摩根大通,2023-07-14,8440
3037,欣興,1275,266,1009,摩根大通,2023-07-14,8440
0050,元大台灣50,1010,14,996,摩根大通,2023-07-14,8440
1513,中興電,1252,317,935,摩根大通,2023-07-14,8440
2801,彰銀,998,76,922,摩根大通,2023-07-14,8440
2356,英業達,3100,2233,867,摩根大通,2023-07-14,8440
2455,全新,874,14,860,摩根大通,2023-07-14,8440
1514,亞力,990,156,834,摩根大通,2023-07-14,8440
1905,華紙,900,115,785,摩根大通,2023-07-14,8440
5607,遠雄港,879,96,783,摩根大通,2023-07-14,8440
6179,亞通,797,24,773,摩根大通,2023-07-14,8440
2812,台中銀,873,108,765,摩根大通,2023-07-14,8440
3035,智原,1013,271,742,摩根大通,2023-07-14,8440
4938,和碩,854,139,715,摩根大通,2023-07-14,8440
6285,啟��,793,129,664,摩根大通,2023-07-14,8440
2201,裕隆,831,174,657,摩根大通,2023-07-14,8440
2301,光寶科,4105,3453,652,摩根大通,2023-07-14,8440
2303,聯電,1768,1138,630,摩根大通,2023-07-14,8440
2324,仁寶,4132,3534,598,摩根大通,2023-07-14,8440
3363,上詮,850,262,588,摩根大通,2023-07-14,8440
8936,國統,998,423,575,摩根大通,2023-07-14,8440
6116,彩晶,652,107,545,摩根大通,2023-07-14,8440
3034,聯詠,644,100,544,摩根大通,2023-07-14,8440
2388,威盛,1405,865,540,摩根大通,2023-07-14,8440
1503,士電,917,384,533,摩根大通,2023-07-14,8440
5871,中租-KY,579,52,527,摩根大通,2023-07-14,8440
2399,映泰,576,49,527,摩根大通,2023-07-14,8440
3058,立德,567,49,518,摩根大通,2023-07-14,8440
6005,群益證,479,0,479,摩根大通,2023-07-14,8440
2883,凱基金,983,519,464,摩根大通,2023-07-14,8440
3078,僑威,1015,564,451,摩根大通,2023-07-14,8440
6239,力成,536,89,447,摩根大通,2023-07-14,8440
3005,神基,460,17,443,摩根大通,2023-07-14,8440
8028,昇陽半導體,473,31,442,摩根大通,2023-07-14,8440
2329,華泰,864,430,434,摩根大通,2023-07-14,8440
1210,大成,443,22,421,摩根大通,2023-07-14,8440
3033,威健,487,77,410,摩根大通,2023-07-14,8440
3071,協禧,648,240,408,摩根大通,2023-07-14,8440
6188,廣明,613,214,399,摩根大通,2023-07-14,8440
6116,彩晶,5584,22,5562,摩根大通,2023-07-17,8440
2888,新光金,4536,214,4322,摩根大通,2023-07-17,8440
2887,台新金,3932,197,3735,摩根大通,2023-07-17,8440
1609,大亞,3535,1194,2341,摩根大通,2023-07-17,8440
2881,富邦金,2424,297,2127,摩根大通,2023-07-17,8440
2886,兆豐金,2005,101,1904,摩根大通,2023-07-17,8440
2801,彰銀,2049,185,1864,摩根大通,2023-07-17,8440
6274,台燿,2257,443,1814,摩根大通,2023-07-17,8440
2618,長榮航,2628,970,1658,摩根大通,2023-07-17,8440
1313,聯成,1619,6,1613,摩根大通,2023-07-17,8440
2449,京元電子,2704,1252,1452,摩根大通,2023-07-17,8440
1514,亞力,1868,483,1385,摩根大通,2023-07-17,8440
3481,群創,1485,224,1261,摩根大通,2023-07-17,8440
4123,晟德,1370,173,1197,摩根大通,2023-07-17,8440
2812,台中銀,1223,60,1163,摩根大通,2023-07-17,8440
2303,聯電,1349,191,1158,摩根大通,2023-07-17,8440
2885,元大金,1283,128,1155,摩根大通,2023-07-17,8440
2603,長榮,1484,476,1008,摩根大通,2023-07-17,8440
2882,國泰金,1209,205,1004,摩根大通,2023-07-17,8440
1101,台泥,1010,57,953,摩根大通,2023-07-17,8440
3518,柏騰,992,108,884,摩根大通,2023-07-17,8440
2880,華南金,828,19,809,摩根大通,2023-07-17,8440
2105,正新,921,128,793,摩根大通,2023-07-17,8440
2323,中環,1122,347,775,摩根大通,2023-07-17,8440
6120,達運,934,161,773,摩根大通,2023-07-17,8440
6282,康舒,1459,697,762,摩根大通,2023-07-17,8440
2312,金寶,2666,1911,755,摩根大通,2023-07-17,8440
2002,中鋼,841,136,705,摩根大通,2023-07-17,8440
3264,欣銓,712,9,703,摩根大通,2023-07-17,8440
2349,錸德,695,4,691,摩根大通,2023-07-17,8440
2884,玉山金,1010,344,666,摩根大通,2023-07-17,8440
5880,合庫金,888,241,647,摩根大通,2023-07-17,8440
2344,華邦電,639,39,600,摩根大通,2023-07-17,8440
2892,第一金,792,210,582,摩根大通,2023-07-17,8440
6005,群益證,578,51,527,摩根大通,2023-07-17,8440
8358,金居,512,3,509,摩根大通,2023-07-17,8440
2354,鴻準,655,172,483,摩根大通,2023-07-17,8440
5328,華容,583,104,479,摩根大通,2023-07-17,8440
6122,擎邦,458,0,458,摩根大通,2023-07-17,8440
3576,聯合再生,523,82,441,摩根大通,2023-07-17,8440
1210,大成,615,175,440,摩根大通,2023-07-17,8440
1504,東元,828,407,421,摩根大通,2023-07-17,8440
6550,北極星藥業-KY,409,6,403,摩根大通,2023-07-17,8440
2206,三陽工業,476,74,402,摩根大通,2023-07-17,8440
3362,先進光,588,197,391,摩根大通,2023-07-17,8440
3712,永崴投控,398,16,382,摩根大通,2023-07-17,8440
1605,華新,473,94,379,摩根大通,2023-07-17,8440
4128,中天,434,69,365,摩根大通,2023-07-17,8440
3515,華擎,538,190,348,摩根大通,2023-07-17,8440
3265,台星科,421,80,341,摩根大通,2023-07-17,8440
3231,緯創,8719,987,7732,摩根大通,2023-07-18,8440
3706,神達,9045,2275,6770,摩根大通,2023-07-18,8440
2317,鴻海,6761,1632,5129,摩根大通,2023-07-18,8440
2887,台新金,3786,221,3565,摩根大通,2023-07-18,8440
2886,兆豐金,3372,545,2827,摩根大通,2023-07-18,8440
2356,英業達,4587,2087,2500,摩根大通,2023-07-18,8440
3481,群創,2883,472,2411,摩根大通,2023-07-18,8440
2882,國泰金,2865,482,2383,摩根大通,2023-07-18,8440
3037,欣興,2989,1018,1971,摩根大通,2023-07-18,8440
2881,富邦金,3449,1479,1970,摩根大通,2023-07-18,8440
2353,宏��,5753,3899,1854,摩根大通,2023-07-18,8440
2609,陽明,2115,275,1840,摩根大通,2023-07-18,8440
2323,中環,2188,532,1656,摩根大通,2023-07-18,8440
2376,技嘉,2148,712,1436,摩根大通,2023-07-18,8440
2834,臺企銀,1448,61,1387,摩根大通,2023-07-18,8440
2884,玉山金,1322,215,1107,摩根大通,2023-07-18,8440
2890,永豐金,1124,29,1095,摩根大通,2023-07-18,8440
2885,元大金,1181,132,1049,摩根大通,2023-07-18,8440
1504,東元,1223,235,988,摩根大通,2023-07-18,8440
2883,凱基金,1049,72,977,摩根大通,2023-07-18,8440
2801,彰銀,1371,422,949,摩根大通,2023-07-18,8440
3264,欣銓,1234,303,931,摩根大通,2023-07-18,8440
3483,力致,1482,670,812,摩根大通,2023-07-18,8440
6841,長佳智能,891,221,670,摩根大通,2023-07-18,8440
3704,合勤控,918,262,656,摩根大通,2023-07-18,8440
6274,台燿,1553,949,604,摩根大通,2023-07-18,8440
2340,台亞,958,373,585,摩根大通,2023-07-18,8440
2349,錸德,594,25,569,摩根大通,2023-07-18,8440
0050,元大台灣50,552,5,547,摩根大通,2023-07-18,8440
2461,光群雷,553,30,523,摩根大通,2023-07-18,8440
2419,仲琦,1235,731,504,摩根大通,2023-07-18,8440
6005,群益證,507,33,474,摩根大通,2023-07-18,8440
2330,台積電,1159,688,471,摩根大通,2023-07-18,8440
2383,台光電,824,369,455,摩根大通,2023-07-18,8440
2401,凌陽,514,76,438,摩根大通,2023-07-18,8440
5258,虹堡,595,179,416,摩根大通,2023-07-18,8440
2486,一詮,525,149,376,摩根大通,2023-07-18,8440
3163,波若威,757,382,375,摩根大通,2023-07-18,8440
8150,南茂,367,6,361,摩根大通,2023-07-18,8440
3324,雙鴻,422,65,357,摩根大通,2023-07-18,8440
2354,鴻準,609,257,352,摩根大通,2023-07-18,8440
2892,第一金,667,318,349,摩根大通,2023-07-18,8440
6188,廣明,1162,814,348,摩根大通,2023-07-18,8440
5439,高技,366,58,308,摩根大通,2023-07-18,8440
1301,台塑,418,130,288,摩根大通,2023-07-18,8440
3105,穩懋,323,35,288,摩根大通,2023-07-18,8440
3380,明泰,446,166,280,摩根大通,2023-07-18,8440
6182,合晶,369,90,279,摩根大通,2023-07-18,8440
3035,智原,631,362,269,摩根大通,2023-07-18,8440
6550,北極星藥業-KY,289,25,264,摩根大通,2023-07-18,8440
2609,陽明,4484,782,3702,摩根大通,2023-07-19,8440
2324,仁寶,9614,6357,3257,摩根大通,2023-07-19,8440
3231,緯創,4889,2275,2614,摩根大通,2023-07-19,8440
6120,達運,2375,204,2171,摩根大通,2023-07-19,8440
2801,彰銀,3271,1192,2079,摩根大通,2023-07-19,8440
4123,晟德,2305,632,1673,摩根大通,2023-07-19,8440
2834,臺企銀,2025,782,1243,摩根大通,2023-07-19,8440
2454,聯發科,1310,75,1235,摩根大通,2023-07-19,8440
6285,啟��,1275,293,982,摩根大通,2023-07-19,8440
2884,玉山金,1739,832,907,摩根大通,2023-07-19,8440
2312,金寶,2134,1233,901,摩根大通,2023-07-19,8440
3035,智原,1440,593,847,摩根大通,2023-07-19,8440
2461,光群雷,943,168,775,摩根大通,2023-07-19,8440
2421,建準,2455,1721,734,摩根大通,2023-07-19,8440
4726,永昕,853,125,728,摩根大通,2023-07-19,8440
2382,廣達,2197,1521,676,摩根大通,2023-07-19,8440
2515,中工,820,158,662,摩根大通,2023-07-19,8440
3032,偉訓,928,283,645,摩根大通,2023-07-19,8440
8403,盛弘,675,34,641,摩根大通,2023-07-19,8440
4938,和碩,1672,1058,614,摩根大通,2023-07-19,8440
2405,輔信,751,140,611,摩根大通,2023-07-19,8440
2891,中信金,2803,2205,598,摩根大通,2023-07-19,8440
6188,廣明,1410,831,579,摩根大通,2023-07-19,8440
6274,台燿,1004,451,553,摩根大通,2023-07-19,8440
2603,長榮,919,434,485,摩根大通,2023-07-19,8440
2449,京元電子,644,177,467,摩根大通,2023-07-19,8440
6546,正基,875,417,458,摩根大通,2023-07-19,8440
6016,康和證,457,29,428,摩根大通,2023-07-19,8440
2301,光寶科,1612,1202,410,摩根大通,2023-07-19,8440
8112,至上,460,56,404,摩根大通,2023-07-19,8440
4129,聯合,426,23,403,摩根大通,2023-07-19,8440
6282,康舒,1231,851,380,摩根大通,2023-07-19,8440
1608,華榮,376,0,376,摩根大通,2023-07-19,8440
2347,聯強,416,43,373,摩根大通,2023-07-19,8440
3346,麗清,386,19,367,摩根大通,2023-07-19,8440
3533,嘉澤,402,56,346,摩根大通,2023-07-19,8440
2323,中環,1057,728,329,摩根大通,2023-07-19,8440
1210,大成,467,141,326,摩根大通,2023-07-19,8440
2388,威盛,405,84,321,摩根大通,2023-07-19,8440
3481,群創,2445,2128,317,摩根大通,2023-07-19,8440
2889,國票金,433,117,316,摩根大通,2023-07-19,8440
5469,瀚宇博,463,155,308,摩根大通,2023-07-19,8440
6548,長科*,434,133,301,摩根大通,2023-07-19,8440
5483,中美晶,718,418,300,摩根大通,2023-07-19,8440
6472,保瑞,401,114,287,摩根大通,2023-07-19,8440
2401,凌陽,350,68,282,摩根大通,2023-07-19,8440
8150,南茂,333,57,276,摩根大通,2023-07-19,8440
3515,華擎,307,40,267,摩根大通,2023-07-19,8440
2395,研華,334,70,264,摩根大通,2023-07-19,8440
3205,佰研,334,77,257,摩根大通,2023-07-19,8440
2885,元大金,6335,90,6245,摩根大通,2023-07-20,8440
2610,華航,7242,1530,5712,摩根大通,2023-07-20,8440
2884,玉山金,3480,152,3328,摩根大通,2023-07-20,8440
2618,長榮航,5295,2141,3154,摩根大通,2023-07-20,8440
2353,宏��,4122,978,3144,摩根大通,2023-07-20,8440
1609,大亞,2506,108,2398,摩根大通,2023-07-20,8440
2887,台新金,2720,833,1887,摩根大通,2023-07-20,8440
2330,台積電,2075,658,1417,摩根大通,2023-07-20,8440
0050,元大台灣50,1291,23,1268,摩根大通,2023-07-20,8440
6016,康和證,1244,0,1244,摩根大通,2023-07-20,8440
1504,東元,1201,40,1161,摩根大通,2023-07-20,8440
3105,穩懋,1240,86,1154,摩根大通,2023-07-20,8440
2603,長榮,1358,237,1121,摩根大通,2023-07-20,8440
1101,台泥,1150,71,1079,摩根大通,2023-07-20,8440
2834,臺企銀,1361,289,1072,摩根大通,2023-07-20,8440
3044,健鼎,1115,193,922,摩根大通,2023-07-20,8440
2027,大成鋼,1166,333,833,摩根大通,2023-07-20,8440
2323,中環,1272,442,830,摩根大通,2023-07-20,8440
2371,大同,1057,274,783,摩根大通,2023-07-20,8440
2882,國泰金,1532,826,706,摩根大通,2023-07-20,8440
2344,華邦電,730,35,695,摩根大通,2023-07-20,8440
2382,廣達,2050,1356,694,摩根大通,2023-07-20,8440
1301,台塑,732,40,692,摩根大通,2023-07-20,8440
2890,永豐金,1806,1135,671,摩根大通,2023-07-20,8440
3515,華擎,670,8,662,摩根大通,2023-07-20,8440
9904,寶成,1066,416,650,摩根大通,2023-07-20,8440
1104,環泥,670,47,623,摩根大通,2023-07-20,8440
1514,亞力,806,188,618,摩根大通,2023-07-20,8440
6274,台燿,1878,1262,616,摩根大通,2023-07-20,8440
1905,華紙,743,129,614,摩根大通,2023-07-20,8440
1605,華新,904,313,591,摩根大通,2023-07-20,8440
2347,聯強,648,88,560,摩根大通,2023-07-20,8440
8210,勤誠,630,96,534,摩根大通,2023-07-20,8440
2412,中華電,602,87,515,摩根大通,2023-07-20,8440
2331,精英,529,17,512,摩根大通,2023-07-20,8440
6112,邁達特,543,51,492,摩根大通,2023-07-20,8440
2615,萬海,641,176,465,摩根大通,2023-07-20,8440
2376,技嘉,935,473,462,摩根大通,2023-07-20,8440
2340,台亞,529,75,454,摩根大通,2023-07-20,8440
2395,研華,542,105,437,摩根大通,2023-07-20,8440
2329,華泰,465,38,427,摩根大通,2023-07-20,8440
2801,彰銀,1344,925,419,摩根大通,2023-07-20,8440
2388,威盛,449,45,404,摩根大通,2023-07-20,8440
4904,遠傳,415,13,402,摩根大通,2023-07-20,8440
2383,台光電,974,574,400,摩根大通,2023-07-20,8440
2317,鴻海,973,589,384,摩根大通,2023-07-20,8440
3141,晶宏,470,91,379,摩根大通,2023-07-20,8440
3380,明泰,478,106,372,摩根大通,2023-07-20,8440
3706,神達,545,182,363,摩根大通,2023-07-20,8440
2637,慧洋-KY,658,300,358,摩根大通,2023-07-20,8440
3576,聯合再生,10277,228,10049,摩根大通,2023-07-21,8440
2329,華泰,2892,538,2354,摩根大通,2023-07-21,8440
2885,元大金,3502,1158,2344,摩根大通,2023-07-21,8440
1504,東元,3252,992,2260,摩根大通,2023-07-21,8440
4904,遠傳,2702,455,2247,摩根大通,2023-07-21,8440
6116,彩晶,2864,727,2137,摩根大通,2023-07-21,8440
2376,技嘉,2963,853,2110,摩根大通,2023-07-21,8440
2312,金寶,1964,307,1657,摩根大通,2023-07-21,8440
2449,京元電子,2034,551,1483,摩根大通,2023-07-21,8440
1609,大亞,1711,262,1449,摩根大通,2023-07-21,8440
2382,廣達,4984,3637,1347,摩根大通,2023-07-21,8440
2360,致茂,1017,74,943,摩根大通,2023-07-21,8440
2408,南亞科,1406,512,894,摩根大通,2023-07-21,8440
2637,慧洋-KY,919,92,827,摩根大通,2023-07-21,8440
2399,映泰,797,18,779,摩根大通,2023-07-21,8440
2347,聯強,1280,523,757,摩根大通,2023-07-21,8440
2884,玉山金,2218,1466,752,摩根大通,2023-07-21,8440
1514,亞力,914,175,739,摩根大通,2023-07-21,8440
3260,威剛,711,3,708,摩根大通,2023-07-21,8440
6176,瑞儀,772,78,694,摩根大通,2023-07-21,8440
2421,建準,2036,1343,693,摩根大通,2023-07-21,8440
2357,華碩,1144,461,683,摩根大通,2023-07-21,8440
2834,臺企銀,2049,1374,675,摩根大通,2023-07-21,8440
4915,致伸,722,54,668,摩根大通,2023-07-21,8440
6278,台表科,1127,468,659,摩根大通,2023-07-21,8440
1529,樂事綠能,845,224,621,摩根大通,2023-07-21,8440
8069,元太,932,316,616,摩根大通,2023-07-21,8440
3706,神達,697,84,613,摩根大通,2023-07-21,8440
2603,長榮,1149,543,606,摩根大通,2023-07-21,8440
2340,台亞,689,90,599,摩根大通,2023-07-21,8440
8112,至上,671,75,596,摩根大通,2023-07-21,8440
3055,蔚華科,757,167,590,摩根大通,2023-07-21,8440
2383,台光電,1002,426,576,摩根大通,2023-07-21,8440
6217,中探針,577,15,562,摩根大通,2023-07-21,8440
3715,定穎投控,604,43,561,摩根大通,2023-07-21,8440
1795,美時,661,130,531,摩根大通,2023-07-21,8440
9105,泰金寶-DR,519,0,519,摩根大通,2023-07-21,8440
2388,威盛,548,35,513,摩根大通,2023-07-21,8440
9904,寶成,1121,612,509,摩根大通,2023-07-21,8440
2461,光群雷,651,156,495,摩根大通,2023-07-21,8440
3689,湧德,524,31,493,摩根大通,2023-07-21,8440
2204,中華,542,50,492,摩根大通,2023-07-21,8440
3324,雙鴻,666,205,461,摩根大通,2023-07-21,8440
1467,南緯,495,35,460,摩根大通,2023-07-21,8440
6214,精誠,544,89,455,摩根大通,2023-07-21,8440
3051,力特,1072,620,452,摩根大通,2023-07-21,8440
2337,旺宏,636,193,443,摩根大通,2023-07-21,8440
2356,英業達,1811,1384,427,摩根大通,2023-07-21,8440
2455,全新,516,116,400,摩根大通,2023-07-21,8440
1217,愛之味,412,26,386,摩根大通,2023-07-21,8440
1605,華新,3741,617,3124,摩根大通,2023-07-24,8440
2357,華碩,2935,740,2195,摩根大通,2023-07-24,8440
2303,聯電,7084,5086,1998,摩根大通,2023-07-24,8440
3576,聯合再生,2052,335,1717,摩根大通,2023-07-24,8440
2885,元大金,2489,910,1579,摩根大通,2023-07-24,8440
2376,技嘉,3318,1812,1506,摩根大通,2023-07-24,8440
1905,華紙,2400,1213,1187,摩根大通,2023-07-24,8440
2324,仁寶,2085,1204,881,摩根大通,2023-07-24,8440
2610,華航,1207,426,781,摩根大通,2023-07-24,8440
2883,凱基金,5365,4596,769,摩根大通,2023-07-24,8440
3706,神達,823,55,768,摩根大通,2023-07-24,8440
1303,南亞,1572,815,757,摩根大通,2023-07-24,8440
9105,泰金寶-DR,782,81,701,摩根大通,2023-07-24,8440
9904,寶成,1062,408,654,摩根大通,2023-07-24,8440
2347,聯強,792,181,611,摩根大通,2023-07-24,8440
4904,遠傳,1206,633,573,摩根大通,2023-07-24,8440
4938,和碩,1425,903,522,摩根大通,2023-07-24,8440
3017,奇鋐,894,391,503,摩根大通,2023-07-24,8440
2637,慧洋-KY,990,488,502,摩根大通,2023-07-24,8440
6116,彩晶,921,426,495,摩根大通,2023-07-24,8440
3661,世芯-KY,459,48,411,摩根大通,2023-07-24,8440
5452,佶優,568,168,400,摩根大通,2023-07-24,8440
3533,嘉澤,443,47,396,摩根大通,2023-07-24,8440
1532,勤美,453,61,392,摩根大通,2023-07-24,8440
8926,台汽電,508,140,368,摩根大通,2023-07-24,8440
5347,世界,426,84,342,摩根大通,2023-07-24,8440
3374,精材,367,31,336,摩根大通,2023-07-24,8440
1305,華夏,493,158,335,摩根大通,2023-07-24,8440
8210,勤誠,717,383,334,摩根大通,2023-07-24,8440
6176,瑞儀,412,82,330,摩根大通,2023-07-24,8440
2308,台達電,786,468,318,摩根大通,2023-07-24,8440
3032,偉訓,890,580,310,摩根大通,2023-07-24,8440
3042,晶技,300,13,287,摩根大通,2023-07-24,8440
2454,聯發科,695,416,279,摩根大通,2023-07-24,8440
6669,緯穎,405,134,271,摩根大通,2023-07-24,8440
3260,威剛,319,56,263,摩根大通,2023-07-24,8440
3231,緯創,1446,1190,256,摩根大通,2023-07-24,8440
4958,臻鼎-KY,313,60,253,摩根大通,2023-07-24,8440
8069,元太,332,79,253,摩根大通,2023-07-24,8440
8112,至上,329,82,247,摩根大通,2023-07-24,8440
6218,豪勉,272,25,247,摩根大通,2023-07-24,8440
1476,儒鴻,319,85,234,摩根大通,2023-07-24,8440
6188,廣明,525,298,227,摩根大通,2023-07-24,8440
4543,萬在,284,75,209,摩根大通,2023-07-24,8440
2395,研華,312,112,200,摩根大通,2023-07-24,8440
1471,首利,234,50,184,摩根大通,2023-07-24,8440
3289,宜特,215,35,180,摩根大通,2023-07-24,8440
3680,家登,185,8,177,摩根大通,2023-07-24,8440
3034,聯詠,282,106,176,摩根大通,2023-07-24,8440
1618,合機,240,76,164,摩根大通,2023-07-24,8440
1504,東元,5516,750,4766,摩根大通,2023-07-25,8440
2317,鴻海,4886,834,4052,摩根大通,2023-07-25,8440
2357,華碩,5428,1468,3960,摩根大通,2023-07-25,8440
2887,台新金,4890,1830,3060,摩根大通,2023-07-25,8440
2324,仁寶,3748,1009,2739,摩根大通,2023-07-25,8440
2353,宏��,2957,697,2260,摩根大通,2023-07-25,8440
2885,元大金,2573,573,2000,摩根大通,2023-07-25,8440
2356,英業達,2431,748,1683,摩根大通,2023-07-25,8440
2323,中環,2024,406,1618,摩根大通,2023-07-25,8440
2421,建準,2107,595,1512,摩根大通,2023-07-25,8440
2352,佳世達,1354,91,1263,摩根大通,2023-07-25,8440
4726,永昕,1220,71,1149,摩根大通,2023-07-25,8440
2308,台達電,1297,168,1129,摩根大通,2023-07-25,8440
2371,大同,1147,132,1015,摩根大通,2023-07-25,8440
4938,和碩,1530,754,776,摩根大通,2023-07-25,8440
3706,神達,824,49,775,摩根大通,2023-07-25,8440
2884,玉山金,1226,462,764,摩根大通,2023-07-25,8440
8358,金居,1675,915,760,摩根大通,2023-07-25,8440
2399,映泰,952,235,717,摩根大通,2023-07-25,8440
2330,台積電,1839,1135,704,摩根大通,2023-07-25,8440
2449,京元電子,2113,1440,673,摩根大通,2023-07-25,8440
4904,遠傳,753,107,646,摩根大通,2023-07-25,8440
3715,定穎投控,831,189,642,摩根大通,2023-07-25,8440
6126,信音,635,0,635,摩根大通,2023-07-25,8440
8112,至上,635,22,613,摩根大通,2023-07-25,8440
3032,偉訓,841,238,603,摩根大通,2023-07-25,8440
3702,大聯大,713,126,587,摩根大通,2023-07-25,8440
6116,彩晶,735,165,570,摩根大通,2023-07-25,8440
2354,鴻準,1267,714,553,摩根大通,2023-07-25,8440
2891,中信金,1179,637,542,摩根大通,2023-07-25,8440
1514,亞力,826,304,522,摩根大通,2023-07-25,8440
6235,華孚,1086,571,515,摩根大通,2023-07-25,8440
3078,僑威,616,102,514,摩根大通,2023-07-25,8440
2313,華通,660,154,506,摩根大通,2023-07-25,8440
2002,中鋼,1033,528,505,摩根大通,2023-07-25,8440
1301,台塑,635,156,479,摩根大通,2023-07-25,8440
6282,康舒,924,446,478,摩根大通,2023-07-25,8440
2201,裕隆,554,101,453,摩根大通,2023-07-25,8440
6112,邁達特,479,34,445,摩根大通,2023-07-25,8440
4129,聯合,527,86,441,摩根大通,2023-07-25,8440
2495,普安,605,168,437,摩根大通,2023-07-25,8440
2607,榮運,446,68,378,摩根大通,2023-07-25,8440
2206,三陽工業,497,129,368,摩根大通,2023-07-25,8440
2457,飛宏,383,23,360,摩根大通,2023-07-25,8440
2303,聯電,1405,1049,356,摩根大通,2023-07-25,8440
1612,宏泰,452,102,350,摩根大通,2023-07-25,8440
1108,幸福,355,12,343,摩根大通,2023-07-25,8440
3540,曜越,393,54,339,摩根大通,2023-07-25,8440
3029,零壹,377,54,323,摩根大通,2023-07-25,8440
2883,凱基金,999,697,302,摩根大通,2023-07-25,8440
2888,新光金,8496,625,7871,摩根大通,2023-07-26,8440
2409,友達,5087,428,4659,摩根大通,2023-07-26,8440
2882,國泰金,5150,718,4432,摩根大通,2023-07-26,8440
2884,玉山金,3650,204,3446,摩根大通,2023-07-26,8440
2359,所羅門,3225,476,2749,摩根大通,2023-07-26,8440
2890,永豐金,2567,161,2406,摩根大通,2023-07-26,8440
6274,台燿,3143,791,2352,摩根大通,2023-07-26,8440
2883,凱基金,2425,203,2222,摩根大通,2023-07-26,8440
2301,光寶科,3923,1718,2205,摩根大通,2023-07-26,8440
2329,華泰,3900,1804,2096,摩根大通,2023-07-26,8440
2885,元大金,2245,169,2076,摩根大通,2023-07-26,8440
2834,臺企銀,1937,87,1850,摩根大通,2023-07-26,8440
2449,京元電子,1644,104,1540,摩根大通,2023-07-26,8440
5880,合庫金,1722,205,1517,摩根大通,2023-07-26,8440
2002,中鋼,2003,805,1198,摩根大通,2023-07-26,8440
2382,廣達,2080,937,1143,摩根大通,2023-07-26,8440
2881,富邦金,1285,150,1135,摩根大通,2023-07-26,8440
6116,彩晶,1206,78,1128,摩根大通,2023-07-26,8440
2353,宏��,1335,276,1059,摩根大通,2023-07-26,8440
2317,鴻海,1648,597,1051,摩根大通,2023-07-26,8440
3017,奇鋐,1256,208,1048,摩根大通,2023-07-26,8440
2376,技嘉,1506,497,1009,摩根大通,2023-07-26,8440
8112,至上,1005,37,968,摩根大通,2023-07-26,8440
2405,輔信,1725,778,947,摩根大通,2023-07-26,8440
2845,遠東銀,942,0,942,摩根大通,2023-07-26,8440
5258,虹堡,899,311,588,摩根大通,2023-07-26,8440
1305,華夏,564,2,562,摩根大通,2023-07-26,8440
6026,福邦證,562,0,562,摩根大通,2023-07-26,8440
8234,新漢,731,178,553,摩根大通,2023-07-26,8440
2357,華碩,957,405,552,摩根大通,2023-07-26,8440
2356,英業達,712,173,539,摩根大通,2023-07-26,8440
3037,欣興,2110,1607,503,摩根大通,2023-07-26,8440
1313,聯成,590,88,502,摩根大通,2023-07-26,8440
1442,名軒,502,21,481,摩根大通,2023-07-26,8440
8028,昇陽半導體,512,34,478,摩根大通,2023-07-26,8440
2867,三商壽,465,0,465,摩根大通,2023-07-26,8440
1301,台塑,504,56,448,摩根大通,2023-07-26,8440
6188,廣明,1018,571,447,摩根大通,2023-07-26,8440
2368,金像電,608,187,421,摩根大通,2023-07-26,8440
6285,啟��,440,21,419,摩根大通,2023-07-26,8440
6016,康和證,468,51,417,摩根大通,2023-07-26,8440
2897,王道銀行,563,147,416,摩根大通,2023-07-26,8440
1903,士紙,459,60,399,摩根大通,2023-07-26,8440
2408,南亞科,664,275,389,摩根大通,2023-07-26,8440
8390,金益鼎,487,110,377,摩根大通,2023-07-26,8440
2377,微星,557,204,353,摩根大通,2023-07-26,8440
2891,中信金,677,326,351,摩根大通,2023-07-26,8440
4526,東台,381,35,346,摩根大通,2023-07-26,8440
1476,儒鴻,336,21,315,摩根大通,2023-07-26,8440
1618,合機,406,93,313,摩根大通,2023-07-26,8440
2409,友達,42133,2333,39800,摩根大通,2023-07-27,8440
3481,群創,10793,1530,9263,摩根大通,2023-07-27,8440
2888,新光金,7330,1865,5465,摩根大通,2023-07-27,8440
2834,臺企銀,4207,9,4198,摩根大通,2023-07-27,8440
2882,國泰金,4035,15,4020,摩根大通,2023-07-27,8440
2883,凱基金,3600,488,3112,摩根大通,2023-07-27,8440
2610,華航,2532,165,2367,摩根大通,2023-07-27,8440
2913,農林,2563,329,2234,摩根大通,2023-07-27,8440
6282,康舒,2486,336,2150,摩根大通,2023-07-27,8440
3017,奇鋐,2067,362,1705,摩根大通,2023-07-27,8440
2801,彰銀,2103,581,1522,摩根大通,2023-07-27,8440
6116,彩晶,1723,220,1503,摩根大通,2023-07-27,8440
2867,三商壽,1266,24,1242,摩根大通,2023-07-27,8440
3056,富華新,1343,148,1195,摩根大通,2023-07-27,8440
2329,華泰,2069,913,1156,摩根大通,2023-07-27,8440
2323,中環,1337,195,1142,摩根大通,2023-07-27,8440
1710,東聯,981,84,897,摩根大通,2023-07-27,8440
0050,元大台灣50,878,0,878,摩根大通,2023-07-27,8440
1905,華紙,993,184,809,摩根大通,2023-07-27,8440
8028,昇陽半導體,954,149,805,摩根大通,2023-07-27,8440
8299,群聯,798,17,781,摩根大通,2023-07-27,8440
2408,南亞科,808,141,667,摩根大通,2023-07-27,8440
1907,永豐餘,1408,763,645,摩根大通,2023-07-27,8440
2748,雲品,691,56,635,摩根大通,2023-07-27,8440
2618,長榮航,1869,1236,633,摩根大通,2023-07-27,8440
2352,佳世達,834,204,630,摩根大通,2023-07-27,8440
2344,華邦電,793,170,623,摩根大通,2023-07-27,8440
2891,中信金,893,303,590,摩根大通,2023-07-27,8440
3029,零壹,925,337,588,摩根大通,2023-07-27,8440
1904,正隆,1260,675,585,摩根大通,2023-07-27,8440
5880,合庫金,824,242,582,摩根大通,2023-07-27,8440
1319,東陽,622,45,577,摩根大通,2023-07-27,8440
3715,定穎投控,657,88,569,摩根大通,2023-07-27,8440
2204,中華,753,196,557,摩根大通,2023-07-27,8440
3380,明泰,559,4,555,摩根大通,2023-07-27,8440
8069,元太,722,168,554,摩根大通,2023-07-27,8440
2331,精英,535,12,523,摩根大通,2023-07-27,8440
2353,宏��,709,193,516,摩根大通,2023-07-27,8440
1711,永光,520,6,514,摩根大通,2023-07-27,8440
4746,台耀,711,205,506,摩根大通,2023-07-27,8440
2363,矽統,519,18,501,摩根大通,2023-07-27,8440
6531,愛普*,482,1,481,摩根大通,2023-07-27,8440
3346,麗清,482,5,477,摩根大通,2023-07-27,8440
3038,全台,467,12,455,摩根大通,2023-07-27,8440
2312,金寶,572,152,420,摩根大通,2023-07-27,8440
1909,榮成,427,14,413,摩根大通,2023-07-27,8440
2330,台積電,621,230,391,摩根大通,2023-07-27,8440
5258,虹堡,430,47,383,摩根大通,2023-07-27,8440
1301,台塑,520,150,370,摩根大通,2023-07-27,8440
2399,映泰,361,16,345,摩根大通,2023-07-27,8440
3481,群創,12499,4928,7571,摩根大通,2023-07-28,8440
2344,華邦電,3330,354,2976,摩根大通,2023-07-28,8440
2409,友達,7746,4787,2959,摩根大通,2023-07-28,8440
2603,長榮,2719,195,2524,摩根大通,2023-07-28,8440
1605,華新,3147,1029,2118,摩根大通,2023-07-28,8440
3264,欣銓,2050,11,2039,摩根大通,2023-07-28,8440
2834,臺企銀,3015,1182,1833,摩根大通,2023-07-28,8440
2449,京元電子,2067,380,1687,摩根大通,2023-07-28,8440
2609,陽明,2610,948,1662,摩根大通,2023-07-28,8440
2356,英業達,1581,180,1401,摩根大通,2023-07-28,8440
2324,仁寶,1940,599,1341,摩根大通,2023-07-28,8440
6116,彩晶,1581,309,1272,摩根大通,2023-07-28,8440
6147,頎邦,1667,519,1148,摩根大通,2023-07-28,8440
2383,台光電,1967,821,1146,摩根大通,2023-07-28,8440
2615,萬海,1135,40,1095,摩根大通,2023-07-28,8440
2323,中環,1388,423,965,摩根大通,2023-07-28,8440
2618,長榮航,3206,2334,872,摩根大通,2023-07-28,8440
2885,元大金,1618,829,789,摩根大通,2023-07-28,8440
6190,萬泰科,1009,238,771,摩根大通,2023-07-28,8440
3017,奇鋐,1311,570,741,摩根大通,2023-07-28,8440
2845,遠東銀,1030,362,668,摩根大通,2023-07-28,8440
3056,富華新,1071,405,666,摩根大通,2023-07-28,8440
2419,仲琦,796,153,643,摩根大通,2023-07-28,8440
2353,宏��,1165,537,628,摩根大通,2023-07-28,8440
2399,映泰,640,19,621,摩根大通,2023-07-28,8440
2426,鼎元,614,0,614,摩根大通,2023-07-28,8440
1905,華紙,2083,1489,594,摩根大通,2023-07-28,8440
2327,國巨,674,102,572,摩根大通,2023-07-28,8440
3257,虹冠電,612,44,568,摩根大通,2023-07-28,8440
2031,新光鋼,556,8,548,摩根大通,2023-07-28,8440
2317,鴻海,1158,630,528,摩根大通,2023-07-28,8440
2382,廣達,1518,995,523,摩根大通,2023-07-28,8440
2408,南亞科,1438,931,507,摩根大通,2023-07-28,8440
6269,台郡,549,57,492,摩根大通,2023-07-28,8440
2913,農林,2354,1868,486,摩根大通,2023-07-28,8440
5483,中美晶,609,129,480,摩根大通,2023-07-28,8440
6531,愛普*,701,231,470,摩根大通,2023-07-28,8440
4904,遠傳,1118,656,462,摩根大通,2023-07-28,8440
5871,中租-KY,686,242,444,摩根大通,2023-07-28,8440
6282,康舒,1005,564,441,摩根大通,2023-07-28,8440
6669,緯穎,566,137,429,摩根大通,2023-07-28,8440
2607,榮運,488,60,428,摩根大通,2023-07-28,8440
8299,群聯,441,28,413,摩根大通,2023-07-28,8440
6148,驊宏資,666,254,412,摩根大通,2023-07-28,8440
6005,群益證,544,141,403,摩根大通,2023-07-28,8440
4915,致伸,407,31,376,摩根大通,2023-07-28,8440
8110,華東,448,86,362,摩根大通,2023-07-28,8440
4572,駐龍,384,30,354,摩根大通,2023-07-28,8440
5443,均豪,435,82,353,摩根大通,2023-07-28,8440
2748,雲品,753,402,351,摩根大通,2023-07-28,8440
2344,華邦電,3984,342,3642,摩根大通,2023-07-31,8440
6282,康舒,4760,2233,2527,摩根大通,2023-07-31,8440
1802,台玻,3239,861,2378,摩根大通,2023-07-31,8440
2885,元大金,2879,559,2320,摩根大通,2023-07-31,8440
2303,聯電,3468,1248,2220,摩根大通,2023-07-31,8440
3044,健鼎,3384,1274,2110,摩根大通,2023-07-31,8440
6116,彩晶,2527,1026,1501,摩根大通,2023-07-31,8440
2353,宏��,2035,613,1422,摩根大通,2023-07-31,8440
2454,聯發科,1443,239,1204,摩根大通,2023-07-31,8440
6415,矽力*-KY,1123,76,1047,摩根大通,2023-07-31,8440
0050,元大台灣50,996,0,996,摩根大通,2023-07-31,8440
2330,台積電,2724,1844,880,摩根大通,2023-07-31,8440
1710,東聯,734,3,731,摩根大通,2023-07-31,8440
1477,聚陽,919,193,726,摩根大通,2023-07-31,8440
3217,優群,734,33,701,摩根大通,2023-07-31,8440
8110,華東,752,84,668,摩根大通,2023-07-31,8440
5871,中租-KY,830,165,665,摩根大通,2023-07-31,8440
5347,世界,836,172,664,摩根大通,2023-07-31,8440
2520,冠德,660,18,642,摩根大通,2023-07-31,8440
8027,鈦昇,831,189,642,摩根大通,2023-07-31,8440
2347,聯強,815,191,624,摩根大通,2023-07-31,8440
6187,萬潤,938,345,593,摩根大通,2023-07-31,8440
2031,新光鋼,596,22,574,摩根大通,2023-07-31,8440
1402,遠東新,726,168,558,摩根大通,2023-07-31,8440
3163,波若威,1255,757,498,摩根大通,2023-07-31,8440
2324,仁寶,2072,1642,430,摩根大通,2023-07-31,8440
4960,誠美材,689,259,430,摩根大通,2023-07-31,8440
2329,華泰,999,572,427,摩根大通,2023-07-31,8440
6550,北極星藥業-KY,423,4,419,摩根大通,2023-07-31,8440
2363,矽統,678,260,418,摩根大通,2023-07-31,8440
3231,緯創,3409,3004,405,摩根大通,2023-07-31,8440
1909,榮成,451,53,398,摩根大通,2023-07-31,8440
1301,台塑,596,216,380,摩根大通,2023-07-31,8440
3032,偉訓,662,301,361,摩根大通,2023-07-31,8440
6125,廣運,609,252,357,摩根大通,2023-07-31,8440
4916,事欣科,420,98,322,摩根大通,2023-07-31,8440
3047,訊舟,354,35,319,摩根大通,2023-07-31,8440
4572,駐龍,380,67,313,摩根大通,2023-07-31,8440
9958,世紀鋼,482,172,310,摩根大通,2023-07-31,8440
2340,台亞,309,3,306,摩根大通,2023-07-31,8440
1718,中纖,305,0,305,摩根大通,2023-07-31,8440
1313,聯成,322,29,293,摩根大通,2023-07-31,8440
4746,台耀,363,74,289,摩根大通,2023-07-31,8440
2913,農林,705,418,287,摩根大通,2023-07-31,8440
2485,兆赫,318,33,285,摩根大通,2023-07-31,8440
6788,華景電,361,80,281,摩根大通,2023-07-31,8440
3011,今皓,272,2,270,摩根大通,2023-07-31,8440
3029,零壹,615,345,270,摩根大通,2023-07-31,8440
1460,宏遠,269,0,269,摩根大通,2023-07-31,8440
3680,家登,266,3,263,摩根大通,2023-07-31,8440
2888,新光金,8137,614,7523,摩根大通,2023-08-01,8440
3481,群創,7489,796,6693,摩根大通,2023-08-01,8440
6116,彩晶,3170,29,3141,摩根大通,2023-08-01,8440
2356,英業達,3477,853,2624,摩根大通,2023-08-01,8440
2449,京元電子,3178,568,2610,摩根大通,2023-08-01,8440
2882,國泰金,3155,618,2537,摩根大通,2023-08-01,8440
2891,中信金,2692,478,2214,摩根大通,2023-08-01,8440
2885,元大金,3084,1425,1659,摩根大通,2023-08-01,8440
2913,農林,3993,2715,1278,摩根大通,2023-08-01,8440
3044,健鼎,3038,1764,1274,摩根大通,2023-08-01,8440
6285,啟��,1810,584,1226,摩根大通,2023-08-01,8440
2890,永豐金,1203,93,1110,摩根大通,2023-08-01,8440
3231,緯創,7102,6119,983,摩根大通,2023-08-01,8440
2301,光寶科,3658,2773,885,摩根大通,2023-08-01,8440
6188,廣明,1239,369,870,摩根大通,2023-08-01,8440
2886,兆豐金,1323,474,849,摩根大通,2023-08-01,8440
2409,友達,1560,780,780,摩根大通,2023-08-01,8440
5371,中光電,895,122,773,摩根大通,2023-08-01,8440
1313,聯成,946,198,748,摩根大通,2023-08-01,8440
2884,玉山金,771,34,737,摩根大通,2023-08-01,8440
2352,佳世達,833,261,572,摩根大通,2023-08-01,8440
2402,毅嘉,891,326,565,摩根大通,2023-08-01,8440
1301,台塑,581,17,564,摩根大通,2023-08-01,8440
2360,致茂,644,125,519,摩根大通,2023-08-01,8440
1718,中纖,518,0,518,摩根大通,2023-08-01,8440
2383,台光電,735,253,482,摩根大通,2023-08-01,8440
6415,矽力*-KY,546,111,435,摩根大通,2023-08-01,8440
2892,第一金,856,426,430,摩根大通,2023-08-01,8440
2610,華航,1074,677,397,摩根大通,2023-08-01,8440
2419,仲琦,550,160,390,摩根大通,2023-08-01,8440
6274,台燿,822,438,384,摩根大通,2023-08-01,8440
3163,波若威,1026,648,378,摩根大通,2023-08-01,8440
3714,富采,509,149,360,摩根大通,2023-08-01,8440
2421,建準,415,69,346,摩根大通,2023-08-01,8440
3325,旭品,488,153,335,摩根大通,2023-08-01,8440
2002,中鋼,962,628,334,摩根大通,2023-08-01,8440
9904,寶成,332,15,317,摩根大通,2023-08-01,8440
2014,中鴻,346,55,291,摩根大通,2023-08-01,8440
8464,億豐,308,18,290,摩根大通,2023-08-01,8440
2748,雲品,365,75,290,摩根大通,2023-08-01,8440
1326,台化,316,32,284,摩根大通,2023-08-01,8440
6235,華孚,333,53,280,摩根大通,2023-08-01,8440
2303,聯電,1661,1391,270,摩根大通,2023-08-01,8440
2633,台灣高鐵,251,13,238,摩根大通,2023-08-01,8440
2880,華南金,506,273,233,摩根大通,2023-08-01,8440
6770,力積電,607,380,227,摩根大通,2023-08-01,8440
2023,燁輝,225,0,225,摩根大通,2023-08-01,8440
3024,憶聲,291,66,225,摩根大通,2023-08-01,8440
2031,新光鋼,263,39,224,摩根大通,2023-08-01,8440
3702,大聯大,264,42,222,摩根大通,2023-08-01,8440
2913,農林,6164,1704,4460,摩根大通,2023-08-02,8440
1609,大亞,6660,2638,4022,摩根大通,2023-08-02,8440
2645,長榮航太,1221,148,1073,摩根大通,2023-08-02,8440
1304,台聚,1085,70,1015,摩根大通,2023-08-02,8440
6274,台燿,1883,906,977,摩根大通,2023-08-02,8440
2520,冠德,1123,174,949,摩根大通,2023-08-02,8440
2031,新光鋼,1166,219,947,摩根大通,2023-08-02,8440
1785,光洋科,1404,500,904,摩根大通,2023-08-02,8440
5388,中磊,1103,221,882,摩根大通,2023-08-02,8440
2409,友達,2781,1934,847,摩根大通,2023-08-02,8440
2329,華泰,758,0,758,摩根大通,2023-08-02,8440
3583,辛耘,1056,402,654,摩根大通,2023-08-02,8440
2023,燁輝,610,63,547,摩根大通,2023-08-02,8440
2014,中鴻,1594,1056,538,摩根大通,2023-08-02,8440
1815,富喬,546,12,534,摩根大通,2023-08-02,8440
1616,億泰,638,152,486,摩根大通,2023-08-02,8440
6187,萬潤,523,57,466,摩根大通,2023-08-02,8440
1710,東聯,678,214,464,摩根大通,2023-08-02,8440
2211,長榮鋼,658,196,462,摩根大通,2023-08-02,8440
1310,台苯,485,50,435,摩根大通,2023-08-02,8440
6125,廣運,752,336,416,摩根大通,2023-08-02,8440
6176,瑞儀,447,38,409,摩根大通,2023-08-02,8440
2383,台光電,1144,746,398,摩根大通,2023-08-02,8440
2442,新美齊,422,26,396,摩根大通,2023-08-02,8440
1108,幸福,482,97,385,摩根大通,2023-08-02,8440
6550,北極星藥業-KY,479,115,364,摩根大通,2023-08-02,8440
1612,宏泰,616,306,310,摩根大通,2023-08-02,8440
4532,瑞智,397,90,307,摩根大通,2023-08-02,8440
3014,聯陽,417,113,304,摩根大通,2023-08-02,8440
1904,正隆,842,540,302,摩根大通,2023-08-02,8440
2461,光群雷,325,26,299,摩根大通,2023-08-02,8440
8936,國統,303,23,280,摩根大通,2023-08-02,8440
3689,湧德,305,30,275,摩根大通,2023-08-02,8440
3231,緯創,4691,4425,266,摩根大通,2023-08-02,8440
2889,國票金,259,17,242,摩根大通,2023-08-02,8440
1727,中華化,273,35,238,摩根大通,2023-08-02,8440
1802,台玻,1699,1465,234,摩根大通,2023-08-02,8440
2356,英業達,382,150,232,摩根大通,2023-08-02,8440
2462,良得電,235,5,230,摩根大通,2023-08-02,8440
3324,雙鴻,512,285,227,摩根大通,2023-08-02,8440
3704,合勤控,330,105,225,摩根大通,2023-08-02,8440
1809,中釉,219,11,208,摩根大通,2023-08-02,8440
6005,群益證,702,495,207,摩根大通,2023-08-02,8440
1909,榮成,241,34,207,摩根大通,2023-08-02,8440
4746,台耀,1522,1323,199,摩根大通,2023-08-02,8440
2504,國產,406,208,198,摩根大通,2023-08-02,8440
3013,晟銘電,530,338,192,摩根大通,2023-08-02,8440
1907,永豐餘,564,372,192,摩根大通,2023-08-02,8440
8155,博智,213,24,189,摩根大通,2023-08-02,8440
3024,憶聲,220,31,189,摩根大通,2023-08-02,8440
3231,緯創,11707,7614,4093,摩根大通,2023-08-04,8440
6116,彩晶,3013,244,2769,摩根大通,2023-08-04,8440
2312,金寶,2613,56,2557,摩根大通,2023-08-04,8440
2603,長榮,2561,576,1985,摩根大通,2023-08-04,8440
2324,仁寶,3301,1552,1749,摩根大通,2023-08-04,8440
2809,京城銀,1259,44,1215,摩根大通,2023-08-04,8440
4906,正文,1166,57,1109,摩根大通,2023-08-04,8440
2504,國產,1091,40,1051,摩根大通,2023-08-04,8440
6285,啟��,1243,206,1037,摩根大通,2023-08-04,8440
2458,義隆,1011,79,932,摩根大通,2023-08-04,8440
3037,欣興,1325,414,911,摩根大通,2023-08-04,8440
3032,偉訓,1068,165,903,摩根大通,2023-08-04,8440
2402,毅嘉,928,54,874,摩根大通,2023-08-04,8440
2006,東和鋼鐵,1019,151,868,摩根大通,2023-08-04,8440
2329,華泰,902,84,818,摩根大通,2023-08-04,8440
2383,台光電,1114,340,774,摩根大通,2023-08-04,8440
3078,僑威,812,41,771,摩根大通,2023-08-04,8440
2419,仲琦,994,227,767,摩根大通,2023-08-04,8440
2609,陽明,1264,526,738,摩根大通,2023-08-04,8440
2352,佳世達,1283,611,672,摩根大通,2023-08-04,8440
3029,零壹,659,27,632,摩根大通,2023-08-04,8440
1210,大成,1003,391,612,摩根大通,2023-08-04,8440
8086,宏捷科,683,72,611,摩根大通,2023-08-04,8440
3052,夆典,587,4,583,摩根大通,2023-08-04,8440
2376,技嘉,1230,676,554,摩根大通,2023-08-04,8440
2031,新光鋼,586,68,518,摩根大通,2023-08-04,8440
4960,誠美材,513,36,477,摩根大通,2023-08-04,8440
2515,中工,492,32,460,摩根大通,2023-08-04,8440
2449,京元電子,951,493,458,摩根大通,2023-08-04,8440
2464,盟立,518,66,452,摩根大通,2023-08-04,8440
2442,新美齊,483,35,448,摩根大通,2023-08-04,8440
1513,中興電,571,135,436,摩根大通,2023-08-04,8440
6214,精誠,467,33,434,摩根大通,2023-08-04,8440
2369,菱生,440,21,419,摩根大通,2023-08-04,8440
1710,東聯,464,48,416,摩根大通,2023-08-04,8440
2489,瑞軒,445,33,412,摩根大通,2023-08-04,8440
3017,奇鋐,581,174,407,摩根大通,2023-08-04,8440
3213,茂訊,429,22,407,摩根大通,2023-08-04,8440
3024,憶聲,437,32,405,摩根大通,2023-08-04,8440
2331,精英,501,96,405,摩根大通,2023-08-04,8440
3380,明泰,471,66,405,摩根大通,2023-08-04,8440
4714,永捷,416,20,396,摩根大通,2023-08-04,8440
2357,華碩,642,264,378,摩根大通,2023-08-04,8440
2023,燁輝,441,72,369,摩根大通,2023-08-04,8440
2530,華建,396,27,369,摩根大通,2023-08-04,8440
6239,力成,774,410,364,摩根大通,2023-08-04,8440
1217,愛之味,377,21,356,摩根大通,2023-08-04,8440
5347,世界,1199,862,337,摩根大通,2023-08-04,8440
2332,友訊,378,43,335,摩根大通,2023-08-04,8440
8016,矽創,373,71,302,摩根大通,2023-08-04,8440
3231,緯創,6720,4430,2290,摩根大通,2023-08-07,8440
2313,華通,2384,131,2253,摩根大通,2023-08-07,8440
2630,亞航,2224,226,1998,摩根大通,2023-08-07,8440
2303,聯電,3519,2117,1402,摩根大通,2023-08-07,8440
2371,大同,1055,145,910,摩根大通,2023-08-07,8440
6282,康舒,950,83,867,摩根大通,2023-08-07,8440
2329,華泰,720,1,719,摩根大通,2023-08-07,8440
8050,廣積,811,93,718,摩根大通,2023-08-07,8440
1710,東聯,720,10,710,摩根大通,2023-08-07,8440
3037,欣興,1183,565,618,摩根大通,2023-08-07,8440
3217,優群,707,93,614,摩根大通,2023-08-07,8440
3706,神達,2888,2275,613,摩根大通,2023-08-07,8440
5880,合庫金,1869,1258,611,摩根大通,2023-08-07,8440
3078,僑威,857,254,603,摩根大通,2023-08-07,8440
4915,致伸,562,2,560,摩根大通,2023-08-07,8440
2404,漢唐,518,6,512,摩根大通,2023-08-07,8440
2312,金寶,530,23,507,摩根大通,2023-08-07,8440
2515,中工,485,0,485,摩根大通,2023-08-07,8440
8027,鈦昇,516,45,471,摩根大通,2023-08-07,8440
3380,明泰,483,20,463,摩根大通,2023-08-07,8440
3325,旭品,530,71,459,摩根大通,2023-08-07,8440
2368,金像電,785,346,439,摩根大通,2023-08-07,8440
3264,欣銓,462,39,423,摩根大通,2023-08-07,8440
2345,智邦,627,213,414,摩根大通,2023-08-07,8440
6191,精成科,415,9,406,摩根大通,2023-08-07,8440
2462,良得電,553,191,362,摩根大通,2023-08-07,8440
5347,世界,496,147,349,摩根大通,2023-08-07,8440
2382,廣達,3042,2706,336,摩根大通,2023-08-07,8440
2369,菱生,329,0,329,摩根大通,2023-08-07,8440
1503,士電,497,184,313,摩根大通,2023-08-07,8440
8150,南茂,356,48,308,摩根大通,2023-08-07,8440
3324,雙鴻,477,170,307,摩根大通,2023-08-07,8440
3533,嘉澤,308,16,292,摩根大通,2023-08-07,8440
6235,華孚,573,286,287,摩根大通,2023-08-07,8440
3693,營邦,561,274,287,摩根大通,2023-08-07,8440
6841,長佳智能,290,17,273,摩根大通,2023-08-07,8440
2006,東和鋼鐵,310,60,250,摩根大通,2023-08-07,8440
2614,東森,252,6,246,摩根大通,2023-08-07,8440
2401,凌陽,326,83,243,摩根大通,2023-08-07,8440
6220,岳豐,242,0,242,摩根大通,2023-08-07,8440
1718,中纖,244,3,241,摩根大通,2023-08-07,8440
2353,宏��,1491,1255,236,摩根大通,2023-08-07,8440
3042,晶技,292,56,236,摩根大通,2023-08-07,8440
4958,臻鼎-KY,306,72,234,摩根大通,2023-08-07,8440
4906,正文,266,33,233,摩根大通,2023-08-07,8440
1608,華榮,270,37,233,摩根大通,2023-08-07,8440
6239,力成,306,74,232,摩根大通,2023-08-07,8440
3005,神基,266,35,231,摩根大通,2023-08-07,8440
3289,宜特,236,10,226,摩根大通,2023-08-07,8440
3029,零壹,301,79,222,摩根大通,2023-08-07,8440
2885,元大金,4605,1825,2780,摩根大通,2023-08-08,8440
3481,群創,6011,3237,2774,摩根大通,2023-08-08,8440
4532,瑞智,2183,386,1797,摩根大通,2023-08-08,8440
2356,英業達,4144,2884,1260,摩根大通,2023-08-08,8440
2645,長榮航太,1441,228,1213,摩根大通,2023-08-08,8440
2913,農林,1801,809,992,摩根大通,2023-08-08,8440
3715,定穎投控,1265,401,864,摩根大通,2023-08-08,8440
2371,大同,1010,171,839,摩根大通,2023-08-08,8440
2603,長榮,845,96,749,摩根大通,2023-08-08,8440
4904,遠傳,897,233,664,摩根大通,2023-08-08,8440
2353,宏��,1674,1080,594,摩根大通,2023-08-08,8440
2303,聯電,1665,1077,588,摩根大通,2023-08-08,8440
2609,陽明,957,372,585,摩根大通,2023-08-08,8440
3324,雙鴻,694,252,442,摩根大通,2023-08-08,8440
2357,華碩,533,99,434,摩根大通,2023-08-08,8440
2383,台光電,858,434,424,摩根大通,2023-08-08,8440
5347,世界,675,253,422,摩根大通,2023-08-08,8440
2330,台積電,2713,2302,411,摩根大通,2023-08-08,8440
6669,緯穎,460,119,341,摩根大通,2023-08-08,8440
6282,康舒,603,300,303,摩根大通,2023-08-08,8440
2377,微星,467,166,301,摩根大通,2023-08-08,8440
3711,日月光投控,529,236,293,摩根大通,2023-08-08,8440
2801,彰銀,1190,917,273,摩根大通,2023-08-08,8440
2379,瑞昱,342,79,263,摩根大通,2023-08-08,8440
5243,乙盛-KY,325,68,257,摩根大通,2023-08-08,8440
3443,創意,488,232,256,摩根大通,2023-08-08,8440
3029,零壹,427,176,251,摩根大通,2023-08-08,8440
6194,育富,283,45,238,摩根大通,2023-08-08,8440
1503,士電,266,30,236,摩根大通,2023-08-08,8440
8930,青鋼,396,162,234,摩根大通,2023-08-08,8440
3078,僑威,618,388,230,摩根大通,2023-08-08,8440
2006,東和鋼鐵,242,22,220,摩根大通,2023-08-08,8440
3038,全台,323,104,219,摩根大通,2023-08-08,8440
2515,中工,263,48,215,摩根大通,2023-08-08,8440
2542,興富發,239,28,211,摩根大通,2023-08-08,8440
2441,超豐,229,31,198,摩根大通,2023-08-08,8440
1784,訊聯,299,102,197,摩根大通,2023-08-08,8440
1905,華紙,543,358,185,摩根大通,2023-08-08,8440
6209,今國光,201,18,183,摩根大通,2023-08-08,8440
1532,勤美,197,17,180,摩根大通,2023-08-08,8440
3163,波若威,570,392,178,摩根大通,2023-08-08,8440
4916,事欣科,247,73,174,摩根大通,2023-08-08,8440
2211,長榮鋼,280,107,173,摩根大通,2023-08-08,8440
5009,榮剛,209,38,171,摩根大通,2023-08-08,8440
1710,東聯,196,28,168,摩根大通,2023-08-08,8440
2425,承啟,275,114,161,摩根大通,2023-08-08,8440
2395,研華,232,77,155,摩根大通,2023-08-08,8440
2206,三陽工業,233,80,153,摩根大通,2023-08-08,8440
9921,巨大,194,44,150,摩根大通,2023-08-08,8440
3042,晶技,208,58,150,摩根大通,2023-08-08,8440
3481,群創,3805,1240,2565,摩根大通,2023-08-09,8440
3037,欣興,2419,275,2144,摩根大通,2023-08-09,8440
2610,華航,2725,643,2082,摩根大通,2023-08-09,8440
2382,廣達,3416,1539,1877,摩根大通,2023-08-09,8440
3231,緯創,3350,1880,1470,摩根大通,2023-08-09,8440
2892,第一金,2317,852,1465,摩根大通,2023-08-09,8440
3711,日月光投控,1459,208,1251,摩根大通,2023-08-09,8440
2352,佳世達,1274,237,1037,摩根大通,2023-08-09,8440
2301,光寶科,2515,1487,1028,摩根大通,2023-08-09,8440
2376,技嘉,1965,955,1010,摩根大通,2023-08-09,8440
2409,友達,1171,381,790,摩根大通,2023-08-09,8440
3706,神達,1770,1026,744,摩根大通,2023-08-09,8440
2634,漢翔,971,236,735,摩根大通,2023-08-09,8440
3036,文曄,738,75,663,摩根大通,2023-08-09,8440
6672,騰輝電子-KY,740,84,656,摩根大通,2023-08-09,8440
2312,金寶,728,86,642,摩根大通,2023-08-09,8440
2356,英業達,2160,1586,574,摩根大通,2023-08-09,8440
2353,宏��,2286,1713,573,摩根大通,2023-08-09,8440
4904,遠傳,656,145,511,摩根大通,2023-08-09,8440
2885,元大金,1033,586,447,摩根大通,2023-08-09,8440
2368,金像電,778,331,447,摩根大通,2023-08-09,8440
6187,萬潤,535,92,443,摩根大通,2023-08-09,8440
2412,中華電,638,213,425,摩根大通,2023-08-09,8440
6239,力成,440,20,420,摩根大通,2023-08-09,8440
3257,虹冠電,685,269,416,摩根大通,2023-08-09,8440
9934,成霖,403,0,403,摩根大通,2023-08-09,8440
2383,台光電,498,104,394,摩根大通,2023-08-09,8440
2401,凌陽,536,153,383,摩根大通,2023-08-09,8440
5425,台半,406,24,382,摩根大通,2023-08-09,8440
1616,億泰,381,10,371,摩根大通,2023-08-09,8440
2402,毅嘉,835,475,360,摩根大通,2023-08-09,8440
8936,國統,365,7,358,摩根大通,2023-08-09,8440
2515,中工,341,0,341,摩根大通,2023-08-09,8440
2867,三商壽,402,72,330,摩根大通,2023-08-09,8440
2454,聯發科,462,144,318,摩根大通,2023-08-09,8440
8112,至上,312,2,310,摩根大通,2023-08-09,8440
2354,鴻準,378,82,296,摩根大通,2023-08-09,8440
9921,巨大,312,29,283,摩根大通,2023-08-09,8440
8155,博智,328,57,271,摩根大通,2023-08-09,8440
3548,兆利,279,13,266,摩根大通,2023-08-09,8440
5469,瀚宇博,351,88,263,摩根大通,2023-08-09,8440
3078,僑威,963,704,259,摩根大通,2023-08-09,8440
1519,華城,459,206,253,摩根大通,2023-08-09,8440
4167,松瑞藥,246,2,244,摩根大通,2023-08-09,8440
6139,亞翔,248,12,236,摩根大通,2023-08-09,8440
2002,中鋼,1225,992,233,摩根大通,2023-08-09,8440
6194,育富,487,259,228,摩根大通,2023-08-09,8440
2460,建通,219,0,219,摩根大通,2023-08-09,8440
2324,仁寶,671,462,209,摩根大通,2023-08-09,8440
5371,中光電,215,6,209,摩根大通,2023-08-09,8440
3231,緯創,14665,5876,8789,摩根大通,2023-08-10,8440
00885,富邦越南,2000,0,2000,摩根大通,2023-08-10,8440
2883,凱基金,5323,3508,1815,摩根大通,2023-08-10,8440
1905,華紙,1738,59,1679,摩根大通,2023-08-10,8440
3706,神達,1891,672,1219,摩根大通,2023-08-10,8440
6188,廣明,1304,244,1060,摩根大通,2023-08-10,8440
8112,至上,1445,396,1049,摩根大通,2023-08-10,8440
2482,連宇,660,13,647,摩根大通,2023-08-10,8440
6187,萬潤,700,79,621,摩根大通,2023-08-10,8440
6120,達運,765,185,580,摩根大通,2023-08-10,8440
2603,長榮,803,250,553,摩根大通,2023-08-10,8440
9958,世紀鋼,551,7,544,摩根大通,2023-08-10,8440
6274,台燿,835,337,498,摩根大通,2023-08-10,8440
3715,定穎投控,697,240,457,摩根大通,2023-08-10,8440
2344,華邦電,1986,1544,442,摩根大通,2023-08-10,8440
2383,台光電,783,361,422,摩根大通,2023-08-10,8440
1467,南緯,642,253,389,摩根大通,2023-08-10,8440
2327,國巨,448,88,360,摩根大通,2023-08-10,8440
3058,立德,365,9,356,摩根大通,2023-08-10,8440
1319,東陽,500,150,350,摩根大通,2023-08-10,8440
6176,瑞儀,360,24,336,摩根大通,2023-08-10,8440
3583,辛耘,558,224,334,摩根大通,2023-08-10,8440
5864,致和證,371,42,329,摩根大通,2023-08-10,8440
5347,世界,780,466,314,摩根大通,2023-08-10,8440
2630,亞航,462,148,314,摩根大通,2023-08-10,8440
9934,成霖,338,36,302,摩根大通,2023-08-10,8440
2404,漢唐,310,14,296,摩根大通,2023-08-10,8440
3515,華擎,316,32,284,摩根大通,2023-08-10,8440
6235,華孚,553,277,276,摩根大通,2023-08-10,8440
2618,長榮航,2313,2060,253,摩根大通,2023-08-10,8440
2515,中工,257,11,246,摩根大通,2023-08-10,8440
2419,仲琦,285,41,244,摩根大通,2023-08-10,8440
3443,創意,359,117,242,摩根大通,2023-08-10,8440
6148,驊宏資,254,13,241,摩根大通,2023-08-10,8440
2399,映泰,368,131,237,摩根大通,2023-08-10,8440
2705,六福,270,36,234,摩根大通,2023-08-10,8440
8081,致新,306,73,233,摩根大通,2023-08-10,8440
1714,和桐,223,0,223,摩根大通,2023-08-10,8440
2634,漢翔,296,74,222,摩根大通,2023-08-10,8440
6285,啟��,633,422,211,摩根大通,2023-08-10,8440
2845,遠東銀,210,0,210,摩根大通,2023-08-10,8440
3228,金麗科,214,8,206,摩根大通,2023-08-10,8440
6605,帝寶,251,47,204,摩根大通,2023-08-10,8440
8048,德勝,246,47,199,摩根大通,2023-08-10,8440
2812,台中銀,293,94,199,摩根大通,2023-08-10,8440
5474,聰泰,206,10,196,摩根大通,2023-08-10,8440
6469,大樹,210,16,194,摩根大通,2023-08-10,8440
9921,巨大,268,75,193,摩根大通,2023-08-10,8440
4763,材料-KY,290,100,190,摩根大通,2023-08-10,8440
2743,山富,215,26,189,摩根大通,2023-08-10,8440
2610,華航,16270,3494,12776,摩根大通,2023-08-11,8440
8112,至上,2859,124,2735,摩根大通,2023-08-11,8440
2301,光寶科,2572,1112,1460,摩根大通,2023-08-11,8440
2609,陽明,1673,640,1033,摩根大通,2023-08-11,8440
1802,台玻,1456,498,958,摩根大通,2023-08-11,8440
2542,興富發,974,75,899,摩根大通,2023-08-11,8440
2402,毅嘉,930,117,813,摩根大通,2023-08-11,8440
2425,承啟,1006,317,689,摩根大通,2023-08-11,8440
3715,定穎投控,965,336,629,摩根大通,2023-08-11,8440
2323,中環,957,343,614,摩根大通,2023-08-11,8440
2105,正新,837,226,611,摩根大通,2023-08-11,8440
2867,三商壽,607,7,600,摩根大通,2023-08-11,8440
6026,福邦證,594,19,575,摩根大通,2023-08-11,8440
2538,基泰,547,5,542,摩根大通,2023-08-11,8440
9919,康那香,515,10,505,摩根大通,2023-08-11,8440
5469,瀚宇博,582,98,484,摩根大通,2023-08-11,8440
6120,達運,511,34,477,摩根大通,2023-08-11,8440
2327,國巨,545,76,469,摩根大通,2023-08-11,8440
2387,精元,468,4,464,摩根大通,2023-08-11,8440
2355,敬鵬,494,42,452,摩根大通,2023-08-11,8440
2704,國賓,438,20,418,摩根大通,2023-08-11,8440
6191,精成科,493,84,409,摩根大通,2023-08-11,8440
2630,亞航,551,145,406,摩根大通,2023-08-11,8440
2383,台光電,600,217,383,摩根大通,2023-08-11,8440
1477,聚陽,498,121,377,摩根大通,2023-08-11,8440
2363,矽統,363,11,352,摩根大通,2023-08-11,8440
2731,雄獅,387,71,316,摩根大通,2023-08-11,8440
2903,遠百,356,45,311,摩根大通,2023-08-11,8440
2884,玉山金,1198,901,297,摩根大通,2023-08-11,8440
2618,長榮航,5255,4966,289,摩根大通,2023-08-11,8440
1904,正隆,310,22,288,摩根大通,2023-08-11,8440
1905,華紙,534,247,287,摩根大通,2023-08-11,8440
2605,新興,304,23,281,摩根大通,2023-08-11,8440
1605,華新,457,184,273,摩根大通,2023-08-11,8440
3356,奇偶,290,19,271,摩根大通,2023-08-11,8440
6139,亞翔,329,58,271,摩根大通,2023-08-11,8440
1515,力山,294,29,265,摩根大通,2023-08-11,8440
6005,群益證,360,100,260,摩根大通,2023-08-11,8440
1216,統一,633,390,243,摩根大通,2023-08-11,8440
6116,彩晶,891,649,242,摩根大通,2023-08-11,8440
8210,勤誠,439,201,238,摩根大通,2023-08-11,8440
9958,世紀鋼,232,3,229,摩根大通,2023-08-11,8440
2340,台亞,240,13,227,摩根大通,2023-08-11,8440
2376,技嘉,917,696,221,摩根大通,2023-08-11,8440
2515,中工,220,14,206,摩根大通,2023-08-11,8440
1714,和桐,203,2,201,摩根大通,2023-08-11,8440
2027,大成鋼,245,45,200,摩根大通,2023-08-11,8440
3010,華立,201,3,198,摩根大通,2023-08-11,8440
6142,友勁,200,3,197,摩根大通,2023-08-11,8440
8222,寶一,199,8,191,摩根大通,2023-08-11,8440
3231,緯創,11041,2687,8354,摩根大通,2023-08-14,8440
1605,華新,4337,226,4111,摩根大通,2023-08-14,8440
1609,大亞,979,10,969,摩根大通,2023-08-14,8440
5425,台半,589,6,583,摩根大通,2023-08-14,8440
6282,康舒,697,124,573,摩根大通,2023-08-14,8440
1305,華夏,531,6,525,摩根大通,2023-08-14,8440
5009,榮剛,521,0,521,摩根大通,2023-08-14,8440
4906,正文,503,25,478,摩根大通,2023-08-14,8440
6443,元晶,510,44,466,摩根大通,2023-08-14,8440
3163,波若威,588,157,431,摩根大通,2023-08-14,8440
3037,欣興,613,195,418,摩根大通,2023-08-14,8440
2637,慧洋-KY,910,497,413,摩根大通,2023-08-14,8440
5258,虹堡,508,137,371,摩根大通,2023-08-14,8440
2327,國巨,410,52,358,摩根大通,2023-08-14,8440
3374,精材,379,22,357,摩根大通,2023-08-14,8440
9958,世紀鋼,454,100,354,摩根大通,2023-08-14,8440
6116,彩晶,750,407,343,摩根大通,2023-08-14,8440
1471,首利,398,71,327,摩根大通,2023-08-14,8440
4306,炎洲,317,7,310,摩根大通,2023-08-14,8440
2409,友達,1224,915,309,摩根大通,2023-08-14,8440
3481,群創,1068,773,295,摩根大通,2023-08-14,8440
2377,微星,410,128,282,摩根大通,2023-08-14,8440
2312,金寶,321,52,269,摩根大通,2023-08-14,8440
2614,東森,283,17,266,摩根大通,2023-08-14,8440
1714,和桐,275,9,266,摩根大通,2023-08-14,8440
2363,矽統,1729,1465,264,摩根大通,2023-08-14,8440
3078,僑威,527,274,253,摩根大通,2023-08-14,8440
2355,敬鵬,513,266,247,摩根大通,2023-08-14,8440
2340,台亞,296,52,244,摩根大通,2023-08-14,8440
5483,中美晶,267,27,240,摩根大通,2023-08-14,8440
1476,儒鴻,260,25,235,摩根大通,2023-08-14,8440
6664,群翊,242,12,230,摩根大通,2023-08-14,8440
1313,聯成,227,0,227,摩根大通,2023-08-14,8440
3260,威剛,265,44,221,摩根大通,2023-08-14,8440
1519,華城,316,100,216,摩根大通,2023-08-14,8440
2705,六福,262,50,212,摩根大通,2023-08-14,8440
1905,華紙,292,81,211,摩根大通,2023-08-14,8440
1513,中興電,556,346,210,摩根大通,2023-08-14,8440
2630,亞航,246,49,197,摩根大通,2023-08-14,8440
1760,寶齡富錦,216,22,194,摩根大通,2023-08-14,8440
2399,映泰,232,41,191,摩根大通,2023-08-14,8440
4746,台耀,187,7,180,摩根大通,2023-08-14,8440
2885,元大金,1480,1302,178,摩根大通,2023-08-14,8440
8996,高力,254,84,170,摩根大通,2023-08-14,8440
3034,聯詠,197,32,165,摩根大通,2023-08-14,8440
3264,欣銓,163,5,158,摩根大通,2023-08-14,8440
2408,南亞科,341,184,157,摩根大通,2023-08-14,8440
2332,友訊,155,5,150,摩根大通,2023-08-14,8440
2455,全新,150,2,148,摩根大通,2023-08-14,8440
6288,聯嘉,152,4,148,摩根大通,2023-08-14,8440
2303,聯電,6056,641,5415,摩根大通,2023-08-15,8440
2610,華航,5875,770,5105,摩根大通,2023-08-15,8440
2323,中環,2431,512,1919,摩根大通,2023-08-15,8440
6282,康舒,1449,150,1299,摩根大通,2023-08-15,8440
2618,長榮航,3479,2205,1274,摩根大通,2023-08-15,8440
3037,欣興,1665,535,1130,摩根大通,2023-08-15,8440
2402,毅嘉,941,9,932,摩根大通,2023-08-15,8440
2457,飛宏,869,71,798,摩根大通,2023-08-15,8440
3702,大聯大,1255,516,739,摩根大通,2023-08-15,8440
1467,南緯,714,5,709,摩根大通,2023-08-15,8440
2357,華碩,1045,451,594,摩根大通,2023-08-15,8440
1616,億泰,627,37,590,摩根大通,2023-08-15,8440
2392,正崴,610,37,573,摩根大通,2023-08-15,8440
2515,中工,725,154,571,摩根大通,2023-08-15,8440
2368,金像電,790,283,507,摩根大通,2023-08-15,8440
3078,僑威,1549,1075,474,摩根大通,2023-08-15,8440
1795,美時,531,73,458,摩根大通,2023-08-15,8440
2312,金寶,463,11,452,摩根大通,2023-08-15,8440
3035,智原,647,209,438,摩根大通,2023-08-15,8440
2023,燁輝,447,11,436,摩根大通,2023-08-15,8440
5469,瀚宇博,438,11,427,摩根大通,2023-08-15,8440
2421,建準,756,331,425,摩根大通,2023-08-15,8440
6203,海韻電,449,29,420,摩根大通,2023-08-15,8440
2425,承啟,445,33,412,摩根大通,2023-08-15,8440
8069,元太,1036,641,395,摩根大通,2023-08-15,8440
3622,洋華,645,253,392,摩根大通,2023-08-15,8440
6191,精成科,410,39,371,摩根大通,2023-08-15,8440
2538,基泰,411,66,345,摩根大通,2023-08-15,8440
2388,威盛,541,213,328,摩根大通,2023-08-15,8440
3545,敦泰,326,27,299,摩根大通,2023-08-15,8440
2101,南港,307,10,297,摩根大通,2023-08-15,8440
9934,成霖,341,47,294,摩根大通,2023-08-15,8440
2206,三陽工業,347,56,291,摩根大通,2023-08-15,8440
2359,所羅門,312,24,288,摩根大通,2023-08-15,8440
6415,矽力*-KY,356,77,279,摩根大通,2023-08-15,8440
2442,新美齊,273,0,273,摩根大通,2023-08-15,8440
2355,敬鵬,296,27,269,摩根大通,2023-08-15,8440
3033,威健,269,3,266,摩根大通,2023-08-15,8440
4942,嘉彰,262,0,262,摩根大通,2023-08-15,8440
3653,健策,339,82,257,摩根大通,2023-08-15,8440
2332,友訊,367,118,249,摩根大通,2023-08-15,8440
3715,定穎投控,1318,1074,244,摩根大通,2023-08-15,8440
1305,華夏,260,20,240,摩根大通,2023-08-15,8440
2401,凌陽,278,41,237,摩根大通,2023-08-15,8440
2645,長榮航太,268,34,234,摩根大通,2023-08-15,8440
2393,億光,250,22,228,摩根大通,2023-08-15,8440
2387,精元,229,2,227,摩根大通,2023-08-15,8440
2201,裕隆,255,29,226,摩根大通,2023-08-15,8440
6122,擎邦,239,14,225,摩根大通,2023-08-15,8440
5706,鳳凰,222,4,218,摩根大通,2023-08-15,8440
2301,光寶科,3447,872,2575,摩根大通,2023-08-16,8440
2609,陽明,3041,584,2457,摩根大通,2023-08-16,8440
2382,廣達,3147,1185,1962,摩根大通,2023-08-16,8440
8069,元太,2235,431,1804,摩根大通,2023-08-16,8440
2610,華航,2521,1046,1475,摩根大通,2023-08-16,8440
2408,南亞科,1632,624,1008,摩根大通,2023-08-16,8440
3078,僑威,1147,283,864,摩根大通,2023-08-16,8440
2913,農林,894,88,806,摩根大通,2023-08-16,8440
1217,愛之味,868,66,802,摩根大通,2023-08-16,8440
2312,金寶,989,266,723,摩根大通,2023-08-16,8440
8050,廣積,865,181,684,摩根大通,2023-08-16,8440
2206,三陽工業,765,166,599,摩根大通,2023-08-16,8440
8358,金居,718,128,590,摩根大通,2023-08-16,8440
2371,大同,780,231,549,摩根大通,2023-08-16,8440
6446,藥華藥,473,53,420,摩根大通,2023-08-16,8440
6188,廣明,494,82,412,摩根大通,2023-08-16,8440
2356,英業達,3969,3562,407,摩根大通,2023-08-16,8440
3576,聯合再生,564,159,405,摩根大通,2023-08-16,8440
3005,神基,520,116,404,摩根大通,2023-08-16,8440
2401,凌陽,434,43,391,摩根大通,2023-08-16,8440
6664,群翊,624,233,391,摩根大通,2023-08-16,8440
3035,智原,737,368,369,摩根大通,2023-08-16,8440
3051,力特,475,126,349,摩根大通,2023-08-16,8440
2615,萬海,953,608,345,摩根大通,2023-08-16,8440
6191,精成科,382,46,336,摩根大通,2023-08-16,8440
2353,宏��,1065,736,329,摩根大通,2023-08-16,8440
6125,廣運,349,37,312,摩根大通,2023-08-16,8440
3163,波若威,525,217,308,摩根大通,2023-08-16,8440
3325,旭品,406,109,297,摩根大通,2023-08-16,8440
3037,欣興,892,596,296,摩根大通,2023-08-16,8440
1215,卜蜂,309,17,292,摩根大通,2023-08-16,8440
2402,毅嘉,553,273,280,摩根大通,2023-08-16,8440
1471,首利,430,153,277,摩根大通,2023-08-16,8440
4162,智擎,274,7,267,摩根大通,2023-08-16,8440
6203,海韻電,278,24,254,摩根大通,2023-08-16,8440
4915,致伸,276,46,230,摩根大通,2023-08-16,8440
5388,中磊,298,70,228,摩根大通,2023-08-16,8440
6122,擎邦,255,29,226,摩根大通,2023-08-16,8440
3043,科風,631,408,223,摩根大通,2023-08-16,8440
5392,能率,216,13,203,摩根大通,2023-08-16,8440
3052,夆典,210,14,196,摩根大通,2023-08-16,8440
3653,健策,227,33,194,摩根大通,2023-08-16,8440
6239,力成,236,45,191,摩根大通,2023-08-16,8440
4533,協易機,199,11,188,摩根大通,2023-08-16,8440
2457,飛宏,519,336,183,摩根大通,2023-08-16,8440
5347,世界,383,200,183,摩根大通,2023-08-16,8440
3689,湧德,424,246,178,摩根大通,2023-08-16,8440
3032,偉訓,283,116,167,摩根大通,2023-08-16,8440
9958,世紀鋼,216,53,163,摩根大通,2023-08-16,8440
3583,辛耘,191,30,161,摩根大通,2023-08-16,8440
2401,凌陽,2246,266,1980,摩根大通,2023-08-17,8440
2312,金寶,2147,492,1655,摩根大通,2023-08-17,8440
2323,中環,1976,342,1634,摩根大通,2023-08-17,8440
2317,鴻海,3462,1969,1493,摩根大通,2023-08-17,8440
3711,日月光投控,1951,477,1474,摩根大通,2023-08-17,8440
2332,友訊,1794,367,1427,摩根大通,2023-08-17,8440
2330,台積電,4444,3145,1299,摩根大通,2023-08-17,8440
8358,金居,938,181,757,摩根大通,2023-08-17,8440
2408,南亞科,1248,564,684,摩根大通,2023-08-17,8440
2355,敬鵬,1008,345,663,摩根大通,2023-08-17,8440
3042,晶技,745,101,644,摩根大通,2023-08-17,8440
2371,大同,765,129,636,摩根大通,2023-08-17,8440
2606,裕民,716,100,616,摩根大通,2023-08-17,8440
2345,智邦,861,247,614,摩根大通,2023-08-17,8440
3105,穩懋,814,219,595,摩根大通,2023-08-17,8440
2105,正新,1033,452,581,摩根大通,2023-08-17,8440
2404,漢唐,588,36,552,摩根大通,2023-08-17,8440
2374,佳能,515,3,512,摩根大通,2023-08-17,8440
4938,和碩,1392,882,510,摩根大通,2023-08-17,8440
2376,技嘉,1681,1193,488,摩根大通,2023-08-17,8440
2402,毅嘉,1252,814,438,摩根大通,2023-08-17,8440
2303,聯電,2742,2313,429,摩根大通,2023-08-17,8440
6125,廣運,890,477,413,摩根大通,2023-08-17,8440
3078,僑威,1052,652,400,摩根大通,2023-08-17,8440
5347,世界,626,247,379,摩根大通,2023-08-17,8440
3325,旭品,637,279,358,摩根大通,2023-08-17,8440
2383,台光電,656,306,350,摩根大通,2023-08-17,8440
6126,信音,355,10,345,摩根大通,2023-08-17,8440
3032,偉訓,431,93,338,摩根大通,2023-08-17,8440
2392,正崴,314,13,301,摩根大通,2023-08-17,8440
3260,威剛,342,44,298,摩根大通,2023-08-17,8440
1519,華城,666,369,297,摩根大通,2023-08-17,8440
3617,碩天,312,40,272,摩根大通,2023-08-17,8440
2457,飛宏,399,135,264,摩根大通,2023-08-17,8440
3047,訊舟,270,7,263,摩根大通,2023-08-17,8440
6282,康舒,703,452,251,摩根大通,2023-08-17,8440
3013,晟銘電,550,301,249,摩根大通,2023-08-17,8440
4904,遠傳,690,444,246,摩根大通,2023-08-17,8440
2338,光罩,257,18,239,摩根大通,2023-08-17,8440
6550,北極星藥業-KY,229,4,225,摩根大通,2023-08-17,8440
2357,華碩,725,502,223,摩根大通,2023-08-17,8440
6415,矽力*-KY,285,72,213,摩根大通,2023-08-17,8440
1104,環泥,235,22,213,摩根大通,2023-08-17,8440
9105,泰金寶-DR,208,0,208,摩根大通,2023-08-17,8440
1584,精剛,208,10,198,摩根大通,2023-08-17,8440
4906,正文,228,36,192,摩根大通,2023-08-17,8440
6209,今國光,192,0,192,摩根大通,2023-08-17,8440
1102,亞泥,725,533,192,摩根大通,2023-08-17,8440
8069,元太,1356,1165,191,摩根大通,2023-08-17,8440
1603,華電,203,21,182,摩根大通,2023-08-17,8440
2603,長榮,3213,491,2722,摩根大通,2023-08-18,8440
2609,陽明,3244,1449,1795,摩根大通,2023-08-18,8440
2607,榮運,1635,27,1608,摩根大通,2023-08-18,8440
2330,台積電,2003,691,1312,摩根大通,2023-08-18,8440
2324,仁寶,3318,2023,1295,摩根大通,2023-08-18,8440
3715,定穎投控,2714,1523,1191,摩根大通,2023-08-18,8440
1609,大亞,1280,134,1146,摩根大通,2023-08-18,8440
2323,中環,1521,627,894,摩根大通,2023-08-18,8440
2374,佳能,864,88,776,摩根大通,2023-08-18,8440
2615,萬海,1431,664,767,摩根大通,2023-08-18,8440
2457,飛宏,891,156,735,摩根大通,2023-08-18,8440
8358,金居,834,196,638,摩根大通,2023-08-18,8440
2376,技嘉,1278,647,631,摩根大通,2023-08-18,8440
2388,威盛,1064,471,593,摩根大通,2023-08-18,8440
2363,矽統,2053,1471,582,摩根大通,2023-08-18,8440
5871,中租-KY,661,103,558,摩根大通,2023-08-18,8440
2601,益航,628,148,480,摩根大通,2023-08-18,8440
6191,精成科,519,72,447,摩根大通,2023-08-18,8440
1316,上曜,450,16,434,摩根大通,2023-08-18,8440
9103,美德醫療-DR,435,12,423,摩根大通,2023-08-18,8440
6415,矽力*-KY,658,239,419,摩根大通,2023-08-18,8440
1314,中石化,442,39,403,摩根大通,2023-08-18,8440
2331,精英,397,9,388,摩根大通,2023-08-18,8440
3675,德微,378,5,373,摩根大通,2023-08-18,8440
2637,慧洋-KY,912,543,369,摩根大通,2023-08-18,8440
2359,所羅門,514,154,360,摩根大通,2023-08-18,8440
3051,力特,582,228,354,摩根大通,2023-08-18,8440
2634,漢翔,426,73,353,摩根大通,2023-08-18,8440
2801,彰銀,810,473,337,摩根大通,2023-08-18,8440
3032,偉訓,429,100,329,摩根大通,2023-08-18,8440
4938,和碩,813,486,327,摩根大通,2023-08-18,8440
3653,健策,387,62,325,摩根大通,2023-08-18,8440
2538,基泰,283,2,281,摩根大通,2023-08-18,8440
2606,裕民,2014,1734,280,摩根大通,2023-08-18,8440
6213,聯茂,424,157,267,摩根大通,2023-08-18,8440
4129,聯合,294,44,250,摩根大通,2023-08-18,8440
2617,台航,265,26,239,摩根大通,2023-08-18,8440
2867,三商壽,247,16,231,摩根大通,2023-08-18,8440
2636,台驊控股,251,22,229,摩根大通,2023-08-18,8440
2023,燁輝,254,29,225,摩根大通,2023-08-18,8440
4915,致伸,244,21,223,摩根大通,2023-08-18,8440
6414,樺漢,271,54,217,摩根大通,2023-08-18,8440
3163,波若威,732,517,215,摩根大通,2023-08-18,8440
2542,興富發,329,135,194,摩根大通,2023-08-18,8440
2645,長榮航太,182,9,173,摩根大通,2023-08-18,8440
8210,勤誠,714,544,170,摩根大通,2023-08-18,8440
8069,元太,442,272,170,摩根大通,2023-08-18,8440
4207,環泰,177,9,168,摩根大通,2023-08-18,8440
4906,正文,249,83,166,摩根大通,2023-08-18,8440
2892,第一金,1117,952,165,摩根大通,2023-08-18,8440
2891,中信金,5196,979,4217,摩根大通,2023-08-21,8440
3231,緯創,4182,1908,2274,摩根大通,2023-08-21,8440
2363,矽統,4027,2203,1824,摩根大通,2023-08-21,8440
2884,玉山金,2357,736,1621,摩根大通,2023-08-21,8440
6235,華孚,2283,687,1596,摩根大通,2023-08-21,8440
2332,友訊,2603,1047,1556,摩根大通,2023-08-21,8440
2211,長榮鋼,1483,30,1453,摩根大通,2023-08-21,8440
2645,長榮航太,1345,60,1285,摩根大通,2023-08-21,8440
2356,英業達,2050,808,1242,摩根大通,2023-08-21,8440
6285,啟��,1284,280,1004,摩根大通,2023-08-21,8440
5347,世界,1053,126,927,摩根大通,2023-08-21,8440
2881,富邦金,1023,174,849,摩根大通,2023-08-21,8440
2376,技嘉,1021,220,801,摩根大通,2023-08-21,8440
2317,鴻海,1051,279,772,摩根大通,2023-08-21,8440
6446,藥華藥,966,223,743,摩根大通,2023-08-21,8440
4906,正文,965,295,670,摩根大通,2023-08-21,8440
2329,華泰,898,238,660,摩根大通,2023-08-21,8440
2892,第一金,969,362,607,摩根大通,2023-08-21,8440
2888,新光金,787,196,591,摩根大通,2023-08-21,8440
2449,京元電子,935,363,572,摩根大通,2023-08-21,8440
3033,威健,552,0,552,摩根大通,2023-08-21,8440
2308,台達電,851,345,506,摩根大通,2023-08-21,8440
2883,凱基金,728,244,484,摩根大通,2023-08-21,8440
5469,瀚宇博,605,153,452,摩根大通,2023-08-21,8440
2002,中鋼,680,244,436,摩根大通,2023-08-21,8440
2331,精英,408,8,400,摩根大通,2023-08-21,8440
2374,佳能,480,104,376,摩根大通,2023-08-21,8440
5871,中租-KY,397,32,365,摩根大通,2023-08-21,8440
2421,建準,1322,965,357,摩根大通,2023-08-21,8440
6770,力積電,673,318,355,摩根大通,2023-08-21,8440
3228,金麗科,374,19,355,摩根大通,2023-08-21,8440
2887,台新金,482,131,351,摩根大通,2023-08-21,8440
1326,台化,410,60,350,摩根大通,2023-08-21,8440
2301,光寶科,608,268,340,摩根大通,2023-08-21,8440
6415,矽力*-KY,407,74,333,摩根大通,2023-08-21,8440
4167,松瑞藥,332,3,329,摩根大通,2023-08-21,8440
6274,台燿,488,160,328,摩根大通,2023-08-21,8440
2353,宏��,1518,1197,321,摩根大通,2023-08-21,8440
2105,正新,354,46,308,摩根大通,2023-08-21,8440
3078,僑威,400,102,298,摩根大通,2023-08-21,8440
2312,金寶,341,48,293,摩根大通,2023-08-21,8440
3704,合勤控,391,102,289,摩根大通,2023-08-21,8440
2352,佳世達,429,147,282,摩根大通,2023-08-21,8440
5439,高技,299,17,282,摩根大通,2023-08-21,8440
2890,永豐金,686,408,278,摩根大通,2023-08-21,8440
1319,東陽,304,33,271,摩根大通,2023-08-21,8440
2834,臺企銀,449,194,255,摩根大通,2023-08-21,8440
6282,康舒,393,139,254,摩根大通,2023-08-21,8440
2360,致茂,271,32,239,摩根大通,2023-08-21,8440
5488,松普,234,9,225,摩根大通,2023-08-21,8440
2376,技嘉,3873,794,3079,摩根大通,2023-08-22,8440
2382,廣達,4068,1603,2465,摩根大通,2023-08-22,8440
2610,華航,4418,2214,2204,摩根大通,2023-08-22,8440
2330,台積電,3126,934,2192,摩根大通,2023-08-22,8440
2891,中信金,3232,1210,2022,摩根大通,2023-08-22,8440
2317,鴻海,2631,1015,1616,摩根大通,2023-08-22,8440
2886,兆豐金,2156,687,1469,摩根大通,2023-08-22,8440
3231,緯創,2638,1223,1415,摩根大通,2023-08-22,8440
2357,華碩,1454,196,1258,摩根大通,2023-08-22,8440
3037,欣興,1448,253,1195,摩根大通,2023-08-22,8440
9919,康那香,1248,80,1168,摩根大通,2023-08-22,8440
4960,誠美材,1188,70,1118,摩根大通,2023-08-22,8440
2303,聯電,1386,291,1095,摩根大通,2023-08-22,8440
2888,新光金,1204,126,1078,摩根大通,2023-08-22,8440
2605,新興,1693,740,953,摩根大通,2023-08-22,8440
2345,智邦,1459,616,843,摩根大通,2023-08-22,8440
4938,和碩,854,149,705,摩根大通,2023-08-22,8440
2882,國泰金,1033,342,691,摩根大通,2023-08-22,8440
2890,永豐金,909,227,682,摩根大通,2023-08-22,8440
2881,富邦金,897,224,673,摩根大通,2023-08-22,8440
5880,合庫金,762,120,642,摩根大通,2023-08-22,8440
2449,京元電子,2108,1482,626,摩根大通,2023-08-22,8440
1301,台塑,677,70,607,摩根大通,2023-08-22,8440
2353,宏��,1184,638,546,摩根大通,2023-08-22,8440
2324,仁寶,1471,927,544,摩根大通,2023-08-22,8440
2331,精英,575,32,543,摩根大通,2023-08-22,8440
1216,統一,678,146,532,摩根大通,2023-08-22,8440
2880,華南金,715,184,531,摩根大通,2023-08-22,8440
2360,致茂,598,81,517,摩根大通,2023-08-22,8440
2329,華泰,1019,510,509,摩根大通,2023-08-22,8440
2485,兆赫,490,6,484,摩根大通,2023-08-22,8440
3042,晶技,593,169,424,摩根大通,2023-08-22,8440
1326,台化,561,156,405,摩根大通,2023-08-22,8440
6274,台燿,877,483,394,摩根大通,2023-08-22,8440
6415,矽力*-KY,436,56,380,摩根大通,2023-08-22,8440
2492,華新科,400,22,378,摩根大通,2023-08-22,8440
5347,世界,417,54,363,摩根大通,2023-08-22,8440
2884,玉山金,905,560,345,摩根大通,2023-08-22,8440
3338,泰碩,460,118,342,摩根大通,2023-08-22,8440
1314,中石化,333,24,309,摩根大通,2023-08-22,8440
4147,中裕,382,74,308,摩根大通,2023-08-22,8440
1471,首利,1055,749,306,摩根大通,2023-08-22,8440
4167,松瑞藥,322,18,304,摩根大通,2023-08-22,8440
2885,元大金,604,303,301,摩根大通,2023-08-22,8440
8358,金居,648,364,284,摩根大通,2023-08-22,8440
3704,合勤控,323,71,252,摩根大通,2023-08-22,8440
1905,華紙,303,61,242,摩根大通,2023-08-22,8440
2395,研華,248,10,238,摩根大通,2023-08-22,8440
6257,矽格,273,41,232,摩根大通,2023-08-22,8440
8069,元太,296,65,231,摩根大通,2023-08-22,8440
2363,矽統,9926,1556,8370,摩根大通,2023-08-23,8440
3231,緯創,8422,1115,7307,摩根大通,2023-08-23,8440
4960,誠美材,2528,280,2248,摩根大通,2023-08-23,8440
2331,精英,1818,25,1793,摩根大通,2023-08-23,8440
6257,矽格,1773,2,1771,摩根大通,2023-08-23,8440
2324,仁寶,2104,420,1684,摩根大通,2023-08-23,8440
3702,大聯大,1562,320,1242,摩根大通,2023-08-23,8440
3044,健鼎,1422,198,1224,摩根大通,2023-08-23,8440
2357,華碩,1510,408,1102,摩根大通,2023-08-23,8440
2485,兆赫,1118,80,1038,摩根大通,2023-08-23,8440
8069,元太,1274,238,1036,摩根大通,2023-08-23,8440
2312,金寶,987,23,964,摩根大通,2023-08-23,8440
2353,宏��,1018,282,736,摩根大通,2023-08-23,8440
2634,漢翔,2323,1638,685,摩根大通,2023-08-23,8440
2332,友訊,1316,640,676,摩根大通,2023-08-23,8440
4906,正文,1465,819,646,摩根大通,2023-08-23,8440
2645,長榮航太,696,73,623,摩根大通,2023-08-23,8440
2401,凌陽,1026,425,601,摩根大通,2023-08-23,8440
6415,矽力*-KY,1033,451,582,摩根大通,2023-08-23,8440
3035,智原,663,92,571,摩根大通,2023-08-23,8440
4938,和碩,741,195,546,摩根大通,2023-08-23,8440
2313,華通,532,34,498,摩根大通,2023-08-23,8440
2317,鴻海,957,475,482,摩根大通,2023-08-23,8440
2105,正新,574,119,455,摩根大通,2023-08-23,8440
1216,統一,738,329,409,摩根大通,2023-08-23,8440
8927,北基,394,12,382,摩根大通,2023-08-23,8440
8210,勤誠,476,105,371,摩根大通,2023-08-23,8440
5452,佶優,443,91,352,摩根大通,2023-08-23,8440
3380,明泰,640,289,351,摩根大通,2023-08-23,8440
5285,界霖,351,1,350,摩根大通,2023-08-23,8440
2388,威盛,821,494,327,摩根大通,2023-08-23,8440
4904,遠傳,443,129,314,摩根大通,2023-08-23,8440
6274,台燿,765,451,314,摩根大通,2023-08-23,8440
6235,華孚,500,195,305,摩根大通,2023-08-23,8440
1471,首利,1287,984,303,摩根大通,2023-08-23,8440
3042,晶技,341,42,299,摩根大通,2023-08-23,8440
2329,華泰,1025,735,290,摩根大通,2023-08-23,8440
8150,南茂,294,4,290,摩根大通,2023-08-23,8440
1722,台肥,358,75,283,摩根大通,2023-08-23,8440
2303,聯電,375,106,269,摩根大通,2023-08-23,8440
8033,雷虎,270,7,263,摩根大通,2023-08-23,8440
3011,今皓,261,2,259,摩根大通,2023-08-23,8440
3264,欣銓,386,133,253,摩根大通,2023-08-23,8440
6117,迎廣,754,507,247,摩根大通,2023-08-23,8440
3021,鴻名,250,5,245,摩根大通,2023-08-23,8440
9934,成霖,262,18,244,摩根大通,2023-08-23,8440
6282,康舒,622,379,243,摩根大通,2023-08-23,8440
3105,穩懋,271,31,240,摩根大通,2023-08-23,8440
3013,晟銘電,1582,1352,230,摩根大通,2023-08-23,8440
6285,啟��,546,316,230,摩根大通,2023-08-23,8440
2324,仁寶,6102,797,5305,摩根大通,2023-08-24,8440
2331,精英,3521,274,3247,摩根大通,2023-08-24,8440
2317,鴻海,2674,112,2562,摩根大通,2023-08-24,8440
2634,漢翔,2637,93,2544,摩根大通,2023-08-24,8440
2301,光寶科,3233,977,2256,摩根大通,2023-08-24,8440
3037,欣興,2985,796,2189,摩根大通,2023-08-24,8440
2353,宏��,2417,397,2020,摩根大通,2023-08-24,8440
3715,定穎投控,2315,834,1481,摩根大通,2023-08-24,8440
2330,台積電,2663,1194,1469,摩根大通,2023-08-24,8440
2888,新光金,1931,727,1204,摩根大通,2023-08-24,8440
2618,長榮航,1674,536,1138,摩根大通,2023-08-24,8440
2645,長榮航太,1142,44,1098,摩根大通,2023-08-24,8440
4938,和碩,1125,170,955,摩根大通,2023-08-24,8440
2308,台達電,957,141,816,摩根大通,2023-08-24,8440
1301,台塑,801,21,780,摩根大通,2023-08-24,8440
2357,華碩,1016,260,756,摩根大通,2023-08-24,8440
2371,大同,740,14,726,摩根大通,2023-08-24,8440
2329,華泰,1944,1219,725,摩根大通,2023-08-24,8440
1319,東陽,1543,818,725,摩根大通,2023-08-24,8440
1504,東元,801,102,699,摩根大通,2023-08-24,8440
8069,元太,736,42,694,摩根大通,2023-08-24,8440
1519,華城,1401,752,649,摩根大通,2023-08-24,8440
3380,明泰,705,78,627,摩根大通,2023-08-24,8440
2884,玉山金,903,296,607,摩根大通,2023-08-24,8440
00830,國泰費城半導體,600,0,600,摩根大通,2023-08-24,8440
4916,事欣科,733,136,597,摩根大通,2023-08-24,8440
4960,誠美材,649,58,591,摩根大通,2023-08-24,8440
2401,凌陽,728,160,568,摩根大通,2023-08-24,8440
2486,一詮,695,152,543,摩根大通,2023-08-24,8440
2610,華航,1195,665,530,摩根大通,2023-08-24,8440
6274,台燿,963,461,502,摩根大通,2023-08-24,8440
1513,中興電,677,193,484,摩根大通,2023-08-24,8440
3017,奇鋐,729,245,484,摩根大通,2023-08-24,8440
1314,中石化,482,0,482,摩根大通,2023-08-24,8440
1477,聚陽,667,195,472,摩根大通,2023-08-24,8440
1609,大亞,477,28,449,摩根大通,2023-08-24,8440
9934,成霖,439,0,439,摩根大通,2023-08-24,8440
6213,聯茂,442,4,438,摩根大通,2023-08-24,8440
8222,寶一,498,75,423,摩根大通,2023-08-24,8440
1101,台泥,472,53,419,摩根大通,2023-08-24,8440
5469,瀚宇博,444,28,416,摩根大通,2023-08-24,8440
1584,精剛,423,34,389,摩根大通,2023-08-24,8440
2890,永豐金,590,201,389,摩根大通,2023-08-24,8440
2885,元大金,529,150,379,摩根大通,2023-08-24,8440
1810,和成,410,42,368,摩根大通,2023-08-24,8440
2355,敬鵬,532,183,349,摩根大通,2023-08-24,8440
2412,中華電,355,16,339,摩根大通,2023-08-24,8440
2892,第一金,466,129,337,摩根大通,2023-08-24,8440
4961,天鈺,358,26,332,摩根大通,2023-08-24,8440
6415,矽力*-KY,398,80,318,摩根大通,2023-08-24,8440
3711,日月光投控,8919,2734,6185,摩根大通,2023-08-25,8440
9945,潤泰新,4358,257,4101,摩根大通,2023-08-25,8440
2331,精英,3581,1132,2449,摩根大通,2023-08-25,8440
2885,元大金,2720,1254,1466,摩根大通,2023-08-25,8440
2388,威盛,1748,800,948,摩根大通,2023-08-25,8440
2383,台光電,1011,90,921,摩根大通,2023-08-25,8440
4906,正文,1302,431,871,摩根大通,2023-08-25,8440
2323,中環,1227,374,853,摩根大通,2023-08-25,8440
5876,上海商銀,1287,445,842,摩根大通,2023-08-25,8440
6125,廣運,950,219,731,摩根大通,2023-08-25,8440
3363,上詮,843,118,725,摩根大通,2023-08-25,8440
2402,毅嘉,809,95,714,摩根大通,2023-08-25,8440
2332,友訊,946,234,712,摩根大通,2023-08-25,8440
2359,所羅門,761,135,626,摩根大通,2023-08-25,8440
2401,凌陽,1027,421,606,摩根大通,2023-08-25,8440
6156,松上,585,15,570,摩根大通,2023-08-25,8440
3062,建漢,752,187,565,摩根大通,2023-08-25,8440
4114,健喬,553,0,553,摩根大通,2023-08-25,8440
3706,神達,1122,598,524,摩根大通,2023-08-25,8440
4123,晟德,469,1,468,摩根大通,2023-08-25,8440
3308,聯德,711,264,447,摩根大通,2023-08-25,8440
9919,康那香,530,86,444,摩根大通,2023-08-25,8440
3094,聯傑,534,159,375,摩根大通,2023-08-25,8440
2419,仲琦,695,339,356,摩根大通,2023-08-25,8440
6257,矽格,359,26,333,摩根大通,2023-08-25,8440
1736,喬山,349,33,316,摩根大通,2023-08-25,8440
2371,大同,366,58,308,摩根大通,2023-08-25,8440
6168,宏齊,420,112,308,摩根大通,2023-08-25,8440
8112,至上,375,68,307,摩根大通,2023-08-25,8440
1314,中石化,372,66,306,摩根大通,2023-08-25,8440
2882,國泰金,1449,1154,295,摩根大通,2023-08-25,8440
2645,長榮航太,457,189,268,摩根大通,2023-08-25,8440
5381,合正,618,360,258,摩根大通,2023-08-25,8440
2368,金像電,304,49,255,摩根大通,2023-08-25,8440
3041,揚智,255,7,248,摩根大通,2023-08-25,8440
3264,欣銓,256,9,247,摩根大通,2023-08-25,8440
3011,今皓,265,23,242,摩根大通,2023-08-25,8440
9934,成霖,245,7,238,摩根大通,2023-08-25,8440
3231,緯創,6333,6098,235,摩根大通,2023-08-25,8440
3380,明泰,290,56,234,摩根大通,2023-08-25,8440
2023,燁輝,267,38,229,摩根大通,2023-08-25,8440
2903,遠百,296,79,217,摩根大通,2023-08-25,8440
5607,遠雄港,217,6,211,摩根大通,2023-08-25,8440
8927,北基,308,101,207,摩根大通,2023-08-25,8440
6173,信昌電,214,17,197,摩根大通,2023-08-25,8440
4533,協易機,226,34,192,摩根大通,2023-08-25,8440
6167,久正,299,119,180,摩根大通,2023-08-25,8440
2355,敬鵬,329,162,167,摩根大通,2023-08-25,8440
4207,環泰,248,82,166,摩根大通,2023-08-25,8440
2105,正新,402,236,166,摩根大通,2023-08-25,8440
3231,緯創,8535,1715,6820,摩根大通,2023-08-28,8440
3481,群創,6330,1215,5115,摩根大通,2023-08-28,8440
3711,日月光投控,5127,1363,3764,摩根大通,2023-08-28,8440
2324,仁寶,4929,1532,3397,摩根大通,2023-08-28,8440
2301,光寶科,2330,247,2083,摩根大通,2023-08-28,8440
9945,潤泰新,1598,62,1536,摩根大通,2023-08-28,8440
2356,英業達,1745,220,1525,摩根大通,2023-08-28,8440
2353,宏��,2276,944,1332,摩根大通,2023-08-28,8440
2888,新光金,1212,62,1150,摩根大通,2023-08-28,8440
3706,神達,1946,799,1147,摩根大通,2023-08-28,8440
6235,華孚,1789,995,794,摩根大通,2023-08-28,8440
2885,元大金,971,238,733,摩根大通,2023-08-28,8440
00878,國泰永續高股息,729,0,729,摩根大通,2023-08-28,8440
2345,智邦,758,72,686,摩根大通,2023-08-28,8440
4961,天鈺,669,3,666,摩根大通,2023-08-28,8440
3483,力致,796,132,664,摩根大通,2023-08-28,8440
8033,雷虎,708,65,643,摩根大通,2023-08-28,8440
2886,兆豐金,753,141,612,摩根大通,2023-08-28,8440
2634,漢翔,1895,1291,604,摩根大通,2023-08-28,8440
5347,世界,714,119,595,摩根大通,2023-08-28,8440
2329,華泰,763,174,589,摩根大通,2023-08-28,8440
2357,華碩,611,46,565,摩根大通,2023-08-28,8440
2891,中信金,588,25,563,摩根大通,2023-08-28,8440
2882,國泰金,642,92,550,摩根大通,2023-08-28,8440
2609,陽明,547,16,531,摩根大通,2023-08-28,8440
2317,鴻海,615,92,523,摩根大通,2023-08-28,8440
5009,榮剛,499,1,498,摩根大通,2023-08-28,8440
2449,京元電子,2227,1730,497,摩根大通,2023-08-28,8440
2884,玉山金,482,89,393,摩根大通,2023-08-28,8440
1314,中石化,380,0,380,摩根大通,2023-08-28,8440
1301,台塑,405,27,378,摩根大通,2023-08-28,8440
2890,永豐金,380,15,365,摩根大通,2023-08-28,8440
4938,和碩,515,178,337,摩根大通,2023-08-28,8440
2340,台亞,448,113,335,摩根大通,2023-08-28,8440
3058,立德,331,2,329,摩根大通,2023-08-28,8440
5439,高技,327,4,323,摩根大通,2023-08-28,8440
9958,世紀鋼,783,463,320,摩根大通,2023-08-28,8440
2454,聯發科,401,127,274,摩根大通,2023-08-28,8440
1216,統一,381,109,272,摩根大通,2023-08-28,8440
2383,台光電,364,96,268,摩根大通,2023-08-28,8440
8069,元太,260,5,255,摩根大通,2023-08-28,8440
6282,康舒,451,200,251,摩根大通,2023-08-28,8440
2637,慧洋-KY,247,3,244,摩根大通,2023-08-28,8440
2880,華南金,323,80,243,摩根大通,2023-08-28,8440
2352,佳世達,310,73,237,摩根大通,2023-08-28,8440
5871,中租-KY,398,168,230,摩根大通,2023-08-28,8440
1609,大亞,381,161,220,摩根大通,2023-08-28,8440
6147,頎邦,240,22,218,摩根大通,2023-08-28,8440
2436,偉詮電,305,111,194,摩根大通,2023-08-28,8440
5284,jpp-KY,344,154,190,摩根大通,2023-08-28,8440
3711,日月光投控,7970,1590,6380,摩根大通,2023-08-29,8440
9945,潤泰新,2882,9,2873,摩根大通,2023-08-29,8440
3481,群創,4470,3014,1456,摩根大通,2023-08-29,8440
2105,正新,1112,75,1037,摩根大通,2023-08-29,8440
2888,新光金,1003,1,1002,摩根大通,2023-08-29,8440
2201,裕隆,1129,151,978,摩根大通,2023-08-29,8440
2486,一詮,950,32,918,摩根大通,2023-08-29,8440
2609,陽明,1032,120,912,摩根大通,2023-08-29,8440
2402,毅嘉,1223,387,836,摩根大通,2023-08-29,8440
2618,長榮航,1089,354,735,摩根大通,2023-08-29,8440
3011,今皓,851,146,705,摩根大通,2023-08-29,8440
2301,光寶科,948,249,699,摩根大通,2023-08-29,8440
2371,大同,714,26,688,摩根大通,2023-08-29,8440
5347,世界,671,46,625,摩根大通,2023-08-29,8440
2634,漢翔,1155,533,622,摩根大通,2023-08-29,8440
2455,全新,650,64,586,摩根大通,2023-08-29,8440
2885,元大金,634,83,551,摩根大通,2023-08-29,8440
2332,友訊,693,166,527,摩根大通,2023-08-29,8440
2457,飛宏,562,62,500,摩根大通,2023-08-29,8440
3715,定穎投控,896,430,466,摩根大通,2023-08-29,8440
2637,慧洋-KY,501,74,427,摩根大通,2023-08-29,8440
2330,台積電,962,545,417,摩根大通,2023-08-29,8440
2308,台達電,576,193,383,摩根大通,2023-08-29,8440
1519,華城,798,434,364,摩根大通,2023-08-29,8440
6415,矽力*-KY,369,22,347,摩根大通,2023-08-29,8440
2537,聯上發,337,3,334,摩根大通,2023-08-29,8440
1402,遠東新,328,1,327,摩根大通,2023-08-29,8440
2436,偉詮電,745,419,326,摩根大通,2023-08-29,8440
5880,合庫金,398,82,316,摩根大通,2023-08-29,8440
2630,亞航,1005,711,294,摩根大通,2023-08-29,8440
4916,事欣科,405,114,291,摩根大通,2023-08-29,8440
2383,台光電,377,101,276,摩根大通,2023-08-29,8440
2331,精英,1292,1037,255,摩根大通,2023-08-29,8440
2645,長榮航太,460,205,255,摩根大通,2023-08-29,8440
2344,華邦電,395,142,253,摩根大通,2023-08-29,8440
2887,台新金,360,110,250,摩根大通,2023-08-29,8440
3094,聯傑,316,70,246,摩根大通,2023-08-29,8440
2368,金像電,415,170,245,摩根大通,2023-08-29,8440
3037,欣興,356,119,237,摩根大通,2023-08-29,8440
2882,國泰金,471,243,228,摩根大通,2023-08-29,8440
1301,台塑,274,60,214,摩根大通,2023-08-29,8440
2353,宏��,487,273,214,摩根大通,2023-08-29,8440
2880,華南金,378,165,213,摩根大通,2023-08-29,8440
1314,中石化,217,12,205,摩根大通,2023-08-29,8440
6122,擎邦,240,37,203,摩根大通,2023-08-29,8440
6282,康舒,259,58,201,摩根大通,2023-08-29,8440
4979,華星光,752,551,201,摩根大通,2023-08-29,8440
5706,鳳凰,235,36,199,摩根大通,2023-08-29,8440
4763,材料-KY,302,114,188,摩根大通,2023-08-29,8440
2360,致茂,190,6,184,摩根大通,2023-08-29,8440
2337,旺宏,9056,918,8138,摩根大通,2023-08-30,8440
2888,新光金,3739,442,3297,摩根大通,2023-08-30,8440
2885,元大金,3389,221,3168,摩根大通,2023-08-30,8440
3711,日月光投控,3555,584,2971,摩根大通,2023-08-30,8440
2201,裕隆,2905,161,2744,摩根大通,2023-08-30,8440
2002,中鋼,2285,306,1979,摩根大通,2023-08-30,8440
2382,廣達,2747,805,1942,摩根大通,2023-08-30,8440
2363,矽統,3902,2016,1886,摩根大通,2023-08-30,8440
9945,潤泰新,1749,16,1733,摩根大通,2023-08-30,8440
2891,中信金,2144,476,1668,摩根大通,2023-08-30,8440
6274,台燿,1788,159,1629,摩根大通,2023-08-30,8440
2329,華泰,1646,54,1592,摩根大通,2023-08-30,8440
2886,兆豐金,1759,284,1475,摩根大通,2023-08-30,8440
2882,國泰金,1814,439,1375,摩根大通,2023-08-30,8440
3231,緯創,2206,999,1207,摩根大通,2023-08-30,8440
2317,鴻海,1657,460,1197,摩根大通,2023-08-30,8440
3715,定穎投控,2781,1589,1192,摩根大通,2023-08-30,8440
1402,遠東新,1235,159,1076,摩根大通,2023-08-30,8440
1319,東陽,1603,561,1042,摩根大通,2023-08-30,8440
3260,威剛,1000,68,932,摩根大通,2023-08-30,8440
2884,玉山金,1440,535,905,摩根大通,2023-08-30,8440
2353,宏��,1388,542,846,摩根大通,2023-08-30,8440
2887,台新金,1081,363,718,摩根大通,2023-08-30,8440
2324,仁寶,1043,334,709,摩根大通,2023-08-30,8440
2401,凌陽,1054,348,706,摩根大通,2023-08-30,8440
2892,第一金,1294,597,697,摩根大通,2023-08-30,8440
6126,信音,726,29,697,摩根大通,2023-08-30,8440
2392,正崴,672,2,670,摩根大通,2023-08-30,8440
2436,偉詮電,1554,890,664,摩根大通,2023-08-30,8440
1802,台玻,1418,760,658,摩根大通,2023-08-30,8440
2633,台灣高鐵,737,91,646,摩根大通,2023-08-30,8440
2356,英業達,1076,482,594,摩根大通,2023-08-30,8440
6168,宏齊,753,163,590,摩根大通,2023-08-30,8440
2352,佳世達,730,145,585,摩根大通,2023-08-30,8440
1605,華新,658,82,576,摩根大通,2023-08-30,8440
1519,華城,896,351,545,摩根大通,2023-08-30,8440
2402,毅嘉,2035,1504,531,摩根大通,2023-08-30,8440
1101,台泥,963,448,515,摩根大通,2023-08-30,8440
1216,統一,1020,537,483,摩根大通,2023-08-30,8440
3325,旭品,707,229,478,摩根大通,2023-08-30,8440
2105,正新,745,281,464,摩根大通,2023-08-30,8440
6005,群益證,482,34,448,摩根大通,2023-08-30,8440
5347,世界,487,42,445,摩根大通,2023-08-30,8440
2371,大同,476,45,431,摩根大通,2023-08-30,8440
3037,欣興,643,233,410,摩根大通,2023-08-30,8440
6770,力積電,474,81,393,摩根大通,2023-08-30,8440
6213,聯茂,1142,760,382,摩根大通,2023-08-30,8440
1504,東元,555,178,377,摩根大通,2023-08-30,8440
2474,可成,429,56,373,摩根大通,2023-08-30,8440
1314,中石化,415,49,366,摩根大通,2023-08-30,8440
2891,中信金,4586,1075,3511,摩根大通,2023-08-31,8440
9945,潤泰新,3517,28,3489,摩根大通,2023-08-31,8440
3481,群創,4343,1374,2969,摩根大通,2023-08-31,8440
2882,國泰金,2591,360,2231,摩根大通,2023-08-31,8440
2449,京元電子,1957,80,1877,摩根大通,2023-08-31,8440
2301,光寶科,2114,393,1721,摩根大通,2023-08-31,8440
2330,台積電,4710,3293,1417,摩根大通,2023-08-31,8440
2455,全新,1317,187,1130,摩根大通,2023-08-31,8440
2353,宏��,2263,1159,1104,摩根大通,2023-08-31,8440
3231,緯創,3970,2953,1017,摩根大通,2023-08-31,8440
2356,英業達,2174,1171,1003,摩根大通,2023-08-31,8440
3260,威剛,1718,737,981,摩根大通,2023-08-31,8440
1314,中石化,1161,265,896,摩根大通,2023-08-31,8440
1605,華新,1503,637,866,摩根大通,2023-08-31,8440
2382,廣達,1203,342,861,摩根大通,2023-08-31,8440
3051,力特,888,87,801,摩根大通,2023-08-31,8440
2618,長榮航,2863,2073,790,摩根大通,2023-08-31,8440
2485,兆赫,1363,618,745,摩根大通,2023-08-31,8440
8299,群聯,892,166,726,摩根大通,2023-08-31,8440
5225,東科-KY,1051,359,692,摩根大通,2023-08-31,8440
6122,擎邦,739,67,672,摩根大通,2023-08-31,8440
5381,合正,1328,657,671,摩根大通,2023-08-31,8440
2383,台光電,748,134,614,摩根大通,2023-08-31,8440
6235,華孚,742,143,599,摩根大通,2023-08-31,8440
4906,正文,780,210,570,摩根大通,2023-08-31,8440
3217,優群,651,92,559,摩根大通,2023-08-31,8440
8088,品安,857,314,543,摩根大通,2023-08-31,8440
1603,華電,566,39,527,摩根大通,2023-08-31,8440
2347,聯強,547,46,501,摩根大通,2023-08-31,8440
6188,廣明,773,276,497,摩根大通,2023-08-31,8440
6125,廣運,631,139,492,摩根大通,2023-08-31,8440
2838,聯邦銀,555,65,490,摩根大通,2023-08-31,8440
2324,仁寶,893,407,486,摩根大通,2023-08-31,8440
2402,毅嘉,3574,3090,484,摩根大通,2023-08-31,8440
2329,華泰,927,455,472,摩根大通,2023-08-31,8440
2363,矽統,1495,1059,436,摩根大通,2023-08-31,8440
6147,頎邦,549,128,421,摩根大通,2023-08-31,8440
2201,裕隆,583,166,417,摩根大通,2023-08-31,8440
9919,康那香,418,4,414,摩根大通,2023-08-31,8440
1522,堤維西,426,52,374,摩根大通,2023-08-31,8440
2421,建準,621,256,365,摩根大通,2023-08-31,8440
2388,威盛,592,238,354,摩根大通,2023-08-31,8440
2913,農林,346,6,340,摩根大通,2023-08-31,8440
1808,潤隆,365,29,336,摩根大通,2023-08-31,8440
2101,南港,357,22,335,摩根大通,2023-08-31,8440
1612,宏泰,337,16,321,摩根大通,2023-08-31,8440
3715,定穎投控,2294,1989,305,摩根大通,2023-08-31,8440
6284,佳邦,273,0,273,摩根大通,2023-08-31,8440
2313,華通,708,437,271,摩根大通,2023-08-31,8440
5388,中磊,260,3,257,摩根大通,2023-08-31,8440
1802,台玻,5721,271,5450,摩根大通,2023-09-01,8440
2890,永豐金,3271,242,3029,摩根大通,2023-09-01,8440
2301,光寶科,2971,362,2609,摩根大通,2023-09-01,8440
2885,元大金,2014,14,2000,摩根大通,2023-09-01,8440
2610,華航,1906,217,1689,摩根大通,2023-09-01,8440
2888,新光金,2138,508,1630,摩根大通,2023-09-01,8440
2324,仁寶,2132,730,1402,摩根大通,2023-09-01,8440
9919,康那香,1385,41,1344,摩根大通,2023-09-01,8440
1314,中石化,1141,16,1125,摩根大通,2023-09-01,8440
2882,國泰金,1310,276,1034,摩根大通,2023-09-01,8440
5347,世界,1046,86,960,摩根大通,2023-09-01,8440
2344,華邦電,1435,552,883,摩根大通,2023-09-01,8440
2618,長榮航,2282,1417,865,摩根大通,2023-09-01,8440
3715,定穎投控,1671,1003,668,摩根大通,2023-09-01,8440
2634,漢翔,986,320,666,摩根大通,2023-09-01,8440
2357,華碩,650,73,577,摩根大通,2023-09-01,8440
6415,矽力*-KY,822,258,564,摩根大通,2023-09-01,8440
2327,國巨,643,127,516,摩根大通,2023-09-01,8440
9904,寶成,543,54,489,摩根大通,2023-09-01,8440
4746,台耀,511,78,433,摩根大通,2023-09-01,8440
5009,榮剛,433,1,432,摩根大通,2023-09-01,8440
8086,宏捷科,431,5,426,摩根大通,2023-09-01,8440
2340,台亞,475,70,405,摩根大通,2023-09-01,8440
6122,擎邦,995,594,401,摩根大通,2023-09-01,8440
3044,健鼎,669,272,397,摩根大通,2023-09-01,8440
2476,鉅祥,406,10,396,摩根大通,2023-09-01,8440
3051,力特,504,145,359,摩根大通,2023-09-01,8440
8069,元太,498,139,359,摩根大通,2023-09-01,8440
3006,晶豪科,357,0,357,摩根大通,2023-09-01,8440
6213,聯茂,672,321,351,摩根大通,2023-09-01,8440
2520,冠德,368,23,345,摩根大通,2023-09-01,8440
4938,和碩,361,18,343,摩根大通,2023-09-01,8440
2891,中信金,603,264,339,摩根大通,2023-09-01,8440
5512,力麒,338,0,338,摩根大通,2023-09-01,8440
2317,鴻海,388,68,320,摩根大通,2023-09-01,8440
1810,和成,375,59,316,摩根大通,2023-09-01,8440
1216,統一,893,596,297,摩根大通,2023-09-01,8440
2352,佳世達,652,359,293,摩根大通,2023-09-01,8440
1217,愛之味,270,0,270,摩根大通,2023-09-01,8440
2377,微星,334,80,254,摩根大通,2023-09-01,8440
1616,億泰,245,0,245,摩根大通,2023-09-01,8440
1618,合機,325,85,240,摩根大通,2023-09-01,8440
1584,精剛,239,2,237,摩根大通,2023-09-01,8440
2023,燁輝,243,6,237,摩根大通,2023-09-01,8440
2332,友訊,280,50,230,摩根大通,2023-09-01,8440
3673,TPK-KY,219,0,219,摩根大通,2023-09-01,8440
2105,正新,214,0,214,摩根大通,2023-09-01,8440
4763,材料-KY,447,240,207,摩根大通,2023-09-01,8440
6547,高端疫苗,671,466,205,摩根大通,2023-09-01,8440
3707,漢磊,202,0,202,摩根大通,2023-09-01,8440
2382,廣達,3639,545,3094,摩根大通,2023-09-04,8440
1314,中石化,2010,0,2010,摩根大通,2023-09-04,8440
2888,新光金,1912,593,1319,摩根大通,2023-09-04,8440
2542,興富發,1104,3,1101,摩根大通,2023-09-04,8440
1301,台塑,1219,260,959,摩根大通,2023-09-04,8440
8086,宏捷科,1039,240,799,摩根大通,2023-09-04,8440
2383,台光電,1003,222,781,摩根大通,2023-09-04,8440
2603,長榮,669,3,666,摩根大通,2023-09-04,8440
2606,裕民,655,6,649,摩根大通,2023-09-04,8440
2615,萬海,662,17,645,摩根大通,2023-09-04,8440
2402,毅嘉,2586,1949,637,摩根大通,2023-09-04,8440
2367,燿華,650,17,633,摩根大通,2023-09-04,8440
5457,宣德,684,77,607,摩根大通,2023-09-04,8440
1305,華夏,582,22,560,摩根大通,2023-09-04,8440
2027,大成鋼,701,158,543,摩根大通,2023-09-04,8440
2891,中信金,779,282,497,摩根大通,2023-09-04,8440
2356,英業達,724,238,486,摩根大通,2023-09-04,8440
2303,聯電,492,19,473,摩根大通,2023-09-04,8440
3059,華晶科,446,0,446,摩根大通,2023-09-04,8440
2485,兆赫,596,161,435,摩根大通,2023-09-04,8440
2892,第一金,763,334,429,摩根大通,2023-09-04,8440
2031,新光鋼,387,2,385,摩根大通,2023-09-04,8440
2492,華新科,735,376,359,摩根大通,2023-09-04,8440
2353,宏��,481,127,354,摩根大通,2023-09-04,8440
6274,台燿,632,315,317,摩根大通,2023-09-04,8440
2006,東和鋼鐵,361,45,316,摩根大通,2023-09-04,8440
3036,文曄,386,85,301,摩根大通,2023-09-04,8440
1477,聚陽,310,12,298,摩根大通,2023-09-04,8440
2301,光寶科,593,297,296,摩根大通,2023-09-04,8440
4979,華星光,281,0,281,摩根大通,2023-09-04,8440
2421,建準,517,240,277,摩根大通,2023-09-04,8440
3042,晶技,336,59,277,摩根大通,2023-09-04,8440
3013,晟銘電,312,40,272,摩根大通,2023-09-04,8440
3706,神達,396,128,268,摩根大通,2023-09-04,8440
2454,聯發科,281,26,255,摩根大通,2023-09-04,8440
9105,泰金寶-DR,252,0,252,摩根大通,2023-09-04,8440
2809,京城銀,258,12,246,摩根大通,2023-09-04,8440
2014,中鴻,238,0,238,摩根大通,2023-09-04,8440
1532,勤美,237,0,237,摩根大通,2023-09-04,8440
2385,群光,322,90,232,摩根大通,2023-09-04,8440
8358,金居,550,319,231,摩根大通,2023-09-04,8440
1216,統一,396,166,230,摩根大通,2023-09-04,8440
2537,聯上發,228,0,228,摩根大通,2023-09-04,8440
2419,仲琦,258,31,227,摩根大通,2023-09-04,8440
6770,力積電,291,66,225,摩根大通,2023-09-04,8440
1504,東元,407,184,223,摩根大通,2023-09-04,8440
2890,永豐金,240,18,222,摩根大通,2023-09-04,8440
1402,遠東新,357,139,218,摩根大通,2023-09-04,8440
6732,昇佳電子,258,45,213,摩根大通,2023-09-04,8440
6531,愛普*,212,0,212,摩根大通,2023-09-04,8440
2324,仁寶,7395,771,6624,摩根大通,2023-09-05,8440
2888,新光金,2077,502,1575,摩根大通,2023-09-05,8440
2353,宏��,1733,309,1424,摩根大通,2023-09-05,8440
6274,台燿,1918,589,1329,摩根大通,2023-09-05,8440
2356,英業達,1375,280,1095,摩根大通,2023-09-05,8440
2897,王道銀行,892,55,837,摩根大通,2023-09-05,8440
2204,中華,983,216,767,摩根大通,2023-09-05,8440
1301,台塑,824,91,733,摩根大通,2023-09-05,8440
8110,華東,669,0,669,摩根大通,2023-09-05,8440
8112,至上,731,92,639,摩根大通,2023-09-05,8440
6122,擎邦,1195,582,613,摩根大通,2023-09-05,8440
2340,台亞,671,66,605,摩根大通,2023-09-05,8440
2454,聯發科,822,248,574,摩根大通,2023-09-05,8440
2388,威盛,1118,595,523,摩根大通,2023-09-05,8440
2331,精英,1694,1171,523,摩根大通,2023-09-05,8440
1402,遠東新,500,5,495,摩根大通,2023-09-05,8440
8358,金居,1274,850,424,摩根大通,2023-09-05,8440
2383,台光電,758,336,422,摩根大通,2023-09-05,8440
2906,高林,514,103,411,摩根大通,2023-09-05,8440
3017,奇鋐,439,33,406,摩根大通,2023-09-05,8440
2515,中工,429,25,404,摩根大通,2023-09-05,8440
3324,雙鴻,439,59,380,摩根大通,2023-09-05,8440
2464,盟立,398,28,370,摩根大通,2023-09-05,8440
8086,宏捷科,727,360,367,摩根大通,2023-09-05,8440
2892,第一金,648,282,366,摩根大通,2023-09-05,8440
2387,精元,388,34,354,摩根大通,2023-09-05,8440
2329,華泰,483,130,353,摩根大通,2023-09-05,8440
6191,精成科,382,35,347,摩根大通,2023-09-05,8440
2609,陽明,483,136,347,摩根大通,2023-09-05,8440
3059,華晶科,354,13,341,摩根大通,2023-09-05,8440
2301,光寶科,1132,792,340,摩根大通,2023-09-05,8440
2303,聯電,377,43,334,摩根大通,2023-09-05,8440
3035,智原,595,263,332,摩根大通,2023-09-05,8440
3715,定穎投控,1610,1290,320,摩根大通,2023-09-05,8440
2369,菱生,405,95,310,摩根大通,2023-09-05,8440
1722,台肥,294,4,290,摩根大通,2023-09-05,8440
2603,長榮,371,86,285,摩根大通,2023-09-05,8440
3592,瑞鼎,310,31,279,摩根大通,2023-09-05,8440
2368,金像電,412,134,278,摩根大通,2023-09-05,8440
1532,勤美,271,0,271,摩根大通,2023-09-05,8440
2421,建準,429,159,270,摩根大通,2023-09-05,8440
5328,華容,356,87,269,摩根大通,2023-09-05,8440
2337,旺宏,366,114,252,摩根大通,2023-09-05,8440
2605,新興,368,116,252,摩根大通,2023-09-05,8440
3264,欣銓,270,29,241,摩根大通,2023-09-05,8440
3576,聯合再生,274,33,241,摩根大通,2023-09-05,8440
2313,華通,250,17,233,摩根大通,2023-09-05,8440
2419,仲琦,252,28,224,摩根大通,2023-09-05,8440
3042,晶技,266,44,222,摩根大通,2023-09-05,8440
2002,中鋼,697,476,221,摩根大通,2023-09-05,8440
2313,華通,7071,726,6345,摩根大通,2023-09-06,8440
2610,華航,4584,476,4108,摩根大通,2023-09-06,8440
3231,緯創,3988,569,3419,摩根大通,2023-09-06,8440
9933,中鼎,1215,12,1203,摩根大通,2023-09-06,8440
9904,寶成,996,90,906,摩根大通,2023-09-06,8440
8112,至上,1375,490,885,摩根大通,2023-09-06,8440
6147,頎邦,1084,253,831,摩根大通,2023-09-06,8440
3362,先進光,774,112,662,摩根大通,2023-09-06,8440
4961,天鈺,771,118,653,摩根大通,2023-09-06,8440
1402,遠東新,980,359,621,摩根大通,2023-09-06,8440
2816,旺旺保,686,122,564,摩根大通,2023-09-06,8440
1605,華新,769,228,541,摩根大通,2023-09-06,8440
8150,南茂,535,18,517,摩根大通,2023-09-06,8440
3044,健鼎,983,482,501,摩根大通,2023-09-06,8440
8110,華東,531,65,466,摩根大通,2023-09-06,8440
2605,新興,745,295,450,摩根大通,2023-09-06,8440
4904,遠傳,543,94,449,摩根大通,2023-09-06,8440
2105,正新,628,187,441,摩根大通,2023-09-06,8440
5388,中磊,522,93,429,摩根大通,2023-09-06,8440
2355,敬鵬,444,16,428,摩根大通,2023-09-06,8440
2329,華泰,435,66,369,摩根大通,2023-09-06,8440
2457,飛宏,638,304,334,摩根大通,2023-09-06,8440
3006,晶豪科,375,45,330,摩根大通,2023-09-06,8440
3704,合勤控,517,196,321,摩根大通,2023-09-06,8440
3380,明泰,294,24,270,摩根大通,2023-09-06,8440
2317,鴻海,793,532,261,摩根大通,2023-09-06,8440
2382,廣達,835,590,245,摩根大通,2023-09-06,8440
8086,宏捷科,346,107,239,摩根大通,2023-09-06,8440
8064,東捷,317,85,232,摩根大通,2023-09-06,8440
2897,王道銀行,303,74,229,摩根大通,2023-09-06,8440
1522,堤維西,251,23,228,摩根大通,2023-09-06,8440
3059,華晶科,238,11,227,摩根大通,2023-09-06,8440
3005,神基,235,16,219,摩根大通,2023-09-06,8440
2337,旺宏,563,348,215,摩根大通,2023-09-06,8440
3324,雙鴻,429,216,213,摩根大通,2023-09-06,8440
1504,東元,500,292,208,摩根大通,2023-09-06,8440
6244,茂迪,213,7,206,摩根大通,2023-09-06,8440
1584,精剛,280,76,204,摩根大通,2023-09-06,8440
2206,三陽工業,293,90,203,摩根大通,2023-09-06,8440
2727,王品,242,47,195,摩根大通,2023-09-06,8440
6282,康舒,215,22,193,摩根大通,2023-09-06,8440
1513,中興電,205,21,184,摩根大通,2023-09-06,8440
6213,聯茂,331,155,176,摩根大通,2023-09-06,8440
2354,鴻準,240,78,162,摩根大通,2023-09-06,8440
9958,世紀鋼,261,103,158,摩根大通,2023-09-06,8440
6243,迅杰,232,76,156,摩根大通,2023-09-06,8440
3264,欣銓,160,7,153,摩根大通,2023-09-06,8440
6269,台郡,167,15,152,摩根大通,2023-09-06,8440
3034,聯詠,211,71,140,摩根大通,2023-09-06,8440
6672,騰輝電子-KY,154,15,139,摩根大通,2023-09-06,8440
2885,元大金,3882,561,3321,摩根大通,2023-09-07,8440
2376,技嘉,2314,508,1806,摩根大通,2023-09-07,8440
2337,旺宏,1500,74,1426,摩根大通,2023-09-07,8440
1605,華新,1658,290,1368,摩根大通,2023-09-07,8440
2353,宏��,1918,601,1317,摩根大通,2023-09-07,8440
9904,寶成,1363,332,1031,摩根大通,2023-09-07,8440
3006,晶豪科,1026,59,967,摩根大通,2023-09-07,8440
2485,兆赫,1494,529,965,摩根大通,2023-09-07,8440
1402,遠東新,1240,325,915,摩根大通,2023-09-07,8440
3264,欣銓,875,0,875,摩根大通,2023-09-07,8440
3715,定穎投控,1315,459,856,摩根大通,2023-09-07,8440
2324,仁寶,1273,460,813,摩根大通,2023-09-07,8440
5351,鈺創,690,29,661,摩根大通,2023-09-07,8440
2486,一詮,1339,843,496,摩根大通,2023-09-07,8440
2105,正新,659,219,440,摩根大通,2023-09-07,8440
5876,上海商銀,571,143,428,摩根大通,2023-09-07,8440
4904,遠傳,587,182,405,摩根大通,2023-09-07,8440
4915,致伸,443,45,398,摩根大通,2023-09-07,8440
2354,鴻準,411,57,354,摩根大通,2023-09-07,8440
2329,華泰,425,83,342,摩根大通,2023-09-07,8440
2816,旺旺保,542,219,323,摩根大通,2023-09-07,8440
3260,威剛,523,203,320,摩根大通,2023-09-07,8440
1471,首利,543,232,311,摩根大通,2023-09-07,8440
2332,友訊,412,106,306,摩根大通,2023-09-07,8440
3622,洋華,297,6,291,摩根大通,2023-09-07,8440
8150,南茂,323,36,287,摩根大通,2023-09-07,8440
8110,華東,298,12,286,摩根大通,2023-09-07,8440
5371,中光電,298,12,286,摩根大通,2023-09-07,8440
3037,欣興,323,40,283,摩根大通,2023-09-07,8440
3090,日電貿,326,43,283,摩根大通,2023-09-07,8440
2633,台灣高鐵,432,152,280,摩根大通,2023-09-07,8440
4746,台耀,285,18,267,摩根大通,2023-09-07,8440
2605,新興,286,43,243,摩根大通,2023-09-07,8440
2867,三商壽,333,93,240,摩根大通,2023-09-07,8440
8050,廣積,274,36,238,摩根大通,2023-09-07,8440
2498,宏達電,295,59,236,摩根大通,2023-09-07,8440
1522,堤維西,311,77,234,摩根大通,2023-09-07,8440
2888,新光金,943,711,232,摩根大通,2023-09-07,8440
2404,漢唐,261,34,227,摩根大通,2023-09-07,8440
2317,鴻海,660,435,225,摩根大通,2023-09-07,8440
6182,合晶,221,11,210,摩根大通,2023-09-07,8440
3017,奇鋐,408,203,205,摩根大通,2023-09-07,8440
3257,虹冠電,320,116,204,摩根大通,2023-09-07,8440
2834,臺企銀,472,274,198,摩根大通,2023-09-07,8440
2489,瑞軒,198,17,181,摩根大通,2023-09-07,8440
2436,偉詮電,343,166,177,摩根大通,2023-09-07,8440
2383,台光電,232,58,174,摩根大通,2023-09-07,8440
1210,大成,209,37,172,摩根大通,2023-09-07,8440
3308,聯德,170,2,168,摩根大通,2023-09-07,8440
3545,敦泰,174,7,167,摩根大通,2023-09-07,8440
2888,新光金,2775,350,2425,摩根大通,2023-09-08,8440
2363,矽統,3791,1377,2414,摩根大通,2023-09-08,8440
2618,長榮航,1443,175,1268,摩根大通,2023-09-08,8440
2105,正新,1350,125,1225,摩根大通,2023-09-08,8440
2892,第一金,1312,248,1064,摩根大通,2023-09-08,8440
1402,遠東新,923,167,756,摩根大通,2023-09-08,8440
2884,玉山金,1301,566,735,摩根大通,2023-09-08,8440
1305,華夏,819,97,722,摩根大通,2023-09-08,8440
2436,偉詮電,932,304,628,摩根大通,2023-09-08,8440
1605,華新,827,210,617,摩根大通,2023-09-08,8440
9904,寶成,757,167,590,摩根大通,2023-09-08,8440
2303,聯電,753,170,583,摩根大通,2023-09-08,8440
3035,智原,863,285,578,摩根大通,2023-09-08,8440
2867,三商壽,591,42,549,摩根大通,2023-09-08,8440
2421,建準,724,194,530,摩根大通,2023-09-08,8440
2886,兆豐金,894,390,504,摩根大通,2023-09-08,8440
1319,東陽,865,373,492,摩根大通,2023-09-08,8440
4532,瑞智,515,23,492,摩根大通,2023-09-08,8440
6213,聯茂,499,24,475,摩根大通,2023-09-08,8440
2801,彰銀,741,299,442,摩根大通,2023-09-08,8440
3231,緯創,881,460,421,摩根大通,2023-09-08,8440
8358,金居,461,41,420,摩根大通,2023-09-08,8440
2371,大同,501,84,417,摩根大通,2023-09-08,8440
2542,興富發,438,43,395,摩根大通,2023-09-08,8440
4904,遠傳,455,64,391,摩根大通,2023-09-08,8440
2337,旺宏,698,362,336,摩根大通,2023-09-08,8440
5876,上海商銀,407,78,329,摩根大通,2023-09-08,8440
2345,智邦,390,66,324,摩根大通,2023-09-08,8440
6274,台燿,496,178,318,摩根大通,2023-09-08,8440
4968,立積,321,20,301,摩根大通,2023-09-08,8440
8050,廣積,439,141,298,摩根大通,2023-09-08,8440
2355,敬鵬,271,5,266,摩根大通,2023-09-08,8440
2834,臺企銀,437,188,249,摩根大通,2023-09-08,8440
6234,高僑,264,28,236,摩根大通,2023-09-08,8440
6191,精成科,366,138,228,摩根大通,2023-09-08,8440
2615,萬海,309,83,226,摩根大通,2023-09-08,8440
3163,波若威,240,23,217,摩根大通,2023-09-08,8440
1304,台聚,267,55,212,摩根大通,2023-09-08,8440
1802,台玻,977,771,206,摩根大通,2023-09-08,8440
1471,首利,750,544,206,摩根大通,2023-09-08,8440
4979,華星光,203,0,203,摩根大通,2023-09-08,8440
5371,中光電,203,1,202,摩根大通,2023-09-08,8440
8299,群聯,240,40,200,摩根大通,2023-09-08,8440
3169,亞信,257,60,197,摩根大通,2023-09-08,8440
3030,德律,204,8,196,摩根大通,2023-09-08,8440
3090,日電貿,240,51,189,摩根大通,2023-09-08,8440
2312,金寶,330,142,188,摩根大通,2023-09-08,8440
2455,全新,226,41,185,摩根大通,2023-09-08,8440
1312,國喬,204,24,180,摩根大通,2023-09-08,8440
3545,敦泰,182,5,177,摩根大通,2023-09-08,8440
2890,永豐金,2498,130,2368,摩根大通,2023-09-11,8440
2301,光寶科,3838,1562,2276,摩根大通,2023-09-11,8440
2303,聯電,2676,568,2108,摩根大通,2023-09-11,8440
3231,緯創,2791,955,1836,摩根大通,2023-09-11,8440
2891,中信金,1316,363,953,摩根大通,2023-09-11,8440
9904,寶成,970,24,946,摩根大通,2023-09-11,8440
2892,第一金,1044,115,929,摩根大通,2023-09-11,8440
3715,定穎投控,2012,1171,841,摩根大通,2023-09-11,8440
1301,台塑,875,183,692,摩根大通,2023-09-11,8440
9910,豐泰,797,121,676,摩根大通,2023-09-11,8440
6188,廣明,752,121,631,摩根大通,2023-09-11,8440
2331,精英,686,70,616,摩根大通,2023-09-11,8440
2883,凱基金,547,1,546,摩根大通,2023-09-11,8440
2356,英業達,2630,2107,523,摩根大通,2023-09-11,8440
3264,欣銓,582,111,471,摩根大通,2023-09-11,8440
8069,元太,461,5,456,摩根大通,2023-09-11,8440
2105,正新,612,246,366,摩根大通,2023-09-11,8440
6153,嘉聯益,311,0,311,摩根大通,2023-09-11,8440
3042,晶技,328,20,308,摩根大通,2023-09-11,8440
2421,建準,667,373,294,摩根大通,2023-09-11,8440
3017,奇鋐,415,129,286,摩根大通,2023-09-11,8440
2455,全新,460,187,273,摩根大通,2023-09-11,8440
3711,日月光投控,363,95,268,摩根大通,2023-09-11,8440
1815,富喬,271,6,265,摩根大通,2023-09-11,8440
3306,鼎天,323,60,263,摩根大通,2023-09-11,8440
3037,欣興,291,30,261,摩根大通,2023-09-11,8440
2308,台達電,356,97,259,摩根大通,2023-09-11,8440
5864,致和證,363,106,257,摩根大通,2023-09-11,8440
3038,全台,252,27,225,摩根大通,2023-09-11,8440
3260,威剛,528,313,215,摩根大通,2023-09-11,8440
6451,訊芯-KY,314,100,214,摩根大通,2023-09-11,8440
2637,慧洋-KY,212,2,210,摩根大通,2023-09-11,8440
2888,新光金,2488,2281,207,摩根大通,2023-09-11,8440
5258,虹堡,226,19,207,摩根大通,2023-09-11,8440
2486,一詮,241,38,203,摩根大通,2023-09-11,8440
1216,統一,280,78,202,摩根大通,2023-09-11,8440
2419,仲琦,209,12,197,摩根大通,2023-09-11,8440
1905,華紙,267,74,193,摩根大通,2023-09-11,8440
3062,建漢,233,47,186,摩根大通,2023-09-11,8440
3545,敦泰,378,201,177,摩根大通,2023-09-11,8440
5512,力麒,177,3,174,摩根大通,2023-09-11,8440
2412,中華電,307,134,173,摩根大通,2023-09-11,8440
2317,鴻海,191,22,169,摩根大通,2023-09-11,8440
2337,旺宏,564,396,168,摩根大通,2023-09-11,8440
9958,世紀鋼,395,227,168,摩根大通,2023-09-11,8440
2427,三商電,434,267,167,摩根大通,2023-09-11,8440
6187,萬潤,192,35,157,摩根大通,2023-09-11,8440
1303,南亞,190,39,151,摩根大通,2023-09-11,8440
2485,兆赫,159,8,151,摩根大通,2023-09-11,8440
5871,中租-KY,179,32,147,摩根大通,2023-09-11,8440
2317,鴻海,6709,974,5735,摩根大通,2023-09-12,8440
1301,台塑,1442,322,1120,摩根大通,2023-09-12,8440
8069,元太,1112,5,1107,摩根大通,2023-09-12,8440
1522,堤維西,2185,1147,1038,摩根大通,2023-09-12,8440
3715,定穎投控,1673,659,1014,摩根大通,2023-09-12,8440
2313,華通,1795,846,949,摩根大通,2023-09-12,8440
4906,正文,845,0,845,摩根大通,2023-09-12,8440
3260,威剛,1643,823,820,摩根大通,2023-09-12,8440
2303,聯電,1233,490,743,摩根大通,2023-09-12,8440
2105,正新,835,126,709,摩根大通,2023-09-12,8440
2301,光寶科,1018,441,577,摩根大通,2023-09-12,8440
3264,欣銓,612,63,549,摩根大通,2023-09-12,8440
3706,神達,854,307,547,摩根大通,2023-09-12,8440
1402,遠東新,721,197,524,摩根大通,2023-09-12,8440
2388,威盛,509,110,399,摩根大通,2023-09-12,8440
2352,佳世達,639,280,359,摩根大通,2023-09-12,8440
6235,華孚,624,269,355,摩根大通,2023-09-12,8440
1314,中石化,356,6,350,摩根大通,2023-09-12,8440
1303,南亞,514,165,349,摩根大通,2023-09-12,8440
8112,至上,483,154,329,摩根大通,2023-09-12,8440
2436,偉詮電,402,73,329,摩根大通,2023-09-12,8440
2354,鴻準,530,221,309,摩根大通,2023-09-12,8440
2355,敬鵬,300,2,298,摩根大通,2023-09-12,8440
8046,南電,332,39,293,摩根大通,2023-09-12,8440
2630,亞航,682,390,292,摩根大通,2023-09-12,8440
1802,台玻,631,352,279,摩根大通,2023-09-12,8440
3346,麗清,587,315,272,摩根大通,2023-09-12,8440
6147,頎邦,257,3,254,摩根大通,2023-09-12,8440
6415,矽力*-KY,389,137,252,摩根大通,2023-09-12,8440
1515,力山,402,157,245,摩根大通,2023-09-12,8440
2851,中再保,242,2,240,摩根大通,2023-09-12,8440
6770,力積電,611,371,240,摩根大通,2023-09-12,8440
2014,中鴻,262,41,221,摩根大通,2023-09-12,8440
6182,合晶,202,13,189,摩根大通,2023-09-12,8440
7402,邑錡,196,8,188,摩根大通,2023-09-12,8440
1316,上曜,207,31,176,摩根大通,2023-09-12,8440
2458,義隆,182,9,173,摩根大通,2023-09-12,8440
6187,萬潤,198,30,168,摩根大通,2023-09-12,8440
2383,台光電,237,76,161,摩根大通,2023-09-12,8440
2449,京元電子,266,105,161,摩根大通,2023-09-12,8440
4915,致伸,609,450,159,摩根大通,2023-09-12,8440
9927,泰銘,158,2,156,摩根大通,2023-09-12,8440
5439,高技,172,17,155,摩根大通,2023-09-12,8440
2379,瑞昱,263,108,155,摩根大通,2023-09-12,8440
6531,愛普*,173,22,151,摩根大通,2023-09-12,8440
5392,能率,140,1,139,摩根大通,2023-09-12,8440
2417,圓剛,143,5,138,摩根大通,2023-09-12,8440
2743,山富,135,2,133,摩根大通,2023-09-12,8440
3624,光頡,186,57,129,摩根大通,2023-09-12,8440
1608,華榮,130,1,129,摩根大通,2023-09-12,8440
2610,華航,4721,776,3945,摩根大通,2023-09-13,8440
2891,中信金,3564,409,3155,摩根大通,2023-09-13,8440
2618,長榮航,4409,1255,3154,摩根大通,2023-09-13,8440
2363,矽統,3189,321,2868,摩根大通,2023-09-13,8440
2301,光寶科,2743,151,2592,摩根大通,2023-09-13,8440
2408,南亞科,2716,578,2138,摩根大通,2023-09-13,8440
4906,正文,2125,28,2097,摩根大通,2023-09-13,8440
3715,定穎投控,2911,867,2044,摩根大通,2023-09-13,8440
6285,啟��,1715,310,1405,摩根大通,2023-09-13,8440
1314,中石化,1530,171,1359,摩根大通,2023-09-13,8440
2323,中環,1315,115,1200,摩根大通,2023-09-13,8440
3017,奇鋐,1110,229,881,摩根大通,2023-09-13,8440
2105,正新,776,125,651,摩根大通,2023-09-13,8440
1524,耿鼎,2162,1517,645,摩根大通,2023-09-13,8440
3706,神達,833,196,637,摩根大通,2023-09-13,8440
2609,陽明,741,105,636,摩根大通,2023-09-13,8440
9904,寶成,874,286,588,摩根大通,2023-09-13,8440
2368,金像電,857,288,569,摩根大通,2023-09-13,8440
1605,華新,651,98,553,摩根大通,2023-09-13,8440
2345,智邦,610,92,518,摩根大通,2023-09-13,8440
4979,華星光,515,0,515,摩根大通,2023-09-13,8440
2357,華碩,869,407,462,摩根大通,2023-09-13,8440
5371,中光電,796,338,458,摩根大通,2023-09-13,8440
1402,遠東新,538,88,450,摩根大通,2023-09-13,8440
3322,建舜電,674,257,417,摩根大通,2023-09-13,8440
2436,偉詮電,694,285,409,摩根大通,2023-09-13,8440
1319,東陽,745,337,408,摩根大通,2023-09-13,8440
9934,成霖,404,1,403,摩根大通,2023-09-13,8440
3005,神基,629,239,390,摩根大通,2023-09-13,8440
2851,中再保,380,6,374,摩根大通,2023-09-13,8440
1802,台玻,445,110,335,摩根大通,2023-09-13,8440
2838,聯邦銀,339,4,335,摩根大通,2023-09-13,8440
1312,國喬,359,34,325,摩根大通,2023-09-13,8440
4105,東洋,309,0,309,摩根大通,2023-09-13,8440
2402,毅嘉,489,215,274,摩根大通,2023-09-13,8440
6239,力成,271,5,266,摩根大通,2023-09-13,8440
3264,欣銓,457,192,265,摩根大通,2023-09-13,8440
1215,卜蜂,319,57,262,摩根大通,2023-09-13,8440
3209,全科,264,5,259,摩根大通,2023-09-13,8440
4915,致伸,406,150,256,摩根大通,2023-09-13,8440
8996,高力,274,30,244,摩根大通,2023-09-13,8440
2421,建準,675,435,240,摩根大通,2023-09-13,8440
1560,中砂,340,105,235,摩根大通,2023-09-13,8440
6451,訊芯-KY,258,28,230,摩根大通,2023-09-13,8440
3162,精確,302,73,229,摩根大通,2023-09-13,8440
6176,瑞儀,360,133,227,摩根大通,2023-09-13,8440
1301,台塑,454,232,222,摩根大通,2023-09-13,8440
3380,明泰,517,305,212,摩根大通,2023-09-13,8440
2601,益航,212,0,212,摩根大通,2023-09-13,8440
2383,台光電,394,183,211,摩根大通,2023-09-13,8440
2363,矽統,12143,99,12044,摩根大通,2023-09-14,8440
1522,堤維西,3607,941,2666,摩根大通,2023-09-14,8440
2637,慧洋-KY,2671,269,2402,摩根大通,2023-09-14,8440
1605,華新,2358,274,2084,摩根大通,2023-09-14,8440
1402,遠東新,1931,39,1892,摩根大通,2023-09-14,8440
2486,一詮,3137,1295,1842,摩根大通,2023-09-14,8440
2002,中鋼,1684,40,1644,摩根大通,2023-09-14,8440
2324,仁寶,2965,1344,1621,摩根大通,2023-09-14,8440
2609,陽明,1552,127,1425,摩根大通,2023-09-14,8440
2352,佳世達,1492,99,1393,摩根大通,2023-09-14,8440
2105,正新,1695,314,1381,摩根大通,2023-09-14,8440
2605,新興,1901,614,1287,摩根大通,2023-09-14,8440
1301,台塑,1650,388,1262,摩根大通,2023-09-14,8440
2891,中信金,1714,453,1261,摩根大通,2023-09-14,8440
2388,威盛,1565,357,1208,摩根大通,2023-09-14,8440
3035,智原,1237,50,1187,摩根大通,2023-09-14,8440
1319,東陽,1803,622,1181,摩根大通,2023-09-14,8440
2890,永豐金,1301,166,1135,摩根大通,2023-09-14,8440
5876,上海商銀,1188,117,1071,摩根大通,2023-09-14,8440
2303,聯電,1195,173,1022,摩根大通,2023-09-14,8440
2615,萬海,1118,116,1002,摩根大通,2023-09-14,8440
2888,新光金,1519,566,953,摩根大通,2023-09-14,8440
2887,台新金,947,15,932,摩根大通,2023-09-14,8440
2355,敬鵬,891,19,872,摩根大通,2023-09-14,8440
2606,裕民,1206,342,864,摩根大通,2023-09-14,8440
4979,華星光,1958,1147,811,摩根大通,2023-09-14,8440
6285,啟��,906,117,789,摩根大通,2023-09-14,8440
4904,遠傳,804,46,758,摩根大通,2023-09-14,8440
2313,華通,2569,1819,750,摩根大通,2023-09-14,8440
2892,第一金,811,64,747,摩根大通,2023-09-14,8440
2801,彰銀,1002,291,711,摩根大通,2023-09-14,8440
2308,台達電,850,186,664,摩根大通,2023-09-14,8440
4906,正文,1205,563,642,摩根大通,2023-09-14,8440
3711,日月光投控,816,178,638,摩根大通,2023-09-14,8440
2382,廣達,1689,1058,631,摩根大通,2023-09-14,8440
3044,健鼎,1006,393,613,摩根大通,2023-09-14,8440
1102,亞泥,800,221,579,摩根大通,2023-09-14,8440
5880,合庫金,883,328,555,摩根大通,2023-09-14,8440
2454,聯發科,567,34,533,摩根大通,2023-09-14,8440
3045,台灣大,529,20,509,摩根大通,2023-09-14,8440
9904,寶成,657,172,485,摩根大通,2023-09-14,8440
3324,雙鴻,590,127,463,摩根大通,2023-09-14,8440
8034,榮群,488,28,460,摩根大通,2023-09-14,8440
2601,益航,460,1,459,摩根大通,2023-09-14,8440
2317,鴻海,603,152,451,摩根大通,2023-09-14,8440
2347,聯強,565,114,451,摩根大通,2023-09-14,8440
2603,長榮,633,186,447,摩根大通,2023-09-14,8440
2886,兆豐金,1462,1027,435,摩根大通,2023-09-14,8440
3545,敦泰,404,12,392,摩根大通,2023-09-14,8440
3062,建漢,421,40,381,摩根大通,2023-09-14,8440
2838,聯邦銀,12843,1,12842,摩根大通,2023-09-15,8440
1402,遠東新,8938,61,8877,摩根大通,2023-09-15,8440
1605,華新,8540,262,8278,摩根大通,2023-09-15,8440
2609,陽明,7040,1733,5307,摩根大通,2023-09-15,8440
2886,兆豐金,5900,958,4942,摩根大通,2023-09-15,8440
2330,台積電,8136,3196,4940,摩根大通,2023-09-15,8440
2603,長榮,4579,268,4311,摩根大通,2023-09-15,8440
2454,聯發科,3074,304,2770,摩根大通,2023-09-15,8440
2363,矽統,3295,562,2733,摩根大通,2023-09-15,8440
2382,廣達,2845,374,2471,摩根大通,2023-09-15,8440
2352,佳世達,2765,312,2453,摩根大通,2023-09-15,8440
2105,正新,2557,245,2312,摩根大通,2023-09-15,8440
2601,益航,2094,7,2087,摩根大通,2023-09-15,8440
2324,仁寶,3258,1530,1728,摩根大通,2023-09-15,8440
3006,晶豪科,1657,87,1570,摩根大通,2023-09-15,8440
5871,中租-KY,1904,355,1549,摩根大通,2023-09-15,8440
2606,裕民,2392,853,1539,摩根大通,2023-09-15,8440
2371,大同,4232,2708,1524,摩根大通,2023-09-15,8440
2888,新光金,2217,802,1415,摩根大通,2023-09-15,8440
2615,萬海,2107,881,1226,摩根大通,2023-09-15,8440
2885,元大金,2492,1333,1159,摩根大通,2023-09-15,8440
5880,合庫金,2444,1312,1132,摩根大通,2023-09-15,8440
4904,遠傳,1106,70,1036,摩根大通,2023-09-15,8440
3045,台灣大,1110,97,1013,摩根大通,2023-09-15,8440
8112,至上,931,5,926,摩根大通,2023-09-15,8440
1522,堤維西,1168,255,913,摩根大通,2023-09-15,8440
9904,寶成,1676,859,817,摩根大通,2023-09-15,8440
2883,凱基金,982,177,805,摩根大通,2023-09-15,8440
2889,國票金,834,38,796,摩根大通,2023-09-15,8440
2399,映泰,871,132,739,摩根大通,2023-09-15,8440
5876,上海商銀,1482,769,713,摩根大通,2023-09-15,8440
3034,聯詠,835,150,685,摩根大通,2023-09-15,8440
4938,和碩,1052,397,655,摩根大通,2023-09-15,8440
6147,頎邦,668,26,642,摩根大通,2023-09-15,8440
9958,世紀鋼,847,211,636,摩根大通,2023-09-15,8440
1301,台塑,1303,712,591,摩根大通,2023-09-15,8440
2449,京元電子,1389,808,581,摩根大通,2023-09-15,8440
8046,南電,615,40,575,摩根大通,2023-09-15,8440
3037,欣興,1347,777,570,摩根大通,2023-09-15,8440
2421,建準,718,153,565,摩根大通,2023-09-15,8440
5351,鈺創,492,23,469,摩根大通,2023-09-15,8440
3017,奇鋐,502,57,445,摩根大通,2023-09-15,8440
8088,品安,458,25,433,摩根大通,2023-09-15,8440
5009,榮剛,446,22,424,摩根大通,2023-09-15,8440
6182,合晶,436,14,422,摩根大通,2023-09-15,8440
3706,神達,727,314,413,摩根大通,2023-09-15,8440
2607,榮運,416,9,407,摩根大通,2023-09-15,8440
3702,大聯大,479,73,406,摩根大通,2023-09-15,8440
3013,晟銘電,539,159,380,摩根大通,2023-09-15,8440
2388,威盛,1942,1579,363,摩根大通,2023-09-15,8440
2301,光寶科,3676,1798,1878,摩根大通,2023-09-18,8440
2376,技嘉,2233,629,1604,摩根大通,2023-09-18,8440
2105,正新,1631,108,1523,摩根大通,2023-09-18,8440
2367,燿華,1866,692,1174,摩根大通,2023-09-18,8440
2014,中鴻,1146,143,1003,摩根大通,2023-09-18,8440
2449,京元電子,1569,627,942,摩根大通,2023-09-18,8440
2885,元大金,1140,235,905,摩根大通,2023-09-18,8440
2345,智邦,1010,139,871,摩根大通,2023-09-18,8440
3231,緯創,2755,2041,714,摩根大通,2023-09-18,8440
2368,金像電,711,24,687,摩根大通,2023-09-18,8440
3032,偉訓,729,61,668,摩根大通,2023-09-18,8440
1519,華城,705,79,626,摩根大通,2023-09-18,8440
2331,精英,723,184,539,摩根大通,2023-09-18,8440
3711,日月光投控,514,13,501,摩根大通,2023-09-18,8440
5371,中光電,553,54,499,摩根大通,2023-09-18,8440
2347,聯強,542,46,496,摩根大通,2023-09-18,8440
3017,奇鋐,946,456,490,摩根大通,2023-09-18,8440
2355,敬鵬,490,2,488,摩根大通,2023-09-18,8440
3265,台星科,552,99,453,摩根大通,2023-09-18,8440
3630,新鉅科,438,2,436,摩根大通,2023-09-18,8440
3163,波若威,826,396,430,摩根大通,2023-09-18,8440
6271,同欣電,447,44,403,摩根大通,2023-09-18,8440
3406,玉晶光,424,24,400,摩根大通,2023-09-18,8440
3704,合勤控,536,137,399,摩根大通,2023-09-18,8440
3189,景碩,407,21,386,摩根大通,2023-09-18,8440
1402,遠東新,560,174,386,摩根大通,2023-09-18,8440
2537,聯上發,378,0,378,摩根大通,2023-09-18,8440
4904,遠傳,386,17,369,摩根大通,2023-09-18,8440
5871,中租-KY,380,18,362,摩根大通,2023-09-18,8440
2329,華泰,704,346,358,摩根大通,2023-09-18,8440
9958,世紀鋼,727,370,357,摩根大通,2023-09-18,8440
6190,萬泰科,413,59,354,摩根大通,2023-09-18,8440
2031,新光鋼,349,0,349,摩根大通,2023-09-18,8440
6285,啟��,479,137,342,摩根大通,2023-09-18,8440
2388,威盛,1703,1372,331,摩根大通,2023-09-18,8440
8011,台通,348,22,326,摩根大通,2023-09-18,8440
4906,正文,502,178,324,摩根大通,2023-09-18,8440
2601,益航,359,36,323,摩根大通,2023-09-18,8440
2421,建準,581,270,311,摩根大通,2023-09-18,8440
2486,一詮,439,130,309,摩根大通,2023-09-18,8440
3702,大聯大,364,57,307,摩根大通,2023-09-18,8440
6182,合晶,392,90,302,摩根大通,2023-09-18,8440
9919,康那香,319,23,296,摩根大通,2023-09-18,8440
3062,建漢,290,2,288,摩根大通,2023-09-18,8440
6150,撼訊,352,73,279,摩根大通,2023-09-18,8440
3419,譁裕,438,170,268,摩根大通,2023-09-18,8440
1310,台苯,272,5,267,摩根大通,2023-09-18,8440
2890,永豐金,363,116,247,摩根大通,2023-09-18,8440
3450,聯鈞,377,130,247,摩根大通,2023-09-18,8440
3024,憶聲,290,50,240,摩根大通,2023-09-18,8440
2363,矽統,7547,466,7081,摩根大通,2023-09-19,8440
2867,三商壽,4231,0,4231,摩根大通,2023-09-19,8440
2885,元大金,3219,288,2931,摩根大通,2023-09-19,8440
2301,光寶科,3244,454,2790,摩根大通,2023-09-19,8440
2105,正新,2709,177,2532,摩根大通,2023-09-19,8440
2603,長榮,2581,401,2180,摩根大通,2023-09-19,8440
2886,兆豐金,2131,625,1506,摩根大通,2023-09-19,8440
2637,慧洋-KY,1775,291,1484,摩根大通,2023-09-19,8440
2303,聯電,1543,103,1440,摩根大通,2023-09-19,8440
2371,大同,1657,513,1144,摩根大通,2023-09-19,8440
2449,京元電子,1311,243,1068,摩根大通,2023-09-19,8440
1584,精剛,1008,30,978,摩根大通,2023-09-19,8440
1605,華新,1056,175,881,摩根大通,2023-09-19,8440
1802,台玻,976,147,829,摩根大通,2023-09-19,8440
3034,聯詠,761,82,679,摩根大通,2023-09-19,8440
2354,鴻準,1662,1041,621,摩根大通,2023-09-19,8440
3265,台星科,1072,498,574,摩根大通,2023-09-19,8440
2888,新光金,1623,1072,551,摩根大通,2023-09-19,8440
9919,康那香,578,46,532,摩根大通,2023-09-19,8440
2892,第一金,569,120,449,摩根大通,2023-09-19,8440
2313,華通,5571,5174,397,摩根大通,2023-09-19,8440
2017,官田鋼,396,0,396,摩根大通,2023-09-19,8440
2412,中華電,357,15,342,摩根大通,2023-09-19,8440
2421,建準,732,397,335,摩根大通,2023-09-19,8440
8112,至上,959,643,316,摩根大通,2023-09-19,8440
5871,中租-KY,611,312,299,摩根大通,2023-09-19,8440
1568,倉佑,306,8,298,摩根大通,2023-09-19,8440
3715,定穎投控,958,660,298,摩根大通,2023-09-19,8440
2882,國泰金,905,609,296,摩根大通,2023-09-19,8440
5347,世界,350,56,294,摩根大通,2023-09-19,8440
2330,台積電,908,622,286,摩根大通,2023-09-19,8440
2538,基泰,368,85,283,摩根大通,2023-09-19,8440
3324,雙鴻,401,118,283,摩根大通,2023-09-19,8440
4904,遠傳,282,18,264,摩根大通,2023-09-19,8440
2382,廣達,664,408,256,摩根大通,2023-09-19,8440
2409,友達,636,388,248,摩根大通,2023-09-19,8440
1524,耿鼎,283,38,245,摩根大通,2023-09-19,8440
2609,陽明,586,344,242,摩根大通,2023-09-19,8440
3090,日電貿,244,2,242,摩根大通,2023-09-19,8440
1314,中石化,267,35,232,摩根大通,2023-09-19,8440
6278,台表科,218,3,215,摩根大通,2023-09-19,8440
2891,中信金,801,590,211,摩根大通,2023-09-19,8440
3032,偉訓,554,345,209,摩根大通,2023-09-19,8440
1402,遠東新,450,243,207,摩根大通,2023-09-19,8440
3702,大聯大,317,111,206,摩根大通,2023-09-19,8440
2374,佳能,202,5,197,摩根大通,2023-09-19,8440
2641,正德,370,177,193,摩根大通,2023-09-19,8440
6770,力積電,267,82,185,摩根大通,2023-09-19,8440
4906,正文,375,195,180,摩根大通,2023-09-19,8440
2014,中鴻,210,37,173,摩根大通,2023-09-19,8440
2610,華航,6265,1297,4968,摩根大通,2023-09-20,8440
2609,陽明,3307,256,3051,摩根大通,2023-09-20,8440
2605,新興,2424,785,1639,摩根大通,2023-09-20,8440
3231,緯創,4572,2953,1619,摩根大通,2023-09-20,8440
2890,永豐金,1086,159,927,摩根大通,2023-09-20,8440
6274,台燿,1089,194,895,摩根大通,2023-09-20,8440
2376,技嘉,1759,1032,727,摩根大通,2023-09-20,8440
1402,遠東新,756,32,724,摩根大通,2023-09-20,8440
4904,遠傳,851,183,668,摩根大通,2023-09-20,8440
2637,慧洋-KY,986,390,596,摩根大通,2023-09-20,8440
2615,萬海,806,232,574,摩根大通,2023-09-20,8440
2014,中鴻,579,58,521,摩根大通,2023-09-20,8440
1609,大亞,528,48,480,摩根大通,2023-09-20,8440
3036,文曄,807,357,450,摩根大通,2023-09-20,8440
2211,長榮鋼,417,5,412,摩根大通,2023-09-20,8440
2538,基泰,603,195,408,摩根大通,2023-09-20,8440
6213,聯茂,471,75,396,摩根大通,2023-09-20,8440
2312,金寶,424,30,394,摩根大通,2023-09-20,8440
2360,致茂,407,15,392,摩根大通,2023-09-20,8440
3380,明泰,432,40,392,摩根大通,2023-09-20,8440
6285,啟��,944,558,386,摩根大通,2023-09-20,8440
1316,上曜,379,4,375,摩根大通,2023-09-20,8440
6182,合晶,420,122,298,摩根大通,2023-09-20,8440
2618,長榮航,926,633,293,摩根大通,2023-09-20,8440
2617,台航,419,132,287,摩根大通,2023-09-20,8440
2356,英業達,1652,1372,280,摩根大通,2023-09-20,8440
3515,華擎,293,22,271,摩根大通,2023-09-20,8440
2880,華南金,639,370,269,摩根大通,2023-09-20,8440
8064,東捷,470,205,265,摩根大通,2023-09-20,8440
3013,晟銘電,347,84,263,摩根大通,2023-09-20,8440
6235,華孚,341,96,245,摩根大通,2023-09-20,8440
2402,毅嘉,444,210,234,摩根大通,2023-09-20,8440
3189,景碩,256,23,233,摩根大通,2023-09-20,8440
2454,聯發科,589,361,228,摩根大通,2023-09-20,8440
9958,世紀鋼,447,220,227,摩根大通,2023-09-20,8440
3035,智原,293,72,221,摩根大通,2023-09-20,8440
2542,興富發,478,258,220,摩根大通,2023-09-20,8440
3260,威剛,434,215,219,摩根大通,2023-09-20,8440
9904,寶成,586,375,211,摩根大通,2023-09-20,8440
2383,台光電,527,327,200,摩根大通,2023-09-20,8440
6531,愛普*,544,351,193,摩根大通,2023-09-20,8440
3014,聯陽,250,62,188,摩根大通,2023-09-20,8440
3702,大聯大,187,0,187,摩根大通,2023-09-20,8440
2308,台達電,516,329,187,摩根大通,2023-09-20,8440
3596,智易,195,18,177,摩根大通,2023-09-20,8440
3324,雙鴻,183,10,173,摩根大通,2023-09-20,8440
2405,輔信,215,43,172,摩根大通,2023-09-20,8440
2458,義隆,190,19,171,摩根大通,2023-09-20,8440
3322,建舜電,179,12,167,摩根大通,2023-09-20,8440
1524,耿鼎,217,57,160,摩根大通,2023-09-20,8440
2303,聯電,8587,2166,6421,摩根大通,2023-09-21,8440
2888,新光金,6151,3801,2350,摩根大通,2023-09-21,8440
2449,京元電子,2941,620,2321,摩根大通,2023-09-21,8440
2637,慧洋-KY,2491,255,2236,摩根大通,2023-09-21,8440
2610,華航,2334,949,1385,摩根大通,2023-09-21,8440
00692,富邦公司治理,1000,0,1000,摩根大通,2023-09-21,8440
9904,寶成,1360,398,962,摩根大通,2023-09-21,8440
5347,世界,1116,303,813,摩根大通,2023-09-21,8440
3044,健鼎,875,135,740,摩根大通,2023-09-21,8440
2609,陽明,1151,442,709,摩根大通,2023-09-21,8440
00861,元大全球未來通訊,700,0,700,摩根大通,2023-09-21,8440
3711,日月光投控,1378,688,690,摩根大通,2023-09-21,8440
2515,中工,644,1,643,摩根大通,2023-09-21,8440
2881,富邦金,2725,2145,580,摩根大通,2023-09-21,8440
2618,長榮航,1264,708,556,摩根大通,2023-09-21,8440
2014,中鴻,632,105,527,摩根大通,2023-09-21,8440
2337,旺宏,618,91,527,摩根大通,2023-09-21,8440
1815,富喬,638,212,426,摩根大通,2023-09-21,8440
2454,聯發科,732,308,424,摩根大通,2023-09-21,8440
2382,廣達,1981,1571,410,摩根大通,2023-09-21,8440
2383,台光電,542,180,362,摩根大通,2023-09-21,8440
1609,大亞,432,82,350,摩根大通,2023-09-21,8440
3035,智原,559,228,331,摩根大通,2023-09-21,8440
3090,日電貿,318,30,288,摩根大通,2023-09-21,8440
6485,點序,285,7,278,摩根大通,2023-09-21,8440
3338,泰碩,311,38,273,摩根大通,2023-09-21,8440
3324,雙鴻,481,232,249,摩根大通,2023-09-21,8440
2102,泰豐,259,10,249,摩根大通,2023-09-21,8440
2352,佳世達,510,264,246,摩根大通,2023-09-21,8440
3289,宜特,240,3,237,摩根大通,2023-09-21,8440
2395,研華,377,141,236,摩根大通,2023-09-21,8440
6669,緯穎,313,85,228,摩根大通,2023-09-21,8440
3483,力致,407,181,226,摩根大通,2023-09-21,8440
3704,合勤控,265,49,216,摩根大通,2023-09-21,8440
6188,廣明,243,31,212,摩根大通,2023-09-21,8440
3533,嘉澤,221,14,207,摩根大通,2023-09-21,8440
2301,光寶科,1807,1602,205,摩根大通,2023-09-21,8440
2436,偉詮電,225,36,189,摩根大通,2023-09-21,8440
3163,波若威,310,124,186,摩根大通,2023-09-21,8440
3005,神基,247,72,175,摩根大通,2023-09-21,8440
1477,聚陽,189,25,164,摩根大通,2023-09-21,8440
2537,聯上發,201,42,159,摩根大通,2023-09-21,8440
2357,華碩,440,284,156,摩根大通,2023-09-21,8440
1503,士電,267,113,154,摩根大通,2023-09-21,8440
4908,前鼎,207,54,153,摩根大通,2023-09-21,8440
2360,致茂,230,84,146,摩根大通,2023-09-21,8440
6244,茂迪,200,55,145,摩根大通,2023-09-21,8440
6285,啟��,566,421,145,摩根大通,2023-09-21,8440
2385,群光,222,92,130,摩根大通,2023-09-21,8440
4966,譜瑞-KY,153,39,114,摩根大通,2023-09-21,8440
2618,長榮航,8135,289,7846,摩根大通,2023-09-22,8440
2382,廣達,7077,750,6327,摩根大通,2023-09-22,8440
2363,矽統,3788,163,3625,摩根大通,2023-09-22,8440
6213,聯茂,2113,515,1598,摩根大通,2023-09-22,8440
2610,華航,1565,178,1387,摩根大通,2023-09-22,8440
1504,東元,1329,254,1075,摩根大通,2023-09-22,8440
3706,神達,1188,134,1054,摩根大通,2023-09-22,8440
9904,寶成,852,36,816,摩根大通,2023-09-22,8440
1605,華新,886,79,807,摩根大通,2023-09-22,8440
2449,京元電子,826,130,696,摩根大通,2023-09-22,8440
2312,金寶,705,22,683,摩根大通,2023-09-22,8440
2890,永豐金,682,17,665,摩根大通,2023-09-22,8440
3036,文曄,1247,619,628,摩根大通,2023-09-22,8440
4979,華星光,979,403,576,摩根大通,2023-09-22,8440
1522,堤維西,739,166,573,摩根大通,2023-09-22,8440
6451,訊芯-KY,670,126,544,摩根大通,2023-09-22,8440
2324,仁寶,697,165,532,摩根大通,2023-09-22,8440
2543,皇昌,505,3,502,摩根大通,2023-09-22,8440
2105,正新,1096,596,500,摩根大通,2023-09-22,8440
2376,技嘉,1696,1241,455,摩根大通,2023-09-22,8440
3322,建舜電,477,50,427,摩根大通,2023-09-22,8440
3013,晟銘電,602,200,402,摩根大通,2023-09-22,8440
2609,陽明,658,267,391,摩根大通,2023-09-22,8440
2323,中環,484,97,387,摩根大通,2023-09-22,8440
3715,定穎投控,839,489,350,摩根大通,2023-09-22,8440
2498,宏達電,359,15,344,摩根大通,2023-09-22,8440
8996,高力,363,37,326,摩根大通,2023-09-22,8440
2409,友達,519,206,313,摩根大通,2023-09-22,8440
3260,威剛,317,14,303,摩根大通,2023-09-22,8440
2405,輔信,382,81,301,摩根大通,2023-09-22,8440
1809,中釉,315,17,298,摩根大通,2023-09-22,8440
3702,大聯大,288,5,283,摩根大通,2023-09-22,8440
6120,達運,280,0,280,摩根大通,2023-09-22,8440
1319,東陽,462,185,277,摩根大通,2023-09-22,8440
1609,大亞,259,0,259,摩根大通,2023-09-22,8440
3596,智易,349,98,251,摩根大通,2023-09-22,8440
6274,台燿,487,239,248,摩根大通,2023-09-22,8440
4564,元翎,263,18,245,摩根大通,2023-09-22,8440
3078,僑威,252,9,243,摩根大通,2023-09-22,8440
1904,正隆,245,3,242,摩根大通,2023-09-22,8440
3338,泰碩,281,40,241,摩根大通,2023-09-22,8440
2886,兆豐金,883,646,237,摩根大通,2023-09-22,8440
2316,楠梓電,418,181,237,摩根大通,2023-09-22,8440
2357,華碩,597,367,230,摩根大通,2023-09-22,8440
2383,台光電,437,213,224,摩根大通,2023-09-22,8440
3034,聯詠,301,81,220,摩根大通,2023-09-22,8440
8088,品安,219,11,208,摩根大通,2023-09-22,8440
2367,燿華,635,445,190,摩根大通,2023-09-22,8440
2474,可成,251,63,188,摩根大通,2023-09-22,8440
3324,雙鴻,391,207,184,摩根大通,2023-09-22,8440
2303,聯電,4075,143,3932,摩根大通,2023-09-25,8440
2382,廣達,3564,1213,2351,摩根大通,2023-09-25,8440
6271,同欣電,1912,243,1669,摩根大通,2023-09-25,8440
3711,日月光投控,1687,125,1562,摩根大通,2023-09-25,8440
2881,富邦金,2615,1123,1492,摩根大通,2023-09-25,8440
5347,世界,1554,66,1488,摩根大通,2023-09-25,8440
2301,光寶科,1499,164,1335,摩根大通,2023-09-25,8440
2886,兆豐金,1477,145,1332,摩根大通,2023-09-25,8440
2363,矽統,2386,1072,1314,摩根大通,2023-09-25,8440
9904,寶成,1650,409,1241,摩根大通,2023-09-25,8440
2368,金像電,1521,431,1090,摩根大通,2023-09-25,8440
2605,新興,1054,70,984,摩根大通,2023-09-25,8440
2330,台積電,1727,889,838,摩根大通,2023-09-25,8440
4906,正文,842,27,815,摩根大通,2023-09-25,8440
2201,裕隆,791,27,764,摩根大通,2023-09-25,8440
8088,品安,792,29,763,摩根大通,2023-09-25,8440
3025,星通,722,32,690,摩根大通,2023-09-25,8440
2379,瑞昱,800,153,647,摩根大通,2023-09-25,8440
3231,緯創,1213,620,593,摩根大通,2023-09-25,8440
2206,三陽工業,885,300,585,摩根大通,2023-09-25,8440
6274,台燿,1067,502,565,摩根大通,2023-09-25,8440
2308,台達電,695,132,563,摩根大通,2023-09-25,8440
6139,亞翔,639,92,547,摩根大通,2023-09-25,8440
1584,精剛,1121,578,543,摩根大通,2023-09-25,8440
2890,永豐金,646,147,499,摩根大通,2023-09-25,8440
3036,文曄,961,478,483,摩根大通,2023-09-25,8440
3715,定穎投控,1081,616,465,摩根大通,2023-09-25,8440
8028,昇陽半導體,457,1,456,摩根大通,2023-09-25,8440
1504,東元,1166,733,433,摩根大通,2023-09-25,8440
2884,玉山金,590,157,433,摩根大通,2023-09-25,8440
1524,耿鼎,499,72,427,摩根大通,2023-09-25,8440
1605,華新,491,68,423,摩根大通,2023-09-25,8440
2340,台亞,402,3,399,摩根大通,2023-09-25,8440
9945,潤泰新,548,150,398,摩根大通,2023-09-25,8440
5009,榮剛,396,0,396,摩根大通,2023-09-25,8440
1609,大亞,395,0,395,摩根大通,2023-09-25,8440
6213,聯茂,462,67,395,摩根大通,2023-09-25,8440
1815,富喬,484,175,309,摩根大通,2023-09-25,8440
2327,國巨,331,37,294,摩根大通,2023-09-25,8440
1722,台肥,312,62,250,摩根大通,2023-09-25,8440
2885,元大金,415,167,248,摩根大通,2023-09-25,8440
3044,健鼎,324,80,244,摩根大通,2023-09-25,8440
5521,工信,242,4,238,摩根大通,2023-09-25,8440
2913,農林,254,19,235,摩根大通,2023-09-25,8440
8210,勤誠,340,109,231,摩根大通,2023-09-25,8440
6191,精成科,242,14,228,摩根大通,2023-09-25,8440
2515,中工,471,257,214,摩根大通,2023-09-25,8440
6415,矽力*-KY,261,48,213,摩根大通,2023-09-25,8440
3491,昇達科,266,57,209,摩根大通,2023-09-25,8440
2421,建準,488,295,193,摩根大通,2023-09-25,8440
1609,大亞,2486,75,2411,摩根大通,2023-09-26,8440
2885,元大金,2581,343,2238,摩根大通,2023-09-26,8440
6139,亞翔,1358,435,923,摩根大通,2023-09-26,8440
9904,寶成,1105,232,873,摩根大通,2023-09-26,8440
2356,英業達,1201,373,828,摩根大通,2023-09-26,8440
1603,華電,740,30,710,摩根大通,2023-09-26,8440
3036,文曄,989,283,706,摩根大通,2023-09-26,8440
1605,華新,712,76,636,摩根大通,2023-09-26,8440
2383,台光電,691,69,622,摩根大通,2023-09-26,8440
6806,森崴能源,732,132,600,摩根大通,2023-09-26,8440
2382,廣達,1190,598,592,摩根大通,2023-09-26,8440
3450,聯鈞,958,385,573,摩根大通,2023-09-26,8440
2376,技嘉,1146,626,520,摩根大通,2023-09-26,8440
9919,康那香,679,180,499,摩根大通,2023-09-26,8440
3017,奇鋐,1073,578,495,摩根大通,2023-09-26,8440
6415,矽力*-KY,558,69,489,摩根大通,2023-09-26,8440
1326,台化,613,143,470,摩根大通,2023-09-26,8440
6213,聯茂,620,168,452,摩根大通,2023-09-26,8440
6257,矽格,462,17,445,摩根大通,2023-09-26,8440
3025,星通,734,312,422,摩根大通,2023-09-26,8440
1612,宏泰,477,59,418,摩根大通,2023-09-26,8440
2313,華通,621,233,388,摩根大通,2023-09-26,8440
2355,敬鵬,444,62,382,摩根大通,2023-09-26,8440
2474,可成,514,134,380,摩根大通,2023-09-26,8440
2609,陽明,783,431,352,摩根大通,2023-09-26,8440
2890,永豐金,748,397,351,摩根大通,2023-09-26,8440
2327,國巨,366,27,339,摩根大通,2023-09-26,8440
8996,高力,400,64,336,摩根大通,2023-09-26,8440
2515,中工,338,7,331,摩根大通,2023-09-26,8440
3032,偉訓,420,132,288,摩根大通,2023-09-26,8440
1217,愛之味,274,7,267,摩根大通,2023-09-26,8440
3363,上詮,501,245,256,摩根大通,2023-09-26,8440
1314,中石化,483,239,244,摩根大通,2023-09-26,8440
3324,雙鴻,504,264,240,摩根大通,2023-09-26,8440
4906,正文,305,66,239,摩根大通,2023-09-26,8440
2845,遠東銀,305,73,232,摩根大通,2023-09-26,8440
1471,首利,393,174,219,摩根大通,2023-09-26,8440
3706,神達,291,77,214,摩根大通,2023-09-26,8440
3515,華擎,320,117,203,摩根大通,2023-09-26,8440
2607,榮運,200,13,187,摩根大通,2023-09-26,8440
2323,中環,198,21,177,摩根大通,2023-09-26,8440
4933,友輝,166,12,154,摩根大通,2023-09-26,8440
1604,聲寶,162,9,153,摩根大通,2023-09-26,8440
2401,凌陽,342,196,146,摩根大通,2023-09-26,8440
3293,鈊象,164,24,140,摩根大通,2023-09-26,8440
4961,天鈺,177,46,131,摩根大通,2023-09-26,8440
2543,皇昌,379,249,130,摩根大通,2023-09-26,8440
6235,華孚,202,84,118,摩根大通,2023-09-26,8440
1616,億泰,131,15,116,摩根大通,2023-09-26,8440
1784,訊聯,125,10,115,摩根大通,2023-09-26,8440
2618,長榮航,5268,654,4614,摩根大通,2023-09-27,8440
2887,台新金,4203,93,4110,摩根大通,2023-09-27,8440
2324,仁寶,3983,449,3534,摩根大通,2023-09-27,8440
2303,聯電,3774,608,3166,摩根大通,2023-09-27,8440
2888,新光金,3244,318,2926,摩根大通,2023-09-27,8440
2330,台積電,3349,501,2848,摩根大通,2023-09-27,8440
2886,兆豐金,3134,300,2834,摩根大通,2023-09-27,8440
2885,元大金,3714,1222,2492,摩根大通,2023-09-27,8440
2409,友達,2262,128,2134,摩根大通,2023-09-27,8440
2892,第一金,2111,95,2016,摩根大通,2023-09-27,8440
5880,合庫金,1938,35,1903,摩根大通,2023-09-27,8440
2610,華航,1923,157,1766,摩根大通,2023-09-27,8440
2883,凱基金,2478,804,1674,摩根大通,2023-09-27,8440
1216,統一,1682,82,1600,摩根大通,2023-09-27,8440
2882,國泰金,1677,180,1497,摩根大通,2023-09-27,8440
3481,群創,4751,3308,1443,摩根大通,2023-09-27,8440
2884,玉山金,1682,240,1442,摩根大通,2023-09-27,8440
2880,華南金,1366,84,1282,摩根大通,2023-09-27,8440
2412,中華電,1253,81,1172,摩根大通,2023-09-27,8440
1101,台泥,3155,2053,1102,摩根大通,2023-09-27,8440
2891,中信金,4889,3796,1093,摩根大通,2023-09-27,8440
2890,永豐金,1142,102,1040,摩根大通,2023-09-27,8440
2352,佳世達,1086,82,1004,摩根大通,2023-09-27,8440
5347,世界,1025,23,1002,摩根大通,2023-09-27,8440
2317,鴻海,1414,436,978,摩根大通,2023-09-27,8440
4904,遠傳,1004,69,935,摩根大通,2023-09-27,8440
2801,彰銀,1114,186,928,摩根大通,2023-09-27,8440
3715,定穎投控,1697,797,900,摩根大通,2023-09-27,8440
1303,南亞,1038,148,890,摩根大通,2023-09-27,8440
6285,啟��,881,8,873,摩根大通,2023-09-27,8440
1605,華新,1195,431,764,摩根大通,2023-09-27,8440
2353,宏��,1099,338,761,摩根大通,2023-09-27,8440
2634,漢翔,747,36,711,摩根大通,2023-09-27,8440
2834,臺企銀,1113,423,690,摩根大通,2023-09-27,8440
2485,兆赫,665,6,659,摩根大通,2023-09-27,8440
2313,華通,810,153,657,摩根大通,2023-09-27,8440
4938,和碩,830,174,656,摩根大通,2023-09-27,8440
2363,矽統,1230,595,635,摩根大通,2023-09-27,8440
3711,日月光投控,861,234,627,摩根大通,2023-09-27,8440
3702,大聯大,620,29,591,摩根大通,2023-09-27,8440
2354,鴻準,595,7,588,摩根大通,2023-09-27,8440
5876,上海商銀,568,9,559,摩根大通,2023-09-27,8440
2383,台光電,636,84,552,摩根大通,2023-09-27,8440
3380,明泰,540,1,539,摩根大通,2023-09-27,8440
6274,台燿,642,104,538,摩根大通,2023-09-27,8440
1402,遠東新,659,124,535,摩根大通,2023-09-27,8440
2371,大同,629,115,514,摩根大通,2023-09-27,8440
3035,智原,641,134,507,摩根大通,2023-09-27,8440
2845,遠東銀,503,3,500,摩根大通,2023-09-27,8440
6139,亞翔,719,229,490,摩根大通,2023-09-27,8440
1609,大亞,6147,392,5755,摩根大通,2023-09-28,8440
2891,中信金,5988,446,5542,摩根大通,2023-09-28,8440
2303,聯電,3090,404,2686,摩根大通,2023-09-28,8440
1504,東元,2360,223,2137,摩根大通,2023-09-28,8440
2324,仁寶,2492,676,1816,摩根大通,2023-09-28,8440
2515,中工,1760,23,1737,摩根大通,2023-09-28,8440
2610,華航,1731,288,1443,摩根大通,2023-09-28,8440
1618,合機,1620,241,1379,摩根大通,2023-09-28,8440
2886,兆豐金,1674,357,1317,摩根大通,2023-09-28,8440
2888,新光金,1757,459,1298,摩根大通,2023-09-28,8440
2890,永豐金,1375,258,1117,摩根大通,2023-09-28,8440
3481,群創,1276,195,1081,摩根大通,2023-09-28,8440
3036,文曄,2284,1298,986,摩根大通,2023-09-28,8440
1560,中砂,1325,379,946,摩根大通,2023-09-28,8440
1101,台泥,2443,1559,884,摩根大通,2023-09-28,8440
2405,輔信,942,59,883,摩根大通,2023-09-28,8440
5347,世界,845,87,758,摩根大通,2023-09-28,8440
2206,三陽工業,755,5,750,摩根大通,2023-09-28,8440
1612,宏泰,801,67,734,摩根大通,2023-09-28,8440
1907,永豐餘,917,229,688,摩根大通,2023-09-28,8440
1216,統一,905,243,662,摩根大通,2023-09-28,8440
2313,華通,758,100,658,摩根大通,2023-09-28,8440
3706,神達,652,63,589,摩根大通,2023-09-28,8440
1522,堤維西,571,18,553,摩根大通,2023-09-28,8440
2412,中華電,843,292,551,摩根大通,2023-09-28,8440
1102,亞泥,664,143,521,摩根大通,2023-09-28,8440
2881,富邦金,865,361,504,摩根大通,2023-09-28,8440
2402,毅嘉,619,130,489,摩根大通,2023-09-28,8440
6806,森崴能源,698,211,487,摩根大通,2023-09-28,8440
6285,啟��,627,140,487,摩根大通,2023-09-28,8440
6213,聯茂,673,205,468,摩根大通,2023-09-28,8440
1303,南亞,605,141,464,摩根大通,2023-09-28,8440
6282,康舒,480,43,437,摩根大通,2023-09-28,8440
3322,建舜電,505,107,398,摩根大通,2023-09-28,8440
1608,華榮,391,0,391,摩根大通,2023-09-28,8440
1402,遠東新,475,89,386,摩根大通,2023-09-28,8440
3042,晶技,449,64,385,摩根大通,2023-09-28,8440
1603,華電,399,39,360,摩根大通,2023-09-28,8440
2327,國巨,404,74,330,摩根大通,2023-09-28,8440
1471,首利,364,36,328,摩根大通,2023-09-28,8440
3045,台灣大,362,38,324,摩根大通,2023-09-28,8440
2883,凱基金,664,342,322,摩根大通,2023-09-28,8440
2352,佳世達,500,202,298,摩根大通,2023-09-28,8440
4306,炎洲,325,27,298,摩根大通,2023-09-28,8440
5452,佶優,389,119,270,摩根大通,2023-09-28,8440
6139,亞翔,326,68,258,摩根大通,2023-09-28,8440
2367,燿華,261,22,239,摩根大通,2023-09-28,8440
2312,金寶,242,5,237,摩根大通,2023-09-28,8440
2606,裕民,283,74,209,摩根大通,2023-09-28,8440
2748,雲品,211,8,203,摩根大通,2023-09-28,8440
3231,緯創,11134,2147,8987,摩根大通,2023-10-02,8440
2618,長榮航,8320,1911,6409,摩根大通,2023-10-02,8440
2330,台積電,6777,1265,5512,摩根大通,2023-10-02,8440
2303,聯電,5529,1005,4524,摩根大通,2023-10-02,8440
2356,英業達,3601,910,2691,摩根大通,2023-10-02,8440
1815,富喬,2439,122,2317,摩根大通,2023-10-02,8440
2353,宏��,2162,288,1874,摩根大通,2023-10-02,8440
2886,兆豐金,2190,696,1494,摩根大通,2023-10-02,8440
3036,文曄,1823,406,1417,摩根大通,2023-10-02,8440
2486,一詮,1378,152,1226,摩根大通,2023-10-02,8440
5347,世界,1325,122,1203,摩根大通,2023-10-02,8440
2412,中華電,1283,163,1120,摩根大通,2023-10-02,8440
1522,堤維西,1235,152,1083,摩根大通,2023-10-02,8440
2891,中信金,1858,793,1065,摩根大通,2023-10-02,8440
2610,華航,1197,370,827,摩根大通,2023-10-02,8440
1216,統一,895,123,772,摩根大通,2023-10-02,8440
3706,神達,1021,269,752,摩根大通,2023-10-02,8440
2405,輔信,1277,617,660,摩根大通,2023-10-02,8440
2308,台達電,880,237,643,摩根大通,2023-10-02,8440
3325,旭品,898,286,612,摩根大通,2023-10-02,8440
2882,國泰金,707,100,607,摩根大通,2023-10-02,8440
2388,威盛,1060,459,601,摩根大通,2023-10-02,8440
4967,十銓,610,16,594,摩根大通,2023-10-02,8440
6235,華孚,1121,578,543,摩根大通,2023-10-02,8440
1609,大亞,1023,499,524,摩根大通,2023-10-02,8440
8936,國統,549,42,507,摩根大通,2023-10-02,8440
2399,映泰,460,0,460,摩根大通,2023-10-02,8440
1524,耿鼎,558,114,444,摩根大通,2023-10-02,8440
8358,金居,453,18,435,摩根大通,2023-10-02,8440
2355,敬鵬,702,268,434,摩根大通,2023-10-02,8440
3481,群創,728,299,429,摩根大通,2023-10-02,8440
2883,凱基金,599,182,417,摩根大通,2023-10-02,8440
3005,神基,419,2,417,摩根大通,2023-10-02,8440
1603,華電,503,88,415,摩根大通,2023-10-02,8440
3702,大聯大,428,15,413,摩根大通,2023-10-02,8440
2377,微星,504,98,406,摩根大通,2023-10-02,8440
2312,金寶,403,6,397,摩根大通,2023-10-02,8440
2374,佳能,438,44,394,摩根大通,2023-10-02,8440
3037,欣興,2016,1635,381,摩根大通,2023-10-02,8440
3013,晟銘電,504,131,373,摩根大通,2023-10-02,8440
8112,至上,437,71,366,摩根大通,2023-10-02,8440
1612,宏泰,602,238,364,摩根大通,2023-10-02,8440
3006,晶豪科,427,70,357,摩根大通,2023-10-02,8440
6451,訊芯-KY,389,39,350,摩根大通,2023-10-02,8440
1736,喬山,347,8,339,摩根大通,2023-10-02,8440
5225,東科-KY,756,436,320,摩根大通,2023-10-02,8440
2516,新建,332,16,316,摩根大通,2023-10-02,8440
2892,第一金,981,668,313,摩根大通,2023-10-02,8440
2327,國巨,312,10,302,摩根大通,2023-10-02,8440
6274,台燿,1111,811,300,摩根大通,2023-10-02,8440
2303,聯電,4817,769,4048,摩根大通,2023-10-03,8440
3006,晶豪科,2135,92,2043,摩根大通,2023-10-03,8440
3260,威剛,2114,208,1906,摩根大通,2023-10-03,8440
2538,基泰,1884,136,1748,摩根大通,2023-10-03,8440
2353,宏��,2339,795,1544,摩根大通,2023-10-03,8440
2618,長榮航,3303,1803,1500,摩根大通,2023-10-03,8440
2610,華航,2333,894,1439,摩根大通,2023-10-03,8440
2886,兆豐金,2905,1527,1378,摩根大通,2023-10-03,8440
6285,啟��,982,57,925,摩根大通,2023-10-03,8440
8358,金居,1046,178,868,摩根大通,2023-10-03,8440
3545,敦泰,854,7,847,摩根大通,2023-10-03,8440
2337,旺宏,914,72,842,摩根大通,2023-10-03,8440
2408,南亞科,896,187,709,摩根大通,2023-10-03,8440
4967,十銓,1218,580,638,摩根大通,2023-10-03,8440
2436,偉詮電,615,55,560,摩根大通,2023-10-03,8440
1815,富喬,1838,1329,509,摩根大通,2023-10-03,8440
5351,鈺創,548,46,502,摩根大通,2023-10-03,8440
8112,至上,569,95,474,摩根大通,2023-10-03,8440
2327,國巨,530,71,459,摩根大通,2023-10-03,8440
5347,世界,590,146,444,摩根大通,2023-10-03,8440
6187,萬潤,506,113,393,摩根大通,2023-10-03,8440
2486,一詮,498,118,380,摩根大通,2023-10-03,8440
6271,同欣電,383,6,377,摩根大通,2023-10-03,8440
6288,聯嘉,875,508,367,摩根大通,2023-10-03,8440
3034,聯詠,447,82,365,摩根大通,2023-10-03,8440
2412,中華電,604,241,363,摩根大通,2023-10-03,8440
8088,品安,546,192,354,摩根大通,2023-10-03,8440
2324,仁寶,1300,970,330,摩根大通,2023-10-03,8440
2401,凌陽,366,50,316,摩根大通,2023-10-03,8440
6213,聯茂,684,372,312,摩根大通,2023-10-03,8440
2605,新興,584,274,310,摩根大通,2023-10-03,8440
3450,聯鈞,853,544,309,摩根大通,2023-10-03,8440
3363,上詮,378,71,307,摩根大通,2023-10-03,8440
2354,鴻準,429,145,284,摩根大通,2023-10-03,8440
3701,大眾控,286,21,265,摩根大通,2023-10-03,8440
1605,華新,561,313,248,摩根大通,2023-10-03,8440
1216,統一,815,580,235,摩根大通,2023-10-03,8440
3234,光環,281,47,234,摩根大通,2023-10-03,8440
2454,聯發科,775,544,231,摩根大通,2023-10-03,8440
9919,康那香,252,24,228,摩根大通,2023-10-03,8440
3702,大聯大,260,40,220,摩根大通,2023-10-03,8440
3037,欣興,984,766,218,摩根大通,2023-10-03,8440
3630,新鉅科,267,50,217,摩根大通,2023-10-03,8440
3005,神基,254,44,210,摩根大通,2023-10-03,8440
3346,麗清,315,108,207,摩根大通,2023-10-03,8440
1316,上曜,190,2,188,摩根大通,2023-10-03,8440
8210,勤誠,357,170,187,摩根大通,2023-10-03,8440
1603,華電,273,87,186,摩根大通,2023-10-03,8440
3694,海華,179,15,164,摩根大通,2023-10-03,8440
2427,三商電,631,479,152,摩根大通,2023-10-03,8440
2618,長榮航,6256,1626,4630,摩根大通,2023-10-04,8440
2610,華航,4587,388,4199,摩根大通,2023-10-04,8440
2363,矽統,2140,214,1926,摩根大通,2023-10-04,8440
6288,聯嘉,1774,264,1510,摩根大通,2023-10-04,8440
1101,台泥,2319,1476,843,摩根大通,2023-10-04,8440
2357,華碩,951,216,735,摩根大通,2023-10-04,8440
2324,仁寶,1595,934,661,摩根大通,2023-10-04,8440
3036,文曄,792,212,580,摩根大通,2023-10-04,8440
3706,神達,752,178,574,摩根大通,2023-10-04,8440
5347,世界,891,363,528,摩根大通,2023-10-04,8440
3380,明泰,462,32,430,摩根大通,2023-10-04,8440
2405,輔信,664,267,397,摩根大通,2023-10-04,8440
1519,華城,393,26,367,摩根大通,2023-10-04,8440
2376,技嘉,744,379,365,摩根大通,2023-10-04,8440
1524,耿鼎,433,94,339,摩根大通,2023-10-04,8440
2417,圓剛,302,18,284,摩根大通,2023-10-04,8440
2867,三商壽,325,49,276,摩根大通,2023-10-04,8440
2436,偉詮電,304,36,268,摩根大通,2023-10-04,8440
2374,佳能,322,62,260,摩根大通,2023-10-04,8440
8210,勤誠,493,233,260,摩根大通,2023-10-04,8440
3450,聯鈞,386,129,257,摩根大通,2023-10-04,8440
4904,遠傳,534,299,235,摩根大通,2023-10-04,8440
3013,晟銘電,767,534,233,摩根大通,2023-10-04,8440
2449,京元電子,264,34,230,摩根大通,2023-10-04,8440
2486,一詮,693,468,225,摩根大通,2023-10-04,8440
1319,東陽,259,39,220,摩根大通,2023-10-04,8440
2327,國巨,320,114,206,摩根大通,2023-10-04,8440
2332,友訊,239,42,197,摩根大通,2023-10-04,8440
2603,長榮,412,231,181,摩根大通,2023-10-04,8440
3017,奇鋐,452,276,176,摩根大通,2023-10-04,8440
2455,全新,189,19,170,摩根大通,2023-10-04,8440
2356,英業達,1136,967,169,摩根大通,2023-10-04,8440
3665,貿聯-KY,173,6,167,摩根大通,2023-10-04,8440
4961,天鈺,201,35,166,摩根大通,2023-10-04,8440
6188,廣明,200,35,165,摩根大通,2023-10-04,8440
5871,中租-KY,388,233,155,摩根大通,2023-10-04,8440
6274,台燿,778,625,153,摩根大通,2023-10-04,8440
3078,僑威,147,0,147,摩根大通,2023-10-04,8440
1471,首利,188,42,146,摩根大通,2023-10-04,8440
6120,達運,176,32,144,摩根大通,2023-10-04,8440
8926,台汽電,151,7,144,摩根大通,2023-10-04,8440
4979,華星光,168,31,137,摩根大通,2023-10-04,8440
2485,兆赫,136,1,135,摩根大通,2023-10-04,8440
6491,晶碩,136,1,135,摩根大通,2023-10-04,8440
6244,茂迪,150,20,130,摩根大通,2023-10-04,8440
1808,潤隆,142,14,128,摩根大通,2023-10-04,8440
2809,京城銀,217,91,126,摩根大通,2023-10-04,8440
5269,祥碩,190,70,120,摩根大通,2023-10-04,8440
3324,雙鴻,176,60,116,摩根大通,2023-10-04,8440
8213,志超,129,13,116,摩根大通,2023-10-04,8440
2618,長榮航,8666,1785,6881,摩根大通,2023-10-05,8440
2891,中信金,7664,2097,5567,摩根大通,2023-10-05,8440
2324,仁寶,5328,640,4688,摩根大通,2023-10-05,8440
2610,華航,4328,1587,2741,摩根大通,2023-10-05,8440
2344,華邦電,2529,294,2235,摩根大通,2023-10-05,8440
2363,矽統,2449,303,2146,摩根大通,2023-10-05,8440
2002,中鋼,3405,1612,1793,摩根大通,2023-10-05,8440
2303,聯電,4457,2976,1481,摩根大通,2023-10-05,8440
2353,宏��,1735,443,1292,摩根大通,2023-10-05,8440
9105,泰金寶-DR,1236,0,1236,摩根大通,2023-10-05,8440
2603,長榮,1304,110,1194,摩根大通,2023-10-05,8440
5347,世界,1346,158,1188,摩根大通,2023-10-05,8440
1605,華新,1624,463,1161,摩根大通,2023-10-05,8440
2357,華碩,1233,177,1056,摩根大通,2023-10-05,8440
2371,大同,1115,75,1040,摩根大通,2023-10-05,8440
2317,鴻海,2173,1236,937,摩根大通,2023-10-05,8440
6285,啟��,824,104,720,摩根大通,2023-10-05,8440
2498,宏達電,790,91,699,摩根大通,2023-10-05,8440
2886,兆豐金,1987,1291,696,摩根大通,2023-10-05,8440
2340,台亞,674,12,662,摩根大通,2023-10-05,8440
2884,玉山金,2725,2079,646,摩根大通,2023-10-05,8440
2609,陽明,849,216,633,摩根大通,2023-10-05,8440
2105,正新,756,163,593,摩根大通,2023-10-05,8440
3035,智原,570,43,527,摩根大通,2023-10-05,8440
6451,訊芯-KY,983,528,455,摩根大通,2023-10-05,8440
6244,茂迪,539,101,438,摩根大通,2023-10-05,8440
3531,先益,468,48,420,摩根大通,2023-10-05,8440
2337,旺宏,438,64,374,摩根大通,2023-10-05,8440
2892,第一金,1515,1174,341,摩根大通,2023-10-05,8440
4977,眾達-KY,343,4,339,摩根大通,2023-10-05,8440
5392,能率,346,15,331,摩根大通,2023-10-05,8440
2881,富邦金,1395,1074,321,摩根大通,2023-10-05,8440
2327,國巨,341,32,309,摩根大通,2023-10-05,8440
5512,力麒,328,25,303,摩根大通,2023-10-05,8440
1301,台塑,583,298,285,摩根大通,2023-10-05,8440
2401,凌陽,337,54,283,摩根大通,2023-10-05,8440
3711,日月光投控,1046,766,280,摩根大通,2023-10-05,8440
2014,中鴻,271,0,271,摩根大通,2023-10-05,8440
4938,和碩,794,528,266,摩根大通,2023-10-05,8440
3034,聯詠,349,84,265,摩根大通,2023-10-05,8440
3702,大聯大,411,148,263,摩根大通,2023-10-05,8440
3406,玉晶光,260,13,247,摩根大通,2023-10-05,8440
5258,虹堡,270,27,243,摩根大通,2023-10-05,8440
2436,偉詮電,256,24,232,摩根大通,2023-10-05,8440
2458,義隆,300,70,230,摩根大通,2023-10-05,8440
2615,萬海,297,74,223,摩根大通,2023-10-05,8440
3346,麗清,250,35,215,摩根大通,2023-10-05,8440
1319,東陽,424,224,200,摩根大通,2023-10-05,8440
2486,一詮,1559,1365,194,摩根大通,2023-10-05,8440
2455,全新,324,131,193,摩根大通,2023-10-05,8440
2891,中信金,6215,464,5751,摩根大通,2023-10-06,8440
1605,華新,3710,76,3634,摩根大通,2023-10-06,8440
2324,仁寶,4062,680,3382,摩根大通,2023-10-06,8440
3013,晟銘電,3648,1061,2587,摩根大通,2023-10-06,8440
3715,定穎投控,3641,1174,2467,摩根大通,2023-10-06,8440
2363,矽統,5142,3732,1410,摩根大通,2023-10-06,8440
2303,聯電,1408,118,1290,摩根大通,2023-10-06,8440
1101,台泥,1760,524,1236,摩根大通,2023-10-06,8440
1519,華城,1664,462,1202,摩根大通,2023-10-06,8440
2330,台積電,2790,1678,1112,摩根大通,2023-10-06,8440
2344,華邦電,1140,131,1009,摩根大通,2023-10-06,8440
2105,正新,1091,104,987,摩根大通,2023-10-06,8440
5876,上海商銀,1167,199,968,摩根大通,2023-10-06,8440
2382,廣達,2497,1542,955,摩根大通,2023-10-06,8440
1524,耿鼎,1050,165,885,摩根大通,2023-10-06,8440
2605,新興,1082,211,871,摩根大通,2023-10-06,8440
3006,晶豪科,875,141,734,摩根大通,2023-10-06,8440
2637,慧洋-KY,733,20,713,摩根大通,2023-10-06,8440
1316,上曜,710,12,698,摩根大通,2023-10-06,8440
2405,輔信,751,54,697,摩根大通,2023-10-06,8440
5347,世界,761,64,697,摩根大通,2023-10-06,8440
2886,兆豐金,930,244,686,摩根大通,2023-10-06,8440
9904,寶成,710,26,684,摩根大通,2023-10-06,8440
9802,鈺齊-KY,852,185,667,摩根大通,2023-10-06,8440
9950,萬國通,847,192,655,摩根大通,2023-10-06,8440
2618,長榮航,4049,3412,637,摩根大通,2023-10-06,8440
2399,映泰,668,168,500,摩根大通,2023-10-06,8440
2352,佳世達,514,27,487,摩根大通,2023-10-06,8440
2606,裕民,514,52,462,摩根大通,2023-10-06,8440
2313,華通,491,45,446,摩根大通,2023-10-06,8440
2455,全新,560,128,432,摩根大通,2023-10-06,8440
2454,聯發科,636,210,426,摩根大通,2023-10-06,8440
1907,永豐餘,453,30,423,摩根大通,2023-10-06,8440
1102,亞泥,520,103,417,摩根大通,2023-10-06,8440
2327,國巨,421,14,407,摩根大通,2023-10-06,8440
6547,高端疫苗,408,12,396,摩根大通,2023-10-06,8440
2002,中鋼,629,261,368,摩根大通,2023-10-06,8440
2331,精英,498,143,355,摩根大通,2023-10-06,8440
2603,長榮,793,439,354,摩根大通,2023-10-06,8440
6271,同欣電,376,33,343,摩根大通,2023-10-06,8440
2867,三商壽,331,0,331,摩根大通,2023-10-06,8440
1722,台肥,332,5,327,摩根大通,2023-10-06,8440
2401,凌陽,321,4,317,摩根大通,2023-10-06,8440
6684,安格,565,252,313,摩根大通,2023-10-06,8440
2884,玉山金,841,529,312,摩根大通,2023-10-06,8440
4904,遠傳,552,244,308,摩根大通,2023-10-06,8440
2601,益航,321,15,306,摩根大通,2023-10-06,8440
5439,高技,419,116,303,摩根大通,2023-10-06,8440
6288,聯嘉,338,49,289,摩根大通,2023-10-06,8440
2427,三商電,546,263,283,摩根大通,2023-10-06,8440
2303,聯電,10910,1216,9694,摩根大通,2023-10-11,8440
2330,台積電,12876,6640,6236,摩根大通,2023-10-11,8440
2344,華邦電,7489,1523,5966,摩根大通,2023-10-11,8440
2363,矽統,6643,943,5700,摩根大通,2023-10-11,8440
2885,元大金,5802,1271,4531,摩根大通,2023-10-11,8440
2891,中信金,5880,2308,3572,摩根大通,2023-10-11,8440
2317,鴻海,4710,1599,3111,摩根大通,2023-10-11,8440
2888,新光金,3743,638,3105,摩根大通,2023-10-11,8440
2105,正新,3269,282,2987,摩根大通,2023-10-11,8440
2324,仁寶,5085,2129,2956,摩根大通,2023-10-11,8440
2883,凱基金,3632,1036,2596,摩根大通,2023-10-11,8440
2352,佳世達,2787,502,2285,摩根大通,2023-10-11,8440
2882,國泰金,3490,1324,2166,摩根大通,2023-10-11,8440
2890,永豐金,3288,1191,2097,摩根大通,2023-10-11,8440
3037,欣興,2431,536,1895,摩根大通,2023-10-11,8440
3045,台灣大,2083,349,1734,摩根大通,2023-10-11,8440
1102,亞泥,2104,458,1646,摩根大通,2023-10-11,8440
2801,彰銀,1753,108,1645,摩根大通,2023-10-11,8440
1605,華新,1792,182,1610,摩根大通,2023-10-11,8440
2607,榮運,1550,47,1503,摩根大通,2023-10-11,8440
5876,上海商銀,2325,946,1379,摩根大通,2023-10-11,8440
4904,遠傳,1879,574,1305,摩根大通,2023-10-11,8440
9904,寶成,3129,1845,1284,摩根大通,2023-10-11,8440
4906,正文,1486,254,1232,摩根大通,2023-10-11,8440
2834,臺企銀,1156,67,1089,摩根大通,2023-10-11,8440
1216,統一,2822,1894,928,摩根大通,2023-10-11,8440
2312,金寶,1562,666,896,摩根大通,2023-10-11,8440
3576,聯合再生,1007,154,853,摩根大通,2023-10-11,8440
2354,鴻準,852,5,847,摩根大通,2023-10-11,8440
3044,健鼎,888,62,826,摩根大通,2023-10-11,8440
2897,王道銀行,834,54,780,摩根大通,2023-10-11,8440
2329,華泰,934,172,762,摩根大通,2023-10-11,8440
1326,台化,1073,337,736,摩根大通,2023-10-11,8440
1303,南亞,1564,849,715,摩根大通,2023-10-11,8440
2615,萬海,819,161,658,摩根大通,2023-10-11,8440
2301,光寶科,2871,2239,632,摩根大通,2023-10-11,8440
3036,文曄,1009,378,631,摩根大通,2023-10-11,8440
1712,興農,649,25,624,摩根大通,2023-10-11,8440
4306,炎洲,620,8,612,摩根大通,2023-10-11,8440
2368,金像電,703,107,596,摩根大通,2023-10-11,8440
5469,瀚宇博,669,117,552,摩根大通,2023-10-11,8440
2382,廣達,2962,2411,551,摩根大通,2023-10-11,8440
6147,頎邦,553,8,545,摩根大通,2023-10-11,8440
2881,富邦金,2344,1802,542,摩根大通,2023-10-11,8440
2439,美律,561,20,541,摩根大通,2023-10-11,8440
2903,遠百,609,70,539,摩根大通,2023-10-11,8440
6176,瑞儀,590,70,520,摩根大通,2023-10-11,8440
6274,台燿,660,152,508,摩根大通,2023-10-11,8440
6139,亞翔,783,307,476,摩根大通,2023-10-11,8440
3034,聯詠,506,34,472,摩根大通,2023-10-11,8440
2330,台積電,5867,1513,4354,摩根大通,2023-10-12,8440
1101,台泥,4513,411,4102,摩根大通,2023-10-12,8440
2891,中信金,6078,2066,4012,摩根大通,2023-10-12,8440
2618,長榮航,3867,916,2951,摩根大通,2023-10-12,8440
5347,世界,3218,298,2920,摩根大通,2023-10-12,8440
3711,日月光投控,3367,504,2863,摩根大通,2023-10-12,8440
2201,裕隆,2641,69,2572,摩根大通,2023-10-12,8440
2888,新光金,2554,196,2358,摩根大通,2023-10-12,8440
2344,華邦電,4609,2438,2171,摩根大通,2023-10-12,8440
9904,寶成,2358,530,1828,摩根大通,2023-10-12,8440
2303,聯電,2810,1107,1703,摩根大通,2023-10-12,8440
1402,遠東新,1548,63,1485,摩根大通,2023-10-12,8440
2329,華泰,1832,473,1359,摩根大通,2023-10-12,8440
1102,亞泥,1577,231,1346,摩根大通,2023-10-12,8440
1314,中石化,1224,58,1166,摩根大通,2023-10-12,8440
2882,國泰金,1679,522,1157,摩根大通,2023-10-12,8440
3715,定穎投控,1384,229,1155,摩根大通,2023-10-12,8440
1605,華新,1572,434,1138,摩根大通,2023-10-12,8440
2886,兆豐金,1801,731,1070,摩根大通,2023-10-12,8440
2881,富邦金,1033,52,981,摩根大通,2023-10-12,8440
2883,凱基金,2379,1430,949,摩根大通,2023-10-12,8440
2204,中華,1005,66,939,摩根大通,2023-10-12,8440
2105,正新,1164,231,933,摩根大通,2023-10-12,8440
2301,光寶科,1131,282,849,摩根大通,2023-10-12,8440
2313,華通,861,158,703,摩根大通,2023-10-12,8440
2454,聯發科,932,234,698,摩根大通,2023-10-12,8440
2492,華新科,705,29,676,摩根大通,2023-10-12,8440
2801,彰銀,829,166,663,摩根大通,2023-10-12,8440
3035,智原,1107,448,659,摩根大通,2023-10-12,8440
3346,麗清,656,13,643,摩根大通,2023-10-12,8440
3045,台灣大,910,301,609,摩根大通,2023-10-12,8440
3231,緯創,2182,1618,564,摩根大通,2023-10-12,8440
6770,力積電,589,32,557,摩根大通,2023-10-12,8440
2885,元大金,989,438,551,摩根大通,2023-10-12,8440
5351,鈺創,560,10,550,摩根大通,2023-10-12,8440
3025,星通,663,115,548,摩根大通,2023-10-12,8440
2399,映泰,689,152,537,摩根大通,2023-10-12,8440
1722,台肥,545,19,526,摩根大通,2023-10-12,8440
3078,僑威,747,244,503,摩根大通,2023-10-12,8440
1785,光洋科,500,15,485,摩根大通,2023-10-12,8440
1301,台塑,558,78,480,摩根大通,2023-10-12,8440
1524,耿鼎,604,125,479,摩根大通,2023-10-12,8440
2354,鴻準,628,152,476,摩根大通,2023-10-12,8440
3702,大聯大,547,101,446,摩根大通,2023-10-12,8440
2425,承啟,478,34,444,摩根大通,2023-10-12,8440
5258,虹堡,469,27,442,摩根大通,2023-10-12,8440
8996,高力,611,181,430,摩根大通,2023-10-12,8440
2401,凌陽,521,97,424,摩根大通,2023-10-12,8440
2449,京元電子,679,261,418,摩根大通,2023-10-12,8440
1603,華電,744,328,416,摩根大通,2023-10-12,8440
2303,聯電,6475,94,6381,摩根大通,2023-10-13,8440
1314,中石化,4752,555,4197,摩根大通,2023-10-13,8440
5347,世界,3960,181,3779,摩根大通,2023-10-13,8440
2330,台積電,3820,728,3092,摩根大通,2023-10-13,8440
1101,台泥,2331,56,2275,摩根大通,2023-10-13,8440
2301,光寶科,4577,2503,2074,摩根大通,2023-10-13,8440
2201,裕隆,2727,735,1992,摩根大通,2023-10-13,8440
2603,長榮,1758,28,1730,摩根大通,2023-10-13,8440
2324,仁寶,2383,942,1441,摩根大通,2023-10-13,8440
2313,華通,1778,349,1429,摩根大通,2023-10-13,8440
2607,榮運,1449,80,1369,摩根大通,2023-10-13,8440
1402,遠東新,1426,145,1281,摩根大通,2023-10-13,8440
2317,鴻海,1413,455,958,摩根大通,2023-10-13,8440
2368,金像電,1183,236,947,摩根大通,2023-10-13,8440
3036,文曄,851,73,778,摩根大通,2023-10-13,8440
2454,聯發科,1130,368,762,摩根大通,2023-10-13,8440
6104,創惟,812,81,731,摩根大通,2023-10-13,8440
2105,正新,693,7,686,摩根大通,2023-10-13,8440
3045,台灣大,905,250,655,摩根大通,2023-10-13,8440
1605,華新,759,153,606,摩根大通,2023-10-13,8440
6257,矽格,666,82,584,摩根大通,2023-10-13,8440
2385,群光,597,17,580,摩根大通,2023-10-13,8440
6182,合晶,524,4,520,摩根大通,2023-10-13,8440
2885,元大金,700,188,512,摩根大通,2023-10-13,8440
2609,陽明,658,207,451,摩根大通,2023-10-13,8440
2360,致茂,559,127,432,摩根大通,2023-10-13,8440
3711,日月光投控,733,334,399,摩根大通,2023-10-13,8440
6770,力積電,364,5,359,摩根大通,2023-10-13,8440
3042,晶技,345,1,344,摩根大通,2023-10-13,8440
2347,聯強,432,91,341,摩根大通,2023-10-13,8440
2542,興富發,417,78,339,摩根大通,2023-10-13,8440
2897,王道銀行,340,2,338,摩根大通,2023-10-13,8440
4960,誠美材,327,0,327,摩根大通,2023-10-13,8440
6285,啟��,370,48,322,摩根大通,2023-10-13,8440
1718,中纖,311,4,307,摩根大通,2023-10-13,8440
1102,亞泥,389,84,305,摩根大通,2023-10-13,8440
8299,群聯,349,63,286,摩根大通,2023-10-13,8440
9950,萬國通,578,301,277,摩根大通,2023-10-13,8440
2458,義隆,338,67,271,摩根大通,2023-10-13,8440
2427,三商電,542,279,263,摩根大通,2023-10-13,8440
4167,松瑞藥,260,0,260,摩根大通,2023-10-13,8440
3005,神基,348,107,241,摩根大通,2023-10-13,8440
4552,力達-KY,290,60,230,摩根大通,2023-10-13,8440
1785,光洋科,237,15,222,摩根大通,2023-10-13,8440
3265,台星科,240,19,221,摩根大通,2023-10-13,8440
1712,興農,218,0,218,摩根大通,2023-10-13,8440
6239,力成,225,10,215,摩根大通,2023-10-13,8440
1722,台肥,219,4,215,摩根大通,2023-10-13,8440
8150,南茂,213,0,213,摩根大通,2023-10-13,8440
2405,輔信,282,70,212,摩根大通,2023-10-13,8440
2303,聯電,4854,1128,3726,摩根大通,2023-10-16,8440
2883,凱基金,2147,218,1929,摩根大通,2023-10-16,8440
3481,群創,2034,280,1754,摩根大通,2023-10-16,8440
2317,鴻海,1856,557,1299,摩根大通,2023-10-16,8440
2313,華通,1451,228,1223,摩根大通,2023-10-16,8440
2105,正新,2145,971,1174,摩根大通,2023-10-16,8440
2886,兆豐金,1862,765,1097,摩根大通,2023-10-16,8440
6244,茂迪,1323,277,1046,摩根大通,2023-10-16,8440
2301,光寶科,1538,635,903,摩根大通,2023-10-16,8440
1718,中纖,813,0,813,摩根大通,2023-10-16,8440
2308,台達電,859,116,743,摩根大通,2023-10-16,8440
3078,僑威,805,140,665,摩根大通,2023-10-16,8440
3044,健鼎,1047,382,665,摩根大通,2023-10-16,8440
2454,聯發科,1069,425,644,摩根大通,2023-10-16,8440
6770,力積電,1049,418,631,摩根大通,2023-10-16,8440
2845,遠東銀,656,66,590,摩根大通,2023-10-16,8440
2603,長榮,725,140,585,摩根大通,2023-10-16,8440
5483,中美晶,545,0,545,摩根大通,2023-10-16,8440
2449,京元電子,750,210,540,摩根大通,2023-10-16,8440
9933,中鼎,529,6,523,摩根大通,2023-10-16,8440
6285,啟��,649,164,485,摩根大通,2023-10-16,8440
3105,穩懋,539,81,458,摩根大通,2023-10-16,8440
4960,誠美材,713,274,439,摩根大通,2023-10-16,8440
6191,精成科,452,26,426,摩根大通,2023-10-16,8440
3006,晶豪科,578,173,405,摩根大通,2023-10-16,8440
2543,皇昌,464,64,400,摩根大通,2023-10-16,8440
1314,中石化,2527,2130,397,摩根大通,2023-10-16,8440
5009,榮剛,635,241,394,摩根大通,2023-10-16,8440
2801,彰銀,523,142,381,摩根大通,2023-10-16,8440
3037,欣興,479,107,372,摩根大通,2023-10-16,8440
3450,聯鈞,398,27,371,摩根大通,2023-10-16,8440
3703,欣陸,363,4,359,摩根大通,2023-10-16,8440
8046,南電,369,25,344,摩根大通,2023-10-16,8440
1402,遠東新,736,392,344,摩根大通,2023-10-16,8440
1785,光洋科,593,254,339,摩根大通,2023-10-16,8440
1522,堤維西,389,54,335,摩根大通,2023-10-16,8440
1409,新纖,320,0,320,摩根大通,2023-10-16,8440
3036,文曄,629,312,317,摩根大通,2023-10-16,8440
3702,大聯大,466,157,309,摩根大通,2023-10-16,8440
2014,中鴻,324,19,305,摩根大通,2023-10-16,8440
4979,華星光,576,272,304,摩根大通,2023-10-16,8440
1304,台聚,343,46,297,摩根大通,2023-10-16,8440
6188,廣明,345,50,295,摩根大通,2023-10-16,8440
1477,聚陽,308,25,283,摩根大通,2023-10-16,8440
2388,威盛,1263,981,282,摩根大通,2023-10-16,8440
2542,興富發,815,534,281,摩根大通,2023-10-16,8440
2331,精英,345,67,278,摩根大通,2023-10-16,8440
6125,廣運,354,77,277,摩根大通,2023-10-16,8440
1722,台肥,274,0,274,摩根大通,2023-10-16,8440
8996,高力,279,18,261,摩根大通,2023-10-16,8440
2303,聯電,23067,1562,21505,摩根大通,2023-10-17,8440
2301,光寶科,4275,502,3773,摩根大通,2023-10-17,8440
2313,華通,3969,444,3525,摩根大通,2023-10-17,8440
2363,矽統,5494,3265,2229,摩根大通,2023-10-17,8440
3035,智原,2301,584,1717,摩根大通,2023-10-17,8440
3260,威剛,1670,183,1487,摩根大通,2023-10-17,8440
4960,誠美材,1244,230,1014,摩根大通,2023-10-17,8440
2890,永豐金,2028,1215,813,摩根大通,2023-10-17,8440
2330,台積電,1765,964,801,摩根大通,2023-10-17,8440
1605,華新,1052,331,721,摩根大通,2023-10-17,8440
3545,敦泰,732,15,717,摩根大通,2023-10-17,8440
3715,定穎投控,2125,1433,692,摩根大通,2023-10-17,8440
2457,飛宏,729,70,659,摩根大通,2023-10-17,8440
2409,友達,735,107,628,摩根大通,2023-10-17,8440
2344,華邦電,709,135,574,摩根大通,2023-10-17,8440
8299,群聯,689,149,540,摩根大通,2023-10-17,8440
2610,華航,855,352,503,摩根大通,2023-10-17,8440
2881,富邦金,516,69,447,摩根大通,2023-10-17,8440
2331,精英,510,66,444,摩根大通,2023-10-17,8440
2345,智邦,491,48,443,摩根大通,2023-10-17,8440
2340,台亞,520,96,424,摩根大通,2023-10-17,8440
2329,華泰,497,149,348,摩根大通,2023-10-17,8440
2634,漢翔,383,49,334,摩根大通,2023-10-17,8440
2603,長榮,486,162,324,摩根大通,2023-10-17,8440
2105,正新,607,296,311,摩根大通,2023-10-17,8440
2327,國巨,420,112,308,摩根大通,2023-10-17,8440
8046,南電,368,67,301,摩根大通,2023-10-17,8440
2605,新興,299,0,299,摩根大通,2023-10-17,8440
1785,光洋科,311,13,298,摩根大通,2023-10-17,8440
5347,世界,303,7,296,摩根大通,2023-10-17,8440
6531,愛普*,326,59,267,摩根大通,2023-10-17,8440
2809,京城銀,258,0,258,摩根大通,2023-10-17,8440
3680,家登,268,13,255,摩根大通,2023-10-17,8440
3105,穩懋,268,23,245,摩根大通,2023-10-17,8440
1326,台化,368,126,242,摩根大通,2023-10-17,8440
2458,義隆,494,255,239,摩根大通,2023-10-17,8440
6191,精成科,286,54,232,摩根大通,2023-10-17,8440
5210,寶碩,261,30,231,摩根大通,2023-10-17,8440
4908,前鼎,826,603,223,摩根大通,2023-10-17,8440
1218,泰山,210,0,210,摩根大通,2023-10-17,8440
3234,光環,420,224,196,摩根大通,2023-10-17,8440
2455,全新,205,11,194,摩根大通,2023-10-17,8440
2401,凌陽,299,108,191,摩根大通,2023-10-17,8440
9105,泰金寶-DR,190,0,190,摩根大通,2023-10-17,8440
3653,健策,204,15,189,摩根大通,2023-10-17,8440
2374,佳能,230,44,186,摩根大通,2023-10-17,8440
6533,晶心科,233,54,179,摩根大通,2023-10-17,8440
1301,台塑,380,202,178,摩根大通,2023-10-17,8440
1603,華電,297,120,177,摩根大通,2023-10-17,8440
2748,雲品,187,11,176,摩根大通,2023-10-17,8440
3231,緯創,11010,2583,8427,摩根大通,2023-10-18,8440
2303,聯電,11836,4975,6861,摩根大通,2023-10-18,8440
2356,英業達,4235,1061,3174,摩根大通,2023-10-18,8440
3481,群創,3419,246,3173,摩根大通,2023-10-18,8440
9904,寶成,2675,188,2487,摩根大通,2023-10-18,8440
2353,宏��,3658,1564,2094,摩根大通,2023-10-18,8440
3037,欣興,2761,753,2008,摩根大通,2023-10-18,8440
2891,中信金,1804,31,1773,摩根大通,2023-10-18,8440
2610,華航,1857,321,1536,摩根大通,2023-10-18,8440
2014,中鴻,1994,528,1466,摩根大通,2023-10-18,8440
2301,光寶科,2109,725,1384,摩根大通,2023-10-18,8440
2542,興富發,1452,121,1331,摩根大通,2023-10-18,8440
2409,友達,1369,265,1104,摩根大通,2023-10-18,8440
1304,台聚,1246,209,1037,摩根大通,2023-10-18,8440
2883,凱基金,1777,800,977,摩根大通,2023-10-18,8440
2363,矽統,952,1,951,摩根大通,2023-10-18,8440
2376,技嘉,1771,901,870,摩根大通,2023-10-18,8440
2609,陽明,2002,1192,810,摩根大通,2023-10-18,8440
2618,長榮航,1673,895,778,摩根大通,2023-10-18,8440
2313,華通,863,93,770,摩根大通,2023-10-18,8440
2382,廣達,4128,3387,741,摩根大通,2023-10-18,8440
6213,聯茂,1667,971,696,摩根大通,2023-10-18,8440
2885,元大金,1775,1129,646,摩根大通,2023-10-18,8440
2324,仁寶,856,218,638,摩根大通,2023-10-18,8440
3044,健鼎,916,284,632,摩根大通,2023-10-18,8440
2105,正新,847,238,609,摩根大通,2023-10-18,8440
2421,建準,1045,447,598,摩根大通,2023-10-18,8440
3048,益登,703,111,592,摩根大通,2023-10-18,8440
3013,晟銘電,807,218,589,摩根大通,2023-10-18,8440
1326,台化,654,68,586,摩根大通,2023-10-18,8440
2892,第一金,822,250,572,摩根大通,2023-10-18,8440
6274,台燿,954,433,521,摩根大通,2023-10-18,8440
1101,台泥,12122,11606,516,摩根大通,2023-10-18,8440
1301,台塑,573,99,474,摩根大通,2023-10-18,8440
1303,南亞,489,29,460,摩根大通,2023-10-18,8440
2809,京城銀,475,16,459,摩根大通,2023-10-18,8440
2010,春源,501,48,453,摩根大通,2023-10-18,8440
1440,南紡,467,49,418,摩根大通,2023-10-18,8440
3693,營邦,496,109,387,摩根大通,2023-10-18,8440
1815,富喬,461,90,371,摩根大通,2023-10-18,8440
6188,廣明,445,75,370,摩根大通,2023-10-18,8440
2327,國巨,412,60,352,摩根大通,2023-10-18,8440
6125,廣運,518,168,350,摩根大通,2023-10-18,8440
1904,正隆,365,47,318,摩根大通,2023-10-18,8440
9958,世紀鋼,443,134,309,摩根大通,2023-10-18,8440
2006,東和鋼鐵,374,67,307,摩根大通,2023-10-18,8440
2103,台橡,385,83,302,摩根大通,2023-10-18,8440
2855,統一證,412,117,295,摩根大通,2023-10-18,8440
1305,華夏,368,81,287,摩根大通,2023-10-18,8440
2332,友訊,344,57,287,摩根大通,2023-10-18,8440
3711,日月光投控,4620,246,4374,摩根大通,2023-10-19,8440
2344,華邦電,3083,352,2731,摩根大通,2023-10-19,8440
2303,聯電,5084,2846,2238,摩根大通,2023-10-19,8440
2324,仁寶,2854,867,1987,摩根大通,2023-10-19,8440
9904,寶成,1684,113,1571,摩根大通,2023-10-19,8440
3260,威剛,1846,376,1470,摩根大通,2023-10-19,8440
2605,新興,1363,294,1069,摩根大通,2023-10-19,8440
2377,微星,1119,114,1005,摩根大通,2023-10-19,8440
2887,台新金,1463,523,940,摩根大通,2023-10-19,8440
2606,裕民,955,131,824,摩根大通,2023-10-19,8440
2105,正新,793,56,737,摩根大通,2023-10-19,8440
2618,長榮航,1153,420,733,摩根大通,2023-10-19,8440
2363,矽統,753,87,666,摩根大通,2023-10-19,8440
2615,萬海,636,23,613,摩根大通,2023-10-19,8440
3704,合勤控,1096,554,542,摩根大通,2023-10-19,8440
2312,金寶,551,21,530,摩根大通,2023-10-19,8440
1301,台塑,552,50,502,摩根大通,2023-10-19,8440
4915,致伸,516,39,477,摩根大通,2023-10-19,8440
2356,英業達,1814,1356,458,摩根大通,2023-10-19,8440
2436,偉詮電,725,268,457,摩根大通,2023-10-19,8440
3094,聯傑,546,111,435,摩根大通,2023-10-19,8440
2401,凌陽,492,73,419,摩根大通,2023-10-19,8440
2323,中環,552,157,395,摩根大通,2023-10-19,8440
1605,華新,947,553,394,摩根大通,2023-10-19,8440
3034,聯詠,372,19,353,摩根大通,2023-10-19,8440
2607,榮運,414,61,353,摩根大通,2023-10-19,8440
2542,興富發,543,191,352,摩根大通,2023-10-19,8440
6120,達運,384,33,351,摩根大通,2023-10-19,8440
2449,京元電子,959,612,347,摩根大通,2023-10-19,8440
2637,慧洋-KY,435,90,345,摩根大通,2023-10-19,8440
4904,遠傳,426,81,345,摩根大通,2023-10-19,8440
4967,十銓,721,379,342,摩根大通,2023-10-19,8440
2308,台達電,493,173,320,摩根大通,2023-10-19,8440
6116,彩晶,2504,2209,295,摩根大通,2023-10-19,8440
5521,工信,318,41,277,摩根大通,2023-10-19,8440
9950,萬國通,417,142,275,摩根大通,2023-10-19,8440
4743,合一,352,87,265,摩根大通,2023-10-19,8440
1785,光洋科,271,7,264,摩根大通,2023-10-19,8440
6168,宏齊,284,29,255,摩根大通,2023-10-19,8440
3545,敦泰,420,210,210,摩根大通,2023-10-19,8440
6158,禾昌,308,98,210,摩根大通,2023-10-19,8440
2633,台灣高鐵,244,42,202,摩根大通,2023-10-19,8440
2327,國巨,354,154,200,摩根大通,2023-10-19,8440
1909,榮成,205,7,198,摩根大通,2023-10-19,8440
2855,統一證,211,22,189,摩根大通,2023-10-19,8440
3588,通嘉,224,35,189,摩根大通,2023-10-19,8440
1477,聚陽,195,8,187,摩根大通,2023-10-19,8440
3653,健策,185,2,183,摩根大通,2023-10-19,8440
3617,碩天,222,42,180,摩根大通,2023-10-19,8440
5381,合正,221,46,175,摩根大通,2023-10-19,8440
6274,台燿,1763,428,1335,摩根大通,2023-10-20,8440
2515,中工,1281,102,1179,摩根大通,2023-10-20,8440
2352,佳世達,1240,351,889,摩根大通,2023-10-20,8440
1513,中興電,834,60,774,摩根大通,2023-10-20,8440
6213,聯茂,822,86,736,摩根大通,2023-10-20,8440
2454,聯發科,1171,464,707,摩根大通,2023-10-20,8440
1568,倉佑,701,151,550,摩根大通,2023-10-20,8440
2457,飛宏,438,22,416,摩根大通,2023-10-20,8440
1319,東陽,494,93,401,摩根大通,2023-10-20,8440
1447,力鵬,400,1,399,摩根大通,2023-10-20,8440
2492,華新科,418,22,396,摩根大通,2023-10-20,8440
2618,長榮航,886,493,393,摩根大通,2023-10-20,8440
2610,華航,777,398,379,摩根大通,2023-10-20,8440
3041,揚智,541,174,367,摩根大通,2023-10-20,8440
6120,達運,371,12,359,摩根大通,2023-10-20,8440
1219,福壽,316,9,307,摩根大通,2023-10-20,8440
2388,威盛,711,413,298,摩根大通,2023-10-20,8440
2371,大同,725,434,291,摩根大通,2023-10-20,8440
8068,全達,283,2,281,摩根大通,2023-10-20,8440
2883,凱基金,2000,1721,279,摩根大通,2023-10-20,8440
6290,良維,440,164,276,摩根大通,2023-10-20,8440
9919,康那香,265,19,246,摩根大通,2023-10-20,8440
2369,菱生,634,392,242,摩根大通,2023-10-20,8440
2401,凌陽,361,124,237,摩根大通,2023-10-20,8440
2538,基泰,269,47,222,摩根大通,2023-10-20,8440
6125,廣運,278,59,219,摩根大通,2023-10-20,8440
3380,明泰,205,3,202,摩根大通,2023-10-20,8440
2498,宏達電,271,69,202,摩根大通,2023-10-20,8440
3450,聯鈞,300,100,200,摩根大通,2023-10-20,8440
3044,健鼎,306,108,198,摩根大通,2023-10-20,8440
6438,迅得,227,29,198,摩根大通,2023-10-20,8440
2367,燿華,210,28,182,摩根大通,2023-10-20,8440
3481,群創,1658,1494,164,摩根大通,2023-10-20,8440
2455,全新,176,12,164,摩根大通,2023-10-20,8440
3324,雙鴻,250,95,155,摩根大通,2023-10-20,8440
3693,營邦,258,109,149,摩根大通,2023-10-20,8440
2867,三商壽,160,13,147,摩根大通,2023-10-20,8440
2305,全友,184,46,138,摩根大通,2023-10-20,8440
3051,力特,359,224,135,摩根大通,2023-10-20,8440
2363,矽統,1060,926,134,摩根大通,2023-10-20,8440
1522,堤維西,168,36,132,摩根大通,2023-10-20,8440
2441,超豐,141,9,132,摩根大通,2023-10-20,8440
4532,瑞智,143,12,131,摩根大通,2023-10-20,8440
1218,泰山,152,21,131,摩根大通,2023-10-20,8440
6237,驊訊,287,161,126,摩根大通,2023-10-20,8440
2458,義隆,159,33,126,摩根大通,2023-10-20,8440
6239,力成,166,43,123,摩根大通,2023-10-20,8440
3221,台嘉碩,142,21,121,摩根大通,2023-10-20,8440
4533,協易機,136,15,121,摩根大通,2023-10-20,8440
2851,中再保,120,0,120,摩根大通,2023-10-20,8440
1504,東元,2083,19,2064,摩根大通,2023-10-23,8440
1513,中興電,1412,111,1301,摩根大通,2023-10-23,8440
2457,飛宏,1360,177,1183,摩根大通,2023-10-23,8440
2301,光寶科,1788,619,1169,摩根大通,2023-10-23,8440
3037,欣興,1394,419,975,摩根大通,2023-10-23,8440
1609,大亞,1009,194,815,摩根大通,2023-10-23,8440
1314,中石化,791,28,763,摩根大通,2023-10-23,8440
1605,華新,1337,589,748,摩根大通,2023-10-23,8440
9950,萬國通,830,101,729,摩根大通,2023-10-23,8440
2363,矽統,1073,431,642,摩根大通,2023-10-23,8440
2303,聯電,5185,4567,618,摩根大通,2023-10-23,8440
2352,佳世達,712,139,573,摩根大通,2023-10-23,8440
2329,華泰,718,156,562,摩根大通,2023-10-23,8440
9904,寶成,1098,574,524,摩根大通,2023-10-23,8440
2399,映泰,684,217,467,摩根大通,2023-10-23,8440
1447,力鵬,445,0,445,摩根大通,2023-10-23,8440
3548,兆利,549,108,441,摩根大通,2023-10-23,8440
3701,大眾控,463,34,429,摩根大通,2023-10-23,8440
6213,聯茂,538,157,381,摩根大通,2023-10-23,8440
3305,昇貿,478,105,373,摩根大通,2023-10-23,8440
2105,正新,787,453,334,摩根大通,2023-10-23,8440
2425,承啟,350,48,302,摩根大通,2023-10-23,8440
2367,燿華,332,36,296,摩根大通,2023-10-23,8440
5009,榮剛,473,180,293,摩根大通,2023-10-23,8440
6443,元晶,311,25,286,摩根大通,2023-10-23,8440
6223,旺矽,269,8,261,摩根大通,2023-10-23,8440
2405,輔信,350,92,258,摩根大通,2023-10-23,8440
6235,華孚,686,435,251,摩根大通,2023-10-23,8440
1503,士電,274,24,250,摩根大通,2023-10-23,8440
2014,中鴻,251,3,248,摩根大通,2023-10-23,8440
6197,佳必琪,263,19,244,摩根大通,2023-10-23,8440
3032,偉訓,463,223,240,摩根大通,2023-10-23,8440
8996,高力,390,150,240,摩根大通,2023-10-23,8440
2340,台亞,262,32,230,摩根大通,2023-10-23,8440
6239,力成,256,27,229,摩根大通,2023-10-23,8440
2520,冠德,222,0,222,摩根大通,2023-10-23,8440
9958,世紀鋼,229,12,217,摩根大通,2023-10-23,8440
3530,晶相光,243,32,211,摩根大通,2023-10-23,8440
3006,晶豪科,706,501,205,摩根大通,2023-10-23,8440
6589,台康生技,223,21,202,摩根大通,2023-10-23,8440
3260,威剛,603,401,202,摩根大通,2023-10-23,8440
2516,新建,326,126,200,摩根大通,2023-10-23,8440
2406,國碩,196,4,192,摩根大通,2023-10-23,8440
4743,合一,241,52,189,摩根大通,2023-10-23,8440
9933,中鼎,201,13,188,摩根大通,2023-10-23,8440
6244,茂迪,256,69,187,摩根大通,2023-10-23,8440
2409,友達,1829,1642,187,摩根大通,2023-10-23,8440
2313,華通,208,26,182,摩根大通,2023-10-23,8440
1310,台苯,191,9,182,摩根大通,2023-10-23,8440
2360,致茂,243,64,179,摩根大通,2023-10-23,8440
2303,聯電,5003,1063,3940,摩根大通,2023-10-24,8440
3481,群創,2117,484,1633,摩根大通,2023-10-24,8440
2883,凱基金,3268,1683,1585,摩根大通,2023-10-24,8440
3715,定穎投控,2093,811,1282,摩根大通,2023-10-24,8440
2515,中工,1174,0,1174,摩根大通,2023-10-24,8440
6244,茂迪,1369,198,1171,摩根大通,2023-10-24,8440
2409,友達,1200,215,985,摩根大通,2023-10-24,8440
2363,矽統,1059,149,910,摩根大通,2023-10-24,8440
1314,中石化,1313,411,902,摩根大通,2023-10-24,8440
2301,光寶科,2002,1144,858,摩根大通,2023-10-24,8440
00830,國泰費城半導體,800,0,800,摩根大通,2023-10-24,8440
2449,京元電子,790,78,712,摩根大通,2023-10-24,8440
2405,輔信,1192,532,660,摩根大通,2023-10-24,8440
2369,菱生,1750,1152,598,摩根大通,2023-10-24,8440
8069,元太,692,112,580,摩根大通,2023-10-24,8440
3078,僑威,609,33,576,摩根大通,2023-10-24,8440
1605,華新,689,136,553,摩根大通,2023-10-24,8440
2458,義隆,542,27,515,摩根大通,2023-10-24,8440
9904,寶成,629,118,511,摩根大通,2023-10-24,8440
2360,致茂,673,170,503,摩根大通,2023-10-24,8440
2353,宏��,784,301,483,摩根大通,2023-10-24,8440
4162,智擎,647,195,452,摩根大通,2023-10-24,8440
2605,新興,468,53,415,摩根大通,2023-10-24,8440
2201,裕隆,460,50,410,摩根大通,2023-10-24,8440
2347,聯強,478,78,400,摩根大通,2023-10-24,8440
2367,燿華,515,125,390,摩根大通,2023-10-24,8440
2313,華通,486,98,388,摩根大通,2023-10-24,8440
2401,凌陽,622,250,372,摩根大通,2023-10-24,8440
2454,聯發科,487,119,368,摩根大通,2023-10-24,8440
6443,元晶,490,153,337,摩根大通,2023-10-24,8440
3035,智原,716,383,333,摩根大通,2023-10-24,8440
3045,台灣大,439,133,306,摩根大通,2023-10-24,8440
2486,一詮,347,47,300,摩根大通,2023-10-24,8440
6257,矽格,325,27,298,摩根大通,2023-10-24,8440
2543,皇昌,329,38,291,摩根大通,2023-10-24,8440
00662,富邦NASDAQ,286,0,286,摩根大通,2023-10-24,8440
4128,中天,354,69,285,摩根大通,2023-10-24,8440
6213,聯茂,294,23,271,摩根大通,2023-10-24,8440
4915,致伸,311,61,250,摩根大通,2023-10-24,8440
6451,訊芯-KY,308,59,249,摩根大通,2023-10-24,8440
2618,長榮航,380,131,249,摩根大通,2023-10-24,8440
1609,大亞,279,32,247,摩根大通,2023-10-24,8440
2607,榮運,270,24,246,摩根大通,2023-10-24,8440
6139,亞翔,512,278,234,摩根大通,2023-10-24,8440
4123,晟德,231,11,220,摩根大通,2023-10-24,8440
2105,正新,542,322,220,摩根大通,2023-10-24,8440
2603,長榮,227,7,220,摩根大通,2023-10-24,8440
1402,遠東新,609,392,217,摩根大通,2023-10-24,8440
2538,基泰,239,26,213,摩根大通,2023-10-24,8440
3048,益登,253,40,213,摩根大通,2023-10-24,8440
2618,長榮航,4003,728,3275,摩根大通,2023-10-25,8440
2388,威盛,3764,701,3063,摩根大通,2023-10-25,8440
2515,中工,2830,646,2184,摩根大通,2023-10-25,8440
2405,輔信,2833,990,1843,摩根大通,2023-10-25,8440
2105,正新,1734,47,1687,摩根大通,2023-10-25,8440
1605,華新,1722,298,1424,摩根大通,2023-10-25,8440
5351,鈺創,1264,14,1250,摩根大通,2023-10-25,8440
2352,佳世達,1407,185,1222,摩根大通,2023-10-25,8440
2486,一詮,1176,20,1156,摩根大通,2023-10-25,8440
1314,中石化,1107,61,1046,摩根大通,2023-10-25,8440
6139,亞翔,1412,369,1043,摩根大通,2023-10-25,8440
2401,凌陽,1079,255,824,摩根大通,2023-10-25,8440
3704,合勤控,945,189,756,摩根大通,2023-10-25,8440
2881,富邦金,831,123,708,摩根大通,2023-10-25,8440
9904,寶成,1111,425,686,摩根大通,2023-10-25,8440
2363,矽統,1035,374,661,摩根大通,2023-10-25,8440
2324,仁寶,924,350,574,摩根大通,2023-10-25,8440
3041,揚智,1182,675,507,摩根大通,2023-10-25,8440
2458,義隆,593,97,496,摩根大通,2023-10-25,8440
2457,飛宏,1046,551,495,摩根大通,2023-10-25,8440
1513,中興電,491,4,487,摩根大通,2023-10-25,8440
2408,南亞科,484,16,468,摩根大通,2023-10-25,8440
1101,台泥,807,347,460,摩根大通,2023-10-25,8440
8069,元太,460,61,399,摩根大通,2023-10-25,8440
5258,虹堡,498,122,376,摩根大通,2023-10-25,8440
2002,中鋼,921,560,361,摩根大通,2023-10-25,8440
5425,台半,374,13,361,摩根大通,2023-10-25,8440
6116,彩晶,484,125,359,摩根大通,2023-10-25,8440
8210,勤誠,582,226,356,摩根大通,2023-10-25,8440
4162,智擎,458,110,348,摩根大通,2023-10-25,8440
2313,華通,814,469,345,摩根大通,2023-10-25,8440
3545,敦泰,370,29,341,摩根大通,2023-10-25,8440
2367,燿華,346,11,335,摩根大通,2023-10-25,8440
5009,榮剛,350,27,323,摩根大通,2023-10-25,8440
1524,耿鼎,1509,1204,305,摩根大通,2023-10-25,8440
3533,嘉澤,318,37,281,摩根大通,2023-10-25,8440
2607,榮運,363,96,267,摩根大通,2023-10-25,8440
2516,新建,289,23,266,摩根大通,2023-10-25,8440
6120,達運,356,91,265,摩根大通,2023-10-25,8440
1471,首利,350,88,262,摩根大通,2023-10-25,8440
8046,南電,317,68,249,摩根大通,2023-10-25,8440
1909,榮成,254,8,246,摩根大通,2023-10-25,8440
5521,工信,276,32,244,摩根大通,2023-10-25,8440
1785,光洋科,570,343,227,摩根大通,2023-10-25,8440
3059,華晶科,251,24,227,摩根大通,2023-10-25,8440
6290,良維,335,111,224,摩根大通,2023-10-25,8440
6257,矽格,337,113,224,摩根大通,2023-10-25,8440
4908,前鼎,740,516,224,摩根大通,2023-10-25,8440
8110,華東,521,298,223,摩根大通,2023-10-25,8440
4743,合一,333,112,221,摩根大通,2023-10-25,8440
3231,緯創,4683,855,3828,摩根大通,2023-10-26,8440
2883,凱基金,3717,935,2782,摩根大通,2023-10-26,8440
1605,華新,2182,46,2136,摩根大通,2023-10-26,8440
2885,元大金,2514,569,1945,摩根大通,2023-10-26,8440
2409,友達,1783,84,1699,摩根大通,2023-10-26,8440
2886,兆豐金,1847,155,1692,摩根大通,2023-10-26,8440
9904,寶成,2052,515,1537,摩根大通,2023-10-26,8440
2105,正新,1734,249,1485,摩根大通,2023-10-26,8440
2329,華泰,1588,258,1330,摩根大通,2023-10-26,8440
3036,文曄,2088,852,1236,摩根大通,2023-10-26,8440
2888,新光金,1267,113,1154,摩根大通,2023-10-26,8440
2352,佳世達,1443,390,1053,摩根大通,2023-10-26,8440
2454,聯發科,1128,108,1020,摩根大通,2023-10-26,8440
2515,中工,1179,180,999,摩根大通,2023-10-26,8440
1216,統一,934,76,858,摩根大通,2023-10-26,8440
2890,永豐金,947,96,851,摩根大通,2023-10-26,8440
2892,第一金,973,135,838,摩根大通,2023-10-26,8440
2382,廣達,2182,1392,790,摩根大通,2023-10-26,8440
2891,中信金,1604,815,789,摩根大通,2023-10-26,8440
1402,遠東新,769,59,710,摩根大通,2023-10-26,8440
5876,上海商銀,730,22,708,摩根大通,2023-10-26,8440
3045,台灣大,809,112,697,摩根大通,2023-10-26,8440
2363,矽統,675,0,675,摩根大通,2023-10-26,8440
00891,中信關鍵半導體,600,0,600,摩根大通,2023-10-26,8440
2357,華碩,605,11,594,摩根大通,2023-10-26,8440
6274,台燿,780,212,568,摩根大通,2023-10-26,8440
2376,技嘉,938,393,545,摩根大通,2023-10-26,8440
2605,新興,515,45,470,摩根大通,2023-10-26,8440
5009,榮剛,525,91,434,摩根大通,2023-10-26,8440
2465,麗臺,635,227,408,摩根大通,2023-10-26,8440
2458,義隆,528,132,396,摩根大通,2023-10-26,8440
2324,仁寶,866,503,363,摩根大通,2023-10-26,8440
8069,元太,440,77,363,摩根大通,2023-10-26,8440
1314,中石化,618,260,358,摩根大通,2023-10-26,8440
2882,國泰金,571,229,342,摩根大通,2023-10-26,8440
2330,台積電,1370,1028,342,摩根大通,2023-10-26,8440
2201,裕隆,426,104,322,摩根大通,2023-10-26,8440
2014,中鴻,317,5,312,摩根大通,2023-10-26,8440
2353,宏��,393,84,309,摩根大通,2023-10-26,8440
1101,台泥,740,436,304,摩根大通,2023-10-26,8440
6239,力成,308,16,292,摩根大通,2023-10-26,8440
2369,菱生,776,513,263,摩根大通,2023-10-26,8440
6451,訊芯-KY,354,95,259,摩根大通,2023-10-26,8440
4960,誠美材,333,85,248,摩根大通,2023-10-26,8440
4967,十銓,288,47,241,摩根大通,2023-10-26,8440
6243,迅杰,696,460,236,摩根大通,2023-10-26,8440
6143,振曜,327,94,233,摩根大通,2023-10-26,8440
2023,燁輝,241,14,227,摩根大通,2023-10-26,8440
2884,玉山金,338,114,224,摩根大通,2023-10-26,8440
3324,雙鴻,284,75,209,摩根大通,2023-10-26,8440
3231,緯創,6643,3472,3171,摩根大通,2023-10-27,8440
2618,長榮航,4256,2314,1942,摩根大通,2023-10-27,8440
2891,中信金,3533,2095,1438,摩根大通,2023-10-27,8440
1605,華新,1695,350,1345,摩根大通,2023-10-27,8440
2883,凱基金,2684,1542,1142,摩根大通,2023-10-27,8440
5521,工信,1169,84,1085,摩根大通,2023-10-27,8440
5876,上海商銀,1221,147,1074,摩根大通,2023-10-27,8440
1314,中石化,1007,27,980,摩根大通,2023-10-27,8440
2105,正新,1022,47,975,摩根大通,2023-10-27,8440
2330,台積電,2337,1373,964,摩根大通,2023-10-27,8440
3715,定穎投控,2121,1213,908,摩根大通,2023-10-27,8440
2363,矽統,1058,156,902,摩根大通,2023-10-27,8440
1216,統一,981,82,899,摩根大通,2023-10-27,8440
2409,友達,1051,159,892,摩根大通,2023-10-27,8440
9904,寶成,1037,179,858,摩根大通,2023-10-27,8440
2408,南亞科,799,26,773,摩根大通,2023-10-27,8440
6213,聯茂,845,97,748,摩根大通,2023-10-27,8440
5871,中租-KY,724,4,720,摩根大通,2023-10-27,8440
6271,同欣電,732,51,681,摩根大通,2023-10-27,8440
2516,新建,684,8,676,摩根大通,2023-10-27,8440
1402,遠東新,951,328,623,摩根大通,2023-10-27,8440
2002,中鋼,863,245,618,摩根大通,2023-10-27,8440
3045,台灣大,716,119,597,摩根大通,2023-10-27,8440
2465,麗臺,762,257,505,摩根大通,2023-10-27,8440
3702,大聯大,653,148,505,摩根大通,2023-10-27,8440
4123,晟德,549,47,502,摩根大通,2023-10-27,8440
2369,菱生,606,158,448,摩根大通,2023-10-27,8440
2609,陽明,505,100,405,摩根大通,2023-10-27,8440
6191,精成科,412,33,379,摩根大通,2023-10-27,8440
2345,智邦,575,200,375,摩根大通,2023-10-27,8440
4157,太景*-KY,360,0,360,摩根大通,2023-10-27,8440
3260,威剛,479,125,354,摩根大通,2023-10-27,8440
2890,永豐金,1236,885,351,摩根大通,2023-10-27,8440
1102,亞泥,668,317,351,摩根大通,2023-10-27,8440
3094,聯傑,547,208,339,摩根大通,2023-10-27,8440
4128,中天,420,97,323,摩根大通,2023-10-27,8440
2323,中環,423,110,313,摩根大通,2023-10-27,8440
2834,臺企銀,463,153,310,摩根大通,2023-10-27,8440
1303,南亞,652,343,309,摩根大通,2023-10-27,8440
2367,燿華,318,15,303,摩根大通,2023-10-27,8440
4979,華星光,681,389,292,摩根大通,2023-10-27,8440
2436,偉詮電,348,62,286,摩根大通,2023-10-27,8440
2610,華航,663,401,262,摩根大通,2023-10-27,8440
8996,高力,519,258,261,摩根大通,2023-10-27,8440
2324,仁寶,574,315,259,摩根大通,2023-10-27,8440
2884,玉山金,1208,949,259,摩根大通,2023-10-27,8440
6451,訊芯-KY,282,24,258,摩根大通,2023-10-27,8440
1721,三晃,389,135,254,摩根大通,2023-10-27,8440
6125,廣運,266,25,241,摩根大通,2023-10-27,8440
2313,華通,318,82,236,摩根大通,2023-10-27,8440
2454,聯發科,2883,552,2331,摩根大通,2023-10-30,8440
2882,國泰金,2490,449,2041,摩根大通,2023-10-30,8440
2303,聯電,2281,378,1903,摩根大通,2023-10-30,8440
3034,聯詠,2371,486,1885,摩根大通,2023-10-30,8440
4960,誠美材,1720,157,1563,摩根大通,2023-10-30,8440
1216,統一,1647,337,1310,摩根大通,2023-10-30,8440
3481,群創,1401,104,1297,摩根大通,2023-10-30,8440
2408,南亞科,1085,80,1005,摩根大通,2023-10-30,8440
2834,臺企銀,1112,147,965,摩根大通,2023-10-30,8440
1303,南亞,1164,239,925,摩根大通,2023-10-30,8440
3545,敦泰,1028,111,917,摩根大通,2023-10-30,8440
2884,玉山金,1063,195,868,摩根大通,2023-10-30,8440
2329,華泰,868,108,760,摩根大通,2023-10-30,8440
9904,寶成,1374,631,743,摩根大通,2023-10-30,8440
2382,廣達,1908,1183,725,摩根大通,2023-10-30,8440
2516,新建,794,102,692,摩根大通,2023-10-30,8440
1605,華新,864,188,676,摩根大通,2023-10-30,8440
2371,大同,669,15,654,摩根大通,2023-10-30,8440
6415,矽力*-KY,711,62,649,摩根大通,2023-10-30,8440
8088,品安,651,10,641,摩根大通,2023-10-30,8440
9950,萬國通,718,77,641,摩根大通,2023-10-30,8440
3006,晶豪科,692,57,635,摩根大通,2023-10-30,8440
2887,台新金,700,94,606,摩根大通,2023-10-30,8440
4979,華星光,867,343,524,摩根大通,2023-10-30,8440
2363,矽統,484,0,484,摩根大通,2023-10-30,8440
2881,富邦金,574,103,471,摩根大通,2023-10-30,8440
2615,萬海,544,89,455,摩根大通,2023-10-30,8440
2405,輔信,657,208,449,摩根大通,2023-10-30,8440
1802,台玻,487,41,446,摩根大通,2023-10-30,8440
2377,微星,421,31,390,摩根大通,2023-10-30,8440
3035,智原,478,95,383,摩根大通,2023-10-30,8440
3711,日月光投控,444,81,363,摩根大通,2023-10-30,8440
2025,千興,406,45,361,摩根大通,2023-10-30,8440
2603,長榮,523,174,349,摩根大通,2023-10-30,8440
5351,鈺創,418,73,345,摩根大通,2023-10-30,8440
6191,精成科,365,32,333,摩根大通,2023-10-30,8440
1785,光洋科,509,178,331,摩根大通,2023-10-30,8440
2449,京元電子,399,85,314,摩根大通,2023-10-30,8440
1301,台塑,415,104,311,摩根大通,2023-10-30,8440
2006,東和鋼鐵,352,54,298,摩根大通,2023-10-30,8440
2609,陽明,466,172,294,摩根大通,2023-10-30,8440
2327,國巨,314,41,273,摩根大通,2023-10-30,8440
1402,遠東新,911,639,272,摩根大通,2023-10-30,8440
6282,康舒,435,171,264,摩根大通,2023-10-30,8440
2474,可成,317,54,263,摩根大通,2023-10-30,8440
2486,一詮,355,93,262,摩根大通,2023-10-30,8440
9917,中保科,273,21,252,摩根大通,2023-10-30,8440
2357,華碩,358,126,232,摩根大通,2023-10-30,8440
1907,永豐餘,305,76,229,摩根大通,2023-10-30,8440
8054,安國,778,558,220,摩根大通,2023-10-30,8440
3105,穩懋,5494,1106,4388,摩根大通,2023-10-31,8440
2883,凱基金,4449,852,3597,摩根大通,2023-10-31,8440
2887,台新金,3423,595,2828,摩根大通,2023-10-31,8440
2884,玉山金,3212,746,2466,摩根大通,2023-10-31,8440
2834,臺企銀,2460,175,2285,摩根大通,2023-10-31,8440
1216,統一,2843,602,2241,摩根大通,2023-10-31,8440
2105,正新,2257,309,1948,摩根大通,2023-10-31,8440
3481,群創,2173,252,1921,摩根大通,2023-10-31,8440
2303,聯電,2851,1344,1507,摩根大通,2023-10-31,8440
2412,中華電,1436,6,1430,摩根大通,2023-10-31,8440
1402,遠東新,1688,606,1082,摩根大通,2023-10-31,8440
2330,台積電,3227,2278,949,摩根大通,2023-10-31,8440
1314,中石化,988,100,888,摩根大通,2023-10-31,8440
2882,國泰金,1882,1002,880,摩根大通,2023-10-31,8440
1560,中砂,1121,242,879,摩根大通,2023-10-31,8440
9904,寶成,1814,972,842,摩根大通,2023-10-31,8440
3045,台灣大,782,39,743,摩根大通,2023-10-31,8440
2002,中鋼,1594,889,705,摩根大通,2023-10-31,8440
2313,華通,935,260,675,摩根大通,2023-10-31,8440
1301,台塑,907,318,589,摩根大通,2023-10-31,8440
2408,南亞科,677,127,550,摩根大通,2023-10-31,8440
2618,長榮航,1183,636,547,摩根大通,2023-10-31,8440
3260,威剛,813,284,529,摩根大通,2023-10-31,8440
1102,亞泥,769,249,520,摩根大通,2023-10-31,8440
1605,華新,1269,791,478,摩根大通,2023-10-31,8440
3062,建漢,511,35,476,摩根大通,2023-10-31,8440
2368,金像電,476,24,452,摩根大通,2023-10-31,8440
2327,國巨,512,70,442,摩根大通,2023-10-31,8440
2006,東和鋼鐵,442,14,428,摩根大通,2023-10-31,8440
3035,智原,843,428,415,摩根大通,2023-10-31,8440
6415,矽力*-KY,449,57,392,摩根大通,2023-10-31,8440
3704,合勤控,755,365,390,摩根大通,2023-10-31,8440
8054,安國,779,390,389,摩根大通,2023-10-31,8440
3044,健鼎,387,32,355,摩根大通,2023-10-31,8440
3006,晶豪科,455,134,321,摩根大通,2023-10-31,8440
3036,文曄,474,158,316,摩根大通,2023-10-31,8440
2886,兆豐金,1491,1202,289,摩根大通,2023-10-31,8440
4162,智擎,296,26,270,摩根大通,2023-10-31,8440
3034,聯詠,522,257,265,摩根大通,2023-10-31,8440
2881,富邦金,746,488,258,摩根大通,2023-10-31,8440
9917,中保科,247,8,239,摩根大通,2023-10-31,8440
1802,台玻,504,268,236,摩根大通,2023-10-31,8440
8086,宏捷科,264,29,235,摩根大通,2023-10-31,8440
6191,精成科,264,40,224,摩根大通,2023-10-31,8440
2014,中鴻,325,102,223,摩根大通,2023-10-31,8440
1503,士電,312,91,221,摩根大通,2023-10-31,8440
6168,宏齊,208,0,208,摩根大通,2023-10-31,8440
9958,世紀鋼,355,153,202,摩根大通,2023-10-31,8440
6121,新普,281,80,201,摩根大通,2023-10-31,8440
6451,訊芯-KY,450,250,200,摩根大通,2023-10-31,8440
2301,光寶科,3686,748,2938,摩根大通,2023-11-01,8440
2891,中信金,3101,664,2437,摩根大通,2023-11-01,8440
2330,台積電,2496,607,1889,摩根大通,2023-11-01,8440
2303,聯電,3593,1915,1678,摩根大通,2023-11-01,8440
2884,玉山金,1600,18,1582,摩根大通,2023-11-01,8440
2886,兆豐金,1557,15,1542,摩根大通,2023-11-01,8440
2882,國泰金,2016,540,1476,摩根大通,2023-11-01,8440
2888,新光金,1427,22,1405,摩根大通,2023-11-01,8440
2834,臺企銀,1472,161,1311,摩根大通,2023-11-01,8440
2883,凱基金,2231,1066,1165,摩根大通,2023-11-01,8440
2890,永豐金,1120,133,987,摩根大通,2023-11-01,8440
5347,世界,967,12,955,摩根大通,2023-11-01,8440
2892,第一金,1323,369,954,摩根大通,2023-11-01,8440
8086,宏捷科,912,57,855,摩根大通,2023-11-01,8440
1216,統一,1882,1082,800,摩根大通,2023-11-01,8440
3704,合勤控,937,334,603,摩根大通,2023-11-01,8440
1303,南亞,654,68,586,摩根大通,2023-11-01,8440
2801,彰銀,582,5,577,摩根大通,2023-11-01,8440
2887,台新金,628,84,544,摩根大通,2023-11-01,8440
2454,聯發科,649,117,532,摩根大通,2023-11-01,8440
2492,華新科,1062,539,523,摩根大通,2023-11-01,8440
2317,鴻海,1439,916,523,摩根大通,2023-11-01,8440
2412,中華電,506,11,495,摩根大通,2023-11-01,8440
2417,圓剛,738,287,451,摩根大通,2023-11-01,8440
2880,華南金,452,11,441,摩根大通,2023-11-01,8440
2881,富邦金,781,347,434,摩根大通,2023-11-01,8440
2354,鴻準,434,23,411,摩根大通,2023-11-01,8440
5469,瀚宇博,638,239,399,摩根大通,2023-11-01,8440
1815,富喬,463,93,370,摩根大通,2023-11-01,8440
6235,華孚,982,620,362,摩根大通,2023-11-01,8440
9958,世紀鋼,650,300,350,摩根大通,2023-11-01,8440
1326,台化,342,18,324,摩根大通,2023-11-01,8440
2449,京元電子,311,3,308,摩根大通,2023-11-01,8440
3715,定穎投控,1903,1605,298,摩根大通,2023-11-01,8440
3596,智易,310,24,286,摩根大通,2023-11-01,8440
2006,東和鋼鐵,286,11,275,摩根大通,2023-11-01,8440
3034,聯詠,511,259,252,摩根大通,2023-11-01,8440
1319,東陽,359,108,251,摩根大通,2023-11-01,8440
2615,萬海,251,5,246,摩根大通,2023-11-01,8440
5483,中美晶,252,7,245,摩根大通,2023-11-01,8440
2352,佳世達,540,298,242,摩根大通,2023-11-01,8440
3548,兆利,539,298,241,摩根大通,2023-11-01,8440
2345,智邦,329,88,241,摩根大通,2023-11-01,8440
3045,台灣大,317,82,235,摩根大通,2023-11-01,8440
2002,中鋼,1281,1052,229,摩根大通,2023-11-01,8440
6274,台燿,339,114,225,摩根大通,2023-11-01,8440
3105,穩懋,641,417,224,摩根大通,2023-11-01,8440
4157,太景*-KY,225,4,221,摩根大通,2023-11-01,8440
1504,東元,204,0,204,摩根大通,2023-11-01,8440
2603,長榮,432,229,203,摩根大通,2023-11-01,8440
2303,聯電,4077,182,3895,摩根大通,2023-11-02,8440
2886,兆豐金,3880,89,3791,摩根大通,2023-11-02,8440
2409,友達,3122,125,2997,摩根大通,2023-11-02,8440
2891,中信金,2863,254,2609,摩根大通,2023-11-02,8440
2882,國泰金,2584,444,2140,摩根大通,2023-11-02,8440
2449,京元電子,1742,19,1723,摩根大通,2023-11-02,8440
2388,威盛,2291,645,1646,摩根大通,2023-11-02,8440
2888,新光金,1488,50,1438,摩根大通,2023-11-02,8440
2317,鴻海,1626,199,1427,摩根大通,2023-11-02,8440
3481,群創,1642,369,1273,摩根大通,2023-11-02,8440
1402,遠東新,1307,132,1175,摩根大通,2023-11-02,8440
6191,精成科,1297,137,1160,摩根大通,2023-11-02,8440
1101,台泥,1218,100,1118,摩根大通,2023-11-02,8440
2353,宏��,1418,437,981,摩根大通,2023-11-02,8440
1815,富喬,2074,1123,951,摩根大通,2023-11-02,8440
2356,英業達,2043,1094,949,摩根大通,2023-11-02,8440
2329,華泰,1054,159,895,摩根大通,2023-11-02,8440
3035,智原,1084,252,832,摩根大通,2023-11-02,8440
2610,華航,1195,380,815,摩根大通,2023-11-02,8440
2881,富邦金,794,33,761,摩根大通,2023-11-02,8440
8936,國統,932,201,731,摩根大通,2023-11-02,8440
1102,亞泥,932,275,657,摩根大通,2023-11-02,8440
2412,中華電,660,42,618,摩根大通,2023-11-02,8440
2340,台亞,577,6,571,摩根大通,2023-11-02,8440
9950,萬國通,589,67,522,摩根大通,2023-11-02,8440
5880,合庫金,737,239,498,摩根大通,2023-11-02,8440
2376,技嘉,816,319,497,摩根大通,2023-11-02,8440
2884,玉山金,755,264,491,摩根大通,2023-11-02,8440
2486,一詮,527,45,482,摩根大通,2023-11-02,8440
2367,燿華,801,321,480,摩根大通,2023-11-02,8440
1504,東元,462,10,452,摩根大通,2023-11-02,8440
2324,仁寶,485,38,447,摩根大通,2023-11-02,8440
2880,華南金,600,158,442,摩根大通,2023-11-02,8440
2892,第一金,579,143,436,摩根大通,2023-11-02,8440
2371,大同,550,144,406,摩根大通,2023-11-02,8440
1524,耿鼎,522,128,394,摩根大通,2023-11-02,8440
2615,萬海,446,57,389,摩根大通,2023-11-02,8440
2308,台達電,520,142,378,摩根大通,2023-11-02,8440
3702,大聯大,709,332,377,摩根大通,2023-11-02,8440
2427,三商電,390,44,346,摩根大通,2023-11-02,8440
6531,愛普*,481,139,342,摩根大通,2023-11-02,8440
3483,力致,413,88,325,摩根大通,2023-11-02,8440
2201,裕隆,327,3,324,摩根大通,2023-11-02,8440
1303,南亞,350,30,320,摩根大通,2023-11-02,8440
4162,智擎,373,63,310,摩根大通,2023-11-02,8440
2887,台新金,429,120,309,摩根大通,2023-11-02,8440
6290,良維,305,13,292,摩根大通,2023-11-02,8440
1802,台玻,280,7,273,摩根大通,2023-11-02,8440
2633,台灣高鐵,373,103,270,摩根大通,2023-11-02,8440
2498,宏達電,273,9,264,摩根大通,2023-11-02,8440
2303,聯電,6649,496,6153,摩根大通,2023-11-03,8440
2891,中信金,4712,169,4543,摩根大通,2023-11-03,8440
2388,威盛,5048,1564,3484,摩根大通,2023-11-03,8440
2301,光寶科,3336,517,2819,摩根大通,2023-11-03,8440
2886,兆豐金,2219,20,2199,摩根大通,2023-11-03,8440
2882,國泰金,1802,60,1742,摩根大通,2023-11-03,8440
6770,力積電,1668,1,1667,摩根大通,2023-11-03,8440
2888,新光金,1636,111,1525,摩根大通,2023-11-03,8440
2330,台積電,1678,326,1352,摩根大通,2023-11-03,8440
2308,台達電,1430,155,1275,摩根大通,2023-11-03,8440
2883,凱基金,1250,57,1193,摩根大通,2023-11-03,8440
3037,欣興,1238,136,1102,摩根大通,2023-11-03,8440
6139,亞翔,1233,164,1069,摩根大通,2023-11-03,8440
2449,京元電子,1179,143,1036,摩根大通,2023-11-03,8440
2606,裕民,984,12,972,摩根大通,2023-11-03,8440
3711,日月光投控,1175,225,950,摩根大通,2023-11-03,8440
2329,華泰,1566,687,879,摩根大通,2023-11-03,8440
9933,中鼎,969,209,760,摩根大通,2023-11-03,8440
2382,廣達,2369,1639,730,摩根大通,2023-11-03,8440
2002,中鋼,1125,413,712,摩根大通,2023-11-03,8440
2385,群光,965,263,702,摩根大通,2023-11-03,8440
2884,玉山金,962,307,655,摩根大通,2023-11-03,8440
2881,富邦金,749,143,606,摩根大通,2023-11-03,8440
9950,萬國通,720,156,564,摩根大通,2023-11-03,8440
1301,台塑,598,35,563,摩根大通,2023-11-03,8440
2887,台新金,569,51,518,摩根大通,2023-11-03,8440
3044,健鼎,693,197,496,摩根大通,2023-11-03,8440
2368,金像電,660,192,468,摩根大通,2023-11-03,8440
2892,第一金,806,340,466,摩根大通,2023-11-03,8440
6531,愛普*,757,295,462,摩根大通,2023-11-03,8440
1907,永豐餘,475,24,451,摩根大通,2023-11-03,8440
1560,中砂,593,172,421,摩根大通,2023-11-03,8440
1326,台化,425,7,418,摩根大通,2023-11-03,8440
2618,長榮航,2065,1652,413,摩根大通,2023-11-03,8440
2486,一詮,630,225,405,摩根大通,2023-11-03,8440
3363,上詮,429,58,371,摩根大通,2023-11-03,8440
1303,南亞,395,57,338,摩根大通,2023-11-03,8440
6116,彩晶,426,91,335,摩根大通,2023-11-03,8440
2890,永豐金,728,411,317,摩根大通,2023-11-03,8440
1605,華新,333,23,310,摩根大通,2023-11-03,8440
2603,長榮,314,9,305,摩根大通,2023-11-03,8440
2498,宏達電,521,216,305,摩根大通,2023-11-03,8440
8088,品安,362,69,293,摩根大通,2023-11-03,8440
4915,致伸,279,16,263,摩根大通,2023-11-03,8440
1409,新纖,251,0,251,摩根大通,2023-11-03,8440
2637,慧洋-KY,260,10,250,摩根大通,2023-11-03,8440
3228,金麗科,254,7,247,摩根大通,2023-11-03,8440
2357,華碩,257,14,243,摩根大通,2023-11-03,8440
2383,台光電,276,38,238,摩根大通,2023-11-03,8440
2201,裕隆,260,32,228,摩根大通,2023-11-03,8440
2884,玉山金,5712,1206,4506,摩根大通,2023-11-06,8440
2883,凱基金,5686,1434,4252,摩根大通,2023-11-06,8440
2886,兆豐金,4507,1088,3419,摩根大通,2023-11-06,8440
2890,永豐金,4268,1212,3056,摩根大通,2023-11-06,8440
1605,華新,3281,230,3051,摩根大通,2023-11-06,8440
2303,聯電,4003,1331,2672,摩根大通,2023-11-06,8440
3481,群創,3132,999,2133,摩根大通,2023-11-06,8440
2891,中信金,4789,2716,2073,摩根大通,2023-11-06,8440
2892,第一金,3229,1207,2022,摩根大通,2023-11-06,8440
1402,遠東新,2533,578,1955,摩根大通,2023-11-06,8440
2409,友達,3666,1772,1894,摩根大通,2023-11-06,8440
2880,華南金,2647,853,1794,摩根大通,2023-11-06,8440
2105,正新,2007,323,1684,摩根大通,2023-11-06,8440
3037,欣興,1913,234,1679,摩根大通,2023-11-06,8440
2317,鴻海,3121,1470,1651,摩根大通,2023-11-06,8440
2888,新光金,2944,1386,1558,摩根大通,2023-11-06,8440
2324,仁寶,2130,603,1527,摩根大通,2023-11-06,8440
1513,中興電,1304,29,1275,摩根大通,2023-11-06,8440
2887,台新金,2150,993,1157,摩根大通,2023-11-06,8440
2882,國泰金,2187,1034,1153,摩根大通,2023-11-06,8440
3036,文曄,1579,435,1144,摩根大通,2023-11-06,8440
3711,日月光投控,1476,391,1085,摩根大通,2023-11-06,8440
2382,廣達,2366,1343,1023,摩根大通,2023-11-06,8440
2881,富邦金,1916,936,980,摩根大通,2023-11-06,8440
3045,台灣大,1310,368,942,摩根大通,2023-11-06,8440
2385,群光,1053,124,929,摩根大通,2023-11-06,8440
6139,亞翔,1271,368,903,摩根大通,2023-11-06,8440
1303,南亞,1477,601,876,摩根大通,2023-11-06,8440
2458,義隆,874,31,843,摩根大通,2023-11-06,8440
2439,美律,887,55,832,摩根大通,2023-11-06,8440
1102,亞泥,1258,487,771,摩根大通,2023-11-06,8440
3017,奇鋐,1101,370,731,摩根大通,2023-11-06,8440
1101,台泥,1430,734,696,摩根大通,2023-11-06,8440
1785,光洋科,896,233,663,摩根大通,2023-11-06,8440
2515,中工,694,38,656,摩根大通,2023-11-06,8440
5880,合庫金,1721,1082,639,摩根大通,2023-11-06,8440
2801,彰銀,1416,782,634,摩根大通,2023-11-06,8440
2367,燿華,641,7,634,摩根大通,2023-11-06,8440
8163,達方,907,309,598,摩根大通,2023-11-06,8440
2002,中鋼,1902,1304,598,摩根大通,2023-11-06,8440
2371,大同,897,311,586,摩根大通,2023-11-06,8440
1326,台化,870,285,585,摩根大通,2023-11-06,8440
4938,和碩,874,321,553,摩根大通,2023-11-06,8440
2412,中華電,906,355,551,摩根大通,2023-11-06,8440
3044,健鼎,589,113,476,摩根大通,2023-11-06,8440
2352,佳世達,937,466,471,摩根大通,2023-11-06,8440
2344,華邦電,704,252,452,摩根大通,2023-11-06,8440
2474,可成,522,78,444,摩根大通,2023-11-06,8440
5521,工信,465,31,434,摩根大通,2023-11-06,8440
2027,大成鋼,430,9,421,摩根大通,2023-11-06,8440
00878,國泰永續高股息,3209,0,3209,摩根大通,2023-11-07,8440
2356,英業達,3289,1583,1706,摩根大通,2023-11-07,8440
1605,華新,1567,179,1388,摩根大通,2023-11-07,8440
1560,中砂,1332,151,1181,摩根大通,2023-11-07,8440
2883,凱基金,2688,1689,999,摩根大通,2023-11-07,8440
2352,佳世達,989,68,921,摩根大通,2023-11-07,8440
1513,中興電,930,15,915,摩根大通,2023-11-07,8440
3260,威剛,879,34,845,摩根大通,2023-11-07,8440
3217,優群,822,33,789,摩根大通,2023-11-07,8440
3045,台灣大,742,111,631,摩根大通,2023-11-07,8440
2313,華通,589,0,589,摩根大通,2023-11-07,8440
2885,元大金,1140,561,579,摩根大通,2023-11-07,8440
2317,鴻海,1289,712,577,摩根大通,2023-11-07,8440
3036,文曄,915,388,527,摩根大通,2023-11-07,8440
2609,陽明,741,284,457,摩根大通,2023-11-07,8440
2369,菱生,568,125,443,摩根大通,2023-11-07,8440
1102,亞泥,759,330,429,摩根大通,2023-11-07,8440
3025,星通,424,11,413,摩根大通,2023-11-07,8440
2303,聯電,1955,1579,376,摩根大通,2023-11-07,8440
2105,正新,746,395,351,摩根大通,2023-11-07,8440
2886,兆豐金,974,670,304,摩根大通,2023-11-07,8440
2884,玉山金,1100,801,299,摩根大通,2023-11-07,8440
1815,富喬,1652,1355,297,摩根大通,2023-11-07,8440
3037,欣興,1116,823,293,摩根大通,2023-11-07,8440
2451,創見,289,0,289,摩根大通,2023-11-07,8440
2201,裕隆,300,16,284,摩根大通,2023-11-07,8440
2327,國巨,314,50,264,摩根大通,2023-11-07,8440
2385,群光,370,124,246,摩根大通,2023-11-07,8440
2615,萬海,286,45,241,摩根大通,2023-11-07,8440
9933,中鼎,235,0,235,摩根大通,2023-11-07,8440
2542,興富發,246,18,228,摩根大通,2023-11-07,8440
6446,藥華藥,273,51,222,摩根大通,2023-11-07,8440
6806,森崴能源,308,94,214,摩根大通,2023-11-07,8440
5880,合庫金,610,402,208,摩根大通,2023-11-07,8440
2636,台驊控股,240,35,205,摩根大通,2023-11-07,8440
3013,晟銘電,292,96,196,摩根大通,2023-11-07,8440
2337,旺宏,294,98,196,摩根大通,2023-11-07,8440
2006,東和鋼鐵,295,103,192,摩根大通,2023-11-07,8440
8086,宏捷科,414,227,187,摩根大通,2023-11-07,8440
1514,亞力,306,120,186,摩根大通,2023-11-07,8440
2405,輔信,221,37,184,摩根大通,2023-11-07,8440
4113,聯上,185,2,183,摩根大通,2023-11-07,8440
2903,遠百,180,0,180,摩根大通,2023-11-07,8440
6223,旺矽,183,5,178,摩根大通,2023-11-07,8440
2603,長榮,231,55,176,摩根大通,2023-11-07,8440
3706,神達,240,72,168,摩根大通,2023-11-07,8440
8271,宇瞻,170,4,166,摩根大通,2023-11-07,8440
2530,華建,165,1,164,摩根大通,2023-11-07,8440
3228,金麗科,246,84,162,摩根大通,2023-11-07,8440
2520,冠德,161,0,161,摩根大通,2023-11-07,8440
2884,玉山金,3532,434,3098,摩根大通,2023-11-08,8440
2883,凱基金,4437,1912,2525,摩根大通,2023-11-08,8440
2353,宏��,2445,828,1617,摩根大通,2023-11-08,8440
2486,一詮,1593,298,1295,摩根大通,2023-11-08,8440
2409,友達,1293,26,1267,摩根大通,2023-11-08,8440
2324,仁寶,1471,428,1043,摩根大通,2023-11-08,8440
2388,威盛,1732,733,999,摩根大通,2023-11-08,8440
1402,遠東新,1351,366,985,摩根大通,2023-11-08,8440
3045,台灣大,933,12,921,摩根大通,2023-11-08,8440
2317,鴻海,2016,1106,910,摩根大通,2023-11-08,8440
2887,台新金,853,39,814,摩根大通,2023-11-08,8440
1319,東陽,941,173,768,摩根大通,2023-11-08,8440
6770,力積電,851,98,753,摩根大通,2023-11-08,8440
2888,新光金,830,104,726,摩根大通,2023-11-08,8440
1101,台泥,809,90,719,摩根大通,2023-11-08,8440
4128,中天,1113,433,680,摩根大通,2023-11-08,8440
1303,南亞,729,65,664,摩根大通,2023-11-08,8440
2352,佳世達,862,244,618,摩根大通,2023-11-08,8440
2337,旺宏,817,203,614,摩根大通,2023-11-08,8440
1301,台塑,604,4,600,摩根大通,2023-11-08,8440
2890,永豐金,950,375,575,摩根大通,2023-11-08,8440
2498,宏達電,590,16,574,摩根大通,2023-11-08,8440
2105,正新,736,166,570,摩根大通,2023-11-08,8440
2881,富邦金,801,256,545,摩根大通,2023-11-08,8440
3576,聯合再生,669,155,514,摩根大通,2023-11-08,8440
2886,兆豐金,1215,707,508,摩根大通,2023-11-08,8440
2885,元大金,887,389,498,摩根大通,2023-11-08,8440
2882,國泰金,757,263,494,摩根大通,2023-11-08,8440
2329,華泰,3159,2683,476,摩根大通,2023-11-08,8440
3036,文曄,816,357,459,摩根大通,2023-11-08,8440
3227,原相,550,96,454,摩根大通,2023-11-08,8440
1102,亞泥,511,67,444,摩根大通,2023-11-08,8440
1605,華新,1013,570,443,摩根大通,2023-11-08,8440
4904,遠傳,515,79,436,摩根大通,2023-11-08,8440
2801,彰銀,565,137,428,摩根大通,2023-11-08,8440
3711,日月光投控,455,37,418,摩根大通,2023-11-08,8440
6446,藥華藥,476,62,414,摩根大通,2023-11-08,8440
1560,中砂,487,77,410,摩根大通,2023-11-08,8440
2462,良得電,495,94,401,摩根大通,2023-11-08,8440
2382,廣達,1279,901,378,摩根大通,2023-11-08,8440
4915,致伸,420,47,373,摩根大通,2023-11-08,8440
5009,榮剛,362,6,356,摩根大通,2023-11-08,8440
2412,中華電,403,57,346,摩根大通,2023-11-08,8440
3481,群創,424,85,339,摩根大通,2023-11-08,8440
2449,京元電子,536,206,330,摩根大通,2023-11-08,8440
3005,神基,423,98,325,摩根大通,2023-11-08,8440
8112,至上,353,30,323,摩根大通,2023-11-08,8440
8069,元太,648,352,296,摩根大通,2023-11-08,8440
2376,技嘉,619,329,290,摩根大通,2023-11-08,8440
2312,金寶,330,49,281,摩根大通,2023-11-08,8440
2891,中信金,3649,75,3574,摩根大通,2023-11-09,8440
1101,台泥,3116,98,3018,摩根大通,2023-11-09,8440
2883,凱基金,3048,675,2373,摩根大通,2023-11-09,8440
2317,鴻海,2377,307,2070,摩根大通,2023-11-09,8440
2890,永豐金,1834,21,1813,摩根大通,2023-11-09,8440
2409,友達,2098,464,1634,摩根大通,2023-11-09,8440
1402,遠東新,1797,229,1568,摩根大通,2023-11-09,8440
2303,聯電,2743,1347,1396,摩根大通,2023-11-09,8440
2886,兆豐金,1460,73,1387,摩根大通,2023-11-09,8440
2892,第一金,1421,311,1110,摩根大通,2023-11-09,8440
2330,台積電,1510,451,1059,摩根大通,2023-11-09,8440
3711,日月光投控,1049,1,1048,摩根大通,2023-11-09,8440
1303,南亞,1072,26,1046,摩根大通,2023-11-09,8440
2352,佳世達,1144,168,976,摩根大通,2023-11-09,8440
2368,金像電,1051,90,961,摩根大通,2023-11-09,8440
2884,玉山金,949,31,918,摩根大通,2023-11-09,8440
1605,華新,1111,303,808,摩根大通,2023-11-09,8440
2885,元大金,957,166,791,摩根大通,2023-11-09,8440
1102,亞泥,900,127,773,摩根大通,2023-11-09,8440
3045,台灣大,776,48,728,摩根大通,2023-11-09,8440
4904,遠傳,877,164,713,摩根大通,2023-11-09,8440
2324,仁寶,1994,1306,688,摩根大通,2023-11-09,8440
2027,大成鋼,644,172,472,摩根大通,2023-11-09,8440
2888,新光金,463,24,439,摩根大通,2023-11-09,8440
2014,中鴻,433,9,424,摩根大通,2023-11-09,8440
2474,可成,407,5,402,摩根大通,2023-11-09,8440
4938,和碩,572,170,402,摩根大通,2023-11-09,8440
3005,神基,471,88,383,摩根大通,2023-11-09,8440
3481,群創,431,57,374,摩根大通,2023-11-09,8440
2412,中華電,391,20,371,摩根大通,2023-11-09,8440
2633,台灣高鐵,360,18,342,摩根大通,2023-11-09,8440
2353,宏��,346,10,336,摩根大通,2023-11-09,8440
2105,正新,579,251,328,摩根大通,2023-11-09,8440
1714,和桐,335,17,318,摩根大通,2023-11-09,8440
6279,胡連,312,5,307,摩根大通,2023-11-09,8440
2880,華南金,319,35,284,摩根大通,2023-11-09,8440
2887,台新金,271,0,271,摩根大通,2023-11-09,8440
6446,藥華藥,321,51,270,摩根大通,2023-11-09,8440
6901,鑽石投資,488,218,270,摩根大通,2023-11-09,8440
1326,台化,269,0,269,摩根大通,2023-11-09,8440
3324,雙鴻,299,36,263,摩根大通,2023-11-09,8440
4979,華星光,254,0,254,摩根大通,2023-11-09,8440
4958,臻鼎-KY,239,4,235,摩根大通,2023-11-09,8440
2881,富邦金,277,42,235,摩根大通,2023-11-09,8440
3035,智原,243,16,227,摩根大通,2023-11-09,8440
3264,欣銓,223,5,218,摩根大通,2023-11-09,8440
1514,亞力,364,148,216,摩根大通,2023-11-09,8440
2603,長榮,210,13,197,摩根大通,2023-11-09,8440
2606,裕民,304,108,196,摩根大通,2023-11-09,8440
2347,聯強,454,263,191,摩根大通,2023-11-09,8440
2891,中信金,2642,10,2632,摩根大通,2023-11-10,8440
2313,華通,3901,1401,2500,摩根大通,2023-11-10,8440
2883,凱基金,2651,164,2487,摩根大通,2023-11-10,8440
1402,遠東新,2299,25,2274,摩根大通,2023-11-10,8440
2884,玉山金,2168,1,2167,摩根大通,2023-11-10,8440
2303,聯電,1667,348,1319,摩根大通,2023-11-10,8440
2368,金像電,1521,205,1316,摩根大通,2023-11-10,8440
2890,永豐金,1077,17,1060,摩根大通,2023-11-10,8440
1605,華新,1075,18,1057,摩根大通,2023-11-10,8440
2376,技嘉,1561,508,1053,摩根大通,2023-11-10,8440
2515,中工,938,0,938,摩根大通,2023-11-10,8440
2892,第一金,1050,126,924,摩根大通,2023-11-10,8440
4938,和碩,901,19,882,摩根大通,2023-11-10,8440
4915,致伸,778,38,740,摩根大通,2023-11-10,8440
2886,兆豐金,725,1,724,摩根大通,2023-11-10,8440
8086,宏捷科,1131,431,700,摩根大通,2023-11-10,8440
2324,仁寶,928,237,691,摩根大通,2023-11-10,8440
1101,台泥,1211,580,631,摩根大通,2023-11-10,8440
2002,中鋼,684,86,598,摩根大通,2023-11-10,8440
2474,可成,592,4,588,摩根大通,2023-11-10,8440
1102,亞泥,600,47,553,摩根大通,2023-11-10,8440
1313,聯成,535,2,533,摩根大通,2023-11-10,8440
4904,遠傳,512,0,512,摩根大通,2023-11-10,8440
3715,定穎投控,515,5,510,摩根大通,2023-11-10,8440
2352,佳世達,1082,587,495,摩根大通,2023-11-10,8440
2353,宏��,686,212,474,摩根大通,2023-11-10,8440
6223,旺矽,572,99,473,摩根大通,2023-11-10,8440
2888,新光金,411,6,405,摩根大通,2023-11-10,8440
3044,健鼎,451,50,401,摩根大通,2023-11-10,8440
00878,國泰永續高股息,400,0,400,摩根大通,2023-11-10,8440
3045,台灣大,461,62,399,摩根大通,2023-11-10,8440
2105,正新,634,249,385,摩根大通,2023-11-10,8440
2385,群光,384,2,382,摩根大通,2023-11-10,8440
2347,聯強,385,9,376,摩根大通,2023-11-10,8440
8069,元太,436,86,350,摩根大通,2023-11-10,8440
5388,中磊,521,173,348,摩根大通,2023-11-10,8440
2331,精英,363,25,338,摩根大通,2023-11-10,8440
1303,南亞,357,22,335,摩根大通,2023-11-10,8440
2363,矽統,964,636,328,摩根大通,2023-11-10,8440
1440,南紡,332,6,326,摩根大通,2023-11-10,8440
5483,中美晶,328,5,323,摩根大通,2023-11-10,8440
4960,誠美材,404,83,321,摩根大通,2023-11-10,8440
2880,華南金,324,13,311,摩根大通,2023-11-10,8440
1301,台塑,311,9,302,摩根大通,2023-11-10,8440
1515,力山,442,148,294,摩根大通,2023-11-10,8440
2387,精元,493,205,288,摩根大通,2023-11-10,8440
2812,台中銀,281,0,281,摩根大通,2023-11-10,8440
1513,中興電,313,38,275,摩根大通,2023-11-10,8440
5258,虹堡,501,235,266,摩根大通,2023-11-10,8440
9933,中鼎,263,0,263,摩根大通,2023-11-10,8440
2303,聯電,9374,1147,8227,摩根大通,2023-11-13,8440
3231,緯創,9179,1861,7318,摩根大通,2023-11-13,8440
2883,凱基金,3197,242,2955,摩根大通,2023-11-13,8440
2409,友達,2466,26,2440,摩根大通,2023-11-13,8440
2891,中信金,1990,14,1976,摩根大通,2023-11-13,8440
1402,遠東新,2051,103,1948,摩根大通,2023-11-13,8440
2376,技嘉,2066,417,1649,摩根大通,2023-11-13,8440
2363,矽統,2539,1300,1239,摩根大通,2023-11-13,8440
1605,華新,1291,91,1200,摩根大通,2023-11-13,8440
2888,新光金,1135,151,984,摩根大通,2023-11-13,8440
2890,永豐金,1080,132,948,摩根大通,2023-11-13,8440
2603,長榮,995,72,923,摩根大通,2023-11-13,8440
2301,光寶科,879,73,806,摩根大通,2023-11-13,8440
2885,元大金,956,165,791,摩根大通,2023-11-13,8440
1102,亞泥,868,92,776,摩根大通,2023-11-13,8440
2886,兆豐金,756,16,740,摩根大通,2023-11-13,8440
2449,京元電子,818,118,700,摩根大通,2023-11-13,8440
4938,和碩,963,277,686,摩根大通,2023-11-13,8440
2105,正新,824,156,668,摩根大通,2023-11-13,8440
5876,上海商銀,721,69,652,摩根大通,2023-11-13,8440
3711,日月光投控,735,90,645,摩根大通,2023-11-13,8440
5347,世界,640,1,639,摩根大通,2023-11-13,8440
2317,鴻海,647,24,623,摩根大通,2023-11-13,8440
2353,宏��,733,133,600,摩根大通,2023-11-13,8440
3094,聯傑,523,9,514,摩根大通,2023-11-13,8440
1303,南亞,528,18,510,摩根大通,2023-11-13,8440
6282,康舒,733,235,498,摩根大通,2023-11-13,8440
3715,定穎投控,497,0,497,摩根大通,2023-11-13,8440
4904,遠傳,557,66,491,摩根大通,2023-11-13,8440
2427,三商電,524,37,487,摩根大通,2023-11-13,8440
2352,佳世達,916,446,470,摩根大通,2023-11-13,8440
2356,英業達,3271,2899,372,摩根大通,2023-11-13,8440
1584,精剛,367,3,364,摩根大通,2023-11-13,8440
2344,華邦電,366,4,362,摩根大通,2023-11-13,8440
2884,玉山金,467,109,358,摩根大通,2023-11-13,8440
2347,聯強,362,19,343,摩根大通,2023-11-13,8440
9927,泰銘,353,23,330,摩根大通,2023-11-13,8440
2002,中鋼,442,116,326,摩根大通,2023-11-13,8440
2607,榮運,349,46,303,摩根大通,2023-11-13,8440
2881,富邦金,334,35,299,摩根大通,2023-11-13,8440
5880,合庫金,345,59,286,摩根大通,2023-11-13,8440
3588,通嘉,300,15,285,摩根大通,2023-11-13,8440
2374,佳能,402,130,272,摩根大通,2023-11-13,8440
2892,第一金,594,323,271,摩根大通,2023-11-13,8440
4743,合一,344,74,270,摩根大通,2023-11-13,8440
2368,金像電,425,158,267,摩根大通,2023-11-13,8440
2399,映泰,284,24,260,摩根大通,2023-11-13,8440
8210,勤誠,397,152,245,摩根大通,2023-11-13,8440
3260,威剛,400,157,243,摩根大通,2023-11-13,8440
2014,中鴻,283,49,234,摩根大通,2023-11-13,8440
2891,中信金,4447,140,4307,摩根大通,2023-11-14,8440
3545,敦泰,3344,197,3147,摩根大通,2023-11-14,8440
2603,長榮,3208,177,3031,摩根大通,2023-11-14,8440
3711,日月光投控,3365,822,2543,摩根大通,2023-11-14,8440
5347,世界,2235,108,2127,摩根大通,2023-11-14,8440
2388,威盛,2938,1017,1921,摩根大通,2023-11-14,8440
1402,遠東新,1785,30,1755,摩根大通,2023-11-14,8440
2363,矽統,1925,320,1605,摩根大通,2023-11-14,8440
2330,台積電,3099,1530,1569,摩根大通,2023-11-14,8440
2885,元大金,1576,38,1538,摩根大通,2023-11-14,8440
2409,友達,1350,76,1274,摩根大通,2023-11-14,8440
4938,和碩,1208,93,1115,摩根大通,2023-11-14,8440
2344,華邦電,1785,742,1043,摩根大通,2023-11-14,8440
2368,金像電,2004,970,1034,摩根大通,2023-11-14,8440
2888,新光金,1101,74,1027,摩根大通,2023-11-14,8440
2880,華南金,1082,185,897,摩根大通,2023-11-14,8440
2886,兆豐金,895,5,890,摩根大通,2023-11-14,8440
1515,力山,967,135,832,摩根大通,2023-11-14,8440
2892,第一金,1082,298,784,摩根大通,2023-11-14,8440
2352,佳世達,752,56,696,摩根大通,2023-11-14,8440
3042,晶技,687,19,668,摩根大通,2023-11-14,8440
5880,合庫金,679,32,647,摩根大通,2023-11-14,8440
3276,宇環,643,45,598,摩根大通,2023-11-14,8440
2002,中鋼,844,283,561,摩根大通,2023-11-14,8440
3706,神達,585,47,538,摩根大通,2023-11-14,8440
2324,仁寶,727,196,531,摩根大通,2023-11-14,8440
2105,正新,665,138,527,摩根大通,2023-11-14,8440
2317,鴻海,940,449,491,摩根大通,2023-11-14,8440
6770,力積電,635,183,452,摩根大通,2023-11-14,8440
2915,潤泰全,663,218,445,摩根大通,2023-11-14,8440
3715,定穎投控,434,0,434,摩根大通,2023-11-14,8440
1303,南亞,807,373,434,摩根大通,2023-11-14,8440
6643,M31,424,2,422,摩根大通,2023-11-14,8440
2884,玉山金,1006,609,397,摩根大通,2023-11-14,8440
1605,華新,905,509,396,摩根大通,2023-11-14,8440
6282,康舒,1081,694,387,摩根大通,2023-11-14,8440
2890,永豐金,928,553,375,摩根大通,2023-11-14,8440
1301,台塑,463,100,363,摩根大通,2023-11-14,8440
6257,矽格,357,4,353,摩根大通,2023-11-14,8440
2887,台新金,366,21,345,摩根大通,2023-11-14,8440
2881,富邦金,591,247,344,摩根大通,2023-11-14,8440
3005,神基,379,38,341,摩根大通,2023-11-14,8440
2417,圓剛,594,260,334,摩根大通,2023-11-14,8440
3704,合勤控,451,119,332,摩根大通,2023-11-14,8440
5351,鈺創,389,59,330,摩根大通,2023-11-14,8440
4904,遠傳,312,12,300,摩根大通,2023-11-14,8440
4961,天鈺,312,19,293,摩根大通,2023-11-14,8440
2538,基泰,340,49,291,摩根大通,2023-11-14,8440
6139,亞翔,436,149,287,摩根大通,2023-11-14,8440
6231,系微,325,39,286,摩根大通,2023-11-14,8440
2344,華邦電,18960,1893,17067,摩根大通,2023-11-15,8440
2883,凱基金,11451,1071,10380,摩根大通,2023-11-15,8440
2884,玉山金,7727,158,7569,摩根大通,2023-11-15,8440
2885,元大金,6983,346,6637,摩根大通,2023-11-15,8440
2303,聯電,7243,1232,6011,摩根大通,2023-11-15,8440
2891,中信金,8811,3892,4919,摩根大通,2023-11-15,8440
2834,臺企銀,3371,288,3083,摩根大通,2023-11-15,8440
2881,富邦金,2960,235,2725,摩根大通,2023-11-15,8440
6415,矽力*-KY,2954,260,2694,摩根大通,2023-11-15,8440
2330,台積電,4682,2034,2648,摩根大通,2023-11-15,8440
2409,友達,3423,777,2646,摩根大通,2023-11-15,8440
1605,華新,2956,438,2518,摩根大通,2023-11-15,8440
1101,台泥,2515,51,2464,摩根大通,2023-11-15,8440
2618,長榮航,4117,1917,2200,摩根大通,2023-11-15,8440
1303,南亞,2502,326,2176,摩根大通,2023-11-15,8440
1402,遠東新,2327,176,2151,摩根大通,2023-11-15,8440
3481,群創,2659,623,2036,摩根大通,2023-11-15,8440
2002,中鋼,2389,386,2003,摩根大通,2023-11-15,8440
3231,緯創,2359,365,1994,摩根大通,2023-11-15,8440
1718,中纖,1923,19,1904,摩根大通,2023-11-15,8440
5880,合庫金,1882,180,1702,摩根大通,2023-11-15,8440
6290,良維,1667,10,1657,摩根大通,2023-11-15,8440
1217,愛之味,1702,64,1638,摩根大通,2023-11-15,8440
1102,亞泥,1585,50,1535,摩根大通,2023-11-15,8440
2867,三商壽,1507,19,1488,摩根大通,2023-11-15,8440
1314,中石化,1481,3,1478,摩根大通,2023-11-15,8440
2382,廣達,1875,449,1426,摩根大通,2023-11-15,8440
2006,東和鋼鐵,1481,65,1416,摩根大通,2023-11-15,8440
2388,威盛,2970,1573,1397,摩根大通,2023-11-15,8440
2105,正新,1527,149,1378,摩根大通,2023-11-15,8440
9945,潤泰新,1495,137,1358,摩根大通,2023-11-15,8440
2412,中華電,2256,947,1309,摩根大通,2023-11-15,8440
3711,日月光投控,1637,372,1265,摩根大通,2023-11-15,8440
1301,台塑,1390,141,1249,摩根大通,2023-11-15,8440
2892,第一金,1484,308,1176,摩根大通,2023-11-15,8440
1524,耿鼎,1310,145,1165,摩根大通,2023-11-15,8440
2352,佳世達,1131,7,1124,摩根大通,2023-11-15,8440
2880,華南金,1398,310,1088,摩根大通,2023-11-15,8440
2905,三商,1041,6,1035,摩根大通,2023-11-15,8440
2845,遠東銀,1077,89,988,摩根大通,2023-11-15,8440
2317,鴻海,1235,258,977,摩根大通,2023-11-15,8440
2385,群光,970,14,956,摩根大通,2023-11-15,8440
1313,聯成,929,6,923,摩根大通,2023-11-15,8440
2886,兆豐金,1439,544,895,摩根大通,2023-11-15,8440
2615,萬海,998,104,894,摩根大通,2023-11-15,8440
2014,中鴻,1109,239,870,摩根大通,2023-11-15,8440
1304,台聚,929,60,869,摩根大通,2023-11-15,8440
2371,大同,1705,857,848,摩根大通,2023-11-15,8440
2812,台中銀,869,30,839,摩根大通,2023-11-15,8440
6239,力成,838,10,828,摩根大通,2023-11-15,8440
2892,第一金,5074,486,4588,摩根大通,2023-11-16,8440
2618,長榮航,6329,2318,4011,摩根大通,2023-11-16,8440
2884,玉山金,4347,733,3614,摩根大通,2023-11-16,8440
2330,台積電,3812,805,3007,摩根大通,2023-11-16,8440
8069,元太,2922,213,2709,摩根大通,2023-11-16,8440
2801,彰銀,2619,69,2550,摩根大通,2023-11-16,8440
2891,中信金,3169,725,2444,摩根大通,2023-11-16,8440
2303,聯電,2856,491,2365,摩根大通,2023-11-16,8440
1301,台塑,2659,497,2162,摩根大通,2023-11-16,8440
2883,凱基金,4102,1987,2115,摩根大通,2023-11-16,8440
2880,華南金,2044,240,1804,摩根大通,2023-11-16,8440
2890,永豐金,1932,146,1786,摩根大通,2023-11-16,8440
2317,鴻海,2299,553,1746,摩根大通,2023-11-16,8440
2885,元大金,2128,395,1733,摩根大通,2023-11-16,8440
2888,新光金,2454,745,1709,摩根大通,2023-11-16,8440
1101,台泥,1916,473,1443,摩根大通,2023-11-16,8440
1402,遠東新,1343,32,1311,摩根大通,2023-11-16,8440
2886,兆豐金,1900,659,1241,摩根大通,2023-11-16,8440
5880,合庫金,1568,397,1171,摩根大通,2023-11-16,8440
2887,台新金,1403,268,1135,摩根大通,2023-11-16,8440
2014,中鴻,1245,138,1107,摩根大通,2023-11-16,8440
2002,中鋼,1244,144,1100,摩根大通,2023-11-16,8440
9950,萬國通,1243,159,1084,摩根大通,2023-11-16,8440
5876,上海商銀,1470,423,1047,摩根大通,2023-11-16,8440
2881,富邦金,1018,40,978,摩根大通,2023-11-16,8440
1326,台化,921,12,909,摩根大通,2023-11-16,8440
2812,台中銀,859,0,859,摩根大通,2023-11-16,8440
1102,亞泥,1111,279,832,摩根大通,2023-11-16,8440
2355,敬鵬,940,121,819,摩根大通,2023-11-16,8440
2105,正新,1018,204,814,摩根大通,2023-11-16,8440
3545,敦泰,865,59,806,摩根大通,2023-11-16,8440
1216,統一,1089,365,724,摩根大通,2023-11-16,8440
1314,中石化,704,2,702,摩根大通,2023-11-16,8440
4904,遠傳,762,96,666,摩根大通,2023-11-16,8440
2383,台光電,1282,617,665,摩根大通,2023-11-16,8440
2324,仁寶,982,318,664,摩根大通,2023-11-16,8440
3231,緯創,1185,542,643,摩根大通,2023-11-16,8440
3481,群創,1063,446,617,摩根大通,2023-11-16,8440
1303,南亞,739,132,607,摩根大通,2023-11-16,8440
3706,神達,686,82,604,摩根大通,2023-11-16,8440
1605,華新,1281,686,595,摩根大通,2023-11-16,8440
2369,菱生,642,102,540,摩根大通,2023-11-16,8440
2023,燁輝,540,3,537,摩根大通,2023-11-16,8440
3005,神基,521,9,512,摩根大通,2023-11-16,8440
1802,台玻,611,100,511,摩根大通,2023-11-16,8440
2607,榮運,504,17,487,摩根大通,2023-11-16,8440
3059,華晶科,458,1,457,摩根大通,2023-11-16,8440
2347,聯強,454,8,446,摩根大通,2023-11-16,8440
1907,永豐餘,468,47,421,摩根大通,2023-11-16,8440
2401,凌陽,413,4,409,摩根大通,2023-11-16,8440
0050,元大台灣50,5633,0,5633,摩根大通,2023-11-17,8440
2303,聯電,6054,586,5468,摩根大通,2023-11-17,8440
2892,第一金,4058,73,3985,摩根大通,2023-11-17,8440
2317,鴻海,4124,239,3885,摩根大通,2023-11-17,8440
2401,凌陽,3034,329,2705,摩根大通,2023-11-17,8440
2330,台積電,3095,566,2529,摩根大通,2023-11-17,8440
3035,智原,2157,103,2054,摩根大通,2023-11-17,8440
2888,新光金,2011,243,1768,摩根大通,2023-11-17,8440
2886,兆豐金,2060,391,1669,摩根大通,2023-11-17,8440
3711,日月光投控,1808,276,1532,摩根大通,2023-11-17,8440
2883,凱基金,5035,3583,1452,摩根大通,2023-11-17,8440
2882,國泰金,1510,80,1430,摩根大通,2023-11-17,8440
2355,敬鵬,1445,95,1350,摩根大通,2023-11-17,8440
3231,緯創,2213,873,1340,摩根大通,2023-11-17,8440
5880,合庫金,1281,11,1270,摩根大通,2023-11-17,8440
2887,台新金,1300,93,1207,摩根大通,2023-11-17,8440
3481,群創,1625,467,1158,摩根大通,2023-11-17,8440
2002,中鋼,1220,100,1120,摩根大通,2023-11-17,8440
3545,敦泰,1257,168,1089,摩根大通,2023-11-17,8440
2891,中信金,2028,1008,1020,摩根大通,2023-11-17,8440
2801,彰銀,1417,406,1011,摩根大通,2023-11-17,8440
2409,友達,1761,791,970,摩根大通,2023-11-17,8440
2880,華南金,1489,530,959,摩根大通,2023-11-17,8440
1402,遠東新,1029,111,918,摩根大通,2023-11-17,8440
5876,上海商銀,1267,407,860,摩根大通,2023-11-17,8440
3037,欣興,1450,599,851,摩根大通,2023-11-17,8440
2329,華泰,1261,438,823,摩根大通,2023-11-17,8440
2313,華通,909,106,803,摩根大通,2023-11-17,8440
3005,神基,1078,310,768,摩根大通,2023-11-17,8440
3376,新日興,814,49,765,摩根大通,2023-11-17,8440
2105,正新,830,78,752,摩根大通,2023-11-17,8440
2881,富邦金,832,80,752,摩根大通,2023-11-17,8440
2812,台中銀,771,30,741,摩根大通,2023-11-17,8440
2890,永豐金,1068,351,717,摩根大通,2023-11-17,8440
2405,輔信,1234,554,680,摩根大通,2023-11-17,8440
2885,元大金,1200,520,680,摩根大通,2023-11-17,8440
3322,建舜電,666,6,660,摩根大通,2023-11-17,8440
3702,大聯大,946,323,623,摩根大通,2023-11-17,8440
3701,大眾控,1035,416,619,摩根大通,2023-11-17,8440
2352,佳世達,762,145,617,摩根大通,2023-11-17,8440
1102,亞泥,721,106,615,摩根大通,2023-11-17,8440
1101,台泥,969,450,519,摩根大通,2023-11-17,8440
1326,台化,504,7,497,摩根大通,2023-11-17,8440
2884,玉山金,1455,988,467,摩根大通,2023-11-17,8440
2323,中環,492,27,465,摩根大通,2023-11-17,8440
2515,中工,472,18,454,摩根大通,2023-11-17,8440
4714,永捷,448,1,447,摩根大通,2023-11-17,8440
4958,臻鼎-KY,445,1,444,摩根大通,2023-11-17,8440
2633,台灣高鐵,472,29,443,摩根大通,2023-11-17,8440
6271,同欣電,485,66,419,摩根大通,2023-11-17,8440
1504,東元,5272,500,4772,摩根大通,2023-11-20,8440
2356,英業達,5063,1658,3405,摩根大通,2023-11-20,8440
3231,緯創,3616,264,3352,摩根大通,2023-11-20,8440
2883,凱基金,5219,2264,2955,摩根大通,2023-11-20,8440
2405,輔信,2717,490,2227,摩根大通,2023-11-20,8440
2303,聯電,6471,4921,1550,摩根大通,2023-11-20,8440
2355,敬鵬,3059,1509,1550,摩根大通,2023-11-20,8440
2401,凌陽,2056,508,1548,摩根大通,2023-11-20,8440
2603,長榮,1908,832,1076,摩根大通,2023-11-20,8440
2408,南亞科,1167,120,1047,摩根大通,2023-11-20,8440
2388,威盛,1379,348,1031,摩根大通,2023-11-20,8440
2301,光寶科,1753,774,979,摩根大通,2023-11-20,8440
2002,中鋼,1031,63,968,摩根大通,2023-11-20,8440
6415,矽力*-KY,1038,99,939,摩根大通,2023-11-20,8440
3483,力致,994,57,937,摩根大通,2023-11-20,8440
3715,定穎投控,2644,1723,921,摩根大通,2023-11-20,8440
3037,欣興,1108,211,897,摩根大通,2023-11-20,8440
6139,亞翔,1404,601,803,摩根大通,2023-11-20,8440
2887,台新金,816,18,798,摩根大通,2023-11-20,8440
3545,敦泰,1255,490,765,摩根大通,2023-11-20,8440
2367,燿華,890,143,747,摩根大通,2023-11-20,8440
2353,宏��,1121,378,743,摩根大通,2023-11-20,8440
3005,神基,950,220,730,摩根大通,2023-11-20,8440
2618,長榮航,5046,4357,689,摩根大通,2023-11-20,8440
6213,聯茂,688,2,686,摩根大通,2023-11-20,8440
2376,技嘉,996,326,670,摩根大通,2023-11-20,8440
3062,建漢,629,9,620,摩根大通,2023-11-20,8440
2412,中華電,848,301,547,摩根大通,2023-11-20,8440
3548,兆利,656,120,536,摩根大通,2023-11-20,8440
2363,矽統,2270,1767,503,摩根大通,2023-11-20,8440
3481,群創,1486,996,490,摩根大通,2023-11-20,8440
2801,彰銀,1063,594,469,摩根大通,2023-11-20,8440
1101,台泥,653,204,449,摩根大通,2023-11-20,8440
3078,僑威,459,11,448,摩根大通,2023-11-20,8440
2383,台光電,921,538,383,摩根大通,2023-11-20,8440
1785,光洋科,414,33,381,摩根大通,2023-11-20,8440
2462,良得電,475,100,375,摩根大通,2023-11-20,8440
2329,華泰,497,127,370,摩根大通,2023-11-20,8440
3702,大聯大,557,216,341,摩根大通,2023-11-20,8440
2888,新光金,1100,782,318,摩根大通,2023-11-20,8440
2206,三陽工業,354,44,310,摩根大通,2023-11-20,8440
5272,笙科,392,99,293,摩根大通,2023-11-20,8440
8150,南茂,290,7,283,摩根大通,2023-11-20,8440
6117,迎廣,419,145,274,摩根大通,2023-11-20,8440
4967,十銓,280,11,269,摩根大通,2023-11-20,8440
3013,晟銘電,260,5,255,摩根大通,2023-11-20,8440
6284,佳邦,358,105,253,摩根大通,2023-11-20,8440
2014,中鴻,271,35,236,摩根大通,2023-11-20,8440
2515,中工,232,0,232,摩根大通,2023-11-20,8440
8088,品安,227,0,227,摩根大通,2023-11-20,8440
2885,元大金,5356,349,5007,摩根大通,2023-11-21,8440
2883,凱基金,9186,4191,4995,摩根大通,2023-11-21,8440
0050,元大台灣50,4735,0,4735,摩根大通,2023-11-21,8440
3711,日月光投控,5506,797,4709,摩根大通,2023-11-21,8440
2353,宏��,5041,373,4668,摩根大通,2023-11-21,8440
2887,台新金,3149,201,2948,摩根大通,2023-11-21,8440
2892,第一金,2988,149,2839,摩根大通,2023-11-21,8440
2002,中鋼,3368,562,2806,摩根大通,2023-11-21,8440
2891,中信金,4443,1689,2754,摩根大通,2023-11-21,8440
2888,新光金,2796,105,2691,摩根大通,2023-11-21,8440
2886,兆豐金,3430,755,2675,摩根大通,2023-11-21,8440
2881,富邦金,3446,789,2657,摩根大通,2023-11-21,8440
1605,華新,2849,265,2584,摩根大通,2023-11-21,8440
2884,玉山金,2464,414,2050,摩根大通,2023-11-21,8440
2880,華南金,2235,265,1970,摩根大通,2023-11-21,8440
5880,合庫金,2058,205,1853,摩根大通,2023-11-21,8440
2105,正新,1900,92,1808,摩根大通,2023-11-21,8440
2801,彰銀,2114,334,1780,摩根大通,2023-11-21,8440
3005,神基,2853,1082,1771,摩根大通,2023-11-21,8440
2610,華航,2460,800,1660,摩根大通,2023-11-21,8440
1303,南亞,2203,719,1484,摩根大通,2023-11-21,8440
2409,友達,1923,447,1476,摩根大通,2023-11-21,8440
2317,鴻海,2369,979,1390,摩根大通,2023-11-21,8440
3481,群創,1558,210,1348,摩根大通,2023-11-21,8440
2882,國泰金,3891,2603,1288,摩根大通,2023-11-21,8440
2890,永豐金,3167,1985,1182,摩根大通,2023-11-21,8440
2405,輔信,2137,997,1140,摩根大通,2023-11-21,8440
2301,光寶科,1505,457,1048,摩根大通,2023-11-21,8440
2408,南亞科,1577,567,1010,摩根大通,2023-11-21,8440
2344,華邦電,1139,209,930,摩根大通,2023-11-21,8440
3047,訊舟,985,115,870,摩根大通,2023-11-21,8440
2812,台中銀,1163,340,823,摩根大通,2023-11-21,8440
6505,台塑化,863,50,813,摩根大通,2023-11-21,8440
2867,三商壽,811,0,811,摩根大通,2023-11-21,8440
1101,台泥,2298,1511,787,摩根大通,2023-11-21,8440
2324,仁寶,1834,1063,771,摩根大通,2023-11-21,8440
2454,聯發科,978,243,735,摩根大通,2023-11-21,8440
2023,燁輝,705,20,685,摩根大通,2023-11-21,8440
1102,亞泥,672,20,652,摩根大通,2023-11-21,8440
4938,和碩,735,83,652,摩根大通,2023-11-21,8440
2809,京城銀,674,28,646,摩根大通,2023-11-21,8440
3545,敦泰,743,97,646,摩根大通,2023-11-21,8440
1326,台化,790,150,640,摩根大通,2023-11-21,8440
2312,金寶,745,158,587,摩根大通,2023-11-21,8440
4904,遠傳,707,171,536,摩根大通,2023-11-21,8440
6770,力積電,723,219,504,摩根大通,2023-11-21,8440
6005,群益證,609,108,501,摩根大通,2023-11-21,8440
2382,廣達,1741,1245,496,摩根大通,2023-11-21,8440
2347,聯強,685,198,487,摩根大通,2023-11-21,8440
2014,中鴻,687,238,449,摩根大通,2023-11-21,8440
3711,日月光投控,1869,273,1596,摩根大通,2023-11-22,8440
3481,群創,1697,152,1545,摩根大通,2023-11-22,8440
2891,中信金,1580,217,1363,摩根大通,2023-11-22,8440
2105,正新,1490,321,1169,摩根大通,2023-11-22,8440
2317,鴻海,1279,163,1116,摩根大通,2023-11-22,8440
6282,康舒,2172,1130,1042,摩根大通,2023-11-22,8440
2002,中鋼,1514,491,1023,摩根大通,2023-11-22,8440
2880,華南金,1331,383,948,摩根大通,2023-11-22,8440
2356,英業達,3503,2576,927,摩根大通,2023-11-22,8440
2329,華泰,1013,172,841,摩根大通,2023-11-22,8440
5351,鈺創,1312,480,832,摩根大通,2023-11-22,8440
3078,僑威,874,68,806,摩根大通,2023-11-22,8440
2312,金寶,889,134,755,摩根大通,2023-11-22,8440
2367,燿華,1010,285,725,摩根大通,2023-11-22,8440
2408,南亞科,888,199,689,摩根大通,2023-11-22,8440
6176,瑞儀,700,22,678,摩根大通,2023-11-22,8440
2353,宏��,1655,987,668,摩根大通,2023-11-22,8440
3363,上詮,1056,401,655,摩根大通,2023-11-22,8440
3005,神基,830,221,609,摩根大通,2023-11-22,8440
2542,興富發,572,13,559,摩根大通,2023-11-22,8440
3045,台灣大,598,47,551,摩根大通,2023-11-22,8440
5009,榮剛,663,127,536,摩根大通,2023-11-22,8440
3545,敦泰,1066,544,522,摩根大通,2023-11-22,8440
2845,遠東銀,527,5,522,摩根大通,2023-11-22,8440
1785,光洋科,513,2,511,摩根大通,2023-11-22,8440
2344,華邦電,575,67,508,摩根大通,2023-11-22,8440
6139,亞翔,855,373,482,摩根大通,2023-11-22,8440
3059,華晶科,776,306,470,摩根大通,2023-11-22,8440
2369,菱生,461,8,453,摩根大通,2023-11-22,8440
3035,智原,448,41,407,摩根大通,2023-11-22,8440
5521,工信,757,356,401,摩根大通,2023-11-22,8440
6411,晶焱,448,55,393,摩根大通,2023-11-22,8440
4919,新唐,438,59,379,摩根大通,2023-11-22,8440
2885,元大金,740,404,336,摩根大通,2023-11-22,8440
1513,中興電,383,49,334,摩根大通,2023-11-22,8440
5439,高技,364,31,333,摩根大通,2023-11-22,8440
8069,元太,390,58,332,摩根大通,2023-11-22,8440
2409,友達,486,170,316,摩根大通,2023-11-22,8440
5225,東科-KY,496,196,300,摩根大通,2023-11-22,8440
2809,京城銀,291,0,291,摩根大通,2023-11-22,8440
6415,矽力*-KY,330,50,280,摩根大通,2023-11-22,8440
1444,力麗,278,0,278,摩根大通,2023-11-22,8440
4960,誠美材,298,26,272,摩根大通,2023-11-22,8440
6202,盛群,262,0,262,摩根大通,2023-11-22,8440
6284,佳邦,372,111,261,摩根大通,2023-11-22,8440
5443,均豪,341,97,244,摩根大通,2023-11-22,8440
3094,聯傑,242,0,242,摩根大通,2023-11-22,8440
3227,原相,354,113,241,摩根大通,2023-11-22,8440
2385,群光,246,10,236,摩根大通,2023-11-22,8440
6285,啟��,245,13,232,摩根大通,2023-11-22,8440
2883,凱基金,14279,8055,6224,摩根大通,2023-11-23,8440
2353,宏��,4437,2100,2337,摩根大通,2023-11-23,8440
2618,長榮航,2385,1067,1318,摩根大通,2023-11-23,8440
2313,華通,1735,590,1145,摩根大通,2023-11-23,8440
3362,先進光,1285,236,1049,摩根大通,2023-11-23,8440
1605,華新,1548,602,946,摩根大通,2023-11-23,8440
5880,合庫金,947,2,945,摩根大通,2023-11-23,8440
4904,遠傳,955,42,913,摩根大通,2023-11-23,8440
2515,中工,825,0,825,摩根大通,2023-11-23,8440
2376,技嘉,882,94,788,摩根大通,2023-11-23,8440
6271,同欣電,806,21,785,摩根大通,2023-11-23,8440
2312,金寶,851,75,776,摩根大通,2023-11-23,8440
3548,兆利,855,87,768,摩根大通,2023-11-23,8440
2356,英業達,1383,676,707,摩根大通,2023-11-23,8440
2880,華南金,899,208,691,摩根大通,2023-11-23,8440
5351,鈺創,1681,1028,653,摩根大通,2023-11-23,8440
3019,亞光,620,41,579,摩根大通,2023-11-23,8440
2317,鴻海,742,179,563,摩根大通,2023-11-23,8440
3035,智原,722,166,556,摩根大通,2023-11-23,8440
2105,正新,820,285,535,摩根大通,2023-11-23,8440
5512,力麒,576,42,534,摩根大通,2023-11-23,8440
2340,台亞,621,91,530,摩根大通,2023-11-23,8440
2801,彰銀,520,23,497,摩根大通,2023-11-23,8440
2371,大同,478,12,466,摩根大通,2023-11-23,8440
2401,凌陽,987,547,440,摩根大通,2023-11-23,8440
3231,緯創,862,426,436,摩根大通,2023-11-23,8440
3711,日月光投控,901,488,413,摩根大通,2023-11-23,8440
2886,兆豐金,606,197,409,摩根大通,2023-11-23,8440
2330,台積電,1636,1232,404,摩根大通,2023-11-23,8440
3227,原相,599,205,394,摩根大通,2023-11-23,8440
2887,台新金,381,1,380,摩根大通,2023-11-23,8440
6415,矽力*-KY,436,64,372,摩根大通,2023-11-23,8440
2324,仁寶,418,62,356,摩根大通,2023-11-23,8440
8183,精星,469,122,347,摩根大通,2023-11-23,8440
1444,力麗,328,0,328,摩根大通,2023-11-23,8440
3701,大眾控,338,29,309,摩根大通,2023-11-23,8440
6237,驊訊,420,119,301,摩根大通,2023-11-23,8440
3694,海華,888,588,300,摩根大通,2023-11-23,8440
2603,長榮,795,502,293,摩根大通,2023-11-23,8440
2206,三陽工業,334,56,278,摩根大通,2023-11-23,8440
6805,富世達,282,12,270,摩根大通,2023-11-23,8440
1785,光洋科,304,40,264,摩根大通,2023-11-23,8440
2812,台中銀,268,5,263,摩根大通,2023-11-23,8440
3147,大綜,526,271,255,摩根大通,2023-11-23,8440
6789,采鈺,330,76,254,摩根大通,2023-11-23,8440
4958,臻鼎-KY,378,128,250,摩根大通,2023-11-23,8440
4967,十銓,371,125,246,摩根大通,2023-11-23,8440
6245,立端,599,362,237,摩根大通,2023-11-23,8440
2606,裕民,335,107,228,摩根大通,2023-11-23,8440
6770,力積電,262,39,223,摩根大通,2023-11-23,8440
2891,中信金,3878,1106,2772,摩根大通,2023-11-24,8440
2330,台積電,1996,162,1834,摩根大通,2023-11-24,8440
2317,鴻海,1806,5,1801,摩根大通,2023-11-24,8440
3711,日月光投控,1697,185,1512,摩根大通,2023-11-24,8440
2885,元大金,2446,944,1502,摩根大通,2023-11-24,8440
1216,統一,2023,679,1344,摩根大通,2023-11-24,8440
6235,華孚,1507,412,1095,摩根大通,2023-11-24,8440
3702,大聯大,1163,89,1074,摩根大通,2023-11-24,8440
1402,遠東新,1500,440,1060,摩根大通,2023-11-24,8440
5880,合庫金,1380,331,1049,摩根大通,2023-11-24,8440
5347,世界,2026,1056,970,摩根大通,2023-11-24,8440
2887,台新金,1016,50,966,摩根大通,2023-11-24,8440
3548,兆利,1207,241,966,摩根大通,2023-11-24,8440
2002,中鋼,2394,1445,949,摩根大通,2023-11-24,8440
1514,亞力,1387,475,912,摩根大通,2023-11-24,8440
2880,華南金,1162,314,848,摩根大通,2023-11-24,8440
3047,訊舟,973,232,741,摩根大通,2023-11-24,8440
5876,上海商銀,712,19,693,摩根大通,2023-11-24,8440
2324,仁寶,1088,418,670,摩根大通,2023-11-24,8440
2892,第一金,1358,729,629,摩根大通,2023-11-24,8440
2890,永豐金,1011,382,629,摩根大通,2023-11-24,8440
2884,玉山金,944,326,618,摩根大通,2023-11-24,8440
4904,遠傳,750,144,606,摩根大通,2023-11-24,8440
8936,國統,642,52,590,摩根大通,2023-11-24,8440
2303,聯電,2512,1955,557,摩根大通,2023-11-24,8440
6505,台塑化,617,61,556,摩根大通,2023-11-24,8440
2371,大同,748,193,555,摩根大通,2023-11-24,8440
2308,台達電,859,340,519,摩根大通,2023-11-24,8440
2634,漢翔,951,445,506,摩根大通,2023-11-24,8440
2392,正崴,578,78,500,摩根大通,2023-11-24,8440
2105,正新,806,315,491,摩根大通,2023-11-24,8440
2881,富邦金,531,60,471,摩根大通,2023-11-24,8440
1312,國喬,430,0,430,摩根大通,2023-11-24,8440
6284,佳邦,463,57,406,摩根大通,2023-11-24,8440
2801,彰銀,407,8,399,摩根大通,2023-11-24,8440
8086,宏捷科,603,222,381,摩根大通,2023-11-24,8440
1326,台化,336,0,336,摩根大通,2023-11-24,8440
2312,金寶,395,66,329,摩根大通,2023-11-24,8440
2606,裕民,378,59,319,摩根大通,2023-11-24,8440
2882,國泰金,785,475,310,摩根大通,2023-11-24,8440
2603,長榮,672,374,298,摩根大通,2023-11-24,8440
9945,潤泰新,402,111,291,摩根大通,2023-11-24,8440
6805,富世達,280,3,277,摩根大通,2023-11-24,8440
5009,榮剛,268,8,260,摩根大通,2023-11-24,8440
2357,華碩,349,95,254,摩根大通,2023-11-24,8440
3059,華晶科,287,36,251,摩根大通,2023-11-24,8440
2327,國巨,441,191,250,摩根大通,2023-11-24,8440
4938,和碩,303,53,250,摩根大通,2023-11-24,8440
2886,兆豐金,845,616,229,摩根大通,2023-11-24,8440
8110,華東,248,26,222,摩根大通,2023-11-24,8440
2329,華泰,3137,29,3108,摩根大通,2023-11-27,8440
2888,新光金,3266,530,2736,摩根大通,2023-11-27,8440
2330,台積電,2852,495,2357,摩根大通,2023-11-27,8440
2353,宏��,3714,1405,2309,摩根大通,2023-11-27,8440
2313,華通,3015,767,2248,摩根大通,2023-11-27,8440
2886,兆豐金,2436,225,2211,摩根大通,2023-11-27,8440
5880,合庫金,2065,136,1929,摩根大通,2023-11-27,8440
2317,鴻海,1775,32,1743,摩根大通,2023-11-27,8440
3711,日月光投控,1774,189,1585,摩根大通,2023-11-27,8440
2891,中信金,2003,496,1507,摩根大通,2023-11-27,8440
3682,亞太電,1507,0,1507,摩根大通,2023-11-27,8440
2002,中鋼,2022,727,1295,摩根大通,2023-11-27,8440
3715,定穎投控,1509,268,1241,摩根大通,2023-11-27,8440
5876,上海商銀,1485,260,1225,摩根大通,2023-11-27,8440
2801,彰銀,1355,196,1159,摩根大通,2023-11-27,8440
2880,華南金,1372,388,984,摩根大通,2023-11-27,8440
2892,第一金,1203,241,962,摩根大通,2023-11-27,8440
2883,凱基金,11283,10328,955,摩根大通,2023-11-27,8440
2890,永豐金,1171,291,880,摩根大通,2023-11-27,8440
2356,英業達,1280,414,866,摩根大通,2023-11-27,8440
2409,友達,862,45,817,摩根大通,2023-11-27,8440
2105,正新,1392,591,801,摩根大通,2023-11-27,8440
2884,玉山金,1168,409,759,摩根大通,2023-11-27,8440
2408,南亞科,728,6,722,摩根大通,2023-11-27,8440
2392,正崴,676,64,612,摩根大通,2023-11-27,8440
2887,台新金,874,283,591,摩根大通,2023-11-27,8440
2881,富邦金,648,58,590,摩根大通,2023-11-27,8440
3702,大聯大,921,360,561,摩根大通,2023-11-27,8440
1605,華新,1096,556,540,摩根大通,2023-11-27,8440
1312,國喬,482,0,482,摩根大通,2023-11-27,8440
2606,裕民,691,213,478,摩根大通,2023-11-27,8440
2454,聯發科,982,512,470,摩根大通,2023-11-27,8440
2355,敬鵬,518,55,463,摩根大通,2023-11-27,8440
1402,遠東新,1007,557,450,摩根大通,2023-11-27,8440
1513,中興電,975,529,446,摩根大通,2023-11-27,8440
4938,和碩,609,191,418,摩根大通,2023-11-27,8440
8046,南電,431,27,404,摩根大通,2023-11-27,8440
1102,亞泥,658,255,403,摩根大通,2023-11-27,8440
1326,台化,415,14,401,摩根大通,2023-11-27,8440
2885,元大金,1076,676,400,摩根大通,2023-11-27,8440
3704,合勤控,556,166,390,摩根大通,2023-11-27,8440
3545,敦泰,409,20,389,摩根大通,2023-11-27,8440
8086,宏捷科,1002,619,383,摩根大通,2023-11-27,8440
3045,台灣大,606,224,382,摩根大通,2023-11-27,8440
2369,菱生,428,58,370,摩根大通,2023-11-27,8440
1714,和桐,322,0,322,摩根大通,2023-11-27,8440
3362,先進光,462,141,321,摩根大通,2023-11-27,8440
2603,長榮,554,240,314,摩根大通,2023-11-27,8440
4958,臻鼎-KY,323,40,283,摩根大通,2023-11-27,8440
1444,力麗,280,6,274,摩根大通,2023-11-27,8440
2409,友達,4485,484,4001,摩根大通,2023-11-28,8440
2883,凱基金,9639,5789,3850,摩根大通,2023-11-28,8440
2887,台新金,4026,300,3726,摩根大通,2023-11-28,8440
2329,華泰,4050,726,3324,摩根大通,2023-11-28,8440
2885,元大金,3351,162,3189,摩根大通,2023-11-28,8440
2002,中鋼,4596,1674,2922,摩根大通,2023-11-28,8440
2886,兆豐金,3049,312,2737,摩根大通,2023-11-28,8440
2330,台積電,3317,746,2571,摩根大通,2023-11-28,8440
2353,宏��,2638,448,2190,摩根大通,2023-11-28,8440
3711,日月光投控,2526,346,2180,摩根大通,2023-11-28,8440
2880,華南金,3071,975,2096,摩根大通,2023-11-28,8440
2884,玉山金,3206,1192,2014,摩根大通,2023-11-28,8440
2890,永豐金,2824,839,1985,摩根大通,2023-11-28,8440
2801,彰銀,2039,83,1956,摩根大通,2023-11-28,8440
2882,國泰金,2559,706,1853,摩根大通,2023-11-28,8440
2892,第一金,3156,1377,1779,摩根大通,2023-11-28,8440
5880,合庫金,2786,1055,1731,摩根大通,2023-11-28,8440
2891,中信金,5729,4123,1606,摩根大通,2023-11-28,8440
2881,富邦金,1835,292,1543,摩根大通,2023-11-28,8440
2408,南亞科,1583,77,1506,摩根大通,2023-11-28,8440
2834,臺企銀,1645,145,1500,摩根大通,2023-11-28,8440
2344,華邦電,1797,311,1486,摩根大通,2023-11-28,8440
4904,遠傳,2286,827,1459,摩根大通,2023-11-28,8440
2356,英業達,1849,408,1441,摩根大通,2023-11-28,8440
2317,鴻海,2192,789,1403,摩根大通,2023-11-28,8440
2888,新光金,2386,1008,1378,摩根大通,2023-11-28,8440
3481,群創,1796,433,1363,摩根大通,2023-11-28,8440
3035,智原,1781,440,1341,摩根大通,2023-11-28,8440
6770,力積電,1421,141,1280,摩根大通,2023-11-28,8440
2609,陽明,1643,494,1149,摩根大通,2023-11-28,8440
1216,統一,2193,1106,1087,摩根大通,2023-11-28,8440
3231,緯創,1233,177,1056,摩根大通,2023-11-28,8440
3702,大聯大,1131,112,1019,摩根大通,2023-11-28,8440
5876,上海商銀,1379,416,963,摩根大通,2023-11-28,8440
1303,南亞,1601,713,888,摩根大通,2023-11-28,8440
3682,亞太電,854,0,854,摩根大通,2023-11-28,8440
2014,中鴻,970,152,818,摩根大通,2023-11-28,8440
3548,兆利,971,246,725,摩根大通,2023-11-28,8440
2498,宏達電,782,60,722,摩根大通,2023-11-28,8440
1402,遠東新,1293,593,700,摩根大通,2023-11-28,8440
9919,康那香,1398,701,697,摩根大通,2023-11-28,8440
1802,台玻,776,110,666,摩根大通,2023-11-28,8440
2449,京元電子,675,21,654,摩根大通,2023-11-28,8440
1301,台塑,803,150,653,摩根大通,2023-11-28,8440
3017,奇鋐,747,98,649,摩根大通,2023-11-28,8440
2845,遠東銀,625,2,623,摩根大通,2023-11-28,8440
2474,可成,672,49,623,摩根大通,2023-11-28,8440
1582,信錦,588,16,572,摩根大通,2023-11-28,8440
3051,力特,648,77,571,摩根大通,2023-11-28,8440
6173,信昌電,593,35,558,摩根大通,2023-11-28,8440
2891,中信金,11630,1772,9858,摩根大通,2023-11-29,8440
2883,凱基金,7681,3615,4066,摩根大通,2023-11-29,8440
2330,台積電,5825,1821,4004,摩根大通,2023-11-29,8440
2317,鴻海,3747,133,3614,摩根大通,2023-11-29,8440
2303,聯電,4856,1282,3574,摩根大通,2023-11-29,8440
2002,中鋼,4048,1375,2673,摩根大通,2023-11-29,8440
2884,玉山金,4177,1675,2502,摩根大通,2023-11-29,8440
2412,中華電,2920,785,2135,摩根大通,2023-11-29,8440
3711,日月光投控,3467,1533,1934,摩根大通,2023-11-29,8440
2887,台新金,3338,1426,1912,摩根大通,2023-11-29,8440
2886,兆豐金,3668,1778,1890,摩根大通,2023-11-29,8440
2356,英業達,2429,724,1705,摩根大通,2023-11-29,8440
3682,亞太電,1392,0,1392,摩根大通,2023-11-29,8440
2881,富邦金,2375,1016,1359,摩根大通,2023-11-29,8440
1303,南亞,1709,539,1170,摩根大通,2023-11-29,8440
3045,台灣大,1603,447,1156,摩根大通,2023-11-29,8440
2882,國泰金,2513,1436,1077,摩根大通,2023-11-29,8440
0050,元大台灣50,1073,0,1073,摩根大通,2023-11-29,8440
2409,友達,2976,1949,1027,摩根大通,2023-11-29,8440
3231,緯創,1159,137,1022,摩根大通,2023-11-29,8440
3035,智原,1276,392,884,摩根大通,2023-11-29,8440
1504,東元,1067,231,836,摩根大通,2023-11-29,8440
2357,華碩,848,26,822,摩根大通,2023-11-29,8440
8054,安國,1207,408,799,摩根大通,2023-11-29,8440
2344,華邦電,1704,922,782,摩根大通,2023-11-29,8440
2603,長榮,951,170,781,摩根大通,2023-11-29,8440
1216,統一,2363,1614,749,摩根大通,2023-11-29,8440
1102,亞泥,990,252,738,摩根大通,2023-11-29,8440
8086,宏捷科,808,80,728,摩根大通,2023-11-29,8440
6770,力積電,1075,388,687,摩根大通,2023-11-29,8440
2382,廣達,1868,1190,678,摩根大通,2023-11-29,8440
4908,前鼎,765,88,677,摩根大通,2023-11-29,8440
1326,台化,996,381,615,摩根大通,2023-11-29,8440
1301,台塑,908,349,559,摩根大通,2023-11-29,8440
2371,大同,912,376,536,摩根大通,2023-11-29,8440
6191,精成科,611,76,535,摩根大通,2023-11-29,8440
2308,台達電,713,179,534,摩根大通,2023-11-29,8440
1605,華新,1255,726,529,摩根大通,2023-11-29,8440
2105,正新,1036,511,525,摩根大通,2023-11-29,8440
6213,聯茂,534,21,513,摩根大通,2023-11-29,8440
2492,華新科,804,315,489,摩根大通,2023-11-29,8440
3094,聯傑,705,233,472,摩根大通,2023-11-29,8440
2890,永豐金,2000,1530,470,摩根大通,2023-11-29,8440
2436,偉詮電,815,352,463,摩根大通,2023-11-29,8440
4958,臻鼎-KY,551,89,462,摩根大通,2023-11-29,8440
2367,燿華,570,121,449,摩根大通,2023-11-29,8440
4167,松瑞藥,443,7,436,摩根大通,2023-11-29,8440
2324,仁寶,1041,611,430,摩根大通,2023-11-29,8440
2301,光寶科,938,514,424,摩根大通,2023-11-29,8440
2845,遠東銀,524,105,419,摩根大通,2023-11-29,8440
2883,凱基金,23330,3503,19827,摩根大通,2023-11-30,8440
2834,臺企銀,17217,554,16663,摩根大通,2023-11-30,8440
2891,中信金,22828,8245,14583,摩根大通,2023-11-30,8440
2882,國泰金,16689,4386,12303,摩根大通,2023-11-30,8440
2884,玉山金,17577,6186,11391,摩根大通,2023-11-30,8440
3481,群創,14086,5221,8865,摩根大通,2023-11-30,8440
2887,台新金,17144,8433,8711,摩根大通,2023-11-30,8440
2363,矽統,10761,2529,8232,摩根大通,2023-11-30,8440
2317,鴻海,10335,4595,5740,摩根大通,2023-11-30,8440
6770,力積電,7086,1409,5677,摩根大通,2023-11-30,8440
2881,富邦金,8315,3584,4731,摩根大通,2023-11-30,8440
2329,華泰,5868,2503,3365,摩根大通,2023-11-30,8440
3715,定穎投控,4878,1619,3259,摩根大通,2023-11-30,8440
3682,亞太電,3059,0,3059,摩根大通,2023-11-30,8440
1301,台塑,3849,1347,2502,摩根大通,2023-11-30,8440
2105,正新,3107,661,2446,摩根大通,2023-11-30,8440
3702,大聯大,4245,1975,2270,摩根大通,2023-11-30,8440
6191,精成科,2580,355,2225,摩根大通,2023-11-30,8440
2867,三商壽,2108,0,2108,摩根大通,2023-11-30,8440
2474,可成,3055,958,2097,摩根大通,2023-11-30,8440
2886,兆豐金,10629,8546,2083,摩根大通,2023-11-30,8440
4938,和碩,1854,210,1644,摩根大通,2023-11-30,8440
3704,合勤控,1750,200,1550,摩根大通,2023-11-30,8440
4904,遠傳,4957,3435,1522,摩根大通,2023-11-30,8440
3661,世芯-KY,2956,1642,1314,摩根大通,2023-11-30,8440
6139,亞翔,1406,188,1218,摩根大通,2023-11-30,8440
2618,長榮航,3670,2476,1194,摩根大通,2023-11-30,8440
0050,元大台灣50,1164,0,1164,摩根大通,2023-11-30,8440
8086,宏捷科,1898,777,1121,摩根大通,2023-11-30,8440
8069,元太,1489,380,1109,摩根大通,2023-11-30,8440
2376,技嘉,1535,445,1090,摩根大通,2023-11-30,8440
2027,大成鋼,1070,42,1028,摩根大通,2023-11-30,8440
6223,旺矽,1453,454,999,摩根大通,2023-11-30,8440
3044,健鼎,1042,85,957,摩根大通,2023-11-30,8440
6125,廣運,1194,301,893,摩根大通,2023-11-30,8440
3036,文曄,892,50,842,摩根大通,2023-11-30,8440
5351,鈺創,857,45,812,摩根大通,2023-11-30,8440
8927,北基,1344,572,772,摩根大通,2023-11-30,8440
5009,榮剛,1236,469,767,摩根大通,2023-11-30,8440
2344,華邦電,2297,1562,735,摩根大通,2023-11-30,8440
9910,豐泰,1013,280,733,摩根大通,2023-11-30,8440
2385,群光,1579,849,730,摩根大通,2023-11-30,8440
3545,敦泰,1009,281,728,摩根大通,2023-11-30,8440
2345,智邦,947,323,624,摩根大通,2023-11-30,8440
9904,寶成,1089,468,621,摩根大通,2023-11-30,8440
6806,森崴能源,628,49,579,摩根大通,2023-11-30,8440
1605,華新,1642,1087,555,摩根大通,2023-11-30,8440
9919,康那香,1109,572,537,摩根大通,2023-11-30,8440
2401,凌陽,854,325,529,摩根大通,2023-11-30,8440
3363,上詮,638,120,518,摩根大通,2023-11-30,8440
2609,陽明,3023,378,2645,摩根大通,2023-12-01,8440
2313,華通,1714,71,1643,摩根大通,2023-12-01,8440
2330,台積電,3851,2238,1613,摩根大通,2023-12-01,8440
2344,華邦電,1611,56,1555,摩根大通,2023-12-01,8440
2605,新興,1903,494,1409,摩根大通,2023-12-01,8440
2421,建準,1226,12,1214,摩根大通,2023-12-01,8440
2601,益航,1192,14,1178,摩根大通,2023-12-01,8440
2606,裕民,1887,749,1138,摩根大通,2023-12-01,8440
3682,亞太電,1106,0,1106,摩根大通,2023-12-01,8440
2352,佳世達,1100,38,1062,摩根大通,2023-12-01,8440
3013,晟銘電,1221,289,932,摩根大通,2023-12-01,8440
2353,宏��,1626,715,911,摩根大通,2023-12-01,8440
0050,元大台灣50,852,0,852,摩根大通,2023-12-01,8440
2615,萬海,935,175,760,摩根大通,2023-12-01,8440
4167,松瑞藥,907,196,711,摩根大通,2023-12-01,8440
2105,正新,821,120,701,摩根大通,2023-12-01,8440
6282,康舒,691,15,676,摩根大通,2023-12-01,8440
5608,四維航,940,266,674,摩根大通,2023-12-01,8440
2637,慧洋-KY,771,109,662,摩根大通,2023-12-01,8440
1102,亞泥,711,60,651,摩根大通,2023-12-01,8440
5388,中磊,569,61,508,摩根大通,2023-12-01,8440
2382,廣達,1460,989,471,摩根大通,2023-12-01,8440
2610,華航,782,316,466,摩根大通,2023-12-01,8440
1618,合機,659,205,454,摩根大通,2023-12-01,8440
2476,鉅祥,738,300,438,摩根大通,2023-12-01,8440
2388,威盛,1102,680,422,摩根大通,2023-12-01,8440
2889,國票金,416,0,416,摩根大通,2023-12-01,8440
3005,神基,693,278,415,摩根大通,2023-12-01,8440
2206,三陽工業,431,35,396,摩根大通,2023-12-01,8440
3711,日月光投控,1265,874,391,摩根大通,2023-12-01,8440
2385,群光,400,41,359,摩根大通,2023-12-01,8440
2612,中航,399,54,345,摩根大通,2023-12-01,8440
2369,菱生,448,106,342,摩根大通,2023-12-01,8440
3051,力特,390,55,335,摩根大通,2023-12-01,8440
1440,南紡,341,13,328,摩根大通,2023-12-01,8440
3264,欣銓,324,0,324,摩根大通,2023-12-01,8440
2603,長榮,570,247,323,摩根大通,2023-12-01,8440
8112,至上,382,70,312,摩根大通,2023-12-01,8440
2887,台新金,1145,838,307,摩根大通,2023-12-01,8440
8069,元太,387,98,289,摩根大通,2023-12-01,8440
2357,華碩,327,40,287,摩根大通,2023-12-01,8440
2883,凱基金,3023,2751,272,摩根大通,2023-12-01,8440
2363,矽統,797,538,259,摩根大通,2023-12-01,8440
3231,緯創,1852,1598,254,摩根大通,2023-12-01,8440
4532,瑞智,247,0,247,摩根大通,2023-12-01,8440
3715,定穎投控,1852,1617,235,摩根大通,2023-12-01,8440
2882,國泰金,956,745,211,摩根大通,2023-12-01,8440
2617,台航,245,35,210,摩根大通,2023-12-01,8440
3059,華晶科,230,21,209,摩根大通,2023-12-01,8440
3032,偉訓,298,95,203,摩根大通,2023-12-01,8440
2382,廣達,3568,881,2687,摩根大通,2023-12-04,8440
2883,凱基金,3075,947,2128,摩根大通,2023-12-04,8440
2409,友達,2938,1000,1938,摩根大通,2023-12-04,8440
2330,台積電,3252,1399,1853,摩根大通,2023-12-04,8440
3702,大聯大,1862,244,1618,摩根大通,2023-12-04,8440
2408,南亞科,1852,380,1472,摩根大通,2023-12-04,8440
3231,緯創,2848,1638,1210,摩根大通,2023-12-04,8440
2603,長榮,1361,187,1174,摩根大通,2023-12-04,8440
5880,合庫金,1418,294,1124,摩根大通,2023-12-04,8440
2609,陽明,2703,1584,1119,摩根大通,2023-12-04,8440
3260,威剛,1072,60,1012,摩根大通,2023-12-04,8440
2618,長榮航,1926,1039,887,摩根大通,2023-12-04,8440
2383,台光電,1056,196,860,摩根大通,2023-12-04,8440
2356,英業達,1239,410,829,摩根大通,2023-12-04,8440
9945,潤泰新,884,144,740,摩根大通,2023-12-04,8440
4157,太景*-KY,800,91,709,摩根大通,2023-12-04,8440
8150,南茂,705,5,700,摩根大通,2023-12-04,8440
1907,永豐餘,953,256,697,摩根大通,2023-12-04,8440
2449,京元電子,640,130,510,摩根大通,2023-12-04,8440
6117,迎廣,967,496,471,摩根大通,2023-12-04,8440
3047,訊舟,552,83,469,摩根大通,2023-12-04,8440
2633,台灣高鐵,493,51,442,摩根大通,2023-12-04,8440
2344,華邦電,472,43,429,摩根大通,2023-12-04,8440
2915,潤泰全,476,48,428,摩根大通,2023-12-04,8440
2607,榮運,434,15,419,摩根大通,2023-12-04,8440
6121,新普,432,23,409,摩根大通,2023-12-04,8440
1608,華榮,454,48,406,摩根大通,2023-12-04,8440
1440,南紡,444,41,403,摩根大通,2023-12-04,8440
5439,高技,766,369,397,摩根大通,2023-12-04,8440
6116,彩晶,462,74,388,摩根大通,2023-12-04,8440
1560,中砂,456,69,387,摩根大通,2023-12-04,8440
2357,華碩,402,19,383,摩根大通,2023-12-04,8440
3017,奇鋐,538,162,376,摩根大通,2023-12-04,8440
2308,台達電,569,197,372,摩根大通,2023-12-04,8440
6669,緯穎,442,76,366,摩根大通,2023-12-04,8440
6147,頎邦,385,26,359,摩根大通,2023-12-04,8440
1718,中纖,353,0,353,摩根大通,2023-12-04,8440
2889,國票金,344,0,344,摩根大通,2023-12-04,8440
2208,台船,439,99,340,摩根大通,2023-12-04,8440
2645,長榮航太,361,26,335,摩根大通,2023-12-04,8440
2812,台中銀,341,7,334,摩根大通,2023-12-04,8440
1904,正隆,338,20,318,摩根大通,2023-12-04,8440
6789,采鈺,414,101,313,摩根大通,2023-12-04,8440
2014,中鴻,335,23,312,摩根大通,2023-12-04,8440
6143,振曜,472,186,286,摩根大通,2023-12-04,8440
6016,康和證,286,13,273,摩根大通,2023-12-04,8440
4142,國光生,304,34,270,摩根大通,2023-12-04,8440
1513,中興電,393,141,252,摩根大通,2023-12-04,8440
6120,達運,257,5,252,摩根大通,2023-12-04,8440
1312,國喬,262,11,251,摩根大通,2023-12-04,8440
2605,新興,3772,1301,2471,摩根大通,2023-12-05,8440
2301,光寶科,3447,1145,2302,摩根大通,2023-12-05,8440
3711,日月光投控,2517,515,2002,摩根大通,2023-12-05,8440
2891,中信金,4139,2143,1996,摩根大通,2023-12-05,8440
2883,凱基金,1844,154,1690,摩根大通,2023-12-05,8440
2002,中鋼,1657,111,1546,摩根大通,2023-12-05,8440
2886,兆豐金,2249,767,1482,摩根大通,2023-12-05,8440
2885,元大金,2264,975,1289,摩根大通,2023-12-05,8440
9958,世紀鋼,1311,49,1262,摩根大通,2023-12-05,8440
2382,廣達,1393,275,1118,摩根大通,2023-12-05,8440
2887,台新金,1064,69,995,摩根大通,2023-12-05,8440
2344,華邦電,1056,175,881,摩根大通,2023-12-05,8440
2329,華泰,2078,1235,843,摩根大通,2023-12-05,8440
2867,三商壽,730,13,717,摩根大通,2023-12-05,8440
2356,英業達,1181,517,664,摩根大通,2023-12-05,8440
3702,大聯大,775,119,656,摩根大通,2023-12-05,8440
6415,矽力*-KY,759,148,611,摩根大通,2023-12-05,8440
4904,遠傳,897,315,582,摩根大通,2023-12-05,8440
2385,群光,683,114,569,摩根大通,2023-12-05,8440
1303,南亞,1253,689,564,摩根大通,2023-12-05,8440
9904,寶成,1350,824,526,摩根大通,2023-12-05,8440
2313,華通,905,391,514,摩根大通,2023-12-05,8440
2454,聯發科,651,157,494,摩根大通,2023-12-05,8440
1519,華城,855,370,485,摩根大通,2023-12-05,8440
3037,欣興,740,276,464,摩根大通,2023-12-05,8440
2308,台達電,1444,1016,428,摩根大通,2023-12-05,8440
2421,建準,493,85,408,摩根大通,2023-12-05,8440
8086,宏捷科,1580,1200,380,摩根大通,2023-12-05,8440
2458,義隆,390,23,367,摩根大通,2023-12-05,8440
1319,東陽,540,196,344,摩根大通,2023-12-05,8440
3013,晟銘電,787,446,341,摩根大通,2023-12-05,8440
6805,富世達,336,9,327,摩根大通,2023-12-05,8440
1326,台化,354,29,325,摩根大通,2023-12-05,8440
3044,健鼎,354,32,322,摩根大通,2023-12-05,8440
4919,新唐,331,11,320,摩根大通,2023-12-05,8440
2845,遠東銀,353,36,317,摩根大通,2023-12-05,8440
3706,神達,589,276,313,摩根大通,2023-12-05,8440
6138,茂達,309,2,307,摩根大通,2023-12-05,8440
5483,中美晶,296,8,288,摩根大通,2023-12-05,8440
4746,台耀,369,84,285,摩根大通,2023-12-05,8440
4113,聯上,293,8,285,摩根大通,2023-12-05,8440
4763,材料-KY,321,37,284,摩根大通,2023-12-05,8440
4167,松瑞藥,528,244,284,摩根大通,2023-12-05,8440
4915,致伸,333,50,283,摩根大通,2023-12-05,8440
6239,力成,364,87,277,摩根大通,2023-12-05,8440
2809,京城銀,353,80,273,摩根大通,2023-12-05,8440
1582,信錦,389,130,259,摩根大通,2023-12-05,8440
2520,冠德,281,22,259,摩根大通,2023-12-05,8440
3450,聯鈞,363,105,258,摩根大通,2023-12-05,8440
2357,華碩,339,84,255,摩根大通,2023-12-05,8440
2891,中信金,7143,2491,4652,摩根大通,2023-12-06,8440
2884,玉山金,3834,960,2874,摩根大通,2023-12-06,8440
2353,宏��,1745,37,1708,摩根大通,2023-12-06,8440
2606,裕民,2713,1114,1599,摩根大通,2023-12-06,8440
2641,正德,1454,53,1401,摩根大通,2023-12-06,8440
2605,新興,3677,2282,1395,摩根大通,2023-12-06,8440
2355,敬鵬,2024,731,1293,摩根大通,2023-12-06,8440
2885,元大金,1688,493,1195,摩根大通,2023-12-06,8440
3260,威剛,1232,45,1187,摩根大通,2023-12-06,8440
3711,日月光投控,1143,38,1105,摩根大通,2023-12-06,8440
00929,復華台灣科技優息,1016,0,1016,摩根大通,2023-12-06,8440
5608,四維航,1117,103,1014,摩根大通,2023-12-06,8440
1514,亞力,1378,417,961,摩根大通,2023-12-06,8440
2801,彰銀,948,0,948,摩根大通,2023-12-06,8440
2886,兆豐金,3105,2249,856,摩根大通,2023-12-06,8440
1907,永豐餘,861,16,845,摩根大通,2023-12-06,8440
5880,合庫金,951,143,808,摩根大通,2023-12-06,8440
2834,臺企銀,811,5,806,摩根大通,2023-12-06,8440
4904,遠傳,1215,410,805,摩根大通,2023-12-06,8440
2882,國泰金,1116,350,766,摩根大通,2023-12-06,8440
3702,大聯大,865,115,750,摩根大通,2023-12-06,8440
2002,中鋼,1076,326,750,摩根大通,2023-12-06,8440
2883,凱基金,998,269,729,摩根大通,2023-12-06,8440
2812,台中銀,746,19,727,摩根大通,2023-12-06,8440
2887,台新金,1018,321,697,摩根大通,2023-12-06,8440
2601,益航,794,169,625,摩根大通,2023-12-06,8440
2880,華南金,1221,598,623,摩根大通,2023-12-06,8440
2376,技嘉,743,159,584,摩根大通,2023-12-06,8440
2317,鴻海,827,266,561,摩根大通,2023-12-06,8440
6415,矽力*-KY,734,191,543,摩根大通,2023-12-06,8440
2890,永豐金,695,178,517,摩根大通,2023-12-06,8440
3044,健鼎,578,118,460,摩根大通,2023-12-06,8440
2612,中航,640,181,459,摩根大通,2023-12-06,8440
2392,正崴,449,3,446,摩根大通,2023-12-06,8440
3051,力特,898,463,435,摩根大通,2023-12-06,8440
6150,撼訊,504,97,407,摩根大通,2023-12-06,8440
1301,台塑,465,78,387,摩根大通,2023-12-06,8440
2356,英業達,1417,1032,385,摩根大通,2023-12-06,8440
2845,遠東銀,362,0,362,摩根大通,2023-12-06,8440
2889,國票金,352,0,352,摩根大通,2023-12-06,8440
6112,邁達特,375,24,351,摩根大通,2023-12-06,8440
3047,訊舟,369,22,347,摩根大通,2023-12-06,8440
2892,第一金,1316,972,344,摩根大通,2023-12-06,8440
5521,工信,509,199,310,摩根大通,2023-12-06,8440
8086,宏捷科,430,124,306,摩根大通,2023-12-06,8440
2637,慧洋-KY,491,196,295,摩根大通,2023-12-06,8440
2915,潤泰全,339,60,279,摩根大通,2023-12-06,8440
00830,國泰費城半導體,275,0,275,摩根大通,2023-12-06,8440
6191,精成科,323,79,244,摩根大通,2023-12-06,8440
2206,三陽工業,254,11,243,摩根大通,2023-12-06,8440
1514,亞力,4062,1043,3019,摩根大通,2023-12-07,8440
2891,中信金,2578,198,2380,摩根大通,2023-12-07,8440
3711,日月光投控,2796,492,2304,摩根大通,2023-12-07,8440
2313,華通,2231,825,1406,摩根大通,2023-12-07,8440
2409,友達,1973,826,1147,摩根大通,2023-12-07,8440
3231,緯創,1627,500,1127,摩根大通,2023-12-07,8440
2449,京元電子,1058,6,1052,摩根大通,2023-12-07,8440
2892,第一金,1107,58,1049,摩根大通,2023-12-07,8440
2355,敬鵬,1135,207,928,摩根大通,2023-12-07,8440
1519,華城,1731,807,924,摩根大通,2023-12-07,8440
2312,金寶,1517,637,880,摩根大通,2023-12-07,8440
2886,兆豐金,1793,929,864,摩根大通,2023-12-07,8440
2330,台積電,1289,431,858,摩根大通,2023-12-07,8440
2887,台新金,846,90,756,摩根大通,2023-12-07,8440
3702,大聯大,912,164,748,摩根大通,2023-12-07,8440
2845,遠東銀,718,0,718,摩根大通,2023-12-07,8440
5871,中租-KY,718,35,683,摩根大通,2023-12-07,8440
2376,技嘉,1044,373,671,摩根大通,2023-12-07,8440
2356,英業達,1561,898,663,摩根大通,2023-12-07,8440
8069,元太,653,14,639,摩根大通,2023-12-07,8440
2382,廣達,828,297,531,摩根大通,2023-12-07,8440
2408,南亞科,565,42,523,摩根大通,2023-12-07,8440
6415,矽力*-KY,680,190,490,摩根大通,2023-12-07,8440
2367,燿華,954,497,457,摩根大通,2023-12-07,8440
4306,炎洲,446,6,440,摩根大通,2023-12-07,8440
2371,大同,942,520,422,摩根大通,2023-12-07,8440
1616,億泰,550,148,402,摩根大通,2023-12-07,8440
3479,安勤,502,115,387,摩根大通,2023-12-07,8440
2883,凱基金,401,41,360,摩根大通,2023-12-07,8440
2368,金像電,457,102,355,摩根大通,2023-12-07,8440
1216,統一,435,82,353,摩根大通,2023-12-07,8440
8936,國統,525,179,346,摩根大通,2023-12-07,8440
9958,世紀鋼,429,83,346,摩根大通,2023-12-07,8440
4938,和碩,361,38,323,摩根大通,2023-12-07,8440
2352,佳世達,403,91,312,摩根大通,2023-12-07,8440
2369,菱生,302,0,302,摩根大通,2023-12-07,8440
3017,奇鋐,402,106,296,摩根大通,2023-12-07,8440
5876,上海商銀,366,77,289,摩根大通,2023-12-07,8440
1319,東陽,612,326,286,摩根大通,2023-12-07,8440
2388,威盛,993,708,285,摩根大通,2023-12-07,8440
2359,所羅門,498,233,265,摩根大通,2023-12-07,8440
1815,富喬,263,1,262,摩根大通,2023-12-07,8440
6547,高端疫苗,321,60,261,摩根大通,2023-12-07,8440
5452,佶優,288,36,252,摩根大通,2023-12-07,8440
3533,嘉澤,263,20,243,摩根大通,2023-12-07,8440
3290,東浦,250,7,243,摩根大通,2023-12-07,8440
4533,協易機,286,55,231,摩根大通,2023-12-07,8440
5269,祥碩,259,30,229,摩根大通,2023-12-07,8440
2314,台揚,248,22,226,摩根大通,2023-12-07,8440
2637,慧洋-KY,297,86,211,摩根大通,2023-12-07,8440
2618,長榮航,7013,1146,5867,摩根大通,2023-12-08,8440
3711,日月光投控,3195,1038,2157,摩根大通,2023-12-08,8440
3078,僑威,2179,156,2023,摩根大通,2023-12-08,8440
2891,中信金,2530,656,1874,摩根大通,2023-12-08,8440
0050,元大台灣50,1824,0,1824,摩根大通,2023-12-08,8440
2027,大成鋼,1818,70,1748,摩根大通,2023-12-08,8440
6285,啟��,1602,83,1519,摩根大通,2023-12-08,8440
2401,凌陽,1200,57,1143,摩根大通,2023-12-08,8440
8054,安國,1236,103,1133,摩根大通,2023-12-08,8440
3035,智原,1306,195,1111,摩根大通,2023-12-08,8440
1513,中興電,955,62,893,摩根大通,2023-12-08,8440
2884,玉山金,891,85,806,摩根大通,2023-12-08,8440
2605,新興,2502,1763,739,摩根大通,2023-12-08,8440
2330,台積電,2604,1879,725,摩根大通,2023-12-08,8440
3051,力特,789,121,668,摩根大通,2023-12-08,8440
1612,宏泰,675,17,658,摩根大通,2023-12-08,8440
6415,矽力*-KY,816,181,635,摩根大通,2023-12-08,8440
2610,華航,1103,490,613,摩根大通,2023-12-08,8440
3044,健鼎,637,31,606,摩根大通,2023-12-08,8440
2885,元大金,1476,888,588,摩根大通,2023-12-08,8440
1216,統一,877,348,529,摩根大通,2023-12-08,8440
2454,聯發科,584,82,502,摩根大通,2023-12-08,8440
2834,臺企銀,584,96,488,摩根大通,2023-12-08,8440
2633,台灣高鐵,489,6,483,摩根大通,2023-12-08,8440
6147,頎邦,480,0,480,摩根大通,2023-12-08,8440
6213,聯茂,518,81,437,摩根大通,2023-12-08,8440
1907,永豐餘,456,23,433,摩根大通,2023-12-08,8440
3702,大聯大,405,0,405,摩根大通,2023-12-08,8440
2603,長榮,552,181,371,摩根大通,2023-12-08,8440
2353,宏��,540,170,370,摩根大通,2023-12-08,8440
3260,威剛,354,0,354,摩根大通,2023-12-08,8440
4938,和碩,391,44,347,摩根大通,2023-12-08,8440
2892,第一金,350,6,344,摩根大通,2023-12-08,8440
8096,擎亞,386,46,340,摩根大通,2023-12-08,8440
1618,合機,420,82,338,摩根大通,2023-12-08,8440
2368,金像電,423,96,327,摩根大通,2023-12-08,8440
3189,景碩,343,20,323,摩根大通,2023-12-08,8440
2323,中環,445,127,318,摩根大通,2023-12-08,8440
2358,廷鑫,463,145,318,摩根大通,2023-12-08,8440
1568,倉佑,380,68,312,摩根大通,2023-12-08,8440
2816,旺旺保,407,104,303,摩根大通,2023-12-08,8440
6684,安格,369,88,281,摩根大通,2023-12-08,8440
1560,中砂,292,14,278,摩根大通,2023-12-08,8440
2377,微星,332,69,263,摩根大通,2023-12-08,8440
3234,光環,285,25,260,摩根大通,2023-12-08,8440
5269,祥碩,332,81,251,摩根大通,2023-12-08,8440
2317,鴻海,586,346,240,摩根大通,2023-12-08,8440
2365,昆盈,253,14,239,摩根大通,2023-12-08,8440
5347,世界,267,41,226,摩根大通,2023-12-08,8440
2812,台中銀,224,4,220,摩根大通,2023-12-08,8440
1216,統一,3003,45,2958,摩根大通,2023-12-11,8440
3037,欣興,3257,1284,1973,摩根大通,2023-12-11,8440
2344,華邦電,2492,713,1779,摩根大通,2023-12-11,8440
2884,玉山金,1839,430,1409,摩根大通,2023-12-11,8440
2317,鴻海,1465,433,1032,摩根大通,2023-12-11,8440
2812,台中銀,1034,20,1014,摩根大通,2023-12-11,8440
3702,大聯大,978,61,917,摩根大通,2023-12-11,8440
2105,正新,1848,942,906,摩根大通,2023-12-11,8440
2603,長榮,1002,100,902,摩根大通,2023-12-11,8440
6285,啟��,859,184,675,摩根大通,2023-12-11,8440
2408,南亞科,685,80,605,摩根大通,2023-12-11,8440
6147,頎邦,588,14,574,摩根大通,2023-12-11,8440
2355,敬鵬,650,78,572,摩根大通,2023-12-11,8440
3711,日月光投控,1086,527,559,摩根大通,2023-12-11,8440
2392,正崴,626,94,532,摩根大通,2023-12-11,8440
4904,遠傳,972,471,501,摩根大通,2023-12-11,8440
1618,合機,807,319,488,摩根大通,2023-12-11,8440
1524,耿鼎,1288,832,456,摩根大通,2023-12-11,8440
1514,亞力,966,521,445,摩根大通,2023-12-11,8440
1519,華城,678,251,427,摩根大通,2023-12-11,8440
8034,榮群,447,29,418,摩根大通,2023-12-11,8440
2353,宏��,491,74,417,摩根大通,2023-12-11,8440
2481,強茂,458,41,417,摩根大通,2023-12-11,8440
2352,佳世達,402,19,383,摩根大通,2023-12-11,8440
1513,中興電,423,41,382,摩根大通,2023-12-11,8440
2515,中工,413,55,358,摩根大通,2023-12-11,8440
2492,華新科,577,222,355,摩根大通,2023-12-11,8440
3059,華晶科,356,15,341,摩根大通,2023-12-11,8440
1612,宏泰,637,304,333,摩根大通,2023-12-11,8440
5258,虹堡,348,17,331,摩根大通,2023-12-11,8440
1609,大亞,835,509,326,摩根大通,2023-12-11,8440
3005,神基,477,159,318,摩根大通,2023-12-11,8440
1504,東元,485,168,317,摩根大通,2023-12-11,8440
2385,群光,483,169,314,摩根大通,2023-12-11,8440
3712,永崴投控,327,15,312,摩根大通,2023-12-11,8440
5347,世界,398,86,312,摩根大通,2023-12-11,8440
1582,信錦,315,3,312,摩根大通,2023-12-11,8440
2606,裕民,545,238,307,摩根大通,2023-12-11,8440
2633,台灣高鐵,339,37,302,摩根大通,2023-12-11,8440
3023,信邦,399,103,296,摩根大通,2023-12-11,8440
4938,和碩,314,31,283,摩根大通,2023-12-11,8440
2449,京元電子,576,302,274,摩根大通,2023-12-11,8440
2915,潤泰全,302,31,271,摩根大通,2023-12-11,8440
1440,南紡,280,12,268,摩根大通,2023-12-11,8440
2401,凌陽,352,96,256,摩根大通,2023-12-11,8440
2454,聯發科,401,149,252,摩根大通,2023-12-11,8440
4958,臻鼎-KY,250,4,246,摩根大通,2023-12-11,8440
2383,台光電,271,29,242,摩根大通,2023-12-11,8440
3363,上詮,372,134,238,摩根大通,2023-12-11,8440
3545,敦泰,293,55,238,摩根大通,2023-12-11,8440
2891,中信金,2692,162,2530,摩根大通,2023-12-12,8440
2886,兆豐金,2525,87,2438,摩根大通,2023-12-12,8440
2890,永豐金,3001,844,2157,摩根大通,2023-12-12,8440
2618,長榮航,2892,757,2135,摩根大通,2023-12-12,8440
2885,元大金,2073,512,1561,摩根大通,2023-12-12,8440
2105,正新,1734,269,1465,摩根大通,2023-12-12,8440
6182,合晶,1458,340,1118,摩根大通,2023-12-12,8440
2356,英業達,1447,490,957,摩根大通,2023-12-12,8440
2603,長榮,1598,656,942,摩根大通,2023-12-12,8440
6147,頎邦,975,65,910,摩根大通,2023-12-12,8440
2317,鴻海,1212,326,886,摩根大通,2023-12-12,8440
2002,中鋼,1137,275,862,摩根大通,2023-12-12,8440
2888,新光金,893,98,795,摩根大通,2023-12-12,8440
3035,智原,966,183,783,摩根大通,2023-12-12,8440
2892,第一金,898,140,758,摩根大通,2023-12-12,8440
1584,精剛,1141,385,756,摩根大通,2023-12-12,8440
00929,復華台灣科技優息,670,0,670,摩根大通,2023-12-12,8440
1618,合機,1434,778,656,摩根大通,2023-12-12,8440
6139,亞翔,985,339,646,摩根大通,2023-12-12,8440
2880,華南金,674,33,641,摩根大通,2023-12-12,8440
6770,力積電,823,212,611,摩根大通,2023-12-12,8440
1504,東元,635,64,571,摩根大通,2023-12-12,8440
2887,台新金,682,129,553,摩根大通,2023-12-12,8440
2313,華通,922,395,527,摩根大通,2023-12-12,8440
2353,宏��,544,18,526,摩根大通,2023-12-12,8440
2609,陽明,1286,794,492,摩根大通,2023-12-12,8440
8069,元太,542,85,457,摩根大通,2023-12-12,8440
2352,佳世達,536,88,448,摩根大通,2023-12-12,8440
2408,南亞科,919,521,398,摩根大通,2023-12-12,8440
2392,正崴,953,574,379,摩根大通,2023-12-12,8440
4906,正文,404,27,377,摩根大通,2023-12-12,8440
9919,康那香,371,0,371,摩根大通,2023-12-12,8440
6285,啟��,762,408,354,摩根大通,2023-12-12,8440
4938,和碩,463,116,347,摩根大通,2023-12-12,8440
3051,力特,456,110,346,摩根大通,2023-12-12,8440
2385,群光,594,255,339,摩根大通,2023-12-12,8440
1514,亞力,840,515,325,摩根大通,2023-12-12,8440
6176,瑞儀,328,5,323,摩根大通,2023-12-12,8440
9802,鈺齊-KY,321,5,316,摩根大通,2023-12-12,8440
2204,中華,505,197,308,摩根大通,2023-12-12,8440
8112,至上,769,463,306,摩根大通,2023-12-12,8440
1303,南亞,440,135,305,摩根大通,2023-12-12,8440
1722,台肥,352,49,303,摩根大通,2023-12-12,8440
2449,京元電子,578,278,300,摩根大通,2023-12-12,8440
2812,台中銀,445,149,296,摩根大通,2023-12-12,8440
1102,亞泥,465,169,296,摩根大通,2023-12-12,8440
3265,台星科,342,54,288,摩根大通,2023-12-12,8440
1907,永豐餘,575,305,270,摩根大通,2023-12-12,8440
2301,光寶科,422,187,235,摩根大通,2023-12-12,8440
6505,台塑化,267,38,229,摩根大通,2023-12-12,8440
2891,中信金,9124,2543,6581,摩根大通,2023-12-13,8440
6770,力積電,1980,260,1720,摩根大通,2023-12-13,8440
1907,永豐餘,1720,5,1715,摩根大通,2023-12-13,8440
6147,頎邦,1264,7,1257,摩根大通,2023-12-13,8440
2886,兆豐金,1605,537,1068,摩根大通,2023-12-13,8440
00929,復華台灣科技優息,1034,0,1034,摩根大通,2023-12-13,8440
6285,啟��,1568,554,1014,摩根大通,2023-12-13,8440
2890,永豐金,2625,1712,913,摩根大通,2023-12-13,8440
2313,華通,1311,470,841,摩根大通,2023-12-13,8440
2345,智邦,1083,257,826,摩根大通,2023-12-13,8440
2317,鴻海,1178,362,816,摩根大通,2023-12-13,8440
5521,工信,1088,314,774,摩根大通,2023-12-13,8440
2801,彰銀,957,214,743,摩根大通,2023-12-13,8440
2449,京元電子,736,6,730,摩根大通,2023-12-13,8440
5880,合庫金,990,302,688,摩根大通,2023-12-13,8440
2885,元大金,1320,740,580,摩根大通,2023-12-13,8440
8112,至上,801,317,484,摩根大通,2023-12-13,8440
2425,承啟,556,143,413,摩根大通,2023-12-13,8440
4938,和碩,554,148,406,摩根大通,2023-12-13,8440
2812,台中銀,406,0,406,摩根大通,2023-12-13,8440
3163,波若威,407,12,395,摩根大通,2023-12-13,8440
4906,正文,593,217,376,摩根大通,2023-12-13,8440
2352,佳世達,368,35,333,摩根大通,2023-12-13,8440
2880,華南金,492,166,326,摩根大通,2023-12-13,8440
2312,金寶,388,63,325,摩根大通,2023-12-13,8440
6111,大宇資,404,89,315,摩根大通,2023-12-13,8440
2401,凌陽,314,16,298,摩根大通,2023-12-13,8440
3019,亞光,455,172,283,摩根大通,2023-12-13,8440
1591,駿吉-KY,325,52,273,摩根大通,2023-12-13,8440
6290,良維,268,0,268,摩根大通,2023-12-13,8440
2331,精英,304,59,245,摩根大通,2023-12-13,8440
3704,合勤控,290,53,237,摩根大通,2023-12-13,8440
2204,中華,290,59,231,摩根大通,2023-12-13,8440
5388,中磊,290,61,229,摩根大通,2023-12-13,8440
1582,信錦,233,6,227,摩根大通,2023-12-13,8440
6176,瑞儀,241,15,226,摩根大通,2023-12-13,8440
2454,聯發科,302,80,222,摩根大通,2023-12-13,8440
5381,合正,232,13,219,摩根大通,2023-12-13,8440
2439,美律,257,47,210,摩根大通,2023-12-13,8440
1608,華榮,303,94,209,摩根大通,2023-12-13,8440
3050,鈺德,251,42,209,摩根大通,2023-12-13,8440
4979,華星光,220,14,206,摩根大通,2023-12-13,8440
2882,國泰金,949,746,203,摩根大通,2023-12-13,8440
2387,精元,470,268,202,摩根大通,2023-12-13,8440
3406,玉晶光,222,20,202,摩根大通,2023-12-13,8440
2357,華碩,249,53,196,摩根大通,2023-12-13,8440
2601,益航,211,18,193,摩根大通,2023-12-13,8440
2308,台達電,360,168,192,摩根大通,2023-12-13,8440
2637,慧洋-KY,337,147,190,摩根大通,2023-12-13,8440
3044,健鼎,275,93,182,摩根大通,2023-12-13,8440
2891,中信金,9873,4852,5021,摩根大通,2023-12-14,8440
2883,凱基金,4261,322,3939,摩根大通,2023-12-14,8440
2618,長榮航,3978,343,3635,摩根大通,2023-12-14,8440
2886,兆豐金,3664,81,3583,摩根大通,2023-12-14,8440
5521,工信,4371,830,3541,摩根大通,2023-12-14,8440
2881,富邦金,4315,862,3453,摩根大通,2023-12-14,8440
2002,中鋼,4082,864,3218,摩根大通,2023-12-14,8440
2885,元大金,2558,308,2250,摩根大通,2023-12-14,8440
00929,復華台灣科技優息,2217,0,2217,摩根大通,2023-12-14,8440
2382,廣達,2277,100,2177,摩根大通,2023-12-14,8440
2882,國泰金,2651,576,2075,摩根大通,2023-12-14,8440
0050,元大台灣50,1940,0,1940,摩根大通,2023-12-14,8440
2888,新光金,1958,81,1877,摩根大通,2023-12-14,8440
6147,頎邦,2389,534,1855,摩根大通,2023-12-14,8440
2801,彰銀,1758,5,1753,摩根大通,2023-12-14,8440
2313,華通,2966,1220,1746,摩根大通,2023-12-14,8440
2884,玉山金,1686,158,1528,摩根大通,2023-12-14,8440
1216,統一,1886,385,1501,摩根大通,2023-12-14,8440
1907,永豐餘,1088,18,1070,摩根大通,2023-12-14,8440
4906,正文,1055,33,1022,摩根大通,2023-12-14,8440
3711,日月光投控,1346,332,1014,摩根大通,2023-12-14,8440
6153,嘉聯益,1018,6,1012,摩根大通,2023-12-14,8440
2317,鴻海,1721,736,985,摩根大通,2023-12-14,8440
2352,佳世達,858,1,857,摩根大通,2023-12-14,8440
5880,合庫金,1025,218,807,摩根大通,2023-12-14,8440
2880,華南金,799,0,799,摩根大通,2023-12-14,8440
2498,宏達電,1384,588,796,摩根大通,2023-12-14,8440
6213,聯茂,779,17,762,摩根大通,2023-12-14,8440
2610,華航,1792,1032,760,摩根大通,2023-12-14,8440
1102,亞泥,930,204,726,摩根大通,2023-12-14,8440
2105,正新,1150,509,641,摩根大通,2023-12-14,8440
2845,遠東銀,623,0,623,摩根大通,2023-12-14,8440
2812,台中銀,592,2,590,摩根大通,2023-12-14,8440
2834,臺企銀,663,75,588,摩根大通,2023-12-14,8440
6005,群益證,586,0,586,摩根大通,2023-12-14,8440
1504,東元,735,154,581,摩根大通,2023-12-14,8440
1718,中纖,579,1,578,摩根大通,2023-12-14,8440
2344,華邦電,924,350,574,摩根大通,2023-12-14,8440
1301,台塑,637,70,567,摩根大通,2023-12-14,8440
2363,矽統,951,402,549,摩根大通,2023-12-14,8440
8299,群聯,542,8,534,摩根大通,2023-12-14,8440
2376,技嘉,805,272,533,摩根大通,2023-12-14,8440
5425,台半,654,122,532,摩根大通,2023-12-14,8440
4938,和碩,562,52,510,摩根大通,2023-12-14,8440
2889,國票金,508,0,508,摩根大通,2023-12-14,8440
5483,中美晶,613,110,503,摩根大通,2023-12-14,8440
3041,揚智,505,4,501,摩根大通,2023-12-14,8440
9904,寶成,486,0,486,摩根大通,2023-12-14,8440
9945,潤泰新,462,0,462,摩根大通,2023-12-14,8440
2385,群光,857,397,460,摩根大通,2023-12-14,8440
2344,華邦電,9056,1149,7907,摩根大通,2023-12-15,8440
1402,遠東新,8534,1020,7514,摩根大通,2023-12-15,8440
1504,東元,5981,569,5412,摩根大通,2023-12-15,8440
2885,元大金,5599,637,4962,摩根大通,2023-12-15,8440
5880,合庫金,4861,312,4549,摩根大通,2023-12-15,8440
2330,台積電,8247,4116,4131,摩根大通,2023-12-15,8440
2886,兆豐金,3590,404,3186,摩根大通,2023-12-15,8440
2515,中工,2963,176,2787,摩根大通,2023-12-15,8440
2610,華航,3480,795,2685,摩根大通,2023-12-15,8440
2884,玉山金,3652,990,2662,摩根大通,2023-12-15,8440
2609,陽明,3728,1111,2617,摩根大通,2023-12-15,8440
9945,潤泰新,2823,244,2579,摩根大通,2023-12-15,8440
2883,凱基金,3172,644,2528,摩根大通,2023-12-15,8440
2801,彰銀,2636,121,2515,摩根大通,2023-12-15,8440
2002,中鋼,3313,884,2429,摩根大通,2023-12-15,8440
2382,廣達,3175,750,2425,摩根大通,2023-12-15,8440
1907,永豐餘,2362,49,2313,摩根大通,2023-12-15,8440
2888,新光金,2712,399,2313,摩根大通,2023-12-15,8440
1101,台泥,2879,737,2142,摩根大通,2023-12-15,8440
2890,永豐金,3728,1968,1760,摩根大通,2023-12-15,8440
1216,統一,2069,524,1545,摩根大通,2023-12-15,8440
2881,富邦金,2367,999,1368,摩根大通,2023-12-15,8440
2882,國泰金,2605,1279,1326,摩根大通,2023-12-15,8440
2892,第一金,4062,2769,1293,摩根大通,2023-12-15,8440
5871,中租-KY,1268,21,1247,摩根大通,2023-12-15,8440
2606,裕民,1311,79,1232,摩根大通,2023-12-15,8440
5425,台半,1601,431,1170,摩根大通,2023-12-15,8440
6005,群益證,1330,180,1150,摩根大通,2023-12-15,8440
1303,南亞,1315,219,1096,摩根大通,2023-12-15,8440
6770,力積電,1765,731,1034,摩根大通,2023-12-15,8440
9904,寶成,1064,30,1034,摩根大通,2023-12-15,8440
2845,遠東銀,1130,109,1021,摩根大通,2023-12-15,8440
1584,精剛,1373,356,1017,摩根大通,2023-12-15,8440
2371,大同,1202,201,1001,摩根大通,2023-12-15,8440
2834,臺企銀,1050,71,979,摩根大通,2023-12-15,8440
1301,台塑,995,38,957,摩根大通,2023-12-15,8440
1802,台玻,1147,243,904,摩根大通,2023-12-15,8440
2867,三商壽,898,0,898,摩根大通,2023-12-15,8440
2603,長榮,1455,561,894,摩根大通,2023-12-15,8440
5876,上海商銀,937,77,860,摩根大通,2023-12-15,8440
2408,南亞科,1935,1079,856,摩根大通,2023-12-15,8440
0050,元大台灣50,845,0,845,摩根大通,2023-12-15,8440
6239,力成,1064,227,837,摩根大通,2023-12-15,8440
2303,聯電,5834,4997,837,摩根大通,2023-12-15,8440
2618,長榮航,1309,482,827,摩根大通,2023-12-15,8440
2501,國建,902,81,821,摩根大通,2023-12-15,8440
2368,金像電,874,56,818,摩根大通,2023-12-15,8440
2412,中華電,1145,328,817,摩根大通,2023-12-15,8440
2915,潤泰全,729,13,716,摩根大通,2023-12-15,8440
1326,台化,868,164,704,摩根大通,2023-12-15,8440
2609,陽明,9630,5510,4120,摩根大通,2023-12-18,8440
2603,長榮,5535,2682,2853,摩根大通,2023-12-18,8440
2606,裕民,3279,528,2751,摩根大通,2023-12-18,8440
2382,廣達,3258,763,2495,摩根大通,2023-12-18,8440
2890,永豐金,2711,239,2472,摩根大通,2023-12-18,8440
00830,國泰費城半導體,1823,0,1823,摩根大通,2023-12-18,8440
2891,中信金,3858,2101,1757,摩根大通,2023-12-18,8440
2324,仁寶,2661,1082,1579,摩根大通,2023-12-18,8440
3037,欣興,2300,785,1515,摩根大通,2023-12-18,8440
1216,統一,1541,119,1422,摩根大通,2023-12-18,8440
2385,群光,1309,143,1166,摩根大通,2023-12-18,8440
1907,永豐餘,1432,291,1141,摩根大通,2023-12-18,8440
2615,萬海,2860,1750,1110,摩根大通,2023-12-18,8440
2353,宏��,1862,895,967,摩根大通,2023-12-18,8440
2880,華南金,976,48,928,摩根大通,2023-12-18,8440
2376,技嘉,940,66,874,摩根大通,2023-12-18,8440
9105,泰金寶-DR,1062,258,804,摩根大通,2023-12-18,8440
3231,緯創,1565,852,713,摩根大通,2023-12-18,8440
2884,玉山金,1155,449,706,摩根大通,2023-12-18,8440
3702,大聯大,1174,493,681,摩根大通,2023-12-18,8440
2607,榮運,843,197,646,摩根大通,2023-12-18,8440
2383,台光電,756,128,628,摩根大通,2023-12-18,8440
8112,至上,731,184,547,摩根大通,2023-12-18,8440
1101,台泥,562,16,546,摩根大通,2023-12-18,8440
2892,第一金,666,128,538,摩根大通,2023-12-18,8440
9904,寶成,585,63,522,摩根大通,2023-12-18,8440
2354,鴻準,619,107,512,摩根大通,2023-12-18,8440
1303,南亞,855,357,498,摩根大通,2023-12-18,8440
6443,元晶,598,144,454,摩根大通,2023-12-18,8440
6176,瑞儀,528,97,431,摩根大通,2023-12-18,8440
8046,南電,639,219,420,摩根大通,2023-12-18,8440
1905,華紙,1262,846,416,摩根大通,2023-12-18,8440
6770,力積電,752,344,408,摩根大通,2023-12-18,8440
4919,新唐,424,27,397,摩根大通,2023-12-18,8440
2636,台驊控股,479,101,378,摩根大通,2023-12-18,8440
2388,威盛,557,187,370,摩根大通,2023-12-18,8440
2412,中華電,373,7,366,摩根大通,2023-12-18,8440
3711,日月光投控,592,238,354,摩根大通,2023-12-18,8440
9802,鈺齊-KY,406,56,350,摩根大通,2023-12-18,8440
6275,元山,442,99,343,摩根大通,2023-12-18,8440
2903,遠百,334,11,323,摩根大通,2023-12-18,8440
2357,華碩,423,102,321,摩根大通,2023-12-18,8440
5483,中美晶,445,129,316,摩根大通,2023-12-18,8440
6153,嘉聯益,311,7,304,摩根大通,2023-12-18,8440
3017,奇鋐,399,98,301,摩根大通,2023-12-18,8440
3715,定穎投控,379,97,282,摩根大通,2023-12-18,8440
2458,義隆,305,44,261,摩根大通,2023-12-18,8440
3264,欣銓,300,42,258,摩根大通,2023-12-18,8440
2369,菱生,332,77,255,摩根大通,2023-12-18,8440
5522,遠雄,255,6,249,摩根大通,2023-12-18,8440
2353,宏��,7194,1459,5735,摩根大通,2023-12-19,8440
2609,陽明,8941,3696,5245,摩根大通,2023-12-19,8440
2890,永豐金,4446,731,3715,摩根大通,2023-12-19,8440
2382,廣達,3860,1190,2670,摩根大通,2023-12-19,8440
2618,長榮航,2681,493,2188,摩根大通,2023-12-19,8440
2607,榮運,2760,1018,1742,摩根大通,2023-12-19,8440
3481,群創,2172,601,1571,摩根大通,2023-12-19,8440
2606,裕民,1554,304,1250,摩根大通,2023-12-19,8440
2002,中鋼,1820,851,969,摩根大通,2023-12-19,8440
1216,統一,1042,136,906,摩根大通,2023-12-19,8440
5871,中租-KY,1131,228,903,摩根大通,2023-12-19,8440
2884,玉山金,857,98,759,摩根大通,2023-12-19,8440
3037,欣興,858,104,754,摩根大通,2023-12-19,8440
3293,鈊象,805,97,708,摩根大通,2023-12-19,8440
1907,永豐餘,714,12,702,摩根大通,2023-12-19,8440
2385,群光,833,135,698,摩根大通,2023-12-19,8440
3006,晶豪科,1031,352,679,摩根大通,2023-12-19,8440
2383,台光電,789,135,654,摩根大通,2023-12-19,8440
1101,台泥,835,260,575,摩根大通,2023-12-19,8440
3715,定穎投控,604,70,534,摩根大通,2023-12-19,8440
3036,文曄,534,36,498,摩根大通,2023-12-19,8440
3189,景碩,433,28,405,摩根大通,2023-12-19,8440
3051,力特,569,165,404,摩根大通,2023-12-19,8440
1314,中石化,402,10,392,摩根大通,2023-12-19,8440
1503,士電,440,59,381,摩根大通,2023-12-19,8440
6239,力成,558,198,360,摩根大通,2023-12-19,8440
6120,達運,384,42,342,摩根大通,2023-12-19,8440
2454,聯發科,406,75,331,摩根大通,2023-12-19,8440
2903,遠百,354,27,327,摩根大通,2023-12-19,8440
3044,健鼎,322,29,293,摩根大通,2023-12-19,8440
2329,華泰,461,182,279,摩根大通,2023-12-19,8440
8112,至上,612,334,278,摩根大通,2023-12-19,8440
2204,中華,289,13,276,摩根大通,2023-12-19,8440
8936,國統,470,195,275,摩根大通,2023-12-19,8440
4766,南寶,290,22,268,摩根大通,2023-12-19,8440
3264,欣銓,308,44,264,摩根大通,2023-12-19,8440
6153,嘉聯益,325,64,261,摩根大通,2023-12-19,8440
3533,嘉澤,273,24,249,摩根大通,2023-12-19,8440
6789,采鈺,263,15,248,摩根大通,2023-12-19,8440
8085,福華,286,56,230,摩根大通,2023-12-19,8440
5521,工信,1474,1253,221,摩根大通,2023-12-19,8440
3217,優群,207,0,207,摩根大通,2023-12-19,8440
8046,南電,318,133,185,摩根大通,2023-12-19,8440
2303,聯電,1799,1615,184,摩根大通,2023-12-19,8440
3228,金麗科,222,41,181,摩根大通,2023-12-19,8440
6669,緯穎,198,20,178,摩根大通,2023-12-19,8440
5522,遠雄,271,97,174,摩根大通,2023-12-19,8440
2022,聚亨,472,302,170,摩根大通,2023-12-19,8440
2395,研華,249,82,167,摩根大通,2023-12-19,8440
2476,鉅祥,168,10,158,摩根大通,2023-12-19,8440
3231,緯創,10777,1279,9498,摩根大通,2023-12-20,8440
2609,陽明,12026,3432,8594,摩根大通,2023-12-20,8440
2382,廣達,8134,903,7231,摩根大通,2023-12-20,8440
2312,金寶,5173,465,4708,摩根大通,2023-12-20,8440
2615,萬海,4882,513,4369,摩根大通,2023-12-20,8440
2317,鴻海,5683,1399,4284,摩根大通,2023-12-20,8440
3481,群創,4272,457,3815,摩根大通,2023-12-20,8440
2618,長榮航,3965,693,3272,摩根大通,2023-12-20,8440
2002,中鋼,3977,1499,2478,摩根大通,2023-12-20,8440
2883,凱基金,2564,247,2317,摩根大通,2023-12-20,8440
6443,元晶,2731,534,2197,摩根大通,2023-12-20,8440
3711,日月光投控,2494,503,1991,摩根大通,2023-12-20,8440
2352,佳世達,2124,196,1928,摩根大通,2023-12-20,8440
2313,華通,1924,226,1698,摩根大通,2023-12-20,8440
2357,華碩,1518,147,1371,摩根大通,2023-12-20,8440
2371,大同,1343,107,1236,摩根大通,2023-12-20,8440
3037,欣興,1401,171,1230,摩根大通,2023-12-20,8440
2610,華航,1736,567,1169,摩根大通,2023-12-20,8440
2027,大成鋼,1475,450,1025,摩根大通,2023-12-20,8440
2845,遠東銀,1032,32,1000,摩根大通,2023-12-20,8440
6005,群益證,1109,231,878,摩根大通,2023-12-20,8440
3189,景碩,877,55,822,摩根大通,2023-12-20,8440
3264,欣銓,909,133,776,摩根大通,2023-12-20,8440
2308,台達電,900,166,734,摩根大通,2023-12-20,8440
5521,工信,1171,503,668,摩根大通,2023-12-20,8440
1216,統一,802,170,632,摩根大通,2023-12-20,8440
2387,精元,677,51,626,摩根大通,2023-12-20,8440
0050,元大台灣50,602,0,602,摩根大通,2023-12-20,8440
6770,力積電,593,15,578,摩根大通,2023-12-20,8440
1907,永豐餘,721,143,578,摩根大通,2023-12-20,8440
3706,神達,609,42,567,摩根大通,2023-12-20,8440
1514,亞力,554,30,524,摩根大通,2023-12-20,8440
2301,光寶科,1935,1415,520,摩根大通,2023-12-20,8440
2330,台積電,2263,1768,495,摩根大通,2023-12-20,8440
3036,文曄,515,46,469,摩根大通,2023-12-20,8440
5347,世界,484,22,462,摩根大通,2023-12-20,8440
8210,勤誠,524,71,453,摩根大通,2023-12-20,8440
2368,金像電,490,82,408,摩根大通,2023-12-20,8440
2383,台光電,609,214,395,摩根大通,2023-12-20,8440
4961,天鈺,420,37,383,摩根大通,2023-12-20,8440
2406,國碩,392,35,357,摩根大通,2023-12-20,8440
6244,茂迪,471,114,357,摩根大通,2023-12-20,8440
2323,中環,810,454,356,摩根大通,2023-12-20,8440
2345,智邦,606,253,353,摩根大通,2023-12-20,8440
2889,國票金,383,39,344,摩根大通,2023-12-20,8440
4968,立積,437,95,342,摩根大通,2023-12-20,8440
2606,裕民,882,541,341,摩根大通,2023-12-20,8440
5371,中光電,341,0,341,摩根大通,2023-12-20,8440
8085,福華,1584,1245,339,摩根大通,2023-12-20,8440
6116,彩晶,388,60,328,摩根大通,2023-12-20,8440
2609,陽明,13738,3939,9799,摩根大通,2023-12-21,8440
2515,中工,6252,598,5654,摩根大通,2023-12-21,8440
3231,緯創,5663,2031,3632,摩根大通,2023-12-21,8440
2353,宏��,7152,3656,3496,摩根大通,2023-12-21,8440
2382,廣達,3394,994,2400,摩根大通,2023-12-21,8440
3481,群創,2781,718,2063,摩根大通,2023-12-21,8440
2801,彰銀,2066,46,2020,摩根大通,2023-12-21,8440
3037,欣興,1864,45,1819,摩根大通,2023-12-21,8440
1907,永豐餘,1899,108,1791,摩根大通,2023-12-21,8440
3702,大聯大,1089,229,860,摩根大通,2023-12-21,8440
2408,南亞科,982,154,828,摩根大通,2023-12-21,8440
3189,景碩,826,17,809,摩根大通,2023-12-21,8440
2383,台光電,797,98,699,摩根大通,2023-12-21,8440
2344,華邦電,1695,1038,657,摩根大通,2023-12-21,8440
6005,群益證,662,20,642,摩根大通,2023-12-21,8440
2345,智邦,606,4,602,摩根大通,2023-12-21,8440
2301,光寶科,698,113,585,摩根大通,2023-12-21,8440
2606,裕民,625,50,575,摩根大通,2023-12-21,8440
2014,中鴻,799,277,522,摩根大通,2023-12-21,8440
2421,建準,541,35,506,摩根大通,2023-12-21,8440
2376,技嘉,566,77,489,摩根大通,2023-12-21,8440
3545,敦泰,545,80,465,摩根大通,2023-12-21,8440
4979,華星光,458,38,420,摩根大通,2023-12-21,8440
2542,興富發,457,60,397,摩根大通,2023-12-21,8440
5371,中光電,405,16,389,摩根大通,2023-12-21,8440
5522,遠雄,410,24,386,摩根大通,2023-12-21,8440
8054,安國,521,173,348,摩根大通,2023-12-21,8440
9802,鈺齊-KY,358,28,330,摩根大通,2023-12-21,8440
5521,工信,898,588,310,摩根大通,2023-12-21,8440
2449,京元電子,583,289,294,摩根大通,2023-12-21,8440
2368,金像電,313,20,293,摩根大通,2023-12-21,8440
2637,慧洋-KY,393,103,290,摩根大通,2023-12-21,8440
1326,台化,306,26,280,摩根大通,2023-12-21,8440
3715,定穎投控,338,71,267,摩根大通,2023-12-21,8440
3346,麗清,336,73,263,摩根大通,2023-12-21,8440
2884,玉山金,513,261,252,摩根大通,2023-12-21,8440
6799,來頡,278,31,247,摩根大通,2023-12-21,8440
4904,遠傳,311,69,242,摩根大通,2023-12-21,8440
2809,京城銀,369,130,239,摩根大通,2023-12-21,8440
6770,力積電,275,50,225,摩根大通,2023-12-21,8440
6505,台塑化,234,14,220,摩根大通,2023-12-21,8440
3711,日月光投控,442,229,213,摩根大通,2023-12-21,8440
1444,力麗,202,0,202,摩根大通,2023-12-21,8440
5469,瀚宇博,216,15,201,摩根大通,2023-12-21,8440
4919,新唐,226,28,198,摩根大通,2023-12-21,8440
6274,台燿,787,597,190,摩根大通,2023-12-21,8440
2845,遠東銀,195,6,189,摩根大通,2023-12-21,8440
3036,文曄,277,93,184,摩根大通,2023-12-21,8440
3489,森寶,175,1,174,摩根大通,2023-12-21,8440
6233,旺玖,171,1,170,摩根大通,2023-12-21,8440
2609,陽明,19089,6491,12598,摩根大通,2023-12-22,8440
2610,華航,9419,167,9252,摩根大通,2023-12-22,8440
2615,萬海,7299,812,6487,摩根大通,2023-12-22,8440
2330,台積電,3706,333,3373,摩根大通,2023-12-22,8440
2353,宏��,3853,1035,2818,摩根大通,2023-12-22,8440
2801,彰銀,2499,47,2452,摩根大通,2023-12-22,8440
5425,台半,1906,61,1845,摩根大通,2023-12-22,8440
2324,仁寶,3566,1729,1837,摩根大通,2023-12-22,8440
2409,友達,3065,1342,1723,摩根大通,2023-12-22,8440
2344,華邦電,3116,1717,1399,摩根大通,2023-12-22,8440
2382,廣達,2576,1324,1252,摩根大通,2023-12-22,8440
3481,群創,2591,1376,1215,摩根大通,2023-12-22,8440
1102,亞泥,1228,232,996,摩根大通,2023-12-22,8440
2498,宏達電,1105,209,896,摩根大通,2023-12-22,8440
3006,晶豪科,1098,297,801,摩根大通,2023-12-22,8440
8069,元太,989,196,793,摩根大通,2023-12-22,8440
2886,兆豐金,1269,506,763,摩根大通,2023-12-22,8440
2357,華碩,842,82,760,摩根大通,2023-12-22,8440
6770,力積電,961,219,742,摩根大通,2023-12-22,8440
6116,彩晶,841,211,630,摩根大通,2023-12-22,8440
3346,麗清,974,353,621,摩根大通,2023-12-22,8440
2890,永豐金,1052,501,551,摩根大通,2023-12-22,8440
3702,大聯大,840,303,537,摩根大通,2023-12-22,8440
2884,玉山金,493,57,436,摩根大通,2023-12-22,8440
2606,裕民,612,177,435,摩根大通,2023-12-22,8440
9105,泰金寶-DR,799,374,425,摩根大通,2023-12-22,8440
5371,中光電,404,0,404,摩根大通,2023-12-22,8440
2383,台光電,474,88,386,摩根大通,2023-12-22,8440
3305,昇貿,441,73,368,摩根大通,2023-12-22,8440
2618,長榮航,663,298,365,摩根大通,2023-12-22,8440
2402,毅嘉,367,33,334,摩根大通,2023-12-22,8440
6285,啟��,420,118,302,摩根大通,2023-12-22,8440
2408,南亞科,944,643,301,摩根大通,2023-12-22,8440
2352,佳世達,327,30,297,摩根大通,2023-12-22,8440
2506,太設,350,67,283,摩根大通,2023-12-22,8440
6462,神盾,469,194,275,摩根大通,2023-12-22,8440
3037,欣興,289,20,269,摩根大通,2023-12-22,8440
2331,精英,449,185,264,摩根大通,2023-12-22,8440
3014,聯陽,297,34,263,摩根大通,2023-12-22,8440
1733,五鼎,267,14,253,摩根大通,2023-12-22,8440
5289,宜鼎,259,7,252,摩根大通,2023-12-22,8440
5522,遠雄,277,34,243,摩根大通,2023-12-22,8440
3017,奇鋐,260,21,239,摩根大通,2023-12-22,8440
3211,順達,229,0,229,摩根大通,2023-12-22,8440
2489,瑞軒,246,17,229,摩根大通,2023-12-22,8440
2809,京城銀,264,36,228,摩根大通,2023-12-22,8440
2611,志信,323,109,214,摩根大通,2023-12-22,8440
8054,安國,513,317,196,摩根大通,2023-12-22,8440
5521,工信,398,224,174,摩根大通,2023-12-22,8440
6274,台燿,314,145,169,摩根大通,2023-12-22,8440
2356,英業達,6205,3222,2983,摩根大通,2023-12-25,8440
0050,元大台灣50,2775,0,2775,摩根大通,2023-12-25,8440
2324,仁寶,3353,1654,1699,摩根大通,2023-12-25,8440
3231,緯創,1747,231,1516,摩根大通,2023-12-25,8440
2801,彰銀,1039,31,1008,摩根大通,2023-12-25,8440
2834,臺企銀,612,9,603,摩根大通,2023-12-25,8440
3714,富采,330,0,330,摩根大通,2023-12-25,8440
2002,中鋼,352,65,287,摩根大通,2023-12-25,8440
2605,新興,532,259,273,摩根大通,2023-12-25,8440
2891,中信金,564,322,242,摩根大通,2023-12-25,8440
2454,聯發科,256,20,236,摩根大通,2023-12-25,8440
5880,合庫金,243,14,229,摩根大通,2023-12-25,8440
8088,品安,350,132,218,摩根大通,2023-12-25,8440
8054,安國,209,0,209,摩根大通,2023-12-25,8440
4938,和碩,211,8,203,摩根大通,2023-12-25,8440
3006,晶豪科,330,128,202,摩根大通,2023-12-25,8440
5347,世界,218,26,192,摩根大通,2023-12-25,8440
2880,華南金,209,17,192,摩根大通,2023-12-25,8440
2376,技嘉,251,69,182,摩根大通,2023-12-25,8440
2393,億光,155,0,155,摩根大通,2023-12-25,8440
2032,新鋼,184,39,145,摩根大通,2023-12-25,8440
2323,中環,186,48,138,摩根大通,2023-12-25,8440
4960,誠美材,136,0,136,摩根大通,2023-12-25,8440
3702,大聯大,228,94,134,摩根大通,2023-12-25,8440
2312,金寶,330,208,122,摩根大通,2023-12-25,8440
2408,南亞科,187,65,122,摩根大通,2023-12-25,8440
2007,燁興,152,32,120,摩根大通,2023-12-25,8440
3045,台灣大,155,38,117,摩根大通,2023-12-25,8440
6548,長科*,116,1,115,摩根大通,2023-12-25,8440
2884,玉山金,135,21,114,摩根大通,2023-12-25,8440
3325,旭品,217,103,114,摩根大通,2023-12-25,8440
5608,四維航,131,23,108,摩根大通,2023-12-25,8440
6187,萬潤,110,2,108,摩根大通,2023-12-25,8440
6104,創惟,123,16,107,摩根大通,2023-12-25,8440
5371,中光電,104,0,104,摩根大通,2023-12-25,8440
1560,中砂,116,16,100,摩根大通,2023-12-25,8440
6274,台燿,126,27,99,摩根大通,2023-12-25,8440
8936,國統,124,26,98,摩根大通,2023-12-25,8440
2344,華邦電,254,159,95,摩根大通,2023-12-25,8440
2327,國巨,109,15,94,摩根大通,2023-12-25,8440
8068,全達,94,1,93,摩根大通,2023-12-25,8440
2402,毅嘉,142,53,89,摩根大通,2023-12-25,8440
2892,第一金,151,63,88,摩根大通,2023-12-25,8440
2618,長榮航,292,204,88,摩根大通,2023-12-25,8440
2633,台灣高鐵,97,9,88,摩根大通,2023-12-25,8440
5426,振發,87,0,87,摩根大通,2023-12-25,8440
3141,晶宏,183,99,84,摩根大通,2023-12-25,8440
2330,台積電,826,743,83,摩根大通,2023-12-25,8440
2890,永豐金,72,0,72,摩根大通,2023-12-25,8440
6257,矽格,100,29,71,摩根大通,2023-12-25,8440
2353,宏��,11722,1223,10499,摩根大通,2023-12-26,8440
2409,友達,6026,258,5768,摩根大通,2023-12-26,8440
0050,元大台灣50,4485,0,4485,摩根大通,2023-12-26,8440
3481,群創,6492,2320,4172,摩根大通,2023-12-26,8440
2891,中信金,3616,41,3575,摩根大通,2023-12-26,8440
2888,新光金,2922,151,2771,摩根大通,2023-12-26,8440
2324,仁寶,4249,1913,2336,摩根大通,2023-12-26,8440
2405,輔信,3327,1128,2199,摩根大通,2023-12-26,8440
2884,玉山金,2209,22,2187,摩根大通,2023-12-26,8440
2303,聯電,1913,31,1882,摩根大通,2023-12-26,8440
2880,華南金,1691,48,1643,摩根大通,2023-12-26,8440
2408,南亞科,1891,256,1635,摩根大通,2023-12-26,8440
5521,工信,1629,230,1399,摩根大通,2023-12-26,8440
2330,台積電,1437,279,1158,摩根大通,2023-12-26,8440
1560,中砂,1237,90,1147,摩根大通,2023-12-26,8440
2882,國泰金,1145,48,1097,摩根大通,2023-12-26,8440
2885,元大金,1260,268,992,摩根大通,2023-12-26,8440
2317,鴻海,996,16,980,摩根大通,2023-12-26,8440
6116,彩晶,1199,258,941,摩根大通,2023-12-26,8440
2890,永豐金,1115,186,929,摩根大通,2023-12-26,8440
2867,三商壽,915,0,915,摩根大通,2023-12-26,8440
5880,合庫金,1114,257,857,摩根大通,2023-12-26,8440
2615,萬海,1199,373,826,摩根大通,2023-12-26,8440
3024,憶聲,1028,251,777,摩根大通,2023-12-26,8440
2637,慧洋-KY,762,57,705,摩根大通,2023-12-26,8440
2881,富邦金,993,288,705,摩根大通,2023-12-26,8440
2312,金寶,870,179,691,摩根大通,2023-12-26,8440
6288,聯嘉,716,38,678,摩根大通,2023-12-26,8440
3711,日月光投控,684,76,608,摩根大通,2023-12-26,8440
3037,欣興,590,53,537,摩根大通,2023-12-26,8440
6770,力積電,540,12,528,摩根大通,2023-12-26,8440
9934,成霖,538,33,505,摩根大通,2023-12-26,8440
6756,威鋒電子,662,165,497,摩根大通,2023-12-26,8440
1216,統一,492,42,450,摩根大通,2023-12-26,8440
6182,合晶,444,0,444,摩根大通,2023-12-26,8440
2886,兆豐金,663,243,420,摩根大通,2023-12-26,8440
2014,中鴻,464,50,414,摩根大通,2023-12-26,8440
3094,聯傑,419,12,407,摩根大通,2023-12-26,8440
2889,國票金,417,10,407,摩根大通,2023-12-26,8440
8050,廣積,401,1,400,摩根大通,2023-12-26,8440
3019,亞光,470,79,391,摩根大通,2023-12-26,8440
1504,東元,550,167,383,摩根大通,2023-12-26,8440
2002,中鋼,874,527,347,摩根大通,2023-12-26,8440
5210,寶碩,387,45,342,摩根大通,2023-12-26,8440
2617,台航,410,77,333,摩根大通,2023-12-26,8440
6505,台塑化,363,41,322,摩根大通,2023-12-26,8440
5876,上海商銀,455,138,317,摩根大通,2023-12-26,8440
6274,台燿,445,143,302,摩根大通,2023-12-26,8440
2023,燁輝,320,19,301,摩根大通,2023-12-26,8440
2606,裕民,408,107,301,摩根大通,2023-12-26,8440
2303,聯電,14657,22,14635,摩根大通,2023-12-27,8440
0050,元大台灣50,6314,0,6314,摩根大通,2023-12-27,8440
2330,台積電,5312,80,5232,摩根大通,2023-12-27,8440
3481,群創,6486,2513,3973,摩根大通,2023-12-27,8440
2890,永豐金,3886,30,3856,摩根大通,2023-12-27,8440
2888,新光金,4810,962,3848,摩根大通,2023-12-27,8440
2891,中信金,3873,313,3560,摩根大通,2023-12-27,8440
2884,玉山金,3552,34,3518,摩根大通,2023-12-27,8440
2356,英業達,4075,597,3478,摩根大通,2023-12-27,8440
2885,元大金,3022,8,3014,摩根大通,2023-12-27,8440
2887,台新金,2827,16,2811,摩根大通,2023-12-27,8440
2344,華邦電,3142,627,2515,摩根大通,2023-12-27,8440
2002,中鋼,2748,314,2434,摩根大通,2023-12-27,8440
5880,合庫金,2420,93,2327,摩根大通,2023-12-27,8440
2317,鴻海,3341,1063,2278,摩根大通,2023-12-27,8440
2880,華南金,2495,347,2148,摩根大通,2023-12-27,8440
2892,第一金,2680,631,2049,摩根大通,2023-12-27,8440
2882,國泰金,2001,77,1924,摩根大通,2023-12-27,8440
2409,友達,3423,1537,1886,摩根大通,2023-12-27,8440
2886,兆豐金,2477,715,1762,摩根大通,2023-12-27,8440
2408,南亞科,4118,2369,1749,摩根大通,2023-12-27,8440
6770,力積電,1713,2,1711,摩根大通,2023-12-27,8440
1216,統一,1689,1,1688,摩根大通,2023-12-27,8440
2881,富邦金,1652,181,1471,摩根大通,2023-12-27,8440
2603,長榮,1703,361,1342,摩根大通,2023-12-27,8440
2801,彰銀,1669,339,1330,摩根大通,2023-12-27,8440
5876,上海商銀,1274,51,1223,摩根大通,2023-12-27,8440
3094,聯傑,1307,127,1180,摩根大通,2023-12-27,8440
6116,彩晶,1371,193,1178,摩根大通,2023-12-27,8440
1301,台塑,1147,2,1145,摩根大通,2023-12-27,8440
2382,廣達,1457,332,1125,摩根大通,2023-12-27,8440
2834,臺企銀,1137,21,1116,摩根大通,2023-12-27,8440
2357,華碩,1213,100,1113,摩根大通,2023-12-27,8440
2399,映泰,1133,65,1068,摩根大通,2023-12-27,8440
1326,台化,1031,36,995,摩根大通,2023-12-27,8440
4938,和碩,1163,213,950,摩根大通,2023-12-27,8440
2609,陽明,1536,607,929,摩根大通,2023-12-27,8440
8069,元太,1042,132,910,摩根大通,2023-12-27,8440
2352,佳世達,890,40,850,摩根大通,2023-12-27,8440
1303,南亞,1293,565,728,摩根大通,2023-12-27,8440
2889,國票金,743,16,727,摩根大通,2023-12-27,8440
2101,南港,831,139,692,摩根大通,2023-12-27,8440
6182,合晶,681,0,681,摩根大通,2023-12-27,8440
2105,正新,732,59,673,摩根大通,2023-12-27,8440
9945,潤泰新,665,0,665,摩根大通,2023-12-27,8440
1402,遠東新,1249,587,662,摩根大通,2023-12-27,8440
2633,台灣高鐵,898,266,632,摩根大通,2023-12-27,8440
5347,世界,872,245,627,摩根大通,2023-12-27,8440
2301,光寶科,636,42,594,摩根大通,2023-12-27,8440
9904,寶成,1044,451,593,摩根大通,2023-12-27,8440
2353,宏��,13159,4058,9101,摩根大通,2023-12-28,8440
2303,聯電,7125,2124,5001,摩根大通,2023-12-28,8440
2891,中信金,4771,152,4619,摩根大通,2023-12-28,8440
2884,玉山金,3428,125,3303,摩根大通,2023-12-28,8440
2324,仁寶,4014,1364,2650,摩根大通,2023-12-28,8440
2409,友達,3046,410,2636,摩根大通,2023-12-28,8440
2330,台積電,3231,844,2387,摩根大通,2023-12-28,8440
2885,元大金,2462,296,2166,摩根大通,2023-12-28,8440
2890,永豐金,2232,411,1821,摩根大通,2023-12-28,8440
3481,群創,2361,543,1818,摩根大通,2023-12-28,8440
2408,南亞科,1929,183,1746,摩根大通,2023-12-28,8440
2887,台新金,1684,53,1631,摩根大通,2023-12-28,8440
2323,中環,2550,940,1610,摩根大通,2023-12-28,8440
2609,陽明,2217,864,1353,摩根大通,2023-12-28,8440
2317,鴻海,1437,127,1310,摩根大通,2023-12-28,8440
2882,國泰金,1308,65,1243,摩根大通,2023-12-28,8440
2892,第一金,1254,126,1128,摩根大通,2023-12-28,8440
5880,合庫金,1164,43,1121,摩根大通,2023-12-28,8440
1519,華城,1219,120,1099,摩根大通,2023-12-28,8440
2886,兆豐金,1372,375,997,摩根大通,2023-12-28,8440
2002,中鋼,1138,195,943,摩根大通,2023-12-28,8440
9945,潤泰新,953,38,915,摩根大通,2023-12-28,8440
2371,大同,1272,369,903,摩根大通,2023-12-28,8440
2888,新光金,1377,533,844,摩根大通,2023-12-28,8440
2867,三商壽,792,25,767,摩根大通,2023-12-28,8440
0050,元大台灣50,737,0,737,摩根大通,2023-12-28,8440
2101,南港,783,79,704,摩根大通,2023-12-28,8440
2880,華南金,1235,550,685,摩根大通,2023-12-28,8440
2881,富邦金,957,277,680,摩根大通,2023-12-28,8440
6005,群益證,709,33,676,摩根大通,2023-12-28,8440
2618,長榮航,731,87,644,摩根大通,2023-12-28,8440
5876,上海商銀,663,115,548,摩根大通,2023-12-28,8440
1101,台泥,879,368,511,摩根大通,2023-12-28,8440
1609,大亞,731,226,505,摩根大通,2023-12-28,8440
1216,統一,540,40,500,摩根大通,2023-12-28,8440
1301,台塑,661,171,490,摩根大通,2023-12-28,8440
4958,臻鼎-KY,511,26,485,摩根大通,2023-12-28,8440
2412,中華電,513,29,484,摩根大通,2023-12-28,8440
1303,南亞,689,230,459,摩根大通,2023-12-28,8440
2801,彰銀,900,453,447,摩根大通,2023-12-28,8440
1504,東元,500,63,437,摩根大通,2023-12-28,8440
2889,國票金,413,14,399,摩根大通,2023-12-28,8440
6116,彩晶,552,156,396,摩根大通,2023-12-28,8440
1326,台化,470,81,389,摩根大通,2023-12-28,8440
6139,亞翔,484,100,384,摩根大通,2023-12-28,8440
6187,萬潤,391,26,365,摩根大通,2023-12-28,8440
6770,力積電,386,30,356,摩根大通,2023-12-28,8440
2006,東和鋼鐵,425,78,347,摩根大通,2023-12-28,8440
1402,遠東新,456,132,324,摩根大通,2023-12-28,8440
2489,瑞軒,316,8,308,摩根大通,2023-12-28,8440
2885,元大金,5327,438,4889,摩根大通,2023-12-29,8440
0050,元大台灣50,3711,0,3711,摩根大通,2023-12-29,8440
3231,緯創,2794,837,1957,摩根大通,2023-12-29,8440
2353,宏��,3799,1963,1836,摩根大通,2023-12-29,8440
2330,台積電,2667,1110,1557,摩根大通,2023-12-29,8440
2888,新光金,1852,305,1547,摩根大通,2023-12-29,8440
2884,玉山金,2186,689,1497,摩根大通,2023-12-29,8440
2317,鴻海,1631,182,1449,摩根大通,2023-12-29,8440
2356,英業達,1783,347,1436,摩根大通,2023-12-29,8440
2891,中信金,2488,1146,1342,摩根大通,2023-12-29,8440
2880,華南金,1549,266,1283,摩根大通,2023-12-29,8440
2887,台新金,1631,358,1273,摩根大通,2023-12-29,8440
2633,台灣高鐵,1329,78,1251,摩根大通,2023-12-29,8440
5876,上海商銀,1349,180,1169,摩根大通,2023-12-29,8440
6415,矽力*-KY,1296,134,1162,摩根大通,2023-12-29,8440
6005,群益證,1156,1,1155,摩根大通,2023-12-29,8440
3017,奇鋐,1171,46,1125,摩根大通,2023-12-29,8440
2867,三商壽,1218,96,1122,摩根大通,2023-12-29,8440
2881,富邦金,1242,158,1084,摩根大通,2023-12-29,8440
2889,國票金,992,0,992,摩根大通,2023-12-29,8440
5880,合庫金,998,32,966,摩根大通,2023-12-29,8440
2609,陽明,1360,407,953,摩根大通,2023-12-29,8440
2892,第一金,1419,547,872,摩根大通,2023-12-29,8440
2890,永豐金,1903,1099,804,摩根大通,2023-12-29,8440
1402,遠東新,759,123,636,摩根大通,2023-12-29,8440
1216,統一,935,332,603,摩根大通,2023-12-29,8440
1101,台泥,782,184,598,摩根大通,2023-12-29,8440
1319,東陽,610,26,584,摩根大通,2023-12-29,8440
4938,和碩,649,116,533,摩根大通,2023-12-29,8440
2002,中鋼,888,369,519,摩根大通,2023-12-29,8440
1326,台化,493,8,485,摩根大通,2023-12-29,8440
2388,威盛,615,137,478,摩根大通,2023-12-29,8440
2886,兆豐金,1581,1130,451,摩根大通,2023-12-29,8440
6770,力積電,574,158,416,摩根大通,2023-12-29,8440
2360,致茂,398,4,394,摩根大通,2023-12-29,8440
3338,泰碩,477,92,385,摩根大通,2023-12-29,8440
6116,彩晶,449,79,370,摩根大通,2023-12-29,8440
3162,精確,358,10,348,摩根大通,2023-12-29,8440
3376,新日興,515,169,346,摩根大通,2023-12-29,8440
2897,王道銀行,344,0,344,摩根大通,2023-12-29,8440
3630,新鉅科,350,14,336,摩根大通,2023-12-29,8440
2365,昆盈,453,139,314,摩根大通,2023-12-29,8440
2357,華碩,334,25,309,摩根大通,2023-12-29,8440
8046,南電,417,110,307,摩根大通,2023-12-29,8440
2409,友達,2151,1879,272,摩根大通,2023-12-29,8440
3715,定穎投控,402,131,271,摩根大通,2023-12-29,8440
2382,廣達,1433,1167,266,摩根大通,2023-12-29,8440
1582,信錦,273,15,258,摩根大通,2023-12-29,8440
2834,臺企銀,354,103,251,摩根大通,2023-12-29,8440
2105,正新,364,133,231,摩根大通,2023-12-29,8440
2618,長榮航,24895,566,24329,摩根大通,2024-01-02,8440
2610,華航,11293,502,10791,摩根大通,2024-01-02,8440
2330,台積電,3163,736,2427,摩根大通,2024-01-02,8440
2603,長榮,2461,908,1553,摩根大通,2024-01-02,8440
2303,聯電,3972,2580,1392,摩根大通,2024-01-02,8440
1514,亞力,1346,168,1178,摩根大通,2024-01-02,8440
3037,欣興,1239,69,1170,摩根大通,2024-01-02,8440
2337,旺宏,1044,16,1028,摩根大通,2024-01-02,8440
0050,元大台灣50,924,0,924,摩根大通,2024-01-02,8440
6223,旺矽,851,13,838,摩根大通,2024-01-02,8440
2890,永豐金,978,146,832,摩根大通,2024-01-02,8440
6770,力積電,919,140,779,摩根大通,2024-01-02,8440
2368,金像電,906,176,730,摩根大通,2024-01-02,8440
9945,潤泰新,967,336,631,摩根大通,2024-01-02,8440
1216,統一,655,37,618,摩根大通,2024-01-02,8440
6116,彩晶,575,16,559,摩根大通,2024-01-02,8440
5009,榮剛,429,6,423,摩根大通,2024-01-02,8440
8011,台通,649,241,408,摩根大通,2024-01-02,8440
1519,華城,456,59,397,摩根大通,2024-01-02,8440
1102,亞泥,418,43,375,摩根大通,2024-01-02,8440
2515,中工,1060,716,344,摩根大通,2024-01-02,8440
9934,成霖,313,13,300,摩根大通,2024-01-02,8440
2206,三陽工業,301,10,291,摩根大通,2024-01-02,8440
2915,潤泰全,344,58,286,摩根大通,2024-01-02,8440
6275,元山,325,48,277,摩根大通,2024-01-02,8440
1904,正隆,281,5,276,摩根大通,2024-01-02,8440
3017,奇鋐,597,352,245,摩根大通,2024-01-02,8440
1582,信錦,246,11,235,摩根大通,2024-01-02,8440
2897,王道銀行,265,42,223,摩根大通,2024-01-02,8440
3402,漢科,234,11,223,摩根大通,2024-01-02,8440
6239,力成,284,71,213,摩根大通,2024-01-02,8440
4113,聯上,230,24,206,摩根大通,2024-01-02,8440
6462,神盾,186,4,182,摩根大通,2024-01-02,8440
6288,聯嘉,194,22,172,摩根大通,2024-01-02,8440
6139,亞翔,615,445,170,摩根大通,2024-01-02,8440
9907,統一實,172,3,169,摩根大通,2024-01-02,8440
5210,寶碩,201,32,169,摩根大通,2024-01-02,8440
2486,一詮,415,249,166,摩根大通,2024-01-02,8440
3708,上緯投控,165,6,159,摩根大通,2024-01-02,8440
2630,亞航,162,4,158,摩根大通,2024-01-02,8440
3376,新日興,216,59,157,摩根大通,2024-01-02,8440
2891,中信金,1048,896,152,摩根大通,2024-01-02,8440
1402,遠東新,233,82,151,摩根大通,2024-01-02,8440
2601,益航,159,10,149,摩根大通,2024-01-02,8440
2534,宏盛,144,1,143,摩根大通,2024-01-02,8440
2027,大成鋼,182,49,133,摩根大通,2024-01-02,8440
2360,致茂,150,18,132,摩根大通,2024-01-02,8440
2379,瑞昱,131,0,131,摩根大通,2024-01-02,8440
4532,瑞智,139,8,131,摩根大通,2024-01-02,8440
2313,華通,132,1,131,摩根大通,2024-01-02,8440
2883,凱基金,5482,2952,2530,摩根大通,2024-01-03,8440
2890,永豐金,2495,467,2028,摩根大通,2024-01-03,8440
2303,聯電,2780,881,1899,摩根大通,2024-01-03,8440
1314,中石化,1691,0,1691,摩根大通,2024-01-03,8440
2515,中工,1512,227,1285,摩根大通,2024-01-03,8440
3035,智原,1199,0,1199,摩根大通,2024-01-03,8440
1216,統一,1261,133,1128,摩根大通,2024-01-03,8440
3037,欣興,1410,311,1099,摩根大通,2024-01-03,8440
9934,成霖,1772,716,1056,摩根大通,2024-01-03,8440
2312,金寶,1029,19,1010,摩根大通,2024-01-03,8440
2891,中信金,2956,2046,910,摩根大通,2024-01-03,8440
2206,三陽工業,869,93,776,摩根大通,2024-01-03,8440
2486,一詮,1361,613,748,摩根大通,2024-01-03,8440
6531,愛普*,689,13,676,摩根大通,2024-01-03,8440
1514,亞力,839,177,662,摩根大通,2024-01-03,8440
3231,緯創,1381,753,628,摩根大通,2024-01-03,8440
2537,聯上發,661,38,623,摩根大通,2024-01-03,8440
4915,致伸,609,38,571,摩根大通,2024-01-03,8440
2317,鴻海,758,224,534,摩根大通,2024-01-03,8440
3702,大聯大,556,46,510,摩根大通,2024-01-03,8440
2881,富邦金,855,347,508,摩根大通,2024-01-03,8440
1102,亞泥,550,72,478,摩根大通,2024-01-03,8440
2357,華碩,829,353,476,摩根大通,2024-01-03,8440
2401,凌陽,510,83,427,摩根大通,2024-01-03,8440
2377,微星,505,86,419,摩根大通,2024-01-03,8440
2889,國票金,462,50,412,摩根大通,2024-01-03,8440
2368,金像電,550,147,403,摩根大通,2024-01-03,8440
1519,華城,594,220,374,摩根大通,2024-01-03,8440
8150,南茂,418,49,369,摩根大通,2024-01-03,8440
2383,台光電,493,141,352,摩根大通,2024-01-03,8440
5425,台半,361,14,347,摩根大通,2024-01-03,8440
8210,勤誠,372,27,345,摩根大通,2024-01-03,8440
3483,力致,350,19,331,摩根大通,2024-01-03,8440
5439,高技,347,17,330,摩根大通,2024-01-03,8440
2345,智邦,414,90,324,摩根大通,2024-01-03,8440
2362,藍天,549,252,297,摩根大通,2024-01-03,8440
4958,臻鼎-KY,318,34,284,摩根大通,2024-01-03,8440
1319,東陽,315,36,279,摩根大通,2024-01-03,8440
2887,台新金,904,640,264,摩根大通,2024-01-03,8440
6625,必應,320,65,255,摩根大通,2024-01-03,8440
3228,金麗科,297,53,244,摩根大通,2024-01-03,8440
2258,鴻華先進-創,249,7,242,摩根大通,2024-01-03,8440
2023,燁輝,224,0,224,摩根大通,2024-01-03,8440
4904,遠傳,298,85,213,摩根大通,2024-01-03,8440
2329,華泰,441,230,211,摩根大通,2024-01-03,8440
3036,文曄,306,111,195,摩根大通,2024-01-03,8440
3704,合勤控,261,70,191,摩根大通,2024-01-03,8440
2360,致茂,229,39,190,摩根大通,2024-01-03,8440
6180,橘子,212,25,187,摩根大通,2024-01-03,8440
2027,大成鋼,218,32,186,摩根大通,2024-01-03,8440
2609,陽明,8033,369,7664,摩根大通,2024-01-04,8440
2603,長榮,4053,495,3558,摩根大通,2024-01-04,8440
2891,中信金,4552,1062,3490,摩根大通,2024-01-04,8440
2313,華通,3384,867,2517,摩根大通,2024-01-04,8440
2324,仁寶,3597,1083,2514,摩根大通,2024-01-04,8440
2382,廣達,2036,58,1978,摩根大通,2024-01-04,8440
2618,長榮航,3706,2431,1275,摩根大通,2024-01-04,8440
2606,裕民,1087,109,978,摩根大通,2024-01-04,8440
1514,亞力,1268,307,961,摩根大通,2024-01-04,8440
6213,聯茂,1136,200,936,摩根大通,2024-01-04,8440
2330,台積電,1390,489,901,摩根大通,2024-01-04,8440
2455,全新,1000,128,872,摩根大通,2024-01-04,8440
2312,金寶,1045,191,854,摩根大通,2024-01-04,8440
3231,緯創,866,48,818,摩根大通,2024-01-04,8440
2486,一詮,1351,536,815,摩根大通,2024-01-04,8440
2352,佳世達,1063,248,815,摩根大通,2024-01-04,8440
2889,國票金,762,34,728,摩根大通,2024-01-04,8440
2605,新興,1142,439,703,摩根大通,2024-01-04,8440
2615,萬海,1057,373,684,摩根大通,2024-01-04,8440
1314,中石化,670,29,641,摩根大通,2024-01-04,8440
2515,中工,660,23,637,摩根大通,2024-01-04,8440
3481,群創,981,386,595,摩根大通,2024-01-04,8440
2357,華碩,629,104,525,摩根大通,2024-01-04,8440
2890,永豐金,686,173,513,摩根大通,2024-01-04,8440
2881,富邦金,515,23,492,摩根大通,2024-01-04,8440
2607,榮運,722,236,486,摩根大通,2024-01-04,8440
2303,聯電,685,211,474,摩根大通,2024-01-04,8440
2329,華泰,551,91,460,摩根大通,2024-01-04,8440
2637,慧洋-KY,514,90,424,摩根大通,2024-01-04,8440
2412,中華電,487,84,403,摩根大通,2024-01-04,8440
1216,統一,418,39,379,摩根大通,2024-01-04,8440
2886,兆豐金,587,230,357,摩根大通,2024-01-04,8440
2377,微星,341,2,339,摩根大通,2024-01-04,8440
2401,凌陽,391,83,308,摩根大通,2024-01-04,8440
3548,兆利,412,137,275,摩根大通,2024-01-04,8440
2101,南港,326,52,274,摩根大通,2024-01-04,8440
2633,台灣高鐵,325,52,273,摩根大通,2024-01-04,8440
2884,玉山金,401,128,273,摩根大通,2024-01-04,8440
2408,南亞科,615,344,271,摩根大通,2024-01-04,8440
8112,至上,286,17,269,摩根大通,2024-01-04,8440
2601,益航,343,78,265,摩根大通,2024-01-04,8440
3711,日月光投控,285,49,236,摩根大通,2024-01-04,8440
2636,台驊控股,294,65,229,摩根大通,2024-01-04,8440
2439,美律,262,34,228,摩根大通,2024-01-04,8440
2809,京城銀,316,90,226,摩根大通,2024-01-04,8440
5880,合庫金,396,172,224,摩根大通,2024-01-04,8440
2301,光寶科,330,110,220,摩根大通,2024-01-04,8440
2520,冠德,235,19,216,摩根大通,2024-01-04,8440
2317,鴻海,242,35,207,摩根大通,2024-01-04,8440
2393,億光,236,35,201,摩根大通,2024-01-04,8440
6770,力積電,4835,126,4709,摩根大通,2024-01-05,8440
2303,聯電,5028,894,4134,摩根大通,2024-01-05,8440
2609,陽明,5051,2002,3049,摩根大通,2024-01-05,8440
2892,第一金,1904,186,1718,摩根大通,2024-01-05,8440
2313,華通,1907,193,1714,摩根大通,2024-01-05,8440
2382,廣達,1039,66,973,摩根大通,2024-01-05,8440
6116,彩晶,1139,377,762,摩根大通,2024-01-05,8440
2607,榮運,1356,713,643,摩根大通,2024-01-05,8440
2324,仁寶,1506,882,624,摩根大通,2024-01-05,8440
3035,智原,783,176,607,摩根大通,2024-01-05,8440
2880,華南金,572,90,482,摩根大通,2024-01-05,8440
1216,統一,767,293,474,摩根大通,2024-01-05,8440
1477,聚陽,495,48,447,摩根大通,2024-01-05,8440
2884,玉山金,803,379,424,摩根大通,2024-01-05,8440
5880,合庫金,469,56,413,摩根大通,2024-01-05,8440
8096,擎亞,928,518,410,摩根大通,2024-01-05,8440
6182,合晶,584,181,403,摩根大通,2024-01-05,8440
2408,南亞科,722,368,354,摩根大通,2024-01-05,8440
6219,富旺,348,22,326,摩根大通,2024-01-05,8440
2357,華碩,421,100,321,摩根大通,2024-01-05,8440
2641,正德,361,46,315,摩根大通,2024-01-05,8440
8027,鈦昇,338,25,313,摩根大通,2024-01-05,8440
8299,群聯,317,12,305,摩根大通,2024-01-05,8440
9105,泰金寶-DR,370,65,305,摩根大通,2024-01-05,8440
2889,國票金,297,0,297,摩根大通,2024-01-05,8440
2603,長榮,1121,825,296,摩根大通,2024-01-05,8440
6531,愛普*,378,82,296,摩根大通,2024-01-05,8440
2615,萬海,1227,932,295,摩根大通,2024-01-05,8440
2886,兆豐金,594,319,275,摩根大通,2024-01-05,8440
8936,國統,365,101,264,摩根大通,2024-01-05,8440
6113,亞矽,302,49,253,摩根大通,2024-01-05,8440
2882,國泰金,618,375,243,摩根大通,2024-01-05,8440
4746,台耀,343,101,242,摩根大通,2024-01-05,8440
5388,中磊,264,30,234,摩根大通,2024-01-05,8440
2360,致茂,261,34,227,摩根大通,2024-01-05,8440
3086,華義,326,116,210,摩根大通,2024-01-05,8440
2888,新光金,212,3,209,摩根大通,2024-01-05,8440
2534,宏盛,209,0,209,摩根大通,2024-01-05,8440
8068,全達,267,64,203,摩根大通,2024-01-05,8440
2617,台航,237,38,199,摩根大通,2024-01-05,8440
6684,安格,251,63,188,摩根大通,2024-01-05,8440
8011,台通,272,85,187,摩根大通,2024-01-05,8440
2489,瑞軒,425,244,181,摩根大通,2024-01-05,8440
5258,虹堡,176,5,171,摩根大通,2024-01-05,8440
6679,鈺太,169,0,169,摩根大通,2024-01-05,8440
6213,聯茂,282,116,166,摩根大通,2024-01-05,8440
6112,邁達特,166,2,164,摩根大通,2024-01-05,8440
4909,新復興,191,28,163,摩根大通,2024-01-05,8440
1795,美時,239,76,163,摩根大通,2024-01-05,8440
9958,世紀鋼,161,5,156,摩根大通,2024-01-05,8440
3481,群創,14129,1227,12902,摩根大通,2024-01-08,8440
2883,凱基金,12260,3264,8996,摩根大通,2024-01-08,8440
2891,中信金,8612,147,8465,摩根大通,2024-01-08,8440
2409,友達,8360,2977,5383,摩根大通,2024-01-08,8440
2324,仁寶,3873,855,3018,摩根大通,2024-01-08,8440
2886,兆豐金,2156,146,2010,摩根大通,2024-01-08,8440
2884,玉山金,1969,12,1957,摩根大通,2024-01-08,8440
2313,華通,2062,163,1899,摩根大通,2024-01-08,8440
3711,日月光投控,1892,60,1832,摩根大通,2024-01-08,8440
6116,彩晶,2383,738,1645,摩根大通,2024-01-08,8440
2303,聯電,1641,448,1193,摩根大通,2024-01-08,8440
2880,華南金,1193,1,1192,摩根大通,2024-01-08,8440
2882,國泰金,1150,0,1150,摩根大通,2024-01-08,8440
2888,新光金,1246,147,1099,摩根大通,2024-01-08,8440
5880,合庫金,1050,0,1050,摩根大通,2024-01-08,8440
2330,台積電,2074,1120,954,摩根大通,2024-01-08,8440
2881,富邦金,1837,913,924,摩根大通,2024-01-08,8440
9105,泰金寶-DR,937,221,716,摩根大通,2024-01-08,8440
2498,宏達電,917,240,677,摩根大通,2024-01-08,8440
2892,第一金,746,96,650,摩根大通,2024-01-08,8440
2887,台新金,610,44,566,摩根大通,2024-01-08,8440
1402,遠東新,709,151,558,摩根大通,2024-01-08,8440
2368,金像電,572,20,552,摩根大通,2024-01-08,8440
2301,光寶科,749,257,492,摩根大通,2024-01-08,8440
2890,永豐金,784,298,486,摩根大通,2024-01-08,8440
1314,中石化,483,0,483,摩根大通,2024-01-08,8440
3032,偉訓,749,303,446,摩根大通,2024-01-08,8440
2885,元大金,459,24,435,摩根大通,2024-01-08,8440
1301,台塑,425,4,421,摩根大通,2024-01-08,8440
2371,大同,472,63,409,摩根大通,2024-01-08,8440
2002,中鋼,427,29,398,摩根大通,2024-01-08,8440
4938,和碩,1347,953,394,摩根大通,2024-01-08,8440
1216,統一,380,8,372,摩根大通,2024-01-08,8440
6239,力成,382,14,368,摩根大通,2024-01-08,8440
6112,邁達特,361,0,361,摩根大通,2024-01-08,8440
1519,華城,421,81,340,摩根大通,2024-01-08,8440
2344,華邦電,986,668,318,摩根大通,2024-01-08,8440
0050,元大台灣50,318,0,318,摩根大通,2024-01-08,8440
8086,宏捷科,387,79,308,摩根大通,2024-01-08,8440
2801,彰銀,302,5,297,摩根大通,2024-01-08,8440
2412,中華電,277,0,277,摩根大通,2024-01-08,8440
1477,聚陽,267,3,264,摩根大通,2024-01-08,8440
5531,鄉林,279,22,257,摩根大通,2024-01-08,8440
3702,大聯大,405,156,249,摩根大通,2024-01-08,8440
2748,雲品,280,35,245,摩根大通,2024-01-08,8440
2258,鴻華先進-創,245,4,241,摩根大通,2024-01-08,8440
4915,致伸,664,424,240,摩根大通,2024-01-08,8440
4157,太景*-KY,236,0,236,摩根大通,2024-01-08,8440
2609,陽明,1035,801,234,摩根大通,2024-01-08,8440
2382,廣達,620,387,233,摩根大通,2024-01-08,8440
2371,大同,3472,510,2962,摩根大通,2024-01-09,8440
2498,宏達電,3607,838,2769,摩根大通,2024-01-09,8440
2353,宏��,3054,857,2197,摩根大通,2024-01-09,8440
3711,日月光投控,2101,30,2071,摩根大通,2024-01-09,8440
2609,陽明,3116,1070,2046,摩根大通,2024-01-09,8440
2324,仁寶,2380,823,1557,摩根大通,2024-01-09,8440
2330,台積電,1938,688,1250,摩根大通,2024-01-09,8440
2449,京元電子,1248,275,973,摩根大通,2024-01-09,8440
2303,聯電,917,70,847,摩根大通,2024-01-09,8440
2605,新興,1187,386,801,摩根大通,2024-01-09,8440
1519,華城,824,161,663,摩根大通,2024-01-09,8440
8210,勤誠,724,94,630,摩根大通,2024-01-09,8440
2363,矽統,693,86,607,摩根大通,2024-01-09,8440
4938,和碩,781,178,603,摩根大通,2024-01-09,8440
3702,大聯大,621,37,584,摩根大通,2024-01-09,8440
3715,定穎投控,731,180,551,摩根大通,2024-01-09,8440
2344,華邦電,683,183,500,摩根大通,2024-01-09,8440
2301,光寶科,663,178,485,摩根大通,2024-01-09,8440
5880,合庫金,434,2,432,摩根大通,2024-01-09,8440
2376,技嘉,757,334,423,摩根大通,2024-01-09,8440
2881,富邦金,665,278,387,摩根大通,2024-01-09,8440
2408,南亞科,452,71,381,摩根大通,2024-01-09,8440
2360,致茂,451,92,359,摩根大通,2024-01-09,8440
2884,玉山金,491,178,313,摩根大通,2024-01-09,8440
2101,南港,300,11,289,摩根大通,2024-01-09,8440
6138,茂達,285,11,274,摩根大通,2024-01-09,8440
2385,群光,333,66,267,摩根大通,2024-01-09,8440
8011,台通,308,45,263,摩根大通,2024-01-09,8440
6223,旺矽,373,114,259,摩根大通,2024-01-09,8440
2501,國建,406,148,258,摩根大通,2024-01-09,8440
2313,華通,293,41,252,摩根大通,2024-01-09,8440
2367,燿華,251,25,226,摩根大通,2024-01-09,8440
8096,擎亞,458,244,214,摩根大通,2024-01-09,8440
2886,兆豐金,1024,814,210,摩根大通,2024-01-09,8440
2332,友訊,235,29,206,摩根大通,2024-01-09,8440
2327,國巨,218,13,205,摩根大通,2024-01-09,8440
3041,揚智,269,65,204,摩根大通,2024-01-09,8440
4919,新唐,270,68,202,摩根大通,2024-01-09,8440
3217,優群,269,74,195,摩根大通,2024-01-09,8440
2637,慧洋-KY,626,435,191,摩根大通,2024-01-09,8440
1612,宏泰,297,107,190,摩根大通,2024-01-09,8440
3587,閎康,216,27,189,摩根大通,2024-01-09,8440
2105,正新,206,20,186,摩根大通,2024-01-09,8440
8086,宏捷科,220,35,185,摩根大通,2024-01-09,8440
2014,中鴻,216,33,183,摩根大通,2024-01-09,8440
2023,燁輝,225,45,180,摩根大通,2024-01-09,8440
3025,星通,867,696,171,摩根大通,2024-01-09,8440
3661,世芯-KY,182,12,170,摩根大通,2024-01-09,8440
6187,萬潤,176,8,168,摩根大通,2024-01-09,8440
3228,金麗科,199,42,157,摩根大通,2024-01-09,8440
2609,陽明,3761,543,3218,摩根大通,2024-01-10,8440
2324,仁寶,3398,606,2792,摩根大通,2024-01-10,8440
2886,兆豐金,2485,877,1608,摩根大通,2024-01-10,8440
2603,長榮,1983,440,1543,摩根大通,2024-01-10,8440
2363,矽統,1465,167,1298,摩根大通,2024-01-10,8440
2891,中信金,1830,612,1218,摩根大通,2024-01-10,8440
3037,欣興,1275,72,1203,摩根大通,2024-01-10,8440
2313,華通,1473,365,1108,摩根大通,2024-01-10,8440
3706,神達,1742,869,873,摩根大通,2024-01-10,8440
2330,台積電,1135,335,800,摩根大通,2024-01-10,8440
3017,奇鋐,871,154,717,摩根大通,2024-01-10,8440
2201,裕隆,637,8,629,摩根大通,2024-01-10,8440
2885,元大金,651,39,612,摩根大通,2024-01-10,8440
2382,廣達,655,45,610,摩根大通,2024-01-10,8440
3055,蔚華科,1200,648,552,摩根大通,2024-01-10,8440
4904,遠傳,554,6,548,摩根大通,2024-01-10,8440
2006,東和鋼鐵,538,40,498,摩根大通,2024-01-10,8440
4746,台耀,544,50,494,摩根大通,2024-01-10,8440
2360,致茂,562,85,477,摩根大通,2024-01-10,8440
2385,群光,609,148,461,摩根大通,2024-01-10,8440
2357,華碩,559,101,458,摩根大通,2024-01-10,8440
1513,中興電,391,1,390,摩根大通,2024-01-10,8440
2014,中鴻,415,48,367,摩根大通,2024-01-10,8440
2884,玉山金,404,68,336,摩根大通,2024-01-10,8440
2634,漢翔,461,132,329,摩根大通,2024-01-10,8440
2371,大同,2100,1785,315,摩根大通,2024-01-10,8440
2515,中工,523,218,305,摩根大通,2024-01-10,8440
3005,神基,302,13,289,摩根大通,2024-01-10,8440
5351,鈺創,295,15,280,摩根大通,2024-01-10,8440
2605,新興,702,436,266,摩根大通,2024-01-10,8440
3034,聯詠,410,147,263,摩根大通,2024-01-10,8440
2641,正德,258,0,258,摩根大通,2024-01-10,8440
1815,富喬,249,11,238,摩根大通,2024-01-10,8440
6243,迅杰,336,99,237,摩根大通,2024-01-10,8440
8069,元太,342,125,217,摩根大通,2024-01-10,8440
6770,力積電,344,135,209,摩根大通,2024-01-10,8440
3545,敦泰,291,99,192,摩根大通,2024-01-10,8440
3035,智原,833,645,188,摩根大通,2024-01-10,8440
2327,國巨,186,2,184,摩根大通,2024-01-10,8440
1514,亞力,547,367,180,摩根大通,2024-01-10,8440
1808,潤隆,178,1,177,摩根大通,2024-01-10,8440
2880,華南金,222,45,177,摩根大通,2024-01-10,8440
2481,強茂,178,2,176,摩根大通,2024-01-10,8440
1216,統一,189,15,174,摩根大通,2024-01-10,8440
3702,大聯大,358,187,171,摩根大通,2024-01-10,8440
9958,世紀鋼,436,271,165,摩根大通,2024-01-10,8440
2539,櫻花建,166,4,162,摩根大通,2024-01-10,8440
2408,南亞科,424,263,161,摩根大通,2024-01-10,8440
8210,勤誠,546,395,151,摩根大通,2024-01-10,8440
8227,巨有科技,269,127,142,摩根大通,2024-01-10,8440
3231,緯創,7007,808,6199,摩根大通,2024-01-11,8440
2330,台積電,2459,181,2278,摩根大通,2024-01-11,8440
3035,智原,2622,539,2083,摩根大通,2024-01-11,8440
2408,南亞科,1984,219,1765,摩根大通,2024-01-11,8440
2884,玉山金,2103,519,1584,摩根大通,2024-01-11,8440
3017,奇鋐,1626,99,1527,摩根大通,2024-01-11,8440
2888,新光金,1408,32,1376,摩根大通,2024-01-11,8440
4904,遠傳,1491,126,1365,摩根大通,2024-01-11,8440
2317,鴻海,2064,864,1200,摩根大通,2024-01-11,8440
2892,第一金,1222,305,917,摩根大通,2024-01-11,8440
2303,聯電,1168,269,899,摩根大通,2024-01-11,8440
2363,矽統,959,125,834,摩根大通,2024-01-11,8440
1515,力山,749,7,742,摩根大通,2024-01-11,8440
2890,永豐金,968,240,728,摩根大通,2024-01-11,8440
2324,仁寶,972,250,722,摩根大通,2024-01-11,8440
2382,廣達,950,250,700,摩根大通,2024-01-11,8440
2301,光寶科,1464,797,667,摩根大通,2024-01-11,8440
2376,技嘉,1332,675,657,摩根大通,2024-01-11,8440
6111,大宇資,676,20,656,摩根大通,2024-01-11,8440
2880,華南金,609,65,544,摩根大通,2024-01-11,8440
2609,陽明,1611,1078,533,摩根大通,2024-01-11,8440
6282,康舒,510,13,497,摩根大通,2024-01-11,8440
6168,宏齊,618,138,480,摩根大通,2024-01-11,8440
8034,榮群,926,458,468,摩根大通,2024-01-11,8440
5880,合庫金,777,317,460,摩根大通,2024-01-11,8440
2887,台新金,643,187,456,摩根大通,2024-01-11,8440
4938,和碩,700,250,450,摩根大通,2024-01-11,8440
9958,世紀鋼,457,10,447,摩根大通,2024-01-11,8440
2881,富邦金,815,369,446,摩根大通,2024-01-11,8440
2882,國泰金,848,421,427,摩根大通,2024-01-11,8440
2891,中信金,856,440,416,摩根大通,2024-01-11,8440
2360,致茂,408,35,373,摩根大通,2024-01-11,8440
3706,神達,882,514,368,摩根大通,2024-01-11,8440
1815,富喬,419,53,366,摩根大通,2024-01-11,8440
2603,長榮,674,318,356,摩根大通,2024-01-11,8440
2406,國碩,375,24,351,摩根大通,2024-01-11,8440
3045,台灣大,401,52,349,摩根大通,2024-01-11,8440
4956,光鋐,448,106,342,摩根大通,2024-01-11,8440
3622,洋華,418,96,322,摩根大通,2024-01-11,8440
2357,華碩,379,63,316,摩根大通,2024-01-11,8440
2395,研華,316,12,304,摩根大通,2024-01-11,8440
2834,臺企銀,307,4,303,摩根大通,2024-01-11,8440
1314,中石化,311,15,296,摩根大通,2024-01-11,8440
3548,兆利,441,161,280,摩根大通,2024-01-11,8440
5347,世界,299,28,271,摩根大通,2024-01-11,8440
3163,波若威,268,6,262,摩根大通,2024-01-11,8440
3032,偉訓,391,131,260,摩根大通,2024-01-11,8440
3055,蔚華科,523,270,253,摩根大通,2024-01-11,8440
2385,群光,442,197,245,摩根大通,2024-01-11,8440
2453,凌群,270,25,245,摩根大通,2024-01-11,8440
3231,緯創,8798,358,8440,摩根大通,2024-01-12,8440
2486,一詮,4220,280,3940,摩根大通,2024-01-12,8440
2609,陽明,3429,1443,1986,摩根大通,2024-01-12,8440
2330,台積電,1577,424,1153,摩根大通,2024-01-12,8440
2888,新光金,1520,400,1120,摩根大通,2024-01-12,8440
1216,統一,1130,84,1046,摩根大通,2024-01-12,8440
2324,仁寶,1658,663,995,摩根大通,2024-01-12,8440
2630,亞航,1100,111,989,摩根大通,2024-01-12,8440
3017,奇鋐,1132,268,864,摩根大通,2024-01-12,8440
8096,擎亞,1718,899,819,摩根大通,2024-01-12,8440
2382,廣達,1281,474,807,摩根大通,2024-01-12,8440
2449,京元電子,1691,895,796,摩根大通,2024-01-12,8440
1519,華城,1067,346,721,摩根大通,2024-01-12,8440
2409,友達,1796,1133,663,摩根大通,2024-01-12,8440
2882,國泰金,794,187,607,摩根大通,2024-01-12,8440
2615,萬海,1312,718,594,摩根大通,2024-01-12,8440
6139,亞翔,724,164,560,摩根大通,2024-01-12,8440
2891,中信金,1125,572,553,摩根大通,2024-01-12,8440
2301,光寶科,727,190,537,摩根大通,2024-01-12,8440
2883,凱基金,3455,2968,487,摩根大通,2024-01-12,8440
1504,東元,550,64,486,摩根大通,2024-01-12,8440
4904,遠傳,545,137,408,摩根大通,2024-01-12,8440
2313,華通,498,94,404,摩根大通,2024-01-12,8440
6415,矽力*-KY,398,44,354,摩根大通,2024-01-12,8440
3036,文曄,625,293,332,摩根大通,2024-01-12,8440
8227,巨有科技,404,120,284,摩根大通,2024-01-12,8440
2603,長榮,1994,1721,273,摩根大通,2024-01-12,8440
8222,寶一,319,63,256,摩根大通,2024-01-12,8440
2634,漢翔,478,257,221,摩根大通,2024-01-12,8440
3025,星通,420,202,218,摩根大通,2024-01-12,8440
2637,慧洋-KY,420,208,212,摩根大通,2024-01-12,8440
2337,旺宏,273,65,208,摩根大通,2024-01-12,8440
6547,高端疫苗,205,3,202,摩根大通,2024-01-12,8440
1514,亞力,442,242,200,摩根大通,2024-01-12,8440
2360,致茂,212,15,197,摩根大通,2024-01-12,8440
2002,中鋼,386,191,195,摩根大通,2024-01-12,8440
2365,昆盈,208,21,187,摩根大通,2024-01-12,8440
2845,遠東銀,366,191,175,摩根大通,2024-01-12,8440
2489,瑞軒,248,82,166,摩根大通,2024-01-12,8440
6239,力成,263,100,163,摩根大通,2024-01-12,8440
6472,保瑞,164,5,159,摩根大通,2024-01-12,8440
1905,華紙,350,201,149,摩根大通,2024-01-12,8440
3533,嘉澤,175,28,147,摩根大通,2024-01-12,8440
3227,原相,186,42,144,摩根大通,2024-01-12,8440
6698,旭暉應材,165,23,142,摩根大通,2024-01-12,8440
9921,巨大,157,21,136,摩根大通,2024-01-12,8440
2890,永豐金,740,609,131,摩根大通,2024-01-12,8440
3702,大聯大,183,52,131,摩根大通,2024-01-12,8440
2362,藍天,176,46,130,摩根大通,2024-01-12,8440
4909,新復興,702,574,128,摩根大通,2024-01-12,8440
2609,陽明,4621,949,3672,摩根大通,2024-01-15,8440
1609,大亞,3443,299,3144,摩根大通,2024-01-15,8440
2603,長榮,2730,285,2445,摩根大通,2024-01-15,8440
5351,鈺創,2146,139,2007,摩根大通,2024-01-15,8440
6443,元晶,1467,177,1290,摩根大通,2024-01-15,8440
1795,美時,1181,4,1177,摩根大通,2024-01-15,8440
3711,日月光投控,1027,162,865,摩根大通,2024-01-15,8440
2002,中鋼,1005,204,801,摩根大通,2024-01-15,8440
6239,力成,1061,288,773,摩根大通,2024-01-15,8440
1301,台塑,732,32,700,摩根大通,2024-01-15,8440
2330,台積電,2068,1437,631,摩根大通,2024-01-15,8440
2344,華邦電,1531,912,619,摩根大通,2024-01-15,8440
4967,十銓,606,67,539,摩根大通,2024-01-15,8440
6274,台燿,609,88,521,摩根大通,2024-01-15,8440
1519,華城,969,492,477,摩根大通,2024-01-15,8440
2408,南亞科,868,400,468,摩根大通,2024-01-15,8440
6139,亞翔,491,27,464,摩根大通,2024-01-15,8440
4109,加捷生醫,490,46,444,摩根大通,2024-01-15,8440
2412,中華電,485,54,431,摩根大通,2024-01-15,8440
3702,大聯大,474,50,424,摩根大通,2024-01-15,8440
5381,合正,426,11,415,摩根大通,2024-01-15,8440
3576,聯合再生,1008,599,409,摩根大通,2024-01-15,8440
6770,力積電,469,61,408,摩根大通,2024-01-15,8440
2406,國碩,719,312,407,摩根大通,2024-01-15,8440
9105,泰金寶-DR,654,252,402,摩根大通,2024-01-15,8440
8027,鈦昇,629,236,393,摩根大通,2024-01-15,8440
8936,國統,451,62,389,摩根大通,2024-01-15,8440
3034,聯詠,782,414,368,摩根大通,2024-01-15,8440
4904,遠傳,549,222,327,摩根大通,2024-01-15,8440
6207,雷科,337,40,297,摩根大通,2024-01-15,8440
3207,耀勝,279,5,274,摩根大通,2024-01-15,8440
1611,中電,272,2,270,摩根大通,2024-01-15,8440
6451,訊芯-KY,517,255,262,摩根大通,2024-01-15,8440
3260,威剛,277,27,250,摩根大通,2024-01-15,8440
2324,仁寶,533,301,232,摩根大通,2024-01-15,8440
3712,永崴投控,329,111,218,摩根大通,2024-01-15,8440
6472,保瑞,275,58,217,摩根大通,2024-01-15,8440
2388,威盛,706,492,214,摩根大通,2024-01-15,8440
1477,聚陽,207,9,198,摩根大通,2024-01-15,8440
2352,佳世達,191,0,191,摩根大通,2024-01-15,8440
2528,皇普,210,19,191,摩根大通,2024-01-15,8440
4915,致伸,212,24,188,摩根大通,2024-01-15,8440
9933,中鼎,311,127,184,摩根大通,2024-01-15,8440
1504,東元,219,38,181,摩根大通,2024-01-15,8440
1608,華榮,207,30,177,摩根大通,2024-01-15,8440
2364,倫飛,219,43,176,摩根大通,2024-01-15,8440
8150,南茂,221,46,175,摩根大通,2024-01-15,8440
2426,鼎元,176,2,174,摩根大通,2024-01-15,8440
3217,優群,207,33,174,摩根大通,2024-01-15,8440
6219,富旺,301,132,169,摩根大通,2024-01-15,8440
3481,群創,25289,1987,23302,摩根大通,2024-01-16,8440
2887,台新金,3370,1501,1869,摩根大通,2024-01-16,8440
2313,華通,1730,253,1477,摩根大通,2024-01-16,8440
3702,大聯大,1085,257,828,摩根大通,2024-01-16,8440
3694,海華,1023,395,628,摩根大通,2024-01-16,8440
3037,欣興,753,177,576,摩根大通,2024-01-16,8440
4904,遠傳,822,257,565,摩根大通,2024-01-16,8440
3265,台星科,540,26,514,摩根大通,2024-01-16,8440
4906,正文,576,84,492,摩根大通,2024-01-16,8440
6695,芯鼎,820,340,480,摩根大通,2024-01-16,8440
4123,晟德,362,4,358,摩根大通,2024-01-16,8440
1514,亞力,697,340,357,摩根大通,2024-01-16,8440
5443,均豪,366,32,334,摩根大通,2024-01-16,8440
2609,陽明,1325,1025,300,摩根大通,2024-01-16,8440
1795,美時,494,196,298,摩根大通,2024-01-16,8440
3034,聯詠,434,147,287,摩根大通,2024-01-16,8440
5457,宣德,269,3,266,摩根大通,2024-01-16,8440
6233,旺玖,434,199,235,摩根大通,2024-01-16,8440
1301,台塑,821,616,205,摩根大通,2024-01-16,8440
1310,台苯,334,136,198,摩根大通,2024-01-16,8440
8050,廣積,184,1,183,摩根大通,2024-01-16,8440
6237,驊訊,248,66,182,摩根大通,2024-01-16,8440
3041,揚智,199,22,177,摩根大通,2024-01-16,8440
2357,華碩,319,144,175,摩根大通,2024-01-16,8440
6684,安格,658,490,168,摩根大通,2024-01-16,8440
6670,復盛應用,187,19,168,摩根大通,2024-01-16,8440
3483,力致,174,6,168,摩根大通,2024-01-16,8440
2454,聯發科,586,426,160,摩根大通,2024-01-16,8440
3324,雙鴻,175,19,156,摩根大通,2024-01-16,8440
3711,日月光投控,1028,874,154,摩根大通,2024-01-16,8440
3033,威健,360,207,153,摩根大通,2024-01-16,8440
3526,凡甲,150,1,149,摩根大通,2024-01-16,8440
2476,鉅祥,245,105,140,摩根大通,2024-01-16,8440
6239,力成,328,199,129,摩根大通,2024-01-16,8440
3706,神達,296,172,124,摩根大通,2024-01-16,8440
6126,信音,124,0,124,摩根大通,2024-01-16,8440
6164,華興,193,72,121,摩根大通,2024-01-16,8440
2603,長榮,698,578,120,摩根大通,2024-01-16,8440
4109,加捷生醫,126,7,119,摩根大通,2024-01-16,8440
2324,仁寶,635,517,118,摩根大通,2024-01-16,8440
3545,敦泰,148,39,109,摩根大通,2024-01-16,8440
3131,弘塑,108,2,106,摩根大通,2024-01-16,8440
2401,凌陽,264,161,103,摩根大通,2024-01-16,8440
8110,華東,162,62,100,摩根大通,2024-01-16,8440
2329,華泰,514,415,99,摩根大通,2024-01-16,8440
1477,聚陽,121,26,95,摩根大通,2024-01-16,8440
3025,星通,887,793,94,摩根大通,2024-01-16,8440
6205,詮欣,123,32,91,摩根大通,2024-01-16,8440
3029,零壹,103,13,90,摩根大通,2024-01-16,8440
3047,訊舟,109,19,90,摩根大通,2024-01-16,8440
2301,光寶科,4932,501,4431,摩根大通,2024-01-17,8440
2382,廣達,3237,1269,1968,摩根大通,2024-01-17,8440
2454,聯發科,1483,280,1203,摩根大通,2024-01-17,8440
2330,台積電,7668,6675,993,摩根大通,2024-01-17,8440
2409,友達,1964,1127,837,摩根大通,2024-01-17,8440
2890,永豐金,2215,1453,762,摩根大通,2024-01-17,8440
2313,華通,1229,490,739,摩根大通,2024-01-17,8440
3037,欣興,898,288,610,摩根大通,2024-01-17,8440
1514,亞力,711,125,586,摩根大通,2024-01-17,8440
1528,恩德,769,219,550,摩根大通,2024-01-17,8440
1303,南亞,1507,1011,496,摩根大通,2024-01-17,8440
2891,中信金,3964,3482,482,摩根大通,2024-01-17,8440
2383,台光電,1103,687,416,摩根大通,2024-01-17,8440
9914,美利達,356,73,283,摩根大通,2024-01-17,8440
6120,達運,663,397,266,摩根大通,2024-01-17,8440
3265,台星科,336,83,253,摩根大通,2024-01-17,8440
6147,頎邦,253,15,238,摩根大通,2024-01-17,8440
2347,聯強,1639,1402,237,摩根大通,2024-01-17,8440
3041,揚智,264,29,235,摩根大通,2024-01-17,8440
2327,國巨,350,118,232,摩根大通,2024-01-17,8440
3533,嘉澤,267,43,224,摩根大通,2024-01-17,8440
6187,萬潤,368,152,216,摩根大通,2024-01-17,8440
4915,致伸,560,350,210,摩根大通,2024-01-17,8440
2345,智邦,311,119,192,摩根大通,2024-01-17,8440
1316,上曜,183,5,178,摩根大通,2024-01-17,8440
2379,瑞昱,225,53,172,摩根大通,2024-01-17,8440
3029,零壹,384,217,167,摩根大通,2024-01-17,8440
6239,力成,383,222,161,摩根大通,2024-01-17,8440
6223,旺矽,190,46,144,摩根大通,2024-01-17,8440
2357,華碩,308,171,137,摩根大通,2024-01-17,8440
5351,鈺創,490,360,130,摩根大通,2024-01-17,8440
6488,環球晶,114,3,111,摩根大通,2024-01-17,8440
3306,鼎天,313,203,110,摩根大通,2024-01-17,8440
3545,敦泰,173,70,103,摩根大通,2024-01-17,8440
3047,訊舟,115,12,103,摩根大通,2024-01-17,8440
8454,富邦媒,158,58,100,摩根大通,2024-01-17,8440
3680,家登,107,9,98,摩根大通,2024-01-17,8440
6669,緯穎,214,122,92,摩根大通,2024-01-17,8440
8112,至上,657,571,86,摩根大通,2024-01-17,8440
2332,友訊,227,146,81,摩根大通,2024-01-17,8440
3324,雙鴻,82,1,81,摩根大通,2024-01-17,8440
4979,華星光,166,86,80,摩根大通,2024-01-17,8440
4306,炎洲,198,118,80,摩根大通,2024-01-17,8440
6196,帆宣,119,41,78,摩根大通,2024-01-17,8440
3661,世芯-KY,125,49,76,摩根大通,2024-01-17,8440
8034,榮群,483,410,73,摩根大通,2024-01-17,8440
4953,緯軟,77,6,71,摩根大通,2024-01-17,8440
3035,智原,269,199,70,摩根大通,2024-01-17,8440
6451,訊芯-KY,324,256,68,摩根大通,2024-01-17,8440
2340,台亞,156,89,67,摩根大通,2024-01-17,8440
3481,群創,4298,1185,3113,摩根大通,2024-01-18,8440
3036,文曄,3064,571,2493,摩根大通,2024-01-18,8440
2891,中信金,2752,1139,1613,摩根大通,2024-01-18,8440
2449,京元電子,2037,588,1449,摩根大通,2024-01-18,8440
3037,欣興,1651,226,1425,摩根大通,2024-01-18,8440
2408,南亞科,1555,235,1320,摩根大通,2024-01-18,8440
2330,台積電,2732,1511,1221,摩根大通,2024-01-18,8440
2385,群光,1376,370,1006,摩根大通,2024-01-18,8440
2356,英業達,1034,146,888,摩根大通,2024-01-18,8440
2313,華通,820,121,699,摩根大通,2024-01-18,8440
1514,亞力,718,84,634,摩根大通,2024-01-18,8440
2409,友達,2417,1791,626,摩根大通,2024-01-18,8440
3033,威健,609,140,469,摩根大通,2024-01-18,8440
6505,台塑化,497,31,466,摩根大通,2024-01-18,8440
3029,零壹,979,577,402,摩根大通,2024-01-18,8440
2405,輔信,391,99,292,摩根大通,2024-01-18,8440
6214,精誠,282,1,281,摩根大通,2024-01-18,8440
2344,華邦電,348,76,272,摩根大通,2024-01-18,8440
2355,敬鵬,252,10,242,摩根大通,2024-01-18,8440
3711,日月光投控,1056,822,234,摩根大通,2024-01-18,8440
8215,明基材,273,61,212,摩根大通,2024-01-18,8440
4746,台耀,559,354,205,摩根大通,2024-01-18,8440
6451,訊芯-KY,280,83,197,摩根大通,2024-01-18,8440
2454,聯發科,454,260,194,摩根大通,2024-01-18,8440
8210,勤誠,272,91,181,摩根大通,2024-01-18,8440
2331,精英,206,40,166,摩根大通,2024-01-18,8440
2485,兆赫,352,187,165,摩根大通,2024-01-18,8440
5347,世界,319,165,154,摩根大通,2024-01-18,8440
8936,國統,196,46,150,摩根大通,2024-01-18,8440
8039,台虹,150,3,147,摩根大通,2024-01-18,8440
6535,順藥,147,2,145,摩根大通,2024-01-18,8440
2388,威盛,231,87,144,摩根大通,2024-01-18,8440
3017,奇鋐,332,194,138,摩根大通,2024-01-18,8440
3047,訊舟,130,3,127,摩根大通,2024-01-18,8440
6117,迎廣,143,17,126,摩根大通,2024-01-18,8440
3265,台星科,149,24,125,摩根大通,2024-01-18,8440
6805,富世達,157,34,123,摩根大通,2024-01-18,8440
2603,長榮,280,159,121,摩根大通,2024-01-18,8440
4188,安克,159,38,121,摩根大通,2024-01-18,8440
2362,藍天,485,365,120,摩根大通,2024-01-18,8440
1590,亞德客-KY,164,44,120,摩根大通,2024-01-18,8440
6462,神盾,223,105,118,摩根大通,2024-01-18,8440
2201,裕隆,297,180,117,摩根大通,2024-01-18,8440
1476,儒鴻,188,81,107,摩根大通,2024-01-18,8440
6164,華興,188,84,104,摩根大通,2024-01-18,8440
3615,安可,117,15,102,摩根大通,2024-01-18,8440
3413,京鼎,101,0,101,摩根大通,2024-01-18,8440
1515,力山,127,27,100,摩根大通,2024-01-18,8440
1319,東陽,706,607,99,摩根大通,2024-01-18,8440
6112,邁達特,167,74,93,摩根大通,2024-01-18,8440
2330,台積電,15817,4643,11174,摩根大通,2024-01-19,8440
3231,緯創,11951,1448,10503,摩根大通,2024-01-19,8440
2356,英業達,4933,199,4734,摩根大通,2024-01-19,8440
2382,廣達,5194,683,4511,摩根大通,2024-01-19,8440
2891,中信金,3657,679,2978,摩根大通,2024-01-19,8440
3037,欣興,2891,484,2407,摩根大通,2024-01-19,8440
3481,群創,2830,671,2159,摩根大通,2024-01-19,8440
3576,聯合再生,2215,439,1776,摩根大通,2024-01-19,8440
2329,華泰,2235,605,1630,摩根大通,2024-01-19,8440
2882,國泰金,1858,749,1109,摩根大通,2024-01-19,8440
2421,建準,1086,12,1074,摩根大通,2024-01-19,8440
3711,日月光投控,1422,397,1025,摩根大通,2024-01-19,8440
2409,友達,2434,1443,991,摩根大通,2024-01-19,8440
2881,富邦金,1774,866,908,摩根大通,2024-01-19,8440
2313,華通,1053,231,822,摩根大通,2024-01-19,8440
3035,智原,840,179,661,摩根大通,2024-01-19,8440
2312,金寶,688,66,622,摩根大通,2024-01-19,8440
1605,華新,760,175,585,摩根大通,2024-01-19,8440
2385,群光,744,178,566,摩根大通,2024-01-19,8440
2363,矽統,740,188,552,摩根大通,2024-01-19,8440
4960,誠美材,891,358,533,摩根大通,2024-01-19,8440
0050,元大台灣50,414,0,414,摩根大通,2024-01-19,8440
2317,鴻海,1706,1310,396,摩根大通,2024-01-19,8440
3706,神達,551,157,394,摩根大通,2024-01-19,8440
6695,芯鼎,472,116,356,摩根大通,2024-01-19,8440
2376,技嘉,465,123,342,摩根大通,2024-01-19,8440
2458,義隆,345,21,324,摩根大通,2024-01-19,8440
2337,旺宏,426,103,323,摩根大通,2024-01-19,8440
6488,環球晶,356,41,315,摩根大通,2024-01-19,8440
8210,勤誠,510,205,305,摩根大通,2024-01-19,8440
3680,家登,290,25,265,摩根大通,2024-01-19,8440
8150,南茂,311,50,261,摩根大通,2024-01-19,8440
3715,定穎投控,574,323,251,摩根大通,2024-01-19,8440
2301,光寶科,481,232,249,摩根大通,2024-01-19,8440
3032,偉訓,293,47,246,摩根大通,2024-01-19,8440
6111,大宇資,242,0,242,摩根大通,2024-01-19,8440
8086,宏捷科,250,11,239,摩根大通,2024-01-19,8440
3036,文曄,498,275,223,摩根大通,2024-01-19,8440
2605,新興,393,172,221,摩根大通,2024-01-19,8440
3548,兆利,243,25,218,摩根大通,2024-01-19,8440
3622,洋華,211,12,199,摩根大通,2024-01-19,8440
4953,緯軟,284,85,199,摩根大通,2024-01-19,8440
6233,旺玖,262,76,186,摩根大通,2024-01-19,8440
6669,緯穎,269,83,186,摩根大通,2024-01-19,8440
2834,臺企銀,273,96,177,摩根大通,2024-01-19,8440
2014,中鴻,170,7,163,摩根大通,2024-01-19,8440
6668,中揚光,187,24,163,摩根大通,2024-01-19,8440
1519,華城,221,58,163,摩根大通,2024-01-19,8440
2906,高林,176,21,155,摩根大通,2024-01-19,8440
5269,祥碩,163,13,150,摩根大通,2024-01-19,8440
2891,中信金,5195,47,5148,摩根大通,2024-01-22,8440
2356,英業達,7354,2594,4760,摩根大通,2024-01-22,8440
2330,台積電,6332,3365,2967,摩根大通,2024-01-22,8440
2618,長榮航,3318,660,2658,摩根大通,2024-01-22,8440
2409,友達,1987,619,1368,摩根大通,2024-01-22,8440
3706,神達,2160,927,1233,摩根大通,2024-01-22,8440
2324,仁寶,3818,2624,1194,摩根大通,2024-01-22,8440
6187,萬潤,1146,31,1115,摩根大通,2024-01-22,8440
2301,光寶科,1537,527,1010,摩根大通,2024-01-22,8440
3711,日月光投控,1323,342,981,摩根大通,2024-01-22,8440
9105,泰金寶-DR,792,50,742,摩根大通,2024-01-22,8440
2345,智邦,866,142,724,摩根大通,2024-01-22,8440
2368,金像電,745,78,667,摩根大通,2024-01-22,8440
6112,邁達特,683,30,653,摩根大通,2024-01-22,8440
2362,藍天,708,89,619,摩根大通,2024-01-22,8440
2347,聯強,613,7,606,摩根大通,2024-01-22,8440
2317,鴻海,1034,441,593,摩根大通,2024-01-22,8440
6111,大宇資,765,213,552,摩根大通,2024-01-22,8440
2357,華碩,670,155,515,摩根大通,2024-01-22,8440
2344,華邦電,555,50,505,摩根大通,2024-01-22,8440
2312,金寶,493,5,488,摩根大通,2024-01-22,8440
8085,福華,522,46,476,摩根大通,2024-01-22,8440
6213,聯茂,482,12,470,摩根大通,2024-01-22,8440
8096,擎亞,530,66,464,摩根大通,2024-01-22,8440
2331,精英,464,10,454,摩根大通,2024-01-22,8440
2377,微星,631,182,449,摩根大通,2024-01-22,8440
9958,世紀鋼,540,119,421,摩根大通,2024-01-22,8440
2421,建準,480,65,415,摩根大通,2024-01-22,8440
3324,雙鴻,490,76,414,摩根大通,2024-01-22,8440
6274,台燿,694,295,399,摩根大通,2024-01-22,8440
2376,技嘉,1190,798,392,摩根大通,2024-01-22,8440
3548,兆利,536,145,391,摩根大通,2024-01-22,8440
4904,遠傳,402,17,385,摩根大通,2024-01-22,8440
2360,致茂,459,77,382,摩根大通,2024-01-22,8440
3450,聯鈞,368,8,360,摩根大通,2024-01-22,8440
6282,康舒,359,0,359,摩根大通,2024-01-22,8440
2352,佳世達,367,17,350,摩根大通,2024-01-22,8440
4906,正文,381,77,304,摩根大通,2024-01-22,8440
3325,旭品,330,28,302,摩根大通,2024-01-22,8440
2365,昆盈,300,8,292,摩根大通,2024-01-22,8440
3047,訊舟,282,0,282,摩根大通,2024-01-22,8440
8040,九暘,329,48,281,摩根大通,2024-01-22,8440
3406,玉晶光,289,11,278,摩根大通,2024-01-22,8440
6237,驊訊,276,11,265,摩根大通,2024-01-22,8440
3034,聯詠,304,48,256,摩根大通,2024-01-22,8440
4956,光鋐,422,173,249,摩根大通,2024-01-22,8440
2363,矽統,759,510,249,摩根大通,2024-01-22,8440
2906,高林,381,135,246,摩根大通,2024-01-22,8440
3583,辛耘,338,100,238,摩根大通,2024-01-22,8440
6152,百一,234,12,222,摩根大通,2024-01-22,8440
2409,友達,15770,594,15176,摩根大通,2024-01-23,8440
2891,中信金,9599,144,9455,摩根大通,2024-01-23,8440
3481,群創,7122,1912,5210,摩根大通,2024-01-23,8440
3231,緯創,4375,427,3948,摩根大通,2024-01-23,8440
2356,英業達,4701,1217,3484,摩根大通,2024-01-23,8440
2324,仁寶,4390,966,3424,摩根大通,2024-01-23,8440
2330,台積電,4927,1625,3302,摩根大通,2024-01-23,8440
2881,富邦金,2192,32,2160,摩根大通,2024-01-23,8440
2882,國泰金,2121,114,2007,摩根大通,2024-01-23,8440
2408,南亞科,3194,1404,1790,摩根大通,2024-01-23,8440
2313,華通,1987,254,1733,摩根大通,2024-01-23,8440
2618,長榮航,1755,40,1715,摩根大通,2024-01-23,8440
6770,力積電,1557,43,1514,摩根大通,2024-01-23,8440
9105,泰金寶-DR,1540,202,1338,摩根大通,2024-01-23,8440
2002,中鋼,1335,68,1267,摩根大通,2024-01-23,8440
3711,日月光投控,1488,317,1171,摩根大通,2024-01-23,8440
2337,旺宏,1011,86,925,摩根大通,2024-01-23,8440
6116,彩晶,1150,382,768,摩根大通,2024-01-23,8440
2371,大同,792,120,672,摩根大通,2024-01-23,8440
4939,亞電,702,35,667,摩根大通,2024-01-23,8440
2369,菱生,912,248,664,摩根大通,2024-01-23,8440
1514,亞力,901,304,597,摩根大通,2024-01-23,8440
2412,中華電,683,104,579,摩根大通,2024-01-23,8440
6806,森崴能源,636,60,576,摩根大通,2024-01-23,8440
6239,力成,742,183,559,摩根大通,2024-01-23,8440
6187,萬潤,568,12,556,摩根大通,2024-01-23,8440
2498,宏達電,594,39,555,摩根大通,2024-01-23,8440
2465,麗臺,577,49,528,摩根大通,2024-01-23,8440
1519,華城,705,179,526,摩根大通,2024-01-23,8440
4938,和碩,725,201,524,摩根大通,2024-01-23,8440
2880,華南金,753,244,509,摩根大通,2024-01-23,8440
2379,瑞昱,554,46,508,摩根大通,2024-01-23,8440
2383,台光電,620,132,488,摩根大通,2024-01-23,8440
2363,矽統,628,153,475,摩根大通,2024-01-23,8440
8027,鈦昇,491,22,469,摩根大通,2024-01-23,8440
1785,光洋科,462,2,460,摩根大通,2024-01-23,8440
2308,台達電,946,503,443,摩根大通,2024-01-23,8440
1101,台泥,543,104,439,摩根大通,2024-01-23,8440
6237,驊訊,560,136,424,摩根大通,2024-01-23,8440
9958,世紀鋼,654,233,421,摩根大通,2024-01-23,8440
6285,啟��,462,41,421,摩根大通,2024-01-23,8440
1303,南亞,536,120,416,摩根大通,2024-01-23,8440
4960,誠美材,425,23,402,摩根大通,2024-01-23,8440
6140,訊達,596,195,401,摩根大通,2024-01-23,8440
2376,技嘉,738,341,397,摩根大通,2024-01-23,8440
3044,健鼎,433,46,387,摩根大通,2024-01-23,8440
4123,晟德,416,40,376,摩根大通,2024-01-23,8440
2323,中環,503,135,368,摩根大通,2024-01-23,8440
2460,建通,561,212,349,摩根大通,2024-01-23,8440
8105,凌巨,452,104,348,摩根大通,2024-01-23,8440
3481,群創,7704,331,7373,摩根大通,2024-01-24,8440
2891,中信金,4390,34,4356,摩根大通,2024-01-24,8440
3047,訊舟,1990,279,1711,摩根大通,2024-01-24,8440
2618,長榮航,1663,12,1651,摩根大通,2024-01-24,8440
2369,菱生,1957,617,1340,摩根大通,2024-01-24,8440
2344,華邦電,2562,1248,1314,摩根大通,2024-01-24,8440
2002,中鋼,1214,51,1163,摩根大通,2024-01-24,8440
8096,擎亞,1068,95,973,摩根大通,2024-01-24,8440
2504,國產,877,16,861,摩根大通,2024-01-24,8440
2607,榮運,906,45,861,摩根大通,2024-01-24,8440
6770,力積電,1015,192,823,摩根大通,2024-01-24,8440
2887,台新金,789,118,671,摩根大通,2024-01-24,8440
2603,長榮,680,47,633,摩根大通,2024-01-24,8440
6116,彩晶,815,193,622,摩根大通,2024-01-24,8440
9105,泰金寶-DR,798,177,621,摩根大通,2024-01-24,8440
8105,凌巨,672,57,615,摩根大通,2024-01-24,8440
2105,正新,639,34,605,摩根大通,2024-01-24,8440
6213,聯茂,630,30,600,摩根大通,2024-01-24,8440
2330,台積電,3292,2703,589,摩根大通,2024-01-24,8440
3694,海華,734,155,579,摩根大通,2024-01-24,8440
2498,宏達電,629,149,480,摩根大通,2024-01-24,8440
2347,聯強,572,103,469,摩根大通,2024-01-24,8440
8085,福華,503,41,462,摩根大通,2024-01-24,8440
2371,大同,544,131,413,摩根大通,2024-01-24,8440
2331,精英,422,21,401,摩根大通,2024-01-24,8440
3231,緯創,1599,1198,401,摩根大通,2024-01-24,8440
6139,亞翔,412,16,396,摩根大通,2024-01-24,8440
1806,冠軍,401,14,387,摩根大通,2024-01-24,8440
1609,大亞,387,18,369,摩根大通,2024-01-24,8440
2886,兆豐金,552,204,348,摩根大通,2024-01-24,8440
3006,晶豪科,400,69,331,摩根大通,2024-01-24,8440
2421,建準,764,460,304,摩根大通,2024-01-24,8440
6026,福邦證,299,0,299,摩根大通,2024-01-24,8440
2406,國碩,295,2,293,摩根大通,2024-01-24,8440
1102,亞泥,386,110,276,摩根大通,2024-01-24,8440
2329,華泰,568,296,272,摩根大通,2024-01-24,8440
4906,正文,284,13,271,摩根大通,2024-01-24,8440
1785,光洋科,320,49,271,摩根大通,2024-01-24,8440
3607,谷崧,287,19,268,摩根大通,2024-01-24,8440
4129,聯合,333,91,242,摩根大通,2024-01-24,8440
5521,工信,327,92,235,摩根大通,2024-01-24,8440
2365,昆盈,230,0,230,摩根大通,2024-01-24,8440
1513,中興電,258,36,222,摩根大通,2024-01-24,8440
2906,高林,225,3,222,摩根大通,2024-01-24,8440
8299,群聯,232,13,219,摩根大通,2024-01-24,8440
5426,振發,444,226,218,摩根大通,2024-01-24,8440
6509,聚和,238,24,214,摩根大通,2024-01-24,8440
2489,瑞軒,210,3,207,摩根大通,2024-01-24,8440
3715,定穎投控,239,46,193,摩根大通,2024-01-24,8440
6237,驊訊,588,399,189,摩根大通,2024-01-24,8440
2330,台積電,5903,847,5056,摩根大通,2024-01-25,8440
2892,第一金,3049,141,2908,摩根大通,2024-01-25,8440
8110,華東,2166,6,2160,摩根大通,2024-01-25,8440
8069,元太,2099,22,2077,摩根大通,2024-01-25,8440
2891,中信金,2317,458,1859,摩根大通,2024-01-25,8440
2886,兆豐金,1573,1,1572,摩根大通,2024-01-25,8440
6770,力積電,1945,593,1352,摩根大通,2024-01-25,8440
3037,欣興,1898,879,1019,摩根大通,2024-01-25,8440
2890,永豐金,1086,87,999,摩根大通,2024-01-25,8440
1319,東陽,1027,40,987,摩根大通,2024-01-25,8440
2881,富邦金,1034,87,947,摩根大通,2024-01-25,8440
2356,英業達,1434,534,900,摩根大通,2024-01-25,8440
3036,文曄,1056,278,778,摩根大通,2024-01-25,8440
4909,新復興,1289,618,671,摩根大通,2024-01-25,8440
3711,日月光投控,730,88,642,摩根大通,2024-01-25,8440
5876,上海商銀,669,37,632,摩根大通,2024-01-25,8440
2618,長榮航,1541,936,605,摩根大通,2024-01-25,8440
6462,神盾,745,187,558,摩根大通,2024-01-25,8440
2105,正新,661,128,533,摩根大通,2024-01-25,8440
2607,榮運,552,74,478,摩根大通,2024-01-25,8440
5521,工信,468,39,429,摩根大通,2024-01-25,8440
2409,友達,1871,1454,417,摩根大通,2024-01-25,8440
5347,世界,592,180,412,摩根大通,2024-01-25,8440
2371,大同,716,320,396,摩根大通,2024-01-25,8440
2882,國泰金,677,306,371,摩根大通,2024-01-25,8440
3055,蔚華科,453,96,357,摩根大通,2024-01-25,8440
2421,建準,512,169,343,摩根大通,2024-01-25,8440
2362,藍天,366,24,342,摩根大通,2024-01-25,8440
9105,泰金寶-DR,789,451,338,摩根大通,2024-01-25,8440
2454,聯發科,371,35,336,摩根大通,2024-01-25,8440
6187,萬潤,290,0,290,摩根大通,2024-01-25,8440
2303,聯電,3163,2890,273,摩根大通,2024-01-25,8440
1314,中石化,296,29,267,摩根大通,2024-01-25,8440
2002,中鋼,264,1,263,摩根大通,2024-01-25,8440
1785,光洋科,239,1,238,摩根大通,2024-01-25,8440
3017,奇鋐,341,146,195,摩根大通,2024-01-25,8440
3189,景碩,189,2,187,摩根大通,2024-01-25,8440
3045,台灣大,204,20,184,摩根大通,2024-01-25,8440
4113,聯上,174,0,174,摩根大通,2024-01-25,8440
6282,康舒,179,5,174,摩根大通,2024-01-25,8440
1303,南亞,212,43,169,摩根大通,2024-01-25,8440
6505,台塑化,163,6,157,摩根大通,2024-01-25,8440
3041,揚智,167,12,155,摩根大通,2024-01-25,8440
2367,燿華,171,23,148,摩根大通,2024-01-25,8440
8096,擎亞,2597,2452,145,摩根大通,2024-01-25,8440
2301,光寶科,191,47,144,摩根大通,2024-01-25,8440
4904,遠傳,176,36,140,摩根大通,2024-01-25,8440
2603,長榮,295,159,136,摩根大通,2024-01-25,8440
1316,上曜,130,0,130,摩根大通,2024-01-25,8440
6257,矽格,147,20,127,摩根大通,2024-01-25,8440
2891,中信金,7425,385,7040,摩根大通,2024-01-26,8440
2330,台積電,7364,1789,5575,摩根大通,2024-01-26,8440
2883,凱基金,5911,1791,4120,摩根大通,2024-01-26,8440
8069,元太,4435,623,3812,摩根大通,2024-01-26,8440
2618,長榮航,3986,928,3058,摩根大通,2024-01-26,8440
2409,友達,2634,209,2425,摩根大通,2024-01-26,8440
2353,宏��,4531,2711,1820,摩根大通,2024-01-26,8440
3481,群創,3207,1682,1525,摩根大通,2024-01-26,8440
8110,華東,1448,39,1409,摩根大通,2024-01-26,8440
1319,東陽,1482,271,1211,摩根大通,2024-01-26,8440
4162,智擎,1030,30,1000,摩根大通,2024-01-26,8440
2892,第一金,1167,225,942,摩根大通,2024-01-26,8440
9105,泰金寶-DR,3918,3123,795,摩根大通,2024-01-26,8440
2881,富邦金,1574,918,656,摩根大通,2024-01-26,8440
2515,中工,629,2,627,摩根大通,2024-01-26,8440
3665,貿聯-KY,537,43,494,摩根大通,2024-01-26,8440
6415,矽力*-KY,578,86,492,摩根大通,2024-01-26,8440
6770,力積電,894,408,486,摩根大通,2024-01-26,8440
3605,宏致,463,6,457,摩根大通,2024-01-26,8440
1316,上曜,503,48,455,摩根大通,2024-01-26,8440
1101,台泥,538,83,455,摩根大通,2024-01-26,8440
2607,榮運,475,31,444,摩根大通,2024-01-26,8440
1314,中石化,469,27,442,摩根大通,2024-01-26,8440
6270,倍微,824,407,417,摩根大通,2024-01-26,8440
2105,正新,411,26,385,摩根大通,2024-01-26,8440
5521,工信,406,62,344,摩根大通,2024-01-26,8440
2455,全新,432,100,332,摩根大通,2024-01-26,8440
3035,智原,435,104,331,摩根大通,2024-01-26,8440
1514,亞力,378,62,316,摩根大通,2024-01-26,8440
2206,三陽工業,349,35,314,摩根大通,2024-01-26,8440
1718,中纖,322,8,314,摩根大通,2024-01-26,8440
2887,台新金,428,126,302,摩根大通,2024-01-26,8440
2382,廣達,373,89,284,摩根大通,2024-01-26,8440
2890,永豐金,427,155,272,摩根大通,2024-01-26,8440
3024,憶聲,310,42,268,摩根大通,2024-01-26,8440
3360,尚立,503,237,266,摩根大通,2024-01-26,8440
6113,亞矽,347,82,265,摩根大通,2024-01-26,8440
3576,聯合再生,308,46,262,摩根大通,2024-01-26,8440
4968,立積,340,85,255,摩根大通,2024-01-26,8440
2812,台中銀,281,33,248,摩根大通,2024-01-26,8440
2449,京元電子,456,208,248,摩根大通,2024-01-26,8440
2337,旺宏,353,110,243,摩根大通,2024-01-26,8440
2308,台達電,274,34,240,摩根大通,2024-01-26,8440
2002,中鋼,397,162,235,摩根大通,2024-01-26,8440
2885,元大金,860,647,213,摩根大通,2024-01-26,8440
2376,技嘉,405,193,212,摩根大通,2024-01-26,8440
2836,高雄銀,207,0,207,摩根大通,2024-01-26,8440
4746,台耀,279,80,199,摩根大通,2024-01-26,8440
6282,康舒,232,35,197,摩根大通,2024-01-26,8440
2360,致茂,252,57,195,摩根大通,2024-01-26,8440
2330,台積電,6621,1373,5248,摩根大通,2024-01-29,8440
2618,長榮航,5640,720,4920,摩根大通,2024-01-29,8440
3037,欣興,3762,65,3697,摩根大通,2024-01-29,8440
9105,泰金寶-DR,1251,0,1251,摩根大通,2024-01-29,8440
2455,全新,1059,27,1032,摩根大通,2024-01-29,8440
6235,華孚,987,103,884,摩根大通,2024-01-29,8440
2409,友達,1149,452,697,摩根大通,2024-01-29,8440
2882,國泰金,1220,547,673,摩根大通,2024-01-29,8440
2892,第一金,816,151,665,摩根大通,2024-01-29,8440
6239,力成,1027,383,644,摩根大通,2024-01-29,8440
2891,中信金,724,187,537,摩根大通,2024-01-29,8440
8069,元太,1597,1074,523,摩根大通,2024-01-29,8440
2886,兆豐金,631,143,488,摩根大通,2024-01-29,8440
2002,中鋼,516,31,485,摩根大通,2024-01-29,8440
2421,建準,869,408,461,摩根大通,2024-01-29,8440
4113,聯上,456,0,456,摩根大通,2024-01-29,8440
8085,福華,734,293,441,摩根大通,2024-01-29,8440
4532,瑞智,411,10,401,摩根大通,2024-01-29,8440
3437,榮創,376,0,376,摩根大通,2024-01-29,8440
2383,台光電,408,34,374,摩根大通,2024-01-29,8440
2883,凱基金,2208,1847,361,摩根大通,2024-01-29,8440
6415,矽力*-KY,421,70,351,摩根大通,2024-01-29,8440
2408,南亞科,422,73,349,摩根大通,2024-01-29,8440
1519,華城,488,141,347,摩根大通,2024-01-29,8440
3483,力致,353,11,342,摩根大通,2024-01-29,8440
1560,中砂,355,14,341,摩根大通,2024-01-29,8440
2353,宏��,653,320,333,摩根大通,2024-01-29,8440
1722,台肥,358,28,330,摩根大通,2024-01-29,8440
1605,華新,371,50,321,摩根大通,2024-01-29,8440
3055,蔚華科,378,106,272,摩根大通,2024-01-29,8440
2453,凌群,272,11,261,摩根大通,2024-01-29,8440
1514,亞力,291,31,260,摩根大通,2024-01-29,8440
3450,聯鈞,302,53,249,摩根大通,2024-01-29,8440
1301,台塑,270,27,243,摩根大通,2024-01-29,8440
2388,威盛,258,18,240,摩根大通,2024-01-29,8440
2534,宏盛,234,1,233,摩根大通,2024-01-29,8440
5210,寶碩,226,7,219,摩根大通,2024-01-29,8440
1524,耿鼎,213,10,203,摩根大通,2024-01-29,8440
1718,中纖,213,11,202,摩根大通,2024-01-29,8440
1708,東鹼,188,0,188,摩根大通,2024-01-29,8440
2201,裕隆,212,24,188,摩根大通,2024-01-29,8440
5443,均豪,203,15,188,摩根大通,2024-01-29,8440
6164,華興,187,0,187,摩根大通,2024-01-29,8440
8044,網家,182,0,182,摩根大通,2024-01-29,8440
3014,聯陽,191,15,176,摩根大通,2024-01-29,8440
2603,長榮,224,50,174,摩根大通,2024-01-29,8440
2748,雲品,214,41,173,摩根大通,2024-01-29,8440
3363,上詮,236,63,173,摩根大通,2024-01-29,8440
3481,群創,1485,1313,172,摩根大通,2024-01-29,8440
8112,至上,212,40,172,摩根大通,2024-01-29,8440
3481,群創,7816,1850,5966,摩根大通,2024-01-30,8440
3037,欣興,2241,592,1649,摩根大通,2024-01-30,8440
3324,雙鴻,1611,54,1557,摩根大通,2024-01-30,8440
2317,鴻海,1738,593,1145,摩根大通,2024-01-30,8440
2382,廣達,2163,1220,943,摩根大通,2024-01-30,8440
2368,金像電,1310,404,906,摩根大通,2024-01-30,8440
3189,景碩,892,65,827,摩根大通,2024-01-30,8440
2324,仁寶,1228,418,810,摩根大通,2024-01-30,8440
2455,全新,712,119,593,摩根大通,2024-01-30,8440
4908,前鼎,831,291,540,摩根大通,2024-01-30,8440
6274,台燿,538,87,451,摩根大通,2024-01-30,8440
3231,緯創,949,499,450,摩根大通,2024-01-30,8440
1301,台塑,531,82,449,摩根大通,2024-01-30,8440
3041,揚智,500,135,365,摩根大通,2024-01-30,8440
6187,萬潤,361,0,361,摩根大通,2024-01-30,8440
3483,力致,358,8,350,摩根大通,2024-01-30,8440
9904,寶成,793,455,338,摩根大通,2024-01-30,8440
6415,矽力*-KY,446,115,331,摩根大通,2024-01-30,8440
3711,日月光投控,443,141,302,摩根大通,2024-01-30,8440
9105,泰金寶-DR,297,0,297,摩根大通,2024-01-30,8440
2303,聯電,5029,4732,297,摩根大通,2024-01-30,8440
8040,九暘,331,43,288,摩根大通,2024-01-30,8440
6140,訊達,290,20,270,摩根大通,2024-01-30,8440
4939,亞電,331,63,268,摩根大通,2024-01-30,8440
8096,擎亞,476,215,261,摩根大通,2024-01-30,8440
2329,華泰,528,284,244,摩根大通,2024-01-30,8440
2383,台光電,489,249,240,摩根大通,2024-01-30,8440
5426,振發,565,335,230,摩根大通,2024-01-30,8440
1519,華城,492,263,229,摩根大通,2024-01-30,8440
2882,國泰金,637,422,215,摩根大通,2024-01-30,8440
3338,泰碩,240,36,204,摩根大通,2024-01-30,8440
2474,可成,343,139,204,摩根大通,2024-01-30,8440
2367,燿華,205,2,203,摩根大通,2024-01-30,8440
1605,華新,354,153,201,摩根大通,2024-01-30,8440
6139,亞翔,222,45,177,摩根大通,2024-01-30,8440
2442,新美齊,178,7,171,摩根大通,2024-01-30,8440
8050,廣積,160,2,158,摩根大通,2024-01-30,8440
1514,亞力,385,230,155,摩根大通,2024-01-30,8440
4904,遠傳,426,275,151,摩根大通,2024-01-30,8440
2449,京元電子,225,80,145,摩根大通,2024-01-30,8440
8086,宏捷科,193,50,143,摩根大通,2024-01-30,8440
6179,亞通,149,10,139,摩根大通,2024-01-30,8440
4979,華星光,150,11,139,摩根大通,2024-01-30,8440
2301,光寶科,328,202,126,摩根大通,2024-01-30,8440
2748,雲品,147,23,124,摩根大通,2024-01-30,8440
3530,晶相光,131,13,118,摩根大通,2024-01-30,8440
3704,合勤控,120,4,116,摩根大通,2024-01-30,8440
3450,聯鈞,116,1,115,摩根大通,2024-01-30,8440
4958,臻鼎-KY,186,74,112,摩根大通,2024-01-30,8440
1904,正隆,117,8,109,摩根大通,2024-01-30,8440
3481,群創,9403,2717,6686,摩根大通,2024-01-31,8440
1101,台泥,3165,491,2674,摩根大通,2024-01-31,8440
2892,第一金,2804,810,1994,摩根大通,2024-01-31,8440
2845,遠東銀,1183,0,1183,摩根大通,2024-01-31,8440
2104,國際中橡,1002,0,1002,摩根大通,2024-01-31,8440
2882,國泰金,2174,1179,995,摩根大通,2024-01-31,8440
2903,遠百,997,4,993,摩根大通,2024-01-31,8440
2812,台中銀,937,10,927,摩根大通,2024-01-31,8440
8054,安國,951,71,880,摩根大通,2024-01-31,8440
8086,宏捷科,823,40,783,摩根大通,2024-01-31,8440
2851,中再保,788,45,743,摩根大通,2024-01-31,8440
1301,台塑,1029,314,715,摩根大通,2024-01-31,8440
2881,富邦金,1747,1054,693,摩根大通,2024-01-31,8440
6139,亞翔,774,99,675,摩根大通,2024-01-31,8440
2801,彰銀,1267,628,639,摩根大通,2024-01-31,8440
2377,微星,794,179,615,摩根大通,2024-01-31,8440
2354,鴻準,734,161,573,摩根大通,2024-01-31,8440
5880,合庫金,1166,633,533,摩根大通,2024-01-31,8440
3362,先進光,741,232,509,摩根大通,2024-01-31,8440
1504,東元,590,86,504,摩根大通,2024-01-31,8440
6415,矽力*-KY,762,307,455,摩根大通,2024-01-31,8440
3376,新日興,502,48,454,摩根大通,2024-01-31,8440
1795,美時,450,16,434,摩根大通,2024-01-31,8440
3055,蔚華科,1102,711,391,摩根大通,2024-01-31,8440
2313,華通,486,96,390,摩根大通,2024-01-31,8440
5009,榮剛,406,20,386,摩根大通,2024-01-31,8440
2344,華邦電,786,406,380,摩根大通,2024-01-31,8440
8089,康全電訊,445,85,360,摩根大通,2024-01-31,8440
2201,裕隆,353,24,329,摩根大通,2024-01-31,8440
5483,中美晶,342,23,319,摩根大通,2024-01-31,8440
6182,合晶,364,46,318,摩根大通,2024-01-31,8440
2337,旺宏,1686,1375,311,摩根大通,2024-01-31,8440
6180,橘子,451,162,289,摩根大通,2024-01-31,8440
6147,頎邦,302,14,288,摩根大通,2024-01-31,8440
3017,奇鋐,341,64,277,摩根大通,2024-01-31,8440
2633,台灣高鐵,307,30,277,摩根大通,2024-01-31,8440
9105,泰金寶-DR,254,0,254,摩根大通,2024-01-31,8440
6585,鼎基,296,47,249,摩根大通,2024-01-31,8440
4904,遠傳,584,337,247,摩根大通,2024-01-31,8440
2449,京元電子,320,76,244,摩根大通,2024-01-31,8440
3702,大聯大,510,267,243,摩根大通,2024-01-31,8440
1434,福懋,359,121,238,摩根大通,2024-01-31,8440
2641,正德,236,3,233,摩根大通,2024-01-31,8440
2329,華泰,632,412,220,摩根大通,2024-01-31,8440
2371,大同,549,333,216,摩根大通,2024-01-31,8440
5876,上海商銀,491,278,213,摩根大通,2024-01-31,8440
1313,聯成,242,33,209,摩根大通,2024-01-31,8440
2357,華碩,418,216,202,摩根大通,2024-01-31,8440
9802,鈺齊-KY,212,15,197,摩根大通,2024-01-31,8440
1303,南亞,846,653,193,摩根大通,2024-01-31,8440
2891,中信金,5089,2229,2860,摩根大通,2024-02-01,8440
2603,長榮,2488,267,2221,摩根大通,2024-02-01,8440
3481,群創,4347,2193,2154,摩根大通,2024-02-01,8440
2618,長榮航,1363,396,967,摩根大通,2024-02-01,8440
8069,元太,1217,261,956,摩根大通,2024-02-01,8440
3017,奇鋐,1308,380,928,摩根大通,2024-02-01,8440
3036,文曄,1284,384,900,摩根大通,2024-02-01,8440
2801,彰銀,1593,845,748,摩根大通,2024-02-01,8440
1216,統一,1311,619,692,摩根大通,2024-02-01,8440
2363,矽統,763,114,649,摩根大通,2024-02-01,8440
2504,國產,540,35,505,摩根大通,2024-02-01,8440
2329,華泰,740,241,499,摩根大通,2024-02-01,8440
2637,慧洋-KY,490,5,485,摩根大通,2024-02-01,8440
1301,台塑,772,331,441,摩根大通,2024-02-01,8440
2634,漢翔,494,73,421,摩根大通,2024-02-01,8440
6442,光聖,478,60,418,摩根大通,2024-02-01,8440
2376,技嘉,575,197,378,摩根大通,2024-02-01,8440
2886,兆豐金,1882,1512,370,摩根大通,2024-02-01,8440
3702,大聯大,510,200,310,摩根大通,2024-02-01,8440
3032,偉訓,501,195,306,摩根大通,2024-02-01,8440
5871,中租-KY,463,160,303,摩根大通,2024-02-01,8440
2609,陽明,520,232,288,摩根大通,2024-02-01,8440
1513,中興電,429,141,288,摩根大通,2024-02-01,8440
5426,振發,466,181,285,摩根大通,2024-02-01,8440
1795,美時,291,9,282,摩根大通,2024-02-01,8440
3041,揚智,666,388,278,摩根大通,2024-02-01,8440
2367,燿華,277,2,275,摩根大通,2024-02-01,8440
2356,英業達,937,683,254,摩根大通,2024-02-01,8440
2330,台積電,6650,6407,243,摩根大通,2024-02-01,8440
3081,聯亞,305,72,233,摩根大通,2024-02-01,8440
8046,南電,257,25,232,摩根大通,2024-02-01,8440
2421,建準,587,365,222,摩根大通,2024-02-01,8440
3055,蔚華科,447,226,221,摩根大通,2024-02-01,8440
6239,力成,265,52,213,摩根大通,2024-02-01,8440
2360,致茂,213,2,211,摩根大通,2024-02-01,8440
2357,華碩,306,96,210,摩根大通,2024-02-01,8440
2889,國票金,196,0,196,摩根大通,2024-02-01,8440
9105,泰金寶-DR,228,36,192,摩根大通,2024-02-01,8440
2442,新美齊,232,41,191,摩根大通,2024-02-01,8440
6585,鼎基,288,107,181,摩根大通,2024-02-01,8440
1609,大亞,396,219,177,摩根大通,2024-02-01,8440
2371,大同,643,471,172,摩根大通,2024-02-01,8440
2903,遠百,193,21,172,摩根大通,2024-02-01,8440
3037,欣興,428,259,169,摩根大通,2024-02-01,8440
6451,訊芯-KY,277,109,168,摩根大通,2024-02-01,8440
6462,神盾,192,25,167,摩根大通,2024-02-01,8440
1590,亞德客-KY,223,56,167,摩根大通,2024-02-01,8440
1618,合機,196,43,153,摩根大通,2024-02-01,8440
3044,健鼎,176,23,153,摩根大通,2024-02-01,8440
8210,勤誠,264,114,150,摩根大通,2024-02-01,8440
2421,建準,6084,518,5566,摩根大通,2024-02-02,8440
3231,緯創,4751,737,4014,摩根大通,2024-02-02,8440
1513,中興電,3157,290,2867,摩根大通,2024-02-02,8440
2409,友達,2482,114,2368,摩根大通,2024-02-02,8440
3037,欣興,2199,205,1994,摩根大通,2024-02-02,8440
8069,元太,1724,58,1666,摩根大通,2024-02-02,8440
2356,英業達,1590,227,1363,摩根大通,2024-02-02,8440
2382,廣達,1360,47,1313,摩根大通,2024-02-02,8440
3081,聯亞,1281,102,1179,摩根大通,2024-02-02,8440
2454,聯發科,1196,103,1093,摩根大通,2024-02-02,8440
2801,彰銀,1117,101,1016,摩根大通,2024-02-02,8440
2002,中鋼,1121,151,970,摩根大通,2024-02-02,8440
2610,華航,934,60,874,摩根大通,2024-02-02,8440
2330,台積電,4177,3328,849,摩根大通,2024-02-02,8440
2329,華泰,1046,310,736,摩根大通,2024-02-02,8440
2317,鴻海,1538,817,721,摩根大通,2024-02-02,8440
2634,漢翔,708,79,629,摩根大通,2024-02-02,8440
1605,華新,634,16,618,摩根大通,2024-02-02,8440
6533,晶心科,558,16,542,摩根大通,2024-02-02,8440
2301,光寶科,580,62,518,摩根大通,2024-02-02,8440
3035,智原,805,331,474,摩根大通,2024-02-02,8440
3105,穩懋,474,23,451,摩根大通,2024-02-02,8440
2889,國票金,456,13,443,摩根大通,2024-02-02,8440
3036,文曄,1181,764,417,摩根大通,2024-02-02,8440
5426,振發,412,14,398,摩根大通,2024-02-02,8440
2412,中華電,576,187,389,摩根大通,2024-02-02,8440
2887,台新金,556,173,383,摩根大通,2024-02-02,8440
2542,興富發,373,32,341,摩根大通,2024-02-02,8440
3483,力致,405,74,331,摩根大通,2024-02-02,8440
2105,正新,332,29,303,摩根大通,2024-02-02,8440
2880,華南金,703,400,303,摩根大通,2024-02-02,8440
2385,群光,497,201,296,摩根大通,2024-02-02,8440
2834,臺企銀,320,37,283,摩根大通,2024-02-02,8440
6505,台塑化,306,38,268,摩根大通,2024-02-02,8440
6213,聯茂,267,2,265,摩根大通,2024-02-02,8440
1303,南亞,291,38,253,摩根大通,2024-02-02,8440
3622,洋華,364,118,246,摩根大通,2024-02-02,8440
3711,日月光投控,1152,913,239,摩根大通,2024-02-02,8440
3032,偉訓,275,37,238,摩根大通,2024-02-02,8440
2354,鴻準,246,12,234,摩根大通,2024-02-02,8440
2402,毅嘉,326,93,233,摩根大通,2024-02-02,8440
3530,晶相光,260,27,233,摩根大通,2024-02-02,8440
1301,台塑,240,9,231,摩根大通,2024-02-02,8440
8046,南電,231,3,228,摩根大通,2024-02-02,8440
2455,全新,269,45,224,摩根大通,2024-02-02,8440
1326,台化,232,16,216,摩根大通,2024-02-02,8440
2367,燿華,251,35,216,摩根大通,2024-02-02,8440
3706,神達,210,2,208,摩根大通,2024-02-02,8440
2395,研華,274,96,178,摩根大通,2024-02-02,8440
2308,台達電,234,59,175,摩根大通,2024-02-02,8440
2330,台積電,13010,1822,11188,摩根大通,2024-02-05,8440
3231,緯創,10296,2218,8078,摩根大通,2024-02-05,8440
2618,長榮航,3030,236,2794,摩根大通,2024-02-05,8440
2313,華通,2878,174,2704,摩根大通,2024-02-05,8440
2610,華航,2488,502,1986,摩根大通,2024-02-05,8440
2454,聯發科,2151,594,1557,摩根大通,2024-02-05,8440
2317,鴻海,2308,778,1530,摩根大通,2024-02-05,8440
2382,廣達,1939,705,1234,摩根大通,2024-02-05,8440
2412,中華電,1563,350,1213,摩根大通,2024-02-05,8440
8096,擎亞,1131,191,940,摩根大通,2024-02-05,8440
3035,智原,1300,514,786,摩根大通,2024-02-05,8440
3443,創意,699,43,656,摩根大通,2024-02-05,8440
6290,良維,641,2,639,摩根大通,2024-02-05,8440
8210,勤誠,778,180,598,摩根大通,2024-02-05,8440
2395,研華,857,266,591,摩根大通,2024-02-05,8440
2801,彰銀,803,311,492,摩根大通,2024-02-05,8440
2634,漢翔,489,56,433,摩根大通,2024-02-05,8440
3693,營邦,527,111,416,摩根大通,2024-02-05,8440
2883,凱基金,1474,1113,361,摩根大通,2024-02-05,8440
2812,台中銀,306,32,274,摩根大通,2024-02-05,8440
6274,台燿,559,296,263,摩根大通,2024-02-05,8440
1907,永豐餘,371,111,260,摩根大通,2024-02-05,8440
6282,康舒,299,44,255,摩根大通,2024-02-05,8440
3312,弘憶股,319,66,253,摩根大通,2024-02-05,8440
3363,上詮,628,382,246,摩根大通,2024-02-05,8440
2809,京城銀,313,73,240,摩根大通,2024-02-05,8440
3576,聯合再生,492,264,228,摩根大通,2024-02-05,8440
2356,英業達,641,415,226,摩根大通,2024-02-05,8440
3706,神達,278,75,203,摩根大通,2024-02-05,8440
8046,南電,241,39,202,摩根大通,2024-02-05,8440
5871,中租-KY,324,128,196,摩根大通,2024-02-05,8440
2353,宏��,595,411,184,摩根大通,2024-02-05,8440
5210,寶碩,237,56,181,摩根大通,2024-02-05,8440
6112,邁達特,325,159,166,摩根大通,2024-02-05,8440
9105,泰金寶-DR,165,0,165,摩根大通,2024-02-05,8440
1210,大成,186,27,159,摩根大通,2024-02-05,8440
4956,光鋐,156,3,153,摩根大通,2024-02-05,8440
3044,健鼎,232,86,146,摩根大通,2024-02-05,8440
6213,聯茂,304,161,143,摩根大通,2024-02-05,8440
3622,洋華,191,52,139,摩根大通,2024-02-05,8440
6113,亞矽,240,106,134,摩根大通,2024-02-05,8440
1402,遠東新,376,247,129,摩根大通,2024-02-05,8440
2206,三陽工業,162,35,127,摩根大通,2024-02-05,8440
2376,技嘉,400,278,122,摩根大通,2024-02-05,8440
3362,先進光,195,75,120,摩根大通,2024-02-05,8440
3661,世芯-KY,194,77,117,摩根大通,2024-02-05,8440
2385,群光,255,142,113,摩根大通,2024-02-05,8440
6742,澤米,119,6,113,摩根大通,2024-02-05,8440
3006,晶豪科,152,39,113,摩根大通,2024-02-05,8440
3702,大聯大,515,405,110,摩根大通,2024-02-05,8440
2324,仁寶,4298,1234,3064,摩根大通,2024-02-15,8440
2363,矽統,2452,37,2415,摩根大通,2024-02-15,8440
2405,輔信,2296,143,2153,摩根大通,2024-02-15,8440
2330,台積電,9224,7102,2122,摩根大通,2024-02-15,8440
1785,光洋科,2041,42,1999,摩根大通,2024-02-15,8440
2369,菱生,1452,90,1362,摩根大通,2024-02-15,8440
3036,文曄,1495,369,1126,摩根大通,2024-02-15,8440
6125,廣運,1405,314,1091,摩根大通,2024-02-15,8440
1609,大亞,1091,46,1045,摩根大通,2024-02-15,8440
2395,研華,1224,274,950,摩根大通,2024-02-15,8440
3706,神達,1206,279,927,摩根大通,2024-02-15,8440
3483,力致,915,89,826,摩根大通,2024-02-15,8440
6239,力成,1007,237,770,摩根大通,2024-02-15,8440
3047,訊舟,696,21,675,摩根大通,2024-02-15,8440
4966,譜瑞-KY,691,27,664,摩根大通,2024-02-15,8440
2347,聯強,1042,408,634,摩根大通,2024-02-15,8440
2637,慧洋-KY,664,49,615,摩根大通,2024-02-15,8440
2454,聯發科,994,387,607,摩根大通,2024-02-15,8440
2812,台中銀,807,232,575,摩根大通,2024-02-15,8440
6770,力積電,1456,883,573,摩根大通,2024-02-15,8440
6120,達運,607,50,557,摩根大通,2024-02-15,8440
2387,精元,555,6,549,摩根大通,2024-02-15,8440
2371,大同,938,393,545,摩根大通,2024-02-15,8440
6415,矽力*-KY,654,144,510,摩根大通,2024-02-15,8440
6274,台燿,908,407,501,摩根大通,2024-02-15,8440
1522,堤維西,496,13,483,摩根大通,2024-02-15,8440
3450,聯鈞,714,249,465,摩根大通,2024-02-15,8440
6126,信音,463,7,456,摩根大通,2024-02-15,8440
4953,緯軟,455,4,451,摩根大通,2024-02-15,8440
6290,良維,624,194,430,摩根大通,2024-02-15,8440
2603,長榮,1127,700,427,摩根大通,2024-02-15,8440
2329,華泰,996,573,423,摩根大通,2024-02-15,8440
2059,川湖,470,50,420,摩根大通,2024-02-15,8440
5457,宣德,397,5,392,摩根大通,2024-02-15,8440
2606,裕民,504,145,359,摩根大通,2024-02-15,8440
2537,聯上發,405,51,354,摩根大通,2024-02-15,8440
3437,榮創,401,47,354,摩根大通,2024-02-15,8440
2889,國票金,540,189,351,摩根大通,2024-02-15,8440
2399,映泰,465,117,348,摩根大通,2024-02-15,8440
3014,聯陽,367,29,338,摩根大通,2024-02-15,8440
4915,致伸,358,22,336,摩根大通,2024-02-15,8440
6196,帆宣,445,110,335,摩根大通,2024-02-15,8440
3592,瑞鼎,348,15,333,摩根大通,2024-02-15,8440
6414,樺漢,381,49,332,摩根大通,2024-02-15,8440
2476,鉅祥,391,61,330,摩根大通,2024-02-15,8440
4904,遠傳,714,390,324,摩根大通,2024-02-15,8440
6548,長科*,298,2,296,摩根大通,2024-02-15,8440
3583,辛耘,479,187,292,摩根大通,2024-02-15,8440
1718,中纖,337,60,277,摩根大通,2024-02-15,8440
8454,富邦媒,550,277,273,摩根大通,2024-02-15,8440
3231,緯創,7156,984,6172,摩根大通,2024-02-16,8440
6120,達運,2998,33,2965,摩根大通,2024-02-16,8440
2409,友達,2634,344,2290,摩根大通,2024-02-16,8440
2324,仁寶,3813,1847,1966,摩根大通,2024-02-16,8440
6770,力積電,2215,303,1912,摩根大通,2024-02-16,8440
2313,華通,1978,93,1885,摩根大通,2024-02-16,8440
2408,南亞科,2058,416,1642,摩根大通,2024-02-16,8440
2399,映泰,1624,37,1587,摩根大通,2024-02-16,8440
2317,鴻海,2922,1401,1521,摩根大通,2024-02-16,8440
3014,聯陽,1479,74,1405,摩根大通,2024-02-16,8440
1513,中興電,1424,103,1321,摩根大通,2024-02-16,8440
3481,群創,1616,329,1287,摩根大通,2024-02-16,8440
1609,大亞,1290,50,1240,摩根大通,2024-02-16,8440
2405,輔信,1376,205,1171,摩根大通,2024-02-16,8440
2206,三陽工業,1201,44,1157,摩根大通,2024-02-16,8440
5347,世界,1272,136,1136,摩根大通,2024-02-16,8440
2867,三商壽,1139,30,1109,摩根大通,2024-02-16,8440
2883,凱基金,2367,1342,1025,摩根大通,2024-02-16,8440
2301,光寶科,1790,842,948,摩根大通,2024-02-16,8440
1216,統一,1430,514,916,摩根大通,2024-02-16,8440
8096,擎亞,1014,128,886,摩根大通,2024-02-16,8440
2383,台光電,1683,825,858,摩根大通,2024-02-16,8440
1101,台泥,1130,272,858,摩根大通,2024-02-16,8440
3044,健鼎,931,75,856,摩根大通,2024-02-16,8440
4938,和碩,1052,246,806,摩根大通,2024-02-16,8440
6153,嘉聯益,854,50,804,摩根大通,2024-02-16,8440
2605,新興,808,45,763,摩根大通,2024-02-16,8440
2330,台積電,2244,1496,748,摩根大通,2024-02-16,8440
2352,佳世達,1022,337,685,摩根大通,2024-02-16,8440
4908,前鼎,856,181,675,摩根大通,2024-02-16,8440
2618,長榮航,858,186,672,摩根大通,2024-02-16,8440
2376,技嘉,1141,497,644,摩根大通,2024-02-16,8440
2515,中工,789,159,630,摩根大通,2024-02-16,8440
8936,國統,911,282,629,摩根大通,2024-02-16,8440
1905,華紙,651,39,612,摩根大通,2024-02-16,8440
3702,大聯大,897,296,601,摩根大通,2024-02-16,8440
3055,蔚華科,639,41,598,摩根大通,2024-02-16,8440
6509,聚和,573,6,567,摩根大通,2024-02-16,8440
2489,瑞軒,567,16,551,摩根大通,2024-02-16,8440
5512,力麒,551,1,550,摩根大通,2024-02-16,8440
4714,永捷,665,162,503,摩根大通,2024-02-16,8440
3673,TPK-KY,523,46,477,摩根大通,2024-02-16,8440
2356,英業達,1099,639,460,摩根大通,2024-02-16,8440
2882,國泰金,534,81,453,摩根大通,2024-02-16,8440
8054,安國,598,152,446,摩根大通,2024-02-16,8440
8040,九暘,446,28,418,摩根大通,2024-02-16,8440
5426,振發,461,67,394,摩根大通,2024-02-16,8440
2363,矽統,1623,1233,390,摩根大通,2024-02-16,8440
1608,華榮,381,1,380,摩根大通,2024-02-16,8440
6799,來頡,381,12,369,摩根大通,2024-02-16,8440
3481,群創,13833,1673,12160,摩根大通,2024-02-19,8440
2867,三商壽,5097,137,4960,摩根大通,2024-02-19,8440
2329,華泰,4590,1492,3098,摩根大通,2024-02-19,8440
2317,鴻海,2958,502,2456,摩根大通,2024-02-19,8440
2409,友達,2405,657,1748,摩根大通,2024-02-19,8440
6116,彩晶,1958,241,1717,摩根大通,2024-02-19,8440
1101,台泥,1993,642,1351,摩根大通,2024-02-19,8440
2504,國產,1311,4,1307,摩根大通,2024-02-19,8440
1609,大亞,1395,143,1252,摩根大通,2024-02-19,8440
1514,亞力,1599,438,1161,摩根大通,2024-02-19,8440
5443,均豪,1370,212,1158,摩根大通,2024-02-19,8440
5512,力麒,1219,80,1139,摩根大通,2024-02-19,8440
6770,力積電,1158,60,1098,摩根大通,2024-02-19,8440
8936,國統,1274,217,1057,摩根大通,2024-02-19,8440
2883,凱基金,1331,348,983,摩根大通,2024-02-19,8440
3037,欣興,2611,1641,970,摩根大通,2024-02-19,8440
2324,仁寶,2431,1476,955,摩根大通,2024-02-19,8440
2009,第一銅,915,61,854,摩根大通,2024-02-19,8440
4960,誠美材,1116,269,847,摩根大通,2024-02-19,8440
2369,菱生,3672,2871,801,摩根大通,2024-02-19,8440
2406,國碩,804,4,800,摩根大通,2024-02-19,8440
2891,中信金,1360,581,779,摩根大通,2024-02-19,8440
2539,櫻花建,793,114,679,摩根大通,2024-02-19,8440
2884,玉山金,669,1,668,摩根大通,2024-02-19,8440
2881,富邦金,662,11,651,摩根大通,2024-02-19,8440
2408,南亞科,1071,422,649,摩根大通,2024-02-19,8440
2371,大同,805,158,647,摩根大通,2024-02-19,8440
1718,中纖,978,364,614,摩根大通,2024-02-19,8440
1522,堤維西,632,27,605,摩根大通,2024-02-19,8440
2405,輔信,789,189,600,摩根大通,2024-02-19,8440
4909,新復興,853,270,583,摩根大通,2024-02-19,8440
6120,達運,645,66,579,摩根大通,2024-02-19,8440
2834,臺企銀,575,0,575,摩根大通,2024-02-19,8440
3372,典範,597,28,569,摩根大通,2024-02-19,8440
8086,宏捷科,698,133,565,摩根大通,2024-02-19,8440
4958,臻鼎-KY,715,162,553,摩根大通,2024-02-19,8440
3363,上詮,928,394,534,摩根大通,2024-02-19,8440
4938,和碩,648,125,523,摩根大通,2024-02-19,8440
3545,敦泰,525,46,479,摩根大通,2024-02-19,8440
2454,聯發科,596,128,468,摩根大通,2024-02-19,8440
1303,南亞,736,270,466,摩根大通,2024-02-19,8440
8110,華東,681,227,454,摩根大通,2024-02-19,8440
2880,華南金,479,29,450,摩根大通,2024-02-19,8440
2002,中鋼,621,176,445,摩根大通,2024-02-19,8440
6005,群益證,458,18,440,摩根大通,2024-02-19,8440
2618,長榮航,685,254,431,摩根大通,2024-02-19,8440
4968,立積,676,245,431,摩根大通,2024-02-19,8440
5347,世界,447,49,398,摩根大通,2024-02-19,8440
1314,中石化,412,34,378,摩根大通,2024-02-19,8440
9105,泰金寶-DR,374,0,374,摩根大通,2024-02-19,8440
2881,富邦金,3559,193,3366,摩根大通,2024-02-20,8440
2892,第一金,3443,554,2889,摩根大通,2024-02-20,8440
2303,聯電,3085,551,2534,摩根大通,2024-02-20,8440
2885,元大金,2826,688,2138,摩根大通,2024-02-20,8440
2886,兆豐金,2554,645,1909,摩根大通,2024-02-20,8440
2409,友達,2507,915,1592,摩根大通,2024-02-20,8440
1815,富喬,1581,69,1512,摩根大通,2024-02-20,8440
2324,仁寶,1977,523,1454,摩根大通,2024-02-20,8440
2891,中信金,2665,1430,1235,摩根大通,2024-02-20,8440
3702,大聯大,1572,404,1168,摩根大通,2024-02-20,8440
1522,堤維西,1297,165,1132,摩根大通,2024-02-20,8440
2408,南亞科,1965,885,1080,摩根大通,2024-02-20,8440
2637,慧洋-KY,943,19,924,摩根大通,2024-02-20,8440
2603,長榮,988,97,891,摩根大通,2024-02-20,8440
2618,長榮航,1100,310,790,摩根大通,2024-02-20,8440
4714,永捷,1408,754,654,摩根大通,2024-02-20,8440
2329,華泰,1108,527,581,摩根大通,2024-02-20,8440
2360,致茂,613,49,564,摩根大通,2024-02-20,8440
2606,裕民,587,59,528,摩根大通,2024-02-20,8440
2357,華碩,592,81,511,摩根大通,2024-02-20,8440
4938,和碩,874,430,444,摩根大通,2024-02-20,8440
1319,東陽,548,119,429,摩根大通,2024-02-20,8440
2454,聯發科,488,68,420,摩根大通,2024-02-20,8440
1605,華新,631,240,391,摩根大通,2024-02-20,8440
1519,華城,482,118,364,摩根大通,2024-02-20,8440
6770,力積電,724,362,362,摩根大通,2024-02-20,8440
3711,日月光投控,418,66,352,摩根大通,2024-02-20,8440
3034,聯詠,911,565,346,摩根大通,2024-02-20,8440
5469,瀚宇博,393,52,341,摩根大通,2024-02-20,8440
2059,川湖,347,14,333,摩根大通,2024-02-20,8440
2605,新興,410,91,319,摩根大通,2024-02-20,8440
6239,力成,315,22,293,摩根大通,2024-02-20,8440
2204,中華,301,16,285,摩根大通,2024-02-20,8440
2009,第一銅,418,136,282,摩根大通,2024-02-20,8440
2834,臺企銀,307,31,276,摩根大通,2024-02-20,8440
2347,聯強,379,111,268,摩根大通,2024-02-20,8440
2543,皇昌,445,195,250,摩根大通,2024-02-20,8440
1216,統一,1037,787,250,摩根大通,2024-02-20,8440
6488,環球晶,237,0,237,摩根大通,2024-02-20,8440
6016,康和證,219,0,219,摩根大通,2024-02-20,8440
8936,國統,314,100,214,摩根大通,2024-02-20,8440
9103,美德醫療-DR,225,14,211,摩根大通,2024-02-20,8440
9105,泰金寶-DR,210,0,210,摩根大通,2024-02-20,8440
8086,宏捷科,707,498,209,摩根大通,2024-02-20,8440
3322,建舜電,203,0,203,摩根大通,2024-02-20,8440
3712,永崴投控,520,319,201,摩根大通,2024-02-20,8440
8064,東捷,338,143,195,摩根大通,2024-02-20,8440
2383,台光電,338,147,191,摩根大通,2024-02-20,8440
2337,旺宏,368,180,188,摩根大通,2024-02-20,8440
6147,頎邦,289,102,187,摩根大通,2024-02-20,8440
2891,中信金,7658,2843,4815,摩根大通,2024-02-21,8440
2618,長榮航,6104,2022,4082,摩根大通,2024-02-21,8440
1514,亞力,2207,687,1520,摩根大通,2024-02-21,8440
2603,長榮,1455,164,1291,摩根大通,2024-02-21,8440
1513,中興電,1252,54,1198,摩根大通,2024-02-21,8440
2409,友達,2181,1016,1165,摩根大通,2024-02-21,8440
2605,新興,1910,923,987,摩根大通,2024-02-21,8440
2382,廣達,1644,674,970,摩根大通,2024-02-21,8440
2371,大同,1065,225,840,摩根大通,2024-02-21,8440
3005,神基,1092,279,813,摩根大通,2024-02-21,8440
2368,金像電,891,101,790,摩根大通,2024-02-21,8440
1455,集盛,830,56,774,摩根大通,2024-02-21,8440
1101,台泥,1108,334,774,摩根大通,2024-02-21,8440
2303,聯電,2164,1405,759,摩根大通,2024-02-21,8440
2408,南亞科,1049,324,725,摩根大通,2024-02-21,8440
4979,華星光,923,218,705,摩根大通,2024-02-21,8440
1605,華新,993,310,683,摩根大通,2024-02-21,8440
5381,合正,1286,652,634,摩根大通,2024-02-21,8440
2812,台中銀,528,0,528,摩根大通,2024-02-21,8440
3234,光環,559,108,451,摩根大通,2024-02-21,8440
6139,亞翔,468,19,449,摩根大通,2024-02-21,8440
2347,聯強,467,57,410,摩根大通,2024-02-21,8440
2637,慧洋-KY,569,200,369,摩根大通,2024-02-21,8440
6451,訊芯-KY,496,143,353,摩根大通,2024-02-21,8440
2504,國產,381,31,350,摩根大通,2024-02-21,8440
6274,台燿,587,251,336,摩根大通,2024-02-21,8440
1519,華城,584,249,335,摩根大通,2024-02-21,8440
2606,裕民,561,254,307,摩根大通,2024-02-21,8440
3045,台灣大,1119,824,295,摩根大通,2024-02-21,8440
1609,大亞,494,202,292,摩根大通,2024-02-21,8440
6147,頎邦,317,48,269,摩根大通,2024-02-21,8440
2539,櫻花建,300,35,265,摩根大通,2024-02-21,8440
3312,弘憶股,469,212,257,摩根大通,2024-02-21,8440
3217,優群,256,16,240,摩根大通,2024-02-21,8440
2363,矽統,280,42,238,摩根大通,2024-02-21,8440
3081,聯亞,333,102,231,摩根大通,2024-02-21,8440
5483,中美晶,253,30,223,摩根大通,2024-02-21,8440
2362,藍天,247,27,220,摩根大通,2024-02-21,8440
2376,技嘉,704,496,208,摩根大通,2024-02-21,8440
1618,合機,244,39,205,摩根大通,2024-02-21,8440
1809,中釉,324,120,204,摩根大通,2024-02-21,8440
3362,先進光,384,184,200,摩根大通,2024-02-21,8440
6168,宏齊,201,9,192,摩根大通,2024-02-21,8440
2484,希華,220,28,192,摩根大通,2024-02-21,8440
6164,華興,362,171,191,摩根大通,2024-02-21,8440
2105,正新,272,88,184,摩根大通,2024-02-21,8440
8086,宏捷科,385,205,180,摩根大通,2024-02-21,8440
3078,僑威,184,7,177,摩根大通,2024-02-21,8440
3036,文曄,440,265,175,摩根大通,2024-02-21,8440
2365,昆盈,175,3,172,摩根大通,2024-02-21,8440
2609,陽明,8904,1160,7744,摩根大通,2024-02-22,8440
2324,仁寶,4712,510,4202,摩根大通,2024-02-22,8440
2330,台積電,5613,2003,3610,摩根大通,2024-02-22,8440
2603,長榮,2908,330,2578,摩根大通,2024-02-22,8440
2891,中信金,3708,1483,2225,摩根大通,2024-02-22,8440
2329,華泰,2130,693,1437,摩根大通,2024-02-22,8440
2382,廣達,2231,824,1407,摩根大通,2024-02-22,8440
2303,聯電,2387,1125,1262,摩根大通,2024-02-22,8440
2454,聯發科,1469,216,1253,摩根大通,2024-02-22,8440
2812,台中銀,1370,121,1249,摩根大通,2024-02-22,8440
1503,士電,2146,1024,1122,摩根大通,2024-02-22,8440
2543,皇昌,1533,412,1121,摩根大通,2024-02-22,8440
2881,富邦金,940,43,897,摩根大通,2024-02-22,8440
2313,華通,1931,1079,852,摩根大通,2024-02-22,8440
2301,光寶科,972,125,847,摩根大通,2024-02-22,8440
6168,宏齊,897,156,741,摩根大通,2024-02-22,8440
1316,上曜,714,1,713,摩根大通,2024-02-22,8440
1605,華新,697,52,645,摩根大通,2024-02-22,8440
3025,星通,757,145,612,摩根大通,2024-02-22,8440
3017,奇鋐,640,62,578,摩根大通,2024-02-22,8440
6239,力成,607,57,550,摩根大通,2024-02-22,8440
2605,新興,1067,519,548,摩根大通,2024-02-22,8440
2385,群光,920,387,533,摩根大通,2024-02-22,8440
3037,欣興,753,224,529,摩根大通,2024-02-22,8440
3036,文曄,718,206,512,摩根大通,2024-02-22,8440
4938,和碩,740,293,447,摩根大通,2024-02-22,8440
3034,聯詠,620,215,405,摩根大通,2024-02-22,8440
3264,欣銓,394,18,376,摩根大通,2024-02-22,8440
4915,致伸,397,35,362,摩根大通,2024-02-22,8440
2362,藍天,383,47,336,摩根大通,2024-02-22,8440
2615,萬海,723,400,323,摩根大通,2024-02-22,8440
2352,佳世達,324,7,317,摩根大通,2024-02-22,8440
6189,豐藝,458,150,308,摩根大通,2024-02-22,8440
2606,裕民,344,42,302,摩根大通,2024-02-22,8440
2059,川湖,354,55,299,摩根大通,2024-02-22,8440
1216,統一,335,40,295,摩根大通,2024-02-22,8440
6257,矽格,326,40,286,摩根大通,2024-02-22,8440
6789,采鈺,436,155,281,摩根大通,2024-02-22,8440
3711,日月光投控,515,240,275,摩根大通,2024-02-22,8440
2206,三陽工業,322,49,273,摩根大通,2024-02-22,8440
2539,櫻花建,290,19,271,摩根大通,2024-02-22,8440
8069,元太,340,69,271,摩根大通,2024-02-22,8440
2347,聯強,390,133,257,摩根大通,2024-02-22,8440
1522,堤維西,341,84,257,摩根大通,2024-02-22,8440
3588,通嘉,372,117,255,摩根大通,2024-02-22,8440
6120,達運,358,106,252,摩根大通,2024-02-22,8440
5608,四維航,346,97,249,摩根大通,2024-02-22,8440
2617,台航,299,52,247,摩根大通,2024-02-22,8440
1101,台泥,597,357,240,摩根大通,2024-02-22,8440
2641,正德,276,56,220,摩根大通,2024-02-22,8440
2344,華邦電,5787,700,5087,摩根大通,2024-02-23,8440
1316,上曜,2628,112,2516,摩根大通,2024-02-23,8440
3481,群創,3431,947,2484,摩根大通,2024-02-23,8440
2330,台積電,6122,3685,2437,摩根大通,2024-02-23,8440
2308,台達電,2286,243,2043,摩根大通,2024-02-23,8440
9105,泰金寶-DR,2080,136,1944,摩根大通,2024-02-23,8440
3711,日月光投控,2271,664,1607,摩根大通,2024-02-23,8440
1503,士電,2518,964,1554,摩根大通,2024-02-23,8440
3037,欣興,2236,727,1509,摩根大通,2024-02-23,8440
2303,聯電,2158,686,1472,摩根大通,2024-02-23,8440
2313,華通,2225,1025,1200,摩根大通,2024-02-23,8440
2885,元大金,1250,195,1055,摩根大通,2024-02-23,8440
2421,建準,1196,202,994,摩根大通,2024-02-23,8440
2371,大同,1560,572,988,摩根大通,2024-02-23,8440
2890,永豐金,1196,262,934,摩根大通,2024-02-23,8440
2383,台光電,1156,248,908,摩根大通,2024-02-23,8440
1513,中興電,2141,1254,887,摩根大通,2024-02-23,8440
3033,威健,897,38,859,摩根大通,2024-02-23,8440
3450,聯鈞,1004,172,832,摩根大通,2024-02-23,8440
2458,義隆,980,198,782,摩根大通,2024-02-23,8440
1524,耿鼎,766,26,740,摩根大通,2024-02-23,8440
2317,鴻海,1109,384,725,摩根大通,2024-02-23,8440
2603,長榮,1815,1110,705,摩根大通,2024-02-23,8440
3036,文曄,854,173,681,摩根大通,2024-02-23,8440
6789,采鈺,680,62,618,摩根大通,2024-02-23,8440
3025,星通,888,293,595,摩根大通,2024-02-23,8440
6167,久正,730,136,594,摩根大通,2024-02-23,8440
6442,光聖,707,124,583,摩根大通,2024-02-23,8440
2395,研華,622,42,580,摩根大通,2024-02-23,8440
2891,中信金,1560,996,564,摩根大通,2024-02-23,8440
2356,英業達,1425,863,562,摩根大通,2024-02-23,8440
3479,安勤,694,180,514,摩根大通,2024-02-23,8440
2345,智邦,687,176,511,摩根大通,2024-02-23,8440
2385,群光,646,158,488,摩根大通,2024-02-23,8440
8027,鈦昇,794,310,484,摩根大通,2024-02-23,8440
2312,金寶,522,46,476,摩根大通,2024-02-23,8440
3047,訊舟,788,319,469,摩根大通,2024-02-23,8440
3576,聯合再生,527,111,416,摩根大通,2024-02-23,8440
2449,京元電子,1460,1045,415,摩根大通,2024-02-23,8440
3221,台嘉碩,461,47,414,摩根大通,2024-02-23,8440
3035,智原,484,84,400,摩根大通,2024-02-23,8440
6288,聯嘉,446,72,374,摩根大通,2024-02-23,8440
2368,金像電,647,304,343,摩根大通,2024-02-23,8440
2405,輔信,714,374,340,摩根大通,2024-02-23,8440
3034,聯詠,435,97,338,摩根大通,2024-02-23,8440
1785,光洋科,371,34,337,摩根大通,2024-02-23,8440
8110,華東,408,90,318,摩根大通,2024-02-23,8440
2633,台灣高鐵,373,70,303,摩根大通,2024-02-23,8440
2881,富邦金,448,147,301,摩根大通,2024-02-23,8440
4968,立積,388,97,291,摩根大通,2024-02-23,8440
3481,群創,5320,471,4849,摩根大通,2024-02-26,8440
2317,鴻海,2833,677,2156,摩根大通,2024-02-26,8440
2345,智邦,1841,105,1736,摩根大通,2024-02-26,8440
2812,台中銀,1709,299,1410,摩根大通,2024-02-26,8440
1795,美時,1182,24,1158,摩根大通,2024-02-26,8440
2367,燿華,1085,143,942,摩根大通,2024-02-26,8440
2313,華通,1289,418,871,摩根大通,2024-02-26,8440
3312,弘憶股,950,119,831,摩根大通,2024-02-26,8440
2891,中信金,1700,879,821,摩根大通,2024-02-26,8440
1605,華新,934,158,776,摩根大通,2024-02-26,8440
2455,全新,778,190,588,摩根大通,2024-02-26,8440
3005,神基,989,450,539,摩根大通,2024-02-26,8440
3406,玉晶光,479,12,467,摩根大通,2024-02-26,8440
1503,士電,1948,1504,444,摩根大通,2024-02-26,8440
2323,中環,554,123,431,摩根大通,2024-02-26,8440
1528,恩德,485,62,423,摩根大通,2024-02-26,8440
2324,仁寶,1329,925,404,摩根大通,2024-02-26,8440
1522,堤維西,737,337,400,摩根大通,2024-02-26,8440
2363,矽統,1358,964,394,摩根大通,2024-02-26,8440
8936,國統,597,210,387,摩根大通,2024-02-26,8440
3707,漢磊,457,75,382,摩根大通,2024-02-26,8440
2881,富邦金,714,336,378,摩根大通,2024-02-26,8440
1524,耿鼎,408,33,375,摩根大通,2024-02-26,8440
2637,慧洋-KY,423,50,373,摩根大通,2024-02-26,8440
9921,巨大,383,16,367,摩根大通,2024-02-26,8440
1712,興農,402,63,339,摩根大通,2024-02-26,8440
2634,漢翔,369,42,327,摩根大通,2024-02-26,8440
5452,佶優,406,81,325,摩根大通,2024-02-26,8440
6712,長聖,318,12,306,摩根大通,2024-02-26,8440
2641,正德,327,24,303,摩根大通,2024-02-26,8440
4763,材料-KY,498,210,288,摩根大通,2024-02-26,8440
5347,世界,318,38,280,摩根大通,2024-02-26,8440
2834,臺企銀,491,219,272,摩根大通,2024-02-26,8440
2486,一詮,326,62,264,摩根大通,2024-02-26,8440
2406,國碩,291,30,261,摩根大通,2024-02-26,8440
3163,波若威,471,211,260,摩根大通,2024-02-26,8440
6179,亞通,265,5,260,摩根大通,2024-02-26,8440
2467,志聖,324,71,253,摩根大通,2024-02-26,8440
3036,文曄,596,344,252,摩根大通,2024-02-26,8440
4770,上品,334,82,252,摩根大通,2024-02-26,8440
2395,研華,298,51,247,摩根大通,2024-02-26,8440
4157,太景*-KY,248,3,245,摩根大通,2024-02-26,8440
4958,臻鼎-KY,340,104,236,摩根大通,2024-02-26,8440
2355,敬鵬,247,20,227,摩根大通,2024-02-26,8440
2206,三陽工業,251,25,226,摩根大通,2024-02-26,8440
3714,富采,274,52,222,摩根大通,2024-02-26,8440
5512,力麒,216,5,211,摩根大通,2024-02-26,8440
3680,家登,298,90,208,摩根大通,2024-02-26,8440
8027,鈦昇,725,518,207,摩根大通,2024-02-26,8440
2610,華航,247,41,206,摩根大通,2024-02-26,8440
2330,台積電,10365,2122,8243,摩根大通,2024-02-27,8440
2353,宏��,4357,440,3917,摩根大通,2024-02-27,8440
2891,中信金,5397,2615,2782,摩根大通,2024-02-27,8440
2609,陽明,3827,1134,2693,摩根大通,2024-02-27,8440
2317,鴻海,4260,2768,1492,摩根大通,2024-02-27,8440
2313,華通,1748,321,1427,摩根大通,2024-02-27,8440
1503,士電,1701,287,1414,摩根大通,2024-02-27,8440
2884,玉山金,3122,1893,1229,摩根大通,2024-02-27,8440
8299,群聯,1013,138,875,摩根大通,2024-02-27,8440
2605,新興,1043,195,848,摩根大通,2024-02-27,8440
1101,台泥,1579,779,800,摩根大通,2024-02-27,8440
2888,新光金,1728,952,776,摩根大通,2024-02-27,8440
4770,上品,624,107,517,摩根大通,2024-02-27,8440
2897,王道銀行,569,56,513,摩根大通,2024-02-27,8440
1608,華榮,582,89,493,摩根大通,2024-02-27,8440
3363,上詮,1134,671,463,摩根大通,2024-02-27,8440
3576,聯合再生,608,152,456,摩根大通,2024-02-27,8440
1795,美時,653,207,446,摩根大通,2024-02-27,8440
3036,文曄,728,325,403,摩根大通,2024-02-27,8440
2880,華南金,1831,1441,390,摩根大通,2024-02-27,8440
3715,定穎投控,515,127,388,摩根大通,2024-02-27,8440
5225,東科-KY,413,41,372,摩根大通,2024-02-27,8440
5512,力麒,357,5,352,摩根大通,2024-02-27,8440
5521,工信,438,107,331,摩根大通,2024-02-27,8440
5347,世界,544,216,328,摩根大通,2024-02-27,8440
2489,瑞軒,394,68,326,摩根大通,2024-02-27,8440
5340,建榮,345,21,324,摩根大通,2024-02-27,8440
4303,信立,518,195,323,摩根大通,2024-02-27,8440
6139,亞翔,1362,1063,299,摩根大通,2024-02-27,8440
2881,富邦金,1090,812,278,摩根大通,2024-02-27,8440
2809,京城銀,390,120,270,摩根大通,2024-02-27,8440
2882,國泰金,1150,880,270,摩根大通,2024-02-27,8440
8070,長華*,298,35,263,摩根大通,2024-02-27,8440
2409,友達,906,656,250,摩根大通,2024-02-27,8440
2867,三商壽,332,91,241,摩根大通,2024-02-27,8440
6274,台燿,284,58,226,摩根大通,2024-02-27,8440
2376,技嘉,943,725,218,摩根大通,2024-02-27,8440
2892,第一金,1848,1634,214,摩根大通,2024-02-27,8440
2886,兆豐金,1149,938,211,摩根大通,2024-02-27,8440
2641,正德,227,24,203,摩根大通,2024-02-27,8440
3047,訊舟,356,174,182,摩根大通,2024-02-27,8440
4543,萬在,210,28,182,摩根大通,2024-02-27,8440
6245,立端,282,101,181,摩根大通,2024-02-27,8440
3588,通嘉,445,264,181,摩根大通,2024-02-27,8440
6138,茂達,192,15,177,摩根大通,2024-02-27,8440
8096,擎亞,1344,1171,173,摩根大通,2024-02-27,8440
2515,中工,287,114,173,摩根大通,2024-02-27,8440
3522,御嵿,179,13,166,摩根大通,2024-02-27,8440
4532,瑞智,167,3,164,摩根大通,2024-02-27,8440
5511,德昌,167,5,162,摩根大通,2024-02-27,8440
2834,臺企銀,14649,843,13806,摩根大通,2024-02-29,8440
2610,華航,7959,273,7686,摩根大通,2024-02-29,8440
3481,群創,9642,2290,7352,摩根大通,2024-02-29,8440
2609,陽明,7364,566,6798,摩根大通,2024-02-29,8440
2303,聯電,8603,2909,5694,摩根大通,2024-02-29,8440
2618,長榮航,5479,961,4518,摩根大通,2024-02-29,8440
2615,萬海,3981,132,3849,摩根大通,2024-02-29,8440
2408,南亞科,3893,249,3644,摩根大通,2024-02-29,8440
2603,長榮,4705,1209,3496,摩根大通,2024-02-29,8440
2812,台中銀,3094,545,2549,摩根大通,2024-02-29,8440
3036,文曄,2836,445,2391,摩根大通,2024-02-29,8440
1605,華新,3735,1411,2324,摩根大通,2024-02-29,8440
2890,永豐金,3611,1403,2208,摩根大通,2024-02-29,8440
3702,大聯大,3252,1056,2196,摩根大通,2024-02-29,8440
1609,大亞,1775,117,1658,摩根大通,2024-02-29,8440
9904,寶成,1995,369,1626,摩根大通,2024-02-29,8440
2884,玉山金,7413,5919,1494,摩根大通,2024-02-29,8440
8069,元太,1892,566,1326,摩根大通,2024-02-29,8440
2897,王道銀行,1293,56,1237,摩根大通,2024-02-29,8440
5871,中租-KY,1341,191,1150,摩根大通,2024-02-29,8440
2883,凱基金,2646,1500,1146,摩根大通,2024-02-29,8440
6239,力成,1481,364,1117,摩根大通,2024-02-29,8440
2888,新光金,2208,1150,1058,摩根大通,2024-02-29,8440
2801,彰銀,1984,933,1051,摩根大通,2024-02-29,8440
3231,緯創,3760,2829,931,摩根大通,2024-02-29,8440
1326,台化,1183,258,925,摩根大通,2024-02-29,8440
9945,潤泰新,1212,305,907,摩根大通,2024-02-29,8440
6282,康舒,1251,375,876,摩根大通,2024-02-29,8440
8150,南茂,944,72,872,摩根大通,2024-02-29,8440
3260,威剛,904,93,811,摩根大通,2024-02-29,8440
2211,長榮鋼,865,56,809,摩根大通,2024-02-29,8440
2412,中華電,2009,1265,744,摩根大通,2024-02-29,8440
2881,富邦金,2494,1820,674,摩根大通,2024-02-29,8440
1522,堤維西,2067,1401,666,摩根大通,2024-02-29,8440
2337,旺宏,1270,618,652,摩根大通,2024-02-29,8440
2383,台光電,880,236,644,摩根大通,2024-02-29,8440
6026,福邦證,636,0,636,摩根大通,2024-02-29,8440
2105,正新,778,170,608,摩根大通,2024-02-29,8440
3045,台灣大,3144,2546,598,摩根大通,2024-02-29,8440
3017,奇鋐,822,238,584,摩根大通,2024-02-29,8440
1514,亞力,1658,1090,568,摩根大通,2024-02-29,8440
3515,華擎,576,31,545,摩根大通,2024-02-29,8440
2457,飛宏,647,113,534,摩根大通,2024-02-29,8440
2637,慧洋-KY,603,107,496,摩根大通,2024-02-29,8440
2324,仁寶,3218,2726,492,摩根大通,2024-02-29,8440
2204,中華,642,161,481,摩根大通,2024-02-29,8440
3081,聯亞,492,36,456,摩根大通,2024-02-29,8440
2504,國產,695,240,455,摩根大通,2024-02-29,8440
6505,台塑化,647,196,451,摩根大通,2024-02-29,8440
3596,智易,522,77,445,摩根大通,2024-02-29,8440
8069,元太,3221,351,2870,摩根大通,2024-03-01,8440
2317,鴻海,2695,795,1900,摩根大通,2024-03-01,8440
2382,廣達,1300,394,906,摩根大通,2024-03-01,8440
3231,緯創,1167,470,697,摩根大通,2024-03-01,8440
2371,大同,1553,858,695,摩根大通,2024-03-01,8440
2301,光寶科,1089,409,680,摩根大通,2024-03-01,8440
2206,三陽工業,722,142,580,摩根大通,2024-03-01,8440
1514,亞力,1267,691,576,摩根大通,2024-03-01,8440
3035,智原,610,59,551,摩根大通,2024-03-01,8440
1503,士電,662,137,525,摩根大通,2024-03-01,8440
6290,良維,545,50,495,摩根大通,2024-03-01,8440
2352,佳世達,508,47,461,摩根大通,2024-03-01,8440
2812,台中銀,554,94,460,摩根大通,2024-03-01,8440
4909,新復興,853,408,445,摩根大通,2024-03-01,8440
2486,一詮,476,71,405,摩根大通,2024-03-01,8440
2356,英業達,697,313,384,摩根大通,2024-03-01,8440
3702,大聯大,585,243,342,摩根大通,2024-03-01,8440
3006,晶豪科,416,115,301,摩根大通,2024-03-01,8440
6026,福邦證,317,19,298,摩根大通,2024-03-01,8440
3260,威剛,321,25,296,摩根大通,2024-03-01,8440
8086,宏捷科,412,130,282,摩根大通,2024-03-01,8440
6806,森崴能源,579,305,274,摩根大通,2024-03-01,8440
6139,亞翔,265,9,256,摩根大通,2024-03-01,8440
3376,新日興,410,159,251,摩根大通,2024-03-01,8440
2454,聯發科,444,194,250,摩根大通,2024-03-01,8440
3289,宜特,258,15,243,摩根大通,2024-03-01,8440
3189,景碩,314,72,242,摩根大通,2024-03-01,8440
8070,長華*,242,7,235,摩根大通,2024-03-01,8440
5009,榮剛,343,116,227,摩根大通,2024-03-01,8440
4908,前鼎,290,67,223,摩根大通,2024-03-01,8440
2383,台光電,382,164,218,摩根大通,2024-03-01,8440
6282,康舒,352,137,215,摩根大通,2024-03-01,8440
9933,中鼎,266,63,203,摩根大通,2024-03-01,8440
3576,聯合再生,352,170,182,摩根大通,2024-03-01,8440
5864,致和證,180,0,180,摩根大通,2024-03-01,8440
1513,中興電,483,303,180,摩根大通,2024-03-01,8440
5871,中租-KY,354,176,178,摩根大通,2024-03-01,8440
6271,同欣電,216,42,174,摩根大通,2024-03-01,8440
3390,旭軟,344,174,170,摩根大通,2024-03-01,8440
5351,鈺創,196,27,169,摩根大通,2024-03-01,8440
1618,合機,672,516,156,摩根大通,2024-03-01,8440
3013,晟銘電,276,125,151,摩根大通,2024-03-01,8440
1905,華紙,216,70,146,摩根大通,2024-03-01,8440
3047,訊舟,158,15,143,摩根大通,2024-03-01,8440
3078,僑威,193,51,142,摩根大通,2024-03-01,8440
2308,台達電,282,142,140,摩根大通,2024-03-01,8440
8011,台通,186,55,131,摩根大通,2024-03-01,8440
4915,致伸,233,106,127,摩根大通,2024-03-01,8440
6016,康和證,122,0,122,摩根大通,2024-03-01,8440
8059,凱碩,144,24,120,摩根大通,2024-03-01,8440
2330,台積電,17558,1829,15729,摩根大通,2024-03-04,8440
2317,鴻海,7249,2435,4814,摩根大通,2024-03-04,8440
2367,燿華,3964,225,3739,摩根大通,2024-03-04,8440
2353,宏��,5572,2403,3169,摩根大通,2024-03-04,8440
2454,聯發科,2675,557,2118,摩根大通,2024-03-04,8440
1303,南亞,1796,350,1446,摩根大通,2024-03-04,8440
9904,寶成,1823,480,1343,摩根大通,2024-03-04,8440
2603,長榮,1829,493,1336,摩根大通,2024-03-04,8440
2371,大同,2204,870,1334,摩根大通,2024-03-04,8440
3036,文曄,1584,268,1316,摩根大通,2024-03-04,8440
2890,永豐金,3213,1963,1250,摩根大通,2024-03-04,8440
3042,晶技,1045,9,1036,摩根大通,2024-03-04,8440
4906,正文,1298,281,1017,摩根大通,2024-03-04,8440
2408,南亞科,1045,207,838,摩根大通,2024-03-04,8440
2337,旺宏,961,138,823,摩根大通,2024-03-04,8440
5876,上海商銀,1332,570,762,摩根大通,2024-03-04,8440
1605,華新,918,232,686,摩根大通,2024-03-04,8440
2316,楠梓電,731,51,680,摩根大通,2024-03-04,8440
2885,元大金,1155,510,645,摩根大通,2024-03-04,8440
3450,聯鈞,689,58,631,摩根大通,2024-03-04,8440
3653,健策,627,40,587,摩根大通,2024-03-04,8440
3576,聯合再生,678,125,553,摩根大通,2024-03-04,8440
2352,佳世達,588,45,543,摩根大通,2024-03-04,8440
2455,全新,787,250,537,摩根大通,2024-03-04,8440
1905,華紙,899,393,506,摩根大通,2024-03-04,8440
2888,新光金,2809,2319,490,摩根大通,2024-03-04,8440
6806,森崴能源,755,275,480,摩根大通,2024-03-04,8440
6290,良維,654,224,430,摩根大通,2024-03-04,8440
3312,弘憶股,469,43,426,摩根大通,2024-03-04,8440
3665,貿聯-KY,753,333,420,摩根大通,2024-03-04,8440
2809,京城銀,392,12,380,摩根大通,2024-03-04,8440
1514,亞力,810,444,366,摩根大通,2024-03-04,8440
5347,世界,571,207,364,摩根大通,2024-03-04,8440
1104,環泥,439,76,363,摩根大通,2024-03-04,8440
2417,圓剛,508,145,363,摩根大通,2024-03-04,8440
3711,日月光投控,1055,695,360,摩根大通,2024-03-04,8440
2882,國泰金,1540,1185,355,摩根大通,2024-03-04,8440
3264,欣銓,367,26,341,摩根大通,2024-03-04,8440
3260,威剛,361,34,327,摩根大通,2024-03-04,8440
6026,福邦證,401,74,327,摩根大通,2024-03-04,8440
2369,菱生,381,60,321,摩根大通,2024-03-04,8440
8150,南茂,380,69,311,摩根大通,2024-03-04,8440
7402,邑錡,298,0,298,摩根大通,2024-03-04,8440
3044,健鼎,377,87,290,摩根大通,2024-03-04,8440
1409,新纖,607,319,288,摩根大通,2024-03-04,8440
3376,新日興,492,206,286,摩根大通,2024-03-04,8440
2449,京元電子,632,347,285,摩根大通,2024-03-04,8440
2314,台揚,301,16,285,摩根大通,2024-03-04,8440
6237,驊訊,329,56,273,摩根大通,2024-03-04,8440
4979,華星光,334,62,272,摩根大通,2024-03-04,8440
2367,燿華,6284,2017,4267,摩根大通,2024-03-05,8440
3231,緯創,4596,378,4218,摩根大通,2024-03-05,8440
2330,台積電,6021,2719,3302,摩根大通,2024-03-05,8440
2897,王道銀行,1949,21,1928,摩根大通,2024-03-05,8440
9904,寶成,2049,127,1922,摩根大通,2024-03-05,8440
2890,永豐金,3800,1926,1874,摩根大通,2024-03-05,8440
2356,英業達,1883,359,1524,摩根大通,2024-03-05,8440
2324,仁寶,2797,1340,1457,摩根大通,2024-03-05,8440
1514,亞力,1700,500,1200,摩根大通,2024-03-05,8440
2412,中華電,1225,34,1191,摩根大通,2024-03-05,8440
2317,鴻海,4333,3159,1174,摩根大通,2024-03-05,8440
3013,晟銘電,2194,1074,1120,摩根大通,2024-03-05,8440
3376,新日興,1589,499,1090,摩根大通,2024-03-05,8440
2884,玉山金,818,76,742,摩根大通,2024-03-05,8440
3711,日月光投控,1422,697,725,摩根大通,2024-03-05,8440
1503,士電,1294,588,706,摩根大通,2024-03-05,8440
8011,台通,756,114,642,摩根大通,2024-03-05,8440
8150,南茂,613,15,598,摩根大通,2024-03-05,8440
2891,中信金,1905,1316,589,摩根大通,2024-03-05,8440
2352,佳世達,588,19,569,摩根大通,2024-03-05,8440
1303,南亞,671,106,565,摩根大通,2024-03-05,8440
2903,遠百,596,42,554,摩根大通,2024-03-05,8440
8086,宏捷科,1114,565,549,摩根大通,2024-03-05,8440
6695,芯鼎,576,35,541,摩根大通,2024-03-05,8440
6005,群益證,515,10,505,摩根大通,2024-03-05,8440
2344,華邦電,669,164,505,摩根大通,2024-03-05,8440
2881,富邦金,1043,544,499,摩根大通,2024-03-05,8440
6188,廣明,517,35,482,摩根大通,2024-03-05,8440
6120,達運,1032,568,464,摩根大通,2024-03-05,8440
2006,東和鋼鐵,553,98,455,摩根大通,2024-03-05,8440
2886,兆豐金,1500,1072,428,摩根大通,2024-03-05,8440
2421,建準,733,341,392,摩根大通,2024-03-05,8440
4402,郡都開發,410,22,388,摩根大通,2024-03-05,8440
8210,勤誠,686,319,367,摩根大通,2024-03-05,8440
6125,廣運,534,181,353,摩根大通,2024-03-05,8440
5876,上海商銀,590,239,351,摩根大通,2024-03-05,8440
2376,技嘉,559,245,314,摩根大通,2024-03-05,8440
5483,中美晶,386,73,313,摩根大通,2024-03-05,8440
1618,合機,345,35,310,摩根大通,2024-03-05,8440
3260,威剛,420,112,308,摩根大通,2024-03-05,8440
3596,智易,318,11,307,摩根大通,2024-03-05,8440
1102,亞泥,475,170,305,摩根大通,2024-03-05,8440
3032,偉訓,331,32,299,摩根大通,2024-03-05,8440
6274,台燿,484,188,296,摩根大通,2024-03-05,8440
2368,金像電,352,57,295,摩根大通,2024-03-05,8440
6143,振曜,318,28,290,摩根大通,2024-03-05,8440
6462,神盾,431,151,280,摩根大通,2024-03-05,8440
3078,僑威,285,6,279,摩根大通,2024-03-05,8440
8050,廣積,279,0,279,摩根大通,2024-03-05,8440
5452,佶優,311,56,255,摩根大通,2024-03-05,8440
2883,凱基金,6972,25,6947,摩根大通,2024-03-06,8440
2330,台積電,8461,3437,5024,摩根大通,2024-03-06,8440
2324,仁寶,5964,1325,4639,摩根大通,2024-03-06,8440
2884,玉山金,4196,345,3851,摩根大通,2024-03-06,8440
2891,中信金,4089,686,3403,摩根大通,2024-03-06,8440
2367,燿華,5331,2527,2804,摩根大通,2024-03-06,8440
2886,兆豐金,2805,57,2748,摩根大通,2024-03-06,8440
2812,台中銀,2344,80,2264,摩根大通,2024-03-06,8440
1101,台泥,2396,276,2120,摩根大通,2024-03-06,8440
2313,華通,1937,114,1823,摩根大通,2024-03-06,8440
3481,群創,2049,534,1515,摩根大通,2024-03-06,8440
2356,英業達,1818,337,1481,摩根大通,2024-03-06,8440
2316,楠梓電,1664,355,1309,摩根大通,2024-03-06,8440
2897,王道銀行,1150,0,1150,摩根大通,2024-03-06,8440
2880,華南金,945,85,860,摩根大通,2024-03-06,8440
1609,大亞,1435,592,843,摩根大通,2024-03-06,8440
3372,典範,840,17,823,摩根大通,2024-03-06,8440
5880,合庫金,844,29,815,摩根大通,2024-03-06,8440
2417,圓剛,1055,265,790,摩根大通,2024-03-06,8440
2888,新光金,1039,305,734,摩根大通,2024-03-06,8440
6117,迎廣,1709,996,713,摩根大通,2024-03-06,8440
2347,聯強,756,49,707,摩根大通,2024-03-06,8440
4968,立積,707,41,666,摩根大通,2024-03-06,8440
4904,遠傳,888,240,648,摩根大通,2024-03-06,8440
2834,臺企銀,716,73,643,摩根大通,2024-03-06,8440
1717,長興,636,0,636,摩根大通,2024-03-06,8440
3325,旭品,2119,1484,635,摩根大通,2024-03-06,8440
6806,森崴能源,670,68,602,摩根大通,2024-03-06,8440
2881,富邦金,869,272,597,摩根大通,2024-03-06,8440
2495,普安,573,4,569,摩根大通,2024-03-06,8440
2303,聯電,825,266,559,摩根大通,2024-03-06,8440
2408,南亞科,548,33,515,摩根大通,2024-03-06,8440
6197,佳必琪,710,204,506,摩根大通,2024-03-06,8440
3005,神基,1046,547,499,摩根大通,2024-03-06,8440
6139,亞翔,545,52,493,摩根大通,2024-03-06,8440
2903,遠百,592,117,475,摩根大通,2024-03-06,8440
2809,京城銀,487,15,472,摩根大通,2024-03-06,8440
2801,彰銀,464,11,453,摩根大通,2024-03-06,8440
3051,力特,443,28,415,摩根大通,2024-03-06,8440
6016,康和證,412,0,412,摩根大通,2024-03-06,8440
2449,京元電子,753,395,358,摩根大通,2024-03-06,8440
6177,達麗,356,0,356,摩根大通,2024-03-06,8440
6179,亞通,421,66,355,摩根大通,2024-03-06,8440
3036,文曄,497,143,354,摩根大通,2024-03-06,8440
9914,美利達,424,74,350,摩根大通,2024-03-06,8440
1104,環泥,356,7,349,摩根大通,2024-03-06,8440
6188,廣明,425,82,343,摩根大通,2024-03-06,8440
6257,矽格,366,27,339,摩根大通,2024-03-06,8440
2606,裕民,453,117,336,摩根大通,2024-03-06,8440
2360,致茂,681,351,330,摩根大通,2024-03-06,8440
2303,聯電,11647,1737,9910,摩根大通,2024-03-07,8440
2883,凱基金,10472,1400,9072,摩根大通,2024-03-07,8440
2885,元大金,4848,1313,3535,摩根大通,2024-03-07,8440
2330,台積電,8137,4733,3404,摩根大通,2024-03-07,8440
2891,中信金,3562,679,2883,摩根大通,2024-03-07,8440
2353,宏��,3435,804,2631,摩根大通,2024-03-07,8440
1815,富喬,3500,1014,2486,摩根大通,2024-03-07,8440
2845,遠東銀,2112,347,1765,摩根大通,2024-03-07,8440
2886,兆豐金,1806,299,1507,摩根大通,2024-03-07,8440
2834,臺企銀,1801,312,1489,摩根大通,2024-03-07,8440
2880,華南金,1738,299,1439,摩根大通,2024-03-07,8440
6005,群益證,1765,458,1307,摩根大通,2024-03-07,8440
2344,華邦電,1951,772,1179,摩根大通,2024-03-07,8440
2884,玉山金,1998,899,1099,摩根大通,2024-03-07,8440
2881,富邦金,1624,690,934,摩根大通,2024-03-07,8440
2897,王道銀行,956,63,893,摩根大通,2024-03-07,8440
4938,和碩,924,131,793,摩根大通,2024-03-07,8440
3702,大聯大,1203,418,785,摩根大通,2024-03-07,8440
2890,永豐金,1735,959,776,摩根大通,2024-03-07,8440
9914,美利達,865,96,769,摩根大通,2024-03-07,8440
2354,鴻準,800,58,742,摩根大通,2024-03-07,8440
6257,矽格,811,108,703,摩根大通,2024-03-07,8440
4958,臻鼎-KY,842,149,693,摩根大通,2024-03-07,8440
9933,中鼎,765,105,660,摩根大通,2024-03-07,8440
5388,中磊,719,71,648,摩根大通,2024-03-07,8440
2360,致茂,773,146,627,摩根大通,2024-03-07,8440
2882,國泰金,1368,748,620,摩根大通,2024-03-07,8440
6695,芯鼎,634,30,604,摩根大通,2024-03-07,8440
2455,全新,643,68,575,摩根大通,2024-03-07,8440
3711,日月光投控,4387,3855,532,摩根大通,2024-03-07,8440
1101,台泥,797,271,526,摩根大通,2024-03-07,8440
3481,群創,1056,539,517,摩根大通,2024-03-07,8440
2542,興富發,565,64,501,摩根大通,2024-03-07,8440
2889,國票金,650,156,494,摩根大通,2024-03-07,8440
1303,南亞,974,482,492,摩根大通,2024-03-07,8440
6176,瑞儀,757,311,446,摩根大通,2024-03-07,8440
5880,合庫金,816,389,427,摩根大通,2024-03-07,8440
2417,圓剛,492,80,412,摩根大通,2024-03-07,8440
8110,華東,496,96,400,摩根大通,2024-03-07,8440
2603,長榮,1029,633,396,摩根大通,2024-03-07,8440
6147,頎邦,424,28,396,摩根大通,2024-03-07,8440
3231,緯創,1167,773,394,摩根大通,2024-03-07,8440
6163,華電網,763,382,381,摩根大通,2024-03-07,8440
2851,中再保,393,23,370,摩根大通,2024-03-07,8440
3338,泰碩,924,556,368,摩根大通,2024-03-07,8440
6239,力成,549,193,356,摩根大通,2024-03-07,8440
2476,鉅祥,348,7,341,摩根大通,2024-03-07,8440
6290,良維,359,36,323,摩根大通,2024-03-07,8440
3017,奇鋐,1028,713,315,摩根大通,2024-03-07,8440
6016,康和證,344,37,307,摩根大通,2024-03-07,8440
2303,聯電,16570,4173,12397,摩根大通,2024-03-08,8440
2886,兆豐金,6087,1495,4592,摩根大通,2024-03-08,8440
2834,臺企銀,5373,962,4411,摩根大通,2024-03-08,8440
2330,台積電,8372,4936,3436,摩根大通,2024-03-08,8440
2891,中信金,5914,2495,3419,摩根大通,2024-03-08,8440
2887,台新金,4769,1667,3102,摩根大通,2024-03-08,8440
2880,華南金,3834,953,2881,摩根大通,2024-03-08,8440
2890,永豐金,3433,841,2592,摩根大通,2024-03-08,8440
2882,國泰金,3010,949,2061,摩根大通,2024-03-08,8440
1513,中興電,1724,180,1544,摩根大通,2024-03-08,8440
1402,遠東新,1763,227,1536,摩根大通,2024-03-08,8440
2885,元大金,2311,784,1527,摩根大通,2024-03-08,8440
2801,彰銀,1870,457,1413,摩根大通,2024-03-08,8440
5880,合庫金,1900,491,1409,摩根大通,2024-03-08,8440
5876,上海商銀,1510,106,1404,摩根大通,2024-03-08,8440
2308,台達電,1789,459,1330,摩根大通,2024-03-08,8440
5483,中美晶,1509,244,1265,摩根大通,2024-03-08,8440
1316,上曜,1183,109,1074,摩根大通,2024-03-08,8440
1514,亞力,1399,393,1006,摩根大通,2024-03-08,8440
2002,中鋼,1704,717,987,摩根大通,2024-03-08,8440
3576,聯合再生,1118,133,985,摩根大通,2024-03-08,8440
2892,第一金,2638,1729,909,摩根大通,2024-03-08,8440
3711,日月光投控,2474,1589,885,摩根大通,2024-03-08,8440
2449,京元電子,1536,668,868,摩根大通,2024-03-08,8440
2637,慧洋-KY,951,98,853,摩根大通,2024-03-08,8440
6125,廣運,1090,246,844,摩根大通,2024-03-08,8440
5498,凱崴,2196,1357,839,摩根大通,2024-03-08,8440
2455,全新,962,148,814,摩根大通,2024-03-08,8440
9933,中鼎,859,50,809,摩根大通,2024-03-08,8440
8150,南茂,850,51,799,摩根大通,2024-03-08,8440
3037,欣興,943,161,782,摩根大通,2024-03-08,8440
2633,台灣高鐵,955,221,734,摩根大通,2024-03-08,8440
6120,達運,870,152,718,摩根大通,2024-03-08,8440
2881,富邦金,1797,1129,668,摩根大通,2024-03-08,8440
3081,聯亞,687,45,642,摩根大通,2024-03-08,8440
1102,亞泥,1091,455,636,摩根大通,2024-03-08,8440
2379,瑞昱,658,38,620,摩根大通,2024-03-08,8440
9914,美利達,669,70,599,摩根大通,2024-03-08,8440
6190,萬泰科,697,107,590,摩根大通,2024-03-08,8440
2542,興富發,703,118,585,摩根大通,2024-03-08,8440
2421,建準,784,214,570,摩根大通,2024-03-08,8440
2603,長榮,1696,1158,538,摩根大通,2024-03-08,8440
8112,至上,661,144,517,摩根大通,2024-03-08,8440
6274,台燿,739,226,513,摩根大通,2024-03-08,8440
5426,振發,518,13,505,摩根大通,2024-03-08,8440
2356,英業達,907,427,480,摩根大通,2024-03-08,8440
6546,正基,559,95,464,摩根大通,2024-03-08,8440
2618,長榮航,3449,2993,456,摩根大通,2024-03-08,8440
4908,前鼎,526,93,433,摩根大通,2024-03-08,8440
3346,麗清,478,61,417,摩根大通,2024-03-08,8440
2409,友達,7588,592,6996,摩根大通,2024-03-11,8440
2303,聯電,5821,1734,4087,摩根大通,2024-03-11,8440
2317,鴻海,6252,2367,3885,摩根大通,2024-03-11,8440
2883,凱基金,4328,1016,3312,摩根大通,2024-03-11,8440
2313,華通,2508,575,1933,摩根大通,2024-03-11,8440
2330,台積電,5994,4381,1613,摩根大通,2024-03-11,8440
2886,兆豐金,1465,135,1330,摩根大通,2024-03-11,8440
2486,一詮,1173,0,1173,摩根大通,2024-03-11,8440
2449,京元電子,1796,633,1163,摩根大通,2024-03-11,8440
2345,智邦,1371,289,1082,摩根大通,2024-03-11,8440
2903,遠百,1026,28,998,摩根大通,2024-03-11,8440
2884,玉山金,1095,165,930,摩根大通,2024-03-11,8440
6180,橘子,834,45,789,摩根大通,2024-03-11,8440
1303,南亞,868,97,771,摩根大通,2024-03-11,8440
3231,緯創,2290,1552,738,摩根大通,2024-03-11,8440
8112,至上,832,118,714,摩根大通,2024-03-11,8440
1608,華榮,705,1,704,摩根大通,2024-03-11,8440
1301,台塑,687,12,675,摩根大通,2024-03-11,8440
2897,王道銀行,665,0,665,摩根大通,2024-03-11,8440
2881,富邦金,916,260,656,摩根大通,2024-03-11,8440
2359,所羅門,650,25,625,摩根大通,2024-03-11,8440
2395,研華,905,283,622,摩根大通,2024-03-11,8440
3583,辛耘,875,258,617,摩根大通,2024-03-11,8440
1402,遠東新,625,32,593,摩根大通,2024-03-11,8440
2408,南亞科,714,126,588,摩根大通,2024-03-11,8440
2885,元大金,728,186,542,摩根大通,2024-03-11,8440
1605,華新,542,20,522,摩根大通,2024-03-11,8440
2537,聯上發,539,28,511,摩根大通,2024-03-11,8440
2337,旺宏,644,141,503,摩根大通,2024-03-11,8440
6016,康和證,630,129,501,摩根大通,2024-03-11,8440
1326,台化,503,4,499,摩根大通,2024-03-11,8440
6197,佳必琪,659,175,484,摩根大通,2024-03-11,8440
1102,亞泥,639,173,466,摩根大通,2024-03-11,8440
6278,台表科,527,63,464,摩根大通,2024-03-11,8440
2376,技嘉,670,227,443,摩根大通,2024-03-11,8440
3260,威剛,534,92,442,摩根大通,2024-03-11,8440
6026,福邦證,439,0,439,摩根大通,2024-03-11,8440
8027,鈦昇,457,23,434,摩根大通,2024-03-11,8440
2383,台光電,539,108,431,摩根大通,2024-03-11,8440
9945,潤泰新,781,353,428,摩根大通,2024-03-11,8440
3163,波若威,678,289,389,摩根大通,2024-03-11,8440
2882,國泰金,1233,856,377,摩根大通,2024-03-11,8440
3339,泰谷,455,78,377,摩根大通,2024-03-11,8440
6505,台塑化,440,68,372,摩根大通,2024-03-11,8440
2528,皇普,377,7,370,摩根大通,2024-03-11,8440
2609,陽明,931,567,364,摩根大通,2024-03-11,8440
8926,台汽電,426,66,360,摩根大通,2024-03-11,8440
5876,上海商銀,423,65,358,摩根大通,2024-03-11,8440
3037,欣興,403,46,357,摩根大通,2024-03-11,8440
1717,長興,356,0,356,摩根大通,2024-03-11,8440
2618,長榮航,11058,10,11048,摩根大通,2024-03-12,8440
2317,鴻海,15093,6418,8675,摩根大通,2024-03-12,8440
1503,士電,6425,674,5751,摩根大通,2024-03-12,8440
2883,凱基金,7130,1812,5318,摩根大通,2024-03-12,8440
2603,長榮,2656,80,2576,摩根大通,2024-03-12,8440
2881,富邦金,2573,31,2542,摩根大通,2024-03-12,8440
6120,達運,2440,202,2238,摩根大通,2024-03-12,8440
1504,東元,2576,357,2219,摩根大通,2024-03-12,8440
3706,神達,2187,8,2179,摩根大通,2024-03-12,8440
2409,友達,3754,1588,2166,摩根大通,2024-03-12,8440
2323,中環,2769,703,2066,摩根大通,2024-03-12,8440
2888,新光金,2062,9,2053,摩根大通,2024-03-12,8440
2834,臺企銀,2433,845,1588,摩根大通,2024-03-12,8440
2885,元大金,2281,771,1510,摩根大通,2024-03-12,8440
2201,裕隆,1538,132,1406,摩根大通,2024-03-12,8440
2542,興富發,1597,239,1358,摩根大通,2024-03-12,8440
9904,寶成,2432,1101,1331,摩根大通,2024-03-12,8440
6016,康和證,1298,48,1250,摩根大通,2024-03-12,8440
1316,上曜,1230,26,1204,摩根大通,2024-03-12,8440
1402,遠東新,1222,174,1048,摩根大通,2024-03-12,8440
2880,華南金,1189,307,882,摩根大通,2024-03-12,8440
2610,華航,1069,233,836,摩根大通,2024-03-12,8440
6005,群益證,829,0,829,摩根大通,2024-03-12,8440
2344,華邦電,1380,556,824,摩根大通,2024-03-12,8440
2882,國泰金,1433,623,810,摩根大通,2024-03-12,8440
2486,一詮,943,134,809,摩根大通,2024-03-12,8440
2890,永豐金,931,130,801,摩根大通,2024-03-12,8440
2356,英業達,1192,400,792,摩根大通,2024-03-12,8440
8150,南茂,935,160,775,摩根大通,2024-03-12,8440
1609,大亞,814,41,773,摩根大通,2024-03-12,8440
3017,奇鋐,1263,494,769,摩根大通,2024-03-12,8440
2887,台新金,981,240,741,摩根大通,2024-03-12,8440
3231,緯創,1646,981,665,摩根大通,2024-03-12,8440
5876,上海商銀,677,26,651,摩根大通,2024-03-12,8440
4958,臻鼎-KY,689,96,593,摩根大通,2024-03-12,8440
1608,華榮,705,144,561,摩根大通,2024-03-12,8440
2368,金像電,586,39,547,摩根大通,2024-03-12,8440
2637,慧洋-KY,569,28,541,摩根大通,2024-03-12,8440
9921,巨大,572,49,523,摩根大通,2024-03-12,8440
1605,華新,588,88,500,摩根大通,2024-03-12,8440
1303,南亞,702,206,496,摩根大通,2024-03-12,8440
5258,虹堡,568,93,475,摩根大通,2024-03-12,8440
5521,工信,568,103,465,摩根大通,2024-03-12,8440
2383,台光電,777,317,460,摩根大通,2024-03-12,8440
2105,正新,456,9,447,摩根大通,2024-03-12,8440
4938,和碩,863,429,434,摩根大通,2024-03-12,8440
2313,華通,1179,751,428,摩根大通,2024-03-12,8440
5880,合庫金,734,307,427,摩根大通,2024-03-12,8440
5309,系統電,407,14,393,摩根大通,2024-03-12,8440
1815,富喬,734,352,382,摩根大通,2024-03-12,8440
2891,中信金,12089,1678,10411,摩根大通,2024-03-13,8440
2317,鴻海,14738,4931,9807,摩根大通,2024-03-13,8440
3481,群創,6774,1059,5715,摩根大通,2024-03-13,8440
2409,友達,3819,1199,2620,摩根大通,2024-03-13,8440
2886,兆豐金,3051,1116,1935,摩根大通,2024-03-13,8440
2882,國泰金,2317,554,1763,摩根大通,2024-03-13,8440
9904,寶成,1896,170,1726,摩根大通,2024-03-13,8440
3231,緯創,3206,1546,1660,摩根大通,2024-03-13,8440
2834,臺企銀,2065,422,1643,摩根大通,2024-03-13,8440
2884,玉山金,1937,501,1436,摩根大通,2024-03-13,8440
1402,遠東新,1645,243,1402,摩根大通,2024-03-13,8440
4938,和碩,1499,228,1271,摩根大通,2024-03-13,8440
6016,康和證,1120,34,1086,摩根大通,2024-03-13,8440
2368,金像電,1227,214,1013,摩根大通,2024-03-13,8440
2313,華通,1180,198,982,摩根大通,2024-03-13,8440
1316,上曜,1090,161,929,摩根大通,2024-03-13,8440
1503,士電,1352,531,821,摩根大通,2024-03-13,8440
2812,台中銀,935,133,802,摩根大通,2024-03-13,8440
4909,新復興,1194,418,776,摩根大通,2024-03-13,8440
8011,台通,1056,302,754,摩根大通,2024-03-13,8440
8040,九暘,1014,274,740,摩根大通,2024-03-13,8440
2449,京元電子,1054,338,716,摩根大通,2024-03-13,8440
5880,合庫金,1231,634,597,摩根大通,2024-03-13,8440
1519,華城,986,394,592,摩根大通,2024-03-13,8440
3706,神達,884,334,550,摩根大通,2024-03-13,8440
5871,中租-KY,716,175,541,摩根大通,2024-03-13,8440
3037,欣興,770,254,516,摩根大通,2024-03-13,8440
2345,智邦,570,59,511,摩根大通,2024-03-13,8440
2395,研華,567,61,506,摩根大通,2024-03-13,8440
3045,台灣大,1032,546,486,摩根大通,2024-03-13,8440
2455,全新,506,33,473,摩根大通,2024-03-13,8440
2486,一詮,571,105,466,摩根大通,2024-03-13,8440
3703,欣陸,487,30,457,摩根大通,2024-03-13,8440
6279,胡連,461,12,449,摩根大通,2024-03-13,8440
2881,富邦金,869,429,440,摩根大通,2024-03-13,8440
2382,廣達,1631,1191,440,摩根大通,2024-03-13,8440
9921,巨大,426,49,377,摩根大通,2024-03-13,8440
3702,大聯大,565,190,375,摩根大通,2024-03-13,8440
2303,聯電,5624,5267,357,摩根大通,2024-03-13,8440
2880,華南金,864,514,350,摩根大通,2024-03-13,8440
3050,鈺德,500,152,348,摩根大通,2024-03-13,8440
1409,新纖,385,45,340,摩根大通,2024-03-13,8440
2615,萬海,522,186,336,摩根大通,2024-03-13,8440
6015,宏遠證,359,33,326,摩根大通,2024-03-13,8440
2308,台達電,823,499,324,摩根大通,2024-03-13,8440
1605,華新,542,229,313,摩根大通,2024-03-13,8440
3711,日月光投控,1799,1491,308,摩根大通,2024-03-13,8440
6462,神盾,447,152,295,摩根大通,2024-03-13,8440
6546,正基,392,100,292,摩根大通,2024-03-13,8440
5222,全訊,323,34,289,摩根大通,2024-03-13,8440
2317,鴻海,20643,4009,16634,摩根大通,2024-03-14,8440
2002,中鋼,2922,101,2821,摩根大通,2024-03-14,8440
2882,國泰金,4863,2390,2473,摩根大通,2024-03-14,8440
2801,彰銀,2420,17,2403,摩根大通,2024-03-14,8440
1605,華新,2377,266,2111,摩根大通,2024-03-14,8440
2885,元大金,4075,2021,2054,摩根大通,2024-03-14,8440
2385,群光,2603,808,1795,摩根大通,2024-03-14,8440
1504,東元,1920,424,1496,摩根大通,2024-03-14,8440
2308,台達電,2156,767,1389,摩根大通,2024-03-14,8440
2105,正新,1493,294,1199,摩根大通,2024-03-14,8440
2892,第一金,1735,588,1147,摩根大通,2024-03-14,8440
1303,南亞,1093,48,1045,摩根大通,2024-03-14,8440
2888,新光金,1303,260,1043,摩根大通,2024-03-14,8440
2356,英業達,3693,2701,992,摩根大通,2024-03-14,8440
1402,遠東新,939,2,937,摩根大通,2024-03-14,8440
3035,智原,1048,215,833,摩根大通,2024-03-14,8440
1513,中興電,1673,878,795,摩根大通,2024-03-14,8440
5876,上海商銀,822,76,746,摩根大通,2024-03-14,8440
2376,技嘉,873,184,689,摩根大通,2024-03-14,8440
2201,裕隆,718,41,677,摩根大通,2024-03-14,8440
1609,大亞,1744,1122,622,摩根大通,2024-03-14,8440
9904,寶成,1173,591,582,摩根大通,2024-03-14,8440
1301,台塑,560,46,514,摩根大通,2024-03-14,8440
3042,晶技,1083,585,498,摩根大通,2024-03-14,8440
8936,國統,579,82,497,摩根大通,2024-03-14,8440
5483,中美晶,549,58,491,摩根大通,2024-03-14,8440
6285,啟��,671,203,468,摩根大通,2024-03-14,8440
2027,大成鋼,594,131,463,摩根大通,2024-03-14,8440
2887,台新金,813,391,422,摩根大通,2024-03-14,8440
2449,京元電子,595,174,421,摩根大通,2024-03-14,8440
2836,高雄銀,726,327,399,摩根大通,2024-03-14,8440
1514,亞力,878,482,396,摩根大通,2024-03-14,8440
3532,台勝科,367,9,358,摩根大通,2024-03-14,8440
2897,王道銀行,685,329,356,摩根大通,2024-03-14,8440
2454,聯發科,765,410,355,摩根大通,2024-03-14,8440
2395,研華,370,17,353,摩根大通,2024-03-14,8440
3163,波若威,856,519,337,摩根大通,2024-03-14,8440
3406,玉晶光,437,101,336,摩根大通,2024-03-14,8440
2368,金像電,370,44,326,摩根大通,2024-03-14,8440
9933,中鼎,397,78,319,摩根大通,2024-03-14,8440
2408,南亞科,501,186,315,摩根大通,2024-03-14,8440
2501,國建,300,5,295,摩根大通,2024-03-14,8440
6275,元山,616,324,292,摩根大通,2024-03-14,8440
4958,臻鼎-KY,720,430,290,摩根大通,2024-03-14,8440
3653,健策,326,37,289,摩根大通,2024-03-14,8440
4904,遠傳,359,75,284,摩根大通,2024-03-14,8440
4915,致伸,432,172,260,摩根大通,2024-03-14,8440
2208,台船,303,55,248,摩根大通,2024-03-14,8440
6873,泓德能源,258,11,247,摩根大通,2024-03-14,8440
6415,矽力*-KY,360,119,241,摩根大通,2024-03-14,8440
2867,三商壽,12137,3736,8401,摩根大通,2024-03-15,8440
2317,鴻海,18914,11081,7833,摩根大通,2024-03-15,8440
1514,亞力,7829,1374,6455,摩根大通,2024-03-15,8440
2539,櫻花建,7798,1458,6340,摩根大通,2024-03-15,8440
2884,玉山金,5563,1718,3845,摩根大通,2024-03-15,8440
2511,太子,4311,661,3650,摩根大通,2024-03-15,8440
2303,聯電,6900,3393,3507,摩根大通,2024-03-15,8440
2885,元大金,5393,1963,3430,摩根大通,2024-03-15,8440
2892,第一金,5204,2439,2765,摩根大通,2024-03-15,8440
4979,華星光,3119,488,2631,摩根大通,2024-03-15,8440
2353,宏��,2824,256,2568,摩根大通,2024-03-15,8440
1513,中興電,2964,478,2486,摩根大通,2024-03-15,8440
2887,台新金,7123,4718,2405,摩根大通,2024-03-15,8440
3045,台灣大,2745,468,2277,摩根大通,2024-03-15,8440
3481,群創,5691,3424,2267,摩根大通,2024-03-15,8440
3036,文曄,3529,1353,2176,摩根大通,2024-03-15,8440
6770,力積電,2493,377,2116,摩根大通,2024-03-15,8440
2324,仁寶,4556,2580,1976,摩根大通,2024-03-15,8440
1504,東元,1716,392,1324,摩根大通,2024-03-15,8440
8112,至上,1379,57,1322,摩根大通,2024-03-15,8440
2891,中信金,11922,10601,1321,摩根大通,2024-03-15,8440
1101,台泥,5982,4698,1284,摩根大通,2024-03-15,8440
3231,緯創,2161,881,1280,摩根大通,2024-03-15,8440
2412,中華電,1790,511,1279,摩根大通,2024-03-15,8440
2308,台達電,1663,401,1262,摩根大通,2024-03-15,8440
6691,洋基工程,1432,238,1194,摩根大通,2024-03-15,8440
1605,華新,3439,2249,1190,摩根大通,2024-03-15,8440
2834,臺企銀,6174,5111,1063,摩根大通,2024-03-15,8440
2615,萬海,1392,369,1023,摩根大通,2024-03-15,8440
2881,富邦金,2761,1743,1018,摩根大通,2024-03-15,8440
9914,美利達,1090,126,964,摩根大通,2024-03-15,8440
9910,豐泰,1157,205,952,摩根大通,2024-03-15,8440
4904,遠傳,1002,168,834,摩根大通,2024-03-15,8440
3702,大聯大,3543,2734,809,摩根大通,2024-03-15,8440
4123,晟德,1129,329,800,摩根大通,2024-03-15,8440
3715,定穎投控,801,63,738,摩根大通,2024-03-15,8440
2409,友達,4170,3446,724,摩根大通,2024-03-15,8440
6139,亞翔,1135,424,711,摩根大通,2024-03-15,8440
3711,日月光投控,2089,1421,668,摩根大通,2024-03-15,8440
2357,華碩,757,111,646,摩根大通,2024-03-15,8440
2801,彰銀,1552,962,590,摩根大通,2024-03-15,8440
2636,台驊控股,845,264,581,摩根大通,2024-03-15,8440
8096,擎亞,919,356,563,摩根大通,2024-03-15,8440
2382,廣達,1611,1064,547,摩根大通,2024-03-15,8440
2385,群光,927,402,525,摩根大通,2024-03-15,8440
4938,和碩,1047,536,511,摩根大通,2024-03-15,8440
2395,研華,669,171,498,摩根大通,2024-03-15,8440
6274,台燿,716,232,484,摩根大通,2024-03-15,8440
4961,天鈺,767,300,467,摩根大通,2024-03-15,8440
8016,矽創,428,7,421,摩根大通,2024-03-15,8440
1513,中興電,3548,1001,2547,摩根大通,2024-03-18,8440
2892,第一金,2712,428,2284,摩根大通,2024-03-18,8440
2449,京元電子,2385,849,1536,摩根大通,2024-03-18,8440
2208,台船,1409,89,1320,摩根大通,2024-03-18,8440
2324,仁寶,1743,748,995,摩根大通,2024-03-18,8440
3037,欣興,1175,207,968,摩根大通,2024-03-18,8440
6139,亞翔,972,45,927,摩根大通,2024-03-18,8440
1303,南亞,1116,257,859,摩根大通,2024-03-18,8440
2382,廣達,1938,1101,837,摩根大通,2024-03-18,8440
3711,日月光投控,1645,860,785,摩根大通,2024-03-18,8440
1503,士電,1846,1087,759,摩根大通,2024-03-18,8440
2105,正新,1377,645,732,摩根大通,2024-03-18,8440
6257,矽格,740,8,732,摩根大通,2024-03-18,8440
2412,中華電,701,12,689,摩根大通,2024-03-18,8440
4904,遠傳,626,12,614,摩根大通,2024-03-18,8440
6191,精成科,577,7,570,摩根大通,2024-03-18,8440
3702,大聯大,1146,591,555,摩根大通,2024-03-18,8440
2367,燿華,1125,601,524,摩根大通,2024-03-18,8440
3583,辛耘,544,46,498,摩根大通,2024-03-18,8440
3045,台灣大,525,64,461,摩根大通,2024-03-18,8440
1522,堤維西,533,86,447,摩根大通,2024-03-18,8440
2369,菱生,406,14,392,摩根大通,2024-03-18,8440
2025,千興,445,56,389,摩根大通,2024-03-18,8440
8064,東捷,468,80,388,摩根大通,2024-03-18,8440
1104,環泥,387,11,376,摩根大通,2024-03-18,8440
3017,奇鋐,563,198,365,摩根大通,2024-03-18,8440
2316,楠梓電,531,170,361,摩根大通,2024-03-18,8440
2206,三陽工業,372,24,348,摩根大通,2024-03-18,8440
6177,達麗,344,3,341,摩根大通,2024-03-18,8440
6125,廣運,402,61,341,摩根大通,2024-03-18,8440
2359,所羅門,350,11,339,摩根大通,2024-03-18,8440
2363,矽統,428,93,335,摩根大通,2024-03-18,8440
1608,華榮,380,53,327,摩根大通,2024-03-18,8440
6235,華孚,350,25,325,摩根大通,2024-03-18,8440
6117,迎廣,362,43,319,摩根大通,2024-03-18,8440
2365,昆盈,343,26,317,摩根大通,2024-03-18,8440
2636,台驊控股,355,45,310,摩根大通,2024-03-18,8440
5469,瀚宇博,323,30,293,摩根大通,2024-03-18,8440
2332,友訊,301,19,282,摩根大通,2024-03-18,8440
8112,至上,367,89,278,摩根大通,2024-03-18,8440
9105,泰金寶-DR,404,129,275,摩根大通,2024-03-18,8440
3234,光環,327,57,270,摩根大通,2024-03-18,8440
1504,東元,535,265,270,摩根大通,2024-03-18,8440
2633,台灣高鐵,270,7,263,摩根大通,2024-03-18,8440
8085,福華,344,89,255,摩根大通,2024-03-18,8440
9907,統一實,255,5,250,摩根大通,2024-03-18,8440
2816,旺旺保,260,10,250,摩根大通,2024-03-18,8440
4919,新唐,237,0,237,摩根大通,2024-03-18,8440
1316,上曜,243,7,236,摩根大通,2024-03-18,8440
3081,聯亞,469,235,234,摩根大通,2024-03-18,8440
2317,鴻海,13921,8833,5088,摩根大通,2024-03-19,8440
2330,台積電,4555,1662,2893,摩根大通,2024-03-19,8440
2303,聯電,4913,2708,2205,摩根大通,2024-03-19,8440
4904,遠傳,1732,308,1424,摩根大通,2024-03-19,8440
2301,光寶科,1292,285,1007,摩根大通,2024-03-19,8440
8112,至上,1146,171,975,摩根大通,2024-03-19,8440
8086,宏捷科,1104,184,920,摩根大通,2024-03-19,8440
3105,穩懋,876,43,833,摩根大通,2024-03-19,8440
3037,欣興,1581,750,831,摩根大通,2024-03-19,8440
1514,亞力,1095,264,831,摩根大通,2024-03-19,8440
3231,緯創,1629,823,806,摩根大通,2024-03-19,8440
6147,頎邦,905,138,767,摩根大通,2024-03-19,8440
6191,精成科,815,129,686,摩根大通,2024-03-19,8440
2886,兆豐金,1030,380,650,摩根大通,2024-03-19,8440
2885,元大金,2202,1554,648,摩根大通,2024-03-19,8440
3706,神達,1309,679,630,摩根大通,2024-03-19,8440
1785,光洋科,660,75,585,摩根大通,2024-03-19,8440
2382,廣達,2036,1475,561,摩根大通,2024-03-19,8440
2359,所羅門,765,213,552,摩根大通,2024-03-19,8440
2884,玉山金,1575,1035,540,摩根大通,2024-03-19,8440
4919,新唐,615,91,524,摩根大通,2024-03-19,8440
6668,中揚光,527,33,494,摩根大通,2024-03-19,8440
1618,合機,751,292,459,摩根大通,2024-03-19,8440
2313,華通,650,234,416,摩根大通,2024-03-19,8440
2409,友達,921,584,337,摩根大通,2024-03-19,8440
6415,矽力*-KY,478,141,337,摩根大通,2024-03-19,8440
6257,矽格,422,87,335,摩根大通,2024-03-19,8440
3041,揚智,813,487,326,摩根大通,2024-03-19,8440
2882,國泰金,827,507,320,摩根大通,2024-03-19,8440
5371,中光電,303,0,303,摩根大通,2024-03-19,8440
2636,台驊控股,293,2,291,摩根大通,2024-03-19,8440
2641,正德,353,70,283,摩根大通,2024-03-19,8440
3443,創意,308,30,278,摩根大通,2024-03-19,8440
6505,台塑化,472,201,271,摩根大通,2024-03-19,8440
3714,富采,302,32,270,摩根大通,2024-03-19,8440
6188,廣明,351,82,269,摩根大通,2024-03-19,8440
2337,旺宏,395,126,269,摩根大通,2024-03-19,8440
2395,研華,500,237,263,摩根大通,2024-03-19,8440
2520,冠德,296,38,258,摩根大通,2024-03-19,8440
1608,華榮,440,198,242,摩根大通,2024-03-19,8440
1714,和桐,249,9,240,摩根大通,2024-03-19,8440
6290,良維,250,13,237,摩根大通,2024-03-19,8440
2606,裕民,519,282,237,摩根大通,2024-03-19,8440
3189,景碩,305,71,234,摩根大通,2024-03-19,8440
2323,中環,922,710,212,摩根大通,2024-03-19,8440
3264,欣銓,455,243,212,摩根大通,2024-03-19,8440
2454,聯發科,576,367,209,摩根大通,2024-03-19,8440
1522,堤維西,389,180,209,摩根大通,2024-03-19,8440
3010,華立,200,6,194,摩根大通,2024-03-19,8440
6285,啟��,282,88,194,摩根大通,2024-03-19,8440
3706,神達,4244,1179,3065,摩根大通,2024-03-20,8440
2883,凱基金,4812,2115,2697,摩根大通,2024-03-20,8440
9904,寶成,2324,559,1765,摩根大通,2024-03-20,8440
1815,富喬,1419,5,1414,摩根大通,2024-03-20,8440
2206,三陽工業,1412,49,1363,摩根大通,2024-03-20,8440
2892,第一金,2062,722,1340,摩根大通,2024-03-20,8440
1503,士電,1040,113,927,摩根大通,2024-03-20,8440
4904,遠傳,1244,389,855,摩根大通,2024-03-20,8440
2880,華南金,1794,954,840,摩根大通,2024-03-20,8440
2329,華泰,835,102,733,摩根大通,2024-03-20,8440
3045,台灣大,756,112,644,摩根大通,2024-03-20,8440
3036,文曄,1758,1129,629,摩根大通,2024-03-20,8440
1216,統一,1347,773,574,摩根大通,2024-03-20,8440
4919,新唐,739,179,560,摩根大通,2024-03-20,8440
2887,台新金,1254,728,526,摩根大通,2024-03-20,8440
6605,帝寶,594,73,521,摩根大通,2024-03-20,8440
3702,大聯大,768,273,495,摩根大通,2024-03-20,8440
2354,鴻準,841,357,484,摩根大通,2024-03-20,8440
3207,耀勝,902,426,476,摩根大通,2024-03-20,8440
4164,承業醫,444,7,437,摩根大通,2024-03-20,8440
2388,威盛,497,73,424,摩根大通,2024-03-20,8440
4915,致伸,496,76,420,摩根大通,2024-03-20,8440
2885,元大金,1299,883,416,摩根大通,2024-03-20,8440
1522,堤維西,518,123,395,摩根大通,2024-03-20,8440
2323,中環,1209,828,381,摩根大通,2024-03-20,8440
6187,萬潤,378,0,378,摩根大通,2024-03-20,8440
4533,協易機,535,168,367,摩根大通,2024-03-20,8440
6191,精成科,795,449,346,摩根大通,2024-03-20,8440
3189,景碩,513,172,341,摩根大通,2024-03-20,8440
9958,世紀鋼,536,204,332,摩根大通,2024-03-20,8440
1218,泰山,476,151,325,摩根大通,2024-03-20,8440
6116,彩晶,424,107,317,摩根大通,2024-03-20,8440
2337,旺宏,604,293,311,摩根大通,2024-03-20,8440
2106,建大,344,37,307,摩根大通,2024-03-20,8440
6223,旺矽,325,22,303,摩根大通,2024-03-20,8440
2486,一詮,370,69,301,摩根大通,2024-03-20,8440
3588,通嘉,332,32,300,摩根大通,2024-03-20,8440
8112,至上,694,397,297,摩根大通,2024-03-20,8440
5388,中磊,499,203,296,摩根大通,2024-03-20,8440
8016,矽創,476,191,285,摩根大通,2024-03-20,8440
2636,台驊控股,296,13,283,摩根大通,2024-03-20,8440
6177,達麗,304,36,268,摩根大通,2024-03-20,8440
6257,矽格,501,236,265,摩根大通,2024-03-20,8440
2387,精元,300,36,264,摩根大通,2024-03-20,8440
6182,合晶,276,12,264,摩根大通,2024-03-20,8440
1316,上曜,472,216,256,摩根大通,2024-03-20,8440
6668,中揚光,250,8,242,摩根大通,2024-03-20,8440
1608,華榮,262,26,236,摩根大通,2024-03-20,8440
2472,立隆電,238,10,228,摩根大通,2024-03-20,8440
6213,聯茂,275,50,225,摩根大通,2024-03-20,8440
2317,鴻海,12727,4020,8707,摩根大通,2024-03-21,8440
2330,台積電,6945,1494,5451,摩根大通,2024-03-21,8440
2603,長榮,6593,1314,5279,摩根大通,2024-03-21,8440
2409,友達,5331,552,4779,摩根大通,2024-03-21,8440
2891,中信金,5212,812,4400,摩根大通,2024-03-21,8440
2408,南亞科,5184,1116,4068,摩根大通,2024-03-21,8440
2883,凱基金,4320,775,3545,摩根大通,2024-03-21,8440
6005,群益證,3014,61,2953,摩根大通,2024-03-21,8440
9904,寶成,3402,470,2932,摩根大通,2024-03-21,8440
2886,兆豐金,2968,252,2716,摩根大通,2024-03-21,8440
5469,瀚宇博,2990,314,2676,摩根大通,2024-03-21,8440
2880,華南金,2801,172,2629,摩根大通,2024-03-21,8440
2890,永豐金,3141,901,2240,摩根大通,2024-03-21,8440
3706,神達,5038,2985,2053,摩根大通,2024-03-21,8440
2887,台新金,2420,463,1957,摩根大通,2024-03-21,8440
3711,日月光投控,1991,96,1895,摩根大通,2024-03-21,8440
2323,中環,2304,806,1498,摩根大通,2024-03-21,8440
6188,廣明,2614,1173,1441,摩根大通,2024-03-21,8440
1402,遠東新,1621,263,1358,摩根大通,2024-03-21,8440
2881,富邦金,1727,398,1329,摩根大通,2024-03-21,8440
1609,大亞,1428,178,1250,摩根大通,2024-03-21,8440
1303,南亞,1488,241,1247,摩根大通,2024-03-21,8440
2324,仁寶,2161,953,1208,摩根大通,2024-03-21,8440
2344,華邦電,1499,294,1205,摩根大通,2024-03-21,8440
2892,第一金,1754,585,1169,摩根大通,2024-03-21,8440
2515,中工,1210,63,1147,摩根大通,2024-03-21,8440
2486,一詮,1326,256,1070,摩根大通,2024-03-21,8440
2888,新光金,1597,536,1061,摩根大通,2024-03-21,8440
2884,玉山金,1204,152,1052,摩根大通,2024-03-21,8440
2313,華通,1049,102,947,摩根大通,2024-03-21,8440
1514,亞力,1211,320,891,摩根大通,2024-03-21,8440
3033,威健,1295,440,855,摩根大通,2024-03-21,8440
3036,文曄,1142,342,800,摩根大通,2024-03-21,8440
2449,京元電子,1459,684,775,摩根大通,2024-03-21,8440
2356,英業達,1339,568,771,摩根大通,2024-03-21,8440
5521,工信,942,186,756,摩根大通,2024-03-21,8440
3260,威剛,806,96,710,摩根大通,2024-03-21,8440
8096,擎亞,850,144,706,摩根大通,2024-03-21,8440
2609,陽明,1333,656,677,摩根大通,2024-03-21,8440
3034,聯詠,887,264,623,摩根大通,2024-03-21,8440
6239,力成,924,337,587,摩根大通,2024-03-21,8440
6026,福邦證,585,1,584,摩根大通,2024-03-21,8440
5876,上海商銀,603,22,581,摩根大通,2024-03-21,8440
4904,遠傳,831,269,562,摩根大通,2024-03-21,8440
1605,華新,1136,604,532,摩根大通,2024-03-21,8440
1785,光洋科,1402,872,530,摩根大通,2024-03-21,8440
4967,十銓,644,115,529,摩根大通,2024-03-21,8440
2376,技嘉,559,43,516,摩根大通,2024-03-21,8440
5880,合庫金,779,281,498,摩根大通,2024-03-21,8440
2367,燿華,798,300,498,摩根大通,2024-03-21,8440
1609,大亞,5189,501,4688,摩根大通,2024-03-22,8440
2603,長榮,4989,759,4230,摩根大通,2024-03-22,8440
2317,鴻海,7900,4534,3366,摩根大通,2024-03-22,8440
2408,南亞科,8239,5578,2661,摩根大通,2024-03-22,8440
1504,東元,2342,457,1885,摩根大通,2024-03-22,8440
2367,燿華,1937,477,1460,摩根大通,2024-03-22,8440
2882,國泰金,4078,2831,1247,摩根大通,2024-03-22,8440
2356,英業達,5110,3866,1244,摩根大通,2024-03-22,8440
2330,台積電,3182,2062,1120,摩根大通,2024-03-22,8440
2382,廣達,1455,345,1110,摩根大通,2024-03-22,8440
3045,台灣大,1232,208,1024,摩根大通,2024-03-22,8440
2449,京元電子,1570,684,886,摩根大通,2024-03-22,8440
5880,合庫金,1437,666,771,摩根大通,2024-03-22,8440
2308,台達電,1907,1168,739,摩根大通,2024-03-22,8440
2836,高雄銀,759,36,723,摩根大通,2024-03-22,8440
2363,矽統,782,79,703,摩根大通,2024-03-22,8440
2618,長榮航,851,215,636,摩根大通,2024-03-22,8440
3017,奇鋐,702,78,624,摩根大通,2024-03-22,8440
3708,上緯投控,669,63,606,摩根大通,2024-03-22,8440
4904,遠傳,883,332,551,摩根大通,2024-03-22,8440
1402,遠東新,896,369,527,摩根大通,2024-03-22,8440
4919,新唐,464,11,453,摩根大通,2024-03-22,8440
6806,森崴能源,509,59,450,摩根大通,2024-03-22,8440
6116,彩晶,717,279,438,摩根大通,2024-03-22,8440
2409,友達,1159,724,435,摩根大通,2024-03-22,8440
1460,宏遠,436,16,420,摩根大通,2024-03-22,8440
8110,華東,477,63,414,摩根大通,2024-03-22,8440
6189,豐藝,458,55,403,摩根大通,2024-03-22,8440
5876,上海商銀,830,434,396,摩根大通,2024-03-22,8440
1618,合機,642,247,395,摩根大通,2024-03-22,8440
3380,明泰,391,11,380,摩根大通,2024-03-22,8440
1319,東陽,488,116,372,摩根大通,2024-03-22,8440
3058,立德,381,48,333,摩根大通,2024-03-22,8440
2312,金寶,337,25,312,摩根大通,2024-03-22,8440
2337,旺宏,559,249,310,摩根大通,2024-03-22,8440
3027,盛達,308,21,287,摩根大通,2024-03-22,8440
1808,潤隆,502,217,285,摩根大通,2024-03-22,8440
2453,凌群,339,59,280,摩根大通,2024-03-22,8440
1514,亞力,738,478,260,摩根大通,2024-03-22,8440
3037,欣興,745,486,259,摩根大通,2024-03-22,8440
3041,揚智,296,38,258,摩根大通,2024-03-22,8440
3673,TPK-KY,259,11,248,摩根大通,2024-03-22,8440
3217,優群,268,29,239,摩根大通,2024-03-22,8440
2461,光群雷,227,11,216,摩根大通,2024-03-22,8440
1909,榮成,212,3,209,摩根大通,2024-03-22,8440
3044,健鼎,254,47,207,摩根大通,2024-03-22,8440
4915,致伸,200,2,198,摩根大通,2024-03-22,8440
3005,神基,419,228,191,摩根大通,2024-03-22,8440
2332,友訊,194,4,190,摩根大通,2024-03-22,8440
6412,群電,212,22,190,摩根大通,2024-03-22,8440
2891,中信金,5486,2727,2759,摩根大通,2024-03-25,8440
2603,長榮,3501,1263,2238,摩根大通,2024-03-25,8440
2371,大同,2552,409,2143,摩根大通,2024-03-25,8440
2330,台積電,2404,1157,1247,摩根大通,2024-03-25,8440
2537,聯上發,1314,79,1235,摩根大通,2024-03-25,8440
8996,高力,1353,177,1176,摩根大通,2024-03-25,8440
9105,泰金寶-DR,1407,321,1086,摩根大通,2024-03-25,8440
1513,中興電,1892,914,978,摩根大通,2024-03-25,8440
1795,美時,911,27,884,摩根大通,2024-03-25,8440
2317,鴻海,5402,4521,881,摩根大通,2024-03-25,8440
3033,威健,1324,516,808,摩根大通,2024-03-25,8440
2449,京元電子,1801,1071,730,摩根大通,2024-03-25,8440
5880,合庫金,1145,492,653,摩根大通,2024-03-25,8440
1503,士電,677,36,641,摩根大通,2024-03-25,8440
2308,台達電,1758,1154,604,摩根大通,2024-03-25,8440
3217,優群,637,34,603,摩根大通,2024-03-25,8440
6789,采鈺,592,25,567,摩根大通,2024-03-25,8440
1909,榮成,552,43,509,摩根大通,2024-03-25,8440
6239,力成,739,237,502,摩根大通,2024-03-25,8440
8086,宏捷科,568,72,496,摩根大通,2024-03-25,8440
6139,亞翔,664,174,490,摩根大通,2024-03-25,8440
2547,日勝生,512,27,485,摩根大通,2024-03-25,8440
1905,華紙,525,54,471,摩根大通,2024-03-25,8440
9945,潤泰新,821,377,444,摩根大通,2024-03-25,8440
2618,長榮航,648,212,436,摩根大通,2024-03-25,8440
3376,新日興,504,69,435,摩根大通,2024-03-25,8440
2903,遠百,461,60,401,摩根大通,2024-03-25,8440
1522,堤維西,443,45,398,摩根大通,2024-03-25,8440
3673,TPK-KY,393,6,387,摩根大通,2024-03-25,8440
8110,華東,441,66,375,摩根大通,2024-03-25,8440
2515,中工,617,248,369,摩根大通,2024-03-25,8440
6412,群電,482,127,355,摩根大通,2024-03-25,8440
3010,華立,356,3,353,摩根大通,2024-03-25,8440
9904,寶成,712,361,351,摩根大通,2024-03-25,8440
2605,新興,374,42,332,摩根大通,2024-03-25,8440
3041,揚智,327,4,323,摩根大通,2024-03-25,8440
2882,國泰金,1281,965,316,摩根大通,2024-03-25,8440
4904,遠傳,496,182,314,摩根大通,2024-03-25,8440
4915,致伸,453,145,308,摩根大通,2024-03-25,8440
3017,奇鋐,437,130,307,摩根大通,2024-03-25,8440
5388,中磊,350,48,302,摩根大通,2024-03-25,8440
4306,炎洲,334,33,301,摩根大通,2024-03-25,8440
1734,杏輝,298,0,298,摩根大通,2024-03-25,8440
5351,鈺創,296,5,291,摩根大通,2024-03-25,8440
3062,建漢,445,157,288,摩根大通,2024-03-25,8440
2359,所羅門,421,134,287,摩根大通,2024-03-25,8440
8112,至上,448,163,285,摩根大通,2024-03-25,8440
2312,金寶,530,247,283,摩根大通,2024-03-25,8440
8271,宇瞻,294,12,282,摩根大通,2024-03-25,8440
2883,凱基金,4053,3772,281,摩根大通,2024-03-25,8440
2317,鴻海,21325,3207,18118,摩根大通,2024-03-26,8440
2353,宏��,8836,2218,6618,摩根大通,2024-03-26,8440
2890,永豐金,4937,350,4587,摩根大通,2024-03-26,8440
2371,大同,5925,2242,3683,摩根大通,2024-03-26,8440
3231,緯創,5286,1853,3433,摩根大通,2024-03-26,8440
2603,長榮,4465,1325,3140,摩根大通,2024-03-26,8440
1216,統一,4500,1481,3019,摩根大通,2024-03-26,8440
2882,國泰金,3173,260,2913,摩根大通,2024-03-26,8440
2002,中鋼,2601,496,2105,摩根大通,2024-03-26,8440
2884,玉山金,3012,935,2077,摩根大通,2024-03-26,8440
2891,中信金,3523,1453,2070,摩根大通,2024-03-26,8440
2887,台新金,2248,227,2021,摩根大通,2024-03-26,8440
2892,第一金,1875,116,1759,摩根大通,2024-03-26,8440
2885,元大金,2412,853,1559,摩根大通,2024-03-26,8440
5880,合庫金,2195,689,1506,摩根大通,2024-03-26,8440
2537,聯上發,1604,450,1154,摩根大通,2024-03-26,8440
2382,廣達,1832,784,1048,摩根大通,2024-03-26,8440
2801,彰銀,1234,186,1048,摩根大通,2024-03-26,8440
4904,遠傳,1843,827,1016,摩根大通,2024-03-26,8440
3045,台灣大,1086,77,1009,摩根大通,2024-03-26,8440
2331,精英,1065,86,979,摩根大通,2024-03-26,8440
6179,亞通,1097,150,947,摩根大通,2024-03-26,8440
1609,大亞,2610,1677,933,摩根大通,2024-03-26,8440
2880,華南金,1266,373,893,摩根大通,2024-03-26,8440
4915,致伸,1071,213,858,摩根大通,2024-03-26,8440
2888,新光金,945,145,800,摩根大通,2024-03-26,8440
1303,南亞,936,142,794,摩根大通,2024-03-26,8440
2412,中華電,821,38,783,摩根大通,2024-03-26,8440
9945,潤泰新,886,234,652,摩根大通,2024-03-26,8440
3706,神達,936,350,586,摩根大通,2024-03-26,8440
3703,欣陸,559,13,546,摩根大通,2024-03-26,8440
6443,元晶,714,174,540,摩根大通,2024-03-26,8440
5876,上海商銀,722,183,539,摩根大通,2024-03-26,8440
2323,中環,820,302,518,摩根大通,2024-03-26,8440
2367,燿華,904,398,506,摩根大通,2024-03-26,8440
3673,TPK-KY,566,61,505,摩根大通,2024-03-26,8440
3702,大聯大,832,335,497,摩根大通,2024-03-26,8440
9907,統一實,468,26,442,摩根大通,2024-03-26,8440
2385,群光,983,547,436,摩根大通,2024-03-26,8440
2049,上銀,826,392,434,摩根大通,2024-03-26,8440
1316,上曜,434,14,420,摩根大通,2024-03-26,8440
1301,台塑,809,391,418,摩根大通,2024-03-26,8440
1612,宏泰,874,459,415,摩根大通,2024-03-26,8440
2489,瑞軒,409,7,402,摩根大通,2024-03-26,8440
2379,瑞昱,488,98,390,摩根大通,2024-03-26,8440
3715,定穎投控,673,290,383,摩根大通,2024-03-26,8440
8150,南茂,447,69,378,摩根大通,2024-03-26,8440
2408,南亞科,1348,970,378,摩根大通,2024-03-26,8440
5871,中租-KY,408,60,348,摩根大通,2024-03-26,8440
1611,中電,571,226,345,摩根大通,2024-03-26,8440
2883,凱基金,7482,534,6948,摩根大通,2024-03-27,8440
1609,大亞,6880,2026,4854,摩根大通,2024-03-27,8440
2603,長榮,3509,1103,2406,摩根大通,2024-03-27,8440
2618,長榮航,3200,923,2277,摩根大通,2024-03-27,8440
1216,統一,2880,1210,1670,摩根大通,2024-03-27,8440
9904,寶成,1528,78,1450,摩根大通,2024-03-27,8440
6274,台燿,1668,416,1252,摩根大通,2024-03-27,8440
6005,群益證,1462,372,1090,摩根大通,2024-03-27,8440
4904,遠傳,1145,136,1009,摩根大通,2024-03-27,8440
2449,京元電子,1054,103,951,摩根大通,2024-03-27,8440
2317,鴻海,6552,5691,861,摩根大通,2024-03-27,8440
2412,中華電,1037,225,812,摩根大通,2024-03-27,8440
4306,炎洲,738,5,733,摩根大通,2024-03-27,8440
2308,台達電,1114,411,703,摩根大通,2024-03-27,8440
2301,光寶科,2126,1430,696,摩根大通,2024-03-27,8440
9945,潤泰新,952,295,657,摩根大通,2024-03-27,8440
2897,王道銀行,675,22,653,摩根大通,2024-03-27,8440
2889,國票金,666,26,640,摩根大通,2024-03-27,8440
6505,台塑化,777,148,629,摩根大通,2024-03-27,8440
2903,遠百,660,42,618,摩根大通,2024-03-27,8440
2520,冠德,631,27,604,摩根大通,2024-03-27,8440
5876,上海商銀,634,72,562,摩根大通,2024-03-27,8440
1616,億泰,727,207,520,摩根大通,2024-03-27,8440
1905,華紙,610,101,509,摩根大通,2024-03-27,8440
1795,美時,706,217,489,摩根大通,2024-03-27,8440
2105,正新,772,288,484,摩根大通,2024-03-27,8440
3714,富采,556,99,457,摩根大通,2024-03-27,8440
2324,仁寶,733,280,453,摩根大通,2024-03-27,8440
1314,中石化,495,62,433,摩根大通,2024-03-27,8440
1808,潤隆,1561,1140,421,摩根大通,2024-03-27,8440
6026,福邦證,407,0,407,摩根大通,2024-03-27,8440
6016,康和證,400,0,400,摩根大通,2024-03-27,8440
2809,京城銀,416,17,399,摩根大通,2024-03-27,8440
2208,台船,494,104,390,摩根大通,2024-03-27,8440
2634,漢翔,894,514,380,摩根大通,2024-03-27,8440
2385,群光,581,212,369,摩根大通,2024-03-27,8440
3056,富華新,385,28,357,摩根大通,2024-03-27,8440
8111,立��,372,16,356,摩根大通,2024-03-27,8440
5512,力麒,369,18,351,摩根大通,2024-03-27,8440
2530,華建,367,23,344,摩根大通,2024-03-27,8440
5871,中租-KY,430,87,343,摩根大通,2024-03-27,8440
2547,日勝生,350,8,342,摩根大通,2024-03-27,8440
2368,金像電,746,408,338,摩根大通,2024-03-27,8440
1442,名軒,340,3,337,摩根大通,2024-03-27,8440
2354,鴻準,544,235,309,摩根大通,2024-03-27,8440
1440,南紡,341,36,305,摩根大通,2024-03-27,8440
2489,瑞軒,309,6,303,摩根大通,2024-03-27,8440
3413,京鼎,328,26,302,摩根大通,2024-03-27,8440
3380,明泰,298,0,298,摩根大通,2024-03-27,8440
2887,台新金,873,577,296,摩根大通,2024-03-27,8440
2317,鴻海,23617,9346,14271,摩根大通,2024-03-28,8440
2603,長榮,4257,1558,2699,摩根大通,2024-03-28,8440
2382,廣達,3257,1099,2158,摩根大通,2024-03-28,8440
2313,華通,1857,471,1386,摩根大通,2024-03-28,8440
2409,友達,1306,117,1189,摩根大通,2024-03-28,8440
2356,英業達,1658,478,1180,摩根大通,2024-03-28,8440
3231,緯創,1826,774,1052,摩根大通,2024-03-28,8440
1504,東元,1404,363,1041,摩根大通,2024-03-28,8440
5512,力麒,1031,98,933,摩根大通,2024-03-28,8440
2385,群光,1404,584,820,摩根大通,2024-03-28,8440
3037,欣興,1029,228,801,摩根大通,2024-03-28,8440
1216,統一,1819,1022,797,摩根大通,2024-03-28,8440
2308,台達電,1586,803,783,摩根大通,2024-03-28,8440
3017,奇鋐,993,279,714,摩根大通,2024-03-28,8440
6191,精成科,905,338,567,摩根大通,2024-03-28,8440
1605,華新,1013,452,561,摩根大通,2024-03-28,8440
2454,聯發科,807,257,550,摩根大通,2024-03-28,8440
8996,高力,574,57,517,摩根大通,2024-03-28,8440
8085,福華,651,142,509,摩根大通,2024-03-28,8440
1808,潤隆,753,251,502,摩根大通,2024-03-28,8440
3260,威剛,523,31,492,摩根大通,2024-03-28,8440
9105,泰金寶-DR,751,275,476,摩根大通,2024-03-28,8440
2365,昆盈,524,53,471,摩根大通,2024-03-28,8440
2530,華建,644,180,464,摩根大通,2024-03-28,8440
2376,技嘉,776,327,449,摩根大通,2024-03-28,8440
1773,勝一,563,115,448,摩根大通,2024-03-28,8440
2367,燿華,1517,1083,434,摩根大通,2024-03-28,8440
2634,漢翔,833,404,429,摩根大通,2024-03-28,8440
2371,大同,3637,3224,413,摩根大通,2024-03-28,8440
2106,建大,440,31,409,摩根大通,2024-03-28,8440
3045,台灣大,629,223,406,摩根大通,2024-03-28,8440
2379,瑞昱,508,114,394,摩根大通,2024-03-28,8440
1455,集盛,392,5,387,摩根大通,2024-03-28,8440
3264,欣銓,442,57,385,摩根大通,2024-03-28,8440
6668,中揚光,402,20,382,摩根大通,2024-03-28,8440
1524,耿鼎,441,65,376,摩根大通,2024-03-28,8440
2402,毅嘉,384,8,376,摩根大通,2024-03-28,8440
1316,上曜,370,2,368,摩根大通,2024-03-28,8440
6274,台燿,530,169,361,摩根大通,2024-03-28,8440
4306,炎洲,376,43,333,摩根大通,2024-03-28,8440
5871,中租-KY,544,234,310,摩根大通,2024-03-28,8440
8467,波力-KY,369,69,300,摩根大通,2024-03-28,8440
6239,力成,689,396,293,摩根大通,2024-03-28,8440
2049,上銀,461,171,290,摩根大通,2024-03-28,8440
1514,亞力,413,134,279,摩根大通,2024-03-28,8440
3704,合勤控,766,490,276,摩根大通,2024-03-28,8440
2301,光寶科,2650,2376,274,摩根大通,2024-03-28,8440
2515,中工,1098,828,270,摩根大通,2024-03-28,8440
1312,國喬,259,10,249,摩根大通,2024-03-28,8440
6414,樺漢,403,163,240,摩根大通,2024-03-28,8440
3231,緯創,10539,650,9889,摩根大通,2024-03-29,8440
2883,凱基金,6009,1453,4556,摩根大通,2024-03-29,8440
2324,仁寶,6090,2322,3768,摩根大通,2024-03-29,8440
2887,台新金,3320,1048,2272,摩根大通,2024-03-29,8440
2618,長榮航,2337,246,2091,摩根大通,2024-03-29,8440
2515,中工,2074,47,2027,摩根大通,2024-03-29,8440
5880,合庫金,3181,1348,1833,摩根大通,2024-03-29,8440
2382,廣達,2987,1236,1751,摩根大通,2024-03-29,8440
2892,第一金,2161,597,1564,摩根大通,2024-03-29,8440
1605,華新,1679,285,1394,摩根大通,2024-03-29,8440
2882,國泰金,1671,365,1306,摩根大通,2024-03-29,8440
6139,亞翔,2059,785,1274,摩根大通,2024-03-29,8440
3481,群創,3734,2464,1270,摩根大通,2024-03-29,8440
1101,台泥,1702,527,1175,摩根大通,2024-03-29,8440
2886,兆豐金,1855,715,1140,摩根大通,2024-03-29,8440
2330,台積電,2059,920,1139,摩根大通,2024-03-29,8440
2313,華通,1192,126,1066,摩根大通,2024-03-29,8440
6505,台塑化,1080,46,1034,摩根大通,2024-03-29,8440
2880,華南金,1873,851,1022,摩根大通,2024-03-29,8440
2354,鴻準,1708,698,1010,摩根大通,2024-03-29,8440
2897,王道銀行,861,0,861,摩根大通,2024-03-29,8440
2409,友達,1605,750,855,摩根大通,2024-03-29,8440
2356,英業達,6617,5786,831,摩根大通,2024-03-29,8440
1608,華榮,1130,332,798,摩根大通,2024-03-29,8440
2885,元大金,1732,1016,716,摩根大通,2024-03-29,8440
2881,富邦金,1607,921,686,摩根大通,2024-03-29,8440
6005,群益證,768,104,664,摩根大通,2024-03-29,8440
6213,聯茂,895,232,663,摩根大通,2024-03-29,8440
2368,金像電,632,33,599,摩根大通,2024-03-29,8440
2317,鴻海,9878,9340,538,摩根大通,2024-03-29,8440
1815,富喬,566,37,529,摩根大通,2024-03-29,8440
4303,信立,1006,490,516,摩根大通,2024-03-29,8440
2801,彰銀,628,133,495,摩根大通,2024-03-29,8440
2331,精英,513,37,476,摩根大通,2024-03-29,8440
3548,兆利,497,53,444,摩根大通,2024-03-29,8440
2834,臺企銀,494,98,396,摩根大通,2024-03-29,8440
2316,楠梓電,383,18,365,摩根大通,2024-03-29,8440
1503,士電,363,0,363,摩根大通,2024-03-29,8440
2377,微星,453,101,352,摩根大通,2024-03-29,8440
2845,遠東銀,380,56,324,摩根大通,2024-03-29,8440
2363,矽統,386,62,324,摩根大通,2024-03-29,8440
3005,神基,459,143,316,摩根大通,2024-03-29,8440
9910,豐泰,338,44,294,摩根大通,2024-03-29,8440
3032,偉訓,282,1,281,摩根大通,2024-03-29,8440
2809,京城銀,331,54,277,摩根大通,2024-03-29,8440
1514,亞力,320,44,276,摩根大通,2024-03-29,8440
8033,雷虎,417,144,273,摩根大通,2024-03-29,8440
8936,國統,399,141,258,摩根大通,2024-03-29,8440
2020,美亞,247,0,247,摩根大通,2024-03-29,8440
2855,統一證,262,19,243,摩根大通,2024-03-29,8440
2492,華新科,2525,99,2426,摩根大通,2024-04-01,8440
2367,燿華,2169,38,2131,摩根大通,2024-04-01,8440
6005,群益證,1476,210,1266,摩根大通,2024-04-01,8440
2603,長榮,1627,383,1244,摩根大通,2024-04-01,8440
6213,聯茂,1289,121,1168,摩根大通,2024-04-01,8440
4904,遠傳,1103,19,1084,摩根大通,2024-04-01,8440
2409,友達,1202,132,1070,摩根大通,2024-04-01,8440
2888,新光金,1341,357,984,摩根大通,2024-04-01,8440
2618,長榮航,2981,2113,868,摩根大通,2024-04-01,8440
2486,一詮,834,154,680,摩根大通,2024-04-01,8440
6026,福邦證,640,0,640,摩根大通,2024-04-01,8440
3376,新日興,790,153,637,摩根大通,2024-04-01,8440
4714,永捷,655,42,613,摩根大通,2024-04-01,8440
3260,威剛,611,1,610,摩根大通,2024-04-01,8440
6015,宏遠證,608,0,608,摩根大通,2024-04-01,8440
6505,台塑化,751,164,587,摩根大通,2024-04-01,8440
8085,福華,577,27,550,摩根大通,2024-04-01,8440
6207,雷科,595,50,545,摩根大通,2024-04-01,8440
5347,世界,718,178,540,摩根大通,2024-04-01,8440
2884,玉山金,666,126,540,摩根大通,2024-04-01,8440
2308,台達電,572,39,533,摩根大通,2024-04-01,8440
6770,力積電,649,138,511,摩根大通,2024-04-01,8440
6667,信紘科,545,39,506,摩根大通,2024-04-01,8440
6550,北極星藥業-KY,515,11,504,摩根大通,2024-04-01,8440
6120,達運,562,60,502,摩根大通,2024-04-01,8440
4915,致伸,524,32,492,摩根大通,2024-04-01,8440
2324,仁寶,1197,720,477,摩根大通,2024-04-01,8440
1217,愛之味,478,5,473,摩根大通,2024-04-01,8440
6016,康和證,458,0,458,摩根大通,2024-04-01,8440
3324,雙鴻,713,257,456,摩根大通,2024-04-01,8440
3715,定穎投控,714,259,455,摩根大通,2024-04-01,8440
2327,國巨,553,118,435,摩根大通,2024-04-01,8440
8150,南茂,452,42,410,摩根大通,2024-04-01,8440
8926,台汽電,411,16,395,摩根大通,2024-04-01,8440
2498,宏達電,406,17,389,摩根大通,2024-04-01,8440
9945,潤泰新,477,98,379,摩根大通,2024-04-01,8440
2344,華邦電,570,200,370,摩根大通,2024-04-01,8440
2886,兆豐金,674,310,364,摩根大通,2024-04-01,8440
6284,佳邦,363,4,359,摩根大通,2024-04-01,8440
6274,台燿,670,314,356,摩根大通,2024-04-01,8440
2504,國產,369,14,355,摩根大通,2024-04-01,8440
2458,義隆,386,40,346,摩根大通,2024-04-01,8440
1102,亞泥,339,8,331,摩根大通,2024-04-01,8440
8027,鈦昇,340,10,330,摩根大通,2024-04-01,8440
2385,群光,627,303,324,摩根大通,2024-04-01,8440
2363,矽統,340,17,323,摩根大通,2024-04-01,8440
2472,立隆電,316,1,315,摩根大通,2024-04-01,8440
6282,康舒,343,35,308,摩根大通,2024-04-01,8440
3035,智原,317,13,304,摩根大通,2024-04-01,8440
3037,欣興,582,281,301,摩根大通,2024-04-01,8440
2002,中鋼,5168,433,4735,摩根大通,2024-04-02,8440
2515,中工,4580,972,3608,摩根大通,2024-04-02,8440
2303,聯電,3808,329,3479,摩根大通,2024-04-02,8440
2891,中信金,5237,2033,3204,摩根大通,2024-04-02,8440
2317,鴻海,6639,3521,3118,摩根大通,2024-04-02,8440
2603,長榮,3070,232,2838,摩根大通,2024-04-02,8440
2486,一詮,2887,709,2178,摩根大通,2024-04-02,8440
2890,永豐金,3227,1305,1922,摩根大通,2024-04-02,8440
2330,台積電,3207,1435,1772,摩根大通,2024-04-02,8440
9904,寶成,1705,118,1587,摩根大通,2024-04-02,8440
1314,中石化,1551,39,1512,摩根大通,2024-04-02,8440
2884,玉山金,1111,64,1047,摩根大通,2024-04-02,8440
1504,東元,1126,86,1040,摩根大通,2024-04-02,8440
2382,廣達,2396,1492,904,摩根大通,2024-04-02,8440
4958,臻鼎-KY,1387,549,838,摩根大通,2024-04-02,8440
2313,華通,757,22,735,摩根大通,2024-04-02,8440
2324,仁寶,1959,1241,718,摩根大通,2024-04-02,8440
3583,辛耘,708,112,596,摩根大通,2024-04-02,8440
1608,華榮,853,261,592,摩根大通,2024-04-02,8440
2408,南亞科,1216,633,583,摩根大通,2024-04-02,8440
5521,工信,700,119,581,摩根大通,2024-04-02,8440
1717,長興,719,177,542,摩根大通,2024-04-02,8440
6197,佳必琪,606,101,505,摩根大通,2024-04-02,8440
8936,國統,519,30,489,摩根大通,2024-04-02,8440
2323,中環,488,28,460,摩根大通,2024-04-02,8440
3264,欣銓,468,18,450,摩根大通,2024-04-02,8440
4909,新復興,506,63,443,摩根大通,2024-04-02,8440
1216,統一,933,499,434,摩根大通,2024-04-02,8440
5515,建國,437,8,429,摩根大通,2024-04-02,8440
3231,緯創,1723,1304,419,摩根大通,2024-04-02,8440
3005,神基,605,213,392,摩根大通,2024-04-02,8440
1503,士電,381,0,381,摩根大通,2024-04-02,8440
3042,晶技,424,59,365,摩根大通,2024-04-02,8440
3376,新日興,650,285,365,摩根大通,2024-04-02,8440
2385,群光,810,457,353,摩根大通,2024-04-02,8440
2883,凱基金,401,50,351,摩根大通,2024-04-02,8440
2530,華建,418,76,342,摩根大通,2024-04-02,8440
6234,高僑,358,35,323,摩根大通,2024-04-02,8440
3189,景碩,352,32,320,摩根大通,2024-04-02,8440
3707,漢磊,582,269,313,摩根大通,2024-04-02,8440
6288,聯嘉,323,13,310,摩根大通,2024-04-02,8440
3533,嘉澤,298,12,286,摩根大通,2024-04-02,8440
6189,豐藝,465,181,284,摩根大通,2024-04-02,8440
3380,明泰,502,220,282,摩根大通,2024-04-02,8440
2454,聯發科,429,163,266,摩根大通,2024-04-02,8440
3045,台灣大,452,201,251,摩根大通,2024-04-02,8440
4938,和碩,828,581,247,摩根大通,2024-04-02,8440
2885,元大金,427,188,239,摩根大通,2024-04-02,8440
6005,群益證,640,409,231,摩根大通,2024-04-02,8440
4915,致伸,282,57,225,摩根大通,2024-04-02,8440
2002,中鋼,10072,696,9376,摩根大通,2024-04-03,8440
3231,緯創,3999,782,3217,摩根大通,2024-04-03,8440
2330,台積電,4442,2400,2042,摩根大通,2024-04-03,8440
6120,達運,2255,263,1992,摩根大通,2024-04-03,8440
5871,中租-KY,2020,242,1778,摩根大通,2024-04-03,8440
1504,東元,1818,206,1612,摩根大通,2024-04-03,8440
2356,英業達,2779,1277,1502,摩根大通,2024-04-03,8440
2385,群光,977,86,891,摩根大通,2024-04-03,8440
5443,均豪,1065,186,879,摩根大通,2024-04-03,8440
1216,統一,1178,524,654,摩根大通,2024-04-03,8440
3005,神基,577,27,550,摩根大通,2024-04-03,8440
6274,台燿,888,380,508,摩根大通,2024-04-03,8440
1582,信錦,479,3,476,摩根大通,2024-04-03,8440
2886,兆豐金,1353,919,434,摩根大通,2024-04-03,8440
2637,慧洋-KY,452,35,417,摩根大通,2024-04-03,8440
6472,保瑞,450,87,363,摩根大通,2024-04-03,8440
2049,上銀,403,52,351,摩根大通,2024-04-03,8440
2634,漢翔,522,173,349,摩根大通,2024-04-03,8440
2504,國產,363,30,333,摩根大通,2024-04-03,8440
5876,上海商銀,733,439,294,摩根大通,2024-04-03,8440
6505,台塑化,424,132,292,摩根大通,2024-04-03,8440
3013,晟銘電,721,432,289,摩根大通,2024-04-03,8440
3033,威健,389,109,280,摩根大通,2024-04-03,8440
6535,順藥,282,12,270,摩根大通,2024-04-03,8440
8069,元太,385,124,261,摩根大通,2024-04-03,8440
9933,中鼎,261,11,250,摩根大通,2024-04-03,8440
8163,達方,278,35,243,摩根大通,2024-04-03,8440
4958,臻鼎-KY,444,203,241,摩根大通,2024-04-03,8440
5483,中美晶,300,61,239,摩根大通,2024-04-03,8440
3044,健鼎,282,47,235,摩根大通,2024-04-03,8440
1409,新纖,247,15,232,摩根大通,2024-04-03,8440
8358,金居,451,236,215,摩根大通,2024-04-03,8440
2809,京城銀,341,141,200,摩根大通,2024-04-03,8440
6177,達麗,257,70,187,摩根大通,2024-04-03,8440
8086,宏捷科,488,307,181,摩根大通,2024-04-03,8440
3042,晶技,231,50,181,摩根大通,2024-04-03,8440
4532,瑞智,246,72,174,摩根大通,2024-04-03,8440
2211,長榮鋼,211,38,173,摩根大通,2024-04-03,8440
1460,宏遠,191,27,164,摩根大通,2024-04-03,8440
2605,新興,207,44,163,摩根大通,2024-04-03,8440
3017,奇鋐,440,281,159,摩根大通,2024-04-03,8440
3380,明泰,260,102,158,摩根大通,2024-04-03,8440
1476,儒鴻,186,30,156,摩根大通,2024-04-03,8440
2454,聯發科,283,128,155,摩根大通,2024-04-03,8440
6288,聯嘉,393,243,150,摩根大通,2024-04-03,8440
2204,中華,218,71,147,摩根大通,2024-04-03,8440
1590,亞德客-KY,171,25,146,摩根大通,2024-04-03,8440
2355,敬鵬,154,9,145,摩根大通,2024-04-03,8440
5515,建國,186,41,145,摩根大通,2024-04-03,8440
3703,欣陸,160,17,143,摩根大通,2024-04-03,8440
2002,中鋼,12500,797,11703,摩根大通,2024-04-08,8440
2891,中信金,11503,3122,8381,摩根大通,2024-04-08,8440
2409,友達,3288,145,3143,摩根大通,2024-04-08,8440
2884,玉山金,2770,252,2518,摩根大通,2024-04-08,8440
2330,台積電,4197,1814,2383,摩根大通,2024-04-08,8440
1504,東元,2386,251,2135,摩根大通,2024-04-08,8440
1303,南亞,2316,288,2028,摩根大通,2024-04-08,8440
6443,元晶,1720,123,1597,摩根大通,2024-04-08,8440
3711,日月光投控,1908,363,1545,摩根大通,2024-04-08,8440
9904,寶成,2596,1090,1506,摩根大通,2024-04-08,8440
6005,群益證,1622,125,1497,摩根大通,2024-04-08,8440
4938,和碩,1670,228,1442,摩根大通,2024-04-08,8440
3481,群創,1497,134,1363,摩根大通,2024-04-08,8440
3037,欣興,1738,476,1262,摩根大通,2024-04-08,8440
2395,研華,1264,24,1240,摩根大通,2024-04-08,8440
8069,元太,1633,394,1239,摩根大通,2024-04-08,8440
5880,合庫金,1355,168,1187,摩根大通,2024-04-08,8440
2603,長榮,3158,2009,1149,摩根大通,2024-04-08,8440
2313,華通,2159,1118,1041,摩根大通,2024-04-08,8440
8936,國統,1200,210,990,摩根大通,2024-04-08,8440
2504,國產,1802,831,971,摩根大通,2024-04-08,8440
2892,第一金,871,39,832,摩根大通,2024-04-08,8440
5876,上海商銀,1336,507,829,摩根大通,2024-04-08,8440
8112,至上,841,113,728,摩根大通,2024-04-08,8440
1605,華新,748,25,723,摩根大通,2024-04-08,8440
1314,中石化,764,55,709,摩根大通,2024-04-08,8440
2382,廣達,1214,507,707,摩根大通,2024-04-08,8440
1608,華榮,864,174,690,摩根大通,2024-04-08,8440
6026,福邦證,548,7,541,摩根大通,2024-04-08,8440
5347,世界,1136,613,523,摩根大通,2024-04-08,8440
2449,京元電子,712,201,511,摩根大通,2024-04-08,8440
2489,瑞軒,528,40,488,摩根大通,2024-04-08,8440
2323,中環,518,50,468,摩根大通,2024-04-08,8440
6669,緯穎,592,154,438,摩根大通,2024-04-08,8440
2412,中華電,478,47,431,摩根大通,2024-04-08,8440
6177,達麗,448,44,404,摩根大通,2024-04-08,8440
6505,台塑化,426,29,397,摩根大通,2024-04-08,8440
6187,萬潤,479,94,385,摩根大通,2024-04-08,8440
6016,康和證,380,1,379,摩根大通,2024-04-08,8440
1618,合機,497,128,369,摩根大通,2024-04-08,8440
2812,台中銀,407,62,345,摩根大通,2024-04-08,8440
1409,新纖,355,11,344,摩根大通,2024-04-08,8440
4958,臻鼎-KY,840,500,340,摩根大通,2024-04-08,8440
3260,威剛,345,13,332,摩根大通,2024-04-08,8440
2383,台光電,1001,675,326,摩根大通,2024-04-08,8440
5515,建國,364,47,317,摩根大通,2024-04-08,8440
4533,協易機,472,157,315,摩根大通,2024-04-08,8440
2809,京城銀,361,52,309,摩根大通,2024-04-08,8440
3034,聯詠,485,176,309,摩根大通,2024-04-08,8440
4306,炎洲,442,134,308,摩根大通,2024-04-08,8440
2002,中鋼,32652,1825,30827,摩根大通,2024-04-09,8440
2409,友達,10793,777,10016,摩根大通,2024-04-09,8440
2883,凱基金,8738,807,7931,摩根大通,2024-04-09,8440
3481,群創,16344,9699,6645,摩根大通,2024-04-09,8440
2603,長榮,5865,588,5277,摩根大通,2024-04-09,8440
1314,中石化,4959,75,4884,摩根大通,2024-04-09,8440
2317,鴻海,6078,1729,4349,摩根大通,2024-04-09,8440
2618,長榮航,3207,114,3093,摩根大通,2024-04-09,8440
2889,國票金,2585,190,2395,摩根大通,2024-04-09,8440
1605,華新,2460,147,2313,摩根大通,2024-04-09,8440
6117,迎廣,2840,528,2312,摩根大通,2024-04-09,8440
1504,東元,3091,870,2221,摩根大通,2024-04-09,8440
2884,玉山金,2737,594,2143,摩根大通,2024-04-09,8440
2882,國泰金,3255,1209,2046,摩根大通,2024-04-09,8440
2610,華航,2223,262,1961,摩根大通,2024-04-09,8440
3711,日月光投控,2208,518,1690,摩根大通,2024-04-09,8440
8112,至上,2217,536,1681,摩根大通,2024-04-09,8440
2371,大同,2033,375,1658,摩根大通,2024-04-09,8440
6005,群益證,2158,557,1601,摩根大通,2024-04-09,8440
1303,南亞,2183,666,1517,摩根大通,2024-04-09,8440
1609,大亞,2081,612,1469,摩根大通,2024-04-09,8440
5347,世界,1761,377,1384,摩根大通,2024-04-09,8440
2606,裕民,1356,112,1244,摩根大通,2024-04-09,8440
2888,新光金,1547,358,1189,摩根大通,2024-04-09,8440
2353,宏��,1478,319,1159,摩根大通,2024-04-09,8440
2486,一詮,1910,830,1080,摩根大通,2024-04-09,8440
6443,元晶,1061,0,1061,摩根大通,2024-04-09,8440
1815,富喬,1076,22,1054,摩根大通,2024-04-09,8440
2885,元大金,4297,3287,1010,摩根大通,2024-04-09,8440
2615,萬海,1094,94,1000,摩根大通,2024-04-09,8440
2637,慧洋-KY,1142,167,975,摩根大通,2024-04-09,8440
3013,晟銘電,1875,998,877,摩根大通,2024-04-09,8440
1608,華榮,1481,604,877,摩根大通,2024-04-09,8440
2892,第一金,1491,636,855,摩根大通,2024-04-09,8440
2367,燿華,881,99,782,摩根大通,2024-04-09,8440
2504,國產,1000,222,778,摩根大通,2024-04-09,8440
2855,統一證,893,165,728,摩根大通,2024-04-09,8440
5512,力麒,609,4,605,摩根大通,2024-04-09,8440
5009,榮剛,622,23,599,摩根大通,2024-04-09,8440
1102,亞泥,764,168,596,摩根大通,2024-04-09,8440
2891,中信金,2693,2115,578,摩根大通,2024-04-09,8440
2897,王道銀行,580,10,570,摩根大通,2024-04-09,8440
2489,瑞軒,634,69,565,摩根大通,2024-04-09,8440
9904,寶成,857,292,565,摩根大通,2024-04-09,8440
2605,新興,638,86,552,摩根大通,2024-04-09,8440
3645,達邁,676,138,538,摩根大通,2024-04-09,8440
9945,潤泰新,636,102,534,摩根大通,2024-04-09,8440
2881,富邦金,1181,647,534,摩根大通,2024-04-09,8440
3017,奇鋐,782,254,528,摩根大通,2024-04-09,8440
2636,台驊控股,523,0,523,摩根大通,2024-04-09,8440
2303,聯電,8828,94,8734,摩根大通,2024-04-10,8440
2363,矽統,9491,1138,8353,摩根大通,2024-04-10,8440
2002,中鋼,10293,2862,7431,摩根大通,2024-04-10,8440
1314,中石化,3369,272,3097,摩根大通,2024-04-10,8440
2603,長榮,3316,304,3012,摩根大通,2024-04-10,8440
2344,華邦電,2136,49,2087,摩根大通,2024-04-10,8440
6443,元晶,1917,32,1885,摩根大通,2024-04-10,8440
3260,威剛,2873,988,1885,摩根大通,2024-04-10,8440
2409,友達,3212,1463,1749,摩根大通,2024-04-10,8440
2330,台積電,4395,2723,1672,摩根大通,2024-04-10,8440
9904,寶成,2361,722,1639,摩根大通,2024-04-10,8440
3450,聯鈞,1325,26,1299,摩根大通,2024-04-10,8440
2884,玉山金,1946,655,1291,摩根大通,2024-04-10,8440
1514,亞力,2385,1094,1291,摩根大通,2024-04-10,8440
4904,遠傳,1407,130,1277,摩根大通,2024-04-10,8440
2367,燿華,1939,741,1198,摩根大通,2024-04-10,8440
2504,國產,1346,159,1187,摩根大通,2024-04-10,8440
5876,上海商銀,1458,289,1169,摩根大通,2024-04-10,8440
1303,南亞,1340,192,1148,摩根大通,2024-04-10,8440
2353,宏��,2305,1158,1147,摩根大通,2024-04-10,8440
2887,台新金,1126,2,1124,摩根大通,2024-04-10,8440
3059,華晶科,1397,279,1118,摩根大通,2024-04-10,8440
2208,台船,1279,169,1110,摩根大通,2024-04-10,8440
2009,第一銅,1513,407,1106,摩根大通,2024-04-10,8440
8112,至上,1278,198,1080,摩根大通,2024-04-10,8440
2892,第一金,1229,199,1030,摩根大通,2024-04-10,8440
3033,威健,1291,330,961,摩根大通,2024-04-10,8440
1608,華榮,1584,624,960,摩根大通,2024-04-10,8440
2393,億光,937,31,906,摩根大通,2024-04-10,8440
3576,聯合再生,1277,371,906,摩根大通,2024-04-10,8440
2891,中信金,1570,725,845,摩根大通,2024-04-10,8440
1905,華紙,962,199,763,摩根大通,2024-04-10,8440
2888,新光金,1894,1151,743,摩根大通,2024-04-10,8440
2408,南亞科,1233,500,733,摩根大通,2024-04-10,8440
4746,台耀,732,36,696,摩根大通,2024-04-10,8440
4958,臻鼎-KY,817,151,666,摩根大通,2024-04-10,8440
2618,長榮航,1485,865,620,摩根大通,2024-04-10,8440
6117,迎廣,1091,478,613,摩根大通,2024-04-10,8440
2537,聯上發,871,281,590,摩根大通,2024-04-10,8440
3645,達邁,754,178,576,摩根大通,2024-04-10,8440
4167,松瑞藥,604,49,555,摩根大通,2024-04-10,8440
2313,華通,1240,686,554,摩根大通,2024-04-10,8440
2405,輔信,654,117,537,摩根大通,2024-04-10,8440
2354,鴻準,621,94,527,摩根大通,2024-04-10,8440
2615,萬海,606,86,520,摩根大通,2024-04-10,8440
2610,華航,649,130,519,摩根大通,2024-04-10,8440
4967,十銓,719,210,509,摩根大通,2024-04-10,8440
1102,亞泥,763,258,505,摩根大通,2024-04-10,8440
8150,南茂,604,101,503,摩根大通,2024-04-10,8440
5009,榮剛,838,351,487,摩根大通,2024-04-10,8440
2618,長榮航,20339,311,20028,摩根大通,2024-04-11,8440
2002,中鋼,9742,1034,8708,摩根大通,2024-04-11,8440
2317,鴻海,11029,3176,7853,摩根大通,2024-04-11,8440
2883,凱基金,7901,633,7268,摩根大通,2024-04-11,8440
2603,長榮,7836,985,6851,摩根大通,2024-04-11,8440
2371,大同,6212,819,5393,摩根大通,2024-04-11,8440
2330,台積電,3916,874,3042,摩根大通,2024-04-11,8440
3715,定穎投控,2912,329,2583,摩根大通,2024-04-11,8440
6005,群益證,2508,76,2432,摩根大通,2024-04-11,8440
2885,元大金,5413,3585,1828,摩根大通,2024-04-11,8440
1609,大亞,2453,640,1813,摩根大通,2024-04-11,8440
2504,國產,1941,263,1678,摩根大通,2024-04-11,8440
2501,國建,1850,226,1624,摩根大通,2024-04-11,8440
4904,遠傳,1765,183,1582,摩根大通,2024-04-11,8440
2324,仁寶,2234,702,1532,摩根大通,2024-04-11,8440
2884,玉山金,2083,577,1506,摩根大通,2024-04-11,8440
9904,寶成,1710,238,1472,摩根大通,2024-04-11,8440
8069,元太,1747,517,1230,摩根大通,2024-04-11,8440
2881,富邦金,1747,602,1145,摩根大通,2024-04-11,8440
8112,至上,1396,275,1121,摩根大通,2024-04-11,8440
2880,華南金,1398,404,994,摩根大通,2024-04-11,8440
5347,世界,1889,1008,881,摩根大通,2024-04-11,8440
2809,京城銀,855,10,845,摩根大通,2024-04-11,8440
2610,華航,1471,650,821,摩根大通,2024-04-11,8440
1513,中興電,1296,477,819,摩根大通,2024-04-11,8440
3045,台灣大,801,66,735,摩根大通,2024-04-11,8440
3034,聯詠,1001,271,730,摩根大通,2024-04-11,8440
5876,上海商銀,1085,363,722,摩根大通,2024-04-11,8440
2891,中信金,2790,2078,712,摩根大通,2024-04-11,8440
2449,京元電子,982,306,676,摩根大通,2024-04-11,8440
2009,第一銅,950,281,669,摩根大通,2024-04-11,8440
2204,中華,615,10,605,摩根大通,2024-04-11,8440
6290,良維,774,195,579,摩根大通,2024-04-11,8440
2606,裕民,692,136,556,摩根大通,2024-04-11,8440
1402,遠東新,666,142,524,摩根大通,2024-04-11,8440
2412,中華電,631,131,500,摩根大通,2024-04-11,8440
9921,巨大,523,38,485,摩根大通,2024-04-11,8440
2323,中環,475,22,453,摩根大通,2024-04-11,8440
4938,和碩,666,241,425,摩根大通,2024-04-11,8440
4533,協易機,1237,813,424,摩根大通,2024-04-11,8440
2852,第一保,455,31,424,摩根大通,2024-04-11,8440
3260,威剛,569,171,398,摩根大通,2024-04-11,8440
8027,鈦昇,413,27,386,摩根大通,2024-04-11,8440
1102,亞泥,548,172,376,摩根大通,2024-04-11,8440
2812,台中銀,479,106,373,摩根大通,2024-04-11,8440
3324,雙鴻,440,88,352,摩根大通,2024-04-11,8440
1529,樂事綠能,448,105,343,摩根大通,2024-04-11,8440
3702,大聯大,440,105,335,摩根大通,2024-04-11,8440
2486,一詮,336,4,332,摩根大通,2024-04-11,8440
8110,華東,445,121,324,摩根大通,2024-04-11,8440
2367,燿華,7489,2092,5397,摩根大通,2024-04-12,8440
1513,中興電,5167,484,4683,摩根大通,2024-04-12,8440
2891,中信金,7127,3112,4015,摩根大通,2024-04-12,8440
1504,東元,4695,1030,3665,摩根大通,2024-04-12,8440
1609,大亞,5097,1574,3523,摩根大通,2024-04-12,8440
2885,元大金,4418,1561,2857,摩根大通,2024-04-12,8440
6005,群益證,2675,299,2376,摩根大通,2024-04-12,8440
2317,鴻海,7093,4975,2118,摩根大通,2024-04-12,8440
2002,中鋼,4878,3009,1869,摩根大通,2024-04-12,8440
8936,國統,1975,223,1752,摩根大通,2024-04-12,8440
5347,世界,2013,363,1650,摩根大通,2024-04-12,8440
5876,上海商銀,2020,543,1477,摩根大通,2024-04-12,8440
2603,長榮,2042,621,1421,摩根大通,2024-04-12,8440
3013,晟銘電,1966,659,1307,摩根大通,2024-04-12,8440
2363,矽統,4877,3579,1298,摩根大通,2024-04-12,8440
2303,聯電,2546,1307,1239,摩根大通,2024-04-12,8440
2618,長榮航,5363,4128,1235,摩根大通,2024-04-12,8440
3045,台灣大,1272,44,1228,摩根大通,2024-04-12,8440
2501,國建,1761,646,1115,摩根大通,2024-04-12,8440
2371,大同,6231,5137,1094,摩根大通,2024-04-12,8440
1605,華新,1996,907,1089,摩根大通,2024-04-12,8440
8069,元太,1561,495,1066,摩根大通,2024-04-12,8440
2504,國產,1601,556,1045,摩根大通,2024-04-12,8440
9904,寶成,1725,786,939,摩根大通,2024-04-12,8440
2313,華通,973,43,930,摩根大通,2024-04-12,8440
3260,威剛,1412,491,921,摩根大通,2024-04-12,8440
2101,南港,1274,375,899,摩根大通,2024-04-12,8440
1532,勤美,822,7,815,摩根大通,2024-04-12,8440
6284,佳邦,813,1,812,摩根大通,2024-04-12,8440
3622,洋華,864,54,810,摩根大通,2024-04-12,8440
2605,新興,1110,300,810,摩根大通,2024-04-12,8440
9914,美利達,943,139,804,摩根大通,2024-04-12,8440
5608,四維航,983,202,781,摩根大通,2024-04-12,8440
4904,遠傳,1492,735,757,摩根大通,2024-04-12,8440
1795,美時,929,202,727,摩根大通,2024-04-12,8440
1514,亞力,2704,2006,698,摩根大通,2024-04-12,8440
1503,士電,837,150,687,摩根大通,2024-04-12,8440
2606,裕民,940,258,682,摩根大通,2024-04-12,8440
2486,一詮,1089,422,667,摩根大通,2024-04-12,8440
1612,宏泰,914,249,665,摩根大通,2024-04-12,8440
1785,光洋科,828,164,664,摩根大通,2024-04-12,8440
2809,京城銀,588,22,566,摩根大通,2024-04-12,8440
1519,華城,729,188,541,摩根大通,2024-04-12,8440
1303,南亞,1154,616,538,摩根大通,2024-04-12,8440
8064,東捷,558,24,534,摩根大通,2024-04-12,8440
2374,佳能,706,174,532,摩根大通,2024-04-12,8440
2637,慧洋-KY,907,402,505,摩根大通,2024-04-12,8440
1815,富喬,643,150,493,摩根大通,2024-04-12,8440
6290,良維,1630,1149,481,摩根大通,2024-04-12,8440
5515,建國,505,25,480,摩根大通,2024-04-12,8440
2317,鴻海,10695,3227,7468,摩根大通,2024-04-15,8440
2002,中鋼,7653,321,7332,摩根大通,2024-04-15,8440
2885,元大金,6313,820,5493,摩根大通,2024-04-15,8440
2884,玉山金,4606,652,3954,摩根大通,2024-04-15,8440
6005,群益證,3868,382,3486,摩根大通,2024-04-15,8440
2890,永豐金,3971,941,3030,摩根大通,2024-04-15,8440
5880,合庫金,3212,455,2757,摩根大通,2024-04-15,8440
2330,台積電,7076,4690,2386,摩根大通,2024-04-15,8440
5876,上海商銀,2568,258,2310,摩根大通,2024-04-15,8440
9904,寶成,2781,533,2248,摩根大通,2024-04-15,8440
4904,遠傳,2358,118,2240,摩根大通,2024-04-15,8440
2897,王道銀行,2256,83,2173,摩根大通,2024-04-15,8440
2409,友達,4571,2694,1877,摩根大通,2024-04-15,8440
2882,國泰金,2255,430,1825,摩根大通,2024-04-15,8440
2834,臺企銀,1865,381,1484,摩根大通,2024-04-15,8440
2301,光寶科,1805,333,1472,摩根大通,2024-04-15,8440
2603,長榮,2916,1587,1329,摩根大通,2024-04-15,8440
2323,中環,1275,9,1266,摩根大通,2024-04-15,8440
2883,凱基金,2776,1669,1107,摩根大通,2024-04-15,8440
2368,金像電,1093,15,1078,摩根大通,2024-04-15,8440
2809,京城銀,986,7,979,摩根大通,2024-04-15,8440
1102,亞泥,1059,96,963,摩根大通,2024-04-15,8440
8069,元太,1177,245,932,摩根大通,2024-04-15,8440
2886,兆豐金,2972,2041,931,摩根大通,2024-04-15,8440
2504,國產,1159,280,879,摩根大通,2024-04-15,8440
1303,南亞,1106,260,846,摩根大通,2024-04-15,8440
2892,第一金,1628,789,839,摩根大通,2024-04-15,8440
2880,華南金,1525,692,833,摩根大通,2024-04-15,8440
3045,台灣大,854,35,819,摩根大通,2024-04-15,8440
2208,台船,998,184,814,摩根大通,2024-04-15,8440
6415,矽力*-KY,1136,327,809,摩根大通,2024-04-15,8440
1402,遠東新,1026,225,801,摩根大通,2024-04-15,8440
2412,中華電,994,226,768,摩根大通,2024-04-15,8440
9945,潤泰新,868,103,765,摩根大通,2024-04-15,8440
2887,台新金,1048,296,752,摩根大通,2024-04-15,8440
2105,正新,812,117,695,摩根大通,2024-04-15,8440
2801,彰銀,1021,379,642,摩根大通,2024-04-15,8440
2501,國建,1293,666,627,摩根大通,2024-04-15,8440
2845,遠東銀,635,60,575,摩根大通,2024-04-15,8440
2606,裕民,674,146,528,摩根大通,2024-04-15,8440
2609,陽明,689,171,518,摩根大通,2024-04-15,8440
2605,新興,913,425,488,摩根大通,2024-04-15,8440
1409,新纖,513,58,455,摩根大通,2024-04-15,8440
2458,義隆,727,304,423,摩根大通,2024-04-15,8440
1326,台化,535,123,412,摩根大通,2024-04-15,8440
2449,京元電子,638,226,412,摩根大通,2024-04-15,8440
2615,萬海,619,211,408,摩根大通,2024-04-15,8440
3402,漢科,584,179,405,摩根大通,2024-04-15,8440
2382,廣達,1333,952,381,摩根大通,2024-04-15,8440
2915,潤泰全,383,7,376,摩根大通,2024-04-15,8440
2317,鴻海,23855,2799,21056,摩根大通,2024-04-16,8440
2371,大同,12587,4464,8123,摩根大通,2024-04-16,8440
2409,友達,11896,5232,6664,摩根大通,2024-04-16,8440
2002,中鋼,5331,1083,4248,摩根大通,2024-04-16,8440
2367,燿華,4998,853,4145,摩根大通,2024-04-16,8440
2515,中工,3117,414,2703,摩根大通,2024-04-16,8440
6005,群益證,3394,697,2697,摩根大通,2024-04-16,8440
1608,華榮,2989,312,2677,摩根大通,2024-04-16,8440
5876,上海商銀,3018,621,2397,摩根大通,2024-04-16,8440
9904,寶成,3645,1673,1972,摩根大通,2024-04-16,8440
3013,晟銘電,1525,204,1321,摩根大通,2024-04-16,8440
1612,宏泰,1526,225,1301,摩根大通,2024-04-16,8440
5347,世界,1456,225,1231,摩根大通,2024-04-16,8440
4904,遠傳,1767,641,1126,摩根大通,2024-04-16,8440
2885,元大金,3928,2852,1076,摩根大通,2024-04-16,8440
2809,京城銀,1155,236,919,摩根大通,2024-04-16,8440
8112,至上,1210,314,896,摩根大通,2024-04-16,8440
3005,神基,1199,303,896,摩根大通,2024-04-16,8440
1513,中興電,1430,540,890,摩根大通,2024-04-16,8440
2356,英業達,2148,1293,855,摩根大通,2024-04-16,8440
2501,國建,1365,543,822,摩根大通,2024-04-16,8440
6274,台燿,1358,558,800,摩根大通,2024-04-16,8440
3060,銘異,946,147,799,摩根大通,2024-04-16,8440
2368,金像電,925,179,746,摩根大通,2024-04-16,8440
2504,國產,1098,355,743,摩根大通,2024-04-16,8440
2457,飛宏,728,14,714,摩根大通,2024-04-16,8440
5515,建國,854,141,713,摩根大通,2024-04-16,8440
2454,聯發科,1535,840,695,摩根大通,2024-04-16,8440
2606,裕民,928,274,654,摩根大通,2024-04-16,8440
3376,新日興,1017,395,622,摩根大通,2024-04-16,8440
1316,上曜,802,187,615,摩根大通,2024-04-16,8440
2537,聯上發,717,110,607,摩根大通,2024-04-16,8440
3045,台灣大,907,328,579,摩根大通,2024-04-16,8440
2385,群光,1065,492,573,摩根大通,2024-04-16,8440
3706,神達,1018,450,568,摩根大通,2024-04-16,8440
9105,泰金寶-DR,723,206,517,摩根大通,2024-04-16,8440
1618,合機,1355,848,507,摩根大通,2024-04-16,8440
6191,精成科,533,33,500,摩根大通,2024-04-16,8440
2449,京元電子,1248,790,458,摩根大通,2024-04-16,8440
6213,聯茂,670,253,417,摩根大通,2024-04-16,8440
3017,奇鋐,710,300,410,摩根大通,2024-04-16,8440
2834,臺企銀,1265,864,401,摩根大通,2024-04-16,8440
1503,士電,672,300,372,摩根大通,2024-04-16,8440
6177,達麗,404,37,367,摩根大通,2024-04-16,8440
9921,巨大,517,155,362,摩根大通,2024-04-16,8440
1514,亞力,367,5,362,摩根大通,2024-04-16,8440
4714,永捷,431,70,361,摩根大通,2024-04-16,8440
4979,華星光,388,27,361,摩根大通,2024-04-16,8440
2106,建大,514,154,360,摩根大通,2024-04-16,8440
5443,均豪,693,334,359,摩根大通,2024-04-16,8440
2371,大同,25909,4092,21817,摩根大通,2024-04-17,8440
2002,中鋼,5089,1387,3702,摩根大通,2024-04-17,8440
1605,華新,4931,1664,3267,摩根大通,2024-04-17,8440
2367,燿華,3087,122,2965,摩根大通,2024-04-17,8440
2884,玉山金,4288,1762,2526,摩根大通,2024-04-17,8440
9904,寶成,2536,450,2086,摩根大通,2024-04-17,8440
2834,臺企銀,2145,396,1749,摩根大通,2024-04-17,8440
8936,國統,1742,116,1626,摩根大通,2024-04-17,8440
6005,群益證,1658,238,1420,摩根大通,2024-04-17,8440
1785,光洋科,1340,143,1197,摩根大通,2024-04-17,8440
5483,中美晶,1286,122,1164,摩根大通,2024-04-17,8440
6282,康舒,1265,162,1103,摩根大通,2024-04-17,8440
5876,上海商銀,1597,522,1075,摩根大通,2024-04-17,8440
2885,元大金,2755,1693,1062,摩根大通,2024-04-17,8440
4938,和碩,1676,681,995,摩根大通,2024-04-17,8440
6125,廣運,1186,216,970,摩根大通,2024-04-17,8440
1216,統一,1937,977,960,摩根大通,2024-04-17,8440
2303,聯電,2478,1532,946,摩根大通,2024-04-17,8440
1815,富喬,1095,157,938,摩根大通,2024-04-17,8440
2515,中工,1454,659,795,摩根大通,2024-04-17,8440
3045,台灣大,1666,873,793,摩根大通,2024-04-17,8440
2542,興富發,757,2,755,摩根大通,2024-04-17,8440
2206,三陽工業,789,48,741,摩根大通,2024-04-17,8440
8088,品安,693,42,651,摩根大通,2024-04-17,8440
2457,飛宏,649,3,646,摩根大通,2024-04-17,8440
1584,精剛,653,18,635,摩根大通,2024-04-17,8440
8926,台汽電,707,112,595,摩根大通,2024-04-17,8440
2009,第一銅,1266,678,588,摩根大通,2024-04-17,8440
1582,信錦,569,3,566,摩根大通,2024-04-17,8440
1504,東元,1146,602,544,摩根大通,2024-04-17,8440
2539,櫻花建,565,33,532,摩根大通,2024-04-17,8440
2467,志聖,567,65,502,摩根大通,2024-04-17,8440
5388,中磊,507,12,495,摩根大通,2024-04-17,8440
3051,力特,555,74,481,摩根大通,2024-04-17,8440
2027,大成鋼,592,114,478,摩根大通,2024-04-17,8440
8027,鈦昇,486,8,478,摩根大通,2024-04-17,8440
2352,佳世達,822,345,477,摩根大通,2024-04-17,8440
3715,定穎投控,825,351,474,摩根大通,2024-04-17,8440
8473,山林水,474,11,463,摩根大通,2024-04-17,8440
5347,世界,703,242,461,摩根大通,2024-04-17,8440
2886,兆豐金,2415,1958,457,摩根大通,2024-04-17,8440
9938,百和,538,83,455,摩根大通,2024-04-17,8440
9934,成霖,516,66,450,摩根大通,2024-04-17,8440
4532,瑞智,540,91,449,摩根大通,2024-04-17,8440
2528,皇普,476,27,449,摩根大通,2024-04-17,8440
2458,義隆,713,277,436,摩根大通,2024-04-17,8440
2514,龍邦,439,4,435,摩根大通,2024-04-17,8440
2329,華泰,524,90,434,摩根大通,2024-04-17,8440
3059,華晶科,452,25,427,摩根大通,2024-04-17,8440
8390,金益鼎,530,116,414,摩根大通,2024-04-17,8440
9904,寶成,8119,2085,6034,摩根大通,2024-04-18,8440
1314,中石化,4747,442,4305,摩根大通,2024-04-18,8440
2002,中鋼,5127,2061,3066,摩根大通,2024-04-18,8440
1216,統一,3776,1517,2259,摩根大通,2024-04-18,8440
1608,華榮,2817,586,2231,摩根大通,2024-04-18,8440
5515,建國,1977,542,1435,摩根大通,2024-04-18,8440
2834,臺企銀,3123,1795,1328,摩根大通,2024-04-18,8440
3036,文曄,1882,656,1226,摩根大通,2024-04-18,8440
3017,奇鋐,1998,778,1220,摩根大通,2024-04-18,8440
3312,弘憶股,1495,293,1202,摩根大通,2024-04-18,8440
2367,燿華,2829,1663,1166,摩根大通,2024-04-18,8440
2882,國泰金,3768,2608,1160,摩根大通,2024-04-18,8440
1529,樂事綠能,1325,279,1046,摩根大通,2024-04-18,8440
2442,新美齊,1064,24,1040,摩根大通,2024-04-18,8440
2457,飛宏,928,19,909,摩根大通,2024-04-18,8440
2363,矽統,1006,104,902,摩根大通,2024-04-18,8440
3622,洋華,1033,140,893,摩根大通,2024-04-18,8440
2889,國票金,1288,457,831,摩根大通,2024-04-18,8440
2467,志聖,978,159,819,摩根大通,2024-04-18,8440
1609,大亞,1848,1052,796,摩根大通,2024-04-18,8440
5521,工信,996,238,758,摩根大通,2024-04-18,8440
2377,微星,962,257,705,摩根大通,2024-04-18,8440
2897,王道銀行,842,140,702,摩根大通,2024-04-18,8440
2308,台達電,1610,974,636,摩根大通,2024-04-18,8440
2374,佳能,870,240,630,摩根大通,2024-04-18,8440
2520,冠德,933,313,620,摩根大通,2024-04-18,8440
1524,耿鼎,650,44,606,摩根大通,2024-04-18,8440
0050,元大台灣50,588,0,588,摩根大通,2024-04-18,8440
2101,南港,755,172,583,摩根大通,2024-04-18,8440
2465,麗臺,949,383,566,摩根大通,2024-04-18,8440
2006,東和鋼鐵,571,48,523,摩根大通,2024-04-18,8440
6125,廣運,1345,829,516,摩根大通,2024-04-18,8440
8054,安國,593,79,514,摩根大通,2024-04-18,8440
1210,大成,612,103,509,摩根大通,2024-04-18,8440
1409,新纖,658,151,507,摩根大通,2024-04-18,8440
2393,億光,575,113,462,摩根大通,2024-04-18,8440
1722,台肥,660,225,435,摩根大通,2024-04-18,8440
4906,正文,456,64,392,摩根大通,2024-04-18,8440
5519,隆大,436,56,380,摩根大通,2024-04-18,8440
2421,建準,435,65,370,摩根大通,2024-04-18,8440
6274,台燿,482,112,370,摩根大通,2024-04-18,8440
4919,新唐,647,281,366,摩根大通,2024-04-18,8440
8011,台通,432,71,361,摩根大通,2024-04-18,8440
2427,三商電,493,133,360,摩根大通,2024-04-18,8440
2538,基泰,440,86,354,摩根大通,2024-04-18,8440
1808,潤隆,543,194,349,摩根大通,2024-04-18,8440
1514,亞力,377,29,348,摩根大通,2024-04-18,8440
2106,建大,378,43,335,摩根大通,2024-04-18,8440
1217,愛之味,347,14,333,摩根大通,2024-04-18,8440
2704,國賓,462,130,332,摩根大通,2024-04-18,8440
2867,三商壽,4039,879,3160,摩根大通,2024-04-19,8440
3576,聯合再生,3611,1298,2313,摩根大通,2024-04-19,8440
1609,大亞,8599,6375,2224,摩根大通,2024-04-19,8440
1216,統一,4397,2264,2133,摩根大通,2024-04-19,8440
9904,寶成,3273,1477,1796,摩根大通,2024-04-19,8440
2834,臺企銀,5304,3514,1790,摩根大通,2024-04-19,8440
2363,矽統,1673,3,1670,摩根大通,2024-04-19,8440
2603,長榮,3308,1674,1634,摩根大通,2024-04-19,8440
6770,力積電,3265,1641,1624,摩根大通,2024-04-19,8440
1618,合機,1784,309,1475,摩根大通,2024-04-19,8440
5521,工信,2451,1008,1443,摩根大通,2024-04-19,8440
2520,冠德,1964,894,1070,摩根大通,2024-04-19,8440
2609,陽明,3256,2254,1002,摩根大通,2024-04-19,8440
5515,建國,1565,580,985,摩根大通,2024-04-19,8440
2374,佳能,1277,318,959,摩根大通,2024-04-19,8440
1513,中興電,1882,1073,809,摩根大通,2024-04-19,8440
5443,均豪,1122,394,728,摩根大通,2024-04-19,8440
5483,中美晶,847,130,717,摩根大通,2024-04-19,8440
2637,慧洋-KY,1180,471,709,摩根大通,2024-04-19,8440
6125,廣運,1659,994,665,摩根大通,2024-04-19,8440
1722,台肥,1117,465,652,摩根大通,2024-04-19,8440
3294,英濟,644,21,623,摩根大通,2024-04-19,8440
1409,新纖,797,197,600,摩根大通,2024-04-19,8440
2002,中鋼,5738,5146,592,摩根大通,2024-04-19,8440
3450,聯鈞,736,144,592,摩根大通,2024-04-19,8440
1442,名軒,644,57,587,摩根大通,2024-04-19,8440
5371,中光電,1033,447,586,摩根大通,2024-04-19,8440
6244,茂迪,1101,558,543,摩根大通,2024-04-19,8440
3605,宏致,670,146,524,摩根大通,2024-04-19,8440
1314,中石化,1633,1110,523,摩根大通,2024-04-19,8440
6143,振曜,897,379,518,摩根大通,2024-04-19,8440
1616,億泰,837,338,499,摩根大通,2024-04-19,8440
2543,皇昌,1137,677,460,摩根大通,2024-04-19,8440
6147,頎邦,817,362,455,摩根大通,2024-04-19,8440
6274,台燿,689,246,443,摩根大通,2024-04-19,8440
2383,台光電,1035,599,436,摩根大通,2024-04-19,8440
9105,泰金寶-DR,463,69,394,摩根大通,2024-04-19,8440
8054,安國,847,463,384,摩根大通,2024-04-19,8440
2464,盟立,454,82,372,摩根大通,2024-04-19,8440
8046,南電,495,128,367,摩根大通,2024-04-19,8440
5009,榮剛,525,161,364,摩根大通,2024-04-19,8440
1514,亞力,399,45,354,摩根大通,2024-04-19,8440
2006,東和鋼鐵,565,234,331,摩根大通,2024-04-19,8440
3287,廣寰科,571,246,325,摩根大通,2024-04-19,8440
9933,中鼎,475,176,299,摩根大通,2024-04-19,8440
8210,勤誠,442,149,293,摩根大通,2024-04-19,8440
2009,第一銅,957,664,293,摩根大通,2024-04-19,8440
1503,士電,2410,2121,289,摩根大通,2024-04-19,8440
4714,永捷,377,95,282,摩根大通,2024-04-19,8440
5608,四維航,560,283,277,摩根大通,2024-04-19,8440
2618,長榮航,13964,2043,11921,摩根大通,2024-04-22,8440
2886,兆豐金,6619,129,6490,摩根大通,2024-04-22,8440
2891,中信金,7954,1614,6340,摩根大通,2024-04-22,8440
2884,玉山金,6279,322,5957,摩根大通,2024-04-22,8440
2883,凱基金,5147,109,5038,摩根大通,2024-04-22,8440
2888,新光金,5258,424,4834,摩根大通,2024-04-22,8440
3481,群創,5281,516,4765,摩根大通,2024-04-22,8440
2834,臺企銀,4752,166,4586,摩根大通,2024-04-22,8440
5880,合庫金,3307,173,3134,摩根大通,2024-04-22,8440
2301,光寶科,3751,673,3078,摩根大通,2024-04-22,8440
1216,統一,3161,91,3070,摩根大通,2024-04-22,8440
1314,中石化,3015,474,2541,摩根大通,2024-04-22,8440
2880,華南金,2732,308,2424,摩根大通,2024-04-22,8440
2002,中鋼,4335,1944,2391,摩根大通,2024-04-22,8440
2890,永豐金,3372,983,2389,摩根大通,2024-04-22,8440
1303,南亞,2367,145,2222,摩根大通,2024-04-22,8440
2317,鴻海,3148,953,2195,摩根大通,2024-04-22,8440
1102,亞泥,2221,49,2172,摩根大通,2024-04-22,8440
2882,國泰金,2293,239,2054,摩根大通,2024-04-22,8440
2887,台新金,2118,118,2000,摩根大通,2024-04-22,8440
2889,國票金,1931,0,1931,摩根大通,2024-04-22,8440
2801,彰銀,1967,154,1813,摩根大通,2024-04-22,8440
2603,長榮,2801,1000,1801,摩根大通,2024-04-22,8440
2353,宏��,1973,288,1685,摩根大通,2024-04-22,8440
1301,台塑,1628,55,1573,摩根大通,2024-04-22,8440
2610,華航,1599,66,1533,摩根大通,2024-04-22,8440
1326,台化,1538,61,1477,摩根大通,2024-04-22,8440
2324,仁寶,1506,212,1294,摩根大通,2024-04-22,8440
2892,第一金,1525,257,1268,摩根大通,2024-04-22,8440
2371,大同,6906,5661,1245,摩根大通,2024-04-22,8440
2543,皇昌,1680,543,1137,摩根大通,2024-04-22,8440
2881,富邦金,2087,985,1102,摩根大通,2024-04-22,8440
1101,台泥,1605,528,1077,摩根大通,2024-04-22,8440
1722,台肥,1089,78,1011,摩根大通,2024-04-22,8440
1605,華新,1321,324,997,摩根大通,2024-04-22,8440
2867,三商壽,3424,2465,959,摩根大通,2024-04-22,8440
1402,遠東新,1081,141,940,摩根大通,2024-04-22,8440
3006,晶豪科,915,10,905,摩根大通,2024-04-22,8440
6505,台塑化,934,46,888,摩根大通,2024-04-22,8440
2845,遠東銀,996,178,818,摩根大通,2024-04-22,8440
5871,中租-KY,815,1,814,摩根大通,2024-04-22,8440
1905,華紙,1048,248,800,摩根大通,2024-04-22,8440
1503,士電,1436,652,784,摩根大通,2024-04-22,8440
1210,大成,787,5,782,摩根大通,2024-04-22,8440
5534,長虹,907,148,759,摩根大通,2024-04-22,8440
6147,頎邦,1344,586,758,摩根大通,2024-04-22,8440
2474,可成,766,16,750,摩根大通,2024-04-22,8440
2376,技嘉,949,205,744,摩根大通,2024-04-22,8440
3703,欣陸,771,60,711,摩根大通,2024-04-22,8440
2520,冠德,1344,635,709,摩根大通,2024-04-22,8440
2618,長榮航,15292,1477,13815,摩根大通,2024-04-23,8440
2834,臺企銀,6351,655,5696,摩根大通,2024-04-23,8440
1609,大亞,5904,1022,4882,摩根大通,2024-04-23,8440
2409,友達,6567,1905,4662,摩根大通,2024-04-23,8440
3481,群創,5553,1182,4371,摩根大通,2024-04-23,8440
2886,兆豐金,5586,1390,4196,摩根大通,2024-04-23,8440
2371,大同,5989,3624,2365,摩根大通,2024-04-23,8440
2891,中信金,5215,2857,2358,摩根大通,2024-04-23,8440
2884,玉山金,3943,1658,2285,摩根大通,2024-04-23,8440
2889,國票金,2288,86,2202,摩根大通,2024-04-23,8440
1618,合機,2896,800,2096,摩根大通,2024-04-23,8440
9945,潤泰新,1792,68,1724,摩根大通,2024-04-23,8440
2354,鴻準,1952,319,1633,摩根大通,2024-04-23,8440
2330,台積電,3124,1491,1633,摩根大通,2024-04-23,8440
2888,新光金,1757,251,1506,摩根大通,2024-04-23,8440
2206,三陽工業,2569,1085,1484,摩根大通,2024-04-23,8440
1102,亞泥,1580,171,1409,摩根大通,2024-04-23,8440
5880,合庫金,2014,784,1230,摩根大通,2024-04-23,8440
2101,南港,1548,417,1131,摩根大通,2024-04-23,8440
2615,萬海,1243,117,1126,摩根大通,2024-04-23,8440
2027,大成鋼,1100,139,961,摩根大通,2024-04-23,8440
2812,台中銀,989,62,927,摩根大通,2024-04-23,8440
2603,長榮,1496,669,827,摩根大通,2024-04-23,8440
3037,欣興,883,83,800,摩根大通,2024-04-23,8440
2887,台新金,1170,386,784,摩根大通,2024-04-23,8440
1216,統一,1007,230,777,摩根大通,2024-04-23,8440
2885,元大金,7429,6658,771,摩根大通,2024-04-23,8440
1808,潤隆,1122,356,766,摩根大通,2024-04-23,8440
2634,漢翔,1092,329,763,摩根大通,2024-04-23,8440
1210,大成,810,64,746,摩根大通,2024-04-23,8440
2363,矽統,917,178,739,摩根大通,2024-04-23,8440
2301,光寶科,1488,774,714,摩根大通,2024-04-23,8440
6147,頎邦,954,276,678,摩根大通,2024-04-23,8440
2542,興富發,858,181,677,摩根大通,2024-04-23,8440
2009,第一銅,1042,378,664,摩根大通,2024-04-23,8440
2006,東和鋼鐵,662,9,653,摩根大通,2024-04-23,8440
4909,新復興,760,118,642,摩根大通,2024-04-23,8440
2605,新興,737,114,623,摩根大通,2024-04-23,8440
5512,力麒,947,340,607,摩根大通,2024-04-23,8440
2903,遠百,722,134,588,摩根大通,2024-04-23,8440
5483,中美晶,635,48,587,摩根大通,2024-04-23,8440
1303,南亞,1078,498,580,摩根大通,2024-04-23,8440
2880,華南金,751,178,573,摩根大通,2024-04-23,8440
6120,達運,907,336,571,摩根大通,2024-04-23,8440
6125,廣運,792,233,559,摩根大通,2024-04-23,8440
5871,中租-KY,882,350,532,摩根大通,2024-04-23,8440
2324,仁寶,1277,759,518,摩根大通,2024-04-23,8440
2449,京元電子,896,389,507,摩根大通,2024-04-23,8440
1905,華紙,716,243,473,摩根大通,2024-04-23,8440
3034,聯詠,589,143,446,摩根大通,2024-04-23,8440
2618,長榮航,31591,1968,29623,摩根大通,2024-04-24,8440
2371,大同,12829,2710,10119,摩根大通,2024-04-24,8440
2603,長榮,7010,406,6604,摩根大通,2024-04-24,8440
2303,聯電,8632,2325,6307,摩根大通,2024-04-24,8440
2891,中信金,9210,3090,6120,摩根大通,2024-04-24,8440
2610,華航,4291,452,3839,摩根大通,2024-04-24,8440
2330,台積電,5549,1996,3553,摩根大通,2024-04-24,8440
2002,中鋼,3613,730,2883,摩根大通,2024-04-24,8440
2301,光寶科,3179,385,2794,摩根大通,2024-04-24,8440
3715,定穎投控,2970,280,2690,摩根大通,2024-04-24,8440
2884,玉山金,3849,1721,2128,摩根大通,2024-04-24,8440
2354,鴻準,2993,1350,1643,摩根大通,2024-04-24,8440
2890,永豐金,3772,2167,1605,摩根大通,2024-04-24,8440
8110,華東,1650,56,1594,摩根大通,2024-04-24,8440
1102,亞泥,1802,226,1576,摩根大通,2024-04-24,8440
5880,合庫金,2120,593,1527,摩根大通,2024-04-24,8440
2353,宏��,1761,274,1487,摩根大通,2024-04-24,8440
2883,凱基金,3115,1693,1422,摩根大通,2024-04-24,8440
1808,潤隆,1645,224,1421,摩根大通,2024-04-24,8440
5521,工信,1513,266,1247,摩根大通,2024-04-24,8440
2101,南港,1650,407,1243,摩根大通,2024-04-24,8440
3037,欣興,1373,169,1204,摩根大通,2024-04-24,8440
2324,仁寶,2370,1179,1191,摩根大通,2024-04-24,8440
8064,東捷,1183,0,1183,摩根大通,2024-04-24,8440
2356,英業達,1654,521,1133,摩根大通,2024-04-24,8440
1455,集盛,1227,112,1115,摩根大通,2024-04-24,8440
3033,威健,1149,52,1097,摩根大通,2024-04-24,8440
1303,南亞,1145,66,1079,摩根大通,2024-04-24,8440
2887,台新金,1795,734,1061,摩根大通,2024-04-24,8440
6274,台燿,1226,169,1057,摩根大通,2024-04-24,8440
3711,日月光投控,1665,614,1051,摩根大通,2024-04-24,8440
1101,台泥,1126,99,1027,摩根大通,2024-04-24,8440
1609,大亞,2650,1645,1005,摩根大通,2024-04-24,8440
2888,新光金,1631,638,993,摩根大通,2024-04-24,8440
4938,和碩,941,19,922,摩根大通,2024-04-24,8440
2867,三商壽,1103,187,916,摩根大通,2024-04-24,8440
1440,南紡,1311,405,906,摩根大通,2024-04-24,8440
8210,勤誠,990,121,869,摩根大通,2024-04-24,8440
6282,康舒,861,48,813,摩根大通,2024-04-24,8440
6147,頎邦,1108,317,791,摩根大通,2024-04-24,8440
2363,矽統,812,30,782,摩根大通,2024-04-24,8440
2362,藍天,895,127,768,摩根大通,2024-04-24,8440
6120,達運,874,136,738,摩根大通,2024-04-24,8440
1301,台塑,897,162,735,摩根大通,2024-04-24,8440
8054,安國,854,165,689,摩根大通,2024-04-24,8440
3013,晟銘電,771,101,670,摩根大通,2024-04-24,8440
2515,中工,3728,3066,662,摩根大通,2024-04-24,8440
2331,精英,697,43,654,摩根大通,2024-04-24,8440
8112,至上,762,114,648,摩根大通,2024-04-24,8440
5511,德昌,648,26,622,摩根大通,2024-04-24,8440
3037,欣興,5818,1065,4753,摩根大通,2024-04-25,8440
2303,聯電,4705,2035,2670,摩根大通,2024-04-25,8440
2323,中環,1355,109,1246,摩根大通,2024-04-25,8440
2834,臺企銀,1668,462,1206,摩根大通,2024-04-25,8440
2867,三商壽,1245,69,1176,摩根大通,2024-04-25,8440
2301,光寶科,1427,259,1168,摩根大通,2024-04-25,8440
2002,中鋼,1829,936,893,摩根大通,2024-04-25,8440
5009,榮剛,871,17,854,摩根大通,2024-04-25,8440
2354,鴻準,916,85,831,摩根大通,2024-04-25,8440
2363,矽統,818,0,818,摩根大通,2024-04-25,8440
5880,合庫金,1244,470,774,摩根大通,2024-04-25,8440
2313,華通,798,41,757,摩根大通,2024-04-25,8440
2101,南港,1179,445,734,摩根大通,2024-04-25,8440
4904,遠傳,1029,335,694,摩根大通,2024-04-25,8440
1314,中石化,867,174,693,摩根大通,2024-04-25,8440
1722,台肥,740,61,679,摩根大通,2024-04-25,8440
6176,瑞儀,758,88,670,摩根大通,2024-04-25,8440
2884,玉山金,2448,1835,613,摩根大通,2024-04-25,8440
2888,新光金,1969,1359,610,摩根大通,2024-04-25,8440
1560,中砂,663,69,594,摩根大通,2024-04-25,8440
3491,昇達科,688,131,557,摩根大通,2024-04-25,8440
6548,長科*,734,178,556,摩根大通,2024-04-25,8440
2458,義隆,588,43,545,摩根大通,2024-04-25,8440
6415,矽力*-KY,736,206,530,摩根大通,2024-04-25,8440
2903,遠百,538,12,526,摩根大通,2024-04-25,8440
6005,群益證,1407,886,521,摩根大通,2024-04-25,8440
2542,興富發,614,95,519,摩根大通,2024-04-25,8440
1609,大亞,2047,1537,510,摩根大通,2024-04-25,8440
1503,士電,668,165,503,摩根大通,2024-04-25,8440
6147,頎邦,662,167,495,摩根大通,2024-04-25,8440
6768,志強-KY,518,33,485,摩根大通,2024-04-25,8440
3481,群創,1942,1457,485,摩根大通,2024-04-25,8440
1409,新纖,490,14,476,摩根大通,2024-04-25,8440
2352,佳世達,653,193,460,摩根大通,2024-04-25,8440
1102,亞泥,588,142,446,摩根大通,2024-04-25,8440
3059,華晶科,474,32,442,摩根大通,2024-04-25,8440
2851,中再保,484,43,441,摩根大通,2024-04-25,8440
2515,中工,2873,2452,421,摩根大通,2024-04-25,8440
3338,泰碩,786,375,411,摩根大通,2024-04-25,8440
8464,億豐,413,19,394,摩根大通,2024-04-25,8440
2474,可成,439,49,390,摩根大通,2024-04-25,8440
1608,華榮,734,359,375,摩根大通,2024-04-25,8440
4909,新復興,564,195,369,摩根大通,2024-04-25,8440
2548,華固,431,82,349,摩根大通,2024-04-25,8440
1316,上曜,555,208,347,摩根大通,2024-04-25,8440
1605,華新,654,309,345,摩根大通,2024-04-25,8440
2006,東和鋼鐵,392,58,334,摩根大通,2024-04-25,8440
2105,正新,591,259,332,摩根大通,2024-04-25,8440
6269,台郡,347,24,323,摩根大通,2024-04-25,8440
5234,達興材料,402,80,322,摩根大通,2024-04-25,8440
2618,長榮航,19536,2324,17212,摩根大通,2024-04-26,8440
2409,友達,14403,1313,13090,摩根大通,2024-04-26,8440
2303,聯電,6897,942,5955,摩根大通,2024-04-26,8440
2609,陽明,7234,1578,5656,摩根大通,2024-04-26,8440
2323,中環,6213,911,5302,摩根大通,2024-04-26,8440
2610,華航,5300,73,5227,摩根大通,2024-04-26,8440
2344,華邦電,5472,618,4854,摩根大通,2024-04-26,8440
2603,長榮,5643,1218,4425,摩根大通,2024-04-26,8440
2330,台積電,4604,931,3673,摩根大通,2024-04-26,8440
1314,中石化,3597,116,3481,摩根大通,2024-04-26,8440
3481,群創,3664,904,2760,摩根大通,2024-04-26,8440
2501,國建,3456,920,2536,摩根大通,2024-04-26,8440
2317,鴻海,5478,3103,2375,摩根大通,2024-04-26,8440
2888,新光金,2849,1000,1849,摩根大通,2024-04-26,8440
2884,玉山金,2327,691,1636,摩根大通,2024-04-26,8440
2486,一詮,2338,763,1575,摩根大通,2024-04-26,8440
2301,光寶科,2051,666,1385,摩根大通,2024-04-26,8440
6005,群益證,2205,846,1359,摩根大通,2024-04-26,8440
1301,台塑,1333,117,1216,摩根大通,2024-04-26,8440
2354,鴻準,1503,309,1194,摩根大通,2024-04-26,8440
2515,中工,4772,3683,1089,摩根大通,2024-04-26,8440
2882,國泰金,1440,391,1049,摩根大通,2024-04-26,8440
2356,英業達,1373,340,1033,摩根大通,2024-04-26,8440
1609,大亞,1553,568,985,摩根大通,2024-04-26,8440
2834,臺企銀,1553,585,968,摩根大通,2024-04-26,8440
2605,新興,1003,102,901,摩根大通,2024-04-26,8440
2615,萬海,1607,767,840,摩根大通,2024-04-26,8440
2511,太子,901,85,816,摩根大通,2024-04-26,8440
4532,瑞智,924,123,801,摩根大通,2024-04-26,8440
2867,三商壽,867,69,798,摩根大通,2024-04-26,8440
1101,台泥,947,156,791,摩根大通,2024-04-26,8440
8110,華東,798,23,775,摩根大通,2024-04-26,8440
2548,華固,760,33,727,摩根大通,2024-04-26,8440
2537,聯上發,748,34,714,摩根大通,2024-04-26,8440
4938,和碩,950,258,692,摩根大通,2024-04-26,8440
3703,欣陸,1333,651,682,摩根大通,2024-04-26,8440
5521,工信,813,134,679,摩根大通,2024-04-26,8440
1102,亞泥,1177,499,678,摩根大通,2024-04-26,8440
2889,國票金,734,74,660,摩根大通,2024-04-26,8440
2352,佳世達,737,129,608,摩根大通,2024-04-26,8440
3715,定穎投控,677,79,598,摩根大通,2024-04-26,8440
2353,宏��,1148,614,534,摩根大通,2024-04-26,8440
2308,台達電,870,338,532,摩根大通,2024-04-26,8440
6415,矽力*-KY,823,308,515,摩根大通,2024-04-26,8440
3035,智原,1022,510,512,摩根大通,2024-04-26,8440
2337,旺宏,595,122,473,摩根大通,2024-04-26,8440
2241,艾姆勒,600,132,468,摩根大通,2024-04-26,8440
3708,上緯投控,492,30,462,摩根大通,2024-04-26,8440
3702,大聯大,647,189,458,摩根大通,2024-04-26,8440
2363,矽統,483,30,453,摩根大通,2024-04-26,8440
2891,中信金,14703,5036,9667,摩根大通,2024-04-29,8440
2888,新光金,8864,1469,7395,摩根大通,2024-04-29,8440
2882,國泰金,5746,28,5718,摩根大通,2024-04-29,8440
2884,玉山金,5943,248,5695,摩根大通,2024-04-29,8440
2303,聯電,5475,44,5431,摩根大通,2024-04-29,8440
2883,凱基金,7587,2199,5388,摩根大通,2024-04-29,8440
2834,臺企銀,5028,25,5003,摩根大通,2024-04-29,8440
2317,鴻海,8051,4152,3899,摩根大通,2024-04-29,8440
2890,永豐金,4317,495,3822,摩根大通,2024-04-29,8440
2885,元大金,4545,780,3765,摩根大通,2024-04-29,8440
2002,中鋼,4005,378,3627,摩根大通,2024-04-29,8440
3481,群創,3895,429,3466,摩根大通,2024-04-29,8440
6005,群益證,3291,178,3113,摩根大通,2024-04-29,8440
1101,台泥,3003,290,2713,摩根大通,2024-04-29,8440
3231,緯創,2968,287,2681,摩根大通,2024-04-29,8440
2409,友達,4680,2011,2669,摩根大通,2024-04-29,8440
2889,國票金,3603,1202,2401,摩根大通,2024-04-29,8440
1314,中石化,5112,2757,2355,摩根大通,2024-04-29,8440
2353,宏��,2496,269,2227,摩根大通,2024-04-29,8440
2324,仁寶,2437,236,2201,摩根大通,2024-04-29,8440
2880,華南金,3766,1883,1883,摩根大通,2024-04-29,8440
2344,華邦電,1983,200,1783,摩根大通,2024-04-29,8440
5347,世界,2463,768,1695,摩根大通,2024-04-29,8440
5880,合庫金,3763,2222,1541,摩根大通,2024-04-29,8440
1102,亞泥,2168,627,1541,摩根大通,2024-04-29,8440
5871,中租-KY,1591,86,1505,摩根大通,2024-04-29,8440
1905,華紙,1676,180,1496,摩根大通,2024-04-29,8440
1326,台化,1487,26,1461,摩根大通,2024-04-29,8440
2301,光寶科,1694,367,1327,摩根大通,2024-04-29,8440
2801,彰銀,1363,70,1293,摩根大通,2024-04-29,8440
1303,南亞,1485,195,1290,摩根大通,2024-04-29,8440
2615,萬海,1630,413,1217,摩根大通,2024-04-29,8440
1402,遠東新,1331,193,1138,摩根大通,2024-04-29,8440
2867,三商壽,1191,60,1131,摩根大通,2024-04-29,8440
4960,誠美材,1138,17,1121,摩根大通,2024-04-29,8440
2458,義隆,1126,27,1099,摩根大通,2024-04-29,8440
1815,富喬,1093,19,1074,摩根大通,2024-04-29,8440
2892,第一金,1809,739,1070,摩根大通,2024-04-29,8440
9945,潤泰新,1184,141,1043,摩根大通,2024-04-29,8440
2379,瑞昱,1371,400,971,摩根大通,2024-04-29,8440
2845,遠東銀,1402,469,933,摩根大通,2024-04-29,8440
3711,日月光投控,2206,1292,914,摩根大通,2024-04-29,8440
2356,英業達,989,79,910,摩根大通,2024-04-29,8440
5876,上海商銀,1699,816,883,摩根大通,2024-04-29,8440
2382,廣達,984,122,862,摩根大通,2024-04-29,8440
2354,鴻準,1342,482,860,摩根大通,2024-04-29,8440
1409,新纖,841,26,815,摩根大通,2024-04-29,8440
6290,良維,809,8,801,摩根大通,2024-04-29,8440
2329,華泰,851,103,748,摩根大通,2024-04-29,8440
2881,富邦金,2484,1736,748,摩根大通,2024-04-29,8440
2303,聯電,7032,707,6325,摩根大通,2024-04-30,8440
3481,群創,5655,1156,4499,摩根大通,2024-04-30,8440
2330,台積電,6605,2520,4085,摩根大通,2024-04-30,8440
2409,友達,5215,1391,3824,摩根大通,2024-04-30,8440
2317,鴻海,4693,1818,2875,摩根大通,2024-04-30,8440
2609,陽明,3539,1411,2128,摩根大通,2024-04-30,8440
5880,合庫金,2623,664,1959,摩根大通,2024-04-30,8440
2344,華邦電,2119,245,1874,摩根大通,2024-04-30,8440
2101,南港,1894,184,1710,摩根大通,2024-04-30,8440
1102,亞泥,1976,289,1687,摩根大通,2024-04-30,8440
4938,和碩,1128,59,1069,摩根大通,2024-04-30,8440
2883,凱基金,2830,1826,1004,摩根大通,2024-04-30,8440
4904,遠傳,1176,179,997,摩根大通,2024-04-30,8440
2887,台新金,1230,234,996,摩根大通,2024-04-30,8440
1608,華榮,934,98,836,摩根大通,2024-04-30,8440
5347,世界,1715,889,826,摩根大通,2024-04-30,8440
2002,中鋼,1937,1137,800,摩根大通,2024-04-30,8440
1503,士電,1296,531,765,摩根大通,2024-04-30,8440
2890,永豐金,1457,738,719,摩根大通,2024-04-30,8440
3017,奇鋐,1115,406,709,摩根大通,2024-04-30,8440
2382,廣達,1139,435,704,摩根大通,2024-04-30,8440
6191,精成科,707,18,689,摩根大通,2024-04-30,8440
2834,臺企銀,1273,590,683,摩根大通,2024-04-30,8440
2301,光寶科,1064,386,678,摩根大通,2024-04-30,8440
1303,南亞,748,77,671,摩根大通,2024-04-30,8440
1618,合機,1049,432,617,摩根大通,2024-04-30,8440
5871,中租-KY,752,184,568,摩根大通,2024-04-30,8440
6290,良維,546,15,531,摩根大通,2024-04-30,8440
2801,彰銀,698,178,520,摩根大通,2024-04-30,8440
3034,聯詠,588,79,509,摩根大通,2024-04-30,8440
2376,技嘉,514,13,501,摩根大通,2024-04-30,8440
4960,誠美材,673,181,492,摩根大通,2024-04-30,8440
8070,長華*,511,31,480,摩根大通,2024-04-30,8440
1712,興農,529,49,480,摩根大通,2024-04-30,8440
1440,南紡,596,128,468,摩根大通,2024-04-30,8440
2354,鴻準,873,423,450,摩根大通,2024-04-30,8440
2611,志信,1224,803,421,摩根大通,2024-04-30,8440
2897,王道銀行,546,128,418,摩根大通,2024-04-30,8440
3702,大聯大,473,66,407,摩根大通,2024-04-30,8440
8112,至上,468,67,401,摩根大通,2024-04-30,8440
2615,萬海,680,282,398,摩根大通,2024-04-30,8440
2867,三商壽,768,390,378,摩根大通,2024-04-30,8440
2474,可成,492,115,377,摩根大通,2024-04-30,8440
2379,瑞昱,497,121,376,摩根大通,2024-04-30,8440
6442,光聖,428,54,374,摩根大通,2024-04-30,8440
2809,京城銀,366,11,355,摩根大通,2024-04-30,8440
2308,台達電,834,499,335,摩根大通,2024-04-30,8440
6257,矽格,337,8,329,摩根大通,2024-04-30,8440
3234,光環,564,240,324,摩根大通,2024-04-30,8440
2903,遠百,444,121,323,摩根大通,2024-04-30,8440
5347,世界,8425,836,7589,摩根大通,2024-05-02,8440
2880,華南金,8237,1396,6841,摩根大通,2024-05-02,8440
5880,合庫金,5484,192,5292,摩根大通,2024-05-02,8440
1314,中石化,5996,1978,4018,摩根大通,2024-05-02,8440
2834,臺企銀,3580,413,3167,摩根大通,2024-05-02,8440
2890,永豐金,3541,684,2857,摩根大通,2024-05-02,8440
1504,東元,3533,1101,2432,摩根大通,2024-05-02,8440
2303,聯電,2909,640,2269,摩根大通,2024-05-02,8440
2408,南亞科,2736,468,2268,摩根大通,2024-05-02,8440
1102,亞泥,2570,419,2151,摩根大通,2024-05-02,8440
1216,統一,2175,121,2054,摩根大通,2024-05-02,8440
2881,富邦金,2660,988,1672,摩根大通,2024-05-02,8440
5521,工信,2055,404,1651,摩根大通,2024-05-02,8440
5009,榮剛,1892,285,1607,摩根大通,2024-05-02,8440
2889,國票金,2104,499,1605,摩根大通,2024-05-02,8440
6005,群益證,2108,512,1596,摩根大通,2024-05-02,8440
2353,宏��,2124,587,1537,摩根大通,2024-05-02,8440
2301,光寶科,1880,379,1501,摩根大通,2024-05-02,8440
2002,中鋼,2532,1069,1463,摩根大通,2024-05-02,8440
9945,潤泰新,2134,701,1433,摩根大通,2024-05-02,8440
1303,南亞,1544,182,1362,摩根大通,2024-05-02,8440
2609,陽明,3166,1870,1296,摩根大通,2024-05-02,8440
2363,矽統,2295,1039,1256,摩根大通,2024-05-02,8440
4904,遠傳,1343,121,1222,摩根大通,2024-05-02,8440
2903,遠百,1217,0,1217,摩根大通,2024-05-02,8440
2324,仁寶,2597,1437,1160,摩根大通,2024-05-02,8440
2867,三商壽,1071,26,1045,摩根大通,2024-05-02,8440
2809,京城銀,1204,289,915,摩根大通,2024-05-02,8440
2454,聯發科,1161,260,901,摩根大通,2024-05-02,8440
5871,中租-KY,1014,119,895,摩根大通,2024-05-02,8440
8069,元太,1050,157,893,摩根大通,2024-05-02,8440
6257,矽格,850,33,817,摩根大通,2024-05-02,8440
2897,王道銀行,809,87,722,摩根大通,2024-05-02,8440
3013,晟銘電,944,231,713,摩根大通,2024-05-02,8440
6191,精成科,728,46,682,摩根大通,2024-05-02,8440
2027,大成鋼,1070,410,660,摩根大通,2024-05-02,8440
2892,第一金,1365,727,638,摩根大通,2024-05-02,8440
2610,華航,1181,558,623,摩根大通,2024-05-02,8440
2511,太子,658,54,604,摩根大通,2024-05-02,8440
2913,農林,987,395,592,摩根大通,2024-05-02,8440
8996,高力,974,387,587,摩根大通,2024-05-02,8440
2547,日勝生,697,113,584,摩根大通,2024-05-02,8440
1409,新纖,568,33,535,摩根大通,2024-05-02,8440
6269,台郡,523,16,507,摩根大通,2024-05-02,8440
2633,台灣高鐵,669,170,499,摩根大通,2024-05-02,8440
2354,鴻準,584,90,494,摩根大通,2024-05-02,8440
2206,三陽工業,747,279,468,摩根大通,2024-05-02,8440
2641,正德,487,25,462,摩根大通,2024-05-02,8440
1718,中纖,431,0,431,摩根大通,2024-05-02,8440
4306,炎洲,547,136,411,摩根大通,2024-05-02,8440
2618,長榮航,15360,9660,5700,摩根大通,2024-05-03,8440
2888,新光金,4721,0,4721,摩根大通,2024-05-03,8440
2887,台新金,6000,1829,4171,摩根大通,2024-05-03,8440
1314,中石化,5295,1149,4146,摩根大通,2024-05-03,8440
2371,大同,5506,1950,3556,摩根大通,2024-05-03,8440
2890,永豐金,3574,208,3366,摩根大通,2024-05-03,8440
2317,鴻海,3575,392,3183,摩根大通,2024-05-03,8440
1216,統一,2933,39,2894,摩根大通,2024-05-03,8440
2303,聯電,3073,232,2841,摩根大通,2024-05-03,8440
2002,中鋼,2774,31,2743,摩根大通,2024-05-03,8440
2363,矽統,3470,740,2730,摩根大通,2024-05-03,8440
2353,宏��,3117,395,2722,摩根大通,2024-05-03,8440
2330,台積電,3331,627,2704,摩根大通,2024-05-03,8440
2880,華南金,4414,1744,2670,摩根大通,2024-05-03,8440
2889,國票金,2793,179,2614,摩根大通,2024-05-03,8440
1102,亞泥,2593,6,2587,摩根大通,2024-05-03,8440
2308,台達電,2873,440,2433,摩根大通,2024-05-03,8440
2408,南亞科,2742,331,2411,摩根大通,2024-05-03,8440
5880,合庫金,2568,393,2175,摩根大通,2024-05-03,8440
9945,潤泰新,3068,947,2121,摩根大通,2024-05-03,8440
2801,彰銀,2410,289,2121,摩根大通,2024-05-03,8440
2886,兆豐金,2485,556,1929,摩根大通,2024-05-03,8440
2834,臺企銀,2457,618,1839,摩根大通,2024-05-03,8440
2884,玉山金,2316,744,1572,摩根大通,2024-05-03,8440
2313,華通,1574,41,1533,摩根大通,2024-05-03,8440
2883,凱基金,1975,532,1443,摩根大通,2024-05-03,8440
2609,陽明,2495,1059,1436,摩根大通,2024-05-03,8440
6177,達麗,1482,52,1430,摩根大通,2024-05-03,8440
0050,元大台灣50,1412,0,1412,摩根大通,2024-05-03,8440
2301,光寶科,2573,1199,1374,摩根大通,2024-05-03,8440
2885,元大金,1992,681,1311,摩根大通,2024-05-03,8440
1504,東元,2171,885,1286,摩根大通,2024-05-03,8440
2454,聯發科,1585,519,1066,摩根大通,2024-05-03,8440
4904,遠傳,1229,240,989,摩根大通,2024-05-03,8440
5522,遠雄,1149,212,937,摩根大通,2024-05-03,8440
1303,南亞,1031,115,916,摩根大通,2024-05-03,8440
5871,中租-KY,1010,109,901,摩根大通,2024-05-03,8440
2354,鴻準,911,45,866,摩根大通,2024-05-03,8440
1326,台化,858,5,853,摩根大通,2024-05-03,8440
6005,群益證,984,143,841,摩根大通,2024-05-03,8440
2809,京城銀,952,117,835,摩根大通,2024-05-03,8440
2027,大成鋼,827,7,820,摩根大通,2024-05-03,8440
2105,正新,823,7,816,摩根大通,2024-05-03,8440
5512,力麒,1522,729,793,摩根大通,2024-05-03,8440
2337,旺宏,834,71,763,摩根大通,2024-05-03,8440
2547,日勝生,902,152,750,摩根大通,2024-05-03,8440
4938,和碩,1117,470,647,摩根大通,2024-05-03,8440
2392,正崴,1134,491,643,摩根大通,2024-05-03,8440
3714,富采,658,34,624,摩根大通,2024-05-03,8440
5009,榮剛,841,231,610,摩根大通,2024-05-03,8440
2880,華南金,17427,202,17225,摩根大通,2024-05-06,8440
2884,玉山金,7597,66,7531,摩根大通,2024-05-06,8440
2317,鴻海,8931,2862,6069,摩根大通,2024-05-06,8440
2353,宏��,6019,428,5591,摩根大通,2024-05-06,8440
2888,新光金,8248,4094,4154,摩根大通,2024-05-06,8440
2889,國票金,3665,294,3371,摩根大通,2024-05-06,8440
1102,亞泥,2753,49,2704,摩根大通,2024-05-06,8440
5880,合庫金,2654,105,2549,摩根大通,2024-05-06,8440
2330,台積電,2700,172,2528,摩根大通,2024-05-06,8440
4904,遠傳,2533,113,2420,摩根大通,2024-05-06,8440
2883,凱基金,2941,633,2308,摩根大通,2024-05-06,8440
2892,第一金,2456,148,2308,摩根大通,2024-05-06,8440
2882,國泰金,2404,283,2121,摩根大通,2024-05-06,8440
2002,中鋼,2182,159,2023,摩根大通,2024-05-06,8440
2408,南亞科,1849,79,1770,摩根大通,2024-05-06,8440
1216,統一,1808,124,1684,摩根大通,2024-05-06,8440
2890,永豐金,2236,658,1578,摩根大通,2024-05-06,8440
2834,臺企銀,2434,981,1453,摩根大通,2024-05-06,8440
2801,彰銀,1477,90,1387,摩根大通,2024-05-06,8440
1609,大亞,1531,189,1342,摩根大通,2024-05-06,8440
3231,緯創,1833,559,1274,摩根大通,2024-05-06,8440
2324,仁寶,1471,308,1163,摩根大通,2024-05-06,8440
2308,台達電,1707,546,1161,摩根大通,2024-05-06,8440
2301,光寶科,1498,383,1115,摩根大通,2024-05-06,8440
6005,群益證,1443,441,1002,摩根大通,2024-05-06,8440
2486,一詮,1046,59,987,摩根大通,2024-05-06,8440
1301,台塑,1059,102,957,摩根大通,2024-05-06,8440
2303,聯電,2684,1735,949,摩根大通,2024-05-06,8440
2881,富邦金,1474,540,934,摩根大通,2024-05-06,8440
1101,台泥,1355,516,839,摩根大通,2024-05-06,8440
1504,東元,1192,359,833,摩根大通,2024-05-06,8440
1514,亞力,1456,650,806,摩根大通,2024-05-06,8440
2809,京城銀,869,70,799,摩根大通,2024-05-06,8440
2501,國建,2102,1388,714,摩根大通,2024-05-06,8440
2836,高雄銀,713,3,710,摩根大通,2024-05-06,8440
2363,矽統,1597,891,706,摩根大通,2024-05-06,8440
3090,日電貿,763,87,676,摩根大通,2024-05-06,8440
3481,群創,751,82,669,摩根大通,2024-05-06,8440
2886,兆豐金,985,324,661,摩根大通,2024-05-06,8440
2903,遠百,648,32,616,摩根大通,2024-05-06,8440
2204,中華,657,52,605,摩根大通,2024-05-06,8440
2356,英業達,1166,562,604,摩根大通,2024-05-06,8440
4938,和碩,848,248,600,摩根大通,2024-05-06,8440
2637,慧洋-KY,759,165,594,摩根大通,2024-05-06,8440
8070,長華*,687,95,592,摩根大通,2024-05-06,8440
2887,台新金,1319,728,591,摩根大通,2024-05-06,8440
6290,良維,650,65,585,摩根大通,2024-05-06,8440
2897,王道銀行,866,287,579,摩根大通,2024-05-06,8440
2354,鴻準,759,202,557,摩根大通,2024-05-06,8440
1314,中石化,2108,1580,528,摩根大通,2024-05-06,8440
2880,華南金,8919,2374,6545,摩根大通,2024-05-07,8440
2889,國票金,5231,195,5036,摩根大通,2024-05-07,8440
2886,兆豐金,6325,1302,5023,摩根大通,2024-05-07,8440
1314,中石化,2268,17,2251,摩根大通,2024-05-07,8440
3260,威剛,1879,86,1793,摩根大通,2024-05-07,8440
2408,南亞科,1870,168,1702,摩根大通,2024-05-07,8440
1504,東元,1964,264,1700,摩根大通,2024-05-07,8440
1582,信錦,1899,265,1634,摩根大通,2024-05-07,8440
2515,中工,1818,223,1595,摩根大通,2024-05-07,8440
4904,遠傳,1723,153,1570,摩根大通,2024-05-07,8440
2501,國建,3019,1473,1546,摩根大通,2024-05-07,8440
2324,仁寶,1755,231,1524,摩根大通,2024-05-07,8440
5531,鄉林,1703,221,1482,摩根大通,2024-05-07,8440
2486,一詮,3597,2152,1445,摩根大通,2024-05-07,8440
1102,亞泥,1675,262,1413,摩根大通,2024-05-07,8440
2363,矽統,1842,506,1336,摩根大通,2024-05-07,8440
5347,世界,2120,840,1280,摩根大通,2024-05-07,8440
2882,國泰金,2088,981,1107,摩根大通,2024-05-07,8440
6177,達麗,2014,984,1030,摩根大通,2024-05-07,8440
2504,國產,1163,156,1007,摩根大通,2024-05-07,8440
3703,欣陸,1036,71,965,摩根大通,2024-05-07,8440
2607,榮運,910,21,889,摩根大通,2024-05-07,8440
8163,達方,975,93,882,摩根大通,2024-05-07,8440
2367,燿華,1689,901,788,摩根大通,2024-05-07,8440
2354,鴻準,894,119,775,摩根大通,2024-05-07,8440
2101,南港,1020,265,755,摩根大通,2024-05-07,8440
2884,玉山金,2198,1443,755,摩根大通,2024-05-07,8440
2412,中華電,913,185,728,摩根大通,2024-05-07,8440
2204,中華,702,15,687,摩根大通,2024-05-07,8440
2610,華航,937,285,652,摩根大通,2024-05-07,8440
5522,遠雄,872,230,642,摩根大通,2024-05-07,8440
2634,漢翔,653,23,630,摩根大通,2024-05-07,8440
1440,南紡,926,303,623,摩根大通,2024-05-07,8440
5880,合庫金,1548,961,587,摩根大通,2024-05-07,8440
2439,美律,608,38,570,摩根大通,2024-05-07,8440
2352,佳世達,1013,461,552,摩根大通,2024-05-07,8440
2330,台積電,3156,2604,552,摩根大通,2024-05-07,8440
2353,宏��,1403,852,551,摩根大通,2024-05-07,8440
4303,信立,668,135,533,摩根大通,2024-05-07,8440
6269,台郡,673,158,515,摩根大通,2024-05-07,8440
2303,聯電,1169,709,460,摩根大通,2024-05-07,8440
3090,日電貿,465,5,460,摩根大通,2024-05-07,8440
6278,台表科,482,42,440,摩根大通,2024-05-07,8440
2605,新興,597,160,437,摩根大通,2024-05-07,8440
0050,元大台灣50,436,0,436,摩根大通,2024-05-07,8440
1216,統一,1528,1103,425,摩根大通,2024-05-07,8440
1101,台泥,1621,1208,413,摩根大通,2024-05-07,8440
1808,潤隆,635,256,379,摩根大通,2024-05-07,8440
6213,聯茂,460,83,377,摩根大通,2024-05-07,8440
2637,慧洋-KY,484,112,372,摩根大通,2024-05-07,8440
2412,中華電,11244,79,11165,摩根大通,2024-05-08,8440
2880,華南金,6794,1065,5729,摩根大通,2024-05-08,8440
2301,光寶科,5671,197,5474,摩根大通,2024-05-08,8440
2888,新光金,6328,872,5456,摩根大通,2024-05-08,8440
2303,聯電,5242,910,4332,摩根大通,2024-05-08,8440
2356,英業達,4985,1714,3271,摩根大通,2024-05-08,8440
2889,國票金,3017,7,3010,摩根大通,2024-05-08,8440
2317,鴻海,3978,1374,2604,摩根大通,2024-05-08,8440
2886,兆豐金,3101,522,2579,摩根大通,2024-05-08,8440
2882,國泰金,2884,591,2293,摩根大通,2024-05-08,8440
5347,世界,2888,853,2035,摩根大通,2024-05-08,8440
3231,緯創,2569,538,2031,摩根大通,2024-05-08,8440
2324,仁寶,1813,241,1572,摩根大通,2024-05-08,8440
2885,元大金,2038,573,1465,摩根大通,2024-05-08,8440
1102,亞泥,1478,17,1461,摩根大通,2024-05-08,8440
2330,台積電,2229,807,1422,摩根大通,2024-05-08,8440
2376,技嘉,1520,299,1221,摩根大通,2024-05-08,8440
3260,威剛,1575,469,1106,摩根大通,2024-05-08,8440
2352,佳世達,1646,579,1067,摩根大通,2024-05-08,8440
2501,國建,1546,560,986,摩根大通,2024-05-08,8440
2367,燿華,1136,234,902,摩根大通,2024-05-08,8440
2634,漢翔,983,113,870,摩根大通,2024-05-08,8440
1402,遠東新,867,76,791,摩根大通,2024-05-08,8440
3045,台灣大,806,19,787,摩根大通,2024-05-08,8440
2105,正新,1450,675,775,摩根大通,2024-05-08,8440
2454,聯發科,1077,306,771,摩根大通,2024-05-08,8440
1101,台泥,1090,322,768,摩根大通,2024-05-08,8440
2338,光罩,882,135,747,摩根大通,2024-05-08,8440
2890,永豐金,755,37,718,摩根大通,2024-05-08,8440
5876,上海商銀,1260,580,680,摩根大通,2024-05-08,8440
6005,群益證,1192,515,677,摩根大通,2024-05-08,8440
2801,彰銀,935,260,675,摩根大通,2024-05-08,8440
5371,中光電,881,215,666,摩根大通,2024-05-08,8440
2101,南港,934,310,624,摩根大通,2024-05-08,8440
2504,國產,860,254,606,摩根大通,2024-05-08,8440
9904,寶成,1066,517,549,摩根大通,2024-05-08,8440
1815,富喬,796,263,533,摩根大通,2024-05-08,8440
5880,合庫金,1113,601,512,摩根大通,2024-05-08,8440
2618,長榮航,4226,3719,507,摩根大通,2024-05-08,8440
1319,東陽,648,154,494,摩根大通,2024-05-08,8440
6191,精成科,484,0,484,摩根大通,2024-05-08,8440
4973,廣穎,512,36,476,摩根大通,2024-05-08,8440
1216,統一,1484,1010,474,摩根大通,2024-05-08,8440
2520,冠德,778,315,463,摩根大通,2024-05-08,8440
2809,京城銀,599,139,460,摩根大通,2024-05-08,8440
2515,中工,626,197,429,摩根大通,2024-05-08,8440
3044,健鼎,456,40,416,摩根大通,2024-05-08,8440
2353,宏��,691,277,414,摩根大通,2024-05-08,8440
5531,鄉林,878,471,407,摩根大通,2024-05-08,8440
2377,微星,1621,1219,402,摩根大通,2024-05-08,8440
2885,元大金,5160,814,4346,摩根大通,2024-05-09,8440
2882,國泰金,4133,410,3723,摩根大通,2024-05-09,8440
2609,陽明,3844,509,3335,摩根大通,2024-05-09,8440
2408,南亞科,3015,26,2989,摩根大通,2024-05-09,8440
2880,華南金,5767,3091,2676,摩根大通,2024-05-09,8440
2890,永豐金,2816,169,2647,摩根大通,2024-05-09,8440
2002,中鋼,4949,2659,2290,摩根大通,2024-05-09,8440
2324,仁寶,2696,449,2247,摩根大通,2024-05-09,8440
2352,佳世達,2687,466,2221,摩根大通,2024-05-09,8440
2903,遠百,2224,16,2208,摩根大通,2024-05-09,8440
2330,台積電,2734,738,1996,摩根大通,2024-05-09,8440
3044,健鼎,2150,530,1620,摩根大通,2024-05-09,8440
2889,國票金,1752,214,1538,摩根大通,2024-05-09,8440
6005,群益證,1712,374,1338,摩根大通,2024-05-09,8440
1609,大亞,1707,460,1247,摩根大通,2024-05-09,8440
1216,統一,1752,553,1199,摩根大通,2024-05-09,8440
2412,中華電,1393,230,1163,摩根大通,2024-05-09,8440
2892,第一金,1378,262,1116,摩根大通,2024-05-09,8440
3481,群創,1808,759,1049,摩根大通,2024-05-09,8440
2301,光寶科,2047,1057,990,摩根大通,2024-05-09,8440
4960,誠美材,992,57,935,摩根大通,2024-05-09,8440
3045,台灣大,948,45,903,摩根大通,2024-05-09,8440
8150,南茂,889,15,874,摩根大通,2024-05-09,8440
2867,三商壽,1079,231,848,摩根大通,2024-05-09,8440
5876,上海商銀,1378,556,822,摩根大通,2024-05-09,8440
6274,台燿,836,58,778,摩根大通,2024-05-09,8440
6177,達麗,1075,360,715,摩根大通,2024-05-09,8440
1102,亞泥,1022,439,583,摩根大通,2024-05-09,8440
2486,一詮,2061,1481,580,摩根大通,2024-05-09,8440
2303,聯電,1860,1315,545,摩根大通,2024-05-09,8440
1714,和桐,635,90,545,摩根大通,2024-05-09,8440
2474,可成,559,23,536,摩根大通,2024-05-09,8440
2362,藍天,760,252,508,摩根大通,2024-05-09,8440
5009,榮剛,764,260,504,摩根大通,2024-05-09,8440
8096,擎亞,654,161,493,摩根大通,2024-05-09,8440
5371,中光電,594,114,480,摩根大通,2024-05-09,8440
2897,王道銀行,609,131,478,摩根大通,2024-05-09,8440
5608,四維航,467,9,458,摩根大通,2024-05-09,8440
4967,十銓,816,370,446,摩根大通,2024-05-09,8440
2634,漢翔,510,65,445,摩根大通,2024-05-09,8440
2439,美律,592,157,435,摩根大通,2024-05-09,8440
2641,正德,514,90,424,摩根大通,2024-05-09,8440
1708,東鹼,421,10,411,摩根大通,2024-05-09,8440
9933,中鼎,418,10,408,摩根大通,2024-05-09,8440
1402,遠東新,718,311,407,摩根大通,2024-05-09,8440
2548,華固,599,193,406,摩根大通,2024-05-09,8440
2204,中華,585,199,386,摩根大通,2024-05-09,8440
1319,東陽,414,36,378,摩根大通,2024-05-09,8440
3013,晟銘電,837,475,362,摩根大通,2024-05-09,8440
2379,瑞昱,488,145,343,摩根大通,2024-05-09,8440
2609,陽明,24358,2804,21554,摩根大通,2024-05-10,8440
2880,華南金,22253,1393,20860,摩根大通,2024-05-10,8440
2610,華航,20021,18,20003,摩根大通,2024-05-10,8440
2618,長榮航,20564,1851,18713,摩根大通,2024-05-10,8440
2891,中信金,15879,4903,10976,摩根大通,2024-05-10,8440
1102,亞泥,7474,1041,6433,摩根大通,2024-05-10,8440
2883,凱基金,6690,309,6381,摩根大通,2024-05-10,8440
2889,國票金,6595,647,5948,摩根大通,2024-05-10,8440
2884,玉山金,5964,1101,4863,摩根大通,2024-05-10,8440
2301,光寶科,5835,1439,4396,摩根大通,2024-05-10,8440
6005,群益證,4450,947,3503,摩根大通,2024-05-10,8440
2888,新光金,3950,701,3249,摩根大通,2024-05-10,8440
2882,國泰金,5244,2522,2722,摩根大通,2024-05-10,8440
2890,永豐金,3033,466,2567,摩根大通,2024-05-10,8440
2408,南亞科,2602,36,2566,摩根大通,2024-05-10,8440
2356,英業達,3111,762,2349,摩根大通,2024-05-10,8440
2809,京城銀,2539,269,2270,摩根大通,2024-05-10,8440
5871,中租-KY,3444,1242,2202,摩根大通,2024-05-10,8440
2887,台新金,2404,274,2130,摩根大通,2024-05-10,8440
2845,遠東銀,2099,34,2065,摩根大通,2024-05-10,8440
2903,遠百,2678,634,2044,摩根大通,2024-05-10,8440
1402,遠東新,1923,48,1875,摩根大通,2024-05-10,8440
2504,國產,2071,201,1870,摩根大通,2024-05-10,8440
2317,鴻海,4325,2550,1775,摩根大通,2024-05-10,8440
2834,臺企銀,1976,212,1764,摩根大通,2024-05-10,8440
2886,兆豐金,3240,1728,1512,摩根大通,2024-05-10,8440
1216,統一,2730,1239,1491,摩根大通,2024-05-10,8440
5009,榮剛,1591,166,1425,摩根大通,2024-05-10,8440
5880,合庫金,2228,933,1295,摩根大通,2024-05-10,8440
2352,佳世達,2491,1203,1288,摩根大通,2024-05-10,8440
2867,三商壽,1303,30,1273,摩根大通,2024-05-10,8440
2603,長榮,5197,3964,1233,摩根大通,2024-05-10,8440
3481,群創,2072,841,1231,摩根大通,2024-05-10,8440
4960,誠美材,1802,630,1172,摩根大通,2024-05-10,8440
1101,台泥,1488,414,1074,摩根大通,2024-05-10,8440
1319,東陽,1062,23,1039,摩根大通,2024-05-10,8440
2801,彰銀,1776,748,1028,摩根大通,2024-05-10,8440
1609,大亞,1131,154,977,摩根大通,2024-05-10,8440
5876,上海商銀,1787,920,867,摩根大通,2024-05-10,8440
2393,億光,991,142,849,摩根大通,2024-05-10,8440
2486,一詮,1644,826,818,摩根大通,2024-05-10,8440
2885,元大金,2462,1695,767,摩根大通,2024-05-10,8440
2412,中華電,1029,263,766,摩根大通,2024-05-10,8440
2474,可成,858,115,743,摩根大通,2024-05-10,8440
2105,正新,802,106,696,摩根大通,2024-05-10,8440
1514,亞力,718,34,684,摩根大通,2024-05-10,8440
9904,寶成,1120,450,670,摩根大通,2024-05-10,8440
8096,擎亞,883,230,653,摩根大通,2024-05-10,8440
3045,台灣大,609,20,589,摩根大通,2024-05-10,8440
2520,冠德,1120,539,581,摩根大通,2024-05-10,8440
2880,華南金,7643,2624,5019,摩根大通,2024-05-13,8440
2317,鴻海,6806,1812,4994,摩根大通,2024-05-13,8440
2886,兆豐金,3092,379,2713,摩根大通,2024-05-13,8440
2367,燿華,4057,1411,2646,摩根大通,2024-05-13,8440
2408,南亞科,2781,163,2618,摩根大通,2024-05-13,8440
2330,台積電,3375,839,2536,摩根大通,2024-05-13,8440
2888,新光金,2995,562,2433,摩根大通,2024-05-13,8440
2303,聯電,2882,538,2344,摩根大通,2024-05-13,8440
1503,士電,2320,183,2137,摩根大通,2024-05-13,8440
2406,國碩,2120,345,1775,摩根大通,2024-05-13,8440
2105,正新,1791,78,1713,摩根大通,2024-05-13,8440
1216,統一,1467,15,1452,摩根大通,2024-05-13,8440
1605,華新,1540,89,1451,摩根大通,2024-05-13,8440
1514,亞力,1664,229,1435,摩根大通,2024-05-13,8440
2362,藍天,1650,265,1385,摩根大通,2024-05-13,8440
1102,亞泥,2160,776,1384,摩根大通,2024-05-13,8440
2374,佳能,1495,195,1300,摩根大通,2024-05-13,8440
2887,台新金,1309,49,1260,摩根大通,2024-05-13,8440
1312,國喬,1428,234,1194,摩根大通,2024-05-13,8440
2883,凱基金,3893,2723,1170,摩根大通,2024-05-13,8440
1402,遠東新,1236,174,1062,摩根大通,2024-05-13,8440
8112,至上,1701,652,1049,摩根大通,2024-05-13,8440
5880,合庫金,1248,209,1039,摩根大通,2024-05-13,8440
2049,上銀,1097,71,1026,摩根大通,2024-05-13,8440
1609,大亞,1111,160,951,摩根大通,2024-05-13,8440
5871,中租-KY,983,41,942,摩根大通,2024-05-13,8440
2633,台灣高鐵,948,28,920,摩根大通,2024-05-13,8440
6005,群益證,1033,214,819,摩根大通,2024-05-13,8440
6770,力積電,806,2,804,摩根大通,2024-05-13,8440
2324,仁寶,1916,1133,783,摩根大通,2024-05-13,8440
1101,台泥,1188,453,735,摩根大通,2024-05-13,8440
2313,華通,958,238,720,摩根大通,2024-05-13,8440
1301,台塑,788,73,715,摩根大通,2024-05-13,8440
2634,漢翔,727,30,697,摩根大通,2024-05-13,8440
1513,中興電,867,191,676,摩根大通,2024-05-13,8440
2308,台達電,733,107,626,摩根大通,2024-05-13,8440
2809,京城銀,1081,466,615,摩根大通,2024-05-13,8440
9105,泰金寶-DR,644,52,592,摩根大通,2024-05-13,8440
2615,萬海,1529,941,588,摩根大通,2024-05-13,8440
2009,第一銅,642,56,586,摩根大通,2024-05-13,8440
2352,佳世達,938,362,576,摩根大通,2024-05-13,8440
2017,官田鋼,571,0,571,摩根大通,2024-05-13,8440
2371,大同,2946,2376,570,摩根大通,2024-05-13,8440
1519,華城,625,97,528,摩根大通,2024-05-13,8440
8210,勤誠,603,95,508,摩根大通,2024-05-13,8440
2884,玉山金,2294,1808,486,摩根大通,2024-05-13,8440
6125,廣運,650,186,464,摩根大通,2024-05-13,8440
2474,可成,663,204,459,摩根大通,2024-05-13,8440
3045,台灣大,469,11,458,摩根大通,2024-05-13,8440
2344,華邦電,568,111,457,摩根大通,2024-05-13,8440
2880,華南金,6864,1113,5751,摩根大通,2024-05-14,8440
2609,陽明,18173,12446,5727,摩根大通,2024-05-14,8440
2330,台積電,7626,2041,5585,摩根大通,2024-05-14,8440
2618,長榮航,6372,1622,4750,摩根大通,2024-05-14,8440
2603,長榮,7020,2529,4491,摩根大通,2024-05-14,8440
2002,中鋼,3455,185,3270,摩根大通,2024-05-14,8440
2605,新興,3899,1005,2894,摩根大通,2024-05-14,8440
2610,華航,7787,4962,2825,摩根大通,2024-05-14,8440
1216,統一,2982,388,2594,摩根大通,2024-05-14,8440
2303,聯電,3492,1732,1760,摩根大通,2024-05-14,8440
1522,堤維西,1998,397,1601,摩根大通,2024-05-14,8440
2331,精英,1657,152,1505,摩根大通,2024-05-14,8440
2615,萬海,4973,3582,1391,摩根大通,2024-05-14,8440
6770,力積電,1375,79,1296,摩根大通,2024-05-14,8440
6125,廣運,1855,585,1270,摩根大通,2024-05-14,8440
1102,亞泥,1666,516,1150,摩根大通,2024-05-14,8440
2606,裕民,1438,294,1144,摩根大通,2024-05-14,8440
6005,群益證,2039,945,1094,摩根大通,2024-05-14,8440
1303,南亞,1446,438,1008,摩根大通,2024-05-14,8440
2888,新光金,4911,3938,973,摩根大通,2024-05-14,8440
3711,日月光投控,1433,485,948,摩根大通,2024-05-14,8440
2504,國產,1026,132,894,摩根大通,2024-05-14,8440
5608,四維航,1105,264,841,摩根大通,2024-05-14,8440
2379,瑞昱,934,98,836,摩根大通,2024-05-14,8440
2476,鉅祥,957,144,813,摩根大通,2024-05-14,8440
2374,佳能,1433,624,809,摩根大通,2024-05-14,8440
2634,漢翔,818,70,748,摩根大通,2024-05-14,8440
5876,上海商銀,1812,1067,745,摩根大通,2024-05-14,8440
4960,誠美材,1091,370,721,摩根大通,2024-05-14,8440
2049,上銀,774,62,712,摩根大通,2024-05-14,8440
3045,台灣大,885,231,654,摩根大通,2024-05-14,8440
8033,雷虎,623,0,623,摩根大通,2024-05-14,8440
2454,聯發科,1338,729,609,摩根大通,2024-05-14,8440
2353,宏��,1979,1380,599,摩根大通,2024-05-14,8440
3034,聯詠,698,117,581,摩根大通,2024-05-14,8440
2405,輔信,651,79,572,摩根大通,2024-05-14,8440
1319,東陽,746,195,551,摩根大通,2024-05-14,8440
2382,廣達,1106,557,549,摩根大通,2024-05-14,8440
4906,正文,557,18,539,摩根大通,2024-05-14,8440
8150,南茂,697,159,538,摩根大通,2024-05-14,8440
6139,亞翔,694,157,537,摩根大通,2024-05-14,8440
2383,台光電,615,93,522,摩根大通,2024-05-14,8440
5347,世界,589,89,500,摩根大通,2024-05-14,8440
2633,台灣高鐵,636,144,492,摩根大通,2024-05-14,8440
1608,華榮,568,107,461,摩根大通,2024-05-14,8440
4915,致伸,922,478,444,摩根大通,2024-05-14,8440
2607,榮運,468,47,421,摩根大通,2024-05-14,8440
5351,鈺創,415,22,393,摩根大通,2024-05-14,8440
8358,金居,383,12,371,摩根大通,2024-05-14,8440
8112,至上,765,401,364,摩根大通,2024-05-14,8440
2609,陽明,16994,3332,13662,摩根大通,2024-05-15,8440
2891,中信金,11824,4138,7686,摩根大通,2024-05-15,8440
2880,華南金,8606,1298,7308,摩根大通,2024-05-15,8440
2317,鴻海,12258,5361,6897,摩根大通,2024-05-15,8440
3231,緯創,6546,1406,5140,摩根大通,2024-05-15,8440
2312,金寶,5057,32,5025,摩根大通,2024-05-15,8440
2883,凱基金,4850,1021,3829,摩根大通,2024-05-15,8440
2881,富邦金,4713,1256,3457,摩根大通,2024-05-15,8440
2885,元大金,4763,1330,3433,摩根大通,2024-05-15,8440
2888,新光金,3921,698,3223,摩根大通,2024-05-15,8440
2892,第一金,3703,495,3208,摩根大通,2024-05-15,8440
2618,長榮航,4639,1731,2908,摩根大通,2024-05-15,8440
2367,燿華,3723,824,2899,摩根大通,2024-05-15,8440
2409,友達,4032,1448,2584,摩根大通,2024-05-15,8440
2884,玉山金,3083,599,2484,摩根大通,2024-05-15,8440
5876,上海商銀,3326,1038,2288,摩根大通,2024-05-15,8440
1102,亞泥,2600,478,2122,摩根大通,2024-05-15,8440
6005,群益證,2350,344,2006,摩根大通,2024-05-15,8440
2382,廣達,3065,1132,1933,摩根大通,2024-05-15,8440
2834,臺企銀,2395,465,1930,摩根大通,2024-05-15,8440
2886,兆豐金,3177,1256,1921,摩根大通,2024-05-15,8440
2845,遠東銀,2114,333,1781,摩根大通,2024-05-15,8440
2887,台新金,2061,332,1729,摩根大通,2024-05-15,8440
2634,漢翔,1658,137,1521,摩根大通,2024-05-15,8440
2889,國票金,1689,197,1492,摩根大通,2024-05-15,8440
2331,精英,1998,617,1381,摩根大通,2024-05-15,8440
5871,中租-KY,2379,1029,1350,摩根大通,2024-05-15,8440
2105,正新,2096,770,1326,摩根大通,2024-05-15,8440
2353,宏��,3508,2188,1320,摩根大通,2024-05-15,8440
1216,統一,2521,1228,1293,摩根大通,2024-05-15,8440
2303,聯電,5163,3933,1230,摩根大通,2024-05-15,8440
8358,金居,1266,46,1220,摩根大通,2024-05-15,8440
9105,泰金寶-DR,1062,25,1037,摩根大通,2024-05-15,8440
1605,華新,1786,750,1036,摩根大通,2024-05-15,8440
6189,豐藝,1018,31,987,摩根大通,2024-05-15,8440
2365,昆盈,1139,176,963,摩根大通,2024-05-15,8440
1504,東元,1294,464,830,摩根大通,2024-05-15,8440
2867,三商壽,1177,373,804,摩根大通,2024-05-15,8440
1513,中興電,854,74,780,摩根大通,2024-05-15,8440
8112,至上,983,215,768,摩根大通,2024-05-15,8440
2882,國泰金,3563,2835,728,摩根大通,2024-05-15,8440
5347,世界,969,280,689,摩根大通,2024-05-15,8440
3481,群創,1875,1230,645,摩根大通,2024-05-15,8440
2504,國產,868,229,639,摩根大通,2024-05-15,8440
2474,可成,819,250,569,摩根大通,2024-05-15,8440
1101,台泥,1591,1031,560,摩根大通,2024-05-15,8440
3406,玉晶光,569,36,533,摩根大通,2024-05-15,8440
8936,國統,593,66,527,摩根大通,2024-05-15,8440
1815,富喬,594,90,504,摩根大通,2024-05-15,8440
3034,聯詠,663,165,498,摩根大通,2024-05-15,8440
2409,友達,12306,1581,10725,摩根大通,2024-05-16,8440
6770,力積電,9130,329,8801,摩根大通,2024-05-16,8440
2609,陽明,13389,5239,8150,摩根大通,2024-05-16,8440
2618,長榮航,12844,6255,6589,摩根大通,2024-05-16,8440
2317,鴻海,7477,1968,5509,摩根大通,2024-05-16,8440
2610,華航,7146,1844,5302,摩根大通,2024-05-16,8440
2891,中信金,10385,5324,5061,摩根大通,2024-05-16,8440
2888,新光金,5002,447,4555,摩根大通,2024-05-16,8440
2504,國產,4750,382,4368,摩根大通,2024-05-16,8440
2884,玉山金,5540,1696,3844,摩根大通,2024-05-16,8440
2885,元大金,5054,1230,3824,摩根大通,2024-05-16,8440
2303,聯電,4665,903,3762,摩根大通,2024-05-16,8440
2330,台積電,5014,1256,3758,摩根大通,2024-05-16,8440
2887,台新金,3996,727,3269,摩根大通,2024-05-16,8440
5876,上海商銀,4009,990,3019,摩根大通,2024-05-16,8440
6005,群益證,3820,865,2955,摩根大通,2024-05-16,8440
1101,台泥,3225,273,2952,摩根大通,2024-05-16,8440
2603,長榮,6135,3371,2764,摩根大通,2024-05-16,8440
5871,中租-KY,3045,311,2734,摩根大通,2024-05-16,8440
2892,第一金,3473,765,2708,摩根大通,2024-05-16,8440
2362,藍天,3416,1069,2347,摩根大通,2024-05-16,8440
5880,合庫金,3215,870,2345,摩根大通,2024-05-16,8440
2867,三商壽,3713,1467,2246,摩根大通,2024-05-16,8440
2105,正新,3433,1259,2174,摩根大通,2024-05-16,8440
2324,仁寶,2613,537,2076,摩根大通,2024-05-16,8440
2344,華邦電,2600,535,2065,摩根大通,2024-05-16,8440
3260,威剛,2009,15,1994,摩根大通,2024-05-16,8440
4904,遠傳,2647,719,1928,摩根大通,2024-05-16,8440
8112,至上,1834,138,1696,摩根大通,2024-05-16,8440
1402,遠東新,1697,229,1468,摩根大通,2024-05-16,8440
2883,凱基金,3146,1847,1299,摩根大通,2024-05-16,8440
2834,臺企銀,1478,197,1281,摩根大通,2024-05-16,8440
3045,台灣大,1328,65,1263,摩根大通,2024-05-16,8440
2801,彰銀,1622,438,1184,摩根大通,2024-05-16,8440
2367,燿華,1878,744,1134,摩根大通,2024-05-16,8440
1605,華新,1246,171,1075,摩根大通,2024-05-16,8440
2467,志聖,1308,275,1033,摩根大通,2024-05-16,8440
1718,中纖,1035,5,1030,摩根大通,2024-05-16,8440
2376,技嘉,1104,83,1021,摩根大通,2024-05-16,8440
2323,中環,1223,270,953,摩根大通,2024-05-16,8440
2359,所羅門,2030,1083,947,摩根大通,2024-05-16,8440
3481,群創,1753,811,942,摩根大通,2024-05-16,8440
3013,晟銘電,1006,66,940,摩根大通,2024-05-16,8440
8069,元太,1261,330,931,摩根大通,2024-05-16,8440
2337,旺宏,957,43,914,摩根大通,2024-05-16,8440
2845,遠東銀,1029,131,898,摩根大通,2024-05-16,8440
1301,台塑,1351,462,889,摩根大通,2024-05-16,8440
2882,國泰金,2371,1505,866,摩根大通,2024-05-16,8440
2353,宏��,1926,1065,861,摩根大通,2024-05-16,8440
1216,統一,2594,1747,847,摩根大通,2024-05-16,8440
2317,鴻海,11451,1300,10151,摩根大通,2024-05-17,8440
2618,長榮航,9168,5151,4017,摩根大通,2024-05-17,8440
5876,上海商銀,4444,656,3788,摩根大通,2024-05-17,8440
2303,聯電,5766,2065,3701,摩根大通,2024-05-17,8440
2367,燿華,4711,1167,3544,摩根大通,2024-05-17,8440
5347,世界,3366,490,2876,摩根大通,2024-05-17,8440
2889,國票金,2830,360,2470,摩根大通,2024-05-17,8440
2634,漢翔,2589,170,2419,摩根大通,2024-05-17,8440
2867,三商壽,5804,3807,1997,摩根大通,2024-05-17,8440
2888,新光金,2040,234,1806,摩根大通,2024-05-17,8440
2105,正新,2057,341,1716,摩根大通,2024-05-17,8440
2609,陽明,1956,276,1680,摩根大通,2024-05-17,8440
2880,華南金,3748,2261,1487,摩根大通,2024-05-17,8440
2881,富邦金,2049,570,1479,摩根大通,2024-05-17,8440
2412,中華電,1326,48,1278,摩根大通,2024-05-17,8440
2382,廣達,1838,614,1224,摩根大通,2024-05-17,8440
1216,統一,1584,379,1205,摩根大通,2024-05-17,8440
6244,茂迪,1447,242,1205,摩根大通,2024-05-17,8440
5483,中美晶,1299,119,1180,摩根大通,2024-05-17,8440
3706,神達,1744,582,1162,摩根大通,2024-05-17,8440
2883,凱基金,2016,898,1118,摩根大通,2024-05-17,8440
6005,群益證,2137,1064,1073,摩根大通,2024-05-17,8440
2504,國產,1491,422,1069,摩根大通,2024-05-17,8440
2406,國碩,1133,75,1058,摩根大通,2024-05-17,8440
1605,華新,1259,229,1030,摩根大通,2024-05-17,8440
2454,聯發科,1419,445,974,摩根大通,2024-05-17,8440
2610,華航,4681,3740,941,摩根大通,2024-05-17,8440
9105,泰金寶-DR,965,52,913,摩根大通,2024-05-17,8440
8112,至上,1138,264,874,摩根大通,2024-05-17,8440
3045,台灣大,1019,173,846,摩根大通,2024-05-17,8440
2887,台新金,1125,285,840,摩根大通,2024-05-17,8440
2002,中鋼,2630,1794,836,摩根大通,2024-05-17,8440
2801,彰銀,900,70,830,摩根大通,2024-05-17,8440
8096,擎亞,1215,406,809,摩根大通,2024-05-17,8440
4114,健喬,795,5,790,摩根大通,2024-05-17,8440
1785,光洋科,793,58,735,摩根大通,2024-05-17,8440
8070,長華*,915,195,720,摩根大通,2024-05-17,8440
3005,神基,1227,536,691,摩根大通,2024-05-17,8440
2374,佳能,1869,1190,679,摩根大通,2024-05-17,8440
3450,聯鈞,772,113,659,摩根大通,2024-05-17,8440
2383,台光電,958,300,658,摩根大通,2024-05-17,8440
3324,雙鴻,718,73,645,摩根大通,2024-05-17,8440
4960,誠美材,723,104,619,摩根大通,2024-05-17,8440
1504,東元,1126,513,613,摩根大通,2024-05-17,8440
9945,潤泰新,1121,517,604,摩根大通,2024-05-17,8440
3033,威健,1539,948,591,摩根大通,2024-05-17,8440
1101,台泥,1438,850,588,摩根大通,2024-05-17,8440
5880,合庫金,1134,553,581,摩根大通,2024-05-17,8440
8033,雷虎,679,98,581,摩根大通,2024-05-17,8440
6446,藥華藥,726,156,570,摩根大通,2024-05-17,8440
2883,凱基金,8858,249,8609,摩根大通,2024-05-20,8440
5876,上海商銀,5814,364,5450,摩根大通,2024-05-20,8440
2603,長榮,5483,950,4533,摩根大通,2024-05-20,8440
2356,英業達,4387,436,3951,摩根大通,2024-05-20,8440
2888,新光金,3860,98,3762,摩根大通,2024-05-20,8440
5880,合庫金,3163,146,3017,摩根大通,2024-05-20,8440
2105,正新,3439,578,2861,摩根大通,2024-05-20,8440
1605,華新,3709,889,2820,摩根大通,2024-05-20,8440
9904,寶成,3574,1086,2488,摩根大通,2024-05-20,8440
3702,大聯大,2575,272,2303,摩根大通,2024-05-20,8440
3005,神基,2685,419,2266,摩根大通,2024-05-20,8440
2801,彰銀,2245,107,2138,摩根大通,2024-05-20,8440
2027,大成鋼,4577,2441,2136,摩根大通,2024-05-20,8440
1319,東陽,2029,108,1921,摩根大通,2024-05-20,8440
2890,永豐金,4412,2543,1869,摩根大通,2024-05-20,8440
2301,光寶科,3330,1475,1855,摩根大通,2024-05-20,8440
3706,神達,1806,213,1593,摩根大通,2024-05-20,8440
2352,佳世達,3123,1538,1585,摩根大通,2024-05-20,8440
2303,聯電,3123,1543,1580,摩根大通,2024-05-20,8440
4915,致伸,1711,131,1580,摩根大通,2024-05-20,8440
2609,陽明,1985,412,1573,摩根大通,2024-05-20,8440
8150,南茂,1590,17,1573,摩根大通,2024-05-20,8440
2889,國票金,2579,1066,1513,摩根大通,2024-05-20,8440
2330,台積電,2926,1482,1444,摩根大通,2024-05-20,8440
2892,第一金,2541,1153,1388,摩根大通,2024-05-20,8440
2412,中華電,1506,118,1388,摩根大通,2024-05-20,8440
3045,台灣大,1412,64,1348,摩根大通,2024-05-20,8440
2834,臺企銀,3365,2061,1304,摩根大通,2024-05-20,8440
2887,台新金,1532,291,1241,摩根大通,2024-05-20,8440
3264,欣銓,1512,324,1188,摩根大通,2024-05-20,8440
2014,中鴻,1257,79,1178,摩根大通,2024-05-20,8440
6274,台燿,1236,153,1083,摩根大通,2024-05-20,8440
6125,廣運,2164,1131,1033,摩根大通,2024-05-20,8440
2009,第一銅,1162,193,969,摩根大通,2024-05-20,8440
1785,光洋科,1539,601,938,摩根大通,2024-05-20,8440
6770,力積電,1559,650,909,摩根大通,2024-05-20,8440
8070,長華*,1279,478,801,摩根大通,2024-05-20,8440
2812,台中銀,776,22,754,摩根大通,2024-05-20,8440
5871,中租-KY,1145,397,748,摩根大通,2024-05-20,8440
3576,聯合再生,1084,347,737,摩根大通,2024-05-20,8440
1102,亞泥,1605,939,666,摩根大通,2024-05-20,8440
2474,可成,1040,387,653,摩根大通,2024-05-20,8440
2408,南亞科,768,120,648,摩根大通,2024-05-20,8440
2897,王道銀行,1104,504,600,摩根大通,2024-05-20,8440
5469,瀚宇博,634,34,600,摩根大通,2024-05-20,8440
2886,兆豐金,2872,2285,587,摩根大通,2024-05-20,8440
4938,和碩,1129,543,586,摩根大通,2024-05-20,8440
2376,技嘉,768,184,584,摩根大通,2024-05-20,8440
5483,中美晶,771,190,581,摩根大通,2024-05-20,8440
2442,新美齊,714,133,581,摩根大通,2024-05-20,8440
2303,聯電,14976,2279,12697,摩根大通,2024-05-21,8440
2105,正新,10127,1017,9110,摩根大通,2024-05-21,8440
3706,神達,8967,638,8329,摩根大通,2024-05-21,8440
5880,合庫金,6935,963,5972,摩根大通,2024-05-21,8440
2603,長榮,4922,668,4254,摩根大通,2024-05-21,8440
9904,寶成,5040,1383,3657,摩根大通,2024-05-21,8440
5876,上海商銀,3708,768,2940,摩根大通,2024-05-21,8440
4915,致伸,2905,97,2808,摩根大通,2024-05-21,8440
8150,南茂,2749,31,2718,摩根大通,2024-05-21,8440
2610,華航,5694,3232,2462,摩根大通,2024-05-21,8440
2867,三商壽,2382,158,2224,摩根大通,2024-05-21,8440
2353,宏��,3156,971,2185,摩根大通,2024-05-21,8440
2352,佳世達,2664,591,2073,摩根大通,2024-05-21,8440
3231,緯創,2463,567,1896,摩根大通,2024-05-21,8440
1319,東陽,1989,177,1812,摩根大通,2024-05-21,8440
5469,瀚宇博,2007,198,1809,摩根大通,2024-05-21,8440
2474,可成,1919,216,1703,摩根大通,2024-05-21,8440
3704,合勤控,1689,3,1686,摩根大通,2024-05-21,8440
4938,和碩,1847,247,1600,摩根大通,2024-05-21,8440
6190,萬泰科,1499,42,1457,摩根大通,2024-05-21,8440
1785,光洋科,2413,1032,1381,摩根大通,2024-05-21,8440
5347,世界,1926,639,1287,摩根大通,2024-05-21,8440
2609,陽明,1708,472,1236,摩根大通,2024-05-21,8440
2301,光寶科,3559,2442,1117,摩根大通,2024-05-21,8440
8070,長華*,1279,224,1055,摩根大通,2024-05-21,8440
3042,晶技,1005,3,1002,摩根大通,2024-05-21,8440
3014,聯陽,945,3,942,摩根大通,2024-05-21,8440
1402,遠東新,1188,253,935,摩根大通,2024-05-21,8440
6257,矽格,943,11,932,摩根大通,2024-05-21,8440
1216,統一,4425,3494,931,摩根大通,2024-05-21,8440
6188,廣明,1317,388,929,摩根大通,2024-05-21,8440
3264,欣銓,1100,176,924,摩根大通,2024-05-21,8440
9921,巨大,870,47,823,摩根大通,2024-05-21,8440
2404,漢唐,925,112,813,摩根大通,2024-05-21,8440
2382,廣達,1278,508,770,摩根大通,2024-05-21,8440
6139,亞翔,958,191,767,摩根大通,2024-05-21,8440
6290,良維,906,148,758,摩根大通,2024-05-21,8440
2009,第一銅,842,120,722,摩根大通,2024-05-21,8440
2324,仁寶,3103,2400,703,摩根大通,2024-05-21,8440
2317,鴻海,2440,1758,682,摩根大通,2024-05-21,8440
2464,盟立,770,88,682,摩根大通,2024-05-21,8440
5871,中租-KY,785,188,597,摩根大通,2024-05-21,8440
2412,中華電,954,360,594,摩根大通,2024-05-21,8440
3483,力致,976,386,590,摩根大通,2024-05-21,8440
3037,欣興,751,224,527,摩根大通,2024-05-21,8440
2637,慧洋-KY,978,453,525,摩根大通,2024-05-21,8440
2501,國建,576,60,516,摩根大通,2024-05-21,8440
9105,泰金寶-DR,574,60,514,摩根大通,2024-05-21,8440
5388,中磊,1886,1391,495,摩根大通,2024-05-21,8440
6770,力積電,543,52,491,摩根大通,2024-05-21,8440
2303,聯電,10390,1715,8675,摩根大通,2024-05-22,8440
2356,英業達,9251,2200,7051,摩根大通,2024-05-22,8440
2353,宏��,8806,2514,6292,摩根大通,2024-05-22,8440
3706,神達,6109,1324,4785,摩根大通,2024-05-22,8440
2324,仁寶,5468,745,4723,摩根大通,2024-05-22,8440
2880,華南金,5640,1068,4572,摩根大通,2024-05-22,8440
2888,新光金,4974,537,4437,摩根大通,2024-05-22,8440
9904,寶成,4418,432,3986,摩根大通,2024-05-22,8440
2603,長榮,4435,763,3672,摩根大通,2024-05-22,8440
2105,正新,3581,870,2711,摩根大通,2024-05-22,8440
2352,佳世達,3415,875,2540,摩根大通,2024-05-22,8440
1785,光洋科,2470,117,2353,摩根大通,2024-05-22,8440
1815,富喬,3125,1104,2021,摩根大通,2024-05-22,8440
1216,統一,2719,770,1949,摩根大通,2024-05-22,8440
5388,中磊,1999,168,1831,摩根大通,2024-05-22,8440
2301,光寶科,2886,1068,1818,摩根大通,2024-05-22,8440
4915,致伸,1968,201,1767,摩根大通,2024-05-22,8440
6257,矽格,1659,12,1647,摩根大通,2024-05-22,8440
2312,金寶,1612,26,1586,摩根大通,2024-05-22,8440
8150,南茂,1619,38,1581,摩根大通,2024-05-22,8440
2330,台積電,3618,2072,1546,摩根大通,2024-05-22,8440
2357,華碩,1696,224,1472,摩根大通,2024-05-22,8440
2405,輔信,1760,294,1466,摩根大通,2024-05-22,8440
2406,國碩,1724,391,1333,摩根大通,2024-05-22,8440
3264,欣銓,1356,44,1312,摩根大通,2024-05-22,8440
1605,華新,1606,302,1304,摩根大通,2024-05-22,8440
5876,上海商銀,3244,1974,1270,摩根大通,2024-05-22,8440
1609,大亞,1355,115,1240,摩根大通,2024-05-22,8440
2009,第一銅,3760,2617,1143,摩根大通,2024-05-22,8440
3312,弘憶股,1171,72,1099,摩根大通,2024-05-22,8440
1102,亞泥,1601,539,1062,摩根大通,2024-05-22,8440
2883,凱基金,1965,938,1027,摩根大通,2024-05-22,8440
3231,緯創,1365,366,999,摩根大通,2024-05-22,8440
8070,長華*,1152,164,988,摩根大通,2024-05-22,8440
2382,廣達,1624,636,988,摩根大通,2024-05-22,8440
2308,台達電,1262,286,976,摩根大通,2024-05-22,8440
3702,大聯大,999,34,965,摩根大通,2024-05-22,8440
5469,瀚宇博,1091,181,910,摩根大通,2024-05-22,8440
2609,陽明,1498,595,903,摩根大通,2024-05-22,8440
2887,台新金,1344,459,885,摩根大通,2024-05-22,8440
2801,彰銀,1468,586,882,摩根大通,2024-05-22,8440
3017,奇鋐,1202,388,814,摩根大通,2024-05-22,8440
5483,中美晶,958,151,807,摩根大通,2024-05-22,8440
2812,台中銀,765,20,745,摩根大通,2024-05-22,8440
3047,訊舟,1311,573,738,摩根大通,2024-05-22,8440
2374,佳能,920,188,732,摩根大通,2024-05-22,8440
3036,文曄,1029,297,732,摩根大通,2024-05-22,8440
6526,達發,751,25,726,摩根大通,2024-05-22,8440
6147,頎邦,878,161,717,摩根大通,2024-05-22,8440
2633,台灣高鐵,824,142,682,摩根大通,2024-05-22,8440
2610,華航,5695,1250,4445,摩根大通,2024-05-23,8440
3711,日月光投控,5060,1062,3998,摩根大通,2024-05-23,8440
1216,統一,5206,1543,3663,摩根大通,2024-05-23,8440
3706,神達,3852,242,3610,摩根大通,2024-05-23,8440
2330,台積電,5692,2436,3256,摩根大通,2024-05-23,8440
2303,聯電,5972,2851,3121,摩根大通,2024-05-23,8440
2880,華南金,3797,1373,2424,摩根大通,2024-05-23,8440
2317,鴻海,5005,2674,2331,摩根大通,2024-05-23,8440
2353,宏��,6243,3945,2298,摩根大通,2024-05-23,8440
2371,大同,2338,149,2189,摩根大通,2024-05-23,8440
2352,佳世達,2389,445,1944,摩根大通,2024-05-23,8440
4915,致伸,1721,39,1682,摩根大通,2024-05-23,8440
2308,台達電,1757,291,1466,摩根大通,2024-05-23,8440
6117,迎廣,1690,249,1441,摩根大通,2024-05-23,8440
1785,光洋科,1481,232,1249,摩根大通,2024-05-23,8440
2542,興富發,1326,165,1161,摩根大通,2024-05-23,8440
2454,聯發科,1274,201,1073,摩根大通,2024-05-23,8440
9904,寶成,1681,627,1054,摩根大通,2024-05-23,8440
8070,長華*,1176,156,1020,摩根大通,2024-05-23,8440
2609,陽明,1115,240,875,摩根大通,2024-05-23,8440
5483,中美晶,1069,205,864,摩根大通,2024-05-23,8440
2345,智邦,932,104,828,摩根大通,2024-05-23,8440
2357,華碩,1007,181,826,摩根大通,2024-05-23,8440
3017,奇鋐,1427,608,819,摩根大通,2024-05-23,8440
8150,南茂,838,23,815,摩根大通,2024-05-23,8440
2392,正崴,1615,835,780,摩根大通,2024-05-23,8440
3005,神基,1296,523,773,摩根大通,2024-05-23,8440
2464,盟立,892,138,754,摩根大通,2024-05-23,8440
6770,力積電,1464,755,709,摩根大通,2024-05-23,8440
2301,光寶科,3043,2343,700,摩根大通,2024-05-23,8440
6257,矽格,737,40,697,摩根大通,2024-05-23,8440
2312,金寶,811,126,685,摩根大通,2024-05-23,8440
2382,廣達,977,351,626,摩根大通,2024-05-23,8440
3406,玉晶光,784,185,599,摩根大通,2024-05-23,8440
3264,欣銓,597,13,584,摩根大通,2024-05-23,8440
2404,漢唐,656,78,578,摩根大通,2024-05-23,8440
6209,今國光,862,296,566,摩根大通,2024-05-23,8440
3037,欣興,1099,546,553,摩根大通,2024-05-23,8440
2867,三商壽,1127,584,543,摩根大通,2024-05-23,8440
2351,順德,546,10,536,摩根大通,2024-05-23,8440
5876,上海商銀,1834,1299,535,摩根大通,2024-05-23,8440
3704,合勤控,529,11,518,摩根大通,2024-05-23,8440
3576,聯合再生,637,164,473,摩根大通,2024-05-23,8440
2501,國建,1050,579,471,摩根大通,2024-05-23,8440
1532,勤美,475,10,465,摩根大通,2024-05-23,8440
2241,艾姆勒,468,19,449,摩根大通,2024-05-23,8440
5469,瀚宇博,649,202,447,摩根大通,2024-05-23,8440
4532,瑞智,557,120,437,摩根大通,2024-05-23,8440
2379,瑞昱,510,81,429,摩根大通,2024-05-23,8440
5351,鈺創,413,4,409,摩根大通,2024-05-23,8440
2891,中信金,8422,907,7515,摩根大通,2024-05-24,8440
1303,南亞,5075,1805,3270,摩根大通,2024-05-24,8440
2301,光寶科,5424,2348,3076,摩根大通,2024-05-24,8440
2363,矽統,3263,395,2868,摩根大通,2024-05-24,8440
9105,泰金寶-DR,2711,16,2695,摩根大通,2024-05-24,8440
3481,群創,3046,445,2601,摩根大通,2024-05-24,8440
2359,所羅門,2941,602,2339,摩根大通,2024-05-24,8440
2365,昆盈,2518,643,1875,摩根大通,2024-05-24,8440
2881,富邦金,1859,130,1729,摩根大通,2024-05-24,8440
1815,富喬,2670,993,1677,摩根大通,2024-05-24,8440
5498,凱崴,1548,300,1248,摩根大通,2024-05-24,8440
2330,台積電,2578,1341,1237,摩根大通,2024-05-24,8440
2356,英業達,1401,165,1236,摩根大通,2024-05-24,8440
2367,燿華,1502,273,1229,摩根大通,2024-05-24,8440
2489,瑞軒,1570,380,1190,摩根大通,2024-05-24,8440
2809,京城銀,1474,367,1107,摩根大通,2024-05-24,8440
2347,聯強,1674,587,1087,摩根大通,2024-05-24,8440
2405,輔信,1177,142,1035,摩根大通,2024-05-24,8440
2392,正崴,1616,585,1031,摩根大通,2024-05-24,8440
2382,廣達,1426,400,1026,摩根大通,2024-05-24,8440
2880,華南金,1540,534,1006,摩根大通,2024-05-24,8440
3033,威健,1607,611,996,摩根大通,2024-05-24,8440
8028,昇陽半導體,1121,151,970,摩根大通,2024-05-24,8440
2801,彰銀,1139,170,969,摩根大通,2024-05-24,8440
3231,緯創,1817,851,966,摩根大通,2024-05-24,8440
2605,新興,932,4,928,摩根大通,2024-05-24,8440
3312,弘憶股,1000,103,897,摩根大通,2024-05-24,8440
3706,神達,1176,321,855,摩根大通,2024-05-24,8440
5347,世界,1815,1000,815,摩根大通,2024-05-24,8440
6188,廣明,1449,702,747,摩根大通,2024-05-24,8440
4938,和碩,837,91,746,摩根大通,2024-05-24,8440
2543,皇昌,895,155,740,摩根大通,2024-05-24,8440
8070,長華*,887,158,729,摩根大通,2024-05-24,8440
2409,友達,936,255,681,摩根大通,2024-05-24,8440
2377,微星,1268,589,679,摩根大通,2024-05-24,8440
2609,陽明,1060,427,633,摩根大通,2024-05-24,8440
3324,雙鴻,628,15,613,摩根大通,2024-05-24,8440
2889,國票金,1163,557,606,摩根大通,2024-05-24,8440
3260,威剛,648,72,576,摩根大通,2024-05-24,8440
4967,十銓,624,68,556,摩根大通,2024-05-24,8440
2352,佳世達,1186,631,555,摩根大通,2024-05-24,8440
2404,漢唐,663,124,539,摩根大通,2024-05-24,8440
2890,永豐金,1940,1417,523,摩根大通,2024-05-24,8440
3005,神基,752,247,505,摩根大通,2024-05-24,8440
2611,志信,612,126,486,摩根大通,2024-05-24,8440
2312,金寶,493,66,427,摩根大通,2024-05-24,8440
9904,寶成,620,200,420,摩根大通,2024-05-24,8440
8027,鈦昇,423,11,412,摩根大通,2024-05-24,8440
3605,宏致,555,176,379,摩根大通,2024-05-24,8440
2897,王道銀行,398,28,370,摩根大通,2024-05-24,8440
2409,友達,6277,979,5298,摩根大通,2024-05-27,8440
2303,聯電,6726,2597,4129,摩根大通,2024-05-27,8440
2890,永豐金,3994,688,3306,摩根大通,2024-05-27,8440
1303,南亞,5639,2891,2748,摩根大通,2024-05-27,8440
0056,元大高股息,2500,0,2500,摩根大通,2024-05-27,8440
2347,聯強,3232,890,2342,摩根大通,2024-05-27,8440
2356,英業達,2779,449,2330,摩根大通,2024-05-27,8440
2885,元大金,2448,216,2232,摩根大通,2024-05-27,8440
3711,日月光投控,2785,562,2223,摩根大通,2024-05-27,8440
9105,泰金寶-DR,2588,709,1879,摩根大通,2024-05-27,8440
2382,廣達,2127,345,1782,摩根大通,2024-05-27,8440
5608,四維航,1461,25,1436,摩根大通,2024-05-27,8440
4906,正文,2062,642,1420,摩根大通,2024-05-27,8440
2308,台達電,2690,1316,1374,摩根大通,2024-05-27,8440
2609,陽明,1313,2,1311,摩根大通,2024-05-27,8440
2886,兆豐金,1475,183,1292,摩根大通,2024-05-27,8440
2641,正德,1282,7,1275,摩根大通,2024-05-27,8440
6189,豐藝,1343,90,1253,摩根大通,2024-05-27,8440
2301,光寶科,4306,3085,1221,摩根大通,2024-05-27,8440
1301,台塑,1494,381,1113,摩根大通,2024-05-27,8440
2324,仁寶,1960,1027,933,摩根大通,2024-05-27,8440
3712,永崴投控,959,163,796,摩根大通,2024-05-27,8440
1216,統一,2014,1238,776,摩根大通,2024-05-27,8440
2331,精英,901,133,768,摩根大通,2024-05-27,8440
2607,榮運,814,94,720,摩根大通,2024-05-27,8440
2357,華碩,1015,332,683,摩根大通,2024-05-27,8440
6207,雷科,656,53,603,摩根大通,2024-05-27,8440
2605,新興,663,63,600,摩根大通,2024-05-27,8440
3481,群創,1273,694,579,摩根大通,2024-05-27,8440
2371,大同,729,179,550,摩根大通,2024-05-27,8440
6239,力成,542,41,501,摩根大通,2024-05-27,8440
1609,大亞,651,161,490,摩根大通,2024-05-27,8440
3694,海華,615,130,485,摩根大通,2024-05-27,8440
2208,台船,575,94,481,摩根大通,2024-05-27,8440
3576,聯合再生,469,1,468,摩根大通,2024-05-27,8440
8234,新漢,468,22,446,摩根大通,2024-05-27,8440
3231,緯創,1138,708,430,摩根大通,2024-05-27,8440
2405,輔信,1544,1115,429,摩根大通,2024-05-27,8440
5230,雷笛克光學,564,151,413,摩根大通,2024-05-27,8440
2338,光罩,492,95,397,摩根大通,2024-05-27,8440
3702,大聯大,674,295,379,摩根大通,2024-05-27,8440
2345,智邦,519,163,356,摩根大通,2024-05-27,8440
2329,華泰,370,16,354,摩根大通,2024-05-27,8440
2312,金寶,392,46,346,摩根大通,2024-05-27,8440
2542,興富發,378,35,343,摩根大通,2024-05-27,8440
3024,憶聲,403,69,334,摩根大通,2024-05-27,8440
2421,建準,337,7,330,摩根大通,2024-05-27,8440
8050,廣積,329,1,328,摩根大通,2024-05-27,8440
2323,中環,353,27,326,摩根大通,2024-05-27,8440
2379,瑞昱,323,33,290,摩根大通,2024-05-27,8440
2618,長榮航,6094,1882,4212,摩根大通,2024-05-28,8440
2610,華航,4613,600,4013,摩根大通,2024-05-28,8440
1303,南亞,5658,1898,3760,摩根大通,2024-05-28,8440
2890,永豐金,5067,1585,3482,摩根大通,2024-05-28,8440
2885,元大金,4234,930,3304,摩根大通,2024-05-28,8440
2883,凱基金,4401,1411,2990,摩根大通,2024-05-28,8440
5608,四維航,3078,105,2973,摩根大通,2024-05-28,8440
9941,裕融,2851,21,2830,摩根大通,2024-05-28,8440
2888,新光金,3675,895,2780,摩根大通,2024-05-28,8440
2337,旺宏,2628,24,2604,摩根大通,2024-05-28,8440
2356,英業達,3417,814,2603,摩根大通,2024-05-28,8440
2641,正德,3432,1146,2286,摩根大通,2024-05-28,8440
2317,鴻海,7236,5203,2033,摩根大通,2024-05-28,8440
3450,聯鈞,2385,565,1820,摩根大通,2024-05-28,8440
2324,仁寶,3108,1379,1729,摩根大通,2024-05-28,8440
2323,中環,1764,86,1678,摩根大通,2024-05-28,8440
2401,凌陽,2029,394,1635,摩根大通,2024-05-28,8440
1301,台塑,2040,492,1548,摩根大通,2024-05-28,8440
2360,致茂,1539,86,1453,摩根大通,2024-05-28,8440
2515,中工,1525,108,1417,摩根大通,2024-05-28,8440
2409,友達,1990,657,1333,摩根大通,2024-05-28,8440
1605,華新,1544,225,1319,摩根大通,2024-05-28,8440
6125,廣運,2034,726,1308,摩根大通,2024-05-28,8440
8064,東捷,1691,499,1192,摩根大通,2024-05-28,8440
5426,振發,1056,0,1056,摩根大通,2024-05-28,8440
2014,中鴻,1021,53,968,摩根大通,2024-05-28,8440
3702,大聯大,1159,197,962,摩根大通,2024-05-28,8440
6120,達運,908,58,850,摩根大通,2024-05-28,8440
5351,鈺創,886,47,839,摩根大通,2024-05-28,8440
1802,台玻,915,85,830,摩根大通,2024-05-28,8440
2886,兆豐金,1762,934,828,摩根大通,2024-05-28,8440
1524,耿鼎,842,45,797,摩根大通,2024-05-28,8440
2344,華邦電,1242,450,792,摩根大通,2024-05-28,8440
9105,泰金寶-DR,867,76,791,摩根大通,2024-05-28,8440
2408,南亞科,991,236,755,摩根大通,2024-05-28,8440
2367,燿華,911,162,749,摩根大通,2024-05-28,8440
4919,新唐,883,134,749,摩根大通,2024-05-28,8440
2486,一詮,1096,349,747,摩根大通,2024-05-28,8440
2882,國泰金,1541,800,741,摩根大通,2024-05-28,8440
2349,錸德,751,18,733,摩根大通,2024-05-28,8440
3712,永崴投控,931,261,670,摩根大通,2024-05-28,8440
2542,興富發,635,2,633,摩根大通,2024-05-28,8440
2614,東森,598,0,598,摩根大通,2024-05-28,8440
3042,晶技,575,33,542,摩根大通,2024-05-28,8440
1785,光洋科,555,32,523,摩根大通,2024-05-28,8440
9904,寶成,997,481,516,摩根大通,2024-05-28,8440
9919,康那香,550,35,515,摩根大通,2024-05-28,8440
2897,王道銀行,658,153,505,摩根大通,2024-05-28,8440
2308,台達電,1105,601,504,摩根大通,2024-05-28,8440
3673,TPK-KY,515,12,503,摩根大通,2024-05-28,8440
2347,聯強,4030,201,3829,摩根大通,2024-05-29,8440
3037,欣興,4216,460,3756,摩根大通,2024-05-29,8440
1303,南亞,4041,481,3560,摩根大通,2024-05-29,8440
0056,元大高股息,3000,0,3000,摩根大通,2024-05-29,8440
2354,鴻準,2951,795,2156,摩根大通,2024-05-29,8440
2382,廣達,2162,646,1516,摩根大通,2024-05-29,8440
2489,瑞軒,2600,1158,1442,摩根大通,2024-05-29,8440
2353,宏��,2957,1671,1286,摩根大通,2024-05-29,8440
4967,十銓,1239,283,956,摩根大通,2024-05-29,8440
1513,中興電,1032,131,901,摩根大通,2024-05-29,8440
9941,裕融,879,41,838,摩根大通,2024-05-29,8440
2356,英業達,1581,768,813,摩根大通,2024-05-29,8440
1504,東元,976,170,806,摩根大通,2024-05-29,8440
6770,力積電,1653,867,786,摩根大通,2024-05-29,8440
2105,正新,1275,515,760,摩根大通,2024-05-29,8440
2542,興富發,781,28,753,摩根大通,2024-05-29,8440
3481,群創,1057,351,706,摩根大通,2024-05-29,8440
4906,正文,678,0,678,摩根大通,2024-05-29,8440
8054,安國,642,5,637,摩根大通,2024-05-29,8440
2337,旺宏,682,54,628,摩根大通,2024-05-29,8440
6117,迎廣,1297,694,603,摩根大通,2024-05-29,8440
4714,永捷,873,297,576,摩根大通,2024-05-29,8440
1524,耿鼎,768,208,560,摩根大通,2024-05-29,8440
1582,信錦,597,40,557,摩根大通,2024-05-29,8440
2330,台積電,2448,1904,544,摩根大通,2024-05-29,8440
2495,普安,1038,494,544,摩根大通,2024-05-29,8440
4938,和碩,567,26,541,摩根大通,2024-05-29,8440
1785,光洋科,765,259,506,摩根大通,2024-05-29,8440
6275,元山,535,31,504,摩根大通,2024-05-29,8440
3042,晶技,560,76,484,摩根大通,2024-05-29,8440
3047,訊舟,759,295,464,摩根大通,2024-05-29,8440
6239,力成,544,81,463,摩根大通,2024-05-29,8440
1522,堤維西,534,76,458,摩根大通,2024-05-29,8440
6285,啟��,547,105,442,摩根大通,2024-05-29,8440
2601,益航,408,0,408,摩根大通,2024-05-29,8440
4532,瑞智,405,1,404,摩根大通,2024-05-29,8440
8096,擎亞,879,475,404,摩根大通,2024-05-29,8440
2349,錸德,990,588,402,摩根大通,2024-05-29,8440
6120,達運,404,9,395,摩根大通,2024-05-29,8440
2393,億光,495,109,386,摩根大通,2024-05-29,8440
1815,富喬,741,362,379,摩根大通,2024-05-29,8440
5351,鈺創,376,12,364,摩根大通,2024-05-29,8440
3537,堡達,420,58,362,摩根大通,2024-05-29,8440
3712,永崴投控,558,208,350,摩根大通,2024-05-29,8440
2454,聯發科,551,202,349,摩根大通,2024-05-29,8440
1809,中釉,412,68,344,摩根大通,2024-05-29,8440
5531,鄉林,355,16,339,摩根大通,2024-05-29,8440
2027,大成鋼,433,116,317,摩根大通,2024-05-29,8440
2405,輔信,658,350,308,摩根大通,2024-05-29,8440
3313,斐成,438,133,305,摩根大通,2024-05-29,8440
2347,聯強,15996,1923,14073,摩根大通,2024-05-30,8440
2882,國泰金,5931,611,5320,摩根大通,2024-05-30,8440
6770,力積電,3724,1141,2583,摩根大通,2024-05-30,8440
2890,永豐金,4847,2655,2192,摩根大通,2024-05-30,8440
3711,日月光投控,2439,378,2061,摩根大通,2024-05-30,8440
2609,陽明,2551,499,2052,摩根大通,2024-05-30,8440
2486,一詮,2328,302,2026,摩根大通,2024-05-30,8440
2412,中華電,2283,688,1595,摩根大通,2024-05-30,8440
3481,群創,2175,650,1525,摩根大通,2024-05-30,8440
1504,東元,1585,82,1503,摩根大通,2024-05-30,8440
2884,玉山金,2776,1301,1475,摩根大通,2024-05-30,8440
2887,台新金,2495,1029,1466,摩根大通,2024-05-30,8440
3005,神基,1892,658,1234,摩根大通,2024-05-30,8440
3033,威健,1559,342,1217,摩根大通,2024-05-30,8440
2385,群光,1237,166,1071,摩根大通,2024-05-30,8440
2360,致茂,1082,73,1009,摩根大通,2024-05-30,8440
1301,台塑,1595,593,1002,摩根大通,2024-05-30,8440
2801,彰銀,2506,1512,994,摩根大通,2024-05-30,8440
3044,健鼎,1072,79,993,摩根大通,2024-05-30,8440
2379,瑞昱,989,62,927,摩根大通,2024-05-30,8440
6125,廣運,1538,618,920,摩根大通,2024-05-30,8440
2377,微星,1361,455,906,摩根大通,2024-05-30,8440
4915,致伸,968,78,890,摩根大通,2024-05-30,8440
3231,緯創,1388,539,849,摩根大通,2024-05-30,8440
2886,兆豐金,4907,4139,768,摩根大通,2024-05-30,8440
1303,南亞,4895,4152,743,摩根大通,2024-05-30,8440
2449,京元電子,1136,396,740,摩根大通,2024-05-30,8440
2367,燿華,1122,394,728,摩根大通,2024-05-30,8440
2618,長榮航,1867,1148,719,摩根大通,2024-05-30,8440
2376,技嘉,919,211,708,摩根大通,2024-05-30,8440
1513,中興電,724,18,706,摩根大通,2024-05-30,8440
1402,遠東新,1613,923,690,摩根大通,2024-05-30,8440
2454,聯發科,1175,541,634,摩根大通,2024-05-30,8440
4906,正文,809,246,563,摩根大通,2024-05-30,8440
2317,鴻海,3957,3408,549,摩根大通,2024-05-30,8440
1442,名軒,532,11,521,摩根大通,2024-05-30,8440
5608,四維航,1113,622,491,摩根大通,2024-05-30,8440
2845,遠東銀,706,233,473,摩根大通,2024-05-30,8440
9904,寶成,630,208,422,摩根大通,2024-05-30,8440
2834,臺企銀,1004,588,416,摩根大通,2024-05-30,8440
2880,華南金,1780,1375,405,摩根大通,2024-05-30,8440
4532,瑞智,400,1,399,摩根大通,2024-05-30,8440
1722,台肥,605,220,385,摩根大通,2024-05-30,8440
6147,頎邦,774,406,368,摩根大通,2024-05-30,8440
3060,銘異,402,35,367,摩根大通,2024-05-30,8440
3045,台灣大,1154,800,354,摩根大通,2024-05-30,8440
2337,旺宏,362,25,337,摩根大通,2024-05-30,8440
3062,建漢,350,14,336,摩根大通,2024-05-30,8440
1785,光洋科,911,587,324,摩根大通,2024-05-30,8440
2101,南港,384,66,318,摩根大通,2024-05-30,8440
2888,新光金,37802,3299,34503,摩根大通,2024-05-31,8440
3481,群創,29487,11719,17768,摩根大通,2024-05-31,8440
2890,永豐金,29824,12631,17193,摩根大通,2024-05-31,8440
2834,臺企銀,13865,974,12891,摩根大通,2024-05-31,8440
2884,玉山金,24134,13110,11024,摩根大通,2024-05-31,8440
1303,南亞,14098,3406,10692,摩根大通,2024-05-31,8440
2618,長榮航,13280,5019,8261,摩根大通,2024-05-31,8440
2367,燿華,11879,3865,8014,摩根大通,2024-05-31,8440
2610,華航,9933,3001,6932,摩根大通,2024-05-31,8440
2867,三商壽,8003,1668,6335,摩根大通,2024-05-31,8440
2885,元大金,7521,1254,6267,摩根大通,2024-05-31,8440
2347,聯強,8042,2532,5510,摩根大通,2024-05-31,8440
2883,凱基金,9022,3547,5475,摩根大通,2024-05-31,8440
1216,統一,8307,2910,5397,摩根大通,2024-05-31,8440
1101,台泥,6200,1040,5160,摩根大通,2024-05-31,8440
3711,日月光投控,6034,1477,4557,摩根大通,2024-05-31,8440
2801,彰銀,3923,80,3843,摩根大通,2024-05-31,8440
8936,國統,4850,1008,3842,摩根大通,2024-05-31,8440
2409,友達,5757,1959,3798,摩根大通,2024-05-31,8440
1608,華榮,5614,1904,3710,摩根大通,2024-05-31,8440
2605,新興,3944,557,3387,摩根大通,2024-05-31,8440
9904,寶成,3938,691,3247,摩根大通,2024-05-31,8440
6177,達麗,4638,1427,3211,摩根大通,2024-05-31,8440
1504,東元,3427,403,3024,摩根大通,2024-05-31,8440
2385,群光,2781,328,2453,摩根大通,2024-05-31,8440
2881,富邦金,8038,5588,2450,摩根大通,2024-05-31,8440
2308,台達電,7111,4703,2408,摩根大通,2024-05-31,8440
1319,東陽,2253,17,2236,摩根大通,2024-05-31,8440
2882,國泰金,9657,7547,2110,摩根大通,2024-05-31,8440
2312,金寶,2140,38,2102,摩根大通,2024-05-31,8440
1314,中石化,2421,371,2050,摩根大通,2024-05-31,8440
1605,華新,4000,2083,1917,摩根大通,2024-05-31,8440
8069,元太,2580,680,1900,摩根大通,2024-05-31,8440
1326,台化,3172,1274,1898,摩根大通,2024-05-31,8440
6189,豐藝,3456,1582,1874,摩根大通,2024-05-31,8440
3005,神基,2518,704,1814,摩根大通,2024-05-31,8440
6116,彩晶,1994,229,1765,摩根大通,2024-05-31,8440
3036,文曄,1992,230,1762,摩根大通,2024-05-31,8440
2382,廣達,2844,1154,1690,摩根大通,2024-05-31,8440
2812,台中銀,1796,125,1671,摩根大通,2024-05-31,8440
2486,一詮,2357,689,1668,摩根大通,2024-05-31,8440
2353,宏��,6726,5103,1623,摩根大通,2024-05-31,8440
2023,燁輝,1738,124,1614,摩根大通,2024-05-31,8440
2337,旺宏,1632,111,1521,摩根大通,2024-05-31,8440
1717,長興,1571,71,1500,摩根大通,2024-05-31,8440
2009,第一銅,2388,904,1484,摩根大通,2024-05-31,8440
2349,錸德,1532,118,1414,摩根大通,2024-05-31,8440
2301,光寶科,7602,6203,1399,摩根大通,2024-05-31,8440
6147,頎邦,1610,228,1382,摩根大通,2024-05-31,8440
2537,聯上發,1409,28,1381,摩根大通,2024-05-31,8440
2609,陽明,16250,4659,11591,摩根大通,2024-06-03,8440
2890,永豐金,8749,642,8107,摩根大通,2024-06-03,8440
2886,兆豐金,5517,397,5120,摩根大通,2024-06-03,8440
2347,聯強,4701,573,4128,摩根大通,2024-06-03,8440
2356,英業達,3936,988,2948,摩根大通,2024-06-03,8440
2317,鴻海,4376,1580,2796,摩根大通,2024-06-03,8440
1303,南亞,2841,170,2671,摩根大通,2024-06-03,8440
6147,頎邦,2591,196,2395,摩根大通,2024-06-03,8440
2449,京元電子,2618,312,2306,摩根大通,2024-06-03,8440
3005,神基,2423,151,2272,摩根大通,2024-06-03,8440
2379,瑞昱,2527,431,2096,摩根大通,2024-06-03,8440
1504,東元,2551,743,1808,摩根大通,2024-06-03,8440
8096,擎亞,1813,25,1788,摩根大通,2024-06-03,8440
4915,致伸,1789,69,1720,摩根大通,2024-06-03,8440
2385,群光,2389,707,1682,摩根大通,2024-06-03,8440
3264,欣銓,1481,46,1435,摩根大通,2024-06-03,8440
2330,台積電,2196,942,1254,摩根大通,2024-06-03,8440
3036,文曄,1282,68,1214,摩根大通,2024-06-03,8440
1319,東陽,1441,261,1180,摩根大通,2024-06-03,8440
2427,三商電,1674,520,1154,摩根大通,2024-06-03,8440
3711,日月光投控,1627,562,1065,摩根大通,2024-06-03,8440
2537,聯上發,1865,830,1035,摩根大通,2024-06-03,8440
4533,協易機,1175,176,999,摩根大通,2024-06-03,8440
2383,台光電,1015,40,975,摩根大通,2024-06-03,8440
2603,長榮,2012,1043,969,摩根大通,2024-06-03,8440
3044,健鼎,1069,176,893,摩根大通,2024-06-03,8440
4938,和碩,2363,1489,874,摩根大通,2024-06-03,8440
2892,第一金,1210,401,809,摩根大通,2024-06-03,8440
6274,台燿,1041,249,792,摩根大通,2024-06-03,8440
3293,鈊象,825,64,761,摩根大通,2024-06-03,8440
1722,台肥,966,240,726,摩根大通,2024-06-03,8440
2881,富邦金,1119,479,640,摩根大通,2024-06-03,8440
5483,中美晶,860,233,627,摩根大通,2024-06-03,8440
6285,啟��,806,200,606,摩根大通,2024-06-03,8440
1582,信錦,1209,625,584,摩根大通,2024-06-03,8440
2542,興富發,625,45,580,摩根大通,2024-06-03,8440
2049,上銀,575,34,541,摩根大通,2024-06-03,8440
1513,中興電,570,41,529,摩根大通,2024-06-03,8440
6197,佳必琪,641,119,522,摩根大通,2024-06-03,8440
2324,仁寶,1756,1236,520,摩根大通,2024-06-03,8440
2888,新光金,8165,7652,513,摩根大通,2024-06-03,8440
2501,國建,589,86,503,摩根大通,2024-06-03,8440
2308,台達電,586,120,466,摩根大通,2024-06-03,8440
4909,新復興,477,25,452,摩根大通,2024-06-03,8440
2615,萬海,3202,2750,452,摩根大通,2024-06-03,8440
8016,矽創,511,60,451,摩根大通,2024-06-03,8440
3702,大聯大,706,259,447,摩根大通,2024-06-03,8440
2368,金像電,504,58,446,摩根大通,2024-06-03,8440
2882,國泰金,623,178,445,摩根大通,2024-06-03,8440
5531,鄉林,673,262,411,摩根大通,2024-06-03,8440
2890,永豐金,8756,3622,5134,摩根大通,2024-06-04,8440
2347,聯強,4356,359,3997,摩根大通,2024-06-04,8440
6125,廣運,6618,2660,3958,摩根大通,2024-06-04,8440
2486,一詮,3151,474,2677,摩根大通,2024-06-04,8440
2886,兆豐金,6450,3918,2532,摩根大通,2024-06-04,8440
1303,南亞,3870,1374,2496,摩根大通,2024-06-04,8440
6147,頎邦,2319,159,2160,摩根大通,2024-06-04,8440
2609,陽明,3912,2270,1642,摩根大通,2024-06-04,8440
3005,神基,1820,499,1321,摩根大通,2024-06-04,8440
4726,永昕,1250,74,1176,摩根大通,2024-06-04,8440
3264,欣銓,1276,110,1166,摩根大通,2024-06-04,8440
1504,東元,2309,1244,1065,摩根大通,2024-06-04,8440
4906,正文,1125,108,1017,摩根大通,2024-06-04,8440
2317,鴻海,7198,6221,977,摩根大通,2024-06-04,8440
4915,致伸,1026,156,870,摩根大通,2024-06-04,8440
3047,訊舟,1080,264,816,摩根大通,2024-06-04,8440
3231,緯創,1441,646,795,摩根大通,2024-06-04,8440
5371,中光電,821,43,778,摩根大通,2024-06-04,8440
2331,精英,2073,1296,777,摩根大通,2024-06-04,8440
2867,三商壽,1473,723,750,摩根大通,2024-06-04,8440
2501,國建,811,104,707,摩根大通,2024-06-04,8440
3711,日月光投控,1533,852,681,摩根大通,2024-06-04,8440
1314,中石化,783,132,651,摩根大通,2024-06-04,8440
2101,南港,1182,544,638,摩根大通,2024-06-04,8440
2354,鴻準,1538,963,575,摩根大通,2024-06-04,8440
8234,新漢,1205,640,565,摩根大通,2024-06-04,8440
2520,冠德,868,316,552,摩根大通,2024-06-04,8440
2360,致茂,558,18,540,摩根大通,2024-06-04,8440
2308,台達電,1072,536,536,摩根大通,2024-06-04,8440
1722,台肥,758,243,515,摩根大通,2024-06-04,8440
6188,廣明,549,64,485,摩根大通,2024-06-04,8440
3592,瑞鼎,503,54,449,摩根大通,2024-06-04,8440
8926,台汽電,474,37,437,摩根大通,2024-06-04,8440
2637,慧洋-KY,486,50,436,摩根大通,2024-06-04,8440
6117,迎廣,1384,952,432,摩根大通,2024-06-04,8440
3293,鈊象,474,56,418,摩根大通,2024-06-04,8440
6538,倉和,415,8,407,摩根大通,2024-06-04,8440
1784,訊聯,411,6,405,摩根大通,2024-06-04,8440
2915,潤泰全,430,28,402,摩根大通,2024-06-04,8440
0050,元大台灣50,393,0,393,摩根大通,2024-06-04,8440
3033,威健,580,218,362,摩根大通,2024-06-04,8440
2395,研華,507,147,360,摩根大通,2024-06-04,8440
1582,信錦,453,96,357,摩根大通,2024-06-04,8440
2404,漢唐,369,13,356,摩根大通,2024-06-04,8440
3338,泰碩,401,66,335,摩根大通,2024-06-04,8440
4167,松瑞藥,341,22,319,摩根大通,2024-06-04,8440
3044,健鼎,609,294,315,摩根大通,2024-06-04,8440
2353,宏��,2180,1884,296,摩根大通,2024-06-04,8440
9934,成霖,329,43,286,摩根大通,2024-06-04,8440
2421,建準,385,101,284,摩根大通,2024-06-04,8440
2609,陽明,6374,2470,3904,摩根大通,2024-06-05,8440
1504,東元,2725,467,2258,摩根大通,2024-06-05,8440
4123,晟德,1723,169,1554,摩根大通,2024-06-05,8440
6147,頎邦,1060,100,960,摩根大通,2024-06-05,8440
2317,鴻海,6327,5377,950,摩根大通,2024-06-05,8440
2501,國建,863,104,759,摩根大通,2024-06-05,8440
2312,金寶,878,150,728,摩根大通,2024-06-05,8440
2489,瑞軒,874,182,692,摩根大通,2024-06-05,8440
3017,奇鋐,742,219,523,摩根大通,2024-06-05,8440
2360,致茂,517,5,512,摩根大通,2024-06-05,8440
3260,威剛,570,58,512,摩根大通,2024-06-05,8440
3231,緯創,1167,656,511,摩根大通,2024-06-05,8440
3005,神基,962,478,484,摩根大通,2024-06-05,8440
9958,世紀鋼,473,3,470,摩根大通,2024-06-05,8440
2641,正德,558,88,470,摩根大通,2024-06-05,8440
3708,上緯投控,607,145,462,摩根大通,2024-06-05,8440
2542,興富發,424,0,424,摩根大通,2024-06-05,8440
2393,億光,475,65,410,摩根大通,2024-06-05,8440
6161,捷波,922,528,394,摩根大通,2024-06-05,8440
2897,王道銀行,397,11,386,摩根大通,2024-06-05,8440
4566,時碩工業,442,71,371,摩根大通,2024-06-05,8440
6177,達麗,373,21,352,摩根大通,2024-06-05,8440
3044,健鼎,425,74,351,摩根大通,2024-06-05,8440
5371,中光電,563,212,351,摩根大通,2024-06-05,8440
6231,系微,318,0,318,摩根大通,2024-06-05,8440
3045,台灣大,940,625,315,摩根大通,2024-06-05,8440
4966,譜瑞-KY,390,118,272,摩根大通,2024-06-05,8440
8085,福華,380,110,270,摩根大通,2024-06-05,8440
4543,萬在,377,112,265,摩根大通,2024-06-05,8440
3293,鈊象,280,18,262,摩根大通,2024-06-05,8440
2464,盟立,484,223,261,摩根大通,2024-06-05,8440
3055,蔚華科,323,65,258,摩根大通,2024-06-05,8440
2495,普安,316,72,244,摩根大通,2024-06-05,8440
0050,元大台灣50,241,0,241,摩根大通,2024-06-05,8440
2915,潤泰全,289,53,236,摩根大通,2024-06-05,8440
6244,茂迪,364,129,235,摩根大通,2024-06-05,8440
1477,聚陽,285,62,223,摩根大通,2024-06-05,8440
2365,昆盈,232,11,221,摩根大通,2024-06-05,8440
2606,裕民,340,125,215,摩根大通,2024-06-05,8440
9941,裕融,231,16,215,摩根大通,2024-06-05,8440
3592,瑞鼎,273,60,213,摩根大通,2024-06-05,8440
4167,松瑞藥,272,62,210,摩根大通,2024-06-05,8440
1110,東泥,217,16,201,摩根大通,2024-06-05,8440
1455,集盛,333,135,198,摩根大通,2024-06-05,8440
6605,帝寶,219,28,191,摩根大通,2024-06-05,8440
1722,台肥,346,159,187,摩根大通,2024-06-05,8440
1314,中石化,623,440,183,摩根大通,2024-06-05,8440
6472,保瑞,189,12,177,摩根大通,2024-06-05,8440
4128,中天,184,7,177,摩根大通,2024-06-05,8440
8358,金居,208,32,176,摩根大通,2024-06-05,8440
2883,凱基金,48911,1057,47854,摩根大通,2024-06-06,8440
2882,國泰金,6679,206,6473,摩根大通,2024-06-06,8440
2610,華航,3411,302,3109,摩根大通,2024-06-06,8440
2105,正新,2430,531,1899,摩根大通,2024-06-06,8440
2881,富邦金,2194,431,1763,摩根大通,2024-06-06,8440
2520,冠德,1616,139,1477,摩根大通,2024-06-06,8440
1504,東元,1861,390,1471,摩根大通,2024-06-06,8440
2887,台新金,3834,2364,1470,摩根大通,2024-06-06,8440
2886,兆豐金,1845,607,1238,摩根大通,2024-06-06,8440
1802,台玻,1270,244,1026,摩根大通,2024-06-06,8440
2312,金寶,1877,859,1018,摩根大通,2024-06-06,8440
9105,泰金寶-DR,2041,1123,918,摩根大通,2024-06-06,8440
2356,英業達,1865,952,913,摩根大通,2024-06-06,8440
2345,智邦,1319,485,834,摩根大通,2024-06-06,8440
2303,聯電,1186,382,804,摩根大通,2024-06-06,8440
2890,永豐金,1645,868,777,摩根大通,2024-06-06,8440
2330,台積電,4183,3470,713,摩根大通,2024-06-06,8440
3045,台灣大,846,220,626,摩根大通,2024-06-06,8440
2615,萬海,2420,1858,562,摩根大通,2024-06-06,8440
4562,穎漢,555,44,511,摩根大通,2024-06-06,8440
2915,潤泰全,563,77,486,摩根大通,2024-06-06,8440
2617,台航,506,29,477,摩根大通,2024-06-06,8440
3564,其陽,848,416,432,摩根大通,2024-06-06,8440
2618,長榮航,6521,6093,428,摩根大通,2024-06-06,8440
1609,大亞,522,149,373,摩根大通,2024-06-06,8440
2501,國建,741,373,368,摩根大通,2024-06-06,8440
2606,裕民,635,270,365,摩根大通,2024-06-06,8440
1587,吉茂,394,46,348,摩根大通,2024-06-06,8440
1319,東陽,368,22,346,摩根大通,2024-06-06,8440
6147,頎邦,472,126,346,摩根大通,2024-06-06,8440
2417,圓剛,302,0,302,摩根大通,2024-06-06,8440
2367,燿華,1012,717,295,摩根大通,2024-06-06,8440
2454,聯發科,725,434,291,摩根大通,2024-06-06,8440
2855,統一證,305,17,288,摩根大通,2024-06-06,8440
9103,美德醫療-DR,294,10,284,摩根大通,2024-06-06,8440
2379,瑞昱,554,275,279,摩根大通,2024-06-06,8440
1301,台塑,774,500,274,摩根大通,2024-06-06,8440
3044,健鼎,363,89,274,摩根大通,2024-06-06,8440
9941,裕融,280,20,260,摩根大通,2024-06-06,8440
4904,遠傳,472,212,260,摩根大通,2024-06-06,8440
2405,輔信,279,28,251,摩根大通,2024-06-06,8440
3017,奇鋐,636,386,250,摩根大通,2024-06-06,8440
2641,正德,459,211,248,摩根大通,2024-06-06,8440
3260,威剛,370,125,245,摩根大通,2024-06-06,8440
2603,長榮,1489,1244,245,摩根大通,2024-06-06,8440
4966,譜瑞-KY,264,30,234,摩根大通,2024-06-06,8440
3293,鈊象,315,92,223,摩根大通,2024-06-06,8440
9945,潤泰新,271,60,211,摩根大通,2024-06-06,8440
6546,正基,343,132,211,摩根大通,2024-06-06,8440
2542,興富發,235,34,201,摩根大通,2024-06-06,8440
2888,新光金,18621,3358,15263,摩根大通,2024-06-07,8440
2609,陽明,8690,1845,6845,摩根大通,2024-06-07,8440
2610,華航,5543,532,5011,摩根大通,2024-06-07,8440
2515,中工,4218,143,4075,摩根大通,2024-06-07,8440
2867,三商壽,4024,138,3886,摩根大通,2024-06-07,8440
1314,中石化,3702,0,3702,摩根大通,2024-06-07,8440
1815,富喬,3773,379,3394,摩根大通,2024-06-07,8440
9105,泰金寶-DR,3898,1363,2535,摩根大通,2024-06-07,8440
2409,友達,3100,676,2424,摩根大通,2024-06-07,8440
6770,力積電,4050,1695,2355,摩根大通,2024-06-07,8440
2501,國建,3099,862,2237,摩根大通,2024-06-07,8440
4714,永捷,2483,284,2199,摩根大通,2024-06-07,8440
2834,臺企銀,2997,940,2057,摩根大通,2024-06-07,8440
2317,鴻海,3370,1330,2040,摩根大通,2024-06-07,8440
2897,王道銀行,2138,126,2012,摩根大通,2024-06-07,8440
2883,凱基金,6327,4337,1990,摩根大通,2024-06-07,8440
1455,集盛,2027,38,1989,摩根大通,2024-06-07,8440
1504,東元,2219,512,1707,摩根大通,2024-06-07,8440
2542,興富發,1719,13,1706,摩根大通,2024-06-07,8440
2406,國碩,1655,72,1583,摩根大通,2024-06-07,8440
9945,潤泰新,1663,168,1495,摩根大通,2024-06-07,8440
8926,台汽電,1502,69,1433,摩根大通,2024-06-07,8440
2506,太設,1479,58,1421,摩根大通,2024-06-07,8440
2511,太子,1360,9,1351,摩根大通,2024-06-07,8440
2606,裕民,1533,203,1330,摩根大通,2024-06-07,8440
9958,世紀鋼,1508,265,1243,摩根大通,2024-06-07,8440
2615,萬海,1981,752,1229,摩根大通,2024-06-07,8440
2801,彰銀,1334,136,1198,摩根大通,2024-06-07,8440
4306,炎洲,1358,172,1186,摩根大通,2024-06-07,8440
3059,華晶科,1178,49,1129,摩根大通,2024-06-07,8440
5512,力麒,1074,29,1045,摩根大通,2024-06-07,8440
3056,富華新,1103,65,1038,摩根大通,2024-06-07,8440
3045,台灣大,1082,58,1024,摩根大通,2024-06-07,8440
1453,大將,1028,127,901,摩根大通,2024-06-07,8440
1447,力鵬,982,112,870,摩根大通,2024-06-07,8440
2886,兆豐金,1896,1027,869,摩根大通,2024-06-07,8440
4967,十銓,953,123,830,摩根大通,2024-06-07,8440
2486,一詮,1245,418,827,摩根大通,2024-06-07,8440
1402,遠東新,1073,257,816,摩根大通,2024-06-07,8440
2881,富邦金,953,141,812,摩根大通,2024-06-07,8440
3005,神基,872,91,781,摩根大通,2024-06-07,8440
2025,千興,791,24,767,摩根大通,2024-06-07,8440
5519,隆大,872,113,759,摩根大通,2024-06-07,8440
2617,台航,792,39,753,摩根大通,2024-06-07,8440
6190,萬泰科,798,69,729,摩根大通,2024-06-07,8440
6207,雷科,826,105,721,摩根大通,2024-06-07,8440
1612,宏泰,934,221,713,摩根大通,2024-06-07,8440
2547,日勝生,743,31,712,摩根大通,2024-06-07,8440
2836,高雄銀,682,0,682,摩根大通,2024-06-07,8440
1714,和桐,656,0,656,摩根大通,2024-06-07,8440
6770,力積電,4275,330,3945,摩根大通,2024-06-11,8440
2883,凱基金,7501,3657,3844,摩根大通,2024-06-11,8440
2303,聯電,5427,3234,2193,摩根大通,2024-06-11,8440
2886,兆豐金,3093,1141,1952,摩根大通,2024-06-11,8440
6125,廣運,1994,396,1598,摩根大通,2024-06-11,8440
1303,南亞,1924,419,1505,摩根大通,2024-06-11,8440
2317,鴻海,5394,3954,1440,摩根大通,2024-06-11,8440
1402,遠東新,1771,365,1406,摩根大通,2024-06-11,8440
2356,英業達,2818,1733,1085,摩根大通,2024-06-11,8440
2347,聯強,2029,985,1044,摩根大通,2024-06-11,8440
2449,京元電子,1487,472,1015,摩根大通,2024-06-11,8440
3374,精材,1111,145,966,摩根大通,2024-06-11,8440
2454,聯發科,1262,333,929,摩根大通,2024-06-11,8440
3231,緯創,1169,430,739,摩根大通,2024-06-11,8440
2312,金寶,881,142,739,摩根大通,2024-06-11,8440
6147,頎邦,981,268,713,摩根大通,2024-06-11,8440
2897,王道銀行,985,285,700,摩根大通,2024-06-11,8440
2464,盟立,804,120,684,摩根大通,2024-06-11,8440
6282,康舒,741,65,676,摩根大通,2024-06-11,8440
2367,燿華,1366,691,675,摩根大通,2024-06-11,8440
6188,廣明,830,177,653,摩根大通,2024-06-11,8440
5876,上海商銀,991,348,643,摩根大通,2024-06-11,8440
3376,新日興,1192,571,621,摩根大通,2024-06-11,8440
3045,台灣大,935,325,610,摩根大通,2024-06-11,8440
8039,台虹,585,8,577,摩根大通,2024-06-11,8440
2610,華航,1061,502,559,摩根大通,2024-06-11,8440
1216,統一,917,374,543,摩根大通,2024-06-11,8440
3711,日月光投控,1157,616,541,摩根大通,2024-06-11,8440
3048,益登,543,18,525,摩根大通,2024-06-11,8440
3260,威剛,646,139,507,摩根大通,2024-06-11,8440
3005,神基,644,164,480,摩根大通,2024-06-11,8440
9907,統一實,564,84,480,摩根大通,2024-06-11,8440
3036,文曄,507,38,469,摩根大通,2024-06-11,8440
5871,中租-KY,569,103,466,摩根大通,2024-06-11,8440
3010,華立,480,14,466,摩根大通,2024-06-11,8440
1319,東陽,521,87,434,摩根大通,2024-06-11,8440
8069,元太,717,291,426,摩根大通,2024-06-11,8440
2377,微星,584,172,412,摩根大通,2024-06-11,8440
6213,聯茂,428,24,404,摩根大通,2024-06-11,8440
2409,友達,1378,977,401,摩根大通,2024-06-11,8440
1722,台肥,669,278,391,摩根大通,2024-06-11,8440
5351,鈺創,403,19,384,摩根大通,2024-06-11,8440
2330,台積電,4642,4265,377,摩根大通,2024-06-11,8440
1714,和桐,487,117,370,摩根大通,2024-06-11,8440
3017,奇鋐,1218,867,351,摩根大通,2024-06-11,8440
5522,遠雄,402,76,326,摩根大通,2024-06-11,8440
2379,瑞昱,417,101,316,摩根大通,2024-06-11,8440
3044,健鼎,415,119,296,摩根大通,2024-06-11,8440
3013,晟銘電,452,159,293,摩根大通,2024-06-11,8440
3293,鈊象,302,18,284,摩根大通,2024-06-11,8440
2330,台積電,7771,3097,4674,摩根大通,2024-06-12,8440
2609,陽明,5604,2986,2618,摩根大通,2024-06-12,8440
2885,元大金,2217,677,1540,摩根大通,2024-06-12,8440
6890,來億-KY,1461,0,1461,摩根大通,2024-06-12,8440
2367,燿華,1521,237,1284,摩根大通,2024-06-12,8440
2615,萬海,1836,588,1248,摩根大通,2024-06-12,8440
3622,洋華,1290,321,969,摩根大通,2024-06-12,8440
3481,群創,1508,546,962,摩根大通,2024-06-12,8440
2368,金像電,984,83,901,摩根大通,2024-06-12,8440
8028,昇陽半導體,860,175,685,摩根大通,2024-06-12,8440
1802,台玻,940,256,684,摩根大通,2024-06-12,8440
1216,統一,789,187,602,摩根大通,2024-06-12,8440
2383,台光電,715,123,592,摩根大通,2024-06-12,8440
3163,波若威,630,39,591,摩根大通,2024-06-12,8440
4958,臻鼎-KY,884,296,588,摩根大通,2024-06-12,8440
2476,鉅祥,623,63,560,摩根大通,2024-06-12,8440
1402,遠東新,1149,594,555,摩根大通,2024-06-12,8440
5608,四維航,794,251,543,摩根大通,2024-06-12,8440
0050,元大台灣50,565,25,540,摩根大通,2024-06-12,8440
3045,台灣大,571,58,513,摩根大通,2024-06-12,8440
3037,欣興,587,109,478,摩根大通,2024-06-12,8440
6274,台燿,491,34,457,摩根大通,2024-06-12,8440
8358,金居,645,197,448,摩根大通,2024-06-12,8440
6190,萬泰科,646,231,415,摩根大通,2024-06-12,8440
2637,慧洋-KY,520,107,413,摩根大通,2024-06-12,8440
3406,玉晶光,602,189,413,摩根大通,2024-06-12,8440
6213,聯茂,703,292,411,摩根大通,2024-06-12,8440
2312,金寶,635,239,396,摩根大通,2024-06-12,8440
4967,十銓,623,230,393,摩根大通,2024-06-12,8440
2880,華南金,981,593,388,摩根大通,2024-06-12,8440
1608,華榮,374,1,373,摩根大通,2024-06-12,8440
4909,新復興,451,83,368,摩根大通,2024-06-12,8440
2303,聯電,2305,1960,345,摩根大通,2024-06-12,8440
3122,笙泉,387,43,344,摩根大通,2024-06-12,8440
2379,瑞昱,375,32,343,摩根大通,2024-06-12,8440
8039,台虹,386,55,331,摩根大通,2024-06-12,8440
3010,華立,344,16,328,摩根大通,2024-06-12,8440
2351,順德,551,228,323,摩根大通,2024-06-12,8440
6180,橘子,316,6,310,摩根大通,2024-06-12,8440
3374,精材,940,634,306,摩根大通,2024-06-12,8440
2427,三商電,345,52,293,摩根大通,2024-06-12,8440
3044,健鼎,338,63,275,摩根大通,2024-06-12,8440
3715,定穎投控,348,75,273,摩根大通,2024-06-12,8440
1563,巧新,320,49,271,摩根大通,2024-06-12,8440
5392,能率,367,98,269,摩根大通,2024-06-12,8440
4966,譜瑞-KY,277,14,263,摩根大通,2024-06-12,8440
9958,世紀鋼,362,100,262,摩根大通,2024-06-12,8440
8069,元太,1160,902,258,摩根大通,2024-06-12,8440
5871,中租-KY,467,209,258,摩根大通,2024-06-12,8440
3005,神基,301,48,253,摩根大通,2024-06-12,8440
2303,聯電,11425,445,10980,摩根大通,2024-06-13,8440
6770,力積電,8252,295,7957,摩根大通,2024-06-13,8440
2330,台積電,5516,1445,4071,摩根大通,2024-06-13,8440
2486,一詮,2342,101,2241,摩根大通,2024-06-13,8440
1785,光洋科,2439,484,1955,摩根大通,2024-06-13,8440
3231,緯創,2086,292,1794,摩根大通,2024-06-13,8440
2801,彰銀,1641,158,1483,摩根大通,2024-06-13,8440
2317,鴻海,7134,5792,1342,摩根大通,2024-06-13,8440
1303,南亞,2558,1260,1298,摩根大通,2024-06-13,8440
2382,廣達,1474,195,1279,摩根大通,2024-06-13,8440
2353,宏��,2003,830,1173,摩根大通,2024-06-13,8440
3105,穩懋,1263,99,1164,摩根大通,2024-06-13,8440
2886,兆豐金,1751,693,1058,摩根大通,2024-06-13,8440
2347,聯強,1347,339,1008,摩根大通,2024-06-13,8440
2356,英業達,2393,1430,963,摩根大通,2024-06-13,8440
2883,凱基金,2903,1954,949,摩根大通,2024-06-13,8440
3045,台灣大,1022,80,942,摩根大通,2024-06-13,8440
5351,鈺創,904,4,900,摩根大通,2024-06-13,8440
2885,元大金,1233,375,858,摩根大通,2024-06-13,8440
1216,統一,1379,573,806,摩根大通,2024-06-13,8440
1609,大亞,825,38,787,摩根大通,2024-06-13,8440
9105,泰金寶-DR,1631,881,750,摩根大通,2024-06-13,8440
2357,華碩,779,37,742,摩根大通,2024-06-13,8440
0050,元大台灣50,739,0,739,摩根大通,2024-06-13,8440
2308,台達電,1513,819,694,摩根大通,2024-06-13,8440
2881,富邦金,777,90,687,摩根大通,2024-06-13,8440
3006,晶豪科,724,56,668,摩根大通,2024-06-13,8440
2884,玉山金,1147,483,664,摩根大通,2024-06-13,8440
2887,台新金,948,318,630,摩根大通,2024-06-13,8440
5347,世界,899,300,599,摩根大通,2024-06-13,8440
8069,元太,963,393,570,摩根大通,2024-06-13,8440
3374,精材,721,182,539,摩根大通,2024-06-13,8440
9904,寶成,588,74,514,摩根大通,2024-06-13,8440
4968,立積,621,145,476,摩根大通,2024-06-13,8440
6451,訊芯-KY,614,157,457,摩根大通,2024-06-13,8440
4906,正文,610,167,443,摩根大通,2024-06-13,8440
6789,采鈺,582,154,428,摩根大通,2024-06-13,8440
3047,訊舟,503,80,423,摩根大通,2024-06-13,8440
3062,建漢,535,118,417,摩根大通,2024-06-13,8440
1402,遠東新,548,131,417,摩根大通,2024-06-13,8440
1519,華城,716,301,415,摩根大通,2024-06-13,8440
3005,神基,415,44,371,摩根大通,2024-06-13,8440
2615,萬海,1020,655,365,摩根大通,2024-06-13,8440
4967,十銓,1364,1017,347,摩根大通,2024-06-13,8440
1617,榮星,1360,1022,338,摩根大通,2024-06-13,8440
2393,億光,402,81,321,摩根大通,2024-06-13,8440
1326,台化,406,85,321,摩根大通,2024-06-13,8440
8110,華東,330,24,306,摩根大通,2024-06-13,8440
2392,正崴,600,295,305,摩根大通,2024-06-13,8440
6143,振曜,357,53,304,摩根大通,2024-06-13,8440
2317,鴻海,9979,3581,6398,摩根大通,2024-06-14,8440
2312,金寶,5566,16,5550,摩根大通,2024-06-14,8440
2409,友達,4183,192,3991,摩根大通,2024-06-14,8440
6770,力積電,4546,1012,3534,摩根大通,2024-06-14,8440
2025,千興,2555,114,2441,摩根大通,2024-06-14,8440
2382,廣達,2224,196,2028,摩根大通,2024-06-14,8440
8096,擎亞,2175,213,1962,摩根大通,2024-06-14,8440
2609,陽明,5131,3298,1833,摩根大通,2024-06-14,8440
4967,十銓,2369,838,1531,摩根大通,2024-06-14,8440
9904,寶成,1524,61,1463,摩根大通,2024-06-14,8440
2515,中工,1825,400,1425,摩根大通,2024-06-14,8440
2542,興富發,1951,554,1397,摩根大通,2024-06-14,8440
4906,正文,1346,1,1345,摩根大通,2024-06-14,8440
3374,精材,1458,284,1174,摩根大通,2024-06-14,8440
1802,台玻,1214,41,1173,摩根大通,2024-06-14,8440
2883,凱基金,2950,1783,1167,摩根大通,2024-06-14,8440
8028,昇陽半導體,1828,672,1156,摩根大通,2024-06-14,8440
9105,泰金寶-DR,1760,666,1094,摩根大通,2024-06-14,8440
2891,中信金,2547,1467,1080,摩根大通,2024-06-14,8440
2913,農林,1213,139,1074,摩根大通,2024-06-14,8440
2308,台達電,1099,90,1009,摩根大通,2024-06-14,8440
1453,大將,1237,229,1008,摩根大通,2024-06-14,8440
6163,華電網,1138,142,996,摩根大通,2024-06-14,8440
4566,時碩工業,989,0,989,摩根大通,2024-06-14,8440
2520,冠德,1036,64,972,摩根大通,2024-06-14,8440
3013,晟銘電,1257,296,961,摩根大通,2024-06-14,8440
1609,大亞,1306,355,951,摩根大通,2024-06-14,8440
8069,元太,1061,128,933,摩根大通,2024-06-14,8440
1522,堤維西,1144,222,922,摩根大通,2024-06-14,8440
1402,遠東新,1078,166,912,摩根大通,2024-06-14,8440
1608,華榮,1226,322,904,摩根大通,2024-06-14,8440
1612,宏泰,1200,357,843,摩根大通,2024-06-14,8440
2031,新光鋼,823,10,813,摩根大通,2024-06-14,8440
8085,福華,1243,480,763,摩根大通,2024-06-14,8440
2316,楠梓電,782,20,762,摩根大通,2024-06-14,8440
2611,志信,754,36,718,摩根大通,2024-06-14,8440
3703,欣陸,694,14,680,摩根大通,2024-06-14,8440
8926,台汽電,691,30,661,摩根大通,2024-06-14,8440
6456,GIS-KY,645,1,644,摩根大通,2024-06-14,8440
2327,國巨,641,22,619,摩根大通,2024-06-14,8440
2606,裕民,706,105,601,摩根大通,2024-06-14,8440
3591,艾笛森,690,89,601,摩根大通,2024-06-14,8440
2615,萬海,963,368,595,摩根大通,2024-06-14,8440
2354,鴻準,848,256,592,摩根大通,2024-06-14,8440
2486,一詮,980,394,586,摩根大通,2024-06-14,8440
2530,華建,596,11,585,摩根大通,2024-06-14,8440
1314,中石化,638,63,575,摩根大通,2024-06-14,8440
2501,國建,831,267,564,摩根大通,2024-06-14,8440
3617,碩天,567,5,562,摩根大通,2024-06-14,8440
2368,金像電,559,9,550,摩根大通,2024-06-14,8440
3481,群創,13581,643,12938,摩根大通,2024-06-17,8440
2409,友達,10851,628,10223,摩根大通,2024-06-17,8440
6770,力積電,7289,336,6953,摩根大通,2024-06-17,8440
2408,南亞科,5218,186,5032,摩根大通,2024-06-17,8440
1303,南亞,1752,33,1719,摩根大通,2024-06-17,8440
2885,元大金,2052,351,1701,摩根大通,2024-06-17,8440
1802,台玻,2109,789,1320,摩根大通,2024-06-17,8440
2347,聯強,1366,59,1307,摩根大通,2024-06-17,8440
2886,兆豐金,1181,25,1156,摩根大通,2024-06-17,8440
1611,中電,1384,229,1155,摩根大通,2024-06-17,8440
2388,威盛,1201,72,1129,摩根大通,2024-06-17,8440
2834,臺企銀,1223,155,1068,摩根大通,2024-06-17,8440
1314,中石化,1018,32,986,摩根大通,2024-06-17,8440
2889,國票金,943,0,943,摩根大通,2024-06-17,8440
3045,台灣大,946,13,933,摩根大通,2024-06-17,8440
6120,達運,902,66,836,摩根大通,2024-06-17,8440
2105,正新,973,152,821,摩根大通,2024-06-17,8440
6207,雷科,848,63,785,摩根大通,2024-06-17,8440
2313,華通,849,74,775,摩根大通,2024-06-17,8440
2801,彰銀,967,219,748,摩根大通,2024-06-17,8440
2353,宏��,1078,340,738,摩根大通,2024-06-17,8440
2892,第一金,789,79,710,摩根大通,2024-06-17,8440
4726,永昕,762,58,704,摩根大通,2024-06-17,8440
2845,遠東銀,667,39,628,摩根大通,2024-06-17,8440
2312,金寶,1895,1275,620,摩根大通,2024-06-17,8440
8050,廣積,712,118,594,摩根大通,2024-06-17,8440
2025,千興,1450,862,588,摩根大通,2024-06-17,8440
4123,晟德,696,176,520,摩根大通,2024-06-17,8440
2884,玉山金,600,105,495,摩根大通,2024-06-17,8440
4714,永捷,613,129,484,摩根大通,2024-06-17,8440
2489,瑞軒,523,54,469,摩根大通,2024-06-17,8440
1785,光洋科,1168,700,468,摩根大通,2024-06-17,8440
4906,正文,469,12,457,摩根大通,2024-06-17,8440
4167,松瑞藥,672,248,424,摩根大通,2024-06-17,8440
2355,敬鵬,630,217,413,摩根大通,2024-06-17,8440
2031,新光鋼,709,298,411,摩根大通,2024-06-17,8440
2377,微星,445,36,409,摩根大通,2024-06-17,8440
4919,新唐,595,197,398,摩根大通,2024-06-17,8440
6116,彩晶,387,19,368,摩根大通,2024-06-17,8440
2017,官田鋼,384,20,364,摩根大通,2024-06-17,8440
6548,長科*,360,0,360,摩根大通,2024-06-17,8440
1514,亞力,428,68,360,摩根大通,2024-06-17,8440
3105,穩懋,532,174,358,摩根大通,2024-06-17,8440
8085,福華,833,481,352,摩根大通,2024-06-17,8440
5258,虹堡,344,0,344,摩根大通,2024-06-17,8440
2363,矽統,335,0,335,摩根大通,2024-06-17,8440
5871,中租-KY,397,78,319,摩根大通,2024-06-17,8440
3005,神基,432,126,306,摩根大通,2024-06-17,8440
2337,旺宏,387,84,303,摩根大通,2024-06-17,8440
2428,興勤,352,53,299,摩根大通,2024-06-17,8440
2618,長榮航,24063,210,23853,摩根大通,2024-06-18,8440
2890,永豐金,7143,242,6901,摩根大通,2024-06-18,8440
2610,華航,6706,31,6675,摩根大通,2024-06-18,8440
2330,台積電,6940,1885,5055,摩根大通,2024-06-18,8440
2884,玉山金,4646,44,4602,摩根大通,2024-06-18,8440
2834,臺企銀,4540,32,4508,摩根大通,2024-06-18,8440
2880,華南金,3698,75,3623,摩根大通,2024-06-18,8440
1303,南亞,3803,229,3574,摩根大通,2024-06-18,8440
2891,中信金,3724,246,3478,摩根大通,2024-06-18,8440
2882,國泰金,3305,14,3291,摩根大通,2024-06-18,8440
2892,第一金,2479,55,2424,摩根大通,2024-06-18,8440
2886,兆豐金,2397,145,2252,摩根大通,2024-06-18,8440
2347,聯強,2226,104,2122,摩根大通,2024-06-18,8440
2887,台新金,2574,574,2000,摩根大通,2024-06-18,8440
2855,統一證,1942,8,1934,摩根大通,2024-06-18,8440
1216,統一,2260,350,1910,摩根大通,2024-06-18,8440
2881,富邦金,2001,105,1896,摩根大通,2024-06-18,8440
2408,南亞科,2411,557,1854,摩根大通,2024-06-18,8440
3711,日月光投控,2438,643,1795,摩根大通,2024-06-18,8440
2344,華邦電,1708,380,1328,摩根大通,2024-06-18,8440
5880,合庫金,1505,198,1307,摩根大通,2024-06-18,8440
1815,富喬,2006,800,1206,摩根大通,2024-06-18,8440
1301,台塑,1209,115,1094,摩根大通,2024-06-18,8440
2801,彰銀,975,0,975,摩根大通,2024-06-18,8440
3045,台灣大,910,0,910,摩根大通,2024-06-18,8440
2449,京元電子,1147,258,889,摩根大通,2024-06-18,8440
2609,陽明,1606,729,877,摩根大通,2024-06-18,8440
2885,元大金,1359,496,863,摩根大通,2024-06-18,8440
2888,新光金,2791,1941,850,摩根大通,2024-06-18,8440
3062,建漢,1002,174,828,摩根大通,2024-06-18,8440
6180,橘子,918,119,799,摩根大通,2024-06-18,8440
4562,穎漢,1642,869,773,摩根大通,2024-06-18,8440
1605,華新,785,18,767,摩根大通,2024-06-18,8440
3673,TPK-KY,888,162,726,摩根大通,2024-06-18,8440
2845,遠東銀,704,0,704,摩根大通,2024-06-18,8440
6505,台塑化,681,0,681,摩根大通,2024-06-18,8440
2809,京城銀,1049,371,678,摩根大通,2024-06-18,8440
2889,國票金,677,0,677,摩根大通,2024-06-18,8440
2105,正新,1152,484,668,摩根大通,2024-06-18,8440
2324,仁寶,1531,890,641,摩根大通,2024-06-18,8440
3450,聯鈞,1278,658,620,摩根大通,2024-06-18,8440
2912,統一超,693,80,613,摩根大通,2024-06-18,8440
3260,威剛,624,38,586,摩根大通,2024-06-18,8440
2615,萬海,821,259,562,摩根大通,2024-06-18,8440
1101,台泥,575,44,531,摩根大通,2024-06-18,8440
4938,和碩,817,287,530,摩根大通,2024-06-18,8440
3702,大聯大,689,171,518,摩根大通,2024-06-18,8440
2382,廣達,732,220,512,摩根大通,2024-06-18,8440
3376,新日興,936,427,509,摩根大通,2024-06-18,8440
8096,擎亞,3523,3042,481,摩根大通,2024-06-18,8440
2449,京元電子,14304,542,13762,摩根大通,2024-06-19,8440
3481,群創,9936,63,9873,摩根大通,2024-06-19,8440
2618,長榮航,11442,3708,7734,摩根大通,2024-06-19,8440
2382,廣達,8177,1087,7090,摩根大通,2024-06-19,8440
2884,玉山金,7954,1907,6047,摩根大通,2024-06-19,8440
2888,新光金,6448,937,5511,摩根大通,2024-06-19,8440
2330,台積電,7594,3980,3614,摩根大通,2024-06-19,8440
2887,台新金,4015,419,3596,摩根大通,2024-06-19,8440
2891,中信金,4490,1009,3481,摩根大通,2024-06-19,8440
2881,富邦金,3444,57,3387,摩根大通,2024-06-19,8440
2308,台達電,3673,304,3369,摩根大通,2024-06-19,8440
2347,聯強,3519,191,3328,摩根大通,2024-06-19,8440
3231,緯創,4222,903,3319,摩根大通,2024-06-19,8440
0050,元大台灣50,3186,0,3186,摩根大通,2024-06-19,8440
2834,臺企銀,3084,43,3041,摩根大通,2024-06-19,8440
2801,彰銀,3411,570,2841,摩根大通,2024-06-19,8440
4958,臻鼎-KY,4285,1458,2827,摩根大通,2024-06-19,8440
2324,仁寶,3231,457,2774,摩根大通,2024-06-19,8440
2356,英業達,2688,108,2580,摩根大通,2024-06-19,8440
2880,華南金,3978,1749,2229,摩根大通,2024-06-19,8440
2885,元大金,3000,984,2016,摩根大通,2024-06-19,8440
1101,台泥,1965,7,1958,摩根大通,2024-06-19,8440
2892,第一金,2059,111,1948,摩根大通,2024-06-19,8440
2886,兆豐金,2962,1037,1925,摩根大通,2024-06-19,8440
1303,南亞,1802,70,1732,摩根大通,2024-06-19,8440
2344,華邦電,2338,699,1639,摩根大通,2024-06-19,8440
2609,陽明,1617,158,1459,摩根大通,2024-06-19,8440
1504,東元,2100,675,1425,摩根大通,2024-06-19,8440
1216,統一,1358,94,1264,摩根大通,2024-06-19,8440
2615,萬海,1515,282,1233,摩根大通,2024-06-19,8440
2486,一詮,1406,198,1208,摩根大通,2024-06-19,8440
2610,華航,3049,1851,1198,摩根大通,2024-06-19,8440
2412,中華電,2346,1178,1168,摩根大通,2024-06-19,8440
1402,遠東新,1136,5,1131,摩根大通,2024-06-19,8440
1301,台塑,1707,579,1128,摩根大通,2024-06-19,8440
2312,金寶,1235,151,1084,摩根大通,2024-06-19,8440
5880,合庫金,1282,229,1053,摩根大通,2024-06-19,8440
6176,瑞儀,1143,91,1052,摩根大通,2024-06-19,8440
2313,華通,1368,318,1050,摩根大通,2024-06-19,8440
1326,台化,1229,218,1011,摩根大通,2024-06-19,8440
2890,永豐金,1543,540,1003,摩根大通,2024-06-19,8440
1605,華新,1039,49,990,摩根大通,2024-06-19,8440
2889,國票金,993,62,931,摩根大通,2024-06-19,8440
2409,友達,1533,611,922,摩根大通,2024-06-19,8440
6269,台郡,898,0,898,摩根大通,2024-06-19,8440
2607,榮運,900,45,855,摩根大通,2024-06-19,8440
5876,上海商銀,859,47,812,摩根大通,2024-06-19,8440
3711,日月光投控,1157,370,787,摩根大通,2024-06-19,8440
9945,潤泰新,873,108,765,摩根大通,2024-06-19,8440
8028,昇陽半導體,985,235,750,摩根大通,2024-06-19,8440
2356,英業達,5132,733,4399,摩根大通,2024-06-20,8440
1815,富喬,3747,481,3266,摩根大通,2024-06-20,8440
2324,仁寶,3738,824,2914,摩根大通,2024-06-20,8440
6770,力積電,2999,246,2753,摩根大通,2024-06-20,8440
2882,國泰金,3756,1073,2683,摩根大通,2024-06-20,8440
2347,聯強,2714,332,2382,摩根大通,2024-06-20,8440
2881,富邦金,2485,187,2298,摩根大通,2024-06-20,8440
6213,聯茂,2334,167,2167,摩根大通,2024-06-20,8440
2317,鴻海,13768,11900,1868,摩根大通,2024-06-20,8440
2890,永豐金,1991,302,1689,摩根大通,2024-06-20,8440
2884,玉山金,2251,562,1689,摩根大通,2024-06-20,8440
3045,台灣大,1737,67,1670,摩根大通,2024-06-20,8440
2344,華邦電,2272,642,1630,摩根大通,2024-06-20,8440
2408,南亞科,2085,508,1577,摩根大通,2024-06-20,8440
2609,陽明,2151,576,1575,摩根大通,2024-06-20,8440
2892,第一金,1625,159,1466,摩根大通,2024-06-20,8440
8064,東捷,1569,186,1383,摩根大通,2024-06-20,8440
6290,良維,1397,25,1372,摩根大通,2024-06-20,8440
2867,三商壽,1288,0,1288,摩根大通,2024-06-20,8440
2607,榮運,1350,128,1222,摩根大通,2024-06-20,8440
1303,南亞,1522,315,1207,摩根大通,2024-06-20,8440
3363,上詮,1481,373,1108,摩根大通,2024-06-20,8440
3481,群創,3401,2356,1045,摩根大通,2024-06-20,8440
5351,鈺創,1012,7,1005,摩根大通,2024-06-20,8440
6505,台塑化,1058,60,998,摩根大通,2024-06-20,8440
2349,錸德,986,0,986,摩根大通,2024-06-20,8440
2354,鴻準,1277,325,952,摩根大通,2024-06-20,8440
2382,廣達,1978,1084,894,摩根大通,2024-06-20,8440
2498,宏達電,1330,440,890,摩根大通,2024-06-20,8440
5347,世界,877,32,845,摩根大通,2024-06-20,8440
1504,東元,1070,239,831,摩根大通,2024-06-20,8440
3265,台星科,882,52,830,摩根大通,2024-06-20,8440
3006,晶豪科,955,184,771,摩根大通,2024-06-20,8440
2367,燿華,853,93,760,摩根大通,2024-06-20,8440
8358,金居,767,22,745,摩根大通,2024-06-20,8440
2365,昆盈,1044,315,729,摩根大通,2024-06-20,8440
5880,合庫金,946,225,721,摩根大通,2024-06-20,8440
2834,臺企銀,1549,833,716,摩根大通,2024-06-20,8440
3450,聯鈞,765,71,694,摩根大通,2024-06-20,8440
1326,台化,818,176,642,摩根大通,2024-06-20,8440
2542,興富發,946,308,638,摩根大通,2024-06-20,8440
2801,彰銀,1122,503,619,摩根大通,2024-06-20,8440
5469,瀚宇博,624,31,593,摩根大通,2024-06-20,8440
2385,群光,772,183,589,摩根大通,2024-06-20,8440
1101,台泥,680,94,586,摩根大通,2024-06-20,8440
2392,正崴,650,71,579,摩根大通,2024-06-20,8440
2323,中環,613,70,543,摩根大通,2024-06-20,8440
2303,聯電,2609,2104,505,摩根大通,2024-06-20,8440
2402,毅嘉,500,2,498,摩根大通,2024-06-20,8440
2913,農林,523,46,477,摩根大通,2024-06-20,8440
2888,新光金,16221,252,15969,摩根大通,2024-06-21,8440
2891,中信金,13220,3684,9536,摩根大通,2024-06-21,8440
2801,彰銀,8886,1021,7865,摩根大通,2024-06-21,8440
2330,台積電,14444,7295,7149,摩根大通,2024-06-21,8440
2884,玉山金,7021,70,6951,摩根大通,2024-06-21,8440
2883,凱基金,5675,275,5400,摩根大通,2024-06-21,8440
2892,第一金,5156,223,4933,摩根大通,2024-06-21,8440
2618,長榮航,7874,3065,4809,摩根大通,2024-06-21,8440
2353,宏��,5710,1156,4554,摩根大通,2024-06-21,8440
2881,富邦金,5714,1216,4498,摩根大通,2024-06-21,8440
2409,友達,8351,4004,4347,摩根大通,2024-06-21,8440
2308,台達電,5130,800,4330,摩根大通,2024-06-21,8440
2882,國泰金,4801,557,4244,摩根大通,2024-06-21,8440
5880,合庫金,5586,1865,3721,摩根大通,2024-06-21,8440
2542,興富發,3378,128,3250,摩根大通,2024-06-21,8440
2324,仁寶,4743,1626,3117,摩根大通,2024-06-21,8440
2890,永豐金,4156,1104,3052,摩根大通,2024-06-21,8440
2887,台新金,3637,956,2681,摩根大通,2024-06-21,8440
2347,聯強,2454,74,2380,摩根大通,2024-06-21,8440
2610,華航,2951,645,2306,摩根大通,2024-06-21,8440
2303,聯電,4751,2450,2301,摩根大通,2024-06-21,8440
1101,台泥,3989,1701,2288,摩根大通,2024-06-21,8440
1216,統一,2384,158,2226,摩根大通,2024-06-21,8440
3047,訊舟,2247,47,2200,摩根大通,2024-06-21,8440
3450,聯鈞,3213,1044,2169,摩根大通,2024-06-21,8440
2344,華邦電,2291,155,2136,摩根大通,2024-06-21,8440
2845,遠東銀,2534,475,2059,摩根大通,2024-06-21,8440
6005,群益證,2083,29,2054,摩根大通,2024-06-21,8440
3231,緯創,3344,1657,1687,摩根大通,2024-06-21,8440
2889,國票金,2002,322,1680,摩根大通,2024-06-21,8440
2834,臺企銀,2893,1373,1520,摩根大通,2024-06-21,8440
2105,正新,1675,177,1498,摩根大通,2024-06-21,8440
5876,上海商銀,1530,53,1477,摩根大通,2024-06-21,8440
1312,國喬,1420,111,1309,摩根大通,2024-06-21,8440
6116,彩晶,2370,1098,1272,摩根大通,2024-06-21,8440
8358,金居,1178,41,1137,摩根大通,2024-06-21,8440
1326,台化,1450,339,1111,摩根大通,2024-06-21,8440
2885,元大金,3521,2448,1073,摩根大通,2024-06-21,8440
2327,國巨,1236,176,1060,摩根大通,2024-06-21,8440
5347,世界,1450,398,1052,摩根大通,2024-06-21,8440
2504,國產,1342,334,1008,摩根大通,2024-06-21,8440
1718,中纖,946,0,946,摩根大通,2024-06-21,8440
6269,台郡,1121,220,901,摩根大通,2024-06-21,8440
4915,致伸,1111,224,887,摩根大通,2024-06-21,8440
2607,榮運,1017,140,877,摩根大通,2024-06-21,8440
2812,台中銀,942,66,876,摩根大通,2024-06-21,8440
3665,貿聯-KY,767,11,756,摩根大通,2024-06-21,8440
9904,寶成,1449,709,740,摩根大通,2024-06-21,8440
2489,瑞軒,1049,316,733,摩根大通,2024-06-21,8440
2406,國碩,1005,282,723,摩根大通,2024-06-21,8440
2891,中信金,6907,792,6115,摩根大通,2024-06-24,8440
0056,元大高股息,5500,0,5500,摩根大通,2024-06-24,8440
2409,友達,6161,978,5183,摩根大通,2024-06-24,8440
2347,聯強,3022,469,2553,摩根大通,2024-06-24,8440
2324,仁寶,2855,504,2351,摩根大通,2024-06-24,8440
2801,彰銀,2413,83,2330,摩根大通,2024-06-24,8440
2353,宏��,3815,1515,2300,摩根大通,2024-06-24,8440
2892,第一金,2202,217,1985,摩根大通,2024-06-24,8440
1301,台塑,2593,676,1917,摩根大通,2024-06-24,8440
2834,臺企銀,2273,536,1737,摩根大通,2024-06-24,8440
2881,富邦金,1877,299,1578,摩根大通,2024-06-24,8440
2882,國泰金,2420,890,1530,摩根大通,2024-06-24,8440
2542,興富發,1186,6,1180,摩根大通,2024-06-24,8440
2884,玉山金,2416,1471,945,摩根大通,2024-06-24,8440
2327,國巨,1197,257,940,摩根大通,2024-06-24,8440
3149,正達,911,14,897,摩根大通,2024-06-24,8440
2317,鴻海,5283,4388,895,摩根大通,2024-06-24,8440
2607,榮運,933,82,851,摩根大通,2024-06-24,8440
2516,新建,842,37,805,摩根大通,2024-06-24,8440
2887,台新金,824,76,748,摩根大通,2024-06-24,8440
2897,王道銀行,733,79,654,摩根大通,2024-06-24,8440
8046,南電,686,117,569,摩根大通,2024-06-24,8440
2455,全新,868,394,474,摩根大通,2024-06-24,8440
3711,日月光投控,826,354,472,摩根大通,2024-06-24,8440
6111,大宇資,576,121,455,摩根大通,2024-06-24,8440
2610,華航,768,333,435,摩根大通,2024-06-24,8440
6269,台郡,734,316,418,摩根大通,2024-06-24,8440
3406,玉晶光,526,109,417,摩根大通,2024-06-24,8440
4906,正文,565,151,414,摩根大通,2024-06-24,8440
2303,聯電,1878,1478,400,摩根大通,2024-06-24,8440
9904,寶成,1416,1030,386,摩根大通,2024-06-24,8440
6412,群電,380,27,353,摩根大通,2024-06-24,8440
3665,貿聯-KY,446,118,328,摩根大通,2024-06-24,8440
6005,群益證,353,44,309,摩根大通,2024-06-24,8440
1718,中纖,281,4,277,摩根大通,2024-06-24,8440
5434,崇越,292,26,266,摩根大通,2024-06-24,8440
1101,台泥,405,141,264,摩根大通,2024-06-24,8440
2211,長榮鋼,309,67,242,摩根大通,2024-06-24,8440
2355,敬鵬,338,99,239,摩根大通,2024-06-24,8440
5880,合庫金,627,395,232,摩根大通,2024-06-24,8440
5469,瀚宇博,337,106,231,摩根大通,2024-06-24,8440
3703,欣陸,238,23,215,摩根大通,2024-06-24,8440
9958,世紀鋼,230,20,210,摩根大通,2024-06-24,8440
6505,台塑化,276,69,207,摩根大通,2024-06-24,8440
2527,宏璟,245,39,206,摩根大通,2024-06-24,8440
3042,晶技,330,126,204,摩根大通,2024-06-24,8440
6446,藥華藥,232,32,200,摩根大通,2024-06-24,8440
2395,研華,206,16,190,摩根大通,2024-06-24,8440
6164,華興,210,27,183,摩根大通,2024-06-24,8440
2368,金像電,542,366,176,摩根大通,2024-06-24,8440
2353,宏��,9611,417,9194,摩根大通,2024-06-25,8440
2884,玉山金,8861,294,8567,摩根大通,2024-06-25,8440
2885,元大金,8794,2561,6233,摩根大通,2024-06-25,8440
2891,中信金,6499,1164,5335,摩根大通,2024-06-25,8440
2610,華航,5916,1031,4885,摩根大通,2024-06-25,8440
2324,仁寶,3930,1026,2904,摩根大通,2024-06-25,8440
2801,彰銀,2848,74,2774,摩根大通,2024-06-25,8440
2892,第一金,2811,140,2671,摩根大通,2024-06-25,8440
2409,友達,9927,7736,2191,摩根大通,2024-06-25,8440
1301,台塑,2777,692,2085,摩根大通,2024-06-25,8440
2542,興富發,2004,74,1930,摩根大通,2024-06-25,8440
2367,燿華,1909,23,1886,摩根大通,2024-06-25,8440
3711,日月光投控,2798,1034,1764,摩根大通,2024-06-25,8440
2301,光寶科,2565,816,1749,摩根大通,2024-06-25,8440
2887,台新金,2060,499,1561,摩根大通,2024-06-25,8440
2881,富邦金,1555,215,1340,摩根大通,2024-06-25,8440
5452,佶優,2619,1287,1332,摩根大通,2024-06-25,8440
5880,合庫金,1530,333,1197,摩根大通,2024-06-25,8440
2888,新光金,1994,802,1192,摩根大通,2024-06-25,8440
1101,台泥,1123,57,1066,摩根大通,2024-06-25,8440
6505,台塑化,1070,123,947,摩根大通,2024-06-25,8440
3047,訊舟,975,74,901,摩根大通,2024-06-25,8440
2607,榮運,917,55,862,摩根大通,2024-06-25,8440
2606,裕民,1041,200,841,摩根大通,2024-06-25,8440
5347,世界,1059,290,769,摩根大通,2024-06-25,8440
2449,京元電子,1015,287,728,摩根大通,2024-06-25,8440
3260,威剛,767,46,721,摩根大通,2024-06-25,8440
2330,台積電,5387,4695,692,摩根大通,2024-06-25,8440
1326,台化,678,6,672,摩根大通,2024-06-25,8440
3062,建漢,1201,539,662,摩根大通,2024-06-25,8440
2371,大同,810,177,633,摩根大通,2024-06-25,8440
2812,台中銀,642,9,633,摩根大通,2024-06-25,8440
1513,中興電,669,65,604,摩根大通,2024-06-25,8440
3055,蔚華科,551,44,507,摩根大通,2024-06-25,8440
1504,東元,747,269,478,摩根大通,2024-06-25,8440
4938,和碩,772,314,458,摩根大通,2024-06-25,8440
1609,大亞,571,125,446,摩根大通,2024-06-25,8440
2347,聯強,825,384,441,摩根大通,2024-06-25,8440
1718,中纖,421,4,417,摩根大通,2024-06-25,8440
2915,潤泰全,445,31,414,摩根大通,2024-06-25,8440
3211,順達,469,56,413,摩根大通,2024-06-25,8440
3535,晶彩科,581,182,399,摩根大通,2024-06-25,8440
6125,廣運,389,12,377,摩根大通,2024-06-25,8440
1785,光洋科,1813,1456,357,摩根大通,2024-06-25,8440
2633,台灣高鐵,375,22,353,摩根大通,2024-06-25,8440
2401,凌陽,666,320,346,摩根大通,2024-06-25,8440
3580,友威科,701,359,342,摩根大通,2024-06-25,8440
2504,國產,733,393,340,摩根大通,2024-06-25,8440
2838,聯邦銀,333,2,331,摩根大通,2024-06-25,8440
2845,遠東銀,464,134,330,摩根大通,2024-06-25,8440
2409,友達,16714,10983,5731,摩根大通,2024-06-26,8440
2301,光寶科,4060,679,3381,摩根大通,2024-06-26,8440
2542,興富發,2812,193,2619,摩根大通,2024-06-26,8440
4167,松瑞藥,2315,15,2300,摩根大通,2024-06-26,8440
2353,宏��,2742,746,1996,摩根大通,2024-06-26,8440
4938,和碩,1767,101,1666,摩根大通,2024-06-26,8440
2330,台積電,2655,1159,1496,摩根大通,2024-06-26,8440
3047,訊舟,1460,227,1233,摩根大通,2024-06-26,8440
3055,蔚華科,1271,329,942,摩根大通,2024-06-26,8440
6806,森崴能源,940,77,863,摩根大通,2024-06-26,8440
3576,聯合再生,1413,605,808,摩根大通,2024-06-26,8440
1301,台塑,2433,1660,773,摩根大通,2024-06-26,8440
2486,一詮,668,0,668,摩根大通,2024-06-26,8440
2382,廣達,981,383,598,摩根大通,2024-06-26,8440
2809,京城銀,1383,791,592,摩根大通,2024-06-26,8440
6244,茂迪,932,345,587,摩根大通,2024-06-26,8440
2313,華通,684,100,584,摩根大通,2024-06-26,8440
2356,英業達,1858,1283,575,摩根大通,2024-06-26,8440
8046,南電,600,29,571,摩根大通,2024-06-26,8440
6505,台塑化,704,148,556,摩根大通,2024-06-26,8440
6550,北極星藥業-KY,548,3,545,摩根大通,2024-06-26,8440
4114,健喬,547,8,539,摩根大通,2024-06-26,8440
5880,合庫金,746,213,533,摩根大通,2024-06-26,8440
6472,保瑞,552,43,509,摩根大通,2024-06-26,8440
6213,聯茂,547,44,503,摩根大通,2024-06-26,8440
6163,華電網,570,86,484,摩根大通,2024-06-26,8440
4976,佳凌,600,119,481,摩根大通,2024-06-26,8440
3324,雙鴻,497,38,459,摩根大通,2024-06-26,8440
2402,毅嘉,566,108,458,摩根大通,2024-06-26,8440
9105,泰金寶-DR,439,8,431,摩根大通,2024-06-26,8440
2449,京元電子,864,452,412,摩根大通,2024-06-26,8440
2367,燿華,594,188,406,摩根大通,2024-06-26,8440
1907,永豐餘,464,58,406,摩根大通,2024-06-26,8440
2504,國產,460,83,377,摩根大通,2024-06-26,8440
3481,群創,1588,1220,368,摩根大通,2024-06-26,8440
5371,中光電,369,23,346,摩根大通,2024-06-26,8440
4162,智擎,340,2,338,摩根大通,2024-06-26,8440
2836,高雄銀,342,15,327,摩根大通,2024-06-26,8440
3227,原相,378,52,326,摩根大通,2024-06-26,8440
2891,中信金,1557,1249,308,摩根大通,2024-06-26,8440
5425,台半,306,0,306,摩根大通,2024-06-26,8440
3045,台灣大,500,201,299,摩根大通,2024-06-26,8440
2324,仁寶,1601,1304,297,摩根大通,2024-06-26,8440
4958,臻鼎-KY,427,142,285,摩根大通,2024-06-26,8440
2606,裕民,329,67,262,摩根大通,2024-06-26,8440
2548,華固,250,2,248,摩根大通,2024-06-26,8440
1528,恩德,252,4,248,摩根大通,2024-06-26,8440
6538,倉和,244,4,240,摩根大通,2024-06-26,8440
6176,瑞儀,371,135,236,摩根大通,2024-06-26,8440
4157,太景*-KY,249,20,229,摩根大通,2024-06-26,8440
2409,友達,14753,3264,11489,摩根大通,2024-06-27,8440
2610,華航,5907,704,5203,摩根大通,2024-06-27,8440
2542,興富發,5162,105,5057,摩根大通,2024-06-27,8440
2809,京城銀,2404,74,2330,摩根大通,2024-06-27,8440
4938,和碩,2704,523,2181,摩根大通,2024-06-27,8440
2353,宏��,3327,1856,1471,摩根大通,2024-06-27,8440
2313,華通,3525,2095,1430,摩根大通,2024-06-27,8440
2801,彰銀,2622,1262,1360,摩根大通,2024-06-27,8440
6505,台塑化,1832,483,1349,摩根大通,2024-06-27,8440
6443,元晶,1581,307,1274,摩根大通,2024-06-27,8440
2301,光寶科,2475,1213,1262,摩根大通,2024-06-27,8440
2881,富邦金,3477,2247,1230,摩根大通,2024-06-27,8440
8069,元太,1665,760,905,摩根大通,2024-06-27,8440
1785,光洋科,1566,716,850,摩根大通,2024-06-27,8440
8046,南電,867,52,815,摩根大通,2024-06-27,8440
3227,原相,823,33,790,摩根大通,2024-06-27,8440
3017,奇鋐,852,176,676,摩根大通,2024-06-27,8440
6806,森崴能源,1169,508,661,摩根大通,2024-06-27,8440
2392,正崴,757,107,650,摩根大通,2024-06-27,8440
2606,裕民,1017,512,505,摩根大通,2024-06-27,8440
0056,元大高股息,500,0,500,摩根大通,2024-06-27,8440
00878,國泰永續高股息,500,0,500,摩根大通,2024-06-27,8440
2504,國產,594,110,484,摩根大通,2024-06-27,8440
3339,泰谷,435,0,435,摩根大通,2024-06-27,8440
2891,中信金,6807,6375,432,摩根大通,2024-06-27,8440
5243,乙盛-KY,1059,632,427,摩根大通,2024-06-27,8440
8150,南茂,670,254,416,摩根大通,2024-06-27,8440
4915,致伸,460,55,405,摩根大通,2024-06-27,8440
1611,中電,594,195,399,摩根大通,2024-06-27,8440
2915,潤泰全,400,39,361,摩根大通,2024-06-27,8440
2609,陽明,810,454,356,摩根大通,2024-06-27,8440
2401,凌陽,411,61,350,摩根大通,2024-06-27,8440
0050,元大台灣50,344,0,344,摩根大通,2024-06-27,8440
3005,神基,609,266,343,摩根大通,2024-06-27,8440
3665,貿聯-KY,400,58,342,摩根大通,2024-06-27,8440
4976,佳凌,700,358,342,摩根大通,2024-06-27,8440
1514,亞力,502,163,339,摩根大通,2024-06-27,8440
3050,鈺德,411,77,334,摩根大通,2024-06-27,8440
3312,弘憶股,782,453,329,摩根大通,2024-06-27,8440
3617,碩天,353,32,321,摩根大通,2024-06-27,8440
2449,京元電子,641,326,315,摩根大通,2024-06-27,8440
2323,中環,451,137,314,摩根大通,2024-06-27,8440
2637,慧洋-KY,445,140,305,摩根大通,2024-06-27,8440
4129,聯合,381,80,301,摩根大通,2024-06-27,8440
2027,大成鋼,557,257,300,摩根大通,2024-06-27,8440
2486,一詮,276,1,275,摩根大通,2024-06-27,8440
4967,十銓,392,140,252,摩根大通,2024-06-27,8440
5475,德宏,279,35,244,摩根大通,2024-06-27,8440
5443,均豪,869,626,243,摩根大通,2024-06-27,8440
2327,國巨,529,296,233,摩根大通,2024-06-27,8440
2352,佳世達,5622,297,5325,摩根大通,2024-06-28,8440
2883,凱基金,6384,1510,4874,摩根大通,2024-06-28,8440
2888,新光金,4870,103,4767,摩根大通,2024-06-28,8440
2884,玉山金,7720,3848,3872,摩根大通,2024-06-28,8440
2885,元大金,5132,1407,3725,摩根大通,2024-06-28,8440
2886,兆豐金,4270,731,3539,摩根大通,2024-06-28,8440
2324,仁寶,4154,1223,2931,摩根大通,2024-06-28,8440
2330,台積電,5428,2599,2829,摩根大通,2024-06-28,8440
0056,元大高股息,2500,0,2500,摩根大通,2024-06-28,8440
2313,華通,2778,313,2465,摩根大通,2024-06-28,8440
2881,富邦金,3118,1010,2108,摩根大通,2024-06-28,8440
2337,旺宏,2599,754,1845,摩根大通,2024-06-28,8440
2892,第一金,1655,34,1621,摩根大通,2024-06-28,8440
2344,華邦電,2102,510,1592,摩根大通,2024-06-28,8440
4958,臻鼎-KY,1626,112,1514,摩根大通,2024-06-28,8440
6191,精成科,1595,85,1510,摩根大通,2024-06-28,8440
4938,和碩,1915,486,1429,摩根大通,2024-06-28,8440
3105,穩懋,2044,704,1340,摩根大通,2024-06-28,8440
2382,廣達,1611,271,1340,摩根大通,2024-06-28,8440
8069,元太,1587,247,1340,摩根大通,2024-06-28,8440
1815,富喬,1414,139,1275,摩根大通,2024-06-28,8440
4919,新唐,1436,197,1239,摩根大通,2024-06-28,8440
2890,永豐金,1754,558,1196,摩根大通,2024-06-28,8440
6505,台塑化,1456,313,1143,摩根大通,2024-06-28,8440
2449,京元電子,1897,814,1083,摩根大通,2024-06-28,8440
5469,瀚宇博,1204,198,1006,摩根大通,2024-06-28,8440
2392,正崴,1102,113,989,摩根大通,2024-06-28,8440
2374,佳能,1369,402,967,摩根大通,2024-06-28,8440
5880,合庫金,1139,174,965,摩根大通,2024-06-28,8440
2889,國票金,1076,144,932,摩根大通,2024-06-28,8440
3312,弘憶股,1349,460,889,摩根大通,2024-06-28,8440
2801,彰銀,1369,483,886,摩根大通,2024-06-28,8440
3024,憶聲,1203,321,882,摩根大通,2024-06-28,8440
9904,寶成,1140,269,871,摩根大通,2024-06-28,8440
1326,台化,883,41,842,摩根大通,2024-06-28,8440
1101,台泥,864,43,821,摩根大通,2024-06-28,8440
6182,合晶,1025,219,806,摩根大通,2024-06-28,8440
2882,國泰金,2839,2069,770,摩根大通,2024-06-28,8440
6239,力成,823,77,746,摩根大通,2024-06-28,8440
6290,良維,737,6,731,摩根大通,2024-06-28,8440
2454,聯發科,842,119,723,摩根大通,2024-06-28,8440
2867,三商壽,867,160,707,摩根大通,2024-06-28,8440
8064,東捷,803,113,690,摩根大通,2024-06-28,8440
3481,群創,2603,1940,663,摩根大通,2024-06-28,8440
2317,鴻海,2205,1582,623,摩根大通,2024-06-28,8440
1802,台玻,788,177,611,摩根大通,2024-06-28,8440
6152,百一,698,89,609,摩根大通,2024-06-28,8440
912000,晨訊科-DR,773,168,605,摩根大通,2024-06-28,8440
3702,大聯大,728,132,596,摩根大通,2024-06-28,8440
2495,普安,719,128,591,摩根大通,2024-06-28,8440
2609,陽明,8142,544,7598,摩根大通,2024-07-01,8440
2888,新光金,6315,743,5572,摩根大通,2024-07-01,8440
2610,華航,3895,43,3852,摩根大通,2024-07-01,8440
2337,旺宏,4280,552,3728,摩根大通,2024-07-01,8440
2882,國泰金,3666,1234,2432,摩根大通,2024-07-01,8440
2352,佳世達,4289,1885,2404,摩根大通,2024-07-01,8440
6182,合晶,1934,1,1933,摩根大通,2024-07-01,8440
3711,日月光投控,2333,535,1798,摩根大通,2024-07-01,8440
3024,憶聲,2253,578,1675,摩根大通,2024-07-01,8440
2365,昆盈,1388,58,1330,摩根大通,2024-07-01,8440
1815,富喬,1592,307,1285,摩根大通,2024-07-01,8440
2330,台積電,1972,702,1270,摩根大通,2024-07-01,8440
5347,世界,1460,296,1164,摩根大通,2024-07-01,8440
2382,廣達,1425,280,1145,摩根大通,2024-07-01,8440
5469,瀚宇博,1185,132,1053,摩根大通,2024-07-01,8440
2454,聯發科,1040,92,948,摩根大通,2024-07-01,8440
1101,台泥,898,0,898,摩根大通,2024-07-01,8440
2891,中信金,5681,4867,814,摩根大通,2024-07-01,8440
2449,京元電子,1117,372,745,摩根大通,2024-07-01,8440
3686,達能,828,104,724,摩根大通,2024-07-01,8440
4958,臻鼎-KY,897,186,711,摩根大通,2024-07-01,8440
3702,大聯大,910,212,698,摩根大通,2024-07-01,8440
3048,益登,816,124,692,摩根大通,2024-07-01,8440
6177,達麗,711,120,591,摩根大通,2024-07-01,8440
1785,光洋科,795,209,586,摩根大通,2024-07-01,8440
5483,中美晶,638,72,566,摩根大通,2024-07-01,8440
2379,瑞昱,798,243,555,摩根大通,2024-07-01,8440
3520,華盈,672,189,483,摩根大通,2024-07-01,8440
4167,松瑞藥,593,142,451,摩根大通,2024-07-01,8440
6578,達邦蛋白,445,16,429,摩根大通,2024-07-01,8440
6239,力成,578,164,414,摩根大通,2024-07-01,8440
2836,高雄銀,404,0,404,摩根大通,2024-07-01,8440
9958,世紀鋼,451,52,399,摩根大通,2024-07-01,8440
8050,廣積,407,27,380,摩根大通,2024-07-01,8440
3060,銘異,391,15,376,摩根大通,2024-07-01,8440
2897,王道銀行,462,91,371,摩根大通,2024-07-01,8440
2801,彰銀,405,38,367,摩根大通,2024-07-01,8440
2530,華建,389,22,367,摩根大通,2024-07-01,8440
1611,中電,376,37,339,摩根大通,2024-07-01,8440
5880,合庫金,380,53,327,摩根大通,2024-07-01,8440
3062,建漢,533,227,306,摩根大通,2024-07-01,8440
2349,錸德,984,683,301,摩根大通,2024-07-01,8440
8383,千附,284,17,267,摩根大通,2024-07-01,8440
6667,信紘科,270,8,262,摩根大通,2024-07-01,8440
6584,南俊國際,266,6,260,摩根大通,2024-07-01,8440
2377,微星,421,168,253,摩根大通,2024-07-01,8440
3050,鈺德,475,234,241,摩根大通,2024-07-01,8440
6505,台塑化,367,132,235,摩根大通,2024-07-01,8440
2834,臺企銀,475,242,233,摩根大通,2024-07-01,8440
5243,乙盛-KY,389,179,210,摩根大通,2024-07-01,8440
2610,華航,35398,2757,32641,摩根大通,2024-07-02,8440
2891,中信金,11426,1102,10324,摩根大通,2024-07-02,8440
2352,佳世達,7539,542,6997,摩根大通,2024-07-02,8440
2337,旺宏,7492,1174,6318,摩根大通,2024-07-02,8440
2883,凱基金,5513,1703,3810,摩根大通,2024-07-02,8440
6182,合晶,2784,401,2383,摩根大通,2024-07-02,8440
3702,大聯大,2946,805,2141,摩根大通,2024-07-02,8440
2313,華通,2642,545,2097,摩根大通,2024-07-02,8440
2801,彰銀,2448,455,1993,摩根大通,2024-07-02,8440
9904,寶成,2317,429,1888,摩根大通,2024-07-02,8440
2606,裕民,2357,822,1535,摩根大通,2024-07-02,8440
5469,瀚宇博,1680,188,1492,摩根大通,2024-07-02,8440
2887,台新金,1952,496,1456,摩根大通,2024-07-02,8440
5371,中光電,1453,108,1345,摩根大通,2024-07-02,8440
4958,臻鼎-KY,1855,543,1312,摩根大通,2024-07-02,8440
4906,正文,1551,240,1311,摩根大通,2024-07-02,8440
2449,京元電子,1934,690,1244,摩根大通,2024-07-02,8440
3481,群創,1941,751,1190,摩根大通,2024-07-02,8440
5452,佶優,1382,289,1093,摩根大通,2024-07-02,8440
2324,仁寶,1696,636,1060,摩根大通,2024-07-02,8440
6176,瑞儀,1071,103,968,摩根大通,2024-07-02,8440
6239,力成,1172,211,961,摩根大通,2024-07-02,8440
2379,瑞昱,1104,264,840,摩根大通,2024-07-02,8440
6191,精成科,729,11,718,摩根大通,2024-07-02,8440
2303,聯電,6669,5951,718,摩根大通,2024-07-02,8440
1402,遠東新,1166,463,703,摩根大通,2024-07-02,8440
1477,聚陽,905,241,664,摩根大通,2024-07-02,8440
2543,皇昌,623,33,590,摩根大通,2024-07-02,8440
8050,廣積,552,43,509,摩根大通,2024-07-02,8440
5483,中美晶,841,336,505,摩根大通,2024-07-02,8440
3189,景碩,677,178,499,摩根大通,2024-07-02,8440
2323,中環,553,64,489,摩根大通,2024-07-02,8440
1504,東元,737,276,461,摩根大通,2024-07-02,8440
3044,健鼎,497,38,459,摩根大通,2024-07-02,8440
4562,穎漢,951,502,449,摩根大通,2024-07-02,8440
6285,啟��,485,61,424,摩根大通,2024-07-02,8440
5880,合庫金,1361,943,418,摩根大通,2024-07-02,8440
2888,新光金,2145,1741,404,摩根大通,2024-07-02,8440
4533,協易機,406,6,400,摩根大通,2024-07-02,8440
1101,台泥,665,275,390,摩根大通,2024-07-02,8440
2504,國產,405,69,336,摩根大通,2024-07-02,8440
1611,中電,407,78,329,摩根大通,2024-07-02,8440
2501,國建,584,255,329,摩根大通,2024-07-02,8440
8277,商丞,340,17,323,摩根大通,2024-07-02,8440
8081,致新,440,126,314,摩根大通,2024-07-02,8440
9945,潤泰新,447,139,308,摩根大通,2024-07-02,8440
4919,新唐,1124,831,293,摩根大通,2024-07-02,8440
6147,頎邦,287,39,248,摩根大通,2024-07-02,8440
2530,華建,272,25,247,摩根大通,2024-07-02,8440
2347,聯強,1210,978,232,摩根大通,2024-07-02,8440
2891,中信金,7990,1923,6067,摩根大通,2024-07-03,8440
2882,國泰金,6110,1464,4646,摩根大通,2024-07-03,8440
2888,新光金,3785,49,3736,摩根大通,2024-07-03,8440
2883,凱基金,5014,1718,3296,摩根大通,2024-07-03,8440
2834,臺企銀,3837,609,3228,摩根大通,2024-07-03,8440
2352,佳世達,2979,11,2968,摩根大通,2024-07-03,8440
2881,富邦金,3304,341,2963,摩根大通,2024-07-03,8440
2867,三商壽,2638,29,2609,摩根大通,2024-07-03,8440
3481,群創,3640,1255,2385,摩根大通,2024-07-03,8440
2887,台新金,3459,1172,2287,摩根大通,2024-07-03,8440
4958,臻鼎-KY,2459,229,2230,摩根大通,2024-07-03,8440
2313,華通,2504,365,2139,摩根大通,2024-07-03,8440
5880,合庫金,2704,659,2045,摩根大通,2024-07-03,8440
2027,大成鋼,2012,225,1787,摩根大通,2024-07-03,8440
8112,至上,1465,92,1373,摩根大通,2024-07-03,8440
2303,聯電,4146,2843,1303,摩根大通,2024-07-03,8440
2884,玉山金,5664,4371,1293,摩根大通,2024-07-03,8440
2606,裕民,1627,411,1216,摩根大通,2024-07-03,8440
2892,第一金,1691,491,1200,摩根大通,2024-07-03,8440
2801,彰銀,1354,154,1200,摩根大通,2024-07-03,8440
2449,京元電子,1662,514,1148,摩根大通,2024-07-03,8440
8069,元太,1222,93,1129,摩根大通,2024-07-03,8440
4919,新唐,1212,137,1075,摩根大通,2024-07-03,8440
3047,訊舟,2466,1449,1017,摩根大通,2024-07-03,8440
2317,鴻海,1406,398,1008,摩根大通,2024-07-03,8440
2408,南亞科,1257,314,943,摩根大通,2024-07-03,8440
2323,中環,2175,1242,933,摩根大通,2024-07-03,8440
2308,台達電,945,33,912,摩根大通,2024-07-03,8440
1101,台泥,970,161,809,摩根大通,2024-07-03,8440
4915,致伸,1012,215,797,摩根大通,2024-07-03,8440
6182,合晶,1239,461,778,摩根大通,2024-07-03,8440
2641,正德,946,201,745,摩根大通,2024-07-03,8440
1714,和桐,741,0,741,摩根大通,2024-07-03,8440
6189,豐藝,1216,478,738,摩根大通,2024-07-03,8440
5483,中美晶,778,56,722,摩根大通,2024-07-03,8440
1444,力麗,750,40,710,摩根大通,2024-07-03,8440
9945,潤泰新,847,157,690,摩根大通,2024-07-03,8440
3050,鈺德,1237,562,675,摩根大通,2024-07-03,8440
2105,正新,789,120,669,摩根大通,2024-07-03,8440
3048,益登,747,97,650,摩根大通,2024-07-03,8440
2809,京城銀,903,261,642,摩根大通,2024-07-03,8440
3033,威健,683,45,638,摩根大通,2024-07-03,8440
3455,由田,803,221,582,摩根大通,2024-07-03,8440
6770,力積電,651,98,553,摩根大通,2024-07-03,8440
5608,四維航,570,23,547,摩根大通,2024-07-03,8440
2614,東森,556,14,542,摩根大通,2024-07-03,8440
2455,全新,816,277,539,摩根大通,2024-07-03,8440
2897,王道銀行,1032,493,539,摩根大通,2024-07-03,8440
1409,新纖,531,0,531,摩根大通,2024-07-03,8440
6015,宏遠證,521,0,521,摩根大通,2024-07-03,8440
2303,聯電,9628,273,9355,摩根大通,2024-07-04,8440
2317,鴻海,7886,1305,6581,摩根大通,2024-07-04,8440
2882,國泰金,7647,1359,6288,摩根大通,2024-07-04,8440
2884,玉山金,6628,368,6260,摩根大通,2024-07-04,8440
1314,中石化,5257,0,5257,摩根大通,2024-07-04,8440
2887,台新金,4942,322,4620,摩根大通,2024-07-04,8440
2330,台積電,4905,824,4081,摩根大通,2024-07-04,8440
3481,群創,4176,538,3638,摩根大通,2024-07-04,8440
2337,旺宏,4397,1087,3310,摩根大通,2024-07-04,8440
2867,三商壽,3438,245,3193,摩根大通,2024-07-04,8440
5880,合庫金,3485,376,3109,摩根大通,2024-07-04,8440
2313,華通,3174,68,3106,摩根大通,2024-07-04,8440
2892,第一金,3397,294,3103,摩根大通,2024-07-04,8440
2888,新光金,3051,351,2700,摩根大通,2024-07-04,8440
2885,元大金,2930,367,2563,摩根大通,2024-07-04,8440
2352,佳世達,2760,261,2499,摩根大通,2024-07-04,8440
2449,京元電子,3118,721,2397,摩根大通,2024-07-04,8440
2312,金寶,2462,67,2395,摩根大通,2024-07-04,8440
2002,中鋼,2694,477,2217,摩根大通,2024-07-04,8440
2886,兆豐金,2761,679,2082,摩根大通,2024-07-04,8440
2801,彰銀,2330,408,1922,摩根大通,2024-07-04,8440
2881,富邦金,2447,549,1898,摩根大通,2024-07-04,8440
2890,永豐金,2960,1188,1772,摩根大通,2024-07-04,8440
2880,華南金,3171,1408,1763,摩根大通,2024-07-04,8440
2417,圓剛,1589,14,1575,摩根大通,2024-07-04,8440
2408,南亞科,1700,134,1566,摩根大通,2024-07-04,8440
1303,南亞,2535,981,1554,摩根大通,2024-07-04,8440
1513,中興電,1856,311,1545,摩根大通,2024-07-04,8440
2891,中信金,2907,1393,1514,摩根大通,2024-07-04,8440
3189,景碩,1332,96,1236,摩根大通,2024-07-04,8440
2323,中環,1654,429,1225,摩根大通,2024-07-04,8440
3702,大聯大,1421,273,1148,摩根大通,2024-07-04,8440
1101,台泥,1622,479,1143,摩根大通,2024-07-04,8440
6505,台塑化,1233,92,1141,摩根大通,2024-07-04,8440
6770,力積電,1610,484,1126,摩根大通,2024-07-04,8440
2356,英業達,1337,228,1109,摩根大通,2024-07-04,8440
2610,華航,1105,12,1093,摩根大通,2024-07-04,8440
2543,皇昌,1143,86,1057,摩根大通,2024-07-04,8440
2308,台達電,1065,50,1015,摩根大通,2024-07-04,8440
6182,合晶,1323,336,987,摩根大通,2024-07-04,8440
2105,正新,1016,75,941,摩根大通,2024-07-04,8440
4958,臻鼎-KY,2407,1475,932,摩根大通,2024-07-04,8440
2467,志聖,1044,182,862,摩根大通,2024-07-04,8440
1718,中纖,856,2,854,摩根大通,2024-07-04,8440
2379,瑞昱,881,134,747,摩根大通,2024-07-04,8440
5876,上海商銀,1139,421,718,摩根大通,2024-07-04,8440
4919,新唐,857,140,717,摩根大通,2024-07-04,8440
1605,華新,721,22,699,摩根大通,2024-07-04,8440
2347,聯強,1221,528,693,摩根大通,2024-07-04,8440
2412,中華電,1179,514,665,摩根大通,2024-07-04,8440
2363,矽統,9301,277,9024,摩根大通,2024-07-05,8440
1785,光洋科,6255,688,5567,摩根大通,2024-07-05,8440
2337,旺宏,5388,344,5044,摩根大通,2024-07-05,8440
2352,佳世達,2717,351,2366,摩根大通,2024-07-05,8440
2313,華通,2211,145,2066,摩根大通,2024-07-05,8440
1815,富喬,2038,0,2038,摩根大通,2024-07-05,8440
6182,合晶,1952,15,1937,摩根大通,2024-07-05,8440
2323,中環,2660,731,1929,摩根大通,2024-07-05,8440
2409,友達,2610,683,1927,摩根大通,2024-07-05,8440
2401,凌陽,2144,335,1809,摩根大通,2024-07-05,8440
5469,瀚宇博,1866,67,1799,摩根大通,2024-07-05,8440
4958,臻鼎-KY,2512,753,1759,摩根大通,2024-07-05,8440
8028,昇陽半導體,1840,106,1734,摩根大通,2024-07-05,8440
4968,立積,1625,295,1330,摩根大通,2024-07-05,8440
3189,景碩,1364,41,1323,摩根大通,2024-07-05,8440
6126,信音,1298,5,1293,摩根大通,2024-07-05,8440
5443,均豪,1283,35,1248,摩根大通,2024-07-05,8440
2609,陽明,2885,1643,1242,摩根大通,2024-07-05,8440
1101,台泥,1214,9,1205,摩根大通,2024-07-05,8440
2417,圓剛,1358,163,1195,摩根大通,2024-07-05,8440
2449,京元電子,1663,486,1177,摩根大通,2024-07-05,8440
4919,新唐,1142,0,1142,摩根大通,2024-07-05,8440
4960,誠美材,1732,653,1079,摩根大通,2024-07-05,8440
2412,中華電,1382,311,1071,摩根大通,2024-07-05,8440
2834,臺企銀,1155,100,1055,摩根大通,2024-07-05,8440
2344,華邦電,1009,7,1002,摩根大通,2024-07-05,8440
6116,彩晶,1002,5,997,摩根大通,2024-07-05,8440
3048,益登,1703,736,967,摩根大通,2024-07-05,8440
5328,華容,982,37,945,摩根大通,2024-07-05,8440
6274,台燿,1092,161,931,摩根大通,2024-07-05,8440
2405,輔信,1011,81,930,摩根大通,2024-07-05,8440
2421,建準,926,0,926,摩根大通,2024-07-05,8440
8064,東捷,965,47,918,摩根大通,2024-07-05,8440
2495,普安,1167,268,899,摩根大通,2024-07-05,8440
2882,國泰金,1210,320,890,摩根大通,2024-07-05,8440
1444,力麗,902,68,834,摩根大通,2024-07-05,8440
3050,鈺德,1056,282,774,摩根大通,2024-07-05,8440
1447,力鵬,733,4,729,摩根大通,2024-07-05,8440
3059,華晶科,730,2,728,摩根大通,2024-07-05,8440
2836,高雄銀,735,8,727,摩根大通,2024-07-05,8440
2369,菱生,726,0,726,摩根大通,2024-07-05,8440
1718,中纖,803,92,711,摩根大通,2024-07-05,8440
1536,和大,833,133,700,摩根大通,2024-07-05,8440
5309,系統電,682,0,682,摩根大通,2024-07-05,8440
1312,國喬,668,10,658,摩根大通,2024-07-05,8440
8110,華東,652,9,643,摩根大通,2024-07-05,8440
3227,原相,740,101,639,摩根大通,2024-07-05,8440
3049,精金,678,44,634,摩根大通,2024-07-05,8440
4908,前鼎,625,18,607,摩根大通,2024-07-05,8440
1711,永光,613,8,605,摩根大通,2024-07-05,8440
2303,聯電,8012,1830,6182,摩根大通,2024-07-08,8440
2891,中信金,4767,726,4041,摩根大通,2024-07-08,8440
2615,萬海,4589,757,3832,摩根大通,2024-07-08,8440
2885,元大金,3338,42,3296,摩根大通,2024-07-08,8440
2344,華邦電,3172,86,3086,摩根大通,2024-07-08,8440
1314,中石化,2889,18,2871,摩根大通,2024-07-08,8440
2609,陽明,4079,1316,2763,摩根大通,2024-07-08,8440
3481,群創,2725,543,2182,摩根大通,2024-07-08,8440
4958,臻鼎-KY,2187,322,1865,摩根大通,2024-07-08,8440
2801,彰銀,2287,450,1837,摩根大通,2024-07-08,8440
2337,旺宏,2325,733,1592,摩根大通,2024-07-08,8440
2412,中華電,1541,17,1524,摩根大通,2024-07-08,8440
2363,矽統,3085,1738,1347,摩根大通,2024-07-08,8440
2812,台中銀,1327,0,1327,摩根大通,2024-07-08,8440
2367,燿華,2273,1046,1227,摩根大通,2024-07-08,8440
3037,欣興,875,3,872,摩根大通,2024-07-08,8440
2313,華通,1289,423,866,摩根大通,2024-07-08,8440
2892,第一金,1037,185,852,摩根大通,2024-07-08,8440
2886,兆豐金,1496,654,842,摩根大通,2024-07-08,8440
2882,國泰金,1456,714,742,摩根大通,2024-07-08,8440
2324,仁寶,766,49,717,摩根大通,2024-07-08,8440
2883,凱基金,1194,497,697,摩根大通,2024-07-08,8440
2897,王道銀行,638,3,635,摩根大通,2024-07-08,8440
5483,中美晶,641,28,613,摩根大通,2024-07-08,8440
1326,台化,839,227,612,摩根大通,2024-07-08,8440
2610,華航,1309,698,611,摩根大通,2024-07-08,8440
6415,矽力*-KY,639,35,604,摩根大通,2024-07-08,8440
2867,三商壽,714,150,564,摩根大通,2024-07-08,8440
2887,台新金,1407,855,552,摩根大通,2024-07-08,8440
3189,景碩,765,260,505,摩根大通,2024-07-08,8440
5347,世界,617,153,464,摩根大通,2024-07-08,8440
5469,瀚宇博,473,36,437,摩根大通,2024-07-08,8440
6770,力積電,894,461,433,摩根大通,2024-07-08,8440
1605,華新,488,57,431,摩根大通,2024-07-08,8440
2352,佳世達,768,343,425,摩根大通,2024-07-08,8440
2889,國票金,499,76,423,摩根大通,2024-07-08,8440
1460,宏遠,423,9,414,摩根大通,2024-07-08,8440
6015,宏遠證,437,28,409,摩根大通,2024-07-08,8440
2915,潤泰全,411,22,389,摩根大通,2024-07-08,8440
2365,昆盈,1269,920,349,摩根大通,2024-07-08,8440
5009,榮剛,339,1,338,摩根大通,2024-07-08,8440
6239,力成,436,118,318,摩根大通,2024-07-08,8440
4123,晟德,320,12,308,摩根大通,2024-07-08,8440
9958,世紀鋼,409,110,299,摩根大通,2024-07-08,8440
6005,群益證,289,4,285,摩根大通,2024-07-08,8440
2354,鴻準,1292,1016,276,摩根大通,2024-07-08,8440
2637,慧洋-KY,376,101,275,摩根大通,2024-07-08,8440
2611,志信,358,90,268,摩根大通,2024-07-08,8440
2408,南亞科,373,113,260,摩根大通,2024-07-08,8440
5452,佶優,775,531,244,摩根大通,2024-07-08,8440
2888,新光金,13947,7081,6866,摩根大通,2024-07-09,8440
2883,凱基金,5808,368,5440,摩根大通,2024-07-09,8440
2405,輔信,5160,2513,2647,摩根大通,2024-07-09,8440
2609,陽明,5459,2935,2524,摩根大通,2024-07-09,8440
2365,昆盈,2543,275,2268,摩根大通,2024-07-09,8440
2408,南亞科,2764,510,2254,摩根大通,2024-07-09,8440
2867,三商壽,2280,153,2127,摩根大通,2024-07-09,8440
5347,世界,2218,264,1954,摩根大通,2024-07-09,8440
2382,廣達,2244,551,1693,摩根大通,2024-07-09,8440
2349,錸德,1672,0,1672,摩根大通,2024-07-09,8440
2344,華邦電,2070,596,1474,摩根大通,2024-07-09,8440
2887,台新金,1747,322,1425,摩根大通,2024-07-09,8440
2464,盟立,1773,441,1332,摩根大通,2024-07-09,8440
1402,遠東新,1573,260,1313,摩根大通,2024-07-09,8440
2615,萬海,2311,1012,1299,摩根大通,2024-07-09,8440
2371,大同,1366,160,1206,摩根大通,2024-07-09,8440
2890,永豐金,1366,169,1197,摩根大通,2024-07-09,8440
3047,訊舟,3797,2672,1125,摩根大通,2024-07-09,8440
6244,茂迪,1040,18,1022,摩根大通,2024-07-09,8440
5443,均豪,1753,732,1021,摩根大通,2024-07-09,8440
2836,高雄銀,1062,81,981,摩根大通,2024-07-09,8440
2884,玉山金,1222,293,929,摩根大通,2024-07-09,8440
3048,益登,1044,117,927,摩根大通,2024-07-09,8440
8064,東捷,1043,197,846,摩根大通,2024-07-09,8440
2412,中華電,869,36,833,摩根大通,2024-07-09,8440
5009,榮剛,671,1,670,摩根大通,2024-07-09,8440
2352,佳世達,1280,615,665,摩根大通,2024-07-09,8440
3535,晶彩科,699,42,657,摩根大通,2024-07-09,8440
2881,富邦金,1077,434,643,摩根大通,2024-07-09,8440
1513,中興電,680,47,633,摩根大通,2024-07-09,8440
1216,統一,1055,470,585,摩根大通,2024-07-09,8440
2417,圓剛,1113,529,584,摩根大通,2024-07-09,8440
2474,可成,716,140,576,摩根大通,2024-07-09,8440
2454,聯發科,881,308,573,摩根大通,2024-07-09,8440
1608,華榮,583,18,565,摩根大通,2024-07-09,8440
2892,第一金,647,113,534,摩根大通,2024-07-09,8440
5469,瀚宇博,630,100,530,摩根大通,2024-07-09,8440
2801,彰銀,662,141,521,摩根大通,2024-07-09,8440
2379,瑞昱,603,100,503,摩根大通,2024-07-09,8440
2313,華通,1140,640,500,摩根大通,2024-07-09,8440
2330,台積電,6787,6310,477,摩根大通,2024-07-09,8440
8028,昇陽半導體,914,449,465,摩根大通,2024-07-09,8440
2337,旺宏,1422,970,452,摩根大通,2024-07-09,8440
3520,華盈,506,60,446,摩根大通,2024-07-09,8440
3576,聯合再生,586,147,439,摩根大通,2024-07-09,8440
2324,仁寶,974,553,421,摩根大通,2024-07-09,8440
2376,技嘉,608,198,410,摩根大通,2024-07-09,8440
2354,鴻準,705,297,408,摩根大通,2024-07-09,8440
4123,晟德,632,248,384,摩根大通,2024-07-09,8440
3324,雙鴻,476,120,356,摩根大通,2024-07-09,8440
2382,廣達,5659,929,4730,摩根大通,2024-07-10,8440
2618,長榮航,4346,409,3937,摩根大通,2024-07-10,8440
2888,新光金,11745,8064,3681,摩根大通,2024-07-10,8440
1815,富喬,2901,4,2897,摩根大通,2024-07-10,8440
2867,三商壽,2997,228,2769,摩根大通,2024-07-10,8440
2301,光寶科,2651,107,2544,摩根大通,2024-07-10,8440
2884,玉山金,2965,995,1970,摩根大通,2024-07-10,8440
4960,誠美材,2042,245,1797,摩根大通,2024-07-10,8440
1513,中興電,1942,288,1654,摩根大通,2024-07-10,8440
2882,國泰金,2057,471,1586,摩根大通,2024-07-10,8440
2357,華碩,1677,116,1561,摩根大通,2024-07-10,8440
2409,友達,2982,1437,1545,摩根大通,2024-07-10,8440
2883,凱基金,2311,988,1323,摩根大通,2024-07-10,8440
6190,萬泰科,1131,6,1125,摩根大通,2024-07-10,8440
4906,正文,1226,189,1037,摩根大通,2024-07-10,8440
2353,宏��,2254,1277,977,摩根大通,2024-07-10,8440
3481,群創,1811,964,847,摩根大通,2024-07-10,8440
2303,聯電,3062,2230,832,摩根大通,2024-07-10,8440
4958,臻鼎-KY,1643,850,793,摩根大通,2024-07-10,8440
6177,達麗,893,115,778,摩根大通,2024-07-10,8440
2615,萬海,1510,735,775,摩根大通,2024-07-10,8440
2609,陽明,1535,782,753,摩根大通,2024-07-10,8440
2548,華固,732,40,692,摩根大通,2024-07-10,8440
1802,台玻,783,151,632,摩根大通,2024-07-10,8440
4938,和碩,644,23,621,摩根大通,2024-07-10,8440
4726,永昕,659,52,607,摩根大通,2024-07-10,8440
4908,前鼎,569,0,569,摩根大通,2024-07-10,8440
8086,宏捷科,558,0,558,摩根大通,2024-07-10,8440
2408,南亞科,1093,544,549,摩根大通,2024-07-10,8440
2442,新美齊,559,28,531,摩根大通,2024-07-10,8440
5498,凱崴,516,7,509,摩根大通,2024-07-10,8440
2836,高雄銀,570,83,487,摩根大通,2024-07-10,8440
5512,力麒,520,39,481,摩根大通,2024-07-10,8440
6163,華電網,497,30,467,摩根大通,2024-07-10,8440
6462,神盾,481,33,448,摩根大通,2024-07-10,8440
6153,嘉聯益,596,161,435,摩根大通,2024-07-10,8440
2206,三陽工業,705,285,420,摩根大通,2024-07-10,8440
3033,威健,522,103,419,摩根大通,2024-07-10,8440
2537,聯上發,433,22,411,摩根大通,2024-07-10,8440
6546,正基,642,232,410,摩根大通,2024-07-10,8440
5880,合庫金,820,419,401,摩根大通,2024-07-10,8440
2504,國產,478,86,392,摩根大通,2024-07-10,8440
8926,台汽電,397,7,390,摩根大通,2024-07-10,8440
2637,慧洋-KY,469,82,387,摩根大通,2024-07-10,8440
8358,金居,807,420,387,摩根大通,2024-07-10,8440
2887,台新金,872,489,383,摩根大通,2024-07-10,8440
8110,華東,389,7,382,摩根大通,2024-07-10,8440
2363,矽統,653,276,377,摩根大通,2024-07-10,8440
6274,台燿,474,97,377,摩根大通,2024-07-10,8440
2885,元大金,601,240,361,摩根大通,2024-07-10,8440
2409,友達,7979,890,7089,摩根大通,2024-07-11,8440
2330,台積電,6866,1605,5261,摩根大通,2024-07-11,8440
2883,凱基金,5712,553,5159,摩根大通,2024-07-11,8440
3481,群創,3504,428,3076,摩根大通,2024-07-11,8440
3037,欣興,3735,829,2906,摩根大通,2024-07-11,8440
2615,萬海,2100,70,2030,摩根大通,2024-07-11,8440
2609,陽明,2226,218,2008,摩根大通,2024-07-11,8440
2356,英業達,3913,1935,1978,摩根大通,2024-07-11,8440
3706,神達,2205,297,1908,摩根大通,2024-07-11,8440
6770,力積電,2002,106,1896,摩根大通,2024-07-11,8440
3013,晟銘電,2167,380,1787,摩根大通,2024-07-11,8440
2303,聯電,2678,899,1779,摩根大通,2024-07-11,8440
1102,亞泥,1795,220,1575,摩根大通,2024-07-11,8440
1402,遠東新,1518,55,1463,摩根大通,2024-07-11,8440
2353,宏��,2041,697,1344,摩根大通,2024-07-11,8440
1303,南亞,2713,1461,1252,摩根大通,2024-07-11,8440
2337,旺宏,1325,162,1163,摩根大通,2024-07-11,8440
2352,佳世達,1158,211,947,摩根大通,2024-07-11,8440
2520,冠德,973,37,936,摩根大通,2024-07-11,8440
2347,聯強,1724,836,888,摩根大通,2024-07-11,8440
2884,玉山金,1713,832,881,摩根大通,2024-07-11,8440
9945,潤泰新,968,130,838,摩根大通,2024-07-11,8440
2892,第一金,846,53,793,摩根大通,2024-07-11,8440
4938,和碩,805,23,782,摩根大通,2024-07-11,8440
3312,弘憶股,1010,261,749,摩根大通,2024-07-11,8440
3702,大聯大,1289,540,749,摩根大通,2024-07-11,8440
2301,光寶科,855,138,717,摩根大通,2024-07-11,8440
1326,台化,787,122,665,摩根大通,2024-07-11,8440
4566,時碩工業,716,68,648,摩根大通,2024-07-11,8440
1513,中興電,2051,1421,630,摩根大通,2024-07-11,8440
2344,華邦電,941,316,625,摩根大通,2024-07-11,8440
2412,中華電,1017,428,589,摩根大通,2024-07-11,8440
2388,威盛,683,119,564,摩根大通,2024-07-11,8440
3576,聯合再生,657,147,510,摩根大通,2024-07-11,8440
6153,嘉聯益,565,68,497,摩根大通,2024-07-11,8440
2855,統一證,497,2,495,摩根大通,2024-07-11,8440
5309,系統電,886,393,493,摩根大通,2024-07-11,8440
2885,元大金,1017,532,485,摩根大通,2024-07-11,8440
2887,台新金,2001,1522,479,摩根大通,2024-07-11,8440
2401,凌陽,549,84,465,摩根大通,2024-07-11,8440
2504,國產,471,14,457,摩根大通,2024-07-11,8440
2317,鴻海,1564,1114,450,摩根大通,2024-07-11,8440
3163,波若威,1071,636,435,摩根大通,2024-07-11,8440
2890,永豐金,861,448,413,摩根大通,2024-07-11,8440
6015,宏遠證,416,23,393,摩根大通,2024-07-11,8440
2453,凌群,553,162,391,摩根大通,2024-07-11,8440
4956,光鋐,386,5,381,摩根大通,2024-07-11,8440
3290,東浦,398,21,377,摩根大通,2024-07-11,8440
2547,日勝生,391,15,376,摩根大通,2024-07-11,8440
2915,潤泰全,502,130,372,摩根大通,2024-07-11,8440
2409,友達,19868,1045,18823,摩根大通,2024-07-12,8440
2888,新光金,11882,3406,8476,摩根大通,2024-07-12,8440
2356,英業達,9106,1148,7958,摩根大通,2024-07-12,8440
2615,萬海,6015,320,5695,摩根大通,2024-07-12,8440
2324,仁寶,3231,455,2776,摩根大通,2024-07-12,8440
3702,大聯大,2114,151,1963,摩根大通,2024-07-12,8440
3189,景碩,2710,870,1840,摩根大通,2024-07-12,8440
1312,國喬,1949,110,1839,摩根大通,2024-07-12,8440
5876,上海商銀,2225,586,1639,摩根大通,2024-07-12,8440
2365,昆盈,2013,737,1276,摩根大通,2024-07-12,8440
9105,泰金寶-DR,1370,103,1267,摩根大通,2024-07-12,8440
5880,合庫金,2232,977,1255,摩根大通,2024-07-12,8440
2354,鴻準,1313,68,1245,摩根大通,2024-07-12,8440
1101,台泥,1938,728,1210,摩根大通,2024-07-12,8440
8105,凌巨,1849,666,1183,摩根大通,2024-07-12,8440
2481,強茂,1246,177,1069,摩根大通,2024-07-12,8440
1402,遠東新,1360,346,1014,摩根大通,2024-07-12,8440
9945,潤泰新,1982,1029,953,摩根大通,2024-07-12,8440
2489,瑞軒,1297,350,947,摩根大通,2024-07-12,8440
2801,彰銀,1454,540,914,摩根大通,2024-07-12,8440
1536,和大,1108,252,856,摩根大通,2024-07-12,8440
2345,智邦,935,106,829,摩根大通,2024-07-12,8440
1303,南亞,1944,1117,827,摩根大通,2024-07-12,8440
1785,光洋科,1068,267,801,摩根大通,2024-07-12,8440
6770,力積電,973,221,752,摩根大通,2024-07-12,8440
3037,欣興,2924,2219,705,摩根大通,2024-07-12,8440
4909,新復興,874,191,683,摩根大通,2024-07-12,8440
1815,富喬,1062,379,683,摩根大通,2024-07-12,8440
1513,中興電,1785,1111,674,摩根大通,2024-07-12,8440
2399,映泰,671,7,664,摩根大通,2024-07-12,8440
2609,陽明,1088,428,660,摩根大通,2024-07-12,8440
6806,森崴能源,1078,423,655,摩根大通,2024-07-12,8440
2498,宏達電,682,49,633,摩根大通,2024-07-12,8440
2392,正崴,720,88,632,摩根大通,2024-07-12,8440
2915,潤泰全,1037,432,605,摩根大通,2024-07-12,8440
2867,三商壽,4801,4201,600,摩根大通,2024-07-12,8440
2882,國泰金,1263,711,552,摩根大通,2024-07-12,8440
1102,亞泥,1299,772,527,摩根大通,2024-07-12,8440
2402,毅嘉,588,82,506,摩根大通,2024-07-12,8440
2886,兆豐金,1380,886,494,摩根大通,2024-07-12,8440
4714,永捷,1173,685,488,摩根大通,2024-07-12,8440
4566,時碩工業,1032,545,487,摩根大通,2024-07-12,8440
1304,台聚,553,69,484,摩根大通,2024-07-12,8440
6015,宏遠證,600,123,477,摩根大通,2024-07-12,8440
2883,凱基金,1782,1313,469,摩根大通,2024-07-12,8440
2524,京城,676,208,468,摩根大通,2024-07-12,8440
1409,新纖,464,0,464,摩根大通,2024-07-12,8440
2406,國碩,570,111,459,摩根大通,2024-07-12,8440
2344,華邦電,966,518,448,摩根大通,2024-07-12,8440
9910,豐泰,489,66,423,摩根大通,2024-07-12,8440
2615,萬海,6593,452,6141,摩根大通,2024-07-15,8440
8936,國統,4471,297,4174,摩根大通,2024-07-15,8440
2881,富邦金,5336,1636,3700,摩根大通,2024-07-15,8440
2449,京元電子,2822,503,2319,摩根大通,2024-07-15,8440
1503,士電,1770,186,1584,摩根大通,2024-07-15,8440
2481,強茂,2369,896,1473,摩根大通,2024-07-15,8440
5876,上海商銀,1940,482,1458,摩根大通,2024-07-15,8440
1402,遠東新,1543,144,1399,摩根大通,2024-07-15,8440
2880,華南金,1737,457,1280,摩根大通,2024-07-15,8440
2303,聯電,2367,1306,1061,摩根大通,2024-07-15,8440
2884,玉山金,4902,3848,1054,摩根大通,2024-07-15,8440
2027,大成鋼,1441,448,993,摩根大通,2024-07-15,8440
4904,遠傳,1659,670,989,摩根大通,2024-07-15,8440
1785,光洋科,1439,472,967,摩根大通,2024-07-15,8440
2345,智邦,902,53,849,摩根大通,2024-07-15,8440
2887,台新金,1007,175,832,摩根大通,2024-07-15,8440
2308,台達電,889,58,831,摩根大通,2024-07-15,8440
3231,緯創,1288,494,794,摩根大通,2024-07-15,8440
3702,大聯大,1743,975,768,摩根大通,2024-07-15,8440
2520,冠德,782,54,728,摩根大通,2024-07-15,8440
2883,凱基金,2402,1689,713,摩根大通,2024-07-15,8440
2610,華航,5522,4868,654,摩根大通,2024-07-15,8440
1102,亞泥,1237,622,615,摩根大通,2024-07-15,8440
5371,中光電,751,181,570,摩根大通,2024-07-15,8440
1101,台泥,812,319,493,摩根大通,2024-07-15,8440
4958,臻鼎-KY,716,255,461,摩根大通,2024-07-15,8440
1316,上曜,500,43,457,摩根大通,2024-07-15,8440
1582,信錦,464,8,456,摩根大通,2024-07-15,8440
2892,第一金,575,119,456,摩根大通,2024-07-15,8440
3056,富華新,631,183,448,摩根大通,2024-07-15,8440
6125,廣運,462,43,419,摩根大通,2024-07-15,8440
6472,保瑞,527,121,406,摩根大通,2024-07-15,8440
2393,億光,560,175,385,摩根大通,2024-07-15,8440
6177,達麗,570,186,384,摩根大通,2024-07-15,8440
2206,三陽工業,481,110,371,摩根大通,2024-07-15,8440
2530,華建,386,17,369,摩根大通,2024-07-15,8440
8086,宏捷科,356,4,352,摩根大通,2024-07-15,8440
2455,全新,367,17,350,摩根大通,2024-07-15,8440
2367,燿華,491,151,340,摩根大通,2024-07-15,8440
9958,世紀鋼,561,225,336,摩根大通,2024-07-15,8440
3576,聯合再生,394,59,335,摩根大通,2024-07-15,8440
2515,中工,364,32,332,摩根大通,2024-07-15,8440
6443,元晶,339,7,332,摩根大通,2024-07-15,8440
9910,豐泰,364,43,321,摩根大通,2024-07-15,8440
2547,日勝生,368,52,316,摩根大通,2024-07-15,8440
4123,晟德,352,49,303,摩根大通,2024-07-15,8440
2359,所羅門,359,60,299,摩根大通,2024-07-15,8440
1532,勤美,329,30,299,摩根大通,2024-07-15,8440
5508,永信建,309,11,298,摩根大通,2024-07-15,8440
1522,堤維西,308,12,296,摩根大通,2024-07-15,8440
00881,國泰台灣5G+,8415,14,8401,摩根大通,2024-07-16,8440
2883,凱基金,2421,339,2082,摩根大通,2024-07-16,8440
3231,緯創,2292,244,2048,摩根大通,2024-07-16,8440
2882,國泰金,2251,921,1330,摩根大通,2024-07-16,8440
2809,京城銀,1323,18,1305,摩根大通,2024-07-16,8440
2303,聯電,2718,1418,1300,摩根大通,2024-07-16,8440
2618,長榮航,1567,402,1165,摩根大通,2024-07-16,8440
2885,元大金,1367,204,1163,摩根大通,2024-07-16,8440
2890,永豐金,1240,122,1118,摩根大通,2024-07-16,8440
4904,遠傳,1226,153,1073,摩根大通,2024-07-16,8440
2449,京元電子,2580,1579,1001,摩根大通,2024-07-16,8440
2504,國產,1146,146,1000,摩根大通,2024-07-16,8440
8054,安國,1054,76,978,摩根大通,2024-07-16,8440
2489,瑞軒,1675,706,969,摩根大通,2024-07-16,8440
2637,慧洋-KY,1102,140,962,摩根大通,2024-07-16,8440
3189,景碩,1200,368,832,摩根大通,2024-07-16,8440
3481,群創,680,0,680,摩根大通,2024-07-16,8440
5347,世界,672,68,604,摩根大通,2024-07-16,8440
1504,東元,634,51,583,摩根大通,2024-07-16,8440
2344,華邦電,591,21,570,摩根大通,2024-07-16,8440
6548,長科*,589,31,558,摩根大通,2024-07-16,8440
4968,立積,599,46,553,摩根大通,2024-07-16,8440
9945,潤泰新,1439,901,538,摩根大通,2024-07-16,8440
6127,九豪,688,162,526,摩根大通,2024-07-16,8440
2405,輔信,778,291,487,摩根大通,2024-07-16,8440
4566,時碩工業,475,23,452,摩根大通,2024-07-16,8440
2609,陽明,972,540,432,摩根大通,2024-07-16,8440
4938,和碩,613,188,425,摩根大通,2024-07-16,8440
8064,東捷,571,156,415,摩根大通,2024-07-16,8440
2442,新美齊,433,36,397,摩根大通,2024-07-16,8440
2368,金像電,574,196,378,摩根大通,2024-07-16,8440
4915,致伸,379,7,372,摩根大通,2024-07-16,8440
3022,威強電,400,31,369,摩根大通,2024-07-16,8440
3045,台灣大,585,217,368,摩根大通,2024-07-16,8440
6834,天二科技,402,40,362,摩根大通,2024-07-16,8440
2498,宏達電,367,6,361,摩根大通,2024-07-16,8440
8028,昇陽半導體,567,211,356,摩根大通,2024-07-16,8440
3673,TPK-KY,368,35,333,摩根大通,2024-07-16,8440
2327,國巨,352,30,322,摩根大通,2024-07-16,8440
9933,中鼎,399,78,321,摩根大通,2024-07-16,8440
3013,晟銘電,1036,717,319,摩根大通,2024-07-16,8440
5512,力麒,431,117,314,摩根大通,2024-07-16,8440
3706,神達,520,208,312,摩根大通,2024-07-16,8440
3710,連展投控,364,56,308,摩根大通,2024-07-16,8440
8086,宏捷科,325,17,308,摩根大通,2024-07-16,8440
2363,矽統,304,0,304,摩根大通,2024-07-16,8440
6176,瑞儀,366,65,301,摩根大通,2024-07-16,8440
8046,南電,543,253,290,摩根大通,2024-07-16,8440
3357,臺慶科,419,131,288,摩根大通,2024-07-16,8440
3207,耀勝,281,14,267,摩根大通,2024-07-16,8440
2303,聯電,12055,1359,10696,摩根大通,2024-07-17,8440
2610,華航,7799,801,6998,摩根大通,2024-07-17,8440
3481,群創,8997,3331,5666,摩根大通,2024-07-17,8440
2883,凱基金,6469,976,5493,摩根大通,2024-07-17,8440
2603,長榮,5272,569,4703,摩根大通,2024-07-17,8440
2885,元大金,4593,1448,3145,摩根大通,2024-07-17,8440
2882,國泰金,3890,1118,2772,摩根大通,2024-07-17,8440
2504,國產,2735,112,2623,摩根大通,2024-07-17,8440
2890,永豐金,2784,525,2259,摩根大通,2024-07-17,8440
2809,京城銀,2231,20,2211,摩根大通,2024-07-17,8440
2867,三商壽,2555,601,1954,摩根大通,2024-07-17,8440
4938,和碩,2311,425,1886,摩根大通,2024-07-17,8440
2884,玉山金,5886,4052,1834,摩根大通,2024-07-17,8440
2402,毅嘉,1974,403,1571,摩根大通,2024-07-17,8440
2317,鴻海,3088,1653,1435,摩根大通,2024-07-17,8440
2412,中華電,1986,597,1389,摩根大通,2024-07-17,8440
2356,英業達,2536,1174,1362,摩根大通,2024-07-17,8440
3062,建漢,1454,141,1313,摩根大通,2024-07-17,8440
4958,臻鼎-KY,1736,463,1273,摩根大通,2024-07-17,8440
4904,遠傳,1897,692,1205,摩根大通,2024-07-17,8440
1504,東元,1214,94,1120,摩根大通,2024-07-17,8440
2892,第一金,1899,800,1099,摩根大通,2024-07-17,8440
3045,台灣大,1414,353,1061,摩根大通,2024-07-17,8440
1605,華新,1409,366,1043,摩根大通,2024-07-17,8440
2834,臺企銀,1316,313,1003,摩根大通,2024-07-17,8440
5512,力麒,1097,102,995,摩根大通,2024-07-17,8440
3013,晟銘電,1958,996,962,摩根大通,2024-07-17,8440
2609,陽明,1828,962,866,摩根大通,2024-07-17,8440
4915,致伸,927,69,858,摩根大通,2024-07-17,8440
1101,台泥,1655,843,812,摩根大通,2024-07-17,8440
4513,福裕,1011,203,808,摩根大通,2024-07-17,8440
5880,合庫金,1095,297,798,摩根大通,2024-07-17,8440
1314,中石化,1030,244,786,摩根大通,2024-07-17,8440
2347,聯強,1018,239,779,摩根大通,2024-07-17,8440
3037,欣興,2357,1586,771,摩根大通,2024-07-17,8440
2548,華固,770,18,752,摩根大通,2024-07-17,8440
2323,中環,873,138,735,摩根大通,2024-07-17,8440
3023,信邦,840,129,711,摩根大通,2024-07-17,8440
1808,潤隆,739,68,671,摩根大通,2024-07-17,8440
2511,太子,907,246,661,摩根大通,2024-07-17,8440
6163,華電網,797,140,657,摩根大通,2024-07-17,8440
2615,萬海,1113,467,646,摩根大通,2024-07-17,8440
3703,欣陸,658,20,638,摩根大通,2024-07-17,8440
8046,南電,974,338,636,摩根大通,2024-07-17,8440
1102,亞泥,2400,1786,614,摩根大通,2024-07-17,8440
2801,彰銀,2513,1926,587,摩根大通,2024-07-17,8440
2365,昆盈,582,1,581,摩根大通,2024-07-17,8440
2337,旺宏,655,80,575,摩根大通,2024-07-17,8440
2354,鴻準,944,370,574,摩根大通,2024-07-17,8440
5534,長虹,647,77,570,摩根大通,2024-07-17,8440
3481,群創,28877,2493,26384,摩根大通,2024-07-18,8440
2883,凱基金,9032,57,8975,摩根大通,2024-07-18,8440
9904,寶成,6230,931,5299,摩根大通,2024-07-18,8440
2303,聯電,5455,1486,3969,摩根大通,2024-07-18,8440
2317,鴻海,6029,2245,3784,摩根大通,2024-07-18,8440
6005,群益證,4270,769,3501,摩根大通,2024-07-18,8440
1785,光洋科,3307,401,2906,摩根大通,2024-07-18,8440
2882,國泰金,3035,221,2814,摩根大通,2024-07-18,8440
2834,臺企銀,2769,14,2755,摩根大通,2024-07-18,8440
2027,大成鋼,3696,1072,2624,摩根大通,2024-07-18,8440
8936,國統,2718,319,2399,摩根大通,2024-07-18,8440
2504,國產,2058,60,1998,摩根大通,2024-07-18,8440
2809,京城銀,1755,35,1720,摩根大通,2024-07-18,8440
2892,第一金,1678,115,1563,摩根大通,2024-07-18,8440
3045,台灣大,1837,291,1546,摩根大通,2024-07-18,8440
4904,遠傳,2338,814,1524,摩根大通,2024-07-18,8440
3013,晟銘電,3133,1658,1475,摩根大通,2024-07-18,8440
5880,合庫金,1488,81,1407,摩根大通,2024-07-18,8440
2412,中華電,1346,108,1238,摩根大通,2024-07-18,8440
2881,富邦金,2468,1298,1170,摩根大通,2024-07-18,8440
2365,昆盈,1244,123,1121,摩根大通,2024-07-18,8440
3189,景碩,2659,1558,1101,摩根大通,2024-07-18,8440
2886,兆豐金,3089,2019,1070,摩根大通,2024-07-18,8440
4938,和碩,1402,400,1002,摩根大通,2024-07-18,8440
2351,順德,1092,174,918,摩根大通,2024-07-18,8440
9938,百和,943,110,833,摩根大通,2024-07-18,8440
2002,中鋼,855,37,818,摩根大通,2024-07-18,8440
2889,國票金,902,110,792,摩根大通,2024-07-18,8440
3163,波若威,1041,275,766,摩根大通,2024-07-18,8440
2308,台達電,878,152,726,摩根大通,2024-07-18,8440
3034,聯詠,776,79,697,摩根大通,2024-07-18,8440
1504,東元,801,159,642,摩根大通,2024-07-18,8440
1101,台泥,1047,439,608,摩根大通,2024-07-18,8440
2511,太子,881,322,559,摩根大通,2024-07-18,8440
2449,京元電子,1709,1163,546,摩根大通,2024-07-18,8440
2885,元大金,3013,2484,529,摩根大通,2024-07-18,8440
2548,華固,613,84,529,摩根大通,2024-07-18,8440
9105,泰金寶-DR,506,2,504,摩根大通,2024-07-18,8440
1102,亞泥,2749,2256,493,摩根大通,2024-07-18,8440
2357,華碩,649,194,455,摩根大通,2024-07-18,8440
8105,凌巨,622,213,409,摩根大通,2024-07-18,8440
2890,永豐金,786,379,407,摩根大通,2024-07-18,8440
6274,台燿,413,55,358,摩根大通,2024-07-18,8440
2006,東和鋼鐵,378,37,341,摩根大通,2024-07-18,8440
2312,金寶,1023,686,337,摩根大通,2024-07-18,8440
1808,潤隆,423,89,334,摩根大通,2024-07-18,8440
2454,聯發科,611,282,329,摩根大通,2024-07-18,8440
2855,統一證,533,209,324,摩根大通,2024-07-18,8440
4526,東台,304,6,298,摩根大通,2024-07-18,8440
3017,奇鋐,447,152,295,摩根大通,2024-07-18,8440
2303,聯電,5847,1830,4017,摩根大通,2024-07-19,8440
6005,群益證,3457,778,2679,摩根大通,2024-07-19,8440
2809,京城銀,1533,179,1354,摩根大通,2024-07-19,8440
2504,國產,1541,402,1139,摩根大通,2024-07-19,8440
3583,辛耘,792,106,686,摩根大通,2024-07-19,8440
1611,中電,704,57,647,摩根大通,2024-07-19,8440
1785,光洋科,973,340,633,摩根大通,2024-07-19,8440
2855,統一證,861,304,557,摩根大通,2024-07-19,8440
5443,均豪,510,91,419,摩根大通,2024-07-19,8440
1584,精剛,408,0,408,摩根大通,2024-07-19,8440
8096,擎亞,492,125,367,摩根大通,2024-07-19,8440
8105,凌巨,649,307,342,摩根大通,2024-07-19,8440
6412,群電,356,21,335,摩根大通,2024-07-19,8440
5213,亞昕,340,9,331,摩根大通,2024-07-19,8440
2520,冠德,608,284,324,摩根大通,2024-07-19,8440
1540,喬福,437,113,324,摩根大通,2024-07-19,8440
2006,東和鋼鐵,448,127,321,摩根大通,2024-07-19,8440
6197,佳必琪,328,10,318,摩根大通,2024-07-19,8440
3052,夆典,423,107,316,摩根大通,2024-07-19,8440
6446,藥華藥,384,82,302,摩根大通,2024-07-19,8440
4915,致伸,341,53,288,摩根大通,2024-07-19,8440
2883B,凱基金乙特,270,0,270,摩根大通,2024-07-19,8440
2489,瑞軒,516,248,268,摩根大通,2024-07-19,8440
4532,瑞智,290,41,249,摩根大通,2024-07-19,8440
2360,致茂,317,75,242,摩根大通,2024-07-19,8440
1309,台達化,260,37,223,摩根大通,2024-07-19,8440
6788,華景電,281,65,216,摩根大通,2024-07-19,8440
9933,中鼎,293,78,215,摩根大通,2024-07-19,8440
4906,正文,433,225,208,摩根大通,2024-07-19,8440
2412,中華電,881,679,202,摩根大通,2024-07-19,8440
1319,東陽,247,46,201,摩根大通,2024-07-19,8440
2025,千興,300,100,200,摩根大通,2024-07-19,8440
5371,中光電,220,25,195,摩根大通,2024-07-19,8440
2548,華固,232,38,194,摩根大通,2024-07-19,8440
1815,富喬,351,177,174,摩根大通,2024-07-19,8440
2354,鴻準,315,142,173,摩根大通,2024-07-19,8440
2347,聯強,632,473,159,摩根大通,2024-07-19,8440
2912,統一超,417,264,153,摩根大通,2024-07-19,8440
3673,TPK-KY,343,198,145,摩根大通,2024-07-19,8440
2417,圓剛,262,117,145,摩根大通,2024-07-19,8440
4109,加捷生醫,372,229,143,摩根大通,2024-07-19,8440
4958,臻鼎-KY,473,333,140,摩根大通,2024-07-19,8440
6180,橘子,142,6,136,摩根大通,2024-07-19,8440
1529,樂事綠能,233,106,127,摩根大通,2024-07-19,8440
3710,連展投控,126,0,126,摩根大通,2024-07-19,8440
3705,永信,162,36,126,摩根大通,2024-07-19,8440
3362,先進光,120,2,118,摩根大通,2024-07-19,8440
4533,協易機,206,89,117,摩根大通,2024-07-19,8440
2421,建準,227,114,113,摩根大通,2024-07-19,8440
2511,太子,417,308,109,摩根大通,2024-07-19,8440
2883,凱基金,5668,34,5634,摩根大通,2024-07-22,8440
2317,鴻海,9729,4479,5250,摩根大通,2024-07-22,8440
6005,群益證,4257,445,3812,摩根大通,2024-07-22,8440
2881,富邦金,3586,778,2808,摩根大通,2024-07-22,8440
2882,國泰金,3340,807,2533,摩根大通,2024-07-22,8440
2002,中鋼,2310,129,2181,摩根大通,2024-07-22,8440
2412,中華電,2242,65,2177,摩根大通,2024-07-22,8440
2888,新光金,4223,2059,2164,摩根大通,2024-07-22,8440
2885,元大金,2423,353,2070,摩根大通,2024-07-22,8440
2609,陽明,3256,1304,1952,摩根大通,2024-07-22,8440
2834,臺企銀,2117,179,1938,摩根大通,2024-07-22,8440
5880,合庫金,1874,147,1727,摩根大通,2024-07-22,8440
2371,大同,1705,90,1615,摩根大通,2024-07-22,8440
2890,永豐金,2138,562,1576,摩根大通,2024-07-22,8440
1101,台泥,1641,111,1530,摩根大通,2024-07-22,8440
2504,國產,1624,115,1509,摩根大通,2024-07-22,8440
2892,第一金,1536,52,1484,摩根大通,2024-07-22,8440
2312,金寶,1519,41,1478,摩根大通,2024-07-22,8440
2886,兆豐金,2528,1094,1434,摩根大通,2024-07-22,8440
2308,台達電,2211,783,1428,摩根大通,2024-07-22,8440
2615,萬海,2441,1047,1394,摩根大通,2024-07-22,8440
2610,華航,1408,162,1246,摩根大通,2024-07-22,8440
2867,三商壽,1245,91,1154,摩根大通,2024-07-22,8440
9105,泰金寶-DR,1146,11,1135,摩根大通,2024-07-22,8440
3045,台灣大,1401,338,1063,摩根大通,2024-07-22,8440
2809,京城銀,1041,144,897,摩根大通,2024-07-22,8440
1326,台化,851,10,841,摩根大通,2024-07-22,8440
6176,瑞儀,883,76,807,摩根大通,2024-07-22,8440
1314,中石化,930,129,801,摩根大通,2024-07-22,8440
2105,正新,844,48,796,摩根大通,2024-07-22,8440
1504,東元,1133,351,782,摩根大通,2024-07-22,8440
3062,建漢,841,91,750,摩根大通,2024-07-22,8440
2855,統一證,997,247,750,摩根大通,2024-07-22,8440
6505,台塑化,754,11,743,摩根大通,2024-07-22,8440
5371,中光電,708,55,653,摩根大通,2024-07-22,8440
4904,遠傳,1598,972,626,摩根大通,2024-07-22,8440
2633,台灣高鐵,635,10,625,摩根大通,2024-07-22,8440
4938,和碩,809,215,594,摩根大通,2024-07-22,8440
1303,南亞,1276,693,583,摩根大通,2024-07-22,8440
2889,國票金,640,66,574,摩根大通,2024-07-22,8440
1815,富喬,637,68,569,摩根大通,2024-07-22,8440
1540,喬福,687,120,567,摩根大通,2024-07-22,8440
2401,凌陽,638,77,561,摩根大通,2024-07-22,8440
4958,臻鼎-KY,893,336,557,摩根大通,2024-07-22,8440
2204,中華,550,6,544,摩根大通,2024-07-22,8440
6412,群電,565,68,497,摩根大通,2024-07-22,8440
1513,中興電,967,480,487,摩根大通,2024-07-22,8440
4123,晟德,495,10,485,摩根大通,2024-07-22,8440
2355,敬鵬,479,15,464,摩根大通,2024-07-22,8440
2836,高雄銀,467,26,441,摩根大通,2024-07-22,8440
2888,新光金,12953,1144,11809,摩根大通,2024-07-23,8440
2317,鴻海,8246,1609,6637,摩根大通,2024-07-23,8440
2027,大成鋼,5052,530,4522,摩根大通,2024-07-23,8440
2887,台新金,3174,434,2740,摩根大通,2024-07-23,8440
2891,中信金,3765,1379,2386,摩根大通,2024-07-23,8440
2834,臺企銀,2248,513,1735,摩根大通,2024-07-23,8440
1402,遠東新,1577,84,1493,摩根大通,2024-07-23,8440
2330,台積電,4247,2814,1433,摩根大通,2024-07-23,8440
2371,大同,1483,162,1321,摩根大通,2024-07-23,8440
2353,宏��,2301,1030,1271,摩根大通,2024-07-23,8440
3037,欣興,2374,1134,1240,摩根大通,2024-07-23,8440
1102,亞泥,1246,115,1131,摩根大通,2024-07-23,8440
2609,陽明,2387,1280,1107,摩根大通,2024-07-23,8440
2412,中華電,1459,360,1099,摩根大通,2024-07-23,8440
1605,華新,1293,214,1079,摩根大通,2024-07-23,8440
2421,建準,989,13,976,摩根大通,2024-07-23,8440
2344,華邦電,1269,368,901,摩根大通,2024-07-23,8440
1513,中興電,1209,325,884,摩根大通,2024-07-23,8440
2882,國泰金,1625,764,861,摩根大通,2024-07-23,8440
2504,國產,1177,426,751,摩根大通,2024-07-23,8440
2603,長榮,1613,878,735,摩根大通,2024-07-23,8440
5371,中光電,776,82,694,摩根大通,2024-07-23,8440
1444,力麗,754,69,685,摩根大通,2024-07-23,8440
2515,中工,708,36,672,摩根大通,2024-07-23,8440
6806,森崴能源,771,116,655,摩根大通,2024-07-23,8440
2204,中華,605,9,596,摩根大通,2024-07-23,8440
2881,富邦金,816,247,569,摩根大通,2024-07-23,8440
1101,台泥,594,69,525,摩根大通,2024-07-23,8440
9933,中鼎,556,32,524,摩根大通,2024-07-23,8440
9907,統一實,551,33,518,摩根大通,2024-07-23,8440
4906,正文,526,26,500,摩根大通,2024-07-23,8440
2880,華南金,876,377,499,摩根大通,2024-07-23,8440
1316,上曜,573,78,495,摩根大通,2024-07-23,8440
2383,台光電,555,66,489,摩根大通,2024-07-23,8440
2511,太子,588,118,470,摩根大通,2024-07-23,8440
3376,新日興,656,200,456,摩根大通,2024-07-23,8440
5880,合庫金,842,403,439,摩根大通,2024-07-23,8440
3324,雙鴻,599,175,424,摩根大通,2024-07-23,8440
2892,第一金,907,500,407,摩根大通,2024-07-23,8440
4109,加捷生醫,512,106,406,摩根大通,2024-07-23,8440
1806,冠軍,431,32,399,摩根大通,2024-07-23,8440
2547,日勝生,555,163,392,摩根大通,2024-07-23,8440
2634,漢翔,472,87,385,摩根大通,2024-07-23,8440
2376,技嘉,544,168,376,摩根大通,2024-07-23,8440
3033,威健,391,16,375,摩根大通,2024-07-23,8440
2362,藍天,467,109,358,摩根大通,2024-07-23,8440
4128,中天,504,147,357,摩根大通,2024-07-23,8440
1440,南紡,405,62,343,摩根大通,2024-07-23,8440
2385,群光,433,101,332,摩根大通,2024-07-23,8440
8473,山林水,372,43,329,摩根大通,2024-07-23,8440
2891,中信金,8093,4193,3900,摩根大通,2024-07-26,8440
2890,永豐金,2594,644,1950,摩根大通,2024-07-26,8440
2610,華航,2024,613,1411,摩根大通,2024-07-26,8440
2880,華南金,1964,773,1191,摩根大通,2024-07-26,8440
2892,第一金,2048,861,1187,摩根大通,2024-07-26,8440
2912,統一超,1057,16,1041,摩根大通,2024-07-26,8440
2408,南亞科,1329,318,1011,摩根大通,2024-07-26,8440
2855,統一證,973,47,926,摩根大通,2024-07-26,8440
3711,日月光投控,1324,443,881,摩根大通,2024-07-26,8440
9105,泰金寶-DR,973,116,857,摩根大通,2024-07-26,8440
3293,鈊象,845,3,842,摩根大通,2024-07-26,8440
3231,緯創,1828,987,841,摩根大通,2024-07-26,8440
1785,光洋科,899,161,738,摩根大通,2024-07-26,8440
1326,台化,776,161,615,摩根大通,2024-07-26,8440
5483,中美晶,683,92,591,摩根大通,2024-07-26,8440
1402,遠東新,934,362,572,摩根大通,2024-07-26,8440
1301,台塑,1182,613,569,摩根大通,2024-07-26,8440
5443,均豪,644,86,558,摩根大通,2024-07-26,8440
2354,鴻準,633,110,523,摩根大通,2024-07-26,8440
2002,中鋼,2675,2172,503,摩根大通,2024-07-26,8440
1102,亞泥,742,257,485,摩根大通,2024-07-26,8440
5876,上海商銀,922,442,480,摩根大通,2024-07-26,8440
3663,鑫科,606,132,474,摩根大通,2024-07-26,8440
4114,健喬,510,37,473,摩根大通,2024-07-26,8440
2324,仁寶,1636,1205,431,摩根大通,2024-07-26,8440
2887,台新金,2789,2367,422,摩根大通,2024-07-26,8440
8064,東捷,521,113,408,摩根大通,2024-07-26,8440
9958,世紀鋼,423,17,406,摩根大通,2024-07-26,8440
8054,安國,497,112,385,摩根大通,2024-07-26,8440
4904,遠傳,508,124,384,摩根大通,2024-07-26,8440
4938,和碩,1063,686,377,摩根大通,2024-07-26,8440
2618,長榮航,1318,962,356,摩根大通,2024-07-26,8440
2603,長榮,969,625,344,摩根大通,2024-07-26,8440
2836,高雄銀,340,7,333,摩根大通,2024-07-26,8440
6415,矽力*-KY,401,103,298,摩根大通,2024-07-26,8440
2406,國碩,365,68,297,摩根大通,2024-07-26,8440
2362,藍天,309,22,287,摩根大通,2024-07-26,8440
6412,群電,403,125,278,摩根大通,2024-07-26,8440
3576,聯合再生,480,210,270,摩根大通,2024-07-26,8440
4906,正文,362,94,268,摩根大通,2024-07-26,8440
3702,大聯大,491,225,266,摩根大通,2024-07-26,8440
2312,金寶,676,415,261,摩根大通,2024-07-26,8440
2421,建準,551,295,256,摩根大通,2024-07-26,8440
3665,貿聯-KY,312,82,230,摩根大通,2024-07-26,8440
3518,柏騰,269,40,229,摩根大通,2024-07-26,8440
1449,佳和,373,148,225,摩根大通,2024-07-26,8440
8085,福華,297,74,223,摩根大通,2024-07-26,8440
6005,群益證,1482,1267,215,摩根大通,2024-07-26,8440
4532,瑞智,299,95,204,摩根大通,2024-07-26,8440
2204,中華,264,60,204,摩根大通,2024-07-26,8440
2891,中信金,6218,2825,3393,摩根大通,2024-07-29,8440
2888,新光金,5373,2293,3080,摩根大通,2024-07-29,8440
2855,統一證,1592,40,1552,摩根大通,2024-07-29,8440
2883,凱基金,1491,43,1448,摩根大通,2024-07-29,8440
1815,富喬,1319,67,1252,摩根大通,2024-07-29,8440
2889,國票金,1159,57,1102,摩根大通,2024-07-29,8440
2834,臺企銀,2138,1042,1096,摩根大通,2024-07-29,8440
1513,中興電,1517,429,1088,摩根大通,2024-07-29,8440
2330,台積電,3238,2157,1081,摩根大通,2024-07-29,8440
6147,頎邦,1094,33,1061,摩根大通,2024-07-29,8440
2892,第一金,1204,222,982,摩根大通,2024-07-29,8440
1102,亞泥,1458,562,896,摩根大通,2024-07-29,8440
2618,長榮航,1339,460,879,摩根大通,2024-07-29,8440
2486,一詮,886,23,863,摩根大通,2024-07-29,8440
5880,合庫金,1115,273,842,摩根大通,2024-07-29,8440
1216,統一,1354,518,836,摩根大通,2024-07-29,8440
3324,雙鴻,847,14,833,摩根大通,2024-07-29,8440
2880,華南金,1352,554,798,摩根大通,2024-07-29,8440
2637,慧洋-KY,772,17,755,摩根大通,2024-07-29,8440
2603,長榮,973,248,725,摩根大通,2024-07-29,8440
1101,台泥,1522,825,697,摩根大通,2024-07-29,8440
3023,信邦,762,103,659,摩根大通,2024-07-29,8440
2809,京城銀,686,28,658,摩根大通,2024-07-29,8440
2371,大同,1032,385,647,摩根大通,2024-07-29,8440
2385,群光,683,47,636,摩根大通,2024-07-29,8440
1514,亞力,873,250,623,摩根大通,2024-07-29,8440
2845,遠東銀,639,27,612,摩根大通,2024-07-29,8440
3211,順達,800,213,587,摩根大通,2024-07-29,8440
1314,中石化,735,162,573,摩根大通,2024-07-29,8440
3376,新日興,822,310,512,摩根大通,2024-07-29,8440
2606,裕民,510,17,493,摩根大通,2024-07-29,8440
2890,永豐金,1075,605,470,摩根大通,2024-07-29,8440
2520,冠德,775,310,465,摩根大通,2024-07-29,8440
2885,元大金,1839,1390,449,摩根大通,2024-07-29,8440
2421,建準,455,15,440,摩根大通,2024-07-29,8440
9958,世紀鋼,604,187,417,摩根大通,2024-07-29,8440
3163,波若威,921,518,403,摩根大通,2024-07-29,8440
2912,統一超,514,115,399,摩根大通,2024-07-29,8440
3036,文曄,469,72,397,摩根大通,2024-07-29,8440
4123,晟德,439,56,383,摩根大通,2024-07-29,8440
2504,國產,509,147,362,摩根大通,2024-07-29,8440
8996,高力,462,134,328,摩根大通,2024-07-29,8440
2351,順德,333,8,325,摩根大通,2024-07-29,8440
9914,美利達,325,5,320,摩根大通,2024-07-29,8440
1519,華城,517,207,310,摩根大通,2024-07-29,8440
5347,世界,698,395,303,摩根大通,2024-07-29,8440
9802,鈺齊-KY,297,1,296,摩根大通,2024-07-29,8440
1784,訊聯,350,56,294,摩根大通,2024-07-29,8440
5371,中光電,334,53,281,摩根大通,2024-07-29,8440
2201,裕隆,292,21,271,摩根大通,2024-07-29,8440
2330,台積電,6217,2575,3642,摩根大通,2024-07-30,8440
2884,玉山金,3314,1586,1728,摩根大通,2024-07-30,8440
2603,長榮,1820,152,1668,摩根大通,2024-07-30,8440
8064,東捷,1562,222,1340,摩根大通,2024-07-30,8440
2412,中華電,1384,239,1145,摩根大通,2024-07-30,8440
9105,泰金寶-DR,1328,260,1068,摩根大通,2024-07-30,8440
3036,文曄,1063,53,1010,摩根大通,2024-07-30,8440
2889,國票金,1068,93,975,摩根大通,2024-07-30,8440
2609,陽明,1713,775,938,摩根大通,2024-07-30,8440
2486,一詮,1303,390,913,摩根大通,2024-07-30,8440
3024,憶聲,1317,463,854,摩根大通,2024-07-30,8440
2855,統一證,897,71,826,摩根大通,2024-07-30,8440
2605,新興,752,16,736,摩根大通,2024-07-30,8440
5512,力麒,781,81,700,摩根大通,2024-07-30,8440
9904,寶成,926,255,671,摩根大通,2024-07-30,8440
2371,大同,1133,478,655,摩根大通,2024-07-30,8440
1314,中石化,698,118,580,摩根大通,2024-07-30,8440
1503,士電,626,54,572,摩根大通,2024-07-30,8440
1514,亞力,722,155,567,摩根大通,2024-07-30,8440
2504,國產,640,99,541,摩根大通,2024-07-30,8440
2637,慧洋-KY,497,1,496,摩根大通,2024-07-30,8440
2442,新美齊,1107,677,430,摩根大通,2024-07-30,8440
2329,華泰,595,166,429,摩根大通,2024-07-30,8440
2385,群光,602,175,427,摩根大通,2024-07-30,8440
6806,森崴能源,606,180,426,摩根大通,2024-07-30,8440
2524,京城,760,340,420,摩根大通,2024-07-30,8440
2809,京城銀,524,113,411,摩根大通,2024-07-30,8440
2379,瑞昱,481,77,404,摩根大通,2024-07-30,8440
1529,樂事綠能,453,50,403,摩根大通,2024-07-30,8440
2515,中工,546,146,400,摩根大通,2024-07-30,8440
3188,鑫龍騰,469,78,391,摩根大通,2024-07-30,8440
3580,友威科,408,22,386,摩根大通,2024-07-30,8440
912000,晨訊科-DR,409,36,373,摩根大通,2024-07-30,8440
1102,亞泥,728,358,370,摩根大通,2024-07-30,8440
1316,上曜,517,148,369,摩根大通,2024-07-30,8440
4562,穎漢,625,265,360,摩根大通,2024-07-30,8440
8046,南電,539,189,350,摩根大通,2024-07-30,8440
3017,奇鋐,626,283,343,摩根大通,2024-07-30,8440
1590,亞德客-KY,374,39,335,摩根大通,2024-07-30,8440
4533,協易機,334,7,327,摩根大通,2024-07-30,8440
2520,冠德,502,177,325,摩根大通,2024-07-30,8440
2317,鴻海,2765,2441,324,摩根大通,2024-07-30,8440
5880,合庫金,869,551,318,摩根大通,2024-07-30,8440
6197,佳必琪,332,20,312,摩根大通,2024-07-30,8440
3663,鑫科,363,58,305,摩根大通,2024-07-30,8440
2812,台中銀,558,254,304,摩根大通,2024-07-30,8440
2606,裕民,521,217,304,摩根大通,2024-07-30,8440
3019,亞光,344,41,303,摩根大通,2024-07-30,8440
2006,東和鋼鐵,361,70,291,摩根大通,2024-07-30,8440
4906,正文,350,70,280,摩根大通,2024-07-30,8440
2885,元大金,3149,321,2828,摩根大通,2024-07-31,8440
2891,中信金,8568,5804,2764,摩根大通,2024-07-31,8440
2609,陽明,3009,415,2594,摩根大通,2024-07-31,8440
2324,仁寶,3124,654,2470,摩根大通,2024-07-31,8440
2317,鴻海,3722,1411,2311,摩根大通,2024-07-31,8440
2337,旺宏,3338,1092,2246,摩根大通,2024-07-31,8440
2834,臺企銀,2296,392,1904,摩根大通,2024-07-31,8440
5443,均豪,2031,239,1792,摩根大通,2024-07-31,8440
2883,凱基金,4925,3362,1563,摩根大通,2024-07-31,8440
2637,慧洋-KY,1613,121,1492,摩根大通,2024-07-31,8440
2881,富邦金,2213,729,1484,摩根大通,2024-07-31,8440
4906,正文,1279,24,1255,摩根大通,2024-07-31,8440
1101,台泥,1297,103,1194,摩根大通,2024-07-31,8440
2412,中華電,2832,1912,920,摩根大通,2024-07-31,8440
2610,華航,1525,610,915,摩根大通,2024-07-31,8440
2880,華南金,1117,291,826,摩根大通,2024-07-31,8440
4938,和碩,1223,425,798,摩根大通,2024-07-31,8440
2308,台達電,1191,402,789,摩根大通,2024-07-31,8440
9921,巨大,792,21,771,摩根大通,2024-07-31,8440
1102,亞泥,1584,846,738,摩根大通,2024-07-31,8440
4532,瑞智,722,6,716,摩根大通,2024-07-31,8440
2884,玉山金,3185,2591,594,摩根大通,2024-07-31,8440
6176,瑞儀,659,86,573,摩根大通,2024-07-31,8440
6005,群益證,900,339,561,摩根大通,2024-07-31,8440
2204,中華,638,88,550,摩根大通,2024-07-31,8440
2504,國產,893,363,530,摩根大通,2024-07-31,8440
2385,群光,701,183,518,摩根大通,2024-07-31,8440
2344,華邦電,1079,563,516,摩根大通,2024-07-31,8440
3163,波若威,671,180,491,摩根大通,2024-07-31,8440
1503,士電,471,15,456,摩根大通,2024-07-31,8440
2809,京城銀,511,62,449,摩根大通,2024-07-31,8440
2887,台新金,845,418,427,摩根大通,2024-07-31,8440
2855,統一證,500,88,412,摩根大通,2024-07-31,8440
2393,億光,456,55,401,摩根大通,2024-07-31,8440
2368,金像電,431,31,400,摩根大通,2024-07-31,8440
2371,大同,590,193,397,摩根大通,2024-07-31,8440
2606,裕民,433,45,388,摩根大通,2024-07-31,8440
1504,東元,409,25,384,摩根大通,2024-07-31,8440
2330,台積電,2588,2211,377,摩根大通,2024-07-31,8440
2603,長榮,541,189,352,摩根大通,2024-07-31,8440
3374,精材,673,321,352,摩根大通,2024-07-31,8440
3023,信邦,537,194,343,摩根大通,2024-07-31,8440
2886,兆豐金,1691,1353,338,摩根大通,2024-07-31,8440
2888,新光金,902,572,330,摩根大通,2024-07-31,8440
4968,立積,401,89,312,摩根大通,2024-07-31,8440
2357,華碩,559,249,310,摩根大通,2024-07-31,8440
1301,台塑,614,306,308,摩根大通,2024-07-31,8440
6548,長科*,326,21,305,摩根大通,2024-07-31,8440
3481,群創,2176,1872,304,摩根大通,2024-07-31,8440
6505,台塑化,543,260,283,摩根大通,2024-07-31,8440
2303,聯電,16557,2117,14440,摩根大通,2024-08-01,8440
9904,寶成,4014,438,3576,摩根大通,2024-08-01,8440
1402,遠東新,2726,610,2116,摩根大通,2024-08-01,8440
1314,中石化,2155,87,2068,摩根大通,2024-08-01,8440
2609,陽明,3174,1198,1976,摩根大通,2024-08-01,8440
1216,統一,2741,988,1753,摩根大通,2024-08-01,8440
1536,和大,2001,398,1603,摩根大通,2024-08-01,8440
2880,華南金,2052,531,1521,摩根大通,2024-08-01,8440
5880,合庫金,1412,14,1398,摩根大通,2024-08-01,8440
6005,群益證,1316,58,1258,摩根大通,2024-08-01,8440
4532,瑞智,1284,47,1237,摩根大通,2024-08-01,8440
5512,力麒,1143,57,1086,摩根大通,2024-08-01,8440
2362,藍天,1663,631,1032,摩根大通,2024-08-01,8440
2855,統一證,999,48,951,摩根大通,2024-08-01,8440
3663,鑫科,1001,124,877,摩根大通,2024-08-01,8440
2867,三商壽,982,106,876,摩根大通,2024-08-01,8440
8054,安國,908,49,859,摩根大通,2024-08-01,8440
2606,裕民,1014,170,844,摩根大通,2024-08-01,8440
2884,玉山金,995,156,839,摩根大通,2024-08-01,8440
2489,瑞軒,1088,261,827,摩根大通,2024-08-01,8440
4714,永捷,843,19,824,摩根大通,2024-08-01,8440
3231,緯創,1538,763,775,摩根大通,2024-08-01,8440
2393,億光,822,50,772,摩根大通,2024-08-01,8440
2520,冠德,755,36,719,摩根大通,2024-08-01,8440
2317,鴻海,2466,1767,699,摩根大通,2024-08-01,8440
2204,中華,865,180,685,摩根大通,2024-08-01,8440
8064,東捷,2029,1362,667,摩根大通,2024-08-01,8440
6274,台燿,846,182,664,摩根大通,2024-08-01,8440
2614,東森,653,22,631,摩根大通,2024-08-01,8440
6163,華電網,659,71,588,摩根大通,2024-08-01,8440
8112,至上,640,96,544,摩根大通,2024-08-01,8440
2301,光寶科,620,91,529,摩根大通,2024-08-01,8440
2547,日勝生,551,25,526,摩根大通,2024-08-01,8440
5531,鄉林,517,10,507,摩根大通,2024-08-01,8440
2337,旺宏,3948,3444,504,摩根大通,2024-08-01,8440
2888,新光金,660,158,502,摩根大通,2024-08-01,8440
1301,台塑,791,323,468,摩根大通,2024-08-01,8440
3045,台灣大,592,128,464,摩根大通,2024-08-01,8440
9934,成霖,594,135,459,摩根大通,2024-08-01,8440
2528,皇普,497,42,455,摩根大通,2024-08-01,8440
2886,兆豐金,744,289,455,摩根大通,2024-08-01,8440
6548,長科*,495,45,450,摩根大通,2024-08-01,8440
1326,台化,485,36,449,摩根大通,2024-08-01,8440
2368,金像電,518,88,430,摩根大通,2024-08-01,8440
6770,力積電,1195,770,425,摩根大通,2024-08-01,8440
8033,雷虎,447,25,422,摩根大通,2024-08-01,8440
8927,北基,435,19,416,摩根大通,2024-08-01,8440
1522,堤維西,429,20,409,摩根大通,2024-08-01,8440
8046,南電,404,2,402,摩根大通,2024-08-01,8440
1584,精剛,402,4,398,摩根大通,2024-08-01,8440
2409,友達,7292,983,6309,摩根大通,2024-08-02,8440
2618,長榮航,5479,1688,3791,摩根大通,2024-08-02,8440
2344,華邦電,4441,1307,3134,摩根大通,2024-08-02,8440
9904,寶成,5126,2025,3101,摩根大通,2024-08-02,8440
2412,中華電,2821,595,2226,摩根大通,2024-08-02,8440
1785,光洋科,1608,220,1388,摩根大通,2024-08-02,8440
2365,昆盈,1432,318,1114,摩根大通,2024-08-02,8440
3665,貿聯-KY,913,186,727,摩根大通,2024-08-02,8440
9921,巨大,710,50,660,摩根大通,2024-08-02,8440
9105,泰金寶-DR,688,66,622,摩根大通,2024-08-02,8440
6805,富世達,672,91,581,摩根大通,2024-08-02,8440
1514,亞力,624,64,560,摩根大通,2024-08-02,8440
3045,台灣大,917,367,550,摩根大通,2024-08-02,8440
6770,力積電,1424,912,512,摩根大通,2024-08-02,8440
4958,臻鼎-KY,1198,716,482,摩根大通,2024-08-02,8440
6239,力成,850,386,464,摩根大通,2024-08-02,8440
3576,聯合再生,546,115,431,摩根大通,2024-08-02,8440
2458,義隆,456,34,422,摩根大通,2024-08-02,8440
2504,國產,565,150,415,摩根大通,2024-08-02,8440
2393,億光,507,96,411,摩根大通,2024-08-02,8440
1326,台化,1102,706,396,摩根大通,2024-08-02,8440
4909,新復興,386,75,311,摩根大通,2024-08-02,8440
2836,高雄銀,372,76,296,摩根大通,2024-08-02,8440
3030,德律,300,28,272,摩根大通,2024-08-02,8440
2345,智邦,368,97,271,摩根大通,2024-08-02,8440
3376,新日興,694,427,267,摩根大通,2024-08-02,8440
1504,東元,385,130,255,摩根大通,2024-08-02,8440
3105,穩懋,371,128,243,摩根大通,2024-08-02,8440
4564,元翎,472,232,240,摩根大通,2024-08-02,8440
9914,美利達,267,35,232,摩根大通,2024-08-02,8440
6890,來億-KY,241,10,231,摩根大通,2024-08-02,8440
2637,慧洋-KY,284,54,230,摩根大通,2024-08-02,8440
3013,晟銘電,333,116,217,摩根大通,2024-08-02,8440
3689,湧德,239,26,213,摩根大通,2024-08-02,8440
8046,南電,312,101,211,摩根大通,2024-08-02,8440
1316,上曜,861,657,204,摩根大通,2024-08-02,8440
4114,健喬,307,105,202,摩根大通,2024-08-02,8440
2606,裕民,258,60,198,摩根大通,2024-08-02,8440
8104,錸寶,234,45,189,摩根大通,2024-08-02,8440
5269,祥碩,201,18,183,摩根大通,2024-08-02,8440
2367,燿華,491,308,183,摩根大通,2024-08-02,8440
2489,瑞軒,286,106,180,摩根大通,2024-08-02,8440
6187,萬潤,194,15,179,摩根大通,2024-08-02,8440
9802,鈺齊-KY,179,4,175,摩根大通,2024-08-02,8440
9958,世紀鋼,229,55,174,摩根大通,2024-08-02,8440
2887,台新金,1700,1527,173,摩根大通,2024-08-02,8440
2376,技嘉,457,288,169,摩根大通,2024-08-02,8440
2809,京城銀,259,94,165,摩根大通,2024-08-02,8440
2349,錸德,1070,907,163,摩根大通,2024-08-02,8440
3003,健和興,178,19,159,摩根大通,2024-08-02,8440
1216,統一,4036,1423,2613,摩根大通,2024-08-05,8440
3231,緯創,3236,1429,1807,摩根大通,2024-08-05,8440
2618,長榮航,3139,1638,1501,摩根大通,2024-08-05,8440
2412,中華電,1942,567,1375,摩根大通,2024-08-05,8440
2371,大同,1431,139,1292,摩根大通,2024-08-05,8440
1514,亞力,1284,162,1122,摩根大通,2024-08-05,8440
2520,冠德,1045,47,998,摩根大通,2024-08-05,8440
00878,國泰永續高股息,913,0,913,摩根大通,2024-08-05,8440
2383,台光電,1211,347,864,摩根大通,2024-08-05,8440
1785,光洋科,1218,360,858,摩根大通,2024-08-05,8440
3376,新日興,1176,321,855,摩根大通,2024-08-05,8440
2886,兆豐金,1887,1052,835,摩根大通,2024-08-05,8440
6505,台塑化,1058,233,825,摩根大通,2024-08-05,8440
4958,臻鼎-KY,2136,1358,778,摩根大通,2024-08-05,8440
9904,寶成,1559,819,740,摩根大通,2024-08-05,8440
2615,萬海,1175,550,625,摩根大通,2024-08-05,8440
2312,金寶,1023,473,550,摩根大通,2024-08-05,8440
1102,亞泥,1159,615,544,摩根大通,2024-08-05,8440
2889,國票金,933,398,535,摩根大通,2024-08-05,8440
4123,晟德,589,54,535,摩根大通,2024-08-05,8440
8096,擎亞,694,161,533,摩根大通,2024-08-05,8440
2393,億光,577,83,494,摩根大通,2024-08-05,8440
2504,國產,626,154,472,摩根大通,2024-08-05,8440
5871,中租-KY,662,220,442,摩根大通,2024-08-05,8440
2605,新興,471,33,438,摩根大通,2024-08-05,8440
6139,亞翔,447,31,416,摩根大通,2024-08-05,8440
1503,士電,433,24,409,摩根大通,2024-08-05,8440
1504,東元,600,197,403,摩根大通,2024-08-05,8440
3443,創意,382,27,355,摩根大通,2024-08-05,8440
2376,技嘉,581,280,301,摩根大通,2024-08-05,8440
2538,基泰,399,101,298,摩根大通,2024-08-05,8440
8069,元太,504,207,297,摩根大通,2024-08-05,8440
2337,旺宏,3308,3021,287,摩根大通,2024-08-05,8440
9105,泰金寶-DR,475,201,274,摩根大通,2024-08-05,8440
3324,雙鴻,311,40,271,摩根大通,2024-08-05,8440
6446,藥華藥,345,76,269,摩根大通,2024-08-05,8440
3312,弘憶股,275,8,267,摩根大通,2024-08-05,8440
2354,鴻準,407,147,260,摩根大通,2024-08-05,8440
2880,華南金,1012,755,257,摩根大通,2024-08-05,8440
6472,保瑞,270,25,245,摩根大通,2024-08-05,8440
9802,鈺齊-KY,339,99,240,摩根大通,2024-08-05,8440
6239,力成,771,532,239,摩根大通,2024-08-05,8440
1784,訊聯,292,54,238,摩根大通,2024-08-05,8440
1312,國喬,439,209,230,摩根大通,2024-08-05,8440
8099,大世科,205,6,199,摩根大通,2024-08-05,8440
2454,聯發科,1323,1127,196,摩根大通,2024-08-05,8440
2542,興富發,458,267,191,摩根大通,2024-08-05,8440
2357,華碩,573,408,165,摩根大通,2024-08-05,8440
2313,華通,1735,1570,165,摩根大通,2024-08-05,8440
6120,達運,230,68,162,摩根大通,2024-08-05,8440
2330,台積電,20675,3447,17228,摩根大通,2024-08-06,8440
2883,凱基金,4956,282,4674,摩根大通,2024-08-06,8440
9105,泰金寶-DR,3735,437,3298,摩根大通,2024-08-06,8440
2344,華邦電,2506,240,2266,摩根大通,2024-08-06,8440
2618,長榮航,2595,989,1606,摩根大通,2024-08-06,8440
2349,錸德,2013,421,1592,摩根大通,2024-08-06,8440
2371,大同,1901,395,1506,摩根大通,2024-08-06,8440
1102,亞泥,1403,255,1148,摩根大通,2024-08-06,8440
3045,台灣大,1207,124,1083,摩根大通,2024-08-06,8440
2882,國泰金,2224,1161,1063,摩根大通,2024-08-06,8440
2489,瑞軒,1256,199,1057,摩根大通,2024-08-06,8440
1216,統一,1929,930,999,摩根大通,2024-08-06,8440
2312,金寶,1628,636,992,摩根大通,2024-08-06,8440
2880,華南金,1847,859,988,摩根大通,2024-08-06,8440
2412,中華電,1107,209,898,摩根大通,2024-08-06,8440
2367,燿華,1711,820,891,摩根大通,2024-08-06,8440
2889,國票金,977,104,873,摩根大通,2024-08-06,8440
2603,長榮,1700,829,871,摩根大通,2024-08-06,8440
3312,弘憶股,1016,159,857,摩根大通,2024-08-06,8440
2501,國建,1115,268,847,摩根大通,2024-08-06,8440
3047,訊舟,888,79,809,摩根大通,2024-08-06,8440
2317,鴻海,9060,8270,790,摩根大通,2024-08-06,8440
2891,中信金,4440,3729,711,摩根大通,2024-08-06,8440
2353,宏��,1347,649,698,摩根大通,2024-08-06,8440
3044,健鼎,754,68,686,摩根大通,2024-08-06,8440
2885,元大金,1523,837,686,摩根大通,2024-08-06,8440
2308,台達電,1886,1204,682,摩根大通,2024-08-06,8440
5876,上海商銀,824,169,655,摩根大通,2024-08-06,8440
2392,正崴,800,146,654,摩根大通,2024-08-06,8440
3450,聯鈞,804,154,650,摩根大通,2024-08-06,8440
6274,台燿,941,297,644,摩根大通,2024-08-06,8440
3324,雙鴻,745,178,567,摩根大通,2024-08-06,8440
3535,晶彩科,731,173,558,摩根大通,2024-08-06,8440
4904,遠傳,1130,579,551,摩根大通,2024-08-06,8440
2324,仁寶,1431,894,537,摩根大通,2024-08-06,8440
2486,一詮,823,305,518,摩根大通,2024-08-06,8440
1513,中興電,734,221,513,摩根大通,2024-08-06,8440
8064,東捷,772,275,497,摩根大通,2024-08-06,8440
3030,德律,542,63,479,摩根大通,2024-08-06,8440
2352,佳世達,936,479,457,摩根大通,2024-08-06,8440
6269,台郡,510,67,443,摩根大通,2024-08-06,8440
2464,盟立,579,153,426,摩根大通,2024-08-06,8440
2002,中鋼,1961,1535,426,摩根大通,2024-08-06,8440
3048,益登,524,108,416,摩根大通,2024-08-06,8440
5452,佶優,472,79,393,摩根大通,2024-08-06,8440
4123,晟德,602,213,389,摩根大通,2024-08-06,8440
1326,台化,657,290,367,摩根大通,2024-08-06,8440
3481,群創,595,232,363,摩根大通,2024-08-06,8440
2476,鉅祥,429,68,361,摩根大通,2024-08-06,8440
3013,晟銘電,700,347,353,摩根大通,2024-08-06,8440
1314,中石化,2238,140,2098,摩根大通,2024-08-07,8440
2412,中華電,2593,935,1658,摩根大通,2024-08-07,8440
1605,華新,1605,179,1426,摩根大通,2024-08-07,8440
2603,長榮,1691,316,1375,摩根大通,2024-08-07,8440
2881,富邦金,2535,1161,1374,摩根大通,2024-08-07,8440
2449,京元電子,4160,2884,1276,摩根大通,2024-08-07,8440
4904,遠傳,1467,329,1138,摩根大通,2024-08-07,8440
2882,國泰金,2305,1206,1099,摩根大通,2024-08-07,8440
3035,智原,1071,11,1060,摩根大通,2024-08-07,8440
2371,大同,1387,357,1030,摩根大通,2024-08-07,8440
2353,宏��,1823,876,947,摩根大通,2024-08-07,8440
2501,國建,994,156,838,摩根大通,2024-08-07,8440
1504,東元,882,68,814,摩根大通,2024-08-07,8440
2464,盟立,963,154,809,摩根大通,2024-08-07,8440
1301,台塑,958,162,796,摩根大通,2024-08-07,8440
2330,台積電,4381,3605,776,摩根大通,2024-08-07,8440
2880,華南金,1339,587,752,摩根大通,2024-08-07,8440
3013,晟銘電,1113,364,749,摩根大通,2024-08-07,8440
2388,威盛,791,44,747,摩根大通,2024-08-07,8440
2515,中工,1124,389,735,摩根大通,2024-08-07,8440
1316,上曜,737,3,734,摩根大通,2024-08-07,8440
2889,國票金,800,70,730,摩根大通,2024-08-07,8440
1101,台泥,947,224,723,摩根大通,2024-08-07,8440
5876,上海商銀,1321,602,719,摩根大通,2024-08-07,8440
3045,台灣大,825,148,677,摩根大通,2024-08-07,8440
2885,元大金,1179,531,648,摩根大通,2024-08-07,8440
2383,台光電,928,280,648,摩根大通,2024-08-07,8440
2331,精英,683,46,637,摩根大通,2024-08-07,8440
2362,藍天,675,40,635,摩根大通,2024-08-07,8440
6125,廣運,637,11,626,摩根大通,2024-08-07,8440
2354,鴻準,681,101,580,摩根大通,2024-08-07,8440
3024,憶聲,981,409,572,摩根大通,2024-08-07,8440
9907,統一實,576,11,565,摩根大通,2024-08-07,8440
4303,信立,672,107,565,摩根大通,2024-08-07,8440
6188,廣明,649,89,560,摩根大通,2024-08-07,8440
2888,新光金,1959,1403,556,摩根大通,2024-08-07,8440
1597,直得,725,181,544,摩根大通,2024-08-07,8440
6282,康舒,552,17,535,摩根大通,2024-08-07,8440
2637,慧洋-KY,518,1,517,摩根大通,2024-08-07,8440
1303,南亞,908,392,516,摩根大通,2024-08-07,8440
1569,濱川,498,2,496,摩根大通,2024-08-07,8440
2365,昆盈,512,16,496,摩根大通,2024-08-07,8440
2323,中環,525,39,486,摩根大通,2024-08-07,8440
3703,欣陸,522,39,483,摩根大通,2024-08-07,8440
9105,泰金寶-DR,609,132,477,摩根大通,2024-08-07,8440
2009,第一銅,504,35,469,摩根大通,2024-08-07,8440
2329,華泰,831,366,465,摩根大通,2024-08-07,8440
4533,協易機,460,4,456,摩根大通,2024-08-07,8440
2867,三商壽,457,25,432,摩根大通,2024-08-07,8440
5512,力麒,753,325,428,摩根大通,2024-08-07,8440
1102,亞泥,3487,332,3155,摩根大通,2024-08-08,8440
2883,凱基金,3438,473,2965,摩根大通,2024-08-08,8440
1303,南亞,2992,626,2366,摩根大通,2024-08-08,8440
2886,兆豐金,3604,1373,2231,摩根大通,2024-08-08,8440
2365,昆盈,2995,990,2005,摩根大通,2024-08-08,8440
2889,國票金,1160,7,1153,摩根大通,2024-08-08,8440
4533,協易機,1214,244,970,摩根大通,2024-08-08,8440
4904,遠傳,1105,207,898,摩根大通,2024-08-08,8440
2393,億光,1008,131,877,摩根大通,2024-08-08,8440
6215,和椿,848,22,826,摩根大通,2024-08-08,8440
2543,皇昌,1205,404,801,摩根大通,2024-08-08,8440
2801,彰銀,1951,1194,757,摩根大通,2024-08-08,8440
5880,合庫金,1670,968,702,摩根大通,2024-08-08,8440
2880,華南金,1302,610,692,摩根大通,2024-08-08,8440
3231,緯創,1805,1141,664,摩根大通,2024-08-08,8440
8096,擎亞,1501,915,586,摩根大通,2024-08-08,8440
1718,中纖,596,22,574,摩根大通,2024-08-08,8440
6412,群電,564,78,486,摩根大通,2024-08-08,8440
1609,大亞,801,329,472,摩根大通,2024-08-08,8440
2439,美律,609,161,448,摩根大通,2024-08-08,8440
3715,定穎投控,743,297,446,摩根大通,2024-08-08,8440
9934,成霖,483,40,443,摩根大通,2024-08-08,8440
1216,統一,1142,731,411,摩根大通,2024-08-08,8440
2881,富邦金,1622,1213,409,摩根大通,2024-08-08,8440
2243,宏旭-KY,612,211,401,摩根大通,2024-08-08,8440
2509,全坤建,426,44,382,摩根大通,2024-08-08,8440
1608,華榮,434,54,380,摩根大通,2024-08-08,8440
9945,潤泰新,469,130,339,摩根大通,2024-08-08,8440
1301,台塑,992,659,333,摩根大通,2024-08-08,8440
1447,力鵬,365,33,332,摩根大通,2024-08-08,8440
8028,昇陽半導體,494,171,323,摩根大通,2024-08-08,8440
3481,群創,1398,1077,321,摩根大通,2024-08-08,8440
2884,玉山金,1813,1498,315,摩根大通,2024-08-08,8440
8064,東捷,653,343,310,摩根大通,2024-08-08,8440
2905,三商,322,29,293,摩根大通,2024-08-08,8440
8374,羅昇,771,478,293,摩根大通,2024-08-08,8440
2331,精英,314,24,290,摩根大通,2024-08-08,8440
3045,台灣大,727,440,287,摩根大通,2024-08-08,8440
2031,新光鋼,307,26,281,摩根大通,2024-08-08,8440
2633,台灣高鐵,381,113,268,摩根大通,2024-08-08,8440
2855,統一證,355,101,254,摩根大通,2024-08-08,8440
1309,台達化,284,30,254,摩根大通,2024-08-08,8440
2049,上銀,277,33,244,摩根大通,2024-08-08,8440
2412,中華電,755,517,238,摩根大通,2024-08-08,8440
2618,長榮航,1059,829,230,摩根大通,2024-08-08,8440
3013,晟銘電,447,225,222,摩根大通,2024-08-08,8440
1590,亞德客-KY,246,35,211,摩根大通,2024-08-08,8440
2637,慧洋-KY,320,109,211,摩根大通,2024-08-08,8440
4906,正文,272,63,209,摩根大通,2024-08-08,8440
2357,華碩,1214,1006,208,摩根大通,2024-08-08,8440
3481,群創,14312,164,14148,摩根大通,2024-08-09,8440
2886,兆豐金,9588,1715,7873,摩根大通,2024-08-09,8440
2317,鴻海,10689,3636,7053,摩根大通,2024-08-09,8440
2303,聯電,8364,2254,6110,摩根大通,2024-08-09,8440
2883,凱基金,4809,182,4627,摩根大通,2024-08-09,8440
2888,新光金,4692,615,4077,摩根大通,2024-08-09,8440
5880,合庫金,4614,678,3936,摩根大通,2024-08-09,8440
2891,中信金,4834,1414,3420,摩根大通,2024-08-09,8440
2884,玉山金,3373,88,3285,摩根大通,2024-08-09,8440
2801,彰銀,3601,400,3201,摩根大通,2024-08-09,8440
2489,瑞軒,3034,171,2863,摩根大通,2024-08-09,8440
2330,台積電,3922,1078,2844,摩根大通,2024-08-09,8440
2324,仁寶,2863,412,2451,摩根大通,2024-08-09,8440
1101,台泥,3376,1009,2367,摩根大通,2024-08-09,8440
0050,元大台灣50,1832,0,1832,摩根大通,2024-08-09,8440
1301,台塑,2172,361,1811,摩根大通,2024-08-09,8440
2344,華邦電,1748,144,1604,摩根大通,2024-08-09,8440
2867,三商壽,1731,173,1558,摩根大通,2024-08-09,8440
1402,遠東新,1679,176,1503,摩根大通,2024-08-09,8440
2887,台新金,4858,3390,1468,摩根大通,2024-08-09,8440
2890,永豐金,1915,907,1008,摩根大通,2024-08-09,8440
1609,大亞,1181,189,992,摩根大通,2024-08-09,8440
6603,富強鑫,1215,240,975,摩根大通,2024-08-09,8440
1303,南亞,1435,461,974,摩根大通,2024-08-09,8440
2885,元大金,1144,283,861,摩根大通,2024-08-09,8440
8054,安國,933,81,852,摩根大通,2024-08-09,8440
2889,國票金,866,15,851,摩根大通,2024-08-09,8440
2412,中華電,1049,308,741,摩根大通,2024-08-09,8440
8028,昇陽半導體,779,38,741,摩根大通,2024-08-09,8440
3189,景碩,1001,286,715,摩根大通,2024-08-09,8440
1718,中纖,734,20,714,摩根大通,2024-08-09,8440
3024,憶聲,898,194,704,摩根大通,2024-08-09,8440
8096,擎亞,1346,657,689,摩根大通,2024-08-09,8440
8069,元太,1290,629,661,摩根大通,2024-08-09,8440
2912,統一超,667,30,637,摩根大通,2024-08-09,8440
3167,大量,998,363,635,摩根大通,2024-08-09,8440
2880,華南金,2329,1701,628,摩根大通,2024-08-09,8440
9955,佳龍,623,15,608,摩根大通,2024-08-09,8440
2359,所羅門,867,262,605,摩根大通,2024-08-09,8440
2464,盟立,1016,425,591,摩根大通,2024-08-09,8440
4904,遠傳,707,136,571,摩根大通,2024-08-09,8440
1316,上曜,621,59,562,摩根大通,2024-08-09,8440
2836,高雄銀,626,93,533,摩根大通,2024-08-09,8440
2633,台灣高鐵,615,93,522,摩根大通,2024-08-09,8440
3006,晶豪科,542,52,490,摩根大通,2024-08-09,8440
1522,堤維西,541,61,480,摩根大通,2024-08-09,8440
1584,精剛,527,49,478,摩根大通,2024-08-09,8440
2905,三商,496,24,472,摩根大通,2024-08-09,8440
9904,寶成,618,147,471,摩根大通,2024-08-09,8440
2371,大同,631,168,463,摩根大通,2024-08-09,8440
2886,兆豐金,5576,596,4980,摩根大通,2024-08-12,8440
2303,聯電,6724,2659,4065,摩根大通,2024-08-12,8440
3231,緯創,2112,391,1721,摩根大通,2024-08-12,8440
2382,廣達,2862,1321,1541,摩根大通,2024-08-12,8440
2506,太設,1859,357,1502,摩根大通,2024-08-12,8440
0050,元大台灣50,1455,0,1455,摩根大通,2024-08-12,8440
5880,合庫金,1538,142,1396,摩根大通,2024-08-12,8440
3663,鑫科,2038,755,1283,摩根大通,2024-08-12,8440
2353,宏��,1356,90,1266,摩根大通,2024-08-12,8440
2324,仁寶,2053,810,1243,摩根大通,2024-08-12,8440
2884,玉山金,1205,96,1109,摩根大通,2024-08-12,8440
1102,亞泥,1110,23,1087,摩根大通,2024-08-12,8440
4562,穎漢,2081,1153,928,摩根大通,2024-08-12,8440
2449,京元電子,1578,690,888,摩根大通,2024-08-12,8440
2489,瑞軒,1493,670,823,摩根大通,2024-08-12,8440
1609,大亞,920,167,753,摩根大通,2024-08-12,8440
8374,羅昇,1440,709,731,摩根大通,2024-08-12,8440
9105,泰金寶-DR,1510,805,705,摩根大通,2024-08-12,8440
2618,長榮航,1113,542,571,摩根大通,2024-08-12,8440
6442,光聖,606,75,531,摩根大通,2024-08-12,8440
6770,力積電,607,85,522,摩根大通,2024-08-12,8440
2354,鴻準,542,46,496,摩根大通,2024-08-12,8440
1605,華新,607,122,485,摩根大通,2024-08-12,8440
3645,達邁,659,188,471,摩根大通,2024-08-12,8440
4513,福裕,908,445,463,摩根大通,2024-08-12,8440
1514,亞力,732,286,446,摩根大通,2024-08-12,8440
3230,錦明,456,17,439,摩根大通,2024-08-12,8440
6282,康舒,487,51,436,摩根大通,2024-08-12,8440
9904,寶成,616,186,430,摩根大通,2024-08-12,8440
1582,信錦,476,48,428,摩根大通,2024-08-12,8440
2464,盟立,808,384,424,摩根大通,2024-08-12,8440
1527,鑽全,445,24,421,摩根大通,2024-08-12,8440
4938,和碩,505,86,419,摩根大通,2024-08-12,8440
5351,鈺創,418,4,414,摩根大通,2024-08-12,8440
3048,益登,451,40,411,摩根大通,2024-08-12,8440
1440,南紡,411,16,395,摩根大通,2024-08-12,8440
1216,統一,658,270,388,摩根大通,2024-08-12,8440
1785,光洋科,449,67,382,摩根大通,2024-08-12,8440
1301,台塑,540,161,379,摩根大通,2024-08-12,8440
1477,聚陽,572,193,379,摩根大通,2024-08-12,8440
4566,時碩工業,452,77,375,摩根大通,2024-08-12,8440
8028,昇陽半導體,604,243,361,摩根大通,2024-08-12,8440
1584,精剛,415,61,354,摩根大通,2024-08-12,8440
5871,中租-KY,496,142,354,摩根大通,2024-08-12,8440
9907,統一實,357,4,353,摩根大通,2024-08-12,8440
6706,惠特,519,170,349,摩根大通,2024-08-12,8440
1316,上曜,376,32,344,摩根大通,2024-08-12,8440
2615,萬海,932,595,337,摩根大通,2024-08-12,8440
3003,健和興,373,52,321,摩根大通,2024-08-12,8440
2374,佳能,424,106,318,摩根大通,2024-08-12,8440
2317,鴻海,7719,4018,3701,摩根大通,2024-08-13,8440
2618,長榮航,5147,1780,3367,摩根大通,2024-08-13,8440
2882,國泰金,3805,558,3247,摩根大通,2024-08-13,8440
2883,凱基金,3637,456,3181,摩根大通,2024-08-13,8440
1402,遠東新,2939,271,2668,摩根大通,2024-08-13,8440
2330,台積電,3541,1624,1917,摩根大通,2024-08-13,8440
2382,廣達,1864,532,1332,摩根大通,2024-08-13,8440
3227,原相,1359,93,1266,摩根大通,2024-08-13,8440
3481,群創,2061,809,1252,摩根大通,2024-08-13,8440
2208,台船,1609,371,1238,摩根大通,2024-08-13,8440
1536,和大,1565,333,1232,摩根大通,2024-08-13,8440
1584,精剛,1273,45,1228,摩根大通,2024-08-13,8440
5443,均豪,1557,451,1106,摩根大通,2024-08-13,8440
2356,英業達,1390,309,1081,摩根大通,2024-08-13,8440
1718,中纖,1016,39,977,摩根大通,2024-08-13,8440
9105,泰金寶-DR,1049,87,962,摩根大通,2024-08-13,8440
1102,亞泥,1037,103,934,摩根大通,2024-08-13,8440
2354,鴻準,941,55,886,摩根大通,2024-08-13,8440
3045,台灣大,946,134,812,摩根大通,2024-08-13,8440
6869,雲豹能源,866,59,807,摩根大通,2024-08-13,8440
1303,南亞,1140,359,781,摩根大通,2024-08-13,8440
2887,台新金,1768,996,772,摩根大通,2024-08-13,8440
2867,三商壽,992,224,768,摩根大通,2024-08-13,8440
2303,聯電,3979,3215,764,摩根大通,2024-08-13,8440
6770,力積電,950,194,756,摩根大通,2024-08-13,8440
2885,元大金,1483,747,736,摩根大通,2024-08-13,8440
3711,日月光投控,1614,879,735,摩根大通,2024-08-13,8440
2344,華邦電,849,129,720,摩根大通,2024-08-13,8440
2374,佳能,1192,493,699,摩根大通,2024-08-13,8440
2439,美律,648,42,606,摩根大通,2024-08-13,8440
2324,仁寶,1448,844,604,摩根大通,2024-08-13,8440
4904,遠傳,972,368,604,摩根大通,2024-08-13,8440
2312,金寶,746,151,595,摩根大通,2024-08-13,8440
2308,台達電,872,338,534,摩根大通,2024-08-13,8440
2892,第一金,1184,656,528,摩根大通,2024-08-13,8440
1609,大亞,552,30,522,摩根大通,2024-08-13,8440
4533,協易機,628,106,522,摩根大通,2024-08-13,8440
2474,可成,705,184,521,摩根大通,2024-08-13,8440
2105,正新,846,336,510,摩根大通,2024-08-13,8440
3374,精材,538,37,501,摩根大通,2024-08-13,8440
2890,永豐金,2299,1816,483,摩根大通,2024-08-13,8440
2884,玉山金,1960,1504,456,摩根大通,2024-08-13,8440
8064,東捷,447,9,438,摩根大通,2024-08-13,8440
4142,國光生,442,4,438,摩根大通,2024-08-13,8440
9939,宏全,440,16,424,摩根大通,2024-08-13,8440
2353,宏��,1016,606,410,摩根大通,2024-08-13,8440
1909,榮成,408,0,408,摩根大通,2024-08-13,8440
3048,益登,414,10,404,摩根大通,2024-08-13,8440
1101,台泥,1114,710,404,摩根大通,2024-08-13,8440
2464,盟立,606,209,397,摩根大通,2024-08-13,8440
2303,聯電,6108,877,5231,摩根大通,2024-08-14,8440
2883,凱基金,4395,667,3728,摩根大通,2024-08-14,8440
2317,鴻海,5720,3247,2473,摩根大通,2024-08-14,8440
1102,亞泥,2551,177,2374,摩根大通,2024-08-14,8440
2867,三商壽,2031,3,2028,摩根大通,2024-08-14,8440
2801,彰銀,2210,482,1728,摩根大通,2024-08-14,8440
2367,燿華,2163,562,1601,摩根大通,2024-08-14,8440
1303,南亞,2063,468,1595,摩根大通,2024-08-14,8440
1402,遠東新,1729,240,1489,摩根大通,2024-08-14,8440
2884,玉山金,2327,850,1477,摩根大通,2024-08-14,8440
2105,正新,1923,473,1450,摩根大通,2024-08-14,8440
3711,日月光投控,2213,900,1313,摩根大通,2024-08-14,8440
2886,兆豐金,2444,1181,1263,摩根大通,2024-08-14,8440
2618,長榮航,2315,1118,1197,摩根大通,2024-08-14,8440
2208,台船,1190,38,1152,摩根大通,2024-08-14,8440
2409,友達,1300,193,1107,摩根大通,2024-08-14,8440
1609,大亞,1212,133,1079,摩根大通,2024-08-14,8440
2006,東和鋼鐵,1090,44,1046,摩根大通,2024-08-14,8440
2603,長榮,1394,390,1004,摩根大通,2024-08-14,8440
2353,宏��,1185,183,1002,摩根大通,2024-08-14,8440
1301,台塑,1261,282,979,摩根大通,2024-08-14,8440
2101,南港,1151,183,968,摩根大通,2024-08-14,8440
2880,華南金,2167,1217,950,摩根大通,2024-08-14,8440
1560,中砂,1068,156,912,摩根大通,2024-08-14,8440
6451,訊芯-KY,1149,282,867,摩根大通,2024-08-14,8440
2889,國票金,860,15,845,摩根大通,2024-08-14,8440
0050,元大台灣50,765,0,765,摩根大通,2024-08-14,8440
2301,光寶科,1059,324,735,摩根大通,2024-08-14,8440
2354,鴻準,744,38,706,摩根大通,2024-08-14,8440
2891,中信金,1655,958,697,摩根大通,2024-08-14,8440
9945,潤泰新,914,222,692,摩根大通,2024-08-14,8440
3019,亞光,772,109,663,摩根大通,2024-08-14,8440
2812,台中銀,638,3,635,摩根大通,2024-08-14,8440
1605,華新,807,178,629,摩根大通,2024-08-14,8440
5880,合庫金,2392,1787,605,摩根大通,2024-08-14,8440
6187,萬潤,669,66,603,摩根大通,2024-08-14,8440
1314,中石化,657,87,570,摩根大通,2024-08-14,8440
1326,台化,827,265,562,摩根大通,2024-08-14,8440
2606,裕民,648,111,537,摩根大通,2024-08-14,8440
2344,華邦電,708,202,506,摩根大通,2024-08-14,8440
6770,力積電,627,127,500,摩根大通,2024-08-14,8440
2543,皇昌,869,373,496,摩根大通,2024-08-14,8440
6505,台塑化,560,76,484,摩根大通,2024-08-14,8440
8069,元太,646,164,482,摩根大通,2024-08-14,8440
2882,國泰金,1381,909,472,摩根大通,2024-08-14,8440
9904,寶成,1598,1127,471,摩根大通,2024-08-14,8440
3706,神達,468,16,452,摩根大通,2024-08-14,8440
8112,至上,431,14,417,摩根大通,2024-08-14,8440
9914,美利達,410,20,390,摩根大通,2024-08-14,8440
2363,矽統,570,182,388,摩根大通,2024-08-14,8440
2317,鴻海,5027,1931,3096,摩根大通,2024-08-15,8440
2881,富邦金,3502,412,3090,摩根大通,2024-08-15,8440
2609,陽明,3261,304,2957,摩根大通,2024-08-15,8440
1102,亞泥,2307,26,2281,摩根大通,2024-08-15,8440
2888,新光金,3535,1571,1964,摩根大通,2024-08-15,8440
2308,台達電,1780,146,1634,摩根大通,2024-08-15,8440
2880,華南金,1748,333,1415,摩根大通,2024-08-15,8440
3711,日月光投控,1588,285,1303,摩根大通,2024-08-15,8440
1402,遠東新,1341,65,1276,摩根大通,2024-08-15,8440
2101,南港,1452,241,1211,摩根大通,2024-08-15,8440
2323,中環,1293,129,1164,摩根大通,2024-08-15,8440
3645,達邁,1562,615,947,摩根大通,2024-08-15,8440
1314,中石化,1012,81,931,摩根大通,2024-08-15,8440
3047,訊舟,1317,397,920,摩根大通,2024-08-15,8440
4904,遠傳,897,11,886,摩根大通,2024-08-15,8440
8069,元太,1264,409,855,摩根大通,2024-08-15,8440
3019,亞光,1140,292,848,摩根大通,2024-08-15,8440
2382,廣達,1112,302,810,摩根大通,2024-08-15,8440
9904,寶成,1078,300,778,摩根大通,2024-08-15,8440
2324,仁寶,1542,774,768,摩根大通,2024-08-15,8440
2886,兆豐金,1706,944,762,摩根大通,2024-08-15,8440
2890,永豐金,1076,345,731,摩根大通,2024-08-15,8440
2884,玉山金,1304,577,727,摩根大通,2024-08-15,8440
2349,錸德,838,179,659,摩根大通,2024-08-15,8440
2883,凱基金,1282,632,650,摩根大通,2024-08-15,8440
2501,國建,620,0,620,摩根大通,2024-08-15,8440
2520,冠德,728,115,613,摩根大通,2024-08-15,8440
5443,均豪,847,266,581,摩根大通,2024-08-15,8440
2449,京元電子,1173,665,508,摩根大通,2024-08-15,8440
1808,潤隆,501,40,461,摩根大通,2024-08-15,8440
3048,益登,672,213,459,摩根大通,2024-08-15,8440
8028,昇陽半導體,674,216,458,摩根大通,2024-08-15,8440
5876,上海商銀,461,13,448,摩根大通,2024-08-15,8440
4561,健椿,1110,673,437,摩根大通,2024-08-15,8440
3284,太普高,534,124,410,摩根大通,2024-08-15,8440
3663,鑫科,724,351,373,摩根大通,2024-08-15,8440
2867,三商壽,1045,681,364,摩根大通,2024-08-15,8440
6869,雲豹能源,503,149,354,摩根大通,2024-08-15,8440
2606,裕民,408,66,342,摩根大通,2024-08-15,8440
2633,台灣高鐵,367,29,338,摩根大通,2024-08-15,8440
3605,宏致,344,22,322,摩根大通,2024-08-15,8440
8096,擎亞,2369,2048,321,摩根大通,2024-08-15,8440
1216,統一,689,373,316,摩根大通,2024-08-15,8440
2301,光寶科,460,161,299,摩根大通,2024-08-15,8440
3045,台灣大,415,140,275,摩根大通,2024-08-15,8440
2545,皇翔,615,347,268,摩根大通,2024-08-15,8440
2442,新美齊,314,46,268,摩根大通,2024-08-15,8440
6147,頎邦,307,40,267,摩根大通,2024-08-15,8440
2002,中鋼,709,459,250,摩根大通,2024-08-15,8440
2408,南亞科,318,68,250,摩根大通,2024-08-15,8440
2888,新光金,13785,1488,12297,摩根大通,2024-08-16,8440
2882,國泰金,11693,303,11390,摩根大通,2024-08-16,8440
2881,富邦金,11364,348,11016,摩根大通,2024-08-16,8440
2883,凱基金,10496,0,10496,摩根大通,2024-08-16,8440
2317,鴻海,7076,887,6189,摩根大通,2024-08-16,8440
2891,中信金,6386,966,5420,摩根大通,2024-08-16,8440
2409,友達,5266,240,5026,摩根大通,2024-08-16,8440
2303,聯電,5678,933,4745,摩根大通,2024-08-16,8440
2884,玉山金,5699,1591,4108,摩根大通,2024-08-16,8440
2359,所羅門,4455,489,3966,摩根大通,2024-08-16,8440
2412,中華電,3973,102,3871,摩根大通,2024-08-16,8440
2886,兆豐金,4562,1763,2799,摩根大通,2024-08-16,8440
2885,元大金,2827,64,2763,摩根大通,2024-08-16,8440
2330,台積電,6007,3255,2752,摩根大通,2024-08-16,8440
2880,華南金,3268,530,2738,摩根大通,2024-08-16,8440
2890,永豐金,2511,63,2448,摩根大通,2024-08-16,8440
5880,合庫金,2994,749,2245,摩根大通,2024-08-16,8440
2834,臺企銀,2159,51,2108,摩根大通,2024-08-16,8440
2308,台達電,2036,14,2022,摩根大通,2024-08-16,8440
2301,光寶科,2193,387,1806,摩根大通,2024-08-16,8440
1216,統一,1496,46,1450,摩根大通,2024-08-16,8440
1402,遠東新,1460,135,1325,摩根大通,2024-08-16,8440
9904,寶成,1494,193,1301,摩根大通,2024-08-16,8440
2344,華邦電,1390,143,1247,摩根大通,2024-08-16,8440
2537,聯上發,1680,435,1245,摩根大通,2024-08-16,8440
2002,中鋼,1618,378,1240,摩根大通,2024-08-16,8440
2845,遠東銀,1569,342,1227,摩根大通,2024-08-16,8440
2363,矽統,1775,552,1223,摩根大通,2024-08-16,8440
3711,日月光投控,1485,298,1187,摩根大通,2024-08-16,8440
2887,台新金,1395,287,1108,摩根大通,2024-08-16,8440
3037,欣興,1110,9,1101,摩根大通,2024-08-16,8440
5876,上海商銀,1394,442,952,摩根大通,2024-08-16,8440
1301,台塑,1008,123,885,摩根大通,2024-08-16,8440
1326,台化,968,84,884,摩根大通,2024-08-16,8440
1101,台泥,1288,458,830,摩根大通,2024-08-16,8440
1303,南亞,1507,695,812,摩根大通,2024-08-16,8440
2382,廣達,1306,497,809,摩根大通,2024-08-16,8440
2388,威盛,956,221,735,摩根大通,2024-08-16,8440
2356,英業達,1141,457,684,摩根大通,2024-08-16,8440
2867,三商壽,893,224,669,摩根大通,2024-08-16,8440
2323,中環,1531,889,642,摩根大通,2024-08-16,8440
1815,富喬,692,89,603,摩根大通,2024-08-16,8440
3019,亞光,883,323,560,摩根大通,2024-08-16,8440
4904,遠傳,669,111,558,摩根大通,2024-08-16,8440
2062,橋椿,1013,455,558,摩根大通,2024-08-16,8440
2520,冠德,772,225,547,摩根大通,2024-08-16,8440
9945,潤泰新,561,15,546,摩根大通,2024-08-16,8440
1102,亞泥,1214,734,480,摩根大通,2024-08-16,8440
1519,華城,547,73,474,摩根大通,2024-08-16,8440
1434,福懋,473,4,469,摩根大通,2024-08-16,8440
2888,新光金,12879,3873,9006,摩根大通,2024-08-19,8440
2891,中信金,6131,406,5725,摩根大通,2024-08-19,8440
2882,國泰金,3989,484,3505,摩根大通,2024-08-19,8440
2409,友達,3852,477,3375,摩根大通,2024-08-19,8440
2543,皇昌,2951,148,2803,摩根大通,2024-08-19,8440
2489,瑞軒,2900,381,2519,摩根大通,2024-08-19,8440
2330,台積電,2759,1433,1326,摩根大通,2024-08-19,8440
2324,仁寶,1246,134,1112,摩根大通,2024-08-19,8440
2890,永豐金,1072,29,1043,摩根大通,2024-08-19,8440
2382,廣達,959,117,842,摩根大通,2024-08-19,8440
2323,中環,1207,377,830,摩根大通,2024-08-19,8440
2884,玉山金,2186,1372,814,摩根大通,2024-08-19,8440
2867,三商壽,873,125,748,摩根大通,2024-08-19,8440
3045,台灣大,769,84,685,摩根大通,2024-08-19,8440
2367,燿華,919,290,629,摩根大通,2024-08-19,8440
3663,鑫科,795,185,610,摩根大通,2024-08-19,8440
6877,鏵友益,869,262,607,摩根大通,2024-08-19,8440
2349,錸德,710,134,576,摩根大通,2024-08-19,8440
2374,佳能,982,412,570,摩根大通,2024-08-19,8440
3312,弘憶股,1165,598,567,摩根大通,2024-08-19,8440
1504,東元,743,192,551,摩根大通,2024-08-19,8440
4909,新復興,606,62,544,摩根大通,2024-08-19,8440
1216,統一,571,71,500,摩根大通,2024-08-19,8440
8071,能率網通,596,112,484,摩根大通,2024-08-19,8440
4906,正文,671,219,452,摩根大通,2024-08-19,8440
2610,華航,736,299,437,摩根大通,2024-08-19,8440
1584,精剛,577,160,417,摩根大通,2024-08-19,8440
2332,友訊,407,1,406,摩根大通,2024-08-19,8440
6177,達麗,718,315,403,摩根大通,2024-08-19,8440
2201,裕隆,470,100,370,摩根大通,2024-08-19,8440
2880,華南金,609,258,351,摩根大通,2024-08-19,8440
2515,中工,366,17,349,摩根大通,2024-08-19,8440
1102,亞泥,355,16,339,摩根大通,2024-08-19,8440
2486,一詮,374,47,327,摩根大通,2024-08-19,8440
2886,兆豐金,573,247,326,摩根大通,2024-08-19,8440
9955,佳龍,424,103,321,摩根大通,2024-08-19,8440
3645,達邁,843,522,321,摩根大通,2024-08-19,8440
2337,旺宏,484,179,305,摩根大通,2024-08-19,8440
8927,北基,349,49,300,摩根大通,2024-08-19,8440
1442,名軒,326,32,294,摩根大通,2024-08-19,8440
5392,能率,448,163,285,摩根大通,2024-08-19,8440
3293,鈊象,351,69,282,摩根大通,2024-08-19,8440
2801,彰銀,556,278,278,摩根大通,2024-08-19,8440
6285,啟��,318,42,276,摩根大通,2024-08-19,8440
6282,康舒,279,12,267,摩根大通,2024-08-19,8440
4533,協易機,332,67,265,摩根大通,2024-08-19,8440
3037,欣興,367,104,263,摩根大通,2024-08-19,8440
3706,神達,253,1,252,摩根大通,2024-08-19,8440
5531,鄉林,261,22,239,摩根大通,2024-08-19,8440
2377,微星,362,125,237,摩根大通,2024-08-19,8440
2888,新光金,26448,9420,17028,摩根大通,2024-08-20,8440
2303,聯電,6382,1464,4918,摩根大通,2024-08-20,8440
2618,長榮航,4318,833,3485,摩根大通,2024-08-20,8440
5443,均豪,3630,1194,2436,摩根大通,2024-08-20,8440
2880,華南金,2500,218,2282,摩根大通,2024-08-20,8440
2388,威盛,2151,151,2000,摩根大通,2024-08-20,8440
2323,中環,2391,456,1935,摩根大通,2024-08-20,8440
1102,亞泥,1966,69,1897,摩根大通,2024-08-20,8440
2801,彰銀,1631,22,1609,摩根大通,2024-08-20,8440
2412,中華電,1676,154,1522,摩根大通,2024-08-20,8440
2002,中鋼,1499,236,1263,摩根大通,2024-08-20,8440
2610,華航,1236,165,1071,摩根大通,2024-08-20,8440
9938,百和,1123,109,1014,摩根大通,2024-08-20,8440
3047,訊舟,1302,381,921,摩根大通,2024-08-20,8440
2890,永豐金,1640,726,914,摩根大通,2024-08-20,8440
2344,華邦電,2595,1712,883,摩根大通,2024-08-20,8440
8064,東捷,1577,747,830,摩根大通,2024-08-20,8440
2337,旺宏,1023,216,807,摩根大通,2024-08-20,8440
2349,錸德,1122,340,782,摩根大通,2024-08-20,8440
2867,三商壽,989,220,769,摩根大通,2024-08-20,8440
6451,訊芯-KY,867,128,739,摩根大通,2024-08-20,8440
1101,台泥,865,140,725,摩根大通,2024-08-20,8440
2354,鴻準,2300,1630,670,摩根大通,2024-08-20,8440
2409,友達,750,101,649,摩根大通,2024-08-20,8440
2615,萬海,667,64,603,摩根大通,2024-08-20,8440
3580,友威科,634,55,579,摩根大通,2024-08-20,8440
6104,創惟,557,32,525,摩根大通,2024-08-20,8440
2886,兆豐金,756,289,467,摩根大通,2024-08-20,8440
2633,台灣高鐵,459,10,449,摩根大通,2024-08-20,8440
2376,技嘉,458,27,431,摩根大通,2024-08-20,8440
2603,長榮,899,476,423,摩根大通,2024-08-20,8440
2634,漢翔,435,19,416,摩根大通,2024-08-20,8440
8234,新漢,613,199,414,摩根大通,2024-08-20,8440
2027,大成鋼,598,192,406,摩根大通,2024-08-20,8440
3019,亞光,577,172,405,摩根大通,2024-08-20,8440
3689,湧德,431,28,403,摩根大通,2024-08-20,8440
3045,台灣大,399,3,396,摩根大通,2024-08-20,8440
3455,由田,618,223,395,摩根大通,2024-08-20,8440
3062,建漢,484,91,393,摩根大通,2024-08-20,8440
2884,玉山金,1317,925,392,摩根大通,2024-08-20,8440
1708,東鹼,472,81,391,摩根大通,2024-08-20,8440
4938,和碩,384,16,368,摩根大通,2024-08-20,8440
3711,日月光投控,678,322,356,摩根大通,2024-08-20,8440
2809,京城銀,512,164,348,摩根大通,2024-08-20,8440
3202,樺晟,477,131,346,摩根大通,2024-08-20,8440
3443,創意,356,16,340,摩根大通,2024-08-20,8440
3663,鑫科,636,304,332,摩根大通,2024-08-20,8440
1504,東元,435,112,323,摩根大通,2024-08-20,8440
2385,群光,443,126,317,摩根大通,2024-08-20,8440
2313,華通,485,171,314,摩根大通,2024-08-20,8440
2303,聯電,9339,4012,5327,摩根大通,2024-08-21,8440
2324,仁寶,6165,1674,4491,摩根大通,2024-08-21,8440
2317,鴻海,4968,2351,2617,摩根大通,2024-08-21,8440
2890,永豐金,2798,1048,1750,摩根大通,2024-08-21,8440
2884,玉山金,3137,1955,1182,摩根大通,2024-08-21,8440
2308,台達電,1332,222,1110,摩根大通,2024-08-21,8440
2609,陽明,1528,426,1102,摩根大通,2024-08-21,8440
3227,原相,1228,218,1010,摩根大通,2024-08-21,8440
3037,欣興,1499,510,989,摩根大通,2024-08-21,8440
2880,華南金,2473,1497,976,摩根大通,2024-08-21,8440
3376,新日興,1030,77,953,摩根大通,2024-08-21,8440
2882,國泰金,2345,1403,942,摩根大通,2024-08-21,8440
8096,擎亞,1243,378,865,摩根大通,2024-08-21,8440
2412,中華電,1834,970,864,摩根大通,2024-08-21,8440
8374,羅昇,889,73,816,摩根大通,2024-08-21,8440
1326,台化,1146,380,766,摩根大通,2024-08-21,8440
8089,康全電訊,994,264,730,摩根大通,2024-08-21,8440
1216,統一,1058,405,653,摩根大通,2024-08-21,8440
9955,佳龍,1040,400,640,摩根大通,2024-08-21,8440
2002,中鋼,1884,1267,617,摩根大通,2024-08-21,8440
2801,彰銀,1291,727,564,摩根大通,2024-08-21,8440
4938,和碩,1017,483,534,摩根大通,2024-08-21,8440
8299,群聯,564,31,533,摩根大通,2024-08-21,8440
1708,東鹼,536,62,474,摩根大通,2024-08-21,8440
1402,遠東新,997,524,473,摩根大通,2024-08-21,8440
2515,中工,872,408,464,摩根大通,2024-08-21,8440
4562,穎漢,519,83,436,摩根大通,2024-08-21,8440
4716,大立,681,254,427,摩根大通,2024-08-21,8440
1314,中石化,716,307,409,摩根大通,2024-08-21,8440
2367,燿華,748,347,401,摩根大通,2024-08-21,8440
2408,南亞科,710,315,395,摩根大通,2024-08-21,8440
3363,上詮,410,34,376,摩根大通,2024-08-21,8440
2867,三商壽,1933,1592,341,摩根大通,2024-08-21,8440
3062,建漢,593,253,340,摩根大通,2024-08-21,8440
2887,台新金,755,443,312,摩根大通,2024-08-21,8440
3167,大量,553,247,306,摩根大通,2024-08-21,8440
6239,力成,538,235,303,摩根大通,2024-08-21,8440
2606,裕民,371,71,300,摩根大通,2024-08-21,8440
5871,中租-KY,399,104,295,摩根大通,2024-08-21,8440
2845,遠東銀,837,543,294,摩根大通,2024-08-21,8440
5225,東科-KY,373,86,287,摩根大通,2024-08-21,8440
3013,晟銘電,425,138,287,摩根大通,2024-08-21,8440
5309,系統電,501,217,284,摩根大通,2024-08-21,8440
2476,鉅祥,349,76,273,摩根大通,2024-08-21,8440
1102,亞泥,754,482,272,摩根大通,2024-08-21,8440
1721,三晃,319,48,271,摩根大通,2024-08-21,8440
3450,聯鈞,286,16,270,摩根大通,2024-08-21,8440
2892,第一金,1073,805,268,摩根大通,2024-08-21,8440
9907,統一實,324,64,260,摩根大通,2024-08-21,8440
1409,新纖,371,121,250,摩根大通,2024-08-21,8440
3037,欣興,3708,344,3364,摩根大通,2024-08-22,8440
5905,南仁湖,2168,406,1762,摩根大通,2024-08-22,8440
2344,華邦電,1579,83,1496,摩根大通,2024-08-22,8440
3374,精材,1077,136,941,摩根大通,2024-08-22,8440
1301,台塑,1130,336,794,摩根大通,2024-08-22,8440
2027,大成鋼,728,18,710,摩根大通,2024-08-22,8440
2883,凱基金,1479,822,657,摩根大通,2024-08-22,8440
3045,台灣大,769,131,638,摩根大通,2024-08-22,8440
9105,泰金寶-DR,868,260,608,摩根大通,2024-08-22,8440
2610,華航,842,252,590,摩根大通,2024-08-22,8440
8069,元太,790,203,587,摩根大通,2024-08-22,8440
2409,友達,2151,1581,570,摩根大通,2024-08-22,8440
2324,仁寶,1029,460,569,摩根大通,2024-08-22,8440
1216,統一,765,209,556,摩根大通,2024-08-22,8440
6770,力積電,661,154,507,摩根大通,2024-08-22,8440
2609,陽明,596,107,489,摩根大通,2024-08-22,8440
2801,彰銀,788,305,483,摩根大通,2024-08-22,8440
2454,聯發科,538,73,465,摩根大通,2024-08-22,8440
3019,亞光,656,192,464,摩根大通,2024-08-22,8440
5880,合庫金,843,387,456,摩根大通,2024-08-22,8440
2892,第一金,1007,551,456,摩根大通,2024-08-22,8440
3665,貿聯-KY,495,62,433,摩根大通,2024-08-22,8440
4904,遠傳,624,234,390,摩根大通,2024-08-22,8440
1102,亞泥,588,202,386,摩根大通,2024-08-22,8440
2365,昆盈,369,7,362,摩根大通,2024-08-22,8440
3013,晟銘電,879,538,341,摩根大通,2024-08-22,8440
6207,雷科,380,39,341,摩根大通,2024-08-22,8440
1710,東聯,437,99,338,摩根大通,2024-08-22,8440
3231,緯創,592,265,327,摩根大通,2024-08-22,8440
2351,順德,357,39,318,摩根大通,2024-08-22,8440
2393,億光,363,45,318,摩根大通,2024-08-22,8440
1304,台聚,331,15,316,摩根大通,2024-08-22,8440
2834,臺企銀,518,209,309,摩根大通,2024-08-22,8440
3580,友威科,425,122,303,摩根大通,2024-08-22,8440
2603,長榮,654,369,285,摩根大通,2024-08-22,8440
2489,瑞軒,435,165,270,摩根大通,2024-08-22,8440
2105,正新,827,558,269,摩根大通,2024-08-22,8440
2337,旺宏,540,275,265,摩根大通,2024-08-22,8440
2880,華南金,767,504,263,摩根大通,2024-08-22,8440
8028,昇陽半導體,301,40,261,摩根大通,2024-08-22,8440
3047,訊舟,1271,1013,258,摩根大通,2024-08-22,8440
1326,台化,415,163,252,摩根大通,2024-08-22,8440
3581,博磊,258,10,248,摩根大通,2024-08-22,8440
2498,宏達電,375,128,247,摩根大通,2024-08-22,8440
3062,建漢,424,180,244,摩根大通,2024-08-22,8440
3036,文曄,239,10,229,摩根大通,2024-08-22,8440
5443,均豪,1295,1072,223,摩根大通,2024-08-22,8440
2368,金像電,275,57,218,摩根大通,2024-08-22,8440
5483,中美晶,228,13,215,摩根大通,2024-08-22,8440
8103,瀚荃,262,53,209,摩根大通,2024-08-22,8440
2890,永豐金,3549,439,3110,摩根大通,2024-08-23,8440
2888,新光金,6829,4495,2334,摩根大通,2024-08-23,8440
8028,昇陽半導體,1793,70,1723,摩根大通,2024-08-23,8440
2886,兆豐金,1819,412,1407,摩根大通,2024-08-23,8440
2208,台船,1575,272,1303,摩根大通,2024-08-23,8440
2610,華航,1325,37,1288,摩根大通,2024-08-23,8440
2801,彰銀,1162,195,967,摩根大通,2024-08-23,8440
8039,台虹,1345,476,869,摩根大通,2024-08-23,8440
2887,台新金,4076,3293,783,摩根大通,2024-08-23,8440
1101,台泥,1019,278,741,摩根大通,2024-08-23,8440
5443,均豪,1708,1009,699,摩根大通,2024-08-23,8440
9105,泰金寶-DR,912,238,674,摩根大通,2024-08-23,8440
1216,統一,717,101,616,摩根大通,2024-08-23,8440
2881,富邦金,742,143,599,摩根大通,2024-08-23,8440
6505,台塑化,1159,563,596,摩根大通,2024-08-23,8440
3376,新日興,691,97,594,摩根大通,2024-08-23,8440
3045,台灣大,678,88,590,摩根大通,2024-08-23,8440
2882,國泰金,951,379,572,摩根大通,2024-08-23,8440
8071,能率網通,761,195,566,摩根大通,2024-08-23,8440
2377,微星,917,357,560,摩根大通,2024-08-23,8440
3231,緯創,765,263,502,摩根大通,2024-08-23,8440
2880,華南金,881,409,472,摩根大通,2024-08-23,8440
5871,中租-KY,1201,778,423,摩根大通,2024-08-23,8440
2883,凱基金,2712,2302,410,摩根大通,2024-08-23,8440
8096,擎亞,773,370,403,摩根大通,2024-08-23,8440
2618,長榮航,734,341,393,摩根大通,2024-08-23,8440
6442,光聖,487,96,391,摩根大通,2024-08-23,8440
1102,亞泥,555,185,370,摩根大通,2024-08-23,8440
6451,訊芯-KY,452,83,369,摩根大通,2024-08-23,8440
5880,合庫金,846,480,366,摩根大通,2024-08-23,8440
8210,勤誠,356,11,345,摩根大通,2024-08-23,8440
6770,力積電,432,89,343,摩根大通,2024-08-23,8440
8299,群聯,351,16,335,摩根大通,2024-08-23,8440
2412,中華電,506,187,319,摩根大通,2024-08-23,8440
3711,日月光投控,1177,893,284,摩根大通,2024-08-23,8440
8438,昶昕,508,242,266,摩根大通,2024-08-23,8440
4903,聯光通,429,166,263,摩根大通,2024-08-23,8440
4906,正文,377,122,255,摩根大通,2024-08-23,8440
6706,惠特,301,46,255,摩根大通,2024-08-23,8440
2454,聯發科,350,100,250,摩根大通,2024-08-23,8440
6125,廣運,319,76,243,摩根大通,2024-08-23,8440
1722,台肥,273,32,241,摩根大通,2024-08-23,8440
3037,欣興,506,281,225,摩根大通,2024-08-23,8440
3615,安可,586,371,215,摩根大通,2024-08-23,8440
3036,文曄,233,19,214,摩根大通,2024-08-23,8440
3149,正達,351,143,208,摩根大通,2024-08-23,8440
3587,閎康,216,13,203,摩根大通,2024-08-23,8440
5876,上海商銀,465,280,185,摩根大通,2024-08-23,8440
2301,光寶科,419,234,185,摩根大通,2024-08-23,8440
6869,雲豹能源,349,168,181,摩根大通,2024-08-23,8440
2353,宏��,6457,2414,4043,摩根大通,2024-08-26,8440
2882,國泰金,4370,375,3995,摩根大通,2024-08-26,8440
2867,三商壽,3985,224,3761,摩根大通,2024-08-26,8440
2883,凱基金,3440,222,3218,摩根大通,2024-08-26,8440
5871,中租-KY,3047,126,2921,摩根大通,2024-08-26,8440
2881,富邦金,3041,418,2623,摩根大通,2024-08-26,8440
2886,兆豐金,3035,779,2256,摩根大通,2024-08-26,8440
2801,彰銀,2608,567,2041,摩根大通,2024-08-26,8440
1802,台玻,2477,550,1927,摩根大通,2024-08-26,8440
2317,鴻海,2683,886,1797,摩根大通,2024-08-26,8440
1314,中石化,1958,163,1795,摩根大通,2024-08-26,8440
2208,台船,1864,180,1684,摩根大通,2024-08-26,8440
2324,仁寶,2177,608,1569,摩根大通,2024-08-26,8440
2618,長榮航,1822,292,1530,摩根大通,2024-08-26,8440
2880,華南金,2177,685,1492,摩根大通,2024-08-26,8440
1102,亞泥,1852,370,1482,摩根大通,2024-08-26,8440
2609,陽明,1601,159,1442,摩根大通,2024-08-26,8440
9904,寶成,1487,68,1419,摩根大通,2024-08-26,8440
1605,華新,1563,188,1375,摩根大通,2024-08-26,8440
1326,台化,1581,264,1317,摩根大通,2024-08-26,8440
2344,華邦電,1528,270,1258,摩根大通,2024-08-26,8440
2610,華航,1504,249,1255,摩根大通,2024-08-26,8440
6285,啟��,1223,131,1092,摩根大通,2024-08-26,8440
1717,長興,1081,24,1057,摩根大通,2024-08-26,8440
2515,中工,1104,85,1019,摩根大通,2024-08-26,8440
8096,擎亞,1905,904,1001,摩根大通,2024-08-26,8440
3231,緯創,1155,175,980,摩根大通,2024-08-26,8440
6505,台塑化,1298,348,950,摩根大通,2024-08-26,8440
2498,宏達電,884,29,855,摩根大通,2024-08-26,8440
1101,台泥,1039,203,836,摩根大通,2024-08-26,8440
6770,力積電,931,103,828,摩根大通,2024-08-26,8440
2606,裕民,892,74,818,摩根大通,2024-08-26,8440
3049,精金,908,180,728,摩根大通,2024-08-26,8440
6116,彩晶,981,261,720,摩根大通,2024-08-26,8440
2884,玉山金,2299,1652,647,摩根大通,2024-08-26,8440
1301,台塑,1145,520,625,摩根大通,2024-08-26,8440
2489,瑞軒,751,131,620,摩根大通,2024-08-26,8440
5880,合庫金,1316,702,614,摩根大通,2024-08-26,8440
9955,佳龍,742,132,610,摩根大通,2024-08-26,8440
1319,東陽,723,115,608,摩根大通,2024-08-26,8440
2912,統一超,620,16,604,摩根大通,2024-08-26,8440
2356,英業達,898,301,597,摩根大通,2024-08-26,8440
9105,泰金寶-DR,803,241,562,摩根大通,2024-08-26,8440
5876,上海商銀,583,54,529,摩根大通,2024-08-26,8440
1504,東元,624,107,517,摩根大通,2024-08-26,8440
4564,元翎,582,69,513,摩根大通,2024-08-26,8440
2027,大成鋼,556,71,485,摩根大通,2024-08-26,8440
2845,遠東銀,702,222,480,摩根大通,2024-08-26,8440
2892,第一金,778,305,473,摩根大通,2024-08-26,8440
2637,慧洋-KY,566,94,472,摩根大通,2024-08-26,8440
2543,皇昌,2203,198,2005,摩根大通,2024-08-27,8440
2890,永豐金,2040,387,1653,摩根大通,2024-08-27,8440
2888,新光金,8074,6495,1579,摩根大通,2024-08-27,8440
1711,永光,2082,544,1538,摩根大通,2024-08-27,8440
2402,毅嘉,2135,787,1348,摩根大通,2024-08-27,8440
3715,定穎投控,1279,29,1250,摩根大通,2024-08-27,8440
2002,中鋼,1714,553,1161,摩根大通,2024-08-27,8440
2867,三商壽,1425,265,1160,摩根大通,2024-08-27,8440
1721,三晃,1162,125,1037,摩根大通,2024-08-27,8440
2208,台船,1201,232,969,摩根大通,2024-08-27,8440
2912,統一超,1030,66,964,摩根大通,2024-08-27,8440
8028,昇陽半導體,1231,383,848,摩根大通,2024-08-27,8440
2618,長榮航,2006,1247,759,摩根大通,2024-08-27,8440
6143,振曜,758,44,714,摩根大通,2024-08-27,8440
2882,國泰金,2371,1660,711,摩根大通,2024-08-27,8440
3450,聯鈞,936,262,674,摩根大通,2024-08-27,8440
1216,統一,1349,678,671,摩根大通,2024-08-27,8440
2062,橋椿,671,32,639,摩根大通,2024-08-27,8440
8064,東捷,1318,692,626,摩根大通,2024-08-27,8440
3019,亞光,1013,406,607,摩根大通,2024-08-27,8440
2881,富邦金,1506,930,576,摩根大通,2024-08-27,8440
2330,台積電,1440,874,566,摩根大通,2024-08-27,8440
2356,英業達,959,410,549,摩根大通,2024-08-27,8440
4904,遠傳,778,237,541,摩根大通,2024-08-27,8440
6285,啟��,647,131,516,摩根大通,2024-08-27,8440
4303,信立,540,65,475,摩根大通,2024-08-27,8440
0050,元大台灣50,439,0,439,摩根大通,2024-08-27,8440
2349,錸德,935,515,420,摩根大通,2024-08-27,8440
2504,國產,417,27,390,摩根大通,2024-08-27,8440
3374,精材,892,505,387,摩根大通,2024-08-27,8440
4938,和碩,475,91,384,摩根大通,2024-08-27,8440
6438,迅得,386,19,367,摩根大通,2024-08-27,8440
5871,中租-KY,457,111,346,摩根大通,2024-08-27,8440
3711,日月光投控,800,460,340,摩根大通,2024-08-27,8440
2357,華碩,587,248,339,摩根大通,2024-08-27,8440
3048,益登,338,4,334,摩根大通,2024-08-27,8440
2204,中華,601,283,318,摩根大通,2024-08-27,8440
1402,遠東新,929,620,309,摩根大通,2024-08-27,8440
2405,輔信,585,302,283,摩根大通,2024-08-27,8440
6177,達麗,473,204,269,摩根大通,2024-08-27,8440
2606,裕民,408,144,264,摩根大通,2024-08-27,8440
2809,京城銀,385,136,249,摩根大通,2024-08-27,8440
6546,正基,251,7,244,摩根大通,2024-08-27,8440
5234,達興材料,466,233,233,摩根大通,2024-08-27,8440
6116,彩晶,427,199,228,摩根大通,2024-08-27,8440
2359,所羅門,371,149,222,摩根大通,2024-08-27,8440
3498,陽程,316,95,221,摩根大通,2024-08-27,8440
2801,彰銀,601,380,221,摩根大通,2024-08-27,8440
2027,大成鋼,383,163,220,摩根大通,2024-08-27,8440
5263,智崴,256,37,219,摩根大通,2024-08-27,8440
3481,群創,3953,764,3189,摩根大通,2024-08-28,8440
2412,中華電,2954,414,2540,摩根大通,2024-08-28,8440
2610,華航,2089,37,2052,摩根大通,2024-08-28,8440
3231,緯創,1972,458,1514,摩根大通,2024-08-28,8440
1711,永光,2214,703,1511,摩根大通,2024-08-28,8440
2883,凱基金,1831,336,1495,摩根大通,2024-08-28,8440
2324,仁寶,1525,94,1431,摩根大通,2024-08-28,8440
2618,長榮航,1572,240,1332,摩根大通,2024-08-28,8440
2801,彰銀,1821,711,1110,摩根大通,2024-08-28,8440
9904,寶成,1226,134,1092,摩根大通,2024-08-28,8440
2890,永豐金,1815,800,1015,摩根大通,2024-08-28,8440
3045,台灣大,1175,258,917,摩根大通,2024-08-28,8440
2889,國票金,879,4,875,摩根大通,2024-08-28,8440
6274,台燿,876,21,855,摩根大通,2024-08-28,8440
2377,微星,950,140,810,摩根大通,2024-08-28,8440
2464,盟立,1049,251,798,摩根大通,2024-08-28,8440
3189,景碩,920,209,711,摩根大通,2024-08-28,8440
5443,均豪,1532,900,632,摩根大通,2024-08-28,8440
2887,台新金,775,212,563,摩根大通,2024-08-28,8440
2504,國產,574,29,545,摩根大通,2024-08-28,8440
2399,映泰,565,28,537,摩根大通,2024-08-28,8440
8927,北基,554,45,509,摩根大通,2024-08-28,8440
2886,兆豐金,1354,907,447,摩根大通,2024-08-28,8440
3450,聯鈞,983,553,430,摩根大通,2024-08-28,8440
2467,志聖,537,142,395,摩根大通,2024-08-28,8440
3711,日月光投控,1334,953,381,摩根大通,2024-08-28,8440
2062,橋椿,662,287,375,摩根大通,2024-08-28,8440
4513,福裕,456,115,341,摩根大通,2024-08-28,8440
5876,上海商銀,722,382,340,摩根大通,2024-08-28,8440
8210,勤誠,362,41,321,摩根大通,2024-08-28,8440
3380,明泰,342,22,320,摩根大通,2024-08-28,8440
5386,青雲,488,171,317,摩根大通,2024-08-28,8440
2204,中華,499,210,289,摩根大通,2024-08-28,8440
8011,台通,513,228,285,摩根大通,2024-08-28,8440
1102,亞泥,1000,718,282,摩根大通,2024-08-28,8440
3149,正達,549,275,274,摩根大通,2024-08-28,8440
1605,華新,592,326,266,摩根大通,2024-08-28,8440
1216,統一,380,117,263,摩根大通,2024-08-28,8440
6285,啟��,340,78,262,摩根大通,2024-08-28,8440
1727,中華化,305,55,250,摩根大通,2024-08-28,8440
1536,和大,373,127,246,摩根大通,2024-08-28,8440
6176,瑞儀,315,69,246,摩根大通,2024-08-28,8440
1210,大成,253,10,243,摩根大通,2024-08-28,8440
2101,南港,260,19,241,摩根大通,2024-08-28,8440
1721,三晃,315,75,240,摩根大通,2024-08-28,8440
6116,彩晶,309,73,236,摩根大通,2024-08-28,8440
3049,精金,249,17,232,摩根大通,2024-08-28,8440
2449,京元電子,398,170,228,摩根大通,2024-08-28,8440
3147,大綜,340,114,226,摩根大通,2024-08-28,8440
8104,錸寶,234,18,216,摩根大通,2024-08-28,8440
2888,新光金,11532,1926,9606,摩根大通,2024-08-29,8440
2618,長榮航,6154,2680,3474,摩根大通,2024-08-29,8440
1101,台泥,3724,885,2839,摩根大通,2024-08-29,8440
2367,燿華,3201,888,2313,摩根大通,2024-08-29,8440
2885,元大金,2405,242,2163,摩根大通,2024-08-29,8440
5880,合庫金,2076,21,2055,摩根大通,2024-08-29,8440
2324,仁寶,2043,195,1848,摩根大通,2024-08-29,8440
2317,鴻海,4178,2362,1816,摩根大通,2024-08-29,8440
2890,永豐金,4303,2501,1802,摩根大通,2024-08-29,8440
2002,中鋼,1944,231,1713,摩根大通,2024-08-29,8440
2883,凱基金,2831,1199,1632,摩根大通,2024-08-29,8440
1216,統一,1489,129,1360,摩根大通,2024-08-29,8440
2884,玉山金,2619,1266,1353,摩根大通,2024-08-29,8440
2880,華南金,1989,654,1335,摩根大通,2024-08-29,8440
2610,華航,1499,173,1326,摩根大通,2024-08-29,8440
2889,國票金,1429,120,1309,摩根大通,2024-08-29,8440
5876,上海商銀,1229,66,1163,摩根大通,2024-08-29,8440
2892,第一金,1161,24,1137,摩根大通,2024-08-29,8440
2377,微星,1201,71,1130,摩根大通,2024-08-29,8440
1102,亞泥,1152,49,1103,摩根大通,2024-08-29,8440
2834,臺企銀,1746,767,979,摩根大通,2024-08-29,8440
9904,寶成,1115,162,953,摩根大通,2024-08-29,8440
3045,台灣大,1091,152,939,摩根大通,2024-08-29,8440
4526,東台,1103,263,840,摩根大通,2024-08-29,8440
2887,台新金,1051,308,743,摩根大通,2024-08-29,8440
4909,新復興,1123,418,705,摩根大通,2024-08-29,8440
3450,聯鈞,1498,870,628,摩根大通,2024-08-29,8440
2801,彰銀,1270,679,591,摩根大通,2024-08-29,8440
4904,遠傳,734,146,588,摩根大通,2024-08-29,8440
3711,日月光投控,1520,932,588,摩根大通,2024-08-29,8440
1303,南亞,939,374,565,摩根大通,2024-08-29,8440
2633,台灣高鐵,583,21,562,摩根大通,2024-08-29,8440
1402,遠東新,1039,497,542,摩根大通,2024-08-29,8440
1301,台塑,624,94,530,摩根大通,2024-08-29,8440
1540,喬福,573,44,529,摩根大通,2024-08-29,8440
2409,友達,1083,575,508,摩根大通,2024-08-29,8440
2882,國泰金,1764,1265,499,摩根大通,2024-08-29,8440
1316,上曜,528,38,490,摩根大通,2024-08-29,8440
1711,永光,1869,1389,480,摩根大通,2024-08-29,8440
3035,智原,535,59,476,摩根大通,2024-08-29,8440
2357,華碩,503,53,450,摩根大通,2024-08-29,8440
3665,貿聯-KY,528,86,442,摩根大通,2024-08-29,8440
6257,矽格,470,36,434,摩根大通,2024-08-29,8440
1605,華新,756,328,428,摩根大通,2024-08-29,8440
1326,台化,684,266,418,摩根大通,2024-08-29,8440
3189,景碩,902,498,404,摩根大通,2024-08-29,8440
4938,和碩,419,16,403,摩根大通,2024-08-29,8440
2312,金寶,531,128,403,摩根大通,2024-08-29,8440
4958,臻鼎-KY,887,489,398,摩根大通,2024-08-29,8440
1519,華城,449,74,375,摩根大通,2024-08-29,8440
3481,群創,14197,2417,11780,摩根大通,2024-08-30,8440
2002,中鋼,14784,6905,7879,摩根大通,2024-08-30,8440
1303,南亞,13541,6662,6879,摩根大通,2024-08-30,8440
2888,新光金,9734,5588,4146,摩根大通,2024-08-30,8440
2409,友達,9737,6378,3359,摩根大通,2024-08-30,8440
9904,寶成,3900,770,3130,摩根大通,2024-08-30,8440
1101,台泥,4948,1850,3098,摩根大通,2024-08-30,8440
2609,陽明,3892,797,3095,摩根大通,2024-08-30,8440
3450,聯鈞,3332,718,2614,摩根大通,2024-08-30,8440
3231,緯創,6037,3446,2591,摩根大通,2024-08-30,8440
1605,華新,3935,1404,2531,摩根大通,2024-08-30,8440
2801,彰銀,8212,5780,2432,摩根大通,2024-08-30,8440
2889,國票金,3276,984,2292,摩根大通,2024-08-30,8440
3037,欣興,2790,520,2270,摩根大通,2024-08-30,8440
1808,潤隆,2162,92,2070,摩根大通,2024-08-30,8440
1102,亞泥,2509,677,1832,摩根大通,2024-08-30,8440
2633,台灣高鐵,4209,2397,1812,摩根大通,2024-08-30,8440
2542,興富發,1743,72,1671,摩根大通,2024-08-30,8440
2836,高雄銀,1915,258,1657,摩根大通,2024-08-30,8440
1326,台化,4993,3346,1647,摩根大通,2024-08-30,8440
2317,鴻海,7822,6180,1642,摩根大通,2024-08-30,8440
2834,臺企銀,4454,2816,1638,摩根大通,2024-08-30,8440
2301,光寶科,3847,2222,1625,摩根大通,2024-08-30,8440
3362,先進光,1763,171,1592,摩根大通,2024-08-30,8440
4526,東台,2745,1259,1486,摩根大通,2024-08-30,8440
4714,永捷,2275,817,1458,摩根大通,2024-08-30,8440
3017,奇鋐,1742,380,1362,摩根大通,2024-08-30,8440
2027,大成鋼,1918,565,1353,摩根大通,2024-08-30,8440
1314,中石化,3275,1978,1297,摩根大通,2024-08-30,8440
2344,華邦電,5747,4478,1269,摩根大通,2024-08-30,8440
2812,台中銀,1421,161,1260,摩根大通,2024-08-30,8440
2618,長榮航,4227,3038,1189,摩根大通,2024-08-30,8440
2851,中再保,1178,0,1178,摩根大通,2024-08-30,8440
2412,中華電,4716,3554,1162,摩根大通,2024-08-30,8440
2105,正新,1947,796,1151,摩根大通,2024-08-30,8440
9945,潤泰新,1393,277,1116,摩根大通,2024-08-30,8440
2603,長榮,1517,458,1059,摩根大通,2024-08-30,8440
3013,晟銘電,1558,504,1054,摩根大通,2024-08-30,8440
3045,台灣大,2013,967,1046,摩根大通,2024-08-30,8440
1717,長興,1063,59,1004,摩根大通,2024-08-30,8440
5876,上海商銀,2545,1567,978,摩根大通,2024-08-30,8440
8028,昇陽半導體,2008,1126,882,摩根大通,2024-08-30,8440
3665,貿聯-KY,1006,210,796,摩根大通,2024-08-30,8440
3062,建漢,1206,416,790,摩根大通,2024-08-30,8440
1519,華城,1604,819,785,摩根大通,2024-08-30,8440
2408,南亞科,2611,1831,780,摩根大通,2024-08-30,8440
2449,京元電子,987,223,764,摩根大通,2024-08-30,8440
1522,堤維西,1661,908,753,摩根大通,2024-08-30,8440
1476,儒鴻,897,180,717,摩根大通,2024-08-30,8440
3081,聯亞,1398,702,696,摩根大通,2024-08-30,8440
2891,中信金,5710,1193,4517,摩根大通,2024-09-02,8440
2881,富邦金,2344,379,1965,摩根大通,2024-09-02,8440
3037,欣興,2034,138,1896,摩根大通,2024-09-02,8440
2618,長榮航,2310,724,1586,摩根大通,2024-09-02,8440
2883,凱基金,1941,540,1401,摩根大通,2024-09-02,8440
1605,華新,1505,140,1365,摩根大通,2024-09-02,8440
2882,國泰金,1762,745,1017,摩根大通,2024-09-02,8440
2889,國票金,1014,85,929,摩根大通,2024-09-02,8440
2610,華航,844,46,798,摩根大通,2024-09-02,8440
2324,仁寶,762,111,651,摩根大通,2024-09-02,8440
2515,中工,1282,771,511,摩根大通,2024-09-02,8440
3231,緯創,1541,1050,491,摩根大通,2024-09-02,8440
8070,長華*,662,236,426,摩根大通,2024-09-02,8440
3711,日月光投控,575,198,377,摩根大通,2024-09-02,8440
3580,友威科,479,108,371,摩根大通,2024-09-02,8440
3047,訊舟,334,4,330,摩根大通,2024-09-02,8440
1727,中華化,339,14,325,摩根大通,2024-09-02,8440
4763,材料-KY,323,8,315,摩根大通,2024-09-02,8440
2317,鴻海,670,370,300,摩根大通,2024-09-02,8440
6442,光聖,350,58,292,摩根大通,2024-09-02,8440
3617,碩天,295,5,290,摩根大通,2024-09-02,8440
4306,炎洲,539,252,287,摩根大通,2024-09-02,8440
2888,新光金,547,266,281,摩根大通,2024-09-02,8440
1101,台泥,1281,1007,274,摩根大通,2024-09-02,8440
1808,潤隆,534,293,241,摩根大通,2024-09-02,8440
2606,裕民,279,68,211,摩根大通,2024-09-02,8440
2301,光寶科,219,18,201,摩根大通,2024-09-02,8440
2402,毅嘉,540,341,199,摩根大通,2024-09-02,8440
3605,宏致,280,98,182,摩根大通,2024-09-02,8440
2382,廣達,621,441,180,摩根大通,2024-09-02,8440
1102,亞泥,402,224,178,摩根大通,2024-09-02,8440
9940,信義,236,58,178,摩根大通,2024-09-02,8440
3481,群創,794,617,177,摩根大通,2024-09-02,8440
3380,明泰,196,26,170,摩根大通,2024-09-02,8440
6284,佳邦,182,13,169,摩根大通,2024-09-02,8440
6153,嘉聯益,258,89,169,摩根大通,2024-09-02,8440
3548,兆利,418,251,167,摩根大通,2024-09-02,8440
2385,群光,328,163,165,摩根大通,2024-09-02,8440
2399,映泰,262,99,163,摩根大通,2024-09-02,8440
4566,時碩工業,182,33,149,摩根大通,2024-09-02,8440
1615,大山,155,13,142,摩根大通,2024-09-02,8440
4167,松瑞藥,144,5,139,摩根大通,2024-09-02,8440
3324,雙鴻,215,80,135,摩根大通,2024-09-02,8440
2489,瑞軒,309,176,133,摩根大通,2024-09-02,8440
3003,健和興,211,78,133,摩根大通,2024-09-02,8440
6186,新潤,167,38,129,摩根大通,2024-09-02,8440
3131,弘塑,147,18,129,摩根大通,2024-09-02,8440
8936,國統,141,12,129,摩根大通,2024-09-02,8440
6609,瀧澤科,211,88,123,摩根大通,2024-09-02,8440
2340,台亞,159,36,123,摩根大通,2024-09-02,8440
2382,廣達,4406,138,4268,摩根大通,2024-09-03,8440
2618,長榮航,4084,619,3465,摩根大通,2024-09-03,8440
2891,中信金,4526,1891,2635,摩根大通,2024-09-03,8440
2610,華航,1853,6,1847,摩根大通,2024-09-03,8440
2801,彰銀,1588,95,1493,摩根大通,2024-09-03,8440
2317,鴻海,3374,2162,1212,摩根大通,2024-09-03,8440
2609,陽明,1201,88,1113,摩根大通,2024-09-03,8440
2464,盟立,1375,375,1000,摩根大通,2024-09-03,8440
2303,聯電,2961,2019,942,摩根大通,2024-09-03,8440
2412,中華電,865,96,769,摩根大通,2024-09-03,8440
2889,國票金,1043,280,763,摩根大通,2024-09-03,8440
2383,台光電,853,131,722,摩根大通,2024-09-03,8440
6415,矽力*-KY,807,89,718,摩根大通,2024-09-03,8440
1711,永光,1030,315,715,摩根大通,2024-09-03,8440
3081,聯亞,924,269,655,摩根大通,2024-09-03,8440
6274,台燿,726,71,655,摩根大通,2024-09-03,8440
4763,材料-KY,659,34,625,摩根大通,2024-09-03,8440
2888,新光金,661,167,494,摩根大通,2024-09-03,8440
2408,南亞科,608,120,488,摩根大通,2024-09-03,8440
3711,日月光投控,546,99,447,摩根大通,2024-09-03,8440
2368,金像電,485,92,393,摩根大通,2024-09-03,8440
2603,長榮,491,132,359,摩根大通,2024-09-03,8440
2883,凱基金,1240,889,351,摩根大通,2024-09-03,8440
3617,碩天,382,34,348,摩根大通,2024-09-03,8440
2880,華南金,917,575,342,摩根大通,2024-09-03,8440
3045,台灣大,485,185,300,摩根大通,2024-09-03,8440
3390,旭軟,318,27,291,摩根大通,2024-09-03,8440
6757,台灣虎航,323,35,288,摩根大通,2024-09-03,8440
6190,萬泰科,325,38,287,摩根大通,2024-09-03,8440
4303,信立,643,358,285,摩根大通,2024-09-03,8440
3450,聯鈞,808,524,284,摩根大通,2024-09-03,8440
2049,上銀,323,51,272,摩根大通,2024-09-03,8440
6505,台塑化,574,303,271,摩根大通,2024-09-03,8440
4526,東台,259,0,259,摩根大通,2024-09-03,8440
4563,百德,356,98,258,摩根大通,2024-09-03,8440
3665,貿聯-KY,365,129,236,摩根大通,2024-09-03,8440
2489,瑞軒,330,103,227,摩根大通,2024-09-03,8440
4167,松瑞藥,227,4,223,摩根大通,2024-09-03,8440
4534,慶騰,262,42,220,摩根大通,2024-09-03,8440
2356,英業達,1041,833,208,摩根大通,2024-09-03,8440
4571,鈞興-KY,346,139,207,摩根大通,2024-09-03,8440
2393,億光,256,49,207,摩根大通,2024-09-03,8440
8070,長華*,606,403,203,摩根大通,2024-09-03,8440
1102,亞泥,336,139,197,摩根大通,2024-09-03,8440
6176,瑞儀,317,121,196,摩根大通,2024-09-03,8440
4977,眾達-KY,209,13,196,摩根大通,2024-09-03,8440
3023,信邦,185,6,179,摩根大通,2024-09-03,8440
5234,達興材料,189,18,171,摩根大通,2024-09-03,8440
2357,華碩,200,31,169,摩根大通,2024-09-03,8440
2884,玉山金,1100,932,168,摩根大通,2024-09-03,8440
2888,新光金,28864,4148,24716,摩根大通,2024-09-04,8440
2323,中環,2140,644,1496,摩根大通,2024-09-04,8440
2606,裕民,1755,269,1486,摩根大通,2024-09-04,8440
3163,波若威,845,179,666,摩根大通,2024-09-04,8440
2609,陽明,1450,839,611,摩根大通,2024-09-04,8440
3711,日月光投控,2737,2152,585,摩根大通,2024-09-04,8440
8096,擎亞,730,149,581,摩根大通,2024-09-04,8440
2889,國票金,1283,732,551,摩根大通,2024-09-04,8440
1540,喬福,573,72,501,摩根大通,2024-09-04,8440
6530,創威,601,203,398,摩根大通,2024-09-04,8440
2349,錸德,678,282,396,摩根大通,2024-09-04,8440
3293,鈊象,440,51,389,摩根大通,2024-09-04,8440
2615,萬海,1137,761,376,摩根大通,2024-09-04,8440
3035,智原,504,130,374,摩根大通,2024-09-04,8440
3062,建漢,777,412,365,摩根大通,2024-09-04,8440
3580,友威科,378,45,333,摩根大通,2024-09-04,8440
2464,盟立,708,386,322,摩根大通,2024-09-04,8440
2393,億光,445,125,320,摩根大通,2024-09-04,8440
8374,羅昇,1145,838,307,摩根大通,2024-09-04,8440
4562,穎漢,591,316,275,摩根大通,2024-09-04,8440
4174,浩鼎,264,3,261,摩根大通,2024-09-04,8440
4526,東台,260,0,260,摩根大通,2024-09-04,8440
5443,均豪,1049,795,254,摩根大通,2024-09-04,8440
8028,昇陽半導體,347,96,251,摩根大通,2024-09-04,8440
6415,矽力*-KY,468,222,246,摩根大通,2024-09-04,8440
2497,怡利電,430,189,241,摩根大通,2024-09-04,8440
4534,慶騰,482,246,236,摩根大通,2024-09-04,8440
1514,亞力,321,99,222,摩根大通,2024-09-04,8440
3312,弘憶股,273,71,202,摩根大通,2024-09-04,8440
2915,潤泰全,413,228,185,摩根大通,2024-09-04,8440
8064,東捷,305,122,183,摩根大通,2024-09-04,8440
1711,永光,618,437,181,摩根大通,2024-09-04,8440
3023,信邦,223,42,181,摩根大通,2024-09-04,8440
6788,華景電,186,9,177,摩根大通,2024-09-04,8440
6442,光聖,235,61,174,摩根大通,2024-09-04,8440
4979,華星光,196,23,173,摩根大通,2024-09-04,8440
6125,廣運,214,42,172,摩根大通,2024-09-04,8440
3450,聯鈞,165,0,165,摩根大通,2024-09-04,8440
2542,興富發,304,139,165,摩根大通,2024-09-04,8440
6609,瀧澤科,240,76,164,摩根大通,2024-09-04,8440
5289,宜鼎,170,6,164,摩根大通,2024-09-04,8440
3290,東浦,195,40,155,摩根大通,2024-09-04,8440
2540,愛山林,331,177,154,摩根大通,2024-09-04,8440
1727,中華化,186,32,154,摩根大通,2024-09-04,8440
4919,新唐,230,80,150,摩根大通,2024-09-04,8440
2062,橋椿,190,42,148,摩根大通,2024-09-04,8440
2504,國產,449,303,146,摩根大通,2024-09-04,8440
4909,新復興,407,263,144,摩根大通,2024-09-04,8440
5452,佶優,160,18,142,摩根大通,2024-09-04,8440
3322,建舜電,165,25,140,摩根大通,2024-09-04,8440
2883,凱基金,27637,2463,25174,摩根大通,2024-09-05,8440
2888,新光金,20907,808,20099,摩根大通,2024-09-05,8440
2882,國泰金,4321,1765,2556,摩根大通,2024-09-05,8440
3481,群創,2846,1216,1630,摩根大通,2024-09-05,8440
2609,陽明,1654,131,1523,摩根大通,2024-09-05,8440
2610,華航,1814,379,1435,摩根大通,2024-09-05,8440
2606,裕民,1264,65,1199,摩根大通,2024-09-05,8440
2618,長榮航,3742,2602,1140,摩根大通,2024-09-05,8440
9904,寶成,1143,173,970,摩根大通,2024-09-05,8440
3045,台灣大,895,219,676,摩根大通,2024-09-05,8440
1102,亞泥,820,183,637,摩根大通,2024-09-05,8440
2637,慧洋-KY,743,122,621,摩根大通,2024-09-05,8440
2464,盟立,946,369,577,摩根大通,2024-09-05,8440
2889,國票金,1076,516,560,摩根大通,2024-09-05,8440
6274,台燿,950,397,553,摩根大通,2024-09-05,8440
6215,和椿,619,96,523,摩根大通,2024-09-05,8440
1711,永光,1084,576,508,摩根大通,2024-09-05,8440
3673,TPK-KY,548,121,427,摩根大通,2024-09-05,8440
2324,仁寶,1457,1097,360,摩根大通,2024-09-05,8440
2383,台光電,456,122,334,摩根大通,2024-09-05,8440
3374,精材,860,541,319,摩根大通,2024-09-05,8440
4513,福裕,359,49,310,摩根大通,2024-09-05,8440
2371,大同,1016,725,291,摩根大通,2024-09-05,8440
2542,興富發,459,168,291,摩根大通,2024-09-05,8440
3023,信邦,295,17,278,摩根大通,2024-09-05,8440
6757,台灣虎航,522,245,277,摩根大通,2024-09-05,8440
2915,潤泰全,340,67,273,摩根大通,2024-09-05,8440
2498,宏達電,353,82,271,摩根大通,2024-09-05,8440
2634,漢翔,711,446,265,摩根大通,2024-09-05,8440
2421,建準,268,13,255,摩根大通,2024-09-05,8440
3663,鑫科,263,13,250,摩根大通,2024-09-05,8440
0050,元大台灣50,243,0,243,摩根大通,2024-09-05,8440
5876,上海商銀,580,359,221,摩根大通,2024-09-05,8440
3665,貿聯-KY,482,266,216,摩根大通,2024-09-05,8440
2881,富邦金,2295,2086,209,摩根大通,2024-09-05,8440
6147,頎邦,259,54,205,摩根大通,2024-09-05,8440
3450,聯鈞,197,0,197,摩根大通,2024-09-05,8440
5443,均豪,827,635,192,摩根大通,2024-09-05,8440
6116,彩晶,382,199,183,摩根大通,2024-09-05,8440
1808,潤隆,267,87,180,摩根大通,2024-09-05,8440
2312,金寶,365,194,171,摩根大通,2024-09-05,8440
3013,晟銘電,284,117,167,摩根大通,2024-09-05,8440
5483,中美晶,246,82,164,摩根大通,2024-09-05,8440
3303,岱稜,162,2,160,摩根大通,2024-09-05,8440
6706,惠特,233,74,159,摩根大通,2024-09-05,8440
3605,宏致,187,29,158,摩根大通,2024-09-05,8440
3576,聯合再生,209,53,156,摩根大通,2024-09-05,8440
2379,瑞昱,690,541,149,摩根大通,2024-09-05,8440
5213,亞昕,150,1,149,摩根大通,2024-09-05,8440
3357,臺慶科,155,7,148,摩根大通,2024-09-05,8440
2888,新光金,15859,185,15674,摩根大通,2024-09-06,8440
2882,國泰金,2862,592,2270,摩根大通,2024-09-06,8440
2609,陽明,2123,240,1883,摩根大通,2024-09-06,8440
2885,元大金,2196,436,1760,摩根大通,2024-09-06,8440
2886,兆豐金,2209,540,1669,摩根大通,2024-09-06,8440
1540,喬福,1493,155,1338,摩根大通,2024-09-06,8440
1301,台塑,1332,187,1145,摩根大通,2024-09-06,8440
2889,國票金,1467,333,1134,摩根大通,2024-09-06,8440
2520,冠德,1417,319,1098,摩根大通,2024-09-06,8440
2356,英業達,1502,446,1056,摩根大通,2024-09-06,8440
1303,南亞,1373,358,1015,摩根大通,2024-09-06,8440
5876,上海商銀,878,29,849,摩根大通,2024-09-06,8440
8069,元太,884,35,849,摩根大通,2024-09-06,8440
2408,南亞科,1049,255,794,摩根大通,2024-09-06,8440
2371,大同,838,92,746,摩根大通,2024-09-06,8440
2353,宏��,2401,1706,695,摩根大通,2024-09-06,8440
2890,永豐金,1345,694,651,摩根大通,2024-09-06,8440
2883,凱基金,2227,1583,644,摩根大通,2024-09-06,8440
3231,緯創,856,224,632,摩根大通,2024-09-06,8440
3227,原相,819,206,613,摩根大通,2024-09-06,8440
2892,第一金,1017,416,601,摩根大通,2024-09-06,8440
8096,擎亞,795,217,578,摩根大通,2024-09-06,8440
9938,百和,622,76,546,摩根大通,2024-09-06,8440
2363,矽統,546,20,526,摩根大通,2024-09-06,8440
2393,億光,601,95,506,摩根大通,2024-09-06,8440
3163,波若威,570,75,495,摩根大通,2024-09-06,8440
6215,和椿,803,316,487,摩根大通,2024-09-06,8440
2884,玉山金,873,454,419,摩根大通,2024-09-06,8440
1326,台化,670,269,401,摩根大通,2024-09-06,8440
2881,富邦金,1073,678,395,摩根大通,2024-09-06,8440
5508,永信建,429,37,392,摩根大通,2024-09-06,8440
4938,和碩,524,139,385,摩根大通,2024-09-06,8440
2867,三商壽,525,165,360,摩根大通,2024-09-06,8440
5871,中租-KY,558,201,357,摩根大通,2024-09-06,8440
2467,志聖,750,394,356,摩根大通,2024-09-06,8440
2382,廣達,634,293,341,摩根大通,2024-09-06,8440
1102,亞泥,493,153,340,摩根大通,2024-09-06,8440
6187,萬潤,572,252,320,摩根大通,2024-09-06,8440
3665,貿聯-KY,436,119,317,摩根大通,2024-09-06,8440
3450,聯鈞,347,45,302,摩根大通,2024-09-06,8440
6706,惠特,491,190,301,摩根大通,2024-09-06,8440
2454,聯發科,407,125,282,摩根大通,2024-09-06,8440
2312,金寶,355,97,258,摩根大通,2024-09-06,8440
3045,台灣大,757,510,247,摩根大通,2024-09-06,8440
4974,亞泰,354,111,243,摩根大通,2024-09-06,8440
1216,統一,654,412,242,摩根大通,2024-09-06,8440
9921,巨大,269,33,236,摩根大通,2024-09-06,8440
1536,和大,262,32,230,摩根大通,2024-09-06,8440
6605,帝寶,231,4,227,摩根大通,2024-09-06,8440
1513,中興電,251,33,218,摩根大通,2024-09-06,8440
2888,新光金,34168,1185,32983,摩根大通,2024-09-09,8440
1303,南亞,1645,686,959,摩根大通,2024-09-09,8440
1514,亞力,908,189,719,摩根大通,2024-09-09,8440
4513,福裕,759,78,681,摩根大通,2024-09-09,8440
3017,奇鋐,985,328,657,摩根大通,2024-09-09,8440
2402,毅嘉,616,50,566,摩根大通,2024-09-09,8440
2889,國票金,1266,774,492,摩根大通,2024-09-09,8440
5347,世界,925,475,450,摩根大通,2024-09-09,8440
3714,富采,560,114,446,摩根大通,2024-09-09,8440
4958,臻鼎-KY,507,83,424,摩根大通,2024-09-09,8440
2637,慧洋-KY,611,255,356,摩根大通,2024-09-09,8440
1605,華新,767,416,351,摩根大通,2024-09-09,8440
1101,台泥,1027,698,329,摩根大通,2024-09-09,8440
1326,台化,887,575,312,摩根大通,2024-09-09,8440
2892,第一金,1034,729,305,摩根大通,2024-09-09,8440
2603,長榮,517,212,305,摩根大通,2024-09-09,8440
8112,至上,556,253,303,摩根大通,2024-09-09,8440
2393,億光,472,173,299,摩根大通,2024-09-09,8440
2371,大同,1295,1003,292,摩根大通,2024-09-09,8440
6147,頎邦,315,32,283,摩根大通,2024-09-09,8440
5443,均豪,614,343,271,摩根大通,2024-09-09,8440
4938,和碩,525,257,268,摩根大通,2024-09-09,8440
2348,海悅,284,24,260,摩根大通,2024-09-09,8440
3227,原相,396,146,250,摩根大通,2024-09-09,8440
2530,華建,337,88,249,摩根大通,2024-09-09,8440
2383,台光電,312,64,248,摩根大通,2024-09-09,8440
8011,台通,295,53,242,摩根大通,2024-09-09,8440
9904,寶成,504,268,236,摩根大通,2024-09-09,8440
4561,健椿,252,19,233,摩根大通,2024-09-09,8440
3013,晟銘電,660,428,232,摩根大通,2024-09-09,8440
2454,聯發科,412,187,225,摩根大通,2024-09-09,8440
5876,上海商銀,318,107,211,摩根大通,2024-09-09,8440
1476,儒鴻,238,32,206,摩根大通,2024-09-09,8440
2421,建準,236,35,201,摩根大通,2024-09-09,8440
3042,晶技,247,57,190,摩根大通,2024-09-09,8440
1402,遠東新,659,476,183,摩根大通,2024-09-09,8440
3312,弘憶股,218,43,175,摩根大通,2024-09-09,8440
8105,凌巨,183,8,175,摩根大通,2024-09-09,8440
8069,元太,299,124,175,摩根大通,2024-09-09,8440
3023,信邦,193,22,171,摩根大通,2024-09-09,8440
2495,普安,196,28,168,摩根大通,2024-09-09,8440
2349,錸德,364,198,166,摩根大通,2024-09-09,8440
2520,冠德,480,314,166,摩根大通,2024-09-09,8440
2498,宏達電,312,159,153,摩根大通,2024-09-09,8440
3708,上緯投控,203,58,145,摩根大通,2024-09-09,8440
3450,聯鈞,145,0,145,摩根大通,2024-09-09,8440
4919,新唐,217,76,141,摩根大通,2024-09-09,8440
6285,啟��,186,49,137,摩根大通,2024-09-09,8440
3045,台灣大,473,337,136,摩根大通,2024-09-09,8440
5508,永信建,148,20,128,摩根大通,2024-09-09,8440
2891,中信金,9398,872,8526,摩根大通,2024-09-10,8440
2888,新光金,8325,604,7721,摩根大通,2024-09-10,8440
2880,華南金,3160,190,2970,摩根大通,2024-09-10,8440
2884,玉山金,4719,2528,2191,摩根大通,2024-09-10,8440
6505,台塑化,2529,660,1869,摩根大通,2024-09-10,8440
2886,兆豐金,2913,1185,1728,摩根大通,2024-09-10,8440
2618,長榮航,1593,328,1265,摩根大通,2024-09-10,8440
2881,富邦金,2202,1027,1175,摩根大通,2024-09-10,8440
5880,合庫金,1448,348,1100,摩根大通,2024-09-10,8440
2357,華碩,996,124,872,摩根大通,2024-09-10,8440
1402,遠東新,993,132,861,摩根大通,2024-09-10,8440
2610,華航,877,20,857,摩根大通,2024-09-10,8440
2603,長榮,1306,481,825,摩根大通,2024-09-10,8440
1303,南亞,1258,441,817,摩根大通,2024-09-10,8440
8064,東捷,790,46,744,摩根大通,2024-09-10,8440
2317,鴻海,3285,2597,688,摩根大通,2024-09-10,8440
5905,南仁湖,743,74,669,摩根大通,2024-09-10,8440
2885,元大金,1454,787,667,摩根大通,2024-09-10,8440
2801,彰銀,946,291,655,摩根大通,2024-09-10,8440
5347,世界,1808,1167,641,摩根大通,2024-09-10,8440
4979,華星光,1261,624,637,摩根大通,2024-09-10,8440
3062,建漢,1483,860,623,摩根大通,2024-09-10,8440
2408,南亞科,1144,528,616,摩根大通,2024-09-10,8440
1514,亞力,692,77,615,摩根大通,2024-09-10,8440
1540,喬福,659,71,588,摩根大通,2024-09-10,8440
2637,慧洋-KY,812,225,587,摩根大通,2024-09-10,8440
3711,日月光投控,939,355,584,摩根大通,2024-09-10,8440
3715,定穎投控,863,353,510,摩根大通,2024-09-10,8440
1102,亞泥,781,275,506,摩根大通,2024-09-10,8440
2393,億光,751,270,481,摩根大通,2024-09-10,8440
4561,健椿,595,134,461,摩根大通,2024-09-10,8440
4566,時碩工業,561,110,451,摩根大通,2024-09-10,8440
9904,寶成,515,70,445,摩根大通,2024-09-10,8440
3231,緯創,742,298,444,摩根大通,2024-09-10,8440
3005,神基,526,98,428,摩根大通,2024-09-10,8440
1101,台泥,708,300,408,摩根大通,2024-09-10,8440
2890,永豐金,1470,1065,405,摩根大通,2024-09-10,8440
1326,台化,728,350,378,摩根大通,2024-09-10,8440
1711,永光,1136,760,376,摩根大通,2024-09-10,8440
6279,胡連,379,22,357,摩根大通,2024-09-10,8440
2353,宏��,848,492,356,摩根大通,2024-09-10,8440
3209,全科,401,53,348,摩根大通,2024-09-10,8440
2609,陽明,793,461,332,摩根大通,2024-09-10,8440
4958,臻鼎-KY,615,285,330,摩根大通,2024-09-10,8440
9938,百和,580,252,328,摩根大通,2024-09-10,8440
2537,聯上發,331,12,319,摩根大通,2024-09-10,8440
1722,台肥,370,53,317,摩根大通,2024-09-10,8440
2406,國碩,325,22,303,摩根大通,2024-09-10,8440
2845,遠東銀,348,49,299,摩根大通,2024-09-10,8440
6152,百一,389,94,295,摩根大通,2024-09-10,8440
2888,新光金,17625,274,17351,摩根大通,2024-09-11,8440
6505,台塑化,2058,254,1804,摩根大通,2024-09-11,8440
2609,陽明,1714,65,1649,摩根大通,2024-09-11,8440
2603,長榮,1574,264,1310,摩根大通,2024-09-11,8440
2801,彰銀,1326,399,927,摩根大通,2024-09-11,8440
2882,國泰金,1541,677,864,摩根大通,2024-09-11,8440
2889,國票金,1201,364,837,摩根大通,2024-09-11,8440
3711,日月光投控,808,14,794,摩根大通,2024-09-11,8440
2399,映泰,1254,556,698,摩根大通,2024-09-11,8440
5871,中租-KY,820,139,681,摩根大通,2024-09-11,8440
2610,華航,681,4,677,摩根大通,2024-09-11,8440
1709,和益,812,165,647,摩根大通,2024-09-11,8440
2349,錸德,876,230,646,摩根大通,2024-09-11,8440
5347,世界,1384,759,625,摩根大通,2024-09-11,8440
2881,富邦金,1673,1098,575,摩根大通,2024-09-11,8440
2542,興富發,605,50,555,摩根大通,2024-09-11,8440
2371,大同,998,463,535,摩根大通,2024-09-11,8440
2497,怡利電,839,335,504,摩根大通,2024-09-11,8440
6770,力積電,670,188,482,摩根大通,2024-09-11,8440
4513,福裕,552,90,462,摩根大通,2024-09-11,8440
1303,南亞,1070,614,456,摩根大通,2024-09-11,8440
6005,群益證,983,528,455,摩根大通,2024-09-11,8440
1326,台化,459,25,434,摩根大通,2024-09-11,8440
8473,山林水,497,80,417,摩根大通,2024-09-11,8440
1102,亞泥,610,200,410,摩根大通,2024-09-11,8440
4938,和碩,466,64,402,摩根大通,2024-09-11,8440
2618,長榮航,1552,1167,385,摩根大通,2024-09-11,8440
1301,台塑,1060,679,381,摩根大通,2024-09-11,8440
2887,台新金,831,453,378,摩根大通,2024-09-11,8440
2867,三商壽,696,329,367,摩根大通,2024-09-11,8440
8112,至上,433,67,366,摩根大通,2024-09-11,8440
1504,東元,417,91,326,摩根大通,2024-09-11,8440
2637,慧洋-KY,454,163,291,摩根大通,2024-09-11,8440
2367,燿華,482,197,285,摩根大通,2024-09-11,8440
4526,東台,283,0,283,摩根大通,2024-09-11,8440
2357,華碩,412,140,272,摩根大通,2024-09-11,8440
5534,長虹,350,79,271,摩根大通,2024-09-11,8440
5905,南仁湖,336,81,255,摩根大通,2024-09-11,8440
1605,華新,825,572,253,摩根大通,2024-09-11,8440
1722,台肥,363,116,247,摩根大通,2024-09-11,8440
2454,聯發科,356,113,243,摩根大通,2024-09-11,8440
6152,百一,432,193,239,摩根大通,2024-09-11,8440
2330,台積電,814,581,233,摩根大通,2024-09-11,8440
2520,冠德,240,12,228,摩根大通,2024-09-11,8440
3284,太普高,228,9,219,摩根大通,2024-09-11,8440
3580,友威科,285,73,212,摩根大通,2024-09-11,8440
8150,南茂,230,20,210,摩根大通,2024-09-11,8440
6442,光聖,250,43,207,摩根大通,2024-09-11,8440
2498,宏達電,221,19,202,摩根大通,2024-09-11,8440
2524,京城,227,26,201,摩根大通,2024-09-11,8440
2888,新光金,22859,7061,15798,摩根大通,2024-09-12,8440
2303,聯電,7227,1003,6224,摩根大通,2024-09-12,8440
2883,凱基金,4619,1382,3237,摩根大通,2024-09-12,8440
2317,鴻海,5589,2522,3067,摩根大通,2024-09-12,8440
1303,南亞,3230,359,2871,摩根大通,2024-09-12,8440
2610,華航,2892,78,2814,摩根大通,2024-09-12,8440
2330,台積電,4894,2121,2773,摩根大通,2024-09-12,8440
2603,長榮,3635,1113,2522,摩根大通,2024-09-12,8440
2886,兆豐金,3039,699,2340,摩根大通,2024-09-12,8440
2002,中鋼,2765,464,2301,摩根大通,2024-09-12,8440
2356,英業達,2522,230,2292,摩根大通,2024-09-12,8440
1402,遠東新,2128,232,1896,摩根大通,2024-09-12,8440
3231,緯創,2269,386,1883,摩根大通,2024-09-12,8440
1301,台塑,2432,581,1851,摩根大通,2024-09-12,8440
2324,仁寶,3060,1296,1764,摩根大通,2024-09-12,8440
2892,第一金,4253,2501,1752,摩根大通,2024-09-12,8440
2353,宏��,2443,718,1725,摩根大通,2024-09-12,8440
5880,合庫金,3024,1348,1676,摩根大通,2024-09-12,8440
2887,台新金,3443,1798,1645,摩根大通,2024-09-12,8440
1101,台泥,1644,130,1514,摩根大通,2024-09-12,8440
2409,友達,1995,598,1397,摩根大通,2024-09-12,8440
1326,台化,1730,342,1388,摩根大通,2024-09-12,8440
6505,台塑化,1874,524,1350,摩根大通,2024-09-12,8440
2885,元大金,2596,1293,1303,摩根大通,2024-09-12,8440
2801,彰銀,1526,395,1131,摩根大通,2024-09-12,8440
1504,東元,1267,159,1108,摩根大通,2024-09-12,8440
3711,日月光投控,2006,992,1014,摩根大通,2024-09-12,8440
3062,建漢,1147,167,980,摩根大通,2024-09-12,8440
2371,大同,1260,320,940,摩根大通,2024-09-12,8440
8249,菱光,1113,202,911,摩根大通,2024-09-12,8440
2367,燿華,855,51,804,摩根大通,2024-09-12,8440
2881,富邦金,2372,1570,802,摩根大通,2024-09-12,8440
4977,眾達-KY,1079,301,778,摩根大通,2024-09-12,8440
4909,新復興,984,274,710,摩根大通,2024-09-12,8440
1540,喬福,972,273,699,摩根大通,2024-09-12,8440
4958,臻鼎-KY,1103,437,666,摩根大通,2024-09-12,8440
4979,華星光,764,130,634,摩根大通,2024-09-12,8440
2882,國泰金,2302,1673,629,摩根大通,2024-09-12,8440
2027,大成鋼,650,23,627,摩根大通,2024-09-12,8440
2344,華邦電,1172,550,622,摩根大通,2024-09-12,8440
6005,群益證,1183,583,600,摩根大通,2024-09-12,8440
2357,華碩,697,114,583,摩根大通,2024-09-12,8440
2880,華南金,2527,1960,567,摩根大通,2024-09-12,8440
2884,玉山金,3419,2865,554,摩根大通,2024-09-12,8440
4938,和碩,562,17,545,摩根大通,2024-09-12,8440
5871,中租-KY,668,124,544,摩根大通,2024-09-12,8440
3049,精金,621,80,541,摩根大通,2024-09-12,8440
2890,永豐金,2498,1976,522,摩根大通,2024-09-12,8440
3017,奇鋐,616,96,520,摩根大通,2024-09-12,8440
3498,陽程,557,78,479,摩根大通,2024-09-12,8440
2888,新光金,20727,1013,19714,摩根大通,2024-09-13,8440
2603,長榮,3177,360,2817,摩根大通,2024-09-13,8440
2610,華航,2691,173,2518,摩根大通,2024-09-13,8440
2618,長榮航,3992,1522,2470,摩根大通,2024-09-13,8440
2834,臺企銀,2171,126,2045,摩根大通,2024-09-13,8440
3231,緯創,2156,269,1887,摩根大通,2024-09-13,8440
2317,鴻海,2469,633,1836,摩根大通,2024-09-13,8440
3062,建漢,1748,102,1646,摩根大通,2024-09-13,8440
2371,大同,1672,254,1418,摩根大通,2024-09-13,8440
2884,玉山金,1668,286,1382,摩根大通,2024-09-13,8440
6505,台塑化,1964,643,1321,摩根大通,2024-09-13,8440
6005,群益證,1290,0,1290,摩根大通,2024-09-13,8440
1216,統一,1459,301,1158,摩根大通,2024-09-13,8440
2889,國票金,1451,362,1089,摩根大通,2024-09-13,8440
5880,合庫金,1135,232,903,摩根大通,2024-09-13,8440
6274,台燿,976,128,848,摩根大通,2024-09-13,8440
2027,大成鋼,850,36,814,摩根大通,2024-09-13,8440
1785,光洋科,894,81,813,摩根大通,2024-09-13,8440
1303,南亞,1474,686,788,摩根大通,2024-09-13,8440
3711,日月光投控,856,138,718,摩根大通,2024-09-13,8440
2892,第一金,1236,526,710,摩根大通,2024-09-13,8440
4909,新復興,1250,576,674,摩根大通,2024-09-13,8440
6104,創惟,1019,371,648,摩根大通,2024-09-13,8440
6187,萬潤,696,85,611,摩根大通,2024-09-13,8440
2062,橋椿,624,25,599,摩根大通,2024-09-13,8440
1309,台達化,581,10,571,摩根大通,2024-09-13,8440
8112,至上,664,160,504,摩根大通,2024-09-13,8440
2388,威盛,799,304,495,摩根大通,2024-09-13,8440
4906,正文,558,70,488,摩根大通,2024-09-13,8440
2356,英業達,672,203,469,摩根大通,2024-09-13,8440
2353,宏��,896,455,441,摩根大通,2024-09-13,8440
6163,華電網,668,230,438,摩根大通,2024-09-13,8440
3715,定穎投控,477,41,436,摩根大通,2024-09-13,8440
2880,華南金,792,384,408,摩根大通,2024-09-13,8440
1540,喬福,923,532,391,摩根大通,2024-09-13,8440
2890,永豐金,867,484,383,摩根大通,2024-09-13,8440
2801,彰銀,416,39,377,摩根大通,2024-09-13,8440
1504,東元,626,249,377,摩根大通,2024-09-13,8440
9938,百和,509,138,371,摩根大通,2024-09-13,8440
9955,佳龍,442,82,360,摩根大通,2024-09-13,8440
2204,中華,383,54,329,摩根大通,2024-09-13,8440
4915,致伸,333,8,325,摩根大通,2024-09-13,8440
4904,遠傳,433,111,322,摩根大通,2024-09-13,8440
6278,台表科,338,16,322,摩根大通,2024-09-13,8440
8011,台通,331,11,320,摩根大通,2024-09-13,8440
3149,正達,461,147,314,摩根大通,2024-09-13,8440
2324,仁寶,592,284,308,摩根大通,2024-09-13,8440
1402,遠東新,524,221,303,摩根大通,2024-09-13,8440
2883,凱基金,1231,935,296,摩根大通,2024-09-13,8440
3665,貿聯-KY,346,52,294,摩根大通,2024-09-13,8440
2888,新光金,13140,388,12752,摩根大通,2024-09-16,8440
2409,友達,10490,19,10471,摩根大通,2024-09-16,8440
2891,中信金,6475,838,5637,摩根大通,2024-09-16,8440
3481,群創,5414,2582,2832,摩根大通,2024-09-16,8440
2303,聯電,3300,645,2655,摩根大通,2024-09-16,8440
2330,台積電,3510,1551,1959,摩根大通,2024-09-16,8440
3231,緯創,2070,218,1852,摩根大通,2024-09-16,8440
1314,中石化,1827,396,1431,摩根大通,2024-09-16,8440
2618,長榮航,2090,777,1313,摩根大通,2024-09-16,8440
2892,第一金,1707,400,1307,摩根大通,2024-09-16,8440
2881,富邦金,1453,243,1210,摩根大通,2024-09-16,8440
6505,台塑化,1464,334,1130,摩根大通,2024-09-16,8440
2913,農林,1079,21,1058,摩根大通,2024-09-16,8440
1303,南亞,1223,203,1020,摩根大通,2024-09-16,8440
3045,台灣大,1074,113,961,摩根大通,2024-09-16,8440
2317,鴻海,1338,396,942,摩根大通,2024-09-16,8440
2812,台中銀,981,116,865,摩根大通,2024-09-16,8440
2356,英業達,992,136,856,摩根大通,2024-09-16,8440
1504,東元,905,72,833,摩根大通,2024-09-16,8440
1722,台肥,892,61,831,摩根大通,2024-09-16,8440
2845,遠東銀,996,168,828,摩根大通,2024-09-16,8440
6153,嘉聯益,804,31,773,摩根大通,2024-09-16,8440
2882,國泰金,1299,550,749,摩根大通,2024-09-16,8440
1304,台聚,722,0,722,摩根大通,2024-09-16,8440
6005,群益證,928,209,719,摩根大通,2024-09-16,8440
1101,台泥,833,120,713,摩根大通,2024-09-16,8440
1718,中纖,723,10,713,摩根大通,2024-09-16,8440
1721,三晃,855,202,653,摩根大通,2024-09-16,8440
8936,國統,562,9,553,摩根大通,2024-09-16,8440
5443,均豪,636,83,553,摩根大通,2024-09-16,8440
1727,中華化,736,202,534,摩根大通,2024-09-16,8440
4906,正文,547,23,524,摩根大通,2024-09-16,8440
1710,東聯,567,51,516,摩根大通,2024-09-16,8440
2610,華航,558,47,511,摩根大通,2024-09-16,8440
1609,大亞,583,79,504,摩根大通,2024-09-16,8440
4938,和碩,524,29,495,摩根大通,2024-09-16,8440
6116,彩晶,978,497,481,摩根大通,2024-09-16,8440
1717,長興,475,4,471,摩根大通,2024-09-16,8440
5347,世界,571,120,451,摩根大通,2024-09-16,8440
4968,立積,593,172,421,摩根大通,2024-09-16,8440
3714,富采,371,24,347,摩根大通,2024-09-16,8440
1709,和益,348,13,335,摩根大通,2024-09-16,8440
2332,友訊,381,49,332,摩根大通,2024-09-16,8440
3550,聯穎,335,18,317,摩根大通,2024-09-16,8440
1569,濱川,338,21,317,摩根大通,2024-09-16,8440
3290,東浦,414,117,297,摩根大通,2024-09-16,8440
6829,千附精密,331,35,296,摩根大通,2024-09-16,8440
6121,新普,297,1,296,摩根大通,2024-09-16,8440
9935,慶豐富,463,173,290,摩根大通,2024-09-16,8440
2408,南亞科,358,76,282,摩根大通,2024-09-16,8440
2891,中信金,17773,9652,8121,摩根大通,2024-09-18,8440
2883,凱基金,11774,3986,7788,摩根大通,2024-09-18,8440
2610,華航,7288,1138,6150,摩根大通,2024-09-18,8440
3481,群創,6975,990,5985,摩根大通,2024-09-18,8440
2618,長榮航,6561,799,5762,摩根大通,2024-09-18,8440
2603,長榮,3757,353,3404,摩根大通,2024-09-18,8440
2881,富邦金,4653,2471,2182,摩根大通,2024-09-18,8440
5347,世界,1879,126,1753,摩根大通,2024-09-18,8440
2609,陽明,1821,368,1453,摩根大通,2024-09-18,8440
1605,華新,1870,774,1096,摩根大通,2024-09-18,8440
1504,東元,1479,446,1033,摩根大通,2024-09-18,8440
1717,長興,1809,782,1027,摩根大通,2024-09-18,8440
2371,大同,1218,539,679,摩根大通,2024-09-18,8440
2308,台達電,952,358,594,摩根大通,2024-09-18,8440
3037,欣興,639,54,585,摩根大通,2024-09-18,8440
4763,材料-KY,486,8,478,摩根大通,2024-09-18,8440
1304,台聚,517,46,471,摩根大通,2024-09-18,8440
9938,百和,516,45,471,摩根大通,2024-09-18,8440
2888,新光金,8539,8086,453,摩根大通,2024-09-18,8440
3374,精材,464,59,405,摩根大通,2024-09-18,8440
2332,友訊,429,26,403,摩根大通,2024-09-18,8440
6187,萬潤,531,134,397,摩根大通,2024-09-18,8440
6706,惠特,708,323,385,摩根大通,2024-09-18,8440
2637,慧洋-KY,399,18,381,摩根大通,2024-09-18,8440
1402,遠東新,908,534,374,摩根大通,2024-09-18,8440
8096,擎亞,609,245,364,摩根大通,2024-09-18,8440
2353,宏��,1417,1054,363,摩根大通,2024-09-18,8440
6278,台表科,401,40,361,摩根大通,2024-09-18,8440
2349,錸德,688,330,358,摩根大通,2024-09-18,8440
8069,元太,503,160,343,摩根大通,2024-09-18,8440
2515,中工,456,114,342,摩根大通,2024-09-18,8440
3376,新日興,668,333,335,摩根大通,2024-09-18,8440
2354,鴻準,369,56,313,摩根大通,2024-09-18,8440
1718,中纖,336,32,304,摩根大通,2024-09-18,8440
2330,台積電,4392,4110,282,摩根大通,2024-09-18,8440
3707,漢磊,435,159,276,摩根大通,2024-09-18,8440
3019,亞光,533,258,275,摩根大通,2024-09-18,8440
2301,光寶科,882,612,270,摩根大通,2024-09-18,8440
1442,名軒,316,59,257,摩根大通,2024-09-18,8440
4908,前鼎,394,139,255,摩根大通,2024-09-18,8440
2498,宏達電,639,392,247,摩根大通,2024-09-18,8440
3189,景碩,1259,1024,235,摩根大通,2024-09-18,8440
2867,三商壽,315,87,228,摩根大通,2024-09-18,8440
9921,巨大,259,39,220,摩根大通,2024-09-18,8440
8112,至上,294,74,220,摩根大通,2024-09-18,8440
6869,雲豹能源,425,213,212,摩根大通,2024-09-18,8440
3443,創意,237,34,203,摩根大通,2024-09-18,8440
3264,欣銓,632,430,202,摩根大通,2024-09-18,8440
4974,亞泰,221,24,197,摩根大通,2024-09-18,8440
3714,富采,269,77,192,摩根大通,2024-09-18,8440
2888,新光金,47292,1067,46225,摩根大通,2024-09-19,8440
2883,凱基金,22829,3455,19374,摩根大通,2024-09-19,8440
2618,長榮航,9164,586,8578,摩根大通,2024-09-19,8440
2881,富邦金,6201,1389,4812,摩根大通,2024-09-19,8440
2353,宏��,3966,161,3805,摩根大通,2024-09-19,8440
2884,玉山金,4666,976,3690,摩根大通,2024-09-19,8440
3049,精金,3232,419,2813,摩根大通,2024-09-19,8440
5347,世界,2610,249,2361,摩根大通,2024-09-19,8440
3576,聯合再生,2427,106,2321,摩根大通,2024-09-19,8440
3481,群創,2797,651,2146,摩根大通,2024-09-19,8440
2885,元大金,2068,271,1797,摩根大通,2024-09-19,8440
4958,臻鼎-KY,1777,166,1611,摩根大通,2024-09-19,8440
2603,長榮,2112,573,1539,摩根大通,2024-09-19,8440
2882,國泰金,2712,1201,1511,摩根大通,2024-09-19,8440
1711,永光,1943,488,1455,摩根大通,2024-09-19,8440
5876,上海商銀,1643,210,1433,摩根大通,2024-09-19,8440
2867,三商壽,1609,190,1419,摩根大通,2024-09-19,8440
2609,陽明,1356,6,1350,摩根大通,2024-09-19,8440
2330,台積電,4657,3361,1296,摩根大通,2024-09-19,8440
9945,潤泰新,1463,216,1247,摩根大通,2024-09-19,8440
2886,兆豐金,1939,706,1233,摩根大通,2024-09-19,8440
5234,達興材料,1590,416,1174,摩根大通,2024-09-19,8440
2356,英業達,1664,497,1167,摩根大通,2024-09-19,8440
3702,大聯大,1250,96,1154,摩根大通,2024-09-19,8440
1402,遠東新,1296,155,1141,摩根大通,2024-09-19,8440
1314,中石化,1335,214,1121,摩根大通,2024-09-19,8440
2347,聯強,1269,168,1101,摩根大通,2024-09-19,8440
2801,彰銀,1434,376,1058,摩根大通,2024-09-19,8440
1303,南亞,1319,266,1053,摩根大通,2024-09-19,8440
1326,台化,1145,101,1044,摩根大通,2024-09-19,8440
2409,友達,1635,642,993,摩根大通,2024-09-19,8440
6443,元晶,1058,66,992,摩根大通,2024-09-19,8440
1785,光洋科,1857,876,981,摩根大通,2024-09-19,8440
5880,合庫金,1702,765,937,摩根大通,2024-09-19,8440
2301,光寶科,1336,418,918,摩根大通,2024-09-19,8440
2637,慧洋-KY,882,8,874,摩根大通,2024-09-19,8440
4903,聯光通,1060,206,854,摩根大通,2024-09-19,8440
2464,盟立,1092,251,841,摩根大通,2024-09-19,8440
1442,名軒,1030,191,839,摩根大通,2024-09-19,8440
5443,均豪,1082,281,801,摩根大通,2024-09-19,8440
2880,華南金,1918,1166,752,摩根大通,2024-09-19,8440
1727,中華化,759,133,626,摩根大通,2024-09-19,8440
3013,晟銘電,1044,428,616,摩根大通,2024-09-19,8440
2382,廣達,1158,562,596,摩根大通,2024-09-19,8440
8112,至上,603,16,587,摩根大通,2024-09-19,8440
2324,仁寶,1272,693,579,摩根大通,2024-09-19,8440
6176,瑞儀,561,13,548,摩根大通,2024-09-19,8440
6505,台塑化,1268,723,545,摩根大通,2024-09-19,8440
8011,台通,591,53,538,摩根大通,2024-09-19,8440
6830,汎銓,566,45,521,摩根大通,2024-09-19,8440
2891,中信金,31850,9540,22310,摩根大通,2024-09-20,8440
3481,群創,10626,386,10240,摩根大通,2024-09-20,8440
2618,長榮航,8400,1958,6442,摩根大通,2024-09-20,8440
2884,玉山金,5371,568,4803,摩根大通,2024-09-20,8440
2317,鴻海,6620,2185,4435,摩根大通,2024-09-20,8440
2882,國泰金,5756,1854,3902,摩根大通,2024-09-20,8440
1711,永光,6120,3262,2858,摩根大通,2024-09-20,8440
2002,中鋼,9684,7526,2158,摩根大通,2024-09-20,8440
3231,緯創,3036,1039,1997,摩根大通,2024-09-20,8440
2353,宏��,3288,1326,1962,摩根大通,2024-09-20,8440
1718,中纖,1892,3,1889,摩根大通,2024-09-20,8440
2464,盟立,2874,1005,1869,摩根大通,2024-09-20,8440
6116,彩晶,1724,5,1719,摩根大通,2024-09-20,8440
4919,新唐,1883,195,1688,摩根大通,2024-09-20,8440
2880,華南金,1868,192,1676,摩根大通,2024-09-20,8440
5347,世界,2185,596,1589,摩根大通,2024-09-20,8440
2324,仁寶,1788,261,1527,摩根大通,2024-09-20,8440
2610,華航,1591,77,1514,摩根大通,2024-09-20,8440
1513,中興電,1605,104,1501,摩根大通,2024-09-20,8440
2409,友達,3517,2036,1481,摩根大通,2024-09-20,8440
2399,映泰,2313,1013,1300,摩根大通,2024-09-20,8440
2889,國票金,1514,260,1254,摩根大通,2024-09-20,8440
2609,陽明,1348,129,1219,摩根大通,2024-09-20,8440
3715,定穎投控,1453,314,1139,摩根大通,2024-09-20,8440
1301,台塑,1297,200,1097,摩根大通,2024-09-20,8440
3702,大聯大,1104,48,1056,摩根大通,2024-09-20,8440
2905,三商,1018,22,996,摩根大通,2024-09-20,8440
1326,台化,939,35,904,摩根大通,2024-09-20,8440
9904,寶成,974,87,887,摩根大通,2024-09-20,8440
3264,欣銓,1026,148,878,摩根大通,2024-09-20,8440
4720,德淵,992,133,859,摩根大通,2024-09-20,8440
1605,華新,951,170,781,摩根大通,2024-09-20,8440
1216,統一,1161,385,776,摩根大通,2024-09-20,8440
2332,友訊,787,48,739,摩根大通,2024-09-20,8440
2382,廣達,1177,454,723,摩根大通,2024-09-20,8440
2845,遠東銀,741,37,704,摩根大通,2024-09-20,8440
6104,創惟,1278,622,656,摩根大通,2024-09-20,8440
3019,亞光,746,91,655,摩根大通,2024-09-20,8440
5876,上海商銀,769,115,654,摩根大通,2024-09-20,8440
2881,富邦金,1881,1235,646,摩根大通,2024-09-20,8440
1444,力麗,943,298,645,摩根大通,2024-09-20,8440
2385,群光,1071,446,625,摩根大通,2024-09-20,8440
1313,聯成,644,28,616,摩根大通,2024-09-20,8440
1717,長興,620,58,562,摩根大通,2024-09-20,8440
2801,彰銀,795,262,533,摩根大通,2024-09-20,8440
1434,福懋,550,30,520,摩根大通,2024-09-20,8440
6770,力積電,1059,564,495,摩根大通,2024-09-20,8440
2633,台灣高鐵,770,288,482,摩根大通,2024-09-20,8440
1303,南亞,1431,954,477,摩根大通,2024-09-20,8440
8112,至上,646,172,474,摩根大通,2024-09-20,8440
2888,新光金,7659,1708,5951,摩根大通,2024-09-23,8440
2618,長榮航,4956,989,3967,摩根大通,2024-09-23,8440
2603,長榮,4508,674,3834,摩根大通,2024-09-23,8440
2887,台新金,3308,595,2713,摩根大通,2024-09-23,8440
3481,群創,2523,620,1903,摩根大通,2024-09-23,8440
2882,國泰金,1890,530,1360,摩根大通,2024-09-23,8440
2834,臺企銀,2092,756,1336,摩根大通,2024-09-23,8440
1605,華新,1260,36,1224,摩根大通,2024-09-23,8440
5876,上海商銀,1380,184,1196,摩根大通,2024-09-23,8440
2884,玉山金,1604,426,1178,摩根大通,2024-09-23,8440
2330,台積電,3320,2216,1104,摩根大通,2024-09-23,8440
4919,新唐,1210,139,1071,摩根大通,2024-09-23,8440
1101,台泥,1566,497,1069,摩根大通,2024-09-23,8440
2353,宏��,1419,439,980,摩根大通,2024-09-23,8440
2881,富邦金,1387,443,944,摩根大通,2024-09-23,8440
2317,鴻海,2090,1168,922,摩根大通,2024-09-23,8440
2365,昆盈,921,0,921,摩根大通,2024-09-23,8440
3702,大聯大,849,82,767,摩根大通,2024-09-23,8440
2610,華航,1091,331,760,摩根大通,2024-09-23,8440
9105,泰金寶-DR,801,62,739,摩根大通,2024-09-23,8440
2537,聯上發,820,81,739,摩根大通,2024-09-23,8440
2542,興富發,1352,649,703,摩根大通,2024-09-23,8440
3550,聯穎,737,38,699,摩根大通,2024-09-23,8440
1102,亞泥,783,89,694,摩根大通,2024-09-23,8440
5347,世界,996,329,667,摩根大通,2024-09-23,8440
1522,堤維西,673,8,665,摩根大通,2024-09-23,8440
2449,京元電子,1706,1045,661,摩根大通,2024-09-23,8440
2385,群光,707,67,640,摩根大通,2024-09-23,8440
3037,欣興,712,75,637,摩根大通,2024-09-23,8440
2347,聯強,764,138,626,摩根大通,2024-09-23,8440
3048,益登,827,218,609,摩根大通,2024-09-23,8440
4716,大立,1764,1160,604,摩根大通,2024-09-23,8440
2027,大成鋼,701,128,573,摩根大通,2024-09-23,8440
2301,光寶科,685,120,565,摩根大通,2024-09-23,8440
8070,長華*,693,134,559,摩根大通,2024-09-23,8440
2637,慧洋-KY,600,42,558,摩根大通,2024-09-23,8440
2501,國建,533,5,528,摩根大通,2024-09-23,8440
3062,建漢,551,38,513,摩根大通,2024-09-23,8440
6176,瑞儀,516,16,500,摩根大通,2024-09-23,8440
6548,長科*,651,170,481,摩根大通,2024-09-23,8440
3580,友威科,520,58,462,摩根大通,2024-09-23,8440
2344,華邦電,952,499,453,摩根大通,2024-09-23,8440
1513,中興電,471,28,443,摩根大通,2024-09-23,8440
1326,台化,706,270,436,摩根大通,2024-09-23,8440
1314,中石化,562,127,435,摩根大通,2024-09-23,8440
2855,統一證,505,89,416,摩根大通,2024-09-23,8440
1519,華城,651,249,402,摩根大通,2024-09-23,8440
5483,中美晶,548,152,396,摩根大通,2024-09-23,8440
6505,台塑化,527,142,385,摩根大通,2024-09-23,8440
5469,瀚宇博,390,16,374,摩根大通,2024-09-23,8440
2888,新光金,19765,207,19558,摩根大通,2024-09-24,8440
2618,長榮航,12419,2931,9488,摩根大通,2024-09-24,8440
2882,國泰金,7213,385,6828,摩根大通,2024-09-24,8440
2603,長榮,7573,2211,5362,摩根大通,2024-09-24,8440
8069,元太,2989,250,2739,摩根大通,2024-09-24,8440
2330,台積電,3759,1438,2321,摩根大通,2024-09-24,8440
3481,群創,2360,185,2175,摩根大通,2024-09-24,8440
2317,鴻海,3053,1096,1957,摩根大通,2024-09-24,8440
5876,上海商銀,1668,67,1601,摩根大通,2024-09-24,8440
2892,第一金,1759,170,1589,摩根大通,2024-09-24,8440
3013,晟銘電,2302,731,1571,摩根大通,2024-09-24,8440
2887,台新金,2535,1241,1294,摩根大通,2024-09-24,8440
2409,友達,2986,1713,1273,摩根大通,2024-09-24,8440
3374,精材,1261,77,1184,摩根大通,2024-09-24,8440
3231,緯創,1661,564,1097,摩根大通,2024-09-24,8440
2455,全新,1353,332,1021,摩根大通,2024-09-24,8440
1605,華新,1253,359,894,摩根大通,2024-09-24,8440
8070,長華*,1180,300,880,摩根大通,2024-09-24,8440
4919,新唐,870,24,846,摩根大通,2024-09-24,8440
2301,光寶科,928,86,842,摩根大通,2024-09-24,8440
1301,台塑,1221,419,802,摩根大通,2024-09-24,8440
2615,萬海,2979,2181,798,摩根大通,2024-09-24,8440
2399,映泰,2043,1253,790,摩根大通,2024-09-24,8440
2880,華南金,1084,316,768,摩根大通,2024-09-24,8440
2303,聯電,3387,2646,741,摩根大通,2024-09-24,8440
3702,大聯大,702,131,571,摩根大通,2024-09-24,8440
2610,華航,1457,906,551,摩根大通,2024-09-24,8440
1402,遠東新,841,291,550,摩根大通,2024-09-24,8440
1102,亞泥,653,116,537,摩根大通,2024-09-24,8440
1711,永光,771,234,537,摩根大通,2024-09-24,8440
2385,群光,603,79,524,摩根大通,2024-09-24,8440
3062,建漢,921,400,521,摩根大通,2024-09-24,8440
1513,中興電,596,102,494,摩根大通,2024-09-24,8440
2308,台達電,759,277,482,摩根大通,2024-09-24,8440
1785,光洋科,642,167,475,摩根大通,2024-09-24,8440
3167,大量,661,200,461,摩根大通,2024-09-24,8440
5469,瀚宇博,454,1,453,摩根大通,2024-09-24,8440
2637,慧洋-KY,508,60,448,摩根大通,2024-09-24,8440
1504,東元,568,132,436,摩根大通,2024-09-24,8440
9904,寶成,572,147,425,摩根大通,2024-09-24,8440
2449,京元電子,557,168,389,摩根大通,2024-09-24,8440
3293,鈊象,569,182,387,摩根大通,2024-09-24,8440
2884,玉山金,1409,1026,383,摩根大通,2024-09-24,8440
6005,群益證,402,24,378,摩根大通,2024-09-24,8440
2027,大成鋼,378,8,370,摩根大通,2024-09-24,8440
5460,同協,422,74,348,摩根大通,2024-09-24,8440
2412,中華電,426,85,341,摩根大通,2024-09-24,8440
4909,新復興,414,91,323,摩根大通,2024-09-24,8440
6669,緯穎,338,44,294,摩根大通,2024-09-24,8440
6770,力積電,344,58,286,摩根大通,2024-09-24,8440
2888,新光金,37184,691,36493,摩根大通,2024-09-25,8440
2615,萬海,6116,1228,4888,摩根大通,2024-09-25,8440
2324,仁寶,3649,248,3401,摩根大通,2024-09-25,8440
2330,台積電,5056,1773,3283,摩根大通,2024-09-25,8440
5876,上海商銀,3085,166,2919,摩根大通,2024-09-25,8440
2317,鴻海,8009,5241,2768,摩根大通,2024-09-25,8440
2618,長榮航,3279,1018,2261,摩根大通,2024-09-25,8440
2603,長榮,3898,1865,2033,摩根大通,2024-09-25,8440
1102,亞泥,1869,174,1695,摩根大通,2024-09-25,8440
3231,緯創,2340,710,1630,摩根大通,2024-09-25,8440
2303,聯電,3747,2202,1545,摩根大通,2024-09-25,8440
3702,大聯大,2217,705,1512,摩根大通,2024-09-25,8440
2347,聯強,2177,744,1433,摩根大通,2024-09-25,8440
1301,台塑,1655,257,1398,摩根大通,2024-09-25,8440
00878,國泰永續高股息,1379,0,1379,摩根大通,2024-09-25,8440
4566,時碩工業,1363,31,1332,摩根大通,2024-09-25,8440
2356,英業達,2207,937,1270,摩根大通,2024-09-25,8440
2301,光寶科,1287,112,1175,摩根大通,2024-09-25,8440
2609,陽明,2916,1749,1167,摩根大通,2024-09-25,8440
2308,台達電,1537,509,1028,摩根大通,2024-09-25,8440
1504,東元,976,12,964,摩根大通,2024-09-25,8440
4979,華星光,1022,166,856,摩根大通,2024-09-25,8440
5871,中租-KY,1078,252,826,摩根大通,2024-09-25,8440
2345,智邦,1047,269,778,摩根大通,2024-09-25,8440
6239,力成,807,40,767,摩根大通,2024-09-25,8440
9904,寶成,938,204,734,摩根大通,2024-09-25,8440
2367,燿華,999,268,731,摩根大通,2024-09-25,8440
3450,聯鈞,937,236,701,摩根大通,2024-09-25,8440
1326,台化,807,140,667,摩根大通,2024-09-25,8440
0050,元大台灣50,845,200,645,摩根大通,2024-09-25,8440
4903,聯光通,813,176,637,摩根大通,2024-09-25,8440
2887,台新金,1371,735,636,摩根大通,2024-09-25,8440
3037,欣興,898,275,623,摩根大通,2024-09-25,8440
1605,華新,837,216,621,摩根大通,2024-09-25,8440
2353,宏��,1525,924,601,摩根大通,2024-09-25,8440
2027,大成鋼,682,86,596,摩根大通,2024-09-25,8440
2408,南亞科,802,217,585,摩根大通,2024-09-25,8440
2385,群光,637,72,565,摩根大通,2024-09-25,8440
2371,大同,654,109,545,摩根大通,2024-09-25,8440
3293,鈊象,947,404,543,摩根大通,2024-09-25,8440
6770,力積電,1235,700,535,摩根大通,2024-09-25,8440
3047,訊舟,782,254,528,摩根大通,2024-09-25,8440
2449,京元電子,1013,502,511,摩根大通,2024-09-25,8440
3376,新日興,565,56,509,摩根大通,2024-09-25,8440
9955,佳龍,594,87,507,摩根大通,2024-09-25,8440
2376,技嘉,752,248,504,摩根大通,2024-09-25,8440
2382,廣達,4777,4287,490,摩根大通,2024-09-25,8440
1101,台泥,1344,858,486,摩根大通,2024-09-25,8440
6176,瑞儀,494,21,473,摩根大通,2024-09-25,8440
2383,台光電,907,444,463,摩根大通,2024-09-25,8440
2882,國泰金,11339,1513,9826,摩根大通,2024-09-26,8440
2609,陽明,10234,2585,7649,摩根大通,2024-09-26,8440
2330,台積電,8217,2705,5512,摩根大通,2024-09-26,8440
3481,群創,5692,1074,4618,摩根大通,2024-09-26,8440
2615,萬海,6258,3045,3213,摩根大通,2024-09-26,8440
2618,長榮航,4689,1700,2989,摩根大通,2024-09-26,8440
2888,新光金,2482,820,1662,摩根大通,2024-09-26,8440
2603,長榮,2581,960,1621,摩根大通,2024-09-26,8440
2891,中信金,3131,1787,1344,摩根大通,2024-09-26,8440
1102,亞泥,1556,302,1254,摩根大通,2024-09-26,8440
2356,英業達,1928,707,1221,摩根大通,2024-09-26,8440
3013,晟銘電,1404,199,1205,摩根大通,2024-09-26,8440
5876,上海商銀,1690,495,1195,摩根大通,2024-09-26,8440
2388,威盛,1730,552,1178,摩根大通,2024-09-26,8440
3702,大聯大,1048,83,965,摩根大通,2024-09-26,8440
2382,廣達,3501,2611,890,摩根大通,2024-09-26,8440
2324,仁寶,1143,305,838,摩根大通,2024-09-26,8440
2543,皇昌,885,140,745,摩根大通,2024-09-26,8440
2002,中鋼,1322,621,701,摩根大通,2024-09-26,8440
6005,群益證,764,63,701,摩根大通,2024-09-26,8440
2347,聯強,966,314,652,摩根大通,2024-09-26,8440
00900,富邦特選高股息30,650,0,650,摩根大通,2024-09-26,8440
2337,旺宏,892,247,645,摩根大通,2024-09-26,8440
2880,華南金,1167,535,632,摩根大通,2024-09-26,8440
3661,世芯-KY,989,376,613,摩根大通,2024-09-26,8440
9904,寶成,1071,485,586,摩根大通,2024-09-26,8440
0050,元大台灣50,515,0,515,摩根大通,2024-09-26,8440
3062,建漢,616,109,507,摩根大通,2024-09-26,8440
4919,新唐,788,282,506,摩根大通,2024-09-26,8440
5880,合庫金,1035,545,490,摩根大通,2024-09-26,8440
2401,凌陽,463,2,461,摩根大通,2024-09-26,8440
2062,橋椿,515,54,461,摩根大通,2024-09-26,8440
5905,南仁湖,457,2,455,摩根大通,2024-09-26,8440
2345,智邦,775,386,389,摩根大通,2024-09-26,8440
2892,第一金,510,131,379,摩根大通,2024-09-26,8440
2449,京元電子,743,397,346,摩根大通,2024-09-26,8440
3324,雙鴻,726,391,335,摩根大通,2024-09-26,8440
3149,正達,786,472,314,摩根大通,2024-09-26,8440
2027,大成鋼,353,40,313,摩根大通,2024-09-26,8440
1605,華新,500,193,307,摩根大通,2024-09-26,8440
3045,台灣大,1602,1304,298,摩根大通,2024-09-26,8440
4906,正文,473,179,294,摩根大通,2024-09-26,8440
3030,德律,306,32,274,摩根大通,2024-09-26,8440
6104,創惟,434,163,271,摩根大通,2024-09-26,8440
6176,瑞儀,343,72,271,摩根大通,2024-09-26,8440
2376,技嘉,466,196,270,摩根大通,2024-09-26,8440
8927,北基,274,9,265,摩根大通,2024-09-26,8440
1717,長興,328,72,256,摩根大通,2024-09-26,8440
5202,力新,346,113,233,摩根大通,2024-09-26,8440
2834,臺企銀,391,161,230,摩根大通,2024-09-26,8440
2002,中鋼,7783,462,7321,摩根大通,2024-09-27,8440
3481,群創,5835,614,5221,摩根大通,2024-09-27,8440
1605,華新,4220,123,4097,摩根大通,2024-09-27,8440
2609,陽明,4948,1332,3616,摩根大通,2024-09-27,8440
2409,友達,3741,453,3288,摩根大通,2024-09-27,8440
2886,兆豐金,2969,617,2352,摩根大通,2024-09-27,8440
1513,中興電,2290,27,2263,摩根大通,2024-09-27,8440
1101,台泥,2790,538,2252,摩根大通,2024-09-27,8440
2615,萬海,3771,1578,2193,摩根大通,2024-09-27,8440
2337,旺宏,2112,119,1993,摩根大通,2024-09-27,8440
6770,力積電,2094,193,1901,摩根大通,2024-09-27,8440
2027,大成鋼,2197,368,1829,摩根大通,2024-09-27,8440
3702,大聯大,1936,148,1788,摩根大通,2024-09-27,8440
1717,長興,1783,3,1780,摩根大通,2024-09-27,8440
1711,永光,1849,180,1669,摩根大通,2024-09-27,8440
2317,鴻海,4260,2620,1640,摩根大通,2024-09-27,8440
2353,宏��,2459,907,1552,摩根大通,2024-09-27,8440
2882,國泰金,2912,1541,1371,摩根大通,2024-09-27,8440
6116,彩晶,1642,287,1355,摩根大通,2024-09-27,8440
5876,上海商銀,1577,226,1351,摩根大通,2024-09-27,8440
3189,景碩,2280,932,1348,摩根大通,2024-09-27,8440
2356,英業達,2106,831,1275,摩根大通,2024-09-27,8440
2888,新光金,1803,598,1205,摩根大通,2024-09-27,8440
1907,永豐餘,1219,20,1199,摩根大通,2024-09-27,8440
2618,長榮航,1929,735,1194,摩根大通,2024-09-27,8440
2382,廣達,1882,822,1060,摩根大通,2024-09-27,8440
2606,裕民,1290,255,1035,摩根大通,2024-09-27,8440
3231,緯創,1939,995,944,摩根大通,2024-09-27,8440
2637,慧洋-KY,1110,213,897,摩根大通,2024-09-27,8440
6257,矽格,875,17,858,摩根大通,2024-09-27,8440
1301,台塑,1097,248,849,摩根大通,2024-09-27,8440
2347,聯強,1244,447,797,摩根大通,2024-09-27,8440
2913,農林,909,116,793,摩根大通,2024-09-27,8440
2014,中鴻,821,58,763,摩根大通,2024-09-27,8440
2301,光寶科,879,134,745,摩根大通,2024-09-27,8440
2344,華邦電,1527,792,735,摩根大通,2024-09-27,8440
2801,彰銀,1276,549,727,摩根大通,2024-09-27,8440
1909,榮成,829,105,724,摩根大通,2024-09-27,8440
2362,藍天,960,270,690,摩根大通,2024-09-27,8440
3049,精金,669,0,669,摩根大通,2024-09-27,8440
1304,台聚,660,0,660,摩根大通,2024-09-27,8440
2892,第一金,968,308,660,摩根大通,2024-09-27,8440
2324,仁寶,1048,438,610,摩根大通,2024-09-27,8440
1709,和益,610,5,605,摩根大通,2024-09-27,8440
2049,上銀,620,20,600,摩根大通,2024-09-27,8440
6005,群益證,685,85,600,摩根大通,2024-09-27,8440
2308,台達電,1164,566,598,摩根大通,2024-09-27,8440
3576,聯合再生,771,182,589,摩根大通,2024-09-27,8440
1785,光洋科,709,120,589,摩根大通,2024-09-27,8440
6239,力成,628,62,566,摩根大通,2024-09-27,8440
2888,新光金,20509,2530,17979,摩根大通,2024-09-30,8440
3481,群創,7876,940,6936,摩根大通,2024-09-30,8440
2330,台積電,6736,2531,4205,摩根大通,2024-09-30,8440
1513,中興電,3948,187,3761,摩根大通,2024-09-30,8440
2317,鴻海,4392,768,3624,摩根大通,2024-09-30,8440
2883,凱基金,5252,1743,3509,摩根大通,2024-09-30,8440
2885,元大金,6655,3617,3038,摩根大通,2024-09-30,8440
1101,台泥,3484,556,2928,摩根大通,2024-09-30,8440
2618,長榮航,3601,759,2842,摩根大通,2024-09-30,8440
2324,仁寶,3136,547,2589,摩根大通,2024-09-30,8440
9904,寶成,2407,223,2184,摩根大通,2024-09-30,8440
1605,華新,2909,879,2030,摩根大通,2024-09-30,8440
6116,彩晶,2097,190,1907,摩根大通,2024-09-30,8440
2884,玉山金,3095,1410,1685,摩根大通,2024-09-30,8440
2886,兆豐金,3099,1635,1464,摩根大通,2024-09-30,8440
2412,中華電,1511,233,1278,摩根大通,2024-09-30,8440
2353,宏��,2316,1112,1204,摩根大通,2024-09-30,8440
2409,友達,1175,107,1068,摩根大通,2024-09-30,8440
2887,台新金,1391,510,881,摩根大通,2024-09-30,8440
8069,元太,905,76,829,摩根大通,2024-09-30,8440
2308,台達電,1424,609,815,摩根大通,2024-09-30,8440
1722,台肥,780,50,730,摩根大通,2024-09-30,8440
2356,英業達,1446,747,699,摩根大通,2024-09-30,8440
2371,大同,681,24,657,摩根大通,2024-09-30,8440
1303,南亞,1389,746,643,摩根大通,2024-09-30,8440
2633,台灣高鐵,731,97,634,摩根大通,2024-09-30,8440
3045,台灣大,714,90,624,摩根大通,2024-09-30,8440
2892,第一金,2010,1414,596,摩根大通,2024-09-30,8440
6005,群益證,616,40,576,摩根大通,2024-09-30,8440
9945,潤泰新,795,219,576,摩根大通,2024-09-30,8440
5347,世界,931,380,551,摩根大通,2024-09-30,8440
1711,永光,623,103,520,摩根大通,2024-09-30,8440
1326,台化,772,256,516,摩根大通,2024-09-30,8440
2312,金寶,650,185,465,摩根大通,2024-09-30,8440
8064,東捷,456,21,435,摩根大通,2024-09-30,8440
2388,威盛,573,142,431,摩根大通,2024-09-30,8440
2881,富邦金,2180,1751,429,摩根大通,2024-09-30,8440
6274,台燿,429,23,406,摩根大通,2024-09-30,8440
2454,聯發科,920,542,378,摩根大通,2024-09-30,8440
2365,昆盈,420,57,363,摩根大通,2024-09-30,8440
6438,迅得,493,134,359,摩根大通,2024-09-30,8440
0050,元大台灣50,340,0,340,摩根大通,2024-09-30,8440
2323,中環,524,218,306,摩根大通,2024-09-30,8440
2376,技嘉,384,83,301,摩根大通,2024-09-30,8440
1714,和桐,297,11,286,摩根大通,2024-09-30,8440
8104,錸寶,387,107,280,摩根大通,2024-09-30,8440
9958,世紀鋼,321,46,275,摩根大通,2024-09-30,8440
3005,神基,349,75,274,摩根大通,2024-09-30,8440
4904,遠傳,434,194,240,摩根大通,2024-09-30,8440
6176,瑞儀,293,54,239,摩根大通,2024-09-30,8440
2888,新光金,39133,2590,36543,摩根大通,2024-10-01,8440
2883,凱基金,6547,1584,4963,摩根大通,2024-10-01,8440
2610,華航,5102,1548,3554,摩根大通,2024-10-01,8440
5876,上海商銀,2765,207,2558,摩根大通,2024-10-01,8440
2637,慧洋-KY,2597,99,2498,摩根大通,2024-10-01,8440
2498,宏達電,2784,1021,1763,摩根大通,2024-10-01,8440
3363,上詮,1366,170,1196,摩根大通,2024-10-01,8440
2356,英業達,1427,495,932,摩根大通,2024-10-01,8440
2603,長榮,1137,310,827,摩根大通,2024-10-01,8440
2891,中信金,3524,2738,786,摩根大通,2024-10-01,8440
1504,東元,769,133,636,摩根大通,2024-10-01,8440
2543,皇昌,991,531,460,摩根大通,2024-10-01,8440
4303,信立,511,56,455,摩根大通,2024-10-01,8440
2454,聯發科,714,360,354,摩根大通,2024-10-01,8440
5452,佶優,372,26,346,摩根大通,2024-10-01,8440
2371,大同,615,290,325,摩根大通,2024-10-01,8440
2301,光寶科,482,164,318,摩根大通,2024-10-01,8440
6706,惠特,318,2,316,摩根大通,2024-10-01,8440
4526,東台,406,91,315,摩根大通,2024-10-01,8440
2006,東和鋼鐵,342,36,306,摩根大通,2024-10-01,8440
3034,聯詠,308,15,293,摩根大通,2024-10-01,8440
1711,永光,799,524,275,摩根大通,2024-10-01,8440
6104,創惟,333,58,275,摩根大通,2024-10-01,8440
3149,正達,314,41,273,摩根大通,2024-10-01,8440
6873,泓德能源,296,27,269,摩根大通,2024-10-01,8440
6530,創威,671,404,267,摩根大通,2024-10-01,8440
4716,大立,480,217,263,摩根大通,2024-10-01,8440
6177,達麗,307,50,257,摩根大通,2024-10-01,8440
6151,晉倫,502,262,240,摩根大通,2024-10-01,8440
6425,易發,612,388,224,摩根大通,2024-10-01,8440
1904,正隆,294,73,221,摩根大通,2024-10-01,8440
1434,福懋,309,93,216,摩根大通,2024-10-01,8440
2357,華碩,328,114,214,摩根大通,2024-10-01,8440
3710,連展投控,256,44,212,摩根大通,2024-10-01,8440
2351,順德,245,36,209,摩根大通,2024-10-01,8440
3234,光環,221,34,187,摩根大通,2024-10-01,8440
1595,川寶,291,105,186,摩根大通,2024-10-01,8440
1513,中興電,928,745,183,摩根大通,2024-10-01,8440
3498,陽程,209,28,181,摩根大通,2024-10-01,8440
2634,漢翔,180,0,180,摩根大通,2024-10-01,8440
9935,慶豐富,285,110,175,摩根大通,2024-10-01,8440
3545,敦泰,265,91,174,摩根大通,2024-10-01,8440
2328,廣宇,199,27,172,摩根大通,2024-10-01,8440
2379,瑞昱,252,81,171,摩根大通,2024-10-01,8440
6244,茂迪,208,52,156,摩根大通,2024-10-01,8440
3013,晟銘電,344,189,155,摩根大通,2024-10-01,8440
3305,昇貿,162,12,150,摩根大通,2024-10-01,8440
1907,永豐餘,222,72,150,摩根大通,2024-10-01,8440
4903,聯光通,475,328,147,摩根大通,2024-10-01,8440
1519,華城,316,170,146,摩根大通,2024-10-01,8440
2002,中鋼,25304,619,24685,摩根大通,2024-10-04,8440
2883,凱基金,9816,1037,8779,摩根大通,2024-10-04,8440
2888,新光金,7663,289,7374,摩根大通,2024-10-04,8440
2882,國泰金,4438,1557,2881,摩根大通,2024-10-04,8440
5876,上海商銀,2963,324,2639,摩根大通,2024-10-04,8440
6505,台塑化,2807,276,2531,摩根大通,2024-10-04,8440
1802,台玻,3002,585,2417,摩根大通,2024-10-04,8440
2317,鴻海,5448,3119,2329,摩根大通,2024-10-04,8440
3481,群創,2881,740,2141,摩根大通,2024-10-04,8440
2330,台積電,5017,2943,2074,摩根大通,2024-10-04,8440
9904,寶成,2204,189,2015,摩根大通,2024-10-04,8440
3231,緯創,3171,1240,1931,摩根大通,2024-10-04,8440
2408,南亞科,1753,58,1695,摩根大通,2024-10-04,8440
2637,慧洋-KY,2086,621,1465,摩根大通,2024-10-04,8440
3017,奇鋐,1662,250,1412,摩根大通,2024-10-04,8440
2606,裕民,1599,475,1124,摩根大通,2024-10-04,8440
2316,楠梓電,1041,66,975,摩根大通,2024-10-04,8440
2890,永豐金,2653,1705,948,摩根大通,2024-10-04,8440
3081,聯亞,1464,604,860,摩根大通,2024-10-04,8440
2399,映泰,1437,616,821,摩根大通,2024-10-04,8440
1815,富喬,917,141,776,摩根大通,2024-10-04,8440
2357,華碩,763,86,677,摩根大通,2024-10-04,8440
3189,景碩,778,142,636,摩根大通,2024-10-04,8440
6139,亞翔,582,20,562,摩根大通,2024-10-04,8440
6177,達麗,522,2,520,摩根大通,2024-10-04,8440
2497,怡利電,544,39,505,摩根大通,2024-10-04,8440
2601,益航,565,63,502,摩根大通,2024-10-04,8440
5871,中租-KY,1015,529,486,摩根大通,2024-10-04,8440
2371,大同,724,243,481,摩根大通,2024-10-04,8440
6239,力成,731,253,478,摩根大通,2024-10-04,8440
6186,新潤,481,16,465,摩根大通,2024-10-04,8440
4113,聯上,465,16,449,摩根大通,2024-10-04,8440
2337,旺宏,614,181,433,摩根大通,2024-10-04,8440
2458,義隆,423,13,410,摩根大通,2024-10-04,8440
1605,華新,694,292,402,摩根大通,2024-10-04,8440
8299,群聯,389,9,380,摩根大通,2024-10-04,8440
6805,富世達,477,107,370,摩根大通,2024-10-04,8440
1301,台塑,692,336,356,摩根大通,2024-10-04,8440
2891,中信金,3074,2720,354,摩根大通,2024-10-04,8440
4938,和碩,420,74,346,摩根大通,2024-10-04,8440
1727,中華化,385,54,331,摩根大通,2024-10-04,8440
2454,聯發科,735,409,326,摩根大通,2024-10-04,8440
1477,聚陽,352,50,302,摩根大通,2024-10-04,8440
2425,承啟,507,210,297,摩根大通,2024-10-04,8440
2347,聯強,903,627,276,摩根大通,2024-10-04,8440
1702,南僑,278,15,263,摩根大通,2024-10-04,8440
8097,常珵,258,4,254,摩根大通,2024-10-04,8440
3576,聯合再生,368,121,247,摩根大通,2024-10-04,8440
4513,福裕,292,46,246,摩根大通,2024-10-04,8440
3702,大聯大,1721,1478,243,摩根大通,2024-10-04,8440
2883,凱基金,15750,542,15208,摩根大通,2024-10-07,8440
2888,新光金,13744,84,13660,摩根大通,2024-10-07,8440
2002,中鋼,8967,569,8398,摩根大通,2024-10-07,8440
2882,國泰金,7150,1076,6074,摩根大通,2024-10-07,8440
6505,台塑化,5497,612,4885,摩根大通,2024-10-07,8440
3481,群創,3677,714,2963,摩根大通,2024-10-07,8440
2330,台積電,3881,984,2897,摩根大通,2024-10-07,8440
3049,精金,3266,540,2726,摩根大通,2024-10-07,8440
1815,富喬,2560,182,2378,摩根大通,2024-10-07,8440
2885,元大金,2807,643,2164,摩根大通,2024-10-07,8440
5876,上海商銀,3000,875,2125,摩根大通,2024-10-07,8440
1802,台玻,2256,350,1906,摩根大通,2024-10-07,8440
2880,華南金,2235,366,1869,摩根大通,2024-10-07,8440
8028,昇陽半導體,1764,54,1710,摩根大通,2024-10-07,8440
5871,中租-KY,3221,1580,1641,摩根大通,2024-10-07,8440
3450,聯鈞,1336,87,1249,摩根大通,2024-10-07,8440
3231,緯創,1769,669,1100,摩根大通,2024-10-07,8440
2382,廣達,1752,689,1063,摩根大通,2024-10-07,8440
8111,立��,1240,188,1052,摩根大通,2024-10-07,8440
2515,中工,1247,198,1049,摩根大通,2024-10-07,8440
6139,亞翔,1061,19,1042,摩根大通,2024-10-07,8440
2889,國票金,1028,35,993,摩根大通,2024-10-07,8440
2881,富邦金,1754,840,914,摩根大通,2024-10-07,8440
1504,東元,1603,729,874,摩根大通,2024-10-07,8440
2543,皇昌,1049,190,859,摩根大通,2024-10-07,8440
2357,華碩,951,134,817,摩根大通,2024-10-07,8440
2610,華航,809,5,804,摩根大通,2024-10-07,8440
2301,光寶科,938,150,788,摩根大通,2024-10-07,8440
2886,兆豐金,1144,448,696,摩根大通,2024-10-07,8440
2867,三商壽,900,209,691,摩根大通,2024-10-07,8440
2371,大同,722,50,672,摩根大通,2024-10-07,8440
2884,玉山金,2705,2056,649,摩根大通,2024-10-07,8440
6005,群益證,774,167,607,摩根大通,2024-10-07,8440
2637,慧洋-KY,645,40,605,摩根大通,2024-10-07,8440
6207,雷科,666,72,594,摩根大通,2024-10-07,8440
2206,三陽工業,636,111,525,摩根大通,2024-10-07,8440
2312,金寶,634,109,525,摩根大通,2024-10-07,8440
2601,益航,887,385,502,摩根大通,2024-10-07,8440
3374,精材,648,154,494,摩根大通,2024-10-07,8440
8064,東捷,486,0,486,摩根大通,2024-10-07,8440
4306,炎洲,477,15,462,摩根大通,2024-10-07,8440
8926,台汽電,462,6,456,摩根大通,2024-10-07,8440
3163,波若威,594,141,453,摩根大通,2024-10-07,8440
6152,百一,437,13,424,摩根大通,2024-10-07,8440
2014,中鴻,553,130,423,摩根大通,2024-10-07,8440
2106,建大,474,56,418,摩根大通,2024-10-07,8440
2520,冠德,503,95,408,摩根大通,2024-10-07,8440
6177,達麗,471,66,405,摩根大通,2024-10-07,8440
1477,聚陽,463,59,404,摩根大通,2024-10-07,8440
2606,裕民,630,247,383,摩根大通,2024-10-07,8440
2002,中鋼,15398,3400,11998,摩根大通,2024-10-08,8440
2888,新光金,7166,1522,5644,摩根大通,2024-10-08,8440
1605,華新,5669,858,4811,摩根大通,2024-10-08,8440
6505,台塑化,2423,708,1715,摩根大通,2024-10-08,8440
3481,群創,2976,1541,1435,摩根大通,2024-10-08,8440
2637,慧洋-KY,1254,29,1225,摩根大通,2024-10-08,8440
1802,台玻,1556,443,1113,摩根大通,2024-10-08,8440
2362,藍天,1187,231,956,摩根大通,2024-10-08,8440
2603,長榮,1370,459,911,摩根大通,2024-10-08,8440
3149,正達,1010,131,879,摩根大通,2024-10-08,8440
2344,華邦電,2581,1851,730,摩根大通,2024-10-08,8440
2615,萬海,1159,433,726,摩根大通,2024-10-08,8440
4903,聯光通,996,312,684,摩根大通,2024-10-08,8440
2520,冠德,896,246,650,摩根大通,2024-10-08,8440
8028,昇陽半導體,692,136,556,摩根大通,2024-10-08,8440
2606,裕民,782,226,556,摩根大通,2024-10-08,8440
6830,汎銓,575,54,521,摩根大通,2024-10-08,8440
2618,長榮航,1625,1131,494,摩根大通,2024-10-08,8440
9938,百和,536,50,486,摩根大通,2024-10-08,8440
5905,南仁湖,486,4,482,摩根大通,2024-10-08,8440
2889,國票金,543,87,456,摩根大通,2024-10-08,8440
3234,光環,652,206,446,摩根大通,2024-10-08,8440
2543,皇昌,793,348,445,摩根大通,2024-10-08,8440
9921,巨大,563,126,437,摩根大通,2024-10-08,8440
6530,創威,492,85,407,摩根大通,2024-10-08,8440
3576,聯合再生,476,77,399,摩根大通,2024-10-08,8440
2609,陽明,1103,724,379,摩根大通,2024-10-08,8440
3013,晟銘電,513,141,372,摩根大通,2024-10-08,8440
2515,中工,468,96,372,摩根大通,2024-10-08,8440
2388,威盛,1189,832,357,摩根大通,2024-10-08,8440
2882,國泰金,2376,2025,351,摩根大通,2024-10-08,8440
2467,志聖,499,160,339,摩根大通,2024-10-08,8440
3227,原相,445,110,335,摩根大通,2024-10-08,8440
6415,矽力*-KY,803,469,334,摩根大通,2024-10-08,8440
6438,迅得,495,162,333,摩根大通,2024-10-08,8440
2337,旺宏,490,163,327,摩根大通,2024-10-08,8440
2458,義隆,395,72,323,摩根大通,2024-10-08,8440
3443,創意,379,83,296,摩根大通,2024-10-08,8440
2316,楠梓電,647,367,280,摩根大通,2024-10-08,8440
6442,光聖,523,249,274,摩根大通,2024-10-08,8440
2208,台船,266,0,266,摩根大通,2024-10-08,8440
4956,光鋐,285,28,257,摩根大通,2024-10-08,8440
3025,星通,1247,992,255,摩根大通,2024-10-08,8440
2497,怡利電,278,24,254,摩根大通,2024-10-08,8440
6218,豪勉,364,114,250,摩根大通,2024-10-08,8440
2425,承啟,555,314,241,摩根大通,2024-10-08,8440
2103,台橡,312,85,227,摩根大通,2024-10-08,8440
2399,映泰,1026,817,209,摩根大通,2024-10-08,8440
3450,聯鈞,435,228,207,摩根大通,2024-10-08,8440
8299,群聯,264,73,191,摩根大通,2024-10-08,8440
2888,新光金,8841,587,8254,摩根大通,2024-10-09,8440
1605,華新,8979,1045,7934,摩根大通,2024-10-09,8440
2002,中鋼,10857,3442,7415,摩根大通,2024-10-09,8440
2610,華航,6583,1316,5267,摩根大通,2024-10-09,8440
2867,三商壽,4677,1722,2955,摩根大通,2024-10-09,8440
3231,緯創,4793,1894,2899,摩根大通,2024-10-09,8440
2609,陽明,2428,46,2382,摩根大通,2024-10-09,8440
2317,鴻海,5514,3460,2054,摩根大通,2024-10-09,8440
9938,百和,2316,359,1957,摩根大通,2024-10-09,8440
2312,金寶,2601,724,1877,摩根大通,2024-10-09,8440
2905,三商,2004,270,1734,摩根大通,2024-10-09,8440
2388,威盛,2248,536,1712,摩根大通,2024-10-09,8440
2449,京元電子,2137,443,1694,摩根大通,2024-10-09,8440
2520,冠德,2006,473,1533,摩根大通,2024-10-09,8440
2101,南港,1690,170,1520,摩根大通,2024-10-09,8440
2356,英業達,2294,873,1421,摩根大通,2024-10-09,8440
6757,台灣虎航,1521,103,1418,摩根大通,2024-10-09,8440
2884,玉山金,1753,393,1360,摩根大通,2024-10-09,8440
2382,廣達,2787,1430,1357,摩根大通,2024-10-09,8440
2882,國泰金,1632,333,1299,摩根大通,2024-10-09,8440
2330,台積電,2781,1602,1179,摩根大通,2024-10-09,8440
1442,名軒,1288,172,1116,摩根大通,2024-10-09,8440
2399,映泰,2232,1127,1105,摩根大通,2024-10-09,8440
2545,皇翔,1197,92,1105,摩根大通,2024-10-09,8440
2637,慧洋-KY,1444,499,945,摩根大通,2024-10-09,8440
3450,聯鈞,995,106,889,摩根大通,2024-10-09,8440
2362,藍天,1403,592,811,摩根大通,2024-10-09,8440
2615,萬海,945,141,804,摩根大通,2024-10-09,8440
1402,遠東新,922,160,762,摩根大通,2024-10-09,8440
3019,亞光,1056,297,759,摩根大通,2024-10-09,8440
2365,昆盈,759,39,720,摩根大通,2024-10-09,8440
6177,達麗,875,193,682,摩根大通,2024-10-09,8440
2353,宏��,1120,466,654,摩根大通,2024-10-09,8440
2605,新興,652,22,630,摩根大通,2024-10-09,8440
1736,喬山,651,82,569,摩根大通,2024-10-09,8440
1504,東元,760,213,547,摩根大通,2024-10-09,8440
2454,聯發科,714,211,503,摩根大通,2024-10-09,8440
2497,怡利電,560,61,499,摩根大通,2024-10-09,8440
2601,益航,590,111,479,摩根大通,2024-10-09,8440
9945,潤泰新,685,206,479,摩根大通,2024-10-09,8440
4510,高鋒,613,142,471,摩根大通,2024-10-09,8440
4909,新復興,722,271,451,摩根大通,2024-10-09,8440
1540,喬福,452,26,426,摩根大通,2024-10-09,8440
2458,義隆,466,77,389,摩根大通,2024-10-09,8440
2301,光寶科,575,214,361,摩根大通,2024-10-09,8440
3443,創意,439,106,333,摩根大通,2024-10-09,8440
1595,川寶,608,284,324,摩根大通,2024-10-09,8440
8028,昇陽半導體,562,242,320,摩根大通,2024-10-09,8440
2337,旺宏,846,548,298,摩根大通,2024-10-09,8440
4545,銘鈺,349,57,292,摩根大通,2024-10-09,8440
2882,國泰金,7187,348,6839,摩根大通,2024-10-11,8440
2317,鴻海,7293,2341,4952,摩根大通,2024-10-11,8440
2888,新光金,4059,423,3636,摩根大通,2024-10-11,8440
3231,緯創,3988,1860,2128,摩根大通,2024-10-11,8440
2362,藍天,2047,81,1966,摩根大通,2024-10-11,8440
2520,冠德,2030,192,1838,摩根大通,2024-10-11,8440
2399,映泰,2159,688,1471,摩根大通,2024-10-11,8440
2330,台積電,2746,1639,1107,摩根大通,2024-10-11,8440
2353,宏��,1188,232,956,摩根大通,2024-10-11,8440
2618,長榮航,2419,1463,956,摩根大通,2024-10-11,8440
2049,上銀,1025,125,900,摩根大通,2024-10-11,8440
2458,義隆,966,83,883,摩根大通,2024-10-11,8440
4958,臻鼎-KY,1434,567,867,摩根大通,2024-10-11,8440
3045,台灣大,877,31,846,摩根大通,2024-10-11,8440
2834,臺企銀,997,188,809,摩根大通,2024-10-11,8440
2609,陽明,1304,516,788,摩根大通,2024-10-11,8440
2489,瑞軒,788,9,779,摩根大通,2024-10-11,8440
3163,波若威,799,115,684,摩根大通,2024-10-11,8440
2637,慧洋-KY,1079,405,674,摩根大通,2024-10-11,8440
5876,上海商銀,863,257,606,摩根大通,2024-10-11,8440
3019,亞光,825,255,570,摩根大通,2024-10-11,8440
3209,全科,692,136,556,摩根大通,2024-10-11,8440
2610,華航,697,160,537,摩根大通,2024-10-11,8440
2497,怡利電,529,14,515,摩根大通,2024-10-11,8440
3293,鈊象,658,150,508,摩根大通,2024-10-11,8440
3017,奇鋐,850,346,504,摩根大通,2024-10-11,8440
2347,聯強,695,225,470,摩根大通,2024-10-11,8440
2543,皇昌,885,422,463,摩根大通,2024-10-11,8440
1504,東元,652,199,453,摩根大通,2024-10-11,8440
1569,濱川,545,94,451,摩根大通,2024-10-11,8440
3024,憶聲,521,82,439,摩根大通,2024-10-11,8440
2367,燿華,515,80,435,摩根大通,2024-10-11,8440
4938,和碩,484,53,431,摩根大通,2024-10-11,8440
3324,雙鴻,503,77,426,摩根大通,2024-10-11,8440
3234,光環,564,139,425,摩根大通,2024-10-11,8440
3036,文曄,623,198,425,摩根大通,2024-10-11,8440
3033,威健,496,74,422,摩根大通,2024-10-11,8440
1101,台泥,898,490,408,摩根大通,2024-10-11,8440
1584,精剛,453,50,403,摩根大通,2024-10-11,8440
2365,昆盈,416,27,389,摩根大通,2024-10-11,8440
3363,上詮,625,239,386,摩根大通,2024-10-11,8440
2371,大同,401,24,377,摩根大通,2024-10-11,8440
6425,易發,779,416,363,摩根大通,2024-10-11,8440
2421,建準,389,26,363,摩根大通,2024-10-11,8440
2426,鼎元,497,141,356,摩根大通,2024-10-11,8440
3047,訊舟,362,9,353,摩根大通,2024-10-11,8440
3535,晶彩科,471,122,349,摩根大通,2024-10-11,8440
3710,連展投控,1355,1009,346,摩根大通,2024-10-11,8440
2515,中工,339,0,339,摩根大通,2024-10-11,8440
2357,華碩,483,180,303,摩根大通,2024-10-11,8440
3062,建漢,2211,79,2132,摩根大通,2024-10-14,8440
2323,中環,1844,80,1764,摩根大通,2024-10-14,8440
2303,聯電,3083,1387,1696,摩根大通,2024-10-14,8440
2889,國票金,2007,334,1673,摩根大通,2024-10-14,8440
2610,華航,1468,2,1466,摩根大通,2024-10-14,8440
4979,華星光,1401,83,1318,摩根大通,2024-10-14,8440
6116,彩晶,1223,12,1211,摩根大通,2024-10-14,8440
3605,宏致,1139,3,1136,摩根大通,2024-10-14,8440
2887,台新金,1331,332,999,摩根大通,2024-10-14,8440
3591,艾笛森,922,241,681,摩根大通,2024-10-14,8440
2637,慧洋-KY,753,73,680,摩根大通,2024-10-14,8440
4956,光鋐,900,283,617,摩根大通,2024-10-14,8440
2891,中信金,3262,2666,596,摩根大通,2024-10-14,8440
2330,台積電,1967,1382,585,摩根大通,2024-10-14,8440
2349,錸德,653,72,581,摩根大通,2024-10-14,8440
3711,日月光投控,795,254,541,摩根大通,2024-10-14,8440
6177,達麗,698,169,529,摩根大通,2024-10-14,8440
3702,大聯大,655,148,507,摩根大通,2024-10-14,8440
8028,昇陽半導體,578,84,494,摩根大通,2024-10-14,8440
2489,瑞軒,504,21,483,摩根大通,2024-10-14,8440
5905,南仁湖,918,437,481,摩根大通,2024-10-14,8440
3615,安可,485,23,462,摩根大通,2024-10-14,8440
4908,前鼎,474,42,432,摩根大通,2024-10-14,8440
1216,統一,783,369,414,摩根大通,2024-10-14,8440
4991,環宇-KY,702,289,413,摩根大通,2024-10-14,8440
3049,精金,525,121,404,摩根大通,2024-10-14,8440
3149,正達,837,435,402,摩根大通,2024-10-14,8440
2497,怡利電,476,90,386,摩根大通,2024-10-14,8440
2515,中工,383,6,377,摩根大通,2024-10-14,8440
5452,佶優,709,333,376,摩根大通,2024-10-14,8440
2301,光寶科,373,8,365,摩根大通,2024-10-14,8440
2308,台達電,527,162,365,摩根大通,2024-10-14,8440
5014,建錩,366,3,363,摩根大通,2024-10-14,8440
1569,濱川,382,22,360,摩根大通,2024-10-14,8440
2352,佳世達,420,64,356,摩根大通,2024-10-14,8440
2880,華南金,754,401,353,摩根大通,2024-10-14,8440
2357,華碩,466,117,349,摩根大通,2024-10-14,8440
6770,力積電,396,48,348,摩根大通,2024-10-14,8440
8111,立��,733,396,337,摩根大通,2024-10-14,8440
9904,寶成,451,115,336,摩根大通,2024-10-14,8440
1402,遠東新,556,222,334,摩根大通,2024-10-14,8440
2425,承啟,432,100,332,摩根大通,2024-10-14,8440
2890,永豐金,972,640,332,摩根大通,2024-10-14,8440
3025,星通,738,408,330,摩根大通,2024-10-14,8440
2408,南亞科,576,248,328,摩根大通,2024-10-14,8440
2897,王道銀行,330,6,324,摩根大通,2024-10-14,8440
3710,連展投控,1822,1501,321,摩根大通,2024-10-14,8440
1802,台玻,535,214,321,摩根大通,2024-10-14,8440
9914,美利達,327,14,313,摩根大通,2024-10-14,8440
2892,第一金,347,44,303,摩根大通,2024-10-14,8440
2883,凱基金,21651,642,21009,摩根大通,2024-10-15,8440
2317,鴻海,13316,3002,10314,摩根大通,2024-10-15,8440
2888,新光金,6252,717,5535,摩根大通,2024-10-15,8440
2882,國泰金,5975,569,5406,摩根大通,2024-10-15,8440
2313,華通,6397,2187,4210,摩根大通,2024-10-15,8440
2887,台新金,5221,1881,3340,摩根大通,2024-10-15,8440
9105,泰金寶-DR,2287,297,1990,摩根大通,2024-10-15,8440
2303,聯電,3650,1710,1940,摩根大通,2024-10-15,8440
3062,建漢,2247,373,1874,摩根大通,2024-10-15,8440
2609,陽明,1727,203,1524,摩根大通,2024-10-15,8440
2603,長榮,1542,122,1420,摩根大通,2024-10-15,8440
2382,廣達,2984,1866,1118,摩根大通,2024-10-15,8440
4903,聯光通,1504,535,969,摩根大通,2024-10-15,8440
2891,中信金,2909,1967,942,摩根大通,2024-10-15,8440
2610,華航,1310,401,909,摩根大通,2024-10-15,8440
5452,佶優,2694,1785,909,摩根大通,2024-10-15,8440
3450,聯鈞,1081,252,829,摩根大通,2024-10-15,8440
2356,英業達,1697,902,795,摩根大通,2024-10-15,8440
2312,金寶,1207,509,698,摩根大通,2024-10-15,8440
2489,瑞軒,672,10,662,摩根大通,2024-10-15,8440
1504,東元,871,220,651,摩根大通,2024-10-15,8440
3498,陽程,998,356,642,摩根大通,2024-10-15,8440
2637,慧洋-KY,650,27,623,摩根大通,2024-10-15,8440
3711,日月光投控,1473,858,615,摩根大通,2024-10-15,8440
2308,台達電,1281,717,564,摩根大通,2024-10-15,8440
2323,中環,758,201,557,摩根大通,2024-10-15,8440
8111,立��,988,435,553,摩根大通,2024-10-15,8440
2353,宏��,654,115,539,摩根大通,2024-10-15,8440
2301,光寶科,703,165,538,摩根大通,2024-10-15,8440
3702,大聯大,1595,1060,535,摩根大通,2024-10-15,8440
8210,勤誠,565,44,521,摩根大通,2024-10-15,8440
3049,精金,637,172,465,摩根大通,2024-10-15,8440
4909,新復興,504,50,454,摩根大通,2024-10-15,8440
2393,億光,505,67,438,摩根大通,2024-10-15,8440
2458,義隆,450,13,437,摩根大通,2024-10-15,8440
6830,汎銓,714,282,432,摩根大通,2024-10-15,8440
4729,熒茂,558,129,429,摩根大通,2024-10-15,8440
3042,晶技,427,6,421,摩根大通,2024-10-15,8440
3230,錦明,651,236,415,摩根大通,2024-10-15,8440
2601,益航,572,161,411,摩根大通,2024-10-15,8440
2344,華邦電,1427,1022,405,摩根大通,2024-10-15,8440
1560,中砂,543,154,389,摩根大通,2024-10-15,8440
3017,奇鋐,1070,689,381,摩根大通,2024-10-15,8440
6442,光聖,624,246,378,摩根大通,2024-10-15,8440
3447,展達,555,186,369,摩根大通,2024-10-15,8440
2357,華碩,483,116,367,摩根大通,2024-10-15,8440
2354,鴻準,489,149,340,摩根大通,2024-10-15,8440
3605,宏致,376,46,330,摩根大通,2024-10-15,8440
2337,旺宏,567,248,319,摩根大通,2024-10-15,8440
3706,神達,368,51,317,摩根大通,2024-10-15,8440
2317,鴻海,13619,3561,10058,摩根大通,2024-10-16,8440
2399,映泰,5150,513,4637,摩根大通,2024-10-16,8440
2883,凱基金,9480,5702,3778,摩根大通,2024-10-16,8440
2888,新光金,5405,2231,3174,摩根大通,2024-10-16,8440
2610,華航,4326,1246,3080,摩根大通,2024-10-16,8440
2312,金寶,3541,771,2770,摩根大通,2024-10-16,8440
2303,聯電,7617,4892,2725,摩根大通,2024-10-16,8440
2890,永豐金,3613,1374,2239,摩根大通,2024-10-16,8440
3231,緯創,2808,684,2124,摩根大通,2024-10-16,8440
2353,宏��,3296,1270,2026,摩根大通,2024-10-16,8440
3062,建漢,2724,785,1939,摩根大通,2024-10-16,8440
2618,長榮航,5838,3937,1901,摩根大通,2024-10-16,8440
3702,大聯大,2737,995,1742,摩根大通,2024-10-16,8440
2603,長榮,1826,722,1104,摩根大通,2024-10-16,8440
3710,連展投控,1961,913,1048,摩根大通,2024-10-16,8440
2382,廣達,1859,924,935,摩根大通,2024-10-16,8440
2449,京元電子,2108,1304,804,摩根大通,2024-10-16,8440
2421,建準,891,95,796,摩根大通,2024-10-16,8440
6763,綠界科技*,946,193,753,摩根大通,2024-10-16,8440
5347,世界,991,282,709,摩根大通,2024-10-16,8440
3013,晟銘電,960,317,643,摩根大通,2024-10-16,8440
2337,旺宏,1138,516,622,摩根大通,2024-10-16,8440
2412,中華電,1319,706,613,摩根大通,2024-10-16,8440
2323,中環,826,301,525,摩根大通,2024-10-16,8440
6134,萬旭,738,219,519,摩根大通,2024-10-16,8440
3209,全科,793,278,515,摩根大通,2024-10-16,8440
4729,熒茂,572,92,480,摩根大通,2024-10-16,8440
3714,富采,661,207,454,摩根大通,2024-10-16,8440
6609,瀧澤科,875,450,425,摩根大通,2024-10-16,8440
3293,鈊象,460,63,397,摩根大通,2024-10-16,8440
6890,來億-KY,415,32,383,摩根大通,2024-10-16,8440
6125,廣運,478,114,364,摩根大通,2024-10-16,8440
2637,慧洋-KY,744,382,362,摩根大通,2024-10-16,8440
3615,安可,427,72,355,摩根大通,2024-10-16,8440
2357,華碩,559,209,350,摩根大通,2024-10-16,8440
4938,和碩,1067,736,331,摩根大通,2024-10-16,8440
9938,百和,423,96,327,摩根大通,2024-10-16,8440
6187,萬潤,532,214,318,摩根大通,2024-10-16,8440
2360,致茂,550,235,315,摩根大通,2024-10-16,8440
1301,台塑,1225,919,306,摩根大通,2024-10-16,8440
2454,聯發科,673,369,304,摩根大通,2024-10-16,8440
1722,台肥,787,485,302,摩根大通,2024-10-16,8440
4903,聯光通,558,261,297,摩根大通,2024-10-16,8440
4576,大銀微系統,420,140,280,摩根大通,2024-10-16,8440
6658,聯策,995,716,279,摩根大通,2024-10-16,8440
8210,勤誠,352,88,264,摩根大通,2024-10-16,8440
3227,原相,364,110,254,摩根大通,2024-10-16,8440
8111,立��,403,158,245,摩根大通,2024-10-16,8440
1721,三晃,516,282,234,摩根大通,2024-10-16,8440
5230,雷笛克光學,318,90,228,摩根大通,2024-10-16,8440
2883,凱基金,15038,2331,12707,摩根大通,2024-10-17,8440
3481,群創,9517,557,8960,摩根大通,2024-10-17,8440
2312,金寶,9733,3128,6605,摩根大通,2024-10-17,8440
9105,泰金寶-DR,4630,354,4276,摩根大通,2024-10-17,8440
2409,友達,4074,619,3455,摩根大通,2024-10-17,8440
2618,長榮航,3354,774,2580,摩根大通,2024-10-17,8440
2303,聯電,3534,1038,2496,摩根大通,2024-10-17,8440
2610,華航,2335,500,1835,摩根大通,2024-10-17,8440
3231,緯創,2144,639,1505,摩根大通,2024-10-17,8440
6116,彩晶,1443,125,1318,摩根大通,2024-10-17,8440
2402,毅嘉,1658,380,1278,摩根大通,2024-10-17,8440
1216,統一,1740,477,1263,摩根大通,2024-10-17,8440
2887,台新金,1246,123,1123,摩根大通,2024-10-17,8440
2353,宏��,1500,377,1123,摩根大通,2024-10-17,8440
1402,遠東新,1134,148,986,摩根大通,2024-10-17,8440
9904,寶成,1141,161,980,摩根大通,2024-10-17,8440
2308,台達電,1351,411,940,摩根大通,2024-10-17,8440
4566,時碩工業,915,44,871,摩根大通,2024-10-17,8440
2609,陽明,904,133,771,摩根大通,2024-10-17,8440
2352,佳世達,751,9,742,摩根大通,2024-10-17,8440
4763,材料-KY,755,22,733,摩根大通,2024-10-17,8440
3711,日月光投控,1228,507,721,摩根大通,2024-10-17,8440
2301,光寶科,842,198,644,摩根大通,2024-10-17,8440
2603,長榮,1831,1200,631,摩根大通,2024-10-17,8440
3056,富華新,677,53,624,摩根大通,2024-10-17,8440
1721,三晃,992,397,595,摩根大通,2024-10-17,8440
2615,萬海,1169,576,593,摩根大通,2024-10-17,8440
6770,力積電,1169,608,561,摩根大通,2024-10-17,8440
2408,南亞科,766,216,550,摩根大通,2024-10-17,8440
5871,中租-KY,581,32,549,摩根大通,2024-10-17,8440
2888,新光金,834,300,534,摩根大通,2024-10-17,8440
5347,世界,670,140,530,摩根大通,2024-10-17,8440
2845,遠東銀,576,48,528,摩根大通,2024-10-17,8440
2313,華通,779,264,515,摩根大通,2024-10-17,8440
3702,大聯大,948,445,503,摩根大通,2024-10-17,8440
2347,聯強,641,139,502,摩根大通,2024-10-17,8440
1504,東元,799,303,496,摩根大通,2024-10-17,8440
3013,晟銘電,1584,1090,494,摩根大通,2024-10-17,8440
6133,金橋,530,61,469,摩根大通,2024-10-17,8440
1711,永光,795,359,436,摩根大通,2024-10-17,8440
2881,富邦金,1693,1278,415,摩根大通,2024-10-17,8440
1326,台化,667,269,398,摩根大通,2024-10-17,8440
3049,精金,492,95,397,摩根大通,2024-10-17,8440
2515,中工,521,134,387,摩根大通,2024-10-17,8440
2344,華邦電,774,387,387,摩根大通,2024-10-17,8440
2374,佳能,483,125,358,摩根大通,2024-10-17,8440
2379,瑞昱,731,393,338,摩根大通,2024-10-17,8440
2354,鴻準,394,61,333,摩根大通,2024-10-17,8440
3037,欣興,358,39,319,摩根大通,2024-10-17,8440
4938,和碩,410,93,317,摩根大通,2024-10-17,8440
2330,台積電,12959,2457,10502,摩根大通,2024-10-18,8440
2881,富邦金,10447,134,10313,摩根大通,2024-10-18,8440
2883,凱基金,12046,2304,9742,摩根大通,2024-10-18,8440
3481,群創,7984,87,7897,摩根大通,2024-10-18,8440
2892,第一金,5595,92,5503,摩根大通,2024-10-18,8440
2891,中信金,6380,983,5397,摩根大通,2024-10-18,8440
2618,長榮航,5879,585,5294,摩根大通,2024-10-18,8440
2890,永豐金,4440,624,3816,摩根大通,2024-10-18,8440
2382,廣達,4980,1258,3722,摩根大通,2024-10-18,8440
2880,華南金,3750,98,3652,摩根大通,2024-10-18,8440
2308,台達電,3540,286,3254,摩根大通,2024-10-18,8440
2882,國泰金,3215,453,2762,摩根大通,2024-10-18,8440
2317,鴻海,10274,7559,2715,摩根大通,2024-10-18,8440
2885,元大金,2607,179,2428,摩根大通,2024-10-18,8440
2887,台新金,3024,608,2416,摩根大通,2024-10-18,8440
2884,玉山金,4668,2418,2250,摩根大通,2024-10-18,8440
2801,彰銀,1995,163,1832,摩根大通,2024-10-18,8440
2886,兆豐金,2259,535,1724,摩根大通,2024-10-18,8440
2609,陽明,2101,392,1709,摩根大通,2024-10-18,8440
2610,華航,1758,171,1587,摩根大通,2024-10-18,8440
1101,台泥,1621,336,1285,摩根大通,2024-10-18,8440
4576,大銀微系統,1324,55,1269,摩根大通,2024-10-18,8440
1711,永光,1618,363,1255,摩根大通,2024-10-18,8440
2834,臺企銀,1808,693,1115,摩根大通,2024-10-18,8440
3702,大聯大,1199,164,1035,摩根大通,2024-10-18,8440
6505,台塑化,1231,197,1034,摩根大通,2024-10-18,8440
2409,友達,1437,436,1001,摩根大通,2024-10-18,8440
5880,合庫金,1023,92,931,摩根大通,2024-10-18,8440
6116,彩晶,920,27,893,摩根大通,2024-10-18,8440
4938,和碩,877,58,819,摩根大通,2024-10-18,8440
4904,遠傳,916,130,786,摩根大通,2024-10-18,8440
1504,東元,1199,481,718,摩根大通,2024-10-18,8440
1303,南亞,807,105,702,摩根大通,2024-10-18,8440
2421,建準,973,283,690,摩根大通,2024-10-18,8440
1102,亞泥,711,31,680,摩根大通,2024-10-18,8440
1216,統一,986,333,653,摩根大通,2024-10-18,8440
9945,潤泰新,603,27,576,摩根大通,2024-10-18,8440
8069,元太,675,122,553,摩根大通,2024-10-18,8440
2888,新光金,605,71,534,摩根大通,2024-10-18,8440
5871,中租-KY,549,31,518,摩根大通,2024-10-18,8440
1402,遠東新,672,163,509,摩根大通,2024-10-18,8440
9938,百和,547,46,501,摩根大通,2024-10-18,8440
3062,建漢,797,303,494,摩根大通,2024-10-18,8440
3011,今皓,738,256,482,摩根大通,2024-10-18,8440
2603,長榮,1004,539,465,摩根大通,2024-10-18,8440
2449,京元電子,627,167,460,摩根大通,2024-10-18,8440
1540,喬福,644,206,438,摩根大通,2024-10-18,8440
2356,英業達,1818,1392,426,摩根大通,2024-10-18,8440
1605,華新,1255,833,422,摩根大通,2024-10-18,8440
3615,安可,655,236,419,摩根大通,2024-10-18,8440
3711,日月光投控,3851,81,3770,摩根大通,2024-10-21,8440
2609,陽明,2256,403,1853,摩根大通,2024-10-21,8440
2610,華航,1764,190,1574,摩根大通,2024-10-21,8440
2330,台積電,4080,2852,1228,摩根大通,2024-10-21,8440
2388,威盛,1563,415,1148,摩根大通,2024-10-21,8440
3231,緯創,1216,292,924,摩根大通,2024-10-21,8440
3037,欣興,1115,231,884,摩根大通,2024-10-21,8440
2449,京元電子,1105,229,876,摩根大通,2024-10-21,8440
4576,大銀微系統,1116,283,833,摩根大通,2024-10-21,8440
5347,世界,864,40,824,摩根大通,2024-10-21,8440
2367,燿華,957,150,807,摩根大通,2024-10-21,8440
2615,萬海,815,80,735,摩根大通,2024-10-21,8440
1504,東元,932,243,689,摩根大通,2024-10-21,8440
2374,佳能,800,174,626,摩根大通,2024-10-21,8440
6116,彩晶,639,37,602,摩根大通,2024-10-21,8440
1402,遠東新,699,109,590,摩根大通,2024-10-21,8440
4533,協易機,514,19,495,摩根大通,2024-10-21,8440
2313,華通,840,360,480,摩根大通,2024-10-21,8440
3710,連展投控,657,192,465,摩根大通,2024-10-21,8440
2329,華泰,452,4,448,摩根大通,2024-10-21,8440
3293,鈊象,571,153,418,摩根大通,2024-10-21,8440
2324,仁寶,587,194,393,摩根大通,2024-10-21,8440
3189,景碩,568,175,393,摩根大通,2024-10-21,8440
6104,創惟,434,45,389,摩根大通,2024-10-21,8440
2458,義隆,379,6,373,摩根大通,2024-10-21,8440
2543,皇昌,467,102,365,摩根大通,2024-10-21,8440
2357,華碩,454,118,336,摩根大通,2024-10-21,8440
6698,旭暉應材,344,18,326,摩根大通,2024-10-21,8440
8064,東捷,493,173,320,摩根大通,2024-10-21,8440
2379,瑞昱,415,96,319,摩根大通,2024-10-21,8440
2603,長榮,864,549,315,摩根大通,2024-10-21,8440
9904,寶成,639,336,303,摩根大通,2024-10-21,8440
1513,中興電,339,37,302,摩根大通,2024-10-21,8440
2453,凌群,404,105,299,摩根大通,2024-10-21,8440
4123,晟德,290,21,269,摩根大通,2024-10-21,8440
2401,凌陽,275,9,266,摩根大通,2024-10-21,8440
2354,鴻準,368,103,265,摩根大通,2024-10-21,8440
1802,台玻,1157,895,262,摩根大通,2024-10-21,8440
3673,TPK-KY,263,2,261,摩根大通,2024-10-21,8440
5534,長虹,336,82,254,摩根大通,2024-10-21,8440
4915,致伸,254,1,253,摩根大通,2024-10-21,8440
6274,台燿,285,40,245,摩根大通,2024-10-21,8440
2406,國碩,265,25,240,摩根大通,2024-10-21,8440
9938,百和,280,46,234,摩根大通,2024-10-21,8440
5871,中租-KY,325,97,228,摩根大通,2024-10-21,8440
6127,九豪,350,123,227,摩根大通,2024-10-21,8440
1303,南亞,762,547,215,摩根大通,2024-10-21,8440
6120,達運,217,7,210,摩根大通,2024-10-21,8440
6695,芯鼎,251,45,206,摩根大通,2024-10-21,8440
2353,宏��,1055,850,205,摩根大通,2024-10-21,8440
2317,鴻海,8581,5139,3442,摩根大通,2024-10-22,8440
3481,群創,3138,725,2413,摩根大通,2024-10-22,8440
3231,緯創,4053,1778,2275,摩根大通,2024-10-22,8440
2881,富邦金,2663,438,2225,摩根大通,2024-10-22,8440
3037,欣興,2795,572,2223,摩根大通,2024-10-22,8440
2610,華航,2775,596,2179,摩根大通,2024-10-22,8440
2618,長榮航,2247,378,1869,摩根大通,2024-10-22,8440
2367,燿華,2014,174,1840,摩根大通,2024-10-22,8440
2882,國泰金,2513,694,1819,摩根大通,2024-10-22,8440
2399,映泰,2679,1024,1655,摩根大通,2024-10-22,8440
2324,仁寶,2231,631,1600,摩根大通,2024-10-22,8440
2409,友達,1776,452,1324,摩根大通,2024-10-22,8440
2353,宏��,1101,147,954,摩根大通,2024-10-22,8440
3711,日月光投控,1325,492,833,摩根大通,2024-10-22,8440
2603,長榮,2368,1620,748,摩根大通,2024-10-22,8440
2368,金像電,939,222,717,摩根大通,2024-10-22,8440
00919,群益台灣精選高息,687,0,687,摩根大通,2024-10-22,8440
2449,京元電子,1350,668,682,摩根大通,2024-10-22,8440
3450,聯鈞,782,159,623,摩根大通,2024-10-22,8440
6116,彩晶,573,16,557,摩根大通,2024-10-22,8440
2888,新光金,1005,461,544,摩根大通,2024-10-22,8440
2312,金寶,1407,898,509,摩根大通,2024-10-22,8440
4716,大立,758,258,500,摩根大通,2024-10-22,8440
5871,中租-KY,546,70,476,摩根大通,2024-10-22,8440
1597,直得,607,172,435,摩根大通,2024-10-22,8440
2357,華碩,586,201,385,摩根大通,2024-10-22,8440
2886,兆豐金,706,325,381,摩根大通,2024-10-22,8440
2855,統一證,543,173,370,摩根大通,2024-10-22,8440
1102,亞泥,463,95,368,摩根大通,2024-10-22,8440
2486,一詮,422,69,353,摩根大通,2024-10-22,8440
3706,神達,350,7,343,摩根大通,2024-10-22,8440
4532,瑞智,337,2,335,摩根大通,2024-10-22,8440
3715,定穎投控,787,460,327,摩根大通,2024-10-22,8440
6505,台塑化,706,390,316,摩根大通,2024-10-22,8440
3189,景碩,1480,1165,315,摩根大通,2024-10-22,8440
3702,大聯大,501,191,310,摩根大通,2024-10-22,8440
8150,南茂,316,6,310,摩根大通,2024-10-22,8440
2211,長榮鋼,362,58,304,摩根大通,2024-10-22,8440
4576,大銀微系統,452,148,304,摩根大通,2024-10-22,8440
6805,富世達,325,23,302,摩根大通,2024-10-22,8440
1216,統一,495,197,298,摩根大通,2024-10-22,8440
4977,眾達-KY,344,64,280,摩根大通,2024-10-22,8440
2301,光寶科,342,66,276,摩根大通,2024-10-22,8440
2504,國產,341,66,275,摩根大通,2024-10-22,8440
3036,文曄,294,34,260,摩根大通,2024-10-22,8440
3045,台灣大,317,66,251,摩根大通,2024-10-22,8440
4938,和碩,311,68,243,摩根大通,2024-10-22,8440
2393,億光,254,22,232,摩根大通,2024-10-22,8440
2379,瑞昱,391,160,231,摩根大通,2024-10-22,8440
6274,台燿,405,175,230,摩根大通,2024-10-22,8440
2888,新光金,8064,280,7784,摩根大通,2024-10-23,8440
1101,台泥,4783,967,3816,摩根大通,2024-10-23,8440
2330,台積電,3474,1072,2402,摩根大通,2024-10-23,8440
2303,聯電,3641,1305,2336,摩根大通,2024-10-23,8440
2610,華航,2036,279,1757,摩根大通,2024-10-23,8440
8069,元太,1417,126,1291,摩根大通,2024-10-23,8440
3037,欣興,2752,1481,1271,摩根大通,2024-10-23,8440
3290,東浦,1739,539,1200,摩根大通,2024-10-23,8440
6197,佳必琪,1232,62,1170,摩根大通,2024-10-23,8440
2881,富邦金,1509,340,1169,摩根大通,2024-10-23,8440
3481,群創,2079,992,1087,摩根大通,2024-10-23,8440
3711,日月光投控,1797,731,1066,摩根大通,2024-10-23,8440
2393,億光,1181,177,1004,摩根大通,2024-10-23,8440
2882,國泰金,1319,507,812,摩根大通,2024-10-23,8440
2449,京元電子,957,188,769,摩根大通,2024-10-23,8440
1102,亞泥,801,106,695,摩根大通,2024-10-23,8440
2801,彰銀,1927,1262,665,摩根大通,2024-10-23,8440
2399,映泰,1298,670,628,摩根大通,2024-10-23,8440
2603,長榮,1175,562,613,摩根大通,2024-10-23,8440
3227,原相,673,66,607,摩根大通,2024-10-23,8440
2609,陽明,1304,722,582,摩根大通,2024-10-23,8440
3045,台灣大,695,142,553,摩根大通,2024-10-23,8440
8070,長華*,576,37,539,摩根大通,2024-10-23,8440
1519,華城,620,87,533,摩根大通,2024-10-23,8440
3030,德律,545,34,511,摩根大通,2024-10-23,8440
2890,永豐金,1344,848,496,摩根大通,2024-10-23,8440
2481,強茂,520,49,471,摩根大通,2024-10-23,8440
1808,潤隆,504,43,461,摩根大通,2024-10-23,8440
5202,力新,561,105,456,摩根大通,2024-10-23,8440
3033,威健,437,10,427,摩根大通,2024-10-23,8440
8210,勤誠,553,127,426,摩根大通,2024-10-23,8440
3013,晟銘電,804,408,396,摩根大通,2024-10-23,8440
1582,信錦,471,96,375,摩根大通,2024-10-23,8440
6116,彩晶,772,400,372,摩根大通,2024-10-23,8440
2301,光寶科,865,493,372,摩根大通,2024-10-23,8440
3450,聯鈞,570,207,363,摩根大通,2024-10-23,8440
2409,友達,899,538,361,摩根大通,2024-10-23,8440
2515,中工,570,212,358,摩根大通,2024-10-23,8440
3673,TPK-KY,458,134,324,摩根大通,2024-10-23,8440
1504,東元,738,444,294,摩根大通,2024-10-23,8440
6120,達運,362,87,275,摩根大通,2024-10-23,8440
3605,宏致,272,2,270,摩根大通,2024-10-23,8440
2474,可成,364,105,259,摩根大通,2024-10-23,8440
3042,晶技,283,26,257,摩根大通,2024-10-23,8440
2915,潤泰全,299,47,252,摩根大通,2024-10-23,8440
2323,中環,240,5,235,摩根大通,2024-10-23,8440
5425,台半,386,163,223,摩根大通,2024-10-23,8440
6147,頎邦,307,89,218,摩根大通,2024-10-23,8440
2504,國產,377,159,218,摩根大通,2024-10-23,8440
6127,九豪,264,47,217,摩根大通,2024-10-23,8440
2354,鴻準,7251,856,6395,摩根大通,2024-10-24,8440
2610,華航,6790,452,6338,摩根大通,2024-10-24,8440
2330,台積電,4903,1003,3900,摩根大通,2024-10-24,8440
2618,長榮航,4365,1305,3060,摩根大通,2024-10-24,8440
2382,廣達,3713,1231,2482,摩根大通,2024-10-24,8440
3037,欣興,3526,1150,2376,摩根大通,2024-10-24,8440
9938,百和,1382,122,1260,摩根大通,2024-10-24,8440
2891,中信金,4370,3334,1036,摩根大通,2024-10-24,8440
5876,上海商銀,1402,384,1018,摩根大通,2024-10-24,8440
2881,富邦金,1683,884,799,摩根大通,2024-10-24,8440
6505,台塑化,1923,1174,749,摩根大通,2024-10-24,8440
2543,皇昌,1369,671,698,摩根大通,2024-10-24,8440
1102,亞泥,1129,488,641,摩根大通,2024-10-24,8440
8210,勤誠,731,110,621,摩根大通,2024-10-24,8440
2393,億光,675,58,617,摩根大通,2024-10-24,8440
1216,統一,1282,713,569,摩根大通,2024-10-24,8440
3045,台灣大,566,23,543,摩根大通,2024-10-24,8440
1504,東元,811,287,524,摩根大通,2024-10-24,8440
3030,德律,571,53,518,摩根大通,2024-10-24,8440
1326,台化,1287,803,484,摩根大通,2024-10-24,8440
1301,台塑,1127,698,429,摩根大通,2024-10-24,8440
1477,聚陽,513,88,425,摩根大通,2024-10-24,8440
6531,愛普*,518,121,397,摩根大通,2024-10-24,8440
4938,和碩,641,253,388,摩根大通,2024-10-24,8440
3013,晟銘電,717,365,352,摩根大通,2024-10-24,8440
5452,佶優,494,149,345,摩根大通,2024-10-24,8440
4906,正文,370,36,334,摩根大通,2024-10-24,8440
2308,台達電,663,340,323,摩根大通,2024-10-24,8440
5438,東友,483,162,321,摩根大通,2024-10-24,8440
1314,中石化,527,211,316,摩根大通,2024-10-24,8440
1808,潤隆,444,138,306,摩根大通,2024-10-24,8440
2412,中華電,450,151,299,摩根大通,2024-10-24,8440
6177,達麗,314,27,287,摩根大通,2024-10-24,8440
4977,眾達-KY,279,6,273,摩根大通,2024-10-24,8440
2912,統一超,430,170,260,摩根大通,2024-10-24,8440
3596,智易,302,53,249,摩根大通,2024-10-24,8440
6806,森崴能源,276,43,233,摩根大通,2024-10-24,8440
6285,啟��,378,147,231,摩根大通,2024-10-24,8440
3293,鈊象,255,32,223,摩根大通,2024-10-24,8440
2324,仁寶,1457,1264,193,摩根大通,2024-10-24,8440
2301,光寶科,714,530,184,摩根大通,2024-10-24,8440
2727,王品,189,9,180,摩根大通,2024-10-24,8440
2504,國產,307,130,177,摩根大通,2024-10-24,8440
2537,聯上發,214,43,171,摩根大通,2024-10-24,8440
5508,永信建,178,7,171,摩根大通,2024-10-24,8440
2515,中工,276,105,171,摩根大通,2024-10-24,8440
2851,中再保,184,14,170,摩根大通,2024-10-24,8440
3380,明泰,254,87,167,摩根大通,2024-10-24,8440
3665,貿聯-KY,189,31,158,摩根大通,2024-10-24,8440
5536,聖暉*,204,48,156,摩根大通,2024-10-24,8440
2610,華航,4944,151,4793,摩根大通,2024-10-25,8440
3711,日月光投控,2602,201,2401,摩根大通,2024-10-25,8440
2454,聯發科,2407,143,2264,摩根大通,2024-10-25,8440
2354,鴻準,2709,660,2049,摩根大通,2024-10-25,8440
2324,仁寶,1852,45,1807,摩根大通,2024-10-25,8440
3019,亞光,2059,544,1515,摩根大通,2024-10-25,8440
2317,鴻海,3121,1648,1473,摩根大通,2024-10-25,8440
2637,慧洋-KY,1288,24,1264,摩根大通,2024-10-25,8440
2393,億光,1118,25,1093,摩根大通,2024-10-25,8440
3231,緯創,4363,3313,1050,摩根大通,2024-10-25,8440
2356,英業達,1524,560,964,摩根大通,2024-10-25,8440
2105,正新,865,17,848,摩根大通,2024-10-25,8440
2888,新光金,870,48,822,摩根大通,2024-10-25,8440
1808,潤隆,794,0,794,摩根大通,2024-10-25,8440
2890,永豐金,1506,742,764,摩根大通,2024-10-25,8440
1102,亞泥,853,155,698,摩根大通,2024-10-25,8440
2504,國產,690,12,678,摩根大通,2024-10-25,8440
5876,上海商銀,1071,463,608,摩根大通,2024-10-25,8440
6415,矽力*-KY,712,145,567,摩根大通,2024-10-25,8440
2382,廣達,964,399,565,摩根大通,2024-10-25,8440
1504,東元,758,221,537,摩根大通,2024-10-25,8440
3013,晟銘電,882,363,519,摩根大通,2024-10-25,8440
2439,美律,570,52,518,摩根大通,2024-10-25,8440
2204,中華,605,106,499,摩根大通,2024-10-25,8440
2606,裕民,809,311,498,摩根大通,2024-10-25,8440
2882,國泰金,596,99,497,摩根大通,2024-10-25,8440
2371,大同,476,85,391,摩根大通,2024-10-25,8440
2458,義隆,523,144,379,摩根大通,2024-10-25,8440
2344,華邦電,724,350,374,摩根大通,2024-10-25,8440
2915,潤泰全,386,14,372,摩根大通,2024-10-25,8440
3576,聯合再生,489,118,371,摩根大通,2024-10-25,8440
3062,建漢,738,378,360,摩根大通,2024-10-25,8440
6530,創威,428,78,350,摩根大通,2024-10-25,8440
6658,聯策,405,70,335,摩根大通,2024-10-25,8440
1519,華城,639,308,331,摩根大通,2024-10-25,8440
8464,億豐,337,23,314,摩根大通,2024-10-25,8440
2363,矽統,333,24,309,摩根大通,2024-10-25,8440
3030,德律,345,45,300,摩根大通,2024-10-25,8440
2495,普安,356,77,279,摩根大通,2024-10-25,8440
6177,達麗,306,48,258,摩根大通,2024-10-25,8440
6443,元晶,294,46,248,摩根大通,2024-10-25,8440
4576,大銀微系統,257,11,246,摩根大通,2024-10-25,8440
2345,智邦,1102,859,243,摩根大通,2024-10-25,8440
2301,光寶科,260,32,228,摩根大通,2024-10-25,8440
2486,一詮,304,92,212,摩根大通,2024-10-25,8440
1477,聚陽,235,32,203,摩根大通,2024-10-25,8440
1314,中石化,287,85,202,摩根大通,2024-10-25,8440
2357,華碩,311,118,193,摩根大通,2024-10-25,8440
6116,彩晶,422,229,193,摩根大通,2024-10-25,8440
3036,文曄,322,134,188,摩根大通,2024-10-25,8440
2618,長榮航,5177,452,4725,摩根大通,2024-10-28,8440
2888,新光金,3371,11,3360,摩根大通,2024-10-28,8440
3711,日月光投控,3065,223,2842,摩根大通,2024-10-28,8440
9904,寶成,2512,150,2362,摩根大通,2024-10-28,8440
2610,華航,3071,856,2215,摩根大通,2024-10-28,8440
2454,聯發科,2140,347,1793,摩根大通,2024-10-28,8440
1802,台玻,2925,1375,1550,摩根大通,2024-10-28,8440
1102,亞泥,1184,6,1178,摩根大通,2024-10-28,8440
2313,華通,1473,501,972,摩根大通,2024-10-28,8440
3450,聯鈞,961,48,913,摩根大通,2024-10-28,8440
2886,兆豐金,961,106,855,摩根大通,2024-10-28,8440
2105,正新,912,69,843,摩根大通,2024-10-28,8440
2393,億光,869,68,801,摩根大通,2024-10-28,8440
2890,永豐金,1903,1181,722,摩根大通,2024-10-28,8440
2439,美律,698,12,686,摩根大通,2024-10-28,8440
1216,統一,758,76,682,摩根大通,2024-10-28,8440
2324,仁寶,1607,940,667,摩根大通,2024-10-28,8440
2637,慧洋-KY,709,78,631,摩根大通,2024-10-28,8440
1101,台泥,1094,497,597,摩根大通,2024-10-28,8440
9914,美利達,624,65,559,摩根大通,2024-10-28,8440
2371,大同,696,152,544,摩根大通,2024-10-28,8440
6187,萬潤,488,0,488,摩根大通,2024-10-28,8440
3037,欣興,1598,1125,473,摩根大通,2024-10-28,8440
3481,群創,1088,638,450,摩根大通,2024-10-28,8440
2504,國產,538,91,447,摩根大通,2024-10-28,8440
2845,遠東銀,1032,601,431,摩根大通,2024-10-28,8440
2330,台積電,2529,2105,424,摩根大通,2024-10-28,8440
3045,台灣大,503,92,411,摩根大通,2024-10-28,8440
2308,台達電,1113,716,397,摩根大通,2024-10-28,8440
6415,矽力*-KY,433,38,395,摩根大通,2024-10-28,8440
1609,大亞,394,10,384,摩根大通,2024-10-28,8440
2458,義隆,459,76,383,摩根大通,2024-10-28,8440
2882,國泰金,542,162,380,摩根大通,2024-10-28,8440
1449,佳和,609,241,368,摩根大通,2024-10-28,8440
2023,燁輝,369,2,367,摩根大通,2024-10-28,8440
2352,佳世達,400,33,367,摩根大通,2024-10-28,8440
2915,潤泰全,382,23,359,摩根大通,2024-10-28,8440
3005,神基,391,47,344,摩根大通,2024-10-28,8440
9105,泰金寶-DR,402,66,336,摩根大通,2024-10-28,8440
2646,星宇航空,327,0,327,摩根大通,2024-10-28,8440
8111,立��,386,68,318,摩根大通,2024-10-28,8440
3714,富采,356,40,316,摩根大通,2024-10-28,8440
2204,中華,471,158,313,摩根大通,2024-10-28,8440
9945,潤泰新,356,58,298,摩根大通,2024-10-28,8440
4979,華星光,338,46,292,摩根大通,2024-10-28,8440
6116,彩晶,349,70,279,摩根大通,2024-10-28,8440
6177,達麗,349,74,275,摩根大通,2024-10-28,8440
5488,松普,815,542,273,摩根大通,2024-10-28,8440
4938,和碩,325,57,268,摩根大通,2024-10-28,8440
1477,聚陽,275,11,264,摩根大通,2024-10-28,8440
1802,台玻,6497,1759,4738,摩根大通,2024-10-29,8440
2337,旺宏,3090,202,2888,摩根大通,2024-10-29,8440
2618,長榮航,3534,1422,2112,摩根大通,2024-10-29,8440
3711,日月光投控,3594,1561,2033,摩根大通,2024-10-29,8440
006208,富邦台50,2000,0,2000,摩根大通,2024-10-29,8440
0056,元大高股息,2000,0,2000,摩根大通,2024-10-29,8440
2610,華航,3779,2077,1702,摩根大通,2024-10-29,8440
2637,慧洋-KY,1052,6,1046,摩根大通,2024-10-29,8440
2308,台達電,1874,1094,780,摩根大通,2024-10-29,8440
2399,映泰,1940,1210,730,摩根大通,2024-10-29,8440
2324,仁寶,1762,1143,619,摩根大通,2024-10-29,8440
6187,萬潤,629,18,611,摩根大通,2024-10-29,8440
2455,全新,568,77,491,摩根大通,2024-10-29,8440
2105,正新,774,338,436,摩根大通,2024-10-29,8440
5347,世界,989,583,406,摩根大通,2024-10-29,8440
2439,美律,469,68,401,摩根大通,2024-10-29,8440
5876,上海商銀,1464,1076,388,摩根大通,2024-10-29,8440
2393,億光,526,141,385,摩根大通,2024-10-29,8440
2312,金寶,383,26,357,摩根大通,2024-10-29,8440
3581,博磊,482,128,354,摩根大通,2024-10-29,8440
2431,聯昌,738,385,353,摩根大通,2024-10-29,8440
5202,力新,613,274,339,摩根大通,2024-10-29,8440
2458,義隆,389,59,330,摩根大通,2024-10-29,8440
1477,聚陽,348,24,324,摩根大通,2024-10-29,8440
2349,錸德,443,134,309,摩根大通,2024-10-29,8440
6415,矽力*-KY,414,107,307,摩根大通,2024-10-29,8440
2504,國產,515,218,297,摩根大通,2024-10-29,8440
3081,聯亞,621,372,249,摩根大通,2024-10-29,8440
3167,大量,558,311,247,摩根大通,2024-10-29,8440
5508,永信建,277,31,246,摩根大通,2024-10-29,8440
1449,佳和,1712,1471,241,摩根大通,2024-10-29,8440
6177,達麗,268,39,229,摩根大通,2024-10-29,8440
3049,精金,314,106,208,摩根大通,2024-10-29,8440
1102,亞泥,876,670,206,摩根大通,2024-10-29,8440
1560,中砂,252,54,198,摩根大通,2024-10-29,8440
5907,大洋-KY,281,84,197,摩根大通,2024-10-29,8440
3324,雙鴻,319,123,196,摩根大通,2024-10-29,8440
6176,瑞儀,232,39,193,摩根大通,2024-10-29,8440
6139,亞翔,208,19,189,摩根大通,2024-10-29,8440
6605,帝寶,208,21,187,摩根大通,2024-10-29,8440
3380,明泰,218,35,183,摩根大通,2024-10-29,8440
3715,定穎投控,325,144,181,摩根大通,2024-10-29,8440
6116,彩晶,465,284,181,摩根大通,2024-10-29,8440
3035,智原,219,40,179,摩根大通,2024-10-29,8440
2360,致茂,220,48,172,摩根大通,2024-10-29,8440
6223,旺矽,190,21,169,摩根大通,2024-10-29,8440
2382,廣達,1411,1242,169,摩根大通,2024-10-29,8440
3293,鈊象,228,62,166,摩根大通,2024-10-29,8440
8032,光菱,240,77,163,摩根大通,2024-10-29,8440
2537,聯上發,223,64,159,摩根大通,2024-10-29,8440
2354,鴻準,7144,2122,5022,摩根大通,2024-10-30,8440
00940,元大台灣價值高息,3737,0,3737,摩根大通,2024-10-30,8440
2882,國泰金,5689,2696,2993,摩根大通,2024-10-30,8440
2610,華航,3065,932,2133,摩根大通,2024-10-30,8440
2887,台新金,2488,505,1983,摩根大通,2024-10-30,8440
3037,欣興,3274,1338,1936,摩根大通,2024-10-30,8440
3711,日月光投控,3058,1313,1745,摩根大通,2024-10-30,8440
3013,晟銘電,1611,267,1344,摩根大通,2024-10-30,8440
2637,慧洋-KY,966,31,935,摩根大通,2024-10-30,8440
2308,台達電,2217,1297,920,摩根大通,2024-10-30,8440
2344,華邦電,1119,470,649,摩根大通,2024-10-30,8440
3047,訊舟,770,124,646,摩根大通,2024-10-30,8440
2606,裕民,818,203,615,摩根大通,2024-10-30,8440
5876,上海商銀,1676,1105,571,摩根大通,2024-10-30,8440
1102,亞泥,998,447,551,摩根大通,2024-10-30,8440
00713,元大台灣高息低波,509,0,509,摩根大通,2024-10-30,8440
9904,寶成,1580,1084,496,摩根大通,2024-10-30,8440
4977,眾達-KY,523,49,474,摩根大通,2024-10-30,8440
2458,義隆,521,50,471,摩根大通,2024-10-30,8440
3049,精金,524,66,458,摩根大通,2024-10-30,8440
2393,億光,461,17,444,摩根大通,2024-10-30,8440
2867,三商壽,614,208,406,摩根大通,2024-10-30,8440
2105,正新,686,304,382,摩根大通,2024-10-30,8440
1326,台化,711,361,350,摩根大通,2024-10-30,8440
2915,潤泰全,430,84,346,摩根大通,2024-10-30,8440
3450,聯鈞,598,269,329,摩根大通,2024-10-30,8440
1477,聚陽,332,17,315,摩根大通,2024-10-30,8440
6757,台灣虎航,318,17,301,摩根大通,2024-10-30,8440
2883B,凱基金乙特,291,0,291,摩根大通,2024-10-30,8440
2543,皇昌,362,74,288,摩根大通,2024-10-30,8440
2337,旺宏,2053,1778,275,摩根大通,2024-10-30,8440
3005,神基,304,29,275,摩根大通,2024-10-30,8440
00919,群益台灣精選高息,611,346,265,摩根大通,2024-10-30,8440
1808,潤隆,324,63,261,摩根大通,2024-10-30,8440
6116,彩晶,282,26,256,摩根大通,2024-10-30,8440
1528,恩德,282,47,235,摩根大通,2024-10-30,8440
2332,友訊,350,117,233,摩根大通,2024-10-30,8440
2388,威盛,352,130,222,摩根大通,2024-10-30,8440
3149,正達,260,51,209,摩根大通,2024-10-30,8440
2497,怡利電,446,239,207,摩根大通,2024-10-30,8440
2357,華碩,398,202,196,摩根大通,2024-10-30,8440
5443,均豪,212,23,189,摩根大通,2024-10-30,8440
6187,萬潤,205,20,185,摩根大通,2024-10-30,8440
8404,百和興業-KY,257,79,178,摩根大通,2024-10-30,8440
6147,頎邦,245,77,168,摩根大通,2024-10-30,8440
2607,榮運,175,16,159,摩根大通,2024-10-30,8440
6126,信音,152,0,152,摩根大通,2024-10-30,8440
4956,光鋐,162,10,152,摩根大通,2024-10-30,8440
2515,中工,181,34,147,摩根大通,2024-10-30,8440
4904,遠傳,391,250,141,摩根大通,2024-10-30,8440
3231,緯創,9605,3157,6448,摩根大通,2024-11-01,8440
2610,華航,5817,1132,4685,摩根大通,2024-11-01,8440
2609,陽明,4000,1064,2936,摩根大通,2024-11-01,8440
3037,欣興,3480,938,2542,摩根大通,2024-11-01,8440
2504,國產,2426,518,1908,摩根大通,2024-11-01,8440
5347,世界,2649,840,1809,摩根大通,2024-11-01,8440
2615,萬海,1959,331,1628,摩根大通,2024-11-01,8440
2618,長榮航,3746,2233,1513,摩根大通,2024-11-01,8440
2890,永豐金,2535,1252,1283,摩根大通,2024-11-01,8440
6133,金橋,1147,137,1010,摩根大通,2024-11-01,8440
2002,中鋼,2999,2213,786,摩根大通,2024-11-01,8440
2882,國泰金,2035,1251,784,摩根大通,2024-11-01,8440
2606,裕民,1119,348,771,摩根大通,2024-11-01,8440
2603,長榮,3600,2842,758,摩根大通,2024-11-01,8440
3481,群創,1690,933,757,摩根大通,2024-11-01,8440
2354,鴻準,2987,2236,751,摩根大通,2024-11-01,8440
2330,台積電,3908,3195,713,摩根大通,2024-11-01,8440
3711,日月光投控,4085,3430,655,摩根大通,2024-11-01,8440
4958,臻鼎-KY,957,316,641,摩根大通,2024-11-01,8440
2105,正新,1142,598,544,摩根大通,2024-11-01,8440
1402,遠東新,848,305,543,摩根大通,2024-11-01,8440
2515,中工,687,156,531,摩根大通,2024-11-01,8440
3047,訊舟,731,212,519,摩根大通,2024-11-01,8440
2360,致茂,619,148,471,摩根大通,2024-11-01,8440
5438,東友,543,76,467,摩根大通,2024-11-01,8440
3576,聯合再生,495,42,453,摩根大通,2024-11-01,8440
2607,榮運,540,90,450,摩根大通,2024-11-01,8440
1102,亞泥,1088,638,450,摩根大通,2024-11-01,8440
1605,華新,1124,684,440,摩根大通,2024-11-01,8440
2637,慧洋-KY,810,378,432,摩根大通,2024-11-01,8440
6116,彩晶,582,158,424,摩根大通,2024-11-01,8440
4915,致伸,627,206,421,摩根大通,2024-11-01,8440
8028,昇陽半導體,462,48,414,摩根大通,2024-11-01,8440
1449,佳和,1319,915,404,摩根大通,2024-11-01,8440
6443,元晶,401,17,384,摩根大通,2024-11-01,8440
9105,泰金寶-DR,380,3,377,摩根大通,2024-11-01,8440
3056,富華新,369,5,364,摩根大通,2024-11-01,8440
1314,中石化,480,117,363,摩根大通,2024-11-01,8440
2836,高雄銀,385,25,360,摩根大通,2024-11-01,8440
2329,華泰,434,104,330,摩根大通,2024-11-01,8440
4303,信立,357,28,329,摩根大通,2024-11-01,8440
2537,聯上發,489,173,316,摩根大通,2024-11-01,8440
1307,三芳,582,272,310,摩根大通,2024-11-01,8440
3081,聯亞,352,62,290,摩根大通,2024-11-01,8440
1442,名軒,336,51,285,摩根大通,2024-11-01,8440
2486,一詮,427,148,279,摩根大通,2024-11-01,8440
6139,亞翔,300,25,275,摩根大通,2024-11-01,8440
2883B,凱基金乙特,273,0,273,摩根大通,2024-11-01,8440
2642,宅配通,487,218,269,摩根大通,2024-11-01,8440
1303,南亞,1065,816,249,摩根大通,2024-11-01,8440
2354,鴻準,8522,2629,5893,摩根大通,2024-11-04,8440
2610,華航,3261,418,2843,摩根大通,2024-11-04,8440
2890,永豐金,3019,431,2588,摩根大通,2024-11-04,8440
2882,國泰金,2416,362,2054,摩根大通,2024-11-04,8440
2317,鴻海,3284,1752,1532,摩根大通,2024-11-04,8440
2618,長榮航,1455,94,1361,摩根大通,2024-11-04,8440
6770,力積電,1602,257,1345,摩根大通,2024-11-04,8440
2887,台新金,1451,173,1278,摩根大通,2024-11-04,8440
2382,廣達,2538,1285,1253,摩根大通,2024-11-04,8440
2892,第一金,1902,732,1170,摩根大通,2024-11-04,8440
2371,大同,1556,408,1148,摩根大通,2024-11-04,8440
2347,聯強,1457,427,1030,摩根大通,2024-11-04,8440
9904,寶成,1720,784,936,摩根大通,2024-11-04,8440
1102,亞泥,1380,459,921,摩根大通,2024-11-04,8440
1303,南亞,1283,372,911,摩根大通,2024-11-04,8440
2408,南亞科,952,120,832,摩根大通,2024-11-04,8440
5876,上海商銀,1355,561,794,摩根大通,2024-11-04,8440
3450,聯鈞,1709,923,786,摩根大通,2024-11-04,8440
1605,華新,1097,376,721,摩根大通,2024-11-04,8440
6505,台塑化,1285,576,709,摩根大通,2024-11-04,8440
1301,台塑,918,220,698,摩根大通,2024-11-04,8440
2301,光寶科,840,209,631,摩根大通,2024-11-04,8440
2504,國產,786,165,621,摩根大通,2024-11-04,8440
6116,彩晶,684,64,620,摩根大通,2024-11-04,8440
2809,京城銀,656,60,596,摩根大通,2024-11-04,8440
1802,台玻,787,333,454,摩根大通,2024-11-04,8440
2312,金寶,736,289,447,摩根大通,2024-11-04,8440
1504,東元,765,331,434,摩根大通,2024-11-04,8440
2344,華邦電,735,341,394,摩根大通,2024-11-04,8440
2888,新光金,949,558,391,摩根大通,2024-11-04,8440
2883B,凱基金乙特,332,0,332,摩根大通,2024-11-04,8440
2606,裕民,585,270,315,摩根大通,2024-11-04,8440
6005,群益證,436,130,306,摩根大通,2024-11-04,8440
9105,泰金寶-DR,359,54,305,摩根大通,2024-11-04,8440
2915,潤泰全,370,75,295,摩根大通,2024-11-04,8440
2402,毅嘉,291,8,283,摩根大通,2024-11-04,8440
6147,頎邦,330,56,274,摩根大通,2024-11-04,8440
2439,美律,368,95,273,摩根大通,2024-11-04,8440
1519,華城,421,158,263,摩根大通,2024-11-04,8440
5880,合庫金,438,180,258,摩根大通,2024-11-04,8440
2885,元大金,1253,998,255,摩根大通,2024-11-04,8440
2884,玉山金,1109,870,239,摩根大通,2024-11-04,8440
8069,元太,281,43,238,摩根大通,2024-11-04,8440
2101,南港,237,14,223,摩根大通,2024-11-04,8440
6134,萬旭,305,84,221,摩根大通,2024-11-04,8440
5508,永信建,243,23,220,摩根大通,2024-11-04,8440
2328,廣宇,544,329,215,摩根大通,2024-11-04,8440
2377,微星,268,55,213,摩根大通,2024-11-04,8440
1528,恩德,542,332,210,摩根大通,2024-11-04,8440
3149,正達,353,144,209,摩根大通,2024-11-04,8440
2891,中信金,11111,3715,7396,摩根大通,2024-11-05,8440
2883,凱基金,6571,1567,5004,摩根大通,2024-11-05,8440
3231,緯創,5583,1398,4185,摩根大通,2024-11-05,8440
2356,英業達,5728,1959,3769,摩根大通,2024-11-05,8440
2609,陽明,4039,742,3297,摩根大通,2024-11-05,8440
2382,廣達,3866,777,3089,摩根大通,2024-11-05,8440
3450,聯鈞,3168,345,2823,摩根大通,2024-11-05,8440
2615,萬海,3684,1516,2168,摩根大通,2024-11-05,8440
2886,兆豐金,2557,884,1673,摩根大通,2024-11-05,8440
2324,仁寶,2177,574,1603,摩根大通,2024-11-05,8440
2002,中鋼,2031,490,1541,摩根大通,2024-11-05,8440
2610,華航,2229,702,1527,摩根大通,2024-11-05,8440
1101,台泥,2282,814,1468,摩根大通,2024-11-05,8440
2887,台新金,2097,877,1220,摩根大通,2024-11-05,8440
2312,金寶,1364,158,1206,摩根大通,2024-11-05,8440
2344,華邦電,1295,200,1095,摩根大通,2024-11-05,8440
2801,彰銀,1433,391,1042,摩根大通,2024-11-05,8440
2888,新光金,1185,227,958,摩根大通,2024-11-05,8440
1519,華城,1059,233,826,摩根大通,2024-11-05,8440
2882,國泰金,1593,780,813,摩根大通,2024-11-05,8440
3037,欣興,1080,326,754,摩根大通,2024-11-05,8440
9105,泰金寶-DR,757,27,730,摩根大通,2024-11-05,8440
2330,台積電,3233,2519,714,摩根大通,2024-11-05,8440
2337,旺宏,841,201,640,摩根大通,2024-11-05,8440
1802,台玻,1001,362,639,摩根大通,2024-11-05,8440
9945,潤泰新,648,35,613,摩根大通,2024-11-05,8440
1815,富喬,604,12,592,摩根大通,2024-11-05,8440
2105,正新,1205,620,585,摩根大通,2024-11-05,8440
4904,遠傳,848,287,561,摩根大通,2024-11-05,8440
2377,微星,605,89,516,摩根大通,2024-11-05,8440
2618,長榮航,932,444,488,摩根大通,2024-11-05,8440
3228,金麗科,607,151,456,摩根大通,2024-11-05,8440
2601,益航,477,50,427,摩根大通,2024-11-05,8440
2409,友達,1464,1039,425,摩根大通,2024-11-05,8440
3706,神達,452,61,391,摩根大通,2024-11-05,8440
3714,富采,460,76,384,摩根大通,2024-11-05,8440
4903,聯光通,587,204,383,摩根大通,2024-11-05,8440
6770,力積電,485,104,381,摩根大通,2024-11-05,8440
2892,第一金,1478,1119,359,摩根大通,2024-11-05,8440
1605,華新,741,387,354,摩根大通,2024-11-05,8440
5508,永信建,373,21,352,摩根大通,2024-11-05,8440
6530,創威,644,305,339,摩根大通,2024-11-05,8440
2412,中華電,603,269,334,摩根大通,2024-11-05,8440
1216,統一,900,567,333,摩根大通,2024-11-05,8440
6147,頎邦,341,12,329,摩根大通,2024-11-05,8440
2353,宏��,1186,859,327,摩根大通,2024-11-05,8440
2633,台灣高鐵,692,366,326,摩根大通,2024-11-05,8440
9914,美利達,410,94,316,摩根大通,2024-11-05,8440
9910,豐泰,329,19,310,摩根大通,2024-11-05,8440
6405,悅城,400,92,308,摩根大通,2024-11-05,8440
2312,金寶,11241,1777,9464,摩根大通,2024-11-06,8440
2883,凱基金,6794,1988,4806,摩根大通,2024-11-06,8440
2891,中信金,5549,1972,3577,摩根大通,2024-11-06,8440
1815,富喬,2320,141,2179,摩根大通,2024-11-06,8440
2354,鴻準,3611,2326,1285,摩根大通,2024-11-06,8440
2449,京元電子,1253,60,1193,摩根大通,2024-11-06,8440
3450,聯鈞,1272,243,1029,摩根大通,2024-11-06,8440
2606,裕民,956,76,880,摩根大通,2024-11-06,8440
2637,慧洋-KY,951,125,826,摩根大通,2024-11-06,8440
2353,宏��,2061,1266,795,摩根大通,2024-11-06,8440
2888,新光金,1091,314,777,摩根大通,2024-11-06,8440
2301,光寶科,996,241,755,摩根大通,2024-11-06,8440
8069,元太,919,242,677,摩根大通,2024-11-06,8440
2610,華航,897,237,660,摩根大通,2024-11-06,8440
2880,華南金,1979,1402,577,摩根大通,2024-11-06,8440
2382,廣達,1739,1192,547,摩根大通,2024-11-06,8440
1808,潤隆,558,12,546,摩根大通,2024-11-06,8440
2027,大成鋼,1099,605,494,摩根大通,2024-11-06,8440
1216,統一,769,328,441,摩根大通,2024-11-06,8440
8028,昇陽半導體,470,113,357,摩根大通,2024-11-06,8440
3005,神基,407,50,357,摩根大通,2024-11-06,8440
1449,佳和,2396,2046,350,摩根大通,2024-11-06,8440
2439,美律,351,4,347,摩根大通,2024-11-06,8440
2323,中環,371,61,310,摩根大通,2024-11-06,8440
1303,南亞,1184,876,308,摩根大通,2024-11-06,8440
4991,環宇-KY,1018,717,301,摩根大通,2024-11-06,8440
3037,欣興,369,68,301,摩根大通,2024-11-06,8440
3034,聯詠,425,130,295,摩根大通,2024-11-06,8440
6139,亞翔,304,23,281,摩根大通,2024-11-06,8440
2458,義隆,332,58,274,摩根大通,2024-11-06,8440
2881,富邦金,759,492,267,摩根大通,2024-11-06,8440
2882,國泰金,534,272,262,摩根大通,2024-11-06,8440
2002,中鋼,1045,784,261,摩根大通,2024-11-06,8440
1477,聚陽,319,73,246,摩根大通,2024-11-06,8440
2887,台新金,839,594,245,摩根大通,2024-11-06,8440
3711,日月光投控,633,392,241,摩根大通,2024-11-06,8440
2425,承啟,299,68,231,摩根大通,2024-11-06,8440
2883B,凱基金乙特,268,56,212,摩根大通,2024-11-06,8440
2613,中櫃,278,68,210,摩根大通,2024-11-06,8440
8299,群聯,203,6,197,摩根大通,2024-11-06,8440
6164,華興,247,57,190,摩根大通,2024-11-06,8440
6535,順藥,202,16,186,摩根大通,2024-11-06,8440
2360,致茂,494,316,178,摩根大通,2024-11-06,8440
2634,漢翔,230,57,173,摩根大通,2024-11-06,8440
2467,志聖,310,141,169,摩根大通,2024-11-06,8440
9105,泰金寶-DR,489,321,168,摩根大通,2024-11-06,8440
3025,星通,378,210,168,摩根大通,2024-11-06,8440
8033,雷虎,184,19,165,摩根大通,2024-11-06,8440
3231,緯創,4302,4139,163,摩根大通,2024-11-06,8440
1313,聯成,223,62,161,摩根大通,2024-11-06,8440
2354,鴻準,8006,1348,6658,摩根大通,2024-11-07,8440
2610,華航,6523,353,6170,摩根大通,2024-11-07,8440
2312,金寶,7771,1852,5919,摩根大通,2024-11-07,8440
2883,凱基金,6387,1112,5275,摩根大通,2024-11-07,8440
3481,群創,4631,951,3680,摩根大通,2024-11-07,8440
6116,彩晶,2004,33,1971,摩根大通,2024-11-07,8440
0056,元大高股息,1959,0,1959,摩根大通,2024-11-07,8440
2618,長榮航,5506,3687,1819,摩根大通,2024-11-07,8440
1303,南亞,2271,622,1649,摩根大通,2024-11-07,8440
2882,國泰金,3147,1602,1545,摩根大通,2024-11-07,8440
9105,泰金寶-DR,1747,209,1538,摩根大通,2024-11-07,8440
2317,鴻海,5090,3637,1453,摩根大通,2024-11-07,8440
5876,上海商銀,2349,897,1452,摩根大通,2024-11-07,8440
2881,富邦金,2268,871,1397,摩根大通,2024-11-07,8440
2409,友達,2041,818,1223,摩根大通,2024-11-07,8440
3706,神達,1315,156,1159,摩根大通,2024-11-07,8440
1301,台塑,1979,856,1123,摩根大通,2024-11-07,8440
2002,中鋼,1889,837,1052,摩根大通,2024-11-07,8440
2515,中工,1048,14,1034,摩根大通,2024-11-07,8440
2337,旺宏,1137,142,995,摩根大通,2024-11-07,8440
2353,宏��,1298,337,961,摩根大通,2024-11-07,8440
2344,華邦電,1739,838,901,摩根大通,2024-11-07,8440
3702,大聯大,1032,291,741,摩根大通,2024-11-07,8440
1560,中砂,736,30,706,摩根大通,2024-11-07,8440
2887,台新金,1152,474,678,摩根大通,2024-11-07,8440
3450,聯鈞,849,195,654,摩根大通,2024-11-07,8440
1449,佳和,1397,743,654,摩根大通,2024-11-07,8440
1504,東元,923,281,642,摩根大通,2024-11-07,8440
6770,力積電,857,224,633,摩根大通,2024-11-07,8440
2313,華通,1329,721,608,摩根大通,2024-11-07,8440
1102,亞泥,809,247,562,摩根大通,2024-11-07,8440
2809,京城銀,756,219,537,摩根大通,2024-11-07,8440
2637,慧洋-KY,643,113,530,摩根大通,2024-11-07,8440
3231,緯創,2139,1621,518,摩根大通,2024-11-07,8440
2606,裕民,622,111,511,摩根大通,2024-11-07,8440
2332,友訊,633,145,488,摩根大通,2024-11-07,8440
6274,台燿,508,61,447,摩根大通,2024-11-07,8440
1612,宏泰,440,22,418,摩根大通,2024-11-07,8440
5347,世界,1132,719,413,摩根大通,2024-11-07,8440
2360,致茂,550,151,399,摩根大通,2024-11-07,8440
6213,聯茂,401,4,397,摩根大通,2024-11-07,8440
3062,建漢,2274,1878,396,摩根大通,2024-11-07,8440
2365,昆盈,518,133,385,摩根大通,2024-11-07,8440
6190,萬泰科,457,74,383,摩根大通,2024-11-07,8440
2888,新光金,1327,957,370,摩根大通,2024-11-07,8440
2883B,凱基金乙特,370,0,370,摩根大通,2024-11-07,8440
4763,材料-KY,343,12,331,摩根大通,2024-11-07,8440
4526,東台,366,36,330,摩根大通,2024-11-07,8440
2867,三商壽,415,85,330,摩根大通,2024-11-07,8440
3576,聯合再生,380,55,325,摩根大通,2024-11-07,8440
2883,凱基金,7246,566,6680,摩根大通,2024-11-08,8440
2609,陽明,6198,210,5988,摩根大通,2024-11-08,8440
2354,鴻準,6789,2357,4432,摩根大通,2024-11-08,8440
2344,華邦電,4673,474,4199,摩根大通,2024-11-08,8440
2317,鴻海,4762,1909,2853,摩根大通,2024-11-08,8440
3231,緯創,3938,1165,2773,摩根大通,2024-11-08,8440
2376,技嘉,2217,47,2170,摩根大通,2024-11-08,8440
2881,富邦金,2344,229,2115,摩根大通,2024-11-08,8440
2303,聯電,2914,954,1960,摩根大通,2024-11-08,8440
2888,新光金,2228,326,1902,摩根大通,2024-11-08,8440
2618,長榮航,1944,197,1747,摩根大通,2024-11-08,8440
2382,廣達,2881,1171,1710,摩根大通,2024-11-08,8440
2610,華航,2092,384,1708,摩根大通,2024-11-08,8440
2885,元大金,2162,757,1405,摩根大通,2024-11-08,8440
1303,南亞,2081,841,1240,摩根大通,2024-11-08,8440
2615,萬海,1587,434,1153,摩根大通,2024-11-08,8440
2330,台積電,2551,1549,1002,摩根大通,2024-11-08,8440
1795,美時,1013,35,978,摩根大通,2024-11-08,8440
3665,貿聯-KY,1000,205,795,摩根大通,2024-11-08,8440
4979,華星光,1039,269,770,摩根大通,2024-11-08,8440
5347,世界,872,111,761,摩根大通,2024-11-08,8440
2002,中鋼,961,246,715,摩根大通,2024-11-08,8440
2324,仁寶,1472,757,715,摩根大通,2024-11-08,8440
9105,泰金寶-DR,689,8,681,摩根大通,2024-11-08,8440
4303,信立,791,138,653,摩根大通,2024-11-08,8440
2887,台新金,1139,497,642,摩根大通,2024-11-08,8440
2393,億光,665,64,601,摩根大通,2024-11-08,8440
2606,裕民,672,71,601,摩根大通,2024-11-08,8440
3211,順達,674,117,557,摩根大通,2024-11-08,8440
2886,兆豐金,771,225,546,摩根大通,2024-11-08,8440
9945,潤泰新,638,119,519,摩根大通,2024-11-08,8440
2892,第一金,1887,1411,476,摩根大通,2024-11-08,8440
3702,大聯大,692,229,463,摩根大通,2024-11-08,8440
1815,富喬,762,316,446,摩根大通,2024-11-08,8440
1808,潤隆,543,106,437,摩根大通,2024-11-08,8440
2520,冠德,847,450,397,摩根大通,2024-11-08,8440
2486,一詮,438,70,368,摩根大通,2024-11-08,8440
3324,雙鴻,485,121,364,摩根大通,2024-11-08,8440
1708,東鹼,340,2,338,摩根大通,2024-11-08,8440
2637,慧洋-KY,444,107,337,摩根大通,2024-11-08,8440
2890,永豐金,1015,698,317,摩根大通,2024-11-08,8440
3019,亞光,501,204,297,摩根大通,2024-11-08,8440
2377,微星,339,46,293,摩根大通,2024-11-08,8440
3033,威健,311,24,287,摩根大通,2024-11-08,8440
1560,中砂,315,29,286,摩根大通,2024-11-08,8440
9802,鈺齊-KY,304,39,265,摩根大通,2024-11-08,8440
3017,奇鋐,505,250,255,摩根大通,2024-11-08,8440
8240,華宏,326,74,252,摩根大通,2024-11-08,8440
2360,致茂,291,43,248,摩根大通,2024-11-08,8440
1101,台泥,499,275,224,摩根大通,2024-11-08,8440
2883,凱基金,15891,1172,14719,摩根大通,2024-11-11,8440
2618,長榮航,7273,337,6936,摩根大通,2024-11-11,8440
2330,台積電,5945,2175,3770,摩根大通,2024-11-11,8440
2344,華邦電,3595,350,3245,摩根大通,2024-11-11,8440
2449,京元電子,3592,812,2780,摩根大通,2024-11-11,8440
2301,光寶科,2865,630,2235,摩根大通,2024-11-11,8440
2888,新光金,2236,166,2070,摩根大通,2024-11-11,8440
2356,英業達,3050,1706,1344,摩根大通,2024-11-11,8440
2606,裕民,1233,57,1176,摩根大通,2024-11-11,8440
9105,泰金寶-DR,1321,420,901,摩根大通,2024-11-11,8440
9945,潤泰新,999,99,900,摩根大通,2024-11-11,8440
2610,華航,1423,532,891,摩根大通,2024-11-11,8440
2637,慧洋-KY,884,35,849,摩根大通,2024-11-11,8440
2349,錸德,887,40,847,摩根大通,2024-11-11,8440
1101,台泥,1382,537,845,摩根大通,2024-11-11,8440
5347,世界,1121,300,821,摩根大通,2024-11-11,8440
2317,鴻海,3179,2596,583,摩根大通,2024-11-11,8440
8210,勤誠,678,107,571,摩根大通,2024-11-11,8440
1102,亞泥,1021,477,544,摩根大通,2024-11-11,8440
1808,潤隆,561,46,515,摩根大通,2024-11-11,8440
4977,眾達-KY,527,42,485,摩根大通,2024-11-11,8440
1519,華城,627,239,388,摩根大通,2024-11-11,8440
4919,新唐,511,127,384,摩根大通,2024-11-11,8440
3005,神基,496,114,382,摩根大通,2024-11-11,8440
2890,永豐金,922,564,358,摩根大通,2024-11-11,8440
3450,聯鈞,463,121,342,摩根大通,2024-11-11,8440
2308,台達電,500,173,327,摩根大通,2024-11-11,8440
3045,台灣大,549,222,327,摩根大通,2024-11-11,8440
3234,光環,669,364,305,摩根大通,2024-11-11,8440
1795,美時,362,63,299,摩根大通,2024-11-11,8440
1708,東鹼,502,219,283,摩根大通,2024-11-11,8440
2515,中工,284,1,283,摩根大通,2024-11-11,8440
6757,台灣虎航,342,63,279,摩根大通,2024-11-11,8440
1434,福懋,345,67,278,摩根大通,2024-11-11,8440
2605,新興,422,145,277,摩根大通,2024-11-11,8440
4956,光鋐,320,47,273,摩根大通,2024-11-11,8440
2412,中華電,492,226,266,摩根大通,2024-11-11,8440
6425,易發,291,37,254,摩根大通,2024-11-11,8440
2603,長榮,611,375,236,摩根大通,2024-11-11,8440
2883B,凱基金乙特,221,0,221,摩根大通,2024-11-11,8440
1609,大亞,211,1,210,摩根大通,2024-11-11,8440
2486,一詮,456,258,198,摩根大通,2024-11-11,8440
3013,晟銘電,533,336,197,摩根大通,2024-11-11,8440
2542,興富發,303,107,196,摩根大通,2024-11-11,8440
1524,耿鼎,262,67,195,摩根大通,2024-11-11,8440
8105,凌巨,201,8,193,摩根大通,2024-11-11,8440
8032,光菱,326,136,190,摩根大通,2024-11-11,8440
1595,川寶,192,6,186,摩根大通,2024-11-11,8440
2520,冠德,586,401,185,摩根大通,2024-11-11,8440
5508,永信建,265,80,185,摩根大通,2024-11-11,8440
2618,長榮航,12867,994,11873,摩根大通,2024-11-12,8440
0050,元大台灣50,11336,185,11151,摩根大通,2024-11-12,8440
2303,聯電,7722,2947,4775,摩根大通,2024-11-12,8440
3706,神達,6291,2906,3385,摩根大通,2024-11-12,8440
2344,華邦電,2908,625,2283,摩根大通,2024-11-12,8440
2887,台新金,3863,1750,2113,摩根大通,2024-11-12,8440
2382,廣達,3682,2001,1681,摩根大通,2024-11-12,8440
1449,佳和,1426,130,1296,摩根大通,2024-11-12,8440
3231,緯創,4011,2924,1087,摩根大通,2024-11-12,8440
1102,亞泥,1641,660,981,摩根大通,2024-11-12,8440
1605,華新,2918,2104,814,摩根大通,2024-11-12,8440
2881,富邦金,3120,2370,750,摩根大通,2024-11-12,8440
3037,欣興,1264,527,737,摩根大通,2024-11-12,8440
2349,錸德,1841,1139,702,摩根大通,2024-11-12,8440
2312,金寶,1194,577,617,摩根大通,2024-11-12,8440
2458,義隆,501,47,454,摩根大通,2024-11-12,8440
2610,華航,1539,1111,428,摩根大通,2024-11-12,8440
1808,潤隆,518,104,414,摩根大通,2024-11-12,8440
9904,寶成,2004,1626,378,摩根大通,2024-11-12,8440
3167,大量,443,92,351,摩根大通,2024-11-12,8440
2520,冠德,561,243,318,摩根大通,2024-11-12,8440
1721,三晃,338,26,312,摩根大通,2024-11-12,8440
6757,台灣虎航,457,167,290,摩根大通,2024-11-12,8440
1528,恩德,339,60,279,摩根大通,2024-11-12,8440
4956,光鋐,316,40,276,摩根大通,2024-11-12,8440
4915,致伸,309,45,264,摩根大通,2024-11-12,8440
4909,新復興,321,68,253,摩根大通,2024-11-12,8440
5426,振發,277,33,244,摩根大通,2024-11-12,8440
9105,泰金寶-DR,468,227,241,摩根大通,2024-11-12,8440
5347,世界,979,745,234,摩根大通,2024-11-12,8440
2605,新興,457,230,227,摩根大通,2024-11-12,8440
8028,昇陽半導體,379,153,226,摩根大通,2024-11-12,8440
8070,長華*,491,269,222,摩根大通,2024-11-12,8440
2449,京元電子,737,522,215,摩根大通,2024-11-12,8440
2606,裕民,950,745,205,摩根大通,2024-11-12,8440
1707,葡萄王,207,12,195,摩根大通,2024-11-12,8440
5269,祥碩,220,31,189,摩根大通,2024-11-12,8440
6288,聯嘉,265,77,188,摩根大通,2024-11-12,8440
2455,全新,360,173,187,摩根大通,2024-11-12,8440
8112,至上,269,85,184,摩根大通,2024-11-12,8440
4919,新唐,192,18,174,摩根大通,2024-11-12,8440
5608,四維航,291,120,171,摩根大通,2024-11-12,8440
2426,鼎元,188,19,169,摩根大通,2024-11-12,8440
1711,永光,268,106,162,摩根大通,2024-11-12,8440
6443,元晶,200,47,153,摩根大通,2024-11-12,8440
2357,華碩,504,356,148,摩根大通,2024-11-12,8440
1519,華城,593,446,147,摩根大通,2024-11-12,8440
3013,晟銘電,347,201,146,摩根大通,2024-11-12,8440
5398,慕康生醫,349,211,138,摩根大通,2024-11-12,8440
4576,大銀微系統,241,109,132,摩根大通,2024-11-12,8440
2618,長榮航,5836,473,5363,摩根大通,2024-11-13,8440
3231,緯創,6033,1497,4536,摩根大通,2024-11-13,8440
2312,金寶,4347,489,3858,摩根大通,2024-11-13,8440
2303,聯電,6235,2423,3812,摩根大通,2024-11-13,8440
3037,欣興,4093,1294,2799,摩根大通,2024-11-13,8440
2317,鴻海,5618,3818,1800,摩根大通,2024-11-13,8440
2344,華邦電,2423,1117,1306,摩根大通,2024-11-13,8440
6505,台塑化,1906,668,1238,摩根大通,2024-11-13,8440
1514,亞力,897,131,766,摩根大通,2024-11-13,8440
2887,台新金,2870,2107,763,摩根大通,2024-11-13,8440
6757,台灣虎航,856,151,705,摩根大通,2024-11-13,8440
9904,寶成,1867,1212,655,摩根大通,2024-11-13,8440
2606,裕民,669,155,514,摩根大通,2024-11-13,8440
00692,富邦公司治理,500,0,500,摩根大通,2024-11-13,8440
3034,聯詠,603,122,481,摩根大通,2024-11-13,8440
2520,冠德,631,169,462,摩根大通,2024-11-13,8440
5243,乙盛-KY,528,89,439,摩根大通,2024-11-13,8440
1808,潤隆,589,166,423,摩根大通,2024-11-13,8440
2884,玉山金,3014,2619,395,摩根大通,2024-11-13,8440
3702,大聯大,929,538,391,摩根大通,2024-11-13,8440
1402,遠東新,1465,1088,377,摩根大通,2024-11-13,8440
2881,富邦金,2893,2522,371,摩根大通,2024-11-13,8440
6223,旺矽,383,47,336,摩根大通,2024-11-13,8440
6282,康舒,632,301,331,摩根大通,2024-11-13,8440
2395,研華,423,143,280,摩根大通,2024-11-13,8440
1560,中砂,352,76,276,摩根大通,2024-11-13,8440
5443,均豪,265,5,260,摩根大通,2024-11-13,8440
3167,大量,311,51,260,摩根大通,2024-11-13,8440
1708,東鹼,705,452,253,摩根大通,2024-11-13,8440
2809,京城銀,590,346,244,摩根大通,2024-11-13,8440
2404,漢唐,393,153,240,摩根大通,2024-11-13,8440
8011,台通,677,443,234,摩根大通,2024-11-13,8440
2646,星宇航空,303,87,216,摩根大通,2024-11-13,8440
9105,泰金寶-DR,240,27,213,摩根大通,2024-11-13,8440
2385,群光,303,91,212,摩根大通,2024-11-13,8440
3376,新日興,267,59,208,摩根大通,2024-11-13,8440
4977,眾達-KY,342,149,193,摩根大通,2024-11-13,8440
4968,立積,200,28,172,摩根大通,2024-11-13,8440
5309,系統電,381,214,167,摩根大通,2024-11-13,8440
5512,力麒,209,50,159,摩根大通,2024-11-13,8440
2637,慧洋-KY,470,313,157,摩根大通,2024-11-13,8440
1611,中電,411,257,154,摩根大通,2024-11-13,8440
3419,譁裕,319,171,148,摩根大通,2024-11-13,8440
2332,友訊,230,85,145,摩根大通,2024-11-13,8440
6182,合晶,218,76,142,摩根大通,2024-11-13,8440
3520,華盈,277,141,136,摩根大通,2024-11-13,8440
1524,耿鼎,483,348,135,摩根大通,2024-11-13,8440
3013,晟銘電,818,685,133,摩根大通,2024-11-13,8440
2476,鉅祥,212,80,132,摩根大通,2024-11-13,8440
8929,富堡,166,38,128,摩根大通,2024-11-13,8440
2618,長榮航,18332,331,18001,摩根大通,2024-11-14,8440
3706,神達,9636,2828,6808,摩根大通,2024-11-14,8440
2887,台新金,5860,197,5663,摩根大通,2024-11-14,8440
2884,玉山金,4437,1238,3199,摩根大通,2024-11-14,8440
2330,台積電,4872,1770,3102,摩根大通,2024-11-14,8440
2317,鴻海,4972,2028,2944,摩根大通,2024-11-14,8440
2886,兆豐金,3649,834,2815,摩根大通,2024-11-14,8440
2801,彰銀,2112,572,1540,摩根大通,2024-11-14,8440
2890,永豐金,2494,1005,1489,摩根大通,2024-11-14,8440
2606,裕民,1497,222,1275,摩根大通,2024-11-14,8440
2892,第一金,1582,364,1218,摩根大通,2024-11-14,8440
3324,雙鴻,910,67,843,摩根大通,2024-11-14,8440
3376,新日興,1173,394,779,摩根大通,2024-11-14,8440
6505,台塑化,1091,326,765,摩根大通,2024-11-14,8440
3045,台灣大,848,92,756,摩根大通,2024-11-14,8440
1402,遠東新,997,268,729,摩根大通,2024-11-14,8440
2393,億光,915,196,719,摩根大通,2024-11-14,8440
1560,中砂,890,267,623,摩根大通,2024-11-14,8440
2888,新光金,728,207,521,摩根大通,2024-11-14,8440
6443,元晶,608,100,508,摩根大通,2024-11-14,8440
1802,台玻,541,40,501,摩根大通,2024-11-14,8440
2610,華航,1794,1342,452,摩根大通,2024-11-14,8440
2809,京城銀,587,159,428,摩根大通,2024-11-14,8440
2344,華邦電,774,346,428,摩根大通,2024-11-14,8440
1303,南亞,576,154,422,摩根大通,2024-11-14,8440
4979,華星光,523,110,413,摩根大通,2024-11-14,8440
1504,東元,571,171,400,摩根大通,2024-11-14,8440
2520,冠德,699,303,396,摩根大通,2024-11-14,8440
6405,悅城,417,68,349,摩根大通,2024-11-14,8440
5880,合庫金,2103,1769,334,摩根大通,2024-11-14,8440
1808,潤隆,444,127,317,摩根大通,2024-11-14,8440
2834,臺企銀,454,144,310,摩根大通,2024-11-14,8440
6757,台灣虎航,345,69,276,摩根大通,2024-11-14,8440
2881,富邦金,1126,863,263,摩根大通,2024-11-14,8440
3712,永崴投控,426,164,262,摩根大通,2024-11-14,8440
6153,嘉聯益,266,12,254,摩根大通,2024-11-14,8440
1795,美時,324,77,247,摩根大通,2024-11-14,8440
2349,錸德,453,218,235,摩根大通,2024-11-14,8440
2405,輔信,528,296,232,摩根大通,2024-11-14,8440
6223,旺矽,362,137,225,摩根大通,2024-11-14,8440
8299,群聯,254,31,223,摩根大通,2024-11-14,8440
3090,日電貿,265,45,220,摩根大通,2024-11-14,8440
3017,奇鋐,569,360,209,摩根大通,2024-11-14,8440
2395,研華,258,53,205,摩根大通,2024-11-14,8440
2412,中華電,378,179,199,摩根大通,2024-11-14,8440
1319,東陽,575,377,198,摩根大通,2024-11-14,8440
1528,恩德,325,130,195,摩根大通,2024-11-14,8440
3227,原相,315,124,191,摩根大通,2024-11-14,8440
3035,智原,191,2,189,摩根大通,2024-11-14,8440
2497,怡利電,207,20,187,摩根大通,2024-11-14,8440
2892,第一金,15862,620,15242,摩根大通,2024-11-15,8440
2303,聯電,10492,72,10420,摩根大通,2024-11-15,8440
2312,金寶,8316,634,7682,摩根大通,2024-11-15,8440
9105,泰金寶-DR,7764,222,7542,摩根大通,2024-11-15,8440
2890,永豐金,7153,783,6370,摩根大通,2024-11-15,8440
3481,群創,6018,636,5382,摩根大通,2024-11-15,8440
2618,長榮航,8628,3661,4967,摩根大通,2024-11-15,8440
5347,世界,3701,361,3340,摩根大通,2024-11-15,8440
2105,正新,3610,486,3124,摩根大通,2024-11-15,8440
2886,兆豐金,3171,116,3055,摩根大通,2024-11-15,8440
2801,彰銀,3012,18,2994,摩根大通,2024-11-15,8440
2603,長榮,3435,903,2532,摩根大通,2024-11-15,8440
2891,中信金,3314,885,2429,摩根大通,2024-11-15,8440
1101,台泥,4056,1632,2424,摩根大通,2024-11-15,8440
2888,新光金,1958,75,1883,摩根大通,2024-11-15,8440
2027,大成鋼,1884,21,1863,摩根大通,2024-11-15,8440
5876,上海商銀,2325,468,1857,摩根大通,2024-11-15,8440
2371,大同,1915,97,1818,摩根大通,2024-11-15,8440
2885,元大金,2055,243,1812,摩根大通,2024-11-15,8440
2330,台積電,4307,2499,1808,摩根大通,2024-11-15,8440
2884,玉山金,3779,2179,1600,摩根大通,2024-11-15,8440
1216,統一,1904,327,1577,摩根大通,2024-11-15,8440
2882,國泰金,1667,123,1544,摩根大通,2024-11-15,8440
2606,裕民,1526,134,1392,摩根大通,2024-11-15,8440
2301,光寶科,1571,277,1294,摩根大通,2024-11-15,8440
6757,台灣虎航,1730,483,1247,摩根大通,2024-11-15,8440
2515,中工,1367,150,1217,摩根大通,2024-11-15,8440
5880,合庫金,1332,153,1179,摩根大通,2024-11-15,8440
1402,遠東新,1533,373,1160,摩根大通,2024-11-15,8440
2609,陽明,1926,797,1129,摩根大通,2024-11-15,8440
6116,彩晶,1147,130,1017,摩根大通,2024-11-15,8440
2881,富邦金,1210,278,932,摩根大通,2024-11-15,8440
3702,大聯大,1186,272,914,摩根大通,2024-11-15,8440
2929,淘帝-KY,1084,224,860,摩根大通,2024-11-15,8440
2633,台灣高鐵,1157,302,855,摩根大通,2024-11-15,8440
3045,台灣大,1101,270,831,摩根大通,2024-11-15,8440
2344,華邦電,1628,815,813,摩根大通,2024-11-15,8440
6505,台塑化,1343,581,762,摩根大通,2024-11-15,8440
4904,遠傳,1037,281,756,摩根大通,2024-11-15,8440
1301,台塑,939,195,744,摩根大通,2024-11-15,8440
1528,恩德,847,116,731,摩根大通,2024-11-15,8440
3712,永崴投控,751,80,671,摩根大通,2024-11-15,8440
3034,聯詠,752,83,669,摩根大通,2024-11-15,8440
1303,南亞,1209,565,644,摩根大通,2024-11-15,8440
9958,世紀鋼,654,72,582,摩根大通,2024-11-15,8440
2349,錸德,646,70,576,摩根大通,2024-11-15,8440
1802,台玻,659,102,557,摩根大通,2024-11-15,8440
1721,三晃,590,43,547,摩根大通,2024-11-15,8440
4958,臻鼎-KY,680,138,542,摩根大通,2024-11-15,8440
3049,精金,555,33,522,摩根大通,2024-11-15,8440
2884,玉山金,9427,187,9240,摩根大通,2024-11-18,8440
2618,長榮航,11202,2260,8942,摩根大通,2024-11-18,8440
2303,聯電,10067,2179,7888,摩根大通,2024-11-18,8440
2892,第一金,9758,3385,6373,摩根大通,2024-11-18,8440
2888,新光金,6173,102,6071,摩根大通,2024-11-18,8440
2105,正新,7812,2393,5419,摩根大通,2024-11-18,8440
2027,大成鋼,4752,575,4177,摩根大通,2024-11-18,8440
2887,台新金,3956,499,3457,摩根大通,2024-11-18,8440
2354,鴻準,4036,1401,2635,摩根大通,2024-11-18,8440
1301,台塑,2504,338,2166,摩根大通,2024-11-18,8440
2344,華邦電,2854,1063,1791,摩根大通,2024-11-18,8440
2891,中信金,2356,677,1679,摩根大通,2024-11-18,8440
2609,陽明,2273,597,1676,摩根大通,2024-11-18,8440
2353,宏��,2078,442,1636,摩根大通,2024-11-18,8440
1442,名軒,1835,292,1543,摩根大通,2024-11-18,8440
2002,中鋼,1980,504,1476,摩根大通,2024-11-18,8440
2886,兆豐金,1749,374,1375,摩根大通,2024-11-18,8440
1303,南亞,2037,666,1371,摩根大通,2024-11-18,8440
2606,裕民,1373,52,1321,摩根大通,2024-11-18,8440
6505,台塑化,1402,126,1276,摩根大通,2024-11-18,8440
1326,台化,1468,318,1150,摩根大通,2024-11-18,8440
2382,廣達,1661,520,1141,摩根大通,2024-11-18,8440
5347,世界,1726,607,1119,摩根大通,2024-11-18,8440
1216,統一,1062,61,1001,摩根大通,2024-11-18,8440
00830,國泰費城半導體,900,0,900,摩根大通,2024-11-18,8440
3045,台灣大,986,125,861,摩根大通,2024-11-18,8440
3711,日月光投控,1205,348,857,摩根大通,2024-11-18,8440
6770,力積電,1124,277,847,摩根大通,2024-11-18,8440
1504,東元,1060,216,844,摩根大通,2024-11-18,8440
2206,三陽工業,979,163,816,摩根大通,2024-11-18,8440
2885,元大金,1026,289,737,摩根大通,2024-11-18,8440
2881,富邦金,898,199,699,摩根大通,2024-11-18,8440
00662,富邦NASDAQ,695,0,695,摩根大通,2024-11-18,8440
4904,遠傳,848,153,695,摩根大通,2024-11-18,8440
2474,可成,653,84,569,摩根大通,2024-11-18,8440
3167,大量,596,46,550,摩根大通,2024-11-18,8440
1605,華新,1686,1171,515,摩根大通,2024-11-18,8440
2801,彰銀,570,67,503,摩根大通,2024-11-18,8440
2399,映泰,715,218,497,摩根大通,2024-11-18,8440
5309,系統電,559,76,483,摩根大通,2024-11-18,8440
2520,冠德,730,252,478,摩根大通,2024-11-18,8440
3703,欣陸,704,229,475,摩根大通,2024-11-18,8440
3149,正達,729,260,469,摩根大通,2024-11-18,8440
2634,漢翔,466,3,463,摩根大通,2024-11-18,8440
8028,昇陽半導體,553,132,421,摩根大通,2024-11-18,8440
2301,光寶科,469,68,401,摩根大通,2024-11-18,8440
3596,智易,397,4,393,摩根大通,2024-11-18,8440
6116,彩晶,445,70,375,摩根大通,2024-11-18,8440
1802,台玻,409,56,353,摩根大通,2024-11-18,8440
8069,元太,518,167,351,摩根大通,2024-11-18,8440
2892,第一金,20154,3211,16943,摩根大通,2024-11-19,8440
2884,玉山金,16109,1185,14924,摩根大通,2024-11-19,8440
2891,中信金,4991,741,4250,摩根大通,2024-11-19,8440
2027,大成鋼,4152,520,3632,摩根大通,2024-11-19,8440
2105,正新,6889,3625,3264,摩根大通,2024-11-19,8440
5347,世界,3533,357,3176,摩根大通,2024-11-19,8440
2609,陽明,4781,1605,3176,摩根大通,2024-11-19,8440
2887,台新金,5650,3022,2628,摩根大通,2024-11-19,8440
1605,華新,2465,436,2029,摩根大通,2024-11-19,8440
2002,中鋼,2619,662,1957,摩根大通,2024-11-19,8440
2886,兆豐金,2407,460,1947,摩根大通,2024-11-19,8440
2801,彰銀,2073,195,1878,摩根大通,2024-11-19,8440
2303,聯電,2880,1175,1705,摩根大通,2024-11-19,8440
1402,遠東新,4361,2789,1572,摩根大通,2024-11-19,8440
2399,映泰,1852,313,1539,摩根大通,2024-11-19,8440
2206,三陽工業,1820,355,1465,摩根大通,2024-11-19,8440
2885,元大金,2928,1477,1451,摩根大通,2024-11-19,8440
2344,華邦電,1528,122,1406,摩根大通,2024-11-19,8440
3711,日月光投控,2472,1153,1319,摩根大通,2024-11-19,8440
2888,新光金,1349,39,1310,摩根大通,2024-11-19,8440
2606,裕民,1402,109,1293,摩根大通,2024-11-19,8440
2520,冠德,1322,91,1231,摩根大通,2024-11-19,8440
2634,漢翔,1230,7,1223,摩根大通,2024-11-19,8440
2353,宏��,1574,474,1100,摩根大通,2024-11-19,8440
1216,統一,1364,296,1068,摩根大通,2024-11-19,8440
5880,合庫金,1380,384,996,摩根大通,2024-11-19,8440
6505,台塑化,1169,188,981,摩根大通,2024-11-19,8440
1442,名軒,1158,295,863,摩根大通,2024-11-19,8440
2354,鴻準,2949,2089,860,摩根大通,2024-11-19,8440
1504,東元,907,89,818,摩根大通,2024-11-19,8440
2603,長榮,1863,1054,809,摩根大通,2024-11-19,8440
2809,京城銀,1020,263,757,摩根大通,2024-11-19,8440
3481,群創,2608,1862,746,摩根大通,2024-11-19,8440
4938,和碩,1017,275,742,摩根大通,2024-11-19,8440
2409,友達,1054,313,741,摩根大通,2024-11-19,8440
6191,精成科,762,28,734,摩根大通,2024-11-19,8440
3706,神達,2286,1618,668,摩根大通,2024-11-19,8440
4904,遠傳,855,189,666,摩根大通,2024-11-19,8440
2882,國泰金,2370,1729,641,摩根大通,2024-11-19,8440
2301,光寶科,920,290,630,摩根大通,2024-11-19,8440
2474,可成,767,138,629,摩根大通,2024-11-19,8440
2867,三商壽,669,41,628,摩根大通,2024-11-19,8440
9945,潤泰新,729,118,611,摩根大通,2024-11-19,8440
3703,欣陸,815,214,601,摩根大通,2024-11-19,8440
5871,中租-KY,1110,515,595,摩根大通,2024-11-19,8440
6121,新普,606,49,557,摩根大通,2024-11-19,8440
2377,微星,664,107,557,摩根大通,2024-11-19,8440
2371,大同,581,50,531,摩根大通,2024-11-19,8440
9938,百和,598,78,520,摩根大通,2024-11-19,8440
2834,臺企銀,1838,1357,481,摩根大通,2024-11-19,8440
2891,中信金,23290,9586,13704,摩根大通,2024-11-20,8440
2609,陽明,11496,2135,9361,摩根大通,2024-11-20,8440
2892,第一金,9888,3360,6528,摩根大通,2024-11-20,8440
2884,玉山金,9585,4931,4654,摩根大通,2024-11-20,8440
2027,大成鋼,2631,265,2366,摩根大通,2024-11-20,8440
2615,萬海,3785,1497,2288,摩根大通,2024-11-20,8440
2303,聯電,5161,3045,2116,摩根大通,2024-11-20,8440
2618,長榮航,4603,3191,1412,摩根大通,2024-11-20,8440
2344,華邦電,2045,672,1373,摩根大通,2024-11-20,8440
1605,華新,1903,536,1367,摩根大通,2024-11-20,8440
2634,漢翔,1419,247,1172,摩根大通,2024-11-20,8440
2606,裕民,1368,406,962,摩根大通,2024-11-20,8440
2520,冠德,1140,260,880,摩根大通,2024-11-20,8440
6505,台塑化,1696,949,747,摩根大通,2024-11-20,8440
2345,智邦,866,216,650,摩根大通,2024-11-20,8440
4938,和碩,1488,954,534,摩根大通,2024-11-20,8440
1569,濱川,839,313,526,摩根大通,2024-11-20,8440
3017,奇鋐,803,290,513,摩根大通,2024-11-20,8440
2206,三陽工業,733,294,439,摩根大通,2024-11-20,8440
2332,友訊,848,412,436,摩根大通,2024-11-20,8440
8464,億豐,460,32,428,摩根大通,2024-11-20,8440
2809,京城銀,868,460,408,摩根大通,2024-11-20,8440
5347,世界,935,538,397,摩根大通,2024-11-20,8440
2603,長榮,2722,2345,377,摩根大通,2024-11-20,8440
3376,新日興,628,255,373,摩根大通,2024-11-20,8440
6147,頎邦,768,411,357,摩根大通,2024-11-20,8440
3010,華立,382,26,356,摩根大通,2024-11-20,8440
6176,瑞儀,373,31,342,摩根大通,2024-11-20,8440
3025,星通,488,148,340,摩根大通,2024-11-20,8440
3047,訊舟,363,42,321,摩根大通,2024-11-20,8440
2867,三商壽,675,359,316,摩根大通,2024-11-20,8440
2383,台光電,431,132,299,摩根大通,2024-11-20,8440
2845,遠東銀,516,233,283,摩根大通,2024-11-20,8440
1442,名軒,427,148,279,摩根大通,2024-11-20,8440
6191,精成科,382,113,269,摩根大通,2024-11-20,8440
4526,東台,297,40,257,摩根大通,2024-11-20,8440
6438,迅得,253,14,239,摩根大通,2024-11-20,8440
2363,矽統,515,279,236,摩根大通,2024-11-20,8440
4123,晟德,282,57,225,摩根大通,2024-11-20,8440
3032,偉訓,538,320,218,摩根大通,2024-11-20,8440
2395,研華,268,50,218,摩根大通,2024-11-20,8440
6415,矽力*-KY,249,32,217,摩根大通,2024-11-20,8440
3260,威剛,213,0,213,摩根大通,2024-11-20,8440
6139,亞翔,512,302,210,摩根大通,2024-11-20,8440
8086,宏捷科,215,9,206,摩根大通,2024-11-20,8440
5531,鄉林,237,33,204,摩根大通,2024-11-20,8440
6121,新普,302,113,189,摩根大通,2024-11-20,8440
3088,艾訊,371,183,188,摩根大通,2024-11-20,8440
3231,緯創,1708,1531,177,摩根大通,2024-11-20,8440
1504,東元,1014,839,175,摩根大通,2024-11-20,8440
2884,玉山金,9321,3197,6124,摩根大通,2024-11-21,8440
2618,長榮航,7395,2807,4588,摩根大通,2024-11-21,8440
2809,京城銀,3904,967,2937,摩根大通,2024-11-21,8440
5347,世界,3460,596,2864,摩根大通,2024-11-21,8440
2027,大成鋼,3773,953,2820,摩根大通,2024-11-21,8440
2609,陽明,5409,3078,2331,摩根大通,2024-11-21,8440
2353,宏��,3046,1597,1449,摩根大通,2024-11-21,8440
2882,國泰金,2099,780,1319,摩根大通,2024-11-21,8440
2887,台新金,2347,1080,1267,摩根大通,2024-11-21,8440
2881,富邦金,2200,957,1243,摩根大通,2024-11-21,8440
1314,中石化,1235,66,1169,摩根大通,2024-11-21,8440
2606,裕民,1291,135,1156,摩根大通,2024-11-21,8440
2634,漢翔,1149,91,1058,摩根大通,2024-11-21,8440
2520,冠德,1631,594,1037,摩根大通,2024-11-21,8440
4904,遠傳,1166,159,1007,摩根大通,2024-11-21,8440
2883,凱基金,1877,884,993,摩根大通,2024-11-21,8440
5309,系統電,1297,376,921,摩根大通,2024-11-21,8440
1802,台玻,2400,1518,882,摩根大通,2024-11-21,8440
2382,廣達,1649,769,880,摩根大通,2024-11-21,8440
2312,金寶,1556,721,835,摩根大通,2024-11-21,8440
2637,慧洋-KY,1198,471,727,摩根大通,2024-11-21,8440
6191,精成科,842,158,684,摩根大通,2024-11-21,8440
2888,新光金,777,117,660,摩根大通,2024-11-21,8440
2344,華邦電,1457,818,639,摩根大通,2024-11-21,8440
3231,緯創,1651,1037,614,摩根大通,2024-11-21,8440
6274,台燿,762,203,559,摩根大通,2024-11-21,8440
2349,錸德,1695,1163,532,摩根大通,2024-11-21,8440
2206,三陽工業,813,309,504,摩根大通,2024-11-21,8440
2474,可成,679,188,491,摩根大通,2024-11-21,8440
1449,佳和,943,468,475,摩根大通,2024-11-21,8440
4977,眾達-KY,704,251,453,摩根大通,2024-11-21,8440
2383,台光電,594,144,450,摩根大通,2024-11-21,8440
2605,新興,542,97,445,摩根大通,2024-11-21,8440
3706,神達,1695,1259,436,摩根大通,2024-11-21,8440
1216,統一,903,493,410,摩根大通,2024-11-21,8440
1605,華新,1063,676,387,摩根大通,2024-11-21,8440
8011,台通,625,244,381,摩根大通,2024-11-21,8440
3711,日月光投控,866,503,363,摩根大通,2024-11-21,8440
6770,力積電,628,272,356,摩根大通,2024-11-21,8440
6505,台塑化,596,244,352,摩根大通,2024-11-21,8440
3450,聯鈞,748,396,352,摩根大通,2024-11-21,8440
1504,東元,749,403,346,摩根大通,2024-11-21,8440
1326,台化,444,120,324,摩根大通,2024-11-21,8440
9938,百和,357,57,300,摩根大通,2024-11-21,8440
3260,威剛,298,16,282,摩根大通,2024-11-21,8440
1815,富喬,445,164,281,摩根大通,2024-11-21,8440
2542,興富發,392,116,276,摩根大通,2024-11-21,8440
3049,精金,321,46,275,摩根大通,2024-11-21,8440
3548,兆利,392,120,272,摩根大通,2024-11-21,8440
2385,群光,323,59,264,摩根大通,2024-11-21,8440
3481,群創,5464,1112,4352,摩根大通,2024-11-22,8440
2371,大同,3774,470,3304,摩根大通,2024-11-22,8440
2027,大成鋼,3179,53,3126,摩根大通,2024-11-22,8440
2884,玉山金,5815,3106,2709,摩根大通,2024-11-22,8440
9105,泰金寶-DR,2753,726,2027,摩根大通,2024-11-22,8440
2882,國泰金,2285,305,1980,摩根大通,2024-11-22,8440
2344,華邦電,2060,426,1634,摩根大通,2024-11-22,8440
2888,新光金,2062,481,1581,摩根大通,2024-11-22,8440
2618,長榮航,1956,410,1546,摩根大通,2024-11-22,8440
2634,漢翔,1708,233,1475,摩根大通,2024-11-22,8440
2520,冠德,1507,105,1402,摩根大通,2024-11-22,8440
2354,鴻準,1595,417,1178,摩根大通,2024-11-22,8440
2367,燿華,1333,200,1133,摩根大通,2024-11-22,8440
6505,台塑化,1234,142,1092,摩根大通,2024-11-22,8440
3032,偉訓,1727,686,1041,摩根大通,2024-11-22,8440
2606,裕民,1138,125,1013,摩根大通,2024-11-22,8440
2474,可成,1454,445,1009,摩根大通,2024-11-22,8440
2206,三陽工業,1029,65,964,摩根大通,2024-11-22,8440
2421,建準,1003,54,949,摩根大通,2024-11-22,8440
1802,台玻,2978,2064,914,摩根大通,2024-11-22,8440
2881,富邦金,2378,1492,886,摩根大通,2024-11-22,8440
2301,光寶科,1017,196,821,摩根大通,2024-11-22,8440
3013,晟銘電,1061,246,815,摩根大通,2024-11-22,8440
2809,京城銀,1193,397,796,摩根大通,2024-11-22,8440
2515,中工,996,204,792,摩根大通,2024-11-22,8440
1815,富喬,1677,954,723,摩根大通,2024-11-22,8440
5243,乙盛-KY,790,133,657,摩根大通,2024-11-22,8440
5347,世界,983,348,635,摩根大通,2024-11-22,8440
4968,立積,748,120,628,摩根大通,2024-11-22,8440
2454,聯發科,812,210,602,摩根大通,2024-11-22,8440
6191,精成科,608,57,551,摩根大通,2024-11-22,8440
1216,統一,673,123,550,摩根大通,2024-11-22,8440
2312,金寶,1825,1324,501,摩根大通,2024-11-22,8440
2353,宏��,844,345,499,摩根大通,2024-11-22,8440
3045,台灣大,551,55,496,摩根大通,2024-11-22,8440
3703,欣陸,634,141,493,摩根大通,2024-11-22,8440
4904,遠傳,707,226,481,摩根大通,2024-11-22,8440
1524,耿鼎,512,33,479,摩根大通,2024-11-22,8440
1442,名軒,511,32,479,摩根大通,2024-11-22,8440
5531,鄉林,493,46,447,摩根大通,2024-11-22,8440
2890,永豐金,1714,1272,442,摩根大通,2024-11-22,8440
6288,聯嘉,452,32,420,摩根大通,2024-11-22,8440
5309,系統電,1200,817,383,摩根大通,2024-11-22,8440
6147,頎邦,791,414,377,摩根大通,2024-11-22,8440
1301,台塑,573,210,363,摩根大通,2024-11-22,8440
2330,台積電,1432,1080,352,摩根大通,2024-11-22,8440
2395,研華,365,23,342,摩根大通,2024-11-22,8440
2542,興富發,566,235,331,摩根大通,2024-11-22,8440
1446,宏和,381,67,314,摩根大通,2024-11-22,8440
2637,慧洋-KY,469,156,313,摩根大通,2024-11-22,8440
2317,鴻海,24878,6701,18177,摩根大通,2024-11-25,8440
2609,陽明,17854,4815,13039,摩根大通,2024-11-25,8440
2891,中信金,18534,7362,11172,摩根大通,2024-11-25,8440
2887,台新金,21655,12149,9506,摩根大通,2024-11-25,8440
2344,華邦電,26669,18690,7979,摩根大通,2024-11-25,8440
2882,國泰金,11112,3887,7225,摩根大通,2024-11-25,8440
2888,新光金,8331,2247,6084,摩根大通,2024-11-25,8440
3231,緯創,9518,3468,6050,摩根大通,2024-11-25,8440
3481,群創,6845,1590,5255,摩根大通,2024-11-25,8440
1101,台泥,6057,1708,4349,摩根大通,2024-11-25,8440
2542,興富發,3776,275,3501,摩根大通,2024-11-25,8440
6443,元晶,3782,646,3136,摩根大通,2024-11-25,8440
2392,正崴,3671,574,3097,摩根大通,2024-11-25,8440
2308,台達電,3393,450,2943,摩根大通,2024-11-25,8440
9904,寶成,3118,400,2718,摩根大通,2024-11-25,8440
2801,彰銀,3233,743,2490,摩根大通,2024-11-25,8440
2610,華航,4192,1826,2366,摩根大通,2024-11-25,8440
2354,鴻準,3632,1294,2338,摩根大通,2024-11-25,8440
4157,太景*-KY,2818,613,2205,摩根大通,2024-11-25,8440
2312,金寶,5768,3759,2009,摩根大通,2024-11-25,8440
4142,國光生,2258,288,1970,摩根大通,2024-11-25,8440
6153,嘉聯益,2280,388,1892,摩根大通,2024-11-25,8440
2409,友達,4236,2580,1656,摩根大通,2024-11-25,8440
2486,一詮,1688,222,1466,摩根大通,2024-11-25,8440
1402,遠東新,2487,1094,1393,摩根大通,2024-11-25,8440
2474,可成,3196,1808,1388,摩根大通,2024-11-25,8440
1605,華新,2515,1168,1347,摩根大通,2024-11-25,8440
2034,允強,1617,299,1318,摩根大通,2024-11-25,8440
2890,永豐金,5290,3979,1311,摩根大通,2024-11-25,8440
8069,元太,1452,192,1260,摩根大通,2024-11-25,8440
2498,宏達電,1394,289,1105,摩根大通,2024-11-25,8440
1504,東元,1215,163,1052,摩根大通,2024-11-25,8440
2606,裕民,1338,308,1030,摩根大通,2024-11-25,8440
4958,臻鼎-KY,1237,210,1027,摩根大通,2024-11-25,8440
2812,台中銀,1396,399,997,摩根大通,2024-11-25,8440
2002,中鋼,4173,3233,940,摩根大通,2024-11-25,8440
1442,名軒,1062,127,935,摩根大通,2024-11-25,8440
8070,長華*,958,45,913,摩根大通,2024-11-25,8440
2395,研華,1309,423,886,摩根大通,2024-11-25,8440
2881,富邦金,3945,3070,875,摩根大通,2024-11-25,8440
1308,亞聚,1240,396,844,摩根大通,2024-11-25,8440
2301,光寶科,2537,1696,841,摩根大通,2024-11-25,8440
6202,盛群,977,140,837,摩根大通,2024-11-25,8440
2402,毅嘉,793,85,708,摩根大通,2024-11-25,8440
2010,春源,1278,589,689,摩根大通,2024-11-25,8440
6505,台塑化,836,155,681,摩根大通,2024-11-25,8440
2845,遠東銀,998,323,675,摩根大通,2024-11-25,8440
8942,森鉅,751,129,622,摩根大通,2024-11-25,8440
3712,永崴投控,935,321,614,摩根大通,2024-11-25,8440
1718,中纖,563,6,557,摩根大通,2024-11-25,8440
2618,長榮航,8926,988,7938,摩根大通,2024-11-26,8440
2610,華航,5456,696,4760,摩根大通,2024-11-26,8440
2888,新光金,4888,2204,2684,摩根大通,2024-11-26,8440
9105,泰金寶-DR,2336,15,2321,摩根大通,2024-11-26,8440
2882,國泰金,3439,1189,2250,摩根大通,2024-11-26,8440
2204,中華,2875,834,2041,摩根大通,2024-11-26,8440
2474,可成,1965,105,1860,摩根大通,2024-11-26,8440
2324,仁寶,2774,1010,1764,摩根大通,2024-11-26,8440
2542,興富發,1700,283,1417,摩根大通,2024-11-26,8440
1605,華新,1468,362,1106,摩根大通,2024-11-26,8440
2301,光寶科,1157,252,905,摩根大通,2024-11-26,8440
2027,大成鋼,1151,295,856,摩根大通,2024-11-26,8440
6505,台塑化,1065,283,782,摩根大通,2024-11-26,8440
6770,力積電,1595,893,702,摩根大通,2024-11-26,8440
2356,英業達,1546,865,681,摩根大通,2024-11-26,8440
2383,台光電,810,138,672,摩根大通,2024-11-26,8440
2637,慧洋-KY,745,87,658,摩根大通,2024-11-26,8440
2603,長榮,2075,1430,645,摩根大通,2024-11-26,8440
2498,宏達電,1351,742,609,摩根大通,2024-11-26,8440
2606,裕民,655,101,554,摩根大通,2024-11-26,8440
1442,名軒,610,115,495,摩根大通,2024-11-26,8440
2363,矽統,477,29,448,摩根大通,2024-11-26,8440
2534,宏盛,456,9,447,摩根大通,2024-11-26,8440
1514,亞力,505,62,443,摩根大通,2024-11-26,8440
5347,世界,829,418,411,摩根大通,2024-11-26,8440
6890,來億-KY,419,32,387,摩根大通,2024-11-26,8440
2891,中信金,2540,2165,375,摩根大通,2024-11-26,8440
6757,台灣虎航,415,77,338,摩根大通,2024-11-26,8440
1708,東鹼,342,7,335,摩根大通,2024-11-26,8440
3230,錦明,409,101,308,摩根大通,2024-11-26,8440
8104,錸寶,641,334,307,摩根大通,2024-11-26,8440
2367,燿華,392,101,291,摩根大通,2024-11-26,8440
2323,中環,323,45,278,摩根大通,2024-11-26,8440
2609,陽明,3588,3310,278,摩根大通,2024-11-26,8440
6116,彩晶,372,94,278,摩根大通,2024-11-26,8440
2351,順德,377,100,277,摩根大通,2024-11-26,8440
2393,億光,318,44,274,摩根大通,2024-11-26,8440
2520,冠德,660,390,270,摩根大通,2024-11-26,8440
3029,零壹,390,126,264,摩根大通,2024-11-26,8440
2385,群光,357,94,263,摩根大通,2024-11-26,8440
6412,群電,346,94,252,摩根大通,2024-11-26,8440
1536,和大,427,175,252,摩根大通,2024-11-26,8440
2362,藍天,258,25,233,摩根大通,2024-11-26,8440
6147,頎邦,260,36,224,摩根大通,2024-11-26,8440
2547,日勝生,313,95,218,摩根大通,2024-11-26,8440
3209,全科,227,10,217,摩根大通,2024-11-26,8440
1609,大亞,344,129,215,摩根大通,2024-11-26,8440
3576,聯合再生,230,26,204,摩根大通,2024-11-26,8440
3032,偉訓,406,203,203,摩根大通,2024-11-26,8440
2332,友訊,227,26,201,摩根大通,2024-11-26,8440
2880,華南金,10493,3387,7106,摩根大通,2024-11-27,8440
2618,長榮航,7151,1197,5954,摩根大通,2024-11-27,8440
2890,永豐金,6481,926,5555,摩根大通,2024-11-27,8440
2610,華航,5299,883,4416,摩根大通,2024-11-27,8440
2886,兆豐金,4854,1199,3655,摩根大通,2024-11-27,8440
1815,富喬,2916,294,2622,摩根大通,2024-11-27,8440
2609,陽明,4406,2542,1864,摩根大通,2024-11-27,8440
2606,裕民,1770,76,1694,摩根大通,2024-11-27,8440
2542,興富發,2200,608,1592,摩根大通,2024-11-27,8440
2637,慧洋-KY,1701,208,1493,摩根大通,2024-11-27,8440
2332,友訊,2036,551,1485,摩根大通,2024-11-27,8440
1504,東元,2495,1070,1425,摩根大通,2024-11-27,8440
3576,聯合再生,1468,123,1345,摩根大通,2024-11-27,8440
2474,可成,1454,192,1262,摩根大通,2024-11-27,8440
2892,第一金,3260,2232,1028,摩根大通,2024-11-27,8440
5347,世界,1152,209,943,摩根大通,2024-11-27,8440
5876,上海商銀,4713,3876,837,摩根大通,2024-11-27,8440
2301,光寶科,1191,539,652,摩根大通,2024-11-27,8440
4904,遠傳,898,266,632,摩根大通,2024-11-27,8440
2347,聯強,851,236,615,摩根大通,2024-11-27,8440
1528,恩德,733,158,575,摩根大通,2024-11-27,8440
2345,智邦,732,230,502,摩根大通,2024-11-27,8440
1514,亞力,506,18,488,摩根大通,2024-11-27,8440
4958,臻鼎-KY,628,157,471,摩根大通,2024-11-27,8440
6443,元晶,622,158,464,摩根大通,2024-11-27,8440
6244,茂迪,563,133,430,摩根大通,2024-11-27,8440
1802,台玻,1349,924,425,摩根大通,2024-11-27,8440
9904,寶成,514,93,421,摩根大通,2024-11-27,8440
9802,鈺齊-KY,504,87,417,摩根大通,2024-11-27,8440
2884,玉山金,1683,1271,412,摩根大通,2024-11-27,8440
1442,名軒,629,217,412,摩根大通,2024-11-27,8440
6415,矽力*-KY,450,83,367,摩根大通,2024-11-27,8440
6239,力成,456,118,338,摩根大通,2024-11-27,8440
1449,佳和,367,33,334,摩根大通,2024-11-27,8440
3293,鈊象,336,20,316,摩根大通,2024-11-27,8440
3380,明泰,424,109,315,摩根大通,2024-11-27,8440
2498,宏達電,427,114,313,摩根大通,2024-11-27,8440
2812,台中銀,328,24,304,摩根大通,2024-11-27,8440
2385,群光,331,43,288,摩根大通,2024-11-27,8440
6438,迅得,313,32,281,摩根大通,2024-11-27,8440
3049,精金,303,24,279,摩根大通,2024-11-27,8440
3665,貿聯-KY,301,30,271,摩根大通,2024-11-27,8440
2887,台新金,854,624,230,摩根大通,2024-11-27,8440
2348,海悅,225,6,219,摩根大通,2024-11-27,8440
1513,中興電,264,46,218,摩根大通,2024-11-27,8440
8044,網家,267,54,213,摩根大通,2024-11-27,8440
3149,正達,238,29,209,摩根大通,2024-11-27,8440
5534,長虹,298,99,199,摩根大通,2024-11-27,8440
4991,環宇-KY,1355,1157,198,摩根大通,2024-11-27,8440
2367,燿華,316,121,195,摩根大通,2024-11-27,8440
2890,永豐金,5606,248,5358,摩根大通,2024-11-28,8440
3706,神達,6706,1871,4835,摩根大通,2024-11-28,8440
2888,新光金,5312,601,4711,摩根大通,2024-11-28,8440
2886,兆豐金,4399,315,4084,摩根大通,2024-11-28,8440
2609,陽明,4569,1761,2808,摩根大通,2024-11-28,8440
3576,聯合再生,2653,6,2647,摩根大通,2024-11-28,8440
2618,長榮航,3204,786,2418,摩根大通,2024-11-28,8440
2884,玉山金,2744,509,2235,摩根大通,2024-11-28,8440
2885,元大金,2299,158,2141,摩根大通,2024-11-28,8440
2408,南亞科,1622,133,1489,摩根大通,2024-11-28,8440
3037,欣興,1849,467,1382,摩根大通,2024-11-28,8440
2392,正崴,2037,693,1344,摩根大通,2024-11-28,8440
5876,上海商銀,4979,3651,1328,摩根大通,2024-11-28,8440
2880,華南金,3119,1824,1295,摩根大通,2024-11-28,8440
2542,興富發,1887,677,1210,摩根大通,2024-11-28,8440
6770,力積電,1674,494,1180,摩根大通,2024-11-28,8440
2426,鼎元,1286,114,1172,摩根大通,2024-11-28,8440
2409,友達,2226,1092,1134,摩根大通,2024-11-28,8440
6443,元晶,1132,96,1036,摩根大通,2024-11-28,8440
2344,華邦電,2666,1647,1019,摩根大通,2024-11-28,8440
1101,台泥,1163,292,871,摩根大通,2024-11-28,8440
6244,茂迪,940,122,818,摩根大通,2024-11-28,8440
2606,裕民,857,114,743,摩根大通,2024-11-28,8440
6415,矽力*-KY,742,27,715,摩根大通,2024-11-28,8440
2354,鴻準,2313,1599,714,摩根大通,2024-11-28,8440
9802,鈺齊-KY,686,32,654,摩根大通,2024-11-28,8440
1216,統一,866,224,642,摩根大通,2024-11-28,8440
2883,凱基金,1362,801,561,摩根大通,2024-11-28,8440
4904,遠傳,751,212,539,摩根大通,2024-11-28,8440
6139,亞翔,542,16,526,摩根大通,2024-11-28,8440
9904,寶成,590,77,513,摩根大通,2024-11-28,8440
3049,精金,502,32,470,摩根大通,2024-11-28,8440
5347,世界,988,525,463,摩根大通,2024-11-28,8440
2347,聯強,532,73,459,摩根大通,2024-11-28,8440
1504,東元,795,336,459,摩根大通,2024-11-28,8440
1442,名軒,701,246,455,摩根大通,2024-11-28,8440
2486,一詮,491,37,454,摩根大通,2024-11-28,8440
3374,精材,457,38,419,摩根大通,2024-11-28,8440
006208,富邦台50,408,0,408,摩根大通,2024-11-28,8440
2323,中環,687,290,397,摩根大通,2024-11-28,8440
6127,九豪,558,172,386,摩根大通,2024-11-28,8440
8070,長華*,462,97,365,摩根大通,2024-11-28,8440
2637,慧洋-KY,508,177,331,摩根大通,2024-11-28,8440
3323,加百裕,417,101,316,摩根大通,2024-11-28,8440
4938,和碩,477,170,307,摩根大通,2024-11-28,8440
2363,矽統,388,85,303,摩根大通,2024-11-28,8440
2385,群光,324,27,297,摩根大通,2024-11-28,8440
6530,創威,354,89,265,摩根大通,2024-11-28,8440
9938,百和,301,39,262,摩根大通,2024-11-28,8440
3032,偉訓,459,206,253,摩根大通,2024-11-28,8440
2330,台積電,5920,2445,3475,摩根大通,2024-11-29,8440
2303,聯電,4677,1888,2789,摩根大通,2024-11-29,8440
2542,興富發,2105,79,2026,摩根大通,2024-11-29,8440
2880,華南金,3860,2243,1617,摩根大通,2024-11-29,8440
2890,永豐金,3103,1559,1544,摩根大通,2024-11-29,8440
2887,台新金,1984,580,1404,摩根大通,2024-11-29,8440
2886,兆豐金,1638,324,1314,摩根大通,2024-11-29,8440
2323,中環,993,30,963,摩根大通,2024-11-29,8440
9904,寶成,1192,266,926,摩根大通,2024-11-29,8440
5347,世界,1306,436,870,摩根大通,2024-11-29,8440
6770,力積電,1309,510,799,摩根大通,2024-11-29,8440
3711,日月光投控,1372,592,780,摩根大通,2024-11-29,8440
8171,天宇,1484,724,760,摩根大通,2024-11-29,8440
3013,晟銘電,745,67,678,摩根大通,2024-11-29,8440
4904,遠傳,789,170,619,摩根大通,2024-11-29,8440
4979,華星光,1131,512,619,摩根大通,2024-11-29,8440
2312,金寶,1398,785,613,摩根大通,2024-11-29,8440
2606,裕民,770,160,610,摩根大通,2024-11-29,8440
1442,名軒,780,201,579,摩根大通,2024-11-29,8440
2637,慧洋-KY,907,351,556,摩根大通,2024-11-29,8440
3189,景碩,742,281,461,摩根大通,2024-11-29,8440
5876,上海商銀,3698,3249,449,摩根大通,2024-11-29,8440
2474,可成,669,236,433,摩根大通,2024-11-29,8440
4303,信立,859,461,398,摩根大通,2024-11-29,8440
4991,環宇-KY,666,276,390,摩根大通,2024-11-29,8440
2382,廣達,1347,962,385,摩根大通,2024-11-29,8440
2332,友訊,468,86,382,摩根大通,2024-11-29,8440
2002,中鋼,1004,659,345,摩根大通,2024-11-29,8440
2845,遠東銀,336,0,336,摩根大通,2024-11-29,8440
1795,美時,352,17,335,摩根大通,2024-11-29,8440
1808,潤隆,375,56,319,摩根大通,2024-11-29,8440
3665,貿聯-KY,713,395,318,摩根大通,2024-11-29,8440
6180,橘子,308,2,306,摩根大通,2024-11-29,8440
6274,台燿,491,186,305,摩根大通,2024-11-29,8440
2609,陽明,3189,2890,299,摩根大通,2024-11-29,8440
2458,義隆,428,130,298,摩根大通,2024-11-29,8440
1802,台玻,1165,871,294,摩根大通,2024-11-29,8440
5465,富驊,360,67,293,摩根大通,2024-11-29,8440
4915,致伸,341,53,288,摩根大通,2024-11-29,8440
4971,IET-KY,545,259,286,摩根大通,2024-11-29,8440
1815,富喬,692,414,278,摩根大通,2024-11-29,8440
3211,順達,912,643,269,摩根大通,2024-11-29,8440
6117,迎廣,267,29,238,摩根大通,2024-11-29,8440
2426,鼎元,270,39,231,摩根大通,2024-11-29,8440
2454,聯發科,557,334,223,摩根大通,2024-11-29,8440
2610,華航,1683,1464,219,摩根大通,2024-11-29,8440
6589,台康生技,220,10,210,摩根大通,2024-11-29,8440
6223,旺矽,242,35,207,摩根大通,2024-11-29,8440
9802,鈺齊-KY,208,17,191,摩根大通,2024-11-29,8440
5907,大洋-KY,226,36,190,摩根大通,2024-11-29,8440
2303,聯電,5495,1054,4441,摩根大通,2024-12-02,8440
2618,長榮航,5198,1757,3441,摩根大通,2024-12-02,8440
2891,中信金,6522,3808,2714,摩根大通,2024-12-02,8440
2880,華南金,4169,1479,2690,摩根大通,2024-12-02,8440
2890,永豐金,4242,2048,2194,摩根大通,2024-12-02,8440
2337,旺宏,1955,13,1942,摩根大通,2024-12-02,8440
3017,奇鋐,2067,360,1707,摩根大通,2024-12-02,8440
2408,南亞科,2325,632,1693,摩根大通,2024-12-02,8440
5876,上海商銀,1722,380,1342,摩根大通,2024-12-02,8440
2884,玉山金,3028,1747,1281,摩根大通,2024-12-02,8440
6005,群益證,2047,771,1276,摩根大通,2024-12-02,8440
2542,興富發,1276,158,1118,摩根大通,2024-12-02,8440
2887,台新金,2217,1127,1090,摩根大通,2024-12-02,8440
9904,寶成,1093,200,893,摩根大通,2024-12-02,8440
2603,長榮,1175,292,883,摩根大通,2024-12-02,8440
2609,陽明,3241,2423,818,摩根大通,2024-12-02,8440
2383,台光電,959,201,758,摩根大通,2024-12-02,8440
3576,聯合再生,496,1,495,摩根大通,2024-12-02,8440
2883,凱基金,3457,3029,428,摩根大通,2024-12-02,8440
2356,英業達,1784,1362,422,摩根大通,2024-12-02,8440
2888,新光金,1307,903,404,摩根大通,2024-12-02,8440
2348,海悅,467,99,368,摩根大通,2024-12-02,8440
6535,順藥,340,5,335,摩根大通,2024-12-02,8440
2606,裕民,466,143,323,摩根大通,2024-12-02,8440
5483,中美晶,546,258,288,摩根大通,2024-12-02,8440
2855,統一證,286,0,286,摩根大通,2024-12-02,8440
2371,大同,530,249,281,摩根大通,2024-12-02,8440
3711,日月光投控,1243,969,274,摩根大通,2024-12-02,8440
2885,元大金,1357,1090,267,摩根大通,2024-12-02,8440
5522,遠雄,452,193,259,摩根大通,2024-12-02,8440
3005,神基,273,15,258,摩根大通,2024-12-02,8440
1442,名軒,375,120,255,摩根大通,2024-12-02,8440
8028,昇陽半導體,453,199,254,摩根大通,2024-12-02,8440
3149,正達,286,55,231,摩根大通,2024-12-02,8440
2419,仲琦,569,355,214,摩根大通,2024-12-02,8440
4991,環宇-KY,862,652,210,摩根大通,2024-12-02,8440
8044,網家,209,0,209,摩根大通,2024-12-02,8440
1808,潤隆,248,51,197,摩根大通,2024-12-02,8440
2881,富邦金,1567,1377,190,摩根大通,2024-12-02,8440
9933,中鼎,248,60,188,摩根大通,2024-12-02,8440
5309,系統電,358,171,187,摩根大通,2024-12-02,8440
4906,正文,201,22,179,摩根大通,2024-12-02,8440
2903,遠百,231,56,175,摩根大通,2024-12-02,8440
2345,智邦,362,192,170,摩根大通,2024-12-02,8440
3324,雙鴻,274,108,166,摩根大通,2024-12-02,8440
2332,友訊,372,210,162,摩根大通,2024-12-02,8440
4303,信立,670,508,162,摩根大通,2024-12-02,8440
8070,長華*,518,357,161,摩根大通,2024-12-02,8440
3704,合勤控,179,19,160,摩根大通,2024-12-02,8440
4714,永捷,175,26,149,摩根大通,2024-12-02,8440
2610,華航,9256,1339,7917,摩根大通,2024-12-03,8440
2883,凱基金,8471,1988,6483,摩根大通,2024-12-03,8440
2882,國泰金,4499,1054,3445,摩根大通,2024-12-03,8440
3706,神達,3915,1179,2736,摩根大通,2024-12-03,8440
2880,華南金,5308,2632,2676,摩根大通,2024-12-03,8440
2618,長榮航,5915,3342,2573,摩根大通,2024-12-03,8440
2002,中鋼,2629,254,2375,摩根大通,2024-12-03,8440
2801,彰銀,2839,781,2058,摩根大通,2024-12-03,8440
5876,上海商銀,2458,477,1981,摩根大通,2024-12-03,8440
2891,中信金,9181,7283,1898,摩根大通,2024-12-03,8440
2884,玉山金,3193,1367,1826,摩根大通,2024-12-03,8440
2888,新光金,2012,254,1758,摩根大通,2024-12-03,8440
3481,群創,2221,540,1681,摩根大通,2024-12-03,8440
2609,陽明,3047,1437,1610,摩根大通,2024-12-03,8440
1402,遠東新,1948,399,1549,摩根大通,2024-12-03,8440
2881,富邦金,1829,301,1528,摩根大通,2024-12-03,8440
6005,群益證,1733,452,1281,摩根大通,2024-12-03,8440
2449,京元電子,1570,290,1280,摩根大通,2024-12-03,8440
2603,長榮,1836,563,1273,摩根大通,2024-12-03,8440
6757,台灣虎航,1324,175,1149,摩根大通,2024-12-03,8440
2890,永豐金,3876,2742,1134,摩根大通,2024-12-03,8440
3017,奇鋐,1901,816,1085,摩根大通,2024-12-03,8440
2637,慧洋-KY,1002,16,986,摩根大通,2024-12-03,8440
2883B,凱基金乙特,939,30,909,摩根大通,2024-12-03,8440
5347,世界,1166,261,905,摩根大通,2024-12-03,8440
1504,東元,1029,134,895,摩根大通,2024-12-03,8440
2324,仁寶,1325,546,779,摩根大通,2024-12-03,8440
1326,台化,1037,265,772,摩根大通,2024-12-03,8440
2383,台光電,1021,260,761,摩根大通,2024-12-03,8440
6116,彩晶,776,47,729,摩根大通,2024-12-03,8440
2606,裕民,774,68,706,摩根大通,2024-12-03,8440
1301,台塑,783,141,642,摩根大通,2024-12-03,8440
2344,華邦電,1223,584,639,摩根大通,2024-12-03,8440
2646,星宇航空,646,29,617,摩根大通,2024-12-03,8440
2542,興富發,1520,911,609,摩根大通,2024-12-03,8440
2412,中華電,1007,398,609,摩根大通,2024-12-03,8440
2356,英業達,1513,915,598,摩根大通,2024-12-03,8440
4904,遠傳,931,361,570,摩根大通,2024-12-03,8440
2301,光寶科,1208,646,562,摩根大通,2024-12-03,8440
3045,台灣大,958,433,525,摩根大通,2024-12-03,8440
1442,名軒,674,194,480,摩根大通,2024-12-03,8440
2393,億光,749,275,474,摩根大通,2024-12-03,8440
9910,豐泰,562,95,467,摩根大通,2024-12-03,8440
2201,裕隆,492,39,453,摩根大通,2024-12-03,8440
5309,系統電,913,472,441,摩根大通,2024-12-03,8440
1519,華城,668,241,427,摩根大通,2024-12-03,8440
5328,華容,565,205,360,摩根大通,2024-12-03,8440
1449,佳和,703,347,356,摩根大通,2024-12-03,8440
9105,泰金寶-DR,540,193,347,摩根大通,2024-12-03,8440
6223,旺矽,446,121,325,摩根大通,2024-12-03,8440
5876,上海商銀,4334,1545,2789,摩根大通,2024-12-04,8440
3711,日月光投控,2866,792,2074,摩根大通,2024-12-04,8440
2880,華南金,4135,2507,1628,摩根大通,2024-12-04,8440
2542,興富發,1644,117,1527,摩根大通,2024-12-04,8440
2303,聯電,2449,1044,1405,摩根大通,2024-12-04,8440
3706,神達,3515,2233,1282,摩根大通,2024-12-04,8440
2458,義隆,1281,58,1223,摩根大通,2024-12-04,8440
5328,華容,1591,397,1194,摩根大通,2024-12-04,8440
3450,聯鈞,1732,547,1185,摩根大通,2024-12-04,8440
2637,慧洋-KY,1244,97,1147,摩根大通,2024-12-04,8440
6127,九豪,1361,283,1078,摩根大通,2024-12-04,8440
1815,富喬,1399,329,1070,摩根大通,2024-12-04,8440
2801,彰銀,1058,157,901,摩根大通,2024-12-04,8440
2603,長榮,1219,425,794,摩根大通,2024-12-04,8440
9904,寶成,2247,1482,765,摩根大通,2024-12-04,8440
4904,遠傳,1127,392,735,摩根大通,2024-12-04,8440
8171,天宇,1100,374,726,摩根大通,2024-12-04,8440
6005,群益證,1187,488,699,摩根大通,2024-12-04,8440
2606,裕民,896,231,665,摩根大通,2024-12-04,8440
2609,陽明,2066,1414,652,摩根大通,2024-12-04,8440
3078,僑威,575,40,535,摩根大通,2024-12-04,8440
6213,聯茂,537,9,528,摩根大通,2024-12-04,8440
1504,東元,740,239,501,摩根大通,2024-12-04,8440
8112,至上,545,45,500,摩根大通,2024-12-04,8440
2887,台新金,1771,1273,498,摩根大通,2024-12-04,8440
5347,世界,1557,1088,469,摩根大通,2024-12-04,8440
6116,彩晶,460,28,432,摩根大通,2024-12-04,8440
9105,泰金寶-DR,497,66,431,摩根大通,2024-12-04,8440
2615,萬海,614,201,413,摩根大通,2024-12-04,8440
3481,群創,914,529,385,摩根大通,2024-12-04,8440
2520,冠德,526,146,380,摩根大通,2024-12-04,8440
5439,高技,554,187,367,摩根大通,2024-12-04,8440
5871,中租-KY,412,72,340,摩根大通,2024-12-04,8440
3019,亞光,369,46,323,摩根大通,2024-12-04,8440
3661,世芯-KY,383,89,294,摩根大通,2024-12-04,8440
4991,環宇-KY,687,393,294,摩根大通,2024-12-04,8440
2855,統一證,307,18,289,摩根大通,2024-12-04,8440
3591,艾笛森,792,506,286,摩根大通,2024-12-04,8440
3045,台灣大,972,692,280,摩根大通,2024-12-04,8440
6176,瑞儀,316,49,267,摩根大通,2024-12-04,8440
2393,億光,828,562,266,摩根大通,2024-12-04,8440
6174,安��,261,4,257,摩根大通,2024-12-04,8440
4128,中天,272,17,255,摩根大通,2024-12-04,8440
2344,華邦電,596,346,250,摩根大通,2024-12-04,8440
3234,光環,313,63,250,摩根大通,2024-12-04,8440
2353,宏��,737,488,249,摩根大通,2024-12-04,8440
2472,立隆電,287,42,245,摩根大通,2024-12-04,8440
2441,超豐,283,41,242,摩根大通,2024-12-04,8440
6901,鑽石投資,251,13,238,摩根大通,2024-12-04,8440
2006,東和鋼鐵,282,44,238,摩根大通,2024-12-04,8440
2883,凱基金,7713,1032,6681,摩根大通,2024-12-05,8440
2880,華南金,3468,441,3027,摩根大通,2024-12-05,8440
5876,上海商銀,2840,631,2209,摩根大通,2024-12-05,8440
2886,兆豐金,2064,461,1603,摩根大通,2024-12-05,8440
9904,寶成,2155,629,1526,摩根大通,2024-12-05,8440
2542,興富發,1559,138,1421,摩根大通,2024-12-05,8440
2888,新光金,1398,32,1366,摩根大通,2024-12-05,8440
2801,彰銀,1935,691,1244,摩根大通,2024-12-05,8440
5347,世界,1467,307,1160,摩根大通,2024-12-05,8440
2393,億光,1070,13,1057,摩根大通,2024-12-05,8440
2383,台光電,1184,129,1055,摩根大通,2024-12-05,8440
3706,神達,2913,1919,994,摩根大通,2024-12-05,8440
2458,義隆,1001,16,985,摩根大通,2024-12-05,8440
4904,遠傳,1044,119,925,摩根大通,2024-12-05,8440
2606,裕民,930,21,909,摩根大通,2024-12-05,8440
3045,台灣大,1145,237,908,摩根大通,2024-12-05,8440
2646,星宇航空,799,12,787,摩根大通,2024-12-05,8440
2887,台新金,2646,1895,751,摩根大通,2024-12-05,8440
2486,一詮,1414,737,677,摩根大通,2024-12-05,8440
2609,陽明,1673,1007,666,摩根大通,2024-12-05,8440
2332,友訊,1175,599,576,摩根大通,2024-12-05,8440
2344,華邦電,1237,664,573,摩根大通,2024-12-05,8440
2637,慧洋-KY,799,261,538,摩根大通,2024-12-05,8440
2449,京元電子,720,187,533,摩根大通,2024-12-05,8440
2301,光寶科,850,318,532,摩根大通,2024-12-05,8440
2454,聯發科,655,148,507,摩根大通,2024-12-05,8440
2603,長榮,697,215,482,摩根大通,2024-12-05,8440
3689,湧德,565,87,478,摩根大通,2024-12-05,8440
6005,群益證,1057,644,413,摩根大通,2024-12-05,8440
2495,普安,533,136,397,摩根大通,2024-12-05,8440
2308,台達電,583,188,395,摩根大通,2024-12-05,8440
2303,聯電,857,473,384,摩根大通,2024-12-05,8440
1442,名軒,800,446,354,摩根大通,2024-12-05,8440
2882,國泰金,916,573,343,摩根大通,2024-12-05,8440
2382,廣達,777,436,341,摩根大通,2024-12-05,8440
2439,美律,352,16,336,摩根大通,2024-12-05,8440
8112,至上,633,297,336,摩根大通,2024-12-05,8440
3591,艾笛森,489,157,332,摩根大通,2024-12-05,8440
3189,景碩,389,68,321,摩根大通,2024-12-05,8440
1504,東元,423,116,307,摩根大通,2024-12-05,8440
3029,零壹,489,185,304,摩根大通,2024-12-05,8440
2312,金寶,649,346,303,摩根大通,2024-12-05,8440
2441,超豐,323,25,298,摩根大通,2024-12-05,8440
6757,台灣虎航,311,21,290,摩根大通,2024-12-05,8440
2014,中鴻,362,77,285,摩根大通,2024-12-05,8440
2385,群光,373,90,283,摩根大通,2024-12-05,8440
2615,萬海,335,52,283,摩根大通,2024-12-05,8440
3605,宏致,280,0,280,摩根大通,2024-12-05,8440
8070,長華*,586,312,274,摩根大通,2024-12-05,8440
4915,致伸,304,32,272,摩根大通,2024-12-05,8440
2887,台新金,13523,793,12730,摩根大通,2024-12-06,8440
2449,京元電子,5800,267,5533,摩根大通,2024-12-06,8440
2880,華南金,6110,742,5368,摩根大通,2024-12-06,8440
3231,緯創,6457,2358,4099,摩根大通,2024-12-06,8440
2883,凱基金,4657,978,3679,摩根大通,2024-12-06,8440
5876,上海商銀,5008,1635,3373,摩根大通,2024-12-06,8440
2303,聯電,3930,561,3369,摩根大通,2024-12-06,8440
2881,富邦金,3156,302,2854,摩根大通,2024-12-06,8440
2609,陽明,3027,802,2225,摩根大通,2024-12-06,8440
2801,彰銀,2701,744,1957,摩根大通,2024-12-06,8440
2542,興富發,1548,33,1515,摩根大通,2024-12-06,8440
3029,零壹,1623,211,1412,摩根大通,2024-12-06,8440
2885,元大金,2177,899,1278,摩根大通,2024-12-06,8440
3481,群創,1207,67,1140,摩根大通,2024-12-06,8440
5347,世界,1260,134,1126,摩根大通,2024-12-06,8440
3045,台灣大,1256,201,1055,摩根大通,2024-12-06,8440
1785,光洋科,1317,321,996,摩根大通,2024-12-06,8440
2606,裕民,1213,226,987,摩根大通,2024-12-06,8440
2353,宏��,1077,96,981,摩根大通,2024-12-06,8440
2308,台達電,1227,287,940,摩根大通,2024-12-06,8440
6005,群益證,1311,403,908,摩根大通,2024-12-06,8440
2324,仁寶,1134,228,906,摩根大通,2024-12-06,8440
4904,遠傳,978,219,759,摩根大通,2024-12-06,8440
1402,遠東新,1121,433,688,摩根大通,2024-12-06,8440
2388,威盛,778,104,674,摩根大通,2024-12-06,8440
2383,台光電,968,351,617,摩根大通,2024-12-06,8440
2637,慧洋-KY,1202,636,566,摩根大通,2024-12-06,8440
3694,海華,793,234,559,摩根大通,2024-12-06,8440
2393,億光,733,175,558,摩根大通,2024-12-06,8440
3711,日月光投控,2187,1651,536,摩根大通,2024-12-06,8440
6505,台塑化,1468,948,520,摩根大通,2024-12-06,8440
1442,名軒,830,325,505,摩根大通,2024-12-06,8440
5328,華容,465,23,442,摩根大通,2024-12-06,8440
2820,華票,427,4,423,摩根大通,2024-12-06,8440
6443,元晶,658,239,419,摩根大通,2024-12-06,8440
2603,長榮,1032,619,413,摩根大通,2024-12-06,8440
2439,美律,452,41,411,摩根大通,2024-12-06,8440
4919,新唐,736,340,396,摩根大通,2024-12-06,8440
2101,南港,397,6,391,摩根大通,2024-12-06,8440
2344,華邦電,3760,3370,390,摩根大通,2024-12-06,8440
1513,中興電,522,138,384,摩根大通,2024-12-06,8440
2347,聯強,517,136,381,摩根大通,2024-12-06,8440
5871,中租-KY,519,139,380,摩根大通,2024-12-06,8440
2534,宏盛,380,5,375,摩根大通,2024-12-06,8440
3576,聯合再生,392,18,374,摩根大通,2024-12-06,8440
2301,光寶科,462,124,338,摩根大通,2024-12-06,8440
8112,至上,695,365,330,摩根大通,2024-12-06,8440
1210,大成,334,7,327,摩根大通,2024-12-06,8440
5244,弘凱,425,107,318,摩根大通,2024-12-06,8440
2323,中環,370,56,314,摩根大通,2024-12-06,8440
2618,長榮航,15813,6983,8830,摩根大通,2024-12-09,8440
2887,台新金,7855,1981,5874,摩根大通,2024-12-09,8440
2801,彰銀,4226,418,3808,摩根大通,2024-12-09,8440
2609,陽明,7228,3836,3392,摩根大通,2024-12-09,8440
5876,上海商銀,5452,2738,2714,摩根大通,2024-12-09,8440
5880,合庫金,1485,139,1346,摩根大通,2024-12-09,8440
1605,華新,2705,1385,1320,摩根大通,2024-12-09,8440
6005,群益證,1190,18,1172,摩根大通,2024-12-09,8440
5522,遠雄,944,70,874,摩根大通,2024-12-09,8440
2880,華南金,4711,3867,844,摩根大通,2024-12-09,8440
2308,台達電,1404,635,769,摩根大通,2024-12-09,8440
2881,富邦金,1263,503,760,摩根大通,2024-12-09,8440
6451,訊芯-KY,1107,423,684,摩根大通,2024-12-09,8440
2886,兆豐金,798,119,679,摩根大通,2024-12-09,8440
2646,星宇航空,629,46,583,摩根大通,2024-12-09,8440
2885,元大金,884,342,542,摩根大通,2024-12-09,8440
1444,力麗,546,16,530,摩根大通,2024-12-09,8440
1442,名軒,748,225,523,摩根大通,2024-12-09,8440
3293,鈊象,570,50,520,摩根大通,2024-12-09,8440
3323,加百裕,587,73,514,摩根大通,2024-12-09,8440
2312,金寶,577,123,454,摩根大通,2024-12-09,8440
1402,遠東新,1054,623,431,摩根大通,2024-12-09,8440
1721,三晃,435,21,414,摩根大通,2024-12-09,8440
2408,南亞科,449,52,397,摩根大通,2024-12-09,8440
3576,聯合再生,365,16,349,摩根大通,2024-12-09,8440
6442,光聖,417,69,348,摩根大通,2024-12-09,8440
8070,長華*,391,78,313,摩根大通,2024-12-09,8440
4979,華星光,568,270,298,摩根大通,2024-12-09,8440
2812,台中銀,423,169,254,摩根大通,2024-12-09,8440
3234,光環,501,253,248,摩根大通,2024-12-09,8440
2888,新光金,470,237,233,摩根大通,2024-12-09,8440
3015,全漢,239,24,215,摩根大通,2024-12-09,8440
8044,網家,210,4,206,摩根大通,2024-12-09,8440
2426,鼎元,260,64,196,摩根大通,2024-12-09,8440
3712,永崴投控,225,29,196,摩根大通,2024-12-09,8440
3558,神準,271,76,195,摩根大通,2024-12-09,8440
9105,泰金寶-DR,194,2,192,摩根大通,2024-12-09,8440
5426,振發,193,7,186,摩根大通,2024-12-09,8440
8096,擎亞,341,157,184,摩根大通,2024-12-09,8440
2329,華泰,185,1,184,摩根大通,2024-12-09,8440
1303,南亞,444,270,174,摩根大通,2024-12-09,8440
3227,原相,226,54,172,摩根大通,2024-12-09,8440
3447,展達,197,25,172,摩根大通,2024-12-09,8440
5481,新華,261,98,163,摩根大通,2024-12-09,8440
3162,精確,173,10,163,摩根大通,2024-12-09,8440
2383,台光電,302,140,162,摩根大通,2024-12-09,8440
3049,精金,206,48,158,摩根大通,2024-12-09,8440
2376,技嘉,165,8,157,摩根大通,2024-12-09,8440
6937,天虹,458,308,150,摩根大通,2024-12-09,8440
2471,資通,478,329,149,摩根大通,2024-12-09,8440
2887,台新金,7700,1548,6152,摩根大通,2024-12-10,8440
9904,寶成,4180,217,3963,摩根大通,2024-12-10,8440
1785,光洋科,2744,629,2115,摩根大通,2024-12-10,8440
2801,彰銀,2758,810,1948,摩根大通,2024-12-10,8440
5871,中租-KY,1422,204,1218,摩根大通,2024-12-10,8440
1605,華新,2203,1105,1098,摩根大通,2024-12-10,8440
00830,國泰費城半導體,1000,0,1000,摩根大通,2024-12-10,8440
2618,長榮航,4028,3177,851,摩根大通,2024-12-10,8440
2356,英業達,1167,360,807,摩根大通,2024-12-10,8440
3029,零壹,957,223,734,摩根大通,2024-12-10,8440
2886,兆豐金,1216,497,719,摩根大通,2024-12-10,8440
2454,聯發科,972,270,702,摩根大通,2024-12-10,8440
3045,台灣大,768,92,676,摩根大通,2024-12-10,8440
2313,華通,1100,505,595,摩根大通,2024-12-10,8440
2354,鴻準,1003,461,542,摩根大通,2024-12-10,8440
4931,新盛力,657,133,524,摩根大通,2024-12-10,8440
00757,統一FANG+,500,0,500,摩根大通,2024-12-10,8440
00885,富邦越南,500,0,500,摩根大通,2024-12-10,8440
5876,上海商銀,1979,1493,486,摩根大通,2024-12-10,8440
2646,星宇航空,542,107,435,摩根大通,2024-12-10,8440
1442,名軒,496,67,429,摩根大通,2024-12-10,8440
5880,合庫金,1443,1016,427,摩根大通,2024-12-10,8440
2344,華邦電,480,64,416,摩根大通,2024-12-10,8440
1301,台塑,815,404,411,摩根大通,2024-12-10,8440
3607,谷崧,597,233,364,摩根大通,2024-12-10,8440
2543,皇昌,440,78,362,摩根大通,2024-12-10,8440
4904,遠傳,550,189,361,摩根大通,2024-12-10,8440
9907,統一實,345,11,334,摩根大通,2024-12-10,8440
6558,興能高,385,54,331,摩根大通,2024-12-10,8440
4915,致伸,375,44,331,摩根大通,2024-12-10,8440
9938,百和,471,148,323,摩根大通,2024-12-10,8440
6684,安格,495,183,312,摩根大通,2024-12-10,8440
3211,順達,529,256,273,摩根大通,2024-12-10,8440
2408,南亞科,894,627,267,摩根大通,2024-12-10,8440
3661,世芯-KY,414,154,260,摩根大通,2024-12-10,8440
2542,興富發,321,65,256,摩根大通,2024-12-10,8440
2323,中環,289,34,255,摩根大通,2024-12-10,8440
2504,國產,338,84,254,摩根大通,2024-12-10,8440
2105,正新,345,98,247,摩根大通,2024-12-10,8440
2383,台光電,282,47,235,摩根大通,2024-12-10,8440
5347,世界,560,327,233,摩根大通,2024-12-10,8440
3047,訊舟,246,14,232,摩根大通,2024-12-10,8440
6005,群益證,992,761,231,摩根大通,2024-12-10,8440
3019,亞光,358,131,227,摩根大通,2024-12-10,8440
4743,合一,320,116,204,摩根大通,2024-12-10,8440
4967,十銓,261,62,199,摩根大通,2024-12-10,8440
2498,宏達電,231,41,190,摩根大通,2024-12-10,8440
2458,義隆,220,31,189,摩根大通,2024-12-10,8440
6695,芯鼎,316,133,183,摩根大通,2024-12-10,8440
2308,台達電,897,716,181,摩根大通,2024-12-10,8440
2887,台新金,9953,1051,8902,摩根大通,2024-12-11,8440
2884,玉山金,4133,459,3674,摩根大通,2024-12-11,8440
2313,華通,3700,113,3587,摩根大通,2024-12-11,8440
2801,彰銀,3497,165,3332,摩根大通,2024-12-11,8440
2888,新光金,3240,270,2970,摩根大通,2024-12-11,8440
5880,合庫金,3286,577,2709,摩根大通,2024-12-11,8440
2892,第一金,2535,189,2346,摩根大通,2024-12-11,8440
1802,台玻,3149,845,2304,摩根大通,2024-12-11,8440
2890,永豐金,2772,800,1972,摩根大通,2024-12-11,8440
2353,宏��,2353,429,1924,摩根大通,2024-12-11,8440
2330,台積電,3163,1349,1814,摩根大通,2024-12-11,8440
2882,國泰金,2495,711,1784,摩根大通,2024-12-11,8440
2885,元大金,2220,455,1765,摩根大通,2024-12-11,8440
2886,兆豐金,2540,921,1619,摩根大通,2024-12-11,8440
2356,英業達,1654,78,1576,摩根大通,2024-12-11,8440
2409,友達,2347,874,1473,摩根大通,2024-12-11,8440
2317,鴻海,3704,2306,1398,摩根大通,2024-12-11,8440
2308,台達電,2056,773,1283,摩根大通,2024-12-11,8440
6005,群益證,1197,69,1128,摩根大通,2024-12-11,8440
2881,富邦金,1800,837,963,摩根大通,2024-12-11,8440
2344,華邦電,1903,969,934,摩根大通,2024-12-11,8440
2891,中信金,2534,1689,845,摩根大通,2024-12-11,8440
3231,緯創,1200,501,699,摩根大通,2024-12-11,8440
2834,臺企銀,741,50,691,摩根大通,2024-12-11,8440
2368,金像電,740,190,550,摩根大通,2024-12-11,8440
1442,名軒,712,179,533,摩根大通,2024-12-11,8440
3481,群創,894,410,484,摩根大通,2024-12-11,8440
6412,群電,496,41,455,摩根大通,2024-12-11,8440
4904,遠傳,520,101,419,摩根大通,2024-12-11,8440
2382,廣達,831,419,412,摩根大通,2024-12-11,8440
1216,統一,652,243,409,摩根大通,2024-12-11,8440
1101,台泥,1055,659,396,摩根大通,2024-12-11,8440
2301,光寶科,646,254,392,摩根大通,2024-12-11,8440
6770,力積電,727,335,392,摩根大通,2024-12-11,8440
2365,昆盈,436,59,377,摩根大通,2024-12-11,8440
2495,普安,373,1,372,摩根大通,2024-12-11,8440
5328,華容,407,58,349,摩根大通,2024-12-11,8440
4958,臻鼎-KY,414,69,345,摩根大通,2024-12-11,8440
2633,台灣高鐵,379,37,342,摩根大通,2024-12-11,8440
1326,台化,684,353,331,摩根大通,2024-12-11,8440
6505,台塑化,634,311,323,摩根大通,2024-12-11,8440
4938,和碩,549,239,310,摩根大通,2024-12-11,8440
2408,南亞科,669,364,305,摩根大通,2024-12-11,8440
1605,華新,1329,1029,300,摩根大通,2024-12-11,8440
3044,健鼎,339,42,297,摩根大通,2024-12-11,8440
3706,神達,703,423,280,摩根大通,2024-12-11,8440
2105,正新,380,103,277,摩根大通,2024-12-11,8440
4971,IET-KY,333,57,276,摩根大通,2024-12-11,8440
2374,佳能,287,11,276,摩根大通,2024-12-11,8440
1528,恩德,389,125,264,摩根大通,2024-12-11,8440
2887,台新金,8727,1316,7411,摩根大通,2024-12-12,8440
2881,富邦金,6461,332,6129,摩根大通,2024-12-12,8440
2618,長榮航,6476,2568,3908,摩根大通,2024-12-12,8440
2882,國泰金,4205,636,3569,摩根大通,2024-12-12,8440
2801,彰銀,3875,345,3530,摩根大通,2024-12-12,8440
2313,華通,3481,773,2708,摩根大通,2024-12-12,8440
2891,中信金,5457,2954,2503,摩根大通,2024-12-12,8440
2885,元大金,2753,260,2493,摩根大通,2024-12-12,8440
2344,華邦電,2410,81,2329,摩根大通,2024-12-12,8440
2356,英業達,2343,362,1981,摩根大通,2024-12-12,8440
6505,台塑化,1809,151,1658,摩根大通,2024-12-12,8440
2330,台積電,2879,1449,1430,摩根大通,2024-12-12,8440
6770,力積電,1775,347,1428,摩根大通,2024-12-12,8440
3019,亞光,1582,256,1326,摩根大通,2024-12-12,8440
2353,宏��,2040,801,1239,摩根大通,2024-12-12,8440
3062,建漢,1276,83,1193,摩根大通,2024-12-12,8440
4958,臻鼎-KY,1395,288,1107,摩根大通,2024-12-12,8440
1326,台化,1119,113,1006,摩根大通,2024-12-12,8440
6187,萬潤,1079,140,939,摩根大通,2024-12-12,8440
1605,華新,1308,409,899,摩根大通,2024-12-12,8440
5880,合庫金,1115,292,823,摩根大通,2024-12-12,8440
9945,潤泰新,827,36,791,摩根大通,2024-12-12,8440
9921,巨大,748,31,717,摩根大通,2024-12-12,8440
2408,南亞科,1068,362,706,摩根大通,2024-12-12,8440
1524,耿鼎,704,104,600,摩根大通,2024-12-12,8440
2383,台光電,627,47,580,摩根大通,2024-12-12,8440
6462,神盾,573,25,548,摩根大通,2024-12-12,8440
2360,致茂,774,233,541,摩根大通,2024-12-12,8440
9904,寶成,845,356,489,摩根大通,2024-12-12,8440
6215,和椿,531,60,471,摩根大通,2024-12-12,8440
2308,台達電,1025,580,445,摩根大通,2024-12-12,8440
2368,金像電,914,478,436,摩根大通,2024-12-12,8440
2834,臺企銀,569,139,430,摩根大通,2024-12-12,8440
2359,所羅門,627,215,412,摩根大通,2024-12-12,8440
3323,加百裕,433,38,395,摩根大通,2024-12-12,8440
2301,光寶科,702,311,391,摩根大通,2024-12-12,8440
2884,玉山金,1117,727,390,摩根大通,2024-12-12,8440
6005,群益證,1001,630,371,摩根大通,2024-12-12,8440
3014,聯陽,362,21,341,摩根大通,2024-12-12,8440
2365,昆盈,500,187,313,摩根大通,2024-12-12,8440
3264,欣銓,363,56,307,摩根大通,2024-12-12,8440
8114,振樺電,318,21,297,摩根大通,2024-12-12,8440
1442,名軒,651,370,281,摩根大通,2024-12-12,8440
3044,健鼎,379,98,281,摩根大通,2024-12-12,8440
5876,上海商銀,658,381,277,摩根大通,2024-12-12,8440
2374,佳能,793,519,274,摩根大通,2024-12-12,8440
4904,遠傳,316,46,270,摩根大通,2024-12-12,8440
3045,台灣大,352,86,266,摩根大通,2024-12-12,8440
6805,富世達,304,40,264,摩根大通,2024-12-12,8440
3545,敦泰,283,22,261,摩根大通,2024-12-12,8440
2618,長榮航,3955,1034,2921,摩根大通,2024-12-13,8440
3019,亞光,3123,312,2811,摩根大通,2024-12-13,8440
6770,力積電,2726,292,2434,摩根大通,2024-12-13,8440
3711,日月光投控,2754,603,2151,摩根大通,2024-12-13,8440
1326,台化,1329,126,1203,摩根大通,2024-12-13,8440
4540,全球傳動,2851,1716,1135,摩根大通,2024-12-13,8440
2354,鴻準,1115,190,925,摩根大通,2024-12-13,8440
3706,神達,2597,1719,878,摩根大通,2024-12-13,8440
3450,聯鈞,1232,360,872,摩根大通,2024-12-13,8440
2312,金寶,835,44,791,摩根大通,2024-12-13,8440
6187,萬潤,759,40,719,摩根大通,2024-12-13,8440
00830,國泰費城半導體,700,0,700,摩根大通,2024-12-13,8440
2345,智邦,769,92,677,摩根大通,2024-12-13,8440
2809,京城銀,754,103,651,摩根大通,2024-12-13,8440
2412,中華電,719,94,625,摩根大通,2024-12-13,8440
2308,台達電,1518,907,611,摩根大通,2024-12-13,8440
3044,健鼎,515,43,472,摩根大通,2024-12-13,8440
8069,元太,555,88,467,摩根大通,2024-12-13,8440
1605,華新,684,221,463,摩根大通,2024-12-13,8440
8070,長華*,501,41,460,摩根大通,2024-12-13,8440
2344,華邦電,610,171,439,摩根大通,2024-12-13,8440
2454,聯發科,851,415,436,摩根大通,2024-12-13,8440
9802,鈺齊-KY,660,239,421,摩根大通,2024-12-13,8440
3661,世芯-KY,696,286,410,摩根大通,2024-12-13,8440
3576,聯合再生,446,39,407,摩根大通,2024-12-13,8440
1904,正隆,379,7,372,摩根大通,2024-12-13,8440
1301,台塑,974,606,368,摩根大通,2024-12-13,8440
2886,兆豐金,719,378,341,摩根大通,2024-12-13,8440
1101,台泥,785,449,336,摩根大通,2024-12-13,8440
3032,偉訓,337,5,332,摩根大通,2024-12-13,8440
2888,新光金,399,74,325,摩根大通,2024-12-13,8440
1609,大亞,393,79,314,摩根大通,2024-12-13,8440
6505,台塑化,375,67,308,摩根大通,2024-12-13,8440
4743,合一,463,165,298,摩根大通,2024-12-13,8440
3029,零壹,622,329,293,摩根大通,2024-12-13,8440
3017,奇鋐,345,57,288,摩根大通,2024-12-13,8440
2399,映泰,288,15,273,摩根大通,2024-12-13,8440
5439,高技,435,162,273,摩根大通,2024-12-13,8440
6805,富世達,282,10,272,摩根大通,2024-12-13,8440
5481,新華,329,66,263,摩根大通,2024-12-13,8440
6757,台灣虎航,309,47,262,摩根大通,2024-12-13,8440
2892,第一金,424,163,261,摩根大通,2024-12-13,8440
8436,大江,264,4,260,摩根大通,2024-12-13,8440
1808,潤隆,350,92,258,摩根大通,2024-12-13,8440
9105,泰金寶-DR,296,42,254,摩根大通,2024-12-13,8440
6558,興能高,246,1,245,摩根大通,2024-12-13,8440
1102,亞泥,349,104,245,摩根大通,2024-12-13,8440
3090,日電貿,288,54,234,摩根大通,2024-12-13,8440
2357,華碩,290,79,211,摩根大通,2024-12-13,8440
2359,所羅門,443,240,203,摩根大通,2024-12-13,8440
2618,長榮航,8037,1602,6435,摩根大通,2024-12-16,8440
2885,元大金,6083,629,5454,摩根大通,2024-12-16,8440
2308,台達電,2559,428,2131,摩根大通,2024-12-16,8440
2888,新光金,1825,58,1767,摩根大通,2024-12-16,8440
6770,力積電,1954,469,1485,摩根大通,2024-12-16,8440
2354,鴻準,1630,288,1342,摩根大通,2024-12-16,8440
2408,南亞科,1414,236,1178,摩根大通,2024-12-16,8440
1216,統一,1672,498,1174,摩根大通,2024-12-16,8440
2344,華邦電,1390,245,1145,摩根大通,2024-12-16,8440
3045,台灣大,1457,328,1129,摩根大通,2024-12-16,8440
2891,中信金,3025,2010,1015,摩根大通,2024-12-16,8440
2892,第一金,1273,298,975,摩根大通,2024-12-16,8440
1815,富喬,1252,347,905,摩根大通,2024-12-16,8440
2882,國泰金,1896,1025,871,摩根大通,2024-12-16,8440
1102,亞泥,889,22,867,摩根大通,2024-12-16,8440
8070,長華*,1353,490,863,摩根大通,2024-12-16,8440
2374,佳能,1161,400,761,摩根大通,2024-12-16,8440
1101,台泥,1121,375,746,摩根大通,2024-12-16,8440
2801,彰銀,992,298,694,摩根大通,2024-12-16,8440
4956,光鋐,675,22,653,摩根大通,2024-12-16,8440
2886,兆豐金,861,224,637,摩根大通,2024-12-16,8440
1301,台塑,960,327,633,摩根大通,2024-12-16,8440
3264,欣銓,684,67,617,摩根大通,2024-12-16,8440
3706,神達,2468,1865,603,摩根大通,2024-12-16,8440
9921,巨大,801,203,598,摩根大通,2024-12-16,8440
6962,ITH-KY,596,57,539,摩根大通,2024-12-16,8440
2881,富邦金,810,291,519,摩根大通,2024-12-16,8440
2360,致茂,530,19,511,摩根大通,2024-12-16,8440
5483,中美晶,556,72,484,摩根大通,2024-12-16,8440
2356,英業達,654,191,463,摩根大通,2024-12-16,8440
3044,健鼎,556,94,462,摩根大通,2024-12-16,8440
3591,艾笛森,435,14,421,摩根大通,2024-12-16,8440
3323,加百裕,522,108,414,摩根大通,2024-12-16,8440
6589,台康生技,500,95,405,摩根大通,2024-12-16,8440
1326,台化,779,389,390,摩根大通,2024-12-16,8440
5871,中租-KY,726,348,378,摩根大通,2024-12-16,8440
6805,富世達,391,31,360,摩根大通,2024-12-16,8440
4958,臻鼎-KY,582,245,337,摩根大通,2024-12-16,8440
3661,世芯-KY,643,314,329,摩根大通,2024-12-16,8440
4743,合一,322,12,310,摩根大通,2024-12-16,8440
3032,偉訓,386,84,302,摩根大通,2024-12-16,8440
1514,亞力,347,45,302,摩根大通,2024-12-16,8440
6191,精成科,307,11,296,摩根大通,2024-12-16,8440
3019,亞光,1658,1389,269,摩根大通,2024-12-16,8440
3702,大聯大,323,55,268,摩根大通,2024-12-16,8440
2495,普安,336,70,266,摩根大通,2024-12-16,8440
3576,聯合再生,327,66,261,摩根大通,2024-12-16,8440
2515,中工,357,105,252,摩根大通,2024-12-16,8440
3211,順達,589,341,248,摩根大通,2024-12-16,8440
9914,美利達,265,18,247,摩根大通,2024-12-16,8440
2618,長榮航,7768,4034,3734,摩根大通,2024-12-17,8440
2885,元大金,7681,4317,3364,摩根大通,2024-12-17,8440
3264,欣銓,1779,87,1692,摩根大通,2024-12-17,8440
2880,華南金,6606,5086,1520,摩根大通,2024-12-17,8440
2889,國票金,1784,265,1519,摩根大通,2024-12-17,8440
2609,陽明,4130,2624,1506,摩根大通,2024-12-17,8440
2368,金像電,1842,405,1437,摩根大通,2024-12-17,8440
8070,長華*,1734,391,1343,摩根大通,2024-12-17,8440
2313,華通,1902,658,1244,摩根大通,2024-12-17,8440
2308,台達電,2757,1611,1146,摩根大通,2024-12-17,8440
2845,遠東銀,1146,64,1082,摩根大通,2024-12-17,8440
1102,亞泥,1988,1074,914,摩根大通,2024-12-17,8440
2474,可成,1828,918,910,摩根大通,2024-12-17,8440
2903,遠百,907,45,862,摩根大通,2024-12-17,8440
5483,中美晶,1158,324,834,摩根大通,2024-12-17,8440
2352,佳世達,801,28,773,摩根大通,2024-12-17,8440
6191,精成科,701,26,675,摩根大通,2024-12-17,8440
9941,裕融,791,206,585,摩根大通,2024-12-17,8440
2646,星宇航空,570,0,570,摩根大通,2024-12-17,8440
2548,華固,587,58,529,摩根大通,2024-12-17,8440
2211,長榮鋼,670,179,491,摩根大通,2024-12-17,8440
9933,中鼎,546,86,460,摩根大通,2024-12-17,8440
2375,凱美,407,0,407,摩根大通,2024-12-17,8440
6187,萬潤,465,58,407,摩根大通,2024-12-17,8440
6962,ITH-KY,503,97,406,摩根大通,2024-12-17,8440
2360,致茂,468,66,402,摩根大通,2024-12-17,8440
6188,廣明,413,28,385,摩根大通,2024-12-17,8440
3014,聯陽,619,239,380,摩根大通,2024-12-17,8440
2383,台光電,440,108,332,摩根大通,2024-12-17,8440
3035,智原,542,225,317,摩根大通,2024-12-17,8440
3545,敦泰,317,2,315,摩根大通,2024-12-17,8440
5243,乙盛-KY,435,121,314,摩根大通,2024-12-17,8440
3062,建漢,583,284,299,摩根大通,2024-12-17,8440
6873,泓德能源,301,13,288,摩根大通,2024-12-17,8440
3661,世芯-KY,425,137,288,摩根大通,2024-12-17,8440
6214,精誠,452,169,283,摩根大通,2024-12-17,8440
2504,國產,1139,859,280,摩根大通,2024-12-17,8440
6531,愛普*,286,13,273,摩根大通,2024-12-17,8440
8016,矽創,281,30,251,摩根大通,2024-12-17,8440
3532,台勝科,292,46,246,摩根大通,2024-12-17,8440
5269,祥碩,252,12,240,摩根大通,2024-12-17,8440
8033,雷虎,242,6,236,摩根大通,2024-12-17,8440
4563,百德,266,36,230,摩根大通,2024-12-17,8440
9105,泰金寶-DR,223,0,223,摩根大通,2024-12-17,8440
3443,創意,762,557,205,摩根大通,2024-12-17,8440
6116,彩晶,308,110,198,摩根大通,2024-12-17,8440
2363,矽統,472,275,197,摩根大通,2024-12-17,8440
2328,廣宇,219,29,190,摩根大通,2024-12-17,8440
1904,正隆,210,25,185,摩根大通,2024-12-17,8440
6278,台表科,187,4,183,摩根大通,2024-12-17,8440
2845,遠東銀,3220,58,3162,摩根大通,2024-12-18,8440
2313,華通,3660,565,3095,摩根大通,2024-12-18,8440
1402,遠東新,2911,408,2503,摩根大通,2024-12-18,8440
5483,中美晶,3063,630,2433,摩根大通,2024-12-18,8440
9904,寶成,2769,558,2211,摩根大通,2024-12-18,8440
2891,中信金,6982,4886,2096,摩根大通,2024-12-18,8440
1216,統一,2464,726,1738,摩根大通,2024-12-18,8440
3481,群創,2199,645,1554,摩根大通,2024-12-18,8440
6962,ITH-KY,1913,411,1502,摩根大通,2024-12-18,8440
8070,長華*,1838,400,1438,摩根大通,2024-12-18,8440
00919,群益台灣精選高息,1320,0,1320,摩根大通,2024-12-18,8440
2308,台達電,2017,954,1063,摩根大通,2024-12-18,8440
3264,欣銓,1143,127,1016,摩根大通,2024-12-18,8440
2903,遠百,1383,373,1010,摩根大通,2024-12-18,8440
2027,大成鋼,1119,132,987,摩根大通,2024-12-18,8440
2352,佳世達,900,30,870,摩根大通,2024-12-18,8440
2855,統一證,890,69,821,摩根大通,2024-12-18,8440
4958,臻鼎-KY,1301,544,757,摩根大通,2024-12-18,8440
2886,兆豐金,1437,692,745,摩根大通,2024-12-18,8440
2474,可成,945,235,710,摩根大通,2024-12-18,8440
9933,中鼎,1106,472,634,摩根大通,2024-12-18,8440
1605,華新,870,241,629,摩根大通,2024-12-18,8440
3045,台灣大,1496,892,604,摩根大通,2024-12-18,8440
1301,台塑,2455,1886,569,摩根大通,2024-12-18,8440
2412,中華電,1554,990,564,摩根大通,2024-12-18,8440
3450,聯鈞,1501,945,556,摩根大通,2024-12-18,8440
2211,長榮鋼,808,257,551,摩根大通,2024-12-18,8440
9105,泰金寶-DR,574,30,544,摩根大通,2024-12-18,8440
3014,聯陽,609,67,542,摩根大通,2024-12-18,8440
4979,華星光,567,52,515,摩根大通,2024-12-18,8440
2360,致茂,544,35,509,摩根大通,2024-12-18,8440
1815,富喬,782,297,485,摩根大通,2024-12-18,8440
8069,元太,489,31,458,摩根大通,2024-12-18,8440
6176,瑞儀,538,91,447,摩根大通,2024-12-18,8440
1102,亞泥,581,141,440,摩根大通,2024-12-18,8440
2881,富邦金,1577,1137,440,摩根大通,2024-12-18,8440
6285,啟��,496,57,439,摩根大通,2024-12-18,8440
2618,長榮航,4948,4522,426,摩根大通,2024-12-18,8440
2324,仁寶,1120,715,405,摩根大通,2024-12-18,8440
2105,正新,607,207,400,摩根大通,2024-12-18,8440
2548,華固,490,94,396,摩根大通,2024-12-18,8440
2915,潤泰全,775,385,390,摩根大通,2024-12-18,8440
2353,宏��,1190,801,389,摩根大通,2024-12-18,8440
4991,環宇-KY,562,184,378,摩根大通,2024-12-18,8440
2515,中工,408,37,371,摩根大通,2024-12-18,8440
3665,貿聯-KY,641,273,368,摩根大通,2024-12-18,8440
6770,力積電,1570,1208,362,摩根大通,2024-12-18,8440
6116,彩晶,488,130,358,摩根大通,2024-12-18,8440
3019,亞光,986,629,357,摩根大通,2024-12-18,8440
8104,錸寶,429,75,354,摩根大通,2024-12-18,8440
2313,華通,6226,163,6063,摩根大通,2024-12-19,8440
1605,華新,3579,1037,2542,摩根大通,2024-12-19,8440
2889,國票金,2164,206,1958,摩根大通,2024-12-19,8440
2891,中信金,3845,1959,1886,摩根大通,2024-12-19,8440
2885,元大金,6817,5040,1777,摩根大通,2024-12-19,8440
1402,遠東新,2719,989,1730,摩根大通,2024-12-19,8440
2374,佳能,2346,1001,1345,摩根大通,2024-12-19,8440
3264,欣銓,1394,177,1217,摩根大通,2024-12-19,8440
2903,遠百,1335,148,1187,摩根大通,2024-12-19,8440
2809,京城銀,2136,975,1161,摩根大通,2024-12-19,8440
2610,華航,2413,1359,1054,摩根大通,2024-12-19,8440
2027,大成鋼,1193,176,1017,摩根大通,2024-12-19,8440
1102,亞泥,1507,524,983,摩根大通,2024-12-19,8440
3019,亞光,1724,765,959,摩根大通,2024-12-19,8440
2449,京元電子,1772,913,859,摩根大通,2024-12-19,8440
9933,中鼎,834,73,761,摩根大通,2024-12-19,8440
3711,日月光投控,1539,833,706,摩根大通,2024-12-19,8440
2548,華固,800,132,668,摩根大通,2024-12-19,8440
3014,聯陽,716,80,636,摩根大通,2024-12-19,8440
2855,統一證,1098,482,616,摩根大通,2024-12-19,8440
2412,中華電,1125,540,585,摩根大通,2024-12-19,8440
2308,台達電,1389,818,571,摩根大通,2024-12-19,8440
8070,長華*,778,214,564,摩根大通,2024-12-19,8440
2454,聯發科,834,287,547,摩根大通,2024-12-19,8440
1216,統一,1560,1029,531,摩根大通,2024-12-19,8440
5483,中美晶,1054,547,507,摩根大通,2024-12-19,8440
2345,智邦,636,149,487,摩根大通,2024-12-19,8440
3045,台灣大,1372,887,485,摩根大通,2024-12-19,8440
6770,力積電,1618,1134,484,摩根大通,2024-12-19,8440
6271,同欣電,533,56,477,摩根大通,2024-12-19,8440
2472,立隆電,458,40,418,摩根大通,2024-12-19,8440
5522,遠雄,808,400,408,摩根大通,2024-12-19,8440
6285,啟��,734,336,398,摩根大通,2024-12-19,8440
2474,可成,524,149,375,摩根大通,2024-12-19,8440
5536,聖暉*,393,24,369,摩根大通,2024-12-19,8440
3042,晶技,393,48,345,摩根大通,2024-12-19,8440
3062,建漢,489,157,332,摩根大通,2024-12-19,8440
8016,矽創,335,27,308,摩根大通,2024-12-19,8440
6962,ITH-KY,604,302,302,摩根大通,2024-12-19,8440
2515,中工,369,83,286,摩根大通,2024-12-19,8440
3231,緯創,1552,1277,275,摩根大通,2024-12-19,8440
2495,普安,370,103,267,摩根大通,2024-12-19,8440
5388,中磊,377,116,261,摩根大通,2024-12-19,8440
6176,瑞儀,321,68,253,摩根大通,2024-12-19,8440
1904,正隆,319,76,243,摩根大通,2024-12-19,8440
2486,一詮,606,369,237,摩根大通,2024-12-19,8440
6257,矽格,317,85,232,摩根大通,2024-12-19,8440
3189,景碩,266,37,229,摩根大通,2024-12-19,8440
2301,光寶科,660,439,221,摩根大通,2024-12-19,8440
00923,群益台ESG低碳50,219,0,219,摩根大通,2024-12-19,8440
