Ticker,Name,buy,sell,diff,Branch,Date,Branch_Code
3707,漢磊,145,6,139,新光-高雄,2023-01-03,8562
6143,振曜,108,8,100,新光-高雄,2023-01-03,8562
00673R,期元大S＆P原油反1,104,19,85,新光-高雄,2023-01-03,8562
3508,位速,84,0,84,新光-高雄,2023-01-03,8562
2618,長榮航,187,108,79,新光-高雄,2023-01-03,8562
00664R,國泰臺灣加權反1,90,13,77,新光-高雄,2023-01-03,8562
00878,國泰永續高股息,79,20,59,新光-高雄,2023-01-03,8562
3703,欣陸,53,0,53,新光-高雄,2023-01-03,8562
00713,元大台灣高息低波,46,0,46,新光-高雄,2023-01-03,8562
2425,承啟,54,8,46,新光-高雄,2023-01-03,8562
1605,華新,159,121,38,新光-高雄,2023-01-03,8562
00650L,復華香港正2,42,5,37,新光-高雄,2023-01-03,8562
00637L,元大滬深300正2,65,30,35,新光-高雄,2023-01-03,8562
8933,愛地雅,70,37,33,新光-高雄,2023-01-03,8562
8429,金麗-KY,32,0,32,新光-高雄,2023-01-03,8562
00902,中信電池及儲能,31,0,31,新光-高雄,2023-01-03,8562
1710,東聯,41,10,31,新光-高雄,2023-01-03,8562
9904,寶成,36,6,30,新光-高雄,2023-01-03,8562
6112,邁達特,25,0,25,新光-高雄,2023-01-03,8562
2603,長榮,47,23,24,新光-高雄,2023-01-03,8562
2412,中華電,47,24,23,新光-高雄,2023-01-03,8562
3218,大學光,22,1,21,新光-高雄,2023-01-03,8562
00679B,元大美債20年,21,0,21,新光-高雄,2023-01-03,8562
2851,中再保,22,2,20,新光-高雄,2023-01-03,8562
2609,陽明,57,37,20,新光-高雄,2023-01-03,8562
2897,王道銀行,20,0,20,新光-高雄,2023-01-03,8562
2049,上銀,23,5,18,新光-高雄,2023-01-03,8562
2615,萬海,77,60,17,新光-高雄,2023-01-03,8562
9919,康那香,17,0,17,新光-高雄,2023-01-03,8562
2867,三商壽,16,0,16,新光-高雄,2023-01-03,8562
00893,國泰智能電動車,26,11,15,新光-高雄,2023-01-03,8562
2884,玉山金,14,0,14,新光-高雄,2023-01-03,8562
2610,華航,46,32,14,新光-高雄,2023-01-03,8562
5386,青雲,25,12,13,新光-高雄,2023-01-03,8562
4102,永日,13,1,12,新光-高雄,2023-01-03,8562
1760,寶齡富錦,33,21,12,新光-高雄,2023-01-03,8562
00687B,國泰20年美債,11,0,11,新光-高雄,2023-01-03,8562
2399,映泰,51,40,11,新光-高雄,2023-01-03,8562
4121,優盛,51,40,11,新光-高雄,2023-01-03,8562
00633L,富邦上証正2,37,26,11,新光-高雄,2023-01-03,8562
6547,高端疫苗,30,19,11,新光-高雄,2023-01-03,8562
2886,兆豐金,10,0,10,新光-高雄,2023-01-03,8562
00900,富邦特選高股息30,10,0,10,新光-高雄,2023-01-03,8562
1104,環泥,10,0,10,新光-高雄,2023-01-03,8562
5015,華祺,10,0,10,新光-高雄,2023-01-03,8562
00648R,元大S＆P500反1,10,0,10,新光-高雄,2023-01-03,8562
6111,大宇資,36,26,10,新光-高雄,2023-01-03,8562
1101,台泥,18,8,10,新光-高雄,2023-01-03,8562
00751B,元大AAA至A公司債,9,0,9,新光-高雄,2023-01-03,8562
00712,復華富時不動產,9,0,9,新光-高雄,2023-01-03,8562
8358,金居,155,32,123,新光-高雄,2023-01-04,8562
00706L,期元大S＆P日圓正2,59,1,58,新光-高雄,2023-01-04,8562
2884,玉山金,55,0,55,新光-高雄,2023-01-04,8562
6116,彩晶,50,0,50,新光-高雄,2023-01-04,8562
3481,群創,63,19,44,新光-高雄,2023-01-04,8562
00893,國泰智能電動車,60,17,43,新光-高雄,2023-01-04,8562
00642U,期元大S＆P石油,40,0,40,新光-高雄,2023-01-04,8562
2317,鴻海,48,13,35,新光-高雄,2023-01-04,8562
2609,陽明,46,15,31,新光-高雄,2023-01-04,8562
6274,台燿,28,0,28,新光-高雄,2023-01-04,8562
3576,聯合再生,28,0,28,新光-高雄,2023-01-04,8562
3037,欣興,52,26,26,新光-高雄,2023-01-04,8562
2002,中鋼,59,35,24,新光-高雄,2023-01-04,8562
2014,中鴻,58,34,24,新光-高雄,2023-01-04,8562
6104,創惟,41,17,24,新光-高雄,2023-01-04,8562
2538,基泰,23,0,23,新光-高雄,2023-01-04,8562
2603,長榮,39,16,23,新光-高雄,2023-01-04,8562
00772B,中信高評級公司債,22,0,22,新光-高雄,2023-01-04,8562
2495,普安,23,1,22,新光-高雄,2023-01-04,8562
3162,精確,22,1,21,新光-高雄,2023-01-04,8562
4155,訊映,21,1,20,新光-高雄,2023-01-04,8562
2610,華航,25,6,19,新光-高雄,2023-01-04,8562
2637,慧洋-KY,41,22,19,新光-高雄,2023-01-04,8562
6672,騰輝電子-KY,18,0,18,新光-高雄,2023-01-04,8562
3380,明泰,37,19,18,新光-高雄,2023-01-04,8562
2851,中再保,21,4,17,新光-高雄,2023-01-04,8562
00679B,元大美債20年,20,3,17,新光-高雄,2023-01-04,8562
8033,雷虎,21,5,16,新光-高雄,2023-01-04,8562
3027,盛達,94,78,16,新光-高雄,2023-01-04,8562
2883B,凱基金乙特,14,0,14,新光-高雄,2023-01-04,8562
2303,聯電,20,6,14,新光-高雄,2023-01-04,8562
1514,亞力,68,54,14,新光-高雄,2023-01-04,8562
5351,鈺創,25,12,13,新光-高雄,2023-01-04,8562
2897,王道銀行,13,0,13,新光-高雄,2023-01-04,8562
8222,寶一,18,5,13,新光-高雄,2023-01-04,8562
2614,東森,34,22,12,新光-高雄,2023-01-04,8562
1732,毛寶,15,3,12,新光-高雄,2023-01-04,8562
5426,振發,12,0,12,新光-高雄,2023-01-04,8562
0050,元大台灣50,12,1,11,新光-高雄,2023-01-04,8562
2328,廣宇,18,8,10,新光-高雄,2023-01-04,8562
2009,第一銅,10,0,10,新光-高雄,2023-01-04,8562
2363,矽統,10,0,10,新光-高雄,2023-01-04,8562
5871A,中租-KY甲特,10,0,10,新光-高雄,2023-01-04,8562
00701,國泰股利精選30,10,0,10,新光-高雄,2023-01-04,8562
1101,台泥,18,9,9,新光-高雄,2023-01-04,8562
6118,建達,64,55,9,新光-高雄,2023-01-04,8562
3081,聯亞,9,0,9,新光-高雄,2023-01-04,8562
4930,燦星網,10,1,9,新光-高雄,2023-01-04,8562
5608,四維航,11,2,9,新光-高雄,2023-01-04,8562
6770,力積電,8,0,8,新光-高雄,2023-01-04,8562
00713,元大台灣高息低波,130,9,121,新光-高雄,2023-01-05,8562
8171,天宇,188,67,121,新光-高雄,2023-01-05,8562
00878,國泰永續高股息,209,88,121,新光-高雄,2023-01-05,8562
5340,建榮,100,0,100,新光-高雄,2023-01-05,8562
2303,聯電,198,118,80,新光-高雄,2023-01-05,8562
00888,永豐台灣ESG,81,1,80,新光-高雄,2023-01-05,8562
00706L,期元大S＆P日圓正2,72,0,72,新光-高雄,2023-01-05,8562
00900,富邦特選高股息30,46,6,40,新光-高雄,2023-01-05,8562
9904,寶成,41,2,39,新光-高雄,2023-01-05,8562
1218,泰山,35,0,35,新光-高雄,2023-01-05,8562
00642U,期元大S＆P石油,41,9,32,新光-高雄,2023-01-05,8562
6015,宏遠證,32,0,32,新光-高雄,2023-01-05,8562
2610,華航,53,23,30,新光-高雄,2023-01-05,8562
2465,麗臺,53,24,29,新光-高雄,2023-01-05,8562
1513,中興電,167,139,28,新光-高雄,2023-01-05,8562
2413,環科,26,0,26,新光-高雄,2023-01-05,8562
3704,合勤控,92,67,25,新光-高雄,2023-01-05,8562
6443,元晶,32,8,24,新光-高雄,2023-01-05,8562
00902,中信電池及儲能,23,0,23,新光-高雄,2023-01-05,8562
5907,大洋-KY,21,0,21,新光-高雄,2023-01-05,8562
2641,正德,20,0,20,新光-高雄,2023-01-05,8562
4130,健亞,49,31,18,新光-高雄,2023-01-05,8562
00772B,中信高評級公司債,19,1,18,新光-高雄,2023-01-05,8562
3231,緯創,19,2,17,新光-高雄,2023-01-05,8562
6143,振曜,32,15,17,新光-高雄,2023-01-05,8562
1609,大亞,17,1,16,新光-高雄,2023-01-05,8562
3479,安勤,62,46,16,新光-高雄,2023-01-05,8562
00679B,元大美債20年,15,0,15,新光-高雄,2023-01-05,8562
3162,精確,26,12,14,新光-高雄,2023-01-05,8562
00753L,中信中國50正2,97,83,14,新光-高雄,2023-01-05,8562
3036,文曄,14,0,14,新光-高雄,2023-01-05,8562
1504,東元,23,9,14,新光-高雄,2023-01-05,8562
1701,中化,59,46,13,新光-高雄,2023-01-05,8562
1802,台玻,16,3,13,新光-高雄,2023-01-05,8562
6182,合晶,14,1,13,新光-高雄,2023-01-05,8562
2002,中鋼,19,6,13,新光-高雄,2023-01-05,8562
5425,台半,18,5,13,新光-高雄,2023-01-05,8562
2409,友達,16,3,13,新光-高雄,2023-01-05,8562
3013,晟銘電,18,6,12,新光-高雄,2023-01-05,8562
3711,日月光投控,19,7,12,新光-高雄,2023-01-05,8562
3209,全科,12,0,12,新光-高雄,2023-01-05,8562
9919,康那香,12,0,12,新光-高雄,2023-01-05,8562
5347,世界,30,18,12,新光-高雄,2023-01-05,8562
1314,中石化,12,1,11,新光-高雄,2023-01-05,8562
2380,虹光,11,0,11,新光-高雄,2023-01-05,8562
1319,東陽,15,4,11,新光-高雄,2023-01-05,8562
4919,新唐,27,16,11,新光-高雄,2023-01-05,8562
2317,鴻海,34,23,11,新光-高雄,2023-01-05,8562
00631L,元大台灣50正2,43,33,10,新光-高雄,2023-01-05,8562
8069,元太,20,10,10,新光-高雄,2023-01-05,8562
00632R,元大台灣50反1,770,121,649,新光-高雄,2023-01-06,8562
2014,中鴻,122,17,105,新光-高雄,2023-01-06,8562
00680L,元大美債20正2,102,7,95,新光-高雄,2023-01-06,8562
4114,健喬,204,111,93,新光-高雄,2023-01-06,8562
00706L,期元大S＆P日圓正2,89,2,87,新光-高雄,2023-01-06,8562
5340,建榮,83,0,83,新光-高雄,2023-01-06,8562
00753L,中信中國50正2,81,2,79,新光-高雄,2023-01-06,8562
6116,彩晶,105,35,70,新光-高雄,2023-01-06,8562
00720B,元大投資級公司債,72,3,69,新光-高雄,2023-01-06,8562
1101,台泥,67,14,53,新光-高雄,2023-01-06,8562
4104,佳醫,38,0,38,新光-高雄,2023-01-06,8562
4190,佐登-KY,38,0,38,新光-高雄,2023-01-06,8562
1231,聯華食,34,0,34,新光-高雄,2023-01-06,8562
3189,景碩,43,12,31,新光-高雄,2023-01-06,8562
3209,全科,27,0,27,新光-高雄,2023-01-06,8562
8171,天宇,122,95,27,新光-高雄,2023-01-06,8562
00665L,富邦�琤肭磪囓�2,52,26,26,新光-高雄,2023-01-06,8562
6015,宏遠證,25,0,25,新光-高雄,2023-01-06,8562
00772B,中信高評級公司債,22,0,22,新光-高雄,2023-01-06,8562
1229,聯華,21,0,21,新光-高雄,2023-01-06,8562
8358,金居,50,29,21,新光-高雄,2023-01-06,8562
00669R,國泰美國道瓊反1,20,0,20,新光-高雄,2023-01-06,8562
00893,國泰智能電動車,22,4,18,新光-高雄,2023-01-06,8562
6770,力積電,37,19,18,新光-高雄,2023-01-06,8562
3141,晶宏,56,39,17,新光-高雄,2023-01-06,8562
1732,毛寶,17,0,17,新光-高雄,2023-01-06,8562
2547,日勝生,17,0,17,新光-高雄,2023-01-06,8562
1529,樂事綠能,36,20,16,新光-高雄,2023-01-06,8562
00892,富邦台灣半導體,29,13,16,新光-高雄,2023-01-06,8562
0056,元大高股息,29,14,15,新光-高雄,2023-01-06,8562
6470,宇智,15,0,15,新光-高雄,2023-01-06,8562
6186,新潤,15,0,15,新光-高雄,2023-01-06,8562
00897,富邦基因免疫生技,15,0,15,新光-高雄,2023-01-06,8562
1785,光洋科,14,0,14,新光-高雄,2023-01-06,8562
5475,德宏,16,2,14,新光-高雄,2023-01-06,8562
1102,亞泥,15,2,13,新光-高雄,2023-01-06,8562
00670L,富邦NASDAQ正2,12,0,12,新光-高雄,2023-01-06,8562
1909,榮成,20,8,12,新光-高雄,2023-01-06,8562
00907,永豐優息存股,20,8,12,新光-高雄,2023-01-06,8562
1519,華城,76,64,12,新光-高雄,2023-01-06,8562
00882,中信中國高股息,24,13,11,新光-高雄,2023-01-06,8562
1752,南光,89,78,11,新光-高雄,2023-01-06,8562
1701,中化,103,92,11,新光-高雄,2023-01-06,8562
1210,大成,11,0,11,新光-高雄,2023-01-06,8562
3094,聯傑,24,13,11,新光-高雄,2023-01-06,8562
4102,永日,26,15,11,新光-高雄,2023-01-06,8562
00712,復華富時不動產,11,1,10,新光-高雄,2023-01-06,8562
4130,健亞,16,6,10,新光-高雄,2023-01-06,8562
00671R,富邦NASDAQ反1,10,0,10,新光-高雄,2023-01-06,8562
4129,聯合,10,0,10,新光-高雄,2023-01-06,8562
00715L,期街口布蘭特正2,428,10,418,新光-高雄,2023-01-09,8562
2867,三商壽,124,0,124,新光-高雄,2023-01-09,8562
00683L,期元大美元指正2,116,2,114,新光-高雄,2023-01-09,8562
2610,華航,216,121,95,新光-高雄,2023-01-09,8562
2450,神腦,63,0,63,新光-高雄,2023-01-09,8562
1314,中石化,101,43,58,新光-高雄,2023-01-09,8562
2634,漢翔,56,3,53,新光-高雄,2023-01-09,8562
3673,TPK-KY,40,0,40,新光-高雄,2023-01-09,8562
2603,長榮,54,16,38,新光-高雄,2023-01-09,8562
3558,神準,41,4,37,新光-高雄,2023-01-09,8562
00903,富邦元宇宙,37,0,37,新光-高雄,2023-01-09,8562
3481,群創,41,7,34,新光-高雄,2023-01-09,8562
8069,元太,101,68,33,新光-高雄,2023-01-09,8562
1605,華新,99,72,27,新光-高雄,2023-01-09,8562
6285,啟��,29,2,27,新光-高雄,2023-01-09,8562
2338,光罩,80,54,26,新光-高雄,2023-01-09,8562
00680L,元大美債20正2,25,0,25,新光-高雄,2023-01-09,8562
2486,一詮,25,1,24,新光-高雄,2023-01-09,8562
2425,承啟,24,0,24,新光-高雄,2023-01-09,8562
1701,中化,30,9,21,新光-高雄,2023-01-09,8562
00795B,中信美國公債20年,21,0,21,新光-高雄,2023-01-09,8562
1609,大亞,23,2,21,新光-高雄,2023-01-09,8562
6139,亞翔,42,22,20,新光-高雄,2023-01-09,8562
3323,加百裕,20,0,20,新光-高雄,2023-01-09,8562
00885,富邦越南,21,2,19,新光-高雄,2023-01-09,8562
2812,台中銀,53,36,17,新光-高雄,2023-01-09,8562
5871,中租-KY,42,25,17,新光-高雄,2023-01-09,8562
2409,友達,34,17,17,新光-高雄,2023-01-09,8562
5340,建榮,17,0,17,新光-高雄,2023-01-09,8562
6104,創惟,20,5,15,新光-高雄,2023-01-09,8562
2547,日勝生,15,0,15,新光-高雄,2023-01-09,8562
2481,強茂,18,4,14,新光-高雄,2023-01-09,8562
2915,潤泰全,17,3,14,新光-高雄,2023-01-09,8562
00648R,元大S＆P500反1,100,86,14,新光-高雄,2023-01-09,8562
5309,系統電,14,0,14,新光-高雄,2023-01-09,8562
2727,王品,14,0,14,新光-高雄,2023-01-09,8562
2887,台新金,23,10,13,新光-高雄,2023-01-09,8562
1795,美時,48,35,13,新光-高雄,2023-01-09,8562
6182,合晶,16,3,13,新光-高雄,2023-01-09,8562
2014,中鴻,32,19,13,新光-高雄,2023-01-09,8562
3062,建漢,21,9,12,新光-高雄,2023-01-09,8562
8044,網家,17,5,12,新光-高雄,2023-01-09,8562
2444,兆勁,14,2,12,新光-高雄,2023-01-09,8562
2332,友訊,15,3,12,新光-高雄,2023-01-09,8562
4915,致伸,21,9,12,新光-高雄,2023-01-09,8562
1417,嘉裕,12,0,12,新光-高雄,2023-01-09,8562
2706,第一店,12,0,12,新光-高雄,2023-01-09,8562
3231,緯創,36,25,11,新光-高雄,2023-01-09,8562
1102,亞泥,16,5,11,新光-高雄,2023-01-09,8562
5351,鈺創,31,20,11,新光-高雄,2023-01-09,8562
00648R,元大S＆P500反1,140,26,114,新光-高雄,2023-01-10,8562
9103,美德醫療-DR,73,4,69,新光-高雄,2023-01-10,8562
2812,台中銀,112,55,57,新光-高雄,2023-01-10,8562
2634,漢翔,52,0,52,新光-高雄,2023-01-10,8562
00715L,期街口布蘭特正2,48,0,48,新光-高雄,2023-01-10,8562
2890,永豐金,59,12,47,新光-高雄,2023-01-10,8562
4979,華星光,52,5,47,新光-高雄,2023-01-10,8562
00671R,富邦NASDAQ反1,40,0,40,新光-高雄,2023-01-10,8562
4128,中天,50,11,39,新光-高雄,2023-01-10,8562
6770,力積電,69,34,35,新光-高雄,2023-01-10,8562
2867,三商壽,34,1,33,新光-高雄,2023-01-10,8562
2338,光罩,69,38,31,新光-高雄,2023-01-10,8562
6122,擎邦,28,1,27,新光-高雄,2023-01-10,8562
1752,南光,50,28,22,新光-高雄,2023-01-10,8562
1721,三晃,21,0,21,新光-高雄,2023-01-10,8562
2444,兆勁,21,0,21,新光-高雄,2023-01-10,8562
2482,連宇,39,19,20,新光-高雄,2023-01-10,8562
00720B,元大投資級公司債,21,2,19,新光-高雄,2023-01-10,8562
00895,富邦未來車,34,14,20,新光-高雄,2023-01-10,8562
2450,神腦,19,0,19,新光-高雄,2023-01-10,8562
00670L,富邦NASDAQ正2,20,2,18,新光-高雄,2023-01-10,8562
1760,寶齡富錦,32,14,18,新光-高雄,2023-01-10,8562
2359,所羅門,18,1,17,新光-高雄,2023-01-10,8562
2014,中鴻,20,4,16,新光-高雄,2023-01-10,8562
1736,喬山,43,27,16,新光-高雄,2023-01-10,8562
3362,先進光,16,0,16,新光-高雄,2023-01-10,8562
6485,點序,16,0,16,新光-高雄,2023-01-10,8562
2354,鴻準,17,1,16,新光-高雄,2023-01-10,8562
3027,盛達,30,14,16,新光-高雄,2023-01-10,8562
5340,建榮,15,0,15,新光-高雄,2023-01-10,8562
8086,宏捷科,16,1,15,新光-高雄,2023-01-10,8562
00753L,中信中國50正2,28,13,15,新光-高雄,2023-01-10,8562
6547,高端疫苗,22,7,15,新光-高雄,2023-01-10,8562
3356,奇偶,37,23,14,新光-高雄,2023-01-10,8562
2312,金寶,13,0,13,新光-高雄,2023-01-10,8562
00680L,元大美債20正2,20,7,13,新光-高雄,2023-01-10,8562
3163,波若威,32,19,13,新光-高雄,2023-01-10,8562
8131,福懋科,12,0,12,新光-高雄,2023-01-10,8562
3704,合勤控,60,48,12,新光-高雄,2023-01-10,8562
2884,玉山金,19,8,11,新光-高雄,2023-01-10,8562
5426,振發,11,0,11,新光-高雄,2023-01-10,8562
9921,巨大,10,0,10,新光-高雄,2023-01-10,8562
2609,陽明,17,7,10,新光-高雄,2023-01-10,8562
6185,幃翔,10,0,10,新光-高雄,2023-01-10,8562
2323,中環,20,10,10,新光-高雄,2023-01-10,8562
3466,德晉,12,2,10,新光-高雄,2023-01-10,8562
6603,富強鑫,12,2,10,新光-高雄,2023-01-10,8562
9945,潤泰新,10,0,10,新光-高雄,2023-01-10,8562
4930,燦星網,10,0,10,新光-高雄,2023-01-10,8562
3675,德微,13,3,10,新光-高雄,2023-01-10,8562
2892,第一金,170,1,169,新光-高雄,2023-01-11,8562
2618,長榮航,288,147,141,新光-高雄,2023-01-11,8562
2610,華航,357,288,69,新光-高雄,2023-01-11,8562
4190,佐登-KY,72,4,68,新光-高雄,2023-01-11,8562
4168,醣聯,50,0,50,新光-高雄,2023-01-11,8562
1584,精剛,133,94,39,新光-高雄,2023-01-11,8562
8028,昇陽半導體,43,7,36,新光-高雄,2023-01-11,8562
6770,力積電,68,32,36,新光-高雄,2023-01-11,8562
00706L,期元大S＆P日圓正2,35,0,35,新光-高雄,2023-01-11,8562
6139,亞翔,35,2,33,新光-高雄,2023-01-11,8562
9103,美德醫療-DR,29,0,29,新光-高雄,2023-01-11,8562
00679B,元大美債20年,28,0,28,新光-高雄,2023-01-11,8562
6443,元晶,46,19,27,新光-高雄,2023-01-11,8562
2014,中鴻,55,29,26,新光-高雄,2023-01-11,8562
3587,閎康,34,10,24,新光-高雄,2023-01-11,8562
3558,神準,24,0,24,新光-高雄,2023-01-11,8562
2867,三商壽,22,0,22,新光-高雄,2023-01-11,8562
00753L,中信中國50正2,69,47,22,新光-高雄,2023-01-11,8562
4904,遠傳,23,1,22,新光-高雄,2023-01-11,8562
8358,金居,25,3,22,新光-高雄,2023-01-11,8562
1701,中化,36,15,21,新光-高雄,2023-01-11,8562
2450,神腦,20,0,20,新光-高雄,2023-01-11,8562
3702,大聯大,20,0,20,新光-高雄,2023-01-11,8562
2359,所羅門,25,6,19,新光-高雄,2023-01-11,8562
3128,昇銳,19,2,17,新光-高雄,2023-01-11,8562
00715L,期街口布蘭特正2,17,0,17,新光-高雄,2023-01-11,8562
5340,建榮,16,0,16,新光-高雄,2023-01-11,8562
2488,漢平,15,0,15,新光-高雄,2023-01-11,8562
1109,信大,15,0,15,新光-高雄,2023-01-11,8562
00902,中信電池及儲能,20,5,15,新光-高雄,2023-01-11,8562
4951,精拓科,15,0,15,新光-高雄,2023-01-11,8562
1309,台達化,15,0,15,新光-高雄,2023-01-11,8562
2313,華通,30,16,14,新光-高雄,2023-01-11,8562
2395,研華,14,0,14,新光-高雄,2023-01-11,8562
2603,長榮,33,20,13,新光-高雄,2023-01-11,8562
1605,華新,30,17,13,新光-高雄,2023-01-11,8562
6592,和潤企業,15,2,13,新光-高雄,2023-01-11,8562
2413,環科,17,4,13,新光-高雄,2023-01-11,8562
1409,新纖,30,17,13,新光-高雄,2023-01-11,8562
00905,FT臺灣Smart,13,1,12,新光-高雄,2023-01-11,8562
8249,菱光,20,8,12,新光-高雄,2023-01-11,8562
3645,達邁,11,0,11,新光-高雄,2023-01-11,8562
3017,奇鋐,11,0,11,新光-高雄,2023-01-11,8562
2633,台灣高鐵,11,0,11,新光-高雄,2023-01-11,8562
6609,瀧澤科,31,20,11,新光-高雄,2023-01-11,8562
2886,兆豐金,14,4,10,新光-高雄,2023-01-11,8562
3045,台灣大,12,2,10,新光-高雄,2023-01-11,8562
9933,中鼎,11,1,10,新光-高雄,2023-01-11,8562
2399,映泰,13,3,10,新光-高雄,2023-01-11,8562
2323,中環,10,0,10,新光-高雄,2023-01-11,8562
00715L,期街口布蘭特正2,992,262,730,新光-高雄,2023-01-12,8562
00878,國泰永續高股息,246,38,208,新光-高雄,2023-01-12,8562
00673R,期元大S＆P原油反1,164,7,157,新光-高雄,2023-01-12,8562
00882,中信中國高股息,157,2,155,新光-高雄,2023-01-12,8562
00888,永豐台灣ESG,94,3,91,新光-高雄,2023-01-12,8562
00713,元大台灣高息低波,82,0,82,新光-高雄,2023-01-12,8562
2897,王道銀行,100,24,76,新光-高雄,2023-01-12,8562
2634,漢翔,71,3,68,新光-高雄,2023-01-12,8562
9103,美德醫療-DR,69,3,66,新光-高雄,2023-01-12,8562
2450,神腦,78,13,65,新光-高雄,2023-01-12,8562
2609,陽明,86,30,56,新光-高雄,2023-01-12,8562
2880,華南金,55,0,55,新光-高雄,2023-01-12,8562
5014,建錩,59,8,51,新光-高雄,2023-01-12,8562
00632R,元大台灣50反1,78,30,48,新光-高雄,2023-01-12,8562
00726B,國泰新興投等債,40,0,40,新光-高雄,2023-01-12,8562
2405,輔信,48,10,38,新光-高雄,2023-01-12,8562
6130,上亞科技,37,2,35,新光-高雄,2023-01-12,8562
3209,全科,35,1,34,新光-高雄,2023-01-12,8562
6806,森崴能源,39,6,33,新光-高雄,2023-01-12,8562
00830,國泰費城半導體,50,18,32,新光-高雄,2023-01-12,8562
00650L,復華香港正2,30,0,30,新光-高雄,2023-01-12,8562
8429,金麗-KY,30,0,30,新光-高雄,2023-01-12,8562
2007,燁興,62,32,30,新光-高雄,2023-01-12,8562
2884,玉山金,34,5,29,新光-高雄,2023-01-12,8562
8070,長華*,30,1,29,新光-高雄,2023-01-12,8562
3704,合勤控,50,22,28,新光-高雄,2023-01-12,8562
4128,中天,41,15,26,新光-高雄,2023-01-12,8562
00665L,富邦�琤肭磪囓�2,32,6,26,新光-高雄,2023-01-12,8562
6015,宏遠證,25,0,25,新光-高雄,2023-01-12,8562
2495,普安,26,3,23,新光-高雄,2023-01-12,8562
2358,廷鑫,128,105,23,新光-高雄,2023-01-12,8562
4974,亞泰,30,7,23,新光-高雄,2023-01-12,8562
3037,欣興,44,22,22,新光-高雄,2023-01-12,8562
3481,群創,64,42,22,新光-高雄,2023-01-12,8562
2332,友訊,25,4,21,新光-高雄,2023-01-12,8562
2845,遠東銀,22,1,21,新光-高雄,2023-01-12,8562
00734B,台新JPM新興債,20,0,20,新光-高雄,2023-01-12,8562
00771,元大US高息特別股,19,0,19,新光-高雄,2023-01-12,8562
1529,樂事綠能,27,9,18,新光-高雄,2023-01-12,8562
1608,華榮,41,24,17,新光-高雄,2023-01-12,8562
6443,元晶,53,36,17,新光-高雄,2023-01-12,8562
2633,台灣高鐵,21,4,17,新光-高雄,2023-01-12,8562
4157,太景*-KY,17,0,17,新光-高雄,2023-01-12,8562
6770,力積電,47,30,17,新光-高雄,2023-01-12,8562
00720B,元大投資級公司債,48,31,17,新光-高雄,2023-01-12,8562
2468,華經,60,44,16,新光-高雄,2023-01-12,8562
5880,合庫金,18,3,15,新光-高雄,2023-01-12,8562
2317,鴻海,19,3,16,新光-高雄,2023-01-12,8562
1701,中化,19,5,14,新光-高雄,2023-01-12,8562
2014,中鴻,98,84,14,新光-高雄,2023-01-12,8562
2618,長榮航,383,101,282,新光-高雄,2023-01-13,8562
00713,元大台灣高息低波,244,76,168,新光-高雄,2023-01-13,8562
2812,台中銀,106,33,73,新光-高雄,2023-01-13,8562
00673R,期元大S＆P原油反1,89,20,69,新光-高雄,2023-01-13,8562
2892,第一金,43,3,40,新光-高雄,2023-01-13,8562
4168,醣聯,38,0,38,新光-高雄,2023-01-13,8562
8358,金居,66,31,35,新光-高雄,2023-01-13,8562
2897,王道銀行,49,18,31,新光-高雄,2023-01-13,8562
1605,華新,65,37,28,新光-高雄,2023-01-13,8562
1536,和大,28,0,28,新光-高雄,2023-01-13,8562
3630,新鉅科,28,1,27,新光-高雄,2023-01-13,8562
00772B,中信高評級公司債,45,19,26,新光-高雄,2023-01-13,8562
00885,富邦越南,25,1,24,新光-高雄,2023-01-13,8562
00720B,元大投資級公司債,25,2,23,新光-高雄,2023-01-13,8562
2015,豐興,23,0,23,新光-高雄,2023-01-13,8562
0056,元大高股息,44,22,22,新光-高雄,2023-01-13,8562
2349,錸德,22,0,22,新光-高雄,2023-01-13,8562
2312,金寶,29,8,21,新光-高雄,2023-01-13,8562
2371,大同,22,1,21,新光-高雄,2023-01-13,8562
00680L,元大美債20正2,20,0,20,新光-高雄,2023-01-13,8562
2609,陽明,23,4,19,新光-高雄,2023-01-13,8562
5443,均豪,19,0,19,新光-高雄,2023-01-13,8562
9933,中鼎,20,1,19,新光-高雄,2023-01-13,8562
2317,鴻海,23,7,16,新光-高雄,2023-01-13,8562
00773B,中信優先金融債,16,0,16,新光-高雄,2023-01-13,8562
2313,華通,25,10,15,新光-高雄,2023-01-13,8562
2880,華南金,17,2,15,新光-高雄,2023-01-13,8562
6130,上亞科技,16,1,15,新光-高雄,2023-01-13,8562
3105,穩懋,35,20,15,新光-高雄,2023-01-13,8562
1313,聯成,15,1,14,新光-高雄,2023-01-13,8562
2498,宏達電,47,34,13,新光-高雄,2023-01-13,8562
2457,飛宏,14,1,13,新光-高雄,2023-01-13,8562
00670L,富邦NASDAQ正2,16,3,13,新光-高雄,2023-01-13,8562
1229,聯華,15,2,13,新光-高雄,2023-01-13,8562
1101,台泥,55,43,12,新光-高雄,2023-01-13,8562
00679B,元大美債20年,19,7,12,新光-高雄,2023-01-13,8562
2450,神腦,22,10,12,新光-高雄,2023-01-13,8562
9945,潤泰新,13,1,12,新光-高雄,2023-01-13,8562
00751B,元大AAA至A公司債,12,1,11,新光-高雄,2023-01-13,8562
1444,力麗,11,0,11,新光-高雄,2023-01-13,8562
3708,上緯投控,19,8,11,新光-高雄,2023-01-13,8562
3362,先進光,14,3,11,新光-高雄,2023-01-13,8562
1304,台聚,15,4,11,新光-高雄,2023-01-13,8562
2889,國票金,14,4,10,新光-高雄,2023-01-13,8562
3230,錦明,10,0,10,新光-高雄,2023-01-13,8562
00904,新光臺灣半導體30,10,0,10,新光-高雄,2023-01-13,8562
8429,金麗-KY,10,0,10,新光-高雄,2023-01-13,8562
2867,三商壽,22,12,10,新光-高雄,2023-01-13,8562
3625,西勝,10,0,10,新光-高雄,2023-01-13,8562
00921,兆豐龍頭等權重,9,0,9,新光-高雄,2023-01-13,8562
00665L,富邦�琤肭磪囓�2,226,7,219,新光-高雄,2023-01-16,8562
4114,健喬,218,61,157,新光-高雄,2023-01-16,8562
00673R,期元大S＆P原油反1,144,0,144,新光-高雄,2023-01-16,8562
5263,智崴,118,3,115,新光-高雄,2023-01-16,8562
00753L,中信中國50正2,132,24,108,新光-高雄,2023-01-16,8562
00882,中信中國高股息,120,38,82,新光-高雄,2023-01-16,8562
00632R,元大台灣50反1,224,144,80,新光-高雄,2023-01-16,8562
2897,王道銀行,60,3,57,新光-高雄,2023-01-16,8562
00772B,中信高評級公司債,62,8,54,新光-高雄,2023-01-16,8562
2610,華航,77,25,52,新光-高雄,2023-01-16,8562
00773B,中信優先金融債,53,3,50,新光-高雄,2023-01-16,8562
00634R,富邦上証反1,50,0,50,新光-高雄,2023-01-16,8562
2468,華經,104,58,46,新光-高雄,2023-01-16,8562
2317,鴻海,44,3,41,新光-高雄,2023-01-16,8562
3703,欣陸,39,0,39,新光-高雄,2023-01-16,8562
1216,統一,70,33,37,新光-高雄,2023-01-16,8562
2633,台灣高鐵,36,1,35,新光-高雄,2023-01-16,8562
6015,宏遠證,35,0,35,新光-高雄,2023-01-16,8562
3062,建漢,32,0,32,新光-高雄,2023-01-16,8562
00669R,國泰美國道瓊反1,28,0,28,新光-高雄,2023-01-16,8562
2812,台中銀,70,43,27,新光-高雄,2023-01-16,8562
9105,泰金寶-DR,32,6,26,新光-高雄,2023-01-16,8562
2883B,凱基金乙特,25,0,25,新光-高雄,2023-01-16,8562
2867,三商壽,30,7,23,新光-高雄,2023-01-16,8562
2884,玉山金,22,0,22,新光-高雄,2023-01-16,8562
8358,金居,42,20,22,新光-高雄,2023-01-16,8562
2618,長榮航,134,113,21,新光-高雄,2023-01-16,8562
3707,漢磊,24,3,21,新光-高雄,2023-01-16,8562
2413,環科,20,0,20,新光-高雄,2023-01-16,8562
6770,力積電,38,20,18,新光-高雄,2023-01-16,8562
6443,元晶,27,10,17,新光-高雄,2023-01-16,8562
5351,鈺創,18,1,17,新光-高雄,2023-01-16,8562
3374,精材,17,2,15,新光-高雄,2023-01-16,8562
0056,元大高股息,31,17,14,新光-高雄,2023-01-16,8562
00679B,元大美債20年,37,24,13,新光-高雄,2023-01-16,8562
00720B,元大投資級公司債,14,1,13,新光-高雄,2023-01-16,8562
6163,華電網,13,0,13,新光-高雄,2023-01-16,8562
1529,樂事綠能,14,1,13,新光-高雄,2023-01-16,8562
2609,陽明,26,13,13,新光-高雄,2023-01-16,8562
4102,永日,14,2,12,新光-高雄,2023-01-16,8562
8421,旭源,29,17,12,新光-高雄,2023-01-16,8562
2034,允強,12,0,12,新光-高雄,2023-01-16,8562
6285,啟��,12,1,11,新光-高雄,2023-01-16,8562
1560,中砂,14,3,11,新光-高雄,2023-01-16,8562
9103,美德醫療-DR,11,0,11,新光-高雄,2023-01-16,8562
2338,光罩,58,47,11,新光-高雄,2023-01-16,8562
2882,國泰金,21,10,11,新光-高雄,2023-01-16,8562
6215,和椿,11,1,10,新光-高雄,2023-01-16,8562
00921,兆豐龍頭等權重,10,0,10,新光-高雄,2023-01-16,8562
2489,瑞軒,10,0,10,新光-高雄,2023-01-16,8562
2812,台中銀,323,66,257,新光-高雄,2023-01-17,8562
4979,華星光,213,99,114,新光-高雄,2023-01-17,8562
00753L,中信中國50正2,115,6,109,新光-高雄,2023-01-17,8562
00673R,期元大S＆P原油反1,108,11,97,新光-高雄,2023-01-17,8562
00882,中信中國高股息,106,13,93,新光-高雄,2023-01-17,8562
00655L,國泰中國A50正2,100,38,62,新光-高雄,2023-01-17,8562
2610,華航,115,64,51,新光-高雄,2023-01-17,8562
2884,玉山金,51,0,51,新光-高雄,2023-01-17,8562
9103,美德醫療-DR,50,0,50,新光-高雄,2023-01-17,8562
3481,群創,79,35,44,新光-高雄,2023-01-17,8562
2332,友訊,40,1,39,新光-高雄,2023-01-17,8562
1519,華城,56,20,36,新光-高雄,2023-01-17,8562
6770,力積電,53,22,31,新光-高雄,2023-01-17,8562
00633L,富邦上証正2,29,0,29,新光-高雄,2023-01-17,8562
00706L,期元大S＆P日圓正2,25,0,25,新光-高雄,2023-01-17,8562
00772B,中信高評級公司債,34,12,22,新光-高雄,2023-01-17,8562
2633,台灣高鐵,23,0,23,新光-高雄,2023-01-17,8562
2312,金寶,25,4,21,新光-高雄,2023-01-17,8562
2449,京元電子,21,0,21,新光-高雄,2023-01-17,8562
2458,義隆,21,0,21,新光-高雄,2023-01-17,8562
5340,建榮,20,0,20,新光-高雄,2023-01-17,8562
00751B,元大AAA至A公司債,19,1,18,新光-高雄,2023-01-17,8562
4763,材料-KY,82,65,17,新光-高雄,2023-01-17,8562
4974,亞泰,47,30,17,新光-高雄,2023-01-17,8562
2317,鴻海,29,13,16,新光-高雄,2023-01-17,8562
1219,福壽,68,52,16,新光-高雄,2023-01-17,8562
3558,神準,18,3,15,新光-高雄,2023-01-17,8562
1752,南光,39,25,14,新光-高雄,2023-01-17,8562
00770,國泰北美科技,15,1,14,新光-高雄,2023-01-17,8562
6485,點序,15,1,14,新光-高雄,2023-01-17,8562
3379,彬台,14,0,14,新光-高雄,2023-01-17,8562
1514,亞力,33,19,14,新光-高雄,2023-01-17,8562
00888,永豐台灣ESG,15,2,13,新光-高雄,2023-01-17,8562
1701,中化,82,69,13,新光-高雄,2023-01-17,8562
6285,啟��,15,2,13,新光-高雄,2023-01-17,8562
0050,元大台灣50,18,5,13,新光-高雄,2023-01-17,8562
2614,東森,32,19,13,新光-高雄,2023-01-17,8562
00665L,富邦�琤肭磪囓�2,12,0,12,新光-高雄,2023-01-17,8562
2867,三商壽,12,0,12,新光-高雄,2023-01-17,8562
8069,元太,65,53,12,新光-高雄,2023-01-17,8562
6741,91APP*-KY,33,21,12,新光-高雄,2023-01-17,8562
00679B,元大美債20年,19,8,11,新光-高雄,2023-01-17,8562
00773B,中信優先金融債,10,0,10,新光-高雄,2023-01-17,8562
2328,廣宇,10,0,10,新光-高雄,2023-01-17,8562
4157,太景*-KY,10,0,10,新光-高雄,2023-01-17,8562
6163,華電網,11,1,10,新光-高雄,2023-01-17,8562
1783,和康生,12,2,10,新光-高雄,2023-01-17,8562
6461,益得,10,0,10,新光-高雄,2023-01-17,8562
8249,菱光,10,0,10,新光-高雄,2023-01-17,8562
5880,合庫金,14,4,10,新光-高雄,2023-01-17,8562
2313,華通,792,8,784,新光-高雄,2023-01-30,8562
00673R,期元大S＆P原油反1,200,0,200,新光-高雄,2023-01-30,8562
2317,鴻海,130,11,119,新光-高雄,2023-01-30,8562
00753L,中信中國50正2,110,10,100,新光-高雄,2023-01-30,8562
1584,精剛,96,17,79,新光-高雄,2023-01-30,8562
4979,華星光,119,46,73,新光-高雄,2023-01-30,8562
3447,展達,67,1,66,新光-高雄,2023-01-30,8562
9103,美德醫療-DR,52,0,52,新光-高雄,2023-01-30,8562
1219,福壽,52,0,52,新光-高雄,2023-01-30,8562
3682,亞太電,48,1,47,新光-高雄,2023-01-30,8562
00655L,國泰中國A50正2,80,34,46,新光-高雄,2023-01-30,8562
01003T,兆豐新光R1,43,0,43,新光-高雄,2023-01-30,8562
00665L,富邦�琤肭磪囓�2,40,3,37,新光-高雄,2023-01-30,8562
4190,佐登-KY,44,7,37,新光-高雄,2023-01-30,8562
00706L,期元大S＆P日圓正2,84,51,33,新光-高雄,2023-01-30,8562
00650L,復華香港正2,50,20,30,新光-高雄,2023-01-30,8562
6130,上亞科技,58,28,30,新光-高雄,2023-01-30,8562
6531,愛普*,35,6,29,新光-高雄,2023-01-30,8562
8936,國統,51,23,28,新光-高雄,2023-01-30,8562
00676R,富邦臺灣加權反1,27,0,27,新光-高雄,2023-01-30,8562
3036A,文曄甲特,28,1,27,新光-高雄,2023-01-30,8562
9904,寶成,43,17,26,新光-高雄,2023-01-30,8562
8069,元太,75,50,25,新光-高雄,2023-01-30,8562
2892,第一金,63,40,23,新光-高雄,2023-01-30,8562
3714,富采,23,1,22,新光-高雄,2023-01-30,8562
4114,健喬,33,11,22,新光-高雄,2023-01-30,8562
2413,環科,22,0,22,新光-高雄,2023-01-30,8562
00637L,元大滬深300正2,59,37,22,新光-高雄,2023-01-30,8562
5388,中磊,25,4,21,新光-高雄,2023-01-30,8562
6182,合晶,50,29,21,新光-高雄,2023-01-30,8562
2014,中鴻,39,19,20,新光-高雄,2023-01-30,8562
2017,官田鋼,20,0,20,新光-高雄,2023-01-30,8562
00648R,元大S＆P500反1,20,0,20,新光-高雄,2023-01-30,8562
00679B,元大美債20年,28,9,19,新光-高雄,2023-01-30,8562
8249,菱光,19,0,19,新光-高雄,2023-01-30,8562
00772B,中信高評級公司債,18,0,18,新光-高雄,2023-01-30,8562
3162,精確,25,7,18,新光-高雄,2023-01-30,8562
1701,中化,72,54,18,新光-高雄,2023-01-30,8562
2851,中再保,22,4,18,新光-高雄,2023-01-30,8562
1109,信大,18,0,18,新光-高雄,2023-01-30,8562
8933,愛地雅,17,0,17,新光-高雄,2023-01-30,8562
1513,中興電,52,36,16,新光-高雄,2023-01-30,8562
3207,耀勝,17,1,16,新光-高雄,2023-01-30,8562
6443,元晶,20,4,16,新光-高雄,2023-01-30,8562
4532,瑞智,15,0,15,新光-高雄,2023-01-30,8562
1504,東元,17,2,15,新光-高雄,2023-01-30,8562
1324,地球,15,0,15,新光-高雄,2023-01-30,8562
8358,金居,30,15,15,新光-高雄,2023-01-30,8562
5236,凌陽創新,14,0,14,新光-高雄,2023-01-30,8562
2812,台中銀,48,34,14,新光-高雄,2023-01-30,8562
2313,華通,223,13,210,新光-高雄,2023-01-31,8562
00648R,元大S＆P500反1,166,0,166,新光-高雄,2023-01-31,8562
00632R,元大台灣50反1,219,73,146,新光-高雄,2023-01-31,8562
2880,華南金,115,1,114,新光-高雄,2023-01-31,8562
00905,FT臺灣Smart,111,21,90,新光-高雄,2023-01-31,8562
00673R,期元大S＆P原油反1,112,25,87,新光-高雄,2023-01-31,8562
2892,第一金,72,10,62,新光-高雄,2023-01-31,8562
00878,國泰永續高股息,159,100,59,新光-高雄,2023-01-31,8562
00772B,中信高評級公司債,52,0,52,新光-高雄,2023-01-31,8562
2891,中信金,49,1,48,新光-高雄,2023-01-31,8562
00637L,元大滬深300正2,67,20,47,新光-高雄,2023-01-31,8562
2887,台新金,46,5,41,新光-高雄,2023-01-31,8562
2890,永豐金,46,6,40,新光-高雄,2023-01-31,8562
1101,台泥,44,6,38,新光-高雄,2023-01-31,8562
2884,玉山金,39,2,37,新光-高雄,2023-01-31,8562
00720B,元大投資級公司債,43,10,33,新光-高雄,2023-01-31,8562
3686,達能,33,0,33,新光-高雄,2023-01-31,8562
2324,仁寶,35,4,31,新光-高雄,2023-01-31,8562
2412,中華電,45,16,29,新光-高雄,2023-01-31,8562
5880,合庫金,30,1,29,新光-高雄,2023-01-31,8562
00706L,期元大S＆P日圓正2,43,15,28,新光-高雄,2023-01-31,8562
1608,華榮,57,30,27,新光-高雄,2023-01-31,8562
2886,兆豐金,28,1,27,新光-高雄,2023-01-31,8562
2303,聯電,123,97,26,新光-高雄,2023-01-31,8562
00701,國泰股利精選30,27,1,26,新光-高雄,2023-01-31,8562
4979,華星光,94,68,26,新光-高雄,2023-01-31,8562
4743,合一,38,12,26,新光-高雄,2023-01-31,8562
2330,台積電,56,31,25,新光-高雄,2023-01-31,8562
00679B,元大美債20年,36,12,24,新光-高雄,2023-01-31,8562
1605,華新,199,175,24,新光-高雄,2023-01-31,8562
6139,亞翔,26,2,24,新光-高雄,2023-01-31,8562
6109,亞元,22,0,22,新光-高雄,2023-01-31,8562
2368,金像電,25,4,21,新光-高雄,2023-01-31,8562
4162,智擎,33,12,21,新光-高雄,2023-01-31,8562
8016,矽創,31,10,21,新光-高雄,2023-01-31,8562
1618,合機,20,0,20,新光-高雄,2023-01-31,8562
1504,東元,79,59,20,新光-高雄,2023-01-31,8562
2337,旺宏,31,14,17,新光-高雄,2023-01-31,8562
8933,愛地雅,18,1,17,新光-高雄,2023-01-31,8562
2885,元大金,16,0,16,新光-高雄,2023-01-31,8562
3209,全科,21,5,16,新光-高雄,2023-01-31,8562
00655L,國泰中國A50正2,41,25,16,新光-高雄,2023-01-31,8562
2408,南亞科,20,4,16,新光-高雄,2023-01-31,8562
3576,聯合再生,25,10,15,新光-高雄,2023-01-31,8562
00770,國泰北美科技,16,1,15,新光-高雄,2023-01-31,8562
1324,地球,16,1,15,新光-高雄,2023-01-31,8562
6174,安��,18,3,15,新光-高雄,2023-01-31,8562
2436,偉詮電,20,5,15,新光-高雄,2023-01-31,8562
5871A,中租-KY甲特,15,0,15,新光-高雄,2023-01-31,8562
00665L,富邦�琤肭磪囓�2,14,0,14,新光-高雄,2023-01-31,8562
2618,長榮航,465,177,288,新光-高雄,2023-02-01,8562
00715L,期街口布蘭特正2,225,19,206,新光-高雄,2023-02-01,8562
8429,金麗-KY,94,10,84,新光-高雄,2023-02-01,8562
00772B,中信高評級公司債,66,0,66,新光-高雄,2023-02-01,8562
00637L,元大滬深300正2,73,15,58,新光-高雄,2023-02-01,8562
5014,建錩,107,57,50,新光-高雄,2023-02-01,8562
2834,臺企銀,43,0,43,新光-高雄,2023-02-01,8562
00701,國泰股利精選30,43,0,43,新光-高雄,2023-02-01,8562
6233,旺玖,41,0,41,新光-高雄,2023-02-01,8562
2812,台中銀,43,2,41,新光-高雄,2023-02-01,8562
3576,聯合再生,96,55,41,新光-高雄,2023-02-01,8562
00720B,元大投資級公司債,40,0,40,新光-高雄,2023-02-01,8562
2017,官田鋼,43,4,39,新光-高雄,2023-02-01,8562
3035,智原,91,53,38,新光-高雄,2023-02-01,8562
00751B,元大AAA至A公司債,37,0,37,新光-高雄,2023-02-01,8562
2897,王道銀行,51,15,36,新光-高雄,2023-02-01,8562
2009,第一銅,173,138,35,新光-高雄,2023-02-01,8562
5340,建榮,35,0,35,新光-高雄,2023-02-01,8562
1584,精剛,104,70,34,新光-高雄,2023-02-01,8562
00882,中信中國高股息,34,0,34,新光-高雄,2023-02-01,8562
2883,凱基金,39,6,33,新光-高雄,2023-02-01,8562
00885,富邦越南,46,13,33,新光-高雄,2023-02-01,8562
6679,鈺太,41,10,31,新光-高雄,2023-02-01,8562
3027,盛達,53,23,30,新光-高雄,2023-02-01,8562
1810,和成,54,24,30,新光-高雄,2023-02-01,8562
2412,中華電,76,46,30,新光-高雄,2023-02-01,8562
1618,合機,30,1,29,新光-高雄,2023-02-01,8562
2889,國票金,30,1,29,新光-高雄,2023-02-01,8562
9904,寶成,28,0,28,新光-高雄,2023-02-01,8562
1227,佳格,31,3,28,新光-高雄,2023-02-01,8562
2413,環科,48,20,28,新光-高雄,2023-02-01,8562
2317,鴻海,48,21,27,新光-高雄,2023-02-01,8562
2014,中鴻,89,62,27,新光-高雄,2023-02-01,8562
00902,中信電池及儲能,26,1,25,新光-高雄,2023-02-01,8562
6531,愛普*,35,10,25,新光-高雄,2023-02-01,8562
6257,矽格,26,1,25,新光-高雄,2023-02-01,8562
6139,亞翔,27,3,24,新光-高雄,2023-02-01,8562
1701,中化,45,21,24,新光-高雄,2023-02-01,8562
2409,友達,28,6,22,新光-高雄,2023-02-01,8562
4162,智擎,41,19,22,新光-高雄,2023-02-01,8562
2406,國碩,23,1,22,新光-高雄,2023-02-01,8562
00706L,期元大S＆P日圓正2,28,6,22,新光-高雄,2023-02-01,8562
8044,網家,56,34,22,新光-高雄,2023-02-01,8562
4164,承業醫,26,4,22,新光-高雄,2023-02-01,8562
8105,凌巨,49,27,22,新光-高雄,2023-02-01,8562
9921,巨大,21,0,21,新光-高雄,2023-02-01,8562
00648R,元大S＆P500反1,20,0,20,新光-高雄,2023-02-01,8562
3312,弘憶股,20,1,19,新光-高雄,2023-02-01,8562
2891,中信金,38,20,18,新光-高雄,2023-02-01,8562
8499,鼎炫-KY,18,0,18,新光-高雄,2023-02-01,8562
00632R,元大台灣50反1,1960,268,1692,新光-高雄,2023-02-02,8562
3041,揚智,205,5,200,新光-高雄,2023-02-02,8562
00671R,富邦NASDAQ反1,170,0,170,新光-高雄,2023-02-02,8562
2834,臺企銀,197,33,164,新光-高雄,2023-02-02,8562
00683L,期元大美元指正2,160,0,160,新光-高雄,2023-02-02,8562
2634,漢翔,162,5,157,新光-高雄,2023-02-02,8562
00680L,元大美債20正2,201,50,151,新光-高雄,2023-02-02,8562
2610,華航,267,135,132,新光-高雄,2023-02-02,8562
00885,富邦越南,146,16,130,新光-高雄,2023-02-02,8562
6205,詮欣,111,3,108,新光-高雄,2023-02-02,8562
00878,國泰永續高股息,139,35,104,新光-高雄,2023-02-02,8562
1810,和成,126,26,100,新光-高雄,2023-02-02,8562
1909,榮成,110,12,98,新光-高雄,2023-02-02,8562
2354,鴻準,110,22,88,新光-高雄,2023-02-02,8562
00882,中信中國高股息,85,10,75,新光-高雄,2023-02-02,8562
2891,中信金,84,15,69,新光-高雄,2023-02-02,8562
00772B,中信高評級公司債,84,22,62,新光-高雄,2023-02-02,8562
00720B,元大投資級公司債,62,1,61,新光-高雄,2023-02-02,8562
4168,醣聯,63,2,61,新光-高雄,2023-02-02,8562
4306,炎洲,60,0,60,新光-高雄,2023-02-02,8562
00637L,元大滬深300正2,73,15,58,新光-高雄,2023-02-02,8562
9105,泰金寶-DR,106,51,55,新光-高雄,2023-02-02,8562
4968,立積,53,3,50,新光-高雄,2023-02-02,8562
00701,國泰股利精選30,46,1,45,新光-高雄,2023-02-02,8562
2367,燿華,50,7,43,新光-高雄,2023-02-02,8562
1513,中興電,66,34,32,新光-高雄,2023-02-02,8562
6191,精成科,30,0,30,新光-高雄,2023-02-02,8562
00753L,中信中國50正2,50,21,29,新光-高雄,2023-02-02,8562
00633L,富邦上証正2,33,4,29,新光-高雄,2023-02-02,8562
5014,建錩,35,6,29,新光-高雄,2023-02-02,8562
6244,茂迪,41,13,28,新光-高雄,2023-02-02,8562
2884,玉山金,31,3,28,新光-高雄,2023-02-02,8562
6129,普誠,81,54,27,新光-高雄,2023-02-02,8562
2888,新光金,28,2,26,新光-高雄,2023-02-02,8562
00751B,元大AAA至A公司債,25,0,25,新光-高雄,2023-02-02,8562
2727,王品,40,16,24,新光-高雄,2023-02-02,8562
5388,中磊,26,3,23,新光-高雄,2023-02-02,8562
1522,堤維西,23,0,23,新光-高雄,2023-02-02,8562
00669R,國泰美國道瓊反1,25,3,22,新光-高雄,2023-02-02,8562
00902,中信電池及儲能,34,13,21,新光-高雄,2023-02-02,8562
2886,兆豐金,27,6,21,新光-高雄,2023-02-02,8562
6443,元晶,100,80,20,新光-高雄,2023-02-02,8562
4951,精拓科,20,0,20,新光-高雄,2023-02-02,8562
2892,第一金,20,1,19,新光-高雄,2023-02-02,8562
8049,晶采,20,1,19,新光-高雄,2023-02-02,8562
2495,普安,21,2,19,新光-高雄,2023-02-02,8562
4931,新盛力,28,9,19,新光-高雄,2023-02-02,8562
00773B,中信優先金融債,20,1,19,新光-高雄,2023-02-02,8562
3481,群創,50,31,19,新光-高雄,2023-02-02,8562
2022,聚亨,20,1,19,新光-高雄,2023-02-02,8562
00632R,元大台灣50反1,650,191,459,新光-高雄,2023-02-03,8562
00637L,元大滬深300正2,390,41,349,新光-高雄,2023-02-03,8562
00715L,期街口布蘭特正2,313,0,313,新光-高雄,2023-02-03,8562
00878,國泰永續高股息,274,10,264,新光-高雄,2023-02-03,8562
2834,臺企銀,362,150,212,新光-高雄,2023-02-03,8562
2344,華邦電,199,17,182,新光-高雄,2023-02-03,8562
00655L,國泰中國A50正2,211,108,103,新光-高雄,2023-02-03,8562
00882,中信中國高股息,121,28,93,新光-高雄,2023-02-03,8562
2610,華航,106,23,83,新光-高雄,2023-02-03,8562
2498,宏達電,308,226,82,新光-高雄,2023-02-03,8562
2450,神腦,84,5,79,新光-高雄,2023-02-03,8562
2481,強茂,109,33,76,新光-高雄,2023-02-03,8562
00665L,富邦�琤肭磪囓�2,69,0,69,新光-高雄,2023-02-03,8562
4114,健喬,165,109,56,新光-高雄,2023-02-03,8562
2609,陽明,107,56,51,新光-高雄,2023-02-03,8562
4979,華星光,100,51,49,新光-高雄,2023-02-03,8562
2014,中鴻,50,2,48,新光-高雄,2023-02-03,8562
2888,新光金,42,0,42,新光-高雄,2023-02-03,8562
8429,金麗-KY,41,0,41,新光-高雄,2023-02-03,8562
0056,元大高股息,47,7,40,新光-高雄,2023-02-03,8562
2027,大成鋼,41,2,39,新光-高雄,2023-02-03,8562
1810,和成,41,3,38,新光-高雄,2023-02-03,8562
00713,元大台灣高息低波,37,1,36,新光-高雄,2023-02-03,8562
2884,玉山金,46,11,35,新光-高雄,2023-02-03,8562
6118,建達,106,72,34,新光-高雄,2023-02-03,8562
2323,中環,47,13,34,新光-高雄,2023-02-03,8562
00680L,元大美債20正2,33,0,33,新光-高雄,2023-02-03,8562
2882,國泰金,38,7,31,新光-高雄,2023-02-03,8562
00852L,國泰美國道瓊正2,34,3,31,新光-高雄,2023-02-03,8562
3037,欣興,50,19,31,新光-高雄,2023-02-03,8562
2317,鴻海,42,12,30,新光-高雄,2023-02-03,8562
00648R,元大S＆P500反1,30,0,30,新光-高雄,2023-02-03,8562
5258,虹堡,125,96,29,新光-高雄,2023-02-03,8562
5285,界霖,41,13,28,新光-高雄,2023-02-03,8562
2615,萬海,114,86,28,新光-高雄,2023-02-03,8562
2891,中信金,27,0,27,新光-高雄,2023-02-03,8562
1608,華榮,26,0,26,新光-高雄,2023-02-03,8562
2425,承啟,20,0,20,新光-高雄,2023-02-03,8562
3305,昇貿,26,8,18,新光-高雄,2023-02-03,8562
1310,台苯,18,1,17,新光-高雄,2023-02-03,8562
2812,台中銀,59,43,16,新光-高雄,2023-02-03,8562
4438,廣越,16,0,16,新光-高雄,2023-02-03,8562
2614,東森,23,8,15,新光-高雄,2023-02-03,8562
00676R,富邦臺灣加權反1,15,0,15,新光-高雄,2023-02-03,8562
1336,台翰,24,9,15,新光-高雄,2023-02-03,8562
3036,文曄,16,1,15,新光-高雄,2023-02-03,8562
00642U,期元大S＆P石油,15,0,15,新光-高雄,2023-02-03,8562
2886,兆豐金,15,0,15,新光-高雄,2023-02-03,8562
00679B,元大美債20年,16,1,15,新光-高雄,2023-02-03,8562
8936,國統,14,0,14,新光-高雄,2023-02-03,8562
00878,國泰永續高股息,382,33,349,新光-高雄,2023-02-06,8562
00637L,元大滬深300正2,353,48,305,新光-高雄,2023-02-06,8562
00715L,期街口布蘭特正2,264,2,262,新光-高雄,2023-02-06,8562
00882,中信中國高股息,120,0,120,新光-高雄,2023-02-06,8562
00706L,期元大S＆P日圓正2,83,0,83,新光-高雄,2023-02-06,8562
00665L,富邦�琤肭磪囓�2,91,10,81,新光-高雄,2023-02-06,8562
00642U,期元大S＆P石油,78,0,78,新光-高雄,2023-02-06,8562
00772B,中信高評級公司債,77,0,77,新光-高雄,2023-02-06,8562
2323,中環,50,1,49,新光-高雄,2023-02-06,8562
2834,臺企銀,98,50,48,新光-高雄,2023-02-06,8562
4164,承業醫,54,7,47,新光-高雄,2023-02-06,8562
00679B,元大美債20年,45,4,41,新光-高雄,2023-02-06,8562
2344,華邦電,62,25,37,新光-高雄,2023-02-06,8562
00773B,中信優先金融債,33,0,33,新光-高雄,2023-02-06,8562
1605,華新,80,47,33,新光-高雄,2023-02-06,8562
00751B,元大AAA至A公司債,32,0,32,新光-高雄,2023-02-06,8562
2603,長榮,39,9,30,新光-高雄,2023-02-06,8562
3056,富華新,30,0,30,新光-高雄,2023-02-06,8562
00633L,富邦上証正2,39,9,30,新光-高雄,2023-02-06,8562
1609,大亞,41,12,29,新光-高雄,2023-02-06,8562
2884,玉山金,27,1,26,新光-高雄,2023-02-06,8562
00720B,元大投資級公司債,41,16,25,新光-高雄,2023-02-06,8562
006208,富邦台50,25,2,23,新光-高雄,2023-02-06,8562
00918,大華優利高填息30,23,0,23,新光-高雄,2023-02-06,8562
5880,合庫金,23,1,22,新光-高雄,2023-02-06,8562
2027,大成鋼,23,1,22,新光-高雄,2023-02-06,8562
8050,廣積,31,9,22,新光-高雄,2023-02-06,8562
6770,力積電,63,41,22,新光-高雄,2023-02-06,8562
2880,華南金,22,1,21,新光-高雄,2023-02-06,8562
2408,南亞科,21,0,21,新光-高雄,2023-02-06,8562
3576,聯合再生,22,1,21,新光-高雄,2023-02-06,8562
6548,長科*,25,5,20,新光-高雄,2023-02-06,8562
00794B,群益7+中國政金債,20,0,20,新光-高雄,2023-02-06,8562
8070,長華*,20,1,19,新光-高雄,2023-02-06,8562
6485,點序,18,0,18,新光-高雄,2023-02-06,8562
3037,欣興,52,35,17,新光-高雄,2023-02-06,8562
2887,台新金,19,2,17,新光-高雄,2023-02-06,8562
2337,旺宏,17,1,16,新光-高雄,2023-02-06,8562
5353,台林,29,13,16,新光-高雄,2023-02-06,8562
00753L,中信中國50正2,15,0,15,新光-高雄,2023-02-06,8562
2409,友達,27,12,15,新光-高雄,2023-02-06,8562
2014,中鴻,18,3,15,新光-高雄,2023-02-06,8562
6005,群益證,16,1,15,新光-高雄,2023-02-06,8562
6182,合晶,14,0,14,新光-高雄,2023-02-06,8562
5315,光聯,15,1,14,新光-高雄,2023-02-06,8562
8046,南電,41,27,14,新光-高雄,2023-02-06,8562
6235,華孚,89,75,14,新光-高雄,2023-02-06,8562
2449,京元電子,15,2,13,新光-高雄,2023-02-06,8562
9904,寶成,13,0,13,新光-高雄,2023-02-06,8562
3231,緯創,13,0,13,新光-高雄,2023-02-06,8562
00715L,期街口布蘭特正2,745,8,737,新光-高雄,2023-02-07,8562
6282,康舒,458,125,333,新光-高雄,2023-02-07,8562
8105,凌巨,208,36,172,新光-高雄,2023-02-07,8562
1417,嘉裕,127,15,112,新光-高雄,2023-02-07,8562
2867,三商壽,105,2,103,新光-高雄,2023-02-07,8562
2450,神腦,132,38,94,新光-高雄,2023-02-07,8562
00706L,期元大S＆P日圓正2,90,0,90,新光-高雄,2023-02-07,8562
2618,長榮航,158,68,90,新光-高雄,2023-02-07,8562
00878,國泰永續高股息,154,75,79,新光-高雄,2023-02-07,8562
8227,巨有科技,106,32,74,新光-高雄,2023-02-07,8562
2883,凱基金,74,13,61,新光-高雄,2023-02-07,8562
4114,健喬,213,163,50,新光-高雄,2023-02-07,8562
2609,陽明,60,14,46,新光-高雄,2023-02-07,8562
00772B,中信高評級公司債,44,0,44,新光-高雄,2023-02-07,8562
4128,中天,51,9,42,新光-高雄,2023-02-07,8562
1752,南光,187,152,35,新光-高雄,2023-02-07,8562
2498,宏達電,77,42,35,新光-高雄,2023-02-07,8562
2887,台新金,45,10,35,新光-高雄,2023-02-07,8562
1605,華新,87,53,34,新光-高雄,2023-02-07,8562
00680L,元大美債20正2,33,0,33,新光-高雄,2023-02-07,8562
2317,鴻海,43,12,31,新光-高雄,2023-02-07,8562
2891,中信金,34,3,31,新光-高雄,2023-02-07,8562
6139,亞翔,30,0,30,新光-高雄,2023-02-07,8562
3047,訊舟,30,0,30,新光-高雄,2023-02-07,8562
3576,聯合再生,32,3,29,新光-高雄,2023-02-07,8562
00679B,元大美債20年,29,0,29,新光-高雄,2023-02-07,8562
1760,寶齡富錦,37,9,28,新光-高雄,2023-02-07,8562
4142,國光生,32,6,26,新光-高雄,2023-02-07,8562
1219,福壽,30,5,25,新光-高雄,2023-02-07,8562
3037,欣興,35,12,23,新光-高雄,2023-02-07,8562
4726,永昕,32,10,22,新光-高雄,2023-02-07,8562
00712,復華富時不動產,23,1,22,新光-高雄,2023-02-07,8562
3680,家登,23,2,21,新光-高雄,2023-02-07,8562
2892,第一金,20,0,20,新光-高雄,2023-02-07,8562
2324,仁寶,19,0,19,新光-高雄,2023-02-07,8562
4104,佳醫,21,2,19,新光-高雄,2023-02-07,8562
2504,國產,30,11,19,新光-高雄,2023-02-07,8562
00639,富邦深100,18,0,18,新光-高雄,2023-02-07,8562
8044,網家,33,15,18,新光-高雄,2023-02-07,8562
00720B,元大投資級公司債,39,22,17,新光-高雄,2023-02-07,8562
00751B,元大AAA至A公司債,16,0,16,新光-高雄,2023-02-07,8562
6603,富強鑫,16,0,16,新光-高雄,2023-02-07,8562
6570,維田,18,2,16,新光-高雄,2023-02-07,8562
3035,智原,33,17,16,新光-高雄,2023-02-07,8562
6788,華景電,20,5,15,新光-高雄,2023-02-07,8562
2812,台中銀,99,85,14,新光-高雄,2023-02-07,8562
2816,旺旺保,13,0,13,新光-高雄,2023-02-07,8562
6414,樺漢,13,0,13,新光-高雄,2023-02-07,8562
00900,富邦特選高股息30,12,0,12,新光-高雄,2023-02-07,8562
6237,驊訊,12,0,12,新光-高雄,2023-02-07,8562
2834,臺企銀,360,50,310,新光-高雄,2023-02-08,8562
00673R,期元大S＆P原油反1,103,0,103,新光-高雄,2023-02-08,8562
00878,國泰永續高股息,153,54,99,新光-高雄,2023-02-08,8562
8105,凌巨,99,9,90,新光-高雄,2023-02-08,8562
2610,華航,127,43,84,新光-高雄,2023-02-08,8562
2884,玉山金,83,12,71,新光-高雄,2023-02-08,8562
00637L,元大滬深300正2,74,22,52,新光-高雄,2023-02-08,8562
2892,第一金,53,2,51,新光-高雄,2023-02-08,8562
2880,華南金,44,1,43,新光-高雄,2023-02-08,8562
00680L,元大美債20正2,142,100,42,新光-高雄,2023-02-08,8562
8069,元太,78,37,41,新光-高雄,2023-02-08,8562
3682,亞太電,41,1,40,新光-高雄,2023-02-08,8562
00664R,國泰臺灣加權反1,40,0,40,新光-高雄,2023-02-08,8562
00753L,中信中國50正2,40,0,40,新光-高雄,2023-02-08,8562
00669R,國泰美國道瓊反1,39,0,39,新光-高雄,2023-02-08,8562
00885,富邦越南,39,0,39,新光-高雄,2023-02-08,8562
00679B,元大美債20年,42,7,35,新光-高雄,2023-02-08,8562
5880,合庫金,34,0,34,新光-高雄,2023-02-08,8562
9904,寶成,52,20,32,新光-高雄,2023-02-08,8562
00665L,富邦�琤肭磪囓�2,32,0,32,新光-高雄,2023-02-08,8562
2358,廷鑫,30,0,30,新光-高雄,2023-02-08,8562
2614,東森,32,2,30,新光-高雄,2023-02-08,8562
3479,安勤,49,19,30,新光-高雄,2023-02-08,8562
8084,巨虹,28,0,28,新光-高雄,2023-02-08,8562
2344,華邦電,49,22,27,新光-高雄,2023-02-08,8562
2450,神腦,35,8,27,新光-高雄,2023-02-08,8562
6282,康舒,52,26,26,新光-高雄,2023-02-08,8562
2812,台中銀,74,49,25,新光-高雄,2023-02-08,8562
3022,威強電,46,21,25,新光-高雄,2023-02-08,8562
6129,普誠,30,5,25,新光-高雄,2023-02-08,8562
00780B,國泰A級金融債,25,1,24,新光-高雄,2023-02-08,8562
2201,裕隆,82,58,24,新光-高雄,2023-02-08,8562
1227,佳格,23,0,23,新光-高雄,2023-02-08,8562
3162,精確,63,40,23,新光-高雄,2023-02-08,8562
1439,雋揚,23,0,23,新光-高雄,2023-02-08,8562
2890,永豐金,23,1,22,新光-高雄,2023-02-08,8562
00772B,中信高評級公司債,25,3,22,新光-高雄,2023-02-08,8562
2801,彰銀,21,0,21,新光-高雄,2023-02-08,8562
2883,凱基金,24,3,21,新光-高雄,2023-02-08,8562
00648R,元大S＆P500反1,20,0,20,新光-高雄,2023-02-08,8562
2888,新光金,25,6,19,新光-高雄,2023-02-08,8562
2363,矽統,19,1,18,新光-高雄,2023-02-08,8562
6117,迎廣,23,5,18,新光-高雄,2023-02-08,8562
1584,精剛,88,70,18,新光-高雄,2023-02-08,8562
2444,兆勁,18,0,18,新光-高雄,2023-02-08,8562
00720B,元大投資級公司債,32,14,18,新光-高雄,2023-02-08,8562
5009,榮剛,30,13,17,新光-高雄,2023-02-08,8562
2867,三商壽,29,12,17,新光-高雄,2023-02-08,8562
6570,維田,17,0,17,新光-高雄,2023-02-08,8562
2727,王品,19,2,17,新光-高雄,2023-02-08,8562
2834,臺企銀,511,97,414,新光-高雄,2023-02-09,8562
00673R,期元大S＆P原油反1,395,70,325,新光-高雄,2023-02-09,8562
00878,國泰永續高股息,230,12,218,新光-高雄,2023-02-09,8562
1409,新纖,245,28,217,新光-高雄,2023-02-09,8562
3708,上緯投控,64,2,62,新光-高雄,2023-02-09,8562
00715L,期街口布蘭特正2,315,259,56,新光-高雄,2023-02-09,8562
6531,愛普*,55,9,46,新光-高雄,2023-02-09,8562
2867,三商壽,45,0,45,新光-高雄,2023-02-09,8562
9105,泰金寶-DR,40,0,40,新光-高雄,2023-02-09,8562
6411,晶焱,61,21,40,新光-高雄,2023-02-09,8562
00680L,元大美債20正2,38,0,38,新光-高雄,2023-02-09,8562
2002,中鋼,44,7,37,新光-高雄,2023-02-09,8562
6245,立端,67,33,34,新光-高雄,2023-02-09,8562
2388,威盛,136,102,34,新光-高雄,2023-02-09,8562
1316,上曜,32,0,32,新光-高雄,2023-02-09,8562
4533,協易機,33,1,32,新光-高雄,2023-02-09,8562
8222,寶一,36,5,31,新光-高雄,2023-02-09,8562
2401,凌陽,42,11,31,新光-高雄,2023-02-09,8562
4113,聯上,30,0,30,新光-高雄,2023-02-09,8562
1437,勤益控,33,8,25,新光-高雄,2023-02-09,8562
2603,長榮,28,5,23,新光-高雄,2023-02-09,8562
6139,亞翔,22,0,22,新光-高雄,2023-02-09,8562
3680,家登,53,31,22,新光-高雄,2023-02-09,8562
8234,新漢,24,3,21,新光-高雄,2023-02-09,8562
1785,光洋科,24,3,21,新光-高雄,2023-02-09,8562
6129,普誠,46,26,20,新光-高雄,2023-02-09,8562
5258,虹堡,22,4,18,新光-高雄,2023-02-09,8562
2890,永豐金,18,0,18,新光-高雄,2023-02-09,8562
4164,承業醫,20,2,18,新光-高雄,2023-02-09,8562
6138,茂達,44,27,17,新光-高雄,2023-02-09,8562
3444,利機,24,8,16,新光-高雄,2023-02-09,8562
6170,統振,16,0,16,新光-高雄,2023-02-09,8562
00881,國泰台灣5G+,15,0,15,新光-高雄,2023-02-09,8562
00676R,富邦臺灣加權反1,15,0,15,新光-高雄,2023-02-09,8562
2484,希華,22,7,15,新光-高雄,2023-02-09,8562
4190,佐登-KY,15,0,15,新光-高雄,2023-02-09,8562
6235,華孚,229,214,15,新光-高雄,2023-02-09,8562
3128,昇銳,32,18,14,新光-高雄,2023-02-09,8562
2405,輔信,15,1,14,新光-高雄,2023-02-09,8562
00665L,富邦�琤肭磪囓�2,28,14,14,新光-高雄,2023-02-09,8562
3010,華立,14,1,13,新光-高雄,2023-02-09,8562
1432,大魯閣,20,7,13,新光-高雄,2023-02-09,8562
1310,台苯,12,0,12,新光-高雄,2023-02-09,8562
6443,元晶,19,7,12,新光-高雄,2023-02-09,8562
2009,第一銅,22,10,12,新光-高雄,2023-02-09,8562
2450,神腦,31,19,12,新光-高雄,2023-02-09,8562
5014,建錩,15,3,12,新光-高雄,2023-02-09,8562
4743,合一,33,22,11,新光-高雄,2023-02-09,8562
3036A,文曄甲特,11,0,11,新光-高雄,2023-02-09,8562
3508,位速,11,0,11,新光-高雄,2023-02-09,8562
00878,國泰永續高股息,336,3,333,新光-高雄,2023-02-10,8562
2450,神腦,177,3,174,新光-高雄,2023-02-10,8562
00637L,元大滬深300正2,228,61,167,新光-高雄,2023-02-10,8562
1810,和成,223,102,121,新光-高雄,2023-02-10,8562
00632R,元大台灣50反1,144,25,119,新光-高雄,2023-02-10,8562
2405,輔信,133,15,118,新光-高雄,2023-02-10,8562
2409,友達,147,36,111,新光-高雄,2023-02-10,8562
00712,復華富時不動產,109,0,109,新光-高雄,2023-02-10,8562
2610,華航,151,45,106,新光-高雄,2023-02-10,8562
2344,華邦電,230,134,96,新光-高雄,2023-02-10,8562
00673R,期元大S＆P原油反1,111,17,94,新光-高雄,2023-02-10,8562
0056,元大高股息,99,6,93,新光-高雄,2023-02-10,8562
2618,長榮航,95,22,73,新光-高雄,2023-02-10,8562
00772B,中信高評級公司債,62,0,62,新光-高雄,2023-02-10,8562
4130,健亞,78,18,60,新光-高雄,2023-02-10,8562
8105,凌巨,62,14,48,新光-高雄,2023-02-10,8562
00715L,期街口布蘭特正2,188,141,47,新光-高雄,2023-02-10,8562
6770,力積電,48,3,45,新光-高雄,2023-02-10,8562
2897,王道銀行,50,6,44,新光-高雄,2023-02-10,8562
1605,華新,73,31,42,新光-高雄,2023-02-10,8562
2498,宏達電,127,85,42,新光-高雄,2023-02-10,8562
00679B,元大美債20年,58,20,38,新光-高雄,2023-02-10,8562
4114,健喬,61,24,37,新光-高雄,2023-02-10,8562
1795,美時,97,61,36,新光-高雄,2023-02-10,8562
2867,三商壽,49,15,34,新光-高雄,2023-02-10,8562
00902,中信電池及儲能,32,0,32,新光-高雄,2023-02-10,8562
3625,西勝,31,0,31,新光-高雄,2023-02-10,8562
2023,燁輝,32,2,30,新光-高雄,2023-02-10,8562
3047,訊舟,33,3,30,新光-高雄,2023-02-10,8562
6120,達運,30,0,30,新光-高雄,2023-02-10,8562
5608,四維航,31,2,29,新光-高雄,2023-02-10,8562
2537,聯上發,29,0,29,新光-高雄,2023-02-10,8562
1708,東鹼,30,1,29,新光-高雄,2023-02-10,8562
6799,來頡,31,3,28,新光-高雄,2023-02-10,8562
3062,建漢,26,1,25,新光-高雄,2023-02-10,8562
00681R,元大美債20反1,25,0,25,新光-高雄,2023-02-10,8562
00720B,元大投資級公司債,30,6,24,新光-高雄,2023-02-10,8562
3209,全科,38,15,23,新光-高雄,2023-02-10,8562
1217,愛之味,24,1,23,新光-高雄,2023-02-10,8562
00753L,中信中國50正2,36,14,22,新光-高雄,2023-02-10,8562
00885,富邦越南,21,1,20,新光-高雄,2023-02-10,8562
2327,國巨,20,0,20,新光-高雄,2023-02-10,8562
00780B,國泰A級金融債,20,0,20,新光-高雄,2023-02-10,8562
9105,泰金寶-DR,20,0,20,新光-高雄,2023-02-10,8562
4113,聯上,20,0,20,新光-高雄,2023-02-10,8562
4979,華星光,124,105,19,新光-高雄,2023-02-10,8562
1609,大亞,21,2,19,新光-高雄,2023-02-10,8562
00892,富邦台灣半導體,21,2,19,新光-高雄,2023-02-10,8562
2888,新光金,32,14,18,新光-高雄,2023-02-10,8562
3494,誠研,18,0,18,新光-高雄,2023-02-10,8562
00632R,元大台灣50反1,539,23,516,新光-高雄,2023-02-13,8562
00900,富邦特選高股息30,313,10,303,新光-高雄,2023-02-13,8562
00882,中信中國高股息,129,5,124,新光-高雄,2023-02-13,8562
00715L,期街口布蘭特正2,277,156,121,新光-高雄,2023-02-13,8562
00878,國泰永續高股息,352,242,110,新光-高雄,2023-02-13,8562
00673R,期元大S＆P原油反1,106,20,86,新光-高雄,2023-02-13,8562
00706L,期元大S＆P日圓正2,76,0,76,新光-高雄,2023-02-13,8562
6245,立端,101,33,68,新光-高雄,2023-02-13,8562
00679B,元大美債20年,69,9,60,新光-高雄,2023-02-13,8562
2409,友達,97,40,57,新光-高雄,2023-02-13,8562
00772B,中信高評級公司債,41,0,41,新光-高雄,2023-02-13,8562
2888,新光金,39,0,39,新光-高雄,2023-02-13,8562
2855,統一證,36,0,36,新光-高雄,2023-02-13,8562
5315,光聯,59,25,34,新光-高雄,2023-02-13,8562
1701,中化,65,32,33,新光-高雄,2023-02-13,8562
2753,八方雲集,46,14,32,新光-高雄,2023-02-13,8562
3013,晟銘電,51,20,31,新光-高雄,2023-02-13,8562
3481,群創,124,93,31,新光-高雄,2023-02-13,8562
6282,康舒,52,22,30,新光-高雄,2023-02-13,8562
2312,金寶,26,1,25,新光-高雄,2023-02-13,8562
1584,精剛,57,32,25,新光-高雄,2023-02-13,8562
1219,福壽,24,0,24,新光-高雄,2023-02-13,8562
5203,訊連,26,2,24,新光-高雄,2023-02-13,8562
00919,群益台灣精選高息,22,0,22,新光-高雄,2023-02-13,8562
00670L,富邦NASDAQ正2,22,0,22,新光-高雄,2023-02-13,8562
2352,佳世達,22,0,22,新光-高雄,2023-02-13,8562
00773B,中信優先金融債,21,0,21,新光-高雄,2023-02-13,8562
2801,彰銀,21,0,21,新光-高雄,2023-02-13,8562
1718,中纖,20,0,20,新光-高雄,2023-02-13,8562
0056,元大高股息,65,45,20,新光-高雄,2023-02-13,8562
8105,凌巨,26,7,19,新光-高雄,2023-02-13,8562
4960,誠美材,33,14,19,新光-高雄,2023-02-13,8562
2390,云辰,19,0,19,新光-高雄,2023-02-13,8562
2363,矽統,19,0,19,新光-高雄,2023-02-13,8562
00891,中信關鍵半導體,21,3,18,新光-高雄,2023-02-13,8562
3714,富采,20,2,18,新光-高雄,2023-02-13,8562
2382,廣達,24,7,17,新光-高雄,2023-02-13,8562
4162,智擎,40,23,17,新光-高雄,2023-02-13,8562
2897,王道銀行,51,34,17,新光-高雄,2023-02-13,8562
2618,長榮航,80,64,16,新光-高雄,2023-02-13,8562
3296,勝德,21,5,16,新光-高雄,2023-02-13,8562
6843,進典,17,1,16,新光-高雄,2023-02-13,8562
2609,陽明,44,28,16,新光-高雄,2023-02-13,8562
3710,連展投控,16,1,15,新光-高雄,2023-02-13,8562
4167,松瑞藥,21,6,15,新光-高雄,2023-02-13,8562
6525,捷敏-KY,14,0,14,新光-高雄,2023-02-13,8562
5351,鈺創,15,1,14,新光-高雄,2023-02-13,8562
2303,聯電,114,101,13,新光-高雄,2023-02-13,8562
2358,廷鑫,23,10,13,新光-高雄,2023-02-13,8562
3029,零壹,52,39,13,新光-高雄,2023-02-13,8562
00632R,元大台灣50反1,628,135,493,新光-高雄,2023-02-14,8562
00673R,期元大S＆P原油反1,231,5,226,新光-高雄,2023-02-14,8562
00664R,國泰臺灣加權反1,100,0,100,新光-高雄,2023-02-14,8562
2634,漢翔,106,16,90,新光-高雄,2023-02-14,8562
00637L,元大滬深300正2,172,89,83,新光-高雄,2023-02-14,8562
00679B,元大美債20年,74,0,74,新光-高雄,2023-02-14,8562
6605,帝寶,66,4,62,新光-高雄,2023-02-14,8562
00720B,元大投資級公司債,66,6,60,新光-高雄,2023-02-14,8562
2332,友訊,55,2,53,新光-高雄,2023-02-14,8562
8105,凌巨,127,76,51,新光-高雄,2023-02-14,8562
2897,王道銀行,47,0,47,新光-高雄,2023-02-14,8562
6285,啟��,66,20,46,新光-高雄,2023-02-14,8562
2812,台中銀,69,24,45,新光-高雄,2023-02-14,8562
2453,凌群,188,144,44,新光-高雄,2023-02-14,8562
00669R,國泰美國道瓊反1,46,2,44,新光-高雄,2023-02-14,8562
00665L,富邦�琤肭磪囓�2,42,3,39,新光-高雄,2023-02-14,8562
3552,同致,39,3,36,新光-高雄,2023-02-14,8562
6603,富強鑫,40,5,35,新光-高雄,2023-02-14,8562
4164,承業醫,48,13,35,新光-高雄,2023-02-14,8562
00753L,中信中國50正2,32,0,32,新光-高雄,2023-02-14,8562
2851,中再保,32,1,31,新光-高雄,2023-02-14,8562
00648R,元大S＆P500反1,32,2,30,新光-高雄,2023-02-14,8562
3209,全科,26,0,26,新光-高雄,2023-02-14,8562
1605,華新,61,36,25,新光-高雄,2023-02-14,8562
00772B,中信高評級公司債,24,0,24,新光-高雄,2023-02-14,8562
2492,華新科,27,4,23,新光-高雄,2023-02-14,8562
2314,台揚,23,2,21,新光-高雄,2023-02-14,8562
3665,貿聯-KY,20,0,20,新光-高雄,2023-02-14,8562
3508,位速,20,0,20,新光-高雄,2023-02-14,8562
2801,彰銀,20,0,20,新光-高雄,2023-02-14,8562
1101,台泥,35,15,20,新光-高雄,2023-02-14,8562
2344,華邦電,34,15,19,新光-高雄,2023-02-14,8562
3494,誠研,23,4,19,新光-高雄,2023-02-14,8562
6443,元晶,27,8,19,新光-高雄,2023-02-14,8562
2027,大成鋼,28,10,18,新光-高雄,2023-02-14,8562
6282,康舒,37,19,18,新光-高雄,2023-02-14,8562
2471,資通,50,33,17,新光-高雄,2023-02-14,8562
3704,合勤控,52,35,17,新光-高雄,2023-02-14,8562
3024,憶聲,19,2,17,新光-高雄,2023-02-14,8562
2915,潤泰全,18,2,16,新光-高雄,2023-02-14,8562
00676R,富邦臺灣加權反1,15,0,15,新光-高雄,2023-02-14,8562
00885,富邦越南,13,0,13,新光-高雄,2023-02-14,8562
4744,皇將,14,1,13,新光-高雄,2023-02-14,8562
2431,聯昌,13,0,13,新光-高雄,2023-02-14,8562
2834,臺企銀,27,15,12,新光-高雄,2023-02-14,8562
6005,群益證,13,1,12,新光-高雄,2023-02-14,8562
5203,訊連,17,5,12,新光-高雄,2023-02-14,8562
3094,聯傑,25,13,12,新光-高雄,2023-02-14,8562
2450,神腦,43,31,12,新光-高雄,2023-02-14,8562
6541,泰福-KY,12,0,12,新光-高雄,2023-02-14,8562
00878,國泰永續高股息,997,137,860,新光-高雄,2023-02-15,8562
00673R,期元大S＆P原油反1,689,38,651,新光-高雄,2023-02-15,8562
00650L,復華香港正2,220,7,213,新光-高雄,2023-02-15,8562
00706L,期元大S＆P日圓正2,170,0,170,新光-高雄,2023-02-15,8562
1513,中興電,411,276,135,新光-高雄,2023-02-15,8562
2834,臺企銀,138,5,133,新光-高雄,2023-02-15,8562
2453,凌群,106,46,60,新光-高雄,2023-02-15,8562
00669R,國泰美國道瓊反1,60,0,60,新光-高雄,2023-02-15,8562
2330,台積電,92,41,51,新光-高雄,2023-02-15,8562
2884,玉山金,51,1,50,新光-高雄,2023-02-15,8562
00780B,國泰A級金融債,49,0,49,新光-高雄,2023-02-15,8562
4533,協易機,50,2,48,新光-高雄,2023-02-15,8562
01003T,兆豐新光R1,47,0,47,新光-高雄,2023-02-15,8562
2547,日勝生,60,14,46,新光-高雄,2023-02-15,8562
00637L,元大滬深300正2,85,40,45,新光-高雄,2023-02-15,8562
00885,富邦越南,50,6,44,新光-高雄,2023-02-15,8562
2486,一詮,61,19,42,新光-高雄,2023-02-15,8562
3617,碩天,46,5,41,新光-高雄,2023-02-15,8562
6282,康舒,48,8,40,新光-高雄,2023-02-15,8562
2027,大成鋼,41,6,35,新光-高雄,2023-02-15,8562
2399,映泰,35,0,35,新光-高雄,2023-02-15,8562
5701,劍湖山,34,0,34,新光-高雄,2023-02-15,8562
3207,耀勝,35,3,32,新光-高雄,2023-02-15,8562
2882,國泰金,34,3,31,新光-高雄,2023-02-15,8562
00631L,元大台灣50正2,46,15,31,新光-高雄,2023-02-15,8562
00891,中信關鍵半導體,44,14,30,新光-高雄,2023-02-15,8562
3714,富采,30,0,30,新光-高雄,2023-02-15,8562
00679B,元大美債20年,30,0,30,新光-高雄,2023-02-15,8562
5607,遠雄港,30,0,30,新光-高雄,2023-02-15,8562
6116,彩晶,33,5,28,新光-高雄,2023-02-15,8562
3221,台嘉碩,33,5,28,新光-高雄,2023-02-15,8562
5009,榮剛,67,41,26,新光-高雄,2023-02-15,8562
9904,寶成,25,1,24,新光-高雄,2023-02-15,8562
00919,群益台灣精選高息,25,1,24,新光-高雄,2023-02-15,8562
5425,台半,42,20,22,新光-高雄,2023-02-15,8562
3710,連展投控,22,1,21,新光-高雄,2023-02-15,8562
2014,中鴻,28,8,20,新光-高雄,2023-02-15,8562
3576,聯合再生,20,0,20,新光-高雄,2023-02-15,8562
2891,中信金,24,4,20,新光-高雄,2023-02-15,8562
2610,華航,68,50,18,新光-高雄,2023-02-15,8562
00882,中信中國高股息,17,0,17,新光-高雄,2023-02-15,8562
1102,亞泥,21,4,17,新光-高雄,2023-02-15,8562
00773B,中信優先金融債,17,0,17,新光-高雄,2023-02-15,8562
00907,永豐優息存股,17,0,17,新光-高雄,2023-02-15,8562
0050,元大台灣50,38,21,17,新光-高雄,2023-02-15,8562
006208,富邦台50,23,7,16,新光-高雄,2023-02-15,8562
4961,天鈺,19,3,16,新光-高雄,2023-02-15,8562
6874,倍力,15,0,15,新光-高雄,2023-02-15,8562
2329,華泰,15,0,15,新光-高雄,2023-02-15,8562
00905,FT臺灣Smart,15,0,15,新光-高雄,2023-02-15,8562
00632R,元大台灣50反1,624,122,502,新光-高雄,2023-02-16,8562
00878,國泰永續高股息,588,96,492,新光-高雄,2023-02-16,8562
00673R,期元大S＆P原油反1,397,10,387,新光-高雄,2023-02-16,8562
3481,群創,428,252,176,新光-高雄,2023-02-16,8562
00679B,元大美債20年,125,10,115,新光-高雄,2023-02-16,8562
00664R,國泰臺灣加權反1,101,0,101,新光-高雄,2023-02-16,8562
1101,台泥,114,26,88,新光-高雄,2023-02-16,8562
2303,聯電,87,17,70,新光-高雄,2023-02-16,8562
00885,富邦越南,80,12,68,新光-高雄,2023-02-16,8562
2450,神腦,85,24,61,新光-高雄,2023-02-16,8562
3058,立德,57,2,55,新光-高雄,2023-02-16,8562
00882,中信中國高股息,57,5,52,新光-高雄,2023-02-16,8562
5009,榮剛,74,27,47,新光-高雄,2023-02-16,8562
2027,大成鋼,44,4,40,新光-高雄,2023-02-16,8562
1712,興農,40,0,40,新光-高雄,2023-02-16,8562
00720B,元大投資級公司債,45,6,39,新光-高雄,2023-02-16,8562
00680L,元大美債20正2,38,0,38,新光-高雄,2023-02-16,8562
01003T,兆豐新光R1,37,0,37,新光-高雄,2023-02-16,8562
3234,光環,32,0,32,新光-高雄,2023-02-16,8562
00706L,期元大S＆P日圓正2,32,0,32,新光-高雄,2023-02-16,8562
6443,元晶,68,39,29,新光-高雄,2023-02-16,8562
2883,凱基金,32,5,27,新光-高雄,2023-02-16,8562
2888,新光金,35,8,27,新光-高雄,2023-02-16,8562
00648R,元大S＆P500反1,25,0,25,新光-高雄,2023-02-16,8562
5388,中磊,28,3,25,新光-高雄,2023-02-16,8562
00772B,中信高評級公司債,24,0,24,新光-高雄,2023-02-16,8562
1609,大亞,128,105,23,新光-高雄,2023-02-16,8562
1584,精剛,44,21,23,新光-高雄,2023-02-16,8562
2486,一詮,40,17,23,新光-高雄,2023-02-16,8562
2312,金寶,22,0,22,新光-高雄,2023-02-16,8562
6005,群益證,21,0,21,新光-高雄,2023-02-16,8562
6153,嘉聯益,21,0,21,新光-高雄,2023-02-16,8562
3714,富采,21,0,21,新光-高雄,2023-02-16,8562
2812,台中銀,49,29,20,新光-高雄,2023-02-16,8562
4113,聯上,20,0,20,新光-高雄,2023-02-16,8562
2637,慧洋-KY,20,0,20,新光-高雄,2023-02-16,8562
2201,裕隆,127,107,20,新光-高雄,2023-02-16,8562
2884,玉山金,21,3,18,新光-高雄,2023-02-16,8562
2603,長榮,34,16,18,新光-高雄,2023-02-16,8562
3576,聯合再生,18,0,18,新光-高雄,2023-02-16,8562
2905,三商,18,0,18,新光-高雄,2023-02-16,8562
1417,嘉裕,19,1,18,新光-高雄,2023-02-16,8562
1513,中興電,97,80,17,新光-高雄,2023-02-16,8562
00900,富邦特選高股息30,17,0,17,新光-高雄,2023-02-16,8562
9958,世紀鋼,16,0,16,新光-高雄,2023-02-16,8562
4744,皇將,48,32,16,新光-高雄,2023-02-16,8562
4916,事欣科,15,1,14,新光-高雄,2023-02-16,8562
2633,台灣高鐵,15,1,14,新光-高雄,2023-02-16,8562
6112,邁達特,14,0,14,新光-高雄,2023-02-16,8562
3044,健鼎,15,1,14,新光-高雄,2023-02-16,8562
00878,國泰永續高股息,222,8,214,新光-高雄,2023-02-17,8562
00655L,國泰中國A50正2,217,13,204,新光-高雄,2023-02-17,8562
6116,彩晶,191,66,125,新光-高雄,2023-02-17,8562
2317,鴻海,120,24,96,新光-高雄,2023-02-17,8562
00715L,期街口布蘭特正2,95,0,95,新光-高雄,2023-02-17,8562
0056,元大高股息,104,11,93,新光-高雄,2023-02-17,8562
00772B,中信高評級公司債,93,0,93,新光-高雄,2023-02-17,8562
8110,華東,80,0,80,新光-高雄,2023-02-17,8562
2208,台船,189,115,74,新光-高雄,2023-02-17,8562
00679B,元大美債20年,83,11,72,新光-高雄,2023-02-17,8562
1514,亞力,71,2,69,新光-高雄,2023-02-17,8562
8936,國統,60,3,57,新光-高雄,2023-02-17,8562
00902,中信電池及儲能,45,0,45,新光-高雄,2023-02-17,8562
2610,華航,196,151,45,新光-高雄,2023-02-17,8562
00650L,復華香港正2,45,0,45,新光-高雄,2023-02-17,8562
5009,榮剛,74,29,45,新光-高雄,2023-02-17,8562
2883,凱基金,46,2,44,新光-高雄,2023-02-17,8562
1529,樂事綠能,64,21,43,新光-高雄,2023-02-17,8562
3558,神準,62,22,40,新光-高雄,2023-02-17,8562
3714,富采,40,0,40,新光-高雄,2023-02-17,8562
3481,群創,502,470,32,新光-高雄,2023-02-17,8562
00706L,期元大S＆P日圓正2,31,0,31,新光-高雄,2023-02-17,8562
9105,泰金寶-DR,31,0,31,新光-高雄,2023-02-17,8562
00773B,中信優先金融債,31,0,31,新光-高雄,2023-02-17,8562
00665L,富邦�琤肭磪囓�2,29,0,29,新光-高雄,2023-02-17,8562
5701,劍湖山,31,2,29,新光-高雄,2023-02-17,8562
2618,長榮航,113,85,28,新光-高雄,2023-02-17,8562
2471,資通,50,23,27,新光-高雄,2023-02-17,8562
2025,千興,26,0,26,新光-高雄,2023-02-17,8562
2027,大成鋼,35,10,25,新光-高雄,2023-02-17,8562
2312,金寶,26,1,25,新光-高雄,2023-02-17,8562
00680L,元大美債20正2,25,0,25,新光-高雄,2023-02-17,8562
2409,友達,129,105,24,新光-高雄,2023-02-17,8562
3022,威強電,115,91,24,新光-高雄,2023-02-17,8562
00673R,期元大S＆P原油反1,32,8,24,新光-高雄,2023-02-17,8562
00900,富邦特選高股息30,22,0,22,新光-高雄,2023-02-17,8562
006208,富邦台50,22,0,22,新光-高雄,2023-02-17,8562
4979,華星光,42,20,22,新光-高雄,2023-02-17,8562
00720B,元大投資級公司債,42,20,22,新光-高雄,2023-02-17,8562
2367,燿華,36,15,21,新光-高雄,2023-02-17,8562
8933,愛地雅,20,0,20,新光-高雄,2023-02-17,8562
2504,國產,20,0,20,新光-高雄,2023-02-17,8562
5703,亞都,20,0,20,新光-高雄,2023-02-17,8562
2201,裕隆,69,49,20,新光-高雄,2023-02-17,8562
6148,驊宏資,30,11,19,新光-高雄,2023-02-17,8562
4503,金雨,19,0,19,新光-高雄,2023-02-17,8562
00893,國泰智能電動車,91,73,18,新光-高雄,2023-02-17,8562
5706,鳳凰,29,11,18,新光-高雄,2023-02-17,8562
5015,華祺,17,0,17,新光-高雄,2023-02-17,8562
2009,第一銅,28,11,17,新光-高雄,2023-02-17,8562
2884,玉山金,270,71,199,新光-高雄,2023-02-20,8562
8110,華東,100,0,100,新光-高雄,2023-02-20,8562
2317,鴻海,110,14,96,新光-高雄,2023-02-20,8562
1314,中石化,108,16,92,新光-高雄,2023-02-20,8562
00715L,期街口布蘭特正2,93,2,91,新光-高雄,2023-02-20,8562
00679B,元大美債20年,91,4,87,新光-高雄,2023-02-20,8562
5258,虹堡,200,120,80,新光-高雄,2023-02-20,8562
6245,立端,113,46,67,新光-高雄,2023-02-20,8562
4128,中天,100,44,56,新光-高雄,2023-02-20,8562
00712,復華富時不動產,56,0,56,新光-高雄,2023-02-20,8562
2022,聚亨,52,1,51,新光-高雄,2023-02-20,8562
2867,三商壽,53,3,50,新光-高雄,2023-02-20,8562
4919,新唐,57,7,50,新光-高雄,2023-02-20,8562
00902,中信電池及儲能,55,7,48,新光-高雄,2023-02-20,8562
2312,金寶,71,25,46,新光-高雄,2023-02-20,8562
8383,千附,65,19,46,新光-高雄,2023-02-20,8562
2705,六福,62,17,45,新光-高雄,2023-02-20,8562
00680L,元大美債20正2,41,0,41,新光-高雄,2023-02-20,8562
2834,臺企銀,207,168,39,新光-高雄,2023-02-20,8562
00720B,元大投資級公司債,45,8,37,新光-高雄,2023-02-20,8562
9914,美利達,37,0,37,新光-高雄,2023-02-20,8562
00751B,元大AAA至A公司債,35,1,34,新光-高雄,2023-02-20,8562
00637L,元大滬深300正2,134,103,31,新光-高雄,2023-02-20,8562
6148,驊宏資,32,1,31,新光-高雄,2023-02-20,8562
2610,華航,191,161,30,新光-高雄,2023-02-20,8562
6843,進典,31,1,30,新光-高雄,2023-02-20,8562
1522,堤維西,30,1,29,新光-高雄,2023-02-20,8562
3049,精金,89,60,29,新光-高雄,2023-02-20,8562
5009,榮剛,43,14,29,新光-高雄,2023-02-20,8562
00772B,中信高評級公司債,29,0,29,新光-高雄,2023-02-20,8562
1101,台泥,60,32,28,新光-高雄,2023-02-20,8562
00885,富邦越南,47,20,27,新光-高雄,2023-02-20,8562
1718,中纖,40,14,26,新光-高雄,2023-02-20,8562
1760,寶齡富錦,34,9,25,新光-高雄,2023-02-20,8562
1503,士電,98,73,25,新光-高雄,2023-02-20,8562
2329,華泰,25,0,25,新光-高雄,2023-02-20,8562
1701,中化,27,7,20,新光-高雄,2023-02-20,8562
2883,凱基金,41,21,20,新光-高雄,2023-02-20,8562
2911,麗嬰房,20,0,20,新光-高雄,2023-02-20,8562
6116,彩晶,116,97,19,新光-高雄,2023-02-20,8562
8050,廣積,53,35,18,新光-高雄,2023-02-20,8562
4142,國光生,21,3,18,新光-高雄,2023-02-20,8562
2929,淘帝-KY,20,3,17,新光-高雄,2023-02-20,8562
3037,欣興,23,6,17,新光-高雄,2023-02-20,8562
1447,力鵬,29,12,17,新光-高雄,2023-02-20,8562
1612,宏泰,16,0,16,新光-高雄,2023-02-20,8562
2618,長榮航,163,147,16,新光-高雄,2023-02-20,8562
3576,聯合再生,15,0,15,新光-高雄,2023-02-20,8562
2462,良得電,19,4,15,新光-高雄,2023-02-20,8562
4526,東台,21,6,15,新光-高雄,2023-02-20,8562
00878,國泰永續高股息,566,45,521,新光-高雄,2023-02-21,8562
00650L,復華香港正2,452,0,452,新光-高雄,2023-02-21,8562
00715L,期街口布蘭特正2,415,30,385,新光-高雄,2023-02-21,8562
2812,台中銀,240,52,188,新光-高雄,2023-02-21,8562
2880,華南金,136,3,133,新光-高雄,2023-02-21,8562
2610,華航,231,105,126,新光-高雄,2023-02-21,8562
2884,玉山金,340,221,119,新光-高雄,2023-02-21,8562
2834,臺企銀,121,15,106,新光-高雄,2023-02-21,8562
2457,飛宏,245,159,86,新光-高雄,2023-02-21,8562
2867,三商壽,88,4,84,新光-高雄,2023-02-21,8562
00753L,中信中國50正2,102,24,78,新光-高雄,2023-02-21,8562
2897,王道銀行,72,0,72,新光-高雄,2023-02-21,8562
2633,台灣高鐵,81,13,68,新光-高雄,2023-02-21,8562
1810,和成,200,144,56,新光-高雄,2023-02-21,8562
2634,漢翔,73,18,55,新光-高雄,2023-02-21,8562
2401,凌陽,56,2,54,新光-高雄,2023-02-21,8562
00712,復華富時不動產,49,0,49,新光-高雄,2023-02-21,8562
00751B,元大AAA至A公司債,49,0,49,新光-高雄,2023-02-21,8562
2618,長榮航,89,43,46,新光-高雄,2023-02-21,8562
6118,建達,62,20,42,新光-高雄,2023-02-21,8562
00772B,中信高評級公司債,31,0,31,新光-高雄,2023-02-21,8562
00720B,元大投資級公司債,34,3,31,新光-高雄,2023-02-21,8562
4113,聯上,30,0,30,新光-高雄,2023-02-21,8562
8046,南電,39,11,28,新光-高雄,2023-02-21,8562
00725B,國泰投資級公司債,28,3,25,新光-高雄,2023-02-21,8562
3051,力特,27,2,25,新光-高雄,2023-02-21,8562
00706L,期元大S＆P日圓正2,24,0,24,新光-高雄,2023-02-21,8562
6282,康舒,99,76,23,新光-高雄,2023-02-21,8562
00665L,富邦�琤肭磪囓�2,40,17,23,新光-高雄,2023-02-21,8562
00905,FT臺灣Smart,22,0,22,新光-高雄,2023-02-21,8562
2911,麗嬰房,22,0,22,新光-高雄,2023-02-21,8562
5309,系統電,26,4,22,新光-高雄,2023-02-21,8562
6517,保勝光學,24,3,21,新光-高雄,2023-02-21,8562
1417,嘉裕,22,1,21,新光-高雄,2023-02-21,8562
6461,益得,21,0,21,新光-高雄,2023-02-21,8562
2367,燿華,23,2,21,新光-高雄,2023-02-21,8562
00669R,國泰美國道瓊反1,20,0,20,新光-高雄,2023-02-21,8562
8105,凌巨,48,28,20,新光-高雄,2023-02-21,8562
8936,國統,88,68,20,新光-高雄,2023-02-21,8562
6271,同欣電,19,0,19,新光-高雄,2023-02-21,8562
00893,國泰智能電動車,26,7,19,新光-高雄,2023-02-21,8562
2014,中鴻,25,6,19,新光-高雄,2023-02-21,8562
2017,官田鋼,18,0,18,新光-高雄,2023-02-21,8562
1512,瑞利,18,0,18,新光-高雄,2023-02-21,8562
6443,元晶,102,85,17,新光-高雄,2023-02-21,8562
8234,新漢,23,6,17,新光-高雄,2023-02-21,8562
6283,淳安,18,1,17,新光-高雄,2023-02-21,8562
8433,弘帆,20,3,17,新光-高雄,2023-02-21,8562
2329,華泰,28,11,17,新光-高雄,2023-02-21,8562
3260,威剛,17,0,17,新光-高雄,2023-02-21,8562
00878,國泰永續高股息,690,191,499,新光-高雄,2023-02-22,8562
2834,臺企銀,551,207,344,新光-高雄,2023-02-22,8562
2812,台中銀,250,49,201,新光-高雄,2023-02-22,8562
00712,復華富時不動產,162,5,157,新光-高雄,2023-02-22,8562
3049,精金,134,2,132,新光-高雄,2023-02-22,8562
00772B,中信高評級公司債,80,0,80,新光-高雄,2023-02-22,8562
2367,燿華,81,1,80,新光-高雄,2023-02-22,8562
00671R,富邦NASDAQ反1,82,4,78,新光-高雄,2023-02-22,8562
00680L,元大美債20正2,78,1,77,新光-高雄,2023-02-22,8562
2344,華邦電,83,18,65,新光-高雄,2023-02-22,8562
2634,漢翔,76,15,61,新光-高雄,2023-02-22,8562
3037,欣興,54,9,45,新光-高雄,2023-02-22,8562
00720B,元大投資級公司債,52,8,44,新光-高雄,2023-02-22,8562
2498,宏達電,81,39,42,新光-高雄,2023-02-22,8562
2618,長榮航,153,114,39,新光-高雄,2023-02-22,8562
1519,華城,220,182,38,新光-高雄,2023-02-22,8562
00751B,元大AAA至A公司債,40,4,36,新光-高雄,2023-02-22,8562
1101,台泥,53,17,36,新光-高雄,2023-02-22,8562
2897,王道銀行,60,25,35,新光-高雄,2023-02-22,8562
3682,亞太電,35,0,35,新光-高雄,2023-02-22,8562
6116,彩晶,131,97,34,新光-高雄,2023-02-22,8562
1810,和成,38,5,33,新光-高雄,2023-02-22,8562
00631L,元大台灣50正2,44,11,33,新光-高雄,2023-02-22,8562
6603,富強鑫,32,0,32,新光-高雄,2023-02-22,8562
1532,勤美,31,0,31,新光-高雄,2023-02-22,8562
2471,資通,53,24,29,新光-高雄,2023-02-22,8562
00679B,元大美債20年,88,59,29,新光-高雄,2023-02-22,8562
2388,威盛,51,24,27,新光-高雄,2023-02-22,8562
2883,凱基金,42,15,27,新光-高雄,2023-02-22,8562
4168,醣聯,51,24,27,新光-高雄,2023-02-22,8562
2201,裕隆,54,29,25,新光-高雄,2023-02-22,8562
6770,力積電,31,6,25,新光-高雄,2023-02-22,8562
2712,遠雄來,24,2,22,新光-高雄,2023-02-22,8562
2641,正德,23,1,22,新光-高雄,2023-02-22,8562
2208,台船,50,29,21,新光-高雄,2023-02-22,8562
4919,新唐,25,5,20,新光-高雄,2023-02-22,8562
2317,鴻海,24,4,20,新光-高雄,2023-02-22,8562
3029,零壹,50,30,20,新光-高雄,2023-02-22,8562
5701,劍湖山,23,3,20,新光-高雄,2023-02-22,8562
3058,立德,20,0,20,新光-高雄,2023-02-22,8562
2002,中鋼,20,1,19,新光-高雄,2023-02-22,8562
4163,鐿鈦,19,0,19,新光-高雄,2023-02-22,8562
6234,高僑,20,1,19,新光-高雄,2023-02-22,8562
00773B,中信優先金融債,20,1,19,新光-高雄,2023-02-22,8562
0050,元大台灣50,26,8,18,新光-高雄,2023-02-22,8562
2303,聯電,48,29,19,新光-高雄,2023-02-22,8562
00885,富邦越南,19,0,19,新光-高雄,2023-02-22,8562
4960,誠美材,40,22,18,新光-高雄,2023-02-22,8562
3035,智原,91,74,17,新光-高雄,2023-02-22,8562
00752,中信中國50,16,0,16,新光-高雄,2023-02-22,8562
00632R,元大台灣50反1,1644,324,1320,新光-高雄,2023-02-23,8562
00715L,期街口布蘭特正2,1213,0,1213,新光-高雄,2023-02-23,8562
3481,群創,379,79,300,新光-高雄,2023-02-23,8562
00642U,期元大S＆P石油,206,0,206,新光-高雄,2023-02-23,8562
2888,新光金,117,5,112,新光-高雄,2023-02-23,8562
2399,映泰,98,5,93,新光-高雄,2023-02-23,8562
2845,遠東銀,80,0,80,新光-高雄,2023-02-23,8562
00882,中信中國高股息,69,0,69,新光-高雄,2023-02-23,8562
2409,友達,71,4,67,新光-高雄,2023-02-23,8562
00753L,中信中國50正2,91,30,61,新光-高雄,2023-02-23,8562
00683L,期元大美元指正2,50,0,50,新光-高雄,2023-02-23,8562
4155,訊映,49,1,48,新光-高雄,2023-02-23,8562
4961,天鈺,73,27,46,新光-高雄,2023-02-23,8562
2634,漢翔,58,13,45,新光-高雄,2023-02-23,8562
5210,寶碩,51,7,44,新光-高雄,2023-02-23,8562
2618,長榮航,119,75,44,新光-高雄,2023-02-23,8562
00720B,元大投資級公司債,74,33,41,新光-高雄,2023-02-23,8562
2834,臺企銀,168,128,40,新光-高雄,2023-02-23,8562
00712,復華富時不動產,39,0,39,新光-高雄,2023-02-23,8562
2812,台中銀,102,64,38,新光-高雄,2023-02-23,8562
3088,艾訊,65,30,35,新光-高雄,2023-02-23,8562
4968,立積,50,18,32,新光-高雄,2023-02-23,8562
2883,凱基金,50,18,32,新光-高雄,2023-02-23,8562
2610,華航,71,40,31,新光-高雄,2023-02-23,8562
3027,盛達,120,92,28,新光-高雄,2023-02-23,8562
2851,中再保,27,0,27,新光-高雄,2023-02-23,8562
00713,元大台灣高息低波,32,7,25,新光-高雄,2023-02-23,8562
1609,大亞,34,10,24,新光-高雄,2023-02-23,8562
3296,勝德,26,2,24,新光-高雄,2023-02-23,8562
2457,飛宏,46,23,23,新光-高雄,2023-02-23,8562
2637,慧洋-KY,68,45,23,新光-高雄,2023-02-23,8562
00773B,中信優先金融債,22,0,22,新光-高雄,2023-02-23,8562
3202,樺晟,22,0,22,新光-高雄,2023-02-23,8562
6733,博晟生醫,23,1,22,新光-高雄,2023-02-23,8562
2641,正德,43,22,21,新光-高雄,2023-02-23,8562
5905,南仁湖,65,44,21,新光-高雄,2023-02-23,8562
00772B,中信高評級公司債,20,0,20,新光-高雄,2023-02-23,8562
1904,正隆,20,0,20,新光-高雄,2023-02-23,8562
8936,國統,65,45,20,新光-高雄,2023-02-23,8562
01003T,兆豐新光R1,20,0,20,新光-高雄,2023-02-23,8562
00671R,富邦NASDAQ反1,32,12,20,新光-高雄,2023-02-23,8562
3252,海灣,30,10,20,新光-高雄,2023-02-23,8562
1795,美時,76,57,19,新光-高雄,2023-02-23,8562
2701,萬企,41,22,19,新光-高雄,2023-02-23,8562
2911,麗嬰房,19,0,19,新光-高雄,2023-02-23,8562
3682,亞太電,19,0,19,新光-高雄,2023-02-23,8562
8033,雷虎,34,16,18,新光-高雄,2023-02-23,8562
00648R,元大S＆P500反1,18,0,18,新光-高雄,2023-02-23,8562
3058,立德,20,2,18,新光-高雄,2023-02-23,8562
5608,四維航,63,46,17,新光-高雄,2023-02-23,8562
4967,十銓,292,42,250,新光-高雄,2023-02-24,8562
00882,中信中國高股息,228,0,228,新光-高雄,2023-02-24,8562
00637L,元大滬深300正2,246,80,166,新光-高雄,2023-02-24,8562
00715L,期街口布蘭特正2,489,367,122,新光-高雄,2023-02-24,8562
2317,鴻海,110,11,99,新光-高雄,2023-02-24,8562
1810,和成,107,8,99,新光-高雄,2023-02-24,8562
8936,國統,111,24,87,新光-高雄,2023-02-24,8562
00712,復華富時不動產,77,3,74,新光-高雄,2023-02-24,8562
00878,國泰永續高股息,153,82,71,新光-高雄,2023-02-24,8562
2834,臺企銀,118,51,67,新光-高雄,2023-02-24,8562
6770,力積電,65,5,60,新光-高雄,2023-02-24,8562
2886,兆豐金,61,3,58,新光-高雄,2023-02-24,8562
2611,志信,71,25,46,新光-高雄,2023-02-24,8562
2014,中鴻,55,14,41,新光-高雄,2023-02-24,8562
2892,第一金,42,1,41,新光-高雄,2023-02-24,8562
2538,基泰,40,0,40,新光-高雄,2023-02-24,8562
1701,中化,79,40,39,新光-高雄,2023-02-24,8562
1514,亞力,59,20,39,新光-高雄,2023-02-24,8562
5512,力麒,125,86,39,新光-高雄,2023-02-24,8562
2408,南亞科,40,3,37,新光-高雄,2023-02-24,8562
2610,華航,70,34,36,新光-高雄,2023-02-24,8562
2884,玉山金,39,4,35,新光-高雄,2023-02-24,8562
5880,合庫金,35,0,35,新光-高雄,2023-02-24,8562
00680L,元大美債20正2,34,0,34,新光-高雄,2023-02-24,8562
2836,高雄銀,33,0,33,新光-高雄,2023-02-24,8562
1718,中纖,38,6,32,新光-高雄,2023-02-24,8562
00772B,中信高評級公司債,31,0,31,新光-高雄,2023-02-24,8562
2880,華南金,33,2,31,新光-高雄,2023-02-24,8562
2883B,凱基金乙特,30,0,30,新光-高雄,2023-02-24,8562
6843,進典,29,0,29,新光-高雄,2023-02-24,8562
00665L,富邦�琤肭磪囓�2,28,0,28,新光-高雄,2023-02-24,8562
8940,新天地,33,5,28,新光-高雄,2023-02-24,8562
2851,中再保,30,3,27,新光-高雄,2023-02-24,8562
6282,康舒,53,30,23,新光-高雄,2023-02-24,8562
3260,威剛,24,1,23,新光-高雄,2023-02-24,8562
2312,金寶,23,0,23,新光-高雄,2023-02-24,8562
4906,正文,23,0,23,新光-高雄,2023-02-24,8562
2618,長榮航,42,20,22,新光-高雄,2023-02-24,8562
1506,正道,21,0,21,新光-高雄,2023-02-24,8562
9935,慶豐富,25,4,21,新光-高雄,2023-02-24,8562
3481,群創,107,86,21,新光-高雄,2023-02-24,8562
6285,啟��,24,3,21,新光-高雄,2023-02-24,8562
5009,榮剛,83,62,21,新光-高雄,2023-02-24,8562
1795,美時,45,25,20,新光-高雄,2023-02-24,8562
2712,遠雄來,30,10,20,新光-高雄,2023-02-24,8562
6233,旺玖,20,0,20,新光-高雄,2023-02-24,8562
3714,富采,23,4,19,新光-高雄,2023-02-24,8562
2812,台中銀,80,61,19,新光-高雄,2023-02-24,8562
5258,虹堡,109,90,19,新光-高雄,2023-02-24,8562
1522,堤維西,24,5,19,新光-高雄,2023-02-24,8562
00878,國泰永續高股息,287,30,257,新光-高雄,2023-03-01,8562
00673R,期元大S＆P原油反1,151,10,141,新光-高雄,2023-03-01,8562
1605,華新,151,31,120,新光-高雄,2023-03-01,8562
00706L,期元大S＆P日圓正2,97,0,97,新光-高雄,2023-03-01,8562
00712,復華富時不動產,94,0,94,新光-高雄,2023-03-01,8562
2002,中鋼,84,5,79,新光-高雄,2023-03-01,8562
00683L,期元大美元指正2,80,5,75,新光-高雄,2023-03-01,8562
2618,長榮航,81,11,70,新光-高雄,2023-03-01,8562
5608,四維航,152,83,69,新光-高雄,2023-03-01,8562
3005,神基,70,4,66,新光-高雄,2023-03-01,8562
00632R,元大台灣50反1,552,499,53,新光-高雄,2023-03-01,8562
2885,元大金,56,5,51,新光-高雄,2023-03-01,8562
3481,群創,79,36,43,新光-高雄,2023-03-01,8562
2412,中華電,42,1,41,新光-高雄,2023-03-01,8562
3033,威健,41,2,39,新光-高雄,2023-03-01,8562
5880,合庫金,39,0,39,新光-高雄,2023-03-01,8562
2892,第一金,40,3,37,新光-高雄,2023-03-01,8562
2852,第一保,36,0,36,新光-高雄,2023-03-01,8562
2883,凱基金,44,8,36,新光-高雄,2023-03-01,8562
2605,新興,201,165,36,新光-高雄,2023-03-01,8562
2014,中鴻,62,27,35,新光-高雄,2023-03-01,8562
2609,陽明,39,5,34,新光-高雄,2023-03-01,8562
1210,大成,82,49,33,新光-高雄,2023-03-01,8562
1101,台泥,76,43,33,新光-高雄,2023-03-01,8562
9945,潤泰新,40,9,31,新光-高雄,2023-03-01,8562
6266,泰詠,72,42,30,新光-高雄,2023-03-01,8562
00902,中信電池及儲能,30,0,30,新光-高雄,2023-03-01,8562
2884,玉山金,57,28,29,新光-高雄,2023-03-01,8562
2881,富邦金,27,0,27,新光-高雄,2023-03-01,8562
2851,中再保,28,1,27,新光-高雄,2023-03-01,8562
00679B,元大美債20年,41,15,26,新光-高雄,2023-03-01,8562
6443,元晶,27,2,25,新光-高雄,2023-03-01,8562
2419,仲琦,60,35,25,新光-高雄,2023-03-01,8562
2880,華南金,28,3,25,新光-高雄,2023-03-01,8562
6288,聯嘉,26,2,24,新光-高雄,2023-03-01,8562
00670L,富邦NASDAQ正2,38,15,23,新光-高雄,2023-03-01,8562
2637,慧洋-KY,37,14,23,新光-高雄,2023-03-01,8562
2414,精技,23,0,23,新光-高雄,2023-03-01,8562
00915,凱基優選高股息30,21,0,21,新光-高雄,2023-03-01,8562
00671R,富邦NASDAQ反1,46,25,21,新光-高雄,2023-03-01,8562
00772B,中信高評級公司債,20,0,20,新光-高雄,2023-03-01,8562
00720B,元大投資級公司債,44,24,20,新光-高雄,2023-03-01,8562
1219,福壽,79,59,20,新光-高雄,2023-03-01,8562
8928,鉅明,24,4,20,新光-高雄,2023-03-01,8562
2453,凌群,29,9,20,新光-高雄,2023-03-01,8562
1240,茂生農經,21,1,20,新光-高雄,2023-03-01,8562
2359,所羅門,24,4,20,新光-高雄,2023-03-01,8562
6116,彩晶,43,24,19,新光-高雄,2023-03-01,8562
6719,力智,27,8,19,新光-高雄,2023-03-01,8562
4915,致伸,31,12,19,新光-高雄,2023-03-01,8562
00715L,期街口布蘭特正2,600,126,474,新光-高雄,2023-03-02,8562
2515,中工,361,0,361,新光-高雄,2023-03-02,8562
00878,國泰永續高股息,317,103,214,新光-高雄,2023-03-02,8562
2812,台中銀,235,62,173,新光-高雄,2023-03-02,8562
00712,復華富時不動產,156,2,154,新光-高雄,2023-03-02,8562
00673R,期元大S＆P原油反1,155,6,149,新光-高雄,2023-03-02,8562
00670L,富邦NASDAQ正2,153,11,142,新光-高雄,2023-03-02,8562
3564,其陽,111,1,110,新光-高雄,2023-03-02,8562
6235,華孚,191,89,102,新光-高雄,2023-03-02,8562
00632R,元大台灣50反1,125,52,73,新光-高雄,2023-03-02,8562
2880,華南金,61,0,61,新光-高雄,2023-03-02,8562
2201,裕隆,111,51,60,新光-高雄,2023-03-02,8562
3508,位速,60,0,60,新光-高雄,2023-03-02,8562
2892,第一金,49,2,47,新光-高雄,2023-03-02,8562
1708,東鹼,57,12,45,新光-高雄,2023-03-02,8562
00669R,國泰美國道瓊反1,60,16,44,新光-高雄,2023-03-02,8562
2498,宏達電,96,54,42,新光-高雄,2023-03-02,8562
2409,友達,60,20,40,新光-高雄,2023-03-02,8562
2888,新光金,38,0,38,新光-高雄,2023-03-02,8562
2911,麗嬰房,38,0,38,新光-高雄,2023-03-02,8562
5258,虹堡,153,115,38,新光-高雄,2023-03-02,8562
2886,兆豐金,37,0,37,新光-高雄,2023-03-02,8562
2834,臺企銀,130,94,36,新光-高雄,2023-03-02,8562
1810,和成,43,8,35,新光-高雄,2023-03-02,8562
5512,力麒,68,33,35,新光-高雄,2023-03-02,8562
6188,廣明,33,0,33,新光-高雄,2023-03-02,8562
2634,漢翔,33,1,32,新光-高雄,2023-03-02,8562
00893,國泰智能電動車,38,8,30,新光-高雄,2023-03-02,8562
4915,致伸,54,25,29,新光-高雄,2023-03-02,8562
2891,中信金,29,1,28,新光-高雄,2023-03-02,8562
1108,幸福,28,0,28,新光-高雄,2023-03-02,8562
2388,威盛,43,15,28,新光-高雄,2023-03-02,8562
3264,欣銓,26,0,26,新光-高雄,2023-03-02,8562
8088,品安,35,9,26,新光-高雄,2023-03-02,8562
00713,元大台灣高息低波,45,19,26,新光-高雄,2023-03-02,8562
3027,盛達,61,36,25,新光-高雄,2023-03-02,8562
2618,長榮航,96,72,24,新光-高雄,2023-03-02,8562
8033,雷虎,40,17,23,新光-高雄,2023-03-02,8562
2883,凱基金,23,1,22,新光-高雄,2023-03-02,8562
00751B,元大AAA至A公司債,22,0,22,新光-高雄,2023-03-02,8562
2885,元大金,35,13,22,新光-高雄,2023-03-02,8562
2303,聯電,28,6,22,新光-高雄,2023-03-02,8562
3714,富采,25,3,22,新光-高雄,2023-03-02,8562
3706,神達,22,1,21,新光-高雄,2023-03-02,8562
00902,中信電池及儲能,20,0,20,新光-高雄,2023-03-02,8562
2605,新興,121,101,20,新光-高雄,2023-03-02,8562
4807,日成-KY,20,0,20,新光-高雄,2023-03-02,8562
2441,超豐,20,0,20,新光-高雄,2023-03-02,8562
3163,波若威,24,5,19,新光-高雄,2023-03-02,8562
2376,技嘉,22,5,17,新光-高雄,2023-03-02,8562
00632R,元大台灣50反1,475,41,434,新光-高雄,2023-03-03,8562
6235,華孚,268,101,167,新光-高雄,2023-03-03,8562
8110,華東,103,0,103,新光-高雄,2023-03-03,8562
00673R,期元大S＆P原油反1,91,0,91,新光-高雄,2023-03-03,8562
00712,復華富時不動產,77,1,76,新光-高雄,2023-03-03,8562
2610,華航,105,36,69,新光-高雄,2023-03-03,8562
00637L,元大滬深300正2,122,57,65,新光-高雄,2023-03-03,8562
1701,中化,81,17,64,新光-高雄,2023-03-03,8562
00679B,元大美債20年,65,3,62,新光-高雄,2023-03-03,8562
3013,晟銘電,117,57,60,新光-高雄,2023-03-03,8562
2867,三商壽,62,5,57,新光-高雄,2023-03-03,8562
4168,醣聯,55,0,55,新光-高雄,2023-03-03,8562
2208,台船,52,3,49,新光-高雄,2023-03-03,8562
2888,新光金,54,7,47,新光-高雄,2023-03-03,8562
4916,事欣科,62,17,45,新光-高雄,2023-03-03,8562
3312,弘憶股,42,0,42,新光-高雄,2023-03-03,8562
2890,永豐金,42,0,42,新光-高雄,2023-03-03,8562
2363,矽統,43,5,38,新光-高雄,2023-03-03,8562
2897,王道銀行,46,10,36,新光-高雄,2023-03-03,8562
2911,麗嬰房,35,0,35,新光-高雄,2023-03-03,8562
2834,臺企銀,374,341,33,新光-高雄,2023-03-03,8562
5443,均豪,33,0,33,新光-高雄,2023-03-03,8562
4977,眾達-KY,44,13,31,新光-高雄,2023-03-03,8562
00671R,富邦NASDAQ反1,35,5,30,新光-高雄,2023-03-03,8562
4743,合一,34,6,28,新光-高雄,2023-03-03,8562
2892,第一金,27,0,27,新光-高雄,2023-03-03,8562
2641,正德,43,17,26,新光-高雄,2023-03-03,8562
2388,威盛,80,55,25,新光-高雄,2023-03-03,8562
00751B,元大AAA至A公司債,25,0,25,新光-高雄,2023-03-03,8562
3006,晶豪科,52,28,24,新光-高雄,2023-03-03,8562
1605,華新,103,80,23,新光-高雄,2023-03-03,8562
2601,益航,41,19,22,新光-高雄,2023-03-03,8562
4128,中天,22,0,22,新光-高雄,2023-03-03,8562
8105,凌巨,43,21,22,新光-高雄,2023-03-03,8562
5353,台林,22,0,22,新光-高雄,2023-03-03,8562
2884,玉山金,31,10,21,新光-高雄,2023-03-03,8562
6727,亞泰金屬,20,0,20,新光-高雄,2023-03-03,8562
00676R,富邦臺灣加權反1,20,0,20,新光-高雄,2023-03-03,8562
8033,雷虎,39,19,20,新光-高雄,2023-03-03,8562
6603,富強鑫,20,1,19,新光-高雄,2023-03-03,8562
2201,裕隆,45,26,19,新光-高雄,2023-03-03,8562
00902,中信電池及儲能,21,3,18,新光-高雄,2023-03-03,8562
2449,京元電子,48,30,18,新光-高雄,2023-03-03,8562
2330,台積電,23,6,17,新光-高雄,2023-03-03,8562
00753L,中信中國50正2,66,49,17,新光-高雄,2023-03-03,8562
5258,虹堡,90,73,17,新光-高雄,2023-03-03,8562
2605,新興,96,79,17,新光-高雄,2023-03-03,8562
2812,台中銀,56,40,16,新光-高雄,2023-03-03,8562
00772B,中信高評級公司債,15,0,15,新光-高雄,2023-03-03,8562
2883,凱基金,20,5,15,新光-高雄,2023-03-03,8562
00673R,期元大S＆P原油反1,1448,54,1394,新光-高雄,2023-03-06,8562
3481,群創,798,71,727,新光-高雄,2023-03-06,8562
00713,元大台灣高息低波,606,6,600,新光-高雄,2023-03-06,8562
00637L,元大滬深300正2,229,50,179,新光-高雄,2023-03-06,8562
00632R,元大台灣50反1,793,619,174,新光-高雄,2023-03-06,8562
2634,漢翔,119,11,108,新光-高雄,2023-03-06,8562
3682,亞太電,97,0,97,新光-高雄,2023-03-06,8562
6177,達麗,70,0,70,新光-高雄,2023-03-06,8562
00712,復華富時不動產,59,0,59,新光-高雄,2023-03-06,8562
2501,國建,57,0,57,新光-高雄,2023-03-06,8562
6261,久元,60,5,55,新光-高雄,2023-03-06,8562
00751B,元大AAA至A公司債,99,51,48,新光-高雄,2023-03-06,8562
2312,金寶,53,6,47,新光-高雄,2023-03-06,8562
1762,中化生,55,9,46,新光-高雄,2023-03-06,8562
3033,威健,43,0,43,新光-高雄,2023-03-06,8562
2002,中鋼,74,38,36,新光-高雄,2023-03-06,8562
2867,三商壽,35,0,35,新光-高雄,2023-03-06,8562
5608,四維航,156,121,35,新光-高雄,2023-03-06,8562
8289,泰藝,71,37,34,新光-高雄,2023-03-06,8562
4128,中天,34,1,33,新光-高雄,2023-03-06,8562
2208,台船,31,0,31,新光-高雄,2023-03-06,8562
5450,南良,33,2,31,新光-高雄,2023-03-06,8562
9921,巨大,34,5,29,新光-高雄,2023-03-06,8562
2890,永豐金,28,0,28,新光-高雄,2023-03-06,8562
6568,宏觀,27,1,26,新光-高雄,2023-03-06,8562
3147,大綜,36,10,26,新光-高雄,2023-03-06,8562
00903,富邦元宇宙,25,0,25,新光-高雄,2023-03-06,8562
6719,力智,36,12,24,新光-高雄,2023-03-06,8562
2332,友訊,27,4,23,新光-高雄,2023-03-06,8562
2610,華航,78,56,22,新光-高雄,2023-03-06,8562
3362,先進光,82,61,21,新光-高雄,2023-03-06,8562
4743,合一,26,6,20,新光-高雄,2023-03-06,8562
2886,兆豐金,28,8,20,新光-高雄,2023-03-06,8562
3432,台端,23,3,20,新光-高雄,2023-03-06,8562
2103,台橡,30,10,20,新光-高雄,2023-03-06,8562
2481,強茂,64,44,20,新光-高雄,2023-03-06,8562
2609,陽明,96,77,19,新光-高雄,2023-03-06,8562
3038,全台,20,1,19,新光-高雄,2023-03-06,8562
4566,時碩工業,19,0,19,新光-高雄,2023-03-06,8562
8104,錸寶,19,0,19,新光-高雄,2023-03-06,8562
2342,茂矽,22,4,18,新光-高雄,2023-03-06,8562
2911,麗嬰房,17,0,17,新光-高雄,2023-03-06,8562
6245,立端,72,55,17,新光-高雄,2023-03-06,8562
2344,華邦電,88,72,16,新光-高雄,2023-03-06,8562
2427,三商電,19,3,16,新光-高雄,2023-03-06,8562
2243,宏旭-KY,22,6,16,新光-高雄,2023-03-06,8562
2305,全友,19,3,16,新光-高雄,2023-03-06,8562
3680,家登,23,8,15,新光-高雄,2023-03-06,8562
5258,虹堡,188,173,15,新光-高雄,2023-03-06,8562
9902,台火,15,0,15,新光-高雄,2023-03-06,8562
00673R,期元大S＆P原油反1,578,119,459,新光-高雄,2023-03-07,8562
2460,建通,82,5,77,新光-高雄,2023-03-07,8562
00712,復華富時不動產,75,4,71,新光-高雄,2023-03-07,8562
2208,台船,71,0,71,新光-高雄,2023-03-07,8562
6116,彩晶,150,83,67,新光-高雄,2023-03-07,8562
4961,天鈺,69,9,60,新光-高雄,2023-03-07,8562
1605,華新,186,140,46,新光-高雄,2023-03-07,8562
00706L,期元大S＆P日圓正2,43,0,43,新光-高雄,2023-03-07,8562
4977,眾達-KY,61,19,42,新光-高雄,2023-03-07,8562
3163,波若威,49,9,40,新光-高雄,2023-03-07,8562
3013,晟銘電,80,42,38,新光-高雄,2023-03-07,8562
4190,佐登-KY,41,5,36,新光-高雄,2023-03-07,8562
2867,三商壽,39,4,35,新光-高雄,2023-03-07,8562
00637L,元大滬深300正2,142,108,34,新光-高雄,2023-03-07,8562
3321,同泰,38,4,34,新光-高雄,2023-03-07,8562
2352,佳世達,34,1,33,新光-高雄,2023-03-07,8562
2402,毅嘉,33,0,33,新光-高雄,2023-03-07,8562
00680L,元大美債20正2,31,0,31,新光-高雄,2023-03-07,8562
1402,遠東新,31,0,31,新光-高雄,2023-03-07,8562
2609,陽明,56,27,29,新光-高雄,2023-03-07,8562
2371,大同,29,0,29,新光-高雄,2023-03-07,8562
6188,廣明,33,7,26,新光-高雄,2023-03-07,8562
2637,慧洋-KY,32,8,24,新光-高雄,2023-03-07,8562
1503,士電,50,27,23,新光-高雄,2023-03-07,8562
00900,富邦特選高股息30,50,27,23,新光-高雄,2023-03-07,8562
00676R,富邦臺灣加權反1,30,8,22,新光-高雄,2023-03-07,8562
6548,長科*,39,17,22,新光-高雄,2023-03-07,8562
2482,連宇,101,80,21,新光-高雄,2023-03-07,8562
5258,虹堡,62,41,21,新光-高雄,2023-03-07,8562
1710,東聯,53,32,21,新光-高雄,2023-03-07,8562
00679B,元大美債20年,21,0,21,新光-高雄,2023-03-07,8562
6279,胡連,21,1,20,新光-高雄,2023-03-07,8562
3297,杭特,23,3,20,新光-高雄,2023-03-07,8562
3029,零壹,50,31,19,新光-高雄,2023-03-07,8562
6235,華孚,157,138,19,新光-高雄,2023-03-07,8562
3033,威健,20,1,19,新光-高雄,2023-03-07,8562
6140,訊達,25,7,18,新光-高雄,2023-03-07,8562
4114,健喬,35,17,18,新光-高雄,2023-03-07,8562
6233,旺玖,23,5,18,新光-高雄,2023-03-07,8562
6153,嘉聯益,20,2,18,新光-高雄,2023-03-07,8562
3037,欣興,25,7,18,新光-高雄,2023-03-07,8562
1795,美時,40,23,17,新光-高雄,2023-03-07,8562
2887,台新金,18,0,18,新光-高雄,2023-03-07,8562
2453,凌群,27,10,17,新光-高雄,2023-03-07,8562
3673,TPK-KY,17,0,17,新光-高雄,2023-03-07,8562
1513,中興電,88,71,17,新光-高雄,2023-03-07,8562
2441,超豐,22,5,17,新光-高雄,2023-03-07,8562
6234,高僑,38,22,16,新光-高雄,2023-03-07,8562
1522,堤維西,21,5,16,新光-高雄,2023-03-07,8562
1519,華城,109,94,15,新光-高雄,2023-03-07,8562
00671R,富邦NASDAQ反1,610,32,578,新光-高雄,2023-03-08,8562
00673R,期元大S＆P原油反1,995,643,352,新光-高雄,2023-03-08,8562
00713,元大台灣高息低波,268,8,260,新光-高雄,2023-03-08,8562
00715L,期街口布蘭特正2,187,11,176,新光-高雄,2023-03-08,8562
00637L,元大滬深300正2,256,90,166,新光-高雄,2023-03-08,8562
3682,亞太電,164,3,161,新光-高雄,2023-03-08,8562
00706L,期元大S＆P日圓正2,165,10,155,新光-高雄,2023-03-08,8562
00878,國泰永續高股息,176,45,131,新光-高雄,2023-03-08,8562
1513,中興電,184,78,106,新光-高雄,2023-03-08,8562
00712,復華富時不動產,109,5,104,新光-高雄,2023-03-08,8562
9921,巨大,84,0,84,新光-高雄,2023-03-08,8562
00882,中信中國高股息,76,0,76,新光-高雄,2023-03-08,8562
00902,中信電池及儲能,64,0,64,新光-高雄,2023-03-08,8562
00923,群益台ESG低碳50,73,12,61,新光-高雄,2023-03-08,8562
3481,群創,78,23,55,新光-高雄,2023-03-08,8562
2359,所羅門,66,13,53,新光-高雄,2023-03-08,8562
2609,陽明,72,25,47,新光-高雄,2023-03-08,8562
00670L,富邦NASDAQ正2,45,0,45,新光-高雄,2023-03-08,8562
5340,建榮,42,0,42,新光-高雄,2023-03-08,8562
0056,元大高股息,62,21,41,新光-高雄,2023-03-08,8562
00753L,中信中國50正2,78,39,39,新光-高雄,2023-03-08,8562
5426,振發,38,0,38,新光-高雄,2023-03-08,8562
1762,中化生,50,14,36,新光-高雄,2023-03-08,8562
4306,炎洲,35,0,35,新光-高雄,2023-03-08,8562
2317,鴻海,64,29,35,新光-高雄,2023-03-08,8562
1709,和益,42,8,34,新光-高雄,2023-03-08,8562
006208,富邦台50,36,4,32,新光-高雄,2023-03-08,8562
1810,和成,40,8,32,新光-高雄,2023-03-08,8562
9904,寶成,32,0,32,新光-高雄,2023-03-08,8562
5388,中磊,33,2,31,新光-高雄,2023-03-08,8562
1453,大將,31,0,31,新光-高雄,2023-03-08,8562
5608,四維航,126,95,31,新光-高雄,2023-03-08,8562
00632R,元大台灣50反1,123,93,30,新光-高雄,2023-03-08,8562
4541,晟田,38,10,28,新光-高雄,2023-03-08,8562
2884,玉山金,30,2,28,新光-高雄,2023-03-08,8562
6509,聚和,30,3,27,新光-高雄,2023-03-08,8562
2641,正德,30,3,27,新光-高雄,2023-03-08,8562
3673,TPK-KY,29,3,26,新光-高雄,2023-03-08,8562
2426,鼎元,28,2,26,新光-高雄,2023-03-08,8562
2344,華邦電,70,45,25,新光-高雄,2023-03-08,8562
2882,國泰金,31,7,24,新光-高雄,2023-03-08,8562
2498,宏達電,76,53,23,新光-高雄,2023-03-08,8562
2367,燿華,23,0,23,新光-高雄,2023-03-08,8562
2912,統一超,23,0,23,新光-高雄,2023-03-08,8562
6196,帆宣,26,3,23,新光-高雄,2023-03-08,8562
2201,裕隆,45,22,23,新光-高雄,2023-03-08,8562
00665L,富邦�琤肭磪囓�2,122,100,22,新光-高雄,2023-03-08,8562
2867,三商壽,22,0,22,新光-高雄,2023-03-08,8562
1101,台泥,37,15,22,新光-高雄,2023-03-08,8562
00891,中信關鍵半導體,21,0,21,新光-高雄,2023-03-08,8562
00878,國泰永續高股息,214,55,159,新光-高雄,2023-03-09,8562
2409,友達,175,18,157,新光-高雄,2023-03-09,8562
4130,健亞,148,10,138,新光-高雄,2023-03-09,8562
2317,鴻海,160,41,119,新光-高雄,2023-03-09,8562
2344,華邦電,156,53,103,新光-高雄,2023-03-09,8562
6282,康舒,158,57,101,新光-高雄,2023-03-09,8562
00637L,元大滬深300正2,268,179,89,新光-高雄,2023-03-09,8562
2609,陽明,141,51,90,新光-高雄,2023-03-09,8562
1810,和成,104,19,85,新光-高雄,2023-03-09,8562
3682,亞太電,81,0,81,新光-高雄,2023-03-09,8562
00715L,期街口布蘭特正2,90,13,77,新光-高雄,2023-03-09,8562
1718,中纖,126,58,68,新光-高雄,2023-03-09,8562
2845,遠東銀,127,76,51,新光-高雄,2023-03-09,8562
8222,寶一,117,66,51,新光-高雄,2023-03-09,8562
2890,永豐金,53,4,49,新光-高雄,2023-03-09,8562
8069,元太,82,33,49,新光-高雄,2023-03-09,8562
9907,統一實,72,24,48,新光-高雄,2023-03-09,8562
6443,元晶,115,69,46,新光-高雄,2023-03-09,8562
0056,元大高股息,108,64,44,新光-高雄,2023-03-09,8562
1101,台泥,54,11,43,新光-高雄,2023-03-09,8562
6116,彩晶,70,30,40,新光-高雄,2023-03-09,8562
00907,永豐優息存股,40,0,40,新光-高雄,2023-03-09,8562
5443,均豪,40,0,40,新光-高雄,2023-03-09,8562
1504,東元,146,106,40,新光-高雄,2023-03-09,8562
00712,復華富時不動產,48,9,39,新光-高雄,2023-03-09,8562
3591,艾笛森,51,14,37,新光-高雄,2023-03-09,8562
2897,王道銀行,70,35,35,新光-高雄,2023-03-09,8562
2390,云辰,58,24,34,新光-高雄,2023-03-09,8562
2347,聯強,39,5,34,新光-高雄,2023-03-09,8562
3362,先進光,51,18,33,新光-高雄,2023-03-09,8562
1432,大魯閣,53,21,32,新光-高雄,2023-03-09,8562
2399,映泰,35,3,32,新光-高雄,2023-03-09,8562
3289,宜特,52,20,32,新光-高雄,2023-03-09,8562
3499,環天科,31,2,29,新光-高雄,2023-03-09,8562
6016,康和證,29,0,29,新光-高雄,2023-03-09,8562
2444,兆勁,28,0,28,新光-高雄,2023-03-09,8562
2883,凱基金,30,3,27,新光-高雄,2023-03-09,8562
2891,中信金,39,13,26,新光-高雄,2023-03-09,8562
00713,元大台灣高息低波,28,2,26,新光-高雄,2023-03-09,8562
3356,奇偶,52,26,26,新光-高雄,2023-03-09,8562
5880,合庫金,26,0,26,新光-高雄,2023-03-09,8562
5272,笙科,35,10,25,新光-高雄,2023-03-09,8562
2884,玉山金,29,4,25,新光-高雄,2023-03-09,8562
2023,燁輝,25,0,25,新光-高雄,2023-03-09,8562
2486,一詮,144,119,25,新光-高雄,2023-03-09,8562
2887,台新金,33,8,25,新光-高雄,2023-03-09,8562
2406,國碩,26,3,23,新光-高雄,2023-03-09,8562
9136,巨騰-DR,29,6,23,新光-高雄,2023-03-09,8562
2812,台中銀,125,102,23,新光-高雄,2023-03-09,8562
4961,天鈺,32,9,23,新光-高雄,2023-03-09,8562
00878,國泰永續高股息,621,31,590,新光-高雄,2023-03-10,8562
00715L,期街口布蘭特正2,598,12,586,新光-高雄,2023-03-10,8562
2834,臺企銀,340,32,308,新光-高雄,2023-03-10,8562
2880,華南金,154,1,153,新光-高雄,2023-03-10,8562
3481,群創,181,38,143,新光-高雄,2023-03-10,8562
00670L,富邦NASDAQ正2,140,4,136,新光-高雄,2023-03-10,8562
2344,華邦電,173,45,128,新光-高雄,2023-03-10,8562
00713,元大台灣高息低波,132,7,125,新光-高雄,2023-03-10,8562
1324,地球,117,11,106,新光-高雄,2023-03-10,8562
2610,華航,198,92,106,新光-高雄,2023-03-10,8562
00882,中信中國高股息,105,10,95,新光-高雄,2023-03-10,8562
6235,華孚,128,35,93,新光-高雄,2023-03-10,8562
6187,萬潤,92,0,92,新光-高雄,2023-03-10,8562
00665L,富邦�琤肭磪囓�2,245,153,92,新光-高雄,2023-03-10,8562
00712,復華富時不動產,128,41,87,新光-高雄,2023-03-10,8562
0056,元大高股息,131,45,86,新光-高雄,2023-03-10,8562
6770,力積電,85,4,81,新光-高雄,2023-03-10,8562
6266,泰詠,78,8,70,新光-高雄,2023-03-10,8562
2890,永豐金,82,15,67,新光-高雄,2023-03-10,8562
00907,永豐優息存股,65,0,65,新光-高雄,2023-03-10,8562
2812,台中銀,93,29,64,新光-高雄,2023-03-10,8562
2884,玉山金,102,41,61,新光-高雄,2023-03-10,8562
2888,新光金,63,3,60,新光-高雄,2023-03-10,8562
2618,長榮航,124,65,59,新光-高雄,2023-03-10,8562
00637L,元大滬深300正2,235,176,59,新光-高雄,2023-03-10,8562
8069,元太,81,23,58,新光-高雄,2023-03-10,8562
00923,群益台ESG低碳50,64,7,57,新光-高雄,2023-03-10,8562
2883,凱基金,72,19,53,新光-高雄,2023-03-10,8562
2882,國泰金,81,32,49,新光-高雄,2023-03-10,8562
8112,至上,71,25,46,新光-高雄,2023-03-10,8562
5608,四維航,143,103,40,新光-高雄,2023-03-10,8562
2911,麗嬰房,40,0,40,新光-高雄,2023-03-10,8562
2891,中信金,67,27,40,新光-高雄,2023-03-10,8562
2208,台船,111,72,39,新光-高雄,2023-03-10,8562
00720B,元大投資級公司債,62,24,38,新光-高雄,2023-03-10,8562
00891,中信關鍵半導體,37,0,37,新光-高雄,2023-03-10,8562
00885,富邦越南,68,32,36,新光-高雄,2023-03-10,8562
2317,鴻海,40,4,36,新光-高雄,2023-03-10,8562
00752,中信中國50,45,10,35,新光-高雄,2023-03-10,8562
2201,裕隆,82,47,35,新光-高雄,2023-03-10,8562
2454,聯發科,35,0,35,新光-高雄,2023-03-10,8562
5880,合庫金,35,1,34,新光-高雄,2023-03-10,8562
2887,台新金,41,8,33,新光-高雄,2023-03-10,8562
2886,兆豐金,33,1,32,新光-高雄,2023-03-10,8562
2399,映泰,33,1,32,新光-高雄,2023-03-10,8562
00881,國泰台灣5G+,47,16,31,新光-高雄,2023-03-10,8562
00902,中信電池及儲能,40,10,30,新光-高雄,2023-03-10,8562
8937,合騏,30,0,30,新光-高雄,2023-03-10,8562
3056,富華新,32,3,29,新光-高雄,2023-03-10,8562
0050,元大台灣50,33,5,28,新光-高雄,2023-03-10,8562
00878,國泰永續高股息,670,154,516,新光-高雄,2023-03-13,8562
2317,鴻海,364,34,330,新光-高雄,2023-03-13,8562
00715L,期街口布蘭特正2,366,112,254,新光-高雄,2023-03-13,8562
2515,中工,253,1,252,新光-高雄,2023-03-13,8562
00632R,元大台灣50反1,794,643,151,新光-高雄,2023-03-13,8562
3046,建��,184,74,110,新光-高雄,2023-03-13,8562
00712,復華富時不動產,136,30,106,新光-高雄,2023-03-13,8562
00882,中信中國高股息,122,23,99,新光-高雄,2023-03-13,8562
2449,京元電子,101,17,84,新光-高雄,2023-03-13,8562
2601,益航,77,2,75,新光-高雄,2023-03-13,8562
8415,大國鋼,72,0,72,新光-高雄,2023-03-13,8562
2834,臺企銀,122,58,64,新光-高雄,2023-03-13,8562
1709,和益,69,8,61,新光-高雄,2023-03-13,8562
2303,聯電,95,35,60,新光-高雄,2023-03-13,8562
9921,巨大,68,8,60,新光-高雄,2023-03-13,8562
00679B,元大美債20年,120,61,59,新光-高雄,2023-03-13,8562
2332,友訊,63,5,58,新光-高雄,2023-03-13,8562
00648R,元大S＆P500反1,57,0,57,新光-高雄,2023-03-13,8562
00713,元大台灣高息低波,60,7,53,新光-高雄,2023-03-13,8562
00637L,元大滬深300正2,123,74,49,新光-高雄,2023-03-13,8562
6770,力積電,58,12,46,新光-高雄,2023-03-13,8562
2882,國泰金,52,11,41,新光-高雄,2023-03-13,8562
2890,永豐金,47,8,39,新光-高雄,2023-03-13,8562
00885,富邦越南,48,9,39,新光-高雄,2023-03-13,8562
911608,明輝-DR,38,0,38,新光-高雄,2023-03-13,8562
00720B,元大投資級公司債,54,17,37,新光-高雄,2023-03-13,8562
2610,華航,132,95,37,新光-高雄,2023-03-13,8562
3005,神基,53,18,35,新光-高雄,2023-03-13,8562
2884,玉山金,45,12,33,新光-高雄,2023-03-13,8562
2359,所羅門,48,16,32,新光-高雄,2023-03-13,8562
00915,凱基優選高股息30,33,1,32,新光-高雄,2023-03-13,8562
2867,三商壽,49,21,28,新光-高雄,2023-03-13,8562
2027,大成鋼,37,9,28,新光-高雄,2023-03-13,8562
3682,亞太電,27,0,27,新光-高雄,2023-03-13,8562
00669R,國泰美國道瓊反1,60,35,25,新光-高雄,2023-03-13,8562
9105,泰金寶-DR,30,5,25,新光-高雄,2023-03-13,8562
3058,立德,38,13,25,新光-高雄,2023-03-13,8562
2891,中信金,47,22,25,新光-高雄,2023-03-13,8562
3083,網龍,24,0,24,新光-高雄,2023-03-13,8562
8176,智捷,24,1,23,新光-高雄,2023-03-13,8562
9925,新保,23,0,23,新光-高雄,2023-03-13,8562
00902,中信電池及儲能,32,9,23,新光-高雄,2023-03-13,8562
1605,華新,64,42,22,新光-高雄,2023-03-13,8562
2641,正德,25,3,22,新光-高雄,2023-03-13,8562
2204,中華,39,18,21,新光-高雄,2023-03-13,8562
2482,連宇,34,13,21,新光-高雄,2023-03-13,8562
2208,台船,24,4,20,新光-高雄,2023-03-13,8562
00923,群益台ESG低碳50,20,0,20,新光-高雄,2023-03-13,8562
8046,南電,56,36,20,新光-高雄,2023-03-13,8562
1215,卜蜂,22,2,20,新光-高雄,2023-03-13,8562
00715L,期街口布蘭特正2,1160,63,1097,新光-高雄,2023-03-14,8562
00878,國泰永續高股息,801,44,757,新光-高雄,2023-03-14,8562
00642U,期元大S＆P石油,213,5,208,新光-高雄,2023-03-14,8562
2891,中信金,155,1,154,新光-高雄,2023-03-14,8562
6235,華孚,228,86,142,新光-高雄,2023-03-14,8562
00665L,富邦�琤肭磪囓�2,285,162,123,新光-高雄,2023-03-14,8562
2883,凱基金,123,2,121,新光-高雄,2023-03-14,8562
2515,中工,174,81,93,新光-高雄,2023-03-14,8562
00923,群益台ESG低碳50,92,0,92,新光-高雄,2023-03-14,8562
2897,王道銀行,102,10,92,新光-高雄,2023-03-14,8562
00637L,元大滬深300正2,194,109,85,新光-高雄,2023-03-14,8562
00882,中信中國高股息,86,1,85,新光-高雄,2023-03-14,8562
5864,致和證,85,0,85,新光-高雄,2023-03-14,8562
8936,國統,83,12,71,新光-高雄,2023-03-14,8562
00712,復華富時不動產,174,106,68,新光-高雄,2023-03-14,8562
2409,友達,79,13,66,新光-高雄,2023-03-14,8562
2610,華航,137,79,58,新光-高雄,2023-03-14,8562
2317,鴻海,76,22,54,新光-高雄,2023-03-14,8562
2303,聯電,74,21,53,新光-高雄,2023-03-14,8562
6122,擎邦,108,55,53,新光-高雄,2023-03-14,8562
8069,元太,76,24,52,新光-高雄,2023-03-14,8562
2609,陽明,199,147,52,新光-高雄,2023-03-14,8562
00679B,元大美債20年,70,18,52,新光-高雄,2023-03-14,8562
2888,新光金,56,6,50,新光-高雄,2023-03-14,8562
5443,均豪,49,0,49,新光-高雄,2023-03-14,8562
1101,台泥,61,13,48,新光-高雄,2023-03-14,8562
2388,威盛,120,77,43,新光-高雄,2023-03-14,8562
00773B,中信優先金融債,41,0,41,新光-高雄,2023-03-14,8562
1709,和益,44,4,40,新光-高雄,2023-03-14,8562
9907,統一實,40,0,40,新光-高雄,2023-03-14,8562
2881,富邦金,50,10,40,新光-高雄,2023-03-14,8562
1305,華夏,38,0,38,新光-高雄,2023-03-14,8562
00902,中信電池及儲能,38,0,38,新光-高雄,2023-03-14,8562
2890,永豐金,41,3,38,新光-高雄,2023-03-14,8562
6163,華電網,59,23,36,新光-高雄,2023-03-14,8562
2834,臺企銀,111,76,35,新光-高雄,2023-03-14,8562
2887,台新金,41,6,35,新光-高雄,2023-03-14,8562
2615,萬海,87,53,34,新光-高雄,2023-03-14,8562
1215,卜蜂,34,2,32,新光-高雄,2023-03-14,8562
00893,國泰智能電動車,37,6,31,新光-高雄,2023-03-14,8562
3712,永崴投控,30,0,30,新光-高雄,2023-03-14,8562
2852,第一保,30,0,30,新光-高雄,2023-03-14,8562
00885,富邦越南,30,2,28,新光-高雄,2023-03-14,8562
6770,力積電,28,0,28,新光-高雄,2023-03-14,8562
2880,華南金,35,9,26,新光-高雄,2023-03-14,8562
3024,憶聲,26,1,25,新光-高雄,2023-03-14,8562
00915,凱基優選高股息30,24,0,24,新光-高雄,2023-03-14,8562
2845,遠東銀,44,20,24,新光-高雄,2023-03-14,8562
1314,中石化,23,0,23,新光-高雄,2023-03-14,8562
2886,兆豐金,25,3,22,新光-高雄,2023-03-14,8562
00715L,期街口布蘭特正2,751,59,692,新光-高雄,2023-03-15,8562
2834,臺企銀,255,16,239,新光-高雄,2023-03-15,8562
00878,國泰永續高股息,217,67,150,新光-高雄,2023-03-15,8562
2603,長榮,289,142,147,新光-高雄,2023-03-15,8562
00632R,元大台灣50反1,477,364,113,新光-高雄,2023-03-15,8562
5864,致和證,107,0,107,新光-高雄,2023-03-15,8562
5425,台半,136,47,89,新光-高雄,2023-03-15,8562
00712,復華富時不動產,88,0,88,新光-高雄,2023-03-15,8562
6257,矽格,95,13,82,新光-高雄,2023-03-15,8562
8415,大國鋼,81,0,81,新光-高雄,2023-03-15,8562
2457,飛宏,186,113,73,新光-高雄,2023-03-15,8562
2881,富邦金,69,2,67,新光-高雄,2023-03-15,8562
2610,華航,204,138,66,新光-高雄,2023-03-15,8562
00751B,元大AAA至A公司債,64,0,64,新光-高雄,2023-03-15,8562
5009,榮剛,101,38,63,新光-高雄,2023-03-15,8562
00706L,期元大S＆P日圓正2,62,0,62,新光-高雄,2023-03-15,8562
6770,力積電,75,15,60,新光-高雄,2023-03-15,8562
2204,中華,96,38,58,新光-高雄,2023-03-15,8562
00902,中信電池及儲能,60,3,57,新光-高雄,2023-03-15,8562
00885,富邦越南,60,5,55,新光-高雄,2023-03-15,8562
00642U,期元大S＆P石油,57,6,51,新光-高雄,2023-03-15,8562
00923,群益台ESG低碳50,47,0,47,新光-高雄,2023-03-15,8562
2891,中信金,57,10,47,新光-高雄,2023-03-15,8562
5880,合庫金,45,0,45,新光-高雄,2023-03-15,8562
00679B,元大美債20年,58,14,44,新光-高雄,2023-03-15,8562
00773B,中信優先金融債,54,11,43,新光-高雄,2023-03-15,8562
3481,群創,146,104,42,新光-高雄,2023-03-15,8562
2880,華南金,42,0,42,新光-高雄,2023-03-15,8562
2027,大成鋼,83,42,41,新光-高雄,2023-03-15,8562
2897,王道銀行,52,13,39,新光-高雄,2023-03-15,8562
1504,東元,83,44,39,新光-高雄,2023-03-15,8562
2884,玉山金,41,3,38,新光-高雄,2023-03-15,8562
4938,和碩,44,7,37,新光-高雄,2023-03-15,8562
00671R,富邦NASDAQ反1,40,5,35,新光-高雄,2023-03-15,8562
2888,新光金,62,29,33,新光-高雄,2023-03-15,8562
2867,三商壽,41,10,31,新光-高雄,2023-03-15,8562
2609,陽明,148,118,30,新光-高雄,2023-03-15,8562
911868,同方友友-DR,30,0,30,新光-高雄,2023-03-15,8562
6112,邁達特,29,0,29,新光-高雄,2023-03-15,8562
2542,興富發,32,4,28,新光-高雄,2023-03-15,8562
00713,元大台灣高息低波,30,3,27,新光-高雄,2023-03-15,8562
2883,凱基金,37,11,26,新光-高雄,2023-03-15,8562
1506,正道,26,0,26,新光-高雄,2023-03-15,8562
00900,富邦特選高股息30,31,5,26,新光-高雄,2023-03-15,8562
9907,統一實,38,12,26,新光-高雄,2023-03-15,8562
2634,漢翔,51,26,25,新光-高雄,2023-03-15,8562
9904,寶成,45,22,23,新光-高雄,2023-03-15,8562
4977,眾達-KY,23,0,23,新光-高雄,2023-03-15,8562
2614,東森,26,5,21,新光-高雄,2023-03-15,8562
4979,華星光,21,0,21,新光-高雄,2023-03-15,8562
00715L,期街口布蘭特正2,1004,321,683,新光-高雄,2023-03-16,8562
00878,國泰永續高股息,412,76,336,新光-高雄,2023-03-16,8562
00642U,期元大S＆P石油,278,70,208,新光-高雄,2023-03-16,8562
2891,中信金,233,41,192,新光-高雄,2023-03-16,8562
0056,元大高股息,203,40,163,新光-高雄,2023-03-16,8562
00713,元大台灣高息低波,144,2,142,新光-高雄,2023-03-16,8562
8415,大國鋼,140,0,140,新光-高雄,2023-03-16,8562
3056,富華新,177,51,126,新光-高雄,2023-03-16,8562
00664R,國泰臺灣加權反1,100,0,100,新光-高雄,2023-03-16,8562
9103,美德醫療-DR,87,1,86,新光-高雄,2023-03-16,8562
00637L,元大滬深300正2,208,123,85,新光-高雄,2023-03-16,8562
2618,長榮航,111,35,76,新光-高雄,2023-03-16,8562
00720B,元大投資級公司債,74,5,69,新光-高雄,2023-03-16,8562
00680L,元大美債20正2,134,67,67,新光-高雄,2023-03-16,8562
2609,陽明,179,114,65,新光-高雄,2023-03-16,8562
2884,玉山金,130,68,62,新光-高雄,2023-03-16,8562
2454,聯發科,61,3,58,新光-高雄,2023-03-16,8562
2633,台灣高鐵,58,5,53,新光-高雄,2023-03-16,8562
00712,復華富時不動產,61,10,51,新光-高雄,2023-03-16,8562
3035,智原,89,40,49,新光-高雄,2023-03-16,8562
6223,旺矽,52,3,49,新光-高雄,2023-03-16,8562
2883B,凱基金乙特,45,0,45,新光-高雄,2023-03-16,8562
2603,長榮,142,97,45,新光-高雄,2023-03-16,8562
2887,台新金,74,31,43,新光-高雄,2023-03-16,8562
4906,正文,43,4,39,新光-高雄,2023-03-16,8562
2867,三商壽,72,34,38,新光-高雄,2023-03-16,8562
2401,凌陽,41,4,37,新光-高雄,2023-03-16,8562
3062,建漢,36,0,36,新光-高雄,2023-03-16,8562
6443,元晶,67,31,36,新光-高雄,2023-03-16,8562
2027,大成鋼,49,13,36,新光-高雄,2023-03-16,8562
6603,富強鑫,35,0,35,新光-高雄,2023-03-16,8562
00908,富邦入息REITs+,35,0,35,新光-高雄,2023-03-16,8562
1718,中纖,34,1,33,新光-高雄,2023-03-16,8562
2312,金寶,30,0,30,新光-高雄,2023-03-16,8562
6753,龍德造船,30,0,30,新光-高雄,2023-03-16,8562
00915,凱基優選高股息30,28,0,28,新光-高雄,2023-03-16,8562
2881,富邦金,34,7,27,新光-高雄,2023-03-16,8562
1314,中石化,31,5,26,新光-高雄,2023-03-16,8562
2886,兆豐金,31,6,25,新光-高雄,2023-03-16,8562
00631L,元大台灣50正2,44,21,23,新光-高雄,2023-03-16,8562
00675L,富邦臺灣加權正2,27,4,23,新光-高雄,2023-03-16,8562
6112,邁達特,28,5,23,新光-高雄,2023-03-16,8562
2427,三商電,25,2,23,新光-高雄,2023-03-16,8562
5009,榮剛,119,96,23,新光-高雄,2023-03-16,8562
2498,宏達電,46,24,22,新光-高雄,2023-03-16,8562
006208,富邦台50,26,4,22,新光-高雄,2023-03-16,8562
2915,潤泰全,34,13,21,新光-高雄,2023-03-16,8562
6770,力積電,29,8,21,新光-高雄,2023-03-16,8562
2313,華通,22,1,21,新光-高雄,2023-03-16,8562
00902,中信電池及儲能,28,8,20,新光-高雄,2023-03-16,8562
00632R,元大台灣50反1,1298,162,1136,新光-高雄,2023-03-17,8562
00715L,期街口布蘭特正2,397,42,355,新光-高雄,2023-03-17,8562
2891,中信金,239,13,226,新光-高雄,2023-03-17,8562
6235,華孚,149,38,111,新光-高雄,2023-03-17,8562
4306,炎洲,110,1,109,新光-高雄,2023-03-17,8562
2834,臺企銀,144,51,93,新光-高雄,2023-03-17,8562
00878,國泰永續高股息,140,48,92,新光-高雄,2023-03-17,8562
00680L,元大美債20正2,100,20,80,新光-高雄,2023-03-17,8562
5864,致和證,75,0,75,新光-高雄,2023-03-17,8562
3528,安馳,74,0,74,新光-高雄,2023-03-17,8562
6548,長科*,72,2,70,新光-高雄,2023-03-17,8562
2610,華航,91,26,65,新光-高雄,2023-03-17,8562
00753L,中信中國50正2,113,55,58,新光-高雄,2023-03-17,8562
6266,泰詠,62,4,58,新光-高雄,2023-03-17,8562
2888,新光金,75,18,57,新光-高雄,2023-03-17,8562
00679B,元大美債20年,75,23,52,新光-高雄,2023-03-17,8562
00713,元大台灣高息低波,62,12,50,新光-高雄,2023-03-17,8562
2851,中再保,54,5,49,新光-高雄,2023-03-17,8562
2881,富邦金,57,13,44,新光-高雄,2023-03-17,8562
00683L,期元大美元指正2,43,0,43,新光-高雄,2023-03-17,8562
00642U,期元大S＆P石油,53,10,43,新光-高雄,2023-03-17,8562
2457,飛宏,203,161,42,新光-高雄,2023-03-17,8562
2609,陽明,84,44,40,新光-高雄,2023-03-17,8562
2392,正崴,63,23,40,新光-高雄,2023-03-17,8562
2883,凱基金,54,17,37,新光-高雄,2023-03-17,8562
1108,幸福,44,10,34,新光-高雄,2023-03-17,8562
2027,大成鋼,39,6,33,新光-高雄,2023-03-17,8562
2530,華建,40,7,33,新光-高雄,2023-03-17,8562
0056,元大高股息,39,10,29,新光-高雄,2023-03-17,8562
9921,巨大,31,4,27,新光-高雄,2023-03-17,8562
00712,復華富時不動產,27,1,26,新光-高雄,2023-03-17,8562
6443,元晶,254,228,26,新光-高雄,2023-03-17,8562
3062,建漢,26,0,26,新光-高雄,2023-03-17,8562
1101,台泥,30,5,25,新光-高雄,2023-03-17,8562
9904,寶成,49,27,22,新光-高雄,2023-03-17,8562
2409,友達,62,40,22,新光-高雄,2023-03-17,8562
5880,合庫金,32,11,21,新光-高雄,2023-03-17,8562
2439,美律,21,0,21,新光-高雄,2023-03-17,8562
2402,毅嘉,41,20,21,新光-高雄,2023-03-17,8562
6485,點序,21,1,20,新光-高雄,2023-03-17,8562
00706L,期元大S＆P日圓正2,20,0,20,新光-高雄,2023-03-17,8562
00919,群益台灣精選高息,20,0,20,新光-高雄,2023-03-17,8562
2812,台中銀,41,21,20,新光-高雄,2023-03-17,8562
2884,玉山金,41,22,19,新光-高雄,2023-03-17,8562
00902,中信電池及儲能,19,0,19,新光-高雄,2023-03-17,8562
4934,太極,42,24,18,新光-高雄,2023-03-17,8562
00885,富邦越南,16,0,16,新光-高雄,2023-03-17,8562
2313,華通,19,3,16,新光-高雄,2023-03-17,8562
6449,鈺邦,17,1,16,新光-高雄,2023-03-17,8562
6122,擎邦,46,30,16,新光-高雄,2023-03-17,8562
00715L,期街口布蘭特正2,447,184,263,新光-高雄,2023-03-20,8562
0056,元大高股息,240,2,238,新光-高雄,2023-03-20,8562
00637L,元大滬深300正2,149,11,138,新光-高雄,2023-03-20,8562
00878,國泰永續高股息,186,54,132,新光-高雄,2023-03-20,8562
00680L,元大美債20正2,155,46,109,新光-高雄,2023-03-20,8562
6266,泰詠,102,1,101,新光-高雄,2023-03-20,8562
2330,台積電,102,2,100,新光-高雄,2023-03-20,8562
2882,國泰金,78,7,71,新光-高雄,2023-03-20,8562
2891,中信金,68,4,64,新光-高雄,2023-03-20,8562
3017,奇鋐,85,24,61,新光-高雄,2023-03-20,8562
2317,鴻海,79,19,60,新光-高雄,2023-03-20,8562
2027,大成鋼,64,5,59,新光-高雄,2023-03-20,8562
1605,華新,75,19,56,新光-高雄,2023-03-20,8562
2329,華泰,55,1,54,新光-高雄,2023-03-20,8562
6244,茂迪,194,141,53,新光-高雄,2023-03-20,8562
2890,永豐金,127,83,44,新光-高雄,2023-03-20,8562
00665L,富邦�琤肭磪囓�2,41,0,41,新光-高雄,2023-03-20,8562
00720B,元大投資級公司債,46,7,39,新光-高雄,2023-03-20,8562
2481,強茂,57,18,39,新光-高雄,2023-03-20,8562
1709,和益,38,0,38,新光-高雄,2023-03-20,8562
2103,台橡,36,0,36,新光-高雄,2023-03-20,8562
2888,新光金,53,20,33,新光-高雄,2023-03-20,8562
5009,榮剛,39,9,30,新光-高雄,2023-03-20,8562
3491,昇達科,30,1,29,新光-高雄,2023-03-20,8562
00713,元大台灣高息低波,28,1,27,新光-高雄,2023-03-20,8562
6282,康舒,28,3,25,新光-高雄,2023-03-20,8562
00882,中信中國高股息,25,0,25,新光-高雄,2023-03-20,8562
2471,資通,76,51,25,新光-高雄,2023-03-20,8562
2537,聯上發,25,0,25,新光-高雄,2023-03-20,8562
00706L,期元大S＆P日圓正2,23,0,23,新光-高雄,2023-03-20,8562
2881,富邦金,24,1,23,新光-高雄,2023-03-20,8562
5534,長虹,22,0,22,新光-高雄,2023-03-20,8562
1108,幸福,29,7,22,新光-高雄,2023-03-20,8562
00725B,國泰投資級公司債,24,3,21,新光-高雄,2023-03-20,8562
9958,世紀鋼,28,7,21,新光-高雄,2023-03-20,8562
3027,盛達,148,127,21,新光-高雄,2023-03-20,8562
3580,友威科,20,0,20,新光-高雄,2023-03-20,8562
1109,信大,20,0,20,新光-高雄,2023-03-20,8562
5880,合庫金,20,0,20,新光-高雄,2023-03-20,8562
6515,穎崴,23,4,19,新光-高雄,2023-03-20,8562
3265,台星科,20,1,19,新光-高雄,2023-03-20,8562
2892,第一金,22,3,19,新光-高雄,2023-03-20,8562
9945,潤泰新,121,103,18,新光-高雄,2023-03-20,8562
00772B,中信高評級公司債,20,2,18,新光-高雄,2023-03-20,8562
00633L,富邦上証正2,20,2,18,新光-高雄,2023-03-20,8562
00712,復華富時不動產,18,0,18,新光-高雄,2023-03-20,8562
3051,力特,20,3,17,新光-高雄,2023-03-20,8562
2883,凱基金,34,17,17,新光-高雄,2023-03-20,8562
00679B,元大美債20年,46,30,16,新光-高雄,2023-03-20,8562
2885,元大金,17,1,16,新光-高雄,2023-03-20,8562
3481,群創,451,49,402,新光-高雄,2023-03-21,8562
00632R,元大台灣50反1,470,257,213,新光-高雄,2023-03-21,8562
00715L,期街口布蘭特正2,200,22,178,新光-高雄,2023-03-21,8562
2851,中再保,135,0,135,新光-高雄,2023-03-21,8562
2344,華邦電,80,5,75,新光-高雄,2023-03-21,8562
6266,泰詠,75,9,66,新光-高雄,2023-03-21,8562
00664R,國泰臺灣加權反1,60,0,60,新光-高雄,2023-03-21,8562
2634,漢翔,71,13,58,新光-高雄,2023-03-21,8562
2891,中信金,75,17,58,新光-高雄,2023-03-21,8562
3046,建��,154,97,57,新光-高雄,2023-03-21,8562
00885,富邦越南,55,0,55,新光-高雄,2023-03-21,8562
2884,玉山金,61,6,55,新光-高雄,2023-03-21,8562
5864,致和證,53,0,53,新光-高雄,2023-03-21,8562
00882,中信中國高股息,55,3,52,新光-高雄,2023-03-21,8562
6443,元晶,113,63,50,新光-高雄,2023-03-21,8562
2883,凱基金,47,6,41,新光-高雄,2023-03-21,8562
2609,陽明,73,32,41,新光-高雄,2023-03-21,8562
8289,泰藝,60,20,40,新光-高雄,2023-03-21,8562
3504,揚明光,35,0,35,新光-高雄,2023-03-21,8562
1513,中興電,143,109,34,新光-高雄,2023-03-21,8562
00679B,元大美債20年,44,10,34,新光-高雄,2023-03-21,8562
1584,精剛,87,59,28,新光-高雄,2023-03-21,8562
1312,國喬,28,0,28,新光-高雄,2023-03-21,8562
6112,邁達特,29,2,27,新光-高雄,2023-03-21,8562
8046,南電,40,14,26,新光-高雄,2023-03-21,8562
00712,復華富時不動產,29,3,26,新光-高雄,2023-03-21,8562
0056,元大高股息,72,47,25,新光-高雄,2023-03-21,8562
00683L,期元大美元指正2,25,0,25,新光-高雄,2023-03-21,8562
00720B,元大投資級公司債,27,3,24,新光-高雄,2023-03-21,8562
00713,元大台灣高息低波,34,10,24,新光-高雄,2023-03-21,8562
8926,台汽電,38,15,23,新光-高雄,2023-03-21,8562
2610,華航,29,8,21,新光-高雄,2023-03-21,8562
1810,和成,21,0,21,新光-高雄,2023-03-21,8562
2453,凌群,135,114,21,新光-高雄,2023-03-21,8562
00642U,期元大S＆P石油,20,0,20,新光-高雄,2023-03-21,8562
00753L,中信中國50正2,40,20,20,新光-高雄,2023-03-21,8562
5015,華祺,21,1,20,新光-高雄,2023-03-21,8562
2881,富邦金,20,1,19,新光-高雄,2023-03-21,8562
1618,合機,20,1,19,新光-高雄,2023-03-21,8562
6163,華電網,48,30,18,新光-高雄,2023-03-21,8562
8358,金居,17,0,17,新光-高雄,2023-03-21,8562
8936,國統,50,33,17,新光-高雄,2023-03-21,8562
2406,國碩,33,17,16,新光-高雄,2023-03-21,8562
3264,欣銓,17,1,16,新光-高雄,2023-03-21,8562
6485,點序,17,2,15,新光-高雄,2023-03-21,8562
4306,炎洲,16,1,15,新光-高雄,2023-03-21,8562
6235,華孚,77,62,15,新光-高雄,2023-03-21,8562
6191,精成科,50,36,14,新光-高雄,2023-03-21,8562
2727,王品,21,7,14,新光-高雄,2023-03-21,8562
6531,愛普*,56,43,13,新光-高雄,2023-03-21,8562
00632R,元大台灣50反1,935,308,627,新光-高雄,2023-03-22,8562
00679B,元大美債20年,217,9,208,新光-高雄,2023-03-22,8562
2402,毅嘉,299,91,208,新光-高雄,2023-03-22,8562
00715L,期街口布蘭特正2,190,80,110,新光-高雄,2023-03-22,8562
2421,建準,125,25,100,新光-高雄,2023-03-22,8562
2812,台中銀,120,25,95,新光-高雄,2023-03-22,8562
00772B,中信高評級公司債,93,0,93,新光-高雄,2023-03-22,8562
2834,臺企銀,154,79,75,新光-高雄,2023-03-22,8562
5864,致和證,70,0,70,新光-高雄,2023-03-22,8562
3038,全台,131,63,68,新光-高雄,2023-03-22,8562
6233,旺玖,79,17,62,新光-高雄,2023-03-22,8562
3715,定穎投控,85,23,62,新光-高雄,2023-03-22,8562
2634,漢翔,64,3,61,新光-高雄,2023-03-22,8562
6266,泰詠,67,17,50,新光-高雄,2023-03-22,8562
2302,麗正,77,28,49,新光-高雄,2023-03-22,8562
2882,國泰金,64,18,46,新光-高雄,2023-03-22,8562
4961,天鈺,54,8,46,新光-高雄,2023-03-22,8562
00680L,元大美債20正2,207,165,42,新光-高雄,2023-03-22,8562
3013,晟銘電,77,36,41,新光-高雄,2023-03-22,8562
00664R,國泰臺灣加權反1,37,0,37,新光-高雄,2023-03-22,8562
1529,樂事綠能,94,59,35,新光-高雄,2023-03-22,8562
4977,眾達-KY,47,12,35,新光-高雄,2023-03-22,8562
00706L,期元大S＆P日圓正2,39,5,34,新光-高雄,2023-03-22,8562
8926,台汽電,38,4,34,新光-高雄,2023-03-22,8562
2881,富邦金,50,17,33,新光-高雄,2023-03-22,8562
00751B,元大AAA至A公司債,31,0,31,新光-高雄,2023-03-22,8562
2727,王品,70,41,29,新光-高雄,2023-03-22,8562
00642U,期元大S＆P石油,35,8,27,新光-高雄,2023-03-22,8562
2888,新光金,34,7,27,新光-高雄,2023-03-22,8562
6282,康舒,33,6,27,新光-高雄,2023-03-22,8562
6196,帆宣,30,5,25,新光-高雄,2023-03-22,8562
5353,台林,97,72,25,新光-高雄,2023-03-22,8562
00712,復華富時不動產,24,0,24,新光-高雄,2023-03-22,8562
6112,邁達特,24,1,23,新光-高雄,2023-03-22,8562
4906,正文,22,0,22,新光-高雄,2023-03-22,8562
3290,東浦,26,4,22,新光-高雄,2023-03-22,8562
3481,群創,64,43,21,新光-高雄,2023-03-22,8562
6138,茂達,78,58,20,新光-高雄,2023-03-22,8562
2313,華通,30,10,20,新光-高雄,2023-03-22,8562
6843,進典,19,0,19,新光-高雄,2023-03-22,8562
6290,良維,40,21,19,新光-高雄,2023-03-22,8562
5258,虹堡,39,21,18,新光-高雄,2023-03-22,8562
9907,統一實,30,12,18,新光-高雄,2023-03-22,8562
6472,保瑞,20,2,18,新光-高雄,2023-03-22,8562
2404,漢唐,17,0,17,新光-高雄,2023-03-22,8562
00648R,元大S＆P500反1,27,10,17,新光-高雄,2023-03-22,8562
6122,擎邦,75,58,17,新光-高雄,2023-03-22,8562
3047,訊舟,25,8,17,新光-高雄,2023-03-22,8562
1304,台聚,28,12,16,新光-高雄,2023-03-22,8562
2442,新美齊,16,1,15,新光-高雄,2023-03-22,8562
00632R,元大台灣50反1,766,222,544,新光-高雄,2023-03-23,8562
2402,毅嘉,377,216,161,新光-高雄,2023-03-23,8562
6122,擎邦,138,39,99,新光-高雄,2023-03-23,8562
3481,群創,191,93,98,新光-高雄,2023-03-23,8562
2327,國巨,93,3,90,新光-高雄,2023-03-23,8562
00679B,元大美債20年,88,5,83,新光-高雄,2023-03-23,8562
0056,元大高股息,89,6,83,新光-高雄,2023-03-23,8562
00664R,國泰臺灣加權反1,100,50,50,新光-高雄,2023-03-23,8562
00715L,期街口布蘭特正2,97,51,46,新光-高雄,2023-03-23,8562
00882,中信中國高股息,42,0,42,新光-高雄,2023-03-23,8562
2303,聯電,55,15,40,新光-高雄,2023-03-23,8562
1524,耿鼎,81,41,40,新光-高雄,2023-03-23,8562
2609,陽明,74,36,38,新光-高雄,2023-03-23,8562
00676R,富邦臺灣加權反1,35,0,35,新光-高雄,2023-03-23,8562
00720B,元大投資級公司債,50,16,34,新光-高雄,2023-03-23,8562
5009,榮剛,46,13,33,新光-高雄,2023-03-23,8562
00669R,國泰美國道瓊反1,62,30,32,新光-高雄,2023-03-23,8562
9103,美德醫療-DR,30,0,30,新光-高雄,2023-03-23,8562
8926,台汽電,38,9,29,新光-高雄,2023-03-23,8562
2867,三商壽,31,5,26,新光-高雄,2023-03-23,8562
1504,東元,157,132,25,新光-高雄,2023-03-23,8562
00712,復華富時不動產,25,0,25,新光-高雄,2023-03-23,8562
3652,精聯,69,44,25,新光-高雄,2023-03-23,8562
6142,友勁,23,0,23,新光-高雄,2023-03-23,8562
3024,憶聲,23,0,23,新光-高雄,2023-03-23,8562
2881,富邦金,27,5,22,新光-高雄,2023-03-23,8562
00651R,復華香港反1,22,0,22,新光-高雄,2023-03-23,8562
00908,富邦入息REITs+,21,0,21,新光-高雄,2023-03-23,8562
00753L,中信中國50正2,40,19,21,新光-高雄,2023-03-23,8562
2601,益航,20,0,20,新光-高雄,2023-03-23,8562
5353,台林,55,35,20,新光-高雄,2023-03-23,8562
5011,久陽,21,1,20,新光-高雄,2023-03-23,8562
6568,宏觀,20,0,20,新光-高雄,2023-03-23,8562
2014,中鴻,22,3,19,新光-高雄,2023-03-23,8562
6125,廣運,22,3,19,新光-高雄,2023-03-23,8562
2888,新光金,30,12,18,新光-高雄,2023-03-23,8562
00642U,期元大S＆P石油,20,2,18,新光-高雄,2023-03-23,8562
6266,泰詠,29,11,18,新光-高雄,2023-03-23,8562
2615,萬海,20,3,17,新光-高雄,2023-03-23,8562
3380,明泰,17,0,17,新光-高雄,2023-03-23,8562
3066,李洲,27,10,17,新光-高雄,2023-03-23,8562
3202,樺晟,17,0,17,新光-高雄,2023-03-23,8562
00888,永豐台灣ESG,17,0,17,新光-高雄,2023-03-23,8562
2388,威盛,27,11,16,新光-高雄,2023-03-23,8562
3013,晟銘電,28,12,16,新光-高雄,2023-03-23,8562
2344,華邦電,28,13,15,新光-高雄,2023-03-23,8562
4527,方土霖,19,4,15,新光-高雄,2023-03-23,8562
8289,泰藝,32,17,15,新光-高雄,2023-03-23,8562
00885,富邦越南,17,2,15,新光-高雄,2023-03-23,8562
4552,力達-KY,14,0,14,新光-高雄,2023-03-23,8562
2515,中工,702,4,698,新光-高雄,2023-03-24,8562
5483,中美晶,324,2,322,新光-高雄,2023-03-24,8562
2303,聯電,161,20,141,新光-高雄,2023-03-24,8562
2402,毅嘉,301,185,116,新光-高雄,2023-03-24,8562
6235,華孚,131,32,99,新光-高雄,2023-03-24,8562
6122,擎邦,207,113,94,新光-高雄,2023-03-24,8562
5425,台半,138,61,77,新光-高雄,2023-03-24,8562
00673R,期元大S＆P原油反1,110,50,60,新光-高雄,2023-03-24,8562
00632R,元大台灣50反1,390,331,59,新光-高雄,2023-03-24,8562
00753L,中信中國50正2,84,27,57,新光-高雄,2023-03-24,8562
5009,榮剛,72,15,57,新光-高雄,2023-03-24,8562
6606,建德工業,57,5,52,新光-高雄,2023-03-24,8562
3013,晟銘電,134,83,51,新光-高雄,2023-03-24,8562
2206,三陽工業,44,0,44,新光-高雄,2023-03-24,8562
2615,萬海,63,22,41,新光-高雄,2023-03-24,8562
00679B,元大美債20年,45,7,38,新光-高雄,2023-03-24,8562
00902,中信電池及儲能,35,0,35,新光-高雄,2023-03-24,8562
4532,瑞智,35,0,35,新光-高雄,2023-03-24,8562
1409,新纖,35,0,35,新光-高雄,2023-03-24,8562
4967,十銓,53,20,33,新光-高雄,2023-03-24,8562
3050,鈺德,32,0,32,新光-高雄,2023-03-24,8562
4960,誠美材,42,10,32,新光-高雄,2023-03-24,8562
3715,定穎投控,62,31,31,新光-高雄,2023-03-24,8562
2887E,台新戊特,30,0,30,新光-高雄,2023-03-24,8562
2388,威盛,121,92,29,新光-高雄,2023-03-24,8562
8289,泰藝,30,1,29,新光-高雄,2023-03-24,8562
9904,寶成,35,6,29,新光-高雄,2023-03-24,8562
3037,欣興,133,105,28,新光-高雄,2023-03-24,8562
8064,東捷,26,0,26,新光-高雄,2023-03-24,8562
2329,華泰,42,16,26,新光-高雄,2023-03-24,8562
3005,神基,40,15,25,新光-高雄,2023-03-24,8562
1795,美時,56,31,25,新光-高雄,2023-03-24,8562
3024,憶聲,25,0,25,新光-高雄,2023-03-24,8562
5015,華祺,26,2,24,新光-高雄,2023-03-24,8562
9914,美利達,23,0,23,新光-高雄,2023-03-24,8562
6443,元晶,58,35,23,新光-高雄,2023-03-24,8562
6213,聯茂,21,0,21,新光-高雄,2023-03-24,8562
2867,三商壽,25,4,21,新光-高雄,2023-03-24,8562
5222,全訊,45,25,20,新光-高雄,2023-03-24,8562
6112,邁達特,20,0,20,新光-高雄,2023-03-24,8562
8374,羅昇,20,0,20,新光-高雄,2023-03-24,8562
6698,旭暉應材,20,0,20,新光-高雄,2023-03-24,8562
6237,驊訊,19,0,19,新光-高雄,2023-03-24,8562
4129,聯合,19,0,19,新光-高雄,2023-03-24,8562
2471,資通,33,14,19,新光-高雄,2023-03-24,8562
2413,環科,26,7,19,新光-高雄,2023-03-24,8562
2603,長榮,34,15,19,新光-高雄,2023-03-24,8562
4104,佳醫,18,0,18,新光-高雄,2023-03-24,8562
3027,盛達,25,7,18,新光-高雄,2023-03-24,8562
3494,誠研,18,0,18,新光-高雄,2023-03-24,8562
00679B,元大美債20年,1050,39,1011,新光-高雄,2023-03-27,8562
2515,中工,230,0,230,新光-高雄,2023-03-27,8562
00650L,復華香港正2,252,50,202,新光-高雄,2023-03-27,8562
00632R,元大台灣50反1,369,214,155,新光-高雄,2023-03-27,8562
6278,台表科,121,7,114,新光-高雄,2023-03-27,8562
1605,華新,175,63,112,新光-高雄,2023-03-27,8562
6235,華孚,137,31,106,新光-高雄,2023-03-27,8562
00882,中信中國高股息,98,0,98,新光-高雄,2023-03-27,8562
3481,群創,134,47,87,新光-高雄,2023-03-27,8562
00878,國泰永續高股息,133,65,68,新光-高雄,2023-03-27,8562
2022,聚亨,67,0,67,新光-高雄,2023-03-27,8562
2317,鴻海,72,8,64,新光-高雄,2023-03-27,8562
2204,中華,58,0,58,新光-高雄,2023-03-27,8562
1609,大亞,133,85,48,新光-高雄,2023-03-27,8562
2409,友達,82,34,48,新光-高雄,2023-03-27,8562
3322,建舜電,40,0,40,新光-高雄,2023-03-27,8562
2890,永豐金,69,29,40,新光-高雄,2023-03-27,8562
2201,裕隆,41,3,38,新光-高雄,2023-03-27,8562
00922,國泰台灣領袖50,37,0,37,新光-高雄,2023-03-27,8562
2413,環科,60,23,37,新光-高雄,2023-03-27,8562
8028,昇陽半導體,51,14,37,新光-高雄,2023-03-27,8562
1314,中石化,36,0,36,新光-高雄,2023-03-27,8562
6142,友勁,64,28,36,新光-高雄,2023-03-27,8562
00706L,期元大S＆P日圓正2,35,0,35,新光-高雄,2023-03-27,8562
00673R,期元大S＆P原油反1,33,0,33,新光-高雄,2023-03-27,8562
3594,磐儀,46,13,33,新光-高雄,2023-03-27,8562
2482,連宇,137,105,32,新光-高雄,2023-03-27,8562
00712,復華富時不動產,101,70,31,新光-高雄,2023-03-27,8562
6606,建德工業,37,7,30,新光-高雄,2023-03-27,8562
4157,太景*-KY,30,0,30,新光-高雄,2023-03-27,8562
2634,漢翔,199,169,30,新光-高雄,2023-03-27,8562
1612,宏泰,32,2,30,新光-高雄,2023-03-27,8562
2352,佳世達,37,10,27,新光-高雄,2023-03-27,8562
2888,新光金,27,0,27,新光-高雄,2023-03-27,8562
8277,商丞,27,1,26,新光-高雄,2023-03-27,8562
2392,正崴,31,6,25,新光-高雄,2023-03-27,8562
3491,昇達科,37,13,24,新光-高雄,2023-03-27,8562
00665L,富邦�琤肭磪囓�2,91,67,24,新光-高雄,2023-03-27,8562
6770,力積電,25,1,24,新光-高雄,2023-03-27,8562
5608,四維航,24,1,23,新光-高雄,2023-03-27,8562
3294,英濟,23,0,23,新光-高雄,2023-03-27,8562
2462,良得電,44,22,22,新光-高雄,2023-03-27,8562
2344,華邦電,63,41,22,新光-高雄,2023-03-27,8562
3673,TPK-KY,23,2,21,新光-高雄,2023-03-27,8562
1442,名軒,21,0,21,新光-高雄,2023-03-27,8562
8105,凌巨,20,0,20,新光-高雄,2023-03-27,8562
00713,元大台灣高息低波,26,7,19,新光-高雄,2023-03-27,8562
1718,中纖,19,0,19,新光-高雄,2023-03-27,8562
5490,同亨,21,2,19,新光-高雄,2023-03-27,8562
1603,華電,21,2,19,新光-高雄,2023-03-27,8562
00679B,元大美債20年,667,39,628,新光-高雄,2023-03-28,8562
2515,中工,200,18,182,新光-高雄,2023-03-28,8562
00772B,中信高評級公司債,78,0,78,新光-高雄,2023-03-28,8562
00680L,元大美債20正2,70,0,70,新光-高雄,2023-03-28,8562
00882,中信中國高股息,73,4,69,新光-高雄,2023-03-28,8562
00751B,元大AAA至A公司債,65,0,65,新光-高雄,2023-03-28,8562
2884,玉山金,65,7,58,新光-高雄,2023-03-28,8562
00720B,元大投資級公司債,70,14,56,新光-高雄,2023-03-28,8562
3013,晟銘電,61,9,52,新光-高雄,2023-03-28,8562
006208,富邦台50,52,0,52,新光-高雄,2023-03-28,8562
2317,鴻海,69,20,49,新光-高雄,2023-03-28,8562
3037,欣興,112,65,47,新光-高雄,2023-03-28,8562
00673R,期元大S＆P原油反1,50,5,45,新光-高雄,2023-03-28,8562
00922,國泰台灣領袖50,44,0,44,新光-高雄,2023-03-28,8562
6235,華孚,84,40,44,新光-高雄,2023-03-28,8562
2890,永豐金,52,10,42,新光-高雄,2023-03-28,8562
2303,聯電,55,15,40,新光-高雄,2023-03-28,8562
2867,三商壽,40,0,40,新光-高雄,2023-03-28,8562
2929,淘帝-KY,33,0,33,新光-高雄,2023-03-28,8562
2731,雄獅,60,29,31,新光-高雄,2023-03-28,8562
1101,台泥,60,30,30,新光-高雄,2023-03-28,8562
1718,中纖,30,0,30,新光-高雄,2023-03-28,8562
2634,漢翔,62,32,30,新光-高雄,2023-03-28,8562
3576,聯合再生,29,0,29,新光-高雄,2023-03-28,8562
5483,中美晶,30,1,29,新光-高雄,2023-03-28,8562
2329,華泰,34,5,29,新光-高雄,2023-03-28,8562
1907,永豐餘,37,8,29,新光-高雄,2023-03-28,8562
00878,國泰永續高股息,121,93,28,新光-高雄,2023-03-28,8562
00893,國泰智能電動車,36,8,28,新光-高雄,2023-03-28,8562
1708,東鹼,42,14,28,新光-高雄,2023-03-28,8562
4967,十銓,34,8,26,新光-高雄,2023-03-28,8562
00637L,元大滬深300正2,44,20,24,新光-高雄,2023-03-28,8562
3296,勝德,33,9,24,新光-高雄,2023-03-28,8562
6288,聯嘉,37,14,23,新光-高雄,2023-03-28,8562
4979,華星光,95,73,22,新光-高雄,2023-03-28,8562
3706,神達,22,0,22,新光-高雄,2023-03-28,8562
6160,欣技,27,5,22,新光-高雄,2023-03-28,8562
6112,邁達特,21,0,21,新光-高雄,2023-03-28,8562
1108,幸福,21,0,21,新光-高雄,2023-03-28,8562
2206,三陽工業,23,3,20,新光-高雄,2023-03-28,8562
2014,中鴻,21,1,20,新光-高雄,2023-03-28,8562
6244,茂迪,51,32,19,新光-高雄,2023-03-28,8562
5490,同亨,20,1,19,新光-高雄,2023-03-28,8562
4527,方土霖,19,0,19,新光-高雄,2023-03-28,8562
00888,永豐台灣ESG,17,0,17,新光-高雄,2023-03-28,8562
2352,佳世達,17,1,16,新光-高雄,2023-03-28,8562
3264,欣銓,30,14,16,新光-高雄,2023-03-28,8562
2409,友達,44,29,15,新光-高雄,2023-03-28,8562
9921,巨大,19,4,15,新光-高雄,2023-03-28,8562
2881,富邦金,19,4,15,新光-高雄,2023-03-28,8562
00632R,元大台灣50反1,335,150,185,新光-高雄,2023-03-29,8562
2515,中工,159,0,159,新光-高雄,2023-03-29,8562
00665L,富邦�琤肭磪囓�2,180,64,116,新光-高雄,2023-03-29,8562
5864,致和證,110,0,110,新光-高雄,2023-03-29,8562
00673R,期元大S＆P原油反1,106,0,106,新光-高雄,2023-03-29,8562
6589,台康生技,116,19,97,新光-高雄,2023-03-29,8562
3224,三顧,101,4,97,新光-高雄,2023-03-29,8562
6116,彩晶,105,10,95,新光-高雄,2023-03-29,8562
00679B,元大美債20年,66,3,63,新光-高雄,2023-03-29,8562
2890,永豐金,66,4,62,新光-高雄,2023-03-29,8562
2402,毅嘉,64,11,53,新光-高雄,2023-03-29,8562
3715,定穎投控,540,489,51,新光-高雄,2023-03-29,8562
00706L,期元大S＆P日圓正2,49,0,49,新光-高雄,2023-03-29,8562
00773B,中信優先金融債,41,0,41,新光-高雄,2023-03-29,8562
2867,三商壽,52,14,38,新光-高雄,2023-03-29,8562
2344,華邦電,63,26,37,新光-高雄,2023-03-29,8562
00720B,元大投資級公司債,37,4,33,新光-高雄,2023-03-29,8562
2371,大同,50,18,32,新光-高雄,2023-03-29,8562
00751B,元大AAA至A公司債,34,2,32,新光-高雄,2023-03-29,8562
2331,精英,59,28,31,新光-高雄,2023-03-29,8562
2426,鼎元,38,9,29,新光-高雄,2023-03-29,8562
00882,中信中國高股息,80,52,28,新光-高雄,2023-03-29,8562
00922,國泰台灣領袖50,32,5,27,新光-高雄,2023-03-29,8562
6770,力積電,27,2,25,新光-高雄,2023-03-29,8562
3499,環天科,29,4,25,新光-高雄,2023-03-29,8562
2303,聯電,64,41,23,新光-高雄,2023-03-29,8562
2885,元大金,25,2,23,新光-高雄,2023-03-29,8562
5258,虹堡,45,23,22,新光-高雄,2023-03-29,8562
3017,奇鋐,139,118,21,新光-高雄,2023-03-29,8562
3706,神達,21,0,21,新光-高雄,2023-03-29,8562
00687B,國泰20年美債,20,0,20,新光-高雄,2023-03-29,8562
5871,中租-KY,26,7,19,新光-高雄,2023-03-29,8562
3570,大塚,20,1,19,新光-高雄,2023-03-29,8562
3013,晟銘電,26,7,19,新光-高雄,2023-03-29,8562
00900,富邦特選高股息30,21,3,18,新光-高雄,2023-03-29,8562
2038,海光,19,2,17,新光-高雄,2023-03-29,8562
3105,穩懋,27,10,17,新光-高雄,2023-03-29,8562
00891,中信關鍵半導體,16,0,16,新光-高雄,2023-03-29,8562
3035,智原,34,18,16,新光-高雄,2023-03-29,8562
00712,復華富時不動產,16,1,15,新光-高雄,2023-03-29,8562
2845,遠東銀,15,0,15,新光-高雄,2023-03-29,8562
8478,東哥遊艇,15,0,15,新光-高雄,2023-03-29,8562
3163,波若威,15,0,15,新光-高雄,2023-03-29,8562
2337,旺宏,17,2,15,新光-高雄,2023-03-29,8562
8926,台汽電,26,11,15,新光-高雄,2023-03-29,8562
2408,南亞科,29,15,14,新光-高雄,2023-03-29,8562
00772B,中信高評級公司債,33,19,14,新光-高雄,2023-03-29,8562
2312,金寶,13,0,13,新光-高雄,2023-03-29,8562
8930,青鋼,16,3,13,新光-高雄,2023-03-29,8562
00631L,元大台灣50正2,17,4,13,新光-高雄,2023-03-29,8562
00632R,元大台灣50反1,567,302,265,新光-高雄,2023-03-30,8562
2610,華航,141,10,131,新光-高雄,2023-03-30,8562
2890,永豐金,103,0,103,新光-高雄,2023-03-30,8562
2897,王道銀行,108,7,101,新光-高雄,2023-03-30,8562
6133,金橋,147,81,66,新光-高雄,2023-03-30,8562
3231,緯創,225,162,63,新光-高雄,2023-03-30,8562
00680L,元大美債20正2,51,0,51,新光-高雄,2023-03-30,8562
2022,聚亨,50,0,50,新光-高雄,2023-03-30,8562
00712,復華富時不動產,49,0,49,新光-高雄,2023-03-30,8562
00665L,富邦�琤肭磪囓�2,207,170,37,新光-高雄,2023-03-30,8562
00715L,期街口布蘭特正2,240,208,32,新光-高雄,2023-03-30,8562
1815,富喬,32,0,32,新光-高雄,2023-03-30,8562
00679B,元大美債20年,48,17,31,新光-高雄,2023-03-30,8562
2634,漢翔,44,14,30,新光-高雄,2023-03-30,8562
2342,茂矽,36,6,30,新光-高雄,2023-03-30,8562
6799,來頡,35,6,29,新光-高雄,2023-03-30,8562
00882,中信中國高股息,27,0,27,新光-高雄,2023-03-30,8562
6112,邁達特,25,0,25,新光-高雄,2023-03-30,8562
6138,茂達,37,12,25,新光-高雄,2023-03-30,8562
3701,大眾控,33,8,25,新光-高雄,2023-03-30,8562
1504,東元,125,100,25,新光-高雄,2023-03-30,8562
2359,所羅門,30,5,25,新光-高雄,2023-03-30,8562
1609,大亞,42,18,24,新光-高雄,2023-03-30,8562
00753L,中信中國50正2,31,9,22,新光-高雄,2023-03-30,8562
2609,陽明,45,23,22,新光-高雄,2023-03-30,8562
8926,台汽電,25,5,20,新光-高雄,2023-03-30,8562
6167,久正,20,0,20,新光-高雄,2023-03-30,8562
5351,鈺創,49,29,20,新光-高雄,2023-03-30,8562
2887,台新金,40,21,19,新光-高雄,2023-03-30,8562
00706L,期元大S＆P日圓正2,19,0,19,新光-高雄,2023-03-30,8562
00720B,元大投資級公司債,30,12,18,新光-高雄,2023-03-30,8562
2312,金寶,18,0,18,新光-高雄,2023-03-30,8562
00637L,元大滬深300正2,31,13,18,新光-高雄,2023-03-30,8562
1795,美時,101,83,18,新光-高雄,2023-03-30,8562
3338,泰碩,20,4,16,新光-高雄,2023-03-30,8562
3714,富采,17,2,15,新光-高雄,2023-03-30,8562
00676R,富邦臺灣加權反1,15,0,15,新光-高雄,2023-03-30,8562
6485,點序,38,23,15,新光-高雄,2023-03-30,8562
2618,長榮航,36,22,14,新光-高雄,2023-03-30,8562
5425,台半,34,20,14,新光-高雄,2023-03-30,8562
5243,乙盛-KY,18,4,14,新光-高雄,2023-03-30,8562
6788,華景電,14,1,13,新光-高雄,2023-03-30,8562
5009,榮剛,33,20,13,新光-高雄,2023-03-30,8562
2889,國票金,22,10,12,新光-高雄,2023-03-30,8562
2915,潤泰全,12,0,12,新光-高雄,2023-03-30,8562
3078,僑威,21,9,12,新光-高雄,2023-03-30,8562
3062,建漢,12,0,12,新光-高雄,2023-03-30,8562
5203,訊連,12,0,12,新光-高雄,2023-03-30,8562
1760,寶齡富錦,31,19,12,新光-高雄,2023-03-30,8562
3035,智原,45,33,12,新光-高雄,2023-03-30,8562
00632R,元大台灣50反1,415,167,248,新光-高雄,2023-03-31,8562
00673R,期元大S＆P原油反1,244,5,239,新光-高雄,2023-03-31,8562
2515,中工,206,2,204,新光-高雄,2023-03-31,8562
3035,智原,123,21,102,新光-高雄,2023-03-31,8562
00712,復華富時不動產,96,0,96,新光-高雄,2023-03-31,8562
8070,長華*,62,2,60,新光-高雄,2023-03-31,8562
1605,華新,103,44,59,新光-高雄,2023-03-31,8562
2022,聚亨,54,0,54,新光-高雄,2023-03-31,8562
00679B,元大美債20年,64,14,50,新光-高雄,2023-03-31,8562
00664R,國泰臺灣加權反1,50,0,50,新光-高雄,2023-03-31,8562
2618,長榮航,112,67,45,新光-高雄,2023-03-31,8562
3006,晶豪科,103,59,44,新光-高雄,2023-03-31,8562
2457,飛宏,101,63,38,新光-高雄,2023-03-31,8562
2634,漢翔,42,7,35,新光-高雄,2023-03-31,8562
1560,中砂,35,3,32,新光-高雄,2023-03-31,8562
5213,亞昕,42,10,32,新光-高雄,2023-03-31,8562
00680L,元大美債20正2,30,0,30,新光-高雄,2023-03-31,8562
00922,國泰台灣領袖50,31,3,28,新光-高雄,2023-03-31,8562
1504,東元,58,31,27,新光-高雄,2023-03-31,8562
8050,廣積,72,48,24,新光-高雄,2023-03-31,8562
2834,臺企銀,125,101,24,新光-高雄,2023-03-31,8562
5309,系統電,122,99,23,新光-高雄,2023-03-31,8562
2812,台中銀,155,132,23,新光-高雄,2023-03-31,8562
1611,中電,56,34,22,新光-高雄,2023-03-31,8562
9904,寶成,25,3,22,新光-高雄,2023-03-31,8562
2201,裕隆,32,11,21,新光-高雄,2023-03-31,8562
8093,保銳,20,0,20,新光-高雄,2023-03-31,8562
3580,友威科,19,0,19,新光-高雄,2023-03-31,8562
1603,華電,19,0,19,新光-高雄,2023-03-31,8562
6443,元晶,30,12,18,新光-高雄,2023-03-31,8562
5009,榮剛,32,14,18,新光-高雄,2023-03-31,8562
3540,曜越,24,7,17,新光-高雄,2023-03-31,8562
4971,IET-KY,19,2,17,新光-高雄,2023-03-31,8562
1513,中興電,46,30,16,新光-高雄,2023-03-31,8562
4979,華星光,31,15,16,新光-高雄,2023-03-31,8562
6133,金橋,62,46,16,新光-高雄,2023-03-31,8562
2889,國票金,15,0,15,新光-高雄,2023-03-31,8562
00772B,中信高評級公司債,35,21,14,新光-高雄,2023-03-31,8562
2609,陽明,44,30,14,新光-高雄,2023-03-31,8562
3711,日月光投控,18,4,14,新光-高雄,2023-03-31,8562
3714,富采,22,9,13,新光-高雄,2023-03-31,8562
6288,聯嘉,20,7,13,新光-高雄,2023-03-31,8562
2610,華航,39,27,12,新光-高雄,2023-03-31,8562
1524,耿鼎,12,0,12,新光-高雄,2023-03-31,8562
5301,寶得利,12,0,12,新光-高雄,2023-03-31,8562
00706L,期元大S＆P日圓正2,42,30,12,新光-高雄,2023-03-31,8562
3062,建漢,12,0,12,新光-高雄,2023-03-31,8562
4919,新唐,17,6,11,新光-高雄,2023-03-31,8562
2915,潤泰全,11,0,11,新光-高雄,2023-03-31,8562
2498,宏達電,23,12,11,新光-高雄,2023-03-31,8562
00673R,期元大S＆P原油反1,1112,12,1100,新光-高雄,2023-04-06,8562
00712,復華富時不動產,147,3,144,新光-高雄,2023-04-06,8562
2618,長榮航,142,1,141,新光-高雄,2023-04-06,8562
00637L,元大滬深300正2,133,9,124,新光-高雄,2023-04-06,8562
2002,中鋼,123,1,122,新光-高雄,2023-04-06,8562
00882,中信中國高股息,120,1,119,新光-高雄,2023-04-06,8562
2897,王道銀行,123,10,113,新光-高雄,2023-04-06,8562
3006,晶豪科,96,8,88,新光-高雄,2023-04-06,8562
2344,華邦電,118,34,84,新光-高雄,2023-04-06,8562
2884,玉山金,98,22,76,新光-高雄,2023-04-06,8562
00902,中信電池及儲能,84,8,76,新光-高雄,2023-04-06,8562
5309,系統電,112,41,71,新光-高雄,2023-04-06,8562
1609,大亞,85,16,69,新光-高雄,2023-04-06,8562
3227,原相,65,0,65,新光-高雄,2023-04-06,8562
2317,鴻海,86,21,65,新光-高雄,2023-04-06,8562
00893,國泰智能電動車,58,0,58,新光-高雄,2023-04-06,8562
8069,元太,107,52,55,新光-高雄,2023-04-06,8562
00753L,中信中國50正2,67,13,54,新光-高雄,2023-04-06,8562
3296,勝德,48,0,48,新光-高雄,2023-04-06,8562
3211,順達,52,5,47,新光-高雄,2023-04-06,8562
5534,長虹,40,0,40,新光-高雄,2023-04-06,8562
2402,毅嘉,65,28,37,新光-高雄,2023-04-06,8562
3491,昇達科,49,15,34,新光-高雄,2023-04-06,8562
6223,旺矽,32,0,32,新光-高雄,2023-04-06,8562
2461,光群雷,28,0,28,新光-高雄,2023-04-06,8562
3209,全科,31,7,24,新光-高雄,2023-04-06,8562
2603,長榮,32,8,24,新光-高雄,2023-04-06,8562
6244,茂迪,25,2,23,新光-高雄,2023-04-06,8562
8064,東捷,21,0,21,新光-高雄,2023-04-06,8562
2460,建通,20,0,20,新光-高雄,2023-04-06,8562
6177,達麗,20,0,20,新光-高雄,2023-04-06,8562
3576,聯合再生,21,1,20,新光-高雄,2023-04-06,8562
4967,十銓,72,52,20,新光-高雄,2023-04-06,8562
00922,國泰台灣領袖50,19,0,19,新光-高雄,2023-04-06,8562
2388,威盛,31,12,19,新光-高雄,2023-04-06,8562
6548,長科*,49,30,19,新光-高雄,2023-04-06,8562
00669R,國泰美國道瓊反1,20,3,17,新光-高雄,2023-04-06,8562
2609,陽明,37,21,16,新光-高雄,2023-04-06,8562
6235,華孚,225,209,16,新光-高雄,2023-04-06,8562
2748,雲品,22,6,16,新光-高雄,2023-04-06,8562
9904,寶成,20,4,16,新光-高雄,2023-04-06,8562
2812,台中銀,44,28,16,新光-高雄,2023-04-06,8562
2204,中華,18,2,16,新光-高雄,2023-04-06,8562
00713,元大台灣高息低波,16,0,16,新光-高雄,2023-04-06,8562
3037,欣興,31,16,15,新光-高雄,2023-04-06,8562
1708,東鹼,16,1,15,新光-高雄,2023-04-06,8562
5236,凌陽創新,16,1,15,新光-高雄,2023-04-06,8562
3035,智原,52,37,15,新光-高雄,2023-04-06,8562
2454,聯發科,15,0,15,新光-高雄,2023-04-06,8562
3711,日月光投控,18,3,15,新光-高雄,2023-04-06,8562
00738U,期元大道瓊白銀,128,1,127,新光-高雄,2023-04-07,8562
3481,群創,205,97,108,新光-高雄,2023-04-07,8562
00912,中信臺灣智慧50,106,0,106,新光-高雄,2023-04-07,8562
2867,三商壽,108,5,103,新光-高雄,2023-04-07,8562
2897,王道銀行,100,0,100,新光-高雄,2023-04-07,8562
00673R,期元大S＆P原油反1,85,3,82,新光-高雄,2023-04-07,8562
5864,致和證,79,4,75,新光-高雄,2023-04-07,8562
3227,原相,67,0,67,新光-高雄,2023-04-07,8562
00712,復華富時不動產,89,26,63,新光-高雄,2023-04-07,8562
8415,大國鋼,60,0,60,新光-高雄,2023-04-07,8562
3479,安勤,68,10,58,新光-高雄,2023-04-07,8562
2634,漢翔,85,29,56,新光-高雄,2023-04-07,8562
5009,榮剛,59,4,55,新光-高雄,2023-04-07,8562
4968,立積,91,38,53,新光-高雄,2023-04-07,8562
3231,緯創,57,10,47,新光-高雄,2023-04-07,8562
6138,茂達,44,0,44,新光-高雄,2023-04-07,8562
00902,中信電池及儲能,51,8,43,新光-高雄,2023-04-07,8562
00676R,富邦臺灣加權反1,42,0,42,新光-高雄,2023-04-07,8562
4532,瑞智,40,0,40,新光-高雄,2023-04-07,8562
6416,瑞祺電通,39,5,34,新光-高雄,2023-04-07,8562
4306,炎洲,39,6,33,新光-高雄,2023-04-07,8562
2482,連宇,42,9,33,新光-高雄,2023-04-07,8562
1584,精剛,47,16,31,新光-高雄,2023-04-07,8562
00772B,中信高評級公司債,55,25,30,新光-高雄,2023-04-07,8562
3046,建��,29,1,28,新光-高雄,2023-04-07,8562
4541,晟田,36,10,26,新光-高雄,2023-04-07,8562
4977,眾達-KY,44,19,25,新光-高雄,2023-04-07,8562
00922,國泰台灣領袖50,27,3,24,新光-高雄,2023-04-07,8562
4943,康控-KY,24,0,24,新光-高雄,2023-04-07,8562
2317,鴻海,39,16,23,新光-高雄,2023-04-07,8562
1815,富喬,21,0,21,新光-高雄,2023-04-07,8562
6274,台燿,18,1,17,新光-高雄,2023-04-07,8562
8064,東捷,22,6,16,新光-高雄,2023-04-07,8562
2887,台新金,17,1,16,新光-高雄,2023-04-07,8562
2538,基泰,16,0,16,新光-高雄,2023-04-07,8562
3062,建漢,22,7,15,新光-高雄,2023-04-07,8562
6156,松上,24,9,15,新光-高雄,2023-04-07,8562
2025,千興,15,0,15,新光-高雄,2023-04-07,8562
6160,欣技,15,0,15,新光-高雄,2023-04-07,8562
2495,普安,22,7,15,新光-高雄,2023-04-07,8562
8046,南電,24,10,14,新光-高雄,2023-04-07,8562
00753L,中信中國50正2,27,13,14,新光-高雄,2023-04-07,8562
3363,上詮,20,6,14,新光-高雄,2023-04-07,8562
3056,富華新,22,8,14,新光-高雄,2023-04-07,8562
1308,亞聚,16,2,14,新光-高雄,2023-04-07,8562
2460,建通,13,0,13,新光-高雄,2023-04-07,8562
3004,豐達科,18,5,13,新光-高雄,2023-04-07,8562
2851,中再保,13,0,13,新光-高雄,2023-04-07,8562
2748,雲品,16,4,12,新光-高雄,2023-04-07,8562
3038,全台,40,28,12,新光-高雄,2023-04-07,8562
2344,華邦電,443,115,328,新光-高雄,2023-04-10,8562
00673R,期元大S＆P原油反1,221,0,221,新光-高雄,2023-04-10,8562
00632R,元大台灣50反1,244,120,124,新光-高雄,2023-04-10,8562
00679B,元大美債20年,123,12,111,新光-高雄,2023-04-10,8562
2834,臺企銀,91,1,90,新光-高雄,2023-04-10,8562
3363,上詮,91,4,87,新光-高雄,2023-04-10,8562
00772B,中信高評級公司債,92,21,71,新光-高雄,2023-04-10,8562
2409,友達,69,0,69,新光-高雄,2023-04-10,8562
2888,新光金,94,25,69,新光-高雄,2023-04-10,8562
5211,蒙恬,68,2,66,新光-高雄,2023-04-10,8562
6285,啟��,83,19,64,新光-高雄,2023-04-10,8562
00720B,元大投資級公司債,89,31,58,新光-高雄,2023-04-10,8562
3481,群創,68,10,58,新光-高雄,2023-04-10,8562
2897,王道銀行,56,0,56,新光-高雄,2023-04-10,8562
00725B,國泰投資級公司債,56,1,55,新光-高雄,2023-04-10,8562
00712,復華富時不動產,53,1,52,新光-高雄,2023-04-10,8562
2812,台中銀,72,24,48,新光-高雄,2023-04-10,8562
8046,南電,59,15,44,新光-高雄,2023-04-10,8562
5864,致和證,43,0,43,新光-高雄,2023-04-10,8562
5465,富驊,135,93,42,新光-高雄,2023-04-10,8562
2408,南亞科,47,6,41,新光-高雄,2023-04-10,8562
00882,中信中國高股息,42,1,41,新光-高雄,2023-04-10,8562
4306,炎洲,38,0,38,新光-高雄,2023-04-10,8562
00680L,元大美債20正2,36,0,36,新光-高雄,2023-04-10,8562
2887,台新金,42,8,34,新光-高雄,2023-04-10,8562
4207,環泰,36,4,32,新光-高雄,2023-04-10,8562
6753,龍德造船,36,5,31,新光-高雄,2023-04-10,8562
00637L,元大滬深300正2,47,16,31,新光-高雄,2023-04-10,8562
5452,佶優,30,0,30,新光-高雄,2023-04-10,8562
00888,永豐台灣ESG,30,0,30,新光-高雄,2023-04-10,8562
6235,華孚,88,60,28,新光-高雄,2023-04-10,8562
00706L,期元大S＆P日圓正2,28,0,28,新光-高雄,2023-04-10,8562
2208,台船,69,42,27,新光-高雄,2023-04-10,8562
1609,大亞,112,85,27,新光-高雄,2023-04-10,8562
3711,日月光投控,34,9,25,新光-高雄,2023-04-10,8562
6770,力積電,28,2,26,新光-高雄,2023-04-10,8562
2317,鴻海,30,4,26,新光-高雄,2023-04-10,8562
2867,三商壽,38,13,25,新光-高雄,2023-04-10,8562
1605,華新,39,15,24,新光-高雄,2023-04-10,8562
9907,統一實,36,15,21,新光-高雄,2023-04-10,8562
9945,潤泰新,24,4,20,新光-高雄,2023-04-10,8562
3499,環天科,20,0,20,新光-高雄,2023-04-10,8562
9958,世紀鋼,52,32,20,新光-高雄,2023-04-10,8562
8415,大國鋼,19,0,19,新光-高雄,2023-04-10,8562
8374,羅昇,20,1,19,新光-高雄,2023-04-10,8562
2603,長榮,80,62,18,新光-高雄,2023-04-10,8562
4967,十銓,39,21,18,新光-高雄,2023-04-10,8562
8183,精星,19,1,18,新光-高雄,2023-04-10,8562
4128,中天,32,15,17,新光-高雄,2023-04-10,8562
4977,眾達-KY,27,10,17,新光-高雄,2023-04-10,8562
00632R,元大台灣50反1,552,100,452,新光-高雄,2023-04-11,8562
00664R,國泰臺灣加權反1,293,0,293,新光-高雄,2023-04-11,8562
00912,中信臺灣智慧50,226,100,126,新光-高雄,2023-04-11,8562
00673R,期元大S＆P原油反1,127,12,115,新光-高雄,2023-04-11,8562
00679B,元大美債20年,99,14,85,新光-高雄,2023-04-11,8562
5864,致和證,83,0,83,新光-高雄,2023-04-11,8562
2317,鴻海,90,9,81,新光-高雄,2023-04-11,8562
00878,國泰永續高股息,219,143,76,新光-高雄,2023-04-11,8562
3231,緯創,143,74,69,新光-高雄,2023-04-11,8562
2881,富邦金,66,0,66,新光-高雄,2023-04-11,8562
2402,毅嘉,67,5,62,新光-高雄,2023-04-11,8562
2812,台中銀,116,63,53,新光-高雄,2023-04-11,8562
2867,三商壽,92,40,52,新光-高雄,2023-04-11,8562
2313,華通,63,11,52,新光-高雄,2023-04-11,8562
00713,元大台灣高息低波,60,12,48,新光-高雄,2023-04-11,8562
8374,羅昇,46,0,46,新光-高雄,2023-04-11,8562
2461,光群雷,45,0,45,新光-高雄,2023-04-11,8562
2851,中再保,50,7,43,新光-高雄,2023-04-11,8562
3033,威健,45,3,42,新光-高雄,2023-04-11,8562
00712,復華富時不動產,49,11,38,新光-高雄,2023-04-11,8562
6217,中探針,41,3,38,新光-高雄,2023-04-11,8562
00706L,期元大S＆P日圓正2,37,0,37,新光-高雄,2023-04-11,8562
6112,邁達特,41,5,36,新光-高雄,2023-04-11,8562
2303,聯電,49,17,32,新光-高雄,2023-04-11,8562
3059,華晶科,32,1,31,新光-高雄,2023-04-11,8562
2002,中鋼,32,1,31,新光-高雄,2023-04-11,8562
1609,大亞,72,43,29,新光-高雄,2023-04-11,8562
6578,達邦蛋白,57,28,29,新光-高雄,2023-04-11,8562
00772B,中信高評級公司債,29,0,29,新光-高雄,2023-04-11,8562
4968,立積,58,32,26,新光-高雄,2023-04-11,8562
6285,啟��,35,10,25,新光-高雄,2023-04-11,8562
00720B,元大投資級公司債,22,0,22,新光-高雄,2023-04-11,8562
6806,森崴能源,54,32,22,新光-高雄,2023-04-11,8562
00637L,元大滬深300正2,84,62,22,新光-高雄,2023-04-11,8562
4541,晟田,22,0,22,新光-高雄,2023-04-11,8562
1618,合機,38,17,21,新光-高雄,2023-04-11,8562
1532,勤美,22,1,21,新光-高雄,2023-04-11,8562
1514,亞力,58,37,21,新光-高雄,2023-04-11,8562
2109,華豐,20,0,20,新光-高雄,2023-04-11,8562
2547,日勝生,20,0,20,新光-高雄,2023-04-11,8562
00853B,統一美債10年Aa-,20,0,20,新光-高雄,2023-04-11,8562
3046,建��,87,67,20,新光-高雄,2023-04-11,8562
6443,元晶,45,25,20,新光-高雄,2023-04-11,8562
2353,宏��,27,8,19,新光-高雄,2023-04-11,8562
2312,金寶,29,11,18,新光-高雄,2023-04-11,8562
2409,友達,35,17,18,新光-高雄,2023-04-11,8562
6233,旺玖,29,11,18,新光-高雄,2023-04-11,8562
2201,裕隆,36,18,18,新光-高雄,2023-04-11,8562
6245,立端,41,23,18,新光-高雄,2023-04-11,8562
00888,永豐台灣ESG,18,1,17,新光-高雄,2023-04-11,8562
00912,中信臺灣智慧50,402,0,402,新光-高雄,2023-04-12,8562
00673R,期元大S＆P原油反1,206,11,195,新光-高雄,2023-04-12,8562
4967,十銓,211,53,158,新光-高雄,2023-04-12,8562
3481,群創,227,96,131,新光-高雄,2023-04-12,8562
3038,全台,118,3,115,新光-高雄,2023-04-12,8562
2022,聚亨,81,0,81,新光-高雄,2023-04-12,8562
00679B,元大美債20年,81,0,81,新光-高雄,2023-04-12,8562
00637L,元大滬深300正2,105,34,71,新光-高雄,2023-04-12,8562
2618,長榮航,84,14,70,新光-高雄,2023-04-12,8562
2834,臺企銀,91,23,68,新光-高雄,2023-04-12,8562
00706L,期元大S＆P日圓正2,65,0,65,新光-高雄,2023-04-12,8562
2364,倫飛,71,10,61,新光-高雄,2023-04-12,8562
3454,晶睿,61,3,58,新光-高雄,2023-04-12,8562
2515,中工,95,45,50,新光-高雄,2023-04-12,8562
00720B,元大投資級公司債,47,2,45,新光-高雄,2023-04-12,8562
2409,友達,75,32,43,新光-高雄,2023-04-12,8562
00676R,富邦臺灣加權反1,40,0,40,新光-高雄,2023-04-12,8562
2344,華邦電,181,144,37,新光-高雄,2023-04-12,8562
2330,台積電,44,7,37,新光-高雄,2023-04-12,8562
4960,誠美材,39,2,37,新光-高雄,2023-04-12,8562
9907,統一實,35,0,35,新光-高雄,2023-04-12,8562
2497,怡利電,32,0,32,新光-高雄,2023-04-12,8562
00712,復華富時不動產,56,25,31,新光-高雄,2023-04-12,8562
2489,瑞軒,30,0,30,新光-高雄,2023-04-12,8562
5443,均豪,29,0,29,新光-高雄,2023-04-12,8562
3479,安勤,44,15,29,新光-高雄,2023-04-12,8562
5475,德宏,27,0,27,新光-高雄,2023-04-12,8562
3664,安瑞-KY,27,0,27,新光-高雄,2023-04-12,8562
5701,劍湖山,26,0,26,新光-高雄,2023-04-12,8562
3056,富華新,46,20,26,新光-高雄,2023-04-12,8562
2461,光群雷,23,0,23,新光-高雄,2023-04-12,8562
8069,元太,30,8,22,新光-高雄,2023-04-12,8562
5425,台半,41,20,21,新光-高雄,2023-04-12,8562
5864,致和證,21,0,21,新光-高雄,2023-04-12,8562
3564,其陽,21,0,21,新光-高雄,2023-04-12,8562
6509,聚和,21,1,20,新光-高雄,2023-04-12,8562
2427,三商電,40,20,20,新光-高雄,2023-04-12,8562
00896,中信綠能及電動車,20,0,20,新光-高雄,2023-04-12,8562
2313,華通,39,20,19,新光-高雄,2023-04-12,8562
9958,世紀鋼,100,81,19,新光-高雄,2023-04-12,8562
00893,國泰智能電動車,19,1,18,新光-高雄,2023-04-12,8562
4114,健喬,89,71,18,新光-高雄,2023-04-12,8562
6288,聯嘉,21,3,18,新光-高雄,2023-04-12,8562
2402,毅嘉,44,27,17,新光-高雄,2023-04-12,8562
2371,大同,17,0,17,新光-高雄,2023-04-12,8562
2455,全新,19,3,16,新光-高雄,2023-04-12,8562
00923,群益台ESG低碳50,16,0,16,新光-高雄,2023-04-12,8562
0050,元大台灣50,15,0,15,新光-高雄,2023-04-12,8562
6477,安集,55,39,16,新光-高雄,2023-04-12,8562
5488,松普,20,5,15,新光-高雄,2023-04-12,8562
00632R,元大台灣50反1,2017,95,1922,新光-高雄,2023-04-13,8562
00712,復華富時不動產,199,0,199,新光-高雄,2023-04-13,8562
00673R,期元大S＆P原油反1,331,173,158,新光-高雄,2023-04-13,8562
00642U,期元大S＆P石油,174,17,157,新光-高雄,2023-04-13,8562
6167,久正,144,0,144,新光-高雄,2023-04-13,8562
00664R,國泰臺灣加權反1,140,0,140,新光-高雄,2023-04-13,8562
5009,榮剛,220,90,130,新光-高雄,2023-04-13,8562
3711,日月光投控,124,3,121,新光-高雄,2023-04-13,8562
00679B,元大美債20年,96,11,85,新光-高雄,2023-04-13,8562
2834,臺企銀,86,2,84,新光-高雄,2023-04-13,8562
00720B,元大投資級公司債,77,0,77,新光-高雄,2023-04-13,8562
8110,華東,93,20,73,新光-高雄,2023-04-13,8562
2515,中工,326,256,70,新光-高雄,2023-04-13,8562
3056,富華新,65,7,58,新光-高雄,2023-04-13,8562
3231,緯創,90,32,58,新光-高雄,2023-04-13,8562
0056,元大高股息,77,24,53,新光-高雄,2023-04-13,8562
3078,僑威,66,14,52,新光-高雄,2023-04-13,8562
5512,力麒,54,2,52,新光-高雄,2023-04-13,8562
8105,凌巨,70,24,46,新光-高雄,2023-04-13,8562
2634,漢翔,167,121,46,新光-高雄,2023-04-13,8562
4744,皇將,52,7,45,新光-高雄,2023-04-13,8562
2344,華邦電,114,69,45,新光-高雄,2023-04-13,8562
1802,台玻,43,1,42,新光-高雄,2023-04-13,8562
6244,茂迪,57,16,41,新光-高雄,2023-04-13,8562
00888,永豐台灣ESG,40,0,40,新光-高雄,2023-04-13,8562
1513,中興電,104,65,39,新光-高雄,2023-04-13,8562
9958,世紀鋼,62,24,38,新光-高雄,2023-04-13,8562
6235,華孚,163,125,38,新光-高雄,2023-04-13,8562
2330,台積電,49,13,36,新光-高雄,2023-04-13,8562
2832,台產,36,0,36,新光-高雄,2023-04-13,8562
00878,國泰永續高股息,92,57,35,新光-高雄,2023-04-13,8562
00637L,元大滬深300正2,137,102,35,新光-高雄,2023-04-13,8562
2498,宏達電,54,19,35,新光-高雄,2023-04-13,8562
6829,千附精密,59,25,34,新光-高雄,2023-04-13,8562
1609,大亞,179,145,34,新光-高雄,2023-04-13,8562
1504,東元,91,58,33,新光-高雄,2023-04-13,8562
1503,士電,75,47,28,新光-高雄,2023-04-13,8562
2408,南亞科,32,4,28,新光-高雄,2023-04-13,8562
00665L,富邦�琤肭磪囓�2,36,8,28,新光-高雄,2023-04-13,8562
1611,中電,50,22,28,新光-高雄,2023-04-13,8562
00751B,元大AAA至A公司債,27,0,27,新光-高雄,2023-04-13,8562
4527,方土霖,30,3,27,新光-高雄,2023-04-13,8562
6139,亞翔,26,0,26,新光-高雄,2023-04-13,8562
6180,橘子,27,2,25,新光-高雄,2023-04-13,8562
2457,飛宏,121,96,25,新光-高雄,2023-04-13,8562
6118,建達,37,12,25,新光-高雄,2023-04-13,8562
5263,智崴,25,0,25,新光-高雄,2023-04-13,8562
2495,普安,43,19,24,新光-高雄,2023-04-13,8562
8088,品安,32,8,24,新光-高雄,2023-04-13,8562
8358,金居,24,1,23,新光-高雄,2023-04-13,8562
00632R,元大台灣50反1,1129,274,855,新光-高雄,2023-04-14,8562
2885,元大金,269,7,262,新光-高雄,2023-04-14,8562
00679B,元大美債20年,216,1,215,新光-高雄,2023-04-14,8562
2201,裕隆,246,36,210,新光-高雄,2023-04-14,8562
2634,漢翔,463,303,160,新光-高雄,2023-04-14,8562
00878,國泰永續高股息,218,79,139,新光-高雄,2023-04-14,8562
2208,台船,230,111,119,新光-高雄,2023-04-14,8562
00720B,元大投資級公司債,111,3,108,新光-高雄,2023-04-14,8562
00712,復華富時不動產,102,0,102,新光-高雄,2023-04-14,8562
2834,臺企銀,119,17,102,新光-高雄,2023-04-14,8562
2884,玉山金,120,23,97,新光-高雄,2023-04-14,8562
00713,元大台灣高息低波,94,5,89,新光-高雄,2023-04-14,8562
00676R,富邦臺灣加權反1,88,0,88,新光-高雄,2023-04-14,8562
2812,台中銀,118,41,77,新光-高雄,2023-04-14,8562
5864,致和證,75,0,75,新光-高雄,2023-04-14,8562
2618,長榮航,140,69,71,新光-高雄,2023-04-14,8562
00673R,期元大S＆P原油反1,67,0,67,新光-高雄,2023-04-14,8562
00772B,中信高評級公司債,72,10,62,新光-高雄,2023-04-14,8562
1513,中興電,186,129,57,新光-高雄,2023-04-14,8562
2402,毅嘉,208,152,56,新光-高雄,2023-04-14,8562
00680L,元大美債20正2,48,0,48,新光-高雄,2023-04-14,8562
5009,榮剛,100,56,44,新光-高雄,2023-04-14,8562
6167,久正,72,31,41,新光-高雄,2023-04-14,8562
2364,倫飛,48,7,41,新光-高雄,2023-04-14,8562
6244,茂迪,58,18,40,新光-高雄,2023-04-14,8562
2329,華泰,39,0,39,新光-高雄,2023-04-14,8562
00751B,元大AAA至A公司債,37,0,37,新光-高雄,2023-04-14,8562
2382,廣達,45,10,35,新光-高雄,2023-04-14,8562
6285,啟��,61,27,34,新光-高雄,2023-04-14,8562
2897,王道銀行,35,1,34,新光-高雄,2023-04-14,8562
6116,彩晶,74,42,32,新光-高雄,2023-04-14,8562
00888,永豐台灣ESG,32,0,32,新光-高雄,2023-04-14,8562
3432,台端,32,1,31,新光-高雄,2023-04-14,8562
2390,云辰,35,5,30,新光-高雄,2023-04-14,8562
4744,皇將,33,3,30,新光-高雄,2023-04-14,8562
2913,農林,32,2,30,新光-高雄,2023-04-14,8562
1584,精剛,155,125,30,新光-高雄,2023-04-14,8562
00902,中信電池及儲能,38,10,28,新光-高雄,2023-04-14,8562
00671R,富邦NASDAQ反1,33,5,28,新光-高雄,2023-04-14,8562
00715L,期街口布蘭特正2,27,0,27,新光-高雄,2023-04-14,8562
6799,來頡,30,3,27,新光-高雄,2023-04-14,8562
00687B,國泰20年美債,23,0,23,新光-高雄,2023-04-14,8562
3078,僑威,44,22,22,新光-高雄,2023-04-14,8562
9907,統一實,42,20,22,新光-高雄,2023-04-14,8562
1608,華榮,22,1,21,新光-高雄,2023-04-14,8562
3290,東浦,23,2,21,新光-高雄,2023-04-14,8562
1701,中化,21,0,21,新光-高雄,2023-04-14,8562
2890,永豐金,47,26,21,新光-高雄,2023-04-14,8562
8150,南茂,21,1,20,新光-高雄,2023-04-14,8562
1519,華城,43,23,20,新光-高雄,2023-04-14,8562
00679B,元大美債20年,517,2,515,新光-高雄,2023-04-17,8562
2610,華航,145,10,135,新光-高雄,2023-04-17,8562
1605,華新,181,48,133,新光-高雄,2023-04-17,8562
00673R,期元大S＆P原油反1,133,15,118,新光-高雄,2023-04-17,8562
00712,復華富時不動產,117,6,111,新光-高雄,2023-04-17,8562
2834,臺企銀,122,12,110,新光-高雄,2023-04-17,8562
2201,裕隆,137,51,86,新光-高雄,2023-04-17,8562
2851,中再保,85,6,79,新光-高雄,2023-04-17,8562
00772B,中信高評級公司債,72,0,72,新光-高雄,2023-04-17,8562
2897,王道銀行,66,0,66,新光-高雄,2023-04-17,8562
00720B,元大投資級公司債,99,36,63,新光-高雄,2023-04-17,8562
6235,華孚,195,133,62,新光-高雄,2023-04-17,8562
2867,三商壽,122,61,61,新光-高雄,2023-04-17,8562
6122,擎邦,67,7,60,新光-高雄,2023-04-17,8562
6285,啟��,66,9,57,新光-高雄,2023-04-17,8562
5864,致和證,57,0,57,新光-高雄,2023-04-17,8562
2002,中鋼,63,7,56,新光-高雄,2023-04-17,8562
3047,訊舟,39,1,38,新光-高雄,2023-04-17,8562
1109,信大,35,0,35,新光-高雄,2023-04-17,8562
1904,正隆,35,0,35,新光-高雄,2023-04-17,8562
00680L,元大美債20正2,34,0,34,新光-高雄,2023-04-17,8562
4433,興采,36,2,34,新光-高雄,2023-04-17,8562
3013,晟銘電,83,52,31,新光-高雄,2023-04-17,8562
00687B,國泰20年美債,29,0,29,新光-高雄,2023-04-17,8562
6547,高端疫苗,54,25,29,新光-高雄,2023-04-17,8562
2313,華通,39,11,28,新光-高雄,2023-04-17,8562
00902,中信電池及儲能,45,17,28,新光-高雄,2023-04-17,8562
1444,力麗,31,3,28,新光-高雄,2023-04-17,8562
2409,友達,33,6,27,新光-高雄,2023-04-17,8562
1313,聯成,27,0,27,新光-高雄,2023-04-17,8562
00888,永豐台灣ESG,34,7,27,新光-高雄,2023-04-17,8562
00878,國泰永續高股息,113,86,27,新光-高雄,2023-04-17,8562
1219,福壽,26,0,26,新光-高雄,2023-04-17,8562
912000,晨訊科-DR,26,0,26,新光-高雄,2023-04-17,8562
6284,佳邦,31,5,26,新光-高雄,2023-04-17,8562
6142,友勁,28,4,24,新光-高雄,2023-04-17,8562
00885,富邦越南,23,0,23,新光-高雄,2023-04-17,8562
5371,中光電,81,58,23,新光-高雄,2023-04-17,8562
00751B,元大AAA至A公司債,23,0,23,新光-高雄,2023-04-17,8562
8034,榮群,22,0,22,新光-高雄,2023-04-17,8562
3372,典範,22,0,22,新光-高雄,2023-04-17,8562
2454,聯發科,29,7,22,新光-高雄,2023-04-17,8562
6148,驊宏資,25,4,21,新光-高雄,2023-04-17,8562
8069,元太,24,3,21,新光-高雄,2023-04-17,8562
2618,長榮航,80,60,20,新光-高雄,2023-04-17,8562
00857B,永豐20年美公債,20,0,20,新光-高雄,2023-04-17,8562
5531,鄉林,20,0,20,新光-高雄,2023-04-17,8562
2317,鴻海,43,23,20,新光-高雄,2023-04-17,8562
00891,中信關鍵半導體,24,5,19,新光-高雄,2023-04-17,8562
9921,巨大,29,10,19,新光-高雄,2023-04-17,8562
00632R,元大台灣50反1,541,5,536,新光-高雄,2023-04-18,8562
00673R,期元大S＆P原油反1,489,107,382,新光-高雄,2023-04-18,8562
3032,偉訓,216,13,203,新光-高雄,2023-04-18,8562
00679B,元大美債20年,216,19,197,新光-高雄,2023-04-18,8562
6167,久正,180,19,161,新光-高雄,2023-04-18,8562
00680L,元大美債20正2,139,1,138,新光-高雄,2023-04-18,8562
3481,群創,150,20,130,新光-高雄,2023-04-18,8562
2201,裕隆,315,189,126,新光-高雄,2023-04-18,8562
00688L,國泰20年美債正2,113,0,113,新光-高雄,2023-04-18,8562
2881,富邦金,102,2,100,新光-高雄,2023-04-18,8562
00878,國泰永續高股息,199,100,99,新光-高雄,2023-04-18,8562
00720B,元大投資級公司債,109,16,93,新光-高雄,2023-04-18,8562
2897,王道銀行,80,5,75,新光-高雄,2023-04-18,8562
00772B,中信高評級公司債,103,40,63,新光-高雄,2023-04-18,8562
1584,精剛,165,104,61,新光-高雄,2023-04-18,8562
00751B,元大AAA至A公司債,55,0,55,新光-高雄,2023-04-18,8562
2329,華泰,53,3,50,新光-高雄,2023-04-18,8562
00713,元大台灣高息低波,61,11,50,新光-高雄,2023-04-18,8562
2457,飛宏,295,247,48,新光-高雄,2023-04-18,8562
00891,中信關鍵半導體,46,0,46,新光-高雄,2023-04-18,8562
2344,華邦電,158,112,46,新光-高雄,2023-04-18,8562
2454,聯發科,44,1,43,新光-高雄,2023-04-18,8562
2834,臺企銀,53,11,42,新光-高雄,2023-04-18,8562
4768,晶呈科技,42,1,41,新光-高雄,2023-04-18,8562
3234,光環,40,0,40,新光-高雄,2023-04-18,8562
3206,志豐,39,0,39,新光-高雄,2023-04-18,8562
2359,所羅門,86,49,37,新光-高雄,2023-04-18,8562
2369,菱生,36,0,36,新光-高雄,2023-04-18,8562
00687B,國泰20年美債,34,0,34,新光-高雄,2023-04-18,8562
2453,凌群,96,63,33,新光-高雄,2023-04-18,8562
00900,富邦特選高股息30,33,1,32,新光-高雄,2023-04-18,8562
00712,復華富時不動產,31,0,31,新光-高雄,2023-04-18,8562
3058,立德,72,41,31,新光-高雄,2023-04-18,8562
2208,台船,63,33,30,新光-高雄,2023-04-18,8562
00664R,國泰臺灣加權反1,30,0,30,新光-高雄,2023-04-18,8562
2364,倫飛,41,12,29,新光-高雄,2023-04-18,8562
2601,益航,31,3,28,新光-高雄,2023-04-18,8562
1605,華新,46,18,28,新光-高雄,2023-04-18,8562
2515,中工,46,19,27,新光-高雄,2023-04-18,8562
1101,台泥,47,21,26,新光-高雄,2023-04-18,8562
2402,毅嘉,39,13,26,新光-高雄,2023-04-18,8562
00715L,期街口布蘭特正2,51,26,25,新光-高雄,2023-04-18,8562
3149,正達,25,0,25,新光-高雄,2023-04-18,8562
6285,啟��,49,25,24,新光-高雄,2023-04-18,8562
3037,欣興,31,7,24,新光-高雄,2023-04-18,8562
2867,三商壽,70,46,24,新光-高雄,2023-04-18,8562
3025,星通,43,19,24,新光-高雄,2023-04-18,8562
8033,雷虎,166,143,23,新光-高雄,2023-04-18,8562
2206,三陽工業,37,14,23,新光-高雄,2023-04-18,8562
2603,長榮,42,19,23,新光-高雄,2023-04-18,8562
00888,永豐台灣ESG,253,0,253,新光-高雄,2023-04-19,8562
2884,玉山金,244,6,238,新光-高雄,2023-04-19,8562
6282,康舒,357,135,222,新光-高雄,2023-04-19,8562
2495,普安,224,61,163,新光-高雄,2023-04-19,8562
3673,TPK-KY,201,88,113,新光-高雄,2023-04-19,8562
4147,中裕,110,20,90,新光-高雄,2023-04-19,8562
2867,三商壽,117,40,77,新光-高雄,2023-04-19,8562
00679B,元大美債20年,85,12,73,新光-高雄,2023-04-19,8562
1810,和成,144,73,71,新光-高雄,2023-04-19,8562
00712,復華富時不動產,66,0,66,新光-高雄,2023-04-19,8562
00687B,國泰20年美債,62,0,62,新光-高雄,2023-04-19,8562
1337,再生-KY,60,0,60,新光-高雄,2023-04-19,8562
6163,華電網,206,148,58,新光-高雄,2023-04-19,8562
2834,臺企銀,57,2,55,新光-高雄,2023-04-19,8562
00900,富邦特選高股息30,66,13,53,新光-高雄,2023-04-19,8562
00772B,中信高評級公司債,62,10,52,新光-高雄,2023-04-19,8562
3712,永崴投控,70,19,51,新光-高雄,2023-04-19,8562
1312,國喬,52,1,51,新光-高雄,2023-04-19,8562
2610,華航,83,33,50,新光-高雄,2023-04-19,8562
3481,群創,192,142,50,新光-高雄,2023-04-19,8562
1727,中華化,51,4,47,新光-高雄,2023-04-19,8562
4979,華星光,162,116,46,新光-高雄,2023-04-19,8562
00720B,元大投資級公司債,43,1,42,新光-高雄,2023-04-19,8562
00878,國泰永續高股息,348,308,40,新光-高雄,2023-04-19,8562
8415,大國鋼,40,0,40,新光-高雄,2023-04-19,8562
00680L,元大美債20正2,49,9,40,新光-高雄,2023-04-19,8562
8926,台汽電,51,13,38,新光-高雄,2023-04-19,8562
00923,群益台ESG低碳50,36,0,36,新光-高雄,2023-04-19,8562
6129,普誠,40,4,36,新光-高雄,2023-04-19,8562
2329,華泰,36,1,35,新光-高雄,2023-04-19,8562
6770,力積電,65,32,33,新光-高雄,2023-04-19,8562
3363,上詮,47,14,33,新光-高雄,2023-04-19,8562
2353,宏��,52,20,32,新光-高雄,2023-04-19,8562
2303,聯電,35,3,32,新光-高雄,2023-04-19,8562
00922,國泰台灣領袖50,32,1,31,新光-高雄,2023-04-19,8562
2892,第一金,31,0,31,新光-高雄,2023-04-19,8562
5340,建榮,35,4,31,新光-高雄,2023-04-19,8562
2409,友達,47,17,30,新光-高雄,2023-04-19,8562
2337,旺宏,31,1,30,新光-高雄,2023-04-19,8562
6806,森崴能源,105,76,29,新光-高雄,2023-04-19,8562
0050,元大台灣50,30,2,28,新光-高雄,2023-04-19,8562
5864,致和證,29,1,28,新光-高雄,2023-04-19,8562
006208,富邦台50,27,0,27,新光-高雄,2023-04-19,8562
2498,宏達電,56,30,26,新光-高雄,2023-04-19,8562
0056,元大高股息,31,5,26,新光-高雄,2023-04-19,8562
2722,夏都,33,9,24,新光-高雄,2023-04-19,8562
2002,中鋼,26,3,23,新光-高雄,2023-04-19,8562
3022,威強電,23,0,23,新光-高雄,2023-04-19,8562
2330,台積電,29,7,22,新光-高雄,2023-04-19,8562
1618,合機,25,3,22,新光-高雄,2023-04-19,8562
00673R,期元大S＆P原油反1,1640,178,1462,新光-高雄,2023-04-20,8562
2897,王道銀行,406,0,406,新光-高雄,2023-04-20,8562
00637L,元大滬深300正2,261,38,223,新光-高雄,2023-04-20,8562
6282,康舒,435,288,147,新光-高雄,2023-04-20,8562
00720B,元大投資級公司債,117,15,102,新光-高雄,2023-04-20,8562
00687B,國泰20年美債,91,2,89,新光-高雄,2023-04-20,8562
2812,台中銀,88,16,72,新光-高雄,2023-04-20,8562
00878,國泰永續高股息,185,121,64,新光-高雄,2023-04-20,8562
00900,富邦特選高股息30,60,2,58,新光-高雄,2023-04-20,8562
00907,永豐優息存股,58,0,58,新光-高雄,2023-04-20,8562
6112,邁達特,56,1,55,新光-高雄,2023-04-20,8562
4147,中裕,79,24,55,新光-高雄,2023-04-20,8562
2867,三商壽,50,0,50,新光-高雄,2023-04-20,8562
00680L,元大美債20正2,49,1,48,新光-高雄,2023-04-20,8562
3231,緯創,107,60,47,新光-高雄,2023-04-20,8562
00888,永豐台灣ESG,83,36,47,新光-高雄,2023-04-20,8562
6244,茂迪,280,233,47,新光-高雄,2023-04-20,8562
4167,松瑞藥,53,8,45,新光-高雄,2023-04-20,8562
00772B,中信高評級公司債,45,0,45,新光-高雄,2023-04-20,8562
00706L,期元大S＆P日圓正2,44,0,44,新光-高雄,2023-04-20,8562
6443,元晶,72,28,44,新光-高雄,2023-04-20,8562
1711,永光,98,56,42,新光-高雄,2023-04-20,8562
4744,皇將,42,0,42,新光-高雄,2023-04-20,8562
2324,仁寶,52,12,40,新光-高雄,2023-04-20,8562
00892,富邦台灣半導體,39,0,39,新光-高雄,2023-04-20,8562
00713,元大台灣高息低波,62,23,39,新光-高雄,2023-04-20,8562
1101,台泥,43,4,39,新光-高雄,2023-04-20,8562
6179,亞通,40,2,38,新光-高雄,2023-04-20,8562
4114,健喬,67,31,36,新光-高雄,2023-04-20,8562
2495,普安,100,64,36,新光-高雄,2023-04-20,8562
0050,元大台灣50,35,1,34,新光-高雄,2023-04-20,8562
2515,中工,62,28,34,新光-高雄,2023-04-20,8562
3576,聯合再生,52,20,32,新光-高雄,2023-04-20,8562
2610,華航,57,26,31,新光-高雄,2023-04-20,8562
0056,元大高股息,37,6,31,新光-高雄,2023-04-20,8562
2457,飛宏,102,72,30,新光-高雄,2023-04-20,8562
3673,TPK-KY,53,23,30,新光-高雄,2023-04-20,8562
00912,中信臺灣智慧50,30,0,30,新光-高雄,2023-04-20,8562
2201,裕隆,57,29,28,新光-高雄,2023-04-20,8562
3715,定穎投控,75,47,28,新光-高雄,2023-04-20,8562
2618,長榮航,54,26,28,新光-高雄,2023-04-20,8562
1321,大洋,27,1,26,新光-高雄,2023-04-20,8562
00633L,富邦上証正2,26,0,26,新光-高雄,2023-04-20,8562
3264,欣銓,26,0,26,新光-高雄,2023-04-20,8562
00922,國泰台灣領袖50,26,0,26,新光-高雄,2023-04-20,8562
3078,僑威,65,41,24,新光-高雄,2023-04-20,8562
3372,典範,24,0,24,新光-高雄,2023-04-20,8562
2535,達欣工,24,0,24,新光-高雄,2023-04-20,8562
8038,長園科,24,1,23,新光-高雄,2023-04-20,8562
2329,華泰,31,8,23,新光-高雄,2023-04-20,8562
2867,三商壽,234,7,227,新光-高雄,2023-04-21,8562
00715L,期街口布蘭特正2,189,40,149,新光-高雄,2023-04-21,8562
3576,聯合再生,161,38,123,新光-高雄,2023-04-21,8562
00637L,元大滬深300正2,114,21,93,新光-高雄,2023-04-21,8562
00888,永豐台灣ESG,77,0,77,新光-高雄,2023-04-21,8562
5263,智崴,72,0,72,新光-高雄,2023-04-21,8562
0056,元大高股息,85,18,67,新光-高雄,2023-04-21,8562
8926,台汽電,76,10,66,新光-高雄,2023-04-21,8562
00720B,元大投資級公司債,64,2,62,新光-高雄,2023-04-21,8562
00900,富邦特選高股息30,63,6,57,新光-高雄,2023-04-21,8562
2610,華航,64,9,55,新光-高雄,2023-04-21,8562
1611,中電,249,196,53,新光-高雄,2023-04-21,8562
2002,中鋼,50,3,47,新光-高雄,2023-04-21,8562
6244,茂迪,216,170,46,新光-高雄,2023-04-21,8562
00892,富邦台灣半導體,41,0,41,新光-高雄,2023-04-21,8562
1609,大亞,49,9,40,新光-高雄,2023-04-21,8562
2409,友達,87,48,39,新光-高雄,2023-04-21,8562
1906,寶隆,39,5,34,新光-高雄,2023-04-21,8562
00680L,元大美債20正2,33,0,33,新光-高雄,2023-04-21,8562
2031,新光鋼,57,26,31,新光-高雄,2023-04-21,8562
2601,益航,32,1,31,新光-高雄,2023-04-21,8562
5302,太欣,31,0,31,新光-高雄,2023-04-21,8562
5880,合庫金,29,0,29,新光-高雄,2023-04-21,8562
1802,台玻,32,4,28,新光-高雄,2023-04-21,8562
4744,皇將,29,1,28,新光-高雄,2023-04-21,8562
8086,宏捷科,44,18,26,新光-高雄,2023-04-21,8562
2834,臺企銀,37,12,25,新光-高雄,2023-04-21,8562
5457,宣德,25,0,25,新光-高雄,2023-04-21,8562
2206,三陽工業,119,95,24,新光-高雄,2023-04-21,8562
00891,中信關鍵半導體,66,43,23,新光-高雄,2023-04-21,8562
5864,致和證,23,0,23,新光-高雄,2023-04-21,8562
1506,正道,23,0,23,新光-高雄,2023-04-21,8562
1909,榮成,173,150,23,新光-高雄,2023-04-21,8562
00919,群益台灣精選高息,23,0,23,新光-高雄,2023-04-21,8562
6274,台燿,22,0,22,新光-高雄,2023-04-21,8562
9921,巨大,26,4,22,新光-高雄,2023-04-21,8562
6112,邁達特,70,48,22,新光-高雄,2023-04-21,8562
3296,勝德,33,11,22,新光-高雄,2023-04-21,8562
1227,佳格,22,0,22,新光-高雄,2023-04-21,8562
2498,宏達電,60,39,21,新光-高雄,2023-04-21,8562
2328,廣宇,23,2,21,新光-高雄,2023-04-21,8562
00669R,國泰美國道瓊反1,20,0,20,新光-高雄,2023-04-21,8562
6182,合晶,20,0,20,新光-高雄,2023-04-21,8562
00712,復華富時不動產,26,7,19,新光-高雄,2023-04-21,8562
00687B,國泰20年美債,28,9,19,新光-高雄,2023-04-21,8562
2313,華通,20,1,19,新光-高雄,2023-04-21,8562
3163,波若威,24,5,19,新光-高雄,2023-04-21,8562
4951,精拓科,21,2,19,新光-高雄,2023-04-21,8562
00641R,富邦日本反1,18,0,18,新光-高雄,2023-04-21,8562
2603,長榮,29,11,18,新光-高雄,2023-04-21,8562
00637L,元大滬深300正2,347,40,307,新光-高雄,2023-04-24,8562
2409,友達,126,6,120,新光-高雄,2023-04-24,8562
1711,永光,193,77,116,新光-高雄,2023-04-24,8562
00902,中信電池及儲能,101,0,101,新光-高雄,2023-04-24,8562
4147,中裕,87,5,82,新光-高雄,2023-04-24,8562
3363,上詮,88,8,80,新光-高雄,2023-04-24,8562
6806,森崴能源,120,45,75,新光-高雄,2023-04-24,8562
2610,華航,78,6,72,新光-高雄,2023-04-24,8562
2303,聯電,70,2,68,新光-高雄,2023-04-24,8562
2313,華通,87,25,62,新光-高雄,2023-04-24,8562
00679B,元大美債20年,78,22,56,新光-高雄,2023-04-24,8562
2867,三商壽,62,6,56,新光-高雄,2023-04-24,8562
00720B,元大投資級公司債,67,12,55,新光-高雄,2023-04-24,8562
1709,和益,110,58,52,新光-高雄,2023-04-24,8562
00882,中信中國高股息,51,0,51,新光-高雄,2023-04-24,8562
3188,鑫龍騰,47,0,47,新光-高雄,2023-04-24,8562
2913,農林,323,280,43,新光-高雄,2023-04-24,8562
00687B,國泰20年美債,38,0,38,新光-高雄,2023-04-24,8562
2881,富邦金,37,4,33,新光-高雄,2023-04-24,8562
4566,時碩工業,30,1,29,新光-高雄,2023-04-24,8562
3058,立德,45,17,28,新光-高雄,2023-04-24,8562
00753L,中信中國50正2,50,23,27,新光-高雄,2023-04-24,8562
2369,菱生,27,0,27,新光-高雄,2023-04-24,8562
00715L,期街口布蘭特正2,33,7,26,新光-高雄,2023-04-24,8562
1752,南光,40,15,25,新光-高雄,2023-04-24,8562
2453,凌群,107,83,24,新光-高雄,2023-04-24,8562
00680L,元大美債20正2,24,0,24,新光-高雄,2023-04-24,8562
5864,致和證,24,0,24,新光-高雄,2023-04-24,8562
5015,華祺,25,1,24,新光-高雄,2023-04-24,8562
2707,晶華,23,0,23,新光-高雄,2023-04-24,8562
00633L,富邦上証正2,25,2,23,新光-高雄,2023-04-24,8562
00665L,富邦�琤肭磪囓�2,21,0,21,新光-高雄,2023-04-24,8562
2323,中環,20,0,20,新光-高雄,2023-04-24,8562
00664R,國泰臺灣加權反1,20,0,20,新光-高雄,2023-04-24,8562
00907,永豐優息存股,20,0,20,新光-高雄,2023-04-24,8562
2353,宏��,27,8,19,新光-高雄,2023-04-24,8562
2208,台船,25,6,19,新光-高雄,2023-04-24,8562
6005,群益證,20,1,19,新光-高雄,2023-04-24,8562
00712,復華富時不動產,21,3,18,新光-高雄,2023-04-24,8562
00772B,中信高評級公司債,39,21,18,新光-高雄,2023-04-24,8562
2317,鴻海,29,11,18,新光-高雄,2023-04-24,8562
6153,嘉聯益,15,0,15,新光-高雄,2023-04-24,8562
6578,達邦蛋白,25,10,15,新光-高雄,2023-04-24,8562
2324,仁寶,15,0,15,新光-高雄,2023-04-24,8562
00641R,富邦日本反1,14,0,14,新光-高雄,2023-04-24,8562
1605,華新,41,28,13,新光-高雄,2023-04-24,8562
4111,濟生,26,13,13,新光-高雄,2023-04-24,8562
8390,金益鼎,14,1,13,新光-高雄,2023-04-24,8562
2603,長榮,21,9,12,新光-高雄,2023-04-24,8562
2314,台揚,21,8,13,新光-高雄,2023-04-24,8562
00878,國泰永續高股息,479,72,407,新光-高雄,2023-04-25,8562
0056,元大高股息,267,10,257,新光-高雄,2023-04-25,8562
00713,元大台灣高息低波,202,2,200,新光-高雄,2023-04-25,8562
00637L,元大滬深300正2,125,11,114,新光-高雄,2023-04-25,8562
00900,富邦特選高股息30,112,0,112,新光-高雄,2023-04-25,8562
2867,三商壽,107,1,106,新光-高雄,2023-04-25,8562
1721,三晃,168,66,102,新光-高雄,2023-04-25,8562
006208,富邦台50,80,2,78,新光-高雄,2023-04-25,8562
2834,臺企銀,74,10,64,新光-高雄,2023-04-25,8562
1101,台泥,281,217,64,新光-高雄,2023-04-25,8562
00753L,中信中國50正2,115,51,64,新光-高雄,2023-04-25,8562
8926,台汽電,58,3,55,新光-高雄,2023-04-25,8562
3231,緯創,101,47,54,新光-高雄,2023-04-25,8562
2002,中鋼,69,17,52,新光-高雄,2023-04-25,8562
1513,中興電,140,89,51,新光-高雄,2023-04-25,8562
4303,信立,49,0,49,新光-高雄,2023-04-25,8562
0050,元大台灣50,66,18,48,新光-高雄,2023-04-25,8562
00888,永豐台灣ESG,46,0,46,新光-高雄,2023-04-25,8562
00881,國泰台灣5G+,46,0,46,新光-高雄,2023-04-25,8562
2913,農林,95,52,43,新光-高雄,2023-04-25,8562
00665L,富邦�琤肭磪囓�2,113,70,43,新光-高雄,2023-04-25,8562
2303,聯電,80,39,41,新光-高雄,2023-04-25,8562
8415,大國鋼,41,0,41,新光-高雄,2023-04-25,8562
2883B,凱基金乙特,35,0,35,新光-高雄,2023-04-25,8562
9945,潤泰新,57,23,34,新光-高雄,2023-04-25,8562
6282,康舒,114,80,34,新光-高雄,2023-04-25,8562
9907,統一實,61,27,34,新光-高雄,2023-04-25,8562
2610,華航,61,28,33,新光-高雄,2023-04-25,8562
1519,華城,75,42,33,新光-高雄,2023-04-25,8562
9904,寶成,36,4,32,新光-高雄,2023-04-25,8562
00891,中信關鍵半導體,35,4,31,新光-高雄,2023-04-25,8562
2441,超豐,31,0,31,新光-高雄,2023-04-25,8562
00892,富邦台灣半導體,31,0,31,新光-高雄,2023-04-25,8562
3188,鑫龍騰,39,8,31,新光-高雄,2023-04-25,8562
00902,中信電池及儲能,36,5,31,新光-高雄,2023-04-25,8562
3035,智原,47,17,30,新光-高雄,2023-04-25,8562
00671R,富邦NASDAQ反1,30,0,30,新光-高雄,2023-04-25,8562
1609,大亞,36,7,29,新光-高雄,2023-04-25,8562
2618,長榮航,51,22,29,新光-高雄,2023-04-25,8562
2338,光罩,42,14,28,新光-高雄,2023-04-25,8562
00752,中信中國50,28,0,28,新光-高雄,2023-04-25,8562
00893,國泰智能電動車,28,0,28,新光-高雄,2023-04-25,8562
2330,台積電,38,11,27,新光-高雄,2023-04-25,8562
2457,飛宏,160,134,26,新光-高雄,2023-04-25,8562
2368,金像電,32,5,27,新光-高雄,2023-04-25,8562
8403,盛弘,26,0,26,新光-高雄,2023-04-25,8562
2388,威盛,53,27,26,新光-高雄,2023-04-25,8562
3071,協禧,108,83,25,新光-高雄,2023-04-25,8562
3479,安勤,27,2,25,新光-高雄,2023-04-25,8562
6187,萬潤,25,0,25,新光-高雄,2023-04-25,8562
3481,群創,371,34,337,新光-高雄,2023-04-26,8562
2882,國泰金,197,1,196,新光-高雄,2023-04-26,8562
3682,亞太電,160,0,160,新光-高雄,2023-04-26,8562
00669R,國泰美國道瓊反1,150,0,150,新光-高雄,2023-04-26,8562
00715L,期街口布蘭特正2,139,40,99,新光-高雄,2023-04-26,8562
2913,農林,136,45,91,新光-高雄,2023-04-26,8562
00712,復華富時不動產,101,18,83,新光-高雄,2023-04-26,8562
2002,中鋼,85,6,79,新光-高雄,2023-04-26,8562
00753L,中信中國50正2,77,12,65,新光-高雄,2023-04-26,8562
4153,鈺緯,61,0,61,新光-高雄,2023-04-26,8562
1709,和益,105,49,56,新光-高雄,2023-04-26,8562
6245,立端,50,2,48,新光-高雄,2023-04-26,8562
00683L,期元大美元指正2,47,0,47,新光-高雄,2023-04-26,8562
3035,智原,85,45,40,新光-高雄,2023-04-26,8562
1101,台泥,97,58,39,新光-高雄,2023-04-26,8562
2609,陽明,40,6,34,新光-高雄,2023-04-26,8562
1904,正隆,80,47,33,新光-高雄,2023-04-26,8562
6179,亞通,35,6,29,新光-高雄,2023-04-26,8562
3071,協禧,50,23,27,新光-高雄,2023-04-26,8562
0050,元大台灣50,30,4,26,新光-高雄,2023-04-26,8562
00885,富邦越南,24,0,24,新光-高雄,2023-04-26,8562
4102,永日,26,2,24,新光-高雄,2023-04-26,8562
6770,力積電,25,1,24,新光-高雄,2023-04-26,8562
2206,三陽工業,48,25,23,新光-高雄,2023-04-26,8562
2330,台積電,31,8,23,新光-高雄,2023-04-26,8562
6806,森崴能源,40,18,22,新光-高雄,2023-04-26,8562
00888,永豐台灣ESG,21,0,21,新光-高雄,2023-04-26,8562
1710,東聯,29,9,20,新光-高雄,2023-04-26,8562
2464,盟立,20,0,20,新光-高雄,2023-04-26,8562
00881,國泰台灣5G+,22,2,20,新光-高雄,2023-04-26,8562
2495,普安,132,113,19,新光-高雄,2023-04-26,8562
1609,大亞,22,3,19,新光-高雄,2023-04-26,8562
006208,富邦台50,21,3,18,新光-高雄,2023-04-26,8562
3711,日月光投控,36,18,18,新光-高雄,2023-04-26,8562
00830,國泰費城半導體,19,2,17,新光-高雄,2023-04-26,8562
1312,國喬,19,2,17,新光-高雄,2023-04-26,8562
2409,友達,35,19,16,新光-高雄,2023-04-26,8562
00902,中信電池及儲能,17,1,16,新光-高雄,2023-04-26,8562
1108,幸福,36,20,16,新光-高雄,2023-04-26,8562
1806,冠軍,15,0,15,新光-高雄,2023-04-26,8562
3479,安勤,25,10,15,新光-高雄,2023-04-26,8562
3189,景碩,27,12,15,新光-高雄,2023-04-26,8562
1605,華新,18,4,14,新光-高雄,2023-04-26,8562
2915,潤泰全,16,3,13,新光-高雄,2023-04-26,8562
00857B,永豐20年美公債,14,1,13,新光-高雄,2023-04-26,8562
5351,鈺創,14,1,13,新光-高雄,2023-04-26,8562
1810,和成,20,7,13,新光-高雄,2023-04-26,8562
6443,元晶,26,13,13,新光-高雄,2023-04-26,8562
5701,劍湖山,12,0,12,新光-高雄,2023-04-26,8562
8926,台汽電,14,2,12,新光-高雄,2023-04-26,8562
00715L,期街口布蘭特正2,976,1,975,新光-高雄,2023-04-27,8562
00632R,元大台灣50反1,525,98,427,新光-高雄,2023-04-27,8562
00753L,中信中國50正2,380,11,369,新光-高雄,2023-04-27,8562
3481,群創,174,6,168,新光-高雄,2023-04-27,8562
00712,復華富時不動產,103,0,103,新光-高雄,2023-04-27,8562
00720B,元大投資級公司債,105,2,103,新光-高雄,2023-04-27,8562
3033,威健,104,3,101,新光-高雄,2023-04-27,8562
2834,臺企銀,97,1,96,新光-高雄,2023-04-27,8562
2409,友達,73,2,71,新光-高雄,2023-04-27,8562
1711,永光,247,180,67,新光-高雄,2023-04-27,8562
2002,中鋼,68,2,66,新光-高雄,2023-04-27,8562
00772B,中信高評級公司債,57,0,57,新光-高雄,2023-04-27,8562
00669R,國泰美國道瓊反1,53,0,53,新光-高雄,2023-04-27,8562
00676R,富邦臺灣加權反1,60,13,47,新光-高雄,2023-04-27,8562
3011,今皓,45,0,45,新光-高雄,2023-04-27,8562
00680L,元大美債20正2,50,8,42,新光-高雄,2023-04-27,8562
5864,致和證,46,5,41,新光-高雄,2023-04-27,8562
6218,豪勉,45,5,40,新光-高雄,2023-04-27,8562
3504,揚明光,41,1,40,新光-高雄,2023-04-27,8562
2609,陽明,68,29,39,新光-高雄,2023-04-27,8562
8069,元太,60,22,38,新光-高雄,2023-04-27,8562
00642U,期元大S＆P石油,51,13,38,新光-高雄,2023-04-27,8562
8112,至上,36,0,36,新光-高雄,2023-04-27,8562
3188,鑫龍騰,35,1,34,新光-高雄,2023-04-27,8562
0050,元大台灣50,37,4,33,新光-高雄,2023-04-27,8562
1101,台泥,42,10,32,新光-高雄,2023-04-27,8562
1104,環泥,32,0,32,新光-高雄,2023-04-27,8562
3284,太普高,35,3,32,新光-高雄,2023-04-27,8562
4153,鈺緯,33,1,32,新光-高雄,2023-04-27,8562
00687B,國泰20年美債,31,0,31,新光-高雄,2023-04-27,8562
6138,茂達,35,5,30,新光-高雄,2023-04-27,8562
1907,永豐餘,68,39,29,新光-高雄,2023-04-27,8562
2610,華航,115,88,27,新光-高雄,2023-04-27,8562
00679B,元大美債20年,43,20,23,新光-高雄,2023-04-27,8562
00751B,元大AAA至A公司債,24,1,23,新光-高雄,2023-04-27,8562
2303,聯電,63,40,23,新光-高雄,2023-04-27,8562
6770,力積電,33,11,22,新光-高雄,2023-04-27,8562
9921,巨大,24,3,21,新光-高雄,2023-04-27,8562
1310,台苯,89,69,20,新光-高雄,2023-04-27,8562
00664R,國泰臺灣加權反1,20,0,20,新光-高雄,2023-04-27,8562
2472,立隆電,22,2,20,新光-高雄,2023-04-27,8562
1103,嘉泥,20,0,20,新光-高雄,2023-04-27,8562
2801,彰銀,32,13,19,新光-高雄,2023-04-27,8562
6179,亞通,21,2,19,新光-高雄,2023-04-27,8562
3037,欣興,32,13,19,新光-高雄,2023-04-27,8562
1717,長興,87,69,18,新光-高雄,2023-04-27,8562
00885,富邦越南,20,2,18,新光-高雄,2023-04-27,8562
00648R,元大S＆P500反1,18,0,18,新光-高雄,2023-04-27,8562
006208,富邦台50,18,0,18,新光-高雄,2023-04-27,8562
1904,正隆,31,14,17,新光-高雄,2023-04-27,8562
00715L,期街口布蘭特正2,614,131,483,新光-高雄,2023-04-28,8562
00706L,期元大S＆P日圓正2,225,0,225,新光-高雄,2023-04-28,8562
00720B,元大投資級公司債,128,2,126,新光-高雄,2023-04-28,8562
00669R,國泰美國道瓊反1,110,0,110,新光-高雄,2023-04-28,8562
00671R,富邦NASDAQ反1,89,0,89,新光-高雄,2023-04-28,8562
3289,宜特,102,16,86,新光-高雄,2023-04-28,8562
2880,華南金,129,46,83,新光-高雄,2023-04-28,8562
2383,台光電,84,5,79,新光-高雄,2023-04-28,8562
3481,群創,153,75,78,新光-高雄,2023-04-28,8562
00753L,中信中國50正2,110,32,78,新光-高雄,2023-04-28,8562
00680L,元大美債20正2,62,10,52,新光-高雄,2023-04-28,8562
00878,國泰永續高股息,155,103,52,新光-高雄,2023-04-28,8562
6417,韋僑,57,6,51,新光-高雄,2023-04-28,8562
4147,中裕,51,5,46,新光-高雄,2023-04-28,8562
00679B,元大美債20年,53,9,44,新光-高雄,2023-04-28,8562
00772B,中信高評級公司債,77,34,43,新光-高雄,2023-04-28,8562
1795,美時,55,15,40,新光-高雄,2023-04-28,8562
1721,三晃,100,62,38,新光-高雄,2023-04-28,8562
8112,至上,37,1,36,新光-高雄,2023-04-28,8562
00751B,元大AAA至A公司債,37,1,36,新光-高雄,2023-04-28,8562
5880,合庫金,42,9,33,新光-高雄,2023-04-28,8562
2313,華通,34,2,32,新光-高雄,2023-04-28,8562
2002,中鋼,37,6,31,新光-高雄,2023-04-28,8562
1609,大亞,54,24,30,新光-高雄,2023-04-28,8562
2453,凌群,101,72,29,新光-高雄,2023-04-28,8562
1101,台泥,50,21,29,新光-高雄,2023-04-28,8562
3265,台星科,31,3,28,新光-高雄,2023-04-28,8562
1569,濱川,26,1,25,新光-高雄,2023-04-28,8562
6116,彩晶,40,15,25,新光-高雄,2023-04-28,8562
1711,永光,50,28,22,新光-高雄,2023-04-28,8562
6245,立端,25,3,22,新光-高雄,2023-04-28,8562
3058,立德,23,2,21,新光-高雄,2023-04-28,8562
00676R,富邦臺灣加權反1,20,0,20,新光-高雄,2023-04-28,8562
2832,台產,20,0,20,新光-高雄,2023-04-28,8562
2464,盟立,20,0,20,新光-高雄,2023-04-28,8562
3209,全科,19,0,19,新光-高雄,2023-04-28,8562
2812,台中銀,48,30,18,新光-高雄,2023-04-28,8562
4527,方土霖,18,0,18,新光-高雄,2023-04-28,8562
3188,鑫龍騰,21,4,17,新光-高雄,2023-04-28,8562
3419,譁裕,56,40,16,新光-高雄,2023-04-28,8562
3704,合勤控,50,33,17,新光-高雄,2023-04-28,8562
00900,富邦特選高股息30,17,1,16,新光-高雄,2023-04-28,8562
1907,永豐餘,32,16,16,新光-高雄,2023-04-28,8562
8222,寶一,109,94,15,新光-高雄,2023-04-28,8562
3105,穩懋,32,17,15,新光-高雄,2023-04-28,8562
1809,中釉,86,71,15,新光-高雄,2023-04-28,8562
1108,幸福,25,10,15,新光-高雄,2023-04-28,8562
006208,富邦台50,18,4,14,新光-高雄,2023-04-28,8562
3711,日月光投控,19,5,14,新光-高雄,2023-04-28,8562
6806,森崴能源,32,18,14,新光-高雄,2023-04-28,8562
5864,致和證,516,0,516,新光-高雄,2023-05-02,8562
00706L,期元大S＆P日圓正2,366,10,356,新光-高雄,2023-05-02,8562
00632R,元大台灣50反1,725,511,214,新光-高雄,2023-05-02,8562
00712,復華富時不動產,206,4,202,新光-高雄,2023-05-02,8562
1210,大成,175,0,175,新光-高雄,2023-05-02,8562
00669R,國泰美國道瓊反1,191,38,153,新光-高雄,2023-05-02,8562
1608,華榮,164,15,149,新光-高雄,2023-05-02,8562
00665L,富邦�琤肭磪囓�2,169,44,125,新光-高雄,2023-05-02,8562
2834,臺企銀,128,22,106,新光-高雄,2023-05-02,8562
2402,毅嘉,106,8,98,新光-高雄,2023-05-02,8562
2609,陽明,107,16,91,新光-高雄,2023-05-02,8562
00680L,元大美債20正2,91,2,89,新光-高雄,2023-05-02,8562
2880,華南金,89,9,80,新光-高雄,2023-05-02,8562
00772B,中信高評級公司債,96,25,71,新光-高雄,2023-05-02,8562
00720B,元大投資級公司債,104,34,70,新光-高雄,2023-05-02,8562
00751B,元大AAA至A公司債,72,2,70,新光-高雄,2023-05-02,8562
00679B,元大美債20年,66,2,64,新光-高雄,2023-05-02,8562
1460,宏遠,74,18,56,新光-高雄,2023-05-02,8562
4306,炎洲,59,8,51,新光-高雄,2023-05-02,8562
00878,國泰永續高股息,180,129,51,新光-高雄,2023-05-02,8562
4147,中裕,50,0,50,新光-高雄,2023-05-02,8562
2409,友達,247,201,46,新光-高雄,2023-05-02,8562
3027,盛達,49,5,44,新光-高雄,2023-05-02,8562
2344,華邦電,143,99,44,新光-高雄,2023-05-02,8562
1310,台苯,53,9,44,新光-高雄,2023-05-02,8562
1711,永光,71,27,44,新光-高雄,2023-05-02,8562
2352,佳世達,61,18,43,新光-高雄,2023-05-02,8562
4979,華星光,63,23,40,新光-高雄,2023-05-02,8562
3058,立德,56,16,40,新光-高雄,2023-05-02,8562
00753L,中信中國50正2,204,166,38,新光-高雄,2023-05-02,8562
4153,鈺緯,37,0,37,新光-高雄,2023-05-02,8562
2603,長榮,57,22,35,新光-高雄,2023-05-02,8562
3363,上詮,82,48,34,新光-高雄,2023-05-02,8562
2634,漢翔,154,121,33,新光-高雄,2023-05-02,8562
2884,玉山金,40,8,32,新光-高雄,2023-05-02,8562
2104,國際中橡,30,0,30,新光-高雄,2023-05-02,8562
00773B,中信優先金融債,34,5,29,新光-高雄,2023-05-02,8562
4162,智擎,34,5,29,新光-高雄,2023-05-02,8562
5009,榮剛,47,19,28,新光-高雄,2023-05-02,8562
3491,昇達科,30,3,27,新光-高雄,2023-05-02,8562
8222,寶一,110,83,27,新光-高雄,2023-05-02,8562
6190,萬泰科,62,35,27,新光-高雄,2023-05-02,8562
6244,茂迪,59,33,26,新光-高雄,2023-05-02,8562
3033,威健,44,18,26,新光-高雄,2023-05-02,8562
1528,恩德,37,11,26,新光-高雄,2023-05-02,8562
00923,群益台ESG低碳50,23,0,23,新光-高雄,2023-05-02,8562
3715,定穎投控,43,20,23,新光-高雄,2023-05-02,8562
3017,奇鋐,85,63,22,新光-高雄,2023-05-02,8562
00671R,富邦NASDAQ反1,36,15,21,新光-高雄,2023-05-02,8562
2881,富邦金,21,0,21,新光-高雄,2023-05-02,8562
00715L,期街口布蘭特正2,703,35,668,新光-高雄,2023-05-03,8562
00712,復華富時不動產,346,0,346,新光-高雄,2023-05-03,8562
00642U,期元大S＆P石油,201,0,201,新光-高雄,2023-05-03,8562
00637L,元大滬深300正2,136,0,136,新光-高雄,2023-05-03,8562
1101,台泥,156,46,110,新光-高雄,2023-05-03,8562
3481,群創,159,91,68,新光-高雄,2023-05-03,8562
2603,長榮,92,30,62,新光-高雄,2023-05-03,8562
2317,鴻海,74,18,56,新光-高雄,2023-05-03,8562
9907,統一實,53,0,53,新光-高雄,2023-05-03,8562
8069,元太,94,43,51,新光-高雄,2023-05-03,8562
1701,中化,56,5,51,新光-高雄,2023-05-03,8562
3030,德律,51,0,51,新光-高雄,2023-05-03,8562
3202,樺晟,54,3,51,新光-高雄,2023-05-03,8562
00665L,富邦�琤肭磪囓�2,214,165,49,新光-高雄,2023-05-03,8562
2201,裕隆,62,14,48,新光-高雄,2023-05-03,8562
2801,彰銀,50,2,48,新光-高雄,2023-05-03,8562
2409,友達,48,0,48,新光-高雄,2023-05-03,8562
2337,旺宏,48,1,47,新光-高雄,2023-05-03,8562
2417,圓剛,64,17,47,新光-高雄,2023-05-03,8562
2344,華邦電,144,97,47,新光-高雄,2023-05-03,8562
3712,永崴投控,91,46,45,新光-高雄,2023-05-03,8562
2365,昆盈,40,1,39,新光-高雄,2023-05-03,8562
4909,新復興,44,8,36,新光-高雄,2023-05-03,8562
3231,緯創,63,27,36,新光-高雄,2023-05-03,8562
00690,兆豐藍籌30,35,0,35,新光-高雄,2023-05-03,8562
1905,華紙,275,241,34,新光-高雄,2023-05-03,8562
4153,鈺緯,34,0,34,新光-高雄,2023-05-03,8562
4306,炎洲,34,1,33,新光-高雄,2023-05-03,8562
3624,光頡,70,37,33,新光-高雄,2023-05-03,8562
5864,致和證,32,0,32,新光-高雄,2023-05-03,8562
2609,陽明,50,18,32,新光-高雄,2023-05-03,8562
2892,第一金,33,2,31,新光-高雄,2023-05-03,8562
1514,亞力,117,87,30,新光-高雄,2023-05-03,8562
2615,萬海,53,23,30,新光-高雄,2023-05-03,8562
2206,三陽工業,65,37,28,新光-高雄,2023-05-03,8562
2913,農林,52,25,27,新光-高雄,2023-05-03,8562
00753L,中信中國50正2,57,30,27,新光-高雄,2023-05-03,8562
00893,國泰智能電動車,27,0,27,新光-高雄,2023-05-03,8562
3296,勝德,27,0,27,新光-高雄,2023-05-03,8562
2834,臺企銀,359,334,25,新光-高雄,2023-05-03,8562
2634,漢翔,169,144,25,新光-高雄,2023-05-03,8562
00680L,元大美債20正2,38,15,23,新光-高雄,2023-05-03,8562
2464,盟立,22,0,22,新光-高雄,2023-05-03,8562
3236,千如,25,4,21,新光-高雄,2023-05-03,8562
3682,亞太電,20,0,20,新光-高雄,2023-05-03,8562
4968,立積,69,49,20,新光-高雄,2023-05-03,8562
3013,晟銘電,24,4,20,新光-高雄,2023-05-03,8562
2880,華南金,25,6,19,新光-高雄,2023-05-03,8562
2882,國泰金,23,4,19,新光-高雄,2023-05-03,8562
1519,華城,64,46,18,新光-高雄,2023-05-03,8562
00715L,期街口布蘭特正2,1431,47,1384,新光-高雄,2023-05-04,8562
00642U,期元大S＆P石油,171,0,171,新光-高雄,2023-05-04,8562
2867,三商壽,161,0,161,新光-高雄,2023-05-04,8562
00878,國泰永續高股息,120,39,81,新光-高雄,2023-05-04,8562
00712,復華富時不動產,78,2,76,新光-高雄,2023-05-04,8562
4968,立積,94,40,54,新光-高雄,2023-05-04,8562
00902,中信電池及儲能,50,0,50,新光-高雄,2023-05-04,8562
00772B,中信高評級公司債,49,0,49,新光-高雄,2023-05-04,8562
00690,兆豐藍籌30,52,3,49,新光-高雄,2023-05-04,8562
2464,盟立,48,0,48,新光-高雄,2023-05-04,8562
2489,瑞軒,92,50,42,新光-高雄,2023-05-04,8562
3188,鑫龍騰,39,1,38,新光-高雄,2023-05-04,8562
1102,亞泥,41,4,37,新光-高雄,2023-05-04,8562
6209,今國光,51,15,36,新光-高雄,2023-05-04,8562
9105,泰金寶-DR,34,0,34,新光-高雄,2023-05-04,8562
2344,華邦電,51,20,31,新光-高雄,2023-05-04,8562
2417,圓剛,31,0,31,新光-高雄,2023-05-04,8562
4306,炎洲,34,4,30,新光-高雄,2023-05-04,8562
00687B,國泰20年美債,29,0,29,新光-高雄,2023-05-04,8562
6510,精測,29,0,29,新光-高雄,2023-05-04,8562
3006,晶豪科,34,7,27,新光-高雄,2023-05-04,8562
1701,中化,37,10,27,新光-高雄,2023-05-04,8562
00720B,元大投資級公司債,63,36,27,新光-高雄,2023-05-04,8562
1514,亞力,56,30,26,新光-高雄,2023-05-04,8562
4153,鈺緯,24,0,24,新光-高雄,2023-05-04,8562
3276,宇環,25,3,22,新光-高雄,2023-05-04,8562
3083,網龍,27,6,21,新光-高雄,2023-05-04,8562
3715,定穎投控,98,77,21,新光-高雄,2023-05-04,8562
1714,和桐,21,0,21,新光-高雄,2023-05-04,8562
00751B,元大AAA至A公司債,20,1,19,新光-高雄,2023-05-04,8562
2230,泰茂,25,6,19,新光-高雄,2023-05-04,8562
3419,譁裕,114,95,19,新光-高雄,2023-05-04,8562
5425,台半,21,3,18,新光-高雄,2023-05-04,8562
6266,泰詠,21,3,18,新光-高雄,2023-05-04,8562
5351,鈺創,19,1,18,新光-高雄,2023-05-04,8562
1711,永光,25,7,18,新光-高雄,2023-05-04,8562
4114,健喬,44,26,18,新光-高雄,2023-05-04,8562
8046,南電,49,32,17,新光-高雄,2023-05-04,8562
2801,彰銀,18,1,17,新光-高雄,2023-05-04,8562
2913,農林,54,37,17,新光-高雄,2023-05-04,8562
1809,中釉,20,4,16,新光-高雄,2023-05-04,8562
6005,群益證,20,4,16,新光-高雄,2023-05-04,8562
6625,必應,35,19,16,新光-高雄,2023-05-04,8562
8085,福華,20,5,15,新光-高雄,2023-05-04,8562
4123,晟德,23,8,15,新光-高雄,2023-05-04,8562
2883B,凱基金乙特,19,4,15,新光-高雄,2023-05-04,8562
2897,王道銀行,15,0,15,新光-高雄,2023-05-04,8562
2609,陽明,39,25,14,新光-高雄,2023-05-04,8562
4722,國精化,14,0,14,新光-高雄,2023-05-04,8562
2402,毅嘉,14,0,14,新光-高雄,2023-05-04,8562
00715L,期街口布蘭特正2,460,46,414,新光-高雄,2023-05-05,8562
00878,國泰永續高股息,222,35,187,新光-高雄,2023-05-05,8562
00679B,元大美債20年,176,58,118,新光-高雄,2023-05-05,8562
4532,瑞智,105,0,105,新光-高雄,2023-05-05,8562
2834,臺企銀,123,26,97,新光-高雄,2023-05-05,8562
00720B,元大投資級公司債,92,5,87,新光-高雄,2023-05-05,8562
00687B,國泰20年美債,78,2,76,新光-高雄,2023-05-05,8562
00642U,期元大S＆P石油,69,0,69,新光-高雄,2023-05-05,8562
3576,聯合再生,110,45,65,新光-高雄,2023-05-05,8562
2883B,凱基金乙特,65,0,65,新光-高雄,2023-05-05,8562
5009,榮剛,108,45,63,新光-高雄,2023-05-05,8562
2344,華邦電,192,133,59,新光-高雄,2023-05-05,8562
6218,豪勉,99,40,59,新光-高雄,2023-05-05,8562
00712,復華富時不動產,88,32,56,新光-高雄,2023-05-05,8562
2897,王道銀行,68,12,56,新光-高雄,2023-05-05,8562
1609,大亞,348,297,51,新光-高雄,2023-05-05,8562
2353,宏��,54,10,44,新光-高雄,2023-05-05,8562
3037,欣興,108,65,43,新光-高雄,2023-05-05,8562
00751B,元大AAA至A公司債,43,0,43,新光-高雄,2023-05-05,8562
00830,國泰費城半導體,39,1,38,新光-高雄,2023-05-05,8562
1101,台泥,49,11,38,新光-高雄,2023-05-05,8562
9904,寶成,34,0,34,新光-高雄,2023-05-05,8562
3596,智易,56,23,33,新光-高雄,2023-05-05,8562
1529,樂事綠能,40,13,27,新光-高雄,2023-05-05,8562
3338,泰碩,55,29,26,新光-高雄,2023-05-05,8562
00713,元大台灣高息低波,38,13,25,新光-高雄,2023-05-05,8562
1307,三芳,29,4,25,新光-高雄,2023-05-05,8562
3712,永崴投控,32,9,23,新光-高雄,2023-05-05,8562
2002,中鋼,24,2,22,新光-高雄,2023-05-05,8562
8936,國統,43,21,22,新光-高雄,2023-05-05,8562
3687,歐買尬,27,6,21,新光-高雄,2023-05-05,8562
1776,展宇,24,4,20,新光-高雄,2023-05-05,8562
5876,上海商銀,18,0,18,新光-高雄,2023-05-05,8562
4129,聯合,17,0,17,新光-高雄,2023-05-05,8562
2515,中工,34,17,17,新光-高雄,2023-05-05,8562
4109,加捷生醫,17,0,17,新光-高雄,2023-05-05,8562
5340,建榮,17,0,17,新光-高雄,2023-05-05,8562
8926,台汽電,19,2,17,新光-高雄,2023-05-05,8562
6244,茂迪,75,59,16,新光-高雄,2023-05-05,8562
2603,長榮,19,3,16,新光-高雄,2023-05-05,8562
1310,台苯,18,3,15,新光-高雄,2023-05-05,8562
4909,新復興,72,57,15,新光-高雄,2023-05-05,8562
2471,資通,47,33,14,新光-高雄,2023-05-05,8562
3701,大眾控,17,3,14,新光-高雄,2023-05-05,8562
5236,凌陽創新,14,0,14,新光-高雄,2023-05-05,8562
2903,遠百,14,0,14,新光-高雄,2023-05-05,8562
5351,鈺創,13,0,13,新光-高雄,2023-05-05,8562
6456,GIS-KY,13,0,13,新光-高雄,2023-05-05,8562
8937,合騏,12,0,12,新光-高雄,2023-05-05,8562
4160,訊聯基因,13,1,12,新光-高雄,2023-05-05,8562
3715,定穎投控,651,209,442,新光-高雄,2023-05-08,8562
00687B,國泰20年美債,425,2,423,新光-高雄,2023-05-08,8562
5864,致和證,417,1,416,新光-高雄,2023-05-08,8562
00715L,期街口布蘭特正2,627,306,321,新光-高雄,2023-05-08,8562
00632R,元大台灣50反1,172,22,150,新光-高雄,2023-05-08,8562
2884,玉山金,172,47,125,新光-高雄,2023-05-08,8562
1218,泰山,117,23,94,新光-高雄,2023-05-08,8562
8930,青鋼,92,0,92,新光-高雄,2023-05-08,8562
2883,凱基金,516,431,85,新光-高雄,2023-05-08,8562
2867,三商壽,109,25,84,新光-高雄,2023-05-08,8562
00669R,國泰美國道瓊反1,88,10,78,新光-高雄,2023-05-08,8562
00675L,富邦臺灣加權正2,69,7,62,新光-高雄,2023-05-08,8562
2851,中再保,85,23,62,新光-高雄,2023-05-08,8562
2883B,凱基金乙特,58,0,58,新光-高雄,2023-05-08,8562
00878,國泰永續高股息,134,80,54,新光-高雄,2023-05-08,8562
00720B,元大投資級公司債,54,3,51,新光-高雄,2023-05-08,8562
1611,中電,58,8,50,新光-高雄,2023-05-08,8562
5464,霖宏,49,0,49,新光-高雄,2023-05-08,8562
2382,廣達,64,15,49,新光-高雄,2023-05-08,8562
4173,久裕,58,12,46,新光-高雄,2023-05-08,8562
2014,中鴻,46,1,45,新光-高雄,2023-05-08,8562
2888,新光金,46,2,44,新光-高雄,2023-05-08,8562
6167,久正,42,0,42,新光-高雄,2023-05-08,8562
00706L,期元大S＆P日圓正2,41,0,41,新光-高雄,2023-05-08,8562
2464,盟立,39,0,39,新光-高雄,2023-05-08,8562
1605,華新,102,63,39,新光-高雄,2023-05-08,8562
00674R,期元大S＆P黃金反1,37,0,37,新光-高雄,2023-05-08,8562
2492,華新科,56,24,32,新光-高雄,2023-05-08,8562
2880,華南金,40,12,28,新光-高雄,2023-05-08,8562
2812,台中銀,116,89,27,新光-高雄,2023-05-08,8562
00680L,元大美債20正2,37,10,27,新光-高雄,2023-05-08,8562
4161,聿新科,36,9,27,新光-高雄,2023-05-08,8562
1314,中石化,26,0,26,新光-高雄,2023-05-08,8562
1701,中化,25,0,25,新光-高雄,2023-05-08,8562
4121,優盛,29,5,24,新光-高雄,2023-05-08,8562
1307,三芳,30,6,24,新光-高雄,2023-05-08,8562
1904,正隆,30,7,23,新光-高雄,2023-05-08,8562
5009,榮剛,37,14,23,新光-高雄,2023-05-08,8562
3481,群創,93,71,22,新光-高雄,2023-05-08,8562
3005,神基,64,42,22,新光-高雄,2023-05-08,8562
1101,台泥,57,35,22,新光-高雄,2023-05-08,8562
1319,東陽,38,16,22,新光-高雄,2023-05-08,8562
00891,中信關鍵半導體,22,1,21,新光-高雄,2023-05-08,8562
3703,欣陸,22,1,21,新光-高雄,2023-05-08,8562
3484,崧騰,21,0,21,新光-高雄,2023-05-08,8562
3025,星通,36,15,21,新光-高雄,2023-05-08,8562
4303,信立,21,0,21,新光-高雄,2023-05-08,8562
2601,益航,20,0,20,新光-高雄,2023-05-08,8562
00772B,中信高評級公司債,23,3,20,新光-高雄,2023-05-08,8562
2897,王道銀行,19,0,19,新光-高雄,2023-05-08,8562
5864,致和證,374,0,374,新光-高雄,2023-05-09,8562
00680L,元大美債20正2,276,8,268,新光-高雄,2023-05-09,8562
00715L,期街口布蘭特正2,665,538,127,新光-高雄,2023-05-09,8562
00687B,國泰20年美債,124,1,123,新光-高雄,2023-05-09,8562
4303,信立,116,0,116,新光-高雄,2023-05-09,8562
1101,台泥,115,28,87,新光-高雄,2023-05-09,8562
00712,復華富時不動產,84,4,80,新光-高雄,2023-05-09,8562
00795B,中信美國公債20年,80,0,80,新光-高雄,2023-05-09,8562
00706L,期元大S＆P日圓正2,76,0,76,新光-高雄,2023-05-09,8562
2834,臺企銀,79,21,58,新光-高雄,2023-05-09,8562
00751B,元大AAA至A公司債,60,10,50,新光-高雄,2023-05-09,8562
3712,永崴投控,55,6,49,新光-高雄,2023-05-09,8562
1905,華紙,257,208,49,新光-高雄,2023-05-09,8562
00720B,元大投資級公司債,64,16,48,新光-高雄,2023-05-09,8562
2801,彰銀,43,0,43,新光-高雄,2023-05-09,8562
00669R,國泰美國道瓊反1,42,0,42,新光-高雄,2023-05-09,8562
00857B,永豐20年美公債,48,7,41,新光-高雄,2023-05-09,8562
3528,安馳,40,0,40,新光-高雄,2023-05-09,8562
3481,群創,136,97,39,新光-高雄,2023-05-09,8562
1314,中石化,38,2,36,新光-高雄,2023-05-09,8562
1519,華城,178,144,34,新光-高雄,2023-05-09,8562
00713,元大台灣高息低波,44,13,31,新光-高雄,2023-05-09,8562
1589,永冠-KY,31,1,30,新光-高雄,2023-05-09,8562
3596,智易,65,35,30,新光-高雄,2023-05-09,8562
2337,旺宏,74,45,29,新光-高雄,2023-05-09,8562
00674R,期元大S＆P黃金反1,29,0,29,新光-高雄,2023-05-09,8562
2486,一詮,30,2,28,新光-高雄,2023-05-09,8562
2402,毅嘉,55,28,27,新光-高雄,2023-05-09,8562
9907,統一實,27,0,27,新光-高雄,2023-05-09,8562
00853B,統一美債10年Aa-,26,0,26,新光-高雄,2023-05-09,8562
1504,東元,104,78,26,新光-高雄,2023-05-09,8562
2498,宏達電,29,4,25,新光-高雄,2023-05-09,8562
3362,先進光,25,0,25,新光-高雄,2023-05-09,8562
8478,東哥遊艇,32,9,23,新光-高雄,2023-05-09,8562
9904,寶成,24,2,22,新光-高雄,2023-05-09,8562
3296,勝德,24,3,21,新光-高雄,2023-05-09,8562
1609,大亞,164,144,20,新光-高雄,2023-05-09,8562
00925,新光標普電動車,20,0,20,新光-高雄,2023-05-09,8562
9955,佳龍,22,2,20,新光-高雄,2023-05-09,8562
2002,中鋼,22,3,19,新光-高雄,2023-05-09,8562
2027,大成鋼,26,7,19,新光-高雄,2023-05-09,8562
6153,嘉聯益,19,0,19,新光-高雄,2023-05-09,8562
4919,新唐,22,4,18,新光-高雄,2023-05-09,8562
3058,立德,34,17,17,新光-高雄,2023-05-09,8562
3029,零壹,45,28,17,新光-高雄,2023-05-09,8562
00830,國泰費城半導體,30,14,16,新光-高雄,2023-05-09,8562
2634,漢翔,63,47,16,新光-高雄,2023-05-09,8562
1802,台玻,16,0,16,新光-高雄,2023-05-09,8562
6538,倉和,27,11,16,新光-高雄,2023-05-09,8562
3402,漢科,16,0,16,新光-高雄,2023-05-09,8562
00637L,元大滬深300正2,606,42,564,新光-高雄,2023-05-10,8562
00680L,元大美債20正2,200,0,200,新光-高雄,2023-05-10,8562
00878,國泰永續高股息,212,35,177,新光-高雄,2023-05-10,8562
00713,元大台灣高息低波,130,10,120,新光-高雄,2023-05-10,8562
00738U,期元大道瓊白銀,100,0,100,新光-高雄,2023-05-10,8562
1314,中石化,109,10,99,新光-高雄,2023-05-10,8562
00687B,國泰20年美債,94,13,81,新光-高雄,2023-05-10,8562
00655L,國泰中國A50正2,87,6,81,新光-高雄,2023-05-10,8562
2832,台產,75,2,73,新光-高雄,2023-05-10,8562
2834,臺企銀,76,6,70,新光-高雄,2023-05-10,8562
2352,佳世達,89,20,69,新光-高雄,2023-05-10,8562
00712,復華富時不動產,66,0,66,新光-高雄,2023-05-10,8562
00795B,中信美國公債20年,66,1,65,新光-高雄,2023-05-10,8562
3202,樺晟,116,57,59,新光-高雄,2023-05-10,8562
00665L,富邦�琤肭磪囓�2,58,5,53,新光-高雄,2023-05-10,8562
4916,事欣科,53,2,51,新光-高雄,2023-05-10,8562
3231,緯創,185,143,42,新光-高雄,2023-05-10,8562
3013,晟銘電,70,28,42,新光-高雄,2023-05-10,8562
00772B,中信高評級公司債,46,5,41,新光-高雄,2023-05-10,8562
00664R,國泰臺灣加權反1,50,10,40,新光-高雄,2023-05-10,8562
6139,亞翔,52,12,40,新光-高雄,2023-05-10,8562
1312,國喬,38,0,38,新光-高雄,2023-05-10,8562
00706L,期元大S＆P日圓正2,37,0,37,新光-高雄,2023-05-10,8562
00633L,富邦上証正2,37,2,35,新光-高雄,2023-05-10,8562
1340,勝悅-KY,34,0,34,新光-高雄,2023-05-10,8562
2890,永豐金,35,1,34,新光-高雄,2023-05-10,8562
1701,中化,37,3,34,新光-高雄,2023-05-10,8562
2337,旺宏,33,0,33,新光-高雄,2023-05-10,8562
5425,台半,38,6,32,新光-高雄,2023-05-10,8562
3694,海華,38,7,31,新光-高雄,2023-05-10,8562
00679B,元大美債20年,67,37,30,新光-高雄,2023-05-10,8562
00720B,元大投資級公司債,32,2,30,新光-高雄,2023-05-10,8562
6806,森崴能源,92,62,30,新光-高雄,2023-05-10,8562
5864,致和證,29,0,29,新光-高雄,2023-05-10,8562
2851,中再保,29,0,29,新光-高雄,2023-05-10,8562
8926,台汽電,31,3,28,新光-高雄,2023-05-10,8562
00669R,國泰美國道瓊反1,27,0,27,新光-高雄,2023-05-10,8562
00888,永豐台灣ESG,27,0,27,新光-高雄,2023-05-10,8562
00753L,中信中國50正2,26,0,26,新光-高雄,2023-05-10,8562
00751B,元大AAA至A公司債,24,0,24,新光-高雄,2023-05-10,8562
3051,力特,24,0,24,新光-高雄,2023-05-10,8562
9945,潤泰新,25,1,24,新光-高雄,2023-05-10,8562
4417,金洲,22,0,22,新光-高雄,2023-05-10,8562
6274,台燿,24,3,21,新光-高雄,2023-05-10,8562
4967,十銓,46,25,21,新光-高雄,2023-05-10,8562
1519,華城,54,34,20,新光-高雄,2023-05-10,8562
9904,寶成,20,0,20,新光-高雄,2023-05-10,8562
00881,國泰台灣5G+,21,2,19,新光-高雄,2023-05-10,8562
5009,榮剛,37,18,19,新光-高雄,2023-05-10,8562
1337,再生-KY,30,11,19,新光-高雄,2023-05-10,8562
00878,國泰永續高股息,314,58,256,新光-高雄,2023-05-11,8562
00664R,國泰臺灣加權反1,208,9,199,新光-高雄,2023-05-11,8562
2867,三商壽,235,54,181,新光-高雄,2023-05-11,8562
9907,統一實,146,16,130,新光-高雄,2023-05-11,8562
00679B,元大美債20年,121,9,112,新光-高雄,2023-05-11,8562
6570,維田,134,23,111,新光-高雄,2023-05-11,8562
3711,日月光投控,92,7,85,新光-高雄,2023-05-11,8562
2610,華航,151,67,84,新光-高雄,2023-05-11,8562
00900,富邦特選高股息30,84,0,84,新光-高雄,2023-05-11,8562
00680L,元大美債20正2,90,13,77,新光-高雄,2023-05-11,8562
3576,聯合再生,75,0,75,新光-高雄,2023-05-11,8562
00713,元大台灣高息低波,83,13,70,新光-高雄,2023-05-11,8562
00795B,中信美國公債20年,64,2,62,新光-高雄,2023-05-11,8562
00671R,富邦NASDAQ反1,65,5,60,新光-高雄,2023-05-11,8562
2890,永豐金,55,0,55,新光-高雄,2023-05-11,8562
00669R,國泰美國道瓊反1,54,1,53,新光-高雄,2023-05-11,8562
3058,立德,57,4,53,新光-高雄,2023-05-11,8562
2851,中再保,51,0,51,新光-高雄,2023-05-11,8562
00637L,元大滬深300正2,89,39,50,新光-高雄,2023-05-11,8562
2897,王道銀行,50,0,50,新光-高雄,2023-05-11,8562
3035,智原,57,7,50,新光-高雄,2023-05-11,8562
4977,眾達-KY,48,2,46,新光-高雄,2023-05-11,8562
3481,群創,85,40,45,新光-高雄,2023-05-11,8562
1522,堤維西,45,1,44,新光-高雄,2023-05-11,8562
3296,勝德,66,24,42,新光-高雄,2023-05-11,8562
1447,力鵬,41,0,41,新光-高雄,2023-05-11,8562
2337,旺宏,41,0,41,新光-高雄,2023-05-11,8562
00888,永豐台灣ESG,36,0,36,新光-高雄,2023-05-11,8562
1701,中化,41,5,36,新光-高雄,2023-05-11,8562
6219,富旺,35,0,35,新光-高雄,2023-05-11,8562
2486,一詮,43,8,35,新光-高雄,2023-05-11,8562
6122,擎邦,142,108,34,新光-高雄,2023-05-11,8562
2618,長榮航,95,61,34,新光-高雄,2023-05-11,8562
6285,啟��,99,65,34,新光-高雄,2023-05-11,8562
00665L,富邦�琤肭磪囓�2,75,42,33,新光-高雄,2023-05-11,8562
1312,國喬,36,3,33,新光-高雄,2023-05-11,8562
00753L,中信中國50正2,35,3,32,新光-高雄,2023-05-11,8562
2883,凱基金,44,13,31,新光-高雄,2023-05-11,8562
2409,友達,41,10,31,新光-高雄,2023-05-11,8562
3062,建漢,35,5,30,新光-高雄,2023-05-11,8562
2022,聚亨,31,1,30,新光-高雄,2023-05-11,8562
2748,雲品,33,4,29,新光-高雄,2023-05-11,8562
4744,皇將,82,54,28,新光-高雄,2023-05-11,8562
2332,友訊,31,3,28,新光-高雄,2023-05-11,8562
2609,陽明,47,20,27,新光-高雄,2023-05-11,8562
3325,旭品,37,10,27,新光-高雄,2023-05-11,8562
2014,中鴻,31,4,27,新光-高雄,2023-05-11,8562
5009,榮剛,63,36,27,新光-高雄,2023-05-11,8562
4526,東台,26,0,26,新光-高雄,2023-05-11,8562
6160,欣技,46,20,26,新光-高雄,2023-05-11,8562
00715L,期街口布蘭特正2,639,297,342,新光-高雄,2023-05-12,8562
00637L,元大滬深300正2,281,34,247,新光-高雄,2023-05-12,8562
3363,上詮,226,8,218,新光-高雄,2023-05-12,8562
00673R,期元大S＆P原油反1,213,5,208,新光-高雄,2023-05-12,8562
00888,永豐台灣ESG,198,0,198,新光-高雄,2023-05-12,8562
00632R,元大台灣50反1,330,136,194,新光-高雄,2023-05-12,8562
2882,國泰金,133,7,126,新光-高雄,2023-05-12,8562
2888,新光金,133,8,125,新光-高雄,2023-05-12,8562
2317,鴻海,206,92,114,新光-高雄,2023-05-12,8562
2883,凱基金,110,4,106,新光-高雄,2023-05-12,8562
3037,欣興,124,32,92,新光-高雄,2023-05-12,8562
8163,達方,90,5,85,新光-高雄,2023-05-12,8562
3576,聯合再生,83,8,75,新光-高雄,2023-05-12,8562
2890,永豐金,70,0,70,新光-高雄,2023-05-12,8562
00882,中信中國高股息,72,2,70,新光-高雄,2023-05-12,8562
1314,中石化,59,0,59,新光-高雄,2023-05-12,8562
00712,復華富時不動產,57,0,57,新光-高雄,2023-05-12,8562
00878,國泰永續高股息,95,40,55,新光-高雄,2023-05-12,8562
2867,三商壽,51,0,51,新光-高雄,2023-05-12,8562
00907,永豐優息存股,50,0,50,新光-高雄,2023-05-12,8562
5483,中美晶,43,3,40,新光-高雄,2023-05-12,8562
1101,台泥,54,16,38,新光-高雄,2023-05-12,8562
8076,伍豐,82,46,36,新光-高雄,2023-05-12,8562
00671R,富邦NASDAQ反1,30,0,30,新光-高雄,2023-05-12,8562
6187,萬潤,31,1,30,新光-高雄,2023-05-12,8562
6276,安鈦克,33,4,29,新光-高雄,2023-05-12,8562
00642U,期元大S＆P石油,80,51,29,新光-高雄,2023-05-12,8562
2409,友達,28,0,28,新光-高雄,2023-05-12,8562
6163,華電網,29,2,27,新光-高雄,2023-05-12,8562
6285,啟��,74,49,25,新光-高雄,2023-05-12,8562
6126,信音,28,3,25,新光-高雄,2023-05-12,8562
2618,長榮航,47,23,24,新光-高雄,2023-05-12,8562
2014,中鴻,40,16,24,新光-高雄,2023-05-12,8562
00633L,富邦上証正2,34,10,24,新光-高雄,2023-05-12,8562
2832,台產,23,0,23,新光-高雄,2023-05-12,8562
00676R,富邦臺灣加權反1,20,0,20,新光-高雄,2023-05-12,8562
4306,炎洲,24,6,18,新光-高雄,2023-05-12,8562
2887,台新金,38,21,17,新光-高雄,2023-05-12,8562
9945,潤泰新,17,0,17,新光-高雄,2023-05-12,8562
2885,元大金,17,1,16,新光-高雄,2023-05-12,8562
6223,旺矽,16,0,16,新光-高雄,2023-05-12,8562
2892,第一金,15,0,15,新光-高雄,2023-05-12,8562
8050,廣積,20,5,15,新光-高雄,2023-05-12,8562
1611,中電,18,3,15,新光-高雄,2023-05-12,8562
1608,華榮,101,86,15,新光-高雄,2023-05-12,8562
4743,合一,27,12,15,新光-高雄,2023-05-12,8562
2801,彰銀,15,1,14,新光-高雄,2023-05-12,8562
1609,大亞,70,56,14,新光-高雄,2023-05-12,8562
1310,台苯,17,4,13,新光-高雄,2023-05-12,8562
1584,精剛,71,58,13,新光-高雄,2023-05-12,8562
2317,鴻海,434,5,429,新光-高雄,2023-05-15,8562
00706L,期元大S＆P日圓正2,220,0,220,新光-高雄,2023-05-15,8562
00673R,期元大S＆P原油反1,120,12,108,新光-高雄,2023-05-15,8562
00885,富邦越南,108,14,94,新光-高雄,2023-05-15,8562
00642U,期元大S＆P石油,94,0,94,新光-高雄,2023-05-15,8562
00632R,元大台灣50反1,82,10,72,新光-高雄,2023-05-15,8562
00679B,元大美債20年,83,15,68,新光-高雄,2023-05-15,8562
9904,寶成,63,0,63,新光-高雄,2023-05-15,8562
00751B,元大AAA至A公司債,58,1,57,新光-高雄,2023-05-15,8562
00878,國泰永續高股息,114,58,56,新光-高雄,2023-05-15,8562
2371,大同,248,194,54,新光-高雄,2023-05-15,8562
3231,緯創,142,93,49,新光-高雄,2023-05-15,8562
00637L,元大滬深300正2,109,66,43,新光-高雄,2023-05-15,8562
2610,華航,60,17,43,新光-高雄,2023-05-15,8562
00687B,國泰20年美債,55,13,42,新光-高雄,2023-05-15,8562
8936,國統,51,9,42,新光-高雄,2023-05-15,8562
3712,永崴投控,46,8,38,新光-高雄,2023-05-15,8562
2331,精英,102,64,38,新光-高雄,2023-05-15,8562
00882,中信中國高股息,37,2,35,新光-高雄,2023-05-15,8562
00713,元大台灣高息低波,34,0,34,新光-高雄,2023-05-15,8562
5511,德昌,35,2,33,新光-高雄,2023-05-15,8562
2457,飛宏,174,141,33,新光-高雄,2023-05-15,8562
2542,興富發,41,8,33,新光-高雄,2023-05-15,8562
6733,博晟生醫,40,8,32,新光-高雄,2023-05-15,8562
00772B,中信高評級公司債,32,0,32,新光-高雄,2023-05-15,8562
00669R,國泰美國道瓊反1,30,0,30,新光-高雄,2023-05-15,8562
2303,聯電,82,52,30,新光-高雄,2023-05-15,8562
00881,國泰台灣5G+,28,1,27,新光-高雄,2023-05-15,8562
3617,碩天,39,12,27,新光-高雄,2023-05-15,8562
2332,友訊,32,6,26,新光-高雄,2023-05-15,8562
6122,擎邦,133,109,24,新光-高雄,2023-05-15,8562
2328,廣宇,23,0,23,新光-高雄,2023-05-15,8562
00680L,元大美債20正2,82,59,23,新光-高雄,2023-05-15,8562
3037,欣興,40,18,22,新光-高雄,2023-05-15,8562
1905,華紙,74,53,21,新光-高雄,2023-05-15,8562
1504,東元,124,103,21,新光-高雄,2023-05-15,8562
2382,廣達,64,44,20,新光-高雄,2023-05-15,8562
8940,新天地,21,1,20,新光-高雄,2023-05-15,8562
5258,虹堡,63,44,19,新光-高雄,2023-05-15,8562
1522,堤維西,18,0,18,新光-高雄,2023-05-15,8562
00795B,中信美國公債20年,34,16,18,新光-高雄,2023-05-15,8562
9939,宏全,19,2,17,新光-高雄,2023-05-15,8562
2364,倫飛,21,5,16,新光-高雄,2023-05-15,8562
1802,台玻,16,0,16,新光-高雄,2023-05-15,8562
2812,台中銀,45,29,16,新光-高雄,2023-05-15,8562
00712,復華富時不動產,16,1,15,新光-高雄,2023-05-15,8562
2460,建通,31,16,15,新光-高雄,2023-05-15,8562
00633L,富邦上証正2,44,29,15,新光-高雄,2023-05-15,8562
5871,中租-KY,23,8,15,新光-高雄,2023-05-15,8562
00720B,元大投資級公司債,23,9,14,新光-高雄,2023-05-15,8562
2867,三商壽,201,20,181,新光-高雄,2023-05-16,8562
00687B,國泰20年美債,158,1,157,新光-高雄,2023-05-16,8562
00680L,元大美債20正2,152,0,152,新光-高雄,2023-05-16,8562
2317,鴻海,198,59,139,新光-高雄,2023-05-16,8562
00751B,元大AAA至A公司債,136,0,136,新光-高雄,2023-05-16,8562
00632R,元大台灣50反1,382,248,134,新光-高雄,2023-05-16,8562
00772B,中信高評級公司債,109,0,109,新光-高雄,2023-05-16,8562
00878,國泰永續高股息,451,351,100,新光-高雄,2023-05-16,8562
2331,精英,116,22,94,新光-高雄,2023-05-16,8562
00720B,元大投資級公司債,89,2,87,新光-高雄,2023-05-16,8562
3481,群創,75,13,62,新光-高雄,2023-05-16,8562
00795B,中信美國公債20年,60,0,60,新光-高雄,2023-05-16,8562
00712,復華富時不動產,49,0,49,新光-高雄,2023-05-16,8562
0056,元大高股息,74,26,48,新光-高雄,2023-05-16,8562
00706L,期元大S＆P日圓正2,73,25,48,新光-高雄,2023-05-16,8562
1709,和益,33,0,33,新光-高雄,2023-05-16,8562
3264,欣銓,31,0,31,新光-高雄,2023-05-16,8562
1337,再生-KY,55,25,30,新光-高雄,2023-05-16,8562
2731,雄獅,68,40,28,新光-高雄,2023-05-16,8562
00885,富邦越南,39,12,27,新光-高雄,2023-05-16,8562
3540,曜越,58,31,27,新光-高雄,2023-05-16,8562
00753L,中信中國50正2,34,10,24,新光-高雄,2023-05-16,8562
1905,華紙,77,54,23,新光-高雄,2023-05-16,8562
1304,台聚,23,0,23,新光-高雄,2023-05-16,8562
2851,中再保,29,6,23,新光-高雄,2023-05-16,8562
3710,連展投控,23,0,23,新光-高雄,2023-05-16,8562
1568,倉佑,20,0,20,新光-高雄,2023-05-16,8562
3010,華立,22,2,20,新光-高雄,2023-05-16,8562
3035,智原,30,11,19,新光-高雄,2023-05-16,8562
5880,合庫金,25,7,18,新光-高雄,2023-05-16,8562
1504,東元,55,39,16,新光-高雄,2023-05-16,8562
00676R,富邦臺灣加權反1,16,0,16,新光-高雄,2023-05-16,8562
2313,華通,30,14,16,新光-高雄,2023-05-16,8562
1314,中石化,24,9,15,新光-高雄,2023-05-16,8562
2605,新興,16,1,15,新光-高雄,2023-05-16,8562
3594,磐儀,23,8,15,新光-高雄,2023-05-16,8562
1307,三芳,15,0,15,新光-高雄,2023-05-16,8562
3580,友威科,15,0,15,新光-高雄,2023-05-16,8562
00902,中信電池及儲能,21,7,14,新光-高雄,2023-05-16,8562
5425,台半,32,19,13,新光-高雄,2023-05-16,8562
3265,台星科,13,0,13,新光-高雄,2023-05-16,8562
2002,中鋼,20,8,12,新光-高雄,2023-05-16,8562
2601,益航,13,1,12,新光-高雄,2023-05-16,8562
1721,三晃,49,37,12,新光-高雄,2023-05-16,8562
6152,百一,12,0,12,新光-高雄,2023-05-16,8562
2603,長榮,18,7,11,新光-高雄,2023-05-16,8562
2498,宏達電,41,30,11,新光-高雄,2023-05-16,8562
2329,華泰,14,3,11,新光-高雄,2023-05-16,8562
3583,辛耘,13,2,11,新光-高雄,2023-05-16,8562
3673,TPK-KY,16,5,11,新光-高雄,2023-05-16,8562
00632R,元大台灣50反1,1133,216,917,新光-高雄,2023-05-17,8562
00878,國泰永續高股息,591,218,373,新光-高雄,2023-05-17,8562
00637L,元大滬深300正2,206,8,198,新光-高雄,2023-05-17,8562
00680L,元大美債20正2,109,0,109,新光-高雄,2023-05-17,8562
00679B,元大美債20年,113,10,103,新光-高雄,2023-05-17,8562
1101,台泥,121,21,100,新光-高雄,2023-05-17,8562
2368,金像電,132,35,97,新光-高雄,2023-05-17,8562
9945,潤泰新,100,7,93,新光-高雄,2023-05-17,8562
2882,國泰金,96,14,82,新光-高雄,2023-05-17,8562
3583,辛耘,89,9,80,新光-高雄,2023-05-17,8562
0056,元大高股息,114,37,77,新光-高雄,2023-05-17,8562
00690,兆豐藍籌30,75,1,74,新光-高雄,2023-05-17,8562
00642U,期元大S＆P石油,72,0,72,新光-高雄,2023-05-17,8562
00751B,元大AAA至A公司債,70,0,70,新光-高雄,2023-05-17,8562
00720B,元大投資級公司債,70,3,67,新光-高雄,2023-05-17,8562
8070,長華*,62,0,62,新光-高雄,2023-05-17,8562
3715,定穎投控,181,125,56,新光-高雄,2023-05-17,8562
2883B,凱基金乙特,53,0,53,新光-高雄,2023-05-17,8562
00676R,富邦臺灣加權反1,52,0,52,新光-高雄,2023-05-17,8562
8163,達方,50,1,49,新光-高雄,2023-05-17,8562
00795B,中信美國公債20年,47,0,47,新光-高雄,2023-05-17,8562
00882,中信中國高股息,41,0,41,新光-高雄,2023-05-17,8562
2495,普安,94,55,39,新光-高雄,2023-05-17,8562
2402,毅嘉,153,117,36,新光-高雄,2023-05-17,8562
00715L,期街口布蘭特正2,174,138,36,新光-高雄,2023-05-17,8562
00687B,國泰20年美債,42,6,36,新光-高雄,2023-05-17,8562
00633L,富邦上証正2,38,4,34,新光-高雄,2023-05-17,8562
00673R,期元大S＆P原油反1,43,10,33,新光-高雄,2023-05-17,8562
1584,精剛,73,42,31,新光-高雄,2023-05-17,8562
00772B,中信高評級公司債,29,0,29,新光-高雄,2023-05-17,8562
3010,華立,31,4,27,新光-高雄,2023-05-17,8562
1617,榮星,30,5,25,新光-高雄,2023-05-17,8562
5864,致和證,23,0,23,新光-高雄,2023-05-17,8562
6285,啟��,53,31,22,新光-高雄,2023-05-17,8562
2887,台新金,28,7,21,新光-高雄,2023-05-17,8562
9962,有益,20,0,20,新光-高雄,2023-05-17,8562
5356,協益,20,1,19,新光-高雄,2023-05-17,8562
3022,威強電,128,109,19,新光-高雄,2023-05-17,8562
6121,新普,18,0,18,新光-高雄,2023-05-17,8562
2313,華通,19,2,17,新光-高雄,2023-05-17,8562
2748,雲品,56,39,17,新光-高雄,2023-05-17,8562
4720,德淵,17,0,17,新光-高雄,2023-05-17,8562
2734,易飛網,18,1,17,新光-高雄,2023-05-17,8562
1609,大亞,76,60,16,新光-高雄,2023-05-17,8562
2352,佳世達,51,35,16,新光-高雄,2023-05-17,8562
3207,耀勝,37,22,15,新光-高雄,2023-05-17,8562
00908,富邦入息REITs+,15,0,15,新光-高雄,2023-05-17,8562
2915,潤泰全,16,2,14,新光-高雄,2023-05-17,8562
00853B,統一美債10年Aa-,14,0,14,新光-高雄,2023-05-17,8562
4973,廣穎,24,10,14,新光-高雄,2023-05-17,8562
00632R,元大台灣50反1,653,308,345,新光-高雄,2023-05-18,8562
00690,兆豐藍籌30,325,0,325,新光-高雄,2023-05-18,8562
00680L,元大美債20正2,307,0,307,新光-高雄,2023-05-18,8562
00706L,期元大S＆P日圓正2,231,0,231,新光-高雄,2023-05-18,8562
2834,臺企銀,267,67,200,新光-高雄,2023-05-18,8562
2393,億光,234,60,174,新光-高雄,2023-05-18,8562
00882,中信中國高股息,102,0,102,新光-高雄,2023-05-18,8562
00673R,期元大S＆P原油反1,83,10,73,新光-高雄,2023-05-18,8562
00751B,元大AAA至A公司債,73,1,72,新光-高雄,2023-05-18,8562
3703,欣陸,66,4,62,新光-高雄,2023-05-18,8562
2201,裕隆,72,13,59,新光-高雄,2023-05-18,8562
2634,漢翔,81,23,58,新光-高雄,2023-05-18,8562
1905,華紙,128,76,52,新光-高雄,2023-05-18,8562
1307,三芳,55,5,50,新光-高雄,2023-05-18,8562
6799,來頡,45,1,44,新光-高雄,2023-05-18,8562
2482,連宇,92,49,43,新光-高雄,2023-05-18,8562
00900,富邦特選高股息30,64,22,42,新光-高雄,2023-05-18,8562
00679B,元大美債20年,56,14,42,新光-高雄,2023-05-18,8562
00687B,國泰20年美債,44,5,39,新光-高雄,2023-05-18,8562
2867,三商壽,47,10,37,新光-高雄,2023-05-18,8562
8222,寶一,88,53,35,新光-高雄,2023-05-18,8562
00795B,中信美國公債20年,35,2,33,新光-高雄,2023-05-18,8562
1795,美時,121,89,32,新光-高雄,2023-05-18,8562
00676R,富邦臺灣加權反1,32,0,32,新光-高雄,2023-05-18,8562
00773B,中信優先金融債,32,1,31,新光-高雄,2023-05-18,8562
2323,中環,40,9,31,新光-高雄,2023-05-18,8562
2630,亞航,77,46,31,新光-高雄,2023-05-18,8562
00712,復華富時不動產,40,13,27,新光-高雄,2023-05-18,8562
00725B,國泰投資級公司債,26,1,25,新光-高雄,2023-05-18,8562
2812,台中銀,28,5,23,新光-高雄,2023-05-18,8562
6443,元晶,25,2,23,新光-高雄,2023-05-18,8562
2888,新光金,78,55,23,新光-高雄,2023-05-18,8562
3231,緯創,145,122,23,新光-高雄,2023-05-18,8562
1101,台泥,26,5,21,新光-高雄,2023-05-18,8562
8936,國統,70,50,20,新光-高雄,2023-05-18,8562
1584,精剛,146,126,20,新光-高雄,2023-05-18,8562
5211,蒙恬,32,13,19,新光-高雄,2023-05-18,8562
1216,統一,19,1,18,新光-高雄,2023-05-18,8562
8155,博智,41,23,18,新光-高雄,2023-05-18,8562
5324,士開,18,0,18,新光-高雄,2023-05-18,8562
00671R,富邦NASDAQ反1,20,2,18,新光-高雄,2023-05-18,8562
1605,華新,37,19,18,新光-高雄,2023-05-18,8562
5356,協益,23,6,17,新光-高雄,2023-05-18,8562
9921,巨大,19,3,16,新光-高雄,2023-05-18,8562
00631L,元大台灣50正2,27,11,16,新光-高雄,2023-05-18,8562
1582,信錦,16,0,16,新光-高雄,2023-05-18,8562
6589,台康生技,20,4,16,新光-高雄,2023-05-18,8562
5328,華容,16,0,16,新光-高雄,2023-05-18,8562
3362,先進光,39,23,16,新光-高雄,2023-05-18,8562
1709,和益,16,1,15,新光-高雄,2023-05-18,8562
00680L,元大美債20正2,322,16,306,新光-高雄,2023-05-19,8562
00706L,期元大S＆P日圓正2,238,28,210,新光-高雄,2023-05-19,8562
00637L,元大滬深300正2,219,65,154,新光-高雄,2023-05-19,8562
00665L,富邦�琤肭磪囓�2,152,0,152,新光-高雄,2023-05-19,8562
00687B,國泰20年美債,135,2,133,新光-高雄,2023-05-19,8562
3044,健鼎,125,10,115,新光-高雄,2023-05-19,8562
2331,精英,114,0,114,新光-高雄,2023-05-19,8562
00751B,元大AAA至A公司債,113,0,113,新光-高雄,2023-05-19,8562
3163,波若威,127,17,110,新光-高雄,2023-05-19,8562
2618,長榮航,525,421,104,新光-高雄,2023-05-19,8562
2887,台新金,113,17,96,新光-高雄,2023-05-19,8562
1905,華紙,127,36,91,新光-高雄,2023-05-19,8562
2705,六福,80,0,80,新光-高雄,2023-05-19,8562
2402,毅嘉,82,7,75,新光-高雄,2023-05-19,8562
00772B,中信高評級公司債,75,0,75,新光-高雄,2023-05-19,8562
00882,中信中國高股息,73,3,70,新光-高雄,2023-05-19,8562
4720,德淵,63,0,63,新光-高雄,2023-05-19,8562
1101,台泥,67,5,62,新光-高雄,2023-05-19,8562
5243,乙盛-KY,216,155,61,新光-高雄,2023-05-19,8562
6112,邁達特,152,92,60,新光-高雄,2023-05-19,8562
00753L,中信中國50正2,62,10,52,新光-高雄,2023-05-19,8562
2453,凌群,89,42,47,新光-高雄,2023-05-19,8562
2317,鴻海,61,17,44,新光-高雄,2023-05-19,8562
5864,致和證,44,0,44,新光-高雄,2023-05-19,8562
2468,華經,46,7,39,新光-高雄,2023-05-19,8562
00885,富邦越南,40,2,38,新光-高雄,2023-05-19,8562
1307,三芳,40,3,37,新光-高雄,2023-05-19,8562
2399,映泰,44,7,37,新光-高雄,2023-05-19,8562
00795B,中信美國公債20年,40,3,37,新光-高雄,2023-05-19,8562
00679B,元大美債20年,102,68,34,新光-高雄,2023-05-19,8562
6235,華孚,90,57,33,新光-高雄,2023-05-19,8562
3029,零壹,109,77,32,新光-高雄,2023-05-19,8562
00720B,元大投資級公司債,34,3,31,新光-高雄,2023-05-19,8562
1717,長興,41,10,31,新光-高雄,2023-05-19,8562
1609,大亞,99,69,30,新光-高雄,2023-05-19,8562
1709,和益,30,0,30,新光-高雄,2023-05-19,8562
00662,富邦NASDAQ,30,0,30,新光-高雄,2023-05-19,8562
5356,協益,29,0,29,新光-高雄,2023-05-19,8562
3622,洋華,26,0,26,新光-高雄,2023-05-19,8562
6244,茂迪,33,10,23,新光-高雄,2023-05-19,8562
6266,泰詠,25,2,23,新光-高雄,2023-05-19,8562
2851,中再保,23,0,23,新光-高雄,2023-05-19,8562
2897,王道銀行,23,0,23,新光-高雄,2023-05-19,8562
4142,國光生,25,2,23,新光-高雄,2023-05-19,8562
2457,飛宏,91,69,22,新光-高雄,2023-05-19,8562
1314,中石化,22,1,21,新光-高雄,2023-05-19,8562
3003,健和興,54,33,21,新光-高雄,2023-05-19,8562
3030,德律,20,0,20,新光-高雄,2023-05-19,8562
00712,復華富時不動產,60,40,20,新光-高雄,2023-05-19,8562
1589,永冠-KY,20,2,18,新光-高雄,2023-05-19,8562
00715L,期街口布蘭特正2,588,46,542,新光-高雄,2023-05-22,8562
00632R,元大台灣50反1,208,20,188,新光-高雄,2023-05-22,8562
00687B,國泰20年美債,142,0,142,新光-高雄,2023-05-22,8562
6274,台燿,115,15,100,新光-高雄,2023-05-22,8562
00795B,中信美國公債20年,114,15,99,新光-高雄,2023-05-22,8562
00680L,元大美債20正2,98,0,98,新光-高雄,2023-05-22,8562
3163,波若威,122,25,97,新光-高雄,2023-05-22,8562
2303,聯電,101,11,90,新光-高雄,2023-05-22,8562
00882,中信中國高股息,76,0,76,新光-高雄,2023-05-22,8562
00712,復華富時不動產,67,1,66,新光-高雄,2023-05-22,8562
2888,新光金,80,33,47,新光-高雄,2023-05-22,8562
00679B,元大美債20年,190,144,46,新光-高雄,2023-05-22,8562
3231,緯創,128,85,43,新光-高雄,2023-05-22,8562
3037,欣興,70,28,42,新光-高雄,2023-05-22,8562
2327,國巨,40,3,37,新光-高雄,2023-05-22,8562
6245,立端,140,103,37,新光-高雄,2023-05-22,8562
00853B,統一美債10年Aa-,35,0,35,新光-高雄,2023-05-22,8562
2812,台中銀,33,0,33,新光-高雄,2023-05-22,8562
4977,眾達-KY,33,1,32,新光-高雄,2023-05-22,8562
8070,長華*,34,2,32,新光-高雄,2023-05-22,8562
8289,泰藝,36,5,31,新光-高雄,2023-05-22,8562
2337,旺宏,36,6,30,新光-高雄,2023-05-22,8562
00888,永豐台灣ESG,29,1,28,新光-高雄,2023-05-22,8562
2352,佳世達,78,50,28,新光-高雄,2023-05-22,8562
2371,大同,47,21,26,新光-高雄,2023-05-22,8562
00690,兆豐藍籌30,25,0,25,新光-高雄,2023-05-22,8562
6510,精測,22,0,22,新光-高雄,2023-05-22,8562
2313,華通,26,5,21,新光-高雄,2023-05-22,8562
9943,好樂迪,24,3,21,新光-高雄,2023-05-22,8562
2412,中華電,21,0,21,新光-高雄,2023-05-22,8562
2356,英業達,24,4,20,新光-高雄,2023-05-22,8562
00751B,元大AAA至A公司債,48,28,20,新光-高雄,2023-05-22,8562
3038,全台,33,13,20,新光-高雄,2023-05-22,8562
4939,亞電,20,0,20,新光-高雄,2023-05-22,8562
2468,華經,20,0,20,新光-高雄,2023-05-22,8562
2884,玉山金,33,14,19,新光-高雄,2023-05-22,8562
2402,毅嘉,25,6,19,新光-高雄,2023-05-22,8562
2892,第一金,19,0,19,新光-高雄,2023-05-22,8562
00772B,中信高評級公司債,19,1,18,新光-高雄,2023-05-22,8562
5398,慕康生醫,20,2,18,新光-高雄,2023-05-22,8562
2105,正新,21,4,17,新光-高雄,2023-05-22,8562
3030,德律,17,0,17,新光-高雄,2023-05-22,8562
1514,亞力,153,137,16,新光-高雄,2023-05-22,8562
2883B,凱基金乙特,16,0,16,新光-高雄,2023-05-22,8562
3162,精確,26,11,15,新光-高雄,2023-05-22,8562
2736,富野,17,2,15,新光-高雄,2023-05-22,8562
2890,永豐金,51,36,15,新光-高雄,2023-05-22,8562
3481,群創,74,60,14,新光-高雄,2023-05-22,8562
6244,茂迪,15,1,14,新光-高雄,2023-05-22,8562
5475,德宏,14,0,14,新光-高雄,2023-05-22,8562
2884,玉山金,324,16,308,新光-高雄,2023-05-23,8562
00680L,元大美債20正2,227,7,220,新光-高雄,2023-05-23,8562
00632R,元大台灣50反1,257,110,147,新光-高雄,2023-05-23,8562
3162,精確,162,15,147,新光-高雄,2023-05-23,8562
00706L,期元大S＆P日圓正2,129,0,129,新光-高雄,2023-05-23,8562
2022,聚亨,129,0,129,新光-高雄,2023-05-23,8562
00637L,元大滬深300正2,179,61,118,新光-高雄,2023-05-23,8562
00882,中信中國高股息,117,4,113,新光-高雄,2023-05-23,8562
00687B,國泰20年美債,96,2,94,新光-高雄,2023-05-23,8562
00795B,中信美國公債20年,80,2,78,新光-高雄,2023-05-23,8562
4904,遠傳,78,0,78,新光-高雄,2023-05-23,8562
2344,華邦電,74,14,60,新光-高雄,2023-05-23,8562
2337,旺宏,81,36,45,新光-高雄,2023-05-23,8562
1218,泰山,47,3,44,新光-高雄,2023-05-23,8562
2425,承啟,38,0,38,新光-高雄,2023-05-23,8562
2731,雄獅,65,28,37,新光-高雄,2023-05-23,8562
00712,復華富時不動產,40,6,34,新光-高雄,2023-05-23,8562
5531,鄉林,45,12,33,新光-高雄,2023-05-23,8562
3078,僑威,129,97,32,新光-高雄,2023-05-23,8562
2442,新美齊,99,68,31,新光-高雄,2023-05-23,8562
2409,友達,57,26,31,新光-高雄,2023-05-23,8562
3591,艾笛森,52,22,30,新光-高雄,2023-05-23,8562
00772B,中信高評級公司債,31,1,30,新光-高雄,2023-05-23,8562
3504,揚明光,29,0,29,新光-高雄,2023-05-23,8562
1762,中化生,31,3,28,新光-高雄,2023-05-23,8562
00633L,富邦上証正2,30,5,25,新光-高雄,2023-05-23,8562
1709,和益,24,0,24,新光-高雄,2023-05-23,8562
00688L,國泰20年美債正2,22,0,22,新光-高雄,2023-05-23,8562
00908,富邦入息REITs+,20,0,20,新光-高雄,2023-05-23,8562
2367,燿華,31,11,20,新光-高雄,2023-05-23,8562
4720,德淵,20,0,20,新光-高雄,2023-05-23,8562
2457,飛宏,74,55,19,新光-高雄,2023-05-23,8562
5356,協益,19,0,19,新光-高雄,2023-05-23,8562
2707,晶華,22,3,19,新光-高雄,2023-05-23,8562
8121,越峰,22,3,19,新光-高雄,2023-05-23,8562
2748,雲品,49,31,18,新光-高雄,2023-05-23,8562
00857B,永豐20年美公債,18,0,18,新光-高雄,2023-05-23,8562
6446,藥華藥,35,18,17,新光-高雄,2023-05-23,8562
4541,晟田,99,83,16,新光-高雄,2023-05-23,8562
6282,康舒,115,99,16,新光-高雄,2023-05-23,8562
2634,漢翔,91,75,16,新光-高雄,2023-05-23,8562
3706,神達,16,0,16,新光-高雄,2023-05-23,8562
4532,瑞智,15,0,15,新光-高雄,2023-05-23,8562
2486,一詮,17,2,15,新光-高雄,2023-05-23,8562
00673R,期元大S＆P原油反1,15,0,15,新光-高雄,2023-05-23,8562
2548,華固,26,11,15,新光-高雄,2023-05-23,8562
2739,寒舍,16,1,15,新光-高雄,2023-05-23,8562
1611,中電,15,0,15,新光-高雄,2023-05-23,8562
2368,金像電,78,64,14,新光-高雄,2023-05-23,8562
6197,佳必琪,20,6,14,新光-高雄,2023-05-23,8562
00882,中信中國高股息,233,5,228,新光-高雄,2023-05-24,8562
00637L,元大滬深300正2,182,18,164,新光-高雄,2023-05-24,8562
00665L,富邦�琤肭磪囓�2,236,110,126,新光-高雄,2023-05-24,8562
2834,臺企銀,166,57,109,新光-高雄,2023-05-24,8562
00878,國泰永續高股息,174,75,99,新光-高雄,2023-05-24,8562
00713,元大台灣高息低波,101,6,95,新光-高雄,2023-05-24,8562
00857B,永豐20年美公債,66,0,66,新光-高雄,2023-05-24,8562
00687B,國泰20年美債,76,11,65,新光-高雄,2023-05-24,8562
2305,全友,73,9,64,新光-高雄,2023-05-24,8562
2734,易飛網,68,5,63,新光-高雄,2023-05-24,8562
2367,燿華,63,0,63,新光-高雄,2023-05-24,8562
00680L,元大美債20正2,72,16,56,新光-高雄,2023-05-24,8562
2867,三商壽,54,0,54,新光-高雄,2023-05-24,8562
3504,揚明光,57,6,51,新光-高雄,2023-05-24,8562
1608,華榮,64,17,47,新光-高雄,2023-05-24,8562
00706L,期元大S＆P日圓正2,51,5,46,新光-高雄,2023-05-24,8562
6274,台燿,72,26,46,新光-高雄,2023-05-24,8562
00664R,國泰臺灣加權反1,50,5,45,新光-高雄,2023-05-24,8562
2705,六福,108,67,41,新光-高雄,2023-05-24,8562
5356,協益,37,0,37,新光-高雄,2023-05-24,8562
2888,新光金,41,4,37,新光-高雄,2023-05-24,8562
5464,霖宏,47,11,36,新光-高雄,2023-05-24,8562
3363,上詮,40,6,34,新光-高雄,2023-05-24,8562
2369,菱生,34,0,34,新光-高雄,2023-05-24,8562
00679B,元大美債20年,187,156,31,新光-高雄,2023-05-24,8562
00795B,中信美國公債20年,34,3,31,新光-高雄,2023-05-24,8562
8436,大江,37,6,31,新光-高雄,2023-05-24,8562
00671R,富邦NASDAQ反1,30,0,30,新光-高雄,2023-05-24,8562
1513,中興電,56,28,28,新光-高雄,2023-05-24,8562
1101,台泥,30,4,26,新光-高雄,2023-05-24,8562
2457,飛宏,233,209,24,新光-高雄,2023-05-24,8562
3049,精金,21,0,21,新光-高雄,2023-05-24,8562
2515,中工,27,6,21,新光-高雄,2023-05-24,8562
00633L,富邦上証正2,35,14,21,新光-高雄,2023-05-24,8562
2801,彰銀,20,0,20,新光-高雄,2023-05-24,8562
2106,建大,20,0,20,新光-高雄,2023-05-24,8562
2537,聯上發,20,1,19,新光-高雄,2023-05-24,8562
00772B,中信高評級公司債,19,0,19,新光-高雄,2023-05-24,8562
00690,兆豐藍籌30,19,0,19,新光-高雄,2023-05-24,8562
00753L,中信中國50正2,38,19,19,新光-高雄,2023-05-24,8562
2618,長榮航,189,171,18,新光-高雄,2023-05-24,8562
5465,富驊,18,0,18,新光-高雄,2023-05-24,8562
5324,士開,17,0,17,新光-高雄,2023-05-24,8562
00885,富邦越南,17,0,17,新光-高雄,2023-05-24,8562
4919,新唐,31,15,16,新光-高雄,2023-05-24,8562
8222,寶一,116,100,16,新光-高雄,2023-05-24,8562
2442,新美齊,48,32,16,新光-高雄,2023-05-24,8562
3078,僑威,56,40,16,新光-高雄,2023-05-24,8562
2327,國巨,17,2,15,新光-高雄,2023-05-24,8562
00673R,期元大S＆P原油反1,20,5,15,新光-高雄,2023-05-24,8562
3231,緯創,466,215,251,新光-高雄,2023-05-25,8562
00637L,元大滬深300正2,308,96,212,新光-高雄,2023-05-25,8562
00706L,期元大S＆P日圓正2,211,0,211,新光-高雄,2023-05-25,8562
00882,中信中國高股息,349,180,169,新光-高雄,2023-05-25,8562
00680L,元大美債20正2,125,0,125,新光-高雄,2023-05-25,8562
00687B,國泰20年美債,121,1,120,新光-高雄,2023-05-25,8562
00712,復華富時不動產,118,2,116,新光-高雄,2023-05-25,8562
2402,毅嘉,112,10,102,新光-高雄,2023-05-25,8562
3481,群創,103,1,102,新光-高雄,2023-05-25,8562
3149,正達,99,0,99,新光-高雄,2023-05-25,8562
00753L,中信中國50正2,113,17,96,新光-高雄,2023-05-25,8562
2376,技嘉,110,15,95,新光-高雄,2023-05-25,8562
2317,鴻海,90,3,87,新光-高雄,2023-05-25,8562
00679B,元大美債20年,131,46,85,新光-高雄,2023-05-25,8562
00720B,元大投資級公司債,80,3,77,新光-高雄,2023-05-25,8562
2867,三商壽,72,8,64,新光-高雄,2023-05-25,8562
00665L,富邦�琤肭磪囓�2,544,480,64,新光-高雄,2023-05-25,8562
2891,中信金,61,1,60,新光-高雄,2023-05-25,8562
2106,建大,60,0,60,新光-高雄,2023-05-25,8562
00795B,中信美國公債20年,61,3,58,新光-高雄,2023-05-25,8562
6187,萬潤,73,17,56,新光-高雄,2023-05-25,8562
2425,承啟,57,2,55,新光-高雄,2023-05-25,8562
00688L,國泰20年美債正2,53,0,53,新光-高雄,2023-05-25,8562
1432,大魯閣,54,3,51,新光-高雄,2023-05-25,8562
2002,中鋼,40,2,38,新光-高雄,2023-05-25,8562
2748,雲品,91,54,37,新光-高雄,2023-05-25,8562
2630,亞航,146,111,35,新光-高雄,2023-05-25,8562
6111,大宇資,40,6,34,新光-高雄,2023-05-25,8562
2356,英業達,65,33,32,新光-高雄,2023-05-25,8562
6835,圓裕,37,6,31,新光-高雄,2023-05-25,8562
1307,三芳,30,0,30,新光-高雄,2023-05-25,8562
00674R,期元大S＆P黃金反1,30,0,30,新光-高雄,2023-05-25,8562
6122,擎邦,53,23,30,新光-高雄,2023-05-25,8562
5871,中租-KY,33,3,30,新光-高雄,2023-05-25,8562
00633L,富邦上証正2,43,14,29,新光-高雄,2023-05-25,8562
2603,長榮,36,7,29,新光-高雄,2023-05-25,8562
00673R,期元大S＆P原油反1,32,5,27,新光-高雄,2023-05-25,8562
1504,東元,75,49,26,新光-高雄,2023-05-25,8562
2712,遠雄來,28,2,26,新光-高雄,2023-05-25,8562
1809,中釉,30,4,26,新光-高雄,2023-05-25,8562
3030,德律,26,0,26,新光-高雄,2023-05-25,8562
2365,昆盈,29,4,25,新光-高雄,2023-05-25,8562
6592,和潤企業,26,1,25,新光-高雄,2023-05-25,8562
2323,中環,61,37,24,新光-高雄,2023-05-25,8562
2329,華泰,22,0,22,新光-高雄,2023-05-25,8562
2472,立隆電,21,0,21,新光-高雄,2023-05-25,8562
00752,中信中國50,21,0,21,新光-高雄,2023-05-25,8562
4162,智擎,23,2,21,新光-高雄,2023-05-25,8562
1513,中興電,56,35,21,新光-高雄,2023-05-25,8562
2615,萬海,21,1,20,新光-高雄,2023-05-25,8562
00632R,元大台灣50反1,846,305,541,新光-高雄,2023-05-26,8562
2618,長榮航,648,292,356,新光-高雄,2023-05-26,8562
00715L,期街口布蘭特正2,322,62,260,新光-高雄,2023-05-26,8562
00712,復華富時不動產,252,0,252,新光-高雄,2023-05-26,8562
2883,凱基金,149,2,147,新光-高雄,2023-05-26,8562
00687B,國泰20年美債,126,0,126,新光-高雄,2023-05-26,8562
00882,中信中國高股息,131,6,125,新光-高雄,2023-05-26,8562
00637L,元大滬深300正2,164,43,121,新光-高雄,2023-05-26,8562
2834,臺企銀,95,4,91,新光-高雄,2023-05-26,8562
2317,鴻海,131,57,74,新光-高雄,2023-05-26,8562
2867,三商壽,78,4,74,新光-高雄,2023-05-26,8562
00680L,元大美債20正2,154,81,73,新光-高雄,2023-05-26,8562
2106,建大,70,0,70,新光-高雄,2023-05-26,8562
2890,永豐金,65,2,63,新光-高雄,2023-05-26,8562
3682,亞太電,62,0,62,新光-高雄,2023-05-26,8562
2610,華航,158,100,58,新光-高雄,2023-05-26,8562
00720B,元大投資級公司債,52,2,50,新光-高雄,2023-05-26,8562
00679B,元大美債20年,49,3,46,新光-高雄,2023-05-26,8562
00713,元大台灣高息低波,141,101,40,新光-高雄,2023-05-26,8562
2356,英業達,187,153,34,新光-高雄,2023-05-26,8562
9938,百和,31,0,31,新光-高雄,2023-05-26,8562
2888,新光金,38,8,30,新光-高雄,2023-05-26,8562
1307,三芳,28,0,28,新光-高雄,2023-05-26,8562
00795B,中信美國公債20年,31,4,27,新光-高雄,2023-05-26,8562
3481,群創,37,11,26,新光-高雄,2023-05-26,8562
3038,全台,31,5,26,新光-高雄,2023-05-26,8562
2208,台船,27,3,24,新光-高雄,2023-05-26,8562
2915,潤泰全,26,2,24,新光-高雄,2023-05-26,8562
00902,中信電池及儲能,24,0,24,新光-高雄,2023-05-26,8562
2812,台中銀,66,42,24,新光-高雄,2023-05-26,8562
1312,國喬,23,0,23,新光-高雄,2023-05-26,8562
2204,中華,24,2,22,新光-高雄,2023-05-26,8562
9945,潤泰新,21,0,21,新光-高雄,2023-05-26,8562
6112,邁達特,40,19,21,新光-高雄,2023-05-26,8562
3455,由田,21,0,21,新光-高雄,2023-05-26,8562
3715,定穎投控,76,55,21,新光-高雄,2023-05-26,8562
9907,統一實,41,20,21,新光-高雄,2023-05-26,8562
2472,立隆電,21,0,21,新光-高雄,2023-05-26,8562
8429,金麗-KY,21,0,21,新光-高雄,2023-05-26,8562
1231,聯華食,21,0,21,新光-高雄,2023-05-26,8562
00923,群益台ESG低碳50,32,12,20,新光-高雄,2023-05-26,8562
00752,中信中國50,20,0,20,新光-高雄,2023-05-26,8562
3290,東浦,20,0,20,新光-高雄,2023-05-26,8562
8064,東捷,20,0,20,新光-高雄,2023-05-26,8562
2801,彰銀,20,1,19,新光-高雄,2023-05-26,8562
8436,大江,23,5,18,新光-高雄,2023-05-26,8562
5340,建榮,18,0,18,新光-高雄,2023-05-26,8562
2486,一詮,26,8,18,新光-高雄,2023-05-26,8562
4306,炎洲,23,6,17,新光-高雄,2023-05-26,8562
3058,立德,20,3,17,新光-高雄,2023-05-26,8562
00673R,期元大S＆P原油反1,117,0,117,新光-高雄,2023-05-29,8562
00687B,國泰20年美債,121,7,114,新光-高雄,2023-05-29,8562
00706L,期元大S＆P日圓正2,105,0,105,新光-高雄,2023-05-29,8562
00772B,中信高評級公司債,80,1,79,新光-高雄,2023-05-29,8562
00680L,元大美債20正2,78,0,78,新光-高雄,2023-05-29,8562
2365,昆盈,74,0,74,新光-高雄,2023-05-29,8562
00688L,國泰20年美債正2,73,0,73,新光-高雄,2023-05-29,8562
00857B,永豐20年美公債,72,1,71,新光-高雄,2023-05-29,8562
1905,華紙,178,108,70,新光-高雄,2023-05-29,8562
1218,泰山,74,6,68,新光-高雄,2023-05-29,8562
2327,國巨,64,3,61,新光-高雄,2023-05-29,8562
00882,中信中國高股息,78,22,56,新光-高雄,2023-05-29,8562
4744,皇將,88,32,56,新光-高雄,2023-05-29,8562
2409,友達,93,42,51,新光-高雄,2023-05-29,8562
2303,聯電,127,78,49,新光-高雄,2023-05-29,8562
8150,南茂,68,24,44,新光-高雄,2023-05-29,8562
00712,復華富時不動產,57,17,40,新光-高雄,2023-05-29,8562
3037,欣興,74,37,37,新光-高雄,2023-05-29,8562
2331,精英,54,17,37,新光-高雄,2023-05-29,8562
2884,玉山金,56,20,36,新光-高雄,2023-05-29,8562
3202,樺晟,38,5,33,新光-高雄,2023-05-29,8562
3419,譁裕,31,0,31,新光-高雄,2023-05-29,8562
00795B,中信美國公債20年,29,0,29,新光-高雄,2023-05-29,8562
6223,旺矽,37,9,28,新光-高雄,2023-05-29,8562
2801,彰銀,38,11,27,新光-高雄,2023-05-29,8562
2883,凱基金,31,4,27,新光-高雄,2023-05-29,8562
3583,辛耘,28,4,24,新光-高雄,2023-05-29,8562
5905,南仁湖,24,1,23,新光-高雄,2023-05-29,8562
00637L,元大滬深300正2,60,38,22,新光-高雄,2023-05-29,8562
3380,明泰,63,41,22,新光-高雄,2023-05-29,8562
3290,東浦,23,2,21,新光-高雄,2023-05-29,8562
9105,泰金寶-DR,21,0,21,新光-高雄,2023-05-29,8562
1337,再生-KY,20,0,20,新光-高雄,2023-05-29,8562
5328,華容,21,1,20,新光-高雄,2023-05-29,8562
4919,新唐,53,35,18,新光-高雄,2023-05-29,8562
00752,中信中國50,18,0,18,新光-高雄,2023-05-29,8562
4934,太極,17,0,17,新光-高雄,2023-05-29,8562
00853B,統一美債10年Aa-,17,0,17,新光-高雄,2023-05-29,8562
2376,技嘉,59,43,16,新光-高雄,2023-05-29,8562
1608,華榮,85,69,16,新光-高雄,2023-05-29,8562
2353,宏��,17,1,16,新光-高雄,2023-05-29,8562
6438,迅得,16,0,16,新光-高雄,2023-05-29,8562
1308,亞聚,21,5,16,新光-高雄,2023-05-29,8562
5371,中光電,16,0,16,新光-高雄,2023-05-29,8562
5301,寶得利,20,4,16,新光-高雄,2023-05-29,8562
3303,岱稜,16,0,16,新光-高雄,2023-05-29,8562
6789,采鈺,17,1,16,新光-高雄,2023-05-29,8562
00720B,元大投資級公司債,18,3,15,新光-高雄,2023-05-29,8562
3017,奇鋐,61,45,16,新光-高雄,2023-05-29,8562
8374,羅昇,15,0,15,新光-高雄,2023-05-29,8562
00713,元大台灣高息低波,233,8,225,新光-高雄,2023-05-30,8562
00882,中信中國高股息,136,11,125,新光-高雄,2023-05-30,8562
3044,健鼎,109,9,100,新光-高雄,2023-05-30,8562
00637L,元大滬深300正2,124,26,98,新光-高雄,2023-05-30,8562
2002,中鋼,81,12,69,新光-高雄,2023-05-30,8562
3231,緯創,354,289,65,新光-高雄,2023-05-30,8562
0056,元大高股息,123,61,62,新光-高雄,2023-05-30,8562
00665L,富邦�琤肭磪囓�2,95,40,55,新光-高雄,2023-05-30,8562
2337,旺宏,85,32,53,新光-高雄,2023-05-30,8562
3706,神達,71,21,50,新光-高雄,2023-05-30,8562
5243,乙盛-KY,78,28,50,新光-高雄,2023-05-30,8562
00680L,元大美債20正2,119,70,49,新光-高雄,2023-05-30,8562
3682,亞太電,49,0,49,新光-高雄,2023-05-30,8562
2834,臺企銀,62,17,45,新光-高雄,2023-05-30,8562
6016,康和證,42,0,42,新光-高雄,2023-05-30,8562
1460,宏遠,49,15,34,新光-高雄,2023-05-30,8562
00772B,中信高評級公司債,34,1,33,新光-高雄,2023-05-30,8562
4190,佐登-KY,34,2,32,新光-高雄,2023-05-30,8562
00706L,期元大S＆P日圓正2,32,0,32,新光-高雄,2023-05-30,8562
2382,廣達,125,94,31,新光-高雄,2023-05-30,8562
3078,僑威,61,31,30,新光-高雄,2023-05-30,8562
8926,台汽電,33,4,29,新光-高雄,2023-05-30,8562
2603,長榮,33,6,27,新光-高雄,2023-05-30,8562
00725B,國泰投資級公司債,26,0,26,新光-高雄,2023-05-30,8562
00679B,元大美債20年,27,2,25,新光-高雄,2023-05-30,8562
9907,統一實,32,7,25,新光-高雄,2023-05-30,8562
00753L,中信中國50正2,25,0,25,新光-高雄,2023-05-30,8562
5871,中租-KY,25,0,25,新光-高雄,2023-05-30,8562
2105,正新,28,3,25,新光-高雄,2023-05-30,8562
1905,華紙,41,16,25,新光-高雄,2023-05-30,8562
4714,永捷,27,3,24,新光-高雄,2023-05-30,8562
00632R,元大台灣50反1,147,123,24,新光-高雄,2023-05-30,8562
6005,群益證,36,13,23,新光-高雄,2023-05-30,8562
3094,聯傑,85,62,23,新光-高雄,2023-05-30,8562
2486,一詮,27,4,23,新光-高雄,2023-05-30,8562
2106,建大,23,0,23,新光-高雄,2023-05-30,8562
2332,友訊,39,16,23,新光-高雄,2023-05-30,8562
1802,台玻,21,0,21,新光-高雄,2023-05-30,8562
2327,國巨,27,7,20,新光-高雄,2023-05-30,8562
2845,遠東銀,20,0,20,新光-高雄,2023-05-30,8562
2329,華泰,22,2,20,新光-高雄,2023-05-30,8562
2891,中信金,50,30,20,新光-高雄,2023-05-30,8562
4919,新唐,42,23,19,新光-高雄,2023-05-30,8562
3419,譁裕,20,1,19,新光-高雄,2023-05-30,8562
6218,豪勉,24,5,19,新光-高雄,2023-05-30,8562
2465,麗臺,20,1,19,新光-高雄,2023-05-30,8562
00687B,國泰20年美債,26,7,19,新光-高雄,2023-05-30,8562
2634,漢翔,40,22,18,新光-高雄,2023-05-30,8562
2867,三商壽,23,5,18,新光-高雄,2023-05-30,8562
2504,國產,17,0,17,新光-高雄,2023-05-30,8562
00715L,期街口布蘭特正2,849,2,847,新光-高雄,2023-05-31,8562
5864,致和證,215,2,213,新光-高雄,2023-05-31,8562
00642U,期元大S＆P石油,191,0,191,新光-高雄,2023-05-31,8562
00882,中信中國高股息,169,0,169,新光-高雄,2023-05-31,8562
00665L,富邦�琤肭磪囓�2,215,75,140,新光-高雄,2023-05-31,8562
2748,雲品,121,26,95,新光-高雄,2023-05-31,8562
5243,乙盛-KY,135,52,83,新光-高雄,2023-05-31,8562
00688L,國泰20年美債正2,90,15,75,新光-高雄,2023-05-31,8562
2845,遠東銀,76,4,72,新光-高雄,2023-05-31,8562
00637L,元大滬深300正2,101,32,69,新光-高雄,2023-05-31,8562
2356,英業達,119,55,64,新光-高雄,2023-05-31,8562
3231,緯創,286,225,61,新光-高雄,2023-05-31,8562
2801,彰銀,46,1,45,新光-高雄,2023-05-31,8562
2352,佳世達,75,38,37,新光-高雄,2023-05-31,8562
5469,瀚宇博,50,17,33,新光-高雄,2023-05-31,8562
00679B,元大美債20年,35,2,33,新光-高雄,2023-05-31,8562
3708,上緯投控,31,0,31,新光-高雄,2023-05-31,8562
4915,致伸,32,1,31,新光-高雄,2023-05-31,8562
6104,創惟,37,6,31,新光-高雄,2023-05-31,8562
2498,宏達電,34,4,30,新光-高雄,2023-05-31,8562
2883B,凱基金乙特,30,0,30,新光-高雄,2023-05-31,8562
2425,承啟,39,10,29,新光-高雄,2023-05-31,8562
2883,凱基金,68,39,29,新光-高雄,2023-05-31,8562
4190,佐登-KY,37,9,28,新光-高雄,2023-05-31,8562
2457,飛宏,172,145,27,新光-高雄,2023-05-31,8562
3006,晶豪科,89,63,26,新光-高雄,2023-05-31,8562
4967,十銓,92,69,23,新光-高雄,2023-05-31,8562
9945,潤泰新,24,2,22,新光-高雄,2023-05-31,8562
9907,統一實,23,1,22,新光-高雄,2023-05-31,8562
2888,新光金,56,35,21,新光-高雄,2023-05-31,8562
2891,中信金,20,0,20,新光-高雄,2023-05-31,8562
3481,群創,24,5,19,新光-高雄,2023-05-31,8562
6150,撼訊,50,31,19,新光-高雄,2023-05-31,8562
4102,永日,24,5,19,新光-高雄,2023-05-31,8562
1460,宏遠,19,0,19,新光-高雄,2023-05-31,8562
2421,建準,38,20,18,新光-高雄,2023-05-31,8562
2301,光寶科,29,11,18,新光-高雄,2023-05-31,8562
4916,事欣科,28,10,18,新光-高雄,2023-05-31,8562
2401,凌陽,18,0,18,新光-高雄,2023-05-31,8562
2106,建大,20,3,17,新光-高雄,2023-05-31,8562
5498,凱崴,21,4,17,新光-高雄,2023-05-31,8562
2409,友達,23,6,17,新光-高雄,2023-05-31,8562
5225,東科-KY,17,0,17,新光-高雄,2023-05-31,8562
00687B,國泰20年美債,28,12,16,新光-高雄,2023-05-31,8562
3037,欣興,24,8,16,新光-高雄,2023-05-31,8562
00752,中信中國50,16,0,16,新光-高雄,2023-05-31,8562
00713,元大台灣高息低波,16,1,15,新光-高雄,2023-05-31,8562
5876,上海商銀,16,1,15,新光-高雄,2023-05-31,8562
1215,卜蜂,14,0,14,新光-高雄,2023-05-31,8562
2354,鴻準,17,3,14,新光-高雄,2023-05-31,8562
00715L,期街口布蘭特正2,944,55,889,新光-高雄,2023-06-01,8562
00919,群益台灣精選高息,213,4,209,新光-高雄,2023-06-01,8562
6188,廣明,268,79,189,新光-高雄,2023-06-01,8562
1721,三晃,140,10,130,新光-高雄,2023-06-01,8562
2883,凱基金,115,0,115,新光-高雄,2023-06-01,8562
2881,富邦金,136,25,111,新光-高雄,2023-06-01,8562
00882,中信中國高股息,108,3,105,新光-高雄,2023-06-01,8562
2913,農林,131,29,102,新光-高雄,2023-06-01,8562
00713,元大台灣高息低波,102,4,98,新光-高雄,2023-06-01,8562
00642U,期元大S＆P石油,103,8,95,新光-高雄,2023-06-01,8562
2402,毅嘉,101,15,86,新光-高雄,2023-06-01,8562
8996,高力,92,18,74,新光-高雄,2023-06-01,8562
2323,中環,149,89,60,新光-高雄,2023-06-01,8562
00632R,元大台灣50反1,271,212,59,新光-高雄,2023-06-01,8562
6282,康舒,159,103,56,新光-高雄,2023-06-01,8562
8105,凌巨,55,3,52,新光-高雄,2023-06-01,8562
2890,永豐金,51,0,51,新光-高雄,2023-06-01,8562
5876,上海商銀,50,1,49,新光-高雄,2023-06-01,8562
00687B,國泰20年美債,65,19,46,新光-高雄,2023-06-01,8562
2303,聯電,70,25,45,新光-高雄,2023-06-01,8562
00888,永豐台灣ESG,37,0,37,新光-高雄,2023-06-01,8562
4916,事欣科,37,2,35,新光-高雄,2023-06-01,8562
2882,國泰金,39,4,35,新光-高雄,2023-06-01,8562
1907,永豐餘,92,58,34,新光-高雄,2023-06-01,8562
5469,瀚宇博,40,7,33,新光-高雄,2023-06-01,8562
2630,亞航,114,82,32,新光-高雄,2023-06-01,8562
3308,聯德,32,0,32,新光-高雄,2023-06-01,8562
4564,元翎,46,14,32,新光-高雄,2023-06-01,8562
2328,廣宇,72,41,31,新光-高雄,2023-06-01,8562
2106,建大,31,0,31,新光-高雄,2023-06-01,8562
3710,連展投控,30,0,30,新光-高雄,2023-06-01,8562
2352,佳世達,52,24,28,新光-高雄,2023-06-01,8562
6477,安集,25,0,25,新光-高雄,2023-06-01,8562
2330,台積電,27,4,23,新光-高雄,2023-06-01,8562
3058,立德,31,8,23,新光-高雄,2023-06-01,8562
8088,品安,38,15,23,新光-高雄,2023-06-01,8562
2834,臺企銀,22,0,22,新光-高雄,2023-06-01,8562
2349,錸德,32,10,22,新光-高雄,2023-06-01,8562
2888,新光金,62,40,22,新光-高雄,2023-06-01,8562
00753L,中信中國50正2,48,26,22,新光-高雄,2023-06-01,8562
6733,博晟生醫,22,0,22,新光-高雄,2023-06-01,8562
2903,遠百,27,5,22,新光-高雄,2023-06-01,8562
6122,擎邦,51,30,21,新光-高雄,2023-06-01,8562
6005,群益證,21,1,20,新光-高雄,2023-06-01,8562
3209,全科,20,0,20,新光-高雄,2023-06-01,8562
3013,晟銘電,173,153,20,新光-高雄,2023-06-01,8562
6016,康和證,27,8,19,新光-高雄,2023-06-01,8562
6194,育富,22,3,19,新光-高雄,2023-06-01,8562
2324,仁寶,29,10,19,新光-高雄,2023-06-01,8562
2356,英業達,45,27,18,新光-高雄,2023-06-01,8562
2515,中工,314,93,221,新光-高雄,2023-06-02,8562
00712,復華富時不動產,239,30,209,新光-高雄,2023-06-02,8562
3231,緯創,617,415,202,新光-高雄,2023-06-02,8562
4979,華星光,408,213,195,新光-高雄,2023-06-02,8562
00637L,元大滬深300正2,248,66,182,新光-高雄,2023-06-02,8562
2323,中環,285,154,131,新光-高雄,2023-06-02,8562
2371,大同,158,29,129,新光-高雄,2023-06-02,8562
2610,華航,388,311,77,新光-高雄,2023-06-02,8562
3289,宜特,78,5,73,新光-高雄,2023-06-02,8562
4190,佐登-KY,70,3,67,新光-高雄,2023-06-02,8562
2357,華碩,61,2,59,新光-高雄,2023-06-02,8562
3591,艾笛森,82,25,57,新光-高雄,2023-06-02,8562
8930,青鋼,56,0,56,新光-高雄,2023-06-02,8562
00919,群益台灣精選高息,92,36,56,新光-高雄,2023-06-02,8562
2442,新美齊,57,2,55,新光-高雄,2023-06-02,8562
3013,晟銘電,86,37,49,新光-高雄,2023-06-02,8562
1504,東元,113,68,45,新光-高雄,2023-06-02,8562
2888,新光金,51,9,42,新光-高雄,2023-06-02,8562
2903,遠百,42,0,42,新光-高雄,2023-06-02,8562
00882,中信中國高股息,101,60,41,新光-高雄,2023-06-02,8562
2845,遠東銀,45,5,40,新光-高雄,2023-06-02,8562
00680L,元大美債20正2,42,2,40,新光-高雄,2023-06-02,8562
1515,力山,46,8,38,新光-高雄,2023-06-02,8562
2748,雲品,45,8,37,新光-高雄,2023-06-02,8562
00679B,元大美債20年,65,31,34,新光-高雄,2023-06-02,8562
1733,五鼎,38,5,33,新光-高雄,2023-06-02,8562
2317,鴻海,167,134,33,新光-高雄,2023-06-02,8562
3707,漢磊,66,36,30,新光-高雄,2023-06-02,8562
2891,中信金,36,6,30,新光-高雄,2023-06-02,8562
00795B,中信美國公債20年,31,2,29,新光-高雄,2023-06-02,8562
4973,廣穎,29,0,29,新光-高雄,2023-06-02,8562
5340,建榮,30,2,28,新光-高雄,2023-06-02,8562
3706,神達,78,51,27,新光-高雄,2023-06-02,8562
2633,台灣高鐵,29,3,26,新光-高雄,2023-06-02,8562
5439,高技,52,27,25,新光-高雄,2023-06-02,8562
1611,中電,61,37,24,新光-高雄,2023-06-02,8562
00902,中信電池及儲能,30,7,23,新光-高雄,2023-06-02,8562
1609,大亞,109,87,22,新光-高雄,2023-06-02,8562
00632R,元大台灣50反1,432,410,22,新光-高雄,2023-06-02,8562
2206,三陽工業,117,95,22,新光-高雄,2023-06-02,8562
01003T,兆豐新光R1,21,0,21,新光-高雄,2023-06-02,8562
3346,麗清,21,0,21,新光-高雄,2023-06-02,8562
1608,華榮,32,12,20,新光-高雄,2023-06-02,8562
8936,國統,20,0,20,新光-高雄,2023-06-02,8562
3022,威強電,24,4,20,新光-高雄,2023-06-02,8562
3454,晶睿,19,0,19,新光-高雄,2023-06-02,8562
1471,首利,19,0,19,新光-高雄,2023-06-02,8562
2337,旺宏,40,21,19,新光-高雄,2023-06-02,8562
2745,五福,19,1,18,新光-高雄,2023-06-02,8562
6167,久正,123,105,18,新光-高雄,2023-06-02,8562
00712,復華富時不動產,433,22,411,新光-高雄,2023-06-05,8562
00673R,期元大S＆P原油反1,496,196,300,新光-高雄,2023-06-05,8562
3033,威健,279,30,249,新光-高雄,2023-06-05,8562
00665L,富邦�琤肭磪囓�2,330,138,192,新光-高雄,2023-06-05,8562
00795B,中信美國公債20年,191,21,170,新光-高雄,2023-06-05,8562
00688L,國泰20年美債正2,112,0,112,新光-高雄,2023-06-05,8562
00679B,元大美債20年,130,23,107,新光-高雄,2023-06-05,8562
00882,中信中國高股息,132,29,103,新光-高雄,2023-06-05,8562
00878,國泰永續高股息,204,108,96,新光-高雄,2023-06-05,8562
00671R,富邦NASDAQ反1,100,10,90,新光-高雄,2023-06-05,8562
2881,富邦金,105,26,79,新光-高雄,2023-06-05,8562
00900,富邦特選高股息30,89,24,65,新光-高雄,2023-06-05,8562
2547,日勝生,70,5,65,新光-高雄,2023-06-05,8562
1528,恩德,66,8,58,新光-高雄,2023-06-05,8562
2388,威盛,154,100,54,新光-高雄,2023-06-05,8562
2515,中工,92,40,52,新光-高雄,2023-06-05,8562
1227,佳格,50,0,50,新光-高雄,2023-06-05,8562
2610,華航,238,189,49,新光-高雄,2023-06-05,8562
00706L,期元大S＆P日圓正2,84,35,49,新光-高雄,2023-06-05,8562
1584,精剛,79,31,48,新光-高雄,2023-06-05,8562
6282,康舒,149,104,45,新光-高雄,2023-06-05,8562
9945,潤泰新,98,54,44,新光-高雄,2023-06-05,8562
6470,宇智,53,9,44,新光-高雄,2023-06-05,8562
2331,精英,139,96,43,新光-高雄,2023-06-05,8562
2344,華邦電,98,55,43,新光-高雄,2023-06-05,8562
2340,台亞,47,5,42,新光-高雄,2023-06-05,8562
00919,群益台灣精選高息,139,101,38,新光-高雄,2023-06-05,8562
1905,華紙,133,96,37,新光-高雄,2023-06-05,8562
3231,緯創,167,132,35,新光-高雄,2023-06-05,8562
3071,協禧,41,7,34,新光-高雄,2023-06-05,8562
2812,台中銀,46,12,34,新光-高雄,2023-06-05,8562
2206,三陽工業,52,19,33,新光-高雄,2023-06-05,8562
00692,富邦公司治理,31,0,31,新光-高雄,2023-06-05,8562
00713,元大台灣高息低波,85,55,30,新光-高雄,2023-06-05,8562
3508,位速,33,3,30,新光-高雄,2023-06-05,8562
1446,宏和,30,0,30,新光-高雄,2023-06-05,8562
2324,仁寶,49,19,30,新光-高雄,2023-06-05,8562
2527,宏璟,28,0,28,新光-高雄,2023-06-05,8562
00751B,元大AAA至A公司債,25,0,25,新光-高雄,2023-06-05,8562
2903,遠百,25,0,25,新光-高雄,2023-06-05,8562
6163,華電網,25,0,25,新光-高雄,2023-06-05,8562
3522,御嵿,24,0,24,新光-高雄,2023-06-05,8562
1608,華榮,75,51,24,新光-高雄,2023-06-05,8562
0056,元大高股息,108,84,24,新光-高雄,2023-06-05,8562
6005,群益證,29,6,23,新光-高雄,2023-06-05,8562
2357,華碩,23,0,23,新光-高雄,2023-06-05,8562
2449,京元電子,36,13,23,新光-高雄,2023-06-05,8562
5706,鳳凰,48,25,23,新光-高雄,2023-06-05,8562
1605,華新,59,36,23,新光-高雄,2023-06-05,8562
2427,三商電,50,28,22,新光-高雄,2023-06-05,8562
5864,致和證,826,65,761,新光-高雄,2023-06-06,8562
2888,新光金,569,67,502,新光-高雄,2023-06-06,8562
00712,復華富時不動產,274,4,270,新光-高雄,2023-06-06,8562
2402,毅嘉,285,140,145,新光-高雄,2023-06-06,8562
00679B,元大美債20年,131,0,131,新光-高雄,2023-06-06,8562
1609,大亞,457,335,122,新光-高雄,2023-06-06,8562
1528,恩德,155,40,115,新光-高雄,2023-06-06,8562
00664R,國泰臺灣加權反1,100,4,96,新光-高雄,2023-06-06,8562
00919,群益台灣精選高息,149,54,95,新光-高雄,2023-06-06,8562
2427,三商電,150,70,80,新光-高雄,2023-06-06,8562
2399,映泰,147,68,79,新光-高雄,2023-06-06,8562
9945,潤泰新,90,16,74,新光-高雄,2023-06-06,8562
1312,國喬,76,3,73,新光-高雄,2023-06-06,8562
6116,彩晶,116,45,71,新光-高雄,2023-06-06,8562
2388,威盛,118,54,64,新光-高雄,2023-06-06,8562
00713,元大台灣高息低波,64,3,61,新光-高雄,2023-06-06,8562
00673R,期元大S＆P原油反1,179,120,59,新光-高雄,2023-06-06,8562
00795B,中信美國公債20年,57,0,57,新光-高雄,2023-06-06,8562
2472,立隆電,51,0,51,新光-高雄,2023-06-06,8562
2340,台亞,38,1,37,新光-高雄,2023-06-06,8562
2014,中鴻,37,1,36,新光-高雄,2023-06-06,8562
2106,建大,35,0,35,新光-高雄,2023-06-06,8562
00720B,元大投資級公司債,40,7,33,新光-高雄,2023-06-06,8562
2731,雄獅,108,76,32,新光-高雄,2023-06-06,8562
00927,群益半導體收益,32,0,32,新光-高雄,2023-06-06,8562
2328,廣宇,41,10,31,新光-高雄,2023-06-06,8562
4906,正文,33,3,30,新光-高雄,2023-06-06,8562
2353,宏��,58,30,28,新光-高雄,2023-06-06,8562
2887,台新金,45,17,28,新光-高雄,2023-06-06,8562
6282,康舒,153,125,28,新光-高雄,2023-06-06,8562
2706,第一店,94,66,28,新光-高雄,2023-06-06,8562
8038,長園科,27,0,27,新光-高雄,2023-06-06,8562
1810,和成,41,15,26,新光-高雄,2023-06-06,8562
5388,中磊,26,1,25,新光-高雄,2023-06-06,8562
00830,國泰費城半導體,24,0,24,新光-高雄,2023-06-06,8562
3078,僑威,110,87,23,新光-高雄,2023-06-06,8562
6290,良維,31,8,23,新光-高雄,2023-06-06,8562
00632R,元大台灣50反1,32,10,22,新光-高雄,2023-06-06,8562
2504,國產,27,5,22,新光-高雄,2023-06-06,8562
00671R,富邦NASDAQ反1,20,0,20,新光-高雄,2023-06-06,8562
3006,晶豪科,25,5,20,新光-高雄,2023-06-06,8562
00753L,中信中國50正2,32,12,20,新光-高雄,2023-06-06,8562
6477,安集,21,1,20,新光-高雄,2023-06-06,8562
2886,兆豐金,20,1,19,新光-高雄,2023-06-06,8562
4121,優盛,44,25,19,新光-高雄,2023-06-06,8562
8926,台汽電,24,5,19,新光-高雄,2023-06-06,8562
1227,佳格,22,3,19,新光-高雄,2023-06-06,8562
1522,堤維西,19,0,19,新光-高雄,2023-06-06,8562
4533,協易機,148,130,18,新光-高雄,2023-06-06,8562
0056,元大高股息,46,28,18,新光-高雄,2023-06-06,8562
6125,廣運,306,87,219,新光-高雄,2023-06-07,8562
3481,群創,268,49,219,新光-高雄,2023-06-07,8562
00715L,期街口布蘭特正2,222,43,179,新光-高雄,2023-06-07,8562
2347,聯強,188,12,176,新光-高雄,2023-06-07,8562
00637L,元大滬深300正2,282,121,161,新光-高雄,2023-06-07,8562
2881,富邦金,160,5,155,新光-高雄,2023-06-07,8562
2610,華航,224,94,130,新光-高雄,2023-06-07,8562
2455,全新,132,30,102,新光-高雄,2023-06-07,8562
00664R,國泰臺灣加權反1,100,0,100,新光-高雄,2023-06-07,8562
1605,華新,106,12,94,新光-高雄,2023-06-07,8562
9945,潤泰新,91,5,86,新光-高雄,2023-06-07,8562
2888,新光金,251,170,81,新光-高雄,2023-06-07,8562
3231,緯創,198,132,66,新光-高雄,2023-06-07,8562
00927,群益半導體收益,62,10,52,新光-高雄,2023-06-07,8562
00679B,元大美債20年,55,5,50,新光-高雄,2023-06-07,8562
2618,長榮航,175,129,46,新光-高雄,2023-06-07,8562
00919,群益台灣精選高息,48,3,45,新光-高雄,2023-06-07,8562
6116,彩晶,52,8,44,新光-高雄,2023-06-07,8562
6218,豪勉,52,8,44,新光-高雄,2023-06-07,8562
3479,安勤,40,1,39,新光-高雄,2023-06-07,8562
2801,彰銀,36,0,36,新光-高雄,2023-06-07,8562
5475,德宏,35,0,35,新光-高雄,2023-06-07,8562
2701,萬企,45,11,34,新光-高雄,2023-06-07,8562
1513,中興電,43,10,33,新光-高雄,2023-06-07,8562
2409,友達,62,32,30,新光-高雄,2023-06-07,8562
2903,遠百,30,0,30,新光-高雄,2023-06-07,8562
1529,樂事綠能,63,34,29,新光-高雄,2023-06-07,8562
2312,金寶,33,4,29,新光-高雄,2023-06-07,8562
1312,國喬,28,0,28,新光-高雄,2023-06-07,8562
2337,旺宏,30,3,27,新光-高雄,2023-06-07,8562
2349,錸德,25,0,25,新光-高雄,2023-06-07,8562
6112,邁達特,27,3,24,新光-高雄,2023-06-07,8562
8936,國統,51,27,24,新光-高雄,2023-06-07,8562
2867,三商壽,29,5,24,新光-高雄,2023-06-07,8562
3252,海灣,30,7,23,新光-高雄,2023-06-07,8562
2457,飛宏,119,97,22,新光-高雄,2023-06-07,8562
2106,建大,31,10,21,新光-高雄,2023-06-07,8562
8277,商丞,23,2,21,新光-高雄,2023-06-07,8562
00830,國泰費城半導體,25,4,21,新光-高雄,2023-06-07,8562
9136,巨騰-DR,20,0,20,新光-高雄,2023-06-07,8562
2609,陽明,33,13,20,新光-高雄,2023-06-07,8562
2329,華泰,26,7,19,新光-高雄,2023-06-07,8562
6101,寬魚國際,20,1,19,新光-高雄,2023-06-07,8562
2615,萬海,22,3,19,新光-高雄,2023-06-07,8562
4741,泓瀚,20,2,18,新光-高雄,2023-06-07,8562
2812,台中銀,52,34,18,新光-高雄,2023-06-07,8562
1582,信錦,17,0,17,新光-高雄,2023-06-07,8562
6799,來頡,21,4,17,新光-高雄,2023-06-07,8562
2883B,凱基金乙特,17,0,17,新光-高雄,2023-06-07,8562
2323,中環,198,182,16,新光-高雄,2023-06-07,8562
00878,國泰永續高股息,784,286,498,新光-高雄,2023-06-08,8562
0056,元大高股息,586,90,496,新光-高雄,2023-06-08,8562
00680L,元大美債20正2,320,0,320,新光-高雄,2023-06-08,8562
00919,群益台灣精選高息,300,142,158,新光-高雄,2023-06-08,8562
00688L,國泰20年美債正2,150,0,150,新光-高雄,2023-06-08,8562
00679B,元大美債20年,156,7,149,新光-高雄,2023-06-08,8562
00687B,國泰20年美債,171,30,141,新光-高雄,2023-06-08,8562
00751B,元大AAA至A公司債,117,4,113,新光-高雄,2023-06-08,8562
00673R,期元大S＆P原油反1,109,5,104,新光-高雄,2023-06-08,8562
00795B,中信美國公債20年,118,17,101,新光-高雄,2023-06-08,8562
6743,安普新,108,10,98,新光-高雄,2023-06-08,8562
2748,雲品,150,52,98,新光-高雄,2023-06-08,8562
2344,華邦電,161,64,97,新光-高雄,2023-06-08,8562
00637L,元大滬深300正2,110,15,95,新光-高雄,2023-06-08,8562
1609,大亞,540,458,82,新光-高雄,2023-06-08,8562
00713,元大台灣高息低波,126,49,77,新光-高雄,2023-06-08,8562
00772B,中信高評級公司債,68,2,66,新光-高雄,2023-06-08,8562
2882,國泰金,62,5,57,新光-高雄,2023-06-08,8562
00720B,元大投資級公司債,68,11,57,新光-高雄,2023-06-08,8562
2401,凌陽,68,19,49,新光-高雄,2023-06-08,8562
2409,友達,82,33,49,新光-高雄,2023-06-08,8562
2337,旺宏,50,4,46,新光-高雄,2023-06-08,8562
2027,大成鋼,82,37,45,新光-高雄,2023-06-08,8562
00706L,期元大S＆P日圓正2,43,0,43,新光-高雄,2023-06-08,8562
9945,潤泰新,50,8,42,新光-高雄,2023-06-08,8562
6285,啟��,59,23,36,新光-高雄,2023-06-08,8562
2442,新美齊,40,5,35,新光-高雄,2023-06-08,8562
1815,富喬,39,5,34,新光-高雄,2023-06-08,8562
2317,鴻海,68,36,32,新光-高雄,2023-06-08,8562
00882,中信中國高股息,31,0,31,新光-高雄,2023-06-08,8562
5864,致和證,38,8,30,新光-高雄,2023-06-08,8562
1504,東元,50,20,30,新光-高雄,2023-06-08,8562
1618,合機,30,1,29,新光-高雄,2023-06-08,8562
4950,牧東,29,0,29,新光-高雄,2023-06-08,8562
2022,聚亨,27,0,27,新光-高雄,2023-06-08,8562
8936,國統,27,0,27,新光-高雄,2023-06-08,8562
5706,鳳凰,81,54,27,新光-高雄,2023-06-08,8562
2881,富邦金,38,11,27,新光-高雄,2023-06-08,8562
2402,毅嘉,88,61,27,新光-高雄,2023-06-08,8562
2323,中環,85,59,26,新光-高雄,2023-06-08,8562
6112,邁達特,31,5,26,新光-高雄,2023-06-08,8562
4960,誠美材,36,10,26,新光-高雄,2023-06-08,8562
2457,飛宏,64,38,26,新光-高雄,2023-06-08,8562
00927,群益半導體收益,25,0,25,新光-高雄,2023-06-08,8562
2890,永豐金,24,0,24,新光-高雄,2023-06-08,8562
2106,建大,24,0,24,新光-高雄,2023-06-08,8562
8069,元太,24,0,24,新光-高雄,2023-06-08,8562
3583,辛耘,50,27,23,新光-高雄,2023-06-08,8562
3011,今皓,23,0,23,新光-高雄,2023-06-08,8562
1611,中電,25,2,23,新光-高雄,2023-06-08,8562
00715L,期街口布蘭特正2,638,5,633,新光-高雄,2023-06-09,8562
00929,復華台灣科技優息,298,11,287,新光-高雄,2023-06-09,8562
3231,緯創,402,267,135,新光-高雄,2023-06-09,8562
6743,安普新,110,12,98,新光-高雄,2023-06-09,8562
00671R,富邦NASDAQ反1,100,5,95,新光-高雄,2023-06-09,8562
3035,智原,103,18,85,新光-高雄,2023-06-09,8562
00712,復華富時不動產,119,41,78,新光-高雄,2023-06-09,8562
1718,中纖,99,22,77,新光-高雄,2023-06-09,8562
5469,瀚宇博,72,8,64,新光-高雄,2023-06-09,8562
2323,中環,156,93,63,新光-高雄,2023-06-09,8562
3046,建��,198,141,57,新光-高雄,2023-06-09,8562
2356,英業達,175,129,46,新光-高雄,2023-06-09,8562
9941,裕融,45,0,45,新光-高雄,2023-06-09,8562
5340,建榮,49,8,41,新光-高雄,2023-06-09,8562
1504,東元,73,32,41,新光-高雄,2023-06-09,8562
1101,台泥,57,17,40,新光-高雄,2023-06-09,8562
00632R,元大台灣50反1,144,105,39,新光-高雄,2023-06-09,8562
2453,凌群,38,0,38,新光-高雄,2023-06-09,8562
2892,第一金,52,15,37,新光-高雄,2023-06-09,8562
3252,海灣,68,31,37,新光-高雄,2023-06-09,8562
2812,台中銀,60,24,36,新光-高雄,2023-06-09,8562
4543,萬在,43,7,36,新光-高雄,2023-06-09,8562
2884,玉山金,48,13,35,新光-高雄,2023-06-09,8562
2421,建準,98,63,35,新光-高雄,2023-06-09,8562
1905,華紙,61,27,34,新光-高雄,2023-06-09,8562
6235,華孚,74,42,32,新光-高雄,2023-06-09,8562
00919,群益台灣精選高息,297,266,31,新光-高雄,2023-06-09,8562
1612,宏泰,52,22,30,新光-高雄,2023-06-09,8562
2883,凱基金,33,4,29,新光-高雄,2023-06-09,8562
1432,大魯閣,33,5,28,新光-高雄,2023-06-09,8562
2637,慧洋-KY,30,2,28,新光-高雄,2023-06-09,8562
6005,群益證,51,24,27,新光-高雄,2023-06-09,8562
2913,農林,37,11,26,新光-高雄,2023-06-09,8562
4916,事欣科,27,1,26,新光-高雄,2023-06-09,8562
1524,耿鼎,46,22,24,新光-高雄,2023-06-09,8562
4157,太景*-KY,29,5,24,新光-高雄,2023-06-09,8562
3498,陽程,67,44,23,新光-高雄,2023-06-09,8562
2367,燿華,22,0,22,新光-高雄,2023-06-09,8562
1584,精剛,35,13,22,新光-高雄,2023-06-09,8562
2352,佳世達,43,22,21,新光-高雄,2023-06-09,8562
2515,中工,72,51,21,新光-高雄,2023-06-09,8562
6196,帆宣,22,1,21,新光-高雄,2023-06-09,8562
00679B,元大美債20年,26,7,19,新光-高雄,2023-06-09,8562
2371,大同,63,45,18,新光-高雄,2023-06-09,8562
6625,必應,73,56,17,新光-高雄,2023-06-09,8562
6150,撼訊,39,22,17,新光-高雄,2023-06-09,8562
2460,建通,19,2,17,新光-高雄,2023-06-09,8562
2867,三商壽,17,0,17,新光-高雄,2023-06-09,8562
2610,華航,165,148,17,新光-高雄,2023-06-09,8562
1714,和桐,16,0,16,新光-高雄,2023-06-09,8562
00715L,期街口布蘭特正2,552,6,546,新光-高雄,2023-06-12,8562
00919,群益台灣精選高息,526,11,515,新光-高雄,2023-06-12,8562
0056,元大高股息,1010,630,380,新光-高雄,2023-06-12,8562
00929,復華台灣科技優息,382,42,340,新光-高雄,2023-06-12,8562
2888,新光金,514,289,225,新光-高雄,2023-06-12,8562
00642U,期元大S＆P石油,203,0,203,新光-高雄,2023-06-12,8562
00632R,元大台灣50反1,278,132,146,新光-高雄,2023-06-12,8562
00713,元大台灣高息低波,155,10,145,新光-高雄,2023-06-12,8562
3033,威健,122,10,112,新光-高雄,2023-06-12,8562
3062,建漢,113,7,106,新光-高雄,2023-06-12,8562
00664R,國泰臺灣加權反1,105,0,105,新光-高雄,2023-06-12,8562
8034,榮群,132,28,104,新光-高雄,2023-06-12,8562
5425,台半,189,97,92,新光-高雄,2023-06-12,8562
3576,聯合再生,92,4,88,新光-高雄,2023-06-12,8562
00712,復華富時不動產,106,21,85,新光-高雄,2023-06-12,8562
2610,華航,182,102,80,新光-高雄,2023-06-12,8562
2891,中信金,97,22,75,新光-高雄,2023-06-12,8562
00671R,富邦NASDAQ反1,80,5,75,新光-高雄,2023-06-12,8562
2442,新美齊,112,46,66,新光-高雄,2023-06-12,8562
2884,玉山金,75,9,66,新光-高雄,2023-06-12,8562
2392,正崴,87,24,63,新光-高雄,2023-06-12,8562
2542,興富發,85,28,57,新光-高雄,2023-06-12,8562
1101,台泥,84,27,57,新光-高雄,2023-06-12,8562
4190,佐登-KY,59,3,56,新光-高雄,2023-06-12,8562
2356,英業達,74,18,56,新光-高雄,2023-06-12,8562
00706L,期元大S＆P日圓正2,54,0,54,新光-高雄,2023-06-12,8562
00900,富邦特選高股息30,87,33,54,新光-高雄,2023-06-12,8562
2402,毅嘉,75,25,50,新光-高雄,2023-06-12,8562
3481,群創,115,67,48,新光-高雄,2023-06-12,8562
1513,中興電,54,8,46,新光-高雄,2023-06-12,8562
2022,聚亨,55,10,45,新光-高雄,2023-06-12,8562
2882,國泰金,48,3,45,新光-高雄,2023-06-12,8562
2206,三陽工業,63,21,42,新光-高雄,2023-06-12,8562
2106,建大,43,1,42,新光-高雄,2023-06-12,8562
2388,威盛,50,9,41,新光-高雄,2023-06-12,8562
2515,中工,68,28,40,新光-高雄,2023-06-12,8562
5426,振發,40,0,40,新光-高雄,2023-06-12,8562
5864,致和證,38,0,38,新光-高雄,2023-06-12,8562
6257,矽格,37,0,37,新光-高雄,2023-06-12,8562
6163,華電網,42,7,35,新光-高雄,2023-06-12,8562
2409,友達,50,16,34,新光-高雄,2023-06-12,8562
2421,建準,61,27,34,新光-高雄,2023-06-12,8562
2352,佳世達,43,11,32,新光-高雄,2023-06-12,8562
3374,精材,109,77,32,新光-高雄,2023-06-12,8562
00885,富邦越南,53,21,32,新光-高雄,2023-06-12,8562
4543,萬在,61,30,31,新光-高雄,2023-06-12,8562
00679B,元大美債20年,41,11,30,新光-高雄,2023-06-12,8562
3714,富采,36,6,30,新光-高雄,2023-06-12,8562
00795B,中信美國公債20年,29,0,29,新光-高雄,2023-06-12,8562
3264,欣銓,39,11,28,新光-高雄,2023-06-12,8562
00715L,期街口布蘭特正2,1564,83,1481,新光-高雄,2023-06-13,8562
00642U,期元大S＆P石油,185,5,180,新光-高雄,2023-06-13,8562
00664R,國泰臺灣加權反1,155,2,153,新光-高雄,2023-06-13,8562
00669R,國泰美國道瓊反1,125,0,125,新光-高雄,2023-06-13,8562
00632R,元大台灣50反1,449,329,120,新光-高雄,2023-06-13,8562
1718,中纖,90,0,90,新光-高雄,2023-06-13,8562
3260,威剛,107,24,83,新光-高雄,2023-06-13,8562
00671R,富邦NASDAQ反1,70,0,70,新光-高雄,2023-06-13,8562
2883,凱基金,72,9,63,新光-高雄,2023-06-13,8562
00637L,元大滬深300正2,111,50,61,新光-高雄,2023-06-13,8562
2845,遠東銀,50,0,50,新光-高雄,2023-06-13,8562
3576,聯合再生,50,1,49,新光-高雄,2023-06-13,8562
6116,彩晶,81,32,49,新光-高雄,2023-06-13,8562
00680L,元大美債20正2,54,6,48,新光-高雄,2023-06-13,8562
3231,緯創,202,156,46,新光-高雄,2023-06-13,8562
2515,中工,51,11,40,新光-高雄,2023-06-13,8562
2344,華邦電,127,91,36,新光-高雄,2023-06-13,8562
3558,神準,41,6,35,新光-高雄,2023-06-13,8562
2903,遠百,34,0,34,新光-高雄,2023-06-13,8562
1101,台泥,38,4,34,新光-高雄,2023-06-13,8562
2812,台中銀,33,0,33,新光-高雄,2023-06-13,8562
4190,佐登-KY,33,1,32,新光-高雄,2023-06-13,8562
5871,中租-KY,33,3,30,新光-高雄,2023-06-13,8562
2897,王道銀行,32,2,30,新光-高雄,2023-06-13,8562
2449,京元電子,112,83,29,新光-高雄,2023-06-13,8562
2027,大成鋼,36,9,27,新光-高雄,2023-06-13,8562
00915,凱基優選高股息30,28,1,27,新光-高雄,2023-06-13,8562
1524,耿鼎,58,32,26,新光-高雄,2023-06-13,8562
3062,建漢,26,0,26,新光-高雄,2023-06-13,8562
5864,致和證,26,1,25,新光-高雄,2023-06-13,8562
3035,智原,75,51,24,新光-高雄,2023-06-13,8562
1319,東陽,35,11,24,新光-高雄,2023-06-13,8562
2882,國泰金,27,4,23,新光-高雄,2023-06-13,8562
2888,新光金,191,168,23,新光-高雄,2023-06-13,8562
5706,鳳凰,78,56,22,新光-高雄,2023-06-13,8562
2731,雄獅,33,13,20,新光-高雄,2023-06-13,8562
3209,全科,25,5,20,新光-高雄,2023-06-13,8562
00688L,國泰20年美債正2,20,0,20,新光-高雄,2023-06-13,8562
2402,毅嘉,37,18,19,新光-高雄,2023-06-13,8562
3178,公準,31,12,19,新光-高雄,2023-06-13,8562
3714,富采,21,2,19,新光-高雄,2023-06-13,8562
2834,臺企銀,96,77,19,新光-高雄,2023-06-13,8562
4919,新唐,41,22,19,新光-高雄,2023-06-13,8562
3207,耀勝,19,0,19,新光-高雄,2023-06-13,8562
00713,元大台灣高息低波,25,7,18,新光-高雄,2023-06-13,8562
8072,陞泰,18,0,18,新光-高雄,2023-06-13,8562
1582,信錦,18,0,18,新光-高雄,2023-06-13,8562
1785,光洋科,22,4,18,新光-高雄,2023-06-13,8562
2890,永豐金,23,5,18,新光-高雄,2023-06-13,8562
3434,哲固,17,0,17,新光-高雄,2023-06-13,8562
2515,中工,236,0,236,新光-高雄,2023-06-14,8562
2356,英業達,504,292,212,新光-高雄,2023-06-14,8562
1201,味全,201,0,201,新光-高雄,2023-06-14,8562
00919,群益台灣精選高息,219,63,156,新光-高雄,2023-06-14,8562
00712,復華富時不動產,179,54,125,新光-高雄,2023-06-14,8562
00680L,元大美債20正2,108,0,108,新光-高雄,2023-06-14,8562
00664R,國泰臺灣加權反1,105,0,105,新光-高雄,2023-06-14,8562
2888,新光金,140,39,101,新光-高雄,2023-06-14,8562
4533,協易機,165,78,87,新光-高雄,2023-06-14,8562
8028,昇陽半導體,87,11,76,新光-高雄,2023-06-14,8562
00679B,元大美債20年,91,17,74,新光-高雄,2023-06-14,8562
00687B,國泰20年美債,76,4,72,新光-高雄,2023-06-14,8562
2363,矽統,73,5,68,新光-高雄,2023-06-14,8562
2889,國票金,61,1,60,新光-高雄,2023-06-14,8562
2106,建大,58,1,57,新光-高雄,2023-06-14,8562
5258,虹堡,212,159,53,新光-高雄,2023-06-14,8562
5469,瀚宇博,48,0,48,新光-高雄,2023-06-14,8562
00751B,元大AAA至A公司債,47,0,47,新光-高雄,2023-06-14,8562
8112,至上,51,6,45,新光-高雄,2023-06-14,8562
1522,堤維西,194,149,45,新光-高雄,2023-06-14,8562
6120,達運,57,15,42,新光-高雄,2023-06-14,8562
3308,聯德,65,23,42,新光-高雄,2023-06-14,8562
00772B,中信高評級公司債,40,4,36,新光-高雄,2023-06-14,8562
2745,五福,44,8,36,新光-高雄,2023-06-14,8562
1609,大亞,188,153,35,新光-高雄,2023-06-14,8562
2891,中信金,34,0,34,新光-高雄,2023-06-14,8562
1101,台泥,43,12,31,新光-高雄,2023-06-14,8562
8163,達方,36,6,30,新光-高雄,2023-06-14,8562
00773B,中信優先金融債,28,0,28,新光-高雄,2023-06-14,8562
4510,高鋒,79,51,28,新光-高雄,2023-06-14,8562
6191,精成科,28,1,27,新光-高雄,2023-06-14,8562
2301,光寶科,35,8,27,新光-高雄,2023-06-14,8562
2886,兆豐金,37,10,27,新光-高雄,2023-06-14,8562
8034,榮群,27,0,27,新光-高雄,2023-06-14,8562
4950,牧東,25,0,25,新光-高雄,2023-06-14,8562
3481,群創,44,19,25,新光-高雄,2023-06-14,8562
00929,復華台灣科技優息,48,25,23,新光-高雄,2023-06-14,8562
5425,台半,48,25,23,新光-高雄,2023-06-14,8562
00706L,期元大S＆P日圓正2,23,0,23,新光-高雄,2023-06-14,8562
6005,群益證,23,0,23,新光-高雄,2023-06-14,8562
2201,裕隆,39,16,23,新光-高雄,2023-06-14,8562
3583,辛耘,69,46,23,新光-高雄,2023-06-14,8562
2705,六福,86,64,22,新光-高雄,2023-06-14,8562
1785,光洋科,31,9,22,新光-高雄,2023-06-14,8562
6139,亞翔,22,0,22,新光-高雄,2023-06-14,8562
2353,宏��,45,24,21,新光-高雄,2023-06-14,8562
00655L,國泰中國A50正2,33,12,21,新光-高雄,2023-06-14,8562
3362,先進光,24,3,21,新光-高雄,2023-06-14,8562
8072,陞泰,26,5,21,新光-高雄,2023-06-14,8562
00671R,富邦NASDAQ反1,20,0,20,新光-高雄,2023-06-14,8562
2515,中工,607,0,607,新光-高雄,2023-06-15,8562
2618,長榮航,1009,709,300,新光-高雄,2023-06-15,8562
00919,群益台灣精選高息,306,19,287,新光-高雄,2023-06-15,8562
00632R,元大台灣50反1,270,3,267,新光-高雄,2023-06-15,8562
5864,致和證,248,1,247,新光-高雄,2023-06-15,8562
00715L,期街口布蘭特正2,584,360,224,新光-高雄,2023-06-15,8562
00712,復華富時不動產,214,22,192,新光-高雄,2023-06-15,8562
00664R,國泰臺灣加權反1,150,0,150,新光-高雄,2023-06-15,8562
1201,味全,146,0,146,新光-高雄,2023-06-15,8562
1528,恩德,156,23,133,新光-高雄,2023-06-15,8562
5258,虹堡,201,78,123,新光-高雄,2023-06-15,8562
2022,聚亨,115,2,113,新光-高雄,2023-06-15,8562
2892,第一金,100,5,95,新光-高雄,2023-06-15,8562
9904,寶成,85,0,85,新光-高雄,2023-06-15,8562
8076,伍豐,134,67,67,新光-高雄,2023-06-15,8562
3706,神達,172,110,62,新光-高雄,2023-06-15,8562
00642U,期元大S＆P石油,99,37,62,新光-高雄,2023-06-15,8562
00706L,期元大S＆P日圓正2,59,1,58,新光-高雄,2023-06-15,8562
00680L,元大美債20正2,56,0,56,新光-高雄,2023-06-15,8562
2888,新光金,81,29,52,新光-高雄,2023-06-15,8562
2885,元大金,59,8,51,新光-高雄,2023-06-15,8562
00772B,中信高評級公司債,54,3,51,新光-高雄,2023-06-15,8562
4973,廣穎,56,6,50,新光-高雄,2023-06-15,8562
2883,凱基金,51,2,49,新光-高雄,2023-06-15,8562
3312,弘憶股,50,1,49,新光-高雄,2023-06-15,8562
2323,中環,63,17,46,新光-高雄,2023-06-15,8562
2405,輔信,52,8,44,新光-高雄,2023-06-15,8562
3013,晟銘電,87,44,43,新光-高雄,2023-06-15,8562
2399,映泰,125,85,40,新光-高雄,2023-06-15,8562
2851,中再保,39,0,39,新光-高雄,2023-06-15,8562
1477,聚陽,41,2,39,新光-高雄,2023-06-15,8562
3346,麗清,42,4,38,新光-高雄,2023-06-15,8562
8415,大國鋼,40,3,37,新光-高雄,2023-06-15,8562
4533,協易機,56,21,35,新光-高雄,2023-06-15,8562
3576,聯合再生,42,8,34,新光-高雄,2023-06-15,8562
00679B,元大美債20年,53,20,33,新光-高雄,2023-06-15,8562
2365,昆盈,30,0,30,新光-高雄,2023-06-15,8562
00885,富邦越南,31,3,28,新光-高雄,2023-06-15,8562
2453,凌群,254,226,28,新光-高雄,2023-06-15,8562
2344,華邦電,72,46,26,新光-高雄,2023-06-15,8562
3702A,大聯大甲特,30,5,25,新光-高雄,2023-06-15,8562
00673R,期元大S＆P原油反1,72,47,25,新光-高雄,2023-06-15,8562
4950,牧東,25,0,25,新光-高雄,2023-06-15,8562
2402,毅嘉,85,61,24,新光-高雄,2023-06-15,8562
6485,點序,24,1,23,新光-高雄,2023-06-15,8562
1806,冠軍,38,15,23,新光-高雄,2023-06-15,8562
6657,華安,23,0,23,新光-高雄,2023-06-15,8562
3032,偉訓,30,7,23,新光-高雄,2023-06-15,8562
00687B,國泰20年美債,35,13,22,新光-高雄,2023-06-15,8562
01003T,兆豐新光R1,22,0,22,新光-高雄,2023-06-15,8562
1815,富喬,376,39,337,新光-高雄,2023-06-16,8562
1201,味全,210,0,210,新光-高雄,2023-06-16,8562
1608,華榮,215,18,197,新光-高雄,2023-06-16,8562
2492,華新科,163,2,161,新光-高雄,2023-06-16,8562
0056,元大高股息,761,609,152,新光-高雄,2023-06-16,8562
00919,群益台灣精選高息,347,199,148,新光-高雄,2023-06-16,8562
2610,華航,927,789,138,新光-高雄,2023-06-16,8562
00673R,期元大S＆P原油反1,135,0,135,新光-高雄,2023-06-16,8562
00885,富邦越南,125,8,117,新光-高雄,2023-06-16,8562
2834,臺企銀,125,23,102,新光-高雄,2023-06-16,8562
00664R,國泰臺灣加權反1,101,0,101,新光-高雄,2023-06-16,8562
1905,華紙,123,30,93,新光-高雄,2023-06-16,8562
2890,永豐金,87,0,87,新光-高雄,2023-06-16,8562
1802,台玻,144,64,80,新光-高雄,2023-06-16,8562
2888,新光金,115,38,77,新光-高雄,2023-06-16,8562
2371,大同,313,248,65,新光-高雄,2023-06-16,8562
00706L,期元大S＆P日圓正2,65,0,65,新光-高雄,2023-06-16,8562
6116,彩晶,116,53,63,新光-高雄,2023-06-16,8562
2201,裕隆,79,25,54,新光-高雄,2023-06-16,8562
8926,台汽電,81,29,52,新光-高雄,2023-06-16,8562
1529,樂事綠能,89,38,51,新光-高雄,2023-06-16,8562
3027,盛達,85,34,51,新光-高雄,2023-06-16,8562
1609,大亞,284,237,47,新光-高雄,2023-06-16,8562
4938,和碩,72,26,46,新光-高雄,2023-06-16,8562
1108,幸福,63,19,44,新光-高雄,2023-06-16,8562
6282,康舒,82,40,42,新光-高雄,2023-06-16,8562
2105,正新,71,30,41,新光-高雄,2023-06-16,8562
2903,遠百,40,0,40,新光-高雄,2023-06-16,8562
2489,瑞軒,58,18,40,新光-高雄,2023-06-16,8562
3693,營邦,63,26,37,新光-高雄,2023-06-16,8562
2002,中鋼,40,4,36,新光-高雄,2023-06-16,8562
2401,凌陽,84,48,36,新光-高雄,2023-06-16,8562
3032,偉訓,45,9,36,新光-高雄,2023-06-16,8562
3062,建漢,40,5,35,新光-高雄,2023-06-16,8562
2301,光寶科,68,34,34,新光-高雄,2023-06-16,8562
5871,中租-KY,33,1,32,新光-高雄,2023-06-16,8562
2402,毅嘉,47,17,30,新光-高雄,2023-06-16,8562
1789,神隆,57,28,29,新光-高雄,2023-06-16,8562
8076,伍豐,87,57,30,新光-高雄,2023-06-16,8562
2457,飛宏,94,65,29,新光-高雄,2023-06-16,8562
2206,三陽工業,63,35,28,新光-高雄,2023-06-16,8562
3706,神達,186,158,28,新光-高雄,2023-06-16,8562
00674R,期元大S＆P黃金反1,31,3,28,新光-高雄,2023-06-16,8562
8936,國統,33,6,27,新光-高雄,2023-06-16,8562
3035,智原,55,29,26,新光-高雄,2023-06-16,8562
3264,欣銓,43,18,25,新光-高雄,2023-06-16,8562
5475,德宏,24,0,24,新光-高雄,2023-06-16,8562
6177,達麗,23,0,23,新光-高雄,2023-06-16,8562
1503,士電,78,56,22,新光-高雄,2023-06-16,8562
5201,凱衛,25,3,22,新光-高雄,2023-06-16,8562
2409,友達,1061,182,879,新光-高雄,2023-06-19,8562
0056,元大高股息,913,81,832,新光-高雄,2023-06-19,8562
2515,中工,510,0,510,新光-高雄,2023-06-19,8562
00673R,期元大S＆P原油反1,491,0,491,新光-高雄,2023-06-19,8562
00712,復華富時不動產,502,50,452,新光-高雄,2023-06-19,8562
00637L,元大滬深300正2,252,43,209,新光-高雄,2023-06-19,8562
2312,金寶,238,60,178,新光-高雄,2023-06-19,8562
2104,國際中橡,231,72,159,新光-高雄,2023-06-19,8562
1308,亞聚,125,0,125,新光-高雄,2023-06-19,8562
1718,中纖,120,0,120,新光-高雄,2023-06-19,8562
2888,新光金,140,20,120,新光-高雄,2023-06-19,8562
4543,萬在,131,15,116,新光-高雄,2023-06-19,8562
1201,味全,111,0,111,新光-高雄,2023-06-19,8562
00706L,期元大S＆P日圓正2,97,0,97,新光-高雄,2023-06-19,8562
00679B,元大美債20年,103,21,82,新光-高雄,2023-06-19,8562
2324,仁寶,119,51,68,新光-高雄,2023-06-19,8562
2352,佳世達,73,9,64,新光-高雄,2023-06-19,8562
1528,恩德,175,115,60,新光-高雄,2023-06-19,8562
1301,台塑,53,0,53,新光-高雄,2023-06-19,8562
2883,凱基金,66,17,49,新光-高雄,2023-06-19,8562
1736,喬山,51,2,49,新光-高雄,2023-06-19,8562
00680L,元大美債20正2,74,31,43,新光-高雄,2023-06-19,8562
1605,華新,80,38,42,新光-高雄,2023-06-19,8562
2206,三陽工業,77,36,41,新光-高雄,2023-06-19,8562
2340,台亞,41,2,39,新光-高雄,2023-06-19,8562
1711,永光,38,1,37,新光-高雄,2023-06-19,8562
00720B,元大投資級公司債,41,4,37,新光-高雄,2023-06-19,8562
00675L,富邦臺灣加權正2,37,1,36,新光-高雄,2023-06-19,8562
3231,緯創,154,118,36,新光-高雄,2023-06-19,8562
2913,農林,40,5,35,新光-高雄,2023-06-19,8562
2891,中信金,49,15,34,新光-高雄,2023-06-19,8562
2867,三商壽,32,0,32,新光-高雄,2023-06-19,8562
2610,華航,408,379,29,新光-高雄,2023-06-19,8562
00665L,富邦�琤肭磪囓�2,56,27,29,新光-高雄,2023-06-19,8562
6485,點序,38,10,28,新光-高雄,2023-06-19,8562
5009,榮剛,69,41,28,新光-高雄,2023-06-19,8562
2002,中鋼,30,4,26,新光-高雄,2023-06-19,8562
1519,華城,67,42,25,新光-高雄,2023-06-19,8562
3209,全科,25,0,25,新光-高雄,2023-06-19,8562
2498,宏達電,28,4,24,新光-高雄,2023-06-19,8562
2892,第一金,35,11,24,新光-高雄,2023-06-19,8562
2359,所羅門,25,2,23,新光-高雄,2023-06-19,8562
1314,中石化,23,0,23,新光-高雄,2023-06-19,8562
3706,神達,88,66,22,新光-高雄,2023-06-19,8562
6148,驊宏資,105,83,22,新光-高雄,2023-06-19,8562
6104,創惟,47,26,21,新光-高雄,2023-06-19,8562
2609,陽明,30,10,20,新光-高雄,2023-06-19,8562
3044,健鼎,21,1,20,新光-高雄,2023-06-19,8562
3252,海灣,38,18,20,新光-高雄,2023-06-19,8562
2014,中鴻,28,8,20,新光-高雄,2023-06-19,8562
2515,中工,506,10,496,新光-高雄,2023-06-20,8562
2317,鴻海,382,88,294,新光-高雄,2023-06-20,8562
00673R,期元大S＆P原油反1,270,8,262,新光-高雄,2023-06-20,8562
3481,群創,283,86,197,新光-高雄,2023-06-20,8562
00712,復華富時不動產,210,35,175,新光-高雄,2023-06-20,8562
00680L,元大美債20正2,130,40,90,新光-高雄,2023-06-20,8562
2634,漢翔,277,187,90,新光-高雄,2023-06-20,8562
2409,友達,220,135,85,新光-高雄,2023-06-20,8562
5864,致和證,84,0,84,新光-高雄,2023-06-20,8562
00929,復華台灣科技優息,96,16,80,新光-高雄,2023-06-20,8562
2618,長榮航,167,97,70,新光-高雄,2023-06-20,8562
2888,新光金,112,46,66,新光-高雄,2023-06-20,8562
00688L,國泰20年美債正2,63,0,63,新光-高雄,2023-06-20,8562
6111,大宇資,101,42,59,新光-高雄,2023-06-20,8562
6266,泰詠,61,7,54,新光-高雄,2023-06-20,8562
3289,宜特,55,2,53,新光-高雄,2023-06-20,8562
3581,博磊,58,6,52,新光-高雄,2023-06-20,8562
2461,光群雷,51,0,51,新光-高雄,2023-06-20,8562
8072,陞泰,49,0,49,新光-高雄,2023-06-20,8562
00878,國泰永續高股息,170,124,46,新光-高雄,2023-06-20,8562
2610,華航,302,258,44,新光-高雄,2023-06-20,8562
00687B,國泰20年美債,79,35,44,新光-高雄,2023-06-20,8562
00706L,期元大S＆P日圓正2,47,5,42,新光-高雄,2023-06-20,8562
2340,台亞,80,38,42,新光-高雄,2023-06-20,8562
2327,國巨,43,3,40,新光-高雄,2023-06-20,8562
00637L,元大滬深300正2,80,41,39,新光-高雄,2023-06-20,8562
2454,聯發科,49,11,38,新光-高雄,2023-06-20,8562
00781B,國泰A級科技債,38,0,38,新光-高雄,2023-06-20,8562
1802,台玻,48,13,35,新光-高雄,2023-06-20,8562
00773B,中信優先金融債,35,0,35,新光-高雄,2023-06-20,8562
2323,中環,291,257,34,新光-高雄,2023-06-20,8562
2027,大成鋼,35,1,34,新光-高雄,2023-06-20,8562
6443,元晶,61,27,34,新光-高雄,2023-06-20,8562
2883,凱基金,38,5,33,新光-高雄,2023-06-20,8562
2337,旺宏,39,8,31,新光-高雄,2023-06-20,8562
2301,光寶科,40,10,30,新光-高雄,2023-06-20,8562
2601,益航,30,1,29,新光-高雄,2023-06-20,8562
1337,再生-KY,29,2,27,新光-高雄,2023-06-20,8562
2382,廣達,84,57,27,新光-高雄,2023-06-20,8562
6191,精成科,26,1,25,新光-高雄,2023-06-20,8562
1522,堤維西,37,12,25,新光-高雄,2023-06-20,8562
1471,首利,29,4,25,新光-高雄,2023-06-20,8562
6147,頎邦,28,4,24,新光-高雄,2023-06-20,8562
2482,連宇,47,23,24,新光-高雄,2023-06-20,8562
5876,上海商銀,22,0,22,新光-高雄,2023-06-20,8562
1460,宏遠,22,0,22,新光-高雄,2023-06-20,8562
8222,寶一,84,63,21,新光-高雄,2023-06-20,8562
1210,大成,22,1,21,新光-高雄,2023-06-20,8562
00636,國泰中國A50,20,0,20,新光-高雄,2023-06-20,8562
3652,精聯,29,9,20,新光-高雄,2023-06-20,8562
00673R,期元大S＆P原油反1,350,6,344,新光-高雄,2023-06-21,8562
00900,富邦特選高股息30,286,12,274,新光-高雄,2023-06-21,8562
00895,富邦未來車,261,9,252,新光-高雄,2023-06-21,8562
00919,群益台灣精選高息,170,5,165,新光-高雄,2023-06-21,8562
2618,長榮航,311,162,149,新光-高雄,2023-06-21,8562
00753L,中信中國50正2,219,81,138,新光-高雄,2023-06-21,8562
2705,六福,267,150,117,新光-高雄,2023-06-21,8562
00929,復華台灣科技優息,156,61,95,新光-高雄,2023-06-21,8562
2382,廣達,162,74,88,新光-高雄,2023-06-21,8562
3481,群創,356,269,87,新光-高雄,2023-06-21,8562
2634,漢翔,224,162,62,新光-高雄,2023-06-21,8562
00882,中信中國高股息,61,0,61,新光-高雄,2023-06-21,8562
1905,華紙,196,139,57,新光-高雄,2023-06-21,8562
2002,中鋼,54,1,53,新光-高雄,2023-06-21,8562
9941,裕融,51,1,50,新光-高雄,2023-06-21,8562
2323,中環,251,203,48,新光-高雄,2023-06-21,8562
2889,國票金,47,0,47,新光-高雄,2023-06-21,8562
2356,英業達,136,89,47,新光-高雄,2023-06-21,8562
00687B,國泰20年美債,88,46,42,新光-高雄,2023-06-21,8562
2104,國際中橡,41,1,40,新光-高雄,2023-06-21,8562
2027,大成鋼,39,0,39,新光-高雄,2023-06-21,8562
00706L,期元大S＆P日圓正2,50,11,39,新光-高雄,2023-06-21,8562
8163,達方,39,3,36,新光-高雄,2023-06-21,8562
2645,長榮航太,33,0,33,新光-高雄,2023-06-21,8562
3289,宜特,42,11,31,新光-高雄,2023-06-21,8562
00632R,元大台灣50反1,40,10,30,新光-高雄,2023-06-21,8562
1711,永光,31,1,30,新光-高雄,2023-06-21,8562
2230,泰茂,38,8,30,新光-高雄,2023-06-21,8562
1227,佳格,27,0,27,新光-高雄,2023-06-21,8562
2888,新光金,28,2,26,新光-高雄,2023-06-21,8562
3687,歐買尬,53,27,26,新光-高雄,2023-06-21,8562
2637,慧洋-KY,26,0,26,新光-高雄,2023-06-21,8562
5309,系統電,26,1,25,新光-高雄,2023-06-21,8562
3013,晟銘電,54,29,25,新光-高雄,2023-06-21,8562
6170,統振,35,11,24,新光-高雄,2023-06-21,8562
00665L,富邦�琤肭磪囓�2,28,5,23,新光-高雄,2023-06-21,8562
2073,雄順,26,4,22,新光-高雄,2023-06-21,8562
2748,雲品,159,138,21,新光-高雄,2023-06-21,8562
00713,元大台灣高息低波,26,5,21,新光-高雄,2023-06-21,8562
00752,中信中國50,22,1,21,新光-高雄,2023-06-21,8562
9907,統一實,21,1,20,新光-高雄,2023-06-21,8562
00675L,富邦臺灣加權正2,20,1,19,新光-高雄,2023-06-21,8562
00637L,元大滬深300正2,48,29,19,新光-高雄,2023-06-21,8562
6282,康舒,47,29,18,新光-高雄,2023-06-21,8562
2303,聯電,60,42,18,新光-高雄,2023-06-21,8562
1471,首利,33,15,18,新光-高雄,2023-06-21,8562
1432,大魯閣,18,0,18,新光-高雄,2023-06-21,8562
00650L,復華香港正2,18,0,18,新光-高雄,2023-06-21,8562
6111,大宇資,54,37,17,新光-高雄,2023-06-21,8562
1736,喬山,17,0,17,新光-高雄,2023-06-21,8562
00715L,期街口布蘭特正2,728,54,674,新光-高雄,2023-06-26,8562
00888,永豐台灣ESG,237,0,237,新光-高雄,2023-06-26,8562
00878,國泰永續高股息,434,287,147,新光-高雄,2023-06-26,8562
00712,復華富時不動產,207,65,142,新光-高雄,2023-06-26,8562
1605,華新,142,13,129,新光-高雄,2023-06-26,8562
2637,慧洋-KY,102,1,101,新光-高雄,2023-06-26,8562
3231,緯創,247,170,77,新光-高雄,2023-06-26,8562
00637L,元大滬深300正2,164,88,76,新光-高雄,2023-06-26,8562
00882,中信中國高股息,74,0,74,新光-高雄,2023-06-26,8562
2409,友達,111,39,72,新光-高雄,2023-06-26,8562
00706L,期元大S＆P日圓正2,80,10,70,新光-高雄,2023-06-26,8562
2106,建大,71,1,70,新光-高雄,2023-06-26,8562
00642U,期元大S＆P石油,62,0,62,新光-高雄,2023-06-26,8562
6111,大宇資,85,34,51,新光-高雄,2023-06-26,8562
5864,致和證,50,0,50,新光-高雄,2023-06-26,8562
2344,華邦電,187,138,49,新光-高雄,2023-06-26,8562
2887,台新金,48,3,45,新光-高雄,2023-06-26,8562
4916,事欣科,75,38,37,新光-高雄,2023-06-26,8562
3673,TPK-KY,50,13,37,新光-高雄,2023-06-26,8562
01003T,兆豐新光R1,36,0,36,新光-高雄,2023-06-26,8562
1802,台玻,112,76,36,新光-高雄,2023-06-26,8562
00687B,國泰20年美債,46,13,33,新光-高雄,2023-06-26,8562
2618,長榮航,221,187,34,新光-高雄,2023-06-26,8562
2457,飛宏,56,23,33,新光-高雄,2023-06-26,8562
2104,國際中橡,44,12,32,新光-高雄,2023-06-26,8562
2888,新光金,61,30,31,新光-高雄,2023-06-26,8562
2332,友訊,40,11,29,新光-高雄,2023-06-26,8562
2913,農林,81,52,29,新光-高雄,2023-06-26,8562
3380,明泰,31,2,29,新光-高雄,2023-06-26,8562
1522,堤維西,74,46,28,新光-高雄,2023-06-26,8562
00929,復華台灣科技優息,38,10,28,新光-高雄,2023-06-26,8562
2610,華航,174,147,27,新光-高雄,2023-06-26,8562
6125,廣運,211,184,27,新光-高雄,2023-06-26,8562
2889,國票金,26,0,26,新光-高雄,2023-06-26,8562
6257,矽格,26,0,26,新光-高雄,2023-06-26,8562
2892,第一金,29,3,26,新光-高雄,2023-06-26,8562
00633L,富邦上証正2,27,2,25,新光-高雄,2023-06-26,8562
2352,佳世達,49,26,23,新光-高雄,2023-06-26,8562
1504,東元,50,26,24,新光-高雄,2023-06-26,8562
2504,國產,23,0,23,新光-高雄,2023-06-26,8562
2603,長榮,47,25,22,新光-高雄,2023-06-26,8562
3317,尼克森,20,0,20,新光-高雄,2023-06-26,8562
2027,大成鋼,25,6,19,新光-高雄,2023-06-26,8562
5880,合庫金,20,1,19,新光-高雄,2023-06-26,8562
2881,富邦金,19,0,19,新光-高雄,2023-06-26,8562
3033,威健,20,1,19,新光-高雄,2023-06-26,8562
1734,杏輝,22,3,19,新光-高雄,2023-06-26,8562
00671R,富邦NASDAQ反1,18,0,18,新光-高雄,2023-06-26,8562
1513,中興電,61,43,18,新光-高雄,2023-06-26,8562
2867,三商壽,80,62,18,新光-高雄,2023-06-26,8562
00929,復華台灣科技優息,297,16,281,新光-高雄,2023-06-27,8562
00637L,元大滬深300正2,307,98,209,新光-高雄,2023-06-27,8562
2344,華邦電,248,119,129,新光-高雄,2023-06-27,8562
2610,華航,486,362,124,新光-高雄,2023-06-27,8562
2409,友達,197,74,123,新光-高雄,2023-06-27,8562
2303,聯電,126,16,110,新光-高雄,2023-06-27,8562
00919,群益台灣精選高息,156,52,104,新光-高雄,2023-06-27,8562
00882,中信中國高股息,104,0,104,新光-高雄,2023-06-27,8562
2885,元大金,91,6,85,新光-高雄,2023-06-27,8562
1605,華新,122,39,83,新光-高雄,2023-06-27,8562
3202,樺晟,117,42,75,新光-高雄,2023-06-27,8562
00888,永豐台灣ESG,74,1,73,新光-高雄,2023-06-27,8562
2332,友訊,120,53,67,新光-高雄,2023-06-27,8562
2867,三商壽,65,1,64,新光-高雄,2023-06-27,8562
6111,大宇資,142,79,63,新光-高雄,2023-06-27,8562
01003T,兆豐新光R1,61,0,61,新光-高雄,2023-06-27,8562
2888,新光金,83,23,60,新光-高雄,2023-06-27,8562
0056,元大高股息,138,80,58,新光-高雄,2023-06-27,8562
00706L,期元大S＆P日圓正2,48,0,48,新光-高雄,2023-06-27,8562
3035,智原,72,23,49,新光-高雄,2023-06-27,8562
2356,英業達,85,37,48,新光-高雄,2023-06-27,8562
1907,永豐餘,145,98,47,新光-高雄,2023-06-27,8562
00795B,中信美國公債20年,52,5,47,新光-高雄,2023-06-27,8562
2317,鴻海,89,45,44,新光-高雄,2023-06-27,8562
00680L,元大美債20正2,45,3,42,新光-高雄,2023-06-27,8562
2023,燁輝,45,4,41,新光-高雄,2023-06-27,8562
3231,緯創,240,199,41,新光-高雄,2023-06-27,8562
3049,精金,79,40,39,新光-高雄,2023-06-27,8562
00688L,國泰20年美債正2,39,0,39,新光-高雄,2023-06-27,8562
1522,堤維西,53,15,38,新光-高雄,2023-06-27,8562
2891,中信金,37,0,37,新光-高雄,2023-06-27,8562
2498,宏達電,34,2,32,新光-高雄,2023-06-27,8562
2886,兆豐金,33,2,31,新光-高雄,2023-06-27,8562
2883,凱基金,30,1,29,新光-高雄,2023-06-27,8562
3032,偉訓,46,17,29,新光-高雄,2023-06-27,8562
4130,健亞,31,3,28,新光-高雄,2023-06-27,8562
00712,復華富時不動產,51,24,27,新光-高雄,2023-06-27,8562
2457,飛宏,86,60,26,新光-高雄,2023-06-27,8562
3038,全台,119,93,26,新光-高雄,2023-06-27,8562
2606,裕民,27,2,25,新光-高雄,2023-06-27,8562
2442,新美齊,27,2,25,新光-高雄,2023-06-27,8562
6188,廣明,44,19,25,新光-高雄,2023-06-27,8562
6770,力積電,25,1,24,新光-高雄,2023-06-27,8562
3587,閎康,29,5,24,新光-高雄,2023-06-27,8562
1810,和成,24,0,24,新光-高雄,2023-06-27,8562
2353,宏��,166,142,24,新光-高雄,2023-06-27,8562
6282,康舒,38,14,24,新光-高雄,2023-06-27,8562
2615,萬海,27,3,24,新光-高雄,2023-06-27,8562
1905,華紙,136,112,24,新光-高雄,2023-06-27,8562
2106,建大,23,0,23,新光-高雄,2023-06-27,8562
00715L,期街口布蘭特正2,1305,116,1189,新光-高雄,2023-06-28,8562
00712,復華富時不動產,823,16,807,新光-高雄,2023-06-28,8562
1605,華新,283,68,215,新光-高雄,2023-06-28,8562
00642U,期元大S＆P石油,194,1,193,新光-高雄,2023-06-28,8562
2845,遠東銀,81,0,81,新光-高雄,2023-06-28,8562
1102,亞泥,69,2,67,新光-高雄,2023-06-28,8562
2352,佳世達,79,15,64,新光-高雄,2023-06-28,8562
00888,永豐台灣ESG,68,8,60,新光-高雄,2023-06-28,8562
2892,第一金,58,0,58,新光-高雄,2023-06-28,8562
2887,台新金,58,2,56,新光-高雄,2023-06-28,8562
1101,台泥,69,18,51,新光-高雄,2023-06-28,8562
2609,陽明,68,20,48,新光-高雄,2023-06-28,8562
1301,台塑,50,3,47,新光-高雄,2023-06-28,8562
2340,台亞,118,73,45,新光-高雄,2023-06-28,8562
2323,中環,80,36,44,新光-高雄,2023-06-28,8562
1444,力麗,69,30,39,新光-高雄,2023-06-28,8562
2106,建大,37,0,37,新光-高雄,2023-06-28,8562
2884,玉山金,37,0,37,新光-高雄,2023-06-28,8562
1471,首利,58,25,33,新光-高雄,2023-06-28,8562
00885,富邦越南,37,5,32,新光-高雄,2023-06-28,8562
00674R,期元大S＆P黃金反1,30,0,30,新光-高雄,2023-06-28,8562
2409,友達,67,38,29,新光-高雄,2023-06-28,8562
2303,聯電,40,12,28,新光-高雄,2023-06-28,8562
00751B,元大AAA至A公司債,29,3,26,新光-高雄,2023-06-28,8562
2888,新光金,62,37,25,新光-高雄,2023-06-28,8562
2801,彰銀,25,1,24,新光-高雄,2023-06-28,8562
6257,矽格,22,0,22,新光-高雄,2023-06-28,8562
00907,永豐優息存股,21,0,21,新光-高雄,2023-06-28,8562
8450,霹靂,33,12,21,新光-高雄,2023-06-28,8562
2634,漢翔,90,70,20,新光-高雄,2023-06-28,8562
1201,味全,18,0,18,新光-高雄,2023-06-28,8562
1802,台玻,72,54,18,新光-高雄,2023-06-28,8562
3025,星通,50,32,18,新光-高雄,2023-06-28,8562
00902,中信電池及儲能,21,3,18,新光-高雄,2023-06-28,8562
1905,華紙,28,10,18,新光-高雄,2023-06-28,8562
00671R,富邦NASDAQ反1,17,0,17,新光-高雄,2023-06-28,8562
6190,萬泰科,42,25,17,新光-高雄,2023-06-28,8562
3374,精材,62,46,16,新光-高雄,2023-06-28,8562
1504,東元,53,37,16,新光-高雄,2023-06-28,8562
00665L,富邦�琤肭磪囓�2,27,11,16,新光-高雄,2023-06-28,8562
8093,保銳,16,0,16,新光-高雄,2023-06-28,8562
1742,台蠟,15,0,15,新光-高雄,2023-06-28,8562
3013,晟銘電,44,30,14,新光-高雄,2023-06-28,8562
4916,事欣科,45,31,14,新光-高雄,2023-06-28,8562
8215,明基材,22,8,14,新光-高雄,2023-06-28,8562
8050,廣積,14,1,13,新光-高雄,2023-06-28,8562
8936,國統,19,6,13,新光-高雄,2023-06-28,8562
2313,華通,27,14,13,新光-高雄,2023-06-28,8562
2906,高林,23,10,13,新光-高雄,2023-06-28,8562
2412,中華電,14,2,12,新光-高雄,2023-06-28,8562
00772B,中信高評級公司債,296,19,277,新光-高雄,2023-06-29,8562
2867,三商壽,250,11,239,新光-高雄,2023-06-29,8562
00706L,期元大S＆P日圓正2,174,0,174,新光-高雄,2023-06-29,8562
00888,永豐台灣ESG,138,1,137,新光-高雄,2023-06-29,8562
2610,華航,202,81,121,新光-高雄,2023-06-29,8562
2888,新光金,107,1,106,新光-高雄,2023-06-29,8562
00632R,元大台灣50反1,142,37,105,新光-高雄,2023-06-29,8562
00753L,中信中國50正2,133,31,102,新光-高雄,2023-06-29,8562
00664R,國泰臺灣加權反1,100,0,100,新光-高雄,2023-06-29,8562
3207,耀勝,218,119,99,新光-高雄,2023-06-29,8562
1201,味全,96,0,96,新光-高雄,2023-06-29,8562
00637L,元大滬深300正2,96,7,89,新光-高雄,2023-06-29,8562
2892,第一金,83,0,83,新光-高雄,2023-06-29,8562
2419,仲琦,209,143,66,新光-高雄,2023-06-29,8562
2618,長榮航,163,102,61,新光-高雄,2023-06-29,8562
00665L,富邦�琤肭磪囓�2,60,0,60,新光-高雄,2023-06-29,8562
1795,美時,107,50,57,新光-高雄,2023-06-29,8562
1605,華新,96,40,56,新光-高雄,2023-06-29,8562
1301,台塑,57,1,56,新光-高雄,2023-06-29,8562
3481,群創,115,60,55,新光-高雄,2023-06-29,8562
00673R,期元大S＆P原油反1,260,205,55,新光-高雄,2023-06-29,8562
4414,如興,67,17,50,新光-高雄,2023-06-29,8562
2303,聯電,47,5,42,新光-高雄,2023-06-29,8562
2317,鴻海,153,118,35,新光-高雄,2023-06-29,8562
2609,陽明,63,28,35,新光-高雄,2023-06-29,8562
2353,宏��,39,5,34,新光-高雄,2023-06-29,8562
00919,群益台灣精選高息,33,3,30,新光-高雄,2023-06-29,8562
2603,長榮,90,61,29,新光-高雄,2023-06-29,8562
5533,皇鼎,26,1,25,新光-高雄,2023-06-29,8562
3049,精金,32,7,25,新光-高雄,2023-06-29,8562
5469,瀚宇博,41,18,23,新光-高雄,2023-06-29,8562
00882,中信中國高股息,25,3,22,新光-高雄,2023-06-29,8562
1460,宏遠,32,10,22,新光-高雄,2023-06-29,8562
6191,精成科,29,8,21,新光-高雄,2023-06-29,8562
4155,訊映,29,8,21,新光-高雄,2023-06-29,8562
4746,台耀,50,30,20,新光-高雄,2023-06-29,8562
1584,精剛,39,19,20,新光-高雄,2023-06-29,8562
00857B,永豐20年美公債,20,0,20,新光-高雄,2023-06-29,8562
2884,玉山金,23,3,20,新光-高雄,2023-06-29,8562
1522,堤維西,39,21,18,新光-高雄,2023-06-29,8562
8110,華東,25,7,18,新光-高雄,2023-06-29,8562
6016,康和證,18,0,18,新光-高雄,2023-06-29,8562
9945,潤泰新,19,1,18,新光-高雄,2023-06-29,8562
1227,佳格,18,1,17,新光-高雄,2023-06-29,8562
6182,合晶,21,4,17,新光-高雄,2023-06-29,8562
00922,國泰台灣領袖50,25,9,16,新光-高雄,2023-06-29,8562
1217,愛之味,18,2,16,新光-高雄,2023-06-29,8562
00902,中信電池及儲能,16,0,16,新光-高雄,2023-06-29,8562
3346,麗清,18,2,16,新光-高雄,2023-06-29,8562
1528,恩德,41,26,15,新光-高雄,2023-06-29,8562
00673R,期元大S＆P原油反1,226,0,226,新光-高雄,2023-06-30,8562
00688L,國泰20年美債正2,148,0,148,新光-高雄,2023-06-30,8562
2888,新光金,164,23,141,新光-高雄,2023-06-30,8562
00680L,元大美債20正2,123,0,123,新光-高雄,2023-06-30,8562
00919,群益台灣精選高息,118,3,115,新光-高雄,2023-06-30,8562
00687B,國泰20年美債,130,25,105,新光-高雄,2023-06-30,8562
2409,友達,114,10,104,新光-高雄,2023-06-30,8562
2344,華邦電,201,103,98,新光-高雄,2023-06-30,8562
2883,凱基金,89,0,89,新光-高雄,2023-06-30,8562
3289,宜特,80,1,79,新光-高雄,2023-06-30,8562
00706L,期元大S＆P日圓正2,72,0,72,新光-高雄,2023-06-30,8562
00720B,元大投資級公司債,69,0,69,新光-高雄,2023-06-30,8562
00772B,中信高評級公司債,74,7,67,新光-高雄,2023-06-30,8562
3479,安勤,55,1,54,新光-高雄,2023-06-30,8562
3017,奇鋐,125,77,48,新光-高雄,2023-06-30,8562
2537,聯上發,40,0,40,新光-高雄,2023-06-30,8562
00676R,富邦臺灣加權反1,40,0,40,新光-高雄,2023-06-30,8562
2485,兆赫,45,5,40,新光-高雄,2023-06-30,8562
1301,台塑,38,0,38,新光-高雄,2023-06-30,8562
3481,群創,105,70,35,新光-高雄,2023-06-30,8562
3056,富華新,34,0,34,新光-高雄,2023-06-30,8562
2303,聯電,44,10,34,新光-高雄,2023-06-30,8562
2356,英業達,58,26,32,新光-高雄,2023-06-30,8562
00773B,中信優先金融債,73,43,30,新光-高雄,2023-06-30,8562
00751B,元大AAA至A公司債,33,3,30,新光-高雄,2023-06-30,8562
5905,南仁湖,53,24,29,新光-高雄,2023-06-30,8562
3045,台灣大,31,3,28,新光-高雄,2023-06-30,8562
3711,日月光投控,67,40,27,新光-高雄,2023-06-30,8562
2353,宏��,27,1,26,新光-高雄,2023-06-30,8562
1605,華新,100,74,26,新光-高雄,2023-06-30,8562
0056,元大高股息,39,14,25,新光-高雄,2023-06-30,8562
2889,國票金,25,0,25,新光-高雄,2023-06-30,8562
2352,佳世達,34,9,25,新光-高雄,2023-06-30,8562
6120,達運,26,1,25,新光-高雄,2023-06-30,8562
6806,森崴能源,57,34,23,新光-高雄,2023-06-30,8562
00885,富邦越南,70,48,22,新光-高雄,2023-06-30,8562
3491,昇達科,23,1,22,新光-高雄,2023-06-30,8562
00713,元大台灣高息低波,22,0,22,新光-高雄,2023-06-30,8562
2103,台橡,21,0,21,新光-高雄,2023-06-30,8562
00795B,中信美國公債20年,39,18,21,新光-高雄,2023-06-30,8562
00679B,元大美債20年,58,37,21,新光-高雄,2023-06-30,8562
5533,皇鼎,26,6,20,新光-高雄,2023-06-30,8562
3033,威健,26,6,20,新光-高雄,2023-06-30,8562
2427,三商電,56,36,20,新光-高雄,2023-06-30,8562
8034,榮群,24,4,20,新光-高雄,2023-06-30,8562
2323,中環,196,176,20,新光-高雄,2023-06-30,8562
2014,中鴻,18,0,18,新光-高雄,2023-06-30,8562
3264,欣銓,25,7,18,新光-高雄,2023-06-30,8562
4147,中裕,23,5,18,新光-高雄,2023-06-30,8562
6550,北極星藥業-KY,18,1,17,新光-高雄,2023-06-30,8562
4714,永捷,490,0,490,新光-高雄,2023-07-03,8562
00632R,元大台灣50反1,559,309,250,新光-高雄,2023-07-03,8562
1201,味全,152,0,152,新光-高雄,2023-07-03,8562
3231,緯創,395,243,152,新光-高雄,2023-07-03,8562
00706L,期元大S＆P日圓正2,92,0,92,新光-高雄,2023-07-03,8562
00673R,期元大S＆P原油反1,77,0,77,新光-高雄,2023-07-03,8562
2106,建大,75,0,75,新光-高雄,2023-07-03,8562
2356,英業達,200,125,75,新光-高雄,2023-07-03,8562
2317,鴻海,171,100,71,新光-高雄,2023-07-03,8562
2104,國際中橡,71,1,70,新光-高雄,2023-07-03,8562
2303,聯電,97,29,68,新光-高雄,2023-07-03,8562
6116,彩晶,68,2,66,新光-高雄,2023-07-03,8562
1210,大成,61,2,59,新光-高雄,2023-07-03,8562
2409,友達,61,11,50,新光-高雄,2023-07-03,8562
1217,愛之味,55,11,44,新光-高雄,2023-07-03,8562
1103,嘉泥,50,8,42,新光-高雄,2023-07-03,8562
2888,新光金,42,2,40,新光-高雄,2023-07-03,8562
2323,中環,101,63,38,新光-高雄,2023-07-03,8562
2603,長榮,139,101,38,新光-高雄,2023-07-03,8562
6122,擎邦,55,20,35,新光-高雄,2023-07-03,8562
2206,三陽工業,78,44,34,新光-高雄,2023-07-03,8562
2331,精英,88,54,34,新光-高雄,2023-07-03,8562
2610,華航,131,98,33,新光-高雄,2023-07-03,8562
1584,精剛,53,21,32,新光-高雄,2023-07-03,8562
4538,大詠城,41,10,31,新光-高雄,2023-07-03,8562
2313,華通,32,1,31,新光-高雄,2023-07-03,8562
3045,台灣大,28,0,28,新光-高雄,2023-07-03,8562
2382,廣達,93,65,28,新光-高雄,2023-07-03,8562
1789,神隆,30,4,26,新光-高雄,2023-07-03,8562
2617,台航,33,7,26,新光-高雄,2023-07-03,8562
2312,金寶,53,27,26,新光-高雄,2023-07-03,8562
2913,農林,29,3,26,新光-高雄,2023-07-03,8562
6191,精成科,26,2,24,新光-高雄,2023-07-03,8562
2615,萬海,52,29,23,新光-高雄,2023-07-03,8562
6185,幃翔,26,3,23,新光-高雄,2023-07-03,8562
3596,智易,36,14,22,新光-高雄,2023-07-03,8562
3455,由田,21,0,21,新光-高雄,2023-07-03,8562
1815,富喬,31,10,21,新光-高雄,2023-07-03,8562
3646,艾恩特,20,0,20,新光-高雄,2023-07-03,8562
2412,中華電,19,0,19,新光-高雄,2023-07-03,8562
6456,GIS-KY,18,0,18,新光-高雄,2023-07-03,8562
6190,萬泰科,19,1,18,新光-高雄,2023-07-03,8562
3706,神達,54,36,18,新光-高雄,2023-07-03,8562
1513,中興電,43,26,17,新光-高雄,2023-07-03,8562
3518,柏騰,19,2,17,新光-高雄,2023-07-03,8562
3491,昇達科,19,2,17,新光-高雄,2023-07-03,8562
2897,王道銀行,16,0,16,新光-高雄,2023-07-03,8562
2413,環科,40,24,16,新光-高雄,2023-07-03,8562
5864,致和證,38,22,16,新光-高雄,2023-07-03,8562
1409,新纖,15,0,15,新光-高雄,2023-07-03,8562
00673R,期元大S＆P原油反1,526,0,526,新光-高雄,2023-07-04,8562
0056,元大高股息,578,88,490,新光-高雄,2023-07-04,8562
00929,復華台灣科技優息,732,342,390,新光-高雄,2023-07-04,8562
2888,新光金,177,28,149,新光-高雄,2023-07-04,8562
00882,中信中國高股息,124,3,121,新光-高雄,2023-07-04,8562
1301,台塑,117,0,117,新光-高雄,2023-07-04,8562
2609,陽明,224,108,116,新光-高雄,2023-07-04,8562
2603,長榮,397,294,103,新光-高雄,2023-07-04,8562
8411,福貞-KY,102,2,100,新光-高雄,2023-07-04,8562
2883,凱基金,145,52,93,新光-高雄,2023-07-04,8562
2409,友達,118,29,89,新光-高雄,2023-07-04,8562
2317,鴻海,155,77,78,新光-高雄,2023-07-04,8562
2106,建大,75,0,75,新光-高雄,2023-07-04,8562
3481,群創,127,58,69,新光-高雄,2023-07-04,8562
3706,神達,180,122,58,新光-高雄,2023-07-04,8562
5864,致和證,62,11,51,新光-高雄,2023-07-04,8562
1905,華紙,162,112,50,新光-高雄,2023-07-04,8562
2915,潤泰全,56,10,46,新光-高雄,2023-07-04,8562
3596,智易,52,7,45,新光-高雄,2023-07-04,8562
2542,興富發,46,3,43,新光-高雄,2023-07-04,8562
2030,彰源,46,3,43,新光-高雄,2023-07-04,8562
3558,神準,43,2,41,新光-高雄,2023-07-04,8562
1201,味全,45,5,40,新光-高雄,2023-07-04,8562
00782B,國泰A級公用債,40,0,40,新光-高雄,2023-07-04,8562
1907,永豐餘,74,36,38,新光-高雄,2023-07-04,8562
1718,中纖,51,15,36,新光-高雄,2023-07-04,8562
3704,合勤控,190,156,34,新光-高雄,2023-07-04,8562
1529,樂事綠能,39,7,32,新光-高雄,2023-07-04,8562
00885,富邦越南,38,6,32,新光-高雄,2023-07-04,8562
2371,大同,54,24,30,新光-高雄,2023-07-04,8562
1815,富喬,28,0,28,新光-高雄,2023-07-04,8562
6155,鈞寶,27,1,26,新光-高雄,2023-07-04,8562
00888,永豐台灣ESG,26,1,25,新光-高雄,2023-07-04,8562
3673,TPK-KY,31,6,25,新光-高雄,2023-07-04,8562
1229,聯華,27,2,25,新光-高雄,2023-07-04,8562
00712,復華富時不動產,45,21,24,新光-高雄,2023-07-04,8562
2601,益航,61,38,23,新光-高雄,2023-07-04,8562
1605,華新,40,18,22,新光-高雄,2023-07-04,8562
4173,久裕,22,0,22,新光-高雄,2023-07-04,8562
2882,國泰金,22,0,22,新光-高雄,2023-07-04,8562
1522,堤維西,115,93,22,新光-高雄,2023-07-04,8562
1513,中興電,43,21,22,新光-高雄,2023-07-04,8562
2482,連宇,23,2,21,新光-高雄,2023-07-04,8562
3402,漢科,25,4,21,新光-高雄,2023-07-04,8562
8358,金居,22,1,21,新光-高雄,2023-07-04,8562
2812,台中銀,33,13,20,新光-高雄,2023-07-04,8562
8289,泰藝,20,0,20,新光-高雄,2023-07-04,8562
2832,台產,20,0,20,新光-高雄,2023-07-04,8562
00688L,國泰20年美債正2,55,35,20,新光-高雄,2023-07-04,8562
00927,群益半導體收益,25,5,20,新光-高雄,2023-07-04,8562
00673R,期元大S＆P原油反1,476,0,476,新光-高雄,2023-07-05,8562
00637L,元大滬深300正2,236,28,208,新光-高雄,2023-07-05,8562
0056,元大高股息,356,157,199,新光-高雄,2023-07-05,8562
00632R,元大台灣50反1,289,155,134,新光-高雄,2023-07-05,8562
3231,緯創,358,244,114,新光-高雄,2023-07-05,8562
2609,陽明,455,353,102,新光-高雄,2023-07-05,8562
00688L,國泰20年美債正2,85,0,85,新光-高雄,2023-07-05,8562
2106,建大,79,0,79,新光-高雄,2023-07-05,8562
2883,凱基金,73,4,69,新光-高雄,2023-07-05,8562
4967,十銓,84,17,67,新光-高雄,2023-07-05,8562
00878,國泰永續高股息,104,39,65,新光-高雄,2023-07-05,8562
2330,台積電,66,6,60,新光-高雄,2023-07-05,8562
2303,聯電,62,3,59,新光-高雄,2023-07-05,8562
2356,英業達,147,88,59,新光-高雄,2023-07-05,8562
2317,鴻海,121,68,53,新光-高雄,2023-07-05,8562
1522,堤維西,106,54,52,新光-高雄,2023-07-05,8562
2867,三商壽,48,0,48,新光-高雄,2023-07-05,8562
2301,光寶科,90,43,47,新光-高雄,2023-07-05,8562
2323,中環,156,109,47,新光-高雄,2023-07-05,8562
2367,燿華,47,1,46,新光-高雄,2023-07-05,8562
00665L,富邦�琤肭磪囓�2,70,24,46,新光-高雄,2023-07-05,8562
00680L,元大美債20正2,91,45,46,新光-高雄,2023-07-05,8562
1718,中纖,45,0,45,新光-高雄,2023-07-05,8562
00782B,國泰A級公用債,45,0,45,新光-高雄,2023-07-05,8562
3013,晟銘電,89,47,42,新光-高雄,2023-07-05,8562
3682,亞太電,42,0,42,新光-高雄,2023-07-05,8562
3706,神達,64,22,42,新光-高雄,2023-07-05,8562
4904,遠傳,42,1,41,新光-高雄,2023-07-05,8562
00712,復華富時不動產,159,119,40,新光-高雄,2023-07-05,8562
2413,環科,39,1,38,新光-高雄,2023-07-05,8562
2405,輔信,52,17,35,新光-高雄,2023-07-05,8562
2369,菱生,104,69,35,新光-高雄,2023-07-05,8562
3260,威剛,44,12,32,新光-高雄,2023-07-05,8562
8071,能率網通,35,3,32,新光-高雄,2023-07-05,8562
4906,正文,70,38,32,新光-高雄,2023-07-05,8562
2365,昆盈,31,0,31,新光-高雄,2023-07-05,8562
3501,維熹,30,0,30,新光-高雄,2023-07-05,8562
3673,TPK-KY,32,2,30,新光-高雄,2023-07-05,8562
6101,寬魚國際,40,12,28,新光-高雄,2023-07-05,8562
2393,億光,31,3,28,新光-高雄,2023-07-05,8562
00882,中信中國高股息,38,11,27,新光-高雄,2023-07-05,8562
2888,新光金,35,8,27,新光-高雄,2023-07-05,8562
1905,華紙,95,68,27,新光-高雄,2023-07-05,8562
6257,矽格,33,7,26,新光-高雄,2023-07-05,8562
3033,威健,31,6,25,新光-高雄,2023-07-05,8562
00720B,元大投資級公司債,26,1,25,新光-高雄,2023-07-05,8562
3265,台星科,36,11,25,新光-高雄,2023-07-05,8562
4977,眾達-KY,33,9,24,新光-高雄,2023-07-05,8562
00631L,元大台灣50正2,24,0,24,新光-高雄,2023-07-05,8562
1605,華新,35,11,24,新光-高雄,2023-07-05,8562
00929,復華台灣科技優息,826,138,688,新光-高雄,2023-07-06,8562
00673R,期元大S＆P原油反1,699,50,649,新光-高雄,2023-07-06,8562
0056,元大高股息,372,69,303,新光-高雄,2023-07-06,8562
5864,致和證,261,30,231,新光-高雄,2023-07-06,8562
00680L,元大美債20正2,230,0,230,新光-高雄,2023-07-06,8562
00687B,國泰20年美債,196,2,194,新光-高雄,2023-07-06,8562
00688L,國泰20年美債正2,192,16,176,新光-高雄,2023-07-06,8562
2888,新光金,176,8,168,新光-高雄,2023-07-06,8562
2883,凱基金,179,13,166,新光-高雄,2023-07-06,8562
1301,台塑,141,0,141,新光-高雄,2023-07-06,8562
2880,華南金,130,3,127,新光-高雄,2023-07-06,8562
2402,毅嘉,184,61,123,新光-高雄,2023-07-06,8562
00882,中信中國高股息,146,23,123,新光-高雄,2023-07-06,8562
2301,光寶科,155,41,114,新光-高雄,2023-07-06,8562
00637L,元大滬深300正2,163,51,112,新光-高雄,2023-07-06,8562
2317,鴻海,128,17,111,新光-高雄,2023-07-06,8562
2329,華泰,169,66,103,新光-高雄,2023-07-06,8562
2891,中信金,102,4,98,新光-高雄,2023-07-06,8562
2356,英業達,170,77,93,新光-高雄,2023-07-06,8562
00712,復華富時不動產,119,30,89,新光-高雄,2023-07-06,8562
6111,大宇資,143,57,86,新光-高雄,2023-07-06,8562
00679B,元大美債20年,80,6,74,新光-高雄,2023-07-06,8562
2892,第一金,71,0,71,新光-高雄,2023-07-06,8562
2409,友達,252,183,69,新光-高雄,2023-07-06,8562
2352,佳世達,80,12,68,新光-高雄,2023-07-06,8562
2419,仲琦,133,67,66,新光-高雄,2023-07-06,8562
00772B,中信高評級公司債,67,1,66,新光-高雄,2023-07-06,8562
4967,十銓,75,11,64,新光-高雄,2023-07-06,8562
2618,長榮航,178,116,62,新光-高雄,2023-07-06,8562
2330,台積電,66,5,61,新光-高雄,2023-07-06,8562
1101,台泥,70,9,61,新光-高雄,2023-07-06,8562
5009,榮剛,71,16,55,新光-高雄,2023-07-06,8562
2106,建大,50,0,50,新光-高雄,2023-07-06,8562
6285,啟��,107,57,50,新光-高雄,2023-07-06,8562
2881,富邦金,53,3,50,新光-高雄,2023-07-06,8562
3013,晟銘電,327,278,49,新光-高雄,2023-07-06,8562
00782B,國泰A級公用債,48,0,48,新光-高雄,2023-07-06,8562
00665L,富邦�琤肭磪囓�2,76,30,46,新光-高雄,2023-07-06,8562
1217,愛之味,46,0,46,新光-高雄,2023-07-06,8562
2885,元大金,45,0,45,新光-高雄,2023-07-06,8562
2406,國碩,41,0,41,新光-高雄,2023-07-06,8562
00919,群益台灣精選高息,89,48,41,新光-高雄,2023-07-06,8562
00706L,期元大S＆P日圓正2,41,1,40,新光-高雄,2023-07-06,8562
3037,欣興,59,19,40,新光-高雄,2023-07-06,8562
2889,國票金,38,0,38,新光-高雄,2023-07-06,8562
2002,中鋼,49,12,37,新光-高雄,2023-07-06,8562
3325,旭品,54,18,36,新光-高雄,2023-07-06,8562
00885,富邦越南,37,2,35,新光-高雄,2023-07-06,8562
00720B,元大投資級公司債,87,52,35,新光-高雄,2023-07-06,8562
6112,邁達特,39,4,35,新光-高雄,2023-07-06,8562
00632R,元大台灣50反1,932,359,573,新光-高雄,2023-07-07,8562
2888,新光金,260,67,193,新光-高雄,2023-07-07,8562
00720B,元大投資級公司債,193,8,185,新光-高雄,2023-07-07,8562
2880,華南金,180,6,174,新光-高雄,2023-07-07,8562
3231,緯創,447,274,173,新光-高雄,2023-07-07,8562
00680L,元大美債20正2,139,15,124,新光-高雄,2023-07-07,8562
1301,台塑,135,20,115,新光-高雄,2023-07-07,8562
00688L,國泰20年美債正2,108,0,108,新光-高雄,2023-07-07,8562
00673R,期元大S＆P原油反1,378,270,108,新光-高雄,2023-07-07,8562
00929,復華台灣科技優息,113,16,97,新光-高雄,2023-07-07,8562
00687B,國泰20年美債,102,7,95,新光-高雄,2023-07-07,8562
00679B,元大美債20年,114,25,89,新光-高雄,2023-07-07,8562
4916,事欣科,91,4,87,新光-高雄,2023-07-07,8562
2409,友達,88,7,81,新光-高雄,2023-07-07,8562
2887,台新金,80,10,70,新光-高雄,2023-07-07,8562
00665L,富邦�琤肭磪囓�2,102,35,67,新光-高雄,2023-07-07,8562
3047,訊舟,90,25,65,新光-高雄,2023-07-07,8562
00882,中信中國高股息,79,15,64,新光-高雄,2023-07-07,8562
00878,國泰永續高股息,127,77,50,新光-高雄,2023-07-07,8562
6101,寬魚國際,50,0,50,新光-高雄,2023-07-07,8562
2380,虹光,51,1,50,新光-高雄,2023-07-07,8562
00669R,國泰美國道瓊反1,45,0,45,新光-高雄,2023-07-07,8562
2883,凱基金,66,23,43,新光-高雄,2023-07-07,8562
2480,敦陽科,50,10,40,新光-高雄,2023-07-07,8562
2344,華邦電,202,162,40,新光-高雄,2023-07-07,8562
2890,永豐金,39,0,39,新光-高雄,2023-07-07,8562
2340,台亞,80,41,39,新光-高雄,2023-07-07,8562
2034,允強,43,5,38,新光-高雄,2023-07-07,8562
00772B,中信高評級公司債,41,4,37,新光-高雄,2023-07-07,8562
8289,泰藝,37,0,37,新光-高雄,2023-07-07,8562
6576,逸達,41,4,37,新光-高雄,2023-07-07,8562
2027,大成鋼,41,5,36,新光-高雄,2023-07-07,8562
1504,東元,50,15,35,新光-高雄,2023-07-07,8562
6285,啟��,55,22,33,新光-高雄,2023-07-07,8562
6016,康和證,51,18,33,新光-高雄,2023-07-07,8562
2002,中鋼,38,5,33,新光-高雄,2023-07-07,8562
4510,高鋒,100,69,31,新光-高雄,2023-07-07,8562
00752,中信中國50,31,0,31,新光-高雄,2023-07-07,8562
2885,元大金,30,0,30,新光-高雄,2023-07-07,8562
2867,三商壽,30,0,30,新光-高雄,2023-07-07,8562
2106,建大,30,0,30,新光-高雄,2023-07-07,8562
2468,華經,117,88,29,新光-高雄,2023-07-07,8562
1217,愛之味,58,30,28,新光-高雄,2023-07-07,8562
4414,如興,31,3,28,新光-高雄,2023-07-07,8562
00857B,永豐20年美公債,26,0,26,新光-高雄,2023-07-07,8562
1314,中石化,25,0,25,新光-高雄,2023-07-07,8562
2881,富邦金,25,1,24,新光-高雄,2023-07-07,8562
3049,精金,31,8,23,新光-高雄,2023-07-07,8562
00921,兆豐龍頭等權重,22,0,22,新光-高雄,2023-07-07,8562
1102,亞泥,22,0,22,新光-高雄,2023-07-07,8562
00673R,期元大S＆P原油反1,565,10,555,新光-高雄,2023-07-10,8562
2501,國建,142,0,142,新光-高雄,2023-07-10,8562
00680L,元大美債20正2,253,114,139,新光-高雄,2023-07-10,8562
00679B,元大美債20年,144,11,133,新光-高雄,2023-07-10,8562
00882,中信中國高股息,241,128,113,新光-高雄,2023-07-10,8562
00687B,國泰20年美債,114,3,111,新光-高雄,2023-07-10,8562
00795B,中信美國公債20年,110,3,107,新光-高雄,2023-07-10,8562
00632R,元大台灣50反1,513,410,103,新光-高雄,2023-07-10,8562
4414,如興,100,0,100,新光-高雄,2023-07-10,8562
6126,信音,129,35,94,新光-高雄,2023-07-10,8562
2883,凱基金,137,48,89,新光-高雄,2023-07-10,8562
1806,冠軍,97,13,84,新光-高雄,2023-07-10,8562
00929,復華台灣科技優息,83,1,82,新光-高雄,2023-07-10,8562
00688L,國泰20年美債正2,163,90,73,新光-高雄,2023-07-10,8562
6576,逸達,59,0,59,新光-高雄,2023-07-10,8562
2610,華航,174,116,58,新光-高雄,2023-07-10,8562
2609,陽明,85,37,48,新光-高雄,2023-07-10,8562
1540,喬福,57,10,47,新光-高雄,2023-07-10,8562
00720B,元大投資級公司債,77,31,46,新光-高雄,2023-07-10,8562
1101,台泥,44,0,44,新光-高雄,2023-07-10,8562
4173,久裕,59,16,43,新光-高雄,2023-07-10,8562
00715L,期街口布蘭特正2,314,272,42,新光-高雄,2023-07-10,8562
2365,昆盈,40,0,40,新光-高雄,2023-07-10,8562
2356,英業達,61,22,39,新光-高雄,2023-07-10,8562
2317,鴻海,43,4,39,新光-高雄,2023-07-10,8562
3346,麗清,45,7,38,新光-高雄,2023-07-10,8562
2504,國產,38,0,38,新光-高雄,2023-07-10,8562
4533,協易機,97,60,37,新光-高雄,2023-07-10,8562
1604,聲寶,38,2,36,新光-高雄,2023-07-10,8562
00671R,富邦NASDAQ反1,35,0,35,新光-高雄,2023-07-10,8562
8163,達方,34,0,34,新光-高雄,2023-07-10,8562
2419,仲琦,111,78,33,新光-高雄,2023-07-10,8562
3576,聯合再生,39,8,31,新光-高雄,2023-07-10,8562
4532,瑞智,296,265,31,新光-高雄,2023-07-10,8562
2303,聯電,42,12,30,新光-高雄,2023-07-10,8562
2603,長榮,41,11,30,新光-高雄,2023-07-10,8562
00850,元大臺灣ESG永續,29,0,29,新光-高雄,2023-07-10,8562
00772B,中信高評級公司債,31,2,29,新光-高雄,2023-07-10,8562
2867,三商壽,41,12,29,新光-高雄,2023-07-10,8562
4967,十銓,30,2,28,新光-高雄,2023-07-10,8562
6282,康舒,109,83,26,新光-高雄,2023-07-10,8562
3491,昇達科,28,3,25,新光-高雄,2023-07-10,8562
00782B,國泰A級公用債,25,0,25,新光-高雄,2023-07-10,8562
1217,愛之味,55,31,24,新光-高雄,2023-07-10,8562
00637L,元大滬深300正2,121,98,23,新光-高雄,2023-07-10,8562
2812,台中銀,47,24,23,新光-高雄,2023-07-10,8562
6288,聯嘉,42,19,23,新光-高雄,2023-07-10,8562
00706L,期元大S＆P日圓正2,128,105,23,新光-高雄,2023-07-10,8562
3625,西勝,21,0,21,新光-高雄,2023-07-10,8562
00751B,元大AAA至A公司債,38,17,21,新光-高雄,2023-07-10,8562
2515,中工,567,5,562,新光-高雄,2023-07-11,8562
00632R,元大台灣50反1,645,330,315,新光-高雄,2023-07-11,8562
00665L,富邦�琤肭磪囓�2,310,70,240,新光-高雄,2023-07-11,8562
00673R,期元大S＆P原油反1,238,0,238,新光-高雄,2023-07-11,8562
1101,台泥,131,18,113,新光-高雄,2023-07-11,8562
1326,台化,93,0,93,新光-高雄,2023-07-11,8562
2409,友達,151,62,89,新光-高雄,2023-07-11,8562
6735,美達科技,74,0,74,新光-高雄,2023-07-11,8562
2812,台中銀,102,34,68,新光-高雄,2023-07-11,8562
5864,致和證,64,2,62,新光-高雄,2023-07-11,8562
2027,大成鋼,68,13,55,新光-高雄,2023-07-11,8562
4934,太極,176,127,49,新光-高雄,2023-07-11,8562
00720B,元大投資級公司債,56,11,45,新光-高雄,2023-07-11,8562
5234,達興材料,48,4,44,新光-高雄,2023-07-11,8562
00679B,元大美債20年,64,21,43,新光-高雄,2023-07-11,8562
6799,來頡,46,4,42,新光-高雄,2023-07-11,8562
3558,神準,54,13,41,新光-高雄,2023-07-11,8562
00715L,期街口布蘭特正2,76,39,37,新光-高雄,2023-07-11,8562
00919,群益台灣精選高息,41,6,35,新光-高雄,2023-07-11,8562
1522,堤維西,37,3,34,新光-高雄,2023-07-11,8562
4526,東台,41,8,33,新光-高雄,2023-07-11,8562
1444,力麗,29,0,29,新光-高雄,2023-07-11,8562
6117,迎廣,31,3,28,新光-高雄,2023-07-11,8562
3706,神達,50,22,28,新光-高雄,2023-07-11,8562
4906,正文,29,1,28,新光-高雄,2023-07-11,8562
4532,瑞智,207,180,27,新光-高雄,2023-07-11,8562
5209,新鼎,27,1,26,新光-高雄,2023-07-11,8562
2340,台亞,174,148,26,新光-高雄,2023-07-11,8562
2371,大同,108,83,25,新光-高雄,2023-07-11,8562
6148,驊宏資,65,40,25,新光-高雄,2023-07-11,8562
3491,昇達科,28,4,24,新光-高雄,2023-07-11,8562
2505,國揚,24,0,24,新光-高雄,2023-07-11,8562
00772B,中信高評級公司債,44,21,23,新光-高雄,2023-07-11,8562
4533,協易機,35,13,22,新光-高雄,2023-07-11,8562
00782B,國泰A級公用債,20,0,20,新光-高雄,2023-07-11,8562
3038,全台,24,6,18,新光-高雄,2023-07-11,8562
6576,逸達,18,0,18,新光-高雄,2023-07-11,8562
4763,材料-KY,25,7,18,新光-高雄,2023-07-11,8562
2472,立隆電,18,0,18,新光-高雄,2023-07-11,8562
2393,億光,21,3,18,新光-高雄,2023-07-11,8562
2889,國票金,17,0,17,新光-高雄,2023-07-11,8562
3011,今皓,19,2,17,新光-高雄,2023-07-11,8562
00891,中信關鍵半導體,18,1,17,新光-高雄,2023-07-11,8562
5469,瀚宇博,17,0,17,新光-高雄,2023-07-11,8562
6592,和潤企業,16,0,16,新光-高雄,2023-07-11,8562
1736,喬山,17,1,16,新光-高雄,2023-07-11,8562
1789,神隆,16,0,16,新光-高雄,2023-07-11,8562
3025,星通,117,102,15,新光-高雄,2023-07-11,8562
1777,生泰,15,0,15,新光-高雄,2023-07-11,8562
5351,鈺創,18,3,15,新光-高雄,2023-07-11,8562
2515,中工,505,18,487,新光-高雄,2023-07-12,8562
2356,英業達,770,413,357,新光-高雄,2023-07-12,8562
00673R,期元大S＆P原油反1,495,256,239,新光-高雄,2023-07-12,8562
00664R,國泰臺灣加權反1,100,0,100,新光-高雄,2023-07-12,8562
00929,復華台灣科技優息,335,236,99,新光-高雄,2023-07-12,8562
4532,瑞智,147,50,97,新光-高雄,2023-07-12,8562
2303,聯電,103,22,81,新光-高雄,2023-07-12,8562
00632R,元大台灣50反1,182,120,62,新光-高雄,2023-07-12,8562
00720B,元大投資級公司債,56,0,56,新光-高雄,2023-07-12,8562
00733,富邦臺灣中小,56,1,55,新光-高雄,2023-07-12,8562
2371,大同,138,85,53,新光-高雄,2023-07-12,8562
4510,高鋒,54,11,43,新光-高雄,2023-07-12,8562
2834,臺企銀,135,92,43,新光-高雄,2023-07-12,8562
9103,美德醫療-DR,43,0,43,新光-高雄,2023-07-12,8562
00679B,元大美債20年,51,10,41,新光-高雄,2023-07-12,8562
00687B,國泰20年美債,46,5,41,新光-高雄,2023-07-12,8562
3231,緯創,260,220,40,新光-高雄,2023-07-12,8562
2106,建大,40,0,40,新光-高雄,2023-07-12,8562
6118,建達,64,24,40,新光-高雄,2023-07-12,8562
2481,強茂,122,84,38,新光-高雄,2023-07-12,8562
2337,旺宏,38,0,38,新光-高雄,2023-07-12,8562
00882,中信中國高股息,37,0,37,新光-高雄,2023-07-12,8562
2867,三商壽,35,0,35,新光-高雄,2023-07-12,8562
00665L,富邦�琤肭磪囓�2,50,15,35,新光-高雄,2023-07-12,8562
6285,啟��,70,35,35,新光-高雄,2023-07-12,8562
00782B,國泰A級公用債,34,0,34,新光-高雄,2023-07-12,8562
4526,東台,32,1,31,新光-高雄,2023-07-12,8562
2887,台新金,35,5,30,新光-高雄,2023-07-12,8562
3005,神基,30,1,29,新光-高雄,2023-07-12,8562
1314,中石化,35,7,28,新光-高雄,2023-07-12,8562
1101,台泥,37,9,28,新光-高雄,2023-07-12,8562
1727,中華化,26,0,26,新光-高雄,2023-07-12,8562
2486,一詮,72,47,25,新光-高雄,2023-07-12,8562
1304,台聚,45,21,24,新光-高雄,2023-07-12,8562
2399,映泰,96,72,24,新光-高雄,2023-07-12,8562
2609,陽明,114,91,23,新光-高雄,2023-07-12,8562
9904,寶成,23,0,23,新光-高雄,2023-07-12,8562
2014,中鴻,23,0,23,新光-高雄,2023-07-12,8562
5258,虹堡,83,60,23,新光-高雄,2023-07-12,8562
5469,瀚宇博,27,4,23,新光-高雄,2023-07-12,8562
3062,建漢,22,0,22,新光-高雄,2023-07-12,8562
00888,永豐台灣ESG,27,6,21,新光-高雄,2023-07-12,8562
2748,雲品,24,3,21,新光-高雄,2023-07-12,8562
1513,中興電,71,51,20,新光-高雄,2023-07-12,8562
9943,好樂迪,20,0,20,新光-高雄,2023-07-12,8562
3027,盛達,41,22,19,新光-高雄,2023-07-12,8562
6218,豪勉,47,29,18,新光-高雄,2023-07-12,8562
6799,來頡,19,1,18,新光-高雄,2023-07-12,8562
6234,高僑,18,0,18,新光-高雄,2023-07-12,8562
1591,駿吉-KY,24,6,18,新光-高雄,2023-07-12,8562
00673R,期元大S＆P原油反1,406,0,406,新光-高雄,2023-07-13,8562
00648R,元大S＆P500反1,350,0,350,新光-高雄,2023-07-13,8562
2618,長榮航,314,84,230,新光-高雄,2023-07-13,8562
2882,國泰金,228,25,203,新光-高雄,2023-07-13,8562
00929,復華台灣科技優息,167,19,148,新光-高雄,2023-07-13,8562
5876,上海商銀,100,0,100,新光-高雄,2023-07-13,8562
00930,永豐ESG低碳高息,96,0,96,新光-高雄,2023-07-13,8562
6120,達運,218,124,94,新光-高雄,2023-07-13,8562
2610,華航,366,280,86,新光-高雄,2023-07-13,8562
2883,凱基金,134,48,86,新光-高雄,2023-07-13,8562
00687B,國泰20年美債,74,0,74,新光-高雄,2023-07-13,8562
2324,仁寶,176,108,68,新光-高雄,2023-07-13,8562
2409,友達,75,18,57,新光-高雄,2023-07-13,8562
1609,大亞,87,31,56,新光-高雄,2023-07-13,8562
00646,元大S＆P500,55,1,54,新光-高雄,2023-07-13,8562
4532,瑞智,141,91,50,新光-高雄,2023-07-13,8562
2367,燿華,58,10,48,新光-高雄,2023-07-13,8562
2889,國票金,42,2,40,新光-高雄,2023-07-13,8562
1605,華新,50,10,40,新光-高雄,2023-07-13,8562
1905,華紙,78,39,39,新光-高雄,2023-07-13,8562
2104,國際中橡,36,0,36,新光-高雄,2023-07-13,8562
3630,新鉅科,36,0,36,新光-高雄,2023-07-13,8562
8936,國統,61,25,36,新光-高雄,2023-07-13,8562
1460,宏遠,35,0,35,新光-高雄,2023-07-13,8562
2371,大同,97,62,35,新光-高雄,2023-07-13,8562
2352,佳世達,156,122,34,新光-高雄,2023-07-13,8562
00907,永豐優息存股,34,0,34,新光-高雄,2023-07-13,8562
2106,建大,35,1,34,新光-高雄,2023-07-13,8562
2887,台新金,38,6,32,新光-高雄,2023-07-13,8562
2884,玉山金,41,9,32,新光-高雄,2023-07-13,8562
2390,云辰,31,0,31,新光-高雄,2023-07-13,8562
2455,全新,78,48,30,新光-高雄,2023-07-13,8562
2353,宏��,78,49,29,新光-高雄,2023-07-13,8562
8072,陞泰,39,11,28,新光-高雄,2023-07-13,8562
3715,定穎投控,42,14,28,新光-高雄,2023-07-13,8562
6806,森崴能源,30,2,28,新光-高雄,2023-07-13,8562
1304,台聚,26,1,25,新光-高雄,2023-07-13,8562
00782B,國泰A級公用債,25,0,25,新光-高雄,2023-07-13,8562
2413,環科,27,2,25,新光-高雄,2023-07-13,8562
2368,金像電,79,54,25,新光-高雄,2023-07-13,8562
00897,富邦基因免疫生技,24,0,24,新光-高雄,2023-07-13,8562
1514,亞力,32,9,23,新光-高雄,2023-07-13,8562
6735,美達科技,23,0,23,新光-高雄,2023-07-13,8562
02001L,富邦蘋果正二N,22,0,22,新光-高雄,2023-07-13,8562
2609,陽明,129,107,22,新光-高雄,2023-07-13,8562
4744,皇將,29,7,22,新光-高雄,2023-07-13,8562
3234,光環,25,4,21,新光-高雄,2023-07-13,8562
2317,鴻海,39,18,21,新光-高雄,2023-07-13,8562
3033,威健,24,4,20,新光-高雄,2023-07-13,8562
8415,大國鋼,20,0,20,新光-高雄,2023-07-13,8562
2897,王道銀行,966,0,966,新光-高雄,2023-07-14,8562
00632R,元大台灣50反1,635,122,513,新光-高雄,2023-07-14,8562
2022,聚亨,181,0,181,新光-高雄,2023-07-14,8562
00664R,國泰臺灣加權反1,120,0,120,新光-高雄,2023-07-14,8562
00882,中信中國高股息,107,18,89,新光-高雄,2023-07-14,8562
00687B,國泰20年美債,93,11,82,新光-高雄,2023-07-14,8562
2883,凱基金,85,15,70,新光-高雄,2023-07-14,8562
2618,長榮航,346,279,67,新光-高雄,2023-07-14,8562
2344,華邦電,178,112,66,新光-高雄,2023-07-14,8562
00665L,富邦�琤肭磪囓�2,77,16,61,新光-高雄,2023-07-14,8562
00680L,元大美債20正2,146,88,58,新光-高雄,2023-07-14,8562
1312,國喬,91,37,54,新光-高雄,2023-07-14,8562
00900,富邦特選高股息30,77,27,50,新光-高雄,2023-07-14,8562
1532,勤美,44,0,44,新光-高雄,2023-07-14,8562
2329,華泰,130,86,44,新光-高雄,2023-07-14,8562
2201,裕隆,75,33,42,新光-高雄,2023-07-14,8562
2812,台中銀,64,23,41,新光-高雄,2023-07-14,8562
00857B,永豐20年美公債,40,0,40,新光-高雄,2023-07-14,8562
6126,信音,43,6,37,新光-高雄,2023-07-14,8562
2324,仁寶,106,70,36,新光-高雄,2023-07-14,8562
6257,矽格,36,0,36,新光-高雄,2023-07-14,8562
3491,昇達科,36,1,35,新光-高雄,2023-07-14,8562
2867,三商壽,49,15,34,新光-高雄,2023-07-14,8562
2328,廣宇,60,27,33,新光-高雄,2023-07-14,8562
3231,緯創,109,77,32,新光-高雄,2023-07-14,8562
00888,永豐台灣ESG,42,11,31,新光-高雄,2023-07-14,8562
00722B,群益投資級電信債,29,0,29,新光-高雄,2023-07-14,8562
3044,健鼎,30,1,29,新光-高雄,2023-07-14,8562
6288,聯嘉,29,2,27,新光-高雄,2023-07-14,8562
3024,憶聲,35,9,26,新光-高雄,2023-07-14,8562
6112,邁達特,28,3,25,新光-高雄,2023-07-14,8562
6191,精成科,35,11,24,新光-高雄,2023-07-14,8562
2419,仲琦,179,155,24,新光-高雄,2023-07-14,8562
2890,永豐金,63,38,25,新光-高雄,2023-07-14,8562
6235,華孚,105,81,24,新光-高雄,2023-07-14,8562
3032,偉訓,49,25,24,新光-高雄,2023-07-14,8562
2603,長榮,61,38,23,新光-高雄,2023-07-14,8562
3673,TPK-KY,23,0,23,新光-高雄,2023-07-14,8562
6691,洋基工程,25,3,22,新光-高雄,2023-07-14,8562
4532,瑞智,91,69,22,新光-高雄,2023-07-14,8562
3163,波若威,43,21,22,新光-高雄,2023-07-14,8562
2371,大同,142,121,21,新光-高雄,2023-07-14,8562
4906,正文,47,26,21,新光-高雄,2023-07-14,8562
5328,華容,20,0,20,新光-高雄,2023-07-14,8562
2358,廷鑫,22,2,20,新光-高雄,2023-07-14,8562
3363,上詮,121,101,20,新光-高雄,2023-07-14,8562
3078,僑威,44,26,18,新光-高雄,2023-07-14,8562
00930,永豐ESG低碳高息,18,0,18,新光-高雄,2023-07-14,8562
8011,台通,17,0,17,新光-高雄,2023-07-14,8562
8926,台汽電,19,2,17,新光-高雄,2023-07-14,8562
6005,群益證,2372,37,2335,新光-高雄,2023-07-17,8562
00929,復華台灣科技優息,566,84,482,新光-高雄,2023-07-17,8562
00673R,期元大S＆P原油反1,464,30,434,新光-高雄,2023-07-17,8562
3231,緯創,438,30,408,新光-高雄,2023-07-17,8562
2515,中工,463,100,363,新光-高雄,2023-07-17,8562
2812,台中銀,341,12,329,新光-高雄,2023-07-17,8562
0056,元大高股息,567,305,262,新光-高雄,2023-07-17,8562
00637L,元大滬深300正2,254,1,253,新光-高雄,2023-07-17,8562
3715,定穎投控,162,5,157,新光-高雄,2023-07-17,8562
00882,中信中國高股息,208,66,142,新光-高雄,2023-07-17,8562
2618,長榮航,257,128,129,新光-高雄,2023-07-17,8562
2301,光寶科,254,136,118,新光-高雄,2023-07-17,8562
2312,金寶,228,112,116,新光-高雄,2023-07-17,8562
2892,第一金,110,5,105,新光-高雄,2023-07-17,8562
00795B,中信美國公債20年,102,0,102,新光-高雄,2023-07-17,8562
4934,太極,133,37,96,新光-高雄,2023-07-17,8562
2890,永豐金,104,13,91,新光-高雄,2023-07-17,8562
6735,美達科技,86,0,86,新光-高雄,2023-07-17,8562
00679B,元大美債20年,95,18,77,新光-高雄,2023-07-17,8562
2885,元大金,62,3,59,新光-高雄,2023-07-17,8562
1101,台泥,57,4,53,新光-高雄,2023-07-17,8562
2801,彰銀,56,6,50,新光-高雄,2023-07-17,8562
6185,幃翔,64,14,50,新光-高雄,2023-07-17,8562
3052,夆典,55,5,50,新光-高雄,2023-07-17,8562
1402,遠東新,48,0,48,新光-高雄,2023-07-17,8562
00772B,中信高評級公司債,106,58,48,新光-高雄,2023-07-17,8562
3005,神基,72,26,46,新光-高雄,2023-07-17,8562
3521,鴻翊,45,0,45,新光-高雄,2023-07-17,8562
00680L,元大美債20正2,46,1,45,新光-高雄,2023-07-17,8562
1905,華紙,72,29,43,新光-高雄,2023-07-17,8562
2388,威盛,149,106,43,新光-高雄,2023-07-17,8562
6118,建達,43,1,42,新光-高雄,2023-07-17,8562
2356,英業達,144,103,41,新光-高雄,2023-07-17,8562
2371,大同,170,130,40,新光-高雄,2023-07-17,8562
3033,威健,53,13,40,新光-高雄,2023-07-17,8562
5488,松普,40,0,40,新光-高雄,2023-07-17,8562
00725B,國泰投資級公司債,41,1,40,新光-高雄,2023-07-17,8562
1504,東元,90,55,35,新光-高雄,2023-07-17,8562
1471,首利,55,20,35,新光-高雄,2023-07-17,8562
2329,華泰,65,33,32,新光-高雄,2023-07-17,8562
3607,谷崧,36,4,32,新光-高雄,2023-07-17,8562
3058,立德,31,0,31,新光-高雄,2023-07-17,8562
1313,聯成,41,10,31,新光-高雄,2023-07-17,8562
6124,業強,79,49,30,新光-高雄,2023-07-17,8562
00720B,元大投資級公司債,65,35,30,新光-高雄,2023-07-17,8562
1528,恩德,80,53,27,新光-高雄,2023-07-17,8562
00675L,富邦臺灣加權正2,26,0,26,新光-高雄,2023-07-17,8562
1444,力麗,26,0,26,新光-高雄,2023-07-17,8562
2542,興富發,26,0,26,新光-高雄,2023-07-17,8562
2382,廣達,129,104,25,新光-高雄,2023-07-17,8562
00878,國泰永續高股息,1111,345,766,新光-高雄,2023-07-18,8562
3706,神達,681,176,505,新光-高雄,2023-07-18,8562
00882,中信中國高股息,438,7,431,新光-高雄,2023-07-18,8562
00929,復華台灣科技優息,525,202,323,新光-高雄,2023-07-18,8562
00673R,期元大S＆P原油反1,255,44,211,新光-高雄,2023-07-18,8562
2324,仁寶,357,215,142,新光-高雄,2023-07-18,8562
2301,光寶科,252,111,141,新光-高雄,2023-07-18,8562
2353,宏��,338,198,140,新光-高雄,2023-07-18,8562
2312,金寶,454,329,125,新光-高雄,2023-07-18,8562
00712,復華富時不動產,236,144,92,新光-高雄,2023-07-18,8562
2412,中華電,87,1,86,新光-高雄,2023-07-18,8562
1711,永光,171,87,84,新光-高雄,2023-07-18,8562
00720B,元大投資級公司債,103,24,79,新光-高雄,2023-07-18,8562
0056,元大高股息,208,130,78,新光-高雄,2023-07-18,8562
4303,信立,77,0,77,新光-高雄,2023-07-18,8562
1101,台泥,83,8,75,新光-高雄,2023-07-18,8562
4919,新唐,97,32,65,新光-高雄,2023-07-18,8562
2352,佳世達,168,104,64,新光-高雄,2023-07-18,8562
2801,彰銀,72,9,63,新光-高雄,2023-07-18,8562
1522,堤維西,59,0,59,新光-高雄,2023-07-18,8562
1609,大亞,181,122,59,新光-高雄,2023-07-18,8562
00772B,中信高評級公司債,65,6,59,新光-高雄,2023-07-18,8562
2897,王道銀行,60,5,55,新光-高雄,2023-07-18,8562
00715L,期街口布蘭特正2,66,12,54,新光-高雄,2023-07-18,8562
2402,毅嘉,103,49,54,新光-高雄,2023-07-18,8562
00751B,元大AAA至A公司債,52,3,49,新光-高雄,2023-07-18,8562
6282,康舒,394,346,48,新光-高雄,2023-07-18,8562
00687B,國泰20年美債,45,0,45,新光-高雄,2023-07-18,8562
1789,神隆,103,60,43,新光-高雄,2023-07-18,8562
00927,群益半導體收益,43,2,41,新光-高雄,2023-07-18,8562
0050,元大台灣50,47,8,39,新光-高雄,2023-07-18,8562
1313,聯成,76,40,36,新光-高雄,2023-07-18,8562
00722B,群益投資級電信債,35,0,35,新光-高雄,2023-07-18,8562
1905,華紙,62,27,35,新光-高雄,2023-07-18,8562
2427,三商電,49,15,34,新光-高雄,2023-07-18,8562
2329,華泰,125,92,33,新光-高雄,2023-07-18,8562
1605,華新,38,5,33,新光-高雄,2023-07-18,8562
2609,陽明,94,63,31,新光-高雄,2023-07-18,8562
3038,全台,35,4,31,新光-高雄,2023-07-18,8562
00665L,富邦�琤肭磪囓�2,32,1,31,新光-高雄,2023-07-18,8562
3265,台星科,56,25,31,新光-高雄,2023-07-18,8562
6188,廣明,89,58,31,新光-高雄,2023-07-18,8562
9939,宏全,34,5,29,新光-高雄,2023-07-18,8562
1402,遠東新,32,3,29,新光-高雄,2023-07-18,8562
4938,和碩,202,173,29,新光-高雄,2023-07-18,8562
2419,仲琦,144,115,29,新光-高雄,2023-07-18,8562
2399,映泰,121,93,28,新光-高雄,2023-07-18,8562
2409,友達,70,42,28,新光-高雄,2023-07-18,8562
5469,瀚宇博,64,36,28,新光-高雄,2023-07-18,8562
3062,建漢,28,0,28,新光-高雄,2023-07-18,8562
00929,復華台灣科技優息,314,87,227,新光-高雄,2023-07-19,8562
2867,三商壽,166,0,166,新光-高雄,2023-07-19,8562
00669R,國泰美國道瓊反1,150,0,150,新光-高雄,2023-07-19,8562
2312,金寶,267,133,134,新光-高雄,2023-07-19,8562
2801,彰銀,139,9,130,新光-高雄,2023-07-19,8562
00632R,元大台灣50反1,178,68,110,新光-高雄,2023-07-19,8562
2106,建大,104,0,104,新光-高雄,2023-07-19,8562
2880,華南金,101,0,101,新光-高雄,2023-07-19,8562
2317,鴻海,160,74,86,新光-高雄,2023-07-19,8562
2353,宏��,215,130,85,新光-高雄,2023-07-19,8562
6218,豪勉,104,20,84,新光-高雄,2023-07-19,8562
00882,中信中國高股息,111,27,84,新光-高雄,2023-07-19,8562
00751B,元大AAA至A公司債,80,1,79,新光-高雄,2023-07-19,8562
1447,力鵬,70,0,70,新光-高雄,2023-07-19,8562
2303,聯電,67,5,62,新光-高雄,2023-07-19,8562
2104,國際中橡,57,1,56,新光-高雄,2023-07-19,8562
2362,藍天,53,0,53,新光-高雄,2023-07-19,8562
00712,復華富時不動產,349,297,52,新光-高雄,2023-07-19,8562
00680L,元大美債20正2,42,0,42,新光-高雄,2023-07-19,8562
1101,台泥,48,7,41,新光-高雄,2023-07-19,8562
2903,遠百,40,1,39,新光-高雄,2023-07-19,8562
2301,光寶科,96,57,39,新光-高雄,2023-07-19,8562
3231,緯創,116,79,37,新光-高雄,2023-07-19,8562
00720B,元大投資級公司債,49,12,37,新光-高雄,2023-07-19,8562
2324,仁寶,266,230,36,新光-高雄,2023-07-19,8562
1701,中化,35,0,35,新光-高雄,2023-07-19,8562
2344,華邦電,295,260,35,新光-高雄,2023-07-19,8562
2495,普安,76,42,34,新光-高雄,2023-07-19,8562
00637L,元大滬深300正2,109,78,31,新光-高雄,2023-07-19,8562
00713,元大台灣高息低波,40,9,31,新光-高雄,2023-07-19,8562
00753L,中信中國50正2,30,0,30,新光-高雄,2023-07-19,8562
00655L,國泰中國A50正2,78,48,30,新光-高雄,2023-07-19,8562
1907,永豐餘,29,0,29,新光-高雄,2023-07-19,8562
6443,元晶,36,8,28,新光-高雄,2023-07-19,8562
3338,泰碩,48,20,28,新光-高雄,2023-07-19,8562
2883,凱基金,38,10,28,新光-高雄,2023-07-19,8562
3037,欣興,102,75,27,新光-高雄,2023-07-19,8562
2915,潤泰全,35,8,27,新光-高雄,2023-07-19,8562
2888,新光金,46,19,27,新光-高雄,2023-07-19,8562
1314,中石化,26,0,26,新光-高雄,2023-07-19,8562
00671R,富邦NASDAQ反1,26,0,26,新光-高雄,2023-07-19,8562
1609,大亞,54,28,26,新光-高雄,2023-07-19,8562
1605,華新,49,25,24,新光-高雄,2023-07-19,8562
5009,榮剛,28,5,23,新光-高雄,2023-07-19,8562
1215,卜蜂,26,3,23,新光-高雄,2023-07-19,8562
3062,建漢,23,0,23,新光-高雄,2023-07-19,8562
6274,台燿,102,79,23,新光-高雄,2023-07-19,8562
2390,云辰,22,0,22,新光-高雄,2023-07-19,8562
2331,精英,25,3,22,新光-高雄,2023-07-19,8562
00905,FT臺灣Smart,21,0,21,新光-高雄,2023-07-19,8562
00929,復華台灣科技優息,704,117,587,新光-高雄,2023-07-20,8562
6016,康和證,554,2,552,新光-高雄,2023-07-20,8562
00888,永豐台灣ESG,126,0,126,新光-高雄,2023-07-20,8562
2303,聯電,127,18,109,新光-高雄,2023-07-20,8562
00712,復華富時不動產,139,44,95,新光-高雄,2023-07-20,8562
2352,佳世達,162,73,89,新光-高雄,2023-07-20,8562
00753L,中信中國50正2,100,12,88,新光-高雄,2023-07-20,8562
00680L,元大美債20正2,86,1,85,新光-高雄,2023-07-20,8562
2405,輔信,231,160,71,新光-高雄,2023-07-20,8562
2801,彰銀,68,1,67,新光-高雄,2023-07-20,8562
1528,恩德,61,0,61,新光-高雄,2023-07-20,8562
8071,能率網通,66,14,52,新光-高雄,2023-07-20,8562
00722B,群益投資級電信債,52,0,52,新光-高雄,2023-07-20,8562
1102,亞泥,50,2,48,新光-高雄,2023-07-20,8562
6282,康舒,183,135,48,新光-高雄,2023-07-20,8562
00919,群益台灣精選高息,53,7,46,新光-高雄,2023-07-20,8562
2301,光寶科,95,50,45,新光-高雄,2023-07-20,8562
1529,樂事綠能,101,57,44,新光-高雄,2023-07-20,8562
1101,台泥,67,25,42,新光-高雄,2023-07-20,8562
00706L,期元大S＆P日圓正2,42,0,42,新光-高雄,2023-07-20,8562
3289,宜特,88,47,41,新光-高雄,2023-07-20,8562
2206,三陽工業,96,58,38,新光-高雄,2023-07-20,8562
5706,鳳凰,56,21,35,新光-高雄,2023-07-20,8562
3024,憶聲,40,6,34,新光-高雄,2023-07-20,8562
2312,金寶,147,116,31,新光-高雄,2023-07-20,8562
3013,晟銘電,36,6,30,新光-高雄,2023-07-20,8562
3231,緯創,67,37,30,新光-高雄,2023-07-20,8562
6126,信音,30,0,30,新光-高雄,2023-07-20,8562
3052,夆典,30,0,30,新光-高雄,2023-07-20,8562
8215,明基材,32,5,27,新光-高雄,2023-07-20,8562
1210,大成,41,15,26,新光-高雄,2023-07-20,8562
3037,欣興,108,83,25,新光-高雄,2023-07-20,8562
2402,毅嘉,105,80,25,新光-高雄,2023-07-20,8562
6120,達運,32,7,25,新光-高雄,2023-07-20,8562
00857B,永豐20年美公債,30,5,25,新光-高雄,2023-07-20,8562
1471,首利,25,0,25,新光-高雄,2023-07-20,8562
4123,晟德,102,77,25,新光-高雄,2023-07-20,8562
5519,隆大,24,0,24,新光-高雄,2023-07-20,8562
00927,群益半導體收益,23,0,23,新光-高雄,2023-07-20,8562
1522,堤維西,28,6,22,新光-高雄,2023-07-20,8562
2881,富邦金,32,10,22,新光-高雄,2023-07-20,8562
00917,中信特選金融,21,0,21,新光-高雄,2023-07-20,8562
6548,長科*,28,8,20,新光-高雄,2023-07-20,8562
1591,駿吉-KY,20,0,20,新光-高雄,2023-07-20,8562
2617,台航,20,0,20,新光-高雄,2023-07-20,8562
6188,廣明,84,64,20,新光-高雄,2023-07-20,8562
8021,尖點,37,20,17,新光-高雄,2023-07-20,8562
2537,聯上發,17,0,17,新光-高雄,2023-07-20,8562
00655L,國泰中國A50正2,47,30,17,新光-高雄,2023-07-20,8562
6217,中探針,70,53,17,新光-高雄,2023-07-20,8562
00878,國泰永續高股息,1240,371,869,新光-高雄,2023-07-21,8562
00632R,元大台灣50反1,742,410,332,新光-高雄,2023-07-21,8562
00706L,期元大S＆P日圓正2,307,0,307,新光-高雄,2023-07-21,8562
2801,彰銀,158,0,158,新光-高雄,2023-07-21,8562
00929,復華台灣科技優息,237,112,125,新光-高雄,2023-07-21,8562
2883,凱基金,126,5,121,新光-高雄,2023-07-21,8562
1605,華新,154,34,120,新光-高雄,2023-07-21,8562
5876,上海商銀,100,0,100,新光-高雄,2023-07-21,8562
2312,金寶,108,16,92,新光-高雄,2023-07-21,8562
00888,永豐台灣ESG,89,0,89,新光-高雄,2023-07-21,8562
00751B,元大AAA至A公司債,83,0,83,新光-高雄,2023-07-21,8562
1714,和桐,80,0,80,新光-高雄,2023-07-21,8562
00688L,國泰20年美債正2,75,0,75,新光-高雄,2023-07-21,8562
2303,聯電,87,17,70,新光-高雄,2023-07-21,8562
3013,晟銘電,173,106,67,新光-高雄,2023-07-21,8562
1789,神隆,105,38,67,新光-高雄,2023-07-21,8562
2201,裕隆,80,15,65,新光-高雄,2023-07-21,8562
00733,富邦臺灣中小,64,0,64,新光-高雄,2023-07-21,8562
6120,達運,83,19,64,新光-高雄,2023-07-21,8562
00673R,期元大S＆P原油反1,213,150,63,新光-高雄,2023-07-21,8562
2897,王道銀行,65,3,62,新光-高雄,2023-07-21,8562
2609,陽明,76,16,60,新光-高雄,2023-07-21,8562
00715L,期街口布蘭特正2,147,88,59,新光-高雄,2023-07-21,8562
2610,華航,126,70,56,新光-高雄,2023-07-21,8562
1708,東鹼,73,20,53,新光-高雄,2023-07-21,8562
00930,永豐ESG低碳高息,49,2,47,新光-高雄,2023-07-21,8562
3209,全科,47,0,47,新光-高雄,2023-07-21,8562
2603,長榮,69,26,43,新光-高雄,2023-07-21,8562
006208,富邦台50,45,4,41,新光-高雄,2023-07-21,8562
00850,元大臺灣ESG永續,43,3,40,新光-高雄,2023-07-21,8562
0050,元大台灣50,41,1,40,新光-高雄,2023-07-21,8562
1301,台塑,69,30,39,新光-高雄,2023-07-21,8562
2888,新光金,90,51,39,新光-高雄,2023-07-21,8562
1102,亞泥,40,1,39,新光-高雄,2023-07-21,8562
1513,中興電,238,201,37,新光-高雄,2023-07-21,8562
1101,台泥,59,23,36,新光-高雄,2023-07-21,8562
2409,友達,61,28,33,新光-高雄,2023-07-21,8562
00919,群益台灣精選高息,48,16,32,新光-高雄,2023-07-21,8562
2402,毅嘉,54,23,31,新光-高雄,2023-07-21,8562
2739,寒舍,36,5,31,新光-高雄,2023-07-21,8562
00637L,元大滬深300正2,164,134,30,新光-高雄,2023-07-21,8562
6186,新潤,30,0,30,新光-高雄,2023-07-21,8562
1736,喬山,51,22,29,新光-高雄,2023-07-21,8562
6274,台燿,77,48,29,新光-高雄,2023-07-21,8562
3264,欣銓,50,22,28,新光-高雄,2023-07-21,8562
5521,工信,28,0,28,新光-高雄,2023-07-21,8562
00692,富邦公司治理,27,0,27,新光-高雄,2023-07-21,8562
1504,東元,101,74,27,新光-高雄,2023-07-21,8562
00679B,元大美債20年,38,12,26,新光-高雄,2023-07-21,8562
6111,大宇資,32,8,24,新光-高雄,2023-07-21,8562
6005,群益證,505,27,478,新光-高雄,2023-07-24,8562
00679B,元大美債20年,209,12,197,新光-高雄,2023-07-24,8562
00673R,期元大S＆P原油反1,151,7,144,新光-高雄,2023-07-24,8562
6016,康和證,121,6,115,新光-高雄,2023-07-24,8562
8050,廣積,131,22,109,新光-高雄,2023-07-24,8562
5876,上海商銀,101,0,101,新光-高雄,2023-07-24,8562
00706L,期元大S＆P日圓正2,88,0,88,新光-高雄,2023-07-24,8562
2382,廣達,218,136,82,新光-高雄,2023-07-24,8562
3013,晟銘電,236,162,74,新光-高雄,2023-07-24,8562
2610,華航,169,97,72,新光-高雄,2023-07-24,8562
1609,大亞,259,188,71,新光-高雄,2023-07-24,8562
2354,鴻準,70,2,68,新光-高雄,2023-07-24,8562
2883,凱基金,65,1,64,新光-高雄,2023-07-24,8562
2887,台新金,56,2,54,新光-高雄,2023-07-24,8562
9105,泰金寶-DR,65,11,54,新光-高雄,2023-07-24,8562
6125,廣運,118,65,53,新光-高雄,2023-07-24,8562
2880,華南金,53,0,53,新光-高雄,2023-07-24,8562
1301,台塑,57,4,53,新光-高雄,2023-07-24,8562
2609,陽明,68,15,53,新光-高雄,2023-07-24,8562
9941,裕融,50,1,49,新光-高雄,2023-07-24,8562
2461,光群雷,174,128,46,新光-高雄,2023-07-24,8562
00772B,中信高評級公司債,47,3,44,新光-高雄,2023-07-24,8562
2421,建準,186,142,44,新光-高雄,2023-07-24,8562
5347,世界,41,0,41,新光-高雄,2023-07-24,8562
00902,中信電池及儲能,42,1,41,新光-高雄,2023-07-24,8562
2399,映泰,46,5,41,新光-高雄,2023-07-24,8562
3051,力特,59,19,40,新光-高雄,2023-07-24,8562
2006,東和鋼鐵,38,0,38,新光-高雄,2023-07-24,8562
6213,聯茂,60,22,38,新光-高雄,2023-07-24,8562
2409,友達,58,20,38,新光-高雄,2023-07-24,8562
00637L,元大滬深300正2,73,36,37,新光-高雄,2023-07-24,8562
3231,緯創,50,14,36,新光-高雄,2023-07-24,8562
2547,日勝生,36,0,36,新光-高雄,2023-07-24,8562
1714,和桐,34,0,34,新光-高雄,2023-07-24,8562
6274,台燿,160,127,33,新光-高雄,2023-07-24,8562
2615,萬海,47,14,33,新光-高雄,2023-07-24,8562
00882,中信中國高股息,41,9,32,新光-高雄,2023-07-24,8562
1101,台泥,58,26,32,新光-高雄,2023-07-24,8562
00720B,元大投資級公司債,41,9,32,新光-高雄,2023-07-24,8562
00688L,國泰20年美債正2,30,0,30,新光-高雄,2023-07-24,8562
6217,中探針,33,3,30,新光-高雄,2023-07-24,8562
2884,玉山金,30,0,30,新光-高雄,2023-07-24,8562
1102,亞泥,28,0,28,新光-高雄,2023-07-24,8562
2329,華泰,190,164,26,新光-高雄,2023-07-24,8562
2355,敬鵬,25,0,25,新光-高雄,2023-07-24,8562
3035,智原,95,70,25,新光-高雄,2023-07-24,8562
2425,承啟,43,19,24,新光-高雄,2023-07-24,8562
2892,第一金,24,0,24,新光-高雄,2023-07-24,8562
00891,中信關鍵半導體,23,0,23,新光-高雄,2023-07-24,8562
2889,國票金,23,0,23,新光-高雄,2023-07-24,8562
00878,國泰永續高股息,1698,1062,636,新光-高雄,2023-07-25,8562
00712,復華富時不動產,233,39,194,新光-高雄,2023-07-25,8562
00664R,國泰臺灣加權反1,180,0,180,新光-高雄,2023-07-25,8562
2881,富邦金,171,3,168,新光-高雄,2023-07-25,8562
00673R,期元大S＆P原油反1,463,302,161,新光-高雄,2023-07-25,8562
00679B,元大美債20年,188,31,157,新光-高雄,2023-07-25,8562
4726,永昕,147,21,126,新光-高雄,2023-07-25,8562
3682,亞太電,120,3,117,新光-高雄,2023-07-25,8562
00687B,國泰20年美債,127,12,115,新光-高雄,2023-07-25,8562
3481,群創,142,56,86,新光-高雄,2023-07-25,8562
00929,復華台灣科技優息,102,25,77,新光-高雄,2023-07-25,8562
2382,廣達,243,176,67,新光-高雄,2023-07-25,8562
2887,台新金,96,39,57,新光-高雄,2023-07-25,8562
1905,華紙,246,190,56,新光-高雄,2023-07-25,8562
00751B,元大AAA至A公司債,55,0,55,新光-高雄,2023-07-25,8562
00830,國泰費城半導體,50,0,50,新光-高雄,2023-07-25,8562
3702,大聯大,42,0,42,新光-高雄,2023-07-25,8562
2903,遠百,42,0,42,新光-高雄,2023-07-25,8562
3558,神準,46,7,39,新光-高雄,2023-07-25,8562
1609,大亞,84,47,37,新光-高雄,2023-07-25,8562
00930,永豐ESG低碳高息,35,0,35,新光-高雄,2023-07-25,8562
2356,英業達,102,67,35,新光-高雄,2023-07-25,8562
5452,佶優,102,68,34,新光-高雄,2023-07-25,8562
2427,三商電,33,2,31,新光-高雄,2023-07-25,8562
00669R,國泰美國道瓊反1,36,5,31,新光-高雄,2023-07-25,8562
2442,新美齊,30,0,30,新光-高雄,2023-07-25,8562
2312,金寶,42,14,28,新光-高雄,2023-07-25,8562
1101,台泥,133,106,27,新光-高雄,2023-07-25,8562
4414,如興,26,0,26,新光-高雄,2023-07-25,8562
00632R,元大台灣50反1,58,32,26,新光-高雄,2023-07-25,8562
2301,光寶科,150,124,26,新光-高雄,2023-07-25,8562
2401,凌陽,52,28,24,新光-高雄,2023-07-25,8562
1102,亞泥,37,13,24,新光-高雄,2023-07-25,8562
3706,神達,40,16,24,新光-高雄,2023-07-25,8562
2812,台中銀,44,21,23,新光-高雄,2023-07-25,8562
1301,台塑,25,2,23,新光-高雄,2023-07-25,8562
2474,可成,23,0,23,新光-高雄,2023-07-25,8562
8021,尖點,27,4,23,新光-高雄,2023-07-25,8562
8050,廣積,46,23,23,新光-高雄,2023-07-25,8562
1215,卜蜂,23,0,23,新光-高雄,2023-07-25,8562
1447,力鵬,22,0,22,新光-高雄,2023-07-25,8562
8092,建暐,22,0,22,新光-高雄,2023-07-25,8562
00885,富邦越南,27,6,21,新光-高雄,2023-07-25,8562
3231,緯創,63,42,21,新光-高雄,2023-07-25,8562
2328,廣宇,25,5,20,新光-高雄,2023-07-25,8562
2637,慧洋-KY,20,0,20,新光-高雄,2023-07-25,8562
9105,泰金寶-DR,70,50,20,新光-高雄,2023-07-25,8562
2419,仲琦,99,80,19,新光-高雄,2023-07-25,8562
2449,京元電子,29,10,19,新光-高雄,2023-07-25,8562
2316,楠梓電,28,9,19,新光-高雄,2023-07-25,8562
6005,群益證,787,33,754,新光-高雄,2023-07-26,8562
00929,復華台灣科技優息,639,2,637,新光-高雄,2023-07-26,8562
8358,金居,347,207,140,新光-高雄,2023-07-26,8562
2897,王道銀行,146,16,130,新光-高雄,2023-07-26,8562
00664R,國泰臺灣加權反1,130,0,130,新光-高雄,2023-07-26,8562
00751B,元大AAA至A公司債,111,0,111,新光-高雄,2023-07-26,8562
1504,東元,465,355,110,新光-高雄,2023-07-26,8562
00673R,期元大S＆P原油反1,163,60,103,新光-高雄,2023-07-26,8562
2354,鴻準,98,8,90,新光-高雄,2023-07-26,8562
2405,輔信,278,195,83,新光-高雄,2023-07-26,8562
6016,康和證,105,36,69,新光-高雄,2023-07-26,8562
2890,永豐金,85,19,66,新光-高雄,2023-07-26,8562
2402,毅嘉,81,16,65,新光-高雄,2023-07-26,8562
3682,亞太電,60,0,60,新光-高雄,2023-07-26,8562
00680L,元大美債20正2,60,1,59,新光-高雄,2023-07-26,8562
2031,新光鋼,54,0,54,新光-高雄,2023-07-26,8562
00772B,中信高評級公司債,54,1,53,新光-高雄,2023-07-26,8562
00679B,元大美債20年,71,21,50,新光-高雄,2023-07-26,8562
2009,第一銅,50,0,50,新光-高雄,2023-07-26,8562
6214,精誠,68,19,49,新光-高雄,2023-07-26,8562
2337,旺宏,50,2,48,新光-高雄,2023-07-26,8562
6218,豪勉,49,1,48,新光-高雄,2023-07-26,8562
2303,聯電,60,13,47,新光-高雄,2023-07-26,8562
2603,長榮,101,57,44,新光-高雄,2023-07-26,8562
3071,協禧,79,36,43,新光-高雄,2023-07-26,8562
2002,中鋼,46,4,42,新光-高雄,2023-07-26,8562
2317,鴻海,61,19,42,新光-高雄,2023-07-26,8562
1609,大亞,78,39,39,新光-高雄,2023-07-26,8562
8092,建暐,36,0,36,新光-高雄,2023-07-26,8562
3231,緯創,73,37,36,新光-高雄,2023-07-26,8562
6770,力積電,37,2,35,新光-高雄,2023-07-26,8562
4188,安克,37,2,35,新光-高雄,2023-07-26,8562
00763U,期街口道瓊銅,34,0,34,新光-高雄,2023-07-26,8562
00637L,元大滬深300正2,45,12,33,新光-高雄,2023-07-26,8562
2801,彰銀,37,5,32,新光-高雄,2023-07-26,8562
6126,信音,126,94,32,新光-高雄,2023-07-26,8562
2385,群光,39,7,32,新光-高雄,2023-07-26,8562
2014,中鴻,37,6,31,新光-高雄,2023-07-26,8562
6112,邁達特,172,142,30,新光-高雄,2023-07-26,8562
2609,陽明,54,25,29,新光-高雄,2023-07-26,8562
2327,國巨,31,2,29,新光-高雄,2023-07-26,8562
6274,台燿,113,86,27,新光-高雄,2023-07-26,8562
2027,大成鋼,33,6,27,新光-高雄,2023-07-26,8562
00687B,國泰20年美債,26,0,26,新光-高雄,2023-07-26,8562
1104,環泥,89,64,25,新光-高雄,2023-07-26,8562
5425,台半,29,4,25,新光-高雄,2023-07-26,8562
1815,富喬,30,5,25,新光-高雄,2023-07-26,8562
2915,潤泰全,29,5,24,新光-高雄,2023-07-26,8562
2883,凱基金,134,111,23,新光-高雄,2023-07-26,8562
6188,廣明,115,92,23,新光-高雄,2023-07-26,8562
00715L,期街口布蘭特正2,857,54,803,新光-高雄,2023-07-27,8562
00929,復華台灣科技優息,882,508,374,新光-高雄,2023-07-27,8562
3481,群創,477,328,149,新光-高雄,2023-07-27,8562
2890,永豐金,159,14,145,新光-高雄,2023-07-27,8562
00664R,國泰臺灣加權反1,150,10,140,新光-高雄,2023-07-27,8562
6405,悅城,140,4,136,新光-高雄,2023-07-27,8562
2027,大成鋼,144,21,123,新光-高雄,2023-07-27,8562
2897,王道銀行,190,88,102,新光-高雄,2023-07-27,8562
00751B,元大AAA至A公司債,82,0,82,新光-高雄,2023-07-27,8562
2312,金寶,97,17,80,新光-高雄,2023-07-27,8562
00679B,元大美債20年,149,70,79,新光-高雄,2023-07-27,8562
00687B,國泰20年美債,62,0,62,新光-高雄,2023-07-27,8562
6015,宏遠證,152,92,60,新光-高雄,2023-07-27,8562
1528,恩德,56,0,56,新光-高雄,2023-07-27,8562
2887,台新金,79,29,50,新光-高雄,2023-07-27,8562
2618,長榮航,136,87,49,新光-高雄,2023-07-27,8562
00830,國泰費城半導體,49,2,47,新光-高雄,2023-07-27,8562
1313,聯成,206,161,45,新光-高雄,2023-07-27,8562
6112,邁達特,66,22,44,新光-高雄,2023-07-27,8562
2405,輔信,116,76,40,新光-高雄,2023-07-27,8562
2002,中鋼,47,9,38,新光-高雄,2023-07-27,8562
8936,國統,41,3,38,新光-高雄,2023-07-27,8562
00772B,中信高評級公司債,37,2,35,新光-高雄,2023-07-27,8562
6126,信音,70,38,32,新光-高雄,2023-07-27,8562
6274,台燿,111,80,31,新光-高雄,2023-07-27,8562
00680L,元大美債20正2,30,0,30,新光-高雄,2023-07-27,8562
6213,聯茂,85,56,29,新光-高雄,2023-07-27,8562
6182,合晶,35,6,29,新光-高雄,2023-07-27,8562
2006,東和鋼鐵,31,2,29,新光-高雄,2023-07-27,8562
5864,致和證,26,0,26,新光-高雄,2023-07-27,8562
2401,凌陽,33,8,25,新光-高雄,2023-07-27,8562
3037,欣興,74,50,24,新光-高雄,2023-07-27,8562
00795B,中信美國公債20年,24,0,24,新光-高雄,2023-07-27,8562
2884,玉山金,50,27,23,新光-高雄,2023-07-27,8562
1514,亞力,26,4,22,新光-高雄,2023-07-27,8562
3231,緯創,49,29,20,新光-高雄,2023-07-27,8562
1785,光洋科,29,8,21,新光-高雄,2023-07-27,8562
1504,東元,38,18,20,新光-高雄,2023-07-27,8562
2317,鴻海,138,118,20,新光-高雄,2023-07-27,8562
00720B,元大投資級公司債,20,1,19,新光-高雄,2023-07-27,8562
3049,精金,82,63,19,新光-高雄,2023-07-27,8562
2301,光寶科,122,105,17,新光-高雄,2023-07-27,8562
4741,泓瀚,17,0,17,新光-高雄,2023-07-27,8562
00888,永豐台灣ESG,20,3,17,新光-高雄,2023-07-27,8562
2353,宏��,57,40,17,新光-高雄,2023-07-27,8562
8234,新漢,87,71,16,新光-高雄,2023-07-27,8562
00857B,永豐20年美公債,15,0,15,新光-高雄,2023-07-27,8562
2484,希華,15,0,15,新光-高雄,2023-07-27,8562
2314,台揚,15,0,15,新光-高雄,2023-07-27,8562
00902,中信電池及儲能,23,10,13,新光-高雄,2023-07-27,8562
00680L,元大美債20正2,881,24,857,新光-高雄,2023-07-28,8562
2027,大成鋼,498,26,472,新光-高雄,2023-07-28,8562
00679B,元大美債20年,282,26,256,新光-高雄,2023-07-28,8562
00687B,國泰20年美債,230,27,203,新光-高雄,2023-07-28,8562
2888,新光金,224,32,192,新光-高雄,2023-07-28,8562
2409,友達,294,115,179,新光-高雄,2023-07-28,8562
00772B,中信高評級公司債,184,26,158,新光-高雄,2023-07-28,8562
00664R,國泰臺灣加權反1,150,0,150,新光-高雄,2023-07-28,8562
00795B,中信美國公債20年,161,16,145,新光-高雄,2023-07-28,8562
00751B,元大AAA至A公司債,146,2,144,新光-高雄,2023-07-28,8562
2329,華泰,523,381,142,新光-高雄,2023-07-28,8562
2610,華航,188,58,130,新光-高雄,2023-07-28,8562
4979,華星光,222,95,127,新光-高雄,2023-07-28,8562
3081,聯亞,143,42,101,新光-高雄,2023-07-28,8562
2405,輔信,116,20,96,新光-高雄,2023-07-28,8562
00688L,國泰20年美債正2,88,2,86,新光-高雄,2023-07-28,8562
00720B,元大投資級公司債,82,11,71,新光-高雄,2023-07-28,8562
3231,緯創,424,356,68,新光-高雄,2023-07-28,8562
2369,菱生,126,61,65,新光-高雄,2023-07-28,8562
00673R,期元大S＆P原油反1,60,0,60,新光-高雄,2023-07-28,8562
00773B,中信優先金融債,59,1,58,新光-高雄,2023-07-28,8562
2303,聯電,132,75,57,新光-高雄,2023-07-28,8562
00923,群益台ESG低碳50,56,0,56,新光-高雄,2023-07-28,8562
00929,復華台灣科技優息,113,58,55,新光-高雄,2023-07-28,8562
6282,康舒,146,92,54,新光-高雄,2023-07-28,8562
2002,中鋼,59,5,54,新光-高雄,2023-07-28,8562
3346,麗清,53,0,53,新光-高雄,2023-07-28,8562
6405,悅城,44,0,44,新光-高雄,2023-07-28,8562
2356,英業達,67,29,38,新光-高雄,2023-07-28,8562
2427,三商電,111,73,38,新光-高雄,2023-07-28,8562
00632R,元大台灣50反1,86,52,34,新光-高雄,2023-07-28,8562
4973,廣穎,41,11,30,新光-高雄,2023-07-28,8562
5452,佶優,32,3,29,新光-高雄,2023-07-28,8562
1522,堤維西,32,6,26,新光-高雄,2023-07-28,8562
1612,宏泰,31,5,26,新光-高雄,2023-07-28,8562
1789,神隆,27,1,26,新光-高雄,2023-07-28,8562
2882,國泰金,24,1,23,新光-高雄,2023-07-28,8562
1402,遠東新,23,0,23,新光-高雄,2023-07-28,8562
2006,東和鋼鐵,22,0,22,新光-高雄,2023-07-28,8562
2345,智邦,24,2,22,新光-高雄,2023-07-28,8562
2480,敦陽科,31,10,21,新光-高雄,2023-07-28,8562
2461,光群雷,28,7,21,新光-高雄,2023-07-28,8562
5386,青雲,44,23,21,新光-高雄,2023-07-28,8562
00722B,群益投資級電信債,60,39,21,新光-高雄,2023-07-28,8562
2354,鴻準,26,6,20,新光-高雄,2023-07-28,8562
00669R,國泰美國道瓊反1,20,0,20,新光-高雄,2023-07-28,8562
5498,凱崴,20,0,20,新光-高雄,2023-07-28,8562
6112,邁達特,23,4,19,新光-高雄,2023-07-28,8562
00764B,群益25年美債,19,0,19,新光-高雄,2023-07-28,8562
5234,達興材料,22,3,19,新光-高雄,2023-07-28,8562
0056,元大高股息,1061,261,800,新光-高雄,2023-07-31,8562
00706L,期元大S＆P日圓正2,289,0,289,新光-高雄,2023-07-31,8562
2027,大成鋼,276,13,263,新光-高雄,2023-07-31,8562
00929,復華台灣科技優息,337,143,194,新光-高雄,2023-07-31,8562
00632R,元大台灣50反1,234,45,189,新光-高雄,2023-07-31,8562
2883,凱基金,179,23,156,新光-高雄,2023-07-31,8562
2610,華航,180,37,143,新光-高雄,2023-07-31,8562
00673R,期元大S＆P原油反1,127,0,127,新光-高雄,2023-07-31,8562
4979,華星光,182,64,118,新光-高雄,2023-07-31,8562
2547,日勝生,100,0,100,新光-高雄,2023-07-31,8562
00878,國泰永續高股息,1033,935,98,新光-高雄,2023-07-31,8562
3481,群創,140,64,76,新光-高雄,2023-07-31,8562
2834,臺企銀,69,7,62,新光-高雄,2023-07-31,8562
3231,緯創,312,252,60,新光-高雄,2023-07-31,8562
3081,聯亞,72,16,56,新光-高雄,2023-07-31,8562
2399,映泰,55,0,55,新光-高雄,2023-07-31,8562
6274,台燿,105,50,55,新光-高雄,2023-07-31,8562
2002,中鋼,81,28,53,新光-高雄,2023-07-31,8562
2880,華南金,103,54,49,新光-高雄,2023-07-31,8562
2031,新光鋼,61,13,48,新光-高雄,2023-07-31,8562
2885,元大金,50,3,47,新光-高雄,2023-07-31,8562
00885,富邦越南,108,63,45,新光-高雄,2023-07-31,8562
3322,建舜電,73,32,41,新光-高雄,2023-07-31,8562
2812,台中銀,79,40,39,新光-高雄,2023-07-31,8562
3047,訊舟,55,16,39,新光-高雄,2023-07-31,8562
3034,聯詠,44,6,38,新光-高雄,2023-07-31,8562
2301,光寶科,251,213,38,新光-高雄,2023-07-31,8562
6285,啟��,89,53,36,新光-高雄,2023-07-31,8562
2402,毅嘉,122,88,34,新光-高雄,2023-07-31,8562
00637L,元大滬深300正2,97,63,34,新光-高雄,2023-07-31,8562
00679B,元大美債20年,57,23,34,新光-高雄,2023-07-31,8562
6126,信音,88,55,33,新光-高雄,2023-07-31,8562
3264,欣銓,62,30,32,新光-高雄,2023-07-31,8562
4904,遠傳,31,0,31,新光-高雄,2023-07-31,8562
2881,富邦金,38,9,29,新光-高雄,2023-07-31,8562
2867,三商壽,29,0,29,新光-高雄,2023-07-31,8562
1605,華新,55,27,28,新光-高雄,2023-07-31,8562
1522,堤維西,27,0,27,新光-高雄,2023-07-31,8562
2890,永豐金,35,8,27,新光-高雄,2023-07-31,8562
2444,兆勁,27,0,27,新光-高雄,2023-07-31,8562
2382,廣達,172,146,26,新光-高雄,2023-07-31,8562
2603,長榮,88,62,26,新光-高雄,2023-07-31,8562
2317,鴻海,33,7,26,新光-高雄,2023-07-31,8562
00900,富邦特選高股息30,51,26,25,新光-高雄,2023-07-31,8562
1305,華夏,33,9,24,新光-高雄,2023-07-31,8562
2609,陽明,37,13,24,新光-高雄,2023-07-31,8562
9940,信義,23,0,23,新光-高雄,2023-07-31,8562
2748,雲品,34,11,23,新光-高雄,2023-07-31,8562
6122,擎邦,23,1,22,新光-高雄,2023-07-31,8562
4741,泓瀚,22,0,22,新光-高雄,2023-07-31,8562
00706L,期元大S＆P日圓正2,215,22,193,新光-高雄,2023-08-01,8562
00923,群益台ESG低碳50,99,0,99,新光-高雄,2023-08-01,8562
2409,友達,115,23,92,新光-高雄,2023-08-01,8562
2027,大成鋼,79,3,76,新光-高雄,2023-08-01,8562
2834,臺企銀,82,7,75,新光-高雄,2023-08-01,8562
00680L,元大美債20正2,96,31,65,新光-高雄,2023-08-01,8562
2913,農林,276,219,57,新光-高雄,2023-08-01,8562
00890B,凱基ESG BBB債,54,0,54,新光-高雄,2023-08-01,8562
2337,旺宏,56,3,53,新光-高雄,2023-08-01,8562
6218,豪勉,71,20,51,新光-高雄,2023-08-01,8562
6282,康舒,201,151,50,新光-高雄,2023-08-01,8562
5880,合庫金,50,3,47,新光-高雄,2023-08-01,8562
3558,神準,54,8,46,新光-高雄,2023-08-01,8562
6217,中探針,47,1,46,新光-高雄,2023-08-01,8562
2344,華邦電,175,137,38,新光-高雄,2023-08-01,8562
2009,第一銅,54,20,34,新光-高雄,2023-08-01,8562
8105,凌巨,32,0,32,新光-高雄,2023-08-01,8562
3051,力特,37,6,31,新光-高雄,2023-08-01,8562
1532,勤美,33,2,31,新光-高雄,2023-08-01,8562
5443,均豪,44,14,30,新光-高雄,2023-08-01,8562
8940,新天地,30,0,30,新光-高雄,2023-08-01,8562
00764B,群益25年美債,30,0,30,新光-高雄,2023-08-01,8562
1513,中興電,60,31,29,新光-高雄,2023-08-01,8562
00885,富邦越南,43,15,28,新光-高雄,2023-08-01,8562
4113,聯上,30,2,28,新光-高雄,2023-08-01,8562
00919,群益台灣精選高息,34,7,27,新光-高雄,2023-08-01,8562
3105,穩懋,29,3,26,新光-高雄,2023-08-01,8562
6733,博晟生醫,24,0,24,新光-高雄,2023-08-01,8562
1609,大亞,31,7,24,新光-高雄,2023-08-01,8562
00712,復華富時不動產,39,16,23,新光-高雄,2023-08-01,8562
6186,新潤,23,0,23,新光-高雄,2023-08-01,8562
3081,聯亞,27,5,22,新光-高雄,2023-08-01,8562
3325,旭品,53,32,21,新光-高雄,2023-08-01,8562
1608,華榮,23,2,21,新光-高雄,2023-08-01,8562
00633L,富邦上証正2,27,6,21,新光-高雄,2023-08-01,8562
1905,華紙,116,95,21,新光-高雄,2023-08-01,8562
2915,潤泰全,20,0,20,新光-高雄,2023-08-01,8562
2354,鴻準,20,0,20,新光-高雄,2023-08-01,8562
00637L,元大滬深300正2,38,18,20,新光-高雄,2023-08-01,8562
3044,健鼎,25,6,19,新光-高雄,2023-08-01,8562
3583,辛耘,58,39,19,新光-高雄,2023-08-01,8562
3419,譁裕,25,6,19,新光-高雄,2023-08-01,8562
3188,鑫龍騰,19,0,19,新光-高雄,2023-08-01,8562
2801,彰銀,27,8,19,新光-高雄,2023-08-01,8562
3596,智易,34,15,19,新光-高雄,2023-08-01,8562
3014,聯陽,25,7,18,新光-高雄,2023-08-01,8562
2327,國巨,18,0,18,新光-高雄,2023-08-01,8562
2880,華南金,27,9,18,新光-高雄,2023-08-01,8562
2498,宏達電,25,7,18,新光-高雄,2023-08-01,8562
1522,堤維西,17,0,17,新光-高雄,2023-08-01,8562
00929,復華台灣科技優息,1605,98,1507,新光-高雄,2023-08-02,8562
00878,國泰永續高股息,1619,301,1318,新光-高雄,2023-08-02,8562
2834,臺企銀,422,0,422,新光-高雄,2023-08-02,8562
00923,群益台ESG低碳50,187,8,179,新光-高雄,2023-08-02,8562
00772B,中信高評級公司債,155,0,155,新光-高雄,2023-08-02,8562
00673R,期元大S＆P原油反1,157,10,147,新光-高雄,2023-08-02,8562
00751B,元大AAA至A公司債,142,0,142,新光-高雄,2023-08-02,8562
00687B,國泰20年美債,147,5,142,新光-高雄,2023-08-02,8562
2801,彰銀,132,0,132,新光-高雄,2023-08-02,8562
2892,第一金,118,1,117,新光-高雄,2023-08-02,8562
0056,元大高股息,226,113,113,新光-高雄,2023-08-02,8562
2610,華航,185,72,113,新光-高雄,2023-08-02,8562
2344,華邦電,280,171,109,新光-高雄,2023-08-02,8562
2888,新光金,144,42,102,新光-高雄,2023-08-02,8562
00900,富邦特選高股息30,202,103,99,新光-高雄,2023-08-02,8562
00688L,國泰20年美債正2,100,2,98,新光-高雄,2023-08-02,8562
8050,廣積,111,15,96,新光-高雄,2023-08-02,8562
9904,寶成,100,4,96,新光-高雄,2023-08-02,8562
00712,復華富時不動產,202,107,95,新光-高雄,2023-08-02,8562
00679B,元大美債20年,107,14,93,新光-高雄,2023-08-02,8562
00795B,中信美國公債20年,92,1,91,新光-高雄,2023-08-02,8562
2618,長榮航,133,46,87,新光-高雄,2023-08-02,8562
2883,凱基金,94,15,79,新光-高雄,2023-08-02,8562
2409,友達,164,85,79,新光-高雄,2023-08-02,8562
2353,宏��,128,52,76,新光-高雄,2023-08-02,8562
00671R,富邦NASDAQ反1,74,0,74,新光-高雄,2023-08-02,8562
2890,永豐金,78,9,69,新光-高雄,2023-08-02,8562
3481,群創,198,131,67,新光-高雄,2023-08-02,8562
1809,中釉,74,10,64,新光-高雄,2023-08-02,8562
00882,中信中國高股息,66,5,61,新光-高雄,2023-08-02,8562
00773B,中信優先金融債,61,0,61,新光-高雄,2023-08-02,8562
2605,新興,64,6,58,新光-高雄,2023-08-02,8562
2880,華南金,53,0,53,新光-高雄,2023-08-02,8562
00753L,中信中國50正2,83,35,48,新光-高雄,2023-08-02,8562
00637L,元大滬深300正2,108,60,48,新光-高雄,2023-08-02,8562
6274,台燿,120,77,43,新光-高雄,2023-08-02,8562
6285,啟��,88,45,43,新光-高雄,2023-08-02,8562
00631L,元大台灣50正2,42,1,41,新光-高雄,2023-08-02,8562
00665L,富邦�琤肭磪囓�2,195,154,41,新光-高雄,2023-08-02,8562
2317,鴻海,52,12,40,新光-高雄,2023-08-02,8562
006208,富邦台50,40,0,40,新光-高雄,2023-08-02,8562
8105,凌巨,41,2,39,新光-高雄,2023-08-02,8562
2812,台中銀,45,8,37,新光-高雄,2023-08-02,8562
6126,信音,47,10,37,新光-高雄,2023-08-02,8562
2352,佳世達,71,34,37,新光-高雄,2023-08-02,8562
3711,日月光投控,49,12,37,新光-高雄,2023-08-02,8562
2498,宏達電,81,45,36,新光-高雄,2023-08-02,8562
3033,威健,46,11,35,新光-高雄,2023-08-02,8562
2002,中鋼,66,31,35,新光-高雄,2023-08-02,8562
00885,富邦越南,157,125,32,新光-高雄,2023-08-02,8562
00632R,元大台灣50反1,2550,298,2252,新光-高雄,2023-08-04,8562
1802,台玻,649,80,569,新光-高雄,2023-08-04,8562
00687B,國泰20年美債,362,46,316,新光-高雄,2023-08-04,8562
00679B,元大美債20年,342,52,290,新光-高雄,2023-08-04,8562
1326,台化,229,1,228,新光-高雄,2023-08-04,8562
00688L,國泰20年美債正2,233,20,213,新光-高雄,2023-08-04,8562
00680L,元大美債20正2,429,246,183,新光-高雄,2023-08-04,8562
2891,中信金,181,23,158,新光-高雄,2023-08-04,8562
00795B,中信美國公債20年,155,3,152,新光-高雄,2023-08-04,8562
3682,亞太電,140,0,140,新光-高雄,2023-08-04,8562
020033,統一�琤肮黕篾,140,0,140,新光-高雄,2023-08-04,8562
2344,華邦電,285,171,114,新光-高雄,2023-08-04,8562
2888,新光金,156,42,114,新光-高雄,2023-08-04,8562
00720B,元大投資級公司債,126,17,109,新光-高雄,2023-08-04,8562
00850,元大臺灣ESG永續,91,0,91,新光-高雄,2023-08-04,8562
00772B,中信高評級公司債,119,30,89,新光-高雄,2023-08-04,8562
00751B,元大AAA至A公司債,86,0,86,新光-高雄,2023-08-04,8562
6235,華孚,130,45,85,新光-高雄,2023-08-04,8562
4960,誠美材,85,0,85,新光-高雄,2023-08-04,8562
2801,彰銀,80,0,80,新光-高雄,2023-08-04,8562
00712,復華富時不動產,110,30,80,新光-高雄,2023-08-04,8562
2002,中鋼,114,35,79,新光-高雄,2023-08-04,8562
00878,國泰永續高股息,361,288,73,新光-高雄,2023-08-04,8562
3231,緯創,509,437,72,新光-高雄,2023-08-04,8562
5009,榮剛,73,4,69,新光-高雄,2023-08-04,8562
00673R,期元大S＆P原油反1,74,10,64,新光-高雄,2023-08-04,8562
1218,泰山,61,0,61,新光-高雄,2023-08-04,8562
00900,富邦特選高股息30,110,55,55,新光-高雄,2023-08-04,8562
2884,玉山金,60,5,55,新光-高雄,2023-08-04,8562
2913,農林,329,274,55,新光-高雄,2023-08-04,8562
1785,光洋科,62,16,46,新光-高雄,2023-08-04,8562
00669R,國泰美國道瓊反1,50,5,45,新光-高雄,2023-08-04,8562
2345,智邦,51,9,42,新光-高雄,2023-08-04,8562
006208,富邦台50,41,0,41,新光-高雄,2023-08-04,8562
00708L,期元大S＆P黃金正2,41,0,41,新光-高雄,2023-08-04,8562
00764B,群益25年美債,41,0,41,新光-高雄,2023-08-04,8562
1210,大成,54,14,40,新光-高雄,2023-08-04,8562
5511,德昌,42,3,39,新光-高雄,2023-08-04,8562
3706,神達,81,42,39,新光-高雄,2023-08-04,8562
00923,群益台ESG低碳50,64,26,38,新光-高雄,2023-08-04,8562
9927,泰銘,37,0,37,新光-高雄,2023-08-04,8562
2352,佳世達,54,21,33,新光-高雄,2023-08-04,8562
2409,友達,56,23,33,新光-高雄,2023-08-04,8562
2027,大成鋼,34,5,29,新光-高雄,2023-08-04,8562
2609,陽明,45,17,28,新光-高雄,2023-08-04,8562
2915,潤泰全,27,1,26,新光-高雄,2023-08-04,8562
2312,金寶,68,42,26,新光-高雄,2023-08-04,8562
3092,鴻碩,36,10,26,新光-高雄,2023-08-04,8562
2206,三陽工業,61,38,23,新光-高雄,2023-08-04,8562
00773B,中信優先金融債,23,0,23,新光-高雄,2023-08-04,8562
00720B,元大投資級公司債,350,0,350,新光-高雄,2023-08-07,8562
00632R,元大台灣50反1,330,137,193,新光-高雄,2023-08-07,8562
2409,友達,239,71,168,新光-高雄,2023-08-07,8562
00680L,元大美債20正2,173,7,166,新光-高雄,2023-08-07,8562
00664R,國泰臺灣加權反1,160,0,160,新光-高雄,2023-08-07,8562
8064,東捷,155,0,155,新光-高雄,2023-08-07,8562
00637L,元大滬深300正2,197,49,148,新光-高雄,2023-08-07,8562
00673R,期元大S＆P原油反1,107,0,107,新光-高雄,2023-08-07,8562
4979,華星光,102,4,98,新光-高雄,2023-08-07,8562
2867,三商壽,78,0,78,新光-高雄,2023-08-07,8562
00751B,元大AAA至A公司債,76,0,76,新光-高雄,2023-08-07,8562
00687B,國泰20年美債,124,57,67,新光-高雄,2023-08-07,8562
00878,國泰永續高股息,212,151,61,新光-高雄,2023-08-07,8562
6235,華孚,97,37,60,新光-高雄,2023-08-07,8562
2504,國產,59,0,59,新光-高雄,2023-08-07,8562
00931B,統一美債20年,166,110,56,新光-高雄,2023-08-07,8562
2618,長榮航,139,85,54,新光-高雄,2023-08-07,8562
2605,新興,54,2,52,新光-高雄,2023-08-07,8562
4173,久裕,50,3,47,新光-高雄,2023-08-07,8562
1905,華紙,182,139,43,新光-高雄,2023-08-07,8562
6548,長科*,50,8,42,新光-高雄,2023-08-07,8562
1218,泰山,40,1,39,新光-高雄,2023-08-07,8562
5285,界霖,44,7,37,新光-高雄,2023-08-07,8562
00857B,永豐20年美公債,37,0,37,新光-高雄,2023-08-07,8562
3481,群創,50,14,36,新光-高雄,2023-08-07,8562
3689,湧德,63,27,36,新光-高雄,2023-08-07,8562
1786,科妍,35,0,35,新光-高雄,2023-08-07,8562
2344,華邦電,60,28,32,新光-高雄,2023-08-07,8562
2323,中環,43,11,32,新光-高雄,2023-08-07,8562
00795B,中信美國公債20年,44,12,32,新光-高雄,2023-08-07,8562
2610,華航,104,75,29,新光-高雄,2023-08-07,8562
00753L,中信中國50正2,43,15,28,新光-高雄,2023-08-07,8562
4906,正文,64,38,26,新光-高雄,2023-08-07,8562
8034,榮群,27,1,26,新光-高雄,2023-08-07,8562
1907,永豐餘,35,13,22,新光-高雄,2023-08-07,8562
2892,第一金,25,3,22,新光-高雄,2023-08-07,8562
2630,亞航,45,24,21,新光-高雄,2023-08-07,8562
9927,泰銘,47,27,20,新光-高雄,2023-08-07,8562
5009,榮剛,56,36,20,新光-高雄,2023-08-07,8562
4157,太景*-KY,20,0,20,新光-高雄,2023-08-07,8562
2903,遠百,20,0,20,新光-高雄,2023-08-07,8562
2812,台中銀,40,20,20,新光-高雄,2023-08-07,8562
2884,玉山金,22,3,19,新光-高雄,2023-08-07,8562
2303,聯電,29,10,19,新光-高雄,2023-08-07,8562
00706L,期元大S＆P日圓正2,19,0,19,新光-高雄,2023-08-07,8562
2897,王道銀行,21,2,19,新光-高雄,2023-08-07,8562
1618,合機,18,0,18,新光-高雄,2023-08-07,8562
6166,凌華,17,0,17,新光-高雄,2023-08-07,8562
4904,遠傳,19,2,17,新光-高雄,2023-08-07,8562
00633L,富邦上証正2,17,0,17,新光-高雄,2023-08-07,8562
00632R,元大台灣50反1,507,18,489,新光-高雄,2023-08-08,8562
00929,復華台灣科技優息,876,625,251,新光-高雄,2023-08-08,8562
2382,廣達,364,189,175,新光-高雄,2023-08-08,8562
00931B,統一美債20年,154,0,154,新光-高雄,2023-08-08,8562
00900,富邦特選高股息30,146,3,143,新光-高雄,2023-08-08,8562
2890,永豐金,149,24,125,新光-高雄,2023-08-08,8562
2356,英業達,300,187,113,新光-高雄,2023-08-08,8562
00923,群益台ESG低碳50,118,6,112,新光-高雄,2023-08-08,8562
1218,泰山,104,0,104,新光-高雄,2023-08-08,8562
5871,中租-KY,103,4,99,新光-高雄,2023-08-08,8562
6120,達運,90,0,90,新光-高雄,2023-08-08,8562
8064,東捷,90,0,90,新光-高雄,2023-08-08,8562
00706L,期元大S＆P日圓正2,84,0,84,新光-高雄,2023-08-08,8562
00673R,期元大S＆P原油反1,75,0,75,新光-高雄,2023-08-08,8562
3231,緯創,497,427,70,新光-高雄,2023-08-08,8562
00665L,富邦�琤肭磪囓�2,149,95,54,新光-高雄,2023-08-08,8562
8942,森鉅,54,2,52,新光-高雄,2023-08-08,8562
2344,華邦電,110,59,51,新光-高雄,2023-08-08,8562
4979,華星光,50,0,50,新光-高雄,2023-08-08,8562
2367,燿華,47,0,47,新光-高雄,2023-08-08,8562
00919,群益台灣精選高息,46,0,46,新光-高雄,2023-08-08,8562
2303,聯電,68,24,44,新光-高雄,2023-08-08,8562
9927,泰銘,44,4,40,新光-高雄,2023-08-08,8562
3706,神達,132,93,39,新光-高雄,2023-08-08,8562
2834,臺企銀,37,0,37,新光-高雄,2023-08-08,8562
2520,冠德,44,8,36,新光-高雄,2023-08-08,8562
5880,合庫金,37,2,35,新光-高雄,2023-08-08,8562
00679B,元大美債20年,50,15,35,新光-高雄,2023-08-08,8562
2891,中信金,38,4,34,新光-高雄,2023-08-08,8562
2316,楠梓電,63,34,29,新光-高雄,2023-08-08,8562
00882,中信中國高股息,41,12,29,新光-高雄,2023-08-08,8562
00680L,元大美債20正2,56,29,27,新光-高雄,2023-08-08,8562
00891,中信關鍵半導體,26,0,26,新光-高雄,2023-08-08,8562
3576,聯合再生,25,1,24,新光-高雄,2023-08-08,8562
4173,久裕,32,8,24,新光-高雄,2023-08-08,8562
00888,永豐台灣ESG,23,0,23,新光-高雄,2023-08-08,8562
2903,遠百,23,0,23,新光-高雄,2023-08-08,8562
1504,東元,34,12,22,新光-高雄,2023-08-08,8562
5243,乙盛-KY,22,0,22,新光-高雄,2023-08-08,8562
8926,台汽電,22,0,22,新光-高雄,2023-08-08,8562
00927,群益半導體收益,21,0,21,新光-高雄,2023-08-08,8562
6414,樺漢,23,2,21,新光-高雄,2023-08-08,8562
00631L,元大台灣50正2,25,4,21,新光-高雄,2023-08-08,8562
2867,三商壽,20,0,20,新光-高雄,2023-08-08,8562
6188,廣明,61,41,20,新光-高雄,2023-08-08,8562
020033,統一�琤肮黕篾,20,0,20,新光-高雄,2023-08-08,8562
3044,健鼎,56,36,20,新光-高雄,2023-08-08,8562
00907,永豐優息存股,19,0,19,新光-高雄,2023-08-08,8562
3491,昇達科,23,4,19,新光-高雄,2023-08-08,8562
1905,華紙,60,41,19,新光-高雄,2023-08-08,8562
00929,復華台灣科技優息,737,14,723,新光-高雄,2023-08-09,8562
2897,王道銀行,416,5,411,新光-高雄,2023-08-09,8562
4190,佐登-KY,138,3,135,新光-高雄,2023-08-09,8562
2017,官田鋼,101,0,101,新光-高雄,2023-08-09,8562
2890,永豐金,107,13,94,新光-高雄,2023-08-09,8562
00923,群益台ESG低碳50,88,3,85,新光-高雄,2023-08-09,8562
00720B,元大投資級公司債,104,25,79,新光-高雄,2023-08-09,8562
6191,精成科,76,3,73,新光-高雄,2023-08-09,8562
00900,富邦特選高股息30,73,1,72,新光-高雄,2023-08-09,8562
1218,泰山,70,0,70,新光-高雄,2023-08-09,8562
00687B,國泰20年美債,115,53,62,新光-高雄,2023-08-09,8562
3231,緯創,391,332,59,新光-高雄,2023-08-09,8562
2344,華邦電,138,84,54,新光-高雄,2023-08-09,8562
4979,華星光,52,1,51,新光-高雄,2023-08-09,8562
2885,元大金,61,12,49,新光-高雄,2023-08-09,8562
2002,中鋼,82,34,48,新光-高雄,2023-08-09,8562
4906,正文,153,105,48,新光-高雄,2023-08-09,8562
1532,勤美,47,0,47,新光-高雄,2023-08-09,8562
0056,元大高股息,72,32,40,新光-高雄,2023-08-09,8562
00907,永豐優息存股,34,0,34,新光-高雄,2023-08-09,8562
1616,億泰,30,2,28,新光-高雄,2023-08-09,8562
2316,楠梓電,48,22,26,新光-高雄,2023-08-09,8562
2855,統一證,25,0,25,新光-高雄,2023-08-09,8562
5469,瀚宇博,28,3,25,新光-高雄,2023-08-09,8562
2891,中信金,40,16,24,新光-高雄,2023-08-09,8562
2385,群光,27,3,24,新光-高雄,2023-08-09,8562
00665L,富邦�琤肭磪囓�2,88,64,24,新光-高雄,2023-08-09,8562
6112,邁達特,27,4,23,新光-高雄,2023-08-09,8562
2915,潤泰全,22,0,22,新光-高雄,2023-08-09,8562
3710,連展投控,22,0,22,新光-高雄,2023-08-09,8562
2543,皇昌,22,0,22,新光-高雄,2023-08-09,8562
3325,旭品,39,17,22,新光-高雄,2023-08-09,8562
00930,永豐ESG低碳高息,21,0,21,新光-高雄,2023-08-09,8562
6116,彩晶,21,1,20,新光-高雄,2023-08-09,8562
1210,大成,41,23,18,新光-高雄,2023-08-09,8562
2027,大成鋼,18,0,18,新光-高雄,2023-08-09,8562
2323,中環,22,4,18,新光-高雄,2023-08-09,8562
2882,國泰金,24,7,17,新光-高雄,2023-08-09,8562
2329,華泰,29,12,17,新光-高雄,2023-08-09,8562
1217,愛之味,26,9,17,新光-高雄,2023-08-09,8562
00751B,元大AAA至A公司債,16,0,16,新光-高雄,2023-08-09,8562
2834,臺企銀,20,4,16,新光-高雄,2023-08-09,8562
8155,博智,33,17,16,新光-高雄,2023-08-09,8562
2637,慧洋-KY,19,3,16,新光-高雄,2023-08-09,8562
9945,潤泰新,16,0,16,新光-高雄,2023-08-09,8562
1528,恩德,15,0,15,新光-高雄,2023-08-09,8562
6185,幃翔,19,4,15,新光-高雄,2023-08-09,8562
4173,久裕,22,7,15,新光-高雄,2023-08-09,8562
2867,三商壽,14,0,14,新光-高雄,2023-08-09,8562
00927,群益半導體收益,17,3,14,新光-高雄,2023-08-09,8562
00878,國泰永續高股息,620,337,283,新光-高雄,2023-08-10,8562
00929,復華台灣科技優息,353,75,278,新光-高雄,2023-08-10,8562
2883,凱基金,266,57,209,新光-高雄,2023-08-10,8562
00900,富邦特選高股息30,238,46,192,新光-高雄,2023-08-10,8562
00751B,元大AAA至A公司債,136,0,136,新光-高雄,2023-08-10,8562
00637L,元大滬深300正2,136,15,121,新光-高雄,2023-08-10,8562
00923,群益台ESG低碳50,114,0,114,新光-高雄,2023-08-10,8562
00919,群益台灣精選高息,112,0,112,新光-高雄,2023-08-10,8562
00706L,期元大S＆P日圓正2,97,5,92,新光-高雄,2023-08-10,8562
4938,和碩,85,10,75,新光-高雄,2023-08-10,8562
2352,佳世達,95,23,72,新光-高雄,2023-08-10,8562
00715L,期街口布蘭特正2,102,32,70,新光-高雄,2023-08-10,8562
2464,盟立,70,3,67,新光-高雄,2023-08-10,8562
2610,華航,271,206,65,新光-高雄,2023-08-10,8562
00655L,國泰中國A50正2,55,6,49,新光-高雄,2023-08-10,8562
00687B,國泰20年美債,71,23,48,新光-高雄,2023-08-10,8562
3673,TPK-KY,64,17,47,新光-高雄,2023-08-10,8562
2891,中信金,73,27,46,新光-高雄,2023-08-10,8562
2402,毅嘉,57,11,46,新光-高雄,2023-08-10,8562
2886,兆豐金,50,4,46,新光-高雄,2023-08-10,8562
2027,大成鋼,52,7,45,新光-高雄,2023-08-10,8562
6235,華孚,61,16,45,新光-高雄,2023-08-10,8562
00931B,統一美債20年,61,20,41,新光-高雄,2023-08-10,8562
5475,德宏,40,0,40,新光-高雄,2023-08-10,8562
2885,元大金,47,7,40,新光-高雄,2023-08-10,8562
006208,富邦台50,39,0,39,新光-高雄,2023-08-10,8562
00720B,元大投資級公司債,61,25,36,新光-高雄,2023-08-10,8562
8390,金益鼎,52,16,36,新光-高雄,2023-08-10,8562
4414,如興,38,2,36,新光-高雄,2023-08-10,8562
6116,彩晶,36,0,36,新光-高雄,2023-08-10,8562
2832,台產,35,0,35,新光-高雄,2023-08-10,8562
00712,復華富時不動產,37,4,33,新光-高雄,2023-08-10,8562
00773B,中信優先金融債,33,0,33,新光-高雄,2023-08-10,8562
2405,輔信,39,6,33,新光-高雄,2023-08-10,8562
9945,潤泰新,39,7,32,新光-高雄,2023-08-10,8562
2390,云辰,51,20,31,新光-高雄,2023-08-10,8562
2344,華邦電,138,107,31,新光-高雄,2023-08-10,8562
00850,元大臺灣ESG永續,31,1,30,新光-高雄,2023-08-10,8562
0050,元大台灣50,33,4,29,新光-高雄,2023-08-10,8562
2614,東森,35,6,29,新光-高雄,2023-08-10,8562
6191,精成科,62,33,29,新光-高雄,2023-08-10,8562
1522,堤維西,32,4,28,新光-高雄,2023-08-10,8562
2855,統一證,32,4,28,新光-高雄,2023-08-10,8562
2867,三商壽,28,0,28,新光-高雄,2023-08-10,8562
00669R,國泰美國道瓊反1,27,0,27,新光-高雄,2023-08-10,8562
2409,友達,71,45,26,新光-高雄,2023-08-10,8562
2324,仁寶,29,3,26,新光-高雄,2023-08-10,8562
00753L,中信中國50正2,26,0,26,新光-高雄,2023-08-10,8562
1609,大亞,45,21,24,新光-高雄,2023-08-10,8562
2303,聯電,30,7,23,新光-高雄,2023-08-10,8562
00931B,統一美債20年,347,15,332,新光-高雄,2023-08-11,8562
00680L,元大美債20正2,317,0,317,新光-高雄,2023-08-11,8562
2606,裕民,278,0,278,新光-高雄,2023-08-11,8562
00900,富邦特選高股息30,141,1,140,新光-高雄,2023-08-11,8562
2888,新光金,125,1,124,新光-高雄,2023-08-11,8562
00929,復華台灣科技優息,168,53,115,新光-高雄,2023-08-11,8562
2892,第一金,108,3,105,新光-高雄,2023-08-11,8562
3231,緯創,320,233,87,新光-高雄,2023-08-11,8562
00637L,元大滬深300正2,258,173,85,新光-高雄,2023-08-11,8562
00878,國泰永續高股息,140,60,80,新光-高雄,2023-08-11,8562
00673R,期元大S＆P原油反1,72,0,72,新光-高雄,2023-08-11,8562
00751B,元大AAA至A公司債,67,0,67,新光-高雄,2023-08-11,8562
00687B,國泰20年美債,86,20,66,新光-高雄,2023-08-11,8562
00773B,中信優先金融債,65,0,65,新光-高雄,2023-08-11,8562
2618,長榮航,215,155,60,新光-高雄,2023-08-11,8562
00795B,中信美國公債20年,60,0,60,新光-高雄,2023-08-11,8562
2885,元大金,59,1,58,新光-高雄,2023-08-11,8562
00772B,中信高評級公司債,57,0,57,新光-高雄,2023-08-11,8562
00679B,元大美債20年,71,18,53,新光-高雄,2023-08-11,8562
2820,華票,50,0,50,新光-高雄,2023-08-11,8562
6216,居易,50,0,50,新光-高雄,2023-08-11,8562
2376,技嘉,103,62,41,新光-高雄,2023-08-11,8562
2409,友達,58,17,41,新光-高雄,2023-08-11,8562
2801,彰銀,40,0,40,新光-高雄,2023-08-11,8562
4414,如興,43,5,38,新光-高雄,2023-08-11,8562
2002,中鋼,41,4,37,新光-高雄,2023-08-11,8562
1532,勤美,38,1,37,新光-高雄,2023-08-11,8562
2457,飛宏,50,17,33,新光-高雄,2023-08-11,8562
6024,群益期,32,0,32,新光-高雄,2023-08-11,8562
2538,基泰,35,5,30,新光-高雄,2023-08-11,8562
00671R,富邦NASDAQ反1,30,0,30,新光-高雄,2023-08-11,8562
00923,群益台ESG低碳50,49,21,28,新光-高雄,2023-08-11,8562
2614,東森,32,4,28,新光-高雄,2023-08-11,8562
2317,鴻海,120,92,28,新光-高雄,2023-08-11,8562
1101,台泥,30,5,25,新光-高雄,2023-08-11,8562
00720B,元大投資級公司債,48,23,25,新光-高雄,2023-08-11,8562
8112A,至上甲特,24,0,24,新光-高雄,2023-08-11,8562
3567,逸昌,27,3,24,新光-高雄,2023-08-11,8562
3483,力致,40,16,24,新光-高雄,2023-08-11,8562
2027,大成鋼,29,5,24,新光-高雄,2023-08-11,8562
2014,中鴻,26,3,23,新光-高雄,2023-08-11,8562
4938,和碩,31,8,23,新光-高雄,2023-08-11,8562
2883,凱基金,32,10,22,新光-高雄,2023-08-11,8562
2913,農林,36,14,22,新光-高雄,2023-08-11,8562
3526,凡甲,22,0,22,新光-高雄,2023-08-11,8562
1471,首利,23,2,21,新光-高雄,2023-08-11,8562
0050,元大台灣50,23,2,21,新光-高雄,2023-08-11,8562
3694,海華,21,0,21,新光-高雄,2023-08-11,8562
3591,艾笛森,27,6,21,新光-高雄,2023-08-11,8562
5511,德昌,23,3,20,新光-高雄,2023-08-11,8562
00929,復華台灣科技優息,1367,18,1349,新光-高雄,2023-08-14,8562
00878,國泰永續高股息,418,135,283,新光-高雄,2023-08-14,8562
00900,富邦特選高股息30,315,53,262,新光-高雄,2023-08-14,8562
2834,臺企銀,173,0,173,新光-高雄,2023-08-14,8562
2888,新光金,211,38,173,新光-高雄,2023-08-14,8562
00923,群益台ESG低碳50,160,20,140,新光-高雄,2023-08-14,8562
2832,台產,126,0,126,新光-高雄,2023-08-14,8562
2867,三商壽,125,9,116,新光-高雄,2023-08-14,8562
2610,華航,166,54,112,新光-高雄,2023-08-14,8562
00673R,期元大S＆P原油反1,150,46,104,新光-高雄,2023-08-14,8562
00919,群益台灣精選高息,88,2,86,新光-高雄,2023-08-14,8562
0050,元大台灣50,81,1,80,新光-高雄,2023-08-14,8562
00680L,元大美債20正2,74,2,72,新光-高雄,2023-08-14,8562
1447,力鵬,69,0,69,新光-高雄,2023-08-14,8562
00637L,元大滬深300正2,289,224,65,新光-高雄,2023-08-14,8562
3481,群創,70,8,62,新光-高雄,2023-08-14,8562
3231,緯創,460,400,60,新光-高雄,2023-08-14,8562
1312,國喬,89,34,55,新光-高雄,2023-08-14,8562
00888,永豐台灣ESG,60,6,54,新光-高雄,2023-08-14,8562
2547,日勝生,50,0,50,新光-高雄,2023-08-14,8562
1301,台塑,52,2,50,新光-高雄,2023-08-14,8562
2845,遠東銀,50,2,48,新光-高雄,2023-08-14,8562
5258,虹堡,70,23,47,新光-高雄,2023-08-14,8562
2344,華邦電,236,190,46,新光-高雄,2023-08-14,8562
00753L,中信中國50正2,49,3,46,新光-高雄,2023-08-14,8562
00665L,富邦�琤肭磪囓�2,85,41,44,新光-高雄,2023-08-14,8562
00675L,富邦臺灣加權正2,44,1,43,新光-高雄,2023-08-14,8562
00633L,富邦上証正2,44,4,40,新光-高雄,2023-08-14,8562
006208,富邦台50,41,1,40,新光-高雄,2023-08-14,8562
1101,台泥,41,2,39,新光-高雄,2023-08-14,8562
00795B,中信美國公債20年,38,0,38,新光-高雄,2023-08-14,8562
2618,長榮航,83,46,37,新光-高雄,2023-08-14,8562
5515,建國,35,0,35,新光-高雄,2023-08-14,8562
2892,第一金,44,9,35,新光-高雄,2023-08-14,8562
00931B,統一美債20年,39,5,34,新光-高雄,2023-08-14,8562
3062,建漢,46,13,33,新光-高雄,2023-08-14,8562
3706,神達,60,28,32,新光-高雄,2023-08-14,8562
6770,力積電,38,6,32,新光-高雄,2023-08-14,8562
2352,佳世達,40,9,31,新光-高雄,2023-08-14,8562
00764B,群益25年美債,31,0,31,新光-高雄,2023-08-14,8562
2390,云辰,31,0,31,新光-高雄,2023-08-14,8562
00907,永豐優息存股,31,0,31,新光-高雄,2023-08-14,8562
4162,智擎,30,1,29,新光-高雄,2023-08-14,8562
2603,長榮,41,12,29,新光-高雄,2023-08-14,8562
3188,鑫龍騰,31,2,29,新光-高雄,2023-08-14,8562
2609,陽明,47,18,29,新光-高雄,2023-08-14,8562
3628,盈正,26,0,26,新光-高雄,2023-08-14,8562
2504,國產,30,4,26,新光-高雄,2023-08-14,8562
2002,中鋼,25,1,24,新光-高雄,2023-08-14,8562
1605,華新,111,87,24,新光-高雄,2023-08-14,8562
00900,富邦特選高股息30,353,26,327,新光-高雄,2023-08-15,8562
00923,群益台ESG低碳50,163,34,129,新光-高雄,2023-08-15,8562
00878,國泰永續高股息,344,240,104,新光-高雄,2023-08-15,8562
8358,金居,103,20,83,新光-高雄,2023-08-15,8562
00679B,元大美債20年,96,19,77,新光-高雄,2023-08-15,8562
5469,瀚宇博,90,14,76,新光-高雄,2023-08-15,8562
2317,鴻海,125,50,75,新光-高雄,2023-08-15,8562
2353,宏��,94,28,66,新光-高雄,2023-08-15,8562
00931B,統一美債20年,62,0,62,新光-高雄,2023-08-15,8562
2002,中鋼,61,2,59,新光-高雄,2023-08-15,8562
6024,群益期,58,1,57,新光-高雄,2023-08-15,8562
00712,復華富時不動產,105,49,56,新光-高雄,2023-08-15,8562
2913,農林,58,3,55,新光-高雄,2023-08-15,8562
2601,益航,50,0,50,新光-高雄,2023-08-15,8562
00764B,群益25年美債,44,0,44,新光-高雄,2023-08-15,8562
2356,英業達,144,101,43,新光-高雄,2023-08-15,8562
2834,臺企銀,76,34,42,新光-高雄,2023-08-15,8562
00671R,富邦NASDAQ反1,41,0,41,新光-高雄,2023-08-15,8562
1101,台泥,41,1,40,新光-高雄,2023-08-15,8562
6167,久正,47,8,39,新光-高雄,2023-08-15,8562
3078,僑威,142,106,36,新光-高雄,2023-08-15,8562
3231,緯創,304,269,35,新光-高雄,2023-08-15,8562
2812,台中銀,43,8,35,新光-高雄,2023-08-15,8562
00907,永豐優息存股,34,0,34,新光-高雄,2023-08-15,8562
00795B,中信美國公債20年,31,0,31,新光-高雄,2023-08-15,8562
2883,凱基金,41,11,30,新光-高雄,2023-08-15,8562
3035,智原,55,27,28,新光-高雄,2023-08-15,8562
1102,亞泥,28,1,27,新光-高雄,2023-08-15,8562
00850,元大臺灣ESG永續,28,1,27,新光-高雄,2023-08-15,8562
3416,融程電,27,0,27,新光-高雄,2023-08-15,8562
00673R,期元大S＆P原油反1,26,0,26,新光-高雄,2023-08-15,8562
2892,第一金,43,17,26,新光-高雄,2023-08-15,8562
2374,佳能,50,25,25,新光-高雄,2023-08-15,8562
1301,台塑,24,0,24,新光-高雄,2023-08-15,8562
00648R,元大S＆P500反1,24,0,24,新光-高雄,2023-08-15,8562
2832,台產,24,0,24,新光-高雄,2023-08-15,8562
00772B,中信高評級公司債,24,0,24,新光-高雄,2023-08-15,8562
1707,葡萄王,22,0,22,新光-高雄,2023-08-15,8562
2330,台積電,28,6,22,新光-高雄,2023-08-15,8562
5488,松普,21,0,21,新光-高雄,2023-08-15,8562
00905,FT臺灣Smart,21,0,21,新光-高雄,2023-08-15,8562
00882,中信中國高股息,37,16,21,新光-高雄,2023-08-15,8562
1210,大成,23,3,20,新光-高雄,2023-08-15,8562
6163,華電網,20,0,20,新光-高雄,2023-08-15,8562
2603,長榮,20,1,19,新光-高雄,2023-08-15,8562
1308,亞聚,20,2,18,新光-高雄,2023-08-15,8562
4950,牧東,18,0,18,新光-高雄,2023-08-15,8562
00669R,國泰美國道瓊反1,28,10,18,新光-高雄,2023-08-15,8562
8093,保銳,18,0,18,新光-高雄,2023-08-15,8562
2887,台新金,19,1,18,新光-高雄,2023-08-15,8562
00878,國泰永續高股息,1776,153,1623,新光-高雄,2023-08-16,8562
00680L,元大美債20正2,1101,69,1032,新光-高雄,2023-08-16,8562
00929,復華台灣科技優息,710,63,647,新光-高雄,2023-08-16,8562
9103,美德醫療-DR,1130,701,429,新光-高雄,2023-08-16,8562
00900,富邦特選高股息30,449,26,423,新光-高雄,2023-08-16,8562
00715L,期街口布蘭特正2,404,154,250,新光-高雄,2023-08-16,8562
00923,群益台ESG低碳50,217,2,215,新光-高雄,2023-08-16,8562
00712,復華富時不動產,279,105,174,新光-高雄,2023-08-16,8562
1101,台泥,136,4,132,新光-高雄,2023-08-16,8562
2303,聯電,157,35,122,新光-高雄,2023-08-16,8562
2834,臺企銀,175,57,118,新光-高雄,2023-08-16,8562
2317,鴻海,104,6,98,新光-高雄,2023-08-16,8562
2610,華航,170,88,82,新光-高雄,2023-08-16,8562
2618,長榮航,126,50,76,新光-高雄,2023-08-16,8562
3706,神達,123,48,75,新光-高雄,2023-08-16,8562
2891,中信金,101,27,74,新光-高雄,2023-08-16,8562
8358,金居,169,96,73,新光-高雄,2023-08-16,8562
00772B,中信高評級公司債,65,0,65,新光-高雄,2023-08-16,8562
00688L,國泰20年美債正2,73,10,63,新光-高雄,2023-08-16,8562
00720B,元大投資級公司債,79,16,63,新光-高雄,2023-08-16,8562
00669R,國泰美國道瓊反1,67,5,62,新光-高雄,2023-08-16,8562
2886,兆豐金,66,7,59,新光-高雄,2023-08-16,8562
1402,遠東新,55,1,54,新光-高雄,2023-08-16,8562
2376,技嘉,81,30,51,新光-高雄,2023-08-16,8562
00687B,國泰20年美債,50,2,48,新光-高雄,2023-08-16,8562
2884,玉山金,56,9,47,新光-高雄,2023-08-16,8562
2867,三商壽,50,5,45,新光-高雄,2023-08-16,8562
6167,久正,45,0,45,新光-高雄,2023-08-16,8562
2603,長榮,49,5,44,新光-高雄,2023-08-16,8562
2609,陽明,52,8,44,新光-高雄,2023-08-16,8562
2002,中鋼,92,49,43,新光-高雄,2023-08-16,8562
3481,群創,66,24,42,新光-高雄,2023-08-16,8562
00764B,群益25年美債,40,0,40,新光-高雄,2023-08-16,8562
00891,中信關鍵半導體,45,6,39,新光-高雄,2023-08-16,8562
2883,凱基金,90,52,38,新光-高雄,2023-08-16,8562
6799,來頡,45,7,38,新光-高雄,2023-08-16,8562
00751B,元大AAA至A公司債,38,0,38,新光-高雄,2023-08-16,8562
2324,仁寶,215,179,36,新光-高雄,2023-08-16,8562
0050,元大台灣50,38,5,33,新光-高雄,2023-08-16,8562
00679B,元大美債20年,37,4,33,新光-高雄,2023-08-16,8562
2890,永豐金,36,5,31,新光-高雄,2023-08-16,8562
2887,台新金,52,22,30,新光-高雄,2023-08-16,8562
2820,華票,30,0,30,新光-高雄,2023-08-16,8562
2801,彰銀,28,0,28,新光-高雄,2023-08-16,8562
1471,首利,36,8,28,新光-高雄,2023-08-16,8562
2460,建通,80,53,27,新光-高雄,2023-08-16,8562
8048,德勝,28,1,27,新光-高雄,2023-08-16,8562
1609,大亞,38,12,26,新光-高雄,2023-08-16,8562
00850,元大臺灣ESG永續,30,5,25,新光-高雄,2023-08-16,8562
1802,台玻,64,39,25,新光-高雄,2023-08-16,8562
00929,復華台灣科技優息,1115,46,1069,新光-高雄,2023-08-17,8562
00680L,元大美債20正2,878,308,570,新光-高雄,2023-08-17,8562
00715L,期街口布蘭特正2,512,148,364,新光-高雄,2023-08-17,8562
2606,裕民,273,8,265,新光-高雄,2023-08-17,8562
1301,台塑,209,31,178,新光-高雄,2023-08-17,8562
00632R,元大台灣50反1,481,368,113,新光-高雄,2023-08-17,8562
00751B,元大AAA至A公司債,95,0,95,新光-高雄,2023-08-17,8562
3231,緯創,477,388,89,新光-高雄,2023-08-17,8562
00687B,國泰20年美債,108,30,78,新光-高雄,2023-08-17,8562
00773B,中信優先金融債,76,0,76,新光-高雄,2023-08-17,8562
2402,毅嘉,199,136,63,新光-高雄,2023-08-17,8562
00795B,中信美國公債20年,56,0,56,新光-高雄,2023-08-17,8562
00720B,元大投資級公司債,58,5,53,新光-高雄,2023-08-17,8562
00882,中信中國高股息,55,2,53,新光-高雄,2023-08-17,8562
3042,晶技,86,34,52,新光-高雄,2023-08-17,8562
00931B,統一美債20年,115,64,51,新光-高雄,2023-08-17,8562
2547,日勝生,50,0,50,新光-高雄,2023-08-17,8562
00664R,國泰臺灣加權反1,50,0,50,新光-高雄,2023-08-17,8562
2880,華南金,47,0,47,新光-高雄,2023-08-17,8562
2885,元大金,49,2,47,新光-高雄,2023-08-17,8562
00712,復華富時不動產,91,45,46,新光-高雄,2023-08-17,8562
2382,廣達,254,208,46,新光-高雄,2023-08-17,8562
00772B,中信高評級公司債,60,15,45,新光-高雄,2023-08-17,8562
1101,台泥,50,7,43,新光-高雄,2023-08-17,8562
2891,中信金,48,5,43,新光-高雄,2023-08-17,8562
2820,華票,40,0,40,新光-高雄,2023-08-17,8562
2727,王品,39,0,39,新光-高雄,2023-08-17,8562
3056,富華新,52,13,39,新光-高雄,2023-08-17,8562
5469,瀚宇博,47,11,36,新光-高雄,2023-08-17,8562
2356,英業達,156,120,36,新光-高雄,2023-08-17,8562
1609,大亞,59,24,35,新光-高雄,2023-08-17,8562
2412,中華電,37,4,33,新光-高雄,2023-08-17,8562
2618,長榮航,76,45,31,新光-高雄,2023-08-17,8562
4707,磐亞,31,0,31,新光-高雄,2023-08-17,8562
2886,兆豐金,35,5,30,新光-高雄,2023-08-17,8562
1326,台化,28,2,26,新光-高雄,2023-08-17,8562
2884,玉山金,44,21,23,新光-高雄,2023-08-17,8562
9945,潤泰新,27,4,23,新光-高雄,2023-08-17,8562
9934,成霖,27,4,23,新光-高雄,2023-08-17,8562
2892,第一金,23,0,23,新光-高雄,2023-08-17,8562
2888,新光金,61,39,22,新光-高雄,2023-08-17,8562
2354,鴻準,21,0,21,新光-高雄,2023-08-17,8562
9919,康那香,32,11,21,新光-高雄,2023-08-17,8562
2883,凱基金,71,51,20,新光-高雄,2023-08-17,8562
00900,富邦特選高股息30,33,15,18,新光-高雄,2023-08-17,8562
5871,中租-KY,24,7,17,新光-高雄,2023-08-17,8562
2915,潤泰全,17,2,15,新光-高雄,2023-08-17,8562
006208,富邦台50,16,1,15,新光-高雄,2023-08-17,8562
4129,聯合,15,0,15,新光-高雄,2023-08-17,8562
2421,建準,175,161,14,新光-高雄,2023-08-17,8562
00929,復華台灣科技優息,643,221,422,新光-高雄,2023-08-18,8562
2888,新光金,278,2,276,新光-高雄,2023-08-18,8562
2618,長榮航,278,116,162,新光-高雄,2023-08-18,8562
00878,國泰永續高股息,307,165,142,新光-高雄,2023-08-18,8562
00885,富邦越南,157,22,135,新光-高雄,2023-08-18,8562
2363,矽統,345,210,135,新光-高雄,2023-08-18,8562
2832,台產,127,0,127,新光-高雄,2023-08-18,8562
3231,緯創,558,433,125,新光-高雄,2023-08-18,8562
2515,中工,82,0,82,新光-高雄,2023-08-18,8562
2610,華航,216,148,68,新光-高雄,2023-08-18,8562
2883,凱基金,67,6,61,新光-高雄,2023-08-18,8562
2324,仁寶,278,218,60,新光-高雄,2023-08-18,8562
00923,群益台ESG低碳50,82,23,59,新光-高雄,2023-08-18,8562
1101,台泥,61,6,55,新光-高雄,2023-08-18,8562
2890,永豐金,53,3,50,新光-高雄,2023-08-18,8562
00664R,國泰臺灣加權反1,55,5,50,新光-高雄,2023-08-18,8562
3515,華擎,71,23,48,新光-高雄,2023-08-18,8562
2382,廣達,241,200,41,新光-高雄,2023-08-18,8562
00919,群益台灣精選高息,49,10,39,新光-高雄,2023-08-18,8562
00850,元大臺灣ESG永續,50,12,38,新光-高雄,2023-08-18,8562
2303,聯電,51,14,37,新光-高雄,2023-08-18,8562
6470,宇智,36,0,36,新光-高雄,2023-08-18,8562
00900,富邦特選高股息30,47,13,34,新光-高雄,2023-08-18,8562
2880,華南金,34,1,33,新光-高雄,2023-08-18,8562
3078,僑威,64,33,31,新光-高雄,2023-08-18,8562
3105,穩懋,37,6,31,新光-高雄,2023-08-18,8562
2356,英業達,158,127,31,新光-高雄,2023-08-18,8562
2739,寒舍,30,0,30,新光-高雄,2023-08-18,8562
00720B,元大投資級公司債,33,4,29,新光-高雄,2023-08-18,8562
2393,億光,30,1,29,新光-高雄,2023-08-18,8562
2317,鴻海,42,14,28,新光-高雄,2023-08-18,8562
6274,台燿,65,37,28,新光-高雄,2023-08-18,8562
00931B,統一美債20年,36,10,26,新光-高雄,2023-08-18,8562
2884,玉山金,35,9,26,新光-高雄,2023-08-18,8562
2313,華通,25,0,25,新光-高雄,2023-08-18,8562
3305,昇貿,26,2,24,新光-高雄,2023-08-18,8562
2353,宏��,49,25,24,新光-高雄,2023-08-18,8562
2301,光寶科,85,61,24,新光-高雄,2023-08-18,8562
6488,環球晶,25,2,23,新光-高雄,2023-08-18,8562
3056,富華新,46,23,23,新光-高雄,2023-08-18,8562
2409,友達,49,26,23,新光-高雄,2023-08-18,8562
4763,材料-KY,29,7,22,新光-高雄,2023-08-18,8562
2812,台中銀,62,40,22,新光-高雄,2023-08-18,8562
3689,湧德,50,28,22,新光-高雄,2023-08-18,8562
0056,元大高股息,99,77,22,新光-高雄,2023-08-18,8562
00753L,中信中國50正2,58,36,22,新光-高雄,2023-08-18,8562
2352,佳世達,33,11,22,新光-高雄,2023-08-18,8562
2845,遠東銀,21,0,21,新光-高雄,2023-08-18,8562
2399,映泰,38,17,21,新光-高雄,2023-08-18,8562
00715L,期街口布蘭特正2,160,139,21,新光-高雄,2023-08-18,8562
00637L,元大滬深300正2,463,163,300,新光-高雄,2023-08-21,8562
2515,中工,178,0,178,新光-高雄,2023-08-21,8562
2832,台產,164,0,164,新光-高雄,2023-08-21,8562
2609,陽明,99,11,88,新光-高雄,2023-08-21,8562
4930,燦星網,78,0,78,新光-高雄,2023-08-21,8562
00751B,元大AAA至A公司債,70,0,70,新光-高雄,2023-08-21,8562
00688L,國泰20年美債正2,65,0,65,新光-高雄,2023-08-21,8562
00687B,國泰20年美債,61,4,57,新光-高雄,2023-08-21,8562
2606,裕民,103,47,56,新光-高雄,2023-08-21,8562
2897,王道銀行,59,5,54,新光-高雄,2023-08-21,8562
1802,台玻,54,5,49,新光-高雄,2023-08-21,8562
2812,台中銀,107,61,46,新光-高雄,2023-08-21,8562
00753L,中信中國50正2,47,0,47,新光-高雄,2023-08-21,8562
00715L,期街口布蘭特正2,61,15,46,新光-高雄,2023-08-21,8562
2603,長榮,63,17,46,新光-高雄,2023-08-21,8562
00772B,中信高評級公司債,46,2,44,新光-高雄,2023-08-21,8562
2834,臺企銀,41,0,41,新光-高雄,2023-08-21,8562
4906,正文,288,247,41,新光-高雄,2023-08-21,8562
2890,永豐金,39,0,39,新光-高雄,2023-08-21,8562
2402,毅嘉,53,14,39,新光-高雄,2023-08-21,8562
2412,中華電,37,0,37,新光-高雄,2023-08-21,8562
2382,廣達,137,100,37,新光-高雄,2023-08-21,8562
2301,光寶科,102,66,36,新光-高雄,2023-08-21,8562
2368,金像電,46,13,33,新光-高雄,2023-08-21,8562
5009,榮剛,50,19,31,新光-高雄,2023-08-21,8562
2329,華泰,133,103,30,新光-高雄,2023-08-21,8562
1722,台肥,30,0,30,新光-高雄,2023-08-21,8562
00773B,中信優先金融債,37,8,29,新光-高雄,2023-08-21,8562
00752,中信中國50,40,12,28,新光-高雄,2023-08-21,8562
00931B,統一美債20年,99,71,28,新光-高雄,2023-08-21,8562
9907,統一實,27,1,26,新光-高雄,2023-08-21,8562
2303,聯電,26,0,26,新光-高雄,2023-08-21,8562
00923,群益台ESG低碳50,24,0,24,新光-高雄,2023-08-21,8562
3056,富華新,29,6,23,新光-高雄,2023-08-21,8562
2618,長榮航,36,14,22,新光-高雄,2023-08-21,8562
0050,元大台灣50,21,2,19,新光-高雄,2023-08-21,8562
5608,四維航,95,76,19,新光-高雄,2023-08-21,8562
00795B,中信美國公債20年,21,3,18,新光-高雄,2023-08-21,8562
8936,國統,18,1,17,新光-高雄,2023-08-21,8562
3338,泰碩,18,1,17,新光-高雄,2023-08-21,8562
2888,新光金,24,7,17,新光-高雄,2023-08-21,8562
9904,寶成,16,0,16,新光-高雄,2023-08-21,8562
4919,新唐,17,1,16,新光-高雄,2023-08-21,8562
2610,華航,41,25,16,新光-高雄,2023-08-21,8562
5388,中磊,33,18,15,新光-高雄,2023-08-21,8562
1605,華新,19,4,15,新光-高雄,2023-08-21,8562
00636,國泰中國A50,15,0,15,新光-高雄,2023-08-21,8562
2014,中鴻,16,1,15,新光-高雄,2023-08-21,8562
1504,東元,31,17,14,新光-高雄,2023-08-21,8562
6176,瑞儀,20,6,14,新光-高雄,2023-08-21,8562
00715L,期街口布蘭特正2,523,28,495,新光-高雄,2023-08-22,8562
00637L,元大滬深300正2,381,125,256,新光-高雄,2023-08-22,8562
00632R,元大台灣50反1,196,39,157,新光-高雄,2023-08-22,8562
2324,仁寶,228,90,138,新光-高雄,2023-08-22,8562
2891,中信金,115,3,112,新光-高雄,2023-08-22,8562
00680L,元大美債20正2,117,9,108,新光-高雄,2023-08-22,8562
00712,復華富時不動產,112,5,107,新光-高雄,2023-08-22,8562
2883B,凱基金乙特,108,5,103,新光-高雄,2023-08-22,8562
2888,新光金,105,5,100,新光-高雄,2023-08-22,8562
3044,健鼎,114,16,98,新光-高雄,2023-08-22,8562
2834,臺企銀,101,9,92,新光-高雄,2023-08-22,8562
00929,復華台灣科技優息,215,131,84,新光-高雄,2023-08-22,8562
00773B,中信優先金融債,64,0,64,新光-高雄,2023-08-22,8562
2832,台產,60,0,60,新光-高雄,2023-08-22,8562
00673R,期元大S＆P原油反1,100,42,58,新光-高雄,2023-08-22,8562
2402,毅嘉,61,3,58,新光-高雄,2023-08-22,8562
2421,建準,163,107,56,新光-高雄,2023-08-22,8562
2357,華碩,63,7,56,新光-高雄,2023-08-22,8562
2002,中鋼,57,2,55,新光-高雄,2023-08-22,8562
00720B,元大投資級公司債,46,2,44,新光-高雄,2023-08-22,8562
00885,富邦越南,70,28,42,新光-高雄,2023-08-22,8562
2356,英業達,105,65,40,新光-高雄,2023-08-22,8562
4938,和碩,43,4,39,新光-高雄,2023-08-22,8562
2363,矽統,449,412,37,新光-高雄,2023-08-22,8562
6125,廣運,184,148,36,新光-高雄,2023-08-22,8562
1316,上曜,31,0,31,新光-高雄,2023-08-22,8562
1707,葡萄王,30,0,30,新光-高雄,2023-08-22,8562
00830,國泰費城半導體,30,0,30,新光-高雄,2023-08-22,8562
2884,玉山金,28,1,27,新光-高雄,2023-08-22,8562
1312,國喬,26,0,26,新光-高雄,2023-08-22,8562
5465,富驊,27,1,26,新光-高雄,2023-08-22,8562
6005,群益證,32,7,25,新光-高雄,2023-08-22,8562
6167,久正,28,3,25,新光-高雄,2023-08-22,8562
2382,廣達,192,168,24,新光-高雄,2023-08-22,8562
00633L,富邦上証正2,52,27,25,新光-高雄,2023-08-22,8562
2883,凱基金,26,2,24,新光-高雄,2023-08-22,8562
00900,富邦特選高股息30,25,1,24,新光-高雄,2023-08-22,8562
00907,永豐優息存股,24,0,24,新光-高雄,2023-08-22,8562
00902,中信電池及儲能,25,3,22,新光-高雄,2023-08-22,8562
1609,大亞,26,4,22,新光-高雄,2023-08-22,8562
5880,合庫金,22,1,21,新光-高雄,2023-08-22,8562
1101,台泥,34,13,21,新光-高雄,2023-08-22,8562
3576,聯合再生,21,0,21,新光-高雄,2023-08-22,8562
1722,台肥,21,0,21,新光-高雄,2023-08-22,8562
00753L,中信中國50正2,21,0,21,新光-高雄,2023-08-22,8562
2547,日勝生,21,0,21,新光-高雄,2023-08-22,8562
2812,台中銀,40,21,19,新光-高雄,2023-08-22,8562
2881,富邦金,25,7,18,新光-高雄,2023-08-22,8562
4906,正文,72,54,18,新光-高雄,2023-08-22,8562
2886,兆豐金,18,1,17,新光-高雄,2023-08-22,8562
00632R,元大台灣50反1,386,1,385,新光-高雄,2023-08-23,8562
00923,群益台ESG低碳50,261,18,243,新光-高雄,2023-08-23,8562
2618,長榮航,293,106,187,新光-高雄,2023-08-23,8562
00715L,期街口布蘭特正2,110,0,110,新光-高雄,2023-08-23,8562
00773B,中信優先金融債,96,0,96,新光-高雄,2023-08-23,8562
00664R,國泰臺灣加權反1,100,5,95,新光-高雄,2023-08-23,8562
00931B,統一美債20年,70,2,68,新光-高雄,2023-08-23,8562
2538,基泰,60,14,46,新光-高雄,2023-08-23,8562
2002,中鋼,42,0,42,新光-高雄,2023-08-23,8562
2609,陽明,46,4,42,新光-高雄,2023-08-23,8562
3013,晟銘電,383,343,40,新光-高雄,2023-08-23,8562
3051,力特,112,72,40,新光-高雄,2023-08-23,8562
2888,新光金,39,0,39,新光-高雄,2023-08-23,8562
3071,協禧,99,65,34,新光-高雄,2023-08-23,8562
3701,大眾控,33,0,33,新光-高雄,2023-08-23,8562
00671R,富邦NASDAQ反1,29,0,29,新光-高雄,2023-08-23,8562
00751B,元大AAA至A公司債,33,5,28,新光-高雄,2023-08-23,8562
00712,復華富時不動產,35,8,27,新光-高雄,2023-08-23,8562
2812,台中銀,58,32,26,新光-高雄,2023-08-23,8562
5426,振發,25,0,25,新光-高雄,2023-08-23,8562
2634,漢翔,150,126,24,新光-高雄,2023-08-23,8562
00680L,元大美債20正2,23,0,23,新光-高雄,2023-08-23,8562
2014,中鴻,23,1,22,新光-高雄,2023-08-23,8562
2421,建準,62,41,21,新光-高雄,2023-08-23,8562
6282,康舒,40,19,21,新光-高雄,2023-08-23,8562
2884,玉山金,26,6,20,新光-高雄,2023-08-23,8562
00795B,中信美國公債20年,19,0,19,新光-高雄,2023-08-23,8562
00673R,期元大S＆P原油反1,50,31,19,新光-高雄,2023-08-23,8562
2409,友達,19,0,19,新光-高雄,2023-08-23,8562
2883B,凱基金乙特,18,0,18,新光-高雄,2023-08-23,8562
4979,華星光,54,36,18,新光-高雄,2023-08-23,8562
00919,群益台灣精選高息,19,2,17,新光-高雄,2023-08-23,8562
4167,松瑞藥,19,2,17,新光-高雄,2023-08-23,8562
5009,榮剛,30,14,16,新光-高雄,2023-08-23,8562
1301,台塑,15,0,15,新光-高雄,2023-08-23,8562
2317,鴻海,22,7,15,新光-高雄,2023-08-23,8562
2891,中信金,20,5,15,新光-高雄,2023-08-23,8562
5203,訊連,16,1,15,新光-高雄,2023-08-23,8562
4707,磐亞,22,7,15,新光-高雄,2023-08-23,8562
2882,國泰金,17,3,14,新光-高雄,2023-08-23,8562
1316,上曜,14,0,14,新光-高雄,2023-08-23,8562
3163,波若威,115,102,13,新光-高雄,2023-08-23,8562
6227,茂綸,13,0,13,新光-高雄,2023-08-23,8562
3042,晶技,17,4,13,新光-高雄,2023-08-23,8562
00631L,元大台灣50正2,17,5,12,新光-高雄,2023-08-23,8562
2739,寒舍,12,0,12,新光-高雄,2023-08-23,8562
3483,力致,71,60,11,新光-高雄,2023-08-23,8562
2880,華南金,11,0,11,新光-高雄,2023-08-23,8562
9904,寶成,10,0,10,新光-高雄,2023-08-23,8562
1444,力麗,10,0,10,新光-高雄,2023-08-23,8562
00919,群益台灣精選高息,613,84,529,新光-高雄,2023-08-24,8562
2881,富邦金,464,3,461,新光-高雄,2023-08-24,8562
3231,緯創,801,542,259,新光-高雄,2023-08-24,8562
1815,富喬,120,17,103,新光-高雄,2023-08-24,8562
00664R,國泰臺灣加權反1,100,0,100,新光-高雄,2023-08-24,8562
4979,華星光,167,82,85,新光-高雄,2023-08-24,8562
8210,勤誠,92,35,57,新光-高雄,2023-08-24,8562
2356,英業達,214,157,57,新光-高雄,2023-08-24,8562
2884,玉山金,57,0,57,新光-高雄,2023-08-24,8562
00900,富邦特選高股息30,75,20,55,新光-高雄,2023-08-24,8562
6257,矽格,61,7,54,新光-高雄,2023-08-24,8562
00753L,中信中國50正2,63,10,53,新光-高雄,2023-08-24,8562
2324,仁寶,129,81,48,新光-高雄,2023-08-24,8562
4960,誠美材,43,0,43,新光-高雄,2023-08-24,8562
1101,台泥,43,1,42,新光-高雄,2023-08-24,8562
2618,長榮航,51,11,40,新光-高雄,2023-08-24,8562
3232,昱捷,37,0,37,新光-高雄,2023-08-24,8562
2337,旺宏,41,5,36,新光-高雄,2023-08-24,8562
2363,矽統,407,373,34,新光-高雄,2023-08-24,8562
2357,華碩,47,18,29,新光-高雄,2023-08-24,8562
2002,中鋼,28,1,27,新光-高雄,2023-08-24,8562
2867,三商壽,25,0,25,新光-高雄,2023-08-24,8562
2449,京元電子,152,127,25,新光-高雄,2023-08-24,8562
3078,僑威,72,48,24,新光-高雄,2023-08-24,8562
1402,遠東新,23,0,23,新光-高雄,2023-08-24,8562
6188,廣明,42,19,23,新光-高雄,2023-08-24,8562
6274,台燿,81,58,23,新光-高雄,2023-08-24,8562
2883,凱基金,22,0,22,新光-高雄,2023-08-24,8562
00642U,期元大S＆P石油,23,1,22,新光-高雄,2023-08-24,8562
6799,來頡,27,5,22,新光-高雄,2023-08-24,8562
00670L,富邦NASDAQ正2,31,11,20,新光-高雄,2023-08-24,8562
6418,詠昇,26,6,20,新光-高雄,2023-08-24,8562
2809,京城銀,20,1,19,新光-高雄,2023-08-24,8562
3702,大聯大,19,0,19,新光-高雄,2023-08-24,8562
1319,東陽,20,1,19,新光-高雄,2023-08-24,8562
6605,帝寶,19,0,19,新光-高雄,2023-08-24,8562
2606,裕民,25,8,17,新光-高雄,2023-08-24,8562
00706L,期元大S＆P日圓正2,17,0,17,新光-高雄,2023-08-24,8562
3032,偉訓,33,16,17,新光-高雄,2023-08-24,8562
00719B,元大美債1-3,17,0,17,新光-高雄,2023-08-24,8562
00665L,富邦�琤肭磪囓�2,45,28,17,新光-高雄,2023-08-24,8562
4916,事欣科,29,13,16,新光-高雄,2023-08-24,8562
00651R,復華香港反1,17,1,16,新光-高雄,2023-08-24,8562
2603,長榮,15,0,15,新光-高雄,2023-08-24,8562
1316,上曜,15,0,15,新光-高雄,2023-08-24,8562
3581,博磊,16,1,15,新光-高雄,2023-08-24,8562
1447,力鵬,14,0,14,新光-高雄,2023-08-24,8562
2880,華南金,70,57,13,新光-高雄,2023-08-24,8562
2607,榮運,13,0,13,新光-高雄,2023-08-24,8562
2461,光群雷,13,0,13,新光-高雄,2023-08-24,8562
00919,群益台灣精選高息,1740,0,1740,新光-高雄,2023-08-25,8562
2409,友達,1194,9,1185,新光-高雄,2023-08-25,8562
00878,國泰永續高股息,466,75,391,新光-高雄,2023-08-25,8562
3231,緯創,500,228,272,新光-高雄,2023-08-25,8562
00923,群益台ESG低碳50,137,8,129,新光-高雄,2023-08-25,8562
00680L,元大美債20正2,118,8,110,新光-高雄,2023-08-25,8562
2891,中信金,96,2,94,新光-高雄,2023-08-25,8562
00712,復華富時不動產,127,43,84,新光-高雄,2023-08-25,8562
00850,元大臺灣ESG永續,83,0,83,新光-高雄,2023-08-25,8562
2301,光寶科,121,50,71,新光-高雄,2023-08-25,8562
00669R,國泰美國道瓊反1,65,0,65,新光-高雄,2023-08-25,8562
2382,廣達,232,168,64,新光-高雄,2023-08-25,8562
00894,中信小資高價30,60,0,60,新光-高雄,2023-08-25,8562
00715L,期街口布蘭特正2,60,0,60,新光-高雄,2023-08-25,8562
2610,華航,122,68,54,新光-高雄,2023-08-25,8562
00665L,富邦�琤肭磪囓�2,154,104,50,新光-高雄,2023-08-25,8562
1101,台泥,49,1,48,新光-高雄,2023-08-25,8562
2002,中鋼,55,10,45,新光-高雄,2023-08-25,8562
2303,聯電,46,3,43,新光-高雄,2023-08-25,8562
5340,建榮,46,3,43,新光-高雄,2023-08-25,8562
4931,新盛力,44,3,41,新光-高雄,2023-08-25,8562
00830,國泰費城半導體,35,0,35,新光-高雄,2023-08-25,8562
00931B,統一美債20年,30,0,30,新光-高雄,2023-08-25,8562
1218,泰山,30,1,29,新光-高雄,2023-08-25,8562
6216,居易,30,1,29,新光-高雄,2023-08-25,8562
00907,永豐優息存股,27,0,27,新光-高雄,2023-08-25,8562
3037,欣興,43,16,27,新光-高雄,2023-08-25,8562
2412,中華電,27,1,26,新光-高雄,2023-08-25,8562
0056,元大高股息,107,81,26,新光-高雄,2023-08-25,8562
2634,漢翔,129,104,25,新光-高雄,2023-08-25,8562
2892,第一金,23,0,23,新光-高雄,2023-08-25,8562
00651R,復華香港反1,20,1,19,新光-高雄,2023-08-25,8562
0050,元大台灣50,21,2,19,新光-高雄,2023-08-25,8562
2884,玉山金,28,10,18,新光-高雄,2023-08-25,8562
2344,華邦電,84,66,18,新光-高雄,2023-08-25,8562
2353,宏��,53,35,18,新光-高雄,2023-08-25,8562
00670L,富邦NASDAQ正2,18,0,18,新光-高雄,2023-08-25,8562
2352,佳世達,19,2,17,新光-高雄,2023-08-25,8562
2605,新興,19,2,17,新光-高雄,2023-08-25,8562
00882,中信中國高股息,21,5,16,新光-高雄,2023-08-25,8562
2618,長榮航,93,77,16,新光-高雄,2023-08-25,8562
2883,凱基金,16,1,15,新光-高雄,2023-08-25,8562
1504,東元,18,3,15,新光-高雄,2023-08-25,8562
2313,華通,21,6,15,新光-高雄,2023-08-25,8562
2363,矽統,298,283,15,新光-高雄,2023-08-25,8562
6285,啟��,38,23,15,新光-高雄,2023-08-25,8562
2324,仁寶,45,30,15,新光-高雄,2023-08-25,8562
8222,寶一,65,51,14,新光-高雄,2023-08-25,8562
00706L,期元大S＆P日圓正2,13,0,13,新光-高雄,2023-08-25,8562
00757,統一FANG+,13,0,13,新光-高雄,2023-08-25,8562
00929,復華台灣科技優息,655,116,539,新光-高雄,2023-08-28,8562
00919,群益台灣精選高息,492,26,466,新光-高雄,2023-08-28,8562
00882,中信中國高股息,200,33,167,新光-高雄,2023-08-28,8562
00795B,中信美國公債20年,160,5,155,新光-高雄,2023-08-28,8562
00632R,元大台灣50反1,166,50,116,新光-高雄,2023-08-28,8562
2485,兆赫,322,225,97,新光-高雄,2023-08-28,8562
4906,正文,219,125,94,新光-高雄,2023-08-28,8562
3481,群創,101,23,78,新光-高雄,2023-08-28,8562
2618,長榮航,186,112,74,新光-高雄,2023-08-28,8562
00753L,中信中國50正2,71,1,70,新光-高雄,2023-08-28,8562
2388,威盛,126,63,63,新光-高雄,2023-08-28,8562
2883,凱基金,67,5,62,新光-高雄,2023-08-28,8562
00878,國泰永續高股息,183,125,58,新光-高雄,2023-08-28,8562
3711,日月光投控,117,64,53,新光-高雄,2023-08-28,8562
1210,大成,55,2,53,新光-高雄,2023-08-28,8562
2374,佳能,52,0,52,新光-高雄,2023-08-28,8562
00671R,富邦NASDAQ反1,52,0,52,新光-高雄,2023-08-28,8562
2610,華航,77,28,49,新光-高雄,2023-08-28,8562
6451,訊芯-KY,40,1,39,新光-高雄,2023-08-28,8562
0056,元大高股息,63,25,38,新光-高雄,2023-08-28,8562
2834,臺企銀,34,4,30,新光-高雄,2023-08-28,8562
00712,復華富時不動產,33,9,24,新光-高雄,2023-08-28,8562
2887,台新金,24,1,23,新光-高雄,2023-08-28,8562
00631L,元大台灣50正2,29,6,23,新光-高雄,2023-08-28,8562
00673R,期元大S＆P原油反1,22,0,22,新光-高雄,2023-08-28,8562
2323,中環,71,50,21,新光-高雄,2023-08-28,8562
2634,漢翔,239,219,20,新光-高雄,2023-08-28,8562
2352,佳世達,20,1,19,新光-高雄,2023-08-28,8562
1609,大亞,22,3,19,新光-高雄,2023-08-28,8562
5880,合庫金,19,0,19,新光-高雄,2023-08-28,8562
2399,映泰,20,2,18,新光-高雄,2023-08-28,8562
3305,昇貿,47,29,18,新光-高雄,2023-08-28,8562
2449,京元電子,60,43,17,新光-高雄,2023-08-28,8562
00679B,元大美債20年,17,0,17,新光-高雄,2023-08-28,8562
2405,輔信,25,9,16,新光-高雄,2023-08-28,8562
1707,葡萄王,17,1,16,新光-高雄,2023-08-28,8562
2812,台中銀,72,56,16,新光-高雄,2023-08-28,8562
1522,堤維西,23,8,15,新光-高雄,2023-08-28,8562
2002,中鋼,21,6,15,新光-高雄,2023-08-28,8562
1802,台玻,17,2,15,新光-高雄,2023-08-28,8562
3052,夆典,15,0,15,新光-高雄,2023-08-28,8562
2886,兆豐金,22,8,14,新光-高雄,2023-08-28,8562
2884,玉山金,15,1,14,新光-高雄,2023-08-28,8562
00751B,元大AAA至A公司債,19,5,14,新光-高雄,2023-08-28,8562
2882,國泰金,17,3,14,新光-高雄,2023-08-28,8562
2401,凌陽,20,6,14,新光-高雄,2023-08-28,8562
2331,精英,233,220,13,新光-高雄,2023-08-28,8562
6005,群益證,13,0,13,新光-高雄,2023-08-28,8562
8932,智通*,13,0,13,新光-高雄,2023-08-28,8562
2355,敬鵬,25,12,13,新光-高雄,2023-08-28,8562
00878,國泰永續高股息,712,54,658,新光-高雄,2023-08-29,8562
00632R,元大台灣50反1,632,87,545,新光-高雄,2023-08-29,8562
00929,復華台灣科技優息,338,72,266,新光-高雄,2023-08-29,8562
2363,矽統,503,360,143,新光-高雄,2023-08-29,8562
2449,京元電子,182,60,122,新光-高雄,2023-08-29,8562
2344,華邦電,120,20,100,新光-高雄,2023-08-29,8562
8358,金居,105,15,90,新光-高雄,2023-08-29,8562
00795B,中信美國公債20年,92,12,80,新光-高雄,2023-08-29,8562
2317,鴻海,81,21,60,新光-高雄,2023-08-29,8562
2881,富邦金,75,17,58,新光-高雄,2023-08-29,8562
6213,聯茂,103,46,57,新光-高雄,2023-08-29,8562
00882,中信中國高股息,64,8,56,新光-高雄,2023-08-29,8562
00919,群益台灣精選高息,480,426,54,新光-高雄,2023-08-29,8562
00885,富邦越南,57,6,51,新光-高雄,2023-08-29,8562
00753L,中信中國50正2,83,33,50,新光-高雄,2023-08-29,8562
2303,聯電,83,36,47,新光-高雄,2023-08-29,8562
5340,建榮,70,24,46,新光-高雄,2023-08-29,8562
00712,復華富時不動產,66,23,43,新光-高雄,2023-08-29,8562
3481,群創,60,20,40,新光-高雄,2023-08-29,8562
2329,華泰,83,45,38,新光-高雄,2023-08-29,8562
2002,中鋼,39,5,34,新光-高雄,2023-08-29,8562
6167,久正,47,13,34,新光-高雄,2023-08-29,8562
00830,國泰費城半導體,30,2,28,新光-高雄,2023-08-29,8562
6209,今國光,26,0,26,新光-高雄,2023-08-29,8562
0056,元大高股息,33,7,26,新光-高雄,2023-08-29,8562
00687B,國泰20年美債,30,6,24,新光-高雄,2023-08-29,8562
2312,金寶,25,1,24,新光-高雄,2023-08-29,8562
3051,力特,87,66,21,新光-高雄,2023-08-29,8562
4532,瑞智,21,0,21,新光-高雄,2023-08-29,8562
3052,夆典,21,0,21,新光-高雄,2023-08-29,8562
00719B,元大美債1-3,18,0,18,新光-高雄,2023-08-29,8562
00665L,富邦�琤肭磪囓�2,107,89,18,新光-高雄,2023-08-29,8562
5371,中光電,35,19,16,新光-高雄,2023-08-29,8562
2832,台產,16,0,16,新光-高雄,2023-08-29,8562
2356,英業達,100,85,15,新光-高雄,2023-08-29,8562
2324,仁寶,34,19,15,新光-高雄,2023-08-29,8562
6024,群益期,14,0,14,新光-高雄,2023-08-29,8562
00670L,富邦NASDAQ正2,13,0,13,新光-高雄,2023-08-29,8562
00673R,期元大S＆P原油反1,14,1,13,新光-高雄,2023-08-29,8562
2892,第一金,14,2,12,新光-高雄,2023-08-29,8562
2390,云辰,12,0,12,新光-高雄,2023-08-29,8562
00931B,統一美債20年,15,4,11,新光-高雄,2023-08-29,8562
00924,復華S＆P500成長,11,0,11,新光-高雄,2023-08-29,8562
6244,茂迪,12,1,11,新光-高雄,2023-08-29,8562
8222,寶一,43,32,11,新光-高雄,2023-08-29,8562
2330,台積電,11,1,10,新光-高雄,2023-08-29,8562
1301,台塑,11,0,11,新光-高雄,2023-08-29,8562
2331,精英,146,136,10,新光-高雄,2023-08-29,8562
2608,嘉里大榮,10,0,10,新光-高雄,2023-08-29,8562
2645,長榮航太,29,19,10,新光-高雄,2023-08-29,8562
00632R,元大台灣50反1,1451,166,1285,新光-高雄,2023-08-30,8562
00637L,元大滬深300正2,327,6,321,新光-高雄,2023-08-30,8562
2356,英業達,238,36,202,新光-高雄,2023-08-30,8562
3682,亞太電,117,0,117,新光-高雄,2023-08-30,8562
2834,臺企銀,123,16,107,新光-高雄,2023-08-30,8562
1568,倉佑,81,1,80,新光-高雄,2023-08-30,8562
5009,榮剛,78,2,76,新光-高雄,2023-08-30,8562
00919,群益台灣精選高息,494,427,67,新光-高雄,2023-08-30,8562
8210,勤誠,80,29,51,新光-高雄,2023-08-30,8562
00670L,富邦NASDAQ正2,44,1,43,新光-高雄,2023-08-30,8562
2344,華邦電,179,139,40,新光-高雄,2023-08-30,8562
2331,精英,192,153,39,新光-高雄,2023-08-30,8562
2105,正新,53,17,36,新光-高雄,2023-08-30,8562
3325,旭品,119,83,36,新光-高雄,2023-08-30,8562
2401,凌陽,44,13,31,新光-高雄,2023-08-30,8562
1314,中石化,31,0,31,新光-高雄,2023-08-30,8562
2357,華碩,31,1,30,新光-高雄,2023-08-30,8562
8064,東捷,30,0,30,新光-高雄,2023-08-30,8562
2301,光寶科,49,24,25,新光-高雄,2023-08-30,8562
3715,定穎投控,170,145,25,新光-高雄,2023-08-30,8562
2027,大成鋼,26,3,23,新光-高雄,2023-08-30,8562
8358,金居,54,31,23,新光-高雄,2023-08-30,8562
1101,台泥,24,2,22,新光-高雄,2023-08-30,8562
3163,波若威,49,28,21,新光-高雄,2023-08-30,8562
9103,美德醫療-DR,22,1,21,新光-高雄,2023-08-30,8562
2891,中信金,28,8,20,新光-高雄,2023-08-30,8562
3290,東浦,20,0,20,新光-高雄,2023-08-30,8562
2832,台產,20,0,20,新光-高雄,2023-08-30,8562
2610,華航,63,44,19,新光-高雄,2023-08-30,8562
6234,高僑,21,2,19,新光-高雄,2023-08-30,8562
00706L,期元大S＆P日圓正2,19,1,18,新光-高雄,2023-08-30,8562
2449,京元電子,59,42,17,新光-高雄,2023-08-30,8562
00633L,富邦上証正2,17,0,17,新光-高雄,2023-08-30,8562
5314,世紀,17,0,17,新光-高雄,2023-08-30,8562
2408,南亞科,24,7,17,新光-高雄,2023-08-30,8562
6111,大宇資,18,2,16,新光-高雄,2023-08-30,8562
5347,世界,16,0,16,新光-高雄,2023-08-30,8562
1597,直得,16,0,16,新光-高雄,2023-08-30,8562
3481,群創,65,49,16,新光-高雄,2023-08-30,8562
2609,陽明,15,0,15,新光-高雄,2023-08-30,8562
00688L,國泰20年美債正2,15,0,15,新光-高雄,2023-08-30,8562
02001L,富邦蘋果正二N,15,0,15,新光-高雄,2023-08-30,8562
6024,群益期,15,0,15,新光-高雄,2023-08-30,8562
2883,凱基金,15,1,14,新光-高雄,2023-08-30,8562
6829,千附精密,21,7,14,新光-高雄,2023-08-30,8562
2002,中鋼,19,6,13,新光-高雄,2023-08-30,8562
2892,第一金,13,0,13,新光-高雄,2023-08-30,8562
4707,磐亞,15,2,13,新光-高雄,2023-08-30,8562
6806,森崴能源,27,14,13,新光-高雄,2023-08-30,8562
8996,高力,16,3,13,新光-高雄,2023-08-30,8562
2834,臺企銀,274,82,192,新光-高雄,2023-08-31,8562
4306,炎洲,100,0,100,新光-高雄,2023-08-31,8562
00929,復華台灣科技優息,228,134,94,新光-高雄,2023-08-31,8562
3682,亞太電,73,0,73,新光-高雄,2023-08-31,8562
00637L,元大滬深300正2,78,13,65,新光-高雄,2023-08-31,8562
2337,旺宏,105,50,55,新光-高雄,2023-08-31,8562
6274,台燿,97,43,54,新光-高雄,2023-08-31,8562
6104,創惟,63,12,51,新光-高雄,2023-08-31,8562
2618,長榮航,196,146,50,新光-高雄,2023-08-31,8562
3051,力特,89,39,50,新光-高雄,2023-08-31,8562
1101,台泥,50,4,46,新光-高雄,2023-08-31,8562
00878,國泰永續高股息,85,42,43,新光-高雄,2023-08-31,8562
3481,群創,36,1,35,新光-高雄,2023-08-31,8562
8088,品安,91,56,35,新光-高雄,2023-08-31,8562
3715,定穎投控,180,145,35,新光-高雄,2023-08-31,8562
2890,永豐金,37,3,34,新光-高雄,2023-08-31,8562
6799,來頡,32,0,32,新光-高雄,2023-08-31,8562
2891,中信金,33,1,32,新光-高雄,2023-08-31,8562
6244,茂迪,34,4,30,新光-高雄,2023-08-31,8562
2324,仁寶,55,25,30,新光-高雄,2023-08-31,8562
4303,信立,29,0,29,新光-高雄,2023-08-31,8562
2880,華南金,29,0,29,新光-高雄,2023-08-31,8562
2002,中鋼,29,1,28,新光-高雄,2023-08-31,8562
2353,宏��,40,13,27,新光-高雄,2023-08-31,8562
1301,台塑,27,0,27,新光-高雄,2023-08-31,8562
1584,精剛,67,40,27,新光-高雄,2023-08-31,8562
00722B,群益投資級電信債,27,0,27,新光-高雄,2023-08-31,8562
2355,敬鵬,39,13,26,新光-高雄,2023-08-31,8562
2892,第一金,25,0,25,新光-高雄,2023-08-31,8562
2886,兆豐金,25,0,25,新光-高雄,2023-08-31,8562
1904,正隆,32,8,24,新光-高雄,2023-08-31,8562
5009,榮剛,52,28,24,新光-高雄,2023-08-31,8562
00680L,元大美債20正2,34,11,23,新光-高雄,2023-08-31,8562
2881,富邦金,23,0,23,新光-高雄,2023-08-31,8562
3305,昇貿,26,4,22,新光-高雄,2023-08-31,8562
5864,致和證,20,0,20,新光-高雄,2023-08-31,8562
9904,寶成,19,0,19,新光-高雄,2023-08-31,8562
00923,群益台ESG低碳50,24,5,19,新光-高雄,2023-08-31,8562
0056,元大高股息,24,5,19,新光-高雄,2023-08-31,8562
2303,聯電,52,33,19,新光-高雄,2023-08-31,8562
5258,虹堡,26,7,19,新光-高雄,2023-08-31,8562
2887,台新金,24,5,19,新光-高雄,2023-08-31,8562
00907,永豐優息存股,18,0,18,新光-高雄,2023-08-31,8562
4931,新盛力,23,5,18,新光-高雄,2023-08-31,8562
6443,元晶,30,12,18,新光-高雄,2023-08-31,8562
3711,日月光投控,29,11,18,新光-高雄,2023-08-31,8562
6547,高端疫苗,31,14,17,新光-高雄,2023-08-31,8562
4906,正文,36,20,16,新光-高雄,2023-08-31,8562
2376,技嘉,78,62,16,新光-高雄,2023-08-31,8562
00922,國泰台灣領袖50,16,0,16,新光-高雄,2023-08-31,8562
00919,群益台灣精選高息,1006,336,670,新光-高雄,2023-09-01,8562
00929,復華台灣科技優息,435,37,398,新光-高雄,2023-09-01,8562
6005,群益證,161,0,161,新光-高雄,2023-09-01,8562
3231,緯創,395,249,146,新光-高雄,2023-09-01,8562
00932,兆豐永續高息等權,128,0,128,新光-高雄,2023-09-01,8562
4938,和碩,118,6,112,新光-高雄,2023-09-01,8562
2485,兆赫,623,517,106,新光-高雄,2023-09-01,8562
00664R,國泰臺灣加權反1,100,0,100,新光-高雄,2023-09-01,8562
2002,中鋼,105,10,95,新光-高雄,2023-09-01,8562
2881,富邦金,102,26,76,新光-高雄,2023-09-01,8562
1605,華新,102,39,63,新光-高雄,2023-09-01,8562
2337,旺宏,93,40,53,新光-高雄,2023-09-01,8562
2331,精英,142,91,51,新光-高雄,2023-09-01,8562
1618,合機,54,4,50,新光-高雄,2023-09-01,8562
00632R,元大台灣50反1,50,2,48,新光-高雄,2023-09-01,8562
2356,英業達,197,154,43,新光-高雄,2023-09-01,8562
2382,廣達,114,73,41,新光-高雄,2023-09-01,8562
6274,台燿,88,51,37,新光-高雄,2023-09-01,8562
8050,廣積,52,24,28,新光-高雄,2023-09-01,8562
6547,高端疫苗,98,71,27,新光-高雄,2023-09-01,8562
3305,昇貿,29,2,27,新光-高雄,2023-09-01,8562
2312,金寶,82,55,27,新光-高雄,2023-09-01,8562
2313,華通,26,0,26,新光-高雄,2023-09-01,8562
2425,承啟,26,0,26,新光-高雄,2023-09-01,8562
1809,中釉,32,6,26,新光-高雄,2023-09-01,8562
1513,中興電,58,33,25,新光-高雄,2023-09-01,8562
0056,元大高股息,40,15,25,新光-高雄,2023-09-01,8562
3682,亞太電,24,0,24,新光-高雄,2023-09-01,8562
2516,新建,23,0,23,新光-高雄,2023-09-01,8562
2363,矽統,499,477,22,新光-高雄,2023-09-01,8562
2022,聚亨,23,1,22,新光-高雄,2023-09-01,8562
2323,中環,22,0,22,新光-高雄,2023-09-01,8562
2838,聯邦銀,19,0,19,新光-高雄,2023-09-01,8562
3380,明泰,22,3,19,新光-高雄,2023-09-01,8562
2329,華泰,68,49,19,新光-高雄,2023-09-01,8562
4934,太極,21,3,18,新光-高雄,2023-09-01,8562
3308,聯德,60,42,18,新光-高雄,2023-09-01,8562
5519,隆大,18,0,18,新光-高雄,2023-09-01,8562
9105,泰金寶-DR,17,0,17,新光-高雄,2023-09-01,8562
6269,台郡,17,0,17,新光-高雄,2023-09-01,8562
6126,信音,19,2,17,新光-高雄,2023-09-01,8562
00900,富邦特選高股息30,19,2,17,新光-高雄,2023-09-01,8562
2324,仁寶,57,42,15,新光-高雄,2023-09-01,8562
00679B,元大美債20年,15,0,15,新光-高雄,2023-09-01,8562
4909,新復興,65,51,14,新光-高雄,2023-09-01,8562
6127,九豪,19,5,14,新光-高雄,2023-09-01,8562
2328,廣宇,14,0,14,新光-高雄,2023-09-01,8562
6235,華孚,82,69,13,新光-高雄,2023-09-01,8562
2880,華南金,13,0,13,新光-高雄,2023-09-01,8562
1717,長興,12,0,12,新光-高雄,2023-09-01,8562
00919,群益台灣精選高息,537,198,339,新光-高雄,2023-09-04,8562
00929,復華台灣科技優息,456,235,221,新光-高雄,2023-09-04,8562
6279,胡連,170,1,169,新光-高雄,2023-09-04,8562
00632R,元大台灣50反1,160,70,90,新光-高雄,2023-09-04,8562
2337,旺宏,69,4,65,新光-高雄,2023-09-04,8562
00673R,期元大S＆P原油反1,64,0,64,新光-高雄,2023-09-04,8562
0056,元大高股息,101,42,59,新光-高雄,2023-09-04,8562
00931B,統一美債20年,63,5,58,新光-高雄,2023-09-04,8562
00680L,元大美債20正2,64,12,52,新光-高雄,2023-09-04,8562
1802,台玻,201,154,47,新光-高雄,2023-09-04,8562
00679B,元大美債20年,51,5,46,新光-高雄,2023-09-04,8562
00915,凱基優選高股息30,180,135,45,新光-高雄,2023-09-04,8562
00687B,國泰20年美債,42,0,42,新光-高雄,2023-09-04,8562
6274,台燿,106,67,39,新光-高雄,2023-09-04,8562
00751B,元大AAA至A公司債,37,0,37,新光-高雄,2023-09-04,8562
2331,精英,53,18,35,新光-高雄,2023-09-04,8562
5009,榮剛,56,24,32,新光-高雄,2023-09-04,8562
00631L,元大台灣50正2,39,7,32,新光-高雄,2023-09-04,8562
2492,華新科,67,35,32,新光-高雄,2023-09-04,8562
00918,大華優利高填息30,164,135,29,新光-高雄,2023-09-04,8562
6208,日揚,27,0,27,新光-高雄,2023-09-04,8562
00772B,中信高評級公司債,26,0,26,新光-高雄,2023-09-04,8562
2888,新光金,58,32,26,新光-高雄,2023-09-04,8562
5381,合正,79,54,25,新光-高雄,2023-09-04,8562
3481,群創,32,8,24,新光-高雄,2023-09-04,8562
1304,台聚,29,5,24,新光-高雄,2023-09-04,8562
2483,百容,23,0,23,新光-高雄,2023-09-04,8562
6213,聯茂,88,65,23,新光-高雄,2023-09-04,8562
6194,育富,23,0,23,新光-高雄,2023-09-04,8562
00713,元大台灣高息低波,25,2,23,新光-高雄,2023-09-04,8562
6168,宏齊,36,14,22,新光-高雄,2023-09-04,8562
2236,百達-KY,25,3,22,新光-高雄,2023-09-04,8562
3290,東浦,89,67,22,新光-高雄,2023-09-04,8562
8069,元太,21,0,21,新光-高雄,2023-09-04,8562
2485,兆赫,307,287,20,新光-高雄,2023-09-04,8562
4938,和碩,22,2,20,新光-高雄,2023-09-04,8562
00773B,中信優先金融債,20,0,20,新光-高雄,2023-09-04,8562
8358,金居,52,32,20,新光-高雄,2023-09-04,8562
1616,億泰,36,17,19,新光-高雄,2023-09-04,8562
9929,秋雨,22,3,19,新光-高雄,2023-09-04,8562
6288,聯嘉,20,1,19,新光-高雄,2023-09-04,8562
2206,三陽工業,57,39,18,新光-高雄,2023-09-04,8562
4906,正文,90,73,17,新光-高雄,2023-09-04,8562
2880,華南金,20,4,16,新光-高雄,2023-09-04,8562
1449,佳和,16,0,16,新光-高雄,2023-09-04,8562
00857B,永豐20年美公債,15,0,15,新光-高雄,2023-09-04,8562
3078,僑威,20,5,15,新光-高雄,2023-09-04,8562
2812,台中銀,44,29,15,新光-高雄,2023-09-04,8562
6829,千附精密,26,11,15,新光-高雄,2023-09-04,8562
2323,中環,55,41,14,新光-高雄,2023-09-04,8562
00915,凱基優選高股息30,507,0,507,新光-高雄,2023-09-05,8562
00632R,元大台灣50反1,410,20,390,新光-高雄,2023-09-05,8562
00929,復華台灣科技優息,521,303,218,新光-高雄,2023-09-05,8562
00637L,元大滬深300正2,132,2,130,新光-高雄,2023-09-05,8562
5258,虹堡,105,8,97,新光-高雄,2023-09-05,8562
00665L,富邦�琤肭磪囓�2,137,66,71,新光-高雄,2023-09-05,8562
00751B,元大AAA至A公司債,64,0,64,新光-高雄,2023-09-05,8562
8110,華東,69,8,61,新光-高雄,2023-09-05,8562
00772B,中信高評級公司債,56,0,56,新光-高雄,2023-09-05,8562
2883,凱基金,68,13,55,新光-高雄,2023-09-05,8562
8086,宏捷科,91,37,54,新光-高雄,2023-09-05,8562
2331,精英,158,106,52,新光-高雄,2023-09-05,8562
5469,瀚宇博,77,32,45,新光-高雄,2023-09-05,8562
2610,華航,81,38,43,新光-高雄,2023-09-05,8562
2485,兆赫,69,29,40,新光-高雄,2023-09-05,8562
2618,長榮航,111,72,39,新光-高雄,2023-09-05,8562
00882,中信中國高股息,40,2,38,新光-高雄,2023-09-05,8562
2402,毅嘉,119,82,37,新光-高雄,2023-09-05,8562
4190,佐登-KY,36,0,36,新光-高雄,2023-09-05,8562
3481,群創,39,4,35,新光-高雄,2023-09-05,8562
00878,國泰永續高股息,93,58,35,新光-高雄,2023-09-05,8562
1605,華新,40,6,34,新光-高雄,2023-09-05,8562
3231,緯創,165,131,34,新光-高雄,2023-09-05,8562
2014,中鴻,33,1,32,新光-高雄,2023-09-05,8562
2504,國產,31,0,31,新光-高雄,2023-09-05,8562
2383,台光電,43,13,30,新光-高雄,2023-09-05,8562
00857B,永豐20年美公債,27,0,27,新光-高雄,2023-09-05,8562
1101,台泥,30,3,27,新光-高雄,2023-09-05,8562
6235,華孚,143,117,26,新光-高雄,2023-09-05,8562
00931B,統一美債20年,27,1,26,新光-高雄,2023-09-05,8562
5608,四維航,25,0,25,新光-高雄,2023-09-05,8562
2891,中信金,45,20,25,新光-高雄,2023-09-05,8562
2436,偉詮電,158,135,23,新光-高雄,2023-09-05,8562
3051,力特,99,76,23,新光-高雄,2023-09-05,8562
5457,宣德,34,12,22,新光-高雄,2023-09-05,8562
6016,康和證,35,13,22,新光-高雄,2023-09-05,8562
00720B,元大投資級公司債,31,10,21,新光-高雄,2023-09-05,8562
00907,永豐優息存股,22,2,20,新光-高雄,2023-09-05,8562
5009,榮剛,38,18,20,新光-高雄,2023-09-05,8562
2884,玉山金,20,0,20,新光-高雄,2023-09-05,8562
1711,永光,20,1,19,新光-高雄,2023-09-05,8562
2328,廣宇,28,9,19,新光-高雄,2023-09-05,8562
9904,寶成,18,0,18,新光-高雄,2023-09-05,8562
3260,威剛,24,6,18,新光-高雄,2023-09-05,8562
2482,連宇,20,2,18,新光-高雄,2023-09-05,8562
2324,仁寶,69,52,17,新光-高雄,2023-09-05,8562
4414,如興,16,0,16,新光-高雄,2023-09-05,8562
00900,富邦特選高股息30,21,5,16,新光-高雄,2023-09-05,8562
3545,敦泰,37,22,15,新光-高雄,2023-09-05,8562
6208,日揚,15,0,15,新光-高雄,2023-09-05,8562
00929,復華台灣科技優息,2258,581,1677,新光-高雄,2023-09-06,8562
00715L,期街口布蘭特正2,984,8,976,新光-高雄,2023-09-06,8562
00878,國泰永續高股息,635,340,295,新光-高雄,2023-09-06,8562
3481,群創,245,58,187,新光-高雄,2023-09-06,8562
0056,元大高股息,523,372,151,新光-高雄,2023-09-06,8562
00664R,國泰臺灣加權反1,150,0,150,新光-高雄,2023-09-06,8562
00637L,元大滬深300正2,112,1,111,新光-高雄,2023-09-06,8562
2409,友達,209,100,109,新光-高雄,2023-09-06,8562
00632R,元大台灣50反1,121,20,101,新光-高雄,2023-09-06,8562
00751B,元大AAA至A公司債,90,1,89,新光-高雄,2023-09-06,8562
00918,大華優利高填息30,156,67,89,新光-高雄,2023-09-06,8562
2401,凌陽,147,82,65,新光-高雄,2023-09-06,8562
2888,新光金,70,7,63,新光-高雄,2023-09-06,8562
1802,台玻,69,7,62,新光-高雄,2023-09-06,8562
00921,兆豐龍頭等權重,55,0,55,新光-高雄,2023-09-06,8562
2884,玉山金,76,21,55,新光-高雄,2023-09-06,8562
00680L,元大美債20正2,62,10,52,新光-高雄,2023-09-06,8562
2356,英業達,101,54,47,新光-高雄,2023-09-06,8562
00900,富邦特選高股息30,50,4,46,新光-高雄,2023-09-06,8562
1605,華新,50,7,43,新光-高雄,2023-09-06,8562
1718,中纖,103,62,41,新光-高雄,2023-09-06,8562
00773B,中信優先金融債,39,0,39,新光-高雄,2023-09-06,8562
00772B,中信高評級公司債,39,0,39,新光-高雄,2023-09-06,8562
00795B,中信美國公債20年,40,2,38,新光-高雄,2023-09-06,8562
8930,青鋼,49,11,38,新光-高雄,2023-09-06,8562
2504,國產,36,0,36,新光-高雄,2023-09-06,8562
00669R,國泰美國道瓊反1,40,5,35,新光-高雄,2023-09-06,8562
6274,台燿,117,83,34,新光-高雄,2023-09-06,8562
3051,力特,88,54,34,新光-高雄,2023-09-06,8562
2002,中鋼,39,6,33,新光-高雄,2023-09-06,8562
00753L,中信中國50正2,58,25,33,新光-高雄,2023-09-06,8562
2618,長榮航,92,60,32,新光-高雄,2023-09-06,8562
8039,台虹,30,1,29,新光-高雄,2023-09-06,8562
2883,凱基金,39,10,29,新光-高雄,2023-09-06,8562
2603,長榮,35,7,28,新光-高雄,2023-09-06,8562
2892,第一金,27,0,27,新光-高雄,2023-09-06,8562
2388,威盛,49,22,27,新光-高雄,2023-09-06,8562
3567,逸昌,65,38,27,新光-高雄,2023-09-06,8562
5880,合庫金,26,1,25,新光-高雄,2023-09-06,8562
2520,冠德,26,1,25,新光-高雄,2023-09-06,8562
3149,正達,41,16,25,新光-高雄,2023-09-06,8562
00931B,統一美債20年,34,10,24,新光-高雄,2023-09-06,8562
00679B,元大美債20年,25,2,23,新光-高雄,2023-09-06,8562
3232,昱捷,20,0,20,新光-高雄,2023-09-06,8562
1532,勤美,21,1,20,新光-高雄,2023-09-06,8562
3715,定穎投控,150,131,19,新光-高雄,2023-09-06,8562
3704,合勤控,44,26,18,新光-高雄,2023-09-06,8562
00932,兆豐永續高息等權,18,0,18,新光-高雄,2023-09-06,8562
2317,鴻海,36,18,18,新光-高雄,2023-09-06,8562
9904,寶成,18,0,18,新光-高雄,2023-09-06,8562
00929,復華台灣科技優息,1362,543,819,新光-高雄,2023-09-07,8562
00715L,期街口布蘭特正2,532,11,521,新光-高雄,2023-09-07,8562
00919,群益台灣精選高息,514,104,410,新光-高雄,2023-09-07,8562
00915,凱基優選高股息30,202,0,202,新光-高雄,2023-09-07,8562
00637L,元大滬深300正2,217,42,175,新光-高雄,2023-09-07,8562
2614,東森,189,42,147,新光-高雄,2023-09-07,8562
00751B,元大AAA至A公司債,127,0,127,新光-高雄,2023-09-07,8562
00918,大華優利高填息30,123,0,123,新光-高雄,2023-09-07,8562
5347,世界,89,0,89,新光-高雄,2023-09-07,8562
00753L,中信中國50正2,127,42,85,新光-高雄,2023-09-07,8562
6274,台燿,138,58,80,新光-高雄,2023-09-07,8562
2303,聯電,82,11,71,新光-高雄,2023-09-07,8562
6485,點序,65,8,57,新光-高雄,2023-09-07,8562
00665L,富邦�琤肭磪囓�2,52,0,52,新光-高雄,2023-09-07,8562
00902,中信電池及儲能,48,0,48,新光-高雄,2023-09-07,8562
00932,兆豐永續高息等權,53,6,47,新光-高雄,2023-09-07,8562
00923,群益台ESG低碳50,46,0,46,新光-高雄,2023-09-07,8562
00713,元大台灣高息低波,44,0,44,新光-高雄,2023-09-07,8562
00673R,期元大S＆P原油反1,43,1,42,新光-高雄,2023-09-07,8562
2618,長榮航,52,11,41,新光-高雄,2023-09-07,8562
1717,長興,41,0,41,新光-高雄,2023-09-07,8562
00642U,期元大S＆P石油,40,0,40,新光-高雄,2023-09-07,8562
5225,東科-KY,50,11,39,新光-高雄,2023-09-07,8562
4908,前鼎,45,8,37,新光-高雄,2023-09-07,8562
00712,復華富時不動產,65,30,35,新光-高雄,2023-09-07,8562
00679B,元大美債20年,38,4,34,新光-高雄,2023-09-07,8562
00720B,元大投資級公司債,32,1,31,新光-高雄,2023-09-07,8562
2880,華南金,31,0,31,新光-高雄,2023-09-07,8562
8112,至上,108,78,30,新光-高雄,2023-09-07,8562
020033,統一�琤肮黕篾,30,0,30,新光-高雄,2023-09-07,8562
2352,佳世達,28,1,27,新光-高雄,2023-09-07,8562
2317,鴻海,31,3,28,新光-高雄,2023-09-07,8562
9904,寶成,26,0,26,新光-高雄,2023-09-07,8562
2330,台積電,24,1,23,新光-高雄,2023-09-07,8562
1618,合機,76,53,23,新光-高雄,2023-09-07,8562
2887,台新金,35,13,22,新光-高雄,2023-09-07,8562
3704,合勤控,85,63,22,新光-高雄,2023-09-07,8562
3481,群創,67,46,21,新光-高雄,2023-09-07,8562
00907,永豐優息存股,21,0,21,新光-高雄,2023-09-07,8562
1301,台塑,51,30,21,新光-高雄,2023-09-07,8562
00922,國泰台灣領袖50,20,0,20,新光-高雄,2023-09-07,8562
1904,正隆,20,0,20,新光-高雄,2023-09-07,8562
3363,上詮,118,98,20,新光-高雄,2023-09-07,8562
8183,精星,22,3,19,新光-高雄,2023-09-07,8562
3617,碩天,27,8,19,新光-高雄,2023-09-07,8562
2312,金寶,18,0,18,新光-高雄,2023-09-07,8562
4934,太極,39,21,18,新光-高雄,2023-09-07,8562
6208,日揚,18,0,18,新光-高雄,2023-09-07,8562
4906,正文,44,27,17,新光-高雄,2023-09-07,8562
6443,元晶,17,0,17,新光-高雄,2023-09-07,8562
00929,復華台灣科技優息,1450,266,1184,新光-高雄,2023-09-08,8562
00632R,元大台灣50反1,134,22,112,新光-高雄,2023-09-08,8562
2382,廣達,266,160,106,新光-高雄,2023-09-08,8562
00637L,元大滬深300正2,130,41,89,新光-高雄,2023-09-08,8562
2485,兆赫,139,57,82,新光-高雄,2023-09-08,8562
9105,泰金寶-DR,165,102,63,新光-高雄,2023-09-08,8562
1802,台玻,82,19,63,新光-高雄,2023-09-08,8562
00753L,中信中國50正2,57,0,57,新光-高雄,2023-09-08,8562
00795B,中信美國公債20年,62,5,57,新光-高雄,2023-09-08,8562
00751B,元大AAA至A公司債,105,51,54,新光-高雄,2023-09-08,8562
2913,農林,55,5,50,新光-高雄,2023-09-08,8562
4945,陞達科技,50,0,50,新光-高雄,2023-09-08,8562
5347,世界,50,1,49,新光-高雄,2023-09-08,8562
8088,品安,57,8,49,新光-高雄,2023-09-08,8562
2855,統一證,49,0,49,新光-高雄,2023-09-08,8562
8222,寶一,83,38,45,新光-高雄,2023-09-08,8562
8034,榮群,61,18,43,新光-高雄,2023-09-08,8562
1471,首利,65,25,40,新光-高雄,2023-09-08,8562
00669R,國泰美國道瓊反1,70,30,40,新光-高雄,2023-09-08,8562
2353,宏��,64,25,39,新光-高雄,2023-09-08,8562
3231,緯創,135,98,37,新光-高雄,2023-09-08,8562
2634,漢翔,85,49,36,新光-高雄,2023-09-08,8562
00915,凱基優選高股息30,35,0,35,新光-高雄,2023-09-08,8562
3062,建漢,35,1,34,新光-高雄,2023-09-08,8562
2317,鴻海,36,2,34,新光-高雄,2023-09-08,8562
00918,大華優利高填息30,33,0,33,新光-高雄,2023-09-08,8562
6024,群益期,33,0,33,新光-高雄,2023-09-08,8562
1707,葡萄王,33,2,31,新光-高雄,2023-09-08,8562
00665L,富邦�琤肭磪囓�2,29,1,28,新光-高雄,2023-09-08,8562
2618,長榮航,104,78,26,新光-高雄,2023-09-08,8562
00931B,統一美債20年,38,14,24,新光-高雄,2023-09-08,8562
3491,昇達科,24,0,24,新光-高雄,2023-09-08,8562
3338,泰碩,37,14,23,新光-高雄,2023-09-08,8562
1316,上曜,22,0,22,新光-高雄,2023-09-08,8562
00715L,期街口布蘭特正2,33,12,21,新光-高雄,2023-09-08,8562
3363,上詮,114,94,20,新光-高雄,2023-09-08,8562
00633L,富邦上証正2,20,0,20,新光-高雄,2023-09-08,8562
5488,松普,30,10,20,新光-高雄,2023-09-08,8562
8390,金益鼎,23,4,19,新光-高雄,2023-09-08,8562
4760,勤凱,21,2,19,新光-高雄,2023-09-08,8562
2436,偉詮電,52,34,18,新光-高雄,2023-09-08,8562
5516,雙喜,18,0,18,新光-高雄,2023-09-08,8562
00923,群益台ESG低碳50,29,11,18,新光-高雄,2023-09-08,8562
2301,光寶科,42,25,17,新光-高雄,2023-09-08,8562
2606,裕民,22,5,17,新光-高雄,2023-09-08,8562
2002,中鋼,18,1,17,新光-高雄,2023-09-08,8562
1319,東陽,43,27,16,新光-高雄,2023-09-08,8562
3715,定穎投控,239,223,16,新光-高雄,2023-09-08,8562
3548,兆利,16,0,16,新光-高雄,2023-09-08,8562
3323,加百裕,17,1,16,新光-高雄,2023-09-08,8562
00929,復華台灣科技優息,629,148,481,新光-高雄,2023-09-11,8562
00919,群益台灣精選高息,518,56,462,新光-高雄,2023-09-11,8562
3481,群創,237,45,192,新光-高雄,2023-09-11,8562
2883,凱基金,159,16,143,新光-高雄,2023-09-11,8562
2832,台產,135,0,135,新光-高雄,2023-09-11,8562
1584,精剛,231,108,123,新光-高雄,2023-09-11,8562
00918,大華優利高填息30,109,0,109,新光-高雄,2023-09-11,8562
0056,元大高股息,134,36,98,新光-高雄,2023-09-11,8562
4938,和碩,92,3,89,新光-高雄,2023-09-11,8562
00673R,期元大S＆P原油反1,74,5,69,新光-高雄,2023-09-11,8562
2405,輔信,443,375,68,新光-高雄,2023-09-11,8562
00720B,元大投資級公司債,78,10,68,新光-高雄,2023-09-11,8562
00915,凱基優選高股息30,69,3,66,新光-高雄,2023-09-11,8562
2363,矽統,589,523,66,新光-高雄,2023-09-11,8562
00715L,期街口布蘭特正2,72,10,62,新光-高雄,2023-09-11,8562
00931B,統一美債20年,59,4,55,新光-高雄,2023-09-11,8562
00932,兆豐永續高息等權,71,20,51,新光-高雄,2023-09-11,8562
4904,遠傳,51,1,50,新光-高雄,2023-09-11,8562
00669R,國泰美國道瓊反1,50,0,50,新光-高雄,2023-09-11,8562
2352,佳世達,67,21,46,新光-高雄,2023-09-11,8562
2353,宏��,71,29,42,新光-高雄,2023-09-11,8562
00900,富邦特選高股息30,42,0,42,新光-高雄,2023-09-11,8562
2457,飛宏,49,10,39,新光-高雄,2023-09-11,8562
3701,大眾控,39,1,38,新光-高雄,2023-09-11,8562
00679B,元大美債20年,47,10,37,新光-高雄,2023-09-11,8562
2880,華南金,38,2,36,新光-高雄,2023-09-11,8562
00687B,國泰20年美債,38,3,35,新光-高雄,2023-09-11,8562
00706L,期元大S＆P日圓正2,51,18,33,新光-高雄,2023-09-11,8562
00907,永豐優息存股,33,0,33,新光-高雄,2023-09-11,8562
2888,新光金,49,16,33,新光-高雄,2023-09-11,8562
1609,大亞,39,7,32,新光-高雄,2023-09-11,8562
1515,力山,33,1,32,新光-高雄,2023-09-11,8562
6274,台燿,132,102,30,新光-高雄,2023-09-11,8562
5443,均豪,30,0,30,新光-高雄,2023-09-11,8562
2374,佳能,60,31,29,新光-高雄,2023-09-11,8562
00857B,永豐20年美公債,29,0,29,新光-高雄,2023-09-11,8562
1605,華新,29,0,29,新光-高雄,2023-09-11,8562
2105,正新,52,24,28,新光-高雄,2023-09-11,8562
2610,華航,97,70,27,新光-高雄,2023-09-11,8562
2641,正德,28,3,25,新光-高雄,2023-09-11,8562
3014,聯陽,44,19,25,新光-高雄,2023-09-11,8562
2312,金寶,31,6,25,新光-高雄,2023-09-11,8562
2420,新巨,24,0,24,新光-高雄,2023-09-11,8562
00888,永豐台灣ESG,33,10,23,新光-高雄,2023-09-11,8562
1324,地球,58,35,23,新光-高雄,2023-09-11,8562
00902,中信電池及儲能,23,0,23,新光-高雄,2023-09-11,8562
00680L,元大美債20正2,24,2,22,新光-高雄,2023-09-11,8562
1618,合機,59,37,22,新光-高雄,2023-09-11,8562
8064,東捷,22,0,22,新光-高雄,2023-09-11,8562
1717,長興,22,1,21,新光-高雄,2023-09-11,8562
3481,群創,424,28,396,新光-高雄,2023-09-12,8562
00929,復華台灣科技優息,459,169,290,新光-高雄,2023-09-12,8562
00919,群益台灣精選高息,263,87,176,新光-高雄,2023-09-12,8562
0056,元大高股息,86,21,65,新光-高雄,2023-09-12,8562
2537,聯上發,56,0,56,新光-高雄,2023-09-12,8562
1584,精剛,292,236,56,新光-高雄,2023-09-12,8562
4904,遠傳,52,3,49,新光-高雄,2023-09-12,8562
2374,佳能,60,16,44,新光-高雄,2023-09-12,8562
00671R,富邦NASDAQ反1,36,0,36,新光-高雄,2023-09-12,8562
00932,兆豐永續高息等權,36,1,35,新光-高雄,2023-09-12,8562
00753L,中信中國50正2,33,0,33,新光-高雄,2023-09-12,8562
2337,旺宏,58,25,33,新光-高雄,2023-09-12,8562
2538,基泰,125,92,33,新光-高雄,2023-09-12,8562
00931B,統一美債20年,31,0,31,新光-高雄,2023-09-12,8562
2313,華通,165,135,30,新光-高雄,2023-09-12,8562
00902,中信電池及儲能,28,0,28,新光-高雄,2023-09-12,8562
00915,凱基優選高股息30,28,0,28,新光-高雄,2023-09-12,8562
2356,英業達,123,96,27,新光-高雄,2023-09-12,8562
00665L,富邦�琤肭磪囓�2,85,59,26,新光-高雄,2023-09-12,8562
5469,瀚宇博,28,3,25,新光-高雄,2023-09-12,8562
3694,海華,25,0,25,新光-高雄,2023-09-12,8562
3715,定穎投控,88,63,25,新光-高雄,2023-09-12,8562
00679B,元大美債20年,25,0,25,新光-高雄,2023-09-12,8562
3264,欣銓,63,40,23,新光-高雄,2023-09-12,8562
2845,遠東銀,22,0,22,新光-高雄,2023-09-12,8562
2002,中鋼,52,31,21,新光-高雄,2023-09-12,8562
2867,三商壽,21,0,21,新光-高雄,2023-09-12,8562
6282,康舒,98,78,20,新光-高雄,2023-09-12,8562
00795B,中信美國公債20年,21,0,21,新光-高雄,2023-09-12,8562
2883,凱基金,75,56,19,新光-高雄,2023-09-12,8562
1710,東聯,19,0,19,新光-高雄,2023-09-12,8562
5309,系統電,19,2,17,新光-高雄,2023-09-12,8562
00637L,元大滬深300正2,47,30,17,新光-高雄,2023-09-12,8562
1609,大亞,17,1,16,新光-高雄,2023-09-12,8562
2536,宏普,15,0,15,新光-高雄,2023-09-12,8562
2603,長榮,18,3,15,新光-高雄,2023-09-12,8562
2204,中華,17,3,14,新光-高雄,2023-09-12,8562
2312,金寶,18,4,14,新光-高雄,2023-09-12,8562
00651R,復華香港反1,14,0,14,新光-高雄,2023-09-12,8562
00751B,元大AAA至A公司債,14,1,13,新光-高雄,2023-09-12,8562
6125,廣運,41,29,12,新光-高雄,2023-09-12,8562
1304,台聚,12,0,12,新光-高雄,2023-09-12,8562
3580,友威科,12,0,12,新光-高雄,2023-09-12,8562
00921,兆豐龍頭等權重,12,0,12,新光-高雄,2023-09-12,8562
1727,中華化,12,0,12,新光-高雄,2023-09-12,8562
2105,正新,22,10,12,新光-高雄,2023-09-12,8562
2630,亞航,118,106,12,新光-高雄,2023-09-12,8562
00918,大華優利高填息30,15,3,12,新光-高雄,2023-09-12,8562
1216,統一,11,0,11,新光-高雄,2023-09-12,8562
2324,仁寶,35,24,11,新光-高雄,2023-09-12,8562
00919,群益台灣精選高息,786,340,446,新光-高雄,2023-09-13,8562
3481,群創,376,8,368,新光-高雄,2023-09-13,8562
6788,華景電,187,3,184,新光-高雄,2023-09-13,8562
00923,群益台ESG低碳50,129,1,128,新光-高雄,2023-09-13,8562
00712,復華富時不動產,73,4,69,新光-高雄,2023-09-13,8562
00671R,富邦NASDAQ反1,68,3,65,新光-高雄,2023-09-13,8562
1524,耿鼎,290,234,56,新光-高雄,2023-09-13,8562
00637L,元大滬深300正2,86,33,53,新光-高雄,2023-09-13,8562
2356,英業達,91,39,52,新光-高雄,2023-09-13,8562
2485,兆赫,73,22,51,新光-高雄,2023-09-13,8562
2832,台產,51,1,50,新光-高雄,2023-09-13,8562
3322,建舜電,77,29,48,新光-高雄,2023-09-13,8562
00665L,富邦�琤肭磪囓�2,70,25,45,新光-高雄,2023-09-13,8562
1101,台泥,71,27,44,新光-高雄,2023-09-13,8562
6163,華電網,40,0,40,新光-高雄,2023-09-13,8562
2317,鴻海,46,6,40,新光-高雄,2023-09-13,8562
2883,凱基金,51,16,35,新光-高雄,2023-09-13,8562
2353,宏��,58,24,34,新光-高雄,2023-09-13,8562
1324,地球,60,26,34,新光-高雄,2023-09-13,8562
2313,華通,85,53,32,新光-高雄,2023-09-13,8562
1707,葡萄王,35,4,31,新光-高雄,2023-09-13,8562
00857B,永豐20年美公債,30,0,30,新光-高雄,2023-09-13,8562
3711,日月光投控,56,27,29,新光-高雄,2023-09-13,8562
00679B,元大美債20年,28,0,28,新光-高雄,2023-09-13,8562
9904,寶成,24,0,24,新光-高雄,2023-09-13,8562
2614,東森,26,2,24,新光-高雄,2023-09-13,8562
2880,華南金,21,0,21,新光-高雄,2023-09-13,8562
2542,興富發,21,1,20,新光-高雄,2023-09-13,8562
3576,聯合再生,25,5,20,新光-高雄,2023-09-13,8562
2618,長榮航,32,12,20,新光-高雄,2023-09-13,8562
2412,中華電,23,4,19,新光-高雄,2023-09-13,8562
6789,采鈺,19,0,19,新光-高雄,2023-09-13,8562
00902,中信電池及儲能,19,0,19,新光-高雄,2023-09-13,8562
2884,玉山金,42,23,19,新光-高雄,2023-09-13,8562
0056,元大高股息,22,5,17,新光-高雄,2023-09-13,8562
9946,三發地產,17,0,17,新光-高雄,2023-09-13,8562
2330,台積電,20,3,17,新光-高雄,2023-09-13,8562
3380,明泰,38,22,16,新光-高雄,2023-09-13,8562
6284,佳邦,42,27,15,新光-高雄,2023-09-13,8562
8064,東捷,15,0,15,新光-高雄,2023-09-13,8562
6432,今展科,15,0,15,新光-高雄,2023-09-13,8562
2630,亞航,84,69,15,新光-高雄,2023-09-13,8562
8011,台通,15,1,14,新光-高雄,2023-09-13,8562
00896,中信綠能及電動車,13,0,13,新光-高雄,2023-09-13,8562
00720B,元大投資級公司債,15,2,13,新光-高雄,2023-09-13,8562
00687B,國泰20年美債,17,5,12,新光-高雄,2023-09-13,8562
2025,千興,18,6,12,新光-高雄,2023-09-13,8562
2427,三商電,13,1,12,新光-高雄,2023-09-13,8562
2387,精元,33,21,12,新光-高雄,2023-09-13,8562
3014,聯陽,34,22,12,新光-高雄,2023-09-13,8562
00929,復華台灣科技優息,1219,127,1092,新光-高雄,2023-09-14,8562
00632R,元大台灣50反1,273,55,218,新光-高雄,2023-09-14,8562
00680L,元大美債20正2,200,30,170,新光-高雄,2023-09-14,8562
3260,威剛,152,16,136,新光-高雄,2023-09-14,8562
00882,中信中國高股息,112,1,111,新光-高雄,2023-09-14,8562
00664R,國泰臺灣加權反1,102,0,102,新光-高雄,2023-09-14,8562
00715L,期街口布蘭特正2,81,0,81,新光-高雄,2023-09-14,8562
2867,三商壽,80,0,80,新光-高雄,2023-09-14,8562
4930,燦星網,70,0,70,新光-高雄,2023-09-14,8562
1626,艾美特-KY,58,0,58,新光-高雄,2023-09-14,8562
8112,至上,129,74,55,新光-高雄,2023-09-14,8562
2323,中環,61,13,48,新光-高雄,2023-09-14,8562
00885,富邦越南,46,5,41,新光-高雄,2023-09-14,8562
00712,復華富時不動產,106,66,40,新光-高雄,2023-09-14,8562
2801,彰銀,37,1,36,新光-高雄,2023-09-14,8562
8234,新漢,23,0,23,新光-高雄,2023-09-14,8562
2371,大同,51,29,22,新光-高雄,2023-09-14,8562
4306,炎洲,22,0,22,新光-高雄,2023-09-14,8562
2419,仲琦,42,20,22,新光-高雄,2023-09-14,8562
6235,華孚,56,35,21,新光-高雄,2023-09-14,8562
00679B,元大美債20年,22,2,20,新光-高雄,2023-09-14,8562
2332,友訊,23,3,20,新光-高雄,2023-09-14,8562
9946,三發地產,19,0,19,新光-高雄,2023-09-14,8562
2344,華邦電,24,6,18,新光-高雄,2023-09-14,8562
00687B,國泰20年美債,19,2,17,新光-高雄,2023-09-14,8562
3006,晶豪科,38,22,16,新光-高雄,2023-09-14,8562
1522,堤維西,382,366,16,新光-高雄,2023-09-14,8562
3189,景碩,24,8,16,新光-高雄,2023-09-14,8562
8936,國統,15,0,15,新光-高雄,2023-09-14,8562
2331,精英,22,9,13,新光-高雄,2023-09-14,8562
00931B,統一美債20年,18,5,13,新光-高雄,2023-09-14,8562
3706,神達,15,3,12,新光-高雄,2023-09-14,8562
3694,海華,24,12,12,新光-高雄,2023-09-14,8562
1319,東陽,67,55,12,新光-高雄,2023-09-14,8562
2634,漢翔,26,15,11,新光-高雄,2023-09-14,8562
1504,東元,14,3,11,新光-高雄,2023-09-14,8562
1305,華夏,11,0,11,新光-高雄,2023-09-14,8562
00753L,中信中國50正2,91,80,11,新光-高雄,2023-09-14,8562
2426,鼎元,21,10,11,新光-高雄,2023-09-14,8562
3013,晟銘電,32,21,11,新光-高雄,2023-09-14,8562
4967,十銓,22,11,11,新光-高雄,2023-09-14,8562
1324,地球,32,21,11,新光-高雄,2023-09-14,8562
6292,迅德,11,0,11,新光-高雄,2023-09-14,8562
1524,耿鼎,98,87,11,新光-高雄,2023-09-14,8562
00631L,元大台灣50正2,35,25,10,新光-高雄,2023-09-14,8562
3202,樺晟,10,0,10,新光-高雄,2023-09-14,8562
3167,大量,10,0,10,新光-高雄,2023-09-14,8562
6757,台灣虎航,10,0,10,新光-高雄,2023-09-14,8562
2027,大成鋼,9,0,9,新光-高雄,2023-09-14,8562
3231,緯創,268,259,9,新光-高雄,2023-09-14,8562
00929,復華台灣科技優息,1204,76,1128,新光-高雄,2023-09-15,8562
3481,群創,444,16,428,新光-高雄,2023-09-15,8562
00919,群益台灣精選高息,455,208,247,新光-高雄,2023-09-15,8562
00918,大華優利高填息30,279,52,227,新光-高雄,2023-09-15,8562
00680L,元大美債20正2,220,0,220,新光-高雄,2023-09-15,8562
00915,凱基優選高股息30,252,34,218,新光-高雄,2023-09-15,8562
00637L,元大滬深300正2,227,78,149,新光-高雄,2023-09-15,8562
00923,群益台ESG低碳50,131,17,114,新光-高雄,2023-09-15,8562
2884,玉山金,108,5,103,新光-高雄,2023-09-15,8562
00664R,國泰臺灣加權反1,100,0,100,新光-高雄,2023-09-15,8562
3231,緯創,237,140,97,新光-高雄,2023-09-15,8562
2542,興富發,92,0,92,新光-高雄,2023-09-15,8562
2610,華航,231,143,88,新光-高雄,2023-09-15,8562
5347,世界,84,3,81,新光-高雄,2023-09-15,8562
00679B,元大美債20年,92,27,65,新光-高雄,2023-09-15,8562
2891,中信金,69,13,56,新光-高雄,2023-09-15,8562
9919,康那香,69,16,53,新光-高雄,2023-09-15,8562
2515,中工,53,0,53,新光-高雄,2023-09-15,8562
9904,寶成,53,1,52,新光-高雄,2023-09-15,8562
2609,陽明,192,140,52,新光-高雄,2023-09-15,8562
00751B,元大AAA至A公司債,49,0,49,新光-高雄,2023-09-15,8562
2520,冠德,46,0,46,新光-高雄,2023-09-15,8562
2486,一詮,147,105,42,新光-高雄,2023-09-15,8562
2485,兆赫,45,3,42,新光-高雄,2023-09-15,8562
00931B,統一美債20年,44,3,41,新光-高雄,2023-09-15,8562
00857B,永豐20年美公債,40,0,40,新光-高雄,2023-09-15,8562
2002,中鋼,41,3,38,新光-高雄,2023-09-15,8562
3715,定穎投控,145,107,38,新光-高雄,2023-09-15,8562
2317,鴻海,52,16,36,新光-高雄,2023-09-15,8562
1605,華新,56,20,36,新光-高雄,2023-09-15,8562
3035,智原,89,55,34,新光-高雄,2023-09-15,8562
5465,富驊,36,3,33,新光-高雄,2023-09-15,8562
2472,立隆電,31,0,31,新光-高雄,2023-09-15,8562
3380,明泰,49,19,30,新光-高雄,2023-09-15,8562
1402,遠東新,36,7,29,新光-高雄,2023-09-15,8562
9946,三發地產,28,0,28,新光-高雄,2023-09-15,8562
00687B,國泰20年美債,33,6,27,新光-高雄,2023-09-15,8562
1217,愛之味,28,2,26,新光-高雄,2023-09-15,8562
8050,廣積,36,11,25,新光-高雄,2023-09-15,8562
2538,基泰,32,7,25,新光-高雄,2023-09-15,8562
3042,晶技,25,1,24,新光-高雄,2023-09-15,8562
4906,正文,34,10,24,新光-高雄,2023-09-15,8562
2312,金寶,25,1,24,新光-高雄,2023-09-15,8562
3287,廣寰科,26,2,24,新光-高雄,2023-09-15,8562
2356,英業達,34,11,23,新光-高雄,2023-09-15,8562
8068,全達,61,39,22,新光-高雄,2023-09-15,8562
6285,啟��,47,25,22,新光-高雄,2023-09-15,8562
1802,台玻,23,2,21,新光-高雄,2023-09-15,8562
1313,聯成,21,0,21,新光-高雄,2023-09-15,8562
00764B,群益25年美債,32,12,20,新光-高雄,2023-09-15,8562
00929,復華台灣科技優息,1585,183,1402,新光-高雄,2023-09-18,8562
00919,群益台灣精選高息,537,186,351,新光-高雄,2023-09-18,8562
00680L,元大美債20正2,344,0,344,新光-高雄,2023-09-18,8562
00923,群益台ESG低碳50,319,0,319,新光-高雄,2023-09-18,8562
00878,國泰永續高股息,240,57,183,新光-高雄,2023-09-18,8562
00665L,富邦�琤肭磪囓�2,185,40,145,新光-高雄,2023-09-18,8562
00712,復華富時不動產,277,135,142,新光-高雄,2023-09-18,8562
2363,矽統,390,249,141,新光-高雄,2023-09-18,8562
3481,群創,180,52,128,新光-高雄,2023-09-18,8562
00687B,國泰20年美債,126,7,119,新光-高雄,2023-09-18,8562
00637L,元大滬深300正2,260,142,118,新光-高雄,2023-09-18,8562
1301,台塑,114,0,114,新光-高雄,2023-09-18,8562
2884,玉山金,108,3,105,新光-高雄,2023-09-18,8562
00679B,元大美債20年,104,13,91,新光-高雄,2023-09-18,8562
00751B,元大AAA至A公司債,82,0,82,新光-高雄,2023-09-18,8562
00931B,統一美債20年,73,0,73,新光-高雄,2023-09-18,8562
2891,中信金,88,17,71,新光-高雄,2023-09-18,8562
2330,台積電,76,7,69,新光-高雄,2023-09-18,8562
00753L,中信中國50正2,74,8,66,新光-高雄,2023-09-18,8562
3231,緯創,155,95,60,新光-高雄,2023-09-18,8562
2609,陽明,97,41,56,新光-高雄,2023-09-18,8562
2880,華南金,56,1,55,新光-高雄,2023-09-18,8562
3037,欣興,61,9,52,新光-高雄,2023-09-18,8562
2542,興富發,53,2,51,新光-高雄,2023-09-18,8562
00857B,永豐20年美公債,47,0,47,新光-高雄,2023-09-18,8562
00915,凱基優選高股息30,47,1,46,新光-高雄,2023-09-18,8562
00885,富邦越南,54,10,44,新光-高雄,2023-09-18,8562
3715,定穎投控,169,125,44,新光-高雄,2023-09-18,8562
3622,洋華,53,11,42,新光-高雄,2023-09-18,8562
1522,堤維西,86,48,38,新光-高雄,2023-09-18,8562
00670L,富邦NASDAQ正2,38,0,38,新光-高雄,2023-09-18,8562
00720B,元大投資級公司債,38,1,37,新光-高雄,2023-09-18,8562
2027,大成鋼,59,22,37,新光-高雄,2023-09-18,8562
2887,台新金,37,1,36,新光-高雄,2023-09-18,8562
2313,華通,302,269,33,新光-高雄,2023-09-18,8562
9904,寶成,33,0,33,新光-高雄,2023-09-18,8562
2352,佳世達,40,8,32,新光-高雄,2023-09-18,8562
2382,廣達,74,43,31,新光-高雄,2023-09-18,8562
00772B,中信高評級公司債,29,1,28,新光-高雄,2023-09-18,8562
00713,元大台灣高息低波,26,0,26,新光-高雄,2023-09-18,8562
2913,農林,31,6,25,新光-高雄,2023-09-18,8562
2462,良得電,51,26,25,新光-高雄,2023-09-18,8562
00795B,中信美國公債20年,25,0,25,新光-高雄,2023-09-18,8562
2449,京元電子,30,7,23,新光-高雄,2023-09-18,8562
00675L,富邦臺灣加權正2,22,0,22,新光-高雄,2023-09-18,8562
3011,今皓,22,0,22,新光-高雄,2023-09-18,8562
0056,元大高股息,50,30,20,新光-高雄,2023-09-18,8562
2605,新興,97,77,20,新光-高雄,2023-09-18,8562
00752,中信中國50,21,1,20,新光-高雄,2023-09-18,8562
3033,威健,20,1,19,新光-高雄,2023-09-18,8562
00929,復華台灣科技優息,696,35,661,新光-高雄,2023-09-19,8562
00919,群益台灣精選高息,734,84,650,新光-高雄,2023-09-19,8562
3481,群創,166,4,162,新光-高雄,2023-09-19,8562
6901,鑽石投資,138,31,107,新光-高雄,2023-09-19,8562
00642U,期元大S＆P石油,150,50,100,新光-高雄,2023-09-19,8562
00921,兆豐龍頭等權重,83,0,83,新光-高雄,2023-09-19,8562
6120,達運,111,33,78,新光-高雄,2023-09-19,8562
00878,國泰永續高股息,118,51,67,新光-高雄,2023-09-19,8562
00753L,中信中國50正2,75,8,67,新光-高雄,2023-09-19,8562
00923,群益台ESG低碳50,67,0,67,新光-高雄,2023-09-19,8562
00665L,富邦�琤肭磪囓�2,182,118,64,新光-高雄,2023-09-19,8562
2356,英業達,78,22,56,新光-高雄,2023-09-19,8562
00680L,元大美債20正2,62,9,53,新光-高雄,2023-09-19,8562
2884,玉山金,56,5,51,新光-高雄,2023-09-19,8562
0056,元大高股息,49,1,48,新光-高雄,2023-09-19,8562
1605,華新,192,146,46,新光-高雄,2023-09-19,8562
1101,台泥,49,4,45,新光-高雄,2023-09-19,8562
5347,世界,41,1,40,新光-高雄,2023-09-19,8562
3701,大眾控,34,2,32,新光-高雄,2023-09-19,8562
4414,如興,31,0,31,新光-高雄,2023-09-19,8562
2485,兆赫,34,4,30,新光-高雄,2023-09-19,8562
00905,FT臺灣Smart,30,2,28,新光-高雄,2023-09-19,8562
00932,兆豐永續高息等權,27,0,27,新光-高雄,2023-09-19,8562
1522,堤維西,410,384,26,新光-高雄,2023-09-19,8562
00655L,國泰中國A50正2,28,2,26,新光-高雄,2023-09-19,8562
3706,神達,65,40,25,新光-高雄,2023-09-19,8562
2330,台積電,28,4,24,新光-高雄,2023-09-19,8562
5381,合正,40,16,24,新光-高雄,2023-09-19,8562
6130,上亞科技,23,0,23,新光-高雄,2023-09-19,8562
3231,緯創,198,175,23,新光-高雄,2023-09-19,8562
2412,中華電,24,2,22,新光-高雄,2023-09-19,8562
6282,康舒,30,8,22,新光-高雄,2023-09-19,8562
3042,晶技,26,5,21,新光-高雄,2023-09-19,8562
2312,金寶,23,3,20,新光-高雄,2023-09-19,8562
2303,聯電,24,4,20,新光-高雄,2023-09-19,8562
1609,大亞,26,7,19,新光-高雄,2023-09-19,8562
2605,新興,43,24,19,新光-高雄,2023-09-19,8562
2313,華通,389,371,18,新光-高雄,2023-09-19,8562
6274,台燿,79,62,17,新光-高雄,2023-09-19,8562
2301,光寶科,61,44,17,新光-高雄,2023-09-19,8562
00679B,元大美債20年,26,9,17,新光-高雄,2023-09-19,8562
2888,新光金,25,8,17,新光-高雄,2023-09-19,8562
00673R,期元大S＆P原油反1,17,0,17,新光-高雄,2023-09-19,8562
5880,合庫金,16,0,16,新光-高雄,2023-09-19,8562
2606,裕民,30,14,16,新光-高雄,2023-09-19,8562
00931B,統一美債20年,35,19,16,新光-高雄,2023-09-19,8562
3035,智原,45,29,16,新光-高雄,2023-09-19,8562
4915,致伸,17,2,15,新光-高雄,2023-09-19,8562
00922,國泰台灣領袖50,15,0,15,新光-高雄,2023-09-19,8562
2204,中華,15,1,14,新光-高雄,2023-09-19,8562
00919,群益台灣精選高息,406,93,313,新光-高雄,2023-09-20,8562
2367,燿華,343,134,209,新光-高雄,2023-09-20,8562
00673R,期元大S＆P原油反1,196,15,181,新光-高雄,2023-09-20,8562
00923,群益台ESG低碳50,139,2,137,新光-高雄,2023-09-20,8562
00712,復華富時不動產,128,15,113,新光-高雄,2023-09-20,8562
2344,華邦電,241,131,110,新光-高雄,2023-09-20,8562
3481,群創,130,22,108,新光-高雄,2023-09-20,8562
00720B,元大投資級公司債,110,17,93,新光-高雄,2023-09-20,8562
1605,華新,109,26,83,新光-高雄,2023-09-20,8562
2883,凱基金,79,1,78,新光-高雄,2023-09-20,8562
2464,盟立,76,0,76,新光-高雄,2023-09-20,8562
2313,華通,308,236,72,新光-高雄,2023-09-20,8562
2888,新光金,56,3,53,新光-高雄,2023-09-20,8562
2354,鴻準,61,15,46,新光-高雄,2023-09-20,8562
00679B,元大美債20年,51,6,45,新光-高雄,2023-09-20,8562
2492,華新科,46,2,44,新光-高雄,2023-09-20,8562
2618,長榮航,51,9,42,新光-高雄,2023-09-20,8562
3680,家登,43,1,42,新光-高雄,2023-09-20,8562
2812,台中銀,59,18,41,新光-高雄,2023-09-20,8562
00751B,元大AAA至A公司債,37,0,37,新光-高雄,2023-09-20,8562
2330,台積電,39,3,36,新光-高雄,2023-09-20,8562
6901,鑽石投資,47,15,32,新光-高雄,2023-09-20,8562
00680L,元大美債20正2,31,0,31,新光-高雄,2023-09-20,8562
2363,矽統,138,108,30,新光-高雄,2023-09-20,8562
0056,元大高股息,55,26,29,新光-高雄,2023-09-20,8562
2515,中工,30,2,28,新光-高雄,2023-09-20,8562
1101,台泥,34,7,27,新光-高雄,2023-09-20,8562
00932,兆豐永續高息等權,27,2,25,新光-高雄,2023-09-20,8562
2606,裕民,31,7,24,新光-高雄,2023-09-20,8562
2312,金寶,28,4,24,新光-高雄,2023-09-20,8562
00918,大華優利高填息30,27,4,23,新光-高雄,2023-09-20,8562
3122,笙泉,86,63,23,新光-高雄,2023-09-20,8562
3037,欣興,42,20,22,新光-高雄,2023-09-20,8562
3062,建漢,22,0,22,新光-高雄,2023-09-20,8562
3715,定穎投控,285,264,21,新光-高雄,2023-09-20,8562
00931B,統一美債20年,20,0,20,新光-高雄,2023-09-20,8562
6163,華電網,20,0,20,新光-高雄,2023-09-20,8562
1609,大亞,28,8,20,新光-高雄,2023-09-20,8562
9921,巨大,34,15,19,新光-高雄,2023-09-20,8562
00753L,中信中國50正2,37,18,19,新光-高雄,2023-09-20,8562
6515,穎崴,25,6,19,新光-高雄,2023-09-20,8562
2301,光寶科,69,50,19,新光-高雄,2023-09-20,8562
2882,國泰金,18,0,18,新光-高雄,2023-09-20,8562
2332,友訊,18,0,18,新光-高雄,2023-09-20,8562
3489,森寶,18,0,18,新光-高雄,2023-09-20,8562
2881,富邦金,18,1,17,新光-高雄,2023-09-20,8562
0050,元大台灣50,18,1,17,新光-高雄,2023-09-20,8562
2801,彰銀,16,0,16,新光-高雄,2023-09-20,8562
4908,前鼎,92,76,16,新光-高雄,2023-09-20,8562
6799,來頡,21,6,15,新光-高雄,2023-09-20,8562
00900,富邦特選高股息30,402,3,399,新光-高雄,2023-09-21,8562
2888,新光金,365,24,341,新光-高雄,2023-09-21,8562
00673R,期元大S＆P原油反1,337,0,337,新光-高雄,2023-09-21,8562
00919,群益台灣精選高息,323,31,292,新光-高雄,2023-09-21,8562
00929,復華台灣科技優息,840,653,187,新光-高雄,2023-09-21,8562
00878,國泰永續高股息,212,75,137,新光-高雄,2023-09-21,8562
0056,元大高股息,152,24,128,新光-高雄,2023-09-21,8562
2891,中信金,117,13,104,新光-高雄,2023-09-21,8562
00753L,中信中國50正2,87,0,87,新光-高雄,2023-09-21,8562
00680L,元大美債20正2,87,0,87,新光-高雄,2023-09-21,8562
00706L,期元大S＆P日圓正2,107,22,85,新光-高雄,2023-09-21,8562
2618,長榮航,99,18,81,新光-高雄,2023-09-21,8562
2905,三商,70,0,70,新光-高雄,2023-09-21,8562
00665L,富邦�琤肭磪囓�2,77,7,70,新光-高雄,2023-09-21,8562
2002,中鋼,71,1,70,新光-高雄,2023-09-21,8562
00679B,元大美債20年,68,1,67,新光-高雄,2023-09-21,8562
1101,台泥,68,0,68,新光-高雄,2023-09-21,8562
2317,鴻海,62,4,58,新光-高雄,2023-09-21,8562
3680,家登,57,3,54,新光-高雄,2023-09-21,8562
5880,合庫金,56,3,53,新光-高雄,2023-09-21,8562
00923,群益台ESG低碳50,52,0,52,新光-高雄,2023-09-21,8562
00637L,元大滬深300正2,81,31,50,新光-高雄,2023-09-21,8562
2883,凱基金,64,15,49,新光-高雄,2023-09-21,8562
2464,盟立,59,10,49,新光-高雄,2023-09-21,8562
00752,中信中國50,44,0,44,新光-高雄,2023-09-21,8562
00932,兆豐永續高息等權,43,0,43,新光-高雄,2023-09-21,8562
2330,台積電,46,3,43,新光-高雄,2023-09-21,8562
00922,國泰台灣領袖50,41,0,41,新光-高雄,2023-09-21,8562
9921,巨大,51,12,39,新光-高雄,2023-09-21,8562
6163,華電網,37,0,37,新光-高雄,2023-09-21,8562
2882,國泰金,38,1,37,新光-高雄,2023-09-21,8562
00713,元大台灣高息低波,35,1,34,新光-高雄,2023-09-21,8562
00687B,國泰20年美債,35,1,34,新光-高雄,2023-09-21,8562
00931B,統一美債20年,73,40,33,新光-高雄,2023-09-21,8562
00631L,元大台灣50正2,37,6,31,新光-高雄,2023-09-21,8562
1609,大亞,47,17,30,新光-高雄,2023-09-21,8562
00857B,永豐20年美公債,30,0,30,新光-高雄,2023-09-21,8562
00751B,元大AAA至A公司債,35,5,30,新光-高雄,2023-09-21,8562
9927,泰銘,33,3,30,新光-高雄,2023-09-21,8562
0050,元大台灣50,30,1,29,新光-高雄,2023-09-21,8562
3036,文曄,124,95,29,新光-高雄,2023-09-21,8562
2801,彰銀,30,2,28,新光-高雄,2023-09-21,8562
3045,台灣大,28,1,27,新光-高雄,2023-09-21,8562
2880,華南金,25,0,25,新光-高雄,2023-09-21,8562
3701,大眾控,25,0,25,新光-高雄,2023-09-21,8562
2605,新興,49,25,24,新光-高雄,2023-09-21,8562
4916,事欣科,29,5,24,新光-高雄,2023-09-21,8562
3231,緯創,223,200,23,新光-高雄,2023-09-21,8562
3056,富華新,23,0,23,新光-高雄,2023-09-21,8562
2363,矽統,156,133,23,新光-高雄,2023-09-21,8562
2344,華邦電,497,12,485,新光-高雄,2023-09-22,8562
2891,中信金,203,7,196,新光-高雄,2023-09-22,8562
00931B,統一美債20年,186,4,182,新光-高雄,2023-09-22,8562
00687B,國泰20年美債,194,50,144,新光-高雄,2023-09-22,8562
00712,復華富時不動產,262,122,140,新光-高雄,2023-09-22,8562
00679B,元大美債20年,174,45,129,新光-高雄,2023-09-22,8562
00720B,元大投資級公司債,133,6,127,新光-高雄,2023-09-22,8562
00857B,永豐20年美公債,124,0,124,新光-高雄,2023-09-22,8562
00929,復華台灣科技優息,402,287,115,新光-高雄,2023-09-22,8562
00919,群益台灣精選高息,165,51,114,新光-高雄,2023-09-22,8562
2409,友達,104,3,101,新光-高雄,2023-09-22,8562
00664R,國泰臺灣加權反1,100,6,94,新光-高雄,2023-09-22,8562
00680L,元大美債20正2,506,415,91,新光-高雄,2023-09-22,8562
00772B,中信高評級公司債,71,0,71,新光-高雄,2023-09-22,8562
2354,鴻準,73,4,69,新光-高雄,2023-09-22,8562
00751B,元大AAA至A公司債,66,0,66,新光-高雄,2023-09-22,8562
00795B,中信美國公債20年,67,2,65,新光-高雄,2023-09-22,8562
00885,富邦越南,60,8,52,新光-高雄,2023-09-22,8562
2883,凱基金,73,23,50,新光-高雄,2023-09-22,8562
1101,台泥,44,1,43,新光-高雄,2023-09-22,8562
00764B,群益25年美債,41,0,41,新光-高雄,2023-09-22,8562
00676R,富邦臺灣加權反1,40,0,40,新光-高雄,2023-09-22,8562
5469,瀚宇博,38,0,38,新光-高雄,2023-09-22,8562
00632R,元大台灣50反1,147,112,35,新光-高雄,2023-09-22,8562
2542,興富發,39,6,33,新光-高雄,2023-09-22,8562
00773B,中信優先金融債,32,0,32,新光-高雄,2023-09-22,8562
00669R,國泰美國道瓊反1,50,20,30,新光-高雄,2023-09-22,8562
00932,兆豐永續高息等權,39,10,29,新光-高雄,2023-09-22,8562
2303,聯電,42,15,27,新光-高雄,2023-09-22,8562
00690,兆豐藍籌30,25,0,25,新光-高雄,2023-09-22,8562
3615,安可,32,7,25,新光-高雄,2023-09-22,8562
00642U,期元大S＆P石油,25,0,25,新光-高雄,2023-09-22,8562
3450,聯鈞,204,179,25,新光-高雄,2023-09-22,8562
2888,新光金,26,3,23,新光-高雄,2023-09-22,8562
3036,文曄,95,72,23,新光-高雄,2023-09-22,8562
3489,森寶,22,0,22,新光-高雄,2023-09-22,8562
6257,矽格,71,49,22,新光-高雄,2023-09-22,8562
3265,台星科,50,28,22,新光-高雄,2023-09-22,8562
00893,國泰智能電動車,22,0,22,新光-高雄,2023-09-22,8562
4931,新盛力,21,0,21,新光-高雄,2023-09-22,8562
00722B,群益投資級電信債,22,2,20,新光-高雄,2023-09-22,8562
2330,台積電,32,13,19,新光-高雄,2023-09-22,8562
6451,訊芯-KY,63,44,19,新光-高雄,2023-09-22,8562
3163,波若威,78,59,19,新光-高雄,2023-09-22,8562
2887,台新金,16,0,16,新光-高雄,2023-09-22,8562
1402,遠東新,17,1,16,新光-高雄,2023-09-22,8562
2504,國產,16,0,16,新光-高雄,2023-09-22,8562
2485,兆赫,16,0,16,新光-高雄,2023-09-22,8562
6005,群益證,15,0,15,新光-高雄,2023-09-22,8562
3188,鑫龍騰,15,0,15,新光-高雄,2023-09-22,8562
00929,復華台灣科技優息,664,179,485,新光-高雄,2023-09-25,8562
2344,華邦電,389,79,310,新光-高雄,2023-09-25,8562
00919,群益台灣精選高息,321,16,305,新光-高雄,2023-09-25,8562
00632R,元大台灣50反1,265,5,260,新光-高雄,2023-09-25,8562
00688L,國泰20年美債正2,205,1,204,新光-高雄,2023-09-25,8562
4931,新盛力,205,1,204,新光-高雄,2023-09-25,8562
00679B,元大美債20年,158,18,140,新光-高雄,2023-09-25,8562
4979,華星光,137,35,102,新光-高雄,2023-09-25,8562
00664R,國泰臺灣加權反1,100,0,100,新光-高雄,2023-09-25,8562
00712,復華富時不動產,80,2,78,新光-高雄,2023-09-25,8562
8088,品安,101,32,69,新光-高雄,2023-09-25,8562
1101,台泥,58,2,56,新光-高雄,2023-09-25,8562
1314,中石化,50,0,50,新光-高雄,2023-09-25,8562
00931B,統一美債20年,48,2,46,新光-高雄,2023-09-25,8562
2352,佳世達,34,2,32,新光-高雄,2023-09-25,8562
2812,台中銀,53,21,32,新光-高雄,2023-09-25,8562
3322,建舜電,104,73,31,新光-高雄,2023-09-25,8562
2355,敬鵬,45,15,30,新光-高雄,2023-09-25,8562
2363,矽統,146,118,28,新光-高雄,2023-09-25,8562
3615,安可,70,42,28,新光-高雄,2023-09-25,8562
00720B,元大投資級公司債,27,0,27,新光-高雄,2023-09-25,8562
6531,愛普*,54,28,26,新光-高雄,2023-09-25,8562
5475,德宏,25,0,25,新光-高雄,2023-09-25,8562
6169,昱泉,24,0,24,新光-高雄,2023-09-25,8562
3149,正達,36,13,23,新光-高雄,2023-09-25,8562
3363,上詮,186,163,23,新光-高雄,2023-09-25,8562
2401,凌陽,23,2,21,新光-高雄,2023-09-25,8562
6189,豐藝,21,0,21,新光-高雄,2023-09-25,8562
3481,群創,19,1,18,新光-高雄,2023-09-25,8562
00753L,中信中國50正2,25,7,18,新光-高雄,2023-09-25,8562
00896,中信綠能及電動車,18,0,18,新光-高雄,2023-09-25,8562
2014,中鴻,17,0,17,新光-高雄,2023-09-25,8562
5302,太欣,17,0,17,新光-高雄,2023-09-25,8562
3680,家登,19,2,17,新光-高雄,2023-09-25,8562
1504,東元,54,37,17,新光-高雄,2023-09-25,8562
2317,鴻海,27,11,16,新光-高雄,2023-09-25,8562
00902,中信電池及儲能,16,0,16,新光-高雄,2023-09-25,8562
00922,國泰台灣領袖50,15,0,15,新光-高雄,2023-09-25,8562
2449,京元電子,36,21,15,新光-高雄,2023-09-25,8562
3013,晟銘電,28,14,14,新光-高雄,2023-09-25,8562
6418,詠昇,41,27,14,新光-高雄,2023-09-25,8562
2891,中信金,22,8,14,新光-高雄,2023-09-25,8562
1319,東陽,45,31,14,新光-高雄,2023-09-25,8562
00673R,期元大S＆P原油反1,13,0,13,新光-高雄,2023-09-25,8562
3027,盛達,22,9,13,新光-高雄,2023-09-25,8562
1324,地球,35,22,13,新光-高雄,2023-09-25,8562
9945,潤泰新,13,0,13,新光-高雄,2023-09-25,8562
3706,神達,68,56,12,新光-高雄,2023-09-25,8562
2206,三陽工業,36,24,12,新光-高雄,2023-09-25,8562
2881,富邦金,14,2,12,新光-高雄,2023-09-25,8562
00929,復華台灣科技優息,941,233,708,新光-高雄,2023-09-26,8562
00664R,國泰臺灣加權反1,200,1,199,新光-高雄,2023-09-26,8562
00919,群益台灣精選高息,194,7,187,新光-高雄,2023-09-26,8562
00680L,元大美債20正2,197,52,145,新光-高雄,2023-09-26,8562
00665L,富邦�琤肭磪囓�2,183,50,133,新光-高雄,2023-09-26,8562
00673R,期元大S＆P原油反1,122,0,122,新光-高雄,2023-09-26,8562
00931B,統一美債20年,119,11,108,新光-高雄,2023-09-26,8562
4931,新盛力,106,0,106,新光-高雄,2023-09-26,8562
00923,群益台ESG低碳50,83,2,81,新光-高雄,2023-09-26,8562
00712,復華富時不動產,86,10,76,新光-高雄,2023-09-26,8562
1101,台泥,70,2,68,新光-高雄,2023-09-26,8562
3481,群創,90,23,67,新光-高雄,2023-09-26,8562
00878,國泰永續高股息,80,18,62,新光-高雄,2023-09-26,8562
2801,彰銀,62,1,61,新光-高雄,2023-09-26,8562
1815,富喬,266,206,60,新光-高雄,2023-09-26,8562
00687B,國泰20年美債,114,56,58,新光-高雄,2023-09-26,8562
1301,台塑,52,0,52,新光-高雄,2023-09-26,8562
00679B,元大美債20年,118,66,52,新光-高雄,2023-09-26,8562
2316,楠梓電,63,11,52,新光-高雄,2023-09-26,8562
6026,福邦證,50,0,50,新光-高雄,2023-09-26,8562
3711,日月光投控,70,21,49,新光-高雄,2023-09-26,8562
00637L,元大滬深300正2,47,0,47,新光-高雄,2023-09-26,8562
00632R,元大台灣50反1,81,35,46,新光-高雄,2023-09-26,8562
2606,裕民,46,4,42,新光-高雄,2023-09-26,8562
2303,聯電,56,14,42,新光-高雄,2023-09-26,8562
00885,富邦越南,42,2,40,新光-高雄,2023-09-26,8562
9904,寶成,39,0,39,新光-高雄,2023-09-26,8562
1471,首利,37,0,37,新光-高雄,2023-09-26,8562
6405,悅城,40,3,37,新光-高雄,2023-09-26,8562
2002,中鋼,42,6,36,新光-高雄,2023-09-26,8562
2388,威盛,65,31,34,新光-高雄,2023-09-26,8562
00922,國泰台灣領袖50,34,0,34,新光-高雄,2023-09-26,8562
2645,長榮航太,56,22,34,新光-高雄,2023-09-26,8562
00772B,中信高評級公司債,36,2,34,新光-高雄,2023-09-26,8562
00795B,中信美國公債20年,33,0,33,新光-高雄,2023-09-26,8562
00932,兆豐永續高息等權,34,1,33,新光-高雄,2023-09-26,8562
2888,新光金,33,2,31,新光-高雄,2023-09-26,8562
2881,富邦金,31,0,31,新光-高雄,2023-09-26,8562
0056,元大高股息,34,4,30,新光-高雄,2023-09-26,8562
00669R,國泰美國道瓊反1,80,50,30,新光-高雄,2023-09-26,8562
00857B,永豐20年美公債,29,0,29,新光-高雄,2023-09-26,8562
2330,台積電,33,4,29,新光-高雄,2023-09-26,8562
4942,嘉彰,28,0,28,新光-高雄,2023-09-26,8562
3105,穩懋,28,1,27,新光-高雄,2023-09-26,8562
5009,榮剛,43,16,27,新光-高雄,2023-09-26,8562
00888,永豐台灣ESG,27,1,26,新光-高雄,2023-09-26,8562
3036,文曄,48,22,26,新光-高雄,2023-09-26,8562
5880,合庫金,30,4,26,新光-高雄,2023-09-26,8562
00720B,元大投資級公司債,25,0,25,新光-高雄,2023-09-26,8562
2883,凱基金,28,4,24,新光-高雄,2023-09-26,8562
00929,復華台灣科技優息,351,115,236,新光-高雄,2023-09-27,8562
00919,群益台灣精選高息,149,14,135,新光-高雄,2023-09-27,8562
00664R,國泰臺灣加權反1,100,0,100,新光-高雄,2023-09-27,8562
3231,緯創,189,97,92,新光-高雄,2023-09-27,8562
2834,臺企銀,98,9,89,新光-高雄,2023-09-27,8562
2002,中鋼,98,21,77,新光-高雄,2023-09-27,8562
0056,元大高股息,91,15,76,新光-高雄,2023-09-27,8562
00712,復華富時不動產,323,250,73,新光-高雄,2023-09-27,8562
00720B,元大投資級公司債,58,0,58,新光-高雄,2023-09-27,8562
3481,群創,59,3,56,新光-高雄,2023-09-27,8562
6026,福邦證,48,0,48,新光-高雄,2023-09-27,8562
00680L,元大美債20正2,45,0,45,新光-高雄,2023-09-27,8562
4931,新盛力,45,0,45,新光-高雄,2023-09-27,8562
4979,華星光,208,166,42,新光-高雄,2023-09-27,8562
00932,兆豐永續高息等權,42,1,41,新光-高雄,2023-09-27,8562
2337,旺宏,46,8,38,新光-高雄,2023-09-27,8562
1339,昭輝,41,7,34,新光-高雄,2023-09-27,8562
00679B,元大美債20年,39,6,33,新光-高雄,2023-09-27,8562
1301,台塑,43,10,33,新光-高雄,2023-09-27,8562
2317,鴻海,36,5,31,新光-高雄,2023-09-27,8562
2888,新光金,32,1,31,新光-高雄,2023-09-27,8562
1717,長興,30,1,29,新光-高雄,2023-09-27,8562
2883,凱基金,43,15,28,新光-高雄,2023-09-27,8562
8420,明揚,71,44,27,新光-高雄,2023-09-27,8562
2485,兆赫,25,0,25,新光-高雄,2023-09-27,8562
2303,聯電,29,4,25,新光-高雄,2023-09-27,8562
9946,三發地產,22,0,22,新光-高雄,2023-09-27,8562
00885,富邦越南,30,8,22,新光-高雄,2023-09-27,8562
2206,三陽工業,30,9,21,新光-高雄,2023-09-27,8562
6442,光聖,70,50,20,新光-高雄,2023-09-27,8562
5426,振發,20,0,20,新光-高雄,2023-09-27,8562
2891,中信金,19,1,18,新光-高雄,2023-09-27,8562
2382,廣達,96,79,17,新光-高雄,2023-09-27,8562
2812,台中銀,45,27,18,新光-高雄,2023-09-27,8562
2344,華邦電,26,9,17,新光-高雄,2023-09-27,8562
3694,海華,17,1,16,新光-高雄,2023-09-27,8562
4906,正文,17,1,16,新光-高雄,2023-09-27,8562
2886,兆豐金,18,2,16,新光-高雄,2023-09-27,8562
2520,冠德,15,0,15,新光-高雄,2023-09-27,8562
3715,定穎投控,473,459,14,新光-高雄,2023-09-27,8562
6806,森崴能源,57,43,14,新光-高雄,2023-09-27,8562
00772B,中信高評級公司債,14,0,14,新光-高雄,2023-09-27,8562
9904,寶成,14,1,13,新光-高雄,2023-09-27,8562
9945,潤泰新,33,20,13,新光-高雄,2023-09-27,8562
1314,中石化,14,2,12,新光-高雄,2023-09-27,8562
3025,星通,35,23,12,新光-高雄,2023-09-27,8562
2889,國票金,12,0,12,新光-高雄,2023-09-27,8562
3363,上詮,68,56,12,新光-高雄,2023-09-27,8562
5608,四維航,12,0,12,新光-高雄,2023-09-27,8562
0050,元大台灣50,13,1,12,新光-高雄,2023-09-27,8562
00676R,富邦臺灣加權反1,240,0,240,新光-高雄,2023-09-28,8562
00712,復華富時不動產,271,142,129,新光-高雄,2023-09-28,8562
2449,京元電子,161,39,122,新光-高雄,2023-09-28,8562
00680L,元大美債20正2,147,30,117,新光-高雄,2023-09-28,8562
3322,建舜電,137,26,111,新光-高雄,2023-09-28,8562
5426,振發,103,0,103,新光-高雄,2023-09-28,8562
00931B,統一美債20年,98,3,95,新光-高雄,2023-09-28,8562
00751B,元大AAA至A公司債,95,7,88,新光-高雄,2023-09-28,8562
00673R,期元大S＆P原油反1,92,10,82,新光-高雄,2023-09-28,8562
00720B,元大投資級公司債,85,4,81,新光-高雄,2023-09-28,8562
00637L,元大滬深300正2,134,56,78,新光-高雄,2023-09-28,8562
1605,華新,66,0,66,新光-高雄,2023-09-28,8562
2610,華航,72,7,65,新光-高雄,2023-09-28,8562
3231,緯創,287,222,65,新光-高雄,2023-09-28,8562
00687B,國泰20年美債,49,0,49,新光-高雄,2023-09-28,8562
00679B,元大美債20年,75,28,47,新光-高雄,2023-09-28,8562
4979,華星光,86,42,44,新光-高雄,2023-09-28,8562
2880,華南金,46,3,43,新光-高雄,2023-09-28,8562
2363,矽統,176,134,42,新光-高雄,2023-09-28,8562
1618,合機,187,148,39,新光-高雄,2023-09-28,8562
9904,寶成,39,1,38,新光-高雄,2023-09-28,8562
1301,台塑,35,1,34,新光-高雄,2023-09-28,8562
2316,楠梓電,93,60,33,新光-高雄,2023-09-28,8562
9946,三發地產,33,1,32,新光-高雄,2023-09-28,8562
4532,瑞智,39,10,29,新光-高雄,2023-09-28,8562
3234,光環,31,2,29,新光-高雄,2023-09-28,8562
2801,彰銀,30,2,28,新光-高雄,2023-09-28,8562
4931,新盛力,27,0,27,新光-高雄,2023-09-28,8562
00753L,中信中國50正2,26,0,26,新光-高雄,2023-09-28,8562
2408,南亞科,41,15,26,新光-高雄,2023-09-28,8562
2317,鴻海,28,3,25,新光-高雄,2023-09-28,8562
3704,合勤控,29,4,25,新光-高雄,2023-09-28,8562
2367,燿華,43,19,24,新光-高雄,2023-09-28,8562
2332,友訊,24,0,24,新光-高雄,2023-09-28,8562
3481,群創,35,11,24,新光-高雄,2023-09-28,8562
2542,興富發,36,13,23,新光-高雄,2023-09-28,8562
00665L,富邦�琤肭磪囓�2,72,50,22,新光-高雄,2023-09-28,8562
2419,仲琦,34,12,22,新光-高雄,2023-09-28,8562
1339,昭輝,22,0,22,新光-高雄,2023-09-28,8562
00885,富邦越南,24,3,21,新光-高雄,2023-09-28,8562
2816,旺旺保,44,23,21,新光-高雄,2023-09-28,8562
6275,元山,20,0,20,新光-高雄,2023-09-28,8562
8940,新天地,20,0,20,新光-高雄,2023-09-28,8562
00795B,中信美國公債20年,18,0,18,新光-高雄,2023-09-28,8562
5469,瀚宇博,17,0,17,新光-高雄,2023-09-28,8562
1101,台泥,19,2,17,新光-高雄,2023-09-28,8562
4944,兆遠,16,0,16,新光-高雄,2023-09-28,8562
2027,大成鋼,16,0,16,新光-高雄,2023-09-28,8562
2388,威盛,47,32,15,新光-高雄,2023-09-28,8562
3494,誠研,15,0,15,新光-高雄,2023-09-28,8562
00929,復華台灣科技優息,1031,155,876,新光-高雄,2023-10-02,8562
00751B,元大AAA至A公司債,172,15,157,新光-高雄,2023-10-02,8562
00720B,元大投資級公司債,140,1,139,新光-高雄,2023-10-02,8562
00885,富邦越南,120,5,115,新光-高雄,2023-10-02,8562
00632R,元大台灣50反1,248,150,98,新光-高雄,2023-10-02,8562
00679B,元大美債20年,100,24,76,新光-高雄,2023-10-02,8562
2442,新美齊,67,2,65,新光-高雄,2023-10-02,8562
2363,矽統,197,134,63,新光-高雄,2023-10-02,8562
1314,中石化,56,0,56,新光-高雄,2023-10-02,8562
2365,昆盈,55,0,55,新光-高雄,2023-10-02,8562
2356,英業達,154,102,52,新光-高雄,2023-10-02,8562
2409,友達,64,14,50,新光-高雄,2023-10-02,8562
00712,復華富時不動產,61,11,50,新光-高雄,2023-10-02,8562
00676R,富邦臺灣加權反1,50,0,50,新光-高雄,2023-10-02,8562
00772B,中信高評級公司債,46,0,46,新光-高雄,2023-10-02,8562
00715L,期街口布蘭特正2,48,4,44,新光-高雄,2023-10-02,8562
5452,佶優,69,26,43,新光-高雄,2023-10-02,8562
2603,長榮,70,30,40,新光-高雄,2023-10-02,8562
1301,台塑,40,1,39,新光-高雄,2023-10-02,8562
6703,軒郁,39,1,38,新光-高雄,2023-10-02,8562
4979,華星光,93,57,36,新光-高雄,2023-10-02,8562
1609,大亞,189,153,36,新光-高雄,2023-10-02,8562
2887,台新金,41,6,35,新光-高雄,2023-10-02,8562
00706L,期元大S＆P日圓正2,30,0,30,新光-高雄,2023-10-02,8562
00671R,富邦NASDAQ反1,36,10,26,新光-高雄,2023-10-02,8562
1711,永光,26,0,26,新光-高雄,2023-10-02,8562
00680L,元大美債20正2,109,84,25,新光-高雄,2023-10-02,8562
00923,群益台ESG低碳50,26,2,24,新光-高雄,2023-10-02,8562
2883,凱基金,23,1,22,新光-高雄,2023-10-02,8562
00673R,期元大S＆P原油反1,64,42,22,新光-高雄,2023-10-02,8562
00722B,群益投資級電信債,25,4,21,新光-高雄,2023-10-02,8562
2313,華通,58,38,20,新光-高雄,2023-10-02,8562
6285,啟��,25,5,20,新光-高雄,2023-10-02,8562
8105,凌巨,20,0,20,新光-高雄,2023-10-02,8562
2417,圓剛,39,19,20,新光-高雄,2023-10-02,8562
2812,台中銀,35,16,19,新光-高雄,2023-10-02,8562
4707,磐亞,19,0,19,新光-高雄,2023-10-02,8562
2352,佳世達,28,9,19,新光-高雄,2023-10-02,8562
2834,臺企銀,80,62,18,新光-高雄,2023-10-02,8562
00708L,期元大S＆P黃金正2,18,1,17,新光-高雄,2023-10-02,8562
8163,達方,17,0,17,新光-高雄,2023-10-02,8562
2002,中鋼,33,17,16,新光-高雄,2023-10-02,8562
4306,炎洲,17,2,15,新光-高雄,2023-10-02,8562
3715,定穎投控,271,256,15,新光-高雄,2023-10-02,8562
2891,中信金,17,4,13,新光-高雄,2023-10-02,8562
00795B,中信美國公債20年,13,0,13,新光-高雄,2023-10-02,8562
3712,永崴投控,15,2,13,新光-高雄,2023-10-02,8562
5388,中磊,13,0,13,新光-高雄,2023-10-02,8562
3325,旭品,110,97,13,新光-高雄,2023-10-02,8562
8046,南電,14,2,12,新光-高雄,2023-10-02,8562
00919,群益台灣精選高息,1590,16,1574,新光-高雄,2023-10-03,8562
00715L,期街口布蘭特正2,1108,50,1058,新光-高雄,2023-10-03,8562
00637L,元大滬深300正2,224,26,198,新光-高雄,2023-10-03,8562
00712,復華富時不動產,204,38,166,新光-高雄,2023-10-03,8562
0056,元大高股息,241,88,153,新光-高雄,2023-10-03,8562
00931B,統一美債20年,139,0,139,新光-高雄,2023-10-03,8562
2409,友達,325,208,117,新光-高雄,2023-10-03,8562
00680L,元大美債20正2,126,21,105,新光-高雄,2023-10-03,8562
00885,富邦越南,117,15,102,新光-高雄,2023-10-03,8562
2888,新光金,102,2,100,新光-高雄,2023-10-03,8562
4931,新盛力,88,0,88,新光-高雄,2023-10-03,8562
2618,長榮航,111,31,80,新光-高雄,2023-10-03,8562
2605,新興,74,2,72,新光-高雄,2023-10-03,8562
1301,台塑,72,0,72,新光-高雄,2023-10-03,8562
00753L,中信中國50正2,80,13,67,新光-高雄,2023-10-03,8562
00679B,元大美債20年,76,11,65,新光-高雄,2023-10-03,8562
00720B,元大投資級公司債,69,5,64,新光-高雄,2023-10-03,8562
3491,昇達科,65,4,61,新光-高雄,2023-10-03,8562
00882,中信中國高股息,61,0,61,新光-高雄,2023-10-03,8562
3231,緯創,218,158,60,新光-高雄,2023-10-03,8562
2442,新美齊,66,8,58,新光-高雄,2023-10-03,8562
2316,楠梓電,91,34,57,新光-高雄,2023-10-03,8562
2883,凱基金,55,0,55,新光-高雄,2023-10-03,8562
2485,兆赫,52,0,52,新光-高雄,2023-10-03,8562
8069,元太,53,4,49,新光-高雄,2023-10-03,8562
2368,金像電,94,47,47,新光-高雄,2023-10-03,8562
3013,晟銘電,120,73,47,新光-高雄,2023-10-03,8562
00929,復華台灣科技優息,522,475,47,新光-高雄,2023-10-03,8562
00751B,元大AAA至A公司債,47,2,45,新光-高雄,2023-10-03,8562
1514,亞力,90,46,44,新光-高雄,2023-10-03,8562
00922,國泰台灣領袖50,42,0,42,新光-高雄,2023-10-03,8562
3481,群創,107,66,41,新光-高雄,2023-10-03,8562
3325,旭品,389,349,40,新光-高雄,2023-10-03,8562
00665L,富邦�琤肭磪囓�2,39,1,38,新光-高雄,2023-10-03,8562
1337,再生-KY,38,0,38,新光-高雄,2023-10-03,8562
2382,廣達,129,91,38,新光-高雄,2023-10-03,8562
2002,中鋼,51,13,38,新光-高雄,2023-10-03,8562
00671R,富邦NASDAQ反1,36,0,36,新光-高雄,2023-10-03,8562
00713,元大台灣高息低波,36,0,36,新光-高雄,2023-10-03,8562
3338,泰碩,35,0,35,新光-高雄,2023-10-03,8562
6235,華孚,44,11,33,新光-高雄,2023-10-03,8562
1815,富喬,146,113,33,新光-高雄,2023-10-03,8562
2301,光寶科,64,32,32,新光-高雄,2023-10-03,8562
9105,泰金寶-DR,32,0,32,新光-高雄,2023-10-03,8562
00706L,期元大S＆P日圓正2,30,0,30,新光-高雄,2023-10-03,8562
2405,輔信,27,1,26,新光-高雄,2023-10-03,8562
2388,威盛,92,67,25,新光-高雄,2023-10-03,8562
00669R,國泰美國道瓊反1,25,0,25,新光-高雄,2023-10-03,8562
2603,長榮,35,10,25,新光-高雄,2023-10-03,8562
2610,華航,56,32,24,新光-高雄,2023-10-03,8562
00680L,元大美債20正2,704,119,585,新光-高雄,2023-10-04,8562
00900,富邦特選高股息30,384,1,383,新光-高雄,2023-10-04,8562
00929,復華台灣科技優息,345,47,298,新光-高雄,2023-10-04,8562
00712,復華富時不動產,277,10,267,新光-高雄,2023-10-04,8562
00715L,期街口布蘭特正2,220,2,218,新光-高雄,2023-10-04,8562
00720B,元大投資級公司債,219,3,216,新光-高雄,2023-10-04,8562
00919,群益台灣精選高息,112,7,105,新光-高雄,2023-10-04,8562
2884,玉山金,94,0,94,新光-高雄,2023-10-04,8562
2883,凱基金,117,30,87,新光-高雄,2023-10-04,8562
2002,中鋼,93,10,83,新光-高雄,2023-10-04,8562
00751B,元大AAA至A公司債,93,13,80,新光-高雄,2023-10-04,8562
2891,中信金,86,11,75,新光-高雄,2023-10-04,8562
5314,世紀,72,0,72,新光-高雄,2023-10-04,8562
00637L,元大滬深300正2,128,57,71,新光-高雄,2023-10-04,8562
4931,新盛力,71,0,71,新光-高雄,2023-10-04,8562
1301,台塑,70,2,68,新光-高雄,2023-10-04,8562
00706L,期元大S＆P日圓正2,95,28,67,新光-高雄,2023-10-04,8562
0056,元大高股息,82,18,64,新光-高雄,2023-10-04,8562
00907,永豐優息存股,54,0,54,新光-高雄,2023-10-04,8562
2838,聯邦銀,53,0,53,新光-高雄,2023-10-04,8562
2303,聯電,56,4,52,新光-高雄,2023-10-04,8562
00671R,富邦NASDAQ反1,90,40,50,新光-高雄,2023-10-04,8562
2409,友達,87,40,47,新光-高雄,2023-10-04,8562
00922,國泰台灣領袖50,41,0,41,新光-高雄,2023-10-04,8562
2887,台新金,41,0,41,新光-高雄,2023-10-04,8562
3062,建漢,43,5,38,新光-高雄,2023-10-04,8562
00679B,元大美債20年,148,111,37,新光-高雄,2023-10-04,8562
1802,台玻,40,4,36,新光-高雄,2023-10-04,8562
3481,群創,65,31,34,新光-高雄,2023-10-04,8562
2834,臺企銀,34,0,34,新光-高雄,2023-10-04,8562
2317,鴻海,42,8,34,新光-高雄,2023-10-04,8562
2888,新光金,240,207,33,新光-高雄,2023-10-04,8562
8086,宏捷科,106,75,31,新光-高雄,2023-10-04,8562
2014,中鴻,33,2,31,新光-高雄,2023-10-04,8562
00795B,中信美國公債20年,31,0,31,新光-高雄,2023-10-04,8562
00772B,中信高評級公司債,32,1,31,新光-高雄,2023-10-04,8562
00648R,元大S＆P500反1,30,0,30,新光-高雄,2023-10-04,8562
3231,緯創,87,57,30,新光-高雄,2023-10-04,8562
2897,王道銀行,29,0,29,新光-高雄,2023-10-04,8562
2882,國泰金,28,1,27,新光-高雄,2023-10-04,8562
3694,海華,32,6,26,新光-高雄,2023-10-04,8562
2892,第一金,40,15,25,新光-高雄,2023-10-04,8562
1711,永光,26,1,25,新光-高雄,2023-10-04,8562
00687B,國泰20年美債,91,66,25,新光-高雄,2023-10-04,8562
2330,台積電,26,2,24,新光-高雄,2023-10-04,8562
3491,昇達科,26,3,23,新光-高雄,2023-10-04,8562
00722B,群益投資級電信債,26,4,22,新光-高雄,2023-10-04,8562
00773B,中信優先金融債,22,0,22,新光-高雄,2023-10-04,8562
2352,佳世達,26,4,22,新光-高雄,2023-10-04,8562
5880,合庫金,25,3,22,新光-高雄,2023-10-04,8562
2845,遠東銀,222,0,222,新光-高雄,2023-10-05,8562
2618,長榮航,367,146,221,新光-高雄,2023-10-05,8562
00712,復華富時不動產,193,9,184,新光-高雄,2023-10-05,8562
3059,華晶科,107,6,101,新光-高雄,2023-10-05,8562
2409,友達,105,12,93,新光-高雄,2023-10-05,8562
00751B,元大AAA至A公司債,66,1,65,新光-高雄,2023-10-05,8562
2382,廣達,127,65,62,新光-高雄,2023-10-05,8562
2313,華通,94,34,60,新光-高雄,2023-10-05,8562
2891,中信金,72,22,50,新光-高雄,2023-10-05,8562
1519,華城,127,81,46,新光-高雄,2023-10-05,8562
1522,堤維西,73,27,46,新光-高雄,2023-10-05,8562
00706L,期元大S＆P日圓正2,43,0,43,新光-高雄,2023-10-05,8562
2388,威盛,69,29,40,新光-高雄,2023-10-05,8562
00882,中信中國高股息,47,10,37,新光-高雄,2023-10-05,8562
4942,嘉彰,37,0,37,新光-高雄,2023-10-05,8562
0056,元大高股息,48,12,36,新光-高雄,2023-10-05,8562
1815,富喬,143,109,34,新光-高雄,2023-10-05,8562
00676R,富邦臺灣加權反1,33,0,33,新光-高雄,2023-10-05,8562
2355,敬鵬,39,8,31,新光-高雄,2023-10-05,8562
00919,群益台灣精選高息,48,21,27,新光-高雄,2023-10-05,8562
00679B,元大美債20年,47,21,26,新光-高雄,2023-10-05,8562
00671R,富邦NASDAQ反1,36,10,26,新光-高雄,2023-10-05,8562
00719B,元大美債1-3,37,11,26,新光-高雄,2023-10-05,8562
2385,群光,24,0,24,新光-高雄,2023-10-05,8562
4979,華星光,78,55,23,新光-高雄,2023-10-05,8562
3704,合勤控,34,13,21,新光-高雄,2023-10-05,8562
2834,臺企銀,22,1,21,新光-高雄,2023-10-05,8562
1301,台塑,23,2,21,新光-高雄,2023-10-05,8562
2515,中工,20,0,20,新光-高雄,2023-10-05,8562
2427,三商電,28,9,19,新光-高雄,2023-10-05,8562
2888,新光金,19,1,18,新光-高雄,2023-10-05,8562
2812,台中銀,42,24,18,新光-高雄,2023-10-05,8562
2542,興富發,18,0,18,新光-高雄,2023-10-05,8562
2417,圓剛,171,153,18,新光-高雄,2023-10-05,8562
00637L,元大滬深300正2,17,0,17,新光-高雄,2023-10-05,8562
3325,旭品,78,61,17,新光-高雄,2023-10-05,8562
2486,一詮,311,294,17,新光-高雄,2023-10-05,8562
1314,中石化,20,3,17,新光-高雄,2023-10-05,8562
00651R,復華香港反1,16,0,16,新光-高雄,2023-10-05,8562
2201,裕隆,17,2,15,新光-高雄,2023-10-05,8562
2637,慧洋-KY,35,20,15,新光-高雄,2023-10-05,8562
3491,昇達科,19,4,15,新光-高雄,2023-10-05,8562
3027,盛達,18,4,14,新光-高雄,2023-10-05,8562
2520,冠德,14,0,14,新光-高雄,2023-10-05,8562
2356,英業達,33,19,14,新光-高雄,2023-10-05,8562
3596,智易,16,3,13,新光-高雄,2023-10-05,8562
1609,大亞,20,7,13,新光-高雄,2023-10-05,8562
3669,圓展,34,21,13,新光-高雄,2023-10-05,8562
2897,王道銀行,25,12,13,新光-高雄,2023-10-05,8562
8271,宇瞻,24,11,13,新光-高雄,2023-10-05,8562
00929,復華台灣科技優息,410,34,376,新光-高雄,2023-10-06,8562
00922,國泰台灣領袖50,289,2,287,新光-高雄,2023-10-06,8562
00715L,期街口布蘭特正2,210,22,188,新光-高雄,2023-10-06,8562
2610,華航,206,27,179,新光-高雄,2023-10-06,8562
00706L,期元大S＆P日圓正2,71,3,68,新光-高雄,2023-10-06,8562
00712,復華富時不動產,66,0,66,新光-高雄,2023-10-06,8562
00632R,元大台灣50反1,71,10,61,新光-高雄,2023-10-06,8562
00679B,元大美債20年,62,11,51,新光-高雄,2023-10-06,8562
2442,新美齊,65,18,47,新光-高雄,2023-10-06,8562
00687B,國泰20年美債,45,2,43,新光-高雄,2023-10-06,8562
2618,長榮航,69,28,41,新光-高雄,2023-10-06,8562
00919,群益台灣精選高息,41,2,39,新光-高雄,2023-10-06,8562
2409,友達,39,2,37,新光-高雄,2023-10-06,8562
00931B,統一美債20年,30,0,30,新光-高雄,2023-10-06,8562
2537,聯上發,30,0,30,新光-高雄,2023-10-06,8562
5864,致和證,28,0,28,新光-高雄,2023-10-06,8562
00720B,元大投資級公司債,28,0,28,新光-高雄,2023-10-06,8562
4979,華星光,38,12,26,新光-高雄,2023-10-06,8562
3231,緯創,145,120,25,新光-高雄,2023-10-06,8562
2888,新光金,27,3,24,新光-高雄,2023-10-06,8562
00885,富邦越南,24,0,24,新光-高雄,2023-10-06,8562
4915,致伸,24,0,24,新光-高雄,2023-10-06,8562
0056,元大高股息,36,13,23,新光-高雄,2023-10-06,8562
8112,至上,32,9,23,新光-高雄,2023-10-06,8562
00888,永豐台灣ESG,23,0,23,新光-高雄,2023-10-06,8562
1101,台泥,25,4,21,新光-高雄,2023-10-06,8562
3325,旭品,103,82,21,新光-高雄,2023-10-06,8562
00751B,元大AAA至A公司債,21,0,21,新光-高雄,2023-10-06,8562
00719B,元大美債1-3,20,0,20,新光-高雄,2023-10-06,8562
5426,振發,42,23,19,新光-高雄,2023-10-06,8562
2542,興富發,22,3,19,新光-高雄,2023-10-06,8562
6605,帝寶,19,1,18,新光-高雄,2023-10-06,8562
2301,光寶科,41,24,17,新光-高雄,2023-10-06,8562
6191,精成科,23,7,16,新光-高雄,2023-10-06,8562
2327,國巨,16,0,16,新光-高雄,2023-10-06,8562
2371,大同,19,3,16,新光-高雄,2023-10-06,8562
3481,群創,20,5,15,新光-高雄,2023-10-06,8562
3081,聯亞,24,9,15,新光-高雄,2023-10-06,8562
2458,義隆,17,2,15,新光-高雄,2023-10-06,8562
00669R,國泰美國道瓊反1,15,0,15,新光-高雄,2023-10-06,8562
00642U,期元大S＆P石油,17,2,15,新光-高雄,2023-10-06,8562
2329,華泰,51,36,15,新光-高雄,2023-10-06,8562
00772B,中信高評級公司債,14,0,14,新光-高雄,2023-10-06,8562
3035,智原,40,26,14,新光-高雄,2023-10-06,8562
6235,華孚,28,14,14,新光-高雄,2023-10-06,8562
2365,昆盈,79,65,14,新光-高雄,2023-10-06,8562
8068,全達,14,2,12,新光-高雄,2023-10-06,8562
5475,德宏,12,0,12,新光-高雄,2023-10-06,8562
2014,中鴻,12,0,12,新光-高雄,2023-10-06,8562
4967,十銓,23,11,12,新光-高雄,2023-10-06,8562
3231,緯創,488,229,259,新光-高雄,2023-10-11,8562
00919,群益台灣精選高息,401,159,242,新光-高雄,2023-10-11,8562
2449,京元電子,245,24,221,新光-高雄,2023-10-11,8562
00882,中信中國高股息,175,1,174,新光-高雄,2023-10-11,8562
00905,FT臺灣Smart,200,50,150,新光-高雄,2023-10-11,8562
2002,中鋼,106,5,101,新光-高雄,2023-10-11,8562
00648R,元大S＆P500反1,100,0,100,新光-高雄,2023-10-11,8562
1339,昭輝,100,10,90,新光-高雄,2023-10-11,8562
00680L,元大美債20正2,102,12,90,新光-高雄,2023-10-11,8562
2634,漢翔,161,93,68,新光-高雄,2023-10-11,8562
2501,國建,70,7,63,新光-高雄,2023-10-11,8562
3036,文曄,97,34,63,新光-高雄,2023-10-11,8562
2442,新美齊,74,15,59,新光-高雄,2023-10-11,8562
00679B,元大美債20年,57,3,54,新光-高雄,2023-10-11,8562
2382,廣達,198,147,51,新光-高雄,2023-10-11,8562
0056,元大高股息,136,85,51,新光-高雄,2023-10-11,8562
00922,國泰台灣領袖50,55,10,45,新光-高雄,2023-10-11,8562
2618,長榮航,69,25,44,新光-高雄,2023-10-11,8562
2515,中工,45,5,40,新光-高雄,2023-10-11,8562
3715,定穎投控,247,210,37,新光-高雄,2023-10-11,8562
1609,大亞,40,4,36,新光-高雄,2023-10-11,8562
6136,富爾特,39,6,33,新光-高雄,2023-10-11,8562
3630,新鉅科,30,0,30,新光-高雄,2023-10-11,8562
00655L,國泰中國A50正2,30,0,30,新光-高雄,2023-10-11,8562
6122,擎邦,41,15,26,新光-高雄,2023-10-11,8562
3481,群創,31,6,25,新光-高雄,2023-10-11,8562
1444,力麗,24,0,24,新光-高雄,2023-10-11,8562
00907,永豐優息存股,24,0,24,新光-高雄,2023-10-11,8562
2393,億光,23,0,23,新光-高雄,2023-10-11,8562
1605,華新,28,6,22,新光-高雄,2023-10-11,8562
2855,統一證,22,0,22,新光-高雄,2023-10-11,8562
2425,承啟,37,15,22,新光-高雄,2023-10-11,8562
2006,東和鋼鐵,22,0,22,新光-高雄,2023-10-11,8562
3234,光環,23,2,21,新光-高雄,2023-10-11,8562
2356,英業達,93,73,20,新光-高雄,2023-10-11,8562
00719B,元大美債1-3,20,0,20,新光-高雄,2023-10-11,8562
1802,台玻,21,3,18,新光-高雄,2023-10-11,8562
1101,台泥,20,2,18,新光-高雄,2023-10-11,8562
2607,榮運,24,6,18,新光-高雄,2023-10-11,8562
2812,台中銀,42,25,17,新光-高雄,2023-10-11,8562
2392,正崴,25,8,17,新光-高雄,2023-10-11,8562
00676R,富邦臺灣加權反1,17,0,17,新光-高雄,2023-10-11,8562
1504,東元,23,7,16,新光-高雄,2023-10-11,8562
2376,技嘉,81,65,16,新光-高雄,2023-10-11,8562
1612,宏泰,17,2,15,新光-高雄,2023-10-11,8562
2439,美律,20,5,15,新光-高雄,2023-10-11,8562
8926,台汽電,15,0,15,新光-高雄,2023-10-11,8562
2486,一詮,25,10,15,新光-高雄,2023-10-11,8562
2468,華經,23,8,15,新光-高雄,2023-10-11,8562
3052,夆典,14,0,14,新光-高雄,2023-10-11,8562
00919,群益台灣精選高息,481,103,378,新光-高雄,2023-10-12,8562
00905,FT臺灣Smart,259,2,257,新光-高雄,2023-10-12,8562
00715L,期街口布蘭特正2,254,40,214,新光-高雄,2023-10-12,8562
00664R,國泰臺灣加權反1,150,0,150,新光-高雄,2023-10-12,8562
4303,信立,68,0,68,新光-高雄,2023-10-12,8562
00632R,元大台灣50反1,83,26,57,新光-高雄,2023-10-12,8562
3481,群創,76,19,57,新光-高雄,2023-10-12,8562
6220,岳豐,51,0,51,新光-高雄,2023-10-12,8562
2363,矽統,393,344,49,新光-高雄,2023-10-12,8562
2850,新產,45,0,45,新光-高雄,2023-10-12,8562
5347,世界,48,8,40,新光-高雄,2023-10-12,8562
00680L,元大美債20正2,69,31,38,新光-高雄,2023-10-12,8562
00713,元大台灣高息低波,35,0,35,新光-高雄,2023-10-12,8562
2405,輔信,30,0,30,新光-高雄,2023-10-12,8562
00712,復華富時不動產,54,24,30,新光-高雄,2023-10-12,8562
2449,京元電子,61,34,27,新光-高雄,2023-10-12,8562
00679B,元大美債20年,34,8,26,新光-高雄,2023-10-12,8562
00669R,國泰美國道瓊反1,30,5,25,新光-高雄,2023-10-12,8562
00888,永豐台灣ESG,25,1,24,新光-高雄,2023-10-12,8562
00642U,期元大S＆P石油,24,0,24,新光-高雄,2023-10-12,8562
3062,建漢,28,6,22,新光-高雄,2023-10-12,8562
3322,建舜電,26,4,22,新光-高雄,2023-10-12,8562
2365,昆盈,22,0,22,新光-高雄,2023-10-12,8562
6703,軒郁,22,0,22,新光-高雄,2023-10-12,8562
3325,旭品,86,64,22,新光-高雄,2023-10-12,8562
2801,彰銀,21,0,21,新光-高雄,2023-10-12,8562
2408,南亞科,40,19,21,新光-高雄,2023-10-12,8562
6189,豐藝,35,14,21,新光-高雄,2023-10-12,8562
3188,鑫龍騰,21,1,20,新光-高雄,2023-10-12,8562
00687B,國泰20年美債,29,10,19,新光-高雄,2023-10-12,8562
8050,廣積,22,4,18,新光-高雄,2023-10-12,8562
00648R,元大S＆P500反1,18,0,18,新光-高雄,2023-10-12,8562
3548,兆利,26,9,17,新光-高雄,2023-10-12,8562
2352,佳世達,19,1,18,新光-高雄,2023-10-12,8562
00907,永豐優息存股,20,3,17,新光-高雄,2023-10-12,8562
1560,中砂,31,14,17,新光-高雄,2023-10-12,8562
9921,巨大,15,0,15,新光-高雄,2023-10-12,8562
3049,精金,15,0,15,新光-高雄,2023-10-12,8562
2392,正崴,20,6,14,新光-高雄,2023-10-12,8562
9950,萬國通,26,12,14,新光-高雄,2023-10-12,8562
1316,上曜,13,0,13,新光-高雄,2023-10-12,8562
3673,TPK-KY,13,0,13,新光-高雄,2023-10-12,8562
2356,英業達,45,33,12,新光-高雄,2023-10-12,8562
1603,華電,47,36,11,新光-高雄,2023-10-12,8562
3264,欣銓,11,0,11,新光-高雄,2023-10-12,8562
1618,合機,11,0,11,新光-高雄,2023-10-12,8562
6005,群益證,11,0,11,新光-高雄,2023-10-12,8562
1319,東陽,48,38,10,新光-高雄,2023-10-12,8562
2103,台橡,10,0,10,新光-高雄,2023-10-12,8562
00676R,富邦臺灣加權反1,100,90,10,新光-高雄,2023-10-12,8562
3481,群創,268,2,266,新光-高雄,2023-10-13,8562
0056,元大高股息,257,7,250,新光-高雄,2023-10-13,8562
00680L,元大美債20正2,250,3,247,新光-高雄,2023-10-13,8562
00905,FT臺灣Smart,212,0,212,新光-高雄,2023-10-13,8562
00878,國泰永續高股息,210,23,187,新光-高雄,2023-10-13,8562
2618,長榮航,146,5,141,新光-高雄,2023-10-13,8562
00637L,元大滬深300正2,132,0,132,新光-高雄,2023-10-13,8562
00665L,富邦�琤肭磪囓�2,145,34,111,新光-高雄,2023-10-13,8562
3231,緯創,222,124,98,新光-高雄,2023-10-13,8562
1605,華新,76,1,75,新光-高雄,2023-10-13,8562
2605,新興,75,4,71,新光-高雄,2023-10-13,8562
2436,偉詮電,72,4,68,新光-高雄,2023-10-13,8562
00679B,元大美債20年,84,18,66,新光-高雄,2023-10-13,8562
00720B,元大投資級公司債,61,0,61,新光-高雄,2023-10-13,8562
00687B,國泰20年美債,53,0,53,新光-高雄,2023-10-13,8562
00753L,中信中國50正2,65,13,52,新光-高雄,2023-10-13,8562
8112,至上,75,23,52,新光-高雄,2023-10-13,8562
2610,華航,45,4,41,新光-高雄,2023-10-13,8562
2301,光寶科,108,68,40,新光-高雄,2023-10-13,8562
00713,元大台灣高息低波,40,3,37,新光-高雄,2023-10-13,8562
00664R,國泰臺灣加權反1,36,0,36,新光-高雄,2023-10-13,8562
2838,聯邦銀,36,4,32,新光-高雄,2023-10-13,8562
2317,鴻海,56,24,32,新光-高雄,2023-10-13,8562
00919,群益台灣精選高息,133,102,31,新光-高雄,2023-10-13,8562
2371,大同,47,16,31,新光-高雄,2023-10-13,8562
1568,倉佑,64,34,30,新光-高雄,2023-10-13,8562
2324,仁寶,33,6,27,新光-高雄,2023-10-13,8562
6005,群益證,25,0,25,新光-高雄,2023-10-13,8562
00751B,元大AAA至A公司債,24,0,24,新光-高雄,2023-10-13,8562
2884,玉山金,27,3,24,新光-高雄,2023-10-13,8562
5321,美而快,25,2,23,新光-高雄,2023-10-13,8562
00712,復華富時不動產,53,30,23,新光-高雄,2023-10-13,8562
2356,英業達,70,49,21,新光-高雄,2023-10-13,8562
4162,智擎,34,13,21,新光-高雄,2023-10-13,8562
00633L,富邦上証正2,21,0,21,新光-高雄,2023-10-13,8562
1815,富喬,129,108,21,新光-高雄,2023-10-13,8562
1218,泰山,20,0,20,新光-高雄,2023-10-13,8562
3322,建舜電,22,2,20,新光-高雄,2023-10-13,8562
3313,斐成,20,0,20,新光-高雄,2023-10-13,8562
5426,振發,26,6,20,新光-高雄,2023-10-13,8562
2484,希華,19,0,19,新光-高雄,2023-10-13,8562
6024,群益期,21,2,19,新光-高雄,2023-10-13,8562
2888,新光金,21,3,18,新光-高雄,2023-10-13,8562
00772B,中信高評級公司債,18,0,18,新光-高雄,2023-10-13,8562
2881,富邦金,18,0,18,新光-高雄,2023-10-13,8562
2615,萬海,21,5,16,新光-高雄,2023-10-13,8562
00931B,統一美債20年,18,3,15,新光-高雄,2023-10-13,8562
8033,雷虎,17,2,15,新光-高雄,2023-10-13,8562
9933,中鼎,15,0,15,新光-高雄,2023-10-13,8562
2402,毅嘉,15,1,14,新光-高雄,2023-10-13,8562
00929,復華台灣科技優息,659,12,647,新光-高雄,2023-10-16,8562
2344,華邦電,355,116,239,新光-高雄,2023-10-16,8562
00919,群益台灣精選高息,248,10,238,新光-高雄,2023-10-16,8562
0056,元大高股息,186,27,159,新光-高雄,2023-10-16,8562
1905,華紙,181,65,116,新光-高雄,2023-10-16,8562
2401,凌陽,103,15,88,新光-高雄,2023-10-16,8562
2618,長榮航,105,24,81,新光-高雄,2023-10-16,8562
00637L,元大滬深300正2,102,26,76,新光-高雄,2023-10-16,8562
00922,國泰台灣領袖50,70,0,70,新光-高雄,2023-10-16,8562
00712,復華富時不動產,66,0,66,新光-高雄,2023-10-16,8562
1218,泰山,66,1,65,新光-高雄,2023-10-16,8562
3260,威剛,78,14,64,新光-高雄,2023-10-16,8562
2888,新光金,63,1,62,新光-高雄,2023-10-16,8562
1316,上曜,51,0,51,新光-高雄,2023-10-16,8562
00632R,元大台灣50反1,58,10,48,新光-高雄,2023-10-16,8562
00665L,富邦�琤肭磪囓�2,57,10,47,新光-高雄,2023-10-16,8562
00923,群益台ESG低碳50,43,1,42,新光-高雄,2023-10-16,8562
00679B,元大美債20年,58,17,41,新光-高雄,2023-10-16,8562
00676R,富邦臺灣加權反1,40,0,40,新光-高雄,2023-10-16,8562
00905,FT臺灣Smart,37,0,37,新光-高雄,2023-10-16,8562
4979,華星光,157,121,36,新光-高雄,2023-10-16,8562
1605,華新,56,20,36,新光-高雄,2023-10-16,8562
6274,台燿,65,33,32,新光-高雄,2023-10-16,8562
6156,松上,33,2,31,新光-高雄,2023-10-16,8562
2201,裕隆,78,49,29,新光-高雄,2023-10-16,8562
00878,國泰永續高股息,79,50,29,新光-高雄,2023-10-16,8562
2607,榮運,77,51,26,新光-高雄,2023-10-16,8562
2913,農林,40,14,26,新光-高雄,2023-10-16,8562
00680L,元大美債20正2,89,64,25,新光-高雄,2023-10-16,8562
1402,遠東新,24,0,24,新光-高雄,2023-10-16,8562
6120,達運,22,0,22,新光-高雄,2023-10-16,8562
2002,中鋼,23,2,21,新光-高雄,2023-10-16,8562
8054,安國,37,16,21,新光-高雄,2023-10-16,8562
3481,群創,24,3,21,新光-高雄,2023-10-16,8562
00715L,期街口布蘭特正2,62,41,21,新光-高雄,2023-10-16,8562
2393,億光,20,0,20,新光-高雄,2023-10-16,8562
9105,泰金寶-DR,20,0,20,新光-高雄,2023-10-16,8562
4162,智擎,21,1,20,新光-高雄,2023-10-16,8562
1471,首利,24,4,20,新光-高雄,2023-10-16,8562
3062,建漢,24,5,19,新光-高雄,2023-10-16,8562
2022,聚亨,20,1,19,新光-高雄,2023-10-16,8562
2462,良得電,19,0,19,新光-高雄,2023-10-16,8562
6276,安鈦克,72,53,19,新光-高雄,2023-10-16,8562
2409,友達,23,4,19,新光-高雄,2023-10-16,8562
6005,群益證,18,0,18,新光-高雄,2023-10-16,8562
2610,華航,29,13,16,新光-高雄,2023-10-16,8562
2324,仁寶,19,4,15,新光-高雄,2023-10-16,8562
00893,國泰智能電動車,15,0,15,新光-高雄,2023-10-16,8562
3056,富華新,15,0,15,新光-高雄,2023-10-16,8562
2603,長榮,17,3,14,新光-高雄,2023-10-16,8562
00637L,元大滬深300正2,757,69,688,新光-高雄,2023-10-17,8562
0056,元大高股息,357,36,321,新光-高雄,2023-10-17,8562
00680L,元大美債20正2,289,115,174,新光-高雄,2023-10-17,8562
00687B,國泰20年美債,170,0,170,新光-高雄,2023-10-17,8562
2834,臺企銀,132,10,122,新光-高雄,2023-10-17,8562
00878,國泰永續高股息,174,60,114,新光-高雄,2023-10-17,8562
2382,廣達,163,58,105,新光-高雄,2023-10-17,8562
00720B,元大投資級公司債,96,12,84,新光-高雄,2023-10-17,8562
2637,慧洋-KY,71,4,67,新光-高雄,2023-10-17,8562
2390,云辰,110,45,65,新光-高雄,2023-10-17,8562
2369,菱生,99,38,61,新光-高雄,2023-10-17,8562
00931B,統一美債20年,61,0,61,新光-高雄,2023-10-17,8562
00888,永豐台灣ESG,65,13,52,新光-高雄,2023-10-17,8562
4979,華星光,129,78,51,新光-高雄,2023-10-17,8562
00751B,元大AAA至A公司債,47,0,47,新光-高雄,2023-10-17,8562
1605,華新,60,14,46,新光-高雄,2023-10-17,8562
3062,建漢,68,26,42,新光-高雄,2023-10-17,8562
6530,創威,127,85,42,新光-高雄,2023-10-17,8562
2405,輔信,40,0,40,新光-高雄,2023-10-17,8562
00772B,中信高評級公司債,42,3,39,新光-高雄,2023-10-17,8562
00679B,元大美債20年,52,14,38,新光-高雄,2023-10-17,8562
00905,FT臺灣Smart,38,1,37,新光-高雄,2023-10-17,8562
6168,宏齊,45,12,33,新光-高雄,2023-10-17,8562
9103,美德醫療-DR,30,0,30,新光-高雄,2023-10-17,8562
9921,巨大,26,1,25,新光-高雄,2023-10-17,8562
9933,中鼎,25,0,25,新光-高雄,2023-10-17,8562
3673,TPK-KY,25,0,25,新光-高雄,2023-10-17,8562
1609,大亞,25,1,24,新光-高雄,2023-10-17,8562
2409,友達,25,2,23,新光-高雄,2023-10-17,8562
3715,定穎投控,287,264,23,新光-高雄,2023-10-17,8562
00923,群益台ESG低碳50,23,0,23,新光-高雄,2023-10-17,8562
1905,華紙,50,27,23,新光-高雄,2023-10-17,8562
00713,元大台灣高息低波,22,0,22,新光-高雄,2023-10-17,8562
2812,台中銀,22,0,22,新光-高雄,2023-10-17,8562
6288,聯嘉,23,1,22,新光-高雄,2023-10-17,8562
2352,佳世達,49,27,22,新光-高雄,2023-10-17,8562
6695,芯鼎,21,0,21,新光-高雄,2023-10-17,8562
00922,國泰台灣領袖50,21,0,21,新光-高雄,2023-10-17,8562
9105,泰金寶-DR,20,0,20,新光-高雄,2023-10-17,8562
3666,光耀,20,0,20,新光-高雄,2023-10-17,8562
2425,承啟,30,10,20,新光-高雄,2023-10-17,8562
1504,東元,27,7,20,新光-高雄,2023-10-17,8562
6691,洋基工程,20,1,19,新光-高雄,2023-10-17,8562
2618,長榮航,81,63,18,新光-高雄,2023-10-17,8562
4306,炎洲,19,1,18,新光-高雄,2023-10-17,8562
00648R,元大S＆P500反1,18,0,18,新光-高雄,2023-10-17,8562
3363,上詮,66,49,17,新光-高雄,2023-10-17,8562
2201,裕隆,28,11,17,新光-高雄,2023-10-17,8562
00706L,期元大S＆P日圓正2,16,0,16,新光-高雄,2023-10-17,8562
1324,地球,32,16,16,新光-高雄,2023-10-17,8562
0056,元大高股息,577,45,532,新光-高雄,2023-10-18,8562
00929,復華台灣科技優息,639,150,489,新光-高雄,2023-10-18,8562
00900,富邦特選高股息30,389,4,385,新光-高雄,2023-10-18,8562
00878,國泰永續高股息,313,32,281,新光-高雄,2023-10-18,8562
00919,群益台灣精選高息,213,11,202,新光-高雄,2023-10-18,8562
00922,國泰台灣領袖50,126,0,126,新光-高雄,2023-10-18,8562
3260,威剛,238,118,120,新光-高雄,2023-10-18,8562
00637L,元大滬深300正2,121,14,107,新光-高雄,2023-10-18,8562
00720B,元大投資級公司債,106,4,102,新光-高雄,2023-10-18,8562
00751B,元大AAA至A公司債,93,0,93,新光-高雄,2023-10-18,8562
2610,華航,107,17,90,新光-高雄,2023-10-18,8562
2867,三商壽,87,10,77,新光-高雄,2023-10-18,8562
2344,華邦電,138,64,74,新光-高雄,2023-10-18,8562
1101,台泥,77,6,71,新光-高雄,2023-10-18,8562
1815,富喬,129,62,67,新光-高雄,2023-10-18,8562
1102,亞泥,62,1,61,新光-高雄,2023-10-18,8562
00715L,期街口布蘭特正2,125,66,59,新光-高雄,2023-10-18,8562
3673,TPK-KY,59,0,59,新光-高雄,2023-10-18,8562
4102,永日,57,3,54,新光-高雄,2023-10-18,8562
2388,威盛,271,217,54,新光-高雄,2023-10-18,8562
00648R,元大S＆P500反1,68,20,48,新光-高雄,2023-10-18,8562
3062,建漢,48,0,48,新光-高雄,2023-10-18,8562
3701,大眾控,68,23,45,新光-高雄,2023-10-18,8562
2515,中工,98,57,41,新光-高雄,2023-10-18,8562
00923,群益台ESG低碳50,41,0,41,新光-高雄,2023-10-18,8562
00713,元大台灣高息低波,49,8,41,新光-高雄,2023-10-18,8562
2002,中鋼,50,10,40,新光-高雄,2023-10-18,8562
00679B,元大美債20年,42,3,39,新光-高雄,2023-10-18,8562
8936,國統,39,0,39,新光-高雄,2023-10-18,8562
2465,麗臺,52,17,35,新光-高雄,2023-10-18,8562
00680L,元大美債20正2,47,12,35,新光-高雄,2023-10-18,8562
2382,廣達,283,249,34,新光-高雄,2023-10-18,8562
00687B,國泰20年美債,42,10,32,新光-高雄,2023-10-18,8562
00932,兆豐永續高息等權,35,3,32,新光-高雄,2023-10-18,8562
3481,群創,53,21,32,新光-高雄,2023-10-18,8562
6150,撼訊,37,6,31,新光-高雄,2023-10-18,8562
8112,至上,37,6,31,新光-高雄,2023-10-18,8562
2363,矽統,90,59,31,新光-高雄,2023-10-18,8562
2905,三商,32,2,30,新光-高雄,2023-10-18,8562
2498,宏達電,33,4,29,新光-高雄,2023-10-18,8562
00795B,中信美國公債20年,29,1,28,新光-高雄,2023-10-18,8562
2328,廣宇,27,0,27,新光-高雄,2023-10-18,8562
00772B,中信高評級公司債,26,0,26,新光-高雄,2023-10-18,8562
1609,大亞,34,9,25,新光-高雄,2023-10-18,8562
2897,王道銀行,22,0,22,新光-高雄,2023-10-18,8562
1319,東陽,39,18,21,新光-高雄,2023-10-18,8562
1444,力麗,21,0,21,新光-高雄,2023-10-18,8562
3380,明泰,21,1,20,新光-高雄,2023-10-18,8562
4714,永捷,20,0,20,新光-高雄,2023-10-18,8562
2409,友達,33,13,20,新光-高雄,2023-10-18,8562
00637L,元大滬深300正2,576,1,575,新光-高雄,2023-10-19,8562
00680L,元大美債20正2,553,19,534,新光-高雄,2023-10-19,8562
0056,元大高股息,420,44,376,新光-高雄,2023-10-19,8562
00929,復華台灣科技優息,581,336,245,新光-高雄,2023-10-19,8562
00933B,國泰10Y+金融債,234,0,234,新光-高雄,2023-10-19,8562
00712,復華富時不動產,214,0,214,新光-高雄,2023-10-19,8562
00878,國泰永續高股息,195,24,171,新光-高雄,2023-10-19,8562
2884,玉山金,118,7,111,新光-高雄,2023-10-19,8562
6257,矽格,101,5,96,新光-高雄,2023-10-19,8562
00720B,元大投資級公司債,127,32,95,新光-高雄,2023-10-19,8562
00687B,國泰20年美債,90,0,90,新光-高雄,2023-10-19,8562
2538,基泰,78,0,78,新光-高雄,2023-10-19,8562
2317,鴻海,84,14,70,新光-高雄,2023-10-19,8562
00751B,元大AAA至A公司債,61,0,61,新光-高雄,2023-10-19,8562
1101,台泥,67,7,60,新光-高雄,2023-10-19,8562
3491,昇達科,79,25,54,新光-高雄,2023-10-19,8562
00795B,中信美國公債20年,50,0,50,新光-高雄,2023-10-19,8562
00688L,國泰20年美債正2,49,0,49,新光-高雄,2023-10-19,8562
2006,東和鋼鐵,48,0,48,新光-高雄,2023-10-19,8562
00931B,統一美債20年,47,0,47,新光-高雄,2023-10-19,8562
2883,凱基金,46,0,46,新光-高雄,2023-10-19,8562
00922,國泰台灣領袖50,42,1,41,新光-高雄,2023-10-19,8562
5355,佳總,41,0,41,新光-高雄,2023-10-19,8562
00885,富邦越南,59,22,37,新光-高雄,2023-10-19,8562
00772B,中信高評級公司債,47,12,35,新光-高雄,2023-10-19,8562
2405,輔信,35,0,35,新光-高雄,2023-10-19,8562
00648R,元大S＆P500反1,35,0,35,新光-高雄,2023-10-19,8562
00671R,富邦NASDAQ反1,29,0,29,新光-高雄,2023-10-19,8562
6136,富爾特,27,0,27,新光-高雄,2023-10-19,8562
3051,力特,27,1,26,新光-高雄,2023-10-19,8562
1711,永光,38,13,25,新光-高雄,2023-10-19,8562
3673,TPK-KY,25,0,25,新光-高雄,2023-10-19,8562
9921,巨大,25,1,24,新光-高雄,2023-10-19,8562
1314,中石化,139,115,24,新光-高雄,2023-10-19,8562
3376,新日興,31,7,24,新光-高雄,2023-10-19,8562
2834,臺企銀,74,50,24,新光-高雄,2023-10-19,8562
2002,中鋼,31,7,24,新光-高雄,2023-10-19,8562
2353,宏��,36,13,23,新光-高雄,2023-10-19,8562
00752,中信中國50,23,0,23,新光-高雄,2023-10-19,8562
2329,華泰,38,15,23,新光-高雄,2023-10-19,8562
4128,中天,34,11,23,新光-高雄,2023-10-19,8562
6130,上亞科技,21,0,21,新光-高雄,2023-10-19,8562
2399,映泰,22,1,21,新光-高雄,2023-10-19,8562
5880,合庫金,22,1,21,新光-高雄,2023-10-19,8562
00893,國泰智能電動車,30,10,20,新光-高雄,2023-10-19,8562
00713,元大台灣高息低波,29,10,19,新光-高雄,2023-10-19,8562
9945,潤泰新,21,2,19,新光-高雄,2023-10-19,8562
3715,定穎投控,350,332,18,新光-高雄,2023-10-19,8562
00907,永豐優息存股,18,0,18,新光-高雄,2023-10-19,8562
00773B,中信優先金融債,17,0,17,新光-高雄,2023-10-19,8562
00715L,期街口布蘭特正2,1033,79,954,新光-高雄,2023-10-20,8562
00712,復華富時不動產,933,16,917,新光-高雄,2023-10-20,8562
00878,國泰永續高股息,217,59,158,新光-高雄,2023-10-20,8562
0056,元大高股息,141,19,122,新光-高雄,2023-10-20,8562
00929,復華台灣科技優息,245,129,116,新光-高雄,2023-10-20,8562
00772B,中信高評級公司債,123,20,103,新光-高雄,2023-10-20,8562
2002,中鋼,100,6,94,新光-高雄,2023-10-20,8562
2883,凱基金,150,68,82,新光-高雄,2023-10-20,8562
00885,富邦越南,81,2,79,新光-高雄,2023-10-20,8562
00632R,元大台灣50反1,147,75,72,新光-高雄,2023-10-20,8562
2887,台新金,66,1,65,新光-高雄,2023-10-20,8562
00919,群益台灣精選高息,65,1,64,新光-高雄,2023-10-20,8562
00687B,國泰20年美債,82,19,63,新光-高雄,2023-10-20,8562
2317,鴻海,81,18,63,新光-高雄,2023-10-20,8562
00720B,元大投資級公司債,78,20,58,新光-高雄,2023-10-20,8562
3450,聯鈞,62,9,53,新光-高雄,2023-10-20,8562
6770,力積電,60,10,50,新光-高雄,2023-10-20,8562
2204,中華,46,0,46,新光-高雄,2023-10-20,8562
3025,星通,162,117,45,新光-高雄,2023-10-20,8562
00751B,元大AAA至A公司債,43,10,33,新光-高雄,2023-10-20,8562
8176,智捷,33,0,33,新光-高雄,2023-10-20,8562
2897,王道銀行,37,6,31,新光-高雄,2023-10-20,8562
2449,京元電子,127,98,29,新光-高雄,2023-10-20,8562
2885,元大金,33,4,29,新光-高雄,2023-10-20,8562
2880,華南金,28,0,28,新光-高雄,2023-10-20,8562
2888,新光金,104,77,27,新光-高雄,2023-10-20,8562
5516,雙喜,28,2,26,新光-高雄,2023-10-20,8562
2006,東和鋼鐵,24,0,24,新光-高雄,2023-10-20,8562
00671R,富邦NASDAQ反1,39,15,24,新光-高雄,2023-10-20,8562
3045,台灣大,23,0,23,新光-高雄,2023-10-20,8562
00753L,中信中國50正2,23,0,23,新光-高雄,2023-10-20,8562
6139,亞翔,88,65,23,新光-高雄,2023-10-20,8562
2605,新興,54,32,22,新光-高雄,2023-10-20,8562
00933B,國泰10Y+金融債,35,13,22,新光-高雄,2023-10-20,8562
2329,華泰,34,13,21,新光-高雄,2023-10-20,8562
3062,建漢,21,0,21,新光-高雄,2023-10-20,8562
1324,地球,105,84,21,新光-高雄,2023-10-20,8562
00679B,元大美債20年,46,25,21,新光-高雄,2023-10-20,8562
2881,富邦金,30,9,21,新光-高雄,2023-10-20,8562
00877,復華中國5G,21,0,21,新光-高雄,2023-10-20,8562
6605,帝寶,20,0,20,新光-高雄,2023-10-20,8562
2891,中信金,44,24,20,新光-高雄,2023-10-20,8562
00902,中信電池及儲能,19,0,19,新光-高雄,2023-10-20,8562
00907,永豐優息存股,20,1,19,新光-高雄,2023-10-20,8562
8112,至上,21,2,19,新光-高雄,2023-10-20,8562
5519,隆大,19,0,19,新光-高雄,2023-10-20,8562
3276,宇環,54,36,18,新光-高雄,2023-10-20,8562
6026,福邦證,18,0,18,新光-高雄,2023-10-20,8562
3041,揚智,108,90,18,新光-高雄,2023-10-20,8562
5355,佳總,20,3,17,新光-高雄,2023-10-20,8562
00715L,期街口布蘭特正2,483,109,374,新光-高雄,2023-10-23,8562
00929,復華台灣科技優息,531,160,371,新光-高雄,2023-10-23,8562
00712,復華富時不動產,356,51,305,新光-高雄,2023-10-23,8562
00680L,元大美債20正2,274,4,270,新光-高雄,2023-10-23,8562
00919,群益台灣精選高息,220,0,220,新光-高雄,2023-10-23,8562
00878,國泰永續高股息,196,30,166,新光-高雄,2023-10-23,8562
00751B,元大AAA至A公司債,96,0,96,新光-高雄,2023-10-23,8562
0056,元大高股息,135,41,94,新光-高雄,2023-10-23,8562
00720B,元大投資級公司債,100,15,85,新光-高雄,2023-10-23,8562
00922,國泰台灣領袖50,80,3,77,新光-高雄,2023-10-23,8562
00671R,富邦NASDAQ反1,96,25,71,新光-高雄,2023-10-23,8562
00687B,國泰20年美債,72,5,67,新光-高雄,2023-10-23,8562
00931B,統一美債20年,65,0,65,新光-高雄,2023-10-23,8562
2317,鴻海,223,162,61,新光-高雄,2023-10-23,8562
2891,中信金,63,4,59,新光-高雄,2023-10-23,8562
3481,群創,54,5,49,新光-高雄,2023-10-23,8562
00923,群益台ESG低碳50,43,0,43,新光-高雄,2023-10-23,8562
2603,長榮,41,5,36,新光-高雄,2023-10-23,8562
00933B,國泰10Y+金融債,34,0,34,新光-高雄,2023-10-23,8562
00631L,元大台灣50正2,40,7,33,新光-高雄,2023-10-23,8562
2605,新興,34,3,31,新光-高雄,2023-10-23,8562
00713,元大台灣高息低波,28,0,28,新光-高雄,2023-10-23,8562
2402,毅嘉,42,14,28,新光-高雄,2023-10-23,8562
00882,中信中國高股息,28,0,28,新光-高雄,2023-10-23,8562
2888,新光金,34,7,27,新光-高雄,2023-10-23,8562
00795B,中信美國公債20年,26,1,25,新光-高雄,2023-10-23,8562
2382,廣達,120,94,26,新光-高雄,2023-10-23,8562
00648R,元大S＆P500反1,30,5,25,新光-高雄,2023-10-23,8562
2881,富邦金,27,3,24,新光-高雄,2023-10-23,8562
2801,彰銀,22,0,22,新光-高雄,2023-10-23,8562
2610,華航,48,26,22,新光-高雄,2023-10-23,8562
2305,全友,42,20,22,新光-高雄,2023-10-23,8562
3062,建漢,22,0,22,新光-高雄,2023-10-23,8562
2330,台積電,30,9,21,新光-高雄,2023-10-23,8562
5880,合庫金,21,0,21,新光-高雄,2023-10-23,8562
00753L,中信中國50正2,21,0,21,新光-高雄,2023-10-23,8562
1301,台塑,22,2,20,新光-高雄,2023-10-23,8562
00665L,富邦�琤肭磪囓�2,20,0,20,新光-高雄,2023-10-23,8562
1709,和益,20,0,20,新光-高雄,2023-10-23,8562
5519,隆大,25,5,20,新光-高雄,2023-10-23,8562
00719B,元大美債1-3,20,0,20,新光-高雄,2023-10-23,8562
2885,元大金,19,1,18,新光-高雄,2023-10-23,8562
6244,茂迪,34,17,17,新光-高雄,2023-10-23,8562
1102,亞泥,16,0,16,新光-高雄,2023-10-23,8562
00888,永豐台灣ESG,16,0,16,新光-高雄,2023-10-23,8562
00932,兆豐永續高息等權,16,0,16,新光-高雄,2023-10-23,8562
00907,永豐優息存股,16,0,16,新光-高雄,2023-10-23,8562
1339,昭輝,16,0,16,新光-高雄,2023-10-23,8562
2409,友達,59,43,16,新光-高雄,2023-10-23,8562
2887,台新金,18,3,15,新光-高雄,2023-10-23,8562
2317,鴻海,438,45,393,新光-高雄,2023-10-24,8562
00712,復華富時不動產,250,26,224,新光-高雄,2023-10-24,8562
2449,京元電子,176,31,145,新光-高雄,2023-10-24,8562
00687B,國泰20年美債,163,30,133,新光-高雄,2023-10-24,8562
00929,復華台灣科技優息,239,115,124,新光-高雄,2023-10-24,8562
00715L,期街口布蘭特正2,91,0,91,新光-高雄,2023-10-24,8562
3044,健鼎,71,11,60,新光-高雄,2023-10-24,8562
00751B,元大AAA至A公司債,54,1,53,新光-高雄,2023-10-24,8562
5876,上海商銀,50,0,50,新光-高雄,2023-10-24,8562
00923,群益台ESG低碳50,50,1,49,新光-高雄,2023-10-24,8562
00720B,元大投資級公司債,53,6,47,新光-高雄,2023-10-24,8562
2883,凱基金,126,80,46,新光-高雄,2023-10-24,8562
9105,泰金寶-DR,52,9,43,新光-高雄,2023-10-24,8562
2486,一詮,50,8,42,新光-高雄,2023-10-24,8562
2887,台新金,42,0,42,新光-高雄,2023-10-24,8562
0056,元大高股息,329,288,41,新光-高雄,2023-10-24,8562
1905,華紙,42,2,40,新光-高雄,2023-10-24,8562
00919,群益台灣精選高息,41,3,38,新光-高雄,2023-10-24,8562
2363,矽統,69,33,36,新光-高雄,2023-10-24,8562
2834,臺企銀,46,11,35,新光-高雄,2023-10-24,8562
1101,台泥,34,0,34,新光-高雄,2023-10-24,8562
00753L,中信中國50正2,62,30,32,新光-高雄,2023-10-24,8562
00706L,期元大S＆P日圓正2,32,0,32,新光-高雄,2023-10-24,8562
00888,永豐台灣ESG,31,0,31,新光-高雄,2023-10-24,8562
2369,菱生,266,236,30,新光-高雄,2023-10-24,8562
1339,昭輝,31,2,29,新光-高雄,2023-10-24,8562
2812,台中銀,50,21,29,新光-高雄,2023-10-24,8562
00922,國泰台灣領袖50,29,2,27,新光-高雄,2023-10-24,8562
2409,友達,42,17,25,新光-高雄,2023-10-24,8562
00878,國泰永續高股息,80,56,24,新光-高雄,2023-10-24,8562
1301,台塑,26,2,24,新光-高雄,2023-10-24,8562
6508,惠光,23,0,23,新光-高雄,2023-10-24,8562
6156,松上,113,91,22,新光-高雄,2023-10-24,8562
2337,旺宏,31,9,22,新光-高雄,2023-10-24,8562
4162,智擎,109,88,21,新光-高雄,2023-10-24,8562
2408,南亞科,28,7,21,新光-高雄,2023-10-24,8562
3228,金麗科,21,0,21,新光-高雄,2023-10-24,8562
2637,慧洋-KY,23,2,21,新光-高雄,2023-10-24,8562
00631L,元大台灣50正2,30,9,21,新光-高雄,2023-10-24,8562
1303,南亞,23,3,20,新光-高雄,2023-10-24,8562
3372,典範,98,78,20,新光-高雄,2023-10-24,8562
00688L,國泰20年美債正2,35,15,20,新光-高雄,2023-10-24,8562
1711,永光,31,12,19,新光-高雄,2023-10-24,8562
3715,定穎投控,218,200,18,新光-高雄,2023-10-24,8562
00654R,富邦印度反1,18,0,18,新光-高雄,2023-10-24,8562
2867,三商壽,17,0,17,新光-高雄,2023-10-24,8562
2356,英業達,80,64,16,新光-高雄,2023-10-24,8562
2367,燿華,19,3,16,新光-高雄,2023-10-24,8562
3704,合勤控,21,6,15,新光-高雄,2023-10-24,8562
0050,元大台灣50,25,9,16,新光-高雄,2023-10-24,8562
2515,中工,1034,90,944,新光-高雄,2023-10-25,8562
3481,群創,463,158,305,新光-高雄,2023-10-25,8562
2891,中信金,156,14,142,新光-高雄,2023-10-25,8562
2633,台灣高鐵,150,9,141,新光-高雄,2023-10-25,8562
00712,復華富時不動產,132,5,127,新光-高雄,2023-10-25,8562
6269,台郡,81,0,81,新光-高雄,2023-10-25,8562
6257,矽格,81,2,79,新光-高雄,2023-10-25,8562
9105,泰金寶-DR,77,7,70,新光-高雄,2023-10-25,8562
1101,台泥,56,1,55,新光-高雄,2023-10-25,8562
1524,耿鼎,284,239,45,新光-高雄,2023-10-25,8562
00922,國泰台灣領袖50,44,0,44,新光-高雄,2023-10-25,8562
2884,玉山金,48,4,44,新光-高雄,2023-10-25,8562
00900,富邦特選高股息30,47,5,42,新光-高雄,2023-10-25,8562
2610,華航,49,10,39,新光-高雄,2023-10-25,8562
4102,永日,40,2,38,新光-高雄,2023-10-25,8562
2317,鴻海,60,25,35,新光-高雄,2023-10-25,8562
3056,富華新,42,10,32,新光-高雄,2023-10-25,8562
00687B,國泰20年美債,60,28,32,新光-高雄,2023-10-25,8562
0056,元大高股息,61,30,31,新光-高雄,2023-10-25,8562
00907,永豐優息存股,30,1,29,新光-高雄,2023-10-25,8562
3025,星通,126,98,28,新光-高雄,2023-10-25,8562
3704,合勤控,85,58,27,新光-高雄,2023-10-25,8562
2888,新光金,27,2,25,新光-高雄,2023-10-25,8562
2812,台中銀,46,25,21,新光-高雄,2023-10-25,8562
2412,中華電,22,1,21,新光-高雄,2023-10-25,8562
4306,炎洲,25,4,21,新光-高雄,2023-10-25,8562
2887,台新金,22,1,21,新光-高雄,2023-10-25,8562
2329,華泰,43,23,20,新光-高雄,2023-10-25,8562
9938,百和,22,2,20,新光-高雄,2023-10-25,8562
00688L,國泰20年美債正2,32,12,20,新光-高雄,2023-10-25,8562
00679B,元大美債20年,22,3,19,新光-高雄,2023-10-25,8562
00919,群益台灣精選高息,21,3,18,新光-高雄,2023-10-25,8562
6443,元晶,32,14,18,新光-高雄,2023-10-25,8562
2603,長榮,21,3,18,新光-高雄,2023-10-25,8562
5302,太欣,17,0,17,新光-高雄,2023-10-25,8562
1305,華夏,17,0,17,新光-高雄,2023-10-25,8562
2436,偉詮電,27,10,17,新光-高雄,2023-10-25,8562
2029,盛餘,16,0,16,新光-高雄,2023-10-25,8562
8064,東捷,16,0,16,新光-高雄,2023-10-25,8562
2880,華南金,16,0,16,新光-高雄,2023-10-25,8562
2337,旺宏,71,56,15,新光-高雄,2023-10-25,8562
2305,全友,55,41,14,新光-高雄,2023-10-25,8562
3013,晟銘電,63,50,13,新光-高雄,2023-10-25,8562
4942,嘉彰,13,0,13,新光-高雄,2023-10-25,8562
2892,第一金,17,4,13,新光-高雄,2023-10-25,8562
9962,有益,13,0,13,新光-高雄,2023-10-25,8562
9904,寶成,14,2,12,新光-高雄,2023-10-25,8562
00751B,元大AAA至A公司債,30,18,12,新光-高雄,2023-10-25,8562
6213,聯茂,33,21,12,新光-高雄,2023-10-25,8562
00670L,富邦NASDAQ正2,11,0,11,新光-高雄,2023-10-25,8562
00687B,國泰20年美債,545,20,525,新光-高雄,2023-10-26,8562
00929,復華台灣科技優息,474,61,413,新光-高雄,2023-10-26,8562
00680L,元大美債20正2,303,26,277,新光-高雄,2023-10-26,8562
0056,元大高股息,477,293,184,新光-高雄,2023-10-26,8562
00712,復華富時不動產,197,14,183,新光-高雄,2023-10-26,8562
00919,群益台灣精選高息,171,3,168,新光-高雄,2023-10-26,8562
00720B,元大投資級公司債,154,1,153,新光-高雄,2023-10-26,8562
2303,聯電,159,55,104,新光-高雄,2023-10-26,8562
00679B,元大美債20年,102,4,98,新光-高雄,2023-10-26,8562
2883,凱基金,157,60,97,新光-高雄,2023-10-26,8562
00878,國泰永續高股息,163,71,92,新光-高雄,2023-10-26,8562
00885,富邦越南,77,4,73,新光-高雄,2023-10-26,8562
0050,元大台灣50,73,2,71,新光-高雄,2023-10-26,8562
2610,華航,75,14,61,新光-高雄,2023-10-26,8562
00706L,期元大S＆P日圓正2,61,0,61,新光-高雄,2023-10-26,8562
6191,精成科,60,1,59,新光-高雄,2023-10-26,8562
00888,永豐台灣ESG,60,2,58,新光-高雄,2023-10-26,8562
1718,中纖,57,0,57,新光-高雄,2023-10-26,8562
00922,國泰台灣領袖50,54,0,54,新光-高雄,2023-10-26,8562
9105,泰金寶-DR,56,3,53,新光-高雄,2023-10-26,8562
2317,鴻海,56,7,49,新光-高雄,2023-10-26,8562
00923,群益台ESG低碳50,46,1,45,新光-高雄,2023-10-26,8562
2615,萬海,43,1,42,新光-高雄,2023-10-26,8562
1101,台泥,45,4,41,新光-高雄,2023-10-26,8562
2107,厚生,39,0,39,新光-高雄,2023-10-26,8562
2344,華邦電,44,6,38,新光-高雄,2023-10-26,8562
00772B,中信高評級公司債,35,1,34,新光-高雄,2023-10-26,8562
006208,富邦台50,33,0,33,新光-高雄,2023-10-26,8562
2888,新光金,35,3,32,新光-高雄,2023-10-26,8562
9921,巨大,31,0,31,新光-高雄,2023-10-26,8562
2884,玉山金,38,9,29,新光-高雄,2023-10-26,8562
00632R,元大台灣50反1,378,349,29,新光-高雄,2023-10-26,8562
2388,威盛,99,70,29,新光-高雄,2023-10-26,8562
3704,合勤控,67,39,28,新光-高雄,2023-10-26,8562
00669R,國泰美國道瓊反1,38,10,28,新光-高雄,2023-10-26,8562
00715L,期街口布蘭特正2,65,37,28,新光-高雄,2023-10-26,8562
00631L,元大台灣50正2,43,15,28,新光-高雄,2023-10-26,8562
2449,京元電子,170,144,26,新光-高雄,2023-10-26,8562
00713,元大台灣高息低波,31,5,26,新光-高雄,2023-10-26,8562
2605,新興,32,6,26,新光-高雄,2023-10-26,8562
1721,三晃,212,186,26,新光-高雄,2023-10-26,8562
2882,國泰金,28,2,26,新光-高雄,2023-10-26,8562
6156,松上,31,7,24,新光-高雄,2023-10-26,8562
00670L,富邦NASDAQ正2,23,0,23,新光-高雄,2023-10-26,8562
1905,華紙,23,0,23,新光-高雄,2023-10-26,8562
2891,中信金,40,17,23,新光-高雄,2023-10-26,8562
00648R,元大S＆P500反1,23,1,22,新光-高雄,2023-10-26,8562
5009,榮剛,30,8,22,新光-高雄,2023-10-26,8562
6005,群益證,22,0,22,新光-高雄,2023-10-26,8562
2337,旺宏,29,7,22,新光-高雄,2023-10-26,8562
00929,復華台灣科技優息,1134,60,1074,新光-高雄,2023-10-27,8562
2618,長榮航,261,60,201,新光-高雄,2023-10-27,8562
00712,復華富時不動產,147,23,124,新光-高雄,2023-10-27,8562
00885,富邦越南,97,1,96,新光-高雄,2023-10-27,8562
2317,鴻海,79,3,76,新光-高雄,2023-10-27,8562
2462,良得電,102,31,71,新光-高雄,2023-10-27,8562
00632R,元大台灣50反1,88,22,66,新光-高雄,2023-10-27,8562
2382,廣達,127,66,61,新光-高雄,2023-10-27,8562
5439,高技,62,9,53,新光-高雄,2023-10-27,8562
2363,矽統,53,11,42,新光-高雄,2023-10-27,8562
3060,銘異,40,0,40,新光-高雄,2023-10-27,8562
00664R,國泰臺灣加權反1,50,10,40,新光-高雄,2023-10-27,8562
2812,台中銀,46,8,38,新光-高雄,2023-10-27,8562
0056,元大高股息,54,16,38,新光-高雄,2023-10-27,8562
5009,榮剛,63,27,36,新光-高雄,2023-10-27,8562
00641R,富邦日本反1,35,0,35,新光-高雄,2023-10-27,8562
2324,仁寶,44,10,34,新光-高雄,2023-10-27,8562
2002,中鋼,48,17,31,新光-高雄,2023-10-27,8562
00919,群益台灣精選高息,42,14,28,新光-高雄,2023-10-27,8562
00670L,富邦NASDAQ正2,25,0,25,新光-高雄,2023-10-27,8562
2538,基泰,27,2,25,新光-高雄,2023-10-27,8562
3051,力特,24,1,23,新光-高雄,2023-10-27,8562
2464,盟立,23,0,23,新光-高雄,2023-10-27,8562
2337,旺宏,47,24,23,新光-高雄,2023-10-27,8562
00878,國泰永續高股息,77,55,22,新光-高雄,2023-10-27,8562
6191,精成科,25,3,22,新光-高雄,2023-10-27,8562
00772B,中信高評級公司債,35,13,22,新光-高雄,2023-10-27,8562
6442,光聖,142,120,22,新光-高雄,2023-10-27,8562
00918,大華優利高填息30,20,1,19,新光-高雄,2023-10-27,8562
3276,宇環,95,77,18,新光-高雄,2023-10-27,8562
2408,南亞科,21,3,18,新光-高雄,2023-10-27,8562
1721,三晃,42,25,17,新光-高雄,2023-10-27,8562
4707,磐亞,16,0,16,新光-高雄,2023-10-27,8562
2006,東和鋼鐵,17,1,16,新光-高雄,2023-10-27,8562
00646,元大S＆P500,15,0,15,新光-高雄,2023-10-27,8562
3035,智原,33,19,14,新光-高雄,2023-10-27,8562
2892,第一金,15,1,14,新光-高雄,2023-10-27,8562
3325,旭品,30,17,13,新光-高雄,2023-10-27,8562
2454,聯發科,16,3,13,新光-高雄,2023-10-27,8562
9950,萬國通,13,0,13,新光-高雄,2023-10-27,8562
2388,威盛,73,62,11,新光-高雄,2023-10-27,8562
6290,良維,19,8,11,新光-高雄,2023-10-27,8562
2405,輔信,13,2,11,新光-高雄,2023-10-27,8562
4161,聿新科,11,0,11,新光-高雄,2023-10-27,8562
2330,台積電,14,3,11,新光-高雄,2023-10-27,8562
6156,松上,31,20,11,新光-高雄,2023-10-27,8562
1101,台泥,11,1,10,新光-高雄,2023-10-27,8562
2107,厚生,10,0,10,新光-高雄,2023-10-27,8562
2607,榮運,15,5,10,新光-高雄,2023-10-27,8562
00676R,富邦臺灣加權反1,10,0,10,新光-高雄,2023-10-27,8562
00676R,富邦臺灣加權反1,500,0,500,新光-高雄,2023-10-30,8562
00687B,國泰20年美債,298,2,296,新光-高雄,2023-10-30,8562
2317,鴻海,458,193,265,新光-高雄,2023-10-30,8562
2610,華航,219,20,199,新光-高雄,2023-10-30,8562
00712,復華富時不動產,184,8,176,新光-高雄,2023-10-30,8562
00680L,元大美債20正2,147,3,144,新光-高雄,2023-10-30,8562
3576,聯合再生,95,28,67,新光-高雄,2023-10-30,8562
9934,成霖,65,2,63,新光-高雄,2023-10-30,8562
5439,高技,53,5,48,新光-高雄,2023-10-30,8562
00715L,期街口布蘭特正2,83,37,46,新光-高雄,2023-10-30,8562
1101,台泥,45,1,44,新光-高雄,2023-10-30,8562
2897,王道銀行,40,0,40,新光-高雄,2023-10-30,8562
2887,台新金,40,0,40,新光-高雄,2023-10-30,8562
00922,國泰台灣領袖50,38,0,38,新光-高雄,2023-10-30,8562
8110,華東,53,15,38,新光-高雄,2023-10-30,8562
2832,台產,37,0,37,新光-高雄,2023-10-30,8562
00931B,統一美債20年,34,0,34,新光-高雄,2023-10-30,8562
00679B,元大美債20年,36,2,34,新光-高雄,2023-10-30,8562
9105,泰金寶-DR,65,32,33,新光-高雄,2023-10-30,8562
00919,群益台灣精選高息,61,28,33,新光-高雄,2023-10-30,8562
2880,華南金,29,0,29,新光-高雄,2023-10-30,8562
6443,元晶,65,41,24,新光-高雄,2023-10-30,8562
006208,富邦台50,30,6,24,新光-高雄,2023-10-30,8562
2618,長榮航,30,10,20,新光-高雄,2023-10-30,8562
4108,懷特,20,0,20,新光-高雄,2023-10-30,8562
3062,建漢,34,15,19,新光-高雄,2023-10-30,8562
00751B,元大AAA至A公司債,19,0,19,新光-高雄,2023-10-30,8562
8150,南茂,21,2,19,新光-高雄,2023-10-30,8562
2352,佳世達,20,2,18,新光-高雄,2023-10-30,8562
4162,智擎,89,71,18,新光-高雄,2023-10-30,8562
2885,元大金,22,4,18,新光-高雄,2023-10-30,8562
4114,健喬,18,1,17,新光-高雄,2023-10-30,8562
2812,台中銀,33,16,17,新光-高雄,2023-10-30,8562
00907,永豐優息存股,15,0,15,新光-高雄,2023-10-30,8562
2303,聯電,33,18,15,新光-高雄,2023-10-30,8562
00720B,元大投資級公司債,17,2,15,新光-高雄,2023-10-30,8562
2882,國泰金,14,0,14,新光-高雄,2023-10-30,8562
2886,兆豐金,24,10,14,新光-高雄,2023-10-30,8562
00933B,國泰10Y+金融債,13,0,13,新光-高雄,2023-10-30,8562
0050,元大台灣50,17,4,13,新光-高雄,2023-10-30,8562
00885,富邦越南,13,0,13,新光-高雄,2023-10-30,8562
2888,新光金,30,17,13,新光-高雄,2023-10-30,8562
3710,連展投控,13,0,13,新光-高雄,2023-10-30,8562
4960,誠美材,16,3,13,新光-高雄,2023-10-30,8562
00632R,元大台灣50反1,18,5,13,新光-高雄,2023-10-30,8562
2603,長榮,27,14,13,新光-高雄,2023-10-30,8562
3290,東浦,15,3,12,新光-高雄,2023-10-30,8562
00664R,國泰臺灣加權反1,12,0,12,新光-高雄,2023-10-30,8562
2330,台積電,15,3,12,新光-高雄,2023-10-30,8562
1710,東聯,13,2,11,新光-高雄,2023-10-30,8562
0056,元大高股息,221,41,180,新光-高雄,2023-10-31,8562
3481,群創,250,71,179,新光-高雄,2023-10-31,8562
00929,復華台灣科技優息,214,72,142,新光-高雄,2023-10-31,8562
00878,國泰永續高股息,182,51,131,新光-高雄,2023-10-31,8562
00648R,元大S＆P500反1,115,0,115,新光-高雄,2023-10-31,8562
00931B,統一美債20年,105,7,98,新光-高雄,2023-10-31,8562
00900,富邦特選高股息30,88,1,87,新光-高雄,2023-10-31,8562
00919,群益台灣精選高息,255,168,87,新光-高雄,2023-10-31,8562
2888,新光金,80,2,78,新光-高雄,2023-10-31,8562
00715L,期街口布蘭特正2,93,30,63,新光-高雄,2023-10-31,8562
00650L,復華香港正2,50,1,49,新光-高雄,2023-10-31,8562
00687B,國泰20年美債,70,26,44,新光-高雄,2023-10-31,8562
2538,基泰,40,0,40,新光-高雄,2023-10-31,8562
9105,泰金寶-DR,57,20,37,新光-高雄,2023-10-31,8562
2406,國碩,127,91,36,新光-高雄,2023-10-31,8562
3035,智原,61,30,31,新光-高雄,2023-10-31,8562
2301,光寶科,45,17,28,新光-高雄,2023-10-31,8562
9921,巨大,33,5,28,新光-高雄,2023-10-31,8562
3380,明泰,56,29,27,新光-高雄,2023-10-31,8562
2006,東和鋼鐵,26,0,26,新光-高雄,2023-10-31,8562
4306,炎洲,26,0,26,新光-高雄,2023-10-31,8562
2344,華邦電,161,136,25,新光-高雄,2023-10-31,8562
00706L,期元大S＆P日圓正2,25,0,25,新光-高雄,2023-10-31,8562
9950,萬國通,24,0,24,新光-高雄,2023-10-31,8562
1324,地球,55,32,23,新光-高雄,2023-10-31,8562
00713,元大台灣高息低波,29,6,23,新光-高雄,2023-10-31,8562
2313,華通,72,51,21,新光-高雄,2023-10-31,8562
6235,華孚,63,42,21,新光-高雄,2023-10-31,8562
2610,華航,239,220,19,新光-高雄,2023-10-31,8562
1449,佳和,19,0,19,新光-高雄,2023-10-31,8562
8176,智捷,19,0,19,新光-高雄,2023-10-31,8562
2367,燿華,70,51,19,新光-高雄,2023-10-31,8562
2887,台新金,24,5,19,新光-高雄,2023-10-31,8562
6605,帝寶,18,0,18,新光-高雄,2023-10-31,8562
2405,輔信,18,1,17,新光-高雄,2023-10-31,8562
2845,遠東銀,17,0,17,新光-高雄,2023-10-31,8562
1609,大亞,39,22,17,新光-高雄,2023-10-31,8562
0050,元大台灣50,21,4,17,新光-高雄,2023-10-31,8562
00751B,元大AAA至A公司債,22,6,16,新光-高雄,2023-10-31,8562
00669R,國泰美國道瓊反1,16,0,16,新光-高雄,2023-10-31,8562
9958,世紀鋼,22,6,16,新光-高雄,2023-10-31,8562
2607,榮運,15,0,15,新光-高雄,2023-10-31,8562
00753L,中信中國50正2,25,10,15,新光-高雄,2023-10-31,8562
2363,矽統,42,27,15,新光-高雄,2023-10-31,8562
00722B,群益投資級電信債,14,0,14,新光-高雄,2023-10-31,8562
9933,中鼎,14,0,14,新光-高雄,2023-10-31,8562
6451,訊芯-KY,37,23,14,新光-高雄,2023-10-31,8562
2331,精英,17,3,14,新光-高雄,2023-10-31,8562
1409,新纖,14,0,14,新光-高雄,2023-10-31,8562
1718,中纖,14,1,13,新光-高雄,2023-10-31,8562
00929,復華台灣科技優息,261,44,217,新光-高雄,2023-11-01,8562
00885,富邦越南,189,1,188,新光-高雄,2023-11-01,8562
00878,國泰永續高股息,164,6,158,新光-高雄,2023-11-01,8562
00934,中信成長高股息,142,0,142,新光-高雄,2023-11-01,8562
00931B,統一美債20年,140,4,136,新光-高雄,2023-11-01,8562
00679B,元大美債20年,110,15,95,新光-高雄,2023-11-01,8562
00715L,期街口布蘭特正2,120,27,93,新光-高雄,2023-11-01,8562
6770,力積電,89,17,72,新光-高雄,2023-11-01,8562
00720B,元大投資級公司債,44,0,44,新光-高雄,2023-11-01,8562
00712,復華富時不動產,81,38,43,新光-高雄,2023-11-01,8562
3338,泰碩,38,2,36,新光-高雄,2023-11-01,8562
2356,英業達,97,62,35,新光-高雄,2023-11-01,8562
00922,國泰台灣領袖50,34,0,34,新光-高雄,2023-11-01,8562
2891,中信金,36,4,32,新光-高雄,2023-11-01,8562
00680L,元大美債20正2,32,0,32,新光-高雄,2023-11-01,8562
6451,訊芯-KY,40,9,31,新光-高雄,2023-11-01,8562
00687B,國泰20年美債,35,5,30,新光-高雄,2023-11-01,8562
6244,茂迪,31,2,29,新光-高雄,2023-11-01,8562
2317,鴻海,33,5,28,新光-高雄,2023-11-01,8562
6418,詠昇,36,9,27,新光-高雄,2023-11-01,8562
00935,野村臺灣新科技50,25,0,25,新光-高雄,2023-11-01,8562
2405,輔信,26,4,22,新光-高雄,2023-11-01,8562
2618,長榮航,85,63,22,新光-高雄,2023-11-01,8562
9921,巨大,21,0,21,新光-高雄,2023-11-01,8562
2006,東和鋼鐵,21,0,21,新光-高雄,2023-11-01,8562
00905,FT臺灣Smart,20,0,20,新光-高雄,2023-11-01,8562
00648R,元大S＆P500反1,20,0,20,新光-高雄,2023-11-01,8562
3032,偉訓,22,2,20,新光-高雄,2023-11-01,8562
00751B,元大AAA至A公司債,22,2,20,新光-高雄,2023-11-01,8562
2887,台新金,19,1,18,新光-高雄,2023-11-01,8562
2427,三商電,36,19,17,新光-高雄,2023-11-01,8562
00670L,富邦NASDAQ正2,18,1,17,新光-高雄,2023-11-01,8562
00671R,富邦NASDAQ反1,23,7,16,新光-高雄,2023-11-01,8562
4108,懷特,15,0,15,新光-高雄,2023-11-01,8562
2739,寒舍,15,0,15,新光-高雄,2023-11-01,8562
2884,玉山金,15,1,14,新光-高雄,2023-11-01,8562
3059,華晶科,13,0,13,新光-高雄,2023-11-01,8562
2107,厚生,13,0,13,新光-高雄,2023-11-01,8562
3346,麗清,12,0,12,新光-高雄,2023-11-01,8562
00933B,國泰10Y+金融債,12,0,12,新光-高雄,2023-11-01,8562
3548,兆利,53,42,11,新光-高雄,2023-11-01,8562
2409,友達,40,30,10,新光-高雄,2023-11-01,8562
9927,泰銘,10,0,10,新光-高雄,2023-11-01,8562
9949,琉園,10,0,10,新光-高雄,2023-11-01,8562
9950,萬國通,20,10,10,新光-高雄,2023-11-01,8562
2886,兆豐金,10,0,10,新光-高雄,2023-11-01,8562
3715,定穎投控,287,277,10,新光-高雄,2023-11-01,8562
3545,敦泰,15,6,9,新光-高雄,2023-11-01,8562
8936,國統,40,31,9,新光-高雄,2023-11-01,8562
1717,長興,9,0,9,新光-高雄,2023-11-01,8562
00676R,富邦臺灣加權反1,520,0,520,新光-高雄,2023-11-02,8562
00632R,元大台灣50反1,554,42,512,新光-高雄,2023-11-02,8562
00712,復華富時不動產,226,78,148,新光-高雄,2023-11-02,8562
00931B,統一美債20年,120,10,110,新光-高雄,2023-11-02,8562
00687B,國泰20年美債,158,49,109,新光-高雄,2023-11-02,8562
00664R,國泰臺灣加權反1,100,0,100,新光-高雄,2023-11-02,8562
00715L,期街口布蘭特正2,80,0,80,新光-高雄,2023-11-02,8562
4303,信立,49,0,49,新光-高雄,2023-11-02,8562
00934,中信成長高股息,59,13,46,新光-高雄,2023-11-02,8562
2913,農林,61,19,42,新光-高雄,2023-11-02,8562
1312,國喬,40,0,40,新光-高雄,2023-11-02,8562
00671R,富邦NASDAQ反1,41,5,36,新光-高雄,2023-11-02,8562
6548,長科*,30,0,30,新光-高雄,2023-11-02,8562
2634,漢翔,32,4,28,新光-高雄,2023-11-02,8562
2006,東和鋼鐵,27,2,25,新光-高雄,2023-11-02,8562
2329,華泰,35,10,25,新光-高雄,2023-11-02,8562
00773B,中信優先金融債,20,0,20,新光-高雄,2023-11-02,8562
2376,技嘉,67,47,20,新光-高雄,2023-11-02,8562
8112,至上,31,11,20,新光-高雄,2023-11-02,8562
1101,台泥,24,4,20,新光-高雄,2023-11-02,8562
00670L,富邦NASDAQ正2,25,7,18,新光-高雄,2023-11-02,8562
00680L,元大美債20正2,197,179,18,新光-高雄,2023-11-02,8562
5356,協益,24,8,16,新光-高雄,2023-11-02,8562
4306,炎洲,14,0,14,新光-高雄,2023-11-02,8562
6284,佳邦,29,15,14,新光-高雄,2023-11-02,8562
6274,台燿,68,55,13,新光-高雄,2023-11-02,8562
4167,松瑞藥,17,4,13,新光-高雄,2023-11-02,8562
00751B,元大AAA至A公司債,15,2,13,新光-高雄,2023-11-02,8562
8110,華東,23,11,12,新光-高雄,2023-11-02,8562
6278,台表科,13,1,12,新光-高雄,2023-11-02,8562
2401,凌陽,11,0,11,新光-高雄,2023-11-02,8562
4162,智擎,26,15,11,新光-高雄,2023-11-02,8562
2883,凱基金,33,22,11,新光-高雄,2023-11-02,8562
00648R,元大S＆P500反1,10,0,10,新光-高雄,2023-11-02,8562
00725B,國泰投資級公司債,10,0,10,新光-高雄,2023-11-02,8562
02001L,富邦蘋果正二N,10,0,10,新光-高雄,2023-11-02,8562
4906,正文,14,4,10,新光-高雄,2023-11-02,8562
5531,鄉林,10,0,10,新光-高雄,2023-11-02,8562
00935,野村臺灣新科技50,9,0,9,新光-高雄,2023-11-02,8562
2905,三商,9,0,9,新光-高雄,2023-11-02,8562
8044,網家,12,3,9,新光-高雄,2023-11-02,8562
6669,緯穎,9,0,9,新光-高雄,2023-11-02,8562
9958,世紀鋼,30,22,8,新光-高雄,2023-11-02,8562
2812,台中銀,24,16,8,新光-高雄,2023-11-02,8562
00655L,國泰中國A50正2,8,0,8,新光-高雄,2023-11-02,8562
4102,永日,8,0,8,新光-高雄,2023-11-02,8562
3702,大聯大,25,18,7,新光-高雄,2023-11-02,8562
3322,建舜電,18,11,7,新光-高雄,2023-11-02,8562
9105,泰金寶-DR,43,36,7,新光-高雄,2023-11-02,8562
2605,新興,7,0,7,新光-高雄,2023-11-02,8562
2618,長榮航,901,409,492,新光-高雄,2023-11-03,8562
2363,矽統,621,371,250,新光-高雄,2023-11-03,8562
00664R,國泰臺灣加權反1,150,0,150,新光-高雄,2023-11-03,8562
00679B,元大美債20年,197,53,144,新光-高雄,2023-11-03,8562
00712,復華富時不動產,225,85,140,新光-高雄,2023-11-03,8562
00878,國泰永續高股息,177,37,140,新光-高雄,2023-11-03,8562
00632R,元大台灣50反1,259,192,67,新光-高雄,2023-11-03,8562
3481,群創,150,86,64,新光-高雄,2023-11-03,8562
00673R,期元大S＆P原油反1,79,15,64,新光-高雄,2023-11-03,8562
00935,野村臺灣新科技50,48,0,48,新光-高雄,2023-11-03,8562
3036A,文曄甲特,42,3,39,新光-高雄,2023-11-03,8562
00931B,統一美債20年,46,10,36,新光-高雄,2023-11-03,8562
2409,友達,124,90,34,新光-高雄,2023-11-03,8562
00922,國泰台灣領袖50,32,1,31,新光-高雄,2023-11-03,8562
1611,中電,30,0,30,新光-高雄,2023-11-03,8562
00676R,富邦臺灣加權反1,30,0,30,新光-高雄,2023-11-03,8562
2538,基泰,29,0,29,新光-高雄,2023-11-03,8562
2406,國碩,25,0,25,新光-高雄,2023-11-03,8562
9105,泰金寶-DR,24,0,24,新光-高雄,2023-11-03,8562
3322,建舜電,50,26,24,新光-高雄,2023-11-03,8562
2610,華航,218,194,24,新光-高雄,2023-11-03,8562
00773B,中信優先金融債,23,0,23,新光-高雄,2023-11-03,8562
6237,驊訊,53,30,23,新光-高雄,2023-11-03,8562
8048,德勝,23,0,23,新光-高雄,2023-11-03,8562
2458,義隆,36,15,21,新光-高雄,2023-11-03,8562
00795B,中信美國公債20年,30,10,20,新光-高雄,2023-11-03,8562
2801,彰銀,20,0,20,新光-高雄,2023-11-03,8562
1815,富喬,216,196,20,新光-高雄,2023-11-03,8562
6290,良維,19,0,19,新光-高雄,2023-11-03,8562
2369,菱生,28,9,19,新光-高雄,2023-11-03,8562
3548,兆利,32,13,19,新光-高雄,2023-11-03,8562
00933B,國泰10Y+金融債,32,13,19,新光-高雄,2023-11-03,8562
3014,聯陽,35,17,18,新光-高雄,2023-11-03,8562
2353,宏��,29,11,18,新光-高雄,2023-11-03,8562
3303,岱稜,17,0,17,新光-高雄,2023-11-03,8562
2402,毅嘉,20,3,17,新光-高雄,2023-11-03,8562
2390,云辰,40,23,17,新光-高雄,2023-11-03,8562
4162,智擎,56,40,16,新光-高雄,2023-11-03,8562
6112,邁達特,27,11,16,新光-高雄,2023-11-03,8562
00900,富邦特選高股息30,19,3,16,新光-高雄,2023-11-03,8562
3576,聯合再生,16,0,16,新光-高雄,2023-11-03,8562
00751B,元大AAA至A公司債,29,15,14,新光-高雄,2023-11-03,8562
6191,精成科,29,15,14,新光-高雄,2023-11-03,8562
2453,凌群,20,7,13,新光-高雄,2023-11-03,8562
8068,全達,46,34,12,新光-高雄,2023-11-03,8562
2515,中工,20,8,12,新光-高雄,2023-11-03,8562
1324,地球,50,39,11,新光-高雄,2023-11-03,8562
2006,東和鋼鐵,12,1,11,新光-高雄,2023-11-03,8562
8176,智捷,11,0,11,新光-高雄,2023-11-03,8562
6176,瑞儀,12,1,11,新光-高雄,2023-11-03,8562
00664R,國泰臺灣加權反1,200,0,200,新光-高雄,2023-11-06,8562
00720B,元大投資級公司債,183,12,171,新光-高雄,2023-11-06,8562
9103,美德醫療-DR,150,0,150,新光-高雄,2023-11-06,8562
00679B,元大美債20年,131,7,124,新光-高雄,2023-11-06,8562
00715L,期街口布蘭特正2,114,2,112,新光-高雄,2023-11-06,8562
2472,立隆電,70,0,70,新光-高雄,2023-11-06,8562
2388,威盛,322,259,63,新光-高雄,2023-11-06,8562
2363,矽統,353,291,62,新光-高雄,2023-11-06,8562
1455,集盛,57,0,57,新光-高雄,2023-11-06,8562
1721,三晃,100,44,56,新光-高雄,2023-11-06,8562
1560,中砂,49,1,48,新光-高雄,2023-11-06,8562
2882,國泰金,63,16,47,新光-高雄,2023-11-06,8562
6799,來頡,41,0,41,新光-高雄,2023-11-06,8562
00632R,元大台灣50反1,246,206,40,新光-高雄,2023-11-06,8562
4303,信立,40,0,40,新光-高雄,2023-11-06,8562
3036A,文曄甲特,42,4,38,新光-高雄,2023-11-06,8562
1718,中纖,35,0,35,新光-高雄,2023-11-06,8562
2002,中鋼,74,43,31,新光-高雄,2023-11-06,8562
2618,長榮航,132,102,30,新光-高雄,2023-11-06,8562
00885,富邦越南,43,16,27,新光-高雄,2023-11-06,8562
00648R,元大S＆P500反1,50,23,27,新光-高雄,2023-11-06,8562
00751B,元大AAA至A公司債,33,8,25,新光-高雄,2023-11-06,8562
5213,亞昕,30,5,25,新光-高雄,2023-11-06,8562
3051,力特,58,33,25,新光-高雄,2023-11-06,8562
00934,中信成長高股息,33,10,23,新光-高雄,2023-11-06,8562
1504,東元,25,2,23,新光-高雄,2023-11-06,8562
2888,新光金,63,40,23,新光-高雄,2023-11-06,8562
00907,永豐優息存股,22,0,22,新光-高雄,2023-11-06,8562
6182,合晶,30,9,21,新光-高雄,2023-11-06,8562
00933B,國泰10Y+金融債,25,5,20,新光-高雄,2023-11-06,8562
1217,愛之味,26,6,20,新光-高雄,2023-11-06,8562
2303,聯電,82,63,19,新光-高雄,2023-11-06,8562
3704,合勤控,52,33,19,新光-高雄,2023-11-06,8562
2515,中工,19,0,19,新光-高雄,2023-11-06,8562
4401,東隆興,19,1,18,新光-高雄,2023-11-06,8562
1514,亞力,22,4,18,新光-高雄,2023-11-06,8562
2408,南亞科,40,23,17,新光-高雄,2023-11-06,8562
2031,新光鋼,23,6,17,新光-高雄,2023-11-06,8562
5301,寶得利,17,0,17,新光-高雄,2023-11-06,8562
6278,台表科,16,0,16,新光-高雄,2023-11-06,8562
2486,一詮,54,39,15,新光-高雄,2023-11-06,8562
2488,漢平,16,1,15,新光-高雄,2023-11-06,8562
00692,富邦公司治理,15,0,15,新光-高雄,2023-11-06,8562
6770,力積電,26,11,15,新光-高雄,2023-11-06,8562
6139,亞翔,46,32,14,新光-高雄,2023-11-06,8562
3032,偉訓,21,7,14,新光-高雄,2023-11-06,8562
6274,台燿,25,11,14,新光-高雄,2023-11-06,8562
3535,晶彩科,38,24,14,新光-高雄,2023-11-06,8562
2542,興富發,14,1,13,新光-高雄,2023-11-06,8562
2485,兆赫,14,1,13,新光-高雄,2023-11-06,8562
00934,中信成長高股息,2142,3,2139,新光-高雄,2023-11-07,8562
1815,富喬,639,156,483,新光-高雄,2023-11-07,8562
00878,國泰永續高股息,385,22,363,新光-高雄,2023-11-07,8562
00664R,國泰臺灣加權反1,150,0,150,新光-高雄,2023-11-07,8562
2610,華航,160,18,142,新光-高雄,2023-11-07,8562
00680L,元大美債20正2,146,24,122,新光-高雄,2023-11-07,8562
00720B,元大投資級公司債,119,2,117,新光-高雄,2023-11-07,8562
00882,中信中國高股息,104,0,104,新光-高雄,2023-11-07,8562
2354,鴻準,102,0,102,新光-高雄,2023-11-07,8562
1314,中石化,109,9,100,新光-高雄,2023-11-07,8562
00632R,元大台灣50反1,155,62,93,新光-高雄,2023-11-07,8562
00751B,元大AAA至A公司債,66,2,64,新光-高雄,2023-11-07,8562
3481,群創,69,7,62,新光-高雄,2023-11-07,8562
00919,群益台灣精選高息,64,3,61,新光-高雄,2023-11-07,8562
00712,復華富時不動產,66,9,57,新光-高雄,2023-11-07,8562
2002,中鋼,83,30,53,新光-高雄,2023-11-07,8562
2317,鴻海,56,4,52,新光-高雄,2023-11-07,8562
2888,新光金,53,2,51,新光-高雄,2023-11-07,8562
00679B,元大美債20年,48,0,48,新光-高雄,2023-11-07,8562
4401,東隆興,45,0,45,新光-高雄,2023-11-07,8562
00687B,國泰20年美債,44,1,43,新光-高雄,2023-11-07,8562
00931B,統一美債20年,46,5,41,新光-高雄,2023-11-07,8562
5351,鈺創,61,21,40,新光-高雄,2023-11-07,8562
6125,廣運,39,1,38,新光-高雄,2023-11-07,8562
00902,中信電池及儲能,33,1,32,新光-高雄,2023-11-07,8562
2498,宏達電,41,14,27,新光-高雄,2023-11-07,8562
5426,振發,25,0,25,新光-高雄,2023-11-07,8562
5009,榮剛,25,0,25,新光-高雄,2023-11-07,8562
2374,佳能,25,0,25,新光-高雄,2023-11-07,8562
00715L,期街口布蘭特正2,39,15,24,新光-高雄,2023-11-07,8562
2442,新美齊,24,0,24,新光-高雄,2023-11-07,8562
1605,華新,27,4,23,新光-高雄,2023-11-07,8562
2486,一詮,28,5,23,新光-高雄,2023-11-07,8562
3623,富晶通,38,15,23,新光-高雄,2023-11-07,8562
1449,佳和,57,34,23,新光-高雄,2023-11-07,8562
00929,復華台灣科技優息,240,218,22,新光-高雄,2023-11-07,8562
3036A,文曄甲特,27,6,21,新光-高雄,2023-11-07,8562
2385,群光,29,9,20,新光-高雄,2023-11-07,8562
2453,凌群,92,72,20,新光-高雄,2023-11-07,8562
5258,虹堡,41,22,19,新光-高雄,2023-11-07,8562
6530,創威,19,1,18,新光-高雄,2023-11-07,8562
2634,漢翔,21,3,18,新光-高雄,2023-11-07,8562
00922,國泰台灣領袖50,25,7,18,新光-高雄,2023-11-07,8562
6605,帝寶,17,0,17,新光-高雄,2023-11-07,8562
6274,台燿,26,10,16,新光-高雄,2023-11-07,8562
2889,國票金,16,0,16,新光-高雄,2023-11-07,8562
2371,大同,17,1,16,新光-高雄,2023-11-07,8562
6148,驊宏資,16,0,16,新光-高雄,2023-11-07,8562
6863,永道-KY,16,0,16,新光-高雄,2023-11-07,8562
00650L,復華香港正2,16,0,16,新光-高雄,2023-11-07,8562
00679B,元大美債20年,263,7,256,新光-高雄,2023-11-08,8562
00715L,期街口布蘭特正2,190,16,174,新光-高雄,2023-11-08,8562
00936,台新永續高息中小,305,146,159,新光-高雄,2023-11-08,8562
00680L,元大美債20正2,234,109,125,新光-高雄,2023-11-08,8562
5258,虹堡,172,71,101,新光-高雄,2023-11-08,8562
5213,亞昕,90,2,88,新光-高雄,2023-11-08,8562
2610,華航,215,130,85,新光-高雄,2023-11-08,8562
00632R,元大台灣50反1,146,65,81,新光-高雄,2023-11-08,8562
00934,中信成長高股息,74,8,66,新光-高雄,2023-11-08,8562
2888,新光金,62,0,62,新光-高雄,2023-11-08,8562
1449,佳和,64,9,55,新光-高雄,2023-11-08,8562
2363,矽統,347,293,54,新光-高雄,2023-11-08,8562
00664R,國泰臺灣加權反1,50,0,50,新光-高雄,2023-11-08,8562
2002,中鋼,51,5,46,新光-高雄,2023-11-08,8562
3504,揚明光,43,1,42,新光-高雄,2023-11-08,8562
2409,友達,45,3,42,新光-高雄,2023-11-08,8562
3481,群創,77,37,40,新光-高雄,2023-11-08,8562
6530,創威,67,29,38,新光-高雄,2023-11-08,8562
2337,旺宏,37,3,34,新光-高雄,2023-11-08,8562
2812,台中銀,74,40,34,新光-高雄,2023-11-08,8562
3221,台嘉碩,35,2,33,新光-高雄,2023-11-08,8562
5351,鈺創,37,6,31,新光-高雄,2023-11-08,8562
4167,松瑞藥,37,7,30,新光-高雄,2023-11-08,8562
2374,佳能,30,1,29,新光-高雄,2023-11-08,8562
00665L,富邦�琤肭磪囓�2,26,0,26,新光-高雄,2023-11-08,8562
2388,威盛,136,112,24,新光-高雄,2023-11-08,8562
6901,鑽石投資,49,27,22,新光-高雄,2023-11-08,8562
1109,信大,22,0,22,新光-高雄,2023-11-08,8562
2303,聯電,43,22,21,新光-高雄,2023-11-08,8562
5519,隆大,30,10,20,新光-高雄,2023-11-08,8562
1455,集盛,20,0,20,新光-高雄,2023-11-08,8562
2515,中工,30,11,19,新光-高雄,2023-11-08,8562
2834,臺企銀,19,0,19,新光-高雄,2023-11-08,8562
6147,頎邦,18,1,17,新光-高雄,2023-11-08,8562
00907,永豐優息存股,16,0,16,新光-高雄,2023-11-08,8562
2399,映泰,16,0,16,新光-高雄,2023-11-08,8562
3036,文曄,96,80,16,新光-高雄,2023-11-08,8562
2542,興富發,15,0,15,新光-高雄,2023-11-08,8562
5347,世界,29,14,15,新光-高雄,2023-11-08,8562
1504,東元,16,1,15,新光-高雄,2023-11-08,8562
5474,聰泰,15,0,15,新光-高雄,2023-11-08,8562
6290,良維,57,42,15,新光-高雄,2023-11-08,8562
4908,前鼎,36,22,14,新光-高雄,2023-11-08,8562
6188,廣明,19,5,14,新光-高雄,2023-11-08,8562
4743,合一,72,58,14,新光-高雄,2023-11-08,8562
00885,富邦越南,26,13,13,新光-高雄,2023-11-08,8562
00688L,國泰20年美債正2,17,4,13,新光-高雄,2023-11-08,8562
2603,長榮,17,5,12,新光-高雄,2023-11-08,8562
1608,華榮,12,0,12,新光-高雄,2023-11-08,8562
2316,楠梓電,14,2,12,新光-高雄,2023-11-08,8562
00929,復華台灣科技優息,2046,241,1805,新光-高雄,2023-11-09,8562
00715L,期街口布蘭特正2,240,2,238,新光-高雄,2023-11-09,8562
00664R,國泰臺灣加權反1,150,0,150,新光-高雄,2023-11-09,8562
00936,台新永續高息中小,161,16,145,新光-高雄,2023-11-09,8562
00878,國泰永續高股息,208,65,143,新光-高雄,2023-11-09,8562
00902,中信電池及儲能,105,0,105,新光-高雄,2023-11-09,8562
00632R,元大台灣50反1,140,45,95,新光-高雄,2023-11-09,8562
00665L,富邦�琤肭磪囓�2,274,185,89,新光-高雄,2023-11-09,8562
6150,撼訊,122,38,84,新光-高雄,2023-11-09,8562
2883,凱基金,95,18,77,新光-高雄,2023-11-09,8562
2329,華泰,202,126,76,新光-高雄,2023-11-09,8562
4533,協易機,75,11,64,新光-高雄,2023-11-09,8562
2363,矽統,361,311,50,新光-高雄,2023-11-09,8562
2515,中工,54,7,47,新光-高雄,2023-11-09,8562
00642U,期元大S＆P石油,48,2,46,新光-高雄,2023-11-09,8562
1449,佳和,50,5,45,新光-高雄,2023-11-09,8562
1324,地球,71,27,44,新光-高雄,2023-11-09,8562
5213,亞昕,42,0,42,新光-高雄,2023-11-09,8562
1515,力山,46,5,41,新光-高雄,2023-11-09,8562
9105,泰金寶-DR,40,0,40,新光-高雄,2023-11-09,8562
00688L,國泰20年美債正2,48,10,38,新光-高雄,2023-11-09,8562
2317,鴻海,63,26,37,新光-高雄,2023-11-09,8562
2486,一詮,69,34,35,新光-高雄,2023-11-09,8562
6805,富世達,36,2,34,新光-高雄,2023-11-09,8562
2891,中信金,58,25,33,新光-高雄,2023-11-09,8562
00933B,國泰10Y+金融債,32,0,32,新光-高雄,2023-11-09,8562
2356,英業達,95,65,30,新光-高雄,2023-11-09,8562
00753L,中信中國50正2,29,0,29,新光-高雄,2023-11-09,8562
8086,宏捷科,68,39,29,新光-高雄,2023-11-09,8562
4906,正文,29,1,28,新光-高雄,2023-11-09,8562
2867,三商壽,27,0,27,新光-高雄,2023-11-09,8562
6922,宸曜,28,1,27,新光-高雄,2023-11-09,8562
2344,華邦電,57,31,26,新光-高雄,2023-11-09,8562
2390,云辰,45,19,26,新光-高雄,2023-11-09,8562
2427,三商電,25,0,25,新光-高雄,2023-11-09,8562
6285,啟��,45,24,21,新光-高雄,2023-11-09,8562
1522,堤維西,57,36,21,新光-高雄,2023-11-09,8562
3062,建漢,31,10,21,新光-高雄,2023-11-09,8562
3078,僑威,32,12,20,新光-高雄,2023-11-09,8562
3346,麗清,22,2,20,新光-高雄,2023-11-09,8562
3504,揚明光,20,0,20,新光-高雄,2023-11-09,8562
5516,雙喜,20,0,20,新光-高雄,2023-11-09,8562
2331,精英,54,34,20,新光-高雄,2023-11-09,8562
2313,華通,62,42,20,新光-高雄,2023-11-09,8562
2353,宏��,24,5,19,新光-高雄,2023-11-09,8562
5347,世界,26,7,19,新光-高雄,2023-11-09,8562
2002,中鋼,24,5,19,新光-高雄,2023-11-09,8562
1710,東聯,18,0,18,新光-高雄,2023-11-09,8562
3481,群創,29,12,17,新光-高雄,2023-11-09,8562
00919,群益台灣精選高息,29,12,17,新光-高雄,2023-11-09,8562
00680L,元大美債20正2,603,85,518,新光-高雄,2023-11-10,8562
00929,復華台灣科技優息,490,239,251,新光-高雄,2023-11-10,8562
00919,群益台灣精選高息,260,29,231,新光-高雄,2023-11-10,8562
00878,國泰永續高股息,242,40,202,新光-高雄,2023-11-10,8562
2317,鴻海,202,11,191,新光-高雄,2023-11-10,8562
2538,基泰,130,3,127,新光-高雄,2023-11-10,8562
00648R,元大S＆P500反1,100,0,100,新光-高雄,2023-11-10,8562
00936,台新永續高息中小,99,7,92,新光-高雄,2023-11-10,8562
00637L,元大滬深300正2,104,38,66,新光-高雄,2023-11-10,8562
00687B,國泰20年美債,63,1,62,新光-高雄,2023-11-10,8562
00688L,國泰20年美債正2,61,0,61,新光-高雄,2023-11-10,8562
8942,森鉅,60,0,60,新光-高雄,2023-11-10,8562
00650L,復華香港正2,56,0,56,新光-高雄,2023-11-10,8562
2409,友達,72,18,54,新光-高雄,2023-11-10,8562
00706L,期元大S＆P日圓正2,52,0,52,新光-高雄,2023-11-10,8562
00679B,元大美債20年,57,6,51,新光-高雄,2023-11-10,8562
1449,佳和,50,0,50,新光-高雄,2023-11-10,8562
2891,中信金,79,37,42,新光-高雄,2023-11-10,8562
2618,長榮航,50,10,40,新光-高雄,2023-11-10,8562
3062,建漢,39,1,38,新光-高雄,2023-11-10,8562
3702,大聯大,41,4,37,新光-高雄,2023-11-10,8562
4533,協易機,154,120,34,新光-高雄,2023-11-10,8562
2637,慧洋-KY,31,0,31,新光-高雄,2023-11-10,8562
0056,元大高股息,38,11,27,新光-高雄,2023-11-10,8562
2405,輔信,31,4,27,新光-高雄,2023-11-10,8562
00720B,元大投資級公司債,27,0,27,新光-高雄,2023-11-10,8562
5519,隆大,35,9,26,新光-高雄,2023-11-10,8562
6922,宸曜,29,3,26,新光-高雄,2023-11-10,8562
3231,緯創,249,224,25,新光-高雄,2023-11-10,8562
00715L,期街口布蘭特正2,54,29,25,新光-高雄,2023-11-10,8562
5213,亞昕,25,0,25,新光-高雄,2023-11-10,8562
2352,佳世達,38,17,21,新光-高雄,2023-11-10,8562
6290,良維,40,19,21,新光-高雄,2023-11-10,8562
6274,台燿,22,2,20,新光-高雄,2023-11-10,8562
6161,捷波,21,1,20,新光-高雄,2023-11-10,8562
00751B,元大AAA至A公司債,19,1,18,新光-高雄,2023-11-10,8562
1522,堤維西,22,4,18,新光-高雄,2023-11-10,8562
5386,青雲,24,7,17,新光-高雄,2023-11-10,8562
00933B,國泰10Y+金融債,25,8,17,新光-高雄,2023-11-10,8562
3557,嘉威,17,0,17,新光-高雄,2023-11-10,8562
1515,力山,81,64,17,新光-高雄,2023-11-10,8562
3176,基亞,18,2,16,新光-高雄,2023-11-10,8562
2421,建準,20,4,16,新光-高雄,2023-11-10,8562
2388,威盛,46,30,16,新光-高雄,2023-11-10,8562
8415,大國鋼,16,0,16,新光-高雄,2023-11-10,8562
00900,富邦特選高股息30,17,1,16,新光-高雄,2023-11-10,8562
4967,十銓,58,43,15,新光-高雄,2023-11-10,8562
5009,榮剛,15,0,15,新光-高雄,2023-11-10,8562
3622,洋華,16,1,15,新光-高雄,2023-11-10,8562
2399,映泰,18,3,15,新光-高雄,2023-11-10,8562
00632R,元大台灣50反1,495,195,300,新光-高雄,2023-11-13,8562
00713,元大台灣高息低波,174,2,172,新光-高雄,2023-11-13,8562
00936,台新永續高息中小,146,21,125,新光-高雄,2023-11-13,8562
00687B,國泰20年美債,195,85,110,新光-高雄,2023-11-13,8562
0056,元大高股息,145,43,102,新光-高雄,2023-11-13,8562
4967,十銓,194,98,96,新光-高雄,2023-11-13,8562
2313,華通,486,391,95,新光-高雄,2023-11-13,8562
00712,復華富時不動產,108,17,91,新光-高雄,2023-11-13,8562
2888,新光金,110,26,84,新光-高雄,2023-11-13,8562
00878,國泰永續高股息,438,356,82,新光-高雄,2023-11-13,8562
00688L,國泰20年美債正2,73,0,73,新光-高雄,2023-11-13,8562
1455,集盛,65,0,65,新光-高雄,2023-11-13,8562
00900,富邦特選高股息30,56,1,55,新光-高雄,2023-11-13,8562
00680L,元大美債20正2,104,49,55,新光-高雄,2023-11-13,8562
2641,正德,49,0,49,新光-高雄,2023-11-13,8562
00676R,富邦臺灣加權反1,48,0,48,新光-高雄,2023-11-13,8562
2329,華泰,200,155,45,新光-高雄,2023-11-13,8562
00637L,元大滬深300正2,49,5,44,新光-高雄,2023-11-13,8562
2881,富邦金,48,6,42,新光-高雄,2023-11-13,8562
2486,一詮,47,5,42,新光-高雄,2023-11-13,8562
9105,泰金寶-DR,41,0,41,新光-高雄,2023-11-13,8562
2610,華航,101,62,39,新光-高雄,2023-11-13,8562
4306,炎洲,39,1,38,新光-高雄,2023-11-13,8562
2382,廣達,238,201,37,新光-高雄,2023-11-13,8562
8942,森鉅,39,3,36,新光-高雄,2023-11-13,8562
2474,可成,35,1,34,新光-高雄,2023-11-13,8562
9921,巨大,41,7,34,新光-高雄,2023-11-13,8562
00679B,元大美債20年,54,20,34,新光-高雄,2023-11-13,8562
2007,燁興,50,17,33,新光-高雄,2023-11-13,8562
3702,大聯大,37,5,32,新光-高雄,2023-11-13,8562
2618,長榮航,65,35,30,新光-高雄,2023-11-13,8562
6770,力積電,30,1,29,新光-高雄,2023-11-13,8562
2405,輔信,30,2,28,新光-高雄,2023-11-13,8562
2369,菱生,166,138,28,新光-高雄,2023-11-13,8562
00720B,元大投資級公司債,27,0,27,新光-高雄,2023-11-13,8562
2402,毅嘉,53,26,27,新光-高雄,2023-11-13,8562
9904,寶成,27,0,27,新光-高雄,2023-11-13,8562
00907,永豐優息存股,27,0,27,新光-高雄,2023-11-13,8562
00715L,期街口布蘭特正2,56,30,26,新光-高雄,2023-11-13,8562
2206,三陽工業,26,0,26,新光-高雄,2023-11-13,8562
3715,定穎投控,32,6,26,新光-高雄,2023-11-13,8562
00915,凱基優選高股息30,31,6,25,新光-高雄,2023-11-13,8562
1449,佳和,25,0,25,新光-高雄,2023-11-13,8562
2852,第一保,28,4,24,新光-高雄,2023-11-13,8562
00665L,富邦�琤肭磪囓�2,84,60,24,新光-高雄,2023-11-13,8562
3045,台灣大,25,2,23,新光-高雄,2023-11-13,8562
8936,國統,33,10,23,新光-高雄,2023-11-13,8562
3228,金麗科,30,7,23,新光-高雄,2023-11-13,8562
2388,威盛,50,27,23,新光-高雄,2023-11-13,8562
3078,僑威,37,15,22,新光-高雄,2023-11-13,8562
00706L,期元大S＆P日圓正2,132,0,132,新光-高雄,2023-11-14,8562
3036A,文曄甲特,131,3,128,新光-高雄,2023-11-14,8562
00878,國泰永續高股息,530,417,113,新光-高雄,2023-11-14,8562
00687B,國泰20年美債,100,1,99,新光-高雄,2023-11-14,8562
3231,緯創,212,124,88,新光-高雄,2023-11-14,8562
00719B,元大美債1-3,82,0,82,新光-高雄,2023-11-14,8562
2515,中工,87,6,81,新光-高雄,2023-11-14,8562
1522,堤維西,94,35,59,新光-高雄,2023-11-14,8562
2618,長榮航,55,3,52,新光-高雄,2023-11-14,8562
00673R,期元大S＆P原油反1,80,32,48,新光-高雄,2023-11-14,8562
2610,華航,90,53,37,新光-高雄,2023-11-14,8562
00675L,富邦臺灣加權正2,37,2,35,新光-高雄,2023-11-14,8562
9904,寶成,36,3,33,新光-高雄,2023-11-14,8562
00931B,統一美債20年,35,2,33,新光-高雄,2023-11-14,8562
00936,台新永續高息中小,33,3,30,新光-高雄,2023-11-14,8562
2002,中鋼,45,17,28,新光-高雄,2023-11-14,8562
2313,華通,54,26,28,新光-高雄,2023-11-14,8562
00850,元大臺灣ESG永續,32,4,28,新光-高雄,2023-11-14,8562
3706,神達,32,4,28,新光-高雄,2023-11-14,8562
9921,巨大,31,4,27,新光-高雄,2023-11-14,8562
2885,元大金,42,15,27,新光-高雄,2023-11-14,8562
2387,精元,35,12,23,新光-高雄,2023-11-14,8562
00922,國泰台灣領袖50,23,0,23,新光-高雄,2023-11-14,8562
1101,台泥,22,0,22,新光-高雄,2023-11-14,8562
5516,雙喜,20,0,20,新光-高雄,2023-11-14,8562
00795B,中信美國公債20年,20,0,20,新光-高雄,2023-11-14,8562
6517,保勝光學,26,7,19,新光-高雄,2023-11-14,8562
2303,聯電,32,13,19,新光-高雄,2023-11-14,8562
2464,盟立,18,0,18,新光-高雄,2023-11-14,8562
2486,一詮,29,12,17,新光-高雄,2023-11-14,8562
2356,英業達,73,57,16,新光-高雄,2023-11-14,8562
3228,金麗科,21,5,16,新光-高雄,2023-11-14,8562
1815,富喬,27,11,16,新光-高雄,2023-11-14,8562
1609,大亞,21,5,16,新光-高雄,2023-11-14,8562
2883,凱基金,28,13,15,新光-高雄,2023-11-14,8562
2006,東和鋼鐵,16,0,16,新光-高雄,2023-11-14,8562
3036,文曄,53,38,15,新光-高雄,2023-11-14,8562
2402,毅嘉,99,84,15,新光-高雄,2023-11-14,8562
3702,大聯大,33,18,15,新光-高雄,2023-11-14,8562
00935,野村臺灣新科技50,15,1,14,新光-高雄,2023-11-14,8562
8940,新天地,15,1,14,新光-高雄,2023-11-14,8562
1455,集盛,14,0,14,新光-高雄,2023-11-14,8562
020031,統一IC設計臺灣N,14,0,14,新光-高雄,2023-11-14,8562
6274,台燿,14,1,13,新光-高雄,2023-11-14,8562
1591,駿吉-KY,15,2,13,新光-高雄,2023-11-14,8562
6213,聯茂,24,12,12,新光-高雄,2023-11-14,8562
00751B,元大AAA至A公司債,14,2,12,新光-高雄,2023-11-14,8562
4510,高鋒,17,5,12,新光-高雄,2023-11-14,8562
6197,佳必琪,12,0,12,新光-高雄,2023-11-14,8562
2337,旺宏,15,3,12,新光-高雄,2023-11-14,8562
00878,國泰永續高股息,573,273,300,新光-高雄,2023-11-15,8562
3036A,文曄甲特,280,6,274,新光-高雄,2023-11-15,8562
00922,國泰台灣領袖50,261,25,236,新光-高雄,2023-11-15,8562
2618,長榮航,290,137,153,新光-高雄,2023-11-15,8562
00919,群益台灣精選高息,156,9,147,新光-高雄,2023-11-15,8562
00688L,國泰20年美債正2,205,78,127,新光-高雄,2023-11-15,8562
00632R,元大台灣50反1,259,140,119,新光-高雄,2023-11-15,8562
00679B,元大美債20年,138,27,111,新光-高雄,2023-11-15,8562
00676R,富邦臺灣加權反1,99,0,99,新光-高雄,2023-11-15,8562
3701,大眾控,115,27,88,新光-高雄,2023-11-15,8562
5871,中租-KY,83,2,81,新光-高雄,2023-11-15,8562
3260,威剛,77,12,65,新光-高雄,2023-11-15,8562
2812,台中銀,68,12,56,新光-高雄,2023-11-15,8562
2442,新美齊,50,0,50,新光-高雄,2023-11-15,8562
00687B,國泰20年美債,54,5,49,新光-高雄,2023-11-15,8562
2449,京元電子,74,25,49,新光-高雄,2023-11-15,8562
3548,兆利,67,25,42,新光-高雄,2023-11-15,8562
2851,中再保,41,0,41,新光-高雄,2023-11-15,8562
2538,基泰,40,0,40,新光-高雄,2023-11-15,8562
00930,永豐ESG低碳高息,35,0,35,新光-高雄,2023-11-15,8562
2516,新建,37,2,35,新光-高雄,2023-11-15,8562
3062,建漢,35,0,35,新光-高雄,2023-11-15,8562
3704,合勤控,32,0,32,新光-高雄,2023-11-15,8562
00719B,元大美債1-3,30,0,30,新光-高雄,2023-11-15,8562
2317,鴻海,43,14,29,新光-高雄,2023-11-15,8562
6147,頎邦,28,0,28,新光-高雄,2023-11-15,8562
8046,南電,70,44,26,新光-高雄,2023-11-15,8562
2457,飛宏,36,11,25,新光-高雄,2023-11-15,8562
2353,宏��,34,9,25,新光-高雄,2023-11-15,8562
2337,旺宏,48,24,24,新光-高雄,2023-11-15,8562
1714,和桐,25,1,24,新光-高雄,2023-11-15,8562
3276,宇環,64,40,24,新光-高雄,2023-11-15,8562
00715L,期街口布蘭特正2,42,21,21,新光-高雄,2023-11-15,8562
5386,青雲,52,32,20,新光-高雄,2023-11-15,8562
2399,映泰,23,3,20,新光-高雄,2023-11-15,8562
00933B,國泰10Y+金融債,24,5,19,新光-高雄,2023-11-15,8562
00669R,國泰美國道瓊反1,24,5,19,新光-高雄,2023-11-15,8562
00935,野村臺灣新科技50,19,0,19,新光-高雄,2023-11-15,8562
00795B,中信美國公債20年,26,7,19,新光-高雄,2023-11-15,8562
5512,力麒,19,0,19,新光-高雄,2023-11-15,8562
2031,新光鋼,24,6,18,新光-高雄,2023-11-15,8562
00904,新光臺灣半導體30,19,1,18,新光-高雄,2023-11-15,8562
3078,僑威,32,15,17,新光-高雄,2023-11-15,8562
1522,堤維西,33,16,17,新光-高雄,2023-11-15,8562
1524,耿鼎,26,10,16,新光-高雄,2023-11-15,8562
5426,振發,18,2,16,新光-高雄,2023-11-15,8562
5351,鈺創,41,25,16,新光-高雄,2023-11-15,8562
2328,廣宇,15,0,15,新光-高雄,2023-11-15,8562
4128,中天,22,7,15,新光-高雄,2023-11-15,8562
00655L,國泰中國A50正2,15,0,15,新光-高雄,2023-11-15,8562
00632R,元大台灣50反1,460,30,430,新光-高雄,2023-11-16,8562
00878,國泰永續高股息,281,44,237,新光-高雄,2023-11-16,8562
00715L,期街口布蘭特正2,292,83,209,新光-高雄,2023-11-16,8562
00687B,國泰20年美債,157,10,147,新光-高雄,2023-11-16,8562
00720B,元大投資級公司債,157,10,147,新光-高雄,2023-11-16,8562
2538,基泰,130,0,130,新光-高雄,2023-11-16,8562
00637L,元大滬深300正2,151,30,121,新光-高雄,2023-11-16,8562
2882,國泰金,105,1,104,新光-高雄,2023-11-16,8562
4960,誠美材,100,0,100,新光-高雄,2023-11-16,8562
00679B,元大美債20年,98,0,98,新光-高雄,2023-11-16,8562
00919,群益台灣精選高息,86,0,86,新光-高雄,2023-11-16,8562
3036A,文曄甲特,91,21,70,新光-高雄,2023-11-16,8562
2329,華泰,372,305,67,新光-高雄,2023-11-16,8562
00680L,元大美債20正2,153,91,62,新光-高雄,2023-11-16,8562
00753L,中信中國50正2,66,5,61,新光-高雄,2023-11-16,8562
00648R,元大S＆P500反1,50,0,50,新光-高雄,2023-11-16,8562
2371,大同,110,63,47,新光-高雄,2023-11-16,8562
2337,旺宏,44,4,40,新光-高雄,2023-11-16,8562
5009,榮剛,49,10,39,新光-高雄,2023-11-16,8562
1101,台泥,44,8,36,新光-高雄,2023-11-16,8562
1339,昭輝,46,13,33,新光-高雄,2023-11-16,8562
6456,GIS-KY,69,38,31,新光-高雄,2023-11-16,8562
1455,集盛,30,0,30,新光-高雄,2023-11-16,8562
00931B,統一美債20年,56,28,28,新光-高雄,2023-11-16,8562
3149,正達,28,0,28,新光-高雄,2023-11-16,8562
00850,元大臺灣ESG永續,25,0,25,新光-高雄,2023-11-16,8562
1102,亞泥,32,7,25,新光-高雄,2023-11-16,8562
00933B,國泰10Y+金融債,43,19,24,新光-高雄,2023-11-16,8562
2390,云辰,44,20,24,新光-高雄,2023-11-16,8562
3450,聯鈞,45,22,23,新光-高雄,2023-11-16,8562
5512,力麒,37,14,23,新光-高雄,2023-11-16,8562
2352,佳世達,45,23,22,新光-高雄,2023-11-16,8562
00751B,元大AAA至A公司債,22,0,22,新光-高雄,2023-11-16,8562
3264,欣銓,22,0,22,新光-高雄,2023-11-16,8562
6163,華電網,21,0,21,新光-高雄,2023-11-16,8562
00669R,國泰美國道瓊反1,30,10,20,新光-高雄,2023-11-16,8562
00671R,富邦NASDAQ反1,20,0,20,新光-高雄,2023-11-16,8562
2399,映泰,42,22,20,新光-高雄,2023-11-16,8562
3346,麗清,40,20,20,新光-高雄,2023-11-16,8562
6122,擎邦,29,9,20,新光-高雄,2023-11-16,8562
2607,榮運,20,1,19,新光-高雄,2023-11-16,8562
5521,工信,23,4,19,新光-高雄,2023-11-16,8562
00772B,中信高評級公司債,18,0,18,新光-高雄,2023-11-16,8562
6245,立端,20,3,17,新光-高雄,2023-11-16,8562
00795B,中信美國公債20年,17,0,17,新光-高雄,2023-11-16,8562
00706L,期元大S＆P日圓正2,16,0,16,新光-高雄,2023-11-16,8562
3231,緯創,129,114,15,新光-高雄,2023-11-16,8562
2313,華通,100,85,15,新光-高雄,2023-11-16,8562
2736,富野,31,16,15,新光-高雄,2023-11-16,8562
00857B,永豐20年美公債,14,0,14,新光-高雄,2023-11-16,8562
00637L,元大滬深300正2,237,64,173,新光-高雄,2023-11-17,8562
00715L,期街口布蘭特正2,240,93,147,新光-高雄,2023-11-17,8562
1449,佳和,108,0,108,新光-高雄,2023-11-17,8562
5475,德宏,88,0,88,新光-高雄,2023-11-17,8562
00878,國泰永續高股息,118,34,84,新光-高雄,2023-11-17,8562
00753L,中信中國50正2,78,0,78,新光-高雄,2023-11-17,8562
00665L,富邦�琤肭磪囓�2,308,231,77,新光-高雄,2023-11-17,8562
2538,基泰,70,0,70,新光-高雄,2023-11-17,8562
2610,華航,285,219,66,新光-高雄,2023-11-17,8562
9921,巨大,70,16,54,新光-高雄,2023-11-17,8562
5516,雙喜,51,0,51,新光-高雄,2023-11-17,8562
2498,宏達電,122,78,44,新光-高雄,2023-11-17,8562
1312,國喬,46,3,43,新光-高雄,2023-11-17,8562
3260,威剛,42,8,34,新光-高雄,2023-11-17,8562
2344,華邦電,151,124,27,新光-高雄,2023-11-17,8562
3041,揚智,328,301,27,新光-高雄,2023-11-17,8562
4979,華星光,38,13,25,新光-高雄,2023-11-17,8562
8936,國統,30,5,25,新光-高雄,2023-11-17,8562
6531,愛普*,41,16,25,新光-高雄,2023-11-17,8562
2705,六福,65,41,24,新光-高雄,2023-11-17,8562
00642U,期元大S＆P石油,27,3,24,新光-高雄,2023-11-17,8562
2388,威盛,149,126,23,新光-高雄,2023-11-17,8562
2542,興富發,25,2,23,新光-高雄,2023-11-17,8562
6235,華孚,48,28,20,新光-高雄,2023-11-17,8562
3105,穩懋,26,6,20,新光-高雄,2023-11-17,8562
1710,東聯,21,1,20,新光-高雄,2023-11-17,8562
1455,集盛,20,0,20,新光-高雄,2023-11-17,8562
9110,越南控-DR,20,0,20,新光-高雄,2023-11-17,8562
9904,寶成,22,3,19,新光-高雄,2023-11-17,8562
00850,元大臺灣ESG永續,21,3,18,新光-高雄,2023-11-17,8562
3231,緯創,132,114,18,新光-高雄,2023-11-17,8562
4906,正文,17,0,17,新光-高雄,2023-11-17,8562
00679B,元大美債20年,33,16,17,新光-高雄,2023-11-17,8562
9950,萬國通,32,15,17,新光-高雄,2023-11-17,8562
2731,雄獅,35,18,17,新光-高雄,2023-11-17,8562
00720B,元大投資級公司債,17,0,17,新光-高雄,2023-11-17,8562
3276,宇環,45,29,16,新光-高雄,2023-11-17,8562
3213,茂訊,17,1,16,新光-高雄,2023-11-17,8562
4413,飛寶企業,15,0,15,新光-高雄,2023-11-17,8562
5533,皇鼎,15,0,15,新光-高雄,2023-11-17,8562
3266,昇陽,16,2,14,新光-高雄,2023-11-17,8562
2399,映泰,21,7,14,新光-高雄,2023-11-17,8562
3704,合勤控,15,1,14,新光-高雄,2023-11-17,8562
00712,復華富時不動產,59,45,14,新光-高雄,2023-11-17,8562
2486,一詮,14,1,13,新光-高雄,2023-11-17,8562
00882,中信中國高股息,13,0,13,新光-高雄,2023-11-17,8562
2630,亞航,15,3,12,新光-高雄,2023-11-17,8562
00885,富邦越南,15,3,12,新光-高雄,2023-11-17,8562
3205,佰研,12,0,12,新光-高雄,2023-11-17,8562
2609,陽明,12,0,12,新光-高雄,2023-11-17,8562
00929,復華台灣科技優息,2489,160,2329,新光-高雄,2023-11-20,8562
00673R,期元大S＆P原油反1,244,0,244,新光-高雄,2023-11-20,8562
00632R,元大台灣50反1,830,651,179,新光-高雄,2023-11-20,8562
01003T,兆豐新光R1,180,3,177,新光-高雄,2023-11-20,8562
3682,亞太電,165,0,165,新光-高雄,2023-11-20,8562
00706L,期元大S＆P日圓正2,150,0,150,新光-高雄,2023-11-20,8562
00712,復華富時不動產,135,16,119,新光-高雄,2023-11-20,8562
3481,群創,143,32,111,新光-高雄,2023-11-20,8562
0056,元大高股息,128,27,101,新光-高雄,2023-11-20,8562
2882,國泰金,99,9,90,新光-高雄,2023-11-20,8562
00878,國泰永續高股息,123,34,89,新光-高雄,2023-11-20,8562
5531,鄉林,80,0,80,新光-高雄,2023-11-20,8562
2610,華航,354,276,78,新光-高雄,2023-11-20,8562
1522,堤維西,82,6,76,新光-高雄,2023-11-20,8562
00882,中信中國高股息,74,1,73,新光-高雄,2023-11-20,8562
2409,友達,83,16,67,新光-高雄,2023-11-20,8562
2812,台中銀,96,30,66,新光-高雄,2023-11-20,8562
3376,新日興,97,32,65,新光-高雄,2023-11-20,8562
00679B,元大美債20年,74,16,58,新光-高雄,2023-11-20,8562
00669R,國泰美國道瓊反1,59,5,54,新光-高雄,2023-11-20,8562
00637L,元大滬深300正2,84,32,52,新光-高雄,2023-11-20,8562
6168,宏齊,194,145,49,新光-高雄,2023-11-20,8562
00931B,統一美債20年,49,3,46,新光-高雄,2023-11-20,8562
2363,矽統,270,224,46,新光-高雄,2023-11-20,8562
9904,寶成,41,0,41,新光-高雄,2023-11-20,8562
2324,仁寶,44,5,39,新光-高雄,2023-11-20,8562
00751B,元大AAA至A公司債,42,3,39,新光-高雄,2023-11-20,8562
00922,國泰台灣領袖50,36,0,36,新光-高雄,2023-11-20,8562
5706,鳳凰,61,25,36,新光-高雄,2023-11-20,8562
2313,華通,207,172,35,新光-高雄,2023-11-20,8562
00885,富邦越南,52,18,34,新光-高雄,2023-11-20,8562
1339,昭輝,35,1,34,新光-高雄,2023-11-20,8562
1718,中纖,32,0,32,新光-高雄,2023-11-20,8562
2317,鴻海,38,7,31,新光-高雄,2023-11-20,8562
2390,云辰,97,66,31,新光-高雄,2023-11-20,8562
9945,潤泰新,34,5,29,新光-高雄,2023-11-20,8562
1710,東聯,42,13,29,新光-高雄,2023-11-20,8562
3025,星通,73,46,27,新光-高雄,2023-11-20,8562
3266,昇陽,30,3,27,新光-高雄,2023-11-20,8562
00934,中信成長高股息,28,2,26,新光-高雄,2023-11-20,8562
1101,台泥,39,15,24,新光-高雄,2023-11-20,8562
00857B,永豐20年美公債,22,0,22,新光-高雄,2023-11-20,8562
6901,鑽石投資,23,1,22,新光-高雄,2023-11-20,8562
6517,保勝光學,24,3,21,新光-高雄,2023-11-20,8562
2516,新建,32,11,21,新光-高雄,2023-11-20,8562
00900,富邦特選高股息30,22,2,20,新光-高雄,2023-11-20,8562
00687B,國泰20年美債,92,72,20,新光-高雄,2023-11-20,8562
00936,台新永續高息中小,21,1,20,新光-高雄,2023-11-20,8562
2356,英業達,120,101,19,新光-高雄,2023-11-20,8562
2382,廣達,113,94,19,新光-高雄,2023-11-20,8562
00632R,元大台灣50反1,885,556,329,新光-高雄,2023-11-21,8562
2618,長榮航,294,27,267,新光-高雄,2023-11-21,8562
01003T,兆豐新光R1,180,0,180,新光-高雄,2023-11-21,8562
3701,大眾控,160,9,151,新光-高雄,2023-11-21,8562
3041,揚智,301,159,142,新光-高雄,2023-11-21,8562
3682,亞太電,108,0,108,新光-高雄,2023-11-21,8562
00713,元大台灣高息低波,105,6,99,新光-高雄,2023-11-21,8562
5351,鈺創,253,153,100,新光-高雄,2023-11-21,8562
3231,緯創,273,176,97,新光-高雄,2023-11-21,8562
00671R,富邦NASDAQ反1,97,0,97,新光-高雄,2023-11-21,8562
2506,太設,88,0,88,新光-高雄,2023-11-21,8562
8110,華東,80,1,79,新光-高雄,2023-11-21,8562
6125,廣運,133,64,69,新光-高雄,2023-11-21,8562
00637L,元大滬深300正2,94,32,62,新光-高雄,2023-11-21,8562
00665L,富邦�琤肭磪囓�2,71,12,59,新光-高雄,2023-11-21,8562
00687B,國泰20年美債,60,2,58,新光-高雄,2023-11-21,8562
2610,華航,244,189,55,新光-高雄,2023-11-21,8562
00929,復華台灣科技優息,206,153,53,新光-高雄,2023-11-21,8562
2375,凱美,62,11,51,新光-高雄,2023-11-21,8562
00679B,元大美債20年,64,16,48,新光-高雄,2023-11-21,8562
1314,中石化,47,0,47,新光-高雄,2023-11-21,8562
00673R,期元大S＆P原油反1,40,0,40,新光-高雄,2023-11-21,8562
00688L,國泰20年美債正2,111,75,36,新光-高雄,2023-11-21,8562
4746,台耀,44,8,36,新光-高雄,2023-11-21,8562
3059,華晶科,97,63,34,新光-高雄,2023-11-21,8562
3078,僑威,43,10,33,新光-高雄,2023-11-21,8562
2356,英業達,255,223,32,新光-高雄,2023-11-21,8562
2023,燁輝,80,48,32,新光-高雄,2023-11-21,8562
2027,大成鋼,36,8,28,新光-高雄,2023-11-21,8562
00907,永豐優息存股,29,2,27,新光-高雄,2023-11-21,8562
1718,中纖,28,2,26,新光-高雄,2023-11-21,8562
2101,南港,26,0,26,新光-高雄,2023-11-21,8562
00751B,元大AAA至A公司債,24,0,24,新光-高雄,2023-11-21,8562
1471,首利,30,6,24,新光-高雄,2023-11-21,8562
5533,皇鼎,39,15,24,新光-高雄,2023-11-21,8562
3376,新日興,32,8,24,新光-高雄,2023-11-21,8562
2812,台中銀,52,29,23,新光-高雄,2023-11-21,8562
00670L,富邦NASDAQ正2,29,7,22,新光-高雄,2023-11-21,8562
5258,虹堡,46,24,22,新光-高雄,2023-11-21,8562
6443,元晶,35,13,22,新光-高雄,2023-11-21,8562
8942,森鉅,21,0,21,新光-高雄,2023-11-21,8562
9946,三發地產,21,0,21,新光-高雄,2023-11-21,8562
3105,穩懋,23,3,20,新光-高雄,2023-11-21,8562
1522,堤維西,25,5,20,新光-高雄,2023-11-21,8562
6799,來頡,29,9,20,新光-高雄,2023-11-21,8562
4933,友輝,23,4,19,新光-高雄,2023-11-21,8562
3260,威剛,27,8,19,新光-高雄,2023-11-21,8562
3715,定穎投控,85,67,18,新光-高雄,2023-11-21,8562
1524,耿鼎,26,8,18,新光-高雄,2023-11-21,8562
5452,佶優,29,12,17,新光-高雄,2023-11-21,8562
00919,群益台灣精選高息,690,12,678,新光-高雄,2023-11-22,8562
01003T,兆豐新光R1,180,0,180,新光-高雄,2023-11-22,8562
2610,華航,381,205,176,新光-高雄,2023-11-22,8562
0056,元大高股息,167,12,155,新光-高雄,2023-11-22,8562
00706L,期元大S＆P日圓正2,104,5,99,新光-高雄,2023-11-22,8562
2344,華邦電,162,65,97,新光-高雄,2023-11-22,8562
00680L,元大美債20正2,88,10,78,新光-高雄,2023-11-22,8562
3231,緯創,254,176,78,新光-高雄,2023-11-22,8562
5302,太欣,75,0,75,新光-高雄,2023-11-22,8562
00673R,期元大S＆P原油反1,70,0,70,新光-高雄,2023-11-22,8562
2301,光寶科,72,4,68,新光-高雄,2023-11-22,8562
1449,佳和,71,3,68,新光-高雄,2023-11-22,8562
3264,欣銓,64,1,63,新光-高雄,2023-11-22,8562
2353,宏��,117,56,61,新光-高雄,2023-11-22,8562
00637L,元大滬深300正2,62,4,58,新光-高雄,2023-11-22,8562
2382,廣達,116,61,55,新光-高雄,2023-11-22,8562
4510,高鋒,61,11,50,新光-高雄,2023-11-22,8562
00878,國泰永續高股息,105,59,46,新光-高雄,2023-11-22,8562
9946,三發地產,45,3,42,新光-高雄,2023-11-22,8562
4401,東隆興,51,10,41,新光-高雄,2023-11-22,8562
2356,英業達,85,45,40,新光-高雄,2023-11-22,8562
3363,上詮,92,52,40,新光-高雄,2023-11-22,8562
6451,訊芯-KY,93,55,38,新光-高雄,2023-11-22,8562
9921,巨大,41,4,37,新光-高雄,2023-11-22,8562
2337,旺宏,41,4,37,新光-高雄,2023-11-22,8562
00687B,國泰20年美債,37,0,37,新光-高雄,2023-11-22,8562
00931B,統一美債20年,46,12,34,新光-高雄,2023-11-22,8562
2401,凌陽,52,18,34,新光-高雄,2023-11-22,8562
1455,集盛,30,0,30,新光-高雄,2023-11-22,8562
00720B,元大投資級公司債,29,0,29,新光-高雄,2023-11-22,8562
00712,復華富時不動產,38,11,27,新光-高雄,2023-11-22,8562
2317,鴻海,78,51,27,新光-高雄,2023-11-22,8562
2330,台積電,39,13,26,新光-高雄,2023-11-22,8562
6118,建達,29,3,26,新光-高雄,2023-11-22,8562
2303,聯電,36,14,22,新光-高雄,2023-11-22,8562
00713,元大台灣高息低波,27,5,22,新光-高雄,2023-11-22,8562
2516,新建,51,30,21,新光-高雄,2023-11-22,8562
2882,國泰金,64,43,21,新光-高雄,2023-11-22,8562
4908,前鼎,74,54,20,新光-高雄,2023-11-22,8562
1101,台泥,25,5,20,新光-高雄,2023-11-22,8562
6231,系微,27,8,19,新光-高雄,2023-11-22,8562
00795B,中信美國公債20年,19,0,19,新光-高雄,2023-11-22,8562
2002,中鋼,36,18,18,新光-高雄,2023-11-22,8562
2845,遠東銀,18,0,18,新光-高雄,2023-11-22,8562
8942,森鉅,18,0,18,新光-高雄,2023-11-22,8562
00881,國泰台灣5G+,26,9,17,新光-高雄,2023-11-22,8562
2888,新光金,20,3,17,新光-高雄,2023-11-22,8562
2748,雲品,26,9,17,新光-高雄,2023-11-22,8562
2892,第一金,17,0,17,新光-高雄,2023-11-22,8562
00679B,元大美債20年,24,8,16,新光-高雄,2023-11-22,8562
00878,國泰永續高股息,300,60,240,新光-高雄,2023-11-23,8562
00680L,元大美債20正2,304,110,194,新光-高雄,2023-11-23,8562
01003T,兆豐新光R1,180,0,180,新光-高雄,2023-11-23,8562
3059,華晶科,167,30,137,新光-高雄,2023-11-23,8562
2515,中工,157,30,127,新光-高雄,2023-11-23,8562
00637L,元大滬深300正2,200,80,120,新光-高雄,2023-11-23,8562
00713,元大台灣高息低波,87,0,87,新光-高雄,2023-11-23,8562
00919,群益台灣精選高息,252,172,80,新光-高雄,2023-11-23,8562
2888,新光金,70,5,65,新光-高雄,2023-11-23,8562
00934,中信成長高股息,65,0,65,新光-高雄,2023-11-23,8562
6237,驊訊,150,87,63,新光-高雄,2023-11-23,8562
00632R,元大台灣50反1,79,20,59,新光-高雄,2023-11-23,8562
3231,緯創,125,66,59,新光-高雄,2023-11-23,8562
1513,中興電,72,16,56,新光-高雄,2023-11-23,8562
2476,鉅祥,72,18,54,新光-高雄,2023-11-23,8562
00923,群益台ESG低碳50,55,1,54,新光-高雄,2023-11-23,8562
00715L,期街口布蘭特正2,57,3,54,新光-高雄,2023-11-23,8562
2006,東和鋼鐵,52,0,52,新光-高雄,2023-11-23,8562
2867,三商壽,45,0,45,新光-高雄,2023-11-23,8562
5258,虹堡,56,15,41,新光-高雄,2023-11-23,8562
6282,康舒,448,409,39,新光-高雄,2023-11-23,8562
6125,廣運,84,46,38,新光-高雄,2023-11-23,8562
2457,飛宏,136,99,37,新光-高雄,2023-11-23,8562
3006,晶豪科,96,60,36,新光-高雄,2023-11-23,8562
8011,台通,35,0,35,新光-高雄,2023-11-23,8562
2538,基泰,32,0,32,新光-高雄,2023-11-23,8562
9945,潤泰新,43,12,31,新光-高雄,2023-11-23,8562
3376,新日興,39,13,26,新光-高雄,2023-11-23,8562
2363,矽統,198,173,25,新光-高雄,2023-11-23,8562
2382,廣達,162,138,24,新光-高雄,2023-11-23,8562
2390,云辰,75,51,24,新光-高雄,2023-11-23,8562
1455,集盛,24,0,24,新光-高雄,2023-11-23,8562
6139,亞翔,63,40,23,新光-高雄,2023-11-23,8562
3264,欣銓,24,2,22,新光-高雄,2023-11-23,8562
3047,訊舟,38,16,22,新光-高雄,2023-11-23,8562
3031,佰鴻,21,0,21,新光-高雄,2023-11-23,8562
3694,海華,68,47,21,新光-高雄,2023-11-23,8562
3041,揚智,199,179,20,新光-高雄,2023-11-23,8562
00655L,國泰中國A50正2,27,7,20,新光-高雄,2023-11-23,8562
6244,茂迪,20,0,20,新光-高雄,2023-11-23,8562
3051,力特,27,7,20,新光-高雄,2023-11-23,8562
4510,高鋒,24,5,19,新光-高雄,2023-11-23,8562
3078,僑威,151,132,19,新光-高雄,2023-11-23,8562
3491,昇達科,25,7,18,新光-高雄,2023-11-23,8562
8163,達方,18,1,17,新光-高雄,2023-11-23,8562
0056,元大高股息,30,13,17,新光-高雄,2023-11-23,8562
3169,亞信,44,28,16,新光-高雄,2023-11-23,8562
6016,康和證,16,0,16,新光-高雄,2023-11-23,8562
00930,永豐ESG低碳高息,16,0,16,新光-高雄,2023-11-23,8562
3035,智原,43,27,16,新光-高雄,2023-11-23,8562
2610,華航,312,31,281,新光-高雄,2023-11-24,8562
1513,中興電,242,78,164,新光-高雄,2023-11-24,8562
2618,長榮航,172,18,154,新光-高雄,2023-11-24,8562
2882,國泰金,142,8,134,新光-高雄,2023-11-24,8562
2442,新美齊,126,2,124,新光-高雄,2023-11-24,8562
00680L,元大美債20正2,121,10,111,新光-高雄,2023-11-24,8562
00720B,元大投資級公司債,119,20,99,新光-高雄,2023-11-24,8562
2515,中工,104,6,98,新光-高雄,2023-11-24,8562
2457,飛宏,320,240,80,新光-高雄,2023-11-24,8562
2313,華通,313,254,59,新光-高雄,2023-11-24,8562
00679B,元大美債20年,48,7,41,新光-高雄,2023-11-24,8562
2337,旺宏,42,1,41,新光-高雄,2023-11-24,8562
00919,群益台灣精選高息,47,7,40,新光-高雄,2023-11-24,8562
00795B,中信美國公債20年,110,70,40,新光-高雄,2023-11-24,8562
1455,集盛,36,0,36,新光-高雄,2023-11-24,8562
2312,金寶,52,17,35,新光-高雄,2023-11-24,8562
2375,凱美,68,34,34,新光-高雄,2023-11-24,8562
1603,華電,37,3,34,新光-高雄,2023-11-24,8562
00673R,期元大S＆P原油反1,30,0,30,新光-高雄,2023-11-24,8562
5351,鈺創,148,119,29,新光-高雄,2023-11-24,8562
3228,金麗科,31,3,28,新光-高雄,2023-11-24,8562
00857B,永豐20年美公債,26,0,26,新光-高雄,2023-11-24,8562
8086,宏捷科,48,22,26,新光-高雄,2023-11-24,8562
00931B,統一美債20年,29,4,25,新光-高雄,2023-11-24,8562
1609,大亞,49,24,25,新光-高雄,2023-11-24,8562
9921,巨大,40,16,24,新光-高雄,2023-11-24,8562
5471,松翰,25,1,24,新光-高雄,2023-11-24,8562
1605,華新,40,16,24,新光-高雄,2023-11-24,8562
2301,光寶科,25,1,24,新光-高雄,2023-11-24,8562
00878,國泰永續高股息,40,16,24,新光-高雄,2023-11-24,8562
2498,宏達電,23,0,23,新光-高雄,2023-11-24,8562
0056,元大高股息,35,12,23,新光-高雄,2023-11-24,8562
00885,富邦越南,27,5,22,新光-高雄,2023-11-24,8562
00706L,期元大S＆P日圓正2,22,0,22,新光-高雄,2023-11-24,8562
2486,一詮,26,4,22,新光-高雄,2023-11-24,8562
2419,仲琦,20,0,20,新光-高雄,2023-11-24,8562
01003T,兆豐新光R1,20,0,20,新光-高雄,2023-11-24,8562
1504,東元,30,12,18,新光-高雄,2023-11-24,8562
2492,華新科,92,74,18,新光-高雄,2023-11-24,8562
3708,上緯投控,20,3,17,新光-高雄,2023-11-24,8562
9946,三發地產,16,0,16,新光-高雄,2023-11-24,8562
2382,廣達,54,38,16,新光-高雄,2023-11-24,8562
00905,FT臺灣Smart,15,0,15,新光-高雄,2023-11-24,8562
2356,英業達,61,46,15,新光-高雄,2023-11-24,8562
1810,和成,22,8,14,新光-高雄,2023-11-24,8562
6237,驊訊,21,7,14,新光-高雄,2023-11-24,8562
2006,東和鋼鐵,16,2,14,新光-高雄,2023-11-24,8562
8183,精星,15,1,14,新光-高雄,2023-11-24,8562
6143,振曜,17,3,14,新光-高雄,2023-11-24,8562
3706,神達,19,5,14,新光-高雄,2023-11-24,8562
2618,長榮航,512,231,281,新光-高雄,2023-11-27,8562
00919,群益台灣精選高息,222,25,197,新光-高雄,2023-11-27,8562
2401,凌陽,217,28,189,新光-高雄,2023-11-27,8562
00878,國泰永續高股息,187,17,170,新光-高雄,2023-11-27,8562
00637L,元大滬深300正2,172,16,156,新光-高雄,2023-11-27,8562
00929,復華台灣科技優息,265,120,145,新光-高雄,2023-11-27,8562
0056,元大高股息,158,22,136,新光-高雄,2023-11-27,8562
00720B,元大投資級公司債,125,5,120,新光-高雄,2023-11-27,8562
2888,新光金,146,27,119,新光-高雄,2023-11-27,8562
00687B,國泰20年美債,111,3,108,新光-高雄,2023-11-27,8562
01003T,兆豐新光R1,100,0,100,新光-高雄,2023-11-27,8562
1312,國喬,94,0,94,新光-高雄,2023-11-27,8562
00715L,期街口布蘭特正2,156,70,86,新光-高雄,2023-11-27,8562
6191,精成科,83,3,80,新光-高雄,2023-11-27,8562
9919,康那香,80,4,76,新光-高雄,2023-11-27,8562
00688L,國泰20年美債正2,73,0,73,新光-高雄,2023-11-27,8562
00679B,元大美債20年,65,0,65,新光-高雄,2023-11-27,8562
2317,鴻海,79,23,56,新光-高雄,2023-11-27,8562
2913,農林,51,3,48,新光-高雄,2023-11-27,8562
2883,凱基金,125,78,47,新光-高雄,2023-11-27,8562
00934,中信成長高股息,63,20,43,新光-高雄,2023-11-27,8562
00680L,元大美債20正2,113,70,43,新光-高雄,2023-11-27,8562
00931B,統一美債20年,42,0,42,新光-高雄,2023-11-27,8562
00795B,中信美國公債20年,36,0,36,新光-高雄,2023-11-27,8562
1314,中石化,35,0,35,新光-高雄,2023-11-27,8562
00900,富邦特選高股息30,54,20,34,新光-高雄,2023-11-27,8562
2476,鉅祥,53,20,33,新光-高雄,2023-11-27,8562
2337,旺宏,48,16,32,新光-高雄,2023-11-27,8562
2634,漢翔,42,11,31,新光-高雄,2023-11-27,8562
2405,輔信,32,1,31,新光-高雄,2023-11-27,8562
4157,太景*-KY,51,21,30,新光-高雄,2023-11-27,8562
2515,中工,30,0,30,新光-高雄,2023-11-27,8562
00933B,國泰10Y+金融債,30,0,30,新光-高雄,2023-11-27,8562
3037,欣興,40,12,28,新光-高雄,2023-11-27,8562
6578,達邦蛋白,30,2,28,新光-高雄,2023-11-27,8562
8033,雷虎,29,1,28,新光-高雄,2023-11-27,8562
00902,中信電池及儲能,28,1,27,新光-高雄,2023-11-27,8562
00713,元大台灣高息低波,59,33,26,新光-高雄,2023-11-27,8562
4107,邦特,27,1,26,新光-高雄,2023-11-27,8562
2344,華邦電,105,80,25,新光-高雄,2023-11-27,8562
2812,台中銀,33,9,24,新光-高雄,2023-11-27,8562
00935,野村臺灣新科技50,24,0,24,新光-高雄,2023-11-27,8562
4133,亞諾法,31,7,24,新光-高雄,2023-11-27,8562
00923,群益台ESG低碳50,24,0,24,新光-高雄,2023-11-27,8562
00857B,永豐20年美公債,23,0,23,新光-高雄,2023-11-27,8562
2528,皇普,22,0,22,新光-高雄,2023-11-27,8562
6274,台燿,49,27,22,新光-高雄,2023-11-27,8562
00922,國泰台灣領袖50,32,11,21,新光-高雄,2023-11-27,8562
3078,僑威,31,10,21,新光-高雄,2023-11-27,8562
3035,智原,40,20,20,新光-高雄,2023-11-27,8562
00632R,元大台灣50反1,380,75,305,新光-高雄,2023-11-28,8562
2408,南亞科,211,46,165,新光-高雄,2023-11-28,8562
1101,台泥,201,90,111,新光-高雄,2023-11-28,8562
00664R,國泰臺灣加權反1,101,0,101,新光-高雄,2023-11-28,8562
1710,東聯,82,2,80,新光-高雄,2023-11-28,8562
0056,元大高股息,120,40,80,新光-高雄,2023-11-28,8562
2867,三商壽,76,0,76,新光-高雄,2023-11-28,8562
3171,炎洲流通,70,0,70,新光-高雄,2023-11-28,8562
00715L,期街口布蘭特正2,98,30,68,新光-高雄,2023-11-28,8562
5347,世界,76,11,65,新光-高雄,2023-11-28,8562
00929,復華台灣科技優息,208,144,64,新光-高雄,2023-11-28,8562
3005,神基,64,2,62,新光-高雄,2023-11-28,8562
6578,達邦蛋白,60,0,60,新光-高雄,2023-11-28,8562
2002,中鋼,94,35,59,新光-高雄,2023-11-28,8562
4114,健喬,214,155,59,新光-高雄,2023-11-28,8562
00733,富邦臺灣中小,58,0,58,新光-高雄,2023-11-28,8562
2442,新美齊,65,8,57,新光-高雄,2023-11-28,8562
00885,富邦越南,56,0,56,新光-高雄,2023-11-28,8562
1597,直得,59,6,53,新光-高雄,2023-11-28,8562
5258,虹堡,61,12,49,新光-高雄,2023-11-28,8562
2301,光寶科,59,11,48,新光-高雄,2023-11-28,8562
2812,台中銀,54,12,42,新光-高雄,2023-11-28,8562
00919,群益台灣精選高息,54,13,41,新光-高雄,2023-11-28,8562
2375,凱美,41,5,36,新光-高雄,2023-11-28,8562
4532,瑞智,33,0,33,新光-高雄,2023-11-28,8562
00665L,富邦�琤肭磪囓�2,37,5,32,新光-高雄,2023-11-28,8562
2303,聯電,57,26,31,新光-高雄,2023-11-28,8562
2618,長榮航,46,17,29,新光-高雄,2023-11-28,8562
1442,名軒,28,1,27,新光-高雄,2023-11-28,8562
2601,益航,34,7,27,新光-高雄,2023-11-28,8562
00753L,中信中國50正2,29,3,26,新光-高雄,2023-11-28,8562
6237,驊訊,56,30,26,新光-高雄,2023-11-28,8562
00687B,國泰20年美債,34,9,25,新光-高雄,2023-11-28,8562
2617,台航,28,3,25,新光-高雄,2023-11-28,8562
2891,中信金,39,14,25,新光-高雄,2023-11-28,8562
2313,華通,345,320,25,新光-高雄,2023-11-28,8562
6191,精成科,25,0,25,新光-高雄,2023-11-28,8562
4133,亞諾法,90,67,23,新光-高雄,2023-11-28,8562
2913,農林,25,2,23,新光-高雄,2023-11-28,8562
2353,宏��,28,6,22,新光-高雄,2023-11-28,8562
00706L,期元大S＆P日圓正2,48,27,21,新光-高雄,2023-11-28,8562
6284,佳邦,23,2,21,新光-高雄,2023-11-28,8562
5521,工信,27,7,20,新光-高雄,2023-11-28,8562
3147,大綜,24,4,20,新光-高雄,2023-11-28,8562
00655L,國泰中國A50正2,24,4,20,新光-高雄,2023-11-28,8562
2888,新光金,24,5,19,新光-高雄,2023-11-28,8562
00882,中信中國高股息,18,0,18,新光-高雄,2023-11-28,8562
00752,中信中國50,17,0,17,新光-高雄,2023-11-28,8562
00637L,元大滬深300正2,31,14,17,新光-高雄,2023-11-28,8562
00720B,元大投資級公司債,32,15,17,新光-高雄,2023-11-28,8562
3682,亞太電,707,1,706,新光-高雄,2023-11-29,8562
2610,華航,155,29,126,新光-高雄,2023-11-29,8562
3363,上詮,154,34,120,新光-高雄,2023-11-29,8562
00665L,富邦�琤肭磪囓�2,387,270,117,新光-高雄,2023-11-29,8562
2891,中信金,128,14,114,新光-高雄,2023-11-29,8562
2882,國泰金,112,5,107,新光-高雄,2023-11-29,8562
00637L,元大滬深300正2,183,81,102,新光-高雄,2023-11-29,8562
6243,迅杰,163,64,99,新光-高雄,2023-11-29,8562
00673R,期元大S＆P原油反1,94,0,94,新光-高雄,2023-11-29,8562
2883,凱基金,289,205,84,新光-高雄,2023-11-29,8562
00664R,國泰臺灣加權反1,80,0,80,新光-高雄,2023-11-29,8562
00753L,中信中國50正2,85,10,75,新光-高雄,2023-11-29,8562
00882,中信中國高股息,75,0,75,新光-高雄,2023-11-29,8562
00720B,元大投資級公司債,99,30,69,新光-高雄,2023-11-29,8562
6578,達邦蛋白,62,0,62,新光-高雄,2023-11-29,8562
00733,富邦臺灣中小,58,1,57,新光-高雄,2023-11-29,8562
00687B,國泰20年美債,73,19,54,新光-高雄,2023-11-29,8562
3105,穩懋,59,6,53,新光-高雄,2023-11-29,8562
5488,松普,45,0,45,新光-高雄,2023-11-29,8562
3231,緯創,109,66,43,新光-高雄,2023-11-29,8562
00751B,元大AAA至A公司債,41,0,41,新光-高雄,2023-11-29,8562
2603,長榮,52,13,39,新光-高雄,2023-11-29,8562
00931B,統一美債20年,43,4,39,新光-高雄,2023-11-29,8562
4714,永捷,53,14,39,新光-高雄,2023-11-29,8562
00713,元大台灣高息低波,49,10,39,新光-高雄,2023-11-29,8562
00935,野村臺灣新科技50,35,1,34,新光-高雄,2023-11-29,8562
1402,遠東新,34,0,34,新光-高雄,2023-11-29,8562
00752,中信中國50,33,0,33,新光-高雄,2023-11-29,8562
5534,長虹,31,0,31,新光-高雄,2023-11-29,8562
4303,信立,30,0,30,新光-高雄,2023-11-29,8562
3037,欣興,67,39,28,新光-高雄,2023-11-29,8562
6233,旺玖,28,2,26,新光-高雄,2023-11-29,8562
4973,廣穎,35,9,26,新光-高雄,2023-11-29,8562
3055,蔚華科,30,4,26,新光-高雄,2023-11-29,8562
2376,技嘉,50,25,25,新光-高雄,2023-11-29,8562
00712,復華富時不動產,34,9,25,新光-高雄,2023-11-29,8562
2006,東和鋼鐵,26,1,25,新光-高雄,2023-11-29,8562
2601,益航,25,0,25,新光-高雄,2023-11-29,8562
8011,台通,24,1,23,新光-高雄,2023-11-29,8562
3033,威健,23,0,23,新光-高雄,2023-11-29,8562
2329,華泰,472,450,22,新光-高雄,2023-11-29,8562
5381,合正,50,28,22,新光-高雄,2023-11-29,8562
6167,久正,45,23,22,新光-高雄,2023-11-29,8562
6171,大城地產,20,0,20,新光-高雄,2023-11-29,8562
00722B,群益投資級電信債,20,0,20,新光-高雄,2023-11-29,8562
2485,兆赫,22,2,20,新光-高雄,2023-11-29,8562
00934,中信成長高股息,37,18,19,新光-高雄,2023-11-29,8562
3322,建舜電,20,1,19,新光-高雄,2023-11-29,8562
1714,和桐,20,1,19,新光-高雄,2023-11-29,8562
6274,台燿,34,15,19,新光-高雄,2023-11-29,8562
3682,亞太電,1224,2,1222,新光-高雄,2023-11-30,8562
00924,復華S＆P500成長,202,3,199,新光-高雄,2023-11-30,8562
00934,中信成長高股息,185,0,185,新光-高雄,2023-11-30,8562
00882,中信中國高股息,121,5,116,新光-高雄,2023-11-30,8562
00632R,元大台灣50反1,151,40,111,新光-高雄,2023-11-30,8562
00680L,元大美債20正2,185,76,109,新光-高雄,2023-11-30,8562
2520,冠德,101,0,101,新光-高雄,2023-11-30,8562
00720B,元大投資級公司債,118,26,92,新光-高雄,2023-11-30,8562
00673R,期元大S＆P原油反1,91,0,91,新光-高雄,2023-11-30,8562
2332,友訊,107,27,80,新光-高雄,2023-11-30,8562
00665L,富邦�琤肭磪囓�2,274,207,67,新光-高雄,2023-11-30,8562
3231,緯創,101,35,66,新光-高雄,2023-11-30,8562
3363,上詮,108,49,59,新光-高雄,2023-11-30,8562
2329,華泰,507,455,52,新光-高雄,2023-11-30,8562
1218,泰山,53,13,40,新光-高雄,2023-11-30,8562
4721,美琪瑪,44,5,39,新光-高雄,2023-11-30,8562
2002,中鋼,103,68,35,新光-高雄,2023-11-30,8562
2376,技嘉,69,33,36,新光-高雄,2023-11-30,8562
00688L,國泰20年美債正2,38,3,35,新光-高雄,2023-11-30,8562
2606,裕民,40,6,34,新光-高雄,2023-11-30,8562
1591,駿吉-KY,32,0,32,新光-高雄,2023-11-30,8562
00753L,中信中國50正2,32,0,32,新光-高雄,2023-11-30,8562
2492,華新科,73,41,32,新光-高雄,2023-11-30,8562
1612,宏泰,30,0,30,新光-高雄,2023-11-30,8562
2353,宏��,46,17,29,新光-高雄,2023-11-30,8562
6171,大城地產,29,0,29,新光-高雄,2023-11-30,8562
3045,台灣大,29,0,29,新光-高雄,2023-11-30,8562
00878,國泰永續高股息,52,24,28,新光-高雄,2023-11-30,8562
3689,湧德,30,3,27,新光-高雄,2023-11-30,8562
6187,萬潤,41,15,26,新光-高雄,2023-11-30,8562
9904,寶成,26,0,26,新光-高雄,2023-11-30,8562
00935,野村臺灣新科技50,24,0,24,新光-高雄,2023-11-30,8562
3615,安可,39,15,24,新光-高雄,2023-11-30,8562
00664R,國泰臺灣加權反1,24,0,24,新光-高雄,2023-11-30,8562
2344,華邦電,250,228,22,新光-高雄,2023-11-30,8562
2317,鴻海,36,14,22,新光-高雄,2023-11-30,8562
00933B,國泰10Y+金融債,36,15,21,新光-高雄,2023-11-30,8562
4401,東隆興,36,15,21,新光-高雄,2023-11-30,8562
2006,東和鋼鐵,21,0,21,新光-高雄,2023-11-30,8562
1714,和桐,20,0,20,新光-高雄,2023-11-30,8562
2610,華航,112,93,19,新光-高雄,2023-11-30,8562
8942,森鉅,18,1,17,新光-高雄,2023-11-30,8562
3234,光環,20,3,17,新光-高雄,2023-11-30,8562
6282,康舒,21,5,16,新光-高雄,2023-11-30,8562
2838,聯邦銀,16,0,16,新光-高雄,2023-11-30,8562
4938,和碩,17,1,16,新光-高雄,2023-11-30,8562
3030,德律,16,0,16,新光-高雄,2023-11-30,8562
6233,旺玖,19,3,16,新光-高雄,2023-11-30,8562
00885,富邦越南,16,1,15,新光-高雄,2023-11-30,8562
6485,點序,28,13,15,新光-高雄,2023-11-30,8562
00919,群益台灣精選高息,407,157,250,新光-高雄,2023-12-01,8562
2884,玉山金,224,2,222,新光-高雄,2023-12-01,8562
00680L,元大美債20正2,188,0,188,新光-高雄,2023-12-01,8562
00715L,期街口布蘭特正2,149,3,146,新光-高雄,2023-12-01,8562
2883,凱基金,191,68,123,新光-高雄,2023-12-01,8562
00706L,期元大S＆P日圓正2,118,0,118,新光-高雄,2023-12-01,8562
4909,新復興,203,106,97,新光-高雄,2023-12-01,8562
00687B,國泰20年美債,97,0,97,新光-高雄,2023-12-01,8562
9919,康那香,268,185,83,新光-高雄,2023-12-01,8562
00637L,元大滬深300正2,154,75,79,新光-高雄,2023-12-01,8562
00673R,期元大S＆P原油反1,136,66,70,新光-高雄,2023-12-01,8562
2359,所羅門,85,23,62,新光-高雄,2023-12-01,8562
2834,臺企銀,60,2,58,新光-高雄,2023-12-01,8562
3041,揚智,152,100,52,新光-高雄,2023-12-01,8562
00632R,元大台灣50反1,52,0,52,新光-高雄,2023-12-01,8562
00712,復華富時不動產,64,13,51,新光-高雄,2023-12-01,8562
2363,矽統,108,59,49,新光-高雄,2023-12-01,8562
00882,中信中國高股息,52,4,48,新光-高雄,2023-12-01,8562
2405,輔信,65,19,46,新光-高雄,2023-12-01,8562
9921,巨大,63,17,46,新光-高雄,2023-12-01,8562
2888,新光金,46,0,46,新光-高雄,2023-12-01,8562
2356,英業達,60,17,43,新光-高雄,2023-12-01,8562
2332,友訊,45,2,43,新光-高雄,2023-12-01,8562
5328,華容,200,158,42,新光-高雄,2023-12-01,8562
8054,安國,102,62,40,新光-高雄,2023-12-01,8562
2002,中鋼,101,62,39,新光-高雄,2023-12-01,8562
1101,台泥,44,6,38,新光-高雄,2023-12-01,8562
2886,兆豐金,37,1,36,新光-高雄,2023-12-01,8562
2317,鴻海,44,9,35,新光-高雄,2023-12-01,8562
00688L,國泰20年美債正2,35,2,33,新光-高雄,2023-12-01,8562
6231,系微,39,7,32,新光-高雄,2023-12-01,8562
4157,太景*-KY,50,18,32,新光-高雄,2023-12-01,8562
2891,中信金,40,8,32,新光-高雄,2023-12-01,8562
00655L,國泰中國A50正2,38,7,31,新光-高雄,2023-12-01,8562
00664R,國泰臺灣加權反1,70,40,30,新光-高雄,2023-12-01,8562
5531,鄉林,30,0,30,新光-高雄,2023-12-01,8562
00720B,元大投資級公司債,138,110,28,新光-高雄,2023-12-01,8562
6213,聯茂,45,17,28,新光-高雄,2023-12-01,8562
3202,樺晟,28,1,27,新光-高雄,2023-12-01,8562
2887,台新金,27,0,27,新光-高雄,2023-12-01,8562
6180,橘子,33,7,26,新光-高雄,2023-12-01,8562
2413,環科,26,0,26,新光-高雄,2023-12-01,8562
6613,朋億*,25,0,25,新光-高雄,2023-12-01,8562
3702,大聯大,28,3,25,新光-高雄,2023-12-01,8562
5347,世界,37,12,25,新光-高雄,2023-12-01,8562
00751B,元大AAA至A公司債,24,0,24,新光-高雄,2023-12-01,8562
2355,敬鵬,60,37,23,新光-高雄,2023-12-01,8562
00642U,期元大S＆P石油,26,3,23,新光-高雄,2023-12-01,8562
2387,精元,24,1,23,新光-高雄,2023-12-01,8562
3481,群創,70,47,23,新光-高雄,2023-12-01,8562
2618,長榮航,558,28,530,新光-高雄,2023-12-04,8562
00919,群益台灣精選高息,599,161,438,新光-高雄,2023-12-04,8562
00929,復華台灣科技優息,558,195,363,新光-高雄,2023-12-04,8562
00715L,期街口布蘭特正2,398,98,300,新光-高雄,2023-12-04,8562
00882,中信中國高股息,285,19,266,新光-高雄,2023-12-04,8562
2888,新光金,174,33,141,新光-高雄,2023-12-04,8562
2353,宏��,126,3,123,新光-高雄,2023-12-04,8562
00687B,國泰20年美債,134,14,120,新光-高雄,2023-12-04,8562
00921,兆豐龍頭等權重,85,5,80,新光-高雄,2023-12-04,8562
2609,陽明,133,56,77,新光-高雄,2023-12-04,8562
3481,群創,195,119,76,新光-高雄,2023-12-04,8562
2883,凱基金,114,38,76,新光-高雄,2023-12-04,8562
00918,大華優利高填息30,81,8,73,新光-高雄,2023-12-04,8562
5871,中租-KY,67,7,60,新光-高雄,2023-12-04,8562
2520,冠德,62,5,57,新光-高雄,2023-12-04,8562
2007,燁興,60,5,55,新光-高雄,2023-12-04,8562
2388,威盛,84,37,47,新光-高雄,2023-12-04,8562
6237,驊訊,50,4,46,新光-高雄,2023-12-04,8562
1810,和成,43,0,43,新光-高雄,2023-12-04,8562
3682,亞太電,43,0,43,新光-高雄,2023-12-04,8562
1605,華新,79,37,42,新光-高雄,2023-12-04,8562
00933B,國泰10Y+金融債,43,2,41,新光-高雄,2023-12-04,8562
9907,統一實,40,0,40,新光-高雄,2023-12-04,8562
2812,台中銀,77,38,39,新光-高雄,2023-12-04,8562
3491,昇達科,40,1,39,新光-高雄,2023-12-04,8562
2356,英業達,71,32,39,新光-高雄,2023-12-04,8562
00905,FT臺灣Smart,35,0,35,新光-高雄,2023-12-04,8562
2530,華建,35,1,34,新光-高雄,2023-12-04,8562
2363,矽統,174,140,34,新光-高雄,2023-12-04,8562
2637,慧洋-KY,104,70,34,新光-高雄,2023-12-04,8562
00720B,元大投資級公司債,50,19,31,新光-高雄,2023-12-04,8562
1714,和桐,42,11,31,新光-高雄,2023-12-04,8562
4532,瑞智,31,0,31,新光-高雄,2023-12-04,8562
00934,中信成長高股息,41,11,30,新光-高雄,2023-12-04,8562
00642U,期元大S＆P石油,31,2,29,新光-高雄,2023-12-04,8562
5469,瀚宇博,104,76,28,新光-高雄,2023-12-04,8562
00679B,元大美債20年,36,9,27,新光-高雄,2023-12-04,8562
6733,博晟生醫,27,0,27,新光-高雄,2023-12-04,8562
2355,敬鵬,175,148,27,新光-高雄,2023-12-04,8562
3081,聯亞,27,1,26,新光-高雄,2023-12-04,8562
8163,達方,26,0,26,新光-高雄,2023-12-04,8562
00632R,元大台灣50反1,630,605,25,新光-高雄,2023-12-04,8562
8227,巨有科技,25,0,25,新光-高雄,2023-12-04,8562
3051,力特,69,45,24,新光-高雄,2023-12-04,8562
1760,寶齡富錦,32,8,24,新光-高雄,2023-12-04,8562
1907,永豐餘,46,23,23,新光-高雄,2023-12-04,8562
3046,建��,23,0,23,新光-高雄,2023-12-04,8562
1718,中纖,42,19,23,新光-高雄,2023-12-04,8562
3228,金麗科,25,2,23,新光-高雄,2023-12-04,8562
3149,正達,22,0,22,新光-高雄,2023-12-04,8562
2367,燿華,536,52,484,新光-高雄,2023-12-05,8562
00878,國泰永續高股息,537,75,462,新光-高雄,2023-12-05,8562
00937B,群益ESG投等債20,690,269,421,新光-高雄,2023-12-05,8562
00929,復華台灣科技優息,574,231,343,新光-高雄,2023-12-05,8562
2610,華航,331,3,328,新光-高雄,2023-12-05,8562
00919,群益台灣精選高息,379,191,188,新光-高雄,2023-12-05,8562
00715L,期街口布蘭特正2,203,50,153,新光-高雄,2023-12-05,8562
2344,華邦電,208,55,153,新光-高雄,2023-12-05,8562
00882,中信中國高股息,139,7,132,新光-高雄,2023-12-05,8562
2641,正德,312,185,127,新光-高雄,2023-12-05,8562
00753L,中信中國50正2,120,0,120,新光-高雄,2023-12-05,8562
2888,新光金,158,58,100,新光-高雄,2023-12-05,8562
3231,緯創,161,80,81,新光-高雄,2023-12-05,8562
1616,億泰,81,3,78,新光-高雄,2023-12-05,8562
4167,松瑞藥,162,84,78,新光-高雄,2023-12-05,8562
00934,中信成長高股息,81,4,77,新光-高雄,2023-12-05,8562
00688L,國泰20年美債正2,77,0,77,新光-高雄,2023-12-05,8562
2601,益航,208,134,74,新光-高雄,2023-12-05,8562
2609,陽明,82,13,69,新光-高雄,2023-12-05,8562
00706L,期元大S＆P日圓正2,64,0,64,新光-高雄,2023-12-05,8562
00687B,國泰20年美債,116,53,63,新光-高雄,2023-12-05,8562
00921,兆豐龍頭等權重,60,0,60,新光-高雄,2023-12-05,8562
3013,晟銘電,227,168,59,新光-高雄,2023-12-05,8562
00679B,元大美債20年,75,20,55,新光-高雄,2023-12-05,8562
00915,凱基優選高股息30,55,2,53,新光-高雄,2023-12-05,8562
00669R,國泰美國道瓊反1,53,0,53,新光-高雄,2023-12-05,8562
3062,建漢,55,2,53,新光-高雄,2023-12-05,8562
2356,英業達,97,46,51,新光-高雄,2023-12-05,8562
5302,太欣,51,0,51,新光-高雄,2023-12-05,8562
5871,中租-KY,53,2,51,新光-高雄,2023-12-05,8562
00918,大華優利高填息30,62,12,50,新光-高雄,2023-12-05,8562
2442,新美齊,49,0,49,新光-高雄,2023-12-05,8562
5347,世界,56,13,43,新光-高雄,2023-12-05,8562
00720B,元大投資級公司債,46,5,41,新光-高雄,2023-12-05,8562
6245,立端,40,1,39,新光-高雄,2023-12-05,8562
2834,臺企銀,48,10,38,新光-高雄,2023-12-05,8562
2516,新建,35,0,35,新光-高雄,2023-12-05,8562
00650L,復華香港正2,34,0,34,新光-高雄,2023-12-05,8562
2606,裕民,319,286,33,新光-高雄,2023-12-05,8562
1815,富喬,35,3,32,新光-高雄,2023-12-05,8562
9958,世紀鋼,34,3,31,新光-高雄,2023-12-05,8562
3390,旭軟,80,49,31,新光-高雄,2023-12-05,8562
8936,國統,39,11,28,新光-高雄,2023-12-05,8562
00637L,元大滬深300正2,105,77,28,新光-高雄,2023-12-05,8562
00922,國泰台灣領袖50,27,0,27,新光-高雄,2023-12-05,8562
2405,輔信,28,1,27,新光-高雄,2023-12-05,8562
2402,毅嘉,26,2,24,新光-高雄,2023-12-05,8562
00933B,國泰10Y+金融債,25,1,24,新光-高雄,2023-12-05,8562
2618,長榮航,33,10,23,新光-高雄,2023-12-05,8562
2612,中航,81,59,22,新光-高雄,2023-12-05,8562
00687B,國泰20年美債,879,65,814,新光-高雄,2023-12-06,8562
00937B,群益ESG投等債20,500,170,330,新光-高雄,2023-12-06,8562
00669R,國泰美國道瓊反1,249,5,244,新光-高雄,2023-12-06,8562
00919,群益台灣精選高息,224,23,201,新光-高雄,2023-12-06,8562
00929,復華台灣科技優息,393,208,185,新光-高雄,2023-12-06,8562
00715L,期街口布蘭特正2,253,90,163,新光-高雄,2023-12-06,8562
3481,群創,192,71,121,新光-高雄,2023-12-06,8562
00712,復華富時不動產,118,6,112,新光-高雄,2023-12-06,8562
00679B,元大美債20年,120,36,84,新光-高雄,2023-12-06,8562
00720B,元大投資級公司債,149,66,83,新光-高雄,2023-12-06,8562
2344,華邦電,114,39,75,新光-高雄,2023-12-06,8562
00918,大華優利高填息30,65,0,65,新光-高雄,2023-12-06,8562
5864,致和證,67,2,65,新光-高雄,2023-12-06,8562
2605,新興,402,346,56,新光-高雄,2023-12-06,8562
1477,聚陽,51,0,51,新光-高雄,2023-12-06,8562
4114,健喬,55,4,51,新光-高雄,2023-12-06,8562
3491,昇達科,50,0,50,新光-高雄,2023-12-06,8562
00664R,國泰臺灣加權反1,47,0,47,新光-高雄,2023-12-06,8562
00681R,元大美債20反1,47,0,47,新光-高雄,2023-12-06,8562
8096,擎亞,53,8,45,新光-高雄,2023-12-06,8562
2618,長榮航,51,9,42,新光-高雄,2023-12-06,8562
00680L,元大美債20正2,145,104,41,新光-高雄,2023-12-06,8562
00665L,富邦�琤肭磪囓�2,270,230,40,新光-高雄,2023-12-06,8562
3013,晟銘電,209,174,35,新光-高雄,2023-12-06,8562
6143,振曜,71,36,35,新光-高雄,2023-12-06,8562
00641R,富邦日本反1,33,0,33,新光-高雄,2023-12-06,8562
2313,華通,73,41,32,新光-高雄,2023-12-06,8562
00688L,國泰20年美債正2,66,35,31,新光-高雄,2023-12-06,8562
2303,聯電,37,9,28,新光-高雄,2023-12-06,8562
2329,華泰,87,60,27,新光-高雄,2023-12-06,8562
3715,定穎投控,81,54,27,新光-高雄,2023-12-06,8562
4532,瑞智,26,0,26,新光-高雄,2023-12-06,8562
2611,志信,52,27,25,新光-高雄,2023-12-06,8562
2355,敬鵬,153,129,24,新光-高雄,2023-12-06,8562
9921,巨大,27,5,22,新光-高雄,2023-12-06,8562
3059,華晶科,22,0,22,新光-高雄,2023-12-06,8562
6605,帝寶,32,10,22,新光-高雄,2023-12-06,8562
3567,逸昌,22,0,22,新光-高雄,2023-12-06,8562
00933B,國泰10Y+金融債,24,2,22,新光-高雄,2023-12-06,8562
6117,迎廣,116,96,20,新光-高雄,2023-12-06,8562
6026,福邦證,20,0,20,新光-高雄,2023-12-06,8562
2538,基泰,20,0,20,新光-高雄,2023-12-06,8562
2312,金寶,20,0,20,新光-高雄,2023-12-06,8562
00751B,元大AAA至A公司債,45,25,20,新光-高雄,2023-12-06,8562
1524,耿鼎,24,5,19,新光-高雄,2023-12-06,8562
2614,東森,19,0,19,新光-高雄,2023-12-06,8562
1529,樂事綠能,103,85,18,新光-高雄,2023-12-06,8562
1815,富喬,21,3,18,新光-高雄,2023-12-06,8562
8926,台汽電,17,0,17,新光-高雄,2023-12-06,8562
3050,鈺德,63,47,16,新光-高雄,2023-12-06,8562
00937B,群益ESG投等債20,646,59,587,新光-高雄,2023-12-07,8562
00688L,國泰20年美債正2,550,6,544,新光-高雄,2023-12-07,8562
00919,群益台灣精選高息,511,19,492,新光-高雄,2023-12-07,8562
00878,國泰永續高股息,540,52,488,新光-高雄,2023-12-07,8562
00669R,國泰美國道瓊反1,196,7,189,新光-高雄,2023-12-07,8562
00712,復華富時不動產,353,167,186,新光-高雄,2023-12-07,8562
00918,大華優利高填息30,124,0,124,新光-高雄,2023-12-07,8562
2882,國泰金,123,5,118,新光-高雄,2023-12-07,8562
1513,中興電,192,83,109,新光-高雄,2023-12-07,8562
00720B,元大投資級公司債,116,21,95,新光-高雄,2023-12-07,8562
2324,仁寶,106,17,89,新光-高雄,2023-12-07,8562
1337,再生-KY,85,0,85,新光-高雄,2023-12-07,8562
2889,國票金,90,12,78,新光-高雄,2023-12-07,8562
3481,群創,180,103,77,新光-高雄,2023-12-07,8562
1618,合機,231,154,77,新光-高雄,2023-12-07,8562
2399,映泰,210,133,77,新光-高雄,2023-12-07,8562
00882,中信中國高股息,81,8,73,新光-高雄,2023-12-07,8562
00637L,元大滬深300正2,211,142,69,新光-高雄,2023-12-07,8562
00679B,元大美債20年,258,194,64,新光-高雄,2023-12-07,8562
2834,臺企銀,65,3,62,新光-高雄,2023-12-07,8562
00930,永豐ESG低碳高息,58,0,58,新光-高雄,2023-12-07,8562
00933B,國泰10Y+金融債,53,0,53,新光-高雄,2023-12-07,8562
3372,典範,50,0,50,新光-高雄,2023-12-07,8562
2408,南亞科,63,13,50,新光-高雄,2023-12-07,8562
9921,巨大,47,0,47,新光-高雄,2023-12-07,8562
1301,台塑,45,2,43,新光-高雄,2023-12-07,8562
2314,台揚,50,9,41,新光-高雄,2023-12-07,8562
2515,中工,40,1,39,新光-高雄,2023-12-07,8562
2641,正德,49,12,37,新光-高雄,2023-12-07,8562
3710,連展投控,37,0,37,新光-高雄,2023-12-07,8562
2303,聯電,77,42,35,新光-高雄,2023-12-07,8562
2371,大同,58,25,33,新光-高雄,2023-12-07,8562
3260,威剛,62,31,31,新光-高雄,2023-12-07,8562
2388,威盛,76,46,30,新光-高雄,2023-12-07,8562
2367,燿華,64,34,30,新光-高雄,2023-12-07,8562
00893,國泰智能電動車,30,0,30,新光-高雄,2023-12-07,8562
3444,利機,44,15,29,新光-高雄,2023-12-07,8562
00907,永豐優息存股,27,0,27,新光-高雄,2023-12-07,8562
4306,炎洲,42,16,26,新光-高雄,2023-12-07,8562
00671R,富邦NASDAQ反1,25,0,25,新光-高雄,2023-12-07,8562
2365,昆盈,32,7,25,新光-高雄,2023-12-07,8562
3390,旭軟,42,18,24,新光-高雄,2023-12-07,8562
4967,十銓,57,33,24,新光-高雄,2023-12-07,8562
5210,寶碩,23,0,23,新光-高雄,2023-12-07,8562
2888,新光金,23,0,23,新光-高雄,2023-12-07,8562
6233,旺玖,70,47,23,新光-高雄,2023-12-07,8562
4939,亞電,23,0,23,新光-高雄,2023-12-07,8562
00642U,期元大S＆P石油,42,20,22,新光-高雄,2023-12-07,8562
4532,瑞智,22,0,22,新光-高雄,2023-12-07,8562
2881,富邦金,31,10,21,新光-高雄,2023-12-07,8562
2610,華航,381,67,314,新光-高雄,2023-12-08,8562
00687B,國泰20年美債,346,103,243,新光-高雄,2023-12-08,8562
00712,復華富時不動產,252,30,222,新光-高雄,2023-12-08,8562
00715L,期街口布蘭特正2,235,43,192,新光-高雄,2023-12-08,8562
00882,中信中國高股息,185,19,166,新光-高雄,2023-12-08,8562
8112,至上,261,120,141,新光-高雄,2023-12-08,8562
2883,凱基金,205,74,131,新光-高雄,2023-12-08,8562
00937B,群益ESG投等債20,145,39,106,新光-高雄,2023-12-08,8562
00632R,元大台灣50反1,828,733,95,新光-高雄,2023-12-08,8562
00919,群益台灣精選高息,232,149,83,新光-高雄,2023-12-08,8562
00933B,國泰10Y+金融債,68,0,68,新光-高雄,2023-12-08,8562
1524,耿鼎,336,268,68,新光-高雄,2023-12-08,8562
00679B,元大美債20年,119,59,60,新光-高雄,2023-12-08,8562
00907,永豐優息存股,55,0,55,新光-高雄,2023-12-08,8562
00934,中信成長高股息,63,10,53,新光-高雄,2023-12-08,8562
00918,大華優利高填息30,52,0,52,新光-高雄,2023-12-08,8562
4979,華星光,93,41,52,新光-高雄,2023-12-08,8562
00930,永豐ESG低碳高息,56,7,49,新光-高雄,2023-12-08,8562
2834,臺企銀,45,1,44,新光-高雄,2023-12-08,8562
2368,金像電,92,49,43,新光-高雄,2023-12-08,8562
2615,萬海,41,3,38,新光-高雄,2023-12-08,8562
2606,裕民,49,12,37,新光-高雄,2023-12-08,8562
8064,東捷,36,0,36,新光-高雄,2023-12-08,8562
00896,中信綠能及電動車,36,0,36,新光-高雄,2023-12-08,8562
4533,協易機,66,31,35,新光-高雄,2023-12-08,8562
00688L,國泰20年美債正2,56,21,35,新光-高雄,2023-12-08,8562
00720B,元大投資級公司債,51,16,35,新光-高雄,2023-12-08,8562
2867,三商壽,34,0,34,新光-高雄,2023-12-08,8562
00935,野村臺灣新科技50,32,0,32,新光-高雄,2023-12-08,8562
00753L,中信中國50正2,31,0,31,新光-高雄,2023-12-08,8562
2303,聯電,93,63,30,新光-高雄,2023-12-08,8562
4401,東隆興,30,0,30,新光-高雄,2023-12-08,8562
2888,新光金,33,4,29,新光-高雄,2023-12-08,8562
00751B,元大AAA至A公司債,31,2,29,新光-高雄,2023-12-08,8562
00795B,中信美國公債20年,32,4,28,新光-高雄,2023-12-08,8562
2329,華泰,75,47,28,新光-高雄,2023-12-08,8562
4306,炎洲,52,25,27,新光-高雄,2023-12-08,8562
5302,太欣,32,5,27,新光-高雄,2023-12-08,8562
5443,均豪,25,0,25,新光-高雄,2023-12-08,8562
2889,國票金,24,0,24,新光-高雄,2023-12-08,8562
6189,豐藝,25,1,24,新光-高雄,2023-12-08,8562
8072,陞泰,32,11,21,新光-高雄,2023-12-08,8562
8354,冠好,23,2,21,新光-高雄,2023-12-08,8562
4432,銘旺實,21,0,21,新光-高雄,2023-12-08,8562
1301,台塑,21,1,20,新光-高雄,2023-12-08,8562
4939,亞電,33,13,20,新光-高雄,2023-12-08,8562
9928,中視,20,0,20,新光-高雄,2023-12-08,8562
4960,誠美材,20,0,20,新光-高雄,2023-12-08,8562
6257,矽格,28,8,20,新光-高雄,2023-12-08,8562
6271,同欣電,29,9,20,新光-高雄,2023-12-08,8562
00929,復華台灣科技優息,585,89,496,新光-高雄,2023-12-11,8562
00919,群益台灣精選高息,593,97,496,新光-高雄,2023-12-11,8562
00715L,期街口布蘭特正2,557,169,388,新光-高雄,2023-12-11,8562
00882,中信中國高股息,330,30,300,新光-高雄,2023-12-11,8562
00795B,中信美國公債20年,252,28,224,新光-高雄,2023-12-11,8562
00671R,富邦NASDAQ反1,223,0,223,新光-高雄,2023-12-11,8562
00687B,國泰20年美債,207,6,201,新光-高雄,2023-12-11,8562
2888,新光金,191,23,168,新光-高雄,2023-12-11,8562
0056,元大高股息,140,18,122,新光-高雄,2023-12-11,8562
00673R,期元大S＆P原油反1,128,9,119,新光-高雄,2023-12-11,8562
00637L,元大滬深300正2,206,99,107,新光-高雄,2023-12-11,8562
4909,新復興,106,10,96,新光-高雄,2023-12-11,8562
00706L,期元大S＆P日圓正2,115,20,95,新光-高雄,2023-12-11,8562
00680L,元大美債20正2,160,65,95,新光-高雄,2023-12-11,8562
00665L,富邦�琤肭磪囓�2,108,33,75,新光-高雄,2023-12-11,8562
2388,威盛,127,53,74,新光-高雄,2023-12-11,8562
3062,建漢,76,4,72,新光-高雄,2023-12-11,8562
2867,三商壽,60,0,60,新光-高雄,2023-12-11,8562
2897,王道銀行,80,28,52,新光-高雄,2023-12-11,8562
00632R,元大台灣50反1,51,0,51,新光-高雄,2023-12-11,8562
6213,聯茂,52,3,49,新光-高雄,2023-12-11,8562
4306,炎洲,92,45,47,新光-高雄,2023-12-11,8562
3105,穩懋,46,0,46,新光-高雄,2023-12-11,8562
9921,巨大,45,1,44,新光-高雄,2023-12-11,8562
4931,新盛力,46,2,44,新光-高雄,2023-12-11,8562
1605,華新,45,1,44,新光-高雄,2023-12-11,8562
00918,大華優利高填息30,53,15,38,新光-高雄,2023-12-11,8562
3491,昇達科,37,0,37,新光-高雄,2023-12-11,8562
2605,新興,75,39,36,新光-高雄,2023-12-11,8562
3231,緯創,109,74,35,新光-高雄,2023-12-11,8562
2002,中鋼,109,76,33,新光-高雄,2023-12-11,8562
2889,國票金,33,0,33,新光-高雄,2023-12-11,8562
00679B,元大美債20年,57,24,33,新光-高雄,2023-12-11,8562
2883,凱基金,31,0,31,新光-高雄,2023-12-11,8562
00773B,中信優先金融債,34,3,31,新光-高雄,2023-12-11,8562
00753L,中信中國50正2,67,36,31,新光-高雄,2023-12-11,8562
6282,康舒,52,23,29,新光-高雄,2023-12-11,8562
3686,達能,27,0,27,新光-高雄,2023-12-11,8562
1515,力山,88,63,25,新光-高雄,2023-12-11,8562
4102,永日,25,0,25,新光-高雄,2023-12-11,8562
3234,光環,24,0,24,新光-高雄,2023-12-11,8562
4968,立積,29,5,24,新光-高雄,2023-12-11,8562
3260,威剛,36,13,23,新光-高雄,2023-12-11,8562
2301,光寶科,30,8,22,新光-高雄,2023-12-11,8562
2358,廷鑫,35,13,22,新光-高雄,2023-12-11,8562
2601,益航,22,1,21,新光-高雄,2023-12-11,8562
00633L,富邦上証正2,28,7,21,新光-高雄,2023-12-11,8562
6530,創威,34,13,21,新光-高雄,2023-12-11,8562
5388,中磊,21,0,21,新光-高雄,2023-12-11,8562
3499,環天科,28,8,20,新光-高雄,2023-12-11,8562
00688L,國泰20年美債正2,558,18,540,新光-高雄,2023-12-12,8562
00687B,國泰20年美債,305,4,301,新光-高雄,2023-12-12,8562
00919,群益台灣精選高息,562,353,209,新光-高雄,2023-12-12,8562
2888,新光金,176,3,173,新光-高雄,2023-12-12,8562
00751B,元大AAA至A公司債,133,0,133,新光-高雄,2023-12-12,8562
00712,復華富時不動產,172,58,114,新光-高雄,2023-12-12,8562
2867,三商壽,125,12,113,新光-高雄,2023-12-12,8562
2892,第一金,100,0,100,新光-高雄,2023-12-12,8562
00679B,元大美債20年,113,16,97,新光-高雄,2023-12-12,8562
00937B,群益ESG投等債20,102,18,84,新光-高雄,2023-12-12,8562
00933B,國泰10Y+金融債,78,8,70,新光-高雄,2023-12-12,8562
9921,巨大,69,11,58,新光-高雄,2023-12-12,8562
2344,華邦電,175,119,56,新光-高雄,2023-12-12,8562
2609,陽明,86,32,54,新光-高雄,2023-12-12,8562
00934,中信成長高股息,52,1,51,新光-高雄,2023-12-12,8562
00915,凱基優選高股息30,47,0,47,新光-高雄,2023-12-12,8562
2615,萬海,63,17,46,新光-高雄,2023-12-12,8562
2464,盟立,45,0,45,新光-高雄,2023-12-12,8562
6546,正基,52,8,44,新光-高雄,2023-12-12,8562
8034,榮群,113,70,43,新光-高雄,2023-12-12,8562
2881,富邦金,42,1,41,新光-高雄,2023-12-12,8562
00885,富邦越南,43,4,39,新光-高雄,2023-12-12,8562
00773B,中信優先金融債,42,3,39,新光-高雄,2023-12-12,8562
00882,中信中國高股息,160,121,39,新光-高雄,2023-12-12,8562
1314,中石化,38,2,36,新光-高雄,2023-12-12,8562
00671R,富邦NASDAQ反1,61,25,36,新光-高雄,2023-12-12,8562
6156,松上,45,10,35,新光-高雄,2023-12-12,8562
2409,友達,39,5,34,新光-高雄,2023-12-12,8562
2002,中鋼,37,4,33,新光-高雄,2023-12-12,8562
1618,合機,152,119,33,新光-高雄,2023-12-12,8562
00918,大華優利高填息30,51,19,32,新光-高雄,2023-12-12,8562
4967,十銓,63,31,32,新光-高雄,2023-12-12,8562
2402,毅嘉,94,63,31,新光-高雄,2023-12-12,8562
2542,興富發,33,2,31,新光-高雄,2023-12-12,8562
3105,穩懋,35,5,30,新光-高雄,2023-12-12,8562
1210,大成,41,11,30,新光-高雄,2023-12-12,8562
5443,均豪,30,0,30,新光-高雄,2023-12-12,8562
1324,地球,55,27,28,新光-高雄,2023-12-12,8562
1584,精剛,125,98,27,新光-高雄,2023-12-12,8562
6113,亞矽,39,12,27,新光-高雄,2023-12-12,8562
2363,矽統,47,22,25,新光-高雄,2023-12-12,8562
00857B,永豐20年美公債,25,0,25,新光-高雄,2023-12-12,8562
4908,前鼎,57,34,23,新光-高雄,2023-12-12,8562
6282,康舒,39,16,23,新光-高雄,2023-12-12,8562
3231,緯創,127,104,23,新光-高雄,2023-12-12,8562
3437,榮創,26,3,23,新光-高雄,2023-12-12,8562
8163,達方,23,1,22,新光-高雄,2023-12-12,8562
2399,映泰,22,0,22,新光-高雄,2023-12-12,8562
2312,金寶,21,0,21,新光-高雄,2023-12-12,8562
8096,擎亞,125,105,20,新光-高雄,2023-12-12,8562
00919,群益台灣精選高息,1005,237,768,新光-高雄,2023-12-13,8562
00715L,期街口布蘭特正2,790,49,741,新光-高雄,2023-12-13,8562
00882,中信中國高股息,719,107,612,新光-高雄,2023-12-13,8562
2867,三商壽,205,20,185,新光-高雄,2023-12-13,8562
00680L,元大美債20正2,185,13,172,新光-高雄,2023-12-13,8562
00632R,元大台灣50反1,177,13,164,新光-高雄,2023-12-13,8562
00637L,元大滬深300正2,172,14,158,新光-高雄,2023-12-13,8562
1210,大成,160,2,158,新光-高雄,2023-12-13,8562
00933B,國泰10Y+金融債,146,2,144,新光-高雄,2023-12-13,8562
00918,大華優利高填息30,191,52,139,新光-高雄,2023-12-13,8562
00896,中信綠能及電動車,137,0,137,新光-高雄,2023-12-13,8562
00687B,國泰20年美債,149,27,122,新光-高雄,2023-12-13,8562
8034,榮群,177,69,108,新光-高雄,2023-12-13,8562
00688L,國泰20年美債正2,117,10,107,新光-高雄,2023-12-13,8562
00929,復華台灣科技優息,401,295,106,新光-高雄,2023-12-13,8562
00885,富邦越南,111,8,103,新光-高雄,2023-12-13,8562
3019,亞光,121,39,82,新光-高雄,2023-12-13,8562
2002,中鋼,87,16,71,新光-高雄,2023-12-13,8562
00931B,統一美債20年,72,7,65,新光-高雄,2023-12-13,8562
00642U,期元大S＆P石油,64,2,62,新光-高雄,2023-12-13,8562
3706,神達,122,62,60,新光-高雄,2023-12-13,8562
00670L,富邦NASDAQ正2,61,3,58,新光-高雄,2023-12-13,8562
3035,智原,91,36,55,新光-高雄,2023-12-13,8562
1301,台塑,55,3,52,新光-高雄,2023-12-13,8562
8011,台通,136,85,51,新光-高雄,2023-12-13,8562
1815,富喬,118,68,50,新光-高雄,2023-12-13,8562
00664R,國泰臺灣加權反1,50,0,50,新光-高雄,2023-12-13,8562
2634,漢翔,69,19,50,新光-高雄,2023-12-13,8562
6546,正基,63,15,48,新光-高雄,2023-12-13,8562
1584,精剛,79,33,46,新光-高雄,2023-12-13,8562
2606,裕民,65,24,41,新光-高雄,2023-12-13,8562
00934,中信成長高股息,39,0,39,新光-高雄,2023-12-13,8562
00753L,中信中國50正2,37,0,37,新光-高雄,2023-12-13,8562
00665L,富邦�琤肭磪囓�2,91,55,36,新光-高雄,2023-12-13,8562
5864,致和證,36,0,36,新光-高雄,2023-12-13,8562
5880,合庫金,60,25,35,新光-高雄,2023-12-13,8562
2025,千興,33,0,33,新光-高雄,2023-12-13,8562
2392,正崴,104,71,33,新光-高雄,2023-12-13,8562
00922,國泰台灣領袖50,32,0,32,新光-高雄,2023-12-13,8562
6223,旺矽,34,3,31,新光-高雄,2023-12-13,8562
6282,康舒,42,12,30,新光-高雄,2023-12-13,8562
2516,新建,36,7,29,新光-高雄,2023-12-13,8562
2615,萬海,30,2,28,新光-高雄,2023-12-13,8562
2812,台中銀,43,16,27,新光-高雄,2023-12-13,8562
00671R,富邦NASDAQ反1,37,11,26,新光-高雄,2023-12-13,8562
5871,中租-KY,27,1,26,新光-高雄,2023-12-13,8562
2480,敦陽科,25,0,25,新光-高雄,2023-12-13,8562
2439,美律,30,6,24,新光-高雄,2023-12-13,8562
3481,群創,33,10,23,新光-高雄,2023-12-13,8562
2425,承啟,62,39,23,新光-高雄,2023-12-13,8562
00919,群益台灣精選高息,1159,103,1056,新光-高雄,2023-12-14,8562
00680L,元大美債20正2,900,538,362,新光-高雄,2023-12-14,8562
00937B,群益ESG投等債20,243,24,219,新光-高雄,2023-12-14,8562
00637L,元大滬深300正2,216,43,173,新光-高雄,2023-12-14,8562
00687B,國泰20年美債,240,92,148,新光-高雄,2023-12-14,8562
00933B,國泰10Y+金融債,179,32,147,新光-高雄,2023-12-14,8562
00882,中信中國高股息,202,70,132,新光-高雄,2023-12-14,8562
1605,華新,108,8,100,新光-高雄,2023-12-14,8562
2313,華通,649,567,82,新光-高雄,2023-12-14,8562
5864,致和證,88,6,82,新光-高雄,2023-12-14,8562
00918,大華優利高填息30,102,32,70,新光-高雄,2023-12-14,8562
3231,緯創,195,127,68,新光-高雄,2023-12-14,8562
2867,三商壽,77,17,60,新光-高雄,2023-12-14,8562
6168,宏齊,95,36,59,新光-高雄,2023-12-14,8562
00936,台新永續高息中小,58,0,58,新光-高雄,2023-12-14,8562
00632R,元大台灣50反1,96,40,56,新光-高雄,2023-12-14,8562
6187,萬潤,58,3,55,新光-高雄,2023-12-14,8562
00669R,國泰美國道瓊反1,68,15,53,新光-高雄,2023-12-14,8562
1312,國喬,65,13,52,新光-高雄,2023-12-14,8562
1907,永豐餘,58,9,49,新光-高雄,2023-12-14,8562
2812,台中銀,56,12,44,新光-高雄,2023-12-14,8562
6257,矽格,84,40,44,新光-高雄,2023-12-14,8562
00665L,富邦�琤肭磪囓�2,55,12,43,新光-高雄,2023-12-14,8562
00720B,元大投資級公司債,68,25,43,新光-高雄,2023-12-14,8562
6127,九豪,60,20,40,新光-高雄,2023-12-14,8562
00681R,元大美債20反1,40,0,40,新光-高雄,2023-12-14,8562
8034,榮群,129,91,38,新光-高雄,2023-12-14,8562
2365,昆盈,92,55,37,新光-高雄,2023-12-14,8562
3702,大聯大,52,15,37,新光-高雄,2023-12-14,8562
00670L,富邦NASDAQ正2,35,1,34,新光-高雄,2023-12-14,8562
2367,燿華,50,17,33,新光-高雄,2023-12-14,8562
8096,擎亞,40,12,28,新光-高雄,2023-12-14,8562
3712,永崴投控,81,54,27,新光-高雄,2023-12-14,8562
2329,華泰,103,76,27,新光-高雄,2023-12-14,8562
6547,高端疫苗,28,2,26,新光-高雄,2023-12-14,8562
00751B,元大AAA至A公司債,35,10,25,新光-高雄,2023-12-14,8562
3706,神達,56,32,24,新光-高雄,2023-12-14,8562
2610,華航,27,3,24,新光-高雄,2023-12-14,8562
3213,茂訊,33,10,23,新光-高雄,2023-12-14,8562
6188,廣明,66,43,23,新光-高雄,2023-12-14,8562
5521,工信,303,280,23,新光-高雄,2023-12-14,8562
5328,華容,51,29,22,新光-高雄,2023-12-14,8562
2486,一詮,59,37,22,新光-高雄,2023-12-14,8562
3062,建漢,22,0,22,新光-高雄,2023-12-14,8562
00857B,永豐20年美公債,27,5,22,新光-高雄,2023-12-14,8562
3029,零壹,24,2,22,新光-高雄,2023-12-14,8562
00795B,中信美國公債20年,31,10,21,新光-高雄,2023-12-14,8562
3005,神基,57,37,20,新光-高雄,2023-12-14,8562
3041,揚智,199,179,20,新光-高雄,2023-12-14,8562
00905,FT臺灣Smart,20,0,20,新光-高雄,2023-12-14,8562
00878,國泰永續高股息,467,84,383,新光-高雄,2023-12-15,8562
00929,復華台灣科技優息,1324,960,364,新光-高雄,2023-12-15,8562
00688L,國泰20年美債正2,392,53,339,新光-高雄,2023-12-15,8562
00918,大華優利高填息30,264,30,234,新光-高雄,2023-12-15,8562
00687B,國泰20年美債,332,108,224,新光-高雄,2023-12-15,8562
2356,英業達,772,567,205,新光-高雄,2023-12-15,8562
00680L,元大美債20正2,509,329,180,新光-高雄,2023-12-15,8562
00673R,期元大S＆P原油反1,174,0,174,新光-高雄,2023-12-15,8562
1513,中興電,193,25,168,新光-高雄,2023-12-15,8562
5864,致和證,169,16,153,新光-高雄,2023-12-15,8562
00896,中信綠能及電動車,130,0,130,新光-高雄,2023-12-15,8562
00637L,元大滬深300正2,271,152,119,新光-高雄,2023-12-15,8562
00679B,元大美債20年,134,34,100,新光-高雄,2023-12-15,8562
1210,大成,98,3,95,新光-高雄,2023-12-15,8562
1312,國喬,100,9,91,新光-高雄,2023-12-15,8562
2371,大同,110,24,86,新光-高雄,2023-12-15,8562
2022,聚亨,100,22,78,新光-高雄,2023-12-15,8562
00669R,國泰美國道瓊反1,93,25,68,新光-高雄,2023-12-15,8562
2363,矽統,482,422,60,新光-高雄,2023-12-15,8562
1584,精剛,277,218,59,新光-高雄,2023-12-15,8562
3059,華晶科,56,0,56,新光-高雄,2023-12-15,8562
00933B,國泰10Y+金融債,76,22,54,新光-高雄,2023-12-15,8562
3231,緯創,114,69,45,新光-高雄,2023-12-15,8562
00632R,元大台灣50反1,73,31,42,新光-高雄,2023-12-15,8562
5515,建國,61,21,40,新光-高雄,2023-12-15,8562
00930,永豐ESG低碳高息,38,0,38,新光-高雄,2023-12-15,8562
2801,彰銀,38,0,38,新光-高雄,2023-12-15,8562
3712,永崴投控,70,39,31,新光-高雄,2023-12-15,8562
3036,文曄,35,4,31,新光-高雄,2023-12-15,8562
5483,中美晶,46,16,30,新光-高雄,2023-12-15,8562
2501,國建,31,1,30,新光-高雄,2023-12-15,8562
5210,寶碩,32,2,30,新光-高雄,2023-12-15,8562
00787B,元大10年IG醫療債,30,0,30,新光-高雄,2023-12-15,8562
2610,華航,86,59,27,新光-高雄,2023-12-15,8562
00720B,元大投資級公司債,109,82,27,新光-高雄,2023-12-15,8562
2009,第一銅,36,10,26,新光-高雄,2023-12-15,8562
2201,裕隆,28,2,26,新光-高雄,2023-12-15,8562
6130,上亞科技,25,0,25,新光-高雄,2023-12-15,8562
1432,大魯閣,25,0,25,新光-高雄,2023-12-15,8562
2887,台新金,34,10,24,新光-高雄,2023-12-15,8562
3260,威剛,62,38,24,新光-高雄,2023-12-15,8562
1319,東陽,39,15,24,新光-高雄,2023-12-15,8562
1609,大亞,39,16,23,新光-高雄,2023-12-15,8562
00670L,富邦NASDAQ正2,23,0,23,新光-高雄,2023-12-15,8562
6191,精成科,34,12,22,新光-高雄,2023-12-15,8562
00915,凱基優選高股息30,41,19,22,新光-高雄,2023-12-15,8562
3346,麗清,41,19,22,新光-高雄,2023-12-15,8562
1608,華榮,33,11,22,新光-高雄,2023-12-15,8562
2834,臺企銀,25,4,21,新光-高雄,2023-12-15,8562
00934,中信成長高股息,37,17,20,新光-高雄,2023-12-15,8562
00688L,國泰20年美債正2,657,96,561,新光-高雄,2023-12-18,8562
00929,復華台灣科技優息,1052,563,489,新光-高雄,2023-12-18,8562
00933B,國泰10Y+金融債,156,5,151,新光-高雄,2023-12-18,8562
2801,彰銀,137,2,135,新光-高雄,2023-12-18,8562
00937B,群益ESG投等債20,193,81,112,新光-高雄,2023-12-18,8562
00671R,富邦NASDAQ反1,105,0,105,新光-高雄,2023-12-18,8562
2356,英業達,247,149,98,新光-高雄,2023-12-18,8562
00669R,國泰美國道瓊反1,90,0,90,新光-高雄,2023-12-18,8562
5864,致和證,89,0,89,新光-高雄,2023-12-18,8562
2527,宏璟,114,25,89,新光-高雄,2023-12-18,8562
1608,華榮,73,0,73,新光-高雄,2023-12-18,8562
1201,味全,64,0,64,新光-高雄,2023-12-18,8562
00715L,期街口布蘭特正2,174,110,64,新光-高雄,2023-12-18,8562
3149,正達,62,0,62,新光-高雄,2023-12-18,8562
2897,王道銀行,61,0,61,新光-高雄,2023-12-18,8562
2610,華航,77,22,55,新光-高雄,2023-12-18,8562
00734B,台新JPM新興債,52,0,52,新光-高雄,2023-12-18,8562
1802,台玻,61,13,48,新光-高雄,2023-12-18,8562
0056,元大高股息,80,35,45,新光-高雄,2023-12-18,8562
2618,長榮航,143,100,43,新光-高雄,2023-12-18,8562
00665L,富邦�琤肭磪囓�2,424,381,43,新光-高雄,2023-12-18,8562
2601,益航,49,6,43,新光-高雄,2023-12-18,8562
8112,至上,115,74,41,新光-高雄,2023-12-18,8562
3013,晟銘電,43,3,40,新光-高雄,2023-12-18,8562
2812,台中銀,40,1,39,新光-高雄,2023-12-18,8562
3481,群創,53,15,38,新光-高雄,2023-12-18,8562
00936,台新永續高息中小,38,0,38,新光-高雄,2023-12-18,8562
00706L,期元大S＆P日圓正2,54,16,38,新光-高雄,2023-12-18,8562
1210,大成,41,4,37,新光-高雄,2023-12-18,8562
2913,農林,52,17,35,新光-高雄,2023-12-18,8562
5014,建錩,50,17,33,新光-高雄,2023-12-18,8562
6546,正基,45,14,31,新光-高雄,2023-12-18,8562
00919,群益台灣精選高息,658,627,31,新光-高雄,2023-12-18,8562
2030,彰源,74,47,27,新光-高雄,2023-12-18,8562
00930,永豐ESG低碳高息,25,0,25,新光-高雄,2023-12-18,8562
2537,聯上發,25,0,25,新光-高雄,2023-12-18,8562
2104,國際中橡,25,0,25,新光-高雄,2023-12-18,8562
3105,穩懋,32,8,24,新光-高雄,2023-12-18,8562
8444,綠河-KY,24,0,24,新光-高雄,2023-12-18,8562
3624,光頡,25,1,24,新光-高雄,2023-12-18,8562
3209,全科,23,0,23,新光-高雄,2023-12-18,8562
2882,國泰金,35,12,23,新光-高雄,2023-12-18,8562
00713,元大台灣高息低波,30,8,22,新光-高雄,2023-12-18,8562
00637L,元大滬深300正2,76,54,22,新光-高雄,2023-12-18,8562
1609,大亞,45,23,22,新光-高雄,2023-12-18,8562
3622,洋華,24,2,22,新光-高雄,2023-12-18,8562
1605,華新,69,48,21,新光-高雄,2023-12-18,8562
2515,中工,50,29,21,新光-高雄,2023-12-18,8562
5347,世界,23,2,21,新光-高雄,2023-12-18,8562
4974,亞泰,21,0,21,新光-高雄,2023-12-18,8562
9105,泰金寶-DR,365,56,309,新光-高雄,2023-12-19,8562
00937B,群益ESG投等債20,350,55,295,新光-高雄,2023-12-19,8562
00919,群益台灣精選高息,357,79,278,新光-高雄,2023-12-19,8562
00688L,國泰20年美債正2,387,143,244,新光-高雄,2023-12-19,8562
2344,華邦電,395,239,156,新光-高雄,2023-12-19,8562
00680L,元大美債20正2,334,195,139,新光-高雄,2023-12-19,8562
00720B,元大投資級公司債,254,119,135,新光-高雄,2023-12-19,8562
5521,工信,203,93,110,新光-高雄,2023-12-19,8562
2356,英業達,170,66,104,新光-高雄,2023-12-19,8562
2609,陽明,455,356,99,新光-高雄,2023-12-19,8562
00712,復華富時不動產,325,237,88,新光-高雄,2023-12-19,8562
00706L,期元大S＆P日圓正2,85,1,84,新光-高雄,2023-12-19,8562
1201,味全,75,0,75,新光-高雄,2023-12-19,8562
1802,台玻,74,1,73,新光-高雄,2023-12-19,8562
00933B,國泰10Y+金融債,63,1,62,新光-高雄,2023-12-19,8562
00687B,國泰20年美債,120,58,62,新光-高雄,2023-12-19,8562
00632R,元大台灣50反1,73,15,58,新光-高雄,2023-12-19,8562
2882,國泰金,59,5,54,新光-高雄,2023-12-19,8562
3060,銘異,50,10,40,新光-高雄,2023-12-19,8562
2505,國揚,52,15,37,新光-高雄,2023-12-19,8562
2610,華航,73,36,37,新光-高雄,2023-12-19,8562
00676R,富邦臺灣加權反1,35,0,35,新光-高雄,2023-12-19,8562
4707,磐亞,34,0,34,新光-高雄,2023-12-19,8562
2801,彰銀,34,0,34,新光-高雄,2023-12-19,8562
00936,台新永續高息中小,29,0,29,新光-高雄,2023-12-19,8562
1808,潤隆,65,37,28,新光-高雄,2023-12-19,8562
6182,合晶,38,10,28,新光-高雄,2023-12-19,8562
2101,南港,28,0,28,新光-高雄,2023-12-19,8562
00918,大華優利高填息30,34,7,27,新光-高雄,2023-12-19,8562
5009,榮剛,34,8,26,新光-高雄,2023-12-19,8562
6443,元晶,51,27,24,新光-高雄,2023-12-19,8562
5347,世界,27,3,24,新光-高雄,2023-12-19,8562
00888,永豐台灣ESG,24,0,24,新光-高雄,2023-12-19,8562
2498,宏達電,25,3,22,新光-高雄,2023-12-19,8562
3105,穩懋,27,5,22,新光-高雄,2023-12-19,8562
00665L,富邦�琤肭磪囓�2,57,35,22,新光-高雄,2023-12-19,8562
2352,佳世達,22,0,22,新光-高雄,2023-12-19,8562
2892,第一金,21,0,21,新光-高雄,2023-12-19,8562
6026,福邦證,20,0,20,新光-高雄,2023-12-19,8562
2069,運錩,21,2,19,新光-高雄,2023-12-19,8562
2618,長榮航,122,104,18,新光-高雄,2023-12-19,8562
2303,聯電,63,44,19,新光-高雄,2023-12-19,8562
2812,台中銀,21,2,19,新光-高雄,2023-12-19,8562
3006,晶豪科,46,28,18,新光-高雄,2023-12-19,8562
5483,中美晶,41,23,18,新光-高雄,2023-12-19,8562
1616,億泰,20,2,18,新光-高雄,2023-12-19,8562
00673R,期元大S＆P原油反1,20,2,18,新光-高雄,2023-12-19,8562
8936,國統,32,14,18,新光-高雄,2023-12-19,8562
2486,一詮,20,3,17,新光-高雄,2023-12-19,8562
2516,新建,35,18,17,新光-高雄,2023-12-19,8562
00632R,元大台灣50反1,990,20,970,新光-高雄,2023-12-20,8562
00919,群益台灣精選高息,493,39,454,新光-高雄,2023-12-20,8562
00929,復華台灣科技優息,432,131,301,新光-高雄,2023-12-20,8562
00937B,群益ESG投等債20,244,29,215,新光-高雄,2023-12-20,8562
00715L,期街口布蘭特正2,316,107,209,新光-高雄,2023-12-20,8562
2884,玉山金,205,1,204,新光-高雄,2023-12-20,8562
2312,金寶,305,102,203,新光-高雄,2023-12-20,8562
00680L,元大美債20正2,257,109,148,新光-高雄,2023-12-20,8562
00706L,期元大S＆P日圓正2,163,20,143,新光-高雄,2023-12-20,8562
00720B,元大投資級公司債,107,3,104,新光-高雄,2023-12-20,8562
00669R,國泰美國道瓊反1,105,10,95,新光-高雄,2023-12-20,8562
00679B,元大美債20年,103,18,85,新光-高雄,2023-12-20,8562
00885,富邦越南,75,0,75,新光-高雄,2023-12-20,8562
2891,中信金,73,4,69,新光-高雄,2023-12-20,8562
1905,華紙,87,20,67,新光-高雄,2023-12-20,8562
00934,中信成長高股息,65,3,62,新光-高雄,2023-12-20,8562
4102,永日,60,0,60,新光-高雄,2023-12-20,8562
5864,致和證,64,6,58,新光-高雄,2023-12-20,8562
00882,中信中國高股息,57,0,57,新光-高雄,2023-12-20,8562
1314,中石化,56,2,54,新光-高雄,2023-12-20,8562
00751B,元大AAA至A公司債,52,1,51,新光-高雄,2023-12-20,8562
2882,國泰金,50,1,49,新光-高雄,2023-12-20,8562
2867,三商壽,71,30,41,新光-高雄,2023-12-20,8562
2405,輔信,41,0,41,新光-高雄,2023-12-20,8562
2007,燁興,72,32,40,新光-高雄,2023-12-20,8562
2801,彰銀,58,18,40,新光-高雄,2023-12-20,8562
2892,第一金,42,3,39,新光-高雄,2023-12-20,8562
00673R,期元大S＆P原油反1,38,0,38,新光-高雄,2023-12-20,8562
4306,炎洲,52,15,37,新光-高雄,2023-12-20,8562
2014,中鴻,175,141,34,新光-高雄,2023-12-20,8562
6140,訊達,34,4,30,新光-高雄,2023-12-20,8562
2601,益航,30,0,30,新光-高雄,2023-12-20,8562
00933B,國泰10Y+金融債,47,19,28,新光-高雄,2023-12-20,8562
2809,京城銀,27,0,27,新光-高雄,2023-12-20,8562
6244,茂迪,41,16,25,新光-高雄,2023-12-20,8562
00905,FT臺灣Smart,30,5,25,新光-高雄,2023-12-20,8562
3287,廣寰科,26,5,21,新光-高雄,2023-12-20,8562
2006,東和鋼鐵,20,0,20,新光-高雄,2023-12-20,8562
3006,晶豪科,39,20,19,新光-高雄,2023-12-20,8562
2880,華南金,21,3,18,新光-高雄,2023-12-20,8562
6282,康舒,27,9,18,新光-高雄,2023-12-20,8562
2369,菱生,57,39,18,新光-高雄,2023-12-20,8562
00915,凱基優選高股息30,17,0,17,新光-高雄,2023-12-20,8562
2023,燁輝,49,32,17,新光-高雄,2023-12-20,8562
2883,凱基金,19,2,17,新光-高雄,2023-12-20,8562
2520,冠德,17,1,16,新光-高雄,2023-12-20,8562
3059,華晶科,15,0,15,新光-高雄,2023-12-20,8562
2009,第一銅,21,6,15,新光-高雄,2023-12-20,8562
9935,慶豐富,15,0,15,新光-高雄,2023-12-20,8562
6127,九豪,15,0,15,新光-高雄,2023-12-20,8562
00919,群益台灣精選高息,638,105,533,新光-高雄,2023-12-21,8562
9105,泰金寶-DR,507,315,192,新光-高雄,2023-12-21,8562
00680L,元大美債20正2,188,50,138,新光-高雄,2023-12-21,8562
00934,中信成長高股息,92,1,91,新光-高雄,2023-12-21,8562
00933B,國泰10Y+金融債,81,2,79,新光-高雄,2023-12-21,8562
0056,元大高股息,99,21,78,新光-高雄,2023-12-21,8562
2801,彰銀,74,1,73,新光-高雄,2023-12-21,8562
2641,正德,116,54,62,新光-高雄,2023-12-21,8562
2886,兆豐金,63,3,60,新光-高雄,2023-12-21,8562
00882,中信中國高股息,352,300,52,新光-高雄,2023-12-21,8562
6546,正基,69,19,50,新光-高雄,2023-12-21,8562
00937B,群益ESG投等債20,89,41,48,新光-高雄,2023-12-21,8562
00679B,元大美債20年,79,35,44,新光-高雄,2023-12-21,8562
1301,台塑,43,0,43,新光-高雄,2023-12-21,8562
00720B,元大投資級公司債,52,9,43,新光-高雄,2023-12-21,8562
2103,台橡,37,0,37,新光-高雄,2023-12-21,8562
2317,鴻海,63,28,35,新光-高雄,2023-12-21,8562
2324,仁寶,273,240,33,新光-高雄,2023-12-21,8562
00923,群益台ESG低碳50,33,1,32,新光-高雄,2023-12-21,8562
2371,大同,49,17,32,新光-高雄,2023-12-21,8562
00712,復華富時不動產,98,68,30,新光-高雄,2023-12-21,8562
00888,永豐台灣ESG,30,0,30,新光-高雄,2023-12-21,8562
9921,巨大,46,16,30,新光-高雄,2023-12-21,8562
2369,菱生,30,0,30,新光-高雄,2023-12-21,8562
00676R,富邦臺灣加權反1,30,0,30,新光-高雄,2023-12-21,8562
2505,國揚,35,7,28,新光-高雄,2023-12-21,8562
1325,恆大,183,156,27,新光-高雄,2023-12-21,8562
2542,興富發,27,0,27,新光-高雄,2023-12-21,8562
2538,基泰,24,0,24,新光-高雄,2023-12-21,8562
2727,王品,22,0,22,新光-高雄,2023-12-21,8562
00935,野村臺灣新科技50,22,0,22,新光-高雄,2023-12-21,8562
6443,元晶,22,1,21,新光-高雄,2023-12-21,8562
1504,東元,22,1,21,新光-高雄,2023-12-21,8562
3047,訊舟,22,1,21,新光-高雄,2023-12-21,8562
1522,堤維西,31,11,20,新光-高雄,2023-12-21,8562
3704,合勤控,21,1,20,新光-高雄,2023-12-21,8562
9919,康那香,232,213,19,新光-高雄,2023-12-21,8562
00675L,富邦臺灣加權正2,19,0,19,新光-高雄,2023-12-21,8562
2892,第一金,21,2,19,新光-高雄,2023-12-21,8562
2634,漢翔,21,4,17,新光-高雄,2023-12-21,8562
4938,和碩,22,5,17,新光-高雄,2023-12-21,8562
6290,良維,18,1,17,新光-高雄,2023-12-21,8562
00795B,中信美國公債20年,17,0,17,新光-高雄,2023-12-21,8562
2368,金像電,26,9,17,新光-高雄,2023-12-21,8562
2353,宏��,300,284,16,新光-高雄,2023-12-21,8562
9945,潤泰新,16,0,16,新光-高雄,2023-12-21,8562
2611,志信,17,1,16,新光-高雄,2023-12-21,8562
2506,太設,25,10,15,新光-高雄,2023-12-21,8562
3006,晶豪科,46,31,15,新光-高雄,2023-12-21,8562
8112,至上,27,12,15,新光-高雄,2023-12-21,8562
00680L,元大美債20正2,414,126,288,新光-高雄,2023-12-22,8562
00919,群益台灣精選高息,389,101,288,新光-高雄,2023-12-22,8562
00687B,國泰20年美債,193,6,187,新光-高雄,2023-12-22,8562
00688L,國泰20年美債正2,232,53,179,新光-高雄,2023-12-22,8562
00720B,元大投資級公司債,157,13,144,新光-高雄,2023-12-22,8562
00673R,期元大S＆P原油反1,75,0,75,新光-高雄,2023-12-22,8562
9904,寶成,70,1,69,新光-高雄,2023-12-22,8562
00933B,國泰10Y+金融債,94,33,61,新光-高雄,2023-12-22,8562
00713,元大台灣高息低波,60,1,59,新光-高雄,2023-12-22,8562
00679B,元大美債20年,92,34,58,新光-高雄,2023-12-22,8562
1301,台塑,54,0,54,新光-高雄,2023-12-22,8562
1210,大成,56,2,54,新光-高雄,2023-12-22,8562
2801,彰銀,63,10,53,新光-高雄,2023-12-22,8562
5009,榮剛,117,65,52,新光-高雄,2023-12-22,8562
00712,復華富時不動產,72,21,51,新光-高雄,2023-12-22,8562
9105,泰金寶-DR,109,59,50,新光-高雄,2023-12-22,8562
4306,炎洲,51,3,48,新光-高雄,2023-12-22,8562
00937B,群益ESG投等債20,62,15,47,新光-高雄,2023-12-22,8562
00632R,元大台灣50反1,60,15,45,新光-高雄,2023-12-22,8562
3231,緯創,113,70,43,新光-高雄,2023-12-22,8562
6550,北極星藥業-KY,40,4,36,新光-高雄,2023-12-22,8562
5864,致和證,36,0,36,新光-高雄,2023-12-22,8562
2356,英業達,440,406,34,新光-高雄,2023-12-22,8562
00719B,元大美債1-3,33,0,33,新光-高雄,2023-12-22,8562
2618,長榮航,228,196,32,新光-高雄,2023-12-22,8562
2515,中工,189,157,32,新光-高雄,2023-12-22,8562
8034,榮群,33,1,32,新光-高雄,2023-12-22,8562
2344,華邦電,244,212,32,新光-高雄,2023-12-22,8562
00753L,中信中國50正2,34,4,30,新光-高雄,2023-12-22,8562
00915,凱基優選高股息30,30,0,30,新光-高雄,2023-12-22,8562
00930,永豐ESG低碳高息,30,0,30,新光-高雄,2023-12-22,8562
2890,永豐金,37,7,30,新光-高雄,2023-12-22,8562
2313,華通,63,34,29,新光-高雄,2023-12-22,8562
1109,信大,29,0,29,新光-高雄,2023-12-22,8562
00650L,復華香港正2,153,124,29,新光-高雄,2023-12-22,8562
3346,麗清,190,162,28,新光-高雄,2023-12-22,8562
6163,華電網,28,1,27,新光-高雄,2023-12-22,8562
1522,堤維西,26,0,26,新光-高雄,2023-12-22,8562
4167,松瑞藥,28,3,25,新光-高雄,2023-12-22,8562
4973,廣穎,66,41,25,新光-高雄,2023-12-22,8562
2105,正新,35,10,25,新光-高雄,2023-12-22,8562
00931B,統一美債20年,65,41,24,新光-高雄,2023-12-22,8562
1513,中興電,29,5,24,新光-高雄,2023-12-22,8562
00900,富邦特選高股息30,27,3,24,新光-高雄,2023-12-22,8562
5388,中磊,35,11,24,新光-高雄,2023-12-22,8562
2363,矽統,46,23,23,新光-高雄,2023-12-22,8562
2014,中鴻,49,26,23,新光-高雄,2023-12-22,8562
2883,凱基金,25,3,22,新光-高雄,2023-12-22,8562
2601,益航,43,21,22,新光-高雄,2023-12-22,8562
2405,輔信,31,10,21,新光-高雄,2023-12-22,8562
00919,群益台灣精選高息,542,28,514,新光-高雄,2023-12-25,8562
2609,陽明,438,264,174,新光-高雄,2023-12-25,8562
00664R,國泰臺灣加權反1,159,0,159,新光-高雄,2023-12-25,8562
00669R,國泰美國道瓊反1,116,0,116,新光-高雄,2023-12-25,8562
00706L,期元大S＆P日圓正2,103,0,103,新光-高雄,2023-12-25,8562
00900,富邦特選高股息30,113,17,96,新光-高雄,2023-12-25,8562
00931B,統一美債20年,120,36,84,新光-高雄,2023-12-25,8562
00929,復華台灣科技優息,195,114,81,新光-高雄,2023-12-25,8562
00937B,群益ESG投等債20,123,43,80,新光-高雄,2023-12-25,8562
00687B,國泰20年美債,110,39,71,新光-高雄,2023-12-25,8562
3051,力特,70,3,67,新光-高雄,2023-12-25,8562
00679B,元大美債20年,87,22,65,新光-高雄,2023-12-25,8562
5521,工信,96,36,60,新光-高雄,2023-12-25,8562
00632R,元大台灣50反1,62,4,58,新光-高雄,2023-12-25,8562
8050,廣積,65,10,55,新光-高雄,2023-12-25,8562
3024,憶聲,117,62,55,新光-高雄,2023-12-25,8562
00882,中信中國高股息,58,3,55,新光-高雄,2023-12-25,8562
00688L,國泰20年美債正2,126,72,54,新光-高雄,2023-12-25,8562
00713,元大台灣高息低波,81,27,54,新光-高雄,2023-12-25,8562
00680L,元大美債20正2,97,49,48,新光-高雄,2023-12-25,8562
1531,高林股,47,0,47,新光-高雄,2023-12-25,8562
2421,建準,117,70,47,新光-高雄,2023-12-25,8562
9904,寶成,46,1,45,新光-高雄,2023-12-25,8562
2606,裕民,67,24,43,新光-高雄,2023-12-25,8562
2331,精英,59,19,40,新光-高雄,2023-12-25,8562
1210,大成,41,3,38,新光-高雄,2023-12-25,8562
2603,長榮,298,264,34,新光-高雄,2023-12-25,8562
8088,品安,82,49,33,新光-高雄,2023-12-25,8562
2401,凌陽,31,0,31,新光-高雄,2023-12-25,8562
6117,迎廣,143,113,30,新光-高雄,2023-12-25,8562
00719B,元大美債1-3,30,0,30,新光-高雄,2023-12-25,8562
9105,泰金寶-DR,46,17,29,新光-高雄,2023-12-25,8562
1301,台塑,50,21,29,新光-高雄,2023-12-25,8562
2101,南港,31,2,29,新光-高雄,2023-12-25,8562
00918,大華優利高填息30,29,0,29,新光-高雄,2023-12-25,8562
2634,漢翔,40,13,27,新光-高雄,2023-12-25,8562
2393,億光,27,0,27,新光-高雄,2023-12-25,8562
2323,中環,31,5,26,新光-高雄,2023-12-25,8562
6550,北極星藥業-KY,89,63,26,新光-高雄,2023-12-25,8562
1314,中石化,30,4,26,新光-高雄,2023-12-25,8562
2884,玉山金,33,8,25,新光-高雄,2023-12-25,8562
3706,神達,26,1,25,新光-高雄,2023-12-25,8562
8059,凱碩,24,2,22,新光-高雄,2023-12-25,8562
2369,菱生,23,1,22,新光-高雄,2023-12-25,8562
2382,廣達,48,28,20,新光-高雄,2023-12-25,8562
00907,永豐優息存股,20,0,20,新光-高雄,2023-12-25,8562
2059,川湖,20,0,20,新光-高雄,2023-12-25,8562
3704,合勤控,20,1,19,新光-高雄,2023-12-25,8562
3532,台勝科,24,5,19,新光-高雄,2023-12-25,8562
3380,明泰,20,1,19,新光-高雄,2023-12-25,8562
00632R,元大台灣50反1,1306,32,1274,新光-高雄,2023-12-26,8562
2888,新光金,400,8,392,新光-高雄,2023-12-26,8562
2610,華航,312,57,255,新光-高雄,2023-12-26,8562
00669R,國泰美國道瓊反1,165,5,160,新光-高雄,2023-12-26,8562
2867,三商壽,180,29,151,新光-高雄,2023-12-26,8562
00688L,國泰20年美債正2,131,24,107,新光-高雄,2023-12-26,8562
00712,復華富時不動產,104,2,102,新光-高雄,2023-12-26,8562
2882,國泰金,107,7,100,新光-高雄,2023-12-26,8562
00680L,元大美債20正2,117,25,92,新光-高雄,2023-12-26,8562
2881,富邦金,103,13,90,新光-高雄,2023-12-26,8562
00937B,群益ESG投等債20,148,67,81,新光-高雄,2023-12-26,8562
00751B,元大AAA至A公司債,70,10,60,新光-高雄,2023-12-26,8562
2498,宏達電,70,17,53,新光-高雄,2023-12-26,8562
00637L,元大滬深300正2,63,15,48,新光-高雄,2023-12-26,8562
00687B,國泰20年美債,43,2,41,新光-高雄,2023-12-26,8562
9105,泰金寶-DR,127,86,41,新光-高雄,2023-12-26,8562
2401,凌陽,37,2,35,新光-高雄,2023-12-26,8562
00720B,元大投資級公司債,33,0,33,新光-高雄,2023-12-26,8562
3694,海華,51,20,31,新光-高雄,2023-12-26,8562
2892,第一金,31,1,30,新光-高雄,2023-12-26,8562
2605,新興,45,17,28,新光-高雄,2023-12-26,8562
1582,信錦,34,8,26,新光-高雄,2023-12-26,8562
2809,京城銀,26,0,26,新光-高雄,2023-12-26,8562
3346,麗清,62,37,25,新光-高雄,2023-12-26,8562
6237,驊訊,78,54,24,新光-高雄,2023-12-26,8562
1609,大亞,26,3,23,新光-高雄,2023-12-26,8562
00706L,期元大S＆P日圓正2,54,31,23,新光-高雄,2023-12-26,8562
2476,鉅祥,27,4,23,新光-高雄,2023-12-26,8562
2618,長榮航,39,19,20,新光-高雄,2023-12-26,8562
3710,連展投控,20,0,20,新光-高雄,2023-12-26,8562
2007,燁興,23,4,19,新光-高雄,2023-12-26,8562
2101,南港,18,0,18,新光-高雄,2023-12-26,8562
9904,寶成,18,0,18,新光-高雄,2023-12-26,8562
2312,金寶,19,2,17,新光-高雄,2023-12-26,8562
4306,炎洲,20,4,16,新光-高雄,2023-12-26,8562
3231,緯創,88,72,16,新光-高雄,2023-12-26,8562
00856B,永豐1-3年美公債,15,0,15,新光-高雄,2023-12-26,8562
9945,潤泰新,18,4,14,新光-高雄,2023-12-26,8562
00665L,富邦�琤肭磪囓�2,14,0,14,新光-高雄,2023-12-26,8562
6443,元晶,15,1,14,新光-高雄,2023-12-26,8562
8054,安國,15,2,13,新光-高雄,2023-12-26,8562
2356,英業達,319,306,13,新光-高雄,2023-12-26,8562
00674R,期元大S＆P黃金反1,13,0,13,新光-高雄,2023-12-26,8562
3588,通嘉,20,7,13,新光-高雄,2023-12-26,8562
3019,亞光,19,6,13,新光-高雄,2023-12-26,8562
00710B,復華彭博非投等債,12,0,12,新光-高雄,2023-12-26,8562
2903,遠百,14,2,12,新光-高雄,2023-12-26,8562
5351,鈺創,51,39,12,新光-高雄,2023-12-26,8562
1513,中興電,14,2,12,新光-高雄,2023-12-26,8562
1519,華城,29,18,11,新光-高雄,2023-12-26,8562
00937B,群益ESG投等債20,546,17,529,新光-高雄,2023-12-27,8562
00632R,元大台灣50反1,376,105,271,新光-高雄,2023-12-27,8562
00929,復華台灣科技優息,329,128,201,新光-高雄,2023-12-27,8562
00688L,國泰20年美債正2,185,30,155,新光-高雄,2023-12-27,8562
9105,泰金寶-DR,323,170,153,新光-高雄,2023-12-27,8562
00882,中信中國高股息,126,0,126,新光-高雄,2023-12-27,8562
2883,凱基金,145,21,124,新光-高雄,2023-12-27,8562
6770,力積電,131,11,120,新光-高雄,2023-12-27,8562
2353,宏��,424,310,114,新光-高雄,2023-12-27,8562
00712,復華富時不動產,123,38,85,新光-高雄,2023-12-27,8562
2888,新光金,189,105,84,新光-高雄,2023-12-27,8562
2610,華航,110,26,84,新光-高雄,2023-12-27,8562
00687B,國泰20年美債,85,9,76,新光-高雄,2023-12-27,8562
00931B,統一美債20年,135,72,63,新光-高雄,2023-12-27,8562
5478,智冠,63,0,63,新光-高雄,2023-12-27,8562
2324,仁寶,477,417,60,新光-高雄,2023-12-27,8562
3481,群創,189,133,56,新光-高雄,2023-12-27,8562
5410,國眾,57,4,53,新光-高雄,2023-12-27,8562
6147,頎邦,53,1,52,新光-高雄,2023-12-27,8562
4513,福裕,50,0,50,新光-高雄,2023-12-27,8562
2892,第一金,50,3,47,新光-高雄,2023-12-27,8562
00673R,期元大S＆P原油反1,45,0,45,新光-高雄,2023-12-27,8562
00713,元大台灣高息低波,46,3,43,新光-高雄,2023-12-27,8562
2388,威盛,66,30,36,新光-高雄,2023-12-27,8562
1806,冠軍,37,4,33,新光-高雄,2023-12-27,8562
8936,國統,81,49,32,新光-高雄,2023-12-27,8562
1210,大成,31,0,31,新光-高雄,2023-12-27,8562
3305,昇貿,69,38,31,新光-高雄,2023-12-27,8562
8059,凱碩,60,30,30,新光-高雄,2023-12-27,8562
9904,寶成,30,0,30,新光-高雄,2023-12-27,8562
2603,長榮,136,108,28,新光-高雄,2023-12-27,8562
2329,華泰,31,3,28,新光-高雄,2023-12-27,8562
2641,正德,33,5,28,新光-高雄,2023-12-27,8562
1560,中砂,39,11,28,新光-高雄,2023-12-27,8562
2812,台中銀,43,16,27,新光-高雄,2023-12-27,8562
3438,類比科,31,5,26,新光-高雄,2023-12-27,8562
6462,神盾,60,35,25,新光-高雄,2023-12-27,8562
1313,聯成,24,0,24,新光-高雄,2023-12-27,8562
00680L,元大美債20正2,27,3,24,新光-高雄,2023-12-27,8562
3380,明泰,25,2,23,新光-高雄,2023-12-27,8562
3702,大聯大,28,5,23,新光-高雄,2023-12-27,8562
00915,凱基優選高股息30,22,0,22,新光-高雄,2023-12-27,8562
00720B,元大投資級公司債,22,0,22,新光-高雄,2023-12-27,8562
1312,國喬,22,1,21,新光-高雄,2023-12-27,8562
2903,遠百,23,2,21,新光-高雄,2023-12-27,8562
3504,揚明光,35,15,20,新光-高雄,2023-12-27,8562
1460,宏遠,20,0,20,新光-高雄,2023-12-27,8562
2006,東和鋼鐵,24,5,19,新光-高雄,2023-12-27,8562
00936,台新永續高息中小,24,5,19,新光-高雄,2023-12-27,8562
6237,驊訊,34,16,18,新光-高雄,2023-12-27,8562
00929,復華台灣科技優息,2446,250,2196,新光-高雄,2023-12-28,8562
00919,群益台灣精選高息,745,210,535,新光-高雄,2023-12-28,8562
00937B,群益ESG投等債20,535,32,503,新光-高雄,2023-12-28,8562
00900,富邦特選高股息30,252,5,247,新光-高雄,2023-12-28,8562
00931B,統一美債20年,265,66,199,新光-高雄,2023-12-28,8562
00680L,元大美債20正2,407,224,183,新光-高雄,2023-12-28,8562
9105,泰金寶-DR,172,11,161,新光-高雄,2023-12-28,8562
2888,新光金,166,5,161,新光-高雄,2023-12-28,8562
2303,聯電,296,164,132,新光-高雄,2023-12-28,8562
2889,國票金,152,20,132,新光-高雄,2023-12-28,8562
5355,佳總,95,0,95,新光-高雄,2023-12-28,8562
00713,元大台灣高息低波,70,5,65,新光-高雄,2023-12-28,8562
00934,中信成長高股息,78,16,62,新光-高雄,2023-12-28,8562
2603,長榮,108,46,62,新光-高雄,2023-12-28,8562
3706,神達,323,273,50,新光-高雄,2023-12-28,8562
1582,信錦,92,44,48,新光-高雄,2023-12-28,8562
00885,富邦越南,47,0,47,新光-高雄,2023-12-28,8562
3483,力致,72,26,46,新光-高雄,2023-12-28,8562
3702,大聯大,52,6,46,新光-高雄,2023-12-28,8562
9921,巨大,61,16,45,新光-高雄,2023-12-28,8562
5351,鈺創,133,88,45,新光-高雄,2023-12-28,8562
6179,亞通,79,35,44,新光-高雄,2023-12-28,8562
5864,致和證,41,0,41,新光-高雄,2023-12-28,8562
6538,倉和,41,1,40,新光-高雄,2023-12-28,8562
2464,盟立,40,0,40,新光-高雄,2023-12-28,8562
3231,緯創,84,48,36,新光-高雄,2023-12-28,8562
8936,國統,66,31,35,新光-高雄,2023-12-28,8562
2421,建準,46,17,29,新光-高雄,2023-12-28,8562
2851,中再保,30,1,29,新光-高雄,2023-12-28,8562
6416,瑞祺電通,28,0,28,新光-高雄,2023-12-28,8562
2324,仁寶,339,311,28,新光-高雄,2023-12-28,8562
2641,正德,26,0,26,新光-高雄,2023-12-28,8562
00632R,元大台灣50反1,44,20,24,新光-高雄,2023-12-28,8562
1514,亞力,129,105,24,新光-高雄,2023-12-28,8562
1529,樂事綠能,23,0,23,新光-高雄,2023-12-28,8562
2465,麗臺,27,4,23,新光-高雄,2023-12-28,8562
00712,復華富時不動產,50,27,23,新光-高雄,2023-12-28,8562
2363,矽統,56,34,22,新光-高雄,2023-12-28,8562
00933B,國泰10Y+金融債,35,13,22,新光-高雄,2023-12-28,8562
00856B,永豐1-3年美公債,22,0,22,新光-高雄,2023-12-28,8562
1618,合機,49,28,21,新光-高雄,2023-12-28,8562
1605,華新,34,13,21,新光-高雄,2023-12-28,8562
00936,台新永續高息中小,21,0,21,新光-高雄,2023-12-28,8562
8048,德勝,21,1,20,新光-高雄,2023-12-28,8562
1560,中砂,23,3,20,新光-高雄,2023-12-28,8562
1513,中興電,51,32,19,新光-高雄,2023-12-28,8562
2606,裕民,21,2,19,新光-高雄,2023-12-28,8562
2301,光寶科,31,13,18,新光-高雄,2023-12-28,8562
00753L,中信中國50正2,34,16,18,新光-高雄,2023-12-28,8562
1313,聯成,30,12,18,新光-高雄,2023-12-28,8562
00937B,群益ESG投等債20,444,17,427,新光-高雄,2023-12-29,8562
00931B,統一美債20年,228,0,228,新光-高雄,2023-12-29,8562
00712,復華富時不動產,246,28,218,新光-高雄,2023-12-29,8562
00715L,期街口布蘭特正2,307,139,168,新光-高雄,2023-12-29,8562
00680L,元大美債20正2,137,11,126,新光-高雄,2023-12-29,8562
2881,富邦金,124,4,120,新光-高雄,2023-12-29,8562
00933B,國泰10Y+金融債,135,20,115,新光-高雄,2023-12-29,8562
1609,大亞,211,115,96,新光-高雄,2023-12-29,8562
00688L,國泰20年美債正2,103,10,93,新光-高雄,2023-12-29,8562
00687B,國泰20年美債,101,15,86,新光-高雄,2023-12-29,8562
00751B,元大AAA至A公司債,137,52,85,新光-高雄,2023-12-29,8562
3706,神達,140,69,71,新光-高雄,2023-12-29,8562
2888,新光金,60,0,60,新光-高雄,2023-12-29,8562
00669R,國泰美國道瓊反1,60,0,60,新光-高雄,2023-12-29,8562
8163,達方,70,10,60,新光-高雄,2023-12-29,8562
2303,聯電,115,57,58,新光-高雄,2023-12-29,8562
00720B,元大投資級公司債,62,7,55,新光-高雄,2023-12-29,8562
3450,聯鈞,71,17,54,新光-高雄,2023-12-29,8562
4402,郡都開發,54,0,54,新光-高雄,2023-12-29,8562
2618,長榮航,74,20,54,新光-高雄,2023-12-29,8562
3231,緯創,285,233,52,新光-高雄,2023-12-29,8562
00929,復華台灣科技優息,115,65,50,新光-高雄,2023-12-29,8562
00632R,元大台灣50反1,51,1,50,新光-高雄,2023-12-29,8562
2101,南港,53,6,47,新光-高雄,2023-12-29,8562
00706L,期元大S＆P日圓正2,86,40,46,新光-高雄,2023-12-29,8562
5864,致和證,46,0,46,新光-高雄,2023-12-29,8562
00679B,元大美債20年,49,9,40,新光-高雄,2023-12-29,8562
00650L,復華香港正2,37,0,37,新光-高雄,2023-12-29,8562
00891,中信關鍵半導體,40,4,36,新光-高雄,2023-12-29,8562
1718,中纖,36,0,36,新光-高雄,2023-12-29,8562
3006,晶豪科,98,66,32,新光-高雄,2023-12-29,8562
2880,華南金,33,0,33,新光-高雄,2023-12-29,8562
1437,勤益控,32,1,31,新光-高雄,2023-12-29,8562
2353,宏��,481,451,30,新光-高雄,2023-12-29,8562
1608,華榮,30,0,30,新光-高雄,2023-12-29,8562
2352,佳世達,284,257,27,新光-高雄,2023-12-29,8562
1503,士電,94,68,26,新光-高雄,2023-12-29,8562
3708,上緯投控,28,2,26,新光-高雄,2023-12-29,8562
5478,智冠,28,4,24,新光-高雄,2023-12-29,8562
3702,大聯大,29,6,23,新光-高雄,2023-12-29,8562
1313,聯成,23,0,23,新光-高雄,2023-12-29,8562
1605,華新,27,5,22,新光-高雄,2023-12-29,8562
1301,台塑,22,0,22,新光-高雄,2023-12-29,8562
5351,鈺創,38,16,22,新光-高雄,2023-12-29,8562
6148,驊宏資,21,0,21,新光-高雄,2023-12-29,8562
9904,寶成,26,5,21,新光-高雄,2023-12-29,8562
3380,明泰,21,0,21,新光-高雄,2023-12-29,8562
4306,炎洲,21,1,20,新光-高雄,2023-12-29,8562
3296,勝德,23,3,20,新光-高雄,2023-12-29,8562
2889,國票金,23,4,19,新光-高雄,2023-12-29,8562
00919,群益台灣精選高息,644,103,541,新光-高雄,2024-01-02,8562
00680L,元大美債20正2,661,232,429,新光-高雄,2024-01-02,8562
00929,復華台灣科技優息,444,30,414,新光-高雄,2024-01-02,8562
00688L,國泰20年美債正2,384,10,374,新光-高雄,2024-01-02,8562
00878,國泰永續高股息,387,103,284,新光-高雄,2024-01-02,8562
00937B,群益ESG投等債20,314,42,272,新光-高雄,2024-01-02,8562
00671R,富邦NASDAQ反1,264,0,264,新光-高雄,2024-01-02,8562
00669R,國泰美國道瓊反1,245,0,245,新光-高雄,2024-01-02,8562
00637L,元大滬深300正2,287,58,229,新光-高雄,2024-01-02,8562
0056,元大高股息,231,32,199,新光-高雄,2024-01-02,8562
00934,中信成長高股息,144,1,143,新光-高雄,2024-01-02,8562
00712,復華富時不動產,304,169,135,新光-高雄,2024-01-02,8562
00687B,國泰20年美債,173,39,134,新光-高雄,2024-01-02,8562
2609,陽明,495,419,76,新光-高雄,2024-01-02,8562
00933B,國泰10Y+金融債,73,1,72,新光-高雄,2024-01-02,8562
3231,緯創,181,115,66,新光-高雄,2024-01-02,8562
2867,三商壽,67,8,59,新光-高雄,2024-01-02,8562
2352,佳世達,68,19,49,新光-高雄,2024-01-02,8562
4931,新盛力,44,0,44,新光-高雄,2024-01-02,8562
00882,中信中國高股息,77,35,42,新光-高雄,2024-01-02,8562
00931B,統一美債20年,74,33,41,新光-高雄,2024-01-02,8562
2883,凱基金,63,22,41,新光-高雄,2024-01-02,8562
2509,全坤建,35,0,35,新光-高雄,2024-01-02,8562
00720B,元大投資級公司債,69,35,34,新光-高雄,2024-01-02,8562
2892,第一金,31,2,29,新光-高雄,2024-01-02,8562
2603,長榮,147,118,29,新光-高雄,2024-01-02,8562
00665L,富邦�琤肭磪囓�2,52,23,29,新光-高雄,2024-01-02,8562
3006,晶豪科,64,35,29,新光-高雄,2024-01-02,8562
00636,國泰中國A50,29,0,29,新光-高雄,2024-01-02,8562
2382,廣達,58,31,27,新光-高雄,2024-01-02,8562
3059,華晶科,27,1,26,新光-高雄,2024-01-02,8562
6005,群益證,41,16,25,新光-高雄,2024-01-02,8562
00633L,富邦上証正2,38,16,22,新光-高雄,2024-01-02,8562
2605,新興,31,9,22,新光-高雄,2024-01-02,8562
2020,美亞,72,50,22,新光-高雄,2024-01-02,8562
2303,聯電,56,35,21,新光-高雄,2024-01-02,8562
4960,誠美材,21,0,21,新光-高雄,2024-01-02,8562
00713,元大台灣高息低波,21,1,20,新光-高雄,2024-01-02,8562
3390,旭軟,97,77,20,新光-高雄,2024-01-02,8562
3380,明泰,21,1,20,新光-高雄,2024-01-02,8562
6589,台康生技,21,1,20,新光-高雄,2024-01-02,8562
00675L,富邦臺灣加權正2,18,0,18,新光-高雄,2024-01-02,8562
2365,昆盈,28,10,18,新光-高雄,2024-01-02,8562
1795,美時,41,24,17,新光-高雄,2024-01-02,8562
6668,中揚光,30,13,17,新光-高雄,2024-01-02,8562
3706,神達,109,93,16,新光-高雄,2024-01-02,8562
00772B,中信高評級公司債,15,0,15,新光-高雄,2024-01-02,8562
6770,力積電,20,5,15,新光-高雄,2024-01-02,8562
1301,台塑,20,5,15,新光-高雄,2024-01-02,8562
5351,鈺創,20,5,15,新光-高雄,2024-01-02,8562
00929,復華台灣科技優息,795,290,505,新光-高雄,2024-01-03,8562
00919,群益台灣精選高息,481,87,394,新光-高雄,2024-01-03,8562
00688L,國泰20年美債正2,309,35,274,新光-高雄,2024-01-03,8562
00715L,期街口布蘭特正2,387,129,258,新光-高雄,2024-01-03,8562
0056,元大高股息,356,109,247,新光-高雄,2024-01-03,8562
00937B,群益ESG投等債20,342,124,218,新光-高雄,2024-01-03,8562
2610,華航,276,104,172,新光-高雄,2024-01-03,8562
5521,工信,290,165,125,新光-高雄,2024-01-03,8562
00680L,元大美債20正2,213,112,101,新光-高雄,2024-01-03,8562
00888,永豐台灣ESG,94,5,89,新光-高雄,2024-01-03,8562
3481,群創,124,41,83,新光-高雄,2024-01-03,8562
00669R,國泰美國道瓊反1,82,0,82,新光-高雄,2024-01-03,8562
2027,大成鋼,86,7,79,新光-高雄,2024-01-03,8562
1301,台塑,74,0,74,新光-高雄,2024-01-03,8562
00934,中信成長高股息,67,7,60,新光-高雄,2024-01-03,8562
00637L,元大滬深300正2,102,43,59,新光-高雄,2024-01-03,8562
2002,中鋼,90,32,58,新光-高雄,2024-01-03,8562
3711,日月光投控,84,35,49,新光-高雄,2024-01-03,8562
5425,台半,53,4,49,新光-高雄,2024-01-03,8562
3325,旭品,121,72,49,新光-高雄,2024-01-03,8562
2303,聯電,68,20,48,新光-高雄,2024-01-03,8562
00922,國泰台灣領袖50,47,0,47,新光-高雄,2024-01-03,8562
4402,郡都開發,46,0,46,新光-高雄,2024-01-03,8562
9921,巨大,48,5,43,新光-高雄,2024-01-03,8562
00751B,元大AAA至A公司債,53,12,41,新光-高雄,2024-01-03,8562
00918,大華優利高填息30,41,1,40,新光-高雄,2024-01-03,8562
3051,力特,41,1,40,新光-高雄,2024-01-03,8562
00671R,富邦NASDAQ反1,49,10,39,新光-高雄,2024-01-03,8562
00930,永豐ESG低碳高息,35,0,35,新光-高雄,2024-01-03,8562
2365,昆盈,50,15,35,新光-高雄,2024-01-03,8562
00712,復華富時不動產,63,28,35,新光-高雄,2024-01-03,8562
00935,野村臺灣新科技50,33,0,33,新光-高雄,2024-01-03,8562
3081,聯亞,33,0,33,新光-高雄,2024-01-03,8562
2845,遠東銀,33,0,33,新光-高雄,2024-01-03,8562
2409,友達,34,2,32,新光-高雄,2024-01-03,8562
00933B,國泰10Y+金融債,45,13,32,新光-高雄,2024-01-03,8562
3006,晶豪科,44,13,31,新光-高雄,2024-01-03,8562
00713,元大台灣高息低波,44,13,31,新光-高雄,2024-01-03,8562
5880,合庫金,33,3,30,新光-高雄,2024-01-03,8562
00725B,國泰投資級公司債,33,3,30,新光-高雄,2024-01-03,8562
6695,芯鼎,139,110,29,新光-高雄,2024-01-03,8562
0050,元大台灣50,32,4,28,新光-高雄,2024-01-03,8562
00857B,永豐20年美公債,99,73,26,新光-高雄,2024-01-03,8562
2498,宏達電,35,10,25,新光-高雄,2024-01-03,8562
2883,凱基金,65,40,25,新光-高雄,2024-01-03,8562
00631L,元大台灣50正2,27,2,25,新光-高雄,2024-01-03,8562
6770,力積電,27,3,24,新光-高雄,2024-01-03,8562
2887,台新金,26,1,25,新光-高雄,2024-01-03,8562
3062,建漢,24,0,24,新光-高雄,2024-01-03,8562
4931,新盛力,24,0,24,新光-高雄,2024-01-03,8562
00929,復華台灣科技優息,1124,12,1112,新光-高雄,2024-01-04,8562
00878,國泰永續高股息,935,83,852,新光-高雄,2024-01-04,8562
00706L,期元大S＆P日圓正2,295,32,263,新光-高雄,2024-01-04,8562
00680L,元大美債20正2,272,15,257,新光-高雄,2024-01-04,8562
00937B,群益ESG投等債20,259,5,254,新光-高雄,2024-01-04,8562
00919,群益台灣精選高息,234,22,212,新光-高雄,2024-01-04,8562
2344,華邦電,274,89,185,新光-高雄,2024-01-04,8562
0056,元大高股息,189,33,156,新光-高雄,2024-01-04,8562
2303,聯電,170,18,152,新光-高雄,2024-01-04,8562
2618,長榮航,195,78,117,新光-高雄,2024-01-04,8562
00927,群益半導體收益,116,0,116,新光-高雄,2024-01-04,8562
2867,三商壽,105,0,105,新光-高雄,2024-01-04,8562
6163,華電網,95,1,94,新光-高雄,2024-01-04,8562
00712,復華富時不動產,205,117,88,新光-高雄,2024-01-04,8562
00637L,元大滬深300正2,140,55,85,新光-高雄,2024-01-04,8562
9919,康那香,210,138,72,新光-高雄,2024-01-04,8562
6770,力積電,72,2,70,新光-高雄,2024-01-04,8562
2905,三商,65,8,57,新光-高雄,2024-01-04,8562
2027,大成鋼,76,24,52,新光-高雄,2024-01-04,8562
00632R,元大台灣50反1,126,74,52,新光-高雄,2024-01-04,8562
00673R,期元大S＆P原油反1,66,16,50,新光-高雄,2024-01-04,8562
3481,群創,77,29,48,新光-高雄,2024-01-04,8562
2101,南港,52,4,48,新光-高雄,2024-01-04,8562
5521,工信,312,266,46,新光-高雄,2024-01-04,8562
2883,凱基金,42,2,40,新光-高雄,2024-01-04,8562
3062,建漢,39,0,39,新光-高雄,2024-01-04,8562
9946,三發地產,39,0,39,新光-高雄,2024-01-04,8562
5525,順天,38,0,38,新光-高雄,2024-01-04,8562
2356,英業達,93,56,37,新光-高雄,2024-01-04,8562
2888,新光金,42,5,37,新光-高雄,2024-01-04,8562
00902,中信電池及儲能,36,0,36,新光-高雄,2024-01-04,8562
00696B,富邦美債20年,40,5,35,新光-高雄,2024-01-04,8562
3373,熱映,79,44,35,新光-高雄,2024-01-04,8562
2641,正德,112,79,33,新光-高雄,2024-01-04,8562
00933B,國泰10Y+金融債,58,28,30,新光-高雄,2024-01-04,8562
2363,矽統,41,11,30,新光-高雄,2024-01-04,8562
9904,寶成,33,4,29,新光-高雄,2024-01-04,8562
00713,元大台灣高息低波,27,0,27,新光-高雄,2024-01-04,8562
2812,台中銀,43,16,27,新光-高雄,2024-01-04,8562
00665L,富邦�琤肭磪囓�2,26,0,26,新光-高雄,2024-01-04,8562
9921,巨大,42,17,25,新光-高雄,2024-01-04,8562
2486,一詮,76,52,24,新光-高雄,2024-01-04,8562
5864,致和證,34,10,24,新光-高雄,2024-01-04,8562
3296,勝德,36,13,23,新光-高雄,2024-01-04,8562
1455,集盛,22,0,22,新光-高雄,2024-01-04,8562
2801,彰銀,22,0,22,新光-高雄,2024-01-04,8562
1584,精剛,22,0,22,新光-高雄,2024-01-04,8562
8936,國統,63,42,21,新光-高雄,2024-01-04,8562
2601,益航,53,32,21,新光-高雄,2024-01-04,8562
00725B,國泰投資級公司債,21,0,21,新光-高雄,2024-01-04,8562
00929,復華台灣科技優息,891,25,866,新光-高雄,2024-01-05,8562
00680L,元大美債20正2,545,295,250,新光-高雄,2024-01-05,8562
00687B,國泰20年美債,267,28,239,新光-高雄,2024-01-05,8562
00937B,群益ESG投等債20,214,0,214,新光-高雄,2024-01-05,8562
00878,國泰永續高股息,226,67,159,新光-高雄,2024-01-05,8562
0056,元大高股息,170,25,145,新光-高雄,2024-01-05,8562
00919,群益台灣精選高息,198,57,141,新光-高雄,2024-01-05,8562
00712,復華富時不動產,143,6,137,新光-高雄,2024-01-05,8562
00679B,元大美債20年,146,38,108,新光-高雄,2024-01-05,8562
00669R,國泰美國道瓊反1,85,0,85,新光-高雄,2024-01-05,8562
00751B,元大AAA至A公司債,84,0,84,新光-高雄,2024-01-05,8562
2344,華邦電,87,14,73,新光-高雄,2024-01-05,8562
2356,英業達,117,47,70,新光-高雄,2024-01-05,8562
00933B,國泰10Y+金融債,67,4,63,新光-高雄,2024-01-05,8562
2610,華航,88,28,60,新光-高雄,2024-01-05,8562
6163,華電網,56,0,56,新光-高雄,2024-01-05,8562
2542,興富發,56,1,55,新光-高雄,2024-01-05,8562
2353,宏��,198,144,54,新光-高雄,2024-01-05,8562
9105,泰金寶-DR,85,35,50,新光-高雄,2024-01-05,8562
00706L,期元大S＆P日圓正2,70,30,40,新光-高雄,2024-01-05,8562
9946,三發地產,39,0,39,新光-高雄,2024-01-05,8562
00772B,中信高評級公司債,38,1,37,新光-高雄,2024-01-05,8562
2607,榮運,108,79,29,新光-高雄,2024-01-05,8562
00915,凱基優選高股息30,29,0,29,新光-高雄,2024-01-05,8562
8112,至上,31,3,28,新光-高雄,2024-01-05,8562
8011,台通,77,49,28,新光-高雄,2024-01-05,8562
1584,精剛,29,2,27,新光-高雄,2024-01-05,8562
6282,康舒,27,0,27,新光-高雄,2024-01-05,8562
1504,東元,34,8,26,新光-高雄,2024-01-05,8562
00795B,中信美國公債20年,26,0,26,新光-高雄,2024-01-05,8562
00673R,期元大S＆P原油反1,26,0,26,新光-高雄,2024-01-05,8562
00881,國泰台灣5G+,29,4,25,新光-高雄,2024-01-05,8562
00713,元大台灣高息低波,26,1,25,新光-高雄,2024-01-05,8562
00655L,國泰中國A50正2,25,1,24,新光-高雄,2024-01-05,8562
1732,毛寶,152,128,24,新光-高雄,2024-01-05,8562
3231,緯創,67,44,23,新光-高雄,2024-01-05,8562
00934,中信成長高股息,22,0,22,新光-高雄,2024-01-05,8562
1444,力麗,20,0,20,新光-高雄,2024-01-05,8562
4303,信立,20,0,20,新光-高雄,2024-01-05,8562
6805,富世達,21,1,20,新光-高雄,2024-01-05,8562
00858,永豐美國500大,20,0,20,新光-高雄,2024-01-05,8562
2486,一詮,66,47,19,新光-高雄,2024-01-05,8562
2358,廷鑫,20,1,19,新光-高雄,2024-01-05,8562
4930,燦星網,20,1,19,新光-高雄,2024-01-05,8562
5533,皇鼎,28,9,19,新光-高雄,2024-01-05,8562
5525,順天,18,0,18,新光-高雄,2024-01-05,8562
00757,統一FANG+,17,0,17,新光-高雄,2024-01-05,8562
8033,雷虎,17,0,17,新光-高雄,2024-01-05,8562
2897,王道銀行,20,3,17,新光-高雄,2024-01-05,8562
8096,擎亞,172,156,16,新光-高雄,2024-01-05,8562
00929,復華台灣科技優息,669,55,614,新光-高雄,2024-01-08,8562
3481,群創,860,357,503,新光-高雄,2024-01-08,8562
00637L,元大滬深300正2,316,42,274,新光-高雄,2024-01-08,8562
00687B,國泰20年美債,234,6,228,新光-高雄,2024-01-08,8562
00937B,群益ESG投等債20,297,103,194,新光-高雄,2024-01-08,8562
00632R,元大台灣50反1,190,5,185,新光-高雄,2024-01-08,8562
00753L,中信中國50正2,193,21,172,新光-高雄,2024-01-08,8562
1605,華新,108,6,102,新光-高雄,2024-01-08,8562
5516,雙喜,94,0,94,新光-高雄,2024-01-08,8562
9904,寶成,108,18,90,新光-高雄,2024-01-08,8562
00931B,統一美債20年,88,7,81,新光-高雄,2024-01-08,8562
6770,力積電,388,312,76,新光-高雄,2024-01-08,8562
4402,郡都開發,64,0,64,新光-高雄,2024-01-08,8562
2344,華邦電,67,6,61,新光-高雄,2024-01-08,8562
2317,鴻海,104,47,57,新光-高雄,2024-01-08,8562
00927,群益半導體收益,54,2,52,新光-高雄,2024-01-08,8562
00933B,國泰10Y+金融債,67,15,52,新光-高雄,2024-01-08,8562
8936,國統,59,10,49,新光-高雄,2024-01-08,8562
00888,永豐台灣ESG,50,1,49,新光-高雄,2024-01-08,8562
00725B,國泰投資級公司債,53,8,45,新光-高雄,2024-01-08,8562
00751B,元大AAA至A公司債,49,10,39,新光-高雄,2024-01-08,8562
00720B,元大投資級公司債,70,32,38,新光-高雄,2024-01-08,8562
5871,中租-KY,47,10,37,新光-高雄,2024-01-08,8562
00715L,期街口布蘭特正2,144,110,34,新光-高雄,2024-01-08,8562
5381,合正,33,0,33,新光-高雄,2024-01-08,8562
2615,萬海,62,30,32,新光-高雄,2024-01-08,8562
2486,一詮,77,46,31,新光-高雄,2024-01-08,8562
2609,陽明,339,313,26,新光-高雄,2024-01-08,8562
2353,宏��,338,313,25,新光-高雄,2024-01-08,8562
6163,華電網,30,5,25,新光-高雄,2024-01-08,8562
1416,廣豐,25,0,25,新光-高雄,2024-01-08,8562
00665L,富邦�琤肭磪囓�2,94,70,24,新光-高雄,2024-01-08,8562
4979,華星光,51,27,24,新光-高雄,2024-01-08,8562
3031,佰鴻,24,0,24,新光-高雄,2024-01-08,8562
5475,德宏,23,0,23,新光-高雄,2024-01-08,8562
00904,新光臺灣半導體30,22,0,22,新光-高雄,2024-01-08,8562
8096,擎亞,94,73,21,新光-高雄,2024-01-08,8562
3231,緯創,99,79,20,新光-高雄,2024-01-08,8562
2543,皇昌,25,5,20,新光-高雄,2024-01-08,8562
1434,福懋,20,0,20,新光-高雄,2024-01-08,8562
00669R,國泰美國道瓊反1,20,0,20,新光-高雄,2024-01-08,8562
9928,中視,20,0,20,新光-高雄,2024-01-08,8562
1721,三晃,34,15,19,新光-高雄,2024-01-08,8562
00722B,群益投資級電信債,21,2,19,新光-高雄,2024-01-08,8562
6462,神盾,62,43,19,新光-高雄,2024-01-08,8562
6168,宏齊,26,7,19,新光-高雄,2024-01-08,8562
3078,僑威,22,4,18,新光-高雄,2024-01-08,8562
3025,星通,30,12,18,新光-高雄,2024-01-08,8562
00712,復華富時不動產,79,62,17,新光-高雄,2024-01-08,8562
3390,旭軟,33,16,17,新光-高雄,2024-01-08,8562
00919,群益台灣精選高息,572,170,402,新光-高雄,2024-01-09,8562
00882,中信中國高股息,329,0,329,新光-高雄,2024-01-09,8562
00929,復華台灣科技優息,234,27,207,新光-高雄,2024-01-09,8562
2609,陽明,374,251,123,新光-高雄,2024-01-09,8562
2460,建通,115,1,114,新光-高雄,2024-01-09,8562
2603,長榮,184,79,105,新光-高雄,2024-01-09,8562
00688L,國泰20年美債正2,124,29,95,新光-高雄,2024-01-09,8562
00937B,群益ESG投等債20,87,0,87,新光-高雄,2024-01-09,8562
00687B,國泰20年美債,94,30,64,新光-高雄,2024-01-09,8562
1532,勤美,63,0,63,新光-高雄,2024-01-09,8562
2892,第一金,63,0,63,新光-高雄,2024-01-09,8562
00931B,統一美債20年,61,1,60,新光-高雄,2024-01-09,8562
00671R,富邦NASDAQ反1,91,35,56,新光-高雄,2024-01-09,8562
00713,元大台灣高息低波,56,1,55,新光-高雄,2024-01-09,8562
5475,德宏,54,0,54,新光-高雄,2024-01-09,8562
1609,大亞,52,0,52,新光-高雄,2024-01-09,8562
2027,大成鋼,51,4,47,新光-高雄,2024-01-09,8562
00720B,元大投資級公司債,56,10,46,新光-高雄,2024-01-09,8562
2884,玉山金,47,2,45,新光-高雄,2024-01-09,8562
00770,國泰北美科技,51,6,45,新光-高雄,2024-01-09,8562
2421,建準,69,25,44,新光-高雄,2024-01-09,8562
00632R,元大台灣50反1,83,40,43,新光-高雄,2024-01-09,8562
4402,郡都開發,39,0,39,新光-高雄,2024-01-09,8562
3346,麗清,54,16,38,新光-高雄,2024-01-09,8562
5871,中租-KY,38,0,38,新光-高雄,2024-01-09,8562
2641,正德,46,8,38,新光-高雄,2024-01-09,8562
6120,達運,113,76,37,新光-高雄,2024-01-09,8562
2324,仁寶,211,174,37,新光-高雄,2024-01-09,8562
2634,漢翔,42,6,36,新光-高雄,2024-01-09,8562
8111,立��,111,77,34,新光-高雄,2024-01-09,8562
1314,中石化,35,1,34,新光-高雄,2024-01-09,8562
00918,大華優利高填息30,36,3,33,新光-高雄,2024-01-09,8562
6191,精成科,32,0,32,新光-高雄,2024-01-09,8562
6684,安格,35,3,32,新光-高雄,2024-01-09,8562
00637L,元大滬深300正2,58,27,31,新光-高雄,2024-01-09,8562
6113,亞矽,28,1,27,新光-高雄,2024-01-09,8562
2317,鴻海,67,41,26,新光-高雄,2024-01-09,8562
2399,映泰,25,0,25,新光-高雄,2024-01-09,8562
2485,兆赫,25,0,25,新光-高雄,2024-01-09,8562
00751B,元大AAA至A公司債,25,0,25,新光-高雄,2024-01-09,8562
2329,華泰,53,29,24,新光-高雄,2024-01-09,8562
5309,系統電,58,34,24,新光-高雄,2024-01-09,8562
2615,萬海,40,16,24,新光-高雄,2024-01-09,8562
00679B,元大美債20年,38,14,24,新光-高雄,2024-01-09,8562
1301,台塑,28,5,23,新光-高雄,2024-01-09,8562
2014,中鴻,29,6,23,新光-高雄,2024-01-09,8562
2353,宏��,462,439,23,新光-高雄,2024-01-09,8562
6126,信音,22,0,22,新光-高雄,2024-01-09,8562
00642U,期元大S＆P石油,22,0,22,新光-高雄,2024-01-09,8562
00907,永豐優息存股,21,0,21,新光-高雄,2024-01-09,8562
00878,國泰永續高股息,1061,47,1014,新光-高雄,2024-01-10,8562
9105,泰金寶-DR,180,15,165,新光-高雄,2024-01-10,8562
2371,大同,326,188,138,新光-高雄,2024-01-10,8562
00671R,富邦NASDAQ反1,124,0,124,新光-高雄,2024-01-10,8562
00680L,元大美債20正2,124,9,115,新光-高雄,2024-01-10,8562
00688L,國泰20年美債正2,114,0,114,新光-高雄,2024-01-10,8562
00937B,群益ESG投等債20,167,64,103,新光-高雄,2024-01-10,8562
2356,英業達,160,69,91,新光-高雄,2024-01-10,8562
2609,陽明,289,211,78,新光-高雄,2024-01-10,8562
2344,華邦電,90,21,69,新光-高雄,2024-01-10,8562
2888,新光金,61,0,61,新光-高雄,2024-01-10,8562
2515,中工,58,1,57,新光-高雄,2024-01-10,8562
00673R,期元大S＆P原油反1,57,0,57,新光-高雄,2024-01-10,8562
2317,鴻海,91,35,56,新光-高雄,2024-01-10,8562
00751B,元大AAA至A公司債,67,16,51,新光-高雄,2024-01-10,8562
4402,郡都開發,45,0,45,新光-高雄,2024-01-10,8562
2610,華航,45,1,44,新光-高雄,2024-01-10,8562
1560,中砂,43,1,42,新光-高雄,2024-01-10,8562
2905,三商,42,0,42,新光-高雄,2024-01-10,8562
2324,仁寶,82,41,41,新光-高雄,2024-01-10,8562
2607,榮運,51,10,41,新光-高雄,2024-01-10,8562
00933B,國泰10Y+金融債,45,10,35,新光-高雄,2024-01-10,8562
1301,台塑,36,1,35,新光-高雄,2024-01-10,8562
3188,鑫龍騰,35,1,34,新光-高雄,2024-01-10,8562
1802,台玻,33,0,33,新光-高雄,2024-01-10,8562
2884,玉山金,51,18,33,新光-高雄,2024-01-10,8562
00665L,富邦�琤肭磪囓�2,57,25,32,新光-高雄,2024-01-10,8562
00679B,元大美債20年,39,7,32,新光-高雄,2024-01-10,8562
2498,宏達電,55,24,31,新光-高雄,2024-01-10,8562
4566,時碩工業,30,0,30,新光-高雄,2024-01-10,8562
2301,光寶科,40,12,28,新光-高雄,2024-01-10,8562
2603,長榮,96,68,28,新光-高雄,2024-01-10,8562
2543,皇昌,37,10,27,新光-高雄,2024-01-10,8562
0050,元大台灣50,28,1,27,新光-高雄,2024-01-10,8562
2362,藍天,98,72,26,新光-高雄,2024-01-10,8562
00919,群益台灣精選高息,246,220,26,新光-高雄,2024-01-10,8562
5521,工信,170,145,25,新光-高雄,2024-01-10,8562
1605,華新,25,1,24,新光-高雄,2024-01-10,8562
00857B,永豐20年美公債,26,2,24,新光-高雄,2024-01-10,8562
6164,華興,82,60,22,新光-高雄,2024-01-10,8562
1717,長興,21,0,21,新光-高雄,2024-01-10,8562
2885,元大金,27,6,21,新光-高雄,2024-01-10,8562
2353,宏��,172,151,21,新光-高雄,2024-01-10,8562
00753L,中信中國50正2,23,3,20,新光-高雄,2024-01-10,8562
1805,寶徠,20,0,20,新光-高雄,2024-01-10,8562
1608,華榮,22,2,20,新光-高雄,2024-01-10,8562
00713,元大台灣高息低波,41,22,19,新光-高雄,2024-01-10,8562
2352,佳世達,26,7,19,新光-高雄,2024-01-10,8562
9921,巨大,28,9,19,新光-高雄,2024-01-10,8562
1101,台泥,23,4,19,新光-高雄,2024-01-10,8562
2337,旺宏,419,7,412,新光-高雄,2024-01-11,8562
00929,復華台灣科技優息,331,124,207,新光-高雄,2024-01-11,8562
00715L,期街口布蘭特正2,140,5,135,新光-高雄,2024-01-11,8562
6120,達運,367,246,121,新光-高雄,2024-01-11,8562
00680L,元大美債20正2,119,0,119,新光-高雄,2024-01-11,8562
00931B,統一美債20年,114,6,108,新光-高雄,2024-01-11,8562
00671R,富邦NASDAQ反1,112,10,102,新光-高雄,2024-01-11,8562
2313,華通,103,13,90,新光-高雄,2024-01-11,8562
00927,群益半導體收益,79,2,77,新光-高雄,2024-01-11,8562
4402,郡都開發,76,0,76,新光-高雄,2024-01-11,8562
5521,工信,180,116,64,新光-高雄,2024-01-11,8562
00919,群益台灣精選高息,198,134,64,新光-高雄,2024-01-11,8562
8110,華東,64,5,59,新光-高雄,2024-01-11,8562
00632R,元大台灣50反1,96,40,56,新光-高雄,2024-01-11,8562
00687B,國泰20年美債,54,5,49,新光-高雄,2024-01-11,8562
2610,華航,88,41,47,新光-高雄,2024-01-11,8562
2883,凱基金,86,40,46,新光-高雄,2024-01-11,8562
00688L,國泰20年美債正2,45,0,45,新光-高雄,2024-01-11,8562
00937B,群益ESG投等債20,72,33,39,新光-高雄,2024-01-11,8562
2515,中工,36,0,36,新光-高雄,2024-01-11,8562
2449,京元電子,64,28,36,新光-高雄,2024-01-11,8562
910322,康師傅-DR,35,0,35,新光-高雄,2024-01-11,8562
6219,富旺,37,3,34,新光-高雄,2024-01-11,8562
00740B,富邦全球投等債,34,0,34,新光-高雄,2024-01-11,8562
2812,台中銀,37,4,33,新光-高雄,2024-01-11,8562
6667,信紘科,55,22,33,新光-高雄,2024-01-11,8562
6695,芯鼎,148,116,32,新光-高雄,2024-01-11,8562
2365,昆盈,34,4,30,新光-高雄,2024-01-11,8562
00665L,富邦�琤肭磪囓�2,100,72,28,新光-高雄,2024-01-11,8562
0056,元大高股息,54,26,28,新光-高雄,2024-01-11,8562
4306,炎洲,27,0,27,新光-高雄,2024-01-11,8562
3024,憶聲,27,1,26,新光-高雄,2024-01-11,8562
6113,亞矽,30,4,26,新光-高雄,2024-01-11,8562
2408,南亞科,51,25,26,新光-高雄,2024-01-11,8562
00933B,國泰10Y+金融債,26,0,26,新光-高雄,2024-01-11,8562
00720B,元大投資級公司債,35,9,26,新光-高雄,2024-01-11,8562
1444,力麗,26,0,26,新光-高雄,2024-01-11,8562
2344,華邦電,129,103,26,新光-高雄,2024-01-11,8562
9921,巨大,71,45,26,新光-高雄,2024-01-11,8562
6462,神盾,56,31,25,新光-高雄,2024-01-11,8562
00642U,期元大S＆P石油,25,0,25,新光-高雄,2024-01-11,8562
8150,南茂,76,52,24,新光-高雄,2024-01-11,8562
1301,台塑,80,56,24,新光-高雄,2024-01-11,8562
00670L,富邦NASDAQ正2,23,0,23,新光-高雄,2024-01-11,8562
00857B,永豐20年美公債,22,0,22,新光-高雄,2024-01-11,8562
00679B,元大美債20年,22,1,21,新光-高雄,2024-01-11,8562
2882,國泰金,29,8,21,新光-高雄,2024-01-11,8562
2442,新美齊,32,11,21,新光-高雄,2024-01-11,8562
6546,正基,48,27,21,新光-高雄,2024-01-11,8562
1605,華新,20,0,20,新光-高雄,2024-01-11,8562
00929,復華台灣科技優息,1559,51,1508,新光-高雄,2024-01-12,8562
00712,復華富時不動產,203,6,197,新光-高雄,2024-01-12,8562
00919,群益台灣精選高息,268,85,183,新光-高雄,2024-01-12,8562
5347,世界,158,4,154,新光-高雄,2024-01-12,8562
00937B,群益ESG投等債20,156,5,151,新光-高雄,2024-01-12,8562
2365,昆盈,146,21,125,新光-高雄,2024-01-12,8562
00795B,中信美國公債20年,108,5,103,新光-高雄,2024-01-12,8562
1560,中砂,101,11,90,新光-高雄,2024-01-12,8562
4402,郡都開發,78,0,78,新光-高雄,2024-01-12,8562
5258,虹堡,83,20,63,新光-高雄,2024-01-12,8562
0056,元大高股息,80,20,60,新光-高雄,2024-01-12,8562
1528,恩德,107,48,59,新光-高雄,2024-01-12,8562
00673R,期元大S＆P原油反1,59,0,59,新光-高雄,2024-01-12,8562
00770,國泰北美科技,65,7,58,新光-高雄,2024-01-12,8562
2023,燁輝,60,2,58,新光-高雄,2024-01-12,8562
00680L,元大美債20正2,73,21,52,新光-高雄,2024-01-12,8562
00676R,富邦臺灣加權反1,50,0,50,新光-高雄,2024-01-12,8562
2888,新光金,136,96,40,新光-高雄,2024-01-12,8562
5426,振發,215,176,39,新光-高雄,2024-01-12,8562
00927,群益半導體收益,37,0,37,新光-高雄,2024-01-12,8562
00713,元大台灣高息低波,49,12,37,新光-高雄,2024-01-12,8562
00882,中信中國高股息,34,1,33,新光-高雄,2024-01-12,8562
00671R,富邦NASDAQ反1,33,0,33,新光-高雄,2024-01-12,8562
2884,玉山金,42,10,32,新光-高雄,2024-01-12,8562
00881,國泰台灣5G+,51,20,31,新光-高雄,2024-01-12,8562
9105,泰金寶-DR,80,50,30,新光-高雄,2024-01-12,8562
4157,太景*-KY,30,1,29,新光-高雄,2024-01-12,8562
1513,中興電,44,16,28,新光-高雄,2024-01-12,8562
2605,新興,30,4,26,新光-高雄,2024-01-12,8562
1326,台化,25,3,22,新光-高雄,2024-01-12,8562
5328,華容,21,0,21,新光-高雄,2024-01-12,8562
2834,臺企銀,22,1,21,新光-高雄,2024-01-12,8562
3025,星通,57,37,20,新光-高雄,2024-01-12,8562
9946,三發地產,21,1,20,新光-高雄,2024-01-12,8562
2887,台新金,25,5,20,新光-高雄,2024-01-12,8562
6140,訊達,52,33,19,新光-高雄,2024-01-12,8562
2401,凌陽,18,1,17,新光-高雄,2024-01-12,8562
00708L,期元大S＆P黃金正2,22,5,17,新光-高雄,2024-01-12,8562
00725B,國泰投資級公司債,20,3,17,新光-高雄,2024-01-12,8562
2542,興富發,18,1,17,新光-高雄,2024-01-12,8562
8227,巨有科技,64,47,17,新光-高雄,2024-01-12,8562
2388,威盛,37,21,16,新光-高雄,2024-01-12,8562
2486,一詮,150,135,15,新光-高雄,2024-01-12,8562
2449,京元電子,38,22,16,新光-高雄,2024-01-12,8562
2515,中工,18,3,15,新光-高雄,2024-01-12,8562
6446,藥華藥,15,0,15,新光-高雄,2024-01-12,8562
00688L,國泰20年美債正2,46,31,15,新光-高雄,2024-01-12,8562
8222,寶一,37,24,13,新光-高雄,2024-01-12,8562
2915,潤泰全,14,2,12,新光-高雄,2024-01-12,8562
2897,王道銀行,14,2,12,新光-高雄,2024-01-12,8562
00637L,元大滬深300正2,656,40,616,新光-高雄,2024-01-15,8562
00882,中信中國高股息,238,19,219,新光-高雄,2024-01-15,8562
00927,群益半導體收益,197,6,191,新光-高雄,2024-01-15,8562
00881,國泰台灣5G+,195,6,189,新光-高雄,2024-01-15,8562
00715L,期街口布蘭特正2,166,3,163,新光-高雄,2024-01-15,8562
3231,緯創,302,156,146,新光-高雄,2024-01-15,8562
00632R,元大台灣50反1,162,16,146,新光-高雄,2024-01-15,8562
2888,新光金,155,27,128,新光-高雄,2024-01-15,8562
2313,華通,139,14,125,新光-高雄,2024-01-15,8562
0056,元大高股息,130,15,115,新光-高雄,2024-01-15,8562
6163,華電網,106,0,106,新光-高雄,2024-01-15,8562
2867,三商壽,105,0,105,新光-高雄,2024-01-15,8562
2101,南港,90,0,90,新光-高雄,2024-01-15,8562
5425,台半,89,2,87,新光-高雄,2024-01-15,8562
2356,英業達,96,17,79,新光-高雄,2024-01-15,8562
2883,凱基金,75,0,75,新光-高雄,2024-01-15,8562
2801,彰銀,71,0,71,新光-高雄,2024-01-15,8562
2489,瑞軒,68,0,68,新光-高雄,2024-01-15,8562
2610,華航,101,38,63,新光-高雄,2024-01-15,8562
6191,精成科,65,3,62,新光-高雄,2024-01-15,8562
00930,永豐ESG低碳高息,61,0,61,新光-高雄,2024-01-15,8562
1584,精剛,60,2,58,新光-高雄,2024-01-15,8562
1503,士電,80,24,56,新光-高雄,2024-01-15,8562
00671R,富邦NASDAQ反1,65,10,55,新光-高雄,2024-01-15,8562
2812,台中銀,171,116,55,新光-高雄,2024-01-15,8562
2002,中鋼,55,1,54,新光-高雄,2024-01-15,8562
2347,聯強,50,0,50,新光-高雄,2024-01-15,8562
3149,正達,51,4,47,新光-高雄,2024-01-15,8562
6219,富旺,51,5,46,新光-高雄,2024-01-15,8562
2317,鴻海,45,3,42,新光-高雄,2024-01-15,8562
2887,台新金,44,2,42,新光-高雄,2024-01-15,8562
3481,群創,118,78,40,新光-高雄,2024-01-15,8562
6120,達運,61,23,38,新光-高雄,2024-01-15,8562
2889,國票金,42,5,37,新光-高雄,2024-01-15,8562
2324,仁寶,46,10,36,新光-高雄,2024-01-15,8562
00688L,國泰20年美債正2,34,2,32,新光-高雄,2024-01-15,8562
1101,台泥,31,1,30,新光-高雄,2024-01-15,8562
1582,信錦,30,0,30,新光-高雄,2024-01-15,8562
2618,長榮航,68,38,30,新光-高雄,2024-01-15,8562
00753L,中信中國50正2,35,6,29,新光-高雄,2024-01-15,8562
3437,榮創,37,8,29,新光-高雄,2024-01-15,8562
1451,年興,25,0,25,新光-高雄,2024-01-15,8562
2409,友達,30,6,24,新光-高雄,2024-01-15,8562
00937B,群益ESG投等債20,71,48,23,新光-高雄,2024-01-15,8562
1326,台化,26,3,23,新光-高雄,2024-01-15,8562
5880,合庫金,23,0,23,新光-高雄,2024-01-15,8562
2634,漢翔,66,46,20,新光-高雄,2024-01-15,8562
2605,新興,22,2,20,新光-高雄,2024-01-15,8562
2106,建大,20,0,20,新光-高雄,2024-01-15,8562
2630,亞航,63,43,20,新光-高雄,2024-01-15,8562
0056,元大高股息,1619,59,1560,新光-高雄,2024-01-16,8562
00878,國泰永續高股息,1074,68,1006,新光-高雄,2024-01-16,8562
00919,群益台灣精選高息,900,101,799,新光-高雄,2024-01-16,8562
00929,復華台灣科技優息,632,108,524,新光-高雄,2024-01-16,8562
00881,國泰台灣5G+,189,6,183,新光-高雄,2024-01-16,8562
00671R,富邦NASDAQ反1,176,0,176,新光-高雄,2024-01-16,8562
00937B,群益ESG投等債20,131,1,130,新光-高雄,2024-01-16,8562
00688L,國泰20年美債正2,187,63,124,新光-高雄,2024-01-16,8562
2867,三商壽,109,0,109,新光-高雄,2024-01-16,8562
2486,一詮,335,232,103,新光-高雄,2024-01-16,8562
00882,中信中國高股息,92,0,92,新光-高雄,2024-01-16,8562
00927,群益半導體收益,113,23,90,新光-高雄,2024-01-16,8562
5880,合庫金,89,0,89,新光-高雄,2024-01-16,8562
1326,台化,89,5,84,新光-高雄,2024-01-16,8562
00715L,期街口布蘭特正2,106,26,80,新光-高雄,2024-01-16,8562
1718,中纖,75,2,73,新光-高雄,2024-01-16,8562
00713,元大台灣高息低波,68,2,66,新光-高雄,2024-01-16,8562
00922,國泰台灣領袖50,64,0,64,新光-高雄,2024-01-16,8562
2801,彰銀,65,1,64,新光-高雄,2024-01-16,8562
00728,第一金工業30,64,0,64,新光-高雄,2024-01-16,8562
00888,永豐台灣ESG,62,0,62,新光-高雄,2024-01-16,8562
3033,威健,94,32,62,新光-高雄,2024-01-16,8562
2365,昆盈,86,25,61,新光-高雄,2024-01-16,8562
2409,友達,131,71,60,新光-高雄,2024-01-16,8562
8096,擎亞,349,289,60,新光-高雄,2024-01-16,8562
2883,凱基金,151,92,59,新光-高雄,2024-01-16,8562
00720B,元大投資級公司債,57,2,55,新光-高雄,2024-01-16,8562
2882,國泰金,52,2,50,新光-高雄,2024-01-16,8562
1907,永豐餘,63,15,48,新光-高雄,2024-01-16,8562
2313,華通,63,16,47,新光-高雄,2024-01-16,8562
2889,國票金,57,10,47,新光-高雄,2024-01-16,8562
2317,鴻海,67,24,43,新光-高雄,2024-01-16,8562
9921,巨大,45,5,40,新光-高雄,2024-01-16,8562
2887,台新金,64,24,40,新光-高雄,2024-01-16,8562
0050,元大台灣50,43,4,39,新光-高雄,2024-01-16,8562
1301,台塑,50,13,37,新光-高雄,2024-01-16,8562
2324,仁寶,42,5,37,新光-高雄,2024-01-16,8562
00687B,國泰20年美債,86,49,37,新光-高雄,2024-01-16,8562
1101,台泥,35,0,35,新光-高雄,2024-01-16,8562
9105,泰金寶-DR,34,0,34,新光-高雄,2024-01-16,8562
00770,國泰北美科技,48,14,34,新光-高雄,2024-01-16,8562
2374,佳能,47,14,33,新光-高雄,2024-01-16,8562
2344,華邦電,184,152,32,新光-高雄,2024-01-16,8562
2603,長榮,92,60,32,新光-高雄,2024-01-16,8562
8085,福華,42,10,32,新光-高雄,2024-01-16,8562
00679B,元大美債20年,71,40,31,新光-高雄,2024-01-16,8562
2101,南港,32,1,31,新光-高雄,2024-01-16,8562
1434,福懋,31,0,31,新光-高雄,2024-01-16,8562
9945,潤泰新,31,0,31,新光-高雄,2024-01-16,8562
2610,華航,67,37,30,新光-高雄,2024-01-16,8562
00919,群益台灣精選高息,1289,71,1218,新光-高雄,2024-01-17,8562
00929,復華台灣科技優息,1141,55,1086,新光-高雄,2024-01-17,8562
00882,中信中國高股息,422,60,362,新光-高雄,2024-01-17,8562
0056,元大高股息,355,34,321,新光-高雄,2024-01-17,8562
00680L,元大美債20正2,262,45,217,新光-高雄,2024-01-17,8562
00688L,國泰20年美債正2,288,133,155,新光-高雄,2024-01-17,8562
3231,緯創,292,163,129,新光-高雄,2024-01-17,8562
00687B,國泰20年美債,141,13,128,新光-高雄,2024-01-17,8562
00715L,期街口布蘭特正2,125,0,125,新光-高雄,2024-01-17,8562
2887,台新金,107,1,106,新光-高雄,2024-01-17,8562
00937B,群益ESG投等債20,131,33,98,新光-高雄,2024-01-17,8562
00679B,元大美債20年,96,9,87,新光-高雄,2024-01-17,8562
2303,聯電,154,75,79,新光-高雄,2024-01-17,8562
00665L,富邦�琤肭磪囓�2,141,68,73,新光-高雄,2024-01-17,8562
00888,永豐台灣ESG,72,0,72,新光-高雄,2024-01-17,8562
00931B,統一美債20年,79,8,71,新光-高雄,2024-01-17,8562
3481,群創,285,214,71,新光-高雄,2024-01-17,8562
2317,鴻海,72,5,67,新光-高雄,2024-01-17,8562
2884,玉山金,78,11,67,新光-高雄,2024-01-17,8562
00927,群益半導體收益,88,22,66,新光-高雄,2024-01-17,8562
9945,潤泰新,65,4,61,新光-高雄,2024-01-17,8562
6155,鈞寶,62,1,61,新光-高雄,2024-01-17,8562
2356,英業達,88,28,60,新光-高雄,2024-01-17,8562
0050,元大台灣50,62,3,59,新光-高雄,2024-01-17,8562
2329,華泰,190,135,55,新光-高雄,2024-01-17,8562
2883,凱基金,88,34,54,新光-高雄,2024-01-17,8562
2867,三商壽,53,1,52,新光-高雄,2024-01-17,8562
2888,新光金,62,11,51,新光-高雄,2024-01-17,8562
3055,蔚華科,62,13,49,新光-高雄,2024-01-17,8562
2882,國泰金,54,7,47,新光-高雄,2024-01-17,8562
00918,大華優利高填息30,45,0,45,新光-高雄,2024-01-17,8562
2609,陽明,135,91,44,新光-高雄,2024-01-17,8562
2371,大同,81,38,43,新光-高雄,2024-01-17,8562
2801,彰銀,88,45,43,新光-高雄,2024-01-17,8562
00706L,期元大S＆P日圓正2,42,0,42,新光-高雄,2024-01-17,8562
1314,中石化,42,1,41,新光-高雄,2024-01-17,8562
1605,華新,52,12,40,新光-高雄,2024-01-17,8562
2023,燁輝,40,0,40,新光-高雄,2024-01-17,8562
00713,元大台灣高息低波,45,5,40,新光-高雄,2024-01-17,8562
2892,第一金,60,22,38,新光-高雄,2024-01-17,8562
00934,中信成長高股息,48,10,38,新光-高雄,2024-01-17,8562
2520,冠德,40,3,37,新光-高雄,2024-01-17,8562
00881,國泰台灣5G+,42,6,36,新光-高雄,2024-01-17,8562
2603,長榮,71,35,36,新光-高雄,2024-01-17,8562
00753L,中信中國50正2,63,27,36,新光-高雄,2024-01-17,8562
2357,華碩,37,1,36,新光-高雄,2024-01-17,8562
00650L,復華香港正2,35,0,35,新光-高雄,2024-01-17,8562
2886,兆豐金,56,21,35,新光-高雄,2024-01-17,8562
00675L,富邦臺灣加權正2,36,2,34,新光-高雄,2024-01-17,8562
2409,友達,32,1,31,新光-高雄,2024-01-17,8562
00929,復華台灣科技優息,576,44,532,新光-高雄,2024-01-18,8562
00650L,復華香港正2,423,1,422,新光-高雄,2024-01-18,8562
00919,群益台灣精選高息,351,26,325,新光-高雄,2024-01-18,8562
2888,新光金,234,0,234,新光-高雄,2024-01-18,8562
00712,復華富時不動產,168,4,164,新光-高雄,2024-01-18,8562
4960,誠美材,213,72,141,新光-高雄,2024-01-18,8562
00680L,元大美債20正2,143,3,140,新光-高雄,2024-01-18,8562
00882,中信中國高股息,161,30,131,新光-高雄,2024-01-18,8562
2887,台新金,110,0,110,新光-高雄,2024-01-18,8562
1560,中砂,109,7,102,新光-高雄,2024-01-18,8562
1447,力鵬,100,0,100,新光-高雄,2024-01-18,8562
00673R,期元大S＆P原油反1,100,0,100,新光-高雄,2024-01-18,8562
00937B,群益ESG投等債20,101,5,96,新光-高雄,2024-01-18,8562
2601,益航,91,0,91,新光-高雄,2024-01-18,8562
2313,華通,121,39,82,新光-高雄,2024-01-18,8562
00687B,國泰20年美債,83,9,74,新光-高雄,2024-01-18,8562
00878,國泰永續高股息,96,27,69,新光-高雄,2024-01-18,8562
0056,元大高股息,151,92,59,新光-高雄,2024-01-18,8562
00728,第一金工業30,60,2,58,新光-高雄,2024-01-18,8562
2409,友達,219,162,57,新光-高雄,2024-01-18,8562
00633L,富邦上証正2,84,30,54,新光-高雄,2024-01-18,8562
2884,玉山金,72,20,52,新光-高雄,2024-01-18,8562
2881,富邦金,53,2,51,新光-高雄,2024-01-18,8562
00706L,期元大S＆P日圓正2,50,0,50,新光-高雄,2024-01-18,8562
4402,郡都開發,38,0,38,新光-高雄,2024-01-18,8562
2388,威盛,56,21,35,新光-高雄,2024-01-18,8562
2615,萬海,52,17,35,新光-高雄,2024-01-18,8562
00635U,期元大S＆P黃金,32,0,32,新光-高雄,2024-01-18,8562
1210,大成,32,0,32,新光-高雄,2024-01-18,8562
00931B,統一美債20年,33,2,31,新光-高雄,2024-01-18,8562
00918,大華優利高填息30,31,0,31,新光-高雄,2024-01-18,8562
00881,國泰台灣5G+,37,7,30,新光-高雄,2024-01-18,8562
2382,廣達,50,21,29,新光-高雄,2024-01-18,8562
3051,力特,29,1,28,新光-高雄,2024-01-18,8562
00637L,元大滬深300正2,235,209,26,新光-高雄,2024-01-18,8562
2353,宏��,246,222,24,新光-高雄,2024-01-18,8562
3380,明泰,22,0,22,新光-高雄,2024-01-18,8562
5880,合庫金,21,0,21,新光-高雄,2024-01-18,8562
2303,聯電,77,56,21,新光-高雄,2024-01-18,8562
00713,元大台灣高息低波,21,0,21,新光-高雄,2024-01-18,8562
5228,鈺鎧,22,2,20,新光-高雄,2024-01-18,8562
00676R,富邦臺灣加權反1,20,0,20,新光-高雄,2024-01-18,8562
6126,信音,20,0,20,新光-高雄,2024-01-18,8562
2883,凱基金,33,15,18,新光-高雄,2024-01-18,8562
00671R,富邦NASDAQ反1,18,0,18,新光-高雄,2024-01-18,8562
1528,恩德,139,121,18,新光-高雄,2024-01-18,8562
3321,同泰,18,0,18,新光-高雄,2024-01-18,8562
00655L,國泰中國A50正2,65,47,18,新光-高雄,2024-01-18,8562
1316,上曜,18,0,18,新光-高雄,2024-01-18,8562
3231,緯創,178,160,18,新光-高雄,2024-01-18,8562
00929,復華台灣科技優息,1569,157,1412,新光-高雄,2024-01-19,8562
00632R,元大台灣50反1,669,177,492,新光-高雄,2024-01-19,8562
00931B,統一美債20年,349,60,289,新光-高雄,2024-01-19,8562
00679B,元大美債20年,254,4,250,新光-高雄,2024-01-19,8562
1326,台化,232,3,229,新光-高雄,2024-01-19,8562
00882,中信中國高股息,187,5,182,新光-高雄,2024-01-19,8562
00937B,群益ESG投等債20,171,20,151,新光-高雄,2024-01-19,8562
2449,京元電子,177,36,141,新光-高雄,2024-01-19,8562
00933B,國泰10Y+金融債,129,5,124,新光-高雄,2024-01-19,8562
2002,中鋼,136,16,120,新光-高雄,2024-01-19,8562
2610,華航,124,7,117,新光-高雄,2024-01-19,8562
3576,聯合再生,141,32,109,新光-高雄,2024-01-19,8562
00919,群益台灣精選高息,125,29,96,新光-高雄,2024-01-19,8562
2303,聯電,124,32,92,新光-高雄,2024-01-19,8562
1528,恩德,99,11,88,新光-高雄,2024-01-19,8562
6120,達運,167,80,87,新光-高雄,2024-01-19,8562
2615,萬海,93,12,81,新光-高雄,2024-01-19,8562
00857B,永豐20年美公債,80,0,80,新光-高雄,2024-01-19,8562
2409,友達,102,34,68,新光-高雄,2024-01-19,8562
00751B,元大AAA至A公司債,67,0,67,新光-高雄,2024-01-19,8562
00712,復華富時不動產,66,0,66,新光-高雄,2024-01-19,8562
00795B,中信美國公債20年,63,0,63,新光-高雄,2024-01-19,8562
2801,彰銀,57,0,57,新光-高雄,2024-01-19,8562
00688L,國泰20年美債正2,213,157,56,新光-高雄,2024-01-19,8562
2867,三商壽,56,0,56,新光-高雄,2024-01-19,8562
2344,華邦電,211,156,55,新光-高雄,2024-01-19,8562
2405,輔信,53,1,52,新光-高雄,2024-01-19,8562
3149,正達,51,1,50,新光-高雄,2024-01-19,8562
00720B,元大投資級公司債,50,3,47,新光-高雄,2024-01-19,8562
2618,長榮航,64,22,42,新光-高雄,2024-01-19,8562
6695,芯鼎,59,20,39,新光-高雄,2024-01-19,8562
5443,均豪,65,26,39,新光-高雄,2024-01-19,8562
9105,泰金寶-DR,46,11,35,新光-高雄,2024-01-19,8562
5347,世界,38,8,30,新光-高雄,2024-01-19,8562
4109,加捷生醫,41,11,30,新光-高雄,2024-01-19,8562
0056,元大高股息,62,37,25,新光-高雄,2024-01-19,8562
00665L,富邦�琤肭磪囓�2,25,0,25,新光-高雄,2024-01-19,8562
2834,臺企銀,26,1,25,新光-高雄,2024-01-19,8562
00907,永豐優息存股,25,0,25,新光-高雄,2024-01-19,8562
2609,陽明,91,66,25,新光-高雄,2024-01-19,8562
1795,美時,36,12,24,新光-高雄,2024-01-19,8562
5880,合庫金,34,10,24,新光-高雄,2024-01-19,8562
1809,中釉,28,6,22,新光-高雄,2024-01-19,8562
00636,國泰中國A50,21,0,21,新光-高雄,2024-01-19,8562
2408,南亞科,26,5,21,新光-高雄,2024-01-19,8562
1455,集盛,20,0,20,新光-高雄,2024-01-19,8562
8096,擎亞,143,124,19,新光-高雄,2024-01-19,8562
3530,晶相光,95,77,18,新光-高雄,2024-01-19,8562
2486,一詮,47,29,18,新光-高雄,2024-01-19,8562
00904,新光臺灣半導體30,18,0,18,新光-高雄,2024-01-19,8562
00650L,復華香港正2,596,0,596,新光-高雄,2024-01-22,8562
00680L,元大美債20正2,456,69,387,新光-高雄,2024-01-22,8562
00687B,國泰20年美債,277,94,183,新光-高雄,2024-01-22,8562
2313,華通,174,8,166,新光-高雄,2024-01-22,8562
00882,中信中國高股息,289,175,114,新光-高雄,2024-01-22,8562
9105,泰金寶-DR,132,24,108,新光-高雄,2024-01-22,8562
00637L,元大滬深300正2,164,72,92,新光-高雄,2024-01-22,8562
2353,宏��,152,67,85,新光-高雄,2024-01-22,8562
4402,郡都開發,83,0,83,新光-高雄,2024-01-22,8562
00937B,群益ESG投等債20,84,1,83,新光-高雄,2024-01-22,8562
1314,中石化,80,0,80,新光-高雄,2024-01-22,8562
2603,長榮,165,86,79,新光-高雄,2024-01-22,8562
2887,台新金,77,7,70,新光-高雄,2024-01-22,8562
00933B,國泰10Y+金融債,69,0,69,新光-高雄,2024-01-22,8562
0056,元大高股息,104,38,66,新光-高雄,2024-01-22,8562
00753L,中信中國50正2,65,0,65,新光-高雄,2024-01-22,8562
2317,鴻海,66,12,54,新光-高雄,2024-01-22,8562
1455,集盛,52,0,52,新光-高雄,2024-01-22,8562
4109,加捷生醫,68,16,52,新光-高雄,2024-01-22,8562
2316,楠梓電,91,40,51,新光-高雄,2024-01-22,8562
2884,玉山金,56,7,49,新光-高雄,2024-01-22,8562
2618,長榮航,129,81,48,新光-高雄,2024-01-22,8562
2801,彰銀,38,0,38,新光-高雄,2024-01-22,8562
2208,台船,36,0,36,新光-高雄,2024-01-22,8562
3324,雙鴻,61,26,35,新光-高雄,2024-01-22,8562
3312,弘憶股,46,12,34,新光-高雄,2024-01-22,8562
3712,永崴投控,42,10,32,新光-高雄,2024-01-22,8562
00927,群益半導體收益,32,0,32,新光-高雄,2024-01-22,8562
8027,鈦昇,50,19,31,新光-高雄,2024-01-22,8562
1795,美時,35,5,30,新光-高雄,2024-01-22,8562
00773B,中信優先金融債,30,0,30,新光-高雄,2024-01-22,8562
00725B,國泰投資級公司債,30,0,30,新光-高雄,2024-01-22,8562
6134,萬旭,30,0,30,新光-高雄,2024-01-22,8562
2412,中華電,31,1,30,新光-高雄,2024-01-22,8562
3078,僑威,31,3,28,新光-高雄,2024-01-22,8562
00713,元大台灣高息低波,37,9,28,新光-高雄,2024-01-22,8562
5426,振發,182,154,28,新光-高雄,2024-01-22,8562
2301,光寶科,78,52,26,新光-高雄,2024-01-22,8562
1101,台泥,26,1,25,新光-高雄,2024-01-22,8562
00712,復華富時不動產,35,11,24,新光-高雄,2024-01-22,8562
2867,三商壽,25,1,24,新光-高雄,2024-01-22,8562
2633,台灣高鐵,23,0,23,新光-高雄,2024-01-22,8562
4129,聯合,26,3,23,新光-高雄,2024-01-22,8562
2834,臺企銀,21,0,21,新光-高雄,2024-01-22,8562
1608,華榮,21,0,21,新光-高雄,2024-01-22,8562
00642U,期元大S＆P石油,20,2,18,新光-高雄,2024-01-22,8562
6732,昇佳電子,18,0,18,新光-高雄,2024-01-22,8562
5880,合庫金,18,0,18,新光-高雄,2024-01-22,8562
2609,陽明,85,68,17,新光-高雄,2024-01-22,8562
1605,華新,20,3,17,新光-高雄,2024-01-22,8562
1314,中石化,441,7,434,新光-高雄,2024-01-23,8562
2337,旺宏,412,1,411,新光-高雄,2024-01-23,8562
00637L,元大滬深300正2,319,101,218,新光-高雄,2024-01-23,8562
00680L,元大美債20正2,180,15,165,新光-高雄,2024-01-23,8562
00679B,元大美債20年,166,7,159,新光-高雄,2024-01-23,8562
00937B,群益ESG投等債20,116,0,116,新光-高雄,2024-01-23,8562
9907,統一實,101,0,101,新光-高雄,2024-01-23,8562
3520,華盈,92,12,80,新光-高雄,2024-01-23,8562
3481,群創,730,669,61,新光-高雄,2024-01-23,8562
2365,昆盈,71,11,60,新光-高雄,2024-01-23,8562
4402,郡都開發,64,5,59,新光-高雄,2024-01-23,8562
2355,敬鵬,66,8,58,新光-高雄,2024-01-23,8562
2610,華航,98,40,58,新光-高雄,2024-01-23,8562
00882,中信中國高股息,141,89,52,新光-高雄,2024-01-23,8562
3702,大聯大,88,36,52,新光-高雄,2024-01-23,8562
2368,金像電,65,16,49,新光-高雄,2024-01-23,8562
1513,中興電,56,9,47,新光-高雄,2024-01-23,8562
6198,瑞築,41,0,41,新光-高雄,2024-01-23,8562
00673R,期元大S＆P原油反1,41,0,41,新光-高雄,2024-01-23,8562
1560,中砂,41,0,41,新光-高雄,2024-01-23,8562
2609,陽明,104,64,40,新光-高雄,2024-01-23,8562
00713,元大台灣高息低波,40,1,39,新光-高雄,2024-01-23,8562
00927,群益半導體收益,45,6,39,新光-高雄,2024-01-23,8562
3363,上詮,51,13,38,新光-高雄,2024-01-23,8562
00632R,元大台灣50反1,147,110,37,新光-高雄,2024-01-23,8562
2884,玉山金,39,3,36,新光-高雄,2024-01-23,8562
00933B,國泰10Y+金融債,64,30,34,新光-高雄,2024-01-23,8562
00878,國泰永續高股息,73,39,34,新光-高雄,2024-01-23,8562
2303,聯電,52,20,32,新光-高雄,2024-01-23,8562
3055,蔚華科,42,12,30,新光-高雄,2024-01-23,8562
1528,恩德,29,0,29,新光-高雄,2024-01-23,8562
00706L,期元大S＆P日圓正2,65,37,28,新光-高雄,2024-01-23,8562
2812,台中銀,33,6,27,新光-高雄,2024-01-23,8562
2002,中鋼,28,2,26,新光-高雄,2024-01-23,8562
3045,台灣大,26,0,26,新光-高雄,2024-01-23,8562
2618,長榮航,45,20,25,新光-高雄,2024-01-23,8562
1608,華榮,25,0,25,新光-高雄,2024-01-23,8562
2383,台光電,28,3,25,新光-高雄,2024-01-23,8562
2486,一詮,53,29,24,新光-高雄,2024-01-23,8562
6906,現觀科,23,0,23,新光-高雄,2024-01-23,8562
8096,擎亞,102,81,21,新光-高雄,2024-01-23,8562
3708,上緯投控,20,0,20,新光-高雄,2024-01-23,8562
3311,閎暉,22,2,20,新光-高雄,2024-01-23,8562
8054,安國,73,53,20,新光-高雄,2024-01-23,8562
2316,楠梓電,23,4,19,新光-高雄,2024-01-23,8562
00688L,國泰20年美債正2,36,16,20,新光-高雄,2024-01-23,8562
00900,富邦特選高股息30,37,18,19,新光-高雄,2024-01-23,8562
4956,光鋐,40,22,18,新光-高雄,2024-01-23,8562
00720B,元大投資級公司債,18,0,18,新光-高雄,2024-01-23,8562
5202,力新,21,3,18,新光-高雄,2024-01-23,8562
00929,復華台灣科技優息,813,96,717,新光-高雄,2024-01-24,8562
00878,國泰永續高股息,555,107,448,新光-高雄,2024-01-24,8562
00937B,群益ESG投等債20,252,39,213,新光-高雄,2024-01-24,8562
00715L,期街口布蘭特正2,286,97,189,新光-高雄,2024-01-24,8562
00637L,元大滬深300正2,271,82,189,新光-高雄,2024-01-24,8562
00687B,國泰20年美債,156,11,145,新光-高雄,2024-01-24,8562
00931B,統一美債20年,138,0,138,新光-高雄,2024-01-24,8562
1605,華新,141,7,134,新光-高雄,2024-01-24,8562
2312,金寶,131,0,131,新光-高雄,2024-01-24,8562
00632R,元大台灣50反1,135,26,109,新光-高雄,2024-01-24,8562
00907,永豐優息存股,94,0,94,新光-高雄,2024-01-24,8562
00915,凱基優選高股息30,88,1,87,新光-高雄,2024-01-24,8562
00933B,國泰10Y+金融債,86,1,85,新光-高雄,2024-01-24,8562
1312,國喬,70,1,69,新光-高雄,2024-01-24,8562
00679B,元大美債20年,111,42,69,新光-高雄,2024-01-24,8562
00753L,中信中國50正2,76,9,67,新光-高雄,2024-01-24,8562
2369,菱生,239,179,60,新光-高雄,2024-01-24,8562
2313,華通,132,73,59,新光-高雄,2024-01-24,8562
00688L,國泰20年美債正2,82,32,50,新光-高雄,2024-01-24,8562
2615,萬海,58,13,45,新光-高雄,2024-01-24,8562
2610,華航,165,121,44,新光-高雄,2024-01-24,8562
8064,東捷,76,33,43,新光-高雄,2024-01-24,8562
00882,中信中國高股息,91,51,40,新光-高雄,2024-01-24,8562
1210,大成,41,2,39,新光-高雄,2024-01-24,8562
8011,台通,40,2,38,新光-高雄,2024-01-24,8562
2356,英業達,264,227,37,新光-高雄,2024-01-24,8562
5351,鈺創,40,5,35,新光-高雄,2024-01-24,8562
1313,聯成,37,2,35,新光-高雄,2024-01-24,8562
2316,楠梓電,39,5,34,新光-高雄,2024-01-24,8562
6237,驊訊,144,112,32,新光-高雄,2024-01-24,8562
2344,華邦電,162,132,30,新光-高雄,2024-01-24,8562
1455,集盛,30,2,28,新光-高雄,2024-01-24,8562
00676R,富邦臺灣加權反1,28,0,28,新光-高雄,2024-01-24,8562
2883,凱基金,34,7,27,新光-高雄,2024-01-24,8562
5009,榮剛,27,0,27,新光-高雄,2024-01-24,8562
2363,矽統,40,14,26,新光-高雄,2024-01-24,8562
5443,均豪,34,10,24,新光-高雄,2024-01-24,8562
2338,光罩,22,0,22,新光-高雄,2024-01-24,8562
2489,瑞軒,22,0,22,新光-高雄,2024-01-24,8562
00877,復華中國5G,21,0,21,新光-高雄,2024-01-24,8562
2884,玉山金,21,1,20,新光-高雄,2024-01-24,8562
00720B,元大投資級公司債,20,0,20,新光-高雄,2024-01-24,8562
4938,和碩,40,21,19,新光-高雄,2024-01-24,8562
6799,來頡,34,15,19,新光-高雄,2024-01-24,8562
2388,威盛,29,10,19,新光-高雄,2024-01-24,8562
2014,中鴻,20,1,19,新光-高雄,2024-01-24,8562
8085,福華,27,9,18,新光-高雄,2024-01-24,8562
00712,復華富時不動產,24,6,18,新光-高雄,2024-01-24,8562
00751B,元大AAA至A公司債,18,1,17,新光-高雄,2024-01-24,8562
3037,欣興,47,30,17,新光-高雄,2024-01-24,8562
00665L,富邦�琤肭磪囓�2,1108,98,1010,新光-高雄,2024-01-25,8562
00929,復華台灣科技優息,807,217,590,新光-高雄,2024-01-25,8562
00680L,元大美債20正2,562,107,455,新光-高雄,2024-01-25,8562
00753L,中信中國50正2,281,54,227,新光-高雄,2024-01-25,8562
00937B,群益ESG投等債20,253,33,220,新光-高雄,2024-01-25,8562
00687B,國泰20年美債,245,28,217,新光-高雄,2024-01-25,8562
00720B,元大投資級公司債,182,8,174,新光-高雄,2024-01-25,8562
00688L,國泰20年美債正2,177,25,152,新光-高雄,2024-01-25,8562
00931B,統一美債20年,150,0,150,新光-高雄,2024-01-25,8562
3376,新日興,160,28,132,新光-高雄,2024-01-25,8562
2610,華航,128,9,119,新光-高雄,2024-01-25,8562
00933B,國泰10Y+金融債,118,7,111,新光-高雄,2024-01-25,8562
00679B,元大美債20年,108,17,91,新光-高雄,2024-01-25,8562
4402,郡都開發,88,0,88,新光-高雄,2024-01-25,8562
3231,緯創,410,334,76,新光-高雄,2024-01-25,8562
6265,方土昶,88,18,70,新光-高雄,2024-01-25,8562
00673R,期元大S＆P原油反1,76,13,63,新光-高雄,2024-01-25,8562
2365,昆盈,167,109,58,新光-高雄,2024-01-25,8562
3005,神基,68,16,52,新光-高雄,2024-01-25,8562
00885,富邦越南,50,0,50,新光-高雄,2024-01-25,8562
2356,英業達,219,171,48,新光-高雄,2024-01-25,8562
00907,永豐優息存股,46,0,46,新光-高雄,2024-01-25,8562
8110,華東,104,58,46,新光-高雄,2024-01-25,8562
6667,信紘科,50,10,40,新光-高雄,2024-01-25,8562
9921,巨大,70,33,37,新光-高雄,2024-01-25,8562
2344,華邦電,131,96,35,新光-高雄,2024-01-25,8562
5516,雙喜,33,0,33,新光-高雄,2024-01-25,8562
00752,中信中國50,34,2,32,新光-高雄,2024-01-25,8562
020033,統一�琤肮黕篾,30,0,30,新光-高雄,2024-01-25,8562
2867,三商壽,31,3,28,新光-高雄,2024-01-25,8562
3687,歐買尬,32,5,27,新光-高雄,2024-01-25,8562
2431,聯昌,28,3,25,新光-高雄,2024-01-25,8562
6274,台燿,40,17,23,新光-高雄,2024-01-25,8562
5351,鈺創,26,3,23,新光-高雄,2024-01-25,8562
3339,泰谷,26,4,22,新光-高雄,2024-01-25,8562
1609,大亞,23,1,22,新光-高雄,2024-01-25,8562
2609,陽明,24,3,21,新光-高雄,2024-01-25,8562
3605,宏致,53,32,21,新光-高雄,2024-01-25,8562
3149,正達,23,3,20,新光-高雄,2024-01-25,8562
3058,立德,20,0,20,新光-高雄,2024-01-25,8562
3049,精金,20,0,20,新光-高雄,2024-01-25,8562
6245,立端,48,28,20,新光-高雄,2024-01-25,8562
2486,一詮,38,18,20,新光-高雄,2024-01-25,8562
8096,擎亞,416,397,19,新光-高雄,2024-01-25,8562
6113,亞矽,70,51,19,新光-高雄,2024-01-25,8562
2905,三商,18,0,18,新光-高雄,2024-01-25,8562
1809,中釉,30,12,18,新光-高雄,2024-01-25,8562
3591,艾笛森,20,2,18,新光-高雄,2024-01-25,8562
00712,復華富時不動產,21,3,18,新光-高雄,2024-01-25,8562
5478,智冠,32,15,17,新光-高雄,2024-01-25,8562
00919,群益台灣精選高息,454,107,347,新光-高雄,2024-01-26,8562
00680L,元大美債20正2,328,48,280,新光-高雄,2024-01-26,8562
00929,復華台灣科技優息,295,50,245,新光-高雄,2024-01-26,8562
00937B,群益ESG投等債20,164,2,162,新光-高雄,2024-01-26,8562
2303,聯電,257,98,159,新光-高雄,2024-01-26,8562
00665L,富邦�琤肭磪囓�2,339,192,147,新光-高雄,2024-01-26,8562
00753L,中信中國50正2,196,74,122,新光-高雄,2024-01-26,8562
00673R,期元大S＆P原油反1,131,26,105,新光-高雄,2024-01-26,8562
2365,昆盈,268,165,103,新光-高雄,2024-01-26,8562
00676R,富邦臺灣加權反1,100,0,100,新光-高雄,2024-01-26,8562
0056,元大高股息,86,7,79,新光-高雄,2024-01-26,8562
00751B,元大AAA至A公司債,72,11,61,新光-高雄,2024-01-26,8562
00878,國泰永續高股息,91,37,54,新光-高雄,2024-01-26,8562
3416,融程電,52,1,51,新光-高雄,2024-01-26,8562
2890,永豐金,50,0,50,新光-高雄,2024-01-26,8562
1805,寶徠,38,0,38,新光-高雄,2024-01-26,8562
00688L,國泰20年美債正2,65,29,36,新光-高雄,2024-01-26,8562
00633L,富邦上証正2,44,10,34,新光-高雄,2024-01-26,8562
6873,泓德能源,32,0,32,新光-高雄,2024-01-26,8562
00934,中信成長高股息,41,11,30,新光-高雄,2024-01-26,8562
00902,中信電池及儲能,30,0,30,新光-高雄,2024-01-26,8562
8105,凌巨,31,2,29,新光-高雄,2024-01-26,8562
2324,仁寶,59,31,28,新光-高雄,2024-01-26,8562
00927,群益半導體收益,27,1,26,新光-高雄,2024-01-26,8562
00687B,國泰20年美債,52,27,25,新光-高雄,2024-01-26,8562
00675L,富邦臺灣加權正2,32,10,22,新光-高雄,2024-01-26,8562
2344,華邦電,31,9,22,新光-高雄,2024-01-26,8562
3576,聯合再生,23,2,21,新光-高雄,2024-01-26,8562
0061,元大寶滬深,20,0,20,新光-高雄,2024-01-26,8562
00719B,元大美債1-3,20,0,20,新光-高雄,2024-01-26,8562
2867,三商壽,27,8,19,新光-高雄,2024-01-26,8562
3623,富晶通,96,78,18,新光-高雄,2024-01-26,8562
00900,富邦特選高股息30,17,0,17,新光-高雄,2024-01-26,8562
2357,華碩,17,0,17,新光-高雄,2024-01-26,8562
2317,鴻海,43,25,18,新光-高雄,2024-01-26,8562
2543,皇昌,24,7,17,新光-高雄,2024-01-26,8562
2363,矽統,22,5,17,新光-高雄,2024-01-26,8562
00922,國泰台灣領袖50,16,0,16,新光-高雄,2024-01-26,8562
00930,永豐ESG低碳高息,16,0,16,新光-高雄,2024-01-26,8562
6235,華孚,31,15,16,新光-高雄,2024-01-26,8562
6198,瑞築,15,0,15,新光-高雄,2024-01-26,8562
3052,夆典,15,0,15,新光-高雄,2024-01-26,8562
00651R,復華香港反1,15,0,15,新光-高雄,2024-01-26,8562
3346,麗清,15,0,15,新光-高雄,2024-01-26,8562
4162,智擎,22,8,14,新光-高雄,2024-01-26,8562
3686,達能,14,0,14,新光-高雄,2024-01-26,8562
3049,精金,20,6,14,新光-高雄,2024-01-26,8562
2888,新光金,22,8,14,新光-高雄,2024-01-26,8562
00923,群益台ESG低碳50,18,5,13,新光-高雄,2024-01-26,8562
2417,圓剛,21,8,13,新光-高雄,2024-01-26,8562
00673R,期元大S＆P原油反1,508,85,423,新光-高雄,2024-01-29,8562
6282,康舒,307,14,293,新光-高雄,2024-01-29,8562
00937B,群益ESG投等債20,268,0,268,新光-高雄,2024-01-29,8562
00632R,元大台灣50反1,470,290,180,新光-高雄,2024-01-29,8562
00680L,元大美債20正2,214,38,176,新光-高雄,2024-01-29,8562
00687B,國泰20年美債,126,4,122,新光-高雄,2024-01-29,8562
00720B,元大投資級公司債,131,12,119,新光-高雄,2024-01-29,8562
2867,三商壽,104,2,102,新光-高雄,2024-01-29,8562
00706L,期元大S＆P日圓正2,81,0,81,新光-高雄,2024-01-29,8562
00679B,元大美債20年,77,6,71,新光-高雄,2024-01-29,8562
00688L,國泰20年美債正2,67,0,67,新光-高雄,2024-01-29,8562
2618,長榮航,184,117,67,新光-高雄,2024-01-29,8562
1718,中纖,66,0,66,新光-高雄,2024-01-29,8562
4414,如興,62,0,62,新光-高雄,2024-01-29,8562
2409,友達,75,18,57,新光-高雄,2024-01-29,8562
9105,泰金寶-DR,92,38,54,新光-高雄,2024-01-29,8562
1313,聯成,72,19,53,新光-高雄,2024-01-29,8562
2374,佳能,55,4,51,新光-高雄,2024-01-29,8562
2356,英業達,135,86,49,新光-高雄,2024-01-29,8562
00933B,國泰10Y+金融債,36,0,36,新光-高雄,2024-01-29,8562
2812,台中銀,44,8,36,新光-高雄,2024-01-29,8562
00676R,富邦臺灣加權反1,26,0,26,新光-高雄,2024-01-29,8562
00637L,元大滬深300正2,211,185,26,新光-高雄,2024-01-29,8562
00877,復華中國5G,26,0,26,新光-高雄,2024-01-29,8562
00751B,元大AAA至A公司債,24,0,24,新光-高雄,2024-01-29,8562
8936,國統,46,22,24,新光-高雄,2024-01-29,8562
3535,晶彩科,87,64,23,新光-高雄,2024-01-29,8562
1316,上曜,27,4,23,新光-高雄,2024-01-29,8562
00712,復華富時不動產,25,3,22,新光-高雄,2024-01-29,8562
00764B,群益25年美債,22,0,22,新光-高雄,2024-01-29,8562
3504,揚明光,22,0,22,新光-高雄,2024-01-29,8562
6116,彩晶,21,0,21,新光-高雄,2024-01-29,8562
3615,安可,38,18,20,新光-高雄,2024-01-29,8562
00795B,中信美國公債20年,19,0,19,新光-高雄,2024-01-29,8562
6237,驊訊,26,7,19,新光-高雄,2024-01-29,8562
2431,聯昌,20,1,19,新光-高雄,2024-01-29,8562
2344,華邦電,90,72,18,新光-高雄,2024-01-29,8562
2882,國泰金,20,2,18,新光-高雄,2024-01-29,8562
1805,寶徠,18,0,18,新光-高雄,2024-01-29,8562
2405,輔信,20,2,18,新光-高雄,2024-01-29,8562
2884,玉山金,18,1,17,新光-高雄,2024-01-29,8562
6446,藥華藥,16,0,16,新光-高雄,2024-01-29,8562
5426,振發,195,179,16,新光-高雄,2024-01-29,8562
3059,華晶科,40,24,16,新光-高雄,2024-01-29,8562
3296,勝德,15,0,15,新光-高雄,2024-01-29,8562
4968,立積,40,25,15,新光-高雄,2024-01-29,8562
00893,國泰智能電動車,14,0,14,新光-高雄,2024-01-29,8562
2352,佳世達,38,24,14,新光-高雄,2024-01-29,8562
2609,陽明,45,33,12,新光-高雄,2024-01-29,8562
4588,玖鼎電力,24,12,12,新光-高雄,2024-01-29,8562
00937B,群益ESG投等債20,445,16,429,新光-高雄,2024-01-30,8562
00637L,元大滬深300正2,428,57,371,新光-高雄,2024-01-30,8562
00632R,元大台灣50反1,397,45,352,新光-高雄,2024-01-30,8562
2618,長榮航,547,227,320,新光-高雄,2024-01-30,8562
2610,華航,278,22,256,新光-高雄,2024-01-30,8562
00715L,期街口布蘭特正2,266,69,197,新光-高雄,2024-01-30,8562
00687B,國泰20年美債,163,62,101,新光-高雄,2024-01-30,8562
00882,中信中國高股息,103,19,84,新光-高雄,2024-01-30,8562
3481,群創,146,72,74,新光-高雄,2024-01-30,8562
00665L,富邦�琤肭磪囓�2,376,305,71,新光-高雄,2024-01-30,8562
2867,三商壽,79,10,69,新光-高雄,2024-01-30,8562
3230,錦明,59,0,59,新光-高雄,2024-01-30,8562
1560,中砂,68,9,59,新光-高雄,2024-01-30,8562
4303,信立,61,3,58,新光-高雄,2024-01-30,8562
2002,中鋼,62,12,50,新光-高雄,2024-01-30,8562
00706L,期元大S＆P日圓正2,57,10,47,新光-高雄,2024-01-30,8562
00907,永豐優息存股,47,0,47,新光-高雄,2024-01-30,8562
00751B,元大AAA至A公司債,46,0,46,新光-高雄,2024-01-30,8562
2882,國泰金,47,1,46,新光-高雄,2024-01-30,8562
00633L,富邦上証正2,56,14,42,新光-高雄,2024-01-30,8562
2887,台新金,41,0,41,新光-高雄,2024-01-30,8562
4908,前鼎,149,108,41,新光-高雄,2024-01-30,8562
2431,聯昌,41,1,40,新光-高雄,2024-01-30,8562
2812,台中銀,56,18,38,新光-高雄,2024-01-30,8562
00764B,群益25年美債,38,0,38,新光-高雄,2024-01-30,8562
00669R,國泰美國道瓊反1,41,3,38,新光-高雄,2024-01-30,8562
2609,陽明,40,5,35,新光-高雄,2024-01-30,8562
2883,凱基金,55,21,34,新光-高雄,2024-01-30,8562
00719B,元大美債1-3,32,0,32,新光-高雄,2024-01-30,8562
00671R,富邦NASDAQ反1,91,60,31,新光-高雄,2024-01-30,8562
3710,連展投控,30,0,30,新光-高雄,2024-01-30,8562
1101,台泥,30,3,27,新光-高雄,2024-01-30,8562
00679B,元大美債20年,82,56,26,新光-高雄,2024-01-30,8562
8085,福華,27,1,26,新光-高雄,2024-01-30,8562
2884,玉山金,25,0,25,新光-高雄,2024-01-30,8562
00931B,統一美債20年,75,50,25,新光-高雄,2024-01-30,8562
2025,千興,24,0,24,新光-高雄,2024-01-30,8562
5516,雙喜,21,0,21,新光-高雄,2024-01-30,8562
1907,永豐餘,21,0,21,新光-高雄,2024-01-30,8562
3694,海華,36,16,20,新光-高雄,2024-01-30,8562
2888,新光金,22,2,20,新光-高雄,2024-01-30,8562
6770,力積電,20,0,20,新光-高雄,2024-01-30,8562
6451,訊芯-KY,28,8,20,新光-高雄,2024-01-30,8562
2374,佳能,22,2,20,新光-高雄,2024-01-30,8562
2467,志聖,35,16,19,新光-高雄,2024-01-30,8562
4532,瑞智,20,2,18,新光-高雄,2024-01-30,8562
2886,兆豐金,18,0,18,新光-高雄,2024-01-30,8562
00725B,國泰投資級公司債,22,5,17,新光-高雄,2024-01-30,8562
1605,華新,18,1,17,新光-高雄,2024-01-30,8562
9921,巨大,26,9,17,新光-高雄,2024-01-30,8562
00680L,元大美債20正2,1730,112,1618,新光-高雄,2024-01-31,8562
00929,復華台灣科技優息,692,62,630,新光-高雄,2024-01-31,8562
00937B,群益ESG投等債20,387,27,360,新光-高雄,2024-01-31,8562
00688L,國泰20年美債正2,258,9,249,新光-高雄,2024-01-31,8562
2884,玉山金,203,0,203,新光-高雄,2024-01-31,8562
2313,華通,216,75,141,新光-高雄,2024-01-31,8562
00687B,國泰20年美債,212,109,103,新光-高雄,2024-01-31,8562
2867,三商壽,78,1,77,新光-高雄,2024-01-31,8562
00882,中信中國高股息,87,15,72,新光-高雄,2024-01-31,8562
4714,永捷,62,2,60,新光-高雄,2024-01-31,8562
3231,緯創,126,73,53,新光-高雄,2024-01-31,8562
00877,復華中國5G,82,30,52,新光-高雄,2024-01-31,8562
3710,連展投控,50,0,50,新光-高雄,2024-01-31,8562
00679B,元大美債20年,138,89,49,新光-高雄,2024-01-31,8562
00751B,元大AAA至A公司債,50,2,48,新光-高雄,2024-01-31,8562
00885,富邦越南,50,4,46,新光-高雄,2024-01-31,8562
00764B,群益25年美債,46,0,46,新光-高雄,2024-01-31,8562
2610,華航,62,19,43,新光-高雄,2024-01-31,8562
2356,英業達,103,61,42,新光-高雄,2024-01-31,8562
1605,華新,52,10,42,新光-高雄,2024-01-31,8562
00918,大華優利高填息30,42,0,42,新光-高雄,2024-01-31,8562
00637L,元大滬深300正2,123,85,38,新光-高雄,2024-01-31,8562
2609,陽明,101,63,38,新光-高雄,2024-01-31,8562
00919,群益台灣精選高息,189,153,36,新光-高雄,2024-01-31,8562
8040,九暘,43,8,35,新光-高雄,2024-01-31,8562
2812,台中銀,80,48,32,新光-高雄,2024-01-31,8562
2303,聯電,43,12,31,新光-高雄,2024-01-31,8562
00931B,統一美債20年,74,43,31,新光-高雄,2024-01-31,8562
2888,新光金,30,0,30,新光-高雄,2024-01-31,8562
2431,聯昌,30,0,30,新光-高雄,2024-01-31,8562
1717,長興,30,0,30,新光-高雄,2024-01-31,8562
6684,安格,68,40,28,新光-高雄,2024-01-31,8562
6667,信紘科,42,14,28,新光-高雄,2024-01-31,8562
00650L,復華香港正2,28,0,28,新光-高雄,2024-01-31,8562
2883,凱基金,36,8,28,新光-高雄,2024-01-31,8562
2344,華邦電,73,47,26,新光-高雄,2024-01-31,8562
2886,兆豐金,39,14,25,新光-高雄,2024-01-31,8562
3712,永崴投控,30,7,23,新光-高雄,2024-01-31,8562
6113,亞矽,102,80,22,新光-高雄,2024-01-31,8562
6120,達運,34,13,21,新光-高雄,2024-01-31,8562
5009,榮剛,23,3,20,新光-高雄,2024-01-31,8562
2025,千興,20,0,20,新光-高雄,2024-01-31,8562
8905,裕國,20,0,20,新光-高雄,2024-01-31,8562
3037,欣興,32,12,20,新光-高雄,2024-01-31,8562
00669R,國泰美國道瓊反1,18,0,18,新光-高雄,2024-01-31,8562
1309,台達化,32,14,18,新光-高雄,2024-01-31,8562
8089,康全電訊,36,18,18,新光-高雄,2024-01-31,8562
2801,彰銀,20,2,18,新光-高雄,2024-01-31,8562
8096,擎亞,108,91,17,新光-高雄,2024-01-31,8562
3033,威健,19,2,17,新光-高雄,2024-01-31,8562
00878,國泰永續高股息,2652,55,2597,新光-高雄,2024-02-01,8562
00680L,元大美債20正2,1692,380,1312,新光-高雄,2024-02-01,8562
00937B,群益ESG投等債20,248,36,212,新光-高雄,2024-02-01,8562
00712,復華富時不動產,246,61,185,新光-高雄,2024-02-01,8562
2812,台中銀,371,192,179,新光-高雄,2024-02-01,8562
00715L,期街口布蘭特正2,141,20,121,新光-高雄,2024-02-01,8562
2409,友達,164,61,103,新光-高雄,2024-02-01,8562
2313,華通,111,11,100,新光-高雄,2024-02-01,8562
8110,華東,85,1,84,新光-高雄,2024-02-01,8562
2472,立隆電,70,0,70,新光-高雄,2024-02-01,8562
2641,正德,61,1,60,新光-高雄,2024-02-01,8562
6695,芯鼎,190,139,51,新光-高雄,2024-02-01,8562
00673R,期元大S＆P原油反1,50,0,50,新光-高雄,2024-02-01,8562
00882,中信中國高股息,69,20,49,新光-高雄,2024-02-01,8562
00751B,元大AAA至A公司債,83,38,45,新光-高雄,2024-02-01,8562
00687B,國泰20年美債,75,31,44,新光-高雄,2024-02-01,8562
00706L,期元大S＆P日圓正2,39,0,39,新光-高雄,2024-02-01,8562
2845,遠東銀,38,0,38,新光-高雄,2024-02-01,8562
00900,富邦特選高股息30,34,0,34,新光-高雄,2024-02-01,8562
2634,漢翔,31,1,30,新光-高雄,2024-02-01,8562
2023,燁輝,40,10,30,新光-高雄,2024-02-01,8562
8096,擎亞,56,28,28,新光-高雄,2024-02-01,8562
1609,大亞,32,4,28,新光-高雄,2024-02-01,8562
00688L,國泰20年美債正2,60,32,28,新光-高雄,2024-02-01,8562
1301,台塑,41,14,27,新光-高雄,2024-02-01,8562
3231,緯創,112,85,27,新光-高雄,2024-02-01,8562
8011,台通,29,4,25,新光-高雄,2024-02-01,8562
3711,日月光投控,34,10,24,新光-高雄,2024-02-01,8562
3264,欣銓,29,6,23,新光-高雄,2024-02-01,8562
3376,新日興,104,81,23,新光-高雄,2024-02-01,8562
2303,聯電,47,24,23,新光-高雄,2024-02-01,8562
3287,廣寰科,68,46,22,新光-高雄,2024-02-01,8562
00927,群益半導體收益,22,0,22,新光-高雄,2024-02-01,8562
8936,國統,188,166,22,新光-高雄,2024-02-01,8562
9136,巨騰-DR,20,0,20,新光-高雄,2024-02-01,8562
00752,中信中國50,18,0,18,新光-高雄,2024-02-01,8562
5381,合正,18,0,18,新光-高雄,2024-02-01,8562
4906,正文,91,74,17,新光-高雄,2024-02-01,8562
2241,艾姆勒,17,2,15,新光-高雄,2024-02-01,8562
6139,亞翔,21,6,15,新光-高雄,2024-02-01,8562
6113,亞矽,46,32,14,新光-高雄,2024-02-01,8562
3706,神達,17,3,14,新光-高雄,2024-02-01,8562
2025,千興,15,1,14,新光-高雄,2024-02-01,8562
6530,創威,57,43,14,新光-高雄,2024-02-01,8562
5516,雙喜,15,1,14,新光-高雄,2024-02-01,8562
5871,中租-KY,14,0,14,新光-高雄,2024-02-01,8562
2884,玉山金,14,1,13,新光-高雄,2024-02-01,8562
4953,緯軟,14,1,13,新光-高雄,2024-02-01,8562
1432,大魯閣,15,2,13,新光-高雄,2024-02-01,8562
6219,富旺,13,0,13,新光-高雄,2024-02-01,8562
00712,復華富時不動產,686,141,545,新光-高雄,2024-02-02,8562
00637L,元大滬深300正2,261,55,206,新光-高雄,2024-02-02,8562
00720B,元大投資級公司債,207,2,205,新光-高雄,2024-02-02,8562
00919,群益台灣精選高息,250,47,203,新光-高雄,2024-02-02,8562
00715L,期街口布蘭特正2,271,77,194,新光-高雄,2024-02-02,8562
2337,旺宏,181,1,180,新光-高雄,2024-02-02,8562
00933B,國泰10Y+金融債,248,85,163,新光-高雄,2024-02-02,8562
2883,凱基金,103,1,102,新光-高雄,2024-02-02,8562
2511,太子,100,0,100,新光-高雄,2024-02-02,8562
2353,宏��,125,32,93,新光-高雄,2024-02-02,8562
2303,聯電,94,8,86,新光-高雄,2024-02-02,8562
2812,台中銀,120,52,68,新光-高雄,2024-02-02,8562
00885,富邦越南,75,16,59,新光-高雄,2024-02-02,8562
2603,長榮,86,27,59,新光-高雄,2024-02-02,8562
00688L,國泰20年美債正2,118,60,58,新光-高雄,2024-02-02,8562
6265,方土昶,107,54,53,新光-高雄,2024-02-02,8562
1609,大亞,51,4,47,新光-高雄,2024-02-02,8562
00900,富邦特選高股息30,44,0,44,新光-高雄,2024-02-02,8562
2867,三商壽,47,7,40,新光-高雄,2024-02-02,8562
2363,矽統,43,5,38,新光-高雄,2024-02-02,8562
2317,鴻海,42,6,36,新光-高雄,2024-02-02,8562
6120,達運,36,5,31,新光-高雄,2024-02-02,8562
2609,陽明,65,34,31,新光-高雄,2024-02-02,8562
2323,中環,30,0,30,新光-高雄,2024-02-02,8562
5469,瀚宇博,33,4,29,新光-高雄,2024-02-02,8562
6592,和潤企業,28,0,28,新光-高雄,2024-02-02,8562
2641,正德,29,2,27,新光-高雄,2024-02-02,8562
00687B,國泰20年美債,91,65,26,新光-高雄,2024-02-02,8562
00642U,期元大S＆P石油,25,0,25,新光-高雄,2024-02-02,8562
2606,裕民,25,1,24,新光-高雄,2024-02-02,8562
00795B,中信美國公債20年,25,1,24,新光-高雄,2024-02-02,8562
6533,晶心科,32,9,23,新光-高雄,2024-02-02,8562
4909,新復興,27,4,23,新光-高雄,2024-02-02,8562
6605,帝寶,23,0,23,新光-高雄,2024-02-02,8562
00877,復華中國5G,96,74,22,新光-高雄,2024-02-02,8562
00882,中信中國高股息,57,35,22,新光-高雄,2024-02-02,8562
6770,力積電,23,2,21,新光-高雄,2024-02-02,8562
3050,鈺德,80,59,21,新光-高雄,2024-02-02,8562
3038,全台,21,1,20,新光-高雄,2024-02-02,8562
5258,虹堡,31,11,20,新光-高雄,2024-02-02,8562
4960,誠美材,22,2,20,新光-高雄,2024-02-02,8562
6130,上亞科技,21,1,20,新光-高雄,2024-02-02,8562
3363,上詮,59,40,19,新光-高雄,2024-02-02,8562
2882,國泰金,19,0,19,新光-高雄,2024-02-02,8562
5512,力麒,20,2,18,新光-高雄,2024-02-02,8562
1514,亞力,53,36,17,新光-高雄,2024-02-02,8562
3029,零壹,32,14,18,新光-高雄,2024-02-02,8562
2312,金寶,17,0,17,新光-高雄,2024-02-02,8562
8059,凱碩,20,3,17,新光-高雄,2024-02-02,8562
8936,國統,50,33,17,新光-高雄,2024-02-02,8562
00680L,元大美債20正2,1062,146,916,新光-高雄,2024-02-05,8562
00753L,中信中國50正2,1626,834,792,新光-高雄,2024-02-05,8562
2344,華邦電,574,11,563,新光-高雄,2024-02-05,8562
00712,復華富時不動產,323,41,282,新光-高雄,2024-02-05,8562
00715L,期街口布蘭特正2,356,75,281,新光-高雄,2024-02-05,8562
00929,復華台灣科技優息,559,293,266,新光-高雄,2024-02-05,8562
00688L,國泰20年美債正2,326,70,256,新光-高雄,2024-02-05,8562
00665L,富邦�琤肭磪囓�2,271,25,246,新光-高雄,2024-02-05,8562
00679B,元大美債20年,248,27,221,新光-高雄,2024-02-05,8562
00751B,元大AAA至A公司債,219,2,217,新光-高雄,2024-02-05,8562
2337,旺宏,181,2,179,新光-高雄,2024-02-05,8562
00878,國泰永續高股息,203,65,138,新光-高雄,2024-02-05,8562
00933B,國泰10Y+金融債,128,5,123,新光-高雄,2024-02-05,8562
2884,玉山金,108,6,102,新光-高雄,2024-02-05,8562
00937B,群益ESG投等債20,220,120,100,新光-高雄,2024-02-05,8562
00733,富邦臺灣中小,98,1,97,新光-高雄,2024-02-05,8562
00687B,國泰20年美債,220,134,86,新光-高雄,2024-02-05,8562
00919,群益台灣精選高息,569,502,67,新光-高雄,2024-02-05,8562
2303,聯電,65,10,55,新光-高雄,2024-02-05,8562
00795B,中信美國公債20年,52,3,49,新光-高雄,2024-02-05,8562
00885,富邦越南,71,23,48,新光-高雄,2024-02-05,8562
2369,菱生,78,31,47,新光-高雄,2024-02-05,8562
00882,中信中國高股息,85,39,46,新光-高雄,2024-02-05,8562
2421,建準,251,205,46,新光-高雄,2024-02-05,8562
00720B,元大投資級公司債,42,0,42,新光-高雄,2024-02-05,8562
2002,中鋼,43,1,42,新光-高雄,2024-02-05,8562
1608,華榮,40,0,40,新光-高雄,2024-02-05,8562
3231,緯創,219,180,39,新光-高雄,2024-02-05,8562
2812,台中銀,47,11,36,新光-高雄,2024-02-05,8562
5522,遠雄,35,0,35,新光-高雄,2024-02-05,8562
2023,燁輝,35,0,35,新光-高雄,2024-02-05,8562
00877,復華中國5G,90,57,33,新光-高雄,2024-02-05,8562
00642U,期元大S＆P石油,32,0,32,新光-高雄,2024-02-05,8562
00915,凱基優選高股息30,32,0,32,新光-高雄,2024-02-05,8562
1316,上曜,34,4,30,新光-高雄,2024-02-05,8562
3709,鑫聯大投控,30,0,30,新光-高雄,2024-02-05,8562
3481,群創,64,36,28,新光-高雄,2024-02-05,8562
00907,永豐優息存股,27,0,27,新光-高雄,2024-02-05,8562
00772B,中信高評級公司債,34,7,27,新光-高雄,2024-02-05,8562
2641,正德,27,0,27,新光-高雄,2024-02-05,8562
00931B,統一美債20年,66,40,26,新光-高雄,2024-02-05,8562
2365,昆盈,174,148,26,新光-高雄,2024-02-05,8562
00752,中信中國50,27,1,26,新光-高雄,2024-02-05,8562
6126,信音,25,0,25,新光-高雄,2024-02-05,8562
2886,兆豐金,25,0,25,新光-高雄,2024-02-05,8562
3380,明泰,38,14,24,新光-高雄,2024-02-05,8562
4906,正文,27,4,23,新光-高雄,2024-02-05,8562
3664,安瑞-KY,21,0,21,新光-高雄,2024-02-05,8562
3297,杭特,28,7,21,新光-高雄,2024-02-05,8562
2887,台新金,23,2,21,新光-高雄,2024-02-05,8562
00937B,群益ESG投等債20,972,24,948,新光-高雄,2024-02-15,8562
00882,中信中國高股息,528,77,451,新光-高雄,2024-02-15,8562
2897,王道銀行,481,43,438,新光-高雄,2024-02-15,8562
00687B,國泰20年美債,423,16,407,新光-高雄,2024-02-15,8562
00673R,期元大S＆P原油反1,349,4,345,新光-高雄,2024-02-15,8562
00680L,元大美債20正2,1082,767,315,新光-高雄,2024-02-15,8562
00712,復華富時不動產,336,76,260,新光-高雄,2024-02-15,8562
00688L,國泰20年美債正2,279,22,257,新光-高雄,2024-02-15,8562
2882,國泰金,244,8,236,新光-高雄,2024-02-15,8562
00857B,永豐20年美公債,231,0,231,新光-高雄,2024-02-15,8562
2886,兆豐金,203,13,190,新光-高雄,2024-02-15,8562
2337,旺宏,186,0,186,新光-高雄,2024-02-15,8562
00923,群益台ESG低碳50,181,12,169,新光-高雄,2024-02-15,8562
00679B,元大美債20年,195,32,163,新光-高雄,2024-02-15,8562
00931B,統一美債20年,199,40,159,新光-高雄,2024-02-15,8562
00933B,國泰10Y+金融債,185,35,150,新光-高雄,2024-02-15,8562
4720,德淵,136,7,129,新光-高雄,2024-02-15,8562
00919,群益台灣精選高息,189,66,123,新光-高雄,2024-02-15,8562
2405,輔信,133,19,114,新光-高雄,2024-02-15,8562
1210,大成,104,0,104,新光-高雄,2024-02-15,8562
00751B,元大AAA至A公司債,136,34,102,新光-高雄,2024-02-15,8562
8070,長華*,103,3,100,新光-高雄,2024-02-15,8562
00929,復華台灣科技優息,281,192,89,新光-高雄,2024-02-15,8562
3045,台灣大,84,0,84,新光-高雄,2024-02-15,8562
2610,華航,131,47,84,新光-高雄,2024-02-15,8562
00795B,中信美國公債20年,89,10,79,新光-高雄,2024-02-15,8562
6024,群益期,75,0,75,新光-高雄,2024-02-15,8562
2344,華邦電,150,88,62,新光-高雄,2024-02-15,8562
3481,群創,207,158,49,新光-高雄,2024-02-15,8562
00720B,元大投資級公司債,63,15,48,新光-高雄,2024-02-15,8562
2353,宏��,64,17,47,新光-高雄,2024-02-15,8562
3105,穩懋,66,20,46,新光-高雄,2024-02-15,8562
2301,光寶科,50,5,45,新光-高雄,2024-02-15,8562
2801,彰銀,44,0,44,新光-高雄,2024-02-15,8562
2365,昆盈,238,194,44,新光-高雄,2024-02-15,8562
2431,聯昌,44,0,44,新光-高雄,2024-02-15,8562
1785,光洋科,55,13,42,新光-高雄,2024-02-15,8562
00772B,中信高評級公司債,42,3,39,新光-高雄,2024-02-15,8562
2889,國票金,36,0,36,新光-高雄,2024-02-15,8562
2633,台灣高鐵,37,3,34,新光-高雄,2024-02-15,8562
8112,至上,37,3,34,新光-高雄,2024-02-15,8562
3036,文曄,61,28,33,新光-高雄,2024-02-15,8562
00936,台新永續高息中小,56,25,31,新光-高雄,2024-02-15,8562
9904,寶成,34,3,31,新光-高雄,2024-02-15,8562
2002,中鋼,33,3,30,新光-高雄,2024-02-15,8562
00645,富邦日本,30,0,30,新光-高雄,2024-02-15,8562
1101,台泥,30,2,28,新光-高雄,2024-02-15,8562
3548,兆利,72,45,27,新光-高雄,2024-02-15,8562
00713,元大台灣高息低波,64,37,27,新光-高雄,2024-02-15,8562
2345,智邦,35,10,25,新光-高雄,2024-02-15,8562
00687B,國泰20年美債,463,30,433,新光-高雄,2024-02-16,8562
00673R,期元大S＆P原油反1,272,0,272,新光-高雄,2024-02-16,8562
1785,光洋科,265,42,223,新光-高雄,2024-02-16,8562
2906,高林,239,24,215,新光-高雄,2024-02-16,8562
00937B,群益ESG投等債20,413,208,205,新光-高雄,2024-02-16,8562
00933B,國泰10Y+金融債,190,1,189,新光-高雄,2024-02-16,8562
00923,群益台ESG低碳50,173,23,150,新光-高雄,2024-02-16,8562
00688L,國泰20年美債正2,305,158,147,新光-高雄,2024-02-16,8562
2845,遠東銀,127,0,127,新光-高雄,2024-02-16,8562
00931B,統一美債20年,117,2,115,新光-高雄,2024-02-16,8562
00680L,元大美債20正2,432,322,110,新光-高雄,2024-02-16,8562
00857B,永豐20年美公債,106,0,106,新光-高雄,2024-02-16,8562
00706L,期元大S＆P日圓正2,106,0,106,新光-高雄,2024-02-16,8562
00795B,中信美國公債20年,118,20,98,新光-高雄,2024-02-16,8562
8358,金居,108,27,81,新光-高雄,2024-02-16,8562
2409,友達,82,3,79,新光-高雄,2024-02-16,8562
2888,新光金,77,13,64,新光-高雄,2024-02-16,8562
3002,歐格,64,2,62,新光-高雄,2024-02-16,8562
2382,廣達,103,42,61,新光-高雄,2024-02-16,8562
2337,旺宏,56,0,56,新光-高雄,2024-02-16,8562
00864B,中信美國公債0-1,56,1,55,新光-高雄,2024-02-16,8562
1815,富喬,236,182,54,新光-高雄,2024-02-16,8562
1522,堤維西,69,18,51,新光-高雄,2024-02-16,8562
2464,盟立,43,0,43,新光-高雄,2024-02-16,8562
2303,聯電,44,6,38,新光-高雄,2024-02-16,8562
8011,台通,42,6,36,新光-高雄,2024-02-16,8562
00632R,元大台灣50反1,75,40,35,新光-高雄,2024-02-16,8562
2421,建準,64,30,34,新光-高雄,2024-02-16,8562
3535,晶彩科,52,18,34,新光-高雄,2024-02-16,8562
2367,燿華,161,127,34,新光-高雄,2024-02-16,8562
00679B,元大美債20年,79,45,34,新光-高雄,2024-02-16,8562
2442,新美齊,38,5,33,新光-高雄,2024-02-16,8562
2002,中鋼,42,9,33,新光-高雄,2024-02-16,8562
3264,欣銓,32,2,30,新光-高雄,2024-02-16,8562
00719B,元大美債1-3,30,0,30,新光-高雄,2024-02-16,8562
2486,一詮,57,27,30,新光-高雄,2024-02-16,8562
00761B,國泰A級公司債,29,0,29,新光-高雄,2024-02-16,8562
00697B,元大美債7-10,29,0,29,新光-高雄,2024-02-16,8562
2537,聯上發,29,1,28,新光-高雄,2024-02-16,8562
3268,海德威,29,1,28,新光-高雄,2024-02-16,8562
8926,台汽電,57,30,27,新光-高雄,2024-02-16,8562
2506,太設,27,0,27,新光-高雄,2024-02-16,8562
8088,品安,25,1,24,新光-高雄,2024-02-16,8562
6234,高僑,24,1,23,新光-高雄,2024-02-16,8562
00764B,群益25年美債,21,0,21,新光-高雄,2024-02-16,8562
3035,智原,44,23,21,新光-高雄,2024-02-16,8562
00725B,國泰投資級公司債,21,0,21,新光-高雄,2024-02-16,8562
2330,台積電,28,8,20,新光-高雄,2024-02-16,8562
1589,永冠-KY,20,0,20,新光-高雄,2024-02-16,8562
1907,永豐餘,22,2,20,新光-高雄,2024-02-16,8562
00878,國泰永續高股息,2833,45,2788,新光-高雄,2024-02-19,8562
00933B,國泰10Y+金融債,714,2,712,新光-高雄,2024-02-19,8562
00937B,群益ESG投等債20,644,311,333,新光-高雄,2024-02-19,8562
2618,長榮航,551,274,277,新光-高雄,2024-02-19,8562
2897,王道銀行,288,15,273,新光-高雄,2024-02-19,8562
00688L,國泰20年美債正2,247,55,192,新光-高雄,2024-02-19,8562
00712,復華富時不動產,145,5,140,新光-高雄,2024-02-19,8562
00679B,元大美債20年,159,24,135,新光-高雄,2024-02-19,8562
8064,東捷,171,43,128,新光-高雄,2024-02-19,8562
00673R,期元大S＆P原油反1,112,0,112,新光-高雄,2024-02-19,8562
00687B,國泰20年美債,138,27,111,新光-高雄,2024-02-19,8562
1309,台達化,110,3,107,新光-高雄,2024-02-19,8562
00751B,元大AAA至A公司債,115,8,107,新光-高雄,2024-02-19,8562
2353,宏��,177,72,105,新光-高雄,2024-02-19,8562
5258,虹堡,104,14,90,新光-高雄,2024-02-19,8562
3706,神達,102,16,86,新光-高雄,2024-02-19,8562
2399,映泰,80,3,77,新光-高雄,2024-02-19,8562
00919,群益台灣精選高息,131,59,72,新光-高雄,2024-02-19,8562
00733,富邦臺灣中小,62,1,61,新光-高雄,2024-02-19,8562
3260,威剛,74,14,60,新光-高雄,2024-02-19,8562
3338,泰碩,57,5,52,新光-高雄,2024-02-19,8562
6546,正基,56,10,46,新光-高雄,2024-02-19,8562
1301,台塑,87,42,45,新光-高雄,2024-02-19,8562
2329,華泰,160,116,44,新光-高雄,2024-02-19,8562
3363,上詮,139,96,43,新光-高雄,2024-02-19,8562
00931B,統一美債20年,43,0,43,新光-高雄,2024-02-19,8562
00923,群益台ESG低碳50,56,15,41,新光-高雄,2024-02-19,8562
00764B,群益25年美債,42,1,41,新光-高雄,2024-02-19,8562
3450,聯鈞,86,45,41,新光-高雄,2024-02-19,8562
3437,榮創,125,85,40,新光-高雄,2024-02-19,8562
2103,台橡,45,7,38,新光-高雄,2024-02-19,8562
2882,國泰金,121,84,37,新光-高雄,2024-02-19,8562
3276,宇環,36,0,36,新光-高雄,2024-02-19,8562
2476,鉅祥,49,13,36,新光-高雄,2024-02-19,8562
6274,台燿,79,44,35,新光-高雄,2024-02-19,8562
2489,瑞軒,48,14,34,新光-高雄,2024-02-19,8562
2642,宅配通,33,0,33,新光-高雄,2024-02-19,8562
3322,建舜電,43,10,33,新光-高雄,2024-02-19,8562
6170,統振,47,14,33,新光-高雄,2024-02-19,8562
6605,帝寶,33,1,32,新光-高雄,2024-02-19,8562
0061,元大寶滬深,38,6,32,新光-高雄,2024-02-19,8562
00795B,中信美國公債20年,32,1,31,新光-高雄,2024-02-19,8562
2515,中工,100,70,30,新光-高雄,2024-02-19,8562
00857B,永豐20年美公債,29,0,29,新光-高雄,2024-02-19,8562
5469,瀚宇博,34,6,28,新光-高雄,2024-02-19,8562
2610,華航,39,11,28,新光-高雄,2024-02-19,8562
00922,國泰台灣領袖50,35,9,26,新光-高雄,2024-02-19,8562
6130,上亞科技,25,0,25,新光-高雄,2024-02-19,8562
00676R,富邦臺灣加權反1,25,0,25,新光-高雄,2024-02-19,8562
3588,通嘉,59,35,24,新光-高雄,2024-02-19,8562
3481,群創,1170,53,1117,新光-高雄,2024-02-20,8562
00929,復華台灣科技優息,1673,561,1112,新光-高雄,2024-02-20,8562
00632R,元大台灣50反1,459,38,421,新光-高雄,2024-02-20,8562
00937B,群益ESG投等債20,446,27,419,新光-高雄,2024-02-20,8562
2610,華航,403,83,320,新光-高雄,2024-02-20,8562
00673R,期元大S＆P原油反1,251,6,245,新光-高雄,2024-02-20,8562
6235,華孚,186,7,179,新光-高雄,2024-02-20,8562
2897,王道銀行,144,3,141,新光-高雄,2024-02-20,8562
00795B,中信美國公債20年,138,0,138,新光-高雄,2024-02-20,8562
2312,金寶,117,0,117,新光-高雄,2024-02-20,8562
3005,神基,121,42,79,新光-高雄,2024-02-20,8562
00857B,永豐20年美公債,78,0,78,新光-高雄,2024-02-20,8562
2371,大同,84,7,77,新光-高雄,2024-02-20,8562
2492,華新科,78,1,77,新光-高雄,2024-02-20,8562
00931B,統一美債20年,75,1,74,新光-高雄,2024-02-20,8562
2489,瑞軒,105,37,68,新光-高雄,2024-02-20,8562
1785,光洋科,67,2,65,新光-高雄,2024-02-20,8562
00712,復華富時不動產,148,86,62,新光-高雄,2024-02-20,8562
2382,廣達,75,17,58,新光-高雄,2024-02-20,8562
2883,凱基金,81,24,57,新光-高雄,2024-02-20,8562
3231,緯創,122,65,57,新光-高雄,2024-02-20,8562
3041,揚智,308,257,51,新光-高雄,2024-02-20,8562
1416,廣豐,50,0,50,新光-高雄,2024-02-20,8562
00933B,國泰10Y+金融債,83,34,49,新光-高雄,2024-02-20,8562
00733,富邦臺灣中小,46,1,45,新光-高雄,2024-02-20,8562
00687B,國泰20年美債,91,49,42,新光-高雄,2024-02-20,8562
00706L,期元大S＆P日圓正2,41,0,41,新光-高雄,2024-02-20,8562
00679B,元大美債20年,82,44,38,新光-高雄,2024-02-20,8562
3450,聯鈞,79,42,37,新光-高雄,2024-02-20,8562
3706,神達,72,35,37,新光-高雄,2024-02-20,8562
2376,技嘉,69,32,37,新光-高雄,2024-02-20,8562
006205,富邦上証,36,0,36,新光-高雄,2024-02-20,8562
1717,長興,42,7,35,新光-高雄,2024-02-20,8562
3363,上詮,95,61,34,新光-高雄,2024-02-20,8562
2405,輔信,191,158,33,新光-高雄,2024-02-20,8562
8112,至上,75,48,27,新光-高雄,2024-02-20,8562
2353,宏��,73,47,26,新光-高雄,2024-02-20,8562
8435,鉅邁,31,5,26,新光-高雄,2024-02-20,8562
00688L,國泰20年美債正2,78,52,26,新光-高雄,2024-02-20,8562
3189,景碩,27,2,25,新光-高雄,2024-02-20,8562
2363,矽統,36,12,24,新光-高雄,2024-02-20,8562
3038,全台,39,16,23,新光-高雄,2024-02-20,8562
9103,美德醫療-DR,26,3,23,新光-高雄,2024-02-20,8562
6120,達運,27,4,23,新光-高雄,2024-02-20,8562
4953,緯軟,43,21,22,新光-高雄,2024-02-20,8562
1103,嘉泥,22,0,22,新光-高雄,2024-02-20,8562
3264,欣銓,21,0,21,新光-高雄,2024-02-20,8562
2399,映泰,23,2,21,新光-高雄,2024-02-20,8562
5009,榮剛,21,0,21,新光-高雄,2024-02-20,8562
3037,欣興,61,40,21,新光-高雄,2024-02-20,8562
00937B,群益ESG投等債20,602,9,593,新光-高雄,2024-02-21,8562
00878,國泰永續高股息,448,56,392,新光-高雄,2024-02-21,8562
00712,復華富時不動產,255,5,250,新光-高雄,2024-02-21,8562
00891,中信關鍵半導體,251,6,245,新光-高雄,2024-02-21,8562
00933B,國泰10Y+金融債,168,9,159,新光-高雄,2024-02-21,8562
2884,玉山金,270,135,135,新光-高雄,2024-02-21,8562
2609,陽明,197,74,123,新光-高雄,2024-02-21,8562
00706L,期元大S＆P日圓正2,116,0,116,新光-高雄,2024-02-21,8562
00632R,元大台灣50反1,114,0,114,新光-高雄,2024-02-21,8562
6116,彩晶,106,1,105,新光-高雄,2024-02-21,8562
00931B,統一美債20年,91,0,91,新光-高雄,2024-02-21,8562
6134,萬旭,84,1,83,新光-高雄,2024-02-21,8562
2360,致茂,83,4,79,新光-高雄,2024-02-21,8562
2812,台中銀,115,42,73,新光-高雄,2024-02-21,8562
2303,聯電,86,13,73,新光-高雄,2024-02-21,8562
00650L,復華香港正2,117,45,72,新光-高雄,2024-02-21,8562
00687B,國泰20年美債,72,4,68,新光-高雄,2024-02-21,8562
2382,廣達,94,28,66,新光-高雄,2024-02-21,8562
00751B,元大AAA至A公司債,65,0,65,新光-高雄,2024-02-21,8562
6126,信音,94,31,63,新光-高雄,2024-02-21,8562
5608,四維航,79,16,63,新光-高雄,2024-02-21,8562
2801,彰銀,61,0,61,新光-高雄,2024-02-21,8562
00680L,元大美債20正2,66,10,56,新光-高雄,2024-02-21,8562
00679B,元大美債20年,60,7,53,新光-高雄,2024-02-21,8562
3078,僑威,51,0,51,新光-高雄,2024-02-21,8562
8110,華東,78,27,51,新光-高雄,2024-02-21,8562
00857B,永豐20年美公債,49,0,49,新光-高雄,2024-02-21,8562
2883,凱基金,48,4,44,新光-高雄,2024-02-21,8562
2409,友達,80,39,41,新光-高雄,2024-02-21,8562
00795B,中信美國公債20年,42,2,40,新光-高雄,2024-02-21,8562
9902,台火,40,0,40,新光-高雄,2024-02-21,8562
3047,訊舟,114,74,40,新光-高雄,2024-02-21,8562
6282,康舒,78,40,38,新光-高雄,2024-02-21,8562
2025,千興,42,6,36,新光-高雄,2024-02-21,8562
00764B,群益25年美債,34,0,34,新光-高雄,2024-02-21,8562
00715L,期街口布蘭特正2,42,8,34,新光-高雄,2024-02-21,8562
3006,晶豪科,46,14,32,新光-高雄,2024-02-21,8562
6835,圓裕,30,0,30,新光-高雄,2024-02-21,8562
2401,凌陽,49,20,29,新光-高雄,2024-02-21,8562
2258,鴻華先進-創,29,0,29,新光-高雄,2024-02-21,8562
2867,三商壽,30,2,28,新光-高雄,2024-02-21,8562
2101,南港,28,0,28,新光-高雄,2024-02-21,8562
8936,國統,46,18,28,新光-高雄,2024-02-21,8562
3231,緯創,142,115,27,新光-高雄,2024-02-21,8562
2353,宏��,36,11,25,新光-高雄,2024-02-21,8562
00725B,國泰投資級公司債,25,0,25,新光-高雄,2024-02-21,8562
2069,運錩,25,0,25,新光-高雄,2024-02-21,8562
00922,國泰台灣領袖50,26,1,25,新光-高雄,2024-02-21,8562
3712,永崴投控,37,13,24,新光-高雄,2024-02-21,8562
2885,元大金,23,0,23,新光-高雄,2024-02-21,8562
00673R,期元大S＆P原油反1,409,4,405,新光-高雄,2024-02-22,8562
2610,華航,405,10,395,新光-高雄,2024-02-22,8562
00933B,國泰10Y+金融債,259,0,259,新光-高雄,2024-02-22,8562
00937B,群益ESG投等債20,246,4,242,新光-高雄,2024-02-22,8562
00929,復華台灣科技優息,580,355,225,新光-高雄,2024-02-22,8562
00680L,元大美債20正2,217,24,193,新光-高雄,2024-02-22,8562
4720,德淵,184,0,184,新光-高雄,2024-02-22,8562
00632R,元大台灣50反1,147,7,140,新光-高雄,2024-02-22,8562
00878,國泰永續高股息,349,217,132,新光-高雄,2024-02-22,8562
00687B,國泰20年美債,149,43,106,新光-高雄,2024-02-22,8562
9105,泰金寶-DR,212,108,104,新光-高雄,2024-02-22,8562
00688L,國泰20年美債正2,179,82,97,新光-高雄,2024-02-22,8562
6126,信音,175,85,90,新光-高雄,2024-02-22,8562
00931B,統一美債20年,89,0,89,新光-高雄,2024-02-22,8562
1313,聯成,92,5,87,新光-高雄,2024-02-22,8562
00712,復華富時不動產,84,1,83,新光-高雄,2024-02-22,8562
00795B,中信美國公債20年,82,0,82,新光-高雄,2024-02-22,8562
2409,友達,89,10,79,新光-高雄,2024-02-22,8562
2489,瑞軒,248,169,79,新光-高雄,2024-02-22,8562
00857B,永豐20年美公債,78,1,77,新光-高雄,2024-02-22,8562
2371,大同,179,112,67,新光-高雄,2024-02-22,8562
00720B,元大投資級公司債,62,6,56,新光-高雄,2024-02-22,8562
3450,聯鈞,89,35,54,新光-高雄,2024-02-22,8562
2542,興富發,57,3,54,新光-高雄,2024-02-22,8562
00919,群益台灣精選高息,633,581,52,新光-高雄,2024-02-22,8562
1309,台達化,52,2,50,新光-高雄,2024-02-22,8562
3231,緯創,192,144,48,新光-高雄,2024-02-22,8562
2345,智邦,53,6,47,新光-高雄,2024-02-22,8562
8936,國統,116,69,47,新光-高雄,2024-02-22,8562
2329,華泰,309,264,45,新光-高雄,2024-02-22,8562
00679B,元大美債20年,86,43,43,新光-高雄,2024-02-22,8562
2884,玉山金,43,1,42,新光-高雄,2024-02-22,8562
00751B,元大AAA至A公司債,38,0,38,新光-高雄,2024-02-22,8562
6116,彩晶,38,0,38,新光-高雄,2024-02-22,8562
2812,台中銀,57,19,38,新光-高雄,2024-02-22,8562
2101,南港,36,0,36,新光-高雄,2024-02-22,8562
00733,富邦臺灣中小,35,0,35,新光-高雄,2024-02-22,8562
6668,中揚光,62,29,33,新光-高雄,2024-02-22,8562
2801,彰銀,34,4,30,新光-高雄,2024-02-22,8562
00650L,復華香港正2,133,103,30,新光-高雄,2024-02-22,8562
00772B,中信高評級公司債,31,2,29,新光-高雄,2024-02-22,8562
2353,宏��,72,43,29,新光-高雄,2024-02-22,8562
00675L,富邦臺灣加權正2,28,0,28,新光-高雄,2024-02-22,8562
2633,台灣高鐵,36,10,26,新光-高雄,2024-02-22,8562
3025,星通,69,43,26,新光-高雄,2024-02-22,8562
5443,均豪,60,34,26,新光-高雄,2024-02-22,8562
2455,全新,32,6,26,新光-高雄,2024-02-22,8562
00670L,富邦NASDAQ正2,25,0,25,新光-高雄,2024-02-22,8562
1524,耿鼎,63,38,25,新光-高雄,2024-02-22,8562
4977,眾達-KY,27,3,24,新光-高雄,2024-02-22,8562
00919,群益台灣精選高息,1000,285,715,新光-高雄,2024-02-23,8562
00687B,國泰20年美債,311,9,302,新光-高雄,2024-02-23,8562
00632R,元大台灣50反1,361,72,289,新光-高雄,2024-02-23,8562
00882,中信中國高股息,426,180,246,新光-高雄,2024-02-23,8562
00673R,期元大S＆P原油反1,206,40,166,新光-高雄,2024-02-23,8562
00937B,群益ESG投等債20,134,12,122,新光-高雄,2024-02-23,8562
8105,凌巨,120,6,114,新光-高雄,2024-02-23,8562
6005,群益證,112,1,111,新光-高雄,2024-02-23,8562
8040,九暘,137,27,110,新光-高雄,2024-02-23,8562
00712,復華富時不動產,110,7,103,新光-高雄,2024-02-23,8562
3231,緯創,221,120,101,新光-高雄,2024-02-23,8562
00679B,元大美債20年,88,4,84,新光-高雄,2024-02-23,8562
00706L,期元大S＆P日圓正2,88,10,78,新光-高雄,2024-02-23,8562
00907,永豐優息存股,70,0,70,新光-高雄,2024-02-23,8562
1316,上曜,225,156,69,新光-高雄,2024-02-23,8562
2369,菱生,68,3,65,新光-高雄,2024-02-23,8562
2888,新光金,66,3,63,新光-高雄,2024-02-23,8562
00733,富邦臺灣中小,65,3,62,新光-高雄,2024-02-23,8562
00931B,統一美債20年,61,0,61,新光-高雄,2024-02-23,8562
3169,亞信,65,4,61,新光-高雄,2024-02-23,8562
8086,宏捷科,66,7,59,新光-高雄,2024-02-23,8562
8147,正淩,74,16,58,新光-高雄,2024-02-23,8562
3078,僑威,54,0,54,新光-高雄,2024-02-23,8562
2356,英業達,116,63,53,新光-高雄,2024-02-23,8562
2610,華航,67,16,51,新光-高雄,2024-02-23,8562
3059,華晶科,53,2,51,新光-高雄,2024-02-23,8562
2101,南港,50,0,50,新光-高雄,2024-02-23,8562
3481,群創,118,68,50,新光-高雄,2024-02-23,8562
00795B,中信美國公債20年,51,5,46,新光-高雄,2024-02-23,8562
2882,國泰金,44,2,42,新光-高雄,2024-02-23,8562
2329,華泰,326,285,41,新光-高雄,2024-02-23,8562
2812,台中銀,54,13,41,新光-高雄,2024-02-23,8562
2313,華通,278,238,40,新光-高雄,2024-02-23,8562
2618,長榮航,61,22,39,新光-高雄,2024-02-23,8562
2352,佳世達,41,3,38,新光-高雄,2024-02-23,8562
8429,金麗-KY,34,0,34,新光-高雄,2024-02-23,8562
2363,矽統,53,21,32,新光-高雄,2024-02-23,8562
2353,宏��,106,75,31,新光-高雄,2024-02-23,8562
9105,泰金寶-DR,85,55,30,新光-高雄,2024-02-23,8562
2515,中工,38,10,28,新光-高雄,2024-02-23,8562
2464,盟立,35,7,28,新光-高雄,2024-02-23,8562
2836,高雄銀,27,0,27,新光-高雄,2024-02-23,8562
3715,定穎投控,45,18,27,新光-高雄,2024-02-23,8562
1611,中電,26,0,26,新光-高雄,2024-02-23,8562
1904,正隆,27,2,25,新光-高雄,2024-02-23,8562
6213,聯茂,36,12,24,新光-高雄,2024-02-23,8562
6207,雷科,63,39,24,新光-高雄,2024-02-23,8562
4960,誠美材,23,0,23,新光-高雄,2024-02-23,8562
00918,大華優利高填息30,24,2,22,新光-高雄,2024-02-23,8562
1718,中纖,21,0,21,新光-高雄,2024-02-23,8562
00929,復華台灣科技優息,1617,612,1005,新光-高雄,2024-02-26,8562
00878,國泰永續高股息,792,190,602,新光-高雄,2024-02-26,8562
00937B,群益ESG投等債20,505,107,398,新光-高雄,2024-02-26,8562
00715L,期街口布蘭特正2,415,27,388,新光-高雄,2024-02-26,8562
00676R,富邦臺灣加權反1,264,2,262,新光-高雄,2024-02-26,8562
00900,富邦特選高股息30,228,19,209,新光-高雄,2024-02-26,8562
2812,台中銀,283,95,188,新光-高雄,2024-02-26,8562
2801,彰銀,163,0,163,新光-高雄,2024-02-26,8562
00706L,期元大S＆P日圓正2,145,10,135,新光-高雄,2024-02-26,8562
1210,大成,156,24,132,新光-高雄,2024-02-26,8562
1609,大亞,170,41,129,新光-高雄,2024-02-26,8562
9105,泰金寶-DR,181,76,105,新光-高雄,2024-02-26,8562
00712,復華富時不動產,187,84,103,新光-高雄,2024-02-26,8562
2349,錸德,100,0,100,新光-高雄,2024-02-26,8562
9103,美德醫療-DR,90,2,88,新光-高雄,2024-02-26,8562
1504,東元,148,68,80,新光-高雄,2024-02-26,8562
2409,友達,82,8,74,新光-高雄,2024-02-26,8562
3535,晶彩科,70,2,68,新光-高雄,2024-02-26,8562
00756B,群益投等新興公債,67,0,67,新光-高雄,2024-02-26,8562
2460,建通,74,7,67,新光-高雄,2024-02-26,8562
1514,亞力,265,200,65,新光-高雄,2024-02-26,8562
5516,雙喜,70,6,64,新光-高雄,2024-02-26,8562
00632R,元大台灣50反1,166,110,56,新光-高雄,2024-02-26,8562
2609,陽明,66,16,50,新光-高雄,2024-02-26,8562
2884,玉山金,59,13,46,新光-高雄,2024-02-26,8562
00907,永豐優息存股,56,10,46,新光-高雄,2024-02-26,8562
2329,華泰,161,115,46,新光-高雄,2024-02-26,8562
00772B,中信高評級公司債,50,6,44,新光-高雄,2024-02-26,8562
00679B,元大美債20年,93,49,44,新光-高雄,2024-02-26,8562
00637L,元大滬深300正2,170,127,43,新光-高雄,2024-02-26,8562
2355,敬鵬,80,37,43,新光-高雄,2024-02-26,8562
5009,榮剛,44,2,42,新光-高雄,2024-02-26,8562
3706,神達,65,24,41,新光-高雄,2024-02-26,8562
2356,英業達,52,11,41,新光-高雄,2024-02-26,8562
6265,方土昶,51,11,40,新光-高雄,2024-02-26,8562
00650L,復華香港正2,42,3,39,新光-高雄,2024-02-26,8562
00891,中信關鍵半導體,94,59,35,新光-高雄,2024-02-26,8562
8011,台通,37,4,33,新光-高雄,2024-02-26,8562
00687B,國泰20年美債,87,55,32,新光-高雄,2024-02-26,8562
4960,誠美材,39,8,31,新光-高雄,2024-02-26,8562
3312,弘憶股,74,43,31,新光-高雄,2024-02-26,8562
4526,東台,66,36,30,新光-高雄,2024-02-26,8562
2887,台新金,33,3,30,新光-高雄,2024-02-26,8562
00923,群益台ESG低碳50,32,4,28,新光-高雄,2024-02-26,8562
00927,群益半導體收益,33,5,28,新光-高雄,2024-02-26,8562
2369,菱生,42,14,28,新光-高雄,2024-02-26,8562
2303,聯電,44,17,27,新光-高雄,2024-02-26,8562
2208,台船,27,1,26,新光-高雄,2024-02-26,8562
1809,中釉,32,6,26,新光-高雄,2024-02-26,8562
8443,阿瘦,25,0,25,新光-高雄,2024-02-26,8562
00919,群益台灣精選高息,2940,872,2068,新光-高雄,2024-02-27,8562
00632R,元大台灣50反1,1044,150,894,新光-高雄,2024-02-27,8562
00878,國泰永續高股息,857,132,725,新光-高雄,2024-02-27,8562
00937B,群益ESG投等債20,510,10,500,新光-高雄,2024-02-27,8562
00795B,中信美國公債20年,262,1,261,新光-高雄,2024-02-27,8562
00900,富邦特選高股息30,395,160,235,新光-高雄,2024-02-27,8562
00933B,國泰10Y+金融債,233,0,233,新光-高雄,2024-02-27,8562
00673R,期元大S＆P原油反1,251,18,233,新光-高雄,2024-02-27,8562
00931B,統一美債20年,230,4,226,新光-高雄,2024-02-27,8562
00918,大華優利高填息30,190,35,155,新光-高雄,2024-02-27,8562
00637L,元大滬深300正2,229,87,142,新光-高雄,2024-02-27,8562
2897,王道銀行,108,1,107,新光-高雄,2024-02-27,8562
2363,矽統,315,222,93,新光-高雄,2024-02-27,8562
4129,聯合,97,5,92,新光-高雄,2024-02-27,8562
00679B,元大美債20年,104,13,91,新光-高雄,2024-02-27,8562
00712,復華富時不動產,90,3,87,新光-高雄,2024-02-27,8562
2882,國泰金,85,0,85,新光-高雄,2024-02-27,8562
2834,臺企銀,116,35,81,新光-高雄,2024-02-27,8562
2002,中鋼,84,4,80,新光-高雄,2024-02-27,8562
8926,台汽電,98,21,77,新光-高雄,2024-02-27,8562
00888,永豐台灣ESG,75,1,74,新光-高雄,2024-02-27,8562
2887,台新金,80,7,73,新光-高雄,2024-02-27,8562
1316,上曜,212,141,71,新光-高雄,2024-02-27,8562
2409,友達,92,21,71,新光-高雄,2024-02-27,8562
3231,緯創,165,95,70,新光-高雄,2024-02-27,8562
3037,欣興,147,82,65,新光-高雄,2024-02-27,8562
2399,映泰,80,19,61,新光-高雄,2024-02-27,8562
3706,神達,79,24,55,新光-高雄,2024-02-27,8562
00857B,永豐20年美公債,55,0,55,新光-高雄,2024-02-27,8562
00882,中信中國高股息,89,37,52,新光-高雄,2024-02-27,8562
1605,華新,61,10,51,新光-高雄,2024-02-27,8562
2888,新光金,51,0,51,新光-高雄,2024-02-27,8562
8096,擎亞,141,91,50,新光-高雄,2024-02-27,8562
6806,森崴能源,98,49,49,新光-高雄,2024-02-27,8562
2382,廣達,71,25,46,新光-高雄,2024-02-27,8562
2345,智邦,53,10,43,新光-高雄,2024-02-27,8562
2104,國際中橡,41,0,41,新光-高雄,2024-02-27,8562
00680L,元大美債20正2,69,28,41,新光-高雄,2024-02-27,8562
3313,斐成,38,1,37,新光-高雄,2024-02-27,8562
4306,炎洲,36,0,36,新光-高雄,2024-02-27,8562
00720B,元大投資級公司債,37,2,35,新光-高雄,2024-02-27,8562
00733,富邦臺灣中小,64,31,33,新光-高雄,2024-02-27,8562
6113,亞矽,74,44,30,新光-高雄,2024-02-27,8562
1524,耿鼎,98,68,30,新光-高雄,2024-02-27,8562
2431,聯昌,30,0,30,新光-高雄,2024-02-27,8562
6125,廣運,181,151,30,新光-高雄,2024-02-27,8562
00923,群益台ESG低碳50,29,0,29,新光-高雄,2024-02-27,8562
6233,旺玖,128,100,28,新光-高雄,2024-02-27,8562
2344,華邦電,98,70,28,新光-高雄,2024-02-27,8562
6245,立端,30,3,27,新光-高雄,2024-02-27,8562
00937B,群益ESG投等債20,619,11,608,新光-高雄,2024-02-29,8562
00919,群益台灣精選高息,565,161,404,新光-高雄,2024-02-29,8562
2417,圓剛,311,39,272,新光-高雄,2024-02-29,8562
2834,臺企銀,295,72,223,新光-高雄,2024-02-29,8562
00687B,國泰20年美債,242,26,216,新光-高雄,2024-02-29,8562
2369,菱生,232,39,193,新光-高雄,2024-02-29,8562
00673R,期元大S＆P原油反1,188,2,186,新光-高雄,2024-02-29,8562
00680L,元大美債20正2,207,25,182,新光-高雄,2024-02-29,8562
00632R,元大台灣50反1,287,134,153,新光-高雄,2024-02-29,8562
2023,燁輝,126,0,126,新光-高雄,2024-02-29,8562
00712,復華富時不動產,129,20,109,新光-高雄,2024-02-29,8562
9105,泰金寶-DR,258,154,104,新光-高雄,2024-02-29,8562
6126,信音,109,9,100,新光-高雄,2024-02-29,8562
2897,王道銀行,111,16,95,新光-高雄,2024-02-29,8562
00882,中信中國高股息,129,48,81,新光-高雄,2024-02-29,8562
6288,聯嘉,197,119,78,新光-高雄,2024-02-29,8562
6016,康和證,74,14,60,新光-高雄,2024-02-29,8562
00665L,富邦�琤肭磪囓�2,93,37,56,新光-高雄,2024-02-29,8562
2605,新興,58,11,47,新光-高雄,2024-02-29,8562
8930,青鋼,54,7,47,新光-高雄,2024-02-29,8562
1815,富喬,110,64,46,新光-高雄,2024-02-29,8562
2820,華票,55,10,45,新光-高雄,2024-02-29,8562
5488,松普,63,20,43,新光-高雄,2024-02-29,8562
2542,興富發,43,0,43,新光-高雄,2024-02-29,8562
2431,聯昌,56,15,41,新光-高雄,2024-02-29,8562
00931B,統一美債20年,38,0,38,新光-高雄,2024-02-29,8562
2888,新光金,47,10,37,新光-高雄,2024-02-29,8562
2882,國泰金,188,151,37,新光-高雄,2024-02-29,8562
3708,上緯投控,63,27,36,新光-高雄,2024-02-29,8562
3481,群創,72,38,34,新光-高雄,2024-02-29,8562
2801,彰銀,46,12,34,新光-高雄,2024-02-29,8562
00706L,期元大S＆P日圓正2,54,21,33,新光-高雄,2024-02-29,8562
1605,華新,47,15,32,新光-高雄,2024-02-29,8562
6239,力成,45,15,30,新光-高雄,2024-02-29,8562
2353,宏��,50,19,31,新光-高雄,2024-02-29,8562
00923,群益台ESG低碳50,32,2,30,新光-高雄,2024-02-29,8562
2836,高雄銀,30,0,30,新光-高雄,2024-02-29,8562
6024,群益期,31,1,30,新光-高雄,2024-02-29,8562
3689,湧德,57,31,26,新光-高雄,2024-02-29,8562
2889,國票金,25,1,24,新光-高雄,2024-02-29,8562
5534,長虹,25,1,24,新光-高雄,2024-02-29,8562
8064,東捷,42,19,23,新光-高雄,2024-02-29,8562
8110,華東,43,20,23,新光-高雄,2024-02-29,8562
2258,鴻華先進-創,22,0,22,新光-高雄,2024-02-29,8562
2345,智邦,26,4,22,新光-高雄,2024-02-29,8562
2002,中鋼,40,18,22,新光-高雄,2024-02-29,8562
00918,大華優利高填息30,46,25,21,新光-高雄,2024-02-29,8562
00655L,國泰中國A50正2,30,9,21,新光-高雄,2024-02-29,8562
2312,金寶,20,0,20,新光-高雄,2024-02-29,8562
8429,金麗-KY,25,5,20,新光-高雄,2024-02-29,8562
00919,群益台灣精選高息,2090,883,1207,新光-高雄,2024-03-01,8562
00671R,富邦NASDAQ反1,822,5,817,新光-高雄,2024-03-01,8562
00937B,群益ESG投等債20,416,108,308,新光-高雄,2024-03-01,8562
00918,大華優利高填息30,318,50,268,新光-高雄,2024-03-01,8562
00933B,國泰10Y+金融債,223,14,209,新光-高雄,2024-03-01,8562
00931B,統一美債20年,218,12,206,新光-高雄,2024-03-01,8562
00673R,期元大S＆P原油反1,144,0,144,新光-高雄,2024-03-01,8562
2882,國泰金,114,1,113,新光-高雄,2024-03-01,8562
8040,九暘,138,27,111,新光-高雄,2024-03-01,8562
00687B,國泰20年美債,126,16,110,新光-高雄,2024-03-01,8562
00637L,元大滬深300正2,149,53,96,新光-高雄,2024-03-01,8562
00679B,元大美債20年,151,62,89,新光-高雄,2024-03-01,8562
00922,國泰台灣領袖50,90,4,86,新光-高雄,2024-03-01,8562
00706L,期元大S＆P日圓正2,76,0,76,新光-高雄,2024-03-01,8562
2834,臺企銀,95,23,72,新光-高雄,2024-03-01,8562
3481,群創,98,31,67,新光-高雄,2024-03-01,8562
2002,中鋼,76,10,66,新光-高雄,2024-03-01,8562
6116,彩晶,65,0,65,新光-高雄,2024-03-01,8562
1702,南僑,60,0,60,新光-高雄,2024-03-01,8562
00670L,富邦NASDAQ正2,56,0,56,新光-高雄,2024-03-01,8562
2399,映泰,129,75,54,新光-高雄,2024-03-01,8562
00753L,中信中國50正2,65,12,53,新光-高雄,2024-03-01,8562
00680L,元大美債20正2,252,200,52,新光-高雄,2024-03-01,8562
2458,義隆,51,0,51,新光-高雄,2024-03-01,8562
00913,兆豐台灣晶圓製造,59,11,48,新光-高雄,2024-03-01,8562
1301,台塑,47,0,47,新光-高雄,2024-03-01,8562
1309,台達化,45,0,45,新光-高雄,2024-03-01,8562
6770,力積電,60,17,43,新光-高雄,2024-03-01,8562
1718,中纖,51,8,43,新光-高雄,2024-03-01,8562
1605,華新,44,4,40,新光-高雄,2024-03-01,8562
3372,典範,117,77,40,新光-高雄,2024-03-01,8562
4720,德淵,40,0,40,新光-高雄,2024-03-01,8562
6531,愛普*,58,18,40,新光-高雄,2024-03-01,8562
2313,華通,110,72,38,新光-高雄,2024-03-01,8562
2867,三商壽,38,0,38,新光-高雄,2024-03-01,8562
3105,穩懋,51,15,36,新光-高雄,2024-03-01,8562
2409,友達,84,48,36,新光-高雄,2024-03-01,8562
2495,普安,40,4,36,新光-高雄,2024-03-01,8562
00772B,中信高評級公司債,35,2,33,新光-高雄,2024-03-01,8562
6239,力成,41,8,33,新光-高雄,2024-03-01,8562
2303,聯電,45,13,32,新光-高雄,2024-03-01,8562
2609,陽明,70,39,31,新光-高雄,2024-03-01,8562
3605,宏致,35,4,31,新光-高雄,2024-03-01,8562
6684,安格,43,13,30,新光-高雄,2024-03-01,8562
8092,建暐,33,3,30,新光-高雄,2024-03-01,8562
2439,美律,29,0,29,新光-高雄,2024-03-01,8562
2897,王道銀行,31,2,29,新光-高雄,2024-03-01,8562
00764B,群益25年美債,36,9,27,新光-高雄,2024-03-01,8562
5864,致和證,31,4,27,新光-高雄,2024-03-01,8562
6112,邁達特,27,2,25,新光-高雄,2024-03-01,8562
00878,國泰永續高股息,1174,116,1058,新光-高雄,2024-03-04,8562
00632R,元大台灣50反1,1189,408,781,新光-高雄,2024-03-04,8562
00937B,群益ESG投等債20,249,86,163,新光-高雄,2024-03-04,8562
2027,大成鋼,143,0,143,新光-高雄,2024-03-04,8562
2324,仁寶,516,376,140,新光-高雄,2024-03-04,8562
00687B,國泰20年美債,179,50,129,新光-高雄,2024-03-04,8562
00673R,期元大S＆P原油反1,151,24,127,新光-高雄,2024-03-04,8562
2313,華通,261,152,109,新光-高雄,2024-03-04,8562
1108,幸福,100,0,100,新光-高雄,2024-03-04,8562
6116,彩晶,97,2,95,新光-高雄,2024-03-04,8562
9943,好樂迪,97,3,94,新光-高雄,2024-03-04,8562
2883,凱基金,129,36,93,新光-高雄,2024-03-04,8562
00679B,元大美債20年,158,71,87,新光-高雄,2024-03-04,8562
2618,長榮航,92,8,84,新光-高雄,2024-03-04,8562
2845,遠東銀,67,0,67,新光-高雄,2024-03-04,8562
1301,台塑,67,9,58,新光-高雄,2024-03-04,8562
3231,緯創,138,89,49,新光-高雄,2024-03-04,8562
2025,千興,48,3,45,新光-高雄,2024-03-04,8562
5009,榮剛,43,2,41,新光-高雄,2024-03-04,8562
00915,凱基優選高股息30,52,12,40,新光-高雄,2024-03-04,8562
4510,高鋒,43,3,40,新光-高雄,2024-03-04,8562
6120,達運,41,1,40,新光-高雄,2024-03-04,8562
00857B,永豐20年美公債,45,6,39,新光-高雄,2024-03-04,8562
2344,華邦電,133,94,39,新光-高雄,2024-03-04,8562
1795,美時,55,18,37,新光-高雄,2024-03-04,8562
00665L,富邦�琤肭磪囓�2,93,56,37,新光-高雄,2024-03-04,8562
2609,陽明,94,58,36,新光-高雄,2024-03-04,8562
2002,中鋼,55,19,36,新光-高雄,2024-03-04,8562
00907,永豐優息存股,35,0,35,新光-高雄,2024-03-04,8562
4906,正文,160,126,34,新光-高雄,2024-03-04,8562
2329,華泰,114,80,34,新光-高雄,2024-03-04,8562
6416,瑞祺電通,42,10,32,新光-高雄,2024-03-04,8562
00918,大華優利高填息30,189,157,32,新光-高雄,2024-03-04,8562
1808,潤隆,31,0,31,新光-高雄,2024-03-04,8562
2455,全新,48,19,29,新光-高雄,2024-03-04,8562
00894,中信小資高價30,29,0,29,新光-高雄,2024-03-04,8562
3708,上緯投控,43,16,27,新光-高雄,2024-03-04,8562
3360,尚立,46,19,27,新光-高雄,2024-03-04,8562
00893,國泰智能電動車,31,4,27,新光-高雄,2024-03-04,8562
2812,台中銀,38,11,27,新光-高雄,2024-03-04,8562
3338,泰碩,34,8,26,新光-高雄,2024-03-04,8562
3035,智原,48,22,26,新光-高雄,2024-03-04,8562
1513,中興電,114,89,25,新光-高雄,2024-03-04,8562
6269,台郡,26,1,25,新光-高雄,2024-03-04,8562
1618,合機,35,10,25,新光-高雄,2024-03-04,8562
4973,廣穎,24,0,24,新光-高雄,2024-03-04,8562
2610,華航,45,21,24,新光-高雄,2024-03-04,8562
2739,寒舍,23,0,23,新光-高雄,2024-03-04,8562
2888,新光金,26,3,23,新光-高雄,2024-03-04,8562
4974,亞泰,22,0,22,新光-高雄,2024-03-04,8562
00937B,群益ESG投等債20,523,20,503,新光-高雄,2024-03-05,8562
00665L,富邦�琤肭磪囓�2,558,80,478,新光-高雄,2024-03-05,8562
3313,斐成,260,1,259,新光-高雄,2024-03-05,8562
00712,復華富時不動產,266,80,186,新光-高雄,2024-03-05,8562
00882,中信中國高股息,178,11,167,新光-高雄,2024-03-05,8562
00687B,國泰20年美債,214,52,162,新光-高雄,2024-03-05,8562
00918,大華優利高填息30,190,74,116,新光-高雄,2024-03-05,8562
6235,華孚,146,33,113,新光-高雄,2024-03-05,8562
00679B,元大美債20年,115,15,100,新光-高雄,2024-03-05,8562
2888,新光金,148,54,94,新光-高雄,2024-03-05,8562
00715L,期街口布蘭特正2,87,0,87,新光-高雄,2024-03-05,8562
00706L,期元大S＆P日圓正2,86,0,86,新光-高雄,2024-03-05,8562
00909,國泰數位支付服務,84,0,84,新光-高雄,2024-03-05,8562
1301,台塑,71,2,69,新光-高雄,2024-03-05,8562
00931B,統一美債20年,64,0,64,新光-高雄,2024-03-05,8562
2002,中鋼,94,30,64,新光-高雄,2024-03-05,8562
00688L,國泰20年美債正2,79,16,63,新光-高雄,2024-03-05,8562
1815,富喬,145,84,61,新光-高雄,2024-03-05,8562
6116,彩晶,59,0,59,新光-高雄,2024-03-05,8562
00753L,中信中國50正2,92,34,58,新光-高雄,2024-03-05,8562
00857B,永豐20年美公債,97,40,57,新光-高雄,2024-03-05,8562
00935,野村臺灣新科技50,55,3,52,新光-高雄,2024-03-05,8562
2455,全新,65,15,50,新光-高雄,2024-03-05,8562
5880,合庫金,48,1,47,新光-高雄,2024-03-05,8562
2104,國際中橡,45,0,45,新光-高雄,2024-03-05,8562
00927,群益半導體收益,42,0,42,新光-高雄,2024-03-05,8562
00894,中信小資高價30,43,1,42,新光-高雄,2024-03-05,8562
2883,凱基金,46,5,41,新光-高雄,2024-03-05,8562
9945,潤泰新,49,9,40,新光-高雄,2024-03-05,8562
3228,金麗科,43,3,40,新光-高雄,2024-03-05,8562
1409,新纖,94,54,40,新光-高雄,2024-03-05,8562
00922,國泰台灣領袖50,37,0,37,新光-高雄,2024-03-05,8562
1605,華新,33,0,33,新光-高雄,2024-03-05,8562
2845,遠東銀,60,27,33,新光-高雄,2024-03-05,8562
2337,旺宏,39,7,32,新光-高雄,2024-03-05,8562
2324,仁寶,169,138,31,新光-高雄,2024-03-05,8562
00830,國泰費城半導體,32,1,31,新光-高雄,2024-03-05,8562
4510,高鋒,31,0,31,新光-高雄,2024-03-05,8562
5488,松普,180,150,30,新光-高雄,2024-03-05,8562
1718,中纖,42,12,30,新光-高雄,2024-03-05,8562
3149,正達,30,0,30,新光-高雄,2024-03-05,8562
8155,博智,30,0,30,新光-高雄,2024-03-05,8562
5309,系統電,30,2,28,新光-高雄,2024-03-05,8562
2409,友達,36,8,28,新光-高雄,2024-03-05,8562
2419,仲琦,70,43,27,新光-高雄,2024-03-05,8562
2374,佳能,62,36,26,新光-高雄,2024-03-05,8562
3163,波若威,73,48,25,新光-高雄,2024-03-05,8562
00934,中信成長高股息,28,3,25,新光-高雄,2024-03-05,8562
5864,致和證,24,0,24,新光-高雄,2024-03-05,8562
2329,華泰,83,59,24,新光-高雄,2024-03-05,8562
00919,群益台灣精選高息,1653,715,938,新光-高雄,2024-03-06,8562
00632R,元大台灣50反1,631,32,599,新光-高雄,2024-03-06,8562
00937B,群益ESG投等債20,493,65,428,新光-高雄,2024-03-06,8562
2897,王道銀行,374,10,364,新光-高雄,2024-03-06,8562
00933B,國泰10Y+金融債,248,51,197,新光-高雄,2024-03-06,8562
00918,大華優利高填息30,324,145,179,新光-高雄,2024-03-06,8562
00915,凱基優選高股息30,169,0,169,新光-高雄,2024-03-06,8562
00679B,元大美債20年,206,67,139,新光-高雄,2024-03-06,8562
3481,群創,138,48,90,新光-高雄,2024-03-06,8562
00712,復華富時不動產,100,10,90,新光-高雄,2024-03-06,8562
1513,中興電,152,66,86,新光-高雄,2024-03-06,8562
00715L,期街口布蘭特正2,94,10,84,新光-高雄,2024-03-06,8562
6005,群益證,112,33,79,新光-高雄,2024-03-06,8562
6285,啟��,90,12,78,新光-高雄,2024-03-06,8562
3231,緯創,140,63,77,新光-高雄,2024-03-06,8562
8926,台汽電,78,1,77,新光-高雄,2024-03-06,8562
2609,陽明,89,13,76,新光-高雄,2024-03-06,8562
00687B,國泰20年美債,171,106,65,新光-高雄,2024-03-06,8562
5388,中磊,76,13,63,新光-高雄,2024-03-06,8562
2547,日勝生,60,1,59,新光-高雄,2024-03-06,8562
2002,中鋼,56,1,55,新光-高雄,2024-03-06,8562
2812,台中銀,90,35,55,新光-高雄,2024-03-06,8562
3062,建漢,66,16,50,新光-高雄,2024-03-06,8562
2882,國泰金,52,3,49,新光-高雄,2024-03-06,8562
3325,旭品,150,102,48,新光-高雄,2024-03-06,8562
2610,華航,66,18,48,新光-高雄,2024-03-06,8562
1504,東元,98,51,47,新光-高雄,2024-03-06,8562
2352,佳世達,68,22,46,新光-高雄,2024-03-06,8562
5355,佳總,39,2,37,新光-高雄,2024-03-06,8562
00857B,永豐20年美公債,41,4,37,新光-高雄,2024-03-06,8562
2104,國際中橡,50,17,33,新光-高雄,2024-03-06,8562
1718,中纖,33,0,33,新光-高雄,2024-03-06,8562
00751B,元大AAA至A公司債,33,2,31,新光-高雄,2024-03-06,8562
00891,中信關鍵半導體,62,32,30,新光-高雄,2024-03-06,8562
3673,TPK-KY,37,7,30,新光-高雄,2024-03-06,8562
6770,力積電,36,8,28,新光-高雄,2024-03-06,8562
3037,欣興,50,24,26,新光-高雄,2024-03-06,8562
2498,宏達電,35,9,26,新光-高雄,2024-03-06,8562
00772B,中信高評級公司債,33,8,25,新光-高雄,2024-03-06,8562
00907,永豐優息存股,25,0,25,新光-高雄,2024-03-06,8562
00671R,富邦NASDAQ反1,25,0,25,新光-高雄,2024-03-06,8562
2367,燿華,405,380,25,新光-高雄,2024-03-06,8562
5864,致和證,42,20,22,新光-高雄,2024-03-06,8562
3105,穩懋,30,8,22,新光-高雄,2024-03-06,8562
5498,凱崴,50,28,22,新光-高雄,2024-03-06,8562
00670L,富邦NASDAQ正2,22,1,21,新光-高雄,2024-03-06,8562
8443,阿瘦,21,0,21,新光-高雄,2024-03-06,8562
5521,工信,93,72,21,新光-高雄,2024-03-06,8562
6217,中探針,44,24,20,新光-高雄,2024-03-06,8562
4533,協易機,58,38,20,新光-高雄,2024-03-06,8562
00632R,元大台灣50反1,1118,170,948,新光-高雄,2024-03-07,8562
5521,工信,443,150,293,新光-高雄,2024-03-07,8562
00937B,群益ESG投等債20,368,130,238,新光-高雄,2024-03-07,8562
00673R,期元大S＆P原油反1,187,0,187,新光-高雄,2024-03-07,8562
6788,華景電,156,0,156,新光-高雄,2024-03-07,8562
00751B,元大AAA至A公司債,130,2,128,新光-高雄,2024-03-07,8562
00733,富邦臺灣中小,121,1,120,新光-高雄,2024-03-07,8562
1301,台塑,117,6,111,新光-高雄,2024-03-07,8562
00706L,期元大S＆P日圓正2,113,10,103,新光-高雄,2024-03-07,8562
00918,大華優利高填息30,211,108,103,新光-高雄,2024-03-07,8562
00637L,元大滬深300正2,188,95,93,新光-高雄,2024-03-07,8562
2888,新光金,101,21,80,新光-高雄,2024-03-07,8562
00931B,統一美債20年,119,40,79,新光-高雄,2024-03-07,8562
00923,群益台ESG低碳50,82,3,79,新光-高雄,2024-03-07,8562
3062,建漢,76,1,75,新光-高雄,2024-03-07,8562
2897,王道銀行,82,7,75,新光-高雄,2024-03-07,8562
9105,泰金寶-DR,123,50,73,新光-高雄,2024-03-07,8562
00753L,中信中國50正2,72,0,72,新光-高雄,2024-03-07,8562
2367,燿華,448,377,71,新光-高雄,2024-03-07,8562
00915,凱基優選高股息30,591,521,70,新光-高雄,2024-03-07,8562
3481,群創,122,53,69,新光-高雄,2024-03-07,8562
2867,三商壽,77,10,67,新光-高雄,2024-03-07,8562
2455,全新,77,11,66,新光-高雄,2024-03-07,8562
1605,華新,62,0,62,新光-高雄,2024-03-07,8562
00933B,國泰10Y+金融債,72,11,61,新光-高雄,2024-03-07,8562
3645,達邁,70,10,60,新光-高雄,2024-03-07,8562
2486,一詮,127,68,59,新光-高雄,2024-03-07,8562
6116,彩晶,58,1,57,新光-高雄,2024-03-07,8562
3149,正達,52,0,52,新光-高雄,2024-03-07,8562
2610,華航,76,25,51,新光-高雄,2024-03-07,8562
00907,永豐優息存股,51,0,51,新光-高雄,2024-03-07,8562
00932,兆豐永續高息等權,50,0,50,新光-高雄,2024-03-07,8562
3294,英濟,81,34,47,新光-高雄,2024-03-07,8562
1471,首利,56,11,45,新光-高雄,2024-03-07,8562
6125,廣運,136,92,44,新光-高雄,2024-03-07,8562
2358,廷鑫,59,15,44,新光-高雄,2024-03-07,8562
2356,英業達,62,19,43,新光-高雄,2024-03-07,8562
2323,中環,42,0,42,新光-高雄,2024-03-07,8562
4906,正文,77,36,41,新光-高雄,2024-03-07,8562
2409,友達,58,18,40,新光-高雄,2024-03-07,8562
5302,太欣,40,0,40,新光-高雄,2024-03-07,8562
00687B,國泰20年美債,213,174,39,新光-高雄,2024-03-07,8562
2883,凱基金,202,164,38,新光-高雄,2024-03-07,8562
5340,建榮,41,4,37,新光-高雄,2024-03-07,8562
4904,遠傳,35,1,34,新光-高雄,2024-03-07,8562
2390,云辰,34,0,34,新光-高雄,2024-03-07,8562
3052,夆典,35,1,34,新光-高雄,2024-03-07,8562
00857B,永豐20年美公債,42,9,33,新光-高雄,2024-03-07,8562
3450,聯鈞,77,45,32,新光-高雄,2024-03-07,8562
3231,緯創,107,75,32,新光-高雄,2024-03-07,8562
00919,群益台灣精選高息,1741,847,894,新光-高雄,2024-03-08,8562
00915,凱基優選高股息30,652,47,605,新光-高雄,2024-03-08,8562
00937B,群益ESG投等債20,576,323,253,新光-高雄,2024-03-08,8562
1301,台塑,219,14,205,新光-高雄,2024-03-08,8562
00687B,國泰20年美債,280,90,190,新光-高雄,2024-03-08,8562
00637L,元大滬深300正2,253,100,153,新光-高雄,2024-03-08,8562
00795B,中信美國公債20年,163,14,149,新光-高雄,2024-03-08,8562
1718,中纖,140,0,140,新光-高雄,2024-03-08,8562
00891,中信關鍵半導體,202,62,140,新光-高雄,2024-03-08,8562
2812,台中銀,170,47,123,新光-高雄,2024-03-08,8562
3481,群創,217,114,103,新光-高雄,2024-03-08,8562
00904,新光臺灣半導體30,118,22,96,新光-高雄,2024-03-08,8562
00650L,復華香港正2,100,10,90,新光-高雄,2024-03-08,8562
3325,旭品,69,5,64,新光-高雄,2024-03-08,8562
6016,康和證,85,22,63,新光-高雄,2024-03-08,8562
2603,長榮,202,139,63,新光-高雄,2024-03-08,8562
9105,泰金寶-DR,125,65,60,新光-高雄,2024-03-08,8562
2547,日勝生,55,2,53,新光-高雄,2024-03-08,8562
4720,德淵,50,0,50,新光-高雄,2024-03-08,8562
4909,新復興,70,21,49,新光-高雄,2024-03-08,8562
00632R,元大台灣50反1,1895,1849,46,新光-高雄,2024-03-08,8562
2344,華邦電,292,249,43,新光-高雄,2024-03-08,8562
2845,遠東銀,44,3,41,新光-高雄,2024-03-08,8562
1313,聯成,39,0,39,新光-高雄,2024-03-08,8562
4938,和碩,44,6,38,新光-高雄,2024-03-08,8562
5347,世界,89,54,35,新光-高雄,2024-03-08,8562
3163,波若威,103,70,33,新光-高雄,2024-03-08,8562
1503,士電,59,26,33,新光-高雄,2024-03-08,8562
2390,云辰,33,2,31,新光-高雄,2024-03-08,8562
00921,兆豐龍頭等權重,31,0,31,新光-高雄,2024-03-08,8562
4306,炎洲,81,50,31,新光-高雄,2024-03-08,8562
2883B,凱基金乙特,30,0,30,新光-高雄,2024-03-08,8562
00673R,期元大S＆P原油反1,80,50,30,新光-高雄,2024-03-08,8562
1815,富喬,145,115,30,新光-高雄,2024-03-08,8562
00751B,元大AAA至A公司債,30,0,30,新光-高雄,2024-03-08,8562
00857B,永豐20年美公債,111,82,29,新光-高雄,2024-03-08,8562
2883,凱基金,120,91,29,新光-高雄,2024-03-08,8562
2498,宏達電,40,12,28,新光-高雄,2024-03-08,8562
6219,富旺,28,0,28,新光-高雄,2024-03-08,8562
1609,大亞,55,28,27,新光-高雄,2024-03-08,8562
2352,佳世達,32,7,25,新光-高雄,2024-03-08,8562
3591,艾笛森,25,0,25,新光-高雄,2024-03-08,8562
1101,台泥,34,10,24,新光-高雄,2024-03-08,8562
3062,建漢,30,6,24,新光-高雄,2024-03-08,8562
00686R,群益臺灣加權反1,24,0,24,新光-高雄,2024-03-08,8562
2025,千興,29,5,24,新光-高雄,2024-03-08,8562
2820,華票,24,0,24,新光-高雄,2024-03-08,8562
3260,威剛,32,8,24,新光-高雄,2024-03-08,8562
2313,華通,84,61,23,新光-高雄,2024-03-08,8562
1513,中興電,109,86,23,新光-高雄,2024-03-08,8562
00632R,元大台灣50反1,1437,35,1402,新光-高雄,2024-03-11,8562
00919,群益台灣精選高息,1225,627,598,新光-高雄,2024-03-11,8562
00937B,群益ESG投等債20,665,197,468,新光-高雄,2024-03-11,8562
00715L,期街口布蘭特正2,355,0,355,新光-高雄,2024-03-11,8562
00687B,國泰20年美債,353,14,339,新光-高雄,2024-03-11,8562
2897,王道銀行,274,35,239,新光-高雄,2024-03-11,8562
00665L,富邦�琤肭磪囓�2,606,408,198,新光-高雄,2024-03-11,8562
00688L,國泰20年美債正2,206,10,196,新光-高雄,2024-03-11,8562
2887,台新金,169,3,166,新光-高雄,2024-03-11,8562
00882,中信中國高股息,169,6,163,新光-高雄,2024-03-11,8562
2834,臺企銀,198,47,151,新光-高雄,2024-03-11,8562
00915,凱基優選高股息30,119,6,113,新光-高雄,2024-03-11,8562
2427,三商電,104,2,102,新光-高雄,2024-03-11,8562
00706L,期元大S＆P日圓正2,146,46,100,新光-高雄,2024-03-11,8562
2610,華航,99,13,86,新光-高雄,2024-03-11,8562
2405,輔信,85,4,81,新光-高雄,2024-03-11,8562
3013,晟銘電,91,12,79,新光-高雄,2024-03-11,8562
3052,夆典,80,7,73,新光-高雄,2024-03-11,8562
00679B,元大美債20年,74,5,69,新光-高雄,2024-03-11,8562
6217,中探針,81,12,69,新光-高雄,2024-03-11,8562
00891,中信關鍵半導體,79,18,61,新光-高雄,2024-03-11,8562
3033,威健,68,10,58,新光-高雄,2024-03-11,8562
00931B,統一美債20年,59,7,52,新光-高雄,2024-03-11,8562
4720,德淵,50,0,50,新光-高雄,2024-03-11,8562
4513,福裕,68,22,46,新光-高雄,2024-03-11,8562
00857B,永豐20年美公債,69,24,45,新光-高雄,2024-03-11,8562
00918,大華優利高填息30,147,102,45,新光-高雄,2024-03-11,8562
2850,新產,44,0,44,新光-高雄,2024-03-11,8562
2367,燿華,237,195,42,新光-高雄,2024-03-11,8562
9946,三發地產,42,0,42,新光-高雄,2024-03-11,8562
4906,正文,41,6,35,新光-高雄,2024-03-11,8562
1907,永豐餘,34,0,34,新光-高雄,2024-03-11,8562
1303,南亞,33,0,33,新光-高雄,2024-03-11,8562
00795B,中信美國公債20年,46,14,32,新光-高雄,2024-03-11,8562
2836,高雄銀,59,27,32,新光-高雄,2024-03-11,8562
8085,福華,42,11,31,新光-高雄,2024-03-11,8562
2603,長榮,96,66,30,新光-高雄,2024-03-11,8562
00904,新光臺灣半導體30,41,11,30,新光-高雄,2024-03-11,8562
1301,台塑,110,81,29,新光-高雄,2024-03-11,8562
2618,長榮航,54,26,28,新光-高雄,2024-03-11,8562
6235,華孚,32,7,25,新光-高雄,2024-03-11,8562
3078,僑威,30,7,23,新光-高雄,2024-03-11,8562
6698,旭暉應材,23,1,22,新光-高雄,2024-03-11,8562
1312,國喬,21,0,21,新光-高雄,2024-03-11,8562
1808,潤隆,20,0,20,新光-高雄,2024-03-11,8562
00671R,富邦NASDAQ反1,20,0,20,新光-高雄,2024-03-11,8562
00936,台新永續高息中小,20,0,20,新光-高雄,2024-03-11,8562
2344,華邦電,104,85,19,新光-高雄,2024-03-11,8562
3171,炎洲流通,31,13,18,新光-高雄,2024-03-11,8562
2104,國際中橡,18,0,18,新光-高雄,2024-03-11,8562
00918,大華優利高填息30,1419,647,772,新光-高雄,2024-03-12,8562
00929,復華台灣科技優息,870,389,481,新光-高雄,2024-03-12,8562
2367,燿華,709,333,376,新光-高雄,2024-03-12,8562
6116,彩晶,193,5,188,新光-高雄,2024-03-12,8562
00933B,國泰10Y+金融債,186,0,186,新光-高雄,2024-03-12,8562
2882,國泰金,215,31,184,新光-高雄,2024-03-12,8562
2313,華通,324,159,165,新光-高雄,2024-03-12,8562
00857B,永豐20年美公債,174,10,164,新光-高雄,2024-03-12,8562
00706L,期元大S＆P日圓正2,126,10,116,新光-高雄,2024-03-12,8562
4510,高鋒,115,0,115,新光-高雄,2024-03-12,8562
00687B,國泰20年美債,181,69,112,新光-高雄,2024-03-12,8562
1522,堤維西,113,3,110,新光-高雄,2024-03-12,8562
00919,群益台灣精選高息,664,559,105,新光-高雄,2024-03-12,8562
2427,三商電,100,1,99,新光-高雄,2024-03-12,8562
00937B,群益ESG投等債20,191,105,86,新光-高雄,2024-03-12,8562
00673R,期元大S＆P原油反1,85,1,84,新光-高雄,2024-03-12,8562
6005,群益證,101,18,83,新光-高雄,2024-03-12,8562
00720B,元大投資級公司債,91,26,65,新光-高雄,2024-03-12,8562
8086,宏捷科,85,22,63,新光-高雄,2024-03-12,8562
2801,彰銀,60,0,60,新光-高雄,2024-03-12,8562
00671R,富邦NASDAQ反1,59,0,59,新光-高雄,2024-03-12,8562
00764B,群益25年美債,52,0,52,新光-高雄,2024-03-12,8562
1618,合機,56,9,47,新光-高雄,2024-03-12,8562
2208,台船,50,4,46,新光-高雄,2024-03-12,8562
2352,佳世達,139,95,44,新光-高雄,2024-03-12,8562
2547,日勝生,40,1,39,新光-高雄,2024-03-12,8562
1605,華新,42,5,37,新光-高雄,2024-03-12,8562
2329,華泰,84,47,37,新光-高雄,2024-03-12,8562
00751B,元大AAA至A公司債,36,0,36,新光-高雄,2024-03-12,8562
00681R,元大美債20反1,34,0,34,新光-高雄,2024-03-12,8562
00795B,中信美國公債20年,46,12,34,新光-高雄,2024-03-12,8562
8110,華東,47,16,31,新光-高雄,2024-03-12,8562
3296,勝德,36,5,31,新光-高雄,2024-03-12,8562
6234,高僑,29,0,29,新光-高雄,2024-03-12,8562
2376,技嘉,46,18,28,新光-高雄,2024-03-12,8562
00680L,元大美債20正2,89,64,25,新光-高雄,2024-03-12,8562
2506,太設,25,1,24,新光-高雄,2024-03-12,8562
2509,全坤建,24,0,24,新光-高雄,2024-03-12,8562
2905,三商,25,2,23,新光-高雄,2024-03-12,8562
2515,中工,30,7,23,新光-高雄,2024-03-12,8562
6616,特昇-KY,23,0,23,新光-高雄,2024-03-12,8562
2845,遠東銀,23,0,23,新光-高雄,2024-03-12,8562
2897,王道銀行,22,0,22,新光-高雄,2024-03-12,8562
1471,首利,23,1,22,新光-高雄,2024-03-12,8562
6770,力積電,31,10,21,新光-高雄,2024-03-12,8562
6823,濾能,21,0,21,新光-高雄,2024-03-12,8562
00931B,統一美債20年,33,12,21,新光-高雄,2024-03-12,8562
1316,上曜,112,92,20,新光-高雄,2024-03-12,8562
2371,大同,71,51,20,新光-高雄,2024-03-12,8562
2453,凌群,20,0,20,新光-高雄,2024-03-12,8562
00632R,元大台灣50反1,1464,17,1447,新光-高雄,2024-03-13,8562
00919,群益台灣精選高息,1162,456,706,新光-高雄,2024-03-13,8562
2882,國泰金,522,25,497,新光-高雄,2024-03-13,8562
00918,大華優利高填息30,1009,599,410,新光-高雄,2024-03-13,8562
3231,緯創,330,117,213,新光-高雄,2024-03-13,8562
00687B,國泰20年美債,340,150,190,新光-高雄,2024-03-13,8562
00637L,元大滬深300正2,176,21,155,新光-高雄,2024-03-13,8562
00929,復華台灣科技優息,456,303,153,新光-高雄,2024-03-13,8562
00795B,中信美國公債20年,141,2,139,新光-高雄,2024-03-13,8562
00679B,元大美債20年,163,53,110,新光-高雄,2024-03-13,8562
2367,燿華,223,122,101,新光-高雄,2024-03-13,8562
1301,台塑,95,5,90,新光-高雄,2024-03-13,8562
00733,富邦臺灣中小,83,2,81,新光-高雄,2024-03-13,8562
3062,建漢,82,3,79,新光-高雄,2024-03-13,8562
8027,鈦昇,81,2,79,新光-高雄,2024-03-13,8562
00688L,國泰20年美債正2,113,39,74,新光-高雄,2024-03-13,8562
6239,力成,82,16,66,新光-高雄,2024-03-13,8562
00751B,元大AAA至A公司債,66,0,66,新光-高雄,2024-03-13,8562
2892,第一金,121,56,65,新光-高雄,2024-03-13,8562
2329,華泰,131,69,62,新光-高雄,2024-03-13,8562
1303,南亞,67,8,59,新光-高雄,2024-03-13,8562
2801,彰銀,63,4,59,新光-高雄,2024-03-13,8562
2609,陽明,111,53,58,新光-高雄,2024-03-13,8562
1522,堤維西,56,1,55,新光-高雄,2024-03-13,8562
2504,國產,66,12,54,新光-高雄,2024-03-13,8562
2344,華邦電,248,196,52,新光-高雄,2024-03-13,8562
00764B,群益25年美債,50,0,50,新光-高雄,2024-03-13,8562
9945,潤泰新,53,3,50,新光-高雄,2024-03-13,8562
3715,定穎投控,68,18,50,新光-高雄,2024-03-13,8562
8011,台通,371,322,49,新光-高雄,2024-03-13,8562
00655L,國泰中國A50正2,48,2,46,新光-高雄,2024-03-13,8562
00706L,期元大S＆P日圓正2,48,4,44,新光-高雄,2024-03-13,8562
00915,凱基優選高股息30,606,563,43,新光-高雄,2024-03-13,8562
2603,長榮,144,103,41,新光-高雄,2024-03-13,8562
1608,華榮,134,95,39,新光-高雄,2024-03-13,8562
8105,凌巨,50,12,38,新光-高雄,2024-03-13,8562
6120,達運,58,21,37,新光-高雄,2024-03-13,8562
1314,中石化,35,1,34,新光-高雄,2024-03-13,8562
1409,新纖,34,0,34,新光-高雄,2024-03-13,8562
3163,波若威,108,74,34,新光-高雄,2024-03-13,8562
1802,台玻,31,0,31,新光-高雄,2024-03-13,8562
2399,映泰,34,3,31,新光-高雄,2024-03-13,8562
1316,上曜,114,84,30,新光-高雄,2024-03-13,8562
5355,佳總,30,1,29,新光-高雄,2024-03-13,8562
4707,磐亞,31,3,28,新光-高雄,2024-03-13,8562
2607,榮運,40,13,27,新光-高雄,2024-03-13,8562
9907,統一實,27,0,27,新光-高雄,2024-03-13,8562
2405,輔信,27,1,26,新光-高雄,2024-03-13,8562
1434,福懋,34,9,25,新光-高雄,2024-03-13,8562
2514,龍邦,25,0,25,新光-高雄,2024-03-13,8562
00919,群益台灣精選高息,1897,536,1361,新光-高雄,2024-03-14,8562
00878,國泰永續高股息,860,177,683,新光-高雄,2024-03-14,8562
00915,凱基優選高股息30,596,50,546,新光-高雄,2024-03-14,8562
00900,富邦特選高股息30,417,35,382,新光-高雄,2024-03-14,8562
00665L,富邦�琤肭磪囓�2,317,49,268,新光-高雄,2024-03-14,8562
00687B,國泰20年美債,270,19,251,新光-高雄,2024-03-14,8562
00918,大華優利高填息30,370,142,228,新光-高雄,2024-03-14,8562
00673R,期元大S＆P原油反1,220,0,220,新光-高雄,2024-03-14,8562
00688L,國泰20年美債正2,270,93,177,新光-高雄,2024-03-14,8562
00679B,元大美債20年,171,10,161,新光-高雄,2024-03-14,8562
2834,臺企銀,177,22,155,新光-高雄,2024-03-14,8562
00937B,群益ESG投等債20,198,63,135,新光-高雄,2024-03-14,8562
4303,信立,112,0,112,新光-高雄,2024-03-14,8562
2603,長榮,207,97,110,新光-高雄,2024-03-14,8562
00706L,期元大S＆P日圓正2,140,30,110,新光-高雄,2024-03-14,8562
00680L,元大美債20正2,290,187,103,新光-高雄,2024-03-14,8562
2367,燿華,127,33,94,新光-高雄,2024-03-14,8562
00671R,富邦NASDAQ反1,94,0,94,新光-高雄,2024-03-14,8562
00795B,中信美國公債20年,83,0,83,新光-高雄,2024-03-14,8562
2889,國票金,236,155,81,新光-高雄,2024-03-14,8562
00857B,永豐20年美公債,95,19,76,新光-高雄,2024-03-14,8562
2812,台中銀,113,52,61,新光-高雄,2024-03-14,8562
1815,富喬,112,63,49,新光-高雄,2024-03-14,8562
2609,陽明,64,16,48,新光-高雄,2024-03-14,8562
3702,大聯大,59,11,48,新光-高雄,2024-03-14,8562
6005,群益證,71,23,48,新光-高雄,2024-03-14,8562
2408,南亞科,55,7,48,新光-高雄,2024-03-14,8562
2527,宏璟,46,0,46,新光-高雄,2024-03-14,8562
2344,華邦電,55,9,46,新光-高雄,2024-03-14,8562
00931B,統一美債20年,57,13,44,新光-高雄,2024-03-14,8562
2353,宏��,47,6,41,新光-高雄,2024-03-14,8562
00882,中信中國高股息,50,8,42,新光-高雄,2024-03-14,8562
2002,中鋼,62,22,40,新光-高雄,2024-03-14,8562
6116,彩晶,40,1,39,新光-高雄,2024-03-14,8562
8936,國統,43,9,34,新光-高雄,2024-03-14,8562
5525,順天,34,0,34,新光-高雄,2024-03-14,8562
3706,神達,49,17,32,新光-高雄,2024-03-14,8562
1710,東聯,30,0,30,新光-高雄,2024-03-14,8562
3164,景岳,30,0,30,新光-高雄,2024-03-14,8562
3231,緯創,103,75,28,新光-高雄,2024-03-14,8562
9902,台火,75,49,26,新光-高雄,2024-03-14,8562
3005,神基,100,74,26,新光-高雄,2024-03-14,8562
6165,浪凡,66,41,25,新光-高雄,2024-03-14,8562
0056,元大高股息,36,11,25,新光-高雄,2024-03-14,8562
00733,富邦臺灣中小,24,0,24,新光-高雄,2024-03-14,8562
1513,中興電,121,98,23,新光-高雄,2024-03-14,8562
2354,鴻準,124,101,23,新光-高雄,2024-03-14,8562
00637L,元大滬深300正2,119,96,23,新光-高雄,2024-03-14,8562
5488,松普,22,0,22,新光-高雄,2024-03-14,8562
2329,華泰,54,33,21,新光-高雄,2024-03-14,8562
00919,群益台灣精選高息,3840,526,3314,新光-高雄,2024-03-15,8562
00680L,元大美債20正2,838,36,802,新光-高雄,2024-03-15,8562
2834,臺企銀,1070,310,760,新光-高雄,2024-03-15,8562
00941,中信上游半導體,499,12,487,新光-高雄,2024-03-15,8562
00688L,國泰20年美債正2,458,50,408,新光-高雄,2024-03-15,8562
2618,長榮航,453,87,366,新光-高雄,2024-03-15,8562
00665L,富邦�琤肭磪囓�2,550,259,291,新光-高雄,2024-03-15,8562
00857B,永豐20年美公債,238,0,238,新光-高雄,2024-03-15,8562
00937B,群益ESG投等債20,422,207,215,新光-高雄,2024-03-15,8562
00687B,國泰20年美債,218,8,210,新光-高雄,2024-03-15,8562
2603,長榮,332,169,163,新光-高雄,2024-03-15,8562
00673R,期元大S＆P原油反1,172,20,152,新光-高雄,2024-03-15,8562
00933B,國泰10Y+金融債,142,7,135,新光-高雄,2024-03-15,8562
00923,群益台ESG低碳50,138,8,130,新光-高雄,2024-03-15,8562
00679B,元大美債20年,185,79,106,新光-高雄,2024-03-15,8562
1303,南亞,109,4,105,新光-高雄,2024-03-15,8562
00632R,元大台灣50反1,148,43,105,新光-高雄,2024-03-15,8562
3322,建舜電,123,32,91,新光-高雄,2024-03-15,8562
00706L,期元大S＆P日圓正2,141,51,90,新光-高雄,2024-03-15,8562
00772B,中信高評級公司債,93,5,88,新光-高雄,2024-03-15,8562
2367,燿華,114,28,86,新光-高雄,2024-03-15,8562
00795B,中信美國公債20年,84,1,83,新光-高雄,2024-03-15,8562
1504,東元,97,18,79,新光-高雄,2024-03-15,8562
2887,台新金,85,12,73,新光-高雄,2024-03-15,8562
00753L,中信中國50正2,73,4,69,新光-高雄,2024-03-15,8562
2352,佳世達,74,9,65,新光-高雄,2024-03-15,8562
8105,凌巨,63,2,61,新光-高雄,2024-03-15,8562
2739,寒舍,61,1,60,新光-高雄,2024-03-15,8562
2610,華航,59,1,58,新光-高雄,2024-03-15,8562
00751B,元大AAA至A公司債,84,27,57,新光-高雄,2024-03-15,8562
2888,新光金,65,13,52,新光-高雄,2024-03-15,8562
3576,聯合再生,117,65,52,新光-高雄,2024-03-15,8562
1301,台塑,62,14,48,新光-高雄,2024-03-15,8562
00671R,富邦NASDAQ反1,47,0,47,新光-高雄,2024-03-15,8562
2303,聯電,99,52,47,新光-高雄,2024-03-15,8562
6770,力積電,44,1,43,新光-高雄,2024-03-15,8562
1582,信錦,46,6,40,新光-高雄,2024-03-15,8562
6120,達運,50,10,40,新光-高雄,2024-03-15,8562
00907,永豐優息存股,49,10,39,新光-高雄,2024-03-15,8562
3005,神基,51,13,38,新光-高雄,2024-03-15,8562
6274,台燿,68,30,38,新光-高雄,2024-03-15,8562
2356,英業達,66,29,37,新光-高雄,2024-03-15,8562
00931B,統一美債20年,64,27,37,新光-高雄,2024-03-15,8562
00918,大華優利高填息30,293,257,36,新光-高雄,2024-03-15,8562
6126,信音,36,1,35,新光-高雄,2024-03-15,8562
2354,鴻準,221,186,35,新光-高雄,2024-03-15,8562
2330,台積電,60,26,34,新光-高雄,2024-03-15,8562
2897,王道銀行,31,0,31,新光-高雄,2024-03-15,8562
5475,德宏,30,0,30,新光-高雄,2024-03-15,8562
5452,佶優,74,44,30,新光-高雄,2024-03-15,8562
00919,群益台灣精選高息,871,163,708,新光-高雄,2024-03-18,8562
00680L,元大美債20正2,533,40,493,新光-高雄,2024-03-18,8562
2884,玉山金,479,39,440,新光-高雄,2024-03-18,8562
00632R,元大台灣50反1,471,50,421,新光-高雄,2024-03-18,8562
2834,臺企銀,469,65,404,新光-高雄,2024-03-18,8562
00937B,群益ESG投等債20,321,13,308,新光-高雄,2024-03-18,8562
2883,凱基金,296,48,248,新光-高雄,2024-03-18,8562
00712,復華富時不動產,364,152,212,新光-高雄,2024-03-18,8562
00941,中信上游半導體,211,23,188,新光-高雄,2024-03-18,8562
00918,大華優利高填息30,222,39,183,新光-高雄,2024-03-18,8562
00795B,中信美國公債20年,164,2,162,新光-高雄,2024-03-18,8562
00933B,國泰10Y+金融債,154,0,154,新光-高雄,2024-03-18,8562
2801,彰銀,158,7,151,新光-高雄,2024-03-18,8562
2867,三商壽,158,21,137,新光-高雄,2024-03-18,8562
00679B,元大美債20年,131,1,130,新光-高雄,2024-03-18,8562
00673R,期元大S＆P原油反1,133,20,113,新光-高雄,2024-03-18,8562
00687B,國泰20年美債,231,133,98,新光-高雄,2024-03-18,8562
00706L,期元大S＆P日圓正2,127,36,91,新光-高雄,2024-03-18,8562
6005,群益證,104,14,90,新光-高雄,2024-03-18,8562
00665L,富邦�琤肭磪囓�2,1151,1072,79,新光-高雄,2024-03-18,8562
1316,上曜,120,50,70,新光-高雄,2024-03-18,8562
00751B,元大AAA至A公司債,124,55,69,新光-高雄,2024-03-18,8562
1301,台塑,87,23,64,新光-高雄,2024-03-18,8562
2812,台中銀,76,14,62,新光-高雄,2024-03-18,8562
2317,鴻海,345,285,60,新光-高雄,2024-03-18,8562
2002,中鋼,74,21,53,新光-高雄,2024-03-18,8562
2486,一詮,226,174,52,新光-高雄,2024-03-18,8562
1815,富喬,53,5,48,新光-高雄,2024-03-18,8562
00764B,群益25年美債,46,0,46,新光-高雄,2024-03-18,8562
2382,廣達,87,42,45,新光-高雄,2024-03-18,8562
1104,環泥,45,0,45,新光-高雄,2024-03-18,8562
3576,聯合再生,45,0,45,新光-高雄,2024-03-18,8562
00688L,國泰20年美債正2,42,0,42,新光-高雄,2024-03-18,8562
00720B,元大投資級公司債,42,1,41,新光-高雄,2024-03-18,8562
00931B,統一美債20年,41,0,41,新光-高雄,2024-03-18,8562
9902,台火,61,24,37,新光-高雄,2024-03-18,8562
2408,南亞科,41,9,32,新光-高雄,2024-03-18,8562
1907,永豐餘,31,0,31,新光-高雄,2024-03-18,8562
2609,陽明,103,73,30,新光-高雄,2024-03-18,8562
2431,聯昌,30,0,30,新光-高雄,2024-03-18,8562
1514,亞力,150,120,30,新光-高雄,2024-03-18,8562
2610,華航,44,15,29,新光-高雄,2024-03-18,8562
2887,台新金,33,4,29,新光-高雄,2024-03-18,8562
8240,華宏,30,2,28,新光-高雄,2024-03-18,8562
2104,國際中橡,33,7,26,新光-高雄,2024-03-18,8562
2301,光寶科,43,18,25,新光-高雄,2024-03-18,8562
2105,正新,43,18,25,新光-高雄,2024-03-18,8562
3313,斐成,25,0,25,新光-高雄,2024-03-18,8562
00915,凱基優選高股息30,29,5,24,新光-高雄,2024-03-18,8562
1101,台泥,26,3,23,新光-高雄,2024-03-18,8562
00919,群益台灣精選高息,1094,659,435,新光-高雄,2024-03-19,8562
00706L,期元大S＆P日圓正2,538,160,378,新光-高雄,2024-03-19,8562
00937B,群益ESG投等債20,421,69,352,新光-高雄,2024-03-19,8562
00673R,期元大S＆P原油反1,259,0,259,新光-高雄,2024-03-19,8562
00687B,國泰20年美債,218,8,210,新光-高雄,2024-03-19,8562
00857B,永豐20年美公債,302,110,192,新光-高雄,2024-03-19,8562
00688L,國泰20年美債正2,212,31,181,新光-高雄,2024-03-19,8562
2867,三商壽,161,0,161,新光-高雄,2024-03-19,8562
1301,台塑,135,9,126,新光-高雄,2024-03-19,8562
3576,聯合再生,137,13,124,新光-高雄,2024-03-19,8562
6016,康和證,115,8,107,新光-高雄,2024-03-19,8562
2208,台船,142,35,107,新光-高雄,2024-03-19,8562
00679B,元大美債20年,109,9,100,新光-高雄,2024-03-19,8562
00715L,期街口布蘭特正2,157,58,99,新光-高雄,2024-03-19,8562
00680L,元大美債20正2,90,0,90,新光-高雄,2024-03-19,8562
00650L,復華香港正2,82,4,78,新光-高雄,2024-03-19,8562
00795B,中信美國公債20年,66,1,65,新光-高雄,2024-03-19,8562
2888,新光金,197,139,58,新光-高雄,2024-03-19,8562
3499,環天科,50,0,50,新光-高雄,2024-03-19,8562
2355,敬鵬,60,11,49,新光-高雄,2024-03-19,8562
2801,彰銀,44,0,44,新光-高雄,2024-03-19,8562
1101,台泥,59,16,43,新光-高雄,2024-03-19,8562
2618,長榮航,69,26,43,新光-高雄,2024-03-19,8562
2834,臺企銀,73,33,40,新光-高雄,2024-03-19,8562
00941,中信上游半導體,39,0,39,新光-高雄,2024-03-19,8562
2486,一詮,125,87,38,新光-高雄,2024-03-19,8562
6139,亞翔,43,6,37,新光-高雄,2024-03-19,8562
2329,華泰,102,66,36,新光-高雄,2024-03-19,8562
0056,元大高股息,51,17,34,新光-高雄,2024-03-19,8562
00751B,元大AAA至A公司債,59,26,33,新光-高雄,2024-03-19,8562
5521,工信,37,4,33,新光-高雄,2024-03-19,8562
00633L,富邦上証正2,65,34,31,新光-高雄,2024-03-19,8562
1605,華新,272,242,30,新光-高雄,2024-03-19,8562
3312,弘憶股,89,60,29,新光-高雄,2024-03-19,8562
2353,宏��,34,6,28,新光-高雄,2024-03-19,8562
00930,永豐ESG低碳高息,30,4,26,新光-高雄,2024-03-19,8562
3090,日電貿,26,0,26,新光-高雄,2024-03-19,8562
1316,上曜,148,123,25,新光-高雄,2024-03-19,8562
00712,復華富時不動產,74,50,24,新光-高雄,2024-03-19,8562
3481,群創,30,6,24,新光-高雄,2024-03-19,8562
3062,建漢,24,1,23,新光-高雄,2024-03-19,8562
2408,南亞科,28,6,22,新光-高雄,2024-03-19,8562
6116,彩晶,22,1,21,新光-高雄,2024-03-19,8562
6125,廣運,38,17,21,新光-高雄,2024-03-19,8562
3059,華晶科,39,18,21,新光-高雄,2024-03-19,8562
5302,太欣,20,0,20,新光-高雄,2024-03-19,8562
00671R,富邦NASDAQ反1,20,0,20,新光-高雄,2024-03-19,8562
2399,映泰,20,0,20,新光-高雄,2024-03-19,8562
1402,遠東新,20,0,20,新光-高雄,2024-03-19,8562
3056,富華新,20,0,20,新光-高雄,2024-03-19,8562
00939,統一台灣高息動能,3522,423,3099,新光-高雄,2024-03-20,8562
6016,康和證,523,20,503,新光-高雄,2024-03-20,8562
00706L,期元大S＆P日圓正2,495,93,402,新光-高雄,2024-03-20,8562
00680L,元大美債20正2,293,37,256,新光-高雄,2024-03-20,8562
3576,聯合再生,217,12,205,新光-高雄,2024-03-20,8562
00632R,元大台灣50反1,198,15,183,新光-高雄,2024-03-20,8562
00679B,元大美債20年,186,17,169,新光-高雄,2024-03-20,8562
2618,長榮航,177,23,154,新光-高雄,2024-03-20,8562
1301,台塑,180,27,153,新光-高雄,2024-03-20,8562
3231,緯創,356,229,127,新光-高雄,2024-03-20,8562
3322,建舜電,158,33,125,新光-高雄,2024-03-20,8562
00857B,永豐20年美公債,132,16,116,新光-高雄,2024-03-20,8562
1522,堤維西,107,8,99,新光-高雄,2024-03-20,8562
6753,龍德造船,141,43,98,新光-高雄,2024-03-20,8562
2324,仁寶,162,68,94,新光-高雄,2024-03-20,8562
00941,中信上游半導體,79,3,76,新光-高雄,2024-03-20,8562
00673R,期元大S＆P原油反1,73,0,73,新光-高雄,2024-03-20,8562
00795B,中信美國公債20年,81,8,73,新光-高雄,2024-03-20,8562
2356,英業達,122,56,66,新光-高雄,2024-03-20,8562
1218,泰山,80,22,58,新光-高雄,2024-03-20,8562
00937B,群益ESG投等債20,195,140,55,新光-高雄,2024-03-20,8562
1785,光洋科,94,42,52,新光-高雄,2024-03-20,8562
00712,復華富時不動產,122,76,46,新光-高雄,2024-03-20,8562
8085,福華,47,1,46,新光-高雄,2024-03-20,8562
2354,鴻準,164,119,45,新光-高雄,2024-03-20,8562
2492,華新科,50,6,44,新光-高雄,2024-03-20,8562
2886,兆豐金,54,10,44,新光-高雄,2024-03-20,8562
2303,聯電,134,90,44,新光-高雄,2024-03-20,8562
2889,國票金,58,23,35,新光-高雄,2024-03-20,8562
6282,康舒,35,0,35,新光-高雄,2024-03-20,8562
2104,國際中橡,34,0,34,新光-高雄,2024-03-20,8562
3481,群創,46,13,33,新光-高雄,2024-03-20,8562
1339,昭輝,52,20,32,新光-高雄,2024-03-20,8562
00751B,元大AAA至A公司債,32,0,32,新光-高雄,2024-03-20,8562
00921,兆豐龍頭等權重,40,10,30,新光-高雄,2024-03-20,8562
3209,全科,29,0,29,新光-高雄,2024-03-20,8562
1616,億泰,31,2,29,新光-高雄,2024-03-20,8562
9902,台火,41,12,29,新光-高雄,2024-03-20,8562
2376,技嘉,38,10,28,新光-高雄,2024-03-20,8562
2449,京元電子,100,72,28,新光-高雄,2024-03-20,8562
00900,富邦特選高股息30,66,38,28,新光-高雄,2024-03-20,8562
1513,中興電,95,68,27,新光-高雄,2024-03-20,8562
2382,廣達,57,31,26,新光-高雄,2024-03-20,8562
00927,群益半導體收益,43,17,26,新光-高雄,2024-03-20,8562
6752,叡揚,26,0,26,新光-高雄,2024-03-20,8562
2313,華通,61,35,26,新光-高雄,2024-03-20,8562
2892,第一金,25,0,25,新光-高雄,2024-03-20,8562
00688L,國泰20年美債正2,25,1,24,新光-高雄,2024-03-20,8562
4938,和碩,156,132,24,新光-高雄,2024-03-20,8562
2641,正德,24,0,24,新光-高雄,2024-03-20,8562
00919,群益台灣精選高息,1783,369,1414,新光-高雄,2024-03-21,8562
00939,統一台灣高息動能,882,237,645,新光-高雄,2024-03-21,8562
00680L,元大美債20正2,334,70,264,新光-高雄,2024-03-21,8562
00632R,元大台灣50反1,793,539,254,新光-高雄,2024-03-21,8562
00687B,國泰20年美債,286,44,242,新光-高雄,2024-03-21,8562
2897,王道銀行,306,115,191,新光-高雄,2024-03-21,8562
00937B,群益ESG投等債20,197,51,146,新光-高雄,2024-03-21,8562
2409,友達,164,43,121,新光-高雄,2024-03-21,8562
00679B,元大美債20年,140,21,119,新光-高雄,2024-03-21,8562
00857B,永豐20年美公債,113,5,108,新光-高雄,2024-03-21,8562
00720B,元大投資級公司債,112,5,107,新光-高雄,2024-03-21,8562
00929,復華台灣科技優息,371,278,93,新光-高雄,2024-03-21,8562
6120,達運,77,6,71,新光-高雄,2024-03-21,8562
8096,擎亞,125,65,60,新光-高雄,2024-03-21,8562
00637L,元大滬深300正2,66,15,51,新光-高雄,2024-03-21,8562
00688L,國泰20年美債正2,47,0,47,新光-高雄,2024-03-21,8562
4973,廣穎,64,20,44,新光-高雄,2024-03-21,8562
1218,泰山,49,7,42,新光-高雄,2024-03-21,8562
6166,凌華,44,2,42,新光-高雄,2024-03-21,8562
2820,華票,50,10,40,新光-高雄,2024-03-21,8562
00941,中信上游半導體,61,23,38,新光-高雄,2024-03-21,8562
00830,國泰費城半導體,50,14,36,新光-高雄,2024-03-21,8562
6191,精成科,81,46,35,新光-高雄,2024-03-21,8562
2316,楠梓電,40,7,33,新光-高雄,2024-03-21,8562
6235,華孚,57,25,32,新光-高雄,2024-03-21,8562
2301,光寶科,83,52,31,新光-高雄,2024-03-21,8562
2362,藍天,42,11,31,新光-高雄,2024-03-21,8562
3005,神基,145,115,30,新光-高雄,2024-03-21,8562
6212,理銘,29,0,29,新光-高雄,2024-03-21,8562
2406,國碩,71,42,29,新光-高雄,2024-03-21,8562
1101,台泥,36,7,29,新光-高雄,2024-03-21,8562
1616,億泰,66,38,28,新光-高雄,2024-03-21,8562
2515,中工,49,22,27,新光-高雄,2024-03-21,8562
1312,國喬,26,0,26,新光-高雄,2024-03-21,8562
2520,冠德,30,4,26,新光-高雄,2024-03-21,8562
1806,冠軍,26,0,26,新光-高雄,2024-03-21,8562
2543,皇昌,31,5,26,新光-高雄,2024-03-21,8562
9105,泰金寶-DR,25,0,25,新光-高雄,2024-03-21,8562
2538,基泰,25,0,25,新光-高雄,2024-03-21,8562
2889,國票金,26,2,24,新光-高雄,2024-03-21,8562
1409,新纖,25,1,24,新光-高雄,2024-03-21,8562
6505,台塑化,26,4,22,新光-高雄,2024-03-21,8562
6244,茂迪,61,39,22,新光-高雄,2024-03-21,8562
8936,國統,50,29,21,新光-高雄,2024-03-21,8562
00795B,中信美國公債20年,83,62,21,新光-高雄,2024-03-21,8562
3508,位速,21,1,20,新光-高雄,2024-03-21,8562
5292,華懋,22,2,20,新光-高雄,2024-03-21,8562
3515,華擎,29,9,20,新光-高雄,2024-03-21,8562
6457,紘康,20,0,20,新光-高雄,2024-03-21,8562
2208,台船,21,1,20,新光-高雄,2024-03-21,8562
00937B,群益ESG投等債20,1207,12,1195,新光-高雄,2024-03-22,8562
00939,統一台灣高息動能,540,149,391,新光-高雄,2024-03-22,8562
00918,大華優利高填息30,512,131,381,新光-高雄,2024-03-22,8562
00665L,富邦�琤肭磪囓�2,422,90,332,新光-高雄,2024-03-22,8562
00900,富邦特選高股息30,354,36,318,新光-高雄,2024-03-22,8562
00680L,元大美債20正2,347,68,279,新光-高雄,2024-03-22,8562
00941,中信上游半導體,246,10,236,新光-高雄,2024-03-22,8562
00706L,期元大S＆P日圓正2,220,0,220,新光-高雄,2024-03-22,8562
3033,威健,193,49,144,新光-高雄,2024-03-22,8562
2887,台新金,125,4,121,新光-高雄,2024-03-22,8562
6214,精誠,92,4,88,新光-高雄,2024-03-22,8562
00673R,期元大S＆P原油反1,102,24,78,新光-高雄,2024-03-22,8562
2356,英業達,504,427,77,新光-高雄,2024-03-22,8562
00637L,元大滬深300正2,119,51,68,新光-高雄,2024-03-22,8562
2303,聯電,95,27,68,新光-高雄,2024-03-22,8562
2353,宏��,240,174,66,新光-高雄,2024-03-22,8562
1605,華新,81,15,66,新光-高雄,2024-03-22,8562
6016,康和證,64,0,64,新光-高雄,2024-03-22,8562
00687B,國泰20年美債,97,35,62,新光-高雄,2024-03-22,8562
00679B,元大美債20年,94,38,56,新光-高雄,2024-03-22,8562
2344,華邦電,269,214,55,新光-高雄,2024-03-22,8562
5512,力麒,56,3,53,新光-高雄,2024-03-22,8562
2883,凱基金,65,16,49,新光-高雄,2024-03-22,8562
3706,神達,299,250,49,新光-高雄,2024-03-22,8562
2834,臺企銀,86,40,46,新光-高雄,2024-03-22,8562
4510,高鋒,45,0,45,新光-高雄,2024-03-22,8562
9105,泰金寶-DR,46,2,44,新光-高雄,2024-03-22,8562
1409,新纖,44,2,42,新光-高雄,2024-03-22,8562
00753L,中信中國50正2,42,3,39,新光-高雄,2024-03-22,8562
2603,長榮,122,83,39,新光-高雄,2024-03-22,8562
1503,士電,197,159,38,新光-高雄,2024-03-22,8562
2449,京元電子,137,99,38,新光-高雄,2024-03-22,8562
3005,神基,65,28,37,新光-高雄,2024-03-22,8562
8086,宏捷科,36,0,36,新光-高雄,2024-03-22,8562
9910,豐泰,36,0,36,新光-高雄,2024-03-22,8562
2367,燿華,164,128,36,新光-高雄,2024-03-22,8562
6274,台燿,159,124,35,新光-高雄,2024-03-22,8562
1218,泰山,65,30,35,新光-高雄,2024-03-22,8562
6547,高端疫苗,35,1,34,新光-高雄,2024-03-22,8562
1608,華榮,91,59,32,新光-高雄,2024-03-22,8562
1101,台泥,35,4,31,新光-高雄,2024-03-22,8562
1304,台聚,33,3,30,新光-高雄,2024-03-22,8562
8070,長華*,33,3,30,新光-高雄,2024-03-22,8562
8155,博智,29,0,29,新光-高雄,2024-03-22,8562
3211,順達,39,11,28,新光-高雄,2024-03-22,8562
1504,東元,128,101,27,新光-高雄,2024-03-22,8562
00655L,國泰中國A50正2,51,26,25,新光-高雄,2024-03-22,8562
1216,統一,25,2,23,新光-高雄,2024-03-22,8562
1301,台塑,70,47,23,新光-高雄,2024-03-22,8562
5880,合庫金,26,3,23,新光-高雄,2024-03-22,8562
2882,國泰金,495,40,455,新光-高雄,2024-03-25,8562
00939,統一台灣高息動能,398,41,357,新光-高雄,2024-03-25,8562
00919,群益台灣精選高息,532,236,296,新光-高雄,2024-03-25,8562
1609,大亞,545,395,150,新光-高雄,2024-03-25,8562
00712,復華富時不動產,192,70,122,新光-高雄,2024-03-25,8562
00632R,元大台灣50反1,249,131,118,新光-高雄,2024-03-25,8562
00931B,統一美債20年,169,57,112,新光-高雄,2024-03-25,8562
1109,信大,118,8,110,新光-高雄,2024-03-25,8562
3416,融程電,90,3,87,新光-高雄,2024-03-25,8562
3712,永崴投控,100,16,84,新光-高雄,2024-03-25,8562
00733,富邦臺灣中小,81,0,81,新光-高雄,2024-03-25,8562
2405,輔信,69,4,65,新光-高雄,2024-03-25,8562
00665L,富邦�琤肭磪囓�2,210,146,64,新光-高雄,2024-03-25,8562
00696B,富邦美債20年,61,0,61,新光-高雄,2024-03-25,8562
2303,聯電,77,23,54,新光-高雄,2024-03-25,8562
00680L,元大美債20正2,150,96,54,新光-高雄,2024-03-25,8562
8110,華東,65,12,53,新光-高雄,2024-03-25,8562
00772B,中信高評級公司債,51,1,50,新光-高雄,2024-03-25,8562
3005,神基,102,53,49,新光-高雄,2024-03-25,8562
2317,鴻海,261,214,47,新光-高雄,2024-03-25,8562
1608,華榮,84,39,45,新光-高雄,2024-03-25,8562
2352,佳世達,77,36,41,新光-高雄,2024-03-25,8562
2547,日勝生,50,10,40,新光-高雄,2024-03-25,8562
00715L,期街口布蘭特正2,40,1,39,新光-高雄,2024-03-25,8562
1101,台泥,44,6,38,新光-高雄,2024-03-25,8562
2409,友達,63,25,38,新光-高雄,2024-03-25,8562
4532,瑞智,43,5,38,新光-高雄,2024-03-25,8562
00941,中信上游半導體,357,320,37,新光-高雄,2024-03-25,8562
2889,國票金,36,0,36,新光-高雄,2024-03-25,8562
2888,新光金,54,18,36,新光-高雄,2024-03-25,8562
2359,所羅門,41,5,36,新光-高雄,2024-03-25,8562
0056,元大高股息,47,12,35,新光-高雄,2024-03-25,8562
8401,白紗科,35,0,35,新光-高雄,2024-03-25,8562
3231,緯創,61,28,33,新光-高雄,2024-03-25,8562
2537,聯上發,38,7,31,新光-高雄,2024-03-25,8562
00891,中信關鍵半導體,32,1,31,新光-高雄,2024-03-25,8562
1618,合機,77,48,29,新光-高雄,2024-03-25,8562
4526,東台,133,105,28,新光-高雄,2024-03-25,8562
8105,凌巨,27,0,27,新光-高雄,2024-03-25,8562
2301,光寶科,59,32,27,新光-高雄,2024-03-25,8562
6282,康舒,35,9,26,新光-高雄,2024-03-25,8562
8064,東捷,96,71,25,新光-高雄,2024-03-25,8562
6188,廣明,104,79,25,新光-高雄,2024-03-25,8562
2367,燿華,374,351,23,新光-高雄,2024-03-25,8562
1503,士電,35,11,24,新光-高雄,2024-03-25,8562
3294,英濟,57,34,23,新光-高雄,2024-03-25,8562
8473,山林水,28,6,22,新光-高雄,2024-03-25,8562
1815,富喬,56,34,22,新光-高雄,2024-03-25,8562
2887,台新金,31,10,21,新光-高雄,2024-03-25,8562
3704,合勤控,23,2,21,新光-高雄,2024-03-25,8562
00929,復華台灣科技優息,1805,1086,719,新光-高雄,2024-03-26,8562
00937B,群益ESG投等債20,449,71,378,新光-高雄,2024-03-26,8562
00632R,元大台灣50反1,742,376,366,新光-高雄,2024-03-26,8562
00941,中信上游半導體,634,333,301,新光-高雄,2024-03-26,8562
00687B,國泰20年美債,242,16,226,新光-高雄,2024-03-26,8562
00680L,元大美債20正2,181,11,170,新光-高雄,2024-03-26,8562
00679B,元大美債20年,166,19,147,新光-高雄,2024-03-26,8562
3231,緯創,192,56,136,新光-高雄,2024-03-26,8562
00933B,國泰10Y+金融債,141,11,130,新光-高雄,2024-03-26,8562
1309,台達化,120,4,116,新光-高雄,2024-03-26,8562
3481,群創,187,72,115,新光-高雄,2024-03-26,8562
2610,華航,141,31,110,新光-高雄,2024-03-26,8562
1616,億泰,128,22,106,新光-高雄,2024-03-26,8562
2353,宏��,210,115,95,新光-高雄,2024-03-26,8562
2359,所羅門,176,90,86,新光-高雄,2024-03-26,8562
2618,長榮航,94,7,87,新光-高雄,2024-03-26,8562
2367,燿華,231,144,87,新光-高雄,2024-03-26,8562
9105,泰金寶-DR,165,84,81,新光-高雄,2024-03-26,8562
00715L,期街口布蘭特正2,132,56,76,新光-高雄,2024-03-26,8562
2609,陽明,104,36,68,新光-高雄,2024-03-26,8562
2303,聯電,87,21,66,新光-高雄,2024-03-26,8562
00733,富邦臺灣中小,65,0,65,新光-高雄,2024-03-26,8562
5521,工信,69,7,62,新光-高雄,2024-03-26,8562
00882,中信中國高股息,66,5,61,新光-高雄,2024-03-26,8562
2547,日勝生,90,30,60,新光-高雄,2024-03-26,8562
00751B,元大AAA至A公司債,84,24,60,新光-高雄,2024-03-26,8562
1109,信大,63,10,53,新光-高雄,2024-03-26,8562
3545,敦泰,54,4,50,新光-高雄,2024-03-26,8562
00706L,期元大S＆P日圓正2,50,0,50,新光-高雄,2024-03-26,8562
4938,和碩,122,75,47,新光-高雄,2024-03-26,8562
4306,炎洲,65,20,45,新光-高雄,2024-03-26,8562
2344,華邦電,234,189,45,新光-高雄,2024-03-26,8562
3703,欣陸,59,16,43,新光-高雄,2024-03-26,8562
00773B,中信優先金融債,43,0,43,新光-高雄,2024-03-26,8562
4121,優盛,42,0,42,新光-高雄,2024-03-26,8562
6139,亞翔,51,10,41,新光-高雄,2024-03-26,8562
3029,零壹,40,0,40,新光-高雄,2024-03-26,8562
2402,毅嘉,43,3,40,新光-高雄,2024-03-26,8562
2356,英業達,212,173,39,新光-高雄,2024-03-26,8562
3062,建漢,73,34,39,新光-高雄,2024-03-26,8562
2834,臺企銀,141,103,38,新光-高雄,2024-03-26,8562
00878,國泰永續高股息,142,105,37,新光-高雄,2024-03-26,8562
6125,廣運,122,86,36,新光-高雄,2024-03-26,8562
8112,至上,44,13,31,新光-高雄,2024-03-26,8562
2836,高雄銀,40,10,30,新光-高雄,2024-03-26,8562
2486,一詮,87,57,30,新光-高雄,2024-03-26,8562
1618,合機,89,61,28,新光-高雄,2024-03-26,8562
8085,福華,39,12,27,新光-高雄,2024-03-26,8562
8936,國統,139,112,27,新光-高雄,2024-03-26,8562
6547,高端疫苗,27,1,26,新光-高雄,2024-03-26,8562
00919,群益台灣精選高息,874,392,482,新光-高雄,2024-03-27,8562
00937B,群益ESG投等債20,349,5,344,新光-高雄,2024-03-27,8562
2834,臺企銀,338,156,182,新光-高雄,2024-03-27,8562
00929,復華台灣科技優息,694,523,171,新光-高雄,2024-03-27,8562
1309,台達化,147,0,147,新光-高雄,2024-03-27,8562
00706L,期元大S＆P日圓正2,162,20,142,新光-高雄,2024-03-27,8562
00939,統一台灣高息動能,283,151,132,新光-高雄,2024-03-27,8562
00673R,期元大S＆P原油反1,310,186,124,新光-高雄,2024-03-27,8562
00857B,永豐20年美公債,127,12,115,新光-高雄,2024-03-27,8562
00665L,富邦�琤肭磪囓�2,116,5,111,新光-高雄,2024-03-27,8562
2301,光寶科,142,31,111,新光-高雄,2024-03-27,8562
00753L,中信中國50正2,112,12,100,新光-高雄,2024-03-27,8562
2371,大同,276,187,89,新光-高雄,2024-03-27,8562
00688L,國泰20年美債正2,86,0,86,新光-高雄,2024-03-27,8562
00712,復華富時不動產,83,3,80,新光-高雄,2024-03-27,8562
2317,鴻海,226,154,72,新光-高雄,2024-03-27,8562
1808,潤隆,115,50,65,新光-高雄,2024-03-27,8562
3013,晟銘電,85,20,65,新光-高雄,2024-03-27,8562
2836,高雄銀,64,0,64,新光-高雄,2024-03-27,8562
00941,中信上游半導體,106,45,61,新光-高雄,2024-03-27,8562
8033,雷虎,94,33,61,新光-高雄,2024-03-27,8562
4938,和碩,77,17,60,新光-高雄,2024-03-27,8562
2801,彰銀,58,0,58,新光-高雄,2024-03-27,8562
2615,萬海,54,0,54,新光-高雄,2024-03-27,8562
1513,中興電,167,114,53,新光-高雄,2024-03-27,8562
3231,緯創,72,20,52,新光-高雄,2024-03-27,8562
3027,盛達,54,2,52,新光-高雄,2024-03-27,8562
2303,聯電,64,13,51,新光-高雄,2024-03-27,8562
3706,神達,271,221,50,新光-高雄,2024-03-27,8562
9105,泰金寶-DR,121,75,46,新光-高雄,2024-03-27,8562
2359,所羅門,55,10,45,新光-高雄,2024-03-27,8562
00882,中信中國高股息,80,38,42,新光-高雄,2024-03-27,8562
1605,華新,70,34,36,新光-高雄,2024-03-27,8562
00719B,元大美債1-3,41,6,35,新光-高雄,2024-03-27,8562
1301,台塑,34,0,34,新光-高雄,2024-03-27,8562
6517,保勝光學,45,15,30,新光-高雄,2024-03-27,8562
1603,華電,135,106,29,新光-高雄,2024-03-27,8562
2867,三商壽,28,0,28,新光-高雄,2024-03-27,8562
9933,中鼎,32,5,27,新光-高雄,2024-03-27,8562
1316,上曜,70,44,26,新光-高雄,2024-03-27,8562
1616,億泰,62,36,26,新光-高雄,2024-03-27,8562
1785,光洋科,29,5,24,新光-高雄,2024-03-27,8562
2609,陽明,57,34,23,新光-高雄,2024-03-27,8562
2331,精英,37,15,22,新光-高雄,2024-03-27,8562
3052,夆典,22,0,22,新光-高雄,2024-03-27,8562
4526,東台,101,80,21,新光-高雄,2024-03-27,8562
2002,中鋼,27,6,21,新光-高雄,2024-03-27,8562
3481,群創,51,31,20,新光-高雄,2024-03-27,8562
00772B,中信高評級公司債,20,0,20,新光-高雄,2024-03-27,8562
2409,友達,19,0,19,新光-高雄,2024-03-27,8562
00885,富邦越南,231,3,228,新光-高雄,2024-03-28,8562
00941,中信上游半導體,173,13,160,新光-高雄,2024-03-28,8562
3481,群創,156,4,152,新光-高雄,2024-03-28,8562
2359,所羅門,153,3,150,新光-高雄,2024-03-28,8562
00753L,中信中國50正2,157,33,124,新光-高雄,2024-03-28,8562
2610,華航,127,3,124,新光-高雄,2024-03-28,8562
00939,統一台灣高息動能,221,103,118,新光-高雄,2024-03-28,8562
2801,彰銀,117,1,116,新光-高雄,2024-03-28,8562
3706,神達,207,121,86,新光-高雄,2024-03-28,8562
2888,新光金,85,0,85,新光-高雄,2024-03-28,8562
00751B,元大AAA至A公司債,115,38,77,新光-高雄,2024-03-28,8562
00632R,元大台灣50反1,169,98,71,新光-高雄,2024-03-28,8562
2891,中信金,80,11,69,新光-高雄,2024-03-28,8562
1303,南亞,69,0,69,新光-高雄,2024-03-28,8562
1316,上曜,113,49,64,新光-高雄,2024-03-28,8562
2301,光寶科,89,28,61,新光-高雄,2024-03-28,8562
1597,直得,80,20,60,新光-高雄,2024-03-28,8562
3701,大眾控,117,62,55,新光-高雄,2024-03-28,8562
1301,台塑,54,1,53,新光-高雄,2024-03-28,8562
3002,歐格,51,0,51,新光-高雄,2024-03-28,8562
2442,新美齊,48,0,48,新光-高雄,2024-03-28,8562
00882,中信中國高股息,118,70,48,新光-高雄,2024-03-28,8562
3005,神基,78,33,45,新光-高雄,2024-03-28,8562
6126,信音,47,3,44,新光-高雄,2024-03-28,8562
2867,三商壽,44,1,43,新光-高雄,2024-03-28,8562
00673R,期元大S＆P原油反1,66,24,42,新光-高雄,2024-03-28,8562
2103,台橡,40,1,39,新光-高雄,2024-03-28,8562
00919,群益台灣精選高息,406,368,38,新光-高雄,2024-03-28,8562
1731,美吾華,38,1,37,新光-高雄,2024-03-28,8562
1734,杏輝,32,1,31,新光-高雄,2024-03-28,8562
5515,建國,106,77,29,新光-高雄,2024-03-28,8562
2323,中環,35,6,29,新光-高雄,2024-03-28,8562
3062,建漢,383,354,29,新光-高雄,2024-03-28,8562
2002,中鋼,36,9,27,新光-高雄,2024-03-28,8562
9907,統一實,27,0,27,新光-高雄,2024-03-28,8562
00712,復華富時不動產,30,4,26,新光-高雄,2024-03-28,8562
5469,瀚宇博,54,28,26,新光-高雄,2024-03-28,8562
5533,皇鼎,28,2,26,新光-高雄,2024-03-28,8562
3294,英濟,44,18,26,新光-高雄,2024-03-28,8562
2887,台新金,29,3,26,新光-高雄,2024-03-28,8562
2409,友達,34,9,25,新光-高雄,2024-03-28,8562
1504,東元,133,109,24,新光-高雄,2024-03-28,8562
1907,永豐餘,23,0,23,新光-高雄,2024-03-28,8562
00891,中信關鍵半導體,25,2,23,新光-高雄,2024-03-28,8562
4402,郡都開發,24,2,22,新光-高雄,2024-03-28,8562
6005,群益證,24,2,22,新光-高雄,2024-03-28,8562
1806,冠軍,21,0,21,新光-高雄,2024-03-28,8562
6257,矽格,48,27,21,新光-高雄,2024-03-28,8562
1909,榮成,20,0,20,新光-高雄,2024-03-28,8562
4121,優盛,20,0,20,新光-高雄,2024-03-28,8562
00937B,群益ESG投等債20,431,61,370,新光-高雄,2024-03-29,8562
2324,仁寶,343,24,319,新光-高雄,2024-03-29,8562
1324,地球,408,139,269,新光-高雄,2024-03-29,8562
00751B,元大AAA至A公司債,189,20,169,新光-高雄,2024-03-29,8562
2867,三商壽,157,0,157,新光-高雄,2024-03-29,8562
4958,臻鼎-KY,164,17,147,新光-高雄,2024-03-29,8562
2417,圓剛,150,8,142,新光-高雄,2024-03-29,8562
9105,泰金寶-DR,384,260,124,新光-高雄,2024-03-29,8562
00941,中信上游半導體,143,32,111,新光-高雄,2024-03-29,8562
00939,統一台灣高息動能,135,25,110,新光-高雄,2024-03-29,8562
5371,中光電,137,43,94,新光-高雄,2024-03-29,8562
3013,晟銘電,251,159,92,新光-高雄,2024-03-29,8562
00665L,富邦�琤肭磪囓�2,112,20,92,新光-高雄,2024-03-29,8562
00688L,國泰20年美債正2,96,10,86,新光-高雄,2024-03-29,8562
6505,台塑化,80,2,78,新光-高雄,2024-03-29,8562
3666,光耀,79,4,75,新光-高雄,2024-03-29,8562
2317,鴻海,545,471,74,新光-高雄,2024-03-29,8562
4402,郡都開發,74,1,73,新光-高雄,2024-03-29,8562
2301,光寶科,114,50,64,新光-高雄,2024-03-29,8562
00882,中信中國高股息,71,22,49,新光-高雄,2024-03-29,8562
2409,友達,47,1,46,新光-高雄,2024-03-29,8562
2354,鴻準,186,141,45,新光-高雄,2024-03-29,8562
2382,廣達,223,179,44,新光-高雄,2024-03-29,8562
8039,台虹,44,1,43,新光-高雄,2024-03-29,8562
6016,康和證,53,14,39,新光-高雄,2024-03-29,8562
5201,凱衛,42,3,39,新光-高雄,2024-03-29,8562
5515,建國,48,11,37,新光-高雄,2024-03-29,8562
2303,聯電,110,73,37,新光-高雄,2024-03-29,8562
00753L,中信中國50正2,38,1,37,新光-高雄,2024-03-29,8562
00687B,國泰20年美債,83,47,36,新光-高雄,2024-03-29,8562
3701,大眾控,47,11,36,新光-高雄,2024-03-29,8562
2885,元大金,37,1,36,新光-高雄,2024-03-29,8562
1597,直得,44,10,34,新光-高雄,2024-03-29,8562
3481,群創,38,5,33,新光-高雄,2024-03-29,8562
1616,億泰,37,4,33,新光-高雄,2024-03-29,8562
00637L,元大滬深300正2,59,31,28,新光-高雄,2024-03-29,8562
6257,矽格,28,3,25,新光-高雄,2024-03-29,8562
2353,宏��,92,68,24,新光-高雄,2024-03-29,8562
5512,力麒,33,10,23,新光-高雄,2024-03-29,8562
2359,所羅門,27,5,22,新光-高雄,2024-03-29,8562
3149,正達,23,1,22,新光-高雄,2024-03-29,8562
6176,瑞儀,27,7,20,新光-高雄,2024-03-29,8562
5465,富驊,21,1,20,新光-高雄,2024-03-29,8562
1904,正隆,20,0,20,新光-高雄,2024-03-29,8562
5351,鈺創,21,1,20,新光-高雄,2024-03-29,8562
2889,國票金,22,2,20,新光-高雄,2024-03-29,8562
4513,福裕,30,11,19,新光-高雄,2024-03-29,8562
2328,廣宇,36,18,18,新光-高雄,2024-03-29,8562
3211,順達,30,12,18,新光-高雄,2024-03-29,8562
2460,建通,18,0,18,新光-高雄,2024-03-29,8562
00940,元大台灣價值高息,4227,385,3842,新光-高雄,2024-04-01,8562
00632R,元大台灣50反1,1157,0,1157,新光-高雄,2024-04-01,8562
00919,群益台灣精選高息,487,211,276,新光-高雄,2024-04-01,8562
00929,復華台灣科技優息,352,140,212,新光-高雄,2024-04-01,8562
9105,泰金寶-DR,189,30,159,新光-高雄,2024-04-01,8562
2891,中信金,162,7,155,新光-高雄,2024-04-01,8562
00679B,元大美債20年,154,26,128,新光-高雄,2024-04-01,8562
1309,台達化,107,0,107,新光-高雄,2024-04-01,8562
00882,中信中國高股息,116,10,106,新光-高雄,2024-04-01,8562
3052,夆典,117,21,96,新光-高雄,2024-04-01,8562
2027,大成鋼,94,1,93,新光-高雄,2024-04-01,8562
3231,緯創,145,59,86,新光-高雄,2024-04-01,8562
00941,中信上游半導體,88,5,83,新光-高雄,2024-04-01,8562
00939,統一台灣高息動能,160,77,83,新光-高雄,2024-04-01,8562
2834,臺企銀,91,17,74,新光-高雄,2024-04-01,8562
00712,復華富時不動產,104,36,68,新光-高雄,2024-04-01,8562
00937B,群益ESG投等債20,192,124,68,新光-高雄,2024-04-01,8562
3711,日月光投控,68,11,57,新光-高雄,2024-04-01,8562
3702,大聯大,124,68,56,新光-高雄,2024-04-01,8562
3701,大眾控,53,0,53,新光-高雄,2024-04-01,8562
2367,燿華,162,109,53,新光-高雄,2024-04-01,8562
2359,所羅門,60,8,52,新光-高雄,2024-04-01,8562
3583,辛耘,87,35,52,新光-高雄,2024-04-01,8562
2371,大同,185,135,50,新光-高雄,2024-04-01,8562
2836,高雄銀,58,8,50,新光-高雄,2024-04-01,8562
6120,達運,53,5,48,新光-高雄,2024-04-01,8562
00650L,復華香港正2,46,2,44,新光-高雄,2024-04-01,8562
2883,凱基金,56,12,44,新光-高雄,2024-04-01,8562
1514,亞力,76,33,43,新光-高雄,2024-04-01,8562
1504,東元,73,32,41,新光-高雄,2024-04-01,8562
2382,廣達,119,79,40,新光-高雄,2024-04-01,8562
1582,信錦,44,4,40,新光-高雄,2024-04-01,8562
2352,佳世達,48,9,39,新光-高雄,2024-04-01,8562
2888,新光金,80,46,34,新光-高雄,2024-04-01,8562
1597,直得,57,24,33,新光-高雄,2024-04-01,8562
2603,長榮,100,67,33,新光-高雄,2024-04-01,8562
2301,光寶科,37,6,31,新光-高雄,2024-04-01,8562
00931B,統一美債20年,30,0,30,新光-高雄,2024-04-01,8562
2101,南港,30,0,30,新光-高雄,2024-04-01,8562
00888,永豐台灣ESG,30,1,29,新光-高雄,2024-04-01,8562
3413,京鼎,35,7,28,新光-高雄,2024-04-01,8562
00878,國泰永續高股息,43,16,27,新光-高雄,2024-04-01,8562
2417,圓剛,36,10,26,新光-高雄,2024-04-01,8562
2356,英業達,168,142,26,新光-高雄,2024-04-01,8562
2353,宏��,28,3,25,新光-高雄,2024-04-01,8562
00900,富邦特選高股息30,25,1,24,新光-高雄,2024-04-01,8562
2328,廣宇,30,6,24,新光-高雄,2024-04-01,8562
2449,京元電子,26,3,23,新光-高雄,2024-04-01,8562
2881,富邦金,22,0,22,新光-高雄,2024-04-01,8562
3710,連展投控,30,9,21,新光-高雄,2024-04-01,8562
00632R,元大台灣50反1,759,94,665,新光-高雄,2024-04-02,8562
00937B,群益ESG投等債20,678,78,600,新光-高雄,2024-04-02,8562
00940,元大台灣價值高息,1145,547,598,新光-高雄,2024-04-02,8562
00929,復華台灣科技優息,1112,643,469,新光-高雄,2024-04-02,8562
00687B,國泰20年美債,363,59,304,新光-高雄,2024-04-02,8562
00680L,元大美債20正2,814,528,286,新光-高雄,2024-04-02,8562
00720B,元大投資級公司債,254,30,224,新光-高雄,2024-04-02,8562
00688L,國泰20年美債正2,256,35,221,新光-高雄,2024-04-02,8562
2610,華航,225,11,214,新光-高雄,2024-04-02,8562
6207,雷科,291,80,211,新光-高雄,2024-04-02,8562
00941,中信上游半導體,221,15,206,新光-高雄,2024-04-02,8562
00933B,國泰10Y+金融債,178,4,174,新光-高雄,2024-04-02,8562
00673R,期元大S＆P原油反1,145,10,135,新光-高雄,2024-04-02,8562
1309,台達化,84,0,84,新光-高雄,2024-04-02,8562
00712,復華富時不動產,89,6,83,新光-高雄,2024-04-02,8562
00857B,永豐20年美公債,73,3,70,新光-高雄,2024-04-02,8562
2027,大成鋼,70,1,69,新光-高雄,2024-04-02,8562
2834,臺企銀,80,12,68,新光-高雄,2024-04-02,8562
00679B,元大美債20年,87,21,66,新光-高雄,2024-04-02,8562
2618,長榮航,63,1,62,新光-高雄,2024-04-02,8562
2506,太設,60,0,60,新光-高雄,2024-04-02,8562
4714,永捷,67,10,57,新光-高雄,2024-04-02,8562
5371,中光電,84,31,53,新光-高雄,2024-04-02,8562
00931B,統一美債20年,57,5,52,新光-高雄,2024-04-02,8562
6215,和椿,71,20,51,新光-高雄,2024-04-02,8562
2492,華新科,137,89,48,新光-高雄,2024-04-02,8562
1218,泰山,45,0,45,新光-高雄,2024-04-02,8562
2009,第一銅,112,68,44,新光-高雄,2024-04-02,8562
6120,達運,149,111,38,新光-高雄,2024-04-02,8562
1605,華新,56,17,39,新光-高雄,2024-04-02,8562
00795B,中信美國公債20年,35,0,35,新光-高雄,2024-04-02,8562
00772B,中信高評級公司債,33,0,33,新光-高雄,2024-04-02,8562
020033,統一�琤肮黕篾,33,0,33,新光-高雄,2024-04-02,8562
2883,凱基金,44,12,32,新光-高雄,2024-04-02,8562
3587,閎康,33,2,31,新光-高雄,2024-04-02,8562
3706,神達,62,32,30,新光-高雄,2024-04-02,8562
1314,中石化,52,22,30,新光-高雄,2024-04-02,8562
2537,聯上發,182,152,30,新光-高雄,2024-04-02,8562
6148,驊宏資,30,0,30,新光-高雄,2024-04-02,8562
2608,嘉里大榮,30,0,30,新光-高雄,2024-04-02,8562
1717,長興,48,21,27,新光-高雄,2024-04-02,8562
1608,華榮,37,10,27,新光-高雄,2024-04-02,8562
2323,中環,25,0,25,新光-高雄,2024-04-02,8562
00909,國泰數位支付服務,26,2,24,新光-高雄,2024-04-02,8562
2356,英業達,85,61,24,新光-高雄,2024-04-02,8562
6177,達麗,54,30,24,新光-高雄,2024-04-02,8562
6548,長科*,27,5,22,新光-高雄,2024-04-02,8562
6284,佳邦,22,0,22,新光-高雄,2024-04-02,8562
3260,威剛,29,7,22,新光-高雄,2024-04-02,8562
00751B,元大AAA至A公司債,47,26,21,新光-高雄,2024-04-02,8562
00929,復華台灣科技優息,2965,62,2903,新光-高雄,2024-04-03,8562
00937B,群益ESG投等債20,1014,222,792,新光-高雄,2024-04-03,8562
00940,元大台灣價值高息,742,208,534,新光-高雄,2024-04-03,8562
00680L,元大美債20正2,536,125,411,新光-高雄,2024-04-03,8562
00687B,國泰20年美債,254,36,218,新光-高雄,2024-04-03,8562
00688L,國泰20年美債正2,173,0,173,新光-高雄,2024-04-03,8562
2486,一詮,476,341,135,新光-高雄,2024-04-03,8562
00679B,元大美債20年,162,31,131,新光-高雄,2024-04-03,8562
3481,群創,199,75,124,新光-高雄,2024-04-03,8562
00665L,富邦�琤肭磪囓�2,130,20,110,新光-高雄,2024-04-03,8562
2851,中再保,106,0,106,新光-高雄,2024-04-03,8562
00941,中信上游半導體,144,39,105,新光-高雄,2024-04-03,8562
4915,致伸,100,1,99,新光-高雄,2024-04-03,8562
2618,長榮航,103,5,98,新光-高雄,2024-04-03,8562
9105,泰金寶-DR,97,1,96,新光-高雄,2024-04-03,8562
5371,中光電,113,20,93,新光-高雄,2024-04-03,8562
2515,中工,387,296,91,新光-高雄,2024-04-03,8562
2801,彰銀,89,0,89,新光-高雄,2024-04-03,8562
2317,鴻海,225,140,85,新光-高雄,2024-04-03,8562
00857B,永豐20年美公債,83,0,83,新光-高雄,2024-04-03,8562
00927,群益半導體收益,81,5,76,新光-高雄,2024-04-03,8562
0056,元大高股息,80,6,74,新光-高雄,2024-04-03,8562
00795B,中信美國公債20年,71,0,71,新光-高雄,2024-04-03,8562
3535,晶彩科,197,126,71,新光-高雄,2024-04-03,8562
00900,富邦特選高股息30,72,3,69,新光-高雄,2024-04-03,8562
00751B,元大AAA至A公司債,133,70,63,新光-高雄,2024-04-03,8562
1522,堤維西,74,12,62,新光-高雄,2024-04-03,8562
2610,華航,99,38,61,新光-高雄,2024-04-03,8562
00753L,中信中國50正2,61,3,58,新光-高雄,2024-04-03,8562
2547,日勝生,61,3,58,新光-高雄,2024-04-03,8562
3059,華晶科,98,41,57,新光-高雄,2024-04-03,8562
5443,均豪,205,157,48,新光-高雄,2024-04-03,8562
6112,邁達特,48,1,47,新光-高雄,2024-04-03,8562
2527,宏璟,47,3,44,新光-高雄,2024-04-03,8562
2101,南港,43,0,43,新光-高雄,2024-04-03,8562
00933B,國泰10Y+金融債,125,83,42,新光-高雄,2024-04-03,8562
1785,光洋科,55,13,42,新光-高雄,2024-04-03,8562
2609,陽明,43,2,41,新光-高雄,2024-04-03,8562
2408,南亞科,47,8,39,新光-高雄,2024-04-03,8562
00720B,元大投資級公司債,52,14,38,新光-高雄,2024-04-03,8562
4401,東隆興,37,0,37,新光-高雄,2024-04-03,8562
2881,富邦金,40,4,36,新光-高雄,2024-04-03,8562
00712,復華富時不動產,41,6,35,新光-高雄,2024-04-03,8562
020033,統一�琤肮黕篾,33,0,33,新光-高雄,2024-04-03,8562
00646,元大S＆P500,33,0,33,新光-高雄,2024-04-03,8562
5864,致和證,53,21,32,新光-高雄,2024-04-03,8562
00939,統一台灣高息動能,83,51,32,新光-高雄,2024-04-03,8562
2344,華邦電,80,50,30,新光-高雄,2024-04-03,8562
2412,中華電,76,46,30,新光-高雄,2024-04-03,8562
00888,永豐台灣ESG,30,0,30,新光-高雄,2024-04-03,8562
00929,復華台灣科技優息,1076,138,938,新光-高雄,2024-04-08,8562
00937B,群益ESG投等債20,486,12,474,新光-高雄,2024-04-08,8562
2374,佳能,553,106,447,新光-高雄,2024-04-08,8562
00679B,元大美債20年,404,18,386,新光-高雄,2024-04-08,8562
00715L,期街口布蘭特正2,476,104,372,新光-高雄,2024-04-08,8562
00940,元大台灣價值高息,469,118,351,新光-高雄,2024-04-08,8562
00687B,國泰20年美債,309,18,291,新光-高雄,2024-04-08,8562
00680L,元大美債20正2,455,197,258,新光-高雄,2024-04-08,8562
00637L,元大滬深300正2,289,37,252,新光-高雄,2024-04-08,8562
00673R,期元大S＆P原油反1,217,0,217,新光-高雄,2024-04-08,8562
2353,宏��,199,1,198,新光-高雄,2024-04-08,8562
00632R,元大台灣50反1,264,85,179,新光-高雄,2024-04-08,8562
00919,群益台灣精選高息,289,117,172,新光-高雄,2024-04-08,8562
00933B,國泰10Y+金融債,153,13,140,新光-高雄,2024-04-08,8562
6899,創為精密,138,1,137,新光-高雄,2024-04-08,8562
00751B,元大AAA至A公司債,123,7,116,新光-高雄,2024-04-08,8562
00931B,統一美債20年,105,0,105,新光-高雄,2024-04-08,8562
2486,一詮,321,217,104,新光-高雄,2024-04-08,8562
6120,達運,219,117,102,新光-高雄,2024-04-08,8562
00795B,中信美國公債20年,100,0,100,新光-高雄,2024-04-08,8562
00753L,中信中國50正2,90,6,84,新光-高雄,2024-04-08,8562
00941,中信上游半導體,89,8,81,新光-高雄,2024-04-08,8562
00857B,永豐20年美公債,78,2,76,新光-高雄,2024-04-08,8562
6005,群益證,126,51,75,新光-高雄,2024-04-08,8562
1597,直得,86,14,72,新光-高雄,2024-04-08,8562
2867,三商壽,100,30,70,新光-高雄,2024-04-08,8562
4915,致伸,70,0,70,新光-高雄,2024-04-08,8562
1227,佳格,68,0,68,新光-高雄,2024-04-08,8562
6016,康和證,91,25,66,新光-高雄,2024-04-08,8562
1603,華電,59,5,54,新光-高雄,2024-04-08,8562
00688L,國泰20年美債正2,115,66,49,新光-高雄,2024-04-08,8562
2527,宏璟,67,21,46,新光-高雄,2024-04-08,8562
3188,鑫龍騰,52,6,46,新光-高雄,2024-04-08,8562
00720B,元大投資級公司債,56,14,42,新光-高雄,2024-04-08,8562
2382,廣達,71,30,41,新光-高雄,2024-04-08,8562
2506,太設,40,0,40,新光-高雄,2024-04-08,8562
00909,國泰數位支付服務,39,0,39,新光-高雄,2024-04-08,8562
3052,夆典,40,6,34,新光-高雄,2024-04-08,8562
6104,創惟,34,1,33,新光-高雄,2024-04-08,8562
6015,宏遠證,37,5,32,新光-高雄,2024-04-08,8562
6288,聯嘉,61,32,29,新光-高雄,2024-04-08,8562
2101,南港,28,0,28,新光-高雄,2024-04-08,8562
3413,京鼎,36,8,28,新光-高雄,2024-04-08,8562
1612,宏泰,75,48,27,新光-高雄,2024-04-08,8562
8085,福華,34,7,27,新光-高雄,2024-04-08,8562
8210,勤誠,38,12,26,新光-高雄,2024-04-08,8562
3231,緯創,138,113,25,新光-高雄,2024-04-08,8562
00712,復華富時不動產,64,41,23,新光-高雄,2024-04-08,8562
2368,金像電,28,6,22,新光-高雄,2024-04-08,8562
2317,鴻海,170,148,22,新光-高雄,2024-04-08,8562
00929,復華台灣科技優息,1152,148,1004,新光-高雄,2024-04-09,8562
00673R,期元大S＆P原油反1,249,0,249,新光-高雄,2024-04-09,8562
00937B,群益ESG投等債20,252,12,240,新光-高雄,2024-04-09,8562
3481,群創,379,192,187,新光-高雄,2024-04-09,8562
2486,一詮,385,213,172,新光-高雄,2024-04-09,8562
00687B,國泰20年美債,192,27,165,新光-高雄,2024-04-09,8562
00720B,元大投資級公司債,175,14,161,新光-高雄,2024-04-09,8562
00679B,元大美債20年,174,15,159,新光-高雄,2024-04-09,8562
8033,雷虎,157,16,141,新光-高雄,2024-04-09,8562
2101,南港,126,6,120,新光-高雄,2024-04-09,8562
00857B,永豐20年美公債,129,16,113,新光-高雄,2024-04-09,8562
00753L,中信中國50正2,110,14,96,新光-高雄,2024-04-09,8562
1309,台達化,96,2,94,新光-高雄,2024-04-09,8562
1522,堤維西,92,3,89,新光-高雄,2024-04-09,8562
1313,聯成,89,4,85,新光-高雄,2024-04-09,8562
2537,聯上發,108,23,85,新光-高雄,2024-04-09,8562
2834,臺企銀,103,30,73,新光-高雄,2024-04-09,8562
00795B,中信美國公債20年,65,2,63,新光-高雄,2024-04-09,8562
2515,中工,162,100,62,新光-高雄,2024-04-09,8562
00715L,期街口布蘭特正2,71,10,61,新光-高雄,2024-04-09,8562
00642U,期元大S＆P石油,63,3,60,新光-高雄,2024-04-09,8562
2329,華泰,59,4,55,新光-高雄,2024-04-09,8562
1440,南紡,55,1,54,新光-高雄,2024-04-09,8562
9105,泰金寶-DR,48,0,48,新光-高雄,2024-04-09,8562
2367,燿華,83,37,46,新光-高雄,2024-04-09,8562
00941,中信上游半導體,46,2,44,新光-高雄,2024-04-09,8562
00637L,元大滬深300正2,74,30,44,新光-高雄,2024-04-09,8562
3052,夆典,46,2,44,新光-高雄,2024-04-09,8562
6899,創為精密,45,1,44,新光-高雄,2024-04-09,8562
2405,輔信,54,13,41,新光-高雄,2024-04-09,8562
1909,榮成,42,1,41,新光-高雄,2024-04-09,8562
2547,日勝生,45,5,40,新光-高雄,2024-04-09,8562
2506,太設,40,0,40,新光-高雄,2024-04-09,8562
2374,佳能,97,57,40,新光-高雄,2024-04-09,8562
2542,興富發,65,26,39,新光-高雄,2024-04-09,8562
1314,中石化,105,66,39,新光-高雄,2024-04-09,8562
6227,茂綸,63,27,36,新光-高雄,2024-04-09,8562
6603,富強鑫,109,73,36,新光-高雄,2024-04-09,8562
2371,大同,102,67,35,新光-高雄,2024-04-09,8562
2313,華通,71,38,33,新光-高雄,2024-04-09,8562
6213,聯茂,131,99,32,新光-高雄,2024-04-09,8562
1304,台聚,46,15,31,新光-高雄,2024-04-09,8562
00676R,富邦臺灣加權反1,30,0,30,新光-高雄,2024-04-09,8562
00939,統一台灣高息動能,42,13,29,新光-高雄,2024-04-09,8562
00688L,國泰20年美債正2,59,31,28,新光-高雄,2024-04-09,8562
2421,建準,36,9,27,新光-高雄,2024-04-09,8562
9940,信義,30,4,26,新光-高雄,2024-04-09,8562
6189,豐藝,162,137,25,新光-高雄,2024-04-09,8562
00940,元大台灣價值高息,159,134,25,新光-高雄,2024-04-09,8562
020033,統一�琤肮黕篾,24,0,24,新光-高雄,2024-04-09,8562
00937B,群益ESG投等債20,353,21,332,新光-高雄,2024-04-10,8562
2834,臺企銀,476,207,269,新光-高雄,2024-04-10,8562
1313,聯成,239,2,237,新光-高雄,2024-04-10,8562
2009,第一銅,320,95,225,新光-高雄,2024-04-10,8562
00632R,元大台灣50反1,234,57,177,新光-高雄,2024-04-10,8562
00673R,期元大S＆P原油反1,149,0,149,新光-高雄,2024-04-10,8562
2515,中工,251,109,142,新光-高雄,2024-04-10,8562
2537,聯上發,209,84,125,新光-高雄,2024-04-10,8562
2317,鴻海,237,127,110,新光-高雄,2024-04-10,8562
2867,三商壽,138,29,109,新光-高雄,2024-04-10,8562
00715L,期街口布蘭特正2,104,20,84,新光-高雄,2024-04-10,8562
2486,一詮,132,74,58,新光-高雄,2024-04-10,8562
5371,中光電,75,19,56,新光-高雄,2024-04-10,8562
1609,大亞,400,347,53,新光-高雄,2024-04-10,8562
2511,太子,57,5,52,新光-高雄,2024-04-10,8562
00679B,元大美債20年,58,10,48,新光-高雄,2024-04-10,8562
00772B,中信高評級公司債,50,2,48,新光-高雄,2024-04-10,8562
00940,元大台灣價值高息,194,146,48,新光-高雄,2024-04-10,8562
00733,富邦臺灣中小,50,3,47,新光-高雄,2024-04-10,8562
2002,中鋼,152,105,47,新光-高雄,2024-04-10,8562
00909,國泰數位支付服務,46,0,46,新光-高雄,2024-04-10,8562
3059,華晶科,201,156,45,新光-高雄,2024-04-10,8562
2812,台中銀,69,25,44,新光-高雄,2024-04-10,8562
1522,堤維西,47,4,43,新光-高雄,2024-04-10,8562
00720B,元大投資級公司債,45,4,41,新光-高雄,2024-04-10,8562
2801,彰銀,41,0,41,新光-高雄,2024-04-10,8562
2376,技嘉,79,39,40,新光-高雄,2024-04-10,8562
00712,復華富時不動產,42,2,40,新光-高雄,2024-04-10,8562
2634,漢翔,116,76,40,新光-高雄,2024-04-10,8562
5347,世界,48,8,40,新光-高雄,2024-04-10,8562
1608,華榮,100,60,40,新光-高雄,2024-04-10,8562
6223,旺矽,43,6,37,新光-高雄,2024-04-10,8562
1513,中興電,108,71,37,新光-高雄,2024-04-10,8562
5324,士開,37,1,36,新光-高雄,2024-04-10,8562
2610,華航,37,2,35,新光-高雄,2024-04-10,8562
2328,廣宇,40,6,34,新光-高雄,2024-04-10,8562
2367,燿華,87,58,29,新光-高雄,2024-04-10,8562
5864,致和證,53,25,28,新光-高雄,2024-04-10,8562
1605,華新,93,66,27,新光-高雄,2024-04-10,8562
2014,中鴻,111,85,26,新光-高雄,2024-04-10,8562
1808,潤隆,41,15,26,新光-高雄,2024-04-10,8562
00857B,永豐20年美公債,26,0,26,新光-高雄,2024-04-10,8562
8358,金居,51,25,26,新光-高雄,2024-04-10,8562
1312,國喬,25,0,25,新光-高雄,2024-04-10,8562
3504,揚明光,33,9,24,新光-高雄,2024-04-10,8562
3038,全台,27,3,24,新光-高雄,2024-04-10,8562
00687B,國泰20年美債,47,24,23,新光-高雄,2024-04-10,8562
8121,越峰,22,0,22,新光-高雄,2024-04-10,8562
6015,宏遠證,37,15,22,新光-高雄,2024-04-10,8562
2506,太設,22,0,22,新光-高雄,2024-04-10,8562
00929,復華台灣科技優息,1161,244,917,新光-高雄,2024-04-11,8562
00937B,群益ESG投等債20,823,25,798,新光-高雄,2024-04-11,8562
00680L,元大美債20正2,682,264,418,新光-高雄,2024-04-11,8562
00712,復華富時不動產,356,37,319,新光-高雄,2024-04-11,8562
3481,群創,385,78,307,新光-高雄,2024-04-11,8562
00687B,國泰20年美債,364,76,288,新光-高雄,2024-04-11,8562
00679B,元大美債20年,382,156,226,新光-高雄,2024-04-11,8562
00900,富邦特選高股息30,222,13,209,新光-高雄,2024-04-11,8562
00720B,元大投資級公司債,189,20,169,新光-高雄,2024-04-11,8562
4915,致伸,156,0,156,新光-高雄,2024-04-11,8562
00795B,中信美國公債20年,163,7,156,新光-高雄,2024-04-11,8562
4303,信立,161,12,149,新光-高雄,2024-04-11,8562
9105,泰金寶-DR,140,0,140,新光-高雄,2024-04-11,8562
00665L,富邦�琤肭磪囓�2,335,200,135,新光-高雄,2024-04-11,8562
00933B,國泰10Y+金融債,155,28,127,新光-高雄,2024-04-11,8562
0056,元大高股息,122,5,117,新光-高雄,2024-04-11,8562
3052,夆典,100,5,95,新光-高雄,2024-04-11,8562
4938,和碩,93,7,86,新光-高雄,2024-04-11,8562
00940,元大台灣價值高息,128,58,70,新光-高雄,2024-04-11,8562
5521,工信,84,15,69,新光-高雄,2024-04-11,8562
2881,富邦金,64,5,59,新光-高雄,2024-04-11,8562
4716,大立,57,4,53,新光-高雄,2024-04-11,8562
6120,達運,52,1,51,新光-高雄,2024-04-11,8562
00931B,統一美債20年,56,5,51,新光-高雄,2024-04-11,8562
6290,良維,87,36,51,新光-高雄,2024-04-11,8562
1597,直得,58,8,50,新光-高雄,2024-04-11,8562
00733,富邦臺灣中小,54,4,50,新光-高雄,2024-04-11,8562
1313,聯成,49,0,49,新光-高雄,2024-04-11,8562
4609,唐鋒,49,0,49,新光-高雄,2024-04-11,8562
3266,昇陽,50,1,49,新光-高雄,2024-04-11,8562
00715L,期街口布蘭特正2,137,88,49,新光-高雄,2024-04-11,8562
00751B,元大AAA至A公司債,51,3,48,新光-高雄,2024-04-11,8562
3686,達能,63,15,48,新光-高雄,2024-04-11,8562
00673R,期元大S＆P原油反1,47,0,47,新光-高雄,2024-04-11,8562
2834,臺企銀,53,9,44,新光-高雄,2024-04-11,8562
3033,威健,58,20,38,新光-高雄,2024-04-11,8562
2883,凱基金,59,25,34,新光-高雄,2024-04-11,8562
3450,聯鈞,46,13,33,新光-高雄,2024-04-11,8562
3260,威剛,58,26,32,新光-高雄,2024-04-11,8562
2409,友達,66,35,31,新光-高雄,2024-04-11,8562
1514,亞力,265,233,32,新光-高雄,2024-04-11,8562
00857B,永豐20年美公債,30,0,30,新光-高雄,2024-04-11,8562
2630,亞航,52,22,30,新光-高雄,2024-04-11,8562
2303,聯電,66,38,28,新光-高雄,2024-04-11,8562
3231,緯創,86,58,28,新光-高雄,2024-04-11,8562
00878,國泰永續高股息,37,10,27,新光-高雄,2024-04-11,8562
00939,統一台灣高息動能,51,26,25,新光-高雄,2024-04-11,8562
2867,三商壽,25,0,25,新光-高雄,2024-04-11,8562
5864,致和證,25,0,25,新光-高雄,2024-04-11,8562
2605,新興,101,76,25,新光-高雄,2024-04-11,8562
00937B,群益ESG投等債20,679,4,675,新光-高雄,2024-04-12,8562
00687B,國泰20年美債,270,4,266,新光-高雄,2024-04-12,8562
00929,復華台灣科技優息,489,237,252,新光-高雄,2024-04-12,8562
8096,擎亞,353,106,247,新光-高雄,2024-04-12,8562
00665L,富邦�琤肭磪囓�2,714,483,231,新光-高雄,2024-04-12,8562
2353,宏��,376,155,221,新光-高雄,2024-04-12,8562
00933B,國泰10Y+金融債,188,3,185,新光-高雄,2024-04-12,8562
00712,復華富時不動產,166,29,137,新光-高雄,2024-04-12,8562
00720B,元大投資級公司債,130,0,130,新光-高雄,2024-04-12,8562
2881,富邦金,123,2,121,新光-高雄,2024-04-12,8562
00679B,元大美債20年,152,37,115,新光-高雄,2024-04-12,8562
2834,臺企銀,107,10,97,新光-高雄,2024-04-12,8562
00688L,國泰20年美債正2,110,18,92,新光-高雄,2024-04-12,8562
00751B,元大AAA至A公司債,89,1,88,新光-高雄,2024-04-12,8562
00940,元大台灣價值高息,307,221,86,新光-高雄,2024-04-12,8562
2317,鴻海,177,96,81,新光-高雄,2024-04-12,8562
2363,矽統,846,766,80,新光-高雄,2024-04-12,8562
2882,國泰金,91,13,78,新光-高雄,2024-04-12,8562
00795B,中信美國公債20年,92,20,72,新光-高雄,2024-04-12,8562
00715L,期街口布蘭特正2,83,11,72,新光-高雄,2024-04-12,8562
5347,世界,98,29,69,新光-高雄,2024-04-12,8562
00878,國泰永續高股息,99,35,64,新光-高雄,2024-04-12,8562
4938,和碩,74,13,61,新光-高雄,2024-04-12,8562
2618,長榮航,70,12,58,新光-高雄,2024-04-12,8562
2465,麗臺,83,26,57,新光-高雄,2024-04-12,8562
2501,國建,79,23,56,新光-高雄,2024-04-12,8562
2382,廣達,77,21,56,新光-高雄,2024-04-12,8562
2344,華邦電,168,115,53,新光-高雄,2024-04-12,8562
00675L,富邦臺灣加權正2,52,0,52,新光-高雄,2024-04-12,8562
00927,群益半導體收益,51,0,51,新光-高雄,2024-04-12,8562
0056,元大高股息,52,4,48,新光-高雄,2024-04-12,8562
2547,日勝生,62,15,47,新光-高雄,2024-04-12,8562
5234,達興材料,100,57,43,新光-高雄,2024-04-12,8562
2820,華票,43,1,42,新光-高雄,2024-04-12,8562
1301,台塑,50,10,40,新光-高雄,2024-04-12,8562
5009,榮剛,44,5,39,新光-高雄,2024-04-12,8562
2883,凱基金,93,54,39,新光-高雄,2024-04-12,8562
6120,達運,65,27,38,新光-高雄,2024-04-12,8562
2329,華泰,63,26,37,新光-高雄,2024-04-12,8562
00637L,元大滬深300正2,67,31,36,新光-高雄,2024-04-12,8562
5533,皇鼎,36,0,36,新光-高雄,2024-04-12,8562
1603,華電,69,34,35,新光-高雄,2024-04-12,8562
2323,中環,35,0,35,新光-高雄,2024-04-12,8562
2492,華新科,40,5,35,新光-高雄,2024-04-12,8562
1605,華新,74,40,34,新光-高雄,2024-04-12,8562
2393,億光,36,2,34,新光-高雄,2024-04-12,8562
1453,大將,39,6,33,新光-高雄,2024-04-12,8562
00857B,永豐20年美公債,35,2,33,新光-高雄,2024-04-12,8562
9940,信義,33,0,33,新光-高雄,2024-04-12,8562
1101,台泥,34,2,32,新光-高雄,2024-04-12,8562
00929,復華台灣科技優息,1393,223,1170,新光-高雄,2024-04-15,8562
00940,元大台灣價值高息,397,84,313,新光-高雄,2024-04-15,8562
00900,富邦特選高股息30,221,12,209,新光-高雄,2024-04-15,8562
00632R,元大台灣50反1,356,170,186,新光-高雄,2024-04-15,8562
00937B,群益ESG投等債20,199,26,173,新光-高雄,2024-04-15,8562
00679B,元大美債20年,170,16,154,新光-高雄,2024-04-15,8562
0056,元大高股息,170,37,133,新光-高雄,2024-04-15,8562
00939,統一台灣高息動能,151,20,131,新光-高雄,2024-04-15,8562
1210,大成,129,3,126,新光-高雄,2024-04-15,8562
00878,國泰永續高股息,174,56,118,新光-高雄,2024-04-15,8562
2367,燿華,199,82,117,新光-高雄,2024-04-15,8562
00927,群益半導體收益,102,4,98,新光-高雄,2024-04-15,8562
00795B,中信美國公債20年,93,7,86,新光-高雄,2024-04-15,8562
2371,大同,379,297,82,新光-高雄,2024-04-15,8562
2515,中工,127,47,80,新光-高雄,2024-04-15,8562
1513,中興電,209,133,76,新光-高雄,2024-04-15,8562
2103,台橡,60,0,60,新光-高雄,2024-04-15,8562
00933B,國泰10Y+金融債,61,5,56,新光-高雄,2024-04-15,8562
00720B,元大投資級公司債,49,0,49,新光-高雄,2024-04-15,8562
00857B,永豐20年美公債,47,0,47,新光-高雄,2024-04-15,8562
3630,新鉅科,46,0,46,新光-高雄,2024-04-15,8562
3289,宜特,75,30,45,新光-高雄,2024-04-15,8562
4306,炎洲,50,6,44,新光-高雄,2024-04-15,8562
2618,長榮航,567,524,43,新光-高雄,2024-04-15,8562
3481,群創,150,108,42,新光-高雄,2024-04-15,8562
2002,中鋼,47,6,41,新光-高雄,2024-04-15,8562
3491,昇達科,43,2,41,新光-高雄,2024-04-15,8562
2374,佳能,68,28,40,新光-高雄,2024-04-15,8562
2485,兆赫,45,5,40,新光-高雄,2024-04-15,8562
4720,德淵,40,0,40,新光-高雄,2024-04-15,8562
2340,台亞,39,0,39,新光-高雄,2024-04-15,8562
1605,華新,191,152,39,新光-高雄,2024-04-15,8562
1608,華榮,205,166,39,新光-高雄,2024-04-15,8562
00751B,元大AAA至A公司債,43,6,37,新光-高雄,2024-04-15,8562
1609,大亞,152,116,36,新光-高雄,2024-04-15,8562
2883,凱基金,52,16,36,新光-高雄,2024-04-15,8562
00712,復華富時不動產,42,8,34,新光-高雄,2024-04-15,8562
6120,達運,38,4,34,新光-高雄,2024-04-15,8562
2501,國建,72,38,34,新光-高雄,2024-04-15,8562
3037,欣興,46,12,34,新光-高雄,2024-04-15,8562
1618,合機,112,80,32,新光-高雄,2024-04-15,8562
3231,緯創,90,58,32,新光-高雄,2024-04-15,8562
3712,永崴投控,83,53,30,新光-高雄,2024-04-15,8562
00788B,元大10年IG電能債,30,0,30,新光-高雄,2024-04-15,8562
2636,台驊控股,31,1,30,新光-高雄,2024-04-15,8562
2344,華邦電,127,97,30,新光-高雄,2024-04-15,8562
2704,國賓,36,7,29,新光-高雄,2024-04-15,8562
2014,中鴻,41,12,29,新光-高雄,2024-04-15,8562
1612,宏泰,151,122,29,新光-高雄,2024-04-15,8562
4533,協易機,307,278,29,新光-高雄,2024-04-15,8562
00937B,群益ESG投等債20,1887,104,1783,新光-高雄,2024-04-16,8562
00929,復華台灣科技優息,1722,680,1042,新光-高雄,2024-04-16,8562
00940,元大台灣價值高息,1723,854,869,新光-高雄,2024-04-16,8562
00919,群益台灣精選高息,1029,476,553,新光-高雄,2024-04-16,8562
00878,國泰永續高股息,476,75,401,新光-高雄,2024-04-16,8562
00720B,元大投資級公司債,377,3,374,新光-高雄,2024-04-16,8562
00679B,元大美債20年,332,33,299,新光-高雄,2024-04-16,8562
00939,統一台灣高息動能,397,102,295,新光-高雄,2024-04-16,8562
0056,元大高股息,330,36,294,新光-高雄,2024-04-16,8562
00900,富邦特選高股息30,268,19,249,新光-高雄,2024-04-16,8562
2888,新光金,264,27,237,新光-高雄,2024-04-16,8562
6269,台郡,192,21,171,新光-高雄,2024-04-16,8562
00665L,富邦�琤肭磪囓�2,594,442,152,新光-高雄,2024-04-16,8562
2834,臺企銀,165,17,148,新光-高雄,2024-04-16,8562
1609,大亞,725,580,145,新光-高雄,2024-04-16,8562
3499,環天科,100,1,99,新光-高雄,2024-04-16,8562
1597,直得,112,13,99,新光-高雄,2024-04-16,8562
2618,長榮航,104,14,90,新光-高雄,2024-04-16,8562
4402,郡都開發,89,6,83,新光-高雄,2024-04-16,8562
2401,凌陽,113,42,71,新光-高雄,2024-04-16,8562
00753L,中信中國50正2,68,0,68,新光-高雄,2024-04-16,8562
2812,台中銀,81,13,68,新光-高雄,2024-04-16,8562
9105,泰金寶-DR,67,0,67,新光-高雄,2024-04-16,8562
3062,建漢,68,2,66,新光-高雄,2024-04-16,8562
2303,聯電,113,48,65,新光-高雄,2024-04-16,8562
3481,群創,232,169,63,新光-高雄,2024-04-16,8562
5864,致和證,65,2,63,新光-高雄,2024-04-16,8562
3260,威剛,130,67,63,新光-高雄,2024-04-16,8562
5533,皇鼎,61,0,61,新光-高雄,2024-04-16,8562
5880,合庫金,61,0,61,新光-高雄,2024-04-16,8562
2887,台新金,80,20,60,新光-高雄,2024-04-16,8562
6237,驊訊,60,2,58,新光-高雄,2024-04-16,8562
00885,富邦越南,60,2,58,新光-高雄,2024-04-16,8562
2308,台達電,61,5,56,新光-高雄,2024-04-16,8562
2515,中工,85,30,55,新光-高雄,2024-04-16,8562
2886,兆豐金,61,7,54,新光-高雄,2024-04-16,8562
2408,南亞科,61,7,54,新光-高雄,2024-04-16,8562
3231,緯創,114,62,52,新光-高雄,2024-04-16,8562
2344,華邦電,199,150,49,新光-高雄,2024-04-16,8562
00795B,中信美國公債20年,47,0,47,新光-高雄,2024-04-16,8562
3059,華晶科,86,39,47,新光-高雄,2024-04-16,8562
2367,燿華,165,119,46,新光-高雄,2024-04-16,8562
00918,大華優利高填息30,120,74,46,新光-高雄,2024-04-16,8562
2603,長榮,86,41,45,新光-高雄,2024-04-16,8562
4306,炎洲,48,4,44,新光-高雄,2024-04-16,8562
00751B,元大AAA至A公司債,44,1,43,新光-高雄,2024-04-16,8562
00941,中信上游半導體,112,72,40,新光-高雄,2024-04-16,8562
2023,燁輝,41,3,38,新光-高雄,2024-04-16,8562
1409,新纖,38,0,38,新光-高雄,2024-04-16,8562
1522,堤維西,52,14,38,新光-高雄,2024-04-16,8562
00937B,群益ESG投等債20,1066,196,870,新光-高雄,2024-04-17,8562
1504,東元,501,179,322,新光-高雄,2024-04-17,8562
00929,復華台灣科技優息,386,101,285,新光-高雄,2024-04-17,8562
00940,元大台灣價值高息,333,50,283,新光-高雄,2024-04-17,8562
00720B,元大投資級公司債,212,30,182,新光-高雄,2024-04-17,8562
00712,復華富時不動產,183,3,180,新光-高雄,2024-04-17,8562
0056,元大高股息,246,83,163,新光-高雄,2024-04-17,8562
00687B,國泰20年美債,160,10,150,新光-高雄,2024-04-17,8562
00857B,永豐20年美公債,164,21,143,新光-高雄,2024-04-17,8562
00679B,元大美債20年,190,67,123,新光-高雄,2024-04-17,8562
00665L,富邦�琤肭磪囓�2,378,273,105,新光-高雄,2024-04-17,8562
00933B,國泰10Y+金融債,103,0,103,新光-高雄,2024-04-17,8562
2888,新光金,102,18,84,新光-高雄,2024-04-17,8562
6770,力積電,78,1,77,新光-高雄,2024-04-17,8562
00637L,元大滬深300正2,134,65,69,新光-高雄,2024-04-17,8562
2618,長榮航,81,16,65,新光-高雄,2024-04-17,8562
00918,大華優利高填息30,79,14,65,新光-高雄,2024-04-17,8562
1101,台泥,86,22,64,新光-高雄,2024-04-17,8562
3231,緯創,111,47,64,新光-高雄,2024-04-17,8562
2603,長榮,120,56,64,新光-高雄,2024-04-17,8562
2101,南港,81,19,62,新光-高雄,2024-04-17,8562
4532,瑞智,87,26,61,新光-高雄,2024-04-17,8562
2887,台新金,66,6,60,新光-高雄,2024-04-17,8562
00941,中信上游半導體,67,8,59,新光-高雄,2024-04-17,8562
2353,宏��,65,10,55,新光-高雄,2024-04-17,8562
2427,三商電,57,5,52,新光-高雄,2024-04-17,8562
5533,皇鼎,52,0,52,新光-高雄,2024-04-17,8562
8085,福華,51,0,51,新光-高雄,2024-04-17,8562
3481,群創,49,1,48,新光-高雄,2024-04-17,8562
00751B,元大AAA至A公司債,48,1,47,新光-高雄,2024-04-17,8562
00909,國泰數位支付服務,55,11,44,新光-高雄,2024-04-17,8562
00931B,統一美債20年,45,2,43,新光-高雄,2024-04-17,8562
3060,銘異,43,3,40,新光-高雄,2024-04-17,8562
00927,群益半導體收益,41,3,38,新光-高雄,2024-04-17,8562
2630,亞航,193,155,38,新光-高雄,2024-04-17,8562
2889,國票金,43,5,38,新光-高雄,2024-04-17,8562
8121,越峰,40,2,38,新光-高雄,2024-04-17,8562
2344,華邦電,38,4,34,新光-高雄,2024-04-17,8562
3489,森寶,38,5,33,新光-高雄,2024-04-17,8562
2352,佳世達,39,7,32,新光-高雄,2024-04-17,8562
3013,晟銘電,63,32,31,新光-高雄,2024-04-17,8562
2328,廣宇,31,0,31,新光-高雄,2024-04-17,8562
2882,國泰金,31,0,31,新光-高雄,2024-04-17,8562
8996,高力,43,13,30,新光-高雄,2024-04-17,8562
4513,福裕,54,24,30,新光-高雄,2024-04-17,8562
00753L,中信中國50正2,28,0,28,新光-高雄,2024-04-17,8562
1615,大山,26,0,26,新光-高雄,2024-04-17,8562
5880,合庫金,26,1,25,新光-高雄,2024-04-17,8562
2543,皇昌,47,22,25,新光-高雄,2024-04-17,8562
2812,台中銀,24,0,24,新光-高雄,2024-04-17,8562
00632R,元大台灣50反1,1093,258,835,新光-高雄,2024-04-18,8562
00929,復華台灣科技優息,718,52,666,新光-高雄,2024-04-18,8562
00937B,群益ESG投等債20,428,40,388,新光-高雄,2024-04-18,8562
1605,華新,849,564,285,新光-高雄,2024-04-18,8562
0056,元大高股息,243,1,242,新光-高雄,2024-04-18,8562
00733,富邦臺灣中小,176,4,172,新光-高雄,2024-04-18,8562
3481,群創,355,211,144,新光-高雄,2024-04-18,8562
2371,大同,847,708,139,新光-高雄,2024-04-18,8562
6269,台郡,130,0,130,新光-高雄,2024-04-18,8562
1504,東元,245,115,130,新光-高雄,2024-04-18,8562
2317,鴻海,175,56,119,新光-高雄,2024-04-18,8562
2104,國際中橡,110,6,104,新光-高雄,2024-04-18,8562
00830,國泰費城半導體,115,14,101,新光-高雄,2024-04-18,8562
1597,直得,124,29,95,新光-高雄,2024-04-18,8562
00919,群益台灣精選高息,222,134,88,新光-高雄,2024-04-18,8562
2023,燁輝,91,10,81,新光-高雄,2024-04-18,8562
00885,富邦越南,75,0,75,新光-高雄,2024-04-18,8562
5512,力麒,91,23,68,新光-高雄,2024-04-18,8562
00795B,中信美國公債20年,73,9,64,新光-高雄,2024-04-18,8562
2367,燿華,228,166,62,新光-高雄,2024-04-18,8562
2329,華泰,114,57,57,新光-高雄,2024-04-18,8562
00679B,元大美債20年,75,23,52,新光-高雄,2024-04-18,8562
5533,皇鼎,50,1,49,新光-高雄,2024-04-18,8562
00940,元大台灣價值高息,263,219,44,新光-高雄,2024-04-18,8562
1529,樂事綠能,61,19,42,新光-高雄,2024-04-18,8562
1513,中興電,264,223,41,新光-高雄,2024-04-18,8562
4532,瑞智,61,21,40,新光-高雄,2024-04-18,8562
2061,風青,49,11,38,新光-高雄,2024-04-18,8562
3491,昇達科,47,9,38,新光-高雄,2024-04-18,8562
2867,三商壽,277,241,36,新光-高雄,2024-04-18,8562
2356,英業達,62,28,34,新光-高雄,2024-04-18,8562
5469,瀚宇博,34,2,32,新光-高雄,2024-04-18,8562
1587,吉茂,34,3,31,新光-高雄,2024-04-18,8562
00687B,國泰20年美債,39,9,30,新光-高雄,2024-04-18,8562
2465,麗臺,48,19,29,新光-高雄,2024-04-18,8562
9105,泰金寶-DR,32,3,29,新光-高雄,2024-04-18,8562
1609,大亞,246,218,28,新光-高雄,2024-04-18,8562
3605,宏致,28,2,26,新光-高雄,2024-04-18,8562
2501,國建,83,58,25,新光-高雄,2024-04-18,8562
00909,國泰數位支付服務,26,1,25,新光-高雄,2024-04-18,8562
5534,長虹,37,12,25,新光-高雄,2024-04-18,8562
6546,正基,26,1,25,新光-高雄,2024-04-18,8562
3712,永崴投控,42,17,25,新光-高雄,2024-04-18,8562
00712,復華富時不動產,106,81,25,新光-高雄,2024-04-18,8562
00942B,台新美A公司債20+,27,2,25,新光-高雄,2024-04-18,8562
3707,漢磊,57,33,24,新光-高雄,2024-04-18,8562
00927,群益半導體收益,30,5,25,新光-高雄,2024-04-18,8562
3563,牧德,27,4,23,新光-高雄,2024-04-18,8562
2603,長榮,62,39,23,新光-高雄,2024-04-18,8562
2504,國產,94,72,22,新光-高雄,2024-04-18,8562
00940,元大台灣價值高息,1584,286,1298,新光-高雄,2024-04-19,8562
00715L,期街口布蘭特正2,1191,272,919,新光-高雄,2024-04-19,8562
0056,元大高股息,623,156,467,新光-高雄,2024-04-19,8562
00680L,元大美債20正2,703,355,348,新光-高雄,2024-04-19,8562
00878,國泰永續高股息,385,65,320,新光-高雄,2024-04-19,8562
00937B,群益ESG投等債20,371,77,294,新光-高雄,2024-04-19,8562
1605,華新,468,181,287,新光-高雄,2024-04-19,8562
5512,力麒,392,189,203,新光-高雄,2024-04-19,8562
00919,群益台灣精選高息,577,391,186,新光-高雄,2024-04-19,8562
1314,中石化,163,20,143,新光-高雄,2024-04-19,8562
2515,中工,719,585,134,新光-高雄,2024-04-19,8562
2303,聯電,144,19,125,新光-高雄,2024-04-19,8562
3062,建漢,143,20,123,新光-高雄,2024-04-19,8562
00939,統一台灣高息動能,227,109,118,新光-高雄,2024-04-19,8562
1609,大亞,1152,1044,108,新光-高雄,2024-04-19,8562
2330,台積電,206,102,104,新光-高雄,2024-04-19,8562
2618,長榮航,215,116,99,新光-高雄,2024-04-19,8562
00941,中信上游半導體,137,39,98,新光-高雄,2024-04-19,8562
00706L,期元大S＆P日圓正2,103,6,97,新光-高雄,2024-04-19,8562
2409,友達,129,38,91,新光-高雄,2024-04-19,8562
8473,山林水,150,63,87,新光-高雄,2024-04-19,8562
5521,工信,306,223,83,新光-高雄,2024-04-19,8562
2547,日勝生,186,103,83,新光-高雄,2024-04-19,8562
2317,鴻海,249,166,83,新光-高雄,2024-04-19,8562
2834,臺企銀,185,105,80,新光-高雄,2024-04-19,8562
00927,群益半導體收益,127,49,78,新光-高雄,2024-04-19,8562
3576,聯合再生,82,5,77,新光-高雄,2024-04-19,8562
1597,直得,92,15,77,新光-高雄,2024-04-19,8562
8936,國統,228,154,74,新光-高雄,2024-04-19,8562
2504,國產,95,24,71,新光-高雄,2024-04-19,8562
5009,榮剛,106,38,68,新光-高雄,2024-04-19,8562
2367,燿華,124,58,66,新光-高雄,2024-04-19,8562
00665L,富邦�琤肭磪囓�2,225,160,65,新光-高雄,2024-04-19,8562
3005,神基,67,4,63,新光-高雄,2024-04-19,8562
2363,矽統,114,53,61,新光-高雄,2024-04-19,8562
2888,新光金,86,29,57,新光-高雄,2024-04-19,8562
2371,大同,923,867,56,新光-高雄,2024-04-19,8562
00720B,元大投資級公司債,79,27,52,新光-高雄,2024-04-19,8562
3499,環天科,50,0,50,新光-高雄,2024-04-19,8562
00675L,富邦臺灣加權正2,56,6,50,新光-高雄,2024-04-19,8562
00733,富邦臺灣中小,66,17,49,新光-高雄,2024-04-19,8562
00631L,元大台灣50正2,81,34,47,新光-高雄,2024-04-19,8562
00881,國泰台灣5G+,48,3,45,新光-高雄,2024-04-19,8562
6153,嘉聯益,45,1,44,新光-高雄,2024-04-19,8562
2885,元大金,47,4,43,新光-高雄,2024-04-19,8562
00900,富邦特選高股息30,57,15,42,新光-高雄,2024-04-19,8562
6770,力積電,87,45,42,新光-高雄,2024-04-19,8562
2634,漢翔,102,60,42,新光-高雄,2024-04-19,8562
3033,威健,75,34,41,新光-高雄,2024-04-19,8562
00915,凱基優選高股息30,43,3,40,新光-高雄,2024-04-19,8562
00929,復華台灣科技優息,1098,222,876,新光-高雄,2024-04-22,8562
00933B,國泰10Y+金融債,343,2,341,新光-高雄,2024-04-22,8562
00940,元大台灣價值高息,480,147,333,新光-高雄,2024-04-22,8562
2609,陽明,508,189,319,新光-高雄,2024-04-22,8562
00919,群益台灣精選高息,453,201,252,新光-高雄,2024-04-22,8562
1314,中石化,360,130,230,新光-高雄,2024-04-22,8562
00937B,群益ESG投等債20,320,144,176,新光-高雄,2024-04-22,8562
00679B,元大美債20年,184,30,154,新光-高雄,2024-04-22,8562
00939,統一台灣高息動能,178,29,149,新光-高雄,2024-04-22,8562
00878,國泰永續高股息,197,65,132,新光-高雄,2024-04-22,8562
00687B,國泰20年美債,133,4,129,新光-高雄,2024-04-22,8562
2543,皇昌,165,48,117,新光-高雄,2024-04-22,8562
00715L,期街口布蘭特正2,206,90,116,新光-高雄,2024-04-22,8562
9946,三發地產,104,6,98,新光-高雄,2024-04-22,8562
6116,彩晶,97,3,94,新光-高雄,2024-04-22,8562
00680L,元大美債20正2,246,152,94,新光-高雄,2024-04-22,8562
6005,群益證,134,43,91,新光-高雄,2024-04-22,8562
2303,聯電,106,17,89,新光-高雄,2024-04-22,8562
2547,日勝生,225,139,86,新光-高雄,2024-04-22,8562
3576,聯合再生,122,42,80,新光-高雄,2024-04-22,8562
2104,國際中橡,80,3,77,新光-高雄,2024-04-22,8562
2405,輔信,71,2,69,新光-高雄,2024-04-22,8562
00942B,台新美A公司債20+,87,20,67,新光-高雄,2024-04-22,8562
2520,冠德,118,51,67,新光-高雄,2024-04-22,8562
2329,華泰,155,88,67,新光-高雄,2024-04-22,8562
1605,華新,130,66,64,新光-高雄,2024-04-22,8562
0056,元大高股息,119,56,63,新光-高雄,2024-04-22,8562
2317,鴻海,173,112,61,新光-高雄,2024-04-22,8562
6191,精成科,61,2,59,新光-高雄,2024-04-22,8562
3703,欣陸,163,107,56,新光-高雄,2024-04-22,8562
3231,緯創,207,152,55,新光-高雄,2024-04-22,8562
8936,國統,125,72,53,新光-高雄,2024-04-22,8562
00733,富邦臺灣中小,52,3,49,新光-高雄,2024-04-22,8562
2603,長榮,142,93,49,新光-高雄,2024-04-22,8562
1616,億泰,62,13,49,新光-高雄,2024-04-22,8562
2201,裕隆,51,3,48,新光-高雄,2024-04-22,8562
5009,榮剛,63,18,45,新光-高雄,2024-04-22,8562
2371,大同,725,685,40,新光-高雄,2024-04-22,8562
4714,永捷,41,1,40,新光-高雄,2024-04-22,8562
5302,太欣,40,0,40,新光-高雄,2024-04-22,8562
6546,正基,40,1,39,新光-高雄,2024-04-22,8562
2501,國建,90,52,38,新光-高雄,2024-04-22,8562
2605,新興,102,64,38,新光-高雄,2024-04-22,8562
00637L,元大滬深300正2,99,61,38,新光-高雄,2024-04-22,8562
3663,鑫科,41,3,38,新光-高雄,2024-04-22,8562
3264,欣銓,37,0,37,新光-高雄,2024-04-22,8562
00688L,國泰20年美債正2,36,0,36,新光-高雄,2024-04-22,8562
00857B,永豐20年美公債,35,0,35,新光-高雄,2024-04-22,8562
5521,工信,304,269,35,新光-高雄,2024-04-22,8562
2409,友達,44,9,35,新光-高雄,2024-04-22,8562
00929,復華台灣科技優息,384,91,293,新光-高雄,2024-04-23,8562
00919,群益台灣精選高息,259,47,212,新光-高雄,2024-04-23,8562
1626,艾美特-KY,175,0,175,新光-高雄,2024-04-23,8562
2609,陽明,126,11,115,新光-高雄,2024-04-23,8562
1440,南紡,153,41,112,新光-高雄,2024-04-23,8562
00940,元大台灣價值高息,152,45,107,新光-高雄,2024-04-23,8562
2515,中工,562,461,101,新光-高雄,2024-04-23,8562
2547,日勝生,242,155,87,新光-高雄,2024-04-23,8562
0056,元大高股息,77,6,71,新光-高雄,2024-04-23,8562
00878,國泰永續高股息,87,18,69,新光-高雄,2024-04-23,8562
00733,富邦臺灣中小,62,2,60,新光-高雄,2024-04-23,8562
6670,復盛應用,55,0,55,新光-高雄,2024-04-23,8562
9946,三發地產,45,0,45,新光-高雄,2024-04-23,8562
2352,佳世達,46,7,39,新光-高雄,2024-04-23,8562
00934,中信成長高股息,38,0,38,新光-高雄,2024-04-23,8562
2371,大同,434,396,38,新光-高雄,2024-04-23,8562
1314,中石化,66,28,38,新光-高雄,2024-04-23,8562
6120,達運,59,23,36,新光-高雄,2024-04-23,8562
2883,凱基金,56,21,35,新光-高雄,2024-04-23,8562
1101,台泥,41,6,35,新光-高雄,2024-04-23,8562
2855,統一證,27,0,27,新光-高雄,2024-04-23,8562
9955,佳龍,28,2,26,新光-高雄,2024-04-23,8562
1789,神隆,26,0,26,新光-高雄,2024-04-23,8562
00706L,期元大S＆P日圓正2,25,0,25,新光-高雄,2024-04-23,8562
00671R,富邦NASDAQ反1,50,25,25,新光-高雄,2024-04-23,8562
00637L,元大滬深300正2,39,16,23,新光-高雄,2024-04-23,8562
3715,定穎投控,52,30,22,新光-高雄,2024-04-23,8562
6197,佳必琪,29,7,22,新光-高雄,2024-04-23,8562
6548,長科*,22,0,22,新光-高雄,2024-04-23,8562
00939,統一台灣高息動能,76,55,21,新光-高雄,2024-04-23,8562
3230,錦明,20,0,20,新光-高雄,2024-04-23,8562
00679B,元大美債20年,38,19,19,新光-高雄,2024-04-23,8562
5443,均豪,20,1,19,新光-高雄,2024-04-23,8562
2505,國揚,21,2,19,新光-高雄,2024-04-23,8562
2882,國泰金,28,9,19,新光-高雄,2024-04-23,8562
00937B,群益ESG投等債20,21,3,18,新光-高雄,2024-04-23,8562
3708,上緯投控,43,25,18,新光-高雄,2024-04-23,8562
00715L,期街口布蘭特正2,85,67,18,新光-高雄,2024-04-23,8562
6443,元晶,24,8,16,新光-高雄,2024-04-23,8562
2317,鴻海,148,132,16,新光-高雄,2024-04-23,8562
00891,中信關鍵半導體,19,3,16,新光-高雄,2024-04-23,8562
4716,大立,16,0,16,新光-高雄,2024-04-23,8562
2492,華新科,29,13,16,新光-高雄,2024-04-23,8562
1455,集盛,43,27,16,新光-高雄,2024-04-23,8562
5533,皇鼎,27,11,16,新光-高雄,2024-04-23,8562
1513,中興電,95,80,15,新光-高雄,2024-04-23,8562
1609,大亞,647,632,15,新光-高雄,2024-04-23,8562
2506,太設,30,15,15,新光-高雄,2024-04-23,8562
1528,恩德,15,1,14,新光-高雄,2024-04-23,8562
3576,聯合再生,14,0,14,新光-高雄,2024-04-23,8562
00632R,元大台灣50反1,810,163,647,新光-高雄,2024-04-24,8562
2834,臺企銀,419,14,405,新光-高雄,2024-04-24,8562
00929,復華台灣科技優息,588,305,283,新光-高雄,2024-04-24,8562
00679B,元大美債20年,333,56,277,新光-高雄,2024-04-24,8562
2618,長榮航,583,320,263,新光-高雄,2024-04-24,8562
2886,兆豐金,239,13,226,新光-高雄,2024-04-24,8562
00673R,期元大S＆P原油反1,180,0,180,新光-高雄,2024-04-24,8562
3481,群創,309,168,141,新光-高雄,2024-04-24,8562
00688L,國泰20年美債正2,116,1,115,新光-高雄,2024-04-24,8562
1626,艾美特-KY,109,0,109,新光-高雄,2024-04-24,8562
6214,精誠,107,1,106,新光-高雄,2024-04-24,8562
2887,台新金,95,9,86,新光-高雄,2024-04-24,8562
00680L,元大美債20正2,138,72,66,新光-高雄,2024-04-24,8562
6116,彩晶,68,2,66,新光-高雄,2024-04-24,8562
00857B,永豐20年美公債,63,1,62,新光-高雄,2024-04-24,8562
00687B,國泰20年美債,59,0,59,新光-高雄,2024-04-24,8562
1457,宜進,67,9,58,新光-高雄,2024-04-24,8562
00937B,群益ESG投等債20,70,12,58,新光-高雄,2024-04-24,8562
2883,凱基金,136,79,57,新光-高雄,2024-04-24,8562
1618,合機,166,109,57,新光-高雄,2024-04-24,8562
3712,永崴投控,62,7,55,新光-高雄,2024-04-24,8562
2509,全坤建,76,22,54,新光-高雄,2024-04-24,8562
2888,新光金,115,62,53,新光-高雄,2024-04-24,8562
0056,元大高股息,89,36,53,新光-高雄,2024-04-24,8562
00706L,期元大S＆P日圓正2,52,0,52,新光-高雄,2024-04-24,8562
2882,國泰金,59,10,49,新光-高雄,2024-04-24,8562
5515,建國,48,1,47,新光-高雄,2024-04-24,8562
1316,上曜,129,83,46,新光-高雄,2024-04-24,8562
9946,三發地產,45,0,45,新光-高雄,2024-04-24,8562
00650L,復華香港正2,69,25,44,新光-高雄,2024-04-24,8562
00885,富邦越南,55,12,43,新光-高雄,2024-04-24,8562
2409,友達,44,4,40,新光-高雄,2024-04-24,8562
2890,永豐金,39,0,39,新光-高雄,2024-04-24,8562
00942B,台新美A公司債20+,37,0,37,新光-高雄,2024-04-24,8562
2634,漢翔,60,25,35,新光-高雄,2024-04-24,8562
2889,國票金,34,1,33,新光-高雄,2024-04-24,8562
2812,台中銀,33,0,33,新光-高雄,2024-04-24,8562
00733,富邦臺灣中小,34,3,31,新光-高雄,2024-04-24,8562
3532,台勝科,41,10,31,新光-高雄,2024-04-24,8562
5864,致和證,30,0,30,新光-高雄,2024-04-24,8562
9907,統一實,28,0,28,新光-高雄,2024-04-24,8562
2504,國產,79,51,28,新光-高雄,2024-04-24,8562
3006,晶豪科,54,28,26,新光-高雄,2024-04-24,8562
00670L,富邦NASDAQ正2,32,7,25,新光-高雄,2024-04-24,8562
00931B,統一美債20年,28,4,24,新光-高雄,2024-04-24,8562
3078,僑威,23,0,23,新光-高雄,2024-04-24,8562
3686,達能,23,1,22,新光-高雄,2024-04-24,8562
1101,台泥,33,12,21,新光-高雄,2024-04-24,8562
2637,慧洋-KY,31,10,21,新光-高雄,2024-04-24,8562
00852L,國泰美國道瓊正2,21,0,21,新光-高雄,2024-04-24,8562
00937B,群益ESG投等債20,341,68,273,新光-高雄,2024-04-25,8562
00688L,國泰20年美債正2,252,0,252,新光-高雄,2024-04-25,8562
2618,長榮航,1048,806,242,新光-高雄,2024-04-25,8562
00940,元大台灣價值高息,219,4,215,新光-高雄,2024-04-25,8562
00878,國泰永續高股息,165,4,161,新光-高雄,2024-04-25,8562
00687B,國泰20年美債,162,6,156,新光-高雄,2024-04-25,8562
00680L,元大美債20正2,187,50,137,新光-高雄,2024-04-25,8562
1409,新纖,130,2,128,新光-高雄,2024-04-25,8562
2359,所羅門,163,37,126,新光-高雄,2024-04-25,8562
00929,復華台灣科技優息,273,149,124,新光-高雄,2024-04-25,8562
2834,臺企銀,121,9,112,新光-高雄,2024-04-25,8562
00679B,元大美債20年,131,19,112,新光-高雄,2024-04-25,8562
2501,國建,325,231,94,新光-高雄,2024-04-25,8562
4306,炎洲,149,58,91,新光-高雄,2024-04-25,8562
2547,日勝生,122,37,85,新光-高雄,2024-04-25,8562
2801,彰銀,73,0,73,新光-高雄,2024-04-25,8562
2317,鴻海,162,99,63,新光-高雄,2024-04-25,8562
00939,統一台灣高息動能,94,31,63,新光-高雄,2024-04-25,8562
00733,富邦臺灣中小,67,4,63,新光-高雄,2024-04-25,8562
00706L,期元大S＆P日圓正2,82,20,62,新光-高雄,2024-04-25,8562
00795B,中信美國公債20年,56,0,56,新光-高雄,2024-04-25,8562
00931B,統一美債20年,69,16,53,新光-高雄,2024-04-25,8562
00893,國泰智能電動車,50,1,49,新光-高雄,2024-04-25,8562
00715L,期街口布蘭特正2,55,9,46,新光-高雄,2024-04-25,8562
1314,中石化,48,6,42,新光-高雄,2024-04-25,8562
2845,遠東銀,92,50,42,新光-高雄,2024-04-25,8562
3483,力致,42,3,39,新光-高雄,2024-04-25,8562
2303,聯電,60,21,39,新光-高雄,2024-04-25,8562
6548,長科*,72,39,33,新光-高雄,2024-04-25,8562
6472,保瑞,33,1,32,新光-高雄,2024-04-25,8562
0056,元大高股息,33,1,32,新光-高雄,2024-04-25,8562
3703,欣陸,97,66,31,新光-高雄,2024-04-25,8562
3694,海華,30,0,30,新光-高雄,2024-04-25,8562
2511,太子,33,5,28,新光-高雄,2024-04-25,8562
00935,野村臺灣新科技50,26,0,26,新光-高雄,2024-04-25,8562
3013,晟銘電,130,106,24,新光-高雄,2024-04-25,8562
5230,雷笛克光學,94,70,24,新光-高雄,2024-04-25,8562
00751B,元大AAA至A公司債,23,0,23,新光-高雄,2024-04-25,8562
3576,聯合再生,35,13,22,新光-高雄,2024-04-25,8562
1609,大亞,260,239,21,新光-高雄,2024-04-25,8562
2883,凱基金,21,0,21,新光-高雄,2024-04-25,8562
00665L,富邦�琤肭磪囓�2,91,70,21,新光-高雄,2024-04-25,8562
3284,太普高,21,0,21,新光-高雄,2024-04-25,8562
00933B,國泰10Y+金融債,29,8,21,新光-高雄,2024-04-25,8562
00671R,富邦NASDAQ反1,20,0,20,新光-高雄,2024-04-25,8562
6139,亞翔,25,6,19,新光-高雄,2024-04-25,8562
1626,艾美特-KY,19,0,19,新光-高雄,2024-04-25,8562
00909,國泰數位支付服務,22,3,19,新光-高雄,2024-04-25,8562
2882,國泰金,20,1,19,新光-高雄,2024-04-25,8562
00720B,元大投資級公司債,29,10,19,新光-高雄,2024-04-25,8562
00632R,元大台灣50反1,2429,1405,1024,新光-高雄,2024-04-26,8562
00882,中信中國高股息,409,36,373,新光-高雄,2024-04-26,8562
00679B,元大美債20年,303,19,284,新光-高雄,2024-04-26,8562
00688L,國泰20年美債正2,256,10,246,新光-高雄,2024-04-26,8562
00933B,國泰10Y+金融債,133,0,133,新光-高雄,2024-04-26,8562
6005,群益證,145,16,129,新光-高雄,2024-04-26,8562
2812,台中銀,135,22,113,新光-高雄,2024-04-26,8562
00687B,國泰20年美債,94,6,88,新光-高雄,2024-04-26,8562
00665L,富邦�琤肭磪囓�2,205,125,80,新光-高雄,2024-04-26,8562
00712,復華富時不動產,73,3,70,新光-高雄,2024-04-26,8562
0056,元大高股息,73,18,55,新光-高雄,2024-04-26,8562
00857B,永豐20年美公債,54,0,54,新光-高雄,2024-04-26,8562
2241,艾姆勒,91,40,51,新光-高雄,2024-04-26,8562
2371,大同,446,395,51,新光-高雄,2024-04-26,8562
6264,富裔,45,1,44,新光-高雄,2024-04-26,8562
00751B,元大AAA至A公司債,43,0,43,新光-高雄,2024-04-26,8562
6190,萬泰科,45,2,43,新光-高雄,2024-04-26,8562
00795B,中信美國公債20年,38,1,37,新光-高雄,2024-04-26,8562
2883,凱基金,61,24,37,新光-高雄,2024-04-26,8562
1440,南紡,180,146,34,新光-高雄,2024-04-26,8562
2505,國揚,52,18,34,新光-高雄,2024-04-26,8562
1597,直得,36,3,33,新光-高雄,2024-04-26,8562
00733,富邦臺灣中小,34,2,32,新光-高雄,2024-04-26,8562
2867,三商壽,41,10,31,新光-高雄,2024-04-26,8562
00919,群益台灣精選高息,58,27,31,新光-高雄,2024-04-26,8562
6177,達麗,40,12,28,新光-高雄,2024-04-26,8562
00650L,復華香港正2,182,154,28,新光-高雄,2024-04-26,8562
1617,榮星,31,3,28,新光-高雄,2024-04-26,8562
1504,東元,33,6,27,新光-高雄,2024-04-26,8562
1536,和大,27,0,27,新光-高雄,2024-04-26,8562
1314,中石化,113,86,27,新光-高雄,2024-04-26,8562
8936,國統,57,32,25,新光-高雄,2024-04-26,8562
9945,潤泰新,42,17,25,新光-高雄,2024-04-26,8562
00706L,期元大S＆P日圓正2,25,0,25,新光-高雄,2024-04-26,8562
5488,松普,25,0,25,新光-高雄,2024-04-26,8562
1316,上曜,70,46,24,新光-高雄,2024-04-26,8562
2634,漢翔,38,14,24,新光-高雄,2024-04-26,8562
2534,宏盛,25,2,23,新光-高雄,2024-04-26,8562
5533,皇鼎,24,1,23,新光-高雄,2024-04-26,8562
2506,太設,40,18,22,新光-高雄,2024-04-26,8562
8942,森鉅,22,0,22,新光-高雄,2024-04-26,8562
00720B,元大投資級公司債,22,0,22,新光-高雄,2024-04-26,8562
1605,華新,78,57,21,新光-高雄,2024-04-26,8562
2374,佳能,39,18,21,新光-高雄,2024-04-26,8562
3010,華立,23,2,21,新光-高雄,2024-04-26,8562
3706,神達,95,75,20,新光-高雄,2024-04-26,8562
8996,高力,55,36,19,新光-高雄,2024-04-26,8562
3338,泰碩,35,16,19,新光-高雄,2024-04-26,8562
6603,富強鑫,20,1,19,新光-高雄,2024-04-26,8562
2104,國際中橡,20,1,19,新光-高雄,2024-04-26,8562
00632R,元大台灣50反1,2731,1378,1353,新光-高雄,2024-04-29,8562
00706L,期元大S＆P日圓正2,565,21,544,新光-高雄,2024-04-29,8562
00929,復華台灣科技優息,537,165,372,新光-高雄,2024-04-29,8562
2618,長榮航,594,237,357,新光-高雄,2024-04-29,8562
2609,陽明,619,350,269,新光-高雄,2024-04-29,8562
00937B,群益ESG投等債20,330,91,239,新光-高雄,2024-04-29,8562
2610,華航,396,258,138,新光-高雄,2024-04-29,8562
2323,中環,199,94,105,新光-高雄,2024-04-29,8562
3289,宜特,131,29,102,新光-高雄,2024-04-29,8562
2363,矽統,239,158,81,新光-高雄,2024-04-29,8562
5324,士開,57,1,56,新光-高雄,2024-04-29,8562
1440,南紡,118,62,56,新光-高雄,2024-04-29,8562
2515,中工,592,538,54,新光-高雄,2024-04-29,8562
2486,一詮,197,144,53,新光-高雄,2024-04-29,8562
8110,華東,110,58,52,新光-高雄,2024-04-29,8562
6177,達麗,92,42,50,新光-高雄,2024-04-29,8562
2241,艾姆勒,58,9,49,新光-高雄,2024-04-29,8562
2061,風青,49,2,47,新光-高雄,2024-04-29,8562
6863,永道-KY,44,0,44,新光-高雄,2024-04-29,8562
1905,華紙,70,30,40,新光-高雄,2024-04-29,8562
2520,冠德,118,78,40,新光-高雄,2024-04-29,8562
1626,艾美特-KY,39,0,39,新光-高雄,2024-04-29,8562
3557,嘉威,49,10,39,新光-高雄,2024-04-29,8562
2102,泰豐,41,3,38,新光-高雄,2024-04-29,8562
1457,宜進,48,12,36,新光-高雄,2024-04-29,8562
2605,新興,46,10,36,新光-高雄,2024-04-29,8562
2501,國建,52,17,35,新光-高雄,2024-04-29,8562
2009,第一銅,119,87,32,新光-高雄,2024-04-29,8562
2066,世德,34,4,30,新光-高雄,2024-04-29,8562
3051,力特,31,2,29,新光-高雄,2024-04-29,8562
1313,聯成,39,12,27,新光-高雄,2024-04-29,8562
2883,凱基金,168,141,27,新光-高雄,2024-04-29,8562
00673R,期元大S＆P原油反1,25,0,25,新光-高雄,2024-04-29,8562
6770,力積電,71,47,24,新光-高雄,2024-04-29,8562
4532,瑞智,27,4,23,新光-高雄,2024-04-29,8562
2516,新建,26,3,23,新光-高雄,2024-04-29,8562
8942,森鉅,23,0,23,新光-高雄,2024-04-29,8562
00857B,永豐20年美公債,33,12,21,新光-高雄,2024-04-29,8562
3013,晟銘電,75,54,21,新光-高雄,2024-04-29,8562
2883B,凱基金乙特,21,0,21,新光-高雄,2024-04-29,8562
1714,和桐,21,0,21,新光-高雄,2024-04-29,8562
00676R,富邦臺灣加權反1,20,0,20,新光-高雄,2024-04-29,8562
2349,錸德,20,0,20,新光-高雄,2024-04-29,8562
6290,良維,34,14,20,新光-高雄,2024-04-29,8562
4919,新唐,21,2,19,新光-高雄,2024-04-29,8562
1504,東元,22,5,17,新光-高雄,2024-04-29,8562
1609,大亞,153,138,15,新光-高雄,2024-04-29,8562
4513,福裕,41,26,15,新光-高雄,2024-04-29,8562
2506,太設,40,25,15,新光-高雄,2024-04-29,8562
5608,四維航,45,30,15,新光-高雄,2024-04-29,8562
00632R,元大台灣50反1,877,432,445,新光-高雄,2024-04-30,8562
00680L,元大美債20正2,402,45,357,新光-高雄,2024-04-30,8562
00940,元大台灣價值高息,204,30,174,新光-高雄,2024-04-30,8562
2501,國建,308,146,162,新光-高雄,2024-04-30,8562
2359,所羅門,214,64,150,新光-高雄,2024-04-30,8562
00733,富邦臺灣中小,162,19,143,新光-高雄,2024-04-30,8562
2317,鴻海,201,59,142,新光-高雄,2024-04-30,8562
00753L,中信中國50正2,148,10,138,新光-高雄,2024-04-30,8562
00715L,期街口布蘭特正2,94,0,94,新光-高雄,2024-04-30,8562
2618,長榮航,265,191,74,新光-高雄,2024-04-30,8562
2880,華南金,114,43,71,新光-高雄,2024-04-30,8562
1304,台聚,60,0,60,新光-高雄,2024-04-30,8562
00673R,期元大S＆P原油反1,83,25,58,新光-高雄,2024-04-30,8562
00918,大華優利高填息30,65,8,57,新光-高雄,2024-04-30,8562
3266,昇陽,57,0,57,新光-高雄,2024-04-30,8562
2520,冠德,106,53,53,新光-高雄,2024-04-30,8562
2897,王道銀行,50,0,50,新光-高雄,2024-04-30,8562
3466,德晉,47,0,47,新光-高雄,2024-04-30,8562
1616,億泰,52,7,45,新光-高雄,2024-04-30,8562
2537,聯上發,58,14,44,新光-高雄,2024-04-30,8562
00712,復華富時不動產,45,2,43,新光-高雄,2024-04-30,8562
2104,國際中橡,54,11,43,新光-高雄,2024-04-30,8562
8096,擎亞,145,102,43,新光-高雄,2024-04-30,8562
2449,京元電子,112,69,43,新光-高雄,2024-04-30,8562
00919,群益台灣精選高息,67,25,42,新光-高雄,2024-04-30,8562
2401,凌陽,80,40,40,新光-高雄,2024-04-30,8562
6264,富裔,39,3,36,新光-高雄,2024-04-30,8562
00706L,期元大S＆P日圓正2,36,0,36,新光-高雄,2024-04-30,8562
00650L,復華香港正2,125,90,35,新光-高雄,2024-04-30,8562
2527,宏璟,34,0,34,新光-高雄,2024-04-30,8562
4976,佳凌,40,7,33,新光-高雄,2024-04-30,8562
2611,志信,76,44,32,新光-高雄,2024-04-30,8562
020033,統一�琤肮黕篾,30,0,30,新光-高雄,2024-04-30,8562
5009,榮剛,67,38,29,新光-高雄,2024-04-30,8562
00936,台新永續高息中小,33,5,28,新光-高雄,2024-04-30,8562
5531,鄉林,58,30,28,新光-高雄,2024-04-30,8562
1316,上曜,124,96,28,新光-高雄,2024-04-30,8562
4714,永捷,30,3,27,新光-高雄,2024-04-30,8562
6770,力積電,36,11,25,新光-高雄,2024-04-30,8562
1446,宏和,33,9,24,新光-高雄,2024-04-30,8562
2516,新建,24,1,23,新光-高雄,2024-04-30,8562
2845,遠東銀,26,3,23,新光-高雄,2024-04-30,8562
2609,陽明,163,141,22,新光-高雄,2024-04-30,8562
6177,達麗,136,115,21,新光-高雄,2024-04-30,8562
00937B,群益ESG投等債20,153,132,21,新光-高雄,2024-04-30,8562
4414,如興,20,0,20,新光-高雄,2024-04-30,8562
2316,楠梓電,48,29,19,新光-高雄,2024-04-30,8562
2867,三商壽,32,13,19,新光-高雄,2024-04-30,8562
2515,中工,527,511,16,新光-高雄,2024-04-30,8562
1587,吉茂,51,35,16,新光-高雄,2024-04-30,8562
00882,中信中國高股息,669,15,654,新光-高雄,2024-05-02,8562
00878,國泰永續高股息,289,88,201,新光-高雄,2024-05-02,8562
1314,中石化,353,189,164,新光-高雄,2024-05-02,8562
3481,群創,172,18,154,新光-高雄,2024-05-02,8562
00680L,元大美債20正2,140,7,133,新光-高雄,2024-05-02,8562
00715L,期街口布蘭特正2,172,40,132,新光-高雄,2024-05-02,8562
00929,復華台灣科技優息,168,51,117,新光-高雄,2024-05-02,8562
2501,國建,406,296,110,新光-高雄,2024-05-02,8562
00937B,群益ESG投等債20,238,140,98,新光-高雄,2024-05-02,8562
2515,中工,313,231,82,新光-高雄,2024-05-02,8562
3363,上詮,167,97,70,新光-高雄,2024-05-02,8562
2409,友達,63,4,59,新光-高雄,2024-05-02,8562
2887,台新金,58,1,57,新光-高雄,2024-05-02,8562
2906,高林,103,46,57,新光-高雄,2024-05-02,8562
2363,矽統,121,73,48,新光-高雄,2024-05-02,8562
1609,大亞,106,59,47,新光-高雄,2024-05-02,8562
2367,燿華,58,12,46,新光-高雄,2024-05-02,8562
2316,楠梓電,88,43,45,新光-高雄,2024-05-02,8562
00919,群益台灣精選高息,221,179,42,新光-高雄,2024-05-02,8562
2891,中信金,63,22,41,新光-高雄,2024-05-02,8562
00940,元大台灣價值高息,80,41,39,新光-高雄,2024-05-02,8562
1614,三洋電,38,0,38,新光-高雄,2024-05-02,8562
2603,長榮,110,72,38,新光-高雄,2024-05-02,8562
2913,農林,217,182,35,新光-高雄,2024-05-02,8562
00935,野村臺灣新科技50,40,8,32,新光-高雄,2024-05-02,8562
2323,中環,53,21,32,新光-高雄,2024-05-02,8562
2545,皇翔,38,8,30,新光-高雄,2024-05-02,8562
1605,華新,43,14,29,新光-高雄,2024-05-02,8562
00712,復華富時不動產,41,13,28,新光-高雄,2024-05-02,8562
2609,陽明,104,75,29,新光-高雄,2024-05-02,8562
00733,富邦臺灣中小,26,0,26,新光-高雄,2024-05-02,8562
2486,一詮,57,32,25,新光-高雄,2024-05-02,8562
1504,東元,83,58,25,新光-高雄,2024-05-02,8562
2812,台中銀,29,5,24,新光-高雄,2024-05-02,8562
6239,力成,32,9,23,新光-高雄,2024-05-02,8562
1227,佳格,24,1,23,新光-高雄,2024-05-02,8562
2303,聯電,35,13,22,新光-高雄,2024-05-02,8562
2324,仁寶,22,1,21,新光-高雄,2024-05-02,8562
5201,凱衛,20,0,20,新光-高雄,2024-05-02,8562
00945B,凱基美國非投等債,20,0,20,新光-高雄,2024-05-02,8562
2301,光寶科,33,13,20,新光-高雄,2024-05-02,8562
2376,技嘉,26,6,20,新光-高雄,2024-05-02,8562
5434,崇越,21,2,19,新光-高雄,2024-05-02,8562
3005,神基,43,25,18,新光-高雄,2024-05-02,8562
2534,宏盛,26,9,17,新光-高雄,2024-05-02,8562
2362,藍天,18,1,17,新光-高雄,2024-05-02,8562
3006,晶豪科,26,9,17,新光-高雄,2024-05-02,8562
2405,輔信,36,21,15,新光-高雄,2024-05-02,8562
8070,長華*,15,0,15,新光-高雄,2024-05-02,8562
3557,嘉威,15,0,15,新光-高雄,2024-05-02,8562
00937B,群益ESG投等債20,357,95,262,新光-高雄,2024-05-03,8562
00632R,元大台灣50反1,1234,1038,196,新光-高雄,2024-05-03,8562
1316,上曜,364,229,135,新光-高雄,2024-05-03,8562
1597,直得,125,24,101,新光-高雄,2024-05-03,8562
2834,臺企銀,129,31,98,新光-高雄,2024-05-03,8562
1101,台泥,99,12,87,新光-高雄,2024-05-03,8562
2515,中工,345,265,80,新光-高雄,2024-05-03,8562
00715L,期街口布蘭特正2,77,0,77,新光-高雄,2024-05-03,8562
00679B,元大美債20年,88,21,67,新光-高雄,2024-05-03,8562
9945,潤泰新,208,145,63,新光-高雄,2024-05-03,8562
00933B,國泰10Y+金融債,64,9,55,新光-高雄,2024-05-03,8562
6120,達運,64,13,51,新光-高雄,2024-05-03,8562
2883B,凱基金乙特,50,0,50,新光-高雄,2024-05-03,8562
00706L,期元大S＆P日圓正2,82,35,47,新光-高雄,2024-05-03,8562
6219,富旺,46,5,41,新光-高雄,2024-05-03,8562
1722,台肥,41,2,39,新光-高雄,2024-05-03,8562
1409,新纖,41,2,39,新光-高雄,2024-05-03,8562
1514,亞力,114,77,37,新光-高雄,2024-05-03,8562
1614,三洋電,39,4,35,新光-高雄,2024-05-03,8562
8096,擎亞,223,189,34,新光-高雄,2024-05-03,8562
2371,大同,141,107,34,新光-高雄,2024-05-03,8562
8163,達方,42,10,32,新光-高雄,2024-05-03,8562
8044,網家,32,2,30,新光-高雄,2024-05-03,8562
1227,佳格,29,0,29,新光-高雄,2024-05-03,8562
2610,華航,98,69,29,新光-高雄,2024-05-03,8562
2603,長榮,100,71,29,新光-高雄,2024-05-03,8562
2206,三陽工業,36,9,27,新光-高雄,2024-05-03,8562
5469,瀚宇博,29,2,27,新光-高雄,2024-05-03,8562
00720B,元大投資級公司債,27,0,27,新光-高雄,2024-05-03,8562
2739,寒舍,55,29,26,新光-高雄,2024-05-03,8562
2363,矽統,157,131,26,新光-高雄,2024-05-03,8562
2845,遠東銀,25,0,25,新光-高雄,2024-05-03,8562
6112,邁達特,25,1,24,新光-高雄,2024-05-03,8562
2365,昆盈,25,1,24,新光-高雄,2024-05-03,8562
2536,宏普,33,9,24,新光-高雄,2024-05-03,8562
00857B,永豐20年美公債,24,0,24,新光-高雄,2024-05-03,8562
00931B,統一美債20年,30,7,23,新光-高雄,2024-05-03,8562
2913,農林,34,11,23,新光-高雄,2024-05-03,8562
6117,迎廣,24,1,23,新光-高雄,2024-05-03,8562
00940,元大台灣價值高息,88,65,23,新光-高雄,2024-05-03,8562
2316,楠梓電,63,41,22,新光-高雄,2024-05-03,8562
3231,緯創,61,39,22,新光-高雄,2024-05-03,8562
2504,國產,31,11,20,新光-高雄,2024-05-03,8562
3025,星通,38,18,20,新光-高雄,2024-05-03,8562
00932,兆豐永續高息等權,21,1,20,新光-高雄,2024-05-03,8562
00687B,國泰20年美債,41,22,19,新光-高雄,2024-05-03,8562
2537,聯上發,119,100,19,新光-高雄,2024-05-03,8562
3557,嘉威,19,0,19,新光-高雄,2024-05-03,8562
00669R,國泰美國道瓊反1,21,2,19,新光-高雄,2024-05-03,8562
3188,鑫龍騰,26,7,19,新光-高雄,2024-05-03,8562
00632R,元大台灣50反1,2361,1112,1249,新光-高雄,2024-05-06,8562
00929,復華台灣科技優息,887,63,824,新光-高雄,2024-05-06,8562
00937B,群益ESG投等債20,488,157,331,新光-高雄,2024-05-06,8562
00671R,富邦NASDAQ反1,208,10,198,新光-高雄,2024-05-06,8562
00680L,元大美債20正2,327,165,162,新光-高雄,2024-05-06,8562
2618,長榮航,329,222,107,新光-高雄,2024-05-06,8562
00688L,國泰20年美債正2,112,10,102,新光-高雄,2024-05-06,8562
2851,中再保,114,13,101,新光-高雄,2024-05-06,8562
8906,花王,115,17,98,新光-高雄,2024-05-06,8562
00715L,期街口布蘭特正2,108,15,93,新光-高雄,2024-05-06,8562
2101,南港,136,43,93,新光-高雄,2024-05-06,8562
9933,中鼎,116,35,81,新光-高雄,2024-05-06,8562
1101,台泥,99,31,68,新光-高雄,2024-05-06,8562
8429,金麗-KY,60,0,60,新光-高雄,2024-05-06,8562
4306,炎洲,93,36,57,新光-高雄,2024-05-06,8562
2409,友達,63,8,55,新光-高雄,2024-05-06,8562
1217,愛之味,52,0,52,新光-高雄,2024-05-06,8562
2883B,凱基金乙特,51,0,51,新光-高雄,2024-05-06,8562
00882,中信中國高股息,79,29,50,新光-高雄,2024-05-06,8562
00930,永豐ESG低碳高息,47,0,47,新光-高雄,2024-05-06,8562
2537,聯上發,64,20,44,新光-高雄,2024-05-06,8562
2363,矽統,101,58,43,新光-高雄,2024-05-06,8562
1409,新纖,45,2,43,新光-高雄,2024-05-06,8562
2887,台新金,74,32,42,新光-高雄,2024-05-06,8562
3356,奇偶,60,21,39,新光-高雄,2024-05-06,8562
00919,群益台灣精選高息,68,31,37,新光-高雄,2024-05-06,8562
2511,太子,52,16,36,新光-高雄,2024-05-06,8562
1597,直得,51,15,36,新光-高雄,2024-05-06,8562
2845,遠東銀,36,0,36,新光-高雄,2024-05-06,8562
3234,光環,39,5,34,新光-高雄,2024-05-06,8562
00637L,元大滬深300正2,56,23,33,新光-高雄,2024-05-06,8562
2610,華航,135,102,33,新光-高雄,2024-05-06,8562
00687B,國泰20年美債,58,27,31,新光-高雄,2024-05-06,8562
6451,訊芯-KY,69,38,31,新光-高雄,2024-05-06,8562
1614,三洋電,35,4,31,新光-高雄,2024-05-06,8562
1339,昭輝,58,28,30,新光-高雄,2024-05-06,8562
3025,星通,32,4,28,新光-高雄,2024-05-06,8562
6112,邁達特,30,2,28,新光-高雄,2024-05-06,8562
3033,威健,168,140,28,新光-高雄,2024-05-06,8562
2352,佳世達,34,7,27,新光-高雄,2024-05-06,8562
3624,光頡,35,8,27,新光-高雄,2024-05-06,8562
4714,永捷,47,21,26,新光-高雄,2024-05-06,8562
2427,三商電,26,1,25,新光-高雄,2024-05-06,8562
2605,新興,27,3,24,新光-高雄,2024-05-06,8562
1337,再生-KY,23,0,23,新光-高雄,2024-05-06,8562
9945,潤泰新,186,163,23,新光-高雄,2024-05-06,8562
6668,中揚光,70,48,22,新光-高雄,2024-05-06,8562
3537,堡達,25,4,21,新光-高雄,2024-05-06,8562
00706L,期元大S＆P日圓正2,21,0,21,新光-高雄,2024-05-06,8562
6282,康舒,21,1,20,新光-高雄,2024-05-06,8562
2344,華邦電,894,67,827,新光-高雄,2024-05-07,8562
00940,元大台灣價值高息,494,37,457,新光-高雄,2024-05-07,8562
00671R,富邦NASDAQ反1,360,0,360,新光-高雄,2024-05-07,8562
2515,中工,611,310,301,新光-高雄,2024-05-07,8562
00715L,期街口布蘭特正2,160,2,158,新光-高雄,2024-05-07,8562
2610,華航,280,129,151,新光-高雄,2024-05-07,8562
2888,新光金,215,65,150,新光-高雄,2024-05-07,8562
1609,大亞,246,103,143,新光-高雄,2024-05-07,8562
00680L,元大美債20正2,277,152,125,新光-高雄,2024-05-07,8562
00688L,國泰20年美債正2,164,48,116,新光-高雄,2024-05-07,8562
2440,太空梭,101,0,101,新光-高雄,2024-05-07,8562
3576,聯合再生,112,15,97,新光-高雄,2024-05-07,8562
2520,冠德,127,41,86,新光-高雄,2024-05-07,8562
1611,中電,87,6,81,新光-高雄,2024-05-07,8562
2883,凱基金,153,75,78,新光-高雄,2024-05-07,8562
00665L,富邦�琤肭磪囓�2,71,5,66,新光-高雄,2024-05-07,8562
2301,光寶科,60,4,56,新光-高雄,2024-05-07,8562
2618,長榮航,445,389,56,新光-高雄,2024-05-07,8562
2834,臺企銀,116,61,55,新光-高雄,2024-05-07,8562
5521,工信,105,50,55,新光-高雄,2024-05-07,8562
2641,正德,65,10,55,新光-高雄,2024-05-07,8562
2486,一詮,260,211,49,新光-高雄,2024-05-07,8562
00936,台新永續高息中小,44,0,44,新光-高雄,2024-05-07,8562
2363,矽統,94,52,42,新光-高雄,2024-05-07,8562
2101,南港,71,32,39,新光-高雄,2024-05-07,8562
5871,中租-KY,36,1,35,新光-高雄,2024-05-07,8562
00679B,元大美債20年,95,61,34,新光-高雄,2024-05-07,8562
3013,晟銘電,145,111,34,新光-高雄,2024-05-07,8562
6112,邁達特,31,0,31,新光-高雄,2024-05-07,8562
2409,友達,33,2,31,新光-高雄,2024-05-07,8562
8277,商丞,31,1,30,新光-高雄,2024-05-07,8562
00918,大華優利高填息30,42,13,29,新光-高雄,2024-05-07,8562
8110,華東,30,1,29,新光-高雄,2024-05-07,8562
2014,中鴻,33,5,28,新光-高雄,2024-05-07,8562
00706L,期元大S＆P日圓正2,34,7,27,新光-高雄,2024-05-07,8562
8096,擎亞,193,166,27,新光-高雄,2024-05-07,8562
4306,炎洲,35,9,26,新光-高雄,2024-05-07,8562
00753L,中信中國50正2,67,41,26,新光-高雄,2024-05-07,8562
2535,達欣工,40,14,26,新光-高雄,2024-05-07,8562
0056,元大高股息,43,17,26,新光-高雄,2024-05-07,8562
1304,台聚,27,3,24,新光-高雄,2024-05-07,8562
5340,建榮,24,0,24,新光-高雄,2024-05-07,8562
5519,隆大,54,31,23,新光-高雄,2024-05-07,8562
5515,建國,31,8,23,新光-高雄,2024-05-07,8562
1339,昭輝,33,11,22,新光-高雄,2024-05-07,8562
3466,德晉,48,26,22,新光-高雄,2024-05-07,8562
1527,鑽全,22,0,22,新光-高雄,2024-05-07,8562
00919,群益台灣精選高息,47,25,22,新光-高雄,2024-05-07,8562
2367,燿華,94,73,21,新光-高雄,2024-05-07,8562
1303,南亞,23,2,21,新光-高雄,2024-05-07,8562
00632R,元大台灣50反1,2178,758,1420,新光-高雄,2024-05-08,8562
00940,元大台灣價值高息,283,6,277,新光-高雄,2024-05-08,8562
2359,所羅門,210,92,118,新光-高雄,2024-05-08,8562
8906,花王,111,0,111,新光-高雄,2024-05-08,8562
2344,華邦電,111,3,108,新光-高雄,2024-05-08,8562
6113,亞矽,105,1,104,新光-高雄,2024-05-08,8562
5871,中租-KY,137,36,101,新光-高雄,2024-05-08,8562
4306,炎洲,93,3,90,新光-高雄,2024-05-08,8562
00679B,元大美債20年,169,82,87,新光-高雄,2024-05-08,8562
00919,群益台灣精選高息,84,10,74,新光-高雄,2024-05-08,8562
1314,中石化,266,192,74,新光-高雄,2024-05-08,8562
1614,三洋電,80,6,74,新光-高雄,2024-05-08,8562
3481,群創,90,17,73,新光-高雄,2024-05-08,8562
00753L,中信中國50正2,79,18,61,新光-高雄,2024-05-08,8562
2618,長榮航,326,265,61,新光-高雄,2024-05-08,8562
00945B,凱基美國非投等債,51,0,51,新光-高雄,2024-05-08,8562
00671R,富邦NASDAQ反1,60,10,50,新光-高雄,2024-05-08,8562
00715L,期街口布蘭特正2,89,40,49,新光-高雄,2024-05-08,8562
00665L,富邦�琤肭磪囓�2,82,33,49,新光-高雄,2024-05-08,8562
2371,大同,156,110,46,新光-高雄,2024-05-08,8562
1612,宏泰,126,81,45,新光-高雄,2024-05-08,8562
6757,台灣虎航,43,2,41,新光-高雄,2024-05-08,8562
2464,盟立,50,14,36,新光-高雄,2024-05-08,8562
00650L,復華香港正2,43,8,35,新光-高雄,2024-05-08,8562
3036,文曄,40,5,35,新光-高雄,2024-05-08,8562
2317,鴻海,105,72,33,新光-高雄,2024-05-08,8562
2603,長榮,137,105,32,新光-高雄,2024-05-08,8562
2374,佳能,116,86,30,新光-高雄,2024-05-08,8562
5533,皇鼎,30,0,30,新光-高雄,2024-05-08,8562
5516,雙喜,30,0,30,新光-高雄,2024-05-08,8562
3033,威健,42,13,29,新光-高雄,2024-05-08,8562
2906,高林,41,14,27,新光-高雄,2024-05-08,8562
6005,群益證,60,34,26,新光-高雄,2024-05-08,8562
4414,如興,25,0,25,新光-高雄,2024-05-08,8562
1514,亞力,75,50,25,新光-高雄,2024-05-08,8562
5514,三豐,23,0,23,新光-高雄,2024-05-08,8562
4303,信立,42,19,23,新光-高雄,2024-05-08,8562
00939,統一台灣高息動能,37,15,22,新光-高雄,2024-05-08,8562
2834,臺企銀,32,11,21,新光-高雄,2024-05-08,8562
1339,昭輝,37,16,21,新光-高雄,2024-05-08,8562
2365,昆盈,30,10,20,新光-高雄,2024-05-08,8562
1305,華夏,20,0,20,新光-高雄,2024-05-08,8562
5340,建榮,20,0,20,新光-高雄,2024-05-08,8562
8234,新漢,56,37,19,新光-高雄,2024-05-08,8562
00933B,國泰10Y+金融債,80,61,19,新光-高雄,2024-05-08,8562
1308,亞聚,18,0,18,新光-高雄,2024-05-08,8562
00930,永豐ESG低碳高息,18,0,18,新光-高雄,2024-05-08,8562
6112,邁達特,18,0,18,新光-高雄,2024-05-08,8562
5386,青雲,21,3,18,新光-高雄,2024-05-08,8562
5521,工信,136,119,17,新光-高雄,2024-05-08,8562
00919,群益台灣精選高息,1260,61,1199,新光-高雄,2024-05-09,8562
2610,華航,384,32,352,新光-高雄,2024-05-09,8562
00940,元大台灣價值高息,337,138,199,新光-高雄,2024-05-09,8562
5871,中租-KY,202,7,195,新光-高雄,2024-05-09,8562
00929,復華台灣科技優息,277,86,191,新光-高雄,2024-05-09,8562
00946,群益科技高息成長,189,0,189,新光-高雄,2024-05-09,8562
2618,長榮航,288,131,157,新光-高雄,2024-05-09,8562
00937B,群益ESG投等債20,178,22,156,新光-高雄,2024-05-09,8562
00944,野村趨勢動能高息,142,0,142,新光-高雄,2024-05-09,8562
00878,國泰永續高股息,152,51,101,新光-高雄,2024-05-09,8562
00932,兆豐永續高息等權,95,0,95,新光-高雄,2024-05-09,8562
1597,直得,97,3,94,新光-高雄,2024-05-09,8562
9904,寶成,100,13,87,新光-高雄,2024-05-09,8562
00673R,期元大S＆P原油反1,80,11,69,新光-高雄,2024-05-09,8562
2851,中再保,62,0,62,新光-高雄,2024-05-09,8562
00650L,復華香港正2,82,22,60,新光-高雄,2024-05-09,8562
2888,新光金,270,210,60,新光-高雄,2024-05-09,8562
2489,瑞軒,101,42,59,新光-高雄,2024-05-09,8562
8906,花王,68,11,57,新光-高雄,2024-05-09,8562
00671R,富邦NASDAQ反1,59,2,57,新光-高雄,2024-05-09,8562
00933B,國泰10Y+金融債,56,3,53,新光-高雄,2024-05-09,8562
2887,台新金,75,24,51,新光-高雄,2024-05-09,8562
4303,信立,67,19,48,新光-高雄,2024-05-09,8562
3231,緯創,88,42,46,新光-高雄,2024-05-09,8562
2408,南亞科,63,21,42,新光-高雄,2024-05-09,8562
6016,康和證,42,0,42,新光-高雄,2024-05-09,8562
4967,十銓,145,106,39,新光-高雄,2024-05-09,8562
2061,風青,35,0,35,新光-高雄,2024-05-09,8562
1815,富喬,94,60,34,新光-高雄,2024-05-09,8562
2905,三商,33,0,33,新光-高雄,2024-05-09,8562
2062,橋椿,41,9,32,新光-高雄,2024-05-09,8562
1109,信大,34,2,32,新光-高雄,2024-05-09,8562
00795B,中信美國公債20年,32,1,31,新光-高雄,2024-05-09,8562
3596,智易,29,0,29,新光-高雄,2024-05-09,8562
0056,元大高股息,49,20,29,新光-高雄,2024-05-09,8562
2344,華邦電,81,53,28,新光-高雄,2024-05-09,8562
2409,友達,28,0,28,新光-高雄,2024-05-09,8562
00720B,元大投資級公司債,28,1,27,新光-高雄,2024-05-09,8562
1522,堤維西,41,14,27,新光-高雄,2024-05-09,8562
2329,華泰,31,4,27,新光-高雄,2024-05-09,8562
6197,佳必琪,61,34,27,新光-高雄,2024-05-09,8562
2402,毅嘉,28,1,27,新光-高雄,2024-05-09,8562
2603,長榮,115,88,27,新光-高雄,2024-05-09,8562
1471,首利,27,1,26,新光-高雄,2024-05-09,8562
5880,合庫金,25,0,25,新光-高雄,2024-05-09,8562
6170,統振,26,1,25,新光-高雄,2024-05-09,8562
2509,全坤建,25,1,24,新光-高雄,2024-05-09,8562
1457,宜進,24,0,24,新光-高雄,2024-05-09,8562
00857B,永豐20年美公債,24,0,24,新光-高雄,2024-05-09,8562
2362,藍天,75,51,24,新光-高雄,2024-05-09,8562
00929,復華台灣科技優息,2239,56,2183,新光-高雄,2024-05-10,8562
8112,至上,358,88,270,新光-高雄,2024-05-10,8562
00679B,元大美債20年,194,26,168,新光-高雄,2024-05-10,8562
2882,國泰金,322,157,165,新光-高雄,2024-05-10,8562
00946,群益科技高息成長,165,20,145,新光-高雄,2024-05-10,8562
00632R,元大台灣50反1,1442,1298,144,新光-高雄,2024-05-10,8562
2409,友達,141,2,139,新光-高雄,2024-05-10,8562
3013,晟銘電,279,177,102,新光-高雄,2024-05-10,8562
00751B,元大AAA至A公司債,91,0,91,新光-高雄,2024-05-10,8562
2317,鴻海,166,77,89,新光-高雄,2024-05-10,8562
5871,中租-KY,88,6,82,新光-高雄,2024-05-10,8562
2313,華通,194,120,74,新光-高雄,2024-05-10,8562
3481,群創,75,4,71,新光-高雄,2024-05-10,8562
00939,統一台灣高息動能,106,41,65,新光-高雄,2024-05-10,8562
6116,彩晶,58,0,58,新光-高雄,2024-05-10,8562
00720B,元大投資級公司債,58,3,55,新光-高雄,2024-05-10,8562
2705,六福,53,0,53,新光-高雄,2024-05-10,8562
3033,威健,74,22,52,新光-高雄,2024-05-10,8562
00688L,國泰20年美債正2,62,15,47,新光-高雄,2024-05-10,8562
5291,邑昇,43,1,42,新光-高雄,2024-05-10,8562
5475,德宏,42,1,41,新光-高雄,2024-05-10,8562
2382,廣達,64,24,40,新光-高雄,2024-05-10,8562
020033,統一�琤肮黕篾,40,0,40,新光-高雄,2024-05-10,8562
6244,茂迪,44,6,38,新光-高雄,2024-05-10,8562
9945,潤泰新,56,19,37,新光-高雄,2024-05-10,8562
2887,台新金,51,15,36,新光-高雄,2024-05-10,8562
8277,商丞,33,0,33,新光-高雄,2024-05-10,8562
00944,野村趨勢動能高息,36,4,32,新光-高雄,2024-05-10,8562
3036,文曄,46,15,31,新光-高雄,2024-05-10,8562
9907,統一實,30,0,30,新光-高雄,2024-05-10,8562
1339,昭輝,60,31,29,新光-高雄,2024-05-10,8562
1815,富喬,41,14,27,新光-高雄,2024-05-10,8562
2537,聯上發,41,17,24,新光-高雄,2024-05-10,8562
3710,連展投控,23,0,23,新光-高雄,2024-05-10,8562
4991,環宇-KY,24,1,23,新光-高雄,2024-05-10,8562
00724B,群益投資級金融債,21,0,21,新光-高雄,2024-05-10,8562
3708,上緯投控,21,1,20,新光-高雄,2024-05-10,8562
2031,新光鋼,20,0,20,新光-高雄,2024-05-10,8562
1515,力山,32,13,19,新光-高雄,2024-05-10,8562
6189,豐藝,27,9,18,新光-高雄,2024-05-10,8562
00795B,中信美國公債20年,35,17,18,新光-高雄,2024-05-10,8562
4306,炎洲,32,15,17,新光-高雄,2024-05-10,8562
2421,建準,27,10,17,新光-高雄,2024-05-10,8562
2836,高雄銀,17,1,16,新光-高雄,2024-05-10,8562
3062,建漢,16,0,16,新光-高雄,2024-05-10,8562
2323,中環,35,19,16,新光-高雄,2024-05-10,8562
3058,立德,16,0,16,新光-高雄,2024-05-10,8562
4561,健椿,25,9,16,新光-高雄,2024-05-10,8562
00752,中信中國50,20,5,15,新光-高雄,2024-05-10,8562
6239,力成,48,33,15,新光-高雄,2024-05-10,8562
00929,復華台灣科技優息,644,49,595,新光-高雄,2024-05-13,8562
00715L,期街口布蘭特正2,264,30,234,新光-高雄,2024-05-13,8562
00669R,國泰美國道瓊反1,191,2,189,新光-高雄,2024-05-13,8562
8112,至上,197,43,154,新光-高雄,2024-05-13,8562
2618,長榮航,335,183,152,新光-高雄,2024-05-13,8562
00944,野村趨勢動能高息,144,3,141,新光-高雄,2024-05-13,8562
2317,鴻海,222,102,120,新光-高雄,2024-05-13,8562
00665L,富邦�琤肭磪囓�2,172,57,115,新光-高雄,2024-05-13,8562
2603,長榮,515,404,111,新光-高雄,2024-05-13,8562
00946,群益科技高息成長,112,8,104,新光-高雄,2024-05-13,8562
3260,威剛,141,54,87,新光-高雄,2024-05-13,8562
2388,威盛,89,5,84,新光-高雄,2024-05-13,8562
2883,凱基金,221,140,81,新光-高雄,2024-05-13,8562
00878,國泰永續高股息,134,56,78,新光-高雄,2024-05-13,8562
2617,台航,86,9,77,新光-高雄,2024-05-13,8562
00733,富邦臺灣中小,74,1,73,新光-高雄,2024-05-13,8562
2362,藍天,105,43,62,新光-高雄,2024-05-13,8562
6117,迎廣,69,9,60,新光-高雄,2024-05-13,8562
4562,穎漢,88,38,50,新光-高雄,2024-05-13,8562
2801,彰銀,89,40,49,新光-高雄,2024-05-13,8562
2906,高林,51,4,47,新光-高雄,2024-05-13,8562
2607,榮運,95,49,46,新光-高雄,2024-05-13,8562
1101,台泥,63,18,45,新光-高雄,2024-05-13,8562
0056,元大高股息,59,16,43,新光-高雄,2024-05-13,8562
00936,台新永續高息中小,61,19,42,新光-高雄,2024-05-13,8562
5864,致和證,43,1,42,新光-高雄,2024-05-13,8562
00720B,元大投資級公司債,45,3,42,新光-高雄,2024-05-13,8562
3231,緯創,73,32,41,新光-高雄,2024-05-13,8562
2486,一詮,70,29,41,新光-高雄,2024-05-13,8562
00932,兆豐永續高息等權,39,0,39,新光-高雄,2024-05-13,8562
2537,聯上發,65,29,36,新光-高雄,2024-05-13,8562
8085,福華,40,4,36,新光-高雄,2024-05-13,8562
00945B,凱基美國非投等債,35,0,35,新光-高雄,2024-05-13,8562
4903,聯光通,39,5,34,新光-高雄,2024-05-13,8562
1616,億泰,37,4,33,新光-高雄,2024-05-13,8562
2241,艾姆勒,118,85,33,新光-高雄,2024-05-13,8562
1605,華新,42,9,33,新光-高雄,2024-05-13,8562
00919,群益台灣精選高息,69,37,32,新光-高雄,2024-05-13,8562
1524,耿鼎,82,50,32,新光-高雄,2024-05-13,8562
00679B,元大美債20年,40,8,32,新光-高雄,2024-05-13,8562
1312,國喬,78,47,31,新光-高雄,2024-05-13,8562
00690,兆豐藍籌30,30,0,30,新光-高雄,2024-05-13,8562
2014,中鴻,37,7,30,新光-高雄,2024-05-13,8562
2891,中信金,44,14,30,新光-高雄,2024-05-13,8562
2820,華票,30,1,29,新光-高雄,2024-05-13,8562
1714,和桐,45,17,28,新光-高雄,2024-05-13,8562
6264,富裔,27,0,27,新光-高雄,2024-05-13,8562
5475,德宏,31,4,27,新光-高雄,2024-05-13,8562
8089,康全電訊,42,15,27,新光-高雄,2024-05-13,8562
3234,光環,25,1,24,新光-高雄,2024-05-13,8562
2882,國泰金,359,9,350,新光-高雄,2024-05-14,8562
00929,復華台灣科技優息,324,85,239,新光-高雄,2024-05-14,8562
00937B,群益ESG投等債20,174,2,172,新光-高雄,2024-05-14,8562
00679B,元大美債20年,167,19,148,新光-高雄,2024-05-14,8562
00933B,國泰10Y+金融債,129,5,124,新光-高雄,2024-05-14,8562
2615,萬海,661,543,118,新光-高雄,2024-05-14,8562
00715L,期街口布蘭特正2,106,3,103,新光-高雄,2024-05-14,8562
6125,廣運,124,29,95,新光-高雄,2024-05-14,8562
3062,建漢,181,86,95,新光-高雄,2024-05-14,8562
00931B,統一美債20年,82,0,82,新光-高雄,2024-05-14,8562
9945,潤泰新,112,31,81,新光-高雄,2024-05-14,8562
2317,鴻海,261,185,76,新光-高雄,2024-05-14,8562
00878,國泰永續高股息,128,53,75,新光-高雄,2024-05-14,8562
00665L,富邦�琤肭磪囓�2,84,17,67,新光-高雄,2024-05-14,8562
00720B,元大投資級公司債,73,9,64,新光-高雄,2024-05-14,8562
2801,彰銀,64,1,63,新光-高雄,2024-05-14,8562
2605,新興,386,325,61,新光-高雄,2024-05-14,8562
2610,華航,124,63,61,新光-高雄,2024-05-14,8562
2892,第一金,54,0,54,新光-高雄,2024-05-14,8562
2906,高林,58,4,54,新光-高雄,2024-05-14,8562
00753L,中信中國50正2,58,5,53,新光-高雄,2024-05-14,8562
6116,彩晶,49,0,49,新光-高雄,2024-05-14,8562
2888,新光金,177,128,49,新光-高雄,2024-05-14,8562
3520,華盈,52,4,48,新光-高雄,2024-05-14,8562
2905,三商,60,17,43,新光-高雄,2024-05-14,8562
2636,台驊控股,89,48,41,新光-高雄,2024-05-14,8562
4609,唐鋒,40,0,40,新光-高雄,2024-05-14,8562
00632R,元大台灣50反1,290,252,38,新光-高雄,2024-05-14,8562
00751B,元大AAA至A公司債,36,0,36,新光-高雄,2024-05-14,8562
2427,三商電,55,20,35,新光-高雄,2024-05-14,8562
4960,誠美材,46,12,34,新光-高雄,2024-05-14,8562
8033,雷虎,37,3,34,新光-高雄,2024-05-14,8562
00936,台新永續高息中小,36,3,33,新光-高雄,2024-05-14,8562
2834,臺企銀,35,2,33,新光-高雄,2024-05-14,8562
2409,友達,31,0,31,新光-高雄,2024-05-14,8562
4303,信立,31,0,31,新光-高雄,2024-05-14,8562
1522,堤維西,197,167,30,新光-高雄,2024-05-14,8562
3047,訊舟,62,33,29,新光-高雄,2024-05-14,8562
5706,鳳凰,43,15,28,新光-高雄,2024-05-14,8562
3231,緯創,59,31,28,新光-高雄,2024-05-14,8562
00713,元大台灣高息低波,29,3,26,新光-高雄,2024-05-14,8562
1609,大亞,45,19,26,新光-高雄,2024-05-14,8562
00724B,群益投資級金融債,25,0,25,新光-高雄,2024-05-14,8562
00944,野村趨勢動能高息,30,5,25,新光-高雄,2024-05-14,8562
2820,華票,25,0,25,新光-高雄,2024-05-14,8562
2891,中信金,66,42,24,新光-高雄,2024-05-14,8562
2890,永豐金,25,1,24,新光-高雄,2024-05-14,8562
4714,永捷,33,9,24,新光-高雄,2024-05-14,8562
00650L,復華香港正2,146,122,24,新光-高雄,2024-05-14,8562
1101,台泥,33,10,23,新光-高雄,2024-05-14,8562
00937B,群益ESG投等債20,792,70,722,新光-高雄,2024-05-15,8562
2618,長榮航,442,176,266,新光-高雄,2024-05-15,8562
00688L,國泰20年美債正2,261,70,191,新光-高雄,2024-05-15,8562
00679B,元大美債20年,208,34,174,新光-高雄,2024-05-15,8562
00738U,期元大道瓊白銀,168,0,168,新光-高雄,2024-05-15,8562
00940,元大台灣價值高息,265,99,166,新光-高雄,2024-05-15,8562
2363,矽統,264,102,162,新光-高雄,2024-05-15,8562
00919,群益台灣精選高息,226,65,161,新光-高雄,2024-05-15,8562
00637L,元大滬深300正2,220,70,150,新光-高雄,2024-05-15,8562
2905,三商,151,9,142,新光-高雄,2024-05-15,8562
00878,國泰永續高股息,205,68,137,新光-高雄,2024-05-15,8562
2356,英業達,193,63,130,新光-高雄,2024-05-15,8562
00932,兆豐永續高息等權,118,9,109,新光-高雄,2024-05-15,8562
2610,華航,278,182,96,新光-高雄,2024-05-15,8562
4533,協易機,197,106,91,新光-高雄,2024-05-15,8562
6116,彩晶,86,3,83,新光-高雄,2024-05-15,8562
00753L,中信中國50正2,86,8,78,新光-高雄,2024-05-15,8562
00945B,凱基美國非投等債,66,0,66,新光-高雄,2024-05-15,8562
2603,長榮,245,181,64,新光-高雄,2024-05-15,8562
3202,樺晟,61,3,58,新光-高雄,2024-05-15,8562
3708,上緯投控,61,5,56,新光-高雄,2024-05-15,8562
00936,台新永續高息中小,99,46,53,新光-高雄,2024-05-15,8562
00795B,中信美國公債20年,72,26,46,新光-高雄,2024-05-15,8562
2243,宏旭-KY,50,5,45,新光-高雄,2024-05-15,8562
00918,大華優利高填息30,53,10,43,新光-高雄,2024-05-15,8562
6244,茂迪,55,13,42,新光-高雄,2024-05-15,8562
2486,一詮,73,33,40,新光-高雄,2024-05-15,8562
2406,國碩,112,72,40,新光-高雄,2024-05-15,8562
2705,六福,40,0,40,新光-高雄,2024-05-15,8562
5515,建國,45,6,39,新光-高雄,2024-05-15,8562
2009,第一銅,102,65,37,新光-高雄,2024-05-15,8562
3033,威健,41,5,36,新光-高雄,2024-05-15,8562
2515,中工,83,48,35,新光-高雄,2024-05-15,8562
6207,雷科,91,60,31,新光-高雄,2024-05-15,8562
5608,四維航,48,21,27,新光-高雄,2024-05-15,8562
3060,銘異,67,41,26,新光-高雄,2024-05-15,8562
5340,建榮,26,0,26,新光-高雄,2024-05-15,8562
3234,光環,32,6,26,新光-高雄,2024-05-15,8562
6120,達運,26,1,25,新光-高雄,2024-05-15,8562
2495,普安,26,2,24,新光-高雄,2024-05-15,8562
1314,中石化,54,30,24,新光-高雄,2024-05-15,8562
6695,芯鼎,23,1,22,新光-高雄,2024-05-15,8562
4414,如興,83,61,22,新光-高雄,2024-05-15,8562
3296,勝德,20,0,20,新光-高雄,2024-05-15,8562
3049,精金,20,0,20,新光-高雄,2024-05-15,8562
2903,遠百,32,12,20,新光-高雄,2024-05-15,8562
2367,燿華,499,480,19,新光-高雄,2024-05-15,8562
3702,大聯大,19,0,19,新光-高雄,2024-05-15,8562
6290,良維,19,0,19,新光-高雄,2024-05-15,8562
6213,聯茂,57,39,18,新光-高雄,2024-05-15,8562
00878,國泰永續高股息,1185,51,1134,新光-高雄,2024-05-16,8562
00680L,元大美債20正2,571,265,306,新光-高雄,2024-05-16,8562
2359,所羅門,491,333,158,新光-高雄,2024-05-16,8562
2356,英業達,172,51,121,新光-高雄,2024-05-16,8562
00706L,期元大S＆P日圓正2,116,0,116,新光-高雄,2024-05-16,8562
6274,台燿,129,26,103,新光-高雄,2024-05-16,8562
3231,緯創,139,36,103,新光-高雄,2024-05-16,8562
00671R,富邦NASDAQ反1,96,0,96,新光-高雄,2024-05-16,8562
3705,永信,80,0,80,新光-高雄,2024-05-16,8562
3535,晶彩科,127,54,73,新光-高雄,2024-05-16,8562
2489,瑞軒,240,172,68,新光-高雄,2024-05-16,8562
6177,達麗,108,44,64,新光-高雄,2024-05-16,8562
00772B,中信高評級公司債,63,3,60,新光-高雄,2024-05-16,8562
00669R,國泰美國道瓊反1,72,12,60,新光-高雄,2024-05-16,8562
2301,光寶科,66,14,52,新光-高雄,2024-05-16,8562
6125,廣運,72,20,52,新光-高雄,2024-05-16,8562
00937B,群益ESG投等債20,268,219,49,新光-高雄,2024-05-16,8562
2317,鴻海,343,298,45,新光-高雄,2024-05-16,8562
2465,麗臺,53,10,43,新光-高雄,2024-05-16,8562
00637L,元大滬深300正2,102,59,43,新光-高雄,2024-05-16,8562
00919,群益台灣精選高息,199,156,43,新光-高雄,2024-05-16,8562
1591,駿吉-KY,60,25,35,新光-高雄,2024-05-16,8562
2527,宏璟,43,9,34,新光-高雄,2024-05-16,8562
6016,康和證,41,8,33,新光-高雄,2024-05-16,8562
2330,台積電,45,13,32,新光-高雄,2024-05-16,8562
2520,冠德,46,13,33,新光-高雄,2024-05-16,8562
8096,擎亞,174,142,32,新光-高雄,2024-05-16,8562
9105,泰金寶-DR,60,30,30,新光-高雄,2024-05-16,8562
3363,上詮,119,90,29,新光-高雄,2024-05-16,8562
4562,穎漢,45,18,27,新光-高雄,2024-05-16,8562
2363,矽統,186,159,27,新光-高雄,2024-05-16,8562
00923,群益台ESG低碳50,28,1,27,新光-高雄,2024-05-16,8562
5871,中租-KY,45,21,24,新光-高雄,2024-05-16,8562
2897,王道銀行,23,0,23,新光-高雄,2024-05-16,8562
00690,兆豐藍籌30,23,0,23,新光-高雄,2024-05-16,8562
1785,光洋科,24,1,23,新光-高雄,2024-05-16,8562
2355,敬鵬,26,3,23,新光-高雄,2024-05-16,8562
6616,特昇-KY,22,1,21,新光-高雄,2024-05-16,8562
00945B,凱基美國非投等債,21,0,21,新光-高雄,2024-05-16,8562
3287,廣寰科,34,13,21,新光-高雄,2024-05-16,8562
5392,能率,66,45,21,新光-高雄,2024-05-16,8562
8936,國統,32,11,21,新光-高雄,2024-05-16,8562
00891,中信關鍵半導體,57,37,20,新光-高雄,2024-05-16,8562
1524,耿鼎,24,4,20,新光-高雄,2024-05-16,8562
2365,昆盈,234,214,20,新光-高雄,2024-05-16,8562
00665L,富邦�琤肭磪囓�2,70,51,19,新光-高雄,2024-05-16,8562
4102,永日,19,0,19,新光-高雄,2024-05-16,8562
2501,國建,41,24,17,新光-高雄,2024-05-16,8562
00679B,元大美債20年,124,106,18,新光-高雄,2024-05-16,8562
2511,太子,19,2,17,新光-高雄,2024-05-16,8562
00929,復華台灣科技優息,530,54,476,新光-高雄,2024-05-17,8562
00940,元大台灣價值高息,390,14,376,新光-高雄,2024-05-17,8562
00632R,元大台灣50反1,478,185,293,新光-高雄,2024-05-17,8562
00878,國泰永續高股息,350,73,277,新光-高雄,2024-05-17,8562
00936,台新永續高息中小,142,0,142,新光-高雄,2024-05-17,8562
00665L,富邦�琤肭磪囓�2,139,25,114,新光-高雄,2024-05-17,8562
2618,長榮航,318,214,104,新光-高雄,2024-05-17,8562
2605,新興,117,16,101,新光-高雄,2024-05-17,8562
2374,佳能,551,464,87,新光-高雄,2024-05-17,8562
00918,大華優利高填息30,136,51,85,新光-高雄,2024-05-17,8562
2317,鴻海,229,144,85,新光-高雄,2024-05-17,8562
00679B,元大美債20年,139,65,74,新光-高雄,2024-05-17,8562
2812,台中銀,93,20,73,新光-高雄,2024-05-17,8562
3481,群創,91,22,69,新光-高雄,2024-05-17,8562
2367,燿華,482,415,67,新光-高雄,2024-05-17,8562
3033,威健,290,225,65,新光-高雄,2024-05-17,8562
2417,圓剛,159,98,61,新光-高雄,2024-05-17,8562
5475,德宏,60,0,60,新光-高雄,2024-05-17,8562
00946,群益科技高息成長,57,1,56,新光-高雄,2024-05-17,8562
00688L,國泰20年美債正2,57,5,52,新光-高雄,2024-05-17,8562
1795,美時,86,36,50,新光-高雄,2024-05-17,8562
5880,合庫金,52,2,50,新光-高雄,2024-05-17,8562
2915,潤泰全,65,17,48,新光-高雄,2024-05-17,8562
2349,錸德,50,7,43,新光-高雄,2024-05-17,8562
2356,英業達,73,36,37,新光-高雄,2024-05-17,8562
1785,光洋科,37,1,36,新光-高雄,2024-05-17,8562
00637L,元大滬深300正2,97,62,35,新光-高雄,2024-05-17,8562
2615,萬海,39,4,35,新光-高雄,2024-05-17,8562
1618,合機,42,11,31,新光-高雄,2024-05-17,8562
2537,聯上發,121,91,30,新光-高雄,2024-05-17,8562
2511,太子,30,0,30,新光-高雄,2024-05-17,8562
6257,矽格,32,2,30,新光-高雄,2024-05-17,8562
1455,集盛,29,0,29,新光-高雄,2024-05-17,8562
2834,臺企銀,52,23,29,新光-高雄,2024-05-17,8562
3363,上詮,47,20,27,新光-高雄,2024-05-17,8562
3260,威剛,37,12,25,新光-高雄,2024-05-17,8562
00724B,群益投資級金融債,25,0,25,新光-高雄,2024-05-17,8562
6244,茂迪,49,25,24,新光-高雄,2024-05-17,8562
2801,彰銀,23,0,23,新光-高雄,2024-05-17,8562
1314,中石化,41,18,23,新光-高雄,2024-05-17,8562
2101,南港,41,18,23,新光-高雄,2024-05-17,8562
2606,裕民,29,7,22,新光-高雄,2024-05-17,8562
2408,南亞科,29,7,22,新光-高雄,2024-05-17,8562
2371,大同,67,45,22,新光-高雄,2024-05-17,8562
3141,晶宏,24,3,21,新光-高雄,2024-05-17,8562
2547,日勝生,25,5,20,新光-高雄,2024-05-17,8562
6834,天二科技,20,0,20,新光-高雄,2024-05-17,8562
4102,永日,20,0,20,新光-高雄,2024-05-17,8562
2889,國票金,21,1,20,新光-高雄,2024-05-17,8562
1532,勤美,33,14,19,新光-高雄,2024-05-17,8562
00929,復華台灣科技優息,912,148,764,新光-高雄,2024-05-20,8562
5410,國眾,352,10,342,新光-高雄,2024-05-20,8562
2610,華航,474,142,332,新光-高雄,2024-05-20,8562
00937B,群益ESG投等債20,262,34,228,新光-高雄,2024-05-20,8562
00878,國泰永續高股息,293,71,222,新光-高雄,2024-05-20,8562
2022,聚亨,212,13,199,新光-高雄,2024-05-20,8562
3033,威健,214,33,181,新光-高雄,2024-05-20,8562
00680L,元大美債20正2,189,32,157,新光-高雄,2024-05-20,8562
00632R,元大台灣50反1,218,78,140,新光-高雄,2024-05-20,8562
2867,三商壽,294,215,79,新光-高雄,2024-05-20,8562
00688L,國泰20年美債正2,81,20,61,新光-高雄,2024-05-20,8562
5521,工信,116,56,60,新光-高雄,2024-05-20,8562
1597,直得,78,20,58,新光-高雄,2024-05-20,8562
2317,鴻海,125,72,53,新光-高雄,2024-05-20,8562
5009,榮剛,96,43,53,新光-高雄,2024-05-20,8562
00946,群益科技高息成長,50,1,49,新光-高雄,2024-05-20,8562
8028,昇陽半導體,115,67,48,新光-高雄,2024-05-20,8562
2025,千興,51,3,48,新光-高雄,2024-05-20,8562
3231,緯創,83,38,45,新光-高雄,2024-05-20,8562
1612,宏泰,85,41,44,新光-高雄,2024-05-20,8562
4939,亞電,44,0,44,新光-高雄,2024-05-20,8562
00679B,元大美債20年,63,20,43,新光-高雄,2024-05-20,8562
2886,兆豐金,42,0,42,新光-高雄,2024-05-20,8562
2201,裕隆,41,0,41,新光-高雄,2024-05-20,8562
2515,中工,125,85,40,新光-高雄,2024-05-20,8562
9105,泰金寶-DR,70,30,40,新光-高雄,2024-05-20,8562
2393,億光,40,1,39,新光-高雄,2024-05-20,8562
2881,富邦金,37,0,37,新光-高雄,2024-05-20,8562
00918,大華優利高填息30,39,4,35,新光-高雄,2024-05-20,8562
00673R,期元大S＆P原油反1,35,0,35,新光-高雄,2024-05-20,8562
6213,聯茂,54,22,32,新光-高雄,2024-05-20,8562
2017,官田鋼,51,20,31,新光-高雄,2024-05-20,8562
4414,如興,30,0,30,新光-高雄,2024-05-20,8562
6237,驊訊,35,6,29,新光-高雄,2024-05-20,8562
5469,瀚宇博,35,6,29,新光-高雄,2024-05-20,8562
1312,國喬,33,6,27,新光-高雄,2024-05-20,8562
00860B,群益1-5Y投資級債,26,0,26,新光-高雄,2024-05-20,8562
2329,華泰,55,30,25,新光-高雄,2024-05-20,8562
00795B,中信美國公債20年,24,0,24,新光-高雄,2024-05-20,8562
1615,大山,28,4,24,新光-高雄,2024-05-20,8562
2467,志聖,61,38,23,新光-高雄,2024-05-20,8562
2412,中華電,44,22,22,新光-高雄,2024-05-20,8562
6215,和椿,66,44,22,新光-高雄,2024-05-20,8562
9904,寶成,23,2,21,新光-高雄,2024-05-20,8562
5508,永信建,42,21,21,新光-高雄,2024-05-20,8562
6278,台表科,25,5,20,新光-高雄,2024-05-20,8562
00719B,元大美債1-3,20,0,20,新光-高雄,2024-05-20,8562
00931B,統一美債20年,20,0,20,新光-高雄,2024-05-20,8562
6928,攸泰科技,20,0,20,新光-高雄,2024-05-20,8562
4533,協易機,275,256,19,新光-高雄,2024-05-20,8562
2891,中信金,542,28,514,新光-高雄,2024-05-21,8562
00632R,元大台灣50反1,1698,1309,389,新光-高雄,2024-05-21,8562
00937B,群益ESG投等債20,293,1,292,新光-高雄,2024-05-21,8562
00929,復華台灣科技優息,395,174,221,新光-高雄,2024-05-21,8562
00680L,元大美債20正2,207,3,204,新光-高雄,2024-05-21,8562
5521,工信,166,8,158,新光-高雄,2024-05-21,8562
5426,振發,166,46,120,新光-高雄,2024-05-21,8562
8028,昇陽半導體,201,93,108,新光-高雄,2024-05-21,8562
3481,群創,93,1,92,新光-高雄,2024-05-21,8562
2605,新興,96,8,88,新光-高雄,2024-05-21,8562
8110,華東,190,123,67,新光-高雄,2024-05-21,8562
5864,致和證,65,0,65,新光-高雄,2024-05-21,8562
00919,群益台灣精選高息,88,27,61,新光-高雄,2024-05-21,8562
2363,矽統,119,59,60,新光-高雄,2024-05-21,8562
1314,中石化,76,18,58,新光-高雄,2024-05-21,8562
3665,貿聯-KY,62,4,58,新光-高雄,2024-05-21,8562
2915,潤泰全,70,15,55,新光-高雄,2024-05-21,8562
2317,鴻海,104,49,55,新光-高雄,2024-05-21,8562
2515,中工,92,38,54,新光-高雄,2024-05-21,8562
2337,旺宏,54,3,51,新光-高雄,2024-05-21,8562
2323,中環,47,0,47,新光-高雄,2024-05-21,8562
00944,野村趨勢動能高息,48,1,47,新光-高雄,2024-05-21,8562
1618,合機,52,7,45,新光-高雄,2024-05-21,8562
2409,友達,44,2,42,新光-高雄,2024-05-21,8562
2834,臺企銀,61,22,39,新光-高雄,2024-05-21,8562
1319,東陽,47,9,38,新光-高雄,2024-05-21,8562
2344,華邦電,40,3,37,新光-高雄,2024-05-21,8562
00688L,國泰20年美債正2,36,0,36,新光-高雄,2024-05-21,8562
2374,佳能,206,171,35,新光-高雄,2024-05-21,8562
3702,大聯大,66,33,33,新光-高雄,2024-05-21,8562
2880,華南金,36,3,33,新光-高雄,2024-05-21,8562
00752,中信中國50,33,2,31,新光-高雄,2024-05-21,8562
1605,華新,209,181,28,新光-高雄,2024-05-21,8562
1597,直得,45,17,28,新光-高雄,2024-05-21,8562
1301,台塑,28,0,28,新光-高雄,2024-05-21,8562
1101,台泥,35,8,27,新光-高雄,2024-05-21,8562
3576,聯合再生,41,13,28,新光-高雄,2024-05-21,8562
6667,信紘科,30,3,27,新光-高雄,2024-05-21,8562
00712,復華富時不動產,35,9,26,新光-高雄,2024-05-21,8562
00939,統一台灣高息動能,41,15,26,新光-高雄,2024-05-21,8562
00724B,群益投資級金融債,25,0,25,新光-高雄,2024-05-21,8562
4513,福裕,25,0,25,新光-高雄,2024-05-21,8562
2603,長榮,87,63,24,新光-高雄,2024-05-21,8562
1218,泰山,25,1,24,新光-高雄,2024-05-21,8562
5469,瀚宇博,31,7,24,新光-高雄,2024-05-21,8562
4164,承業醫,25,1,24,新光-高雄,2024-05-21,8562
0056,元大高股息,37,13,24,新光-高雄,2024-05-21,8562
2890,永豐金,30,7,23,新光-高雄,2024-05-21,8562
00933B,國泰10Y+金融債,63,40,23,新光-高雄,2024-05-21,8562
00931B,統一美債20年,33,10,23,新光-高雄,2024-05-21,8562
00937B,群益ESG投等債20,381,10,371,新光-高雄,2024-05-22,8562
3481,群創,827,578,249,新光-高雄,2024-05-22,8562
2867,三商壽,261,37,224,新光-高雄,2024-05-22,8562
2884,玉山金,195,0,195,新光-高雄,2024-05-22,8562
1815,富喬,498,355,143,新光-高雄,2024-05-22,8562
2002,中鋼,105,0,105,新光-高雄,2024-05-22,8562
2610,華航,106,25,81,新光-高雄,2024-05-22,8562
00930,永豐ESG低碳高息,89,11,78,新光-高雄,2024-05-22,8562
2888,新光金,98,20,78,新光-高雄,2024-05-22,8562
5521,工信,90,15,75,新光-高雄,2024-05-22,8562
2359,所羅門,303,234,69,新光-高雄,2024-05-22,8562
2344,華邦電,64,3,61,新光-高雄,2024-05-22,8562
3047,訊舟,240,181,59,新光-高雄,2024-05-22,8562
00715L,期街口布蘭特正2,87,31,56,新光-高雄,2024-05-22,8562
00753L,中信中國50正2,56,0,56,新光-高雄,2024-05-22,8562
00679B,元大美債20年,60,8,52,新光-高雄,2024-05-22,8562
1303,南亞,57,5,52,新光-高雄,2024-05-22,8562
4533,協易機,213,163,50,新光-高雄,2024-05-22,8562
3576,聯合再生,81,33,48,新光-高雄,2024-05-22,8562
4714,永捷,46,5,41,新光-高雄,2024-05-22,8562
6274,台燿,49,8,41,新光-高雄,2024-05-22,8562
00752,中信中國50,41,0,41,新光-高雄,2024-05-22,8562
1319,東陽,42,2,40,新光-高雄,2024-05-22,8562
00637L,元大滬深300正2,42,2,40,新光-高雄,2024-05-22,8562
2367,燿華,245,207,38,新光-高雄,2024-05-22,8562
6115,鎰勝,40,2,38,新光-高雄,2024-05-22,8562
6125,廣運,228,191,37,新光-高雄,2024-05-22,8562
2014,中鴻,35,0,35,新光-高雄,2024-05-22,8562
5009,榮剛,36,3,33,新光-高雄,2024-05-22,8562
5515,建國,33,0,33,新光-高雄,2024-05-22,8562
00882,中信中國高股息,112,80,32,新光-高雄,2024-05-22,8562
5392,能率,114,83,31,新光-高雄,2024-05-22,8562
2489,瑞軒,82,51,31,新光-高雄,2024-05-22,8562
00712,復華富時不動產,33,2,31,新光-高雄,2024-05-22,8562
2342,茂矽,30,0,30,新光-高雄,2024-05-22,8562
4414,如興,30,0,30,新光-高雄,2024-05-22,8562
6188,廣明,152,123,29,新光-高雄,2024-05-22,8562
00944,野村趨勢動能高息,61,33,28,新光-高雄,2024-05-22,8562
1312,國喬,28,0,28,新光-高雄,2024-05-22,8562
1809,中釉,59,31,28,新光-高雄,2024-05-22,8562
2027,大成鋼,34,8,26,新光-高雄,2024-05-22,8562
1604,聲寶,25,0,25,新光-高雄,2024-05-22,8562
00946,群益科技高息成長,32,8,24,新光-高雄,2024-05-22,8562
2504,國產,40,16,24,新光-高雄,2024-05-22,8562
00665L,富邦�琤肭磪囓�2,39,16,23,新光-高雄,2024-05-22,8562
2009,第一銅,267,246,21,新光-高雄,2024-05-22,8562
8071,能率網通,100,79,21,新光-高雄,2024-05-22,8562
3338,泰碩,54,33,21,新光-高雄,2024-05-22,8562
1605,華新,54,33,21,新光-高雄,2024-05-22,8562
1618,合機,27,6,21,新光-高雄,2024-05-22,8562
1815,富喬,1082,789,293,新光-高雄,2024-05-23,8562
00940,元大台灣價值高息,410,197,213,新光-高雄,2024-05-23,8562
00946,群益科技高息成長,207,32,175,新光-高雄,2024-05-23,8562
00637L,元大滬深300正2,266,106,160,新光-高雄,2024-05-23,8562
2705,六福,157,0,157,新光-高雄,2024-05-23,8562
00715L,期街口布蘭特正2,183,30,153,新光-高雄,2024-05-23,8562
3481,群創,173,56,117,新光-高雄,2024-05-23,8562
2324,仁寶,227,113,114,新光-高雄,2024-05-23,8562
2464,盟立,286,185,101,新光-高雄,2024-05-23,8562
2002,中鋼,143,44,99,新光-高雄,2024-05-23,8562
5521,工信,107,15,92,新光-高雄,2024-05-23,8562
1604,聲寶,87,0,87,新光-高雄,2024-05-23,8562
00927,群益半導體收益,80,2,78,新光-高雄,2024-05-23,8562
3576,聯合再生,113,36,77,新光-高雄,2024-05-23,8562
3312,弘憶股,90,25,65,新光-高雄,2024-05-23,8562
00680L,元大美債20正2,81,19,62,新光-高雄,2024-05-23,8562
4306,炎洲,55,0,55,新光-高雄,2024-05-23,8562
1319,東陽,52,0,52,新光-高雄,2024-05-23,8562
1597,直得,64,12,52,新光-高雄,2024-05-23,8562
2101,南港,60,9,51,新光-高雄,2024-05-23,8562
6213,聯茂,114,65,49,新光-高雄,2024-05-23,8562
1409,新纖,49,0,49,新光-高雄,2024-05-23,8562
2886,兆豐金,49,2,47,新光-高雄,2024-05-23,8562
2915,潤泰全,53,7,46,新光-高雄,2024-05-23,8562
2892,第一金,53,7,46,新光-高雄,2024-05-23,8562
1314,中石化,58,15,43,新光-高雄,2024-05-23,8562
2356,英業達,60,19,41,新光-高雄,2024-05-23,8562
2371,大同,78,38,40,新光-高雄,2024-05-23,8562
00937B,群益ESG投等債20,153,114,39,新光-高雄,2024-05-23,8562
2340,台亞,41,2,39,新光-高雄,2024-05-23,8562
6937,天虹,37,0,37,新光-高雄,2024-05-23,8562
3710,連展投控,37,0,37,新光-高雄,2024-05-23,8562
5371,中光電,99,64,35,新光-高雄,2024-05-23,8562
6757,台灣虎航,35,0,35,新光-高雄,2024-05-23,8562
6147,頎邦,35,2,33,新光-高雄,2024-05-23,8562
2406,國碩,36,3,33,新光-高雄,2024-05-23,8562
2812,台中銀,36,4,32,新光-高雄,2024-05-23,8562
2888,新光金,176,144,32,新光-高雄,2024-05-23,8562
2882,國泰金,37,5,32,新光-高雄,2024-05-23,8562
5864,致和證,41,10,31,新光-高雄,2024-05-23,8562
3260,威剛,32,2,30,新光-高雄,2024-05-23,8562
1460,宏遠,30,0,30,新光-高雄,2024-05-23,8562
2374,佳能,50,20,30,新光-高雄,2024-05-23,8562
2609,陽明,48,18,30,新光-高雄,2024-05-23,8562
1504,東元,35,6,29,新光-高雄,2024-05-23,8562
3052,夆典,29,0,29,新光-高雄,2024-05-23,8562
2618,長榮航,167,139,28,新光-高雄,2024-05-23,8562
00936,台新永續高息中小,32,5,27,新光-高雄,2024-05-23,8562
6209,今國光,127,101,26,新光-高雄,2024-05-23,8562
2009,第一銅,66,40,26,新光-高雄,2024-05-23,8562
2801,彰銀,606,7,599,新光-高雄,2024-05-24,8562
00712,復華富時不動產,556,26,530,新光-高雄,2024-05-24,8562
00632R,元大台灣50反1,336,26,310,新光-高雄,2024-05-24,8562
00637L,元大滬深300正2,292,131,161,新光-高雄,2024-05-24,8562
00929,復華台灣科技優息,251,102,149,新光-高雄,2024-05-24,8562
8028,昇陽半導體,158,25,133,新光-高雄,2024-05-24,8562
2515,中工,141,39,102,新光-高雄,2024-05-24,8562
00720B,元大投資級公司債,95,0,95,新光-高雄,2024-05-24,8562
2303,聯電,113,31,82,新光-高雄,2024-05-24,8562
00946,群益科技高息成長,87,5,82,新光-高雄,2024-05-24,8562
1810,和成,113,42,71,新光-高雄,2024-05-24,8562
6283,淳安,72,4,68,新光-高雄,2024-05-24,8562
4306,炎洲,80,13,67,新光-高雄,2024-05-24,8562
00715L,期街口布蘭特正2,110,45,65,新光-高雄,2024-05-24,8562
1314,中石化,72,13,59,新光-高雄,2024-05-24,8562
3060,銘異,90,32,58,新光-高雄,2024-05-24,8562
6125,廣運,142,87,55,新光-高雄,2024-05-24,8562
8906,花王,53,2,51,新光-高雄,2024-05-24,8562
2002,中鋼,57,6,51,新光-高雄,2024-05-24,8562
2867,三商壽,78,27,51,新光-高雄,2024-05-24,8562
00751B,元大AAA至A公司債,50,0,50,新光-高雄,2024-05-24,8562
8374,羅昇,49,0,49,新光-高雄,2024-05-24,8562
00882,中信中國高股息,97,48,49,新光-高雄,2024-05-24,8562
6830,汎銓,48,0,48,新光-高雄,2024-05-24,8562
2884,玉山金,57,9,48,新光-高雄,2024-05-24,8562
9938,百和,45,1,44,新光-高雄,2024-05-24,8562
1312,國喬,39,1,38,新光-高雄,2024-05-24,8562
2891,中信金,52,15,37,新光-高雄,2024-05-24,8562
8070,長華*,60,26,34,新光-高雄,2024-05-24,8562
00857B,永豐20年美公債,44,10,34,新光-高雄,2024-05-24,8562
2344,華邦電,100,67,33,新光-高雄,2024-05-24,8562
00933B,國泰10Y+金融債,53,21,32,新光-高雄,2024-05-24,8562
3706,神達,44,12,32,新光-高雄,2024-05-24,8562
8110,華東,34,2,32,新光-高雄,2024-05-24,8562
00927,群益半導體收益,32,2,30,新光-高雄,2024-05-24,8562
2618,長榮航,120,90,30,新光-高雄,2024-05-24,8562
2888,新光金,36,6,30,新光-高雄,2024-05-24,8562
4414,如興,30,0,30,新光-高雄,2024-05-24,8562
00738U,期元大道瓊白銀,30,0,30,新光-高雄,2024-05-24,8562
6269,台郡,36,6,30,新光-高雄,2024-05-24,8562
6147,頎邦,33,4,29,新光-高雄,2024-05-24,8562
2367,燿華,125,97,28,新光-高雄,2024-05-24,8562
00752,中信中國50,28,1,27,新光-高雄,2024-05-24,8562
2886,兆豐金,27,0,27,新光-高雄,2024-05-24,8562
1303,南亞,30,3,27,新光-高雄,2024-05-24,8562
1339,昭輝,25,2,23,新光-高雄,2024-05-24,8562
2014,中鴻,24,2,22,新光-高雄,2024-05-24,8562
5522,遠雄,47,25,22,新光-高雄,2024-05-24,8562
6288,聯嘉,21,0,21,新光-高雄,2024-05-24,8562
2834,臺企銀,22,1,21,新光-高雄,2024-05-24,8562
9105,泰金寶-DR,947,356,591,新光-高雄,2024-05-27,8562
00937B,群益ESG投等債20,680,276,404,新光-高雄,2024-05-27,8562
2610,華航,309,10,299,新光-高雄,2024-05-27,8562
00712,復華富時不動產,205,1,204,新光-高雄,2024-05-27,8562
020033,統一�琤肮黕篾,200,0,200,新光-高雄,2024-05-27,8562
00946,群益科技高息成長,161,46,115,新光-高雄,2024-05-27,8562
2353,宏��,389,280,109,新光-高雄,2024-05-27,8562
2867,三商壽,138,38,100,新光-高雄,2024-05-27,8562
00927,群益半導體收益,120,22,98,新光-高雄,2024-05-27,8562
2609,陽明,131,39,92,新光-高雄,2024-05-27,8562
2363,矽統,311,225,86,新光-高雄,2024-05-27,8562
2611,志信,95,12,83,新光-高雄,2024-05-27,8562
2889,國票金,73,2,71,新光-高雄,2024-05-27,8562
00679B,元大美債20年,67,5,62,新光-高雄,2024-05-27,8562
00936,台新永續高息中小,96,37,59,新光-高雄,2024-05-27,8562
6284,佳邦,54,3,51,新光-高雄,2024-05-27,8562
1503,士電,66,18,48,新光-高雄,2024-05-27,8562
2888,新光金,50,2,48,新光-高雄,2024-05-27,8562
2489,瑞軒,324,277,47,新光-高雄,2024-05-27,8562
2002,中鋼,58,12,46,新光-高雄,2024-05-27,8562
6126,信音,46,1,45,新光-高雄,2024-05-27,8562
9945,潤泰新,55,11,44,新光-高雄,2024-05-27,8562
3060,銘異,65,21,44,新光-高雄,2024-05-27,8562
5469,瀚宇博,51,8,43,新光-高雄,2024-05-27,8562
2509,全坤建,45,3,42,新光-高雄,2024-05-27,8562
5498,凱崴,139,99,40,新光-高雄,2024-05-27,8562
2618,長榮航,671,632,39,新光-高雄,2024-05-27,8562
2886,兆豐金,39,2,37,新光-高雄,2024-05-27,8562
6125,廣運,174,138,36,新光-高雄,2024-05-27,8562
3047,訊舟,235,201,34,新光-高雄,2024-05-27,8562
00650L,復華香港正2,48,15,33,新光-高雄,2024-05-27,8562
2340,台亞,44,11,33,新光-高雄,2024-05-27,8562
6152,百一,31,0,31,新光-高雄,2024-05-27,8562
6213,聯茂,127,97,30,新光-高雄,2024-05-27,8562
4414,如興,30,0,30,新光-高雄,2024-05-27,8562
00676R,富邦臺灣加權反1,30,0,30,新光-高雄,2024-05-27,8562
2412,中華電,40,10,30,新光-高雄,2024-05-27,8562
1108,幸福,30,1,29,新光-高雄,2024-05-27,8562
2405,輔信,135,106,29,新光-高雄,2024-05-27,8562
2330,台積電,35,8,27,新光-高雄,2024-05-27,8562
6190,萬泰科,29,2,27,新光-高雄,2024-05-27,8562
00942B,台新美A公司債20+,27,0,27,新光-高雄,2024-05-27,8562
2883,凱基金,27,1,26,新光-高雄,2024-05-27,8562
3501,維熹,25,0,25,新光-高雄,2024-05-27,8562
3499,環天科,28,3,25,新光-高雄,2024-05-27,8562
6414,樺漢,29,5,24,新光-高雄,2024-05-27,8562
5210,寶碩,25,1,24,新光-高雄,2024-05-27,8562
00933B,國泰10Y+金融債,31,8,23,新光-高雄,2024-05-27,8562
2392,正崴,67,44,23,新光-高雄,2024-05-27,8562
1319,東陽,27,4,23,新光-高雄,2024-05-27,8562
00712,復華富時不動產,300,7,293,新光-高雄,2024-05-28,8562
00937B,群益ESG投等債20,412,134,278,新光-高雄,2024-05-28,8562
00929,復華台灣科技優息,360,160,200,新光-高雄,2024-05-28,8562
00637L,元大滬深300正2,193,38,155,新光-高雄,2024-05-28,8562
9105,泰金寶-DR,248,107,141,新光-高雄,2024-05-28,8562
00908,富邦入息REITs+,129,0,129,新光-高雄,2024-05-28,8562
00679B,元大美債20年,121,4,117,新光-高雄,2024-05-28,8562
5210,寶碩,112,0,112,新光-高雄,2024-05-28,8562
00665L,富邦�琤肭磪囓�2,149,47,102,新光-高雄,2024-05-28,8562
2313,華通,109,15,94,新光-高雄,2024-05-28,8562
2891,中信金,93,9,84,新光-高雄,2024-05-28,8562
2354,鴻準,570,487,83,新光-高雄,2024-05-28,8562
2301,光寶科,102,24,78,新光-高雄,2024-05-28,8562
3712,永崴投控,154,80,74,新光-高雄,2024-05-28,8562
00946,群益科技高息成長,73,9,64,新光-高雄,2024-05-28,8562
2886,兆豐金,58,0,58,新光-高雄,2024-05-28,8562
2834,臺企銀,67,12,55,新光-高雄,2024-05-28,8562
3231,緯創,204,149,55,新光-高雄,2024-05-28,8562
2601,益航,84,34,50,新光-高雄,2024-05-28,8562
5512,力麒,66,19,47,新光-高雄,2024-05-28,8562
2464,盟立,193,146,47,新光-高雄,2024-05-28,8562
00795B,中信美國公債20年,47,1,46,新光-高雄,2024-05-28,8562
2515,中工,180,135,45,新光-高雄,2024-05-28,8562
2317,鴻海,172,129,43,新光-高雄,2024-05-28,8562
00940,元大台灣價值高息,101,59,42,新光-高雄,2024-05-28,8562
6275,元山,55,18,37,新光-高雄,2024-05-28,8562
6806,森崴能源,46,11,35,新光-高雄,2024-05-28,8562
6177,達麗,43,9,34,新光-高雄,2024-05-28,8562
6152,百一,31,0,31,新光-高雄,2024-05-28,8562
4938,和碩,37,7,30,新光-高雄,2024-05-28,8562
2637,慧洋-KY,35,5,30,新光-高雄,2024-05-28,8562
2812,台中銀,38,8,30,新光-高雄,2024-05-28,8562
3202,樺晟,121,93,28,新光-高雄,2024-05-28,8562
8940,新天地,40,13,27,新光-高雄,2024-05-28,8562
4303,信立,28,2,26,新光-高雄,2024-05-28,8562
6188,廣明,138,112,26,新光-高雄,2024-05-28,8562
2609,陽明,81,55,26,新光-高雄,2024-05-28,8562
2324,仁寶,93,69,24,新光-高雄,2024-05-28,8562
3686,達能,25,2,23,新光-高雄,2024-05-28,8562
8027,鈦昇,59,37,22,新光-高雄,2024-05-28,8562
00753L,中信中國50正2,33,12,21,新光-高雄,2024-05-28,8562
1303,南亞,26,6,20,新光-高雄,2024-05-28,8562
00673R,期元大S＆P原油反1,20,0,20,新光-高雄,2024-05-28,8562
2641,正德,115,95,20,新光-高雄,2024-05-28,8562
1618,合機,28,9,19,新光-高雄,2024-05-28,8562
8110,華東,24,5,19,新光-高雄,2024-05-28,8562
8255,朋程,19,1,18,新光-高雄,2024-05-28,8562
1531,高林股,20,2,18,新光-高雄,2024-05-28,8562
00919,群益台灣精選高息,106,88,18,新光-高雄,2024-05-28,8562
2382,廣達,44,26,18,新光-高雄,2024-05-28,8562
00937B,群益ESG投等債20,929,263,666,新光-高雄,2024-05-29,8562
00946,群益科技高息成長,403,56,347,新光-高雄,2024-05-29,8562
00679B,元大美債20年,404,96,308,新光-高雄,2024-05-29,8562
00680L,元大美債20正2,305,80,225,新光-高雄,2024-05-29,8562
2886,兆豐金,187,1,186,新光-高雄,2024-05-29,8562
5210,寶碩,185,0,185,新光-高雄,2024-05-29,8562
2610,華航,306,128,178,新光-高雄,2024-05-29,8562
00632R,元大台灣50反1,291,130,161,新光-高雄,2024-05-29,8562
2317,鴻海,218,65,153,新光-高雄,2024-05-29,8562
00712,復華富時不動產,167,25,142,新光-高雄,2024-05-29,8562
00671R,富邦NASDAQ反1,140,0,140,新光-高雄,2024-05-29,8562
2883,凱基金,133,8,125,新光-高雄,2024-05-29,8562
1815,富喬,228,122,106,新光-高雄,2024-05-29,8562
2905,三商,120,33,87,新光-高雄,2024-05-29,8562
00933B,國泰10Y+金融債,110,24,86,新光-高雄,2024-05-29,8562
00753L,中信中國50正2,89,4,85,新光-高雄,2024-05-29,8562
2834,臺企銀,90,8,82,新光-高雄,2024-05-29,8562
2353,宏��,215,134,81,新光-高雄,2024-05-29,8562
00665L,富邦�琤肭磪囓�2,130,52,78,新光-高雄,2024-05-29,8562
00940,元大台灣價值高息,184,108,76,新光-高雄,2024-05-29,8562
8064,東捷,118,43,75,新光-高雄,2024-05-29,8562
00795B,中信美國公債20年,78,6,72,新光-高雄,2024-05-29,8562
3231,緯創,185,117,68,新光-高雄,2024-05-29,8562
2609,陽明,102,34,68,新光-高雄,2024-05-29,8562
00687B,國泰20年美債,173,107,66,新光-高雄,2024-05-29,8562
2891,中信金,81,16,65,新光-高雄,2024-05-29,8562
2618,長榮航,235,170,65,新光-高雄,2024-05-29,8562
3380,明泰,88,24,64,新光-高雄,2024-05-29,8562
2801,彰銀,63,1,62,新光-高雄,2024-05-29,8562
1101,台泥,70,9,61,新光-高雄,2024-05-29,8562
5871,中租-KY,62,3,59,新光-高雄,2024-05-29,8562
1714,和桐,50,0,50,新光-高雄,2024-05-29,8562
00930,永豐ESG低碳高息,50,4,46,新光-高雄,2024-05-29,8562
8028,昇陽半導體,67,22,45,新光-高雄,2024-05-29,8562
1303,南亞,49,4,45,新光-高雄,2024-05-29,8562
00720B,元大投資級公司債,47,2,45,新光-高雄,2024-05-29,8562
8096,擎亞,85,40,45,新光-高雄,2024-05-29,8562
2367,燿華,93,49,44,新光-高雄,2024-05-29,8562
2884,玉山金,57,14,43,新光-高雄,2024-05-29,8562
4714,永捷,60,17,43,新光-高雄,2024-05-29,8562
1319,東陽,43,1,42,新光-高雄,2024-05-29,8562
00944,野村趨勢動能高息,41,0,41,新光-高雄,2024-05-29,8562
2365,昆盈,84,45,39,新光-高雄,2024-05-29,8562
2409,友達,49,10,39,新光-高雄,2024-05-29,8562
3576,聯合再生,42,4,38,新光-高雄,2024-05-29,8562
2101,南港,43,6,37,新光-高雄,2024-05-29,8562
8046,南電,95,58,37,新光-高雄,2024-05-29,8562
4543,萬在,44,8,36,新光-高雄,2024-05-29,8562
2605,新興,203,168,35,新光-高雄,2024-05-29,8562
6125,廣運,201,166,35,新光-高雄,2024-05-29,8562
00937B,群益ESG投等債20,749,12,737,新光-高雄,2024-05-30,8562
00680L,元大美債20正2,417,26,391,新光-高雄,2024-05-30,8562
00940,元大台灣價值高息,515,149,366,新光-高雄,2024-05-30,8562
00929,復華台灣科技優息,508,163,345,新光-高雄,2024-05-30,8562
00712,復華富時不動產,274,11,263,新光-高雄,2024-05-30,8562
00632R,元大台灣50反1,971,781,190,新光-高雄,2024-05-30,8562
2312,金寶,155,6,149,新光-高雄,2024-05-30,8562
2610,華航,298,155,143,新光-高雄,2024-05-30,8562
5210,寶碩,132,0,132,新光-高雄,2024-05-30,8562
4414,如興,118,0,118,新光-高雄,2024-05-30,8562
2905,三商,121,5,116,新光-高雄,2024-05-30,8562
00878,國泰永續高股息,129,22,107,新光-高雄,2024-05-30,8562
00679B,元大美債20年,189,94,95,新光-高雄,2024-05-30,8562
1440,南紡,83,1,82,新光-高雄,2024-05-30,8562
2489,瑞軒,150,78,72,新光-高雄,2024-05-30,8562
4562,穎漢,138,67,71,新光-高雄,2024-05-30,8562
9105,泰金寶-DR,71,5,66,新光-高雄,2024-05-30,8562
2891,中信金,74,10,64,新光-高雄,2024-05-30,8562
1442,名軒,70,6,64,新光-高雄,2024-05-30,8562
00933B,國泰10Y+金融債,81,19,62,新光-高雄,2024-05-30,8562
2323,中環,65,6,59,新光-高雄,2024-05-30,8562
2353,宏��,265,207,58,新光-高雄,2024-05-30,8562
6213,聯茂,85,31,54,新光-高雄,2024-05-30,8562
00720B,元大投資級公司債,52,0,52,新光-高雄,2024-05-30,8562
6116,彩晶,52,0,52,新光-高雄,2024-05-30,8562
2354,鴻準,136,85,51,新光-高雄,2024-05-30,8562
2834,臺企銀,62,13,49,新光-高雄,2024-05-30,8562
2915,潤泰全,52,4,48,新光-高雄,2024-05-30,8562
3013,晟銘電,87,40,47,新光-高雄,2024-05-30,8562
2884,玉山金,46,1,45,新光-高雄,2024-05-30,8562
6143,振曜,46,1,45,新光-高雄,2024-05-30,8562
1303,南亞,64,20,44,新光-高雄,2024-05-30,8562
00946,群益科技高息成長,62,19,43,新光-高雄,2024-05-30,8562
2349,錸德,46,3,43,新光-高雄,2024-05-30,8562
3033,威健,146,104,42,新光-高雄,2024-05-30,8562
3710,連展投控,49,8,41,新光-高雄,2024-05-30,8562
2888,新光金,65,24,41,新光-高雄,2024-05-30,8562
2892,第一金,42,1,41,新光-高雄,2024-05-30,8562
2547,日勝生,40,0,40,新光-高雄,2024-05-30,8562
00637L,元大滬深300正2,71,31,40,新光-高雄,2024-05-30,8562
1597,直得,40,1,39,新光-高雄,2024-05-30,8562
2301,光寶科,50,11,39,新光-高雄,2024-05-30,8562
2882,國泰金,56,17,39,新光-高雄,2024-05-30,8562
2363,矽統,86,47,39,新光-高雄,2024-05-30,8562
2886,兆豐金,40,2,38,新光-高雄,2024-05-30,8562
4533,協易機,93,55,38,新光-高雄,2024-05-30,8562
6177,達麗,55,18,37,新光-高雄,2024-05-30,8562
2515,中工,83,46,37,新光-高雄,2024-05-30,8562
8028,昇陽半導體,91,54,37,新光-高雄,2024-05-30,8562
4306,炎洲,45,8,37,新光-高雄,2024-05-30,8562
00929,復華台灣科技優息,510,97,413,新光-高雄,2024-05-31,8562
2609,陽明,1023,738,285,新光-高雄,2024-05-31,8562
2354,鴻準,575,320,255,新光-高雄,2024-05-31,8562
9105,泰金寶-DR,313,71,242,新光-高雄,2024-05-31,8562
00637L,元大滬深300正2,283,50,233,新光-高雄,2024-05-31,8562
2109,華豐,188,9,179,新光-高雄,2024-05-31,8562
3033,威健,265,87,178,新光-高雄,2024-05-31,8562
00632R,元大台灣50反1,231,83,148,新光-高雄,2024-05-31,8562
00946,群益科技高息成長,261,118,143,新光-高雄,2024-05-31,8562
00927,群益半導體收益,175,42,133,新光-高雄,2024-05-31,8562
2317,鴻海,212,93,119,新光-高雄,2024-05-31,8562
3231,緯創,147,37,110,新光-高雄,2024-05-31,8562
2313,華通,111,8,103,新光-高雄,2024-05-31,8562
2889,國票金,103,15,88,新光-高雄,2024-05-31,8562
2002,中鋼,90,12,78,新光-高雄,2024-05-31,8562
00679B,元大美債20年,95,17,78,新光-高雄,2024-05-31,8562
00715L,期街口布蘭特正2,87,10,77,新光-高雄,2024-05-31,8562
1536,和大,85,17,68,新光-高雄,2024-05-31,8562
00688L,國泰20年美債正2,76,11,65,新光-高雄,2024-05-31,8562
1815,富喬,230,170,60,新光-高雄,2024-05-31,8562
00671R,富邦NASDAQ反1,56,0,56,新光-高雄,2024-05-31,8562
2886,兆豐金,56,1,55,新光-高雄,2024-05-31,8562
3312,弘憶股,204,150,54,新光-高雄,2024-05-31,8562
4960,誠美材,71,18,53,新光-高雄,2024-05-31,8562
00940,元大台灣價值高息,97,45,52,新光-高雄,2024-05-31,8562
1802,台玻,57,5,52,新光-高雄,2024-05-31,8562
2891,中信金,77,27,50,新光-高雄,2024-05-31,8562
00939,統一台灣高息動能,49,0,49,新光-高雄,2024-05-31,8562
6546,正基,44,0,44,新光-高雄,2024-05-31,8562
2637,慧洋-KY,62,19,43,新光-高雄,2024-05-31,8562
6170,統振,45,3,42,新光-高雄,2024-05-31,8562
00935,野村臺灣新科技50,41,0,41,新光-高雄,2024-05-31,8562
2382,廣達,60,20,40,新光-高雄,2024-05-31,8562
9902,台火,50,10,40,新光-高雄,2024-05-31,8562
2356,英業達,55,18,37,新光-高雄,2024-05-31,8562
1314,中石化,41,6,35,新光-高雄,2024-05-31,8562
00878,國泰永續高股息,48,16,32,新光-高雄,2024-05-31,8562
6806,森崴能源,34,2,32,新光-高雄,2024-05-31,8562
8429,金麗-KY,30,0,30,新光-高雄,2024-05-31,8562
2401,凌陽,41,14,27,新光-高雄,2024-05-31,8562
2367,燿華,131,105,26,新光-高雄,2024-05-31,8562
8227,巨有科技,33,7,26,新光-高雄,2024-05-31,8562
1301,台塑,33,8,25,新光-高雄,2024-05-31,8562
1225,福懋油,25,0,25,新光-高雄,2024-05-31,8562
4804,大略-KY,25,0,25,新光-高雄,2024-05-31,8562
4167,松瑞藥,24,0,24,新光-高雄,2024-05-31,8562
6770,力積電,31,7,24,新光-高雄,2024-05-31,8562
9958,世紀鋼,34,11,23,新光-高雄,2024-05-31,8562
8112,至上,30,7,23,新光-高雄,2024-05-31,8562
1326,台化,24,2,22,新光-高雄,2024-05-31,8562
00918,大華優利高填息30,623,10,613,新光-高雄,2024-06-03,8562
00919,群益台灣精選高息,263,43,220,新光-高雄,2024-06-03,8562
2313,華通,282,81,201,新光-高雄,2024-06-03,8562
00680L,元大美債20正2,329,165,164,新光-高雄,2024-06-03,8562
00715L,期街口布蘭特正2,164,5,159,新光-高雄,2024-06-03,8562
00637L,元大滬深300正2,216,57,159,新光-高雄,2024-06-03,8562
5210,寶碩,143,0,143,新光-高雄,2024-06-03,8562
3481,群創,146,35,111,新光-高雄,2024-06-03,8562
1815,富喬,238,131,107,新光-高雄,2024-06-03,8562
2323,中環,127,21,106,新光-高雄,2024-06-03,8562
2867,三商壽,142,39,103,新光-高雄,2024-06-03,8562
00940,元大台灣價值高息,172,72,100,新光-高雄,2024-06-03,8562
5512,力麒,100,5,95,新光-高雄,2024-06-03,8562
0056,元大高股息,106,19,87,新光-高雄,2024-06-03,8562
2486,一詮,155,85,70,新光-高雄,2024-06-03,8562
2641,正德,77,8,69,新光-高雄,2024-06-03,8562
2615,萬海,363,302,61,新光-高雄,2024-06-03,8562
2880,華南金,77,17,60,新光-高雄,2024-06-03,8562
3501,維熹,60,0,60,新光-高雄,2024-06-03,8562
8374,羅昇,55,0,55,新光-高雄,2024-06-03,8562
2618,長榮航,127,75,52,新光-高雄,2024-06-03,8562
2891,中信金,104,56,48,新光-高雄,2024-06-03,8562
2609,陽明,696,652,44,新光-高雄,2024-06-03,8562
2353,宏��,130,86,44,新光-高雄,2024-06-03,8562
4414,如興,44,0,44,新光-高雄,2024-06-03,8562
00650L,復華香港正2,60,20,40,新光-高雄,2024-06-03,8562
8028,昇陽半導體,66,26,40,新光-高雄,2024-06-03,8562
1201,味全,40,1,39,新光-高雄,2024-06-03,8562
2365,昆盈,51,12,39,新光-高雄,2024-06-03,8562
1536,和大,45,8,37,新光-高雄,2024-06-03,8562
3059,華晶科,65,29,36,新光-高雄,2024-06-03,8562
4938,和碩,132,97,35,新光-高雄,2024-06-03,8562
1532,勤美,50,16,34,新光-高雄,2024-06-03,8562
1722,台肥,36,3,33,新光-高雄,2024-06-03,8562
4533,協易機,278,247,31,新光-高雄,2024-06-03,8562
3515,華擎,37,6,31,新光-高雄,2024-06-03,8562
1303,南亞,35,6,29,新光-高雄,2024-06-03,8562
3047,訊舟,100,72,28,新光-高雄,2024-06-03,8562
6116,彩晶,28,0,28,新光-高雄,2024-06-03,8562
2812,台中銀,46,20,26,新光-高雄,2024-06-03,8562
6188,廣明,181,155,26,新光-高雄,2024-06-03,8562
2520,冠德,35,9,26,新光-高雄,2024-06-03,8562
9962,有益,25,0,25,新光-高雄,2024-06-03,8562
2002,中鋼,26,2,24,新光-高雄,2024-06-03,8562
1582,信錦,76,52,24,新光-高雄,2024-06-03,8562
2324,仁寶,81,58,23,新光-高雄,2024-06-03,8562
00908,富邦入息REITs+,23,0,23,新光-高雄,2024-06-03,8562
2610,華航,35,13,22,新光-高雄,2024-06-03,8562
2409,友達,27,6,21,新光-高雄,2024-06-03,8562
8147,正淩,31,10,21,新光-高雄,2024-06-03,8562
00632R,元大台灣50反1,6584,299,6285,新光-高雄,2024-06-04,8562
2344,華邦電,958,60,898,新光-高雄,2024-06-04,8562
2888,新光金,660,126,534,新光-高雄,2024-06-04,8562
00929,復華台灣科技優息,1213,692,521,新光-高雄,2024-06-04,8562
00936,台新永續高息中小,547,253,294,新光-高雄,2024-06-04,8562
00715L,期街口布蘭特正2,361,76,285,新光-高雄,2024-06-04,8562
00940,元大台灣價值高息,301,25,276,新光-高雄,2024-06-04,8562
2312,金寶,228,34,194,新光-高雄,2024-06-04,8562
3481,群創,253,61,192,新光-高雄,2024-06-04,8562
00918,大華優利高填息30,200,16,184,新光-高雄,2024-06-04,8562
2317,鴻海,271,123,148,新光-高雄,2024-06-04,8562
00671R,富邦NASDAQ反1,140,5,135,新光-高雄,2024-06-04,8562
1815,富喬,463,350,113,新光-高雄,2024-06-04,8562
2409,友達,113,15,98,新光-高雄,2024-06-04,8562
1597,直得,96,15,81,新光-高雄,2024-06-04,8562
2328,廣宇,113,35,78,新光-高雄,2024-06-04,8562
5880,合庫金,78,1,77,新光-高雄,2024-06-04,8562
4414,如興,73,0,73,新光-高雄,2024-06-04,8562
00946,群益科技高息成長,69,0,69,新光-高雄,2024-06-04,8562
1316,上曜,72,3,69,新光-高雄,2024-06-04,8562
00650L,復華香港正2,88,20,68,新光-高雄,2024-06-04,8562
2367,燿華,185,123,62,新光-高雄,2024-06-04,8562
2537,聯上發,183,122,61,新光-高雄,2024-06-04,8562
2313,華通,61,2,59,新光-高雄,2024-06-04,8562
1503,士電,60,5,55,新光-高雄,2024-06-04,8562
00878,國泰永續高股息,121,67,54,新光-高雄,2024-06-04,8562
3013,晟銘電,155,103,52,新光-高雄,2024-06-04,8562
2465,麗臺,138,87,51,新光-高雄,2024-06-04,8562
2615,萬海,134,84,50,新光-高雄,2024-06-04,8562
1477,聚陽,50,1,49,新光-高雄,2024-06-04,8562
2301,光寶科,87,39,48,新光-高雄,2024-06-04,8562
3059,華晶科,61,15,46,新光-高雄,2024-06-04,8562
3710,連展投控,45,0,45,新光-高雄,2024-06-04,8562
1303,南亞,57,13,44,新光-高雄,2024-06-04,8562
4306,炎洲,45,2,43,新光-高雄,2024-06-04,8562
2509,全坤建,43,0,43,新光-高雄,2024-06-04,8562
1326,台化,47,6,41,新光-高雄,2024-06-04,8562
5864,致和證,44,3,41,新光-高雄,2024-06-04,8562
2880,華南金,49,9,40,新光-高雄,2024-06-04,8562
4938,和碩,53,13,40,新光-高雄,2024-06-04,8562
2603,長榮,74,34,40,新光-高雄,2024-06-04,8562
4533,協易機,145,106,39,新光-高雄,2024-06-04,8562
00713,元大台灣高息低波,53,14,39,新光-高雄,2024-06-04,8562
8096,擎亞,72,34,38,新光-高雄,2024-06-04,8562
3231,緯創,77,40,37,新光-高雄,2024-06-04,8562
4303,信立,36,1,35,新光-高雄,2024-06-04,8562
2324,仁寶,132,98,34,新光-高雄,2024-06-04,8562
2882,國泰金,38,4,34,新光-高雄,2024-06-04,8562
00642U,期元大S＆P石油,42,10,32,新光-高雄,2024-06-04,8562
6005,群益證,34,3,31,新光-高雄,2024-06-04,8562
00929,復華台灣科技優息,727,128,599,新光-高雄,2024-06-05,8562
00688L,國泰20年美債正2,653,62,591,新光-高雄,2024-06-05,8562
00936,台新永續高息中小,482,207,275,新光-高雄,2024-06-05,8562
00632R,元大台灣50反1,795,547,248,新光-高雄,2024-06-05,8562
00878,國泰永續高股息,235,17,218,新光-高雄,2024-06-05,8562
00715L,期街口布蘭特正2,251,66,185,新光-高雄,2024-06-05,8562
2888,新光金,214,56,158,新光-高雄,2024-06-05,8562
0056,元大高股息,118,7,111,新光-高雄,2024-06-05,8562
00713,元大台灣高息低波,78,1,77,新光-高雄,2024-06-05,8562
6274,台燿,89,16,73,新光-高雄,2024-06-05,8562
1409,新纖,73,0,73,新光-高雄,2024-06-05,8562
2317,鴻海,252,179,73,新光-高雄,2024-06-05,8562
6164,華興,99,35,64,新光-高雄,2024-06-05,8562
3372,典範,132,74,58,新光-高雄,2024-06-05,8562
8906,花王,56,1,55,新光-高雄,2024-06-05,8562
2855,統一證,59,9,50,新光-高雄,2024-06-05,8562
2324,仁寶,61,12,49,新光-高雄,2024-06-05,8562
6143,振曜,44,0,44,新光-高雄,2024-06-05,8562
2344,華邦電,50,7,43,新光-高雄,2024-06-05,8562
00918,大華優利高填息30,85,44,41,新光-高雄,2024-06-05,8562
3048,益登,111,70,41,新光-高雄,2024-06-05,8562
2489,瑞軒,65,24,41,新光-高雄,2024-06-05,8562
2002,中鋼,42,2,40,新光-高雄,2024-06-05,8562
2605,新興,106,66,40,新光-高雄,2024-06-05,8562
3576,聯合再生,47,10,37,新光-高雄,2024-06-05,8562
2427,三商電,84,48,36,新光-高雄,2024-06-05,8562
4513,福裕,53,17,36,新光-高雄,2024-06-05,8562
4534,慶騰,42,7,35,新光-高雄,2024-06-05,8562
3059,華晶科,35,0,35,新光-高雄,2024-06-05,8562
6546,正基,54,20,34,新光-高雄,2024-06-05,8562
00942B,台新美A公司債20+,34,0,34,新光-高雄,2024-06-05,8562
2417,圓剛,78,45,33,新光-高雄,2024-06-05,8562
3481,群創,58,26,32,新光-高雄,2024-06-05,8562
1303,南亞,40,9,31,新光-高雄,2024-06-05,8562
5469,瀚宇博,33,3,30,新光-高雄,2024-06-05,8562
4303,信立,29,0,29,新光-高雄,2024-06-05,8562
2323,中環,218,190,28,新光-高雄,2024-06-05,8562
2520,冠德,63,35,28,新光-高雄,2024-06-05,8562
3062,建漢,36,9,27,新光-高雄,2024-06-05,8562
2838,聯邦銀,38,11,27,新光-高雄,2024-06-05,8562
1316,上曜,39,13,26,新光-高雄,2024-06-05,8562
6177,達麗,29,4,25,新光-高雄,2024-06-05,8562
2610,華航,56,31,25,新光-高雄,2024-06-05,8562
4532,瑞智,27,2,25,新光-高雄,2024-06-05,8562
5340,建榮,31,6,25,新光-高雄,2024-06-05,8562
4414,如興,25,0,25,新光-高雄,2024-06-05,8562
1201,味全,25,0,25,新光-高雄,2024-06-05,8562
1438,三地開發,24,0,24,新光-高雄,2024-06-05,8562
6770,力積電,28,5,23,新光-高雄,2024-06-05,8562
2514,龍邦,23,0,23,新光-高雄,2024-06-05,8562
00632R,元大台灣50反1,1332,211,1121,新光-高雄,2024-06-06,8562
00919,群益台灣精選高息,489,82,407,新光-高雄,2024-06-06,8562
00936,台新永續高息中小,411,32,379,新光-高雄,2024-06-06,8562
2344,華邦電,296,39,257,新光-高雄,2024-06-06,8562
00687B,國泰20年美債,381,141,240,新光-高雄,2024-06-06,8562
9907,統一實,158,0,158,新光-高雄,2024-06-06,8562
00688L,國泰20年美債正2,148,6,142,新光-高雄,2024-06-06,8562
00929,復華台灣科技優息,288,146,142,新光-高雄,2024-06-06,8562
2301,光寶科,147,39,108,新光-高雄,2024-06-06,8562
00679B,元大美債20年,259,153,106,新光-高雄,2024-06-06,8562
2002,中鋼,118,14,104,新光-高雄,2024-06-06,8562
00940,元大台灣價值高息,241,149,92,新光-高雄,2024-06-06,8562
3708,上緯投控,86,5,81,新光-高雄,2024-06-06,8562
3710,連展投控,80,0,80,新光-高雄,2024-06-06,8562
1597,直得,108,32,76,新光-高雄,2024-06-06,8562
6244,茂迪,70,1,69,新光-高雄,2024-06-06,8562
2409,友達,104,38,66,新光-高雄,2024-06-06,8562
2609,陽明,609,546,63,新光-高雄,2024-06-06,8562
2547,日勝生,61,0,61,新光-高雄,2024-06-06,8562
00715L,期街口布蘭特正2,91,36,55,新光-高雄,2024-06-06,8562
1409,新纖,65,11,54,新光-高雄,2024-06-06,8562
2354,鴻準,163,116,47,新光-高雄,2024-06-06,8562
5871,中租-KY,46,0,46,新光-高雄,2024-06-06,8562
2356,英業達,86,41,45,新光-高雄,2024-06-06,8562
4960,誠美材,62,20,42,新光-高雄,2024-06-06,8562
00712,復華富時不動產,42,2,40,新光-高雄,2024-06-06,8562
2101,南港,109,69,40,新光-高雄,2024-06-06,8562
00918,大華優利高填息30,85,47,38,新光-高雄,2024-06-06,8562
5236,凌陽創新,38,2,36,新光-高雄,2024-06-06,8562
5243,乙盛-KY,36,1,35,新光-高雄,2024-06-06,8562
1909,榮成,51,17,34,新光-高雄,2024-06-06,8562
1103,嘉泥,30,0,30,新光-高雄,2024-06-06,8562
2641,正德,52,22,30,新光-高雄,2024-06-06,8562
00878,國泰永續高股息,69,39,30,新光-高雄,2024-06-06,8562
1303,南亞,31,2,29,新光-高雄,2024-06-06,8562
5009,榮剛,33,4,29,新光-高雄,2024-06-06,8562
6270,倍微,44,15,29,新光-高雄,2024-06-06,8562
2331,精英,40,12,28,新光-高雄,2024-06-06,8562
00942B,台新美A公司債20+,24,0,24,新光-高雄,2024-06-06,8562
2201,裕隆,25,2,23,新光-高雄,2024-06-06,8562
6147,頎邦,25,2,23,新光-高雄,2024-06-06,8562
3481,群創,71,49,22,新光-高雄,2024-06-06,8562
1586,和勤,21,0,21,新光-高雄,2024-06-06,8562
00706L,期元大S＆P日圓正2,21,0,21,新光-高雄,2024-06-06,8562
1455,集盛,43,22,21,新光-高雄,2024-06-06,8562
6005,群益證,34,14,20,新光-高雄,2024-06-06,8562
9919,康那香,20,0,20,新光-高雄,2024-06-06,8562
2029,盛餘,20,0,20,新光-高雄,2024-06-06,8562
1522,堤維西,32,13,19,新光-高雄,2024-06-06,8562
9940,信義,21,2,19,新光-高雄,2024-06-06,8562
00929,復華台灣科技優息,363,17,346,新光-高雄,2024-06-07,8562
00937B,群益ESG投等債20,393,112,281,新光-高雄,2024-06-07,8562
00942B,台新美A公司債20+,222,0,222,新光-高雄,2024-06-07,8562
2486,一詮,396,186,210,新光-高雄,2024-06-07,8562
2303,聯電,228,40,188,新光-高雄,2024-06-07,8562
00637L,元大滬深300正2,778,593,185,新光-高雄,2024-06-07,8562
00936,台新永續高息中小,203,27,176,新光-高雄,2024-06-07,8562
00688L,國泰20年美債正2,145,34,111,新光-高雄,2024-06-07,8562
00687B,國泰20年美債,125,18,107,新光-高雄,2024-06-07,8562
00712,復華富時不動產,110,10,100,新光-高雄,2024-06-07,8562
1815,富喬,359,266,93,新光-高雄,2024-06-07,8562
5302,太欣,102,12,90,新光-高雄,2024-06-07,8562
3231,緯創,109,29,80,新光-高雄,2024-06-07,8562
2891,中信金,163,92,71,新光-高雄,2024-06-07,8562
00918,大華優利高填息30,69,6,63,新光-高雄,2024-06-07,8562
2312,金寶,456,397,59,新光-高雄,2024-06-07,8562
4903,聯光通,61,6,55,新光-高雄,2024-06-07,8562
4303,信立,58,7,51,新光-高雄,2024-06-07,8562
4414,如興,49,0,49,新光-高雄,2024-06-07,8562
2002,中鋼,49,2,47,新光-高雄,2024-06-07,8562
00673R,期元大S＆P原油反1,50,5,45,新光-高雄,2024-06-07,8562
2609,陽明,673,629,44,新光-高雄,2024-06-07,8562
6213,聯茂,92,49,43,新光-高雄,2024-06-07,8562
0056,元大高股息,41,0,41,新光-高雄,2024-06-07,8562
6207,雷科,88,50,38,新光-高雄,2024-06-07,8562
00665L,富邦�琤肭磪囓�2,174,137,37,新光-高雄,2024-06-07,8562
2356,英業達,71,34,37,新光-高雄,2024-06-07,8562
6164,華興,40,4,36,新光-高雄,2024-06-07,8562
1303,南亞,39,5,34,新光-高雄,2024-06-07,8562
2353,宏��,101,69,32,新光-高雄,2024-06-07,8562
6143,振曜,44,13,31,新光-高雄,2024-06-07,8562
00878,國泰永續高股息,52,22,30,新光-高雄,2024-06-07,8562
3060,銘異,48,19,29,新光-高雄,2024-06-07,8562
2382,廣達,38,9,29,新光-高雄,2024-06-07,8562
8936,國統,37,9,28,新光-高雄,2024-06-07,8562
2369,菱生,28,0,28,新光-高雄,2024-06-07,8562
2367,燿華,147,120,27,新光-高雄,2024-06-07,8562
5469,瀚宇博,27,0,27,新光-高雄,2024-06-07,8562
2324,仁寶,30,4,26,新光-高雄,2024-06-07,8562
1810,和成,31,5,26,新光-高雄,2024-06-07,8562
2330,台積電,39,14,25,新光-高雄,2024-06-07,8562
2613,中櫃,148,123,25,新光-高雄,2024-06-07,8562
3583,辛耘,27,3,24,新光-高雄,2024-06-07,8562
00923,群益台ESG低碳50,25,4,21,新光-高雄,2024-06-07,8562
6026,福邦證,21,0,21,新光-高雄,2024-06-07,8562
00753L,中信中國50正2,23,3,20,新光-高雄,2024-06-07,8562
5522,遠雄,22,2,20,新光-高雄,2024-06-07,8562
3372,典範,72,52,20,新光-高雄,2024-06-07,8562
2615,萬海,257,238,19,新光-高雄,2024-06-07,8562
00915,凱基優選高股息30,19,0,19,新光-高雄,2024-06-07,8562
00632R,元大台灣50反1,2318,138,2180,新光-高雄,2024-06-11,8562
00680L,元大美債20正2,644,28,616,新光-高雄,2024-06-11,8562
00937B,群益ESG投等債20,702,142,560,新光-高雄,2024-06-11,8562
2303,聯電,507,25,482,新光-高雄,2024-06-11,8562
00688L,國泰20年美債正2,373,5,368,新光-高雄,2024-06-11,8562
00942B,台新美A公司債20+,309,0,309,新光-高雄,2024-06-11,8562
00687B,國泰20年美債,326,41,285,新光-高雄,2024-06-11,8562
00918,大華優利高填息30,256,12,244,新光-高雄,2024-06-11,8562
2609,陽明,685,486,199,新光-高雄,2024-06-11,8562
3481,群創,158,3,155,新光-高雄,2024-06-11,8562
00679B,元大美債20年,223,90,133,新光-高雄,2024-06-11,8562
00878,國泰永續高股息,152,28,124,新光-高雄,2024-06-11,8562
00637L,元大滬深300正2,760,645,115,新光-高雄,2024-06-11,8562
8906,花王,115,1,114,新光-高雄,2024-06-11,8562
00933B,國泰10Y+金融債,109,2,107,新光-高雄,2024-06-11,8562
00919,群益台灣精選高息,219,115,104,新光-高雄,2024-06-11,8562
00936,台新永續高息中小,207,118,89,新光-高雄,2024-06-11,8562
9945,潤泰新,148,59,89,新光-高雄,2024-06-11,8562
1712,興農,108,20,88,新光-高雄,2024-06-11,8562
2002,中鋼,100,14,86,新光-高雄,2024-06-11,8562
3712,永崴投控,127,46,81,新光-高雄,2024-06-11,8562
5871,中租-KY,74,2,72,新光-高雄,2024-06-11,8562
8028,昇陽半導體,64,5,59,新光-高雄,2024-06-11,8562
2427,三商電,82,25,57,新光-高雄,2024-06-11,8562
2603,長榮,190,140,50,新光-高雄,2024-06-11,8562
2489,瑞軒,70,23,47,新光-高雄,2024-06-11,8562
2615,萬海,358,315,43,新光-高雄,2024-06-11,8562
2374,佳能,71,29,42,新光-高雄,2024-06-11,8562
1513,中興電,80,37,43,新光-高雄,2024-06-11,8562
6005,群益證,49,7,42,新光-高雄,2024-06-11,8562
00738U,期元大道瓊白銀,41,0,41,新光-高雄,2024-06-11,8562
1440,南紡,40,0,40,新光-高雄,2024-06-11,8562
6190,萬泰科,56,16,40,新光-高雄,2024-06-11,8562
8277,商丞,40,0,40,新光-高雄,2024-06-11,8562
2412,中華電,40,4,36,新光-高雄,2024-06-11,8562
00908,富邦入息REITs+,35,0,35,新光-高雄,2024-06-11,8562
3202,樺晟,93,58,35,新光-高雄,2024-06-11,8562
1718,中纖,34,0,34,新光-高雄,2024-06-11,8562
6290,良維,49,15,34,新光-高雄,2024-06-11,8562
2501,國建,63,30,33,新光-高雄,2024-06-11,8562
5475,德宏,33,1,32,新光-高雄,2024-06-11,8562
1608,華榮,102,70,32,新光-高雄,2024-06-11,8562
1609,大亞,66,35,31,新光-高雄,2024-06-11,8562
3231,緯創,55,24,31,新光-高雄,2024-06-11,8562
00931B,統一美債20年,48,18,30,新光-高雄,2024-06-11,8562
2506,太設,30,0,30,新光-高雄,2024-06-11,8562
1514,亞力,114,84,30,新光-高雄,2024-06-11,8562
3576,聯合再生,31,1,30,新光-高雄,2024-06-11,8562
1597,直得,44,14,30,新光-高雄,2024-06-11,8562
2611,志信,54,25,29,新光-高雄,2024-06-11,8562
00706L,期元大S＆P日圓正2,588,0,588,新光-高雄,2024-06-12,8562
00632R,元大台灣50反1,504,29,475,新光-高雄,2024-06-12,8562
00937B,群益ESG投等債20,364,75,289,新光-高雄,2024-06-12,8562
2312,金寶,263,7,256,新光-高雄,2024-06-12,8562
00712,復華富時不動產,218,6,212,新光-高雄,2024-06-12,8562
2888,新光金,335,125,210,新光-高雄,2024-06-12,8562
00948B,中信優息投資級債,186,0,186,新光-高雄,2024-06-12,8562
00933B,國泰10Y+金融債,237,53,184,新光-高雄,2024-06-12,8562
00687B,國泰20年美債,150,4,146,新光-高雄,2024-06-12,8562
2867,三商壽,185,53,132,新光-高雄,2024-06-12,8562
2609,陽明,496,391,105,新光-高雄,2024-06-12,8562
5210,寶碩,102,1,101,新光-高雄,2024-06-12,8562
8085,福華,110,12,98,新光-高雄,2024-06-12,8562
00918,大華優利高填息30,125,30,95,新光-高雄,2024-06-12,8562
3481,群創,100,5,95,新光-高雄,2024-06-12,8562
9105,泰金寶-DR,92,20,72,新光-高雄,2024-06-12,8562
6830,汎銓,71,0,71,新光-高雄,2024-06-12,8562
00931B,統一美債20年,85,15,70,新光-高雄,2024-06-12,8562
2344,華邦電,77,10,67,新光-高雄,2024-06-12,8562
2610,華航,241,174,67,新光-高雄,2024-06-12,8562
2883,凱基金,171,109,62,新光-高雄,2024-06-12,8562
2409,友達,71,9,62,新光-高雄,2024-06-12,8562
00733,富邦臺灣中小,63,2,61,新光-高雄,2024-06-12,8562
4720,德淵,65,5,60,新光-高雄,2024-06-12,8562
2515,中工,65,6,59,新光-高雄,2024-06-12,8562
1440,南紡,56,0,56,新光-高雄,2024-06-12,8562
00878,國泰永續高股息,125,70,55,新光-高雄,2024-06-12,8562
4188,安克,53,0,53,新光-高雄,2024-06-12,8562
2801,彰銀,54,5,49,新光-高雄,2024-06-12,8562
3450,聯鈞,84,42,42,新光-高雄,2024-06-12,8562
2913,農林,40,2,38,新光-高雄,2024-06-12,8562
3231,緯創,66,28,38,新光-高雄,2024-06-12,8562
4545,銘鈺,47,10,37,新光-高雄,2024-06-12,8562
00936,台新永續高息中小,241,205,36,新光-高雄,2024-06-12,8562
2886,兆豐金,43,8,35,新光-高雄,2024-06-12,8562
5519,隆大,64,29,35,新光-高雄,2024-06-12,8562
2002,中鋼,40,6,34,新光-高雄,2024-06-12,8562
6283,淳安,33,0,33,新光-高雄,2024-06-12,8562
4306,炎洲,35,3,32,新光-高雄,2024-06-12,8562
1714,和桐,31,0,31,新光-高雄,2024-06-12,8562
3622,洋華,72,41,31,新光-高雄,2024-06-12,8562
2313,華通,52,21,31,新光-高雄,2024-06-12,8562
912000,晨訊科-DR,34,4,30,新光-高雄,2024-06-12,8562
2023,燁輝,30,0,30,新光-高雄,2024-06-12,8562
2390,云辰,30,0,30,新光-高雄,2024-06-12,8562
1301,台塑,50,21,29,新光-高雄,2024-06-12,8562
3312,弘憶股,29,1,28,新光-高雄,2024-06-12,8562
2408,南亞科,33,5,28,新光-高雄,2024-06-12,8562
00676R,富邦臺灣加權反1,30,3,27,新光-高雄,2024-06-12,8562
00738U,期元大道瓊白銀,27,0,27,新光-高雄,2024-06-12,8562
00712,復華富時不動產,912,13,899,新光-高雄,2024-06-13,8562
2344,華邦電,672,42,630,新光-高雄,2024-06-13,8562
00948B,中信優息投資級債,401,3,398,新光-高雄,2024-06-13,8562
00679B,元大美債20年,704,310,394,新光-高雄,2024-06-13,8562
2610,華航,208,70,138,新光-高雄,2024-06-13,8562
4414,如興,116,0,116,新光-高雄,2024-06-13,8562
00933B,國泰10Y+金融債,144,43,101,新光-高雄,2024-06-13,8562
2515,中工,86,17,69,新光-高雄,2024-06-13,8562
6890,來億-KY,61,2,59,新光-高雄,2024-06-13,8562
2367,燿華,160,101,59,新光-高雄,2024-06-13,8562
4726,永昕,60,2,58,新光-高雄,2024-06-13,8562
00671R,富邦NASDAQ反1,117,65,52,新光-高雄,2024-06-13,8562
8028,昇陽半導體,137,87,50,新光-高雄,2024-06-13,8562
2892,第一金,49,1,48,新光-高雄,2024-06-13,8562
00919,群益台灣精選高息,241,195,46,新光-高雄,2024-06-13,8562
8069,元太,60,14,46,新光-高雄,2024-06-13,8562
2603,長榮,123,77,46,新光-高雄,2024-06-13,8562
1597,直得,48,4,44,新光-高雄,2024-06-13,8562
3060,銘異,44,1,43,新光-高雄,2024-06-13,8562
3481,群創,66,23,43,新光-高雄,2024-06-13,8562
2888,新光金,227,185,42,新光-高雄,2024-06-13,8562
2489,瑞軒,44,2,42,新光-高雄,2024-06-13,8562
2867,三商壽,131,91,40,新光-高雄,2024-06-13,8562
1409,新纖,39,0,39,新光-高雄,2024-06-13,8562
2615,萬海,133,94,39,新光-高雄,2024-06-13,8562
3049,精金,38,0,38,新光-高雄,2024-06-13,8562
2365,昆盈,67,29,38,新光-高雄,2024-06-13,8562
00947,台新臺灣IC設計,39,2,37,新光-高雄,2024-06-13,8562
2105,正新,39,7,32,新光-高雄,2024-06-13,8562
1303,南亞,35,3,32,新光-高雄,2024-06-13,8562
6216,居易,52,21,31,新光-高雄,2024-06-13,8562
3264,欣銓,43,13,30,新光-高雄,2024-06-13,8562
00946,群益科技高息成長,88,58,30,新光-高雄,2024-06-13,8562
1612,宏泰,31,2,29,新光-高雄,2024-06-13,8562
1815,富喬,113,84,29,新光-高雄,2024-06-13,8562
2801,彰銀,32,4,28,新光-高雄,2024-06-13,8562
2520,冠德,27,0,27,新光-高雄,2024-06-13,8562
2208,台船,38,11,27,新光-高雄,2024-06-13,8562
2885,元大金,30,4,26,新光-高雄,2024-06-13,8562
5302,太欣,27,1,26,新光-高雄,2024-06-13,8562
3122,笙泉,26,0,26,新光-高雄,2024-06-13,8562
6788,華景電,37,12,25,新光-高雄,2024-06-13,8562
2641,正德,26,2,24,新光-高雄,2024-06-13,8562
2891,中信金,31,8,23,新光-高雄,2024-06-13,8562
6805,富世達,27,5,22,新光-高雄,2024-06-13,8562
4958,臻鼎-KY,23,1,22,新光-高雄,2024-06-13,8562
00648R,元大S＆P500反1,24,2,22,新光-高雄,2024-06-13,8562
6548,長科*,48,26,22,新光-高雄,2024-06-13,8562
3363,上詮,64,43,21,新光-高雄,2024-06-13,8562
00881,國泰台灣5G+,26,6,20,新光-高雄,2024-06-13,8562
00918,大華優利高填息30,416,19,397,新光-高雄,2024-06-14,8562
2371,大同,416,107,309,新光-高雄,2024-06-14,8562
00688L,國泰20年美債正2,436,128,308,新光-高雄,2024-06-14,8562
00948B,中信優息投資級債,168,21,147,新光-高雄,2024-06-14,8562
2486,一詮,227,106,121,新光-高雄,2024-06-14,8562
2888,新光金,226,117,109,新光-高雄,2024-06-14,8562
5905,南仁湖,110,9,101,新光-高雄,2024-06-14,8562
1808,潤隆,116,19,97,新光-高雄,2024-06-14,8562
00933B,國泰10Y+金融債,108,12,96,新光-高雄,2024-06-14,8562
00946,群益科技高息成長,97,3,94,新光-高雄,2024-06-14,8562
2801,彰銀,80,0,80,新光-高雄,2024-06-14,8562
00632R,元大台灣50反1,95,20,75,新光-高雄,2024-06-14,8562
00673R,期元大S＆P原油反1,72,0,72,新光-高雄,2024-06-14,8562
2353,宏��,126,58,68,新光-高雄,2024-06-14,8562
00637L,元大滬深300正2,125,62,63,新光-高雄,2024-06-14,8562
00706L,期元大S＆P日圓正2,60,0,60,新光-高雄,2024-06-14,8562
2886,兆豐金,50,3,47,新光-高雄,2024-06-14,8562
2405,輔信,58,13,45,新光-高雄,2024-06-14,8562
2427,三商電,96,51,45,新光-高雄,2024-06-14,8562
2520,冠德,92,50,42,新光-高雄,2024-06-14,8562
00947,台新臺灣IC設計,41,0,41,新光-高雄,2024-06-14,8562
00878,國泰永續高股息,68,27,41,新光-高雄,2024-06-14,8562
2537,聯上發,151,111,40,新光-高雄,2024-06-14,8562
2392,正崴,125,88,37,新光-高雄,2024-06-14,8562
3450,聯鈞,74,37,37,新光-高雄,2024-06-14,8562
2027,大成鋼,37,1,36,新光-高雄,2024-06-14,8562
2641,正德,37,2,35,新光-高雄,2024-06-14,8562
2367,燿華,73,38,35,新光-高雄,2024-06-14,8562
6190,萬泰科,52,18,34,新光-高雄,2024-06-14,8562
1316,上曜,66,33,33,新光-高雄,2024-06-14,8562
00681R,元大美債20反1,30,0,30,新光-高雄,2024-06-14,8562
3707,漢磊,52,23,29,新光-高雄,2024-06-14,8562
00929,復華台灣科技優息,612,583,29,新光-高雄,2024-06-14,8562
2605,新興,52,25,27,新光-高雄,2024-06-14,8562
2103,台橡,26,0,26,新光-高雄,2024-06-14,8562
3591,艾笛森,34,8,26,新光-高雄,2024-06-14,8562
00713,元大台灣高息低波,26,0,26,新光-高雄,2024-06-14,8562
3047,訊舟,53,28,25,新光-高雄,2024-06-14,8562
00764B,群益25年美債,25,0,25,新光-高雄,2024-06-14,8562
4938,和碩,26,2,24,新光-高雄,2024-06-14,8562
2515,中工,124,100,24,新光-高雄,2024-06-14,8562
2356,英業達,35,12,23,新光-高雄,2024-06-14,8562
1455,集盛,22,0,22,新光-高雄,2024-06-14,8562
9105,泰金寶-DR,870,848,22,新光-高雄,2024-06-14,8562
3455,由田,25,3,22,新光-高雄,2024-06-14,8562
00753L,中信中國50正2,25,4,21,新光-高雄,2024-06-14,8562
2002,中鋼,34,13,21,新光-高雄,2024-06-14,8562
3059,華晶科,23,2,21,新光-高雄,2024-06-14,8562
6125,廣運,29,8,21,新光-高雄,2024-06-14,8562
1815,富喬,50,29,21,新光-高雄,2024-06-14,8562
00929,復華台灣科技優息,710,289,421,新光-高雄,2024-06-17,8562
2208,台船,203,0,203,新光-高雄,2024-06-17,8562
2344,華邦電,249,62,187,新光-高雄,2024-06-17,8562
00948B,中信優息投資級債,162,0,162,新光-高雄,2024-06-17,8562
2312,金寶,299,149,150,新光-高雄,2024-06-17,8562
6770,力積電,211,72,139,新光-高雄,2024-06-17,8562
00936,台新永續高息中小,388,260,128,新光-高雄,2024-06-17,8562
00933B,國泰10Y+金融債,118,2,116,新光-高雄,2024-06-17,8562
2356,英業達,145,29,116,新光-高雄,2024-06-17,8562
00919,群益台灣精選高息,263,174,89,新光-高雄,2024-06-17,8562
2610,華航,122,34,88,新光-高雄,2024-06-17,8562
00946,群益科技高息成長,106,22,84,新光-高雄,2024-06-17,8562
6449,鈺邦,82,0,82,新光-高雄,2024-06-17,8562
1618,合機,297,224,73,新光-高雄,2024-06-17,8562
2609,陽明,194,129,65,新光-高雄,2024-06-17,8562
1514,亞力,200,135,65,新光-高雄,2024-06-17,8562
00733,富邦臺灣中小,66,3,63,新光-高雄,2024-06-17,8562
912000,晨訊科-DR,65,2,63,新光-高雄,2024-06-17,8562
2313,華通,66,6,60,新光-高雄,2024-06-17,8562
3062,建漢,64,8,56,新光-高雄,2024-06-17,8562
2615,萬海,216,160,56,新光-高雄,2024-06-17,8562
2515,中工,60,4,56,新光-高雄,2024-06-17,8562
5905,南仁湖,60,6,54,新光-高雄,2024-06-17,8562
1608,華榮,187,134,53,新光-高雄,2024-06-17,8562
1503,士電,118,70,48,新光-高雄,2024-06-17,8562
00713,元大台灣高息低波,52,5,47,新光-高雄,2024-06-17,8562
2867,三商壽,62,16,46,新光-高雄,2024-06-17,8562
8028,昇陽半導體,95,51,44,新光-高雄,2024-06-17,8562
8096,擎亞,75,32,43,新光-高雄,2024-06-17,8562
00942B,台新美A公司債20+,41,0,41,新光-高雄,2024-06-17,8562
3363,上詮,78,37,41,新光-高雄,2024-06-17,8562
4306,炎洲,40,0,40,新光-高雄,2024-06-17,8562
1616,億泰,157,117,40,新光-高雄,2024-06-17,8562
6170,統振,40,0,40,新光-高雄,2024-06-17,8562
1609,大亞,151,111,40,新光-高雄,2024-06-17,8562
2376,技嘉,41,2,39,新光-高雄,2024-06-17,8562
00687B,國泰20年美債,120,84,36,新光-高雄,2024-06-17,8562
1784,訊聯,73,38,35,新光-高雄,2024-06-17,8562
6188,廣明,39,4,35,新光-高雄,2024-06-17,8562
9919,康那香,55,23,32,新光-高雄,2024-06-17,8562
3033,威健,33,1,32,新光-高雄,2024-06-17,8562
1101,台泥,38,7,31,新光-高雄,2024-06-17,8562
1786,科妍,41,10,31,新光-高雄,2024-06-17,8562
2883,凱基金,43,12,31,新光-高雄,2024-06-17,8562
00921,兆豐龍頭等權重,30,1,29,新光-高雄,2024-06-17,8562
1301,台塑,31,2,29,新光-高雄,2024-06-17,8562
4532,瑞智,132,104,28,新光-高雄,2024-06-17,8562
6213,聯茂,147,120,27,新光-高雄,2024-06-17,8562
3443,創意,28,2,26,新光-高雄,2024-06-17,8562
2390,云辰,26,0,26,新光-高雄,2024-06-17,8562
00632R,元大台灣50反1,2255,1359,896,新光-高雄,2024-06-18,8562
00937B,群益ESG投等債20,492,42,450,新光-高雄,2024-06-18,8562
00915,凱基優選高股息30,203,16,187,新光-高雄,2024-06-18,8562
9105,泰金寶-DR,270,90,180,新光-高雄,2024-06-18,8562
00936,台新永續高息中小,276,102,174,新光-高雄,2024-06-18,8562
00929,復華台灣科技優息,414,275,139,新光-高雄,2024-06-18,8562
2317,鴻海,196,70,126,新光-高雄,2024-06-18,8562
00673R,期元大S＆P原油反1,125,10,115,新光-高雄,2024-06-18,8562
00733,富邦臺灣中小,122,10,112,新光-高雄,2024-06-18,8562
00948B,中信優息投資級債,133,21,112,新光-高雄,2024-06-18,8562
00687B,國泰20年美債,117,6,111,新光-高雄,2024-06-18,8562
3481,群創,157,58,99,新光-高雄,2024-06-18,8562
3163,波若威,151,55,96,新光-高雄,2024-06-18,8562
00713,元大台灣高息低波,99,4,95,新光-高雄,2024-06-18,8562
2615,萬海,167,90,77,新光-高雄,2024-06-18,8562
00940,元大台灣價值高息,96,23,73,新光-高雄,2024-06-18,8562
1802,台玻,123,60,63,新光-高雄,2024-06-18,8562
2812,台中銀,61,5,56,新光-高雄,2024-06-18,8562
6170,統振,55,1,54,新光-高雄,2024-06-18,8562
1409,新纖,53,0,53,新光-高雄,2024-06-18,8562
3294,英濟,56,4,52,新光-高雄,2024-06-18,8562
00946,群益科技高息成長,50,2,48,新光-高雄,2024-06-18,8562
5457,宣德,45,2,43,新光-高雄,2024-06-18,8562
4956,光鋐,49,8,41,新光-高雄,2024-06-18,8562
00907,永豐優息存股,38,0,38,新光-高雄,2024-06-18,8562
4562,穎漢,130,93,37,新光-高雄,2024-06-18,8562
00947,台新臺灣IC設計,39,3,36,新光-高雄,2024-06-18,8562
1504,東元,65,29,36,新光-高雄,2024-06-18,8562
2603,長榮,53,19,34,新光-高雄,2024-06-18,8562
2301,光寶科,43,9,34,新光-高雄,2024-06-18,8562
2353,宏��,71,38,33,新光-高雄,2024-06-18,8562
3013,晟銘電,87,55,32,新光-高雄,2024-06-18,8562
1785,光洋科,50,18,32,新光-高雄,2024-06-18,8562
00930,永豐ESG低碳高息,38,8,30,新光-高雄,2024-06-18,8562
1514,亞力,170,141,29,新光-高雄,2024-06-18,8562
3376,新日興,39,10,29,新光-高雄,2024-06-18,8562
6116,彩晶,27,0,27,新光-高雄,2024-06-18,8562
3081,聯亞,39,13,26,新光-高雄,2024-06-18,8562
4526,東台,37,12,25,新光-高雄,2024-06-18,8562
6180,橘子,29,6,23,新光-高雄,2024-06-18,8562
1460,宏遠,23,0,23,新光-高雄,2024-06-18,8562
8150,南茂,25,2,23,新光-高雄,2024-06-18,8562
1303,南亞,30,7,23,新光-高雄,2024-06-18,8562
1301,台塑,28,6,22,新光-高雄,2024-06-18,8562
8040,九暘,23,2,21,新光-高雄,2024-06-18,8562
00942B,台新美A公司債20+,21,0,21,新光-高雄,2024-06-18,8562
6130,上亞科技,21,0,21,新光-高雄,2024-06-18,8562
1326,台化,24,4,20,新光-高雄,2024-06-18,8562
00923,群益台ESG低碳50,32,11,21,新光-高雄,2024-06-18,8562
3141,晶宏,20,0,20,新光-高雄,2024-06-18,8562
00929,復華台灣科技優息,1416,706,710,新光-高雄,2024-06-19,8562
00936,台新永續高息中小,306,59,247,新光-高雄,2024-06-19,8562
00937B,群益ESG投等債20,250,29,221,新光-高雄,2024-06-19,8562
00673R,期元大S＆P原油反1,206,1,205,新光-高雄,2024-06-19,8562
00687B,國泰20年美債,330,130,200,新光-高雄,2024-06-19,8562
00931B,統一美債20年,192,1,191,新光-高雄,2024-06-19,8562
2609,陽明,350,184,166,新光-高雄,2024-06-19,8562
00712,復華富時不動產,341,183,158,新光-高雄,2024-06-19,8562
00947,台新臺灣IC設計,176,28,148,新光-高雄,2024-06-19,8562
00881,國泰台灣5G+,145,3,142,新光-高雄,2024-06-19,8562
3673,TPK-KY,210,73,137,新光-高雄,2024-06-19,8562
2618,長榮航,421,291,130,新光-高雄,2024-06-19,8562
2405,輔信,130,7,123,新光-高雄,2024-06-19,8562
2406,國碩,97,0,97,新光-高雄,2024-06-19,8562
00713,元大台灣高息低波,112,16,96,新光-高雄,2024-06-19,8562
3450,聯鈞,167,95,72,新光-高雄,2024-06-19,8562
6213,聯茂,126,57,69,新光-高雄,2024-06-19,8562
2365,昆盈,449,381,68,新光-高雄,2024-06-19,8562
8473,山林水,71,8,63,新光-高雄,2024-06-19,8562
3052,夆典,60,0,60,新光-高雄,2024-06-19,8562
3234,光環,66,8,58,新光-高雄,2024-06-19,8562
8374,羅昇,57,0,57,新光-高雄,2024-06-19,8562
4714,永捷,58,3,55,新光-高雄,2024-06-19,8562
3712,永崴投控,117,66,51,新光-高雄,2024-06-19,8562
4967,十銓,86,37,49,新光-高雄,2024-06-19,8562
8103,瀚荃,48,1,47,新光-高雄,2024-06-19,8562
2344,華邦電,131,84,47,新光-高雄,2024-06-19,8562
2353,宏��,106,62,44,新光-高雄,2024-06-19,8562
2515,中工,44,4,40,新光-高雄,2024-06-19,8562
2330,台積電,75,36,39,新光-高雄,2024-06-19,8562
2301,光寶科,70,32,38,新光-高雄,2024-06-19,8562
2371,大同,190,153,37,新光-高雄,2024-06-19,8562
9105,泰金寶-DR,123,87,36,新光-高雄,2024-06-19,8562
5516,雙喜,35,0,35,新光-高雄,2024-06-19,8562
2409,友達,47,13,34,新光-高雄,2024-06-19,8562
00927,群益半導體收益,45,11,34,新光-高雄,2024-06-19,8562
2367,燿華,54,22,32,新光-高雄,2024-06-19,8562
3260,威剛,39,7,32,新光-高雄,2024-06-19,8562
00725B,國泰投資級公司債,30,0,30,新光-高雄,2024-06-19,8562
00675L,富邦臺灣加權正2,32,3,29,新光-高雄,2024-06-19,8562
6282,康舒,35,7,28,新光-高雄,2024-06-19,8562
2329,華泰,40,12,28,新光-高雄,2024-06-19,8562
4924,欣厚-KY,29,1,28,新光-高雄,2024-06-19,8562
8050,廣積,37,10,27,新光-高雄,2024-06-19,8562
00888,永豐台灣ESG,37,10,27,新光-高雄,2024-06-19,8562
2392,正崴,52,27,25,新光-高雄,2024-06-19,8562
2369,菱生,25,0,25,新光-高雄,2024-06-19,8562
6152,百一,41,17,24,新光-高雄,2024-06-19,8562
5488,松普,23,0,23,新光-高雄,2024-06-19,8562
1504,東元,31,9,22,新光-高雄,2024-06-19,8562
00940,元大台灣價值高息,1247,120,1127,新光-高雄,2024-06-20,8562
00937B,群益ESG投等債20,518,22,496,新光-高雄,2024-06-20,8562
00946,群益科技高息成長,358,1,357,新光-高雄,2024-06-20,8562
00712,復華富時不動產,348,2,346,新光-高雄,2024-06-20,8562
00632R,元大台灣50反1,409,117,292,新光-高雄,2024-06-20,8562
2888,新光金,343,101,242,新光-高雄,2024-06-20,8562
00919,群益台灣精選高息,410,188,222,新光-高雄,2024-06-20,8562
00679B,元大美債20年,244,63,181,新光-高雄,2024-06-20,8562
00936,台新永續高息中小,289,121,168,新光-高雄,2024-06-20,8562
00687B,國泰20年美債,208,44,164,新光-高雄,2024-06-20,8562
2359,所羅門,202,48,154,新光-高雄,2024-06-20,8562
2812,台中銀,159,9,150,新光-高雄,2024-06-20,8562
00673R,期元大S＆P原油反1,110,0,110,新光-高雄,2024-06-20,8562
5512,力麒,104,10,94,新光-高雄,2024-06-20,8562
3580,友威科,99,16,83,新光-高雄,2024-06-20,8562
00915,凱基優選高股息30,83,2,81,新光-高雄,2024-06-20,8562
00948B,中信優息投資級債,78,3,75,新光-高雄,2024-06-20,8562
2886,兆豐金,75,6,69,新光-高雄,2024-06-20,8562
2515,中工,69,1,68,新光-高雄,2024-06-20,8562
2883B,凱基金乙特,70,3,67,新光-高雄,2024-06-20,8562
2636,台驊控股,64,2,62,新光-高雄,2024-06-20,8562
2023,燁輝,64,11,53,新光-高雄,2024-06-20,8562
6117,迎廣,64,13,51,新光-高雄,2024-06-20,8562
2618,長榮航,113,63,50,新光-高雄,2024-06-20,8562
2345,智邦,51,3,48,新光-高雄,2024-06-20,8562
00751B,元大AAA至A公司債,46,0,46,新光-高雄,2024-06-20,8562
6531,愛普*,57,11,46,新光-高雄,2024-06-20,8562
1513,中興電,71,25,46,新光-高雄,2024-06-20,8562
3712,永崴投控,58,13,45,新光-高雄,2024-06-20,8562
1301,台塑,50,8,42,新光-高雄,2024-06-20,8562
4306,炎洲,55,16,39,新光-高雄,2024-06-20,8562
1514,亞力,215,176,39,新光-高雄,2024-06-20,8562
00650L,復華香港正2,50,12,38,新光-高雄,2024-06-20,8562
3707,漢磊,56,21,35,新光-高雄,2024-06-20,8562
00713,元大台灣高息低波,40,5,35,新光-高雄,2024-06-20,8562
2330,台積電,59,27,32,新光-高雄,2024-06-20,8562
5340,建榮,33,2,31,新光-高雄,2024-06-20,8562
6244,茂迪,30,0,30,新光-高雄,2024-06-20,8562
9945,潤泰新,34,5,29,新光-高雄,2024-06-20,8562
6005,群益證,33,5,28,新光-高雄,2024-06-20,8562
00706L,期元大S＆P日圓正2,28,0,28,新光-高雄,2024-06-20,8562
4938,和碩,74,46,28,新光-高雄,2024-06-20,8562
2332,友訊,30,3,27,新光-高雄,2024-06-20,8562
1325,恆大,33,7,26,新光-高雄,2024-06-20,8562
5864,致和證,35,10,25,新光-高雄,2024-06-20,8562
5324,士開,25,0,25,新光-高雄,2024-06-20,8562
2025,千興,30,5,25,新光-高雄,2024-06-20,8562
5516,雙喜,25,0,25,新光-高雄,2024-06-20,8562
6548,長科*,26,2,24,新光-高雄,2024-06-20,8562
2887,台新金,24,0,24,新光-高雄,2024-06-20,8562
00687B,國泰20年美債,1095,10,1085,新光-高雄,2024-06-21,8562
00937B,群益ESG投等債20,1067,2,1065,新光-高雄,2024-06-21,8562
00919,群益台灣精選高息,608,198,410,新光-高雄,2024-06-21,8562
1815,富喬,368,84,284,新光-高雄,2024-06-21,8562
2317,鴻海,358,143,215,新光-高雄,2024-06-21,8562
00948B,中信優息投資級債,181,0,181,新光-高雄,2024-06-21,8562
00712,復華富時不動產,179,7,172,新光-高雄,2024-06-21,8562
00637L,元大滬深300正2,780,612,168,新光-高雄,2024-06-21,8562
1319,東陽,151,5,146,新光-高雄,2024-06-21,8562
00940,元大台灣價值高息,260,123,137,新光-高雄,2024-06-21,8562
9105,泰金寶-DR,137,32,105,新光-高雄,2024-06-21,8562
1301,台塑,113,11,102,新光-高雄,2024-06-21,8562
8027,鈦昇,115,14,101,新光-高雄,2024-06-21,8562
2409,友達,574,482,92,新光-高雄,2024-06-21,8562
00933B,國泰10Y+金融債,100,10,90,新光-高雄,2024-06-21,8562
00706L,期元大S＆P日圓正2,89,0,89,新光-高雄,2024-06-21,8562
00936,台新永續高息中小,136,53,83,新光-高雄,2024-06-21,8562
2615,萬海,329,246,83,新光-高雄,2024-06-21,8562
00673R,期元大S＆P原油反1,74,0,74,新光-高雄,2024-06-21,8562
2520,冠德,83,14,69,新光-高雄,2024-06-21,8562
2504,國產,51,0,51,新光-高雄,2024-06-21,8562
1314,中石化,53,2,51,新光-高雄,2024-06-21,8562
2515,中工,52,4,48,新光-高雄,2024-06-21,8562
00942B,台新美A公司債20+,47,0,47,新光-高雄,2024-06-21,8562
00665L,富邦�琤肭磪囓�2,217,172,45,新光-高雄,2024-06-21,8562
3048,益登,71,27,44,新光-高雄,2024-06-21,8562
2301,光寶科,60,16,44,新光-高雄,2024-06-21,8562
2442,新美齊,50,8,42,新光-高雄,2024-06-21,8562
1309,台達化,79,39,40,新光-高雄,2024-06-21,8562
00676R,富邦臺灣加權反1,40,0,40,新光-高雄,2024-06-21,8562
00915,凱基優選高股息30,45,6,39,新光-高雄,2024-06-21,8562
00947,台新臺灣IC設計,52,14,38,新光-高雄,2024-06-21,8562
6695,芯鼎,138,101,37,新光-高雄,2024-06-21,8562
2609,陽明,278,242,36,新光-高雄,2024-06-21,8562
6806,森崴能源,60,25,35,新光-高雄,2024-06-21,8562
2547,日勝生,36,1,35,新光-高雄,2024-06-21,8562
3443,創意,41,6,35,新光-高雄,2024-06-21,8562
2365,昆盈,167,135,32,新光-高雄,2024-06-21,8562
00632R,元大台灣50反1,49,19,30,新光-高雄,2024-06-21,8562
00946,群益科技高息成長,52,22,30,新光-高雄,2024-06-21,8562
8105,凌巨,146,120,26,新光-高雄,2024-06-21,8562
6217,中探針,54,28,26,新光-高雄,2024-06-21,8562
00905,FT臺灣Smart,24,0,24,新光-高雄,2024-06-21,8562
4956,光鋐,78,54,24,新光-高雄,2024-06-21,8562
6207,雷科,46,23,23,新光-高雄,2024-06-21,8562
2501,國建,25,3,22,新光-高雄,2024-06-21,8562
6177,達麗,44,22,22,新光-高雄,2024-06-21,8562
2836,高雄銀,25,3,22,新光-高雄,2024-06-21,8562
00655L,國泰中國A50正2,32,10,22,新光-高雄,2024-06-21,8562
1785,光洋科,84,63,21,新光-高雄,2024-06-21,8562
00929,復華台灣科技優息,1700,697,1003,新光-高雄,2024-06-24,8562
3481,群創,1092,549,543,新光-高雄,2024-06-24,8562
00919,群益台灣精選高息,724,245,479,新光-高雄,2024-06-24,8562
00937B,群益ESG投等債20,308,39,269,新光-高雄,2024-06-24,8562
8110,華東,255,65,190,新光-高雄,2024-06-24,8562
9907,統一實,180,0,180,新光-高雄,2024-06-24,8562
00936,台新永續高息中小,178,4,174,新光-高雄,2024-06-24,8562
00948B,中信優息投資級債,109,0,109,新光-高雄,2024-06-24,8562
2301,光寶科,112,4,108,新光-高雄,2024-06-24,8562
3010,華立,98,1,97,新光-高雄,2024-06-24,8562
2330,台積電,130,34,96,新光-高雄,2024-06-24,8562
00753L,中信中國50正2,89,1,88,新光-高雄,2024-06-24,8562
00733,富邦臺灣中小,89,1,88,新光-高雄,2024-06-24,8562
2347,聯強,87,5,82,新光-高雄,2024-06-24,8562
6116,彩晶,104,26,78,新光-高雄,2024-06-24,8562
00679B,元大美債20年,140,63,77,新光-高雄,2024-06-24,8562
2883,凱基金,81,6,75,新光-高雄,2024-06-24,8562
2317,鴻海,202,131,71,新光-高雄,2024-06-24,8562
00946,群益科技高息成長,93,23,70,新光-高雄,2024-06-24,8562
2405,輔信,69,0,69,新光-高雄,2024-06-24,8562
00688L,國泰20年美債正2,68,0,68,新光-高雄,2024-06-24,8562
1319,東陽,79,12,67,新光-高雄,2024-06-24,8562
6284,佳邦,77,10,67,新光-高雄,2024-06-24,8562
9105,泰金寶-DR,191,125,66,新光-高雄,2024-06-24,8562
2442,新美齊,62,0,62,新光-高雄,2024-06-24,8562
2329,華泰,80,19,61,新光-高雄,2024-06-24,8562
3576,聯合再生,64,3,61,新光-高雄,2024-06-24,8562
00947,台新臺灣IC設計,78,18,60,新光-高雄,2024-06-24,8562
2812,台中銀,62,4,58,新光-高雄,2024-06-24,8562
00706L,期元大S＆P日圓正2,54,0,54,新光-高雄,2024-06-24,8562
2324,仁寶,67,15,52,新光-高雄,2024-06-24,8562
3580,友威科,68,16,52,新光-高雄,2024-06-24,8562
3450,聯鈞,154,102,52,新光-高雄,2024-06-24,8562
3025,星通,144,92,52,新光-高雄,2024-06-24,8562
2618,長榮航,102,52,50,新光-高雄,2024-06-24,8562
00857B,永豐20年美公債,51,1,50,新光-高雄,2024-06-24,8562
00933B,國泰10Y+金融債,51,3,48,新光-高雄,2024-06-24,8562
2353,宏��,57,11,46,新光-高雄,2024-06-24,8562
6438,迅得,42,0,42,新光-高雄,2024-06-24,8562
5871,中租-KY,50,8,42,新光-高雄,2024-06-24,8562
3060,銘異,43,2,41,新光-高雄,2024-06-24,8562
5880,合庫金,51,11,40,新光-高雄,2024-06-24,8562
2881,富邦金,38,0,38,新光-高雄,2024-06-24,8562
4938,和碩,42,5,37,新光-高雄,2024-06-24,8562
3047,訊舟,153,117,36,新光-高雄,2024-06-24,8562
5443,均豪,158,122,36,新光-高雄,2024-06-24,8562
00915,凱基優選高股息30,45,9,36,新光-高雄,2024-06-24,8562
6213,聯茂,46,12,34,新光-高雄,2024-06-24,8562
9945,潤泰新,74,40,34,新光-高雄,2024-06-24,8562
00673R,期元大S＆P原油反1,40,7,33,新光-高雄,2024-06-24,8562
00929,復華台灣科技優息,577,218,359,新光-高雄,2024-06-25,8562
00936,台新永續高息中小,195,4,191,新光-高雄,2024-06-25,8562
9105,泰金寶-DR,192,18,174,新光-高雄,2024-06-25,8562
00673R,期元大S＆P原油反1,160,2,158,新光-高雄,2024-06-25,8562
00632R,元大台灣50反1,830,697,133,新光-高雄,2024-06-25,8562
2867,三商壽,123,0,123,新光-高雄,2024-06-25,8562
00940,元大台灣價值高息,150,39,111,新光-高雄,2024-06-25,8562
00706L,期元大S＆P日圓正2,140,30,110,新光-高雄,2024-06-25,8562
00687B,國泰20年美債,219,115,104,新光-高雄,2024-06-25,8562
3450,聯鈞,157,63,94,新光-高雄,2024-06-25,8562
00946,群益科技高息成長,126,34,92,新光-高雄,2024-06-25,8562
1611,中電,229,139,90,新光-高雄,2024-06-25,8562
00637L,元大滬深300正2,115,36,79,新光-高雄,2024-06-25,8562
2409,友達,148,69,79,新光-高雄,2024-06-25,8562
1301,台塑,88,11,77,新光-高雄,2024-06-25,8562
6869,雲豹能源,119,47,72,新光-高雄,2024-06-25,8562
2547,日勝生,71,0,71,新光-高雄,2024-06-25,8562
00927,群益半導體收益,60,1,59,新光-高雄,2024-06-25,8562
8011,台通,65,8,57,新光-高雄,2024-06-25,8562
1785,光洋科,249,194,55,新光-高雄,2024-06-25,8562
2002,中鋼,57,3,54,新光-高雄,2024-06-25,8562
3710,連展投控,50,0,50,新光-高雄,2024-06-25,8562
2883B,凱基金乙特,50,0,50,新光-高雄,2024-06-25,8562
00918,大華優利高填息30,60,10,50,新光-高雄,2024-06-25,8562
6806,森崴能源,92,42,50,新光-高雄,2024-06-25,8562
2303,聯電,104,54,50,新光-高雄,2024-06-25,8562
6957,裕慶-KY,44,2,42,新光-高雄,2024-06-25,8562
1319,東陽,49,8,41,新光-高雄,2024-06-25,8562
6116,彩晶,41,0,41,新光-高雄,2024-06-25,8562
911868,同方友友-DR,40,0,40,新光-高雄,2024-06-25,8562
2618,長榮航,45,8,37,新光-高雄,2024-06-25,8562
3025,星通,76,42,34,新光-高雄,2024-06-25,8562
3037,欣興,37,3,34,新光-高雄,2024-06-25,8562
00947,台新臺灣IC設計,50,17,33,新光-高雄,2024-06-25,8562
00878,國泰永續高股息,64,33,31,新光-高雄,2024-06-25,8562
8354,冠好,30,0,30,新光-高雄,2024-06-25,8562
2485,兆赫,30,0,30,新光-高雄,2024-06-25,8562
2328,廣宇,31,1,30,新光-高雄,2024-06-25,8562
4306,炎洲,31,1,30,新光-高雄,2024-06-25,8562
1314,中石化,124,95,29,新光-高雄,2024-06-25,8562
8110,華東,131,102,29,新光-高雄,2024-06-25,8562
3481,群創,575,546,29,新光-高雄,2024-06-25,8562
2408,南亞科,38,10,28,新光-高雄,2024-06-25,8562
5864,致和證,26,0,26,新光-高雄,2024-06-25,8562
8277,商丞,30,5,25,新光-高雄,2024-06-25,8562
6130,上亞科技,25,0,25,新光-高雄,2024-06-25,8562
00738U,期元大道瓊白銀,26,1,25,新光-高雄,2024-06-25,8562
2393,億光,24,0,24,新光-高雄,2024-06-25,8562
00830,國泰費城半導體,24,2,22,新光-高雄,2024-06-25,8562
00939,統一台灣高息動能,25,3,22,新光-高雄,2024-06-25,8562
00929,復華台灣科技優息,453,171,282,新光-高雄,2024-06-26,8562
3481,群創,456,233,223,新光-高雄,2024-06-26,8562
6005,群益證,211,10,201,新光-高雄,2024-06-26,8562
00680L,元大美債20正2,195,7,188,新光-高雄,2024-06-26,8562
00936,台新永續高息中小,198,50,148,新光-高雄,2024-06-26,8562
2409,友達,160,20,140,新光-高雄,2024-06-26,8562
00937B,群益ESG投等債20,153,13,140,新光-高雄,2024-06-26,8562
1301,台塑,139,7,132,新光-高雄,2024-06-26,8562
00632R,元大台灣50反1,324,193,131,新光-高雄,2024-06-26,8562
2888,新光金,159,37,122,新光-高雄,2024-06-26,8562
00905,FT臺灣Smart,121,1,120,新光-高雄,2024-06-26,8562
00919,群益台灣精選高息,202,86,116,新光-高雄,2024-06-26,8562
2890,永豐金,104,0,104,新光-高雄,2024-06-26,8562
3419,譁裕,108,8,100,新光-高雄,2024-06-26,8562
6116,彩晶,101,12,89,新光-高雄,2024-06-26,8562
2883,凱基金,109,24,85,新光-高雄,2024-06-26,8562
5607,遠雄港,79,2,77,新光-高雄,2024-06-26,8562
9105,泰金寶-DR,100,27,73,新光-高雄,2024-06-26,8562
2515,中工,75,5,70,新光-高雄,2024-06-26,8562
2347,聯強,68,0,68,新光-高雄,2024-06-26,8562
2344,華邦電,109,54,55,新光-高雄,2024-06-26,8562
00713,元大台灣高息低波,60,6,54,新光-高雄,2024-06-26,8562
5864,致和證,51,0,51,新光-高雄,2024-06-26,8562
006208,富邦台50,54,3,51,新光-高雄,2024-06-26,8562
2354,鴻準,92,44,48,新光-高雄,2024-06-26,8562
2603,長榮,51,6,45,新光-高雄,2024-06-26,8562
2609,陽明,79,36,43,新光-高雄,2024-06-26,8562
2353,宏��,58,16,42,新光-高雄,2024-06-26,8562
00688L,國泰20年美債正2,63,22,41,新光-高雄,2024-06-26,8562
00946,群益科技高息成長,41,1,40,新光-高雄,2024-06-26,8562
6757,台灣虎航,41,1,40,新光-高雄,2024-06-26,8562
00675L,富邦臺灣加權正2,43,3,40,新光-高雄,2024-06-26,8562
00881,國泰台灣5G+,45,7,38,新光-高雄,2024-06-26,8562
2317,鴻海,144,106,38,新光-高雄,2024-06-26,8562
2201,裕隆,38,0,38,新光-高雄,2024-06-26,8562
2615,萬海,135,100,35,新光-高雄,2024-06-26,8562
2892,第一金,33,0,33,新光-高雄,2024-06-26,8562
00637L,元大滬深300正2,69,36,33,新光-高雄,2024-06-26,8562
2891,中信金,38,6,32,新光-高雄,2024-06-26,8562
1303,南亞,36,5,31,新光-高雄,2024-06-26,8562
1503,士電,49,18,31,新光-高雄,2024-06-26,8562
6462,神盾,45,15,30,新光-高雄,2024-06-26,8562
2617,台航,30,0,30,新光-高雄,2024-06-26,8562
6449,鈺邦,35,6,29,新光-高雄,2024-06-26,8562
1785,光洋科,149,121,28,新光-高雄,2024-06-26,8562
2442,新美齊,30,2,28,新光-高雄,2024-06-26,8562
3017,奇鋐,68,40,28,新光-高雄,2024-06-26,8562
3090,日電貿,30,3,27,新光-高雄,2024-06-26,8562
00712,復華富時不動產,26,0,26,新光-高雄,2024-06-26,8562
00907,永豐優息存股,25,0,25,新光-高雄,2024-06-26,8562
00937B,群益ESG投等債20,550,83,467,新光-高雄,2024-06-27,8562
5880,合庫金,404,51,353,新光-高雄,2024-06-27,8562
8076,伍豐,399,59,340,新光-高雄,2024-06-27,8562
00680L,元大美債20正2,397,70,327,新光-高雄,2024-06-27,8562
00929,復華台灣科技優息,334,47,287,新光-高雄,2024-06-27,8562
2344,華邦電,290,13,277,新光-高雄,2024-06-27,8562
9105,泰金寶-DR,350,94,256,新光-高雄,2024-06-27,8562
00687B,國泰20年美債,209,38,171,新光-高雄,2024-06-27,8562
00706L,期元大S＆P日圓正2,167,0,167,新光-高雄,2024-06-27,8562
00936,台新永續高息中小,207,43,164,新光-高雄,2024-06-27,8562
6806,森崴能源,346,202,144,新光-高雄,2024-06-27,8562
00948B,中信優息投資級債,143,0,143,新光-高雄,2024-06-27,8562
00679B,元大美債20年,144,2,142,新光-高雄,2024-06-27,8562
00919,群益台灣精選高息,148,33,115,新光-高雄,2024-06-27,8562
00665L,富邦�琤肭磪囓�2,223,115,108,新光-高雄,2024-06-27,8562
3481,群創,397,317,80,新光-高雄,2024-06-27,8562
2409,友達,95,16,79,新光-高雄,2024-06-27,8562
00927,群益半導體收益,73,0,73,新光-高雄,2024-06-27,8562
2885,元大金,78,5,73,新光-高雄,2024-06-27,8562
3047,訊舟,680,609,71,新光-高雄,2024-06-27,8562
5871,中租-KY,68,1,67,新光-高雄,2024-06-27,8562
4707,磐亞,73,8,65,新光-高雄,2024-06-27,8562
00946,群益科技高息成長,69,6,63,新光-高雄,2024-06-27,8562
2615,萬海,186,126,60,新光-高雄,2024-06-27,8562
1597,直得,66,12,54,新光-高雄,2024-06-27,8562
00878,國泰永續高股息,92,38,54,新光-高雄,2024-06-27,8562
3666,光耀,71,19,52,新光-高雄,2024-06-27,8562
6120,達運,50,0,50,新光-高雄,2024-06-27,8562
3710,連展投控,50,0,50,新光-高雄,2024-06-27,8562
00751B,元大AAA至A公司債,49,0,49,新光-高雄,2024-06-27,8562
2883,凱基金,62,17,45,新光-高雄,2024-06-27,8562
00881,國泰台灣5G+,46,2,44,新光-高雄,2024-06-27,8562
0056,元大高股息,58,14,44,新光-高雄,2024-06-27,8562
4534,慶騰,41,0,41,新光-高雄,2024-06-27,8562
6451,訊芯-KY,43,3,40,新光-高雄,2024-06-27,8562
00733,富邦臺灣中小,40,1,39,新光-高雄,2024-06-27,8562
912000,晨訊科-DR,52,13,39,新光-高雄,2024-06-27,8562
1303,南亞,43,4,39,新光-高雄,2024-06-27,8562
9945,潤泰新,44,7,37,新光-高雄,2024-06-27,8562
2888,新光金,37,0,37,新光-高雄,2024-06-27,8562
00753L,中信中國50正2,58,23,35,新光-高雄,2024-06-27,8562
1608,華榮,36,2,34,新光-高雄,2024-06-27,8562
00713,元大台灣高息低波,33,0,33,新光-高雄,2024-06-27,8562
2104,國際中橡,33,0,33,新光-高雄,2024-06-27,8562
1809,中釉,80,50,30,新光-高雄,2024-06-27,8562
6869,雲豹能源,89,60,29,新光-高雄,2024-06-27,8562
2337,旺宏,33,4,29,新光-高雄,2024-06-27,8562
2301,光寶科,46,17,29,新光-高雄,2024-06-27,8562
2002,中鋼,41,12,29,新光-高雄,2024-06-27,8562
2329,華泰,29,1,28,新光-高雄,2024-06-27,8562
2610,華航,575,77,498,新光-高雄,2024-06-28,8562
00679B,元大美債20年,324,51,273,新光-高雄,2024-06-28,8562
00688L,國泰20年美債正2,311,50,261,新光-高雄,2024-06-28,8562
00929,復華台灣科技優息,293,53,240,新光-高雄,2024-06-28,8562
2409,友達,189,37,152,新光-高雄,2024-06-28,8562
0056,元大高股息,171,33,138,新光-高雄,2024-06-28,8562
00936,台新永續高息中小,151,20,131,新光-高雄,2024-06-28,8562
00937B,群益ESG投等債20,163,33,130,新光-高雄,2024-06-28,8562
2359,所羅門,146,23,123,新光-高雄,2024-06-28,8562
00712,復華富時不動產,145,28,117,新光-高雄,2024-06-28,8562
3712,永崴投控,135,33,102,新光-高雄,2024-06-28,8562
00878,國泰永續高股息,119,21,98,新光-高雄,2024-06-28,8562
00673R,期元大S＆P原油反1,97,0,97,新光-高雄,2024-06-28,8562
00687B,國泰20年美債,99,4,95,新光-高雄,2024-06-28,8562
2897,王道銀行,88,0,88,新光-高雄,2024-06-28,8562
2892,第一金,90,6,84,新光-高雄,2024-06-28,8562
00919,群益台灣精選高息,111,29,82,新光-高雄,2024-06-28,8562
2353,宏��,99,34,65,新光-高雄,2024-06-28,8562
2337,旺宏,84,26,58,新光-高雄,2024-06-28,8562
2882,國泰金,63,6,57,新光-高雄,2024-06-28,8562
8027,鈦昇,79,23,56,新光-高雄,2024-06-28,8562
8112,至上,74,18,56,新光-高雄,2024-06-28,8562
3024,憶聲,103,48,55,新光-高雄,2024-06-28,8562
1339,昭輝,57,2,55,新光-高雄,2024-06-28,8562
00933B,國泰10Y+金融債,72,20,52,新光-高雄,2024-06-28,8562
6443,元晶,216,166,50,新光-高雄,2024-06-28,8562
00706L,期元大S＆P日圓正2,109,60,49,新光-高雄,2024-06-28,8562
2002,中鋼,56,9,47,新光-高雄,2024-06-28,8562
3312,弘憶股,255,208,47,新光-高雄,2024-06-28,8562
6139,亞翔,64,20,44,新光-高雄,2024-06-28,8562
2464,盟立,194,152,42,新光-高雄,2024-06-28,8562
3580,友威科,43,2,41,新光-高雄,2024-06-28,8562
3581,博磊,63,23,40,新光-高雄,2024-06-28,8562
4908,前鼎,50,12,38,新光-高雄,2024-06-28,8562
912000,晨訊科-DR,68,31,37,新光-高雄,2024-06-28,8562
8421,旭源,39,2,37,新光-高雄,2024-06-28,8562
1314,中石化,35,0,35,新光-高雄,2024-06-28,8562
00948B,中信優息投資級債,33,0,33,新光-高雄,2024-06-28,8562
8105,凌巨,194,162,32,新光-高雄,2024-06-28,8562
8086,宏捷科,47,15,32,新光-高雄,2024-06-28,8562
2206,三陽工業,30,0,30,新光-高雄,2024-06-28,8562
1218,泰山,30,0,30,新光-高雄,2024-06-28,8562
2406,國碩,221,191,30,新光-高雄,2024-06-28,8562
2855,統一證,30,2,28,新光-高雄,2024-06-28,8562
2867,三商壽,31,3,28,新光-高雄,2024-06-28,8562
6790,永豐實,27,0,27,新光-高雄,2024-06-28,8562
6026,福邦證,26,0,26,新光-高雄,2024-06-28,8562
5534,長虹,28,3,25,新光-高雄,2024-06-28,8562
4909,新復興,98,74,24,新光-高雄,2024-06-28,8562
4503,金雨,29,5,24,新光-高雄,2024-06-28,8562
00680L,元大美債20正2,809,35,774,新光-高雄,2024-07-01,8562
00937B,群益ESG投等債20,796,72,724,新光-高雄,2024-07-01,8562
00679B,元大美債20年,531,145,386,新光-高雄,2024-07-01,8562
00720B,元大投資級公司債,353,0,353,新光-高雄,2024-07-01,8562
00688L,國泰20年美債正2,719,388,331,新光-高雄,2024-07-01,8562
9105,泰金寶-DR,367,48,319,新光-高雄,2024-07-01,8562
00929,復華台灣科技優息,367,130,237,新光-高雄,2024-07-01,8562
00948B,中信優息投資級債,232,0,232,新光-高雄,2024-07-01,8562
00687B,國泰20年美債,359,129,230,新光-高雄,2024-07-01,8562
00632R,元大台灣50反1,365,150,215,新光-高雄,2024-07-01,8562
00936,台新永續高息中小,228,37,191,新光-高雄,2024-07-01,8562
00881,國泰台灣5G+,190,3,187,新光-高雄,2024-07-01,8562
2409,友達,135,1,134,新光-高雄,2024-07-01,8562
6127,九豪,268,151,117,新光-高雄,2024-07-01,8562
2892,第一金,110,0,110,新光-高雄,2024-07-01,8562
00942B,台新美A公司債20+,157,50,107,新光-高雄,2024-07-01,8562
00933B,國泰10Y+金融債,102,4,98,新光-高雄,2024-07-01,8562
2337,旺宏,147,52,95,新光-高雄,2024-07-01,8562
2359,所羅門,213,141,72,新光-高雄,2024-07-01,8562
00751B,元大AAA至A公司債,72,0,72,新光-高雄,2024-07-01,8562
2303,聯電,184,119,65,新光-高雄,2024-07-01,8562
3580,友威科,93,28,65,新光-高雄,2024-07-01,8562
0056,元大高股息,103,42,61,新光-高雄,2024-07-01,8562
4720,德淵,62,4,58,新光-高雄,2024-07-01,8562
2323,中環,59,2,57,新光-高雄,2024-07-01,8562
2367,燿華,154,98,56,新光-高雄,2024-07-01,8562
6753,龍德造船,101,46,55,新光-高雄,2024-07-01,8562
3060,銘異,74,21,53,新光-高雄,2024-07-01,8562
2312,金寶,68,18,50,新光-高雄,2024-07-01,8562
00637L,元大滬深300正2,92,43,49,新光-高雄,2024-07-01,8562
2883,凱基金,66,17,49,新光-高雄,2024-07-01,8562
2882,國泰金,53,4,49,新光-高雄,2024-07-01,8562
00753L,中信中國50正2,45,0,45,新光-高雄,2024-07-01,8562
00919,群益台灣精選高息,283,239,44,新光-高雄,2024-07-01,8562
1301,台塑,48,10,38,新光-高雄,2024-07-01,8562
1309,台達化,40,2,38,新光-高雄,2024-07-01,8562
00949,復華日本龍頭,39,1,38,新光-高雄,2024-07-01,8562
4534,慶騰,43,6,37,新光-高雄,2024-07-01,8562
2867,三商壽,38,2,36,新光-高雄,2024-07-01,8562
2891,中信金,40,4,36,新光-高雄,2024-07-01,8562
6695,芯鼎,46,11,35,新光-高雄,2024-07-01,8562
3062,建漢,60,27,33,新光-高雄,2024-07-01,8562
5905,南仁湖,42,9,33,新光-高雄,2024-07-01,8562
8064,東捷,99,70,29,新光-高雄,2024-07-01,8562
00857B,永豐20年美公債,28,0,28,新光-高雄,2024-07-01,8562
00909,國泰數位支付服務,28,0,28,新光-高雄,2024-07-01,8562
2049,上銀,27,0,27,新光-高雄,2024-07-01,8562
8176,智捷,30,4,26,新光-高雄,2024-07-01,8562
2374,佳能,43,18,25,新光-高雄,2024-07-01,8562
5512,力麒,25,0,25,新光-高雄,2024-07-01,8562
00934,中信成長高股息,1552,149,1403,新光-高雄,2024-07-02,8562
00680L,元大美債20正2,964,0,964,新光-高雄,2024-07-02,8562
00688L,國泰20年美債正2,780,10,770,新光-高雄,2024-07-02,8562
9105,泰金寶-DR,676,134,542,新光-高雄,2024-07-02,8562
00679B,元大美債20年,363,86,277,新光-高雄,2024-07-02,8562
2303,聯電,347,85,262,新光-高雄,2024-07-02,8562
2449,京元電子,330,84,246,新光-高雄,2024-07-02,8562
2317,鴻海,279,61,218,新光-高雄,2024-07-02,8562
00687B,國泰20年美債,239,24,215,新光-高雄,2024-07-02,8562
00937B,群益ESG投等債20,247,38,209,新光-高雄,2024-07-02,8562
2515,中工,219,15,204,新光-高雄,2024-07-02,8562
00942B,台新美A公司債20+,185,0,185,新光-高雄,2024-07-02,8562
2892,第一金,179,1,178,新光-高雄,2024-07-02,8562
00948B,中信優息投資級債,184,9,175,新光-高雄,2024-07-02,8562
00720B,元大投資級公司債,153,12,141,新光-高雄,2024-07-02,8562
1301,台塑,142,5,137,新光-高雄,2024-07-02,8562
0056,元大高股息,247,115,132,新光-高雄,2024-07-02,8562
3481,群創,187,60,127,新光-高雄,2024-07-02,8562
00936,台新永續高息中小,203,83,120,新光-高雄,2024-07-02,8562
3535,晶彩科,298,179,119,新光-高雄,2024-07-02,8562
00712,復華富時不動產,118,0,118,新光-高雄,2024-07-02,8562
1597,直得,112,5,107,新光-高雄,2024-07-02,8562
3713,新晶投控,100,0,100,新光-高雄,2024-07-02,8562
00908,富邦入息REITs+,99,0,99,新光-高雄,2024-07-02,8562
1303,南亞,100,6,94,新光-高雄,2024-07-02,8562
00673R,期元大S＆P原油反1,258,170,88,新光-高雄,2024-07-02,8562
5880,合庫金,81,0,81,新光-高雄,2024-07-02,8562
00881,國泰台灣5G+,138,58,80,新光-高雄,2024-07-02,8562
00795B,中信美國公債20年,80,0,80,新光-高雄,2024-07-02,8562
00940,元大台灣價值高息,206,129,77,新光-高雄,2024-07-02,8562
2409,友達,76,1,75,新光-高雄,2024-07-02,8562
00706L,期元大S＆P日圓正2,69,2,67,新光-高雄,2024-07-02,8562
2349,錸德,159,94,65,新光-高雄,2024-07-02,8562
2464,盟立,107,46,61,新光-高雄,2024-07-02,8562
2812,台中銀,62,4,58,新光-高雄,2024-07-02,8562
4562,穎漢,224,172,52,新光-高雄,2024-07-02,8562
1409,新纖,49,0,49,新光-高雄,2024-07-02,8562
2324,仁寶,53,5,48,新光-高雄,2024-07-02,8562
1785,光洋科,115,67,48,新光-高雄,2024-07-02,8562
912000,晨訊科-DR,57,10,47,新光-高雄,2024-07-02,8562
6239,力成,48,1,47,新光-高雄,2024-07-02,8562
1326,台化,64,17,47,新光-高雄,2024-07-02,8562
3702,大聯大,64,20,44,新光-高雄,2024-07-02,8562
00949,復華日本龍頭,41,2,39,新光-高雄,2024-07-02,8562
3711,日月光投控,40,2,38,新光-高雄,2024-07-02,8562
2883,凱基金,46,10,36,新光-高雄,2024-07-02,8562
6770,力積電,38,3,35,新光-高雄,2024-07-02,8562
6127,九豪,48,13,35,新光-高雄,2024-07-02,8562
00918,大華優利高填息30,36,4,32,新光-高雄,2024-07-02,8562
5452,佶優,71,41,30,新光-高雄,2024-07-02,8562
00680L,元大美債20正2,1440,39,1401,新光-高雄,2024-07-03,8562
00687B,國泰20年美債,250,1,249,新光-高雄,2024-07-03,8562
00934,中信成長高股息,342,105,237,新光-高雄,2024-07-03,8562
00940,元大台灣價值高息,292,111,181,新光-高雄,2024-07-03,8562
00929,復華台灣科技優息,270,95,175,新光-高雄,2024-07-03,8562
00936,台新永續高息中小,162,5,157,新光-高雄,2024-07-03,8562
3050,鈺德,207,57,150,新光-高雄,2024-07-03,8562
6026,福邦證,124,10,114,新光-高雄,2024-07-03,8562
2615,萬海,244,151,93,新光-高雄,2024-07-03,8562
1785,光洋科,178,87,91,新光-高雄,2024-07-03,8562
2317,鴻海,144,59,85,新光-高雄,2024-07-03,8562
2610,華航,156,74,82,新光-高雄,2024-07-03,8562
2820,華票,82,2,80,新光-高雄,2024-07-03,8562
2402,毅嘉,288,210,78,新光-高雄,2024-07-03,8562
3450,聯鈞,142,67,75,新光-高雄,2024-07-03,8562
3576,聯合再生,531,468,63,新光-高雄,2024-07-03,8562
00679B,元大美債20年,99,38,61,新光-高雄,2024-07-03,8562
6443,元晶,260,202,58,新光-高雄,2024-07-03,8562
4906,正文,195,147,48,新光-高雄,2024-07-03,8562
2464,盟立,125,83,42,新光-高雄,2024-07-03,8562
8027,鈦昇,57,18,39,新光-高雄,2024-07-03,8562
2340,台亞,42,3,39,新光-高雄,2024-07-03,8562
00949,復華日本龍頭,40,2,38,新光-高雄,2024-07-03,8562
6120,達運,40,5,35,新光-高雄,2024-07-03,8562
3689,湧德,50,15,35,新光-高雄,2024-07-03,8562
2002,中鋼,40,6,34,新光-高雄,2024-07-03,8562
1309,台達化,34,0,34,新光-高雄,2024-07-03,8562
3324,雙鴻,43,10,33,新光-高雄,2024-07-03,8562
2303,聯電,48,19,29,新光-高雄,2024-07-03,8562
2427,三商電,52,23,29,新光-高雄,2024-07-03,8562
00946,群益科技高息成長,32,5,27,新光-高雄,2024-07-03,8562
2489,瑞軒,57,30,27,新光-高雄,2024-07-03,8562
00945B,凱基美國非投等債,26,0,26,新光-高雄,2024-07-03,8562
2812,台中銀,26,0,26,新光-高雄,2024-07-03,8562
3686,達能,25,0,25,新光-高雄,2024-07-03,8562
2352,佳世達,28,4,24,新光-高雄,2024-07-03,8562
5443,均豪,130,106,24,新光-高雄,2024-07-03,8562
1612,宏泰,23,0,23,新光-高雄,2024-07-03,8562
2419,仲琦,33,10,23,新光-高雄,2024-07-03,8562
3005,神基,40,18,22,新光-高雄,2024-07-03,8562
2105,正新,28,5,23,新光-高雄,2024-07-03,8562
00918,大華優利高填息30,25,3,22,新光-高雄,2024-07-03,8562
1714,和桐,23,2,21,新光-高雄,2024-07-03,8562
2301,光寶科,32,12,20,新光-高雄,2024-07-03,8562
3062,建漢,50,30,20,新光-高雄,2024-07-03,8562
2316,楠梓電,28,8,20,新光-高雄,2024-07-03,8562
3047,訊舟,349,329,20,新光-高雄,2024-07-03,8562
4915,致伸,23,5,18,新光-高雄,2024-07-03,8562
6152,百一,27,9,18,新光-高雄,2024-07-03,8562
3105,穩懋,28,10,18,新光-高雄,2024-07-03,8562
00632R,元大台灣50反1,1190,301,889,新光-高雄,2024-07-04,8562
00680L,元大美債20正2,802,243,559,新光-高雄,2024-07-04,8562
00936,台新永續高息中小,141,15,126,新光-高雄,2024-07-04,8562
2834,臺企銀,147,40,107,新光-高雄,2024-07-04,8562
2883,凱基金,209,103,106,新光-高雄,2024-07-04,8562
2353,宏��,130,31,99,新光-高雄,2024-07-04,8562
2897,王道銀行,95,0,95,新光-高雄,2024-07-04,8562
00688L,國泰20年美債正2,274,181,93,新光-高雄,2024-07-04,8562
8249,菱光,89,0,89,新光-高雄,2024-07-04,8562
00857B,永豐20年美公債,85,5,80,新光-高雄,2024-07-04,8562
2412,中華電,116,40,76,新光-高雄,2024-07-04,8562
2367,燿華,166,91,75,新光-高雄,2024-07-04,8562
00696B,富邦美債20年,72,2,70,新光-高雄,2024-07-04,8562
3450,聯鈞,198,136,62,新光-高雄,2024-07-04,8562
9907,統一實,60,0,60,新光-高雄,2024-07-04,8562
00687B,國泰20年美債,130,73,57,新光-高雄,2024-07-04,8562
2887,台新金,89,31,58,新光-高雄,2024-07-04,8562
3481,群創,299,242,57,新光-高雄,2024-07-04,8562
2913,農林,81,24,57,新光-高雄,2024-07-04,8562
00795B,中信美國公債20年,53,2,51,新光-高雄,2024-07-04,8562
2359,所羅門,155,106,49,新光-高雄,2024-07-04,8562
4938,和碩,51,4,47,新光-高雄,2024-07-04,8562
2449,京元電子,85,42,43,新光-高雄,2024-07-04,8562
00929,復華台灣科技優息,175,132,43,新光-高雄,2024-07-04,8562
00673R,期元大S＆P原油反1,43,0,43,新光-高雄,2024-07-04,8562
9105,泰金寶-DR,268,226,42,新光-高雄,2024-07-04,8562
2338,光罩,56,17,39,新光-高雄,2024-07-04,8562
3047,訊舟,193,155,38,新光-高雄,2024-07-04,8562
5347,世界,61,24,37,新光-高雄,2024-07-04,8562
1785,光洋科,321,285,36,新光-高雄,2024-07-04,8562
1514,亞力,138,107,31,新光-高雄,2024-07-04,8562
00676R,富邦臺灣加權反1,31,0,31,新光-高雄,2024-07-04,8562
00706L,期元大S＆P日圓正2,30,0,30,新光-高雄,2024-07-04,8562
6603,富強鑫,35,6,29,新光-高雄,2024-07-04,8562
3062,建漢,64,37,27,新光-高雄,2024-07-04,8562
2743,山富,27,1,26,新光-高雄,2024-07-04,8562
2349,錸德,38,12,26,新光-高雄,2024-07-04,8562
6698,旭暉應材,67,41,26,新光-高雄,2024-07-04,8562
2603,長榮,46,20,26,新光-高雄,2024-07-04,8562
2329,華泰,26,1,25,新光-高雄,2024-07-04,8562
00932,兆豐永續高息等權,26,2,24,新光-高雄,2024-07-04,8562
2618,長榮航,93,69,24,新光-高雄,2024-07-04,8562
6179,亞通,97,73,24,新光-高雄,2024-07-04,8562
6127,九豪,118,94,24,新光-高雄,2024-07-04,8562
00923,群益台ESG低碳50,33,9,24,新光-高雄,2024-07-04,8562
2324,仁寶,25,2,23,新光-高雄,2024-07-04,8562
2845,遠東銀,23,0,23,新光-高雄,2024-07-04,8562
3312,弘憶股,172,149,23,新光-高雄,2024-07-04,8562
2611,志信,22,0,22,新光-高雄,2024-07-04,8562
00882,中信中國高股息,22,1,21,新光-高雄,2024-07-04,8562
2515,中工,1124,44,1080,新光-高雄,2024-07-05,8562
00673R,期元大S＆P原油反1,393,0,393,新光-高雄,2024-07-05,8562
2610,華航,283,24,259,新光-高雄,2024-07-05,8562
00706L,期元大S＆P日圓正2,230,0,230,新光-高雄,2024-07-05,8562
00637L,元大滬深300正2,342,126,216,新光-高雄,2024-07-05,8562
6005,群益證,206,0,206,新光-高雄,2024-07-05,8562
2888,新光金,379,194,185,新光-高雄,2024-07-05,8562
912000,晨訊科-DR,197,13,184,新光-高雄,2024-07-05,8562
1303,南亞,152,2,150,新光-高雄,2024-07-05,8562
00929,復華台灣科技優息,254,113,141,新光-高雄,2024-07-05,8562
00679B,元大美債20年,136,15,121,新光-高雄,2024-07-05,8562
2884,玉山金,111,12,99,新光-高雄,2024-07-05,8562
00687B,國泰20年美債,113,42,71,新光-高雄,2024-07-05,8562
2812,台中銀,84,17,67,新光-高雄,2024-07-05,8562
3374,精材,123,59,64,新光-高雄,2024-07-05,8562
6443,元晶,148,87,61,新光-高雄,2024-07-05,8562
8064,東捷,111,51,60,新光-高雄,2024-07-05,8562
00712,復華富時不動產,80,34,46,新光-高雄,2024-07-05,8562
6244,茂迪,84,37,47,新光-高雄,2024-07-05,8562
00934,中信成長高股息,55,10,45,新光-高雄,2024-07-05,8562
1471,首利,45,1,44,新光-高雄,2024-07-05,8562
2609,陽明,79,35,44,新光-高雄,2024-07-05,8562
4534,慶騰,73,30,43,新光-高雄,2024-07-05,8562
4960,誠美材,117,76,41,新光-高雄,2024-07-05,8562
8150,南茂,41,0,41,新光-高雄,2024-07-05,8562
2867,三商壽,70,29,41,新光-高雄,2024-07-05,8562
6179,亞通,86,46,40,新光-高雄,2024-07-05,8562
3048,益登,134,95,39,新光-高雄,2024-07-05,8562
6770,力積電,38,1,37,新光-高雄,2024-07-05,8562
9906,欣巴巴,36,1,35,新光-高雄,2024-07-05,8562
00936,台新永續高息中小,35,2,33,新光-高雄,2024-07-05,8562
3050,鈺德,52,19,33,新光-高雄,2024-07-05,8562
2354,鴻準,58,25,33,新光-高雄,2024-07-05,8562
5392,能率,88,56,32,新光-高雄,2024-07-05,8562
5484,慧友,34,3,31,新光-高雄,2024-07-05,8562
8027,鈦昇,47,18,29,新光-高雄,2024-07-05,8562
2603,長榮,85,56,29,新光-高雄,2024-07-05,8562
2401,凌陽,126,99,27,新光-高雄,2024-07-05,8562
3094,聯傑,33,6,27,新光-高雄,2024-07-05,8562
2543,皇昌,129,102,27,新光-高雄,2024-07-05,8562
2349,錸德,42,16,26,新光-高雄,2024-07-05,8562
00915,凱基優選高股息30,26,0,26,新光-高雄,2024-07-05,8562
00948B,中信優息投資級債,25,0,25,新光-高雄,2024-07-05,8562
2301,光寶科,62,38,24,新光-高雄,2024-07-05,8562
2745,五福,25,1,24,新光-高雄,2024-07-05,8562
2344,華邦電,41,18,23,新光-高雄,2024-07-05,8562
8093,保銳,23,0,23,新光-高雄,2024-07-05,8562
3024,憶聲,30,7,23,新光-高雄,2024-07-05,8562
6152,百一,38,15,23,新光-高雄,2024-07-05,8562
6207,雷科,126,103,23,新光-高雄,2024-07-05,8562
00929,復華台灣科技優息,541,198,343,新光-高雄,2024-07-08,8562
00934,中信成長高股息,343,16,327,新光-高雄,2024-07-08,8562
1316,上曜,336,49,287,新光-高雄,2024-07-08,8562
00881,國泰台灣5G+,207,4,203,新光-高雄,2024-07-08,8562
1303,南亞,203,11,192,新光-高雄,2024-07-08,8562
00931B,統一美債20年,189,12,177,新光-高雄,2024-07-08,8562
00712,復華富時不動產,160,5,155,新光-高雄,2024-07-08,8562
2888,新光金,407,255,152,新光-高雄,2024-07-08,8562
5512,力麒,181,37,144,新光-高雄,2024-07-08,8562
4909,新復興,155,22,133,新光-高雄,2024-07-08,8562
2331,精英,138,17,121,新光-高雄,2024-07-08,8562
00936,台新永續高息中小,144,27,117,新光-高雄,2024-07-08,8562
2365,昆盈,400,291,109,新光-高雄,2024-07-08,8562
1785,光洋科,302,194,108,新光-高雄,2024-07-08,8562
2401,凌陽,140,34,106,新光-高雄,2024-07-08,8562
00945B,凱基美國非投等債,101,0,101,新光-高雄,2024-07-08,8562
2337,旺宏,109,15,94,新光-高雄,2024-07-08,8562
00937B,群益ESG投等債20,346,258,88,新光-高雄,2024-07-08,8562
4906,正文,137,49,88,新光-高雄,2024-07-08,8562
00632R,元大台灣50反1,292,208,84,新光-高雄,2024-07-08,8562
6213,聯茂,103,30,73,新光-高雄,2024-07-08,8562
3481,群創,184,112,72,新光-高雄,2024-07-08,8562
2515,中工,87,16,71,新光-高雄,2024-07-08,8562
3033,威健,144,75,69,新光-高雄,2024-07-08,8562
00688L,國泰20年美債正2,133,65,68,新光-高雄,2024-07-08,8562
6443,元晶,126,63,63,新光-高雄,2024-07-08,8562
3045,台灣大,78,19,59,新光-高雄,2024-07-08,8562
2641,正德,61,5,56,新光-高雄,2024-07-08,8562
3296,勝德,55,0,55,新光-高雄,2024-07-08,8562
2402,毅嘉,64,10,54,新光-高雄,2024-07-08,8562
2464,盟立,398,344,54,新光-高雄,2024-07-08,8562
9906,欣巴巴,55,8,47,新光-高雄,2024-07-08,8562
4960,誠美材,101,57,44,新光-高雄,2024-07-08,8562
2867,三商壽,95,51,44,新光-高雄,2024-07-08,8562
2427,三商電,130,87,43,新光-高雄,2024-07-08,8562
2495,普安,134,93,41,新光-高雄,2024-07-08,8562
6188,廣明,77,38,39,新光-高雄,2024-07-08,8562
3581,博磊,42,3,39,新光-高雄,2024-07-08,8562
00927,群益半導體收益,65,26,39,新光-高雄,2024-07-08,8562
4904,遠傳,114,77,37,新光-高雄,2024-07-08,8562
2392,正崴,98,62,36,新光-高雄,2024-07-08,8562
3005,神基,44,9,35,新光-高雄,2024-07-08,8562
4162,智擎,43,8,35,新光-高雄,2024-07-08,8562
6133,金橋,44,9,35,新光-高雄,2024-07-08,8562
2457,飛宏,44,9,35,新光-高雄,2024-07-08,8562
6269,台郡,37,3,34,新光-高雄,2024-07-08,8562
6546,正基,39,5,34,新光-高雄,2024-07-08,8562
2611,志信,38,5,33,新光-高雄,2024-07-08,8562
3498,陽程,67,34,33,新光-高雄,2024-07-08,8562
00939,統一台灣高息動能,37,5,32,新光-高雄,2024-07-08,8562
00882,中信中國高股息,783,12,771,新光-高雄,2024-07-09,8562
4904,遠傳,714,101,613,新光-高雄,2024-07-09,8562
2888,新光金,860,350,510,新光-高雄,2024-07-09,8562
9105,泰金寶-DR,1076,632,444,新光-高雄,2024-07-09,8562
2834,臺企銀,283,16,267,新光-高雄,2024-07-09,8562
00929,復華台灣科技優息,413,150,263,新光-高雄,2024-07-09,8562
00934,中信成長高股息,314,52,262,新光-高雄,2024-07-09,8562
2312,金寶,512,351,161,新光-高雄,2024-07-09,8562
00936,台新永續高息中小,254,114,140,新光-高雄,2024-07-09,8562
00945B,凱基美國非投等債,134,0,134,新光-高雄,2024-07-09,8562
4167,松瑞藥,130,2,128,新光-高雄,2024-07-09,8562
6153,嘉聯益,144,34,110,新光-高雄,2024-07-09,8562
00878,國泰永續高股息,131,23,108,新光-高雄,2024-07-09,8562
2317,鴻海,307,206,101,新光-高雄,2024-07-09,8562
6603,富強鑫,307,212,95,新光-高雄,2024-07-09,8562
2405,輔信,284,188,96,新光-高雄,2024-07-09,8562
1569,濱川,94,6,88,新光-高雄,2024-07-09,8562
5309,系統電,189,101,88,新光-高雄,2024-07-09,8562
2303,聯電,133,49,84,新光-高雄,2024-07-09,8562
00946,群益科技高息成長,86,18,68,新光-高雄,2024-07-09,8562
2349,錸德,98,31,67,新光-高雄,2024-07-09,8562
00686R,群益臺灣加權反1,65,0,65,新光-高雄,2024-07-09,8562
1718,中纖,68,6,62,新光-高雄,2024-07-09,8562
3019,亞光,93,31,62,新光-高雄,2024-07-09,8562
6116,彩晶,68,9,59,新光-高雄,2024-07-09,8562
2353,宏��,66,7,59,新光-高雄,2024-07-09,8562
00665L,富邦�琤肭磪囓�2,73,15,58,新光-高雄,2024-07-09,8562
4906,正文,130,74,56,新光-高雄,2024-07-09,8562
5864,致和證,64,10,54,新光-高雄,2024-07-09,8562
1309,台達化,54,1,53,新光-高雄,2024-07-09,8562
2367,燿華,551,498,53,新光-高雄,2024-07-09,8562
00733,富邦臺灣中小,53,1,52,新光-高雄,2024-07-09,8562
2618,長榮航,70,21,49,新光-高雄,2024-07-09,8562
6278,台表科,59,12,47,新光-高雄,2024-07-09,8562
9902,台火,49,2,47,新光-高雄,2024-07-09,8562
2330,台積電,75,29,46,新光-高雄,2024-07-09,8562
4533,協易機,100,54,46,新光-高雄,2024-07-09,8562
2354,鴻準,131,86,45,新光-高雄,2024-07-09,8562
2301,光寶科,66,21,45,新光-高雄,2024-07-09,8562
3047,訊舟,389,344,45,新光-高雄,2024-07-09,8562
00927,群益半導體收益,79,36,43,新光-高雄,2024-07-09,8562
3163,波若威,75,32,43,新光-高雄,2024-07-09,8562
1504,東元,46,4,42,新光-高雄,2024-07-09,8562
2801,彰銀,46,4,42,新光-高雄,2024-07-09,8562
3673,TPK-KY,147,105,42,新光-高雄,2024-07-09,8562
2610,華航,108,68,40,新光-高雄,2024-07-09,8562
2439,美律,43,7,36,新光-高雄,2024-07-09,8562
00753L,中信中國50正2,56,21,35,新光-高雄,2024-07-09,8562
8088,品安,35,0,35,新光-高雄,2024-07-09,8562
9938,百和,34,0,34,新光-高雄,2024-07-09,8562
2888,新光金,940,481,459,新光-高雄,2024-07-10,8562
00764B,群益25年美債,301,1,300,新光-高雄,2024-07-10,8562
00934,中信成長高股息,262,46,216,新光-高雄,2024-07-10,8562
00950B,凱基A級公司債,144,0,144,新光-高雄,2024-07-10,8562
00949,復華日本龍頭,127,0,127,新光-高雄,2024-07-10,8562
00927,群益半導體收益,158,31,127,新光-高雄,2024-07-10,8562
2317,鴻海,209,92,117,新光-高雄,2024-07-10,8562
912000,晨訊科-DR,137,20,117,新光-高雄,2024-07-10,8562
3042,晶技,102,3,99,新光-高雄,2024-07-10,8562
00878,國泰永續高股息,95,10,85,新光-高雄,2024-07-10,8562
4909,新復興,94,12,82,新光-高雄,2024-07-10,8562
6126,信音,131,55,76,新光-高雄,2024-07-10,8562
2002,中鋼,87,11,76,新光-高雄,2024-07-10,8562
1301,台塑,77,3,74,新光-高雄,2024-07-10,8562
2312,金寶,217,146,71,新光-高雄,2024-07-10,8562
00940,元大台灣價值高息,160,92,68,新光-高雄,2024-07-10,8562
2331,精英,76,10,66,新光-高雄,2024-07-10,8562
4979,華星光,82,25,57,新光-高雄,2024-07-10,8562
4510,高鋒,63,7,56,新光-高雄,2024-07-10,8562
4904,遠傳,63,7,56,新光-高雄,2024-07-10,8562
3466,德晉,60,7,53,新光-高雄,2024-07-10,8562
1609,大亞,96,44,52,新光-高雄,2024-07-10,8562
1909,榮成,50,0,50,新光-高雄,2024-07-10,8562
2897A,王道銀甲特,50,0,50,新光-高雄,2024-07-10,8562
00679B,元大美債20年,96,47,49,新光-高雄,2024-07-10,8562
3535,晶彩科,50,3,47,新光-高雄,2024-07-10,8562
00929,復華台灣科技優息,192,146,46,新光-高雄,2024-07-10,8562
00688L,國泰20年美債正2,60,14,46,新光-高雄,2024-07-10,8562
00687B,國泰20年美債,160,115,45,新光-高雄,2024-07-10,8562
2392,正崴,279,238,41,新光-高雄,2024-07-10,8562
2354,鴻準,98,59,39,新光-高雄,2024-07-10,8562
3712,永崴投控,77,38,39,新光-高雄,2024-07-10,8562
8105,凌巨,112,75,37,新光-高雄,2024-07-10,8562
5488,松普,35,1,34,新光-高雄,2024-07-10,8562
2543,皇昌,71,38,33,新光-高雄,2024-07-10,8562
1326,台化,34,2,32,新光-高雄,2024-07-10,8562
4533,協易機,33,3,30,新光-高雄,2024-07-10,8562
00895,富邦未來車,30,0,30,新光-高雄,2024-07-10,8562
3686,達能,31,2,29,新光-高雄,2024-07-10,8562
4958,臻鼎-KY,50,21,29,新光-高雄,2024-07-10,8562
2359,所羅門,74,45,29,新光-高雄,2024-07-10,8562
4534,慶騰,29,1,28,新光-高雄,2024-07-10,8562
00905,FT臺灣Smart,40,12,28,新光-高雄,2024-07-10,8562
1303,南亞,30,2,28,新光-高雄,2024-07-10,8562
00680L,元大美債20正2,94,67,27,新光-高雄,2024-07-10,8562
2606,裕民,30,3,27,新光-高雄,2024-07-10,8562
6244,茂迪,58,31,27,新光-高雄,2024-07-10,8562
00882,中信中國高股息,34,10,24,新光-高雄,2024-07-10,8562
3047,訊舟,195,171,24,新光-高雄,2024-07-10,8562
4588,玖鼎電力,27,4,23,新光-高雄,2024-07-10,8562
00680L,元大美債20正2,498,26,472,新光-高雄,2024-07-11,8562
2888,新光金,545,136,409,新光-高雄,2024-07-11,8562
2356,英業達,563,256,307,新光-高雄,2024-07-11,8562
00632R,元大台灣50反1,437,166,271,新光-高雄,2024-07-11,8562
1314,中石化,221,1,220,新光-高雄,2024-07-11,8562
00934,中信成長高股息,229,35,194,新光-高雄,2024-07-11,8562
2515,中工,180,45,135,新光-高雄,2024-07-11,8562
00687B,國泰20年美債,163,35,128,新光-高雄,2024-07-11,8562
8011,台通,348,220,128,新光-高雄,2024-07-11,8562
2323,中環,124,6,118,新光-高雄,2024-07-11,8562
00936,台新永續高息中小,128,11,117,新光-高雄,2024-07-11,8562
2303,聯電,145,35,110,新光-高雄,2024-07-11,8562
2610,華航,262,157,105,新光-高雄,2024-07-11,8562
6153,嘉聯益,111,15,96,新光-高雄,2024-07-11,8562
2365,昆盈,354,260,94,新光-高雄,2024-07-11,8562
00937B,群益ESG投等債20,117,25,92,新光-高雄,2024-07-11,8562
3663,鑫科,97,9,88,新光-高雄,2024-07-11,8562
2002,中鋼,122,45,77,新光-高雄,2024-07-11,8562
6163,華電網,137,61,76,新光-高雄,2024-07-11,8562
2537,聯上發,145,73,72,新光-高雄,2024-07-11,8562
2618,長榮航,153,83,70,新光-高雄,2024-07-11,8562
2801,彰銀,81,13,68,新光-高雄,2024-07-11,8562
00673R,期元大S＆P原油反1,60,0,60,新光-高雄,2024-07-11,8562
2542,興富發,80,20,60,新光-高雄,2024-07-11,8562
1101,台泥,85,27,58,新光-高雄,2024-07-11,8562
1447,力鵬,90,36,54,新光-高雄,2024-07-11,8562
3050,鈺德,181,133,48,新光-高雄,2024-07-11,8562
00679B,元大美債20年,56,8,48,新光-高雄,2024-07-11,8562
3594,磐儀,66,19,47,新光-高雄,2024-07-11,8562
00927,群益半導體收益,49,4,45,新光-高雄,2024-07-11,8562
1309,台達化,51,6,45,新光-高雄,2024-07-11,8562
2449,京元電子,60,17,43,新光-高雄,2024-07-11,8562
1504,東元,44,4,40,新光-高雄,2024-07-11,8562
1612,宏泰,41,1,40,新光-高雄,2024-07-11,8562
1532,勤美,41,2,39,新光-高雄,2024-07-11,8562
1514,亞力,124,86,38,新光-高雄,2024-07-11,8562
0056,元大高股息,62,25,37,新光-高雄,2024-07-11,8562
2617,台航,39,3,36,新光-高雄,2024-07-11,8562
5512,力麒,35,0,35,新光-高雄,2024-07-11,8562
5905,南仁湖,39,4,35,新光-高雄,2024-07-11,8562
9902,台火,35,1,34,新光-高雄,2024-07-11,8562
2392,正崴,118,85,33,新光-高雄,2024-07-11,8562
00945B,凱基美國非投等債,43,10,33,新光-高雄,2024-07-11,8562
2408,南亞科,77,45,32,新光-高雄,2024-07-11,8562
1303,南亞,56,24,32,新光-高雄,2024-07-11,8562
3450,聯鈞,128,96,32,新光-高雄,2024-07-11,8562
8086,宏捷科,35,3,32,新光-高雄,2024-07-11,8562
2388,威盛,53,21,32,新光-高雄,2024-07-11,8562
6596,寬宏藝術,30,0,30,新光-高雄,2024-07-11,8562
2342,茂矽,33,3,30,新光-高雄,2024-07-11,8562
00934,中信成長高股息,826,96,730,新光-高雄,2024-07-12,8562
00929,復華台灣科技優息,770,200,570,新光-高雄,2024-07-12,8562
00680L,元大美債20正2,725,408,317,新光-高雄,2024-07-12,8562
2867,三商壽,443,185,258,新光-高雄,2024-07-12,8562
2515,中工,332,121,211,新光-高雄,2024-07-12,8562
1718,中纖,202,40,162,新光-高雄,2024-07-12,8562
2303,聯電,173,14,159,新光-高雄,2024-07-12,8562
2317,鴻海,342,190,152,新光-高雄,2024-07-12,8562
00940,元大台灣價值高息,173,35,138,新光-高雄,2024-07-12,8562
00937B,群益ESG投等債20,427,294,133,新光-高雄,2024-07-12,8562
2534,宏盛,126,0,126,新光-高雄,2024-07-12,8562
00927,群益半導體收益,137,18,119,新光-高雄,2024-07-12,8562
00881,國泰台灣5G+,109,17,92,新光-高雄,2024-07-12,8562
2365,昆盈,404,314,90,新光-高雄,2024-07-12,8562
6120,達運,90,2,88,新光-高雄,2024-07-12,8562
00688L,國泰20年美債正2,112,26,86,新光-高雄,2024-07-12,8562
2312,金寶,429,347,82,新光-高雄,2024-07-12,8562
5202,力新,126,52,74,新光-高雄,2024-07-12,8562
2330,台積電,100,29,71,新光-高雄,2024-07-12,8562
00936,台新永續高息中小,77,11,66,新光-高雄,2024-07-12,8562
8011,台通,85,27,58,新光-高雄,2024-07-12,8562
3189,景碩,200,143,57,新光-高雄,2024-07-12,8562
3535,晶彩科,99,47,52,新光-高雄,2024-07-12,8562
1316,上曜,159,109,50,新光-高雄,2024-07-12,8562
2897A,王道銀甲特,50,0,50,新光-高雄,2024-07-12,8562
00945B,凱基美國非投等債,52,2,50,新光-高雄,2024-07-12,8562
6005,群益證,82,42,40,新光-高雄,2024-07-12,8562
2606,裕民,38,0,38,新光-高雄,2024-07-12,8562
00935,野村臺灣新科技50,38,1,37,新光-高雄,2024-07-12,8562
2313,華通,62,25,37,新光-高雄,2024-07-12,8562
0056,元大高股息,70,33,37,新光-高雄,2024-07-12,8562
006208,富邦台50,43,7,36,新光-高雄,2024-07-12,8562
00946,群益科技高息成長,47,11,36,新光-高雄,2024-07-12,8562
2049,上銀,67,32,35,新光-高雄,2024-07-12,8562
3037,欣興,123,88,35,新光-高雄,2024-07-12,8562
00891,中信關鍵半導體,73,38,35,新光-高雄,2024-07-12,8562
3231,緯創,42,9,33,新光-高雄,2024-07-12,8562
1617,榮星,66,33,33,新光-高雄,2024-07-12,8562
2618,長榮航,101,68,33,新光-高雄,2024-07-12,8562
9906,欣巴巴,35,3,32,新光-高雄,2024-07-12,8562
3090,日電貿,32,0,32,新光-高雄,2024-07-12,8562
00725B,國泰投資級公司債,30,0,30,新光-高雄,2024-07-12,8562
6112,邁達特,34,4,30,新光-高雄,2024-07-12,8562
00892,富邦台灣半導體,29,0,29,新光-高雄,2024-07-12,8562
2406,國碩,118,90,28,新光-高雄,2024-07-12,8562
1815,富喬,71,43,28,新光-高雄,2024-07-12,8562
4532,瑞智,35,7,28,新光-高雄,2024-07-12,8562
5498,凱崴,33,5,28,新光-高雄,2024-07-12,8562
0050,元大台灣50,35,7,28,新光-高雄,2024-07-12,8562
5512,力麒,35,7,28,新光-高雄,2024-07-12,8562
00632R,元大台灣50反1,4936,18,4918,新光-高雄,2024-07-15,8562
00687B,國泰20年美債,1485,40,1445,新光-高雄,2024-07-15,8562
00937B,群益ESG投等債20,482,17,465,新光-高雄,2024-07-15,8562
00929,復華台灣科技優息,420,72,348,新光-高雄,2024-07-15,8562
00934,中信成長高股息,282,27,255,新光-高雄,2024-07-15,8562
00680L,元大美債20正2,293,72,221,新光-高雄,2024-07-15,8562
2891,中信金,243,25,218,新光-高雄,2024-07-15,8562
00679B,元大美債20年,195,34,161,新光-高雄,2024-07-15,8562
00945B,凱基美國非投等債,157,0,157,新光-高雄,2024-07-15,8562
912000,晨訊科-DR,152,10,142,新光-高雄,2024-07-15,8562
2888,新光金,482,349,133,新光-高雄,2024-07-15,8562
1536,和大,215,98,117,新光-高雄,2024-07-15,8562
00688L,國泰20年美債正2,124,18,106,新光-高雄,2024-07-15,8562
3019,亞光,161,68,93,新光-高雄,2024-07-15,8562
2312,金寶,449,358,91,新光-高雄,2024-07-15,8562
00650L,復華香港正2,128,37,91,新光-高雄,2024-07-15,8562
3535,晶彩科,283,200,83,新光-高雄,2024-07-15,8562
6015,宏遠證,83,0,83,新光-高雄,2024-07-15,8562
1608,華榮,277,197,80,新光-高雄,2024-07-15,8562
6005,群益證,79,0,79,新光-高雄,2024-07-15,8562
6603,富強鑫,96,18,78,新光-高雄,2024-07-15,8562
00936,台新永續高息中小,82,4,78,新光-高雄,2024-07-15,8562
2489,瑞軒,418,344,74,新光-高雄,2024-07-15,8562
2834,臺企銀,74,4,70,新光-高雄,2024-07-15,8562
0056,元大高股息,106,37,69,新光-高雄,2024-07-15,8562
5309,系統電,74,11,63,新光-高雄,2024-07-15,8562
5202,力新,73,10,63,新光-高雄,2024-07-15,8562
8105,凌巨,116,54,62,新光-高雄,2024-07-15,8562
00919,群益台灣精選高息,150,98,52,新光-高雄,2024-07-15,8562
4960,誠美材,75,24,51,新光-高雄,2024-07-15,8562
2406,國碩,58,12,46,新光-高雄,2024-07-15,8562
4153,鈺緯,46,0,46,新光-高雄,2024-07-15,8562
2049,上銀,60,16,44,新光-高雄,2024-07-15,8562
2070,精湛,45,1,44,新光-高雄,2024-07-15,8562
1409,新纖,45,2,43,新光-高雄,2024-07-15,8562
2913,農林,57,14,43,新光-高雄,2024-07-15,8562
5469,瀚宇博,44,1,43,新光-高雄,2024-07-15,8562
00878,國泰永續高股息,65,23,42,新光-高雄,2024-07-15,8562
9945,潤泰新,69,29,40,新光-高雄,2024-07-15,8562
1314,中石化,40,2,38,新光-高雄,2024-07-15,8562
1718,中纖,67,30,37,新光-高雄,2024-07-15,8562
2606,裕民,36,1,35,新光-高雄,2024-07-15,8562
6570,維田,49,14,35,新光-高雄,2024-07-15,8562
3710,連展投控,39,6,33,新光-高雄,2024-07-15,8562
6770,力積電,73,40,33,新光-高雄,2024-07-15,8562
00673R,期元大S＆P原油反1,32,0,32,新光-高雄,2024-07-15,8562
9902,台火,33,1,32,新光-高雄,2024-07-15,8562
6214,精誠,33,2,31,新光-高雄,2024-07-15,8562
4729,熒茂,30,0,30,新光-高雄,2024-07-15,8562
5512,力麒,30,0,30,新光-高雄,2024-07-15,8562
00937B,群益ESG投等債20,635,101,534,新光-高雄,2024-07-16,8562
1316,上曜,384,133,251,新光-高雄,2024-07-16,8562
00934,中信成長高股息,205,0,205,新光-高雄,2024-07-16,8562
00905,FT臺灣Smart,170,2,168,新光-高雄,2024-07-16,8562
00919,群益台灣精選高息,194,36,158,新光-高雄,2024-07-16,8562
00933B,國泰10Y+金融債,160,13,147,新光-高雄,2024-07-16,8562
3294,英濟,209,66,143,新光-高雄,2024-07-16,8562
00950B,凱基A級公司債,119,0,119,新光-高雄,2024-07-16,8562
00882,中信中國高股息,129,23,106,新光-高雄,2024-07-16,8562
8039,台虹,100,1,99,新光-高雄,2024-07-16,8562
00688L,國泰20年美債正2,111,28,83,新光-高雄,2024-07-16,8562
2515,中工,101,18,83,新光-高雄,2024-07-16,8562
0056,元大高股息,171,90,81,新光-高雄,2024-07-16,8562
00946,群益科技高息成長,80,0,80,新光-高雄,2024-07-16,8562
3481,群創,132,54,78,新光-高雄,2024-07-16,8562
2049,上銀,79,5,74,新光-高雄,2024-07-16,8562
00936,台新永續高息中小,85,12,73,新光-高雄,2024-07-16,8562
2891,中信金,77,15,62,新光-高雄,2024-07-16,8562
00706L,期元大S＆P日圓正2,62,0,62,新光-高雄,2024-07-16,8562
2317,鴻海,110,52,58,新光-高雄,2024-07-16,8562
2867,三商壽,152,95,57,新光-高雄,2024-07-16,8562
6005,群益證,150,96,54,新光-高雄,2024-07-16,8562
1536,和大,93,39,54,新光-高雄,2024-07-16,8562
00664R,國泰臺灣加權反1,50,0,50,新光-高雄,2024-07-16,8562
8936,國統,82,34,48,新光-高雄,2024-07-16,8562
00930,永豐ESG低碳高息,46,0,46,新光-高雄,2024-07-16,8562
9906,欣巴巴,54,9,45,新光-高雄,2024-07-16,8562
1303,南亞,47,2,45,新光-高雄,2024-07-16,8562
00753L,中信中國50正2,45,2,43,新光-高雄,2024-07-16,8562
00929,復華台灣科技優息,294,254,40,新光-高雄,2024-07-16,8562
2353,宏��,109,71,38,新光-高雄,2024-07-16,8562
6188,廣明,41,3,38,新光-高雄,2024-07-16,8562
2356,英業達,82,45,37,新光-高雄,2024-07-16,8562
2363,矽統,123,86,37,新光-高雄,2024-07-16,8562
2303,聯電,48,12,36,新光-高雄,2024-07-16,8562
2615,萬海,94,58,36,新光-高雄,2024-07-16,8562
1532,勤美,40,5,35,新光-高雄,2024-07-16,8562
3686,達能,34,0,34,新光-高雄,2024-07-16,8562
3545,敦泰,46,13,33,新光-高雄,2024-07-16,8562
2312,金寶,264,232,32,新光-高雄,2024-07-16,8562
2070,精湛,54,22,32,新光-高雄,2024-07-16,8562
6443,元晶,42,11,31,新光-高雄,2024-07-16,8562
5202,力新,38,7,31,新光-高雄,2024-07-16,8562
2610,華航,43,12,31,新光-高雄,2024-07-16,8562
1319,東陽,34,4,30,新光-高雄,2024-07-16,8562
4109,加捷生醫,58,29,29,新光-高雄,2024-07-16,8562
00927,群益半導體收益,29,1,28,新光-高雄,2024-07-16,8562
6191,精成科,28,1,27,新光-高雄,2024-07-16,8562
8021,尖點,33,6,27,新光-高雄,2024-07-16,8562
00665L,富邦�琤肭磪囓�2,42,15,27,新光-高雄,2024-07-16,8562
00929,復華台灣科技優息,851,82,769,新光-高雄,2024-07-17,8562
00937B,群益ESG投等債20,666,43,623,新光-高雄,2024-07-17,8562
00687B,國泰20年美債,643,111,532,新光-高雄,2024-07-17,8562
00919,群益台灣精選高息,379,32,347,新光-高雄,2024-07-17,8562
00940,元大台灣價值高息,295,76,219,新光-高雄,2024-07-17,8562
0056,元大高股息,161,17,144,新光-高雄,2024-07-17,8562
00934,中信成長高股息,175,43,132,新光-高雄,2024-07-17,8562
912000,晨訊科-DR,131,0,131,新光-高雄,2024-07-17,8562
1708,東鹼,124,0,124,新光-高雄,2024-07-17,8562
00878,國泰永續高股息,126,7,119,新光-高雄,2024-07-17,8562
00669R,國泰美國道瓊反1,127,30,97,新光-高雄,2024-07-17,8562
00715L,期街口布蘭特正2,97,2,95,新光-高雄,2024-07-17,8562
00936,台新永續高息中小,100,7,93,新光-高雄,2024-07-17,8562
3711,日月光投控,124,32,92,新光-高雄,2024-07-17,8562
2312,金寶,224,139,85,新光-高雄,2024-07-17,8562
00882,中信中國高股息,80,11,69,新光-高雄,2024-07-17,8562
5512,力麒,375,307,68,新光-高雄,2024-07-17,8562
1609,大亞,329,263,66,新光-高雄,2024-07-17,8562
2101,南港,64,8,56,新光-高雄,2024-07-17,8562
2891,中信金,64,9,55,新光-高雄,2024-07-17,8562
00753L,中信中國50正2,52,0,52,新光-高雄,2024-07-17,8562
3231,緯創,81,30,51,新光-高雄,2024-07-17,8562
2489,瑞軒,172,121,51,新光-高雄,2024-07-17,8562
6770,力積電,140,92,48,新光-高雄,2024-07-17,8562
2887,台新金,54,8,46,新光-高雄,2024-07-17,8562
1101,台泥,65,21,44,新光-高雄,2024-07-17,8562
2547,日勝生,45,3,42,新光-高雄,2024-07-17,8562
2330,台積電,61,20,41,新光-高雄,2024-07-17,8562
00945B,凱基美國非投等債,41,0,41,新光-高雄,2024-07-17,8562
2801,彰銀,39,1,38,新光-高雄,2024-07-17,8562
2897,王道銀行,50,12,38,新光-高雄,2024-07-17,8562
2374,佳能,42,5,37,新光-高雄,2024-07-17,8562
00881,國泰台灣5G+,37,0,37,新光-高雄,2024-07-17,8562
2867,三商壽,101,64,37,新光-高雄,2024-07-17,8562
2845,遠東銀,38,2,36,新光-高雄,2024-07-17,8562
2888,新光金,94,60,34,新光-高雄,2024-07-17,8562
6117,迎廣,108,74,34,新光-高雄,2024-07-17,8562
00927,群益半導體收益,119,86,33,新光-高雄,2024-07-17,8562
00918,大華優利高填息30,43,11,32,新光-高雄,2024-07-17,8562
2537,聯上發,384,352,32,新光-高雄,2024-07-17,8562
3710,連展投控,38,6,32,新光-高雄,2024-07-17,8562
3706,神達,68,37,31,新光-高雄,2024-07-17,8562
2618,長榮航,44,15,29,新光-高雄,2024-07-17,8562
00946,群益科技高息成長,54,24,30,新光-高雄,2024-07-17,8562
00923,群益台ESG低碳50,29,0,29,新光-高雄,2024-07-17,8562
2376,技嘉,40,11,29,新光-高雄,2024-07-17,8562
2317,鴻海,64,35,29,新光-高雄,2024-07-17,8562
006208,富邦台50,33,5,28,新光-高雄,2024-07-17,8562
2382,廣達,39,12,27,新光-高雄,2024-07-17,8562
3050,鈺德,70,43,27,新光-高雄,2024-07-17,8562
00940,元大台灣價值高息,773,197,576,新光-高雄,2024-07-18,8562
00937B,群益ESG投等債20,631,99,532,新光-高雄,2024-07-18,8562
00929,復華台灣科技優息,957,462,495,新光-高雄,2024-07-18,8562
00919,群益台灣精選高息,456,143,313,新光-高雄,2024-07-18,8562
00673R,期元大S＆P原油反1,181,0,181,新光-高雄,2024-07-18,8562
00878,國泰永續高股息,231,68,163,新光-高雄,2024-07-18,8562
0056,元大高股息,190,47,143,新光-高雄,2024-07-18,8562
00934,中信成長高股息,178,50,128,新光-高雄,2024-07-18,8562
00936,台新永續高息中小,151,36,115,新光-高雄,2024-07-18,8562
00927,群益半導體收益,124,17,107,新光-高雄,2024-07-18,8562
2881,富邦金,112,13,99,新光-高雄,2024-07-18,8562
2317,鴻海,196,100,96,新光-高雄,2024-07-18,8562
2356,英業達,134,44,90,新光-高雄,2024-07-18,8562
6127,九豪,84,3,81,新光-高雄,2024-07-18,8562
1540,喬福,130,51,79,新光-高雄,2024-07-18,8562
8105,凌巨,310,235,75,新光-高雄,2024-07-18,8562
2330,台積電,106,34,72,新光-高雄,2024-07-18,8562
6492,生華科,95,25,70,新光-高雄,2024-07-18,8562
2344,華邦電,78,8,70,新光-高雄,2024-07-18,8562
2365,昆盈,976,906,70,新光-高雄,2024-07-18,8562
6116,彩晶,68,0,68,新光-高雄,2024-07-18,8562
9955,佳龍,119,58,61,新光-高雄,2024-07-18,8562
3230,錦明,69,12,57,新光-高雄,2024-07-18,8562
00918,大華優利高填息30,75,19,56,新光-高雄,2024-07-18,8562
00631L,元大台灣50正2,78,22,56,新光-高雄,2024-07-18,8562
00881,國泰台灣5G+,70,16,54,新光-高雄,2024-07-18,8562
3481,群創,296,244,52,新光-高雄,2024-07-18,8562
2409,友達,94,42,52,新光-高雄,2024-07-18,8562
2204,中華,54,3,51,新光-高雄,2024-07-18,8562
2362,藍天,140,92,48,新光-高雄,2024-07-18,8562
00946,群益科技高息成長,101,53,48,新光-高雄,2024-07-18,8562
6770,力積電,64,18,46,新光-高雄,2024-07-18,8562
3581,博磊,71,25,46,新光-高雄,2024-07-18,8562
1611,中電,86,42,44,新光-高雄,2024-07-18,8562
3231,緯創,53,9,44,新光-高雄,2024-07-18,8562
4968,立積,53,10,43,新光-高雄,2024-07-18,8562
2891,中信金,58,15,43,新光-高雄,2024-07-18,8562
5469,瀚宇博,42,0,42,新光-高雄,2024-07-18,8562
1101,台泥,99,57,42,新光-高雄,2024-07-18,8562
2888,新光金,146,104,42,新光-高雄,2024-07-18,8562
1402,遠東新,48,8,40,新光-高雄,2024-07-18,8562
00930,永豐ESG低碳高息,40,1,39,新光-高雄,2024-07-18,8562
6443,元晶,54,15,39,新光-高雄,2024-07-18,8562
3062,建漢,102,63,39,新光-高雄,2024-07-18,8562
3518,柏騰,79,41,38,新光-高雄,2024-07-18,8562
2481,強茂,39,1,38,新光-高雄,2024-07-18,8562
2542,興富發,60,24,36,新光-高雄,2024-07-18,8562
2610,華航,115,79,36,新光-高雄,2024-07-18,8562
1471,首利,35,0,35,新光-高雄,2024-07-18,8562
2609,陽明,50,15,35,新光-高雄,2024-07-18,8562
00929,復華台灣科技優息,781,148,633,新光-高雄,2024-07-19,8562
00919,群益台灣精選高息,454,98,356,新光-高雄,2024-07-19,8562
00937B,群益ESG投等債20,369,46,323,新光-高雄,2024-07-19,8562
0056,元大高股息,340,19,321,新光-高雄,2024-07-19,8562
2915,潤泰全,277,8,269,新光-高雄,2024-07-19,8562
00878,國泰永續高股息,270,31,239,新光-高雄,2024-07-19,8562
6603,富強鑫,329,129,200,新光-高雄,2024-07-19,8562
2888,新光金,452,265,187,新光-高雄,2024-07-19,8562
00680L,元大美債20正2,280,94,186,新光-高雄,2024-07-19,8562
00679B,元大美債20年,279,119,160,新光-高雄,2024-07-19,8562
2867,三商壽,220,60,160,新光-高雄,2024-07-19,8562
00940,元大台灣價值高息,199,57,142,新光-高雄,2024-07-19,8562
5512,力麒,426,288,138,新光-高雄,2024-07-19,8562
2891,中信金,144,11,133,新光-高雄,2024-07-19,8562
2330,台積電,165,47,118,新光-高雄,2024-07-19,8562
00664R,國泰臺灣加權反1,100,1,99,新光-高雄,2024-07-19,8562
00946,群益科技高息成長,109,14,95,新光-高雄,2024-07-19,8562
00936,台新永續高息中小,100,13,87,新光-高雄,2024-07-19,8562
00918,大華優利高填息30,161,76,85,新光-高雄,2024-07-19,8562
3049,精金,85,2,83,新光-高雄,2024-07-19,8562
4513,福裕,118,37,81,新光-高雄,2024-07-19,8562
00934,中信成長高股息,132,52,80,新光-高雄,2024-07-19,8562
00650L,復華香港正2,80,0,80,新光-高雄,2024-07-19,8562
6116,彩晶,85,5,80,新光-高雄,2024-07-19,8562
2880,華南金,82,5,77,新光-高雄,2024-07-19,8562
00715L,期街口布蘭特正2,75,1,74,新光-高雄,2024-07-19,8562
3481,群創,202,129,73,新光-高雄,2024-07-19,8562
8240,華宏,70,0,70,新光-高雄,2024-07-19,8562
2356,英業達,106,39,67,新光-高雄,2024-07-19,8562
00665L,富邦�琤肭磪囓�2,105,38,67,新光-高雄,2024-07-19,8562
2705,六福,75,10,65,新光-高雄,2024-07-19,8562
00713,元大台灣高息低波,70,6,64,新光-高雄,2024-07-19,8562
2883,凱基金,72,12,60,新光-高雄,2024-07-19,8562
00631L,元大台灣50正2,89,31,58,新光-高雄,2024-07-19,8562
3576,聯合再生,89,32,57,新光-高雄,2024-07-19,8562
2243,宏旭-KY,64,7,57,新光-高雄,2024-07-19,8562
00927,群益半導體收益,108,52,56,新光-高雄,2024-07-19,8562
2204,中華,60,4,56,新光-高雄,2024-07-19,8562
00915,凱基優選高股息30,58,3,55,新光-高雄,2024-07-19,8562
3450,聯鈞,101,46,55,新光-高雄,2024-07-19,8562
2474,可成,69,15,54,新光-高雄,2024-07-19,8562
00706L,期元大S＆P日圓正2,60,10,50,新光-高雄,2024-07-19,8562
2801,彰銀,79,30,49,新光-高雄,2024-07-19,8562
2913,農林,56,12,44,新光-高雄,2024-07-19,8562
2002,中鋼,50,10,40,新光-高雄,2024-07-19,8562
912000,晨訊科-DR,40,0,40,新光-高雄,2024-07-19,8562
00675L,富邦臺灣加權正2,66,26,40,新光-高雄,2024-07-19,8562
00753L,中信中國50正2,41,3,38,新光-高雄,2024-07-19,8562
2402,毅嘉,96,59,37,新光-高雄,2024-07-19,8562
2812,台中銀,51,14,37,新光-高雄,2024-07-19,8562
00946,群益科技高息成長,615,23,592,新光-高雄,2024-07-22,8562
00940,元大台灣價值高息,706,146,560,新光-高雄,2024-07-22,8562
00881,國泰台灣5G+,561,49,512,新光-高雄,2024-07-22,8562
00919,群益台灣精選高息,665,202,463,新光-高雄,2024-07-22,8562
00680L,元大美債20正2,679,306,373,新光-高雄,2024-07-22,8562
3481,群創,442,121,321,新光-高雄,2024-07-22,8562
0056,元大高股息,247,59,188,新光-高雄,2024-07-22,8562
00715L,期街口布蘭特正2,149,1,148,新光-高雄,2024-07-22,8562
00878,國泰永續高股息,268,120,148,新光-高雄,2024-07-22,8562
00637L,元大滬深300正2,189,43,146,新光-高雄,2024-07-22,8562
00942B,台新美A公司債20+,119,0,119,新光-高雄,2024-07-22,8562
00936,台新永續高息中小,220,109,111,新光-高雄,2024-07-22,8562
00631L,元大台灣50正2,121,16,105,新光-高雄,2024-07-22,8562
5512,力麒,579,474,105,新光-高雄,2024-07-22,8562
8112,至上,109,5,104,新光-高雄,2024-07-22,8562
2834,臺企銀,132,28,104,新光-高雄,2024-07-22,8562
2356,英業達,228,131,97,新光-高雄,2024-07-22,8562
00929,復華台灣科技優息,1402,1311,91,新光-高雄,2024-07-22,8562
1529,樂事綠能,146,66,80,新光-高雄,2024-07-22,8562
00944,野村趨勢動能高息,82,4,78,新光-高雄,2024-07-22,8562
2402,毅嘉,160,84,76,新光-高雄,2024-07-22,8562
2303,聯電,85,16,69,新光-高雄,2024-07-22,8562
00923,群益台ESG低碳50,66,10,56,新光-高雄,2024-07-22,8562
00675L,富邦臺灣加權正2,78,24,54,新光-高雄,2024-07-22,8562
2888,新光金,239,186,53,新光-高雄,2024-07-22,8562
00915,凱基優選高股息30,88,38,50,新光-高雄,2024-07-22,8562
00664R,國泰臺灣加權反1,160,110,50,新光-高雄,2024-07-22,8562
2409,友達,90,43,47,新光-高雄,2024-07-22,8562
8473,山林水,151,104,47,新光-高雄,2024-07-22,8562
5309,系統電,174,129,45,新光-高雄,2024-07-22,8562
3312,弘憶股,71,28,43,新光-高雄,2024-07-22,8562
4532,瑞智,45,3,42,新光-高雄,2024-07-22,8562
2442,新美齊,42,1,41,新光-高雄,2024-07-22,8562
2317,鴻海,237,197,40,新光-高雄,2024-07-22,8562
0050,元大台灣50,58,18,40,新光-高雄,2024-07-22,8562
6244,茂迪,72,32,40,新光-高雄,2024-07-22,8562
00905,FT臺灣Smart,50,10,40,新光-高雄,2024-07-22,8562
1714,和桐,40,1,39,新光-高雄,2024-07-22,8562
6005,群益證,49,11,38,新光-高雄,2024-07-22,8562
9902,台火,38,0,38,新光-高雄,2024-07-22,8562
1611,中電,108,71,37,新光-高雄,2024-07-22,8562
5864,致和證,37,0,37,新光-高雄,2024-07-22,8562
2344,華邦電,65,29,36,新光-高雄,2024-07-22,8562
2913,農林,60,25,35,新光-高雄,2024-07-22,8562
00733,富邦臺灣中小,36,2,34,新光-高雄,2024-07-22,8562
3049,精金,55,21,34,新光-高雄,2024-07-22,8562
6548,長科*,39,6,33,新光-高雄,2024-07-22,8562
00713,元大台灣高息低波,41,8,33,新光-高雄,2024-07-22,8562
912000,晨訊科-DR,32,0,32,新光-高雄,2024-07-22,8562
3576,聯合再生,39,8,31,新光-高雄,2024-07-22,8562
00632R,元大台灣50反1,1071,407,664,新光-高雄,2024-07-23,8562
8112,至上,336,2,334,新光-高雄,2024-07-23,8562
00929,復華台灣科技優息,480,166,314,新光-高雄,2024-07-23,8562
00937B,群益ESG投等債20,373,115,258,新光-高雄,2024-07-23,8562
2891,中信金,353,112,241,新光-高雄,2024-07-23,8562
2888,新光金,302,66,236,新光-高雄,2024-07-23,8562
00919,群益台灣精選高息,198,37,161,新光-高雄,2024-07-23,8562
2812,台中銀,148,8,140,新光-高雄,2024-07-23,8562
00680L,元大美債20正2,174,40,134,新光-高雄,2024-07-23,8562
00934,中信成長高股息,139,8,131,新光-高雄,2024-07-23,8562
00679B,元大美債20年,144,16,128,新光-高雄,2024-07-23,8562
00918,大華優利高填息30,134,14,120,新光-高雄,2024-07-23,8562
9105,泰金寶-DR,286,171,115,新光-高雄,2024-07-23,8562
2409,友達,140,27,113,新光-高雄,2024-07-23,8562
00715L,期街口布蘭特正2,94,0,94,新光-高雄,2024-07-23,8562
1314,中石化,76,1,75,新光-高雄,2024-07-23,8562
6005,群益證,119,44,75,新光-高雄,2024-07-23,8562
00946,群益科技高息成長,87,13,74,新光-高雄,2024-07-23,8562
0056,元大高股息,92,19,73,新光-高雄,2024-07-23,8562
2408,南亞科,79,14,65,新光-高雄,2024-07-23,8562
2511,太子,65,1,64,新光-高雄,2024-07-23,8562
1477,聚陽,51,1,50,新光-高雄,2024-07-23,8562
1402,遠東新,51,1,50,新光-高雄,2024-07-23,8562
00940,元大台灣價值高息,193,145,48,新光-高雄,2024-07-23,8562
2317,鴻海,151,104,47,新光-高雄,2024-07-23,8562
5871,中租-KY,62,15,47,新光-高雄,2024-07-23,8562
2489,瑞軒,67,25,42,新光-高雄,2024-07-23,8562
2405,輔信,43,2,41,新光-高雄,2024-07-23,8562
6788,華景電,41,1,40,新光-高雄,2024-07-23,8562
00878,國泰永續高股息,62,22,40,新光-高雄,2024-07-23,8562
4526,東台,41,2,39,新光-高雄,2024-07-23,8562
8440,綠電,95,59,36,新光-高雄,2024-07-23,8562
00935,野村臺灣新科技50,35,2,33,新光-高雄,2024-07-23,8562
5512,力麒,206,175,31,新光-高雄,2024-07-23,8562
5443,均豪,127,97,30,新光-高雄,2024-07-23,8562
5905,南仁湖,33,3,30,新光-高雄,2024-07-23,8562
5522,遠雄,38,9,29,新光-高雄,2024-07-23,8562
1316,上曜,50,22,28,新光-高雄,2024-07-23,8562
1309,台達化,32,5,27,新光-高雄,2024-07-23,8562
3663,鑫科,74,47,27,新光-高雄,2024-07-23,8562
2836,高雄銀,30,4,26,新光-高雄,2024-07-23,8562
6125,廣運,31,5,26,新光-高雄,2024-07-23,8562
00795B,中信美國公債20年,25,0,25,新光-高雄,2024-07-23,8562
00751B,元大AAA至A公司債,28,3,25,新光-高雄,2024-07-23,8562
3047,訊舟,60,35,25,新光-高雄,2024-07-23,8562
2359,所羅門,73,50,23,新光-高雄,2024-07-23,8562
2605,新興,43,20,23,新光-高雄,2024-07-23,8562
1786,科妍,23,0,23,新光-高雄,2024-07-23,8562
2349,錸德,34,13,21,新光-高雄,2024-07-23,8562
1301,台塑,26,6,20,新光-高雄,2024-07-23,8562
00637L,元大滬深300正2,557,34,523,新光-高雄,2024-07-26,8562
00929,復華台灣科技優息,800,307,493,新光-高雄,2024-07-26,8562
00937B,群益ESG投等債20,633,194,439,新光-高雄,2024-07-26,8562
00878,國泰永續高股息,450,19,431,新光-高雄,2024-07-26,8562
00940,元大台灣價值高息,309,81,228,新光-高雄,2024-07-26,8562
00919,群益台灣精選高息,357,142,215,新光-高雄,2024-07-26,8562
00680L,元大美債20正2,306,130,176,新光-高雄,2024-07-26,8562
2884,玉山金,188,12,176,新光-高雄,2024-07-26,8562
00942B,台新美A公司債20+,133,0,133,新光-高雄,2024-07-26,8562
0056,元大高股息,164,32,132,新光-高雄,2024-07-26,8562
2330,台積電,181,57,124,新光-高雄,2024-07-26,8562
2883,凱基金,128,15,113,新光-高雄,2024-07-26,8562
00918,大華優利高填息30,99,4,95,新光-高雄,2024-07-26,8562
2317,鴻海,152,58,94,新光-高雄,2024-07-26,8562
1101,台泥,99,10,89,新光-高雄,2024-07-26,8562
00688L,國泰20年美債正2,146,60,86,新光-高雄,2024-07-26,8562
3711,日月光投控,94,12,82,新光-高雄,2024-07-26,8562
00753L,中信中國50正2,109,33,76,新光-高雄,2024-07-26,8562
9105,泰金寶-DR,75,0,75,新光-高雄,2024-07-26,8562
6213,聯茂,76,11,65,新光-高雄,2024-07-26,8562
00679B,元大美債20年,163,98,65,新光-高雄,2024-07-26,8562
4566,時碩工業,102,38,64,新光-高雄,2024-07-26,8562
00665L,富邦�琤肭磪囓�2,107,43,64,新光-高雄,2024-07-26,8562
2834,臺企銀,68,6,62,新光-高雄,2024-07-26,8562
2812,台中銀,74,16,58,新光-高雄,2024-07-26,8562
6116,彩晶,57,0,57,新光-高雄,2024-07-26,8562
0050,元大台灣50,82,29,53,新光-高雄,2024-07-26,8562
1314,中石化,56,6,50,新光-高雄,2024-07-26,8562
00631L,元大台灣50正2,75,28,47,新光-高雄,2024-07-26,8562
00795B,中信美國公債20年,47,0,47,新光-高雄,2024-07-26,8562
3033,威健,47,0,47,新光-高雄,2024-07-26,8562
00923,群益台ESG低碳50,50,4,46,新光-高雄,2024-07-26,8562
2390,云辰,46,0,46,新光-高雄,2024-07-26,8562
00945B,凱基美國非投等債,53,8,45,新光-高雄,2024-07-26,8562
00675L,富邦臺灣加權正2,90,45,45,新光-高雄,2024-07-26,8562
00936,台新永續高息中小,90,45,45,新光-高雄,2024-07-26,8562
2897,王道銀行,55,10,45,新光-高雄,2024-07-26,8562
006208,富邦台50,47,6,41,新光-高雄,2024-07-26,8562
00931B,統一美債20年,49,9,40,新光-高雄,2024-07-26,8562
3312,弘憶股,50,11,39,新光-高雄,2024-07-26,8562
2509,全坤建,38,0,38,新光-高雄,2024-07-26,8562
2486,一詮,78,40,38,新光-高雄,2024-07-26,8562
2349,錸德,57,21,36,新光-高雄,2024-07-26,8562
9902,台火,37,3,34,新光-高雄,2024-07-26,8562
2408,南亞科,43,9,34,新光-高雄,2024-07-26,8562
2002,中鋼,62,29,33,新光-高雄,2024-07-26,8562
00934,中信成長高股息,48,15,33,新光-高雄,2024-07-26,8562
00715L,期街口布蘭特正2,34,2,32,新光-高雄,2024-07-26,8562
00751B,元大AAA至A公司債,31,0,31,新光-高雄,2024-07-26,8562
1305,華夏,42,12,30,新光-高雄,2024-07-26,8562
1314,中石化,718,111,607,新光-高雄,2024-07-29,8562
00929,復華台灣科技優息,723,277,446,新光-高雄,2024-07-29,8562
00680L,元大美債20正2,784,397,387,新光-高雄,2024-07-29,8562
00937B,群益ESG投等債20,465,179,286,新光-高雄,2024-07-29,8562
00688L,國泰20年美債正2,293,55,238,新光-高雄,2024-07-29,8562
00940,元大台灣價值高息,201,14,187,新光-高雄,2024-07-29,8562
00919,群益台灣精選高息,289,103,186,新光-高雄,2024-07-29,8562
2515,中工,237,58,179,新光-高雄,2024-07-29,8562
00878,國泰永續高股息,215,37,178,新光-高雄,2024-07-29,8562
0056,元大高股息,170,16,154,新光-高雄,2024-07-29,8562
00715L,期街口布蘭特正2,148,0,148,新光-高雄,2024-07-29,8562
00918,大華優利高填息30,134,19,115,新光-高雄,2024-07-29,8562
00934,中信成長高股息,141,31,110,新光-高雄,2024-07-29,8562
5309,系統電,165,55,110,新光-高雄,2024-07-29,8562
2888,新光金,299,195,104,新光-高雄,2024-07-29,8562
2845,遠東銀,102,0,102,新光-高雄,2024-07-29,8562
2027,大成鋼,93,2,91,新光-高雄,2024-07-29,8562
1456,怡華,100,13,87,新光-高雄,2024-07-29,8562
1101,台泥,102,25,77,新光-高雄,2024-07-29,8562
1308,亞聚,81,5,76,新光-高雄,2024-07-29,8562
2891,中信金,81,16,65,新光-高雄,2024-07-29,8562
2834,臺企銀,69,4,65,新光-高雄,2024-07-29,8562
3535,晶彩科,61,0,61,新光-高雄,2024-07-29,8562
00687B,國泰20年美債,122,63,59,新光-高雄,2024-07-29,8562
4168,醣聯,62,4,58,新光-高雄,2024-07-29,8562
9902,台火,92,36,56,新光-高雄,2024-07-29,8562
3481,群創,148,95,53,新光-高雄,2024-07-29,8562
00632R,元大台灣50反1,1266,1213,53,新光-高雄,2024-07-29,8562
2812,台中銀,49,4,45,新光-高雄,2024-07-29,8562
00669R,國泰美國道瓊反1,50,6,44,新光-高雄,2024-07-29,8562
1529,樂事綠能,45,5,40,新光-高雄,2024-07-29,8562
1316,上曜,79,39,40,新光-高雄,2024-07-29,8562
2439,美律,44,5,39,新光-高雄,2024-07-29,8562
2049,上銀,55,18,37,新光-高雄,2024-07-29,8562
00946,群益科技高息成長,88,52,36,新光-高雄,2024-07-29,8562
00712,復華富時不動產,45,9,36,新光-高雄,2024-07-29,8562
1609,大亞,80,45,35,新光-高雄,2024-07-29,8562
2356,英業達,73,38,35,新光-高雄,2024-07-29,8562
00753L,中信中國50正2,39,4,35,新光-高雄,2024-07-29,8562
3287,廣寰科,33,0,33,新光-高雄,2024-07-29,8562
2603,長榮,44,12,32,新光-高雄,2024-07-29,8562
00671R,富邦NASDAQ反1,30,0,30,新光-高雄,2024-07-29,8562
2486,一詮,67,37,30,新光-高雄,2024-07-29,8562
4128,中天,36,7,29,新光-高雄,2024-07-29,8562
4153,鈺緯,29,0,29,新光-高雄,2024-07-29,8562
5515,建國,35,6,29,新光-高雄,2024-07-29,8562
2409,友達,60,32,28,新光-高雄,2024-07-29,8562
4306,炎洲,56,28,28,新光-高雄,2024-07-29,8562
1808,潤隆,32,6,26,新光-高雄,2024-07-29,8562
00720B,元大投資級公司債,32,6,26,新光-高雄,2024-07-29,8562
00632R,元大台灣50反1,5732,1634,4098,新光-高雄,2024-07-30,8562
00929,復華台灣科技優息,675,94,581,新光-高雄,2024-07-30,8562
00940,元大台灣價值高息,597,22,575,新光-高雄,2024-07-30,8562
00715L,期街口布蘭特正2,203,2,201,新光-高雄,2024-07-30,8562
00878,國泰永續高股息,306,106,200,新光-高雄,2024-07-30,8562
2891,中信金,149,13,136,新光-高雄,2024-07-30,8562
00919,群益台灣精選高息,175,43,132,新光-高雄,2024-07-30,8562
2409,友達,179,60,119,新光-高雄,2024-07-30,8562
00934,中信成長高股息,128,20,108,新光-高雄,2024-07-30,8562
00946,群益科技高息成長,122,15,107,新光-高雄,2024-07-30,8562
2313,華通,109,8,101,新光-高雄,2024-07-30,8562
2537,聯上發,156,56,100,新光-高雄,2024-07-30,8562
0056,元大高股息,150,76,74,新光-高雄,2024-07-30,8562
00915,凱基優選高股息30,91,21,70,新光-高雄,2024-07-30,8562
00936,台新永續高息中小,77,7,70,新光-高雄,2024-07-30,8562
00933B,國泰10Y+金融債,90,28,62,新光-高雄,2024-07-30,8562
00650L,復華香港正2,70,9,61,新光-高雄,2024-07-30,8562
00637L,元大滬深300正2,162,102,60,新光-高雄,2024-07-30,8562
3535,晶彩科,64,5,59,新光-高雄,2024-07-30,8562
2027,大成鋼,66,12,54,新光-高雄,2024-07-30,8562
2515,中工,55,2,53,新光-高雄,2024-07-30,8562
00713,元大台灣高息低波,58,5,53,新光-高雄,2024-07-30,8562
2812,台中銀,52,0,52,新光-高雄,2024-07-30,8562
1314,中石化,54,7,47,新光-高雄,2024-07-30,8562
00725B,國泰投資級公司債,48,2,46,新光-高雄,2024-07-30,8562
2344,華邦電,63,17,46,新光-高雄,2024-07-30,8562
5512,力麒,50,7,43,新光-高雄,2024-07-30,8562
5864,致和證,40,0,40,新光-高雄,2024-07-30,8562
0050,元大台灣50,47,13,34,新光-高雄,2024-07-30,8562
5243,乙盛-KY,34,0,34,新光-高雄,2024-07-30,8562
2442,新美齊,51,18,33,新光-高雄,2024-07-30,8562
1305,華夏,31,1,30,新光-高雄,2024-07-30,8562
9906,欣巴巴,71,41,30,新光-高雄,2024-07-30,8562
2884,玉山金,74,46,28,新光-高雄,2024-07-30,8562
00918,大華優利高填息30,31,2,29,新光-高雄,2024-07-30,8562
2303,聯電,36,8,28,新光-高雄,2024-07-30,8562
00664R,國泰臺灣加權反1,51,24,27,新光-高雄,2024-07-30,8562
2243,宏旭-KY,26,0,26,新光-高雄,2024-07-30,8562
00795B,中信美國公債20年,30,4,26,新光-高雄,2024-07-30,8562
3312,弘憶股,48,22,26,新光-高雄,2024-07-30,8562
2382,廣達,36,11,25,新光-高雄,2024-07-30,8562
2834,臺企銀,44,18,26,新光-高雄,2024-07-30,8562
6177,達麗,38,13,25,新光-高雄,2024-07-30,8562
3673,TPK-KY,25,0,25,新光-高雄,2024-07-30,8562
00665L,富邦�琤肭磪囓�2,29,4,25,新光-高雄,2024-07-30,8562
6806,森崴能源,60,35,25,新光-高雄,2024-07-30,8562
9105,泰金寶-DR,37,13,24,新光-高雄,2024-07-30,8562
2882,國泰金,32,8,24,新光-高雄,2024-07-30,8562
1312,國喬,24,0,24,新光-高雄,2024-07-30,8562
00937B,群益ESG投等債20,94,71,23,新光-高雄,2024-07-30,8562
00712,復華富時不動產,388,62,326,新光-高雄,2024-07-31,8562
00680L,元大美債20正2,609,431,178,新光-高雄,2024-07-31,8562
3481,群創,327,173,154,新光-高雄,2024-07-31,8562
00937B,群益ESG投等債20,154,28,126,新光-高雄,2024-07-31,8562
00715L,期街口布蘭特正2,133,8,125,新光-高雄,2024-07-31,8562
00687B,國泰20年美債,175,50,125,新光-高雄,2024-07-31,8562
00878,國泰永續高股息,141,19,122,新光-高雄,2024-07-31,8562
00946,群益科技高息成長,120,0,120,新光-高雄,2024-07-31,8562
2349,錸德,260,151,109,新光-高雄,2024-07-31,8562
00919,群益台灣精選高息,134,32,102,新光-高雄,2024-07-31,8562
00725B,國泰投資級公司債,100,1,99,新光-高雄,2024-07-31,8562
00929,復華台灣科技優息,416,329,87,新光-高雄,2024-07-31,8562
5347,世界,84,13,71,新光-高雄,2024-07-31,8562
2382,廣達,88,19,69,新光-高雄,2024-07-31,8562
00688L,國泰20年美債正2,164,100,64,新光-高雄,2024-07-31,8562
2208,台船,54,0,54,新光-高雄,2024-07-31,8562
2812,台中銀,60,8,52,新光-高雄,2024-07-31,8562
2439,美律,46,0,46,新光-高雄,2024-07-31,8562
00945B,凱基美國非投等債,46,0,46,新光-高雄,2024-07-31,8562
00940,元大台灣價值高息,108,67,41,新光-高雄,2024-07-31,8562
1809,中釉,40,0,40,新光-高雄,2024-07-31,8562
3663,鑫科,217,178,39,新光-高雄,2024-07-31,8562
8028,昇陽半導體,85,49,36,新光-高雄,2024-07-31,8562
00664R,國泰臺灣加權反1,34,0,34,新光-高雄,2024-07-31,8562
2913,農林,37,3,34,新光-高雄,2024-07-31,8562
00934,中信成長高股息,45,12,33,新光-高雄,2024-07-31,8562
1536,和大,41,9,32,新光-高雄,2024-07-31,8562
3105,穩懋,52,22,30,新光-高雄,2024-07-31,8562
3535,晶彩科,50,20,30,新光-高雄,2024-07-31,8562
2101,南港,41,11,30,新光-高雄,2024-07-31,8562
2542,興富發,30,1,29,新光-高雄,2024-07-31,8562
00891,中信關鍵半導體,68,40,28,新光-高雄,2024-07-31,8562
00679B,元大美債20年,126,99,27,新光-高雄,2024-07-31,8562
5905,南仁湖,28,1,27,新光-高雄,2024-07-31,8562
4128,中天,26,0,26,新光-高雄,2024-07-31,8562
5512,力麒,169,143,26,新光-高雄,2024-07-31,8562
912000,晨訊科-DR,25,0,25,新光-高雄,2024-07-31,8562
4545,銘鈺,34,9,25,新光-高雄,2024-07-31,8562
6147,頎邦,27,3,24,新光-高雄,2024-07-31,8562
3088,艾訊,24,0,24,新光-高雄,2024-07-31,8562
2454,聯發科,50,26,24,新光-高雄,2024-07-31,8562
6770,力積電,27,3,24,新光-高雄,2024-07-31,8562
2509,全坤建,29,6,23,新光-高雄,2024-07-31,8562
4958,臻鼎-KY,25,3,22,新光-高雄,2024-07-31,8562
3037,欣興,96,75,21,新光-高雄,2024-07-31,8562
4967,十銓,31,11,20,新光-高雄,2024-07-31,8562
3167,大量,63,43,20,新光-高雄,2024-07-31,8562
2883,凱基金,46,26,20,新光-高雄,2024-07-31,8562
2412,中華電,23,3,20,新光-高雄,2024-07-31,8562
2486,一詮,92,73,19,新光-高雄,2024-07-31,8562
00937B,群益ESG投等債20,268,25,243,新光-高雄,2024-08-01,8562
00878,國泰永續高股息,244,31,213,新光-高雄,2024-08-01,8562
2409,友達,167,17,150,新光-高雄,2024-08-01,8562
00931B,統一美債20年,131,10,121,新光-高雄,2024-08-01,8562
00688L,國泰20年美債正2,365,254,111,新光-高雄,2024-08-01,8562
00948B,中信優息投資級債,101,1,100,新光-高雄,2024-08-01,8562
00637L,元大滬深300正2,177,78,99,新光-高雄,2024-08-01,8562
4114,健喬,102,3,99,新光-高雄,2024-08-01,8562
2349,錸德,476,395,81,新光-高雄,2024-08-01,8562
0056,元大高股息,112,32,80,新光-高雄,2024-08-01,8562
6274,台燿,86,6,80,新光-高雄,2024-08-01,8562
00751B,元大AAA至A公司債,73,5,68,新光-高雄,2024-08-01,8562
3663,鑫科,317,251,66,新光-高雄,2024-08-01,8562
3481,群創,177,116,61,新光-高雄,2024-08-01,8562
00633L,富邦上証正2,60,0,60,新光-高雄,2024-08-01,8562
00945B,凱基美國非投等債,54,0,54,新光-高雄,2024-08-01,8562
00673R,期元大S＆P原油反1,75,24,51,新光-高雄,2024-08-01,8562
00934,中信成長高股息,51,4,47,新光-高雄,2024-08-01,8562
2887,台新金,63,19,44,新光-高雄,2024-08-01,8562
2204,中華,47,7,40,新光-高雄,2024-08-01,8562
00881,國泰台灣5G+,48,9,39,新光-高雄,2024-08-01,8562
2883,凱基金,38,2,36,新光-高雄,2024-08-01,8562
5443,均豪,220,184,36,新光-高雄,2024-08-01,8562
5905,南仁湖,42,7,35,新光-高雄,2024-08-01,8562
00946,群益科技高息成長,54,20,34,新光-高雄,2024-08-01,8562
5533,皇鼎,34,1,33,新光-高雄,2024-08-01,8562
3491,昇達科,48,16,32,新光-高雄,2024-08-01,8562
3047,訊舟,108,78,30,新光-高雄,2024-08-01,8562
2527,宏璟,41,12,29,新光-高雄,2024-08-01,8562
9105,泰金寶-DR,60,31,29,新光-高雄,2024-08-01,8562
2542,興富發,37,11,26,新光-高雄,2024-08-01,8562
2834,臺企銀,45,20,25,新光-高雄,2024-08-01,8562
2337,旺宏,268,243,25,新光-高雄,2024-08-01,8562
3710,連展投控,25,0,25,新光-高雄,2024-08-01,8562
4720,德淵,25,0,25,新光-高雄,2024-08-01,8562
2363,矽統,131,108,23,新光-高雄,2024-08-01,8562
4566,時碩工業,50,27,23,新光-高雄,2024-08-01,8562
8105,凌巨,46,23,23,新光-高雄,2024-08-01,8562
2442,新美齊,48,26,22,新光-高雄,2024-08-01,8562
3019,亞光,35,13,22,新光-高雄,2024-08-01,8562
00712,復華富時不動產,36,14,22,新光-高雄,2024-08-01,8562
6807,峰源-KY,30,9,21,新光-高雄,2024-08-01,8562
3522,御嵿,30,9,21,新光-高雄,2024-08-01,8562
9958,世紀鋼,24,4,20,新光-高雄,2024-08-01,8562
00753L,中信中國50正2,23,3,20,新光-高雄,2024-08-01,8562
6546,正基,27,7,20,新光-高雄,2024-08-01,8562
6547,高端疫苗,20,0,20,新光-高雄,2024-08-01,8562
00951,台新日本半導體,33,14,19,新光-高雄,2024-08-01,8562
2061,風青,23,4,19,新光-高雄,2024-08-01,8562
00923,群益台ESG低碳50,20,1,19,新光-高雄,2024-08-01,8562
00929,復華台灣科技優息,1048,171,877,新光-高雄,2024-08-02,8562
00878,國泰永續高股息,715,63,652,新光-高雄,2024-08-02,8562
00919,群益台灣精選高息,433,37,396,新光-高雄,2024-08-02,8562
00940,元大台灣價值高息,350,29,321,新光-高雄,2024-08-02,8562
2915,潤泰全,280,13,267,新光-高雄,2024-08-02,8562
00923,群益台ESG低碳50,238,0,238,新光-高雄,2024-08-02,8562
00945B,凱基美國非投等債,226,0,226,新光-高雄,2024-08-02,8562
5512,力麒,246,23,223,新光-高雄,2024-08-02,8562
1316,上曜,337,125,212,新光-高雄,2024-08-02,8562
00679B,元大美債20年,364,153,211,新光-高雄,2024-08-02,8562
2317,鴻海,345,179,166,新光-高雄,2024-08-02,8562
00891,中信關鍵半導體,181,32,149,新光-高雄,2024-08-02,8562
2891,中信金,161,17,144,新光-高雄,2024-08-02,8562
0056,元大高股息,189,47,142,新光-高雄,2024-08-02,8562
00665L,富邦�琤肭磪囓�2,252,120,132,新光-高雄,2024-08-02,8562
00675L,富邦臺灣加權正2,134,3,131,新光-高雄,2024-08-02,8562
2892,第一金,135,10,125,新光-高雄,2024-08-02,8562
00881,國泰台灣5G+,122,1,121,新光-高雄,2024-08-02,8562
2330,台積電,159,43,116,新光-高雄,2024-08-02,8562
3481,群創,221,106,115,新光-高雄,2024-08-02,8562
00936,台新永續高息中小,119,8,111,新光-高雄,2024-08-02,8562
2101,南港,118,7,111,新光-高雄,2024-08-02,8562
2515,中工,184,81,103,新光-高雄,2024-08-02,8562
2887,台新金,115,21,94,新光-高雄,2024-08-02,8562
00631L,元大台灣50正2,115,28,87,新光-高雄,2024-08-02,8562
9945,潤泰新,112,30,82,新光-高雄,2024-08-02,8562
00715L,期街口布蘭特正2,96,19,77,新光-高雄,2024-08-02,8562
00900,富邦特選高股息30,72,0,72,新光-高雄,2024-08-02,8562
00949,復華日本龍頭,71,0,71,新光-高雄,2024-08-02,8562
2337,旺宏,91,22,69,新光-高雄,2024-08-02,8562
1314,中石化,109,42,67,新光-高雄,2024-08-02,8562
2442,新美齊,81,17,64,新光-高雄,2024-08-02,8562
2485,兆赫,61,0,61,新光-高雄,2024-08-02,8562
00932,兆豐永續高息等權,61,0,61,新光-高雄,2024-08-02,8562
00927,群益半導體收益,81,22,59,新光-高雄,2024-08-02,8562
3037,欣興,109,50,59,新光-高雄,2024-08-02,8562
00946,群益科技高息成長,164,106,58,新光-高雄,2024-08-02,8562
00795B,中信美國公債20年,89,33,56,新光-高雄,2024-08-02,8562
00941,中信上游半導體,55,0,55,新光-高雄,2024-08-02,8562
0050,元大台灣50,94,40,54,新光-高雄,2024-08-02,8562
1718,中纖,50,0,50,新光-高雄,2024-08-02,8562
6126,信音,62,12,50,新光-高雄,2024-08-02,8562
00733,富邦臺灣中小,51,2,49,新光-高雄,2024-08-02,8562
1409,新纖,49,0,49,新光-高雄,2024-08-02,8562
2885,元大金,51,3,48,新光-高雄,2024-08-02,8562
00951,台新日本半導體,66,19,47,新光-高雄,2024-08-02,8562
00713,元大台灣高息低波,51,5,46,新光-高雄,2024-08-02,8562
2002,中鋼,57,12,45,新光-高雄,2024-08-02,8562
2027,大成鋼,57,12,45,新光-高雄,2024-08-02,8562
2408,南亞科,57,13,44,新光-高雄,2024-08-02,8562
00929,復華台灣科技優息,2100,893,1207,新光-高雄,2024-08-05,8562
00940,元大台灣價值高息,1226,260,966,新光-高雄,2024-08-05,8562
00878,國泰永續高股息,1216,322,894,新光-高雄,2024-08-05,8562
00948B,中信優息投資級債,504,15,489,新光-高雄,2024-08-05,8562
00715L,期街口布蘭特正2,481,32,449,新光-高雄,2024-08-05,8562
00919,群益台灣精選高息,777,337,440,新光-高雄,2024-08-05,8562
00900,富邦特選高股息30,361,53,308,新光-高雄,2024-08-05,8562
3576,聯合再生,251,15,236,新光-高雄,2024-08-05,8562
3481,群創,514,297,217,新光-高雄,2024-08-05,8562
00936,台新永續高息中小,234,33,201,新光-高雄,2024-08-05,8562
00932,兆豐永續高息等權,208,23,185,新光-高雄,2024-08-05,8562
2409,友達,334,151,183,新光-高雄,2024-08-05,8562
00945B,凱基美國非投等債,175,0,175,新光-高雄,2024-08-05,8562
0056,元大高股息,361,197,164,新光-高雄,2024-08-05,8562
00648R,元大S＆P500反1,161,0,161,新光-高雄,2024-08-05,8562
00686R,群益臺灣加權反1,160,0,160,新光-高雄,2024-08-05,8562
2317,鴻海,390,248,142,新光-高雄,2024-08-05,8562
2834,臺企銀,222,84,138,新光-高雄,2024-08-05,8562
00631L,元大台灣50正2,217,80,137,新光-高雄,2024-08-05,8562
2330,台積電,253,121,132,新光-高雄,2024-08-05,8562
00923,群益台ESG低碳50,170,51,119,新光-高雄,2024-08-05,8562
2061,風青,114,0,114,新光-高雄,2024-08-05,8562
9105,泰金寶-DR,127,16,111,新光-高雄,2024-08-05,8562
2492,華新科,111,4,107,新光-高雄,2024-08-05,8562
00675L,富邦臺灣加權正2,151,47,104,新光-高雄,2024-08-05,8562
2905,三商,121,18,103,新光-高雄,2024-08-05,8562
2851,中再保,106,4,102,新光-高雄,2024-08-05,8562
2891,中信金,181,82,99,新光-高雄,2024-08-05,8562
1409,新纖,127,28,99,新光-高雄,2024-08-05,8562
2408,南亞科,119,22,97,新光-高雄,2024-08-05,8562
1314,中石化,126,30,96,新光-高雄,2024-08-05,8562
1305,華夏,95,0,95,新光-高雄,2024-08-05,8562
00753L,中信中國50正2,87,1,86,新光-高雄,2024-08-05,8562
00637L,元大滬深300正2,163,83,80,新光-高雄,2024-08-05,8562
4510,高鋒,418,338,80,新光-高雄,2024-08-05,8562
00713,元大台灣高息低波,121,42,79,新光-高雄,2024-08-05,8562
006208,富邦台50,149,73,76,新光-高雄,2024-08-05,8562
2104,國際中橡,95,20,75,新光-高雄,2024-08-05,8562
6005,群益證,77,8,69,新光-高雄,2024-08-05,8562
2618,長榮航,157,94,63,新光-高雄,2024-08-05,8562
5512,力麒,85,25,60,新光-高雄,2024-08-05,8562
2208,台船,59,0,59,新光-高雄,2024-08-05,8562
1316,上曜,87,29,58,新光-高雄,2024-08-05,8562
00944,野村趨勢動能高息,65,7,58,新光-高雄,2024-08-05,8562
2812,台中銀,72,17,55,新光-高雄,2024-08-05,8562
00795B,中信美國公債20年,75,20,55,新光-高雄,2024-08-05,8562
2892,第一金,82,28,54,新光-高雄,2024-08-05,8562
0050,元大台灣50,122,67,55,新光-高雄,2024-08-05,8562
1313,聯成,54,2,52,新光-高雄,2024-08-05,8562
2547,日勝生,55,4,51,新光-高雄,2024-08-05,8562
00632R,元大台灣50反1,4459,738,3721,新光-高雄,2024-08-06,8562
00940,元大台灣價值高息,499,236,263,新光-高雄,2024-08-06,8562
00715L,期街口布蘭特正2,256,3,253,新光-高雄,2024-08-06,8562
00948B,中信優息投資級債,270,26,244,新光-高雄,2024-08-06,8562
3576,聯合再生,222,30,192,新光-高雄,2024-08-06,8562
2820,華票,154,0,154,新光-高雄,2024-08-06,8562
9105,泰金寶-DR,160,38,122,新光-高雄,2024-08-06,8562
00936,台新永續高息中小,156,46,110,新光-高雄,2024-08-06,8562
2892,第一金,143,36,107,新光-高雄,2024-08-06,8562
00941,中信上游半導體,106,4,102,新光-高雄,2024-08-06,8562
912000,晨訊科-DR,101,0,101,新光-高雄,2024-08-06,8562
2409,友達,126,41,85,新光-高雄,2024-08-06,8562
2104,國際中橡,86,1,85,新光-高雄,2024-08-06,8562
00637L,元大滬深300正2,187,106,81,新光-高雄,2024-08-06,8562
1536,和大,84,15,69,新光-高雄,2024-08-06,8562
006208,富邦台50,111,43,68,新光-高雄,2024-08-06,8562
3338,泰碩,61,1,60,新光-高雄,2024-08-06,8562
2609,陽明,163,104,59,新光-高雄,2024-08-06,8562
2888,新光金,133,74,59,新光-高雄,2024-08-06,8562
2049,上銀,97,40,57,新光-高雄,2024-08-06,8562
00733,富邦臺灣中小,53,4,49,新光-高雄,2024-08-06,8562
3062,建漢,51,3,48,新光-高雄,2024-08-06,8562
2915,潤泰全,54,6,48,新光-高雄,2024-08-06,8562
00675L,富邦臺灣加權正2,97,53,44,新光-高雄,2024-08-06,8562
0056,元大高股息,149,105,44,新光-高雄,2024-08-06,8562
00686R,群益臺灣加權反1,52,10,42,新光-高雄,2024-08-06,8562
3312,弘憶股,84,43,41,新光-高雄,2024-08-06,8562
2442,新美齊,46,6,40,新光-高雄,2024-08-06,8562
2515,中工,78,38,40,新光-高雄,2024-08-06,8562
5871,中租-KY,51,12,39,新光-高雄,2024-08-06,8562
1409,新纖,51,14,37,新光-高雄,2024-08-06,8562
2303,聯電,117,82,35,新光-高雄,2024-08-06,8562
00712,復華富時不動產,64,30,34,新光-高雄,2024-08-06,8562
2002,中鋼,45,15,30,新光-高雄,2024-08-06,8562
4153,鈺緯,30,0,30,新光-高雄,2024-08-06,8562
00881,國泰台灣5G+,100,71,29,新光-高雄,2024-08-06,8562
0050,元大台灣50,146,117,29,新光-高雄,2024-08-06,8562
2419,仲琦,38,9,29,新光-高雄,2024-08-06,8562
2834,臺企銀,54,26,28,新光-高雄,2024-08-06,8562
00900,富邦特選高股息30,37,9,28,新光-高雄,2024-08-06,8562
3037,欣興,75,47,28,新光-高雄,2024-08-06,8562
3188,鑫龍騰,44,16,28,新光-高雄,2024-08-06,8562
4123,晟德,38,10,28,新光-高雄,2024-08-06,8562
1718,中纖,27,0,27,新光-高雄,2024-08-06,8562
00665L,富邦�琤肭磪囓�2,33,8,25,新光-高雄,2024-08-06,8562
9958,世紀鋼,53,29,24,新光-高雄,2024-08-06,8562
8110,華東,26,2,24,新光-高雄,2024-08-06,8562
2337,旺宏,87,64,23,新光-高雄,2024-08-06,8562
1304,台聚,32,9,23,新光-高雄,2024-08-06,8562
6177,達麗,57,36,21,新光-高雄,2024-08-06,8562
00929,復華台灣科技優息,634,245,389,新光-高雄,2024-08-07,8562
00680L,元大美債20正2,994,654,340,新光-高雄,2024-08-07,8562
00715L,期街口布蘭特正2,302,12,290,新光-高雄,2024-08-07,8562
00687B,國泰20年美債,494,204,290,新光-高雄,2024-08-07,8562
00679B,元大美債20年,384,108,276,新光-高雄,2024-08-07,8562
00935,野村臺灣新科技50,171,4,167,新光-高雄,2024-08-07,8562
00720B,元大投資級公司債,187,24,163,新光-高雄,2024-08-07,8562
00931B,統一美債20年,172,31,141,新光-高雄,2024-08-07,8562
2834,臺企銀,184,45,139,新光-高雄,2024-08-07,8562
2887,台新金,129,0,129,新光-高雄,2024-08-07,8562
2344,華邦電,139,14,125,新光-高雄,2024-08-07,8562
2409,友達,201,82,119,新光-高雄,2024-08-07,8562
2812,台中銀,123,5,118,新光-高雄,2024-08-07,8562
00664R,國泰臺灣加權反1,110,0,110,新光-高雄,2024-08-07,8562
3481,群創,148,38,110,新光-高雄,2024-08-07,8562
00753L,中信中國50正2,98,5,93,新光-高雄,2024-08-07,8562
00936,台新永續高息中小,160,74,86,新光-高雄,2024-08-07,8562
00676R,富邦臺灣加權反1,81,0,81,新光-高雄,2024-08-07,8562
6005,群益證,100,22,78,新光-高雄,2024-08-07,8562
6477,安集,70,2,68,新光-高雄,2024-08-07,8562
2317,鴻海,280,213,67,新光-高雄,2024-08-07,8562
00671R,富邦NASDAQ反1,53,0,53,新光-高雄,2024-08-07,8562
6213,聯茂,95,46,49,新光-高雄,2024-08-07,8562
8096,擎亞,81,32,49,新光-高雄,2024-08-07,8562
00942B,台新美A公司債20+,51,5,46,新光-高雄,2024-08-07,8562
1402,遠東新,50,5,45,新光-高雄,2024-08-07,8562
2408,南亞科,91,50,41,新光-高雄,2024-08-07,8562
2062,橋椿,74,34,40,新光-高雄,2024-08-07,8562
2838,聯邦銀,39,0,39,新光-高雄,2024-08-07,8562
3045,台灣大,47,9,38,新光-高雄,2024-08-07,8562
00882,中信中國高股息,36,0,36,新光-高雄,2024-08-07,8562
00948B,中信優息投資級債,52,17,35,新光-高雄,2024-08-07,8562
6116,彩晶,56,22,34,新光-高雄,2024-08-07,8562
00881,國泰台灣5G+,45,13,32,新光-高雄,2024-08-07,8562
2356,英業達,115,84,31,新光-高雄,2024-08-07,8562
5880,合庫金,35,5,30,新光-高雄,2024-08-07,8562
912000,晨訊科-DR,38,8,30,新光-高雄,2024-08-07,8562
00933B,國泰10Y+金融債,40,11,29,新光-高雄,2024-08-07,8562
1101,台泥,38,10,28,新光-高雄,2024-08-07,8562
2101,南港,36,8,28,新光-高雄,2024-08-07,8562
2891,中信金,58,33,25,新光-高雄,2024-08-07,8562
00946,群益科技高息成長,40,17,23,新光-高雄,2024-08-07,8562
1436,華友聯,25,2,23,新光-高雄,2024-08-07,8562
00945B,凱基美國非投等債,23,0,23,新光-高雄,2024-08-07,8562
2382,廣達,76,54,22,新光-高雄,2024-08-07,8562
2845,遠東銀,23,1,22,新光-高雄,2024-08-07,8562
2412,中華電,33,12,21,新光-高雄,2024-08-07,8562
3050,鈺德,32,11,21,新光-高雄,2024-08-07,8562
00918,大華優利高填息30,23,3,20,新光-高雄,2024-08-07,8562
00697B,元大美債7-10,28,8,20,新光-高雄,2024-08-07,8562
00679B,元大美債20年,578,212,366,新光-高雄,2024-08-08,8562
00929,復華台灣科技優息,406,95,311,新光-高雄,2024-08-08,8562
00878,國泰永續高股息,219,23,196,新光-高雄,2024-08-08,8562
00680L,元大美債20正2,417,222,195,新光-高雄,2024-08-08,8562
2317,鴻海,320,143,177,新光-高雄,2024-08-08,8562
00940,元大台灣價值高息,207,32,175,新光-高雄,2024-08-08,8562
00919,群益台灣精選高息,189,20,169,新光-高雄,2024-08-08,8562
00715L,期街口布蘭特正2,415,253,162,新光-高雄,2024-08-08,8562
00720B,元大投資級公司債,188,44,144,新光-高雄,2024-08-08,8562
2834,臺企銀,182,46,136,新光-高雄,2024-08-08,8562
00648R,元大S＆P500反1,130,0,130,新光-高雄,2024-08-08,8562
00687B,國泰20年美債,199,72,127,新光-高雄,2024-08-08,8562
00712,復華富時不動產,128,12,116,新光-高雄,2024-08-08,8562
00631L,元大台灣50正2,157,46,111,新光-高雄,2024-08-08,8562
00664R,國泰臺灣加權反1,95,0,95,新光-高雄,2024-08-08,8562
00923,群益台ESG低碳50,117,23,94,新光-高雄,2024-08-08,8562
2892,第一金,94,1,93,新光-高雄,2024-08-08,8562
0056,元大高股息,95,8,87,新光-高雄,2024-08-08,8562
00795B,中信美國公債20年,117,35,82,新光-高雄,2024-08-08,8562
00936,台新永續高息中小,82,0,82,新光-高雄,2024-08-08,8562
2886,兆豐金,101,19,82,新光-高雄,2024-08-08,8562
2618,長榮航,72,4,68,新光-高雄,2024-08-08,8562
00946,群益科技高息成長,82,26,56,新光-高雄,2024-08-08,8562
2002,中鋼,61,5,56,新光-高雄,2024-08-08,8562
00948B,中信優息投資級債,55,6,49,新光-高雄,2024-08-08,8562
1316,上曜,86,37,49,新光-高雄,2024-08-08,8562
2610,華航,50,1,49,新光-高雄,2024-08-08,8562
00933B,國泰10Y+金融債,51,4,47,新光-高雄,2024-08-08,8562
2405,輔信,51,5,46,新光-高雄,2024-08-08,8562
00753L,中信中國50正2,47,1,46,新光-高雄,2024-08-08,8562
2204,中華,77,33,44,新光-高雄,2024-08-08,8562
2609,陽明,72,29,43,新光-高雄,2024-08-08,8562
2884,玉山金,54,12,42,新光-高雄,2024-08-08,8562
00915,凱基優選高股息30,56,15,41,新光-高雄,2024-08-08,8562
00830,國泰費城半導體,41,1,40,新光-高雄,2024-08-08,8562
3264,欣銓,55,15,40,新光-高雄,2024-08-08,8562
00713,元大台灣高息低波,46,7,39,新光-高雄,2024-08-08,8562
2408,南亞科,119,80,39,新光-高雄,2024-08-08,8562
4510,高鋒,330,293,37,新光-高雄,2024-08-08,8562
2382,廣達,57,23,34,新光-高雄,2024-08-08,8562
3712,永崴投控,55,22,33,新光-高雄,2024-08-08,8562
00675L,富邦臺灣加權正2,48,15,33,新光-高雄,2024-08-08,8562
00907,永豐優息存股,31,0,31,新光-高雄,2024-08-08,8562
2883,凱基金,42,11,31,新光-高雄,2024-08-08,8562
2515,中工,63,32,31,新光-高雄,2024-08-08,8562
1326,台化,37,7,30,新光-高雄,2024-08-08,8562
3450,聯鈞,103,74,29,新光-高雄,2024-08-08,8562
2402,毅嘉,70,41,29,新光-高雄,2024-08-08,8562
00918,大華優利高填息30,39,11,28,新光-高雄,2024-08-08,8562
2349,錸德,209,181,28,新光-高雄,2024-08-08,8562
00632R,元大台灣50反1,7212,728,6484,新光-高雄,2024-08-09,8562
00680L,元大美債20正2,1341,559,782,新光-高雄,2024-08-09,8562
00931B,統一美債20年,338,0,338,新光-高雄,2024-08-09,8562
00929,復華台灣科技優息,435,196,239,新光-高雄,2024-08-09,8562
00881,國泰台灣5G+,241,15,226,新光-高雄,2024-08-09,8562
00679B,元大美債20年,358,150,208,新光-高雄,2024-08-09,8562
00688L,國泰20年美債正2,811,630,181,新光-高雄,2024-08-09,8562
00687B,國泰20年美債,458,283,175,新光-高雄,2024-08-09,8562
00725B,國泰投資級公司債,141,1,140,新光-高雄,2024-08-09,8562
00937B,群益ESG投等債20,617,481,136,新光-高雄,2024-08-09,8562
00676R,富邦臺灣加權反1,110,0,110,新光-高雄,2024-08-09,8562
2883,凱基金,227,120,107,新光-高雄,2024-08-09,8562
00650L,復華香港正2,101,5,96,新光-高雄,2024-08-09,8562
6603,富強鑫,246,150,96,新光-高雄,2024-08-09,8562
2887,台新金,144,49,95,新光-高雄,2024-08-09,8562
1513,中興電,94,22,72,新光-高雄,2024-08-09,8562
9945,潤泰新,92,21,71,新光-高雄,2024-08-09,8562
0056,元大高股息,91,32,59,新光-高雄,2024-08-09,8562
00795B,中信美國公債20年,83,27,56,新光-高雄,2024-08-09,8562
3450,聯鈞,123,70,53,新光-高雄,2024-08-09,8562
00948B,中信優息投資級債,124,76,48,新光-高雄,2024-08-09,8562
5871,中租-KY,63,17,46,新光-高雄,2024-08-09,8562
00664R,國泰臺灣加權反1,42,0,42,新光-高雄,2024-08-09,8562
2515,中工,61,20,41,新光-高雄,2024-08-09,8562
00720B,元大投資級公司債,41,0,41,新光-高雄,2024-08-09,8562
00932,兆豐永續高息等權,38,0,38,新光-高雄,2024-08-09,8562
8069,元太,43,6,37,新光-高雄,2024-08-09,8562
00878,國泰永續高股息,149,113,36,新光-高雄,2024-08-09,8562
3455,由田,39,4,35,新光-高雄,2024-08-09,8562
00669R,國泰美國道瓊反1,35,0,35,新光-高雄,2024-08-09,8562
2834,臺企銀,42,8,34,新光-高雄,2024-08-09,8562
8096,擎亞,64,30,34,新光-高雄,2024-08-09,8562
4513,福裕,57,23,34,新光-高雄,2024-08-09,8562
00895,富邦未來車,33,0,33,新光-高雄,2024-08-09,8562
5443,均豪,101,68,33,新光-高雄,2024-08-09,8562
00933B,國泰10Y+金融債,44,11,33,新光-高雄,2024-08-09,8562
2365,昆盈,347,315,32,新光-高雄,2024-08-09,8562
00951,台新日本半導體,43,12,31,新光-高雄,2024-08-09,8562
8996,高力,38,7,31,新光-高雄,2024-08-09,8562
2353,宏��,60,31,29,新光-高雄,2024-08-09,8562
2603,長榮,113,85,28,新光-高雄,2024-08-09,8562
00947,台新臺灣IC設計,31,3,28,新光-高雄,2024-08-09,8562
2609,陽明,99,71,28,新光-高雄,2024-08-09,8562
912000,晨訊科-DR,26,0,26,新光-高雄,2024-08-09,8562
5263,智崴,27,4,23,新光-高雄,2024-08-09,8562
3363,上詮,28,5,23,新光-高雄,2024-08-09,8562
8028,昇陽半導體,61,38,23,新光-高雄,2024-08-09,8562
3706,神達,23,1,22,新光-高雄,2024-08-09,8562
9958,世紀鋼,49,27,22,新光-高雄,2024-08-09,8562
2312,金寶,81,59,22,新光-高雄,2024-08-09,8562
00688L,國泰20年美債正2,778,66,712,新光-高雄,2024-08-12,8562
00937B,群益ESG投等債20,479,89,390,新光-高雄,2024-08-12,8562
00680L,元大美債20正2,326,26,300,新光-高雄,2024-08-12,8562
00948B,中信優息投資級債,250,0,250,新光-高雄,2024-08-12,8562
2888,新光金,408,189,219,新光-高雄,2024-08-12,8562
00679B,元大美債20年,257,65,192,新光-高雄,2024-08-12,8562
00857B,永豐20年美公債,186,0,186,新光-高雄,2024-08-12,8562
3481,群創,366,200,166,新光-高雄,2024-08-12,8562
2609,陽明,272,117,155,新光-高雄,2024-08-12,8562
2402,毅嘉,157,54,103,新光-高雄,2024-08-12,8562
3580,友威科,108,6,102,新光-高雄,2024-08-12,8562
2883,凱基金,157,59,98,新光-高雄,2024-08-12,8562
00929,復華台灣科技優息,309,213,96,新光-高雄,2024-08-12,8562
00676R,富邦臺灣加權反1,103,10,93,新光-高雄,2024-08-12,8562
00923,群益台ESG低碳50,97,4,93,新光-高雄,2024-08-12,8562
00687B,國泰20年美債,166,84,82,新光-高雄,2024-08-12,8562
00936,台新永續高息中小,90,10,80,新光-高雄,2024-08-12,8562
2312,金寶,239,165,74,新光-高雄,2024-08-12,8562
00882,中信中國高股息,60,0,60,新光-高雄,2024-08-12,8562
2061,風青,60,0,60,新光-高雄,2024-08-12,8562
00725B,國泰投資級公司債,56,0,56,新光-高雄,2024-08-12,8562
00795B,中信美國公債20年,58,4,54,新光-高雄,2024-08-12,8562
3663,鑫科,148,95,53,新光-高雄,2024-08-12,8562
3455,由田,67,15,52,新光-高雄,2024-08-12,8562
00713,元大台灣高息低波,55,6,49,新光-高雄,2024-08-12,8562
00915,凱基優選高股息30,55,8,47,新光-高雄,2024-08-12,8562
00931B,統一美債20年,56,11,45,新光-高雄,2024-08-12,8562
3230,錦明,59,14,45,新光-高雄,2024-08-12,8562
00751B,元大AAA至A公司債,44,0,44,新光-高雄,2024-08-12,8562
912000,晨訊科-DR,39,0,39,新光-高雄,2024-08-12,8562
4562,穎漢,198,160,38,新光-高雄,2024-08-12,8562
2515,中工,34,0,34,新光-高雄,2024-08-12,8562
2834,臺企銀,54,21,33,新光-高雄,2024-08-12,8562
00919,群益台灣精選高息,77,44,33,新光-高雄,2024-08-12,8562
3363,上詮,37,5,32,新光-高雄,2024-08-12,8562
2468,華經,41,10,31,新光-高雄,2024-08-12,8562
00933B,國泰10Y+金融債,39,10,29,新光-高雄,2024-08-12,8562
5880,合庫金,30,1,29,新光-高雄,2024-08-12,8562
4958,臻鼎-KY,33,4,29,新光-高雄,2024-08-12,8562
006208,富邦台50,35,6,29,新光-高雄,2024-08-12,8562
3450,聯鈞,92,64,28,新光-高雄,2024-08-12,8562
6612,奈米醫材,27,0,27,新光-高雄,2024-08-12,8562
3048,益登,42,15,27,新光-高雄,2024-08-12,8562
6156,松上,32,5,27,新光-高雄,2024-08-12,8562
00946,群益科技高息成長,34,7,27,新光-高雄,2024-08-12,8562
1301,台塑,27,3,24,新光-高雄,2024-08-12,8562
00637L,元大滬深300正2,53,30,23,新光-高雄,2024-08-12,8562
1316,上曜,150,129,21,新光-高雄,2024-08-12,8562
2201,裕隆,21,1,20,新光-高雄,2024-08-12,8562
1447,力鵬,20,0,20,新光-高雄,2024-08-12,8562
00632R,元大台灣50反1,498,180,318,新光-高雄,2024-08-13,8562
00688L,國泰20年美債正2,259,11,248,新光-高雄,2024-08-13,8562
00948B,中信優息投資級債,241,0,241,新光-高雄,2024-08-13,8562
00680L,元大美債20正2,282,45,237,新光-高雄,2024-08-13,8562
00936,台新永續高息中小,186,5,181,新光-高雄,2024-08-13,8562
00937B,群益ESG投等債20,310,129,181,新光-高雄,2024-08-13,8562
2880,華南金,101,0,101,新光-高雄,2024-08-13,8562
00712,復華富時不動產,103,8,95,新光-高雄,2024-08-13,8562
00878,國泰永續高股息,145,57,88,新光-高雄,2024-08-13,8562
00679B,元大美債20年,197,114,83,新光-高雄,2024-08-13,8562
00631L,元大台灣50正2,91,19,72,新光-高雄,2024-08-13,8562
00857B,永豐20年美公債,67,0,67,新光-高雄,2024-08-13,8562
00919,群益台灣精選高息,112,46,66,新光-高雄,2024-08-13,8562
8096,擎亞,191,127,64,新光-高雄,2024-08-13,8562
4720,德淵,62,2,60,新光-高雄,2024-08-13,8562
2891,中信金,102,48,54,新光-高雄,2024-08-13,8562
8107,大億金茂,75,24,51,新光-高雄,2024-08-13,8562
3481,群創,178,128,50,新光-高雄,2024-08-13,8562
1314,中石化,49,0,49,新光-高雄,2024-08-13,8562
00637L,元大滬深300正2,52,3,49,新光-高雄,2024-08-13,8562
00673R,期元大S＆P原油反1,48,0,48,新光-高雄,2024-08-13,8562
2615,萬海,112,66,46,新光-高雄,2024-08-13,8562
2204,中華,49,3,46,新光-高雄,2024-08-13,8562
00795B,中信美國公債20年,47,3,44,新光-高雄,2024-08-13,8562
2301,光寶科,89,45,44,新光-高雄,2024-08-13,8562
1101,台泥,49,11,38,新光-高雄,2024-08-13,8562
2359,所羅門,141,104,37,新光-高雄,2024-08-13,8562
2312,金寶,37,2,35,新光-高雄,2024-08-13,8562
1301,台塑,37,2,35,新光-高雄,2024-08-13,8562
2610,華航,39,6,33,新光-高雄,2024-08-13,8562
2477,美隆電,33,0,33,新光-高雄,2024-08-13,8562
2317,鴻海,153,124,29,新光-高雄,2024-08-13,8562
00706L,期元大S＆P日圓正2,29,0,29,新光-高雄,2024-08-13,8562
3013,晟銘電,199,171,28,新光-高雄,2024-08-13,8562
3264,欣銓,28,0,28,新光-高雄,2024-08-13,8562
1321,大洋,39,11,28,新光-高雄,2024-08-13,8562
00929,復華台灣科技優息,252,224,28,新光-高雄,2024-08-13,8562
2603,長榮,56,28,28,新光-高雄,2024-08-13,8562
2834,臺企銀,72,46,26,新光-高雄,2024-08-13,8562
00751B,元大AAA至A公司債,26,0,26,新光-高雄,2024-08-13,8562
2886,兆豐金,32,7,25,新光-高雄,2024-08-13,8562
00881,國泰台灣5G+,35,11,24,新光-高雄,2024-08-13,8562
4974,亞泰,23,0,23,新光-高雄,2024-08-13,8562
00907,永豐優息存股,22,0,22,新光-高雄,2024-08-13,8562
00918,大華優利高填息30,24,2,22,新光-高雄,2024-08-13,8562
3706,神達,26,5,21,新光-高雄,2024-08-13,8562
6269,台郡,26,6,20,新光-高雄,2024-08-13,8562
3011,今皓,20,0,20,新光-高雄,2024-08-13,8562
4153,鈺緯,20,0,20,新光-高雄,2024-08-13,8562
1218,泰山,20,0,20,新光-高雄,2024-08-13,8562
00632R,元大台灣50反1,2196,597,1599,新光-高雄,2024-08-14,8562
00937B,群益ESG投等債20,423,99,324,新光-高雄,2024-08-14,8562
00945B,凱基美國非投等債,322,0,322,新光-高雄,2024-08-14,8562
00679B,元大美債20年,365,102,263,新光-高雄,2024-08-14,8562
00706L,期元大S＆P日圓正2,257,10,247,新光-高雄,2024-08-14,8562
2883,凱基金,301,86,215,新光-高雄,2024-08-14,8562
2888,新光金,264,58,206,新光-高雄,2024-08-14,8562
3481,群創,247,54,193,新光-高雄,2024-08-14,8562
2887,台新金,202,36,166,新光-高雄,2024-08-14,8562
1806,冠軍,159,2,157,新光-高雄,2024-08-14,8562
00715L,期街口布蘭特正2,244,93,151,新光-高雄,2024-08-14,8562
2312,金寶,141,23,118,新光-高雄,2024-08-14,8562
2101,南港,106,12,94,新光-高雄,2024-08-14,8562
00665L,富邦�琤肭磪囓�2,133,45,88,新光-高雄,2024-08-14,8562
00795B,中信美國公債20年,89,3,86,新光-高雄,2024-08-14,8562
9907,統一實,101,20,81,新光-高雄,2024-08-14,8562
2356,英業達,158,83,75,新光-高雄,2024-08-14,8562
00637L,元大滬深300正2,71,0,71,新光-高雄,2024-08-14,8562
00687B,國泰20年美債,160,94,66,新光-高雄,2024-08-14,8562
9945,潤泰新,152,87,65,新光-高雄,2024-08-14,8562
00652,富邦印度,61,0,61,新光-高雄,2024-08-14,8562
00936,台新永續高息中小,266,206,60,新光-高雄,2024-08-14,8562
9935,慶豐富,147,88,59,新光-高雄,2024-08-14,8562
2880,華南金,67,10,57,新光-高雄,2024-08-14,8562
4534,慶騰,68,13,55,新光-高雄,2024-08-14,8562
00688L,國泰20年美債正2,174,122,52,新光-高雄,2024-08-14,8562
5443,均豪,96,49,47,新光-高雄,2024-08-14,8562
6462,神盾,51,10,41,新光-高雄,2024-08-14,8562
00857B,永豐20年美公債,40,0,40,新光-高雄,2024-08-14,8562
00949,復華日本龍頭,38,0,38,新光-高雄,2024-08-14,8562
00753L,中信中國50正2,39,1,38,新光-高雄,2024-08-14,8562
2049,上銀,56,19,37,新光-高雄,2024-08-14,8562
3062,建漢,92,55,37,新光-高雄,2024-08-14,8562
00948B,中信優息投資級債,42,10,32,新光-高雄,2024-08-14,8562
00931B,統一美債20年,54,23,31,新光-高雄,2024-08-14,8562
4716,大立,34,3,31,新光-高雄,2024-08-14,8562
2371,大同,41,10,31,新光-高雄,2024-08-14,8562
00671R,富邦NASDAQ反1,30,0,30,新光-高雄,2024-08-14,8562
1536,和大,64,34,30,新光-高雄,2024-08-14,8562
4555,氣立,37,8,29,新光-高雄,2024-08-14,8562
4414,如興,28,0,28,新光-高雄,2024-08-14,8562
4402,郡都開發,27,0,27,新光-高雄,2024-08-14,8562
6186,新潤,40,14,26,新光-高雄,2024-08-14,8562
2363,矽統,61,36,25,新光-高雄,2024-08-14,8562
00633L,富邦上証正2,25,0,25,新光-高雄,2024-08-14,8562
3284,太普高,30,5,25,新光-高雄,2024-08-14,8562
2801,彰銀,24,0,24,新光-高雄,2024-08-14,8562
1532,勤美,50,26,24,新光-高雄,2024-08-14,8562
00881,國泰台灣5G+,36,12,24,新光-高雄,2024-08-14,8562
2392,正崴,25,3,22,新光-高雄,2024-08-14,8562
00680L,元大美債20正2,1010,299,711,新光-高雄,2024-08-15,8562
00632R,元大台灣50反1,682,169,513,新光-高雄,2024-08-15,8562
00900,富邦特選高股息30,443,44,399,新光-高雄,2024-08-15,8562
00878,國泰永續高股息,368,51,317,新光-高雄,2024-08-15,8562
00687B,國泰20年美債,382,79,303,新光-高雄,2024-08-15,8562
00795B,中信美國公債20年,297,0,297,新光-高雄,2024-08-15,8562
2002,中鋼,278,2,276,新光-高雄,2024-08-15,8562
00679B,元大美債20年,362,135,227,新光-高雄,2024-08-15,8562
00945B,凱基美國非投等債,208,0,208,新光-高雄,2024-08-15,8562
2883,凱基金,215,30,185,新光-高雄,2024-08-15,8562
2888,新光金,225,41,184,新光-高雄,2024-08-15,8562
00673R,期元大S＆P原油反1,167,0,167,新光-高雄,2024-08-15,8562
00931B,統一美債20年,135,13,122,新光-高雄,2024-08-15,8562
2610,華航,129,12,117,新光-高雄,2024-08-15,8562
2890,永豐金,114,0,114,新光-高雄,2024-08-15,8562
6005,群益證,110,10,100,新光-高雄,2024-08-15,8562
00664R,國泰臺灣加權反1,100,3,97,新光-高雄,2024-08-15,8562
2834,臺企銀,88,3,85,新光-高雄,2024-08-15,8562
2409,友達,113,28,85,新光-高雄,2024-08-15,8562
6603,富強鑫,135,58,77,新光-高雄,2024-08-15,8562
2317,鴻海,199,126,73,新光-高雄,2024-08-15,8562
00929,復華台灣科技優息,259,187,72,新光-高雄,2024-08-15,8562
00949,復華日本龍頭,68,0,68,新光-高雄,2024-08-15,8562
2349,錸德,86,19,67,新光-高雄,2024-08-15,8562
00948B,中信優息投資級債,82,18,64,新光-高雄,2024-08-15,8562
3019,亞光,193,131,62,新光-高雄,2024-08-15,8562
00951,台新日本半導體,58,1,57,新光-高雄,2024-08-15,8562
3455,由田,55,3,52,新光-高雄,2024-08-15,8562
1101,台泥,96,49,47,新光-高雄,2024-08-15,8562
5469,瀚宇博,47,0,47,新光-高雄,2024-08-15,8562
2867,三商壽,96,49,47,新光-高雄,2024-08-15,8562
00712,復華富時不動產,49,3,46,新光-高雄,2024-08-15,8562
00932,兆豐永續高息等權,50,5,45,新光-高雄,2024-08-15,8562
2497,怡利電,52,8,44,新光-高雄,2024-08-15,8562
2538,基泰,43,0,43,新光-高雄,2024-08-15,8562
2892,第一金,40,0,40,新光-高雄,2024-08-15,8562
6761,穩得,38,0,38,新光-高雄,2024-08-15,8562
00857B,永豐20年美公債,38,1,37,新光-高雄,2024-08-15,8562
6901,鑽石投資,36,1,35,新光-高雄,2024-08-15,8562
8021,尖點,50,16,34,新光-高雄,2024-08-15,8562
00923,群益台ESG低碳50,30,1,29,新光-高雄,2024-08-15,8562
5488,松普,30,2,28,新光-高雄,2024-08-15,8562
8374,羅昇,212,185,27,新光-高雄,2024-08-15,8562
2515,中工,29,3,26,新光-高雄,2024-08-15,8562
4555,氣立,29,3,26,新光-高雄,2024-08-15,8562
2801,彰銀,35,10,25,新光-高雄,2024-08-15,8562
3284,太普高,29,4,25,新光-高雄,2024-08-15,8562
9935,慶豐富,200,176,24,新光-高雄,2024-08-15,8562
1402,遠東新,23,0,23,新光-高雄,2024-08-15,8562
00882,中信中國高股息,22,1,21,新光-高雄,2024-08-15,8562
00632R,元大台灣50反1,1028,427,601,新光-高雄,2024-08-16,8562
00687B,國泰20年美債,544,35,509,新光-高雄,2024-08-16,8562
00676R,富邦臺灣加權反1,410,0,410,新光-高雄,2024-08-16,8562
00688L,國泰20年美債正2,309,50,259,新光-高雄,2024-08-16,8562
00878,國泰永續高股息,257,14,243,新光-高雄,2024-08-16,8562
00936,台新永續高息中小,247,40,207,新光-高雄,2024-08-16,8562
00712,復華富時不動產,186,15,171,新光-高雄,2024-08-16,8562
8096,擎亞,525,357,168,新光-高雄,2024-08-16,8562
00795B,中信美國公債20年,138,1,137,新光-高雄,2024-08-16,8562
2062,橋椿,185,98,87,新光-高雄,2024-08-16,8562
1314,中石化,86,0,86,新光-高雄,2024-08-16,8562
5443,均豪,197,113,84,新光-高雄,2024-08-16,8562
3673,TPK-KY,104,23,81,新光-高雄,2024-08-16,8562
00919,群益台灣精選高息,120,43,77,新光-高雄,2024-08-16,8562
00918,大華優利高填息30,88,13,75,新光-高雄,2024-08-16,8562
2888,新光金,120,46,74,新光-高雄,2024-08-16,8562
9958,世紀鋼,83,11,72,新光-高雄,2024-08-16,8562
00881,國泰台灣5G+,76,15,61,新光-高雄,2024-08-16,8562
5014,建錩,60,0,60,新光-高雄,2024-08-16,8562
00680L,元大美債20正2,485,434,51,新光-高雄,2024-08-16,8562
1584,精剛,56,6,50,新光-高雄,2024-08-16,8562
00706L,期元大S＆P日圓正2,70,22,48,新光-高雄,2024-08-16,8562
3535,晶彩科,94,48,46,新光-高雄,2024-08-16,8562
00900,富邦特選高股息30,74,29,45,新光-高雄,2024-08-16,8562
1101,台泥,77,32,45,新光-高雄,2024-08-16,8562
00931B,統一美債20年,109,65,44,新光-高雄,2024-08-16,8562
2905,三商,75,31,44,新光-高雄,2024-08-16,8562
5302,太欣,40,0,40,新光-高雄,2024-08-16,8562
5905,南仁湖,67,28,39,新光-高雄,2024-08-16,8562
2323,中環,107,68,39,新光-高雄,2024-08-16,8562
2489,瑞軒,181,143,38,新光-高雄,2024-08-16,8562
6265,方土昶,42,4,38,新光-高雄,2024-08-16,8562
2363,矽統,145,108,37,新光-高雄,2024-08-16,8562
9934,成霖,40,3,37,新光-高雄,2024-08-16,8562
2365,昆盈,214,179,35,新光-高雄,2024-08-16,8562
0056,元大高股息,58,25,33,新光-高雄,2024-08-16,8562
1786,科妍,36,3,33,新光-高雄,2024-08-16,8562
3490,單井,49,18,31,新光-高雄,2024-08-16,8562
5512,力麒,50,20,30,新光-高雄,2024-08-16,8562
00673R,期元大S＆P原油反1,29,0,29,新光-高雄,2024-08-16,8562
00671R,富邦NASDAQ反1,27,0,27,新光-高雄,2024-08-16,8562
1303,南亞,36,11,25,新光-高雄,2024-08-16,8562
00696B,富邦美債20年,25,0,25,新光-高雄,2024-08-16,8562
2542,興富發,73,48,25,新光-高雄,2024-08-16,8562
2208,台船,23,2,21,新光-高雄,2024-08-16,8562
2002,中鋼,25,3,22,新光-高雄,2024-08-16,8562
00945B,凱基美國非投等債,21,0,21,新光-高雄,2024-08-16,8562
00719B,元大美債1-3,21,0,21,新光-高雄,2024-08-16,8562
6197,佳必琪,41,20,21,新光-高雄,2024-08-16,8562
6126,信音,27,7,20,新光-高雄,2024-08-16,8562
2888,新光金,745,108,637,新光-高雄,2024-08-19,8562
00687B,國泰20年美債,387,9,378,新光-高雄,2024-08-19,8562
00923,群益台ESG低碳50,319,8,311,新光-高雄,2024-08-19,8562
00632R,元大台灣50反1,361,136,225,新光-高雄,2024-08-19,8562
00948B,中信優息投資級債,226,8,218,新光-高雄,2024-08-19,8562
00680L,元大美債20正2,291,74,217,新光-高雄,2024-08-19,8562
00715L,期街口布蘭特正2,138,0,138,新光-高雄,2024-08-19,8562
00795B,中信美國公債20年,131,0,131,新光-高雄,2024-08-19,8562
00929,復華台灣科技優息,388,275,113,新光-高雄,2024-08-19,8562
2883,凱基金,106,5,101,新光-高雄,2024-08-19,8562
2891,中信金,105,8,97,新光-高雄,2024-08-19,8562
00712,復華富時不動產,95,14,81,新光-高雄,2024-08-19,8562
1101,台泥,72,1,71,新光-高雄,2024-08-19,8562
6133,金橋,72,3,69,新光-高雄,2024-08-19,8562
2405,輔信,78,10,68,新光-高雄,2024-08-19,8562
00945B,凱基美國非投等債,68,0,68,新光-高雄,2024-08-19,8562
00878,國泰永續高股息,127,68,59,新光-高雄,2024-08-19,8562
2002,中鋼,69,10,59,新光-高雄,2024-08-19,8562
4526,東台,80,22,58,新光-高雄,2024-08-19,8562
2243,宏旭-KY,67,11,56,新光-高雄,2024-08-19,8562
2467,志聖,85,30,55,新光-高雄,2024-08-19,8562
2610,華航,58,3,55,新光-高雄,2024-08-19,8562
4562,穎漢,118,65,53,新光-高雄,2024-08-19,8562
2062,橋椿,173,126,47,新光-高雄,2024-08-19,8562
5905,南仁湖,109,62,47,新光-高雄,2024-08-19,8562
3013,晟銘電,91,45,46,新光-高雄,2024-08-19,8562
00688L,國泰20年美債正2,108,66,42,新光-高雄,2024-08-19,8562
8071,能率網通,61,20,41,新光-高雄,2024-08-19,8562
00671R,富邦NASDAQ反1,50,10,40,新光-高雄,2024-08-19,8562
00881,國泰台灣5G+,57,18,39,新光-高雄,2024-08-19,8562
9904,寶成,49,12,37,新光-高雄,2024-08-19,8562
00753L,中信中國50正2,39,3,36,新光-高雄,2024-08-19,8562
2312,金寶,85,50,35,新光-高雄,2024-08-19,8562
4956,光鋐,65,30,35,新光-高雄,2024-08-19,8562
00713,元大台灣高息低波,37,5,32,新光-高雄,2024-08-19,8562
3052,夆典,30,0,30,新光-高雄,2024-08-19,8562
9902,台火,41,11,30,新光-高雄,2024-08-19,8562
1611,中電,81,52,29,新光-高雄,2024-08-19,8562
00933B,國泰10Y+金融債,33,7,26,新光-高雄,2024-08-19,8562
2412,中華電,26,2,24,新光-高雄,2024-08-19,8562
3490,單井,120,97,23,新光-高雄,2024-08-19,8562
1786,科妍,22,0,22,新光-高雄,2024-08-19,8562
8039,台虹,22,0,22,新光-高雄,2024-08-19,8562
1316,上曜,60,38,22,新光-高雄,2024-08-19,8562
2402,毅嘉,25,3,22,新光-高雄,2024-08-19,8562
3047,訊舟,250,229,21,新光-高雄,2024-08-19,8562
6727,亞泰金屬,46,25,21,新光-高雄,2024-08-19,8562
2615,萬海,50,31,19,新光-高雄,2024-08-19,8562
2356,英業達,31,12,19,新光-高雄,2024-08-19,8562
4566,時碩工業,54,36,18,新光-高雄,2024-08-19,8562
00680L,元大美債20正2,756,53,703,新光-高雄,2024-08-20,8562
00687B,國泰20年美債,647,10,637,新光-高雄,2024-08-20,8562
00715L,期街口布蘭特正2,396,50,346,新光-高雄,2024-08-20,8562
00937B,群益ESG投等債20,464,128,336,新光-高雄,2024-08-20,8562
00929,復華台灣科技優息,186,68,118,新光-高雄,2024-08-20,8562
1785,光洋科,178,62,116,新光-高雄,2024-08-20,8562
6005,群益證,101,0,101,新光-高雄,2024-08-20,8562
00706L,期元大S＆P日圓正2,90,0,90,新光-高雄,2024-08-20,8562
1303,南亞,82,2,80,新光-高雄,2024-08-20,8562
2204,中華,79,6,73,新光-高雄,2024-08-20,8562
9934,成霖,50,0,50,新光-高雄,2024-08-20,8562
2317,鴻海,123,74,49,新光-高雄,2024-08-20,8562
2356,英業達,93,45,48,新光-高雄,2024-08-20,8562
00923,群益台ESG低碳50,53,5,48,新光-高雄,2024-08-20,8562
00795B,中信美國公債20年,46,0,46,新光-高雄,2024-08-20,8562
00907,永豐優息存股,43,0,43,新光-高雄,2024-08-20,8562
00915,凱基優選高股息30,43,1,42,新光-高雄,2024-08-20,8562
2106,建大,40,0,40,新光-高雄,2024-08-20,8562
9945,潤泰新,73,33,40,新光-高雄,2024-08-20,8562
4714,永捷,40,0,40,新光-高雄,2024-08-20,8562
4540,全球傳動,51,11,40,新光-高雄,2024-08-20,8562
1326,台化,44,5,39,新光-高雄,2024-08-20,8562
00642U,期元大S＆P石油,36,0,36,新光-高雄,2024-08-20,8562
00650L,復華香港正2,40,5,35,新光-高雄,2024-08-20,8562
00671R,富邦NASDAQ反1,50,15,35,新光-高雄,2024-08-20,8562
2312,金寶,55,22,33,新光-高雄,2024-08-20,8562
00943,兆豐電子高息等權,32,0,32,新光-高雄,2024-08-20,8562
3419,譁裕,30,0,30,新光-高雄,2024-08-20,8562
4909,新復興,88,58,30,新光-高雄,2024-08-20,8562
2030,彰源,30,0,30,新光-高雄,2024-08-20,8562
4109,加捷生醫,51,22,29,新光-高雄,2024-08-20,8562
00948B,中信優息投資級債,31,3,28,新光-高雄,2024-08-20,8562
3047,訊舟,111,83,28,新光-高雄,2024-08-20,8562
2464,盟立,75,48,27,新光-高雄,2024-08-20,8562
4931,新盛力,35,8,27,新光-高雄,2024-08-20,8562
3312,弘憶股,75,48,27,新光-高雄,2024-08-20,8562
00676R,富邦臺灣加權反1,26,0,26,新光-高雄,2024-08-20,8562
2891,中信金,37,12,25,新光-高雄,2024-08-20,8562
1101,台泥,25,1,24,新光-高雄,2024-08-20,8562
5534,長虹,27,4,23,新光-高雄,2024-08-20,8562
6125,廣運,57,34,23,新光-高雄,2024-08-20,8562
3673,TPK-KY,34,12,22,新光-高雄,2024-08-20,8562
00945B,凱基美國非投等債,22,0,22,新光-高雄,2024-08-20,8562
2618,長榮航,46,24,22,新光-高雄,2024-08-20,8562
00720B,元大投資級公司債,21,0,21,新光-高雄,2024-08-20,8562
8028,昇陽半導體,102,81,21,新光-高雄,2024-08-20,8562
5521,工信,21,0,21,新光-高雄,2024-08-20,8562
2352,佳世達,24,4,20,新光-高雄,2024-08-20,8562
2501,國建,24,4,20,新光-高雄,2024-08-20,8562
6958,日盛台駿,27,7,20,新光-高雄,2024-08-20,8562
2891,中信金,655,129,526,新光-高雄,2024-08-21,8562
00688L,國泰20年美債正2,978,608,370,新光-高雄,2024-08-21,8562
4109,加捷生醫,230,35,195,新光-高雄,2024-08-21,8562
00715L,期街口布蘭特正2,249,57,192,新光-高雄,2024-08-21,8562
2887,台新金,179,48,131,新光-高雄,2024-08-21,8562
00945B,凱基美國非投等債,138,8,130,新光-高雄,2024-08-21,8562
00919,群益台灣精選高息,168,45,123,新光-高雄,2024-08-21,8562
2317,鴻海,142,51,91,新光-高雄,2024-08-21,8562
00878,國泰永續高股息,102,14,88,新光-高雄,2024-08-21,8562
00948B,中信優息投資級債,88,10,78,新光-高雄,2024-08-21,8562
00953B,群益優選非投等債,74,0,74,新光-高雄,2024-08-21,8562
3673,TPK-KY,84,14,70,新光-高雄,2024-08-21,8562
00942B,台新美A公司債20+,62,0,62,新光-高雄,2024-08-21,8562
3490,單井,128,70,58,新光-高雄,2024-08-21,8562
2888,新光金,930,873,57,新光-高雄,2024-08-21,8562
6727,亞泰金屬,49,0,49,新光-高雄,2024-08-21,8562
5905,南仁湖,308,263,45,新光-高雄,2024-08-21,8562
00923,群益台ESG低碳50,241,200,41,新光-高雄,2024-08-21,8562
2547,日勝生,40,0,40,新光-高雄,2024-08-21,8562
1609,大亞,65,27,38,新光-高雄,2024-08-21,8562
0056,元大高股息,40,3,37,新光-高雄,2024-08-21,8562
8054,安國,62,28,34,新光-高雄,2024-08-21,8562
5309,系統電,56,23,33,新光-高雄,2024-08-21,8562
1409,新纖,50,18,32,新光-高雄,2024-08-21,8562
00950B,凱基A級公司債,31,0,31,新光-高雄,2024-08-21,8562
2461,光群雷,30,0,30,新光-高雄,2024-08-21,8562
3312,弘憶股,85,56,29,新光-高雄,2024-08-21,8562
6208,日揚,32,4,28,新光-高雄,2024-08-21,8562
4906,正文,61,33,28,新光-高雄,2024-08-21,8562
1218,泰山,27,0,27,新光-高雄,2024-08-21,8562
2542,興富發,37,10,27,新光-高雄,2024-08-21,8562
2392,正崴,38,12,26,新光-高雄,2024-08-21,8562
00931B,統一美債20年,28,4,24,新光-高雄,2024-08-21,8562
1326,台化,23,1,22,新光-高雄,2024-08-21,8562
00631L,元大台灣50正2,42,20,22,新光-高雄,2024-08-21,8562
6570,維田,30,9,21,新光-高雄,2024-08-21,8562
00940,元大台灣價值高息,34,13,21,新光-高雄,2024-08-21,8562
3535,晶彩科,231,209,22,新光-高雄,2024-08-21,8562
00935,野村臺灣新科技50,22,1,21,新光-高雄,2024-08-21,8562
2354,鴻準,55,36,19,新光-高雄,2024-08-21,8562
1416,廣豐,19,0,19,新光-高雄,2024-08-21,8562
00795B,中信美國公債20年,27,9,18,新光-高雄,2024-08-21,8562
2312,金寶,64,45,19,新光-高雄,2024-08-21,8562
2070,精湛,32,15,17,新光-高雄,2024-08-21,8562
2363,矽統,56,39,17,新光-高雄,2024-08-21,8562
00932,兆豐永續高息等權,16,0,16,新光-高雄,2024-08-21,8562
3047,訊舟,305,289,16,新光-高雄,2024-08-21,8562
1321,大洋,16,0,16,新光-高雄,2024-08-21,8562
00665L,富邦�琤肭磪囓�2,51,35,16,新光-高雄,2024-08-21,8562
00772B,中信高評級公司債,16,0,16,新光-高雄,2024-08-21,8562
00715L,期街口布蘭特正2,253,0,253,新光-高雄,2024-08-22,8562
00931B,統一美債20年,251,0,251,新光-高雄,2024-08-22,8562
00687B,國泰20年美債,216,21,195,新光-高雄,2024-08-22,8562
00953B,群益優選非投等債,193,0,193,新光-高雄,2024-08-22,8562
2349,錸德,826,643,183,新光-高雄,2024-08-22,8562
00764B,群益25年美債,177,0,177,新光-高雄,2024-08-22,8562
2891,中信金,198,36,162,新光-高雄,2024-08-22,8562
00907,永豐優息存股,135,0,135,新光-高雄,2024-08-22,8562
2312,金寶,136,35,101,新光-高雄,2024-08-22,8562
00665L,富邦�琤肭磪囓�2,132,44,88,新光-高雄,2024-08-22,8562
2317,鴻海,130,43,87,新光-高雄,2024-08-22,8562
00679B,元大美債20年,156,78,78,新光-高雄,2024-08-22,8562
3455,由田,79,1,78,新光-高雄,2024-08-22,8562
2409,友達,109,34,75,新光-高雄,2024-08-22,8562
00712,復華富時不動產,70,9,61,新光-高雄,2024-08-22,8562
2890,永豐金,472,412,60,新光-高雄,2024-08-22,8562
5309,系統電,197,141,56,新光-高雄,2024-08-22,8562
00795B,中信美國公債20年,57,2,55,新光-高雄,2024-08-22,8562
00675L,富邦臺灣加權正2,58,10,48,新光-高雄,2024-08-22,8562
2851,中再保,82,35,47,新光-高雄,2024-08-22,8562
00940,元大台灣價值高息,64,19,45,新光-高雄,2024-08-22,8562
00733,富邦臺灣中小,45,0,45,新光-高雄,2024-08-22,8562
00642U,期元大S＆P石油,54,9,45,新光-高雄,2024-08-22,8562
5905,南仁湖,145,101,44,新光-高雄,2024-08-22,8562
4903,聯光通,73,32,41,新光-高雄,2024-08-22,8562
1773,勝一,44,7,37,新光-高雄,2024-08-22,8562
2542,興富發,53,17,36,新光-高雄,2024-08-22,8562
00948B,中信優息投資級債,35,0,35,新光-高雄,2024-08-22,8562
2442,新美齊,39,4,35,新光-高雄,2024-08-22,8562
1709,和益,36,2,34,新光-高雄,2024-08-22,8562
4716,大立,123,89,34,新光-高雄,2024-08-22,8562
2524,京城,84,51,33,新光-高雄,2024-08-22,8562
1513,中興電,45,14,31,新光-高雄,2024-08-22,8562
2034,允強,30,0,30,新光-高雄,2024-08-22,8562
6125,廣運,63,33,30,新光-高雄,2024-08-22,8562
8064,東捷,92,66,26,新光-高雄,2024-08-22,8562
6134,萬旭,26,0,26,新光-高雄,2024-08-22,8562
3535,晶彩科,54,28,26,新光-高雄,2024-08-22,8562
6177,達麗,46,21,25,新光-高雄,2024-08-22,8562
1786,科妍,27,2,25,新光-高雄,2024-08-22,8562
00631L,元大台灣50正2,35,11,24,新光-高雄,2024-08-22,8562
5443,均豪,185,160,25,新光-高雄,2024-08-22,8562
2883,凱基金,38,14,24,新光-高雄,2024-08-22,8562
3339,泰谷,27,4,23,新光-高雄,2024-08-22,8562
2354,鴻準,31,8,23,新光-高雄,2024-08-22,8562
00650L,復華香港正2,22,0,22,新光-高雄,2024-08-22,8562
3289,宜特,30,8,22,新光-高雄,2024-08-22,8562
00919,群益台灣精選高息,57,37,20,新光-高雄,2024-08-22,8562
6219,富旺,26,7,19,新光-高雄,2024-08-22,8562
6186,新潤,20,2,18,新光-高雄,2024-08-22,8562
00687B,國泰20年美債,529,3,526,新光-高雄,2024-08-23,8562
00937B,群益ESG投等債20,345,15,330,新光-高雄,2024-08-23,8562
00679B,元大美債20年,305,20,285,新光-高雄,2024-08-23,8562
2891,中信金,287,60,227,新光-高雄,2024-08-23,8562
00688L,國泰20年美債正2,199,0,199,新光-高雄,2024-08-23,8562
1708,東鹼,232,55,177,新光-高雄,2024-08-23,8562
2887,台新金,355,191,164,新光-高雄,2024-08-23,8562
00715L,期街口布蘭特正2,140,13,127,新光-高雄,2024-08-23,8562
1721,三晃,238,123,115,新光-高雄,2024-08-23,8562
00680L,元大美債20正2,234,119,115,新光-高雄,2024-08-23,8562
1409,新纖,139,42,97,新光-高雄,2024-08-23,8562
00753L,中信中國50正2,100,3,97,新光-高雄,2024-08-23,8562
2303,聯電,144,56,88,新光-高雄,2024-08-23,8562
1326,台化,79,3,76,新光-高雄,2024-08-23,8562
00919,群益台灣精選高息,106,29,77,新光-高雄,2024-08-23,8562
00795B,中信美國公債20年,63,4,59,新光-高雄,2024-08-23,8562
00929,復華台灣科技優息,176,119,57,新光-高雄,2024-08-23,8562
4513,福裕,149,100,49,新光-高雄,2024-08-23,8562
8071,能率網通,68,27,41,新光-高雄,2024-08-23,8562
8021,尖點,284,244,40,新光-高雄,2024-08-23,8562
4716,大立,55,17,38,新光-高雄,2024-08-23,8562
3339,泰谷,41,3,38,新光-高雄,2024-08-23,8562
1711,永光,222,187,35,新光-高雄,2024-08-23,8562
8354,冠好,46,15,31,新光-高雄,2024-08-23,8562
1101,台泥,33,3,30,新光-高雄,2024-08-23,8562
4720,德淵,30,0,30,新光-高雄,2024-08-23,8562
2442,新美齊,28,0,28,新光-高雄,2024-08-23,8562
3149,正達,53,25,28,新光-高雄,2024-08-23,8562
2337,旺宏,44,16,28,新光-高雄,2024-08-23,8562
00931B,統一美債20年,62,34,28,新光-高雄,2024-08-23,8562
3645,達邁,85,58,27,新光-高雄,2024-08-23,8562
00764B,群益25年美債,27,0,27,新光-高雄,2024-08-23,8562
3455,由田,26,0,26,新光-高雄,2024-08-23,8562
3652,精聯,36,10,26,新光-高雄,2024-08-23,8562
2467,志聖,48,22,26,新光-高雄,2024-08-23,8562
4729,熒茂,48,23,25,新光-高雄,2024-08-23,8562
4960,誠美材,25,0,25,新光-高雄,2024-08-23,8562
2349,錸德,483,458,25,新光-高雄,2024-08-23,8562
6187,萬潤,25,2,23,新光-高雄,2024-08-23,8562
2371,大同,34,11,23,新光-高雄,2024-08-23,8562
3707,漢磊,40,18,22,新光-高雄,2024-08-23,8562
2402,毅嘉,40,18,22,新光-高雄,2024-08-23,8562
00932,兆豐永續高息等權,27,6,21,新光-高雄,2024-08-23,8562
2330,台積電,53,32,21,新光-高雄,2024-08-23,8562
2542,興富發,27,7,20,新光-高雄,2024-08-23,8562
3060,銘異,20,0,20,新光-高雄,2024-08-23,8562
1536,和大,27,7,20,新光-高雄,2024-08-23,8562
00953B,群益優選非投等債,21,1,20,新光-高雄,2024-08-23,8562
6156,松上,26,7,19,新光-高雄,2024-08-23,8562
2301,光寶科,22,3,19,新光-高雄,2024-08-23,8562
2888,新光金,2301,1565,736,新光-高雄,2024-08-26,8562
00948B,中信優息投資級債,914,217,697,新光-高雄,2024-08-26,8562
00687B,國泰20年美債,591,17,574,新光-高雄,2024-08-26,8562
00937B,群益ESG投等債20,348,100,248,新光-高雄,2024-08-26,8562
00891,中信關鍵半導體,168,8,160,新光-高雄,2024-08-26,8562
00945B,凱基美國非投等債,130,0,130,新光-高雄,2024-08-26,8562
00733,富邦臺灣中小,132,3,129,新光-高雄,2024-08-26,8562
2890,永豐金,119,2,117,新光-高雄,2024-08-26,8562
2851,中再保,108,1,107,新光-高雄,2024-08-26,8562
00679B,元大美債20年,259,154,105,新光-高雄,2024-08-26,8562
8096,擎亞,237,136,101,新光-高雄,2024-08-26,8562
4904,遠傳,117,16,101,新光-高雄,2024-08-26,8562
00676R,富邦臺灣加權反1,100,0,100,新光-高雄,2024-08-26,8562
6606,建德工業,86,2,84,新光-高雄,2024-08-26,8562
2442,新美齊,85,3,82,新光-高雄,2024-08-26,8562
2891,中信金,121,60,61,新光-高雄,2024-08-26,8562
2441,超豐,63,3,60,新光-高雄,2024-08-26,8562
00632R,元大台灣50反1,497,441,56,新光-高雄,2024-08-26,8562
2845,遠東銀,76,22,54,新光-高雄,2024-08-26,8562
4167,松瑞藥,43,0,43,新光-高雄,2024-08-26,8562
00764B,群益25年美債,43,0,43,新光-高雄,2024-08-26,8562
1532,勤美,42,0,42,新光-高雄,2024-08-26,8562
00637L,元大滬深300正2,83,41,42,新光-高雄,2024-08-26,8562
3663,鑫科,52,11,41,新光-高雄,2024-08-26,8562
0056,元大高股息,60,20,40,新光-高雄,2024-08-26,8562
2515,中工,60,20,40,新光-高雄,2024-08-26,8562
3430,奇鈦科,50,11,39,新光-高雄,2024-08-26,8562
2464,盟立,44,7,37,新光-高雄,2024-08-26,8562
8021,尖點,70,34,36,新光-高雄,2024-08-26,8562
2362,藍天,52,17,35,新光-高雄,2024-08-26,8562
3390,旭軟,54,23,31,新光-高雄,2024-08-26,8562
00936,台新永續高息中小,29,0,29,新光-高雄,2024-08-26,8562
00673R,期元大S＆P原油反1,29,0,29,新光-高雄,2024-08-26,8562
00650L,復華香港正2,40,12,28,新光-高雄,2024-08-26,8562
4513,福裕,96,68,28,新光-高雄,2024-08-26,8562
1540,喬福,30,3,27,新光-高雄,2024-08-26,8562
3019,亞光,53,26,27,新光-高雄,2024-08-26,8562
2905,三商,54,28,26,新光-高雄,2024-08-26,8562
4561,健椿,51,27,24,新光-高雄,2024-08-26,8562
1570,力肯,27,3,24,新光-高雄,2024-08-26,8562
2330,台積電,41,18,23,新光-高雄,2024-08-26,8562
2323,中環,23,0,23,新光-高雄,2024-08-26,8562
2409,友達,89,67,22,新光-高雄,2024-08-26,8562
2402,毅嘉,147,125,22,新光-高雄,2024-08-26,8562
3231,緯創,37,16,21,新光-高雄,2024-08-26,8562
8028,昇陽半導體,140,119,21,新光-高雄,2024-08-26,8562
2317,鴻海,59,38,21,新光-高雄,2024-08-26,8562
3017,奇鋐,37,16,21,新光-高雄,2024-08-26,8562
5608,四維航,25,4,21,新光-高雄,2024-08-26,8562
2356,英業達,48,29,19,新光-高雄,2024-08-26,8562
2891,中信金,307,22,285,新光-高雄,2024-08-27,8562
00673R,期元大S＆P原油反1,203,0,203,新光-高雄,2024-08-27,8562
2303,聯電,225,54,171,新光-高雄,2024-08-27,8562
2887,台新金,190,43,147,新光-高雄,2024-08-27,8562
00680L,元大美債20正2,228,83,145,新光-高雄,2024-08-27,8562
3481,群創,352,214,138,新光-高雄,2024-08-27,8562
00929,復華台灣科技優息,189,57,132,新光-高雄,2024-08-27,8562
8027,鈦昇,142,30,112,新光-高雄,2024-08-27,8562
00919,群益台灣精選高息,126,24,102,新光-高雄,2024-08-27,8562
1773,勝一,89,0,89,新光-高雄,2024-08-27,8562
2317,鴻海,92,12,80,新光-高雄,2024-08-27,8562
2344,華邦電,77,2,75,新光-高雄,2024-08-27,8562
00688L,國泰20年美債正2,70,1,69,新光-高雄,2024-08-27,8562
2845,遠東銀,63,0,63,新光-高雄,2024-08-27,8562
00687B,國泰20年美債,202,140,62,新光-高雄,2024-08-27,8562
2367,燿華,76,16,60,新光-高雄,2024-08-27,8562
3576,聯合再生,65,9,56,新光-高雄,2024-08-27,8562
2429,銘旺科,56,3,53,新光-高雄,2024-08-27,8562
00795B,中信美國公債20年,55,2,53,新光-高雄,2024-08-27,8562
5469,瀚宇博,75,27,48,新光-高雄,2024-08-27,8562
3430,奇鈦科,70,25,45,新光-高雄,2024-08-27,8562
2883,凱基金,50,5,45,新光-高雄,2024-08-27,8562
00675L,富邦臺灣加權正2,46,3,43,新光-高雄,2024-08-27,8562
6548,長科*,44,1,43,新光-高雄,2024-08-27,8562
2610,華航,43,1,42,新光-高雄,2024-08-27,8562
2356,英業達,90,50,40,新光-高雄,2024-08-27,8562
3450,聯鈞,115,76,39,新光-高雄,2024-08-27,8562
3707,漢磊,67,32,35,新光-高雄,2024-08-27,8562
4729,熒茂,34,0,34,新光-高雄,2024-08-27,8562
4526,東台,93,60,33,新光-高雄,2024-08-27,8562
1409,新纖,62,29,33,新光-高雄,2024-08-27,8562
2465,麗臺,36,4,32,新光-高雄,2024-08-27,8562
2609,陽明,39,7,32,新光-高雄,2024-08-27,8562
00706L,期元大S＆P日圓正2,35,3,32,新光-高雄,2024-08-27,8562
2851,中再保,31,0,31,新光-高雄,2024-08-27,8562
2615,萬海,53,23,30,新光-高雄,2024-08-27,8562
1711,永光,88,62,26,新光-高雄,2024-08-27,8562
2382,廣達,33,9,24,新光-高雄,2024-08-27,8562
00679B,元大美債20年,71,48,23,新光-高雄,2024-08-27,8562
6415,矽力*-KY,25,2,23,新光-高雄,2024-08-27,8562
2323,中環,22,0,22,新光-高雄,2024-08-27,8562
4979,華星光,29,8,21,新光-高雄,2024-08-27,8562
00631L,元大台灣50正2,44,23,21,新光-高雄,2024-08-27,8562
1304,台聚,21,1,20,新光-高雄,2024-08-27,8562
00878,國泰永續高股息,52,32,20,新光-高雄,2024-08-27,8562
00940,元大台灣價值高息,21,2,19,新光-高雄,2024-08-27,8562
9945,潤泰新,25,6,19,新光-高雄,2024-08-27,8562
00733,富邦臺灣中小,19,0,19,新光-高雄,2024-08-27,8562
00893,國泰智能電動車,18,0,18,新光-高雄,2024-08-27,8562
2880,華南金,19,2,17,新光-高雄,2024-08-27,8562
3481,群創,1107,189,918,新光-高雄,2024-08-28,8562
00940,元大台灣價值高息,543,12,531,新光-高雄,2024-08-28,8562
00632R,元大台灣50反1,665,264,401,新光-高雄,2024-08-28,8562
00688L,國泰20年美債正2,265,6,259,新光-高雄,2024-08-28,8562
00637L,元大滬深300正2,225,35,190,新光-高雄,2024-08-28,8562
9934,成霖,171,7,164,新光-高雄,2024-08-28,8562
00680L,元大美債20正2,178,19,159,新光-高雄,2024-08-28,8562
2891,中信金,167,39,128,新光-高雄,2024-08-28,8562
2897,王道銀行,101,0,101,新光-高雄,2024-08-28,8562
00937B,群益ESG投等債20,128,33,95,新光-高雄,2024-08-28,8562
2442,新美齊,89,10,79,新光-高雄,2024-08-28,8562
00959B,大華投等美債15Y+,69,0,69,新光-高雄,2024-08-28,8562
2402,毅嘉,122,56,66,新光-高雄,2024-08-28,8562
2543,皇昌,92,33,59,新光-高雄,2024-08-28,8562
00919,群益台灣精選高息,75,22,53,新光-高雄,2024-08-28,8562
2367,燿華,161,109,52,新光-高雄,2024-08-28,8562
4720,德淵,53,4,49,新光-高雄,2024-08-28,8562
00795B,中信美國公債20年,62,19,43,新光-高雄,2024-08-28,8562
8039,台虹,123,80,43,新光-高雄,2024-08-28,8562
00687B,國泰20年美債,187,145,42,新光-高雄,2024-08-28,8562
2354,鴻準,50,9,41,新光-高雄,2024-08-28,8562
2845,遠東銀,62,25,37,新光-高雄,2024-08-28,8562
00713,元大台灣高息低波,42,6,36,新光-高雄,2024-08-28,8562
00948B,中信優息投資級債,37,1,36,新光-高雄,2024-08-28,8562
1591,駿吉-KY,33,0,33,新光-高雄,2024-08-28,8562
2890,永豐金,40,7,33,新光-高雄,2024-08-28,8562
2913,農林,29,0,29,新光-高雄,2024-08-28,8562
2464,盟立,95,66,29,新光-高雄,2024-08-28,8562
00753L,中信中國50正2,27,0,27,新光-高雄,2024-08-28,8562
3673,TPK-KY,43,17,26,新光-高雄,2024-08-28,8562
1409,新纖,25,0,25,新光-高雄,2024-08-28,8562
3550,聯穎,52,28,24,新光-高雄,2024-08-28,8562
4562,穎漢,72,49,23,新光-高雄,2024-08-28,8562
2515,中工,25,2,23,新光-高雄,2024-08-28,8562
2353,宏��,24,2,22,新光-高雄,2024-08-28,8562
2049,上銀,71,50,21,新光-高雄,2024-08-28,8562
3522,御嵿,27,6,21,新光-高雄,2024-08-28,8562
3265,台星科,21,0,21,新光-高雄,2024-08-28,8562
00655L,國泰中國A50正2,31,10,21,新光-高雄,2024-08-28,8562
3498,陽程,44,23,21,新光-高雄,2024-08-28,8562
5386,青雲,78,57,21,新光-高雄,2024-08-28,8562
2385,群光,22,1,21,新光-高雄,2024-08-28,8562
9105,泰金寶-DR,20,0,20,新光-高雄,2024-08-28,8562
3048,益登,23,3,20,新光-高雄,2024-08-28,8562
1597,直得,41,21,20,新光-高雄,2024-08-28,8562
3483,力致,19,0,19,新光-高雄,2024-08-28,8562
3049,精金,21,2,19,新光-高雄,2024-08-28,8562
3013,晟銘電,31,12,19,新光-高雄,2024-08-28,8562
8096,擎亞,48,29,19,新光-高雄,2024-08-28,8562
5871,中租-KY,30,12,18,新光-高雄,2024-08-28,8562
00680L,元大美債20正2,471,40,431,新光-高雄,2024-08-29,8562
00688L,國泰20年美債正2,290,23,267,新光-高雄,2024-08-29,8562
1314,中石化,255,5,250,新光-高雄,2024-08-29,8562
00687B,國泰20年美債,303,65,238,新光-高雄,2024-08-29,8562
2891,中信金,197,11,186,新光-高雄,2024-08-29,8562
00679B,元大美債20年,195,22,173,新光-高雄,2024-08-29,8562
3481,群創,184,61,123,新光-高雄,2024-08-29,8562
1721,三晃,200,82,118,新光-高雄,2024-08-29,8562
00675L,富邦臺灣加權正2,130,20,110,新光-高雄,2024-08-29,8562
8011,台通,134,26,108,新光-高雄,2024-08-29,8562
3550,聯穎,138,48,90,新光-高雄,2024-08-29,8562
00631L,元大台灣50正2,98,23,75,新光-高雄,2024-08-29,8562
2002,中鋼,80,7,73,新光-高雄,2024-08-29,8562
2349,錸德,149,77,72,新光-高雄,2024-08-29,8562
2880,華南金,71,0,71,新光-高雄,2024-08-29,8562
3289,宜特,68,9,59,新光-高雄,2024-08-29,8562
3430,奇鈦科,62,3,59,新光-高雄,2024-08-29,8562
2913,農林,81,34,47,新光-高雄,2024-08-29,8562
2367,燿華,183,136,47,新光-高雄,2024-08-29,8562
00948B,中信優息投資級債,55,10,45,新光-高雄,2024-08-29,8562
2888,新光金,271,228,43,新光-高雄,2024-08-29,8562
00720B,元大投資級公司債,41,1,40,新光-高雄,2024-08-29,8562
2887,台新金,52,14,38,新光-高雄,2024-08-29,8562
9934,成霖,35,0,35,新光-高雄,2024-08-29,8562
1536,和大,35,2,33,新光-高雄,2024-08-29,8562
00830,國泰費城半導體,35,3,32,新光-高雄,2024-08-29,8562
1409,新纖,45,14,31,新光-高雄,2024-08-29,8562
3060,銘異,30,0,30,新光-高雄,2024-08-29,8562
6126,信音,32,2,30,新光-高雄,2024-08-29,8562
2330,台積電,46,17,29,新光-高雄,2024-08-29,8562
6603,富強鑫,273,244,29,新光-高雄,2024-08-29,8562
6438,迅得,40,12,28,新光-高雄,2024-08-29,8562
5521,工信,31,3,28,新光-高雄,2024-08-29,8562
00795B,中信美國公債20年,28,0,28,新光-高雄,2024-08-29,8562
2356,英業達,40,13,27,新光-高雄,2024-08-29,8562
00953B,群益優選非投等債,28,1,27,新光-高雄,2024-08-29,8562
2324,仁寶,32,6,26,新光-高雄,2024-08-29,8562
00915,凱基優選高股息30,26,0,26,新光-高雄,2024-08-29,8562
8070,長華*,51,26,25,新光-高雄,2024-08-29,8562
5522,遠雄,25,0,25,新光-高雄,2024-08-29,8562
4903,聯光通,34,9,25,新光-高雄,2024-08-29,8562
00857B,永豐20年美公債,24,0,24,新光-高雄,2024-08-29,8562
2890,永豐金,25,2,23,新光-高雄,2024-08-29,8562
00935,野村臺灣新科技50,24,1,23,新光-高雄,2024-08-29,8562
3455,由田,25,2,23,新光-高雄,2024-08-29,8562
6770,力積電,22,0,22,新光-高雄,2024-08-29,8562
3149,正達,81,59,22,新光-高雄,2024-08-29,8562
1109,信大,21,0,21,新光-高雄,2024-08-29,8562
2883,凱基金,26,6,20,新光-高雄,2024-08-29,8562
2340,台亞,27,7,20,新光-高雄,2024-08-29,8562
00688L,國泰20年美債正2,398,9,389,新光-高雄,2024-08-30,8562
00687B,國泰20年美債,359,27,332,新光-高雄,2024-08-30,8562
00680L,元大美債20正2,296,0,296,新光-高雄,2024-08-30,8562
1711,永光,347,167,180,新光-高雄,2024-08-30,8562
2477,美隆電,177,4,173,新光-高雄,2024-08-30,8562
2891,中信金,196,23,173,新光-高雄,2024-08-30,8562
9907,統一實,120,0,120,新光-高雄,2024-08-30,8562
3481,群創,138,18,120,新光-高雄,2024-08-30,8562
6257,矽格,122,5,117,新光-高雄,2024-08-30,8562
00936,台新永續高息中小,128,12,116,新光-高雄,2024-08-30,8562
912000,晨訊科-DR,115,0,115,新光-高雄,2024-08-30,8562
2439,美律,111,9,102,新光-高雄,2024-08-30,8562
00959B,大華投等美債15Y+,101,0,101,新光-高雄,2024-08-30,8562
9902,台火,100,0,100,新光-高雄,2024-08-30,8562
8011,台通,102,19,83,新光-高雄,2024-08-30,8562
00948B,中信優息投資級債,78,0,78,新光-高雄,2024-08-30,8562
2409,友達,86,13,73,新光-高雄,2024-08-30,8562
2408,南亞科,80,7,73,新光-高雄,2024-08-30,8562
2618,長榮航,105,33,72,新光-高雄,2024-08-30,8562
4906,正文,93,38,55,新光-高雄,2024-08-30,8562
2323,中環,53,0,53,新光-高雄,2024-08-30,8562
1314,中石化,85,35,50,新光-高雄,2024-08-30,8562
00753L,中信中國50正2,52,3,49,新光-高雄,2024-08-30,8562
6290,良維,55,7,48,新光-高雄,2024-08-30,8562
3066,李洲,83,36,47,新光-高雄,2024-08-30,8562
2464,盟立,100,54,46,新光-高雄,2024-08-30,8562
6134,萬旭,51,5,46,新光-高雄,2024-08-30,8562
2801,彰銀,47,2,45,新光-高雄,2024-08-30,8562
1721,三晃,72,29,43,新光-高雄,2024-08-30,8562
2610,華航,43,0,43,新光-高雄,2024-08-30,8562
3645,達邁,52,11,41,新光-高雄,2024-08-30,8562
00907,永豐優息存股,41,1,40,新光-高雄,2024-08-30,8562
2062,橋椿,40,0,40,新光-高雄,2024-08-30,8562
2845,遠東銀,38,0,38,新光-高雄,2024-08-30,8562
2425,承啟,133,96,37,新光-高雄,2024-08-30,8562
3189,景碩,91,57,34,新光-高雄,2024-08-30,8562
8064,東捷,75,42,33,新光-高雄,2024-08-30,8562
5474,聰泰,37,4,33,新光-高雄,2024-08-30,8562
6213,聯茂,163,131,32,新光-高雄,2024-08-30,8562
00918,大華優利高填息30,42,12,30,新光-高雄,2024-08-30,8562
2442,新美齊,49,20,29,新光-高雄,2024-08-30,8562
3580,友威科,49,21,28,新光-高雄,2024-08-30,8562
3049,精金,35,7,28,新光-高雄,2024-08-30,8562
2851,中再保,30,3,27,新光-高雄,2024-08-30,8562
1786,科妍,31,4,27,新光-高雄,2024-08-30,8562
3037,欣興,47,20,27,新光-高雄,2024-08-30,8562
6164,華興,64,38,26,新光-高雄,2024-08-30,8562
5534,長虹,27,1,26,新光-高雄,2024-08-30,8562
2363,矽統,31,7,24,新光-高雄,2024-08-30,8562
3374,精材,38,13,25,新光-高雄,2024-08-30,8562
00680L,元大美債20正2,890,38,852,新光-高雄,2024-09-02,8562
00688L,國泰20年美債正2,707,9,698,新光-高雄,2024-09-02,8562
00715L,期街口布蘭特正2,574,60,514,新光-高雄,2024-09-02,8562
2883,凱基金,514,27,487,新光-高雄,2024-09-02,8562
00687B,國泰20年美債,361,82,279,新光-高雄,2024-09-02,8562
00937B,群益ESG投等債20,304,52,252,新光-高雄,2024-09-02,8562
00637L,元大滬深300正2,233,0,233,新光-高雄,2024-09-02,8562
00632R,元大台灣50反1,240,54,186,新光-高雄,2024-09-02,8562
2002,中鋼,136,3,133,新光-高雄,2024-09-02,8562
00669R,國泰美國道瓊反1,129,0,129,新光-高雄,2024-09-02,8562
2344,華邦電,134,25,109,新光-高雄,2024-09-02,8562
1314,中石化,109,6,103,新光-高雄,2024-09-02,8562
00931B,統一美債20年,96,0,96,新光-高雄,2024-09-02,8562
00642U,期元大S＆P石油,89,0,89,新光-高雄,2024-09-02,8562
2495,普安,172,92,80,新光-高雄,2024-09-02,8562
8105,凌巨,210,131,79,新光-高雄,2024-09-02,8562
00795B,中信美國公債20年,75,0,75,新光-高雄,2024-09-02,8562
00919,群益台灣精選高息,129,55,74,新光-高雄,2024-09-02,8562
00706L,期元大S＆P日圓正2,75,9,66,新光-高雄,2024-09-02,8562
3380,明泰,83,17,66,新光-高雄,2024-09-02,8562
6770,力積電,62,0,62,新光-高雄,2024-09-02,8562
6743,安普新,73,13,60,新光-高雄,2024-09-02,8562
4306,炎洲,208,150,58,新光-高雄,2024-09-02,8562
00918,大華優利高填息30,62,9,53,新光-高雄,2024-09-02,8562
00887,永豐中國科技50大,58,6,52,新光-高雄,2024-09-02,8562
3078,僑威,51,1,50,新光-高雄,2024-09-02,8562
00948B,中信優息投資級債,75,25,50,新光-高雄,2024-09-02,8562
8107,大億金茂,75,26,49,新光-高雄,2024-09-02,8562
2543,皇昌,62,19,43,新光-高雄,2024-09-02,8562
1326,台化,46,4,42,新光-高雄,2024-09-02,8562
00907,永豐優息存股,48,6,42,新光-高雄,2024-09-02,8562
00915,凱基優選高股息30,52,10,42,新光-高雄,2024-09-02,8562
3290,東浦,37,0,37,新光-高雄,2024-09-02,8562
00665L,富邦�琤肭磪囓�2,90,55,35,新光-高雄,2024-09-02,8562
2049,上銀,45,13,32,新光-高雄,2024-09-02,8562
2603,長榮,82,52,30,新光-高雄,2024-09-02,8562
00959B,大華投等美債15Y+,33,4,29,新光-高雄,2024-09-02,8562
00933B,國泰10Y+金融債,41,13,28,新光-高雄,2024-09-02,8562
2609,陽明,43,15,28,新光-高雄,2024-09-02,8562
3390,旭軟,63,36,27,新光-高雄,2024-09-02,8562
00936,台新永續高息中小,28,1,27,新光-高雄,2024-09-02,8562
00650L,復華香港正2,31,5,26,新光-高雄,2024-09-02,8562
2537,聯上發,84,58,26,新光-高雄,2024-09-02,8562
1316,上曜,71,45,26,新光-高雄,2024-09-02,8562
2905,三商,26,0,26,新光-高雄,2024-09-02,8562
2408,南亞科,42,16,26,新光-高雄,2024-09-02,8562
2880,華南金,28,3,25,新光-高雄,2024-09-02,8562
2890,永豐金,26,2,24,新光-高雄,2024-09-02,8562
2313,華通,56,32,24,新光-高雄,2024-09-02,8562
2363,矽統,43,19,24,新光-高雄,2024-09-02,8562
00919,群益台灣精選高息,2754,86,2668,新光-高雄,2024-09-03,8562
00688L,國泰20年美債正2,1207,1,1206,新光-高雄,2024-09-03,8562
00937B,群益ESG投等債20,662,41,621,新光-高雄,2024-09-03,8562
00680L,元大美債20正2,466,2,464,新光-高雄,2024-09-03,8562
2883,凱基金,333,8,325,新光-高雄,2024-09-03,8562
0056,元大高股息,260,8,252,新光-高雄,2024-09-03,8562
00918,大華優利高填息30,232,5,227,新光-高雄,2024-09-03,8562
2486,一詮,221,59,162,新光-高雄,2024-09-03,8562
00940,元大台灣價值高息,120,2,118,新光-高雄,2024-09-03,8562
2002,中鋼,102,3,99,新光-高雄,2024-09-03,8562
9907,統一實,103,4,99,新光-高雄,2024-09-03,8562
2408,南亞科,107,12,95,新光-高雄,2024-09-03,8562
9945,潤泰新,100,8,92,新光-高雄,2024-09-03,8562
00632R,元大台灣50反1,170,83,87,新光-高雄,2024-09-03,8562
1815,富喬,148,63,85,新光-高雄,2024-09-03,8562
00943,兆豐電子高息等權,85,0,85,新光-高雄,2024-09-03,8562
8462,柏文,133,51,82,新光-高雄,2024-09-03,8562
3704,合勤控,81,0,81,新光-高雄,2024-09-03,8562
2419,仲琦,90,19,71,新光-高雄,2024-09-03,8562
00637L,元大滬深300正2,110,40,70,新光-高雄,2024-09-03,8562
00878,國泰永續高股息,88,20,68,新光-高雄,2024-09-03,8562
4510,高鋒,161,93,68,新光-高雄,2024-09-03,8562
2241,艾姆勒,139,78,61,新光-高雄,2024-09-03,8562
2340,台亞,61,0,61,新光-高雄,2024-09-03,8562
00706L,期元大S＆P日圓正2,59,1,58,新光-高雄,2024-09-03,8562
6770,力積電,55,0,55,新光-高雄,2024-09-03,8562
00882,中信中國高股息,51,0,51,新光-高雄,2024-09-03,8562
8070,長華*,85,39,46,新光-高雄,2024-09-03,8562
6538,倉和,48,4,44,新光-高雄,2024-09-03,8562
2420,新巨,110,67,43,新光-高雄,2024-09-03,8562
00665L,富邦�琤肭磪囓�2,44,3,41,新光-高雄,2024-09-03,8562
00795B,中信美國公債20年,45,6,39,新光-高雄,2024-09-03,8562
2495,普安,50,12,38,新光-高雄,2024-09-03,8562
1101,台泥,51,13,38,新光-高雄,2024-09-03,8562
00915,凱基優選高股息30,53,16,37,新光-高雄,2024-09-03,8562
2243,宏旭-KY,46,9,37,新光-高雄,2024-09-03,8562
00954,中信日本半導體,37,0,37,新光-高雄,2024-09-03,8562
2344,華邦電,110,74,36,新光-高雄,2024-09-03,8562
912000,晨訊科-DR,35,0,35,新光-高雄,2024-09-03,8562
2891,中信金,59,25,34,新光-高雄,2024-09-03,8562
2609,陽明,43,9,34,新光-高雄,2024-09-03,8562
2515,中工,60,27,33,新光-高雄,2024-09-03,8562
3062,建漢,121,92,29,新光-高雄,2024-09-03,8562
00959B,大華投等美債15Y+,28,0,28,新光-高雄,2024-09-03,8562
2330,台積電,39,12,27,新光-高雄,2024-09-03,8562
1301,台塑,31,5,26,新光-高雄,2024-09-03,8562
8064,東捷,55,30,25,新光-高雄,2024-09-03,8562
4714,永捷,280,256,24,新光-高雄,2024-09-03,8562
5315,光聯,28,6,22,新光-高雄,2024-09-03,8562
00679B,元大美債20年,51,30,21,新光-高雄,2024-09-03,8562
00918,大華優利高填息30,795,62,733,新光-高雄,2024-09-04,8562
00715L,期街口布蘭特正2,594,3,591,新光-高雄,2024-09-04,8562
00919,群益台灣精選高息,703,206,497,新光-高雄,2024-09-04,8562
00878,國泰永續高股息,539,147,392,新光-高雄,2024-09-04,8562
00940,元大台灣價值高息,419,45,374,新光-高雄,2024-09-04,8562
00915,凱基優選高股息30,341,9,332,新光-高雄,2024-09-04,8562
00923,群益台ESG低碳50,336,21,315,新光-高雄,2024-09-04,8562
2891,中信金,293,60,233,新光-高雄,2024-09-04,8562
0056,元大高股息,210,56,154,新光-高雄,2024-09-04,8562
3481,群創,216,73,143,新光-高雄,2024-09-04,8562
00946,群益科技高息成長,125,5,120,新光-高雄,2024-09-04,8562
00675L,富邦臺灣加權正2,153,34,119,新光-高雄,2024-09-04,8562
00713,元大台灣高息低波,126,7,119,新光-高雄,2024-09-04,8562
2834,臺企銀,130,14,116,新光-高雄,2024-09-04,8562
00679B,元大美債20年,338,227,111,新光-高雄,2024-09-04,8562
00954,中信日本半導體,97,1,96,新光-高雄,2024-09-04,8562
1314,中石化,92,0,92,新光-高雄,2024-09-04,8562
2408,南亞科,108,17,91,新光-高雄,2024-09-04,8562
2330,台積電,173,86,87,新光-高雄,2024-09-04,8562
2002,中鋼,94,13,81,新光-高雄,2024-09-04,8562
2344,華邦電,113,36,77,新光-高雄,2024-09-04,8562
006208,富邦台50,82,8,74,新光-高雄,2024-09-04,8562
0050,元大台灣50,86,13,73,新光-高雄,2024-09-04,8562
00642U,期元大S＆P石油,92,20,72,新光-高雄,2024-09-04,8562
2106,建大,72,2,70,新光-高雄,2024-09-04,8562
2881,富邦金,78,11,67,新光-高雄,2024-09-04,8562
00881,國泰台灣5G+,80,15,65,新光-高雄,2024-09-04,8562
2367,燿華,84,24,60,新光-高雄,2024-09-04,8562
2049,上銀,74,15,59,新光-高雄,2024-09-04,8562
1326,台化,74,15,59,新光-高雄,2024-09-04,8562
2104,國際中橡,57,0,57,新光-高雄,2024-09-04,8562
00631L,元大台灣50正2,130,76,54,新光-高雄,2024-09-04,8562
4128,中天,54,2,52,新光-高雄,2024-09-04,8562
2483,百容,51,0,51,新光-高雄,2024-09-04,8562
2317,鴻海,156,105,51,新光-高雄,2024-09-04,8562
1312,國喬,56,6,50,新光-高雄,2024-09-04,8562
4563,百德,107,58,49,新光-高雄,2024-09-04,8562
2886,兆豐金,50,3,47,新光-高雄,2024-09-04,8562
00891,中信關鍵半導體,55,9,46,新光-高雄,2024-09-04,8562
1109,信大,45,0,45,新光-高雄,2024-09-04,8562
1718,中纖,43,0,43,新光-高雄,2024-09-04,8562
00951,台新日本半導體,53,10,43,新光-高雄,2024-09-04,8562
00948B,中信優息投資級債,89,46,43,新光-高雄,2024-09-04,8562
8462,柏文,237,195,42,新光-高雄,2024-09-04,8562
2547,日勝生,40,0,40,新光-高雄,2024-09-04,8562
9105,泰金寶-DR,51,14,37,新光-高雄,2024-09-04,8562
2892,第一金,38,2,36,新光-高雄,2024-09-04,8562
2492,華新科,39,3,36,新光-高雄,2024-09-04,8562
1540,喬福,344,309,35,新光-高雄,2024-09-04,8562
00753L,中信中國50正2,55,20,35,新光-高雄,2024-09-04,8562
00632R,元大台灣50反1,1388,569,819,新光-高雄,2024-09-05,8562
2888,新光金,792,153,639,新光-高雄,2024-09-05,8562
00915,凱基優選高股息30,619,5,614,新光-高雄,2024-09-05,8562
00715L,期街口布蘭特正2,956,455,501,新光-高雄,2024-09-05,8562
00919,群益台灣精選高息,451,95,356,新光-高雄,2024-09-05,8562
00878,國泰永續高股息,271,26,245,新光-高雄,2024-09-05,8562
00679B,元大美債20年,370,199,171,新光-高雄,2024-09-05,8562
00918,大華優利高填息30,170,1,169,新光-高雄,2024-09-05,8562
8011,台通,234,75,159,新光-高雄,2024-09-05,8562
2887,台新金,152,12,140,新光-高雄,2024-09-05,8562
6505,台塑化,117,6,111,新光-高雄,2024-09-05,8562
2344,華邦電,258,149,109,新光-高雄,2024-09-05,8562
00940,元大台灣價值高息,296,198,98,新光-高雄,2024-09-05,8562
5460,同協,108,17,91,新光-高雄,2024-09-05,8562
2002,中鋼,116,28,88,新光-高雄,2024-09-05,8562
2408,南亞科,107,23,84,新光-高雄,2024-09-05,8562
00930,永豐ESG低碳高息,74,0,74,新光-高雄,2024-09-05,8562
00642U,期元大S＆P石油,72,2,70,新光-高雄,2024-09-05,8562
00637L,元大滬深300正2,87,32,55,新光-高雄,2024-09-05,8562
3550,聯穎,55,0,55,新光-高雄,2024-09-05,8562
4303,信立,153,99,54,新光-高雄,2024-09-05,8562
2317,鴻海,184,135,49,新光-高雄,2024-09-05,8562
0056,元大高股息,55,7,48,新光-高雄,2024-09-05,8562
2367,燿華,74,28,46,新光-高雄,2024-09-05,8562
3481,群創,67,21,46,新光-高雄,2024-09-05,8562
2454,聯發科,57,13,44,新光-高雄,2024-09-05,8562
2867,三商壽,40,0,40,新光-高雄,2024-09-05,8562
00946,群益科技高息成長,64,26,38,新光-高雄,2024-09-05,8562
00952,凱基台灣AI50,36,0,36,新光-高雄,2024-09-05,8562
00953B,群益優選非投等債,36,0,36,新光-高雄,2024-09-05,8562
2409,友達,36,1,35,新光-高雄,2024-09-05,8562
00713,元大台灣高息低波,36,5,31,新光-高雄,2024-09-05,8562
1711,永光,95,65,30,新光-高雄,2024-09-05,8562
1316,上曜,58,29,29,新光-高雄,2024-09-05,8562
5469,瀚宇博,32,3,29,新光-高雄,2024-09-05,8562
1101,台泥,30,1,29,新光-高雄,2024-09-05,8562
3339,泰谷,38,11,27,新光-高雄,2024-09-05,8562
00954,中信日本半導體,27,0,27,新光-高雄,2024-09-05,8562
6143,振曜,30,4,26,新光-高雄,2024-09-05,8562
00951,台新日本半導體,25,1,24,新光-高雄,2024-09-05,8562
00932,兆豐永續高息等權,28,4,24,新光-高雄,2024-09-05,8562
1326,台化,38,15,23,新光-高雄,2024-09-05,8562
5905,南仁湖,26,3,23,新光-高雄,2024-09-05,8562
5225,東科-KY,31,9,22,新光-高雄,2024-09-05,8562
1540,喬福,378,356,22,新光-高雄,2024-09-05,8562
4561,健椿,103,82,21,新光-高雄,2024-09-05,8562
2337,旺宏,36,16,20,新光-高雄,2024-09-05,8562
3363,上詮,30,10,20,新光-高雄,2024-09-05,8562
00665L,富邦�琤肭磪囓�2,30,10,20,新光-高雄,2024-09-05,8562
912000,晨訊科-DR,25,5,20,新光-高雄,2024-09-05,8562
00632R,元大台灣50反1,8250,1295,6955,新光-高雄,2024-09-06,8562
00715L,期街口布蘭特正2,471,113,358,新光-高雄,2024-09-06,8562
00686R,群益臺灣加權反1,300,0,300,新光-高雄,2024-09-06,8562
8011,台通,238,32,206,新光-高雄,2024-09-06,8562
00919,群益台灣精選高息,248,54,194,新光-高雄,2024-09-06,8562
00687B,國泰20年美債,474,316,158,新光-高雄,2024-09-06,8562
00680L,元大美債20正2,464,330,134,新光-高雄,2024-09-06,8562
00918,大華優利高填息30,136,12,124,新光-高雄,2024-09-06,8562
00937B,群益ESG投等債20,245,139,106,新光-高雄,2024-09-06,8562
4510,高鋒,267,164,103,新光-高雄,2024-09-06,8562
2888,新光金,174,78,96,新光-高雄,2024-09-06,8562
00945B,凱基美國非投等債,94,0,94,新光-高雄,2024-09-06,8562
2002,中鋼,120,39,81,新光-高雄,2024-09-06,8562
00878,國泰永續高股息,115,41,74,新光-高雄,2024-09-06,8562
8105,凌巨,67,0,67,新光-高雄,2024-09-06,8562
00959B,大華投等美債15Y+,70,7,63,新光-高雄,2024-09-06,8562
00679B,元大美債20年,148,86,62,新光-高雄,2024-09-06,8562
2317,鴻海,96,35,61,新光-高雄,2024-09-06,8562
2880,華南金,66,12,54,新光-高雄,2024-09-06,8562
1711,永光,107,59,48,新光-高雄,2024-09-06,8562
6274,台燿,70,30,40,新光-高雄,2024-09-06,8562
9934,成霖,35,0,35,新光-高雄,2024-09-06,8562
6770,力積電,35,3,32,新光-高雄,2024-09-06,8562
2883,凱基金,50,19,31,新光-高雄,2024-09-06,8562
2855,統一證,31,0,31,新光-高雄,2024-09-06,8562
00877,復華中國5G,30,0,30,新光-高雄,2024-09-06,8562
00954,中信日本半導體,28,0,28,新光-高雄,2024-09-06,8562
1815,富喬,330,302,28,新光-高雄,2024-09-06,8562
2049,上銀,30,4,26,新光-高雄,2024-09-06,8562
3029,零壹,26,1,25,新光-高雄,2024-09-06,8562
4974,亞泰,28,6,22,新光-高雄,2024-09-06,8562
6160,欣技,21,0,21,新光-高雄,2024-09-06,8562
2204,中華,21,1,20,新光-高雄,2024-09-06,8562
8927,北基,25,4,21,新光-高雄,2024-09-06,8562
00637L,元大滬深300正2,44,24,20,新光-高雄,2024-09-06,8562
2034,允強,20,0,20,新光-高雄,2024-09-06,8562
00882,中信中國高股息,20,0,20,新光-高雄,2024-09-06,8562
00720B,元大投資級公司債,20,1,19,新光-高雄,2024-09-06,8562
00927,群益半導體收益,19,0,19,新光-高雄,2024-09-06,8562
00857B,永豐20年美公債,26,8,18,新光-高雄,2024-09-06,8562
3264,欣銓,18,0,18,新光-高雄,2024-09-06,8562
2337,旺宏,23,5,18,新光-高雄,2024-09-06,8562
1316,上曜,26,8,18,新光-高雄,2024-09-06,8562
2485,兆赫,20,2,18,新光-高雄,2024-09-06,8562
00915,凱基優選高股息30,19,1,18,新光-高雄,2024-09-06,8562
2313,華通,62,45,17,新光-高雄,2024-09-06,8562
4128,中天,17,0,17,新光-高雄,2024-09-06,8562
2408,南亞科,30,14,16,新光-高雄,2024-09-06,8562
3550,聯穎,16,0,16,新光-高雄,2024-09-06,8562
2368,金像電,17,1,16,新光-高雄,2024-09-06,8562
00929,復華台灣科技優息,581,115,466,新光-高雄,2024-09-09,8562
00715L,期街口布蘭特正2,576,126,450,新光-高雄,2024-09-09,8562
00919,群益台灣精選高息,500,104,396,新光-高雄,2024-09-09,8562
2303,聯電,241,14,227,新光-高雄,2024-09-09,8562
00878,國泰永續高股息,211,14,197,新光-高雄,2024-09-09,8562
00632R,元大台灣50反1,1130,944,186,新光-高雄,2024-09-09,8562
00918,大華優利高填息30,128,16,112,新光-高雄,2024-09-09,8562
2317,鴻海,204,94,110,新光-高雄,2024-09-09,8562
00637L,元大滬深300正2,134,30,104,新光-高雄,2024-09-09,8562
2880,華南金,110,10,100,新光-高雄,2024-09-09,8562
4956,光鋐,229,135,94,新光-高雄,2024-09-09,8562
00915,凱基優選高股息30,159,67,92,新光-高雄,2024-09-09,8562
00931B,統一美債20年,82,0,82,新光-高雄,2024-09-09,8562
2891,中信金,98,24,74,新光-高雄,2024-09-09,8562
6191,精成科,70,1,69,新光-高雄,2024-09-09,8562
2002,中鋼,76,11,65,新光-高雄,2024-09-09,8562
2402,毅嘉,74,10,64,新光-高雄,2024-09-09,8562
00713,元大台灣高息低波,62,5,57,新光-高雄,2024-09-09,8562
00930,永豐ESG低碳高息,57,1,56,新光-高雄,2024-09-09,8562
1307,三芳,60,4,56,新光-高雄,2024-09-09,8562
0056,元大高股息,65,10,55,新光-高雄,2024-09-09,8562
00753L,中信中國50正2,60,5,55,新光-高雄,2024-09-09,8562
2359,所羅門,62,12,50,新光-高雄,2024-09-09,8562
006208,富邦台50,49,0,49,新光-高雄,2024-09-09,8562
1303,南亞,71,23,48,新光-高雄,2024-09-09,8562
6505,台塑化,48,9,39,新光-高雄,2024-09-09,8562
2881,富邦金,56,17,39,新光-高雄,2024-09-09,8562
2408,南亞科,44,6,38,新光-高雄,2024-09-09,8562
2812,台中銀,50,12,38,新光-高雄,2024-09-09,8562
1539,巨庭,80,43,37,新光-高雄,2024-09-09,8562
1314,中石化,46,9,37,新光-高雄,2024-09-09,8562
0050,元大台灣50,49,12,37,新光-高雄,2024-09-09,8562
00665L,富邦�琤肭磪囓�2,69,34,35,新光-高雄,2024-09-09,8562
00951,台新日本半導體,39,6,33,新光-高雄,2024-09-09,8562
6873,泓德能源,32,0,32,新光-高雄,2024-09-09,8562
2834,臺企銀,36,6,30,新光-高雄,2024-09-09,8562
2885,元大金,30,1,29,新光-高雄,2024-09-09,8562
00946,群益科技高息成長,32,5,27,新光-高雄,2024-09-09,8562
6116,彩晶,28,1,27,新光-高雄,2024-09-09,8562
3550,聯穎,27,0,27,新光-高雄,2024-09-09,8562
1326,台化,48,21,27,新光-高雄,2024-09-09,8562
912000,晨訊科-DR,26,0,26,新光-高雄,2024-09-09,8562
00733,富邦臺灣中小,26,0,26,新光-高雄,2024-09-09,8562
2330,台積電,44,18,26,新光-高雄,2024-09-09,8562
00934,中信成長高股息,32,7,25,新光-高雄,2024-09-09,8562
3105,穩懋,25,0,25,新光-高雄,2024-09-09,8562
00945B,凱基美國非投等債,24,0,24,新光-高雄,2024-09-09,8562
6182,合晶,24,1,23,新光-高雄,2024-09-09,8562
00959B,大華投等美債15Y+,23,0,23,新光-高雄,2024-09-09,8562
2388,威盛,45,22,23,新光-高雄,2024-09-09,8562
00929,復華台灣科技優息,740,131,609,新光-高雄,2024-09-10,8562
00632R,元大台灣50反1,678,259,419,新光-高雄,2024-09-10,8562
1307,三芳,193,5,188,新光-高雄,2024-09-10,8562
00688L,國泰20年美債正2,247,60,187,新光-高雄,2024-09-10,8562
2303,聯電,139,2,137,新光-高雄,2024-09-10,8562
00957B,兆豐US優選投等債,148,20,128,新光-高雄,2024-09-10,8562
00918,大華優利高填息30,102,2,100,新光-高雄,2024-09-10,8562
00664R,國泰臺灣加權反1,90,0,90,新光-高雄,2024-09-10,8562
4979,華星光,191,104,87,新光-高雄,2024-09-10,8562
8011,台通,266,180,86,新光-高雄,2024-09-10,8562
2344,華邦電,156,75,81,新光-高雄,2024-09-10,8562
00706L,期元大S＆P日圓正2,80,0,80,新光-高雄,2024-09-10,8562
3264,欣銓,76,5,71,新光-高雄,2024-09-10,8562
00679B,元大美債20年,206,136,70,新光-高雄,2024-09-10,8562
4903,聯光通,75,8,67,新光-高雄,2024-09-10,8562
1316,上曜,83,22,61,新光-高雄,2024-09-10,8562
2317,鴻海,163,102,61,新光-高雄,2024-09-10,8562
3481,群創,66,6,60,新光-高雄,2024-09-10,8562
3294,英濟,63,4,59,新光-高雄,2024-09-10,8562
2515,中工,70,12,58,新光-高雄,2024-09-10,8562
2442,新美齊,53,0,53,新光-高雄,2024-09-10,8562
3518,柏騰,72,21,51,新光-高雄,2024-09-10,8562
2356,英業達,76,28,48,新光-高雄,2024-09-10,8562
4128,中天,58,13,45,新光-高雄,2024-09-10,8562
1314,中石化,49,5,44,新光-高雄,2024-09-10,8562
1409,新纖,48,5,43,新光-高雄,2024-09-10,8562
2337,旺宏,64,21,43,新光-高雄,2024-09-10,8562
00713,元大台灣高息低波,44,3,41,新光-高雄,2024-09-10,8562
00878,國泰永續高股息,135,94,41,新光-高雄,2024-09-10,8562
00934,中信成長高股息,46,8,38,新光-高雄,2024-09-10,8562
1536,和大,37,1,36,新光-高雄,2024-09-10,8562
00676R,富邦臺灣加權反1,36,0,36,新光-高雄,2024-09-10,8562
2002,中鋼,51,15,36,新光-高雄,2024-09-10,8562
00675L,富邦臺灣加權正2,58,26,32,新光-高雄,2024-09-10,8562
00921,兆豐龍頭等權重,32,0,32,新光-高雄,2024-09-10,8562
00945B,凱基美國非投等債,50,20,30,新光-高雄,2024-09-10,8562
00946,群益科技高息成長,46,16,30,新光-高雄,2024-09-10,8562
4153,鈺緯,32,3,29,新光-高雄,2024-09-10,8562
00959B,大華投等美債15Y+,42,13,29,新光-高雄,2024-09-10,8562
2542,興富發,34,7,27,新光-高雄,2024-09-10,8562
6213,聯茂,31,4,27,新光-高雄,2024-09-10,8562
3714,富采,30,3,27,新光-高雄,2024-09-10,8562
4513,福裕,61,36,25,新光-高雄,2024-09-10,8562
6152,百一,30,5,25,新光-高雄,2024-09-10,8562
2368,金像電,43,19,24,新光-高雄,2024-09-10,8562
912000,晨訊科-DR,24,0,24,新光-高雄,2024-09-10,8562
6838,台新藥,26,2,24,新光-高雄,2024-09-10,8562
4904,遠傳,23,0,23,新光-高雄,2024-09-10,8562
3030,德律,26,3,23,新光-高雄,2024-09-10,8562
5871,中租-KY,24,1,23,新光-高雄,2024-09-10,8562
00715L,期街口布蘭特正2,919,72,847,新光-高雄,2024-09-11,8562
00953B,群益優選非投等債,501,0,501,新光-高雄,2024-09-11,8562
00942B,台新美A公司債20+,345,7,338,新光-高雄,2024-09-11,8562
00632R,元大台灣50反1,780,478,302,新光-高雄,2024-09-11,8562
00929,復華台灣科技優息,320,92,228,新光-高雄,2024-09-11,8562
00687B,國泰20年美債,343,153,190,新光-高雄,2024-09-11,8562
00919,群益台灣精選高息,219,35,184,新光-高雄,2024-09-11,8562
00706L,期元大S＆P日圓正2,214,56,158,新光-高雄,2024-09-11,8562
1522,堤維西,174,20,154,新光-高雄,2024-09-11,8562
00933B,國泰10Y+金融債,266,116,150,新光-高雄,2024-09-11,8562
00713,元大台灣高息低波,119,0,119,新光-高雄,2024-09-11,8562
2347,聯強,105,0,105,新光-高雄,2024-09-11,8562
2317,鴻海,251,151,100,新光-高雄,2024-09-11,8562
00915,凱基優選高股息30,140,42,98,新光-高雄,2024-09-11,8562
00878,國泰永續高股息,128,32,96,新光-高雄,2024-09-11,8562
00957B,兆豐US優選投等債,73,1,72,新光-高雄,2024-09-11,8562
2891,中信金,78,7,71,新光-高雄,2024-09-11,8562
00945B,凱基美國非投等債,60,0,60,新光-高雄,2024-09-11,8562
9907,統一實,67,8,59,新光-高雄,2024-09-11,8562
00946,群益科技高息成長,70,13,57,新光-高雄,2024-09-11,8562
00642U,期元大S＆P石油,53,0,53,新光-高雄,2024-09-11,8562
00712,復華富時不動產,63,10,53,新光-高雄,2024-09-11,8562
2515,中工,51,0,51,新光-高雄,2024-09-11,8562
3227,原相,78,29,49,新光-高雄,2024-09-11,8562
6239,力成,56,7,49,新光-高雄,2024-09-11,8562
00637L,元大滬深300正2,277,230,47,新光-高雄,2024-09-11,8562
00665L,富邦�琤肭磪囓�2,62,17,45,新光-高雄,2024-09-11,8562
9905,大華,40,0,40,新光-高雄,2024-09-11,8562
5905,南仁湖,50,10,40,新光-高雄,2024-09-11,8562
00940,元大台灣價值高息,59,22,37,新光-高雄,2024-09-11,8562
0056,元大高股息,40,4,36,新光-高雄,2024-09-11,8562
2610,華航,46,13,33,新光-高雄,2024-09-11,8562
2883,凱基金,44,14,30,新光-高雄,2024-09-11,8562
00959B,大華投等美債15Y+,30,0,30,新光-高雄,2024-09-11,8562
9927,泰銘,28,0,28,新光-高雄,2024-09-11,8562
00753L,中信中國50正2,26,0,26,新光-高雄,2024-09-11,8562
3294,英濟,29,3,26,新光-高雄,2024-09-11,8562
00934,中信成長高股息,30,5,25,新光-高雄,2024-09-11,8562
4741,泓瀚,25,0,25,新光-高雄,2024-09-11,8562
2834,臺企銀,77,53,24,新光-高雄,2024-09-11,8562
6163,華電網,25,1,24,新光-高雄,2024-09-11,8562
2104,國際中橡,22,0,22,新光-高雄,2024-09-11,8562
2477,美隆電,68,46,22,新光-高雄,2024-09-11,8562
1709,和益,62,40,22,新光-高雄,2024-09-11,8562
5871,中租-KY,28,6,22,新光-高雄,2024-09-11,8562
2070,精湛,104,83,21,新光-高雄,2024-09-11,8562
2881,富邦金,21,0,21,新光-高雄,2024-09-11,8562
00918,大華優利高填息30,32,11,21,新光-高雄,2024-09-11,8562
00720B,元大投資級公司債,21,0,21,新光-高雄,2024-09-11,8562
1447,力鵬,20,0,20,新光-高雄,2024-09-11,8562
00632R,元大台灣50反1,1176,327,849,新光-高雄,2024-09-12,8562
00715L,期街口布蘭特正2,570,83,487,新光-高雄,2024-09-12,8562
00919,群益台灣精選高息,514,259,255,新光-高雄,2024-09-12,8562
2891,中信金,170,5,165,新光-高雄,2024-09-12,8562
4563,百德,180,17,163,新光-高雄,2024-09-12,8562
3481,群創,131,39,92,新光-高雄,2024-09-12,8562
5460,同協,142,55,87,新光-高雄,2024-09-12,8562
00686R,群益臺灣加權反1,81,0,81,新光-高雄,2024-09-12,8562
00673R,期元大S＆P原油反1,91,30,61,新光-高雄,2024-09-12,8562
00945B,凱基美國非投等債,70,10,60,新光-高雄,2024-09-12,8562
3303,岱稜,108,53,55,新光-高雄,2024-09-12,8562
00937B,群益ESG投等債20,211,158,53,新光-高雄,2024-09-12,8562
00957B,兆豐US優選投等債,52,0,52,新光-高雄,2024-09-12,8562
00637L,元大滬深300正2,94,43,51,新光-高雄,2024-09-12,8562
00942B,台新美A公司債20+,50,0,50,新光-高雄,2024-09-12,8562
2388,威盛,120,70,50,新光-高雄,2024-09-12,8562
00679B,元大美債20年,171,127,44,新光-高雄,2024-09-12,8562
00633L,富邦上証正2,47,5,42,新光-高雄,2024-09-12,8562
6438,迅得,40,0,40,新光-高雄,2024-09-12,8562
2371,大同,76,37,39,新光-高雄,2024-09-12,8562
00918,大華優利高填息30,43,8,35,新光-高雄,2024-09-12,8562
2913,農林,33,0,33,新光-高雄,2024-09-12,8562
2313,華通,66,34,32,新光-高雄,2024-09-12,8562
8462,柏文,115,84,31,新光-高雄,2024-09-12,8562
1453,大將,30,0,30,新光-高雄,2024-09-12,8562
1316,上曜,34,5,29,新光-高雄,2024-09-12,8562
2845,遠東銀,132,104,28,新光-高雄,2024-09-12,8562
00930,永豐ESG低碳高息,23,0,23,新光-高雄,2024-09-12,8562
2605,新興,21,0,21,新光-高雄,2024-09-12,8562
00761B,國泰A級公司債,20,0,20,新光-高雄,2024-09-12,8562
00648R,元大S＆P500反1,20,0,20,新光-高雄,2024-09-12,8562
4153,鈺緯,20,0,20,新光-高雄,2024-09-12,8562
00680L,元大美債20正2,428,408,20,新光-高雄,2024-09-12,8562
00915,凱基優選高股息30,30,12,18,新光-高雄,2024-09-12,8562
2399,映泰,94,77,17,新光-高雄,2024-09-12,8562
3062,建漢,47,30,17,新光-高雄,2024-09-12,8562
1301,台塑,19,3,16,新光-高雄,2024-09-12,8562
1802,台玻,16,0,16,新光-高雄,2024-09-12,8562
3045,台灣大,17,1,16,新光-高雄,2024-09-12,8562
1446,宏和,18,3,15,新光-高雄,2024-09-12,8562
00946,群益科技高息成長,44,29,15,新光-高雄,2024-09-12,8562
2812,台中銀,33,19,14,新光-高雄,2024-09-12,8562
6151,晉倫,16,2,14,新光-高雄,2024-09-12,8562
912000,晨訊科-DR,14,0,14,新光-高雄,2024-09-12,8562
2444,兆勁,18,4,14,新光-高雄,2024-09-12,8562
6548,長科*,14,0,14,新光-高雄,2024-09-12,8562
2880,華南金,17,4,13,新光-高雄,2024-09-12,8562
6182,合晶,12,0,12,新光-高雄,2024-09-12,8562
6531,愛普*,13,1,12,新光-高雄,2024-09-12,8562
6670,復盛應用,13,1,12,新光-高雄,2024-09-12,8562
2888,新光金,590,120,470,新光-高雄,2024-09-13,8562
00687B,國泰20年美債,342,30,312,新光-高雄,2024-09-13,8562
2371,大同,335,59,276,新光-高雄,2024-09-13,8562
00673R,期元大S＆P原油反1,218,5,213,新光-高雄,2024-09-13,8562
00929,復華台灣科技優息,342,148,194,新光-高雄,2024-09-13,8562
00688L,國泰20年美債正2,181,42,139,新光-高雄,2024-09-13,8562
2845,遠東銀,110,0,110,新光-高雄,2024-09-13,8562
00915,凱基優選高股息30,103,3,100,新光-高雄,2024-09-13,8562
00918,大華優利高填息30,98,21,77,新光-高雄,2024-09-13,8562
2891,中信金,127,53,74,新光-高雄,2024-09-13,8562
0056,元大高股息,76,13,63,新光-高雄,2024-09-13,8562
00633L,富邦上証正2,60,0,60,新光-高雄,2024-09-13,8562
6743,安普新,55,2,53,新光-高雄,2024-09-13,8562
4540,全球傳動,47,1,46,新光-高雄,2024-09-13,8562
2303,聯電,50,5,45,新光-高雄,2024-09-13,8562
3013,晟銘電,82,43,39,新光-高雄,2024-09-13,8562
2883,凱基金,56,18,38,新光-高雄,2024-09-13,8562
8070,長華*,73,37,36,新光-高雄,2024-09-13,8562
4306,炎洲,36,0,36,新光-高雄,2024-09-13,8562
9907,統一實,40,5,35,新光-高雄,2024-09-13,8562
2317,鴻海,77,42,35,新光-高雄,2024-09-13,8562
1711,永光,96,62,34,新光-高雄,2024-09-13,8562
4510,高鋒,174,143,31,新光-高雄,2024-09-13,8562
00948B,中信優息投資級債,90,62,28,新光-高雄,2024-09-13,8562
00946,群益科技高息成長,29,2,27,新光-高雄,2024-09-13,8562
5905,南仁湖,35,8,27,新光-高雄,2024-09-13,8562
5460,同協,61,34,27,新光-高雄,2024-09-13,8562
2449,京元電子,29,3,26,新光-高雄,2024-09-13,8562
6405,悅城,92,66,26,新光-高雄,2024-09-13,8562
6548,長科*,24,0,24,新光-高雄,2024-09-13,8562
8039,台虹,57,34,23,新光-高雄,2024-09-13,8562
00795B,中信美國公債20年,26,3,23,新光-高雄,2024-09-13,8562
00931B,統一美債20年,22,2,20,新光-高雄,2024-09-13,8562
00945B,凱基美國非投等債,20,0,20,新光-高雄,2024-09-13,8562
2301,光寶科,28,9,19,新光-高雄,2024-09-13,8562
1584,精剛,25,7,18,新光-高雄,2024-09-13,8562
00933B,國泰10Y+金融債,44,26,18,新光-高雄,2024-09-13,8562
00930,永豐ESG低碳高息,18,0,18,新光-高雄,2024-09-13,8562
8249,菱光,43,26,17,新光-高雄,2024-09-13,8562
00899,FT潔淨能源,17,0,17,新光-高雄,2024-09-13,8562
6470,宇智,17,0,17,新光-高雄,2024-09-13,8562
2834,臺企銀,17,2,15,新光-高雄,2024-09-13,8562
00857B,永豐20年美公債,17,2,15,新光-高雄,2024-09-13,8562
4303,信立,30,17,13,新光-高雄,2024-09-13,8562
2454,聯發科,19,6,13,新光-高雄,2024-09-13,8562
6547,高端疫苗,13,0,13,新光-高雄,2024-09-13,8562
9945,潤泰新,17,5,12,新光-高雄,2024-09-13,8562
3363,上詮,18,6,12,新光-高雄,2024-09-13,8562
00751B,元大AAA至A公司債,21,9,12,新光-高雄,2024-09-13,8562
4545,銘鈺,24,12,12,新光-高雄,2024-09-13,8562
00687B,國泰20年美債,982,48,934,新光-高雄,2024-09-16,8562
00680L,元大美債20正2,704,44,660,新光-高雄,2024-09-16,8562
00688L,國泰20年美債正2,494,14,480,新光-高雄,2024-09-16,8562
2349,錸德,496,190,306,新光-高雄,2024-09-16,8562
2515,中工,251,22,229,新光-高雄,2024-09-16,8562
00919,群益台灣精選高息,285,62,223,新光-高雄,2024-09-16,8562
00918,大華優利高填息30,186,10,176,新光-高雄,2024-09-16,8562
00937B,群益ESG投等債20,170,28,142,新光-高雄,2024-09-16,8562
2888,新光金,246,108,138,新光-高雄,2024-09-16,8562
1307,三芳,148,17,131,新光-高雄,2024-09-16,8562
1785,光洋科,219,98,121,新光-高雄,2024-09-16,8562
00673R,期元大S＆P原油反1,120,0,120,新光-高雄,2024-09-16,8562
2062,橋椿,190,118,72,新光-高雄,2024-09-16,8562
00706L,期元大S＆P日圓正2,57,1,56,新光-高雄,2024-09-16,8562
00945B,凱基美國非投等債,54,0,54,新光-高雄,2024-09-16,8562
00713,元大台灣高息低波,55,2,53,新光-高雄,2024-09-16,8562
00751B,元大AAA至A公司債,48,0,48,新光-高雄,2024-09-16,8562
00933B,國泰10Y+金融債,52,5,47,新光-高雄,2024-09-16,8562
1727,中華化,73,28,45,新光-高雄,2024-09-16,8562
4540,全球傳動,56,12,44,新光-高雄,2024-09-16,8562
1711,永光,136,92,44,新光-高雄,2024-09-16,8562
00795B,中信美國公債20年,48,8,40,新光-高雄,2024-09-16,8562
00715L,期街口布蘭特正2,79,41,38,新光-高雄,2024-09-16,8562
00679B,元大美債20年,125,87,38,新光-高雄,2024-09-16,8562
00959B,大華投等美債15Y+,37,0,37,新光-高雄,2024-09-16,8562
2851,中再保,36,0,36,新光-高雄,2024-09-16,8562
1721,三晃,41,6,35,新光-高雄,2024-09-16,8562
00635U,期元大S＆P黃金,34,0,34,新光-高雄,2024-09-16,8562
0056,元大高股息,40,8,32,新光-高雄,2024-09-16,8562
2049,上銀,36,7,29,新光-高雄,2024-09-16,8562
2603,長榮,30,3,27,新光-高雄,2024-09-16,8562
2801,彰銀,40,13,27,新光-高雄,2024-09-16,8562
2201,裕隆,50,24,26,新光-高雄,2024-09-16,8562
00633L,富邦上証正2,30,4,26,新光-高雄,2024-09-16,8562
8096,擎亞,27,3,24,新光-高雄,2024-09-16,8562
6005,群益證,24,0,24,新光-高雄,2024-09-16,8562
00947,台新臺灣IC設計,25,1,24,新光-高雄,2024-09-16,8562
00882,中信中國高股息,24,1,23,新光-高雄,2024-09-16,8562
00637L,元大滬深300正2,57,35,22,新光-高雄,2024-09-16,8562
3360,尚立,67,45,22,新光-高雄,2024-09-16,8562
6290,良維,24,3,21,新光-高雄,2024-09-16,8562
5347,世界,22,1,21,新光-高雄,2024-09-16,8562
6151,晉倫,23,2,21,新光-高雄,2024-09-16,8562
00671R,富邦NASDAQ反1,26,5,21,新光-高雄,2024-09-16,8562
006208,富邦台50,23,2,21,新光-高雄,2024-09-16,8562
00929,復華台灣科技優息,211,191,20,新光-高雄,2024-09-16,8562
4720,德淵,20,0,20,新光-高雄,2024-09-16,8562
00957B,兆豐US優選投等債,20,0,20,新光-高雄,2024-09-16,8562
3057,喬鼎,20,0,20,新光-高雄,2024-09-16,8562
2388,威盛,27,7,20,新光-高雄,2024-09-16,8562
00929,復華台灣科技優息,633,30,603,新光-高雄,2024-09-18,8562
00671R,富邦NASDAQ反1,380,0,380,新光-高雄,2024-09-18,8562
2883,凱基金,464,90,374,新光-高雄,2024-09-18,8562
00669R,國泰美國道瓊反1,389,40,349,新光-高雄,2024-09-18,8562
00688L,國泰20年美債正2,285,42,243,新光-高雄,2024-09-18,8562
2303,聯電,217,17,200,新光-高雄,2024-09-18,8562
00937B,群益ESG投等債20,315,120,195,新光-高雄,2024-09-18,8562
00632R,元大台灣50反1,378,187,191,新光-高雄,2024-09-18,8562
00673R,期元大S＆P原油反1,175,0,175,新光-高雄,2024-09-18,8562
0056,元大高股息,146,8,138,新光-高雄,2024-09-18,8562
00915,凱基優選高股息30,126,23,103,新光-高雄,2024-09-18,8562
00733,富邦臺灣中小,95,0,95,新光-高雄,2024-09-18,8562
00713,元大台灣高息低波,119,31,88,新光-高雄,2024-09-18,8562
3062,建漢,238,155,83,新光-高雄,2024-09-18,8562
00945B,凱基美國非投等債,82,0,82,新光-高雄,2024-09-18,8562
2867,三商壽,100,24,76,新光-高雄,2024-09-18,8562
5398,慕康生醫,70,5,65,新光-高雄,2024-09-18,8562
00930,永豐ESG低碳高息,67,4,63,新光-高雄,2024-09-18,8562
2313,華通,96,34,62,新光-高雄,2024-09-18,8562
00958B,永豐ESG銀行債15,61,0,61,新光-高雄,2024-09-18,8562
3289,宜特,73,13,60,新光-高雄,2024-09-18,8562
00934,中信成長高股息,63,6,57,新光-高雄,2024-09-18,8562
8011,台通,61,4,57,新光-高雄,2024-09-18,8562
00877,復華中國5G,55,0,55,新光-高雄,2024-09-18,8562
3714,富采,55,1,54,新光-高雄,2024-09-18,8562
3715,定穎投控,54,3,51,新光-高雄,2024-09-18,8562
2515,中工,77,30,47,新光-高雄,2024-09-18,8562
00679B,元大美債20年,184,139,45,新光-高雄,2024-09-18,8562
8431,匯鑽科,42,1,41,新光-高雄,2024-09-18,8562
00706L,期元大S＆P日圓正2,53,14,39,新光-高雄,2024-09-18,8562
6213,聯茂,44,5,39,新光-高雄,2024-09-18,8562
3498,陽程,100,64,36,新光-高雄,2024-09-18,8562
2887,台新金,51,15,36,新光-高雄,2024-09-18,8562
00952,凱基台灣AI50,35,0,35,新光-高雄,2024-09-18,8562
1708,東鹼,57,23,34,新光-高雄,2024-09-18,8562
2442,新美齊,34,0,34,新光-高雄,2024-09-18,8562
3711,日月光投控,48,14,34,新光-高雄,2024-09-18,8562
1314,中石化,76,43,33,新光-高雄,2024-09-18,8562
4306,炎洲,31,1,30,新光-高雄,2024-09-18,8562
2106,建大,30,0,30,新光-高雄,2024-09-18,8562
00878,國泰永續高股息,113,83,30,新光-高雄,2024-09-18,8562
3605,宏致,82,53,29,新光-高雄,2024-09-18,8562
00946,群益科技高息成長,31,3,28,新光-高雄,2024-09-18,8562
00752,中信中國50,25,0,25,新光-高雄,2024-09-18,8562
2405,輔信,25,0,25,新光-高雄,2024-09-18,8562
00932,兆豐永續高息等權,25,0,25,新光-高雄,2024-09-18,8562
00772B,中信高評級公司債,27,3,24,新光-高雄,2024-09-18,8562
1519,華城,41,18,23,新光-高雄,2024-09-18,8562
00935,野村臺灣新科技50,28,5,23,新光-高雄,2024-09-18,8562
00891,中信關鍵半導體,33,10,23,新光-高雄,2024-09-18,8562
00687B,國泰20年美債,1050,98,952,新光-高雄,2024-09-19,8562
00715L,期街口布蘭特正2,782,109,673,新光-高雄,2024-09-19,8562
00680L,元大美債20正2,1030,591,439,新光-高雄,2024-09-19,8562
00857B,永豐20年美公債,325,1,324,新光-高雄,2024-09-19,8562
00669R,國泰美國道瓊反1,280,11,269,新光-高雄,2024-09-19,8562
2888,新光金,552,288,264,新光-高雄,2024-09-19,8562
00919,群益台灣精選高息,604,365,239,新光-高雄,2024-09-19,8562
6278,台表科,191,2,189,新光-高雄,2024-09-19,8562
00929,復華台灣科技優息,292,115,177,新光-高雄,2024-09-19,8562
00931B,統一美債20年,129,10,119,新光-高雄,2024-09-19,8562
00688L,國泰20年美債正2,256,138,118,新光-高雄,2024-09-19,8562
00671R,富邦NASDAQ反1,120,10,110,新光-高雄,2024-09-19,8562
912000,晨訊科-DR,108,0,108,新光-高雄,2024-09-19,8562
00915,凱基優選高股息30,102,5,97,新光-高雄,2024-09-19,8562
3167,大量,198,106,92,新光-高雄,2024-09-19,8562
00673R,期元大S＆P原油反1,91,0,91,新光-高雄,2024-09-19,8562
00679B,元大美債20年,194,103,91,新光-高雄,2024-09-19,8562
1721,三晃,84,6,78,新光-高雄,2024-09-19,8562
3105,穩懋,109,33,76,新光-高雄,2024-09-19,8562
00918,大華優利高填息30,108,47,61,新光-高雄,2024-09-19,8562
2105,正新,59,0,59,新光-高雄,2024-09-19,8562
2458,義隆,56,1,55,新光-高雄,2024-09-19,8562
6163,華電網,65,12,53,新光-高雄,2024-09-19,8562
00632R,元大台灣50反1,447,395,52,新光-高雄,2024-09-19,8562
00708L,期元大S＆P黃金正2,50,0,50,新光-高雄,2024-09-19,8562
020033,統一�琤肮黕篾,50,0,50,新光-高雄,2024-09-19,8562
00933B,國泰10Y+金融債,50,6,44,新光-高雄,2024-09-19,8562
2605,新興,44,0,44,新光-高雄,2024-09-19,8562
2344,華邦電,169,127,42,新光-高雄,2024-09-19,8562
00706L,期元大S＆P日圓正2,41,1,40,新光-高雄,2024-09-19,8562
00948B,中信優息投資級債,69,32,37,新光-高雄,2024-09-19,8562
00713,元大台灣高息低波,36,3,33,新光-高雄,2024-09-19,8562
00751B,元大AAA至A公司債,33,1,32,新光-高雄,2024-09-19,8562
00958B,永豐ESG銀行債15,32,0,32,新光-高雄,2024-09-19,8562
2442,新美齊,41,9,32,新光-高雄,2024-09-19,8562
2106,建大,30,0,30,新光-高雄,2024-09-19,8562
3712,永崴投控,29,1,28,新光-高雄,2024-09-19,8562
4128,中天,27,0,27,新光-高雄,2024-09-19,8562
2891,中信金,71,47,24,新光-高雄,2024-09-19,8562
00720B,元大投資級公司債,24,0,24,新光-高雄,2024-09-19,8562
2504,國產,33,9,24,新光-高雄,2024-09-19,8562
2408,南亞科,24,3,21,新光-高雄,2024-09-19,8562
6492,生華科,30,10,20,新光-高雄,2024-09-19,8562
2542,興富發,43,25,18,新光-高雄,2024-09-19,8562
4513,福裕,88,70,18,新光-高雄,2024-09-19,8562
6609,瀧澤科,63,46,17,新光-高雄,2024-09-19,8562
2201,裕隆,20,3,17,新光-高雄,2024-09-19,8562
00639,富邦深100,17,0,17,新光-高雄,2024-09-19,8562
00943,兆豐電子高息等權,17,0,17,新光-高雄,2024-09-19,8562
6405,悅城,41,25,16,新光-高雄,2024-09-19,8562
00919,群益台灣精選高息,936,78,858,新光-高雄,2024-09-20,8562
2515,中工,831,11,820,新光-高雄,2024-09-20,8562
00687B,國泰20年美債,556,53,503,新光-高雄,2024-09-20,8562
00679B,元大美債20年,368,80,288,新光-高雄,2024-09-20,8562
00680L,元大美債20正2,406,140,266,新光-高雄,2024-09-20,8562
00632R,元大台灣50反1,393,176,217,新光-高雄,2024-09-20,8562
00676R,富邦臺灣加權反1,210,35,175,新光-高雄,2024-09-20,8562
1711,永光,383,225,158,新光-高雄,2024-09-20,8562
3062,建漢,260,103,157,新光-高雄,2024-09-20,8562
2883,凱基金,194,48,146,新光-高雄,2024-09-20,8562
00915,凱基優選高股息30,154,14,140,新光-高雄,2024-09-20,8562
00637L,元大滬深300正2,226,90,136,新光-高雄,2024-09-20,8562
00949,復華日本龍頭,157,36,121,新光-高雄,2024-09-20,8562
2399,映泰,523,423,100,新光-高雄,2024-09-20,8562
00931B,統一美債20年,143,44,99,新光-高雄,2024-09-20,8562
9945,潤泰新,132,36,96,新光-高雄,2024-09-20,8562
2542,興富發,111,35,76,新光-高雄,2024-09-20,8562
2243,宏旭-KY,135,62,73,新光-高雄,2024-09-20,8562
3663,鑫科,103,41,62,新光-高雄,2024-09-20,8562
00930,永豐ESG低碳高息,95,40,55,新光-高雄,2024-09-20,8562
1321,大洋,75,20,55,新光-高雄,2024-09-20,8562
3011,今皓,55,0,55,新光-高雄,2024-09-20,8562
1416,廣豐,55,0,55,新光-高雄,2024-09-20,8562
2845,遠東銀,56,4,52,新光-高雄,2024-09-20,8562
2049,上銀,78,26,52,新光-高雄,2024-09-20,8562
020033,統一�琤肮黕篾,50,0,50,新光-高雄,2024-09-20,8562
3550,聯穎,74,25,49,新光-高雄,2024-09-20,8562
5516,雙喜,44,0,44,新光-高雄,2024-09-20,8562
2367,燿華,61,20,41,新光-高雄,2024-09-20,8562
3306,鼎天,41,1,40,新光-高雄,2024-09-20,8562
00664R,國泰臺灣加權反1,39,0,39,新光-高雄,2024-09-20,8562
00891,中信關鍵半導體,40,5,35,新光-高雄,2024-09-20,8562
5905,南仁湖,56,23,33,新光-高雄,2024-09-20,8562
2106,建大,31,0,31,新光-高雄,2024-09-20,8562
2464,盟立,283,252,31,新光-高雄,2024-09-20,8562
2313,華通,51,21,30,新光-高雄,2024-09-20,8562
00633L,富邦上証正2,33,3,30,新光-高雄,2024-09-20,8562
2363,矽統,55,25,30,新光-高雄,2024-09-20,8562
2101,南港,43,13,30,新光-高雄,2024-09-20,8562
00907,永豐優息存股,32,3,29,新光-高雄,2024-09-20,8562
6177,達麗,49,20,29,新光-高雄,2024-09-20,8562
00946,群益科技高息成長,29,0,29,新光-高雄,2024-09-20,8562
4306,炎洲,45,17,28,新光-高雄,2024-09-20,8562
00958B,永豐ESG銀行債15,27,0,27,新光-高雄,2024-09-20,8562
00650L,復華香港正2,56,29,27,新光-高雄,2024-09-20,8562
5512,力麒,57,31,26,新光-高雄,2024-09-20,8562
3581,博磊,57,31,26,新光-高雄,2024-09-20,8562
6753,龍德造船,28,2,26,新光-高雄,2024-09-20,8562
4157,太景*-KY,25,0,25,新光-高雄,2024-09-20,8562
00673R,期元大S＆P原油反1,64,40,24,新光-高雄,2024-09-20,8562
00680L,元大美債20正2,778,229,549,新光-高雄,2024-09-23,8562
00687B,國泰20年美債,487,18,469,新光-高雄,2024-09-23,8562
4707,磐亞,162,17,145,新光-高雄,2024-09-23,8562
00679B,元大美債20年,193,55,138,新光-高雄,2024-09-23,8562
00937B,群益ESG投等債20,206,72,134,新光-高雄,2024-09-23,8562
00688L,國泰20年美債正2,178,65,113,新光-高雄,2024-09-23,8562
2106,建大,70,0,70,新光-高雄,2024-09-23,8562
00706L,期元大S＆P日圓正2,72,4,68,新光-高雄,2024-09-23,8562
3450,聯鈞,156,95,61,新光-高雄,2024-09-23,8562
00673R,期元大S＆P原油反1,55,0,55,新光-高雄,2024-09-23,8562
2243,宏旭-KY,77,22,55,新光-高雄,2024-09-23,8562
2809,京城銀,50,2,48,新光-高雄,2024-09-23,8562
2542,興富發,71,27,44,新光-高雄,2024-09-23,8562
00929,復華台灣科技優息,129,85,44,新光-高雄,2024-09-23,8562
6532,瑞耘,52,11,41,新光-高雄,2024-09-23,8562
3543,州巧,41,1,40,新光-高雄,2024-09-23,8562
1321,大洋,41,1,40,新光-高雄,2024-09-23,8562
3062,建漢,161,124,37,新光-高雄,2024-09-23,8562
4716,大立,87,50,37,新光-高雄,2024-09-23,8562
1409,新纖,36,0,36,新光-高雄,2024-09-23,8562
00631L,元大台灣50正2,62,28,34,新光-高雄,2024-09-23,8562
1711,永光,170,138,32,新光-高雄,2024-09-23,8562
00945B,凱基美國非投等債,30,1,29,新光-高雄,2024-09-23,8562
2449,京元電子,37,8,29,新光-高雄,2024-09-23,8562
3607,谷崧,38,9,29,新光-高雄,2024-09-23,8562
8032,光菱,31,2,29,新光-高雄,2024-09-23,8562
8222,寶一,40,11,29,新光-高雄,2024-09-23,8562
2399,映泰,191,162,29,新光-高雄,2024-09-23,8562
00753L,中信中國50正2,60,32,28,新光-高雄,2024-09-23,8562
2425,承啟,62,34,28,新光-高雄,2024-09-23,8562
1326,台化,33,7,26,新光-高雄,2024-09-23,8562
8096,擎亞,71,46,25,新光-高雄,2024-09-23,8562
00958B,永豐ESG銀行債15,25,0,25,新光-高雄,2024-09-23,8562
4720,德淵,31,7,24,新光-高雄,2024-09-23,8562
2344,華邦電,39,15,24,新光-高雄,2024-09-23,8562
00751B,元大AAA至A公司債,24,0,24,新光-高雄,2024-09-23,8562
1785,光洋科,104,81,23,新光-高雄,2024-09-23,8562
2009,第一銅,27,5,22,新光-高雄,2024-09-23,8562
3049,精金,26,4,22,新光-高雄,2024-09-23,8562
00795B,中信美國公債20年,39,17,22,新光-高雄,2024-09-23,8562
9934,成霖,21,0,21,新光-高雄,2024-09-23,8562
6215,和椿,25,5,20,新光-高雄,2024-09-23,8562
00923,群益台ESG低碳50,20,0,20,新光-高雄,2024-09-23,8562
6005,群益證,19,0,19,新光-高雄,2024-09-23,8562
2497,怡利電,37,18,19,新光-高雄,2024-09-23,8562
3580,友威科,59,40,19,新光-高雄,2024-09-23,8562
2104,國際中橡,20,1,19,新光-高雄,2024-09-23,8562
2367,燿華,29,10,19,新光-高雄,2024-09-23,8562
3481,群創,57,38,19,新光-高雄,2024-09-23,8562
6187,萬潤,20,2,18,新光-高雄,2024-09-23,8562
00632R,元大台灣50反1,3226,33,3193,新光-高雄,2024-09-24,8562
00929,復華台灣科技優息,712,167,545,新光-高雄,2024-09-24,8562
00687B,國泰20年美債,426,34,392,新光-高雄,2024-09-24,8562
5398,慕康生醫,349,109,240,新光-高雄,2024-09-24,8562
00679B,元大美債20年,248,19,229,新光-高雄,2024-09-24,8562
2888,新光金,267,88,179,新光-高雄,2024-09-24,8562
00680L,元大美債20正2,367,192,175,新光-高雄,2024-09-24,8562
2891,中信金,191,32,159,新光-高雄,2024-09-24,8562
00931B,統一美債20年,153,11,142,新光-高雄,2024-09-24,8562
3149,正達,331,191,140,新光-高雄,2024-09-24,8562
00669R,國泰美國道瓊反1,200,80,120,新光-高雄,2024-09-24,8562
4414,如興,105,1,104,新光-高雄,2024-09-24,8562
4714,永捷,69,0,69,新光-高雄,2024-09-24,8562
00688L,國泰20年美債正2,122,57,65,新光-高雄,2024-09-24,8562
6191,精成科,65,1,64,新光-高雄,2024-09-24,8562
00918,大華優利高填息30,69,10,59,新光-高雄,2024-09-24,8562
00930,永豐ESG低碳高息,53,0,53,新光-高雄,2024-09-24,8562
00795B,中信美國公債20年,53,3,50,新光-高雄,2024-09-24,8562
2542,興富發,56,12,44,新光-高雄,2024-09-24,8562
00948B,中信優息投資級債,45,3,42,新光-高雄,2024-09-24,8562
0056,元大高股息,46,4,42,新光-高雄,2024-09-24,8562
00945B,凱基美國非投等債,40,0,40,新光-高雄,2024-09-24,8562
020033,統一�琤肮黕篾,40,0,40,新光-高雄,2024-09-24,8562
3712,永崴投控,50,13,37,新光-高雄,2024-09-24,8562
00878,國泰永續高股息,64,28,36,新光-高雄,2024-09-24,8562
2382,廣達,39,5,34,新光-高雄,2024-09-24,8562
2812,台中銀,55,22,33,新光-高雄,2024-09-24,8562
3605,宏致,53,22,31,新光-高雄,2024-09-24,8562
1309,台達化,31,1,30,新光-高雄,2024-09-24,8562
3537,堡達,32,5,27,新光-高雄,2024-09-24,8562
3481,群創,38,12,26,新光-高雄,2024-09-24,8562
6156,松上,28,3,25,新光-高雄,2024-09-24,8562
8046,南電,26,2,24,新光-高雄,2024-09-24,8562
00934,中信成長高股息,24,0,24,新光-高雄,2024-09-24,8562
00857B,永豐20年美公債,23,0,23,新光-高雄,2024-09-24,8562
1776,展宇,23,2,21,新光-高雄,2024-09-24,8562
00673R,期元大S＆P原油反1,20,0,20,新光-高雄,2024-09-24,8562
8112,至上,20,0,20,新光-高雄,2024-09-24,8562
5324,士開,20,0,20,新光-高雄,2024-09-24,8562
2501,國建,20,0,20,新光-高雄,2024-09-24,8562
3047,訊舟,41,21,20,新光-高雄,2024-09-24,8562
2497,怡利電,76,56,20,新光-高雄,2024-09-24,8562
5905,南仁湖,59,40,19,新光-高雄,2024-09-24,8562
2243,宏旭-KY,162,143,19,新光-高雄,2024-09-24,8562
2344,華邦電,19,1,18,新光-高雄,2024-09-24,8562
1539,巨庭,57,40,17,新光-高雄,2024-09-24,8562
6743,安普新,17,0,17,新光-高雄,2024-09-24,8562
3363,上詮,53,36,17,新光-高雄,2024-09-24,8562
3062,建漢,74,58,16,新光-高雄,2024-09-24,8562
4707,磐亞,19,3,16,新光-高雄,2024-09-24,8562
00687B,國泰20年美債,534,45,489,新光-高雄,2024-09-25,8562
00679B,元大美債20年,376,100,276,新光-高雄,2024-09-25,8562
4904,遠傳,115,7,108,新光-高雄,2024-09-25,8562
2243,宏旭-KY,137,41,96,新光-高雄,2024-09-25,8562
00857B,永豐20年美公債,98,2,96,新光-高雄,2024-09-25,8562
3045,台灣大,96,3,93,新光-高雄,2024-09-25,8562
00664R,國泰臺灣加權反1,90,0,90,新光-高雄,2024-09-25,8562
00764B,群益25年美債,88,0,88,新光-高雄,2024-09-25,8562
00665L,富邦�琤肭磪囓�2,133,49,84,新光-高雄,2024-09-25,8562
9958,世紀鋼,89,12,77,新光-高雄,2024-09-25,8562
2332,友訊,77,2,75,新光-高雄,2024-09-25,8562
00688L,國泰20年美債正2,136,62,74,新光-高雄,2024-09-25,8562
00953B,群益優選非投等債,70,0,70,新光-高雄,2024-09-25,8562
3550,聯穎,258,188,70,新光-高雄,2024-09-25,8562
2388,威盛,96,34,62,新光-高雄,2024-09-25,8562
00960,野村全球航運龍頭,144,83,61,新光-高雄,2024-09-25,8562
3209,全科,79,20,59,新光-高雄,2024-09-25,8562
2883,凱基金,79,27,52,新光-高雄,2024-09-25,8562
2106,建大,51,0,51,新光-高雄,2024-09-25,8562
00638R,元大滬深300反1,50,0,50,新光-高雄,2024-09-25,8562
00948B,中信優息投資級債,49,2,47,新光-高雄,2024-09-25,8562
2609,陽明,228,181,47,新光-高雄,2024-09-25,8562
1584,精剛,57,13,44,新光-高雄,2024-09-25,8562
00937B,群益ESG投等債20,120,81,39,新光-高雄,2024-09-25,8562
00931B,統一美債20年,138,100,38,新光-高雄,2024-09-25,8562
6197,佳必琪,39,1,38,新光-高雄,2024-09-25,8562
00631L,元大台灣50正2,70,33,37,新光-高雄,2024-09-25,8562
5516,雙喜,36,0,36,新光-高雄,2024-09-25,8562
00907,永豐優息存股,40,6,34,新光-高雄,2024-09-25,8562
5452,佶優,39,6,33,新光-高雄,2024-09-25,8562
2618,長榮航,56,23,33,新光-高雄,2024-09-25,8562
3149,正達,88,56,32,新光-高雄,2024-09-25,8562
4303,信立,31,0,31,新光-高雄,2024-09-25,8562
00713,元大台灣高息低波,35,8,27,新光-高雄,2024-09-25,8562
3062,建漢,113,85,28,新光-高雄,2024-09-25,8562
1319,東陽,39,12,27,新光-高雄,2024-09-25,8562
4510,高鋒,146,121,25,新光-高雄,2024-09-25,8562
2313,華通,51,26,25,新光-高雄,2024-09-25,8562
2349,錸德,33,9,24,新光-高雄,2024-09-25,8562
8112,至上,26,2,24,新光-高雄,2024-09-25,8562
6414,樺漢,27,3,24,新光-高雄,2024-09-25,8562
2838,聯邦銀,24,0,24,新光-高雄,2024-09-25,8562
2888,新光金,63,39,24,新光-高雄,2024-09-25,8562
2464,盟立,58,35,23,新光-高雄,2024-09-25,8562
912000,晨訊科-DR,22,0,22,新光-高雄,2024-09-25,8562
2347,聯強,23,2,21,新光-高雄,2024-09-25,8562
2867,三商壽,110,89,21,新光-高雄,2024-09-25,8562
00932,兆豐永續高息等權,43,22,21,新光-高雄,2024-09-25,8562
00648R,元大S＆P500反1,20,0,20,新光-高雄,2024-09-25,8562
8021,尖點,32,12,20,新光-高雄,2024-09-25,8562
00680L,元大美債20正2,775,35,740,新光-高雄,2024-09-26,8562
00687B,國泰20年美債,636,78,558,新光-高雄,2024-09-26,8562
00753L,中信中國50正2,593,196,397,新光-高雄,2024-09-26,8562
00688L,國泰20年美債正2,406,87,319,新光-高雄,2024-09-26,8562
00679B,元大美債20年,261,6,255,新光-高雄,2024-09-26,8562
00948B,中信優息投資級債,370,116,254,新光-高雄,2024-09-26,8562
4904,遠傳,256,16,240,新光-高雄,2024-09-26,8562
00715L,期街口布蘭特正2,288,65,223,新光-高雄,2024-09-26,8562
00937B,群益ESG投等債20,230,14,216,新光-高雄,2024-09-26,8562
00632R,元大台灣50反1,586,413,173,新光-高雄,2024-09-26,8562
00664R,國泰臺灣加權反1,100,0,100,新光-高雄,2024-09-26,8562
2409,友達,203,105,98,新光-高雄,2024-09-26,8562
5202,力新,98,3,95,新光-高雄,2024-09-26,8562
00671R,富邦NASDAQ反1,165,75,90,新光-高雄,2024-09-26,8562
00712,復華富時不動產,96,11,85,新光-高雄,2024-09-26,8562
00857B,永豐20年美公債,86,2,84,新光-高雄,2024-09-26,8562
00795B,中信美國公債20年,91,11,80,新光-高雄,2024-09-26,8562
00751B,元大AAA至A公司債,75,0,75,新光-高雄,2024-09-26,8562
3019,亞光,142,69,73,新光-高雄,2024-09-26,8562
6233,旺玖,89,21,68,新光-高雄,2024-09-26,8562
8277,商丞,61,0,61,新光-高雄,2024-09-26,8562
2344,華邦電,177,116,61,新光-高雄,2024-09-26,8562
9927,泰銘,58,0,58,新光-高雄,2024-09-26,8562
4958,臻鼎-KY,54,0,54,新光-高雄,2024-09-26,8562
2106,建大,50,0,50,新光-高雄,2024-09-26,8562
00946,群益科技高息成長,55,5,50,新光-高雄,2024-09-26,8562
2354,鴻準,54,5,49,新光-高雄,2024-09-26,8562
00960,野村全球航運龍頭,323,274,49,新光-高雄,2024-09-26,8562
2353,宏��,77,29,48,新光-高雄,2024-09-26,8562
2515,中工,48,0,48,新光-高雄,2024-09-26,8562
00933B,國泰10Y+金融債,65,22,43,新光-高雄,2024-09-26,8562
2855,統一證,45,2,43,新光-高雄,2024-09-26,8562
1540,喬福,167,125,42,新光-高雄,2024-09-26,8562
1721,三晃,41,0,41,新光-高雄,2024-09-26,8562
2317,鴻海,105,65,40,新光-高雄,2024-09-26,8562
00650L,復華香港正2,51,12,39,新光-高雄,2024-09-26,8562
1584,精剛,61,23,38,新光-高雄,2024-09-26,8562
2615,萬海,306,272,34,新光-高雄,2024-09-26,8562
6104,創惟,154,120,34,新光-高雄,2024-09-26,8562
2049,上銀,44,11,33,新光-高雄,2024-09-26,8562
2104,國際中橡,32,0,32,新光-高雄,2024-09-26,8562
6873,泓德能源,31,3,28,新光-高雄,2024-09-26,8562
2451,創見,33,6,27,新光-高雄,2024-09-26,8562
2312,金寶,109,84,25,新光-高雄,2024-09-26,8562
3689,湧德,28,7,21,新光-高雄,2024-09-26,8562
3673,TPK-KY,42,21,21,新光-高雄,2024-09-26,8562
6112,邁達特,21,0,21,新光-高雄,2024-09-26,8562
3630,新鉅科,21,0,21,新光-高雄,2024-09-26,8562
00878,國泰永續高股息,76,56,20,新光-高雄,2024-09-26,8562
5516,雙喜,20,0,20,新光-高雄,2024-09-26,8562
00687B,國泰20年美債,518,27,491,新光-高雄,2024-09-27,8562
4105,東洋,438,75,363,新光-高雄,2024-09-27,8562
00715L,期街口布蘭特正2,351,38,313,新光-高雄,2024-09-27,8562
00633L,富邦上証正2,312,12,300,新光-高雄,2024-09-27,8562
00937B,群益ESG投等債20,322,32,290,新光-高雄,2024-09-27,8562
00764B,群益25年美債,230,6,224,新光-高雄,2024-09-27,8562
00632R,元大台灣50反1,545,372,173,新光-高雄,2024-09-27,8562
00665L,富邦�琤肭磪囓�2,210,61,149,新光-高雄,2024-09-27,8562
1314,中石化,183,64,119,新光-高雄,2024-09-27,8562
2617,台航,108,3,105,新光-高雄,2024-09-27,8562
00675L,富邦臺灣加權正2,107,11,96,新光-高雄,2024-09-27,8562
00931B,統一美債20年,148,52,96,新光-高雄,2024-09-27,8562
00948B,中信優息投資級債,100,10,90,新光-高雄,2024-09-27,8562
2104,國際中橡,85,2,83,新光-高雄,2024-09-27,8562
00680L,元大美債20正2,164,83,81,新光-高雄,2024-09-27,8562
2883,凱基金,79,7,72,新光-高雄,2024-09-27,8562
00679B,元大美債20年,147,81,66,新光-高雄,2024-09-27,8562
2442,新美齊,64,0,64,新光-高雄,2024-09-27,8562
1319,東陽,70,11,59,新光-高雄,2024-09-27,8562
2313,華通,69,10,59,新光-高雄,2024-09-27,8562
3702,大聯大,61,2,59,新光-高雄,2024-09-27,8562
00945B,凱基美國非投等債,61,3,58,新光-高雄,2024-09-27,8562
2888,新光金,78,20,58,新光-高雄,2024-09-27,8562
1727,中華化,76,24,52,新光-高雄,2024-09-27,8562
2317,鴻海,199,149,50,新光-高雄,2024-09-27,8562
1522,堤維西,47,1,46,新光-高雄,2024-09-27,8562
00688L,國泰20年美債正2,144,100,44,新光-高雄,2024-09-27,8562
00642U,期元大S＆P石油,44,0,44,新光-高雄,2024-09-27,8562
00650L,復華香港正2,56,14,42,新光-高雄,2024-09-27,8562
2897A,王道銀甲特,40,0,40,新光-高雄,2024-09-27,8562
00960,野村全球航運龍頭,192,154,38,新光-高雄,2024-09-27,8562
4903,聯光通,69,33,36,新光-高雄,2024-09-27,8562
3711,日月光投控,49,14,35,新光-高雄,2024-09-27,8562
5202,力新,35,1,34,新光-高雄,2024-09-27,8562
2867,三商壽,40,7,33,新光-高雄,2024-09-27,8562
3019,亞光,57,26,31,新光-高雄,2024-09-27,8562
4714,永捷,37,6,31,新光-高雄,2024-09-27,8562
00751B,元大AAA至A公司債,43,13,30,新光-高雄,2024-09-27,8562
00958B,永豐ESG銀行債15,39,10,29,新光-高雄,2024-09-27,8562
00933B,國泰10Y+金融債,75,46,29,新光-高雄,2024-09-27,8562
2363,矽統,132,104,28,新光-高雄,2024-09-27,8562
2515,中工,80,52,28,新光-高雄,2024-09-27,8562
00795B,中信美國公債20年,26,0,26,新光-高雄,2024-09-27,8562
5876,上海商銀,26,0,26,新光-高雄,2024-09-27,8562
8112,至上,29,4,25,新光-高雄,2024-09-27,8562
6233,旺玖,25,0,25,新光-高雄,2024-09-27,8562
6443,元晶,29,5,24,新光-高雄,2024-09-27,8562
2897,王道銀行,25,5,20,新光-高雄,2024-09-27,8562
8111,立��,45,25,20,新光-高雄,2024-09-27,8562
8438,昶昕,23,3,20,新光-高雄,2024-09-27,8562
00929,復華台灣科技優息,838,58,780,新光-高雄,2024-09-30,8562
0056,元大高股息,699,13,686,新光-高雄,2024-09-30,8562
00688L,國泰20年美債正2,498,27,471,新光-高雄,2024-09-30,8562
00680L,元大美債20正2,491,40,451,新光-高雄,2024-09-30,8562
00679B,元大美債20年,490,75,415,新光-高雄,2024-09-30,8562
00919,群益台灣精選高息,426,222,204,新光-高雄,2024-09-30,8562
00937B,群益ESG投等債20,297,95,202,新光-高雄,2024-09-30,8562
00753L,中信中國50正2,443,294,149,新光-高雄,2024-09-30,8562
00764B,群益25年美債,143,0,143,新光-高雄,2024-09-30,8562
00715L,期街口布蘭特正2,393,268,125,新光-高雄,2024-09-30,8562
00931B,統一美債20年,128,6,122,新光-高雄,2024-09-30,8562
2344,華邦電,162,50,112,新光-高雄,2024-09-30,8562
1307,三芳,229,124,105,新光-高雄,2024-09-30,8562
1309,台達化,172,73,99,新光-高雄,2024-09-30,8562
00675L,富邦臺灣加權正2,101,9,92,新光-高雄,2024-09-30,8562
00878,國泰永續高股息,105,22,83,新光-高雄,2024-09-30,8562
00940,元大台灣價值高息,93,12,81,新光-高雄,2024-09-30,8562
2313,華通,110,33,77,新光-高雄,2024-09-30,8562
2303,聯電,99,26,73,新光-高雄,2024-09-30,8562
00639,富邦深100,69,0,69,新光-高雄,2024-09-30,8562
2845,遠東銀,65,0,65,新光-高雄,2024-09-30,8562
2330,台積電,88,33,55,新光-高雄,2024-09-30,8562
00945B,凱基美國非投等債,53,0,53,新光-高雄,2024-09-30,8562
2356,英業達,66,16,50,新光-高雄,2024-09-30,8562
00948B,中信優息投資級債,48,0,48,新光-高雄,2024-09-30,8562
2515,中工,52,5,47,新光-高雄,2024-09-30,8562
00918,大華優利高填息30,61,20,41,新光-高雄,2024-09-30,8562
00927,群益半導體收益,43,4,39,新光-高雄,2024-09-30,8562
5443,均豪,39,0,39,新光-高雄,2024-09-30,8562
00915,凱基優選高股息30,49,10,39,新光-高雄,2024-09-30,8562
00665L,富邦�琤肭磪囓�2,159,122,37,新光-高雄,2024-09-30,8562
00942B,台新美A公司債20+,36,0,36,新光-高雄,2024-09-30,8562
2881,富邦金,38,2,36,新光-高雄,2024-09-30,8562
00720B,元大投資級公司債,36,1,35,新光-高雄,2024-09-30,8562
2009,第一銅,75,41,34,新光-高雄,2024-09-30,8562
6024,群益期,32,0,32,新光-高雄,2024-09-30,8562
2605,新興,249,217,32,新光-高雄,2024-09-30,8562
3041,揚智,39,8,31,新光-高雄,2024-09-30,8562
9927,泰銘,31,0,31,新光-高雄,2024-09-30,8562
2104,國際中橡,68,38,30,新光-高雄,2024-09-30,8562
1904,正隆,34,4,30,新光-高雄,2024-09-30,8562
00946,群益科技高息成長,27,0,27,新光-高雄,2024-09-30,8562
4513,福裕,35,8,27,新光-高雄,2024-09-30,8562
2905,三商,27,0,27,新光-高雄,2024-09-30,8562
00673R,期元大S＆P原油反1,32,5,27,新光-高雄,2024-09-30,8562
3231,緯創,36,10,26,新光-高雄,2024-09-30,8562
00631L,元大台灣50正2,48,22,26,新光-高雄,2024-09-30,8562
2382,廣達,36,10,26,新光-高雄,2024-09-30,8562
2388,威盛,61,36,25,新光-高雄,2024-09-30,8562
00935,野村臺灣新科技50,25,0,25,新光-高雄,2024-09-30,8562
00937B,群益ESG投等債20,1044,78,966,新光-高雄,2024-10-01,8562
00929,復華台灣科技優息,281,8,273,新光-高雄,2024-10-01,8562
00688L,國泰20年美債正2,229,4,225,新光-高雄,2024-10-01,8562
0056,元大高股息,217,14,203,新光-高雄,2024-10-01,8562
00680L,元大美債20正2,298,101,197,新光-高雄,2024-10-01,8562
2845,遠東銀,113,0,113,新光-高雄,2024-10-01,8562
2888,新光金,114,12,102,新光-高雄,2024-10-01,8562
00878,國泰永續高股息,115,13,102,新光-高雄,2024-10-01,8562
00857B,永豐20年美公債,100,0,100,新光-高雄,2024-10-01,8562
00638R,元大滬深300反1,100,0,100,新光-高雄,2024-10-01,8562
00919,群益台灣精選高息,139,43,96,新光-高雄,2024-10-01,8562
4714,永捷,89,0,89,新光-高雄,2024-10-01,8562
00637L,元大滬深300正2,209,130,79,新光-高雄,2024-10-01,8562
1815,富喬,88,15,73,新光-高雄,2024-10-01,8562
3481,群創,76,7,69,新光-高雄,2024-10-01,8562
3663,鑫科,78,13,65,新光-高雄,2024-10-01,8562
1304,台聚,41,2,39,新光-高雄,2024-10-01,8562
2605,新興,76,38,38,新光-高雄,2024-10-01,8562
6530,創威,111,77,34,新光-高雄,2024-10-01,8562
00948B,中信優息投資級債,33,0,33,新光-高雄,2024-10-01,8562
2455,全新,77,44,33,新光-高雄,2024-10-01,8562
00922,國泰台灣領袖50,34,1,33,新光-高雄,2024-10-01,8562
1309,台達化,44,11,33,新光-高雄,2024-10-01,8562
2834,臺企銀,159,127,32,新光-高雄,2024-10-01,8562
2615,萬海,141,109,32,新光-高雄,2024-10-01,8562
2303,聯電,37,6,31,新光-高雄,2024-10-01,8562
00915,凱基優選高股息30,33,3,30,新光-高雄,2024-10-01,8562
2230,泰茂,30,1,29,新光-高雄,2024-10-01,8562
2408,南亞科,33,6,27,新光-高雄,2024-10-01,8562
1721,三晃,29,2,27,新光-高雄,2024-10-01,8562
00706L,期元大S＆P日圓正2,26,0,26,新光-高雄,2024-10-01,8562
3046,建��,26,0,26,新光-高雄,2024-10-01,8562
3360,尚立,29,3,26,新光-高雄,2024-10-01,8562
00940,元大台灣價值高息,32,7,25,新光-高雄,2024-10-01,8562
3234,光環,25,1,24,新光-高雄,2024-10-01,8562
3167,大量,23,0,23,新光-高雄,2024-10-01,8562
5905,南仁湖,31,9,22,新光-高雄,2024-10-01,8562
2312,金寶,66,44,22,新光-高雄,2024-10-01,8562
2892,第一金,22,0,22,新光-高雄,2024-10-01,8562
2402,毅嘉,30,9,21,新光-高雄,2024-10-01,8562
00881,國泰台灣5G+,20,0,20,新光-高雄,2024-10-01,8562
3702,大聯大,21,1,20,新光-高雄,2024-10-01,8562
00927,群益半導體收益,23,3,20,新光-高雄,2024-10-01,8562
2363,矽統,71,52,19,新光-高雄,2024-10-01,8562
00713,元大台灣高息低波,43,24,19,新光-高雄,2024-10-01,8562
006208,富邦台50,19,1,18,新光-高雄,2024-10-01,8562
2344,華邦電,72,54,18,新光-高雄,2024-10-01,8562
2316,楠梓電,26,8,18,新光-高雄,2024-10-01,8562
1513,中興電,25,7,18,新光-高雄,2024-10-01,8562
00679B,元大美債20年,82,65,17,新光-高雄,2024-10-01,8562
00688L,國泰20年美債正2,642,116,526,新光-高雄,2024-10-04,8562
00919,群益台灣精選高息,537,42,495,新光-高雄,2024-10-04,8562
00680L,元大美債20正2,881,414,467,新光-高雄,2024-10-04,8562
00633L,富邦上証正2,423,35,388,新光-高雄,2024-10-04,8562
0056,元大高股息,341,9,332,新光-高雄,2024-10-04,8562
00632R,元大台灣50反1,272,125,147,新光-高雄,2024-10-04,8562
00706L,期元大S＆P日圓正2,148,21,127,新光-高雄,2024-10-04,8562
00937B,群益ESG投等債20,211,87,124,新光-高雄,2024-10-04,8562
2303,聯電,125,2,123,新光-高雄,2024-10-04,8562
2603,長榮,151,45,106,新光-高雄,2024-10-04,8562
2243,宏旭-KY,128,25,103,新光-高雄,2024-10-04,8562
00665L,富邦�琤肭磪囓�2,294,197,97,新光-高雄,2024-10-04,8562
00878,國泰永續高股息,124,30,94,新光-高雄,2024-10-04,8562
00679B,元大美債20年,155,60,95,新光-高雄,2024-10-04,8562
00940,元大台灣價值高息,157,71,86,新光-高雄,2024-10-04,8562
3234,光環,91,6,85,新光-高雄,2024-10-04,8562
2610,華航,80,1,79,新光-高雄,2024-10-04,8562
2618,長榮航,96,28,68,新光-高雄,2024-10-04,8562
00918,大華優利高填息30,92,24,68,新光-高雄,2024-10-04,8562
2891,中信金,73,10,63,新光-高雄,2024-10-04,8562
00922,國泰台灣領袖50,67,6,61,新光-高雄,2024-10-04,8562
00915,凱基優選高股息30,61,0,61,新光-高雄,2024-10-04,8562
00927,群益半導體收益,64,3,61,新光-高雄,2024-10-04,8562
00712,復華富時不動產,62,2,60,新光-高雄,2024-10-04,8562
2615,萬海,95,38,57,新光-高雄,2024-10-04,8562
00905,FT臺灣Smart,56,4,52,新光-高雄,2024-10-04,8562
2312,金寶,73,22,51,新光-高雄,2024-10-04,8562
00713,元大台灣高息低波,56,10,46,新光-高雄,2024-10-04,8562
3062,建漢,122,77,45,新光-高雄,2024-10-04,8562
1304,台聚,46,2,44,新光-高雄,2024-10-04,8562
2515,中工,41,0,41,新光-高雄,2024-10-04,8562
00907,永豐優息存股,41,3,38,新光-高雄,2024-10-04,8562
00673R,期元大S＆P原油反1,278,243,35,新光-高雄,2024-10-04,8562
3046,建��,37,2,35,新光-高雄,2024-10-04,8562
9921,巨大,64,30,34,新光-高雄,2024-10-04,8562
2609,陽明,112,79,33,新光-高雄,2024-10-04,8562
4938,和碩,37,5,32,新光-高雄,2024-10-04,8562
2402,毅嘉,49,17,32,新光-高雄,2024-10-04,8562
00943,兆豐電子高息等權,43,12,31,新光-高雄,2024-10-04,8562
5483,中美晶,26,0,26,新光-高雄,2024-10-04,8562
1595,川寶,94,68,26,新光-高雄,2024-10-04,8562
5009,榮剛,27,1,26,新光-高雄,2024-10-04,8562
4113,聯上,31,6,25,新光-高雄,2024-10-04,8562
00932,兆豐永續高息等權,25,0,25,新光-高雄,2024-10-04,8562
3511,矽瑪,29,4,25,新光-高雄,2024-10-04,8562
3037,欣興,27,2,25,新光-高雄,2024-10-04,8562
00675L,富邦臺灣加權正2,38,14,24,新光-高雄,2024-10-04,8562
9958,世紀鋼,29,5,24,新光-高雄,2024-10-04,8562
2388,威盛,45,21,24,新光-高雄,2024-10-04,8562
2834,臺企銀,33,9,24,新光-高雄,2024-10-04,8562
00680L,元大美債20正2,831,296,535,新光-高雄,2024-10-07,8562
00715L,期街口布蘭特正2,551,132,419,新光-高雄,2024-10-07,8562
00720B,元大投資級公司債,426,19,407,新光-高雄,2024-10-07,8562
00753L,中信中國50正2,915,522,393,新光-高雄,2024-10-07,8562
00919,群益台灣精選高息,411,32,379,新光-高雄,2024-10-07,8562
00665L,富邦�琤肭磪囓�2,437,111,326,新光-高雄,2024-10-07,8562
00948B,中信優息投資級債,370,52,318,新光-高雄,2024-10-07,8562
00887,永豐中國科技50大,396,173,223,新光-高雄,2024-10-07,8562
2801,彰銀,200,3,197,新光-高雄,2024-10-07,8562
00706L,期元大S＆P日圓正2,163,0,163,新光-高雄,2024-10-07,8562
2897A,王道銀甲特,85,0,85,新光-高雄,2024-10-07,8562
2405,輔信,88,3,85,新光-高雄,2024-10-07,8562
00937B,群益ESG投等債20,325,242,83,新光-高雄,2024-10-07,8562
00713,元大台灣高息低波,74,5,69,新光-高雄,2024-10-07,8562
6133,金橋,68,0,68,新光-高雄,2024-10-07,8562
1314,中石化,127,61,66,新光-高雄,2024-10-07,8562
2855,統一證,58,0,58,新光-高雄,2024-10-07,8562
00650L,復華香港正2,78,23,55,新光-高雄,2024-10-07,8562
1815,富喬,146,95,51,新光-高雄,2024-10-07,8562
00918,大華優利高填息30,79,32,47,新光-高雄,2024-10-07,8562
4938,和碩,47,5,42,新光-高雄,2024-10-07,8562
912000,晨訊科-DR,41,0,41,新光-高雄,2024-10-07,8562
2402,毅嘉,149,110,39,新光-高雄,2024-10-07,8562
0056,元大高股息,61,22,39,新光-高雄,2024-10-07,8562
2363,矽統,69,34,35,新光-高雄,2024-10-07,8562
2867,三商壽,63,29,34,新光-高雄,2024-10-07,8562
1309,台達化,35,3,32,新光-高雄,2024-10-07,8562
00922,國泰台灣領袖50,44,12,32,新光-高雄,2024-10-07,8562
2615,萬海,94,62,32,新光-高雄,2024-10-07,8562
3481,群創,49,19,30,新光-高雄,2024-10-07,8562
2634,漢翔,30,0,30,新光-高雄,2024-10-07,8562
2515,中工,69,39,30,新光-高雄,2024-10-07,8562
3052,夆典,30,0,30,新光-高雄,2024-10-07,8562
00907,永豐優息存股,44,15,29,新光-高雄,2024-10-07,8562
3037,欣興,36,7,29,新光-高雄,2024-10-07,8562
00639,富邦深100,38,11,27,新光-高雄,2024-10-07,8562
00655L,國泰中國A50正2,66,39,27,新光-高雄,2024-10-07,8562
00931B,統一美債20年,45,19,26,新光-高雄,2024-10-07,8562
2356,英業達,58,32,26,新光-高雄,2024-10-07,8562
00764B,群益25年美債,26,0,26,新光-高雄,2024-10-07,8562
2834,臺企銀,50,24,26,新光-高雄,2024-10-07,8562
8111,立��,242,217,25,新光-高雄,2024-10-07,8562
2230,泰茂,26,1,25,新光-高雄,2024-10-07,8562
00960,野村全球航運龍頭,24,0,24,新光-高雄,2024-10-07,8562
00712,復華富時不動產,28,5,23,新光-高雄,2024-10-07,8562
00679B,元大美債20年,205,182,23,新光-高雄,2024-10-07,8562
2388,威盛,41,19,22,新光-高雄,2024-10-07,8562
2408,南亞科,28,6,22,新光-高雄,2024-10-07,8562
6753,龍德造船,26,5,21,新光-高雄,2024-10-07,8562
2606,裕民,21,0,21,新光-高雄,2024-10-07,8562
00948B,中信優息投資級債,346,0,346,新光-高雄,2024-10-08,8562
00687B,國泰20年美債,390,92,298,新光-高雄,2024-10-08,8562
00688L,國泰20年美債正2,427,135,292,新光-高雄,2024-10-08,8562
00665L,富邦�琤肭磪囓�2,523,248,275,新光-高雄,2024-10-08,8562
00919,群益台灣精選高息,276,108,168,新光-高雄,2024-10-08,8562
00937B,群益ESG投等債20,330,170,160,新光-高雄,2024-10-08,8562
00676R,富邦臺灣加權反1,155,0,155,新光-高雄,2024-10-08,8562
2883,凱基金,141,1,140,新光-高雄,2024-10-08,8562
00946,群益科技高息成長,140,1,139,新光-高雄,2024-10-08,8562
2897A,王道銀甲特,135,0,135,新光-高雄,2024-10-08,8562
0056,元大高股息,140,6,134,新光-高雄,2024-10-08,8562
00878,國泰永續高股息,140,17,123,新光-高雄,2024-10-08,8562
00929,復華台灣科技優息,269,148,121,新光-高雄,2024-10-08,8562
00679B,元大美債20年,229,110,119,新光-高雄,2024-10-08,8562
1314,中石化,123,8,115,新光-高雄,2024-10-08,8562
00918,大華優利高填息30,101,1,100,新光-高雄,2024-10-08,8562
2801,彰銀,99,0,99,新光-高雄,2024-10-08,8562
3049,精金,168,72,96,新光-高雄,2024-10-08,8562
3550,聯穎,108,15,93,新光-高雄,2024-10-08,8562
00922,國泰台灣領袖50,89,11,78,新光-高雄,2024-10-08,8562
911868,同方友友-DR,77,7,70,新光-高雄,2024-10-08,8562
3481,群創,108,47,61,新光-高雄,2024-10-08,8562
2032,新鋼,61,1,60,新光-高雄,2024-10-08,8562
2402,毅嘉,96,37,59,新光-高雄,2024-10-08,8562
2888,新光金,231,176,55,新光-高雄,2024-10-08,8562
00915,凱基優選高股息30,55,7,48,新光-高雄,2024-10-08,8562
1815,富喬,96,52,44,新光-高雄,2024-10-08,8562
00713,元大台灣高息低波,51,8,43,新光-高雄,2024-10-08,8562
4108,懷特,38,0,38,新光-高雄,2024-10-08,8562
6248,沛波,37,0,37,新光-高雄,2024-10-08,8562
4306,炎洲,36,0,36,新光-高雄,2024-10-08,8562
00712,復華富時不動產,69,33,36,新光-高雄,2024-10-08,8562
2634,漢翔,35,0,35,新光-高雄,2024-10-08,8562
00783,富邦中証500,33,0,33,新光-高雄,2024-10-08,8562
2356,英業達,51,20,31,新光-高雄,2024-10-08,8562
3037,欣興,33,2,31,新光-高雄,2024-10-08,8562
00945B,凱基美國非投等債,31,0,31,新光-高雄,2024-10-08,8562
00907,永豐優息存股,33,3,30,新光-高雄,2024-10-08,8562
2399,映泰,389,360,29,新光-高雄,2024-10-08,8562
00927,群益半導體收益,34,6,28,新光-高雄,2024-10-08,8562
4903,聯光通,129,101,28,新光-高雄,2024-10-08,8562
6133,金橋,41,14,27,新光-高雄,2024-10-08,8562
2615,萬海,81,55,26,新光-高雄,2024-10-08,8562
00638R,元大滬深300反1,25,0,25,新光-高雄,2024-10-08,8562
3046,建��,26,1,25,新光-高雄,2024-10-08,8562
3234,光環,34,9,25,新光-高雄,2024-10-08,8562
1309,台達化,36,12,24,新光-高雄,2024-10-08,8562
2838,聯邦銀,25,1,24,新光-高雄,2024-10-08,8562
3689,湧德,27,4,23,新光-高雄,2024-10-08,8562
1304,台聚,21,0,21,新光-高雄,2024-10-08,8562
00882,中信中國高股息,955,224,731,新光-高雄,2024-10-09,8562
00688L,國泰20年美債正2,696,70,626,新光-高雄,2024-10-09,8562
00687B,國泰20年美債,516,17,499,新光-高雄,2024-10-09,8562
00679B,元大美債20年,448,22,426,新光-高雄,2024-10-09,8562
00632R,元大台灣50反1,420,200,220,新光-高雄,2024-10-09,8562
1718,中纖,215,0,215,新光-高雄,2024-10-09,8562
00937B,群益ESG投等債20,208,13,195,新光-高雄,2024-10-09,8562
00940,元大台灣價值高息,131,1,130,新光-高雄,2024-10-09,8562
2880,華南金,130,2,128,新光-高雄,2024-10-09,8562
00680L,元大美債20正2,337,215,122,新光-高雄,2024-10-09,8562
1815,富喬,154,32,122,新光-高雄,2024-10-09,8562
2892,第一金,116,0,116,新光-高雄,2024-10-09,8562
00907,永豐優息存股,97,0,97,新光-高雄,2024-10-09,8562
00673R,期元大S＆P原油反1,154,61,93,新光-高雄,2024-10-09,8562
2002,中鋼,104,12,92,新光-高雄,2024-10-09,8562
00948B,中信優息投資級債,77,1,76,新光-高雄,2024-10-09,8562
2547,日勝生,60,0,60,新光-高雄,2024-10-09,8562
8028,昇陽半導體,101,42,59,新光-高雄,2024-10-09,8562
00665L,富邦�琤肭磪囓�2,486,427,59,新光-高雄,2024-10-09,8562
2601,益航,59,2,57,新光-高雄,2024-10-09,8562
00946,群益科技高息成長,56,0,56,新光-高雄,2024-10-09,8562
00915,凱基優選高股息30,74,19,55,新光-高雄,2024-10-09,8562
1314,中石化,110,56,54,新光-高雄,2024-10-09,8562
00650L,復華香港正2,134,82,52,新光-高雄,2024-10-09,8562
5512,力麒,52,1,51,新光-高雄,2024-10-09,8562
00795B,中信美國公債20年,54,4,50,新光-高雄,2024-10-09,8562
1409,新纖,51,1,50,新光-高雄,2024-10-09,8562
5398,慕康生醫,52,2,50,新光-高雄,2024-10-09,8562
00725B,國泰投資級公司債,47,0,47,新光-高雄,2024-10-09,8562
2498,宏達電,62,15,47,新光-高雄,2024-10-09,8562
1309,台達化,57,10,47,新光-高雄,2024-10-09,8562
3363,上詮,159,112,47,新光-高雄,2024-10-09,8562
2603,長榮,68,23,45,新光-高雄,2024-10-09,8562
1312,國喬,44,0,44,新光-高雄,2024-10-09,8562
00706L,期元大S＆P日圓正2,42,0,42,新光-高雄,2024-10-09,8562
00633L,富邦上証正2,281,239,42,新光-高雄,2024-10-09,8562
3052,夆典,40,0,40,新光-高雄,2024-10-09,8562
2303,聯電,43,3,40,新光-高雄,2024-10-09,8562
2363,矽統,311,275,36,新光-高雄,2024-10-09,8562
00929,復華台灣科技優息,86,54,32,新光-高雄,2024-10-09,8562
3591,艾笛森,39,7,32,新光-高雄,2024-10-09,8562
00712,復華富時不動產,32,1,31,新光-高雄,2024-10-09,8562
4105,東洋,31,0,31,新光-高雄,2024-10-09,8562
3234,光環,36,6,30,新光-高雄,2024-10-09,8562
5907,大洋-KY,30,3,27,新光-高雄,2024-10-09,8562
2313,華通,34,7,27,新光-高雄,2024-10-09,8562
3380,明泰,93,67,26,新光-高雄,2024-10-09,8562
3622,洋華,36,12,24,新光-高雄,2024-10-09,8562
1326,台化,35,12,23,新光-高雄,2024-10-09,8562
2368,金像電,22,0,22,新光-高雄,2024-10-09,8562
00632R,元大台灣50反1,2137,120,2017,新光-高雄,2024-10-11,8562
2883,凱基金,1451,158,1293,新光-高雄,2024-10-11,8562
00680L,元大美債20正2,788,97,691,新光-高雄,2024-10-11,8562
00637L,元大滬深300正2,1320,652,668,新光-高雄,2024-10-11,8562
00688L,國泰20年美債正2,365,109,256,新光-高雄,2024-10-11,8562
00679B,元大美債20年,227,35,192,新光-高雄,2024-10-11,8562
2880,華南金,126,15,111,新光-高雄,2024-10-11,8562
9921,巨大,116,26,90,新光-高雄,2024-10-11,8562
00753L,中信中國50正2,532,443,89,新光-高雄,2024-10-11,8562
00673R,期元大S＆P原油反1,99,10,89,新光-高雄,2024-10-11,8562
00915,凱基優選高股息30,112,30,82,新光-高雄,2024-10-11,8562
3715,定穎投控,77,8,69,新光-高雄,2024-10-11,8562
00795B,中信美國公債20年,63,5,58,新光-高雄,2024-10-11,8562
00633L,富邦上証正2,264,211,53,新光-高雄,2024-10-11,8562
00676R,富邦臺灣加權反1,52,0,52,新光-高雄,2024-10-11,8562
5324,士開,50,0,50,新光-高雄,2024-10-11,8562
2388,威盛,73,26,47,新光-高雄,2024-10-11,8562
2449,京元電子,116,71,45,新光-高雄,2024-10-11,8562
0056,元大高股息,59,14,45,新光-高雄,2024-10-11,8562
00725B,國泰投資級公司債,43,1,42,新光-高雄,2024-10-11,8562
00713,元大台灣高息低波,45,3,42,新光-高雄,2024-10-11,8562
3706,神達,59,18,41,新光-高雄,2024-10-11,8562
4414,如興,40,0,40,新光-高雄,2024-10-11,8562
3163,波若威,122,82,40,新光-高雄,2024-10-11,8562
2855,統一證,37,0,37,新光-高雄,2024-10-11,8562
2887,台新金,65,29,36,新光-高雄,2024-10-11,8562
1314,中石化,58,24,34,新光-高雄,2024-10-11,8562
00922,國泰台灣領袖50,49,16,33,新光-高雄,2024-10-11,8562
3052,夆典,31,0,31,新光-高雄,2024-10-11,8562
4958,臻鼎-KY,32,2,30,新光-高雄,2024-10-11,8562
6108,競國,30,0,30,新光-高雄,2024-10-11,8562
00706L,期元大S＆P日圓正2,29,0,29,新光-高雄,2024-10-11,8562
6770,力積電,31,2,29,新光-高雄,2024-10-11,8562
00733,富邦臺灣中小,29,1,28,新光-高雄,2024-10-11,8562
2610,華航,33,5,28,新光-高雄,2024-10-11,8562
00919,群益台灣精選高息,61,33,28,新光-高雄,2024-10-11,8562
3450,聯鈞,62,36,26,新光-高雄,2024-10-11,8562
00882,中信中國高股息,569,544,25,新光-高雄,2024-10-11,8562
2601,益航,27,3,24,新光-高雄,2024-10-11,8562
00937B,群益ESG投等債20,152,128,24,新光-高雄,2024-10-11,8562
2349,錸德,73,50,23,新光-高雄,2024-10-11,8562
6292,迅德,23,0,23,新光-高雄,2024-10-11,8562
2905,三商,23,0,23,新光-高雄,2024-10-11,8562
00655L,國泰中國A50正2,24,2,22,新光-高雄,2024-10-11,8562
8105,凌巨,22,0,22,新光-高雄,2024-10-11,8562
4906,正文,29,8,21,新光-高雄,2024-10-11,8562
2885,元大金,23,1,22,新光-高雄,2024-10-11,8562
2303,聯電,22,1,21,新光-高雄,2024-10-11,8562
00931B,統一美債20年,22,2,20,新光-高雄,2024-10-11,8562
3591,艾笛森,25,5,20,新光-高雄,2024-10-11,8562
00680L,元大美債20正2,365,56,309,新光-高雄,2024-10-14,8562
00688L,國泰20年美債正2,391,86,305,新光-高雄,2024-10-14,8562
2883,凱基金,313,15,298,新光-高雄,2024-10-14,8562
00637L,元大滬深300正2,843,605,238,新光-高雄,2024-10-14,8562
00887,永豐中國科技50大,198,0,198,新光-高雄,2024-10-14,8562
00679B,元大美債20年,245,60,185,新光-高雄,2024-10-14,8562
00937B,群益ESG投等債20,324,193,131,新光-高雄,2024-10-14,8562
00715L,期街口布蘭特正2,124,2,122,新光-高雄,2024-10-14,8562
00687B,國泰20年美債,359,243,116,新光-高雄,2024-10-14,8562
2880,華南金,120,6,114,新光-高雄,2024-10-14,8562
2881,富邦金,101,1,100,新光-高雄,2024-10-14,8562
00915,凱基優選高股息30,83,11,72,新光-高雄,2024-10-14,8562
00795B,中信美國公債20年,91,22,69,新光-高雄,2024-10-14,8562
3234,光環,68,1,67,新光-高雄,2024-10-14,8562
00922,國泰台灣領袖50,74,9,65,新光-高雄,2024-10-14,8562
2312,金寶,225,163,62,新光-高雄,2024-10-14,8562
00673R,期元大S＆P原油反1,110,55,55,新光-高雄,2024-10-14,8562
00948B,中信優息投資級債,64,10,54,新光-高雄,2024-10-14,8562
00633L,富邦上証正2,70,18,52,新光-高雄,2024-10-14,8562
3710,連展投控,53,12,41,新光-高雄,2024-10-14,8562
00712,復華富時不動產,50,10,40,新光-高雄,2024-10-14,8562
00656R,國泰中國A50反1,40,0,40,新光-高雄,2024-10-14,8562
3481,群創,81,49,32,新光-高雄,2024-10-14,8562
00764B,群益25年美債,32,1,31,新光-高雄,2024-10-14,8562
8011,台通,41,14,27,新光-高雄,2024-10-14,8562
3289,宜特,38,11,27,新光-高雄,2024-10-14,8562
3715,定穎投控,44,17,27,新光-高雄,2024-10-14,8562
3049,精金,67,42,25,新光-高雄,2024-10-14,8562
2388,威盛,51,29,22,新光-高雄,2024-10-14,8562
4956,光鋐,217,195,22,新光-高雄,2024-10-14,8562
8936,國統,21,0,21,新光-高雄,2024-10-14,8562
2243,宏旭-KY,22,1,21,新光-高雄,2024-10-14,8562
1436,華友聯,20,0,20,新光-高雄,2024-10-14,8562
4903,聯光通,43,23,20,新光-高雄,2024-10-14,8562
2066,世德,20,0,20,新光-高雄,2024-10-14,8562
00730,富邦臺灣優質高息,20,1,19,新光-高雄,2024-10-14,8562
1326,台化,24,5,19,新光-高雄,2024-10-14,8562
1313,聯成,20,1,19,新光-高雄,2024-10-14,8562
00696B,富邦美債20年,23,5,18,新光-高雄,2024-10-14,8562
00706L,期元大S＆P日圓正2,18,0,18,新光-高雄,2024-10-14,8562
9945,潤泰新,25,7,18,新光-高雄,2024-10-14,8562
1314,中石化,17,0,17,新光-高雄,2024-10-14,8562
2543,皇昌,63,46,17,新光-高雄,2024-10-14,8562
3576,聯合再生,17,0,17,新光-高雄,2024-10-14,8562
2892,第一金,17,1,16,新光-高雄,2024-10-14,8562
2618,長榮航,25,9,16,新光-高雄,2024-10-14,8562
6104,創惟,59,43,16,新光-高雄,2024-10-14,8562
9919,康那香,16,0,16,新光-高雄,2024-10-14,8562
2002,中鋼,20,4,16,新光-高雄,2024-10-14,8562
00857B,永豐20年美公債,16,0,16,新光-高雄,2024-10-14,8562
3481,群創,536,33,503,新光-高雄,2024-10-15,8562
00637L,元大滬深300正2,556,120,436,新光-高雄,2024-10-15,8562
00680L,元大美債20正2,280,47,233,新光-高雄,2024-10-15,8562
1314,中石化,255,36,219,新光-高雄,2024-10-15,8562
00937B,群益ESG投等債20,204,18,186,新光-高雄,2024-10-15,8562
2449,京元電子,175,31,144,新光-高雄,2024-10-15,8562
00676R,富邦臺灣加權反1,102,0,102,新光-高雄,2024-10-15,8562
00642U,期元大S＆P石油,100,0,100,新光-高雄,2024-10-15,8562
3049,精金,115,18,97,新光-高雄,2024-10-15,8562
00715L,期街口布蘭特正2,179,86,93,新光-高雄,2024-10-15,8562
00639,富邦深100,107,14,93,新光-高雄,2024-10-15,8562
00665L,富邦�琤肭磪囓�2,193,112,81,新光-高雄,2024-10-15,8562
00887,永豐中國科技50大,128,50,78,新光-高雄,2024-10-15,8562
00633L,富邦上証正2,77,0,77,新光-高雄,2024-10-15,8562
9921,巨大,84,11,73,新光-高雄,2024-10-15,8562
2455,全新,113,41,72,新光-高雄,2024-10-15,8562
1718,中纖,65,0,65,新光-高雄,2024-10-15,8562
00687B,國泰20年美債,141,79,62,新光-高雄,2024-10-15,8562
00948B,中信優息投資級債,61,0,61,新光-高雄,2024-10-15,8562
00753L,中信中國50正2,232,173,59,新光-高雄,2024-10-15,8562
00679B,元大美債20年,90,37,53,新光-高雄,2024-10-15,8562
3062,建漢,257,207,50,新光-高雄,2024-10-15,8562
2312,金寶,91,44,47,新光-高雄,2024-10-15,8562
1301,台塑,45,0,45,新光-高雄,2024-10-15,8562
5438,東友,47,4,43,新光-高雄,2024-10-15,8562
2905,三商,52,9,43,新光-高雄,2024-10-15,8562
00795B,中信美國公債20年,46,4,42,新光-高雄,2024-10-15,8562
00946,群益科技高息成長,47,7,40,新光-高雄,2024-10-15,8562
00882,中信中國高股息,69,32,37,新光-高雄,2024-10-15,8562
00961,FT臺灣永續高息,34,0,34,新光-高雄,2024-10-15,8562
3027,盛達,36,3,33,新光-高雄,2024-10-15,8562
3591,艾笛森,34,1,33,新光-高雄,2024-10-15,8562
00650L,復華香港正2,32,0,32,新光-高雄,2024-10-15,8562
3710,連展投控,32,1,31,新光-高雄,2024-10-15,8562
1626,艾美特-KY,31,1,30,新光-高雄,2024-10-15,8562
2388,威盛,53,25,28,新光-高雄,2024-10-15,8562
00725B,國泰投資級公司債,28,1,27,新光-高雄,2024-10-15,8562
3149,正達,258,233,25,新光-高雄,2024-10-15,8562
3694,海華,25,0,25,新光-高雄,2024-10-15,8562
8110,華東,30,5,25,新光-高雄,2024-10-15,8562
2405,輔信,25,1,24,新光-高雄,2024-10-15,8562
6743,安普新,24,0,24,新光-高雄,2024-10-15,8562
8028,昇陽半導體,45,23,22,新光-高雄,2024-10-15,8562
00922,國泰台灣領袖50,28,6,22,新光-高雄,2024-10-15,8562
2887,台新金,56,34,22,新光-高雄,2024-10-15,8562
1503,士電,26,5,21,新光-高雄,2024-10-15,8562
2605,新興,20,0,20,新光-高雄,2024-10-15,8562
2059,川湖,18,0,18,新光-高雄,2024-10-15,8562
2812,台中銀,25,8,17,新光-高雄,2024-10-15,8562
00907,永豐優息存股,33,16,17,新光-高雄,2024-10-15,8562
00937B,群益ESG投等債20,338,3,335,新光-高雄,2024-10-16,8562
00637L,元大滬深300正2,613,306,307,新光-高雄,2024-10-16,8562
2888,新光金,243,18,225,新光-高雄,2024-10-16,8562
00922,國泰台灣領袖50,209,10,199,新光-高雄,2024-10-16,8562
00887,永豐中國科技50大,173,20,153,新光-高雄,2024-10-16,8562
00688L,國泰20年美債正2,366,245,121,新光-高雄,2024-10-16,8562
0056,元大高股息,316,210,106,新光-高雄,2024-10-16,8562
00725B,國泰投資級公司債,104,2,102,新光-高雄,2024-10-16,8562
2812,台中銀,102,8,94,新光-高雄,2024-10-16,8562
00830,國泰費城半導體,87,7,80,新光-高雄,2024-10-16,8562
00679B,元大美債20年,153,81,72,新光-高雄,2024-10-16,8562
00680L,元大美債20正2,229,159,70,新光-高雄,2024-10-16,8562
00948B,中信優息投資級債,73,5,68,新光-高雄,2024-10-16,8562
2317,鴻海,106,41,65,新光-高雄,2024-10-16,8562
2634,漢翔,66,2,64,新光-高雄,2024-10-16,8562
2883,凱基金,101,40,61,新光-高雄,2024-10-16,8562
2887,台新金,64,4,60,新光-高雄,2024-10-16,8562
00665L,富邦�琤肭磪囓�2,111,56,55,新光-高雄,2024-10-16,8562
2002,中鋼,59,6,53,新光-高雄,2024-10-16,8562
00795B,中信美國公債20年,59,9,50,新光-高雄,2024-10-16,8562
00656R,國泰中國A50反1,50,0,50,新光-高雄,2024-10-16,8562
00895,富邦未來車,49,1,48,新光-高雄,2024-10-16,8562
00664R,國泰臺灣加權反1,50,2,48,新光-高雄,2024-10-16,8562
00687B,國泰20年美債,182,138,44,新光-高雄,2024-10-16,8562
4714,永捷,40,0,40,新光-高雄,2024-10-16,8562
2303,聯電,43,4,39,新光-高雄,2024-10-16,8562
00919,群益台灣精選高息,89,52,37,新光-高雄,2024-10-16,8562
00715L,期街口布蘭特正2,37,0,37,新光-高雄,2024-10-16,8562
00706L,期元大S＆P日圓正2,35,0,35,新光-高雄,2024-10-16,8562
00675L,富邦臺灣加權正2,52,18,34,新光-高雄,2024-10-16,8562
00639,富邦深100,48,14,34,新光-高雄,2024-10-16,8562
6743,安普新,31,0,31,新光-高雄,2024-10-16,8562
1595,川寶,38,10,28,新光-高雄,2024-10-16,8562
00932,兆豐永續高息等權,33,7,26,新光-高雄,2024-10-16,8562
00713,元大台灣高息低波,28,2,26,新光-高雄,2024-10-16,8562
2486,一詮,111,86,25,新光-高雄,2024-10-16,8562
2027,大成鋼,26,3,23,新光-高雄,2024-10-16,8562
6290,良維,22,0,22,新光-高雄,2024-10-16,8562
8086,宏捷科,22,1,21,新光-高雄,2024-10-16,8562
6164,華興,23,4,19,新光-高雄,2024-10-16,8562
2363,矽統,88,69,19,新光-高雄,2024-10-16,8562
3189,景碩,22,4,18,新光-高雄,2024-10-16,8562
6126,信音,18,0,18,新光-高雄,2024-10-16,8562
2891,中信金,44,26,18,新光-高雄,2024-10-16,8562
006208,富邦台50,37,20,17,新光-高雄,2024-10-16,8562
00905,FT臺灣Smart,32,15,17,新光-高雄,2024-10-16,8562
3511,矽瑪,18,1,17,新光-高雄,2024-10-16,8562
2408,南亞科,22,5,17,新光-高雄,2024-10-16,8562
1319,東陽,42,25,17,新光-高雄,2024-10-16,8562
2033,佳大,35,19,16,新光-高雄,2024-10-16,8562
00680L,元大美債20正2,403,102,301,新光-高雄,2024-10-17,8562
0056,元大高股息,244,35,209,新光-高雄,2024-10-17,8562
00637L,元大滬深300正2,382,185,197,新光-高雄,2024-10-17,8562
00687B,國泰20年美債,261,64,197,新光-高雄,2024-10-17,8562
00688L,國泰20年美債正2,177,20,157,新光-高雄,2024-10-17,8562
00887,永豐中國科技50大,157,3,154,新光-高雄,2024-10-17,8562
5452,佶優,186,49,137,新光-高雄,2024-10-17,8562
00795B,中信美國公債20年,122,0,122,新光-高雄,2024-10-17,8562
4714,永捷,110,6,104,新光-高雄,2024-10-17,8562
00922,國泰台灣領袖50,115,11,104,新光-高雄,2024-10-17,8562
00665L,富邦�琤肭磪囓�2,170,73,97,新光-高雄,2024-10-17,8562
00715L,期街口布蘭特正2,112,25,87,新光-高雄,2024-10-17,8562
00632R,元大台灣50反1,170,90,80,新光-高雄,2024-10-17,8562
00753L,中信中國50正2,365,287,78,新光-高雄,2024-10-17,8562
00882,中信中國高股息,85,18,67,新光-高雄,2024-10-17,8562
00945B,凱基美國非投等債,57,0,57,新光-高雄,2024-10-17,8562
8111,立��,173,116,57,新光-高雄,2024-10-17,8562
2363,矽統,91,37,54,新光-高雄,2024-10-17,8562
00905,FT臺灣Smart,71,18,53,新光-高雄,2024-10-17,8562
4956,光鋐,52,0,52,新光-高雄,2024-10-17,8562
3450,聯鈞,179,128,51,新光-高雄,2024-10-17,8562
00931B,統一美債20年,101,50,51,新光-高雄,2024-10-17,8562
2303,聯電,51,4,47,新光-高雄,2024-10-17,8562
2399,映泰,423,377,46,新光-高雄,2024-10-17,8562
1101,台泥,40,0,40,新光-高雄,2024-10-17,8562
3011,今皓,50,14,36,新光-高雄,2024-10-17,8562
4533,協易機,72,36,36,新光-高雄,2024-10-17,8562
00935,野村臺灣新科技50,41,7,34,新光-高雄,2024-10-17,8562
00647L,元大S＆P500正2,30,0,30,新光-高雄,2024-10-17,8562
00706L,期元大S＆P日圓正2,26,0,26,新光-高雄,2024-10-17,8562
1312,國喬,39,14,25,新光-高雄,2024-10-17,8562
3062,建漢,212,188,24,新光-高雄,2024-10-17,8562
2402,毅嘉,70,46,24,新光-高雄,2024-10-17,8562
00927,群益半導體收益,23,0,23,新光-高雄,2024-10-17,8562
00912,中信臺灣智慧50,22,1,21,新光-高雄,2024-10-17,8562
00919,群益台灣精選高息,52,31,21,新光-高雄,2024-10-17,8562
00937B,群益ESG投等債20,174,154,20,新光-高雄,2024-10-17,8562
2520,冠德,21,1,20,新光-高雄,2024-10-17,8562
4958,臻鼎-KY,26,7,19,新光-高雄,2024-10-17,8562
3615,安可,36,17,19,新光-高雄,2024-10-17,8562
2388,威盛,20,2,18,新光-高雄,2024-10-17,8562
2426,鼎元,29,11,18,新光-高雄,2024-10-17,8562
2330,台積電,35,17,18,新光-高雄,2024-10-17,8562
1473,台南,18,1,17,新光-高雄,2024-10-17,8562
5230,雷笛克光學,45,28,17,新光-高雄,2024-10-17,8562
6609,瀧澤科,56,40,16,新光-高雄,2024-10-17,8562
1528,恩德,77,61,16,新光-高雄,2024-10-17,8562
2601,益航,26,10,16,新光-高雄,2024-10-17,8562
3702A,大聯大甲特,15,0,15,新光-高雄,2024-10-17,8562
00948B,中信優息投資級債,15,0,15,新光-高雄,2024-10-17,8562
00632R,元大台灣50反1,736,55,681,新光-高雄,2024-10-18,8562
00937B,群益ESG投等債20,374,7,367,新光-高雄,2024-10-18,8562
00688L,國泰20年美債正2,349,0,349,新光-高雄,2024-10-18,8562
00679B,元大美債20年,388,75,313,新光-高雄,2024-10-18,8562
00687B,國泰20年美債,315,13,302,新光-高雄,2024-10-18,8562
00948B,中信優息投資級債,265,0,265,新光-高雄,2024-10-18,8562
00795B,中信美國公債20年,236,0,236,新光-高雄,2024-10-18,8562
0056,元大高股息,227,26,201,新光-高雄,2024-10-18,8562
1721,三晃,177,15,162,新光-高雄,2024-10-18,8562
2409,友達,151,26,125,新光-高雄,2024-10-18,8562
00676R,富邦臺灣加權反1,115,0,115,新光-高雄,2024-10-18,8562
2317,鴻海,323,234,89,新光-高雄,2024-10-18,8562
00919,群益台灣精選高息,147,69,78,新光-高雄,2024-10-18,8562
00905,FT臺灣Smart,135,65,70,新光-高雄,2024-10-18,8562
00639,富邦深100,70,6,64,新光-高雄,2024-10-18,8562
00887,永豐中國科技50大,81,20,61,新光-高雄,2024-10-18,8562
00706L,期元大S＆P日圓正2,61,0,61,新光-高雄,2024-10-18,8562
2303,聯電,82,26,56,新光-高雄,2024-10-18,8562
00931B,統一美債20年,56,0,56,新光-高雄,2024-10-18,8562
00633L,富邦上証正2,110,63,47,新光-高雄,2024-10-18,8562
00942B,台新美A公司債20+,42,0,42,新光-高雄,2024-10-18,8562
2399,映泰,190,149,41,新光-高雄,2024-10-18,8562
00740B,富邦全球投等債,40,0,40,新光-高雄,2024-10-18,8562
2353,宏��,42,3,39,新光-高雄,2024-10-18,8562
00733,富邦臺灣中小,41,3,38,新光-高雄,2024-10-18,8562
00720B,元大投資級公司債,68,31,37,新光-高雄,2024-10-18,8562
3209,全科,55,20,35,新光-高雄,2024-10-18,8562
00932,兆豐永續高息等權,34,0,34,新光-高雄,2024-10-18,8562
00764B,群益25年美債,31,0,31,新光-高雄,2024-10-18,8562
4714,永捷,28,0,28,新光-高雄,2024-10-18,8562
1597,直得,55,28,27,新光-高雄,2024-10-18,8562
6213,聯茂,26,0,26,新光-高雄,2024-10-18,8562
3037,欣興,50,24,26,新光-高雄,2024-10-18,8562
3312,弘憶股,47,22,25,新光-高雄,2024-10-18,8562
2897,王道銀行,24,0,24,新光-高雄,2024-10-18,8562
3689,湧德,26,2,24,新光-高雄,2024-10-18,8562
2313,華通,25,1,24,新光-高雄,2024-10-18,8562
6763,綠界科技*,51,27,24,新光-高雄,2024-10-18,8562
3450,聯鈞,92,69,23,新光-高雄,2024-10-18,8562
00933B,國泰10Y+金融債,43,20,23,新光-高雄,2024-10-18,8562
6134,萬旭,27,4,23,新光-高雄,2024-10-18,8562
2605,新興,22,0,22,新光-高雄,2024-10-18,8562
00751B,元大AAA至A公司債,51,29,22,新光-高雄,2024-10-18,8562
4979,華星光,56,34,22,新光-高雄,2024-10-18,8562
4938,和碩,21,0,21,新光-高雄,2024-10-18,8562
9938,百和,23,3,20,新光-高雄,2024-10-18,8562
9105,泰金寶-DR,46,26,20,新光-高雄,2024-10-18,8562
4510,高鋒,225,205,20,新光-高雄,2024-10-18,8562
3162,精確,35,16,19,新光-高雄,2024-10-18,8562
2374,佳能,54,35,19,新光-高雄,2024-10-18,8562
00937B,群益ESG投等債20,1287,244,1043,新光-高雄,2024-10-21,8562
00753L,中信中國50正2,1013,358,655,新光-高雄,2024-10-21,8562
00637L,元大滬深300正2,546,311,235,新光-高雄,2024-10-21,8562
00795B,中信美國公債20年,222,1,221,新光-高雄,2024-10-21,8562
00948B,中信優息投資級債,191,8,183,新光-高雄,2024-10-21,8562
2883,凱基金,214,32,182,新光-高雄,2024-10-21,8562
00725B,國泰投資級公司債,177,12,165,新光-高雄,2024-10-21,8562
00639,富邦深100,185,23,162,新光-高雄,2024-10-21,8562
00715L,期街口布蘭特正2,144,6,138,新光-高雄,2024-10-21,8562
00679B,元大美債20年,188,52,136,新光-高雄,2024-10-21,8562
00687B,國泰20年美債,196,61,135,新光-高雄,2024-10-21,8562
2312,金寶,167,63,104,新光-高雄,2024-10-21,8562
2409,友達,102,10,92,新光-高雄,2024-10-21,8562
2332,友訊,100,8,92,新光-高雄,2024-10-21,8562
2881,富邦金,101,12,89,新光-高雄,2024-10-21,8562
00878,國泰永續高股息,153,66,87,新光-高雄,2024-10-21,8562
8027,鈦昇,108,28,80,新光-高雄,2024-10-21,8562
00959B,大華投等美債15Y+,61,0,61,新光-高雄,2024-10-21,8562
4414,如興,58,0,58,新光-高雄,2024-10-21,8562
00720B,元大投資級公司債,59,2,57,新光-高雄,2024-10-21,8562
3481,群創,117,60,57,新光-高雄,2024-10-21,8562
00882,中信中國高股息,102,50,52,新光-高雄,2024-10-21,8562
00633L,富邦上証正2,52,9,43,新光-高雄,2024-10-21,8562
00915,凱基優選高股息30,56,15,41,新光-高雄,2024-10-21,8562
3011,今皓,61,25,36,新光-高雄,2024-10-21,8562
2493,揚博,39,5,34,新光-高雄,2024-10-21,8562
5452,佶優,102,72,30,新光-高雄,2024-10-21,8562
4714,永捷,30,0,30,新光-高雄,2024-10-21,8562
2884,玉山金,28,0,28,新光-高雄,2024-10-21,8562
1314,中石化,30,3,27,新光-高雄,2024-10-21,8562
3051,力特,32,5,27,新光-高雄,2024-10-21,8562
00751B,元大AAA至A公司債,30,3,27,新光-高雄,2024-10-21,8562
2882,國泰金,28,2,26,新光-高雄,2024-10-21,8562
0056,元大高股息,38,13,25,新光-高雄,2024-10-21,8562
00950B,凱基A級公司債,25,0,25,新光-高雄,2024-10-21,8562
9105,泰金寶-DR,99,74,25,新光-高雄,2024-10-21,8562
2421,建準,31,6,25,新光-高雄,2024-10-21,8562
1312,國喬,24,0,24,新光-高雄,2024-10-21,8562
00772B,中信高評級公司債,25,3,22,新光-高雄,2024-10-21,8562
0050,元大台灣50,31,8,23,新光-高雄,2024-10-21,8562
2890,永豐金,27,5,22,新光-高雄,2024-10-21,8562
6532,瑞耘,59,37,22,新光-高雄,2024-10-21,8562
00895,富邦未來車,23,1,22,新光-高雄,2024-10-21,8562
2891,中信金,138,116,22,新光-高雄,2024-10-21,8562
3711,日月光投控,23,2,21,新光-高雄,2024-10-21,8562
5516,雙喜,21,0,21,新光-高雄,2024-10-21,8562
6136,富爾特,20,0,20,新光-高雄,2024-10-21,8562
2834,臺企銀,29,10,19,新光-高雄,2024-10-21,8562
1301,台塑,22,3,19,新光-高雄,2024-10-21,8562
2367,燿華,23,5,18,新光-高雄,2024-10-21,8562
00937B,群益ESG投等債20,1258,162,1096,新光-高雄,2024-10-22,8562
00680L,元大美債20正2,1027,236,791,新光-高雄,2024-10-22,8562
00687B,國泰20年美債,606,29,577,新光-高雄,2024-10-22,8562
00948B,中信優息投資級債,506,0,506,新光-高雄,2024-10-22,8562
00679B,元大美債20年,408,81,327,新光-高雄,2024-10-22,8562
3481,群創,377,63,314,新光-高雄,2024-10-22,8562
00688L,國泰20年美債正2,568,279,289,新光-高雄,2024-10-22,8562
00905,FT臺灣Smart,148,3,145,新光-高雄,2024-10-22,8562
00712,復華富時不動產,142,10,132,新光-高雄,2024-10-22,8562
2002,中鋼,118,3,115,新光-高雄,2024-10-22,8562
2883,凱基金,117,7,110,新光-高雄,2024-10-22,8562
00751B,元大AAA至A公司債,113,6,107,新光-高雄,2024-10-22,8562
00795B,中信美國公債20年,101,1,100,新光-高雄,2024-10-22,8562
00720B,元大投資級公司債,113,25,88,新光-高雄,2024-10-22,8562
00725B,國泰投資級公司債,63,0,63,新光-高雄,2024-10-22,8562
2330,台積電,86,24,62,新光-高雄,2024-10-22,8562
9949,琉園,54,0,54,新光-高雄,2024-10-22,8562
1785,光洋科,62,12,50,新光-高雄,2024-10-22,8562
1605,華新,52,4,48,新光-高雄,2024-10-22,8562
2887,台新金,106,61,45,新光-高雄,2024-10-22,8562
00706L,期元大S＆P日圓正2,64,21,43,新光-高雄,2024-10-22,8562
00650L,復華香港正2,43,0,43,新光-高雄,2024-10-22,8562
00764B,群益25年美債,42,0,42,新光-高雄,2024-10-22,8562
6197,佳必琪,53,12,41,新光-高雄,2024-10-22,8562
3581,博磊,66,27,39,新光-高雄,2024-10-22,8562
00929,復華台灣科技優息,74,37,37,新光-高雄,2024-10-22,8562
4938,和碩,57,21,36,新光-高雄,2024-10-22,8562
2405,輔信,84,50,34,新光-高雄,2024-10-22,8562
2363,矽統,123,90,33,新光-高雄,2024-10-22,8562
2388,威盛,39,7,32,新光-高雄,2024-10-22,8562
4533,協易機,35,5,30,新光-高雄,2024-10-22,8562
2515,中工,30,0,30,新光-高雄,2024-10-22,8562
00933B,國泰10Y+金融債,80,51,29,新光-高雄,2024-10-22,8562
2444,兆勁,29,0,29,新光-高雄,2024-10-22,8562
3615,安可,137,109,28,新光-高雄,2024-10-22,8562
5521,工信,29,4,25,新光-高雄,2024-10-22,8562
2884,玉山金,26,2,24,新光-高雄,2024-10-22,8562
4979,華星光,59,35,24,新光-高雄,2024-10-22,8562
2303,聯電,29,7,22,新光-高雄,2024-10-22,8562
3715,定穎投控,47,26,21,新光-高雄,2024-10-22,8562
0061,元大寶滬深,21,0,21,新光-高雄,2024-10-22,8562
00907,永豐優息存股,21,0,21,新光-高雄,2024-10-22,8562
00953B,群益優選非投等債,20,0,20,新光-高雄,2024-10-22,8562
006208,富邦台50,25,5,20,新光-高雄,2024-10-22,8562
1314,中石化,33,14,19,新光-高雄,2024-10-22,8562
2412,中華電,26,8,18,新光-高雄,2024-10-22,8562
2243,宏旭-KY,18,0,18,新光-高雄,2024-10-22,8562
3189,景碩,161,143,18,新光-高雄,2024-10-22,8562
8021,尖點,59,42,17,新光-高雄,2024-10-22,8562
2615,萬海,52,35,17,新光-高雄,2024-10-22,8562
00919,群益台灣精選高息,1102,46,1056,新光-高雄,2024-10-23,8562
0056,元大高股息,298,10,288,新光-高雄,2024-10-23,8562
2887,台新金,266,2,264,新光-高雄,2024-10-23,8562
00937B,群益ESG投等債20,515,256,259,新光-高雄,2024-10-23,8562
2409,友達,250,53,197,新光-高雄,2024-10-23,8562
00706L,期元大S＆P日圓正2,189,0,189,新光-高雄,2024-10-23,8562
00712,復華富時不動產,199,11,188,新光-高雄,2024-10-23,8562
00680L,元大美債20正2,138,28,110,新光-高雄,2024-10-23,8562
00639,富邦深100,104,2,102,新光-高雄,2024-10-23,8562
00878,國泰永續高股息,101,4,97,新光-高雄,2024-10-23,8562
00679B,元大美債20年,226,135,91,新光-高雄,2024-10-23,8562
00688L,國泰20年美債正2,84,3,81,新光-高雄,2024-10-23,8562
00929,復華台灣科技優息,119,42,77,新光-高雄,2024-10-23,8562
00948B,中信優息投資級債,77,3,74,新光-高雄,2024-10-23,8562
00675L,富邦臺灣加權正2,74,7,67,新光-高雄,2024-10-23,8562
1314,中石化,64,2,62,新光-高雄,2024-10-23,8562
2884,玉山金,58,1,57,新光-高雄,2024-10-23,8562
00959B,大華投等美債15Y+,54,0,54,新光-高雄,2024-10-23,8562
2329,華泰,206,152,54,新光-高雄,2024-10-23,8562
00907,永豐優息存股,53,0,53,新光-高雄,2024-10-23,8562
00938,凱基優選30,55,2,53,新光-高雄,2024-10-23,8562
00673R,期元大S＆P原油反1,56,7,49,新光-高雄,2024-10-23,8562
5519,隆大,52,4,48,新光-高雄,2024-10-23,8562
6151,晉倫,199,153,46,新光-高雄,2024-10-23,8562
2867,三商壽,50,7,43,新光-高雄,2024-10-23,8562
2303,聯電,44,1,43,新光-高雄,2024-10-23,8562
1101,台泥,49,9,40,新光-高雄,2024-10-23,8562
3532,台勝科,39,0,39,新光-高雄,2024-10-23,8562
2412,中華電,39,0,39,新光-高雄,2024-10-23,8562
2515,中工,49,12,37,新光-高雄,2024-10-23,8562
00949,復華日本龍頭,36,0,36,新光-高雄,2024-10-23,8562
00720B,元大投資級公司債,35,0,35,新光-高雄,2024-10-23,8562
00795B,中信美國公債20年,35,0,35,新光-高雄,2024-10-23,8562
2890,永豐金,34,0,34,新光-高雄,2024-10-23,8562
5469,瀚宇博,34,2,32,新光-高雄,2024-10-23,8562
00687B,國泰20年美債,194,163,31,新光-高雄,2024-10-23,8562
00635U,期元大S＆P黃金,41,10,31,新光-高雄,2024-10-23,8562
00933B,國泰10Y+金融債,49,22,27,新光-高雄,2024-10-23,8562
9949,琉園,27,0,27,新光-高雄,2024-10-23,8562
2812,台中銀,26,0,26,新光-高雄,2024-10-23,8562
00652,富邦印度,30,4,26,新光-高雄,2024-10-23,8562
2405,輔信,26,0,26,新光-高雄,2024-10-23,8562
912000,晨訊科-DR,26,0,26,新光-高雄,2024-10-23,8562
2369,菱生,71,46,25,新光-高雄,2024-10-23,8562
2399,映泰,170,146,24,新光-高雄,2024-10-23,8562
006208,富邦台50,26,2,24,新光-高雄,2024-10-23,8562
1815,富喬,41,17,24,新光-高雄,2024-10-23,8562
00954,中信日本半導體,24,0,24,新光-高雄,2024-10-23,8562
00887,永豐中國科技50大,27,5,22,新光-高雄,2024-10-23,8562
4306,炎洲,22,0,22,新光-高雄,2024-10-23,8562
00632R,元大台灣50反1,672,66,606,新光-高雄,2024-10-24,8562
00680L,元大美債20正2,345,9,336,新光-高雄,2024-10-24,8562
4109,加捷生醫,235,1,234,新光-高雄,2024-10-24,8562
00953B,群益優選非投等債,200,0,200,新光-高雄,2024-10-24,8562
00937B,群益ESG投等債20,232,51,181,新光-高雄,2024-10-24,8562
00929,復華台灣科技優息,261,85,176,新光-高雄,2024-10-24,8562
00688L,國泰20年美債正2,155,1,154,新光-高雄,2024-10-24,8562
0056,元大高股息,170,32,138,新光-高雄,2024-10-24,8562
00948B,中信優息投資級債,134,2,132,新光-高雄,2024-10-24,8562
00665L,富邦�琤肭磪囓�2,156,25,131,新光-高雄,2024-10-24,8562
00725B,國泰投資級公司債,103,0,103,新光-高雄,2024-10-24,8562
2354,鴻準,323,220,103,新光-高雄,2024-10-24,8562
2489,瑞軒,190,89,101,新光-高雄,2024-10-24,8562
00942B,台新美A公司債20+,100,0,100,新光-高雄,2024-10-24,8562
2515,中工,119,23,96,新光-高雄,2024-10-24,8562
00919,群益台灣精選高息,133,42,91,新光-高雄,2024-10-24,8562
00959B,大華投等美債15Y+,90,0,90,新光-高雄,2024-10-24,8562
00637L,元大滬深300正2,213,125,88,新光-高雄,2024-10-24,8562
3481,群創,243,156,87,新光-高雄,2024-10-24,8562
3520,華盈,80,6,74,新光-高雄,2024-10-24,8562
00733,富邦臺灣中小,70,0,70,新光-高雄,2024-10-24,8562
2431,聯昌,82,12,70,新光-高雄,2024-10-24,8562
1528,恩德,316,248,68,新光-高雄,2024-10-24,8562
2887,台新金,71,3,68,新光-高雄,2024-10-24,8562
00715L,期街口布蘭特正2,70,5,65,新光-高雄,2024-10-24,8562
8929,富堡,62,0,62,新光-高雄,2024-10-24,8562
2409,友達,58,0,58,新光-高雄,2024-10-24,8562
00753L,中信中國50正2,260,206,54,新光-高雄,2024-10-24,8562
2881,富邦金,55,3,52,新光-高雄,2024-10-24,8562
00650L,復華香港正2,45,0,45,新光-高雄,2024-10-24,8562
00905,FT臺灣Smart,49,5,44,新光-高雄,2024-10-24,8562
3689,湧德,93,51,42,新光-高雄,2024-10-24,8562
1314,中石化,41,1,40,新光-高雄,2024-10-24,8562
00679B,元大美債20年,90,50,40,新光-高雄,2024-10-24,8562
2884,玉山金,40,0,40,新光-高雄,2024-10-24,8562
00938,凱基優選30,37,0,37,新光-高雄,2024-10-24,8562
4714,永捷,39,2,37,新光-高雄,2024-10-24,8562
00706L,期元大S＆P日圓正2,39,4,35,新光-高雄,2024-10-24,8562
2851,中再保,35,0,35,新光-高雄,2024-10-24,8562
1524,耿鼎,90,56,34,新光-高雄,2024-10-24,8562
6170,統振,37,3,34,新光-高雄,2024-10-24,8562
00907,永豐優息存股,34,0,34,新光-高雄,2024-10-24,8562
00662,富邦NASDAQ,32,0,32,新光-高雄,2024-10-24,8562
6202,盛群,38,7,31,新光-高雄,2024-10-24,8562
3290,東浦,63,33,30,新光-高雄,2024-10-24,8562
2481,強茂,40,11,29,新光-高雄,2024-10-24,8562
6104,創惟,40,13,27,新光-高雄,2024-10-24,8562
6770,力積電,27,0,27,新光-高雄,2024-10-24,8562
4909,新復興,41,15,26,新光-高雄,2024-10-24,8562
2852,第一保,25,0,25,新光-高雄,2024-10-24,8562
2646,星宇航空,418,209,209,新光-高雄,2024-10-25,8562
00712,復華富時不動產,216,18,198,新光-高雄,2024-10-25,8562
00679B,元大美債20年,174,37,137,新光-高雄,2024-10-25,8562
00937B,群益ESG投等債20,140,26,114,新光-高雄,2024-10-25,8562
2603,長榮,124,19,105,新光-高雄,2024-10-25,8562
00715L,期街口布蘭特正2,107,7,100,新光-高雄,2024-10-25,8562
00942B,台新美A公司債20+,100,0,100,新光-高雄,2024-10-25,8562
6509,聚和,153,54,99,新光-高雄,2024-10-25,8562
1229,聯華,98,1,97,新光-高雄,2024-10-25,8562
00915,凱基優選高股息30,92,4,88,新光-高雄,2024-10-25,8562
00887,永豐中國科技50大,217,135,82,新光-高雄,2024-10-25,8562
2312,金寶,470,398,72,新光-高雄,2024-10-25,8562
6218,豪勉,68,4,64,新光-高雄,2024-10-25,8562
2888,新光金,62,4,58,新光-高雄,2024-10-25,8562
00919,群益台灣精選高息,79,31,48,新光-高雄,2024-10-25,8562
00637L,元大滬深300正2,292,248,44,新光-高雄,2024-10-25,8562
00633L,富邦上証正2,44,6,38,新光-高雄,2024-10-25,8562
3402,漢科,50,12,38,新光-高雄,2024-10-25,8562
4743,合一,40,3,37,新光-高雄,2024-10-25,8562
00948B,中信優息投資級債,34,0,34,新光-高雄,2024-10-25,8562
2867,三商壽,33,0,33,新光-高雄,2024-10-25,8562
00938,凱基優選30,32,0,32,新光-高雄,2024-10-25,8562
2303,聯電,33,3,30,新光-高雄,2024-10-25,8562
912000,晨訊科-DR,30,0,30,新光-高雄,2024-10-25,8562
1806,冠軍,40,10,30,新光-高雄,2024-10-25,8562
4716,大立,37,7,30,新光-高雄,2024-10-25,8562
6246,臺龍,62,33,29,新光-高雄,2024-10-25,8562
4414,如興,29,0,29,新光-高雄,2024-10-25,8562
2883,凱基金,31,3,28,新光-高雄,2024-10-25,8562
00950B,凱基A級公司債,30,3,27,新光-高雄,2024-10-25,8562
4562,穎漢,28,1,27,新光-高雄,2024-10-25,8562
4979,華星光,33,7,26,新光-高雄,2024-10-25,8562
00959B,大華投等美債15Y+,25,0,25,新光-高雄,2024-10-25,8562
2453,凌群,24,0,24,新光-高雄,2024-10-25,8562
6134,萬旭,33,11,22,新光-高雄,2024-10-25,8562
2884,玉山金,22,0,22,新光-高雄,2024-10-25,8562
2495,普安,215,193,22,新光-高雄,2024-10-25,8562
5202,力新,88,67,21,新光-高雄,2024-10-25,8562
2409,友達,31,11,20,新光-高雄,2024-10-25,8562
5608,四維航,20,0,20,新光-高雄,2024-10-25,8562
00652,富邦印度,20,0,20,新光-高雄,2024-10-25,8562
4545,銘鈺,69,49,20,新光-高雄,2024-10-25,8562
3029,零壹,31,12,19,新光-高雄,2024-10-25,8562
00693U,期街口S＆P黃豆,19,0,19,新光-高雄,2024-10-25,8562
5864,致和證,19,0,19,新光-高雄,2024-10-25,8562
00725B,國泰投資級公司債,24,6,18,新光-高雄,2024-10-25,8562
2363,矽統,25,7,18,新光-高雄,2024-10-25,8562
1326,台化,18,0,18,新光-高雄,2024-10-25,8562
2399,映泰,120,103,17,新光-高雄,2024-10-25,8562
6182,合晶,18,1,17,新光-高雄,2024-10-25,8562
00753L,中信中國50正2,1198,142,1056,新光-高雄,2024-10-28,8562
00632R,元大台灣50反1,1438,785,653,新光-高雄,2024-10-28,8562
00937B,群益ESG投等債20,249,52,197,新光-高雄,2024-10-28,8562
00679B,元大美債20年,298,115,183,新光-高雄,2024-10-28,8562
00712,復華富時不動產,194,34,160,新光-高雄,2024-10-28,8562
1802,台玻,245,98,147,新光-高雄,2024-10-28,8562
2887,台新金,138,9,129,新光-高雄,2024-10-28,8562
0056,元大高股息,151,26,125,新光-高雄,2024-10-28,8562
00673R,期元大S＆P原油反1,129,5,124,新光-高雄,2024-10-28,8562
00953B,群益優選非投等債,100,0,100,新光-高雄,2024-10-28,8562
2302,麗正,173,76,97,新光-高雄,2024-10-28,8562
00948B,中信優息投資級債,147,60,87,新光-高雄,2024-10-28,8562
00733,富邦臺灣中小,81,0,81,新光-高雄,2024-10-28,8562
00919,群益台灣精選高息,95,15,80,新光-高雄,2024-10-28,8562
8074,鉅橡,97,21,76,新光-高雄,2024-10-28,8562
00706L,期元大S＆P日圓正2,175,100,75,新光-高雄,2024-10-28,8562
00878,國泰永續高股息,140,67,73,新光-高雄,2024-10-28,8562
2303,聯電,62,0,62,新光-高雄,2024-10-28,8562
00938,凱基優選30,54,0,54,新光-高雄,2024-10-28,8562
0061,元大寶滬深,53,0,53,新光-高雄,2024-10-28,8562
00959B,大華投等美債15Y+,86,33,53,新光-高雄,2024-10-28,8562
00637L,元大滬深300正2,259,206,53,新光-高雄,2024-10-28,8562
2409,友達,52,4,48,新光-高雄,2024-10-28,8562
00882,中信中國高股息,49,4,45,新光-高雄,2024-10-28,8562
6770,力積電,58,20,38,新光-高雄,2024-10-28,8562
2515,中工,45,8,37,新光-高雄,2024-10-28,8562
2891,中信金,38,2,36,新光-高雄,2024-10-28,8562
3689,湧德,36,0,36,新光-高雄,2024-10-28,8562
3715,定穎投控,73,38,35,新光-高雄,2024-10-28,8562
5398,慕康生醫,85,50,35,新光-高雄,2024-10-28,8562
3402,漢科,38,4,34,新光-高雄,2024-10-28,8562
3372,典範,38,6,32,新光-高雄,2024-10-28,8562
6269,台郡,33,1,32,新光-高雄,2024-10-28,8562
3149,正達,44,13,31,新光-高雄,2024-10-28,8562
5488,松普,52,22,30,新光-高雄,2024-10-28,8562
00647L,元大S＆P500正2,30,0,30,新光-高雄,2024-10-28,8562
3231,緯創,69,39,30,新光-高雄,2024-10-28,8562
00642U,期元大S＆P石油,29,0,29,新光-高雄,2024-10-28,8562
00887,永豐中國科技50大,46,17,29,新光-高雄,2024-10-28,8562
2337,旺宏,26,0,26,新光-高雄,2024-10-28,8562
4414,如興,26,0,26,新光-高雄,2024-10-28,8562
2369,菱生,86,61,25,新光-高雄,2024-10-28,8562
6235,華孚,102,80,22,新光-高雄,2024-10-28,8562
00665L,富邦�琤肭磪囓�2,41,20,21,新光-高雄,2024-10-28,8562
1314,中石化,65,44,21,新光-高雄,2024-10-28,8562
2634,漢翔,21,0,21,新光-高雄,2024-10-28,8562
6134,萬旭,24,3,21,新光-高雄,2024-10-28,8562
00931B,統一美債20年,61,40,21,新光-高雄,2024-10-28,8562
9921,巨大,51,31,20,新光-高雄,2024-10-28,8562
2330,台積電,61,41,20,新光-高雄,2024-10-28,8562
00929,復華台灣科技優息,547,66,481,新光-高雄,2024-10-29,8562
00919,群益台灣精選高息,429,18,411,新光-高雄,2024-10-29,8562
00715L,期街口布蘭特正2,335,11,324,新光-高雄,2024-10-29,8562
00753L,中信中國50正2,440,126,314,新光-高雄,2024-10-29,8562
00680L,元大美債20正2,325,72,253,新光-高雄,2024-10-29,8562
00915,凱基優選高股息30,233,3,230,新光-高雄,2024-10-29,8562
00940,元大台灣價值高息,206,4,202,新光-高雄,2024-10-29,8562
2880,華南金,190,6,184,新光-高雄,2024-10-29,8562
00878,國泰永續高股息,213,44,169,新光-高雄,2024-10-29,8562
0056,元大高股息,315,148,167,新光-高雄,2024-10-29,8562
00948B,中信優息投資級債,148,2,146,新光-高雄,2024-10-29,8562
00918,大華優利高填息30,154,11,143,新光-高雄,2024-10-29,8562
00675L,富邦臺灣加權正2,143,19,124,新光-高雄,2024-10-29,8562
00937B,群益ESG投等債20,235,135,100,新光-高雄,2024-10-29,8562
00712,復華富時不動產,105,5,100,新光-高雄,2024-10-29,8562
2317,鴻海,152,64,88,新光-高雄,2024-10-29,8562
2409,友達,97,10,87,新光-高雄,2024-10-29,8562
2801,彰銀,87,7,80,新光-高雄,2024-10-29,8562
1314,中石化,101,22,79,新光-高雄,2024-10-29,8562
2303,聯電,132,56,76,新光-高雄,2024-10-29,8562
3450,聯鈞,169,102,67,新光-高雄,2024-10-29,8562
8429,金麗-KY,68,2,66,新光-高雄,2024-10-29,8562
00946,群益科技高息成長,61,0,61,新光-高雄,2024-10-29,8562
006208,富邦台50,71,11,60,新光-高雄,2024-10-29,8562
00922,國泰台灣領袖50,60,2,58,新光-高雄,2024-10-29,8562
2867,三商壽,69,13,56,新光-高雄,2024-10-29,8562
2515,中工,55,0,55,新光-高雄,2024-10-29,8562
00887,永豐中國科技50大,75,24,51,新光-高雄,2024-10-29,8562
2887,台新金,50,1,49,新光-高雄,2024-10-29,8562
00733,富邦臺灣中小,48,0,48,新光-高雄,2024-10-29,8562
2812,台中銀,47,2,45,新光-高雄,2024-10-29,8562
6133,金橋,161,118,43,新光-高雄,2024-10-29,8562
00676R,富邦臺灣加權反1,45,2,43,新光-高雄,2024-10-29,8562
2312,金寶,96,54,42,新光-高雄,2024-10-29,8562
2883,凱基金,44,2,42,新光-高雄,2024-10-29,8562
5488,松普,85,46,39,新光-高雄,2024-10-29,8562
00959B,大華投等美債15Y+,38,0,38,新光-高雄,2024-10-29,8562
00706L,期元大S＆P日圓正2,37,0,37,新光-高雄,2024-10-29,8562
3189,景碩,61,25,36,新光-高雄,2024-10-29,8562
2354,鴻準,86,51,35,新光-高雄,2024-10-29,8562
00679B,元大美債20年,58,23,35,新光-高雄,2024-10-29,8562
2892,第一金,36,2,34,新光-高雄,2024-10-29,8562
00631L,元大台灣50正2,94,60,34,新光-高雄,2024-10-29,8562
2888,新光金,44,14,30,新光-高雄,2024-10-29,8562
2884,玉山金,37,7,30,新光-高雄,2024-10-29,8562
8107,大億金茂,195,166,29,新光-高雄,2024-10-29,8562
00927,群益半導體收益,30,2,28,新光-高雄,2024-10-29,8562
6505,台塑化,28,0,28,新光-高雄,2024-10-29,8562
912000,晨訊科-DR,28,0,28,新光-高雄,2024-10-29,8562
00642U,期元大S＆P石油,28,0,28,新光-高雄,2024-10-29,8562
00680L,元大美債20正2,483,174,309,新光-高雄,2024-10-30,8562
00953B,群益優選非投等債,300,0,300,新光-高雄,2024-10-30,8562
00637L,元大滬深300正2,335,93,242,新光-高雄,2024-10-30,8562
00715L,期街口布蘭特正2,214,5,209,新光-高雄,2024-10-30,8562
00919,群益台灣精選高息,171,6,165,新光-高雄,2024-10-30,8562
00878,國泰永續高股息,153,11,142,新光-高雄,2024-10-30,8562
3481,群創,206,79,127,新光-高雄,2024-10-30,8562
2887,台新金,121,16,105,新光-高雄,2024-10-30,8562
00929,復華台灣科技優息,186,84,102,新光-高雄,2024-10-30,8562
00632R,元大台灣50反1,178,89,89,新光-高雄,2024-10-30,8562
0056,元大高股息,116,31,85,新光-高雄,2024-10-30,8562
2477,美隆電,220,143,77,新光-高雄,2024-10-30,8562
00712,復華富時不動產,61,5,56,新光-高雄,2024-10-30,8562
00946,群益科技高息成長,55,0,55,新光-高雄,2024-10-30,8562
00706L,期元大S＆P日圓正2,53,0,53,新光-高雄,2024-10-30,8562
5398,慕康生醫,121,68,53,新光-高雄,2024-10-30,8562
1314,中石化,57,6,51,新光-高雄,2024-10-30,8562
2337,旺宏,50,1,49,新光-高雄,2024-10-30,8562
2646,星宇航空,61,12,49,新光-高雄,2024-10-30,8562
00687B,國泰20年美債,60,13,47,新光-高雄,2024-10-30,8562
00915,凱基優選高股息30,47,0,47,新光-高雄,2024-10-30,8562
8044,網家,297,251,46,新光-高雄,2024-10-30,8562
00635U,期元大S＆P黃金,47,2,45,新光-高雄,2024-10-30,8562
1528,恩德,243,199,44,新光-高雄,2024-10-30,8562
4919,新唐,139,95,44,新光-高雄,2024-10-30,8562
00959B,大華投等美債15Y+,43,0,43,新光-高雄,2024-10-30,8562
3356,奇偶,35,0,35,新光-高雄,2024-10-30,8562
2547,日勝生,35,0,35,新光-高雄,2024-10-30,8562
2313,華通,35,3,32,新光-高雄,2024-10-30,8562
00887,永豐中國科技50大,33,2,31,新光-高雄,2024-10-30,8562
6770,力積電,39,8,31,新光-高雄,2024-10-30,8562
00713,元大台灣高息低波,30,0,30,新光-高雄,2024-10-30,8562
2303,聯電,40,10,30,新光-高雄,2024-10-30,8562
2890,永豐金,29,3,26,新光-高雄,2024-10-30,8562
5263,智崴,26,0,26,新光-高雄,2024-10-30,8562
00882,中信中國高股息,26,0,26,新光-高雄,2024-10-30,8562
2897,王道銀行,25,0,25,新光-高雄,2024-10-30,8562
2867,三商壽,26,1,25,新光-高雄,2024-10-30,8562
00932,兆豐永續高息等權,24,0,24,新光-高雄,2024-10-30,8562
5315,光聯,23,1,22,新光-高雄,2024-10-30,8562
2883,凱基金,23,1,22,新光-高雄,2024-10-30,8562
2393,億光,28,7,21,新光-高雄,2024-10-30,8562
00934,中信成長高股息,20,0,20,新光-高雄,2024-10-30,8562
00940,元大台灣價值高息,26,7,19,新光-高雄,2024-10-30,8562
00937B,群益ESG投等債20,68,50,18,新光-高雄,2024-10-30,8562
2388,威盛,49,31,18,新光-高雄,2024-10-30,8562
2323,中環,18,0,18,新光-高雄,2024-10-30,8562
2353,宏��,19,2,17,新光-高雄,2024-10-30,8562
2892,第一金,17,0,17,新光-高雄,2024-10-30,8562
2412,中華電,23,7,16,新光-高雄,2024-10-30,8562
00929,復華台灣科技優息,282,36,246,新光-高雄,2024-11-01,8562
2888,新光金,244,56,188,新光-高雄,2024-11-01,8562
00878,國泰永續高股息,207,20,187,新光-高雄,2024-11-01,8562
00687B,國泰20年美債,212,70,142,新光-高雄,2024-11-01,8562
00919,群益台灣精選高息,197,60,137,新光-高雄,2024-11-01,8562
3231,緯創,203,79,124,新光-高雄,2024-11-01,8562
00915,凱基優選高股息30,144,24,120,新光-高雄,2024-11-01,8562
1528,恩德,270,152,118,新光-高雄,2024-11-01,8562
00830,國泰費城半導體,117,2,115,新光-高雄,2024-11-01,8562
00673R,期元大S＆P原油反1,108,1,107,新光-高雄,2024-11-01,8562
00725B,國泰投資級公司債,103,0,103,新光-高雄,2024-11-01,8562
00940,元大台灣價值高息,220,120,100,新光-高雄,2024-11-01,8562
2303,聯電,119,23,96,新光-高雄,2024-11-01,8562
00959B,大華投等美債15Y+,94,10,84,新光-高雄,2024-11-01,8562
00679B,元大美債20年,127,49,78,新光-高雄,2024-11-01,8562
3052,夆典,71,0,71,新光-高雄,2024-11-01,8562
6285,啟��,68,1,67,新光-高雄,2024-11-01,8562
2354,鴻準,500,436,64,新光-高雄,2024-11-01,8562
0056,元大高股息,108,44,64,新光-高雄,2024-11-01,8562
2887,台新金,62,1,61,新光-高雄,2024-11-01,8562
2317,鴻海,120,60,60,新光-高雄,2024-11-01,8562
006208,富邦台50,63,7,56,新光-高雄,2024-11-01,8562
8429,金麗-KY,50,0,50,新光-高雄,2024-11-01,8562
2543,皇昌,72,23,49,新光-高雄,2024-11-01,8562
00712,復華富時不動產,49,0,49,新光-高雄,2024-11-01,8562
2883,凱基金,53,5,48,新光-高雄,2024-11-01,8562
00905,FT臺灣Smart,53,7,46,新光-高雄,2024-11-01,8562
6216,居易,174,131,43,新光-高雄,2024-11-01,8562
4174,浩鼎,43,2,41,新光-高雄,2024-11-01,8562
00713,元大台灣高息低波,56,18,38,新光-高雄,2024-11-01,8562
8039,台虹,38,2,36,新光-高雄,2024-11-01,8562
00922,國泰台灣領袖50,36,2,34,新光-高雄,2024-11-01,8562
8070,長華*,56,24,32,新光-高雄,2024-11-01,8562
00948B,中信優息投資級債,31,0,31,新光-高雄,2024-11-01,8562
6246,臺龍,52,23,29,新光-高雄,2024-11-01,8562
2884,玉山金,33,5,28,新光-高雄,2024-11-01,8562
00946,群益科技高息成長,28,0,28,新光-高雄,2024-11-01,8562
3447,展達,26,0,26,新光-高雄,2024-11-01,8562
2243,宏旭-KY,26,0,26,新光-高雄,2024-11-01,8562
00639,富邦深100,31,5,26,新光-高雄,2024-11-01,8562
5871,中租-KY,27,2,25,新光-高雄,2024-11-01,8562
00675L,富邦臺灣加權正2,46,22,24,新光-高雄,2024-11-01,8562
00927,群益半導體收益,35,11,24,新光-高雄,2024-11-01,8562
00907,永豐優息存股,24,0,24,新光-高雄,2024-11-01,8562
00662,富邦NASDAQ,23,0,23,新光-高雄,2024-11-01,8562
00949,復華日本龍頭,23,0,23,新光-高雄,2024-11-01,8562
6505,台塑化,22,0,22,新光-高雄,2024-11-01,8562
3013,晟銘電,104,82,22,新光-高雄,2024-11-01,8562
2392,正崴,27,6,21,新光-高雄,2024-11-01,8562
00944,野村趨勢動能高息,20,0,20,新光-高雄,2024-11-01,8562
00878,國泰永續高股息,758,12,746,新光-高雄,2024-11-04,8562
2409,友達,473,13,460,新光-高雄,2024-11-04,8562
00937B,群益ESG投等債20,244,55,189,新光-高雄,2024-11-04,8562
00679B,元大美債20年,168,24,144,新光-高雄,2024-11-04,8562
00688L,國泰20年美債正2,133,0,133,新光-高雄,2024-11-04,8562
2354,鴻準,468,349,119,新光-高雄,2024-11-04,8562
00795B,中信美國公債20年,116,10,106,新光-高雄,2024-11-04,8562
00712,復華富時不動產,144,42,102,新光-高雄,2024-11-04,8562
00725B,國泰投資級公司債,128,28,100,新光-高雄,2024-11-04,8562
00680L,元大美債20正2,136,44,92,新光-高雄,2024-11-04,8562
00948B,中信優息投資級債,153,67,86,新光-高雄,2024-11-04,8562
8028,昇陽半導體,93,11,82,新光-高雄,2024-11-04,8562
00687B,國泰20年美債,475,401,74,新光-高雄,2024-11-04,8562
00930,永豐ESG低碳高息,71,0,71,新光-高雄,2024-11-04,8562
00637L,元大滬深300正2,145,75,70,新光-高雄,2024-11-04,8562
6757,台灣虎航,55,2,53,新光-高雄,2024-11-04,8562
00932,兆豐永續高息等權,64,12,52,新光-高雄,2024-11-04,8562
2337,旺宏,56,7,49,新光-高雄,2024-11-04,8562
2303,聯電,60,12,48,新光-高雄,2024-11-04,8562
0056,元大高股息,57,10,47,新光-高雄,2024-11-04,8562
5340,建榮,45,0,45,新光-高雄,2024-11-04,8562
2388,威盛,54,10,44,新光-高雄,2024-11-04,8562
2887,台新金,47,4,43,新光-高雄,2024-11-04,8562
00713,元大台灣高息低波,47,5,42,新光-高雄,2024-11-04,8562
1319,東陽,50,9,41,新光-高雄,2024-11-04,8562
00731,復華富時高息低波,41,1,40,新光-高雄,2024-11-04,8562
5202,力新,52,13,39,新光-高雄,2024-11-04,8562
00918,大華優利高填息30,37,0,37,新光-高雄,2024-11-04,8562
00915,凱基優選高股息30,37,2,35,新光-高雄,2024-11-04,8562
4174,浩鼎,34,0,34,新光-高雄,2024-11-04,8562
2442,新美齊,37,4,33,新光-高雄,2024-11-04,8562
00946,群益科技高息成長,33,2,31,新光-高雄,2024-11-04,8562
2243,宏旭-KY,31,0,31,新光-高雄,2024-11-04,8562
3535,晶彩科,32,1,31,新光-高雄,2024-11-04,8562
00690,兆豐藍籌30,31,0,31,新光-高雄,2024-11-04,8562
00953B,群益優選非投等債,30,0,30,新光-高雄,2024-11-04,8562
2427,三商電,30,0,30,新光-高雄,2024-11-04,8562
00887,永豐中國科技50大,89,60,29,新光-高雄,2024-11-04,8562
2524,京城,38,12,26,新光-高雄,2024-11-04,8562
3016,嘉晶,25,1,24,新光-高雄,2024-11-04,8562
00927,群益半導體收益,28,5,23,新光-高雄,2024-11-04,8562
00905,FT臺灣Smart,26,4,22,新光-高雄,2024-11-04,8562
6133,金橋,70,48,22,新光-高雄,2024-11-04,8562
6167,久正,22,0,22,新光-高雄,2024-11-04,8562
5009,榮剛,22,0,22,新光-高雄,2024-11-04,8562
00635U,期元大S＆P黃金,22,0,22,新光-高雄,2024-11-04,8562
00662,富邦NASDAQ,21,0,21,新光-高雄,2024-11-04,8562
2609,陽明,97,77,20,新光-高雄,2024-11-04,8562
00902,中信電池及儲能,20,0,20,新光-高雄,2024-11-04,8562
00706L,期元大S＆P日圓正2,20,0,20,新光-高雄,2024-11-04,8562
00688L,國泰20年美債正2,453,50,403,新光-高雄,2024-11-05,8562
00878,國泰永續高股息,258,38,220,新光-高雄,2024-11-05,8562
3049,精金,213,65,148,新光-高雄,2024-11-05,8562
00919,群益台灣精選高息,148,19,129,新光-高雄,2024-11-05,8562
00632R,元大台灣50反1,143,47,96,新光-高雄,2024-11-05,8562
00953B,群益優選非投等債,86,6,80,新光-高雄,2024-11-05,8562
00915,凱基優選高股息30,88,9,79,新光-高雄,2024-11-05,8562
00753L,中信中國50正2,121,48,73,新光-高雄,2024-11-05,8562
2303,聯電,85,12,73,新光-高雄,2024-11-05,8562
3062,建漢,147,79,68,新光-高雄,2024-11-05,8562
2887,台新金,49,1,48,新光-高雄,2024-11-05,8562
4903,聯光通,112,65,47,新光-高雄,2024-11-05,8562
00720B,元大投資級公司債,64,20,44,新光-高雄,2024-11-05,8562
2354,鴻準,444,401,43,新光-高雄,2024-11-05,8562
0056,元大高股息,45,4,41,新光-高雄,2024-11-05,8562
00712,復華富時不動產,53,14,39,新光-高雄,2024-11-05,8562
2867,三商壽,45,6,39,新光-高雄,2024-11-05,8562
00946,群益科技高息成長,42,4,38,新光-高雄,2024-11-05,8562
00932,兆豐永續高息等權,38,0,38,新光-高雄,2024-11-05,8562
5315,光聯,80,51,29,新光-高雄,2024-11-05,8562
00882,中信中國高股息,48,19,29,新光-高雄,2024-11-05,8562
00937B,群益ESG投等債20,103,74,29,新光-高雄,2024-11-05,8562
00713,元大台灣高息低波,28,1,27,新光-高雄,2024-11-05,8562
3711,日月光投控,32,6,26,新光-高雄,2024-11-05,8562
2606,裕民,42,17,25,新光-高雄,2024-11-05,8562
4414,如興,25,0,25,新光-高雄,2024-11-05,8562
2243,宏旭-KY,43,20,23,新光-高雄,2024-11-05,8562
5907,大洋-KY,26,4,22,新光-高雄,2024-11-05,8562
6770,力積電,30,9,21,新光-高雄,2024-11-05,8562
1218,泰山,21,0,21,新光-高雄,2024-11-05,8562
00733,富邦臺灣中小,21,0,21,新光-高雄,2024-11-05,8562
2888,新光金,21,0,21,新光-高雄,2024-11-05,8562
8044,網家,21,3,18,新光-高雄,2024-11-05,8562
3230,錦明,28,13,15,新光-高雄,2024-11-05,8562
3013,晟銘電,63,48,15,新光-高雄,2024-11-05,8562
2834,臺企銀,18,4,14,新光-高雄,2024-11-05,8562
00934,中信成長高股息,15,1,14,新光-高雄,2024-11-05,8562
2351,順德,20,6,14,新光-高雄,2024-11-05,8562
2344,華邦電,114,100,14,新光-高雄,2024-11-05,8562
8047,星雲,23,9,14,新光-高雄,2024-11-05,8562
2641,正德,14,0,14,新光-高雄,2024-11-05,8562
9921,巨大,28,16,12,新光-高雄,2024-11-05,8562
1220,台榮,12,0,12,新光-高雄,2024-11-05,8562
1307,三芳,25,13,12,新光-高雄,2024-11-05,8562
4123,晟德,12,0,12,新光-高雄,2024-11-05,8562
3490,單井,81,69,12,新光-高雄,2024-11-05,8562
8070,長華*,11,0,11,新光-高雄,2024-11-05,8562
1584,精剛,11,0,11,新光-高雄,2024-11-05,8562
00930,永豐ESG低碳高息,20,10,10,新光-高雄,2024-11-05,8562
6290,良維,11,1,10,新光-高雄,2024-11-05,8562
00679B,元大美債20年,655,77,578,新光-高雄,2024-11-06,8562
00687B,國泰20年美債,992,642,350,新光-高雄,2024-11-06,8562
00637L,元大滬深300正2,545,272,273,新光-高雄,2024-11-06,8562
00680L,元大美債20正2,441,255,186,新光-高雄,2024-11-06,8562
00753L,中信中國50正2,377,196,181,新光-高雄,2024-11-06,8562
00915,凱基優選高股息30,166,0,166,新光-高雄,2024-11-06,8562
00688L,國泰20年美債正2,417,252,165,新光-高雄,2024-11-06,8562
6757,台灣虎航,164,9,155,新光-高雄,2024-11-06,8562
00795B,中信美國公債20年,174,21,153,新光-高雄,2024-11-06,8562
2351,順德,126,5,121,新光-高雄,2024-11-06,8562
00937B,群益ESG投等債20,243,126,117,新光-高雄,2024-11-06,8562
00902,中信電池及儲能,100,0,100,新光-高雄,2024-11-06,8562
00720B,元大投資級公司債,84,0,84,新光-高雄,2024-11-06,8562
3005,神基,84,1,83,新光-高雄,2024-11-06,8562
00933B,國泰10Y+金融債,90,10,80,新光-高雄,2024-11-06,8562
2409,友達,56,0,56,新光-高雄,2024-11-06,8562
00633L,富邦上証正2,64,11,53,新光-高雄,2024-11-06,8562
00676R,富邦臺灣加權反1,50,0,50,新光-高雄,2024-11-06,8562
00942B,台新美A公司債20+,50,1,49,新光-高雄,2024-11-06,8562
00895,富邦未來車,61,14,47,新光-高雄,2024-11-06,8562
2243,宏旭-KY,109,63,46,新光-高雄,2024-11-06,8562
00878,國泰永續高股息,102,58,44,新光-高雄,2024-11-06,8562
00712,復華富時不動產,47,4,43,新光-高雄,2024-11-06,8562
3149,正達,75,33,42,新光-高雄,2024-11-06,8562
00665L,富邦�琤肭磪囓�2,73,33,40,新光-高雄,2024-11-06,8562
1718,中纖,39,0,39,新光-高雄,2024-11-06,8562
00713,元大台灣高息低波,30,0,30,新光-高雄,2024-11-06,8562
2356,英業達,234,204,30,新光-高雄,2024-11-06,8562
2303,聯電,49,19,30,新光-高雄,2024-11-06,8562
2887,台新金,32,5,27,新光-高雄,2024-11-06,8562
8249,菱光,152,125,27,新光-高雄,2024-11-06,8562
2884,玉山金,29,2,27,新光-高雄,2024-11-06,8562
6134,萬旭,26,1,25,新光-高雄,2024-11-06,8562
00919,群益台灣精選高息,55,30,25,新光-高雄,2024-11-06,8562
2615,萬海,82,57,25,新光-高雄,2024-11-06,8562
2883,凱基金,33,9,24,新光-高雄,2024-11-06,8562
3167,大量,26,3,23,新光-高雄,2024-11-06,8562
1307,三芳,63,41,22,新光-高雄,2024-11-06,8562
2892,第一金,18,0,18,新光-高雄,2024-11-06,8562
00725B,國泰投資級公司債,25,7,18,新光-高雄,2024-11-06,8562
1319,東陽,23,5,18,新光-高雄,2024-11-06,8562
8064,東捷,38,20,18,新光-高雄,2024-11-06,8562
1449,佳和,138,121,17,新光-高雄,2024-11-06,8562
1708,東鹼,17,0,17,新光-高雄,2024-11-06,8562
00887,永豐中國科技50大,87,70,17,新光-高雄,2024-11-06,8562
2367,燿華,27,11,16,新光-高雄,2024-11-06,8562
00931B,統一美債20年,16,0,16,新光-高雄,2024-11-06,8562
6488,環球晶,17,1,16,新光-高雄,2024-11-06,8562
6613,朋億*,20,5,15,新光-高雄,2024-11-06,8562
1513,中興電,17,3,14,新光-高雄,2024-11-06,8562
00680L,元大美債20正2,370,0,370,新光-高雄,2024-11-07,8562
00688L,國泰20年美債正2,270,17,253,新光-高雄,2024-11-07,8562
00687B,國泰20年美債,272,29,243,新光-高雄,2024-11-07,8562
00933B,國泰10Y+金融債,207,12,195,新光-高雄,2024-11-07,8562
5398,慕康生醫,173,56,117,新光-高雄,2024-11-07,8562
1464,得力,114,14,100,新光-高雄,2024-11-07,8562
1524,耿鼎,94,0,94,新光-高雄,2024-11-07,8562
2867,三商壽,90,8,82,新光-高雄,2024-11-07,8562
2303,聯電,180,109,71,新光-高雄,2024-11-07,8562
2324,仁寶,147,80,67,新光-高雄,2024-11-07,8562
00919,群益台灣精選高息,78,18,60,新光-高雄,2024-11-07,8562
2453,凌群,54,0,54,新光-高雄,2024-11-07,8562
00673R,期元大S＆P原油反1,74,22,52,新光-高雄,2024-11-07,8562
00633L,富邦上証正2,56,5,51,新光-高雄,2024-11-07,8562
00950B,凱基A級公司債,50,0,50,新光-高雄,2024-11-07,8562
00679B,元大美債20年,69,20,49,新光-高雄,2024-11-07,8562
3494,誠研,48,0,48,新光-高雄,2024-11-07,8562
2027,大成鋼,82,34,48,新光-高雄,2024-11-07,8562
00712,復華富時不動產,46,0,46,新光-高雄,2024-11-07,8562
2892,第一金,46,0,46,新光-高雄,2024-11-07,8562
3230,錦明,82,39,43,新光-高雄,2024-11-07,8562
00650L,復華香港正2,50,7,43,新光-高雄,2024-11-07,8562
8070,長華*,49,8,41,新光-高雄,2024-11-07,8562
3450,聯鈞,103,63,40,新光-高雄,2024-11-07,8562
00948B,中信優息投資級債,55,16,39,新光-高雄,2024-11-07,8562
00676R,富邦臺灣加權反1,37,0,37,新光-高雄,2024-11-07,8562
8110,華東,35,0,35,新光-高雄,2024-11-07,8562
00646,元大S＆P500,36,1,35,新光-高雄,2024-11-07,8562
00713,元大台灣高息低波,33,0,33,新光-高雄,2024-11-07,8562
3563,牧德,33,0,33,新光-高雄,2024-11-07,8562
9105,泰金寶-DR,590,559,31,新光-高雄,2024-11-07,8562
2457,飛宏,52,24,28,新光-高雄,2024-11-07,8562
8404,百和興業-KY,28,0,28,新光-高雄,2024-11-07,8562
00693U,期街口S＆P黃豆,30,2,28,新光-高雄,2024-11-07,8562
5438,東友,35,9,26,新光-高雄,2024-11-07,8562
6451,訊芯-KY,49,24,25,新光-高雄,2024-11-07,8562
2543,皇昌,26,2,24,新光-高雄,2024-11-07,8562
2890,永豐金,25,2,23,新光-高雄,2024-11-07,8562
00720B,元大投資級公司債,23,0,23,新光-高雄,2024-11-07,8562
00878,國泰永續高股息,88,65,23,新光-高雄,2024-11-07,8562
00940,元大台灣價值高息,26,4,22,新光-高雄,2024-11-07,8562
1101,台泥,22,0,22,新光-高雄,2024-11-07,8562
2603,長榮,56,35,21,新光-高雄,2024-11-07,8562
2851,中再保,21,0,21,新光-高雄,2024-11-07,8562
6282,康舒,32,11,21,新光-高雄,2024-11-07,8562
3455,由田,31,10,21,新光-高雄,2024-11-07,8562
6573,虹揚-KY,20,0,20,新光-高雄,2024-11-07,8562
00927,群益半導體收益,21,1,20,新光-高雄,2024-11-07,8562
3045,台灣大,19,0,19,新光-高雄,2024-11-07,8562
8054,安國,19,0,19,新光-高雄,2024-11-07,8562
3062,建漢,942,213,729,新光-高雄,2024-11-08,8562
2312,金寶,282,15,267,新光-高雄,2024-11-08,8562
2354,鴻準,643,415,228,新光-高雄,2024-11-08,8562
00688L,國泰20年美債正2,610,388,222,新光-高雄,2024-11-08,8562
00937B,群益ESG投等債20,392,258,134,新光-高雄,2024-11-08,8562
00929,復華台灣科技優息,201,67,134,新光-高雄,2024-11-08,8562
00918,大華優利高填息30,106,17,89,新光-高雄,2024-11-08,8562
00753L,中信中國50正2,641,560,81,新光-高雄,2024-11-08,8562
2388,威盛,98,22,76,新光-高雄,2024-11-08,8562
00795B,中信美國公債20年,79,5,74,新光-高雄,2024-11-08,8562
00932,兆豐永續高息等權,71,0,71,新光-高雄,2024-11-08,8562
3037,欣興,93,22,71,新光-高雄,2024-11-08,8562
2353,宏��,95,27,68,新光-高雄,2024-11-08,8562
00671R,富邦NASDAQ反1,81,15,66,新光-高雄,2024-11-08,8562
6505,台塑化,66,0,66,新光-高雄,2024-11-08,8562
6248,沛波,71,10,61,新光-高雄,2024-11-08,8562
9907,統一實,60,0,60,新光-高雄,2024-11-08,8562
3056,富華新,70,15,55,新光-高雄,2024-11-08,8562
2303,聯電,91,37,54,新光-高雄,2024-11-08,8562
2887,台新金,59,6,53,新光-高雄,2024-11-08,8562
00673R,期元大S＆P原油反1,73,22,51,新光-高雄,2024-11-08,8562
00664R,國泰臺灣加權反1,50,0,50,新光-高雄,2024-11-08,8562
00632R,元大台灣50反1,125,76,49,新光-高雄,2024-11-08,8562
00953B,群益優選非投等債,43,0,43,新光-高雄,2024-11-08,8562
00733,富邦臺灣中小,44,2,42,新光-高雄,2024-11-08,8562
2409,友達,45,6,39,新光-高雄,2024-11-08,8562
00650L,復華香港正2,100,62,38,新光-高雄,2024-11-08,8562
00919,群益台灣精選高息,67,31,36,新光-高雄,2024-11-08,8562
6290,良維,34,1,33,新光-高雄,2024-11-08,8562
6005,群益證,49,17,32,新光-高雄,2024-11-08,8562
912000,晨訊科-DR,32,0,32,新光-高雄,2024-11-08,8562
4510,高鋒,42,10,32,新光-高雄,2024-11-08,8562
1314,中石化,45,14,31,新光-高雄,2024-11-08,8562
2314,台揚,50,19,31,新光-高雄,2024-11-08,8562
2313,華通,36,6,30,新光-高雄,2024-11-08,8562
2506,太設,30,0,30,新光-高雄,2024-11-08,8562
3290,東浦,106,76,30,新光-高雄,2024-11-08,8562
8249,菱光,69,40,29,新光-高雄,2024-11-08,8562
00945B,凱基美國非投等債,30,1,29,新光-高雄,2024-11-08,8562
2368,金像電,33,4,29,新光-高雄,2024-11-08,8562
3149,正達,42,14,28,新光-高雄,2024-11-08,8562
00720B,元大投資級公司債,30,2,28,新光-高雄,2024-11-08,8562
1708,東鹼,33,5,28,新光-高雄,2024-11-08,8562
3498,陽程,134,107,27,新光-高雄,2024-11-08,8562
8176,智捷,27,0,27,新光-高雄,2024-11-08,8562
00915,凱基優選高股息30,28,1,27,新光-高雄,2024-11-08,8562
8155,博智,33,7,26,新光-高雄,2024-11-08,8562
00637L,元大滬深300正2,458,432,26,新光-高雄,2024-11-08,8562
00878,國泰永續高股息,71,46,25,新光-高雄,2024-11-08,8562
3324,雙鴻,44,20,24,新光-高雄,2024-11-08,8562
00679B,元大美債20年,461,41,420,新光-高雄,2024-11-11,8562
00715L,期街口布蘭特正2,220,0,220,新光-高雄,2024-11-11,8562
2409,友達,195,3,192,新光-高雄,2024-11-11,8562
00915,凱基優選高股息30,179,0,179,新光-高雄,2024-11-11,8562
00878,國泰永續高股息,215,39,176,新光-高雄,2024-11-11,8562
00637L,元大滬深300正2,379,216,163,新光-高雄,2024-11-11,8562
00919,群益台灣精選高息,195,37,158,新光-高雄,2024-11-11,8562
2506,太設,159,10,149,新光-高雄,2024-11-11,8562
2609,陽明,157,30,127,新光-高雄,2024-11-11,8562
2354,鴻準,331,219,112,新光-高雄,2024-11-11,8562
2887,台新金,105,4,101,新光-高雄,2024-11-11,8562
3062,建漢,151,51,100,新光-高雄,2024-11-11,8562
00857B,永豐20年美公債,86,2,84,新光-高雄,2024-11-11,8562
2834,臺企銀,90,15,75,新光-高雄,2024-11-11,8562
00713,元大台灣高息低波,87,28,59,新光-高雄,2024-11-11,8562
00942B,台新美A公司債20+,52,0,52,新光-高雄,2024-11-11,8562
00932,兆豐永續高息等權,57,6,51,新光-高雄,2024-11-11,8562
00753L,中信中國50正2,296,245,51,新光-高雄,2024-11-11,8562
2838,聯邦銀,45,2,43,新光-高雄,2024-11-11,8562
2615,萬海,106,66,40,新光-高雄,2024-11-11,8562
8936,國統,49,9,40,新光-高雄,2024-11-11,8562
00918,大華優利高填息30,51,14,37,新光-高雄,2024-11-11,8562
2353,宏��,43,6,37,新光-高雄,2024-11-11,8562
1301,台塑,41,4,37,新光-高雄,2024-11-11,8562
2486,一詮,71,35,36,新光-高雄,2024-11-11,8562
6182,合晶,36,1,35,新光-高雄,2024-11-11,8562
1605,華新,76,41,35,新光-高雄,2024-11-11,8562
9921,巨大,74,41,33,新光-高雄,2024-11-11,8562
00674R,期元大S＆P黃金反1,32,0,32,新光-高雄,2024-11-11,8562
00887,永豐中國科技50大,93,61,32,新光-高雄,2024-11-11,8562
2303,聯電,41,10,31,新光-高雄,2024-11-11,8562
2892,第一金,35,4,31,新光-高雄,2024-11-11,8562
00882,中信中國高股息,40,10,30,新光-高雄,2024-11-11,8562
3189,景碩,36,7,29,新光-高雄,2024-11-11,8562
1584,精剛,31,3,28,新光-高雄,2024-11-11,8562
6290,良維,38,10,28,新光-高雄,2024-11-11,8562
3689,湧德,32,6,26,新光-高雄,2024-11-11,8562
2801,彰銀,25,0,25,新光-高雄,2024-11-11,8562
2646,星宇航空,23,1,22,新光-高雄,2024-11-11,8562
1569,濱川,24,3,21,新光-高雄,2024-11-11,8562
00945B,凱基美國非投等債,22,2,20,新光-高雄,2024-11-11,8562
00680L,元大美債20正2,25,5,20,新光-高雄,2024-11-11,8562
00953B,群益優選非投等債,20,0,20,新光-高雄,2024-11-11,8562
6127,九豪,20,0,20,新光-高雄,2024-11-11,8562
3701,大眾控,20,1,19,新光-高雄,2024-11-11,8562
00642U,期元大S＆P石油,19,0,19,新光-高雄,2024-11-11,8562
3481,群創,23,6,17,新光-高雄,2024-11-11,8562
2882,國泰金,18,1,17,新光-高雄,2024-11-11,8562
2349,錸德,17,0,17,新光-高雄,2024-11-11,8562
2337,旺宏,22,6,16,新光-高雄,2024-11-11,8562
00878,國泰永續高股息,453,71,382,新光-高雄,2024-11-12,8562
00715L,期街口布蘭特正2,475,120,355,新光-高雄,2024-11-12,8562
0056,元大高股息,349,54,295,新光-高雄,2024-11-12,8562
2002,中鋼,168,4,164,新光-高雄,2024-11-12,8562
00919,群益台灣精選高息,202,46,156,新光-高雄,2024-11-12,8562
2444,兆勁,143,3,140,新光-高雄,2024-11-12,8562
00665L,富邦�琤肭磪囓�2,1180,1048,132,新光-高雄,2024-11-12,8562
00932,兆豐永續高息等權,131,0,131,新光-高雄,2024-11-12,8562
00706L,期元大S＆P日圓正2,119,0,119,新光-高雄,2024-11-12,8562
00915,凱基優選高股息30,158,48,110,新光-高雄,2024-11-12,8562
2317,鴻海,164,61,103,新光-高雄,2024-11-12,8562
2609,陽明,192,93,99,新光-高雄,2024-11-12,8562
00753L,中信中國50正2,238,141,97,新光-高雄,2024-11-12,8562
5871,中租-KY,127,30,97,新光-高雄,2024-11-12,8562
3481,群創,95,4,91,新光-高雄,2024-11-12,8562
00675L,富邦臺灣加權正2,89,10,79,新光-高雄,2024-11-12,8562
3013,晟銘電,153,77,76,新光-高雄,2024-11-12,8562
2356,英業達,168,94,74,新光-高雄,2024-11-12,8562
9921,巨大,91,17,74,新光-高雄,2024-11-12,8562
1314,中石化,81,7,74,新光-高雄,2024-11-12,8562
2409,友達,70,3,67,新光-高雄,2024-11-12,8562
2882,國泰金,61,0,61,新光-高雄,2024-11-12,8562
2883,凱基金,62,2,60,新光-高雄,2024-11-12,8562
00930,永豐ESG低碳高息,59,0,59,新光-高雄,2024-11-12,8562
00631L,元大台灣50正2,89,31,58,新光-高雄,2024-11-12,8562
2382,廣達,60,7,53,新光-高雄,2024-11-12,8562
2892,第一金,54,5,49,新光-高雄,2024-11-12,8562
2330,台積電,121,74,47,新光-高雄,2024-11-12,8562
2834,臺企銀,51,6,45,新光-高雄,2024-11-12,8562
2888,新光金,67,23,44,新光-高雄,2024-11-12,8562
2472,立隆電,44,0,44,新光-高雄,2024-11-12,8562
006208,富邦台50,54,12,42,新光-高雄,2024-11-12,8562
00642U,期元大S＆P石油,41,0,41,新光-高雄,2024-11-12,8562
1531,高林股,41,0,41,新光-高雄,2024-11-12,8562
4128,中天,40,1,39,新光-高雄,2024-11-12,8562
0050,元大台灣50,49,12,37,新光-高雄,2024-11-12,8562
3231,緯創,77,40,37,新光-高雄,2024-11-12,8562
00922,國泰台灣領袖50,44,11,33,新光-高雄,2024-11-12,8562
6288,聯嘉,71,39,32,新光-高雄,2024-11-12,8562
2353,宏��,39,7,32,新光-高雄,2024-11-12,8562
1609,大亞,33,2,31,新光-高雄,2024-11-12,8562
3049,精金,34,5,29,新光-高雄,2024-11-12,8562
1301,台塑,30,1,29,新光-高雄,2024-11-12,8562
00857B,永豐20年美公債,39,10,29,新光-高雄,2024-11-12,8562
2419,仲琦,30,1,29,新光-高雄,2024-11-12,8562
00887,永豐中國科技50大,151,122,29,新光-高雄,2024-11-12,8562
2887,台新金,41,12,29,新光-高雄,2024-11-12,8562
00669R,國泰美國道瓊反1,30,2,28,新光-高雄,2024-11-12,8562
00902,中信電池及儲能,30,3,27,新光-高雄,2024-11-12,8562
3016,嘉晶,26,0,26,新光-高雄,2024-11-12,8562
00878,國泰永續高股息,351,10,341,新光-高雄,2024-11-13,8562
00680L,元大美債20正2,498,169,329,新光-高雄,2024-11-13,8562
3015,全漢,222,4,218,新光-高雄,2024-11-13,8562
2883,凱基金,143,16,127,新光-高雄,2024-11-13,8562
00687B,國泰20年美債,166,52,114,新光-高雄,2024-11-13,8562
00930,永豐ESG低碳高息,105,0,105,新光-高雄,2024-11-13,8562
00933B,國泰10Y+金融債,113,11,102,新光-高雄,2024-11-13,8562
00915,凱基優選高股息30,98,2,96,新光-高雄,2024-11-13,8562
00706L,期元大S＆P日圓正2,93,0,93,新光-高雄,2024-11-13,8562
0056,元大高股息,128,43,85,新光-高雄,2024-11-13,8562
2891,中信金,83,8,75,新光-高雄,2024-11-13,8562
2801,彰銀,81,10,71,新光-高雄,2024-11-13,8562
00852L,國泰美國道瓊正2,69,0,69,新光-高雄,2024-11-13,8562
2409,友達,64,0,64,新光-高雄,2024-11-13,8562
00679B,元大美債20年,73,9,64,新光-高雄,2024-11-13,8562
2609,陽明,106,47,59,新光-高雄,2024-11-13,8562
00675L,富邦臺灣加權正2,68,14,54,新光-高雄,2024-11-13,8562
1799,易威,57,4,53,新光-高雄,2024-11-13,8562
00931B,統一美債20年,62,11,51,新光-高雄,2024-11-13,8562
00945B,凱基美國非投等債,50,3,47,新光-高雄,2024-11-13,8562
00882,中信中國高股息,44,0,44,新光-高雄,2024-11-13,8562
006208,富邦台50,42,1,41,新光-高雄,2024-11-13,8562
00795B,中信美國公債20年,80,44,36,新光-高雄,2024-11-13,8562
2449,京元電子,51,16,35,新光-高雄,2024-11-13,8562
1595,川寶,59,25,34,新光-高雄,2024-11-13,8562
3209,全科,36,2,34,新光-高雄,2024-11-13,8562
00844B,新光15年IG金融債,33,0,33,新光-高雄,2024-11-13,8562
2317,鴻海,67,35,32,新光-高雄,2024-11-13,8562
2442,新美齊,36,4,32,新光-高雄,2024-11-13,8562
0050,元大台灣50,36,4,32,新光-高雄,2024-11-13,8562
00712,復華富時不動產,51,20,31,新光-高雄,2024-11-13,8562
00713,元大台灣高息低波,40,10,30,新光-高雄,2024-11-13,8562
00902,中信電池及儲能,30,0,30,新光-高雄,2024-11-13,8562
0061,元大寶滬深,30,0,30,新光-高雄,2024-11-13,8562
00953B,群益優選非投等債,30,0,30,新光-高雄,2024-11-13,8562
8027,鈦昇,36,9,27,新光-高雄,2024-11-13,8562
2412,中華電,29,4,25,新光-高雄,2024-11-13,8562
3481,群創,35,10,25,新光-高雄,2024-11-13,8562
8069,元太,25,1,24,新光-高雄,2024-11-13,8562
2344,華邦電,52,28,24,新光-高雄,2024-11-13,8562
00720B,元大投資級公司債,22,0,22,新光-高雄,2024-11-13,8562
1326,台化,26,5,21,新光-高雄,2024-11-13,8562
00887,永豐中國科技50大,259,238,21,新光-高雄,2024-11-13,8562
2812,台中銀,21,0,21,新光-高雄,2024-11-13,8562
00751B,元大AAA至A公司債,24,4,20,新光-高雄,2024-11-13,8562
5880,合庫金,28,8,20,新光-高雄,2024-11-13,8562
1609,大亞,39,19,20,新光-高雄,2024-11-13,8562
00907,永豐優息存股,20,0,20,新光-高雄,2024-11-13,8562
00646,元大S＆P500,19,0,19,新光-高雄,2024-11-13,8562
2882,國泰金,43,25,18,新光-高雄,2024-11-13,8562
00878,國泰永續高股息,1104,30,1074,新光-高雄,2024-11-14,8562
00929,復華台灣科技優息,479,163,316,新光-高雄,2024-11-14,8562
00930,永豐ESG低碳高息,299,3,296,新光-高雄,2024-11-14,8562
00937B,群益ESG投等債20,343,153,190,新光-高雄,2024-11-14,8562
2324,仁寶,228,39,189,新光-高雄,2024-11-14,8562
3049,精金,148,1,147,新光-高雄,2024-11-14,8562
00688L,國泰20年美債正2,209,75,134,新光-高雄,2024-11-14,8562
00679B,元大美債20年,157,45,112,新光-高雄,2024-11-14,8562
00887,永豐中國科技50大,269,162,107,新光-高雄,2024-11-14,8562
00942B,台新美A公司債20+,100,0,100,新光-高雄,2024-11-14,8562
00950B,凱基A級公司債,100,0,100,新光-高雄,2024-11-14,8562
00915,凱基優選高股息30,103,4,99,新光-高雄,2024-11-14,8562
00706L,期元大S＆P日圓正2,98,2,96,新光-高雄,2024-11-14,8562
00680L,元大美債20正2,205,110,95,新光-高雄,2024-11-14,8562
00940,元大台灣價值高息,105,22,83,新光-高雄,2024-11-14,8562
1314,中石化,93,15,78,新光-高雄,2024-11-14,8562
2317,鴻海,138,75,63,新光-高雄,2024-11-14,8562
2409,友達,65,3,62,新光-高雄,2024-11-14,8562
2303,聯電,104,42,62,新光-高雄,2024-11-14,8562
2887,台新金,61,3,58,新光-高雄,2024-11-14,8562
00932,兆豐永續高息等權,58,0,58,新光-高雄,2024-11-14,8562
2838,聯邦銀,50,0,50,新光-高雄,2024-11-14,8562
2243,宏旭-KY,50,0,50,新光-高雄,2024-11-14,8562
2312,金寶,67,19,48,新光-高雄,2024-11-14,8562
00665L,富邦�琤肭磪囓�2,1347,1300,47,新光-高雄,2024-11-14,8562
00943,兆豐電子高息等權,44,0,44,新光-高雄,2024-11-14,8562
00795B,中信美國公債20年,47,3,44,新光-高雄,2024-11-14,8562
00675L,富邦臺灣加權正2,46,5,41,新光-高雄,2024-11-14,8562
00918,大華優利高填息30,41,1,40,新光-高雄,2024-11-14,8562
00687B,國泰20年美債,86,47,39,新光-高雄,2024-11-14,8562
00751B,元大AAA至A公司債,38,1,37,新光-高雄,2024-11-14,8562
2382,廣達,76,39,37,新光-高雄,2024-11-14,8562
2883,凱基金,40,4,36,新光-高雄,2024-11-14,8562
00713,元大台灣高息低波,56,23,33,新光-高雄,2024-11-14,8562
0056,元大高股息,214,184,30,新光-高雄,2024-11-14,8562
1447,力鵬,30,0,30,新光-高雄,2024-11-14,8562
2520,冠德,32,2,30,新光-高雄,2024-11-14,8562
2892,第一金,29,0,29,新光-高雄,2024-11-14,8562
006208,富邦台50,30,2,28,新光-高雄,2024-11-14,8562
2476,鉅祥,39,12,27,新光-高雄,2024-11-14,8562
2337,旺宏,28,1,27,新光-高雄,2024-11-14,8562
1312,國喬,30,3,27,新光-高雄,2024-11-14,8562
2330,台積電,61,35,26,新光-高雄,2024-11-14,8562
3027,盛達,26,0,26,新光-高雄,2024-11-14,8562
5531,鄉林,26,0,26,新光-高雄,2024-11-14,8562
3673,TPK-KY,25,0,25,新光-高雄,2024-11-14,8562
00631L,元大台灣50正2,30,6,24,新光-高雄,2024-11-14,8562
3037,欣興,29,6,23,新光-高雄,2024-11-14,8562
9904,寶成,57,34,23,新光-高雄,2024-11-14,8562
6182,合晶,26,3,23,新光-高雄,2024-11-14,8562
00937B,群益ESG投等債20,735,103,632,新光-高雄,2024-11-15,8562
00878,國泰永續高股息,644,42,602,新光-高雄,2024-11-15,8562
00688L,國泰20年美債正2,380,27,353,新光-高雄,2024-11-15,8562
00948B,中信優息投資級債,314,20,294,新光-高雄,2024-11-15,8562
2838,聯邦銀,247,0,247,新光-高雄,2024-11-15,8562
2812,台中銀,213,0,213,新光-高雄,2024-11-15,8562
00632R,元大台灣50反1,220,32,188,新光-高雄,2024-11-15,8562
2354,鴻準,588,431,157,新光-高雄,2024-11-15,8562
00720B,元大投資級公司債,130,0,130,新光-高雄,2024-11-15,8562
4414,如興,115,0,115,新光-高雄,2024-11-15,8562
00650L,復華香港正2,102,2,100,新光-高雄,2024-11-15,8562
2382,廣達,174,85,89,新光-高雄,2024-11-15,8562
00680L,元大美債20正2,107,24,83,新光-高雄,2024-11-15,8562
00930,永豐ESG低碳高息,77,0,77,新光-高雄,2024-11-15,8562
00915,凱基優選高股息30,76,0,76,新光-高雄,2024-11-15,8562
3045,台灣大,83,25,58,新光-高雄,2024-11-15,8562
3706,神達,433,377,56,新光-高雄,2024-11-15,8562
00953B,群益優選非投等債,50,0,50,新光-高雄,2024-11-15,8562
00887,永豐中國科技50大,152,106,46,新光-高雄,2024-11-15,8562
2317,鴻海,213,168,45,新光-高雄,2024-11-15,8562
0056,元大高股息,75,33,42,新光-高雄,2024-11-15,8562
5426,振發,83,43,40,新光-高雄,2024-11-15,8562
1449,佳和,64,30,34,新光-高雄,2024-11-15,8562
2543,皇昌,40,9,31,新光-高雄,2024-11-15,8562
00900,富邦特選高股息30,32,1,31,新光-高雄,2024-11-15,8562
00725B,國泰投資級公司債,30,0,30,新光-高雄,2024-11-15,8562
6405,悅城,74,44,30,新光-高雄,2024-11-15,8562
1528,恩德,46,17,29,新光-高雄,2024-11-15,8562
3014,聯陽,30,1,29,新光-高雄,2024-11-15,8562
9945,潤泰新,43,16,27,新光-高雄,2024-11-15,8562
00929,復華台灣科技優息,183,159,24,新光-高雄,2024-11-15,8562
00902,中信電池及儲能,24,0,24,新光-高雄,2024-11-15,8562
6133,金橋,27,4,23,新光-高雄,2024-11-15,8562
00639,富邦深100,30,7,23,新光-高雄,2024-11-15,8562
3037,欣興,29,7,22,新光-高雄,2024-11-15,8562
8070,長華*,24,3,21,新光-高雄,2024-11-15,8562
00943,兆豐電子高息等權,23,2,21,新光-高雄,2024-11-15,8562
00733,富邦臺灣中小,20,0,20,新光-高雄,2024-11-15,8562
00706L,期元大S＆P日圓正2,20,0,20,新光-高雄,2024-11-15,8562
1307,三芳,22,2,20,新光-高雄,2024-11-15,8562
5608,四維航,49,29,20,新光-高雄,2024-11-15,8562
3017,奇鋐,33,13,20,新光-高雄,2024-11-15,8562
2330,台積電,38,18,20,新光-高雄,2024-11-15,8562
006208,富邦台50,23,3,20,新光-高雄,2024-11-15,8562
3576,聯合再生,50,31,19,新光-高雄,2024-11-15,8562
8027,鈦昇,20,4,16,新光-高雄,2024-11-15,8562
2888,新光金,21,5,16,新光-高雄,2024-11-15,8562
3013,晟銘電,79,63,16,新光-高雄,2024-11-15,8562
6763,綠界科技*,39,24,15,新光-高雄,2024-11-15,8562
00772B,中信高評級公司債,15,0,15,新光-高雄,2024-11-15,8562
00878,國泰永續高股息,732,75,657,新光-高雄,2024-11-18,8562
00929,復華台灣科技優息,401,44,357,新光-高雄,2024-11-18,8562
00715L,期街口布蘭特正2,257,32,225,新光-高雄,2024-11-18,8562
3481,群創,134,17,117,新光-高雄,2024-11-18,8562
00637L,元大滬深300正2,459,375,84,新光-高雄,2024-11-18,8562
00919,群益台灣精選高息,98,16,82,新光-高雄,2024-11-18,8562
1815,富喬,78,0,78,新光-高雄,2024-11-18,8562
0056,元大高股息,91,15,76,新光-高雄,2024-11-18,8562
00680L,元大美債20正2,78,5,73,新光-高雄,2024-11-18,8562
006208,富邦台50,71,1,70,新光-高雄,2024-11-18,8562
2312,金寶,304,237,67,新光-高雄,2024-11-18,8562
5425,台半,61,0,61,新光-高雄,2024-11-18,8562
00915,凱基優選高股息30,63,3,60,新光-高雄,2024-11-18,8562
00713,元大台灣高息低波,70,25,45,新光-高雄,2024-11-18,8562
00733,富邦臺灣中小,46,2,44,新光-高雄,2024-11-18,8562
3090,日電貿,80,40,40,新光-高雄,2024-11-18,8562
2409,友達,42,4,38,新光-高雄,2024-11-18,8562
00731,復華富時高息低波,39,2,37,新光-高雄,2024-11-18,8562
00937B,群益ESG投等債20,41,5,36,新光-高雄,2024-11-18,8562
3689,湧德,41,7,34,新光-高雄,2024-11-18,8562
00642U,期元大S＆P石油,32,0,32,新光-高雄,2024-11-18,8562
6763,綠界科技*,47,16,31,新光-高雄,2024-11-18,8562
00953B,群益優選非投等債,30,0,30,新光-高雄,2024-11-18,8562
2371,大同,37,8,29,新光-高雄,2024-11-18,8562
00795B,中信美國公債20年,28,0,28,新光-高雄,2024-11-18,8562
2887,台新金,36,7,29,新光-高雄,2024-11-18,8562
2354,鴻準,291,263,28,新光-高雄,2024-11-18,8562
00891,中信關鍵半導體,40,12,28,新光-高雄,2024-11-18,8562
2881,富邦金,29,2,27,新光-高雄,2024-11-18,8562
00900,富邦特選高股息30,27,0,27,新光-高雄,2024-11-18,8562
2324,仁寶,108,82,26,新光-高雄,2024-11-18,8562
3706,神達,298,272,26,新光-高雄,2024-11-18,8562
3062,建漢,141,115,26,新光-高雄,2024-11-18,8562
00945B,凱基美國非投等債,25,0,25,新光-高雄,2024-11-18,8562
4174,浩鼎,25,0,25,新光-高雄,2024-11-18,8562
00675L,富邦臺灣加權正2,32,7,25,新光-高雄,2024-11-18,8562
5388,中磊,22,0,22,新光-高雄,2024-11-18,8562
00665L,富邦�琤肭磪囓�2,222,201,21,新光-高雄,2024-11-18,8562
3050,鈺德,88,67,21,新光-高雄,2024-11-18,8562
00930,永豐ESG低碳高息,20,0,20,新光-高雄,2024-11-18,8562
00943,兆豐電子高息等權,27,9,18,新光-高雄,2024-11-18,8562
3037,欣興,34,16,18,新光-高雄,2024-11-18,8562
00922,國泰台灣領袖50,21,4,17,新光-高雄,2024-11-18,8562
1307,三芳,17,0,17,新光-高雄,2024-11-18,8562
3704,合勤控,18,1,17,新光-高雄,2024-11-18,8562
00934,中信成長高股息,17,0,17,新光-高雄,2024-11-18,8562
2605,新興,30,14,16,新光-高雄,2024-11-18,8562
00688L,國泰20年美債正2,20,5,15,新光-高雄,2024-11-18,8562
00877,復華中國5G,65,50,15,新光-高雄,2024-11-18,8562
0050,元大台灣50,17,3,14,新光-高雄,2024-11-18,8562
00929,復華台灣科技優息,869,361,508,新光-高雄,2024-11-19,8562
00637L,元大滬深300正2,1106,814,292,新光-高雄,2024-11-19,8562
2312,金寶,644,470,174,新光-高雄,2024-11-19,8562
00673R,期元大S＆P原油反1,183,41,142,新光-高雄,2024-11-19,8562
2349,錸德,406,276,130,新光-高雄,2024-11-19,8562
1301,台塑,169,39,130,新光-高雄,2024-11-19,8562
4904,遠傳,105,3,102,新光-高雄,2024-11-19,8562
00915,凱基優選高股息30,100,3,97,新光-高雄,2024-11-19,8562
2838,聯邦銀,81,2,79,新光-高雄,2024-11-19,8562
00753L,中信中國50正2,169,92,77,新光-高雄,2024-11-19,8562
2890,永豐金,75,7,68,新光-高雄,2024-11-19,8562
2812,台中銀,72,4,68,新光-高雄,2024-11-19,8562
6182,合晶,66,9,57,新光-高雄,2024-11-19,8562
00932,兆豐永續高息等權,61,13,48,新光-高雄,2024-11-19,8562
2867,三商壽,60,18,42,新光-高雄,2024-11-19,8562
3090,日電貿,55,14,41,新光-高雄,2024-11-19,8562
2317,鴻海,77,39,38,新光-高雄,2024-11-19,8562
3706,神達,285,249,36,新光-高雄,2024-11-19,8562
2891,中信金,48,15,33,新光-高雄,2024-11-19,8562
00945B,凱基美國非投等債,32,0,32,新光-高雄,2024-11-19,8562
00877,復華中國5G,35,5,30,新光-高雄,2024-11-19,8562
2884,玉山金,27,1,26,新光-高雄,2024-11-19,8562
9904,寶成,41,15,26,新光-高雄,2024-11-19,8562
0061,元大寶滬深,24,0,24,新光-高雄,2024-11-19,8562
2399,映泰,85,62,23,新光-高雄,2024-11-19,8562
00679B,元大美債20年,57,35,22,新光-高雄,2024-11-19,8562
8104,錸寶,80,58,22,新光-高雄,2024-11-19,8562
00713,元大台灣高息低波,24,4,20,新光-高雄,2024-11-19,8562
6763,綠界科技*,34,14,20,新光-高雄,2024-11-19,8562
9921,巨大,21,4,17,新光-高雄,2024-11-19,8562
2382,廣達,41,24,17,新光-高雄,2024-11-19,8562
2409,友達,21,5,16,新光-高雄,2024-11-19,8562
2444,兆勁,19,3,16,新光-高雄,2024-11-19,8562
00688L,國泰20年美債正2,20,5,15,新光-高雄,2024-11-19,8562
1321,大洋,15,0,15,新光-高雄,2024-11-19,8562
5608,四維航,15,0,15,新光-高雄,2024-11-19,8562
00953B,群益優選非投等債,15,0,15,新光-高雄,2024-11-19,8562
00887,永豐中國科技50大,122,107,15,新光-高雄,2024-11-19,8562
00712,復華富時不動產,20,6,14,新光-高雄,2024-11-19,8562
3548,兆利,14,0,14,新光-高雄,2024-11-19,8562
2929,淘帝-KY,18,6,12,新光-高雄,2024-11-19,8562
2324,仁寶,21,10,11,新光-高雄,2024-11-19,8562
00795B,中信美國公債20年,11,0,11,新光-高雄,2024-11-19,8562
1227,佳格,11,0,11,新光-高雄,2024-11-19,8562
3290,東浦,13,2,11,新光-高雄,2024-11-19,8562
6213,聯茂,13,2,11,新光-高雄,2024-11-19,8562
00943,兆豐電子高息等權,22,12,10,新光-高雄,2024-11-19,8562
6245,立端,10,0,10,新光-高雄,2024-11-19,8562
4909,新復興,34,24,10,新光-高雄,2024-11-19,8562
00959B,大華投等美債15Y+,10,0,10,新光-高雄,2024-11-19,8562
00632R,元大台灣50反1,999,16,983,新光-高雄,2024-11-20,8562
00953B,群益優選非投等債,322,0,322,新光-高雄,2024-11-20,8562
00679B,元大美債20年,197,4,193,新光-高雄,2024-11-20,8562
00878,國泰永續高股息,217,38,179,新光-高雄,2024-11-20,8562
2888,新光金,160,20,140,新光-高雄,2024-11-20,8562
2312,金寶,195,63,132,新光-高雄,2024-11-20,8562
2812,台中銀,127,17,110,新光-高雄,2024-11-20,8562
3062,建漢,146,35,111,新光-高雄,2024-11-20,8562
00940,元大台灣價值高息,92,12,80,新光-高雄,2024-11-20,8562
2231,為升,75,0,75,新光-高雄,2024-11-20,8562
00929,復華台灣科技優息,155,88,67,新光-高雄,2024-11-20,8562
3450,聯鈞,128,64,64,新光-高雄,2024-11-20,8562
00915,凱基優選高股息30,64,0,64,新光-高雄,2024-11-20,8562
0056,元大高股息,56,2,54,新光-高雄,2024-11-20,8562
2317,鴻海,89,43,46,新光-高雄,2024-11-20,8562
3594,磐儀,63,19,44,新光-高雄,2024-11-20,8562
2547,日勝生,42,0,42,新光-高雄,2024-11-20,8562
00930,永豐ESG低碳高息,41,1,40,新光-高雄,2024-11-20,8562
3706,神達,431,391,40,新光-高雄,2024-11-20,8562
2303,聯電,39,2,37,新光-高雄,2024-11-20,8562
5905,南仁湖,39,4,35,新光-高雄,2024-11-20,8562
2354,鴻準,385,350,35,新光-高雄,2024-11-20,8562
9904,寶成,41,7,34,新光-高雄,2024-11-20,8562
00631L,元大台灣50正2,50,16,34,新光-高雄,2024-11-20,8562
00945B,凱基美國非投等債,34,0,34,新光-高雄,2024-11-20,8562
2603,長榮,65,34,31,新光-高雄,2024-11-20,8562
00639,富邦深100,35,6,29,新光-高雄,2024-11-20,8562
00894,中信小資高價30,29,0,29,新光-高雄,2024-11-20,8562
2834,臺企銀,33,6,27,新光-高雄,2024-11-20,8562
2330,台積電,69,42,27,新光-高雄,2024-11-20,8562
1446,宏和,30,5,25,新光-高雄,2024-11-20,8562
6182,合晶,25,1,24,新光-高雄,2024-11-20,8562
2380,虹光,24,0,24,新光-高雄,2024-11-20,8562
3234,光環,24,0,24,新光-高雄,2024-11-20,8562
2543,皇昌,60,36,24,新光-高雄,2024-11-20,8562
00902,中信電池及儲能,30,7,23,新光-高雄,2024-11-20,8562
2329,華泰,30,7,23,新光-高雄,2024-11-20,8562
3029,零壹,28,6,22,新光-高雄,2024-11-20,8562
4577,達航科技,23,1,22,新光-高雄,2024-11-20,8562
00713,元大台灣高息低波,23,1,22,新光-高雄,2024-11-20,8562
00733,富邦臺灣中小,21,0,21,新光-高雄,2024-11-20,8562
00751B,元大AAA至A公司債,22,1,21,新光-高雄,2024-11-20,8562
2356,英業達,89,69,20,新光-高雄,2024-11-20,8562
00912,中信臺灣智慧50,20,0,20,新光-高雄,2024-11-20,8562
00673R,期元大S＆P原油反1,20,0,20,新光-高雄,2024-11-20,8562
3323,加百裕,65,45,20,新光-高雄,2024-11-20,8562
006208,富邦台50,20,1,19,新光-高雄,2024-11-20,8562
3447,展達,58,40,18,新光-高雄,2024-11-20,8562
1799,易威,18,0,18,新光-高雄,2024-11-20,8562
2882,國泰金,19,2,17,新光-高雄,2024-11-20,8562
3511,矽瑪,330,65,265,新光-高雄,2024-11-21,8562
2542,興富發,268,6,262,新光-高雄,2024-11-21,8562
2610,華航,225,46,179,新光-高雄,2024-11-21,8562
00878,國泰永續高股息,203,88,115,新光-高雄,2024-11-21,8562
2002,中鋼,117,5,112,新光-高雄,2024-11-21,8562
2915,潤泰全,111,17,94,新光-高雄,2024-11-21,8562
00680L,元大美債20正2,100,13,87,新光-高雄,2024-11-21,8562
00959B,大華投等美債15Y+,82,0,82,新光-高雄,2024-11-21,8562
2317,鴻海,98,28,70,新光-高雄,2024-11-21,8562
006208,富邦台50,72,1,71,新光-高雄,2024-11-21,8562
2890,永豐金,69,0,69,新光-高雄,2024-11-21,8562
2618,長榮航,601,534,67,新光-高雄,2024-11-21,8562
5880,合庫金,64,0,64,新光-高雄,2024-11-21,8562
00687B,國泰20年美債,82,24,58,新光-高雄,2024-11-21,8562
00795B,中信美國公債20年,64,7,57,新光-高雄,2024-11-21,8562
00675L,富邦臺灣加權正2,55,4,51,新光-高雄,2024-11-21,8562
0050,元大台灣50,47,0,47,新光-高雄,2024-11-21,8562
2881,富邦金,46,0,46,新光-高雄,2024-11-21,8562
2303,聯電,47,2,45,新光-高雄,2024-11-21,8562
00919,群益台灣精選高息,155,114,41,新光-高雄,2024-11-21,8562
4927,泰鼎-KY,39,0,39,新光-高雄,2024-11-21,8562
00887,永豐中國科技50大,97,59,38,新光-高雄,2024-11-21,8562
5907,大洋-KY,66,30,36,新光-高雄,2024-11-21,8562
1301,台塑,65,30,35,新光-高雄,2024-11-21,8562
4968,立積,41,9,32,新光-高雄,2024-11-21,8562
0056,元大高股息,60,29,31,新光-高雄,2024-11-21,8562
00725B,國泰投資級公司債,30,0,30,新光-高雄,2024-11-21,8562
00953B,群益優選非投等債,35,5,30,新光-高雄,2024-11-21,8562
00715L,期街口布蘭特正2,30,0,30,新光-高雄,2024-11-21,8562
2027,大成鋼,34,5,29,新光-高雄,2024-11-21,8562
00665L,富邦�琤肭磪囓�2,549,522,27,新光-高雄,2024-11-21,8562
5398,慕康生醫,122,96,26,新光-高雄,2024-11-21,8562
5465,富驊,26,2,24,新光-高雄,2024-11-21,8562
00720B,元大投資級公司債,26,3,23,新光-高雄,2024-11-21,8562
5876,上海商銀,23,1,22,新光-高雄,2024-11-21,8562
1471,首利,22,0,22,新光-高雄,2024-11-21,8562
3231,緯創,25,4,21,新光-高雄,2024-11-21,8562
2838,聯邦銀,21,0,21,新光-高雄,2024-11-21,8562
1447,力鵬,20,0,20,新光-高雄,2024-11-21,8562
2101,南港,20,0,20,新光-高雄,2024-11-21,8562
00891,中信關鍵半導體,20,0,20,新光-高雄,2024-11-21,8562
2615,萬海,146,127,19,新光-高雄,2024-11-21,8562
2109,華豐,20,2,18,新光-高雄,2024-11-21,8562
2330,台積電,93,75,18,新光-高雄,2024-11-21,8562
2539,櫻花建,23,6,17,新光-高雄,2024-11-21,8562
2380,虹光,16,0,16,新光-高雄,2024-11-21,8562
1569,濱川,121,107,14,新光-高雄,2024-11-21,8562
2812,台中銀,29,15,14,新光-高雄,2024-11-21,8562
5388,中磊,15,1,14,新光-高雄,2024-11-21,8562
1101,台泥,17,4,13,新光-高雄,2024-11-21,8562
2867,三商壽,900,56,844,新光-高雄,2024-11-22,8562
00959B,大華投等美債15Y+,658,0,658,新光-高雄,2024-11-22,8562
00753L,中信中國50正2,1049,734,315,新光-高雄,2024-11-22,8562
00637L,元大滬深300正2,685,521,164,新光-高雄,2024-11-22,8562
00929,復華台灣科技優息,339,191,148,新光-高雄,2024-11-22,8562
00937B,群益ESG投等債20,134,10,124,新光-高雄,2024-11-22,8562
00915,凱基優選高股息30,110,3,107,新光-高雄,2024-11-22,8562
6546,正基,118,22,96,新光-高雄,2024-11-22,8562
2349,錸德,160,81,79,新光-高雄,2024-11-22,8562
00665L,富邦�琤肭磪囓�2,561,483,78,新光-高雄,2024-11-22,8562
3290,東浦,73,4,69,新光-高雄,2024-11-22,8562
2515,中工,101,37,64,新光-高雄,2024-11-22,8562
9105,泰金寶-DR,799,737,62,新光-高雄,2024-11-22,8562
00687B,國泰20年美債,145,93,52,新光-高雄,2024-11-22,8562
3511,矽瑪,68,17,51,新光-高雄,2024-11-22,8562
3489,森寶,51,0,51,新光-高雄,2024-11-22,8562
5905,南仁湖,55,6,49,新光-高雄,2024-11-22,8562
5876,上海商銀,50,5,45,新光-高雄,2024-11-22,8562
00830,國泰費城半導體,44,0,44,新光-高雄,2024-11-22,8562
1449,佳和,109,65,44,新光-高雄,2024-11-22,8562
3706,神達,452,413,39,新光-高雄,2024-11-22,8562
00632R,元大台灣50反1,347,310,37,新光-高雄,2024-11-22,8562
2838,聯邦銀,36,2,34,新光-高雄,2024-11-22,8562
2636,台驊控股,34,0,34,新光-高雄,2024-11-22,8562
8261,富鼎,38,7,31,新光-高雄,2024-11-22,8562
2615,萬海,92,61,31,新光-高雄,2024-11-22,8562
00953B,群益優選非投等債,30,0,30,新光-高雄,2024-11-22,8562
6854,錼創科技-KY創,30,0,30,新光-高雄,2024-11-22,8562
00712,復華富時不動產,42,14,28,新光-高雄,2024-11-22,8562
2511,太子,26,0,26,新光-高雄,2024-11-22,8562
00673R,期元大S＆P原油反1,25,0,25,新光-高雄,2024-11-22,8562
1528,恩德,32,7,25,新光-高雄,2024-11-22,8562
5608,四維航,27,3,24,新光-高雄,2024-11-22,8562
00887,永豐中國科技50大,33,10,23,新光-高雄,2024-11-22,8562
6416,瑞祺電通,23,0,23,新光-高雄,2024-11-22,8562
00930,永豐ESG低碳高息,22,0,22,新光-高雄,2024-11-22,8562
3264,欣銓,22,0,22,新光-高雄,2024-11-22,8562
2317,鴻海,79,58,21,新光-高雄,2024-11-22,8562
4562,穎漢,24,3,21,新光-高雄,2024-11-22,8562
5907,大洋-KY,21,0,21,新光-高雄,2024-11-22,8562
4714,永捷,20,0,20,新光-高雄,2024-11-22,8562
6182,合晶,19,0,19,新光-高雄,2024-11-22,8562
3303,岱稜,23,4,19,新光-高雄,2024-11-22,8562
2609,陽明,88,69,19,新光-高雄,2024-11-22,8562
2486,一詮,35,17,18,新光-高雄,2024-11-22,8562
6770,力積電,18,0,18,新光-高雄,2024-11-22,8562
00909,國泰數位支付服務,27,10,17,新光-高雄,2024-11-22,8562
2431,聯昌,22,6,16,新光-高雄,2024-11-22,8562
2442,新美齊,20,4,16,新光-高雄,2024-11-22,8562
3702,大聯大,16,1,15,新光-高雄,2024-11-22,8562
00953B,群益優選非投等債,528,1,527,新光-高雄,2024-11-25,8562
9105,泰金寶-DR,959,465,494,新光-高雄,2024-11-25,8562
00959B,大華投等美債15Y+,359,30,329,新光-高雄,2024-11-25,8562
1815,富喬,710,412,298,新光-高雄,2024-11-25,8562
00753L,中信中國50正2,671,489,182,新光-高雄,2024-11-25,8562
00919,群益台灣精選高息,193,43,150,新光-高雄,2024-11-25,8562
00687B,國泰20年美債,99,8,91,新光-高雄,2024-11-25,8562
00673R,期元大S＆P原油反1,76,0,76,新光-高雄,2024-11-25,8562
2371,大同,114,55,59,新光-高雄,2024-11-25,8562
00632R,元大台灣50反1,59,1,58,新光-高雄,2024-11-25,8562
5465,富驊,114,58,56,新光-高雄,2024-11-25,8562
00930,永豐ESG低碳高息,56,3,53,新光-高雄,2024-11-25,8562
2105,正新,63,10,53,新光-高雄,2024-11-25,8562
2834,臺企銀,52,0,52,新光-高雄,2024-11-25,8562
00918,大華優利高填息30,82,30,52,新光-高雄,2024-11-25,8562
3706,神達,460,411,49,新光-高雄,2024-11-25,8562
00948B,中信優息投資級債,40,0,40,新光-高雄,2024-11-25,8562
8070,長華*,44,8,36,新光-高雄,2024-11-25,8562
1809,中釉,136,102,34,新光-高雄,2024-11-25,8562
6854,錼創科技-KY創,34,0,34,新光-高雄,2024-11-25,8562
2838,聯邦銀,36,2,34,新光-高雄,2024-11-25,8562
2892,第一金,35,2,33,新光-高雄,2024-11-25,8562
2615,萬海,85,51,34,新光-高雄,2024-11-25,8562
1528,恩德,34,3,31,新光-高雄,2024-11-25,8562
00679B,元大美債20年,89,59,30,新光-高雄,2024-11-25,8562
2603,長榮,99,69,30,新光-高雄,2024-11-25,8562
006208,富邦台50,34,5,29,新光-高雄,2024-11-25,8562
8261,富鼎,55,26,29,新光-高雄,2024-11-25,8562
00639,富邦深100,30,2,28,新光-高雄,2024-11-25,8562
2312,金寶,677,650,27,新光-高雄,2024-11-25,8562
2449,京元電子,43,16,27,新光-高雄,2024-11-25,8562
4907,富宇,26,0,26,新光-高雄,2024-11-25,8562
00713,元大台灣高息低波,26,0,26,新光-高雄,2024-11-25,8562
912000,晨訊科-DR,23,0,23,新光-高雄,2024-11-25,8562
00675L,富邦臺灣加權正2,40,17,23,新光-高雄,2024-11-25,8562
00934,中信成長高股息,25,3,22,新光-高雄,2024-11-25,8562
00648R,元大S＆P500反1,19,0,19,新光-高雄,2024-11-25,8562
1446,宏和,20,1,19,新光-高雄,2024-11-25,8562
5876,上海商銀,19,1,18,新光-高雄,2024-11-25,8562
1799,易威,17,0,17,新光-高雄,2024-11-25,8562
1402,遠東新,20,4,16,新光-高雄,2024-11-25,8562
2323,中環,16,0,16,新光-高雄,2024-11-25,8562
00904,新光臺灣半導體30,15,0,15,新光-高雄,2024-11-25,8562
00635U,期元大S＆P黃金,18,3,15,新光-高雄,2024-11-25,8562
00901,永豐智能車供應鏈,20,6,14,新光-高雄,2024-11-25,8562
2330,台積電,93,79,14,新光-高雄,2024-11-25,8562
5483,中美晶,17,3,14,新光-高雄,2024-11-25,8562
6005,群益證,16,2,14,新光-高雄,2024-11-25,8562
2367,燿華,51,37,14,新光-高雄,2024-11-25,8562
3712,永崴投控,78,64,14,新光-高雄,2024-11-25,8562
2618,長榮航,822,57,765,新光-高雄,2024-11-26,8562
3323,加百裕,535,123,412,新光-高雄,2024-11-26,8562
00669R,國泰美國道瓊反1,401,3,398,新光-高雄,2024-11-26,8562
00953B,群益優選非投等債,315,6,309,新光-高雄,2024-11-26,8562
2027,大成鋼,221,25,196,新光-高雄,2024-11-26,8562
00878,國泰永續高股息,168,7,161,新光-高雄,2024-11-26,8562
2317,鴻海,240,83,157,新光-高雄,2024-11-26,8562
00959B,大華投等美債15Y+,152,1,151,新光-高雄,2024-11-26,8562
9105,泰金寶-DR,321,228,93,新光-高雄,2024-11-26,8562
00940,元大台灣價值高息,106,12,94,新光-高雄,2024-11-26,8562
00930,永豐ESG低碳高息,95,3,92,新光-高雄,2024-11-26,8562
2106,建大,80,0,80,新光-高雄,2024-11-26,8562
6962,ITH-KY,78,8,70,新光-高雄,2024-11-26,8562
00951,台新日本半導體,60,0,60,新光-高雄,2024-11-26,8562
00918,大華優利高填息30,58,0,58,新光-高雄,2024-11-26,8562
0056,元大高股息,63,10,53,新光-高雄,2024-11-26,8562
00891,中信關鍵半導體,56,5,51,新光-高雄,2024-11-26,8562
5309,系統電,119,70,49,新光-高雄,2024-11-26,8562
2515,中工,52,5,47,新光-高雄,2024-11-26,8562
3706,神達,262,215,47,新光-高雄,2024-11-26,8562
2890,永豐金,42,2,40,新光-高雄,2024-11-26,8562
8044,網家,73,33,40,新光-高雄,2024-11-26,8562
006208,富邦台50,40,0,40,新光-高雄,2024-11-26,8562
00715L,期街口布蘭特正2,148,108,40,新光-高雄,2024-11-26,8562
3231,緯創,76,39,37,新光-高雄,2024-11-26,8562
00857B,永豐20年美公債,59,23,36,新光-高雄,2024-11-26,8562
2330,台積電,71,35,36,新光-高雄,2024-11-26,8562
00646,元大S＆P500,35,1,34,新光-高雄,2024-11-26,8562
00713,元大台灣高息低波,34,1,33,新光-高雄,2024-11-26,8562
00675L,富邦臺灣加權正2,49,20,29,新光-高雄,2024-11-26,8562
00887,永豐中國科技50大,27,0,27,新光-高雄,2024-11-26,8562
2542,興富發,37,10,27,新光-高雄,2024-11-26,8562
00915,凱基優選高股息30,44,18,26,新光-高雄,2024-11-26,8562
2303,聯電,39,12,27,新光-高雄,2024-11-26,8562
00922,國泰台灣領袖50,36,12,24,新光-高雄,2024-11-26,8562
00909,國泰數位支付服務,25,2,23,新光-高雄,2024-11-26,8562
2834,臺企銀,24,1,23,新光-高雄,2024-11-26,8562
2603,長榮,57,35,22,新光-高雄,2024-11-26,8562
00631L,元大台灣50正2,48,26,22,新光-高雄,2024-11-26,8562
0050,元大台灣50,24,2,22,新光-高雄,2024-11-26,8562
2405,輔信,21,0,21,新光-高雄,2024-11-26,8562
3211,順達,23,2,21,新光-高雄,2024-11-26,8562
00733,富邦臺灣中小,21,0,21,新光-高雄,2024-11-26,8562
00919,群益台灣精選高息,44,24,20,新光-高雄,2024-11-26,8562
00954,中信日本半導體,20,0,20,新光-高雄,2024-11-26,8562
00949,復華日本龍頭,21,1,20,新光-高雄,2024-11-26,8562
00676R,富邦臺灣加權反1,20,0,20,新光-高雄,2024-11-26,8562
2887,台新金,28,8,20,新光-高雄,2024-11-26,8562
1802,台玻,30,11,19,新光-高雄,2024-11-26,8562
00731,復華富時高息低波,19,1,18,新光-高雄,2024-11-26,8562
00919,群益台灣精選高息,575,30,545,新光-高雄,2024-11-27,8562
00878,國泰永續高股息,497,69,428,新光-高雄,2024-11-27,8562
0056,元大高股息,329,76,253,新光-高雄,2024-11-27,8562
00940,元大台灣價值高息,217,3,214,新光-高雄,2024-11-27,8562
2303,聯電,172,47,125,新光-高雄,2024-11-27,8562
2002,中鋼,141,24,117,新光-高雄,2024-11-27,8562
00675L,富邦臺灣加權正2,126,22,104,新光-高雄,2024-11-27,8562
00715L,期街口布蘭特正2,136,37,99,新光-高雄,2024-11-27,8562
2349,錸德,120,23,97,新光-高雄,2024-11-27,8562
00930,永豐ESG低碳高息,99,3,96,新光-高雄,2024-11-27,8562
3090,日電貿,97,15,82,新光-高雄,2024-11-27,8562
00929,復華台灣科技優息,254,175,79,新光-高雄,2024-11-27,8562
2353,宏��,85,7,78,新光-高雄,2024-11-27,8562
00946,群益科技高息成長,76,2,74,新光-高雄,2024-11-27,8562
3706,神達,419,355,64,新光-高雄,2024-11-27,8562
2317,鴻海,202,145,57,新光-高雄,2024-11-27,8562
2812,台中銀,64,8,56,新光-高雄,2024-11-27,8562
00669R,國泰美國道瓊反1,86,31,55,新光-高雄,2024-11-27,8562
00932,兆豐永續高息等權,52,0,52,新光-高雄,2024-11-27,8562
2511,太子,50,0,50,新光-高雄,2024-11-27,8562
1815,富喬,186,137,49,新光-高雄,2024-11-27,8562
1536,和大,184,136,48,新光-高雄,2024-11-27,8562
2330,台積電,109,61,48,新光-高雄,2024-11-27,8562
00922,國泰台灣領袖50,70,25,45,新光-高雄,2024-11-27,8562
2603,長榮,133,88,45,新光-高雄,2024-11-27,8562
00915,凱基優選高股息30,42,0,42,新光-高雄,2024-11-27,8562
1569,濱川,45,4,41,新光-高雄,2024-11-27,8562
006208,富邦台50,41,1,40,新光-高雄,2024-11-27,8562
00753L,中信中國50正2,1306,1268,38,新光-高雄,2024-11-27,8562
6213,聯茂,55,19,36,新光-高雄,2024-11-27,8562
2323,中環,43,7,36,新光-高雄,2024-11-27,8562
00631L,元大台灣50正2,50,14,36,新光-高雄,2024-11-27,8562
3211,順達,37,2,35,新光-高雄,2024-11-27,8562
2615,萬海,124,90,34,新光-高雄,2024-11-27,8562
2881,富邦金,35,1,34,新光-高雄,2024-11-27,8562
0050,元大台灣50,48,14,34,新光-高雄,2024-11-27,8562
00960,野村全球航運龍頭,33,0,33,新光-高雄,2024-11-27,8562
2426,鼎元,39,7,32,新光-高雄,2024-11-27,8562
1532,勤美,30,1,29,新光-高雄,2024-11-27,8562
5488,松普,30,2,28,新光-高雄,2024-11-27,8562
4977,眾達-KY,50,23,27,新光-高雄,2024-11-27,8562
00905,FT臺灣Smart,25,0,25,新光-高雄,2024-11-27,8562
00706L,期元大S＆P日圓正2,105,80,25,新光-高雄,2024-11-27,8562
2609,陽明,146,123,23,新光-高雄,2024-11-27,8562
3520,華盈,24,1,23,新光-高雄,2024-11-27,8562
2887,台新金,25,4,21,新光-高雄,2024-11-27,8562
00639,富邦深100,21,0,21,新光-高雄,2024-11-27,8562
2344,華邦電,101,81,20,新光-高雄,2024-11-27,8562
2883,凱基金,27,7,20,新光-高雄,2024-11-27,8562
1605,華新,20,0,20,新光-高雄,2024-11-27,8562
00878,國泰永續高股息,513,80,433,新光-高雄,2024-11-28,8562
00919,群益台灣精選高息,383,39,344,新光-高雄,2024-11-28,8562
00929,復華台灣科技優息,408,87,321,新光-高雄,2024-11-28,8562
0056,元大高股息,247,40,207,新光-高雄,2024-11-28,8562
2312,金寶,378,237,141,新光-高雄,2024-11-28,8562
2609,陽明,168,31,137,新光-高雄,2024-11-28,8562
00715L,期街口布蘭特正2,124,5,119,新光-高雄,2024-11-28,8562
00940,元大台灣價值高息,203,116,87,新光-高雄,2024-11-28,8562
4510,高鋒,311,230,81,新光-高雄,2024-11-28,8562
2409,友達,90,10,80,新光-高雄,2024-11-28,8562
1815,富喬,473,400,73,新光-高雄,2024-11-28,8562
00922,國泰台灣領袖50,70,1,69,新光-高雄,2024-11-28,8562
00915,凱基優選高股息30,66,5,61,新光-高雄,2024-11-28,8562
00918,大華優利高填息30,91,30,61,新光-高雄,2024-11-28,8562
4414,如興,60,0,60,新光-高雄,2024-11-28,8562
2867,三商壽,56,0,56,新光-高雄,2024-11-28,8562
00891,中信關鍵半導體,57,4,53,新光-高雄,2024-11-28,8562
00953B,群益優選非投等債,40,0,40,新光-高雄,2024-11-28,8562
00930,永豐ESG低碳高息,40,1,39,新光-高雄,2024-11-28,8562
2515,中工,35,0,35,新光-高雄,2024-11-28,8562
00675L,富邦臺灣加權正2,44,10,34,新光-高雄,2024-11-28,8562
2324,仁寶,49,15,34,新光-高雄,2024-11-28,8562
2332,友訊,107,74,33,新光-高雄,2024-11-28,8562
5880,合庫金,33,2,31,新光-高雄,2024-11-28,8562
1301,台塑,33,7,26,新光-高雄,2024-11-28,8562
2882,國泰金,28,2,26,新光-高雄,2024-11-28,8562
4991,環宇-KY,40,14,26,新光-高雄,2024-11-28,8562
2354,鴻準,154,128,26,新光-高雄,2024-11-28,8562
00881,國泰台灣5G+,27,2,25,新光-高雄,2024-11-28,8562
5905,南仁湖,35,10,25,新光-高雄,2024-11-28,8562
4971,IET-KY,33,8,25,新光-高雄,2024-11-28,8562
6405,悅城,27,3,24,新光-高雄,2024-11-28,8562
2353,宏��,34,10,24,新光-高雄,2024-11-28,8562
00753L,中信中國50正2,1201,1178,23,新光-高雄,2024-11-28,8562
0050,元大台灣50,27,4,23,新光-高雄,2024-11-28,8562
00943,兆豐電子高息等權,25,4,21,新光-高雄,2024-11-28,8562
4960,誠美材,21,0,21,新光-高雄,2024-11-28,8562
2382,廣達,28,7,21,新光-高雄,2024-11-28,8562
006208,富邦台50,27,7,20,新光-高雄,2024-11-28,8562
00665L,富邦�琤肭磪囓�2,76,56,20,新光-高雄,2024-11-28,8562
3234,光環,21,1,20,新光-高雄,2024-11-28,8562
00713,元大台灣高息低波,48,28,20,新光-高雄,2024-11-28,8562
2610,華航,116,96,20,新光-高雄,2024-11-28,8562
3003,健和興,19,0,19,新光-高雄,2024-11-28,8562
5302,太欣,20,1,19,新光-高雄,2024-11-28,8562
2892,第一金,19,0,19,新光-高雄,2024-11-28,8562
2405,輔信,33,15,18,新光-高雄,2024-11-28,8562
00852L,國泰美國道瓊正2,25,7,18,新光-高雄,2024-11-28,8562
3231,緯創,64,46,18,新光-高雄,2024-11-28,8562
6962,ITH-KY,19,2,17,新光-高雄,2024-11-28,8562
1802,台玻,374,40,334,新光-高雄,2024-11-29,8562
00953B,群益優選非投等債,260,6,254,新光-高雄,2024-11-29,8562
3231,緯創,206,27,179,新光-高雄,2024-11-29,8562
00919,群益台灣精選高息,297,139,158,新光-高雄,2024-11-29,8562
00878,國泰永續高股息,190,64,126,新光-高雄,2024-11-29,8562
2303,聯電,93,16,77,新光-高雄,2024-11-29,8562
2002,中鋼,66,0,66,新光-高雄,2024-11-29,8562
2867,三商壽,50,0,50,新光-高雄,2024-11-29,8562
00915,凱基優選高股息30,56,8,48,新光-高雄,2024-11-29,8562
0056,元大高股息,105,59,46,新光-高雄,2024-11-29,8562
1301,台塑,55,10,45,新光-高雄,2024-11-29,8562
6139,亞翔,54,10,44,新光-高雄,2024-11-29,8562
2838,聯邦銀,43,0,43,新光-高雄,2024-11-29,8562
00931B,統一美債20年,63,22,41,新光-高雄,2024-11-29,8562
3062,建漢,82,42,40,新光-高雄,2024-11-29,8562
00633L,富邦上証正2,49,9,40,新光-高雄,2024-11-29,8562
6257,矽格,38,0,38,新光-高雄,2024-11-29,8562
3211,順達,149,115,34,新光-高雄,2024-11-29,8562
5864,致和證,32,0,32,新光-高雄,2024-11-29,8562
2812,台中銀,38,8,30,新光-高雄,2024-11-29,8562
00902,中信電池及儲能,30,0,30,新光-高雄,2024-11-29,8562
00929,復華台灣科技優息,153,125,28,新光-高雄,2024-11-29,8562
1605,華新,56,29,27,新光-高雄,2024-11-29,8562
2882,國泰金,32,5,27,新光-高雄,2024-11-29,8562
2891,中信金,37,11,26,新光-高雄,2024-11-29,8562
5880,合庫金,25,1,24,新光-高雄,2024-11-29,8562
2392,正崴,89,66,23,新光-高雄,2024-11-29,8562
2834,臺企銀,24,2,22,新光-高雄,2024-11-29,8562
00930,永豐ESG低碳高息,23,1,22,新光-高雄,2024-11-29,8562
00950B,凱基A級公司債,52,30,22,新光-高雄,2024-11-29,8562
2353,宏��,21,0,21,新光-高雄,2024-11-29,8562
00673R,期元大S＆P原油反1,23,2,21,新光-高雄,2024-11-29,8562
2412,中華電,22,1,21,新光-高雄,2024-11-29,8562
00918,大華優利高填息30,26,5,21,新光-高雄,2024-11-29,8562
2881,富邦金,26,7,19,新光-高雄,2024-11-29,8562
3339,泰谷,21,2,19,新光-高雄,2024-11-29,8562
00631L,元大台灣50正2,44,27,17,新光-高雄,2024-11-29,8562
3234,光環,18,1,17,新光-高雄,2024-11-29,8562
00940,元大台灣價值高息,29,12,17,新光-高雄,2024-11-29,8562
00922,國泰台灣領袖50,18,2,16,新光-高雄,2024-11-29,8562
2615,萬海,71,56,15,新光-高雄,2024-11-29,8562
2618,長榮航,32,17,15,新光-高雄,2024-11-29,8562
006208,富邦台50,16,2,14,新光-高雄,2024-11-29,8562
2317,鴻海,48,34,14,新光-高雄,2024-11-29,8562
2905,三商,16,2,14,新光-高雄,2024-11-29,8562
1305,華夏,14,0,14,新光-高雄,2024-11-29,8562
1569,濱川,24,11,13,新光-高雄,2024-11-29,8562
00713,元大台灣高息低波,20,7,13,新光-高雄,2024-11-29,8562
2520,冠德,15,2,13,新光-高雄,2024-11-29,8562
2404,漢唐,16,4,12,新光-高雄,2024-11-29,8562
00959B,大華投等美債15Y+,451,31,420,新光-高雄,2024-12-02,8562
00669R,國泰美國道瓊反1,317,10,307,新光-高雄,2024-12-02,8562
1524,耿鼎,261,3,258,新光-高雄,2024-12-02,8562
00918,大華優利高填息30,249,35,214,新光-高雄,2024-12-02,8562
1815,富喬,235,111,124,新光-高雄,2024-12-02,8562
00953B,群益優選非投等債,81,0,81,新光-高雄,2024-12-02,8562
3450,聯鈞,144,66,78,新光-高雄,2024-12-02,8562
6285,啟��,77,4,73,新光-高雄,2024-12-02,8562
00715L,期街口布蘭特正2,97,34,63,新光-高雄,2024-12-02,8562
2317,鴻海,96,33,63,新光-高雄,2024-12-02,8562
1314,中石化,71,13,58,新光-高雄,2024-12-02,8562
2069,運錩,55,0,55,新光-高雄,2024-12-02,8562
2344,華邦電,63,9,54,新光-高雄,2024-12-02,8562
00915,凱基優選高股息30,71,18,53,新光-高雄,2024-12-02,8562
00637L,元大滬深300正2,118,66,52,新光-高雄,2024-12-02,8562
1217,愛之味,50,0,50,新光-高雄,2024-12-02,8562
2027,大成鋼,47,0,47,新光-高雄,2024-12-02,8562
3706,神達,312,275,37,新光-高雄,2024-12-02,8562
2408,南亞科,55,20,35,新光-高雄,2024-12-02,8562
00753L,中信中國50正2,131,97,34,新光-高雄,2024-12-02,8562
00932,兆豐永續高息等權,35,1,34,新光-高雄,2024-12-02,8562
2354,鴻準,99,66,33,新光-高雄,2024-12-02,8562
00882,中信中國高股息,35,2,33,新光-高雄,2024-12-02,8562
5880,合庫金,38,5,33,新光-高雄,2024-12-02,8562
00852L,國泰美國道瓊正2,31,0,31,新光-高雄,2024-12-02,8562
1305,華夏,30,0,30,新光-高雄,2024-12-02,8562
6859,伯特光,32,3,29,新光-高雄,2024-12-02,8562
4510,高鋒,125,97,28,新光-高雄,2024-12-02,8562
00945B,凱基美國非投等債,30,3,27,新光-高雄,2024-12-02,8562
2392,正崴,47,20,27,新光-高雄,2024-12-02,8562
2615,萬海,45,19,26,新光-高雄,2024-12-02,8562
2905,三商,28,2,26,新光-高雄,2024-12-02,8562
00878,國泰永續高股息,68,44,24,新光-高雄,2024-12-02,8562
2375,凱美,36,13,23,新光-高雄,2024-12-02,8562
4513,福裕,22,0,22,新光-高雄,2024-12-02,8562
4931,新盛力,37,15,22,新光-高雄,2024-12-02,8562
2892,第一金,23,1,22,新光-高雄,2024-12-02,8562
3162,精確,22,2,20,新光-高雄,2024-12-02,8562
1618,合機,20,0,20,新光-高雄,2024-12-02,8562
5488,松普,20,0,20,新光-高雄,2024-12-02,8562
6558,興能高,160,141,19,新光-高雄,2024-12-02,8562
5244,弘凱,41,23,18,新光-高雄,2024-12-02,8562
2812,台中銀,36,19,17,新光-高雄,2024-12-02,8562
1336,台翰,18,2,16,新光-高雄,2024-12-02,8562
2337,旺宏,27,13,14,新光-高雄,2024-12-02,8562
8404,百和興業-KY,27,13,14,新光-高雄,2024-12-02,8562
2886,兆豐金,15,2,13,新光-高雄,2024-12-02,8562
3031,佰鴻,13,0,13,新光-高雄,2024-12-02,8562
4956,光鋐,15,2,13,新光-高雄,2024-12-02,8562
2426,鼎元,15,3,12,新光-高雄,2024-12-02,8562
00919,群益台灣精選高息,649,188,461,新光-高雄,2024-12-03,8562
00671R,富邦NASDAQ反1,455,10,445,新光-高雄,2024-12-03,8562
00918,大華優利高填息30,292,26,266,新光-高雄,2024-12-03,8562
00953B,群益優選非投等債,364,101,263,新光-高雄,2024-12-03,8562
00715L,期街口布蘭特正2,273,10,263,新光-高雄,2024-12-03,8562
00706L,期元大S＆P日圓正2,201,0,201,新光-高雄,2024-12-03,8562
00965,元大航太防衛科技,210,10,200,新光-高雄,2024-12-03,8562
00878,國泰永續高股息,192,27,165,新光-高雄,2024-12-03,8562
00915,凱基優選高股息30,201,60,141,新光-高雄,2024-12-03,8562
1524,耿鼎,147,43,104,新光-高雄,2024-12-03,8562
6104,創惟,161,62,99,新光-高雄,2024-12-03,8562
2486,一詮,112,27,85,新光-高雄,2024-12-03,8562
5353,台林,64,7,57,新光-高雄,2024-12-03,8562
2646,星宇航空,65,12,53,新光-高雄,2024-12-03,8562
2317,鴻海,100,54,46,新光-高雄,2024-12-03,8562
00946,群益科技高息成長,49,3,46,新光-高雄,2024-12-03,8562
00642U,期元大S＆P石油,43,0,43,新光-高雄,2024-12-03,8562
00887,永豐中國科技50大,37,0,37,新光-高雄,2024-12-03,8562
5465,富驊,47,10,37,新光-高雄,2024-12-03,8562
4714,永捷,39,8,31,新光-高雄,2024-12-03,8562
00639,富邦深100,34,3,31,新光-高雄,2024-12-03,8562
00713,元大台灣高息低波,34,4,30,新光-高雄,2024-12-03,8562
9105,泰金寶-DR,207,178,29,新光-高雄,2024-12-03,8562
1536,和大,35,8,27,新光-高雄,2024-12-03,8562
1802,台玻,35,10,25,新光-高雄,2024-12-03,8562
1336,台翰,26,2,24,新光-高雄,2024-12-03,8562
2070,精湛,26,3,23,新光-高雄,2024-12-03,8562
5516,雙喜,21,0,21,新光-高雄,2024-12-03,8562
8171,天宇,22,1,21,新光-高雄,2024-12-03,8562
3209,全科,20,0,20,新光-高雄,2024-12-03,8562
2356,英業達,28,8,20,新光-高雄,2024-12-03,8562
6546,正基,31,11,20,新光-高雄,2024-12-03,8562
4968,立積,34,14,20,新光-高雄,2024-12-03,8562
2014,中鴻,23,4,19,新光-高雄,2024-12-03,8562
6757,台灣虎航,32,14,18,新光-高雄,2024-12-03,8562
3231,緯創,38,20,18,新光-高雄,2024-12-03,8562
6548,長科*,17,0,17,新光-高雄,2024-12-03,8562
3380,明泰,48,31,17,新光-高雄,2024-12-03,8562
2444,兆勁,18,2,16,新光-高雄,2024-12-03,8562
1308,亞聚,16,0,16,新光-高雄,2024-12-03,8562
4979,華星光,145,130,15,新光-高雄,2024-12-03,8562
00909,國泰數位支付服務,20,5,15,新光-高雄,2024-12-03,8562
2385,群光,15,0,15,新光-高雄,2024-12-03,8562
3045,台灣大,43,28,15,新光-高雄,2024-12-03,8562
00900,富邦特選高股息30,30,16,14,新光-高雄,2024-12-03,8562
5315,光聯,19,5,14,新光-高雄,2024-12-03,8562
2511,太子,14,0,14,新光-高雄,2024-12-03,8562
4904,遠傳,37,24,13,新光-高雄,2024-12-03,8562
1305,華夏,13,0,13,新光-高雄,2024-12-03,8562
4534,慶騰,22,9,13,新光-高雄,2024-12-03,8562
00669R,國泰美國道瓊反1,300,3,297,新光-高雄,2024-12-04,8562
00712,復華富時不動產,286,11,275,新光-高雄,2024-12-04,8562
00680L,元大美債20正2,216,13,203,新光-高雄,2024-12-04,8562
2610,華航,302,122,180,新光-高雄,2024-12-04,8562
3323,加百裕,317,137,180,新光-高雄,2024-12-04,8562
00639,富邦深100,184,7,177,新光-高雄,2024-12-04,8562
00688L,國泰20年美債正2,207,39,168,新光-高雄,2024-12-04,8562
3591,艾笛森,129,5,124,新光-高雄,2024-12-04,8562
2891,中信金,128,19,109,新光-高雄,2024-12-04,8562
00953B,群益優選非投等債,112,10,102,新光-高雄,2024-12-04,8562
2887,台新金,101,16,85,新光-高雄,2024-12-04,8562
9105,泰金寶-DR,627,544,83,新光-高雄,2024-12-04,8562
2834,臺企銀,81,2,79,新光-高雄,2024-12-04,8562
00673R,期元大S＆P原油反1,95,20,75,新光-高雄,2024-12-04,8562
00878,國泰永續高股息,105,32,73,新光-高雄,2024-12-04,8562
00650L,復華香港正2,80,12,68,新光-高雄,2024-12-04,8562
2382,廣達,70,2,68,新光-高雄,2024-12-04,8562
00919,群益台灣精選高息,161,100,61,新光-高雄,2024-12-04,8562
00907,永豐優息存股,61,1,60,新光-高雄,2024-12-04,8562
00665L,富邦�琤肭磪囓�2,70,10,60,新光-高雄,2024-12-04,8562
3078,僑威,63,4,59,新光-高雄,2024-12-04,8562
5443,均豪,55,1,54,新光-高雄,2024-12-04,8562
00918,大華優利高填息30,190,136,54,新光-高雄,2024-12-04,8562
00948B,中信優息投資級債,57,3,54,新光-高雄,2024-12-04,8562
00933B,國泰10Y+金融債,64,10,54,新光-高雄,2024-12-04,8562
00900,富邦特選高股息30,45,0,45,新光-高雄,2024-12-04,8562
00687B,國泰20年美債,106,62,44,新光-高雄,2024-12-04,8562
1595,川寶,61,19,42,新光-高雄,2024-12-04,8562
8176,智捷,41,0,41,新光-高雄,2024-12-04,8562
00720B,元大投資級公司債,79,41,38,新光-高雄,2024-12-04,8562
00931B,統一美債20年,36,0,36,新光-高雄,2024-12-04,8562
5236,凌陽創新,36,0,36,新光-高雄,2024-12-04,8562
2457,飛宏,35,3,32,新光-高雄,2024-12-04,8562
00713,元大台灣高息低波,29,0,29,新光-高雄,2024-12-04,8562
1605,華新,27,0,27,新光-高雄,2024-12-04,8562
6190,萬泰科,25,0,25,新光-高雄,2024-12-04,8562
5371,中光電,29,4,25,新光-高雄,2024-12-04,8562
9946,三發地產,22,0,22,新光-高雄,2024-12-04,8562
3605,宏致,21,0,21,新光-高雄,2024-12-04,8562
4968,立積,53,33,20,新光-高雄,2024-12-04,8562
4714,永捷,23,3,20,新光-高雄,2024-12-04,8562
00679B,元大美債20年,83,63,20,新光-高雄,2024-12-04,8562
3163,波若威,29,10,19,新光-高雄,2024-12-04,8562
1449,佳和,17,0,17,新光-高雄,2024-12-04,8562
2303,聯電,73,56,17,新光-高雄,2024-12-04,8562
00751B,元大AAA至A公司債,17,1,16,新光-高雄,2024-12-04,8562
6668,中揚光,18,2,16,新光-高雄,2024-12-04,8562
8104,錸寶,75,59,16,新光-高雄,2024-12-04,8562
1569,濱川,23,7,16,新光-高雄,2024-12-04,8562
2615,萬海,43,27,16,新光-高雄,2024-12-04,8562
00712,復華富時不動產,685,5,680,新光-高雄,2024-12-05,8562
00937B,群益ESG投等債20,1124,524,600,新光-高雄,2024-12-05,8562
00715L,期街口布蘭特正2,322,1,321,新光-高雄,2024-12-05,8562
00953B,群益優選非投等債,273,0,273,新光-高雄,2024-12-05,8562
2354,鴻準,440,238,202,新光-高雄,2024-12-05,8562
2317,鴻海,219,34,185,新光-高雄,2024-12-05,8562
2027,大成鋼,150,2,148,新光-高雄,2024-12-05,8562
1815,富喬,575,446,129,新光-高雄,2024-12-05,8562
00918,大華優利高填息30,129,5,124,新光-高雄,2024-12-05,8562
00637L,元大滬深300正2,244,134,110,新光-高雄,2024-12-05,8562
3062,建漢,141,45,96,新光-高雄,2024-12-05,8562
3706,神達,282,210,72,新光-高雄,2024-12-05,8562
2609,陽明,80,11,69,新光-高雄,2024-12-05,8562
00713,元大台灣高息低波,51,0,51,新光-高雄,2024-12-05,8562
00887,永豐中國科技50大,51,0,51,新光-高雄,2024-12-05,8562
3090,日電貿,229,181,48,新光-高雄,2024-12-05,8562
8104,錸寶,53,7,46,新光-高雄,2024-12-05,8562
4908,前鼎,108,63,45,新光-高雄,2024-12-05,8562
2838,聯邦銀,43,0,43,新光-高雄,2024-12-05,8562
2303,聯電,62,20,42,新光-高雄,2024-12-05,8562
6603,富強鑫,48,6,42,新光-高雄,2024-12-05,8562
1721,三晃,83,46,37,新光-高雄,2024-12-05,8562
00665L,富邦�琤肭磪囓�2,34,0,34,新光-高雄,2024-12-05,8562
2023,燁輝,32,0,32,新光-高雄,2024-12-05,8562
2834,臺企銀,33,4,29,新光-高雄,2024-12-05,8562
3548,兆利,50,23,27,新光-高雄,2024-12-05,8562
2344,華邦電,37,10,27,新光-高雄,2024-12-05,8562
00680L,元大美債20正2,210,183,27,新光-高雄,2024-12-05,8562
00681R,元大美債20反1,26,0,26,新光-高雄,2024-12-05,8562
3317,尼克森,28,2,26,新光-高雄,2024-12-05,8562
3494,誠研,25,0,25,新光-高雄,2024-12-05,8562
8171,天宇,25,1,24,新光-高雄,2024-12-05,8562
4931,新盛力,110,87,23,新光-高雄,2024-12-05,8562
3481,群創,28,5,23,新光-高雄,2024-12-05,8562
3078,僑威,34,12,22,新光-高雄,2024-12-05,8562
5443,均豪,23,2,21,新光-高雄,2024-12-05,8562
2371,大同,53,32,21,新光-高雄,2024-12-05,8562
2615,萬海,51,30,21,新光-高雄,2024-12-05,8562
1447,力鵬,21,0,21,新光-高雄,2024-12-05,8562
00930,永豐ESG低碳高息,21,0,21,新光-高雄,2024-12-05,8562
3003,健和興,26,6,20,新光-高雄,2024-12-05,8562
3105,穩懋,20,0,20,新光-高雄,2024-12-05,8562
2243,宏旭-KY,20,0,20,新光-高雄,2024-12-05,8562
3625,西勝,29,9,20,新光-高雄,2024-12-05,8562
2501,國建,20,0,20,新光-高雄,2024-12-05,8562
6505,台塑化,20,0,20,新光-高雄,2024-12-05,8562
1524,耿鼎,50,31,19,新光-高雄,2024-12-05,8562
2929,淘帝-KY,27,8,19,新光-高雄,2024-12-05,8562
1718,中纖,19,0,19,新光-高雄,2024-12-05,8562
00915,凱基優選高股息30,23,4,19,新光-高雄,2024-12-05,8562
00712,復華富時不動產,1656,0,1656,新光-高雄,2024-12-06,8562
2610,華航,497,78,419,新光-高雄,2024-12-06,8562
00671R,富邦NASDAQ反1,337,35,302,新光-高雄,2024-12-06,8562
2542,興富發,222,16,206,新光-高雄,2024-12-06,8562
00676R,富邦臺灣加權反1,200,0,200,新光-高雄,2024-12-06,8562
00896,中信綠能及電動車,142,0,142,新光-高雄,2024-12-06,8562
00715L,期街口布蘭特正2,188,70,118,新光-高雄,2024-12-06,8562
00639,富邦深100,113,0,113,新光-高雄,2024-12-06,8562
9105,泰金寶-DR,133,22,111,新光-高雄,2024-12-06,8562
00719B,元大美債1-3,100,0,100,新光-高雄,2024-12-06,8562
00918,大華優利高填息30,142,45,97,新光-高雄,2024-12-06,8562
6139,亞翔,115,18,97,新光-高雄,2024-12-06,8562
00953B,群益優選非投等債,94,0,94,新光-高雄,2024-12-06,8562
00962,台新AI優息動能,74,0,74,新光-高雄,2024-12-06,8562
00919,群益台灣精選高息,173,110,63,新光-高雄,2024-12-06,8562
00933B,國泰10Y+金融債,52,0,52,新光-高雄,2024-12-06,8562
2352,佳世達,46,2,44,新光-高雄,2024-12-06,8562
00642U,期元大S＆P石油,40,0,40,新光-高雄,2024-12-06,8562
00633L,富邦上証正2,37,3,34,新光-高雄,2024-12-06,8562
8027,鈦昇,34,0,34,新光-高雄,2024-12-06,8562
4128,中天,42,12,30,新光-高雄,2024-12-06,8562
1802,台玻,29,0,29,新光-高雄,2024-12-06,8562
2375,凱美,38,10,28,新光-高雄,2024-12-06,8562
2399,映泰,82,54,28,新光-高雄,2024-12-06,8562
2356,英業達,32,4,28,新光-高雄,2024-12-06,8562
2838,聯邦銀,28,0,28,新光-高雄,2024-12-06,8562
5465,富驊,53,27,26,新光-高雄,2024-12-06,8562
3003,健和興,30,5,25,新光-高雄,2024-12-06,8562
8097,常珵,42,17,25,新光-高雄,2024-12-06,8562
2303,聯電,54,29,25,新光-高雄,2024-12-06,8562
00909,國泰數位支付服務,27,3,24,新光-高雄,2024-12-06,8562
006208,富邦台50,28,4,24,新光-高雄,2024-12-06,8562
1815,富喬,190,166,24,新光-高雄,2024-12-06,8562
4919,新唐,89,66,23,新光-高雄,2024-12-06,8562
4743,合一,73,50,23,新光-高雄,2024-12-06,8562
2204,中華,25,2,23,新光-高雄,2024-12-06,8562
00938,凱基優選30,26,4,22,新光-高雄,2024-12-06,8562
1609,大亞,24,4,20,新光-高雄,2024-12-06,8562
2882,國泰金,23,3,20,新光-高雄,2024-12-06,8562
00954,中信日本半導體,20,0,20,新光-高雄,2024-12-06,8562
1336,台翰,21,1,20,新光-高雄,2024-12-06,8562
3019,亞光,24,5,19,新光-高雄,2024-12-06,8562
2888,新光金,30,12,18,新光-高雄,2024-12-06,8562
2867,三商壽,18,0,18,新光-高雄,2024-12-06,8562
8054,安國,25,8,17,新光-高雄,2024-12-06,8562
6191,精成科,17,1,16,新光-高雄,2024-12-06,8562
8069,元太,17,2,15,新光-高雄,2024-12-06,8562
6142,友勁,15,0,15,新光-高雄,2024-12-06,8562
5388,中磊,15,0,15,新光-高雄,2024-12-06,8562
8111,立��,54,39,15,新光-高雄,2024-12-06,8562
00715L,期街口布蘭特正2,651,0,651,新光-高雄,2024-12-09,8562
1524,耿鼎,256,35,221,新光-高雄,2024-12-09,8562
00896,中信綠能及電動車,215,1,214,新光-高雄,2024-12-09,8562
0056,元大高股息,184,15,169,新光-高雄,2024-12-09,8562
2812,台中銀,160,10,150,新光-高雄,2024-12-09,8562
00953B,群益優選非投等債,149,1,148,新光-高雄,2024-12-09,8562
2838,聯邦銀,138,0,138,新光-高雄,2024-12-09,8562
00878,國泰永續高股息,169,33,136,新光-高雄,2024-12-09,8562
2344,華邦電,101,5,96,新光-高雄,2024-12-09,8562
00933B,國泰10Y+金融債,81,1,80,新光-高雄,2024-12-09,8562
00918,大華優利高填息30,121,56,65,新光-高雄,2024-12-09,8562
5465,富驊,77,13,64,新光-高雄,2024-12-09,8562
00713,元大台灣高息低波,76,13,63,新光-高雄,2024-12-09,8562
2890,永豐金,60,2,58,新光-高雄,2024-12-09,8562
2399,映泰,143,90,53,新光-高雄,2024-12-09,8562
6133,金橋,51,1,50,新光-高雄,2024-12-09,8562
00945B,凱基美國非投等債,50,1,49,新光-高雄,2024-12-09,8562
2801,彰銀,57,16,41,新光-高雄,2024-12-09,8562
2002,中鋼,45,4,41,新光-高雄,2024-12-09,8562
00954,中信日本半導體,40,0,40,新光-高雄,2024-12-09,8562
2834,臺企銀,40,2,38,新光-高雄,2024-12-09,8562
2383,台光電,49,15,34,新光-高雄,2024-12-09,8562
3481,群創,35,1,34,新光-高雄,2024-12-09,8562
3029,零壹,165,133,32,新光-高雄,2024-12-09,8562
00676R,富邦臺灣加權反1,31,0,31,新光-高雄,2024-12-09,8562
2845,遠東銀,31,0,31,新光-高雄,2024-12-09,8562
1305,華夏,31,1,30,新光-高雄,2024-12-09,8562
00639,富邦深100,30,0,30,新光-高雄,2024-12-09,8562
2449,京元電子,33,4,29,新光-高雄,2024-12-09,8562
00891,中信關鍵半導體,28,0,28,新光-高雄,2024-12-09,8562
4977,眾達-KY,105,78,27,新光-高雄,2024-12-09,8562
00932,兆豐永續高息等權,26,0,26,新光-高雄,2024-12-09,8562
00690,兆豐藍籌30,26,0,26,新光-高雄,2024-12-09,8562
3702A,大聯大甲特,26,0,26,新光-高雄,2024-12-09,8562
2317,鴻海,51,26,25,新光-高雄,2024-12-09,8562
6186,新潤,25,0,25,新光-高雄,2024-12-09,8562
00731,復華富時高息低波,25,0,25,新光-高雄,2024-12-09,8562
00665L,富邦�琤肭磪囓�2,48,24,24,新光-高雄,2024-12-09,8562
5244,弘凱,26,2,24,新光-高雄,2024-12-09,8562
4912,聯德控股-KY,25,1,24,新光-高雄,2024-12-09,8562
00905,FT臺灣Smart,27,4,23,新光-高雄,2024-12-09,8562
3450,聯鈞,90,67,23,新光-高雄,2024-12-09,8562
00962,台新AI優息動能,22,0,22,新光-高雄,2024-12-09,8562
2867,三商壽,46,24,22,新光-高雄,2024-12-09,8562
2498,宏達電,23,1,22,新光-高雄,2024-12-09,8562
6177,達麗,21,0,21,新光-高雄,2024-12-09,8562
5202,力新,65,44,21,新光-高雄,2024-12-09,8562
3548,兆利,32,11,21,新光-高雄,2024-12-09,8562
00927,群益半導體收益,21,0,21,新光-高雄,2024-12-09,8562
8011,台通,19,2,17,新光-高雄,2024-12-09,8562
00753L,中信中國50正2,753,194,559,新光-高雄,2024-12-10,8562
00918,大華優利高填息30,324,38,286,新光-高雄,2024-12-10,8562
00680L,元大美債20正2,226,14,212,新光-高雄,2024-12-10,8562
00688L,國泰20年美債正2,200,30,170,新光-高雄,2024-12-10,8562
2880,華南金,154,2,152,新光-高雄,2024-12-10,8562
00633L,富邦上証正2,144,17,127,新光-高雄,2024-12-10,8562
3706,神達,490,366,124,新光-高雄,2024-12-10,8562
3481,群創,146,31,115,新光-高雄,2024-12-10,8562
00919,群益台灣精選高息,115,13,102,新光-高雄,2024-12-10,8562
00639,富邦深100,112,17,95,新光-高雄,2024-12-10,8562
00948B,中信優息投資級債,100,7,93,新光-高雄,2024-12-10,8562
2609,陽明,243,154,89,新光-高雄,2024-12-10,8562
0056,元大高股息,193,106,87,新光-高雄,2024-12-10,8562
2845,遠東銀,85,0,85,新光-高雄,2024-12-10,8562
9105,泰金寶-DR,90,12,78,新光-高雄,2024-12-10,8562
2317,鴻海,94,32,62,新光-高雄,2024-12-10,8562
2547,日勝生,98,41,57,新光-高雄,2024-12-10,8562
00687B,國泰20年美債,79,31,48,新光-高雄,2024-12-10,8562
00937B,群益ESG投等債20,46,3,43,新光-高雄,2024-12-10,8562
2353,宏��,56,23,33,新光-高雄,2024-12-10,8562
4909,新復興,45,12,33,新光-高雄,2024-12-10,8562
2646,星宇航空,32,0,32,新光-高雄,2024-12-10,8562
1312,國喬,40,10,30,新光-高雄,2024-12-10,8562
3234,光環,31,1,30,新光-高雄,2024-12-10,8562
6112,邁達特,37,9,28,新光-高雄,2024-12-10,8562
00878,國泰永續高股息,46,18,28,新光-高雄,2024-12-10,8562
2362,藍天,44,17,27,新光-高雄,2024-12-10,8562
1446,宏和,33,7,26,新光-高雄,2024-12-10,8562
00895,富邦未來車,25,0,25,新光-高雄,2024-12-10,8562
4979,華星光,73,48,25,新光-高雄,2024-12-10,8562
00959B,大華投等美債15Y+,27,3,24,新光-高雄,2024-12-10,8562
2330,台積電,38,15,23,新光-高雄,2024-12-10,8562
2603,長榮,36,14,22,新光-高雄,2024-12-10,8562
00706L,期元大S＆P日圓正2,22,0,22,新光-高雄,2024-12-10,8562
00719B,元大美債1-3,22,0,22,新光-高雄,2024-12-10,8562
2891,中信金,29,7,22,新光-高雄,2024-12-10,8562
00909,國泰數位支付服務,28,7,21,新光-高雄,2024-12-10,8562
00770,國泰北美科技,20,0,20,新光-高雄,2024-12-10,8562
00896,中信綠能及電動車,24,4,20,新光-高雄,2024-12-10,8562
4991,環宇-KY,33,13,20,新光-高雄,2024-12-10,8562
3511,矽瑪,24,4,20,新光-高雄,2024-12-10,8562
6133,金橋,20,0,20,新光-高雄,2024-12-10,8562
1524,耿鼎,263,244,19,新光-高雄,2024-12-10,8562
00946,群益科技高息成長,25,6,19,新光-高雄,2024-12-10,8562
1101,台泥,28,9,19,新光-高雄,2024-12-10,8562
1314,中石化,73,54,19,新光-高雄,2024-12-10,8562
3015,全漢,22,3,19,新光-高雄,2024-12-10,8562
3019,亞光,40,21,19,新光-高雄,2024-12-10,8562
00922,國泰台灣領袖50,25,7,18,新光-高雄,2024-12-10,8562
2354,鴻準,71,53,18,新光-高雄,2024-12-10,8562
00919,群益台灣精選高息,1270,30,1240,新光-高雄,2024-12-11,8562
00918,大華優利高填息30,471,2,469,新光-高雄,2024-12-11,8562
00753L,中信中國50正2,469,160,309,新光-高雄,2024-12-11,8562
2609,陽明,340,94,246,新光-高雄,2024-12-11,8562
00953B,群益優選非投等債,237,0,237,新光-高雄,2024-12-11,8562
00680L,元大美債20正2,202,16,186,新光-高雄,2024-12-11,8562
00688L,國泰20年美債正2,134,0,134,新光-高雄,2024-12-11,8562
00637L,元大滬深300正2,684,574,110,新光-高雄,2024-12-11,8562
0056,元大高股息,102,4,98,新光-高雄,2024-12-11,8562
1101,台泥,99,6,93,新光-高雄,2024-12-11,8562
00878,國泰永續高股息,86,4,82,新光-高雄,2024-12-11,8562
2601,益航,73,0,73,新光-高雄,2024-12-11,8562
00713,元大台灣高息低波,72,0,72,新光-高雄,2024-12-11,8562
4414,如興,70,0,70,新光-高雄,2024-12-11,8562
00915,凱基優選高股息30,62,0,62,新光-高雄,2024-12-11,8562
2610,華航,131,71,60,新光-高雄,2024-12-11,8562
1447,力鵬,58,0,58,新光-高雄,2024-12-11,8562
2409,友達,96,40,56,新光-高雄,2024-12-11,8562
00675L,富邦臺灣加權正2,65,10,55,新光-高雄,2024-12-11,8562
2867,三商壽,54,0,54,新光-高雄,2024-12-11,8562
00687B,國泰20年美債,63,9,54,新光-高雄,2024-12-11,8562
2106,建大,52,0,52,新光-高雄,2024-12-11,8562
2002,中鋼,51,1,50,新光-高雄,2024-12-11,8562
2855,統一證,48,0,48,新光-高雄,2024-12-11,8562
2886,兆豐金,45,1,44,新光-高雄,2024-12-11,8562
00665L,富邦�琤肭磪囓�2,63,21,42,新光-高雄,2024-12-11,8562
2401,凌陽,51,10,41,新光-高雄,2024-12-11,8562
6770,力積電,40,0,40,新光-高雄,2024-12-11,8562
1305,華夏,41,1,40,新光-高雄,2024-12-11,8562
1612,宏泰,40,0,40,新光-高雄,2024-12-11,8562
2027,大成鋼,45,9,36,新光-高雄,2024-12-11,8562
00937B,群益ESG投等債20,34,0,34,新光-高雄,2024-12-11,8562
2405,輔信,34,0,34,新光-高雄,2024-12-11,8562
00950B,凱基A級公司債,30,0,30,新光-高雄,2024-12-11,8562
2324,仁寶,33,3,30,新光-高雄,2024-12-11,8562
1802,台玻,41,13,28,新光-高雄,2024-12-11,8562
00900,富邦特選高股息30,26,0,26,新光-高雄,2024-12-11,8562
2402,毅嘉,29,3,26,新光-高雄,2024-12-11,8562
2303,聯電,88,63,25,新光-高雄,2024-12-11,8562
00903,富邦元宇宙,26,1,25,新光-高雄,2024-12-11,8562
5465,富驊,37,13,24,新光-高雄,2024-12-11,8562
2442,新美齊,23,0,23,新光-高雄,2024-12-11,8562
1220,台榮,26,3,23,新光-高雄,2024-12-11,8562
1301,台塑,30,8,22,新光-高雄,2024-12-11,8562
00650L,復華香港正2,22,0,22,新光-高雄,2024-12-11,8562
3296,勝德,45,23,22,新光-高雄,2024-12-11,8562
00725B,國泰投資級公司債,21,0,21,新光-高雄,2024-12-11,8562
6548,長科*,21,0,21,新光-高雄,2024-12-11,8562
2851,中再保,20,0,20,新光-高雄,2024-12-11,8562
3189,景碩,41,21,20,新光-高雄,2024-12-11,8562
2618,長榮航,981,394,587,新光-高雄,2024-12-12,8562
00687B,國泰20年美債,579,13,566,新光-高雄,2024-12-12,8562
00953B,群益優選非投等債,377,0,377,新光-高雄,2024-12-12,8562
00673R,期元大S＆P原油反1,362,0,362,新光-高雄,2024-12-12,8562
2312,金寶,435,81,354,新光-高雄,2024-12-12,8562
00680L,元大美債20正2,368,17,351,新光-高雄,2024-12-12,8562
00671R,富邦NASDAQ反1,290,50,240,新光-高雄,2024-12-12,8562
2317,鴻海,208,29,179,新光-高雄,2024-12-12,8562
00679B,元大美債20年,164,0,164,新光-高雄,2024-12-12,8562
00937B,群益ESG投等債20,220,63,157,新光-高雄,2024-12-12,8562
00665L,富邦�琤肭磪囓�2,196,64,132,新光-高雄,2024-12-12,8562
2515,中工,116,0,116,新光-高雄,2024-12-12,8562
00918,大華優利高填息30,115,14,101,新光-高雄,2024-12-12,8562
00719B,元大美債1-3,82,0,82,新光-高雄,2024-12-12,8562
4908,前鼎,94,19,75,新光-高雄,2024-12-12,8562
3706,神達,364,289,75,新光-高雄,2024-12-12,8562
1301,台塑,94,22,72,新光-高雄,2024-12-12,8562
2887,台新金,76,5,71,新光-高雄,2024-12-12,8562
2867,三商壽,67,0,67,新光-高雄,2024-12-12,8562
00764B,群益25年美債,59,0,59,新光-高雄,2024-12-12,8562
00688L,國泰20年美債正2,54,0,54,新光-高雄,2024-12-12,8562
2002,中鋼,56,2,54,新光-高雄,2024-12-12,8562
1447,力鵬,39,0,39,新光-高雄,2024-12-12,8562
2888,新光金,70,33,37,新光-高雄,2024-12-12,8562
1595,川寶,78,46,32,新光-高雄,2024-12-12,8562
00795B,中信美國公債20年,32,0,32,新光-高雄,2024-12-12,8562
00915,凱基優選高股息30,35,4,31,新光-高雄,2024-12-12,8562
00950B,凱基A級公司債,31,0,31,新光-高雄,2024-12-12,8562
6133,金橋,42,12,30,新光-高雄,2024-12-12,8562
1326,台化,46,19,27,新光-高雄,2024-12-12,8562
2324,仁寶,25,0,25,新光-高雄,2024-12-12,8562
3013,晟銘電,74,49,25,新光-高雄,2024-12-12,8562
8054,安國,34,10,24,新光-高雄,2024-12-12,8562
2107,厚生,28,4,24,新光-高雄,2024-12-12,8562
2303,聯電,102,79,23,新光-高雄,2024-12-12,8562
5340,建榮,23,0,23,新光-高雄,2024-12-12,8562
3019,亞光,80,59,21,新光-高雄,2024-12-12,8562
4977,眾達-KY,63,42,21,新光-高雄,2024-12-12,8562
6170,統振,21,0,21,新光-高雄,2024-12-12,8562
1569,濱川,27,7,20,新光-高雄,2024-12-12,8562
00650L,復華香港正2,30,10,20,新光-高雄,2024-12-12,8562
2328,廣宇,63,43,20,新光-高雄,2024-12-12,8562
8131,福懋科,20,0,20,新光-高雄,2024-12-12,8562
4909,新復興,32,12,20,新光-高雄,2024-12-12,8562
2615,萬海,65,45,20,新光-高雄,2024-12-12,8562
1815,富喬,246,227,19,新光-高雄,2024-12-12,8562
2382,廣達,25,6,19,新光-高雄,2024-12-12,8562
00930,永豐ESG低碳高息,19,2,17,新光-高雄,2024-12-12,8562
6005,群益證,20,2,18,新光-高雄,2024-12-12,8562
2344,華邦電,38,21,17,新光-高雄,2024-12-12,8562
2610,華航,748,69,679,新光-高雄,2024-12-13,8562
00937B,群益ESG投等債20,502,3,499,新光-高雄,2024-12-13,8562
00637L,元大滬深300正2,738,257,481,新光-高雄,2024-12-13,8562
00918,大華優利高填息30,329,47,282,新光-高雄,2024-12-13,8562
00753L,中信中國50正2,416,161,255,新光-高雄,2024-12-13,8562
00919,群益台灣精選高息,236,17,219,新光-高雄,2024-12-13,8562
1785,光洋科,233,64,169,新光-高雄,2024-12-13,8562
2498,宏達電,159,0,159,新光-高雄,2024-12-13,8562
00665L,富邦�琤肭磪囓�2,209,50,159,新光-高雄,2024-12-13,8562
00680L,元大美債20正2,163,13,150,新光-高雄,2024-12-13,8562
00687B,國泰20年美債,227,80,147,新光-高雄,2024-12-13,8562
2867,三商壽,144,4,140,新光-高雄,2024-12-13,8562
0056,元大高股息,165,26,139,新光-高雄,2024-12-13,8562
00878,國泰永續高股息,166,27,139,新光-高雄,2024-12-13,8562
2353,宏��,149,23,126,新光-高雄,2024-12-13,8562
00915,凱基優選高股息30,123,0,123,新光-高雄,2024-12-13,8562
00688L,國泰20年美債正2,135,15,120,新光-高雄,2024-12-13,8562
00926,凱基全球菁英55,111,4,107,新光-高雄,2024-12-13,8562
00679B,元大美債20年,99,3,96,新光-高雄,2024-12-13,8562
00940,元大台灣價值高息,95,21,74,新光-高雄,2024-12-13,8562
2317,鴻海,98,27,71,新光-高雄,2024-12-13,8562
00751B,元大AAA至A公司債,59,0,59,新光-高雄,2024-12-13,8562
00671R,富邦NASDAQ反1,50,0,50,新光-高雄,2024-12-13,8562
2313,華通,98,50,48,新光-高雄,2024-12-13,8562
6182,合晶,55,7,48,新光-高雄,2024-12-13,8562
5398,慕康生醫,47,0,47,新光-高雄,2024-12-13,8562
2356,英業達,48,1,47,新光-高雄,2024-12-13,8562
00929,復華台灣科技優息,125,79,46,新光-高雄,2024-12-13,8562
3231,緯創,52,8,44,新光-高雄,2024-12-13,8562
2615,萬海,86,43,43,新光-高雄,2024-12-13,8562
5907,大洋-KY,42,0,42,新光-高雄,2024-12-13,8562
00931B,統一美債20年,45,4,41,新光-高雄,2024-12-13,8562
2002,中鋼,45,4,41,新光-高雄,2024-12-13,8562
2303,聯電,178,137,41,新光-高雄,2024-12-13,8562
1109,信大,40,0,40,新光-高雄,2024-12-13,8562
4576,大銀微系統,59,20,39,新光-高雄,2024-12-13,8562
1447,力鵬,36,0,36,新光-高雄,2024-12-13,8562
6177,達麗,36,0,36,新光-高雄,2024-12-13,8562
1605,華新,50,15,35,新光-高雄,2024-12-13,8562
3481,群創,42,8,34,新光-高雄,2024-12-13,8562
00959B,大華投等美債15Y+,33,0,33,新光-高雄,2024-12-13,8562
2613,中櫃,38,7,31,新光-高雄,2024-12-13,8562
1409,新纖,35,5,30,新光-高雄,2024-12-13,8562
2887,台新金,29,0,29,新光-高雄,2024-12-13,8562
2324,仁寶,30,2,28,新光-高雄,2024-12-13,8562
6244,茂迪,28,0,28,新光-高雄,2024-12-13,8562
00932,兆豐永續高息等權,31,5,26,新光-高雄,2024-12-13,8562
00673R,期元大S＆P原油反1,26,0,26,新光-高雄,2024-12-13,8562
1314,中石化,53,28,25,新光-高雄,2024-12-13,8562
00948B,中信優息投資級債,27,2,25,新光-高雄,2024-12-13,8562
00937B,群益ESG投等債20,647,10,637,新光-高雄,2024-12-16,8562
00918,大華優利高填息30,572,76,496,新光-高雄,2024-12-16,8562
2303,聯電,595,156,439,新光-高雄,2024-12-16,8562
00919,群益台灣精選高息,451,75,376,新光-高雄,2024-12-16,8562
2610,華航,349,62,287,新光-高雄,2024-12-16,8562
00948B,中信優息投資級債,247,0,247,新光-高雄,2024-12-16,8562
0056,元大高股息,202,29,173,新光-高雄,2024-12-16,8562
00687B,國泰20年美債,212,43,169,新光-高雄,2024-12-16,8562
00637L,元大滬深300正2,169,7,162,新光-高雄,2024-12-16,8562
2609,陽明,227,77,150,新光-高雄,2024-12-16,8562
00933B,國泰10Y+金融債,134,0,134,新光-高雄,2024-12-16,8562
00940,元大台灣價值高息,152,22,130,新光-高雄,2024-12-16,8562
2409,友達,130,7,123,新光-高雄,2024-12-16,8562
2106,建大,122,0,122,新光-高雄,2024-12-16,8562
00795B,中信美國公債20年,121,0,121,新光-高雄,2024-12-16,8562
00680L,元大美債20正2,126,30,96,新光-高雄,2024-12-16,8562
2002,中鋼,95,6,89,新光-高雄,2024-12-16,8562
3234,光環,119,31,88,新光-高雄,2024-12-16,8562
00752,中信中國50,80,0,80,新光-高雄,2024-12-16,8562
00706L,期元大S＆P日圓正2,66,0,66,新光-高雄,2024-12-16,8562
00688L,國泰20年美債正2,87,25,62,新光-高雄,2024-12-16,8562
6603,富強鑫,61,0,61,新光-高雄,2024-12-16,8562
00671R,富邦NASDAQ反1,58,0,58,新光-高雄,2024-12-16,8562
00946,群益科技高息成長,56,0,56,新光-高雄,2024-12-16,8562
2449,京元電子,71,15,56,新光-高雄,2024-12-16,8562
00878,國泰永續高股息,98,50,48,新光-高雄,2024-12-16,8562
4977,眾達-KY,94,49,45,新光-高雄,2024-12-16,8562
00679B,元大美債20年,68,23,45,新光-高雄,2024-12-16,8562
00673R,期元大S＆P原油反1,89,45,44,新光-高雄,2024-12-16,8562
00764B,群益25年美債,43,1,42,新光-高雄,2024-12-16,8562
2328,廣宇,53,12,41,新光-高雄,2024-12-16,8562
2486,一詮,57,20,37,新光-高雄,2024-12-16,8562
00751B,元大AAA至A公司債,35,0,35,新光-高雄,2024-12-16,8562
2867,三商壽,43,11,32,新光-高雄,2024-12-16,8562
2455,全新,39,7,32,新光-高雄,2024-12-16,8562
1717,長興,27,0,27,新光-高雄,2024-12-16,8562
2402,毅嘉,31,4,27,新光-高雄,2024-12-16,8562
4979,華星光,65,39,26,新光-高雄,2024-12-16,8562
8069,元太,29,3,26,新光-高雄,2024-12-16,8562
00753L,中信中國50正2,168,144,24,新光-高雄,2024-12-16,8562
1409,新纖,26,2,24,新光-高雄,2024-12-16,8562
3017,奇鋐,27,3,24,新光-高雄,2024-12-16,8562
00926,凱基全球菁英55,24,1,23,新光-高雄,2024-12-16,8562
00665L,富邦�琤肭磪囓�2,37,14,23,新光-高雄,2024-12-16,8562
00712,復華富時不動產,34,14,20,新光-高雄,2024-12-16,8562
00932,兆豐永續高息等權,20,0,20,新光-高雄,2024-12-16,8562
00909,國泰數位支付服務,22,2,20,新光-高雄,2024-12-16,8562
00725B,國泰投資級公司債,19,0,19,新光-高雄,2024-12-16,8562
2354,鴻準,45,27,18,新光-高雄,2024-12-16,8562
3520,華盈,17,0,17,新光-高雄,2024-12-16,8562
00953B,群益優選非投等債,656,0,656,新光-高雄,2024-12-17,8562
00687B,國泰20年美債,343,9,334,新光-高雄,2024-12-17,8562
00933B,國泰10Y+金融債,219,0,219,新光-高雄,2024-12-17,8562
00937B,群益ESG投等債20,211,0,211,新光-高雄,2024-12-17,8562
00679B,元大美債20年,191,1,190,新光-高雄,2024-12-17,8562
00915,凱基優選高股息30,166,3,163,新光-高雄,2024-12-17,8562
00713,元大台灣高息低波,181,30,151,新光-高雄,2024-12-17,8562
2609,陽明,207,66,141,新光-高雄,2024-12-17,8562
3481,群創,133,16,117,新光-高雄,2024-12-17,8562
00795B,中信美國公債20年,103,0,103,新光-高雄,2024-12-17,8562
0056,元大高股息,96,6,90,新光-高雄,2024-12-17,8562
2317,鴻海,131,41,90,新光-高雄,2024-12-17,8562
2883,凱基金,95,22,73,新光-高雄,2024-12-17,8562
6285,啟��,70,2,68,新光-高雄,2024-12-17,8562
5880,合庫金,67,0,67,新光-高雄,2024-12-17,8562
00942B,台新美A公司債20+,60,0,60,新光-高雄,2024-12-17,8562
2834,臺企銀,60,0,60,新光-高雄,2024-12-17,8562
2303,聯電,156,98,58,新光-高雄,2024-12-17,8562
00665L,富邦�琤肭磪囓�2,105,48,57,新光-高雄,2024-12-17,8562
00948B,中信優息投資級債,55,0,55,新光-高雄,2024-12-17,8562
2359,所羅門,122,67,55,新光-高雄,2024-12-17,8562
2887,台新金,85,34,51,新光-高雄,2024-12-17,8562
2312,金寶,83,32,51,新光-高雄,2024-12-17,8562
00688L,國泰20年美債正2,47,0,47,新光-高雄,2024-12-17,8562
3059,華晶科,47,7,40,新光-高雄,2024-12-17,8562
00712,復華富時不動產,82,42,40,新光-高雄,2024-12-17,8562
00857B,永豐20年美公債,35,0,35,新光-高雄,2024-12-17,8562
00926,凱基全球菁英55,34,3,31,新光-高雄,2024-12-17,8562
9921,巨大,34,4,30,新光-高雄,2024-12-17,8562
2374,佳能,349,323,26,新光-高雄,2024-12-17,8562
2855,統一證,26,0,26,新光-高雄,2024-12-17,8562
00751B,元大AAA至A公司債,29,3,26,新光-高雄,2024-12-17,8562
00878,國泰永續高股息,38,13,25,新光-高雄,2024-12-17,8562
6177,達麗,25,0,25,新光-高雄,2024-12-17,8562
2449,京元電子,31,7,24,新光-高雄,2024-12-17,8562
912000,晨訊科-DR,23,0,23,新光-高雄,2024-12-17,8562
00959B,大華投等美債15Y+,22,0,22,新光-高雄,2024-12-17,8562
1402,遠東新,21,0,21,新光-高雄,2024-12-17,8562
2014,中鴻,21,0,21,新光-高雄,2024-12-17,8562
3045,台灣大,33,13,20,新光-高雄,2024-12-17,8562
1519,華城,23,4,19,新光-高雄,2024-12-17,8562
00830,國泰費城半導體,25,8,17,新光-高雄,2024-12-17,8562
3706,神達,174,157,17,新光-高雄,2024-12-17,8562
2464,盟立,28,11,17,新光-高雄,2024-12-17,8562
6505,台塑化,17,1,16,新光-高雄,2024-12-17,8562
2890,永豐金,20,4,16,新光-高雄,2024-12-17,8562
1532,勤美,17,1,16,新光-高雄,2024-12-17,8562
5315,光聯,32,16,16,新光-高雄,2024-12-17,8562
00680L,元大美債20正2,87,71,16,新光-高雄,2024-12-17,8562
00931B,統一美債20年,15,0,15,新光-高雄,2024-12-17,8562
00712,復華富時不動產,292,0,292,新光-高雄,2024-12-18,8562
00918,大華優利高填息30,330,53,277,新光-高雄,2024-12-18,8562
1524,耿鼎,260,7,253,新光-高雄,2024-12-18,8562
2313,華通,320,93,227,新光-高雄,2024-12-18,8562
00937B,群益ESG投等債20,220,33,187,新光-高雄,2024-12-18,8562
1101,台泥,101,2,99,新光-高雄,2024-12-18,8562
00950B,凱基A級公司債,95,0,95,新光-高雄,2024-12-18,8562
00945B,凱基美國非投等債,87,0,87,新光-高雄,2024-12-18,8562
00948B,中信優息投資級債,78,0,78,新光-高雄,2024-12-18,8562
00953B,群益優選非投等債,78,0,78,新光-高雄,2024-12-18,8562
00715L,期街口布蘭特正2,84,12,72,新光-高雄,2024-12-18,8562
00679B,元大美債20年,68,1,67,新光-高雄,2024-12-18,8562
00687B,國泰20年美債,76,17,59,新光-高雄,2024-12-18,8562
00795B,中信美國公債20年,61,4,57,新光-高雄,2024-12-18,8562
00680L,元大美債20正2,60,5,55,新光-高雄,2024-12-18,8562
2002,中鋼,54,0,54,新光-高雄,2024-12-18,8562
00940,元大台灣價值高息,58,5,53,新光-高雄,2024-12-18,8562
00924,復華S＆P500成長,52,1,51,新光-高雄,2024-12-18,8562
00916,國泰全球品牌50,42,0,42,新光-高雄,2024-12-18,8562
9105,泰金寶-DR,645,605,40,新光-高雄,2024-12-18,8562
2547,日勝生,40,0,40,新光-高雄,2024-12-18,8562
4533,協易機,49,14,35,新光-高雄,2024-12-18,8562
2388,威盛,47,12,35,新光-高雄,2024-12-18,8562
4540,全球傳動,217,182,35,新光-高雄,2024-12-18,8562
3231,緯創,52,18,34,新光-高雄,2024-12-18,8562
00915,凱基優選高股息30,34,2,32,新光-高雄,2024-12-18,8562
00926,凱基全球菁英55,34,3,31,新光-高雄,2024-12-18,8562
00903,富邦元宇宙,30,0,30,新光-高雄,2024-12-18,8562
2409,友達,41,12,29,新光-高雄,2024-12-18,8562
0056,元大高股息,37,9,28,新光-高雄,2024-12-18,8562
6962,ITH-KY,52,24,28,新光-高雄,2024-12-18,8562
2312,金寶,46,19,27,新光-高雄,2024-12-18,8562
3041,揚智,499,472,27,新光-高雄,2024-12-18,8562
1605,華新,45,19,26,新光-高雄,2024-12-18,8562
2349,錸德,30,4,26,新光-高雄,2024-12-18,8562
3665,貿聯-KY,30,5,25,新光-高雄,2024-12-18,8562
6186,新潤,25,0,25,新光-高雄,2024-12-18,8562
5347,世界,35,10,25,新光-高雄,2024-12-18,8562
00662,富邦NASDAQ,20,0,20,新光-高雄,2024-12-18,8562
00673R,期元大S＆P原油反1,20,0,20,新光-高雄,2024-12-18,8562
00830,國泰費城半導體,22,3,19,新光-高雄,2024-12-18,8562
2609,陽明,61,41,20,新光-高雄,2024-12-18,8562
00922,國泰台灣領袖50,31,12,19,新光-高雄,2024-12-18,8562
2892,第一金,19,0,19,新光-高雄,2024-12-18,8562
2884,玉山金,20,1,19,新光-高雄,2024-12-18,8562
2888,新光金,20,2,18,新光-高雄,2024-12-18,8562
8171,天宇,27,9,18,新光-高雄,2024-12-18,8562
2886,兆豐金,20,3,17,新光-高雄,2024-12-18,8562
3702A,大聯大甲特,17,0,17,新光-高雄,2024-12-18,8562
00852L,國泰美國道瓊正2,17,0,17,新光-高雄,2024-12-18,8562
00937B,群益ESG投等債20,1084,157,927,新光-高雄,2024-12-19,8562
2618,長榮航,572,83,489,新光-高雄,2024-12-19,8562
1524,耿鼎,263,0,263,新光-高雄,2024-12-19,8562
00680L,元大美債20正2,404,167,237,新光-高雄,2024-12-19,8562
00918,大華優利高填息30,270,34,236,新光-高雄,2024-12-19,8562
00688L,國泰20年美債正2,282,64,218,新光-高雄,2024-12-19,8562
0056,元大高股息,197,9,188,新光-高雄,2024-12-19,8562
00712,復華富時不動產,168,0,168,新光-高雄,2024-12-19,8562
00687B,國泰20年美債,224,63,161,新光-高雄,2024-12-19,8562
00933B,國泰10Y+金融債,155,0,155,新光-高雄,2024-12-19,8562
2880,華南金,140,1,139,新光-高雄,2024-12-19,8562
00679B,元大美債20年,132,9,123,新光-高雄,2024-12-19,8562
2610,華航,167,45,122,新光-高雄,2024-12-19,8562
2883,凱基金,141,35,106,新光-高雄,2024-12-19,8562
00919,群益台灣精選高息,240,143,97,新光-高雄,2024-12-19,8562
00675L,富邦臺灣加權正2,98,8,90,新光-高雄,2024-12-19,8562
00915,凱基優選高股息30,85,5,80,新光-高雄,2024-12-19,8562
00795B,中信美國公債20年,94,16,78,新光-高雄,2024-12-19,8562
00940,元大台灣價值高息,104,39,65,新光-高雄,2024-12-19,8562
6285,啟��,84,22,62,新光-高雄,2024-12-19,8562
00852L,國泰美國道瓊正2,61,0,61,新光-高雄,2024-12-19,8562
8249,菱光,114,65,49,新光-高雄,2024-12-19,8562
2332,友訊,90,42,48,新光-高雄,2024-12-19,8562
00950B,凱基A級公司債,48,0,48,新光-高雄,2024-12-19,8562
00706L,期元大S＆P日圓正2,57,10,47,新光-高雄,2024-12-19,8562
00924,復華S＆P500成長,46,0,46,新光-高雄,2024-12-19,8562
00878,國泰永續高股息,159,114,45,新光-高雄,2024-12-19,8562
006208,富邦台50,47,3,44,新光-高雄,2024-12-19,8562
2609,陽明,111,71,40,新光-高雄,2024-12-19,8562
2330,台積電,79,40,39,新光-高雄,2024-12-19,8562
00830,國泰費城半導體,40,1,39,新光-高雄,2024-12-19,8562
2886,兆豐金,39,1,38,新光-高雄,2024-12-19,8562
2371,大同,38,0,38,新光-高雄,2024-12-19,8562
00922,國泰台灣領袖50,40,3,37,新光-高雄,2024-12-19,8562
00907,永豐優息存股,42,6,36,新光-高雄,2024-12-19,8562
2891,中信金,82,48,34,新光-高雄,2024-12-19,8562
00948B,中信優息投資級債,38,4,34,新光-高雄,2024-12-19,8562
2633,台灣高鐵,33,0,33,新光-高雄,2024-12-19,8562
4414,如興,30,0,30,新光-高雄,2024-12-19,8562
2023,燁輝,30,0,30,新光-高雄,2024-12-19,8562
00715L,期街口布蘭特正2,39,9,30,新光-高雄,2024-12-19,8562
2408,南亞科,76,46,30,新光-高雄,2024-12-19,8562
5880,合庫金,29,0,29,新光-高雄,2024-12-19,8562
2409,友達,29,0,29,新光-高雄,2024-12-19,8562
2002,中鋼,33,6,27,新光-高雄,2024-12-19,8562
4540,全球傳動,30,3,27,新光-高雄,2024-12-19,8562
00670L,富邦NASDAQ正2,38,11,27,新光-高雄,2024-12-19,8562
00753L,中信中國50正2,126,100,26,新光-高雄,2024-12-19,8562
00665L,富邦�琤肭磪囓�2,67,41,26,新光-高雄,2024-12-19,8562
2897,王道銀行,24,0,24,新光-高雄,2024-12-19,8562
