Ticker,Name,buy,sell,diff,Branch,Date,Branch_Code
2634,漢翔,120,20,100,陽信-石牌,2023-01-03,8711
1752,南光,73,4,69,陽信-石牌,2023-01-03,8711
4114,健喬,161,119,42,陽信-石牌,2023-01-03,8711
2636,台驊控股,40,0,40,陽信-石牌,2023-01-03,8711
1312,國喬,30,0,30,陽信-石牌,2023-01-03,8711
2102,泰豐,30,0,30,陽信-石牌,2023-01-03,8711
5608,四維航,30,2,28,陽信-石牌,2023-01-03,8711
00632R,元大台灣50反1,30,3,27,陽信-石牌,2023-01-03,8711
1909,榮成,30,5,25,陽信-石牌,2023-01-03,8711
2609,陽明,26,4,22,陽信-石牌,2023-01-03,8711
2367,燿華,20,0,20,陽信-石牌,2023-01-03,8711
2601,益航,300,280,20,陽信-石牌,2023-01-03,8711
2444,兆勁,20,5,15,陽信-石牌,2023-01-03,8711
2022,聚亨,13,0,13,陽信-石牌,2023-01-03,8711
2449,京元電子,12,0,12,陽信-石牌,2023-01-03,8711
5880,合庫金,12,0,12,陽信-石牌,2023-01-03,8711
6266,泰詠,12,0,12,陽信-石牌,2023-01-03,8711
2317,鴻海,28,17,11,陽信-石牌,2023-01-03,8711
1504,東元,10,0,10,陽信-石牌,2023-01-03,8711
1514,亞力,20,10,10,陽信-石牌,2023-01-03,8711
00688L,國泰20年美債正2,10,0,10,陽信-石牌,2023-01-03,8711
00720B,元大投資級公司債,10,0,10,陽信-石牌,2023-01-03,8711
2034,允強,10,0,10,陽信-石牌,2023-01-03,8711
3231,緯創,10,0,10,陽信-石牌,2023-01-03,8711
00878,國泰永續高股息,16,7,9,陽信-石牌,2023-01-03,8711
1598,岱宇,9,0,9,陽信-石牌,2023-01-03,8711
2603,長榮,18,9,9,陽信-石牌,2023-01-03,8711
6143,振曜,8,0,8,陽信-石牌,2023-01-03,8711
6770,力積電,10,2,8,陽信-石牌,2023-01-03,8711
1605,華新,138,131,7,陽信-石牌,2023-01-03,8711
2425,承啟,20,14,6,陽信-石牌,2023-01-03,8711
4167,松瑞藥,56,50,6,陽信-石牌,2023-01-03,8711
6547,高端疫苗,15,9,6,陽信-石牌,2023-01-03,8711
3481,群創,7,2,5,陽信-石牌,2023-01-03,8711
1522,堤維西,7,2,5,陽信-石牌,2023-01-03,8711
1218,泰山,6,1,5,陽信-石牌,2023-01-03,8711
1102,亞泥,5,0,5,陽信-石牌,2023-01-03,8711
2892,第一金,5,0,5,陽信-石牌,2023-01-03,8711
3447,展達,5,0,5,陽信-石牌,2023-01-03,8711
4116,明基醫,5,0,5,陽信-石牌,2023-01-03,8711
9904,寶成,5,0,5,陽信-石牌,2023-01-03,8711
9907,統一實,5,0,5,陽信-石牌,2023-01-03,8711
1731,美吾華,4,0,4,陽信-石牌,2023-01-03,8711
2327,國巨,5,1,4,陽信-石牌,2023-01-03,8711
2364,倫飛,4,0,4,陽信-石牌,2023-01-03,8711
2606,裕民,4,0,4,陽信-石牌,2023-01-03,8711
2612,中航,4,0,4,陽信-石牌,2023-01-03,8711
2890,永豐金,4,0,4,陽信-石牌,2023-01-03,8711
6202,盛群,5,1,4,陽信-石牌,2023-01-03,8711
2359,所羅門,3,0,3,陽信-石牌,2023-01-03,8711
1609,大亞,237,24,213,陽信-石牌,2023-01-04,8711
00715L,期街口布蘭特正2,157,0,157,陽信-石牌,2023-01-04,8711
0056,元大高股息,62,1,61,陽信-石牌,2023-01-04,8711
1447,力鵬,50,0,50,陽信-石牌,2023-01-04,8711
1529,樂事綠能,60,16,44,陽信-石牌,2023-01-04,8711
2610,華航,36,0,36,陽信-石牌,2023-01-04,8711
3535,晶彩科,31,0,31,陽信-石牌,2023-01-04,8711
9802,鈺齊-KY,34,4,30,陽信-石牌,2023-01-04,8711
1517,利奇,25,0,25,陽信-石牌,2023-01-04,8711
4743,合一,23,2,21,陽信-石牌,2023-01-04,8711
2603,長榮,23,5,18,陽信-石牌,2023-01-04,8711
5425,台半,21,3,18,陽信-石牌,2023-01-04,8711
8440,綠電,28,10,18,陽信-石牌,2023-01-04,8711
3037,欣興,29,12,17,陽信-石牌,2023-01-04,8711
2317,鴻海,18,2,16,陽信-石牌,2023-01-04,8711
3272,東碩,17,1,16,陽信-石牌,2023-01-04,8711
02002L,兆豐富櫃200正二N,15,0,15,陽信-石牌,2023-01-04,8711
1605,華新,68,54,14,陽信-石牌,2023-01-04,8711
2634,漢翔,14,0,14,陽信-石牌,2023-01-04,8711
3047,訊舟,15,1,14,陽信-石牌,2023-01-04,8711
2882,國泰金,22,8,14,陽信-石牌,2023-01-04,8711
1513,中興電,42,31,11,陽信-石牌,2023-01-04,8711
00680L,元大美債20正2,11,0,11,陽信-石牌,2023-01-04,8711
00893,國泰智能電動車,11,0,11,陽信-石牌,2023-01-04,8711
6806,森崴能源,26,15,11,陽信-石牌,2023-01-04,8711
2617,台航,10,0,10,陽信-石牌,2023-01-04,8711
3265,台星科,10,0,10,陽信-石牌,2023-01-04,8711
3356,奇偶,10,0,10,陽信-石牌,2023-01-04,8711
6217,中探針,10,0,10,陽信-石牌,2023-01-04,8711
8227,巨有科技,10,0,10,陽信-石牌,2023-01-04,8711
2637,慧洋-KY,14,5,9,陽信-石牌,2023-01-04,8711
6244,茂迪,30,21,9,陽信-石牌,2023-01-04,8711
00881,國泰台灣5G+,8,0,8,陽信-石牌,2023-01-04,8711
2886,兆豐金,8,0,8,陽信-石牌,2023-01-04,8711
6266,泰詠,8,0,8,陽信-石牌,2023-01-04,8711
8046,南電,10,2,8,陽信-石牌,2023-01-04,8711
2014,中鴻,12,5,7,陽信-石牌,2023-01-04,8711
2887,台新金,7,0,7,陽信-石牌,2023-01-04,8711
4746,台耀,7,0,7,陽信-石牌,2023-01-04,8711
6279,胡連,7,0,7,陽信-石牌,2023-01-04,8711
1514,亞力,20,14,6,陽信-石牌,2023-01-04,8711
3324,雙鴻,6,0,6,陽信-石牌,2023-01-04,8711
6235,華孚,14,8,6,陽信-石牌,2023-01-04,8711
6756,威鋒電子,7,1,6,陽信-石牌,2023-01-04,8711
00701,國泰股利精選30,5,0,5,陽信-石牌,2023-01-04,8711
02001L,富邦蘋果正二N,5,0,5,陽信-石牌,2023-01-04,8711
00902,中信電池及儲能,5,0,5,陽信-石牌,2023-01-04,8711
2405,輔信,5,0,5,陽信-石牌,2023-01-04,8711
2890,永豐金,5,0,5,陽信-石牌,2023-01-04,8711
3034,聯詠,9,4,5,陽信-石牌,2023-01-04,8711
8016,矽創,86,1,85,陽信-石牌,2023-01-05,8711
4167,松瑞藥,123,80,43,陽信-石牌,2023-01-05,8711
00632R,元大台灣50反1,57,15,42,陽信-石牌,2023-01-05,8711
1905,華紙,30,0,30,陽信-石牌,2023-01-05,8711
2030,彰源,30,0,30,陽信-石牌,2023-01-05,8711
1710,東聯,27,0,27,陽信-石牌,2023-01-05,8711
4804,大略-KY,24,0,24,陽信-石牌,2023-01-05,8711
2317,鴻海,23,1,22,陽信-石牌,2023-01-05,8711
4960,誠美材,22,0,22,陽信-石牌,2023-01-05,8711
4743,合一,26,5,21,陽信-石牌,2023-01-05,8711
2380,虹光,23,3,20,陽信-石牌,2023-01-05,8711
2489,瑞軒,20,0,20,陽信-石牌,2023-01-05,8711
5905,南仁湖,20,0,20,陽信-石牌,2023-01-05,8711
2610,華航,16,0,16,陽信-石牌,2023-01-05,8711
00670L,富邦NASDAQ正2,14,0,14,陽信-石牌,2023-01-05,8711
6266,泰詠,13,0,13,陽信-石牌,2023-01-05,8711
6244,茂迪,21,10,11,陽信-石牌,2023-01-05,8711
2017,官田鋼,10,0,10,陽信-石牌,2023-01-05,8711
2908,特力,10,0,10,陽信-石牌,2023-01-05,8711
4916,事欣科,12,2,10,陽信-石牌,2023-01-05,8711
5880,合庫金,10,0,10,陽信-石牌,2023-01-05,8711
6443,元晶,11,1,10,陽信-石牌,2023-01-05,8711
8086,宏捷科,10,0,10,陽信-石牌,2023-01-05,8711
8121,越峰,10,0,10,陽信-石牌,2023-01-05,8711
8069,元太,11,2,9,陽信-石牌,2023-01-05,8711
2409,友達,10,1,9,陽信-石牌,2023-01-05,8711
2882,國泰金,11,2,9,陽信-石牌,2023-01-05,8711
4974,亞泰,9,0,9,陽信-石牌,2023-01-05,8711
3189,景碩,21,12,9,陽信-石牌,2023-01-05,8711
3035,智原,10,2,8,陽信-石牌,2023-01-05,8711
4162,智擎,8,0,8,陽信-石牌,2023-01-05,8711
9103,美德醫療-DR,11,3,8,陽信-石牌,2023-01-05,8711
3083,網龍,7,0,7,陽信-石牌,2023-01-05,8711
3265,台星科,7,0,7,陽信-石牌,2023-01-05,8711
5009,榮剛,11,4,7,陽信-石牌,2023-01-05,8711
5607,遠雄港,7,0,7,陽信-石牌,2023-01-05,8711
6111,大宇資,14,7,7,陽信-石牌,2023-01-05,8711
00773B,中信優先金融債,6,0,6,陽信-石牌,2023-01-05,8711
1720,生達,6,0,6,陽信-石牌,2023-01-05,8711
2376,技嘉,10,4,6,陽信-石牌,2023-01-05,8711
3631,晟楠,6,0,6,陽信-石牌,2023-01-05,8711
8436,大江,6,0,6,陽信-石牌,2023-01-05,8711
1444,力麗,5,0,5,陽信-石牌,2023-01-05,8711
1789,神隆,5,0,5,陽信-石牌,2023-01-05,8711
2347,聯強,5,0,5,陽信-石牌,2023-01-05,8711
2419,仲琦,18,13,5,陽信-石牌,2023-01-05,8711
2498,宏達電,22,17,5,陽信-石牌,2023-01-05,8711
3025,星通,5,0,5,陽信-石牌,2023-01-05,8711
3682,亞太電,5,0,5,陽信-石牌,2023-01-05,8711
6133,金橋,5,0,5,陽信-石牌,2023-01-05,8711
00632R,元大台灣50反1,178,0,178,陽信-石牌,2023-01-06,8711
5351,鈺創,127,9,118,陽信-石牌,2023-01-06,8711
1519,華城,76,23,53,陽信-石牌,2023-01-06,8711
00676R,富邦臺灣加權反1,51,0,51,陽信-石牌,2023-01-06,8711
3006,晶豪科,40,1,39,陽信-石牌,2023-01-06,8711
6806,森崴能源,41,3,38,陽信-石牌,2023-01-06,8711
6285,啟��,36,0,36,陽信-石牌,2023-01-06,8711
1513,中興電,31,4,27,陽信-石牌,2023-01-06,8711
1710,東聯,27,0,27,陽信-石牌,2023-01-06,8711
3141,晶宏,33,10,23,陽信-石牌,2023-01-06,8711
2439,美律,20,0,20,陽信-石牌,2023-01-06,8711
4157,太景*-KY,20,0,20,陽信-石牌,2023-01-06,8711
3708,上緯投控,19,0,19,陽信-石牌,2023-01-06,8711
2482,連宇,16,0,16,陽信-石牌,2023-01-06,8711
2201,裕隆,59,45,14,陽信-石牌,2023-01-06,8711
02002L,兆豐富櫃200正二N,11,0,11,陽信-石牌,2023-01-06,8711
5608,四維航,11,0,11,陽信-石牌,2023-01-06,8711
1201,味全,10,0,10,陽信-石牌,2023-01-06,8711
3712,永崴投控,10,0,10,陽信-石牌,2023-01-06,8711
5009,榮剛,10,0,10,陽信-石牌,2023-01-06,8711
9105,泰金寶-DR,15,5,10,陽信-石牌,2023-01-06,8711
1503,士電,8,0,8,陽信-石牌,2023-01-06,8711
4961,天鈺,23,16,7,陽信-石牌,2023-01-06,8711
00720B,元大投資級公司債,7,0,7,陽信-石牌,2023-01-06,8711
2610,華航,10,3,7,陽信-石牌,2023-01-06,8711
3631,晟楠,7,0,7,陽信-石牌,2023-01-06,8711
8086,宏捷科,7,0,7,陽信-石牌,2023-01-06,8711
2444,兆勁,10,4,6,陽信-石牌,2023-01-06,8711
3047,訊舟,6,0,6,陽信-石牌,2023-01-06,8711
2308,台達電,7,2,5,陽信-石牌,2023-01-06,8711
1514,亞力,5,0,5,陽信-石牌,2023-01-06,8711
1609,大亞,5,0,5,陽信-石牌,2023-01-06,8711
2317,鴻海,12,7,5,陽信-石牌,2023-01-06,8711
2601,益航,25,20,5,陽信-石牌,2023-01-06,8711
3406,玉晶光,6,1,5,陽信-石牌,2023-01-06,8711
3594,磐儀,5,0,5,陽信-石牌,2023-01-06,8711
4916,事欣科,5,0,5,陽信-石牌,2023-01-06,8711
4931,新盛力,5,0,5,陽信-石牌,2023-01-06,8711
6176,瑞儀,5,0,5,陽信-石牌,2023-01-06,8711
6202,盛群,8,3,5,陽信-石牌,2023-01-06,8711
2007,燁興,4,0,4,陽信-石牌,2023-01-06,8711
2888,新光金,24,20,4,陽信-石牌,2023-01-06,8711
3443,創意,4,0,4,陽信-石牌,2023-01-06,8711
6266,泰詠,4,0,4,陽信-石牌,2023-01-06,8711
6404,通訊-KY,4,0,4,陽信-石牌,2023-01-06,8711
1512,瑞利,3,0,3,陽信-石牌,2023-01-06,8711
00637L,元大滬深300正2,3,0,3,陽信-石牌,2023-01-06,8711
1701,中化,21,18,3,陽信-石牌,2023-01-06,8711
2642,宅配通,3,0,3,陽信-石牌,2023-01-06,8711
3567,逸昌,3,0,3,陽信-石牌,2023-01-06,8711
6244,茂迪,127,0,127,陽信-石牌,2023-01-09,8711
2867,三商壽,100,0,100,陽信-石牌,2023-01-09,8711
00676R,富邦臺灣加權反1,129,30,99,陽信-石牌,2023-01-09,8711
2538,基泰,70,0,70,陽信-石牌,2023-01-09,8711
2601,益航,60,0,60,陽信-石牌,2023-01-09,8711
1710,東聯,54,0,54,陽信-石牌,2023-01-09,8711
2102,泰豐,45,0,45,陽信-石牌,2023-01-09,8711
2609,陽明,47,3,44,陽信-石牌,2023-01-09,8711
3535,晶彩科,44,1,43,陽信-石牌,2023-01-09,8711
2520,冠德,35,0,35,陽信-石牌,2023-01-09,8711
1605,華新,374,342,32,陽信-石牌,2023-01-09,8711
2501,國建,30,0,30,陽信-石牌,2023-01-09,8711
0050,元大台灣50,31,4,27,陽信-石牌,2023-01-09,8711
8289,泰藝,26,0,26,陽信-石牌,2023-01-09,8711
4916,事欣科,25,0,25,陽信-石牌,2023-01-09,8711
2313,華通,25,1,24,陽信-石牌,2023-01-09,8711
1909,榮成,57,36,21,陽信-石牌,2023-01-09,8711
1718,中纖,20,0,20,陽信-石牌,2023-01-09,8711
2208,台船,20,0,20,陽信-石牌,2023-01-09,8711
2610,華航,45,25,20,陽信-石牌,2023-01-09,8711
00885,富邦越南,40,21,19,陽信-石牌,2023-01-09,8711
1516,川飛,36,17,19,陽信-石牌,2023-01-09,8711
4968,立積,16,0,16,陽信-石牌,2023-01-09,8711
2323,中環,13,0,13,陽信-石牌,2023-01-09,8711
1227,佳格,10,0,10,陽信-石牌,2023-01-09,8711
3686,達能,10,0,10,陽信-石牌,2023-01-09,8711
3704,合勤控,15,5,10,陽信-石牌,2023-01-09,8711
5608,四維航,10,0,10,陽信-石牌,2023-01-09,8711
6176,瑞儀,10,0,10,陽信-石牌,2023-01-09,8711
8016,矽創,11,1,10,陽信-石牌,2023-01-09,8711
1529,樂事綠能,17,8,9,陽信-石牌,2023-01-09,8711
5269,祥碩,36,27,9,陽信-石牌,2023-01-09,8711
5351,鈺創,14,5,9,陽信-石牌,2023-01-09,8711
5425,台半,19,11,8,陽信-石牌,2023-01-09,8711
6279,胡連,8,0,8,陽信-石牌,2023-01-09,8711
2009,第一銅,10,3,7,陽信-石牌,2023-01-09,8711
3447,展達,7,0,7,陽信-石牌,2023-01-09,8711
2603,長榮,20,14,6,陽信-石牌,2023-01-09,8711
3545,敦泰,11,5,6,陽信-石牌,2023-01-09,8711
4931,新盛力,6,0,6,陽信-石牌,2023-01-09,8711
6129,普誠,7,1,6,陽信-石牌,2023-01-09,8711
2515,中工,5,0,5,陽信-石牌,2023-01-09,8711
2637,慧洋-KY,6,1,5,陽信-石牌,2023-01-09,8711
3706,神達,5,0,5,陽信-石牌,2023-01-09,8711
4804,大略-KY,5,0,5,陽信-石牌,2023-01-09,8711
2402,毅嘉,4,0,4,陽信-石牌,2023-01-09,8711
4961,天鈺,15,11,4,陽信-石牌,2023-01-09,8711
6733,博晟生醫,4,0,4,陽信-石牌,2023-01-09,8711
6806,森崴能源,8,4,4,陽信-石牌,2023-01-09,8711
8085,福華,4,0,4,陽信-石牌,2023-01-09,8711
1710,東聯,163,0,163,陽信-石牌,2023-01-10,8711
2885,元大金,120,0,120,陽信-石牌,2023-01-10,8711
2317,鴻海,106,1,105,陽信-石牌,2023-01-10,8711
2601,益航,272,182,90,陽信-石牌,2023-01-10,8711
2313,華通,84,4,80,陽信-石牌,2023-01-10,8711
1752,南光,68,6,62,陽信-石牌,2023-01-10,8711
6244,茂迪,52,0,52,陽信-石牌,2023-01-10,8711
1477,聚陽,51,0,51,陽信-石牌,2023-01-10,8711
2834,臺企銀,90,49,41,陽信-石牌,2023-01-10,8711
2444,兆勁,35,0,35,陽信-石牌,2023-01-10,8711
6443,元晶,41,8,33,陽信-石牌,2023-01-10,8711
2880,華南金,30,0,30,陽信-石牌,2023-01-10,8711
5009,榮剛,29,2,27,陽信-石牌,2023-01-10,8711
9933,中鼎,25,0,25,陽信-石牌,2023-01-10,8711
1605,華新,36,16,20,陽信-石牌,2023-01-10,8711
00670L,富邦NASDAQ正2,20,0,20,陽信-石牌,2023-01-10,8711
6477,安集,20,0,20,陽信-石牌,2023-01-10,8711
2439,美律,20,1,19,陽信-石牌,2023-01-10,8711
3686,達能,20,2,18,陽信-石牌,2023-01-10,8711
3535,晶彩科,15,0,15,陽信-石牌,2023-01-10,8711
6266,泰詠,22,8,14,陽信-石牌,2023-01-10,8711
3481,群創,13,0,13,陽信-石牌,2023-01-10,8711
2368,金像電,19,7,12,陽信-石牌,2023-01-10,8711
2886,兆豐金,14,2,12,陽信-石牌,2023-01-10,8711
0050,元大台灣50,18,7,11,陽信-石牌,2023-01-10,8711
4931,新盛力,11,0,11,陽信-石牌,2023-01-10,8711
1810,和成,10,0,10,陽信-石牌,2023-01-10,8711
3356,奇偶,10,0,10,陽信-石牌,2023-01-10,8711
6234,高僑,10,0,10,陽信-石牌,2023-01-10,8711
2344,華邦電,15,6,9,陽信-石牌,2023-01-10,8711
2609,陽明,14,6,8,陽信-石牌,2023-01-10,8711
2748,雲品,8,0,8,陽信-石牌,2023-01-10,8711
2929,淘帝-KY,22,14,8,陽信-石牌,2023-01-10,8711
5351,鈺創,15,7,8,陽信-石牌,2023-01-10,8711
3162,精確,7,0,7,陽信-石牌,2023-01-10,8711
6148,驊宏資,7,0,7,陽信-石牌,2023-01-10,8711
1513,中興電,8,2,6,陽信-石牌,2023-01-10,8711
2069,運錩,6,0,6,陽信-石牌,2023-01-10,8711
3491,昇達科,6,0,6,陽信-石牌,2023-01-10,8711
3704,合勤控,29,23,6,陽信-石牌,2023-01-10,8711
6176,瑞儀,6,0,6,陽信-石牌,2023-01-10,8711
1444,力麗,10,5,5,陽信-石牌,2023-01-10,8711
1736,喬山,15,10,5,陽信-石牌,2023-01-10,8711
2007,燁興,5,0,5,陽信-石牌,2023-01-10,8711
2607,榮運,5,0,5,陽信-石牌,2023-01-10,8711
3022,威強電,5,0,5,陽信-石牌,2023-01-10,8711
3025,星通,5,0,5,陽信-石牌,2023-01-10,8711
3083,網龍,7,2,5,陽信-石牌,2023-01-10,8711
3508,位速,5,0,5,陽信-石牌,2023-01-10,8711
3548,兆利,5,0,5,陽信-石牌,2023-01-10,8711
6138,茂達,200,1,199,陽信-石牌,2023-01-11,8711
2027,大成鋼,84,4,80,陽信-石牌,2023-01-11,8711
2618,長榮航,116,61,55,陽信-石牌,2023-01-11,8711
00753L,中信中國50正2,50,0,50,陽信-石牌,2023-01-11,8711
00632R,元大台灣50反1,50,0,50,陽信-石牌,2023-01-11,8711
2313,華通,69,22,47,陽信-石牌,2023-01-11,8711
3045,台灣大,40,0,40,陽信-石牌,2023-01-11,8711
2515,中工,30,0,30,陽信-石牌,2023-01-11,8711
3682,亞太電,25,0,25,陽信-石牌,2023-01-11,8711
2886,兆豐金,23,0,23,陽信-石牌,2023-01-11,8711
3221,台嘉碩,20,0,20,陽信-石牌,2023-01-11,8711
8044,網家,23,4,19,陽信-石牌,2023-01-11,8711
3062,建漢,18,0,18,陽信-石牌,2023-01-11,8711
3704,合勤控,48,30,18,陽信-石牌,2023-01-11,8711
2888,新光金,17,0,17,陽信-石牌,2023-01-11,8711
5388,中磊,16,0,16,陽信-石牌,2023-01-11,8711
6266,泰詠,14,0,14,陽信-石牌,2023-01-11,8711
9945,潤泰新,20,8,12,陽信-石牌,2023-01-11,8711
1440,南紡,10,0,10,陽信-石牌,2023-01-11,8711
6257,矽格,10,0,10,陽信-石牌,2023-01-11,8711
00878,國泰永續高股息,9,0,9,陽信-石牌,2023-01-11,8711
3162,精確,9,0,9,陽信-石牌,2023-01-11,8711
8069,元太,13,4,9,陽信-石牌,2023-01-11,8711
8463,潤泰材,9,0,9,陽信-石牌,2023-01-11,8711
00642U,期元大S＆P石油,8,0,8,陽信-石牌,2023-01-11,8711
2883,凱基金,8,0,8,陽信-石牌,2023-01-11,8711
4979,華星光,21,13,8,陽信-石牌,2023-01-11,8711
2317,鴻海,8,1,7,陽信-石牌,2023-01-11,8711
6477,安集,8,1,7,陽信-石牌,2023-01-11,8711
2360,致茂,6,0,6,陽信-石牌,2023-01-11,8711
2486,一詮,6,0,6,陽信-石牌,2023-01-11,8711
3027,盛達,11,5,6,陽信-石牌,2023-01-11,8711
00752,中信中國50,5,0,5,陽信-石牌,2023-01-11,8711
00679B,元大美債20年,5,0,5,陽信-石牌,2023-01-11,8711
1558,伸興,5,0,5,陽信-石牌,2023-01-11,8711
1611,中電,5,0,5,陽信-石牌,2023-01-11,8711
2108,南帝,5,0,5,陽信-石牌,2023-01-11,8711
2331,精英,5,0,5,陽信-石牌,2023-01-11,8711
2399,映泰,5,0,5,陽信-石牌,2023-01-11,8711
2607,榮運,15,10,5,陽信-石牌,2023-01-11,8711
2633,台灣高鐵,5,0,5,陽信-石牌,2023-01-11,8711
3374,精材,5,0,5,陽信-石牌,2023-01-11,8711
3594,磐儀,5,0,5,陽信-石牌,2023-01-11,8711
3706,神達,5,0,5,陽信-石牌,2023-01-11,8711
3710,連展投控,5,0,5,陽信-石牌,2023-01-11,8711
5608,四維航,20,15,5,陽信-石牌,2023-01-11,8711
6111,大宇資,5,0,5,陽信-石牌,2023-01-11,8711
6186,新潤,5,0,5,陽信-石牌,2023-01-11,8711
00905,FT臺灣Smart,4,0,4,陽信-石牌,2023-01-11,8711
1310,台苯,4,0,4,陽信-石牌,2023-01-11,8711
6719,力智,162,1,161,陽信-石牌,2023-01-12,8711
00715L,期街口布蘭特正2,139,1,138,陽信-石牌,2023-01-12,8711
00753L,中信中國50正2,51,0,51,陽信-石牌,2023-01-12,8711
00650L,復華香港正2,50,0,50,陽信-石牌,2023-01-12,8711
00632R,元大台灣50反1,50,0,50,陽信-石牌,2023-01-12,8711
2601,益航,120,78,42,陽信-石牌,2023-01-12,8711
2891,中信金,30,1,29,陽信-石牌,2023-01-12,8711
2014,中鴻,27,5,22,陽信-石牌,2023-01-12,8711
2609,陽明,23,1,22,陽信-石牌,2023-01-12,8711
2884,玉山金,20,0,20,陽信-石牌,2023-01-12,8711
2886,兆豐金,20,0,20,陽信-石牌,2023-01-12,8711
2637,慧洋-KY,16,0,16,陽信-石牌,2023-01-12,8711
00878,國泰永續高股息,15,0,15,陽信-石牌,2023-01-12,8711
2603,長榮,25,10,15,陽信-石牌,2023-01-12,8711
4916,事欣科,15,0,15,陽信-石牌,2023-01-12,8711
00885,富邦越南,14,2,12,陽信-石牌,2023-01-12,8711
2312,金寶,12,0,12,陽信-石牌,2023-01-12,8711
2498,宏達電,24,12,12,陽信-石牌,2023-01-12,8711
3521,鴻翊,10,0,10,陽信-石牌,2023-01-12,8711
1519,華城,9,0,9,陽信-石牌,2023-01-12,8711
2201,裕隆,32,23,9,陽信-石牌,2023-01-12,8711
00670L,富邦NASDAQ正2,8,0,8,陽信-石牌,2023-01-12,8711
2368,金像電,9,1,8,陽信-石牌,2023-01-12,8711
2409,友達,14,7,7,陽信-石牌,2023-01-12,8711
00673R,期元大S＆P原油反1,7,0,7,陽信-石牌,2023-01-12,8711
1810,和成,7,0,7,陽信-石牌,2023-01-12,8711
6266,泰詠,7,0,7,陽信-石牌,2023-01-12,8711
1514,亞力,6,0,6,陽信-石牌,2023-01-12,8711
2108,南帝,6,0,6,陽信-石牌,2023-01-12,8711
3711,日月光投控,6,0,6,陽信-石牌,2023-01-12,8711
4128,中天,6,0,6,陽信-石牌,2023-01-12,8711
4148,全宇生技-KY,6,0,6,陽信-石牌,2023-01-12,8711
5347,世界,7,1,6,陽信-石牌,2023-01-12,8711
8071,能率網通,6,0,6,陽信-石牌,2023-01-12,8711
1309,台達化,5,0,5,陽信-石牌,2023-01-12,8711
1584,精剛,12,7,5,陽信-石牌,2023-01-12,8711
1605,華新,20,15,5,陽信-石牌,2023-01-12,8711
1612,宏泰,5,0,5,陽信-石牌,2023-01-12,8711
2023,燁輝,5,0,5,陽信-石牌,2023-01-12,8711
2607,榮運,5,0,5,陽信-石牌,2023-01-12,8711
3704,合勤控,15,10,5,陽信-石牌,2023-01-12,8711
4102,永日,5,0,5,陽信-石牌,2023-01-12,8711
5425,台半,5,0,5,陽信-石牌,2023-01-12,8711
6190,萬泰科,5,0,5,陽信-石牌,2023-01-12,8711
6477,安集,5,0,5,陽信-石牌,2023-01-12,8711
8043,蜜望實,5,0,5,陽信-石牌,2023-01-12,8711
2317,鴻海,4,0,4,陽信-石牌,2023-01-12,8711
2511,太子,4,0,4,陽信-石牌,2023-01-12,8711
3025,星通,5,1,4,陽信-石牌,2023-01-12,8711
6245,立端,8,4,4,陽信-石牌,2023-01-12,8711
1326,台化,40,0,40,陽信-石牌,2023-01-13,8711
2358,廷鑫,43,3,40,陽信-石牌,2023-01-13,8711
2303,聯電,81,45,36,陽信-石牌,2023-01-13,8711
2492,華新科,35,0,35,陽信-石牌,2023-01-13,8711
2891,中信金,27,0,27,陽信-石牌,2023-01-13,8711
2312,金寶,23,0,23,陽信-石牌,2023-01-13,8711
00900,富邦特選高股息30,20,0,20,陽信-石牌,2023-01-13,8711
3128,昇銳,20,0,20,陽信-石牌,2023-01-13,8711
2511,太子,18,0,18,陽信-石牌,2023-01-13,8711
2637,慧洋-KY,25,7,18,陽信-石牌,2023-01-13,8711
4916,事欣科,15,0,15,陽信-石牌,2023-01-13,8711
6443,元晶,13,0,13,陽信-石牌,2023-01-13,8711
00673R,期元大S＆P原油反1,12,0,12,陽信-石牌,2023-01-13,8711
2607,榮運,11,0,11,陽信-石牌,2023-01-13,8711
1513,中興電,11,1,10,陽信-石牌,2023-01-13,8711
00669R,國泰美國道瓊反1,10,0,10,陽信-石牌,2023-01-13,8711
2329,華泰,10,0,10,陽信-石牌,2023-01-13,8711
2704,國賓,10,0,10,陽信-石牌,2023-01-13,8711
4114,健喬,25,15,10,陽信-石牌,2023-01-13,8711
4976,佳凌,10,0,10,陽信-石牌,2023-01-13,8711
6113,亞矽,14,4,10,陽信-石牌,2023-01-13,8711
9938,百和,10,0,10,陽信-石牌,2023-01-13,8711
2498,宏達電,17,8,9,陽信-石牌,2023-01-13,8711
3010,華立,9,0,9,陽信-石牌,2023-01-13,8711
00773B,中信優先金融債,8,0,8,陽信-石牌,2023-01-13,8711
00772B,中信高評級公司債,8,1,7,陽信-石牌,2023-01-13,8711
2069,運錩,7,0,7,陽信-石牌,2023-01-13,8711
2884,玉山金,7,0,7,陽信-石牌,2023-01-13,8711
3545,敦泰,8,1,7,陽信-石牌,2023-01-13,8711
2031,新光鋼,6,0,6,陽信-石牌,2023-01-13,8711
3083,網龍,6,0,6,陽信-石牌,2023-01-13,8711
3374,精材,12,6,6,陽信-石牌,2023-01-13,8711
4931,新盛力,7,1,6,陽信-石牌,2023-01-13,8711
0056,元大高股息,5,0,5,陽信-石牌,2023-01-13,8711
1519,華城,5,0,5,陽信-石牌,2023-01-13,8711
1584,精剛,46,41,5,陽信-石牌,2023-01-13,8711
2023,燁輝,5,0,5,陽信-石牌,2023-01-13,8711
2481,強茂,6,1,5,陽信-石牌,2023-01-13,8711
4168,醣聯,5,0,5,陽信-石牌,2023-01-13,8711
6176,瑞儀,5,0,5,陽信-石牌,2023-01-13,8711
6609,瀧澤科,5,0,5,陽信-石牌,2023-01-13,8711
8463,潤泰材,5,0,5,陽信-石牌,2023-01-13,8711
00893,國泰智能電動車,5,1,4,陽信-石牌,2023-01-13,8711
1752,南光,12,8,4,陽信-石牌,2023-01-13,8711
2313,華通,26,22,4,陽信-石牌,2023-01-13,8711
3141,晶宏,4,0,4,陽信-石牌,2023-01-13,8711
8028,昇陽半導體,12,8,4,陽信-石牌,2023-01-13,8711
1612,宏泰,16,13,3,陽信-石牌,2023-01-13,8711
1476,儒鴻,3,0,3,陽信-石牌,2023-01-13,8711
1439,雋揚,3,0,3,陽信-石牌,2023-01-13,8711
00770,國泰北美科技,100,0,100,陽信-石牌,2023-01-16,8711
1710,東聯,55,0,55,陽信-石牌,2023-01-16,8711
00632R,元大台灣50反1,98,45,53,陽信-石牌,2023-01-16,8711
1584,精剛,81,36,45,陽信-石牌,2023-01-16,8711
00885,富邦越南,44,0,44,陽信-石牌,2023-01-16,8711
1605,華新,76,46,30,陽信-石牌,2023-01-16,8711
2618,長榮航,27,0,27,陽信-石牌,2023-01-16,8711
3665,貿聯-KY,26,0,26,陽信-石牌,2023-01-16,8711
2851,中再保,20,0,20,陽信-石牌,2023-01-16,8711
2520,冠德,18,0,18,陽信-石牌,2023-01-16,8711
00720B,元大投資級公司債,15,0,15,陽信-石牌,2023-01-16,8711
8436,大江,15,0,15,陽信-石牌,2023-01-16,8711
2312,金寶,14,0,14,陽信-石牌,2023-01-16,8711
0056,元大高股息,16,3,13,陽信-石牌,2023-01-16,8711
6770,力積電,13,0,13,陽信-石牌,2023-01-16,8711
2637,慧洋-KY,14,1,13,陽信-石牌,2023-01-16,8711
1314,中石化,15,3,12,陽信-石牌,2023-01-16,8711
2351,順德,12,0,12,陽信-石牌,2023-01-16,8711
4974,亞泰,12,0,12,陽信-石牌,2023-01-16,8711
2317,鴻海,11,1,10,陽信-石牌,2023-01-16,8711
00900,富邦特選高股息30,10,0,10,陽信-石牌,2023-01-16,8711
2607,榮運,10,0,10,陽信-石牌,2023-01-16,8711
8050,廣積,10,0,10,陽信-石牌,2023-01-16,8711
2603,長榮,14,5,9,陽信-石牌,2023-01-16,8711
1701,中化,12,3,9,陽信-石牌,2023-01-16,8711
2402,毅嘉,10,1,9,陽信-石牌,2023-01-16,8711
5880,合庫金,9,0,9,陽信-石牌,2023-01-16,8711
1313,聯成,7,0,7,陽信-石牌,2023-01-16,8711
00669R,國泰美國道瓊反1,7,0,7,陽信-石牌,2023-01-16,8711
00679B,元大美債20年,7,0,7,陽信-石牌,2023-01-16,8711
2606,裕民,6,0,6,陽信-石牌,2023-01-16,8711
2884,玉山金,5,0,5,陽信-石牌,2023-01-16,8711
3294,英濟,5,0,5,陽信-石牌,2023-01-16,8711
3704,合勤控,5,0,5,陽信-石牌,2023-01-16,8711
6609,瀧澤科,5,0,5,陽信-石牌,2023-01-16,8711
2612,中航,4,0,4,陽信-石牌,2023-01-16,8711
3059,華晶科,4,0,4,陽信-石牌,2023-01-16,8711
4174,浩鼎,4,0,4,陽信-石牌,2023-01-16,8711
0050,元大台灣50,10,7,3,陽信-石牌,2023-01-16,8711
00673R,期元大S＆P原油反1,3,0,3,陽信-石牌,2023-01-16,8711
2007,燁興,3,0,3,陽信-石牌,2023-01-16,8711
2511,太子,3,0,3,陽信-石牌,2023-01-16,8711
2609,陽明,27,24,3,陽信-石牌,2023-01-16,8711
3128,昇銳,3,0,3,陽信-石牌,2023-01-16,8711
4532,瑞智,3,0,3,陽信-石牌,2023-01-16,8711
1409,新纖,2,0,2,陽信-石牌,2023-01-16,8711
00882,中信中國高股息,2,0,2,陽信-石牌,2023-01-16,8711
1612,宏泰,11,9,2,陽信-石牌,2023-01-16,8711
1752,南光,17,15,2,陽信-石牌,2023-01-16,8711
2108,南帝,2,0,2,陽信-石牌,2023-01-16,8711
1752,南光,97,8,89,陽信-石牌,2023-01-17,8711
1584,精剛,169,100,69,陽信-石牌,2023-01-17,8711
00715L,期街口布蘭特正2,67,0,67,陽信-石牌,2023-01-17,8711
2014,中鴻,64,10,54,陽信-石牌,2023-01-17,8711
1312,國喬,50,0,50,陽信-石牌,2023-01-17,8711
2891,中信金,50,0,50,陽信-石牌,2023-01-17,8711
2601,益航,205,165,40,陽信-石牌,2023-01-17,8711
1710,東聯,27,0,27,陽信-石牌,2023-01-17,8711
00679B,元大美債20年,21,0,21,陽信-石牌,2023-01-17,8711
00753L,中信中國50正2,20,0,20,陽信-石牌,2023-01-17,8711
6770,力積電,21,1,20,陽信-石牌,2023-01-17,8711
9933,中鼎,20,0,20,陽信-石牌,2023-01-17,8711
00676R,富邦臺灣加權反1,18,0,18,陽信-石牌,2023-01-17,8711
2002,中鋼,30,12,18,陽信-石牌,2023-01-17,8711
2201,裕隆,33,15,18,陽信-石牌,2023-01-17,8711
1519,華城,16,0,16,陽信-石牌,2023-01-17,8711
2317,鴻海,23,8,15,陽信-石牌,2023-01-17,8711
2439,美律,13,0,13,陽信-石牌,2023-01-17,8711
1722,台肥,12,0,12,陽信-石牌,2023-01-17,8711
2886,兆豐金,10,0,10,陽信-石牌,2023-01-17,8711
1701,中化,10,0,10,陽信-石牌,2023-01-17,8711
1463,強盛新,10,0,10,陽信-石牌,2023-01-17,8711
2607,榮運,10,0,10,陽信-石牌,2023-01-17,8711
2614,東森,10,0,10,陽信-石牌,2023-01-17,8711
3048,益登,10,0,10,陽信-石牌,2023-01-17,8711
4155,訊映,10,0,10,陽信-石牌,2023-01-17,8711
6155,鈞寶,10,0,10,陽信-石牌,2023-01-17,8711
2330,台積電,12,4,8,陽信-石牌,2023-01-17,8711
00632R,元大台灣50反1,13,5,8,陽信-石牌,2023-01-17,8711
2409,友達,8,0,8,陽信-石牌,2023-01-17,8711
2637,慧洋-KY,9,1,8,陽信-石牌,2023-01-17,8711
2812,台中銀,8,0,8,陽信-石牌,2023-01-17,8711
3494,誠研,8,0,8,陽信-石牌,2023-01-17,8711
4743,合一,12,4,8,陽信-石牌,2023-01-17,8711
6139,亞翔,8,0,8,陽信-石牌,2023-01-17,8711
6443,元晶,25,17,8,陽信-石牌,2023-01-17,8711
2027,大成鋼,8,0,8,陽信-石牌,2023-01-17,8711
8069,元太,14,6,8,陽信-石牌,2023-01-17,8711
2377,微星,10,3,7,陽信-石牌,2023-01-17,8711
1219,福壽,6,0,6,陽信-石牌,2023-01-17,8711
1734,杏輝,6,0,6,陽信-石牌,2023-01-17,8711
1795,美時,18,12,6,陽信-石牌,2023-01-17,8711
2049,上銀,9,3,6,陽信-石牌,2023-01-17,8711
2204,中華,6,0,6,陽信-石牌,2023-01-17,8711
3481,群創,6,0,6,陽信-石牌,2023-01-17,8711
4148,全宇生技-KY,6,0,6,陽信-石牌,2023-01-17,8711
1560,中砂,5,0,5,陽信-石牌,2023-01-17,8711
1101,台泥,7,2,5,陽信-石牌,2023-01-17,8711
00680L,元大美債20正2,5,0,5,陽信-石牌,2023-01-17,8711
2367,燿華,5,0,5,陽信-石牌,2023-01-17,8711
00728,第一金工業30,1200,0,1200,陽信-石牌,2023-01-30,8711
00878,國泰永續高股息,1202,22,1180,陽信-石牌,2023-01-30,8711
2408,南亞科,300,2,298,陽信-石牌,2023-01-30,8711
00881,國泰台灣5G+,310,63,247,陽信-石牌,2023-01-30,8711
00692,富邦公司治理,200,0,200,陽信-石牌,2023-01-30,8711
2342,茂矽,125,0,125,陽信-石牌,2023-01-30,8711
2358,廷鑫,63,0,63,陽信-石牌,2023-01-30,8711
4114,健喬,91,40,51,陽信-石牌,2023-01-30,8711
2102,泰豐,50,0,50,陽信-石牌,2023-01-30,8711
5536,聖暉*,50,0,50,陽信-石牌,2023-01-30,8711
00679B,元大美債20年,45,0,45,陽信-石牌,2023-01-30,8711
00676R,富邦臺灣加權反1,50,13,37,陽信-石牌,2023-01-30,8711
2317,鴻海,40,6,34,陽信-石牌,2023-01-30,8711
2607,榮運,25,0,25,陽信-石牌,2023-01-30,8711
2634,漢翔,25,0,25,陽信-石牌,2023-01-30,8711
4966,譜瑞-KY,22,0,22,陽信-石牌,2023-01-30,8711
2851,中再保,20,0,20,陽信-石牌,2023-01-30,8711
2891,中信金,21,1,20,陽信-石牌,2023-01-30,8711
8436,大江,20,0,20,陽信-石牌,2023-01-30,8711
2303,聯電,188,169,19,陽信-石牌,2023-01-30,8711
2415,錩新,21,2,19,陽信-石牌,2023-01-30,8711
2601,益航,44,26,18,陽信-石牌,2023-01-30,8711
2609,陽明,42,24,18,陽信-石牌,2023-01-30,8711
2892,第一金,14,0,14,陽信-石牌,2023-01-30,8711
6244,茂迪,13,0,13,陽信-石牌,2023-01-30,8711
6404,通訊-KY,12,0,12,陽信-石牌,2023-01-30,8711
2812,台中銀,11,0,11,陽信-石牌,2023-01-30,8711
2356,英業達,10,0,10,陽信-石牌,2023-01-30,8711
2617,台航,10,0,10,陽信-石牌,2023-01-30,8711
2748,雲品,10,0,10,陽信-石牌,2023-01-30,8711
8289,泰藝,10,0,10,陽信-石牌,2023-01-30,8711
00772B,中信高評級公司債,9,0,9,陽信-石牌,2023-01-30,8711
6139,亞翔,13,4,9,陽信-石牌,2023-01-30,8711
1526,日馳,8,0,8,陽信-石牌,2023-01-30,8711
2377,微星,10,2,8,陽信-石牌,2023-01-30,8711
6274,台燿,8,0,8,陽信-石牌,2023-01-30,8711
2481,強茂,8,1,7,陽信-石牌,2023-01-30,8711
3504,揚明光,7,0,7,陽信-石牌,2023-01-30,8711
4105,東洋,7,0,7,陽信-石牌,2023-01-30,8711
5608,四維航,36,29,7,陽信-石牌,2023-01-30,8711
6806,森崴能源,7,0,7,陽信-石牌,2023-01-30,8711
8069,元太,12,5,7,陽信-石牌,2023-01-30,8711
5425,台半,17,10,7,陽信-石牌,2023-01-30,8711
4175,杏一,9,3,6,陽信-石牌,2023-01-30,8711
6279,胡連,10,4,6,陽信-石牌,2023-01-30,8711
3034,聯詠,6,0,6,陽信-石牌,2023-01-30,8711
00894,中信小資高價30,5,0,5,陽信-石牌,2023-01-30,8711
2883,凱基金,5,0,5,陽信-石牌,2023-01-30,8711
3374,精材,11,6,5,陽信-石牌,2023-01-30,8711
5014,建錩,5,0,5,陽信-石牌,2023-01-30,8711
00728,第一金工業30,801,0,801,陽信-石牌,2023-01-31,8711
3558,神準,163,4,159,陽信-石牌,2023-01-31,8711
00902,中信電池及儲能,100,1,99,陽信-石牌,2023-01-31,8711
2409,友達,86,30,56,陽信-石牌,2023-01-31,8711
5536,聖暉*,46,0,46,陽信-石牌,2023-01-31,8711
2303,聯電,138,103,35,陽信-石牌,2023-01-31,8711
6188,廣明,32,0,32,陽信-石牌,2023-01-31,8711
00753L,中信中國50正2,30,0,30,陽信-石牌,2023-01-31,8711
00878,國泰永續高股息,35,5,30,陽信-石牌,2023-01-31,8711
2601,益航,31,2,29,陽信-石牌,2023-01-31,8711
00905,FT臺灣Smart,28,0,28,陽信-石牌,2023-01-31,8711
3045,台灣大,28,0,28,陽信-石牌,2023-01-31,8711
2891,中信金,26,0,26,陽信-石牌,2023-01-31,8711
2885,元大金,23,0,23,陽信-石牌,2023-01-31,8711
8105,凌巨,40,17,23,陽信-石牌,2023-01-31,8711
6451,訊芯-KY,21,0,21,陽信-石牌,2023-01-31,8711
2888,新光金,20,0,20,陽信-石牌,2023-01-31,8711
8227,巨有科技,20,0,20,陽信-石牌,2023-01-31,8711
2406,國碩,16,0,16,陽信-石牌,2023-01-31,8711
2412,中華電,15,0,15,陽信-石牌,2023-01-31,8711
2330,台積電,17,2,15,陽信-石牌,2023-01-31,8711
00900,富邦特選高股息30,12,0,12,陽信-石牌,2023-01-31,8711
2465,麗臺,13,1,12,陽信-石牌,2023-01-31,8711
2417,圓剛,11,0,11,陽信-石牌,2023-01-31,8711
3037,欣興,12,2,10,陽信-石牌,2023-01-31,8711
00772B,中信高評級公司債,10,0,10,陽信-石牌,2023-01-31,8711
020031,統一IC設計臺灣N,10,0,10,陽信-石牌,2023-01-31,8711
00665L,富邦�琤肭磪囓�2,38,28,10,陽信-石牌,2023-01-31,8711
00664R,國泰臺灣加權反1,10,0,10,陽信-石牌,2023-01-31,8711
1463,強盛新,10,0,10,陽信-石牌,2023-01-31,8711
1301,台塑,10,0,10,陽信-石牌,2023-01-31,8711
1785,光洋科,11,1,10,陽信-石牌,2023-01-31,8711
2313,華通,11,1,10,陽信-石牌,2023-01-31,8711
2887,台新金,10,0,10,陽信-石牌,2023-01-31,8711
2377,微星,10,1,9,陽信-石牌,2023-01-31,8711
2610,華航,12,3,9,陽信-石牌,2023-01-31,8711
6550,北極星藥業-KY,14,5,9,陽信-石牌,2023-01-31,8711
8069,元太,12,3,9,陽信-石牌,2023-01-31,8711
1101,台泥,10,2,8,陽信-石牌,2023-01-31,8711
0056,元大高股息,24,17,7,陽信-石牌,2023-01-31,8711
2359,所羅門,7,0,7,陽信-石牌,2023-01-31,8711
2408,南亞科,12,5,7,陽信-石牌,2023-01-31,8711
3711,日月光投控,7,0,7,陽信-石牌,2023-01-31,8711
1513,中興電,27,21,6,陽信-石牌,2023-01-31,8711
2880,華南金,6,0,6,陽信-石牌,2023-01-31,8711
3232,昱捷,6,0,6,陽信-石牌,2023-01-31,8711
5347,世界,7,1,6,陽信-石牌,2023-01-31,8711
6202,盛群,6,0,6,陽信-石牌,2023-01-31,8711
6237,驊訊,7,1,6,陽信-石牌,2023-01-31,8711
6712,長聖,6,0,6,陽信-石牌,2023-01-31,8711
00881,國泰台灣5G+,200,3,197,陽信-石牌,2023-02-01,8711
00715L,期街口布蘭特正2,163,0,163,陽信-石牌,2023-02-01,8711
3305,昇貿,113,3,110,陽信-石牌,2023-02-01,8711
6244,茂迪,73,4,69,陽信-石牌,2023-02-01,8711
6188,廣明,50,0,50,陽信-石牌,2023-02-01,8711
2353,宏��,56,10,46,陽信-石牌,2023-02-01,8711
00905,FT臺灣Smart,40,0,40,陽信-石牌,2023-02-01,8711
2323,中環,40,2,38,陽信-石牌,2023-02-01,8711
2303,聯電,217,186,31,陽信-石牌,2023-02-01,8711
8436,大江,25,0,25,陽信-石牌,2023-02-01,8711
2014,中鴻,31,8,23,陽信-石牌,2023-02-01,8711
2377,微星,20,0,20,陽信-石牌,2023-02-01,8711
2444,兆勁,20,0,20,陽信-石牌,2023-02-01,8711
6770,力積電,29,9,20,陽信-石牌,2023-02-01,8711
6796,晉弘,20,0,20,陽信-石牌,2023-02-01,8711
2312,金寶,20,1,19,陽信-石牌,2023-02-01,8711
6589,台康生技,16,0,16,陽信-石牌,2023-02-01,8711
3481,群創,38,22,16,陽信-石牌,2023-02-01,8711
2104,國際中橡,15,0,15,陽信-石牌,2023-02-01,8711
2412,中華電,15,0,15,陽信-石牌,2023-02-01,8711
2317,鴻海,20,6,14,陽信-石牌,2023-02-01,8711
6689,伊雲谷,14,0,14,陽信-石牌,2023-02-01,8711
2201,裕隆,62,49,13,陽信-石牌,2023-02-01,8711
1513,中興電,30,17,13,陽信-石牌,2023-02-01,8711
2614,東森,13,0,13,陽信-石牌,2023-02-01,8711
1760,寶齡富錦,11,0,11,陽信-石牌,2023-02-01,8711
2618,長榮航,41,30,11,陽信-石牌,2023-02-01,8711
3037,欣興,21,10,11,陽信-石牌,2023-02-01,8711
6550,北極星藥業-KY,11,0,11,陽信-石牌,2023-02-01,8711
0050,元大台灣50,10,0,10,陽信-石牌,2023-02-01,8711
1611,中電,10,0,10,陽信-石牌,2023-02-01,8711
1752,南光,11,1,10,陽信-石牌,2023-02-01,8711
3041,揚智,10,0,10,陽信-石牌,2023-02-01,8711
3607,谷崧,10,0,10,陽信-石牌,2023-02-01,8711
4171,瑞基,10,0,10,陽信-石牌,2023-02-01,8711
5351,鈺創,18,8,10,陽信-石牌,2023-02-01,8711
6274,台燿,12,2,10,陽信-石牌,2023-02-01,8711
9103,美德醫療-DR,10,0,10,陽信-石牌,2023-02-01,8711
9105,泰金寶-DR,10,0,10,陽信-石牌,2023-02-01,8711
1909,榮成,10,1,9,陽信-石牌,2023-02-01,8711
5347,世界,10,1,9,陽信-石牌,2023-02-01,8711
02002L,兆豐富櫃200正二N,8,0,8,陽信-石牌,2023-02-01,8711
2548,華固,13,5,8,陽信-石牌,2023-02-01,8711
3624,光頡,13,5,8,陽信-石牌,2023-02-01,8711
2891,中信金,8,0,8,陽信-石牌,2023-02-01,8711
3545,敦泰,11,3,8,陽信-石牌,2023-02-01,8711
00637L,元大滬深300正2,7,0,7,陽信-石牌,2023-02-01,8711
1722,台肥,6,0,6,陽信-石牌,2023-02-01,8711
2049,上銀,6,0,6,陽信-石牌,2023-02-01,8711
2748,雲品,6,0,6,陽信-石牌,2023-02-01,8711
00878,國泰永續高股息,2030,36,1994,陽信-石牌,2023-02-02,8711
3305,昇貿,428,2,426,陽信-石牌,2023-02-02,8711
00885,富邦越南,223,0,223,陽信-石牌,2023-02-02,8711
6244,茂迪,165,5,160,陽信-石牌,2023-02-02,8711
2102,泰豐,100,0,100,陽信-石牌,2023-02-02,8711
2618,長榮航,327,237,90,陽信-石牌,2023-02-02,8711
2317,鴻海,62,3,59,陽信-石牌,2023-02-02,8711
2337,旺宏,80,21,59,陽信-石牌,2023-02-02,8711
00895,富邦未來車,55,0,55,陽信-石牌,2023-02-02,8711
2413,環科,61,8,53,陽信-石牌,2023-02-02,8711
00882,中信中國高股息,51,0,51,陽信-石牌,2023-02-02,8711
1609,大亞,69,18,51,陽信-石牌,2023-02-02,8711
2314,台揚,50,1,49,陽信-石牌,2023-02-02,8711
2891,中信金,46,0,46,陽信-石牌,2023-02-02,8711
1444,力麗,40,0,40,陽信-石牌,2023-02-02,8711
0056,元大高股息,42,3,39,陽信-石牌,2023-02-02,8711
2439,美律,37,1,36,陽信-石牌,2023-02-02,8711
00632R,元大台灣50反1,34,0,34,陽信-石牌,2023-02-02,8711
2492,華新科,38,5,33,陽信-石牌,2023-02-02,8711
2801,彰銀,33,0,33,陽信-石牌,2023-02-02,8711
6284,佳邦,42,9,33,陽信-石牌,2023-02-02,8711
2022,聚亨,30,2,28,陽信-石牌,2023-02-02,8711
00671R,富邦NASDAQ反1,23,0,23,陽信-石牌,2023-02-02,8711
6188,廣明,23,0,23,陽信-石牌,2023-02-02,8711
2201,裕隆,78,55,23,陽信-石牌,2023-02-02,8711
2884,玉山金,19,0,19,陽信-石牌,2023-02-02,8711
5309,系統電,20,3,17,陽信-石牌,2023-02-02,8711
00664R,國泰臺灣加權反1,15,0,15,陽信-石牌,2023-02-02,8711
5525,順天,15,0,15,陽信-石牌,2023-02-02,8711
5880,合庫金,15,0,15,陽信-石牌,2023-02-02,8711
6111,大宇資,16,1,15,陽信-石牌,2023-02-02,8711
3047,訊舟,12,0,12,陽信-石牌,2023-02-02,8711
8086,宏捷科,12,0,12,陽信-石牌,2023-02-02,8711
1529,樂事綠能,11,0,11,陽信-石牌,2023-02-02,8711
2461,光群雷,11,0,11,陽信-石牌,2023-02-02,8711
3088,艾訊,11,0,11,陽信-石牌,2023-02-02,8711
6274,台燿,11,0,11,陽信-石牌,2023-02-02,8711
6477,安集,11,0,11,陽信-石牌,2023-02-02,8711
8261,富鼎,11,0,11,陽信-石牌,2023-02-02,8711
2444,兆勁,15,5,10,陽信-石牌,2023-02-02,8711
2851,中再保,10,0,10,陽信-石牌,2023-02-02,8711
2886,兆豐金,10,0,10,陽信-石牌,2023-02-02,8711
2892,第一金,10,0,10,陽信-石牌,2023-02-02,8711
2313,華通,18,9,9,陽信-石牌,2023-02-02,8711
2511,太子,9,0,9,陽信-石牌,2023-02-02,8711
2542,興富發,9,0,9,陽信-石牌,2023-02-02,8711
3591,艾笛森,10,2,8,陽信-石牌,2023-02-02,8711
5321,美而快,11,3,8,陽信-石牌,2023-02-02,8711
6245,立端,8,0,8,陽信-石牌,2023-02-02,8711
1783,和康生,12,5,7,陽信-石牌,2023-02-02,8711
2303,聯電,712,25,687,陽信-石牌,2023-02-03,8711
6411,晶焱,281,9,272,陽信-石牌,2023-02-03,8711
6546,正基,245,0,245,陽信-石牌,2023-02-03,8711
5425,台半,192,0,192,陽信-石牌,2023-02-03,8711
6244,茂迪,160,4,156,陽信-石牌,2023-02-03,8711
6799,來頡,106,4,102,陽信-石牌,2023-02-03,8711
1609,大亞,74,5,69,陽信-石牌,2023-02-03,8711
2313,華通,56,5,51,陽信-石牌,2023-02-03,8711
00753L,中信中國50正2,50,0,50,陽信-石牌,2023-02-03,8711
3362,先進光,50,0,50,陽信-石牌,2023-02-03,8711
00878,國泰永續高股息,43,1,42,陽信-石牌,2023-02-03,8711
2611,志信,40,0,40,陽信-石牌,2023-02-03,8711
3037,欣興,51,16,35,陽信-石牌,2023-02-03,8711
2891,中信金,33,0,33,陽信-石牌,2023-02-03,8711
2022,聚亨,30,0,30,陽信-石牌,2023-02-03,8711
3508,位速,31,1,30,陽信-石牌,2023-02-03,8711
6806,森崴能源,30,1,29,陽信-石牌,2023-02-03,8711
2329,華泰,27,0,27,陽信-石牌,2023-02-03,8711
00900,富邦特選高股息30,27,1,26,陽信-石牌,2023-02-03,8711
2444,兆勁,25,0,25,陽信-石牌,2023-02-03,8711
2439,美律,24,0,24,陽信-石牌,2023-02-03,8711
2888,新光金,22,0,22,陽信-石牌,2023-02-03,8711
5608,四維航,22,1,21,陽信-石牌,2023-02-03,8711
4976,佳凌,20,0,20,陽信-石牌,2023-02-03,8711
2436,偉詮電,25,7,18,陽信-石牌,2023-02-03,8711
6770,力積電,24,8,16,陽信-石牌,2023-02-03,8711
2461,光群雷,15,0,15,陽信-石牌,2023-02-03,8711
3088,艾訊,15,0,15,陽信-石牌,2023-02-03,8711
3689,湧德,15,0,15,陽信-石牌,2023-02-03,8711
1752,南光,24,11,13,陽信-石牌,2023-02-03,8711
1101,台泥,12,0,12,陽信-石牌,2023-02-03,8711
1519,華城,21,9,12,陽信-石牌,2023-02-03,8711
4726,永昕,11,0,11,陽信-石牌,2023-02-03,8711
1443,立益物流,10,0,10,陽信-石牌,2023-02-03,8711
1325,恆大,10,0,10,陽信-石牌,2023-02-03,8711
00905,FT臺灣Smart,10,0,10,陽信-石牌,2023-02-03,8711
00653L,富邦印度正2,10,0,10,陽信-石牌,2023-02-03,8711
1810,和成,13,3,10,陽信-石牌,2023-02-03,8711
3046,建��,10,0,10,陽信-石牌,2023-02-03,8711
5009,榮剛,45,35,10,陽信-石牌,2023-02-03,8711
5258,虹堡,12,2,10,陽信-石牌,2023-02-03,8711
6239,力成,10,0,10,陽信-石牌,2023-02-03,8711
2409,友達,12,2,10,陽信-石牌,2023-02-03,8711
2317,鴻海,17,8,9,陽信-石牌,2023-02-03,8711
00665L,富邦�琤肭磪囓�2,37,28,9,陽信-石牌,2023-02-03,8711
2481,強茂,13,4,9,陽信-石牌,2023-02-03,8711
2882,國泰金,9,0,9,陽信-石牌,2023-02-03,8711
6477,安集,9,0,9,陽信-石牌,2023-02-03,8711
2332,友訊,8,0,8,陽信-石牌,2023-02-03,8711
5871,中租-KY,8,0,8,陽信-石牌,2023-02-03,8711
4919,新唐,409,1,408,陽信-石牌,2023-02-06,8711
8069,元太,121,3,118,陽信-石牌,2023-02-06,8711
4137,麗豐-KY,101,1,100,陽信-石牌,2023-02-06,8711
2303,聯電,82,21,61,陽信-石牌,2023-02-06,8711
1584,精剛,96,36,60,陽信-石牌,2023-02-06,8711
6799,來頡,55,0,55,陽信-石牌,2023-02-06,8711
1609,大亞,53,0,53,陽信-石牌,2023-02-06,8711
2883,凱基金,42,0,42,陽信-石牌,2023-02-06,8711
6282,康舒,138,101,37,陽信-石牌,2023-02-06,8711
6213,聯茂,31,0,31,陽信-石牌,2023-02-06,8711
6411,晶焱,33,3,30,陽信-石牌,2023-02-06,8711
2891,中信金,25,0,25,陽信-石牌,2023-02-06,8711
2344,華邦電,30,6,24,陽信-石牌,2023-02-06,8711
00878,國泰永續高股息,46,24,22,陽信-石牌,2023-02-06,8711
6116,彩晶,23,1,22,陽信-石牌,2023-02-06,8711
00900,富邦特選高股息30,21,0,21,陽信-石牌,2023-02-06,8711
1611,中電,21,0,21,陽信-石牌,2023-02-06,8711
1717,長興,30,10,20,陽信-石牌,2023-02-06,8711
1810,和成,20,0,20,陽信-石牌,2023-02-06,8711
2329,華泰,20,0,20,陽信-石牌,2023-02-06,8711
3508,位速,25,5,20,陽信-石牌,2023-02-06,8711
4804,大略-KY,20,0,20,陽信-石牌,2023-02-06,8711
2498,宏達電,32,13,19,陽信-石牌,2023-02-06,8711
3037,欣興,20,2,18,陽信-石牌,2023-02-06,8711
00715L,期街口布蘭特正2,17,0,17,陽信-石牌,2023-02-06,8711
2330,台積電,16,1,15,陽信-石牌,2023-02-06,8711
2609,陽明,20,5,15,陽信-石牌,2023-02-06,8711
2481,強茂,17,2,15,陽信-石牌,2023-02-06,8711
2603,長榮,29,14,15,陽信-石牌,2023-02-06,8711
2852,第一保,15,0,15,陽信-石牌,2023-02-06,8711
6770,力積電,18,4,14,陽信-石牌,2023-02-06,8711
3088,艾訊,13,0,13,陽信-石牌,2023-02-06,8711
3189,景碩,13,0,13,陽信-石牌,2023-02-06,8711
1605,華新,17,6,11,陽信-石牌,2023-02-06,8711
4138,曜亞,11,0,11,陽信-石牌,2023-02-06,8711
00882,中信中國高股息,10,0,10,陽信-石牌,2023-02-06,8711
00737,國泰AI+Robo,10,0,10,陽信-石牌,2023-02-06,8711
1514,亞力,10,0,10,陽信-石牌,2023-02-06,8711
2027,大成鋼,10,0,10,陽信-石牌,2023-02-06,8711
2834,臺企銀,10,0,10,陽信-石牌,2023-02-06,8711
3059,華晶科,10,0,10,陽信-石牌,2023-02-06,8711
4943,康控-KY,10,0,10,陽信-石牌,2023-02-06,8711
1760,寶齡富錦,17,8,9,陽信-石牌,2023-02-06,8711
2486,一詮,27,18,9,陽信-石牌,2023-02-06,8711
9907,統一實,10,1,9,陽信-石牌,2023-02-06,8711
1707,葡萄王,11,3,8,陽信-石牌,2023-02-06,8711
2601,益航,16,8,8,陽信-石牌,2023-02-06,8711
2883B,凱基金乙特,8,0,8,陽信-石牌,2023-02-06,8711
3444,利機,8,0,8,陽信-石牌,2023-02-06,8711
3707,漢磊,20,12,8,陽信-石牌,2023-02-06,8711
00878,國泰永續高股息,473,1,472,陽信-石牌,2023-02-07,8711
00895,富邦未來車,450,0,450,陽信-石牌,2023-02-07,8711
00715L,期街口布蘭特正2,217,6,211,陽信-石牌,2023-02-07,8711
5388,中磊,96,5,91,陽信-石牌,2023-02-07,8711
4721,美琪瑪,91,5,86,陽信-石牌,2023-02-07,8711
2515,中工,80,0,80,陽信-石牌,2023-02-07,8711
2834,臺企銀,70,0,70,陽信-石牌,2023-02-07,8711
8933,愛地雅,61,1,60,陽信-石牌,2023-02-07,8711
1605,華新,243,194,49,陽信-石牌,2023-02-07,8711
1717,長興,40,0,40,陽信-石牌,2023-02-07,8711
2444,兆勁,32,0,32,陽信-石牌,2023-02-07,8711
2317,鴻海,26,0,26,陽信-石牌,2023-02-07,8711
6188,廣明,26,0,26,陽信-石牌,2023-02-07,8711
2344,華邦電,30,5,25,陽信-石牌,2023-02-07,8711
6244,茂迪,23,0,23,陽信-石牌,2023-02-07,8711
1810,和成,27,5,22,陽信-石牌,2023-02-07,8711
1440,南紡,20,0,20,陽信-石牌,2023-02-07,8711
1718,中纖,19,0,19,陽信-石牌,2023-02-07,8711
3059,華晶科,62,45,17,陽信-石牌,2023-02-07,8711
3189,景碩,17,0,17,陽信-石牌,2023-02-07,8711
2618,長榮航,36,20,16,陽信-石牌,2023-02-07,8711
5608,四維航,16,0,16,陽信-石牌,2023-02-07,8711
2103,台橡,51,36,15,陽信-石牌,2023-02-07,8711
1795,美時,51,38,13,陽信-石牌,2023-02-07,8711
4114,健喬,28,15,13,陽信-石牌,2023-02-07,8711
3128,昇銳,18,6,12,陽信-石牌,2023-02-07,8711
6806,森崴能源,12,0,12,陽信-石牌,2023-02-07,8711
2888,新光金,11,0,11,陽信-石牌,2023-02-07,8711
3088,艾訊,11,0,11,陽信-石牌,2023-02-07,8711
1409,新纖,10,0,10,陽信-石牌,2023-02-07,8711
2302,麗正,15,5,10,陽信-石牌,2023-02-07,8711
2408,南亞科,10,0,10,陽信-石牌,2023-02-07,8711
2736,富野,10,0,10,陽信-石牌,2023-02-07,8711
4939,亞電,10,0,10,陽信-石牌,2023-02-07,8711
5880,合庫金,10,0,10,陽信-石牌,2023-02-07,8711
6116,彩晶,10,0,10,陽信-石牌,2023-02-07,8711
8478,東哥遊艇,16,6,10,陽信-石牌,2023-02-07,8711
9105,泰金寶-DR,10,0,10,陽信-石牌,2023-02-07,8711
2603,長榮,8,0,8,陽信-石牌,2023-02-07,8711
2609,陽明,9,1,8,陽信-石牌,2023-02-07,8711
3535,晶彩科,8,0,8,陽信-石牌,2023-02-07,8711
2330,台積電,10,2,8,陽信-石牌,2023-02-07,8711
1443,立益物流,7,0,7,陽信-石牌,2023-02-07,8711
3041,揚智,7,0,7,陽信-石牌,2023-02-07,8711
1701,中化,18,12,6,陽信-石牌,2023-02-07,8711
2368,金像電,8,2,6,陽信-石牌,2023-02-07,8711
2743,山富,6,0,6,陽信-石牌,2023-02-07,8711
4142,國光生,6,0,6,陽信-石牌,2023-02-07,8711
4746,台耀,6,0,6,陽信-石牌,2023-02-07,8711
6589,台康生技,9,3,6,陽信-石牌,2023-02-07,8711
2634,漢翔,1232,14,1218,陽信-石牌,2023-02-08,8711
00878,國泰永續高股息,337,2,335,陽信-石牌,2023-02-08,8711
3624,光頡,261,10,251,陽信-石牌,2023-02-08,8711
2888,新光金,201,0,201,陽信-石牌,2023-02-08,8711
2601,益航,123,23,100,陽信-石牌,2023-02-08,8711
5388,中磊,95,2,93,陽信-石牌,2023-02-08,8711
2492,華新科,69,1,68,陽信-石牌,2023-02-08,8711
6282,康舒,142,76,66,陽信-石牌,2023-02-08,8711
2303,聯電,71,28,43,陽信-石牌,2023-02-08,8711
2515,中工,50,10,40,陽信-石牌,2023-02-08,8711
2882,國泰金,32,0,32,陽信-石牌,2023-02-08,8711
9105,泰金寶-DR,29,0,29,陽信-石牌,2023-02-08,8711
4529,淳紳,27,1,26,陽信-石牌,2023-02-08,8711
6142,友勁,30,4,26,陽信-石牌,2023-02-08,8711
2329,華泰,25,0,25,陽信-石牌,2023-02-08,8711
6443,元晶,23,1,22,陽信-石牌,2023-02-08,8711
8114,振樺電,22,0,22,陽信-石牌,2023-02-08,8711
2380,虹光,20,0,20,陽信-石牌,2023-02-08,8711
4903,聯光通,20,0,20,陽信-石牌,2023-02-08,8711
4961,天鈺,21,1,20,陽信-石牌,2023-02-08,8711
4934,太極,19,0,19,陽信-石牌,2023-02-08,8711
2317,鴻海,20,2,18,陽信-石牌,2023-02-08,8711
1605,華新,46,28,18,陽信-石牌,2023-02-08,8711
3022,威強電,30,12,18,陽信-石牌,2023-02-08,8711
1514,亞力,17,0,17,陽信-石牌,2023-02-08,8711
5608,四維航,17,0,17,陽信-石牌,2023-02-08,8711
2834,臺企銀,15,0,15,陽信-石牌,2023-02-08,8711
00885,富邦越南,15,1,14,陽信-石牌,2023-02-08,8711
1432,大魯閣,14,0,14,陽信-石牌,2023-02-08,8711
1584,精剛,15,1,14,陽信-石牌,2023-02-08,8711
6799,來頡,21,7,14,陽信-石牌,2023-02-08,8711
1417,嘉裕,13,0,13,陽信-石牌,2023-02-08,8711
3037,欣興,20,8,12,陽信-石牌,2023-02-08,8711
6509,聚和,18,6,12,陽信-石牌,2023-02-08,8711
6789,采鈺,11,0,11,陽信-石牌,2023-02-08,8711
1342,八貫,10,0,10,陽信-石牌,2023-02-08,8711
1229,聯華,10,0,10,陽信-石牌,2023-02-08,8711
1718,中纖,10,0,10,陽信-石牌,2023-02-08,8711
2031,新光鋼,10,0,10,陽信-石牌,2023-02-08,8711
2312,金寶,10,0,10,陽信-石牌,2023-02-08,8711
2867,三商壽,10,0,10,陽信-石牌,2023-02-08,8711
3078,僑威,10,0,10,陽信-石牌,2023-02-08,8711
3141,晶宏,11,1,10,陽信-石牌,2023-02-08,8711
3686,達能,10,0,10,陽信-石牌,2023-02-08,8711
4943,康控-KY,10,0,10,陽信-石牌,2023-02-08,8711
4977,眾達-KY,13,3,10,陽信-石牌,2023-02-08,8711
8033,雷虎,15,5,10,陽信-石牌,2023-02-08,8711
8049,晶采,10,0,10,陽信-石牌,2023-02-08,8711
8081,致新,11,1,10,陽信-石牌,2023-02-08,8711
8097,常珵,10,1,9,陽信-石牌,2023-02-08,8711
1591,駿吉-KY,171,0,171,陽信-石牌,2023-02-09,8711
3552,同致,122,4,118,陽信-石牌,2023-02-09,8711
2444,兆勁,95,0,95,陽信-石牌,2023-02-09,8711
3710,連展投控,80,1,79,陽信-石牌,2023-02-09,8711
8049,晶采,50,0,50,陽信-石牌,2023-02-09,8711
3059,華晶科,46,5,41,陽信-石牌,2023-02-09,8711
4533,協易機,47,6,41,陽信-石牌,2023-02-09,8711
00878,國泰永續高股息,40,0,40,陽信-石牌,2023-02-09,8711
2845,遠東銀,30,0,30,陽信-石牌,2023-02-09,8711
2867,三商壽,30,0,30,陽信-石牌,2023-02-09,8711
9105,泰金寶-DR,29,0,29,陽信-石牌,2023-02-09,8711
6129,普誠,24,1,23,陽信-石牌,2023-02-09,8711
2344,華邦電,41,20,21,陽信-石牌,2023-02-09,8711
2888,新光金,21,0,21,陽信-石牌,2023-02-09,8711
2801,彰銀,20,0,20,陽信-石牌,2023-02-09,8711
3041,揚智,20,0,20,陽信-石牌,2023-02-09,8711
2359,所羅門,15,0,15,陽信-石牌,2023-02-09,8711
8105,凌巨,15,0,15,陽信-石牌,2023-02-09,8711
8222,寶一,15,2,13,陽信-石牌,2023-02-09,8711
4721,美琪瑪,12,0,12,陽信-石牌,2023-02-09,8711
8044,網家,12,0,12,陽信-石牌,2023-02-09,8711
1810,和成,11,0,11,陽信-石牌,2023-02-09,8711
2492,華新科,15,4,11,陽信-石牌,2023-02-09,8711
3665,貿聯-KY,11,0,11,陽信-石牌,2023-02-09,8711
00902,中信電池及儲能,10,0,10,陽信-石牌,2023-02-09,8711
00673R,期元大S＆P原油反1,10,0,10,陽信-石牌,2023-02-09,8711
1434,福懋,10,0,10,陽信-石牌,2023-02-09,8711
2471,資通,10,0,10,陽信-石牌,2023-02-09,8711
2515,中工,10,0,10,陽信-石牌,2023-02-09,8711
2736,富野,10,0,10,陽信-石牌,2023-02-09,8711
3268,海德威,10,0,10,陽信-石牌,2023-02-09,8711
4114,健喬,44,34,10,陽信-石牌,2023-02-09,8711
4726,永昕,10,0,10,陽信-石牌,2023-02-09,8711
4960,誠美材,10,0,10,陽信-石牌,2023-02-09,8711
5251,天鉞電,15,5,10,陽信-石牌,2023-02-09,8711
6155,鈞寶,10,0,10,陽信-石牌,2023-02-09,8711
6278,台表科,10,0,10,陽信-石牌,2023-02-09,8711
2610,華航,10,1,9,陽信-石牌,2023-02-09,8711
3508,位速,10,1,9,陽信-石牌,2023-02-09,8711
6213,聯茂,9,0,9,陽信-石牌,2023-02-09,8711
2748,雲品,8,0,8,陽信-石牌,2023-02-09,8711
3580,友威科,14,6,8,陽信-石牌,2023-02-09,8711
6138,茂達,16,8,8,陽信-石牌,2023-02-09,8711
6477,安集,13,5,8,陽信-石牌,2023-02-09,8711
1514,亞力,10,3,7,陽信-石牌,2023-02-09,8711
1519,華城,7,0,7,陽信-石牌,2023-02-09,8711
2603,長榮,8,1,7,陽信-石牌,2023-02-09,8711
4919,新唐,23,16,7,陽信-石牌,2023-02-09,8711
5009,榮剛,17,10,7,陽信-石牌,2023-02-09,8711
6215,和椿,8,1,7,陽信-石牌,2023-02-09,8711
2409,友達,329,16,313,陽信-石牌,2023-02-10,8711
3231,緯創,308,1,307,陽信-石牌,2023-02-10,8711
2610,華航,102,0,102,陽信-石牌,2023-02-10,8711
6116,彩晶,54,0,54,陽信-石牌,2023-02-10,8711
2618,長榮航,59,8,51,陽信-石牌,2023-02-10,8711
00878,國泰永續高股息,45,0,45,陽信-石牌,2023-02-10,8711
3332,幸康,44,0,44,陽信-石牌,2023-02-10,8711
6282,康舒,72,28,44,陽信-石牌,2023-02-10,8711
5388,中磊,50,7,43,陽信-石牌,2023-02-10,8711
3037,欣興,33,1,32,陽信-石牌,2023-02-10,8711
2344,華邦電,34,3,31,陽信-石牌,2023-02-10,8711
1789,神隆,30,0,30,陽信-石牌,2023-02-10,8711
3707,漢磊,30,1,29,陽信-石牌,2023-02-10,8711
2609,陽明,25,0,25,陽信-石牌,2023-02-10,8711
6546,正基,35,11,24,陽信-石牌,2023-02-10,8711
3711,日月光投控,36,15,21,陽信-石牌,2023-02-10,8711
0056,元大高股息,17,0,17,陽信-石牌,2023-02-10,8711
3356,奇偶,16,0,16,陽信-石牌,2023-02-10,8711
1312,國喬,14,0,14,陽信-石牌,2023-02-10,8711
2888,新光金,13,0,13,陽信-石牌,2023-02-10,8711
1519,華城,16,3,13,陽信-石牌,2023-02-10,8711
2486,一詮,13,0,13,陽信-石牌,2023-02-10,8711
1417,嘉裕,12,0,12,陽信-石牌,2023-02-10,8711
1524,耿鼎,18,7,11,陽信-石牌,2023-02-10,8711
2367,燿華,11,0,11,陽信-石牌,2023-02-10,8711
2845,遠東銀,11,0,11,陽信-石牌,2023-02-10,8711
4739,康普,11,0,11,陽信-石牌,2023-02-10,8711
8038,長園科,17,6,11,陽信-石牌,2023-02-10,8711
2614,東森,11,1,10,陽信-石牌,2023-02-10,8711
00665L,富邦�琤肭磪囓�2,30,20,10,陽信-石牌,2023-02-10,8711
00637L,元大滬深300正2,10,0,10,陽信-石牌,2023-02-10,8711
1723,中碳,10,0,10,陽信-石牌,2023-02-10,8711
2891,中信金,10,0,10,陽信-石牌,2023-02-10,8711
3162,精確,10,0,10,陽信-石牌,2023-02-10,8711
3686,達能,10,0,10,陽信-石牌,2023-02-10,8711
4976,佳凌,10,0,10,陽信-石牌,2023-02-10,8711
6176,瑞儀,10,0,10,陽信-石牌,2023-02-10,8711
6188,廣明,10,0,10,陽信-石牌,2023-02-10,8711
6527,明達醫,10,0,10,陽信-石牌,2023-02-10,8711
8049,晶采,10,0,10,陽信-石牌,2023-02-10,8711
00885,富邦越南,11,2,9,陽信-石牌,2023-02-10,8711
00720B,元大投資級公司債,9,0,9,陽信-石牌,2023-02-10,8711
1605,華新,65,56,9,陽信-石牌,2023-02-10,8711
2376,技嘉,9,0,9,陽信-石牌,2023-02-10,8711
2401,凌陽,10,1,9,陽信-石牌,2023-02-10,8711
6278,台表科,9,0,9,陽信-石牌,2023-02-10,8711
3624,光頡,38,30,8,陽信-石牌,2023-02-10,8711
2603,長榮,10,3,7,陽信-石牌,2023-02-10,8711
2883,凱基金,8,1,7,陽信-石牌,2023-02-10,8711
3447,展達,9,2,7,陽信-石牌,2023-02-10,8711
6605,帝寶,175,5,170,陽信-石牌,2023-02-13,8711
2601,益航,150,2,148,陽信-石牌,2023-02-13,8711
2610,華航,82,4,78,陽信-石牌,2023-02-13,8711
00900,富邦特選高股息30,72,0,72,陽信-石牌,2023-02-13,8711
2388,威盛,64,1,63,陽信-石牌,2023-02-13,8711
1584,精剛,99,44,55,陽信-石牌,2023-02-13,8711
8049,晶采,40,0,40,陽信-石牌,2023-02-13,8711
00679B,元大美債20年,31,0,31,陽信-石牌,2023-02-13,8711
1701,中化,32,1,31,陽信-石牌,2023-02-13,8711
2102,泰豐,30,0,30,陽信-石牌,2023-02-13,8711
2409,友達,30,2,28,陽信-石牌,2023-02-13,8711
2618,長榮航,148,123,25,陽信-石牌,2023-02-13,8711
4746,台耀,22,1,21,陽信-石牌,2023-02-13,8711
2607,榮運,20,0,20,陽信-石牌,2023-02-13,8711
6443,元晶,23,3,20,陽信-石牌,2023-02-13,8711
00878,國泰永續高股息,20,1,19,陽信-石牌,2023-02-13,8711
1810,和成,20,1,19,陽信-石牌,2023-02-13,8711
00715L,期街口布蘭特正2,250,232,18,陽信-石牌,2023-02-13,8711
3289,宜特,15,0,15,陽信-石牌,2023-02-13,8711
2498,宏達電,22,8,14,陽信-石牌,2023-02-13,8711
2425,承啟,18,5,13,陽信-石牌,2023-02-13,8711
2449,京元電子,13,0,13,陽信-石牌,2023-02-13,8711
2888,新光金,13,0,13,陽信-石牌,2023-02-13,8711
4919,新唐,13,0,13,陽信-石牌,2023-02-13,8711
00885,富邦越南,12,0,12,陽信-石牌,2023-02-13,8711
0056,元大高股息,11,0,11,陽信-石牌,2023-02-13,8711
2317,鴻海,11,0,11,陽信-石牌,2023-02-13,8711
00893,國泰智能電動車,11,0,11,陽信-石牌,2023-02-13,8711
2201,裕隆,12,1,11,陽信-石牌,2023-02-13,8711
2603,長榮,12,1,11,陽信-石牌,2023-02-13,8711
00680L,元大美債20正2,10,0,10,陽信-石牌,2023-02-13,8711
1714,和桐,10,0,10,陽信-石牌,2023-02-13,8711
2812,台中銀,10,0,10,陽信-石牌,2023-02-13,8711
3548,兆利,10,0,10,陽信-石牌,2023-02-13,8711
4938,和碩,10,0,10,陽信-石牌,2023-02-13,8711
6155,鈞寶,10,0,10,陽信-石牌,2023-02-13,8711
6282,康舒,10,0,10,陽信-石牌,2023-02-13,8711
6643,M31,17,7,10,陽信-石牌,2023-02-13,8711
3037,欣興,10,1,9,陽信-石牌,2023-02-13,8711
6266,泰詠,14,6,8,陽信-石牌,2023-02-13,8711
8033,雷虎,9,1,8,陽信-石牌,2023-02-13,8711
00720B,元大投資級公司債,7,0,7,陽信-石牌,2023-02-13,8711
1101,台泥,11,4,7,陽信-石牌,2023-02-13,8711
2458,義隆,7,0,7,陽信-石牌,2023-02-13,8711
3504,揚明光,7,0,7,陽信-石牌,2023-02-13,8711
3508,位速,7,0,7,陽信-石牌,2023-02-13,8711
6205,詮欣,7,0,7,陽信-石牌,2023-02-13,8711
9907,統一實,7,0,7,陽信-石牌,2023-02-13,8711
2330,台積電,12,6,6,陽信-石牌,2023-02-13,8711
00653L,富邦印度正2,6,0,6,陽信-石牌,2023-02-13,8711
6104,創惟,127,3,124,陽信-石牌,2023-02-14,8711
00676R,富邦臺灣加權反1,105,0,105,陽信-石牌,2023-02-14,8711
00772B,中信高評級公司債,102,0,102,陽信-石牌,2023-02-14,8711
2388,威盛,78,3,75,陽信-石牌,2023-02-14,8711
6552,易華電,48,1,47,陽信-石牌,2023-02-14,8711
00679B,元大美債20年,40,0,40,陽信-石牌,2023-02-14,8711
4114,健喬,146,108,38,陽信-石牌,2023-02-14,8711
2014,中鴻,51,14,37,陽信-石牌,2023-02-14,8711
6140,訊達,40,5,35,陽信-石牌,2023-02-14,8711
2884,玉山金,52,19,33,陽信-石牌,2023-02-14,8711
2610,華航,37,6,31,陽信-石牌,2023-02-14,8711
2498,宏達電,30,0,30,陽信-石牌,2023-02-14,8711
6282,康舒,19,1,18,陽信-石牌,2023-02-14,8711
1540,喬福,16,0,16,陽信-石牌,2023-02-14,8711
6240,松崗,15,0,15,陽信-石牌,2023-02-14,8711
00720B,元大投資級公司債,13,0,13,陽信-石牌,2023-02-14,8711
00632R,元大台灣50反1,13,0,13,陽信-石牌,2023-02-14,8711
3552,同致,11,0,11,陽信-石牌,2023-02-14,8711
9105,泰金寶-DR,11,0,11,陽信-石牌,2023-02-14,8711
00885,富邦越南,10,0,10,陽信-石牌,2023-02-14,8711
2365,昆盈,10,0,10,陽信-石牌,2023-02-14,8711
2704,國賓,10,0,10,陽信-石牌,2023-02-14,8711
2845,遠東銀,10,0,10,陽信-石牌,2023-02-14,8711
2885,元大金,10,0,10,陽信-石牌,2023-02-14,8711
3706,神達,10,0,10,陽信-石牌,2023-02-14,8711
4716,大立,10,0,10,陽信-石牌,2023-02-14,8711
8049,晶采,10,0,10,陽信-石牌,2023-02-14,8711
8171,天宇,11,1,10,陽信-石牌,2023-02-14,8711
2511,太子,9,0,9,陽信-石牌,2023-02-14,8711
5608,四維航,8,0,8,陽信-石牌,2023-02-14,8711
1609,大亞,7,0,7,陽信-石牌,2023-02-14,8711
1795,美時,26,19,7,陽信-石牌,2023-02-14,8711
6806,森崴能源,7,0,7,陽信-石牌,2023-02-14,8711
2881,富邦金,6,0,6,陽信-石牌,2023-02-14,8711
5475,德宏,6,0,6,陽信-石牌,2023-02-14,8711
6550,北極星藥業-KY,6,0,6,陽信-石牌,2023-02-14,8711
2455,全新,5,0,5,陽信-石牌,2023-02-14,8711
2607,榮運,5,0,5,陽信-石牌,2023-02-14,8711
3141,晶宏,5,0,5,陽信-石牌,2023-02-14,8711
3217,優群,5,0,5,陽信-石牌,2023-02-14,8711
3289,宜特,8,3,5,陽信-石牌,2023-02-14,8711
4726,永昕,5,0,5,陽信-石牌,2023-02-14,8711
5871,中租-KY,5,0,5,陽信-石牌,2023-02-14,8711
6589,台康生技,6,1,5,陽信-石牌,2023-02-14,8711
8068,全達,5,0,5,陽信-石牌,2023-02-14,8711
00665L,富邦�琤肭磪囓�2,12,8,4,陽信-石牌,2023-02-14,8711
0056,元大高股息,4,0,4,陽信-石牌,2023-02-14,8711
1605,華新,94,90,4,陽信-石牌,2023-02-14,8711
1710,東聯,4,0,4,陽信-石牌,2023-02-14,8711
2009,第一銅,8,4,4,陽信-石牌,2023-02-14,8711
00673R,期元大S＆P原油反1,404,3,401,陽信-石牌,2023-02-15,8711
00772B,中信高評級公司債,213,0,213,陽信-石牌,2023-02-15,8711
2610,華航,121,1,120,陽信-石牌,2023-02-15,8711
00878,國泰永續高股息,115,1,114,陽信-石牌,2023-02-15,8711
8436,大江,95,0,95,陽信-石牌,2023-02-15,8711
8349,�矬�,108,18,90,陽信-石牌,2023-02-15,8711
6605,帝寶,81,8,73,陽信-石牌,2023-02-15,8711
6104,創惟,83,13,70,陽信-石牌,2023-02-15,8711
6271,同欣電,69,0,69,陽信-石牌,2023-02-15,8711
00900,富邦特選高股息30,65,0,65,陽信-石牌,2023-02-15,8711
1101,台泥,67,5,62,陽信-石牌,2023-02-15,8711
2330,台積電,33,5,28,陽信-石牌,2023-02-15,8711
2371,大同,30,2,28,陽信-石牌,2023-02-15,8711
6188,廣明,24,0,24,陽信-石牌,2023-02-15,8711
1514,亞力,32,10,22,陽信-石牌,2023-02-15,8711
2634,漢翔,24,2,22,陽信-石牌,2023-02-15,8711
6443,元晶,27,5,22,陽信-石牌,2023-02-15,8711
1718,中纖,40,19,21,陽信-石牌,2023-02-15,8711
3710,連展投控,21,0,21,陽信-石牌,2023-02-15,8711
2618,長榮航,20,0,20,陽信-石牌,2023-02-15,8711
2723,美食-KY,22,4,18,陽信-石牌,2023-02-15,8711
5425,台半,20,2,18,陽信-石牌,2023-02-15,8711
00882,中信中國高股息,16,0,16,陽信-石牌,2023-02-15,8711
00632R,元大台灣50反1,18,2,16,陽信-石牌,2023-02-15,8711
5512,力麒,20,5,15,陽信-石牌,2023-02-15,8711
2834,臺企銀,14,0,14,陽信-石牌,2023-02-15,8711
6140,訊達,14,0,14,陽信-石牌,2023-02-15,8711
6235,華孚,24,11,13,陽信-石牌,2023-02-15,8711
2891,中信金,13,0,13,陽信-石牌,2023-02-15,8711
4746,台耀,12,0,12,陽信-石牌,2023-02-15,8711
2886,兆豐金,11,0,11,陽信-石牌,2023-02-15,8711
6531,愛普*,16,5,11,陽信-石牌,2023-02-15,8711
3529,力旺,13,3,10,陽信-石牌,2023-02-15,8711
2014,中鴻,10,0,10,陽信-石牌,2023-02-15,8711
2641,正德,10,0,10,陽信-石牌,2023-02-15,8711
2702,華園,10,0,10,陽信-石牌,2023-02-15,8711
2867,三商壽,10,0,10,陽信-石牌,2023-02-15,8711
3706,神達,10,0,10,陽信-石牌,2023-02-15,8711
4943,康控-KY,10,0,10,陽信-石牌,2023-02-15,8711
6282,康舒,20,10,10,陽信-石牌,2023-02-15,8711
2002,中鋼,11,2,9,陽信-石牌,2023-02-15,8711
2705,六福,10,1,9,陽信-石牌,2023-02-15,8711
4976,佳凌,9,0,9,陽信-石牌,2023-02-15,8711
6191,精成科,10,1,9,陽信-石牌,2023-02-15,8711
8150,南茂,10,1,9,陽信-石牌,2023-02-15,8711
2351,順德,9,1,8,陽信-石牌,2023-02-15,8711
6101,寬魚國際,8,0,8,陽信-石牌,2023-02-15,8711
6770,力積電,9,1,8,陽信-石牌,2023-02-15,8711
3029,零壹,9,2,7,陽信-石牌,2023-02-15,8711
3356,奇偶,7,0,7,陽信-石牌,2023-02-15,8711
00715L,期街口布蘭特正2,218,0,218,陽信-石牌,2023-02-16,8711
8183,精星,169,0,169,陽信-石牌,2023-02-16,8711
6217,中探針,145,0,145,陽信-石牌,2023-02-16,8711
2880,華南金,100,0,100,陽信-石牌,2023-02-16,8711
2330,台積電,72,5,67,陽信-石牌,2023-02-16,8711
8349,�矬�,41,0,41,陽信-石牌,2023-02-16,8711
2439,美律,40,0,40,陽信-石牌,2023-02-16,8711
8436,大江,38,2,36,陽信-石牌,2023-02-16,8711
2102,泰豐,30,0,30,陽信-石牌,2023-02-16,8711
1609,大亞,72,42,30,陽信-石牌,2023-02-16,8711
00713,元大台灣高息低波,27,0,27,陽信-石牌,2023-02-16,8711
1108,幸福,25,0,25,陽信-石牌,2023-02-16,8711
8936,國統,23,0,23,陽信-石牌,2023-02-16,8711
2444,兆勁,25,5,20,陽信-石牌,2023-02-16,8711
4804,大略-KY,20,0,20,陽信-石牌,2023-02-16,8711
00679B,元大美債20年,19,0,19,陽信-石牌,2023-02-16,8711
3027,盛達,27,9,18,陽信-石牌,2023-02-16,8711
1513,中興電,36,21,15,陽信-石牌,2023-02-16,8711
2027,大成鋼,14,0,14,陽信-石牌,2023-02-16,8711
00772B,中信高評級公司債,19,6,13,陽信-石牌,2023-02-16,8711
2704,國賓,13,0,13,陽信-石牌,2023-02-16,8711
4915,致伸,15,2,13,陽信-石牌,2023-02-16,8711
1101,台泥,13,1,12,陽信-石牌,2023-02-16,8711
8171,天宇,11,0,11,陽信-石牌,2023-02-16,8711
1416,廣豐,10,0,10,陽信-石牌,2023-02-16,8711
00754B,群益AAA-AA公司,10,0,10,陽信-石牌,2023-02-16,8711
2603,長榮,27,17,10,陽信-石牌,2023-02-16,8711
2867,三商壽,10,0,10,陽信-石牌,2023-02-16,8711
1522,堤維西,9,0,9,陽信-石牌,2023-02-16,8711
3029,零壹,9,0,9,陽信-石牌,2023-02-16,8711
3037,欣興,21,12,9,陽信-石牌,2023-02-16,8711
4746,台耀,9,0,9,陽信-石牌,2023-02-16,8711
6605,帝寶,15,6,9,陽信-石牌,2023-02-16,8711
3290,東浦,8,0,8,陽信-石牌,2023-02-16,8711
8097,常珵,8,0,8,陽信-石牌,2023-02-16,8711
6126,信音,7,0,7,陽信-石牌,2023-02-16,8711
2606,裕民,6,0,6,陽信-石牌,2023-02-16,8711
2852,第一保,6,0,6,陽信-石牌,2023-02-16,8711
3010,華立,6,0,6,陽信-石牌,2023-02-16,8711
3105,穩懋,6,0,6,陽信-石牌,2023-02-16,8711
5905,南仁湖,6,0,6,陽信-石牌,2023-02-16,8711
6589,台康生技,7,1,6,陽信-石牌,2023-02-16,8711
00738U,期元大道瓊白銀,5,0,5,陽信-石牌,2023-02-16,8711
1447,力鵬,5,0,5,陽信-石牌,2023-02-16,8711
2009,第一銅,10,5,5,陽信-石牌,2023-02-16,8711
2329,華泰,5,0,5,陽信-石牌,2023-02-16,8711
2428,興勤,5,0,5,陽信-石牌,2023-02-16,8711
2468,華經,7,2,5,陽信-石牌,2023-02-16,8711
3308,聯德,5,0,5,陽信-石牌,2023-02-16,8711
4171,瑞基,5,0,5,陽信-石牌,2023-02-16,8711
00881,國泰台灣5G+,499,0,499,陽信-石牌,2023-02-17,8711
00713,元大台灣高息低波,310,0,310,陽信-石牌,2023-02-17,8711
3005,神基,220,0,220,陽信-石牌,2023-02-17,8711
2492,華新科,109,3,106,陽信-石牌,2023-02-17,8711
2303,聯電,68,27,41,陽信-石牌,2023-02-17,8711
2102,泰豐,40,0,40,陽信-石牌,2023-02-17,8711
6217,中探針,40,0,40,陽信-石牌,2023-02-17,8711
2201,裕隆,74,38,36,陽信-石牌,2023-02-17,8711
00679B,元大美債20年,34,0,34,陽信-石牌,2023-02-17,8711
1810,和成,42,11,31,陽信-石牌,2023-02-17,8711
1460,宏遠,30,0,30,陽信-石牌,2023-02-17,8711
2705,六福,30,0,30,陽信-石牌,2023-02-17,8711
6443,元晶,29,0,29,陽信-石牌,2023-02-17,8711
5340,建榮,25,0,25,陽信-石牌,2023-02-17,8711
2610,華航,50,27,23,陽信-石牌,2023-02-17,8711
2637,慧洋-KY,23,0,23,陽信-石牌,2023-02-17,8711
5425,台半,27,5,22,陽信-石牌,2023-02-17,8711
00680L,元大美債20正2,21,0,21,陽信-石牌,2023-02-17,8711
2607,榮運,25,5,20,陽信-石牌,2023-02-17,8711
2745,五福,20,0,20,陽信-石牌,2023-02-17,8711
3049,精金,20,0,20,陽信-石牌,2023-02-17,8711
2027,大成鋼,16,0,16,陽信-石牌,2023-02-17,8711
1417,嘉裕,15,0,15,陽信-石牌,2023-02-17,8711
6266,泰詠,15,0,15,陽信-石牌,2023-02-17,8711
2606,裕民,14,0,14,陽信-石牌,2023-02-17,8711
2419,仲琦,12,0,12,陽信-石牌,2023-02-17,8711
2497,怡利電,15,3,12,陽信-石牌,2023-02-17,8711
2618,長榮航,56,44,12,陽信-石牌,2023-02-17,8711
3234,光環,14,2,12,陽信-石牌,2023-02-17,8711
3236,千如,12,0,12,陽信-石牌,2023-02-17,8711
4538,大詠城,12,0,12,陽信-石牌,2023-02-17,8711
00772B,中信高評級公司債,11,0,11,陽信-石牌,2023-02-17,8711
2449,京元電子,11,0,11,陽信-石牌,2023-02-17,8711
2609,陽明,14,3,11,陽信-石牌,2023-02-17,8711
3376,新日興,11,0,11,陽信-石牌,2023-02-17,8711
00907,永豐優息存股,11,0,11,陽信-石牌,2023-02-17,8711
2739,寒舍,10,0,10,陽信-石牌,2023-02-17,8711
3037,欣興,11,1,10,陽信-石牌,2023-02-17,8711
3380,明泰,10,0,10,陽信-石牌,2023-02-17,8711
4931,新盛力,10,0,10,陽信-石牌,2023-02-17,8711
4956,光鋐,10,0,10,陽信-石牌,2023-02-17,8711
6161,捷波,10,0,10,陽信-石牌,2023-02-17,8711
6547,高端疫苗,10,0,10,陽信-石牌,2023-02-17,8711
8222,寶一,15,5,10,陽信-石牌,2023-02-17,8711
8436,大江,12,2,10,陽信-石牌,2023-02-17,8711
2330,台積電,9,1,8,陽信-石牌,2023-02-17,8711
2603,長榮,9,1,8,陽信-石牌,2023-02-17,8711
4961,天鈺,25,18,7,陽信-石牌,2023-02-17,8711
2009,第一銅,7,0,7,陽信-石牌,2023-02-17,8711
2486,一詮,7,0,7,陽信-石牌,2023-02-17,8711
3005,神基,200,0,200,陽信-石牌,2023-02-20,8711
00713,元大台灣高息低波,100,0,100,陽信-石牌,2023-02-20,8711
2208,台船,106,6,100,陽信-石牌,2023-02-20,8711
5283,禾聯碩,90,0,90,陽信-石牌,2023-02-20,8711
00878,國泰永續高股息,97,17,80,陽信-石牌,2023-02-20,8711
2492,華新科,68,2,66,陽信-石牌,2023-02-20,8711
00902,中信電池及儲能,63,2,61,陽信-石牌,2023-02-20,8711
2753,八方雲集,50,0,50,陽信-石牌,2023-02-20,8711
2401,凌陽,46,0,46,陽信-石牌,2023-02-20,8711
3231,緯創,40,2,38,陽信-石牌,2023-02-20,8711
6266,泰詠,30,0,30,陽信-石牌,2023-02-20,8711
2330,台積電,31,3,28,陽信-石牌,2023-02-20,8711
3714,富采,30,2,28,陽信-石牌,2023-02-20,8711
6438,迅得,26,0,26,陽信-石牌,2023-02-20,8711
5425,台半,27,4,23,陽信-石牌,2023-02-20,8711
00885,富邦越南,20,0,20,陽信-石牌,2023-02-20,8711
4916,事欣科,20,0,20,陽信-石牌,2023-02-20,8711
6164,華興,20,0,20,陽信-石牌,2023-02-20,8711
8436,大江,21,1,20,陽信-石牌,2023-02-20,8711
2610,華航,56,37,19,陽信-石牌,2023-02-20,8711
2340,台亞,18,0,18,陽信-石牌,2023-02-20,8711
2482,連宇,18,0,18,陽信-石牌,2023-02-20,8711
8349,�矬�,18,0,18,陽信-石牌,2023-02-20,8711
2706,第一店,17,0,17,陽信-石牌,2023-02-20,8711
8183,精星,17,0,17,陽信-石牌,2023-02-20,8711
2455,全新,16,0,16,陽信-石牌,2023-02-20,8711
4529,淳紳,16,0,16,陽信-石牌,2023-02-20,8711
6443,元晶,33,17,16,陽信-石牌,2023-02-20,8711
00633L,富邦上証正2,15,0,15,陽信-石牌,2023-02-20,8711
1762,中化生,15,0,15,陽信-石牌,2023-02-20,8711
2736,富野,30,15,15,陽信-石牌,2023-02-20,8711
4402,郡都開發,15,0,15,陽信-石牌,2023-02-20,8711
5880,合庫金,14,0,14,陽信-石牌,2023-02-20,8711
2201,裕隆,49,37,12,陽信-石牌,2023-02-20,8711
1529,樂事綠能,15,3,12,陽信-石牌,2023-02-20,8711
1709,和益,12,0,12,陽信-石牌,2023-02-20,8711
1727,中華化,11,0,11,陽信-石牌,2023-02-20,8711
6109,亞元,12,1,11,陽信-石牌,2023-02-20,8711
8227,巨有科技,12,1,11,陽信-石牌,2023-02-20,8711
00893,國泰智能電動車,10,0,10,陽信-石牌,2023-02-20,8711
2425,承啟,12,2,10,陽信-石牌,2023-02-20,8711
2890,永豐金,10,0,10,陽信-石牌,2023-02-20,8711
2897,王道銀行,10,0,10,陽信-石牌,2023-02-20,8711
5340,建榮,12,2,10,陽信-石牌,2023-02-20,8711
6244,茂迪,10,0,10,陽信-石牌,2023-02-20,8711
6282,康舒,154,144,10,陽信-石牌,2023-02-20,8711
3532,台勝科,9,0,9,陽信-石牌,2023-02-20,8711
1503,士電,10,2,8,陽信-石牌,2023-02-20,8711
2634,漢翔,20,12,8,陽信-石牌,2023-02-20,8711
3162,精確,10,2,8,陽信-石牌,2023-02-20,8711
2610,華航,337,34,303,陽信-石牌,2023-02-21,8711
00673R,期元大S＆P原油反1,280,5,275,陽信-石牌,2023-02-21,8711
5243,乙盛-KY,232,0,232,陽信-石牌,2023-02-21,8711
2436,偉詮電,124,0,124,陽信-石牌,2023-02-21,8711
2884,玉山金,176,74,102,陽信-石牌,2023-02-21,8711
2618,長榮航,351,253,98,陽信-石牌,2023-02-21,8711
3481,群創,153,66,87,陽信-石牌,2023-02-21,8711
00902,中信電池及儲能,84,8,76,陽信-石牌,2023-02-21,8711
6274,台燿,75,0,75,陽信-石牌,2023-02-21,8711
9105,泰金寶-DR,50,0,50,陽信-石牌,2023-02-21,8711
00725B,國泰投資級公司債,41,0,41,陽信-石牌,2023-02-21,8711
2607,榮運,39,2,37,陽信-石牌,2023-02-21,8711
00885,富邦越南,31,0,31,陽信-石牌,2023-02-21,8711
00753L,中信中國50正2,30,0,30,陽信-石牌,2023-02-21,8711
2419,仲琦,30,0,30,陽信-石牌,2023-02-21,8711
3047,訊舟,30,1,29,陽信-石牌,2023-02-21,8711
5283,禾聯碩,26,0,26,陽信-石牌,2023-02-21,8711
8086,宏捷科,26,0,26,陽信-石牌,2023-02-21,8711
2457,飛宏,40,19,21,陽信-石牌,2023-02-21,8711
3221,台嘉碩,20,0,20,陽信-石牌,2023-02-21,8711
4804,大略-KY,20,0,20,陽信-石牌,2023-02-21,8711
5512,力麒,20,0,20,陽信-石牌,2023-02-21,8711
2401,凌陽,21,3,18,陽信-石牌,2023-02-21,8711
00665L,富邦�琤肭磪囓�2,42,25,17,陽信-石牌,2023-02-21,8711
1437,勤益控,16,0,16,陽信-石牌,2023-02-21,8711
2201,裕隆,68,52,16,陽信-石牌,2023-02-21,8711
2206,三陽工業,16,0,16,陽信-石牌,2023-02-21,8711
2330,台積電,17,4,13,陽信-石牌,2023-02-21,8711
2739,寒舍,11,0,11,陽信-石牌,2023-02-21,8711
3710,連展投控,12,1,11,陽信-石牌,2023-02-21,8711
8358,金居,12,1,11,陽信-石牌,2023-02-21,8711
2736,富野,10,0,10,陽信-石牌,2023-02-21,8711
2885,元大金,10,0,10,陽信-石牌,2023-02-21,8711
3356,奇偶,10,0,10,陽信-石牌,2023-02-21,8711
3693,營邦,11,1,10,陽信-石牌,2023-02-21,8711
4564,元翎,10,0,10,陽信-石牌,2023-02-21,8711
5388,中磊,10,0,10,陽信-石牌,2023-02-21,8711
4961,天鈺,23,14,9,陽信-石牌,2023-02-21,8711
2461,光群雷,10,1,9,陽信-石牌,2023-02-21,8711
2601,益航,11,2,9,陽信-石牌,2023-02-21,8711
2617,台航,10,1,9,陽信-石牌,2023-02-21,8711
1101,台泥,8,0,8,陽信-石牌,2023-02-21,8711
1605,華新,84,76,8,陽信-石牌,2023-02-21,8711
4979,華星光,37,29,8,陽信-石牌,2023-02-21,8711
8097,常珵,10,2,8,陽信-石牌,2023-02-21,8711
2402,毅嘉,9,2,7,陽信-石牌,2023-02-21,8711
2867,三商壽,7,0,7,陽信-石牌,2023-02-21,8711
3058,立德,7,0,7,陽信-石牌,2023-02-21,8711
3228,金麗科,8,1,7,陽信-石牌,2023-02-21,8711
4968,立積,9,2,7,陽信-石牌,2023-02-21,8711
5243,乙盛-KY,117,0,117,陽信-石牌,2023-02-22,8711
00720B,元大投資級公司債,109,0,109,陽信-石牌,2023-02-22,8711
2436,偉詮電,92,5,87,陽信-石牌,2023-02-22,8711
1519,華城,114,29,85,陽信-石牌,2023-02-22,8711
2504,國產,70,0,70,陽信-石牌,2023-02-22,8711
2618,長榮航,174,134,40,陽信-石牌,2023-02-22,8711
4960,誠美材,40,0,40,陽信-石牌,2023-02-22,8711
00725B,國泰投資級公司債,32,0,32,陽信-石牌,2023-02-22,8711
6116,彩晶,35,3,32,陽信-石牌,2023-02-22,8711
2017,官田鋼,30,0,30,陽信-石牌,2023-02-22,8711
3710,連展投控,30,0,30,陽信-石牌,2023-02-22,8711
8436,大江,26,0,26,陽信-石牌,2023-02-22,8711
00893,國泰智能電動車,25,0,25,陽信-石牌,2023-02-22,8711
2705,六福,31,10,21,陽信-石牌,2023-02-22,8711
2702,華園,21,1,20,陽信-石牌,2023-02-22,8711
3290,東浦,20,0,20,陽信-石牌,2023-02-22,8711
4903,聯光通,20,0,20,陽信-石牌,2023-02-22,8711
1609,大亞,27,9,18,陽信-石牌,2023-02-22,8711
1584,精剛,19,2,17,陽信-石牌,2023-02-22,8711
2330,台積電,18,2,16,陽信-石牌,2023-02-22,8711
00715L,期街口布蘭特正2,15,0,15,陽信-石牌,2023-02-22,8711
00753L,中信中國50正2,15,0,15,陽信-石牌,2023-02-22,8711
8927,北基,14,0,14,陽信-石牌,2023-02-22,8711
8222,寶一,51,38,13,陽信-石牌,2023-02-22,8711
2455,全新,12,0,12,陽信-石牌,2023-02-22,8711
00751B,元大AAA至A公司債,11,0,11,陽信-石牌,2023-02-22,8711
00680L,元大美債20正2,14,3,11,陽信-石牌,2023-02-22,8711
4976,佳凌,11,0,11,陽信-石牌,2023-02-22,8711
00687B,國泰20年美債,10,0,10,陽信-石牌,2023-02-22,8711
2371,大同,11,1,10,陽信-石牌,2023-02-22,8711
2615,萬海,16,6,10,陽信-石牌,2023-02-22,8711
2634,漢翔,18,8,10,陽信-石牌,2023-02-22,8711
3035,智原,14,4,10,陽信-石牌,2023-02-22,8711
3508,位速,20,10,10,陽信-石牌,2023-02-22,8711
5227,立凱-KY,10,0,10,陽信-石牌,2023-02-22,8711
6005,群益證,10,0,10,陽信-石牌,2023-02-22,8711
00900,富邦特選高股息30,10,1,9,陽信-石牌,2023-02-22,8711
00665L,富邦�琤肭磪囓�2,37,28,9,陽信-石牌,2023-02-22,8711
00773B,中信優先金融債,8,0,8,陽信-石牌,2023-02-22,8711
2607,榮運,15,7,8,陽信-石牌,2023-02-22,8711
4743,合一,8,0,8,陽信-石牌,2023-02-22,8711
6285,啟��,8,0,8,陽信-石牌,2023-02-22,8711
00679B,元大美債20年,7,0,7,陽信-石牌,2023-02-22,8711
00902,中信電池及儲能,7,0,7,陽信-石牌,2023-02-22,8711
2023,燁輝,7,0,7,陽信-石牌,2023-02-22,8711
2303,聯電,28,21,7,陽信-石牌,2023-02-22,8711
6176,瑞儀,7,0,7,陽信-石牌,2023-02-22,8711
8054,安國,11,4,7,陽信-石牌,2023-02-22,8711
8105,凌巨,7,0,7,陽信-石牌,2023-02-22,8711
4961,天鈺,8,1,7,陽信-石牌,2023-02-22,8711
6274,台燿,201,0,201,陽信-石牌,2023-02-23,8711
00902,中信電池及儲能,103,0,103,陽信-石牌,2023-02-23,8711
2371,大同,92,0,92,陽信-石牌,2023-02-23,8711
3481,群創,175,96,79,陽信-石牌,2023-02-23,8711
6266,泰詠,70,5,65,陽信-石牌,2023-02-23,8711
00893,國泰智能電動車,51,0,51,陽信-石牌,2023-02-23,8711
2017,官田鋼,51,0,51,陽信-石牌,2023-02-23,8711
00895,富邦未來車,50,0,50,陽信-石牌,2023-02-23,8711
5283,禾聯碩,50,0,50,陽信-石牌,2023-02-23,8711
8213,志超,50,0,50,陽信-石牌,2023-02-23,8711
2492,華新科,32,1,31,陽信-石牌,2023-02-23,8711
6116,彩晶,37,7,30,陽信-石牌,2023-02-23,8711
2344,華邦電,27,1,26,陽信-石牌,2023-02-23,8711
2882,國泰金,26,0,26,陽信-石牌,2023-02-23,8711
3027,盛達,31,10,21,陽信-石牌,2023-02-23,8711
5464,霖宏,22,1,21,陽信-石牌,2023-02-23,8711
2883,凱基金,27,7,20,陽信-石牌,2023-02-23,8711
00712,復華富時不動產,20,0,20,陽信-石牌,2023-02-23,8711
3005,神基,20,0,20,陽信-石牌,2023-02-23,8711
1605,華新,39,20,19,陽信-石牌,2023-02-23,8711
1701,中化,24,5,19,陽信-石牌,2023-02-23,8711
00632R,元大台灣50反1,17,0,17,陽信-石牌,2023-02-23,8711
1417,嘉裕,17,0,17,陽信-石牌,2023-02-23,8711
6148,驊宏資,20,3,17,陽信-石牌,2023-02-23,8711
2457,飛宏,16,0,16,陽信-石牌,2023-02-23,8711
1444,力麗,15,0,15,陽信-石牌,2023-02-23,8711
6517,保勝光學,19,4,15,陽信-石牌,2023-02-23,8711
2377,微星,15,1,14,陽信-石牌,2023-02-23,8711
1810,和成,23,9,14,陽信-石牌,2023-02-23,8711
2748,雲品,18,5,13,陽信-石牌,2023-02-23,8711
5512,力麒,14,1,13,陽信-石牌,2023-02-23,8711
6806,森崴能源,15,2,13,陽信-石牌,2023-02-23,8711
2436,偉詮電,12,0,12,陽信-石牌,2023-02-23,8711
3252,海灣,12,0,12,陽信-石牌,2023-02-23,8711
6235,華孚,29,17,12,陽信-石牌,2023-02-23,8711
3673,TPK-KY,17,6,11,陽信-石牌,2023-02-23,8711
00753L,中信中國50正2,10,0,10,陽信-石牌,2023-02-23,8711
2444,兆勁,15,5,10,陽信-石牌,2023-02-23,8711
2634,漢翔,10,0,10,陽信-石牌,2023-02-23,8711
8016,矽創,11,1,10,陽信-石牌,2023-02-23,8711
8044,網家,12,2,10,陽信-石牌,2023-02-23,8711
8222,寶一,12,2,10,陽信-石牌,2023-02-23,8711
0056,元大高股息,17,8,9,陽信-石牌,2023-02-23,8711
2610,華航,12,3,9,陽信-石牌,2023-02-23,8711
6443,元晶,16,7,9,陽信-石牌,2023-02-23,8711
1342,八貫,9,1,8,陽信-石牌,2023-02-23,8711
2401,凌陽,8,0,8,陽信-石牌,2023-02-23,8711
00637L,元大滬深300正2,23,16,7,陽信-石牌,2023-02-23,8711
00715L,期街口布蘭特正2,27,20,7,陽信-石牌,2023-02-23,8711
1514,亞力,32,25,7,陽信-石牌,2023-02-23,8711
00715L,期街口布蘭特正2,210,0,210,陽信-石牌,2023-02-24,8711
5512,力麒,161,12,149,陽信-石牌,2023-02-24,8711
6026,福邦證,122,0,122,陽信-石牌,2023-02-24,8711
2324,仁寶,120,1,119,陽信-石牌,2023-02-24,8711
00878,國泰永續高股息,69,0,69,陽信-石牌,2023-02-24,8711
6126,信音,62,0,62,陽信-石牌,2023-02-24,8711
00633L,富邦上証正2,61,0,61,陽信-石牌,2023-02-24,8711
2371,大同,50,0,50,陽信-石牌,2023-02-24,8711
2317,鴻海,53,5,48,陽信-石牌,2023-02-24,8711
6188,廣明,49,1,48,陽信-石牌,2023-02-24,8711
8436,大江,42,0,42,陽信-石牌,2023-02-24,8711
3037,欣興,38,2,36,陽信-石牌,2023-02-24,8711
1605,華新,108,72,36,陽信-石牌,2023-02-24,8711
2444,兆勁,35,1,34,陽信-石牌,2023-02-24,8711
2230,泰茂,31,5,26,陽信-石牌,2023-02-24,8711
00665L,富邦�琤肭磪囓�2,54,29,25,陽信-石牌,2023-02-24,8711
2368,金像電,36,13,23,陽信-石牌,2023-02-24,8711
1314,中石化,20,0,20,陽信-石牌,2023-02-24,8711
00753L,中信中國50正2,20,0,20,陽信-石牌,2023-02-24,8711
2104,國際中橡,20,0,20,陽信-石牌,2023-02-24,8711
2882,國泰金,20,0,20,陽信-石牌,2023-02-24,8711
4804,大略-KY,20,0,20,陽信-石牌,2023-02-24,8711
6116,彩晶,20,0,20,陽信-石牌,2023-02-24,8711
6806,森崴能源,26,7,19,陽信-石牌,2023-02-24,8711
00637L,元大滬深300正2,23,5,18,陽信-石牌,2023-02-24,8711
8033,雷虎,24,6,18,陽信-石牌,2023-02-24,8711
2344,華邦電,47,30,17,陽信-石牌,2023-02-24,8711
1444,力麗,15,1,14,陽信-石牌,2023-02-24,8711
2603,長榮,35,22,13,陽信-石牌,2023-02-24,8711
2002,中鋼,15,2,13,陽信-石牌,2023-02-24,8711
2436,偉詮電,13,0,13,陽信-石牌,2023-02-24,8711
2618,長榮航,13,0,13,陽信-石牌,2023-02-24,8711
2330,台積電,14,1,13,陽信-石牌,2023-02-24,8711
4114,健喬,15,4,11,陽信-石牌,2023-02-24,8711
4967,十銓,14,3,11,陽信-石牌,2023-02-24,8711
6531,愛普*,25,14,11,陽信-石牌,2023-02-24,8711
2461,光群雷,10,0,10,陽信-石牌,2023-02-24,8711
2501,國建,10,0,10,陽信-石牌,2023-02-24,8711
3264,欣銓,10,0,10,陽信-石牌,2023-02-24,8711
3540,曜越,10,0,10,陽信-石牌,2023-02-24,8711
5014,建錩,10,0,10,陽信-石牌,2023-02-24,8711
9955,佳龍,10,0,10,陽信-石牌,2023-02-24,8711
00900,富邦特選高股息30,10,1,9,陽信-石牌,2023-02-24,8711
2607,榮運,30,21,9,陽信-石牌,2023-02-24,8711
2641,正德,19,10,9,陽信-石牌,2023-02-24,8711
3664,安瑞-KY,10,1,9,陽信-石牌,2023-02-24,8711
4128,中天,9,0,9,陽信-石牌,2023-02-24,8711
6179,亞通,9,0,9,陽信-石牌,2023-02-24,8711
6411,晶焱,9,0,9,陽信-石牌,2023-02-24,8711
1218,泰山,8,0,8,陽信-石牌,2023-02-24,8711
2324,仁寶,549,2,547,陽信-石牌,2023-03-01,8711
2006,東和鋼鐵,300,0,300,陽信-石牌,2023-03-01,8711
6274,台燿,134,0,134,陽信-石牌,2023-03-01,8711
2610,華航,110,8,102,陽信-石牌,2023-03-01,8711
8938,明安,90,0,90,陽信-石牌,2023-03-01,8711
00878,國泰永續高股息,86,0,86,陽信-石牌,2023-03-01,8711
00753L,中信中國50正2,80,0,80,陽信-石牌,2023-03-01,8711
2344,華邦電,76,2,74,陽信-石牌,2023-03-01,8711
2022,聚亨,60,0,60,陽信-石牌,2023-03-01,8711
2430,燦坤,60,1,59,陽信-石牌,2023-03-01,8711
1605,華新,264,206,58,陽信-石牌,2023-03-01,8711
2102,泰豐,50,0,50,陽信-石牌,2023-03-01,8711
8213,志超,50,0,50,陽信-石牌,2023-03-01,8711
2882,國泰金,46,4,42,陽信-石牌,2023-03-01,8711
2888,新光金,40,0,40,陽信-石牌,2023-03-01,8711
5608,四維航,52,16,36,陽信-石牌,2023-03-01,8711
6266,泰詠,47,15,32,陽信-石牌,2023-03-01,8711
2409,友達,88,57,31,陽信-石牌,2023-03-01,8711
5283,禾聯碩,30,0,30,陽信-石牌,2023-03-01,8711
2303,聯電,51,22,29,陽信-石牌,2023-03-01,8711
3652,精聯,48,22,26,陽信-石牌,2023-03-01,8711
00712,復華富時不動產,25,0,25,陽信-石牌,2023-03-01,8711
2017,官田鋼,23,0,23,陽信-石牌,2023-03-01,8711
2618,長榮航,22,0,22,陽信-石牌,2023-03-01,8711
6188,廣明,22,1,21,陽信-石牌,2023-03-01,8711
6806,森崴能源,21,0,21,陽信-石牌,2023-03-01,8711
1718,中纖,20,0,20,陽信-石牌,2023-03-01,8711
2002,中鋼,24,4,20,陽信-石牌,2023-03-01,8711
2392,正崴,20,0,20,陽信-石牌,2023-03-01,8711
6116,彩晶,25,5,20,陽信-石牌,2023-03-01,8711
5880,合庫金,21,2,19,陽信-石牌,2023-03-01,8711
2455,全新,18,0,18,陽信-石牌,2023-03-01,8711
4927,泰鼎-KY,25,8,17,陽信-石牌,2023-03-01,8711
2492,華新科,16,0,16,陽信-石牌,2023-03-01,8711
1810,和成,15,0,15,陽信-石牌,2023-03-01,8711
2498,宏達電,29,17,12,陽信-石牌,2023-03-01,8711
5464,霖宏,15,3,12,陽信-石牌,2023-03-01,8711
1524,耿鼎,10,0,10,陽信-石牌,2023-03-01,8711
1529,樂事綠能,15,5,10,陽信-石牌,2023-03-01,8711
1909,榮成,10,0,10,陽信-石牌,2023-03-01,8711
2027,大成鋼,10,0,10,陽信-石牌,2023-03-01,8711
2031,新光鋼,11,1,10,陽信-石牌,2023-03-01,8711
2603,長榮,19,9,10,陽信-石牌,2023-03-01,8711
2611,志信,10,0,10,陽信-石牌,2023-03-01,8711
4109,加捷生醫,10,0,10,陽信-石牌,2023-03-01,8711
4114,健喬,12,2,10,陽信-石牌,2023-03-01,8711
6128,上福,10,0,10,陽信-石牌,2023-03-01,8711
6177,達麗,10,0,10,陽信-石牌,2023-03-01,8711
1101,台泥,11,1,10,陽信-石牌,2023-03-01,8711
00773B,中信優先金融債,9,0,9,陽信-石牌,2023-03-01,8711
4915,致伸,721,2,719,陽信-石牌,2023-03-02,8711
8401,白紗科,150,0,150,陽信-石牌,2023-03-02,8711
00878,國泰永續高股息,104,0,104,陽信-石牌,2023-03-02,8711
2020,美亞,100,0,100,陽信-石牌,2023-03-02,8711
6274,台燿,80,0,80,陽信-石牌,2023-03-02,8711
2492,華新科,68,5,63,陽信-石牌,2023-03-02,8711
2601,益航,93,34,59,陽信-石牌,2023-03-02,8711
00712,復華富時不動產,51,1,50,陽信-石牌,2023-03-02,8711
2430,燦坤,50,0,50,陽信-石牌,2023-03-02,8711
8213,志超,50,0,50,陽信-石牌,2023-03-02,8711
2498,宏達電,80,36,44,陽信-石牌,2023-03-02,8711
5283,禾聯碩,40,0,40,陽信-石牌,2023-03-02,8711
2303,聯電,39,7,32,陽信-石牌,2023-03-02,8711
2006,東和鋼鐵,31,0,31,陽信-石牌,2023-03-02,8711
3027,盛達,34,5,29,陽信-石牌,2023-03-02,8711
2402,毅嘉,28,1,27,陽信-石牌,2023-03-02,8711
2883,凱基金,26,0,26,陽信-石牌,2023-03-02,8711
2885,元大金,23,0,23,陽信-石牌,2023-03-02,8711
3481,群創,276,254,22,陽信-石牌,2023-03-02,8711
2017,官田鋼,22,0,22,陽信-石牌,2023-03-02,8711
2889,國票金,20,0,20,陽信-石牌,2023-03-02,8711
4804,大略-KY,20,0,20,陽信-石牌,2023-03-02,8711
6285,啟��,20,0,20,陽信-石牌,2023-03-02,8711
6411,晶焱,21,1,20,陽信-石牌,2023-03-02,8711
8105,凌巨,20,0,20,陽信-石牌,2023-03-02,8711
2409,友達,146,130,16,陽信-石牌,2023-03-02,8711
00720B,元大投資級公司債,15,0,15,陽信-石牌,2023-03-02,8711
3508,位速,15,0,15,陽信-石牌,2023-03-02,8711
4116,明基醫,15,0,15,陽信-石牌,2023-03-02,8711
5227,立凱-KY,15,0,15,陽信-石牌,2023-03-02,8711
6147,頎邦,20,5,15,陽信-石牌,2023-03-02,8711
8938,明安,27,12,15,陽信-石牌,2023-03-02,8711
2031,新光鋼,13,0,13,陽信-石牌,2023-03-02,8711
1210,大成,11,0,11,陽信-石牌,2023-03-02,8711
2606,裕民,26,15,11,陽信-石牌,2023-03-02,8711
8028,昇陽半導體,12,1,11,陽信-石牌,2023-03-02,8711
6142,友勁,11,0,11,陽信-石牌,2023-03-02,8711
00888,永豐台灣ESG,10,0,10,陽信-石牌,2023-03-02,8711
1529,樂事綠能,10,0,10,陽信-石牌,2023-03-02,8711
1810,和成,10,0,10,陽信-石牌,2023-03-02,8711
2401,凌陽,10,0,10,陽信-石牌,2023-03-02,8711
2412,中華電,10,0,10,陽信-石牌,2023-03-02,8711
2748,雲品,13,3,10,陽信-石牌,2023-03-02,8711
5536,聖暉*,11,1,10,陽信-石牌,2023-03-02,8711
6026,福邦證,10,0,10,陽信-石牌,2023-03-02,8711
6148,驊宏資,10,0,10,陽信-石牌,2023-03-02,8711
2359,所羅門,9,0,9,陽信-石牌,2023-03-02,8711
2882,國泰金,9,0,9,陽信-石牌,2023-03-02,8711
3037,欣興,22,13,9,陽信-石牌,2023-03-02,8711
8112,至上,20,11,9,陽信-石牌,2023-03-02,8711
00632R,元大台灣50反1,1852,45,1807,陽信-石牌,2023-03-03,8711
00878,國泰永續高股息,74,6,68,陽信-石牌,2023-03-03,8711
2449,京元電子,55,4,51,陽信-石牌,2023-03-03,8711
2371,大同,46,0,46,陽信-石牌,2023-03-03,8711
4906,正文,45,0,45,陽信-石牌,2023-03-03,8711
00773B,中信優先金融債,41,0,41,陽信-石牌,2023-03-03,8711
2601,益航,71,33,38,陽信-石牌,2023-03-03,8711
00712,復華富時不動產,35,1,34,陽信-石牌,2023-03-03,8711
00751B,元大AAA至A公司債,32,0,32,陽信-石牌,2023-03-03,8711
1909,榮成,30,0,30,陽信-石牌,2023-03-03,8711
2337,旺宏,40,10,30,陽信-石牌,2023-03-03,8711
3049,精金,30,0,30,陽信-石牌,2023-03-03,8711
6235,華孚,127,97,30,陽信-石牌,2023-03-03,8711
1810,和成,29,0,29,陽信-石牌,2023-03-03,8711
6752,叡揚,29,0,29,陽信-石牌,2023-03-03,8711
00795B,中信美國公債20年,25,0,25,陽信-石牌,2023-03-03,8711
2736,富野,28,4,24,陽信-石牌,2023-03-03,8711
3441,聯一光,22,0,22,陽信-石牌,2023-03-03,8711
2891,中信金,21,0,21,陽信-石牌,2023-03-03,8711
1587,吉茂,20,0,20,陽信-石牌,2023-03-03,8711
0056,元大高股息,19,0,19,陽信-石牌,2023-03-03,8711
1762,中化生,20,1,19,陽信-石牌,2023-03-03,8711
2363,矽統,18,0,18,陽信-石牌,2023-03-03,8711
3689,湧德,18,0,18,陽信-石牌,2023-03-03,8711
00650L,復華香港正2,16,0,16,陽信-石牌,2023-03-03,8711
2845,遠東銀,15,0,15,陽信-石牌,2023-03-03,8711
3016,嘉晶,17,2,15,陽信-石牌,2023-03-03,8711
3169,亞信,15,1,14,陽信-石牌,2023-03-03,8711
2722,夏都,14,2,12,陽信-石牌,2023-03-03,8711
3594,磐儀,17,5,12,陽信-石牌,2023-03-03,8711
3481,群創,124,113,11,陽信-石牌,2023-03-03,8711
1605,華新,68,57,11,陽信-石牌,2023-03-03,8711
2882,國泰金,11,0,11,陽信-石牌,2023-03-03,8711
00687B,國泰20年美債,10,0,10,陽信-石牌,2023-03-03,8711
2329,華泰,10,0,10,陽信-石牌,2023-03-03,8711
2419,仲琦,10,0,10,陽信-石牌,2023-03-03,8711
3128,昇銳,18,8,10,陽信-石牌,2023-03-03,8711
4207,環泰,10,0,10,陽信-石牌,2023-03-03,8711
00637L,元大滬深300正2,10,1,9,陽信-石牌,2023-03-03,8711
2382,廣達,10,1,9,陽信-石牌,2023-03-03,8711
3652,精聯,15,6,9,陽信-石牌,2023-03-03,8711
00679B,元大美債20年,8,0,8,陽信-石牌,2023-03-03,8711
2409,友達,57,49,8,陽信-石牌,2023-03-03,8711
2481,強茂,12,4,8,陽信-石牌,2023-03-03,8711
3029,零壹,11,3,8,陽信-石牌,2023-03-03,8711
2486,一詮,7,0,7,陽信-石牌,2023-03-03,8711
3714,富采,12,5,7,陽信-石牌,2023-03-03,8711
6616,特昇-KY,7,0,7,陽信-石牌,2023-03-03,8711
2330,台積電,8,1,7,陽信-石牌,2023-03-03,8711
2886,兆豐金,6,0,6,陽信-石牌,2023-03-03,8711
00673R,期元大S＆P原油反1,848,490,358,陽信-石牌,2023-03-06,8711
2324,仁寶,255,0,255,陽信-石牌,2023-03-06,8711
3029,零壹,200,10,190,陽信-石牌,2023-03-06,8711
2020,美亞,114,1,113,陽信-石牌,2023-03-06,8711
2356,英業達,80,2,78,陽信-石牌,2023-03-06,8711
00632R,元大台灣50反1,72,0,72,陽信-石牌,2023-03-06,8711
2454,聯發科,52,0,52,陽信-石牌,2023-03-06,8711
8401,白紗科,50,0,50,陽信-石牌,2023-03-06,8711
2637,慧洋-KY,154,109,45,陽信-石牌,2023-03-06,8711
2736,富野,42,2,40,陽信-石牌,2023-03-06,8711
2607,榮運,40,1,39,陽信-石牌,2023-03-06,8711
9105,泰金寶-DR,50,11,39,陽信-石牌,2023-03-06,8711
2430,燦坤,30,0,30,陽信-石牌,2023-03-06,8711
5283,禾聯碩,30,0,30,陽信-石牌,2023-03-06,8711
5604,中連,23,0,23,陽信-石牌,2023-03-06,8711
9945,潤泰新,21,0,21,陽信-石牌,2023-03-06,8711
2002,中鋼,27,6,21,陽信-石牌,2023-03-06,8711
6142,友勁,21,0,21,陽信-石牌,2023-03-06,8711
8112,至上,25,4,21,陽信-石牌,2023-03-06,8711
2314,台揚,23,4,19,陽信-石牌,2023-03-06,8711
2601,益航,19,2,17,陽信-石牌,2023-03-06,8711
3689,湧德,17,0,17,陽信-石牌,2023-03-06,8711
6752,叡揚,16,0,16,陽信-石牌,2023-03-06,8711
00637L,元大滬深300正2,19,4,15,陽信-石牌,2023-03-06,8711
2641,正德,25,10,15,陽信-石牌,2023-03-06,8711
4743,合一,18,3,15,陽信-石牌,2023-03-06,8711
4931,新盛力,15,0,15,陽信-石牌,2023-03-06,8711
8927,北基,13,0,13,陽信-石牌,2023-03-06,8711
00885,富邦越南,12,0,12,陽信-石牌,2023-03-06,8711
2337,旺宏,12,0,12,陽信-石牌,2023-03-06,8711
00712,復華富時不動產,11,0,11,陽信-石牌,2023-03-06,8711
2401,凌陽,14,3,11,陽信-石牌,2023-03-06,8711
3707,漢磊,12,1,11,陽信-石牌,2023-03-06,8711
00896,中信綠能及電動車,10,0,10,陽信-石牌,2023-03-06,8711
1616,億泰,10,0,10,陽信-石牌,2023-03-06,8711
1909,榮成,10,0,10,陽信-石牌,2023-03-06,8711
2486,一詮,15,5,10,陽信-石牌,2023-03-06,8711
3006,晶豪科,11,1,10,陽信-石牌,2023-03-06,8711
4943,康控-KY,10,0,10,陽信-石牌,2023-03-06,8711
6143,振曜,10,0,10,陽信-石牌,2023-03-06,8711
6215,和椿,10,0,10,陽信-石牌,2023-03-06,8711
8028,昇陽半導體,10,0,10,陽信-石牌,2023-03-06,8711
1605,華新,20,11,9,陽信-石牌,2023-03-06,8711
2331,精英,9,0,9,陽信-石牌,2023-03-06,8711
2375,凱美,10,1,9,陽信-石牌,2023-03-06,8711
2727,王品,12,3,9,陽信-石牌,2023-03-06,8711
3016,嘉晶,10,1,9,陽信-石牌,2023-03-06,8711
6404,通訊-KY,9,0,9,陽信-石牌,2023-03-06,8711
6509,聚和,12,3,9,陽信-石牌,2023-03-06,8711
8033,雷虎,18,9,9,陽信-石牌,2023-03-06,8711
00673R,期元大S＆P原油反1,507,0,507,陽信-石牌,2023-03-07,8711
3481,群創,325,65,260,陽信-石牌,2023-03-07,8711
8401,白紗科,200,0,200,陽信-石牌,2023-03-07,8711
3406,玉晶光,133,0,133,陽信-石牌,2023-03-07,8711
2430,燦坤,80,0,80,陽信-石牌,2023-03-07,8711
2324,仁寶,85,6,79,陽信-石牌,2023-03-07,8711
00632R,元大台灣50反1,66,0,66,陽信-石牌,2023-03-07,8711
5225,東科-KY,60,0,60,陽信-石牌,2023-03-07,8711
1909,榮成,50,0,50,陽信-石牌,2023-03-07,8711
2201,裕隆,80,31,49,陽信-石牌,2023-03-07,8711
8938,明安,30,0,30,陽信-石牌,2023-03-07,8711
6116,彩晶,30,1,29,陽信-石牌,2023-03-07,8711
2820,華票,28,0,28,陽信-石牌,2023-03-07,8711
1810,和成,25,0,25,陽信-石牌,2023-03-07,8711
6235,華孚,47,23,24,陽信-石牌,2023-03-07,8711
5283,禾聯碩,22,0,22,陽信-石牌,2023-03-07,8711
0056,元大高股息,41,21,20,陽信-石牌,2023-03-07,8711
2352,佳世達,20,0,20,陽信-石牌,2023-03-07,8711
2436,偉詮電,20,0,20,陽信-石牌,2023-03-07,8711
4743,合一,19,0,19,陽信-石牌,2023-03-07,8711
00753L,中信中國50正2,15,0,15,陽信-石牌,2023-03-07,8711
2017,官田鋼,20,5,15,陽信-石牌,2023-03-07,8711
2332,友訊,15,0,15,陽信-石牌,2023-03-07,8711
5351,鈺創,19,4,15,陽信-石牌,2023-03-07,8711
5426,振發,15,0,15,陽信-石牌,2023-03-07,8711
1519,華城,19,5,14,陽信-石牌,2023-03-07,8711
2444,兆勁,15,1,14,陽信-石牌,2023-03-07,8711
5512,力麒,14,0,14,陽信-石牌,2023-03-07,8711
00725B,國泰投資級公司債,13,0,13,陽信-石牌,2023-03-07,8711
1710,東聯,18,5,13,陽信-石牌,2023-03-07,8711
2481,強茂,47,34,13,陽信-石牌,2023-03-07,8711
2327,國巨,11,0,11,陽信-石牌,2023-03-07,8711
3105,穩懋,12,1,11,陽信-石牌,2023-03-07,8711
2609,陽明,22,11,11,陽信-石牌,2023-03-07,8711
4128,中天,10,0,10,陽信-石牌,2023-03-07,8711
2049,上銀,12,2,10,陽信-石牌,2023-03-07,8711
2801,彰銀,10,0,10,陽信-石牌,2023-03-07,8711
3710,連展投控,10,0,10,陽信-石牌,2023-03-07,8711
4113,聯上,10,0,10,陽信-石牌,2023-03-07,8711
6113,亞矽,10,0,10,陽信-石牌,2023-03-07,8711
6209,今國光,10,0,10,陽信-石牌,2023-03-07,8711
00637L,元大滬深300正2,15,6,9,陽信-石牌,2023-03-07,8711
2344,華邦電,47,38,9,陽信-石牌,2023-03-07,8711
6282,康舒,61,52,9,陽信-石牌,2023-03-07,8711
8927,北基,13,4,9,陽信-石牌,2023-03-07,8711
2454,聯發科,9,0,9,陽信-石牌,2023-03-07,8711
1540,喬福,38,30,8,陽信-石牌,2023-03-07,8711
1795,美時,11,3,8,陽信-石牌,2023-03-07,8711
4915,致伸,8,0,8,陽信-石牌,2023-03-07,8711
2368,金像電,12,4,8,陽信-石牌,2023-03-07,8711
2002,中鋼,1314,0,1314,陽信-石牌,2023-03-08,8711
00923,群益台ESG低碳50,105,0,105,陽信-石牌,2023-03-08,8711
3491,昇達科,112,10,102,陽信-石牌,2023-03-08,8711
3029,零壹,95,3,92,陽信-石牌,2023-03-08,8711
2439,美律,90,0,90,陽信-石牌,2023-03-08,8711
8938,明安,82,0,82,陽信-石牌,2023-03-08,8711
2344,華邦電,70,3,67,陽信-石牌,2023-03-08,8711
00772B,中信高評級公司債,50,0,50,陽信-石牌,2023-03-08,8711
5225,東科-KY,50,0,50,陽信-石牌,2023-03-08,8711
2006,東和鋼鐵,50,2,48,陽信-石牌,2023-03-08,8711
2371,大同,49,1,48,陽信-石牌,2023-03-08,8711
00900,富邦特選高股息30,43,1,42,陽信-石牌,2023-03-08,8711
2430,燦坤,40,0,40,陽信-石牌,2023-03-08,8711
2454,聯發科,38,0,38,陽信-石牌,2023-03-08,8711
3406,玉晶光,38,1,37,陽信-石牌,2023-03-08,8711
2609,陽明,54,19,35,陽信-石牌,2023-03-08,8711
6234,高僑,34,1,33,陽信-石牌,2023-03-08,8711
00632R,元大台灣50反1,32,0,32,陽信-石牌,2023-03-08,8711
2607,榮運,30,0,30,陽信-石牌,2023-03-08,8711
5009,榮剛,29,2,27,陽信-石牌,2023-03-08,8711
1102,亞泥,22,0,22,陽信-石牌,2023-03-08,8711
00637L,元大滬深300正2,28,6,22,陽信-石牌,2023-03-08,8711
2444,兆勁,42,20,22,陽信-石牌,2023-03-08,8711
2736,富野,22,1,21,陽信-石牌,2023-03-08,8711
4114,健喬,23,3,20,陽信-石牌,2023-03-08,8711
5210,寶碩,20,0,20,陽信-石牌,2023-03-08,8711
3481,群創,53,35,18,陽信-石牌,2023-03-08,8711
2367,燿華,18,0,18,陽信-石牌,2023-03-08,8711
1514,亞力,26,9,17,陽信-石牌,2023-03-08,8711
3066,李洲,27,10,17,陽信-石牌,2023-03-08,8711
00734B,台新JPM新興債,16,0,16,陽信-石牌,2023-03-08,8711
1605,華新,160,144,16,陽信-石牌,2023-03-08,8711
2481,強茂,29,13,16,陽信-石牌,2023-03-08,8711
2498,宏達電,19,3,16,陽信-石牌,2023-03-08,8711
2637,慧洋-KY,23,7,16,陽信-石牌,2023-03-08,8711
3236,千如,16,0,16,陽信-石牌,2023-03-08,8711
1101,台泥,15,0,15,陽信-石牌,2023-03-08,8711
1810,和成,21,6,15,陽信-石牌,2023-03-08,8711
3508,位速,15,0,15,陽信-石牌,2023-03-08,8711
9933,中鼎,18,3,15,陽信-石牌,2023-03-08,8711
00885,富邦越南,13,0,13,陽信-石牌,2023-03-08,8711
00650L,復華香港正2,13,1,12,陽信-石牌,2023-03-08,8711
00665L,富邦�琤肭磪囓�2,48,36,12,陽信-石牌,2023-03-08,8711
2376,技嘉,13,1,12,陽信-石牌,2023-03-08,8711
3138,耀登,12,0,12,陽信-石牌,2023-03-08,8711
5340,建榮,14,2,12,陽信-石牌,2023-03-08,8711
6129,普誠,21,9,12,陽信-石牌,2023-03-08,8711
00725B,國泰投資級公司債,11,0,11,陽信-石牌,2023-03-08,8711
2312,金寶,12,1,11,陽信-石牌,2023-03-08,8711
2313,華通,15,4,11,陽信-石牌,2023-03-08,8711
3481,群創,270,84,186,陽信-石牌,2023-03-09,8711
00900,富邦特選高股息30,163,10,153,陽信-石牌,2023-03-09,8711
2888,新光金,104,0,104,陽信-石牌,2023-03-09,8711
2371,大同,101,0,101,陽信-石牌,2023-03-09,8711
2007,燁興,100,0,100,陽信-石牌,2023-03-09,8711
2444,兆勁,85,22,63,陽信-石牌,2023-03-09,8711
2002,中鋼,56,5,51,陽信-石牌,2023-03-09,8711
9105,泰金寶-DR,73,23,50,陽信-石牌,2023-03-09,8711
2457,飛宏,130,81,49,陽信-石牌,2023-03-09,8711
2317,鴻海,49,1,48,陽信-石牌,2023-03-09,8711
6282,康舒,100,60,40,陽信-石牌,2023-03-09,8711
3406,玉晶光,40,0,40,陽信-石牌,2023-03-09,8711
8070,長華*,40,0,40,陽信-石牌,2023-03-09,8711
1101,台泥,32,0,32,陽信-石牌,2023-03-09,8711
1560,中砂,32,0,32,陽信-石牌,2023-03-09,8711
2609,陽明,40,9,31,陽信-石牌,2023-03-09,8711
2022,聚亨,30,0,30,陽信-石牌,2023-03-09,8711
8215,明基材,27,0,27,陽信-石牌,2023-03-09,8711
2409,友達,116,90,26,陽信-石牌,2023-03-09,8711
6129,普誠,38,12,26,陽信-石牌,2023-03-09,8711
2484,希華,25,1,24,陽信-石牌,2023-03-09,8711
4147,中裕,77,53,24,陽信-石牌,2023-03-09,8711
3013,晟銘電,29,7,22,陽信-石牌,2023-03-09,8711
5469,瀚宇博,22,0,22,陽信-石牌,2023-03-09,8711
6116,彩晶,22,0,22,陽信-石牌,2023-03-09,8711
2486,一詮,33,12,21,陽信-石牌,2023-03-09,8711
1789,神隆,20,0,20,陽信-石牌,2023-03-09,8711
2323,中環,20,0,20,陽信-石牌,2023-03-09,8711
4804,大略-KY,20,0,20,陽信-石牌,2023-03-09,8711
2820,華票,18,0,18,陽信-石牌,2023-03-09,8711
5351,鈺創,31,14,17,陽信-石牌,2023-03-09,8711
3066,李洲,34,18,16,陽信-石牌,2023-03-09,8711
6443,元晶,37,21,16,陽信-石牌,2023-03-09,8711
2359,所羅門,18,3,15,陽信-石牌,2023-03-09,8711
4114,健喬,20,5,15,陽信-石牌,2023-03-09,8711
2482,連宇,36,22,14,陽信-石牌,2023-03-09,8711
4138,曜亞,14,0,14,陽信-石牌,2023-03-09,8711
2884,玉山金,13,0,13,陽信-石牌,2023-03-09,8711
5475,德宏,13,0,13,陽信-石牌,2023-03-09,8711
6234,高僑,13,0,13,陽信-石牌,2023-03-09,8711
1584,精剛,12,0,12,陽信-石牌,2023-03-09,8711
2313,華通,18,6,12,陽信-石牌,2023-03-09,8711
2454,聯發科,11,0,11,陽信-石牌,2023-03-09,8711
3268,海德威,11,0,11,陽信-石牌,2023-03-09,8711
3594,磐儀,31,20,11,陽信-石牌,2023-03-09,8711
3689,湧德,16,5,11,陽信-石牌,2023-03-09,8711
6509,聚和,11,0,11,陽信-石牌,2023-03-09,8711
00632R,元大台灣50反1,10,0,10,陽信-石牌,2023-03-09,8711
00637L,元大滬深300正2,16,6,10,陽信-石牌,2023-03-09,8711
00896,中信綠能及電動車,10,0,10,陽信-石牌,2023-03-09,8711
1802,台玻,405,0,405,陽信-石牌,2023-03-10,8711
00897,富邦基因免疫生技,401,0,401,陽信-石牌,2023-03-10,8711
00671R,富邦NASDAQ反1,270,15,255,陽信-石牌,2023-03-10,8711
00648R,元大S＆P500反1,160,1,159,陽信-石牌,2023-03-10,8711
00923,群益台ESG低碳50,141,0,141,陽信-石牌,2023-03-10,8711
2609,陽明,238,123,115,陽信-石牌,2023-03-10,8711
3029,零壹,112,1,111,陽信-石牌,2023-03-10,8711
2618,長榮航,91,9,82,陽信-石牌,2023-03-10,8711
00712,復華富時不動產,103,25,78,陽信-石牌,2023-03-10,8711
2027,大成鋼,90,20,70,陽信-石牌,2023-03-10,8711
2610,華航,96,27,69,陽信-石牌,2023-03-10,8711
2344,華邦電,75,7,68,陽信-石牌,2023-03-10,8711
2444,兆勁,60,0,60,陽信-石牌,2023-03-10,8711
2504,國產,60,0,60,陽信-石牌,2023-03-10,8711
3707,漢磊,62,2,60,陽信-石牌,2023-03-10,8711
00713,元大台灣高息低波,57,0,57,陽信-石牌,2023-03-10,8711
00878,國泰永續高股息,56,0,56,陽信-石牌,2023-03-10,8711
2002,中鋼,90,37,53,陽信-石牌,2023-03-10,8711
2736,富野,62,10,52,陽信-石牌,2023-03-10,8711
2102,泰豐,50,0,50,陽信-石牌,2023-03-10,8711
5225,東科-KY,48,0,48,陽信-石牌,2023-03-10,8711
2883,凱基金,46,0,46,陽信-石牌,2023-03-10,8711
1605,華新,99,55,44,陽信-石牌,2023-03-10,8711
2317,鴻海,46,4,42,陽信-石牌,2023-03-10,8711
2330,台積電,43,3,40,陽信-石牌,2023-03-10,8711
00637L,元大滬深300正2,33,2,31,陽信-石牌,2023-03-10,8711
1560,中砂,30,0,30,陽信-石牌,2023-03-10,8711
5608,四維航,45,15,30,陽信-石牌,2023-03-10,8711
8938,明安,30,0,30,陽信-石牌,2023-03-10,8711
0056,元大高股息,29,2,27,陽信-石牌,2023-03-10,8711
3264,欣銓,30,3,27,陽信-石牌,2023-03-10,8711
1519,華城,56,30,26,陽信-石牌,2023-03-10,8711
8069,元太,26,0,26,陽信-石牌,2023-03-10,8711
00715L,期街口布蘭特正2,25,0,25,陽信-石牌,2023-03-10,8711
2498,宏達電,26,1,25,陽信-石牌,2023-03-10,8711
2538,基泰,25,0,25,陽信-石牌,2023-03-10,8711
5351,鈺創,29,5,24,陽信-石牌,2023-03-10,8711
4147,中裕,23,0,23,陽信-石牌,2023-03-10,8711
2881,富邦金,26,3,23,陽信-石牌,2023-03-10,8711
1584,精剛,112,92,20,陽信-石牌,2023-03-10,8711
4804,大略-KY,20,0,20,陽信-石牌,2023-03-10,8711
5452,佶優,20,0,20,陽信-石牌,2023-03-10,8711
8105,凌巨,20,0,20,陽信-石牌,2023-03-10,8711
3466,德晉,18,0,18,陽信-石牌,2023-03-10,8711
2885,元大金,17,0,17,陽信-石牌,2023-03-10,8711
4138,曜亞,16,0,16,陽信-石牌,2023-03-10,8711
6806,森崴能源,18,2,16,陽信-石牌,2023-03-10,8711
3322,建舜電,15,0,15,陽信-石牌,2023-03-10,8711
3508,位速,15,0,15,陽信-石牌,2023-03-10,8711
6129,普誠,15,0,15,陽信-石牌,2023-03-10,8711
00715L,期街口布蘭特正2,410,220,190,陽信-石牌,2023-03-13,8711
6719,力智,139,2,137,陽信-石牌,2023-03-13,8711
1712,興農,125,0,125,陽信-石牌,2023-03-13,8711
00878,國泰永續高股息,84,4,80,陽信-石牌,2023-03-13,8711
2609,陽明,110,57,53,陽信-石牌,2023-03-13,8711
00632R,元大台灣50反1,48,5,43,陽信-石牌,2023-03-13,8711
6244,茂迪,40,0,40,陽信-石牌,2023-03-13,8711
2301,光寶科,40,1,39,陽信-石牌,2023-03-13,8711
1605,華新,86,51,35,陽信-石牌,2023-03-13,8711
2201,裕隆,50,18,32,陽信-石牌,2023-03-13,8711
2634,漢翔,39,8,31,陽信-石牌,2023-03-13,8711
00648R,元大S＆P500反1,30,0,30,陽信-石牌,2023-03-13,8711
3029,零壹,50,20,30,陽信-石牌,2023-03-13,8711
4707,磐亞,30,0,30,陽信-石牌,2023-03-13,8711
00712,復華富時不動產,29,0,29,陽信-石牌,2023-03-13,8711
2601,益航,28,0,28,陽信-石牌,2023-03-13,8711
3707,漢磊,29,1,28,陽信-石牌,2023-03-13,8711
3494,誠研,26,0,26,陽信-石牌,2023-03-13,8711
6188,廣明,26,0,26,陽信-石牌,2023-03-13,8711
2312,金寶,24,0,24,陽信-石牌,2023-03-13,8711
2610,華航,41,20,21,陽信-石牌,2023-03-13,8711
4147,中裕,21,0,21,陽信-石牌,2023-03-13,8711
2303,聯電,29,9,20,陽信-石牌,2023-03-13,8711
2617,台航,175,155,20,陽信-石牌,2023-03-13,8711
2618,長榮航,187,167,20,陽信-石牌,2023-03-13,8711
911868,同方友友-DR,20,0,20,陽信-石牌,2023-03-13,8711
2882,國泰金,23,4,19,陽信-石牌,2023-03-13,8711
3712,永崴投控,20,1,19,陽信-石牌,2023-03-13,8711
3093,港建*,27,10,17,陽信-石牌,2023-03-13,8711
3236,千如,23,6,17,陽信-石牌,2023-03-13,8711
3508,位速,17,0,17,陽信-石牌,2023-03-13,8711
00713,元大台灣高息低波,16,0,16,陽信-石牌,2023-03-13,8711
00671R,富邦NASDAQ反1,15,0,15,陽信-石牌,2023-03-13,8711
2538,基泰,15,0,15,陽信-石牌,2023-03-13,8711
2607,榮運,15,0,15,陽信-石牌,2023-03-13,8711
2402,毅嘉,36,23,13,陽信-石牌,2023-03-13,8711
2449,京元電子,13,0,13,陽信-石牌,2023-03-13,8711
1218,泰山,11,0,11,陽信-石牌,2023-03-13,8711
5351,鈺創,16,5,11,陽信-石牌,2023-03-13,8711
6235,華孚,32,21,11,陽信-石牌,2023-03-13,8711
8050,廣積,11,0,11,陽信-石牌,2023-03-13,8711
1432,大魯閣,10,0,10,陽信-石牌,2023-03-13,8711
2534,宏盛,10,0,10,陽信-石牌,2023-03-13,8711
2611,志信,10,0,10,陽信-石牌,2023-03-13,8711
2637,慧洋-KY,32,22,10,陽信-石牌,2023-03-13,8711
2881,富邦金,10,0,10,陽信-石牌,2023-03-13,8711
2890,永豐金,10,0,10,陽信-石牌,2023-03-13,8711
4114,健喬,10,0,10,陽信-石牌,2023-03-13,8711
4953,緯軟,15,5,10,陽信-石牌,2023-03-13,8711
6789,采鈺,10,0,10,陽信-石牌,2023-03-13,8711
2610,華航,496,18,478,陽信-石牌,2023-03-14,8711
2834,臺企銀,173,10,163,陽信-石牌,2023-03-14,8711
00878,國泰永續高股息,129,30,99,陽信-石牌,2023-03-14,8711
2618,長榮航,104,13,91,陽信-石牌,2023-03-14,8711
6244,茂迪,66,6,60,陽信-石牌,2023-03-14,8711
2882,國泰金,56,0,56,陽信-石牌,2023-03-14,8711
2102,泰豐,50,0,50,陽信-石牌,2023-03-14,8711
3491,昇達科,54,5,49,陽信-石牌,2023-03-14,8711
2303,聯電,71,32,39,陽信-石牌,2023-03-14,8711
2884,玉山金,35,0,35,陽信-石牌,2023-03-14,8711
00637L,元大滬深300正2,36,3,33,陽信-石牌,2023-03-14,8711
2409,友達,119,90,29,陽信-石牌,2023-03-14,8711
2891,中信金,29,0,29,陽信-石牌,2023-03-14,8711
2883,凱基金,38,10,28,陽信-石牌,2023-03-14,8711
3707,漢磊,27,0,27,陽信-石牌,2023-03-14,8711
2615,萬海,55,29,26,陽信-石牌,2023-03-14,8711
3013,晟銘電,41,15,26,陽信-石牌,2023-03-14,8711
8936,國統,22,0,22,陽信-石牌,2023-03-14,8711
2889,國票金,24,3,21,陽信-石牌,2023-03-14,8711
1785,光洋科,21,1,20,陽信-石牌,2023-03-14,8711
1789,神隆,20,0,20,陽信-石牌,2023-03-14,8711
2027,大成鋼,28,8,20,陽信-石牌,2023-03-14,8711
2380,虹光,20,0,20,陽信-石牌,2023-03-14,8711
2851,中再保,20,0,20,陽信-石牌,2023-03-14,8711
2880,華南金,20,0,20,陽信-石牌,2023-03-14,8711
00923,群益台ESG低碳50,19,0,19,陽信-石牌,2023-03-14,8711
2881,富邦金,19,0,19,陽信-石牌,2023-03-14,8711
00773B,中信優先金融債,15,0,15,陽信-石牌,2023-03-14,8711
00664R,國泰臺灣加權反1,15,0,15,陽信-石牌,2023-03-14,8711
2887,台新金,15,0,15,陽信-石牌,2023-03-14,8711
4927,泰鼎-KY,16,1,15,陽信-石牌,2023-03-14,8711
2330,台積電,15,0,15,陽信-石牌,2023-03-14,8711
2892,第一金,14,0,14,陽信-石牌,2023-03-14,8711
00632R,元大台灣50反1,18,5,13,陽信-石牌,2023-03-14,8711
2388,威盛,21,8,13,陽信-石牌,2023-03-14,8711
5481,新華,13,0,13,陽信-石牌,2023-03-14,8711
00712,復華富時不動產,12,0,12,陽信-石牌,2023-03-14,8711
00679B,元大美債20年,15,4,11,陽信-石牌,2023-03-14,8711
00905,FT臺灣Smart,10,0,10,陽信-石牌,2023-03-14,8711
2641,正德,12,2,10,陽信-石牌,2023-03-14,8711
2736,富野,12,2,10,陽信-石牌,2023-03-14,8711
2820,華票,10,0,10,陽信-石牌,2023-03-14,8711
3029,零壹,10,0,10,陽信-石牌,2023-03-14,8711
4157,太景*-KY,10,0,10,陽信-石牌,2023-03-14,8711
6209,今國光,10,0,10,陽信-石牌,2023-03-14,8711
6266,泰詠,10,0,10,陽信-石牌,2023-03-14,8711
6235,華孚,21,12,9,陽信-石牌,2023-03-14,8711
2308,台達電,10,1,9,陽信-石牌,2023-03-14,8711
00642U,期元大S＆P石油,8,0,8,陽信-石牌,2023-03-14,8711
1504,東元,7,0,7,陽信-石牌,2023-03-14,8711
00715L,期街口布蘭特正2,267,0,267,陽信-石牌,2023-03-15,8711
2888,新光金,108,3,105,陽信-石牌,2023-03-15,8711
2504,國產,100,0,100,陽信-石牌,2023-03-15,8711
00878,國泰永續高股息,87,2,85,陽信-石牌,2023-03-15,8711
00923,群益台ESG低碳50,65,0,65,陽信-石牌,2023-03-15,8711
00713,元大台灣高息低波,53,0,53,陽信-石牌,2023-03-15,8711
2891,中信金,55,3,52,陽信-石牌,2023-03-15,8711
2603,長榮,89,42,47,陽信-石牌,2023-03-15,8711
5522,遠雄,40,0,40,陽信-石牌,2023-03-15,8711
2444,兆勁,35,0,35,陽信-石牌,2023-03-15,8711
2409,友達,35,2,33,陽信-石牌,2023-03-15,8711
00679B,元大美債20年,26,0,26,陽信-石牌,2023-03-15,8711
6266,泰詠,26,0,26,陽信-石牌,2023-03-15,8711
2883,凱基金,25,0,25,陽信-石牌,2023-03-15,8711
8936,國統,24,1,23,陽信-石牌,2023-03-15,8711
00637L,元大滬深300正2,34,12,22,陽信-石牌,2023-03-15,8711
2892,第一金,22,0,22,陽信-石牌,2023-03-15,8711
2618,長榮航,37,16,21,陽信-石牌,2023-03-15,8711
00907,永豐優息存股,20,0,20,陽信-石牌,2023-03-15,8711
1718,中纖,20,0,20,陽信-石牌,2023-03-15,8711
2027,大成鋼,29,9,20,陽信-石牌,2023-03-15,8711
2208,台船,20,0,20,陽信-石牌,2023-03-15,8711
3052,夆典,20,0,20,陽信-石牌,2023-03-15,8711
1611,中電,20,1,19,陽信-石牌,2023-03-15,8711
2614,東森,37,18,19,陽信-石牌,2023-03-15,8711
2880,華南金,18,0,18,陽信-石牌,2023-03-15,8711
2002,中鋼,26,9,17,陽信-石牌,2023-03-15,8711
3520,華盈,17,0,17,陽信-石牌,2023-03-15,8711
6488,環球晶,17,0,17,陽信-石牌,2023-03-15,8711
2615,萬海,48,32,16,陽信-石牌,2023-03-15,8711
00882,中信中國高股息,15,0,15,陽信-石牌,2023-03-15,8711
00671R,富邦NASDAQ反1,15,0,15,陽信-石牌,2023-03-15,8711
2399,映泰,15,0,15,陽信-石牌,2023-03-15,8711
2609,陽明,58,43,15,陽信-石牌,2023-03-15,8711
3217,優群,15,0,15,陽信-石牌,2023-03-15,8711
9945,潤泰新,15,0,15,陽信-石牌,2023-03-15,8711
0056,元大高股息,17,3,14,陽信-石牌,2023-03-15,8711
3491,昇達科,54,42,12,陽信-石牌,2023-03-15,8711
00642U,期元大S＆P石油,12,0,12,陽信-石牌,2023-03-15,8711
2313,華通,13,1,12,陽信-石牌,2023-03-15,8711
6026,福邦證,12,0,12,陽信-石牌,2023-03-15,8711
9907,統一實,12,0,12,陽信-石牌,2023-03-15,8711
4958,臻鼎-KY,11,0,11,陽信-石牌,2023-03-15,8711
5014,建錩,10,0,10,陽信-石牌,2023-03-15,8711
6209,今國光,10,0,10,陽信-石牌,2023-03-15,8711
3481,群創,46,37,9,陽信-石牌,2023-03-15,8711
1584,精剛,14,5,9,陽信-石牌,2023-03-15,8711
1605,華新,23,14,9,陽信-石牌,2023-03-15,8711
2731,雄獅,10,1,9,陽信-石牌,2023-03-15,8711
3042,晶技,9,0,9,陽信-石牌,2023-03-15,8711
00642U,期元大S＆P石油,235,2,233,陽信-石牌,2023-03-16,8711
2881,富邦金,115,0,115,陽信-石牌,2023-03-16,8711
6026,福邦證,111,0,111,陽信-石牌,2023-03-16,8711
00878,國泰永續高股息,114,12,102,陽信-石牌,2023-03-16,8711
2882,國泰金,69,0,69,陽信-石牌,2023-03-16,8711
00715L,期街口布蘭特正2,58,1,57,陽信-石牌,2023-03-16,8711
2515,中工,55,2,53,陽信-石牌,2023-03-16,8711
2610,華航,67,16,51,陽信-石牌,2023-03-16,8711
2618,長榮航,146,96,50,陽信-石牌,2023-03-16,8711
2603,長榮,101,68,33,陽信-石牌,2023-03-16,8711
1785,光洋科,35,5,30,陽信-石牌,2023-03-16,8711
2609,陽明,86,56,30,陽信-石牌,2023-03-16,8711
3702,大聯大,30,0,30,陽信-石牌,2023-03-16,8711
2884,玉山金,31,3,28,陽信-石牌,2023-03-16,8711
5603,陸海,28,0,28,陽信-石牌,2023-03-16,8711
6285,啟��,36,10,26,陽信-石牌,2023-03-16,8711
2498,宏達電,29,4,25,陽信-石牌,2023-03-16,8711
00712,復華富時不動產,23,0,23,陽信-石牌,2023-03-16,8711
2427,三商電,21,0,21,陽信-石牌,2023-03-16,8711
4114,健喬,26,5,21,陽信-石牌,2023-03-16,8711
00671R,富邦NASDAQ反1,20,0,20,陽信-石牌,2023-03-16,8711
2392,正崴,20,0,20,陽信-石牌,2023-03-16,8711
2538,基泰,39,19,20,陽信-石牌,2023-03-16,8711
2851,中再保,20,0,20,陽信-石牌,2023-03-16,8711
3260,威剛,20,0,20,陽信-石牌,2023-03-16,8711
6116,彩晶,20,0,20,陽信-石牌,2023-03-16,8711
6609,瀧澤科,20,0,20,陽信-石牌,2023-03-16,8711
2883,凱基金,18,0,18,陽信-石牌,2023-03-16,8711
2330,台積電,18,0,18,陽信-石牌,2023-03-16,8711
2891,中信金,23,6,17,陽信-石牌,2023-03-16,8711
2313,華通,19,2,17,陽信-石牌,2023-03-16,8711
6266,泰詠,17,0,17,陽信-石牌,2023-03-16,8711
00637L,元大滬深300正2,26,11,15,陽信-石牌,2023-03-16,8711
2444,兆勁,15,0,15,陽信-石牌,2023-03-16,8711
2637,慧洋-KY,15,0,15,陽信-石牌,2023-03-16,8711
2880,華南金,15,0,15,陽信-石牌,2023-03-16,8711
2888,新光金,20,6,14,陽信-石牌,2023-03-16,8711
2457,飛宏,212,199,13,陽信-石牌,2023-03-16,8711
00923,群益台ESG低碳50,13,0,13,陽信-石牌,2023-03-16,8711
00738U,期元大道瓊白銀,13,0,13,陽信-石牌,2023-03-16,8711
8933,愛地雅,12,0,12,陽信-石牌,2023-03-16,8711
00751B,元大AAA至A公司債,12,0,12,陽信-石牌,2023-03-16,8711
1584,精剛,17,5,12,陽信-石牌,2023-03-16,8711
1609,大亞,14,2,12,陽信-石牌,2023-03-16,8711
2892,第一金,12,0,12,陽信-石牌,2023-03-16,8711
6129,普誠,13,1,12,陽信-石牌,2023-03-16,8711
5880,合庫金,12,0,12,陽信-石牌,2023-03-16,8711
1440,南紡,11,0,11,陽信-石牌,2023-03-16,8711
1524,耿鼎,10,0,10,陽信-石牌,2023-03-16,8711
00772B,中信高評級公司債,10,0,10,陽信-石牌,2023-03-16,8711
1611,中電,121,10,111,陽信-石牌,2023-03-17,8711
2006,東和鋼鐵,80,0,80,陽信-石牌,2023-03-17,8711
2834,臺企銀,77,8,69,陽信-石牌,2023-03-17,8711
00632R,元大台灣50反1,60,0,60,陽信-石牌,2023-03-17,8711
2442,新美齊,58,0,58,陽信-石牌,2023-03-17,8711
2891,中信金,60,10,50,陽信-石牌,2023-03-17,8711
6643,M31,52,2,50,陽信-石牌,2023-03-17,8711
9105,泰金寶-DR,50,0,50,陽信-石牌,2023-03-17,8711
2603,長榮,57,20,37,陽信-石牌,2023-03-17,8711
00878,國泰永續高股息,46,12,34,陽信-石牌,2023-03-17,8711
6177,達麗,34,0,34,陽信-石牌,2023-03-17,8711
1213,大飲,32,0,32,陽信-石牌,2023-03-17,8711
2601,益航,30,0,30,陽信-石牌,2023-03-17,8711
00713,元大台灣高息低波,29,0,29,陽信-石牌,2023-03-17,8711
3052,夆典,29,0,29,陽信-石牌,2023-03-17,8711
0056,元大高股息,26,0,26,陽信-石牌,2023-03-17,8711
00671R,富邦NASDAQ反1,25,0,25,陽信-石牌,2023-03-17,8711
00715L,期街口布蘭特正2,26,1,25,陽信-石牌,2023-03-17,8711
2883,凱基金,24,0,24,陽信-石牌,2023-03-17,8711
1314,中石化,23,0,23,陽信-石牌,2023-03-17,8711
5014,建錩,22,0,22,陽信-石牌,2023-03-17,8711
00907,永豐優息存股,20,0,20,陽信-石牌,2023-03-17,8711
00679B,元大美債20年,20,0,20,陽信-石牌,2023-03-17,8711
2014,中鴻,20,0,20,陽信-石牌,2023-03-17,8711
2471,資通,34,14,20,陽信-石牌,2023-03-17,8711
2888,新光金,19,0,19,陽信-石牌,2023-03-17,8711
3576,聯合再生,33,15,18,陽信-石牌,2023-03-17,8711
2017,官田鋼,16,0,16,陽信-石牌,2023-03-17,8711
4915,致伸,20,4,16,陽信-石牌,2023-03-17,8711
1609,大亞,25,10,15,陽信-石牌,2023-03-17,8711
5481,新華,15,0,15,陽信-石牌,2023-03-17,8711
2313,華通,14,0,14,陽信-石牌,2023-03-17,8711
2880,華南金,13,0,13,陽信-石牌,2023-03-17,8711
2615,萬海,12,0,12,陽信-石牌,2023-03-17,8711
2208,台船,10,0,10,陽信-石牌,2023-03-17,8711
2402,毅嘉,23,13,10,陽信-石牌,2023-03-17,8711
5388,中磊,10,0,10,陽信-石牌,2023-03-17,8711
6164,華興,10,0,10,陽信-石牌,2023-03-17,8711
2406,國碩,12,3,9,陽信-石牌,2023-03-17,8711
2606,裕民,9,0,9,陽信-石牌,2023-03-17,8711
4960,誠美材,10,1,9,陽信-石牌,2023-03-17,8711
4976,佳凌,9,0,9,陽信-石牌,2023-03-17,8711
5351,鈺創,12,3,9,陽信-石牌,2023-03-17,8711
6182,合晶,12,3,9,陽信-石牌,2023-03-17,8711
2031,新光鋼,8,0,8,陽信-石牌,2023-03-17,8711
2634,漢翔,39,31,8,陽信-石牌,2023-03-17,8711
9907,統一實,8,0,8,陽信-石牌,2023-03-17,8711
2609,陽明,20,13,7,陽信-石牌,2023-03-17,8711
3652,精聯,7,0,7,陽信-石牌,2023-03-17,8711
4164,承業醫,9,2,7,陽信-石牌,2023-03-17,8711
5225,東科-KY,150,0,150,陽信-石牌,2023-03-20,8711
00642U,期元大S＆P石油,126,0,126,陽信-石牌,2023-03-20,8711
2211,長榮鋼,80,0,80,陽信-石牌,2023-03-20,8711
2065,世豐,50,0,50,陽信-石牌,2023-03-20,8711
2371,大同,48,0,48,陽信-石牌,2023-03-20,8711
3211,順達,40,0,40,陽信-石牌,2023-03-20,8711
2609,陽明,36,0,36,陽信-石牌,2023-03-20,8711
1605,華新,235,200,35,陽信-石牌,2023-03-20,8711
2618,長榮航,30,0,30,陽信-石牌,2023-03-20,8711
8938,明安,40,10,30,陽信-石牌,2023-03-20,8711
00665L,富邦�琤肭磪囓�2,82,55,27,陽信-石牌,2023-03-20,8711
2615,萬海,52,28,24,陽信-石牌,2023-03-20,8711
00885,富邦越南,22,0,22,陽信-石牌,2023-03-20,8711
5481,新華,20,0,20,陽信-石牌,2023-03-20,8711
6788,華景電,20,0,20,陽信-石牌,2023-03-20,8711
8086,宏捷科,20,0,20,陽信-石牌,2023-03-20,8711
9955,佳龍,26,6,20,陽信-石牌,2023-03-20,8711
6140,訊達,19,0,19,陽信-石牌,2023-03-20,8711
1514,亞力,20,1,19,陽信-石牌,2023-03-20,8711
2882,國泰金,20,1,19,陽信-石牌,2023-03-20,8711
4114,健喬,18,0,18,陽信-石牌,2023-03-20,8711
1432,大魯閣,17,0,17,陽信-石牌,2023-03-20,8711
2481,強茂,19,3,16,陽信-石牌,2023-03-20,8711
6177,達麗,16,0,16,陽信-石牌,2023-03-20,8711
2206,三陽工業,15,0,15,陽信-石牌,2023-03-20,8711
2388,威盛,26,11,15,陽信-石牌,2023-03-20,8711
2460,建通,15,0,15,陽信-石牌,2023-03-20,8711
6116,彩晶,15,0,15,陽信-石牌,2023-03-20,8711
1611,中電,12,0,12,陽信-石牌,2023-03-20,8711
1519,華城,17,5,12,陽信-石牌,2023-03-20,8711
3017,奇鋐,17,5,12,陽信-石牌,2023-03-20,8711
5347,世界,12,0,12,陽信-石牌,2023-03-20,8711
2886,兆豐金,12,0,12,陽信-石牌,2023-03-20,8711
00923,群益台ESG低碳50,11,0,11,陽信-石牌,2023-03-20,8711
00715L,期街口布蘭特正2,11,0,11,陽信-石牌,2023-03-20,8711
2342,茂矽,11,0,11,陽信-石牌,2023-03-20,8711
2449,京元電子,11,0,11,陽信-石牌,2023-03-20,8711
2891,中信金,23,12,11,陽信-石牌,2023-03-20,8711
1217,愛之味,10,0,10,陽信-石牌,2023-03-20,8711
2313,華通,10,0,10,陽信-石牌,2023-03-20,8711
2324,仁寶,17,7,10,陽信-石牌,2023-03-20,8711
3217,優群,10,0,10,陽信-石牌,2023-03-20,8711
5388,中磊,10,0,10,陽信-石牌,2023-03-20,8711
8440,綠電,11,1,10,陽信-石牌,2023-03-20,8711
2881,富邦金,10,0,10,陽信-石牌,2023-03-20,8711
2888,新光金,9,0,9,陽信-石牌,2023-03-20,8711
3466,德晉,9,0,9,陽信-石牌,2023-03-20,8711
0056,元大高股息,8,0,8,陽信-石牌,2023-03-20,8711
1736,喬山,9,1,8,陽信-石牌,2023-03-20,8711
2303,聯電,13,5,8,陽信-石牌,2023-03-20,8711
3481,群創,108,10,98,陽信-石牌,2023-03-21,8711
00902,中信電池及儲能,74,0,74,陽信-石牌,2023-03-21,8711
2888,新光金,86,14,72,陽信-石牌,2023-03-21,8711
3714,富采,51,2,49,陽信-石牌,2023-03-21,8711
2211,長榮鋼,43,0,43,陽信-石牌,2023-03-21,8711
9105,泰金寶-DR,50,10,40,陽信-石牌,2023-03-21,8711
2881,富邦金,40,1,39,陽信-石牌,2023-03-21,8711
2430,燦坤,39,0,39,陽信-石牌,2023-03-21,8711
2883,凱基金,38,0,38,陽信-石牌,2023-03-21,8711
4934,太極,36,1,35,陽信-石牌,2023-03-21,8711
6288,聯嘉,197,162,35,陽信-石牌,2023-03-21,8711
6443,元晶,250,218,32,陽信-石牌,2023-03-21,8711
6515,穎崴,30,0,30,陽信-石牌,2023-03-21,8711
4953,緯軟,27,0,27,陽信-石牌,2023-03-21,8711
3652,精聯,26,0,26,陽信-石牌,2023-03-21,8711
00632R,元大台灣50反1,25,0,25,陽信-石牌,2023-03-21,8711
6770,力積電,23,0,23,陽信-石牌,2023-03-21,8711
2427,三商電,21,0,21,陽信-石牌,2023-03-21,8711
3017,奇鋐,23,2,21,陽信-石牌,2023-03-21,8711
4804,大略-KY,20,0,20,陽信-石牌,2023-03-21,8711
5481,新華,20,0,20,陽信-石牌,2023-03-21,8711
6788,華景電,25,6,19,陽信-石牌,2023-03-21,8711
4960,誠美材,20,2,18,陽信-石牌,2023-03-21,8711
2409,友達,26,10,16,陽信-石牌,2023-03-21,8711
2609,陽明,21,5,16,陽信-石牌,2023-03-21,8711
5425,台半,16,0,16,陽信-石牌,2023-03-21,8711
2344,華邦電,24,9,15,陽信-石牌,2023-03-21,8711
3027,盛達,15,0,15,陽信-石牌,2023-03-21,8711
6442,光聖,15,0,15,陽信-石牌,2023-03-21,8711
2607,榮運,13,0,13,陽信-石牌,2023-03-21,8711
1513,中興電,37,25,12,陽信-石牌,2023-03-21,8711
3434,哲固,22,10,12,陽信-石牌,2023-03-21,8711
8050,廣積,12,0,12,陽信-石牌,2023-03-21,8711
2206,三陽工業,12,1,11,陽信-石牌,2023-03-21,8711
2748,雲品,19,8,11,陽信-石牌,2023-03-21,8711
1326,台化,10,0,10,陽信-石牌,2023-03-21,8711
1815,富喬,10,0,10,陽信-石牌,2023-03-21,8711
2014,中鴻,15,5,10,陽信-石牌,2023-03-21,8711
2102,泰豐,10,0,10,陽信-石牌,2023-03-21,8711
2338,光罩,10,0,10,陽信-石牌,2023-03-21,8711
2615,萬海,12,2,10,陽信-石牌,2023-03-21,8711
2634,漢翔,43,33,10,陽信-石牌,2023-03-21,8711
2882,國泰金,10,0,10,陽信-石牌,2023-03-21,8711
3704,合勤控,10,0,10,陽信-石牌,2023-03-21,8711
4739,康普,15,5,10,陽信-石牌,2023-03-21,8711
2007,燁興,9,0,9,陽信-石牌,2023-03-21,8711
3231,緯創,25,16,9,陽信-石牌,2023-03-21,8711
5388,中磊,10,1,9,陽信-石牌,2023-03-21,8711
6531,愛普*,18,9,9,陽信-石牌,2023-03-21,8711
8033,雷虎,10,1,9,陽信-石牌,2023-03-21,8711
2834,臺企銀,412,5,407,陽信-石牌,2023-03-22,8711
3710,連展投控,120,22,98,陽信-石牌,2023-03-22,8711
3059,華晶科,100,12,88,陽信-石牌,2023-03-22,8711
00772B,中信高評級公司債,48,0,48,陽信-石牌,2023-03-22,8711
00720B,元大投資級公司債,48,0,48,陽信-石牌,2023-03-22,8711
1455,集盛,47,0,47,陽信-石牌,2023-03-22,8711
00679B,元大美債20年,46,0,46,陽信-石牌,2023-03-22,8711
00712,復華富時不動產,46,0,46,陽信-石牌,2023-03-22,8711
00632R,元大台灣50反1,45,2,43,陽信-石牌,2023-03-22,8711
00751B,元大AAA至A公司債,40,0,40,陽信-石牌,2023-03-22,8711
5515,建國,40,0,40,陽信-石牌,2023-03-22,8711
2482,連宇,56,19,37,陽信-石牌,2023-03-22,8711
2413,環科,46,15,31,陽信-石牌,2023-03-22,8711
2609,陽明,40,9,31,陽信-石牌,2023-03-22,8711
2211,長榮鋼,30,0,30,陽信-石牌,2023-03-22,8711
8454,富邦媒,26,1,25,陽信-石牌,2023-03-22,8711
2457,飛宏,106,82,24,陽信-石牌,2023-03-22,8711
00900,富邦特選高股息30,23,0,23,陽信-石牌,2023-03-22,8711
2891,中信金,31,9,22,陽信-石牌,2023-03-22,8711
3013,晟銘電,33,15,18,陽信-石牌,2023-03-22,8711
3499,環天科,18,0,18,陽信-石牌,2023-03-22,8711
8383,千附,19,2,17,陽信-石牌,2023-03-22,8711
5481,新華,15,0,15,陽信-石牌,2023-03-22,8711
6122,擎邦,48,33,15,陽信-石牌,2023-03-22,8711
2453,凌群,17,3,14,陽信-石牌,2023-03-22,8711
1504,東元,53,39,14,陽信-石牌,2023-03-22,8711
3010,華立,12,0,12,陽信-石牌,2023-03-22,8711
1609,大亞,11,0,11,陽信-石牌,2023-03-22,8711
8215,明基材,11,0,11,陽信-石牌,2023-03-22,8711
00779B,凱基美債25+,10,0,10,陽信-石牌,2023-03-22,8711
00713,元大台灣高息低波,11,1,10,陽信-石牌,2023-03-22,8711
1409,新纖,10,0,10,陽信-石牌,2023-03-22,8711
1605,華新,84,74,10,陽信-石牌,2023-03-22,8711
1718,中纖,10,0,10,陽信-石牌,2023-03-22,8711
2002,中鋼,19,9,10,陽信-石牌,2023-03-22,8711
3011,今皓,10,0,10,陽信-石牌,2023-03-22,8711
3051,力特,10,0,10,陽信-石牌,2023-03-22,8711
4953,緯軟,17,7,10,陽信-石牌,2023-03-22,8711
5309,系統電,11,1,10,陽信-石牌,2023-03-22,8711
5353,台林,13,3,10,陽信-石牌,2023-03-22,8711
6288,聯嘉,81,71,10,陽信-石牌,2023-03-22,8711
6806,森崴能源,10,0,10,陽信-石牌,2023-03-22,8711
1611,中電,24,15,9,陽信-石牌,2023-03-22,8711
4114,健喬,10,1,9,陽信-石牌,2023-03-22,8711
4543,萬在,11,2,9,陽信-石牌,2023-03-22,8711
6275,元山,10,1,9,陽信-石牌,2023-03-22,8711
6733,博晟生醫,9,0,9,陽信-石牌,2023-03-22,8711
2206,三陽工業,10,2,8,陽信-石牌,2023-03-22,8711
2606,裕民,9,1,8,陽信-石牌,2023-03-22,8711
3047,訊舟,8,0,8,陽信-石牌,2023-03-22,8711
3481,群創,109,4,105,陽信-石牌,2023-03-23,8711
00632R,元大台灣50反1,95,0,95,陽信-石牌,2023-03-23,8711
2375,凱美,75,3,72,陽信-石牌,2023-03-23,8711
8155,博智,54,0,54,陽信-石牌,2023-03-23,8711
1213,大飲,40,0,40,陽信-石牌,2023-03-23,8711
6411,晶焱,40,0,40,陽信-石牌,2023-03-23,8711
6116,彩晶,45,7,38,陽信-石牌,2023-03-23,8711
3306,鼎天,85,58,27,陽信-石牌,2023-03-23,8711
2883,凱基金,30,6,24,陽信-石牌,2023-03-23,8711
2637,慧洋-KY,25,2,23,陽信-石牌,2023-03-23,8711
1903,士紙,21,0,21,陽信-石牌,2023-03-23,8711
3051,力特,21,0,21,陽信-石牌,2023-03-23,8711
2534,宏盛,20,0,20,陽信-石牌,2023-03-23,8711
2356,英業達,20,1,19,陽信-石牌,2023-03-23,8711
2427,三商電,29,10,19,陽信-石牌,2023-03-23,8711
3231,緯創,19,1,18,陽信-石牌,2023-03-23,8711
00885,富邦越南,16,0,16,陽信-石牌,2023-03-23,8711
2413,環科,38,22,16,陽信-石牌,2023-03-23,8711
1504,東元,38,23,15,陽信-石牌,2023-03-23,8711
5481,新華,15,0,15,陽信-石牌,2023-03-23,8711
2204,中華,18,4,14,陽信-石牌,2023-03-23,8711
3029,零壹,15,1,14,陽信-石牌,2023-03-23,8711
9955,佳龍,14,0,14,陽信-石牌,2023-03-23,8711
2606,裕民,13,0,13,陽信-石牌,2023-03-23,8711
4934,太極,20,7,13,陽信-石牌,2023-03-23,8711
2603,長榮,27,15,12,陽信-石牌,2023-03-23,8711
2471,資通,12,1,11,陽信-石牌,2023-03-23,8711
3447,展達,11,0,11,陽信-石牌,2023-03-23,8711
00712,復華富時不動產,10,0,10,陽信-石牌,2023-03-23,8711
2368,金像電,25,15,10,陽信-石牌,2023-03-23,8711
2409,友達,15,5,10,陽信-石牌,2023-03-23,8711
4123,晟德,10,0,10,陽信-石牌,2023-03-23,8711
4950,牧東,10,0,10,陽信-石牌,2023-03-23,8711
5381,合正,10,0,10,陽信-石牌,2023-03-23,8711
6138,茂達,11,1,10,陽信-石牌,2023-03-23,8711
6179,亞通,10,0,10,陽信-石牌,2023-03-23,8711
8215,明基材,10,0,10,陽信-石牌,2023-03-23,8711
2481,強茂,11,2,9,陽信-石牌,2023-03-23,8711
3017,奇鋐,15,6,9,陽信-石牌,2023-03-23,8711
3532,台勝科,8,0,8,陽信-石牌,2023-03-23,8711
1524,耿鼎,10,2,8,陽信-石牌,2023-03-23,8711
2402,毅嘉,31,23,8,陽信-石牌,2023-03-23,8711
3041,揚智,9,1,8,陽信-石牌,2023-03-23,8711
4943,康控-KY,8,0,8,陽信-石牌,2023-03-23,8711
5289,宜鼎,10,2,8,陽信-石牌,2023-03-23,8711
9907,統一實,9,1,8,陽信-石牌,2023-03-23,8711
1513,中興電,65,58,7,陽信-石牌,2023-03-23,8711
2605,新興,9,2,7,陽信-石牌,2023-03-23,8711
3322,建舜電,30,23,7,陽信-石牌,2023-03-23,8711
5512,力麒,7,0,7,陽信-石牌,2023-03-23,8711
00650L,復華香港正2,800,0,800,陽信-石牌,2023-03-24,8711
00632R,元大台灣50反1,914,265,649,陽信-石牌,2023-03-24,8711
2601,益航,91,0,91,陽信-石牌,2023-03-24,8711
3406,玉晶光,65,6,59,陽信-石牌,2023-03-24,8711
00712,復華富時不動產,49,1,48,陽信-石牌,2023-03-24,8711
2883,凱基金,45,0,45,陽信-石牌,2023-03-24,8711
2609,陽明,51,7,44,陽信-石牌,2023-03-24,8711
2492,華新科,40,0,40,陽信-石牌,2023-03-24,8711
2442,新美齊,39,0,39,陽信-石牌,2023-03-24,8711
3481,群創,34,0,34,陽信-石牌,2023-03-24,8711
2736,富野,33,0,33,陽信-石牌,2023-03-24,8711
2375,凱美,30,0,30,陽信-石牌,2023-03-24,8711
2897,王道銀行,30,0,30,陽信-石牌,2023-03-24,8711
6788,華景電,32,4,28,陽信-石牌,2023-03-24,8711
2881,富邦金,28,1,27,陽信-石牌,2023-03-24,8711
2303,聯電,26,5,21,陽信-石牌,2023-03-24,8711
1718,中纖,20,0,20,陽信-石牌,2023-03-24,8711
4953,緯軟,30,10,20,陽信-石牌,2023-03-24,8711
6691,洋基工程,21,2,19,陽信-石牌,2023-03-24,8711
5425,台半,43,25,18,陽信-石牌,2023-03-24,8711
8033,雷虎,27,9,18,陽信-石牌,2023-03-24,8711
8171,天宇,20,2,18,陽信-石牌,2023-03-24,8711
2637,慧洋-KY,17,0,17,陽信-石牌,2023-03-24,8711
2439,美律,56,40,16,陽信-石牌,2023-03-24,8711
00651R,復華香港反1,15,0,15,陽信-石牌,2023-03-24,8711
5481,新華,15,0,15,陽信-石牌,2023-03-24,8711
2618,長榮航,14,0,14,陽信-石牌,2023-03-24,8711
2634,漢翔,23,9,14,陽信-石牌,2023-03-24,8711
2017,官田鋼,13,0,13,陽信-石牌,2023-03-24,8711
3094,聯傑,13,0,13,陽信-石牌,2023-03-24,8711
4755,三福化,13,0,13,陽信-石牌,2023-03-24,8711
3441,聯一光,28,16,12,陽信-石牌,2023-03-24,8711
1504,東元,22,11,11,陽信-石牌,2023-03-24,8711
3362,先進光,11,0,11,陽信-石牌,2023-03-24,8711
3715,定穎投控,251,240,11,陽信-石牌,2023-03-24,8711
1409,新纖,10,0,10,陽信-石牌,2023-03-24,8711
1464,得力,10,0,10,陽信-石牌,2023-03-24,8711
1319,東陽,12,2,10,陽信-石牌,2023-03-24,8711
00900,富邦特選高股息30,10,0,10,陽信-石牌,2023-03-24,8711
2367,燿華,10,0,10,陽信-石牌,2023-03-24,8711
3011,今皓,10,0,10,陽信-石牌,2023-03-24,8711
3038,全台,10,0,10,陽信-石牌,2023-03-24,8711
3051,力特,15,5,10,陽信-石牌,2023-03-24,8711
3630,新鉅科,10,0,10,陽信-石牌,2023-03-24,8711
5014,建錩,10,0,10,陽信-石牌,2023-03-24,8711
6147,頎邦,10,0,10,陽信-石牌,2023-03-24,8711
6266,泰詠,10,0,10,陽信-石牌,2023-03-24,8711
00893,國泰智能電動車,10,1,9,陽信-石牌,2023-03-24,8711
00919,群益台灣精選高息,9,0,9,陽信-石牌,2023-03-24,8711
2206,三陽工業,9,0,9,陽信-石牌,2023-03-24,8711
6143,振曜,251,0,251,陽信-石牌,2023-03-27,8711
00650L,復華香港正2,204,0,204,陽信-石牌,2023-03-27,8711
00632R,元大台灣50反1,203,0,203,陽信-石牌,2023-03-27,8711
2881,富邦金,154,0,154,陽信-石牌,2023-03-27,8711
2102,泰豐,80,0,80,陽信-石牌,2023-03-27,8711
2344,華邦電,110,33,77,陽信-石牌,2023-03-27,8711
2496,卓越,70,0,70,陽信-石牌,2023-03-27,8711
5478,智冠,50,0,50,陽信-石牌,2023-03-27,8711
9105,泰金寶-DR,50,0,50,陽信-石牌,2023-03-27,8711
4953,緯軟,43,0,43,陽信-石牌,2023-03-27,8711
1609,大亞,49,14,35,陽信-石牌,2023-03-27,8711
1605,華新,44,13,31,陽信-石牌,2023-03-27,8711
1810,和成,35,8,27,陽信-石牌,2023-03-27,8711
2324,仁寶,27,0,27,陽信-石牌,2023-03-27,8711
8155,博智,28,3,25,陽信-石牌,2023-03-27,8711
3056,富華新,25,1,24,陽信-石牌,2023-03-27,8711
3576,聯合再生,26,2,24,陽信-石牌,2023-03-27,8711
1504,東元,88,65,23,陽信-石牌,2023-03-27,8711
6244,茂迪,57,34,23,陽信-石牌,2023-03-27,8711
2634,漢翔,53,32,21,陽信-石牌,2023-03-27,8711
00922,國泰台灣領袖50,20,0,20,陽信-石牌,2023-03-27,8711
2601,益航,20,0,20,陽信-石牌,2023-03-27,8711
2736,富野,20,0,20,陽信-石牌,2023-03-27,8711
5481,新華,20,0,20,陽信-石牌,2023-03-27,8711
3231,緯創,26,6,20,陽信-石牌,2023-03-27,8711
2353,宏��,20,2,18,陽信-石牌,2023-03-27,8711
6288,聯嘉,29,11,18,陽信-石牌,2023-03-27,8711
00878,國泰永續高股息,23,6,17,陽信-石牌,2023-03-27,8711
3264,欣銓,17,0,17,陽信-石牌,2023-03-27,8711
2329,華泰,56,40,16,陽信-石牌,2023-03-27,8711
00725B,國泰投資級公司債,15,0,15,陽信-石牌,2023-03-27,8711
2302,麗正,15,0,15,陽信-石牌,2023-03-27,8711
6442,光聖,12,0,12,陽信-石牌,2023-03-27,8711
1101,台泥,22,11,11,陽信-石牌,2023-03-27,8711
00715L,期街口布蘭特正2,11,0,11,陽信-石牌,2023-03-27,8711
2002,中鋼,19,8,11,陽信-石牌,2023-03-27,8711
2345,智邦,11,0,11,陽信-石牌,2023-03-27,8711
2471,資通,15,4,11,陽信-石牌,2023-03-27,8711
3484,崧騰,11,0,11,陽信-石牌,2023-03-27,8711
6733,博晟生醫,13,2,11,陽信-石牌,2023-03-27,8711
1506,正道,10,0,10,陽信-石牌,2023-03-27,8711
00712,復華富時不動產,10,0,10,陽信-石牌,2023-03-27,8711
00882,中信中國高股息,10,0,10,陽信-石牌,2023-03-27,8711
1218,泰山,10,0,10,陽信-石牌,2023-03-27,8711
2444,兆勁,10,0,10,陽信-石牌,2023-03-27,8711
3322,建舜電,10,0,10,陽信-石牌,2023-03-27,8711
3481,群創,20,10,10,陽信-石牌,2023-03-27,8711
3689,湧德,10,0,10,陽信-石牌,2023-03-27,8711
4190,佐登-KY,10,0,10,陽信-石牌,2023-03-27,8711
4903,聯光通,10,0,10,陽信-石牌,2023-03-27,8711
6443,元晶,1328,18,1310,陽信-石牌,2023-03-28,8711
00632R,元大台灣50反1,623,10,613,陽信-石牌,2023-03-28,8711
00922,國泰台灣領袖50,51,0,51,陽信-石牌,2023-03-28,8711
1605,華新,223,176,47,陽信-石牌,2023-03-28,8711
3211,順達,41,0,41,陽信-石牌,2023-03-28,8711
3037,欣興,52,13,39,陽信-石牌,2023-03-28,8711
6294,智基,34,0,34,陽信-石牌,2023-03-28,8711
2388,威盛,32,2,30,陽信-石牌,2023-03-28,8711
2610,華航,31,2,29,陽信-石牌,2023-03-28,8711
2317,鴻海,33,6,27,陽信-石牌,2023-03-28,8711
2211,長榮鋼,25,0,25,陽信-石牌,2023-03-28,8711
0056,元大高股息,23,0,23,陽信-石牌,2023-03-28,8711
6168,宏齊,23,0,23,陽信-石牌,2023-03-28,8711
2409,友達,31,9,22,陽信-石牌,2023-03-28,8711
2444,兆勁,20,0,20,陽信-石牌,2023-03-28,8711
2834,臺企銀,20,0,20,陽信-石牌,2023-03-28,8711
2883,凱基金,20,0,20,陽信-石牌,2023-03-28,8711
6116,彩晶,20,1,19,陽信-石牌,2023-03-28,8711
6226,光鼎,20,1,19,陽信-石牌,2023-03-28,8711
2402,毅嘉,37,19,18,陽信-石牌,2023-03-28,8711
2880,華南金,20,3,17,陽信-石牌,2023-03-28,8711
6266,泰詠,17,0,17,陽信-石牌,2023-03-28,8711
2347,聯強,16,0,16,陽信-石牌,2023-03-28,8711
3264,欣銓,19,3,16,陽信-石牌,2023-03-28,8711
3231,緯創,16,1,15,陽信-石牌,2023-03-28,8711
3294,英濟,15,0,15,陽信-石牌,2023-03-28,8711
6411,晶焱,40,25,15,陽信-石牌,2023-03-28,8711
6752,叡揚,14,0,14,陽信-石牌,2023-03-28,8711
8222,寶一,16,2,14,陽信-石牌,2023-03-28,8711
00923,群益台ESG低碳50,13,0,13,陽信-石牌,2023-03-28,8711
3710,連展投控,17,4,13,陽信-石牌,2023-03-28,8711
00878,國泰永續高股息,26,14,12,陽信-石牌,2023-03-28,8711
2344,華邦電,21,9,12,陽信-石牌,2023-03-28,8711
2884,玉山金,12,0,12,陽信-石牌,2023-03-28,8711
8155,博智,14,2,12,陽信-石牌,2023-03-28,8711
5425,台半,24,12,12,陽信-石牌,2023-03-28,8711
2303,聯電,32,21,11,陽信-石牌,2023-03-28,8711
2534,宏盛,11,0,11,陽信-石牌,2023-03-28,8711
2736,富野,14,3,11,陽信-石牌,2023-03-28,8711
3035,智原,18,7,11,陽信-石牌,2023-03-28,8711
6134,萬旭,11,0,11,陽信-石牌,2023-03-28,8711
00687B,國泰20年美債,10,0,10,陽信-石牌,2023-03-28,8711
1609,大亞,28,18,10,陽信-石牌,2023-03-28,8711
2845,遠東銀,10,0,10,陽信-石牌,2023-03-28,8711
3576,聯合再生,10,0,10,陽信-石牌,2023-03-28,8711
3686,達能,10,0,10,陽信-石牌,2023-03-28,8711
3714,富采,11,1,10,陽信-石牌,2023-03-28,8711
4903,聯光通,10,0,10,陽信-石牌,2023-03-28,8711
8033,雷虎,11,1,10,陽信-石牌,2023-03-28,8711
8215,明基材,10,0,10,陽信-石牌,2023-03-28,8711
00632R,元大台灣50反1,100,30,70,陽信-石牌,2023-03-29,8711
00922,國泰台灣領袖50,58,0,58,陽信-石牌,2023-03-29,8711
2329,華泰,63,10,53,陽信-石牌,2023-03-29,8711
00650L,復華香港正2,50,1,49,陽信-石牌,2023-03-29,8711
2331,精英,57,27,30,陽信-石牌,2023-03-29,8711
00679B,元大美債20年,23,0,23,陽信-石牌,2023-03-29,8711
2303,聯電,57,34,23,陽信-石牌,2023-03-29,8711
6235,華孚,36,15,21,陽信-石牌,2023-03-29,8711
00712,復華富時不動產,20,0,20,陽信-石牌,2023-03-29,8711
4532,瑞智,20,0,20,陽信-石牌,2023-03-29,8711
3447,展達,23,6,17,陽信-石牌,2023-03-29,8711
00878,國泰永續高股息,22,7,15,陽信-石牌,2023-03-29,8711
1504,東元,30,17,13,陽信-石牌,2023-03-29,8711
2323,中環,13,0,13,陽信-石牌,2023-03-29,8711
2340,台亞,14,1,13,陽信-石牌,2023-03-29,8711
2603,長榮,13,1,12,陽信-石牌,2023-03-29,8711
5243,乙盛-KY,13,2,11,陽信-石牌,2023-03-29,8711
8215,明基材,11,0,11,陽信-石牌,2023-03-29,8711
1720,生達,10,0,10,陽信-石牌,2023-03-29,8711
2444,兆勁,10,0,10,陽信-石牌,2023-03-29,8711
2615,萬海,10,0,10,陽信-石牌,2023-03-29,8711
2617,台航,10,0,10,陽信-石牌,2023-03-29,8711
2886,兆豐金,10,0,10,陽信-石牌,2023-03-29,8711
2908,特力,10,0,10,陽信-石牌,2023-03-29,8711
3294,英濟,10,0,10,陽信-石牌,2023-03-29,8711
3508,位速,10,0,10,陽信-石牌,2023-03-29,8711
5011,久陽,10,0,10,陽信-石牌,2023-03-29,8711
6168,宏齊,10,0,10,陽信-石牌,2023-03-29,8711
6177,達麗,10,0,10,陽信-石牌,2023-03-29,8711
6443,元晶,12,2,10,陽信-石牌,2023-03-29,8711
6753,龍德造船,11,2,9,陽信-石牌,2023-03-29,8711
2637,慧洋-KY,8,0,8,陽信-石牌,2023-03-29,8711
3594,磐儀,9,1,8,陽信-石牌,2023-03-29,8711
00725B,國泰投資級公司債,7,0,7,陽信-石牌,2023-03-29,8711
2413,環科,12,5,7,陽信-石牌,2023-03-29,8711
3025,星通,12,5,7,陽信-石牌,2023-03-29,8711
4961,天鈺,7,0,7,陽信-石牌,2023-03-29,8711
5516,雙喜,7,0,7,陽信-石牌,2023-03-29,8711
6109,亞元,7,0,7,陽信-石牌,2023-03-29,8711
8050,廣積,7,0,7,陽信-石牌,2023-03-29,8711
8936,國統,9,2,7,陽信-石牌,2023-03-29,8711
2606,裕民,6,0,6,陽信-石牌,2023-03-29,8711
3653,健策,7,1,6,陽信-石牌,2023-03-29,8711
6205,詮欣,6,0,6,陽信-石牌,2023-03-29,8711
6245,立端,7,1,6,陽信-石牌,2023-03-29,8711
3035,智原,11,6,5,陽信-石牌,2023-03-29,8711
00891,中信關鍵半導體,5,0,5,陽信-石牌,2023-03-29,8711
00902,中信電池及儲能,5,0,5,陽信-石牌,2023-03-29,8711
00893,國泰智能電動車,5,0,5,陽信-石牌,2023-03-29,8711
020034,元大IC設計N,5,0,5,陽信-石牌,2023-03-29,8711
00632R,元大台灣50反1,285,95,190,陽信-石牌,2023-03-30,8711
2504,國產,90,1,89,陽信-石牌,2023-03-30,8711
2344,華邦電,107,19,88,陽信-石牌,2023-03-30,8711
2618,長榮航,73,9,64,陽信-石牌,2023-03-30,8711
00922,國泰台灣領袖50,51,0,51,陽信-石牌,2023-03-30,8711
00650L,復華香港正2,56,6,50,陽信-石牌,2023-03-30,8711
2834,臺企銀,40,0,40,陽信-石牌,2023-03-30,8711
2356,英業達,40,3,37,陽信-石牌,2023-03-30,8711
2498,宏達電,33,2,31,陽信-石牌,2023-03-30,8711
1218,泰山,30,0,30,陽信-石牌,2023-03-30,8711
5481,新華,30,0,30,陽信-石牌,2023-03-30,8711
2610,華航,25,2,23,陽信-石牌,2023-03-30,8711
2736,富野,20,0,20,陽信-石牌,2023-03-30,8711
4702,中美實,20,0,20,陽信-石牌,2023-03-30,8711
1903,士紙,17,0,17,陽信-石牌,2023-03-30,8711
00902,中信電池及儲能,15,0,15,陽信-石牌,2023-03-30,8711
6156,松上,13,0,13,陽信-石牌,2023-03-30,8711
1504,東元,31,20,11,陽信-石牌,2023-03-30,8711
2359,所羅門,15,4,11,陽信-石牌,2023-03-30,8711
3231,緯創,36,25,11,陽信-石牌,2023-03-30,8711
1314,中石化,10,0,10,陽信-石牌,2023-03-30,8711
1217,愛之味,10,0,10,陽信-石牌,2023-03-30,8711
1605,華新,45,35,10,陽信-石牌,2023-03-30,8711
1752,南光,10,0,10,陽信-石牌,2023-03-30,8711
2617,台航,10,0,10,陽信-石牌,2023-03-30,8711
2867,三商壽,10,0,10,陽信-石牌,2023-03-30,8711
2891,中信金,10,0,10,陽信-石牌,2023-03-30,8711
5388,中磊,11,1,10,陽信-石牌,2023-03-30,8711
5452,佶優,10,0,10,陽信-石牌,2023-03-30,8711
6265,方土昶,10,0,10,陽信-石牌,2023-03-30,8711
8074,鉅橡,10,0,10,陽信-石牌,2023-03-30,8711
00893,國泰智能電動車,15,6,9,陽信-石牌,2023-03-30,8711
3041,揚智,13,4,9,陽信-石牌,2023-03-30,8711
2409,友達,83,75,8,陽信-石牌,2023-03-30,8711
2890,永豐金,8,0,8,陽信-石牌,2023-03-30,8711
5243,乙盛-KY,8,0,8,陽信-石牌,2023-03-30,8711
6180,橘子,8,0,8,陽信-石牌,2023-03-30,8711
2426,鼎元,10,3,7,陽信-石牌,2023-03-30,8711
2889,國票金,7,0,7,陽信-石牌,2023-03-30,8711
5351,鈺創,11,4,7,陽信-石牌,2023-03-30,8711
2204,中華,6,0,6,陽信-石牌,2023-03-30,8711
2455,全新,6,0,6,陽信-石牌,2023-03-30,8711
4976,佳凌,7,1,6,陽信-石牌,2023-03-30,8711
6133,金橋,9,3,6,陽信-石牌,2023-03-30,8711
6752,叡揚,8,2,6,陽信-石牌,2023-03-30,8711
8086,宏捷科,9,3,6,陽信-石牌,2023-03-30,8711
1108,幸福,5,0,5,陽信-石牌,2023-03-30,8711
1104,環泥,5,0,5,陽信-石牌,2023-03-30,8711
00772B,中信高評級公司債,5,0,5,陽信-石牌,2023-03-30,8711
00720B,元大投資級公司債,5,0,5,陽信-石牌,2023-03-30,8711
00632R,元大台灣50反1,340,130,210,陽信-石牌,2023-03-31,8711
00669R,國泰美國道瓊反1,80,0,80,陽信-石牌,2023-03-31,8711
2881,富邦金,56,0,56,陽信-石牌,2023-03-31,8711
00922,國泰台灣領袖50,52,0,52,陽信-石牌,2023-03-31,8711
5481,新華,30,0,30,陽信-石牌,2023-03-31,8711
00852L,國泰美國道瓊正2,28,0,28,陽信-石牌,2023-03-31,8711
2102,泰豐,28,0,28,陽信-石牌,2023-03-31,8711
3051,力特,23,0,23,陽信-石牌,2023-03-31,8711
00893,國泰智能電動車,21,0,21,陽信-石牌,2023-03-31,8711
00885,富邦越南,20,0,20,陽信-石牌,2023-03-31,8711
1611,中電,51,31,20,陽信-石牌,2023-03-31,8711
8215,明基材,18,0,18,陽信-石牌,2023-03-31,8711
3346,麗清,17,1,16,陽信-石牌,2023-03-31,8711
2344,華邦電,306,291,15,陽信-石牌,2023-03-31,8711
2402,毅嘉,27,12,15,陽信-石牌,2023-03-31,8711
2457,飛宏,64,49,15,陽信-石牌,2023-03-31,8711
2515,中工,16,2,14,陽信-石牌,2023-03-31,8711
8222,寶一,27,14,13,陽信-石牌,2023-03-31,8711
00673R,期元大S＆P原油反1,12,0,12,陽信-石牌,2023-03-31,8711
1903,士紙,11,0,11,陽信-石牌,2023-03-31,8711
1506,正道,10,0,10,陽信-石牌,2023-03-31,8711
1605,華新,142,132,10,陽信-石牌,2023-03-31,8711
2312,金寶,10,0,10,陽信-石牌,2023-03-31,8711
2328,廣宇,10,0,10,陽信-石牌,2023-03-31,8711
2702,華園,10,0,10,陽信-石牌,2023-03-31,8711
3294,英濟,10,0,10,陽信-石牌,2023-03-31,8711
3508,位速,12,2,10,陽信-石牌,2023-03-31,8711
3567,逸昌,10,0,10,陽信-石牌,2023-03-31,8711
3686,達能,10,0,10,陽信-石牌,2023-03-31,8711
3707,漢磊,10,0,10,陽信-石牌,2023-03-31,8711
8176,智捷,10,0,10,陽信-石牌,2023-03-31,8711
9955,佳龍,10,0,10,陽信-石牌,2023-03-31,8711
3056,富華新,12,3,9,陽信-石牌,2023-03-31,8711
3231,緯創,20,11,9,陽信-石牌,2023-03-31,8711
00900,富邦特選高股息30,8,0,8,陽信-石牌,2023-03-31,8711
3711,日月光投控,8,0,8,陽信-石牌,2023-03-31,8711
5521,工信,8,0,8,陽信-石牌,2023-03-31,8711
6233,旺玖,15,7,8,陽信-石牌,2023-03-31,8711
6470,宇智,11,3,8,陽信-石牌,2023-03-31,8711
2342,茂矽,9,2,7,陽信-石牌,2023-03-31,8711
2603,長榮,12,5,7,陽信-石牌,2023-03-31,8711
6441,廣錠,8,1,7,陽信-石牌,2023-03-31,8711
6719,力智,7,0,7,陽信-石牌,2023-03-31,8711
2027,大成鋼,8,1,7,陽信-石牌,2023-03-31,8711
2368,金像電,6,0,6,陽信-石牌,2023-03-31,8711
2201,裕隆,31,25,6,陽信-石牌,2023-03-31,8711
3268,海德威,6,0,6,陽信-石牌,2023-03-31,8711
3338,泰碩,6,0,6,陽信-石牌,2023-03-31,8711
6669,緯穎,6,0,6,陽信-石牌,2023-03-31,8711
1609,大亞,11,6,5,陽信-石牌,2023-03-31,8711
00673R,期元大S＆P原油反1,490,0,490,陽信-石牌,2023-04-06,8711
00650L,復華香港正2,200,2,198,陽信-石牌,2023-04-06,8711
2881,富邦金,155,6,149,陽信-石牌,2023-04-06,8711
00882,中信中國高股息,104,0,104,陽信-石牌,2023-04-06,8711
00632R,元大台灣50反1,150,55,95,陽信-石牌,2023-04-06,8711
2102,泰豐,50,0,50,陽信-石牌,2023-04-06,8711
2606,裕民,129,86,43,陽信-石牌,2023-04-06,8711
2617,台航,40,0,40,陽信-石牌,2023-04-06,8711
3289,宜特,35,0,35,陽信-石牌,2023-04-06,8711
9105,泰金寶-DR,32,0,32,陽信-石牌,2023-04-06,8711
1605,華新,217,187,30,陽信-石牌,2023-04-06,8711
2851,中再保,30,0,30,陽信-石牌,2023-04-06,8711
5481,新華,30,0,30,陽信-石牌,2023-04-06,8711
00878,國泰永續高股息,37,8,29,陽信-石牌,2023-04-06,8711
6548,長科*,28,3,25,陽信-石牌,2023-04-06,8711
0056,元大高股息,24,0,24,陽信-石牌,2023-04-06,8711
2891,中信金,24,0,24,陽信-石牌,2023-04-06,8711
3231,緯創,23,0,23,陽信-石牌,2023-04-06,8711
2618,長榮航,62,40,22,陽信-石牌,2023-04-06,8711
8110,華東,22,0,22,陽信-石牌,2023-04-06,8711
2603,長榮,22,0,22,陽信-石牌,2023-04-06,8711
00712,復華富時不動產,20,0,20,陽信-石牌,2023-04-06,8711
3490,單井,20,0,20,陽信-石牌,2023-04-06,8711
3058,立德,23,5,18,陽信-石牌,2023-04-06,8711
6163,華電網,23,6,17,陽信-石牌,2023-04-06,8711
3290,東浦,15,0,15,陽信-石牌,2023-04-06,8711
00893,國泰智能電動車,14,0,14,陽信-石牌,2023-04-06,8711
4157,太景*-KY,20,6,14,陽信-石牌,2023-04-06,8711
00902,中信電池及儲能,13,0,13,陽信-石牌,2023-04-06,8711
2637,慧洋-KY,14,1,13,陽信-石牌,2023-04-06,8711
3664,安瑞-KY,13,0,13,陽信-石牌,2023-04-06,8711
00679B,元大美債20年,13,1,12,陽信-石牌,2023-04-06,8711
1611,中電,15,3,12,陽信-石牌,2023-04-06,8711
2317,鴻海,17,5,12,陽信-石牌,2023-04-06,8711
2342,茂矽,14,2,12,陽信-石牌,2023-04-06,8711
2615,萬海,12,0,12,陽信-石牌,2023-04-06,8711
3037,欣興,11,0,11,陽信-石牌,2023-04-06,8711
1220,台榮,11,0,11,陽信-石牌,2023-04-06,8711
2347,聯強,11,0,11,陽信-石牌,2023-04-06,8711
8069,元太,11,1,10,陽信-石牌,2023-04-06,8711
00713,元大台灣高息低波,10,0,10,陽信-石牌,2023-04-06,8711
1560,中砂,45,35,10,陽信-石牌,2023-04-06,8711
2027,大成鋼,10,0,10,陽信-石牌,2023-04-06,8711
2444,兆勁,10,0,10,陽信-石牌,2023-04-06,8711
2886,兆豐金,10,0,10,陽信-石牌,2023-04-06,8711
3038,全台,14,4,10,陽信-石牌,2023-04-06,8711
6129,普誠,10,0,10,陽信-石牌,2023-04-06,8711
6148,驊宏資,10,0,10,陽信-石牌,2023-04-06,8711
6152,百一,10,0,10,陽信-石牌,2023-04-06,8711
6156,松上,10,0,10,陽信-石牌,2023-04-06,8711
00632R,元大台灣50反1,255,80,175,陽信-石牌,2023-04-07,8711
00712,復華富時不動產,122,0,122,陽信-石牌,2023-04-07,8711
00671R,富邦NASDAQ反1,100,40,60,陽信-石牌,2023-04-07,8711
00878,國泰永續高股息,50,0,50,陽信-石牌,2023-04-07,8711
2356,英業達,50,7,43,陽信-石牌,2023-04-07,8711
1513,中興電,35,7,28,陽信-石牌,2023-04-07,8711
2705,六福,25,0,25,陽信-石牌,2023-04-07,8711
4804,大略-KY,25,0,25,陽信-石牌,2023-04-07,8711
8028,昇陽半導體,40,15,25,陽信-石牌,2023-04-07,8711
2884,玉山金,24,0,24,陽信-石牌,2023-04-07,8711
3047,訊舟,24,0,24,陽信-石牌,2023-04-07,8711
00679B,元大美債20年,22,0,22,陽信-石牌,2023-04-07,8711
4979,華星光,30,8,22,陽信-石牌,2023-04-07,8711
00902,中信電池及儲能,21,0,21,陽信-石牌,2023-04-07,8711
2409,友達,21,0,21,陽信-石牌,2023-04-07,8711
2610,華航,20,0,20,陽信-石牌,2023-04-07,8711
2617,台航,20,0,20,陽信-石牌,2023-04-07,8711
5481,新華,20,0,20,陽信-石牌,2023-04-07,8711
2645,長榮航太,15,1,14,陽信-石牌,2023-04-07,8711
2834,臺企銀,14,0,14,陽信-石牌,2023-04-07,8711
5351,鈺創,15,1,14,陽信-石牌,2023-04-07,8711
2498,宏達電,20,7,13,陽信-石牌,2023-04-07,8711
2511,太子,13,0,13,陽信-石牌,2023-04-07,8711
6235,華孚,61,48,13,陽信-石牌,2023-04-07,8711
1605,華新,91,79,12,陽信-石牌,2023-04-07,8711
3051,力特,12,0,12,陽信-石牌,2023-04-07,8711
3221,台嘉碩,12,0,12,陽信-石牌,2023-04-07,8711
2891,中信金,13,2,11,陽信-石牌,2023-04-07,8711
4541,晟田,70,59,11,陽信-石牌,2023-04-07,8711
2376,技嘉,10,0,10,陽信-石牌,2023-04-07,8711
00725B,國泰投資級公司債,10,0,10,陽信-石牌,2023-04-07,8711
2338,光罩,10,0,10,陽信-石牌,2023-04-07,8711
4934,太極,12,2,10,陽信-石牌,2023-04-07,8711
6461,益得,10,0,10,陽信-石牌,2023-04-07,8711
2345,智邦,9,0,9,陽信-石牌,2023-04-07,8711
2388,威盛,12,3,9,陽信-石牌,2023-04-07,8711
3058,立德,9,0,9,陽信-石牌,2023-04-07,8711
3217,優群,9,0,9,陽信-石牌,2023-04-07,8711
4147,中裕,9,0,9,陽信-石牌,2023-04-07,8711
4417,金洲,10,1,9,陽信-石牌,2023-04-07,8711
5469,瀚宇博,13,4,9,陽信-石牌,2023-04-07,8711
1434,福懋,8,0,8,陽信-石牌,2023-04-07,8711
1213,大飲,8,0,8,陽信-石牌,2023-04-07,8711
3038,全台,12,4,8,陽信-石牌,2023-04-07,8711
6753,龍德造船,14,6,8,陽信-石牌,2023-04-07,8711
8086,宏捷科,14,6,8,陽信-石牌,2023-04-07,8711
2329,華泰,9,2,7,陽信-石牌,2023-04-07,8711
2364,倫飛,8,1,7,陽信-石牌,2023-04-07,8711
2457,飛宏,36,29,7,陽信-石牌,2023-04-07,8711
6223,旺矽,7,0,7,陽信-石牌,2023-04-07,8711
00632R,元大台灣50反1,456,190,266,陽信-石牌,2023-04-10,8711
9962,有益,152,2,150,陽信-石牌,2023-04-10,8711
8028,昇陽半導體,124,16,108,陽信-石牌,2023-04-10,8711
00878,國泰永續高股息,104,1,103,陽信-石牌,2023-04-10,8711
2344,華邦電,175,90,85,陽信-石牌,2023-04-10,8711
2610,華航,107,40,67,陽信-石牌,2023-04-10,8711
2409,友達,63,0,63,陽信-石牌,2023-04-10,8711
1605,華新,94,55,39,陽信-石牌,2023-04-10,8711
2382,廣達,37,0,37,陽信-石牌,2023-04-10,8711
2303,聯電,41,5,36,陽信-石牌,2023-04-10,8711
00902,中信電池及儲能,30,0,30,陽信-石牌,2023-04-10,8711
00671R,富邦NASDAQ反1,50,20,30,陽信-石牌,2023-04-10,8711
6208,日揚,30,1,29,陽信-石牌,2023-04-10,8711
6294,智基,25,0,25,陽信-石牌,2023-04-10,8711
8183,精星,48,23,25,陽信-石牌,2023-04-10,8711
2454,聯發科,23,0,23,陽信-石牌,2023-04-10,8711
2017,官田鋼,40,20,20,陽信-石牌,2023-04-10,8711
2443,昶虹,20,0,20,陽信-石牌,2023-04-10,8711
5481,新華,20,0,20,陽信-石牌,2023-04-10,8711
6120,達運,20,0,20,陽信-石牌,2023-04-10,8711
4804,大略-KY,20,2,18,陽信-石牌,2023-04-10,8711
3715,定穎投控,25,8,17,陽信-石牌,2023-04-10,8711
1609,大亞,36,19,17,陽信-石牌,2023-04-10,8711
8155,博智,16,0,16,陽信-石牌,2023-04-10,8711
5009,榮剛,20,5,15,陽信-石牌,2023-04-10,8711
2457,飛宏,41,27,14,陽信-石牌,2023-04-10,8711
2444,兆勁,23,10,13,陽信-石牌,2023-04-10,8711
2607,榮運,13,0,13,陽信-石牌,2023-04-10,8711
2634,漢翔,29,16,13,陽信-石牌,2023-04-10,8711
2483,百容,12,0,12,陽信-石牌,2023-04-10,8711
2704,國賓,11,0,11,陽信-石牌,2023-04-10,8711
4114,健喬,108,97,11,陽信-石牌,2023-04-10,8711
6147,頎邦,11,0,11,陽信-石牌,2023-04-10,8711
00712,復華富時不動產,10,0,10,陽信-石牌,2023-04-10,8711
1611,中電,10,0,10,陽信-石牌,2023-04-10,8711
2302,麗正,10,0,10,陽信-石牌,2023-04-10,8711
5014,建錩,10,0,10,陽信-石牌,2023-04-10,8711
6416,瑞祺電通,10,0,10,陽信-石牌,2023-04-10,8711
2609,陽明,14,5,9,陽信-石牌,2023-04-10,8711
3520,華盈,9,0,9,陽信-石牌,2023-04-10,8711
6173,信昌電,10,1,9,陽信-石牌,2023-04-10,8711
2882,國泰金,10,2,8,陽信-石牌,2023-04-10,8711
6152,百一,8,0,8,陽信-石牌,2023-04-10,8711
3056,富華新,8,1,7,陽信-石牌,2023-04-10,8711
1519,華城,22,15,7,陽信-石牌,2023-04-10,8711
2442,新美齊,7,0,7,陽信-石牌,2023-04-10,8711
2834,臺企銀,13,6,7,陽信-石牌,2023-04-10,8711
2883,凱基金,9,2,7,陽信-石牌,2023-04-10,8711
3354,律勝,7,0,7,陽信-石牌,2023-04-10,8711
3419,譁裕,7,0,7,陽信-石牌,2023-04-10,8711
00878,國泰永續高股息,523,41,482,陽信-石牌,2023-04-11,8711
00632R,元大台灣50反1,245,90,155,陽信-石牌,2023-04-11,8711
3715,定穎投控,150,1,149,陽信-石牌,2023-04-11,8711
00712,復華富時不動產,81,0,81,陽信-石牌,2023-04-11,8711
8028,昇陽半導體,65,0,65,陽信-石牌,2023-04-11,8711
6461,益得,65,2,63,陽信-石牌,2023-04-11,8711
00648R,元大S＆P500反1,75,30,45,陽信-石牌,2023-04-11,8711
00713,元大台灣高息低波,36,1,35,陽信-石牌,2023-04-11,8711
1310,台苯,30,0,30,陽信-石牌,2023-04-11,8711
00671R,富邦NASDAQ反1,50,20,30,陽信-石牌,2023-04-11,8711
2611,志信,30,0,30,陽信-石牌,2023-04-11,8711
3231,緯創,70,41,29,陽信-石牌,2023-04-11,8711
2890,永豐金,27,0,27,陽信-石牌,2023-04-11,8711
1789,神隆,25,0,25,陽信-石牌,2023-04-11,8711
2208,台船,23,0,23,陽信-石牌,2023-04-11,8711
00679B,元大美債20年,22,0,22,陽信-石牌,2023-04-11,8711
2736,富野,22,0,22,陽信-石牌,2023-04-11,8711
6209,今國光,24,2,22,陽信-石牌,2023-04-11,8711
2484,希華,33,13,20,陽信-石牌,2023-04-11,8711
3545,敦泰,33,13,20,陽信-石牌,2023-04-11,8711
5381,合正,20,0,20,陽信-石牌,2023-04-11,8711
5481,新華,20,0,20,陽信-石牌,2023-04-11,8711
3325,旭品,19,0,19,陽信-石牌,2023-04-11,8711
2031,新光鋼,18,0,18,陽信-石牌,2023-04-11,8711
6223,旺矽,20,2,18,陽信-石牌,2023-04-11,8711
3714,富采,20,2,18,陽信-石牌,2023-04-11,8711
4720,德淵,16,0,16,陽信-石牌,2023-04-11,8711
4804,大略-KY,20,4,16,陽信-石牌,2023-04-11,8711
4953,緯軟,31,15,16,陽信-石牌,2023-04-11,8711
5488,松普,16,0,16,陽信-石牌,2023-04-11,8711
6191,精成科,20,5,15,陽信-石牌,2023-04-11,8711
0056,元大高股息,20,7,13,陽信-石牌,2023-04-11,8711
2002,中鋼,21,8,13,陽信-石牌,2023-04-11,8711
6176,瑞儀,20,7,13,陽信-石牌,2023-04-11,8711
6129,普誠,13,1,12,陽信-石牌,2023-04-11,8711
8110,華東,12,0,12,陽信-石牌,2023-04-11,8711
2317,鴻海,12,1,11,陽信-石牌,2023-04-11,8711
6244,茂迪,11,0,11,陽信-石牌,2023-04-11,8711
00680L,元大美債20正2,10,0,10,陽信-石牌,2023-04-11,8711
1218,泰山,10,0,10,陽信-石牌,2023-04-11,8711
1714,和桐,10,0,10,陽信-石牌,2023-04-11,8711
2515,中工,10,0,10,陽信-石牌,2023-04-11,8711
3710,連展投控,10,0,10,陽信-石牌,2023-04-11,8711
6552,易華電,10,0,10,陽信-石牌,2023-04-11,8711
2889,國票金,9,0,9,陽信-石牌,2023-04-11,8711
6485,點序,17,8,9,陽信-石牌,2023-04-11,8711
3294,英濟,8,0,8,陽信-石牌,2023-04-11,8711
4109,加捷生醫,7,0,7,陽信-石牌,2023-04-11,8711
6282,康舒,7,0,7,陽信-石牌,2023-04-11,8711
6532,瑞耘,12,5,7,陽信-石牌,2023-04-11,8711
00632R,元大台灣50反1,160,45,115,陽信-石牌,2023-04-12,8711
00712,復華富時不動產,72,0,72,陽信-石牌,2023-04-12,8711
00713,元大台灣高息低波,65,1,64,陽信-石牌,2023-04-12,8711
3322,建舜電,48,0,48,陽信-石牌,2023-04-12,8711
5425,台半,47,9,38,陽信-石牌,2023-04-12,8711
3432,台端,36,0,36,陽信-石牌,2023-04-12,8711
6443,元晶,52,19,33,陽信-石牌,2023-04-12,8711
2634,漢翔,63,30,33,陽信-石牌,2023-04-12,8711
6196,帆宣,31,1,30,陽信-石牌,2023-04-12,8711
2409,友達,102,75,27,陽信-石牌,2023-04-12,8711
1609,大亞,73,51,22,陽信-石牌,2023-04-12,8711
6806,森崴能源,41,20,21,陽信-石牌,2023-04-12,8711
00725B,國泰投資級公司債,20,0,20,陽信-石牌,2023-04-12,8711
2344,華邦電,35,15,20,陽信-石牌,2023-04-12,8711
4707,磐亞,20,0,20,陽信-石牌,2023-04-12,8711
4804,大略-KY,20,0,20,陽信-石牌,2023-04-12,8711
2027,大成鋼,20,1,19,陽信-石牌,2023-04-12,8711
6234,高僑,32,13,19,陽信-石牌,2023-04-12,8711
1605,華新,76,58,18,陽信-石牌,2023-04-12,8711
2427,三商電,18,0,18,陽信-石牌,2023-04-12,8711
6515,穎崴,18,2,16,陽信-石牌,2023-04-12,8711
0056,元大高股息,17,2,15,陽信-石牌,2023-04-12,8711
8183,精星,16,1,15,陽信-石牌,2023-04-12,8711
00637L,元大滬深300正2,19,6,13,陽信-石牌,2023-04-12,8711
2408,南亞科,19,6,13,陽信-石牌,2023-04-12,8711
6235,華孚,26,13,13,陽信-石牌,2023-04-12,8711
3689,湧德,12,0,12,陽信-石牌,2023-04-12,8711
5469,瀚宇博,11,0,11,陽信-石牌,2023-04-12,8711
00680L,元大美債20正2,10,0,10,陽信-石牌,2023-04-12,8711
2880,華南金,10,0,10,陽信-石牌,2023-04-12,8711
3092,鴻碩,10,0,10,陽信-石牌,2023-04-12,8711
3625,西勝,10,0,10,陽信-石牌,2023-04-12,8711
4916,事欣科,10,0,10,陽信-石牌,2023-04-12,8711
4953,緯軟,10,0,10,陽信-石牌,2023-04-12,8711
5353,台林,10,0,10,陽信-石牌,2023-04-12,8711
2330,台積電,19,9,10,陽信-石牌,2023-04-12,8711
2603,長榮,50,40,10,陽信-石牌,2023-04-12,8711
2317,鴻海,12,3,9,陽信-石牌,2023-04-12,8711
1310,台苯,10,1,9,陽信-石牌,2023-04-12,8711
2881,富邦金,10,1,9,陽信-石牌,2023-04-12,8711
3308,聯德,16,7,9,陽信-石牌,2023-04-12,8711
5309,系統電,12,3,9,陽信-石牌,2023-04-12,8711
5481,新華,9,0,9,陽信-石牌,2023-04-12,8711
1584,精剛,21,13,8,陽信-石牌,2023-04-12,8711
2302,麗正,10,2,8,陽信-石牌,2023-04-12,8711
3324,雙鴻,14,6,8,陽信-石牌,2023-04-12,8711
3708,上緯投控,10,2,8,陽信-石牌,2023-04-12,8711
8086,宏捷科,8,0,8,陽信-石牌,2023-04-12,8711
2444,兆勁,7,0,7,陽信-石牌,2023-04-12,8711
5483,中美晶,7,0,7,陽信-石牌,2023-04-12,8711
00712,復華富時不動產,126,0,126,陽信-石牌,2023-04-13,8711
2317,鴻海,113,12,101,陽信-石牌,2023-04-13,8711
5531,鄉林,159,65,94,陽信-石牌,2023-04-13,8711
00648R,元大S＆P500反1,90,30,60,陽信-石牌,2023-04-13,8711
1503,士電,68,18,50,陽信-石牌,2023-04-13,8711
3707,漢磊,53,3,50,陽信-石牌,2023-04-13,8711
2444,兆勁,47,0,47,陽信-石牌,2023-04-13,8711
2610,華航,94,49,45,陽信-石牌,2023-04-13,8711
2402,毅嘉,61,19,42,陽信-石牌,2023-04-13,8711
2362,藍天,40,0,40,陽信-石牌,2023-04-13,8711
00671R,富邦NASDAQ反1,75,40,35,陽信-石牌,2023-04-13,8711
1513,中興電,49,22,27,陽信-石牌,2023-04-13,8711
1218,泰山,26,0,26,陽信-石牌,2023-04-13,8711
1609,大亞,64,39,25,陽信-石牌,2023-04-13,8711
2302,麗正,30,7,23,陽信-石牌,2023-04-13,8711
5481,新華,22,0,22,陽信-石牌,2023-04-13,8711
00632R,元大台灣50反1,25,5,20,陽信-石牌,2023-04-13,8711
2601,益航,20,0,20,陽信-石牌,2023-04-13,8711
4916,事欣科,30,10,20,陽信-石牌,2023-04-13,8711
6015,宏遠證,20,0,20,陽信-石牌,2023-04-13,8711
6411,晶焱,60,40,20,陽信-石牌,2023-04-13,8711
8110,華東,19,1,18,陽信-石牌,2023-04-13,8711
00878,國泰永續高股息,18,1,17,陽信-石牌,2023-04-13,8711
00673R,期元大S＆P原油反1,17,0,17,陽信-石牌,2023-04-13,8711
2303,聯電,19,2,17,陽信-石牌,2023-04-13,8711
2634,漢翔,28,11,17,陽信-石牌,2023-04-13,8711
2637,慧洋-KY,16,0,16,陽信-石牌,2023-04-13,8711
2888,新光金,20,4,16,陽信-石牌,2023-04-13,8711
6111,大宇資,17,1,16,陽信-石牌,2023-04-13,8711
5880,合庫金,15,0,15,陽信-石牌,2023-04-13,8711
1519,華城,29,15,14,陽信-石牌,2023-04-13,8711
5351,鈺創,22,8,14,陽信-石牌,2023-04-13,8711
5465,富驊,14,0,14,陽信-石牌,2023-04-13,8711
1524,耿鼎,13,0,13,陽信-石牌,2023-04-13,8711
8046,南電,14,1,13,陽信-石牌,2023-04-13,8711
2002,中鋼,14,2,12,陽信-石牌,2023-04-13,8711
3264,欣銓,12,0,12,陽信-石牌,2023-04-13,8711
5388,中磊,15,3,12,陽信-石牌,2023-04-13,8711
2330,台積電,13,1,12,陽信-石牌,2023-04-13,8711
00665L,富邦�琤肭磪囓�2,55,44,11,陽信-石牌,2023-04-13,8711
1504,東元,22,11,11,陽信-石牌,2023-04-13,8711
2368,金像電,12,1,11,陽信-石牌,2023-04-13,8711
2408,南亞科,120,109,11,陽信-石牌,2023-04-13,8711
3037,欣興,29,18,11,陽信-石牌,2023-04-13,8711
5234,達興材料,11,0,11,陽信-石牌,2023-04-13,8711
5309,系統電,14,3,11,陽信-石牌,2023-04-13,8711
8105,凌巨,11,0,11,陽信-石牌,2023-04-13,8711
0056,元大高股息,10,0,10,陽信-石牌,2023-04-13,8711
00650L,復華香港正2,16,6,10,陽信-石牌,2023-04-13,8711
2313,華通,10,0,10,陽信-石牌,2023-04-13,8711
00671R,富邦NASDAQ反1,150,60,90,陽信-石牌,2023-04-14,8711
2634,漢翔,126,38,88,陽信-石牌,2023-04-14,8711
3481,群創,106,26,80,陽信-石牌,2023-04-14,8711
2493,揚博,55,0,55,陽信-石牌,2023-04-14,8711
00772B,中信高評級公司債,52,0,52,陽信-石牌,2023-04-14,8711
2208,台船,72,21,51,陽信-石牌,2023-04-14,8711
2002,中鋼,39,3,36,陽信-石牌,2023-04-14,8711
3038,全台,33,0,33,陽信-石牌,2023-04-14,8711
2610,華航,42,10,32,陽信-石牌,2023-04-14,8711
00648R,元大S＆P500反1,50,20,30,陽信-石牌,2023-04-14,8711
2329,華泰,40,12,28,陽信-石牌,2023-04-14,8711
3037,欣興,27,1,26,陽信-石牌,2023-04-14,8711
1810,和成,25,0,25,陽信-石牌,2023-04-14,8711
5009,榮剛,86,61,25,陽信-石牌,2023-04-14,8711
0056,元大高股息,22,1,21,陽信-石牌,2023-04-14,8711
6485,點序,21,0,21,陽信-石牌,2023-04-14,8711
00897,富邦基因免疫生技,20,0,20,陽信-石牌,2023-04-14,8711
2382,廣達,20,0,20,陽信-石牌,2023-04-14,8711
4174,浩鼎,20,0,20,陽信-石牌,2023-04-14,8711
4702,中美實,20,0,20,陽信-石牌,2023-04-14,8711
5481,新華,20,0,20,陽信-石牌,2023-04-14,8711
5512,力麒,20,0,20,陽信-石牌,2023-04-14,8711
2413,環科,17,0,17,陽信-石牌,2023-04-14,8711
3520,華盈,24,7,17,陽信-石牌,2023-04-14,8711
6288,聯嘉,16,0,16,陽信-石牌,2023-04-14,8711
00720B,元大投資級公司債,15,0,15,陽信-石牌,2023-04-14,8711
6196,帆宣,15,0,15,陽信-石牌,2023-04-14,8711
6244,茂迪,16,1,15,陽信-石牌,2023-04-14,8711
6547,高端疫苗,23,8,15,陽信-石牌,2023-04-14,8711
2614,東森,14,0,14,陽信-石牌,2023-04-14,8711
2330,台積電,23,9,14,陽信-石牌,2023-04-14,8711
2884,玉山金,12,0,12,陽信-石牌,2023-04-14,8711
2457,飛宏,100,88,12,陽信-石牌,2023-04-14,8711
1584,精剛,43,31,12,陽信-石牌,2023-04-14,8711
3147,大綜,12,0,12,陽信-石牌,2023-04-14,8711
00885,富邦越南,11,0,11,陽信-石牌,2023-04-14,8711
1903,士紙,13,2,11,陽信-石牌,2023-04-14,8711
4541,晟田,19,8,11,陽信-石牌,2023-04-14,8711
8222,寶一,23,12,11,陽信-石牌,2023-04-14,8711
00761B,國泰A級公司債,10,0,10,陽信-石牌,2023-04-14,8711
1101,台泥,10,0,10,陽信-石牌,2023-04-14,8711
00687B,國泰20年美債,10,0,10,陽信-石牌,2023-04-14,8711
2017,官田鋼,13,3,10,陽信-石牌,2023-04-14,8711
3264,欣銓,10,0,10,陽信-石牌,2023-04-14,8711
3617,碩天,10,0,10,陽信-石牌,2023-04-14,8711
4938,和碩,10,0,10,陽信-石牌,2023-04-14,8711
6154,順發,10,0,10,陽信-石牌,2023-04-14,8711
00679B,元大美債20年,9,0,9,陽信-石牌,2023-04-14,8711
00725B,國泰投資級公司債,9,0,9,陽信-石牌,2023-04-14,8711
2014,中鴻,10,1,9,陽信-石牌,2023-04-14,8711
00632R,元大台灣50反1,370,175,195,陽信-石牌,2023-04-17,8711
00712,復華富時不動產,69,0,69,陽信-石牌,2023-04-17,8711
00679B,元大美債20年,62,0,62,陽信-石牌,2023-04-17,8711
00671R,富邦NASDAQ反1,75,20,55,陽信-石牌,2023-04-17,8711
3013,晟銘電,57,6,51,陽信-石牌,2023-04-17,8711
00642U,期元大S＆P石油,50,0,50,陽信-石牌,2023-04-17,8711
2884,玉山金,38,0,38,陽信-石牌,2023-04-17,8711
00878,國泰永續高股息,41,4,37,陽信-石牌,2023-04-17,8711
2634,漢翔,187,155,32,陽信-石牌,2023-04-17,8711
1104,環泥,30,0,30,陽信-石牌,2023-04-17,8711
2206,三陽工業,36,9,27,陽信-石牌,2023-04-17,8711
2211,長榮鋼,27,0,27,陽信-石牌,2023-04-17,8711
2610,華航,28,2,26,陽信-石牌,2023-04-17,8711
1519,華城,28,3,25,陽信-石牌,2023-04-17,8711
2312,金寶,47,23,24,陽信-石牌,2023-04-17,8711
3011,今皓,21,0,21,陽信-石牌,2023-04-17,8711
2329,華泰,34,13,21,陽信-石牌,2023-04-17,8711
00885,富邦越南,20,0,20,陽信-石牌,2023-04-17,8711
1514,亞力,46,26,20,陽信-石牌,2023-04-17,8711
4804,大略-KY,20,0,20,陽信-石牌,2023-04-17,8711
5481,新華,20,0,20,陽信-石牌,2023-04-17,8711
6196,帆宣,20,0,20,陽信-石牌,2023-04-17,8711
2890,永豐金,19,0,19,陽信-石牌,2023-04-17,8711
6185,幃翔,19,0,19,陽信-石牌,2023-04-17,8711
1314,中石化,17,0,17,陽信-石牌,2023-04-17,8711
2492,華新科,17,0,17,陽信-石牌,2023-04-17,8711
00648R,元大S＆P500反1,36,20,16,陽信-石牌,2023-04-17,8711
1471,首利,20,4,16,陽信-石牌,2023-04-17,8711
1762,中化生,17,1,16,陽信-石牌,2023-04-17,8711
00656R,國泰中國A50反1,15,0,15,陽信-石牌,2023-04-17,8711
3481,群創,18,3,15,陽信-石牌,2023-04-17,8711
4979,華星光,21,6,15,陽信-石牌,2023-04-17,8711
2454,聯發科,23,9,14,陽信-石牌,2023-04-17,8711
2515,中工,26,12,14,陽信-石牌,2023-04-17,8711
2891,中信金,20,6,14,陽信-石牌,2023-04-17,8711
4541,晟田,28,14,14,陽信-石牌,2023-04-17,8711
2002,中鋼,14,1,13,陽信-石牌,2023-04-17,8711
1504,東元,72,59,13,陽信-石牌,2023-04-17,8711
3689,湧德,12,0,12,陽信-石牌,2023-04-17,8711
8215,明基材,22,10,12,陽信-石牌,2023-04-17,8711
3419,譁裕,11,0,11,陽信-石牌,2023-04-17,8711
1102,亞泥,10,0,10,陽信-石牌,2023-04-17,8711
00680L,元大美債20正2,10,0,10,陽信-石牌,2023-04-17,8711
1708,東鹼,10,0,10,陽信-石牌,2023-04-17,8711
2367,燿華,10,0,10,陽信-石牌,2023-04-17,8711
2702,華園,10,0,10,陽信-石牌,2023-04-17,8711
2855,統一證,10,0,10,陽信-石牌,2023-04-17,8711
2886,兆豐金,10,0,10,陽信-石牌,2023-04-17,8711
4956,光鋐,10,0,10,陽信-石牌,2023-04-17,8711
5452,佶優,15,5,10,陽信-石牌,2023-04-17,8711
00679B,元大美債20年,173,0,173,陽信-石牌,2023-04-18,8711
9110,越南控-DR,100,0,100,陽信-石牌,2023-04-18,8711
00632R,元大台灣50反1,255,185,70,陽信-石牌,2023-04-18,8711
00720B,元大投資級公司債,59,0,59,陽信-石牌,2023-04-18,8711
00772B,中信高評級公司債,58,0,58,陽信-石牌,2023-04-18,8711
00687B,國泰20年美債,51,0,51,陽信-石牌,2023-04-18,8711
6266,泰詠,63,20,43,陽信-石牌,2023-04-18,8711
2102,泰豐,40,0,40,陽信-石牌,2023-04-18,8711
2603,長榮,77,40,37,陽信-石牌,2023-04-18,8711
2457,飛宏,150,114,36,陽信-石牌,2023-04-18,8711
3714,富采,50,15,35,陽信-石牌,2023-04-18,8711
2409,友達,39,7,32,陽信-石牌,2023-04-18,8711
2834,臺企銀,41,11,30,陽信-石牌,2023-04-18,8711
2610,華航,32,5,27,陽信-石牌,2023-04-18,8711
2515,中工,26,0,26,陽信-石牌,2023-04-18,8711
2201,裕隆,83,58,25,陽信-石牌,2023-04-18,8711
1444,力麗,42,20,22,陽信-石牌,2023-04-18,8711
00891,中信關鍵半導體,22,0,22,陽信-石牌,2023-04-18,8711
2891,中信金,22,0,22,陽信-石牌,2023-04-18,8711
8028,昇陽半導體,28,6,22,陽信-石牌,2023-04-18,8711
00878,國泰永續高股息,63,42,21,陽信-石牌,2023-04-18,8711
2208,台船,67,46,21,陽信-石牌,2023-04-18,8711
2867,三商壽,20,0,20,陽信-石牌,2023-04-18,8711
5481,新華,20,0,20,陽信-石牌,2023-04-18,8711
6770,力積電,21,1,20,陽信-石牌,2023-04-18,8711
1471,首利,30,12,18,陽信-石牌,2023-04-18,8711
2314,台揚,31,13,18,陽信-石牌,2023-04-18,8711
2645,長榮航太,20,2,18,陽信-石牌,2023-04-18,8711
3037,欣興,19,1,18,陽信-石牌,2023-04-18,8711
6282,康舒,42,24,18,陽信-石牌,2023-04-18,8711
8033,雷虎,46,28,18,陽信-石牌,2023-04-18,8711
8069,元太,18,0,18,陽信-石牌,2023-04-18,8711
1584,精剛,55,38,17,陽信-石牌,2023-04-18,8711
3206,志豐,16,0,16,陽信-石牌,2023-04-18,8711
1609,大亞,16,1,15,陽信-石牌,2023-04-18,8711
6179,亞通,20,5,15,陽信-石牌,2023-04-18,8711
2002,中鋼,15,1,14,陽信-石牌,2023-04-18,8711
2388,威盛,33,19,14,陽信-石牌,2023-04-18,8711
1533,車王電,22,8,14,陽信-石牌,2023-04-18,8711
2634,漢翔,161,148,13,陽信-石牌,2023-04-18,8711
3025,星通,16,3,13,陽信-石牌,2023-04-18,8711
3419,譁裕,13,0,13,陽信-石牌,2023-04-18,8711
00680L,元大美債20正2,12,0,12,陽信-石牌,2023-04-18,8711
3308,聯德,12,0,12,陽信-石牌,2023-04-18,8711
6147,頎邦,12,0,12,陽信-石牌,2023-04-18,8711
2383,台光電,11,0,11,陽信-石牌,2023-04-18,8711
1218,泰山,10,0,10,陽信-石牌,2023-04-18,8711
00642U,期元大S＆P石油,10,0,10,陽信-石牌,2023-04-18,8711
2417,圓剛,10,0,10,陽信-石牌,2023-04-18,8711
2607,榮運,10,0,10,陽信-石牌,2023-04-18,8711
3592,瑞鼎,104,0,104,陽信-石牌,2023-04-19,8711
3419,譁裕,102,1,101,陽信-石牌,2023-04-19,8711
6806,森崴能源,105,14,91,陽信-石牌,2023-04-19,8711
1514,亞力,53,0,53,陽信-石牌,2023-04-19,8711
3707,漢磊,57,4,53,陽信-石牌,2023-04-19,8711
00632R,元大台灣50反1,110,60,50,陽信-石牌,2023-04-19,8711
2504,國產,50,1,49,陽信-石牌,2023-04-19,8711
3491,昇達科,51,3,48,陽信-石牌,2023-04-19,8711
00878,國泰永續高股息,43,0,43,陽信-石牌,2023-04-19,8711
2610,華航,47,5,42,陽信-石牌,2023-04-19,8711
1218,泰山,40,0,40,陽信-石牌,2023-04-19,8711
1785,光洋科,40,0,40,陽信-石牌,2023-04-19,8711
00648R,元大S＆P500反1,45,15,30,陽信-石牌,2023-04-19,8711
00671R,富邦NASDAQ反1,50,20,30,陽信-石牌,2023-04-19,8711
1718,中纖,32,2,30,陽信-石牌,2023-04-19,8711
1609,大亞,65,40,25,陽信-石牌,2023-04-19,8711
2201,裕隆,102,77,25,陽信-石牌,2023-04-19,8711
3481,群創,163,138,25,陽信-石牌,2023-04-19,8711
00679B,元大美債20年,23,0,23,陽信-石牌,2023-04-19,8711
6116,彩晶,25,2,23,陽信-石牌,2023-04-19,8711
2402,毅嘉,38,16,22,陽信-石牌,2023-04-19,8711
2313,華通,21,0,21,陽信-石牌,2023-04-19,8711
4109,加捷生醫,21,0,21,陽信-石牌,2023-04-19,8711
8028,昇陽半導體,35,14,21,陽信-石牌,2023-04-19,8711
00712,復華富時不動產,20,0,20,陽信-石牌,2023-04-19,8711
2303,聯電,22,2,20,陽信-石牌,2023-04-19,8711
5481,新華,20,0,20,陽信-石牌,2023-04-19,8711
8105,凌巨,30,10,20,陽信-石牌,2023-04-19,8711
2457,飛宏,99,80,19,陽信-石牌,2023-04-19,8711
6770,力積電,21,2,19,陽信-石牌,2023-04-19,8711
3025,星通,21,2,19,陽信-石牌,2023-04-19,8711
2603,長榮,37,19,18,陽信-石牌,2023-04-19,8711
1417,嘉裕,23,6,17,陽信-石牌,2023-04-19,8711
2637,慧洋-KY,17,0,17,陽信-石牌,2023-04-19,8711
6538,倉和,17,0,17,陽信-石牌,2023-04-19,8711
00891,中信關鍵半導體,15,0,15,陽信-石牌,2023-04-19,8711
3576,聯合再生,17,2,15,陽信-石牌,2023-04-19,8711
6235,華孚,30,16,14,陽信-石牌,2023-04-19,8711
2002,中鋼,16,2,14,陽信-石牌,2023-04-19,8711
3037,欣興,14,0,14,陽信-石牌,2023-04-19,8711
2338,光罩,13,0,13,陽信-石牌,2023-04-19,8711
6290,良維,14,1,13,陽信-石牌,2023-04-19,8711
6531,愛普*,19,6,13,陽信-石牌,2023-04-19,8711
6589,台康生技,13,0,13,陽信-石牌,2023-04-19,8711
1810,和成,22,10,12,陽信-石牌,2023-04-19,8711
6753,龍德造船,12,0,12,陽信-石牌,2023-04-19,8711
2885,元大金,11,0,11,陽信-石牌,2023-04-19,8711
2615,萬海,10,0,10,陽信-石牌,2023-04-19,8711
1229,聯華,10,0,10,陽信-石牌,2023-04-19,8711
1584,精剛,123,113,10,陽信-石牌,2023-04-19,8711
3707,漢磊,60,3,57,陽信-石牌,2023-04-20,8711
3481,群創,104,51,53,陽信-石牌,2023-04-20,8711
2059,川湖,56,6,50,陽信-石牌,2023-04-20,8711
4906,正文,50,1,49,陽信-石牌,2023-04-20,8711
6215,和椿,46,2,44,陽信-石牌,2023-04-20,8711
6752,叡揚,40,0,40,陽信-石牌,2023-04-20,8711
6547,高端疫苗,39,2,37,陽信-石牌,2023-04-20,8711
00671R,富邦NASDAQ反1,75,40,35,陽信-石牌,2023-04-20,8711
00632R,元大台灣50反1,100,65,35,陽信-石牌,2023-04-20,8711
00878,國泰永續高股息,43,10,33,陽信-石牌,2023-04-20,8711
6411,晶焱,52,20,32,陽信-石牌,2023-04-20,8711
1789,神隆,30,0,30,陽信-石牌,2023-04-20,8711
2601,益航,25,2,23,陽信-石牌,2023-04-20,8711
2314,台揚,23,1,22,陽信-石牌,2023-04-20,8711
2324,仁寶,23,2,21,陽信-石牌,2023-04-20,8711
2014,中鴻,20,0,20,陽信-石牌,2023-04-20,8711
5009,榮剛,22,2,20,陽信-石牌,2023-04-20,8711
5481,新華,20,0,20,陽信-石牌,2023-04-20,8711
6134,萬旭,30,12,18,陽信-石牌,2023-04-20,8711
8050,廣積,18,0,18,陽信-石牌,2023-04-20,8711
6282,康舒,66,49,17,陽信-石牌,2023-04-20,8711
0056,元大高股息,16,0,16,陽信-石牌,2023-04-20,8711
2444,兆勁,39,24,15,陽信-石牌,2023-04-20,8711
2498,宏達電,15,0,15,陽信-石牌,2023-04-20,8711
1605,華新,21,7,14,陽信-石牌,2023-04-20,8711
1611,中電,22,8,14,陽信-石牌,2023-04-20,8711
1909,榮成,14,0,14,陽信-石牌,2023-04-20,8711
3051,力特,14,0,14,陽信-石牌,2023-04-20,8711
4167,松瑞藥,14,0,14,陽信-石牌,2023-04-20,8711
00712,復華富時不動產,12,0,12,陽信-石牌,2023-04-20,8711
6190,萬泰科,14,2,12,陽信-石牌,2023-04-20,8711
8069,元太,12,0,12,陽信-石牌,2023-04-20,8711
00891,中信關鍵半導體,11,0,11,陽信-石牌,2023-04-20,8711
00772B,中信高評級公司債,11,0,11,陽信-石牌,2023-04-20,8711
2364,倫飛,11,0,11,陽信-石牌,2023-04-20,8711
2618,長榮航,11,0,11,陽信-石牌,2023-04-20,8711
3056,富華新,11,0,11,陽信-石牌,2023-04-20,8711
3673,TPK-KY,16,5,11,陽信-石牌,2023-04-20,8711
4927,泰鼎-KY,11,0,11,陽信-石牌,2023-04-20,8711
1464,得力,10,0,10,陽信-石牌,2023-04-20,8711
1810,和成,41,31,10,陽信-石牌,2023-04-20,8711
2367,燿華,10,0,10,陽信-石牌,2023-04-20,8711
2455,全新,20,10,10,陽信-石牌,2023-04-20,8711
2617,台航,10,0,10,陽信-石牌,2023-04-20,8711
2637,慧洋-KY,10,0,10,陽信-石牌,2023-04-20,8711
3045,台灣大,10,0,10,陽信-石牌,2023-04-20,8711
4174,浩鼎,10,0,10,陽信-石牌,2023-04-20,8711
4911,德英,10,0,10,陽信-石牌,2023-04-20,8711
4956,光鋐,10,0,10,陽信-石牌,2023-04-20,8711
6197,佳必琪,10,0,10,陽信-石牌,2023-04-20,8711
1710,東聯,213,57,156,陽信-石牌,2023-04-21,8711
6244,茂迪,122,25,97,陽信-石牌,2023-04-21,8711
00671R,富邦NASDAQ反1,110,30,80,陽信-石牌,2023-04-21,8711
00632R,元大台灣50反1,175,95,80,陽信-石牌,2023-04-21,8711
3481,群創,154,75,79,陽信-石牌,2023-04-21,8711
0056,元大高股息,75,2,73,陽信-石牌,2023-04-21,8711
2601,益航,66,0,66,陽信-石牌,2023-04-21,8711
4906,正文,54,0,54,陽信-石牌,2023-04-21,8711
00720B,元大投資級公司債,53,0,53,陽信-石牌,2023-04-21,8711
2102,泰豐,50,0,50,陽信-石牌,2023-04-21,8711
8213,志超,40,0,40,陽信-石牌,2023-04-21,8711
00679B,元大美債20年,33,1,32,陽信-石牌,2023-04-21,8711
2603,長榮,35,4,31,陽信-石牌,2023-04-21,8711
2617,台航,30,0,30,陽信-石牌,2023-04-21,8711
6176,瑞儀,30,1,29,陽信-石牌,2023-04-21,8711
00648R,元大S＆P500反1,60,35,25,陽信-石牌,2023-04-21,8711
1471,首利,21,0,21,陽信-石牌,2023-04-21,8711
6770,力積電,22,1,21,陽信-石牌,2023-04-21,8711
4974,亞泰,20,0,20,陽信-石牌,2023-04-21,8711
5481,新華,20,0,20,陽信-石牌,2023-04-21,8711
6752,叡揚,20,0,20,陽信-石牌,2023-04-21,8711
2484,希華,23,5,18,陽信-石牌,2023-04-21,8711
2634,漢翔,85,67,18,陽信-石牌,2023-04-21,8711
1609,大亞,17,0,17,陽信-石牌,2023-04-21,8711
3491,昇達科,22,5,17,陽信-石牌,2023-04-21,8711
8927,北基,16,0,16,陽信-石牌,2023-04-21,8711
00923,群益台ESG低碳50,15,0,15,陽信-石牌,2023-04-21,8711
00900,富邦特選高股息30,15,0,15,陽信-石牌,2023-04-21,8711
3011,今皓,15,0,15,陽信-石牌,2023-04-21,8711
6215,和椿,16,1,15,陽信-石牌,2023-04-21,8711
2328,廣宇,14,0,14,陽信-石牌,2023-04-21,8711
2637,慧洋-KY,14,0,14,陽信-石牌,2023-04-21,8711
3289,宜特,16,2,14,陽信-石牌,2023-04-21,8711
8091,翔名,15,1,14,陽信-石牌,2023-04-21,8711
1409,新纖,24,12,12,陽信-石牌,2023-04-21,8711
1319,東陽,12,0,12,陽信-石牌,2023-04-21,8711
3051,力特,14,2,12,陽信-石牌,2023-04-21,8711
00891,中信關鍵半導體,12,1,11,陽信-石牌,2023-04-21,8711
1904,正隆,21,10,11,陽信-石牌,2023-04-21,8711
1907,永豐餘,25,14,11,陽信-石牌,2023-04-21,8711
2492,華新科,11,0,11,陽信-石牌,2023-04-21,8711
3714,富采,11,0,11,陽信-石牌,2023-04-21,8711
6163,華電網,12,1,11,陽信-石牌,2023-04-21,8711
00853B,統一美債10年Aa-,10,0,10,陽信-石牌,2023-04-21,8711
00893,國泰智能電動車,10,0,10,陽信-石牌,2023-04-21,8711
2022,聚亨,30,20,10,陽信-石牌,2023-04-21,8711
2337,旺宏,10,0,10,陽信-石牌,2023-04-21,8711
2883,凱基金,14,4,10,陽信-石牌,2023-04-21,8711
3322,建舜電,10,0,10,陽信-石牌,2023-04-21,8711
3665,貿聯-KY,10,0,10,陽信-石牌,2023-04-21,8711
2457,飛宏,84,44,40,陽信-石牌,2023-04-24,8711
6288,聯嘉,37,4,33,陽信-石牌,2023-04-24,8711
3673,TPK-KY,30,0,30,陽信-石牌,2023-04-24,8711
5009,榮剛,30,0,30,陽信-石牌,2023-04-24,8711
2324,仁寶,34,6,28,陽信-石牌,2023-04-24,8711
3710,連展投控,28,0,28,陽信-石牌,2023-04-24,8711
6244,茂迪,85,61,24,陽信-石牌,2023-04-24,8711
2313,華通,22,0,22,陽信-石牌,2023-04-24,8711
5481,新華,20,0,20,陽信-石牌,2023-04-24,8711
6120,達運,20,0,20,陽信-石牌,2023-04-24,8711
00637L,元大滬深300正2,21,3,18,陽信-石牌,2023-04-24,8711
2634,漢翔,81,65,16,陽信-石牌,2023-04-24,8711
00923,群益台ESG低碳50,15,0,15,陽信-石牌,2023-04-24,8711
00671R,富邦NASDAQ反1,25,10,15,陽信-石牌,2023-04-24,8711
1907,永豐餘,23,9,14,陽信-石牌,2023-04-24,8711
2492,華新科,14,0,14,陽信-石牌,2023-04-24,8711
3231,緯創,29,15,14,陽信-石牌,2023-04-24,8711
00715L,期街口布蘭特正2,12,0,12,陽信-石牌,2023-04-24,8711
00878,國泰永續高股息,12,0,12,陽信-石牌,2023-04-24,8711
6282,康舒,46,34,12,陽信-石牌,2023-04-24,8711
1310,台苯,11,0,11,陽信-石牌,2023-04-24,8711
00902,中信電池及儲能,11,0,11,陽信-石牌,2023-04-24,8711
2637,慧洋-KY,11,0,11,陽信-石牌,2023-04-24,8711
3051,力特,11,0,11,陽信-石牌,2023-04-24,8711
00680L,元大美債20正2,10,0,10,陽信-石牌,2023-04-24,8711
00753L,中信中國50正2,10,0,10,陽信-石牌,2023-04-24,8711
00751B,元大AAA至A公司債,10,0,10,陽信-石牌,2023-04-24,8711
1444,力麗,10,0,10,陽信-石牌,2023-04-24,8711
1464,得力,10,0,10,陽信-石牌,2023-04-24,8711
2014,中鴻,15,5,10,陽信-石牌,2023-04-24,8711
2312,金寶,10,0,10,陽信-石牌,2023-04-24,8711
2520,冠德,10,0,10,陽信-石牌,2023-04-24,8711
2913,農林,12,2,10,陽信-石牌,2023-04-24,8711
3147,大綜,10,0,10,陽信-石牌,2023-04-24,8711
3521,鴻翊,10,0,10,陽信-石牌,2023-04-24,8711
6770,力積電,11,1,10,陽信-石牌,2023-04-24,8711
8091,翔名,10,0,10,陽信-石牌,2023-04-24,8711
8240,華宏,23,13,10,陽信-石牌,2023-04-24,8711
2889,國票金,10,0,10,陽信-石牌,2023-04-24,8711
00891,中信關鍵半導體,9,0,9,陽信-石牌,2023-04-24,8711
8069,元太,11,3,8,陽信-石牌,2023-04-24,8711
1303,南亞,8,0,8,陽信-石牌,2023-04-24,8711
00881,國泰台灣5G+,8,0,8,陽信-石牌,2023-04-24,8711
6269,台郡,8,0,8,陽信-石牌,2023-04-24,8711
8046,南電,10,2,8,陽信-石牌,2023-04-24,8711
00679B,元大美債20年,12,5,7,陽信-石牌,2023-04-24,8711
8222,寶一,24,17,7,陽信-石牌,2023-04-24,8711
0056,元大高股息,7,1,6,陽信-石牌,2023-04-24,8711
00893,國泰智能電動車,7,1,6,陽信-石牌,2023-04-24,8711
00772B,中信高評級公司債,6,0,6,陽信-石牌,2023-04-24,8711
00632R,元大台灣50反1,850,305,545,陽信-石牌,2023-04-25,8711
1710,東聯,100,3,97,陽信-石牌,2023-04-25,8711
2610,華航,70,0,70,陽信-石牌,2023-04-25,8711
00923,群益台ESG低碳50,69,0,69,陽信-石牌,2023-04-25,8711
2102,泰豐,63,0,63,陽信-石牌,2023-04-25,8711
00671R,富邦NASDAQ反1,55,5,50,陽信-石牌,2023-04-25,8711
1611,中電,63,13,50,陽信-石牌,2023-04-25,8711
2457,飛宏,126,79,47,陽信-石牌,2023-04-25,8711
1605,華新,55,14,41,陽信-石牌,2023-04-25,8711
2603,長榮,40,0,40,陽信-石牌,2023-04-25,8711
0056,元大高股息,40,1,39,陽信-石牌,2023-04-25,8711
1101,台泥,59,21,38,陽信-石牌,2023-04-25,8711
1310,台苯,85,53,32,陽信-石牌,2023-04-25,8711
2303,聯電,51,21,30,陽信-石牌,2023-04-25,8711
00648R,元大S＆P500反1,40,10,30,陽信-石牌,2023-04-25,8711
1444,力麗,30,0,30,陽信-石牌,2023-04-25,8711
2344,華邦電,30,0,30,陽信-石牌,2023-04-25,8711
3260,威剛,31,1,30,陽信-石牌,2023-04-25,8711
4114,健喬,34,6,28,陽信-石牌,2023-04-25,8711
2313,華通,32,5,27,陽信-石牌,2023-04-25,8711
4175,杏一,23,0,23,陽信-石牌,2023-04-25,8711
2881,富邦金,22,0,22,陽信-石牌,2023-04-25,8711
8050,廣積,22,0,22,陽信-石牌,2023-04-25,8711
2330,台積電,30,8,22,陽信-石牌,2023-04-25,8711
4923,力士,21,0,21,陽信-石牌,2023-04-25,8711
00853B,統一美債10年Aa-,20,0,20,陽信-石牌,2023-04-25,8711
2618,長榮航,32,12,20,陽信-石牌,2023-04-25,8711
5481,新華,20,0,20,陽信-石牌,2023-04-25,8711
4503,金雨,20,1,19,陽信-石牌,2023-04-25,8711
2887,台新金,20,2,18,陽信-石牌,2023-04-25,8711
3051,力特,17,0,17,陽信-石牌,2023-04-25,8711
2444,兆勁,16,0,16,陽信-石牌,2023-04-25,8711
4566,時碩工業,21,5,16,陽信-石牌,2023-04-25,8711
3071,協禧,18,2,16,陽信-石牌,2023-04-25,8711
5014,建錩,15,0,15,陽信-石牌,2023-04-25,8711
0050,元大台灣50,15,0,15,陽信-石牌,2023-04-25,8711
2736,富野,14,0,14,陽信-石牌,2023-04-25,8711
6282,康舒,26,12,14,陽信-石牌,2023-04-25,8711
00772B,中信高評級公司債,15,2,13,陽信-石牌,2023-04-25,8711
1513,中興電,16,3,13,陽信-石牌,2023-04-25,8711
00637L,元大滬深300正2,12,0,12,陽信-石牌,2023-04-25,8711
2409,友達,13,1,12,陽信-石牌,2023-04-25,8711
1514,亞力,11,0,11,陽信-石牌,2023-04-25,8711
1609,大亞,31,20,11,陽信-石牌,2023-04-25,8711
4543,萬在,11,0,11,陽信-石牌,2023-04-25,8711
4721,美琪瑪,11,0,11,陽信-石牌,2023-04-25,8711
4906,正文,12,1,11,陽信-石牌,2023-04-25,8711
1409,新纖,10,0,10,陽信-石牌,2023-04-25,8711
00893,國泰智能電動車,10,0,10,陽信-石牌,2023-04-25,8711
00753L,中信中國50正2,10,0,10,陽信-石牌,2023-04-25,8711
00712,復華富時不動產,97,0,97,陽信-石牌,2023-04-26,8711
2881,富邦金,74,0,74,陽信-石牌,2023-04-26,8711
00853B,統一美債10年Aa-,70,0,70,陽信-石牌,2023-04-26,8711
00671R,富邦NASDAQ反1,70,0,70,陽信-石牌,2023-04-26,8711
00648R,元大S＆P500反1,60,0,60,陽信-石牌,2023-04-26,8711
00923,群益台ESG低碳50,52,0,52,陽信-石牌,2023-04-26,8711
00878,國泰永續高股息,46,0,46,陽信-石牌,2023-04-26,8711
00641R,富邦日本反1,45,0,45,陽信-石牌,2023-04-26,8711
1101,台泥,62,26,36,陽信-石牌,2023-04-26,8711
3706,神達,30,0,30,陽信-石牌,2023-04-26,8711
1218,泰山,29,0,29,陽信-石牌,2023-04-26,8711
2913,農林,25,2,23,陽信-石牌,2023-04-26,8711
6244,茂迪,24,1,23,陽信-石牌,2023-04-26,8711
00772B,中信高評級公司債,21,0,21,陽信-石牌,2023-04-26,8711
2409,友達,52,31,21,陽信-石牌,2023-04-26,8711
2618,長榮航,21,0,21,陽信-石牌,2023-04-26,8711
2002,中鋼,21,1,20,陽信-石牌,2023-04-26,8711
2211,長榮鋼,21,1,20,陽信-石牌,2023-04-26,8711
5481,新華,20,0,20,陽信-石牌,2023-04-26,8711
8105,凌巨,20,0,20,陽信-石牌,2023-04-26,8711
00679B,元大美債20年,18,1,17,陽信-石牌,2023-04-26,8711
2634,漢翔,197,180,17,陽信-石牌,2023-04-26,8711
4702,中美實,17,0,17,陽信-石牌,2023-04-26,8711
6188,廣明,18,1,17,陽信-石牌,2023-04-26,8711
6282,康舒,27,11,16,陽信-石牌,2023-04-26,8711
2330,台積電,24,10,14,陽信-石牌,2023-04-26,8711
2606,裕民,14,0,14,陽信-石牌,2023-04-26,8711
2027,大成鋼,13,0,13,陽信-石牌,2023-04-26,8711
1519,華城,16,5,11,陽信-石牌,2023-04-26,8711
2337,旺宏,19,8,11,陽信-石牌,2023-04-26,8711
5009,榮剛,15,4,11,陽信-石牌,2023-04-26,8711
8050,廣積,11,0,11,陽信-石牌,2023-04-26,8711
8222,寶一,20,9,11,陽信-石牌,2023-04-26,8711
1473,台南,10,0,10,陽信-石牌,2023-04-26,8711
00656R,國泰中國A50反1,10,0,10,陽信-石牌,2023-04-26,8711
00885,富邦越南,10,0,10,陽信-石牌,2023-04-26,8711
2609,陽明,14,4,10,陽信-石牌,2023-04-26,8711
2610,華航,20,10,10,陽信-石牌,2023-04-26,8711
2617,台航,10,0,10,陽信-石牌,2023-04-26,8711
2867,三商壽,10,0,10,陽信-石牌,2023-04-26,8711
3701,大眾控,10,0,10,陽信-石牌,2023-04-26,8711
6116,彩晶,25,15,10,陽信-石牌,2023-04-26,8711
8028,昇陽半導體,10,0,10,陽信-石牌,2023-04-26,8711
1810,和成,10,1,9,陽信-石牌,2023-04-26,8711
2031,新光鋼,9,0,9,陽信-石牌,2023-04-26,8711
4911,德英,9,0,9,陽信-石牌,2023-04-26,8711
6274,台燿,9,0,9,陽信-石牌,2023-04-26,8711
2331,精英,8,0,8,陽信-石牌,2023-04-26,8711
3035,智原,16,8,8,陽信-石牌,2023-04-26,8711
00891,中信關鍵半導體,7,0,7,陽信-石牌,2023-04-26,8711
00632R,元大台灣50反1,470,130,340,陽信-石牌,2023-04-27,8711
00641R,富邦日本反1,80,0,80,陽信-石牌,2023-04-27,8711
1310,台苯,58,7,51,陽信-石牌,2023-04-27,8711
00680L,元大美債20正2,50,0,50,陽信-石牌,2023-04-27,8711
00715L,期街口布蘭特正2,47,0,47,陽信-石牌,2023-04-27,8711
00669R,國泰美國道瓊反1,42,0,42,陽信-石牌,2023-04-27,8711
2402,毅嘉,34,1,33,陽信-石牌,2023-04-27,8711
2102,泰豐,22,0,22,陽信-石牌,2023-04-27,8711
4541,晟田,78,56,22,陽信-石牌,2023-04-27,8711
6288,聯嘉,51,30,21,陽信-石牌,2023-04-27,8711
00900,富邦特選高股息30,20,0,20,陽信-石牌,2023-04-27,8711
00772B,中信高評級公司債,20,0,20,陽信-石牌,2023-04-27,8711
2892,第一金,20,0,20,陽信-石牌,2023-04-27,8711
5481,新華,20,0,20,陽信-石牌,2023-04-27,8711
2409,友達,44,25,19,陽信-石牌,2023-04-27,8711
2002,中鋼,31,13,18,陽信-石牌,2023-04-27,8711
1464,得力,17,0,17,陽信-石牌,2023-04-27,8711
2206,三陽工業,162,146,16,陽信-石牌,2023-04-27,8711
5309,系統電,15,0,15,陽信-石牌,2023-04-27,8711
2609,陽明,22,8,14,陽信-石牌,2023-04-27,8711
2888,新光金,14,0,14,陽信-石牌,2023-04-27,8711
3017,奇鋐,18,5,13,陽信-石牌,2023-04-27,8711
6285,啟��,13,0,13,陽信-石牌,2023-04-27,8711
1711,永光,33,21,12,陽信-石牌,2023-04-27,8711
2331,精英,12,0,12,陽信-石牌,2023-04-27,8711
2610,華航,19,8,11,陽信-石牌,2023-04-27,8711
2884,玉山金,11,0,11,陽信-石牌,2023-04-27,8711
6156,松上,12,1,11,陽信-石牌,2023-04-27,8711
6269,台郡,11,0,11,陽信-石牌,2023-04-27,8711
2834,臺企銀,10,0,10,陽信-石牌,2023-04-27,8711
00692,富邦公司治理,10,0,10,陽信-石牌,2023-04-27,8711
1609,大亞,21,11,10,陽信-石牌,2023-04-27,8711
3294,英濟,10,0,10,陽信-石牌,2023-04-27,8711
3499,環天科,10,0,10,陽信-石牌,2023-04-27,8711
5014,建錩,10,0,10,陽信-石牌,2023-04-27,8711
6461,益得,10,0,10,陽信-石牌,2023-04-27,8711
3466,德晉,9,0,9,陽信-石牌,2023-04-27,8711
2330,台積電,8,0,8,陽信-石牌,2023-04-27,8711
3035,智原,13,5,8,陽信-石牌,2023-04-27,8711
3308,聯德,7,0,7,陽信-石牌,2023-04-27,8711
3594,磐儀,7,0,7,陽信-石牌,2023-04-27,8711
3596,智易,7,0,7,陽信-石牌,2023-04-27,8711
0050,元大台灣50,9,2,7,陽信-石牌,2023-04-27,8711
1721,三晃,9,3,6,陽信-石牌,2023-04-27,8711
3324,雙鴻,6,0,6,陽信-石牌,2023-04-27,8711
5289,宜鼎,6,0,6,陽信-石牌,2023-04-27,8711
6509,聚和,10,4,6,陽信-石牌,2023-04-27,8711
6770,力積電,8,2,6,陽信-石牌,2023-04-27,8711
00656R,國泰中國A50反1,5,0,5,陽信-石牌,2023-04-27,8711
1604,聲寶,5,0,5,陽信-石牌,2023-04-27,8711
3481,群創,382,61,321,陽信-石牌,2023-04-28,8711
5531,鄉林,105,0,105,陽信-石牌,2023-04-28,8711
00671R,富邦NASDAQ反1,175,80,95,陽信-石牌,2023-04-28,8711
00641R,富邦日本反1,165,75,90,陽信-石牌,2023-04-28,8711
4130,健亞,115,28,87,陽信-石牌,2023-04-28,8711
2453,凌群,90,5,85,陽信-石牌,2023-04-28,8711
2344,華邦電,112,31,81,陽信-石牌,2023-04-28,8711
2102,泰豐,80,0,80,陽信-石牌,2023-04-28,8711
6770,力積電,76,4,72,陽信-石牌,2023-04-28,8711
00669R,國泰美國道瓊反1,45,2,43,陽信-石牌,2023-04-28,8711
6288,聯嘉,151,111,40,陽信-石牌,2023-04-28,8711
5309,系統電,46,10,36,陽信-石牌,2023-04-28,8711
2880,華南金,46,11,35,陽信-石牌,2023-04-28,8711
1611,中電,30,0,30,陽信-石牌,2023-04-28,8711
2630,亞航,27,2,25,陽信-石牌,2023-04-28,8711
1101,台泥,24,4,20,陽信-石牌,2023-04-28,8711
00772B,中信高評級公司債,20,0,20,陽信-石牌,2023-04-28,8711
00642U,期元大S＆P石油,20,0,20,陽信-石牌,2023-04-28,8711
2206,三陽工業,76,56,20,陽信-石牌,2023-04-28,8711
4960,誠美材,20,0,20,陽信-石牌,2023-04-28,8711
2409,友達,96,77,19,陽信-石牌,2023-04-28,8711
6116,彩晶,19,0,19,陽信-石牌,2023-04-28,8711
2408,南亞科,19,3,16,陽信-石牌,2023-04-28,8711
5388,中磊,15,0,15,陽信-石牌,2023-04-28,8711
4566,時碩工業,27,13,14,陽信-石牌,2023-04-28,8711
2329,華泰,13,0,13,陽信-石牌,2023-04-28,8711
8358,金居,12,0,12,陽信-石牌,2023-04-28,8711
8426,紅木-KY,12,0,12,陽信-石牌,2023-04-28,8711
00679B,元大美債20年,11,0,11,陽信-石牌,2023-04-28,8711
4927,泰鼎-KY,11,0,11,陽信-石牌,2023-04-28,8711
8222,寶一,34,23,11,陽信-石牌,2023-04-28,8711
00648R,元大S＆P500反1,10,0,10,陽信-石牌,2023-04-28,8711
1522,堤維西,10,0,10,陽信-石牌,2023-04-28,8711
1727,中華化,32,22,10,陽信-石牌,2023-04-28,8711
2367,燿華,10,0,10,陽信-石牌,2023-04-28,8711
2530,華建,10,0,10,陽信-石牌,2023-04-28,8711
2633,台灣高鐵,10,0,10,陽信-石牌,2023-04-28,8711
2801,彰銀,12,2,10,陽信-石牌,2023-04-28,8711
2884,玉山金,10,0,10,陽信-石牌,2023-04-28,8711
6215,和椿,10,0,10,陽信-石牌,2023-04-28,8711
8011,台通,10,0,10,陽信-石牌,2023-04-28,8711
8028,昇陽半導體,10,0,10,陽信-石牌,2023-04-28,8711
8086,宏捷科,11,1,10,陽信-石牌,2023-04-28,8711
1503,士電,21,11,10,陽信-石牌,2023-04-28,8711
1907,永豐餘,9,0,9,陽信-石牌,2023-04-28,8711
3013,晟銘電,10,1,9,陽信-石牌,2023-04-28,8711
6185,幃翔,10,1,9,陽信-石牌,2023-04-28,8711
2603,長榮,15,6,9,陽信-石牌,2023-04-28,8711
00773B,中信優先金融債,8,0,8,陽信-石牌,2023-04-28,8711
2313,華通,8,0,8,陽信-石牌,2023-04-28,8711
00650L,復華香港正2,300,0,300,陽信-石牌,2023-05-02,8711
00669R,國泰美國道瓊反1,194,10,184,陽信-石牌,2023-05-02,8711
2471,資通,91,1,90,陽信-石牌,2023-05-02,8711
2453,凌群,78,3,75,陽信-石牌,2023-05-02,8711
2603,長榮,71,7,64,陽信-石牌,2023-05-02,8711
5531,鄉林,80,20,60,陽信-石牌,2023-05-02,8711
4916,事欣科,54,2,52,陽信-石牌,2023-05-02,8711
00676R,富邦臺灣加權反1,50,0,50,陽信-石牌,2023-05-02,8711
00648R,元大S＆P500反1,100,51,49,陽信-石牌,2023-05-02,8711
5876,上海商銀,40,0,40,陽信-石牌,2023-05-02,8711
1101,台泥,55,16,39,陽信-石牌,2023-05-02,8711
6163,華電網,40,5,35,陽信-石牌,2023-05-02,8711
6244,茂迪,39,11,28,陽信-石牌,2023-05-02,8711
8099,大世科,27,0,27,陽信-石牌,2023-05-02,8711
00772B,中信高評級公司債,26,0,26,陽信-石牌,2023-05-02,8711
00720B,元大投資級公司債,25,0,25,陽信-石牌,2023-05-02,8711
3264,欣銓,24,0,24,陽信-石牌,2023-05-02,8711
1528,恩德,20,0,20,陽信-石牌,2023-05-02,8711
5481,新華,20,0,20,陽信-石牌,2023-05-02,8711
1611,中電,20,1,19,陽信-石牌,2023-05-02,8711
2344,華邦電,24,7,17,陽信-石牌,2023-05-02,8711
2609,陽明,47,31,16,陽信-石牌,2023-05-02,8711
1310,台苯,15,0,15,陽信-石牌,2023-05-02,8711
00641R,富邦日本反1,15,0,15,陽信-石牌,2023-05-02,8711
00878,國泰永續高股息,15,0,15,陽信-石牌,2023-05-02,8711
6874,倍力,15,0,15,陽信-石牌,2023-05-02,8711
5009,榮剛,70,56,14,陽信-石牌,2023-05-02,8711
1513,中興電,21,8,13,陽信-石牌,2023-05-02,8711
1720,生達,17,5,12,陽信-石牌,2023-05-02,8711
2880,華南金,12,0,12,陽信-石牌,2023-05-02,8711
2641,正德,11,0,11,陽信-石牌,2023-05-02,8711
4961,天鈺,13,2,11,陽信-石牌,2023-05-02,8711
6167,久正,18,7,11,陽信-石牌,2023-05-02,8711
6770,力積電,11,0,11,陽信-石牌,2023-05-02,8711
2206,三陽工業,118,108,10,陽信-石牌,2023-05-02,8711
00671R,富邦NASDAQ反1,40,30,10,陽信-石牌,2023-05-02,8711
00665L,富邦�琤肭磪囓�2,40,30,10,陽信-石牌,2023-05-02,8711
00680L,元大美債20正2,10,0,10,陽信-石牌,2023-05-02,8711
2014,中鴻,10,0,10,陽信-石牌,2023-05-02,8711
3058,立德,12,2,10,陽信-石牌,2023-05-02,8711
3081,聯亞,15,5,10,陽信-石牌,2023-05-02,8711
4934,太極,11,1,10,陽信-石牌,2023-05-02,8711
5426,振發,10,0,10,陽信-石牌,2023-05-02,8711
0050,元大台灣50,11,2,9,陽信-石牌,2023-05-02,8711
1708,東鹼,9,0,9,陽信-石牌,2023-05-02,8711
2402,毅嘉,21,12,9,陽信-石牌,2023-05-02,8711
8046,南電,12,3,9,陽信-石牌,2023-05-02,8711
8086,宏捷科,25,16,9,陽信-石牌,2023-05-02,8711
1504,東元,18,10,8,陽信-石牌,2023-05-02,8711
2457,飛宏,49,41,8,陽信-石牌,2023-05-02,8711
00632R,元大台灣50反1,430,15,415,陽信-石牌,2023-05-03,8711
00650L,復華香港正2,200,0,200,陽信-石牌,2023-05-03,8711
00712,復華富時不動產,125,0,125,陽信-石牌,2023-05-03,8711
2603,長榮,121,11,110,陽信-石牌,2023-05-03,8711
2515,中工,100,0,100,陽信-石牌,2023-05-03,8711
3481,群創,98,1,97,陽信-石牌,2023-05-03,8711
4916,事欣科,71,0,71,陽信-石牌,2023-05-03,8711
00715L,期街口布蘭特正2,68,0,68,陽信-石牌,2023-05-03,8711
2883,凱基金,70,2,68,陽信-石牌,2023-05-03,8711
3005,神基,47,5,42,陽信-石牌,2023-05-03,8711
5351,鈺創,40,0,40,陽信-石牌,2023-05-03,8711
6234,高僑,47,12,35,陽信-石牌,2023-05-03,8711
1711,永光,41,8,33,陽信-石牌,2023-05-03,8711
00878,國泰永續高股息,32,3,29,陽信-石牌,2023-05-03,8711
00642U,期元大S＆P石油,27,0,27,陽信-石牌,2023-05-03,8711
2601,益航,25,0,25,陽信-石牌,2023-05-03,8711
00648R,元大S＆P500反1,20,0,20,陽信-石牌,2023-05-03,8711
00669R,國泰美國道瓊反1,20,0,20,陽信-石牌,2023-05-03,8711
4960,誠美材,20,0,20,陽信-石牌,2023-05-03,8711
3231,緯創,38,19,19,陽信-石牌,2023-05-03,8711
6770,力積電,22,5,17,陽信-石牌,2023-05-03,8711
1519,華城,19,3,16,陽信-石牌,2023-05-03,8711
5309,系統電,17,1,16,陽信-石牌,2023-05-03,8711
2457,飛宏,47,32,15,陽信-石牌,2023-05-03,8711
1513,中興電,24,9,15,陽信-石牌,2023-05-03,8711
6411,晶焱,13,0,13,陽信-石牌,2023-05-03,8711
2331,精英,14,2,12,陽信-石牌,2023-05-03,8711
2609,陽明,13,1,12,陽信-石牌,2023-05-03,8711
3419,譁裕,18,6,12,陽信-石牌,2023-05-03,8711
4109,加捷生醫,12,0,12,陽信-石牌,2023-05-03,8711
00637L,元大滬深300正2,13,2,11,陽信-石牌,2023-05-03,8711
2495,普安,17,6,11,陽信-石牌,2023-05-03,8711
5481,新華,11,0,11,陽信-石牌,2023-05-03,8711
00753L,中信中國50正2,10,0,10,陽信-石牌,2023-05-03,8711
00641R,富邦日本反1,10,0,10,陽信-石牌,2023-05-03,8711
1810,和成,10,0,10,陽信-石牌,2023-05-03,8711
2102,泰豐,40,30,10,陽信-石牌,2023-05-03,8711
2388,威盛,10,0,10,陽信-石牌,2023-05-03,8711
2504,國產,10,0,10,陽信-石牌,2023-05-03,8711
3060,銘異,20,10,10,陽信-石牌,2023-05-03,8711
3078,僑威,14,4,10,陽信-石牌,2023-05-03,8711
3346,麗清,10,0,10,陽信-石牌,2023-05-03,8711
6753,龍德造船,11,1,10,陽信-石牌,2023-05-03,8711
8426,紅木-KY,10,0,10,陽信-石牌,2023-05-03,8711
9955,佳龍,10,0,10,陽信-石牌,2023-05-03,8711
6806,森崴能源,11,2,9,陽信-石牌,2023-05-03,8711
2337,旺宏,9,0,9,陽信-石牌,2023-05-03,8711
2889,國票金,10,1,9,陽信-石牌,2023-05-03,8711
3673,TPK-KY,10,1,9,陽信-石牌,2023-05-03,8711
6689,伊雲谷,9,0,9,陽信-石牌,2023-05-03,8711
00650L,復華香港正2,500,0,500,陽信-石牌,2023-05-04,8711
2812,台中銀,120,0,120,陽信-石牌,2023-05-04,8711
00715L,期街口布蘭特正2,75,0,75,陽信-石牌,2023-05-04,8711
3694,海華,72,0,72,陽信-石牌,2023-05-04,8711
8085,福華,70,3,67,陽信-石牌,2023-05-04,8711
3481,群創,76,15,61,陽信-石牌,2023-05-04,8711
00712,復華富時不動產,59,0,59,陽信-石牌,2023-05-04,8711
4906,正文,59,2,57,陽信-石牌,2023-05-04,8711
00632R,元大台灣50反1,65,10,55,陽信-石牌,2023-05-04,8711
00642U,期元大S＆P石油,44,0,44,陽信-石牌,2023-05-04,8711
2603,長榮,45,5,40,陽信-石牌,2023-05-04,8711
1907,永豐餘,37,3,34,陽信-石牌,2023-05-04,8711
00671R,富邦NASDAQ反1,30,0,30,陽信-石牌,2023-05-04,8711
00641R,富邦日本反1,30,0,30,陽信-石牌,2023-05-04,8711
6244,茂迪,38,15,23,陽信-石牌,2023-05-04,8711
1218,泰山,20,0,20,陽信-石牌,2023-05-04,8711
2887,台新金,20,0,20,陽信-石牌,2023-05-04,8711
4721,美琪瑪,20,0,20,陽信-石牌,2023-05-04,8711
2457,飛宏,41,21,20,陽信-石牌,2023-05-04,8711
2102,泰豐,20,1,19,陽信-石牌,2023-05-04,8711
2409,友達,45,26,19,陽信-石牌,2023-05-04,8711
2468,華經,32,14,18,陽信-石牌,2023-05-04,8711
6806,森崴能源,26,8,18,陽信-石牌,2023-05-04,8711
00679B,元大美債20年,16,0,16,陽信-石牌,2023-05-04,8711
6167,久正,19,5,14,陽信-石牌,2023-05-04,8711
1605,華新,19,6,13,陽信-石牌,2023-05-04,8711
2515,中工,13,0,13,陽信-石牌,2023-05-04,8711
2303,聯電,22,10,12,陽信-石牌,2023-05-04,8711
00878,國泰永續高股息,11,0,11,陽信-石牌,2023-05-04,8711
1711,永光,13,2,11,陽信-石牌,2023-05-04,8711
2201,裕隆,12,1,11,陽信-石牌,2023-05-04,8711
2637,慧洋-KY,11,0,11,陽信-石牌,2023-05-04,8711
3013,晟銘電,13,2,11,陽信-石牌,2023-05-04,8711
3231,緯創,16,5,11,陽信-石牌,2023-05-04,8711
8436,大江,11,0,11,陽信-石牌,2023-05-04,8711
00853B,統一美債10年Aa-,10,0,10,陽信-石牌,2023-05-04,8711
1471,首利,10,0,10,陽信-石牌,2023-05-04,8711
1810,和成,10,0,10,陽信-石牌,2023-05-04,8711
2618,長榮航,11,1,10,陽信-石牌,2023-05-04,8711
2891,中信金,10,0,10,陽信-石牌,2023-05-04,8711
3033,威健,10,0,10,陽信-石牌,2023-05-04,8711
4173,久裕,18,8,10,陽信-石牌,2023-05-04,8711
6129,普誠,10,0,10,陽信-石牌,2023-05-04,8711
6589,台康生技,18,8,10,陽信-石牌,2023-05-04,8711
8069,元太,12,2,10,陽信-石牌,2023-05-04,8711
2495,普安,11,2,9,陽信-石牌,2023-05-04,8711
6443,元晶,9,0,9,陽信-石牌,2023-05-04,8711
8440,綠電,10,1,9,陽信-石牌,2023-05-04,8711
1337,再生-KY,8,0,8,陽信-石牌,2023-05-04,8711
2014,中鴻,8,0,8,陽信-石牌,2023-05-04,8711
00650L,復華香港正2,1100,0,1100,陽信-石牌,2023-05-05,8711
00632R,元大台灣50反1,70,5,65,陽信-石牌,2023-05-05,8711
3202,樺晟,65,0,65,陽信-石牌,2023-05-05,8711
00878,國泰永續高股息,60,0,60,陽信-石牌,2023-05-05,8711
1609,大亞,207,155,52,陽信-石牌,2023-05-05,8711
6538,倉和,50,0,50,陽信-石牌,2023-05-05,8711
00751B,元大AAA至A公司債,42,0,42,陽信-石牌,2023-05-05,8711
2801,彰銀,39,0,39,陽信-石牌,2023-05-05,8711
2359,所羅門,42,6,36,陽信-石牌,2023-05-05,8711
3694,海華,28,0,28,陽信-石牌,2023-05-05,8711
6573,虹揚-KY,28,0,28,陽信-石牌,2023-05-05,8711
2610,華航,25,0,25,陽信-石牌,2023-05-05,8711
00772B,中信高評級公司債,22,0,22,陽信-石牌,2023-05-05,8711
2208,台船,25,3,22,陽信-石牌,2023-05-05,8711
6129,普誠,22,0,22,陽信-石牌,2023-05-05,8711
6234,高僑,21,0,21,陽信-石牌,2023-05-05,8711
2634,漢翔,49,28,21,陽信-石牌,2023-05-05,8711
1218,泰山,20,0,20,陽信-石牌,2023-05-05,8711
5481,新華,20,0,20,陽信-石牌,2023-05-05,8711
6142,友勁,20,0,20,陽信-石牌,2023-05-05,8711
2618,長榮航,19,0,19,陽信-石牌,2023-05-05,8711
2317,鴻海,18,0,18,陽信-石牌,2023-05-05,8711
8069,元太,19,2,17,陽信-石牌,2023-05-05,8711
00676R,富邦臺灣加權反1,15,0,15,陽信-石牌,2023-05-05,8711
1409,新纖,15,0,15,陽信-石牌,2023-05-05,8711
1514,亞力,15,0,15,陽信-石牌,2023-05-05,8711
4541,晟田,28,13,15,陽信-石牌,2023-05-05,8711
00882,中信中國高股息,14,0,14,陽信-石牌,2023-05-05,8711
2353,宏��,16,2,14,陽信-石牌,2023-05-05,8711
3027,盛達,15,1,14,陽信-石牌,2023-05-05,8711
3046,建��,44,30,14,陽信-石牌,2023-05-05,8711
2609,陽明,13,0,13,陽信-石牌,2023-05-05,8711
2105,正新,13,1,12,陽信-石牌,2023-05-05,8711
3356,奇偶,13,1,12,陽信-石牌,2023-05-05,8711
3576,聯合再生,12,0,12,陽信-石牌,2023-05-05,8711
9919,康那香,12,0,12,陽信-石牌,2023-05-05,8711
00712,復華富時不動產,11,0,11,陽信-石牌,2023-05-05,8711
4916,事欣科,11,0,11,陽信-石牌,2023-05-05,8711
00641R,富邦日本反1,10,0,10,陽信-石牌,2023-05-05,8711
00715L,期街口布蘭特正2,10,0,10,陽信-石牌,2023-05-05,8711
2421,建準,13,3,10,陽信-石牌,2023-05-05,8711
2889,國票金,10,0,10,陽信-石牌,2023-05-05,8711
3094,聯傑,10,0,10,陽信-石牌,2023-05-05,8711
6841,長佳智能,10,0,10,陽信-石牌,2023-05-05,8711
2603,長榮,15,6,9,陽信-石牌,2023-05-05,8711
2511,太子,9,0,9,陽信-石牌,2023-05-05,8711
3045,台灣大,37,28,9,陽信-石牌,2023-05-05,8711
3484,崧騰,9,0,9,陽信-石牌,2023-05-05,8711
1513,中興電,15,7,8,陽信-石牌,2023-05-05,8711
1709,和益,8,0,8,陽信-石牌,2023-05-05,8711
00878,國泰永續高股息,214,1,213,陽信-石牌,2023-05-08,8711
2883,凱基金,133,23,110,陽信-石牌,2023-05-08,8711
00676R,富邦臺灣加權反1,50,0,50,陽信-石牌,2023-05-08,8711
3005,神基,52,4,48,陽信-石牌,2023-05-08,8711
00671R,富邦NASDAQ反1,45,0,45,陽信-石牌,2023-05-08,8711
2208,台船,33,1,32,陽信-石牌,2023-05-08,8711
4916,事欣科,30,0,30,陽信-石牌,2023-05-08,8711
3481,群創,34,5,29,陽信-石牌,2023-05-08,8711
2468,華經,46,21,25,陽信-石牌,2023-05-08,8711
2801,彰銀,25,1,24,陽信-石牌,2023-05-08,8711
2344,華邦電,33,10,23,陽信-石牌,2023-05-08,8711
1605,華新,162,141,21,陽信-石牌,2023-05-08,8711
6841,長佳智能,21,0,21,陽信-石牌,2023-05-08,8711
8033,雷虎,25,4,21,陽信-石牌,2023-05-08,8711
5481,新華,20,0,20,陽信-石牌,2023-05-08,8711
8112,至上,20,0,20,陽信-石牌,2023-05-08,8711
00669R,國泰美國道瓊反1,19,0,19,陽信-石牌,2023-05-08,8711
8085,福華,21,2,19,陽信-石牌,2023-05-08,8711
2603,長榮,17,0,17,陽信-石牌,2023-05-08,8711
00751B,元大AAA至A公司債,16,0,16,陽信-石牌,2023-05-08,8711
3294,英濟,16,0,16,陽信-石牌,2023-05-08,8711
4541,晟田,44,28,16,陽信-石牌,2023-05-08,8711
00772B,中信高評級公司債,15,0,15,陽信-石牌,2023-05-08,8711
2892,第一金,15,0,15,陽信-石牌,2023-05-08,8711
6573,虹揚-KY,15,0,15,陽信-石牌,2023-05-08,8711
8222,寶一,20,5,15,陽信-石牌,2023-05-08,8711
9933,中鼎,15,0,15,陽信-石牌,2023-05-08,8711
1101,台泥,23,9,14,陽信-石牌,2023-05-08,8711
6547,高端疫苗,13,0,13,陽信-石牌,2023-05-08,8711
5245,智晶,12,0,12,陽信-石牌,2023-05-08,8711
5465,富驊,16,4,12,陽信-石牌,2023-05-08,8711
6532,瑞耘,12,0,12,陽信-石牌,2023-05-08,8711
8069,元太,17,5,12,陽信-石牌,2023-05-08,8711
3710,連展投控,11,0,11,陽信-石牌,2023-05-08,8711
5880,合庫金,11,0,11,陽信-石牌,2023-05-08,8711
00674R,期元大S＆P黃金反1,10,0,10,陽信-石牌,2023-05-08,8711
2702,華園,10,0,10,陽信-石牌,2023-05-08,8711
3060,銘異,10,0,10,陽信-石牌,2023-05-08,8711
4123,晟德,13,3,10,陽信-石牌,2023-05-08,8711
4968,立積,10,0,10,陽信-石牌,2023-05-08,8711
6209,今國光,10,0,10,陽信-石牌,2023-05-08,8711
3715,定穎投控,11,2,9,陽信-石牌,2023-05-08,8711
6129,普誠,8,0,8,陽信-石牌,2023-05-08,8711
3324,雙鴻,7,0,7,陽信-石牌,2023-05-08,8711
00725B,國泰投資級公司債,6,0,6,陽信-石牌,2023-05-08,8711
1316,上曜,6,0,6,陽信-石牌,2023-05-08,8711
2009,第一銅,6,0,6,陽信-石牌,2023-05-08,8711
2014,中鴻,6,0,6,陽信-石牌,2023-05-08,8711
2409,友達,16,10,6,陽信-石牌,2023-05-08,8711
2609,陽明,19,13,6,陽信-石牌,2023-05-08,8711
3694,海華,330,0,330,陽信-石牌,2023-05-09,8711
2409,友達,102,19,83,陽信-石牌,2023-05-09,8711
00751B,元大AAA至A公司債,53,0,53,陽信-石牌,2023-05-09,8711
2913,農林,56,3,53,陽信-石牌,2023-05-09,8711
2102,泰豐,50,1,49,陽信-石牌,2023-05-09,8711
2206,三陽工業,64,16,48,陽信-石牌,2023-05-09,8711
00712,復華富時不動產,40,0,40,陽信-石牌,2023-05-09,8711
6288,聯嘉,41,1,40,陽信-石牌,2023-05-09,8711
00671R,富邦NASDAQ反1,40,3,37,陽信-石牌,2023-05-09,8711
3045,台灣大,33,0,33,陽信-石牌,2023-05-09,8711
3027,盛達,30,1,29,陽信-石牌,2023-05-09,8711
1513,中興電,42,17,25,陽信-石牌,2023-05-09,8711
1611,中電,25,0,25,陽信-石牌,2023-05-09,8711
4417,金洲,25,0,25,陽信-石牌,2023-05-09,8711
2359,所羅門,24,0,24,陽信-石牌,2023-05-09,8711
3005,神基,51,27,24,陽信-石牌,2023-05-09,8711
6174,安��,23,0,23,陽信-石牌,2023-05-09,8711
2891,中信金,22,0,22,陽信-石牌,2023-05-09,8711
2402,毅嘉,26,5,21,陽信-石牌,2023-05-09,8711
6266,泰詠,21,0,21,陽信-石牌,2023-05-09,8711
00724B,群益投資級金融債,20,0,20,陽信-石牌,2023-05-09,8711
2022,聚亨,20,0,20,陽信-石牌,2023-05-09,8711
2352,佳世達,28,8,20,陽信-石牌,2023-05-09,8711
2897,王道銀行,20,0,20,陽信-石牌,2023-05-09,8711
1905,華紙,40,21,19,陽信-石牌,2023-05-09,8711
5009,榮剛,61,42,19,陽信-石牌,2023-05-09,8711
2609,陽明,20,3,17,陽信-石牌,2023-05-09,8711
3484,崧騰,21,4,17,陽信-石牌,2023-05-09,8711
00878,國泰永續高股息,17,1,16,陽信-石牌,2023-05-09,8711
2421,建準,30,14,16,陽信-石牌,2023-05-09,8711
6152,百一,16,0,16,陽信-石牌,2023-05-09,8711
00676R,富邦臺灣加權反1,15,0,15,陽信-石牌,2023-05-09,8711
1909,榮成,15,0,15,陽信-石牌,2023-05-09,8711
2201,裕隆,30,15,15,陽信-石牌,2023-05-09,8711
1519,華城,41,27,14,陽信-石牌,2023-05-09,8711
5481,新華,14,0,14,陽信-石牌,2023-05-09,8711
00679B,元大美債20年,13,0,13,陽信-石牌,2023-05-09,8711
3029,零壹,13,1,12,陽信-石牌,2023-05-09,8711
00641R,富邦日本反1,10,0,10,陽信-石牌,2023-05-09,8711
00674R,期元大S＆P黃金反1,10,0,10,陽信-石牌,2023-05-09,8711
2331,精英,10,0,10,陽信-石牌,2023-05-09,8711
2388,威盛,10,0,10,陽信-石牌,2023-05-09,8711
2468,華經,10,0,10,陽信-石牌,2023-05-09,8711
3686,達能,10,0,10,陽信-石牌,2023-05-09,8711
4911,德英,10,0,10,陽信-石牌,2023-05-09,8711
6282,康舒,40,30,10,陽信-石牌,2023-05-09,8711
8044,網家,11,1,10,陽信-石牌,2023-05-09,8711
8358,金居,10,0,10,陽信-石牌,2023-05-09,8711
1504,東元,14,5,9,陽信-石牌,2023-05-09,8711
2495,普安,9,0,9,陽信-石牌,2023-05-09,8711
00632R,元大台灣50反1,400,55,345,陽信-石牌,2023-05-10,8711
00673R,期元大S＆P原油反1,276,0,276,陽信-石牌,2023-05-10,8711
00878,國泰永續高股息,141,7,134,陽信-石牌,2023-05-10,8711
3680,家登,130,0,130,陽信-石牌,2023-05-10,8711
00882,中信中國高股息,125,14,111,陽信-石牌,2023-05-10,8711
3481,群創,110,1,109,陽信-石牌,2023-05-10,8711
6244,茂迪,119,11,108,陽信-石牌,2023-05-10,8711
3694,海華,68,0,68,陽信-石牌,2023-05-10,8711
00671R,富邦NASDAQ反1,30,0,30,陽信-石牌,2023-05-10,8711
2887,台新金,28,0,28,陽信-石牌,2023-05-10,8711
8112,至上,30,2,28,陽信-石牌,2023-05-10,8711
2634,漢翔,27,3,24,陽信-石牌,2023-05-10,8711
8222,寶一,31,8,23,陽信-石牌,2023-05-10,8711
1609,大亞,95,73,22,陽信-石牌,2023-05-10,8711
2303,聯電,37,16,21,陽信-石牌,2023-05-10,8711
00680L,元大美債20正2,21,0,21,陽信-石牌,2023-05-10,8711
2891,中信金,21,0,21,陽信-石牌,2023-05-10,8711
3013,晟銘電,21,0,21,陽信-石牌,2023-05-10,8711
6465,威潤,21,0,21,陽信-石牌,2023-05-10,8711
00753L,中信中國50正2,20,0,20,陽信-石牌,2023-05-10,8711
5481,新華,20,0,20,陽信-石牌,2023-05-10,8711
2881,富邦金,19,0,19,陽信-石牌,2023-05-10,8711
5009,榮剛,20,1,19,陽信-石牌,2023-05-10,8711
5381,合正,16,0,16,陽信-石牌,2023-05-10,8711
8426,紅木-KY,16,0,16,陽信-石牌,2023-05-10,8711
00641R,富邦日本反1,15,0,15,陽信-石牌,2023-05-10,8711
8463,潤泰材,15,0,15,陽信-石牌,2023-05-10,8711
3231,緯創,18,5,13,陽信-石牌,2023-05-10,8711
3046,建��,25,13,12,陽信-石牌,2023-05-10,8711
6163,華電網,12,0,12,陽信-石牌,2023-05-10,8711
6443,元晶,13,1,12,陽信-石牌,2023-05-10,8711
2356,英業達,11,0,11,陽信-石牌,2023-05-10,8711
8091,翔名,16,5,11,陽信-石牌,2023-05-10,8711
1314,中石化,10,0,10,陽信-石牌,2023-05-10,8711
00772B,中信高評級公司債,10,0,10,陽信-石牌,2023-05-10,8711
00637L,元大滬深300正2,22,12,10,陽信-石牌,2023-05-10,8711
00674R,期元大S＆P黃金反1,10,0,10,陽信-石牌,2023-05-10,8711
3484,崧騰,10,0,10,陽信-石牌,2023-05-10,8711
6129,普誠,10,0,10,陽信-石牌,2023-05-10,8711
8171,天宇,10,0,10,陽信-石牌,2023-05-10,8711
8936,國統,10,0,10,陽信-石牌,2023-05-10,8711
2409,友達,10,1,9,陽信-石牌,2023-05-10,8711
2453,凌群,13,4,9,陽信-石牌,2023-05-10,8711
4979,華星光,13,4,9,陽信-石牌,2023-05-10,8711
5469,瀚宇博,9,0,9,陽信-石牌,2023-05-10,8711
6282,康舒,10,1,9,陽信-石牌,2023-05-10,8711
6288,聯嘉,16,7,9,陽信-石牌,2023-05-10,8711
1515,力山,8,0,8,陽信-石牌,2023-05-10,8711
2387,精元,8,0,8,陽信-石牌,2023-05-10,8711
3308,聯德,10,2,8,陽信-石牌,2023-05-10,8711
00632R,元大台灣50反1,300,95,205,陽信-石牌,2023-05-11,8711
3481,群創,212,15,197,陽信-石牌,2023-05-11,8711
00715L,期街口布蘭特正2,209,13,196,陽信-石牌,2023-05-11,8711
2610,華航,183,14,169,陽信-石牌,2023-05-11,8711
1609,大亞,224,64,160,陽信-石牌,2023-05-11,8711
6538,倉和,141,0,141,陽信-石牌,2023-05-11,8711
4916,事欣科,121,2,119,陽信-石牌,2023-05-11,8711
00882,中信中國高股息,101,0,101,陽信-石牌,2023-05-11,8711
2888,新光金,70,0,70,陽信-石牌,2023-05-11,8711
1710,東聯,60,1,59,陽信-石牌,2023-05-11,8711
2603,長榮,58,0,58,陽信-石牌,2023-05-11,8711
00671R,富邦NASDAQ反1,40,0,40,陽信-石牌,2023-05-11,8711
2102,泰豐,40,0,40,陽信-石牌,2023-05-11,8711
2618,長榮航,54,18,36,陽信-石牌,2023-05-11,8711
00641R,富邦日本反1,35,0,35,陽信-石牌,2023-05-11,8711
4114,健喬,33,1,32,陽信-石牌,2023-05-11,8711
1101,台泥,35,4,31,陽信-石牌,2023-05-11,8711
2303,聯電,33,2,31,陽信-石牌,2023-05-11,8711
3260,威剛,31,0,31,陽信-石牌,2023-05-11,8711
9907,統一實,28,1,27,陽信-石牌,2023-05-11,8711
2801,彰銀,25,0,25,陽信-石牌,2023-05-11,8711
2892,第一金,25,0,25,陽信-石牌,2023-05-11,8711
2421,建準,23,1,22,陽信-石牌,2023-05-11,8711
3037,欣興,27,5,22,陽信-石牌,2023-05-11,8711
2380,虹光,20,0,20,陽信-石牌,2023-05-11,8711
2382,廣達,23,4,19,陽信-石牌,2023-05-11,8711
2880,華南金,20,1,19,陽信-石牌,2023-05-11,8711
5201,凱衛,24,6,18,陽信-石牌,2023-05-11,8711
8426,紅木-KY,18,0,18,陽信-石牌,2023-05-11,8711
00878,國泰永續高股息,17,0,17,陽信-石牌,2023-05-11,8711
2402,毅嘉,13,0,13,陽信-石牌,2023-05-11,8711
2812,台中銀,13,0,13,陽信-石牌,2023-05-11,8711
2014,中鴻,12,0,12,陽信-石牌,2023-05-11,8711
2444,兆勁,12,0,12,陽信-石牌,2023-05-11,8711
2609,陽明,14,2,12,陽信-石牌,2023-05-11,8711
6266,泰詠,12,0,12,陽信-石牌,2023-05-11,8711
1471,首利,11,0,11,陽信-石牌,2023-05-11,8711
6443,元晶,11,0,11,陽信-石牌,2023-05-11,8711
2888A,新光金甲特,10,0,10,陽信-石牌,2023-05-11,8711
2890,永豐金,10,0,10,陽信-石牌,2023-05-11,8711
3005,神基,10,0,10,陽信-石牌,2023-05-11,8711
4911,德英,10,0,10,陽信-石牌,2023-05-11,8711
5481,新華,10,0,10,陽信-石牌,2023-05-11,8711
6187,萬潤,10,0,10,陽信-石牌,2023-05-11,8711
2022,聚亨,11,2,9,陽信-石牌,2023-05-11,8711
3027,盛達,10,1,9,陽信-石牌,2023-05-11,8711
3035,智原,11,2,9,陽信-石牌,2023-05-11,8711
3419,譁裕,10,1,9,陽信-石牌,2023-05-11,8711
3548,兆利,10,1,9,陽信-石牌,2023-05-11,8711
2881,富邦金,20,12,8,陽信-石牌,2023-05-11,8711
2453,凌群,217,2,215,陽信-石牌,2023-05-12,8711
00632R,元大台灣50反1,164,30,134,陽信-石牌,2023-05-12,8711
00878,國泰永續高股息,137,4,133,陽信-石牌,2023-05-12,8711
3481,群創,115,11,104,陽信-石牌,2023-05-12,8711
2890,永豐金,50,0,50,陽信-石牌,2023-05-12,8711
6257,矽格,50,2,48,陽信-石牌,2023-05-12,8711
1504,東元,58,12,46,陽信-石牌,2023-05-12,8711
2102,泰豐,46,0,46,陽信-石牌,2023-05-12,8711
2002,中鋼,40,0,40,陽信-石牌,2023-05-12,8711
8112,至上,50,10,40,陽信-石牌,2023-05-12,8711
2317,鴻海,37,0,37,陽信-石牌,2023-05-12,8711
00671R,富邦NASDAQ反1,35,0,35,陽信-石牌,2023-05-12,8711
2884,玉山金,36,3,33,陽信-石牌,2023-05-12,8711
2409,友達,31,0,31,陽信-石牌,2023-05-12,8711
2303,聯電,35,5,30,陽信-石牌,2023-05-12,8711
1905,華紙,59,30,29,陽信-石牌,2023-05-12,8711
6414,樺漢,28,1,27,陽信-石牌,2023-05-12,8711
2457,飛宏,56,34,22,陽信-石牌,2023-05-12,8711
6770,力積電,20,0,20,陽信-石牌,2023-05-12,8711
00641R,富邦日本反1,18,0,18,陽信-石牌,2023-05-12,8711
1783,和康生,17,0,17,陽信-石牌,2023-05-12,8711
6244,茂迪,17,2,15,陽信-石牌,2023-05-12,8711
1907,永豐餘,15,0,15,陽信-石牌,2023-05-12,8711
1101,台泥,15,1,14,陽信-石牌,2023-05-12,8711
2886,兆豐金,12,0,12,陽信-石牌,2023-05-12,8711
2014,中鴻,19,7,12,陽信-石牌,2023-05-12,8711
2801,彰銀,12,0,12,陽信-石牌,2023-05-12,8711
8050,廣積,12,0,12,陽信-石牌,2023-05-12,8711
2313,華通,11,0,11,陽信-石牌,2023-05-12,8711
5201,凱衛,13,2,11,陽信-石牌,2023-05-12,8711
2492,華新科,10,0,10,陽信-石牌,2023-05-12,8711
2851,中再保,10,0,10,陽信-石牌,2023-05-12,8711
2887,台新金,20,10,10,陽信-石牌,2023-05-12,8711
5536,聖暉*,10,0,10,陽信-石牌,2023-05-12,8711
8085,福華,10,0,10,陽信-石牌,2023-05-12,8711
00882,中信中國高股息,9,0,9,陽信-石牌,2023-05-12,8711
00712,復華富時不動產,10,1,9,陽信-石牌,2023-05-12,8711
00642U,期元大S＆P石油,14,5,9,陽信-石牌,2023-05-12,8711
9907,統一實,10,1,9,陽信-石牌,2023-05-12,8711
1609,大亞,19,10,9,陽信-石牌,2023-05-12,8711
2888,新光金,9,1,8,陽信-石牌,2023-05-12,8711
00637L,元大滬深300正2,10,2,8,陽信-石牌,2023-05-12,8711
1605,華新,16,8,8,陽信-石牌,2023-05-12,8711
2641,正德,8,0,8,陽信-石牌,2023-05-12,8711
4128,中天,8,0,8,陽信-石牌,2023-05-12,8711
00888,永豐台灣ESG,7,0,7,陽信-石牌,2023-05-12,8711
0056,元大高股息,9,2,7,陽信-石牌,2023-05-12,8711
3591,艾笛森,7,0,7,陽信-石牌,2023-05-12,8711
4967,十銓,12,5,7,陽信-石牌,2023-05-12,8711
5009,榮剛,38,31,7,陽信-石牌,2023-05-12,8711
00632R,元大台灣50反1,600,30,570,陽信-石牌,2023-05-15,8711
2453,凌群,115,2,113,陽信-石牌,2023-05-15,8711
00878,國泰永續高股息,103,0,103,陽信-石牌,2023-05-15,8711
3481,群創,100,3,97,陽信-石牌,2023-05-15,8711
2303,聯電,64,2,62,陽信-石牌,2023-05-15,8711
4417,金洲,40,0,40,陽信-石牌,2023-05-15,8711
00679B,元大美債20年,36,0,36,陽信-石牌,2023-05-15,8711
2402,毅嘉,35,1,34,陽信-石牌,2023-05-15,8711
6515,穎崴,36,4,32,陽信-石牌,2023-05-15,8711
1789,神隆,30,0,30,陽信-石牌,2023-05-15,8711
2457,飛宏,135,105,30,陽信-石牌,2023-05-15,8711
6288,聯嘉,30,0,30,陽信-石牌,2023-05-15,8711
2356,英業達,33,7,26,陽信-石牌,2023-05-15,8711
5009,榮剛,24,0,24,陽信-石牌,2023-05-15,8711
3691,碩禾,24,0,24,陽信-石牌,2023-05-15,8711
6163,華電網,26,2,24,陽信-石牌,2023-05-15,8711
4114,健喬,24,1,23,陽信-石牌,2023-05-15,8711
3231,緯創,37,15,22,陽信-石牌,2023-05-15,8711
6414,樺漢,30,10,20,陽信-石牌,2023-05-15,8711
2382,廣達,22,3,19,陽信-石牌,2023-05-15,8711
4123,晟德,17,0,17,陽信-石牌,2023-05-15,8711
00772B,中信高評級公司債,16,0,16,陽信-石牌,2023-05-15,8711
00641R,富邦日本反1,15,0,15,陽信-石牌,2023-05-15,8711
00648R,元大S＆P500反1,15,0,15,陽信-石牌,2023-05-15,8711
4804,大略-KY,13,0,13,陽信-石牌,2023-05-15,8711
00751B,元大AAA至A公司債,11,0,11,陽信-石牌,2023-05-15,8711
2317,鴻海,16,5,11,陽信-石牌,2023-05-15,8711
2377,微星,10,0,10,陽信-石牌,2023-05-15,8711
2393,億光,10,0,10,陽信-石牌,2023-05-15,8711
2406,國碩,10,0,10,陽信-石牌,2023-05-15,8711
2801,彰銀,10,0,10,陽信-石牌,2023-05-15,8711
6235,華孚,11,1,10,陽信-石牌,2023-05-15,8711
6443,元晶,11,1,10,陽信-石牌,2023-05-15,8711
3105,穩懋,13,4,9,陽信-石牌,2023-05-15,8711
6112,邁達特,22,13,9,陽信-石牌,2023-05-15,8711
6664,群翊,9,0,9,陽信-石牌,2023-05-15,8711
9933,中鼎,10,1,9,陽信-石牌,2023-05-15,8711
2603,長榮,22,14,8,陽信-石牌,2023-05-15,8711
00642U,期元大S＆P石油,8,0,8,陽信-石牌,2023-05-15,8711
1612,宏泰,8,0,8,陽信-石牌,2023-05-15,8711
2376,技嘉,8,0,8,陽信-石牌,2023-05-15,8711
4961,天鈺,13,5,8,陽信-石牌,2023-05-15,8711
6234,高僑,7,0,7,陽信-石牌,2023-05-15,8711
1503,士電,7,0,7,陽信-石牌,2023-05-15,8711
2888,新光金,7,1,6,陽信-石牌,2023-05-15,8711
3078,僑威,6,0,6,陽信-石牌,2023-05-15,8711
4120,友華,6,0,6,陽信-石牌,2023-05-15,8711
4726,永昕,6,0,6,陽信-石牌,2023-05-15,8711
5258,虹堡,6,0,6,陽信-石牌,2023-05-15,8711
00773B,中信優先金融債,5,0,5,陽信-石牌,2023-05-15,8711
2493,揚博,117,1,116,陽信-石牌,2023-05-16,8711
6712,長聖,82,0,82,陽信-石牌,2023-05-16,8711
2453,凌群,83,30,53,陽信-石牌,2023-05-16,8711
1504,東元,246,215,31,陽信-石牌,2023-05-16,8711
5452,佶優,30,0,30,陽信-石牌,2023-05-16,8711
2102,泰豐,28,0,28,陽信-石牌,2023-05-16,8711
00679B,元大美債20年,25,0,25,陽信-石牌,2023-05-16,8711
00676R,富邦臺灣加權反1,25,0,25,陽信-石牌,2023-05-16,8711
6806,森崴能源,24,1,23,陽信-石牌,2023-05-16,8711
00751B,元大AAA至A公司債,20,0,20,陽信-石牌,2023-05-16,8711
3078,僑威,20,0,20,陽信-石牌,2023-05-16,8711
4804,大略-KY,20,0,20,陽信-石牌,2023-05-16,8711
1519,華城,70,51,19,陽信-石牌,2023-05-16,8711
00680L,元大美債20正2,17,0,17,陽信-石牌,2023-05-16,8711
2504,國產,17,0,17,陽信-石牌,2023-05-16,8711
6244,茂迪,21,5,16,陽信-石牌,2023-05-16,8711
6443,元晶,20,4,16,陽信-石牌,2023-05-16,8711
8927,北基,16,0,16,陽信-石牌,2023-05-16,8711
2892,第一金,15,0,15,陽信-石牌,2023-05-16,8711
2409,友達,15,1,14,陽信-石牌,2023-05-16,8711
4919,新唐,14,1,13,陽信-石牌,2023-05-16,8711
1709,和益,12,0,12,陽信-石牌,2023-05-16,8711
8222,寶一,37,25,12,陽信-石牌,2023-05-16,8711
00772B,中信高評級公司債,11,0,11,陽信-石牌,2023-05-16,8711
00725B,國泰投資級公司債,11,0,11,陽信-石牌,2023-05-16,8711
2402,毅嘉,34,23,11,陽信-石牌,2023-05-16,8711
006208,富邦台50,10,0,10,陽信-石牌,2023-05-16,8711
2344,華邦電,12,2,10,陽信-石牌,2023-05-16,8711
2353,宏��,10,0,10,陽信-石牌,2023-05-16,8711
2745,五福,10,0,10,陽信-石牌,2023-05-16,8711
3294,英濟,13,3,10,陽信-石牌,2023-05-16,8711
3520,華盈,10,0,10,陽信-石牌,2023-05-16,8711
3548,兆利,10,0,10,陽信-石牌,2023-05-16,8711
9105,泰金寶-DR,10,0,10,陽信-石牌,2023-05-16,8711
2603,長榮,17,8,9,陽信-石牌,2023-05-16,8711
4147,中裕,8,0,8,陽信-石牌,2023-05-16,8711
00720B,元大投資級公司債,7,0,7,陽信-石牌,2023-05-16,8711
00715L,期街口布蘭特正2,16,9,7,陽信-石牌,2023-05-16,8711
2206,三陽工業,102,95,7,陽信-石牌,2023-05-16,8711
2331,精英,10,3,7,陽信-石牌,2023-05-16,8711
5381,合正,7,0,7,陽信-石牌,2023-05-16,8711
2368,金像電,16,10,6,陽信-石牌,2023-05-16,8711
2404,漢唐,10,4,6,陽信-石牌,2023-05-16,8711
2427,三商電,7,1,6,陽信-石牌,2023-05-16,8711
2630,亞航,6,0,6,陽信-石牌,2023-05-16,8711
4967,十銓,19,13,6,陽信-石牌,2023-05-16,8711
6122,擎邦,10,4,6,陽信-石牌,2023-05-16,8711
6753,龍德造船,7,1,6,陽信-石牌,2023-05-16,8711
8038,長園科,6,0,6,陽信-石牌,2023-05-16,8711
00713,元大台灣高息低波,5,0,5,陽信-石牌,2023-05-16,8711
3260,威剛,200,33,167,陽信-石牌,2023-05-17,8711
00751B,元大AAA至A公司債,107,0,107,陽信-石牌,2023-05-17,8711
1609,大亞,164,57,107,陽信-石牌,2023-05-17,8711
00713,元大台灣高息低波,104,0,104,陽信-石牌,2023-05-17,8711
8038,長園科,89,1,88,陽信-石牌,2023-05-17,8711
6741,91APP*-KY,60,0,60,陽信-石牌,2023-05-17,8711
2890,永豐金,60,1,59,陽信-石牌,2023-05-17,8711
2493,揚博,60,2,58,陽信-石牌,2023-05-17,8711
00671R,富邦NASDAQ反1,50,0,50,陽信-石牌,2023-05-17,8711
3704,合勤控,44,4,40,陽信-石牌,2023-05-17,8711
8046,南電,43,11,32,陽信-石牌,2023-05-17,8711
4804,大略-KY,30,0,30,陽信-石牌,2023-05-17,8711
2457,飛宏,63,38,25,陽信-石牌,2023-05-17,8711
1314,中石化,20,0,20,陽信-石牌,2023-05-17,8711
2352,佳世達,27,7,20,陽信-石牌,2023-05-17,8711
2453,凌群,20,0,20,陽信-石牌,2023-05-17,8711
00641R,富邦日本反1,17,0,17,陽信-石牌,2023-05-17,8711
3017,奇鋐,17,0,17,陽信-石牌,2023-05-17,8711
00772B,中信高評級公司債,16,0,16,陽信-石牌,2023-05-17,8711
2634,漢翔,66,50,16,陽信-石牌,2023-05-17,8711
00676R,富邦臺灣加權反1,15,0,15,陽信-石牌,2023-05-17,8711
6285,啟��,41,26,15,陽信-石牌,2023-05-17,8711
1709,和益,14,0,14,陽信-石牌,2023-05-17,8711
00720B,元大投資級公司債,11,0,11,陽信-石牌,2023-05-17,8711
2887,台新金,12,1,11,陽信-石牌,2023-05-17,8711
6234,高僑,11,0,11,陽信-石牌,2023-05-17,8711
6279,胡連,12,1,11,陽信-石牌,2023-05-17,8711
6806,森崴能源,12,1,11,陽信-石牌,2023-05-17,8711
00722B,群益投資級電信債,10,0,10,陽信-石牌,2023-05-17,8711
00680L,元大美債20正2,10,0,10,陽信-石牌,2023-05-17,8711
1611,中電,10,0,10,陽信-石牌,2023-05-17,8711
2441,超豐,10,0,10,陽信-石牌,2023-05-17,8711
2884,玉山金,10,0,10,陽信-石牌,2023-05-17,8711
3028,增你強,10,0,10,陽信-石牌,2023-05-17,8711
3058,立德,10,0,10,陽信-石牌,2023-05-17,8711
3308,聯德,10,0,10,陽信-石牌,2023-05-17,8711
4953,緯軟,10,0,10,陽信-石牌,2023-05-17,8711
4958,臻鼎-KY,10,0,10,陽信-石牌,2023-05-17,8711
4979,華星光,12,2,10,陽信-石牌,2023-05-17,8711
6191,精成科,11,1,10,陽信-石牌,2023-05-17,8711
8105,凌巨,10,0,10,陽信-石牌,2023-05-17,8711
2731,雄獅,16,7,9,陽信-石牌,2023-05-17,8711
8050,廣積,9,0,9,陽信-石牌,2023-05-17,8711
8440,綠電,9,0,9,陽信-石牌,2023-05-17,8711
00637L,元大滬深300正2,15,7,8,陽信-石牌,2023-05-17,8711
1464,得力,8,0,8,陽信-石牌,2023-05-17,8711
2618,長榮航,13,5,8,陽信-石牌,2023-05-17,8711
6244,茂迪,19,11,8,陽信-石牌,2023-05-17,8711
2201,裕隆,65,58,7,陽信-石牌,2023-05-17,8711
6185,幃翔,10,3,7,陽信-石牌,2023-05-17,8711
00715L,期街口布蘭特正2,172,18,154,陽信-石牌,2023-05-18,8711
2377,微星,150,0,150,陽信-石牌,2023-05-18,8711
00751B,元大AAA至A公司債,60,0,60,陽信-石牌,2023-05-18,8711
3673,TPK-KY,46,4,42,陽信-石牌,2023-05-18,8711
2402,毅嘉,58,21,37,陽信-石牌,2023-05-18,8711
6414,樺漢,45,8,37,陽信-石牌,2023-05-18,8711
6689,伊雲谷,38,2,36,陽信-石牌,2023-05-18,8711
5425,台半,55,20,35,陽信-石牌,2023-05-18,8711
2313,華通,32,0,32,陽信-石牌,2023-05-18,8711
00671R,富邦NASDAQ反1,30,0,30,陽信-石牌,2023-05-18,8711
4804,大略-KY,30,0,30,陽信-石牌,2023-05-18,8711
2352,佳世達,32,6,26,陽信-石牌,2023-05-18,8711
1504,東元,68,43,25,陽信-石牌,2023-05-18,8711
6770,力積電,24,1,23,陽信-石牌,2023-05-18,8711
2886,兆豐金,25,3,22,陽信-石牌,2023-05-18,8711
3028,增你強,21,0,21,陽信-石牌,2023-05-18,8711
00641R,富邦日本反1,20,0,20,陽信-石牌,2023-05-18,8711
1718,中纖,20,0,20,陽信-石牌,2023-05-18,8711
2634,漢翔,66,47,19,陽信-石牌,2023-05-18,8711
6538,倉和,59,41,18,陽信-石牌,2023-05-18,8711
2630,亞航,17,0,17,陽信-石牌,2023-05-18,8711
1783,和康生,15,0,15,陽信-石牌,2023-05-18,8711
2603,長榮,16,1,15,陽信-石牌,2023-05-18,8711
6806,森崴能源,18,3,15,陽信-石牌,2023-05-18,8711
6841,長佳智能,15,0,15,陽信-石牌,2023-05-18,8711
9105,泰金寶-DR,15,0,15,陽信-石牌,2023-05-18,8711
6443,元晶,16,3,13,陽信-石牌,2023-05-18,8711
8069,元太,20,7,13,陽信-石牌,2023-05-18,8711
8046,南電,16,4,12,陽信-石牌,2023-05-18,8711
00680L,元大美債20正2,12,0,12,陽信-石牌,2023-05-18,8711
00673R,期元大S＆P原油反1,12,0,12,陽信-石牌,2023-05-18,8711
00722B,群益投資級電信債,11,0,11,陽信-石牌,2023-05-18,8711
00772B,中信高評級公司債,11,0,11,陽信-石牌,2023-05-18,8711
1795,美時,22,11,11,陽信-石牌,2023-05-18,8711
2338,光罩,11,0,11,陽信-石牌,2023-05-18,8711
00753L,中信中國50正2,10,0,10,陽信-石牌,2023-05-18,8711
00676R,富邦臺灣加權反1,10,0,10,陽信-石牌,2023-05-18,8711
3056,富華新,10,0,10,陽信-石牌,2023-05-18,8711
6129,普誠,10,0,10,陽信-石牌,2023-05-18,8711
6209,今國光,10,0,10,陽信-石牌,2023-05-18,8711
5469,瀚宇博,10,1,9,陽信-石牌,2023-05-18,8711
6589,台康生技,11,2,9,陽信-石牌,2023-05-18,8711
006208,富邦台50,10,3,7,陽信-石牌,2023-05-18,8711
2323,中環,7,0,7,陽信-石牌,2023-05-18,8711
3037,欣興,12,5,7,陽信-石牌,2023-05-18,8711
3630,新鉅科,7,0,7,陽信-石牌,2023-05-18,8711
6266,泰詠,7,0,7,陽信-石牌,2023-05-18,8711
8222,寶一,12,5,7,陽信-石牌,2023-05-18,8711
2331,精英,10,4,6,陽信-石牌,2023-05-18,8711
2427,三商電,6,0,6,陽信-石牌,2023-05-18,8711
00650L,復華香港正2,500,0,500,陽信-石牌,2023-05-19,8711
3003,健和興,157,0,157,陽信-石牌,2023-05-19,8711
6689,伊雲谷,152,41,111,陽信-石牌,2023-05-19,8711
2453,凌群,101,4,97,陽信-石牌,2023-05-19,8711
1504,東元,103,18,85,陽信-石牌,2023-05-19,8711
3045,台灣大,68,0,68,陽信-石牌,2023-05-19,8711
00882,中信中國高股息,52,0,52,陽信-石牌,2023-05-19,8711
2371,大同,56,4,52,陽信-石牌,2023-05-19,8711
00900,富邦特選高股息30,50,0,50,陽信-石牌,2023-05-19,8711
00878,國泰永續高股息,93,49,44,陽信-石牌,2023-05-19,8711
00753L,中信中國50正2,42,0,42,陽信-石牌,2023-05-19,8711
5009,榮剛,38,2,36,陽信-石牌,2023-05-19,8711
1810,和成,31,1,30,陽信-石牌,2023-05-19,8711
2344,華邦電,35,8,27,陽信-石牌,2023-05-19,8711
3406,玉晶光,31,9,22,陽信-石牌,2023-05-19,8711
00751B,元大AAA至A公司債,22,0,22,陽信-石牌,2023-05-19,8711
2206,三陽工業,65,43,22,陽信-石牌,2023-05-19,8711
4114,健喬,27,6,21,陽信-石牌,2023-05-19,8711
00671R,富邦NASDAQ反1,20,0,20,陽信-石牌,2023-05-19,8711
2022,聚亨,20,0,20,陽信-石牌,2023-05-19,8711
3058,立德,20,0,20,陽信-石牌,2023-05-19,8711
2603,長榮,26,8,18,陽信-石牌,2023-05-19,8711
6285,啟��,18,1,17,陽信-石牌,2023-05-19,8711
8105,凌巨,20,3,17,陽信-石牌,2023-05-19,8711
6112,邁達特,21,5,16,陽信-石牌,2023-05-19,8711
1608,華榮,15,0,15,陽信-石牌,2023-05-19,8711
6160,欣技,16,1,15,陽信-石牌,2023-05-19,8711
6163,華電網,15,0,15,陽信-石牌,2023-05-19,8711
1605,華新,74,60,14,陽信-石牌,2023-05-19,8711
6806,森崴能源,14,0,14,陽信-石牌,2023-05-19,8711
00772B,中信高評級公司債,13,0,13,陽信-石牌,2023-05-19,8711
00687B,國泰20年美債,12,0,12,陽信-石牌,2023-05-19,8711
1513,中興電,20,8,12,陽信-石牌,2023-05-19,8711
4919,新唐,13,2,11,陽信-石牌,2023-05-19,8711
1101,台泥,11,0,11,陽信-石牌,2023-05-19,8711
2482,連宇,11,0,11,陽信-石牌,2023-05-19,8711
3025,星通,17,6,11,陽信-石牌,2023-05-19,8711
00673R,期元大S＆P原油反1,10,0,10,陽信-石牌,2023-05-19,8711
00642U,期元大S＆P石油,10,0,10,陽信-石牌,2023-05-19,8711
3548,兆利,10,0,10,陽信-石牌,2023-05-19,8711
4729,熒茂,10,0,10,陽信-石牌,2023-05-19,8711
4976,佳凌,10,0,10,陽信-石牌,2023-05-19,8711
00885,富邦越南,12,3,9,陽信-石牌,2023-05-19,8711
1514,亞力,19,10,9,陽信-石牌,2023-05-19,8711
4173,久裕,23,14,9,陽信-石牌,2023-05-19,8711
00637L,元大滬深300正2,26,18,8,陽信-石牌,2023-05-19,8711
2402,毅嘉,40,32,8,陽信-石牌,2023-05-19,8711
3029,零壹,13,5,8,陽信-石牌,2023-05-19,8711
6288,聯嘉,40,32,8,陽信-石牌,2023-05-19,8711
1711,永光,7,0,7,陽信-石牌,2023-05-19,8711
2812,台中銀,220,0,220,陽信-石牌,2023-05-22,8711
2303,聯電,158,1,157,陽信-石牌,2023-05-22,8711
00632R,元大台灣50反1,110,0,110,陽信-石牌,2023-05-22,8711
6026,福邦證,60,0,60,陽信-石牌,2023-05-22,8711
8046,南電,60,15,45,陽信-石牌,2023-05-22,8711
2324,仁寶,53,10,43,陽信-石牌,2023-05-22,8711
5531,鄉林,62,28,34,陽信-石牌,2023-05-22,8711
00857B,永豐20年美公債,30,0,30,陽信-石牌,2023-05-22,8711
00687B,國泰20年美債,30,0,30,陽信-石牌,2023-05-22,8711
00673R,期元大S＆P原油反1,33,8,25,陽信-石牌,2023-05-22,8711
2892,第一金,25,1,24,陽信-石牌,2023-05-22,8711
00772B,中信高評級公司債,24,0,24,陽信-石牌,2023-05-22,8711
6233,旺玖,23,2,21,陽信-石牌,2023-05-22,8711
00753L,中信中國50正2,20,0,20,陽信-石牌,2023-05-22,8711
1201,味全,20,0,20,陽信-石牌,2023-05-22,8711
2313,華通,25,5,20,陽信-石牌,2023-05-22,8711
2495,普安,20,0,20,陽信-石牌,2023-05-22,8711
4916,事欣科,23,3,20,陽信-石牌,2023-05-22,8711
3032,偉訓,25,6,19,陽信-石牌,2023-05-22,8711
00679B,元大美債20年,26,8,18,陽信-石牌,2023-05-22,8711
3037,欣興,60,43,17,陽信-石牌,2023-05-22,8711
00895,富邦未來車,17,0,17,陽信-石牌,2023-05-22,8711
3035,智原,20,5,15,陽信-石牌,2023-05-22,8711
6116,彩晶,15,2,13,陽信-石牌,2023-05-22,8711
00712,復華富時不動產,11,0,11,陽信-石牌,2023-05-22,8711
8935,邦泰,11,0,11,陽信-石牌,2023-05-22,8711
9919,康那香,11,0,11,陽信-石牌,2023-05-22,8711
00713,元大台灣高息低波,11,1,10,陽信-石牌,2023-05-22,8711
1591,駿吉-KY,10,0,10,陽信-石牌,2023-05-22,8711
2022,聚亨,10,0,10,陽信-石牌,2023-05-22,8711
2739,寒舍,10,0,10,陽信-石牌,2023-05-22,8711
4543,萬在,10,0,10,陽信-石牌,2023-05-22,8711
4768,晶呈科技,10,0,10,陽信-石牌,2023-05-22,8711
4960,誠美材,10,0,10,陽信-石牌,2023-05-22,8711
4979,華星光,16,6,10,陽信-石牌,2023-05-22,8711
2886,兆豐金,13,3,10,陽信-石牌,2023-05-22,8711
00878,國泰永續高股息,22,13,9,陽信-石牌,2023-05-22,8711
1528,恩德,16,7,9,陽信-石牌,2023-05-22,8711
6213,聯茂,10,1,9,陽信-石牌,2023-05-22,8711
3308,聯德,8,0,8,陽信-石牌,2023-05-22,8711
5439,高技,10,2,8,陽信-石牌,2023-05-22,8711
8240,華宏,8,0,8,陽信-石牌,2023-05-22,8711
00680L,元大美債20正2,7,0,7,陽信-石牌,2023-05-22,8711
2743,山富,8,1,7,陽信-石牌,2023-05-22,8711
2891,中信金,17,10,7,陽信-石牌,2023-05-22,8711
6515,穎崴,12,5,7,陽信-石牌,2023-05-22,8711
1795,美時,8,2,6,陽信-石牌,2023-05-22,8711
1314,中石化,6,0,6,陽信-石牌,2023-05-22,8711
00882,中信中國高股息,6,0,6,陽信-石牌,2023-05-22,8711
6223,旺矽,8,2,6,陽信-石牌,2023-05-22,8711
00882,中信中國高股息,207,0,207,陽信-石牌,2023-05-23,8711
00715L,期街口布蘭特正2,160,5,155,陽信-石牌,2023-05-23,8711
6689,伊雲谷,86,8,78,陽信-石牌,2023-05-23,8711
4564,元翎,67,0,67,陽信-石牌,2023-05-23,8711
2618,長榮航,179,113,66,陽信-石牌,2023-05-23,8711
2409,友達,60,3,57,陽信-石牌,2023-05-23,8711
2453,凌群,46,4,42,陽信-石牌,2023-05-23,8711
1514,亞力,34,5,29,陽信-石牌,2023-05-23,8711
2603,長榮,32,4,28,陽信-石牌,2023-05-23,8711
2851,中再保,28,1,27,陽信-石牌,2023-05-23,8711
2331,精英,33,7,26,陽信-石牌,2023-05-23,8711
2881,富邦金,25,0,25,陽信-石牌,2023-05-23,8711
6112,邁達特,38,17,21,陽信-石牌,2023-05-23,8711
3024,憶聲,20,0,20,陽信-石牌,2023-05-23,8711
6176,瑞儀,20,1,19,陽信-石牌,2023-05-23,8711
00679B,元大美債20年,18,0,18,陽信-石牌,2023-05-23,8711
2303,聯電,27,9,18,陽信-石牌,2023-05-23,8711
8097,常珵,19,2,17,陽信-石牌,2023-05-23,8711
2548,華固,16,0,16,陽信-石牌,2023-05-23,8711
2731,雄獅,23,7,16,陽信-石牌,2023-05-23,8711
3252,海灣,16,0,16,陽信-石牌,2023-05-23,8711
6226,光鼎,15,0,15,陽信-石牌,2023-05-23,8711
00687B,國泰20年美債,14,0,14,陽信-石牌,2023-05-23,8711
1810,和成,15,1,14,陽信-石牌,2023-05-23,8711
6274,台燿,16,2,14,陽信-石牌,2023-05-23,8711
8076,伍豐,21,7,14,陽信-石牌,2023-05-23,8711
2368,金像電,13,0,13,陽信-石牌,2023-05-23,8711
2442,新美齊,12,0,12,陽信-石牌,2023-05-23,8711
3308,聯德,26,14,12,陽信-石牌,2023-05-23,8711
2323,中環,13,2,11,陽信-石牌,2023-05-23,8711
2801,彰銀,11,0,11,陽信-石牌,2023-05-23,8711
6535,順藥,14,3,11,陽信-石牌,2023-05-23,8711
2022,聚亨,10,0,10,陽信-石牌,2023-05-23,8711
6248,沛波,10,0,10,陽信-石牌,2023-05-23,8711
1605,華新,9,0,9,陽信-石牌,2023-05-23,8711
00751B,元大AAA至A公司債,8,0,8,陽信-石牌,2023-05-23,8711
00637L,元大滬深300正2,8,0,8,陽信-石牌,2023-05-23,8711
1905,華紙,29,21,8,陽信-石牌,2023-05-23,8711
2313,華通,8,0,8,陽信-石牌,2023-05-23,8711
2609,陽明,10,2,8,陽信-石牌,2023-05-23,8711
3232,昱捷,8,0,8,陽信-石牌,2023-05-23,8711
3706,神達,8,0,8,陽信-石牌,2023-05-23,8711
6550,北極星藥業-KY,9,1,8,陽信-石牌,2023-05-23,8711
1513,中興電,21,14,7,陽信-石牌,2023-05-23,8711
2201,裕隆,39,32,7,陽信-石牌,2023-05-23,8711
3591,艾笛森,9,2,7,陽信-石牌,2023-05-23,8711
00633L,富邦上証正2,6,0,6,陽信-石牌,2023-05-23,8711
6223,旺矽,10,4,6,陽信-石牌,2023-05-23,8711
6418,詠昇,8,2,6,陽信-石牌,2023-05-23,8711
6754,匯僑設計,6,0,6,陽信-石牌,2023-05-23,8711
00882,中信中國高股息,201,10,191,陽信-石牌,2023-05-24,8711
8099,大世科,132,2,130,陽信-石牌,2023-05-24,8711
00687B,國泰20年美債,108,0,108,陽信-石牌,2023-05-24,8711
1609,大亞,82,28,54,陽信-石牌,2023-05-24,8711
2609,陽明,64,13,51,陽信-石牌,2023-05-24,8711
2636,台驊控股,51,0,51,陽信-石牌,2023-05-24,8711
2637,慧洋-KY,51,0,51,陽信-石牌,2023-05-24,8711
2915,潤泰全,50,0,50,陽信-石牌,2023-05-24,8711
00878,國泰永續高股息,100,51,49,陽信-石牌,2023-05-24,8711
00753L,中信中國50正2,44,0,44,陽信-石牌,2023-05-24,8711
1809,中釉,50,6,44,陽信-石牌,2023-05-24,8711
2886,兆豐金,42,1,41,陽信-石牌,2023-05-24,8711
2371,大同,43,2,41,陽信-石牌,2023-05-24,8711
00637L,元大滬深300正2,43,4,39,陽信-石牌,2023-05-24,8711
2457,飛宏,107,69,38,陽信-石牌,2023-05-24,8711
5512,力麒,31,4,27,陽信-石牌,2023-05-24,8711
4564,元翎,111,85,26,陽信-石牌,2023-05-24,8711
1529,樂事綠能,34,11,23,陽信-石牌,2023-05-24,8711
6244,茂迪,23,0,23,陽信-石牌,2023-05-24,8711
2548,華固,22,0,22,陽信-石牌,2023-05-24,8711
2380,虹光,20,0,20,陽信-石牌,2023-05-24,8711
2331,精英,19,0,19,陽信-石牌,2023-05-24,8711
4541,晟田,20,1,19,陽信-石牌,2023-05-24,8711
2486,一詮,20,2,18,陽信-石牌,2023-05-24,8711
2603,長榮,25,7,18,陽信-石牌,2023-05-24,8711
6535,順藥,20,2,18,陽信-石牌,2023-05-24,8711
00665L,富邦�琤肭磪囓�2,17,0,17,陽信-石牌,2023-05-24,8711
2719,燦星旅,17,0,17,陽信-石牌,2023-05-24,8711
2425,承啟,16,0,16,陽信-石牌,2023-05-24,8711
2892,第一金,15,0,15,陽信-石牌,2023-05-24,8711
6188,廣明,15,0,15,陽信-石牌,2023-05-24,8711
6288,聯嘉,50,35,15,陽信-石牌,2023-05-24,8711
1513,中興電,31,17,14,陽信-石牌,2023-05-24,8711
2702,華園,52,38,14,陽信-石牌,2023-05-24,8711
2303,聯電,15,2,13,陽信-石牌,2023-05-24,8711
00928,中信上櫃ESG30,12,0,12,陽信-石牌,2023-05-24,8711
1708,東鹼,12,0,12,陽信-石牌,2023-05-24,8711
2701,萬企,18,6,12,陽信-石牌,2023-05-24,8711
3711,日月光投控,12,0,12,陽信-石牌,2023-05-24,8711
4162,智擎,12,0,12,陽信-石牌,2023-05-24,8711
8069,元太,13,2,11,陽信-石牌,2023-05-24,8711
1789,神隆,10,0,10,陽信-石牌,2023-05-24,8711
2344,華邦電,10,0,10,陽信-石牌,2023-05-24,8711
2412,中華電,10,0,10,陽信-石牌,2023-05-24,8711
3032,偉訓,10,0,10,陽信-石牌,2023-05-24,8711
3038,全台,13,3,10,陽信-石牌,2023-05-24,8711
3205,佰研,14,4,10,陽信-石牌,2023-05-24,8711
3576,聯合再生,10,0,10,陽信-石牌,2023-05-24,8711
4128,中天,10,0,10,陽信-石牌,2023-05-24,8711
5222,全訊,10,0,10,陽信-石牌,2023-05-24,8711
00673R,期元大S＆P原油反1,222,0,222,陽信-石牌,2023-05-25,8711
00632R,元大台灣50反1,165,0,165,陽信-石牌,2023-05-25,8711
00637L,元大滬深300正2,106,16,90,陽信-石牌,2023-05-25,8711
1609,大亞,151,74,77,陽信-石牌,2023-05-25,8711
2402,毅嘉,96,35,61,陽信-石牌,2023-05-25,8711
2812,台中銀,53,0,53,陽信-石牌,2023-05-25,8711
1717,長興,50,0,50,陽信-石牌,2023-05-25,8711
6841,長佳智能,50,0,50,陽信-石牌,2023-05-25,8711
2603,長榮,52,6,46,陽信-石牌,2023-05-25,8711
2887,台新金,45,0,45,陽信-石牌,2023-05-25,8711
00878,國泰永續高股息,51,10,41,陽信-石牌,2023-05-25,8711
0056,元大高股息,56,17,39,陽信-石牌,2023-05-25,8711
5243,乙盛-KY,46,16,30,陽信-石牌,2023-05-25,8711
8358,金居,31,1,30,陽信-石牌,2023-05-25,8711
2457,飛宏,36,7,29,陽信-石牌,2023-05-25,8711
6176,瑞儀,27,0,27,陽信-石牌,2023-05-25,8711
2748,雲品,27,1,26,陽信-石牌,2023-05-25,8711
2606,裕民,25,0,25,陽信-石牌,2023-05-25,8711
8099,大世科,64,40,24,陽信-石牌,2023-05-25,8711
6112,邁達特,25,4,21,陽信-石牌,2023-05-25,8711
1513,中興電,32,11,21,陽信-石牌,2023-05-25,8711
4541,晟田,20,0,20,陽信-石牌,2023-05-25,8711
8105,凌巨,20,0,20,陽信-石牌,2023-05-25,8711
00882,中信中國高股息,109,90,19,陽信-石牌,2023-05-25,8711
00687B,國泰20年美債,19,0,19,陽信-石牌,2023-05-25,8711
2609,陽明,24,5,19,陽信-石牌,2023-05-25,8711
6191,精成科,20,2,18,陽信-石牌,2023-05-25,8711
6274,台燿,21,3,18,陽信-石牌,2023-05-25,8711
00713,元大台灣高息低波,18,0,18,陽信-石牌,2023-05-25,8711
1219,福壽,20,3,17,陽信-石牌,2023-05-25,8711
2885,元大金,25,8,17,陽信-石牌,2023-05-25,8711
1519,華城,19,4,15,陽信-石牌,2023-05-25,8711
1529,樂事綠能,15,0,15,陽信-石牌,2023-05-25,8711
2630,亞航,20,5,15,陽信-石牌,2023-05-25,8711
3032,偉訓,16,1,15,陽信-石牌,2023-05-25,8711
3045,台灣大,16,1,15,陽信-石牌,2023-05-25,8711
1618,合機,34,20,14,陽信-石牌,2023-05-25,8711
00753L,中信中國50正2,14,0,14,陽信-石牌,2023-05-25,8711
3711,日月光投控,14,0,14,陽信-石牌,2023-05-25,8711
5009,榮剛,37,23,14,陽信-石牌,2023-05-25,8711
3017,奇鋐,16,3,13,陽信-石牌,2023-05-25,8711
00712,復華富時不動產,12,0,12,陽信-石牌,2023-05-25,8711
3707,漢磊,13,1,12,陽信-石牌,2023-05-25,8711
4114,健喬,12,0,12,陽信-石牌,2023-05-25,8711
1789,神隆,11,0,11,陽信-石牌,2023-05-25,8711
2009,第一銅,11,0,11,陽信-石牌,2023-05-25,8711
00772B,中信高評級公司債,10,0,10,陽信-石牌,2023-05-25,8711
1584,精剛,15,5,10,陽信-石牌,2023-05-25,8711
2301,光寶科,12,2,10,陽信-石牌,2023-05-25,8711
2393,億光,10,0,10,陽信-石牌,2023-05-25,8711
2349,錸德,250,0,250,陽信-石牌,2023-05-26,8711
6835,圓裕,246,1,245,陽信-石牌,2023-05-26,8711
3481,群創,305,106,199,陽信-石牌,2023-05-26,8711
2491,吉祥全,115,0,115,陽信-石牌,2023-05-26,8711
00676R,富邦臺灣加權反1,90,0,90,陽信-石牌,2023-05-26,8711
00712,復華富時不動產,86,0,86,陽信-石牌,2023-05-26,8711
6414,樺漢,70,0,70,陽信-石牌,2023-05-26,8711
2637,慧洋-KY,58,0,58,陽信-石牌,2023-05-26,8711
2356,英業達,61,5,56,陽信-石牌,2023-05-26,8711
00673R,期元大S＆P原油反1,280,229,51,陽信-石牌,2023-05-26,8711
00753L,中信中國50正2,51,0,51,陽信-石牌,2023-05-26,8711
00713,元大台灣高息低波,45,5,40,陽信-石牌,2023-05-26,8711
4417,金洲,36,0,36,陽信-石牌,2023-05-26,8711
1905,華紙,42,8,34,陽信-石牌,2023-05-26,8711
2453,凌群,62,30,32,陽信-石牌,2023-05-26,8711
1609,大亞,133,102,31,陽信-石牌,2023-05-26,8711
00898,國泰基因免疫革命,30,0,30,陽信-石牌,2023-05-26,8711
2538,基泰,30,0,30,陽信-石牌,2023-05-26,8711
6217,中探針,44,15,29,陽信-石牌,2023-05-26,8711
2801,彰銀,28,0,28,陽信-石牌,2023-05-26,8711
3189,景碩,34,7,27,陽信-石牌,2023-05-26,8711
8358,金居,28,2,26,陽信-石牌,2023-05-26,8711
6136,富爾特,24,0,24,陽信-石牌,2023-05-26,8711
1314,中石化,27,5,22,陽信-石牌,2023-05-26,8711
2442,新美齊,21,0,21,陽信-石牌,2023-05-26,8711
00632R,元大台灣50反1,245,225,20,陽信-石牌,2023-05-26,8711
2022,聚亨,20,0,20,陽信-石牌,2023-05-26,8711
2374,佳能,20,0,20,陽信-石牌,2023-05-26,8711
2380,虹光,20,0,20,陽信-石牌,2023-05-26,8711
2886,兆豐金,20,0,20,陽信-石牌,2023-05-26,8711
3521,鴻翊,20,0,20,陽信-石牌,2023-05-26,8711
6282,康舒,20,0,20,陽信-石牌,2023-05-26,8711
8105,凌巨,20,0,20,陽信-石牌,2023-05-26,8711
00878,國泰永續高股息,36,17,19,陽信-石牌,2023-05-26,8711
6697,東捷資訊,19,0,19,陽信-石牌,2023-05-26,8711
1605,華新,30,12,18,陽信-石牌,2023-05-26,8711
2884,玉山金,16,0,16,陽信-石牌,2023-05-26,8711
1907,永豐餘,16,0,16,陽信-石牌,2023-05-26,8711
2425,承啟,32,16,16,陽信-石牌,2023-05-26,8711
6190,萬泰科,21,5,16,陽信-石牌,2023-05-26,8711
3032,偉訓,16,1,15,陽信-石牌,2023-05-26,8711
3048,益登,15,0,15,陽信-石牌,2023-05-26,8711
1519,華城,19,4,15,陽信-石牌,2023-05-26,8711
1460,宏遠,15,1,14,陽信-石牌,2023-05-26,8711
2883,凱基金,14,0,14,陽信-石牌,2023-05-26,8711
1101,台泥,13,0,13,陽信-石牌,2023-05-26,8711
5469,瀚宇博,13,0,13,陽信-石牌,2023-05-26,8711
2014,中鴻,22,10,12,陽信-石牌,2023-05-26,8711
2031,新光鋼,12,0,12,陽信-石牌,2023-05-26,8711
2376,技嘉,29,17,12,陽信-石牌,2023-05-26,8711
00715L,期街口布蘭特正2,196,5,191,陽信-石牌,2023-05-29,8711
00632R,元大台灣50反1,120,0,120,陽信-石牌,2023-05-29,8711
00640L,富邦日本正2,120,0,120,陽信-石牌,2023-05-29,8711
6789,采鈺,101,2,99,陽信-石牌,2023-05-29,8711
2634,漢翔,82,5,77,陽信-石牌,2023-05-29,8711
00895,富邦未來車,63,4,59,陽信-石牌,2023-05-29,8711
2371,大同,57,1,56,陽信-石牌,2023-05-29,8711
2349,錸德,50,1,49,陽信-石牌,2023-05-29,8711
2449,京元電子,59,12,47,陽信-石牌,2023-05-29,8711
00637L,元大滬深300正2,46,0,46,陽信-石牌,2023-05-29,8711
0056,元大高股息,87,43,44,陽信-石牌,2023-05-29,8711
2538,基泰,42,0,42,陽信-石牌,2023-05-29,8711
6120,達運,40,2,38,陽信-石牌,2023-05-29,8711
2404,漢唐,27,0,27,陽信-石牌,2023-05-29,8711
3037,欣興,51,24,27,陽信-石牌,2023-05-29,8711
3028,增你強,25,0,25,陽信-石牌,2023-05-29,8711
2731,雄獅,24,3,21,陽信-石牌,2023-05-29,8711
00857B,永豐20年美公債,20,0,20,陽信-石牌,2023-05-29,8711
00671R,富邦NASDAQ反1,20,0,20,陽信-石牌,2023-05-29,8711
3033,威健,20,0,20,陽信-石牌,2023-05-29,8711
3520,華盈,20,0,20,陽信-石牌,2023-05-29,8711
4804,大略-KY,20,0,20,陽信-石牌,2023-05-29,8711
4960,誠美材,20,0,20,陽信-石牌,2023-05-29,8711
1101,台泥,19,2,17,陽信-石牌,2023-05-29,8711
00712,復華富時不動產,17,0,17,陽信-石牌,2023-05-29,8711
2457,飛宏,52,35,17,陽信-石牌,2023-05-29,8711
2637,慧洋-KY,17,0,17,陽信-石牌,2023-05-29,8711
1810,和成,17,1,16,陽信-石牌,2023-05-29,8711
5388,中磊,17,1,16,陽信-石牌,2023-05-29,8711
3231,緯創,137,122,15,陽信-石牌,2023-05-29,8711
1514,亞力,17,2,15,陽信-石牌,2023-05-29,8711
3232,昱捷,17,2,15,陽信-石牌,2023-05-29,8711
8054,安國,16,1,15,陽信-石牌,2023-05-29,8711
4971,IET-KY,13,0,13,陽信-石牌,2023-05-29,8711
5608,四維航,13,0,13,陽信-石牌,2023-05-29,8711
6285,啟��,15,2,13,陽信-石牌,2023-05-29,8711
6770,力積電,15,4,11,陽信-石牌,2023-05-29,8711
3711,日月光投控,11,0,11,陽信-石牌,2023-05-29,8711
4153,鈺緯,11,0,11,陽信-石牌,2023-05-29,8711
5481,新華,10,0,10,陽信-石牌,2023-05-29,8711
00690,兆豐藍籌30,10,0,10,陽信-石牌,2023-05-29,8711
2342,茂矽,10,0,10,陽信-石牌,2023-05-29,8711
2383,台光電,14,4,10,陽信-石牌,2023-05-29,8711
3228,金麗科,10,0,10,陽信-石牌,2023-05-29,8711
4417,金洲,10,0,10,陽信-石牌,2023-05-29,8711
6231,系微,10,0,10,陽信-石牌,2023-05-29,8711
2883,凱基金,12,2,10,陽信-石牌,2023-05-29,8711
00687B,國泰20年美債,9,0,9,陽信-石牌,2023-05-29,8711
6188,廣明,13,4,9,陽信-石牌,2023-05-29,8711
6470,宇智,13,4,9,陽信-石牌,2023-05-29,8711
00673R,期元大S＆P原油反1,257,0,257,陽信-石牌,2023-05-30,8711
00632R,元大台灣50反1,220,0,220,陽信-石牌,2023-05-30,8711
2610,華航,209,76,133,陽信-石牌,2023-05-30,8711
6163,華電網,112,6,106,陽信-石牌,2023-05-30,8711
2881,富邦金,100,0,100,陽信-石牌,2023-05-30,8711
00725B,國泰投資級公司債,95,3,92,陽信-石牌,2023-05-30,8711
00637L,元大滬深300正2,77,2,75,陽信-石牌,2023-05-30,8711
6689,伊雲谷,76,4,72,陽信-石牌,2023-05-30,8711
2356,英業達,120,69,51,陽信-石牌,2023-05-30,8711
5310,天剛,50,0,50,陽信-石牌,2023-05-30,8711
6835,圓裕,65,15,50,陽信-石牌,2023-05-30,8711
00882,中信中國高股息,42,0,42,陽信-石牌,2023-05-30,8711
1609,大亞,48,8,40,陽信-石牌,2023-05-30,8711
00878,國泰永續高股息,47,8,39,陽信-石牌,2023-05-30,8711
6026,福邦證,52,20,32,陽信-石牌,2023-05-30,8711
6414,樺漢,32,0,32,陽信-石牌,2023-05-30,8711
2882,國泰金,31,0,31,陽信-石牌,2023-05-30,8711
1218,泰山,30,0,30,陽信-石牌,2023-05-30,8711
2888,新光金,30,0,30,陽信-石牌,2023-05-30,8711
2504,國產,25,0,25,陽信-石牌,2023-05-30,8711
3028,增你強,25,0,25,陽信-石牌,2023-05-30,8711
2618,長榮航,82,61,21,陽信-石牌,2023-05-30,8711
2883,凱基金,21,0,21,陽信-石牌,2023-05-30,8711
3710,連展投控,21,0,21,陽信-石牌,2023-05-30,8711
1789,神隆,20,0,20,陽信-石牌,2023-05-30,8711
2886,兆豐金,20,0,20,陽信-石牌,2023-05-30,8711
3706,神達,27,7,20,陽信-石牌,2023-05-30,8711
4114,健喬,20,0,20,陽信-石牌,2023-05-30,8711
8105,凌巨,20,0,20,陽信-石牌,2023-05-30,8711
1605,華新,24,6,18,陽信-石牌,2023-05-30,8711
2002,中鋼,20,2,18,陽信-石牌,2023-05-30,8711
2637,慧洋-KY,17,0,17,陽信-石牌,2023-05-30,8711
8240,華宏,17,0,17,陽信-石牌,2023-05-30,8711
00679B,元大美債20年,16,0,16,陽信-石牌,2023-05-30,8711
2382,廣達,31,15,16,陽信-石牌,2023-05-30,8711
3704,合勤控,19,4,15,陽信-石牌,2023-05-30,8711
1301,台塑,15,0,15,陽信-石牌,2023-05-30,8711
4971,IET-KY,15,0,15,陽信-石牌,2023-05-30,8711
6288,聯嘉,15,0,15,陽信-石牌,2023-05-30,8711
8150,南茂,16,1,15,陽信-石牌,2023-05-30,8711
2834,臺企銀,13,0,13,陽信-石牌,2023-05-30,8711
6188,廣明,33,20,13,陽信-石牌,2023-05-30,8711
00713,元大台灣高息低波,14,3,11,陽信-石牌,2023-05-30,8711
00650L,復華香港正2,11,0,11,陽信-石牌,2023-05-30,8711
2457,飛宏,40,29,11,陽信-石牌,2023-05-30,8711
3078,僑威,12,1,11,陽信-石牌,2023-05-30,8711
00922,國泰台灣領袖50,11,1,10,陽信-石牌,2023-05-30,8711
00898,國泰基因免疫革命,10,0,10,陽信-石牌,2023-05-30,8711
1432,大魯閣,10,0,10,陽信-石牌,2023-05-30,8711
1474,弘裕,10,0,10,陽信-石牌,2023-05-30,8711
8038,長園科,169,0,169,陽信-石牌,2023-05-31,8711
2349,錸德,140,1,139,陽信-石牌,2023-05-31,8711
00632R,元大台灣50反1,100,0,100,陽信-石牌,2023-05-31,8711
00725B,國泰投資級公司債,100,0,100,陽信-石牌,2023-05-31,8711
00882,中信中國高股息,73,0,73,陽信-石牌,2023-05-31,8711
00637L,元大滬深300正2,59,0,59,陽信-石牌,2023-05-31,8711
8099,大世科,47,4,43,陽信-石牌,2023-05-31,8711
00642U,期元大S＆P石油,41,0,41,陽信-石牌,2023-05-31,8711
6835,圓裕,40,0,40,陽信-石牌,2023-05-31,8711
00687B,國泰20年美債,39,0,39,陽信-石牌,2023-05-31,8711
00715L,期街口布蘭特正2,36,0,36,陽信-石牌,2023-05-31,8711
2515,中工,50,18,32,陽信-石牌,2023-05-31,8711
3264,欣銓,29,0,29,陽信-石牌,2023-05-31,8711
3231,緯創,120,94,26,陽信-石牌,2023-05-31,8711
3252,海灣,25,0,25,陽信-石牌,2023-05-31,8711
3533,嘉澤,24,0,24,陽信-石牌,2023-05-31,8711
6789,采鈺,30,7,23,陽信-石牌,2023-05-31,8711
00878,國泰永續高股息,27,5,22,陽信-石牌,2023-05-31,8711
2382,廣達,37,16,21,陽信-石牌,2023-05-31,8711
3005,神基,20,0,20,陽信-石牌,2023-05-31,8711
4971,IET-KY,19,0,19,陽信-石牌,2023-05-31,8711
6164,華興,16,0,16,陽信-石牌,2023-05-31,8711
00713,元大台灣高息低波,15,0,15,陽信-石牌,2023-05-31,8711
2801,彰銀,15,0,15,陽信-石牌,2023-05-31,8711
4804,大略-KY,15,0,15,陽信-石牌,2023-05-31,8711
1504,東元,15,1,14,陽信-石牌,2023-05-31,8711
2317,鴻海,16,3,13,陽信-石牌,2023-05-31,8711
2465,麗臺,13,0,13,陽信-石牌,2023-05-31,8711
3706,神達,135,123,12,陽信-石牌,2023-05-31,8711
2457,飛宏,74,63,11,陽信-石牌,2023-05-31,8711
1218,泰山,10,0,10,陽信-石牌,2023-05-31,8711
1101,台泥,10,0,10,陽信-石牌,2023-05-31,8711
1789,神隆,10,0,10,陽信-石牌,2023-05-31,8711
2374,佳能,10,0,10,陽信-石牌,2023-05-31,8711
2887,台新金,10,0,10,陽信-石牌,2023-05-31,8711
2892,第一金,10,0,10,陽信-石牌,2023-05-31,8711
4503,金雨,10,0,10,陽信-石牌,2023-05-31,8711
4934,太極,10,0,10,陽信-石牌,2023-05-31,8711
4967,十銓,40,30,10,陽信-石牌,2023-05-31,8711
5481,新華,10,0,10,陽信-石牌,2023-05-31,8711
6150,撼訊,11,1,10,陽信-石牌,2023-05-31,8711
3037,欣興,10,1,9,陽信-石牌,2023-05-31,8711
2530,華建,9,0,9,陽信-石牌,2023-05-31,8711
2637,慧洋-KY,9,0,9,陽信-石牌,2023-05-31,8711
6285,啟��,11,2,9,陽信-石牌,2023-05-31,8711
9933,中鼎,9,0,9,陽信-石牌,2023-05-31,8711
2371,大同,18,10,8,陽信-石牌,2023-05-31,8711
0056,元大高股息,8,0,8,陽信-石牌,2023-05-31,8711
00665L,富邦�琤肭磪囓�2,43,35,8,陽信-石牌,2023-05-31,8711
2201,裕隆,62,54,8,陽信-石牌,2023-05-31,8711
8038,長園科,140,0,140,陽信-石牌,2023-06-01,8711
2303,聯電,125,9,116,陽信-石牌,2023-06-01,8711
1609,大亞,134,23,111,陽信-石牌,2023-06-01,8711
2881,富邦金,90,0,90,陽信-石牌,2023-06-01,8711
00919,群益台灣精選高息,62,0,62,陽信-石牌,2023-06-01,8711
4952,凌通,60,0,60,陽信-石牌,2023-06-01,8711
00679B,元大美債20年,51,0,51,陽信-石牌,2023-06-01,8711
00895,富邦未來車,50,0,50,陽信-石牌,2023-06-01,8711
00632R,元大台灣50反1,50,0,50,陽信-石牌,2023-06-01,8711
1605,華新,67,25,42,陽信-石牌,2023-06-01,8711
00665L,富邦�琤肭磪囓�2,78,40,38,陽信-石牌,2023-06-01,8711
00715L,期街口布蘭特正2,38,0,38,陽信-石牌,2023-06-01,8711
2489,瑞軒,48,14,34,陽信-石牌,2023-06-01,8711
2002,中鋼,42,9,33,陽信-石牌,2023-06-01,8711
2349,錸德,40,10,30,陽信-石牌,2023-06-01,8711
6414,樺漢,30,1,29,陽信-石牌,2023-06-01,8711
00882,中信中國高股息,28,0,28,陽信-石牌,2023-06-01,8711
6188,廣明,102,77,25,陽信-石牌,2023-06-01,8711
2323,中環,71,47,24,陽信-石牌,2023-06-01,8711
6712,長聖,24,0,24,陽信-石牌,2023-06-01,8711
2630,亞航,26,4,22,陽信-石牌,2023-06-01,8711
00642U,期元大S＆P石油,21,0,21,陽信-石牌,2023-06-01,8711
5876,上海商銀,21,0,21,陽信-石牌,2023-06-01,8711
2022,聚亨,20,0,20,陽信-石牌,2023-06-01,8711
2719,燦星旅,20,0,20,陽信-石牌,2023-06-01,8711
2748,雲品,22,2,20,陽信-石牌,2023-06-01,8711
2882,國泰金,21,1,20,陽信-石牌,2023-06-01,8711
2886,兆豐金,20,0,20,陽信-石牌,2023-06-01,8711
8011,台通,20,0,20,陽信-石牌,2023-06-01,8711
3406,玉晶光,40,21,19,陽信-石牌,2023-06-01,8711
6770,力積電,21,2,19,陽信-石牌,2023-06-01,8711
00878,國泰永續高股息,18,0,18,陽信-石牌,2023-06-01,8711
2027,大成鋼,18,0,18,陽信-石牌,2023-06-01,8711
2888,新光金,15,0,15,陽信-石牌,2023-06-01,8711
0056,元大高股息,16,1,15,陽信-石牌,2023-06-01,8711
6196,帆宣,15,0,15,陽信-石牌,2023-06-01,8711
6538,倉和,15,0,15,陽信-石牌,2023-06-01,8711
8358,金居,15,1,14,陽信-石牌,2023-06-01,8711
2206,三陽工業,58,45,13,陽信-石牌,2023-06-01,8711
00640L,富邦日本正2,10,0,10,陽信-石牌,2023-06-01,8711
00671R,富邦NASDAQ反1,10,0,10,陽信-石牌,2023-06-01,8711
00898,國泰基因免疫革命,10,0,10,陽信-石牌,2023-06-01,8711
1445,大宇,10,0,10,陽信-石牌,2023-06-01,8711
2454,聯發科,10,0,10,陽信-石牌,2023-06-01,8711
2745,五福,10,0,10,陽信-石牌,2023-06-01,8711
2845,遠東銀,10,0,10,陽信-石牌,2023-06-01,8711
2891,中信金,10,0,10,陽信-石牌,2023-06-01,8711
3041,揚智,10,0,10,陽信-石牌,2023-06-01,8711
5351,鈺創,19,9,10,陽信-石牌,2023-06-01,8711
2614,東森,9,0,9,陽信-石牌,2023-06-01,8711
00632R,元大台灣50反1,425,5,420,陽信-石牌,2023-06-02,8711
00673R,期元大S＆P原油反1,267,0,267,陽信-石牌,2023-06-02,8711
2610,華航,292,65,227,陽信-石牌,2023-06-02,8711
5478,智冠,140,2,138,陽信-石牌,2023-06-02,8711
2349,錸德,130,1,129,陽信-石牌,2023-06-02,8711
2618,長榮航,196,83,113,陽信-石牌,2023-06-02,8711
6835,圓裕,101,0,101,陽信-石牌,2023-06-02,8711
00725B,國泰投資級公司債,70,0,70,陽信-石牌,2023-06-02,8711
1504,東元,71,6,65,陽信-石牌,2023-06-02,8711
00895,富邦未來車,53,0,53,陽信-石牌,2023-06-02,8711
00882,中信中國高股息,53,1,52,陽信-石牌,2023-06-02,8711
5876,上海商銀,45,0,45,陽信-石牌,2023-06-02,8711
00919,群益台灣精選高息,38,0,38,陽信-石牌,2023-06-02,8711
00902,中信電池及儲能,30,0,30,陽信-石牌,2023-06-02,8711
00713,元大台灣高息低波,29,0,29,陽信-石牌,2023-06-02,8711
3003,健和興,145,118,27,陽信-石牌,2023-06-02,8711
2371,大同,30,6,24,陽信-石牌,2023-06-02,8711
3163,波若威,25,2,23,陽信-石牌,2023-06-02,8711
3706,神達,58,35,23,陽信-石牌,2023-06-02,8711
6279,胡連,21,0,21,陽信-石牌,2023-06-02,8711
2457,飛宏,73,53,20,陽信-石牌,2023-06-02,8711
2884,玉山金,20,0,20,陽信-石牌,2023-06-02,8711
3058,立德,20,0,20,陽信-石牌,2023-06-02,8711
6189,豐藝,20,0,20,陽信-石牌,2023-06-02,8711
6161,捷波,24,5,19,陽信-石牌,2023-06-02,8711
3406,玉晶光,30,11,19,陽信-石牌,2023-06-02,8711
5243,乙盛-KY,19,1,18,陽信-石牌,2023-06-02,8711
1218,泰山,17,0,17,陽信-石牌,2023-06-02,8711
1904,正隆,15,0,15,陽信-石牌,2023-06-02,8711
2421,建準,47,32,15,陽信-石牌,2023-06-02,8711
2732,六角,15,0,15,陽信-石牌,2023-06-02,8711
3583,辛耘,39,25,14,陽信-石牌,2023-06-02,8711
8099,大世科,17,3,14,陽信-石牌,2023-06-02,8711
2331,精英,32,19,13,陽信-石牌,2023-06-02,8711
00687B,國泰20年美債,12,0,12,陽信-石牌,2023-06-02,8711
2328,廣宇,11,0,11,陽信-石牌,2023-06-02,8711
2492,華新科,11,0,11,陽信-石牌,2023-06-02,8711
3042,晶技,11,0,11,陽信-石牌,2023-06-02,8711
3617,碩天,12,1,11,陽信-石牌,2023-06-02,8711
1513,中興電,47,37,10,陽信-石牌,2023-06-02,8711
1612,宏泰,10,0,10,陽信-石牌,2023-06-02,8711
1314,中石化,10,0,10,陽信-石牌,2023-06-02,8711
00634R,富邦上証反1,10,0,10,陽信-石牌,2023-06-02,8711
2444,兆勁,10,0,10,陽信-石牌,2023-06-02,8711
2745,五福,10,0,10,陽信-石牌,2023-06-02,8711
3520,華盈,10,0,10,陽信-石牌,2023-06-02,8711
5481,新華,10,0,10,陽信-石牌,2023-06-02,8711
8440,綠電,11,1,10,陽信-石牌,2023-06-02,8711
9919,康那香,10,0,10,陽信-石牌,2023-06-02,8711
6531,愛普*,14,4,10,陽信-石牌,2023-06-02,8711
00715L,期街口布蘭特正2,206,50,156,陽信-石牌,2023-06-05,8711
2603,長榮,136,24,112,陽信-石牌,2023-06-05,8711
5425,台半,112,3,109,陽信-石牌,2023-06-05,8711
6174,安��,90,0,90,陽信-石牌,2023-06-05,8711
3045,台灣大,86,0,86,陽信-石牌,2023-06-05,8711
3541,西柏,80,0,80,陽信-石牌,2023-06-05,8711
00633L,富邦上証正2,77,1,76,陽信-石牌,2023-06-05,8711
6789,采鈺,101,28,73,陽信-石牌,2023-06-05,8711
1584,精剛,89,20,69,陽信-石牌,2023-06-05,8711
1806,冠軍,56,0,56,陽信-石牌,2023-06-05,8711
2303,聯電,59,3,56,陽信-石牌,2023-06-05,8711
00878,國泰永續高股息,49,3,46,陽信-石牌,2023-06-05,8711
1611,中電,44,0,44,陽信-石牌,2023-06-05,8711
6282,康舒,87,45,42,陽信-石牌,2023-06-05,8711
00713,元大台灣高息低波,62,23,39,陽信-石牌,2023-06-05,8711
00919,群益台灣精選高息,38,0,38,陽信-石牌,2023-06-05,8711
2515,中工,53,16,37,陽信-石牌,2023-06-05,8711
5478,智冠,113,76,37,陽信-石牌,2023-06-05,8711
00882,中信中國高股息,32,0,32,陽信-石牌,2023-06-05,8711
5243,乙盛-KY,36,4,32,陽信-石牌,2023-06-05,8711
2812,台中銀,60,30,30,陽信-石牌,2023-06-05,8711
3081,聯亞,30,1,29,陽信-石牌,2023-06-05,8711
8099,大世科,44,15,29,陽信-石牌,2023-06-05,8711
0056,元大高股息,37,10,27,陽信-石牌,2023-06-05,8711
4971,IET-KY,26,0,26,陽信-石牌,2023-06-05,8711
6160,欣技,30,5,25,陽信-石牌,2023-06-05,8711
1513,中興電,30,7,23,陽信-石牌,2023-06-05,8711
3162,精確,25,3,22,陽信-石牌,2023-06-05,8711
4804,大略-KY,22,0,22,陽信-石牌,2023-06-05,8711
3231,緯創,85,64,21,陽信-石牌,2023-06-05,8711
3711,日月光投控,20,0,20,陽信-石牌,2023-06-05,8711
2317,鴻海,22,3,19,陽信-石牌,2023-06-05,8711
2344,華邦電,25,6,19,陽信-石牌,2023-06-05,8711
1514,亞力,26,8,18,陽信-石牌,2023-06-05,8711
2014,中鴻,29,13,16,陽信-石牌,2023-06-05,8711
00637L,元大滬深300正2,28,13,15,陽信-石牌,2023-06-05,8711
2444,兆勁,15,0,15,陽信-石牌,2023-06-05,8711
3362,先進光,15,0,15,陽信-石牌,2023-06-05,8711
5464,霖宏,14,0,14,陽信-石牌,2023-06-05,8711
2606,裕民,17,4,13,陽信-石牌,2023-06-05,8711
1519,華城,23,11,12,陽信-石牌,2023-06-05,8711
3380,明泰,11,0,11,陽信-石牌,2023-06-05,8711
6112,邁達特,13,2,11,陽信-石牌,2023-06-05,8711
6279,胡連,11,0,11,陽信-石牌,2023-06-05,8711
8215,明基材,11,0,11,陽信-石牌,2023-06-05,8711
1101,台泥,15,5,10,陽信-石牌,2023-06-05,8711
1714,和桐,30,20,10,陽信-石牌,2023-06-05,8711
2337,旺宏,10,0,10,陽信-石牌,2023-06-05,8711
2353,宏��,29,19,10,陽信-石牌,2023-06-05,8711
2904,匯僑,10,0,10,陽信-石牌,2023-06-05,8711
00673R,期元大S＆P原油反1,272,0,272,陽信-石牌,2023-06-06,8711
00795B,中信美國公債20年,103,0,103,陽信-石牌,2023-06-06,8711
3055,蔚華科,90,0,90,陽信-石牌,2023-06-06,8711
2362,藍天,80,5,75,陽信-石牌,2023-06-06,8711
00919,群益台灣精選高息,58,0,58,陽信-石牌,2023-06-06,8711
00927,群益半導體收益,54,0,54,陽信-石牌,2023-06-06,8711
3707,漢磊,51,0,51,陽信-石牌,2023-06-06,8711
2504,國產,40,0,40,陽信-石牌,2023-06-06,8711
00878,國泰永續高股息,48,10,38,陽信-石牌,2023-06-06,8711
6789,采鈺,60,25,35,陽信-石牌,2023-06-06,8711
2402,毅嘉,58,24,34,陽信-石牌,2023-06-06,8711
5474,聰泰,34,0,34,陽信-石牌,2023-06-06,8711
3406,玉晶光,41,10,31,陽信-石牌,2023-06-06,8711
3058,立德,33,3,30,陽信-石牌,2023-06-06,8711
1810,和成,110,84,26,陽信-石牌,2023-06-06,8711
1907,永豐餘,30,4,26,陽信-石牌,2023-06-06,8711
2888,新光金,35,10,25,陽信-石牌,2023-06-06,8711
4906,正文,21,0,21,陽信-石牌,2023-06-06,8711
00679B,元大美債20年,21,1,20,陽信-石牌,2023-06-06,8711
2022,聚亨,20,0,20,陽信-石牌,2023-06-06,8711
2706,第一店,25,5,20,陽信-石牌,2023-06-06,8711
3508,位速,20,0,20,陽信-石牌,2023-06-06,8711
2014,中鴻,20,1,19,陽信-石牌,2023-06-06,8711
2498,宏達電,24,5,19,陽信-石牌,2023-06-06,8711
2368,金像電,19,1,18,陽信-石牌,2023-06-06,8711
3042,晶技,18,1,17,陽信-石牌,2023-06-06,8711
8085,福華,17,0,17,陽信-石牌,2023-06-06,8711
1218,泰山,17,1,16,陽信-石牌,2023-06-06,8711
2303,聯電,17,1,16,陽信-石牌,2023-06-06,8711
2421,建準,16,0,16,陽信-石牌,2023-06-06,8711
4971,IET-KY,16,0,16,陽信-石牌,2023-06-06,8711
5243,乙盛-KY,18,2,16,陽信-石牌,2023-06-06,8711
2206,三陽工業,93,78,15,陽信-石牌,2023-06-06,8711
2301,光寶科,15,0,15,陽信-石牌,2023-06-06,8711
2312,金寶,15,0,15,陽信-石牌,2023-06-06,8711
2427,三商電,14,0,14,陽信-石牌,2023-06-06,8711
2492,華新科,15,1,14,陽信-石牌,2023-06-06,8711
2634,漢翔,58,44,14,陽信-石牌,2023-06-06,8711
1513,中興電,19,5,14,陽信-石牌,2023-06-06,8711
2454,聯發科,16,3,13,陽信-石牌,2023-06-06,8711
4123,晟德,13,0,13,陽信-石牌,2023-06-06,8711
6163,華電網,18,6,12,陽信-石牌,2023-06-06,8711
3346,麗清,15,4,11,陽信-石牌,2023-06-06,8711
00632R,元大台灣50反1,50,40,10,陽信-石牌,2023-06-06,8711
00713,元大台灣高息低波,10,0,10,陽信-石牌,2023-06-06,8711
1514,亞力,17,7,10,陽信-石牌,2023-06-06,8711
1457,宜進,10,0,10,陽信-石牌,2023-06-06,8711
1326,台化,10,0,10,陽信-石牌,2023-06-06,8711
2027,大成鋼,13,3,10,陽信-石牌,2023-06-06,8711
6134,萬旭,10,0,10,陽信-石牌,2023-06-06,8711
00715L,期街口布蘭特正2,202,0,202,陽信-石牌,2023-06-07,8711
00632R,元大台灣50反1,170,0,170,陽信-石牌,2023-06-07,8711
6166,凌華,155,0,155,陽信-石牌,2023-06-07,8711
5222,全訊,89,0,89,陽信-石牌,2023-06-07,8711
3045,台灣大,65,1,64,陽信-石牌,2023-06-07,8711
2382,廣達,76,13,63,陽信-石牌,2023-06-07,8711
1402,遠東新,50,0,50,陽信-石牌,2023-06-07,8711
00795B,中信美國公債20年,41,0,41,陽信-石牌,2023-06-07,8711
00882,中信中國高股息,40,0,40,陽信-石牌,2023-06-07,8711
2402,毅嘉,37,1,36,陽信-石牌,2023-06-07,8711
00919,群益台灣精選高息,35,0,35,陽信-石牌,2023-06-07,8711
4543,萬在,29,1,28,陽信-石牌,2023-06-07,8711
8099,大世科,27,0,27,陽信-石牌,2023-06-07,8711
1444,力麗,25,0,25,陽信-石牌,2023-06-07,8711
1605,華新,34,9,25,陽信-石牌,2023-06-07,8711
2301,光寶科,26,1,25,陽信-石牌,2023-06-07,8711
6274,台燿,28,3,25,陽信-石牌,2023-06-07,8711
3055,蔚華科,75,51,24,陽信-石牌,2023-06-07,8711
4746,台耀,28,4,24,陽信-石牌,2023-06-07,8711
4161,聿新科,23,0,23,陽信-石牌,2023-06-07,8711
2618,長榮航,101,79,22,陽信-石牌,2023-06-07,8711
2022,聚亨,20,0,20,陽信-石牌,2023-06-07,8711
2515,中工,40,20,20,陽信-石牌,2023-06-07,8711
2211,長榮鋼,20,1,19,陽信-石牌,2023-06-07,8711
5478,智冠,20,1,19,陽信-石牌,2023-06-07,8711
1903,士紙,36,19,17,陽信-石牌,2023-06-07,8711
8105,凌巨,20,4,16,陽信-石牌,2023-06-07,8711
2344,華邦電,18,3,15,陽信-石牌,2023-06-07,8711
5210,寶碩,15,0,15,陽信-石牌,2023-06-07,8711
1591,駿吉-KY,13,0,13,陽信-石牌,2023-06-07,8711
6112,邁達特,13,0,13,陽信-石牌,2023-06-07,8711
3558,神準,11,0,11,陽信-石牌,2023-06-07,8711
1584,精剛,21,10,11,陽信-石牌,2023-06-07,8711
2409,友達,11,0,11,陽信-石牌,2023-06-07,8711
2883,凱基金,11,0,11,陽信-石牌,2023-06-07,8711
3027,盛達,116,105,11,陽信-石牌,2023-06-07,8711
3711,日月光投控,38,27,11,陽信-石牌,2023-06-07,8711
8234,新漢,11,0,11,陽信-石牌,2023-06-07,8711
1532,勤美,10,0,10,陽信-石牌,2023-06-07,8711
2610,華航,31,21,10,陽信-石牌,2023-06-07,8711
3037,欣興,13,3,10,陽信-石牌,2023-06-07,8711
3207,耀勝,10,0,10,陽信-石牌,2023-06-07,8711
6189,豐藝,10,0,10,陽信-石牌,2023-06-07,8711
5474,聰泰,23,14,9,陽信-石牌,2023-06-07,8711
1608,華榮,22,14,8,陽信-石牌,2023-06-07,8711
6143,振曜,8,0,8,陽信-石牌,2023-06-07,8711
6223,旺矽,13,5,8,陽信-石牌,2023-06-07,8711
00679B,元大美債20年,7,0,7,陽信-石牌,2023-06-07,8711
2313,華通,7,0,7,陽信-石牌,2023-06-07,8711
3673,TPK-KY,13,6,7,陽信-石牌,2023-06-07,8711
2881,富邦金,142,0,142,陽信-石牌,2023-06-08,8711
2504,國產,100,0,100,陽信-石牌,2023-06-08,8711
00878,國泰永續高股息,85,10,75,陽信-石牌,2023-06-08,8711
00795B,中信美國公債20年,73,0,73,陽信-石牌,2023-06-08,8711
4930,燦星網,71,1,70,陽信-石牌,2023-06-08,8711
0056,元大高股息,71,12,59,陽信-石牌,2023-06-08,8711
00919,群益台灣精選高息,58,2,56,陽信-石牌,2023-06-08,8711
6189,豐藝,54,0,54,陽信-石牌,2023-06-08,8711
2402,毅嘉,63,15,48,陽信-石牌,2023-06-08,8711
1605,華新,57,12,45,陽信-石牌,2023-06-08,8711
00679B,元大美債20年,55,13,42,陽信-石牌,2023-06-08,8711
1515,力山,40,0,40,陽信-石牌,2023-06-08,8711
00687B,國泰20年美債,38,0,38,陽信-石牌,2023-06-08,8711
8403,盛弘,37,0,37,陽信-石牌,2023-06-08,8711
1524,耿鼎,36,1,35,陽信-石牌,2023-06-08,8711
1609,大亞,90,55,35,陽信-石牌,2023-06-08,8711
1612,宏泰,38,6,32,陽信-石牌,2023-06-08,8711
1444,力麗,31,0,31,陽信-石牌,2023-06-08,8711
3056,富華新,30,0,30,陽信-石牌,2023-06-08,8711
2457,飛宏,46,17,29,陽信-石牌,2023-06-08,8711
2303,聯電,41,13,28,陽信-石牌,2023-06-08,8711
2882,國泰金,27,0,27,陽信-石牌,2023-06-08,8711
2382,廣達,61,35,26,陽信-石牌,2023-06-08,8711
2427,三商電,26,0,26,陽信-石牌,2023-06-08,8711
2409,友達,24,0,24,陽信-石牌,2023-06-08,8711
6243,迅杰,27,3,24,陽信-石牌,2023-06-08,8711
00927,群益半導體收益,23,0,23,陽信-石牌,2023-06-08,8711
2317,鴻海,30,7,23,陽信-石牌,2023-06-08,8711
1504,東元,23,2,21,陽信-石牌,2023-06-08,8711
2022,聚亨,21,0,21,陽信-石牌,2023-06-08,8711
00641R,富邦日本反1,20,0,20,陽信-石牌,2023-06-08,8711
4960,誠美材,20,0,20,陽信-石牌,2023-06-08,8711
00713,元大台灣高息低波,19,0,19,陽信-石牌,2023-06-08,8711
8905,裕國,21,2,19,陽信-石牌,2023-06-08,8711
00751B,元大AAA至A公司債,17,0,17,陽信-石牌,2023-06-08,8711
2492,華新科,18,1,17,陽信-石牌,2023-06-08,8711
3025,星通,16,0,16,陽信-石牌,2023-06-08,8711
6282,康舒,19,3,16,陽信-石牌,2023-06-08,8711
2323,中環,20,5,15,陽信-石牌,2023-06-08,8711
6125,廣運,63,49,14,陽信-石牌,2023-06-08,8711
3006,晶豪科,12,0,12,陽信-石牌,2023-06-08,8711
4746,台耀,22,10,12,陽信-石牌,2023-06-08,8711
2330,台積電,12,1,11,陽信-石牌,2023-06-08,8711
2388,威盛,43,32,11,陽信-石牌,2023-06-08,8711
3533,嘉澤,11,0,11,陽信-石牌,2023-06-08,8711
8034,榮群,11,0,11,陽信-石牌,2023-06-08,8711
00632R,元大台灣50反1,110,100,10,陽信-石牌,2023-06-08,8711
00772B,中信高評級公司債,10,0,10,陽信-石牌,2023-06-08,8711
00720B,元大投資級公司債,10,0,10,陽信-石牌,2023-06-08,8711
1460,宏遠,10,0,10,陽信-石牌,2023-06-08,8711
00715L,期街口布蘭特正2,213,50,163,陽信-石牌,2023-06-09,8711
00929,復華台灣科技優息,79,0,79,陽信-石牌,2023-06-09,8711
4930,燦星網,60,0,60,陽信-石牌,2023-06-09,8711
2610,華航,60,1,59,陽信-石牌,2023-06-09,8711
00632R,元大台灣50反1,50,0,50,陽信-石牌,2023-06-09,8711
6245,立端,42,0,42,陽信-石牌,2023-06-09,8711
6244,茂迪,40,0,40,陽信-石牌,2023-06-09,8711
6274,台燿,40,4,36,陽信-石牌,2023-06-09,8711
2102,泰豐,35,0,35,陽信-石牌,2023-06-09,8711
6288,聯嘉,30,1,29,陽信-石牌,2023-06-09,8711
2356,英業達,72,45,27,陽信-石牌,2023-06-09,8711
00642U,期元大S＆P石油,27,1,26,陽信-石牌,2023-06-09,8711
2211,長榮鋼,25,0,25,陽信-石牌,2023-06-09,8711
2504,國產,25,0,25,陽信-石牌,2023-06-09,8711
2618,長榮航,72,47,25,陽信-石牌,2023-06-09,8711
5009,榮剛,22,0,22,陽信-石牌,2023-06-09,8711
5876,上海商銀,20,0,20,陽信-石牌,2023-06-09,8711
1802,台玻,21,2,19,陽信-石牌,2023-06-09,8711
2454,聯發科,20,1,19,陽信-石牌,2023-06-09,8711
2027,大成鋼,20,3,17,陽信-石牌,2023-06-09,8711
8069,元太,20,3,17,陽信-石牌,2023-06-09,8711
4543,萬在,17,1,16,陽信-石牌,2023-06-09,8711
2634,漢翔,24,8,16,陽信-石牌,2023-06-09,8711
1815,富喬,17,2,15,陽信-石牌,2023-06-09,8711
2302,麗正,15,0,15,陽信-石牌,2023-06-09,8711
2388,威盛,48,33,15,陽信-石牌,2023-06-09,8711
2887,台新金,20,5,15,陽信-石牌,2023-06-09,8711
6532,瑞耘,16,1,15,陽信-石牌,2023-06-09,8711
8210,勤誠,17,3,14,陽信-石牌,2023-06-09,8711
1810,和成,21,8,13,陽信-石牌,2023-06-09,8711
2383,台光電,20,7,13,陽信-石牌,2023-06-09,8711
2882,國泰金,13,0,13,陽信-石牌,2023-06-09,8711
5478,智冠,13,0,13,陽信-石牌,2023-06-09,8711
6835,圓裕,15,3,12,陽信-石牌,2023-06-09,8711
8171,天宇,13,1,12,陽信-石牌,2023-06-09,8711
1533,車王電,16,4,12,陽信-石牌,2023-06-09,8711
1314,中石化,12,1,11,陽信-石牌,2023-06-09,8711
2888,新光金,19,8,11,陽信-石牌,2023-06-09,8711
5243,乙盛-KY,12,1,11,陽信-石牌,2023-06-09,8711
6188,廣明,12,1,11,陽信-石牌,2023-06-09,8711
8215,明基材,11,0,11,陽信-石牌,2023-06-09,8711
3558,神準,13,3,10,陽信-石牌,2023-06-09,8711
3617,碩天,11,1,10,陽信-石牌,2023-06-09,8711
1432,大魯閣,12,2,10,陽信-石牌,2023-06-09,8711
00679B,元大美債20年,10,0,10,陽信-石牌,2023-06-09,8711
2243,宏旭-KY,10,0,10,陽信-石牌,2023-06-09,8711
2812,台中銀,10,0,10,陽信-石牌,2023-06-09,8711
2883B,凱基金乙特,10,0,10,陽信-石牌,2023-06-09,8711
2906,高林,10,0,10,陽信-石牌,2023-06-09,8711
3017,奇鋐,15,5,10,陽信-石牌,2023-06-09,8711
2382,廣達,235,33,202,陽信-石牌,2023-06-12,8711
3035,智原,202,1,201,陽信-石牌,2023-06-12,8711
3673,TPK-KY,110,3,107,陽信-石牌,2023-06-12,8711
00713,元大台灣高息低波,90,0,90,陽信-石牌,2023-06-12,8711
2888,新光金,90,11,79,陽信-石牌,2023-06-12,8711
2881,富邦金,78,1,77,陽信-石牌,2023-06-12,8711
4961,天鈺,65,3,62,陽信-石牌,2023-06-12,8711
2618,長榮航,93,33,60,陽信-石牌,2023-06-12,8711
00878,國泰永續高股息,80,25,55,陽信-石牌,2023-06-12,8711
00919,群益台灣精選高息,55,0,55,陽信-石牌,2023-06-12,8711
1603,華電,55,0,55,陽信-石牌,2023-06-12,8711
2891,中信金,86,31,55,陽信-石牌,2023-06-12,8711
3521,鴻翊,51,0,51,陽信-石牌,2023-06-12,8711
2610,華航,58,8,50,陽信-石牌,2023-06-12,8711
6244,茂迪,60,10,50,陽信-石牌,2023-06-12,8711
2504,國產,50,2,48,陽信-石牌,2023-06-12,8711
2211,長榮鋼,40,0,40,陽信-石牌,2023-06-12,8711
2405,輔信,36,0,36,陽信-石牌,2023-06-12,8711
8099,大世科,35,0,35,陽信-石牌,2023-06-12,8711
9944,新麗,33,0,33,陽信-石牌,2023-06-12,8711
00642U,期元大S＆P石油,30,0,30,陽信-石牌,2023-06-12,8711
3231,緯創,79,50,29,陽信-石牌,2023-06-12,8711
00929,復華台灣科技優息,32,5,27,陽信-石牌,2023-06-12,8711
4930,燦星網,27,2,25,陽信-石牌,2023-06-12,8711
5469,瀚宇博,27,2,25,陽信-石牌,2023-06-12,8711
8210,勤誠,31,7,24,陽信-石牌,2023-06-12,8711
00715L,期街口布蘭特正2,22,0,22,陽信-石牌,2023-06-12,8711
3149,正達,20,0,20,陽信-石牌,2023-06-12,8711
8222,寶一,20,0,20,陽信-石牌,2023-06-12,8711
4968,立積,21,2,19,陽信-石牌,2023-06-12,8711
1762,中化生,18,0,18,陽信-石牌,2023-06-12,8711
6443,元晶,19,1,18,陽信-石牌,2023-06-12,8711
1905,華紙,15,0,15,陽信-石牌,2023-06-12,8711
5905,南仁湖,15,0,15,陽信-石牌,2023-06-12,8711
5381,合正,14,0,14,陽信-石牌,2023-06-12,8711
2731,雄獅,19,6,13,陽信-石牌,2023-06-12,8711
6163,華電網,29,16,13,陽信-石牌,2023-06-12,8711
6689,伊雲谷,15,2,13,陽信-石牌,2023-06-12,8711
1513,中興電,20,8,12,陽信-石牌,2023-06-12,8711
4161,聿新科,14,2,12,陽信-石牌,2023-06-12,8711
1810,和成,12,1,11,陽信-石牌,2023-06-12,8711
2356,英業達,39,28,11,陽信-石牌,2023-06-12,8711
3630,新鉅科,11,0,11,陽信-石牌,2023-06-12,8711
6101,寬魚國際,11,0,11,陽信-石牌,2023-06-12,8711
1474,弘裕,10,0,10,陽信-石牌,2023-06-12,8711
1460,宏遠,10,0,10,陽信-石牌,2023-06-12,8711
1605,華新,10,0,10,陽信-石牌,2023-06-12,8711
2495,普安,10,0,10,陽信-石牌,2023-06-12,8711
3374,精材,16,6,10,陽信-石牌,2023-06-12,8711
4903,聯光通,10,0,10,陽信-石牌,2023-06-12,8711
00632R,元大台灣50反1,410,10,400,陽信-石牌,2023-06-13,8711
00919,群益台灣精選高息,146,0,146,陽信-石牌,2023-06-13,8711
2888,新光金,127,6,121,陽信-石牌,2023-06-13,8711
3413,京鼎,100,0,100,陽信-石牌,2023-06-13,8711
3673,TPK-KY,90,0,90,陽信-石牌,2023-06-13,8711
00715L,期街口布蘭特正2,80,0,80,陽信-石牌,2023-06-13,8711
00671R,富邦NASDAQ反1,80,0,80,陽信-石牌,2023-06-13,8711
1603,華電,79,0,79,陽信-石牌,2023-06-13,8711
2421,建準,71,11,60,陽信-石牌,2023-06-13,8711
3481,群創,66,11,55,陽信-石牌,2023-06-13,8711
2881,富邦金,56,3,53,陽信-石牌,2023-06-13,8711
3557,嘉威,50,0,50,陽信-石牌,2023-06-13,8711
6125,廣運,73,28,45,陽信-石牌,2023-06-13,8711
8261,富鼎,44,0,44,陽信-石牌,2023-06-13,8711
00642U,期元大S＆P石油,38,0,38,陽信-石牌,2023-06-13,8711
4533,協易機,40,11,29,陽信-石牌,2023-06-13,8711
1605,華新,34,6,28,陽信-石牌,2023-06-13,8711
2206,三陽工業,55,30,25,陽信-石牌,2023-06-13,8711
2211,長榮鋼,25,0,25,陽信-石牌,2023-06-13,8711
2504,國產,25,0,25,陽信-石牌,2023-06-13,8711
3521,鴻翊,25,0,25,陽信-石牌,2023-06-13,8711
0056,元大高股息,34,11,23,陽信-石牌,2023-06-13,8711
2009,第一銅,23,0,23,陽信-石牌,2023-06-13,8711
00664R,國泰臺灣加權反1,20,0,20,陽信-石牌,2023-06-13,8711
1528,恩德,20,0,20,陽信-石牌,2023-06-13,8711
2380,虹光,20,0,20,陽信-石牌,2023-06-13,8711
8096,擎亞,20,0,20,陽信-石牌,2023-06-13,8711
2607,榮運,19,0,19,陽信-石牌,2023-06-13,8711
1218,泰山,17,0,17,陽信-石牌,2023-06-13,8711
2515,中工,16,0,16,陽信-石牌,2023-06-13,8711
8033,雷虎,16,0,16,陽信-石牌,2023-06-13,8711
2705,六福,20,5,15,陽信-石牌,2023-06-13,8711
5386,青雲,16,1,15,陽信-石牌,2023-06-13,8711
2402,毅嘉,14,0,14,陽信-石牌,2023-06-13,8711
6689,伊雲谷,16,2,14,陽信-石牌,2023-06-13,8711
1785,光洋科,41,28,13,陽信-石牌,2023-06-13,8711
1907,永豐餘,15,2,13,陽信-石牌,2023-06-13,8711
3033,威健,13,0,13,陽信-石牌,2023-06-13,8711
3706,神達,28,15,13,陽信-石牌,2023-06-13,8711
5258,虹堡,35,22,13,陽信-石牌,2023-06-13,8711
2371,大同,15,3,12,陽信-石牌,2023-06-13,8711
5464,霖宏,12,0,12,陽信-石牌,2023-06-13,8711
00929,復華台灣科技優息,13,2,11,陽信-石牌,2023-06-13,8711
1727,中華化,11,0,11,陽信-石牌,2023-06-13,8711
2305,全友,11,0,11,陽信-石牌,2023-06-13,8711
2409,友達,11,0,11,陽信-石牌,2023-06-13,8711
2637,慧洋-KY,11,0,11,陽信-石牌,2023-06-13,8711
3689,湧德,11,0,11,陽信-石牌,2023-06-13,8711
020034,元大IC設計N,10,0,10,陽信-石牌,2023-06-13,8711
1471,首利,10,0,10,陽信-石牌,2023-06-13,8711
00919,群益台灣精選高息,546,0,546,陽信-石牌,2023-06-14,8711
3265,台星科,315,4,311,陽信-石牌,2023-06-14,8711
2888,新光金,129,0,129,陽信-石牌,2023-06-14,8711
00687B,國泰20年美債,123,0,123,陽信-石牌,2023-06-14,8711
8261,富鼎,122,1,121,陽信-石牌,2023-06-14,8711
3019,亞光,115,1,114,陽信-石牌,2023-06-14,8711
00712,復華富時不動產,113,2,111,陽信-石牌,2023-06-14,8711
00632R,元大台灣50反1,110,0,110,陽信-石牌,2023-06-14,8711
4961,天鈺,96,0,96,陽信-石牌,2023-06-14,8711
00795B,中信美國公債20年,76,0,76,陽信-石牌,2023-06-14,8711
6138,茂達,75,0,75,陽信-石牌,2023-06-14,8711
2382,廣達,97,23,74,陽信-石牌,2023-06-14,8711
2356,英業達,202,141,61,陽信-石牌,2023-06-14,8711
1609,大亞,79,18,61,陽信-石牌,2023-06-14,8711
2368,金像電,56,2,54,陽信-石牌,2023-06-14,8711
4533,協易機,63,9,54,陽信-石牌,2023-06-14,8711
2504,國產,50,0,50,陽信-石牌,2023-06-14,8711
2637,慧洋-KY,27,0,27,陽信-石牌,2023-06-14,8711
4906,正文,42,15,27,陽信-石牌,2023-06-14,8711
6282,康舒,30,3,27,陽信-石牌,2023-06-14,8711
5905,南仁湖,35,10,25,陽信-石牌,2023-06-14,8711
00671R,富邦NASDAQ反1,20,0,20,陽信-石牌,2023-06-14,8711
4971,IET-KY,20,0,20,陽信-石牌,2023-06-14,8711
2457,飛宏,50,33,17,陽信-石牌,2023-06-14,8711
2330,台積電,20,3,17,陽信-石牌,2023-06-14,8711
2489,瑞軒,17,0,17,陽信-石牌,2023-06-14,8711
1905,華紙,19,3,16,陽信-石牌,2023-06-14,8711
2630,亞航,19,3,16,陽信-石牌,2023-06-14,8711
6288,聯嘉,47,31,16,陽信-石牌,2023-06-14,8711
2412,中華電,15,0,15,陽信-石牌,2023-06-14,8711
2634,漢翔,14,0,14,陽信-石牌,2023-06-14,8711
8076,伍豐,26,12,14,陽信-石牌,2023-06-14,8711
1522,堤維西,37,24,13,陽信-石牌,2023-06-14,8711
8446,華研,24,11,13,陽信-石牌,2023-06-14,8711
1533,車王電,14,2,12,陽信-石牌,2023-06-14,8711
2208,台船,12,0,12,陽信-石牌,2023-06-14,8711
8088,品安,24,12,12,陽信-石牌,2023-06-14,8711
3037,欣興,13,2,11,陽信-石牌,2023-06-14,8711
1810,和成,11,0,11,陽信-石牌,2023-06-14,8711
2468,華經,27,16,11,陽信-石牌,2023-06-14,8711
2705,六福,22,11,11,陽信-石牌,2023-06-14,8711
8105,凌巨,15,4,11,陽信-石牌,2023-06-14,8711
8933,愛地雅,11,0,11,陽信-石牌,2023-06-14,8711
00688L,國泰20年美債正2,10,0,10,陽信-石牌,2023-06-14,8711
1460,宏遠,10,0,10,陽信-石牌,2023-06-14,8711
1513,中興電,12,2,10,陽信-石牌,2023-06-14,8711
1802,台玻,10,0,10,陽信-石牌,2023-06-14,8711
2211,長榮鋼,10,0,10,陽信-石牌,2023-06-14,8711
2444,兆勁,10,0,10,陽信-石牌,2023-06-14,8711
2732,六角,10,0,10,陽信-石牌,2023-06-14,8711
2888,新光金,193,10,183,陽信-石牌,2023-06-15,8711
00632R,元大台灣50反1,134,11,123,陽信-石牌,2023-06-15,8711
0056,元大高股息,83,10,73,陽信-石牌,2023-06-15,8711
2102,泰豐,62,0,62,陽信-石牌,2023-06-15,8711
3576,聯合再生,50,0,50,陽信-石牌,2023-06-15,8711
9105,泰金寶-DR,50,0,50,陽信-石牌,2023-06-15,8711
3583,辛耘,51,2,49,陽信-石牌,2023-06-15,8711
1795,美時,56,8,48,陽信-石牌,2023-06-15,8711
3308,聯德,39,0,39,陽信-石牌,2023-06-15,8711
1904,正隆,35,1,34,陽信-石牌,2023-06-15,8711
1611,中電,51,20,31,陽信-石牌,2023-06-15,8711
8261,富鼎,35,5,30,陽信-石牌,2023-06-15,8711
4971,IET-KY,29,0,29,陽信-石牌,2023-06-15,8711
2382,廣達,51,24,27,陽信-石牌,2023-06-15,8711
2618,長榮航,249,223,26,陽信-石牌,2023-06-15,8711
2486,一詮,25,0,25,陽信-石牌,2023-06-15,8711
1815,富喬,31,8,23,陽信-石牌,2023-06-15,8711
4960,誠美材,24,2,22,陽信-石牌,2023-06-15,8711
2342,茂矽,21,0,21,陽信-石牌,2023-06-15,8711
2457,飛宏,35,14,21,陽信-石牌,2023-06-15,8711
2362,藍天,20,0,20,陽信-石牌,2023-06-15,8711
3011,今皓,20,0,20,陽信-石牌,2023-06-15,8711
5905,南仁湖,20,0,20,陽信-石牌,2023-06-15,8711
6148,驊宏資,32,12,20,陽信-石牌,2023-06-15,8711
2454,聯發科,19,0,19,陽信-石牌,2023-06-15,8711
2637,慧洋-KY,22,3,19,陽信-石牌,2023-06-15,8711
00712,復華富時不動產,17,0,17,陽信-石牌,2023-06-15,8711
6205,詮欣,17,0,17,陽信-石牌,2023-06-15,8711
2317,鴻海,17,1,16,陽信-石牌,2023-06-15,8711
2402,毅嘉,23,7,16,陽信-石牌,2023-06-15,8711
3346,麗清,21,5,16,陽信-石牌,2023-06-15,8711
3504,揚明光,16,0,16,陽信-石牌,2023-06-15,8711
00651R,復華香港反1,15,0,15,陽信-石牌,2023-06-15,8711
3033,威健,24,11,13,陽信-石牌,2023-06-15,8711
1504,東元,35,23,12,陽信-石牌,2023-06-15,8711
3062,建漢,12,0,12,陽信-石牌,2023-06-15,8711
5201,凱衛,36,24,12,陽信-石牌,2023-06-15,8711
6416,瑞祺電通,12,0,12,陽信-石牌,2023-06-15,8711
3231,緯創,74,63,11,陽信-石牌,2023-06-15,8711
00882,中信中國高股息,11,0,11,陽信-石牌,2023-06-15,8711
2867,三商壽,11,0,11,陽信-石牌,2023-06-15,8711
2887,台新金,11,0,11,陽信-石牌,2023-06-15,8711
1218,泰山,10,0,10,陽信-石牌,2023-06-15,8711
1598,岱宇,10,0,10,陽信-石牌,2023-06-15,8711
3022,威強電,15,5,10,陽信-石牌,2023-06-15,8711
3027,盛達,19,9,10,陽信-石牌,2023-06-15,8711
5481,新華,10,0,10,陽信-石牌,2023-06-15,8711
5864,致和證,10,0,10,陽信-石牌,2023-06-15,8711
6245,立端,15,5,10,陽信-石牌,2023-06-15,8711
00919,群益台灣精選高息,20,11,9,陽信-石牌,2023-06-15,8711
00632R,元大台灣50反1,421,0,421,陽信-石牌,2023-06-16,8711
2610,華航,675,342,333,陽信-石牌,2023-06-16,8711
00919,群益台灣精選高息,287,0,287,陽信-石牌,2023-06-16,8711
00878,國泰永續高股息,189,55,134,陽信-石牌,2023-06-16,8711
2888,新光金,153,24,129,陽信-石牌,2023-06-16,8711
00671R,富邦NASDAQ反1,70,0,70,陽信-石牌,2023-06-16,8711
2371,大同,140,96,44,陽信-石牌,2023-06-16,8711
1514,亞力,60,17,43,陽信-石牌,2023-06-16,8711
6265,方土昶,41,5,36,陽信-石牌,2023-06-16,8711
2457,飛宏,114,81,33,陽信-石牌,2023-06-16,8711
3265,台星科,28,0,28,陽信-石牌,2023-06-16,8711
6416,瑞祺電通,29,1,28,陽信-石牌,2023-06-16,8711
3019,亞光,26,0,26,陽信-石牌,2023-06-16,8711
2637,慧洋-KY,25,0,25,陽信-石牌,2023-06-16,8711
6176,瑞儀,25,0,25,陽信-石牌,2023-06-16,8711
2468,華經,48,25,23,陽信-石牌,2023-06-16,8711
2303,聯電,49,27,22,陽信-石牌,2023-06-16,8711
2359,所羅門,33,11,22,陽信-石牌,2023-06-16,8711
3044,健鼎,22,0,22,陽信-石牌,2023-06-16,8711
1907,永豐餘,21,0,21,陽信-石牌,2023-06-16,8711
3419,譁裕,21,0,21,陽信-石牌,2023-06-16,8711
3028,增你強,20,0,20,陽信-石牌,2023-06-16,8711
5905,南仁湖,20,0,20,陽信-石牌,2023-06-16,8711
2486,一詮,25,6,19,陽信-石牌,2023-06-16,8711
3498,陽程,19,0,19,陽信-石牌,2023-06-16,8711
6116,彩晶,25,7,18,陽信-石牌,2023-06-16,8711
2882,國泰金,16,0,16,陽信-石牌,2023-06-16,8711
4303,信立,16,0,16,陽信-石牌,2023-06-16,8711
00651R,復華香港反1,15,0,15,陽信-石牌,2023-06-16,8711
3706,神達,93,78,15,陽信-石牌,2023-06-16,8711
2603,長榮,39,24,15,陽信-石牌,2023-06-16,8711
2405,輔信,14,0,14,陽信-石牌,2023-06-16,8711
00927,群益半導體收益,13,0,13,陽信-石牌,2023-06-16,8711
1605,華新,124,111,13,陽信-石牌,2023-06-16,8711
2883,凱基金,12,0,12,陽信-石牌,2023-06-16,8711
8076,伍豐,14,2,12,陽信-石牌,2023-06-16,8711
1718,中纖,14,2,12,陽信-石牌,2023-06-16,8711
2308,台達電,14,3,11,陽信-石牌,2023-06-16,8711
2915,潤泰全,11,0,11,陽信-石牌,2023-06-16,8711
3264,欣銓,21,10,11,陽信-石牌,2023-06-16,8711
2887,台新金,13,2,11,陽信-石牌,2023-06-16,8711
2103,台橡,10,0,10,陽信-石牌,2023-06-16,8711
2331,精英,10,0,10,陽信-石牌,2023-06-16,8711
2442,新美齊,10,0,10,陽信-石牌,2023-06-16,8711
3011,今皓,10,0,10,陽信-石牌,2023-06-16,8711
3296,勝德,10,0,10,陽信-石牌,2023-06-16,8711
4971,IET-KY,10,0,10,陽信-石牌,2023-06-16,8711
6163,華電網,10,0,10,陽信-石牌,2023-06-16,8711
6179,亞通,10,0,10,陽信-石牌,2023-06-16,8711
6214,精誠,10,0,10,陽信-石牌,2023-06-16,8711
00673R,期元大S＆P原油反1,241,0,241,陽信-石牌,2023-06-19,8711
00632R,元大台灣50反1,129,0,129,陽信-石牌,2023-06-19,8711
3028,增你強,80,0,80,陽信-石牌,2023-06-19,8711
2609,陽明,81,2,79,陽信-石牌,2023-06-19,8711
2603,長榮,82,9,73,陽信-石牌,2023-06-19,8711
8112,至上,71,0,71,陽信-石牌,2023-06-19,8711
2427,三商電,80,20,60,陽信-石牌,2023-06-19,8711
4952,凌通,60,0,60,陽信-石牌,2023-06-19,8711
2618,長榮航,134,75,59,陽信-石牌,2023-06-19,8711
2504,國產,57,0,57,陽信-石牌,2023-06-19,8711
3035,智原,62,5,57,陽信-石牌,2023-06-19,8711
2324,仁寶,45,7,38,陽信-石牌,2023-06-19,8711
2888,新光金,56,18,38,陽信-石牌,2023-06-19,8711
00882,中信中國高股息,36,4,32,陽信-石牌,2023-06-19,8711
6244,茂迪,37,6,31,陽信-石牌,2023-06-19,8711
1815,富喬,32,2,30,陽信-石牌,2023-06-19,8711
1907,永豐餘,30,0,30,陽信-石牌,2023-06-19,8711
6285,啟��,46,16,30,陽信-石牌,2023-06-19,8711
8210,勤誠,31,2,29,陽信-石牌,2023-06-19,8711
6584,南俊國際,24,0,24,陽信-石牌,2023-06-19,8711
6288,聯嘉,26,3,23,陽信-石牌,2023-06-19,8711
1513,中興電,32,10,22,陽信-石牌,2023-06-19,8711
2913,農林,28,6,22,陽信-石牌,2023-06-19,8711
2421,建準,24,4,20,陽信-石牌,2023-06-19,8711
2486,一詮,20,0,20,陽信-石牌,2023-06-19,8711
3576,聯合再生,20,0,20,陽信-石牌,2023-06-19,8711
6443,元晶,23,3,20,陽信-石牌,2023-06-19,8711
9904,寶成,20,0,20,陽信-石牌,2023-06-19,8711
2303,聯電,35,16,19,陽信-石牌,2023-06-19,8711
2344,華邦電,20,1,19,陽信-石牌,2023-06-19,8711
3231,緯創,96,77,19,陽信-石牌,2023-06-19,8711
0056,元大高股息,30,12,18,陽信-石牌,2023-06-19,8711
1802,台玻,58,40,18,陽信-石牌,2023-06-19,8711
6116,彩晶,76,58,18,陽信-石牌,2023-06-19,8711
00712,復華富時不動產,18,1,17,陽信-石牌,2023-06-19,8711
6005,群益證,15,0,15,陽信-石牌,2023-06-19,8711
1605,華新,70,56,14,陽信-石牌,2023-06-19,8711
2312,金寶,35,21,14,陽信-石牌,2023-06-19,8711
2353,宏��,12,0,12,陽信-石牌,2023-06-19,8711
2883,凱基金,17,5,12,陽信-石牌,2023-06-19,8711
1905,華紙,11,0,11,陽信-石牌,2023-06-19,8711
2362,藍天,25,14,11,陽信-石牌,2023-06-19,8711
2705,六福,41,30,11,陽信-石牌,2023-06-19,8711
3264,欣銓,34,23,11,陽信-石牌,2023-06-19,8711
5284,jpp-KY,17,6,11,陽信-石牌,2023-06-19,8711
6743,安普新,11,0,11,陽信-石牌,2023-06-19,8711
00679B,元大美債20年,10,0,10,陽信-石牌,2023-06-19,8711
00696B,富邦美債20年,10,0,10,陽信-石牌,2023-06-19,8711
1218,泰山,19,9,10,陽信-石牌,2023-06-19,8711
00926,凱基全球菁英55,10,0,10,陽信-石牌,2023-06-19,8711
00632R,元大台灣50反1,251,0,251,陽信-石牌,2023-06-20,8711
2610,華航,195,70,125,陽信-石牌,2023-06-20,8711
3013,晟銘電,115,0,115,陽信-石牌,2023-06-20,8711
2609,陽明,83,6,77,陽信-石牌,2023-06-20,8711
6689,伊雲谷,55,0,55,陽信-石牌,2023-06-20,8711
2388,威盛,47,0,47,陽信-石牌,2023-06-20,8711
6116,彩晶,47,0,47,陽信-石牌,2023-06-20,8711
8099,大世科,47,0,47,陽信-石牌,2023-06-20,8711
00882,中信中國高股息,77,35,42,陽信-石牌,2023-06-20,8711
3481,群創,152,115,37,陽信-石牌,2023-06-20,8711
2634,漢翔,126,90,36,陽信-石牌,2023-06-20,8711
6288,聯嘉,34,3,31,陽信-石牌,2023-06-20,8711
2317,鴻海,22,0,22,陽信-石牌,2023-06-20,8711
3049,精金,22,0,22,陽信-石牌,2023-06-20,8711
1319,東陽,23,2,21,陽信-石牌,2023-06-20,8711
00671R,富邦NASDAQ反1,20,0,20,陽信-石牌,2023-06-20,8711
2027,大成鋼,20,0,20,陽信-石牌,2023-06-20,8711
3380,明泰,20,0,20,陽信-石牌,2023-06-20,8711
2603,長榮,20,1,19,陽信-石牌,2023-06-20,8711
4541,晟田,22,3,19,陽信-石牌,2023-06-20,8711
8210,勤誠,22,4,18,陽信-石牌,2023-06-20,8711
00720B,元大投資級公司債,17,0,17,陽信-石牌,2023-06-20,8711
2337,旺宏,17,0,17,陽信-石牌,2023-06-20,8711
1605,華新,28,12,16,陽信-石牌,2023-06-20,8711
1584,精剛,15,0,15,陽信-石牌,2023-06-20,8711
2201,裕隆,19,4,15,陽信-石牌,2023-06-20,8711
5009,榮剛,16,1,15,陽信-石牌,2023-06-20,8711
6148,驊宏資,23,8,15,陽信-石牌,2023-06-20,8711
6416,瑞祺電通,20,5,15,陽信-石牌,2023-06-20,8711
00712,復華富時不動產,21,7,14,陽信-石牌,2023-06-20,8711
1591,駿吉-KY,14,0,14,陽信-石牌,2023-06-20,8711
2413,環科,14,0,14,陽信-石牌,2023-06-20,8711
3260,威剛,15,1,14,陽信-石牌,2023-06-20,8711
7402,邑錡,14,0,14,陽信-石牌,2023-06-20,8711
2312,金寶,20,7,13,陽信-石牌,2023-06-20,8711
3564,其陽,15,2,13,陽信-石牌,2023-06-20,8711
2731,雄獅,12,0,12,陽信-石牌,2023-06-20,8711
3689,湧德,12,0,12,陽信-石牌,2023-06-20,8711
3706,神達,20,9,11,陽信-石牌,2023-06-20,8711
00919,群益台灣精選高息,12,2,10,陽信-石牌,2023-06-20,8711
1528,恩德,16,6,10,陽信-石牌,2023-06-20,8711
1611,中電,10,0,10,陽信-石牌,2023-06-20,8711
2009,第一銅,10,0,10,陽信-石牌,2023-06-20,8711
2457,飛宏,40,30,10,陽信-石牌,2023-06-20,8711
3011,今皓,10,0,10,陽信-石牌,2023-06-20,8711
4114,健喬,13,3,10,陽信-石牌,2023-06-20,8711
5356,協益,10,0,10,陽信-石牌,2023-06-20,8711
6412,群電,10,0,10,陽信-石牌,2023-06-20,8711
00772B,中信高評級公司債,10,1,9,陽信-石牌,2023-06-20,8711
2344,華邦電,10,1,9,陽信-石牌,2023-06-20,8711
2603,長榮,220,11,209,陽信-石牌,2023-06-21,8711
00715L,期街口布蘭特正2,189,27,162,陽信-石牌,2023-06-21,8711
3481,群創,355,197,158,陽信-石牌,2023-06-21,8711
00632R,元大台灣50反1,120,1,119,陽信-石牌,2023-06-21,8711
6244,茂迪,107,0,107,陽信-石牌,2023-06-21,8711
2609,陽明,104,0,104,陽信-石牌,2023-06-21,8711
2881,富邦金,90,0,90,陽信-石牌,2023-06-21,8711
2211,長榮鋼,58,0,58,陽信-石牌,2023-06-21,8711
2371,大同,166,108,58,陽信-石牌,2023-06-21,8711
2388,威盛,54,3,51,陽信-石牌,2023-06-21,8711
6438,迅得,50,0,50,陽信-石牌,2023-06-21,8711
00671R,富邦NASDAQ反1,40,0,40,陽信-石牌,2023-06-21,8711
2885,元大金,46,6,40,陽信-石牌,2023-06-21,8711
2634,漢翔,122,84,38,陽信-石牌,2023-06-21,8711
3056,富華新,47,14,33,陽信-石牌,2023-06-21,8711
3035,智原,86,59,27,陽信-石牌,2023-06-21,8711
2545,皇翔,25,0,25,陽信-石牌,2023-06-21,8711
4916,事欣科,38,14,24,陽信-石牌,2023-06-21,8711
2323,中環,28,5,23,陽信-石牌,2023-06-21,8711
2337,旺宏,22,0,22,陽信-石牌,2023-06-21,8711
5465,富驊,21,0,21,陽信-石牌,2023-06-21,8711
00882,中信中國高股息,100,80,20,陽信-石牌,2023-06-21,8711
2014,中鴻,20,0,20,陽信-石牌,2023-06-21,8711
2104,國際中橡,20,0,20,陽信-石牌,2023-06-21,8711
2489,瑞軒,20,0,20,陽信-石牌,2023-06-21,8711
8210,勤誠,28,9,19,陽信-石牌,2023-06-21,8711
3260,威剛,18,1,17,陽信-石牌,2023-06-21,8711
4961,天鈺,17,0,17,陽信-石牌,2023-06-21,8711
6288,聯嘉,16,0,16,陽信-石牌,2023-06-21,8711
2017,官田鋼,15,0,15,陽信-石牌,2023-06-21,8711
2442,新美齊,15,0,15,陽信-石牌,2023-06-21,8711
4726,永昕,15,0,15,陽信-石牌,2023-06-21,8711
2313,華通,14,0,14,陽信-石牌,2023-06-21,8711
8046,南電,14,0,14,陽信-石牌,2023-06-21,8711
4971,IET-KY,13,0,13,陽信-石牌,2023-06-21,8711
3058,立德,15,3,12,陽信-石牌,2023-06-21,8711
6257,矽格,12,0,12,陽信-石牌,2023-06-21,8711
6290,良維,13,1,12,陽信-石牌,2023-06-21,8711
00927,群益半導體收益,11,0,11,陽信-石牌,2023-06-21,8711
00919,群益台灣精選高息,11,0,11,陽信-石牌,2023-06-21,8711
2408,南亞科,11,0,11,陽信-石牌,2023-06-21,8711
3011,今皓,11,0,11,陽信-石牌,2023-06-21,8711
3025,星通,12,1,11,陽信-石牌,2023-06-21,8711
1795,美時,11,1,10,陽信-石牌,2023-06-21,8711
1440,南紡,10,0,10,陽信-石牌,2023-06-21,8711
1802,台玻,11,1,10,陽信-石牌,2023-06-21,8711
3520,華盈,10,0,10,陽信-石牌,2023-06-21,8711
4538,大詠城,11,1,10,陽信-石牌,2023-06-21,8711
4934,太極,10,0,10,陽信-石牌,2023-06-21,8711
5905,南仁湖,37,27,10,陽信-石牌,2023-06-21,8711
2303,聯電,861,30,831,陽信-石牌,2023-06-26,8711
2349,錸德,200,1,199,陽信-石牌,2023-06-26,8711
2382,廣達,189,12,177,陽信-石牌,2023-06-26,8711
00673R,期元大S＆P原油反1,191,35,156,陽信-石牌,2023-06-26,8711
2610,華航,144,36,108,陽信-石牌,2023-06-26,8711
3481,群創,138,49,89,陽信-石牌,2023-06-26,8711
3374,精材,73,2,71,陽信-石牌,2023-06-26,8711
00632R,元大台灣50反1,60,4,56,陽信-石牌,2023-06-26,8711
2498,宏達電,55,2,53,陽信-石牌,2023-06-26,8711
00640L,富邦日本正2,50,0,50,陽信-石牌,2023-06-26,8711
2881,富邦金,50,0,50,陽信-石牌,2023-06-26,8711
3071,協禧,49,0,49,陽信-石牌,2023-06-26,8711
2211,長榮鋼,42,0,42,陽信-石牌,2023-06-26,8711
2609,陽明,80,38,42,陽信-石牌,2023-06-26,8711
2344,華邦電,48,10,38,陽信-石牌,2023-06-26,8711
0056,元大高股息,37,0,37,陽信-石牌,2023-06-26,8711
6416,瑞祺電通,35,0,35,陽信-石牌,2023-06-26,8711
1513,中興電,34,0,34,陽信-石牌,2023-06-26,8711
2883,凱基金,34,0,34,陽信-石牌,2023-06-26,8711
3265,台星科,30,0,30,陽信-石牌,2023-06-26,8711
1217,愛之味,26,0,26,陽信-石牌,2023-06-26,8711
1504,東元,25,0,25,陽信-石牌,2023-06-26,8711
3260,威剛,24,0,24,陽信-石牌,2023-06-26,8711
4543,萬在,34,10,24,陽信-石牌,2023-06-26,8711
2637,慧洋-KY,23,0,23,陽信-石牌,2023-06-26,8711
3032,偉訓,22,0,22,陽信-石牌,2023-06-26,8711
00642U,期元大S＆P石油,20,0,20,陽信-石牌,2023-06-26,8711
2867,三商壽,20,0,20,陽信-石牌,2023-06-26,8711
1605,華新,49,30,19,陽信-石牌,2023-06-26,8711
3056,富華新,19,0,19,陽信-石牌,2023-06-26,8711
6288,聯嘉,19,0,19,陽信-石牌,2023-06-26,8711
3013,晟銘電,18,0,18,陽信-石牌,2023-06-26,8711
3413,京鼎,20,2,18,陽信-石牌,2023-06-26,8711
3673,TPK-KY,21,3,18,陽信-石牌,2023-06-26,8711
00713,元大台灣高息低波,17,0,17,陽信-石牌,2023-06-26,8711
2356,英業達,37,20,17,陽信-石牌,2023-06-26,8711
2457,飛宏,31,14,17,陽信-石牌,2023-06-26,8711
3380,明泰,17,0,17,陽信-石牌,2023-06-26,8711
2330,台積電,16,0,16,陽信-石牌,2023-06-26,8711
1802,台玻,27,11,16,陽信-石牌,2023-06-26,8711
2023,燁輝,16,0,16,陽信-石牌,2023-06-26,8711
6282,康舒,16,0,16,陽信-石牌,2023-06-26,8711
2889,國票金,15,0,15,陽信-石牌,2023-06-26,8711
2204,中華,14,0,14,陽信-石牌,2023-06-26,8711
6411,晶焱,13,0,13,陽信-石牌,2023-06-26,8711
2340,台亞,23,11,12,陽信-石牌,2023-06-26,8711
3037,欣興,12,1,11,陽信-石牌,2023-06-26,8711
2442,新美齊,11,0,11,陽信-石牌,2023-06-26,8711
3051,力特,11,0,11,陽信-石牌,2023-06-26,8711
3363,上詮,11,0,11,陽信-石牌,2023-06-26,8711
3481,群創,896,146,750,陽信-石牌,2023-06-27,8711
1605,華新,119,0,119,陽信-石牌,2023-06-27,8711
2883,凱基金,101,0,101,陽信-石牌,2023-06-27,8711
2610,華航,195,105,90,陽信-石牌,2023-06-27,8711
2618,長榮航,165,98,67,陽信-石牌,2023-06-27,8711
2303,聯電,71,5,66,陽信-石牌,2023-06-27,8711
3518,柏騰,64,0,64,陽信-石牌,2023-06-27,8711
2014,中鴻,85,22,63,陽信-石牌,2023-06-27,8711
00919,群益台灣精選高息,62,0,62,陽信-石牌,2023-06-27,8711
7402,邑錡,58,0,58,陽信-石牌,2023-06-27,8711
2323,中環,66,12,54,陽信-石牌,2023-06-27,8711
00640L,富邦日本正2,50,0,50,陽信-石牌,2023-06-27,8711
2344,華邦電,52,2,50,陽信-石牌,2023-06-27,8711
6416,瑞祺電通,50,0,50,陽信-石牌,2023-06-27,8711
00795B,中信美國公債20年,40,0,40,陽信-石牌,2023-06-27,8711
2102,泰豐,40,0,40,陽信-石牌,2023-06-27,8711
3073,天方能源,39,0,39,陽信-石牌,2023-06-27,8711
2442,新美齊,32,0,32,陽信-石牌,2023-06-27,8711
4503,金雨,33,3,30,陽信-石牌,2023-06-27,8711
2317,鴻海,69,39,30,陽信-石牌,2023-06-27,8711
00713,元大台灣高息低波,29,0,29,陽信-石牌,2023-06-27,8711
00673R,期元大S＆P原油反1,30,1,29,陽信-石牌,2023-06-27,8711
2324,仁寶,27,2,25,陽信-石牌,2023-06-27,8711
3265,台星科,25,0,25,陽信-石牌,2023-06-27,8711
1734,杏輝,36,12,24,陽信-石牌,2023-06-27,8711
1301,台塑,23,0,23,陽信-石牌,2023-06-27,8711
3032,偉訓,23,0,23,陽信-石牌,2023-06-27,8711
3013,晟銘電,26,4,22,陽信-石牌,2023-06-27,8711
2498,宏達電,21,0,21,陽信-石牌,2023-06-27,8711
6026,福邦證,21,0,21,陽信-石牌,2023-06-27,8711
2734,易飛網,20,0,20,陽信-石牌,2023-06-27,8711
3231,緯創,95,75,20,陽信-石牌,2023-06-27,8711
3356,奇偶,42,22,20,陽信-石牌,2023-06-27,8711
4510,高鋒,20,0,20,陽信-石牌,2023-06-27,8711
6163,華電網,20,0,20,陽信-石牌,2023-06-27,8711
6414,樺漢,19,1,18,陽信-石牌,2023-06-27,8711
0056,元大高股息,24,7,17,陽信-石牌,2023-06-27,8711
1603,華電,21,4,17,陽信-石牌,2023-06-27,8711
4564,元翎,17,0,17,陽信-石牌,2023-06-27,8711
8033,雷虎,17,0,17,陽信-石牌,2023-06-27,8711
1905,華紙,19,3,16,陽信-石牌,2023-06-27,8711
2356,英業達,54,38,16,陽信-石牌,2023-06-27,8711
2388,威盛,19,3,16,陽信-石牌,2023-06-27,8711
2637,慧洋-KY,16,0,16,陽信-石牌,2023-06-27,8711
3038,全台,29,13,16,陽信-石牌,2023-06-27,8711
00927,群益半導體收益,15,0,15,陽信-石牌,2023-06-27,8711
00665L,富邦�琤肭磪囓�2,45,30,15,陽信-石牌,2023-06-27,8711
2615,萬海,15,0,15,陽信-石牌,2023-06-27,8711
3056,富華新,15,0,15,陽信-石牌,2023-06-27,8711
6116,彩晶,15,0,15,陽信-石牌,2023-06-27,8711
3481,群創,340,28,312,陽信-石牌,2023-06-28,8711
2906,高林,123,0,123,陽信-石牌,2023-06-28,8711
2867,三商壽,90,0,90,陽信-石牌,2023-06-28,8711
2409,友達,65,0,65,陽信-石牌,2023-06-28,8711
1605,華新,115,59,56,陽信-石牌,2023-06-28,8711
2634,漢翔,77,25,52,陽信-石牌,2023-06-28,8711
6166,凌華,52,1,51,陽信-石牌,2023-06-28,8711
00919,群益台灣精選高息,41,0,41,陽信-石牌,2023-06-28,8711
00642U,期元大S＆P石油,136,100,36,陽信-石牌,2023-06-28,8711
1301,台塑,32,0,32,陽信-石牌,2023-06-28,8711
3231,緯創,108,77,31,陽信-石牌,2023-06-28,8711
00634R,富邦上証反1,30,0,30,陽信-石牌,2023-06-28,8711
2498,宏達電,30,0,30,陽信-石牌,2023-06-28,8711
8222,寶一,34,4,30,陽信-石牌,2023-06-28,8711
00795B,中信美國公債20年,30,1,29,陽信-石牌,2023-06-28,8711
2323,中環,147,118,29,陽信-石牌,2023-06-28,8711
2881,富邦金,30,2,28,陽信-石牌,2023-06-28,8711
00715L,期街口布蘭特正2,27,0,27,陽信-石牌,2023-06-28,8711
2609,陽明,38,11,27,陽信-石牌,2023-06-28,8711
6116,彩晶,24,0,24,陽信-石牌,2023-06-28,8711
00898,國泰基因免疫革命,20,0,20,陽信-石牌,2023-06-28,8711
3011,今皓,24,4,20,陽信-石牌,2023-06-28,8711
3682,亞太電,20,0,20,陽信-石牌,2023-06-28,8711
5386,青雲,20,0,20,陽信-石牌,2023-06-28,8711
6125,廣運,21,1,20,陽信-石牌,2023-06-28,8711
8150,南茂,20,0,20,陽信-石牌,2023-06-28,8711
2022,聚亨,20,1,19,陽信-石牌,2023-06-28,8711
2330,台積電,18,0,18,陽信-石牌,2023-06-28,8711
1513,中興電,30,13,17,陽信-石牌,2023-06-28,8711
2014,中鴻,21,4,17,陽信-石牌,2023-06-28,8711
3706,神達,25,8,17,陽信-石牌,2023-06-28,8711
6164,華興,17,0,17,陽信-石牌,2023-06-28,8711
1609,大亞,20,4,16,陽信-石牌,2023-06-28,8711
2383,台光電,19,3,16,陽信-石牌,2023-06-28,8711
1907,永豐餘,15,0,15,陽信-石牌,2023-06-28,8711
4906,正文,36,21,15,陽信-石牌,2023-06-28,8711
00878,國泰永續高股息,20,7,13,陽信-石牌,2023-06-28,8711
2637,慧洋-KY,14,1,13,陽信-石牌,2023-06-28,8711
1303,南亞,12,0,12,陽信-石牌,2023-06-28,8711
1810,和成,25,14,11,陽信-石牌,2023-06-28,8711
3356,奇偶,21,10,11,陽信-石牌,2023-06-28,8711
6288,聯嘉,12,1,11,陽信-石牌,2023-06-28,8711
00725B,國泰投資級公司債,10,0,10,陽信-石牌,2023-06-28,8711
2356,英業達,50,40,10,陽信-石牌,2023-06-28,8711
2369,菱生,10,0,10,陽信-石牌,2023-06-28,8711
3260,威剛,11,1,10,陽信-石牌,2023-06-28,8711
3686,達能,10,0,10,陽信-石牌,2023-06-28,8711
4510,高鋒,10,0,10,陽信-石牌,2023-06-28,8711
6282,康舒,10,0,10,陽信-石牌,2023-06-28,8711
9944,新麗,10,0,10,陽信-石牌,2023-06-28,8711
3481,群創,416,21,395,陽信-石牌,2023-06-29,8711
7402,邑錡,347,6,341,陽信-石牌,2023-06-29,8711
2349,錸德,180,0,180,陽信-石牌,2023-06-29,8711
00715L,期街口布蘭特正2,150,2,148,陽信-石牌,2023-06-29,8711
2382,廣達,76,11,65,陽信-石牌,2023-06-29,8711
2618,長榮航,159,106,53,陽信-石牌,2023-06-29,8711
2317,鴻海,48,3,45,陽信-石牌,2023-06-29,8711
2637,慧洋-KY,45,0,45,陽信-石牌,2023-06-29,8711
00919,群益台灣精選高息,41,1,40,陽信-石牌,2023-06-29,8711
0056,元大高股息,40,0,40,陽信-石牌,2023-06-29,8711
1528,恩德,40,0,40,陽信-石牌,2023-06-29,8711
6274,台燿,43,3,40,陽信-石牌,2023-06-29,8711
00922,國泰台灣領袖50,38,0,38,陽信-石牌,2023-06-29,8711
2610,華航,122,86,36,陽信-石牌,2023-06-29,8711
00878,國泰永續高股息,38,4,34,陽信-石牌,2023-06-29,8711
1467,南緯,30,0,30,陽信-石牌,2023-06-29,8711
2303,聯電,29,2,27,陽信-石牌,2023-06-29,8711
00882,中信中國高股息,26,0,26,陽信-石牌,2023-06-29,8711
2402,毅嘉,30,4,26,陽信-石牌,2023-06-29,8711
2609,陽明,26,1,25,陽信-石牌,2023-06-29,8711
6153,嘉聯益,25,1,24,陽信-石牌,2023-06-29,8711
00795B,中信美國公債20年,30,10,20,陽信-石牌,2023-06-29,8711
1905,華紙,24,4,20,陽信-石牌,2023-06-29,8711
2022,聚亨,20,0,20,陽信-石牌,2023-06-29,8711
00637L,元大滬深300正2,20,2,18,陽信-石牌,2023-06-29,8711
00725B,國泰投資級公司債,15,0,15,陽信-石牌,2023-06-29,8711
1605,華新,23,9,14,陽信-石牌,2023-06-29,8711
6125,廣運,15,1,14,陽信-石牌,2023-06-29,8711
8069,元太,14,0,14,陽信-石牌,2023-06-29,8711
5386,青雲,13,0,13,陽信-石牌,2023-06-29,8711
3673,TPK-KY,13,1,12,陽信-石牌,2023-06-29,8711
1326,台化,11,0,11,陽信-石牌,2023-06-29,8711
2457,飛宏,13,2,11,陽信-石牌,2023-06-29,8711
2498,宏達電,11,0,11,陽信-石牌,2023-06-29,8711
3011,今皓,11,0,11,陽信-石牌,2023-06-29,8711
4123,晟德,12,1,11,陽信-石牌,2023-06-29,8711
4157,太景*-KY,15,4,11,陽信-石牌,2023-06-29,8711
5521,工信,11,0,11,陽信-石牌,2023-06-29,8711
8033,雷虎,11,0,11,陽信-石牌,2023-06-29,8711
8150,南茂,11,0,11,陽信-石牌,2023-06-29,8711
8403,盛弘,12,1,11,陽信-石牌,2023-06-29,8711
2102,泰豐,10,0,10,陽信-石牌,2023-06-29,8711
2409,友達,31,21,10,陽信-石牌,2023-06-29,8711
2431,聯昌,10,0,10,陽信-石牌,2023-06-29,8711
3017,奇鋐,10,0,10,陽信-石牌,2023-06-29,8711
6148,驊宏資,10,0,10,陽信-石牌,2023-06-29,8711
5388,中磊,12,2,10,陽信-石牌,2023-06-29,8711
3005,神基,11,2,9,陽信-石牌,2023-06-29,8711
1802,台玻,10,1,9,陽信-石牌,2023-06-29,8711
3260,威剛,25,16,9,陽信-石牌,2023-06-29,8711
3481,群創,202,53,149,陽信-石牌,2023-06-30,8711
2882,國泰金,65,0,65,陽信-石牌,2023-06-30,8711
2382,廣達,99,44,55,陽信-石牌,2023-06-30,8711
2409,友達,68,14,54,陽信-石牌,2023-06-30,8711
2637,慧洋-KY,51,0,51,陽信-石牌,2023-06-30,8711
2881,富邦金,45,0,45,陽信-石牌,2023-06-30,8711
00725B,國泰投資級公司債,35,0,35,陽信-石牌,2023-06-30,8711
7402,邑錡,46,11,35,陽信-石牌,2023-06-30,8711
8099,大世科,35,0,35,陽信-石牌,2023-06-30,8711
1514,亞力,42,10,32,陽信-石牌,2023-06-30,8711
00634R,富邦上証反1,30,0,30,陽信-石牌,2023-06-30,8711
1605,華新,34,6,28,陽信-石牌,2023-06-30,8711
00679B,元大美債20年,27,0,27,陽信-石牌,2023-06-30,8711
9958,世紀鋼,33,6,27,陽信-石牌,2023-06-30,8711
00919,群益台灣精選高息,26,0,26,陽信-石牌,2023-06-30,8711
00687B,國泰20年美債,23,0,23,陽信-石牌,2023-06-30,8711
4906,正文,94,73,21,陽信-石牌,2023-06-30,8711
00671R,富邦NASDAQ反1,20,0,20,陽信-石牌,2023-06-30,8711
00720B,元大投資級公司債,20,0,20,陽信-石牌,2023-06-30,8711
2014,中鴻,20,0,20,陽信-石牌,2023-06-30,8711
2022,聚亨,20,0,20,陽信-石牌,2023-06-30,8711
4414,如興,40,20,20,陽信-石牌,2023-06-30,8711
6116,彩晶,20,0,20,陽信-石牌,2023-06-30,8711
6546,正基,20,0,20,陽信-石牌,2023-06-30,8711
2344,華邦電,21,2,19,陽信-石牌,2023-06-30,8711
8105,凌巨,30,12,18,陽信-石牌,2023-06-30,8711
2886,兆豐金,20,4,16,陽信-石牌,2023-06-30,8711
8033,雷虎,16,0,16,陽信-石牌,2023-06-30,8711
1907,永豐餘,15,0,15,陽信-石牌,2023-06-30,8711
00751B,元大AAA至A公司債,14,0,14,陽信-石牌,2023-06-30,8711
3034,聯詠,13,0,13,陽信-石牌,2023-06-30,8711
8097,常珵,12,0,12,陽信-石牌,2023-06-30,8711
4967,十銓,13,1,12,陽信-石牌,2023-06-30,8711
1609,大亞,41,30,11,陽信-石牌,2023-06-30,8711
2371,大同,88,77,11,陽信-石牌,2023-06-30,8711
1460,宏遠,20,10,10,陽信-石牌,2023-06-30,8711
1314,中石化,10,0,10,陽信-石牌,2023-06-30,8711
00795B,中信美國公債20年,10,0,10,陽信-石牌,2023-06-30,8711
1701,中化,10,0,10,陽信-石牌,2023-06-30,8711
1727,中華化,10,0,10,陽信-石牌,2023-06-30,8711
2399,映泰,10,0,10,陽信-石牌,2023-06-30,8711
3089,億杰,10,0,10,陽信-石牌,2023-06-30,8711
4142,國光生,10,0,10,陽信-石牌,2023-06-30,8711
4161,聿新科,20,10,10,陽信-石牌,2023-06-30,8711
6185,幃翔,10,0,10,陽信-石牌,2023-06-30,8711
6243,迅杰,11,1,10,陽信-石牌,2023-06-30,8711
6443,元晶,10,0,10,陽信-石牌,2023-06-30,8711
2356,英業達,33,24,9,陽信-石牌,2023-06-30,8711
3545,敦泰,9,0,9,陽信-石牌,2023-06-30,8711
2419,仲琦,15,7,8,陽信-石牌,2023-06-30,8711
00632R,元大台灣50反1,200,0,200,陽信-石牌,2023-07-03,8711
3518,柏騰,127,1,126,陽信-石牌,2023-07-03,8711
7402,邑錡,99,1,98,陽信-石牌,2023-07-03,8711
6279,胡連,61,1,60,陽信-石牌,2023-07-03,8711
3481,群創,52,1,51,陽信-石牌,2023-07-03,8711
00919,群益台灣精選高息,50,2,48,陽信-石牌,2023-07-03,8711
2637,慧洋-KY,49,5,44,陽信-石牌,2023-07-03,8711
3231,緯創,108,66,42,陽信-石牌,2023-07-03,8711
2610,華航,58,23,35,陽信-石牌,2023-07-03,8711
1219,福壽,36,2,34,陽信-石牌,2023-07-03,8711
2882,國泰金,33,0,33,陽信-石牌,2023-07-03,8711
4532,瑞智,33,0,33,陽信-石牌,2023-07-03,8711
3483,力致,33,1,32,陽信-石牌,2023-07-03,8711
1460,宏遠,37,10,27,陽信-石牌,2023-07-03,8711
6285,啟��,53,26,27,陽信-石牌,2023-07-03,8711
6166,凌華,26,1,25,陽信-石牌,2023-07-03,8711
1513,中興電,29,7,22,陽信-石牌,2023-07-03,8711
1217,愛之味,21,0,21,陽信-石牌,2023-07-03,8711
3049,精金,20,0,20,陽信-石牌,2023-07-03,8711
3652,精聯,21,1,20,陽信-石牌,2023-07-03,8711
6625,必應,20,0,20,陽信-石牌,2023-07-03,8711
2603,長榮,35,16,19,陽信-石牌,2023-07-03,8711
2337,旺宏,37,18,19,陽信-石牌,2023-07-03,8711
2883,凱基金,16,0,16,陽信-石牌,2023-07-03,8711
2419,仲琦,19,4,15,陽信-石牌,2023-07-03,8711
3044,健鼎,14,0,14,陽信-石牌,2023-07-03,8711
2331,精英,25,12,13,陽信-石牌,2023-07-03,8711
2913,農林,19,6,13,陽信-石牌,2023-07-03,8711
1795,美時,13,1,12,陽信-石牌,2023-07-03,8711
1789,神隆,12,0,12,陽信-石牌,2023-07-03,8711
2421,建準,14,2,12,陽信-石牌,2023-07-03,8711
3207,耀勝,17,5,12,陽信-石牌,2023-07-03,8711
1591,駿吉-KY,11,0,11,陽信-石牌,2023-07-03,8711
2344,華邦電,12,1,11,陽信-石牌,2023-07-03,8711
6190,萬泰科,11,0,11,陽信-石牌,2023-07-03,8711
00706L,期元大S＆P日圓正2,10,0,10,陽信-石牌,2023-07-03,8711
1802,台玻,10,0,10,陽信-石牌,2023-07-03,8711
2303,聯電,22,12,10,陽信-石牌,2023-07-03,8711
2809,京城銀,10,0,10,陽信-石牌,2023-07-03,8711
5533,皇鼎,10,0,10,陽信-石牌,2023-07-03,8711
6016,康和證,10,0,10,陽信-石牌,2023-07-03,8711
3711,日月光投控,9,0,9,陽信-石牌,2023-07-03,8711
4503,金雨,11,2,9,陽信-石牌,2023-07-03,8711
5534,長虹,9,0,9,陽信-石牌,2023-07-03,8711
2317,鴻海,32,24,8,陽信-石牌,2023-07-03,8711
1903,士紙,10,3,7,陽信-石牌,2023-07-03,8711
3017,奇鋐,8,1,7,陽信-石牌,2023-07-03,8711
4973,廣穎,10,3,7,陽信-石牌,2023-07-03,8711
9907,統一實,10,3,7,陽信-石牌,2023-07-03,8711
2030,彰源,6,0,6,陽信-石牌,2023-07-03,8711
0056,元大高股息,333,53,280,陽信-石牌,2023-07-04,8711
00715L,期街口布蘭特正2,165,0,165,陽信-石牌,2023-07-04,8711
1434,福懋,107,0,107,陽信-石牌,2023-07-04,8711
2880,華南金,104,0,104,陽信-石牌,2023-07-04,8711
3518,柏騰,90,0,90,陽信-石牌,2023-07-04,8711
00712,復華富時不動產,84,10,74,陽信-石牌,2023-07-04,8711
6438,迅得,66,5,61,陽信-石牌,2023-07-04,8711
2303,聯電,60,6,54,陽信-石牌,2023-07-04,8711
2362,藍天,50,0,50,陽信-石牌,2023-07-04,8711
00720B,元大投資級公司債,41,0,41,陽信-石牌,2023-07-04,8711
2352,佳世達,40,0,40,陽信-石牌,2023-07-04,8711
2312,金寶,71,35,36,陽信-石牌,2023-07-04,8711
2610,華航,125,91,34,陽信-石牌,2023-07-04,8711
00637L,元大滬深300正2,36,3,33,陽信-石牌,2023-07-04,8711
00929,復華台灣科技優息,41,10,31,陽信-石牌,2023-07-04,8711
00925,新光標普電動車,30,0,30,陽信-石牌,2023-07-04,8711
1584,精剛,80,50,30,陽信-石牌,2023-07-04,8711
2637,慧洋-KY,31,1,30,陽信-石牌,2023-07-04,8711
2906,高林,30,0,30,陽信-石牌,2023-07-04,8711
2883,凱基金,29,0,29,陽信-石牌,2023-07-04,8711
8016,矽創,30,1,29,陽信-石牌,2023-07-04,8711
2609,陽明,88,62,26,陽信-石牌,2023-07-04,8711
1810,和成,25,0,25,陽信-石牌,2023-07-04,8711
6126,信音,25,2,23,陽信-石牌,2023-07-04,8711
2344,華邦電,24,2,22,陽信-石牌,2023-07-04,8711
1310,台苯,20,0,20,陽信-石牌,2023-07-04,8711
6266,泰詠,20,0,20,陽信-石牌,2023-07-04,8711
1905,華紙,80,61,19,陽信-石牌,2023-07-04,8711
1217,愛之味,18,0,18,陽信-石牌,2023-07-04,8711
1513,中興電,25,9,16,陽信-石牌,2023-07-04,8711
6188,廣明,49,33,16,陽信-石牌,2023-07-04,8711
2801,彰銀,15,0,15,陽信-石牌,2023-07-04,8711
6112,邁達特,16,1,15,陽信-石牌,2023-07-04,8711
6148,驊宏資,15,0,15,陽信-石牌,2023-07-04,8711
1762,中化生,15,1,14,陽信-石牌,2023-07-04,8711
2317,鴻海,25,12,13,陽信-石牌,2023-07-04,8711
2607,榮運,20,7,13,陽信-石牌,2023-07-04,8711
6279,胡連,19,6,13,陽信-石牌,2023-07-04,8711
6546,正基,13,0,13,陽信-石牌,2023-07-04,8711
2204,中華,18,6,12,陽信-石牌,2023-07-04,8711
6120,達運,12,0,12,陽信-石牌,2023-07-04,8711
8088,品安,12,0,12,陽信-石牌,2023-07-04,8711
9907,統一實,12,0,12,陽信-石牌,2023-07-04,8711
2330,台積電,16,5,11,陽信-石牌,2023-07-04,8711
1109,信大,10,0,10,陽信-石牌,2023-07-04,8711
1529,樂事綠能,10,0,10,陽信-石牌,2023-07-04,8711
1907,永豐餘,19,9,10,陽信-石牌,2023-07-04,8711
2206,三陽工業,28,18,10,陽信-石牌,2023-07-04,8711
3041,揚智,10,0,10,陽信-石牌,2023-07-04,8711
3704,合勤控,15,5,10,陽信-石牌,2023-07-04,8711
2382,廣達,252,14,238,陽信-石牌,2023-07-05,8711
2609,陽明,271,135,136,陽信-石牌,2023-07-05,8711
2340,台亞,129,21,108,陽信-石牌,2023-07-05,8711
00632R,元大台灣50反1,105,0,105,陽信-石牌,2023-07-05,8711
0056,元大高股息,103,12,91,陽信-石牌,2023-07-05,8711
4919,新唐,102,18,84,陽信-石牌,2023-07-05,8711
9907,統一實,78,0,78,陽信-石牌,2023-07-05,8711
2610,華航,108,35,73,陽信-石牌,2023-07-05,8711
2883,凱基金,61,0,61,陽信-石牌,2023-07-05,8711
2211,長榮鋼,60,1,59,陽信-石牌,2023-07-05,8711
2618,長榮航,167,113,54,陽信-石牌,2023-07-05,8711
00882,中信中國高股息,50,0,50,陽信-石牌,2023-07-05,8711
6288,聯嘉,40,0,40,陽信-石牌,2023-07-05,8711
2402,毅嘉,134,99,35,陽信-石牌,2023-07-05,8711
3231,緯創,61,27,34,陽信-石牌,2023-07-05,8711
5347,世界,34,0,34,陽信-石牌,2023-07-05,8711
6438,迅得,33,0,33,陽信-石牌,2023-07-05,8711
2801,彰銀,32,2,30,陽信-石牌,2023-07-05,8711
8093,保銳,30,2,28,陽信-石牌,2023-07-05,8711
2329,華泰,34,8,26,陽信-石牌,2023-07-05,8711
2317,鴻海,32,7,25,陽信-石牌,2023-07-05,8711
2356,英業達,90,66,24,陽信-石牌,2023-07-05,8711
1460,宏遠,20,0,20,陽信-石牌,2023-07-05,8711
6139,亞翔,22,2,20,陽信-石牌,2023-07-05,8711
2881,富邦金,20,1,19,陽信-石牌,2023-07-05,8711
2330,台積電,18,0,18,陽信-石牌,2023-07-05,8711
2352,佳世達,20,2,18,陽信-石牌,2023-07-05,8711
3163,波若威,23,5,18,陽信-石牌,2023-07-05,8711
3372,典範,42,26,16,陽信-石牌,2023-07-05,8711
3564,其陽,20,4,16,陽信-石牌,2023-07-05,8711
3037,欣興,23,7,16,陽信-石牌,2023-07-05,8711
4128,中天,15,0,15,陽信-石牌,2023-07-05,8711
2206,三陽工業,14,0,14,陽信-石牌,2023-07-05,8711
2409,友達,16,2,14,陽信-石牌,2023-07-05,8711
2449,京元電子,23,9,14,陽信-石牌,2023-07-05,8711
2486,一詮,16,2,14,陽信-石牌,2023-07-05,8711
3346,麗清,14,0,14,陽信-石牌,2023-07-05,8711
1810,和成,21,8,13,陽信-石牌,2023-07-05,8711
3284,太普高,28,15,13,陽信-石牌,2023-07-05,8711
4904,遠傳,13,0,13,陽信-石牌,2023-07-05,8711
5871,中租-KY,12,0,12,陽信-石牌,2023-07-05,8711
1101,台泥,14,2,12,陽信-石牌,2023-07-05,8711
00878,國泰永續高股息,16,4,12,陽信-石牌,2023-07-05,8711
1522,堤維西,26,14,12,陽信-石牌,2023-07-05,8711
2880,華南金,12,0,12,陽信-石牌,2023-07-05,8711
6168,宏齊,12,0,12,陽信-石牌,2023-07-05,8711
4979,華星光,17,6,11,陽信-石牌,2023-07-05,8711
4746,台耀,11,0,11,陽信-石牌,2023-07-05,8711
5258,虹堡,11,0,11,陽信-石牌,2023-07-05,8711
3035,智原,22,11,11,陽信-石牌,2023-07-05,8711
00673R,期元大S＆P原油反1,333,0,333,陽信-石牌,2023-07-06,8711
2609,陽明,231,27,204,陽信-石牌,2023-07-06,8711
2340,台亞,215,56,159,陽信-石牌,2023-07-06,8711
8048,德勝,63,0,63,陽信-石牌,2023-07-06,8711
2409,友達,77,16,61,陽信-石牌,2023-07-06,8711
6282,康舒,66,15,51,陽信-石牌,2023-07-06,8711
3163,波若威,98,48,50,陽信-石牌,2023-07-06,8711
8099,大世科,50,0,50,陽信-石牌,2023-07-06,8711
2889,國票金,46,0,46,陽信-石牌,2023-07-06,8711
2801,彰銀,37,0,37,陽信-石牌,2023-07-06,8711
2880,華南金,36,0,36,陽信-石牌,2023-07-06,8711
00919,群益台灣精選高息,35,0,35,陽信-石牌,2023-07-06,8711
3015,全漢,35,0,35,陽信-石牌,2023-07-06,8711
00720B,元大投資級公司債,34,0,34,陽信-石牌,2023-07-06,8711
00882,中信中國高股息,32,0,32,陽信-石牌,2023-07-06,8711
2317,鴻海,34,4,30,陽信-石牌,2023-07-06,8711
2330,台積電,32,2,30,陽信-石牌,2023-07-06,8711
1471,首利,42,12,30,陽信-石牌,2023-07-06,8711
2329,華泰,37,7,30,陽信-石牌,2023-07-06,8711
8028,昇陽半導體,30,0,30,陽信-石牌,2023-07-06,8711
6139,亞翔,45,16,29,陽信-石牌,2023-07-06,8711
2610,華航,46,18,28,陽信-石牌,2023-07-06,8711
2303,聯電,35,10,25,陽信-石牌,2023-07-06,8711
6770,力積電,25,0,25,陽信-石牌,2023-07-06,8711
2887,台新金,24,0,24,陽信-石牌,2023-07-06,8711
8936,國統,35,11,24,陽信-石牌,2023-07-06,8711
5009,榮剛,55,32,23,陽信-石牌,2023-07-06,8711
1216,統一,22,0,22,陽信-石牌,2023-07-06,8711
2888,新光金,22,0,22,陽信-石牌,2023-07-06,8711
00907,永豐優息存股,20,0,20,陽信-石牌,2023-07-06,8711
1308,亞聚,20,0,20,陽信-石牌,2023-07-06,8711
1907,永豐餘,20,0,20,陽信-石牌,2023-07-06,8711
2427,三商電,39,19,20,陽信-石牌,2023-07-06,8711
5876,上海商銀,20,0,20,陽信-石牌,2023-07-06,8711
1301,台塑,19,0,19,陽信-石牌,2023-07-06,8711
1101,台泥,20,1,19,陽信-石牌,2023-07-06,8711
8050,廣積,18,0,18,陽信-石牌,2023-07-06,8711
8215,明基材,24,6,18,陽信-石牌,2023-07-06,8711
2371,大同,25,8,17,陽信-石牌,2023-07-06,8711
3308,聯德,16,0,16,陽信-石牌,2023-07-06,8711
4960,誠美材,17,1,16,陽信-石牌,2023-07-06,8711
2538,基泰,15,0,15,陽信-石牌,2023-07-06,8711
6285,啟��,30,15,15,陽信-石牌,2023-07-06,8711
3037,欣興,17,3,14,陽信-石牌,2023-07-06,8711
2402,毅嘉,53,39,14,陽信-石牌,2023-07-06,8711
4566,時碩工業,25,11,14,陽信-石牌,2023-07-06,8711
00712,復華富時不動產,13,0,13,陽信-石牌,2023-07-06,8711
3372,典範,15,2,13,陽信-石牌,2023-07-06,8711
2882,國泰金,13,0,13,陽信-石牌,2023-07-06,8711
2457,飛宏,25,13,12,陽信-石牌,2023-07-06,8711
3481,群創,239,7,232,陽信-石牌,2023-07-07,8711
00878,國泰永續高股息,189,0,189,陽信-石牌,2023-07-07,8711
00882,中信中國高股息,104,0,104,陽信-石牌,2023-07-07,8711
8093,保銳,101,4,97,陽信-石牌,2023-07-07,8711
3163,波若威,274,192,82,陽信-石牌,2023-07-07,8711
2409,友達,72,1,71,陽信-石牌,2023-07-07,8711
2406,國碩,70,0,70,陽信-石牌,2023-07-07,8711
00919,群益台灣精選高息,57,0,57,陽信-石牌,2023-07-07,8711
6116,彩晶,47,0,47,陽信-石牌,2023-07-07,8711
2880,華南金,46,0,46,陽信-石牌,2023-07-07,8711
2344,華邦電,50,9,41,陽信-石牌,2023-07-07,8711
3032,偉訓,42,1,41,陽信-石牌,2023-07-07,8711
00927,群益半導體收益,39,0,39,陽信-石牌,2023-07-07,8711
1905,華紙,35,2,33,陽信-石牌,2023-07-07,8711
2425,承啟,33,2,31,陽信-石牌,2023-07-07,8711
00671R,富邦NASDAQ反1,30,0,30,陽信-石牌,2023-07-07,8711
2897,王道銀行,30,0,30,陽信-石牌,2023-07-07,8711
2634,漢翔,25,0,25,陽信-石牌,2023-07-07,8711
2637,慧洋-KY,25,0,25,陽信-石牌,2023-07-07,8711
00929,復華台灣科技優息,23,0,23,陽信-石牌,2023-07-07,8711
00713,元大台灣高息低波,24,2,22,陽信-石牌,2023-07-07,8711
1626,艾美特-KY,22,0,22,陽信-石牌,2023-07-07,8711
1301,台塑,21,0,21,陽信-石牌,2023-07-07,8711
2618,長榮航,61,40,21,陽信-石牌,2023-07-07,8711
00687B,國泰20年美債,20,0,20,陽信-石牌,2023-07-07,8711
9904,寶成,20,0,20,陽信-石牌,2023-07-07,8711
2383,台光電,19,0,19,陽信-石牌,2023-07-07,8711
6288,聯嘉,24,7,17,陽信-石牌,2023-07-07,8711
2371,大同,29,13,16,陽信-石牌,2023-07-07,8711
2883B,凱基金乙特,16,0,16,陽信-石牌,2023-07-07,8711
6164,華興,16,0,16,陽信-石牌,2023-07-07,8711
1605,華新,16,1,15,陽信-石牌,2023-07-07,8711
6532,瑞耘,15,0,15,陽信-石牌,2023-07-07,8711
8050,廣積,14,0,14,陽信-石牌,2023-07-07,8711
00720B,元大投資級公司債,13,0,13,陽信-石牌,2023-07-07,8711
1711,永光,13,0,13,陽信-石牌,2023-07-07,8711
6285,啟��,23,10,13,陽信-石牌,2023-07-07,8711
00712,復華富時不動產,12,0,12,陽信-石牌,2023-07-07,8711
3372,典範,12,0,12,陽信-石牌,2023-07-07,8711
4157,太景*-KY,12,0,12,陽信-石牌,2023-07-07,8711
8016,矽創,12,0,12,陽信-石牌,2023-07-07,8711
8358,金居,12,0,12,陽信-石牌,2023-07-07,8711
2301,光寶科,12,0,12,陽信-石牌,2023-07-07,8711
1609,大亞,23,12,11,陽信-石牌,2023-07-07,8711
6550,北極星藥業-KY,13,2,11,陽信-石牌,2023-07-07,8711
9933,中鼎,11,0,11,陽信-石牌,2023-07-07,8711
1308,亞聚,10,0,10,陽信-石牌,2023-07-07,8711
1810,和成,16,6,10,陽信-石牌,2023-07-07,8711
2010,春源,20,10,10,陽信-石牌,2023-07-07,8711
2601,益航,10,0,10,陽信-石牌,2023-07-07,8711
2609,陽明,457,6,451,陽信-石牌,2023-07-10,8711
00673R,期元大S＆P原油反1,329,0,329,陽信-石牌,2023-07-10,8711
6288,聯嘉,132,5,127,陽信-石牌,2023-07-10,8711
2883,凱基金,103,0,103,陽信-石牌,2023-07-10,8711
00680L,元大美債20正2,50,0,50,陽信-石牌,2023-07-10,8711
9933,中鼎,50,0,50,陽信-石牌,2023-07-10,8711
2884,玉山金,51,3,48,陽信-石牌,2023-07-10,8711
2340,台亞,60,13,47,陽信-石牌,2023-07-10,8711
3163,波若威,91,49,42,陽信-石牌,2023-07-10,8711
4532,瑞智,65,25,40,陽信-石牌,2023-07-10,8711
3078,僑威,35,0,35,陽信-石牌,2023-07-10,8711
2610,華航,50,16,34,陽信-石牌,2023-07-10,8711
2834,臺企銀,32,0,32,陽信-石牌,2023-07-10,8711
1529,樂事綠能,31,0,31,陽信-石牌,2023-07-10,8711
2356,英業達,55,24,31,陽信-石牌,2023-07-10,8711
2605,新興,30,0,30,陽信-石牌,2023-07-10,8711
00720B,元大投資級公司債,24,0,24,陽信-石牌,2023-07-10,8711
3666,光耀,22,0,22,陽信-石牌,2023-07-10,8711
2380,虹光,21,0,21,陽信-石牌,2023-07-10,8711
00706L,期元大S＆P日圓正2,20,0,20,陽信-石牌,2023-07-10,8711
3346,麗清,50,33,17,陽信-石牌,2023-07-10,8711
2419,仲琦,26,9,17,陽信-石牌,2023-07-10,8711
00632R,元大台灣50反1,40,25,15,陽信-石牌,2023-07-10,8711
00882,中信中國高股息,17,2,15,陽信-石牌,2023-07-10,8711
3228,金麗科,15,0,15,陽信-石牌,2023-07-10,8711
4303,信立,15,0,15,陽信-石牌,2023-07-10,8711
4707,磐亞,15,0,15,陽信-石牌,2023-07-10,8711
4726,永昕,15,0,15,陽信-石牌,2023-07-10,8711
6120,達運,43,28,15,陽信-石牌,2023-07-10,8711
2106,建大,14,0,14,陽信-石牌,2023-07-10,8711
2634,漢翔,30,16,14,陽信-石牌,2023-07-10,8711
3231,緯創,71,57,14,陽信-石牌,2023-07-10,8711
1528,恩德,13,0,13,陽信-石牌,2023-07-10,8711
2412,中華電,13,0,13,陽信-石牌,2023-07-10,8711
4130,健亞,13,0,13,陽信-石牌,2023-07-10,8711
8215,明基材,24,11,13,陽信-石牌,2023-07-10,8711
1101,台泥,12,0,12,陽信-石牌,2023-07-10,8711
00795B,中信美國公債20年,12,0,12,陽信-石牌,2023-07-10,8711
2618,長榮航,40,28,12,陽信-石牌,2023-07-10,8711
3673,TPK-KY,12,0,12,陽信-石牌,2023-07-10,8711
1609,大亞,57,46,11,陽信-石牌,2023-07-10,8711
3047,訊舟,11,0,11,陽信-石牌,2023-07-10,8711
6770,力積電,11,0,11,陽信-石牌,2023-07-10,8711
00687B,國泰20年美債,10,0,10,陽信-石牌,2023-07-10,8711
00927,群益半導體收益,10,0,10,陽信-石牌,2023-07-10,8711
1711,永光,10,0,10,陽信-石牌,2023-07-10,8711
2633,台灣高鐵,10,0,10,陽信-石牌,2023-07-10,8711
6147,頎邦,10,0,10,陽信-石牌,2023-07-10,8711
6209,今國光,10,0,10,陽信-石牌,2023-07-10,8711
6215,和椿,10,0,10,陽信-石牌,2023-07-10,8711
2340,台亞,118,33,85,陽信-石牌,2023-07-11,8711
2425,承啟,58,4,54,陽信-石牌,2023-07-11,8711
00632R,元大台灣50反1,50,0,50,陽信-石牌,2023-07-11,8711
2609,陽明,89,40,49,陽信-石牌,2023-07-11,8711
3711,日月光投控,46,0,46,陽信-石牌,2023-07-11,8711
3518,柏騰,45,5,40,陽信-石牌,2023-07-11,8711
9904,寶成,40,0,40,陽信-石牌,2023-07-11,8711
0050,元大台灣50,35,0,35,陽信-石牌,2023-07-11,8711
5876,上海商銀,30,0,30,陽信-石牌,2023-07-11,8711
8048,德勝,30,1,29,陽信-石牌,2023-07-11,8711
3163,波若威,35,8,27,陽信-石牌,2023-07-11,8711
2371,大同,53,27,26,陽信-石牌,2023-07-11,8711
2312,金寶,29,4,25,陽信-石牌,2023-07-11,8711
6182,合晶,45,21,24,陽信-石牌,2023-07-11,8711
1101,台泥,26,3,23,陽信-石牌,2023-07-11,8711
2323,中環,62,39,23,陽信-石牌,2023-07-11,8711
4532,瑞智,137,115,22,陽信-石牌,2023-07-11,8711
6288,聯嘉,39,17,22,陽信-石牌,2023-07-11,8711
1444,力麗,20,0,20,陽信-石牌,2023-07-11,8711
00722B,群益投資級電信債,20,0,20,陽信-石牌,2023-07-11,8711
2022,聚亨,20,0,20,陽信-石牌,2023-07-11,8711
2884,玉山金,20,0,20,陽信-石牌,2023-07-11,8711
2890,永豐金,20,0,20,陽信-石牌,2023-07-11,8711
2301,光寶科,31,11,20,陽信-石牌,2023-07-11,8711
6142,友勁,18,0,18,陽信-石牌,2023-07-11,8711
3346,麗清,23,5,18,陽信-石牌,2023-07-11,8711
2332,友訊,17,0,17,陽信-石牌,2023-07-11,8711
3058,立德,22,5,17,陽信-石牌,2023-07-11,8711
4130,健亞,17,0,17,陽信-石牌,2023-07-11,8711
3016,嘉晶,16,0,16,陽信-石牌,2023-07-11,8711
3706,神達,50,34,16,陽信-石牌,2023-07-11,8711
1522,堤維西,15,0,15,陽信-石牌,2023-07-11,8711
1605,華新,21,6,15,陽信-石牌,2023-07-11,8711
1810,和成,15,0,15,陽信-石牌,2023-07-11,8711
3707,漢磊,18,3,15,陽信-石牌,2023-07-11,8711
00929,復華台灣科技優息,14,0,14,陽信-石牌,2023-07-11,8711
3025,星通,30,16,14,陽信-石牌,2023-07-11,8711
2459,敦吉,13,0,13,陽信-石牌,2023-07-11,8711
3022,威強電,16,3,13,陽信-石牌,2023-07-11,8711
3374,精材,13,0,13,陽信-石牌,2023-07-11,8711
6531,愛普*,14,1,13,陽信-石牌,2023-07-11,8711
1603,華電,13,1,12,陽信-石牌,2023-07-11,8711
2427,三商電,93,81,12,陽信-石牌,2023-07-11,8711
2376,技嘉,21,10,11,陽信-石牌,2023-07-11,8711
3114,好德,11,0,11,陽信-石牌,2023-07-11,8711
3265,台星科,14,3,11,陽信-石牌,2023-07-11,8711
6266,泰詠,11,0,11,陽信-石牌,2023-07-11,8711
1314,中石化,10,0,10,陽信-石牌,2023-07-11,8711
1802,台玻,10,0,10,陽信-石牌,2023-07-11,8711
1808,潤隆,10,0,10,陽信-石牌,2023-07-11,8711
00673R,期元大S＆P原油反1,317,0,317,陽信-石牌,2023-07-12,8711
2481,強茂,217,21,196,陽信-石牌,2023-07-12,8711
00632R,元大台灣50反1,140,0,140,陽信-石牌,2023-07-12,8711
2349,錸德,100,0,100,陽信-石牌,2023-07-12,8711
3374,精材,100,7,93,陽信-石牌,2023-07-12,8711
0056,元大高股息,96,18,78,陽信-石牌,2023-07-12,8711
2603,長榮,108,31,77,陽信-石牌,2023-07-12,8711
2609,陽明,91,15,76,陽信-石牌,2023-07-12,8711
2887,台新金,56,0,56,陽信-石牌,2023-07-12,8711
2888,新光金,54,0,54,陽信-石牌,2023-07-12,8711
2323,中環,50,3,47,陽信-石牌,2023-07-12,8711
2409,友達,60,16,44,陽信-石牌,2023-07-12,8711
2211,長榮鋼,40,0,40,陽信-石牌,2023-07-12,8711
2303,聯電,41,3,38,陽信-石牌,2023-07-12,8711
2356,英業達,137,101,36,陽信-石牌,2023-07-12,8711
6182,合晶,48,13,35,陽信-石牌,2023-07-12,8711
1907,永豐餘,32,1,31,陽信-石牌,2023-07-12,8711
2352,佳世達,34,4,30,陽信-石牌,2023-07-12,8711
1611,中電,25,0,25,陽信-石牌,2023-07-12,8711
3078,僑威,29,5,24,陽信-石牌,2023-07-12,8711
1905,華紙,27,5,22,陽信-石牌,2023-07-12,8711
00895,富邦未來車,20,0,20,陽信-石牌,2023-07-12,8711
1313,聯成,20,0,20,陽信-石牌,2023-07-12,8711
2884,玉山金,20,0,20,陽信-石牌,2023-07-12,8711
2637,慧洋-KY,20,1,19,陽信-石牌,2023-07-12,8711
6283,淳安,18,0,18,陽信-石牌,2023-07-12,8711
6288,聯嘉,18,0,18,陽信-石牌,2023-07-12,8711
2444,兆勁,19,3,16,陽信-石牌,2023-07-12,8711
6160,欣技,15,0,15,陽信-石牌,2023-07-12,8711
6285,啟��,40,25,15,陽信-石牌,2023-07-12,8711
2883,凱基金,21,7,14,陽信-石牌,2023-07-12,8711
6278,台表科,13,0,13,陽信-石牌,2023-07-12,8711
8086,宏捷科,13,0,13,陽信-石牌,2023-07-12,8711
2486,一詮,22,10,12,陽信-石牌,2023-07-12,8711
4157,太景*-KY,15,3,12,陽信-石牌,2023-07-12,8711
5009,榮剛,12,0,12,陽信-石牌,2023-07-12,8711
1815,富喬,11,0,11,陽信-石牌,2023-07-12,8711
1904,正隆,11,0,11,陽信-石牌,2023-07-12,8711
6164,華興,11,0,11,陽信-石牌,2023-07-12,8711
8033,雷虎,11,0,11,陽信-石牌,2023-07-12,8711
00722B,群益投資級電信債,10,0,10,陽信-石牌,2023-07-12,8711
2412,中華電,10,0,10,陽信-石牌,2023-07-12,8711
2427,三商電,14,4,10,陽信-石牌,2023-07-12,8711
2449,京元電子,12,2,10,陽信-石牌,2023-07-12,8711
2489,瑞軒,10,0,10,陽信-石牌,2023-07-12,8711
2881,富邦金,12,2,10,陽信-石牌,2023-07-12,8711
4726,永昕,10,0,10,陽信-石牌,2023-07-12,8711
6112,邁達特,10,0,10,陽信-石牌,2023-07-12,8711
6139,亞翔,22,12,10,陽信-石牌,2023-07-12,8711
6215,和椿,10,0,10,陽信-石牌,2023-07-12,8711
7402,邑錡,180,11,169,陽信-石牌,2023-07-13,8711
3228,金麗科,129,1,128,陽信-石牌,2023-07-13,8711
2618,長榮航,147,32,115,陽信-石牌,2023-07-13,8711
6190,萬泰科,100,1,99,陽信-石牌,2023-07-13,8711
2610,華航,136,48,88,陽信-石牌,2023-07-13,8711
2211,長榮鋼,71,0,71,陽信-石牌,2023-07-13,8711
2497,怡利電,73,3,70,陽信-石牌,2023-07-13,8711
3025,星通,66,8,58,陽信-石牌,2023-07-13,8711
2481,強茂,66,13,53,陽信-石牌,2023-07-13,8711
2637,慧洋-KY,53,0,53,陽信-石牌,2023-07-13,8711
6689,伊雲谷,100,49,51,陽信-石牌,2023-07-13,8711
2812,台中銀,50,0,50,陽信-石牌,2023-07-13,8711
00930,永豐ESG低碳高息,46,0,46,陽信-石牌,2023-07-13,8711
2883,凱基金,43,0,43,陽信-石牌,2023-07-13,8711
00895,富邦未來車,40,0,40,陽信-石牌,2023-07-13,8711
2352,佳世達,53,13,40,陽信-石牌,2023-07-13,8711
3217,優群,41,2,39,陽信-石牌,2023-07-13,8711
2609,陽明,72,36,36,陽信-石牌,2023-07-13,8711
0050,元大台灣50,40,5,35,陽信-石牌,2023-07-13,8711
2382,廣達,63,31,32,陽信-石牌,2023-07-13,8711
6120,達運,52,21,31,陽信-石牌,2023-07-13,8711
2353,宏��,71,41,30,陽信-石牌,2023-07-13,8711
00929,復華台灣科技優息,27,0,27,陽信-石牌,2023-07-13,8711
4743,合一,27,1,26,陽信-石牌,2023-07-13,8711
2603,長榮,39,15,24,陽信-石牌,2023-07-13,8711
1789,神隆,38,14,24,陽信-石牌,2023-07-13,8711
1101,台泥,24,2,22,陽信-石牌,2023-07-13,8711
4934,太極,22,0,22,陽信-石牌,2023-07-13,8711
3231,緯創,100,79,21,陽信-石牌,2023-07-13,8711
1905,華紙,26,5,21,陽信-石牌,2023-07-13,8711
2421,建準,26,5,21,陽信-石牌,2023-07-13,8711
1444,力麗,20,0,20,陽信-石牌,2023-07-13,8711
2897,王道銀行,20,0,20,陽信-石牌,2023-07-13,8711
3346,麗清,28,8,20,陽信-石牌,2023-07-13,8711
2380,虹光,20,2,18,陽信-石牌,2023-07-13,8711
5483,中美晶,18,2,16,陽信-石牌,2023-07-13,8711
3711,日月光投控,16,2,14,陽信-石牌,2023-07-13,8711
2367,燿華,13,0,13,陽信-石牌,2023-07-13,8711
3037,欣興,71,58,13,陽信-石牌,2023-07-13,8711
8038,長園科,13,0,13,陽信-石牌,2023-07-13,8711
2498,宏達電,19,7,12,陽信-石牌,2023-07-13,8711
8210,勤誠,15,4,11,陽信-石牌,2023-07-13,8711
2303,聯電,15,4,11,陽信-石牌,2023-07-13,8711
2457,飛宏,13,2,11,陽信-石牌,2023-07-13,8711
3078,僑威,32,21,11,陽信-石牌,2023-07-13,8711
3666,光耀,11,0,11,陽信-石牌,2023-07-13,8711
4919,新唐,11,0,11,陽信-石牌,2023-07-13,8711
4967,十銓,20,9,11,陽信-石牌,2023-07-13,8711
5443,均豪,11,0,11,陽信-石牌,2023-07-13,8711
6282,康舒,40,30,10,陽信-石牌,2023-07-13,8711
00919,群益台灣精選高息,1035,42,993,陽信-石牌,2023-07-14,8711
00673R,期元大S＆P原油反1,238,0,238,陽信-石牌,2023-07-14,8711
2610,華航,212,87,125,陽信-石牌,2023-07-14,8711
6288,聯嘉,94,1,93,陽信-石牌,2023-07-14,8711
3363,上詮,66,6,60,陽信-石牌,2023-07-14,8711
00905,FT臺灣Smart,50,0,50,陽信-石牌,2023-07-14,8711
2102,泰豐,50,1,49,陽信-石牌,2023-07-14,8711
2014,中鴻,45,0,45,陽信-石牌,2023-07-14,8711
3706,神達,57,19,38,陽信-石牌,2023-07-14,8711
00715L,期街口布蘭特正2,141,104,37,陽信-石牌,2023-07-14,8711
00720B,元大投資級公司債,35,0,35,陽信-石牌,2023-07-14,8711
2368,金像電,38,3,35,陽信-石牌,2023-07-14,8711
2382,廣達,116,82,34,陽信-石牌,2023-07-14,8711
3704,合勤控,50,16,34,陽信-石牌,2023-07-14,8711
2497,怡利電,31,0,31,陽信-石牌,2023-07-14,8711
2812,台中銀,30,0,30,陽信-石牌,2023-07-14,8711
4533,協易機,45,15,30,陽信-石牌,2023-07-14,8711
2444,兆勁,28,0,28,陽信-石牌,2023-07-14,8711
2618,長榮航,133,105,28,陽信-石牌,2023-07-14,8711
6139,亞翔,27,1,26,陽信-石牌,2023-07-14,8711
3521,鴻翊,25,0,25,陽信-石牌,2023-07-14,8711
00929,復華台灣科技優息,29,7,22,陽信-石牌,2023-07-14,8711
2358,廷鑫,21,0,21,陽信-石牌,2023-07-14,8711
4953,緯軟,27,6,21,陽信-石牌,2023-07-14,8711
00651R,復華香港反1,20,0,20,陽信-石牌,2023-07-14,8711
4960,誠美材,20,0,20,陽信-石牌,2023-07-14,8711
2383,台光電,18,0,18,陽信-石牌,2023-07-14,8711
6245,立端,23,6,17,陽信-石牌,2023-07-14,8711
2883,凱基金,16,0,16,陽信-石牌,2023-07-14,8711
6279,胡連,16,0,16,陽信-石牌,2023-07-14,8711
3594,磐儀,30,15,15,陽信-石牌,2023-07-14,8711
2498,宏達電,20,6,14,陽信-石牌,2023-07-14,8711
2881,富邦金,15,1,14,陽信-石牌,2023-07-14,8711
4934,太極,14,0,14,陽信-石牌,2023-07-14,8711
3533,嘉澤,12,0,12,陽信-石牌,2023-07-14,8711
4532,瑞智,30,18,12,陽信-石牌,2023-07-14,8711
6120,達運,22,10,12,陽信-石牌,2023-07-14,8711
1514,亞力,22,11,11,陽信-石牌,2023-07-14,8711
3189,景碩,12,1,11,陽信-石牌,2023-07-14,8711
1229,聯華,10,0,10,陽信-石牌,2023-07-14,8711
1314,中石化,10,0,10,陽信-石牌,2023-07-14,8711
1611,中電,10,0,10,陽信-石牌,2023-07-14,8711
1725,元禎,10,0,10,陽信-石牌,2023-07-14,8711
2208,台船,10,0,10,陽信-石牌,2023-07-14,8711
2329,華泰,202,192,10,陽信-石牌,2023-07-14,8711
5425,台半,11,1,10,陽信-石牌,2023-07-14,8711
8016,矽創,10,0,10,陽信-石牌,2023-07-14,8711
8034,榮群,10,0,10,陽信-石牌,2023-07-14,8711
8038,長園科,10,0,10,陽信-石牌,2023-07-14,8711
8092,建暐,10,0,10,陽信-石牌,2023-07-14,8711
2882,國泰金,332,34,298,陽信-石牌,2023-07-17,8711
00929,復華台灣科技優息,259,5,254,陽信-石牌,2023-07-17,8711
2211,長榮鋼,131,1,130,陽信-石牌,2023-07-17,8711
3362,先進光,103,5,98,陽信-石牌,2023-07-17,8711
00905,FT臺灣Smart,50,0,50,陽信-石牌,2023-07-17,8711
6451,訊芯-KY,50,0,50,陽信-石牌,2023-07-17,8711
2312,金寶,58,9,49,陽信-石牌,2023-07-17,8711
2883,凱基金,143,100,43,陽信-石牌,2023-07-17,8711
2371,大同,74,35,39,陽信-石牌,2023-07-17,8711
3481,群創,87,48,39,陽信-石牌,2023-07-17,8711
2340,台亞,75,37,38,陽信-石牌,2023-07-17,8711
6188,廣明,42,4,38,陽信-石牌,2023-07-17,8711
3706,神達,39,7,32,陽信-石牌,2023-07-17,8711
2328,廣宇,31,0,31,陽信-石牌,2023-07-17,8711
3324,雙鴻,31,1,30,陽信-石牌,2023-07-17,8711
2887,台新金,35,6,29,陽信-石牌,2023-07-17,8711
2356,英業達,40,14,26,陽信-石牌,2023-07-17,8711
2498,宏達電,25,0,25,陽信-石牌,2023-07-17,8711
3037,欣興,37,12,25,陽信-石牌,2023-07-17,8711
5425,台半,33,8,25,陽信-石牌,2023-07-17,8711
8096,擎亞,25,0,25,陽信-石牌,2023-07-17,8711
2323,中環,35,13,22,陽信-石牌,2023-07-17,8711
6279,胡連,20,0,20,陽信-石牌,2023-07-17,8711
9904,寶成,20,0,20,陽信-石牌,2023-07-17,8711
4938,和碩,31,12,19,陽信-石牌,2023-07-17,8711
00878,國泰永續高股息,68,50,18,陽信-石牌,2023-07-17,8711
2618,長榮航,76,60,16,陽信-石牌,2023-07-17,8711
5439,高技,18,2,16,陽信-石牌,2023-07-17,8711
8011,台通,17,2,15,陽信-石牌,2023-07-17,8711
1611,中電,15,0,15,陽信-石牌,2023-07-17,8711
3027,盛達,15,0,15,陽信-石牌,2023-07-17,8711
3231,緯創,23,8,15,陽信-石牌,2023-07-17,8711
2014,中鴻,15,1,14,陽信-石牌,2023-07-17,8711
2402,毅嘉,16,2,14,陽信-石牌,2023-07-17,8711
3540,曜越,20,6,14,陽信-石牌,2023-07-17,8711
3704,合勤控,24,10,14,陽信-石牌,2023-07-17,8711
6243,迅杰,20,6,14,陽信-石牌,2023-07-17,8711
1101,台泥,12,0,12,陽信-石牌,2023-07-17,8711
3011,今皓,13,1,12,陽信-石牌,2023-07-17,8711
8936,國統,15,3,12,陽信-石牌,2023-07-17,8711
3265,台星科,12,1,11,陽信-石牌,2023-07-17,8711
00885,富邦越南,11,0,11,陽信-石牌,2023-07-17,8711
2301,光寶科,31,20,11,陽信-石牌,2023-07-17,8711
3306,鼎天,13,2,11,陽信-石牌,2023-07-17,8711
3617,碩天,11,0,11,陽信-石牌,2023-07-17,8711
6153,嘉聯益,14,3,11,陽信-石牌,2023-07-17,8711
6197,佳必琪,12,1,11,陽信-石牌,2023-07-17,8711
00850,元大臺灣ESG永續,10,0,10,陽信-石牌,2023-07-17,8711
1444,力麗,10,0,10,陽信-石牌,2023-07-17,8711
1718,中纖,10,0,10,陽信-石牌,2023-07-17,8711
00929,復華台灣科技優息,393,0,393,陽信-石牌,2023-07-18,8711
2388,威盛,168,1,167,陽信-石牌,2023-07-18,8711
00927,群益半導體收益,114,0,114,陽信-石牌,2023-07-18,8711
2312,金寶,165,67,98,陽信-石牌,2023-07-18,8711
2883,凱基金,108,10,98,陽信-石牌,2023-07-18,8711
2449,京元電子,134,53,81,陽信-石牌,2023-07-18,8711
2880,華南金,80,0,80,陽信-石牌,2023-07-18,8711
6116,彩晶,105,44,61,陽信-石牌,2023-07-18,8711
2892,第一金,52,0,52,陽信-石牌,2023-07-18,8711
6282,康舒,126,83,43,陽信-石牌,2023-07-18,8711
2889,國票金,42,0,42,陽信-石牌,2023-07-18,8711
0056,元大高股息,61,22,39,陽信-石牌,2023-07-18,8711
3078,僑威,60,22,38,陽信-石牌,2023-07-18,8711
6194,育富,36,1,35,陽信-石牌,2023-07-18,8711
00882,中信中國高股息,34,0,34,陽信-石牌,2023-07-18,8711
2324,仁寶,65,31,34,陽信-石牌,2023-07-18,8711
6288,聯嘉,31,0,31,陽信-石牌,2023-07-18,8711
1504,東元,51,21,30,陽信-石牌,2023-07-18,8711
2102,泰豐,30,0,30,陽信-石牌,2023-07-18,8711
3455,由田,29,0,29,陽信-石牌,2023-07-18,8711
2329,華泰,113,87,26,陽信-石牌,2023-07-18,8711
4938,和碩,56,31,25,陽信-石牌,2023-07-18,8711
1609,大亞,64,39,25,陽信-石牌,2023-07-18,8711
2498,宏達電,25,0,25,陽信-石牌,2023-07-18,8711
3057,喬鼎,32,7,25,陽信-石牌,2023-07-18,8711
2520,冠德,24,0,24,陽信-石牌,2023-07-18,8711
3706,神達,117,93,24,陽信-石牌,2023-07-18,8711
1514,亞力,31,8,23,陽信-石牌,2023-07-18,8711
2356,英業達,157,135,22,陽信-石牌,2023-07-18,8711
2344,華邦電,23,1,22,陽信-石牌,2023-07-18,8711
2427,三商電,77,55,22,陽信-石牌,2023-07-18,8711
2330,台積電,22,0,22,陽信-石牌,2023-07-18,8711
1789,神隆,28,7,21,陽信-石牌,2023-07-18,8711
2349,錸德,21,0,21,陽信-石牌,2023-07-18,8711
3346,麗清,22,1,21,陽信-石牌,2023-07-18,8711
1444,力麗,20,0,20,陽信-石牌,2023-07-18,8711
2409,友達,20,0,20,陽信-石牌,2023-07-18,8711
2888,新光金,20,0,20,陽信-石牌,2023-07-18,8711
7402,邑錡,20,0,20,陽信-石牌,2023-07-18,8711
2371,大同,43,24,19,陽信-石牌,2023-07-18,8711
2402,毅嘉,30,11,19,陽信-石牌,2023-07-18,8711
8068,全達,18,0,18,陽信-石牌,2023-07-18,8711
2353,宏��,69,51,18,陽信-石牌,2023-07-18,8711
2481,強茂,123,106,17,陽信-石牌,2023-07-18,8711
2201,裕隆,23,7,16,陽信-石牌,2023-07-18,8711
00720B,元大投資級公司債,16,0,16,陽信-石牌,2023-07-18,8711
1907,永豐餘,16,0,16,陽信-石牌,2023-07-18,8711
1905,華紙,28,13,15,陽信-石牌,2023-07-18,8711
6188,廣明,47,32,15,陽信-石牌,2023-07-18,8711
2313,華通,67,53,14,陽信-石牌,2023-07-18,8711
3481,群創,916,20,896,陽信-石牌,2023-07-19,8711
00673R,期元大S＆P原油反1,233,0,233,陽信-石牌,2023-07-19,8711
2409,友達,121,1,120,陽信-石牌,2023-07-19,8711
2882,國泰金,118,31,87,陽信-石牌,2023-07-19,8711
2481,強茂,82,2,80,陽信-石牌,2023-07-19,8711
2610,華航,99,46,53,陽信-石牌,2023-07-19,8711
2355,敬鵬,50,0,50,陽信-石牌,2023-07-19,8711
2707,晶華,50,0,50,陽信-石牌,2023-07-19,8711
2887,台新金,50,0,50,陽信-石牌,2023-07-19,8711
3707,漢磊,50,0,50,陽信-石牌,2023-07-19,8711
6257,矽格,51,7,44,陽信-石牌,2023-07-19,8711
1444,力麗,40,0,40,陽信-石牌,2023-07-19,8711
6190,萬泰科,40,0,40,陽信-石牌,2023-07-19,8711
00713,元大台灣高息低波,36,0,36,陽信-石牌,2023-07-19,8711
2324,仁寶,53,18,35,陽信-石牌,2023-07-19,8711
2637,慧洋-KY,42,8,34,陽信-石牌,2023-07-19,8711
2880,華南金,32,0,32,陽信-石牌,2023-07-19,8711
6182,合晶,32,0,32,陽信-石牌,2023-07-19,8711
3071,協禧,34,3,31,陽信-石牌,2023-07-19,8711
4938,和碩,40,10,30,陽信-石牌,2023-07-19,8711
9105,泰金寶-DR,30,0,30,陽信-石牌,2023-07-19,8711
3032,偉訓,40,12,28,陽信-石牌,2023-07-19,8711
6218,豪勉,28,0,28,陽信-石牌,2023-07-19,8711
8048,德勝,29,1,28,陽信-石牌,2023-07-19,8711
2618,長榮航,60,33,27,陽信-石牌,2023-07-19,8711
6124,業強,28,1,27,陽信-石牌,2023-07-19,8711
00669R,國泰美國道瓊反1,23,0,23,陽信-石牌,2023-07-19,8711
2515,中工,23,0,23,陽信-石牌,2023-07-19,8711
6188,廣明,29,7,22,陽信-石牌,2023-07-19,8711
00930,永豐ESG低碳高息,21,0,21,陽信-石牌,2023-07-19,8711
2888,新光金,20,0,20,陽信-石牌,2023-07-19,8711
00753L,中信中國50正2,20,0,20,陽信-石牌,2023-07-19,8711
2425,承啟,30,10,20,陽信-石牌,2023-07-19,8711
2489,瑞軒,20,0,20,陽信-石牌,2023-07-19,8711
2881,富邦金,23,3,20,陽信-石牌,2023-07-19,8711
3037,欣興,88,68,20,陽信-石牌,2023-07-19,8711
3078,僑威,28,8,20,陽信-石牌,2023-07-19,8711
4960,誠美材,20,0,20,陽信-石牌,2023-07-19,8711
9904,寶成,20,0,20,陽信-石牌,2023-07-19,8711
2313,華通,20,1,19,陽信-石牌,2023-07-19,8711
1101,台泥,18,0,18,陽信-石牌,2023-07-19,8711
2329,華泰,67,49,18,陽信-石牌,2023-07-19,8711
4541,晟田,18,0,18,陽信-石牌,2023-07-19,8711
6235,華孚,19,1,18,陽信-石牌,2023-07-19,8711
2303,聯電,27,10,17,陽信-石牌,2023-07-19,8711
2511,太子,16,0,16,陽信-石牌,2023-07-19,8711
2883,凱基金,20,4,16,陽信-石牌,2023-07-19,8711
00929,復華台灣科技優息,15,0,15,陽信-石牌,2023-07-19,8711
00882,中信中國高股息,15,0,15,陽信-石牌,2023-07-19,8711
3019,亞光,15,0,15,陽信-石牌,2023-07-19,8711
2882,國泰金,315,0,315,陽信-石牌,2023-07-20,8711
0056,元大高股息,76,1,75,陽信-石牌,2023-07-20,8711
2913,農林,70,0,70,陽信-石牌,2023-07-20,8711
2303,聯電,79,17,62,陽信-石牌,2023-07-20,8711
2617,台航,60,0,60,陽信-石牌,2023-07-20,8711
1789,神隆,55,1,54,陽信-石牌,2023-07-20,8711
6841,長佳智能,47,3,44,陽信-石牌,2023-07-20,8711
3037,欣興,64,25,39,陽信-石牌,2023-07-20,8711
00713,元大台灣高息低波,36,0,36,陽信-石牌,2023-07-20,8711
2382,廣達,78,44,34,陽信-石牌,2023-07-20,8711
6116,彩晶,30,0,30,陽信-石牌,2023-07-20,8711
00919,群益台灣精選高息,27,0,27,陽信-石牌,2023-07-20,8711
2344,華邦電,27,0,27,陽信-石牌,2023-07-20,8711
2884,玉山金,30,6,24,陽信-石牌,2023-07-20,8711
4114,健喬,23,1,22,陽信-石牌,2023-07-20,8711
1402,遠東新,20,0,20,陽信-石牌,2023-07-20,8711
2601,益航,20,0,20,陽信-石牌,2023-07-20,8711
8086,宏捷科,32,13,19,陽信-石牌,2023-07-20,8711
2313,華通,21,3,18,陽信-石牌,2023-07-20,8711
2630,亞航,19,2,17,陽信-石牌,2023-07-20,8711
1795,美時,17,1,16,陽信-石牌,2023-07-20,8711
2352,佳世達,43,27,16,陽信-石牌,2023-07-20,8711
6282,康舒,43,27,16,陽信-石牌,2023-07-20,8711
00679B,元大美債20年,14,0,14,陽信-石牌,2023-07-20,8711
2634,漢翔,30,16,14,陽信-石牌,2023-07-20,8711
6266,泰詠,14,0,14,陽信-石牌,2023-07-20,8711
2312,金寶,18,5,13,陽信-石牌,2023-07-20,8711
3051,力特,13,0,13,陽信-石牌,2023-07-20,8711
4123,晟德,29,16,13,陽信-石牌,2023-07-20,8711
5386,青雲,16,3,13,陽信-石牌,2023-07-20,8711
2027,大成鋼,20,8,12,陽信-石牌,2023-07-20,8711
2883,凱基金,14,2,12,陽信-石牌,2023-07-20,8711
1529,樂事綠能,49,37,12,陽信-石牌,2023-07-20,8711
3149,正達,12,0,12,陽信-石牌,2023-07-20,8711
5351,鈺創,14,2,12,陽信-石牌,2023-07-20,8711
2330,台積電,11,0,11,陽信-石牌,2023-07-20,8711
2705,六福,16,5,11,陽信-石牌,2023-07-20,8711
4153,鈺緯,11,0,11,陽信-石牌,2023-07-20,8711
2317,鴻海,15,5,10,陽信-石牌,2023-07-20,8711
00878,國泰永續高股息,47,37,10,陽信-石牌,2023-07-20,8711
1314,中石化,10,0,10,陽信-石牌,2023-07-20,8711
2374,佳能,10,0,10,陽信-石牌,2023-07-20,8711
3576,聯合再生,10,0,10,陽信-石牌,2023-07-20,8711
4130,健亞,10,0,10,陽信-石牌,2023-07-20,8711
8150,南茂,10,0,10,陽信-石牌,2023-07-20,8711
6188,廣明,34,25,9,陽信-石牌,2023-07-20,8711
6806,森崴能源,10,1,9,陽信-石牌,2023-07-20,8711
2405,輔信,23,15,8,陽信-石牌,2023-07-20,8711
2425,承啟,41,33,8,陽信-石牌,2023-07-20,8711
2495,普安,10,2,8,陽信-石牌,2023-07-20,8711
2883,凱基金,304,1,303,陽信-石牌,2023-07-21,8711
00715L,期街口布蘭特正2,145,0,145,陽信-石牌,2023-07-21,8711
00712,復華富時不動產,90,0,90,陽信-石牌,2023-07-21,8711
2353,宏��,80,2,78,陽信-石牌,2023-07-21,8711
00905,FT臺灣Smart,67,0,67,陽信-石牌,2023-07-21,8711
2419,仲琦,73,13,60,陽信-石牌,2023-07-21,8711
00878,國泰永續高股息,171,118,53,陽信-石牌,2023-07-21,8711
2882,國泰金,47,0,47,陽信-石牌,2023-07-21,8711
2014,中鴻,52,11,41,陽信-石牌,2023-07-21,8711
2617,台航,40,0,40,陽信-石牌,2023-07-21,8711
6188,廣明,58,19,39,陽信-石牌,2023-07-21,8711
2610,華航,45,9,36,陽信-石牌,2023-07-21,8711
2618,長榮航,61,27,34,陽信-石牌,2023-07-21,8711
2412,中華電,30,0,30,陽信-石牌,2023-07-21,8711
1217,愛之味,31,3,28,陽信-石牌,2023-07-21,8711
8048,德勝,27,0,27,陽信-石牌,2023-07-21,8711
2609,陽明,45,20,25,陽信-石牌,2023-07-21,8711
2748,雲品,24,0,24,陽信-石牌,2023-07-21,8711
3711,日月光投控,21,0,21,陽信-石牌,2023-07-21,8711
1514,亞力,34,14,20,陽信-石牌,2023-07-21,8711
2022,聚亨,20,0,20,陽信-石牌,2023-07-21,8711
2323,中環,30,11,19,陽信-石牌,2023-07-21,8711
6191,精成科,20,1,19,陽信-石牌,2023-07-21,8711
3706,神達,28,10,18,陽信-石牌,2023-07-21,8711
8215,明基材,19,1,18,陽信-石牌,2023-07-21,8711
00927,群益半導體收益,17,0,17,陽信-石牌,2023-07-21,8711
2206,三陽工業,28,11,17,陽信-石牌,2023-07-21,8711
2634,漢翔,26,9,17,陽信-石牌,2023-07-21,8711
3013,晟銘電,37,20,17,陽信-石牌,2023-07-21,8711
4532,瑞智,18,1,17,陽信-石牌,2023-07-21,8711
2630,亞航,20,4,16,陽信-石牌,2023-07-21,8711
2421,建準,22,7,15,陽信-石牌,2023-07-21,8711
2637,慧洋-KY,21,6,15,陽信-石牌,2023-07-21,8711
2886,兆豐金,15,0,15,陽信-石牌,2023-07-21,8711
3044,健鼎,24,9,15,陽信-石牌,2023-07-21,8711
2301,光寶科,38,24,14,陽信-石牌,2023-07-21,8711
6282,康舒,32,18,14,陽信-石牌,2023-07-21,8711
2382,廣達,77,64,13,陽信-石牌,2023-07-21,8711
00679B,元大美債20年,13,0,13,陽信-石牌,2023-07-21,8711
3455,由田,12,0,12,陽信-石牌,2023-07-21,8711
6182,合晶,12,0,12,陽信-石牌,2023-07-21,8711
6806,森崴能源,15,3,12,陽信-石牌,2023-07-21,8711
1101,台泥,12,0,12,陽信-石牌,2023-07-21,8711
1907,永豐餘,11,0,11,陽信-石牌,2023-07-21,8711
3521,鴻翊,11,0,11,陽信-石牌,2023-07-21,8711
6120,達運,12,1,11,陽信-石牌,2023-07-21,8711
2330,台積電,26,16,10,陽信-石牌,2023-07-21,8711
8426,紅木-KY,10,0,10,陽信-石牌,2023-07-21,8711
2324,仁寶,25,15,10,陽信-石牌,2023-07-21,8711
2405,輔信,24,14,10,陽信-石牌,2023-07-21,8711
00673R,期元大S＆P原油反1,233,0,233,陽信-石牌,2023-07-24,8711
00878,國泰永續高股息,341,230,111,陽信-石牌,2023-07-24,8711
3481,群創,114,10,104,陽信-石牌,2023-07-24,8711
2882,國泰金,102,1,101,陽信-石牌,2023-07-24,8711
00722B,群益投資級電信債,56,0,56,陽信-石牌,2023-07-24,8711
00850,元大臺灣ESG永續,50,0,50,陽信-石牌,2023-07-24,8711
1710,東聯,45,0,45,陽信-石牌,2023-07-24,8711
8048,德勝,43,1,42,陽信-石牌,2023-07-24,8711
1513,中興電,82,41,41,陽信-石牌,2023-07-24,8711
6288,聯嘉,41,0,41,陽信-石牌,2023-07-24,8711
2481,強茂,73,32,41,陽信-石牌,2023-07-24,8711
00764B,群益25年美債,40,0,40,陽信-石牌,2023-07-24,8711
2329,華泰,122,83,39,陽信-石牌,2023-07-24,8711
2014,中鴻,60,25,35,陽信-石牌,2023-07-24,8711
2312,金寶,38,3,35,陽信-石牌,2023-07-24,8711
00927,群益半導體收益,33,0,33,陽信-石牌,2023-07-24,8711
3264,欣銓,32,0,32,陽信-石牌,2023-07-24,8711
6116,彩晶,30,0,30,陽信-石牌,2023-07-24,8711
2323,中環,39,10,29,陽信-石牌,2023-07-24,8711
0056,元大高股息,62,35,27,陽信-石牌,2023-07-24,8711
1609,大亞,65,38,27,陽信-石牌,2023-07-24,8711
6188,廣明,40,17,23,陽信-石牌,2023-07-24,8711
2356,英業達,43,22,21,陽信-石牌,2023-07-24,8711
3548,兆利,21,0,21,陽信-石牌,2023-07-24,8711
6182,合晶,21,0,21,陽信-石牌,2023-07-24,8711
00929,復華台灣科技優息,20,0,20,陽信-石牌,2023-07-24,8711
2380,虹光,20,0,20,陽信-石牌,2023-07-24,8711
2637,慧洋-KY,34,14,20,陽信-石牌,2023-07-24,8711
1102,亞泥,18,0,18,陽信-石牌,2023-07-24,8711
2371,大同,31,13,18,陽信-石牌,2023-07-24,8711
3338,泰碩,26,8,18,陽信-石牌,2023-07-24,8711
1471,首利,20,3,17,陽信-石牌,2023-07-24,8711
1504,東元,26,9,17,陽信-石牌,2023-07-24,8711
2603,長榮,19,2,17,陽信-石牌,2023-07-24,8711
00885,富邦越南,16,0,16,陽信-石牌,2023-07-24,8711
1218,泰山,23,7,16,陽信-石牌,2023-07-24,8711
00753L,中信中國50正2,20,4,16,陽信-石牌,2023-07-24,8711
2388,威盛,20,4,16,陽信-石牌,2023-07-24,8711
6546,正基,16,0,16,陽信-石牌,2023-07-24,8711
2351,順德,15,0,15,陽信-石牌,2023-07-24,8711
2409,友達,15,0,15,陽信-石牌,2023-07-24,8711
2886,兆豐金,16,1,15,陽信-石牌,2023-07-24,8711
3521,鴻翊,15,0,15,陽信-石牌,2023-07-24,8711
8105,凌巨,15,0,15,陽信-石牌,2023-07-24,8711
2606,裕民,13,0,13,陽信-石牌,2023-07-24,8711
6213,聯茂,13,0,13,陽信-石牌,2023-07-24,8711
2734,易飛網,12,0,12,陽信-石牌,2023-07-24,8711
2880,華南金,12,0,12,陽信-石牌,2023-07-24,8711
2887,台新金,12,0,12,陽信-石牌,2023-07-24,8711
6194,育富,20,8,12,陽信-石牌,2023-07-24,8711
6116,彩晶,70,0,70,陽信-石牌,2023-07-25,8711
00878,國泰永續高股息,287,243,44,陽信-石牌,2023-07-25,8711
00722B,群益投資級電信債,42,0,42,陽信-石牌,2023-07-25,8711
2353,宏��,45,9,36,陽信-石牌,2023-07-25,8711
1444,力麗,32,0,32,陽信-石牌,2023-07-25,8711
2610,華航,98,67,31,陽信-石牌,2023-07-25,8711
3338,泰碩,37,6,31,陽信-石牌,2023-07-25,8711
00634R,富邦上証反1,30,0,30,陽信-石牌,2023-07-25,8711
00764B,群益25年美債,30,0,30,陽信-石牌,2023-07-25,8711
5469,瀚宇博,32,2,30,陽信-石牌,2023-07-25,8711
2301,光寶科,94,66,28,陽信-石牌,2023-07-25,8711
00929,復華台灣科技優息,26,0,26,陽信-石牌,2023-07-25,8711
2449,京元電子,25,1,24,陽信-石牌,2023-07-25,8711
1605,華新,37,15,22,陽信-石牌,2023-07-25,8711
1710,東聯,22,0,22,陽信-石牌,2023-07-25,8711
1905,華紙,58,37,21,陽信-石牌,2023-07-25,8711
2637,慧洋-KY,36,15,21,陽信-石牌,2023-07-25,8711
2617,台航,20,0,20,陽信-石牌,2023-07-25,8711
6244,茂迪,20,0,20,陽信-石牌,2023-07-25,8711
6235,華孚,44,25,19,陽信-石牌,2023-07-25,8711
2356,英業達,44,25,19,陽信-石牌,2023-07-25,8711
0056,元大高股息,110,92,18,陽信-石牌,2023-07-25,8711
3149,正達,17,0,17,陽信-石牌,2023-07-25,8711
00795B,中信美國公債20年,16,0,16,陽信-石牌,2023-07-25,8711
2383,台光電,16,0,16,陽信-石牌,2023-07-25,8711
2313,華通,51,36,15,陽信-石牌,2023-07-25,8711
2812,台中銀,15,0,15,陽信-石牌,2023-07-25,8711
1301,台塑,14,0,14,陽信-石牌,2023-07-25,8711
00919,群益台灣精選高息,15,1,14,陽信-石牌,2023-07-25,8711
2388,威盛,13,0,13,陽信-石牌,2023-07-25,8711
3013,晟銘電,36,23,13,陽信-石牌,2023-07-25,8711
00772B,中信高評級公司債,12,0,12,陽信-石牌,2023-07-25,8711
2376,技嘉,31,19,12,陽信-石牌,2023-07-25,8711
3055,蔚華科,12,0,12,陽信-石牌,2023-07-25,8711
3059,華晶科,12,0,12,陽信-石牌,2023-07-25,8711
3711,日月光投控,12,0,12,陽信-石牌,2023-07-25,8711
8050,廣積,17,5,12,陽信-石牌,2023-07-25,8711
1514,亞力,15,4,11,陽信-石牌,2023-07-25,8711
2455,全新,13,2,11,陽信-石牌,2023-07-25,8711
2883,凱基金,11,0,11,陽信-石牌,2023-07-25,8711
3702,大聯大,11,0,11,陽信-石牌,2023-07-25,8711
8926,台汽電,13,2,11,陽信-石牌,2023-07-25,8711
3324,雙鴻,27,16,11,陽信-石牌,2023-07-25,8711
00632R,元大台灣50反1,10,0,10,陽信-石牌,2023-07-25,8711
1540,喬福,10,0,10,陽信-石牌,2023-07-25,8711
1711,永光,10,0,10,陽信-石牌,2023-07-25,8711
2511,太子,10,0,10,陽信-石牌,2023-07-25,8711
3706,神達,20,10,10,陽信-石牌,2023-07-25,8711
4157,太景*-KY,10,0,10,陽信-石牌,2023-07-25,8711
4541,晟田,10,0,10,陽信-石牌,2023-07-25,8711
00673R,期元大S＆P原油反1,228,0,228,陽信-石牌,2023-07-26,8711
0056,元大高股息,251,89,162,陽信-石牌,2023-07-26,8711
2890,永豐金,150,1,149,陽信-石牌,2023-07-26,8711
5531,鄉林,120,0,120,陽信-石牌,2023-07-26,8711
00878,國泰永續高股息,236,125,111,陽信-石牌,2023-07-26,8711
1504,東元,89,19,70,陽信-石牌,2023-07-26,8711
00929,復華台灣科技優息,47,0,47,陽信-石牌,2023-07-26,8711
2382,廣達,90,47,43,陽信-石牌,2023-07-26,8711
2355,敬鵬,58,15,43,陽信-石牌,2023-07-26,8711
6125,廣運,60,24,36,陽信-石牌,2023-07-26,8711
2399,映泰,35,0,35,陽信-石牌,2023-07-26,8711
3029,零壹,82,47,35,陽信-石牌,2023-07-26,8711
2014,中鴻,33,1,32,陽信-石牌,2023-07-26,8711
00650L,復華香港正2,27,0,27,陽信-石牌,2023-07-26,8711
2371,大同,33,6,27,陽信-石牌,2023-07-26,8711
8358,金居,33,7,26,陽信-石牌,2023-07-26,8711
1905,華紙,54,28,26,陽信-石牌,2023-07-26,8711
00927,群益半導體收益,25,0,25,陽信-石牌,2023-07-26,8711
1609,大亞,37,13,24,陽信-石牌,2023-07-26,8711
2329,華泰,112,88,24,陽信-石牌,2023-07-26,8711
1537,廣隆,20,0,20,陽信-石牌,2023-07-26,8711
4919,新唐,24,5,19,陽信-石牌,2023-07-26,8711
5469,瀚宇博,18,0,18,陽信-石牌,2023-07-26,8711
2359,所羅門,45,28,17,陽信-石牌,2023-07-26,8711
2449,京元電子,18,1,17,陽信-石牌,2023-07-26,8711
2481,強茂,20,5,15,陽信-石牌,2023-07-26,8711
6548,長科*,15,0,15,陽信-石牌,2023-07-26,8711
1471,首利,17,3,14,陽信-石牌,2023-07-26,8711
2027,大成鋼,17,3,14,陽信-石牌,2023-07-26,8711
2323,中環,34,20,14,陽信-石牌,2023-07-26,8711
3189,景碩,14,0,14,陽信-石牌,2023-07-26,8711
4533,協易機,50,36,14,陽信-石牌,2023-07-26,8711
6257,矽格,14,0,14,陽信-石牌,2023-07-26,8711
6274,台燿,19,5,14,陽信-石牌,2023-07-26,8711
6806,森崴能源,15,1,14,陽信-石牌,2023-07-26,8711
2368,金像電,20,7,13,陽信-石牌,2023-07-26,8711
2603,長榮,29,16,13,陽信-石牌,2023-07-26,8711
2344,華邦電,14,2,12,陽信-石牌,2023-07-26,8711
2377,微星,12,0,12,陽信-石牌,2023-07-26,8711
3356,奇偶,14,2,12,陽信-石牌,2023-07-26,8711
6182,合晶,12,0,12,陽信-石牌,2023-07-26,8711
8234,新漢,22,10,12,陽信-石牌,2023-07-26,8711
2883,凱基金,11,0,11,陽信-石牌,2023-07-26,8711
6235,華孚,24,13,11,陽信-石牌,2023-07-26,8711
6288,聯嘉,11,0,11,陽信-石牌,2023-07-26,8711
020034,元大IC設計N,10,0,10,陽信-石牌,2023-07-26,8711
00680L,元大美債20正2,10,0,10,陽信-石牌,2023-07-26,8711
00713,元大台灣高息低波,10,0,10,陽信-石牌,2023-07-26,8711
00756B,群益投等新興公債,10,0,10,陽信-石牌,2023-07-26,8711
2017,官田鋼,10,0,10,陽信-石牌,2023-07-26,8711
00878,國泰永續高股息,158,7,151,陽信-石牌,2023-07-27,8711
00715L,期街口布蘭特正2,125,0,125,陽信-石牌,2023-07-27,8711
2888,新光金,116,27,89,陽信-石牌,2023-07-27,8711
1313,聯成,65,2,63,陽信-石牌,2023-07-27,8711
2610,華航,99,40,59,陽信-石牌,2023-07-27,8711
3346,麗清,63,12,51,陽信-石牌,2023-07-27,8711
00712,復華富時不動產,50,0,50,陽信-石牌,2023-07-27,8711
6451,訊芯-KY,50,0,50,陽信-石牌,2023-07-27,8711
2027,大成鋼,60,16,44,陽信-石牌,2023-07-27,8711
2618,長榮航,63,20,43,陽信-石牌,2023-07-27,8711
6188,廣明,78,36,42,陽信-石牌,2023-07-27,8711
8403,盛弘,42,0,42,陽信-石牌,2023-07-27,8711
2836,高雄銀,41,0,41,陽信-石牌,2023-07-27,8711
4503,金雨,30,0,30,陽信-石牌,2023-07-27,8711
2891,中信金,30,1,29,陽信-石牌,2023-07-27,8711
1304,台聚,28,0,28,陽信-石牌,2023-07-27,8711
2734,易飛網,30,2,28,陽信-石牌,2023-07-27,8711
3037,欣興,42,14,28,陽信-石牌,2023-07-27,8711
3231,緯創,43,15,28,陽信-石牌,2023-07-27,8711
0056,元大高股息,40,13,27,陽信-石牌,2023-07-27,8711
2002,中鋼,26,1,25,陽信-石牌,2023-07-27,8711
2887,台新金,22,0,22,陽信-石牌,2023-07-27,8711
2371,大同,43,22,21,陽信-石牌,2023-07-27,8711
00713,元大台灣高息低波,20,0,20,陽信-石牌,2023-07-27,8711
2007,燁興,20,0,20,陽信-石牌,2023-07-27,8711
2890,永豐金,20,0,20,陽信-石牌,2023-07-27,8711
2301,光寶科,43,25,18,陽信-石牌,2023-07-27,8711
3055,蔚華科,17,0,17,陽信-石牌,2023-07-27,8711
00651R,復華香港反1,15,0,15,陽信-石牌,2023-07-27,8711
3071,協禧,22,7,15,陽信-石牌,2023-07-27,8711
8926,台汽電,15,0,15,陽信-石牌,2023-07-27,8711
5203,訊連,14,0,14,陽信-石牌,2023-07-27,8711
6290,良維,20,6,14,陽信-石牌,2023-07-27,8711
1815,富喬,35,21,14,陽信-石牌,2023-07-27,8711
2317,鴻海,17,5,12,陽信-石牌,2023-07-27,8711
4726,永昕,12,0,12,陽信-石牌,2023-07-27,8711
00679B,元大美債20年,11,0,11,陽信-石牌,2023-07-27,8711
02001L,富邦蘋果正二N,16,5,11,陽信-石牌,2023-07-27,8711
2405,輔信,22,11,11,陽信-石牌,2023-07-27,8711
1303,南亞,10,0,10,陽信-石牌,2023-07-27,8711
00632R,元大台灣50反1,10,0,10,陽信-石牌,2023-07-27,8711
1528,恩德,11,1,10,陽信-石牌,2023-07-27,8711
2376,技嘉,19,9,10,陽信-石牌,2023-07-27,8711
2719,燦星旅,10,0,10,陽信-石牌,2023-07-27,8711
4532,瑞智,21,11,10,陽信-石牌,2023-07-27,8711
8358,金居,37,28,9,陽信-石牌,2023-07-27,8711
2328,廣宇,9,0,9,陽信-石牌,2023-07-27,8711
2368,金像電,20,11,9,陽信-石牌,2023-07-27,8711
3380,明泰,10,1,9,陽信-石牌,2023-07-27,8711
00680L,元大美債20正2,8,0,8,陽信-石牌,2023-07-27,8711
00673R,期元大S＆P原油反1,225,0,225,陽信-石牌,2023-07-28,8711
6244,茂迪,51,0,51,陽信-石牌,2023-07-28,8711
3231,緯創,130,81,49,陽信-石牌,2023-07-28,8711
1905,華紙,119,78,41,陽信-石牌,2023-07-28,8711
1907,永豐餘,50,10,40,陽信-石牌,2023-07-28,8711
2610,華航,93,57,36,陽信-石牌,2023-07-28,8711
2615,萬海,36,0,36,陽信-石牌,2023-07-28,8711
3521,鴻翊,35,0,35,陽信-石牌,2023-07-28,8711
00679B,元大美債20年,31,0,31,陽信-石牌,2023-07-28,8711
1605,華新,31,1,30,陽信-石牌,2023-07-28,8711
2405,輔信,42,12,30,陽信-石牌,2023-07-28,8711
6535,順藥,31,4,27,陽信-石牌,2023-07-28,8711
3029,零壹,35,11,24,陽信-石牌,2023-07-28,8711
020028,元大特選電動車N,22,0,22,陽信-石牌,2023-07-28,8711
2891,中信金,22,1,21,陽信-石牌,2023-07-28,8711
3013,晟銘電,23,2,21,陽信-石牌,2023-07-28,8711
00687B,國泰20年美債,20,0,20,陽信-石牌,2023-07-28,8711
2617,台航,20,0,20,陽信-石牌,2023-07-28,8711
6288,聯嘉,20,0,20,陽信-石牌,2023-07-28,8711
2027,大成鋼,36,18,18,陽信-石牌,2023-07-28,8711
2882,國泰金,19,1,18,陽信-石牌,2023-07-28,8711
00795B,中信美國公債20年,17,0,17,陽信-石牌,2023-07-28,8711
2427,三商電,46,29,17,陽信-石牌,2023-07-28,8711
2883,凱基金,17,0,17,陽信-石牌,2023-07-28,8711
00637L,元大滬深300正2,21,5,16,陽信-石牌,2023-07-28,8711
2888,新光金,21,5,16,陽信-石牌,2023-07-28,8711
6770,力積電,16,0,16,陽信-石牌,2023-07-28,8711
1609,大亞,25,10,15,陽信-石牌,2023-07-28,8711
2323,中環,15,0,15,陽信-石牌,2023-07-28,8711
2886,兆豐金,17,2,15,陽信-石牌,2023-07-28,8711
00923,群益台ESG低碳50,15,1,14,陽信-石牌,2023-07-28,8711
5386,青雲,20,6,14,陽信-石牌,2023-07-28,8711
2329,華泰,81,67,14,陽信-石牌,2023-07-28,8711
2355,敬鵬,13,0,13,陽信-石牌,2023-07-28,8711
2002,中鋼,19,7,12,陽信-石牌,2023-07-28,8711
00772B,中信高評級公司債,12,0,12,陽信-石牌,2023-07-28,8711
3037,欣興,38,27,11,陽信-石牌,2023-07-28,8711
00712,復華富時不動產,23,12,11,陽信-石牌,2023-07-28,8711
2106,建大,11,0,11,陽信-石牌,2023-07-28,8711
3189,景碩,11,0,11,陽信-石牌,2023-07-28,8711
6182,合晶,11,0,11,陽信-石牌,2023-07-28,8711
6274,台燿,21,10,11,陽信-石牌,2023-07-28,8711
00696B,富邦美債20年,10,0,10,陽信-石牌,2023-07-28,8711
00720B,元大投資級公司債,10,0,10,陽信-石牌,2023-07-28,8711
1314,中石化,10,0,10,陽信-石牌,2023-07-28,8711
1340,勝悅-KY,10,0,10,陽信-石牌,2023-07-28,8711
2034,允強,10,0,10,陽信-石牌,2023-07-28,8711
2301,光寶科,79,69,10,陽信-石牌,2023-07-28,8711
2383,台光電,22,12,10,陽信-石牌,2023-07-28,8711
2913,農林,16,6,10,陽信-石牌,2023-07-28,8711
0056,元大高股息,380,30,350,陽信-石牌,2023-07-31,8711
2340,台亞,214,5,209,陽信-石牌,2023-07-31,8711
00878,國泰永續高股息,274,134,140,陽信-石牌,2023-07-31,8711
6218,豪勉,77,1,76,陽信-石牌,2023-07-31,8711
2317,鴻海,75,2,73,陽信-石牌,2023-07-31,8711
2888,新光金,105,39,66,陽信-石牌,2023-07-31,8711
3231,緯創,93,27,66,陽信-石牌,2023-07-31,8711
3037,欣興,70,6,64,陽信-石牌,2023-07-31,8711
2409,友達,79,17,62,陽信-石牌,2023-07-31,8711
2382,廣達,82,21,61,陽信-石牌,2023-07-31,8711
00905,FT臺灣Smart,60,0,60,陽信-石牌,2023-07-31,8711
3481,群創,120,74,46,陽信-石牌,2023-07-31,8711
2609,陽明,67,22,45,陽信-石牌,2023-07-31,8711
2313,華通,66,28,38,陽信-石牌,2023-07-31,8711
6470,宇智,43,7,36,陽信-石牌,2023-07-31,8711
2617,台航,30,0,30,陽信-石牌,2023-07-31,8711
6861,睿生光電,30,0,30,陽信-石牌,2023-07-31,8711
3081,聯亞,30,2,28,陽信-石牌,2023-07-31,8711
2329,華泰,131,104,27,陽信-石牌,2023-07-31,8711
3711,日月光投控,33,6,27,陽信-石牌,2023-07-31,8711
2515,中工,26,0,26,陽信-石牌,2023-07-31,8711
2618,長榮航,65,40,25,陽信-石牌,2023-07-31,8711
02001L,富邦蘋果正二N,24,0,24,陽信-石牌,2023-07-31,8711
2371,大同,36,14,22,陽信-石牌,2023-07-31,8711
2603,長榮,25,3,22,陽信-石牌,2023-07-31,8711
3704,合勤控,25,4,21,陽信-石牌,2023-07-31,8711
00795B,中信美國公債20年,20,0,20,陽信-石牌,2023-07-31,8711
2421,建準,24,5,19,陽信-石牌,2023-07-31,8711
2637,慧洋-KY,29,10,19,陽信-石牌,2023-07-31,8711
3013,晟銘電,39,22,17,陽信-石牌,2023-07-31,8711
4979,華星光,29,12,17,陽信-石牌,2023-07-31,8711
2383,台光電,18,2,16,陽信-石牌,2023-07-31,8711
2376,技嘉,26,11,15,陽信-石牌,2023-07-31,8711
2211,長榮鋼,15,0,15,陽信-石牌,2023-07-31,8711
3264,欣銓,18,3,15,陽信-石牌,2023-07-31,8711
8936,國統,15,0,15,陽信-石牌,2023-07-31,8711
1712,興農,14,0,14,陽信-石牌,2023-07-31,8711
1789,神隆,21,7,14,陽信-石牌,2023-07-31,8711
3706,神達,21,7,14,陽信-石牌,2023-07-31,8711
4532,瑞智,25,11,14,陽信-石牌,2023-07-31,8711
2834,臺企銀,13,0,13,陽信-石牌,2023-07-31,8711
2303,聯電,15,2,13,陽信-石牌,2023-07-31,8711
00679B,元大美債20年,12,0,12,陽信-石牌,2023-07-31,8711
3078,僑威,14,2,12,陽信-石牌,2023-07-31,8711
8050,廣積,20,8,12,陽信-石牌,2023-07-31,8711
2883,凱基金,11,0,11,陽信-石牌,2023-07-31,8711
6188,廣明,34,23,11,陽信-石牌,2023-07-31,8711
6570,維田,11,0,11,陽信-石牌,2023-07-31,8711
2330,台積電,14,3,11,陽信-石牌,2023-07-31,8711
1434,福懋,10,0,10,陽信-石牌,2023-07-31,8711
0056,元大高股息,99,6,93,陽信-石牌,2023-08-01,8711
00929,復華台灣科技優息,112,20,92,陽信-石牌,2023-08-01,8711
6282,康舒,73,13,60,陽信-石牌,2023-08-01,8711
1905,華紙,58,16,42,陽信-石牌,2023-08-01,8711
1605,華新,51,10,41,陽信-石牌,2023-08-01,8711
00892,富邦台灣半導體,40,0,40,陽信-石牌,2023-08-01,8711
5531,鄉林,40,0,40,陽信-石牌,2023-08-01,8711
1618,合機,36,1,35,陽信-石牌,2023-08-01,8711
6239,力成,35,1,34,陽信-石牌,2023-08-01,8711
1529,樂事綠能,33,2,31,陽信-石牌,2023-08-01,8711
1802,台玻,64,37,27,陽信-石牌,2023-08-01,8711
2312,金寶,29,4,25,陽信-石牌,2023-08-01,8711
2444,兆勁,25,0,25,陽信-石牌,2023-08-01,8711
8027,鈦昇,61,36,25,陽信-石牌,2023-08-01,8711
00923,群益台ESG低碳50,24,0,24,陽信-石牌,2023-08-01,8711
3013,晟銘電,44,25,19,陽信-石牌,2023-08-01,8711
3105,穩懋,20,2,18,陽信-石牌,2023-08-01,8711
2380,虹光,20,3,17,陽信-石牌,2023-08-01,8711
2891,中信金,17,0,17,陽信-石牌,2023-08-01,8711
3706,神達,27,10,17,陽信-石牌,2023-08-01,8711
1301,台塑,17,1,16,陽信-石牌,2023-08-01,8711
2027,大成鋼,26,10,16,陽信-石牌,2023-08-01,8711
3033,威健,17,1,16,陽信-石牌,2023-08-01,8711
1471,首利,15,0,15,陽信-石牌,2023-08-01,8711
2610,華航,28,13,15,陽信-石牌,2023-08-01,8711
4974,亞泰,15,0,15,陽信-石牌,2023-08-01,8711
3004,豐達科,40,26,14,陽信-石牌,2023-08-01,8711
5388,中磊,44,30,14,陽信-石牌,2023-08-01,8711
6288,聯嘉,19,5,14,陽信-石牌,2023-08-01,8711
2337,旺宏,15,2,13,陽信-石牌,2023-08-01,8711
3037,欣興,16,3,13,陽信-石牌,2023-08-01,8711
3260,威剛,15,2,13,陽信-石牌,2023-08-01,8711
00637L,元大滬深300正2,18,6,12,陽信-石牌,2023-08-01,8711
1712,興農,12,0,12,陽信-石牌,2023-08-01,8711
4919,新唐,20,8,12,陽信-石牌,2023-08-01,8711
2301,光寶科,38,27,11,陽信-石牌,2023-08-01,8711
2913,農林,63,52,11,陽信-石牌,2023-08-01,8711
3257,虹冠電,13,2,11,陽信-石牌,2023-08-01,8711
5351,鈺創,11,0,11,陽信-石牌,2023-08-01,8711
3231,緯創,85,74,11,陽信-石牌,2023-08-01,8711
2371,大同,15,4,11,陽信-石牌,2023-08-01,8711
2007,燁興,10,0,10,陽信-石牌,2023-08-01,8711
2363,矽統,19,9,10,陽信-石牌,2023-08-01,8711
2449,京元電子,16,6,10,陽信-石牌,2023-08-01,8711
3049,精金,10,0,10,陽信-石牌,2023-08-01,8711
3521,鴻翊,10,0,10,陽信-石牌,2023-08-01,8711
6120,達運,10,0,10,陽信-石牌,2023-08-01,8711
6187,萬潤,21,11,10,陽信-石牌,2023-08-01,8711
6190,萬泰科,10,0,10,陽信-石牌,2023-08-01,8711
8028,昇陽半導體,10,0,10,陽信-石牌,2023-08-01,8711
2891,中信金,511,0,511,陽信-石牌,2023-08-02,8711
00878,國泰永續高股息,265,36,229,陽信-石牌,2023-08-02,8711
2515,中工,200,0,200,陽信-石牌,2023-08-02,8711
3481,群創,177,8,169,陽信-石牌,2023-08-02,8711
00929,復華台灣科技優息,124,0,124,陽信-石牌,2023-08-02,8711
00715L,期街口布蘭特正2,115,0,115,陽信-石牌,2023-08-02,8711
00923,群益台ESG低碳50,99,0,99,陽信-石牌,2023-08-02,8711
00900,富邦特選高股息30,81,0,81,陽信-石牌,2023-08-02,8711
00885,富邦越南,69,0,69,陽信-石牌,2023-08-02,8711
1304,台聚,67,1,66,陽信-石牌,2023-08-02,8711
6282,康舒,140,84,56,陽信-石牌,2023-08-02,8711
4533,協易機,51,0,51,陽信-石牌,2023-08-02,8711
9105,泰金寶-DR,50,0,50,陽信-石牌,2023-08-02,8711
1605,華新,145,98,47,陽信-石牌,2023-08-02,8711
2498,宏達電,48,1,47,陽信-石牌,2023-08-02,8711
00687B,國泰20年美債,44,0,44,陽信-石牌,2023-08-02,8711
2301,光寶科,44,4,40,陽信-石牌,2023-08-02,8711
2617,台航,40,0,40,陽信-石牌,2023-08-02,8711
2382,廣達,67,28,39,陽信-石牌,2023-08-02,8711
2834,臺企銀,47,10,37,陽信-石牌,2023-08-02,8711
1789,神隆,36,0,36,陽信-石牌,2023-08-02,8711
2388,威盛,32,0,32,陽信-石牌,2023-08-02,8711
2612,中航,31,0,31,陽信-石牌,2023-08-02,8711
00679B,元大美債20年,30,0,30,陽信-石牌,2023-08-02,8711
2324,仁寶,39,11,28,陽信-石牌,2023-08-02,8711
8027,鈦昇,32,5,27,陽信-石牌,2023-08-02,8711
3037,欣興,44,18,26,陽信-石牌,2023-08-02,8711
2444,兆勁,25,0,25,陽信-石牌,2023-08-02,8711
00927,群益半導體收益,24,0,24,陽信-石牌,2023-08-02,8711
2618,長榮航,95,72,23,陽信-石牌,2023-08-02,8711
00772B,中信高評級公司債,23,0,23,陽信-石牌,2023-08-02,8711
2609,陽明,24,1,23,陽信-石牌,2023-08-02,8711
5347,世界,22,0,22,陽信-石牌,2023-08-02,8711
00722B,群益投資級電信債,21,0,21,陽信-石牌,2023-08-02,8711
5531,鄉林,20,0,20,陽信-石牌,2023-08-02,8711
8464,億豐,20,0,20,陽信-石牌,2023-08-02,8711
2409,友達,32,13,19,陽信-石牌,2023-08-02,8711
2002,中鋼,19,0,19,陽信-石牌,2023-08-02,8711
3013,晟銘電,33,14,19,陽信-石牌,2023-08-02,8711
4746,台耀,38,19,19,陽信-石牌,2023-08-02,8711
2308,台達電,21,3,18,陽信-石牌,2023-08-02,8711
02001L,富邦蘋果正二N,18,0,18,陽信-石牌,2023-08-02,8711
3033,威健,17,0,17,陽信-石牌,2023-08-02,8711
3078,僑威,18,1,17,陽信-石牌,2023-08-02,8711
4919,新唐,17,0,17,陽信-石牌,2023-08-02,8711
2882,國泰金,16,0,16,陽信-石牌,2023-08-02,8711
8210,勤誠,23,7,16,陽信-石牌,2023-08-02,8711
3231,緯創,168,153,15,陽信-石牌,2023-08-02,8711
00850,元大臺灣ESG永續,15,0,15,陽信-石牌,2023-08-02,8711
00720B,元大投資級公司債,15,0,15,陽信-石牌,2023-08-02,8711
2891,中信金,1035,2,1033,陽信-石牌,2023-08-04,8711
00673R,期元大S＆P原油反1,215,0,215,陽信-石牌,2023-08-04,8711
00878,國泰永續高股息,144,2,142,陽信-石牌,2023-08-04,8711
1605,華新,160,33,127,陽信-石牌,2023-08-04,8711
00930,永豐ESG低碳高息,61,0,61,陽信-石牌,2023-08-04,8711
00687B,國泰20年美債,55,0,55,陽信-石牌,2023-08-04,8711
1609,大亞,76,25,51,陽信-石牌,2023-08-04,8711
1305,華夏,50,0,50,陽信-石牌,2023-08-04,8711
00795B,中信美國公債20年,48,0,48,陽信-石牌,2023-08-04,8711
2349,錸德,50,3,47,陽信-石牌,2023-08-04,8711
2344,華邦電,61,14,47,陽信-石牌,2023-08-04,8711
1905,華紙,70,25,45,陽信-石牌,2023-08-04,8711
00929,復華台灣科技優息,41,0,41,陽信-石牌,2023-08-04,8711
00679B,元大美債20年,42,2,40,陽信-石牌,2023-08-04,8711
2352,佳世達,45,6,39,陽信-石牌,2023-08-04,8711
2618,長榮航,46,14,32,陽信-石牌,2023-08-04,8711
00665L,富邦�琤肭磪囓�2,60,31,29,陽信-石牌,2023-08-04,8711
00722B,群益投資級電信債,28,1,27,陽信-石牌,2023-08-04,8711
2303,聯電,25,0,25,陽信-石牌,2023-08-04,8711
2913,農林,53,29,24,陽信-石牌,2023-08-04,8711
5351,鈺創,24,0,24,陽信-石牌,2023-08-04,8711
1789,神隆,23,0,23,陽信-石牌,2023-08-04,8711
00772B,中信高評級公司債,22,0,22,陽信-石牌,2023-08-04,8711
0056,元大高股息,35,14,21,陽信-石牌,2023-08-04,8711
3044,健鼎,21,1,20,陽信-石牌,2023-08-04,8711
1598,岱宇,19,0,19,陽信-石牌,2023-08-04,8711
8210,勤誠,18,0,18,陽信-石牌,2023-08-04,8711
6216,居易,17,0,17,陽信-石牌,2023-08-04,8711
8215,明基材,17,1,16,陽信-石牌,2023-08-04,8711
5009,榮剛,16,0,16,陽信-石牌,2023-08-04,8711
2340,台亞,16,1,15,陽信-石牌,2023-08-04,8711
2498,宏達電,16,1,15,陽信-石牌,2023-08-04,8711
2313,華通,55,41,14,陽信-石牌,2023-08-04,8711
5871,中租-KY,12,0,12,陽信-石牌,2023-08-04,8711
2356,英業達,63,51,12,陽信-石牌,2023-08-04,8711
2630,亞航,12,0,12,陽信-石牌,2023-08-04,8711
2801,彰銀,12,0,12,陽信-石牌,2023-08-04,8711
6188,廣明,38,26,12,陽信-石牌,2023-08-04,8711
00751B,元大AAA至A公司債,11,0,11,陽信-石牌,2023-08-04,8711
3325,旭品,11,0,11,陽信-石牌,2023-08-04,8711
00696B,富邦美債20年,10,0,10,陽信-石牌,2023-08-04,8711
00919,群益台灣精選高息,10,0,10,陽信-石牌,2023-08-04,8711
00764B,群益25年美債,10,0,10,陽信-石牌,2023-08-04,8711
2482,連宇,10,0,10,陽信-石牌,2023-08-04,8711
2834,臺企銀,10,0,10,陽信-石牌,2023-08-04,8711
2912,統一超,10,0,10,陽信-石牌,2023-08-04,8711
3004,豐達科,52,42,10,陽信-石牌,2023-08-04,8711
5388,中磊,11,1,10,陽信-石牌,2023-08-04,8711
1785,光洋科,11,2,9,陽信-石牌,2023-08-04,8711
3081,聯亞,9,0,9,陽信-石牌,2023-08-04,8711
2891,中信金,336,4,332,陽信-石牌,2023-08-07,8711
3481,群創,153,1,152,陽信-石牌,2023-08-07,8711
1905,華紙,285,169,116,陽信-石牌,2023-08-07,8711
00715L,期街口布蘭特正2,105,0,105,陽信-石牌,2023-08-07,8711
2382,廣達,139,47,92,陽信-石牌,2023-08-07,8711
2884,玉山金,56,1,55,陽信-石牌,2023-08-07,8711
2913,農林,73,18,55,陽信-石牌,2023-08-07,8711
2353,宏��,52,6,46,陽信-石牌,2023-08-07,8711
00900,富邦特選高股息30,50,6,44,陽信-石牌,2023-08-07,8711
5371,中光電,33,2,31,陽信-石牌,2023-08-07,8711
00722B,群益投資級電信債,30,0,30,陽信-石牌,2023-08-07,8711
1460,宏遠,30,0,30,陽信-石牌,2023-08-07,8711
2352,佳世達,40,11,29,陽信-石牌,2023-08-07,8711
00633L,富邦上証正2,24,0,24,陽信-石牌,2023-08-07,8711
6125,廣運,23,0,23,陽信-石牌,2023-08-07,8711
2421,建準,21,0,21,陽信-石牌,2023-08-07,8711
1305,華夏,31,11,20,陽信-石牌,2023-08-07,8711
6116,彩晶,20,0,20,陽信-石牌,2023-08-07,8711
6274,台燿,32,12,20,陽信-石牌,2023-08-07,8711
2409,友達,24,6,18,陽信-石牌,2023-08-07,8711
2609,陽明,19,2,17,陽信-石牌,2023-08-07,8711
5381,合正,17,0,17,陽信-石牌,2023-08-07,8711
1907,永豐餘,27,11,16,陽信-石牌,2023-08-07,8711
1609,大亞,48,34,14,陽信-石牌,2023-08-07,8711
2610,華航,18,4,14,陽信-石牌,2023-08-07,8711
2630,亞航,25,11,14,陽信-石牌,2023-08-07,8711
1785,光洋科,12,0,12,陽信-石牌,2023-08-07,8711
2603,長榮,32,21,11,陽信-石牌,2023-08-07,8711
2329,華泰,27,16,11,陽信-石牌,2023-08-07,8711
3004,豐達科,20,9,11,陽信-石牌,2023-08-07,8711
3308,聯德,11,0,11,陽信-石牌,2023-08-07,8711
1340,勝悅-KY,10,0,10,陽信-石牌,2023-08-07,8711
1709,和益,10,0,10,陽信-石牌,2023-08-07,8711
1711,永光,10,0,10,陽信-石牌,2023-08-07,8711
1815,富喬,10,0,10,陽信-石牌,2023-08-07,8711
2530,華建,10,0,10,陽信-石牌,2023-08-07,8711
2542,興富發,10,0,10,陽信-石牌,2023-08-07,8711
2617,台航,10,0,10,陽信-石牌,2023-08-07,8711
3017,奇鋐,10,0,10,陽信-石牌,2023-08-07,8711
4541,晟田,11,1,10,陽信-石牌,2023-08-07,8711
4580,捷流閥業,10,0,10,陽信-石牌,2023-08-07,8711
6182,合晶,10,0,10,陽信-石牌,2023-08-07,8711
6244,茂迪,10,0,10,陽信-石牌,2023-08-07,8711
8028,昇陽半導體,30,20,10,陽信-石牌,2023-08-07,8711
8105,凌巨,10,0,10,陽信-石牌,2023-08-07,8711
2355,敬鵬,9,0,9,陽信-石牌,2023-08-07,8711
2388,威盛,27,18,9,陽信-石牌,2023-08-07,8711
6234,高僑,10,1,9,陽信-石牌,2023-08-07,8711
6477,安集,9,0,9,陽信-石牌,2023-08-07,8711
2313,華通,62,54,8,陽信-石牌,2023-08-07,8711
00673R,期元大S＆P原油反1,200,0,200,陽信-石牌,2023-08-08,8711
2382,廣達,116,48,68,陽信-石牌,2023-08-08,8711
00923,群益台ESG低碳50,64,0,64,陽信-石牌,2023-08-08,8711
00931B,統一美債20年,61,0,61,陽信-石牌,2023-08-08,8711
00687B,國泰20年美債,61,0,61,陽信-石牌,2023-08-08,8711
00919,群益台灣精選高息,60,0,60,陽信-石牌,2023-08-08,8711
3231,緯創,133,84,49,陽信-石牌,2023-08-08,8711
00929,復華台灣科技優息,50,1,49,陽信-石牌,2023-08-08,8711
1605,華新,51,3,48,陽信-石牌,2023-08-08,8711
00665L,富邦�琤肭磪囓�2,65,21,44,陽信-石牌,2023-08-08,8711
2884,玉山金,41,1,40,陽信-石牌,2023-08-08,8711
00878,國泰永續高股息,100,62,38,陽信-石牌,2023-08-08,8711
00795B,中信美國公債20年,46,10,36,陽信-石牌,2023-08-08,8711
2352,佳世達,35,0,35,陽信-石牌,2023-08-08,8711
3715,定穎投控,30,1,29,陽信-石牌,2023-08-08,8711
3308,聯德,25,0,25,陽信-石牌,2023-08-08,8711
3706,神達,37,13,24,陽信-石牌,2023-08-08,8711
2890,永豐金,23,2,21,陽信-石牌,2023-08-08,8711
00753L,中信中國50正2,20,0,20,陽信-石牌,2023-08-08,8711
2376,技嘉,42,22,20,陽信-石牌,2023-08-08,8711
2881,富邦金,20,0,20,陽信-石牌,2023-08-08,8711
2891,中信金,60,44,16,陽信-石牌,2023-08-08,8711
6443,元晶,20,4,16,陽信-石牌,2023-08-08,8711
1802,台玻,32,17,15,陽信-石牌,2023-08-08,8711
4533,協易機,14,0,14,陽信-石牌,2023-08-08,8711
00900,富邦特選高股息30,13,1,12,陽信-石牌,2023-08-08,8711
2323,中環,12,0,12,陽信-石牌,2023-08-08,8711
00891,中信關鍵半導體,11,0,11,陽信-石牌,2023-08-08,8711
00633L,富邦上証正2,11,0,11,陽信-石牌,2023-08-08,8711
1789,神隆,11,0,11,陽信-石牌,2023-08-08,8711
2363,矽統,17,7,10,陽信-石牌,2023-08-08,8711
2492,華新科,11,1,10,陽信-石牌,2023-08-08,8711
2617,台航,10,0,10,陽信-石牌,2023-08-08,8711
3207,耀勝,10,0,10,陽信-石牌,2023-08-08,8711
4973,廣穎,10,0,10,陽信-石牌,2023-08-08,8711
6446,藥華藥,10,0,10,陽信-石牌,2023-08-08,8711
8464,億豐,10,0,10,陽信-石牌,2023-08-08,8711
9933,中鼎,10,0,10,陽信-石牌,2023-08-08,8711
1598,岱宇,9,0,9,陽信-石牌,2023-08-08,8711
2886,兆豐金,9,0,9,陽信-石牌,2023-08-08,8711
8210,勤誠,9,0,9,陽信-石牌,2023-08-08,8711
2303,聯電,10,1,9,陽信-石牌,2023-08-08,8711
1305,華夏,50,42,8,陽信-石牌,2023-08-08,8711
2329,華泰,24,16,8,陽信-石牌,2023-08-08,8711
2609,陽明,16,8,8,陽信-石牌,2023-08-08,8711
3029,零壹,9,1,8,陽信-石牌,2023-08-08,8711
5388,中磊,8,0,8,陽信-石牌,2023-08-08,8711
6274,台燿,15,7,8,陽信-石牌,2023-08-08,8711
1609,大亞,9,2,7,陽信-石牌,2023-08-08,8711
1795,美時,7,0,7,陽信-石牌,2023-08-08,8711
3481,群創,263,5,258,陽信-石牌,2023-08-09,8711
00878,國泰永續高股息,97,1,96,陽信-石牌,2023-08-09,8711
00929,復華台灣科技優息,73,0,73,陽信-石牌,2023-08-09,8711
2884,玉山金,40,0,40,陽信-石牌,2023-08-09,8711
6120,達運,36,0,36,陽信-石牌,2023-08-09,8711
2637,慧洋-KY,41,7,34,陽信-石牌,2023-08-09,8711
00923,群益台ESG低碳50,30,0,30,陽信-石牌,2023-08-09,8711
2617,台航,30,0,30,陽信-石牌,2023-08-09,8711
4533,協易機,27,0,27,陽信-石牌,2023-08-09,8711
2897,王道銀行,26,0,26,陽信-石牌,2023-08-09,8711
2442,新美齊,26,1,25,陽信-石牌,2023-08-09,8711
1605,華新,29,5,24,陽信-石牌,2023-08-09,8711
2408,南亞科,21,0,21,陽信-石牌,2023-08-09,8711
3521,鴻翊,26,5,21,陽信-石牌,2023-08-09,8711
1785,光洋科,20,0,20,陽信-石牌,2023-08-09,8711
2880,華南金,20,0,20,陽信-石牌,2023-08-09,8711
6116,彩晶,20,0,20,陽信-石牌,2023-08-09,8711
00753L,中信中國50正2,20,1,19,陽信-石牌,2023-08-09,8711
6182,合晶,18,1,17,陽信-石牌,2023-08-09,8711
2634,漢翔,19,2,17,陽信-石牌,2023-08-09,8711
00665L,富邦�琤肭磪囓�2,30,15,15,陽信-石牌,2023-08-09,8711
1532,勤美,15,0,15,陽信-石牌,2023-08-09,8711
2886,兆豐金,15,0,15,陽信-石牌,2023-08-09,8711
2892,第一金,15,0,15,陽信-石牌,2023-08-09,8711
2913,農林,38,23,15,陽信-石牌,2023-08-09,8711
8155,博智,16,1,15,陽信-石牌,2023-08-09,8711
2353,宏��,13,0,13,陽信-石牌,2023-08-09,8711
1319,東陽,12,0,12,陽信-石牌,2023-08-09,8711
2460,建通,12,0,12,陽信-石牌,2023-08-09,8711
2344,華邦電,12,1,11,陽信-石牌,2023-08-09,8711
2882,國泰金,11,0,11,陽信-石牌,2023-08-09,8711
4960,誠美材,11,0,11,陽信-石牌,2023-08-09,8711
5465,富驊,12,1,11,陽信-石牌,2023-08-09,8711
2002,中鋼,11,0,11,陽信-石牌,2023-08-09,8711
2603,長榮,12,2,10,陽信-石牌,2023-08-09,8711
1504,東元,12,2,10,陽信-石牌,2023-08-09,8711
2367,燿華,10,0,10,陽信-石牌,2023-08-09,8711
3260,威剛,16,6,10,陽信-石牌,2023-08-09,8711
3356,奇偶,18,8,10,陽信-石牌,2023-08-09,8711
3363,上詮,11,1,10,陽信-石牌,2023-08-09,8711
6147,頎邦,10,0,10,陽信-石牌,2023-08-09,8711
2887,台新金,10,0,10,陽信-石牌,2023-08-09,8711
2356,英業達,34,25,9,陽信-石牌,2023-08-09,8711
3056,富華新,9,0,9,陽信-石牌,2023-08-09,8711
6218,豪勉,12,3,9,陽信-石牌,2023-08-09,8711
8027,鈦昇,16,7,9,陽信-石牌,2023-08-09,8711
2382,廣達,77,68,9,陽信-石牌,2023-08-09,8711
00907,永豐優息存股,8,0,8,陽信-石牌,2023-08-09,8711
1598,岱宇,8,0,8,陽信-石牌,2023-08-09,8711
2303,聯電,9,1,8,陽信-石牌,2023-08-09,8711
3481,群創,820,30,790,陽信-石牌,2023-08-10,8711
2516,新建,217,0,217,陽信-石牌,2023-08-10,8711
00753L,中信中國50正2,100,0,100,陽信-石牌,2023-08-10,8711
00715L,期街口布蘭特正2,95,0,95,陽信-石牌,2023-08-10,8711
00878,國泰永續高股息,120,44,76,陽信-石牌,2023-08-10,8711
2548,華固,60,0,60,陽信-石牌,2023-08-10,8711
1609,大亞,60,8,52,陽信-石牌,2023-08-10,8711
00650L,復華香港正2,50,0,50,陽信-石牌,2023-08-10,8711
00900,富邦特選高股息30,49,0,49,陽信-石牌,2023-08-10,8711
00929,復華台灣科技優息,74,30,44,陽信-石牌,2023-08-10,8711
0056,元大高股息,43,3,40,陽信-石牌,2023-08-10,8711
00927,群益半導體收益,40,0,40,陽信-石牌,2023-08-10,8711
00919,群益台灣精選高息,38,0,38,陽信-石牌,2023-08-10,8711
3231,緯創,68,33,35,陽信-石牌,2023-08-10,8711
2897,王道銀行,35,0,35,陽信-石牌,2023-08-10,8711
3526,凡甲,35,0,35,陽信-石牌,2023-08-10,8711
6282,康舒,59,24,35,陽信-石牌,2023-08-10,8711
6546,正基,34,0,34,陽信-石牌,2023-08-10,8711
2888,新光金,62,30,32,陽信-石牌,2023-08-10,8711
3356,奇偶,36,4,32,陽信-石牌,2023-08-10,8711
2618,長榮航,65,34,31,陽信-石牌,2023-08-10,8711
2409,友達,31,1,30,陽信-石牌,2023-08-10,8711
6239,力成,30,0,30,陽信-石牌,2023-08-10,8711
1605,華新,48,21,27,陽信-石牌,2023-08-10,8711
2402,毅嘉,41,15,26,陽信-石牌,2023-08-10,8711
00923,群益台ESG低碳50,24,0,24,陽信-石牌,2023-08-10,8711
1905,華紙,48,24,24,陽信-石牌,2023-08-10,8711
2444,兆勁,22,0,22,陽信-石牌,2023-08-10,8711
2383,台光電,28,7,21,陽信-石牌,2023-08-10,8711
3260,威剛,21,0,21,陽信-石牌,2023-08-10,8711
00656R,國泰中國A50反1,20,0,20,陽信-石牌,2023-08-10,8711
00633L,富邦上証正2,20,0,20,陽信-石牌,2023-08-10,8711
00891,中信關鍵半導體,20,0,20,陽信-石牌,2023-08-10,8711
2486,一詮,20,0,20,陽信-石牌,2023-08-10,8711
2324,仁寶,19,2,17,陽信-石牌,2023-08-10,8711
2313,華通,44,28,16,陽信-石牌,2023-08-10,8711
00930,永豐ESG低碳高息,15,0,15,陽信-石牌,2023-08-10,8711
3038,全台,15,0,15,陽信-石牌,2023-08-10,8711
3521,鴻翊,15,0,15,陽信-石牌,2023-08-10,8711
8210,勤誠,14,0,14,陽信-石牌,2023-08-10,8711
1802,台玻,37,24,13,陽信-石牌,2023-08-10,8711
2303,聯電,17,4,13,陽信-石牌,2023-08-10,8711
2312,金寶,25,12,13,陽信-石牌,2023-08-10,8711
2421,建準,14,1,13,陽信-石牌,2023-08-10,8711
2913,農林,44,31,13,陽信-石牌,2023-08-10,8711
2340,台亞,12,0,12,陽信-石牌,2023-08-10,8711
2637,慧洋-KY,12,0,12,陽信-石牌,2023-08-10,8711
9907,統一實,12,0,12,陽信-石牌,2023-08-10,8711
00931B,統一美債20年,11,0,11,陽信-石牌,2023-08-10,8711
2883,凱基金,21,10,11,陽信-石牌,2023-08-10,8711
3481,群創,847,1,846,陽信-石牌,2023-08-11,8711
6244,茂迪,90,0,90,陽信-石牌,2023-08-11,8711
2888,新光金,76,0,76,陽信-石牌,2023-08-11,8711
00900,富邦特選高股息30,53,0,53,陽信-石牌,2023-08-11,8711
00878,國泰永續高股息,66,15,51,陽信-石牌,2023-08-11,8711
00931B,統一美債20年,43,0,43,陽信-石牌,2023-08-11,8711
1609,大亞,48,14,34,陽信-石牌,2023-08-11,8711
1785,光洋科,31,0,31,陽信-石牌,2023-08-11,8711
00656R,國泰中國A50反1,30,0,30,陽信-石牌,2023-08-11,8711
9933,中鼎,30,0,30,陽信-石牌,2023-08-11,8711
2637,慧洋-KY,28,0,28,陽信-石牌,2023-08-11,8711
2409,友達,29,2,27,陽信-石牌,2023-08-11,8711
2601,益航,25,0,25,陽信-石牌,2023-08-11,8711
00929,復華台灣科技優息,20,0,20,陽信-石牌,2023-08-11,8711
2617,台航,20,0,20,陽信-石牌,2023-08-11,8711
2897,王道銀行,20,0,20,陽信-石牌,2023-08-11,8711
8034,榮群,20,0,20,陽信-石牌,2023-08-11,8711
00923,群益台ESG低碳50,19,0,19,陽信-石牌,2023-08-11,8711
1727,中華化,18,0,18,陽信-石牌,2023-08-11,8711
00680L,元大美債20正2,16,0,16,陽信-石牌,2023-08-11,8711
4541,晟田,16,0,16,陽信-石牌,2023-08-11,8711
2801,彰銀,15,0,15,陽信-石牌,2023-08-11,8711
1808,潤隆,14,0,14,陽信-石牌,2023-08-11,8711
6770,力積電,14,0,14,陽信-石牌,2023-08-11,8711
2634,漢翔,20,7,13,陽信-石牌,2023-08-11,8711
3044,健鼎,16,4,12,陽信-石牌,2023-08-11,8711
3289,宜特,17,5,12,陽信-石牌,2023-08-11,8711
2002,中鋼,11,0,11,陽信-石牌,2023-08-11,8711
2014,中鴻,11,0,11,陽信-石牌,2023-08-11,8711
2312,金寶,12,1,11,陽信-石牌,2023-08-11,8711
2886,兆豐金,47,36,11,陽信-石牌,2023-08-11,8711
3325,旭品,11,0,11,陽信-石牌,2023-08-11,8711
00651R,復華香港反1,10,0,10,陽信-石牌,2023-08-11,8711
0056,元大高股息,12,2,10,陽信-石牌,2023-08-11,8711
1802,台玻,20,10,10,陽信-石牌,2023-08-11,8711
2405,輔信,10,0,10,陽信-石牌,2023-08-11,8711
2881,富邦金,10,0,10,陽信-石牌,2023-08-11,8711
3014,聯陽,10,0,10,陽信-石牌,2023-08-11,8711
4157,太景*-KY,10,0,10,陽信-石牌,2023-08-11,8711
6234,高僑,10,0,10,陽信-石牌,2023-08-11,8711
9938,百和,10,0,10,陽信-石牌,2023-08-11,8711
2454,聯發科,10,1,9,陽信-石牌,2023-08-11,8711
1447,力鵬,9,0,9,陽信-石牌,2023-08-11,8711
00885,富邦越南,20,11,9,陽信-石牌,2023-08-11,8711
2363,矽統,22,13,9,陽信-石牌,2023-08-11,8711
4763,材料-KY,11,2,9,陽信-石牌,2023-08-11,8711
00751B,元大AAA至A公司債,8,0,8,陽信-石牌,2023-08-11,8711
2356,英業達,30,22,8,陽信-石牌,2023-08-11,8711
3483,力致,8,0,8,陽信-石牌,2023-08-11,8711
6282,康舒,38,30,8,陽信-石牌,2023-08-11,8711
3481,群創,831,1,830,陽信-石牌,2023-08-14,8711
00900,富邦特選高股息30,269,0,269,陽信-石牌,2023-08-14,8711
2382,廣達,174,67,107,陽信-石牌,2023-08-14,8711
2891,中信金,102,0,102,陽信-石牌,2023-08-14,8711
2637,慧洋-KY,83,0,83,陽信-石牌,2023-08-14,8711
00753L,中信中國50正2,52,0,52,陽信-石牌,2023-08-14,8711
2897,王道銀行,51,0,51,陽信-石牌,2023-08-14,8711
6120,達運,51,1,50,陽信-石牌,2023-08-14,8711
00650L,復華香港正2,53,5,48,陽信-石牌,2023-08-14,8711
00878,國泰永續高股息,96,48,48,陽信-石牌,2023-08-14,8711
1710,東聯,48,0,48,陽信-石牌,2023-08-14,8711
1785,光洋科,46,0,46,陽信-石牌,2023-08-14,8711
1504,東元,49,8,41,陽信-石牌,2023-08-14,8711
00919,群益台灣精選高息,33,0,33,陽信-石牌,2023-08-14,8711
2618,長榮航,96,66,30,陽信-石牌,2023-08-14,8711
00931B,統一美債20年,24,0,24,陽信-石牌,2023-08-14,8711
00923,群益台ESG低碳50,24,0,24,陽信-石牌,2023-08-14,8711
2356,英業達,48,25,23,陽信-石牌,2023-08-14,8711
2344,華邦電,23,1,22,陽信-石牌,2023-08-14,8711
2610,華航,69,47,22,陽信-石牌,2023-08-14,8711
6116,彩晶,22,0,22,陽信-石牌,2023-08-14,8711
1905,華紙,37,18,19,陽信-石牌,2023-08-14,8711
2399,映泰,20,1,19,陽信-石牌,2023-08-14,8711
2530,華建,19,0,19,陽信-石牌,2023-08-14,8711
3231,緯創,55,38,17,陽信-石牌,2023-08-14,8711
2027,大成鋼,17,0,17,陽信-石牌,2023-08-14,8711
2401,凌陽,18,1,17,陽信-石牌,2023-08-14,8711
2312,金寶,17,1,16,陽信-石牌,2023-08-14,8711
8210,勤誠,21,5,16,陽信-石牌,2023-08-14,8711
9933,中鼎,21,5,16,陽信-石牌,2023-08-14,8711
2812,台中銀,15,0,15,陽信-石牌,2023-08-14,8711
6546,正基,15,0,15,陽信-石牌,2023-08-14,8711
8936,國統,15,0,15,陽信-石牌,2023-08-14,8711
2368,金像電,22,8,14,陽信-石牌,2023-08-14,8711
0050,元大台灣50,13,0,13,陽信-石牌,2023-08-14,8711
6182,合晶,14,1,13,陽信-石牌,2023-08-14,8711
00633L,富邦上証正2,12,0,12,陽信-石牌,2023-08-14,8711
2353,宏��,16,4,12,陽信-石牌,2023-08-14,8711
2444,兆勁,12,0,12,陽信-石牌,2023-08-14,8711
2201,裕隆,14,3,11,陽信-石牌,2023-08-14,8711
2402,毅嘉,16,5,11,陽信-石牌,2023-08-14,8711
2409,友達,12,1,11,陽信-石牌,2023-08-14,8711
2880,華南金,13,2,11,陽信-石牌,2023-08-14,8711
2881,富邦金,11,0,11,陽信-石牌,2023-08-14,8711
1339,昭輝,10,0,10,陽信-石牌,2023-08-14,8711
1101,台泥,11,1,10,陽信-石牌,2023-08-14,8711
1217,愛之味,10,0,10,陽信-石牌,2023-08-14,8711
00712,復華富時不動產,10,0,10,陽信-石牌,2023-08-14,8711
1598,岱宇,10,0,10,陽信-石牌,2023-08-14,8711
2439,美律,10,0,10,陽信-石牌,2023-08-14,8711
00923,群益台ESG低碳50,161,5,156,陽信-石牌,2023-08-15,8711
2637,慧洋-KY,78,1,77,陽信-石牌,2023-08-15,8711
00850,元大臺灣ESG永續,58,0,58,陽信-石牌,2023-08-15,8711
2891,中信金,60,5,55,陽信-石牌,2023-08-15,8711
00650L,復華香港正2,50,0,50,陽信-石牌,2023-08-15,8711
2382,廣達,87,53,34,陽信-石牌,2023-08-15,8711
2317,鴻海,36,5,31,陽信-石牌,2023-08-15,8711
00929,復華台灣科技優息,30,0,30,陽信-石牌,2023-08-15,8711
2356,英業達,46,22,24,陽信-石牌,2023-08-15,8711
2002,中鋼,23,0,23,陽信-石牌,2023-08-15,8711
00712,復華富時不動產,23,0,23,陽信-石牌,2023-08-15,8711
2609,陽明,104,81,23,陽信-石牌,2023-08-15,8711
2884,玉山金,22,0,22,陽信-石牌,2023-08-15,8711
2444,兆勁,22,1,21,陽信-石牌,2023-08-15,8711
1108,幸福,20,0,20,陽信-石牌,2023-08-15,8711
00772B,中信高評級公司債,20,0,20,陽信-石牌,2023-08-15,8711
2332,友訊,32,12,20,陽信-石牌,2023-08-15,8711
6116,彩晶,20,0,20,陽信-石牌,2023-08-15,8711
2881,富邦金,30,13,17,陽信-石牌,2023-08-15,8711
3481,群創,22,6,16,陽信-石牌,2023-08-15,8711
00900,富邦特選高股息30,38,22,16,陽信-石牌,2023-08-15,8711
00931B,統一美債20年,16,0,16,陽信-石牌,2023-08-15,8711
4927,泰鼎-KY,16,0,16,陽信-石牌,2023-08-15,8711
0050,元大台灣50,15,0,15,陽信-石牌,2023-08-15,8711
3308,聯德,25,10,15,陽信-石牌,2023-08-15,8711
9103,美德醫療-DR,13,0,13,陽信-石牌,2023-08-15,8711
00740B,富邦全球投等債,12,0,12,陽信-石牌,2023-08-15,8711
2312,金寶,12,0,12,陽信-石牌,2023-08-15,8711
3013,晟銘電,14,2,12,陽信-石牌,2023-08-15,8711
2330,台積電,12,1,11,陽信-石牌,2023-08-15,8711
0056,元大高股息,16,5,11,陽信-石牌,2023-08-15,8711
2801,彰銀,11,0,11,陽信-石牌,2023-08-15,8711
2883,凱基金,18,7,11,陽信-石牌,2023-08-15,8711
00679B,元大美債20年,10,0,10,陽信-石牌,2023-08-15,8711
2340,台亞,10,0,10,陽信-石牌,2023-08-15,8711
2617,台航,10,0,10,陽信-石牌,2023-08-15,8711
5009,榮剛,10,0,10,陽信-石牌,2023-08-15,8711
5392,能率,10,0,10,陽信-石牌,2023-08-15,8711
8426,紅木-KY,15,5,10,陽信-石牌,2023-08-15,8711
1101,台泥,32,23,9,陽信-石牌,2023-08-15,8711
2412,中華電,9,0,9,陽信-石牌,2023-08-15,8711
2363,矽統,56,47,9,陽信-石牌,2023-08-15,8711
2392,正崴,8,0,8,陽信-石牌,2023-08-15,8711
4906,正文,10,2,8,陽信-石牌,2023-08-15,8711
1477,聚陽,8,1,7,陽信-石牌,2023-08-15,8711
00751B,元大AAA至A公司債,7,0,7,陽信-石牌,2023-08-15,8711
1711,永光,7,0,7,陽信-石牌,2023-08-15,8711
2892,第一金,8,1,7,陽信-石牌,2023-08-15,8711
3056,富華新,7,0,7,陽信-石牌,2023-08-15,8711
3665,貿聯-KY,7,0,7,陽信-石牌,2023-08-15,8711
1710,東聯,425,0,425,陽信-石牌,2023-08-16,8711
3481,群創,427,12,415,陽信-石牌,2023-08-16,8711
2891,中信金,107,2,105,陽信-石牌,2023-08-16,8711
5876,上海商銀,61,0,61,陽信-石牌,2023-08-16,8711
8049,晶采,60,1,59,陽信-石牌,2023-08-16,8711
00878,國泰永續高股息,93,35,58,陽信-石牌,2023-08-16,8711
2890,永豐金,51,0,51,陽信-石牌,2023-08-16,8711
2329,華泰,79,40,39,陽信-石牌,2023-08-16,8711
2637,慧洋-KY,41,4,37,陽信-石牌,2023-08-16,8711
3231,緯創,102,67,35,陽信-石牌,2023-08-16,8711
2603,長榮,35,1,34,陽信-石牌,2023-08-16,8711
2610,華航,46,13,33,陽信-石牌,2023-08-16,8711
00931B,統一美債20年,30,0,30,陽信-石牌,2023-08-16,8711
8930,青鋼,26,0,26,陽信-石牌,2023-08-16,8711
00929,復華台灣科技優息,25,0,25,陽信-石牌,2023-08-16,8711
6116,彩晶,25,0,25,陽信-石牌,2023-08-16,8711
3706,神達,34,10,24,陽信-石牌,2023-08-16,8711
00679B,元大美債20年,32,9,23,陽信-石牌,2023-08-16,8711
2897,王道銀行,32,9,23,陽信-石牌,2023-08-16,8711
2303,聯電,69,47,22,陽信-石牌,2023-08-16,8711
2344,華邦電,22,1,21,陽信-石牌,2023-08-16,8711
6282,康舒,38,17,21,陽信-石牌,2023-08-16,8711
00722B,群益投資級電信債,20,0,20,陽信-石牌,2023-08-16,8711
1905,華紙,25,5,20,陽信-石牌,2023-08-16,8711
2886,兆豐金,21,1,20,陽信-石牌,2023-08-16,8711
5210,寶碩,20,0,20,陽信-石牌,2023-08-16,8711
3325,旭品,18,0,18,陽信-石牌,2023-08-16,8711
2323,中環,19,2,17,陽信-石牌,2023-08-16,8711
2356,英業達,33,16,17,陽信-石牌,2023-08-16,8711
2883,凱基金,26,10,16,陽信-石牌,2023-08-16,8711
8112,至上,15,0,15,陽信-石牌,2023-08-16,8711
1909,榮成,14,0,14,陽信-石牌,2023-08-16,8711
2618,長榮航,29,15,14,陽信-石牌,2023-08-16,8711
6706,惠特,15,1,14,陽信-石牌,2023-08-16,8711
1609,大亞,19,6,13,陽信-石牌,2023-08-16,8711
3363,上詮,21,8,13,陽信-石牌,2023-08-16,8711
1301,台塑,12,0,12,陽信-石牌,2023-08-16,8711
00923,群益台ESG低碳50,12,1,11,陽信-石牌,2023-08-16,8711
2317,鴻海,15,4,11,陽信-石牌,2023-08-16,8711
1217,愛之味,10,0,10,陽信-石牌,2023-08-16,8711
3228,金麗科,10,0,10,陽信-石牌,2023-08-16,8711
6743,安普新,10,0,10,陽信-石牌,2023-08-16,8711
9938,百和,10,0,10,陽信-石牌,2023-08-16,8711
8069,元太,12,3,9,陽信-石牌,2023-08-16,8711
3588,通嘉,10,1,9,陽信-石牌,2023-08-16,8711
2851,中再保,8,0,8,陽信-石牌,2023-08-16,8711
2880,華南金,9,1,8,陽信-石牌,2023-08-16,8711
2913,農林,19,11,8,陽信-石牌,2023-08-16,8711
5381,合正,8,0,8,陽信-石牌,2023-08-16,8711
3037,欣興,12,5,7,陽信-石牌,2023-08-16,8711
2888,新光金,65,0,65,陽信-石牌,2023-08-17,8711
6231,系微,56,0,56,陽信-石牌,2023-08-17,8711
2890,永豐金,54,0,54,陽信-石牌,2023-08-17,8711
00929,復華台灣科技優息,47,0,47,陽信-石牌,2023-08-17,8711
3231,緯創,227,187,40,陽信-石牌,2023-08-17,8711
2324,仁寶,125,88,37,陽信-石牌,2023-08-17,8711
2610,華航,47,10,37,陽信-石牌,2023-08-17,8711
1710,東聯,30,0,30,陽信-石牌,2023-08-17,8711
00931B,統一美債20年,27,0,27,陽信-石牌,2023-08-17,8711
6274,台燿,29,2,27,陽信-石牌,2023-08-17,8711
5210,寶碩,25,0,25,陽信-石牌,2023-08-17,8711
00753L,中信中國50正2,23,0,23,陽信-石牌,2023-08-17,8711
00900,富邦特選高股息30,21,0,21,陽信-石牌,2023-08-17,8711
2303,聯電,26,5,21,陽信-石牌,2023-08-17,8711
00688L,國泰20年美債正2,20,0,20,陽信-石牌,2023-08-17,8711
2834,臺企銀,20,0,20,陽信-石牌,2023-08-17,8711
2301,光寶科,40,22,18,陽信-石牌,2023-08-17,8711
2014,中鴻,16,0,16,陽信-石牌,2023-08-17,8711
6275,元山,22,6,16,陽信-石牌,2023-08-17,8711
00898,國泰基因免疫革命,15,0,15,陽信-石牌,2023-08-17,8711
00664R,國泰臺灣加權反1,15,0,15,陽信-石牌,2023-08-17,8711
4533,協易機,14,0,14,陽信-石牌,2023-08-17,8711
6235,華孚,37,23,14,陽信-石牌,2023-08-17,8711
00687B,國泰20年美債,13,0,13,陽信-石牌,2023-08-17,8711
00772B,中信高評級公司債,13,0,13,陽信-石牌,2023-08-17,8711
00923,群益台ESG低碳50,13,0,13,陽信-石牌,2023-08-17,8711
2382,廣達,111,98,13,陽信-石牌,2023-08-17,8711
1101,台泥,12,0,12,陽信-石牌,2023-08-17,8711
2369,菱生,15,3,12,陽信-石牌,2023-08-17,8711
2371,大同,22,10,12,陽信-石牌,2023-08-17,8711
2637,慧洋-KY,20,8,12,陽信-石牌,2023-08-17,8711
6125,廣運,24,12,12,陽信-石牌,2023-08-17,8711
00795B,中信美國公債20年,11,0,11,陽信-石牌,2023-08-17,8711
2801,彰銀,11,0,11,陽信-石牌,2023-08-17,8711
00680L,元大美債20正2,10,0,10,陽信-石牌,2023-08-17,8711
00706L,期元大S＆P日圓正2,10,0,10,陽信-石牌,2023-08-17,8711
1314,中石化,12,2,10,陽信-石牌,2023-08-17,8711
1467,南緯,10,0,10,陽信-石牌,2023-08-17,8711
3296,勝德,10,0,10,陽信-石牌,2023-08-17,8711
5439,高技,12,3,9,陽信-石牌,2023-08-17,8711
00878,國泰永續高股息,28,19,9,陽信-石牌,2023-08-17,8711
3105,穩懋,8,0,8,陽信-石牌,2023-08-17,8711
2332,友訊,17,9,8,陽信-石牌,2023-08-17,8711
00712,復華富時不動產,7,0,7,陽信-石牌,2023-08-17,8711
6116,彩晶,8,1,7,陽信-石牌,2023-08-17,8711
6204,艾華,7,0,7,陽信-石牌,2023-08-17,8711
8210,勤誠,17,10,7,陽信-石牌,2023-08-17,8711
2454,聯發科,7,1,6,陽信-石牌,2023-08-17,8711
00679B,元大美債20年,7,1,6,陽信-石牌,2023-08-17,8711
2002,中鋼,6,0,6,陽信-石牌,2023-08-17,8711
00680L,元大美債20正2,520,2,518,陽信-石牌,2023-08-18,8711
2329,華泰,219,55,164,陽信-石牌,2023-08-18,8711
00751B,元大AAA至A公司債,124,0,124,陽信-石牌,2023-08-18,8711
2324,仁寶,157,76,81,陽信-石牌,2023-08-18,8711
2344,華邦電,81,0,81,陽信-石牌,2023-08-18,8711
00929,復華台灣科技優息,72,0,72,陽信-石牌,2023-08-18,8711
3231,緯創,173,111,62,陽信-石牌,2023-08-18,8711
6125,廣運,38,6,32,陽信-石牌,2023-08-18,8711
3005,神基,41,10,31,陽信-石牌,2023-08-18,8711
9105,泰金寶-DR,30,0,30,陽信-石牌,2023-08-18,8711
00885,富邦越南,26,0,26,陽信-石牌,2023-08-18,8711
6282,康舒,38,15,23,陽信-石牌,2023-08-18,8711
3037,欣興,29,7,22,陽信-石牌,2023-08-18,8711
3043,科風,28,6,22,陽信-石牌,2023-08-18,8711
2376,技嘉,39,18,21,陽信-石牌,2023-08-18,8711
1609,大亞,41,21,20,陽信-石牌,2023-08-18,8711
00665L,富邦�琤肭磪囓�2,35,15,20,陽信-石牌,2023-08-18,8711
5210,寶碩,20,0,20,陽信-石牌,2023-08-18,8711
5234,達興材料,20,0,20,陽信-石牌,2023-08-18,8711
2402,毅嘉,48,30,18,陽信-石牌,2023-08-18,8711
2618,長榮航,35,18,17,陽信-石牌,2023-08-18,8711
2356,英業達,32,16,16,陽信-石牌,2023-08-18,8711
1101,台泥,15,0,15,陽信-石牌,2023-08-18,8711
1789,神隆,15,0,15,陽信-石牌,2023-08-18,8711
2355,敬鵬,21,6,15,陽信-石牌,2023-08-18,8711
6142,友勁,14,0,14,陽信-石牌,2023-08-18,8711
2449,京元電子,12,0,12,陽信-石牌,2023-08-18,8711
3521,鴻翊,12,0,12,陽信-石牌,2023-08-18,8711
6016,康和證,12,0,12,陽信-石牌,2023-08-18,8711
1905,華紙,20,9,11,陽信-石牌,2023-08-18,8711
2338,光罩,11,0,11,陽信-石牌,2023-08-18,8711
6275,元山,11,0,11,陽信-石牌,2023-08-18,8711
1313,聯成,10,0,10,陽信-石牌,2023-08-18,8711
00882,中信中國高股息,10,0,10,陽信-石牌,2023-08-18,8711
2481,強茂,10,0,10,陽信-石牌,2023-08-18,8711
2489,瑞軒,10,0,10,陽信-石牌,2023-08-18,8711
2851,中再保,10,0,10,陽信-石牌,2023-08-18,8711
4906,正文,11,1,10,陽信-石牌,2023-08-18,8711
6244,茂迪,10,0,10,陽信-石牌,2023-08-18,8711
6546,正基,10,0,10,陽信-石牌,2023-08-18,8711
6589,台康生技,10,0,10,陽信-石牌,2023-08-18,8711
2206,三陽工業,11,2,9,陽信-石牌,2023-08-18,8711
3056,富華新,30,22,8,陽信-石牌,2023-08-18,8711
3042,晶技,11,3,8,陽信-石牌,2023-08-18,8711
6274,台燿,10,2,8,陽信-石牌,2023-08-18,8711
1477,聚陽,11,4,7,陽信-石牌,2023-08-18,8711
2308,台達電,7,0,7,陽信-石牌,2023-08-18,8711
2323,中環,24,17,7,陽信-石牌,2023-08-18,8711
3265,台星科,9,2,7,陽信-石牌,2023-08-18,8711
3583,辛耘,8,1,7,陽信-石牌,2023-08-18,8711
00680L,元大美債20正2,102,0,102,陽信-石牌,2023-08-21,8711
00923,群益台ESG低碳50,73,0,73,陽信-石牌,2023-08-21,8711
00929,復華台灣科技優息,67,6,61,陽信-石牌,2023-08-21,8711
00650L,復華香港正2,70,20,50,陽信-石牌,2023-08-21,8711
00656R,國泰中國A50反1,50,0,50,陽信-石牌,2023-08-21,8711
2382,廣達,88,47,41,陽信-石牌,2023-08-21,8711
2610,華航,49,12,37,陽信-石牌,2023-08-21,8711
3042,晶技,72,35,37,陽信-石牌,2023-08-21,8711
5608,四維航,34,0,34,陽信-石牌,2023-08-21,8711
2603,長榮,33,1,32,陽信-石牌,2023-08-21,8711
00712,復華富時不動產,30,0,30,陽信-石牌,2023-08-21,8711
2609,陽明,28,2,26,陽信-石牌,2023-08-21,8711
2637,慧洋-KY,41,15,26,陽信-石牌,2023-08-21,8711
2892,第一金,25,0,25,陽信-石牌,2023-08-21,8711
00919,群益台灣精選高息,21,0,21,陽信-石牌,2023-08-21,8711
2548,華固,21,0,21,陽信-石牌,2023-08-21,8711
1504,東元,16,0,16,陽信-石牌,2023-08-21,8711
3056,富華新,15,0,15,陽信-石牌,2023-08-21,8711
2383,台光電,18,4,14,陽信-石牌,2023-08-21,8711
6585,鼎基,14,0,14,陽信-石牌,2023-08-21,8711
2606,裕民,21,8,13,陽信-石牌,2023-08-21,8711
2344,華邦電,12,0,12,陽信-石牌,2023-08-21,8711
2634,漢翔,13,1,12,陽信-石牌,2023-08-21,8711
00688L,國泰20年美債正2,10,0,10,陽信-石牌,2023-08-21,8711
1802,台玻,10,0,10,陽信-石牌,2023-08-21,8711
2402,毅嘉,10,0,10,陽信-石牌,2023-08-21,8711
2405,輔信,10,0,10,陽信-石牌,2023-08-21,8711
2888,新光金,10,0,10,陽信-石牌,2023-08-21,8711
2890,永豐金,10,0,10,陽信-石牌,2023-08-21,8711
6108,競國,28,18,10,陽信-石牌,2023-08-21,8711
1101,台泥,11,2,9,陽信-石牌,2023-08-21,8711
9103,美德醫療-DR,9,0,9,陽信-石牌,2023-08-21,8711
2324,仁寶,9,2,7,陽信-石牌,2023-08-21,8711
6160,欣技,7,0,7,陽信-石牌,2023-08-21,8711
00665L,富邦�琤肭磪囓�2,38,32,6,陽信-石牌,2023-08-21,8711
00633L,富邦上証正2,6,0,6,陽信-石牌,2023-08-21,8711
6190,萬泰科,6,0,6,陽信-石牌,2023-08-21,8711
6197,佳必琪,7,1,6,陽信-石牌,2023-08-21,8711
1301,台塑,5,0,5,陽信-石牌,2023-08-21,8711
1529,樂事綠能,5,0,5,陽信-石牌,2023-08-21,8711
1513,中興電,6,1,5,陽信-石牌,2023-08-21,8711
00881,國泰台灣5G+,5,0,5,陽信-石牌,2023-08-21,8711
00888,永豐台灣ESG,5,0,5,陽信-石牌,2023-08-21,8711
00637L,元大滬深300正2,5,0,5,陽信-石牌,2023-08-21,8711
2313,華通,5,0,5,陽信-石牌,2023-08-21,8711
2316,楠梓電,5,0,5,陽信-石牌,2023-08-21,8711
2332,友訊,10,5,5,陽信-石牌,2023-08-21,8711
2354,鴻準,5,0,5,陽信-石牌,2023-08-21,8711
2801,彰銀,5,0,5,陽信-石牌,2023-08-21,8711
4167,松瑞藥,5,0,5,陽信-石牌,2023-08-21,8711
2906,高林,76,0,76,陽信-石牌,2023-08-22,8711
2363,矽統,139,76,63,陽信-石牌,2023-08-22,8711
2324,仁寶,103,46,57,陽信-石牌,2023-08-22,8711
00878,國泰永續高股息,56,10,46,陽信-石牌,2023-08-22,8711
00680L,元大美債20正2,39,1,38,陽信-石牌,2023-08-22,8711
00637L,元大滬深300正2,35,0,35,陽信-石牌,2023-08-22,8711
2883,凱基金,33,0,33,陽信-石牌,2023-08-22,8711
6176,瑞儀,41,8,33,陽信-石牌,2023-08-22,8711
00650L,復華香港正2,34,4,30,陽信-石牌,2023-08-22,8711
2421,建準,49,22,27,陽信-石牌,2023-08-22,8711
1471,首利,25,1,24,陽信-石牌,2023-08-22,8711
5608,四維航,22,0,22,陽信-石牌,2023-08-22,8711
2618,長榮航,51,31,20,陽信-石牌,2023-08-22,8711
2890,永豐金,20,0,20,陽信-石牌,2023-08-22,8711
9904,寶成,20,0,20,陽信-石牌,2023-08-22,8711
6125,廣運,39,20,19,陽信-石牌,2023-08-22,8711
00929,復華台灣科技優息,17,2,15,陽信-石牌,2023-08-22,8711
2368,金像電,15,0,15,陽信-石牌,2023-08-22,8711
2891,中信金,15,0,15,陽信-石牌,2023-08-22,8711
6190,萬泰科,15,0,15,陽信-石牌,2023-08-22,8711
00712,復華富時不動產,14,0,14,陽信-石牌,2023-08-22,8711
2312,金寶,30,16,14,陽信-石牌,2023-08-22,8711
5478,智冠,14,0,14,陽信-石牌,2023-08-22,8711
1905,華紙,25,12,13,陽信-石牌,2023-08-22,8711
2002,中鋼,13,0,13,陽信-石牌,2023-08-22,8711
2329,華泰,21,8,13,陽信-石牌,2023-08-22,8711
2409,友達,13,0,13,陽信-石牌,2023-08-22,8711
2356,英業達,25,13,12,陽信-石牌,2023-08-22,8711
8050,廣積,18,6,12,陽信-石牌,2023-08-22,8711
00720B,元大投資級公司債,10,0,10,陽信-石牌,2023-08-22,8711
00795B,中信美國公債20年,10,0,10,陽信-石牌,2023-08-22,8711
00923,群益台ESG低碳50,10,0,10,陽信-石牌,2023-08-22,8711
1737,臺鹽,10,0,10,陽信-石牌,2023-08-22,8711
2427,三商電,10,0,10,陽信-石牌,2023-08-22,8711
2617,台航,10,0,10,陽信-石牌,2023-08-22,8711
2637,慧洋-KY,22,12,10,陽信-石牌,2023-08-22,8711
3052,夆典,10,0,10,陽信-石牌,2023-08-22,8711
3673,TPK-KY,10,0,10,陽信-石牌,2023-08-22,8711
6016,康和證,10,0,10,陽信-石牌,2023-08-22,8711
6120,達運,10,0,10,陽信-石牌,2023-08-22,8711
6231,系微,11,1,10,陽信-石牌,2023-08-22,8711
8076,伍豐,10,0,10,陽信-石牌,2023-08-22,8711
8930,青鋼,10,0,10,陽信-石牌,2023-08-22,8711
9934,成霖,10,0,10,陽信-石牌,2023-08-22,8711
1104,環泥,9,0,9,陽信-石牌,2023-08-22,8711
2015,豐興,9,0,9,陽信-石牌,2023-08-22,8711
2634,漢翔,12,3,9,陽信-石牌,2023-08-22,8711
1598,岱宇,8,0,8,陽信-石牌,2023-08-22,8711
3306,鼎天,17,9,8,陽信-石牌,2023-08-22,8711
3567,逸昌,26,18,8,陽信-石牌,2023-08-22,8711
00751B,元大AAA至A公司債,100,0,100,陽信-石牌,2023-08-23,8711
3005,神基,76,0,76,陽信-石牌,2023-08-23,8711
2603,長榮,50,3,47,陽信-石牌,2023-08-23,8711
2883,凱基金,42,0,42,陽信-石牌,2023-08-23,8711
3042,晶技,56,14,42,陽信-石牌,2023-08-23,8711
2382,廣達,87,46,41,陽信-石牌,2023-08-23,8711
00919,群益台灣精選高息,31,0,31,陽信-石牌,2023-08-23,8711
2355,敬鵬,55,24,31,陽信-石牌,2023-08-23,8711
2618,長榮航,68,40,28,陽信-石牌,2023-08-23,8711
6167,久正,47,20,27,陽信-石牌,2023-08-23,8711
3071,協禧,40,15,25,陽信-石牌,2023-08-23,8711
00713,元大台灣高息低波,24,0,24,陽信-石牌,2023-08-23,8711
00929,復華台灣科技優息,29,7,22,陽信-石牌,2023-08-23,8711
2352,佳世達,20,0,20,陽信-石牌,2023-08-23,8711
1519,華城,33,14,19,陽信-石牌,2023-08-23,8711
3094,聯傑,19,1,18,陽信-石牌,2023-08-23,8711
2637,慧洋-KY,27,10,17,陽信-石牌,2023-08-23,8711
3483,力致,19,4,15,陽信-石牌,2023-08-23,8711
2634,漢翔,100,85,15,陽信-石牌,2023-08-23,8711
2027,大成鋼,13,0,13,陽信-石牌,2023-08-23,8711
2332,友訊,49,36,13,陽信-石牌,2023-08-23,8711
2344,華邦電,12,0,12,陽信-石牌,2023-08-23,8711
9950,萬國通,12,0,12,陽信-石牌,2023-08-23,8711
00931B,統一美債20年,11,0,11,陽信-石牌,2023-08-23,8711
2892,第一金,11,0,11,陽信-石牌,2023-08-23,8711
5371,中光電,15,4,11,陽信-石牌,2023-08-23,8711
6282,康舒,28,17,11,陽信-石牌,2023-08-23,8711
00680L,元大美債20正2,10,0,10,陽信-石牌,2023-08-23,8711
1460,宏遠,10,0,10,陽信-石牌,2023-08-23,8711
2601,益航,10,0,10,陽信-石牌,2023-08-23,8711
6015,宏遠證,10,0,10,陽信-石牌,2023-08-23,8711
8426,紅木-KY,10,0,10,陽信-石牌,2023-08-23,8711
3051,力特,16,7,9,陽信-石牌,2023-08-23,8711
2913,農林,15,6,9,陽信-石牌,2023-08-23,8711
6274,台燿,14,6,8,陽信-石牌,2023-08-23,8711
1442,名軒,8,0,8,陽信-石牌,2023-08-23,8711
2707,晶華,8,0,8,陽信-石牌,2023-08-23,8711
3325,旭品,11,3,8,陽信-石牌,2023-08-23,8711
3380,明泰,10,2,8,陽信-石牌,2023-08-23,8711
5388,中磊,10,2,8,陽信-石牌,2023-08-23,8711
6170,統振,12,4,8,陽信-石牌,2023-08-23,8711
2002,中鋼,8,1,7,陽信-石牌,2023-08-23,8711
2421,建準,9,2,7,陽信-石牌,2023-08-23,8711
3013,晟銘電,35,28,7,陽信-石牌,2023-08-23,8711
3715,定穎投控,26,19,7,陽信-石牌,2023-08-23,8711
6125,廣運,38,31,7,陽信-石牌,2023-08-23,8711
8027,鈦昇,14,7,7,陽信-石牌,2023-08-23,8711
1808,潤隆,6,0,6,陽信-石牌,2023-08-23,8711
1810,和成,15,9,6,陽信-石牌,2023-08-23,8711
2376,技嘉,12,6,6,陽信-石牌,2023-08-23,8711
1802,台玻,400,0,400,陽信-石牌,2023-08-24,8711
00713,元大台灣高息低波,200,0,200,陽信-石牌,2023-08-24,8711
00878,國泰永續高股息,205,50,155,陽信-石牌,2023-08-24,8711
00715L,期街口布蘭特正2,90,0,90,陽信-石牌,2023-08-24,8711
2324,仁寶,67,13,54,陽信-石牌,2023-08-24,8711
2363,矽統,186,134,52,陽信-石牌,2023-08-24,8711
2382,廣達,112,79,33,陽信-石牌,2023-08-24,8711
2609,陽明,73,41,32,陽信-石牌,2023-08-24,8711
00633L,富邦上証正2,30,1,29,陽信-石牌,2023-08-24,8711
00929,復華台灣科技優息,54,26,28,陽信-石牌,2023-08-24,8711
2449,京元電子,52,31,21,陽信-石牌,2023-08-24,8711
5452,佶優,19,0,19,陽信-石牌,2023-08-24,8711
3231,緯創,190,172,18,陽信-石牌,2023-08-24,8711
00881,國泰台灣5G+,22,5,17,陽信-石牌,2023-08-24,8711
2002,中鋼,17,0,17,陽信-石牌,2023-08-24,8711
8210,勤誠,27,10,17,陽信-石牌,2023-08-24,8711
00919,群益台灣精選高息,18,2,16,陽信-石牌,2023-08-24,8711
8050,廣積,19,3,16,陽信-石牌,2023-08-24,8711
4906,正文,28,13,15,陽信-石牌,2023-08-24,8711
6282,康舒,14,1,13,陽信-石牌,2023-08-24,8711
6176,瑞儀,13,0,13,陽信-石牌,2023-08-24,8711
2383,台光電,15,3,12,陽信-石牌,2023-08-24,8711
2883,凱基金,13,1,12,陽信-石牌,2023-08-24,8711
0050,元大台灣50,11,0,11,陽信-石牌,2023-08-24,8711
1101,台泥,11,0,11,陽信-石牌,2023-08-24,8711
4542,科嶠,11,0,11,陽信-石牌,2023-08-24,8711
6167,久正,20,9,11,陽信-石牌,2023-08-24,8711
6274,台燿,28,18,10,陽信-石牌,2023-08-24,8711
1305,華夏,10,0,10,陽信-石牌,2023-08-24,8711
00664R,國泰臺灣加權反1,10,0,10,陽信-石牌,2023-08-24,8711
2440,太空梭,10,0,10,陽信-石牌,2023-08-24,8711
2880,華南金,10,0,10,陽信-石牌,2023-08-24,8711
6770,力積電,10,0,10,陽信-石牌,2023-08-24,8711
2409,友達,20,11,9,陽信-石牌,2023-08-24,8711
2419,仲琦,24,15,9,陽信-石牌,2023-08-24,8711
8033,雷虎,13,4,9,陽信-石牌,2023-08-24,8711
8403,盛弘,9,0,9,陽信-石牌,2023-08-24,8711
3596,智易,18,10,8,陽信-石牌,2023-08-24,8711
2359,所羅門,20,12,8,陽信-石牌,2023-08-24,8711
00637L,元大滬深300正2,6,0,6,陽信-石牌,2023-08-24,8711
2352,佳世達,6,0,6,陽信-石牌,2023-08-24,8711
2637,慧洋-KY,6,0,6,陽信-石牌,2023-08-24,8711
3707,漢磊,7,1,6,陽信-石牌,2023-08-24,8711
4123,晟德,6,0,6,陽信-石牌,2023-08-24,8711
00687B,國泰20年美債,5,0,5,陽信-石牌,2023-08-24,8711
00931B,統一美債20年,5,0,5,陽信-石牌,2023-08-24,8711
2727,王品,5,0,5,陽信-石牌,2023-08-24,8711
2882,國泰金,5,0,5,陽信-石牌,2023-08-24,8711
3715,定穎投控,25,20,5,陽信-石牌,2023-08-24,8711
5478,智冠,5,0,5,陽信-石牌,2023-08-24,8711
1802,台玻,405,5,400,陽信-石牌,2023-08-25,8711
00878,國泰永續高股息,198,30,168,陽信-石牌,2023-08-25,8711
3231,緯創,227,69,158,陽信-石牌,2023-08-25,8711
5371,中光電,101,1,100,陽信-石牌,2023-08-25,8711
2449,京元電子,117,26,91,陽信-石牌,2023-08-25,8711
7402,邑錡,104,16,88,陽信-石牌,2023-08-25,8711
2886,兆豐金,64,6,58,陽信-石牌,2023-08-25,8711
00885,富邦越南,50,0,50,陽信-石牌,2023-08-25,8711
2344,華邦電,41,0,41,陽信-石牌,2023-08-25,8711
2610,華航,49,16,33,陽信-石牌,2023-08-25,8711
2892,第一金,33,0,33,陽信-石牌,2023-08-25,8711
3042,晶技,49,16,33,陽信-石牌,2023-08-25,8711
00919,群益台灣精選高息,32,0,32,陽信-石牌,2023-08-25,8711
8240,華宏,31,0,31,陽信-石牌,2023-08-25,8711
8222,寶一,41,11,30,陽信-石牌,2023-08-25,8711
2356,英業達,47,17,30,陽信-石牌,2023-08-25,8711
2637,慧洋-KY,30,0,30,陽信-石牌,2023-08-25,8711
1905,華紙,42,15,27,陽信-石牌,2023-08-25,8711
3037,欣興,28,2,26,陽信-石牌,2023-08-25,8711
2883,凱基金,25,0,25,陽信-石牌,2023-08-25,8711
6275,元山,25,0,25,陽信-石牌,2023-08-25,8711
6282,康舒,32,7,25,陽信-石牌,2023-08-25,8711
2618,長榮航,30,6,24,陽信-石牌,2023-08-25,8711
3051,力特,24,0,24,陽信-石牌,2023-08-25,8711
00929,復華台灣科技優息,26,3,23,陽信-石牌,2023-08-25,8711
2630,亞航,26,3,23,陽信-石牌,2023-08-25,8711
2634,漢翔,71,50,21,陽信-石牌,2023-08-25,8711
1305,華夏,20,0,20,陽信-石牌,2023-08-25,8711
00650L,復華香港正2,20,0,20,陽信-石牌,2023-08-25,8711
2603,長榮,25,5,20,陽信-石牌,2023-08-25,8711
2605,新興,20,0,20,陽信-石牌,2023-08-25,8711
4543,萬在,22,2,20,陽信-石牌,2023-08-25,8711
6016,康和證,20,0,20,陽信-石牌,2023-08-25,8711
2891,中信金,16,0,16,陽信-石牌,2023-08-25,8711
2330,台積電,16,1,15,陽信-石牌,2023-08-25,8711
00680L,元大美債20正2,15,0,15,陽信-石牌,2023-08-25,8711
2376,技嘉,35,20,15,陽信-石牌,2023-08-25,8711
3035,智原,27,12,15,陽信-石牌,2023-08-25,8711
2002,中鋼,15,1,14,陽信-石牌,2023-08-25,8711
2913,農林,19,5,14,陽信-石牌,2023-08-25,8711
8210,勤誠,15,1,14,陽信-石牌,2023-08-25,8711
2301,光寶科,26,13,13,陽信-石牌,2023-08-25,8711
3055,蔚華科,12,0,12,陽信-石牌,2023-08-25,8711
00665L,富邦�琤肭磪囓�2,16,5,11,陽信-石牌,2023-08-25,8711
1598,岱宇,11,0,11,陽信-石牌,2023-08-25,8711
2353,宏��,11,0,11,陽信-石牌,2023-08-25,8711
0050,元大台灣50,11,0,11,陽信-石牌,2023-08-25,8711
00905,FT臺灣Smart,10,0,10,陽信-石牌,2023-08-25,8711
00634R,富邦上証反1,10,0,10,陽信-石牌,2023-08-25,8711
2027,大成鋼,10,0,10,陽信-石牌,2023-08-25,8711
00929,復華台灣科技優息,102,0,102,陽信-石牌,2023-08-28,8711
3234,光環,101,0,101,陽信-石牌,2023-08-28,8711
00713,元大台灣高息低波,72,0,72,陽信-石牌,2023-08-28,8711
3231,緯創,111,48,63,陽信-石牌,2023-08-28,8711
00712,復華富時不動產,60,0,60,陽信-石牌,2023-08-28,8711
2388,威盛,43,7,36,陽信-石牌,2023-08-28,8711
1471,首利,34,2,32,陽信-石牌,2023-08-28,8711
2382,廣達,63,32,31,陽信-石牌,2023-08-28,8711
1609,大亞,31,0,31,陽信-石牌,2023-08-28,8711
2891,中信金,30,0,30,陽信-石牌,2023-08-28,8711
6190,萬泰科,30,0,30,陽信-石牌,2023-08-28,8711
3051,力特,31,2,29,陽信-石牌,2023-08-28,8711
00878,國泰永續高股息,97,70,27,陽信-石牌,2023-08-28,8711
2323,中環,25,0,25,陽信-石牌,2023-08-28,8711
0056,元大高股息,26,2,24,陽信-石牌,2023-08-28,8711
2421,建準,27,3,24,陽信-石牌,2023-08-28,8711
2486,一詮,24,1,23,陽信-石牌,2023-08-28,8711
3005,神基,23,0,23,陽信-石牌,2023-08-28,8711
3711,日月光投控,32,9,23,陽信-石牌,2023-08-28,8711
5608,四維航,20,0,20,陽信-石牌,2023-08-28,8711
6016,康和證,20,0,20,陽信-石牌,2023-08-28,8711
8110,華東,20,0,20,陽信-石牌,2023-08-28,8711
00885,富邦越南,20,1,19,陽信-石牌,2023-08-28,8711
4916,事欣科,25,7,18,陽信-石牌,2023-08-28,8711
6275,元山,17,1,16,陽信-石牌,2023-08-28,8711
00724B,群益投資級金融債,15,0,15,陽信-石牌,2023-08-28,8711
1762,中化生,15,0,15,陽信-石牌,2023-08-28,8711
2449,京元電子,21,8,13,陽信-石牌,2023-08-28,8711
2618,長榮航,79,66,13,陽信-石牌,2023-08-28,8711
3481,群創,24,12,12,陽信-石牌,2023-08-28,8711
1612,宏泰,12,0,12,陽信-石牌,2023-08-28,8711
3042,晶技,17,5,12,陽信-石牌,2023-08-28,8711
3528,安馳,15,3,12,陽信-石牌,2023-08-28,8711
3548,兆利,15,3,12,陽信-石牌,2023-08-28,8711
8050,廣積,13,1,12,陽信-石牌,2023-08-28,8711
1529,樂事綠能,10,0,10,陽信-石牌,2023-08-28,8711
00722B,群益投資級電信債,10,0,10,陽信-石牌,2023-08-28,8711
2601,益航,20,10,10,陽信-石牌,2023-08-28,8711
3056,富華新,10,0,10,陽信-石牌,2023-08-28,8711
3518,柏騰,10,0,10,陽信-石牌,2023-08-28,8711
5439,高技,10,0,10,陽信-石牌,2023-08-28,8711
6015,宏遠證,10,0,10,陽信-石牌,2023-08-28,8711
8341,日友,10,0,10,陽信-石牌,2023-08-28,8711
8926,台汽電,10,0,10,陽信-石牌,2023-08-28,8711
00764B,群益25年美債,10,1,9,陽信-石牌,2023-08-28,8711
1785,光洋科,9,0,9,陽信-石牌,2023-08-28,8711
2331,精英,17,8,9,陽信-石牌,2023-08-28,8711
4763,材料-KY,11,3,8,陽信-石牌,2023-08-28,8711
2630,亞航,17,9,8,陽信-石牌,2023-08-28,8711
3308,聯德,12,4,8,陽信-石牌,2023-08-28,8711
00650L,復華香港正2,89,20,69,陽信-石牌,2023-08-29,8711
2317,鴻海,51,2,49,陽信-石牌,2023-08-29,8711
3481,群創,40,0,40,陽信-石牌,2023-08-29,8711
2363,矽統,121,86,35,陽信-石牌,2023-08-29,8711
2027,大成鋼,23,0,23,陽信-石牌,2023-08-29,8711
1815,富喬,20,0,20,陽信-石牌,2023-08-29,8711
6116,彩晶,20,0,20,陽信-石牌,2023-08-29,8711
2329,華泰,47,28,19,陽信-石牌,2023-08-29,8711
2618,長榮航,44,25,19,陽信-石牌,2023-08-29,8711
4503,金雨,18,0,18,陽信-石牌,2023-08-29,8711
2630,亞航,35,18,17,陽信-石牌,2023-08-29,8711
00919,群益台灣精選高息,16,0,16,陽信-石牌,2023-08-29,8711
1203,味王,16,0,16,陽信-石牌,2023-08-29,8711
2913,農林,23,7,16,陽信-石牌,2023-08-29,8711
6274,台燿,17,1,16,陽信-石牌,2023-08-29,8711
5301,寶得利,13,0,13,陽信-石牌,2023-08-29,8711
8222,寶一,61,49,12,陽信-石牌,2023-08-29,8711
5284,jpp-KY,22,11,11,陽信-石牌,2023-08-29,8711
2601,益航,10,0,10,陽信-石牌,2023-08-29,8711
2801,彰銀,10,0,10,陽信-石牌,2023-08-29,8711
2903,遠百,10,0,10,陽信-石牌,2023-08-29,8711
3711,日月光投控,14,4,10,陽信-石牌,2023-08-29,8711
6143,振曜,10,0,10,陽信-石牌,2023-08-29,8711
8049,晶采,10,0,10,陽信-石牌,2023-08-29,8711
1319,東陽,17,8,9,陽信-石牌,2023-08-29,8711
2610,華航,43,34,9,陽信-石牌,2023-08-29,8711
3094,聯傑,11,2,9,陽信-石牌,2023-08-29,8711
1598,岱宇,8,0,8,陽信-石牌,2023-08-29,8711
2368,金像電,13,5,8,陽信-石牌,2023-08-29,8711
8033,雷虎,11,4,7,陽信-石牌,2023-08-29,8711
9933,中鼎,20,13,7,陽信-石牌,2023-08-29,8711
2303,聯電,8,2,6,陽信-石牌,2023-08-29,8711
4908,前鼎,6,0,6,陽信-石牌,2023-08-29,8711
00724B,群益投資級金融債,5,0,5,陽信-石牌,2023-08-29,8711
00923,群益台ESG低碳50,5,0,5,陽信-石牌,2023-08-29,8711
1455,集盛,5,0,5,陽信-石牌,2023-08-29,8711
1904,正隆,5,0,5,陽信-石牌,2023-08-29,8711
2409,友達,5,0,5,陽信-石牌,2023-08-29,8711
4960,誠美材,5,0,5,陽信-石牌,2023-08-29,8711
6167,久正,16,11,5,陽信-石牌,2023-08-29,8711
2002,中鋼,5,1,4,陽信-石牌,2023-08-29,8711
2331,精英,51,47,4,陽信-石牌,2023-08-29,8711
2419,仲琦,4,0,4,陽信-石牌,2023-08-29,8711
2462,良得電,4,0,4,陽信-石牌,2023-08-29,8711
3081,聯亞,6,2,4,陽信-石牌,2023-08-29,8711
4566,時碩工業,4,0,4,陽信-石牌,2023-08-29,8711
4979,華星光,5,1,4,陽信-石牌,2023-08-29,8711
3231,緯創,30,26,4,陽信-石牌,2023-08-29,8711
1314,中石化,3,0,3,陽信-石牌,2023-08-29,8711
2377,微星,3,0,3,陽信-石牌,2023-08-29,8711
00929,復華台灣科技優息,117,0,117,陽信-石牌,2023-08-30,8711
2382,廣達,112,34,78,陽信-石牌,2023-08-30,8711
3481,群創,57,5,52,陽信-石牌,2023-08-30,8711
5608,四維航,49,0,49,陽信-石牌,2023-08-30,8711
2002,中鋼,41,1,40,陽信-石牌,2023-08-30,8711
3406,玉晶光,24,0,24,陽信-石牌,2023-08-30,8711
00919,群益台灣精選高息,24,2,22,陽信-石牌,2023-08-30,8711
2610,華航,25,3,22,陽信-石牌,2023-08-30,8711
2891,中信金,20,0,20,陽信-石牌,2023-08-30,8711
5483,中美晶,20,0,20,陽信-石牌,2023-08-30,8711
2324,仁寶,22,6,16,陽信-石牌,2023-08-30,8711
5269,祥碩,17,1,16,陽信-石牌,2023-08-30,8711
6194,育富,16,0,16,陽信-石牌,2023-08-30,8711
1529,樂事綠能,16,1,15,陽信-石牌,2023-08-30,8711
2376,技嘉,41,26,15,陽信-石牌,2023-08-30,8711
5432,新門,16,1,15,陽信-石牌,2023-08-30,8711
2436,偉詮電,26,13,13,陽信-石牌,2023-08-30,8711
3037,欣興,21,8,13,陽信-石牌,2023-08-30,8711
5876,上海商銀,13,0,13,陽信-石牌,2023-08-30,8711
8210,勤誠,24,11,13,陽信-石牌,2023-08-30,8711
9103,美德醫療-DR,12,0,12,陽信-石牌,2023-08-30,8711
1217,愛之味,11,0,11,陽信-石牌,2023-08-30,8711
3044,健鼎,17,6,11,陽信-石牌,2023-08-30,8711
00724B,群益投資級金融債,10,0,10,陽信-石牌,2023-08-30,8711
5439,高技,10,0,10,陽信-石牌,2023-08-30,8711
2317,鴻海,16,7,9,陽信-石牌,2023-08-30,8711
2301,光寶科,18,9,9,陽信-石牌,2023-08-30,8711
2421,建準,12,3,9,陽信-石牌,2023-08-30,8711
2535,達欣工,8,0,8,陽信-石牌,2023-08-30,8711
2834,臺企銀,10,2,8,陽信-石牌,2023-08-30,8711
3617,碩天,9,1,8,陽信-石牌,2023-08-30,8711
5009,榮剛,43,35,8,陽信-石牌,2023-08-30,8711
5284,jpp-KY,7,0,7,陽信-石牌,2023-08-30,8711
2486,一詮,6,0,6,陽信-石牌,2023-08-30,8711
3081,聯亞,6,0,6,陽信-石牌,2023-08-30,8711
5243,乙盛-KY,6,0,6,陽信-石牌,2023-08-30,8711
00930,永豐ESG低碳高息,5,0,5,陽信-石牌,2023-08-30,8711
00679B,元大美債20年,5,0,5,陽信-石牌,2023-08-30,8711
1314,中石化,5,0,5,陽信-石牌,2023-08-30,8711
1417,嘉裕,7,2,5,陽信-石牌,2023-08-30,8711
1609,大亞,10,5,5,陽信-石牌,2023-08-30,8711
2230,泰茂,5,0,5,陽信-石牌,2023-08-30,8711
2303,聯電,50,45,5,陽信-石牌,2023-08-30,8711
2540,愛山林,5,0,5,陽信-石牌,2023-08-30,8711
2882,國泰金,5,0,5,陽信-石牌,2023-08-30,8711
3325,旭品,12,7,5,陽信-石牌,2023-08-30,8711
3607,谷崧,5,0,5,陽信-石牌,2023-08-30,8711
8033,雷虎,10,5,5,陽信-石牌,2023-08-30,8711
1319,東陽,10,6,4,陽信-石牌,2023-08-30,8711
2495,普安,4,0,4,陽信-石牌,2023-08-30,8711
3481,群創,146,0,146,陽信-石牌,2023-08-31,8711
2883,凱基金,86,0,86,陽信-石牌,2023-08-31,8711
2337,旺宏,90,17,73,陽信-石牌,2023-08-31,8711
2303,聯電,82,28,54,陽信-石牌,2023-08-31,8711
2610,華航,73,21,52,陽信-石牌,2023-08-31,8711
6547,高端疫苗,41,1,40,陽信-石牌,2023-08-31,8711
2618,長榮航,48,18,30,陽信-石牌,2023-08-31,8711
6126,信音,52,24,28,陽信-石牌,2023-08-31,8711
3715,定穎投控,46,19,27,陽信-石牌,2023-08-31,8711
2317,鴻海,45,20,25,陽信-石牌,2023-08-31,8711
00923,群益台ESG低碳50,22,0,22,陽信-石牌,2023-08-31,8711
2511,太子,22,0,22,陽信-石牌,2023-08-31,8711
1305,華夏,20,0,20,陽信-石牌,2023-08-31,8711
5439,高技,20,0,20,陽信-石牌,2023-08-31,8711
2359,所羅門,19,0,19,陽信-石牌,2023-08-31,8711
5608,四維航,19,0,19,陽信-石牌,2023-08-31,8711
00878,國泰永續高股息,60,43,17,陽信-石牌,2023-08-31,8711
2330,台積電,17,0,17,陽信-石牌,2023-08-31,8711
2356,英業達,17,2,15,陽信-石牌,2023-08-31,8711
00641R,富邦日本反1,15,0,15,陽信-石牌,2023-08-31,8711
2367,燿華,15,0,15,陽信-石牌,2023-08-31,8711
6770,力積電,15,0,15,陽信-石牌,2023-08-31,8711
1802,台玻,21,8,13,陽信-石牌,2023-08-31,8711
3051,力特,13,0,13,陽信-石牌,2023-08-31,8711
1904,正隆,11,0,11,陽信-石牌,2023-08-31,8711
2388,威盛,13,2,11,陽信-石牌,2023-08-31,8711
00697B,元大美債7-10,10,0,10,陽信-石牌,2023-08-31,8711
00671R,富邦NASDAQ反1,10,0,10,陽信-石牌,2023-08-31,8711
1217,愛之味,19,9,10,陽信-石牌,2023-08-31,8711
2440,太空梭,10,0,10,陽信-石牌,2023-08-31,8711
6015,宏遠證,10,0,10,陽信-石牌,2023-08-31,8711
8028,昇陽半導體,10,0,10,陽信-石牌,2023-08-31,8711
8110,華東,10,0,10,陽信-石牌,2023-08-31,8711
1612,宏泰,15,6,9,陽信-石牌,2023-08-31,8711
2376,技嘉,43,34,9,陽信-石牌,2023-08-31,8711
3311,閎暉,9,0,9,陽信-石牌,2023-08-31,8711
5225,東科-KY,15,6,9,陽信-石牌,2023-08-31,8711
1203,味王,8,0,8,陽信-石牌,2023-08-31,8711
5381,合正,11,3,8,陽信-石牌,2023-08-31,8711
2230,泰茂,6,0,6,陽信-石牌,2023-08-31,8711
2606,裕民,6,0,6,陽信-石牌,2023-08-31,8711
2633,台灣高鐵,6,0,6,陽信-石牌,2023-08-31,8711
2880,華南金,6,0,6,陽信-石牌,2023-08-31,8711
3045,台灣大,6,0,6,陽信-石牌,2023-08-31,8711
5880,合庫金,6,0,6,陽信-石牌,2023-08-31,8711
6282,康舒,6,0,6,陽信-石牌,2023-08-31,8711
6806,森崴能源,6,0,6,陽信-石牌,2023-08-31,8711
2353,宏��,5,0,5,陽信-石牌,2023-08-31,8711
2491,吉祥全,5,0,5,陽信-石牌,2023-08-31,8711
2886,兆豐金,5,0,5,陽信-石牌,2023-08-31,8711
00919,群益台灣精選高息,417,0,417,陽信-石牌,2023-09-01,8711
00673R,期元大S＆P原油反1,157,0,157,陽信-石牌,2023-09-01,8711
2610,華航,135,8,127,陽信-石牌,2023-09-01,8711
2363,矽統,204,87,117,陽信-石牌,2023-09-01,8711
00932,兆豐永續高息等權,61,0,61,陽信-石牌,2023-09-01,8711
3231,緯創,96,40,56,陽信-石牌,2023-09-01,8711
2891,中信金,50,0,50,陽信-石牌,2023-09-01,8711
3078,僑威,54,5,49,陽信-石牌,2023-09-01,8711
00900,富邦特選高股息30,52,5,47,陽信-石牌,2023-09-01,8711
6547,高端疫苗,55,19,36,陽信-石牌,2023-09-01,8711
2634,漢翔,37,9,28,陽信-石牌,2023-09-01,8711
3325,旭品,35,10,25,陽信-石牌,2023-09-01,8711
8183,精星,30,5,25,陽信-石牌,2023-09-01,8711
2603,長榮,26,2,24,陽信-石牌,2023-09-01,8711
5009,榮剛,23,0,23,陽信-石牌,2023-09-01,8711
2511,太子,22,0,22,陽信-石牌,2023-09-01,8711
2365,昆盈,20,0,20,陽信-石牌,2023-09-01,8711
6282,康舒,35,15,20,陽信-石牌,2023-09-01,8711
2359,所羅門,22,3,19,陽信-石牌,2023-09-01,8711
2609,陽明,17,0,17,陽信-石牌,2023-09-01,8711
2301,光寶科,25,9,16,陽信-石牌,2023-09-01,8711
3024,憶聲,15,0,15,陽信-石牌,2023-09-01,8711
2356,英業達,19,5,14,陽信-石牌,2023-09-01,8711
4909,新復興,16,2,14,陽信-石牌,2023-09-01,8711
7402,邑錡,16,2,14,陽信-石牌,2023-09-01,8711
3037,欣興,20,6,14,陽信-石牌,2023-09-01,8711
6770,力積電,15,3,12,陽信-石牌,2023-09-01,8711
1612,宏泰,14,3,11,陽信-石牌,2023-09-01,8711
2376,技嘉,32,21,11,陽信-石牌,2023-09-01,8711
00898,國泰基因免疫革命,10,0,10,陽信-石牌,2023-09-01,8711
1434,福懋,10,0,10,陽信-石牌,2023-09-01,8711
2323,中環,10,0,10,陽信-石牌,2023-09-01,8711
2337,旺宏,16,6,10,陽信-石牌,2023-09-01,8711
2704,國賓,10,0,10,陽信-石牌,2023-09-01,8711
2880,華南金,10,0,10,陽信-石牌,2023-09-01,8711
5284,jpp-KY,10,0,10,陽信-石牌,2023-09-01,8711
6173,信昌電,13,3,10,陽信-石牌,2023-09-01,8711
6245,立端,10,0,10,陽信-石牌,2023-09-01,8711
8996,高力,12,2,10,陽信-石牌,2023-09-01,8711
1513,中興電,15,6,9,陽信-石牌,2023-09-01,8711
1540,喬福,9,0,9,陽信-石牌,2023-09-01,8711
3081,聯亞,9,0,9,陽信-石牌,2023-09-01,8711
6515,穎崴,11,2,9,陽信-石牌,2023-09-01,8711
2618,長榮航,46,38,8,陽信-石牌,2023-09-01,8711
3583,辛耘,12,4,8,陽信-石牌,2023-09-01,8711
1616,億泰,7,0,7,陽信-石牌,2023-09-01,8711
2010,春源,7,0,7,陽信-石牌,2023-09-01,8711
2208,台船,7,0,7,陽信-石牌,2023-09-01,8711
2368,金像電,22,15,7,陽信-石牌,2023-09-01,8711
2419,仲琦,9,2,7,陽信-石牌,2023-09-01,8711
00919,群益台灣精選高息,175,20,155,陽信-石牌,2023-09-04,8711
2488,漢平,100,0,100,陽信-石牌,2023-09-04,8711
2884,玉山金,100,0,100,陽信-石牌,2023-09-04,8711
00929,復華台灣科技優息,79,8,71,陽信-石牌,2023-09-04,8711
2882,國泰金,40,0,40,陽信-石牌,2023-09-04,8711
1609,大亞,56,17,39,陽信-石牌,2023-09-04,8711
3005,神基,35,2,33,陽信-石牌,2023-09-04,8711
00687B,國泰20年美債,32,0,32,陽信-石牌,2023-09-04,8711
00680L,元大美債20正2,30,0,30,陽信-石牌,2023-09-04,8711
00931B,統一美債20年,29,0,29,陽信-石牌,2023-09-04,8711
4533,協易機,30,1,29,陽信-石牌,2023-09-04,8711
5009,榮剛,30,8,22,陽信-石牌,2023-09-04,8711
2457,飛宏,20,0,20,陽信-石牌,2023-09-04,8711
5381,合正,23,3,20,陽信-石牌,2023-09-04,8711
1727,中華化,20,0,20,陽信-石牌,2023-09-04,8711
2548,華固,20,0,20,陽信-石牌,2023-09-04,8711
5210,寶碩,20,0,20,陽信-石牌,2023-09-04,8711
6116,彩晶,20,0,20,陽信-石牌,2023-09-04,8711
3481,群創,19,0,19,陽信-石牌,2023-09-04,8711
2409,友達,44,25,19,陽信-石牌,2023-09-04,8711
2331,精英,16,1,15,陽信-石牌,2023-09-04,8711
5284,jpp-KY,15,1,14,陽信-石牌,2023-09-04,8711
7402,邑錡,14,0,14,陽信-石牌,2023-09-04,8711
6125,廣運,13,0,13,陽信-石牌,2023-09-04,8711
6143,振曜,16,4,12,陽信-石牌,2023-09-04,8711
8068,全達,19,7,12,陽信-石牌,2023-09-04,8711
8110,華東,14,2,12,陽信-石牌,2023-09-04,8711
9907,統一實,12,0,12,陽信-石牌,2023-09-04,8711
00679B,元大美債20年,16,5,11,陽信-石牌,2023-09-04,8711
2618,長榮航,37,26,11,陽信-石牌,2023-09-04,8711
2634,漢翔,16,5,11,陽信-石牌,2023-09-04,8711
6155,鈞寶,12,1,11,陽信-石牌,2023-09-04,8711
1217,愛之味,10,0,10,陽信-石牌,2023-09-04,8711
1591,駿吉-KY,10,0,10,陽信-石牌,2023-09-04,8711
2388,威盛,12,2,10,陽信-石牌,2023-09-04,8711
5222,全訊,10,0,10,陽信-石牌,2023-09-04,8711
2317,鴻海,11,2,9,陽信-石牌,2023-09-04,8711
2405,輔信,8,0,8,陽信-石牌,2023-09-04,8711
3078,僑威,8,0,8,陽信-石牌,2023-09-04,8711
5340,建榮,8,0,8,陽信-石牌,2023-09-04,8711
6111,大宇資,11,3,8,陽信-石牌,2023-09-04,8711
1795,美時,7,0,7,陽信-石牌,2023-09-04,8711
2329,華泰,21,14,7,陽信-石牌,2023-09-04,8711
6213,聯茂,14,7,7,陽信-石牌,2023-09-04,8711
00915,凱基優選高股息30,6,0,6,陽信-石牌,2023-09-04,8711
1313,聯成,6,0,6,陽信-石牌,2023-09-04,8711
1802,台玻,60,54,6,陽信-石牌,2023-09-04,8711
2323,中環,7,1,6,陽信-石牌,2023-09-04,8711
3484,崧騰,7,1,6,陽信-石牌,2023-09-04,8711
4908,前鼎,6,0,6,陽信-石牌,2023-09-04,8711
1471,首利,264,3,261,陽信-石牌,2023-09-05,8711
00919,群益台灣精選高息,130,9,121,陽信-石牌,2023-09-05,8711
00929,復華台灣科技優息,169,48,121,陽信-石牌,2023-09-05,8711
2344,華邦電,57,17,40,陽信-石牌,2023-09-05,8711
3508,位速,36,10,26,陽信-石牌,2023-09-05,8711
2312,金寶,29,4,25,陽信-石牌,2023-09-05,8711
7402,邑錡,54,29,25,陽信-石牌,2023-09-05,8711
3583,辛耘,24,2,22,陽信-石牌,2023-09-05,8711
00679B,元大美債20年,21,0,21,陽信-石牌,2023-09-05,8711
3645,達邁,33,12,21,陽信-石牌,2023-09-05,8711
2380,虹光,20,0,20,陽信-石牌,2023-09-05,8711
6548,長科*,20,0,20,陽信-石牌,2023-09-05,8711
2476,鉅祥,19,0,19,陽信-石牌,2023-09-05,8711
2634,漢翔,36,19,17,陽信-石牌,2023-09-05,8711
2353,宏��,34,18,16,陽信-石牌,2023-09-05,8711
3311,閎暉,14,0,14,陽信-石牌,2023-09-05,8711
2369,菱生,18,5,13,陽信-石牌,2023-09-05,8711
6118,建達,13,0,13,陽信-石牌,2023-09-05,8711
2330,台積電,20,7,13,陽信-石牌,2023-09-05,8711
1513,中興電,11,0,11,陽信-石牌,2023-09-05,8711
1203,味王,12,1,11,陽信-石牌,2023-09-05,8711
2371,大同,26,16,10,陽信-石牌,2023-09-05,8711
00850,元大臺灣ESG永續,10,0,10,陽信-石牌,2023-09-05,8711
1783,和康生,10,0,10,陽信-石牌,2023-09-05,8711
2421,建準,10,0,10,陽信-石牌,2023-09-05,8711
2498,宏達電,10,0,10,陽信-石牌,2023-09-05,8711
2748,雲品,10,0,10,陽信-石牌,2023-09-05,8711
4541,晟田,10,0,10,陽信-石牌,2023-09-05,8711
5351,鈺創,37,27,10,陽信-石牌,2023-09-05,8711
6015,宏遠證,10,0,10,陽信-石牌,2023-09-05,8711
8183,精星,10,0,10,陽信-石牌,2023-09-05,8711
3051,力特,19,10,9,陽信-石牌,2023-09-05,8711
2485,兆赫,9,0,9,陽信-石牌,2023-09-05,8711
4908,前鼎,9,0,9,陽信-石牌,2023-09-05,8711
6125,廣運,19,10,9,陽信-石牌,2023-09-05,8711
2206,三陽工業,17,8,9,陽信-石牌,2023-09-05,8711
8358,金居,30,22,8,陽信-石牌,2023-09-05,8711
2618,長榮航,29,21,8,陽信-石牌,2023-09-05,8711
2402,毅嘉,19,11,8,陽信-石牌,2023-09-05,8711
2497,怡利電,10,2,8,陽信-石牌,2023-09-05,8711
4729,熒茂,8,0,8,陽信-石牌,2023-09-05,8711
8431,匯鑽科,8,0,8,陽信-石牌,2023-09-05,8711
0056,元大高股息,11,4,7,陽信-石牌,2023-09-05,8711
2610,華航,35,28,7,陽信-石牌,2023-09-05,8711
00751B,元大AAA至A公司債,7,0,7,陽信-石牌,2023-09-05,8711
2337,旺宏,7,0,7,陽信-石牌,2023-09-05,8711
3231,緯創,19,12,7,陽信-石牌,2023-09-05,8711
3325,旭品,18,11,7,陽信-石牌,2023-09-05,8711
6194,育富,7,0,7,陽信-石牌,2023-09-05,8711
3481,群創,29,23,6,陽信-石牌,2023-09-05,8711
00713,元大台灣高息低波,110,0,110,陽信-石牌,2023-09-06,8711
3481,群創,93,3,90,陽信-石牌,2023-09-06,8711
2883,凱基金,84,0,84,陽信-石牌,2023-09-06,8711
2409,友達,100,39,61,陽信-石牌,2023-09-06,8711
00680L,元大美債20正2,55,0,55,陽信-石牌,2023-09-06,8711
2538,基泰,50,0,50,陽信-石牌,2023-09-06,8711
7402,邑錡,45,2,43,陽信-石牌,2023-09-06,8711
1313,聯成,35,0,35,陽信-石牌,2023-09-06,8711
00915,凱基優選高股息30,33,0,33,陽信-石牌,2023-09-06,8711
3311,閎暉,41,10,31,陽信-石牌,2023-09-06,8711
1101,台泥,23,0,23,陽信-石牌,2023-09-06,8711
2323,中環,23,0,23,陽信-石牌,2023-09-06,8711
9103,美德醫療-DR,20,0,20,陽信-石牌,2023-09-06,8711
2363,矽統,67,48,19,陽信-石牌,2023-09-06,8711
2891,中信金,19,0,19,陽信-石牌,2023-09-06,8711
4916,事欣科,18,0,18,陽信-石牌,2023-09-06,8711
2027,大成鋼,17,0,17,陽信-石牌,2023-09-06,8711
2354,鴻準,18,1,17,陽信-石牌,2023-09-06,8711
2890,永豐金,17,0,17,陽信-石牌,2023-09-06,8711
6706,惠特,17,0,17,陽信-石牌,2023-09-06,8711
2376,技嘉,38,22,16,陽信-石牌,2023-09-06,8711
6016,康和證,15,0,15,陽信-石牌,2023-09-06,8711
2206,三陽工業,16,3,13,陽信-石牌,2023-09-06,8711
2303,聯電,28,15,13,陽信-石牌,2023-09-06,8711
00900,富邦特選高股息30,12,0,12,陽信-石牌,2023-09-06,8711
1789,神隆,12,0,12,陽信-石牌,2023-09-06,8711
1513,中興電,11,0,11,陽信-石牌,2023-09-06,8711
2331,精英,19,8,11,陽信-石牌,2023-09-06,8711
8068,全達,26,15,11,陽信-石牌,2023-09-06,8711
00898,國泰基因免疫革命,10,0,10,陽信-石牌,2023-09-06,8711
1810,和成,10,0,10,陽信-石牌,2023-09-06,8711
2498,宏達電,10,0,10,陽信-石牌,2023-09-06,8711
2515,中工,10,0,10,陽信-石牌,2023-09-06,8711
2601,益航,10,0,10,陽信-石牌,2023-09-06,8711
2913,農林,10,0,10,陽信-石牌,2023-09-06,8711
3508,位速,10,0,10,陽信-石牌,2023-09-06,8711
3710,連展投控,10,0,10,陽信-石牌,2023-09-06,8711
3715,定穎投控,39,29,10,陽信-石牌,2023-09-06,8711
4157,太景*-KY,10,0,10,陽信-石牌,2023-09-06,8711
5210,寶碩,10,0,10,陽信-石牌,2023-09-06,8711
8076,伍豐,10,0,10,陽信-石牌,2023-09-06,8711
00923,群益台ESG低碳50,9,0,9,陽信-石牌,2023-09-06,8711
00679B,元大美債20年,8,0,8,陽信-石牌,2023-09-06,8711
1802,台玻,19,11,8,陽信-石牌,2023-09-06,8711
2317,鴻海,10,2,8,陽信-石牌,2023-09-06,8711
2881,富邦金,8,0,8,陽信-石牌,2023-09-06,8711
3325,旭品,19,11,8,陽信-石牌,2023-09-06,8711
00932,兆豐永續高息等權,7,0,7,陽信-石牌,2023-09-06,8711
2330,台積電,11,4,7,陽信-石牌,2023-09-06,8711
1468,昶和,7,0,7,陽信-石牌,2023-09-06,8711
00929,復華台灣科技優息,206,21,185,陽信-石牌,2023-09-07,8711
3481,群創,117,0,117,陽信-石牌,2023-09-07,8711
00919,群益台灣精選高息,73,18,55,陽信-石牌,2023-09-07,8711
00931B,統一美債20年,40,0,40,陽信-石牌,2023-09-07,8711
5272,笙科,40,0,40,陽信-石牌,2023-09-07,8711
00900,富邦特選高股息30,51,20,31,陽信-石牌,2023-09-07,8711
2337,旺宏,42,12,30,陽信-石牌,2023-09-07,8711
2498,宏達電,31,1,30,陽信-石牌,2023-09-07,8711
3624,光頡,29,2,27,陽信-石牌,2023-09-07,8711
2610,華航,31,8,23,陽信-石牌,2023-09-07,8711
2637,慧洋-KY,22,0,22,陽信-石牌,2023-09-07,8711
3078,僑威,24,2,22,陽信-石牌,2023-09-07,8711
6116,彩晶,22,0,22,陽信-石牌,2023-09-07,8711
00753L,中信中國50正2,20,0,20,陽信-石牌,2023-09-07,8711
2369,菱生,19,0,19,陽信-石牌,2023-09-07,8711
2332,友訊,30,12,18,陽信-石牌,2023-09-07,8711
2330,台積電,22,4,18,陽信-石牌,2023-09-07,8711
8028,昇陽半導體,18,0,18,陽信-石牌,2023-09-07,8711
2887,台新金,18,0,18,陽信-石牌,2023-09-07,8711
1305,華夏,30,15,15,陽信-石牌,2023-09-07,8711
1313,聯成,15,0,15,陽信-石牌,2023-09-07,8711
2313,華通,37,22,15,陽信-石牌,2023-09-07,8711
4977,眾達-KY,20,5,15,陽信-石牌,2023-09-07,8711
5381,合正,20,5,15,陽信-石牌,2023-09-07,8711
3051,力特,15,1,14,陽信-石牌,2023-09-07,8711
00795B,中信美國公債20年,13,0,13,陽信-石牌,2023-09-07,8711
2027,大成鋼,23,10,13,陽信-石牌,2023-09-07,8711
2409,友達,52,40,12,陽信-石牌,2023-09-07,8711
2497,怡利電,16,4,12,陽信-石牌,2023-09-07,8711
2707,晶華,12,0,12,陽信-石牌,2023-09-07,8711
4906,正文,15,3,12,陽信-石牌,2023-09-07,8711
2485,兆赫,98,87,11,陽信-石牌,2023-09-07,8711
2504,國產,11,0,11,陽信-石牌,2023-09-07,8711
00932,兆豐永續高息等權,10,0,10,陽信-石牌,2023-09-07,8711
00687B,國泰20年美債,10,0,10,陽信-石牌,2023-09-07,8711
1529,樂事綠能,10,0,10,陽信-石牌,2023-09-07,8711
2880,華南金,10,0,10,陽信-石牌,2023-09-07,8711
3013,晟銘電,12,2,10,陽信-石牌,2023-09-07,8711
6015,宏遠證,10,0,10,陽信-石牌,2023-09-07,8711
6548,長科*,13,3,10,陽信-石牌,2023-09-07,8711
3363,上詮,12,3,9,陽信-石牌,2023-09-07,8711
4541,晟田,9,0,9,陽信-石牌,2023-09-07,8711
1810,和成,12,4,8,陽信-石牌,2023-09-07,8711
3588,通嘉,8,0,8,陽信-石牌,2023-09-07,8711
4916,事欣科,11,3,8,陽信-石牌,2023-09-07,8711
1618,合機,7,0,7,陽信-石牌,2023-09-07,8711
2359,所羅門,7,0,7,陽信-石牌,2023-09-07,8711
4967,十銓,10,3,7,陽信-石牌,2023-09-07,8711
6515,穎崴,9,2,7,陽信-石牌,2023-09-07,8711
2382,廣達,16,10,6,陽信-石牌,2023-09-07,8711
2409,友達,142,25,117,陽信-石牌,2023-09-08,8711
00929,復華台灣科技優息,127,16,111,陽信-石牌,2023-09-08,8711
1304,台聚,95,5,90,陽信-石牌,2023-09-08,8711
00919,群益台灣精選高息,105,20,85,陽信-石牌,2023-09-08,8711
1471,首利,76,2,74,陽信-石牌,2023-09-08,8711
2330,台積電,63,3,60,陽信-石牌,2023-09-08,8711
00878,國泰永續高股息,40,6,34,陽信-石牌,2023-09-08,8711
5608,四維航,50,17,33,陽信-石牌,2023-09-08,8711
00713,元大台灣高息低波,35,4,31,陽信-石牌,2023-09-08,8711
2457,飛宏,30,0,30,陽信-石牌,2023-09-08,8711
2882,國泰金,32,2,30,陽信-石牌,2023-09-08,8711
4532,瑞智,30,1,29,陽信-石牌,2023-09-08,8711
2382,廣達,37,9,28,陽信-石牌,2023-09-08,8711
2316,楠梓電,29,7,22,陽信-石牌,2023-09-08,8711
2498,宏達電,22,0,22,陽信-石牌,2023-09-08,8711
2363,矽統,62,41,21,陽信-石牌,2023-09-08,8711
2618,長榮航,38,17,21,陽信-石牌,2023-09-08,8711
00931B,統一美債20年,20,0,20,陽信-石牌,2023-09-08,8711
00753L,中信中國50正2,20,0,20,陽信-石牌,2023-09-08,8711
00795B,中信美國公債20年,20,0,20,陽信-石牌,2023-09-08,8711
2358,廷鑫,25,5,20,陽信-石牌,2023-09-08,8711
3483,力致,45,25,20,陽信-石牌,2023-09-08,8711
4707,磐亞,20,0,20,陽信-石牌,2023-09-08,8711
00687B,國泰20年美債,20,1,19,陽信-石牌,2023-09-08,8711
2637,慧洋-KY,19,1,18,陽信-石牌,2023-09-08,8711
2313,華通,22,6,16,陽信-石牌,2023-09-08,8711
3078,僑威,15,0,15,陽信-石牌,2023-09-08,8711
6016,康和證,15,0,15,陽信-石牌,2023-09-08,8711
2329,華泰,41,27,14,陽信-石牌,2023-09-08,8711
3006,晶豪科,18,4,14,陽信-石牌,2023-09-08,8711
1609,大亞,16,3,13,陽信-石牌,2023-09-08,8711
6418,詠昇,15,3,12,陽信-石牌,2023-09-08,8711
00773B,中信優先金融債,10,0,10,陽信-石牌,2023-09-08,8711
2356,英業達,15,5,10,陽信-石牌,2023-09-08,8711
3094,聯傑,10,0,10,陽信-石牌,2023-09-08,8711
3710,連展投控,10,0,10,陽信-石牌,2023-09-08,8711
4927,泰鼎-KY,10,0,10,陽信-石牌,2023-09-08,8711
5488,松普,10,0,10,陽信-石牌,2023-09-08,8711
6116,彩晶,10,0,10,陽信-石牌,2023-09-08,8711
8390,金益鼎,10,0,10,陽信-石牌,2023-09-08,8711
00932,兆豐永續高息等權,9,0,9,陽信-石牌,2023-09-08,8711
0050,元大台灣50,9,0,9,陽信-石牌,2023-09-08,8711
5439,高技,20,11,9,陽信-石牌,2023-09-08,8711
2603,長榮,11,3,8,陽信-石牌,2023-09-08,8711
1442,名軒,8,0,8,陽信-石牌,2023-09-08,8711
2402,毅嘉,40,32,8,陽信-石牌,2023-09-08,8711
2444,兆勁,8,0,8,陽信-石牌,2023-09-08,8711
2614,東森,9,1,8,陽信-石牌,2023-09-08,8711
3576,聯合再生,8,0,8,陽信-石牌,2023-09-08,8711
5381,合正,9,1,8,陽信-石牌,2023-09-08,8711
00918,大華優利高填息30,919,2,917,陽信-石牌,2023-09-11,8711
00919,群益台灣精選高息,238,45,193,陽信-石牌,2023-09-11,8711
00878,國泰永續高股息,119,12,107,陽信-石牌,2023-09-11,8711
1605,華新,61,8,53,陽信-石牌,2023-09-11,8711
9105,泰金寶-DR,50,0,50,陽信-石牌,2023-09-11,8711
4128,中天,45,0,45,陽信-石牌,2023-09-11,8711
00929,復華台灣科技優息,50,8,42,陽信-石牌,2023-09-11,8711
2618,長榮航,60,24,36,陽信-石牌,2023-09-11,8711
6672,騰輝電子-KY,39,4,35,陽信-石牌,2023-09-11,8711
3231,緯創,82,47,35,陽信-石牌,2023-09-11,8711
00931B,統一美債20年,34,0,34,陽信-石牌,2023-09-11,8711
2312,金寶,38,4,34,陽信-石牌,2023-09-11,8711
2363,矽統,131,97,34,陽信-石牌,2023-09-11,8711
00900,富邦特選高股息30,24,0,24,陽信-石牌,2023-09-11,8711
3043,科風,24,0,24,陽信-石牌,2023-09-11,8711
2352,佳世達,30,8,22,陽信-石牌,2023-09-11,8711
3356,奇偶,21,0,21,陽信-石牌,2023-09-11,8711
3078,僑威,30,10,20,陽信-石牌,2023-09-11,8711
6015,宏遠證,20,0,20,陽信-石牌,2023-09-11,8711
6016,康和證,20,0,20,陽信-石牌,2023-09-11,8711
2359,所羅門,30,11,19,陽信-石牌,2023-09-11,8711
2883,凱基金,20,1,19,陽信-石牌,2023-09-11,8711
6285,啟��,22,3,19,陽信-石牌,2023-09-11,8711
5608,四維航,18,0,18,陽信-石牌,2023-09-11,8711
3005,神基,24,7,17,陽信-石牌,2023-09-11,8711
00679B,元大美債20年,16,0,16,陽信-石牌,2023-09-11,8711
3521,鴻翊,16,0,16,陽信-石牌,2023-09-11,8711
00751B,元大AAA至A公司債,15,0,15,陽信-石牌,2023-09-11,8711
2457,飛宏,15,1,14,陽信-石牌,2023-09-11,8711
2603,長榮,18,4,14,陽信-石牌,2023-09-11,8711
2330,台積電,21,8,13,陽信-石牌,2023-09-11,8711
2498,宏達電,13,0,13,陽信-石牌,2023-09-11,8711
2705,六福,13,0,13,陽信-石牌,2023-09-11,8711
8112,至上,13,0,13,陽信-石牌,2023-09-11,8711
1905,華紙,12,0,12,陽信-石牌,2023-09-11,8711
2332,友訊,13,1,12,陽信-石牌,2023-09-11,8711
5340,建榮,12,0,12,陽信-石牌,2023-09-11,8711
8210,勤誠,12,0,12,陽信-石牌,2023-09-11,8711
4938,和碩,11,0,11,陽信-石牌,2023-09-11,8711
1515,力山,11,0,11,陽信-石牌,2023-09-11,8711
00720B,元大投資級公司債,11,0,11,陽信-石牌,2023-09-11,8711
2436,偉詮電,16,5,11,陽信-石牌,2023-09-11,8711
6125,廣運,11,0,11,陽信-石牌,2023-09-11,8711
00687B,國泰20年美債,10,0,10,陽信-石牌,2023-09-11,8711
00795B,中信美國公債20年,10,0,10,陽信-石牌,2023-09-11,8711
5531,鄉林,10,0,10,陽信-石牌,2023-09-11,8711
6213,聯茂,11,1,10,陽信-石牌,2023-09-11,8711
6743,安普新,10,0,10,陽信-石牌,2023-09-11,8711
2356,英業達,11,3,8,陽信-石牌,2023-09-11,8711
2376,技嘉,27,19,8,陽信-石牌,2023-09-11,8711
00915,凱基優選高股息30,120,0,120,陽信-石牌,2023-09-12,8711
1471,首利,109,4,105,陽信-石牌,2023-09-12,8711
6120,達運,50,0,50,陽信-石牌,2023-09-12,8711
2402,毅嘉,41,3,38,陽信-石牌,2023-09-12,8711
00857B,永豐20年美公債,30,0,30,陽信-石牌,2023-09-12,8711
00885,富邦越南,30,0,30,陽信-石牌,2023-09-12,8711
00919,群益台灣精選高息,29,0,29,陽信-石牌,2023-09-12,8711
2883,凱基金,26,0,26,陽信-石牌,2023-09-12,8711
6282,康舒,34,13,21,陽信-石牌,2023-09-12,8711
00878,國泰永續高股息,32,11,21,陽信-石牌,2023-09-12,8711
1319,東陽,33,13,20,陽信-石牌,2023-09-12,8711
5439,高技,20,0,20,陽信-石牌,2023-09-12,8711
2355,敬鵬,20,2,18,陽信-石牌,2023-09-12,8711
3078,僑威,23,5,18,陽信-石牌,2023-09-12,8711
6605,帝寶,23,5,18,陽信-石牌,2023-09-12,8711
5381,合正,26,10,16,陽信-石牌,2023-09-12,8711
1305,華夏,15,0,15,陽信-石牌,2023-09-12,8711
00687B,國泰20年美債,15,0,15,陽信-石牌,2023-09-12,8711
2340,台亞,14,1,13,陽信-石牌,2023-09-12,8711
2458,義隆,15,2,13,陽信-石牌,2023-09-12,8711
4503,金雨,13,0,13,陽信-石牌,2023-09-12,8711
4306,炎洲,12,0,12,陽信-石牌,2023-09-12,8711
3035,智原,14,3,11,陽信-石牌,2023-09-12,8711
8222,寶一,13,2,11,陽信-石牌,2023-09-12,8711
00713,元大台灣高息低波,10,0,10,陽信-石牌,2023-09-12,8711
2888,新光金,10,0,10,陽信-石牌,2023-09-12,8711
2891,中信金,10,0,10,陽信-石牌,2023-09-12,8711
3128,昇銳,10,0,10,陽信-石牌,2023-09-12,8711
5309,系統電,10,0,10,陽信-石牌,2023-09-12,8711
8147,正淩,10,0,10,陽信-石牌,2023-09-12,8711
1529,樂事綠能,14,5,9,陽信-石牌,2023-09-12,8711
6245,立端,9,0,9,陽信-石牌,2023-09-12,8711
1584,精剛,12,4,8,陽信-石牌,2023-09-12,8711
2356,英業達,10,2,8,陽信-石牌,2023-09-12,8711
2606,裕民,8,0,8,陽信-石牌,2023-09-12,8711
3032,偉訓,12,4,8,陽信-石牌,2023-09-12,8711
3178,公準,8,0,8,陽信-石牌,2023-09-12,8711
8112,至上,29,21,8,陽信-石牌,2023-09-12,8711
00720B,元大投資級公司債,7,0,7,陽信-石牌,2023-09-12,8711
2331,精英,52,45,7,陽信-石牌,2023-09-12,8711
3090,日電貿,7,0,7,陽信-石牌,2023-09-12,8711
3380,明泰,7,0,7,陽信-石牌,2023-09-12,8711
3521,鴻翊,7,0,7,陽信-石牌,2023-09-12,8711
3624,光頡,19,12,7,陽信-石牌,2023-09-12,8711
3715,定穎投控,13,6,7,陽信-石牌,2023-09-12,8711
9933,中鼎,10,3,7,陽信-石牌,2023-09-12,8711
8046,南電,12,5,7,陽信-石牌,2023-09-12,8711
00918,大華優利高填息30,6,0,6,陽信-石牌,2023-09-12,8711
00923,群益台ESG低碳50,10,4,6,陽信-石牌,2023-09-12,8711
00898,國泰基因免疫革命,6,0,6,陽信-石牌,2023-09-12,8711
00929,復華台灣科技優息,134,27,107,陽信-石牌,2023-09-13,8711
2890,永豐金,100,11,89,陽信-石牌,2023-09-13,8711
3081,聯亞,81,2,79,陽信-石牌,2023-09-13,8711
5348,正能量智能,49,0,49,陽信-石牌,2023-09-13,8711
2340,台亞,47,16,31,陽信-石牌,2023-09-13,8711
00857B,永豐20年美公債,30,0,30,陽信-石牌,2023-09-13,8711
2497,怡利電,80,58,22,陽信-石牌,2023-09-13,8711
2402,毅嘉,22,1,21,陽信-石牌,2023-09-13,8711
00687B,國泰20年美債,20,0,20,陽信-石牌,2023-09-13,8711
2352,佳世達,36,16,20,陽信-石牌,2023-09-13,8711
6605,帝寶,28,10,18,陽信-石牌,2023-09-13,8711
00918,大華優利高填息30,17,0,17,陽信-石牌,2023-09-13,8711
6706,惠特,16,0,16,陽信-石牌,2023-09-13,8711
2323,中環,23,8,15,陽信-石牌,2023-09-13,8711
2356,英業達,17,2,15,陽信-石牌,2023-09-13,8711
2880,華南金,15,0,15,陽信-石牌,2023-09-13,8711
3037,欣興,19,4,15,陽信-石牌,2023-09-13,8711
3122,笙泉,15,0,15,陽信-石牌,2023-09-13,8711
6243,迅杰,14,0,14,陽信-石牌,2023-09-13,8711
3051,力特,12,0,12,陽信-石牌,2023-09-13,8711
6288,聯嘉,26,14,12,陽信-石牌,2023-09-13,8711
6531,愛普*,12,1,11,陽信-石牌,2023-09-13,8711
8112,至上,18,7,11,陽信-石牌,2023-09-13,8711
00795B,中信美國公債20年,10,0,10,陽信-石牌,2023-09-13,8711
00773B,中信優先金融債,10,0,10,陽信-石牌,2023-09-13,8711
1737,臺鹽,10,0,10,陽信-石牌,2023-09-13,8711
2312,金寶,10,0,10,陽信-石牌,2023-09-13,8711
2504,國產,10,0,10,陽信-石牌,2023-09-13,8711
3711,日月光投控,11,1,10,陽信-石牌,2023-09-13,8711
4533,協易機,10,0,10,陽信-石牌,2023-09-13,8711
8105,凌巨,10,0,10,陽信-石牌,2023-09-13,8711
1584,精剛,10,1,9,陽信-石牌,2023-09-13,8711
1524,耿鼎,23,15,8,陽信-石牌,2023-09-13,8711
2419,仲琦,8,0,8,陽信-石牌,2023-09-13,8711
2458,義隆,8,0,8,陽信-石牌,2023-09-13,8711
6546,正基,8,0,8,陽信-石牌,2023-09-13,8711
00673R,期元大S＆P原油反1,7,0,7,陽信-石牌,2023-09-13,8711
1618,合機,7,0,7,陽信-石牌,2023-09-13,8711
3406,玉晶光,13,6,7,陽信-石牌,2023-09-13,8711
2609,陽明,6,0,6,陽信-石牌,2023-09-13,8711
3042,晶技,8,2,6,陽信-石牌,2023-09-13,8711
6125,廣運,6,0,6,陽信-石牌,2023-09-13,8711
6282,康舒,9,3,6,陽信-石牌,2023-09-13,8711
00898,國泰基因免疫革命,5,0,5,陽信-石牌,2023-09-13,8711
00751B,元大AAA至A公司債,5,0,5,陽信-石牌,2023-09-13,8711
00701,國泰股利精選30,5,0,5,陽信-石牌,2023-09-13,8711
1536,和大,5,0,5,陽信-石牌,2023-09-13,8711
1809,中釉,5,0,5,陽信-石牌,2023-09-13,8711
3059,華晶科,5,0,5,陽信-石牌,2023-09-13,8711
3705,永信,5,0,5,陽信-石牌,2023-09-13,8711
00632R,元大台灣50反1,210,0,210,陽信-石牌,2023-09-14,8711
1605,華新,102,3,99,陽信-石牌,2023-09-14,8711
6288,聯嘉,82,0,82,陽信-石牌,2023-09-14,8711
2497,怡利電,80,3,77,陽信-石牌,2023-09-14,8711
00929,復華台灣科技優息,83,16,67,陽信-石牌,2023-09-14,8711
00885,富邦越南,66,0,66,陽信-石牌,2023-09-14,8711
00882,中信中國高股息,56,0,56,陽信-石牌,2023-09-14,8711
2303,聯電,51,2,49,陽信-石牌,2023-09-14,8711
2883,凱基金,40,0,40,陽信-石牌,2023-09-14,8711
1203,味王,30,0,30,陽信-石牌,2023-09-14,8711
00918,大華優利高填息30,30,0,30,陽信-石牌,2023-09-14,8711
1524,耿鼎,38,15,23,陽信-石牌,2023-09-14,8711
1313,聯成,22,2,20,陽信-石牌,2023-09-14,8711
00724B,群益投資級金融債,20,0,20,陽信-石牌,2023-09-14,8711
1789,神隆,20,0,20,陽信-石牌,2023-09-14,8711
1802,台玻,20,0,20,陽信-石牌,2023-09-14,8711
8255,朋程,17,0,17,陽信-石牌,2023-09-14,8711
2913,農林,18,2,16,陽信-石牌,2023-09-14,8711
3432,台端,15,0,15,陽信-石牌,2023-09-14,8711
3709,鑫聯大投控,15,0,15,陽信-石牌,2023-09-14,8711
5210,寶碩,15,0,15,陽信-石牌,2023-09-14,8711
00679B,元大美債20年,13,0,13,陽信-石牌,2023-09-14,8711
2605,新興,57,44,13,陽信-石牌,2023-09-14,8711
1319,東陽,39,28,11,陽信-石牌,2023-09-14,8711
1582,信錦,11,0,11,陽信-石牌,2023-09-14,8711
2882,國泰金,10,0,10,陽信-石牌,2023-09-14,8711
3686,達能,10,0,10,陽信-石牌,2023-09-14,8711
4167,松瑞藥,10,0,10,陽信-石牌,2023-09-14,8711
4906,正文,23,13,10,陽信-石牌,2023-09-14,8711
2409,友達,10,1,9,陽信-石牌,2023-09-14,8711
1568,倉佑,11,2,9,陽信-石牌,2023-09-14,8711
1905,華紙,10,1,9,陽信-石牌,2023-09-14,8711
3078,僑威,10,1,9,陽信-石牌,2023-09-14,8711
3234,光環,9,0,9,陽信-石牌,2023-09-14,8711
6126,信音,10,1,9,陽信-石牌,2023-09-14,8711
0056,元大高股息,11,4,7,陽信-石牌,2023-09-14,8711
00930,永豐ESG低碳高息,7,0,7,陽信-石牌,2023-09-14,8711
3521,鴻翊,7,0,7,陽信-石牌,2023-09-14,8711
4979,華星光,30,23,7,陽信-石牌,2023-09-14,8711
8046,南電,7,0,7,陽信-石牌,2023-09-14,8711
8112,至上,26,19,7,陽信-石牌,2023-09-14,8711
2301,光寶科,9,3,6,陽信-石牌,2023-09-14,8711
2312,金寶,6,0,6,陽信-石牌,2023-09-14,8711
2382,廣達,30,24,6,陽信-石牌,2023-09-14,8711
2504,國產,7,1,6,陽信-石牌,2023-09-14,8711
2610,華航,19,13,6,陽信-石牌,2023-09-14,8711
3704,合勤控,20,14,6,陽信-石牌,2023-09-14,8711
3715,定穎投控,34,28,6,陽信-石牌,2023-09-14,8711
4123,晟德,6,0,6,陽信-石牌,2023-09-14,8711
8034,榮群,24,18,6,陽信-石牌,2023-09-14,8711
00929,復華台灣科技優息,316,58,258,陽信-石牌,2023-09-15,8711
1313,聯成,130,0,130,陽信-石牌,2023-09-15,8711
00919,群益台灣精選高息,136,17,119,陽信-石牌,2023-09-15,8711
6451,訊芯-KY,111,4,107,陽信-石牌,2023-09-15,8711
2834,臺企銀,100,0,100,陽信-石牌,2023-09-15,8711
3706,神達,82,3,79,陽信-石牌,2023-09-15,8711
2486,一詮,67,15,52,陽信-石牌,2023-09-15,8711
9105,泰金寶-DR,50,0,50,陽信-石牌,2023-09-15,8711
2892,第一金,50,2,48,陽信-石牌,2023-09-15,8711
8255,朋程,45,0,45,陽信-石牌,2023-09-15,8711
3325,旭品,50,8,42,陽信-石牌,2023-09-15,8711
00931B,統一美債20年,37,0,37,陽信-石牌,2023-09-15,8711
00921,兆豐龍頭等權重,37,0,37,陽信-石牌,2023-09-15,8711
00673R,期元大S＆P原油反1,34,0,34,陽信-石牌,2023-09-15,8711
00885,富邦越南,31,0,31,陽信-石牌,2023-09-15,8711
00632R,元大台灣50反1,30,0,30,陽信-石牌,2023-09-15,8711
5371,中光電,30,0,30,陽信-石牌,2023-09-15,8711
6672,騰輝電子-KY,39,10,29,陽信-石牌,2023-09-15,8711
00679B,元大美債20年,23,0,23,陽信-石牌,2023-09-15,8711
2610,華航,29,7,22,陽信-石牌,2023-09-15,8711
2340,台亞,29,8,21,陽信-石牌,2023-09-15,8711
4147,中裕,21,0,21,陽信-石牌,2023-09-15,8711
4123,晟德,20,0,20,陽信-石牌,2023-09-15,8711
2511,太子,18,0,18,陽信-石牌,2023-09-15,8711
2634,漢翔,26,8,18,陽信-石牌,2023-09-15,8711
3231,緯創,22,4,18,陽信-石牌,2023-09-15,8711
6282,康舒,16,2,14,陽信-石牌,2023-09-15,8711
2425,承啟,12,0,12,陽信-石牌,2023-09-15,8711
3715,定穎投控,30,18,12,陽信-石牌,2023-09-15,8711
4977,眾達-KY,12,0,12,陽信-石牌,2023-09-15,8711
6120,達運,12,0,12,陽信-石牌,2023-09-15,8711
8046,南電,19,7,12,陽信-石牌,2023-09-15,8711
8227,巨有科技,12,0,12,陽信-石牌,2023-09-15,8711
00713,元大台灣高息低波,11,0,11,陽信-石牌,2023-09-15,8711
2637,慧洋-KY,32,21,11,陽信-石牌,2023-09-15,8711
00857B,永豐20年美公債,10,0,10,陽信-石牌,2023-09-15,8711
00896,中信綠能及電動車,10,0,10,陽信-石牌,2023-09-15,8711
2618,長榮航,25,15,10,陽信-石牌,2023-09-15,8711
3011,今皓,10,0,10,陽信-石牌,2023-09-15,8711
5210,寶碩,10,0,10,陽信-石牌,2023-09-15,8711
3324,雙鴻,10,0,10,陽信-石牌,2023-09-15,8711
2458,義隆,12,3,9,陽信-石牌,2023-09-15,8711
3163,波若威,24,15,9,陽信-石牌,2023-09-15,8711
3521,鴻翊,9,0,9,陽信-石牌,2023-09-15,8711
2371,大同,9,1,8,陽信-石牌,2023-09-15,8711
6419,京晨科,8,0,8,陽信-石牌,2023-09-15,8711
6442,光聖,8,0,8,陽信-石牌,2023-09-15,8711
8054,安國,11,3,8,陽信-石牌,2023-09-15,8711
8097,常珵,8,0,8,陽信-石牌,2023-09-15,8711
2884,玉山金,9,2,7,陽信-石牌,2023-09-15,8711
00919,群益台灣精選高息,305,6,299,陽信-石牌,2023-09-18,8711
00929,復華台灣科技優息,204,95,109,陽信-石牌,2023-09-18,8711
2331,精英,111,10,101,陽信-石牌,2023-09-18,8711
2330,台積電,91,4,87,陽信-石牌,2023-09-18,8711
6451,訊芯-KY,87,3,84,陽信-石牌,2023-09-18,8711
3231,緯創,89,23,66,陽信-石牌,2023-09-18,8711
2617,台航,50,0,50,陽信-石牌,2023-09-18,8711
2363,矽統,90,46,44,陽信-石牌,2023-09-18,8711
3037,欣興,50,12,38,陽信-石牌,2023-09-18,8711
3521,鴻翊,30,0,30,陽信-石牌,2023-09-18,8711
6026,福邦證,30,0,30,陽信-石牌,2023-09-18,8711
7402,邑錡,29,0,29,陽信-石牌,2023-09-18,8711
00878,國泰永續高股息,29,0,29,陽信-石牌,2023-09-18,8711
3706,神達,27,0,27,陽信-石牌,2023-09-18,8711
2356,英業達,30,4,26,陽信-石牌,2023-09-18,8711
2374,佳能,26,0,26,陽信-石牌,2023-09-18,8711
3090,日電貿,25,0,25,陽信-石牌,2023-09-18,8711
2329,華泰,23,1,22,陽信-石牌,2023-09-18,8711
00679B,元大美債20年,22,0,22,陽信-石牌,2023-09-18,8711
3011,今皓,21,0,21,陽信-石牌,2023-09-18,8711
00931B,統一美債20年,20,0,20,陽信-石牌,2023-09-18,8711
2489,瑞軒,20,0,20,陽信-石牌,2023-09-18,8711
3531,先益,20,0,20,陽信-石牌,2023-09-18,8711
3710,連展投控,20,1,19,陽信-石牌,2023-09-18,8711
8050,廣積,20,1,19,陽信-石牌,2023-09-18,8711
2605,新興,16,0,16,陽信-石牌,2023-09-18,8711
2884,玉山金,16,0,16,陽信-石牌,2023-09-18,8711
00656R,國泰中國A50反1,15,0,15,陽信-石牌,2023-09-18,8711
00751B,元大AAA至A公司債,15,0,15,陽信-石牌,2023-09-18,8711
2603,長榮,27,12,15,陽信-石牌,2023-09-18,8711
2316,楠梓電,17,3,14,陽信-石牌,2023-09-18,8711
3711,日月光投控,14,0,14,陽信-石牌,2023-09-18,8711
6426,統新,16,2,14,陽信-石牌,2023-09-18,8711
00772B,中信高評級公司債,12,0,12,陽信-石牌,2023-09-18,8711
6120,達運,12,0,12,陽信-石牌,2023-09-18,8711
3105,穩懋,16,5,11,陽信-石牌,2023-09-18,8711
00687B,國泰20年美債,11,0,11,陽信-石牌,2023-09-18,8711
1560,中砂,11,0,11,陽信-石牌,2023-09-18,8711
2881,富邦金,11,0,11,陽信-石牌,2023-09-18,8711
6274,台燿,11,0,11,陽信-石牌,2023-09-18,8711
3324,雙鴻,11,1,10,陽信-石牌,2023-09-18,8711
1402,遠東新,10,0,10,陽信-石牌,2023-09-18,8711
1903,士紙,12,2,10,陽信-石牌,2023-09-18,8711
2883,凱基金,10,0,10,陽信-石牌,2023-09-18,8711
3356,奇偶,10,0,10,陽信-石牌,2023-09-18,8711
3483,力致,10,0,10,陽信-石牌,2023-09-18,8711
4155,訊映,10,0,10,陽信-石牌,2023-09-18,8711
4157,太景*-KY,10,0,10,陽信-石牌,2023-09-18,8711
00680L,元大美債20正2,9,0,9,陽信-石牌,2023-09-18,8711
2010,春源,9,0,9,陽信-石牌,2023-09-18,8711
3450,聯鈞,153,10,143,陽信-石牌,2023-09-19,8711
00929,復華台灣科技優息,116,10,106,陽信-石牌,2023-09-19,8711
1802,台玻,102,4,98,陽信-石牌,2023-09-19,8711
3694,海華,70,0,70,陽信-石牌,2023-09-19,8711
00919,群益台灣精選高息,48,3,45,陽信-石牌,2023-09-19,8711
1905,華紙,39,4,35,陽信-石牌,2023-09-19,8711
2331,精英,44,9,35,陽信-石牌,2023-09-19,8711
2618,長榮航,38,3,35,陽信-石牌,2023-09-19,8711
2374,佳能,24,0,24,陽信-石牌,2023-09-19,8711
6274,台燿,29,5,24,陽信-石牌,2023-09-19,8711
6672,騰輝電子-KY,24,0,24,陽信-石牌,2023-09-19,8711
2330,台積電,23,2,21,陽信-石牌,2023-09-19,8711
1305,華夏,20,0,20,陽信-石牌,2023-09-19,8711
7402,邑錡,22,2,20,陽信-石牌,2023-09-19,8711
6605,帝寶,22,4,18,陽信-石牌,2023-09-19,8711
2356,英業達,17,0,17,陽信-石牌,2023-09-19,8711
4979,華星光,29,12,17,陽信-石牌,2023-09-19,8711
3231,緯創,72,56,16,陽信-石牌,2023-09-19,8711
2497,怡利電,16,0,16,陽信-石牌,2023-09-19,8711
2606,裕民,16,0,16,陽信-石牌,2023-09-19,8711
00898,國泰基因免疫革命,15,0,15,陽信-石牌,2023-09-19,8711
00773B,中信優先金融債,15,0,15,陽信-石牌,2023-09-19,8711
0056,元大高股息,14,0,14,陽信-石牌,2023-09-19,8711
2362,藍天,14,0,14,陽信-石牌,2023-09-19,8711
5227,立凱-KY,14,0,14,陽信-石牌,2023-09-19,8711
5284,jpp-KY,16,2,14,陽信-石牌,2023-09-19,8711
2312,金寶,13,0,13,陽信-石牌,2023-09-19,8711
2486,一詮,24,11,13,陽信-石牌,2023-09-19,8711
3035,智原,15,2,13,陽信-石牌,2023-09-19,8711
6150,撼訊,20,7,13,陽信-石牌,2023-09-19,8711
2329,華泰,20,7,13,陽信-石牌,2023-09-19,8711
2382,廣達,20,8,12,陽信-石牌,2023-09-19,8711
2316,楠梓電,11,0,11,陽信-石牌,2023-09-19,8711
3032,偉訓,25,14,11,陽信-石牌,2023-09-19,8711
8390,金益鼎,11,0,11,陽信-石牌,2023-09-19,8711
2313,華通,85,75,10,陽信-石牌,2023-09-19,8711
1440,南紡,10,0,10,陽信-石牌,2023-09-19,8711
00724B,群益投資級金融債,10,0,10,陽信-石牌,2023-09-19,8711
1513,中興電,13,3,10,陽信-石牌,2023-09-19,8711
2301,光寶科,11,1,10,陽信-石牌,2023-09-19,8711
2515,中工,10,0,10,陽信-石牌,2023-09-19,8711
3163,波若威,12,2,10,陽信-石牌,2023-09-19,8711
4503,金雨,10,0,10,陽信-石牌,2023-09-19,8711
6120,達運,10,0,10,陽信-石牌,2023-09-19,8711
8028,昇陽半導體,10,0,10,陽信-石牌,2023-09-19,8711
2888,新光金,10,0,10,陽信-石牌,2023-09-19,8711
00878,國泰永續高股息,16,7,9,陽信-石牌,2023-09-19,8711
5225,東科-KY,15,6,9,陽信-石牌,2023-09-19,8711
2455,全新,15,7,8,陽信-石牌,2023-09-19,8711
2482,連宇,8,0,8,陽信-石牌,2023-09-19,8711
00929,復華台灣科技優息,188,67,121,陽信-石牌,2023-09-20,8711
2367,燿華,140,22,118,陽信-石牌,2023-09-20,8711
2332,友訊,84,7,77,陽信-石牌,2023-09-20,8711
00931B,統一美債20年,65,0,65,陽信-石牌,2023-09-20,8711
00919,群益台灣精選高息,51,1,50,陽信-石牌,2023-09-20,8711
00764B,群益25年美債,48,0,48,陽信-石牌,2023-09-20,8711
3037,欣興,48,2,46,陽信-石牌,2023-09-20,8711
1313,聯成,35,0,35,陽信-石牌,2023-09-20,8711
2449,京元電子,35,2,33,陽信-石牌,2023-09-20,8711
00722B,群益投資級電信債,28,0,28,陽信-石牌,2023-09-20,8711
2637,慧洋-KY,33,5,28,陽信-石牌,2023-09-20,8711
2331,精英,51,24,27,陽信-石牌,2023-09-20,8711
2330,台積電,28,1,27,陽信-石牌,2023-09-20,8711
00932,兆豐永續高息等權,25,0,25,陽信-石牌,2023-09-20,8711
2002,中鋼,17,0,17,陽信-石牌,2023-09-20,8711
2883,凱基金,26,10,16,陽信-石牌,2023-09-20,8711
1101,台泥,16,0,16,陽信-石牌,2023-09-20,8711
1605,華新,34,19,15,陽信-石牌,2023-09-20,8711
2344,華邦電,16,1,15,陽信-石牌,2023-09-20,8711
2606,裕民,26,11,15,陽信-石牌,2023-09-20,8711
5439,高技,15,0,15,陽信-石牌,2023-09-20,8711
1522,堤維西,32,18,14,陽信-石牌,2023-09-20,8711
1524,耿鼎,15,2,13,陽信-石牌,2023-09-20,8711
3663,鑫科,13,0,13,陽信-石牌,2023-09-20,8711
00921,兆豐龍頭等權重,12,0,12,陽信-石牌,2023-09-20,8711
00878,國泰永續高股息,22,10,12,陽信-石牌,2023-09-20,8711
3450,聯鈞,13,1,12,陽信-石牌,2023-09-20,8711
2201,裕隆,37,26,11,陽信-石牌,2023-09-20,8711
2363,矽統,30,19,11,陽信-石牌,2023-09-20,8711
2888,新光金,11,0,11,陽信-石牌,2023-09-20,8711
00680L,元大美債20正2,10,0,10,陽信-石牌,2023-09-20,8711
2382,廣達,33,23,10,陽信-石牌,2023-09-20,8711
2515,中工,10,0,10,陽信-石牌,2023-09-20,8711
2890,永豐金,10,0,10,陽信-石牌,2023-09-20,8711
2913,農林,38,28,10,陽信-石牌,2023-09-20,8711
3715,定穎投控,40,30,10,陽信-石牌,2023-09-20,8711
5234,達興材料,10,0,10,陽信-石牌,2023-09-20,8711
5478,智冠,9,0,9,陽信-石牌,2023-09-20,8711
6684,安格,9,0,9,陽信-石牌,2023-09-20,8711
8255,朋程,9,0,9,陽信-石牌,2023-09-20,8711
2371,大同,8,0,8,陽信-石牌,2023-09-20,8711
2926,誠品生活,8,0,8,陽信-石牌,2023-09-20,8711
2912,統一超,7,0,7,陽信-石牌,2023-09-20,8711
00679B,元大美債20年,17,10,7,陽信-石牌,2023-09-20,8711
1584,精剛,22,15,7,陽信-石牌,2023-09-20,8711
2392,正崴,8,1,7,陽信-石牌,2023-09-20,8711
3032,偉訓,18,11,7,陽信-石牌,2023-09-20,8711
3035,智原,15,8,7,陽信-石牌,2023-09-20,8711
3042,晶技,8,1,7,陽信-石牌,2023-09-20,8711
3483,力致,12,5,7,陽信-石牌,2023-09-20,8711
2883,凱基金,84,2,82,陽信-石牌,2023-09-21,8711
00680L,元大美債20正2,64,0,64,陽信-石牌,2023-09-21,8711
2610,華航,82,27,55,陽信-石牌,2023-09-21,8711
00932,兆豐永續高息等權,53,0,53,陽信-石牌,2023-09-21,8711
3325,旭品,65,12,53,陽信-石牌,2023-09-21,8711
00931B,統一美債20年,52,0,52,陽信-石牌,2023-09-21,8711
00878,國泰永續高股息,40,0,40,陽信-石牌,2023-09-21,8711
1313,聯成,40,0,40,陽信-石牌,2023-09-21,8711
00919,群益台灣精選高息,47,8,39,陽信-石牌,2023-09-21,8711
00900,富邦特選高股息30,51,18,33,陽信-石牌,2023-09-21,8711
2617,台航,30,0,30,陽信-石牌,2023-09-21,8711
2002,中鋼,27,0,27,陽信-石牌,2023-09-21,8711
2330,台積電,34,9,25,陽信-石牌,2023-09-21,8711
2882,國泰金,24,0,24,陽信-石牌,2023-09-21,8711
0056,元大高股息,21,0,21,陽信-石牌,2023-09-21,8711
2208,台船,20,1,19,陽信-石牌,2023-09-21,8711
2374,佳能,19,0,19,陽信-石牌,2023-09-21,8711
2888,新光金,28,10,18,陽信-石牌,2023-09-21,8711
2331,精英,41,26,15,陽信-石牌,2023-09-21,8711
6235,華孚,16,1,15,陽信-石牌,2023-09-21,8711
00679B,元大美債20年,14,0,14,陽信-石牌,2023-09-21,8711
3481,群創,17,4,13,陽信-石牌,2023-09-21,8711
1101,台泥,13,0,13,陽信-石牌,2023-09-21,8711
5880,合庫金,13,0,13,陽信-石牌,2023-09-21,8711
3617,碩天,14,1,13,陽信-石牌,2023-09-21,8711
2801,彰銀,12,0,12,陽信-石牌,2023-09-21,8711
2354,鴻準,14,2,12,陽信-石牌,2023-09-21,8711
2605,新興,13,1,12,陽信-石牌,2023-09-21,8711
2637,慧洋-KY,15,3,12,陽信-石牌,2023-09-21,8711
3576,聯合再生,12,0,12,陽信-石牌,2023-09-21,8711
2027,大成鋼,12,1,11,陽信-石牌,2023-09-21,8711
4533,協易機,11,0,11,陽信-石牌,2023-09-21,8711
6605,帝寶,13,2,11,陽信-石牌,2023-09-21,8711
2884,玉山金,10,0,10,陽信-石牌,2023-09-21,8711
00701,國泰股利精選30,10,0,10,陽信-石牌,2023-09-21,8711
00922,國泰台灣領袖50,10,0,10,陽信-石牌,2023-09-21,8711
1568,倉佑,10,0,10,陽信-石牌,2023-09-21,8711
1905,華紙,20,10,10,陽信-石牌,2023-09-21,8711
3060,銘異,10,0,10,陽信-石牌,2023-09-21,8711
5344,立衛,10,0,10,陽信-石牌,2023-09-21,8711
6015,宏遠證,10,0,10,陽信-石牌,2023-09-21,8711
6446,藥華藥,10,0,10,陽信-石牌,2023-09-21,8711
1203,味王,9,0,9,陽信-石牌,2023-09-21,8711
2355,敬鵬,10,1,9,陽信-石牌,2023-09-21,8711
2382,廣達,34,25,9,陽信-石牌,2023-09-21,8711
6732,昇佳電子,9,0,9,陽信-石牌,2023-09-21,8711
3037,欣興,12,3,9,陽信-石牌,2023-09-21,8711
00915,凱基優選高股息30,8,0,8,陽信-石牌,2023-09-21,8711
2486,一詮,17,9,8,陽信-石牌,2023-09-21,8711
4906,正文,8,0,8,陽信-石牌,2023-09-21,8711
00632R,元大台灣50反1,509,10,499,陽信-石牌,2023-09-22,8711
00931B,統一美債20年,99,0,99,陽信-石牌,2023-09-22,8711
00929,復華台灣科技優息,70,6,64,陽信-石牌,2023-09-22,8711
00679B,元大美債20年,45,0,45,陽信-石牌,2023-09-22,8711
00712,復華富時不動產,38,0,38,陽信-石牌,2023-09-22,8711
00919,群益台灣精選高息,41,10,31,陽信-石牌,2023-09-22,8711
1467,南緯,30,0,30,陽信-石牌,2023-09-22,8711
2617,台航,30,0,30,陽信-石牌,2023-09-22,8711
00932,兆豐永續高息等權,25,0,25,陽信-石牌,2023-09-22,8711
2606,裕民,25,0,25,陽信-石牌,2023-09-22,8711
00650L,復華香港正2,54,32,22,陽信-石牌,2023-09-22,8711
2330,台積電,22,4,18,陽信-石牌,2023-09-22,8711
2882,國泰金,18,0,18,陽信-石牌,2023-09-22,8711
2883,凱基金,19,2,17,陽信-石牌,2023-09-22,8711
2303,聯電,16,0,16,陽信-石牌,2023-09-22,8711
2002,中鋼,17,1,16,陽信-石牌,2023-09-22,8711
00687B,國泰20年美債,15,0,15,陽信-石牌,2023-09-22,8711
00898,國泰基因免疫革命,15,0,15,陽信-石牌,2023-09-22,8711
9919,康那香,15,0,15,陽信-石牌,2023-09-22,8711
6901,鑽石投資,14,0,14,陽信-石牌,2023-09-22,8711
2367,燿華,113,101,12,陽信-石牌,2023-09-22,8711
00751B,元大AAA至A公司債,11,0,11,陽信-石牌,2023-09-22,8711
2356,英業達,15,4,11,陽信-石牌,2023-09-22,8711
3149,正達,13,2,11,陽信-石牌,2023-09-22,8711
00634R,富邦上証反1,10,0,10,陽信-石牌,2023-09-22,8711
00719B,元大美債1-3,10,0,10,陽信-石牌,2023-09-22,8711
2014,中鴻,10,0,10,陽信-石牌,2023-09-22,8711
2462,良得電,10,0,10,陽信-石牌,2023-09-22,8711
2892,第一金,10,0,10,陽信-石牌,2023-09-22,8711
6016,康和證,10,0,10,陽信-石牌,2023-09-22,8711
9928,中視,12,2,10,陽信-石牌,2023-09-22,8711
2402,毅嘉,10,1,9,陽信-石牌,2023-09-22,8711
2641,正德,11,2,9,陽信-石牌,2023-09-22,8711
2399,映泰,8,0,8,陽信-石牌,2023-09-22,8711
2881,富邦金,8,0,8,陽信-石牌,2023-09-22,8711
2612,中航,11,4,7,陽信-石牌,2023-09-22,8711
2734,易飛網,7,0,7,陽信-石牌,2023-09-22,8711
3450,聯鈞,43,36,7,陽信-石牌,2023-09-22,8711
00878,國泰永續高股息,6,0,6,陽信-石牌,2023-09-22,8711
00795B,中信美國公債20年,6,0,6,陽信-石牌,2023-09-22,8711
2305,全友,6,0,6,陽信-石牌,2023-09-22,8711
2603,長榮,18,12,6,陽信-石牌,2023-09-22,8711
00688L,國泰20年美債正2,5,0,5,陽信-石牌,2023-09-22,8711
1435,中福,5,0,5,陽信-石牌,2023-09-22,8711
1444,力麗,5,0,5,陽信-石牌,2023-09-22,8711
2436,偉詮電,6,1,5,陽信-石牌,2023-09-22,8711
2444,兆勁,5,0,5,陽信-石牌,2023-09-22,8711
2520,冠德,5,0,5,陽信-石牌,2023-09-22,8711
2885,元大金,5,0,5,陽信-石牌,2023-09-22,8711
2891,中信金,5,0,5,陽信-石牌,2023-09-22,8711
2637,慧洋-KY,52,0,52,陽信-石牌,2023-09-25,8711
2330,台積電,53,2,51,陽信-石牌,2023-09-25,8711
9103,美德醫療-DR,35,0,35,陽信-石牌,2023-09-25,8711
3037,欣興,31,2,29,陽信-石牌,2023-09-25,8711
00712,復華富時不動產,25,0,25,陽信-石牌,2023-09-25,8711
3706,神達,25,2,23,陽信-石牌,2023-09-25,8711
1504,東元,24,3,21,陽信-石牌,2023-09-25,8711
2313,華通,22,2,20,陽信-石牌,2023-09-25,8711
2363,矽統,70,50,20,陽信-石牌,2023-09-25,8711
2601,益航,20,0,20,陽信-石牌,2023-09-25,8711
1203,味王,18,0,18,陽信-石牌,2023-09-25,8711
00669R,國泰美國道瓊反1,17,0,17,陽信-石牌,2023-09-25,8711
1101,台泥,21,4,17,陽信-石牌,2023-09-25,8711
3531,先益,14,0,14,陽信-石牌,2023-09-25,8711
9105,泰金寶-DR,14,0,14,陽信-石牌,2023-09-25,8711
00919,群益台灣精選高息,17,5,12,陽信-石牌,2023-09-25,8711
3022,威強電,12,0,12,陽信-石牌,2023-09-25,8711
5410,國眾,12,0,12,陽信-石牌,2023-09-25,8711
3450,聯鈞,19,8,11,陽信-石牌,2023-09-25,8711
00719B,元大美債1-3,10,0,10,陽信-石牌,2023-09-25,8711
1717,長興,10,0,10,陽信-石牌,2023-09-25,8711
2357,華碩,10,0,10,陽信-石牌,2023-09-25,8711
2399,映泰,12,2,10,陽信-石牌,2023-09-25,8711
2618,長榮航,26,16,10,陽信-石牌,2023-09-25,8711
2883,凱基金,10,0,10,陽信-石牌,2023-09-25,8711
3363,上詮,14,4,10,陽信-石牌,2023-09-25,8711
3704,合勤控,10,0,10,陽信-石牌,2023-09-25,8711
6143,振曜,10,0,10,陽信-石牌,2023-09-25,8711
6156,松上,10,0,10,陽信-石牌,2023-09-25,8711
8028,昇陽半導體,10,0,10,陽信-石牌,2023-09-25,8711
2401,凌陽,9,0,9,陽信-石牌,2023-09-25,8711
6108,競國,9,0,9,陽信-石牌,2023-09-25,8711
2834,臺企銀,10,1,9,陽信-石牌,2023-09-25,8711
1605,華新,11,3,8,陽信-石牌,2023-09-25,8711
2882,國泰金,8,0,8,陽信-石牌,2023-09-25,8711
2002,中鋼,9,2,7,陽信-石牌,2023-09-25,8711
2913,農林,12,5,7,陽信-石牌,2023-09-25,8711
3044,健鼎,8,1,7,陽信-石牌,2023-09-25,8711
1584,精剛,23,17,6,陽信-石牌,2023-09-25,8711
1905,華紙,6,0,6,陽信-石牌,2023-09-25,8711
2208,台船,6,0,6,陽信-石牌,2023-09-25,8711
2374,佳能,7,1,6,陽信-石牌,2023-09-25,8711
2634,漢翔,6,0,6,陽信-石牌,2023-09-25,8711
3711,日月光投控,6,0,6,陽信-石牌,2023-09-25,8711
5439,高技,6,0,6,陽信-石牌,2023-09-25,8711
6168,宏齊,6,0,6,陽信-石牌,2023-09-25,8711
2376,技嘉,16,10,6,陽信-石牌,2023-09-25,8711
006208,富邦台50,5,0,5,陽信-石牌,2023-09-25,8711
2303,聯電,5,0,5,陽信-石牌,2023-09-25,8711
2382,廣達,33,28,5,陽信-石牌,2023-09-25,8711
3481,群創,166,1,165,陽信-石牌,2023-09-26,8711
3706,神達,91,0,91,陽信-石牌,2023-09-26,8711
00929,復華台灣科技優息,65,0,65,陽信-石牌,2023-09-26,8711
00680L,元大美債20正2,56,0,56,陽信-石牌,2023-09-26,8711
00857B,永豐20年美公債,54,0,54,陽信-石牌,2023-09-26,8711
2637,慧洋-KY,42,0,42,陽信-石牌,2023-09-26,8711
1609,大亞,49,12,37,陽信-石牌,2023-09-26,8711
5608,四維航,33,0,33,陽信-石牌,2023-09-26,8711
2303,聯電,32,0,32,陽信-石牌,2023-09-26,8711
00919,群益台灣精選高息,31,0,31,陽信-石牌,2023-09-26,8711
3044,健鼎,29,2,27,陽信-石牌,2023-09-26,8711
1710,東聯,26,0,26,陽信-石牌,2023-09-26,8711
2363,矽統,78,52,26,陽信-石牌,2023-09-26,8711
1203,味王,24,0,24,陽信-石牌,2023-09-26,8711
6505,台塑化,30,6,24,陽信-石牌,2023-09-26,8711
2002,中鋼,23,1,22,陽信-石牌,2023-09-26,8711
00795B,中信美國公債20年,21,0,21,陽信-石牌,2023-09-26,8711
2368,金像電,34,14,20,陽信-石牌,2023-09-26,8711
9933,中鼎,20,0,20,陽信-石牌,2023-09-26,8711
8088,品安,20,1,19,陽信-石牌,2023-09-26,8711
00900,富邦特選高股息30,18,0,18,陽信-石牌,2023-09-26,8711
1605,華新,27,10,17,陽信-石牌,2023-09-26,8711
00878,國泰永續高股息,16,0,16,陽信-石牌,2023-09-26,8711
2329,華泰,29,13,16,陽信-石牌,2023-09-26,8711
6770,力積電,15,0,15,陽信-石牌,2023-09-26,8711
00905,FT臺灣Smart,14,0,14,陽信-石牌,2023-09-26,8711
2399,映泰,14,0,14,陽信-石牌,2023-09-26,8711
2605,新興,17,3,14,陽信-石牌,2023-09-26,8711
00885,富邦越南,13,0,13,陽信-石牌,2023-09-26,8711
2330,台積電,18,5,13,陽信-石牌,2023-09-26,8711
00679B,元大美債20年,14,2,12,陽信-石牌,2023-09-26,8711
1522,堤維西,25,13,12,陽信-石牌,2023-09-26,8711
1504,東元,39,28,11,陽信-石牌,2023-09-26,8711
3231,緯創,19,8,11,陽信-石牌,2023-09-26,8711
6446,藥華藥,11,0,11,陽信-石牌,2023-09-26,8711
2881,富邦金,12,2,10,陽信-石牌,2023-09-26,8711
00687B,國泰20年美債,12,2,10,陽信-石牌,2023-09-26,8711
00773B,中信優先金融債,10,0,10,陽信-石牌,2023-09-26,8711
00772B,中信高評級公司債,10,0,10,陽信-石牌,2023-09-26,8711
1532,勤美,10,0,10,陽信-石牌,2023-09-26,8711
2313,華通,14,4,10,陽信-石牌,2023-09-26,8711
2409,友達,11,1,10,陽信-石牌,2023-09-26,8711
2883,凱基金,10,0,10,陽信-石牌,2023-09-26,8711
2903,遠百,10,0,10,陽信-石牌,2023-09-26,8711
4106,雃博,10,0,10,陽信-石牌,2023-09-26,8711
5371,中光電,10,0,10,陽信-石牌,2023-09-26,8711
6143,振曜,10,0,10,陽信-石牌,2023-09-26,8711
8171,天宇,10,0,10,陽信-石牌,2023-09-26,8711
00931B,統一美債20年,16,8,8,陽信-石牌,2023-09-26,8711
1319,東陽,11,3,8,陽信-石牌,2023-09-26,8711
00632R,元大台灣50反1,407,80,327,陽信-石牌,2023-09-27,8711
2303,聯電,141,6,135,陽信-石牌,2023-09-27,8711
4566,時碩工業,72,1,71,陽信-石牌,2023-09-27,8711
00857B,永豐20年美公債,60,0,60,陽信-石牌,2023-09-27,8711
1710,東聯,53,0,53,陽信-石牌,2023-09-27,8711
2834,臺企銀,45,0,45,陽信-石牌,2023-09-27,8711
2014,中鴻,40,0,40,陽信-石牌,2023-09-27,8711
00932,兆豐永續高息等權,38,4,34,陽信-石牌,2023-09-27,8711
00929,復華台灣科技優息,57,26,31,陽信-石牌,2023-09-27,8711
00669R,國泰美國道瓊反1,24,1,23,陽信-石牌,2023-09-27,8711
3231,緯創,29,6,23,陽信-石牌,2023-09-27,8711
00919,群益台灣精選高息,25,4,21,陽信-石牌,2023-09-27,8711
2312,金寶,20,0,20,陽信-石牌,2023-09-27,8711
2883,凱基金,41,21,20,陽信-石牌,2023-09-27,8711
00885,富邦越南,20,1,19,陽信-石牌,2023-09-27,8711
00671R,富邦NASDAQ反1,18,1,17,陽信-石牌,2023-09-27,8711
3521,鴻翊,16,0,16,陽信-石牌,2023-09-27,8711
9919,康那香,21,5,16,陽信-石牌,2023-09-27,8711
00898,國泰基因免疫革命,15,0,15,陽信-石牌,2023-09-27,8711
3044,健鼎,15,1,14,陽信-石牌,2023-09-27,8711
1203,味王,13,0,13,陽信-石牌,2023-09-27,8711
2891,中信金,13,0,13,陽信-石牌,2023-09-27,8711
3017,奇鋐,14,3,11,陽信-石牌,2023-09-27,8711
00719B,元大美債1-3,10,0,10,陽信-石牌,2023-09-27,8711
2816,旺旺保,10,0,10,陽信-石牌,2023-09-27,8711
3081,聯亞,10,0,10,陽信-石牌,2023-09-27,8711
5222,全訊,10,0,10,陽信-石牌,2023-09-27,8711
5880,合庫金,10,0,10,陽信-石牌,2023-09-27,8711
1319,東陽,9,0,9,陽信-石牌,2023-09-27,8711
00878,國泰永續高股息,10,2,8,陽信-石牌,2023-09-27,8711
2206,三陽工業,8,0,8,陽信-石牌,2023-09-27,8711
2313,華通,19,11,8,陽信-石牌,2023-09-27,8711
3322,建舜電,11,3,8,陽信-石牌,2023-09-27,8711
3707,漢磊,8,0,8,陽信-石牌,2023-09-27,8711
4906,正文,10,2,8,陽信-石牌,2023-09-27,8711
1802,台玻,7,0,7,陽信-石牌,2023-09-27,8711
2603,長榮,14,7,7,陽信-石牌,2023-09-27,8711
2913,農林,7,0,7,陽信-石牌,2023-09-27,8711
00673R,期元大S＆P原油反1,6,0,6,陽信-石牌,2023-09-27,8711
1409,新纖,6,0,6,陽信-石牌,2023-09-27,8711
1471,首利,6,0,6,陽信-石牌,2023-09-27,8711
3022,威強電,6,0,6,陽信-石牌,2023-09-27,8711
3025,星通,11,5,6,陽信-石牌,2023-09-27,8711
6191,精成科,6,0,6,陽信-石牌,2023-09-27,8711
6285,啟��,6,0,6,陽信-石牌,2023-09-27,8711
6282,康舒,6,0,6,陽信-石牌,2023-09-27,8711
1314,中石化,5,0,5,陽信-石牌,2023-09-27,8711
1513,中興電,6,1,5,陽信-石牌,2023-09-27,8711
3006,晶豪科,5,0,5,陽信-石牌,2023-09-27,8711
3071,協禧,5,0,5,陽信-石牌,2023-09-27,8711
1710,東聯,356,0,356,陽信-石牌,2023-09-28,8711
3231,緯創,289,13,276,陽信-石牌,2023-09-28,8711
2421,建準,103,3,100,陽信-石牌,2023-09-28,8711
5371,中光電,100,0,100,陽信-石牌,2023-09-28,8711
00712,復華富時不動產,61,0,61,陽信-石牌,2023-09-28,8711
2363,矽統,110,51,59,陽信-石牌,2023-09-28,8711
2542,興富發,58,0,58,陽信-石牌,2023-09-28,8711
00679B,元大美債20年,51,0,51,陽信-石牌,2023-09-28,8711
6120,達運,50,0,50,陽信-石牌,2023-09-28,8711
1449,佳和,31,1,30,陽信-石牌,2023-09-28,8711
9103,美德醫療-DR,30,0,30,陽信-石牌,2023-09-28,8711
2408,南亞科,35,7,28,陽信-石牌,2023-09-28,8711
6108,競國,32,5,27,陽信-石牌,2023-09-28,8711
3521,鴻翊,42,16,26,陽信-石牌,2023-09-28,8711
6188,廣明,24,0,24,陽信-石牌,2023-09-28,8711
00751B,元大AAA至A公司債,22,0,22,陽信-石牌,2023-09-28,8711
6510,精測,23,1,22,陽信-石牌,2023-09-28,8711
00932,兆豐永續高息等權,21,0,21,陽信-石牌,2023-09-28,8711
00885,富邦越南,20,0,20,陽信-石牌,2023-09-28,8711
2801,彰銀,20,0,20,陽信-石牌,2023-09-28,8711
2317,鴻海,19,0,19,陽信-石牌,2023-09-28,8711
2344,華邦電,19,2,17,陽信-石牌,2023-09-28,8711
4306,炎洲,15,0,15,陽信-石牌,2023-09-28,8711
3006,晶豪科,14,0,14,陽信-石牌,2023-09-28,8711
1203,味王,13,0,13,陽信-石牌,2023-09-28,8711
00720B,元大投資級公司債,13,0,13,陽信-石牌,2023-09-28,8711
00680L,元大美債20正2,12,0,12,陽信-石牌,2023-09-28,8711
2882,國泰金,12,1,11,陽信-石牌,2023-09-28,8711
3217,優群,11,0,11,陽信-石牌,2023-09-28,8711
6485,點序,11,0,11,陽信-石牌,2023-09-28,8711
00931B,統一美債20年,10,0,10,陽信-石牌,2023-09-28,8711
2515,中工,10,0,10,陽信-石牌,2023-09-28,8711
2641,正德,10,0,10,陽信-石牌,2023-09-28,8711
3011,今皓,10,0,10,陽信-石牌,2023-09-28,8711
3548,兆利,15,5,10,陽信-石牌,2023-09-28,8711
6122,擎邦,10,0,10,陽信-石牌,2023-09-28,8711
6579,研揚,10,0,10,陽信-石牌,2023-09-28,8711
6732,昇佳電子,10,0,10,陽信-石牌,2023-09-28,8711
8038,長園科,10,0,10,陽信-石牌,2023-09-28,8711
3630,新鉅科,9,0,9,陽信-石牌,2023-09-28,8711
6158,禾昌,9,0,9,陽信-石牌,2023-09-28,8711
2376,技嘉,34,25,9,陽信-石牌,2023-09-28,8711
00919,群益台灣精選高息,8,0,8,陽信-石牌,2023-09-28,8711
2606,裕民,13,5,8,陽信-石牌,2023-09-28,8711
3017,奇鋐,10,2,8,陽信-石牌,2023-09-28,8711
2208,台船,12,5,7,陽信-石牌,2023-09-28,8711
2312,金寶,12,5,7,陽信-石牌,2023-09-28,8711
5465,富驊,9,2,7,陽信-石牌,2023-09-28,8711
3260,威剛,11,4,7,陽信-石牌,2023-09-28,8711
6274,台燿,7,1,6,陽信-石牌,2023-09-28,8711
00751B,元大AAA至A公司債,199,0,199,陽信-石牌,2023-10-02,8711
1514,亞力,149,0,149,陽信-石牌,2023-10-02,8711
00931B,統一美債20年,86,0,86,陽信-石牌,2023-10-02,8711
2882,國泰金,80,14,66,陽信-石牌,2023-10-02,8711
3521,鴻翊,56,3,53,陽信-石牌,2023-10-02,8711
1605,華新,55,3,52,陽信-石牌,2023-10-02,8711
3081,聯亞,50,3,47,陽信-石牌,2023-10-02,8711
1905,華紙,48,3,45,陽信-石牌,2023-10-02,8711
00857B,永豐20年美公債,41,0,41,陽信-石牌,2023-10-02,8711
2324,仁寶,41,3,38,陽信-石牌,2023-10-02,8711
00679B,元大美債20年,33,0,33,陽信-石牌,2023-10-02,8711
00650L,復華香港正2,32,0,32,陽信-石牌,2023-10-02,8711
2331,精英,31,0,31,陽信-石牌,2023-10-02,8711
2363,矽統,104,77,27,陽信-石牌,2023-10-02,8711
2542,興富發,26,0,26,陽信-石牌,2023-10-02,8711
00919,群益台灣精選高息,41,15,26,陽信-石牌,2023-10-02,8711
2409,友達,72,50,22,陽信-石牌,2023-10-02,8711
6579,研揚,21,1,20,陽信-石牌,2023-10-02,8711
2605,新興,23,4,19,陽信-石牌,2023-10-02,8711
2376,技嘉,26,8,18,陽信-石牌,2023-10-02,8711
6257,矽格,20,2,18,陽信-石牌,2023-10-02,8711
2002,中鋼,24,6,18,陽信-石牌,2023-10-02,8711
1785,光洋科,16,0,16,陽信-石牌,2023-10-02,8711
2356,英業達,28,12,16,陽信-石牌,2023-10-02,8711
6108,競國,27,11,16,陽信-石牌,2023-10-02,8711
2637,慧洋-KY,13,0,13,陽信-石牌,2023-10-02,8711
1727,中華化,12,0,12,陽信-石牌,2023-10-02,8711
2617,台航,12,0,12,陽信-石牌,2023-10-02,8711
2883,凱基金,12,0,12,陽信-石牌,2023-10-02,8711
3056,富華新,15,3,12,陽信-石牌,2023-10-02,8711
5324,士開,12,0,12,陽信-石牌,2023-10-02,8711
2382,廣達,51,40,11,陽信-石牌,2023-10-02,8711
8099,大世科,11,0,11,陽信-石牌,2023-10-02,8711
9904,寶成,11,0,11,陽信-石牌,2023-10-02,8711
00898,國泰基因免疫革命,10,0,10,陽信-石牌,2023-10-02,8711
1305,華夏,10,0,10,陽信-石牌,2023-10-02,8711
1203,味王,10,0,10,陽信-石牌,2023-10-02,8711
2606,裕民,10,0,10,陽信-石牌,2023-10-02,8711
2867,三商壽,10,0,10,陽信-石牌,2023-10-02,8711
3149,正達,10,0,10,陽信-石牌,2023-10-02,8711
3520,華盈,10,0,10,陽信-石牌,2023-10-02,8711
4503,金雨,10,0,10,陽信-石牌,2023-10-02,8711
8028,昇陽半導體,10,0,10,陽信-石牌,2023-10-02,8711
1504,東元,11,2,9,陽信-石牌,2023-10-02,8711
2913,農林,15,6,9,陽信-石牌,2023-10-02,8711
2903,遠百,8,0,8,陽信-石牌,2023-10-02,8711
3036,文曄,26,18,8,陽信-石牌,2023-10-02,8711
2884,玉山金,7,0,7,陽信-石牌,2023-10-02,8711
2603,長榮,33,26,7,陽信-石牌,2023-10-02,8711
2027,大成鋼,7,0,7,陽信-石牌,2023-10-02,8711
00922,國泰台灣領袖50,137,0,137,陽信-石牌,2023-10-03,8711
2883,凱基金,86,2,84,陽信-石牌,2023-10-03,8711
00712,復華富時不動產,79,0,79,陽信-石牌,2023-10-03,8711
00882,中信中國高股息,66,0,66,陽信-石牌,2023-10-03,8711
2888,新光金,61,0,61,陽信-石牌,2023-10-03,8711
00929,復華台灣科技優息,59,0,59,陽信-石牌,2023-10-03,8711
3521,鴻翊,56,0,56,陽信-石牌,2023-10-03,8711
3231,緯創,102,50,52,陽信-石牌,2023-10-03,8711
00720B,元大投資級公司債,51,0,51,陽信-石牌,2023-10-03,8711
00857B,永豐20年美公債,40,0,40,陽信-石牌,2023-10-03,8711
3706,神達,41,3,38,陽信-石牌,2023-10-03,8711
2409,友達,61,31,30,陽信-石牌,2023-10-03,8711
6016,康和證,25,0,25,陽信-石牌,2023-10-03,8711
6573,虹揚-KY,25,0,25,陽信-石牌,2023-10-03,8711
2882,國泰金,25,1,24,陽信-石牌,2023-10-03,8711
1605,華新,36,15,21,陽信-石牌,2023-10-03,8711
00633L,富邦上証正2,20,0,20,陽信-石牌,2023-10-03,8711
2332,友訊,20,0,20,陽信-石牌,2023-10-03,8711
2382,廣達,39,19,20,陽信-石牌,2023-10-03,8711
4960,誠美材,20,0,20,陽信-石牌,2023-10-03,8711
2355,敬鵬,19,0,19,陽信-石牌,2023-10-03,8711
2312,金寶,17,0,17,陽信-石牌,2023-10-03,8711
2002,中鋼,17,2,15,陽信-石牌,2023-10-03,8711
2458,義隆,20,5,15,陽信-石牌,2023-10-03,8711
6806,森崴能源,15,0,15,陽信-石牌,2023-10-03,8711
2313,華通,19,5,14,陽信-石牌,2023-10-03,8711
2603,長榮,15,1,14,陽信-石牌,2023-10-03,8711
6117,迎廣,18,4,14,陽信-石牌,2023-10-03,8711
1905,華紙,63,50,13,陽信-石牌,2023-10-03,8711
2633,台灣高鐵,13,0,13,陽信-石牌,2023-10-03,8711
2637,慧洋-KY,13,0,13,陽信-石牌,2023-10-03,8711
00680L,元大美債20正2,12,0,12,陽信-石牌,2023-10-03,8711
2606,裕民,23,11,12,陽信-石牌,2023-10-03,8711
3051,力特,12,0,12,陽信-石牌,2023-10-03,8711
00921,兆豐龍頭等權重,11,0,11,陽信-石牌,2023-10-03,8711
3035,智原,25,14,11,陽信-石牌,2023-10-03,8711
5426,振發,15,4,11,陽信-石牌,2023-10-03,8711
6550,北極星藥業-KY,11,0,11,陽信-石牌,2023-10-03,8711
2812,台中銀,10,0,10,陽信-石牌,2023-10-03,8711
00898,國泰基因免疫革命,10,0,10,陽信-石牌,2023-10-03,8711
00896,中信綠能及電動車,10,0,10,陽信-石牌,2023-10-03,8711
00719B,元大美債1-3,10,0,10,陽信-石牌,2023-10-03,8711
00665L,富邦�琤肭磪囓�2,45,35,10,陽信-石牌,2023-10-03,8711
00650L,復華香港正2,38,28,10,陽信-石牌,2023-10-03,8711
2014,中鴻,10,0,10,陽信-石牌,2023-10-03,8711
3014,聯陽,10,0,10,陽信-石牌,2023-10-03,8711
3078,僑威,11,1,10,陽信-石牌,2023-10-03,8711
4906,正文,11,1,10,陽信-石牌,2023-10-03,8711
5222,全訊,10,0,10,陽信-石牌,2023-10-03,8711
9105,泰金寶-DR,10,0,10,陽信-石牌,2023-10-03,8711
2610,華航,152,2,150,陽信-石牌,2023-10-04,8711
00922,國泰台灣領袖50,108,0,108,陽信-石牌,2023-10-04,8711
2880,華南金,103,0,103,陽信-石牌,2023-10-04,8711
00929,復華台灣科技優息,76,0,76,陽信-石牌,2023-10-04,8711
00857B,永豐20年美公債,72,0,72,陽信-石牌,2023-10-04,8711
0056,元大高股息,89,24,65,陽信-石牌,2023-10-04,8711
00712,復華富時不動產,61,0,61,陽信-石牌,2023-10-04,8711
00885,富邦越南,61,0,61,陽信-石牌,2023-10-04,8711
2891,中信金,59,0,59,陽信-石牌,2023-10-04,8711
2886,兆豐金,54,0,54,陽信-石牌,2023-10-04,8711
2330,台積電,56,3,53,陽信-石牌,2023-10-04,8711
2606,裕民,42,0,42,陽信-石牌,2023-10-04,8711
3231,緯創,71,31,40,陽信-石牌,2023-10-04,8711
2206,三陽工業,32,1,31,陽信-石牌,2023-10-04,8711
1514,亞力,29,2,27,陽信-石牌,2023-10-04,8711
2303,聯電,25,0,25,陽信-石牌,2023-10-04,8711
00919,群益台灣精選高息,27,3,24,陽信-石牌,2023-10-04,8711
911868,同方友友-DR,22,0,22,陽信-石牌,2023-10-04,8711
00795B,中信美國公債20年,21,0,21,陽信-石牌,2023-10-04,8711
00637L,元大滬深300正2,20,0,20,陽信-石牌,2023-10-04,8711
2014,中鴻,21,1,20,陽信-石牌,2023-10-04,8711
8064,東捷,20,0,20,陽信-石牌,2023-10-04,8711
1319,東陽,19,0,19,陽信-石牌,2023-10-04,8711
2892,第一金,19,0,19,陽信-石牌,2023-10-04,8711
1609,大亞,75,56,19,陽信-石牌,2023-10-04,8711
00772B,中信高評級公司債,19,0,19,陽信-石牌,2023-10-04,8711
00687B,國泰20年美債,18,0,18,陽信-石牌,2023-10-04,8711
1802,台玻,18,0,18,陽信-石牌,2023-10-04,8711
2617,台航,18,0,18,陽信-石牌,2023-10-04,8711
00680L,元大美債20正2,16,0,16,陽信-石牌,2023-10-04,8711
1301,台塑,14,0,14,陽信-石牌,2023-10-04,8711
6235,華孚,15,1,14,陽信-石牌,2023-10-04,8711
1722,台肥,14,0,14,陽信-石牌,2023-10-04,8711
6288,聯嘉,79,65,14,陽信-石牌,2023-10-04,8711
3481,群創,13,0,13,陽信-石牌,2023-10-04,8711
00646,元大S＆P500,11,0,11,陽信-石牌,2023-10-04,8711
1905,華紙,14,3,11,陽信-石牌,2023-10-04,8711
2355,敬鵬,21,10,11,陽信-石牌,2023-10-04,8711
2409,友達,12,1,11,陽信-石牌,2023-10-04,8711
3006,晶豪科,14,3,11,陽信-石牌,2023-10-04,8711
3230,錦明,11,0,11,陽信-石牌,2023-10-04,8711
00751B,元大AAA至A公司債,10,0,10,陽信-石牌,2023-10-04,8711
00719B,元大美債1-3,10,0,10,陽信-石牌,2023-10-04,8711
1605,華新,11,1,10,陽信-石牌,2023-10-04,8711
2801,彰銀,10,0,10,陽信-石牌,2023-10-04,8711
3045,台灣大,10,0,10,陽信-石牌,2023-10-04,8711
4157,太景*-KY,10,0,10,陽信-石牌,2023-10-04,8711
6015,宏遠證,10,0,10,陽信-石牌,2023-10-04,8711
6016,康和證,10,0,10,陽信-石牌,2023-10-04,8711
8464,億豐,10,0,10,陽信-石牌,2023-10-04,8711
3481,群創,158,0,158,陽信-石牌,2023-10-05,8711
2618,長榮航,137,36,101,陽信-石牌,2023-10-05,8711
3078,僑威,102,2,100,陽信-石牌,2023-10-05,8711
6451,訊芯-KY,104,5,99,陽信-石牌,2023-10-05,8711
00712,復華富時不動產,46,1,45,陽信-石牌,2023-10-05,8711
2314,台揚,31,0,31,陽信-石牌,2023-10-05,8711
1319,東陽,39,10,29,陽信-石牌,2023-10-05,8711
6235,華孚,39,13,26,陽信-石牌,2023-10-05,8711
3231,緯創,70,45,25,陽信-石牌,2023-10-05,8711
2382,廣達,38,14,24,陽信-石牌,2023-10-05,8711
00637L,元大滬深300正2,20,0,20,陽信-石牌,2023-10-05,8711
00633L,富邦上証正2,20,0,20,陽信-石牌,2023-10-05,8711
2417,圓剛,29,9,20,陽信-石牌,2023-10-05,8711
5344,立衛,20,0,20,陽信-石牌,2023-10-05,8711
2374,佳能,16,0,16,陽信-石牌,2023-10-05,8711
8054,安國,15,1,14,陽信-石牌,2023-10-05,8711
2002,中鋼,15,2,13,陽信-石牌,2023-10-05,8711
3260,威剛,12,0,12,陽信-石牌,2023-10-05,8711
2882,國泰金,12,0,12,陽信-石牌,2023-10-05,8711
00929,復華台灣科技優息,24,12,12,陽信-石牌,2023-10-05,8711
2206,三陽工業,20,8,12,陽信-石牌,2023-10-05,8711
6285,啟��,15,3,12,陽信-石牌,2023-10-05,8711
8201,無敵,12,0,12,陽信-石牌,2023-10-05,8711
2427,三商電,15,4,11,陽信-石牌,2023-10-05,8711
00922,國泰台灣領袖50,10,0,10,陽信-石牌,2023-10-05,8711
00720B,元大投資級公司債,10,0,10,陽信-石牌,2023-10-05,8711
00719B,元大美債1-3,10,0,10,陽信-石牌,2023-10-05,8711
2031,新光鋼,10,0,10,陽信-石牌,2023-10-05,8711
6120,達運,32,23,9,陽信-石牌,2023-10-05,8711
00680L,元大美債20正2,10,2,8,陽信-石牌,2023-10-05,8711
2357,華碩,8,0,8,陽信-石牌,2023-10-05,8711
2409,友達,8,0,8,陽信-石牌,2023-10-05,8711
8271,宇瞻,12,4,8,陽信-石牌,2023-10-05,8711
2353,宏��,11,4,7,陽信-石牌,2023-10-05,8711
2412,中華電,7,0,7,陽信-石牌,2023-10-05,8711
3531,先益,7,0,7,陽信-石牌,2023-10-05,8711
6288,聯嘉,82,75,7,陽信-石牌,2023-10-05,8711
3037,欣興,16,9,7,陽信-石牌,2023-10-05,8711
2408,南亞科,7,1,6,陽信-石牌,2023-10-05,8711
3002,歐格,6,0,6,陽信-石牌,2023-10-05,8711
3548,兆利,11,5,6,陽信-石牌,2023-10-05,8711
5258,虹堡,8,2,6,陽信-石牌,2023-10-05,8711
5465,富驊,6,0,6,陽信-石牌,2023-10-05,8711
6442,光聖,9,3,6,陽信-石牌,2023-10-05,8711
00898,國泰基因免疫革命,5,0,5,陽信-石牌,2023-10-05,8711
1603,華電,23,18,5,陽信-石牌,2023-10-05,8711
1609,大亞,5,0,5,陽信-石牌,2023-10-05,8711
2015,豐興,5,0,5,陽信-石牌,2023-10-05,8711
2425,承啟,5,0,5,陽信-石牌,2023-10-05,8711
2455,全新,5,0,5,陽信-石牌,2023-10-05,8711
00632R,元大台灣50反1,201,0,201,陽信-石牌,2023-10-06,8711
3481,群創,144,45,99,陽信-石牌,2023-10-06,8711
2882,國泰金,95,23,72,陽信-石牌,2023-10-06,8711
5608,四維航,50,3,47,陽信-石牌,2023-10-06,8711
00929,復華台灣科技優息,42,0,42,陽信-石牌,2023-10-06,8711
2610,華航,51,10,41,陽信-石牌,2023-10-06,8711
3231,緯創,59,21,38,陽信-石牌,2023-10-06,8711
9105,泰金寶-DR,35,0,35,陽信-石牌,2023-10-06,8711
2618,長榮航,59,25,34,陽信-石牌,2023-10-06,8711
00634R,富邦上証反1,30,0,30,陽信-石牌,2023-10-06,8711
00715L,期街口布蘭特正2,25,0,25,陽信-石牌,2023-10-06,8711
00922,國泰台灣領袖50,24,0,24,陽信-石牌,2023-10-06,8711
00931B,統一美債20年,22,0,22,陽信-石牌,2023-10-06,8711
911868,同方友友-DR,19,0,19,陽信-石牌,2023-10-06,8711
2409,友達,42,25,17,陽信-石牌,2023-10-06,8711
2374,佳能,17,0,17,陽信-石牌,2023-10-06,8711
8046,南電,14,0,14,陽信-石牌,2023-10-06,8711
2329,華泰,18,6,12,陽信-石牌,2023-10-06,8711
2442,新美齊,12,1,11,陽信-石牌,2023-10-06,8711
1603,華電,12,2,10,陽信-石牌,2023-10-06,8711
00893,國泰智能電動車,10,0,10,陽信-石牌,2023-10-06,8711
2208,台船,10,0,10,陽信-石牌,2023-10-06,8711
3021,鴻名,10,0,10,陽信-石牌,2023-10-06,8711
8096,擎亞,10,0,10,陽信-石牌,2023-10-06,8711
5351,鈺創,13,3,10,陽信-石牌,2023-10-06,8711
2313,華通,42,33,9,陽信-石牌,2023-10-06,8711
2455,全新,13,5,8,陽信-石牌,2023-10-06,8711
2468,華經,19,11,8,陽信-石牌,2023-10-06,8711
6282,康舒,10,2,8,陽信-石牌,2023-10-06,8711
3032,偉訓,9,1,8,陽信-石牌,2023-10-06,8711
2354,鴻準,7,1,6,陽信-石牌,2023-10-06,8711
2603,長榮,6,0,6,陽信-石牌,2023-10-06,8711
2816,旺旺保,6,0,6,陽信-石牌,2023-10-06,8711
3022,威強電,6,0,6,陽信-石牌,2023-10-06,8711
5225,東科-KY,6,0,6,陽信-石牌,2023-10-06,8711
6672,騰輝電子-KY,27,21,6,陽信-石牌,2023-10-06,8711
7402,邑錡,6,0,6,陽信-石牌,2023-10-06,8711
8033,雷虎,6,0,6,陽信-石牌,2023-10-06,8711
1815,富喬,7,2,5,陽信-石牌,2023-10-06,8711
2425,承啟,5,0,5,陽信-石牌,2023-10-06,8711
2451,創見,5,0,5,陽信-石牌,2023-10-06,8711
3058,立德,5,0,5,陽信-石牌,2023-10-06,8711
3081,聯亞,13,8,5,陽信-石牌,2023-10-06,8711
3701,大眾控,9,4,5,陽信-石牌,2023-10-06,8711
6274,台燿,10,5,5,陽信-石牌,2023-10-06,8711
8210,勤誠,24,19,5,陽信-石牌,2023-10-06,8711
1626,艾美特-KY,4,0,4,陽信-石牌,2023-10-06,8711
2332,友訊,8,4,4,陽信-石牌,2023-10-06,8711
2383,台光電,4,0,4,陽信-石牌,2023-10-06,8711
2641,正德,4,0,4,陽信-石牌,2023-10-06,8711
00632R,元大台灣50反1,509,0,509,陽信-石牌,2023-10-11,8711
2882,國泰金,150,34,116,陽信-石牌,2023-10-11,8711
3231,緯創,154,78,76,陽信-石牌,2023-10-11,8711
2504,國產,54,0,54,陽信-石牌,2023-10-11,8711
00919,群益台灣精選高息,67,16,51,陽信-石牌,2023-10-11,8711
9105,泰金寶-DR,47,0,47,陽信-石牌,2023-10-11,8711
3530,晶相光,41,1,40,陽信-石牌,2023-10-11,8711
6016,康和證,35,0,35,陽信-石牌,2023-10-11,8711
2356,英業達,38,7,31,陽信-石牌,2023-10-11,8711
2603,長榮,36,11,25,陽信-石牌,2023-10-11,8711
2618,長榮航,35,11,24,陽信-石牌,2023-10-11,8711
6285,啟��,33,11,22,陽信-石牌,2023-10-11,8711
2312,金寶,18,0,18,陽信-石牌,2023-10-11,8711
3545,敦泰,20,2,18,陽信-石牌,2023-10-11,8711
1905,華紙,19,2,17,陽信-石牌,2023-10-11,8711
2329,華泰,25,8,17,陽信-石牌,2023-10-11,8711
2465,麗臺,17,0,17,陽信-石牌,2023-10-11,8711
5469,瀚宇博,17,0,17,陽信-石牌,2023-10-11,8711
6861,睿生光電,18,1,17,陽信-石牌,2023-10-11,8711
2617,台航,16,0,16,陽信-石牌,2023-10-11,8711
3025,星通,24,8,16,陽信-石牌,2023-10-11,8711
6120,達運,15,0,15,陽信-石牌,2023-10-11,8711
8240,華宏,15,0,15,陽信-石牌,2023-10-11,8711
2314,台揚,15,1,14,陽信-石牌,2023-10-11,8711
1514,亞力,15,2,13,陽信-石牌,2023-10-11,8711
2606,裕民,14,1,13,陽信-石牌,2023-10-11,8711
3078,僑威,13,0,13,陽信-石牌,2023-10-11,8711
6158,禾昌,15,2,13,陽信-石牌,2023-10-11,8711
1612,宏泰,19,7,12,陽信-石牌,2023-10-11,8711
2382,廣達,31,20,11,陽信-石牌,2023-10-11,8711
2388,威盛,13,2,11,陽信-石牌,2023-10-11,8711
00720B,元大投資級公司債,10,0,10,陽信-石牌,2023-10-11,8711
2316,楠梓電,10,0,10,陽信-石牌,2023-10-11,8711
2641,正德,10,0,10,陽信-石牌,2023-10-11,8711
3005,神基,10,0,10,陽信-石牌,2023-10-11,8711
3520,華盈,10,0,10,陽信-石牌,2023-10-11,8711
5348,正能量智能,10,0,10,陽信-石牌,2023-10-11,8711
5608,四維航,10,0,10,陽信-石牌,2023-10-11,8711
6170,統振,10,0,10,陽信-石牌,2023-10-11,8711
6510,精測,16,6,10,陽信-石牌,2023-10-11,8711
6672,騰輝電子-KY,30,20,10,陽信-石牌,2023-10-11,8711
8068,全達,10,0,10,陽信-石牌,2023-10-11,8711
8464,億豐,10,0,10,陽信-石牌,2023-10-11,8711
2031,新光鋼,9,0,9,陽信-石牌,2023-10-11,8711
2427,三商電,69,60,9,陽信-石牌,2023-10-11,8711
3325,旭品,27,18,9,陽信-石牌,2023-10-11,8711
4721,美琪瑪,9,0,9,陽信-石牌,2023-10-11,8711
4916,事欣科,12,3,9,陽信-石牌,2023-10-11,8711
3217,優群,8,0,8,陽信-石牌,2023-10-11,8711
5457,宣德,8,0,8,陽信-石牌,2023-10-11,8711
00712,復華富時不動產,50,0,50,陽信-石牌,2023-10-12,8711
2637,慧洋-KY,27,0,27,陽信-石牌,2023-10-12,8711
00919,群益台灣精選高息,29,5,24,陽信-石牌,2023-10-12,8711
3231,緯創,55,31,24,陽信-石牌,2023-10-12,8711
2356,英業達,28,5,23,陽信-石牌,2023-10-12,8711
2427,三商電,21,1,20,陽信-石牌,2023-10-12,8711
2363,矽統,82,62,20,陽信-石牌,2023-10-12,8711
2399,映泰,35,17,18,陽信-石牌,2023-10-12,8711
00929,復華台灣科技優息,16,1,15,陽信-石牌,2023-10-12,8711
00905,FT臺灣Smart,15,0,15,陽信-石牌,2023-10-12,8711
2377,微星,15,0,15,陽信-石牌,2023-10-12,8711
6213,聯茂,17,2,15,陽信-石牌,2023-10-12,8711
8046,南電,16,1,15,陽信-石牌,2023-10-12,8711
0056,元大高股息,13,0,13,陽信-石牌,2023-10-12,8711
1203,味王,12,0,12,陽信-石牌,2023-10-12,8711
00881,國泰台灣5G+,12,0,12,陽信-石牌,2023-10-12,8711
3037,欣興,17,6,11,陽信-石牌,2023-10-12,8711
5469,瀚宇博,11,0,11,陽信-石牌,2023-10-12,8711
5351,鈺創,12,1,11,陽信-石牌,2023-10-12,8711
00632R,元大台灣50反1,10,0,10,陽信-石牌,2023-10-12,8711
00634R,富邦上証反1,10,0,10,陽信-石牌,2023-10-12,8711
00665L,富邦�琤肭磪囓�2,46,36,10,陽信-石牌,2023-10-12,8711
00932,兆豐永續高息等權,10,0,10,陽信-石牌,2023-10-12,8711
1783,和康生,10,0,10,陽信-石牌,2023-10-12,8711
3308,聯德,12,2,10,陽信-石牌,2023-10-12,8711
6139,亞翔,10,0,10,陽信-石牌,2023-10-12,8711
6158,禾昌,41,31,10,陽信-石牌,2023-10-12,8711
00878,國泰永續高股息,14,5,9,陽信-石牌,2023-10-12,8711
00679B,元大美債20年,10,1,9,陽信-石牌,2023-10-12,8711
1802,台玻,9,0,9,陽信-石牌,2023-10-12,8711
3276,宇環,12,3,9,陽信-石牌,2023-10-12,8711
2367,燿華,10,2,8,陽信-石牌,2023-10-12,8711
2374,佳能,8,0,8,陽信-石牌,2023-10-12,8711
2493,揚博,9,1,8,陽信-石牌,2023-10-12,8711
2905,三商,8,0,8,陽信-石牌,2023-10-12,8711
3060,銘異,8,0,8,陽信-石牌,2023-10-12,8711
4552,力達-KY,8,0,8,陽信-石牌,2023-10-12,8711
6112,邁達特,8,0,8,陽信-石牌,2023-10-12,8711
3689,湧德,7,0,7,陽信-石牌,2023-10-12,8711
00922,國泰台灣領袖50,6,0,6,陽信-石牌,2023-10-12,8711
2390,云辰,6,0,6,陽信-石牌,2023-10-12,8711
3050,鈺德,6,0,6,陽信-石牌,2023-10-12,8711
4916,事欣科,8,2,6,陽信-石牌,2023-10-12,8711
5457,宣德,6,0,6,陽信-石牌,2023-10-12,8711
1314,中石化,7,2,5,陽信-石牌,2023-10-12,8711
1815,富喬,35,30,5,陽信-石牌,2023-10-12,8711
2504,國產,5,0,5,陽信-石牌,2023-10-12,8711
3149,正達,5,0,5,陽信-石牌,2023-10-12,8711
3189,景碩,5,0,5,陽信-石牌,2023-10-12,8711
4157,太景*-KY,5,0,5,陽信-石牌,2023-10-12,8711
3260,威剛,1018,6,1012,陽信-石牌,2023-10-13,8711
0056,元大高股息,65,1,64,陽信-石牌,2023-10-13,8711
6244,茂迪,53,0,53,陽信-石牌,2023-10-13,8711
9105,泰金寶-DR,50,0,50,陽信-石牌,2023-10-13,8711
3231,緯創,83,35,48,陽信-石牌,2023-10-13,8711
2303,聯電,52,4,48,陽信-石牌,2023-10-13,8711
00878,國泰永續高股息,46,0,46,陽信-石牌,2023-10-13,8711
00931B,統一美債20年,44,0,44,陽信-石牌,2023-10-13,8711
1605,華新,40,0,40,陽信-石牌,2023-10-13,8711
1314,中石化,43,12,31,陽信-石牌,2023-10-13,8711
2538,基泰,32,1,31,陽信-石牌,2023-10-13,8711
00715L,期街口布蘭特正2,24,1,23,陽信-石牌,2023-10-13,8711
2504,國產,22,0,22,陽信-石牌,2023-10-13,8711
2605,新興,22,0,22,陽信-石牌,2023-10-13,8711
00919,群益台灣精選高息,21,0,21,陽信-石牌,2023-10-13,8711
00857B,永豐20年美公債,20,0,20,陽信-石牌,2023-10-13,8711
00905,FT臺灣Smart,20,0,20,陽信-石牌,2023-10-13,8711
5284,jpp-KY,19,0,19,陽信-石牌,2023-10-13,8711
3037,欣興,33,15,18,陽信-石牌,2023-10-13,8711
2363,矽統,228,211,17,陽信-石牌,2023-10-13,8711
2313,華通,17,1,16,陽信-石牌,2023-10-13,8711
1609,大亞,22,8,14,陽信-石牌,2023-10-13,8711
00712,復華富時不動產,12,0,12,陽信-石牌,2023-10-13,8711
2329,華泰,19,7,12,陽信-石牌,2023-10-13,8711
2356,英業達,16,4,12,陽信-石牌,2023-10-13,8711
6231,系微,16,4,12,陽信-石牌,2023-10-13,8711
6257,矽格,15,3,12,陽信-石牌,2023-10-13,8711
1513,中興電,12,0,12,陽信-石牌,2023-10-13,8711
1319,東陽,16,5,11,陽信-石牌,2023-10-13,8711
2886,兆豐金,10,0,10,陽信-石牌,2023-10-13,8711
2101,南港,10,0,10,陽信-石牌,2023-10-13,8711
2392,正崴,10,0,10,陽信-石牌,2023-10-13,8711
2618,長榮航,11,1,10,陽信-石牌,2023-10-13,8711
3056,富華新,10,0,10,陽信-石牌,2023-10-13,8711
3450,聯鈞,26,16,10,陽信-石牌,2023-10-13,8711
3483,力致,18,8,10,陽信-石牌,2023-10-13,8711
8150,南茂,10,0,10,陽信-石牌,2023-10-13,8711
8464,億豐,10,0,10,陽信-石牌,2023-10-13,8711
9933,中鼎,10,0,10,陽信-石牌,2023-10-13,8711
2390,云辰,9,0,9,陽信-石牌,2023-10-13,8711
5426,振發,9,0,9,陽信-石牌,2023-10-13,8711
00720B,元大投資級公司債,8,0,8,陽信-石牌,2023-10-13,8711
2736,富野,8,0,8,陽信-石牌,2023-10-13,8711
00923,群益台ESG低碳50,7,0,7,陽信-石牌,2023-10-13,8711
1514,亞力,7,0,7,陽信-石牌,2023-10-13,8711
3189,景碩,8,1,7,陽信-石牌,2023-10-13,8711
1444,力麗,6,0,6,陽信-石牌,2023-10-13,8711
1437,勤益控,6,0,6,陽信-石牌,2023-10-13,8711
00932,兆豐永續高息等權,6,0,6,陽信-石牌,2023-10-13,8711
2425,承啟,12,6,6,陽信-石牌,2023-10-13,8711
2344,華邦電,144,4,140,陽信-石牌,2023-10-16,8711
0056,元大高股息,139,0,139,陽信-石牌,2023-10-16,8711
1314,中石化,208,116,92,陽信-石牌,2023-10-16,8711
2363,矽統,176,102,74,陽信-石牌,2023-10-16,8711
8429,金麗-KY,72,0,72,陽信-石牌,2023-10-16,8711
00929,復華台灣科技優息,69,5,64,陽信-石牌,2023-10-16,8711
9105,泰金寶-DR,58,0,58,陽信-石牌,2023-10-16,8711
00919,群益台灣精選高息,50,0,50,陽信-石牌,2023-10-16,8711
2427,三商電,51,2,49,陽信-石牌,2023-10-16,8711
2515,中工,48,10,38,陽信-石牌,2023-10-16,8711
00720B,元大投資級公司債,35,0,35,陽信-石牌,2023-10-16,8711
6120,達運,34,0,34,陽信-石牌,2023-10-16,8711
2605,新興,33,0,33,陽信-石牌,2023-10-16,8711
1309,台達化,30,0,30,陽信-石牌,2023-10-16,8711
6770,力積電,32,3,29,陽信-石牌,2023-10-16,8711
1605,華新,28,1,27,陽信-石牌,2023-10-16,8711
2425,承啟,33,7,26,陽信-石牌,2023-10-16,8711
2369,菱生,25,0,25,陽信-石牌,2023-10-16,8711
2618,長榮航,50,26,24,陽信-石牌,2023-10-16,8711
00712,復華富時不動產,23,0,23,陽信-石牌,2023-10-16,8711
00669R,國泰美國道瓊反1,22,0,22,陽信-石牌,2023-10-16,8711
1802,台玻,21,0,21,陽信-石牌,2023-10-16,8711
00637L,元大滬深300正2,20,0,20,陽信-石牌,2023-10-16,8711
2610,華航,19,2,17,陽信-石牌,2023-10-16,8711
2338,光罩,17,1,16,陽信-石牌,2023-10-16,8711
6285,啟��,16,0,16,陽信-石牌,2023-10-16,8711
2312,金寶,15,0,15,陽信-石牌,2023-10-16,8711
3217,優群,15,0,15,陽信-石牌,2023-10-16,8711
2002,中鋼,13,0,13,陽信-石牌,2023-10-16,8711
1612,宏泰,12,0,12,陽信-石牌,2023-10-16,8711
1815,富喬,12,0,12,陽信-石牌,2023-10-16,8711
3043,科風,13,1,12,陽信-石牌,2023-10-16,8711
3083,網龍,12,0,12,陽信-石牌,2023-10-16,8711
6235,華孚,12,0,12,陽信-石牌,2023-10-16,8711
6806,森崴能源,12,0,12,陽信-石牌,2023-10-16,8711
2371,大同,12,1,11,陽信-石牌,2023-10-16,8711
3051,力特,12,1,11,陽信-石牌,2023-10-16,8711
4744,皇將,11,0,11,陽信-石牌,2023-10-16,8711
5426,振發,11,0,11,陽信-石牌,2023-10-16,8711
00656R,國泰中國A50反1,10,0,10,陽信-石牌,2023-10-16,8711
00632R,元大台灣50反1,20,10,10,陽信-石牌,2023-10-16,8711
2014,中鴻,10,0,10,陽信-石牌,2023-10-16,8711
2426,鼎元,10,0,10,陽信-石牌,2023-10-16,8711
2748,雲品,10,0,10,陽信-石牌,2023-10-16,8711
5425,台半,10,0,10,陽信-石牌,2023-10-16,8711
6593,台灣銘板,10,0,10,陽信-石牌,2023-10-16,8711
8467,波力-KY,10,0,10,陽信-石牌,2023-10-16,8711
2913,農林,13,4,9,陽信-石牌,2023-10-16,8711
3706,神達,26,17,9,陽信-石牌,2023-10-16,8711
8996,高力,10,1,9,陽信-石牌,2023-10-16,8711
3481,群創,200,28,172,陽信-石牌,2023-10-17,8711
9105,泰金寶-DR,78,0,78,陽信-石牌,2023-10-17,8711
0056,元大高股息,77,0,77,陽信-石牌,2023-10-17,8711
2363,矽統,161,95,66,陽信-石牌,2023-10-17,8711
2618,長榮航,109,48,61,陽信-石牌,2023-10-17,8711
2542,興富發,60,0,60,陽信-石牌,2023-10-17,8711
2233,宇隆,57,4,53,陽信-石牌,2023-10-17,8711
1605,華新,51,1,50,陽信-石牌,2023-10-17,8711
6451,訊芯-KY,53,3,50,陽信-石牌,2023-10-17,8711
3231,緯創,104,54,50,陽信-石牌,2023-10-17,8711
00929,復華台灣科技優息,43,2,41,陽信-石牌,2023-10-17,8711
6510,精測,38,0,38,陽信-石牌,2023-10-17,8711
1524,耿鼎,36,0,36,陽信-石牌,2023-10-17,8711
2313,華通,42,12,30,陽信-石牌,2023-10-17,8711
00751B,元大AAA至A公司債,26,0,26,陽信-石牌,2023-10-17,8711
2637,慧洋-KY,26,0,26,陽信-石牌,2023-10-17,8711
2312,金寶,25,0,25,陽信-石牌,2023-10-17,8711
00857B,永豐20年美公債,24,0,24,陽信-石牌,2023-10-17,8711
6770,力積電,32,11,21,陽信-石牌,2023-10-17,8711
6806,森崴能源,20,0,20,陽信-石牌,2023-10-17,8711
8011,台通,20,0,20,陽信-石牌,2023-10-17,8711
3715,定穎投控,48,29,19,陽信-石牌,2023-10-17,8711
00878,國泰永續高股息,30,12,18,陽信-石牌,2023-10-17,8711
00931B,統一美債20年,17,0,17,陽信-石牌,2023-10-17,8711
00687B,國泰20年美債,16,0,16,陽信-石牌,2023-10-17,8711
3078,僑威,53,37,16,陽信-石牌,2023-10-17,8711
2458,義隆,15,0,15,陽信-石牌,2023-10-17,8711
1785,光洋科,16,1,15,陽信-石牌,2023-10-17,8711
3583,辛耘,15,0,15,陽信-石牌,2023-10-17,8711
00922,國泰台灣領袖50,14,0,14,陽信-石牌,2023-10-17,8711
00720B,元大投資級公司債,14,0,14,陽信-石牌,2023-10-17,8711
1905,華紙,21,7,14,陽信-石牌,2023-10-17,8711
4908,前鼎,39,25,14,陽信-石牌,2023-10-17,8711
00665L,富邦�琤肭磪囓�2,24,10,14,陽信-石牌,2023-10-17,8711
3035,智原,36,23,13,陽信-石牌,2023-10-17,8711
5469,瀚宇博,12,0,12,陽信-石牌,2023-10-17,8711
6515,穎崴,11,0,11,陽信-石牌,2023-10-17,8711
00642U,期元大S＆P石油,10,0,10,陽信-石牌,2023-10-17,8711
00637L,元大滬深300正2,10,0,10,陽信-石牌,2023-10-17,8711
1514,亞力,20,10,10,陽信-石牌,2023-10-17,8711
1532,勤美,10,0,10,陽信-石牌,2023-10-17,8711
2540,愛山林,10,0,10,陽信-石牌,2023-10-17,8711
2605,新興,20,10,10,陽信-石牌,2023-10-17,8711
2883,凱基金,10,0,10,陽信-石牌,2023-10-17,8711
5880,合庫金,10,0,10,陽信-石牌,2023-10-17,8711
6016,康和證,10,0,10,陽信-石牌,2023-10-17,8711
2301,光寶科,33,24,9,陽信-石牌,2023-10-17,8711
3006,晶豪科,9,0,9,陽信-石牌,2023-10-17,8711
3051,力特,17,8,9,陽信-石牌,2023-10-17,8711
3094,聯傑,11,2,9,陽信-石牌,2023-10-17,8711
2883,凱基金,201,0,201,陽信-石牌,2023-10-18,8711
00878,國泰永續高股息,136,0,136,陽信-石牌,2023-10-18,8711
00931B,統一美債20年,124,0,124,陽信-石牌,2023-10-18,8711
0056,元大高股息,93,0,93,陽信-石牌,2023-10-18,8711
1471,首利,93,9,84,陽信-石牌,2023-10-18,8711
00922,國泰台灣領袖50,76,0,76,陽信-石牌,2023-10-18,8711
00929,復華台灣科技優息,68,1,67,陽信-石牌,2023-10-18,8711
1609,大亞,62,0,62,陽信-石牌,2023-10-18,8711
2498,宏達電,62,0,62,陽信-石牌,2023-10-18,8711
1102,亞泥,61,0,61,陽信-石牌,2023-10-18,8711
2504,國產,54,0,54,陽信-石牌,2023-10-18,8711
2618,長榮航,46,9,37,陽信-石牌,2023-10-18,8711
00919,群益台灣精選高息,36,0,36,陽信-石牌,2023-10-18,8711
2201,裕隆,64,31,33,陽信-石牌,2023-10-18,8711
3706,神達,33,0,33,陽信-石牌,2023-10-18,8711
00932,兆豐永續高息等權,29,0,29,陽信-石牌,2023-10-18,8711
2312,金寶,26,0,26,陽信-石牌,2023-10-18,8711
00715L,期街口布蘭特正2,25,0,25,陽信-石牌,2023-10-18,8711
1802,台玻,30,5,25,陽信-石牌,2023-10-18,8711
1905,華紙,38,15,23,陽信-石牌,2023-10-18,8711
2344,華邦電,25,4,21,陽信-石牌,2023-10-18,8711
2014,中鴻,20,0,20,陽信-石牌,2023-10-18,8711
3518,柏騰,20,0,20,陽信-石牌,2023-10-18,8711
3576,聯合再生,22,2,20,陽信-石牌,2023-10-18,8711
8011,台通,20,0,20,陽信-石牌,2023-10-18,8711
00687B,國泰20年美債,19,0,19,陽信-石牌,2023-10-18,8711
1584,精剛,25,8,17,陽信-石牌,2023-10-18,8711
00679B,元大美債20年,16,0,16,陽信-石牌,2023-10-18,8711
00720B,元大投資級公司債,16,0,16,陽信-石牌,2023-10-18,8711
1598,岱宇,15,0,15,陽信-石牌,2023-10-18,8711
8046,南電,18,4,14,陽信-石牌,2023-10-18,8711
2388,威盛,35,21,14,陽信-石牌,2023-10-18,8711
2330,台積電,13,0,13,陽信-石牌,2023-10-18,8711
6168,宏齊,49,36,13,陽信-石牌,2023-10-18,8711
00857B,永豐20年美公債,12,0,12,陽信-石牌,2023-10-18,8711
00905,FT臺灣Smart,12,0,12,陽信-石牌,2023-10-18,8711
2401,凌陽,14,2,12,陽信-石牌,2023-10-18,8711
4960,誠美材,12,0,12,陽信-石牌,2023-10-18,8711
2634,漢翔,12,2,10,陽信-石牌,2023-10-18,8711
2867,三商壽,10,0,10,陽信-石牌,2023-10-18,8711
1409,新纖,10,0,10,陽信-石牌,2023-10-18,8711
00701,國泰股利精選30,10,0,10,陽信-石牌,2023-10-18,8711
00719B,元大美債1-3,10,0,10,陽信-石牌,2023-10-18,8711
6015,宏遠證,10,0,10,陽信-石牌,2023-10-18,8711
6213,聯茂,10,0,10,陽信-石牌,2023-10-18,8711
6743,安普新,10,0,10,陽信-石牌,2023-10-18,8711
9933,中鼎,10,0,10,陽信-石牌,2023-10-18,8711
6285,啟��,19,9,10,陽信-石牌,2023-10-18,8711
1101,台泥,14,5,9,陽信-石牌,2023-10-18,8711
2913,農林,9,0,9,陽信-石牌,2023-10-18,8711
00632R,元大台灣50反1,582,0,582,陽信-石牌,2023-10-19,8711
00671R,富邦NASDAQ反1,280,0,280,陽信-石牌,2023-10-19,8711
00637L,元大滬深300正2,240,0,240,陽信-石牌,2023-10-19,8711
0056,元大高股息,116,2,114,陽信-石牌,2023-10-19,8711
2504,國產,105,0,105,陽信-石牌,2023-10-19,8711
3481,群創,105,0,105,陽信-石牌,2023-10-19,8711
00885,富邦越南,100,0,100,陽信-石牌,2023-10-19,8711
6244,茂迪,90,0,90,陽信-石牌,2023-10-19,8711
00878,國泰永續高股息,78,13,65,陽信-石牌,2023-10-19,8711
2486,一詮,53,0,53,陽信-石牌,2023-10-19,8711
00857B,永豐20年美公債,44,0,44,陽信-石牌,2023-10-19,8711
2233,宇隆,58,14,44,陽信-石牌,2023-10-19,8711
00933B,國泰10Y+金融債,37,0,37,陽信-石牌,2023-10-19,8711
3231,緯創,80,45,35,陽信-石牌,2023-10-19,8711
1101,台泥,34,0,34,陽信-石牌,2023-10-19,8711
3044,健鼎,30,0,30,陽信-石牌,2023-10-19,8711
4128,中天,30,0,30,陽信-石牌,2023-10-19,8711
00929,復華台灣科技優息,30,2,28,陽信-石牌,2023-10-19,8711
8064,東捷,28,0,28,陽信-石牌,2023-10-19,8711
2201,裕隆,27,4,23,陽信-石牌,2023-10-19,8711
1609,大亞,21,0,21,陽信-石牌,2023-10-19,8711
00680L,元大美債20正2,20,0,20,陽信-石牌,2023-10-19,8711
00665L,富邦�琤肭磪囓�2,32,15,17,陽信-石牌,2023-10-19,8711
00687B,國泰20年美債,17,1,16,陽信-石牌,2023-10-19,8711
2323,中環,16,0,16,陽信-石牌,2023-10-19,8711
00633L,富邦上証正2,15,0,15,陽信-石牌,2023-10-19,8711
5608,四維航,15,0,15,陽信-石牌,2023-10-19,8711
6691,洋基工程,15,1,14,陽信-石牌,2023-10-19,8711
8046,南電,13,0,13,陽信-石牌,2023-10-19,8711
9955,佳龍,13,0,13,陽信-石牌,2023-10-19,8711
1618,合機,12,0,12,陽信-石牌,2023-10-19,8711
2002,中鋼,17,5,12,陽信-石牌,2023-10-19,8711
2356,英業達,19,7,12,陽信-石牌,2023-10-19,8711
2388,威盛,17,6,11,陽信-石牌,2023-10-19,8711
1789,神隆,11,0,11,陽信-石牌,2023-10-19,8711
3548,兆利,11,0,11,陽信-石牌,2023-10-19,8711
8210,勤誠,12,1,11,陽信-石牌,2023-10-19,8711
2317,鴻海,11,1,10,陽信-石牌,2023-10-19,8711
00751B,元大AAA至A公司債,10,0,10,陽信-石牌,2023-10-19,8711
00915,凱基優選高股息30,10,0,10,陽信-石牌,2023-10-19,8711
1460,宏遠,10,0,10,陽信-石牌,2023-10-19,8711
2520,冠德,10,0,10,陽信-石牌,2023-10-19,8711
2743,山富,10,0,10,陽信-石牌,2023-10-19,8711
2885,元大金,10,0,10,陽信-石牌,2023-10-19,8711
3508,位速,10,0,10,陽信-石牌,2023-10-19,8711
8464,億豐,10,0,10,陽信-石牌,2023-10-19,8711
9105,泰金寶-DR,10,0,10,陽信-石牌,2023-10-19,8711
00922,國泰台灣領袖50,10,0,10,陽信-石牌,2023-10-19,8711
00720B,元大投資級公司債,9,0,9,陽信-石牌,2023-10-19,8711
1905,華紙,21,12,9,陽信-石牌,2023-10-19,8711
2883,凱基金,243,0,243,陽信-石牌,2023-10-20,8711
00669R,國泰美國道瓊反1,145,5,140,陽信-石牌,2023-10-20,8711
00637L,元大滬深300正2,133,3,130,陽信-石牌,2023-10-20,8711
00885,富邦越南,107,0,107,陽信-石牌,2023-10-20,8711
00712,復華富時不動產,93,0,93,陽信-石牌,2023-10-20,8711
00878,國泰永續高股息,82,5,77,陽信-石牌,2023-10-20,8711
1605,華新,71,0,71,陽信-石牌,2023-10-20,8711
00929,復華台灣科技優息,64,4,60,陽信-石牌,2023-10-20,8711
3041,揚智,54,3,51,陽信-石牌,2023-10-20,8711
1905,華紙,43,9,34,陽信-石牌,2023-10-20,8711
2886,兆豐金,32,0,32,陽信-石牌,2023-10-20,8711
00857B,永豐20年美公債,32,0,32,陽信-石牌,2023-10-20,8711
00722B,群益投資級電信債,28,0,28,陽信-石牌,2023-10-20,8711
00679B,元大美債20年,26,0,26,陽信-石牌,2023-10-20,8711
2002,中鋼,29,6,23,陽信-石牌,2023-10-20,8711
00919,群益台灣精選高息,21,0,21,陽信-石牌,2023-10-20,8711
6274,台燿,28,7,21,陽信-石牌,2023-10-20,8711
8011,台通,20,0,20,陽信-石牌,2023-10-20,8711
1213,大飲,19,0,19,陽信-石牌,2023-10-20,8711
2332,友訊,20,1,19,陽信-石牌,2023-10-20,8711
8049,晶采,20,2,18,陽信-石牌,2023-10-20,8711
2637,慧洋-KY,17,0,17,陽信-石牌,2023-10-20,8711
2888,新光金,17,0,17,陽信-石牌,2023-10-20,8711
00687B,國泰20年美債,23,7,16,陽信-石牌,2023-10-20,8711
1101,台泥,19,3,16,陽信-石牌,2023-10-20,8711
00931B,統一美債20年,15,0,15,陽信-石牌,2023-10-20,8711
00715L,期街口布蘭特正2,33,19,14,陽信-石牌,2023-10-20,8711
1598,岱宇,14,0,14,陽信-石牌,2023-10-20,8711
6770,力積電,18,4,14,陽信-石牌,2023-10-20,8711
1514,亞力,13,0,13,陽信-石牌,2023-10-20,8711
8068,全達,16,3,13,陽信-石牌,2023-10-20,8711
00680L,元大美債20正2,12,0,12,陽信-石牌,2023-10-20,8711
1524,耿鼎,18,6,12,陽信-石牌,2023-10-20,8711
1903,士紙,12,0,12,陽信-石牌,2023-10-20,8711
2382,廣達,33,21,12,陽信-石牌,2023-10-20,8711
2313,華通,12,1,11,陽信-石牌,2023-10-20,8711
2201,裕隆,14,3,11,陽信-石牌,2023-10-20,8711
2633,台灣高鐵,11,0,11,陽信-石牌,2023-10-20,8711
4128,中天,11,0,11,陽信-石牌,2023-10-20,8711
1609,大亞,11,0,11,陽信-石牌,2023-10-20,8711
2882,國泰金,11,1,10,陽信-石牌,2023-10-20,8711
2885,元大金,10,0,10,陽信-石牌,2023-10-20,8711
3710,連展投控,10,0,10,陽信-石牌,2023-10-20,8711
6015,宏遠證,10,0,10,陽信-石牌,2023-10-20,8711
9950,萬國通,10,0,10,陽信-石牌,2023-10-20,8711
2331,精英,9,0,9,陽信-石牌,2023-10-20,8711
2486,一詮,9,0,9,陽信-石牌,2023-10-20,8711
00922,國泰台灣領袖50,8,0,8,陽信-石牌,2023-10-20,8711
1504,東元,8,0,8,陽信-石牌,2023-10-20,8711
1712,興農,8,0,8,陽信-石牌,2023-10-20,8711
5355,佳總,1002,0,1002,陽信-石牌,2023-10-23,8711
00857B,永豐20年美公債,103,0,103,陽信-石牌,2023-10-23,8711
00929,復華台灣科技優息,86,2,84,陽信-石牌,2023-10-23,8711
00712,復華富時不動產,79,0,79,陽信-石牌,2023-10-23,8711
00673R,期元大S＆P原油反1,50,15,35,陽信-石牌,2023-10-23,8711
0056,元大高股息,40,6,34,陽信-石牌,2023-10-23,8711
2605,新興,32,0,32,陽信-石牌,2023-10-23,8711
00878,國泰永續高股息,30,0,30,陽信-石牌,2023-10-23,8711
00919,群益台灣精選高息,28,0,28,陽信-石牌,2023-10-23,8711
2402,毅嘉,40,16,24,陽信-石牌,2023-10-23,8711
2891,中信金,23,0,23,陽信-石牌,2023-10-23,8711
2892,第一金,22,0,22,陽信-石牌,2023-10-23,8711
2317,鴻海,23,1,22,陽信-石牌,2023-10-23,8711
1219,福壽,20,0,20,陽信-石牌,2023-10-23,8711
2897,王道銀行,20,0,20,陽信-石牌,2023-10-23,8711
2201,裕隆,19,1,18,陽信-石牌,2023-10-23,8711
2233,宇隆,56,40,16,陽信-石牌,2023-10-23,8711
00923,群益台ESG低碳50,15,0,15,陽信-石牌,2023-10-23,8711
2883,凱基金,15,0,15,陽信-石牌,2023-10-23,8711
2886,兆豐金,14,0,14,陽信-石牌,2023-10-23,8711
2002,中鋼,13,0,13,陽信-石牌,2023-10-23,8711
2882,國泰金,13,0,13,陽信-石牌,2023-10-23,8711
1727,中華化,12,0,12,陽信-石牌,2023-10-23,8711
1815,富喬,14,2,12,陽信-石牌,2023-10-23,8711
3443,創意,20,8,12,陽信-石牌,2023-10-23,8711
4958,臻鼎-KY,12,0,12,陽信-石牌,2023-10-23,8711
5880,合庫金,11,0,11,陽信-石牌,2023-10-23,8711
2303,聯電,14,4,10,陽信-石牌,2023-10-23,8711
00701,國泰股利精選30,10,0,10,陽信-石牌,2023-10-23,8711
00877,復華中國5G,10,0,10,陽信-石牌,2023-10-23,8711
2542,興富發,10,0,10,陽信-石牌,2023-10-23,8711
2637,慧洋-KY,10,0,10,陽信-石牌,2023-10-23,8711
2834,臺企銀,10,0,10,陽信-石牌,2023-10-23,8711
2888,新光金,10,0,10,陽信-石牌,2023-10-23,8711
3588,通嘉,10,0,10,陽信-石牌,2023-10-23,8711
6147,頎邦,10,1,9,陽信-石牌,2023-10-23,8711
6168,宏齊,10,1,9,陽信-石牌,2023-10-23,8711
6244,茂迪,9,0,9,陽信-石牌,2023-10-23,8711
4714,永捷,15,7,8,陽信-石牌,2023-10-23,8711
6526,達發,8,0,8,陽信-石牌,2023-10-23,8711
1598,岱宇,7,0,7,陽信-石牌,2023-10-23,8711
2409,友達,6,0,6,陽信-石牌,2023-10-23,8711
2633,台灣高鐵,6,0,6,陽信-石牌,2023-10-23,8711
3686,達能,6,0,6,陽信-石牌,2023-10-23,8711
6122,擎邦,7,1,6,陽信-石牌,2023-10-23,8711
6233,旺玖,6,0,6,陽信-石牌,2023-10-23,8711
8110,華東,6,0,6,陽信-石牌,2023-10-23,8711
3325,旭品,15,10,5,陽信-石牌,2023-10-23,8711
00900,富邦特選高股息30,5,0,5,陽信-石牌,2023-10-23,8711
00896,中信綠能及電動車,5,0,5,陽信-石牌,2023-10-23,8711
3481,群創,216,0,216,陽信-石牌,2023-10-24,8711
1802,台玻,100,0,100,陽信-石牌,2023-10-24,8711
9105,泰金寶-DR,100,0,100,陽信-石牌,2023-10-24,8711
00637L,元大滬深300正2,90,0,90,陽信-石牌,2023-10-24,8711
00712,復華富時不動產,75,0,75,陽信-石牌,2023-10-24,8711
00715L,期街口布蘭特正2,65,0,65,陽信-石牌,2023-10-24,8711
2303,聯電,61,15,46,陽信-石牌,2023-10-24,8711
2637,慧洋-KY,38,0,38,陽信-石牌,2023-10-24,8711
2743,山富,37,4,33,陽信-石牌,2023-10-24,8711
00665L,富邦�琤肭磪囓�2,57,25,32,陽信-石牌,2023-10-24,8711
3149,正達,32,0,32,陽信-石牌,2023-10-24,8711
2317,鴻海,59,27,32,陽信-石牌,2023-10-24,8711
2369,菱生,66,36,30,陽信-石牌,2023-10-24,8711
2891,中信金,30,0,30,陽信-石牌,2023-10-24,8711
2883,凱基金,32,3,29,陽信-石牌,2023-10-24,8711
1815,富喬,25,0,25,陽信-石牌,2023-10-24,8711
5880,合庫金,21,0,21,陽信-石牌,2023-10-24,8711
4128,中天,20,0,20,陽信-石牌,2023-10-24,8711
4960,誠美材,19,0,19,陽信-石牌,2023-10-24,8711
00919,群益台灣精選高息,17,0,17,陽信-石牌,2023-10-24,8711
3363,上詮,30,14,16,陽信-石牌,2023-10-24,8711
3231,緯創,77,64,13,陽信-石牌,2023-10-24,8711
1101,台泥,13,0,13,陽信-石牌,2023-10-24,8711
1314,中石化,12,0,12,陽信-石牌,2023-10-24,8711
2834,臺企銀,12,0,12,陽信-石牌,2023-10-24,8711
2889,國票金,12,0,12,陽信-石牌,2023-10-24,8711
3055,蔚華科,12,0,12,陽信-石牌,2023-10-24,8711
2388,威盛,15,4,11,陽信-石牌,2023-10-24,8711
1219,福壽,10,0,10,陽信-石牌,2023-10-24,8711
1723,中碳,10,0,10,陽信-石牌,2023-10-24,8711
2316,楠梓電,11,1,10,陽信-石牌,2023-10-24,8711
2323,中環,10,0,10,陽信-石牌,2023-10-24,8711
2897,王道銀行,10,0,10,陽信-石牌,2023-10-24,8711
4503,金雨,10,0,10,陽信-石牌,2023-10-24,8711
6257,矽格,10,0,10,陽信-石牌,2023-10-24,8711
6282,康舒,10,0,10,陽信-石牌,2023-10-24,8711
3265,台星科,11,2,9,陽信-石牌,2023-10-24,8711
6770,力積電,10,1,9,陽信-石牌,2023-10-24,8711
3715,定穎投控,89,80,9,陽信-石牌,2023-10-24,8711
2330,台積電,8,0,8,陽信-石牌,2023-10-24,8711
1301,台塑,8,0,8,陽信-石牌,2023-10-24,8711
6443,元晶,19,11,8,陽信-石牌,2023-10-24,8711
1598,岱宇,7,0,7,陽信-石牌,2023-10-24,8711
1605,華新,7,0,7,陽信-石牌,2023-10-24,8711
6150,撼訊,15,8,7,陽信-石牌,2023-10-24,8711
3037,欣興,17,11,6,陽信-石牌,2023-10-24,8711
5386,青雲,9,3,6,陽信-石牌,2023-10-24,8711
6442,光聖,16,10,6,陽信-石牌,2023-10-24,8711
2308,台達電,5,0,5,陽信-石牌,2023-10-24,8711
00922,國泰台灣領袖50,5,0,5,陽信-石牌,2023-10-24,8711
00673R,期元大S＆P原油反1,100,1,99,陽信-石牌,2023-10-25,8711
3481,群創,60,0,60,陽信-石牌,2023-10-25,8711
2882,國泰金,46,0,46,陽信-石牌,2023-10-25,8711
1314,中石化,50,10,40,陽信-石牌,2023-10-25,8711
6117,迎廣,44,8,36,陽信-石牌,2023-10-25,8711
2317,鴻海,38,9,29,陽信-石牌,2023-10-25,8711
1524,耿鼎,68,42,26,陽信-石牌,2023-10-25,8711
00712,復華富時不動產,28,5,23,陽信-石牌,2023-10-25,8711
2337,旺宏,26,6,20,陽信-石牌,2023-10-25,8711
6451,訊芯-KY,25,5,20,陽信-石牌,2023-10-25,8711
00671R,富邦NASDAQ反1,20,1,19,陽信-石牌,2023-10-25,8711
2618,長榮航,27,8,19,陽信-石牌,2023-10-25,8711
8110,華東,30,11,19,陽信-石牌,2023-10-25,8711
2883,凱基金,25,7,18,陽信-石牌,2023-10-25,8711
6282,康舒,18,2,16,陽信-石牌,2023-10-25,8711
2498,宏達電,15,0,15,陽信-石牌,2023-10-25,8711
3041,揚智,26,11,15,陽信-石牌,2023-10-25,8711
3017,奇鋐,14,1,13,陽信-石牌,2023-10-25,8711
2458,義隆,15,2,13,陽信-石牌,2023-10-25,8711
8068,全達,43,31,12,陽信-石牌,2023-10-25,8711
2301,光寶科,12,1,11,陽信-石牌,2023-10-25,8711
3025,星通,13,2,11,陽信-石牌,2023-10-25,8711
3265,台星科,13,2,11,陽信-石牌,2023-10-25,8711
3576,聯合再生,11,1,10,陽信-石牌,2023-10-25,8711
5371,中光電,10,0,10,陽信-石牌,2023-10-25,8711
6143,振曜,10,0,10,陽信-石牌,2023-10-25,8711
6182,合晶,10,0,10,陽信-石牌,2023-10-25,8711
8935,邦泰,10,0,10,陽信-石牌,2023-10-25,8711
1785,光洋科,9,0,9,陽信-石牌,2023-10-25,8711
2105,正新,10,1,9,陽信-石牌,2023-10-25,8711
3231,緯創,42,33,9,陽信-石牌,2023-10-25,8711
2399,映泰,25,17,8,陽信-石牌,2023-10-25,8711
2515,中工,19,11,8,陽信-石牌,2023-10-25,8711
2886,兆豐金,8,0,8,陽信-石牌,2023-10-25,8711
2892,第一金,7,0,7,陽信-石牌,2023-10-25,8711
3051,力特,20,13,7,陽信-石牌,2023-10-25,8711
2637,慧洋-KY,15,8,7,陽信-石牌,2023-10-25,8711
00929,復華台灣科技優息,6,0,6,陽信-石牌,2023-10-25,8711
00878,國泰永續高股息,7,1,6,陽信-石牌,2023-10-25,8711
1216,統一,6,0,6,陽信-石牌,2023-10-25,8711
2022,聚亨,6,0,6,陽信-石牌,2023-10-25,8711
2383,台光電,6,0,6,陽信-石牌,2023-10-25,8711
2610,華航,6,0,6,陽信-石牌,2023-10-25,8711
4960,誠美材,10,4,6,陽信-石牌,2023-10-25,8711
6244,茂迪,6,0,6,陽信-石牌,2023-10-25,8711
5269,祥碩,7,1,6,陽信-石牌,2023-10-25,8711
2367,燿華,5,0,5,陽信-石牌,2023-10-25,8711
2380,虹光,5,0,5,陽信-石牌,2023-10-25,8711
2408,南亞科,5,0,5,陽信-石牌,2023-10-25,8711
2606,裕民,5,0,5,陽信-石牌,2023-10-25,8711
2303,聯電,250,17,233,陽信-石牌,2023-10-26,8711
00885,富邦越南,103,0,103,陽信-石牌,2023-10-26,8711
2883,凱基金,69,10,59,陽信-石牌,2023-10-26,8711
2610,華航,66,11,55,陽信-石牌,2023-10-26,8711
00929,復華台灣科技優息,83,30,53,陽信-石牌,2023-10-26,8711
00676R,富邦臺灣加權反1,40,0,40,陽信-石牌,2023-10-26,8711
2014,中鴻,40,0,40,陽信-石牌,2023-10-26,8711
6139,亞翔,62,25,37,陽信-石牌,2023-10-26,8711
00687B,國泰20年美債,32,0,32,陽信-石牌,2023-10-26,8711
2637,慧洋-KY,32,0,32,陽信-石牌,2023-10-26,8711
00878,國泰永續高股息,41,10,31,陽信-石牌,2023-10-26,8711
2401,凌陽,34,3,31,陽信-石牌,2023-10-26,8711
2897,王道銀行,30,0,30,陽信-石牌,2023-10-26,8711
9105,泰金寶-DR,25,0,25,陽信-石牌,2023-10-26,8711
2317,鴻海,26,2,24,陽信-石牌,2023-10-26,8711
6122,擎邦,24,2,22,陽信-石牌,2023-10-26,8711
00919,群益台灣精選高息,21,0,21,陽信-石牌,2023-10-26,8711
00696B,富邦美債20年,20,0,20,陽信-石牌,2023-10-26,8711
3058,立德,20,0,20,陽信-石牌,2023-10-26,8711
00931B,統一美債20年,19,0,19,陽信-石牌,2023-10-26,8711
00922,國泰台灣領袖50,19,0,19,陽信-石牌,2023-10-26,8711
2330,台積電,16,0,16,陽信-石牌,2023-10-26,8711
3615,安可,15,0,15,陽信-石牌,2023-10-26,8711
3037,欣興,25,11,14,陽信-石牌,2023-10-26,8711
00669R,國泰美國道瓊反1,20,6,14,陽信-石牌,2023-10-26,8711
2486,一詮,25,12,13,陽信-石牌,2023-10-26,8711
00907,永豐優息存股,12,0,12,陽信-石牌,2023-10-26,8711
2344,華邦電,14,2,12,陽信-石牌,2023-10-26,8711
6462,神盾,12,0,12,陽信-石牌,2023-10-26,8711
1721,三晃,19,8,11,陽信-石牌,2023-10-26,8711
2882,國泰金,11,0,11,陽信-石牌,2023-10-26,8711
00924,復華S＆P500成長,10,0,10,陽信-石牌,2023-10-26,8711
00930,永豐ESG低碳高息,10,0,10,陽信-石牌,2023-10-26,8711
1203,味王,10,0,10,陽信-石牌,2023-10-26,8711
1409,新纖,10,0,10,陽信-石牌,2023-10-26,8711
2485,兆赫,14,4,10,陽信-石牌,2023-10-26,8711
2888,新光金,10,0,10,陽信-石牌,2023-10-26,8711
3450,聯鈞,10,0,10,陽信-石牌,2023-10-26,8711
3520,華盈,20,10,10,陽信-石牌,2023-10-26,8711
4726,永昕,10,0,10,陽信-石牌,2023-10-26,8711
8107,大億金茂,10,0,10,陽信-石牌,2023-10-26,8711
1514,亞力,11,2,9,陽信-石牌,2023-10-26,8711
3325,旭品,12,3,9,陽信-石牌,2023-10-26,8711
1598,岱宇,8,0,8,陽信-石牌,2023-10-26,8711
1789,神隆,8,0,8,陽信-石牌,2023-10-26,8711
2439,美律,8,0,8,陽信-石牌,2023-10-26,8711
6451,訊芯-KY,12,4,8,陽信-石牌,2023-10-26,8711
00680L,元大美債20正2,7,0,7,陽信-石牌,2023-10-26,8711
1101,台泥,12,5,7,陽信-石牌,2023-10-26,8711
3227,原相,7,0,7,陽信-石牌,2023-10-26,8711
00929,復華台灣科技優息,95,0,95,陽信-石牌,2023-10-27,8711
5009,榮剛,104,13,91,陽信-石牌,2023-10-27,8711
00885,富邦越南,70,0,70,陽信-石牌,2023-10-27,8711
1789,神隆,38,0,38,陽信-石牌,2023-10-27,8711
00632R,元大台灣50反1,35,0,35,陽信-石牌,2023-10-27,8711
1203,味王,33,0,33,陽信-石牌,2023-10-27,8711
2883,凱基金,33,0,33,陽信-石牌,2023-10-27,8711
2317,鴻海,33,4,29,陽信-石牌,2023-10-27,8711
3149,正達,24,0,24,陽信-石牌,2023-10-27,8711
5351,鈺創,24,0,24,陽信-石牌,2023-10-27,8711
2515,中工,23,0,23,陽信-石牌,2023-10-27,8711
4908,前鼎,56,33,23,陽信-石牌,2023-10-27,8711
4128,中天,28,5,23,陽信-石牌,2023-10-27,8711
00634R,富邦上証反1,20,0,20,陽信-石牌,2023-10-27,8711
2888,新光金,20,0,20,陽信-石牌,2023-10-27,8711
3325,旭品,20,3,17,陽信-石牌,2023-10-27,8711
4960,誠美材,24,7,17,陽信-石牌,2023-10-27,8711
2329,華泰,19,3,16,陽信-石牌,2023-10-27,8711
2408,南亞科,16,0,16,陽信-石牌,2023-10-27,8711
3548,兆利,19,5,14,陽信-石牌,2023-10-27,8711
3051,力特,22,8,14,陽信-石牌,2023-10-27,8711
00919,群益台灣精選高息,14,0,14,陽信-石牌,2023-10-27,8711
6541,泰福-KY,15,2,13,陽信-石牌,2023-10-27,8711
2382,廣達,32,21,11,陽信-石牌,2023-10-27,8711
5225,東科-KY,11,0,11,陽信-石牌,2023-10-27,8711
6282,康舒,12,1,11,陽信-石牌,2023-10-27,8711
00676R,富邦臺灣加權反1,10,0,10,陽信-石牌,2023-10-27,8711
2337,旺宏,11,1,10,陽信-石牌,2023-10-27,8711
2369,菱生,15,5,10,陽信-石牌,2023-10-27,8711
2530,華建,10,0,10,陽信-石牌,2023-10-27,8711
2313,華通,10,2,8,陽信-石牌,2023-10-27,8711
3105,穩懋,9,1,8,陽信-石牌,2023-10-27,8711
2538,基泰,14,7,7,陽信-石牌,2023-10-27,8711
1760,寶齡富錦,7,1,6,陽信-石牌,2023-10-27,8711
2425,承啟,6,0,6,陽信-石牌,2023-10-27,8711
6139,亞翔,7,1,6,陽信-石牌,2023-10-27,8711
6442,光聖,18,12,6,陽信-石牌,2023-10-27,8711
9950,萬國通,8,2,6,陽信-石牌,2023-10-27,8711
2409,友達,6,1,5,陽信-石牌,2023-10-27,8711
00900,富邦特選高股息30,5,0,5,陽信-石牌,2023-10-27,8711
00679B,元大美債20年,5,0,5,陽信-石牌,2023-10-27,8711
1515,力山,5,0,5,陽信-石牌,2023-10-27,8711
2324,仁寶,6,1,5,陽信-石牌,2023-10-27,8711
2458,義隆,5,0,5,陽信-石牌,2023-10-27,8711
2816,旺旺保,6,1,5,陽信-石牌,2023-10-27,8711
3037,欣興,11,6,5,陽信-石牌,2023-10-27,8711
3437,榮創,5,0,5,陽信-石牌,2023-10-27,8711
3520,華盈,5,0,5,陽信-石牌,2023-10-27,8711
4414,如興,5,0,5,陽信-石牌,2023-10-27,8711
4714,永捷,5,0,5,陽信-石牌,2023-10-27,8711
00637L,元大滬深300正2,73,0,73,陽信-石牌,2023-10-30,8711
1324,地球,70,10,60,陽信-石牌,2023-10-30,8711
00878,國泰永續高股息,61,2,59,陽信-石牌,2023-10-30,8711
2637,慧洋-KY,45,0,45,陽信-石牌,2023-10-30,8711
9105,泰金寶-DR,46,3,43,陽信-石牌,2023-10-30,8711
00885,富邦越南,30,0,30,陽信-石牌,2023-10-30,8711
2337,旺宏,30,4,26,陽信-石牌,2023-10-30,8711
2317,鴻海,33,8,25,陽信-石牌,2023-10-30,8711
2390,云辰,36,13,23,陽信-石牌,2023-10-30,8711
2883,凱基金,22,0,22,陽信-石牌,2023-10-30,8711
2886,兆豐金,21,0,21,陽信-石牌,2023-10-30,8711
4128,中天,21,0,21,陽信-石牌,2023-10-30,8711
1802,台玻,20,0,20,陽信-石牌,2023-10-30,8711
2427,三商電,20,0,20,陽信-石牌,2023-10-30,8711
911868,同方友友-DR,20,0,20,陽信-石牌,2023-10-30,8711
00712,復華富時不動產,18,0,18,陽信-石牌,2023-10-30,8711
3491,昇達科,19,1,18,陽信-石牌,2023-10-30,8711
2406,國碩,16,0,16,陽信-石牌,2023-10-30,8711
2610,華航,18,2,16,陽信-石牌,2023-10-30,8711
5880,合庫金,15,0,15,陽信-石牌,2023-10-30,8711
0061,元大寶滬深,15,0,15,陽信-石牌,2023-10-30,8711
2884,玉山金,15,0,15,陽信-石牌,2023-10-30,8711
00932,兆豐永續高息等權,14,1,13,陽信-石牌,2023-10-30,8711
5876,上海商銀,13,0,13,陽信-石牌,2023-10-30,8711
1303,南亞,11,0,11,陽信-石牌,2023-10-30,8711
00923,群益台ESG低碳50,10,0,10,陽信-石牌,2023-10-30,8711
00751B,元大AAA至A公司債,10,0,10,陽信-石牌,2023-10-30,8711
2897,王道銀行,10,0,10,陽信-石牌,2023-10-30,8711
3550,聯穎,10,0,10,陽信-石牌,2023-10-30,8711
8110,華東,30,20,10,陽信-石牌,2023-10-30,8711
2330,台積電,9,0,9,陽信-石牌,2023-10-30,8711
2303,聯電,10,1,9,陽信-石牌,2023-10-30,8711
5426,振發,9,0,9,陽信-石牌,2023-10-30,8711
2885,元大金,9,0,9,陽信-石牌,2023-10-30,8711
2888,新光金,12,4,8,陽信-石牌,2023-10-30,8711
3231,緯創,30,22,8,陽信-石牌,2023-10-30,8711
3325,旭品,9,1,8,陽信-石牌,2023-10-30,8711
00687B,國泰20年美債,8,0,8,陽信-石牌,2023-10-30,8711
00676R,富邦臺灣加權反1,7,0,7,陽信-石牌,2023-10-30,8711
2465,麗臺,10,3,7,陽信-石牌,2023-10-30,8711
1524,耿鼎,17,11,6,陽信-石牌,2023-10-30,8711
0056,元大高股息,9,3,6,陽信-石牌,2023-10-30,8711
00931B,統一美債20年,6,0,6,陽信-石牌,2023-10-30,8711
6244,茂迪,6,0,6,陽信-石牌,2023-10-30,8711
8048,德勝,8,2,6,陽信-石牌,2023-10-30,8711
2458,義隆,5,0,5,陽信-石牌,2023-10-30,8711
00929,復華台灣科技優息,9,4,5,陽信-石牌,2023-10-30,8711
00772B,中信高評級公司債,5,0,5,陽信-石牌,2023-10-30,8711
1216,統一,5,0,5,陽信-石牌,2023-10-30,8711
00665L,富邦�琤肭磪囓�2,10,5,5,陽信-石牌,2023-10-30,8711
2449,京元電子,108,4,104,陽信-石牌,2023-10-31,8711
3481,群創,107,4,103,陽信-石牌,2023-10-31,8711
2883,凱基金,108,11,97,陽信-石牌,2023-10-31,8711
2618,長榮航,116,23,93,陽信-石牌,2023-10-31,8711
2303,聯電,63,6,57,陽信-石牌,2023-10-31,8711
00878,國泰永續高股息,59,4,55,陽信-石牌,2023-10-31,8711
0056,元大高股息,73,21,52,陽信-石牌,2023-10-31,8711
00885,富邦越南,46,0,46,陽信-石牌,2023-10-31,8711
00929,復華台灣科技優息,31,0,31,陽信-石牌,2023-10-31,8711
00676R,富邦臺灣加權反1,31,0,31,陽信-石牌,2023-10-31,8711
9105,泰金寶-DR,30,0,30,陽信-石牌,2023-10-31,8711
2637,慧洋-KY,25,0,25,陽信-石牌,2023-10-31,8711
3576,聯合再生,65,44,21,陽信-石牌,2023-10-31,8711
1598,岱宇,20,0,20,陽信-石牌,2023-10-31,8711
2809,京城銀,20,0,20,陽信-石牌,2023-10-31,8711
8011,台通,20,0,20,陽信-石牌,2023-10-31,8711
00648R,元大S＆P500反1,19,0,19,陽信-石牌,2023-10-31,8711
2409,友達,20,5,15,陽信-石牌,2023-10-31,8711
6282,康舒,18,3,15,陽信-石牌,2023-10-31,8711
0050,元大台灣50,14,0,14,陽信-石牌,2023-10-31,8711
1815,富喬,19,6,13,陽信-石牌,2023-10-31,8711
2313,華通,39,26,13,陽信-石牌,2023-10-31,8711
2743,山富,13,0,13,陽信-石牌,2023-10-31,8711
3372,典範,13,0,13,陽信-石牌,2023-10-31,8711
2344,華邦電,14,2,12,陽信-石牌,2023-10-31,8711
2356,英業達,12,0,12,陽信-石牌,2023-10-31,8711
2406,國碩,12,0,12,陽信-石牌,2023-10-31,8711
4908,前鼎,17,5,12,陽信-石牌,2023-10-31,8711
4960,誠美材,12,0,12,陽信-石牌,2023-10-31,8711
6285,啟��,13,1,12,陽信-石牌,2023-10-31,8711
00669R,國泰美國道瓊反1,11,0,11,陽信-石牌,2023-10-31,8711
1905,華紙,11,0,11,陽信-石牌,2023-10-31,8711
2316,楠梓電,10,0,10,陽信-石牌,2023-10-31,8711
2399,映泰,16,6,10,陽信-石牌,2023-10-31,8711
2892,第一金,10,0,10,陽信-石牌,2023-10-31,8711
3149,正達,10,0,10,陽信-石牌,2023-10-31,8711
4171,瑞基,10,0,10,陽信-石牌,2023-10-31,8711
6015,宏遠證,10,0,10,陽信-石牌,2023-10-31,8711
6541,泰福-KY,15,5,10,陽信-石牌,2023-10-31,8711
00637L,元大滬深300正2,15,6,9,陽信-石牌,2023-10-31,8711
00919,群益台灣精選高息,9,0,9,陽信-石牌,2023-10-31,8711
3450,聯鈞,10,1,9,陽信-石牌,2023-10-31,8711
6150,撼訊,15,6,9,陽信-石牌,2023-10-31,8711
2301,光寶科,19,11,8,陽信-石牌,2023-10-31,8711
2002,中鋼,8,0,8,陽信-石牌,2023-10-31,8711
2485,兆赫,13,5,8,陽信-石牌,2023-10-31,8711
3078,僑威,12,4,8,陽信-石牌,2023-10-31,8711
5340,建榮,8,0,8,陽信-石牌,2023-10-31,8711
1605,華新,7,0,7,陽信-石牌,2023-10-31,8711
3094,聯傑,12,5,7,陽信-石牌,2023-10-31,8711
00934,中信成長高股息,148,0,148,陽信-石牌,2023-11-01,8711
2344,華邦電,102,1,101,陽信-石牌,2023-11-01,8711
9105,泰金寶-DR,101,0,101,陽信-石牌,2023-11-01,8711
00679B,元大美債20年,100,0,100,陽信-石牌,2023-11-01,8711
00715L,期街口布蘭特正2,59,3,56,陽信-石牌,2023-11-01,8711
1605,華新,57,21,36,陽信-石牌,2023-11-01,8711
00885,富邦越南,35,0,35,陽信-石牌,2023-11-01,8711
00929,復華台灣科技優息,23,0,23,陽信-石牌,2023-11-01,8711
2409,友達,22,0,22,陽信-石牌,2023-11-01,8711
1219,福壽,22,2,20,陽信-石牌,2023-11-01,8711
00878,國泰永續高股息,22,2,20,陽信-石牌,2023-11-01,8711
2314,台揚,18,0,18,陽信-石牌,2023-11-01,8711
00637L,元大滬深300正2,32,15,17,陽信-石牌,2023-11-01,8711
1905,華紙,20,4,16,陽信-石牌,2023-11-01,8711
3231,緯創,55,39,16,陽信-石牌,2023-11-01,8711
6127,九豪,12,0,12,陽信-石牌,2023-11-01,8711
1760,寶齡富錦,12,1,11,陽信-石牌,2023-11-01,8711
3041,揚智,11,0,11,陽信-石牌,2023-11-01,8711
2313,華通,12,2,10,陽信-石牌,2023-11-01,8711
2356,英業達,14,4,10,陽信-石牌,2023-11-01,8711
2402,毅嘉,11,1,10,陽信-石牌,2023-11-01,8711
2897,王道銀行,10,0,10,陽信-石牌,2023-11-01,8711
3029,零壹,10,0,10,陽信-石牌,2023-11-01,8711
5425,台半,10,0,10,陽信-石牌,2023-11-01,8711
6168,宏齊,10,0,10,陽信-石牌,2023-11-01,8711
6173,信昌電,15,5,10,陽信-石牌,2023-11-01,8711
9911,櫻花,10,0,10,陽信-石牌,2023-11-01,8711
00712,復華富時不動產,8,0,8,陽信-石牌,2023-11-01,8711
3176,基亞,12,4,8,陽信-石牌,2023-11-01,8711
6488,環球晶,8,0,8,陽信-石牌,2023-11-01,8711
00648R,元大S＆P500反1,7,0,7,陽信-石牌,2023-11-01,8711
00665L,富邦�琤肭磪囓�2,22,15,7,陽信-石牌,2023-11-01,8711
1203,味王,7,0,7,陽信-石牌,2023-11-01,8711
2883,凱基金,7,0,7,陽信-石牌,2023-11-01,8711
2002,中鋼,10,4,6,陽信-石牌,2023-11-01,8711
3035,智原,26,20,6,陽信-石牌,2023-11-01,8711
3234,光環,6,0,6,陽信-石牌,2023-11-01,8711
4130,健亞,6,0,6,陽信-石牌,2023-11-01,8711
8011,台通,6,0,6,陽信-石牌,2023-11-01,8711
1909,榮成,6,0,6,陽信-石牌,2023-11-01,8711
1101,台泥,6,1,5,陽信-石牌,2023-11-01,8711
2401,凌陽,5,0,5,陽信-石牌,2023-11-01,8711
2425,承啟,5,0,5,陽信-石牌,2023-11-01,8711
2453,凌群,5,0,5,陽信-石牌,2023-11-01,8711
2465,麗臺,8,3,5,陽信-石牌,2023-11-01,8711
2891,中信金,5,0,5,陽信-石牌,2023-11-01,8711
3022,威強電,5,0,5,陽信-石牌,2023-11-01,8711
3059,華晶科,5,0,5,陽信-石牌,2023-11-01,8711
3257,虹冠電,5,0,5,陽信-石牌,2023-11-01,8711
3325,旭品,5,0,5,陽信-石牌,2023-11-01,8711
2883,凱基金,100,0,100,陽信-石牌,2023-11-02,8711
00934,中信成長高股息,50,0,50,陽信-石牌,2023-11-02,8711
2363,矽統,57,12,45,陽信-石牌,2023-11-02,8711
2356,英業達,31,2,29,陽信-石牌,2023-11-02,8711
3491,昇達科,33,4,29,陽信-石牌,2023-11-02,8711
00857B,永豐20年美公債,30,3,27,陽信-石牌,2023-11-02,8711
6187,萬潤,25,0,25,陽信-石牌,2023-11-02,8711
00712,復華富時不動產,23,0,23,陽信-石牌,2023-11-02,8711
2313,華通,31,11,20,陽信-石牌,2023-11-02,8711
3576,聯合再生,20,0,20,陽信-石牌,2023-11-02,8711
2367,燿華,35,16,19,陽信-石牌,2023-11-02,8711
6117,迎廣,25,6,19,陽信-石牌,2023-11-02,8711
2382,廣達,33,17,16,陽信-石牌,2023-11-02,8711
00632R,元大台灣50反1,20,5,15,陽信-石牌,2023-11-02,8711
1723,中碳,15,0,15,陽信-石牌,2023-11-02,8711
2603,長榮,14,0,14,陽信-石牌,2023-11-02,8711
3006,晶豪科,15,3,12,陽信-石牌,2023-11-02,8711
1324,地球,21,10,11,陽信-石牌,2023-11-02,8711
1319,東陽,19,8,11,陽信-石牌,2023-11-02,8711
1584,精剛,13,2,11,陽信-石牌,2023-11-02,8711
6274,台燿,14,3,11,陽信-石牌,2023-11-02,8711
00637L,元大滬深300正2,15,5,10,陽信-石牌,2023-11-02,8711
3231,緯創,45,35,10,陽信-石牌,2023-11-02,8711
4162,智擎,11,1,10,陽信-石牌,2023-11-02,8711
9103,美德醫療-DR,10,0,10,陽信-石牌,2023-11-02,8711
00679B,元大美債20年,112,103,9,陽信-石牌,2023-11-02,8711
9938,百和,12,3,9,陽信-石牌,2023-11-02,8711
3325,旭品,8,0,8,陽信-石牌,2023-11-02,8711
6285,啟��,8,0,8,陽信-石牌,2023-11-02,8711
2834,臺企銀,7,0,7,陽信-石牌,2023-11-02,8711
00885,富邦越南,6,0,6,陽信-石牌,2023-11-02,8711
2538,基泰,6,0,6,陽信-石牌,2023-11-02,8711
2637,慧洋-KY,15,9,6,陽信-石牌,2023-11-02,8711
1314,中石化,5,0,5,陽信-石牌,2023-11-02,8711
2358,廷鑫,5,0,5,陽信-石牌,2023-11-02,8711
2417,圓剛,10,5,5,陽信-石牌,2023-11-02,8711
2515,中工,5,0,5,陽信-石牌,2023-11-02,8711
3029,零壹,5,0,5,陽信-石牌,2023-11-02,8711
3058,立德,5,0,5,陽信-石牌,2023-11-02,8711
3380,明泰,5,0,5,陽信-石牌,2023-11-02,8711
3591,艾笛森,5,0,5,陽信-石牌,2023-11-02,8711
4188,安克,5,0,5,陽信-石牌,2023-11-02,8711
4414,如興,5,0,5,陽信-石牌,2023-11-02,8711
6841,長佳智能,5,0,5,陽信-石牌,2023-11-02,8711
00893,國泰智能電動車,4,0,4,陽信-石牌,2023-11-02,8711
2913,農林,9,5,4,陽信-石牌,2023-11-02,8711
6182,合晶,4,0,4,陽信-石牌,2023-11-02,8711
2390,云辰,25,22,3,陽信-石牌,2023-11-02,8711
2605,新興,3,0,3,陽信-石牌,2023-11-02,8711
3060,銘異,3,0,3,陽信-石牌,2023-11-02,8711
9105,泰金寶-DR,100,0,100,陽信-石牌,2023-11-03,8711
2382,廣達,120,28,92,陽信-石牌,2023-11-03,8711
2317,鴻海,64,21,43,陽信-石牌,2023-11-03,8711
6278,台表科,41,0,41,陽信-石牌,2023-11-03,8711
00669R,國泰美國道瓊反1,36,0,36,陽信-石牌,2023-11-03,8711
4960,誠美材,33,0,33,陽信-石牌,2023-11-03,8711
00648R,元大S＆P500反1,31,0,31,陽信-石牌,2023-11-03,8711
8016,矽創,30,0,30,陽信-石牌,2023-11-03,8711
2313,華通,34,5,29,陽信-石牌,2023-11-03,8711
00713,元大台灣高息低波,23,0,23,陽信-石牌,2023-11-03,8711
6235,華孚,23,0,23,陽信-石牌,2023-11-03,8711
00632R,元大台灣50反1,21,0,21,陽信-石牌,2023-11-03,8711
00720B,元大投資級公司債,22,1,21,陽信-石牌,2023-11-03,8711
1598,岱宇,19,0,19,陽信-石牌,2023-11-03,8711
00878,國泰永續高股息,20,3,17,陽信-石牌,2023-11-03,8711
1203,味王,17,0,17,陽信-石牌,2023-11-03,8711
1319,東陽,16,0,16,陽信-石牌,2023-11-03,8711
6150,撼訊,19,3,16,陽信-石牌,2023-11-03,8711
8044,網家,16,1,15,陽信-石牌,2023-11-03,8711
2637,慧洋-KY,14,0,14,陽信-石牌,2023-11-03,8711
2002,中鋼,11,0,11,陽信-石牌,2023-11-03,8711
3213,茂訊,11,0,11,陽信-石牌,2023-11-03,8711
4943,康控-KY,11,0,11,陽信-石牌,2023-11-03,8711
6531,愛普*,15,4,11,陽信-石牌,2023-11-03,8711
00935,野村臺灣新科技50,10,0,10,陽信-石牌,2023-11-03,8711
00671R,富邦NASDAQ反1,10,0,10,陽信-石牌,2023-11-03,8711
00637L,元大滬深300正2,10,0,10,陽信-石牌,2023-11-03,8711
00651R,復華香港反1,10,0,10,陽信-石牌,2023-11-03,8711
6120,達運,10,0,10,陽信-石牌,2023-11-03,8711
2881,富邦金,10,0,10,陽信-石牌,2023-11-03,8711
3576,聯合再生,20,11,9,陽信-石牌,2023-11-03,8711
2390,云辰,8,0,8,陽信-石牌,2023-11-03,8711
4147,中裕,13,5,8,陽信-石牌,2023-11-03,8711
6488,環球晶,7,0,7,陽信-石牌,2023-11-03,8711
8046,南電,7,1,6,陽信-石牌,2023-11-03,8711
1760,寶齡富錦,6,0,6,陽信-石牌,2023-11-03,8711
2383,台光電,17,11,6,陽信-石牌,2023-11-03,8711
3260,威剛,6,0,6,陽信-石牌,2023-11-03,8711
6115,鎰勝,6,0,6,陽信-石牌,2023-11-03,8711
0056,元大高股息,8,2,6,陽信-石牌,2023-11-03,8711
00893,國泰智能電動車,6,1,5,陽信-石牌,2023-11-03,8711
00680L,元大美債20正2,10,5,5,陽信-石牌,2023-11-03,8711
00858,永豐美國500大,5,0,5,陽信-石牌,2023-11-03,8711
2206,三陽工業,5,0,5,陽信-石牌,2023-11-03,8711
2344,華邦電,5,0,5,陽信-石牌,2023-11-03,8711
2465,麗臺,5,0,5,陽信-石牌,2023-11-03,8711
2538,基泰,5,0,5,陽信-石牌,2023-11-03,8711
2542,興富發,5,0,5,陽信-石牌,2023-11-03,8711
3149,正達,5,0,5,陽信-石牌,2023-11-03,8711
3380,明泰,5,0,5,陽信-石牌,2023-11-03,8711
00632R,元大台灣50反1,270,85,185,陽信-石牌,2023-11-06,8711
00676R,富邦臺灣加權反1,200,88,112,陽信-石牌,2023-11-06,8711
00687B,國泰20年美債,110,2,108,陽信-石牌,2023-11-06,8711
00715L,期街口布蘭特正2,105,0,105,陽信-石牌,2023-11-06,8711
1802,台玻,100,0,100,陽信-石牌,2023-11-06,8711
1605,華新,100,4,96,陽信-石牌,2023-11-06,8711
00882,中信中國高股息,80,0,80,陽信-石牌,2023-11-06,8711
1905,華紙,77,5,72,陽信-石牌,2023-11-06,8711
2363,矽統,151,88,63,陽信-石牌,2023-11-06,8711
00679B,元大美債20年,62,6,56,陽信-石牌,2023-11-06,8711
00651R,復華香港反1,32,0,32,陽信-石牌,2023-11-06,8711
1504,東元,32,1,31,陽信-石牌,2023-11-06,8711
2515,中工,30,0,30,陽信-石牌,2023-11-06,8711
8110,華東,36,12,24,陽信-石牌,2023-11-06,8711
1721,三晃,29,7,22,陽信-石牌,2023-11-06,8711
8016,矽創,20,0,20,陽信-石牌,2023-11-06,8711
2618,長榮航,50,31,19,陽信-石牌,2023-11-06,8711
6770,力積電,21,2,19,陽信-石牌,2023-11-06,8711
5483,中美晶,19,1,18,陽信-石牌,2023-11-06,8711
2382,廣達,35,18,17,陽信-石牌,2023-11-06,8711
2486,一詮,15,1,14,陽信-石牌,2023-11-06,8711
3017,奇鋐,15,1,14,陽信-石牌,2023-11-06,8711
6235,華孚,15,2,13,陽信-石牌,2023-11-06,8711
3265,台星科,11,0,11,陽信-石牌,2023-11-06,8711
2408,南亞科,12,2,10,陽信-石牌,2023-11-06,8711
2530,華建,10,0,10,陽信-石牌,2023-11-06,8711
3056,富華新,10,0,10,陽信-石牌,2023-11-06,8711
3508,位速,10,0,10,陽信-石牌,2023-11-06,8711
4961,天鈺,10,0,10,陽信-石牌,2023-11-06,8711
9945,潤泰新,10,0,10,陽信-石牌,2023-11-06,8711
2317,鴻海,14,5,9,陽信-石牌,2023-11-06,8711
1789,神隆,10,1,9,陽信-石牌,2023-11-06,8711
2816,旺旺保,15,6,9,陽信-石牌,2023-11-06,8711
3276,宇環,10,1,9,陽信-石牌,2023-11-06,8711
2388,威盛,29,20,9,陽信-石牌,2023-11-06,8711
2455,全新,18,10,8,陽信-石牌,2023-11-06,8711
2543,皇昌,8,0,8,陽信-石牌,2023-11-06,8711
6278,台表科,16,9,7,陽信-石牌,2023-11-06,8711
2337,旺宏,7,0,7,陽信-石牌,2023-11-06,8711
0056,元大高股息,13,6,7,陽信-石牌,2023-11-06,8711
00720B,元大投資級公司債,6,0,6,陽信-石牌,2023-11-06,8711
1519,華城,7,1,6,陽信-石牌,2023-11-06,8711
3189,景碩,6,0,6,陽信-石牌,2023-11-06,8711
3715,定穎投控,6,0,6,陽信-石牌,2023-11-06,8711
6153,嘉聯益,6,0,6,陽信-石牌,2023-11-06,8711
6216,居易,8,2,6,陽信-石牌,2023-11-06,8711
2376,技嘉,48,42,6,陽信-石牌,2023-11-06,8711
1231,聯華食,5,0,5,陽信-石牌,2023-11-06,8711
1582,信錦,5,0,5,陽信-石牌,2023-11-06,8711
2390,云辰,14,9,5,陽信-石牌,2023-11-06,8711
00679B,元大美債20年,108,0,108,陽信-石牌,2023-11-07,8711
00673R,期元大S＆P原油反1,96,2,94,陽信-石牌,2023-11-07,8711
8110,華東,80,3,77,陽信-石牌,2023-11-07,8711
6278,台表科,50,1,49,陽信-石牌,2023-11-07,8711
1815,富喬,60,16,44,陽信-石牌,2023-11-07,8711
4167,松瑞藥,43,0,43,陽信-石牌,2023-11-07,8711
00878,國泰永續高股息,37,1,36,陽信-石牌,2023-11-07,8711
9103,美德醫療-DR,30,0,30,陽信-石牌,2023-11-07,8711
2486,一詮,30,1,29,陽信-石牌,2023-11-07,8711
5483,中美晶,28,2,26,陽信-石牌,2023-11-07,8711
00637L,元大滬深300正2,25,0,25,陽信-石牌,2023-11-07,8711
2634,漢翔,24,2,22,陽信-石牌,2023-11-07,8711
8044,網家,33,11,22,陽信-石牌,2023-11-07,8711
1203,味王,21,0,21,陽信-石牌,2023-11-07,8711
2618,長榮航,42,21,21,陽信-石牌,2023-11-07,8711
00671R,富邦NASDAQ反1,20,0,20,陽信-石牌,2023-11-07,8711
00713,元大台灣高息低波,19,0,19,陽信-石牌,2023-11-07,8711
0056,元大高股息,21,2,19,陽信-石牌,2023-11-07,8711
3037,欣興,19,0,19,陽信-石牌,2023-11-07,8711
8046,南電,18,0,18,陽信-石牌,2023-11-07,8711
2356,英業達,16,1,15,陽信-石牌,2023-11-07,8711
2515,中工,15,0,15,陽信-石牌,2023-11-07,8711
2637,慧洋-KY,14,0,14,陽信-石牌,2023-11-07,8711
2401,凌陽,40,27,13,陽信-石牌,2023-11-07,8711
3041,揚智,14,1,13,陽信-石牌,2023-11-07,8711
2409,友達,39,26,13,陽信-石牌,2023-11-07,8711
00687B,國泰20年美債,11,0,11,陽信-石牌,2023-11-07,8711
2707,晶華,11,0,11,陽信-石牌,2023-11-07,8711
2002,中鋼,12,2,10,陽信-石牌,2023-11-07,8711
2332,友訊,10,0,10,陽信-石牌,2023-11-07,8711
2359,所羅門,11,1,10,陽信-石牌,2023-11-07,8711
2383,台光電,11,1,10,陽信-石牌,2023-11-07,8711
2609,陽明,12,2,10,陽信-石牌,2023-11-07,8711
2614,東森,10,0,10,陽信-石牌,2023-11-07,8711
3520,華盈,10,0,10,陽信-石牌,2023-11-07,8711
4726,永昕,10,0,10,陽信-石牌,2023-11-07,8711
6189,豐藝,10,0,10,陽信-石牌,2023-11-07,8711
6541,泰福-KY,15,5,10,陽信-石牌,2023-11-07,8711
2317,鴻海,13,3,10,陽信-石牌,2023-11-07,8711
1711,永光,10,1,9,陽信-石牌,2023-11-07,8711
8069,元太,8,0,8,陽信-石牌,2023-11-07,8711
5284,jpp-KY,8,0,8,陽信-石牌,2023-11-07,8711
1319,東陽,8,1,7,陽信-石牌,2023-11-07,8711
2344,華邦電,7,0,7,陽信-石牌,2023-11-07,8711
2705,六福,9,2,7,陽信-石牌,2023-11-07,8711
3051,力特,8,1,7,陽信-石牌,2023-11-07,8711
3105,穩懋,8,1,7,陽信-石牌,2023-11-07,8711
5457,宣德,7,0,7,陽信-石牌,2023-11-07,8711
00923,群益台ESG低碳50,6,0,6,陽信-石牌,2023-11-07,8711
2388,威盛,14,8,6,陽信-石牌,2023-11-07,8711
2890,永豐金,500,0,500,陽信-石牌,2023-11-08,8711
00715L,期街口布蘭特正2,188,0,188,陽信-石牌,2023-11-08,8711
00632R,元大台灣50反1,245,90,155,陽信-石牌,2023-11-08,8711
00934,中信成長高股息,128,0,128,陽信-石牌,2023-11-08,8711
00936,台新永續高息中小,109,0,109,陽信-石牌,2023-11-08,8711
2303,聯電,66,11,55,陽信-石牌,2023-11-08,8711
2882,國泰金,50,0,50,陽信-石牌,2023-11-08,8711
00648R,元大S＆P500反1,65,26,39,陽信-石牌,2023-11-08,8711
1789,神隆,40,2,38,陽信-石牌,2023-11-08,8711
1203,味王,36,0,36,陽信-石牌,2023-11-08,8711
4147,中裕,34,0,34,陽信-石牌,2023-11-08,8711
5381,合正,30,0,30,陽信-石牌,2023-11-08,8711
8034,榮群,52,27,25,陽信-石牌,2023-11-08,8711
00919,群益台灣精選高息,21,0,21,陽信-石牌,2023-11-08,8711
2609,陽明,21,0,21,陽信-石牌,2023-11-08,8711
4908,前鼎,25,4,21,陽信-石牌,2023-11-08,8711
00671R,富邦NASDAQ反1,18,0,18,陽信-石牌,2023-11-08,8711
2367,燿華,18,0,18,陽信-石牌,2023-11-08,8711
00679B,元大美債20年,18,1,17,陽信-石牌,2023-11-08,8711
2618,長榮航,24,7,17,陽信-石牌,2023-11-08,8711
3051,力特,22,5,17,陽信-石牌,2023-11-08,8711
9958,世紀鋼,18,3,15,陽信-石牌,2023-11-08,8711
3176,基亞,15,1,14,陽信-石牌,2023-11-08,8711
00929,復華台灣科技優息,17,4,13,陽信-石牌,2023-11-08,8711
00885,富邦越南,15,2,13,陽信-石牌,2023-11-08,8711
1815,富喬,29,16,13,陽信-石牌,2023-11-08,8711
2511,太子,13,0,13,陽信-石牌,2023-11-08,8711
5347,世界,12,0,12,陽信-石牌,2023-11-08,8711
2455,全新,23,11,12,陽信-石牌,2023-11-08,8711
5452,佶優,12,0,12,陽信-石牌,2023-11-08,8711
2356,英業達,17,6,11,陽信-石牌,2023-11-08,8711
1605,華新,15,4,11,陽信-石牌,2023-11-08,8711
5483,中美晶,11,0,11,陽信-石牌,2023-11-08,8711
1217,愛之味,10,0,10,陽信-石牌,2023-11-08,8711
00933B,國泰10Y+金融債,10,0,10,陽信-石牌,2023-11-08,8711
00900,富邦特選高股息30,10,0,10,陽信-石牌,2023-11-08,8711
3056,富華新,10,0,10,陽信-石牌,2023-11-08,8711
3276,宇環,10,0,10,陽信-石牌,2023-11-08,8711
5321,美而快,11,1,10,陽信-石牌,2023-11-08,8711
5880,合庫金,10,0,10,陽信-石牌,2023-11-08,8711
6122,擎邦,12,2,10,陽信-石牌,2023-11-08,8711
8176,智捷,10,0,10,陽信-石牌,2023-11-08,8711
2002,中鋼,9,0,9,陽信-石牌,2023-11-08,8711
3481,群創,10,1,9,陽信-石牌,2023-11-08,8711
5439,高技,11,2,9,陽信-石牌,2023-11-08,8711
8068,全達,8,0,8,陽信-石牌,2023-11-08,8711
1515,力山,7,0,7,陽信-石牌,2023-11-08,8711
2610,華航,12,5,7,陽信-石牌,2023-11-08,8711
3437,榮創,7,0,7,陽信-石牌,2023-11-08,8711
6426,統新,7,0,7,陽信-石牌,2023-11-08,8711
00632R,元大台灣50反1,300,0,300,陽信-石牌,2023-11-09,8711
5347,世界,57,0,57,陽信-石牌,2023-11-09,8711
2363,矽統,272,220,52,陽信-石牌,2023-11-09,8711
2427,三商電,56,14,42,陽信-石牌,2023-11-09,8711
00878,國泰永續高股息,41,2,39,陽信-石牌,2023-11-09,8711
2329,華泰,53,15,38,陽信-石牌,2023-11-09,8711
00679B,元大美債20年,36,2,34,陽信-石牌,2023-11-09,8711
2888,新光金,34,0,34,陽信-石牌,2023-11-09,8711
2610,華航,35,2,33,陽信-石牌,2023-11-09,8711
6491,晶碩,33,0,33,陽信-石牌,2023-11-09,8711
1314,中石化,34,3,31,陽信-石牌,2023-11-09,8711
00934,中信成長高股息,32,2,30,陽信-石牌,2023-11-09,8711
1815,富喬,30,0,30,陽信-石牌,2023-11-09,8711
2337,旺宏,30,0,30,陽信-石牌,2023-11-09,8711
6189,豐藝,27,0,27,陽信-石牌,2023-11-09,8711
6278,台表科,26,0,26,陽信-石牌,2023-11-09,8711
4906,正文,24,0,24,陽信-石牌,2023-11-09,8711
2338,光罩,33,10,23,陽信-石牌,2023-11-09,8711
00648R,元大S＆P500反1,21,0,21,陽信-石牌,2023-11-09,8711
4147,中裕,21,0,21,陽信-石牌,2023-11-09,8711
00850,元大臺灣ESG永續,20,0,20,陽信-石牌,2023-11-09,8711
3231,緯創,62,44,18,陽信-石牌,2023-11-09,8711
2402,毅嘉,18,1,17,陽信-石牌,2023-11-09,8711
3032,偉訓,20,3,17,陽信-石牌,2023-11-09,8711
6161,捷波,21,4,17,陽信-石牌,2023-11-09,8711
8070,長華*,15,0,15,陽信-石牌,2023-11-09,8711
3260,威剛,20,6,14,陽信-石牌,2023-11-09,8711
6243,迅杰,16,2,14,陽信-石牌,2023-11-09,8711
2313,華通,32,19,13,陽信-石牌,2023-11-09,8711
3308,聯德,13,0,13,陽信-石牌,2023-11-09,8711
6901,鑽石投資,15,2,13,陽信-石牌,2023-11-09,8711
8103,瀚荃,12,0,12,陽信-石牌,2023-11-09,8711
00929,復華台灣科技優息,13,2,11,陽信-石牌,2023-11-09,8711
00715L,期街口布蘭特正2,11,0,11,陽信-石牌,2023-11-09,8711
5426,振發,11,0,11,陽信-石牌,2023-11-09,8711
00882,中信中國高股息,10,0,10,陽信-石牌,2023-11-09,8711
00933B,國泰10Y+金融債,10,0,10,陽信-石牌,2023-11-09,8711
00692,富邦公司治理,10,0,10,陽信-石牌,2023-11-09,8711
1783,和康生,10,0,10,陽信-石牌,2023-11-09,8711
2368,金像電,14,4,10,陽信-石牌,2023-11-09,8711
3014,聯陽,10,0,10,陽信-石牌,2023-11-09,8711
3051,力特,10,0,10,陽信-石牌,2023-11-09,8711
3686,達能,10,0,10,陽信-石牌,2023-11-09,8711
3694,海華,10,0,10,陽信-石牌,2023-11-09,8711
8043,蜜望實,10,0,10,陽信-石牌,2023-11-09,8711
9955,佳龍,10,0,10,陽信-石牌,2023-11-09,8711
2331,精英,15,5,10,陽信-石牌,2023-11-09,8711
2301,光寶科,11,2,9,陽信-石牌,2023-11-09,8711
2408,南亞科,10,1,9,陽信-石牌,2023-11-09,8711
00676R,富邦臺灣加權反1,8,0,8,陽信-石牌,2023-11-09,8711
00857B,永豐20年美公債,103,0,103,陽信-石牌,2023-11-10,8711
00637L,元大滬深300正2,100,1,99,陽信-石牌,2023-11-10,8711
4906,正文,101,2,99,陽信-石牌,2023-11-10,8711
6472,保瑞,63,4,59,陽信-石牌,2023-11-10,8711
2891,中信金,50,0,50,陽信-石牌,2023-11-10,8711
8089,康全電訊,48,0,48,陽信-石牌,2023-11-10,8711
00676R,富邦臺灣加權反1,40,0,40,陽信-石牌,2023-11-10,8711
3231,緯創,74,41,33,陽信-石牌,2023-11-10,8711
00900,富邦特選高股息30,33,0,33,陽信-石牌,2023-11-10,8711
2402,毅嘉,34,2,32,陽信-石牌,2023-11-10,8711
6189,豐藝,32,0,32,陽信-石牌,2023-11-10,8711
6016,康和證,30,0,30,陽信-石牌,2023-11-10,8711
00934,中信成長高股息,29,0,29,陽信-石牌,2023-11-10,8711
00648R,元大S＆P500反1,25,0,25,陽信-石牌,2023-11-10,8711
3176,基亞,26,2,24,陽信-石牌,2023-11-10,8711
00650L,復華香港正2,33,12,21,陽信-石牌,2023-11-10,8711
3260,威剛,26,6,20,陽信-石牌,2023-11-10,8711
00936,台新永續高息中小,18,0,18,陽信-石牌,2023-11-10,8711
2618,長榮航,27,10,17,陽信-石牌,2023-11-10,8711
2376,技嘉,29,12,17,陽信-石牌,2023-11-10,8711
00669R,國泰美國道瓊反1,16,0,16,陽信-石牌,2023-11-10,8711
3041,揚智,16,0,16,陽信-石牌,2023-11-10,8711
6213,聯茂,21,5,16,陽信-石牌,2023-11-10,8711
00679B,元大美債20年,14,0,14,陽信-石牌,2023-11-10,8711
2353,宏��,15,1,14,陽信-石牌,2023-11-10,8711
3044,健鼎,17,3,14,陽信-石牌,2023-11-10,8711
00878,國泰永續高股息,14,1,13,陽信-石牌,2023-11-10,8711
2388,威盛,15,2,13,陽信-石牌,2023-11-10,8711
2457,飛宏,13,0,13,陽信-石牌,2023-11-10,8711
00885,富邦越南,11,0,11,陽信-石牌,2023-11-10,8711
00712,復華富時不動產,11,0,11,陽信-石牌,2023-11-10,8711
3032,偉訓,11,0,11,陽信-石牌,2023-11-10,8711
4147,中裕,11,0,11,陽信-石牌,2023-11-10,8711
2889,國票金,10,0,10,陽信-石牌,2023-11-10,8711
00665L,富邦�琤肭磪囓�2,25,15,10,陽信-石牌,2023-11-10,8711
00882,中信中國高股息,10,0,10,陽信-石牌,2023-11-10,8711
2883,凱基金,10,0,10,陽信-石牌,2023-11-10,8711
3576,聯合再生,10,0,10,陽信-石牌,2023-11-10,8711
6589,台康生技,9,0,9,陽信-石牌,2023-11-10,8711
3056,富華新,9,1,8,陽信-石牌,2023-11-10,8711
2511,太子,8,0,8,陽信-石牌,2023-11-10,8711
2486,一詮,12,4,8,陽信-石牌,2023-11-10,8711
2338,光罩,10,3,7,陽信-石牌,2023-11-10,8711
00720B,元大投資級公司債,7,1,6,陽信-石牌,2023-11-10,8711
2449,京元電子,7,1,6,陽信-石牌,2023-11-10,8711
2736,富野,8,2,6,陽信-石牌,2023-11-10,8711
4306,炎洲,7,1,6,陽信-石牌,2023-11-10,8711
5284,jpp-KY,6,0,6,陽信-石牌,2023-11-10,8711
5871,中租-KY,5,0,5,陽信-石牌,2023-11-10,8711
2201,裕隆,5,0,5,陽信-石牌,2023-11-10,8711
00632R,元大台灣50反1,575,200,375,陽信-石牌,2023-11-13,8711
2885,元大金,205,0,205,陽信-石牌,2023-11-13,8711
2892,第一金,200,0,200,陽信-石牌,2023-11-13,8711
00673R,期元大S＆P原油反1,92,0,92,陽信-石牌,2023-11-13,8711
00637L,元大滬深300正2,60,0,60,陽信-石牌,2023-11-13,8711
2303,聯電,67,7,60,陽信-石牌,2023-11-13,8711
00751B,元大AAA至A公司債,24,0,24,陽信-石牌,2023-11-13,8711
4147,中裕,24,0,24,陽信-石牌,2023-11-13,8711
1795,美時,23,2,21,陽信-石牌,2023-11-13,8711
6189,豐藝,23,2,21,陽信-石牌,2023-11-13,8711
00878,國泰永續高股息,24,7,17,陽信-石牌,2023-11-13,8711
3260,威剛,32,16,16,陽信-石牌,2023-11-13,8711
3032,偉訓,25,10,15,陽信-石牌,2023-11-13,8711
00929,復華台灣科技優息,34,19,15,陽信-石牌,2023-11-13,8711
3036,文曄,13,0,13,陽信-石牌,2023-11-13,8711
00648R,元大S＆P500反1,15,3,12,陽信-石牌,2023-11-13,8711
8163,達方,14,2,12,陽信-石牌,2023-11-13,8711
2352,佳世達,12,1,11,陽信-石牌,2023-11-13,8711
2618,長榮航,49,38,11,陽信-石牌,2023-11-13,8711
2313,華通,51,41,10,陽信-石牌,2023-11-13,8711
00720B,元大投資級公司債,10,0,10,陽信-石牌,2023-11-13,8711
00772B,中信高評級公司債,10,0,10,陽信-石牌,2023-11-13,8711
2369,菱生,35,25,10,陽信-石牌,2023-11-13,8711
2439,美律,12,2,10,陽信-石牌,2023-11-13,8711
2889,國票金,10,0,10,陽信-石牌,2023-11-13,8711
2897,王道銀行,10,0,10,陽信-石牌,2023-11-13,8711
3376,新日興,10,0,10,陽信-石牌,2023-11-13,8711
6743,安普新,12,2,10,陽信-石牌,2023-11-13,8711
2317,鴻海,12,3,9,陽信-石牌,2023-11-13,8711
2408,南亞科,9,0,9,陽信-石牌,2023-11-13,8711
1203,味王,8,0,8,陽信-石牌,2023-11-13,8711
6547,高端疫苗,8,0,8,陽信-石牌,2023-11-13,8711
6290,良維,7,0,7,陽信-石牌,2023-11-13,8711
1522,堤維西,8,1,7,陽信-石牌,2023-11-13,8711
2340,台亞,7,0,7,陽信-石牌,2023-11-13,8711
2353,宏��,7,0,7,陽信-石牌,2023-11-13,8711
3617,碩天,8,1,7,陽信-石牌,2023-11-13,8711
00679B,元大美債20年,6,0,6,陽信-石牌,2023-11-13,8711
2630,亞航,6,0,6,陽信-石牌,2023-11-13,8711
3083,網龍,6,0,6,陽信-石牌,2023-11-13,8711
00915,凱基優選高股息30,5,0,5,陽信-石牌,2023-11-13,8711
00738U,期元大道瓊白銀,5,0,5,陽信-石牌,2023-11-13,8711
00671R,富邦NASDAQ反1,8,3,5,陽信-石牌,2023-11-13,8711
1460,宏遠,5,0,5,陽信-石牌,2023-11-13,8711
1722,台肥,5,0,5,陽信-石牌,2023-11-13,8711
1815,富喬,10,5,5,陽信-石牌,2023-11-13,8711
2014,中鴻,5,0,5,陽信-石牌,2023-11-13,8711
2337,旺宏,5,0,5,陽信-石牌,2023-11-13,8711
2368,金像電,8,3,5,陽信-石牌,2023-11-13,8711
2423,固緯,5,0,5,陽信-石牌,2023-11-13,8711
00632R,元大台灣50反1,585,80,505,陽信-石牌,2023-11-14,8711
00670L,富邦NASDAQ正2,66,0,66,陽信-石牌,2023-11-14,8711
6282,康舒,67,1,66,陽信-石牌,2023-11-14,8711
0056,元大高股息,61,5,56,陽信-石牌,2023-11-14,8711
2331,精英,55,2,53,陽信-石牌,2023-11-14,8711
2882,國泰金,40,1,39,陽信-石牌,2023-11-14,8711
00935,野村臺灣新科技50,30,0,30,陽信-石牌,2023-11-14,8711
2371,大同,26,0,26,陽信-石牌,2023-11-14,8711
2637,慧洋-KY,27,1,26,陽信-石牌,2023-11-14,8711
6451,訊芯-KY,20,0,20,陽信-石牌,2023-11-14,8711
3051,力特,19,0,19,陽信-石牌,2023-11-14,8711
00648R,元大S＆P500反1,25,7,18,陽信-石牌,2023-11-14,8711
00857B,永豐20年美公債,40,22,18,陽信-石牌,2023-11-14,8711
1723,中碳,18,0,18,陽信-石牌,2023-11-14,8711
00878,國泰永續高股息,69,52,17,陽信-石牌,2023-11-14,8711
5388,中磊,17,0,17,陽信-石牌,2023-11-14,8711
00651R,復華香港反1,15,0,15,陽信-石牌,2023-11-14,8711
2417,圓剛,28,15,13,陽信-石牌,2023-11-14,8711
3325,旭品,21,8,13,陽信-石牌,2023-11-14,8711
2382,廣達,28,16,12,陽信-石牌,2023-11-14,8711
1795,美時,18,7,11,陽信-石牌,2023-11-14,8711
3037,欣興,11,0,11,陽信-石牌,2023-11-14,8711
8011,台通,11,0,11,陽信-石牌,2023-11-14,8711
3231,緯創,26,15,11,陽信-石牌,2023-11-14,8711
00923,群益台ESG低碳50,10,0,10,陽信-石牌,2023-11-14,8711
00712,復華富時不動產,10,0,10,陽信-石牌,2023-11-14,8711
1783,和康生,10,0,10,陽信-石牌,2023-11-14,8711
2105,正新,10,0,10,陽信-石牌,2023-11-14,8711
5210,寶碩,10,0,10,陽信-石牌,2023-11-14,8711
5425,台半,10,0,10,陽信-石牌,2023-11-14,8711
00679B,元大美債20年,10,1,9,陽信-石牌,2023-11-14,8711
1815,富喬,9,0,9,陽信-石牌,2023-11-14,8711
2915,潤泰全,11,2,9,陽信-石牌,2023-11-14,8711
6235,華孚,21,12,9,陽信-石牌,2023-11-14,8711
2543,皇昌,9,1,8,陽信-石牌,2023-11-14,8711
4105,東洋,9,1,8,陽信-石牌,2023-11-14,8711
1301,台塑,7,0,7,陽信-石牌,2023-11-14,8711
2511,太子,7,0,7,陽信-石牌,2023-11-14,8711
6443,元晶,7,0,7,陽信-石牌,2023-11-14,8711
00671R,富邦NASDAQ反1,6,0,6,陽信-石牌,2023-11-14,8711
5483,中美晶,7,1,6,陽信-石牌,2023-11-14,8711
6213,聯茂,6,0,6,陽信-石牌,2023-11-14,8711
6278,台表科,6,0,6,陽信-石牌,2023-11-14,8711
4915,致伸,5,0,5,陽信-石牌,2023-11-14,8711
00706L,期元大S＆P日圓正2,5,0,5,陽信-石牌,2023-11-14,8711
2303,聯電,5,0,5,陽信-石牌,2023-11-14,8711
2316,楠梓電,10,5,5,陽信-石牌,2023-11-14,8711
2482,連宇,5,0,5,陽信-石牌,2023-11-14,8711
2884,玉山金,5,0,5,陽信-石牌,2023-11-14,8711
3691,碩禾,5,0,5,陽信-石牌,2023-11-14,8711
00632R,元大台灣50反1,320,80,240,陽信-石牌,2023-11-15,8711
9105,泰金寶-DR,200,0,200,陽信-石牌,2023-11-15,8711
00878,國泰永續高股息,170,53,117,陽信-石牌,2023-11-15,8711
00673R,期元大S＆P原油反1,92,2,90,陽信-石牌,2023-11-15,8711
00648R,元大S＆P500反1,71,0,71,陽信-石牌,2023-11-15,8711
6451,訊芯-KY,55,4,51,陽信-石牌,2023-11-15,8711
00795B,中信美國公債20年,30,0,30,陽信-石牌,2023-11-15,8711
6491,晶碩,44,14,30,陽信-石牌,2023-11-15,8711
3017,奇鋐,41,12,29,陽信-石牌,2023-11-15,8711
00713,元大台灣高息低波,28,0,28,陽信-石牌,2023-11-15,8711
5351,鈺創,26,0,26,陽信-石牌,2023-11-15,8711
2369,菱生,42,19,23,陽信-石牌,2023-11-15,8711
2313,華通,29,8,21,陽信-石牌,2023-11-15,8711
2323,中環,20,0,20,陽信-石牌,2023-11-15,8711
2390,云辰,20,0,20,陽信-石牌,2023-11-15,8711
2605,新興,20,0,20,陽信-石牌,2023-11-15,8711
6150,撼訊,36,16,20,陽信-石牌,2023-11-15,8711
8932,智通*,20,0,20,陽信-石牌,2023-11-15,8711
8034,榮群,19,2,17,陽信-石牌,2023-11-15,8711
2314,台揚,16,0,16,陽信-石牌,2023-11-15,8711
2383,台光電,13,0,13,陽信-石牌,2023-11-15,8711
3548,兆利,17,4,13,陽信-石牌,2023-11-15,8711
2359,所羅門,14,2,12,陽信-石牌,2023-11-15,8711
3006,晶豪科,22,11,11,陽信-石牌,2023-11-15,8711
1203,味王,11,0,11,陽信-石牌,2023-11-15,8711
1503,士電,12,1,11,陽信-石牌,2023-11-15,8711
2449,京元電子,15,4,11,陽信-石牌,2023-11-15,8711
2317,鴻海,13,2,11,陽信-石牌,2023-11-15,8711
00669R,國泰美國道瓊反1,10,0,10,陽信-石牌,2023-11-15,8711
00671R,富邦NASDAQ反1,10,0,10,陽信-石牌,2023-11-15,8711
00651R,復華香港反1,10,0,10,陽信-石牌,2023-11-15,8711
3032,偉訓,10,0,10,陽信-石牌,2023-11-15,8711
3374,精材,11,1,10,陽信-石牌,2023-11-15,8711
2607,榮運,28,19,9,陽信-石牌,2023-11-15,8711
3169,亞信,11,2,9,陽信-石牌,2023-11-15,8711
2356,英業達,19,10,9,陽信-石牌,2023-11-15,8711
00679B,元大美債20年,9,1,8,陽信-石牌,2023-11-15,8711
2884,玉山金,10,2,8,陽信-石牌,2023-11-15,8711
3051,力特,8,0,8,陽信-石牌,2023-11-15,8711
3706,神達,8,0,8,陽信-石牌,2023-11-15,8711
00642U,期元大S＆P石油,7,0,7,陽信-石牌,2023-11-15,8711
2329,華泰,47,40,7,陽信-石牌,2023-11-15,8711
2353,宏��,7,0,7,陽信-石牌,2023-11-15,8711
2427,三商電,10,3,7,陽信-石牌,2023-11-15,8711
3078,僑威,8,1,7,陽信-石牌,2023-11-15,8711
2881,富邦金,8,1,7,陽信-石牌,2023-11-15,8711
2915,潤泰全,6,0,6,陽信-石牌,2023-11-15,8711
3450,聯鈞,6,0,6,陽信-石牌,2023-11-15,8711
3228,金麗科,7,1,6,陽信-石牌,2023-11-15,8711
1723,中碳,5,0,5,陽信-石牌,2023-11-15,8711
0056,元大高股息,216,3,213,陽信-石牌,2023-11-16,8711
2885,元大金,200,0,200,陽信-石牌,2023-11-16,8711
00669R,國泰美國道瓊反1,290,120,170,陽信-石牌,2023-11-16,8711
00632R,元大台灣50反1,100,0,100,陽信-石牌,2023-11-16,8711
1802,台玻,100,0,100,陽信-石牌,2023-11-16,8711
2892,第一金,100,2,98,陽信-石牌,2023-11-16,8711
00715L,期街口布蘭特正2,59,2,57,陽信-石牌,2023-11-16,8711
4960,誠美材,40,0,40,陽信-石牌,2023-11-16,8711
2344,華邦電,50,12,38,陽信-石牌,2023-11-16,8711
00637L,元大滬深300正2,35,3,32,陽信-石牌,2023-11-16,8711
1203,味王,31,0,31,陽信-石牌,2023-11-16,8711
00878,國泰永續高股息,44,15,29,陽信-石牌,2023-11-16,8711
00857B,永豐20年美公債,24,0,24,陽信-石牌,2023-11-16,8711
2371,大同,40,20,20,陽信-石牌,2023-11-16,8711
00676R,富邦臺灣加權反1,18,0,18,陽信-石牌,2023-11-16,8711
1815,富喬,34,16,18,陽信-石牌,2023-11-16,8711
4906,正文,20,3,17,陽信-石牌,2023-11-16,8711
8054,安國,16,0,16,陽信-石牌,2023-11-16,8711
00929,復華台灣科技優息,16,0,16,陽信-石牌,2023-11-16,8711
00885,富邦越南,15,0,15,陽信-石牌,2023-11-16,8711
2014,中鴻,15,0,15,陽信-石牌,2023-11-16,8711
6158,禾昌,15,0,15,陽信-石牌,2023-11-16,8711
2382,廣達,32,18,14,陽信-石牌,2023-11-16,8711
00687B,國泰20年美債,14,0,14,陽信-石牌,2023-11-16,8711
2356,英業達,31,17,14,陽信-石牌,2023-11-16,8711
1101,台泥,13,0,13,陽信-石牌,2023-11-16,8711
3036,文曄,35,22,13,陽信-石牌,2023-11-16,8711
5425,台半,12,0,12,陽信-石牌,2023-11-16,8711
6104,創惟,12,0,12,陽信-石牌,2023-11-16,8711
2332,友訊,11,0,11,陽信-石牌,2023-11-16,8711
3260,威剛,11,0,11,陽信-石牌,2023-11-16,8711
6150,撼訊,11,0,11,陽信-石牌,2023-11-16,8711
5516,雙喜,10,0,10,陽信-石牌,2023-11-16,8711
5706,鳳凰,11,1,10,陽信-石牌,2023-11-16,8711
6138,茂達,10,0,10,陽信-石牌,2023-11-16,8711
6419,京晨科,10,0,10,陽信-石牌,2023-11-16,8711
8016,矽創,10,0,10,陽信-石牌,2023-11-16,8711
8210,勤誠,21,11,10,陽信-石牌,2023-11-16,8711
3617,碩天,9,0,9,陽信-石牌,2023-11-16,8711
6213,聯茂,9,0,9,陽信-石牌,2023-11-16,8711
3231,緯創,12,4,8,陽信-石牌,2023-11-16,8711
00679B,元大美債20年,7,0,7,陽信-石牌,2023-11-16,8711
3481,群創,7,0,7,陽信-石牌,2023-11-16,8711
5533,皇鼎,7,0,7,陽信-石牌,2023-11-16,8711
2329,華泰,89,83,6,陽信-石牌,2023-11-16,8711
3006,晶豪科,10,4,6,陽信-石牌,2023-11-16,8711
3450,聯鈞,6,0,6,陽信-石牌,2023-11-16,8711
3715,定穎投控,6,1,5,陽信-石牌,2023-11-16,8711
00648R,元大S＆P500反1,5,0,5,陽信-石牌,2023-11-16,8711
1477,聚陽,5,0,5,陽信-石牌,2023-11-16,8711
00632R,元大台灣50反1,420,0,420,陽信-石牌,2023-11-17,8711
2885,元大金,200,0,200,陽信-石牌,2023-11-17,8711
2002,中鋼,163,1,162,陽信-石牌,2023-11-17,8711
1605,華新,103,0,103,陽信-石牌,2023-11-17,8711
00671R,富邦NASDAQ反1,130,39,91,陽信-石牌,2023-11-17,8711
00637L,元大滬深300正2,83,0,83,陽信-石牌,2023-11-17,8711
2883,凱基金,103,41,62,陽信-石牌,2023-11-17,8711
00878,國泰永續高股息,57,2,55,陽信-石牌,2023-11-17,8711
9105,泰金寶-DR,50,0,50,陽信-石牌,2023-11-17,8711
2312,金寶,31,0,31,陽信-石牌,2023-11-17,8711
3041,揚智,41,10,31,陽信-石牌,2023-11-17,8711
2618,長榮航,84,57,27,陽信-石牌,2023-11-17,8711
2637,慧洋-KY,31,9,22,陽信-石牌,2023-11-17,8711
2331,精英,21,0,21,陽信-石牌,2023-11-17,8711
3276,宇環,21,0,21,陽信-石牌,2023-11-17,8711
2607,榮運,23,3,20,陽信-石牌,2023-11-17,8711
00665L,富邦�琤肭磪囓�2,49,30,19,陽信-石牌,2023-11-17,8711
2905,三商,20,2,18,陽信-石牌,2023-11-17,8711
00642U,期元大S＆P石油,16,0,16,陽信-石牌,2023-11-17,8711
1905,華紙,17,1,16,陽信-石牌,2023-11-17,8711
3231,緯創,50,34,16,陽信-石牌,2023-11-17,8711
2702,華園,20,6,14,陽信-石牌,2023-11-17,8711
6491,晶碩,27,13,14,陽信-石牌,2023-11-17,8711
00676R,富邦臺灣加權反1,13,0,13,陽信-石牌,2023-11-17,8711
1712,興農,13,0,13,陽信-石牌,2023-11-17,8711
6188,廣明,13,0,13,陽信-石牌,2023-11-17,8711
2436,偉詮電,18,6,12,陽信-石牌,2023-11-17,8711
2606,裕民,15,4,11,陽信-石牌,2023-11-17,8711
2615,萬海,10,0,10,陽信-石牌,2023-11-17,8711
1449,佳和,10,0,10,陽信-石牌,2023-11-17,8711
1506,正道,10,0,10,陽信-石牌,2023-11-17,8711
2105,正新,12,2,10,陽信-石牌,2023-11-17,8711
2486,一詮,12,2,10,陽信-石牌,2023-11-17,8711
3521,鴻翊,12,2,10,陽信-石牌,2023-11-17,8711
5388,中磊,10,0,10,陽信-石牌,2023-11-17,8711
5534,長虹,10,0,10,陽信-石牌,2023-11-17,8711
6108,競國,10,0,10,陽信-石牌,2023-11-17,8711
6158,禾昌,20,10,10,陽信-石牌,2023-11-17,8711
2707,晶華,10,1,9,陽信-石牌,2023-11-17,8711
8034,榮群,12,3,9,陽信-石牌,2023-11-17,8711
2610,華航,12,4,8,陽信-石牌,2023-11-17,8711
2736,富野,8,0,8,陽信-石牌,2023-11-17,8711
2731,雄獅,10,3,7,陽信-石牌,2023-11-17,8711
2609,陽明,7,0,7,陽信-石牌,2023-11-17,8711
2734,易飛網,8,1,7,陽信-石牌,2023-11-17,8711
6231,系微,7,0,7,陽信-石牌,2023-11-17,8711
6282,康舒,8,1,7,陽信-石牌,2023-11-17,8711
6901,鑽石投資,7,0,7,陽信-石牌,2023-11-17,8711
00715L,期街口布蘭特正2,6,0,6,陽信-石牌,2023-11-17,8711
00931B,統一美債20年,6,0,6,陽信-石牌,2023-11-17,8711
3576,聯合再生,205,5,200,陽信-石牌,2023-11-20,8711
2892,第一金,200,0,200,陽信-石牌,2023-11-20,8711
00885,富邦越南,150,0,150,陽信-石牌,2023-11-20,8711
6282,康舒,81,5,76,陽信-石牌,2023-11-20,8711
00637L,元大滬深300正2,35,0,35,陽信-石牌,2023-11-20,8711
2883,凱基金,32,0,32,陽信-石牌,2023-11-20,8711
2317,鴻海,30,1,29,陽信-石牌,2023-11-20,8711
00671R,富邦NASDAQ反1,48,20,28,陽信-石牌,2023-11-20,8711
00712,復華富時不動產,28,0,28,陽信-石牌,2023-11-20,8711
2382,廣達,45,17,28,陽信-石牌,2023-11-20,8711
6491,晶碩,25,4,21,陽信-石牌,2023-11-20,8711
2884,玉山金,20,0,20,陽信-石牌,2023-11-20,8711
2606,裕民,18,0,18,陽信-石牌,2023-11-20,8711
6125,廣運,24,6,18,陽信-石牌,2023-11-20,8711
00878,國泰永續高股息,48,31,17,陽信-石牌,2023-11-20,8711
6274,台燿,21,4,17,陽信-石牌,2023-11-20,8711
00687B,國泰20年美債,20,5,15,陽信-石牌,2023-11-20,8711
2637,慧洋-KY,20,5,15,陽信-石牌,2023-11-20,8711
3122,笙泉,15,0,15,陽信-石牌,2023-11-20,8711
2344,華邦電,18,4,14,陽信-石牌,2023-11-20,8711
8426,紅木-KY,13,0,13,陽信-石牌,2023-11-20,8711
00934,中信成長高股息,12,0,12,陽信-石牌,2023-11-20,8711
1789,神隆,12,0,12,陽信-石牌,2023-11-20,8711
2748,雲品,21,9,12,陽信-石牌,2023-11-20,8711
3708,上緯投控,12,0,12,陽信-石牌,2023-11-20,8711
2388,威盛,17,6,11,陽信-石牌,2023-11-20,8711
2462,良得電,16,5,11,陽信-石牌,2023-11-20,8711
1504,東元,32,22,10,陽信-石牌,2023-11-20,8711
00931B,統一美債20年,10,0,10,陽信-石牌,2023-11-20,8711
00935,野村臺灣新科技50,10,0,10,陽信-石牌,2023-11-20,8711
1609,大亞,10,0,10,陽信-石牌,2023-11-20,8711
1734,杏輝,10,0,10,陽信-石牌,2023-11-20,8711
2007,燁興,10,0,10,陽信-石牌,2023-11-20,8711
2328,廣宇,10,0,10,陽信-石牌,2023-11-20,8711
2342,茂矽,10,0,10,陽信-石牌,2023-11-20,8711
2458,義隆,10,0,10,陽信-石牌,2023-11-20,8711
2705,六福,10,0,10,陽信-石牌,2023-11-20,8711
2891,中信金,10,0,10,陽信-石牌,2023-11-20,8711
3047,訊舟,10,0,10,陽信-石牌,2023-11-20,8711
3373,熱映,10,0,10,陽信-石牌,2023-11-20,8711
3374,精材,10,0,10,陽信-石牌,2023-11-20,8711
4142,國光生,10,0,10,陽信-石牌,2023-11-20,8711
8034,榮群,18,8,10,陽信-石牌,2023-11-20,8711
8050,廣積,10,0,10,陽信-石牌,2023-11-20,8711
9950,萬國通,18,8,10,陽信-石牌,2023-11-20,8711
3362,先進光,10,1,9,陽信-石牌,2023-11-20,8711
3545,敦泰,18,9,9,陽信-石牌,2023-11-20,8711
6196,帆宣,9,0,9,陽信-石牌,2023-11-20,8711
6550,北極星藥業-KY,9,0,9,陽信-石牌,2023-11-20,8711
2402,毅嘉,16,8,8,陽信-石牌,2023-11-20,8711
00632R,元大台灣50反1,405,0,405,陽信-石牌,2023-11-21,8711
00931B,統一美債20年,100,0,100,陽信-石牌,2023-11-21,8711
00673R,期元大S＆P原油反1,97,0,97,陽信-石牌,2023-11-21,8711
1802,台玻,51,0,51,陽信-石牌,2023-11-21,8711
00692,富邦公司治理,50,0,50,陽信-石牌,2023-11-21,8711
2882,國泰金,52,2,50,陽信-石牌,2023-11-21,8711
2891,中信金,50,3,47,陽信-石牌,2023-11-21,8711
2462,良得電,44,0,44,陽信-石牌,2023-11-21,8711
2303,聯電,67,25,42,陽信-石牌,2023-11-21,8711
00671R,富邦NASDAQ反1,73,32,41,陽信-石牌,2023-11-21,8711
1789,神隆,38,0,38,陽信-石牌,2023-11-21,8711
2356,英業達,54,21,33,陽信-石牌,2023-11-21,8711
00764B,群益25年美債,32,0,32,陽信-石牌,2023-11-21,8711
6233,旺玖,57,25,32,陽信-石牌,2023-11-21,8711
00751B,元大AAA至A公司債,30,0,30,陽信-石牌,2023-11-21,8711
2367,燿華,40,11,29,陽信-石牌,2023-11-21,8711
0056,元大高股息,58,30,28,陽信-石牌,2023-11-21,8711
2355,敬鵬,47,21,26,陽信-石牌,2023-11-21,8711
1815,富喬,38,13,25,陽信-石牌,2023-11-21,8711
2363,矽統,44,23,21,陽信-石牌,2023-11-21,8711
6472,保瑞,24,3,21,陽信-石牌,2023-11-21,8711
00929,復華台灣科技優息,27,7,20,陽信-石牌,2023-11-21,8711
00935,野村臺灣新科技50,20,0,20,陽信-石牌,2023-11-21,8711
3149,正達,19,0,19,陽信-石牌,2023-11-21,8711
2421,建準,20,2,18,陽信-石牌,2023-11-21,8711
2382,廣達,46,30,16,陽信-石牌,2023-11-21,8711
6451,訊芯-KY,30,14,16,陽信-石牌,2023-11-21,8711
00923,群益台ESG低碳50,15,0,15,陽信-石牌,2023-11-21,8711
3268,海德威,15,0,15,陽信-石牌,2023-11-21,8711
8011,台通,18,3,15,陽信-石牌,2023-11-21,8711
2883,凱基金,17,3,14,陽信-石牌,2023-11-21,8711
6122,擎邦,12,0,12,陽信-石牌,2023-11-21,8711
1710,東聯,12,0,12,陽信-石牌,2023-11-21,8711
3041,揚智,56,44,12,陽信-石牌,2023-11-21,8711
2603,長榮,11,0,11,陽信-石牌,2023-11-21,8711
6806,森崴能源,11,0,11,陽信-石牌,2023-11-21,8711
6191,精成科,19,8,11,陽信-石牌,2023-11-21,8711
00720B,元大投資級公司債,10,0,10,陽信-石牌,2023-11-21,8711
00665L,富邦�琤肭磪囓�2,38,28,10,陽信-石牌,2023-11-21,8711
1514,亞力,10,0,10,陽信-石牌,2023-11-21,8711
2414,精技,10,0,10,陽信-石牌,2023-11-21,8711
3260,威剛,10,0,10,陽信-石牌,2023-11-21,8711
4157,太景*-KY,10,0,10,陽信-石牌,2023-11-21,8711
6901,鑽石投資,12,2,10,陽信-石牌,2023-11-21,8711
8176,智捷,10,0,10,陽信-石牌,2023-11-21,8711
3036,文曄,9,0,9,陽信-石牌,2023-11-21,8711
3163,波若威,12,3,9,陽信-石牌,2023-11-21,8711
3708,上緯投控,12,3,9,陽信-石牌,2023-11-21,8711
6158,禾昌,17,8,9,陽信-石牌,2023-11-21,8711
2486,一詮,8,0,8,陽信-石牌,2023-11-21,8711
00918,大華優利高填息30,300,0,300,陽信-石牌,2023-11-22,8711
2883,凱基金,204,0,204,陽信-石牌,2023-11-22,8711
00915,凱基優選高股息30,200,0,200,陽信-石牌,2023-11-22,8711
2885,元大金,100,0,100,陽信-石牌,2023-11-22,8711
2892,第一金,100,10,90,陽信-石牌,2023-11-22,8711
2356,英業達,74,11,63,陽信-石牌,2023-11-22,8711
00919,群益台灣精選高息,62,1,61,陽信-石牌,2023-11-22,8711
00878,國泰永續高股息,60,0,60,陽信-石牌,2023-11-22,8711
3605,宏致,60,0,60,陽信-石牌,2023-11-22,8711
6451,訊芯-KY,61,2,59,陽信-石牌,2023-11-22,8711
1203,味王,43,0,43,陽信-石牌,2023-11-22,8711
1815,富喬,42,2,40,陽信-石牌,2023-11-22,8711
1722,台肥,35,0,35,陽信-石牌,2023-11-22,8711
3231,緯創,152,118,34,陽信-石牌,2023-11-22,8711
2313,華通,41,9,32,陽信-石牌,2023-11-22,8711
3047,訊舟,48,16,32,陽信-石牌,2023-11-22,8711
00671R,富邦NASDAQ反1,50,20,30,陽信-石牌,2023-11-22,8711
00692,富邦公司治理,30,0,30,陽信-石牌,2023-11-22,8711
00637L,元大滬深300正2,30,0,30,陽信-石牌,2023-11-22,8711
00632R,元大台灣50反1,65,35,30,陽信-石牌,2023-11-22,8711
4543,萬在,31,4,27,陽信-石牌,2023-11-22,8711
00929,復華台灣科技優息,35,10,25,陽信-石牌,2023-11-22,8711
2390,云辰,25,0,25,陽信-石牌,2023-11-22,8711
2516,新建,28,3,25,陽信-石牌,2023-11-22,8711
00931B,統一美債20年,25,2,23,陽信-石牌,2023-11-22,8711
0056,元大高股息,26,4,22,陽信-石牌,2023-11-22,8711
00905,FT臺灣Smart,21,0,21,陽信-石牌,2023-11-22,8711
3325,旭品,41,20,21,陽信-石牌,2023-11-22,8711
2371,大同,20,0,20,陽信-石牌,2023-11-22,8711
4906,正文,20,0,20,陽信-石牌,2023-11-22,8711
6116,彩晶,20,0,20,陽信-石牌,2023-11-22,8711
912000,晨訊科-DR,20,0,20,陽信-石牌,2023-11-22,8711
2317,鴻海,16,3,13,陽信-石牌,2023-11-22,8711
2731,雄獅,13,0,13,陽信-石牌,2023-11-22,8711
3041,揚智,36,24,12,陽信-石牌,2023-11-22,8711
9939,宏全,11,0,11,陽信-石牌,2023-11-22,8711
3706,神達,45,35,10,陽信-石牌,2023-11-22,8711
2382,廣達,40,30,10,陽信-石牌,2023-11-22,8711
2376,技嘉,36,26,10,陽信-石牌,2023-11-22,8711
00680L,元大美債20正2,10,0,10,陽信-石牌,2023-11-22,8711
00665L,富邦�琤肭磪囓�2,10,0,10,陽信-石牌,2023-11-22,8711
1326,台化,10,0,10,陽信-石牌,2023-11-22,8711
1324,地球,11,1,10,陽信-石牌,2023-11-22,8711
2409,友達,10,0,10,陽信-石牌,2023-11-22,8711
2449,京元電子,11,1,10,陽信-石牌,2023-11-22,8711
2515,中工,10,0,10,陽信-石牌,2023-11-22,8711
2538,基泰,10,0,10,陽信-石牌,2023-11-22,8711
3290,東浦,10,0,10,陽信-石牌,2023-11-22,8711
6108,競國,10,0,10,陽信-石牌,2023-11-22,8711
8076,伍豐,10,0,10,陽信-石牌,2023-11-22,8711
2892,第一金,100,0,100,陽信-石牌,2023-11-23,8711
2449,京元電子,100,2,98,陽信-石牌,2023-11-23,8711
00918,大華優利高填息30,90,0,90,陽信-石牌,2023-11-23,8711
00671R,富邦NASDAQ反1,110,50,60,陽信-石牌,2023-11-23,8711
3078,僑威,67,18,49,陽信-石牌,2023-11-23,8711
3576,聯合再生,40,0,40,陽信-石牌,2023-11-23,8711
2457,飛宏,50,14,36,陽信-石牌,2023-11-23,8711
1313,聯成,37,3,34,陽信-石牌,2023-11-23,8711
6282,康舒,97,63,34,陽信-石牌,2023-11-23,8711
00878,國泰永續高股息,45,13,32,陽信-石牌,2023-11-23,8711
6117,迎廣,36,4,32,陽信-石牌,2023-11-23,8711
00919,群益台灣精選高息,30,0,30,陽信-石牌,2023-11-23,8711
00637L,元大滬深300正2,30,0,30,陽信-石牌,2023-11-23,8711
3708,上緯投控,29,0,29,陽信-石牌,2023-11-23,8711
6684,安格,36,8,28,陽信-石牌,2023-11-23,8711
00929,復華台灣科技優息,27,1,26,陽信-石牌,2023-11-23,8711
5521,工信,30,6,24,陽信-石牌,2023-11-23,8711
6139,亞翔,21,0,21,陽信-石牌,2023-11-23,8711
1314,中石化,20,0,20,陽信-石牌,2023-11-23,8711
3041,揚智,40,21,19,陽信-石牌,2023-11-23,8711
6237,驊訊,23,4,19,陽信-石牌,2023-11-23,8711
2637,慧洋-KY,28,10,18,陽信-石牌,2023-11-23,8711
6213,聯茂,18,0,18,陽信-石牌,2023-11-23,8711
3481,群創,16,0,16,陽信-石牌,2023-11-23,8711
2891,中信金,17,1,16,陽信-石牌,2023-11-23,8711
1213,大飲,15,0,15,陽信-石牌,2023-11-23,8711
8076,伍豐,15,0,15,陽信-石牌,2023-11-23,8711
8086,宏捷科,17,2,15,陽信-石牌,2023-11-23,8711
1203,味王,14,0,14,陽信-石牌,2023-11-23,8711
6104,創惟,18,4,14,陽信-石牌,2023-11-23,8711
2314,台揚,16,3,13,陽信-石牌,2023-11-23,8711
2516,新建,16,3,13,陽信-石牌,2023-11-23,8711
2610,華航,32,19,13,陽信-石牌,2023-11-23,8711
4543,萬在,17,4,13,陽信-石牌,2023-11-23,8711
5292,華懋,13,0,13,陽信-石牌,2023-11-23,8711
3051,力特,14,2,12,陽信-石牌,2023-11-23,8711
3006,晶豪科,34,22,12,陽信-石牌,2023-11-23,8711
3047,訊舟,14,2,12,陽信-石牌,2023-11-23,8711
3169,亞信,14,2,12,陽信-石牌,2023-11-23,8711
2382,廣達,26,15,11,陽信-石牌,2023-11-23,8711
3035,智原,10,0,10,陽信-石牌,2023-11-23,8711
0056,元大高股息,10,0,10,陽信-石牌,2023-11-23,8711
2313,華通,31,21,10,陽信-石牌,2023-11-23,8711
00632R,元大台灣50反1,10,0,10,陽信-石牌,2023-11-23,8711
1326,台化,10,0,10,陽信-石牌,2023-11-23,8711
2027,大成鋼,10,0,10,陽信-石牌,2023-11-23,8711
2344,華邦電,24,14,10,陽信-石牌,2023-11-23,8711
2538,基泰,10,0,10,陽信-石牌,2023-11-23,8711
2605,新興,10,0,10,陽信-石牌,2023-11-23,8711
3017,奇鋐,12,2,10,陽信-石牌,2023-11-23,8711
2449,京元電子,104,0,104,陽信-石牌,2023-11-24,8711
00632R,元大台灣50反1,90,30,60,陽信-石牌,2023-11-24,8711
00931B,統一美債20年,50,0,50,陽信-石牌,2023-11-24,8711
2618,長榮航,68,22,46,陽信-石牌,2023-11-24,8711
3576,聯合再生,40,0,40,陽信-石牌,2023-11-24,8711
6116,彩晶,40,3,37,陽信-石牌,2023-11-24,8711
00885,富邦越南,30,1,29,陽信-石牌,2023-11-24,8711
2329,華泰,29,1,28,陽信-石牌,2023-11-24,8711
2891,中信金,27,0,27,陽信-石牌,2023-11-24,8711
6472,保瑞,31,5,26,陽信-石牌,2023-11-24,8711
00671R,富邦NASDAQ反1,70,45,25,陽信-石牌,2023-11-24,8711
5314,世紀,25,0,25,陽信-石牌,2023-11-24,8711
3276,宇環,25,2,23,陽信-石牌,2023-11-24,8711
3231,緯創,22,1,21,陽信-石牌,2023-11-24,8711
3060,銘異,21,2,19,陽信-石牌,2023-11-24,8711
6180,橘子,20,1,19,陽信-石牌,2023-11-24,8711
3260,威剛,18,0,18,陽信-石牌,2023-11-24,8711
3437,榮創,21,3,18,陽信-石牌,2023-11-24,8711
6161,捷波,19,1,18,陽信-石牌,2023-11-24,8711
2401,凌陽,19,2,17,陽信-石牌,2023-11-24,8711
3006,晶豪科,19,2,17,陽信-石牌,2023-11-24,8711
2913,農林,16,0,16,陽信-石牌,2023-11-24,8711
1609,大亞,18,3,15,陽信-石牌,2023-11-24,8711
2630,亞航,28,14,14,陽信-石牌,2023-11-24,8711
00934,中信成長高股息,13,0,13,陽信-石牌,2023-11-24,8711
2748,雲品,20,8,12,陽信-石牌,2023-11-24,8711
5426,振發,12,0,12,陽信-石牌,2023-11-24,8711
2382,廣達,28,18,10,陽信-石牌,2023-11-24,8711
00795B,中信美國公債20年,10,0,10,陽信-石牌,2023-11-24,8711
1213,大飲,10,0,10,陽信-石牌,2023-11-24,8711
1611,中電,10,0,10,陽信-石牌,2023-11-24,8711
2353,宏��,12,2,10,陽信-石牌,2023-11-24,8711
2417,圓剛,18,8,10,陽信-石牌,2023-11-24,8711
2609,陽明,10,0,10,陽信-石牌,2023-11-24,8711
2610,華航,21,11,10,陽信-石牌,2023-11-24,8711
3047,訊舟,25,15,10,陽信-石牌,2023-11-24,8711
3230,錦明,10,0,10,陽信-石牌,2023-11-24,8711
3666,光耀,10,0,10,陽信-石牌,2023-11-24,8711
6414,樺漢,10,0,10,陽信-石牌,2023-11-24,8711
8176,智捷,10,0,10,陽信-石牌,2023-11-24,8711
9103,美德醫療-DR,20,10,10,陽信-石牌,2023-11-24,8711
2484,希華,9,0,9,陽信-石牌,2023-11-24,8711
5351,鈺創,12,3,9,陽信-石牌,2023-11-24,8711
1809,中釉,8,0,8,陽信-石牌,2023-11-24,8711
2457,飛宏,11,3,8,陽信-石牌,2023-11-24,8711
6669,緯穎,13,5,8,陽信-石牌,2023-11-24,8711
00679B,元大美債20年,7,0,7,陽信-石牌,2023-11-24,8711
2453,凌群,7,0,7,陽信-石牌,2023-11-24,8711
2838,聯邦銀,7,0,7,陽信-石牌,2023-11-24,8711
5388,中磊,7,0,7,陽信-石牌,2023-11-24,8711
2323,中環,100,0,100,陽信-石牌,2023-11-27,8711
4906,正文,100,12,88,陽信-石牌,2023-11-27,8711
2504,國產,85,0,85,陽信-石牌,2023-11-27,8711
00935,野村臺灣新科技50,61,0,61,陽信-石牌,2023-11-27,8711
00715L,期街口布蘭特正2,60,0,60,陽信-石牌,2023-11-27,8711
00637L,元大滬深300正2,87,27,60,陽信-石牌,2023-11-27,8711
2605,新興,61,1,60,陽信-石牌,2023-11-27,8711
00857B,永豐20年美公債,56,0,56,陽信-石牌,2023-11-27,8711
8299,群聯,51,0,51,陽信-石牌,2023-11-27,8711
00885,富邦越南,50,0,50,陽信-石牌,2023-11-27,8711
00632R,元大台灣50反1,60,30,30,陽信-石牌,2023-11-27,8711
2344,華邦電,31,4,27,陽信-石牌,2023-11-27,8711
2455,全新,35,9,26,陽信-石牌,2023-11-27,8711
1503,士電,28,4,24,陽信-石牌,2023-11-27,8711
00919,群益台灣精選高息,21,0,21,陽信-石牌,2023-11-27,8711
1305,華夏,20,0,20,陽信-石牌,2023-11-27,8711
1213,大飲,20,0,20,陽信-石牌,2023-11-27,8711
3576,聯合再生,20,0,20,陽信-石牌,2023-11-27,8711
6411,晶焱,20,0,20,陽信-石牌,2023-11-27,8711
1513,中興電,43,23,20,陽信-石牌,2023-11-27,8711
2402,毅嘉,24,5,19,陽信-石牌,2023-11-27,8711
6204,艾華,19,0,19,陽信-石牌,2023-11-27,8711
4167,松瑞藥,33,15,18,陽信-石牌,2023-11-27,8711
00934,中信成長高股息,18,0,18,陽信-石牌,2023-11-27,8711
2330,台積電,18,0,18,陽信-石牌,2023-11-27,8711
2382,廣達,37,20,17,陽信-石牌,2023-11-27,8711
3708,上緯投控,20,3,17,陽信-石牌,2023-11-27,8711
3017,奇鋐,21,6,15,陽信-石牌,2023-11-27,8711
1203,味王,14,0,14,陽信-石牌,2023-11-27,8711
2618,長榮航,28,15,13,陽信-石牌,2023-11-27,8711
6168,宏齊,22,9,13,陽信-石牌,2023-11-27,8711
00929,復華台灣科技優息,26,14,12,陽信-石牌,2023-11-27,8711
1314,中石化,12,0,12,陽信-石牌,2023-11-27,8711
1612,宏泰,12,0,12,陽信-石牌,2023-11-27,8711
2538,基泰,12,0,12,陽信-石牌,2023-11-27,8711
6127,九豪,27,15,12,陽信-石牌,2023-11-27,8711
3006,晶豪科,13,2,11,陽信-石牌,2023-11-27,8711
1701,中化,38,28,10,陽信-石牌,2023-11-27,8711
2014,中鴻,12,2,10,陽信-石牌,2023-11-27,8711
2106,建大,10,0,10,陽信-石牌,2023-11-27,8711
2316,楠梓電,10,0,10,陽信-石牌,2023-11-27,8711
2520,冠德,10,0,10,陽信-石牌,2023-11-27,8711
2634,漢翔,60,50,10,陽信-石牌,2023-11-27,8711
4934,太極,10,0,10,陽信-石牌,2023-11-27,8711
6180,橘子,10,0,10,陽信-石牌,2023-11-27,8711
6669,緯穎,16,6,10,陽信-石牌,2023-11-27,8711
6732,昇佳電子,10,0,10,陽信-石牌,2023-11-27,8711
6805,富世達,13,3,10,陽信-石牌,2023-11-27,8711
8222,寶一,11,1,10,陽信-石牌,2023-11-27,8711
5347,世界,15,5,10,陽信-石牌,2023-11-27,8711
1802,台玻,200,0,200,陽信-石牌,2023-11-28,8711
00632R,元大台灣50反1,101,0,101,陽信-石牌,2023-11-28,8711
00918,大華優利高填息30,70,0,70,陽信-石牌,2023-11-28,8711
00671R,富邦NASDAQ反1,90,40,50,陽信-石牌,2023-11-28,8711
2606,裕民,55,14,41,陽信-石牌,2023-11-28,8711
4114,健喬,35,2,33,陽信-石牌,2023-11-28,8711
3260,威剛,36,5,31,陽信-石牌,2023-11-28,8711
1203,味王,30,0,30,陽信-石牌,2023-11-28,8711
00885,富邦越南,26,0,26,陽信-石牌,2023-11-28,8711
2323,中環,23,0,23,陽信-石牌,2023-11-28,8711
1213,大飲,20,0,20,陽信-石牌,2023-11-28,8711
6472,保瑞,21,1,20,陽信-石牌,2023-11-28,8711
1325,恆大,20,2,18,陽信-石牌,2023-11-28,8711
2367,燿華,35,17,18,陽信-石牌,2023-11-28,8711
2462,良得電,18,0,18,陽信-石牌,2023-11-28,8711
2330,台積電,23,6,17,陽信-石牌,2023-11-28,8711
00680L,元大美債20正2,16,0,16,陽信-石牌,2023-11-28,8711
3706,神達,16,0,16,陽信-石牌,2023-11-28,8711
00923,群益台ESG低碳50,15,0,15,陽信-石牌,2023-11-28,8711
9919,康那香,20,5,15,陽信-石牌,2023-11-28,8711
2303,聯電,14,0,14,陽信-石牌,2023-11-28,8711
2383,台光電,16,2,14,陽信-石牌,2023-11-28,8711
2337,旺宏,13,0,13,陽信-石牌,2023-11-28,8711
3715,定穎投控,17,4,13,陽信-石牌,2023-11-28,8711
4106,雃博,13,0,13,陽信-石牌,2023-11-28,8711
8086,宏捷科,20,8,12,陽信-石牌,2023-11-28,8711
3041,揚智,12,1,11,陽信-石牌,2023-11-28,8711
6243,迅杰,16,5,11,陽信-石牌,2023-11-28,8711
3231,緯創,14,3,11,陽信-石牌,2023-11-28,8711
00933B,國泰10Y+金融債,10,0,10,陽信-石牌,2023-11-28,8711
00679B,元大美債20年,15,5,10,陽信-石牌,2023-11-28,8711
3221,台嘉碩,10,0,10,陽信-石牌,2023-11-28,8711
4157,太景*-KY,43,33,10,陽信-石牌,2023-11-28,8711
6120,達運,10,0,10,陽信-石牌,2023-11-28,8711
6158,禾昌,10,0,10,陽信-石牌,2023-11-28,8711
6669,緯穎,14,5,9,陽信-石牌,2023-11-28,8711
1324,地球,9,0,9,陽信-石牌,2023-11-28,8711
00712,復華富時不動產,9,0,9,陽信-石牌,2023-11-28,8711
1101,台泥,36,27,9,陽信-石牌,2023-11-28,8711
2382,廣達,20,12,8,陽信-石牌,2023-11-28,8711
6530,創威,8,0,8,陽信-石牌,2023-11-28,8711
6806,森崴能源,8,0,8,陽信-石牌,2023-11-28,8711
9802,鈺齊-KY,7,0,7,陽信-石牌,2023-11-28,8711
5351,鈺創,15,8,7,陽信-石牌,2023-11-28,8711
00676R,富邦臺灣加權反1,6,0,6,陽信-石牌,2023-11-28,8711
1342,八貫,6,0,6,陽信-石牌,2023-11-28,8711
1905,華紙,40,34,6,陽信-石牌,2023-11-28,8711
2344,華邦電,10,4,6,陽信-石牌,2023-11-28,8711
2371,大同,16,10,6,陽信-石牌,2023-11-28,8711
8942,森鉅,6,0,6,陽信-石牌,2023-11-28,8711
00632R,元大台灣50反1,270,30,240,陽信-石牌,2023-11-29,8711
00665L,富邦�琤肭磪囓�2,217,42,175,陽信-石牌,2023-11-29,8711
2504,國產,86,2,84,陽信-石牌,2023-11-29,8711
6147,頎邦,50,0,50,陽信-石牌,2023-11-29,8711
2605,新興,92,44,48,陽信-石牌,2023-11-29,8711
2637,慧洋-KY,45,5,40,陽信-石牌,2023-11-29,8711
2618,長榮航,47,10,37,陽信-石牌,2023-11-29,8711
2634,漢翔,44,7,37,陽信-石牌,2023-11-29,8711
00637L,元大滬深300正2,38,6,32,陽信-石牌,2023-11-29,8711
2601,益航,30,0,30,陽信-石牌,2023-11-29,8711
4503,金雨,30,0,30,陽信-石牌,2023-11-29,8711
3231,緯創,34,5,29,陽信-石牌,2023-11-29,8711
6282,康舒,31,2,29,陽信-石牌,2023-11-29,8711
1101,台泥,29,2,27,陽信-石牌,2023-11-29,8711
1513,中興電,31,5,26,陽信-石牌,2023-11-29,8711
00671R,富邦NASDAQ反1,50,25,25,陽信-石牌,2023-11-29,8711
1319,東陽,22,0,22,陽信-石牌,2023-11-29,8711
2356,英業達,23,1,22,陽信-石牌,2023-11-29,8711
2313,華通,70,49,21,陽信-石牌,2023-11-29,8711
1314,中石化,20,0,20,陽信-石牌,2023-11-29,8711
6538,倉和,21,1,20,陽信-石牌,2023-11-29,8711
3047,訊舟,31,14,17,陽信-石牌,2023-11-29,8711
2883,凱基金,19,3,16,陽信-石牌,2023-11-29,8711
00934,中信成長高股息,18,2,16,陽信-石牌,2023-11-29,8711
2405,輔信,16,0,16,陽信-石牌,2023-11-29,8711
2610,華航,19,3,16,陽信-石牌,2023-11-29,8711
3011,今皓,16,0,16,陽信-石牌,2023-11-29,8711
3105,穩懋,17,2,15,陽信-石牌,2023-11-29,8711
4714,永捷,15,1,14,陽信-石牌,2023-11-29,8711
8942,森鉅,14,0,14,陽信-石牌,2023-11-29,8711
1815,富喬,15,2,13,陽信-石牌,2023-11-29,8711
3163,波若威,14,1,13,陽信-石牌,2023-11-29,8711
3221,台嘉碩,11,0,11,陽信-石牌,2023-11-29,8711
4979,華星光,16,5,11,陽信-石牌,2023-11-29,8711
1305,華夏,10,0,10,陽信-石牌,2023-11-29,8711
2355,敬鵬,20,10,10,陽信-石牌,2023-11-29,8711
2358,廷鑫,11,1,10,陽信-石牌,2023-11-29,8711
2520,冠德,10,0,10,陽信-石牌,2023-11-29,8711
4171,瑞基,10,0,10,陽信-石牌,2023-11-29,8711
4968,立積,14,4,10,陽信-石牌,2023-11-29,8711
8054,安國,66,56,10,陽信-石牌,2023-11-29,8711
9944,新麗,10,0,10,陽信-石牌,2023-11-29,8711
1710,東聯,12,3,9,陽信-石牌,2023-11-29,8711
2886,兆豐金,10,1,9,陽信-石牌,2023-11-29,8711
5351,鈺創,31,22,9,陽信-石牌,2023-11-29,8711
00919,群益台灣精選高息,43,35,8,陽信-石牌,2023-11-29,8711
1701,中化,10,2,8,陽信-石牌,2023-11-29,8711
2540,愛山林,8,0,8,陽信-石牌,2023-11-29,8711
2606,裕民,8,0,8,陽信-石牌,2023-11-29,8711
3265,台星科,8,0,8,陽信-石牌,2023-11-29,8711
2323,中環,200,0,200,陽信-石牌,2023-11-30,8711
00673R,期元大S＆P原油反1,124,0,124,陽信-石牌,2023-11-30,8711
1605,華新,105,14,91,陽信-石牌,2023-11-30,8711
5348,正能量智能,60,0,60,陽信-石牌,2023-11-30,8711
1712,興農,45,0,45,陽信-石牌,2023-11-30,8711
00687B,國泰20年美債,40,1,39,陽信-石牌,2023-11-30,8711
2504,國產,37,3,34,陽信-石牌,2023-11-30,8711
1598,岱宇,33,0,33,陽信-石牌,2023-11-30,8711
2605,新興,56,25,31,陽信-石牌,2023-11-30,8711
9103,美德醫療-DR,30,0,30,陽信-石牌,2023-11-30,8711
00919,群益台灣精選高息,38,10,28,陽信-石牌,2023-11-30,8711
4188,安克,27,0,27,陽信-石牌,2023-11-30,8711
00933B,國泰10Y+金融債,24,0,24,陽信-石牌,2023-11-30,8711
9919,康那香,48,26,22,陽信-石牌,2023-11-30,8711
1203,味王,21,0,21,陽信-石牌,2023-11-30,8711
3047,訊舟,21,0,21,陽信-石牌,2023-11-30,8711
2601,益航,20,0,20,陽信-石牌,2023-11-30,8711
5521,工信,20,0,20,陽信-石牌,2023-11-30,8711
1312,國喬,19,0,19,陽信-石牌,2023-11-30,8711
1815,富喬,17,0,17,陽信-石牌,2023-11-30,8711
2313,華通,41,25,16,陽信-石牌,2023-11-30,8711
2492,華新科,20,5,15,陽信-石牌,2023-11-30,8711
2377,微星,16,2,14,陽信-石牌,2023-11-30,8711
6180,橘子,16,2,14,陽信-石牌,2023-11-30,8711
6491,晶碩,19,5,14,陽信-石牌,2023-11-30,8711
2353,宏��,30,17,13,陽信-石牌,2023-11-30,8711
6472,保瑞,14,1,13,陽信-石牌,2023-11-30,8711
6770,力積電,15,2,13,陽信-石牌,2023-11-30,8711
2867,三商壽,12,0,12,陽信-石牌,2023-11-30,8711
2002,中鋼,12,1,11,陽信-石牌,2023-11-30,8711
2344,華邦電,14,3,11,陽信-石牌,2023-11-30,8711
3481,群創,11,0,11,陽信-石牌,2023-11-30,8711
3530,晶相光,12,1,11,陽信-石牌,2023-11-30,8711
4908,前鼎,32,21,11,陽信-石牌,2023-11-30,8711
1319,東陽,10,0,10,陽信-石牌,2023-11-30,8711
1314,中石化,10,0,10,陽信-石牌,2023-11-30,8711
1213,大飲,10,0,10,陽信-石牌,2023-11-30,8711
00795B,中信美國公債20年,10,0,10,陽信-石牌,2023-11-30,8711
00897,富邦基因免疫生技,10,0,10,陽信-石牌,2023-11-30,8711
1326,台化,10,0,10,陽信-石牌,2023-11-30,8711
1727,中華化,10,0,10,陽信-石牌,2023-11-30,8711
2405,輔信,10,0,10,陽信-石牌,2023-11-30,8711
2543,皇昌,10,0,10,陽信-石牌,2023-11-30,8711
3437,榮創,10,0,10,陽信-石牌,2023-11-30,8711
5292,華懋,11,1,10,陽信-石牌,2023-11-30,8711
6188,廣明,10,0,10,陽信-石牌,2023-11-30,8711
8112,至上,13,3,10,陽信-石牌,2023-11-30,8711
8358,金居,13,3,10,陽信-石牌,2023-11-30,8711
2530,華建,10,0,10,陽信-石牌,2023-11-30,8711
0056,元大高股息,9,0,9,陽信-石牌,2023-11-30,8711
00933B,國泰10Y+金融債,200,0,200,陽信-石牌,2023-12-01,8711
1712,興農,130,1,129,陽信-石牌,2023-12-01,8711
00931B,統一美債20年,110,0,110,陽信-石牌,2023-12-01,8711
00715L,期街口布蘭特正2,70,2,68,陽信-石牌,2023-12-01,8711
00919,群益台灣精選高息,82,18,64,陽信-石牌,2023-12-01,8711
2610,華航,78,24,54,陽信-石牌,2023-12-01,8711
6233,旺玖,76,24,52,陽信-石牌,2023-12-01,8711
2206,三陽工業,50,1,49,陽信-石牌,2023-12-01,8711
2355,敬鵬,63,16,47,陽信-石牌,2023-12-01,8711
2317,鴻海,47,1,46,陽信-石牌,2023-12-01,8711
00701,國泰股利精選30,45,1,44,陽信-石牌,2023-12-01,8711
6438,迅得,42,0,42,陽信-石牌,2023-12-01,8711
2436,偉詮電,40,0,40,陽信-石牌,2023-12-01,8711
00637L,元大滬深300正2,39,0,39,陽信-石牌,2023-12-01,8711
2605,新興,62,26,36,陽信-石牌,2023-12-01,8711
2888,新光金,33,0,33,陽信-石牌,2023-12-01,8711
00878,國泰永續高股息,38,12,26,陽信-石牌,2023-12-01,8711
3276,宇環,38,12,26,陽信-石牌,2023-12-01,8711
00885,富邦越南,25,0,25,陽信-石牌,2023-12-01,8711
2367,燿華,62,40,22,陽信-石牌,2023-12-01,8711
5608,四維航,23,1,22,陽信-石牌,2023-12-01,8711
6491,晶碩,31,9,22,陽信-石牌,2023-12-01,8711
2457,飛宏,30,9,21,陽信-石牌,2023-12-01,8711
00882,中信中國高股息,20,0,20,陽信-石牌,2023-12-01,8711
00888,永豐台灣ESG,20,0,20,陽信-石牌,2023-12-01,8711
2834,臺企銀,20,0,20,陽信-石牌,2023-12-01,8711
3706,神達,48,28,20,陽信-石牌,2023-12-01,8711
00929,復華台灣科技優息,18,0,18,陽信-石牌,2023-12-01,8711
3708,上緯投控,28,10,18,陽信-石牌,2023-12-01,8711
00679B,元大美債20年,19,2,17,陽信-石牌,2023-12-01,8711
2891,中信金,17,0,17,陽信-石牌,2023-12-01,8711
6139,亞翔,19,2,17,陽信-石牌,2023-12-01,8711
6282,康舒,19,2,17,陽信-石牌,2023-12-01,8711
00669R,國泰美國道瓊反1,15,0,15,陽信-石牌,2023-12-01,8711
3518,柏騰,15,0,15,陽信-石牌,2023-12-01,8711
4157,太景*-KY,18,3,15,陽信-石牌,2023-12-01,8711
1101,台泥,15,0,15,陽信-石牌,2023-12-01,8711
2359,所羅門,21,7,14,陽信-石牌,2023-12-01,8711
2371,大同,15,1,14,陽信-石牌,2023-12-01,8711
4503,金雨,14,0,14,陽信-石牌,2023-12-01,8711
1325,恆大,13,0,13,陽信-石牌,2023-12-01,8711
1815,富喬,14,2,12,陽信-石牌,2023-12-01,8711
2022,聚亨,12,0,12,陽信-石牌,2023-12-01,8711
6257,矽格,19,7,12,陽信-石牌,2023-12-01,8711
00857B,永豐20年美公債,20,10,10,陽信-石牌,2023-12-01,8711
2027,大成鋼,13,3,10,陽信-石牌,2023-12-01,8711
2332,友訊,15,5,10,陽信-石牌,2023-12-01,8711
2816,旺旺保,10,0,10,陽信-石牌,2023-12-01,8711
5347,世界,9,0,9,陽信-石牌,2023-12-01,8711
1314,中石化,9,0,9,陽信-石牌,2023-12-01,8711
1616,億泰,384,0,384,陽信-石牌,2023-12-04,8711
2888,新光金,205,0,205,陽信-石牌,2023-12-04,8711
1605,華新,143,8,135,陽信-石牌,2023-12-04,8711
3481,群創,200,81,119,陽信-石牌,2023-12-04,8711
00933B,國泰10Y+金融債,112,0,112,陽信-石牌,2023-12-04,8711
3231,緯創,149,42,107,陽信-石牌,2023-12-04,8711
00673R,期元大S＆P原油反1,100,0,100,陽信-石牌,2023-12-04,8711
00713,元大台灣高息低波,90,0,90,陽信-石牌,2023-12-04,8711
00919,群益台灣精選高息,127,41,86,陽信-石牌,2023-12-04,8711
6180,橘子,78,0,78,陽信-石牌,2023-12-04,8711
3540,曜越,70,0,70,陽信-石牌,2023-12-04,8711
2618,長榮航,79,18,61,陽信-石牌,2023-12-04,8711
3013,晟銘電,74,32,42,陽信-石牌,2023-12-04,8711
2312,金寶,40,0,40,陽信-石牌,2023-12-04,8711
6125,廣運,48,8,40,陽信-石牌,2023-12-04,8711
1711,永光,32,0,32,陽信-石牌,2023-12-04,8711
2421,建準,32,0,32,陽信-石牌,2023-12-04,8711
5426,振發,30,1,29,陽信-石牌,2023-12-04,8711
2313,華通,50,24,26,陽信-石牌,2023-12-04,8711
3518,柏騰,22,0,22,陽信-石牌,2023-12-04,8711
00679B,元大美債20年,22,1,21,陽信-石牌,2023-12-04,8711
2444,兆勁,21,0,21,陽信-石牌,2023-12-04,8711
2528,皇普,21,0,21,陽信-石牌,2023-12-04,8711
2399,映泰,26,6,20,陽信-石牌,2023-12-04,8711
00637L,元大滬深300正2,23,4,19,陽信-石牌,2023-12-04,8711
2344,華邦電,21,2,19,陽信-石牌,2023-12-04,8711
8054,安國,25,6,19,陽信-石牌,2023-12-04,8711
2402,毅嘉,26,8,18,陽信-石牌,2023-12-04,8711
2812,台中銀,18,0,18,陽信-石牌,2023-12-04,8711
6669,緯穎,28,10,18,陽信-石牌,2023-12-04,8711
00915,凱基優選高股息30,20,4,16,陽信-石牌,2023-12-04,8711
1514,亞力,41,25,16,陽信-石牌,2023-12-04,8711
4167,松瑞藥,34,18,16,陽信-石牌,2023-12-04,8711
2330,台積電,16,0,16,陽信-石牌,2023-12-04,8711
2208,台船,15,0,15,陽信-石牌,2023-12-04,8711
2883,凱基金,21,6,15,陽信-石牌,2023-12-04,8711
6231,系微,18,3,15,陽信-石牌,2023-12-04,8711
2383,台光電,16,2,14,陽信-石牌,2023-12-04,8711
6235,華孚,15,3,12,陽信-石牌,2023-12-04,8711
2356,英業達,12,0,12,陽信-石牌,2023-12-04,8711
3041,揚智,17,5,12,陽信-石牌,2023-12-04,8711
2355,敬鵬,37,26,11,陽信-石牌,2023-12-04,8711
3687,歐買尬,12,1,11,陽信-石牌,2023-12-04,8711
5465,富驊,11,0,11,陽信-石牌,2023-12-04,8711
00929,復華台灣科技優息,16,6,10,陽信-石牌,2023-12-04,8711
1305,華夏,10,0,10,陽信-石牌,2023-12-04,8711
00665L,富邦�琤肭磪囓�2,25,15,10,陽信-石牌,2023-12-04,8711
2323,中環,10,0,10,陽信-石牌,2023-12-04,8711
2542,興富發,10,0,10,陽信-石牌,2023-12-04,8711
3032,偉訓,11,1,10,陽信-石牌,2023-12-04,8711
00918,大華優利高填息30,479,0,479,陽信-石牌,2023-12-05,8711
00937B,群益ESG投等債20,260,100,160,陽信-石牌,2023-12-05,8711
00637L,元大滬深300正2,138,0,138,陽信-石牌,2023-12-05,8711
2330,台積電,145,12,133,陽信-石牌,2023-12-05,8711
00650L,復華香港正2,109,28,81,陽信-石牌,2023-12-05,8711
2888,新光金,80,0,80,陽信-石牌,2023-12-05,8711
00715L,期街口布蘭特正2,64,0,64,陽信-石牌,2023-12-05,8711
6472,保瑞,50,1,49,陽信-石牌,2023-12-05,8711
9103,美德醫療-DR,40,0,40,陽信-石牌,2023-12-05,8711
2618,長榮航,79,45,34,陽信-石牌,2023-12-05,8711
2641,正德,50,16,34,陽信-石牌,2023-12-05,8711
2637,慧洋-KY,104,71,33,陽信-石牌,2023-12-05,8711
00878,國泰永續高股息,32,1,31,陽信-石牌,2023-12-05,8711
2489,瑞軒,31,0,31,陽信-石牌,2023-12-05,8711
2882,國泰金,31,0,31,陽信-石牌,2023-12-05,8711
00929,復華台灣科技優息,44,18,26,陽信-石牌,2023-12-05,8711
4157,太景*-KY,32,7,25,陽信-石牌,2023-12-05,8711
2609,陽明,41,17,24,陽信-石牌,2023-12-05,8711
1515,力山,23,0,23,陽信-石牌,2023-12-05,8711
3380,明泰,28,5,23,陽信-石牌,2023-12-05,8711
6168,宏齊,23,0,23,陽信-石牌,2023-12-05,8711
3231,緯創,37,16,21,陽信-石牌,2023-12-05,8711
2363,矽統,28,7,21,陽信-石牌,2023-12-05,8711
2606,裕民,39,19,20,陽信-石牌,2023-12-05,8711
00632R,元大台灣50反1,30,11,19,陽信-石牌,2023-12-05,8711
1605,華新,25,6,19,陽信-石牌,2023-12-05,8711
3037,欣興,19,2,17,陽信-石牌,2023-12-05,8711
3050,鈺德,19,2,17,陽信-石牌,2023-12-05,8711
8222,寶一,17,0,17,陽信-石牌,2023-12-05,8711
00751B,元大AAA至A公司債,15,0,15,陽信-石牌,2023-12-05,8711
2542,興富發,15,0,15,陽信-石牌,2023-12-05,8711
5347,世界,15,0,15,陽信-石牌,2023-12-05,8711
00687B,國泰20年美債,15,1,14,陽信-石牌,2023-12-05,8711
2355,敬鵬,26,12,14,陽信-石牌,2023-12-05,8711
2369,菱生,16,2,14,陽信-石牌,2023-12-05,8711
3260,威剛,14,0,14,陽信-石牌,2023-12-05,8711
6491,晶碩,22,9,13,陽信-石牌,2023-12-05,8711
00919,群益台灣精選高息,21,9,12,陽信-石牌,2023-12-05,8711
2449,京元電子,15,3,12,陽信-石牌,2023-12-05,8711
3035,智原,12,1,11,陽信-石牌,2023-12-05,8711
00923,群益台ESG低碳50,11,0,11,陽信-石牌,2023-12-05,8711
2332,友訊,21,10,11,陽信-石牌,2023-12-05,8711
2610,華航,26,15,11,陽信-石牌,2023-12-05,8711
4743,合一,10,0,10,陽信-石牌,2023-12-05,8711
00935,野村臺灣新科技50,10,0,10,陽信-石牌,2023-12-05,8711
00633L,富邦上証正2,10,0,10,陽信-石牌,2023-12-05,8711
1324,地球,10,0,10,陽信-石牌,2023-12-05,8711
1467,南緯,10,0,10,陽信-石牌,2023-12-05,8711
2367,燿華,14,4,10,陽信-石牌,2023-12-05,8711
2486,一詮,10,0,10,陽信-石牌,2023-12-05,8711
00918,大華優利高填息30,790,0,790,陽信-石牌,2023-12-06,8711
00687B,國泰20年美債,306,10,296,陽信-石牌,2023-12-06,8711
00937B,群益ESG投等債20,224,0,224,陽信-石牌,2023-12-06,8711
2323,中環,200,0,200,陽信-石牌,2023-12-06,8711
2504,國產,64,0,64,陽信-石牌,2023-12-06,8711
2605,新興,133,74,59,陽信-石牌,2023-12-06,8711
2601,益航,47,0,47,陽信-石牌,2023-12-06,8711
2542,興富發,42,0,42,陽信-石牌,2023-12-06,8711
2313,華通,43,3,40,陽信-石牌,2023-12-06,8711
3481,群創,40,0,40,陽信-石牌,2023-12-06,8711
2355,敬鵬,83,43,40,陽信-石牌,2023-12-06,8711
4933,友輝,33,0,33,陽信-石牌,2023-12-06,8711
00919,群益台灣精選高息,32,1,31,陽信-石牌,2023-12-06,8711
00915,凱基優選高股息30,30,0,30,陽信-石牌,2023-12-06,8711
8089,康全電訊,26,0,26,陽信-石牌,2023-12-06,8711
6282,康舒,25,0,25,陽信-石牌,2023-12-06,8711
3013,晟銘電,61,37,24,陽信-石牌,2023-12-06,8711
1305,華夏,20,0,20,陽信-石牌,2023-12-06,8711
6451,訊芯-KY,20,0,20,陽信-石牌,2023-12-06,8711
2538,基泰,19,0,19,陽信-石牌,2023-12-06,8711
2014,中鴻,17,0,17,陽信-石牌,2023-12-06,8711
3701,大眾控,17,0,17,陽信-石牌,2023-12-06,8711
2609,陽明,27,11,16,陽信-石牌,2023-12-06,8711
6472,保瑞,17,1,16,陽信-石牌,2023-12-06,8711
00720B,元大投資級公司債,16,1,15,陽信-石牌,2023-12-06,8711
3710,連展投控,15,1,14,陽信-石牌,2023-12-06,8711
1598,岱宇,13,0,13,陽信-石牌,2023-12-06,8711
2606,裕民,46,33,13,陽信-石牌,2023-12-06,8711
3231,緯創,24,11,13,陽信-石牌,2023-12-06,8711
1522,堤維西,14,2,12,陽信-石牌,2023-12-06,8711
6117,迎廣,16,4,12,陽信-石牌,2023-12-06,8711
1519,華城,15,4,11,陽信-石牌,2023-12-06,8711
00680L,元大美債20正2,10,0,10,陽信-石牌,2023-12-06,8711
00933B,國泰10Y+金融債,10,0,10,陽信-石牌,2023-12-06,8711
1326,台化,10,0,10,陽信-石牌,2023-12-06,8711
1603,華電,10,0,10,陽信-石牌,2023-12-06,8711
2316,楠梓電,10,0,10,陽信-石牌,2023-12-06,8711
2409,友達,10,0,10,陽信-石牌,2023-12-06,8711
3522,御嵿,10,0,10,陽信-石牌,2023-12-06,8711
3686,達能,10,0,10,陽信-石牌,2023-12-06,8711
2882,國泰金,10,1,9,陽信-石牌,2023-12-06,8711
1203,味王,9,0,9,陽信-石牌,2023-12-06,8711
1504,東元,28,19,9,陽信-石牌,2023-12-06,8711
2301,光寶科,11,2,9,陽信-石牌,2023-12-06,8711
2312,金寶,9,0,9,陽信-石牌,2023-12-06,8711
2356,英業達,10,1,9,陽信-石牌,2023-12-06,8711
2883,凱基金,9,0,9,陽信-石牌,2023-12-06,8711
6129,普誠,10,1,9,陽信-石牌,2023-12-06,8711
00642U,期元大S＆P石油,8,0,8,陽信-石牌,2023-12-06,8711
2344,華邦電,9,1,8,陽信-石牌,2023-12-06,8711
1616,億泰,113,5,108,陽信-石牌,2023-12-07,8711
8936,國統,106,6,100,陽信-石牌,2023-12-07,8711
2102,泰豐,101,7,94,陽信-石牌,2023-12-07,8711
00715L,期街口布蘭特正2,91,0,91,陽信-石牌,2023-12-07,8711
6109,亞元,80,0,80,陽信-石牌,2023-12-07,8711
00919,群益台灣精選高息,68,5,63,陽信-石牌,2023-12-07,8711
00687B,國泰20年美債,61,0,61,陽信-石牌,2023-12-07,8711
00712,復華富時不動產,60,1,59,陽信-石牌,2023-12-07,8711
00937B,群益ESG投等債20,58,0,58,陽信-石牌,2023-12-07,8711
00650L,復華香港正2,94,44,50,陽信-石牌,2023-12-07,8711
00935,野村臺灣新科技50,46,0,46,陽信-石牌,2023-12-07,8711
6233,旺玖,55,9,46,陽信-石牌,2023-12-07,8711
00918,大華優利高填息30,54,10,44,陽信-石牌,2023-12-07,8711
2637,慧洋-KY,43,0,43,陽信-石牌,2023-12-07,8711
1609,大亞,62,19,43,陽信-石牌,2023-12-07,8711
4533,協易機,42,2,40,陽信-石牌,2023-12-07,8711
2882,國泰金,38,0,38,陽信-石牌,2023-12-07,8711
4939,亞電,40,4,36,陽信-石牌,2023-12-07,8711
5426,振發,36,0,36,陽信-石牌,2023-12-07,8711
2610,華航,40,7,33,陽信-石牌,2023-12-07,8711
00680L,元大美債20正2,30,0,30,陽信-石牌,2023-12-07,8711
00688L,國泰20年美債正2,30,0,30,陽信-石牌,2023-12-07,8711
00885,富邦越南,30,3,27,陽信-石牌,2023-12-07,8711
2330,台積電,26,0,26,陽信-石牌,2023-12-07,8711
00679B,元大美債20年,27,2,25,陽信-石牌,2023-12-07,8711
2369,菱生,35,12,23,陽信-石牌,2023-12-07,8711
2444,兆勁,25,2,23,陽信-石牌,2023-12-07,8711
2601,益航,28,7,21,陽信-石牌,2023-12-07,8711
3540,曜越,21,0,21,陽信-石牌,2023-12-07,8711
2303,聯電,23,3,20,陽信-石牌,2023-12-07,8711
2489,瑞軒,20,0,20,陽信-石牌,2023-12-07,8711
5512,力麒,20,0,20,陽信-石牌,2023-12-07,8711
6126,信音,20,0,20,陽信-石牌,2023-12-07,8711
8110,華東,20,0,20,陽信-石牌,2023-12-07,8711
2888,新光金,20,0,20,陽信-石牌,2023-12-07,8711
1513,中興電,41,22,19,陽信-石牌,2023-12-07,8711
1612,宏泰,22,4,18,陽信-石牌,2023-12-07,8711
8086,宏捷科,18,0,18,陽信-石牌,2023-12-07,8711
3006,晶豪科,20,3,17,陽信-石牌,2023-12-07,8711
3706,神達,28,12,16,陽信-石牌,2023-12-07,8711
4967,十銓,19,3,16,陽信-石牌,2023-12-07,8711
2609,陽明,27,12,15,陽信-石牌,2023-12-07,8711
1313,聯成,15,0,15,陽信-石牌,2023-12-07,8711
2356,英業達,23,8,15,陽信-石牌,2023-12-07,8711
2409,友達,15,0,15,陽信-石牌,2023-12-07,8711
2891,中信金,15,0,15,陽信-石牌,2023-12-07,8711
4157,太景*-KY,15,0,15,陽信-石牌,2023-12-07,8711
5425,台半,15,0,15,陽信-石牌,2023-12-07,8711
1795,美時,16,3,13,陽信-石牌,2023-12-07,8711
6150,撼訊,14,1,13,陽信-石牌,2023-12-07,8711
00918,大華優利高填息30,280,0,280,陽信-石牌,2023-12-08,8711
00919,群益台灣精選高息,224,5,219,陽信-石牌,2023-12-08,8711
00933B,國泰10Y+金融債,181,20,161,陽信-石牌,2023-12-08,8711
2834,臺企銀,110,0,110,陽信-石牌,2023-12-08,8711
00772B,中信高評級公司債,109,0,109,陽信-石牌,2023-12-08,8711
00720B,元大投資級公司債,100,0,100,陽信-石牌,2023-12-08,8711
00673R,期元大S＆P原油反1,86,5,81,陽信-石牌,2023-12-08,8711
2641,正德,75,0,75,陽信-石牌,2023-12-08,8711
2601,益航,101,28,73,陽信-石牌,2023-12-08,8711
6491,晶碩,62,1,61,陽信-石牌,2023-12-08,8711
1313,聯成,55,0,55,陽信-石牌,2023-12-08,8711
00931B,統一美債20年,52,0,52,陽信-石牌,2023-12-08,8711
2637,慧洋-KY,54,7,47,陽信-石牌,2023-12-08,8711
2882,國泰金,43,0,43,陽信-石牌,2023-12-08,8711
2610,華航,52,10,42,陽信-石牌,2023-12-08,8711
00857B,永豐20年美公債,40,0,40,陽信-石牌,2023-12-08,8711
1609,大亞,96,56,40,陽信-石牌,2023-12-08,8711
6233,旺玖,63,24,39,陽信-石牌,2023-12-08,8711
2887,台新金,32,0,32,陽信-石牌,2023-12-08,8711
00687B,國泰20年美債,30,0,30,陽信-石牌,2023-12-08,8711
00915,凱基優選高股息30,30,0,30,陽信-石牌,2023-12-08,8711
00937B,群益ESG投等債20,29,0,29,陽信-石牌,2023-12-08,8711
00882,中信中國高股息,26,0,26,陽信-石牌,2023-12-08,8711
4906,正文,39,16,23,陽信-石牌,2023-12-08,8711
5284,jpp-KY,23,0,23,陽信-石牌,2023-12-08,8711
3481,群創,21,1,20,陽信-石牌,2023-12-08,8711
6148,驊宏資,20,0,20,陽信-石牌,2023-12-08,8711
2405,輔信,20,1,19,陽信-石牌,2023-12-08,8711
5452,佶優,17,0,17,陽信-石牌,2023-12-08,8711
5469,瀚宇博,18,1,17,陽信-石牌,2023-12-08,8711
2303,聯電,16,0,16,陽信-石牌,2023-12-08,8711
3231,緯創,47,31,16,陽信-石牌,2023-12-08,8711
2605,新興,91,76,15,陽信-石牌,2023-12-08,8711
6235,華孚,15,1,14,陽信-石牌,2023-12-08,8711
2855,統一證,13,0,13,陽信-石牌,2023-12-08,8711
6282,康舒,18,5,13,陽信-石牌,2023-12-08,8711
8155,博智,14,1,13,陽信-石牌,2023-12-08,8711
2027,大成鋼,12,0,12,陽信-石牌,2023-12-08,8711
2609,陽明,12,0,12,陽信-石牌,2023-12-08,8711
00751B,元大AAA至A公司債,11,0,11,陽信-石牌,2023-12-08,8711
00679B,元大美債20年,11,0,11,陽信-石牌,2023-12-08,8711
2888,新光金,11,0,11,陽信-石牌,2023-12-08,8711
00633L,富邦上証正2,10,0,10,陽信-石牌,2023-12-08,8711
1714,和桐,10,0,10,陽信-石牌,2023-12-08,8711
2002,中鋼,10,0,10,陽信-石牌,2023-12-08,8711
2476,鉅祥,10,0,10,陽信-石牌,2023-12-08,8711
2530,華建,10,0,10,陽信-石牌,2023-12-08,8711
2538,基泰,10,0,10,陽信-石牌,2023-12-08,8711
2542,興富發,10,0,10,陽信-石牌,2023-12-08,8711
2743,山富,10,0,10,陽信-石牌,2023-12-08,8711
00919,群益台灣精選高息,1528,13,1515,陽信-石牌,2023-12-11,8711
2882,國泰金,151,1,150,陽信-石牌,2023-12-11,8711
5351,鈺創,84,10,74,陽信-石牌,2023-12-11,8711
00937B,群益ESG投等債20,67,7,60,陽信-石牌,2023-12-11,8711
00931B,統一美債20年,60,0,60,陽信-石牌,2023-12-11,8711
2444,兆勁,52,0,52,陽信-石牌,2023-12-11,8711
00665L,富邦�琤肭磪囓�2,92,42,50,陽信-石牌,2023-12-11,8711
3694,海華,50,3,47,陽信-石牌,2023-12-11,8711
3050,鈺德,45,1,44,陽信-石牌,2023-12-11,8711
2618,長榮航,55,12,43,陽信-石牌,2023-12-11,8711
2610,華航,57,15,42,陽信-石牌,2023-12-11,8711
2605,新興,68,27,41,陽信-石牌,2023-12-11,8711
2402,毅嘉,44,6,38,陽信-石牌,2023-12-11,8711
00650L,復華香港正2,47,14,33,陽信-石牌,2023-12-11,8711
1524,耿鼎,58,27,31,陽信-石牌,2023-12-11,8711
9103,美德醫療-DR,30,0,30,陽信-石牌,2023-12-11,8711
3041,揚智,37,9,28,陽信-石牌,2023-12-11,8711
5340,建榮,27,0,27,陽信-石牌,2023-12-11,8711
00738U,期元大道瓊白銀,24,0,24,陽信-石牌,2023-12-11,8711
3078,僑威,39,16,23,陽信-石牌,2023-12-11,8711
1313,聯成,20,0,20,陽信-石牌,2023-12-11,8711
6491,晶碩,27,7,20,陽信-石牌,2023-12-11,8711
2641,正德,17,0,17,陽信-石牌,2023-12-11,8711
00878,國泰永續高股息,22,6,16,陽信-石牌,2023-12-11,8711
00720B,元大投資級公司債,16,0,16,陽信-石牌,2023-12-11,8711
4906,正文,16,0,16,陽信-石牌,2023-12-11,8711
00633L,富邦上証正2,15,0,15,陽信-石牌,2023-12-11,8711
00687B,國泰20年美債,15,0,15,陽信-石牌,2023-12-11,8711
2002,中鋼,15,0,15,陽信-石牌,2023-12-11,8711
6233,旺玖,15,0,15,陽信-石牌,2023-12-11,8711
00929,復華台灣科技優息,22,8,14,陽信-石牌,2023-12-11,8711
1312,國喬,14,0,14,陽信-石牌,2023-12-11,8711
00882,中信中國高股息,14,0,14,陽信-石牌,2023-12-11,8711
00674R,期元大S＆P黃金反1,13,0,13,陽信-石牌,2023-12-11,8711
3035,智原,26,13,13,陽信-石牌,2023-12-11,8711
3036,文曄,13,0,13,陽信-石牌,2023-12-11,8711
3260,威剛,16,3,13,陽信-石牌,2023-12-11,8711
2388,威盛,43,31,12,陽信-石牌,2023-12-11,8711
2421,建準,12,0,12,陽信-石牌,2023-12-11,8711
3234,光環,12,0,12,陽信-石牌,2023-12-11,8711
6806,森崴能源,13,1,12,陽信-石牌,2023-12-11,8711
8076,伍豐,12,0,12,陽信-石牌,2023-12-11,8711
3701,大眾控,12,1,11,陽信-石牌,2023-12-11,8711
5284,jpp-KY,11,0,11,陽信-石牌,2023-12-11,8711
1503,士電,14,4,10,陽信-石牌,2023-12-11,8711
00857B,永豐20年美公債,10,0,10,陽信-石牌,2023-12-11,8711
2323,中環,10,0,10,陽信-石牌,2023-12-11,8711
2520,冠德,10,0,10,陽信-石牌,2023-12-11,8711
2547,日勝生,10,0,10,陽信-石牌,2023-12-11,8711
2867,三商壽,10,0,10,陽信-石牌,2023-12-11,8711
00918,大華優利高填息30,1220,0,1220,陽信-石牌,2023-12-12,8711
00931B,統一美債20年,105,0,105,陽信-石牌,2023-12-12,8711
00632R,元大台灣50反1,100,0,100,陽信-石牌,2023-12-12,8711
3545,敦泰,101,1,100,陽信-石牌,2023-12-12,8711
00673R,期元大S＆P原油反1,88,0,88,陽信-石牌,2023-12-12,8711
1584,精剛,104,16,88,陽信-石牌,2023-12-12,8711
00934,中信成長高股息,69,0,69,陽信-石牌,2023-12-12,8711
2618,長榮航,79,17,62,陽信-石牌,2023-12-12,8711
1815,富喬,64,6,58,陽信-石牌,2023-12-12,8711
00712,復華富時不動產,51,0,51,陽信-石牌,2023-12-12,8711
2329,華泰,55,16,39,陽信-石牌,2023-12-12,8711
00929,復華台灣科技優息,40,4,36,陽信-石牌,2023-12-12,8711
5388,中磊,42,12,30,陽信-石牌,2023-12-12,8711
5533,皇鼎,30,0,30,陽信-石牌,2023-12-12,8711
9105,泰金寶-DR,30,0,30,陽信-石牌,2023-12-12,8711
2313,華通,47,20,27,陽信-石牌,2023-12-12,8711
2538,基泰,25,0,25,陽信-石牌,2023-12-12,8711
2363,矽統,36,12,24,陽信-石牌,2023-12-12,8711
2402,毅嘉,33,9,24,陽信-石牌,2023-12-12,8711
2605,新興,38,14,24,陽信-石牌,2023-12-12,8711
1905,華紙,60,38,22,陽信-石牌,2023-12-12,8711
2882,國泰金,25,3,22,陽信-石牌,2023-12-12,8711
3481,群創,22,0,22,陽信-石牌,2023-12-12,8711
2353,宏��,21,0,21,陽信-石牌,2023-12-12,8711
00687B,國泰20年美債,20,0,20,陽信-石牌,2023-12-12,8711
2022,聚亨,20,0,20,陽信-石牌,2023-12-12,8711
5381,合正,20,0,20,陽信-石牌,2023-12-12,8711
2816,旺旺保,18,0,18,陽信-石牌,2023-12-12,8711
00882,中信中國高股息,17,0,17,陽信-石牌,2023-12-12,8711
4908,前鼎,30,13,17,陽信-石牌,2023-12-12,8711
3231,緯創,30,14,16,陽信-石牌,2023-12-12,8711
1203,味王,16,0,16,陽信-石牌,2023-12-12,8711
2610,華航,23,7,16,陽信-石牌,2023-12-12,8711
00648R,元大S＆P500反1,15,0,15,陽信-石牌,2023-12-12,8711
00637L,元大滬深300正2,15,0,15,陽信-石牌,2023-12-12,8711
1101,台泥,15,2,13,陽信-石牌,2023-12-12,8711
0056,元大高股息,18,5,13,陽信-石牌,2023-12-12,8711
1609,大亞,24,12,12,陽信-石牌,2023-12-12,8711
2371,大同,19,7,12,陽信-石牌,2023-12-12,8711
2374,佳能,22,10,12,陽信-石牌,2023-12-12,8711
00679B,元大美債20年,11,0,11,陽信-石牌,2023-12-12,8711
00680L,元大美債20正2,10,0,10,陽信-石牌,2023-12-12,8711
00650L,復華香港正2,30,20,10,陽信-石牌,2023-12-12,8711
1616,億泰,10,0,10,陽信-石牌,2023-12-12,8711
2511,太子,10,0,10,陽信-石牌,2023-12-12,8711
3032,偉訓,10,0,10,陽信-石牌,2023-12-12,8711
3706,神達,10,0,10,陽信-石牌,2023-12-12,8711
4157,太景*-KY,10,0,10,陽信-石牌,2023-12-12,8711
6026,福邦證,10,0,10,陽信-石牌,2023-12-12,8711
6695,芯鼎,13,3,10,陽信-石牌,2023-12-12,8711
00919,群益台灣精選高息,1251,443,808,陽信-石牌,2023-12-13,8711
00933B,國泰10Y+金融債,351,0,351,陽信-石牌,2023-12-13,8711
00937B,群益ESG投等債20,205,5,200,陽信-石牌,2023-12-13,8711
0050,元大台灣50,106,4,102,陽信-石牌,2023-12-13,8711
00665L,富邦�琤肭磪囓�2,73,6,67,陽信-石牌,2023-12-13,8711
00687B,國泰20年美債,61,2,59,陽信-石牌,2023-12-13,8711
2889,國票金,59,2,57,陽信-石牌,2023-12-13,8711
00929,復華台灣科技優息,76,22,54,陽信-石牌,2023-12-13,8711
2610,華航,62,10,52,陽信-石牌,2023-12-13,8711
00715L,期街口布蘭特正2,40,0,40,陽信-石牌,2023-12-13,8711
2883,凱基金,35,2,33,陽信-石牌,2023-12-13,8711
2618,長榮航,54,21,33,陽信-石牌,2023-12-13,8711
2402,毅嘉,43,16,27,陽信-石牌,2023-12-13,8711
6284,佳邦,29,3,26,陽信-石牌,2023-12-13,8711
2882,國泰金,25,0,25,陽信-石牌,2023-12-13,8711
1584,精剛,23,0,23,陽信-石牌,2023-12-13,8711
1440,南紡,21,0,21,陽信-石牌,2023-12-13,8711
6282,康舒,21,0,21,陽信-石牌,2023-12-13,8711
3035,智原,32,12,20,陽信-石牌,2023-12-13,8711
1722,台肥,20,0,20,陽信-石牌,2023-12-13,8711
2102,泰豐,20,0,20,陽信-石牌,2023-12-13,8711
2353,宏��,33,13,20,陽信-石牌,2023-12-13,8711
00934,中信成長高股息,19,0,19,陽信-石牌,2023-12-13,8711
2371,大同,18,1,17,陽信-石牌,2023-12-13,8711
2601,益航,17,0,17,陽信-石牌,2023-12-13,8711
2313,華通,72,55,17,陽信-石牌,2023-12-13,8711
2515,中工,66,50,16,陽信-石牌,2023-12-13,8711
5347,世界,26,11,15,陽信-石牌,2023-12-13,8711
1513,中興電,16,2,14,陽信-石牌,2023-12-13,8711
1605,華新,13,0,13,陽信-石牌,2023-12-13,8711
3078,僑威,12,0,12,陽信-石牌,2023-12-13,8711
3362,先進光,13,1,12,陽信-石牌,2023-12-13,8711
2308,台達電,11,0,11,陽信-石牌,2023-12-13,8711
00720B,元大投資級公司債,11,0,11,陽信-石牌,2023-12-13,8711
1612,宏泰,22,11,11,陽信-石牌,2023-12-13,8711
4915,致伸,10,0,10,陽信-石牌,2023-12-13,8711
1519,華城,19,9,10,陽信-石牌,2023-12-13,8711
2419,仲琦,29,19,10,陽信-石牌,2023-12-13,8711
2520,冠德,10,0,10,陽信-石牌,2023-12-13,8711
2704,國賓,10,0,10,陽信-石牌,2023-12-13,8711
6026,福邦證,10,0,10,陽信-石牌,2023-12-13,8711
6148,驊宏資,10,0,10,陽信-石牌,2023-12-13,8711
6485,點序,10,0,10,陽信-石牌,2023-12-13,8711
8201,無敵,10,0,10,陽信-石牌,2023-12-13,8711
1734,杏輝,10,0,10,陽信-石牌,2023-12-13,8711
00923,群益台ESG低碳50,10,1,9,陽信-石牌,2023-12-13,8711
1615,大山,47,38,9,陽信-石牌,2023-12-13,8711
2332,友訊,20,11,9,陽信-石牌,2023-12-13,8711
3548,兆利,9,0,9,陽信-石牌,2023-12-13,8711
3711,日月光投控,11,2,9,陽信-石牌,2023-12-13,8711
00918,大華優利高填息30,1519,400,1119,陽信-石牌,2023-12-14,8711
00937B,群益ESG投等債20,185,5,180,陽信-石牌,2023-12-14,8711
00687B,國泰20年美債,111,10,101,陽信-石牌,2023-12-14,8711
3374,精材,100,0,100,陽信-石牌,2023-12-14,8711
00669R,國泰美國道瓊反1,81,0,81,陽信-石牌,2023-12-14,8711
2641,正德,68,0,68,陽信-石牌,2023-12-14,8711
2882,國泰金,89,29,60,陽信-石牌,2023-12-14,8711
00715L,期街口布蘭特正2,63,5,58,陽信-石牌,2023-12-14,8711
00882,中信中國高股息,58,0,58,陽信-石牌,2023-12-14,8711
2382,廣達,54,15,39,陽信-石牌,2023-12-14,8711
00929,復華台灣科技優息,51,14,37,陽信-石牌,2023-12-14,8711
2515,中工,61,28,33,陽信-石牌,2023-12-14,8711
2891,中信金,33,2,31,陽信-石牌,2023-12-14,8711
2409,友達,35,5,30,陽信-石牌,2023-12-14,8711
00648R,元大S＆P500反1,50,23,27,陽信-石牌,2023-12-14,8711
6937,天虹,29,2,27,陽信-石牌,2023-12-14,8711
2610,華航,28,2,26,陽信-石牌,2023-12-14,8711
00637L,元大滬深300正2,30,5,25,陽信-石牌,2023-12-14,8711
2353,宏��,32,10,22,陽信-石牌,2023-12-14,8711
2601,益航,39,17,22,陽信-石牌,2023-12-14,8711
2617,台航,22,0,22,陽信-石牌,2023-12-14,8711
6712,長聖,20,0,20,陽信-石牌,2023-12-14,8711
00885,富邦越南,22,2,20,陽信-石牌,2023-12-14,8711
9951,皇田,20,0,20,陽信-石牌,2023-12-14,8711
3362,先進光,20,1,19,陽信-石牌,2023-12-14,8711
00931B,統一美債20年,30,11,19,陽信-石牌,2023-12-14,8711
00720B,元大投資級公司債,18,0,18,陽信-石牌,2023-12-14,8711
00674R,期元大S＆P黃金反1,20,3,17,陽信-石牌,2023-12-14,8711
1598,岱宇,16,0,16,陽信-石牌,2023-12-14,8711
2355,敬鵬,17,1,16,陽信-石牌,2023-12-14,8711
1612,宏泰,15,1,14,陽信-石牌,2023-12-14,8711
6213,聯茂,14,0,14,陽信-石牌,2023-12-14,8711
3231,緯創,21,7,14,陽信-石牌,2023-12-14,8711
3617,碩天,12,0,12,陽信-石牌,2023-12-14,8711
1591,駿吉-KY,23,12,11,陽信-石牌,2023-12-14,8711
2387,精元,13,2,11,陽信-石牌,2023-12-14,8711
2425,承啟,15,4,11,陽信-石牌,2023-12-14,8711
2609,陽明,11,0,11,陽信-石牌,2023-12-14,8711
4503,金雨,11,0,11,陽信-石牌,2023-12-14,8711
00633L,富邦上証正2,10,0,10,陽信-石牌,2023-12-14,8711
1584,精剛,10,0,10,陽信-石牌,2023-12-14,8711
1618,合機,14,4,10,陽信-石牌,2023-12-14,8711
2208,台船,10,0,10,陽信-石牌,2023-12-14,8711
2801,彰銀,10,0,10,陽信-石牌,2023-12-14,8711
3032,偉訓,10,0,10,陽信-石牌,2023-12-14,8711
3373,熱映,10,0,10,陽信-石牌,2023-12-14,8711
4973,廣穎,12,2,10,陽信-石牌,2023-12-14,8711
6244,茂迪,10,0,10,陽信-石牌,2023-12-14,8711
8034,榮群,10,0,10,陽信-石牌,2023-12-14,8711
2365,昆盈,15,6,9,陽信-石牌,2023-12-14,8711
2363,矽統,118,27,91,陽信-石牌,2023-12-15,8711
00673R,期元大S＆P原油反1,100,20,80,陽信-石牌,2023-12-15,8711
00687B,國泰20年美債,117,45,72,陽信-石牌,2023-12-15,8711
00918,大華優利高填息30,69,0,69,陽信-石牌,2023-12-15,8711
00919,群益台灣精選高息,195,133,62,陽信-石牌,2023-12-15,8711
1802,台玻,62,0,62,陽信-石牌,2023-12-15,8711
1609,大亞,51,3,48,陽信-石牌,2023-12-15,8711
2356,英業達,145,103,42,陽信-石牌,2023-12-15,8711
6122,擎邦,40,0,40,陽信-石牌,2023-12-15,8711
2102,泰豐,40,0,40,陽信-石牌,2023-12-15,8711
2382,廣達,35,5,30,陽信-石牌,2023-12-15,8711
1718,中纖,30,0,30,陽信-石牌,2023-12-15,8711
1455,集盛,50,27,23,陽信-石牌,2023-12-15,8711
00651R,復華香港反1,20,0,20,陽信-石牌,2023-12-15,8711
00680L,元大美債20正2,20,0,20,陽信-石牌,2023-12-15,8711
00674R,期元大S＆P黃金反1,20,0,20,陽信-石牌,2023-12-15,8711
6491,晶碩,29,9,20,陽信-石牌,2023-12-15,8711
6901,鑽石投資,20,0,20,陽信-石牌,2023-12-15,8711
8011,台通,21,1,20,陽信-石牌,2023-12-15,8711
00720B,元大投資級公司債,23,5,18,陽信-石牌,2023-12-15,8711
2641,正德,18,0,18,陽信-石牌,2023-12-15,8711
3032,偉訓,17,0,17,陽信-石牌,2023-12-15,8711
2401,凌陽,17,1,16,陽信-石牌,2023-12-15,8711
2038,海光,15,0,15,陽信-石牌,2023-12-15,8711
6207,雷科,15,0,15,陽信-石牌,2023-12-15,8711
6170,統振,14,0,14,陽信-石牌,2023-12-15,8711
1504,東元,23,9,14,陽信-石牌,2023-12-15,8711
00713,元大台灣高息低波,15,2,13,陽信-石牌,2023-12-15,8711
1615,大山,13,0,13,陽信-石牌,2023-12-15,8711
00669R,國泰美國道瓊反1,22,10,12,陽信-石牌,2023-12-15,8711
2017,官田鋼,12,0,12,陽信-石牌,2023-12-15,8711
3005,神基,15,3,12,陽信-石牌,2023-12-15,8711
3014,聯陽,12,0,12,陽信-石牌,2023-12-15,8711
3265,台星科,12,0,12,陽信-石牌,2023-12-15,8711
3346,麗清,14,2,12,陽信-石牌,2023-12-15,8711
2887,台新金,11,0,11,陽信-石牌,2023-12-15,8711
2892,第一金,11,0,11,陽信-石牌,2023-12-15,8711
3011,今皓,11,0,11,陽信-石牌,2023-12-15,8711
3017,奇鋐,12,1,11,陽信-石牌,2023-12-15,8711
6245,立端,11,0,11,陽信-石牌,2023-12-15,8711
3041,揚智,14,4,10,陽信-石牌,2023-12-15,8711
00931B,統一美債20年,10,0,10,陽信-石牌,2023-12-15,8711
00633L,富邦上証正2,10,0,10,陽信-石牌,2023-12-15,8711
00934,中信成長高股息,15,5,10,陽信-石牌,2023-12-15,8711
1727,中華化,20,10,10,陽信-石牌,2023-12-15,8711
1806,冠軍,10,0,10,陽信-石牌,2023-12-15,8711
2236,百達-KY,10,0,10,陽信-石牌,2023-12-15,8711
2331,精英,10,0,10,陽信-石牌,2023-12-15,8711
2801,彰銀,10,0,10,陽信-石牌,2023-12-15,8711
2913,農林,10,0,10,陽信-石牌,2023-12-15,8711
0056,元大高股息,179,1,178,陽信-石牌,2023-12-18,8711
00715L,期街口布蘭特正2,100,0,100,陽信-石牌,2023-12-18,8711
3545,敦泰,100,0,100,陽信-石牌,2023-12-18,8711
00919,群益台灣精選高息,89,8,81,陽信-石牌,2023-12-18,8711
2618,長榮航,80,7,73,陽信-石牌,2023-12-18,8711
1905,華紙,104,61,43,陽信-石牌,2023-12-18,8711
00929,復華台灣科技優息,52,11,41,陽信-石牌,2023-12-18,8711
2801,彰銀,29,0,29,陽信-石牌,2023-12-18,8711
3032,偉訓,29,0,29,陽信-石牌,2023-12-18,8711
2362,藍天,24,0,24,陽信-石牌,2023-12-18,8711
9933,中鼎,24,0,24,陽信-石牌,2023-12-18,8711
2356,英業達,75,51,24,陽信-石牌,2023-12-18,8711
00680L,元大美債20正2,23,0,23,陽信-石牌,2023-12-18,8711
1907,永豐餘,20,0,20,陽信-石牌,2023-12-18,8711
2303,聯電,22,2,20,陽信-石牌,2023-12-18,8711
2530,華建,20,0,20,陽信-石牌,2023-12-18,8711
6443,元晶,23,3,20,陽信-石牌,2023-12-18,8711
8176,智捷,20,0,20,陽信-石牌,2023-12-18,8711
3189,景碩,20,0,20,陽信-石牌,2023-12-18,8711
2637,慧洋-KY,91,72,19,陽信-石牌,2023-12-18,8711
00751B,元大AAA至A公司債,18,0,18,陽信-石牌,2023-12-18,8711
6451,訊芯-KY,18,0,18,陽信-石牌,2023-12-18,8711
1789,神隆,17,0,17,陽信-石牌,2023-12-18,8711
2542,興富發,15,0,15,陽信-石牌,2023-12-18,8711
00882,中信中國高股息,14,0,14,陽信-石牌,2023-12-18,8711
2888,新光金,14,0,14,陽信-石牌,2023-12-18,8711
3037,欣興,13,0,13,陽信-石牌,2023-12-18,8711
5425,台半,16,3,13,陽信-石牌,2023-12-18,8711
8112,至上,13,0,13,陽信-石牌,2023-12-18,8711
1609,大亞,12,0,12,陽信-石牌,2023-12-18,8711
00674R,期元大S＆P黃金反1,11,0,11,陽信-石牌,2023-12-18,8711
2425,承啟,11,0,11,陽信-石牌,2023-12-18,8711
4432,銘旺實,11,0,11,陽信-石牌,2023-12-18,8711
2316,楠梓電,10,0,10,陽信-石牌,2023-12-18,8711
3041,揚智,10,0,10,陽信-石牌,2023-12-18,8711
3047,訊舟,17,7,10,陽信-石牌,2023-12-18,8711
3380,明泰,11,1,10,陽信-石牌,2023-12-18,8711
3520,華盈,10,0,10,陽信-石牌,2023-12-18,8711
4157,太景*-KY,20,10,10,陽信-石牌,2023-12-18,8711
5522,遠雄,10,0,10,陽信-石牌,2023-12-18,8711
6170,統振,10,0,10,陽信-石牌,2023-12-18,8711
00687B,國泰20年美債,15,6,9,陽信-石牌,2023-12-18,8711
00720B,元大投資級公司債,10,1,9,陽信-石牌,2023-12-18,8711
2610,華航,20,11,9,陽信-石牌,2023-12-18,8711
2611,志信,10,1,9,陽信-石牌,2023-12-18,8711
2634,漢翔,11,2,9,陽信-石牌,2023-12-18,8711
3450,聯鈞,11,2,9,陽信-石牌,2023-12-18,8711
6414,樺漢,9,0,9,陽信-石牌,2023-12-18,8711
2376,技嘉,23,14,9,陽信-石牌,2023-12-18,8711
2538,基泰,8,0,8,陽信-石牌,2023-12-18,8711
2323,中環,208,0,208,陽信-石牌,2023-12-19,8711
2820,華票,100,5,95,陽信-石牌,2023-12-19,8711
4167,松瑞藥,96,8,88,陽信-石牌,2023-12-19,8711
2610,華航,74,6,68,陽信-石牌,2023-12-19,8711
00712,復華富時不動產,66,5,61,陽信-石牌,2023-12-19,8711
00929,復華台灣科技優息,114,60,54,陽信-石牌,2023-12-19,8711
2882,國泰金,48,0,48,陽信-石牌,2023-12-19,8711
00919,群益台灣精選高息,46,5,41,陽信-石牌,2023-12-19,8711
2618,長榮航,50,9,41,陽信-石牌,2023-12-19,8711
00918,大華優利高填息30,30,0,30,陽信-石牌,2023-12-19,8711
00937B,群益ESG投等債20,29,0,29,陽信-石牌,2023-12-19,8711
2344,華邦電,78,50,28,陽信-石牌,2023-12-19,8711
2023,燁輝,25,0,25,陽信-石牌,2023-12-19,8711
1101,台泥,25,0,25,陽信-石牌,2023-12-19,8711
1609,大亞,23,0,23,陽信-石牌,2023-12-19,8711
2801,彰銀,22,0,22,陽信-石牌,2023-12-19,8711
1513,中興電,32,11,21,陽信-石牌,2023-12-19,8711
3532,台勝科,21,0,21,陽信-石牌,2023-12-19,8711
2356,英業達,26,6,20,陽信-石牌,2023-12-19,8711
3006,晶豪科,24,4,20,陽信-石牌,2023-12-19,8711
8477,創業家,20,0,20,陽信-石牌,2023-12-19,8711
6472,保瑞,31,12,19,陽信-石牌,2023-12-19,8711
6138,茂達,20,3,17,陽信-石牌,2023-12-19,8711
2888,新光金,22,6,16,陽信-石牌,2023-12-19,8711
2365,昆盈,16,1,15,陽信-石牌,2023-12-19,8711
3481,群創,21,6,15,陽信-石牌,2023-12-19,8711
4147,中裕,15,0,15,陽信-石牌,2023-12-19,8711
3105,穩懋,15,2,13,陽信-石牌,2023-12-19,8711
6669,緯穎,13,0,13,陽信-石牌,2023-12-19,8711
2462,良得電,15,3,12,陽信-石牌,2023-12-19,8711
2530,華建,12,0,12,陽信-石牌,2023-12-19,8711
2883,凱基金,12,0,12,陽信-石牌,2023-12-19,8711
00720B,元大投資級公司債,21,10,11,陽信-石牌,2023-12-19,8711
00642U,期元大S＆P石油,11,0,11,陽信-石牌,2023-12-19,8711
00934,中信成長高股息,11,0,11,陽信-石牌,2023-12-19,8711
2515,中工,14,3,11,陽信-石牌,2023-12-19,8711
2601,益航,11,0,11,陽信-石牌,2023-12-19,8711
1722,台肥,10,0,10,陽信-石牌,2023-12-19,8711
6443,元晶,15,5,10,陽信-石牌,2023-12-19,8711
8016,矽創,10,0,10,陽信-石牌,2023-12-19,8711
8176,智捷,10,0,10,陽信-石牌,2023-12-19,8711
5351,鈺創,19,10,9,陽信-石牌,2023-12-19,8711
5522,遠雄,9,0,9,陽信-石牌,2023-12-19,8711
2538,基泰,8,0,8,陽信-石牌,2023-12-19,8711
2548,華固,8,0,8,陽信-石牌,2023-12-19,8711
2903,遠百,8,0,8,陽信-石牌,2023-12-19,8711
9951,皇田,8,0,8,陽信-石牌,2023-12-19,8711
00933B,國泰10Y+金融債,7,0,7,陽信-石牌,2023-12-19,8711
6274,台燿,7,0,7,陽信-石牌,2023-12-19,8711
6491,晶碩,7,0,7,陽信-石牌,2023-12-19,8711
00712,復華富時不動產,160,0,160,陽信-石牌,2023-12-20,8711
00919,群益台灣精選高息,113,0,113,陽信-石牌,2023-12-20,8711
1905,華紙,129,31,98,陽信-石牌,2023-12-20,8711
2356,英業達,154,74,80,陽信-石牌,2023-12-20,8711
00929,復華台灣科技優息,87,10,77,陽信-石牌,2023-12-20,8711
2102,泰豐,60,0,60,陽信-石牌,2023-12-20,8711
5521,工信,67,12,55,陽信-石牌,2023-12-20,8711
00679B,元大美債20年,43,1,42,陽信-石牌,2023-12-20,8711
2609,陽明,130,94,36,陽信-石牌,2023-12-20,8711
00934,中信成長高股息,32,0,32,陽信-石牌,2023-12-20,8711
1609,大亞,30,2,28,陽信-石牌,2023-12-20,8711
2882,國泰金,38,10,28,陽信-石牌,2023-12-20,8711
00882,中信中國高股息,27,0,27,陽信-石牌,2023-12-20,8711
3011,今皓,27,0,27,陽信-石牌,2023-12-20,8711
00931B,統一美債20年,24,0,24,陽信-石牌,2023-12-20,8711
2891,中信金,25,1,24,陽信-石牌,2023-12-20,8711
6451,訊芯-KY,23,1,22,陽信-石牌,2023-12-20,8711
00680L,元大美債20正2,20,0,20,陽信-石牌,2023-12-20,8711
1584,精剛,18,1,17,陽信-石牌,2023-12-20,8711
1815,富喬,16,0,16,陽信-石牌,2023-12-20,8711
00642U,期元大S＆P石油,17,2,15,陽信-石牌,2023-12-20,8711
2913,農林,35,20,15,陽信-石牌,2023-12-20,8711
1712,興農,13,0,13,陽信-石牌,2023-12-20,8711
1319,東陽,12,0,12,陽信-石牌,2023-12-20,8711
2303,聯電,13,1,12,陽信-石牌,2023-12-20,8711
1582,信錦,11,0,11,陽信-石牌,2023-12-20,8711
2363,矽統,11,0,11,陽信-石牌,2023-12-20,8711
3035,智原,12,1,11,陽信-石牌,2023-12-20,8711
3712,永崴投控,11,0,11,陽信-石牌,2023-12-20,8711
6156,松上,13,2,11,陽信-石牌,2023-12-20,8711
6244,茂迪,11,0,11,陽信-石牌,2023-12-20,8711
8112,至上,11,0,11,陽信-石牌,2023-12-20,8711
00669R,國泰美國道瓊反1,10,0,10,陽信-石牌,2023-12-20,8711
00700,富邦�琤肭磪�,10,0,10,陽信-石牌,2023-12-20,8711
1717,長興,10,0,10,陽信-石牌,2023-12-20,8711
2337,旺宏,10,0,10,陽信-石牌,2023-12-20,8711
3006,晶豪科,13,3,10,陽信-石牌,2023-12-20,8711
2615,萬海,22,12,10,陽信-石牌,2023-12-20,8711
00674R,期元大S＆P黃金反1,10,1,9,陽信-石牌,2023-12-20,8711
3017,奇鋐,13,4,9,陽信-石牌,2023-12-20,8711
6125,廣運,10,1,9,陽信-石牌,2023-12-20,8711
6147,頎邦,13,4,9,陽信-石牌,2023-12-20,8711
8068,全達,10,1,9,陽信-石牌,2023-12-20,8711
0056,元大高股息,18,10,8,陽信-石牌,2023-12-20,8711
00933B,國泰10Y+金融債,8,0,8,陽信-石牌,2023-12-20,8711
2344,華邦電,8,0,8,陽信-石牌,2023-12-20,8711
1522,堤維西,7,0,7,陽信-石牌,2023-12-20,8711
2402,毅嘉,8,1,7,陽信-石牌,2023-12-20,8711
2538,基泰,7,0,7,陽信-石牌,2023-12-20,8711
9950,萬國通,7,0,7,陽信-石牌,2023-12-20,8711
2324,仁寶,221,43,178,陽信-石牌,2023-12-21,8711
2330,台積電,118,2,116,陽信-石牌,2023-12-21,8711
00937B,群益ESG投等債20,100,0,100,陽信-石牌,2023-12-21,8711
00929,復華台灣科技優息,80,5,75,陽信-石牌,2023-12-21,8711
00919,群益台灣精選高息,75,1,74,陽信-石牌,2023-12-21,8711
2886,兆豐金,58,0,58,陽信-石牌,2023-12-21,8711
2014,中鴻,45,8,37,陽信-石牌,2023-12-21,8711
00882,中信中國高股息,38,3,35,陽信-石牌,2023-12-21,8711
6443,元晶,36,2,34,陽信-石牌,2023-12-21,8711
2323,中環,42,11,31,陽信-石牌,2023-12-21,8711
2344,華邦電,51,25,26,陽信-石牌,2023-12-21,8711
6547,高端疫苗,22,0,22,陽信-石牌,2023-12-21,8711
2331,精英,24,3,21,陽信-石牌,2023-12-21,8711
00934,中信成長高股息,20,0,20,陽信-石牌,2023-12-21,8711
2374,佳能,20,0,20,陽信-石牌,2023-12-21,8711
8033,雷虎,20,0,20,陽信-石牌,2023-12-21,8711
1513,中興電,20,1,19,陽信-石牌,2023-12-21,8711
00878,國泰永續高股息,33,15,18,陽信-石牌,2023-12-21,8711
1325,恆大,39,21,18,陽信-石牌,2023-12-21,8711
2362,藍天,30,13,17,陽信-石牌,2023-12-21,8711
6491,晶碩,17,0,17,陽信-石牌,2023-12-21,8711
3035,智原,18,2,16,陽信-石牌,2023-12-21,8711
00933B,國泰10Y+金融債,24,10,14,陽信-石牌,2023-12-21,8711
2615,萬海,49,36,13,陽信-石牌,2023-12-21,8711
2913,農林,15,3,12,陽信-石牌,2023-12-21,8711
1319,東陽,13,2,11,陽信-石牌,2023-12-21,8711
1616,億泰,11,0,11,陽信-石牌,2023-12-21,8711
2748,雲品,12,1,11,陽信-石牌,2023-12-21,8711
2897,王道銀行,11,0,11,陽信-石牌,2023-12-21,8711
00936,台新永續高息中小,10,0,10,陽信-石牌,2023-12-21,8711
00898,國泰基因免疫革命,10,0,10,陽信-石牌,2023-12-21,8711
00671R,富邦NASDAQ反1,10,0,10,陽信-石牌,2023-12-21,8711
1326,台化,10,0,10,陽信-石牌,2023-12-21,8711
1789,神隆,10,0,10,陽信-石牌,2023-12-21,8711
3045,台灣大,10,0,10,陽信-石牌,2023-12-21,8711
3576,聯合再生,10,0,10,陽信-石牌,2023-12-21,8711
8222,寶一,26,16,10,陽信-石牌,2023-12-21,8711
2303,聯電,9,0,9,陽信-石牌,2023-12-21,8711
00687B,國泰20年美債,13,5,8,陽信-石牌,2023-12-21,8711
1795,美時,8,0,8,陽信-石牌,2023-12-21,8711
2023,燁輝,8,0,8,陽信-石牌,2023-12-21,8711
2613,中櫃,8,0,8,陽信-石牌,2023-12-21,8711
6472,保瑞,13,5,8,陽信-石牌,2023-12-21,8711
6733,博晟生醫,8,0,8,陽信-石牌,2023-12-21,8711
9919,康那香,33,25,8,陽信-石牌,2023-12-21,8711
1732,毛寶,21,14,7,陽信-石牌,2023-12-21,8711
2881,富邦金,7,0,7,陽信-石牌,2023-12-21,8711
8110,華東,40,33,7,陽信-石牌,2023-12-21,8711
2317,鴻海,9,3,6,陽信-石牌,2023-12-21,8711
2520,冠德,6,0,6,陽信-石牌,2023-12-21,8711
00715L,期街口布蘭特正2,104,1,103,陽信-石牌,2023-12-22,8711
2356,英業達,114,44,70,陽信-石牌,2023-12-22,8711
00687B,國泰20年美債,66,0,66,陽信-石牌,2023-12-22,8711
5348,正能量智能,63,0,63,陽信-石牌,2023-12-22,8711
00679B,元大美債20年,62,0,62,陽信-石牌,2023-12-22,8711
1314,中石化,46,0,46,陽信-石牌,2023-12-22,8711
1905,華紙,50,4,46,陽信-石牌,2023-12-22,8711
2543,皇昌,37,1,36,陽信-石牌,2023-12-22,8711
2897,王道銀行,27,0,27,陽信-石牌,2023-12-22,8711
1598,岱宇,26,0,26,陽信-石牌,2023-12-22,8711
2027,大成鋼,22,0,22,陽信-石牌,2023-12-22,8711
00933B,國泰10Y+金融債,21,0,21,陽信-石牌,2023-12-22,8711
6233,旺玖,49,28,21,陽信-石牌,2023-12-22,8711
5009,榮剛,21,1,20,陽信-石牌,2023-12-22,8711
1802,台玻,20,0,20,陽信-石牌,2023-12-22,8711
2105,正新,21,1,20,陽信-石牌,2023-12-22,8711
2405,輔信,20,0,20,陽信-石牌,2023-12-22,8711
9103,美德醫療-DR,30,10,20,陽信-石牌,2023-12-22,8711
9105,泰金寶-DR,20,0,20,陽信-石牌,2023-12-22,8711
9950,萬國通,20,0,20,陽信-石牌,2023-12-22,8711
2913,農林,19,0,19,陽信-石牌,2023-12-22,8711
3231,緯創,27,9,18,陽信-石牌,2023-12-22,8711
00795B,中信美國公債20年,17,0,17,陽信-石牌,2023-12-22,8711
2323,中環,21,5,16,陽信-石牌,2023-12-22,8711
1313,聯成,15,0,15,陽信-石牌,2023-12-22,8711
00937B,群益ESG投等債20,13,0,13,陽信-石牌,2023-12-22,8711
2892,第一金,13,0,13,陽信-石牌,2023-12-22,8711
3005,神基,24,11,13,陽信-石牌,2023-12-22,8711
2331,精英,17,5,12,陽信-石牌,2023-12-22,8711
00931B,統一美債20年,11,0,11,陽信-石牌,2023-12-22,8711
2355,敬鵬,12,1,11,陽信-石牌,2023-12-22,8711
3260,威剛,13,2,11,陽信-石牌,2023-12-22,8711
8996,高力,12,1,11,陽信-石牌,2023-12-22,8711
1326,台化,10,0,10,陽信-石牌,2023-12-22,8711
00772B,中信高評級公司債,10,0,10,陽信-石牌,2023-12-22,8711
00720B,元大投資級公司債,10,0,10,陽信-石牌,2023-12-22,8711
1815,富喬,15,5,10,陽信-石牌,2023-12-22,8711
2022,聚亨,10,0,10,陽信-石牌,2023-12-22,8711
2312,金寶,10,0,10,陽信-石牌,2023-12-22,8711
2388,威盛,15,5,10,陽信-石牌,2023-12-22,8711
4157,太景*-KY,10,0,10,陽信-石牌,2023-12-22,8711
8926,台汽電,10,0,10,陽信-石牌,2023-12-22,8711
00751B,元大AAA至A公司債,9,0,9,陽信-石牌,2023-12-22,8711
2637,慧洋-KY,39,30,9,陽信-石牌,2023-12-22,8711
2704,國賓,9,0,9,陽信-石牌,2023-12-22,8711
3540,曜越,13,4,9,陽信-石牌,2023-12-22,8711
8034,榮群,9,0,9,陽信-石牌,2023-12-22,8711
00929,復華台灣科技優息,8,0,8,陽信-石牌,2023-12-22,8711
4147,中裕,14,6,8,陽信-石牌,2023-12-22,8711
5521,工信,16,8,8,陽信-石牌,2023-12-22,8711
00919,群益台灣精選高息,419,25,394,陽信-石牌,2023-12-25,8711
2610,華航,196,37,159,陽信-石牌,2023-12-25,8711
9105,泰金寶-DR,110,0,110,陽信-石牌,2023-12-25,8711
2609,陽明,184,76,108,陽信-石牌,2023-12-25,8711
2605,新興,104,25,79,陽信-石牌,2023-12-25,8711
2618,長榮航,99,39,60,陽信-石牌,2023-12-25,8711
2601,益航,58,1,57,陽信-石牌,2023-12-25,8711
1789,神隆,46,0,46,陽信-石牌,2023-12-25,8711
00878,國泰永續高股息,47,4,43,陽信-石牌,2023-12-25,8711
5469,瀚宇博,42,0,42,陽信-石牌,2023-12-25,8711
9103,美德醫療-DR,30,0,30,陽信-石牌,2023-12-25,8711
2617,台航,29,0,29,陽信-石牌,2023-12-25,8711
2637,慧洋-KY,29,2,27,陽信-石牌,2023-12-25,8711
2615,萬海,96,70,26,陽信-石牌,2023-12-25,8711
4915,致伸,24,0,24,陽信-石牌,2023-12-25,8711
2014,中鴻,35,12,23,陽信-石牌,2023-12-25,8711
2606,裕民,22,1,21,陽信-石牌,2023-12-25,8711
2388,威盛,29,9,20,陽信-石牌,2023-12-25,8711
6147,頎邦,20,0,20,陽信-石牌,2023-12-25,8711
6170,統振,20,0,20,陽信-石牌,2023-12-25,8711
00679B,元大美債20年,16,0,16,陽信-石牌,2023-12-25,8711
6781,AES-KY,16,0,16,陽信-石牌,2023-12-25,8711
2704,國賓,15,0,15,陽信-石牌,2023-12-25,8711
2324,仁寶,58,44,14,陽信-石牌,2023-12-25,8711
1905,華紙,23,10,13,陽信-石牌,2023-12-25,8711
2344,華邦電,17,4,13,陽信-石牌,2023-12-25,8711
6472,保瑞,12,0,12,陽信-石牌,2023-12-25,8711
2425,承啟,12,0,12,陽信-石牌,2023-12-25,8711
8088,品安,12,0,12,陽信-石牌,2023-12-25,8711
00751B,元大AAA至A公司債,11,0,11,陽信-石牌,2023-12-25,8711
3686,達能,10,0,10,陽信-石牌,2023-12-25,8711
6111,大宇資,10,0,10,陽信-石牌,2023-12-25,8711
6120,達運,10,0,10,陽信-石牌,2023-12-25,8711
8110,華東,10,0,10,陽信-石牌,2023-12-25,8711
00738U,期元大道瓊白銀,9,0,9,陽信-石牌,2023-12-25,8711
1314,中石化,9,0,9,陽信-石牌,2023-12-25,8711
3083,網龍,9,0,9,陽信-石牌,2023-12-25,8711
4533,協易機,9,0,9,陽信-石牌,2023-12-25,8711
4906,正文,13,4,9,陽信-石牌,2023-12-25,8711
5284,jpp-KY,9,0,9,陽信-石牌,2023-12-25,8711
5521,工信,15,6,9,陽信-石牌,2023-12-25,8711
6278,台表科,9,0,9,陽信-石牌,2023-12-25,8711
1313,聯成,10,2,8,陽信-石牌,2023-12-25,8711
2530,華建,8,0,8,陽信-石牌,2023-12-25,8711
00712,復華富時不動產,7,0,7,陽信-石牌,2023-12-25,8711
2038,海光,17,10,7,陽信-石牌,2023-12-25,8711
2421,建準,13,6,7,陽信-石牌,2023-12-25,8711
2883,凱基金,10,3,7,陽信-石牌,2023-12-25,8711
2382,廣達,14,7,7,陽信-石牌,2023-12-25,8711
2449,京元電子,7,1,6,陽信-石牌,2023-12-25,8711
9105,泰金寶-DR,607,0,607,陽信-石牌,2023-12-26,8711
2323,中環,200,41,159,陽信-石牌,2023-12-26,8711
00720B,元大投資級公司債,81,0,81,陽信-石牌,2023-12-26,8711
0056,元大高股息,81,19,62,陽信-石牌,2023-12-26,8711
00687B,國泰20年美債,57,5,52,陽信-石牌,2023-12-26,8711
2610,華航,42,9,33,陽信-石牌,2023-12-26,8711
2615,萬海,36,6,30,陽信-石牌,2023-12-26,8711
3122,笙泉,27,2,25,陽信-石牌,2023-12-26,8711
4167,松瑞藥,20,0,20,陽信-石牌,2023-12-26,8711
4533,協易機,20,0,20,陽信-石牌,2023-12-26,8711
1513,中興電,19,0,19,陽信-石牌,2023-12-26,8711
2102,泰豐,20,1,19,陽信-石牌,2023-12-26,8711
4142,國光生,19,0,19,陽信-石牌,2023-12-26,8711
00929,復華台灣科技優息,25,7,18,陽信-石牌,2023-12-26,8711
2618,長榮航,22,5,17,陽信-石牌,2023-12-26,8711
5521,工信,18,1,17,陽信-石牌,2023-12-26,8711
00680L,元大美債20正2,15,0,15,陽信-石牌,2023-12-26,8711
2417,圓剛,17,2,15,陽信-石牌,2023-12-26,8711
2634,漢翔,14,1,13,陽信-石牌,2023-12-26,8711
3264,欣銓,13,0,13,陽信-石牌,2023-12-26,8711
00919,群益台灣精選高息,14,2,12,陽信-石牌,2023-12-26,8711
2365,昆盈,16,4,12,陽信-石牌,2023-12-26,8711
3231,緯創,23,12,11,陽信-石牌,2023-12-26,8711
00882,中信中國高股息,10,0,10,陽信-石牌,2023-12-26,8711
00633L,富邦上証正2,10,0,10,陽信-石牌,2023-12-26,8711
1711,永光,10,0,10,陽信-石牌,2023-12-26,8711
2352,佳世達,14,4,10,陽信-石牌,2023-12-26,8711
5498,凱崴,10,0,10,陽信-石牌,2023-12-26,8711
6117,迎廣,15,5,10,陽信-石牌,2023-12-26,8711
8110,華東,10,0,10,陽信-石牌,2023-12-26,8711
1519,華城,14,5,9,陽信-石牌,2023-12-26,8711
2881,富邦金,12,5,7,陽信-石牌,2023-12-26,8711
3071,協禧,7,0,7,陽信-石牌,2023-12-26,8711
6166,凌華,7,0,7,陽信-石牌,2023-12-26,8711
3669,圓展,6,0,6,陽信-石牌,2023-12-26,8711
6558,興能高,7,1,6,陽信-石牌,2023-12-26,8711
8050,廣積,5,0,5,陽信-石牌,2023-12-26,8711
00665L,富邦�琤肭磪囓�2,17,12,5,陽信-石牌,2023-12-26,8711
00877,復華中國5G,5,0,5,陽信-石牌,2023-12-26,8711
2736,富野,5,0,5,陽信-石牌,2023-12-26,8711
3032,偉訓,5,0,5,陽信-石牌,2023-12-26,8711
3043,科風,5,0,5,陽信-石牌,2023-12-26,8711
3450,聯鈞,5,0,5,陽信-石牌,2023-12-26,8711
3588,通嘉,5,0,5,陽信-石牌,2023-12-26,8711
4503,金雨,5,0,5,陽信-石牌,2023-12-26,8711
6147,頎邦,5,0,5,陽信-石牌,2023-12-26,8711
1582,信錦,5,1,4,陽信-石牌,2023-12-26,8711
00679B,元大美債20年,4,0,4,陽信-石牌,2023-12-26,8711
1337,再生-KY,4,0,4,陽信-石牌,2023-12-26,8711
00937B,群益ESG投等債20,54,50,4,陽信-石牌,2023-12-26,8711
00937B,群益ESG投等債20,377,40,337,陽信-石牌,2023-12-27,8711
00720B,元大投資級公司債,164,0,164,陽信-石牌,2023-12-27,8711
00858,永豐美國500大,100,0,100,陽信-石牌,2023-12-27,8711
3231,緯創,78,4,74,陽信-石牌,2023-12-27,8711
9105,泰金寶-DR,75,4,71,陽信-石牌,2023-12-27,8711
00687B,國泰20年美債,69,0,69,陽信-石牌,2023-12-27,8711
2367,燿華,51,0,51,陽信-石牌,2023-12-27,8711
2353,宏��,104,55,49,陽信-石牌,2023-12-27,8711
2356,英業達,107,64,43,陽信-石牌,2023-12-27,8711
8936,國統,45,3,42,陽信-石牌,2023-12-27,8711
2027,大成鋼,40,0,40,陽信-石牌,2023-12-27,8711
2543,皇昌,41,1,40,陽信-石牌,2023-12-27,8711
00679B,元大美債20年,35,0,35,陽信-石牌,2023-12-27,8711
3545,敦泰,36,3,33,陽信-石牌,2023-12-27,8711
4157,太景*-KY,30,0,30,陽信-石牌,2023-12-27,8711
1905,華紙,25,0,25,陽信-石牌,2023-12-27,8711
1733,五鼎,21,2,19,陽信-石牌,2023-12-27,8711
6442,光聖,16,0,16,陽信-石牌,2023-12-27,8711
2882,國泰金,19,3,16,陽信-石牌,2023-12-27,8711
00632R,元大台灣50反1,15,0,15,陽信-石牌,2023-12-27,8711
8039,台虹,22,8,14,陽信-石牌,2023-12-27,8711
2337,旺宏,15,2,13,陽信-石牌,2023-12-27,8711
2405,輔信,45,32,13,陽信-石牌,2023-12-27,8711
1603,華電,12,0,12,陽信-石牌,2023-12-27,8711
2402,毅嘉,52,40,12,陽信-石牌,2023-12-27,8711
6488,環球晶,11,0,11,陽信-石牌,2023-12-27,8711
8110,華東,11,0,11,陽信-石牌,2023-12-27,8711
00650L,復華香港正2,30,20,10,陽信-石牌,2023-12-27,8711
2362,藍天,20,10,10,陽信-石牌,2023-12-27,8711
6235,華孚,10,0,10,陽信-石牌,2023-12-27,8711
2884,玉山金,10,0,10,陽信-石牌,2023-12-27,8711
00933B,國泰10Y+金融債,9,0,9,陽信-石牌,2023-12-27,8711
2317,鴻海,10,1,9,陽信-石牌,2023-12-27,8711
2388,威盛,14,5,9,陽信-石牌,2023-12-27,8711
8096,擎亞,13,4,9,陽信-石牌,2023-12-27,8711
2409,友達,12,4,8,陽信-石牌,2023-12-27,8711
4533,協易機,8,0,8,陽信-石牌,2023-12-27,8711
6288,聯嘉,15,7,8,陽信-石牌,2023-12-27,8711
3479,安勤,7,0,7,陽信-石牌,2023-12-27,8711
5309,系統電,7,0,7,陽信-石牌,2023-12-27,8711
6472,保瑞,16,9,7,陽信-石牌,2023-12-27,8711
00929,復華台灣科技優息,9,3,6,陽信-石牌,2023-12-27,8711
00878,國泰永續高股息,12,6,6,陽信-石牌,2023-12-27,8711
2365,昆盈,10,4,6,陽信-石牌,2023-12-27,8711
3380,明泰,10,4,6,陽信-石牌,2023-12-27,8711
6170,統振,6,0,6,陽信-石牌,2023-12-27,8711
6282,康舒,29,23,6,陽信-石牌,2023-12-27,8711
8942,森鉅,6,0,6,陽信-石牌,2023-12-27,8711
8996,高力,6,0,6,陽信-石牌,2023-12-27,8711
6209,今國光,6,0,6,陽信-石牌,2023-12-27,8711
2449,京元電子,209,15,194,陽信-石牌,2023-12-28,8711
00937B,群益ESG投等債20,86,0,86,陽信-石牌,2023-12-28,8711
2610,華航,72,0,72,陽信-石牌,2023-12-28,8711
00936,台新永續高息中小,70,0,70,陽信-石牌,2023-12-28,8711
00637L,元大滬深300正2,77,24,53,陽信-石牌,2023-12-28,8711
0056,元大高股息,46,0,46,陽信-石牌,2023-12-28,8711
2362,藍天,65,20,45,陽信-石牌,2023-12-28,8711
1514,亞力,67,22,45,陽信-石牌,2023-12-28,8711
00651R,復華香港反1,35,0,35,陽信-石牌,2023-12-28,8711
2102,泰豐,30,0,30,陽信-石牌,2023-12-28,8711
2380,虹光,30,0,30,陽信-石牌,2023-12-28,8711
00929,復華台灣科技優息,63,34,29,陽信-石牌,2023-12-28,8711
3438,類比科,48,21,27,陽信-石牌,2023-12-28,8711
6233,旺玖,23,1,22,陽信-石牌,2023-12-28,8711
2601,益航,33,13,20,陽信-石牌,2023-12-28,8711
4503,金雨,20,0,20,陽信-石牌,2023-12-28,8711
2367,燿華,16,0,16,陽信-石牌,2023-12-28,8711
2637,慧洋-KY,17,1,16,陽信-石牌,2023-12-28,8711
00919,群益台灣精選高息,23,8,15,陽信-石牌,2023-12-28,8711
5347,世界,16,2,14,陽信-石牌,2023-12-28,8711
2352,佳世達,21,8,13,陽信-石牌,2023-12-28,8711
00934,中信成長高股息,13,1,12,陽信-石牌,2023-12-28,8711
2365,昆盈,25,13,12,陽信-石牌,2023-12-28,8711
2607,榮運,12,0,12,陽信-石牌,2023-12-28,8711
3305,昇貿,12,0,12,陽信-石牌,2023-12-28,8711
3548,兆利,16,4,12,陽信-石牌,2023-12-28,8711
2369,菱生,14,3,11,陽信-石牌,2023-12-28,8711
2618,長榮航,16,5,11,陽信-石牌,2023-12-28,8711
6152,百一,11,0,11,陽信-石牌,2023-12-28,8711
2022,聚亨,20,10,10,陽信-石牌,2023-12-28,8711
2743,山富,10,0,10,陽信-石牌,2023-12-28,8711
2010,春源,10,0,10,陽信-石牌,2023-12-28,8711
2603,長榮,11,1,10,陽信-石牌,2023-12-28,8711
2612,中航,10,0,10,陽信-石牌,2023-12-28,8711
3024,憶聲,12,2,10,陽信-石牌,2023-12-28,8711
3041,揚智,10,0,10,陽信-石牌,2023-12-28,8711
6806,森崴能源,11,1,10,陽信-石牌,2023-12-28,8711
1319,東陽,11,2,9,陽信-石牌,2023-12-28,8711
6488,環球晶,10,1,9,陽信-石牌,2023-12-28,8711
6901,鑽石投資,12,3,9,陽信-石牌,2023-12-28,8711
2405,輔信,22,14,8,陽信-石牌,2023-12-28,8711
5426,振發,10,2,8,陽信-石牌,2023-12-28,8711
3483,力致,12,5,7,陽信-石牌,2023-12-28,8711
3630,新鉅科,7,0,7,陽信-石牌,2023-12-28,8711
4908,前鼎,8,1,7,陽信-石牌,2023-12-28,8711
00878,國泰永續高股息,17,11,6,陽信-石牌,2023-12-28,8711
00795B,中信美國公債20年,6,0,6,陽信-石牌,2023-12-28,8711
00918,大華優利高填息30,6,0,6,陽信-石牌,2023-12-28,8711
2462,良得電,6,0,6,陽信-石牌,2023-12-28,8711
3537,堡達,6,0,6,陽信-石牌,2023-12-28,8711
00937B,群益ESG投等債20,48,0,48,陽信-石牌,2023-12-29,8711
00929,復華台灣科技優息,47,1,46,陽信-石牌,2023-12-29,8711
3706,神達,67,22,45,陽信-石牌,2023-12-29,8711
3006,晶豪科,42,1,41,陽信-石牌,2023-12-29,8711
2412,中華電,25,0,25,陽信-石牌,2023-12-29,8711
2515,中工,31,7,24,陽信-石牌,2023-12-29,8711
2303,聯電,31,7,24,陽信-石牌,2023-12-29,8711
00687B,國泰20年美債,23,0,23,陽信-石牌,2023-12-29,8711
4147,中裕,35,12,23,陽信-石牌,2023-12-29,8711
2409,友達,30,9,21,陽信-石牌,2023-12-29,8711
2356,英業達,46,25,21,陽信-石牌,2023-12-29,8711
3380,明泰,21,0,21,陽信-石牌,2023-12-29,8711
1504,東元,30,10,20,陽信-石牌,2023-12-29,8711
00725B,國泰投資級公司債,20,0,20,陽信-石牌,2023-12-29,8711
2472,立隆電,21,2,19,陽信-石牌,2023-12-29,8711
5452,佶優,16,0,16,陽信-石牌,2023-12-29,8711
00751B,元大AAA至A公司債,15,0,15,陽信-石牌,2023-12-29,8711
8112,至上,19,5,14,陽信-石牌,2023-12-29,8711
1503,士電,21,8,13,陽信-石牌,2023-12-29,8711
00919,群益台灣精選高息,13,0,13,陽信-石牌,2023-12-29,8711
2601,益航,13,0,13,陽信-石牌,2023-12-29,8711
00637L,元大滬深300正2,22,10,12,陽信-石牌,2023-12-29,8711
2417,圓剛,12,0,12,陽信-石牌,2023-12-29,8711
2637,慧洋-KY,13,2,11,陽信-石牌,2023-12-29,8711
6187,萬潤,16,5,11,陽信-石牌,2023-12-29,8711
5483,中美晶,18,8,10,陽信-石牌,2023-12-29,8711
00669R,國泰美國道瓊反1,10,0,10,陽信-石牌,2023-12-29,8711
00933B,國泰10Y+金融債,10,0,10,陽信-石牌,2023-12-29,8711
2482,連宇,10,0,10,陽信-石牌,2023-12-29,8711
8222,寶一,10,0,10,陽信-石牌,2023-12-29,8711
9105,泰金寶-DR,10,0,10,陽信-石牌,2023-12-29,8711
3260,威剛,11,3,8,陽信-石牌,2023-12-29,8711
3548,兆利,8,0,8,陽信-石牌,2023-12-29,8711
6233,旺玖,8,0,8,陽信-石牌,2023-12-29,8711
2402,毅嘉,7,0,7,陽信-石牌,2023-12-29,8711
2465,麗臺,7,0,7,陽信-石牌,2023-12-29,8711
2606,裕民,7,0,7,陽信-石牌,2023-12-29,8711
4973,廣穎,8,1,7,陽信-石牌,2023-12-29,8711
1314,中石化,6,0,6,陽信-石牌,2023-12-29,8711
5344,立衛,6,0,6,陽信-石牌,2023-12-29,8711
6166,凌華,6,0,6,陽信-石牌,2023-12-29,8711
6179,亞通,6,0,6,陽信-石牌,2023-12-29,8711
1513,中興電,6,1,5,陽信-石牌,2023-12-29,8711
00674R,期元大S＆P黃金反1,5,0,5,陽信-石牌,2023-12-29,8711
1591,駿吉-KY,5,0,5,陽信-石牌,2023-12-29,8711
1616,億泰,8,3,5,陽信-石牌,2023-12-29,8711
2324,仁寶,27,22,5,陽信-石牌,2023-12-29,8711
2344,華邦電,17,12,5,陽信-石牌,2023-12-29,8711
2462,良得電,5,0,5,陽信-石牌,2023-12-29,8711
2520,冠德,5,0,5,陽信-石牌,2023-12-29,8711
0056,元大高股息,235,5,230,陽信-石牌,2024-01-02,8711
6163,華電網,159,0,159,陽信-石牌,2024-01-02,8711
2609,陽明,193,77,116,陽信-石牌,2024-01-02,8711
2303,聯電,73,2,71,陽信-石牌,2024-01-02,8711
3231,緯創,83,20,63,陽信-石牌,2024-01-02,8711
2382,廣達,46,3,43,陽信-石牌,2024-01-02,8711
9945,潤泰新,44,2,42,陽信-石牌,2024-01-02,8711
00751B,元大AAA至A公司債,38,0,38,陽信-石牌,2024-01-02,8711
00712,復華富時不動產,37,0,37,陽信-石牌,2024-01-02,8711
9105,泰金寶-DR,35,0,35,陽信-石牌,2024-01-02,8711
2605,新興,32,0,32,陽信-石牌,2024-01-02,8711
00878,國泰永續高股息,32,1,31,陽信-石牌,2024-01-02,8711
2352,佳世達,21,1,20,陽信-石牌,2024-01-02,8711
2489,瑞軒,20,0,20,陽信-石牌,2024-01-02,8711
2324,仁寶,33,15,18,陽信-石牌,2024-01-02,8711
3013,晟銘電,18,0,18,陽信-石牌,2024-01-02,8711
6233,旺玖,18,0,18,陽信-石牌,2024-01-02,8711
6781,AES-KY,18,0,18,陽信-石牌,2024-01-02,8711
2353,宏��,24,9,15,陽信-石牌,2024-01-02,8711
3006,晶豪科,20,5,15,陽信-石牌,2024-01-02,8711
00680L,元大美債20正2,14,0,14,陽信-石牌,2024-01-02,8711
5425,台半,13,0,13,陽信-石牌,2024-01-02,8711
2356,英業達,54,41,13,陽信-石牌,2024-01-02,8711
6841,長佳智能,13,0,13,陽信-石牌,2024-01-02,8711
2704,國賓,11,0,11,陽信-石牌,2024-01-02,8711
00720B,元大投資級公司債,10,0,10,陽信-石牌,2024-01-02,8711
4906,正文,10,0,10,陽信-石牌,2024-01-02,8711
912000,晨訊科-DR,10,0,10,陽信-石牌,2024-01-02,8711
2882,國泰金,10,1,9,陽信-石牌,2024-01-02,8711
3037,欣興,12,3,9,陽信-石牌,2024-01-02,8711
5258,虹堡,9,0,9,陽信-石牌,2024-01-02,8711
6215,和椿,9,0,9,陽信-石牌,2024-01-02,8711
00934,中信成長高股息,8,0,8,陽信-石牌,2024-01-02,8711
2369,菱生,11,3,8,陽信-石牌,2024-01-02,8711
2851,中再保,8,0,8,陽信-石牌,2024-01-02,8711
3044,健鼎,8,0,8,陽信-石牌,2024-01-02,8711
5515,建國,13,5,8,陽信-石牌,2024-01-02,8711
6547,高端疫苗,8,0,8,陽信-石牌,2024-01-02,8711
00931B,統一美債20年,7,0,7,陽信-石牌,2024-01-02,8711
2337,旺宏,10,3,7,陽信-石牌,2024-01-02,8711
2344,華邦電,17,11,6,陽信-石牌,2024-01-02,8711
3260,威剛,6,0,6,陽信-石牌,2024-01-02,8711
3532,台勝科,6,0,6,陽信-石牌,2024-01-02,8711
00935,野村臺灣新科技50,5,0,5,陽信-石牌,2024-01-02,8711
00919,群益台灣精選高息,13,8,5,陽信-石牌,2024-01-02,8711
00674R,期元大S＆P黃金反1,5,0,5,陽信-石牌,2024-01-02,8711
00669R,國泰美國道瓊反1,5,0,5,陽信-石牌,2024-01-02,8711
1612,宏泰,5,0,5,陽信-石牌,2024-01-02,8711
2313,華通,6,1,5,陽信-石牌,2024-01-02,8711
2392,正崴,15,10,5,陽信-石牌,2024-01-02,8711
00632R,元大台灣50反1,400,5,395,陽信-石牌,2024-01-03,8711
00937B,群益ESG投等債20,249,0,249,陽信-石牌,2024-01-03,8711
2610,華航,131,0,131,陽信-石牌,2024-01-03,8711
2618,長榮航,157,38,119,陽信-石牌,2024-01-03,8711
6163,華電網,125,29,96,陽信-石牌,2024-01-03,8711
00770,國泰北美科技,90,0,90,陽信-石牌,2024-01-03,8711
4938,和碩,80,4,76,陽信-石牌,2024-01-03,8711
3231,緯創,115,41,74,陽信-石牌,2024-01-03,8711
00673R,期元大S＆P原油反1,72,0,72,陽信-石牌,2024-01-03,8711
00919,群益台灣精選高息,105,39,66,陽信-石牌,2024-01-03,8711
00929,復華台灣科技優息,73,9,64,陽信-石牌,2024-01-03,8711
6239,力成,60,0,60,陽信-石牌,2024-01-03,8711
1802,台玻,51,0,51,陽信-石牌,2024-01-03,8711
2882,國泰金,52,1,51,陽信-石牌,2024-01-03,8711
00715L,期街口布蘭特正2,48,0,48,陽信-石牌,2024-01-03,8711
2344,華邦電,67,24,43,陽信-石牌,2024-01-03,8711
2704,國賓,40,0,40,陽信-石牌,2024-01-03,8711
3481,群創,37,0,37,陽信-石牌,2024-01-03,8711
6235,華孚,34,0,34,陽信-石牌,2024-01-03,8711
2317,鴻海,35,3,32,陽信-石牌,2024-01-03,8711
2324,仁寶,34,5,29,陽信-石牌,2024-01-03,8711
2515,中工,30,1,29,陽信-石牌,2024-01-03,8711
5426,振發,36,10,26,陽信-石牌,2024-01-03,8711
2455,全新,25,0,25,陽信-石牌,2024-01-03,8711
00934,中信成長高股息,25,0,25,陽信-石牌,2024-01-03,8711
00795B,中信美國公債20年,30,5,25,陽信-石牌,2024-01-03,8711
6116,彩晶,23,0,23,陽信-石牌,2024-01-03,8711
1905,華紙,26,10,16,陽信-石牌,2024-01-03,8711
5483,中美晶,16,0,16,陽信-石牌,2024-01-03,8711
5425,台半,15,0,15,陽信-石牌,2024-01-03,8711
3438,類比科,14,0,14,陽信-石牌,2024-01-03,8711
2330,台積電,16,2,14,陽信-石牌,2024-01-03,8711
00882,中信中國高股息,13,0,13,陽信-石牌,2024-01-03,8711
00720B,元大投資級公司債,12,0,12,陽信-石牌,2024-01-03,8711
2409,友達,14,2,12,陽信-石牌,2024-01-03,8711
2885,元大金,12,0,12,陽信-石牌,2024-01-03,8711
2887,台新金,12,0,12,陽信-石牌,2024-01-03,8711
6108,競國,13,1,12,陽信-石牌,2024-01-03,8711
3260,威剛,11,0,11,陽信-石牌,2024-01-03,8711
00650L,復華香港正2,10,0,10,陽信-石牌,2024-01-03,8711
00915,凱基優選高股息30,10,0,10,陽信-石牌,2024-01-03,8711
00904,新光臺灣半導體30,10,0,10,陽信-石牌,2024-01-03,8711
00891,中信關鍵半導體,10,0,10,陽信-石牌,2024-01-03,8711
00933B,國泰10Y+金融債,10,0,10,陽信-石牌,2024-01-03,8711
00931B,統一美債20年,10,0,10,陽信-石牌,2024-01-03,8711
1612,宏泰,10,0,10,陽信-石牌,2024-01-03,8711
2316,楠梓電,10,0,10,陽信-石牌,2024-01-03,8711
2883,凱基金,10,0,10,陽信-石牌,2024-01-03,8711
2888,新光金,10,0,10,陽信-石牌,2024-01-03,8711
5324,士開,10,0,10,陽信-石牌,2024-01-03,8711
9105,泰金寶-DR,250,10,240,陽信-石牌,2024-01-04,8711
2605,新興,118,30,88,陽信-石牌,2024-01-04,8711
00929,復華台灣科技優息,74,0,74,陽信-石牌,2024-01-04,8711
2303,聯電,63,2,61,陽信-石牌,2024-01-04,8711
2419,仲琦,65,5,60,陽信-石牌,2024-01-04,8711
00878,國泰永續高股息,48,0,48,陽信-石牌,2024-01-04,8711
00637L,元大滬深300正2,46,5,41,陽信-石牌,2024-01-04,8711
00927,群益半導體收益,39,0,39,陽信-石牌,2024-01-04,8711
2882,國泰金,46,10,36,陽信-石牌,2024-01-04,8711
00712,復華富時不動產,33,2,31,陽信-石牌,2024-01-04,8711
2449,京元電子,31,0,31,陽信-石牌,2024-01-04,8711
5521,工信,46,15,31,陽信-石牌,2024-01-04,8711
4938,和碩,30,2,28,陽信-石牌,2024-01-04,8711
2353,宏��,48,21,27,陽信-石牌,2024-01-04,8711
2352,佳世達,41,16,25,陽信-石牌,2024-01-04,8711
3380,明泰,26,2,24,陽信-石牌,2024-01-04,8711
2884,玉山金,23,0,23,陽信-石牌,2024-01-04,8711
3231,緯創,60,37,23,陽信-石牌,2024-01-04,8711
2323,中環,73,51,22,陽信-石牌,2024-01-04,8711
2618,長榮航,38,18,20,陽信-石牌,2024-01-04,8711
00937B,群益ESG投等債20,19,0,19,陽信-石牌,2024-01-04,8711
2324,仁寶,20,1,19,陽信-石牌,2024-01-04,8711
00665L,富邦�琤肭磪囓�2,26,9,17,陽信-石牌,2024-01-04,8711
6443,元晶,17,0,17,陽信-石牌,2024-01-04,8711
6290,良維,27,10,17,陽信-石牌,2024-01-04,8711
3260,威剛,17,0,17,陽信-石牌,2024-01-04,8711
3479,安勤,16,0,16,陽信-石牌,2024-01-04,8711
6451,訊芯-KY,16,0,16,陽信-石牌,2024-01-04,8711
00720B,元大投資級公司債,15,0,15,陽信-石牌,2024-01-04,8711
2369,菱生,15,0,15,陽信-石牌,2024-01-04,8711
4533,協易機,15,0,15,陽信-石牌,2024-01-04,8711
2486,一詮,18,4,14,陽信-石牌,2024-01-04,8711
2704,國賓,13,0,13,陽信-石牌,2024-01-04,8711
3033,威健,13,0,13,陽信-石牌,2024-01-04,8711
3706,神達,36,24,12,陽信-石牌,2024-01-04,8711
6547,高端疫苗,17,5,12,陽信-石牌,2024-01-04,8711
6841,長佳智能,12,0,12,陽信-石牌,2024-01-04,8711
00751B,元大AAA至A公司債,11,0,11,陽信-石牌,2024-01-04,8711
2515,中工,18,7,11,陽信-石牌,2024-01-04,8711
3390,旭軟,11,0,11,陽信-石牌,2024-01-04,8711
4906,正文,11,0,11,陽信-石牌,2024-01-04,8711
6233,旺玖,14,3,11,陽信-石牌,2024-01-04,8711
4743,合一,10,0,10,陽信-石牌,2024-01-04,8711
00674R,期元大S＆P黃金反1,10,0,10,陽信-石牌,2024-01-04,8711
00933B,國泰10Y+金融債,10,0,10,陽信-石牌,2024-01-04,8711
00892,富邦台灣半導體,10,0,10,陽信-石牌,2024-01-04,8711
1815,富喬,10,0,10,陽信-石牌,2024-01-04,8711
3372,典範,10,0,10,陽信-石牌,2024-01-04,8711
6275,元山,12,2,10,陽信-石牌,2024-01-04,8711
9934,成霖,10,0,10,陽信-石牌,2024-01-04,8711
2610,華航,240,0,240,陽信-石牌,2024-01-05,8711
2323,中環,176,2,174,陽信-石牌,2024-01-05,8711
00936,台新永續高息中小,120,0,120,陽信-石牌,2024-01-05,8711
00738U,期元大道瓊白銀,86,1,85,陽信-石牌,2024-01-05,8711
2605,新興,66,11,55,陽信-石牌,2024-01-05,8711
00919,群益台灣精選高息,55,0,55,陽信-石牌,2024-01-05,8711
8096,擎亞,54,3,51,陽信-石牌,2024-01-05,8711
00929,復華台灣科技優息,40,0,40,陽信-石牌,2024-01-05,8711
2353,宏��,61,24,37,陽信-石牌,2024-01-05,8711
2324,仁寶,36,0,36,陽信-石牌,2024-01-05,8711
2618,長榮航,51,20,31,陽信-石牌,2024-01-05,8711
00931B,統一美債20年,30,0,30,陽信-石牌,2024-01-05,8711
2601,益航,30,0,30,陽信-石牌,2024-01-05,8711
2885,元大金,28,0,28,陽信-石牌,2024-01-05,8711
00720B,元大投資級公司債,36,13,23,陽信-石牌,2024-01-05,8711
00665L,富邦�琤肭磪囓�2,57,35,22,陽信-石牌,2024-01-05,8711
2704,國賓,22,0,22,陽信-石牌,2024-01-05,8711
00933B,國泰10Y+金融債,20,0,20,陽信-石牌,2024-01-05,8711
9105,泰金寶-DR,20,0,20,陽信-石牌,2024-01-05,8711
3044,健鼎,19,0,19,陽信-石牌,2024-01-05,8711
00937B,群益ESG投等債20,17,0,17,陽信-石牌,2024-01-05,8711
6443,元晶,16,0,16,陽信-石牌,2024-01-05,8711
1609,大亞,18,3,15,陽信-石牌,2024-01-05,8711
3037,欣興,16,1,15,陽信-石牌,2024-01-05,8711
6108,競國,15,0,15,陽信-石牌,2024-01-05,8711
2344,華邦電,18,4,14,陽信-石牌,2024-01-05,8711
6781,AES-KY,14,0,14,陽信-石牌,2024-01-05,8711
00679B,元大美債20年,13,0,13,陽信-石牌,2024-01-05,8711
00687B,國泰20年美債,26,13,13,陽信-石牌,2024-01-05,8711
1325,恆大,16,3,13,陽信-石牌,2024-01-05,8711
00927,群益半導體收益,15,2,13,陽信-石牌,2024-01-05,8711
3231,緯創,37,24,13,陽信-石牌,2024-01-05,8711
2330,台積電,15,2,13,陽信-石牌,2024-01-05,8711
4906,正文,12,0,12,陽信-石牌,2024-01-05,8711
5223,安力-KY,15,3,12,陽信-石牌,2024-01-05,8711
00712,復華富時不動產,11,0,11,陽信-石牌,2024-01-05,8711
00900,富邦特選高股息30,10,0,10,陽信-石牌,2024-01-05,8711
1319,東陽,10,0,10,陽信-石牌,2024-01-05,8711
1213,大飲,10,0,10,陽信-石牌,2024-01-05,8711
00935,野村臺灣新科技50,10,0,10,陽信-石牌,2024-01-05,8711
2014,中鴻,10,0,10,陽信-石牌,2024-01-05,8711
2208,台船,15,5,10,陽信-石牌,2024-01-05,8711
2641,正德,21,11,10,陽信-石牌,2024-01-05,8711
2882,國泰金,12,2,10,陽信-石牌,2024-01-05,8711
00934,中信成長高股息,9,0,9,陽信-石牌,2024-01-05,8711
2332,友訊,9,0,9,陽信-石牌,2024-01-05,8711
5483,中美晶,9,0,9,陽信-石牌,2024-01-05,8711
3406,玉晶光,9,0,9,陽信-石牌,2024-01-05,8711
2352,佳世達,11,3,8,陽信-石牌,2024-01-05,8711
2615,萬海,19,11,8,陽信-石牌,2024-01-05,8711
00632R,元大台灣50反1,203,0,203,陽信-石牌,2024-01-08,8711
6770,力積電,190,9,181,陽信-石牌,2024-01-08,8711
00936,台新永續高息中小,97,0,97,陽信-石牌,2024-01-08,8711
1314,中石化,100,20,80,陽信-石牌,2024-01-08,8711
2388,威盛,77,21,56,陽信-石牌,2024-01-08,8711
00687B,國泰20年美債,41,0,41,陽信-石牌,2024-01-08,8711
8011,台通,52,11,41,陽信-石牌,2024-01-08,8711
00931B,統一美債20年,40,0,40,陽信-石牌,2024-01-08,8711
2323,中環,40,0,40,陽信-石牌,2024-01-08,8711
2882,國泰金,54,17,37,陽信-石牌,2024-01-08,8711
2615,萬海,44,7,37,陽信-石牌,2024-01-08,8711
00665L,富邦�琤肭磪囓�2,84,48,36,陽信-石牌,2024-01-08,8711
2303,聯電,41,6,35,陽信-石牌,2024-01-08,8711
2102,泰豐,30,0,30,陽信-石牌,2024-01-08,8711
2317,鴻海,30,4,26,陽信-石牌,2024-01-08,8711
2704,國賓,24,0,24,陽信-石牌,2024-01-08,8711
2405,輔信,22,0,22,陽信-石牌,2024-01-08,8711
00937B,群益ESG投等債20,21,0,21,陽信-石牌,2024-01-08,8711
3491,昇達科,24,3,21,陽信-石牌,2024-01-08,8711
00919,群益台灣精選高息,20,0,20,陽信-石牌,2024-01-08,8711
3041,揚智,20,0,20,陽信-石牌,2024-01-08,8711
9103,美德醫療-DR,28,8,20,陽信-石牌,2024-01-08,8711
5284,jpp-KY,18,1,17,陽信-石牌,2024-01-08,8711
2486,一詮,17,0,17,陽信-石牌,2024-01-08,8711
3017,奇鋐,15,0,15,陽信-石牌,2024-01-08,8711
3437,榮創,15,0,15,陽信-石牌,2024-01-08,8711
00650L,復華香港正2,29,16,13,陽信-石牌,2024-01-08,8711
6235,華孚,13,0,13,陽信-石牌,2024-01-08,8711
3006,晶豪科,25,14,11,陽信-石牌,2024-01-08,8711
1217,愛之味,10,0,10,陽信-石牌,2024-01-08,8711
00679B,元大美債20年,10,0,10,陽信-石牌,2024-01-08,8711
00927,群益半導體收益,10,0,10,陽信-石牌,2024-01-08,8711
00772B,中信高評級公司債,10,0,10,陽信-石牌,2024-01-08,8711
2324,仁寶,35,25,10,陽信-石牌,2024-01-08,8711
2329,華泰,11,1,10,陽信-石牌,2024-01-08,8711
2369,菱生,10,0,10,陽信-石牌,2024-01-08,8711
3711,日月光投控,10,0,10,陽信-石牌,2024-01-08,8711
00751B,元大AAA至A公司債,9,0,9,陽信-石牌,2024-01-08,8711
00669R,國泰美國道瓊反1,9,0,9,陽信-石牌,2024-01-08,8711
00688L,國泰20年美債正2,9,0,9,陽信-石牌,2024-01-08,8711
2352,佳世達,13,4,9,陽信-石牌,2024-01-08,8711
2520,冠德,10,1,9,陽信-石牌,2024-01-08,8711
2454,聯發科,11,2,9,陽信-石牌,2024-01-08,8711
00712,復華富時不動產,8,0,8,陽信-石牌,2024-01-08,8711
2607,榮運,8,0,8,陽信-石牌,2024-01-08,8711
2609,陽明,45,37,8,陽信-石牌,2024-01-08,8711
2640,大車隊,8,0,8,陽信-石牌,2024-01-08,8711
2353,宏��,38,31,7,陽信-石牌,2024-01-08,8711
00720B,元大投資級公司債,7,0,7,陽信-石牌,2024-01-08,8711
00671R,富邦NASDAQ反1,7,0,7,陽信-石牌,2024-01-08,8711
00919,群益台灣精選高息,213,55,158,陽信-石牌,2024-01-09,8711
2609,陽明,197,66,131,陽信-石牌,2024-01-09,8711
2610,華航,107,3,104,陽信-石牌,2024-01-09,8711
6282,康舒,78,0,78,陽信-石牌,2024-01-09,8711
2601,益航,67,1,66,陽信-石牌,2024-01-09,8711
6244,茂迪,50,0,50,陽信-石牌,2024-01-09,8711
4938,和碩,45,0,45,陽信-石牌,2024-01-09,8711
00936,台新永續高息中小,38,0,38,陽信-石牌,2024-01-09,8711
00937B,群益ESG投等債20,37,2,35,陽信-石牌,2024-01-09,8711
00878,國泰永續高股息,31,0,31,陽信-石牌,2024-01-09,8711
9103,美德醫療-DR,43,14,29,陽信-石牌,2024-01-09,8711
3481,群創,26,3,23,陽信-石牌,2024-01-09,8711
6116,彩晶,26,4,22,陽信-石牌,2024-01-09,8711
2317,鴻海,22,1,21,陽信-石牌,2024-01-09,8711
00929,復華台灣科技優息,22,1,21,陽信-石牌,2024-01-09,8711
8011,台通,20,0,20,陽信-石牌,2024-01-09,8711
2002,中鋼,20,1,19,陽信-石牌,2024-01-09,8711
00687B,國泰20年美債,20,1,19,陽信-石牌,2024-01-09,8711
0056,元大高股息,39,21,18,陽信-石牌,2024-01-09,8711
00715L,期街口布蘭特正2,24,7,17,陽信-石牌,2024-01-09,8711
2605,新興,22,6,16,陽信-石牌,2024-01-09,8711
3231,緯創,49,33,16,陽信-石牌,2024-01-09,8711
1217,愛之味,17,2,15,陽信-石牌,2024-01-09,8711
1522,堤維西,21,6,15,陽信-石牌,2024-01-09,8711
2027,大成鋼,15,0,15,陽信-石牌,2024-01-09,8711
6443,元晶,15,0,15,陽信-石牌,2024-01-09,8711
2230,泰茂,16,2,14,陽信-石牌,2024-01-09,8711
2405,輔信,14,0,14,陽信-石牌,2024-01-09,8711
6841,長佳智能,14,0,14,陽信-石牌,2024-01-09,8711
1301,台塑,12,0,12,陽信-石牌,2024-01-09,8711
2704,國賓,12,0,12,陽信-石牌,2024-01-09,8711
2603,長榮,16,5,11,陽信-石牌,2024-01-09,8711
2201,裕隆,12,1,11,陽信-石牌,2024-01-09,8711
1905,華紙,21,10,11,陽信-石牌,2024-01-09,8711
00881,國泰台灣5G+,10,0,10,陽信-石牌,2024-01-09,8711
1789,神隆,10,0,10,陽信-石牌,2024-01-09,8711
2323,中環,15,5,10,陽信-石牌,2024-01-09,8711
2344,華邦電,13,3,10,陽信-石牌,2024-01-09,8711
2520,冠德,10,0,10,陽信-石牌,2024-01-09,8711
2617,台航,10,0,10,陽信-石牌,2024-01-09,8711
3036,文曄,10,0,10,陽信-石牌,2024-01-09,8711
6547,高端疫苗,10,0,10,陽信-石牌,2024-01-09,8711
9904,寶成,10,0,10,陽信-石牌,2024-01-09,8711
1598,岱宇,9,0,9,陽信-石牌,2024-01-09,8711
00918,大華優利高填息30,8,0,8,陽信-石牌,2024-01-09,8711
00915,凱基優選高股息30,8,0,8,陽信-石牌,2024-01-09,8711
2382,廣達,33,25,8,陽信-石牌,2024-01-09,8711
4533,協易機,13,5,8,陽信-石牌,2024-01-09,8711
6414,樺漢,9,1,8,陽信-石牌,2024-01-09,8711
3032,偉訓,10,3,7,陽信-石牌,2024-01-09,8711
9105,泰金寶-DR,144,22,122,陽信-石牌,2024-01-10,8711
1314,中石化,120,0,120,陽信-石牌,2024-01-10,8711
00929,復華台灣科技優息,76,0,76,陽信-石牌,2024-01-10,8711
2610,華航,56,0,56,陽信-石牌,2024-01-10,8711
00637L,元大滬深300正2,60,5,55,陽信-石牌,2024-01-10,8711
2303,聯電,55,6,49,陽信-石牌,2024-01-10,8711
0056,元大高股息,68,20,48,陽信-石牌,2024-01-10,8711
2609,陽明,141,103,38,陽信-石牌,2024-01-10,8711
00919,群益台灣精選高息,28,0,28,陽信-石牌,2024-01-10,8711
00936,台新永續高息中小,25,0,25,陽信-石牌,2024-01-10,8711
2897,王道銀行,25,0,25,陽信-石牌,2024-01-10,8711
2615,萬海,27,2,25,陽信-石牌,2024-01-10,8711
2317,鴻海,26,1,25,陽信-石牌,2024-01-10,8711
1515,力山,21,0,21,陽信-石牌,2024-01-10,8711
2603,長榮,24,4,20,陽信-石牌,2024-01-10,8711
2885,元大金,20,0,20,陽信-石牌,2024-01-10,8711
2618,長榮航,25,6,19,陽信-石牌,2024-01-10,8711
00933B,國泰10Y+金融債,18,0,18,陽信-石牌,2024-01-10,8711
2323,中環,16,0,16,陽信-石牌,2024-01-10,8711
00918,大華優利高填息30,15,0,15,陽信-石牌,2024-01-10,8711
2362,藍天,38,23,15,陽信-石牌,2024-01-10,8711
1598,岱宇,13,0,13,陽信-石牌,2024-01-10,8711
1605,華新,13,0,13,陽信-石牌,2024-01-10,8711
2313,華通,15,2,13,陽信-石牌,2024-01-10,8711
5425,台半,13,0,13,陽信-石牌,2024-01-10,8711
2363,矽統,13,1,12,陽信-石牌,2024-01-10,8711
2498,宏達電,20,9,11,陽信-石牌,2024-01-10,8711
2344,華邦電,11,1,10,陽信-石牌,2024-01-10,8711
6472,保瑞,10,0,10,陽信-石牌,2024-01-10,8711
2324,仁寶,14,4,10,陽信-石牌,2024-01-10,8711
5309,系統電,10,0,10,陽信-石牌,2024-01-10,8711
00934,中信成長高股息,9,0,9,陽信-石牌,2024-01-10,8711
2486,一詮,9,1,8,陽信-石牌,2024-01-10,8711
2371,大同,17,9,8,陽信-石牌,2024-01-10,8711
2442,新美齊,8,0,8,陽信-石牌,2024-01-10,8711
2530,華建,10,2,8,陽信-石牌,2024-01-10,8711
4543,萬在,8,0,8,陽信-石牌,2024-01-10,8711
6770,力積電,8,0,8,陽信-石牌,2024-01-10,8711
2301,光寶科,7,0,7,陽信-石牌,2024-01-10,8711
00720B,元大投資級公司債,8,1,7,陽信-石牌,2024-01-10,8711
00650L,復華香港正2,23,16,7,陽信-石牌,2024-01-10,8711
00882,中信中國高股息,7,0,7,陽信-石牌,2024-01-10,8711
2449,京元電子,7,0,7,陽信-石牌,2024-01-10,8711
2637,慧洋-KY,7,0,7,陽信-石牌,2024-01-10,8711
4909,新復興,13,6,7,陽信-石牌,2024-01-10,8711
6166,凌華,7,0,7,陽信-石牌,2024-01-10,8711
2201,裕隆,8,2,6,陽信-石牌,2024-01-10,8711
6789,采鈺,6,0,6,陽信-石牌,2024-01-10,8711
1609,大亞,6,0,6,陽信-石牌,2024-01-10,8711
2027,大成鋼,6,0,6,陽信-石牌,2024-01-10,8711
00728,第一金工業30,100,0,100,陽信-石牌,2024-01-11,8711
00929,復華台灣科技優息,110,16,94,陽信-石牌,2024-01-11,8711
2610,華航,79,6,73,陽信-石牌,2024-01-11,8711
00715L,期街口布蘭特正2,58,0,58,陽信-石牌,2024-01-11,8711
00919,群益台灣精選高息,67,15,52,陽信-石牌,2024-01-11,8711
6695,芯鼎,45,0,45,陽信-石牌,2024-01-11,8711
2888,新光金,40,0,40,陽信-石牌,2024-01-11,8711
6164,華興,50,12,38,陽信-石牌,2024-01-11,8711
2329,華泰,61,29,32,陽信-石牌,2024-01-11,8711
00933B,國泰10Y+金融債,30,0,30,陽信-石牌,2024-01-11,8711
2834,臺企銀,30,0,30,陽信-石牌,2024-01-11,8711
00712,復華富時不動產,30,1,29,陽信-石牌,2024-01-11,8711
6117,迎廣,27,1,26,陽信-石牌,2024-01-11,8711
6282,康舒,27,2,25,陽信-石牌,2024-01-11,8711
2344,華邦電,28,4,24,陽信-石牌,2024-01-11,8711
2323,中環,42,20,22,陽信-石牌,2024-01-11,8711
1301,台塑,21,0,21,陽信-石牌,2024-01-11,8711
4533,協易機,21,0,21,陽信-石牌,2024-01-11,8711
00772B,中信高評級公司債,20,0,20,陽信-石牌,2024-01-11,8711
2305,全友,20,0,20,陽信-石牌,2024-01-11,8711
2359,所羅門,20,0,20,陽信-石牌,2024-01-11,8711
2618,長榮航,30,11,19,陽信-石牌,2024-01-11,8711
3264,欣銓,17,0,17,陽信-石牌,2024-01-11,8711
2317,鴻海,17,1,16,陽信-石牌,2024-01-11,8711
5521,工信,16,0,16,陽信-石牌,2024-01-11,8711
8210,勤誠,20,4,16,陽信-石牌,2024-01-11,8711
2882,國泰金,15,0,15,陽信-石牌,2024-01-11,8711
6120,達運,46,31,15,陽信-石牌,2024-01-11,8711
2461,光群雷,30,16,14,陽信-石牌,2024-01-11,8711
8111,立��,17,3,14,陽信-石牌,2024-01-11,8711
0056,元大高股息,42,29,13,陽信-石牌,2024-01-11,8711
00934,中信成長高股息,12,0,12,陽信-石牌,2024-01-11,8711
2002,中鋼,12,0,12,陽信-石牌,2024-01-11,8711
2605,新興,12,0,12,陽信-石牌,2024-01-11,8711
2630,亞航,14,2,12,陽信-石牌,2024-01-11,8711
3711,日月光投控,11,0,11,陽信-石牌,2024-01-11,8711
9103,美德醫療-DR,11,0,11,陽信-石牌,2024-01-11,8711
2303,聯電,15,5,10,陽信-石牌,2024-01-11,8711
00936,台新永續高息中小,10,0,10,陽信-石牌,2024-01-11,8711
1789,神隆,10,0,10,陽信-石牌,2024-01-11,8711
2530,華建,10,0,10,陽信-石牌,2024-01-11,8711
2538,基泰,10,0,10,陽信-石牌,2024-01-11,8711
4743,合一,10,0,10,陽信-石牌,2024-01-11,8711
2449,京元電子,10,0,10,陽信-石牌,2024-01-11,8711
2454,聯發科,13,4,9,陽信-石牌,2024-01-11,8711
2609,陽明,17,8,9,陽信-石牌,2024-01-11,8711
4906,正文,10,1,9,陽信-石牌,2024-01-11,8711
00931B,統一美債20年,8,0,8,陽信-石牌,2024-01-11,8711
00679B,元大美債20年,8,1,7,陽信-石牌,2024-01-11,8711
2324,仁寶,18,11,7,陽信-石牌,2024-01-11,8711
00919,群益台灣精選高息,133,0,133,陽信-石牌,2024-01-12,8711
00929,復華台灣科技優息,139,8,131,陽信-石牌,2024-01-12,8711
1444,力麗,100,0,100,陽信-石牌,2024-01-12,8711
8034,榮群,298,201,97,陽信-石牌,2024-01-12,8711
0056,元大高股息,107,31,76,陽信-石牌,2024-01-12,8711
2530,華建,45,0,45,陽信-石牌,2024-01-12,8711
4979,華星光,41,9,32,陽信-石牌,2024-01-12,8711
00885,富邦越南,30,0,30,陽信-石牌,2024-01-12,8711
3481,群創,35,9,26,陽信-石牌,2024-01-12,8711
00936,台新永續高息中小,24,0,24,陽信-石牌,2024-01-12,8711
5426,振發,38,15,23,陽信-石牌,2024-01-12,8711
00878,國泰永續高股息,22,0,22,陽信-石牌,2024-01-12,8711
6695,芯鼎,27,5,22,陽信-石牌,2024-01-12,8711
4989,榮科,21,1,20,陽信-石牌,2024-01-12,8711
6179,亞通,20,0,20,陽信-石牌,2024-01-12,8711
9105,泰金寶-DR,20,0,20,陽信-石牌,2024-01-12,8711
2324,仁寶,21,3,18,陽信-石牌,2024-01-12,8711
2883,凱基金,20,2,18,陽信-石牌,2024-01-12,8711
2882,國泰金,17,1,16,陽信-石牌,2024-01-12,8711
2208,台船,28,13,15,陽信-石牌,2024-01-12,8711
6781,AES-KY,13,0,13,陽信-石牌,2024-01-12,8711
00937B,群益ESG投等債20,12,0,12,陽信-石牌,2024-01-12,8711
1319,東陽,12,0,12,陽信-石牌,2024-01-12,8711
00934,中信成長高股息,11,0,11,陽信-石牌,2024-01-12,8711
2376,技嘉,19,8,11,陽信-石牌,2024-01-12,8711
00795B,中信美國公債20年,10,0,10,陽信-石牌,2024-01-12,8711
1466,聚隆,10,0,10,陽信-石牌,2024-01-12,8711
2515,中工,10,0,10,陽信-石牌,2024-01-12,8711
2748,雲品,11,1,10,陽信-石牌,2024-01-12,8711
3372,典範,10,0,10,陽信-石牌,2024-01-12,8711
4743,合一,10,0,10,陽信-石牌,2024-01-12,8711
8105,凌巨,10,0,10,陽信-石牌,2024-01-12,8711
3380,明泰,10,1,9,陽信-石牌,2024-01-12,8711
5880,合庫金,9,0,9,陽信-石牌,2024-01-12,8711
1102,亞泥,8,0,8,陽信-石牌,2024-01-12,8711
1795,美時,10,2,8,陽信-石牌,2024-01-12,8711
2371,大同,10,2,8,陽信-石牌,2024-01-12,8711
2498,宏達電,15,7,8,陽信-石牌,2024-01-12,8711
4503,金雨,8,0,8,陽信-石牌,2024-01-12,8711
1598,岱宇,7,0,7,陽信-石牌,2024-01-12,8711
3264,欣銓,7,0,7,陽信-石牌,2024-01-12,8711
1216,統一,7,0,7,陽信-石牌,2024-01-12,8711
4906,正文,6,0,6,陽信-石牌,2024-01-12,8711
6239,力成,7,1,6,陽信-石牌,2024-01-12,8711
1528,恩德,12,6,6,陽信-石牌,2024-01-12,8711
2230,泰茂,6,0,6,陽信-石牌,2024-01-12,8711
2402,毅嘉,7,1,6,陽信-石牌,2024-01-12,8711
2913,農林,6,0,6,陽信-石牌,2024-01-12,8711
6122,擎邦,6,0,6,陽信-石牌,2024-01-12,8711
6138,茂達,9,3,6,陽信-石牌,2024-01-12,8711
2887,台新金,111,0,111,陽信-石牌,2024-01-15,8711
2883,凱基金,110,2,108,陽信-石牌,2024-01-15,8711
2610,華航,82,3,79,陽信-石牌,2024-01-15,8711
00687B,國泰20年美債,56,0,56,陽信-石牌,2024-01-15,8711
3231,緯創,83,29,54,陽信-石牌,2024-01-15,8711
2303,聯電,51,3,48,陽信-石牌,2024-01-15,8711
00751B,元大AAA至A公司債,50,3,47,陽信-石牌,2024-01-15,8711
00679B,元大美債20年,44,0,44,陽信-石牌,2024-01-15,8711
00720B,元大投資級公司債,40,1,39,陽信-石牌,2024-01-15,8711
2618,長榮航,40,12,28,陽信-石牌,2024-01-15,8711
2882,國泰金,28,0,28,陽信-石牌,2024-01-15,8711
2356,英業達,28,5,23,陽信-石牌,2024-01-15,8711
00929,復華台灣科技優息,21,0,21,陽信-石牌,2024-01-15,8711
2382,廣達,22,2,20,陽信-石牌,2024-01-15,8711
2897,王道銀行,20,0,20,陽信-石牌,2024-01-15,8711
2704,國賓,17,0,17,陽信-石牌,2024-01-15,8711
3017,奇鋐,14,1,13,陽信-石牌,2024-01-15,8711
4956,光鋐,14,3,11,陽信-石牌,2024-01-15,8711
1519,華城,21,10,11,陽信-石牌,2024-01-15,8711
00933B,國泰10Y+金融債,10,0,10,陽信-石牌,2024-01-15,8711
00665L,富邦�琤肭磪囓�2,22,12,10,陽信-石牌,2024-01-15,8711
00728,第一金工業30,10,0,10,陽信-石牌,2024-01-15,8711
2421,建準,10,0,10,陽信-石牌,2024-01-15,8711
2748,雲品,11,1,10,陽信-石牌,2024-01-15,8711
2816,旺旺保,10,0,10,陽信-石牌,2024-01-15,8711
3013,晟銘電,10,0,10,陽信-石牌,2024-01-15,8711
3234,光環,10,0,10,陽信-石牌,2024-01-15,8711
4526,東台,10,0,10,陽信-石牌,2024-01-15,8711
3035,智原,13,4,9,陽信-石牌,2024-01-15,8711
2731,雄獅,9,0,9,陽信-石牌,2024-01-15,8711
2801,彰銀,9,0,9,陽信-石牌,2024-01-15,8711
2615,萬海,11,3,8,陽信-石牌,2024-01-15,8711
3481,群創,11,3,8,陽信-石牌,2024-01-15,8711
1314,中石化,7,0,7,陽信-石牌,2024-01-15,8711
2812,台中銀,7,0,7,陽信-石牌,2024-01-15,8711
6443,元晶,8,1,7,陽信-石牌,2024-01-15,8711
8033,雷虎,7,0,7,陽信-石牌,2024-01-15,8711
8222,寶一,8,1,7,陽信-石牌,2024-01-15,8711
2603,長榮,8,1,7,陽信-石牌,2024-01-15,8711
1474,弘裕,6,0,6,陽信-石牌,2024-01-15,8711
2736,富野,9,3,6,陽信-石牌,2024-01-15,8711
2888,新光金,6,0,6,陽信-石牌,2024-01-15,8711
3027,盛達,8,2,6,陽信-石牌,2024-01-15,8711
3443,創意,8,2,6,陽信-石牌,2024-01-15,8711
3576,聯合再生,6,0,6,陽信-石牌,2024-01-15,8711
2317,鴻海,6,1,5,陽信-石牌,2024-01-15,8711
3707,漢磊,5,0,5,陽信-石牌,2024-01-15,8711
00770,國泰北美科技,5,0,5,陽信-石牌,2024-01-15,8711
2104,國際中橡,5,0,5,陽信-石牌,2024-01-15,8711
2465,麗臺,5,0,5,陽信-石牌,2024-01-15,8711
00927,群益半導體收益,208,0,208,陽信-石牌,2024-01-16,8711
2812,台中銀,118,0,118,陽信-石牌,2024-01-16,8711
00919,群益台灣精選高息,104,3,101,陽信-石牌,2024-01-16,8711
0056,元大高股息,100,3,97,陽信-石牌,2024-01-16,8711
00673R,期元大S＆P原油反1,94,0,94,陽信-石牌,2024-01-16,8711
00929,復華台灣科技優息,92,1,91,陽信-石牌,2024-01-16,8711
2883,凱基金,83,0,83,陽信-石牌,2024-01-16,8711
2312,金寶,70,2,68,陽信-石牌,2024-01-16,8711
1905,華紙,71,5,66,陽信-石牌,2024-01-16,8711
6288,聯嘉,64,0,64,陽信-石牌,2024-01-16,8711
2344,華邦電,56,2,54,陽信-石牌,2024-01-16,8711
2882,國泰金,48,0,48,陽信-石牌,2024-01-16,8711
00720B,元大投資級公司債,43,0,43,陽信-石牌,2024-01-16,8711
2486,一詮,51,13,38,陽信-石牌,2024-01-16,8711
2405,輔信,57,24,33,陽信-石牌,2024-01-16,8711
2515,中工,34,2,32,陽信-石牌,2024-01-16,8711
9103,美德醫療-DR,30,0,30,陽信-石牌,2024-01-16,8711
1605,華新,28,0,28,陽信-石牌,2024-01-16,8711
2801,彰銀,28,0,28,陽信-石牌,2024-01-16,8711
1504,東元,27,0,27,陽信-石牌,2024-01-16,8711
2890,永豐金,26,0,26,陽信-石牌,2024-01-16,8711
2530,華建,25,0,25,陽信-石牌,2024-01-16,8711
00900,富邦特選高股息30,24,0,24,陽信-石牌,2024-01-16,8711
2606,裕民,24,0,24,陽信-石牌,2024-01-16,8711
2618,長榮航,39,15,24,陽信-石牌,2024-01-16,8711
2002,中鋼,23,0,23,陽信-石牌,2024-01-16,8711
1301,台塑,22,0,22,陽信-石牌,2024-01-16,8711
6179,亞通,22,0,22,陽信-石牌,2024-01-16,8711
2610,華航,21,0,21,陽信-石牌,2024-01-16,8711
1310,台苯,20,0,20,陽信-石牌,2024-01-16,8711
3045,台灣大,20,0,20,陽信-石牌,2024-01-16,8711
2429,銘旺科,19,0,19,陽信-石牌,2024-01-16,8711
4123,晟德,21,2,19,陽信-石牌,2024-01-16,8711
2454,聯發科,23,4,19,陽信-石牌,2024-01-16,8711
6806,森崴能源,20,3,17,陽信-石牌,2024-01-16,8711
2317,鴻海,25,9,16,陽信-石牌,2024-01-16,8711
2402,毅嘉,20,4,16,陽信-石牌,2024-01-16,8711
00878,國泰永續高股息,19,3,16,陽信-石牌,2024-01-16,8711
1313,聯成,15,0,15,陽信-石牌,2024-01-16,8711
4743,合一,15,0,15,陽信-石牌,2024-01-16,8711
5880,合庫金,14,0,14,陽信-石牌,2024-01-16,8711
1326,台化,15,1,14,陽信-石牌,2024-01-16,8711
5347,世界,13,0,13,陽信-石牌,2024-01-16,8711
1598,岱宇,13,0,13,陽信-石牌,2024-01-16,8711
2888,新光金,13,0,13,陽信-石牌,2024-01-16,8711
2748,雲品,12,0,12,陽信-石牌,2024-01-16,8711
3587,閎康,12,0,12,陽信-石牌,2024-01-16,8711
8027,鈦昇,14,2,12,陽信-石牌,2024-01-16,8711
00637L,元大滬深300正2,36,25,11,陽信-石牌,2024-01-16,8711
2605,新興,11,0,11,陽信-石牌,2024-01-16,8711
1802,台玻,612,0,612,陽信-石牌,2024-01-17,8711
00687B,國泰20年美債,163,0,163,陽信-石牌,2024-01-17,8711
2882,國泰金,142,0,142,陽信-石牌,2024-01-17,8711
2303,聯電,111,2,109,陽信-石牌,2024-01-17,8711
00919,群益台灣精選高息,103,14,89,陽信-石牌,2024-01-17,8711
2618,長榮航,79,4,75,陽信-石牌,2024-01-17,8711
2897,王道銀行,75,0,75,陽信-石牌,2024-01-17,8711
00933B,國泰10Y+金融債,72,0,72,陽信-石牌,2024-01-17,8711
0056,元大高股息,72,5,67,陽信-石牌,2024-01-17,8711
00650L,復華香港正2,83,24,59,陽信-石牌,2024-01-17,8711
00715L,期街口布蘭特正2,59,0,59,陽信-石牌,2024-01-17,8711
2344,華邦電,64,12,52,陽信-石牌,2024-01-17,8711
00929,復華台灣科技優息,61,12,49,陽信-石牌,2024-01-17,8711
00679B,元大美債20年,44,0,44,陽信-石牌,2024-01-17,8711
2371,大同,44,0,44,陽信-石牌,2024-01-17,8711
3306,鼎天,53,10,43,陽信-石牌,2024-01-17,8711
00918,大華優利高填息30,42,0,42,陽信-石牌,2024-01-17,8711
00878,國泰永續高股息,41,2,39,陽信-石牌,2024-01-17,8711
00936,台新永續高息中小,37,0,37,陽信-石牌,2024-01-17,8711
2883,凱基金,31,0,31,陽信-石牌,2024-01-17,8711
2530,華建,30,0,30,陽信-石牌,2024-01-17,8711
2886,兆豐金,31,1,30,陽信-石牌,2024-01-17,8711
3044,健鼎,31,1,30,陽信-石牌,2024-01-17,8711
00706L,期元大S＆P日圓正2,29,0,29,陽信-石牌,2024-01-17,8711
2317,鴻海,33,6,27,陽信-石牌,2024-01-17,8711
00882,中信中國高股息,26,0,26,陽信-石牌,2024-01-17,8711
5443,均豪,35,10,25,陽信-石牌,2024-01-17,8711
9105,泰金寶-DR,25,0,25,陽信-石牌,2024-01-17,8711
0050,元大台灣50,24,0,24,陽信-石牌,2024-01-17,8711
3583,辛耘,24,1,23,陽信-石牌,2024-01-17,8711
2002,中鋼,27,5,22,陽信-石牌,2024-01-17,8711
6116,彩晶,22,0,22,陽信-石牌,2024-01-17,8711
2610,華航,22,1,21,陽信-石牌,2024-01-17,8711
2892,第一金,21,0,21,陽信-石牌,2024-01-17,8711
00701,國泰股利精選30,20,0,20,陽信-石牌,2024-01-17,8711
2609,陽明,60,40,20,陽信-石牌,2024-01-17,8711
3045,台灣大,20,0,20,陽信-石牌,2024-01-17,8711
3518,柏騰,20,0,20,陽信-石牌,2024-01-17,8711
4533,協易機,20,0,20,陽信-石牌,2024-01-17,8711
8110,華東,20,2,18,陽信-石牌,2024-01-17,8711
5223,安力-KY,16,0,16,陽信-石牌,2024-01-17,8711
6125,廣運,17,1,16,陽信-石牌,2024-01-17,8711
2634,漢翔,15,0,15,陽信-石牌,2024-01-17,8711
00665L,富邦�琤肭磪囓�2,56,42,14,陽信-石牌,2024-01-17,8711
1905,華紙,14,0,14,陽信-石牌,2024-01-17,8711
2606,裕民,14,0,14,陽信-石牌,2024-01-17,8711
00934,中信成長高股息,13,0,13,陽信-石牌,2024-01-17,8711
1795,美時,15,2,13,陽信-石牌,2024-01-17,8711
8085,福華,20,7,13,陽信-石牌,2024-01-17,8711
00931B,統一美債20年,12,0,12,陽信-石牌,2024-01-17,8711
00929,復華台灣科技優息,80,3,77,陽信-石牌,2024-01-18,8711
00882,中信中國高股息,73,0,73,陽信-石牌,2024-01-18,8711
6015,宏遠證,73,0,73,陽信-石牌,2024-01-18,8711
2887,台新金,50,0,50,陽信-石牌,2024-01-18,8711
2329,華泰,57,8,49,陽信-石牌,2024-01-18,8711
00937B,群益ESG投等債20,48,0,48,陽信-石牌,2024-01-18,8711
00706L,期元大S＆P日圓正2,31,0,31,陽信-石牌,2024-01-18,8711
2601,益航,45,14,31,陽信-石牌,2024-01-18,8711
00919,群益台灣精選高息,28,0,28,陽信-石牌,2024-01-18,8711
2405,輔信,30,5,25,陽信-石牌,2024-01-18,8711
2801,彰銀,25,0,25,陽信-石牌,2024-01-18,8711
0056,元大高股息,24,0,24,陽信-石牌,2024-01-18,8711
00878,國泰永續高股息,24,0,24,陽信-石牌,2024-01-18,8711
1326,台化,22,0,22,陽信-石牌,2024-01-18,8711
1718,中纖,20,0,20,陽信-石牌,2024-01-18,8711
1905,華紙,25,5,20,陽信-石牌,2024-01-18,8711
4142,國光生,20,0,20,陽信-石牌,2024-01-18,8711
00687B,國泰20年美債,18,0,18,陽信-石牌,2024-01-18,8711
2324,仁寶,30,12,18,陽信-石牌,2024-01-18,8711
6179,亞通,18,0,18,陽信-石牌,2024-01-18,8711
2382,廣達,19,2,17,陽信-石牌,2024-01-18,8711
2427,三商電,15,2,13,陽信-石牌,2024-01-18,8711
00686R,群益臺灣加權反1,10,0,10,陽信-石牌,2024-01-18,8711
1303,南亞,10,0,10,陽信-石牌,2024-01-18,8711
1409,新纖,10,0,10,陽信-石牌,2024-01-18,8711
2617,台航,10,0,10,陽信-石牌,2024-01-18,8711
2888,新光金,10,0,10,陽信-石牌,2024-01-18,8711
3051,力特,10,0,10,陽信-石牌,2024-01-18,8711
5443,均豪,10,0,10,陽信-石牌,2024-01-18,8711
8176,智捷,10,0,10,陽信-石牌,2024-01-18,8711
8085,福華,23,14,9,陽信-石牌,2024-01-18,8711
00936,台新永續高息中小,8,0,8,陽信-石牌,2024-01-18,8711
2377,微星,8,0,8,陽信-石牌,2024-01-18,8711
2834,臺企銀,10,2,8,陽信-石牌,2024-01-18,8711
8011,台通,8,0,8,陽信-石牌,2024-01-18,8711
00665L,富邦�琤肭磪囓�2,7,0,7,陽信-石牌,2024-01-18,8711
1325,恆大,8,1,7,陽信-石牌,2024-01-18,8711
2353,宏��,14,7,7,陽信-石牌,2024-01-18,8711
2605,新興,7,0,7,陽信-石牌,2024-01-18,8711
2882,國泰金,7,0,7,陽信-石牌,2024-01-18,8711
3071,協禧,7,0,7,陽信-石牌,2024-01-18,8711
6684,安格,11,4,7,陽信-石牌,2024-01-18,8711
6712,長聖,7,0,7,陽信-石牌,2024-01-18,8711
8034,榮群,19,12,7,陽信-石牌,2024-01-18,8711
6505,台塑化,6,0,6,陽信-石牌,2024-01-18,8711
2308,台達電,6,0,6,陽信-石牌,2024-01-18,8711
00650L,復華香港正2,14,8,6,陽信-石牌,2024-01-18,8711
1301,台塑,6,0,6,陽信-石牌,2024-01-18,8711
2002,中鋼,8,2,6,陽信-石牌,2024-01-18,8711
2303,聯電,38,32,6,陽信-石牌,2024-01-18,8711
00931B,統一美債20年,176,5,171,陽信-石牌,2024-01-19,8711
2618,長榮航,54,2,52,陽信-石牌,2024-01-19,8711
00929,復華台灣科技優息,78,30,48,陽信-石牌,2024-01-19,8711
2834,臺企銀,40,0,40,陽信-石牌,2024-01-19,8711
2486,一詮,40,2,38,陽信-石牌,2024-01-19,8711
00882,中信中國高股息,37,0,37,陽信-石牌,2024-01-19,8711
00934,中信成長高股息,33,2,31,陽信-石牌,2024-01-19,8711
2637,慧洋-KY,30,1,29,陽信-石牌,2024-01-19,8711
6117,迎廣,31,2,29,陽信-石牌,2024-01-19,8711
0056,元大高股息,34,6,28,陽信-石牌,2024-01-19,8711
3532,台勝科,28,1,27,陽信-石牌,2024-01-19,8711
1609,大亞,26,0,26,陽信-石牌,2024-01-19,8711
00936,台新永續高息中小,26,0,26,陽信-石牌,2024-01-19,8711
2605,新興,26,0,26,陽信-石牌,2024-01-19,8711
6285,啟��,28,6,22,陽信-石牌,2024-01-19,8711
2301,光寶科,21,0,21,陽信-石牌,2024-01-19,8711
2606,裕民,21,0,21,陽信-石牌,2024-01-19,8711
00634R,富邦上証反1,20,0,20,陽信-石牌,2024-01-19,8711
2355,敬鵬,20,0,20,陽信-石牌,2024-01-19,8711
2489,瑞軒,20,0,20,陽信-石牌,2024-01-19,8711
2897,王道銀行,20,0,20,陽信-石牌,2024-01-19,8711
5880,合庫金,20,0,20,陽信-石牌,2024-01-19,8711
00937B,群益ESG投等債20,16,1,15,陽信-石牌,2024-01-19,8711
4906,正文,15,0,15,陽信-石牌,2024-01-19,8711
6472,保瑞,15,0,15,陽信-石牌,2024-01-19,8711
4916,事欣科,13,0,13,陽信-石牌,2024-01-19,8711
4960,誠美材,12,0,12,陽信-石牌,2024-01-19,8711
00680L,元大美債20正2,11,0,11,陽信-石牌,2024-01-19,8711
2344,華邦電,37,26,11,陽信-石牌,2024-01-19,8711
2883,凱基金,11,0,11,陽信-石牌,2024-01-19,8711
6116,彩晶,31,20,11,陽信-石牌,2024-01-19,8711
2002,中鋼,12,1,11,陽信-石牌,2024-01-19,8711
00919,群益台灣精選高息,12,2,10,陽信-石牌,2024-01-19,8711
00687B,國泰20年美債,10,0,10,陽信-石牌,2024-01-19,8711
00898,國泰基因免疫革命,10,0,10,陽信-石牌,2024-01-19,8711
00918,大華優利高填息30,20,10,10,陽信-石牌,2024-01-19,8711
00905,FT臺灣Smart,10,0,10,陽信-石牌,2024-01-19,8711
00670L,富邦NASDAQ正2,10,0,10,陽信-石牌,2024-01-19,8711
2704,國賓,10,0,10,陽信-石牌,2024-01-19,8711
2884,玉山金,10,0,10,陽信-石牌,2024-01-19,8711
5521,工信,12,2,10,陽信-石牌,2024-01-19,8711
6741,91APP*-KY,10,0,10,陽信-石牌,2024-01-19,8711
6770,力積電,20,10,10,陽信-石牌,2024-01-19,8711
00795B,中信美國公債20年,8,0,8,陽信-石牌,2024-01-19,8711
2303,聯電,32,24,8,陽信-石牌,2024-01-19,8711
3032,偉訓,16,8,8,陽信-石牌,2024-01-19,8711
6462,神盾,12,4,8,陽信-石牌,2024-01-19,8711
3443,創意,7,0,7,陽信-石牌,2024-01-19,8711
3380,明泰,7,0,7,陽信-石牌,2024-01-19,8711
4956,光鋐,39,32,7,陽信-石牌,2024-01-19,8711
00882,中信中國高股息,383,0,383,陽信-石牌,2024-01-22,8711
00673R,期元大S＆P原油反1,90,0,90,陽信-石牌,2024-01-22,8711
2618,長榮航,90,0,90,陽信-石牌,2024-01-22,8711
0056,元大高股息,84,9,75,陽信-石牌,2024-01-22,8711
2344,華邦電,78,10,68,陽信-石牌,2024-01-22,8711
2367,燿華,62,0,62,陽信-石牌,2024-01-22,8711
2886,兆豐金,50,0,50,陽信-石牌,2024-01-22,8711
6229,研通,45,0,45,陽信-石牌,2024-01-22,8711
2329,華泰,92,57,35,陽信-石牌,2024-01-22,8711
00650L,復華香港正2,70,36,34,陽信-石牌,2024-01-22,8711
00713,元大台灣高息低波,34,0,34,陽信-石牌,2024-01-22,8711
6196,帆宣,34,1,33,陽信-石牌,2024-01-22,8711
00919,群益台灣精選高息,45,15,30,陽信-石牌,2024-01-22,8711
00927,群益半導體收益,30,0,30,陽信-石牌,2024-01-22,8711
00706L,期元大S＆P日圓正2,30,0,30,陽信-石牌,2024-01-22,8711
2530,華建,30,0,30,陽信-石牌,2024-01-22,8711
00679B,元大美債20年,26,0,26,陽信-石牌,2024-01-22,8711
8201,無敵,25,0,25,陽信-石牌,2024-01-22,8711
2444,兆勁,22,0,22,陽信-石牌,2024-01-22,8711
2353,宏��,40,19,21,陽信-石牌,2024-01-22,8711
00665L,富邦�琤肭磪囓�2,62,42,20,陽信-石牌,2024-01-22,8711
2834,臺企銀,20,0,20,陽信-石牌,2024-01-22,8711
00937B,群益ESG投等債20,28,10,18,陽信-石牌,2024-01-22,8711
2337,旺宏,21,6,15,陽信-石牌,2024-01-22,8711
4157,太景*-KY,15,0,15,陽信-石牌,2024-01-22,8711
5258,虹堡,13,0,13,陽信-石牌,2024-01-22,8711
2301,光寶科,16,4,12,陽信-石牌,2024-01-22,8711
2363,矽統,18,6,12,陽信-石牌,2024-01-22,8711
2603,長榮,16,4,12,陽信-石牌,2024-01-22,8711
4938,和碩,11,0,11,陽信-石牌,2024-01-22,8711
00712,復華富時不動產,10,0,10,陽信-石牌,2024-01-22,8711
2106,建大,10,0,10,陽信-石牌,2024-01-22,8711
2201,裕隆,10,0,10,陽信-石牌,2024-01-22,8711
2374,佳能,10,0,10,陽信-石牌,2024-01-22,8711
4912,聯德控股-KY,10,0,10,陽信-石牌,2024-01-22,8711
6179,亞通,20,10,10,陽信-石牌,2024-01-22,8711
8028,昇陽半導體,10,0,10,陽信-石牌,2024-01-22,8711
2838,聯邦銀,9,0,9,陽信-石牌,2024-01-22,8711
6257,矽格,10,1,9,陽信-石牌,2024-01-22,8711
1609,大亞,10,2,8,陽信-石牌,2024-01-22,8711
6147,頎邦,8,0,8,陽信-石牌,2024-01-22,8711
6770,力積電,8,0,8,陽信-石牌,2024-01-22,8711
1909,榮成,7,0,7,陽信-石牌,2024-01-22,8711
2359,所羅門,14,7,7,陽信-石牌,2024-01-22,8711
2429,銘旺科,7,0,7,陽信-石牌,2024-01-22,8711
2515,中工,9,2,7,陽信-石牌,2024-01-22,8711
2609,陽明,34,27,7,陽信-石牌,2024-01-22,8711
3483,力致,7,0,7,陽信-石牌,2024-01-22,8711
8222,寶一,7,0,7,陽信-石牌,2024-01-22,8711
2327,國巨,6,0,6,陽信-石牌,2024-01-22,8711
2888,新光金,529,0,529,陽信-石牌,2024-01-23,8711
2883,凱基金,499,0,499,陽信-石牌,2024-01-23,8711
1101,台泥,400,6,394,陽信-石牌,2024-01-23,8711
2323,中環,200,0,200,陽信-石牌,2024-01-23,8711
2891,中信金,80,5,75,陽信-石牌,2024-01-23,8711
2014,中鴻,61,0,61,陽信-石牌,2024-01-23,8711
00927,群益半導體收益,60,2,58,陽信-石牌,2024-01-23,8711
00715L,期街口布蘭特正2,74,27,47,陽信-石牌,2024-01-23,8711
00713,元大台灣高息低波,44,0,44,陽信-石牌,2024-01-23,8711
0050,元大台灣50,31,3,28,陽信-石牌,2024-01-23,8711
2605,新興,29,1,28,陽信-石牌,2024-01-23,8711
00933B,國泰10Y+金融債,22,0,22,陽信-石牌,2024-01-23,8711
00857B,永豐20年美公債,20,0,20,陽信-石牌,2024-01-23,8711
00795B,中信美國公債20年,20,0,20,陽信-石牌,2024-01-23,8711
2419,仲琦,20,0,20,陽信-石牌,2024-01-23,8711
2427,三商電,21,1,20,陽信-石牌,2024-01-23,8711
8028,昇陽半導體,20,0,20,陽信-石牌,2024-01-23,8711
9103,美德醫療-DR,20,0,20,陽信-石牌,2024-01-23,8711
00937B,群益ESG投等債20,19,0,19,陽信-石牌,2024-01-23,8711
2609,陽明,33,14,19,陽信-石牌,2024-01-23,8711
00679B,元大美債20年,17,0,17,陽信-石牌,2024-01-23,8711
2454,聯發科,16,0,16,陽信-石牌,2024-01-23,8711
2382,廣達,26,10,16,陽信-石牌,2024-01-23,8711
3706,神達,26,12,14,陽信-石牌,2024-01-23,8711
2106,建大,13,0,13,陽信-石牌,2024-01-23,8711
8021,尖點,14,1,13,陽信-石牌,2024-01-23,8711
00919,群益台灣精選高息,11,0,11,陽信-石牌,2024-01-23,8711
2369,菱生,33,22,11,陽信-石牌,2024-01-23,8711
2884,玉山金,11,0,11,陽信-石牌,2024-01-23,8711
6111,大宇資,14,3,11,陽信-石牌,2024-01-23,8711
00922,國泰台灣領袖50,10,0,10,陽信-石牌,2024-01-23,8711
2329,華泰,32,22,10,陽信-石牌,2024-01-23,8711
2542,興富發,10,0,10,陽信-石牌,2024-01-23,8711
2615,萬海,13,3,10,陽信-石牌,2024-01-23,8711
2913,農林,10,0,10,陽信-石牌,2024-01-23,8711
3149,正達,10,0,10,陽信-石牌,2024-01-23,8711
3479,安勤,10,0,10,陽信-石牌,2024-01-23,8711
3701,大眾控,10,0,10,陽信-石牌,2024-01-23,8711
3712,永崴投控,9,0,9,陽信-石牌,2024-01-23,8711
00882,中信中國高股息,68,60,8,陽信-石牌,2024-01-23,8711
3545,敦泰,14,6,8,陽信-石牌,2024-01-23,8711
6113,亞矽,11,3,8,陽信-石牌,2024-01-23,8711
1471,首利,14,7,7,陽信-石牌,2024-01-23,8711
2376,技嘉,16,10,6,陽信-石牌,2024-01-23,8711
00929,復華台灣科技優息,6,0,6,陽信-石牌,2024-01-23,8711
2208,台船,6,0,6,陽信-石牌,2024-01-23,8711
2353,宏��,12,6,6,陽信-石牌,2024-01-23,8711
5351,鈺創,11,5,6,陽信-石牌,2024-01-23,8711
5533,皇鼎,6,0,6,陽信-石牌,2024-01-23,8711
6126,信音,6,0,6,陽信-石牌,2024-01-23,8711
2888,新光金,524,0,524,陽信-石牌,2024-01-24,8711
9105,泰金寶-DR,509,10,499,陽信-石牌,2024-01-24,8711
00931B,統一美債20年,112,0,112,陽信-石牌,2024-01-24,8711
4938,和碩,116,4,112,陽信-石牌,2024-01-24,8711
8027,鈦昇,66,10,56,陽信-石牌,2024-01-24,8711
00878,國泰永續高股息,53,3,50,陽信-石牌,2024-01-24,8711
00933B,國泰10Y+金融債,49,0,49,陽信-石牌,2024-01-24,8711
2486,一詮,40,1,39,陽信-石牌,2024-01-24,8711
2409,友達,44,11,33,陽信-石牌,2024-01-24,8711
00882,中信中國高股息,62,30,32,陽信-石牌,2024-01-24,8711
2102,泰豐,30,0,30,陽信-石牌,2024-01-24,8711
5880,合庫金,28,0,28,陽信-石牌,2024-01-24,8711
2344,華邦電,48,22,26,陽信-石牌,2024-01-24,8711
00937B,群益ESG投等債20,40,15,25,陽信-石牌,2024-01-24,8711
00715L,期街口布蘭特正2,72,54,18,陽信-石牌,2024-01-24,8711
3055,蔚華科,34,17,17,陽信-石牌,2024-01-24,8711
00637L,元大滬深300正2,16,0,16,陽信-石牌,2024-01-24,8711
3260,威剛,24,9,15,陽信-石牌,2024-01-24,8711
6531,愛普*,15,2,13,陽信-石牌,2024-01-24,8711
00687B,國泰20年美債,13,0,13,陽信-石牌,2024-01-24,8711
1815,富喬,13,0,13,陽信-石牌,2024-01-24,8711
6188,廣明,14,1,13,陽信-石牌,2024-01-24,8711
00665L,富邦�琤肭磪囓�2,24,12,12,陽信-石牌,2024-01-24,8711
2324,仁寶,16,5,11,陽信-石牌,2024-01-24,8711
4906,正文,11,0,11,陽信-石牌,2024-01-24,8711
6179,亞通,13,2,11,陽信-石牌,2024-01-24,8711
2002,中鋼,11,0,11,陽信-石牌,2024-01-24,8711
2313,華通,24,14,10,陽信-石牌,2024-01-24,8711
4714,永捷,10,0,10,陽信-石牌,2024-01-24,8711
8021,尖點,10,0,10,陽信-石牌,2024-01-24,8711
8201,無敵,10,0,10,陽信-石牌,2024-01-24,8711
3443,創意,9,0,9,陽信-石牌,2024-01-24,8711
2363,矽統,12,3,9,陽信-石牌,2024-01-24,8711
1785,光洋科,8,0,8,陽信-石牌,2024-01-24,8711
2371,大同,20,12,8,陽信-石牌,2024-01-24,8711
2438,翔耀,8,0,8,陽信-石牌,2024-01-24,8711
3005,神基,12,4,8,陽信-石牌,2024-01-24,8711
6770,力積電,11,3,8,陽信-石牌,2024-01-24,8711
3231,緯創,42,35,7,陽信-石牌,2024-01-24,8711
6153,嘉聯益,8,1,7,陽信-石牌,2024-01-24,8711
8050,廣積,7,0,7,陽信-石牌,2024-01-24,8711
1802,台玻,6,0,6,陽信-石牌,2024-01-24,8711
2014,中鴻,6,0,6,陽信-石牌,2024-01-24,8711
2897,王道銀行,6,0,6,陽信-石牌,2024-01-24,8711
3032,偉訓,6,0,6,陽信-石牌,2024-01-24,8711
3047,訊舟,7,1,6,陽信-石牌,2024-01-24,8711
3504,揚明光,10,4,6,陽信-石牌,2024-01-24,8711
4909,新復興,14,8,6,陽信-石牌,2024-01-24,8711
5439,高技,6,0,6,陽信-石牌,2024-01-24,8711
6235,華孚,6,0,6,陽信-石牌,2024-01-24,8711
00931B,統一美債20年,135,30,105,陽信-石牌,2024-01-25,8711
00673R,期元大S＆P原油反1,101,0,101,陽信-石牌,2024-01-25,8711
1722,台肥,100,0,100,陽信-石牌,2024-01-25,8711
4938,和碩,81,1,80,陽信-石牌,2024-01-25,8711
00937B,群益ESG投等債20,52,6,46,陽信-石牌,2024-01-25,8711
2356,英業達,61,15,46,陽信-石牌,2024-01-25,8711
00651R,復華香港反1,40,0,40,陽信-石牌,2024-01-25,8711
4956,光鋐,38,6,32,陽信-石牌,2024-01-25,8711
3231,緯創,71,40,31,陽信-石牌,2024-01-25,8711
5314,世紀,30,0,30,陽信-石牌,2024-01-25,8711
3530,晶相光,30,1,29,陽信-石牌,2024-01-25,8711
1519,華城,29,2,27,陽信-石牌,2024-01-25,8711
4743,合一,25,0,25,陽信-石牌,2024-01-25,8711
5880,合庫金,24,0,24,陽信-石牌,2024-01-25,8711
2208,台船,20,0,20,陽信-石牌,2024-01-25,8711
2489,瑞軒,20,0,20,陽信-石牌,2024-01-25,8711
2605,新興,21,1,20,陽信-石牌,2024-01-25,8711
3691,碩禾,20,2,18,陽信-石牌,2024-01-25,8711
6472,保瑞,17,0,17,陽信-石牌,2024-01-25,8711
1905,華紙,20,5,15,陽信-石牌,2024-01-25,8711
2332,友訊,15,0,15,陽信-石牌,2024-01-25,8711
6235,華孚,15,0,15,陽信-石牌,2024-01-25,8711
8028,昇陽半導體,15,0,15,陽信-石牌,2024-01-25,8711
2409,友達,18,5,13,陽信-石牌,2024-01-25,8711
8096,擎亞,41,28,13,陽信-石牌,2024-01-25,8711
6111,大宇資,14,2,12,陽信-石牌,2024-01-25,8711
2486,一詮,12,0,12,陽信-石牌,2024-01-25,8711
2206,三陽工業,12,1,11,陽信-石牌,2024-01-25,8711
2316,楠梓電,11,0,11,陽信-石牌,2024-01-25,8711
2402,毅嘉,11,0,11,陽信-石牌,2024-01-25,8711
00933B,國泰10Y+金融債,10,0,10,陽信-石牌,2024-01-25,8711
00688L,國泰20年美債正2,10,0,10,陽信-石牌,2024-01-25,8711
2102,泰豐,10,0,10,陽信-石牌,2024-01-25,8711
2461,光群雷,10,0,10,陽信-石牌,2024-01-25,8711
2610,華航,10,0,10,陽信-石牌,2024-01-25,8711
3360,尚立,10,0,10,陽信-石牌,2024-01-25,8711
3380,明泰,10,0,10,陽信-石牌,2024-01-25,8711
4157,太景*-KY,10,0,10,陽信-石牌,2024-01-25,8711
5498,凱崴,10,0,10,陽信-石牌,2024-01-25,8711
6120,達運,13,3,10,陽信-石牌,2024-01-25,8711
9934,成霖,10,0,10,陽信-石牌,2024-01-25,8711
2436,偉詮電,10,1,9,陽信-石牌,2024-01-25,8711
1101,台泥,9,0,9,陽信-石牌,2024-01-25,8711
00934,中信成長高股息,20,11,9,陽信-石牌,2024-01-25,8711
2353,宏��,18,9,9,陽信-石牌,2024-01-25,8711
00679B,元大美債20年,18,10,8,陽信-石牌,2024-01-25,8711
2603,長榮,8,0,8,陽信-石牌,2024-01-25,8711
2606,裕民,8,0,8,陽信-石牌,2024-01-25,8711
5426,振發,18,10,8,陽信-石牌,2024-01-25,8711
6104,創惟,8,0,8,陽信-石牌,2024-01-25,8711
00933B,國泰10Y+金融債,382,2,380,陽信-石牌,2024-01-26,8711
2303,聯電,170,5,165,陽信-石牌,2024-01-26,8711
00637L,元大滬深300正2,112,6,106,陽信-石牌,2024-01-26,8711
2324,仁寶,89,25,64,陽信-石牌,2024-01-26,8711
2369,菱生,56,0,56,陽信-石牌,2024-01-26,8711
3288,點晶,43,0,43,陽信-石牌,2024-01-26,8711
3481,群創,67,29,38,陽信-石牌,2024-01-26,8711
2409,友達,43,10,33,陽信-石牌,2024-01-26,8711
3360,尚立,41,9,32,陽信-石牌,2024-01-26,8711
2102,泰豐,30,0,30,陽信-石牌,2024-01-26,8711
00937B,群益ESG投等債20,22,0,22,陽信-石牌,2024-01-26,8711
00687B,國泰20年美債,29,9,20,陽信-石牌,2024-01-26,8711
00679B,元大美債20年,20,0,20,陽信-石牌,2024-01-26,8711
1314,中石化,20,0,20,陽信-石牌,2024-01-26,8711
2390,云辰,20,0,20,陽信-石牌,2024-01-26,8711
2605,新興,20,0,20,陽信-石牌,2024-01-26,8711
2344,華邦電,44,25,19,陽信-石牌,2024-01-26,8711
4979,華星光,20,1,19,陽信-石牌,2024-01-26,8711
1789,神隆,18,0,18,陽信-石牌,2024-01-26,8711
6282,康舒,20,4,16,陽信-石牌,2024-01-26,8711
3032,偉訓,17,1,16,陽信-石牌,2024-01-26,8711
3535,晶彩科,21,6,15,陽信-石牌,2024-01-26,8711
8027,鈦昇,20,5,15,陽信-石牌,2024-01-26,8711
2382,廣達,22,8,14,陽信-石牌,2024-01-26,8711
2457,飛宏,17,3,14,陽信-石牌,2024-01-26,8711
2454,聯發科,16,3,13,陽信-石牌,2024-01-26,8711
00882,中信中國高股息,14,1,13,陽信-石牌,2024-01-26,8711
3013,晟銘電,13,0,13,陽信-石牌,2024-01-26,8711
5251,天鉞電,13,0,13,陽信-石牌,2024-01-26,8711
8222,寶一,15,2,13,陽信-石牌,2024-01-26,8711
2356,英業達,28,16,12,陽信-石牌,2024-01-26,8711
00680L,元大美債20正2,11,0,11,陽信-石牌,2024-01-26,8711
2106,建大,11,0,11,陽信-石牌,2024-01-26,8711
2353,宏��,29,18,11,陽信-石牌,2024-01-26,8711
2363,矽統,11,0,11,陽信-石牌,2024-01-26,8711
3128,昇銳,11,0,11,陽信-石牌,2024-01-26,8711
3483,力致,12,1,11,陽信-石牌,2024-01-26,8711
00665L,富邦�琤肭磪囓�2,22,12,10,陽信-石牌,2024-01-26,8711
00643,群益深証中小,10,0,10,陽信-石牌,2024-01-26,8711
00898,國泰基因免疫革命,10,0,10,陽信-石牌,2024-01-26,8711
00922,國泰台灣領袖50,10,0,10,陽信-石牌,2024-01-26,8711
2329,華泰,30,20,10,陽信-石牌,2024-01-26,8711
8064,東捷,10,0,10,陽信-石牌,2024-01-26,8711
1503,士電,9,0,9,陽信-石牌,2024-01-26,8711
5489,彩富,10,1,9,陽信-石牌,2024-01-26,8711
1519,華城,21,13,8,陽信-石牌,2024-01-26,8711
2465,麗臺,8,0,8,陽信-石牌,2024-01-26,8711
2498,宏達電,8,0,8,陽信-石牌,2024-01-26,8711
8089,康全電訊,11,3,8,陽信-石牌,2024-01-26,8711
6235,華孚,7,0,7,陽信-石牌,2024-01-26,8711
2883,凱基金,998,0,998,陽信-石牌,2024-01-29,8711
00937B,群益ESG投等債20,88,0,88,陽信-石牌,2024-01-29,8711
3265,台星科,54,1,53,陽信-石牌,2024-01-29,8711
1303,南亞,50,0,50,陽信-石牌,2024-01-29,8711
1504,東元,50,0,50,陽信-石牌,2024-01-29,8711
5478,智冠,41,5,36,陽信-石牌,2024-01-29,8711
6451,訊芯-KY,30,3,27,陽信-石牌,2024-01-29,8711
00933B,國泰10Y+金融債,35,10,25,陽信-石牌,2024-01-29,8711
2365,昆盈,21,0,21,陽信-石牌,2024-01-29,8711
2610,華航,27,6,21,陽信-石牌,2024-01-29,8711
1718,中纖,20,0,20,陽信-石牌,2024-01-29,8711
2489,瑞軒,20,0,20,陽信-石牌,2024-01-29,8711
5484,慧友,20,0,20,陽信-石牌,2024-01-29,8711
6179,亞通,21,2,19,陽信-石牌,2024-01-29,8711
00687B,國泰20年美債,18,0,18,陽信-石牌,2024-01-29,8711
2368,金像電,18,3,15,陽信-石牌,2024-01-29,8711
00919,群益台灣精選高息,27,13,14,陽信-石牌,2024-01-29,8711
00878,國泰永續高股息,33,20,13,陽信-石牌,2024-01-29,8711
00877,復華中國5G,13,0,13,陽信-石牌,2024-01-29,8711
00931B,統一美債20年,11,0,11,陽信-石牌,2024-01-29,8711
2409,友達,18,7,11,陽信-石牌,2024-01-29,8711
6168,宏齊,11,0,11,陽信-石牌,2024-01-29,8711
00665L,富邦�琤肭磪囓�2,40,30,10,陽信-石牌,2024-01-29,8711
00764B,群益25年美債,10,0,10,陽信-石牌,2024-01-29,8711
1467,南緯,10,0,10,陽信-石牌,2024-01-29,8711
2324,仁寶,26,16,10,陽信-石牌,2024-01-29,8711
2390,云辰,10,0,10,陽信-石牌,2024-01-29,8711
2892,第一金,10,0,10,陽信-石牌,2024-01-29,8711
3450,聯鈞,15,5,10,陽信-石牌,2024-01-29,8711
3520,華盈,10,0,10,陽信-石牌,2024-01-29,8711
3523,迎輝,10,0,10,陽信-石牌,2024-01-29,8711
4906,正文,16,6,10,陽信-石牌,2024-01-29,8711
2356,英業達,23,14,9,陽信-石牌,2024-01-29,8711
2303,聯電,21,13,8,陽信-石牌,2024-01-29,8711
2337,旺宏,9,1,8,陽信-石牌,2024-01-29,8711
00679B,元大美債20年,7,0,7,陽信-石牌,2024-01-29,8711
00673R,期元大S＆P原油反1,97,90,7,陽信-石牌,2024-01-29,8711
1789,神隆,7,0,7,陽信-石牌,2024-01-29,8711
1905,華紙,22,15,7,陽信-石牌,2024-01-29,8711
2836,高雄銀,7,0,7,陽信-石牌,2024-01-29,8711
5469,瀚宇博,9,2,7,陽信-石牌,2024-01-29,8711
2317,鴻海,6,0,6,陽信-石牌,2024-01-29,8711
2344,華邦電,17,11,6,陽信-石牌,2024-01-29,8711
3622,洋華,6,0,6,陽信-石牌,2024-01-29,8711
6237,驊訊,7,1,6,陽信-石牌,2024-01-29,8711
6472,保瑞,6,0,6,陽信-石牌,2024-01-29,8711
6768,志強-KY,6,0,6,陽信-石牌,2024-01-29,8711
1325,恆大,10,5,5,陽信-石牌,2024-01-29,8711
1216,統一,5,0,5,陽信-石牌,2024-01-29,8711
00927,群益半導體收益,5,0,5,陽信-石牌,2024-01-29,8711
3481,群創,358,84,274,陽信-石牌,2024-01-30,8711
00882,中信中國高股息,148,20,128,陽信-石牌,2024-01-30,8711
00927,群益半導體收益,121,0,121,陽信-石牌,2024-01-30,8711
00679B,元大美債20年,87,1,86,陽信-石牌,2024-01-30,8711
1722,台肥,60,0,60,陽信-石牌,2024-01-30,8711
00637L,元大滬深300正2,72,16,56,陽信-石牌,2024-01-30,8711
2897,王道銀行,52,0,52,陽信-石牌,2024-01-30,8711
6451,訊芯-KY,42,2,40,陽信-石牌,2024-01-30,8711
3715,定穎投控,42,7,35,陽信-石牌,2024-01-30,8711
2344,華邦電,42,8,34,陽信-石牌,2024-01-30,8711
00929,復華台灣科技優息,32,0,32,陽信-石牌,2024-01-30,8711
3265,台星科,28,1,27,陽信-石牌,2024-01-30,8711
2356,英業達,48,24,24,陽信-石牌,2024-01-30,8711
1471,首利,20,0,20,陽信-石牌,2024-01-30,8711
00713,元大台灣高息低波,20,0,20,陽信-石牌,2024-01-30,8711
2601,益航,20,0,20,陽信-石牌,2024-01-30,8711
6179,亞通,25,5,20,陽信-石牌,2024-01-30,8711
6229,研通,43,23,20,陽信-石牌,2024-01-30,8711
00772B,中信高評級公司債,19,0,19,陽信-石牌,2024-01-30,8711
2313,華通,20,1,19,陽信-石牌,2024-01-30,8711
2603,長榮,20,1,19,陽信-石牌,2024-01-30,8711
8064,東捷,26,8,18,陽信-石牌,2024-01-30,8711
00934,中信成長高股息,17,0,17,陽信-石牌,2024-01-30,8711
6147,頎邦,31,14,17,陽信-石牌,2024-01-30,8711
5272,笙科,16,0,16,陽信-石牌,2024-01-30,8711
2002,中鋼,15,0,15,陽信-石牌,2024-01-30,8711
2455,全新,20,5,15,陽信-石牌,2024-01-30,8711
6768,志強-KY,15,0,15,陽信-石牌,2024-01-30,8711
2609,陽明,16,2,14,陽信-石牌,2024-01-30,8711
3706,神達,24,11,13,陽信-石牌,2024-01-30,8711
6182,合晶,15,2,13,陽信-石牌,2024-01-30,8711
6113,亞矽,25,13,12,陽信-石牌,2024-01-30,8711
2886,兆豐金,13,2,11,陽信-石牌,2024-01-30,8711
00687B,國泰20年美債,13,2,11,陽信-石牌,2024-01-30,8711
1503,士電,11,0,11,陽信-石牌,2024-01-30,8711
2352,佳世達,15,4,11,陽信-石牌,2024-01-30,8711
2498,宏達電,11,0,11,陽信-石牌,2024-01-30,8711
2606,裕民,12,1,11,陽信-石牌,2024-01-30,8711
2883,凱基金,11,0,11,陽信-石牌,2024-01-30,8711
3380,明泰,11,0,11,陽信-石牌,2024-01-30,8711
8110,華東,11,0,11,陽信-石牌,2024-01-30,8711
8936,國統,12,1,11,陽信-石牌,2024-01-30,8711
5388,中磊,11,1,10,陽信-石牌,2024-01-30,8711
6235,華孚,10,0,10,陽信-石牌,2024-01-30,8711
1409,新纖,10,0,10,陽信-石牌,2024-01-30,8711
00905,FT臺灣Smart,10,0,10,陽信-石牌,2024-01-30,8711
1612,宏泰,10,0,10,陽信-石牌,2024-01-30,8711
3043,科風,10,0,10,陽信-石牌,2024-01-30,8711
3686,達能,10,0,10,陽信-石牌,2024-01-30,8711
4906,正文,10,0,10,陽信-石牌,2024-01-30,8711
00687B,國泰20年美債,224,11,213,陽信-石牌,2024-01-31,8711
00937B,群益ESG投等債20,106,2,104,陽信-石牌,2024-01-31,8711
2883,凱基金,100,0,100,陽信-石牌,2024-01-31,8711
3581,博磊,50,13,37,陽信-石牌,2024-01-31,8711
1722,台肥,30,0,30,陽信-石牌,2024-01-31,8711
3055,蔚華科,44,15,29,陽信-石牌,2024-01-31,8711
3189,景碩,29,1,28,陽信-石牌,2024-01-31,8711
2609,陽明,49,22,27,陽信-石牌,2024-01-31,8711
2330,台積電,28,3,25,陽信-石牌,2024-01-31,8711
0050,元大台灣50,24,0,24,陽信-石牌,2024-01-31,8711
00929,復華台灣科技優息,28,4,24,陽信-石牌,2024-01-31,8711
00773B,中信優先金融債,25,3,22,陽信-石牌,2024-01-31,8711
2369,菱生,24,3,21,陽信-石牌,2024-01-31,8711
3265,台星科,26,6,20,陽信-石牌,2024-01-31,8711
3290,東浦,20,0,20,陽信-石牌,2024-01-31,8711
3706,神達,21,2,19,陽信-石牌,2024-01-31,8711
5347,世界,22,3,19,陽信-石牌,2024-01-31,8711
3360,尚立,26,8,18,陽信-石牌,2024-01-31,8711
00877,復華中國5G,18,2,16,陽信-石牌,2024-01-31,8711
6113,亞矽,28,13,15,陽信-石牌,2024-01-31,8711
2405,輔信,13,0,13,陽信-石牌,2024-01-31,8711
00882,中信中國高股息,12,0,12,陽信-石牌,2024-01-31,8711
2356,英業達,20,8,12,陽信-石牌,2024-01-31,8711
3032,偉訓,15,3,12,陽信-石牌,2024-01-31,8711
6841,長佳智能,12,0,12,陽信-石牌,2024-01-31,8711
2303,聯電,15,4,11,陽信-石牌,2024-01-31,8711
00646,元大S＆P500,11,0,11,陽信-石牌,2024-01-31,8711
2382,廣達,19,8,11,陽信-石牌,2024-01-31,8711
2637,慧洋-KY,11,0,11,陽信-石牌,2024-01-31,8711
6462,神盾,17,7,10,陽信-石牌,2024-01-31,8711
2603,長榮,10,0,10,陽信-石牌,2024-01-31,8711
00712,復華富時不動產,10,0,10,陽信-石牌,2024-01-31,8711
3041,揚智,11,1,10,陽信-石牌,2024-01-31,8711
4154,樂威科-KY,10,0,10,陽信-石牌,2024-01-31,8711
4542,科嶠,10,0,10,陽信-石牌,2024-01-31,8711
4714,永捷,10,0,10,陽信-石牌,2024-01-31,8711
6282,康舒,20,11,9,陽信-石牌,2024-01-31,8711
00713,元大台灣高息低波,9,0,9,陽信-石牌,2024-01-31,8711
2344,華邦電,11,2,9,陽信-石牌,2024-01-31,8711
3025,星通,13,4,9,陽信-石牌,2024-01-31,8711
4960,誠美材,9,0,9,陽信-石牌,2024-01-31,8711
00919,群益台灣精選高息,8,0,8,陽信-石牌,2024-01-31,8711
2605,新興,8,0,8,陽信-石牌,2024-01-31,8711
5263,智崴,8,0,8,陽信-石牌,2024-01-31,8711
2886,兆豐金,12,5,7,陽信-石牌,2024-01-31,8711
00936,台新永續高息中小,6,0,6,陽信-石牌,2024-01-31,8711
2352,佳世達,16,10,6,陽信-石牌,2024-01-31,8711
2421,建準,18,12,6,陽信-石牌,2024-01-31,8711
3715,定穎投控,12,6,6,陽信-石牌,2024-01-31,8711
5533,皇鼎,6,0,6,陽信-石牌,2024-01-31,8711
2303,聯電,165,5,160,陽信-石牌,2024-02-01,8711
00919,群益台灣精選高息,73,6,67,陽信-石牌,2024-02-01,8711
00929,復華台灣科技優息,60,1,59,陽信-石牌,2024-02-01,8711
00937B,群益ESG投等債20,55,6,49,陽信-石牌,2024-02-01,8711
3260,威剛,40,1,39,陽信-石牌,2024-02-01,8711
00936,台新永續高息中小,35,0,35,陽信-石牌,2024-02-01,8711
2313,華通,28,1,27,陽信-石牌,2024-02-01,8711
3545,敦泰,28,2,26,陽信-石牌,2024-02-01,8711
2365,昆盈,36,15,21,陽信-石牌,2024-02-01,8711
4967,十銓,20,0,20,陽信-石牌,2024-02-01,8711
6695,芯鼎,30,10,20,陽信-石牌,2024-02-01,8711
6768,志強-KY,20,0,20,陽信-石牌,2024-02-01,8711
6442,光聖,31,12,19,陽信-石牌,2024-02-01,8711
6243,迅杰,29,11,18,陽信-石牌,2024-02-01,8711
2812,台中銀,25,7,18,陽信-石牌,2024-02-01,8711
6143,振曜,17,0,17,陽信-石牌,2024-02-01,8711
2486,一詮,16,0,16,陽信-石牌,2024-02-01,8711
6116,彩晶,15,0,15,陽信-石牌,2024-02-01,8711
2356,英業達,23,9,14,陽信-石牌,2024-02-01,8711
8930,青鋼,14,2,12,陽信-石牌,2024-02-01,8711
8936,國統,24,12,12,陽信-石牌,2024-02-01,8711
2330,台積電,17,5,12,陽信-石牌,2024-02-01,8711
1319,東陽,13,2,11,陽信-石牌,2024-02-01,8711
5388,中磊,11,0,11,陽信-石牌,2024-02-01,8711
00680L,元大美債20正2,10,0,10,陽信-石牌,2024-02-01,8711
2476,鉅祥,10,0,10,陽信-石牌,2024-02-01,8711
2634,漢翔,10,0,10,陽信-石牌,2024-02-01,8711
3234,光環,10,0,10,陽信-石牌,2024-02-01,8711
3437,榮創,11,1,10,陽信-石牌,2024-02-01,8711
3581,博磊,12,2,10,陽信-石牌,2024-02-01,8711
6237,驊訊,14,4,10,陽信-石牌,2024-02-01,8711
6530,創威,10,0,10,陽信-石牌,2024-02-01,8711
6770,力積電,10,0,10,陽信-石牌,2024-02-01,8711
3231,緯創,25,16,9,陽信-石牌,2024-02-01,8711
2461,光群雷,9,0,9,陽信-石牌,2024-02-01,8711
4933,友輝,14,5,9,陽信-石牌,2024-02-01,8711
6147,頎邦,9,0,9,陽信-石牌,2024-02-01,8711
00679B,元大美債20年,10,2,8,陽信-石牌,2024-02-01,8711
2353,宏��,9,1,8,陽信-石牌,2024-02-01,8711
3376,新日興,26,18,8,陽信-石牌,2024-02-01,8711
2412,中華電,7,0,7,陽信-石牌,2024-02-01,8711
3548,兆利,14,7,7,陽信-石牌,2024-02-01,8711
8011,台通,7,0,7,陽信-石牌,2024-02-01,8711
8096,擎亞,32,25,7,陽信-石牌,2024-02-01,8711
2897,王道銀行,6,0,6,陽信-石牌,2024-02-01,8711
6182,合晶,6,0,6,陽信-石牌,2024-02-01,8711
6667,信紘科,7,1,6,陽信-石牌,2024-02-01,8711
3707,漢磊,6,0,6,陽信-石牌,2024-02-01,8711
1218,泰山,5,0,5,陽信-石牌,2024-02-01,8711
00665L,富邦�琤肭磪囓�2,54,49,5,陽信-石牌,2024-02-01,8711
2504,國產,202,0,202,陽信-石牌,2024-02-02,8711
00937B,群益ESG投等債20,174,0,174,陽信-石牌,2024-02-02,8711
2303,聯電,162,0,162,陽信-石牌,2024-02-02,8711
3376,新日興,91,5,86,陽信-石牌,2024-02-02,8711
2897,王道銀行,55,0,55,陽信-石牌,2024-02-02,8711
2305,全友,52,0,52,陽信-石牌,2024-02-02,8711
2313,華通,56,12,44,陽信-石牌,2024-02-02,8711
2603,長榮,36,0,36,陽信-石牌,2024-02-02,8711
2609,陽明,72,36,36,陽信-石牌,2024-02-02,8711
2637,慧洋-KY,35,0,35,陽信-石牌,2024-02-02,8711
2618,長榮航,41,10,31,陽信-石牌,2024-02-02,8711
2344,華邦電,28,0,28,陽信-石牌,2024-02-02,8711
00637L,元大滬深300正2,21,0,21,陽信-石牌,2024-02-02,8711
00725B,國泰投資級公司債,21,0,21,陽信-石牌,2024-02-02,8711
00715L,期街口布蘭特正2,21,0,21,陽信-石牌,2024-02-02,8711
2405,輔信,20,0,20,陽信-石牌,2024-02-02,8711
9907,統一實,20,0,20,陽信-石牌,2024-02-02,8711
2615,萬海,19,0,19,陽信-石牌,2024-02-02,8711
6770,力積電,18,2,16,陽信-石牌,2024-02-02,8711
8473,山林水,16,0,16,陽信-石牌,2024-02-02,8711
2883,凱基金,16,0,16,陽信-石牌,2024-02-02,8711
1609,大亞,17,2,15,陽信-石牌,2024-02-02,8711
8996,高力,21,6,15,陽信-石牌,2024-02-02,8711
1905,華紙,21,7,14,陽信-石牌,2024-02-02,8711
5439,高技,17,3,14,陽信-石牌,2024-02-02,8711
8085,福華,14,0,14,陽信-石牌,2024-02-02,8711
3081,聯亞,16,3,13,陽信-石牌,2024-02-02,8711
2324,仁寶,14,1,13,陽信-石牌,2024-02-02,8711
3543,州巧,13,0,13,陽信-石牌,2024-02-02,8711
4960,誠美材,15,2,13,陽信-石牌,2024-02-02,8711
3037,欣興,12,0,12,陽信-石牌,2024-02-02,8711
6237,驊訊,12,0,12,陽信-石牌,2024-02-02,8711
1795,美時,12,1,11,陽信-石牌,2024-02-02,8711
3374,精材,11,0,11,陽信-石牌,2024-02-02,8711
8096,擎亞,13,2,11,陽信-石牌,2024-02-02,8711
8110,華東,11,0,11,陽信-石牌,2024-02-02,8711
3041,揚智,10,0,10,陽信-石牌,2024-02-02,8711
3437,榮創,20,10,10,陽信-石牌,2024-02-02,8711
3576,聯合再生,10,0,10,陽信-石牌,2024-02-02,8711
3605,宏致,10,0,10,陽信-石牌,2024-02-02,8711
5309,系統電,10,0,10,陽信-石牌,2024-02-02,8711
6266,泰詠,10,0,10,陽信-石牌,2024-02-02,8711
2363,矽統,9,0,9,陽信-石牌,2024-02-02,8711
2606,裕民,9,0,9,陽信-石牌,2024-02-02,8711
3520,華盈,10,1,9,陽信-石牌,2024-02-02,8711
6151,晉倫,9,0,9,陽信-石牌,2024-02-02,8711
00933B,國泰10Y+金融債,10,2,8,陽信-石牌,2024-02-02,8711
3006,晶豪科,8,0,8,陽信-石牌,2024-02-02,8711
6125,廣運,11,3,8,陽信-石牌,2024-02-02,8711
00712,復華富時不動產,7,0,7,陽信-石牌,2024-02-02,8711
2303,聯電,111,12,99,陽信-石牌,2024-02-05,8711
2882,國泰金,65,0,65,陽信-石牌,2024-02-05,8711
00882,中信中國高股息,61,0,61,陽信-石牌,2024-02-05,8711
00937B,群益ESG投等債20,56,0,56,陽信-石牌,2024-02-05,8711
2504,國產,50,0,50,陽信-石牌,2024-02-05,8711
2883,凱基金,46,0,46,陽信-石牌,2024-02-05,8711
2405,輔信,45,5,40,陽信-石牌,2024-02-05,8711
4908,前鼎,36,2,34,陽信-石牌,2024-02-05,8711
00687B,國泰20年美債,38,7,31,陽信-石牌,2024-02-05,8711
2891,中信金,31,0,31,陽信-石牌,2024-02-05,8711
3543,州巧,33,2,31,陽信-石牌,2024-02-05,8711
3231,緯創,110,79,31,陽信-石牌,2024-02-05,8711
1528,恩德,29,0,29,陽信-石牌,2024-02-05,8711
2421,建準,62,33,29,陽信-石牌,2024-02-05,8711
2884,玉山金,28,0,28,陽信-石牌,2024-02-05,8711
2498,宏達電,24,0,24,陽信-石牌,2024-02-05,8711
6229,研通,29,5,24,陽信-石牌,2024-02-05,8711
2329,華泰,35,12,23,陽信-石牌,2024-02-05,8711
2610,華航,24,1,23,陽信-石牌,2024-02-05,8711
00929,復華台灣科技優息,49,27,22,陽信-石牌,2024-02-05,8711
5880,合庫金,22,0,22,陽信-石牌,2024-02-05,8711
00712,復華富時不動產,20,0,20,陽信-石牌,2024-02-05,8711
2363,矽統,22,2,20,陽信-石牌,2024-02-05,8711
2606,裕民,20,1,19,陽信-石牌,2024-02-05,8711
6684,安格,20,2,18,陽信-石牌,2024-02-05,8711
2002,中鋼,17,0,17,陽信-石牌,2024-02-05,8711
1905,華紙,20,5,15,陽信-石牌,2024-02-05,8711
1314,中石化,14,0,14,陽信-石牌,2024-02-05,8711
2492,華新科,14,0,14,陽信-石牌,2024-02-05,8711
4706,大恭,14,0,14,陽信-石牌,2024-02-05,8711
8358,金居,14,0,14,陽信-石牌,2024-02-05,8711
00715L,期街口布蘭特正2,12,0,12,陽信-石牌,2024-02-05,8711
1514,亞力,16,5,11,陽信-石牌,2024-02-05,8711
2637,慧洋-KY,11,0,11,陽信-石牌,2024-02-05,8711
3545,敦泰,11,0,11,陽信-石牌,2024-02-05,8711
8054,安國,11,0,11,陽信-石牌,2024-02-05,8711
8936,國統,13,2,11,陽信-石牌,2024-02-05,8711
1609,大亞,10,0,10,陽信-石牌,2024-02-05,8711
2809,京城銀,10,0,10,陽信-石牌,2024-02-05,8711
3593,力銘,10,0,10,陽信-石牌,2024-02-05,8711
4142,國光生,10,0,10,陽信-石牌,2024-02-05,8711
4979,華星光,15,5,10,陽信-石牌,2024-02-05,8711
6235,華孚,10,0,10,陽信-石牌,2024-02-05,8711
6550,北極星藥業-KY,10,0,10,陽信-石牌,2024-02-05,8711
6672,騰輝電子-KY,10,0,10,陽信-石牌,2024-02-05,8711
6863,永道-KY,13,3,10,陽信-石牌,2024-02-05,8711
00688L,國泰20年美債正2,9,0,9,陽信-石牌,2024-02-05,8711
2301,光寶科,10,1,9,陽信-石牌,2024-02-05,8711
3338,泰碩,18,9,9,陽信-石牌,2024-02-05,8711
4503,金雨,9,0,9,陽信-石牌,2024-02-05,8711
00931B,統一美債20年,150,0,150,陽信-石牌,2024-02-15,8711
3481,群創,268,146,122,陽信-石牌,2024-02-15,8711
00937B,群益ESG投等債20,119,1,118,陽信-石牌,2024-02-15,8711
00688L,國泰20年美債正2,114,0,114,陽信-石牌,2024-02-15,8711
00673R,期元大S＆P原油反1,98,0,98,陽信-石牌,2024-02-15,8711
00927,群益半導體收益,108,18,90,陽信-石牌,2024-02-15,8711
00687B,國泰20年美債,80,0,80,陽信-石牌,2024-02-15,8711
00706L,期元大S＆P日圓正2,80,0,80,陽信-石牌,2024-02-15,8711
2356,英業達,98,45,53,陽信-石牌,2024-02-15,8711
2883,凱基金,52,1,51,陽信-石牌,2024-02-15,8711
2504,國產,50,0,50,陽信-石牌,2024-02-15,8711
00891,中信關鍵半導體,50,2,48,陽信-石牌,2024-02-15,8711
2344,華邦電,54,11,43,陽信-石牌,2024-02-15,8711
00679B,元大美債20年,42,0,42,陽信-石牌,2024-02-15,8711
3711,日月光投控,39,4,35,陽信-石牌,2024-02-15,8711
2637,慧洋-KY,53,19,34,陽信-石牌,2024-02-15,8711
2408,南亞科,35,2,33,陽信-石牌,2024-02-15,8711
1789,神隆,32,0,32,陽信-石牌,2024-02-15,8711
2331,精英,31,0,31,陽信-石牌,2024-02-15,8711
2610,華航,35,5,30,陽信-石牌,2024-02-15,8711
8086,宏捷科,35,5,30,陽信-石牌,2024-02-15,8711
2618,長榮航,40,13,27,陽信-石牌,2024-02-15,8711
00720B,元大投資級公司債,25,0,25,陽信-石牌,2024-02-15,8711
00751B,元大AAA至A公司債,24,0,24,陽信-石牌,2024-02-15,8711
00919,群益台灣精選高息,40,19,21,陽信-石牌,2024-02-15,8711
2354,鴻準,20,0,20,陽信-石牌,2024-02-15,8711
4142,國光生,20,0,20,陽信-石牌,2024-02-15,8711
5465,富驊,20,0,20,陽信-石牌,2024-02-15,8711
3265,台星科,60,42,18,陽信-石牌,2024-02-15,8711
8473,山林水,18,0,18,陽信-石牌,2024-02-15,8711
2301,光寶科,19,3,16,陽信-石牌,2024-02-15,8711
00651R,復華香港反1,25,10,15,陽信-石牌,2024-02-15,8711
4157,太景*-KY,15,0,15,陽信-石牌,2024-02-15,8711
00712,復華富時不動產,14,0,14,陽信-石牌,2024-02-15,8711
1467,南緯,13,0,13,陽信-石牌,2024-02-15,8711
1513,中興電,16,3,13,陽信-石牌,2024-02-15,8711
3032,偉訓,61,48,13,陽信-石牌,2024-02-15,8711
8054,安國,17,4,13,陽信-石牌,2024-02-15,8711
3294,英濟,18,6,12,陽信-石牌,2024-02-15,8711
3035,智原,16,5,11,陽信-石牌,2024-02-15,8711
2892,第一金,11,0,11,陽信-石牌,2024-02-15,8711
3036,文曄,14,3,11,陽信-石牌,2024-02-15,8711
3209,全科,11,0,11,陽信-石牌,2024-02-15,8711
2376,技嘉,23,13,10,陽信-石牌,2024-02-15,8711
1307,三芳,10,0,10,陽信-石牌,2024-02-15,8711
1447,力鵬,10,0,10,陽信-石牌,2024-02-15,8711
2845,遠東銀,10,0,10,陽信-石牌,2024-02-15,8711
3321,同泰,10,0,10,陽信-石牌,2024-02-15,8711
3380,明泰,10,0,10,陽信-石牌,2024-02-15,8711
3645,達邁,10,0,10,陽信-石牌,2024-02-15,8711
2606,裕民,150,5,145,陽信-石牌,2024-02-16,8711
2882,國泰金,112,3,109,陽信-石牌,2024-02-16,8711
0050,元大台灣50,97,1,96,陽信-石牌,2024-02-16,8711
2303,聯電,97,1,96,陽信-石牌,2024-02-16,8711
00679B,元大美債20年,88,0,88,陽信-石牌,2024-02-16,8711
2353,宏��,165,82,83,陽信-石牌,2024-02-16,8711
00634R,富邦上証反1,125,51,74,陽信-石牌,2024-02-16,8711
3711,日月光投控,66,2,64,陽信-石牌,2024-02-16,8711
4915,致伸,61,1,60,陽信-石牌,2024-02-16,8711
00937B,群益ESG投等債20,44,0,44,陽信-石牌,2024-02-16,8711
9904,寶成,43,0,43,陽信-石牌,2024-02-16,8711
00706L,期元大S＆P日圓正2,40,0,40,陽信-石牌,2024-02-16,8711
00687B,國泰20年美債,63,25,38,陽信-石牌,2024-02-16,8711
2382,廣達,95,58,37,陽信-石牌,2024-02-16,8711
2405,輔信,39,8,31,陽信-石牌,2024-02-16,8711
3265,台星科,31,4,27,陽信-石牌,2024-02-16,8711
2014,中鴻,56,30,26,陽信-石牌,2024-02-16,8711
00712,復華富時不動產,25,0,25,陽信-石牌,2024-02-16,8711
1785,光洋科,72,47,25,陽信-石牌,2024-02-16,8711
2356,英業達,44,19,25,陽信-石牌,2024-02-16,8711
3231,緯創,92,68,24,陽信-石牌,2024-02-16,8711
3041,揚智,22,0,22,陽信-石牌,2024-02-16,8711
9105,泰金寶-DR,23,2,21,陽信-石牌,2024-02-16,8711
00931B,統一美債20年,20,0,20,陽信-石牌,2024-02-16,8711
8936,國統,64,44,20,陽信-石牌,2024-02-16,8711
00688L,國泰20年美債正2,18,0,18,陽信-石牌,2024-02-16,8711
8473,山林水,31,14,17,陽信-石牌,2024-02-16,8711
4503,金雨,16,0,16,陽信-石牌,2024-02-16,8711
2365,昆盈,72,57,15,陽信-石牌,2024-02-16,8711
00680L,元大美債20正2,19,5,14,陽信-石牌,2024-02-16,8711
5443,均豪,20,6,14,陽信-石牌,2024-02-16,8711
0056,元大高股息,16,2,14,陽信-石牌,2024-02-16,8711
00696B,富邦美債20年,13,0,13,陽信-石牌,2024-02-16,8711
00720B,元大投資級公司債,15,3,12,陽信-石牌,2024-02-16,8711
2355,敬鵬,20,8,12,陽信-石牌,2024-02-16,8711
2376,技嘉,23,12,11,陽信-石牌,2024-02-16,8711
00933B,國泰10Y+金融債,11,0,11,陽信-石牌,2024-02-16,8711
2367,燿華,47,36,11,陽信-石牌,2024-02-16,8711
3035,智原,13,2,11,陽信-石牌,2024-02-16,8711
3322,建舜電,11,0,11,陽信-石牌,2024-02-16,8711
00891,中信關鍵半導體,10,0,10,陽信-石牌,2024-02-16,8711
00885,富邦越南,10,0,10,陽信-石牌,2024-02-16,8711
00927,群益半導體收益,170,160,10,陽信-石牌,2024-02-16,8711
1447,力鵬,10,0,10,陽信-石牌,2024-02-16,8711
2312,金寶,10,0,10,陽信-石牌,2024-02-16,8711
2362,藍天,11,1,10,陽信-石牌,2024-02-16,8711
2488,漢平,10,0,10,陽信-石牌,2024-02-16,8711
2511,太子,10,0,10,陽信-石牌,2024-02-16,8711
2515,中工,10,0,10,陽信-石牌,2024-02-16,8711
2537,聯上發,10,0,10,陽信-石牌,2024-02-16,8711
00929,復華台灣科技優息,204,1,203,陽信-石牌,2024-02-19,8711
1815,富喬,251,116,135,陽信-石牌,2024-02-19,8711
2883,凱基金,100,12,88,陽信-石牌,2024-02-19,8711
00937B,群益ESG投等債20,68,0,68,陽信-石牌,2024-02-19,8711
1789,神隆,64,0,64,陽信-石牌,2024-02-19,8711
00687B,國泰20年美債,55,0,55,陽信-石牌,2024-02-19,8711
1504,東元,46,0,46,陽信-石牌,2024-02-19,8711
00919,群益台灣精選高息,37,0,37,陽信-石牌,2024-02-19,8711
6120,達運,36,0,36,陽信-石牌,2024-02-19,8711
2313,華通,34,2,32,陽信-石牌,2024-02-19,8711
2468,華經,32,0,32,陽信-石牌,2024-02-19,8711
2369,菱生,33,6,27,陽信-石牌,2024-02-19,8711
5347,世界,25,1,24,陽信-石牌,2024-02-19,8711
2427,三商電,24,1,23,陽信-石牌,2024-02-19,8711
3207,耀勝,22,0,22,陽信-石牌,2024-02-19,8711
5452,佶優,22,0,22,陽信-石牌,2024-02-19,8711
3707,漢磊,20,0,20,陽信-石牌,2024-02-19,8711
4157,太景*-KY,25,5,20,陽信-石牌,2024-02-19,8711
3481,群創,49,30,19,陽信-石牌,2024-02-19,8711
2330,台積電,30,11,19,陽信-石牌,2024-02-19,8711
2365,昆盈,52,34,18,陽信-石牌,2024-02-19,8711
3017,奇鋐,25,7,18,陽信-石牌,2024-02-19,8711
4123,晟德,20,2,18,陽信-石牌,2024-02-19,8711
2454,聯發科,19,2,17,陽信-石牌,2024-02-19,8711
0056,元大高股息,19,2,17,陽信-石牌,2024-02-19,8711
3712,永崴投控,21,4,17,陽信-石牌,2024-02-19,8711
00673R,期元大S＆P原油反1,16,0,16,陽信-石牌,2024-02-19,8711
4960,誠美材,17,1,16,陽信-石牌,2024-02-19,8711
3374,精材,20,5,15,陽信-石牌,2024-02-19,8711
00931B,統一美債20年,14,0,14,陽信-石牌,2024-02-19,8711
2352,佳世達,15,1,14,陽信-石牌,2024-02-19,8711
2353,宏��,40,26,14,陽信-石牌,2024-02-19,8711
3048,益登,14,0,14,陽信-石牌,2024-02-19,8711
3363,上詮,18,4,14,陽信-石牌,2024-02-19,8711
4938,和碩,13,0,13,陽信-石牌,2024-02-19,8711
8096,擎亞,19,6,13,陽信-石牌,2024-02-19,8711
1720,生達,12,0,12,陽信-石牌,2024-02-19,8711
5443,均豪,16,5,11,陽信-石牌,2024-02-19,8711
00764B,群益25年美債,10,0,10,陽信-石牌,2024-02-19,8711
00679B,元大美債20年,60,50,10,陽信-石牌,2024-02-19,8711
1612,宏泰,10,0,10,陽信-石牌,2024-02-19,8711
2528,皇普,10,0,10,陽信-石牌,2024-02-19,8711
3576,聯合再生,10,0,10,陽信-石牌,2024-02-19,8711
3617,碩天,10,0,10,陽信-石牌,2024-02-19,8711
4526,東台,10,0,10,陽信-石牌,2024-02-19,8711
5344,立衛,10,0,10,陽信-石牌,2024-02-19,8711
6127,九豪,10,0,10,陽信-石牌,2024-02-19,8711
6550,北極星藥業-KY,10,0,10,陽信-石牌,2024-02-19,8711
8112,至上,21,11,10,陽信-石牌,2024-02-19,8711
00688L,國泰20年美債正2,9,0,9,陽信-石牌,2024-02-19,8711
2392,正崴,110,0,110,陽信-石牌,2024-02-20,8711
00937B,群益ESG投等債20,89,0,89,陽信-石牌,2024-02-20,8711
00713,元大台灣高息低波,86,0,86,陽信-石牌,2024-02-20,8711
3711,日月光投控,80,1,79,陽信-石牌,2024-02-20,8711
1815,富喬,86,9,77,陽信-石牌,2024-02-20,8711
2344,華邦電,70,6,64,陽信-石牌,2024-02-20,8711
3481,群創,64,0,64,陽信-石牌,2024-02-20,8711
4915,致伸,62,0,62,陽信-石牌,2024-02-20,8711
8996,高力,66,8,58,陽信-石牌,2024-02-20,8711
4960,誠美材,64,21,43,陽信-石牌,2024-02-20,8711
00632R,元大台灣50反1,50,9,41,陽信-石牌,2024-02-20,8711
8110,華東,62,27,35,陽信-石牌,2024-02-20,8711
00679B,元大美債20年,32,2,30,陽信-石牌,2024-02-20,8711
2431,聯昌,30,0,30,陽信-石牌,2024-02-20,8711
2617,台航,40,10,30,陽信-石牌,2024-02-20,8711
00687B,國泰20年美債,26,1,25,陽信-石牌,2024-02-20,8711
2002,中鋼,24,0,24,陽信-石牌,2024-02-20,8711
6282,康舒,66,42,24,陽信-石牌,2024-02-20,8711
1219,福壽,20,0,20,陽信-石牌,2024-02-20,8711
00885,富邦越南,20,0,20,陽信-石牌,2024-02-20,8711
2380,虹光,20,0,20,陽信-石牌,2024-02-20,8711
2460,建通,20,5,15,陽信-石牌,2024-02-20,8711
2489,瑞軒,26,11,15,陽信-石牌,2024-02-20,8711
6126,信音,19,4,15,陽信-石牌,2024-02-20,8711
5452,佶優,14,0,14,陽信-石牌,2024-02-20,8711
00857B,永豐20年美公債,12,0,12,陽信-石牌,2024-02-20,8711
00931B,統一美債20年,12,0,12,陽信-石牌,2024-02-20,8711
00712,復華富時不動產,12,0,12,陽信-石牌,2024-02-20,8711
2401,凌陽,12,0,12,陽信-石牌,2024-02-20,8711
5340,建榮,12,0,12,陽信-石牌,2024-02-20,8711
5381,合正,14,2,12,陽信-石牌,2024-02-20,8711
6807,峰源-KY,12,0,12,陽信-石牌,2024-02-20,8711
3504,揚明光,11,0,11,陽信-石牌,2024-02-20,8711
3715,定穎投控,13,2,11,陽信-石牌,2024-02-20,8711
6207,雷科,11,0,11,陽信-石牌,2024-02-20,8711
6233,旺玖,16,5,11,陽信-石牌,2024-02-20,8711
8105,凌巨,11,0,11,陽信-石牌,2024-02-20,8711
8150,南茂,11,0,11,陽信-石牌,2024-02-20,8711
1905,華紙,20,10,10,陽信-石牌,2024-02-20,8711
2301,光寶科,11,1,10,陽信-石牌,2024-02-20,8711
2353,宏��,16,6,10,陽信-石牌,2024-02-20,8711
3260,威剛,11,1,10,陽信-石牌,2024-02-20,8711
3520,華盈,10,0,10,陽信-石牌,2024-02-20,8711
3576,聯合再生,10,0,10,陽信-石牌,2024-02-20,8711
3607,谷崧,17,7,10,陽信-石牌,2024-02-20,8711
4927,泰鼎-KY,10,0,10,陽信-石牌,2024-02-20,8711
6182,合晶,10,0,10,陽信-石牌,2024-02-20,8711
6237,驊訊,10,0,10,陽信-石牌,2024-02-20,8711
6667,信紘科,23,13,10,陽信-石牌,2024-02-20,8711
9955,佳龍,10,0,10,陽信-石牌,2024-02-20,8711
2303,聯電,200,1,199,陽信-石牌,2024-02-21,8711
2330,台積電,113,0,113,陽信-石牌,2024-02-21,8711
00927,群益半導體收益,100,0,100,陽信-石牌,2024-02-21,8711
00878,國泰永續高股息,84,6,78,陽信-石牌,2024-02-21,8711
00919,群益台灣精選高息,71,13,58,陽信-石牌,2024-02-21,8711
2460,建通,82,25,57,陽信-石牌,2024-02-21,8711
00937B,群益ESG投等債20,55,0,55,陽信-石牌,2024-02-21,8711
6233,旺玖,69,15,54,陽信-石牌,2024-02-21,8711
00687B,國泰20年美債,44,1,43,陽信-石牌,2024-02-21,8711
00679B,元大美債20年,42,0,42,陽信-石牌,2024-02-21,8711
1722,台肥,40,0,40,陽信-石牌,2024-02-21,8711
1314,中石化,37,0,37,陽信-石牌,2024-02-21,8711
4915,致伸,40,3,37,陽信-石牌,2024-02-21,8711
2891,中信金,50,13,37,陽信-石牌,2024-02-21,8711
2380,虹光,30,0,30,陽信-石牌,2024-02-21,8711
2382,廣達,41,11,30,陽信-石牌,2024-02-21,8711
00933B,國泰10Y+金融債,29,0,29,陽信-石牌,2024-02-21,8711
3260,威剛,43,15,28,陽信-石牌,2024-02-21,8711
3066,李洲,36,9,27,陽信-石牌,2024-02-21,8711
3057,喬鼎,26,0,26,陽信-石牌,2024-02-21,8711
1815,富喬,25,0,25,陽信-石牌,2024-02-21,8711
6290,良維,38,13,25,陽信-石牌,2024-02-21,8711
1785,光洋科,49,27,22,陽信-石牌,2024-02-21,8711
6451,訊芯-KY,25,3,22,陽信-石牌,2024-02-21,8711
1316,上曜,30,10,20,陽信-石牌,2024-02-21,8711
2885,元大金,20,0,20,陽信-石牌,2024-02-21,8711
3666,光耀,20,0,20,陽信-石牌,2024-02-21,8711
3711,日月光投控,20,0,20,陽信-石牌,2024-02-21,8711
8477,創業家,20,0,20,陽信-石牌,2024-02-21,8711
9105,泰金寶-DR,20,1,19,陽信-石牌,2024-02-21,8711
00929,復華台灣科技優息,20,1,19,陽信-石牌,2024-02-21,8711
6282,康舒,57,40,17,陽信-石牌,2024-02-21,8711
2332,友訊,16,0,16,陽信-石牌,2024-02-21,8711
00907,永豐優息存股,20,5,15,陽信-石牌,2024-02-21,8711
00651R,復華香港反1,15,0,15,陽信-石牌,2024-02-21,8711
1609,大亞,15,0,15,陽信-石牌,2024-02-21,8711
6116,彩晶,15,0,15,陽信-石牌,2024-02-21,8711
6279,胡連,15,0,15,陽信-石牌,2024-02-21,8711
2609,陽明,35,21,14,陽信-石牌,2024-02-21,8711
8105,凌巨,15,1,14,陽信-石牌,2024-02-21,8711
00753L,中信中國50正2,13,0,13,陽信-石牌,2024-02-21,8711
2312,金寶,30,17,13,陽信-石牌,2024-02-21,8711
3035,智原,22,10,12,陽信-石牌,2024-02-21,8711
3673,TPK-KY,12,0,12,陽信-石牌,2024-02-21,8711
5443,均豪,17,5,12,陽信-石牌,2024-02-21,8711
9103,美德醫療-DR,12,0,12,陽信-石牌,2024-02-21,8711
3005,神基,18,7,11,陽信-石牌,2024-02-21,8711
5465,富驊,11,0,11,陽信-石牌,2024-02-21,8711
6288,聯嘉,11,0,11,陽信-石牌,2024-02-21,8711
3443,創意,10,0,10,陽信-石牌,2024-02-21,8711
00937B,群益ESG投等債20,139,0,139,陽信-石牌,2024-02-22,8711
00878,國泰永續高股息,148,21,127,陽信-石牌,2024-02-22,8711
2392,正崴,111,0,111,陽信-石牌,2024-02-22,8711
00933B,國泰10Y+金融債,104,0,104,陽信-石牌,2024-02-22,8711
2303,聯電,94,2,92,陽信-石牌,2024-02-22,8711
2606,裕民,106,18,88,陽信-石牌,2024-02-22,8711
2022,聚亨,64,0,64,陽信-石牌,2024-02-22,8711
2489,瑞軒,69,8,61,陽信-石牌,2024-02-22,8711
2610,華航,57,2,55,陽信-石牌,2024-02-22,8711
1314,中石化,52,0,52,陽信-石牌,2024-02-22,8711
2363,矽統,52,2,50,陽信-石牌,2024-02-22,8711
3231,緯創,84,36,48,陽信-石牌,2024-02-22,8711
00632R,元大台灣50反1,50,2,48,陽信-石牌,2024-02-22,8711
8110,華東,51,4,47,陽信-石牌,2024-02-22,8711
5272,笙科,42,0,42,陽信-石牌,2024-02-22,8711
2371,大同,46,9,37,陽信-石牌,2024-02-22,8711
4157,太景*-KY,35,0,35,陽信-石牌,2024-02-22,8711
3163,波若威,61,27,34,陽信-石牌,2024-02-22,8711
00751B,元大AAA至A公司債,35,2,33,陽信-石牌,2024-02-22,8711
2312,金寶,33,0,33,陽信-石牌,2024-02-22,8711
00713,元大台灣高息低波,31,0,31,陽信-石牌,2024-02-22,8711
00679B,元大美債20年,32,1,31,陽信-石牌,2024-02-22,8711
9103,美德醫療-DR,49,19,30,陽信-石牌,2024-02-22,8711
2618,長榮航,28,1,27,陽信-石牌,2024-02-22,8711
2353,宏��,41,15,26,陽信-石牌,2024-02-22,8711
1215,卜蜂,25,0,25,陽信-石牌,2024-02-22,8711
3450,聯鈞,30,7,23,陽信-石牌,2024-02-22,8711
3689,湧德,25,2,23,陽信-石牌,2024-02-22,8711
2367,燿華,24,3,21,陽信-石牌,2024-02-22,8711
3032,偉訓,21,0,21,陽信-石牌,2024-02-22,8711
00633L,富邦上証正2,20,0,20,陽信-石牌,2024-02-22,8711
1455,集盛,20,0,20,陽信-石牌,2024-02-22,8711
1762,中化生,20,0,20,陽信-石牌,2024-02-22,8711
3057,喬鼎,20,0,20,陽信-石牌,2024-02-22,8711
3211,順達,20,0,20,陽信-石牌,2024-02-22,8711
3360,尚立,20,0,20,陽信-石牌,2024-02-22,8711
3035,智原,26,7,19,陽信-石牌,2024-02-22,8711
2637,慧洋-KY,30,12,18,陽信-石牌,2024-02-22,8711
1316,上曜,17,0,17,陽信-石牌,2024-02-22,8711
2888,新光金,20,3,17,陽信-石牌,2024-02-22,8711
6451,訊芯-KY,26,9,17,陽信-石牌,2024-02-22,8711
6282,康舒,26,9,17,陽信-石牌,2024-02-22,8711
2002,中鋼,16,0,16,陽信-石牌,2024-02-22,8711
3532,台勝科,16,0,16,陽信-石牌,2024-02-22,8711
0050,元大台灣50,19,4,15,陽信-石牌,2024-02-22,8711
2388,威盛,19,4,15,陽信-石牌,2024-02-22,8711
3066,李洲,26,11,15,陽信-石牌,2024-02-22,8711
6233,旺玖,27,12,15,陽信-石牌,2024-02-22,8711
00795B,中信美國公債20年,14,0,14,陽信-石牌,2024-02-22,8711
00687B,國泰20年美債,14,0,14,陽信-石牌,2024-02-22,8711
2303,聯電,165,3,162,陽信-石牌,2024-02-23,8711
2891,中信金,123,0,123,陽信-石牌,2024-02-23,8711
00632R,元大台灣50反1,110,0,110,陽信-石牌,2024-02-23,8711
00713,元大台灣高息低波,90,0,90,陽信-石牌,2024-02-23,8711
2888,新光金,90,16,74,陽信-石牌,2024-02-23,8711
00919,群益台灣精選高息,145,75,70,陽信-石牌,2024-02-23,8711
00937B,群益ESG投等債20,64,1,63,陽信-石牌,2024-02-23,8711
2022,聚亨,63,0,63,陽信-石牌,2024-02-23,8711
00931B,統一美債20年,62,0,62,陽信-石牌,2024-02-23,8711
3231,緯創,74,17,57,陽信-石牌,2024-02-23,8711
6288,聯嘉,62,6,56,陽信-石牌,2024-02-23,8711
00927,群益半導體收益,170,122,48,陽信-石牌,2024-02-23,8711
3047,訊舟,48,3,45,陽信-石牌,2024-02-23,8711
1215,卜蜂,40,0,40,陽信-石牌,2024-02-23,8711
1815,富喬,40,4,36,陽信-石牌,2024-02-23,8711
6282,康舒,37,1,36,陽信-石牌,2024-02-23,8711
3481,群創,51,17,34,陽信-石牌,2024-02-23,8711
00679B,元大美債20年,30,0,30,陽信-石牌,2024-02-23,8711
1455,集盛,30,0,30,陽信-石牌,2024-02-23,8711
2380,虹光,30,0,30,陽信-石牌,2024-02-23,8711
2444,兆勁,30,0,30,陽信-石牌,2024-02-23,8711
00933B,國泰10Y+金融債,33,5,28,陽信-石牌,2024-02-23,8711
2376,技嘉,43,16,27,陽信-石牌,2024-02-23,8711
1905,華紙,30,5,25,陽信-石牌,2024-02-23,8711
00795B,中信美國公債20年,20,0,20,陽信-石牌,2024-02-23,8711
1722,台肥,20,0,20,陽信-石牌,2024-02-23,8711
2392,正崴,20,0,20,陽信-石牌,2024-02-23,8711
6116,彩晶,20,0,20,陽信-石牌,2024-02-23,8711
2355,敬鵬,20,1,19,陽信-石牌,2024-02-23,8711
3025,星通,39,20,19,陽信-石牌,2024-02-23,8711
5272,笙科,21,2,19,陽信-石牌,2024-02-23,8711
2312,金寶,30,12,18,陽信-石牌,2024-02-23,8711
2609,陽明,20,2,18,陽信-石牌,2024-02-23,8711
4966,譜瑞-KY,18,0,18,陽信-石牌,2024-02-23,8711
2884,玉山金,17,0,17,陽信-石牌,2024-02-23,8711
00673R,期元大S＆P原油反1,16,0,16,陽信-石牌,2024-02-23,8711
2618,長榮航,29,13,16,陽信-石牌,2024-02-23,8711
1609,大亞,22,7,15,陽信-石牌,2024-02-23,8711
1717,長興,16,1,15,陽信-石牌,2024-02-23,8711
2354,鴻準,15,0,15,陽信-石牌,2024-02-23,8711
2363,矽統,38,23,15,陽信-石牌,2024-02-23,8711
6112,邁達特,16,1,15,陽信-石牌,2024-02-23,8711
8064,東捷,30,15,15,陽信-石牌,2024-02-23,8711
1303,南亞,14,0,14,陽信-石牌,2024-02-23,8711
2356,英業達,46,32,14,陽信-石牌,2024-02-23,8711
6167,久正,15,1,14,陽信-石牌,2024-02-23,8711
6438,迅得,16,2,14,陽信-石牌,2024-02-23,8711
00891,中信關鍵半導體,15,2,13,陽信-石牌,2024-02-23,8711
6770,力積電,13,0,13,陽信-石牌,2024-02-23,8711
00881,國泰台灣5G+,14,2,12,陽信-石牌,2024-02-23,8711
2892,第一金,200,0,200,陽信-石牌,2024-02-26,8711
00878,國泰永續高股息,122,2,120,陽信-石牌,2024-02-26,8711
2610,華航,126,12,114,陽信-石牌,2024-02-26,8711
00927,群益半導體收益,100,0,100,陽信-石牌,2024-02-26,8711
6163,華電網,100,0,100,陽信-石牌,2024-02-26,8711
9919,康那香,100,0,100,陽信-石牌,2024-02-26,8711
00679B,元大美債20年,100,1,99,陽信-石牌,2024-02-26,8711
9105,泰金寶-DR,84,2,82,陽信-石牌,2024-02-26,8711
2303,聯電,80,1,79,陽信-石牌,2024-02-26,8711
00929,復華台灣科技優息,70,6,64,陽信-石牌,2024-02-26,8711
4915,致伸,61,2,59,陽信-石牌,2024-02-26,8711
8996,高力,69,18,51,陽信-石牌,2024-02-26,8711
2022,聚亨,48,0,48,陽信-石牌,2024-02-26,8711
00919,群益台灣精選高息,116,75,41,陽信-石牌,2024-02-26,8711
00720B,元大投資級公司債,40,0,40,陽信-石牌,2024-02-26,8711
1717,長興,40,2,38,陽信-石牌,2024-02-26,8711
6120,達運,37,0,37,陽信-石牌,2024-02-26,8711
6182,合晶,30,0,30,陽信-石牌,2024-02-26,8711
00937B,群益ESG投等債20,50,21,29,陽信-石牌,2024-02-26,8711
4167,松瑞藥,28,1,27,陽信-石牌,2024-02-26,8711
4908,前鼎,56,31,25,陽信-石牌,2024-02-26,8711
00713,元大台灣高息低波,22,0,22,陽信-石牌,2024-02-26,8711
1710,東聯,28,6,22,陽信-石牌,2024-02-26,8711
5439,高技,22,0,22,陽信-石牌,2024-02-26,8711
8936,國統,36,14,22,陽信-石牌,2024-02-26,8711
4938,和碩,20,0,20,陽信-石牌,2024-02-26,8711
2606,裕民,17,0,17,陽信-石牌,2024-02-26,8711
2376,技嘉,20,4,16,陽信-石牌,2024-02-26,8711
8085,福華,30,14,16,陽信-石牌,2024-02-26,8711
00633L,富邦上証正2,15,0,15,陽信-石牌,2024-02-26,8711
1519,華城,16,1,15,陽信-石牌,2024-02-26,8711
6282,康舒,15,0,15,陽信-石牌,2024-02-26,8711
6579,研揚,15,0,15,陽信-石牌,2024-02-26,8711
00712,復華富時不動產,14,0,14,陽信-石牌,2024-02-26,8711
6285,啟��,14,0,14,陽信-石牌,2024-02-26,8711
1447,力鵬,16,3,13,陽信-石牌,2024-02-26,8711
2324,仁寶,13,0,13,陽信-石牌,2024-02-26,8711
1733,五鼎,12,0,12,陽信-石牌,2024-02-26,8711
5534,長虹,12,0,12,陽信-石牌,2024-02-26,8711
6235,華孚,12,0,12,陽信-石牌,2024-02-26,8711
9907,統一實,12,0,12,陽信-石牌,2024-02-26,8711
2329,華泰,25,14,11,陽信-石牌,2024-02-26,8711
6243,迅杰,13,2,11,陽信-石牌,2024-02-26,8711
2313,華通,12,2,10,陽信-石牌,2024-02-26,8711
1314,中石化,10,0,10,陽信-石牌,2024-02-26,8711
00673R,期元大S＆P原油反1,10,0,10,陽信-石牌,2024-02-26,8711
00881,國泰台灣5G+,10,0,10,陽信-石牌,2024-02-26,8711
1608,華榮,10,0,10,陽信-石牌,2024-02-26,8711
2002,中鋼,10,0,10,陽信-石牌,2024-02-26,8711
2023,燁輝,10,0,10,陽信-石牌,2024-02-26,8711
00919,群益台灣精選高息,189,26,163,陽信-石牌,2024-02-27,8711
00927,群益半導體收益,153,0,153,陽信-石牌,2024-02-27,8711
00632R,元大台灣50反1,130,10,120,陽信-石牌,2024-02-27,8711
9105,泰金寶-DR,111,16,95,陽信-石牌,2024-02-27,8711
2606,裕民,100,6,94,陽信-石牌,2024-02-27,8711
00937B,群益ESG投等債20,88,0,88,陽信-石牌,2024-02-27,8711
00878,國泰永續高股息,206,121,85,陽信-石牌,2024-02-27,8711
00679B,元大美債20年,85,0,85,陽信-石牌,2024-02-27,8711
2883,凱基金,80,0,80,陽信-石牌,2024-02-27,8711
00933B,國泰10Y+金融債,65,0,65,陽信-石牌,2024-02-27,8711
8040,九暘,68,7,61,陽信-石牌,2024-02-27,8711
4915,致伸,60,0,60,陽信-石牌,2024-02-27,8711
4938,和碩,60,0,60,陽信-石牌,2024-02-27,8711
2392,正崴,52,0,52,陽信-石牌,2024-02-27,8711
1215,卜蜂,50,0,50,陽信-石牌,2024-02-27,8711
1722,台肥,50,0,50,陽信-石牌,2024-02-27,8711
4157,太景*-KY,42,0,42,陽信-石牌,2024-02-27,8711
00712,復華富時不動產,41,0,41,陽信-石牌,2024-02-27,8711
3707,漢磊,50,10,40,陽信-石牌,2024-02-27,8711
2891,中信金,40,0,40,陽信-石牌,2024-02-27,8711
1504,東元,37,2,35,陽信-石牌,2024-02-27,8711
3450,聯鈞,41,7,34,陽信-石牌,2024-02-27,8711
3437,榮創,30,0,30,陽信-石牌,2024-02-27,8711
8996,高力,33,4,29,陽信-石牌,2024-02-27,8711
2302,麗正,35,8,27,陽信-石牌,2024-02-27,8711
3521,鴻翊,26,0,26,陽信-石牌,2024-02-27,8711
4716,大立,25,0,25,陽信-石牌,2024-02-27,8711
2601,益航,24,0,24,陽信-石牌,2024-02-27,8711
6770,力積電,25,1,24,陽信-石牌,2024-02-27,8711
00882,中信中國高股息,25,2,23,陽信-石牌,2024-02-27,8711
2812,台中銀,22,0,22,陽信-石牌,2024-02-27,8711
2382,廣達,33,11,22,陽信-石牌,2024-02-27,8711
2353,宏��,24,3,21,陽信-石牌,2024-02-27,8711
00680L,元大美債20正2,20,0,20,陽信-石牌,2024-02-27,8711
1721,三晃,22,2,20,陽信-石牌,2024-02-27,8711
4562,穎漢,20,0,20,陽信-石牌,2024-02-27,8711
5488,松普,20,0,20,陽信-石牌,2024-02-27,8711
6125,廣運,26,6,20,陽信-石牌,2024-02-27,8711
6179,亞通,20,0,20,陽信-石牌,2024-02-27,8711
00936,台新永續高息中小,21,2,19,陽信-石牌,2024-02-27,8711
00687B,國泰20年美債,20,1,19,陽信-石牌,2024-02-27,8711
2312,金寶,33,14,19,陽信-石牌,2024-02-27,8711
3037,欣興,31,13,18,陽信-石牌,2024-02-27,8711
3189,景碩,18,0,18,陽信-石牌,2024-02-27,8711
3231,緯創,50,33,17,陽信-石牌,2024-02-27,8711
1711,永光,25,8,17,陽信-石牌,2024-02-27,8711
4743,合一,16,0,16,陽信-石牌,2024-02-27,8711
2457,飛宏,15,0,15,陽信-石牌,2024-02-27,8711
2888,新光金,25,10,15,陽信-石牌,2024-02-27,8711
6451,訊芯-KY,20,5,15,陽信-石牌,2024-02-27,8711
00919,群益台灣精選高息,403,240,163,陽信-石牌,2024-02-29,8711
4543,萬在,150,9,141,陽信-石牌,2024-02-29,8711
9105,泰金寶-DR,135,16,119,陽信-石牌,2024-02-29,8711
2303,聯電,123,9,114,陽信-石牌,2024-02-29,8711
00927,群益半導體收益,102,0,102,陽信-石牌,2024-02-29,8711
00937B,群益ESG投等債20,84,0,84,陽信-石牌,2024-02-29,8711
00632R,元大台灣50反1,100,20,80,陽信-石牌,2024-02-29,8711
3707,漢磊,55,0,55,陽信-石牌,2024-02-29,8711
00929,復華台灣科技優息,61,8,53,陽信-石牌,2024-02-29,8711
2892,第一金,52,0,52,陽信-石牌,2024-02-29,8711
2022,聚亨,48,0,48,陽信-石牌,2024-02-29,8711
4542,科嶠,41,0,41,陽信-石牌,2024-02-29,8711
00687B,國泰20年美債,38,0,38,陽信-石牌,2024-02-29,8711
3481,群創,39,3,36,陽信-石牌,2024-02-29,8711
00679B,元大美債20年,33,0,33,陽信-石牌,2024-02-29,8711
4973,廣穎,41,8,33,陽信-石牌,2024-02-29,8711
1722,台肥,30,0,30,陽信-石牌,2024-02-29,8711
2412,中華電,30,0,30,陽信-石牌,2024-02-29,8711
3231,緯創,32,3,29,陽信-石牌,2024-02-29,8711
8050,廣積,30,1,29,陽信-石牌,2024-02-29,8711
2363,矽統,29,4,25,陽信-石牌,2024-02-29,8711
2353,宏��,27,4,23,陽信-石牌,2024-02-29,8711
3622,洋華,23,0,23,陽信-石牌,2024-02-29,8711
2330,台積電,29,6,23,陽信-石牌,2024-02-29,8711
5328,華容,22,0,22,陽信-石牌,2024-02-29,8711
00713,元大台灣高息低波,21,0,21,陽信-石牌,2024-02-29,8711
1618,合機,23,2,21,陽信-石牌,2024-02-29,8711
00933B,國泰10Y+金融債,20,0,20,陽信-石牌,2024-02-29,8711
2888,新光金,40,20,20,陽信-石牌,2024-02-29,8711
8033,雷虎,20,0,20,陽信-石牌,2024-02-29,8711
2329,華泰,38,18,20,陽信-石牌,2024-02-29,8711
6116,彩晶,20,1,19,陽信-石牌,2024-02-29,8711
8110,華東,20,1,19,陽信-石牌,2024-02-29,8711
2368,金像電,23,5,18,陽信-石牌,2024-02-29,8711
4915,致伸,20,2,18,陽信-石牌,2024-02-29,8711
6213,聯茂,18,0,18,陽信-石牌,2024-02-29,8711
2371,大同,47,30,17,陽信-石牌,2024-02-29,8711
2834,臺企銀,22,5,17,陽信-石牌,2024-02-29,8711
2002,中鋼,17,1,16,陽信-石牌,2024-02-29,8711
00773B,中信優先金融債,15,0,15,陽信-石牌,2024-02-29,8711
2444,兆勁,15,0,15,陽信-石牌,2024-02-29,8711
2882,國泰金,15,1,14,陽信-石牌,2024-02-29,8711
4562,穎漢,14,0,14,陽信-石牌,2024-02-29,8711
1529,樂事綠能,16,3,13,陽信-石牌,2024-02-29,8711
2609,陽明,31,18,13,陽信-石牌,2024-02-29,8711
2610,華航,12,0,12,陽信-石牌,2024-02-29,8711
4966,譜瑞-KY,14,2,12,陽信-石牌,2024-02-29,8711
2884,玉山金,17,5,12,陽信-石牌,2024-02-29,8711
2402,毅嘉,11,0,11,陽信-石牌,2024-02-29,8711
2617,台航,12,1,11,陽信-石牌,2024-02-29,8711
9105,泰金寶-DR,337,30,307,陽信-石牌,2024-03-01,8711
00918,大華優利高填息30,173,0,173,陽信-石牌,2024-03-01,8711
2303,聯電,171,2,169,陽信-石牌,2024-03-01,8711
00927,群益半導體收益,150,0,150,陽信-石牌,2024-03-01,8711
2883,凱基金,141,2,139,陽信-石牌,2024-03-01,8711
00919,群益台灣精選高息,263,124,139,陽信-石牌,2024-03-01,8711
1102,亞泥,117,0,117,陽信-石牌,2024-03-01,8711
2888,新光金,115,6,109,陽信-石牌,2024-03-01,8711
1722,台肥,100,0,100,陽信-石牌,2024-03-01,8711
00937B,群益ESG投等債20,91,0,91,陽信-石牌,2024-03-01,8711
00713,元大台灣高息低波,90,3,87,陽信-石牌,2024-03-01,8711
2368,金像電,73,1,72,陽信-石牌,2024-03-01,8711
2606,裕民,61,2,59,陽信-石牌,2024-03-01,8711
6116,彩晶,55,0,55,陽信-石牌,2024-03-01,8711
00632R,元大台灣50反1,50,0,50,陽信-石牌,2024-03-01,8711
3576,聯合再生,50,2,48,陽信-石牌,2024-03-01,8711
00679B,元大美債20年,45,0,45,陽信-石牌,2024-03-01,8711
3055,蔚華科,56,11,45,陽信-石牌,2024-03-01,8711
00773B,中信優先金融債,40,0,40,陽信-石牌,2024-03-01,8711
2392,正崴,40,0,40,陽信-石牌,2024-03-01,8711
6227,茂綸,41,1,40,陽信-石牌,2024-03-01,8711
00751B,元大AAA至A公司債,35,0,35,陽信-石牌,2024-03-01,8711
3706,神達,47,13,34,陽信-石牌,2024-03-01,8711
2353,宏��,36,8,28,陽信-石牌,2024-03-01,8711
3265,台星科,30,5,25,陽信-石牌,2024-03-01,8711
2369,菱生,24,1,23,陽信-石牌,2024-03-01,8711
2409,友達,48,26,22,陽信-石牌,2024-03-01,8711
00933B,國泰10Y+金融債,21,0,21,陽信-石牌,2024-03-01,8711
2468,華經,20,0,20,陽信-石牌,2024-03-01,8711
8096,擎亞,20,0,20,陽信-石牌,2024-03-01,8711
3374,精材,20,1,19,陽信-石牌,2024-03-01,8711
3163,波若威,18,0,18,陽信-石牌,2024-03-01,8711
1513,中興電,30,13,17,陽信-石牌,2024-03-01,8711
3689,湧德,42,25,17,陽信-石牌,2024-03-01,8711
4303,信立,19,2,17,陽信-石牌,2024-03-01,8711
6491,晶碩,20,3,17,陽信-石牌,2024-03-01,8711
6695,芯鼎,16,0,16,陽信-石牌,2024-03-01,8711
00922,國泰台灣領袖50,16,0,16,陽信-石牌,2024-03-01,8711
1325,恆大,21,6,15,陽信-石牌,2024-03-01,8711
2444,兆勁,15,0,15,陽信-石牌,2024-03-01,8711
2618,長榮航,18,3,15,陽信-石牌,2024-03-01,8711
3032,偉訓,26,11,15,陽信-石牌,2024-03-01,8711
9910,豐泰,15,0,15,陽信-石牌,2024-03-01,8711
8085,福華,135,121,14,陽信-石牌,2024-03-01,8711
4562,穎漢,13,0,13,陽信-石牌,2024-03-01,8711
6237,驊訊,13,0,13,陽信-石牌,2024-03-01,8711
3036,文曄,49,38,11,陽信-石牌,2024-03-01,8711
8936,國統,12,1,11,陽信-石牌,2024-03-01,8711
5425,台半,10,0,10,陽信-石牌,2024-03-01,8711
1326,台化,11,1,10,陽信-石牌,2024-03-01,8711
00632R,元大台灣50反1,260,25,235,陽信-石牌,2024-03-04,8711
3694,海華,151,8,143,陽信-石牌,2024-03-04,8711
00937B,群益ESG投等債20,134,15,119,陽信-石牌,2024-03-04,8711
00919,群益台灣精選高息,150,44,106,陽信-石牌,2024-03-04,8711
2892,第一金,101,0,101,陽信-石牌,2024-03-04,8711
3481,群創,101,1,100,陽信-石牌,2024-03-04,8711
3576,聯合再生,90,0,90,陽信-石牌,2024-03-04,8711
1102,亞泥,83,0,83,陽信-石牌,2024-03-04,8711
2392,正崴,69,0,69,陽信-石牌,2024-03-04,8711
3231,緯創,71,27,44,陽信-石牌,2024-03-04,8711
2022,聚亨,37,0,37,陽信-石牌,2024-03-04,8711
2405,輔信,42,6,36,陽信-石牌,2024-03-04,8711
9103,美德醫療-DR,36,0,36,陽信-石牌,2024-03-04,8711
1514,亞力,43,8,35,陽信-石牌,2024-03-04,8711
3443,創意,34,1,33,陽信-石牌,2024-03-04,8711
2882,國泰金,38,5,33,陽信-石牌,2024-03-04,8711
2504,國產,30,0,30,陽信-石牌,2024-03-04,8711
3005,神基,37,7,30,陽信-石牌,2024-03-04,8711
2606,裕民,30,2,28,陽信-石牌,2024-03-04,8711
5452,佶優,30,2,28,陽信-石牌,2024-03-04,8711
3437,榮創,25,0,25,陽信-石牌,2024-03-04,8711
2476,鉅祥,27,3,24,陽信-石牌,2024-03-04,8711
00915,凱基優選高股息30,23,0,23,陽信-石牌,2024-03-04,8711
00878,國泰永續高股息,41,18,23,陽信-石牌,2024-03-04,8711
2382,廣達,29,7,22,陽信-石牌,2024-03-04,8711
2614,東森,20,0,20,陽信-石牌,2024-03-04,8711
1215,卜蜂,20,0,20,陽信-石牌,2024-03-04,8711
00857B,永豐20年美公債,20,0,20,陽信-石牌,2024-03-04,8711
2486,一詮,23,3,20,陽信-石牌,2024-03-04,8711
2618,長榮航,22,2,20,陽信-石牌,2024-03-04,8711
9951,皇田,20,0,20,陽信-石牌,2024-03-04,8711
2888,新光金,40,20,20,陽信-石牌,2024-03-04,8711
1301,台塑,20,1,19,陽信-石牌,2024-03-04,8711
2421,建準,19,0,19,陽信-石牌,2024-03-04,8711
3055,蔚華科,23,4,19,陽信-石牌,2024-03-04,8711
4974,亞泰,19,0,19,陽信-石牌,2024-03-04,8711
00679B,元大美債20年,23,5,18,陽信-石牌,2024-03-04,8711
2365,昆盈,17,1,16,陽信-石牌,2024-03-04,8711
6290,良維,72,57,15,陽信-石牌,2024-03-04,8711
2206,三陽工業,16,2,14,陽信-石牌,2024-03-04,8711
4157,太景*-KY,14,0,14,陽信-石牌,2024-03-04,8711
2812,台中銀,13,0,13,陽信-石牌,2024-03-04,8711
4562,穎漢,12,0,12,陽信-石牌,2024-03-04,8711
00897,富邦基因免疫生技,11,0,11,陽信-石牌,2024-03-04,8711
1409,新纖,11,0,11,陽信-石牌,2024-03-04,8711
2371,大同,27,16,11,陽信-石牌,2024-03-04,8711
6446,藥華藥,11,0,11,陽信-石牌,2024-03-04,8711
00751B,元大AAA至A公司債,10,0,10,陽信-石牌,2024-03-04,8711
00722B,群益投資級電信債,10,0,10,陽信-石牌,2024-03-04,8711
00665L,富邦�琤肭磪囓�2,34,24,10,陽信-石牌,2024-03-04,8711
3325,旭品,196,11,185,陽信-石牌,2024-03-05,8711
00937B,群益ESG投等債20,131,0,131,陽信-石牌,2024-03-05,8711
00632R,元大台灣50反1,100,5,95,陽信-石牌,2024-03-05,8711
2606,裕民,90,7,83,陽信-石牌,2024-03-05,8711
4915,致伸,70,0,70,陽信-石牌,2024-03-05,8711
9105,泰金寶-DR,92,30,62,陽信-石牌,2024-03-05,8711
1102,亞泥,50,0,50,陽信-石牌,2024-03-05,8711
1722,台肥,50,0,50,陽信-石牌,2024-03-05,8711
2888,新光金,60,10,50,陽信-石牌,2024-03-05,8711
2303,聯電,59,14,45,陽信-石牌,2024-03-05,8711
2882,國泰金,41,0,41,陽信-石牌,2024-03-05,8711
00857B,永豐20年美公債,40,0,40,陽信-石牌,2024-03-05,8711
1313,聯成,38,0,38,陽信-石牌,2024-03-05,8711
2356,英業達,46,9,37,陽信-石牌,2024-03-05,8711
5608,四維航,37,0,37,陽信-石牌,2024-03-05,8711
5452,佶優,38,2,36,陽信-石牌,2024-03-05,8711
00915,凱基優選高股息30,35,0,35,陽信-石牌,2024-03-05,8711
2367,燿華,81,50,31,陽信-石牌,2024-03-05,8711
00878,國泰永續高股息,37,7,30,陽信-石牌,2024-03-05,8711
00753L,中信中國50正2,30,0,30,陽信-石牌,2024-03-05,8711
6591,動力-KY,43,14,29,陽信-石牌,2024-03-05,8711
2324,仁寶,28,0,28,陽信-石牌,2024-03-05,8711
3481,群創,40,12,28,陽信-石牌,2024-03-05,8711
6770,力積電,39,11,28,陽信-石牌,2024-03-05,8711
2409,友達,35,9,26,陽信-石牌,2024-03-05,8711
00933B,國泰10Y+金融債,25,0,25,陽信-石牌,2024-03-05,8711
2427,三商電,27,2,25,陽信-石牌,2024-03-05,8711
3021,鴻名,23,0,23,陽信-石牌,2024-03-05,8711
2605,新興,24,3,21,陽信-石牌,2024-03-05,8711
00650L,復華香港正2,36,16,20,陽信-石牌,2024-03-05,8711
3045,台灣大,20,0,20,陽信-石牌,2024-03-05,8711
6182,合晶,20,0,20,陽信-石牌,2024-03-05,8711
1409,新纖,48,29,19,陽信-石牌,2024-03-05,8711
3041,揚智,20,2,18,陽信-石牌,2024-03-05,8711
6127,九豪,20,2,18,陽信-石牌,2024-03-05,8711
1786,科妍,16,0,16,陽信-石牌,2024-03-05,8711
6443,元晶,16,0,16,陽信-石牌,2024-03-05,8711
8054,安國,19,3,16,陽信-石牌,2024-03-05,8711
8064,東捷,20,4,16,陽信-石牌,2024-03-05,8711
3372,典範,50,35,15,陽信-石牌,2024-03-05,8711
00688L,國泰20年美債正2,15,0,15,陽信-石牌,2024-03-05,8711
6126,信音,31,16,15,陽信-石牌,2024-03-05,8711
2308,台達電,17,2,15,陽信-石牌,2024-03-05,8711
3163,波若威,35,21,14,陽信-石牌,2024-03-05,8711
4938,和碩,20,7,13,陽信-石牌,2024-03-05,8711
2329,華泰,48,36,12,陽信-石牌,2024-03-05,8711
00891,中信關鍵半導體,11,0,11,陽信-石牌,2024-03-05,8711
3105,穩懋,19,8,11,陽信-石牌,2024-03-05,8711
3715,定穎投控,12,1,11,陽信-石牌,2024-03-05,8711
6213,聯茂,13,2,11,陽信-石牌,2024-03-05,8711
00919,群益台灣精選高息,837,54,783,陽信-石牌,2024-03-06,8711
00918,大華優利高填息30,523,0,523,陽信-石牌,2024-03-06,8711
00915,凱基優選高股息30,211,0,211,陽信-石牌,2024-03-06,8711
00927,群益半導體收益,160,0,160,陽信-石牌,2024-03-06,8711
1102,亞泥,150,0,150,陽信-石牌,2024-03-06,8711
2504,國產,150,0,150,陽信-石牌,2024-03-06,8711
2515,中工,137,12,125,陽信-石牌,2024-03-06,8711
2605,新興,121,2,119,陽信-石牌,2024-03-06,8711
3481,群創,131,21,110,陽信-石牌,2024-03-06,8711
2392,正崴,99,0,99,陽信-石牌,2024-03-06,8711
2618,長榮航,101,6,95,陽信-石牌,2024-03-06,8711
5521,工信,124,52,72,陽信-石牌,2024-03-06,8711
2444,兆勁,68,0,68,陽信-石牌,2024-03-06,8711
0050,元大台灣50,72,6,66,陽信-石牌,2024-03-06,8711
6443,元晶,58,0,58,陽信-石牌,2024-03-06,8711
2634,漢翔,60,3,57,陽信-石牌,2024-03-06,8711
2611,志信,50,0,50,陽信-石牌,2024-03-06,8711
2382,廣達,51,6,45,陽信-石牌,2024-03-06,8711
3576,聯合再生,51,11,40,陽信-石牌,2024-03-06,8711
9103,美德醫療-DR,41,1,40,陽信-石牌,2024-03-06,8711
2356,英業達,46,8,38,陽信-石牌,2024-03-06,8711
6163,華電網,64,31,33,陽信-石牌,2024-03-06,8711
1722,台肥,30,0,30,陽信-石牌,2024-03-06,8711
4938,和碩,30,0,30,陽信-石牌,2024-03-06,8711
2498,宏達電,33,5,28,陽信-石牌,2024-03-06,8711
1536,和大,28,1,27,陽信-石牌,2024-03-06,8711
6472,保瑞,26,3,23,陽信-石牌,2024-03-06,8711
1215,卜蜂,23,0,23,陽信-石牌,2024-03-06,8711
3711,日月光投控,25,3,22,陽信-石牌,2024-03-06,8711
5388,中磊,24,2,22,陽信-石牌,2024-03-06,8711
00937B,群益ESG投等債20,81,60,21,陽信-石牌,2024-03-06,8711
6237,驊訊,21,0,21,陽信-石牌,2024-03-06,8711
4157,太景*-KY,20,0,20,陽信-石牌,2024-03-06,8711
4532,瑞智,20,0,20,陽信-石牌,2024-03-06,8711
6244,茂迪,20,0,20,陽信-石牌,2024-03-06,8711
3483,力致,25,6,19,陽信-石牌,2024-03-06,8711
1786,科妍,25,8,17,陽信-石牌,2024-03-06,8711
2302,麗正,17,0,17,陽信-石牌,2024-03-06,8711
6282,康舒,19,2,17,陽信-石牌,2024-03-06,8711
2363,矽統,37,21,16,陽信-石牌,2024-03-06,8711
8027,鈦昇,23,8,15,陽信-石牌,2024-03-06,8711
8996,高力,22,7,15,陽信-石牌,2024-03-06,8711
2208,台船,14,0,14,陽信-石牌,2024-03-06,8711
6550,北極星藥業-KY,15,2,13,陽信-石牌,2024-03-06,8711
8936,國統,17,4,13,陽信-石牌,2024-03-06,8711
9907,統一實,12,0,12,陽信-石牌,2024-03-06,8711
2606,裕民,30,19,11,陽信-石牌,2024-03-06,8711
2610,華航,41,30,11,陽信-石牌,2024-03-06,8711
6531,愛普*,12,2,10,陽信-石牌,2024-03-06,8711
6235,華孚,13,3,10,陽信-石牌,2024-03-06,8711
00919,群益台灣精選高息,1323,640,683,陽信-石牌,2024-03-07,8711
00915,凱基優選高股息30,546,177,369,陽信-石牌,2024-03-07,8711
00927,群益半導體收益,501,160,341,陽信-石牌,2024-03-07,8711
00632R,元大台灣50反1,245,10,235,陽信-石牌,2024-03-07,8711
4915,致伸,103,1,102,陽信-石牌,2024-03-07,8711
2392,正崴,101,0,101,陽信-石牌,2024-03-07,8711
5521,工信,101,19,82,陽信-石牌,2024-03-07,8711
2332,友訊,63,0,63,陽信-石牌,2024-03-07,8711
2022,聚亨,58,0,58,陽信-石牌,2024-03-07,8711
1102,亞泥,52,0,52,陽信-石牌,2024-03-07,8711
1471,首利,50,1,49,陽信-石牌,2024-03-07,8711
8011,台通,54,10,44,陽信-石牌,2024-03-07,8711
1605,華新,43,0,43,陽信-石牌,2024-03-07,8711
1722,台肥,40,0,40,陽信-石牌,2024-03-07,8711
3231,緯創,58,21,37,陽信-石牌,2024-03-07,8711
2313,華通,49,13,36,陽信-石牌,2024-03-07,8711
00905,FT臺灣Smart,35,0,35,陽信-石牌,2024-03-07,8711
2535,達欣工,30,0,30,陽信-石牌,2024-03-07,8711
2409,友達,66,37,29,陽信-石牌,2024-03-07,8711
2324,仁寶,34,5,29,陽信-石牌,2024-03-07,8711
6472,保瑞,34,5,29,陽信-石牌,2024-03-07,8711
6274,台燿,34,6,28,陽信-石牌,2024-03-07,8711
6126,信音,32,4,28,陽信-石牌,2024-03-07,8711
3481,群創,60,34,26,陽信-石牌,2024-03-07,8711
1313,聯成,25,0,25,陽信-石牌,2024-03-07,8711
2405,輔信,25,0,25,陽信-石牌,2024-03-07,8711
6443,元晶,24,0,24,陽信-石牌,2024-03-07,8711
00933B,國泰10Y+金融債,23,0,23,陽信-石牌,2024-03-07,8711
1905,華紙,26,3,23,陽信-石牌,2024-03-07,8711
2402,毅嘉,23,0,23,陽信-石牌,2024-03-07,8711
1316,上曜,79,57,22,陽信-石牌,2024-03-07,8711
2444,兆勁,24,2,22,陽信-石牌,2024-03-07,8711
4938,和碩,21,0,21,陽信-石牌,2024-03-07,8711
1215,卜蜂,20,0,20,陽信-石牌,2024-03-07,8711
1626,艾美特-KY,20,0,20,陽信-石牌,2024-03-07,8711
2353,宏��,20,0,20,陽信-石牌,2024-03-07,8711
2412,中華電,20,1,19,陽信-石牌,2024-03-07,8711
3521,鴻翊,19,0,19,陽信-石牌,2024-03-07,8711
1434,福懋,18,0,18,陽信-石牌,2024-03-07,8711
6282,康舒,57,39,18,陽信-石牌,2024-03-07,8711
2367,燿華,69,52,17,陽信-石牌,2024-03-07,8711
2605,新興,17,0,17,陽信-石牌,2024-03-07,8711
5452,佶優,43,26,17,陽信-石牌,2024-03-07,8711
8926,台汽電,16,0,16,陽信-石牌,2024-03-07,8711
3032,偉訓,15,0,15,陽信-石牌,2024-03-07,8711
6697,東捷資訊,15,0,15,陽信-石牌,2024-03-07,8711
1795,美時,24,11,13,陽信-石牌,2024-03-07,8711
3376,新日興,17,5,12,陽信-石牌,2024-03-07,8711
2449,京元電子,18,6,12,陽信-石牌,2024-03-07,8711
2609,陽明,23,11,12,陽信-石牌,2024-03-07,8711
2392,正崴,200,0,200,陽信-石牌,2024-03-08,8711
00632R,元大台灣50反1,170,10,160,陽信-石牌,2024-03-08,8711
1229,聯華,150,0,150,陽信-石牌,2024-03-08,8711
9902,台火,116,0,116,陽信-石牌,2024-03-08,8711
00919,群益台灣精選高息,1215,1117,98,陽信-石牌,2024-03-08,8711
3094,聯傑,70,0,70,陽信-石牌,2024-03-08,8711
1313,聯成,65,0,65,陽信-石牌,2024-03-08,8711
2535,達欣工,60,0,60,陽信-石牌,2024-03-08,8711
2605,新興,60,0,60,陽信-石牌,2024-03-08,8711
3711,日月光投控,71,16,55,陽信-石牌,2024-03-08,8711
6290,良維,55,0,55,陽信-石牌,2024-03-08,8711
1215,卜蜂,48,0,48,陽信-石牌,2024-03-08,8711
4915,致伸,63,26,37,陽信-石牌,2024-03-08,8711
1301,台塑,32,0,32,陽信-石牌,2024-03-08,8711
2634,漢翔,31,0,31,陽信-石牌,2024-03-08,8711
00664R,國泰臺灣加權反1,30,0,30,陽信-石牌,2024-03-08,8711
1609,大亞,29,2,27,陽信-石牌,2024-03-08,8711
2812,台中銀,28,2,26,陽信-石牌,2024-03-08,8711
2409,友達,27,2,25,陽信-石牌,2024-03-08,8711
3169,亞信,24,0,24,陽信-石牌,2024-03-08,8711
3481,群創,75,51,24,陽信-石牌,2024-03-08,8711
8027,鈦昇,24,1,23,陽信-石牌,2024-03-08,8711
5452,佶優,23,1,22,陽信-石牌,2024-03-08,8711
2014,中鴻,21,0,21,陽信-石牌,2024-03-08,8711
2353,宏��,33,12,21,陽信-石牌,2024-03-08,8711
3006,晶豪科,32,11,21,陽信-石牌,2024-03-08,8711
4707,磐亞,20,0,20,陽信-石牌,2024-03-08,8711
00918,大華優利高填息30,33,16,17,陽信-石牌,2024-03-08,8711
1316,上曜,82,65,17,陽信-石牌,2024-03-08,8711
1795,美時,17,0,17,陽信-石牌,2024-03-08,8711
8150,南茂,20,3,17,陽信-石牌,2024-03-08,8711
6472,保瑞,24,8,16,陽信-石牌,2024-03-08,8711
2363,矽統,24,9,15,陽信-石牌,2024-03-08,8711
2365,昆盈,19,4,15,陽信-石牌,2024-03-08,8711
3163,波若威,16,1,15,陽信-石牌,2024-03-08,8711
3645,達邁,20,5,15,陽信-石牌,2024-03-08,8711
00651R,復華香港反1,14,0,14,陽信-石牌,2024-03-08,8711
1773,勝一,16,2,14,陽信-石牌,2024-03-08,8711
2880,華南金,20,6,14,陽信-石牌,2024-03-08,8711
6189,豐藝,13,0,13,陽信-石牌,2024-03-08,8711
3338,泰碩,26,13,13,陽信-石牌,2024-03-08,8711
6125,廣運,20,7,13,陽信-石牌,2024-03-08,8711
1101,台泥,13,0,13,陽信-石牌,2024-03-08,8711
00923,群益台ESG低碳50,12,0,12,陽信-石牌,2024-03-08,8711
2340,台亞,12,0,12,陽信-石牌,2024-03-08,8711
3045,台灣大,15,3,12,陽信-石牌,2024-03-08,8711
3450,聯鈞,14,2,12,陽信-石牌,2024-03-08,8711
3521,鴻翊,12,0,12,陽信-石牌,2024-03-08,8711
4402,郡都開發,20,8,12,陽信-石牌,2024-03-08,8711
5302,太欣,12,0,12,陽信-石牌,2024-03-08,8711
2504,國產,150,0,150,陽信-石牌,2024-03-11,8711
00937B,群益ESG投等債20,173,43,130,陽信-石牌,2024-03-11,8711
3294,英濟,115,1,114,陽信-石牌,2024-03-11,8711
2845,遠東銀,105,0,105,陽信-石牌,2024-03-11,8711
2022,聚亨,84,0,84,陽信-石牌,2024-03-11,8711
1460,宏遠,52,0,52,陽信-石牌,2024-03-11,8711
00632R,元大台灣50反1,50,10,40,陽信-石牌,2024-03-11,8711
2392,正崴,41,1,40,陽信-石牌,2024-03-11,8711
00706L,期元大S＆P日圓正2,40,1,39,陽信-石牌,2024-03-11,8711
00918,大華優利高填息30,39,8,31,陽信-石牌,2024-03-11,8711
00930,永豐ESG低碳高息,31,0,31,陽信-石牌,2024-03-11,8711
2610,華航,33,2,31,陽信-石牌,2024-03-11,8711
1101,台泥,26,0,26,陽信-石牌,2024-03-11,8711
2301,光寶科,26,1,25,陽信-石牌,2024-03-11,8711
3481,群創,60,35,25,陽信-石牌,2024-03-11,8711
5347,世界,24,0,24,陽信-石牌,2024-03-11,8711
00679B,元大美債20年,25,2,23,陽信-石牌,2024-03-11,8711
00687B,國泰20年美債,22,0,22,陽信-石牌,2024-03-11,8711
00933B,國泰10Y+金融債,24,4,20,陽信-石牌,2024-03-11,8711
3325,旭品,20,0,20,陽信-石牌,2024-03-11,8711
4529,淳紳,20,0,20,陽信-石牌,2024-03-11,8711
6550,北極星藥業-KY,20,0,20,陽信-石牌,2024-03-11,8711
3060,銘異,23,5,18,陽信-石牌,2024-03-11,8711
6770,力積電,21,3,18,陽信-石牌,2024-03-11,8711
2356,英業達,37,20,17,陽信-石牌,2024-03-11,8711
2382,廣達,26,9,17,陽信-石牌,2024-03-11,8711
1514,亞力,22,6,16,陽信-石牌,2024-03-11,8711
2330,台積電,17,2,15,陽信-石牌,2024-03-11,8711
6443,元晶,15,0,15,陽信-石牌,2024-03-11,8711
2618,長榮航,21,7,14,陽信-石牌,2024-03-11,8711
00764B,群益25年美債,12,0,12,陽信-石牌,2024-03-11,8711
2352,佳世達,11,0,11,陽信-石牌,2024-03-11,8711
1589,永冠-KY,10,0,10,陽信-石牌,2024-03-11,8711
6462,神盾,14,4,10,陽信-石牌,2024-03-11,8711
00680L,元大美債20正2,10,0,10,陽信-石牌,2024-03-11,8711
00882,中信中國高股息,10,0,10,陽信-石牌,2024-03-11,8711
1712,興農,10,0,10,陽信-石牌,2024-03-11,8711
2109,華豐,10,0,10,陽信-石牌,2024-03-11,8711
2327,國巨,10,0,10,陽信-石牌,2024-03-11,8711
2465,麗臺,11,1,10,陽信-石牌,2024-03-11,8711
3669,圓展,15,5,10,陽信-石牌,2024-03-11,8711
6005,群益證,10,0,10,陽信-石牌,2024-03-11,8711
6218,豪勉,10,0,10,陽信-石牌,2024-03-11,8711
00929,復華台灣科技優息,15,5,10,陽信-石牌,2024-03-11,8711
2449,京元電子,9,0,9,陽信-石牌,2024-03-11,8711
2342,茂矽,15,6,9,陽信-石牌,2024-03-11,8711
2538,基泰,9,0,9,陽信-石牌,2024-03-11,8711
2855,統一證,15,6,9,陽信-石牌,2024-03-11,8711
5272,笙科,10,1,9,陽信-石牌,2024-03-11,8711
2801,彰銀,10,1,9,陽信-石牌,2024-03-11,8711
00919,群益台灣精選高息,606,258,348,陽信-石牌,2024-03-12,8711
00632R,元大台灣50反1,215,0,215,陽信-石牌,2024-03-12,8711
6205,詮欣,100,0,100,陽信-石牌,2024-03-12,8711
9917,中保科,100,0,100,陽信-石牌,2024-03-12,8711
00713,元大台灣高息低波,100,1,99,陽信-石牌,2024-03-12,8711
1229,聯華,100,5,95,陽信-石牌,2024-03-12,8711
2365,昆盈,102,12,90,陽信-石牌,2024-03-12,8711
2371,大同,93,6,87,陽信-石牌,2024-03-12,8711
00918,大華優利高填息30,96,20,76,陽信-石牌,2024-03-12,8711
00937B,群益ESG投等債20,53,0,53,陽信-石牌,2024-03-12,8711
2892,第一金,51,0,51,陽信-石牌,2024-03-12,8711
9945,潤泰新,50,0,50,陽信-石牌,2024-03-12,8711
00922,國泰台灣領袖50,30,0,30,陽信-石牌,2024-03-12,8711
9103,美德醫療-DR,30,0,30,陽信-石牌,2024-03-12,8711
00927,群益半導體收益,30,2,28,陽信-石牌,2024-03-12,8711
2301,光寶科,32,5,27,陽信-石牌,2024-03-12,8711
1514,亞力,32,5,27,陽信-石牌,2024-03-12,8711
00857B,永豐20年美公債,26,0,26,陽信-石牌,2024-03-12,8711
3294,英濟,24,1,23,陽信-石牌,2024-03-12,8711
2313,華通,53,31,22,陽信-石牌,2024-03-12,8711
2367,燿華,41,19,22,陽信-石牌,2024-03-12,8711
5488,松普,21,0,21,陽信-石牌,2024-03-12,8711
1612,宏泰,20,0,20,陽信-石牌,2024-03-12,8711
3481,群創,29,9,20,陽信-石牌,2024-03-12,8711
4402,郡都開發,20,0,20,陽信-石牌,2024-03-12,8711
4714,永捷,28,9,19,陽信-石牌,2024-03-12,8711
4971,IET-KY,19,0,19,陽信-石牌,2024-03-12,8711
00751B,元大AAA至A公司債,18,0,18,陽信-石牌,2024-03-12,8711
2444,兆勁,18,0,18,陽信-石牌,2024-03-12,8711
00933B,國泰10Y+金融債,23,6,17,陽信-石牌,2024-03-12,8711
3163,波若威,18,1,17,陽信-石牌,2024-03-12,8711
3081,聯亞,16,1,15,陽信-石牌,2024-03-12,8711
5483,中美晶,20,5,15,陽信-石牌,2024-03-12,8711
00715L,期街口布蘭特正2,14,0,14,陽信-石牌,2024-03-12,8711
3209,全科,14,0,14,陽信-石牌,2024-03-12,8711
00897,富邦基因免疫生技,12,0,12,陽信-石牌,2024-03-12,8711
2328,廣宇,16,4,12,陽信-石牌,2024-03-12,8711
5443,均豪,16,4,12,陽信-石牌,2024-03-12,8711
9934,成霖,12,0,12,陽信-石牌,2024-03-12,8711
2324,仁寶,15,4,11,陽信-石牌,2024-03-12,8711
3006,晶豪科,12,1,11,陽信-石牌,2024-03-12,8711
2609,陽明,14,4,10,陽信-石牌,2024-03-12,8711
00753L,中信中國50正2,10,0,10,陽信-石牌,2024-03-12,8711
00712,復華富時不動產,10,0,10,陽信-石牌,2024-03-12,8711
1213,大飲,10,0,10,陽信-石牌,2024-03-12,8711
2641,正德,10,0,10,陽信-石牌,2024-03-12,8711
3041,揚智,11,1,10,陽信-石牌,2024-03-12,8711
3520,華盈,10,0,10,陽信-石牌,2024-03-12,8711
4903,聯光通,10,0,10,陽信-石牌,2024-03-12,8711
4927,泰鼎-KY,10,0,10,陽信-石牌,2024-03-12,8711
1802,台玻,400,0,400,陽信-石牌,2024-03-13,8711
00918,大華優利高填息30,285,43,242,陽信-石牌,2024-03-13,8711
00915,凱基優選高股息30,219,16,203,陽信-石牌,2024-03-13,8711
2855,統一證,110,11,99,陽信-石牌,2024-03-13,8711
00857B,永豐20年美公債,107,20,87,陽信-石牌,2024-03-13,8711
1102,亞泥,87,0,87,陽信-石牌,2024-03-13,8711
6189,豐藝,79,13,66,陽信-石牌,2024-03-13,8711
2354,鴻準,96,38,58,陽信-石牌,2024-03-13,8711
2888,新光金,58,0,58,陽信-石牌,2024-03-13,8711
3231,緯創,107,53,54,陽信-石牌,2024-03-13,8711
00937B,群益ESG投等債20,61,10,51,陽信-石牌,2024-03-13,8711
3711,日月光投控,51,1,50,陽信-石牌,2024-03-13,8711
2890,永豐金,50,2,48,陽信-石牌,2024-03-13,8711
1229,聯華,50,2,48,陽信-石牌,2024-03-13,8711
00933B,國泰10Y+金融債,47,0,47,陽信-石牌,2024-03-13,8711
2892,第一金,51,4,47,陽信-石牌,2024-03-13,8711
9103,美德醫療-DR,35,0,35,陽信-石牌,2024-03-13,8711
00679B,元大美債20年,40,10,30,陽信-石牌,2024-03-13,8711
4157,太景*-KY,23,0,23,陽信-石牌,2024-03-13,8711
2371,大同,26,4,22,陽信-石牌,2024-03-13,8711
2882,國泰金,42,20,22,陽信-石牌,2024-03-13,8711
2382,廣達,32,11,21,陽信-石牌,2024-03-13,8711
2376,技嘉,50,29,21,陽信-石牌,2024-03-13,8711
2408,南亞科,30,10,20,陽信-石牌,2024-03-13,8711
3339,泰谷,20,0,20,陽信-石牌,2024-03-13,8711
8011,台通,39,19,20,陽信-石牌,2024-03-13,8711
8926,台汽電,21,1,20,陽信-石牌,2024-03-13,8711
1503,士電,28,8,20,陽信-石牌,2024-03-13,8711
6282,康舒,22,3,19,陽信-石牌,2024-03-13,8711
00651R,復華香港反1,18,0,18,陽信-石牌,2024-03-13,8711
5443,均豪,20,2,18,陽信-石牌,2024-03-13,8711
1312,國喬,17,0,17,陽信-石牌,2024-03-13,8711
2329,華泰,92,75,17,陽信-石牌,2024-03-13,8711
6237,驊訊,17,0,17,陽信-石牌,2024-03-13,8711
2002,中鋼,16,0,16,陽信-石牌,2024-03-13,8711
0052,富邦科技,16,0,16,陽信-石牌,2024-03-13,8711
4979,華星光,16,0,16,陽信-石牌,2024-03-13,8711
6113,亞矽,16,0,16,陽信-石牌,2024-03-13,8711
6120,達運,16,0,16,陽信-石牌,2024-03-13,8711
2344,華邦電,29,14,15,陽信-石牌,2024-03-13,8711
3171,炎洲流通,15,0,15,陽信-石牌,2024-03-13,8711
00882,中信中國高股息,20,6,14,陽信-石牌,2024-03-13,8711
5488,松普,14,0,14,陽信-石牌,2024-03-13,8711
5498,凱崴,14,0,14,陽信-石牌,2024-03-13,8711
6462,神盾,15,1,14,陽信-石牌,2024-03-13,8711
6117,迎廣,14,1,13,陽信-石牌,2024-03-13,8711
6217,中探針,36,23,13,陽信-石牌,2024-03-13,8711
00688L,國泰20年美債正2,12,0,12,陽信-石牌,2024-03-13,8711
00687B,國泰20年美債,13,1,12,陽信-石牌,2024-03-13,8711
1589,永冠-KY,12,0,12,陽信-石牌,2024-03-13,8711
00919,群益台灣精選高息,278,91,187,陽信-石牌,2024-03-14,8711
00918,大華優利高填息30,175,13,162,陽信-石牌,2024-03-14,8711
2504,國產,121,5,116,陽信-石牌,2024-03-14,8711
00937B,群益ESG投等債20,132,21,111,陽信-石牌,2024-03-14,8711
1229,聯華,90,1,89,陽信-石牌,2024-03-14,8711
00933B,國泰10Y+金融債,78,0,78,陽信-石牌,2024-03-14,8711
00857B,永豐20年美公債,76,0,76,陽信-石牌,2024-03-14,8711
2303,聯電,79,15,64,陽信-石牌,2024-03-14,8711
00632R,元大台灣50反1,63,10,53,陽信-石牌,2024-03-14,8711
2618,長榮航,64,11,53,陽信-石牌,2024-03-14,8711
2367,燿華,76,25,51,陽信-石牌,2024-03-14,8711
9945,潤泰新,50,0,50,陽信-石牌,2024-03-14,8711
2838,聯邦銀,40,0,40,陽信-石牌,2024-03-14,8711
2603,長榮,49,17,32,陽信-石牌,2024-03-14,8711
00673R,期元大S＆P原油反1,30,0,30,陽信-石牌,2024-03-14,8711
6206,飛捷,30,0,30,陽信-石牌,2024-03-14,8711
2801,彰銀,39,10,29,陽信-石牌,2024-03-14,8711
3325,旭品,31,6,25,陽信-石牌,2024-03-14,8711
00688L,國泰20年美債正2,24,0,24,陽信-石牌,2024-03-14,8711
6217,中探針,29,5,24,陽信-石牌,2024-03-14,8711
1316,上曜,39,16,23,陽信-石牌,2024-03-14,8711
2615,萬海,23,0,23,陽信-石牌,2024-03-14,8711
4938,和碩,25,3,22,陽信-石牌,2024-03-14,8711
2313,華通,27,6,21,陽信-石牌,2024-03-14,8711
2312,金寶,20,0,20,陽信-石牌,2024-03-14,8711
2634,漢翔,20,0,20,陽信-石牌,2024-03-14,8711
9939,宏全,20,0,20,陽信-石牌,2024-03-14,8711
2609,陽明,21,2,19,陽信-石牌,2024-03-14,8711
00929,復華台灣科技優息,56,38,18,陽信-石牌,2024-03-14,8711
2887,台新金,18,0,18,陽信-石牌,2024-03-14,8711
5347,世界,19,1,18,陽信-石牌,2024-03-14,8711
00878,國泰永續高股息,25,10,15,陽信-石牌,2024-03-14,8711
6279,胡連,15,0,15,陽信-石牌,2024-03-14,8711
2883,凱基金,56,42,14,陽信-石牌,2024-03-14,8711
00915,凱基優選高股息30,72,59,13,陽信-石牌,2024-03-14,8711
2354,鴻準,42,29,13,陽信-石牌,2024-03-14,8711
2889,國票金,24,11,13,陽信-石牌,2024-03-14,8711
6189,豐藝,18,5,13,陽信-石牌,2024-03-14,8711
00751B,元大AAA至A公司債,12,0,12,陽信-石牌,2024-03-14,8711
6285,啟��,22,10,12,陽信-石牌,2024-03-14,8711
3105,穩懋,12,1,11,陽信-石牌,2024-03-14,8711
6179,亞通,11,0,11,陽信-石牌,2024-03-14,8711
3017,奇鋐,17,7,10,陽信-石牌,2024-03-14,8711
2812,台中銀,10,0,10,陽信-石牌,2024-03-14,8711
3260,威剛,10,0,10,陽信-石牌,2024-03-14,8711
3518,柏騰,10,0,10,陽信-石牌,2024-03-14,8711
5608,四維航,10,0,10,陽信-石牌,2024-03-14,8711
6129,普誠,10,0,10,陽信-石牌,2024-03-14,8711
6806,森崴能源,18,8,10,陽信-石牌,2024-03-14,8711
1808,潤隆,15,6,9,陽信-石牌,2024-03-14,8711
00918,大華優利高填息30,236,0,236,陽信-石牌,2024-03-15,8711
2845,遠東銀,213,0,213,陽信-石牌,2024-03-15,8711
00931B,統一美債20年,190,0,190,陽信-石牌,2024-03-15,8711
00915,凱基優選高股息30,212,32,180,陽信-石牌,2024-03-15,8711
0052,富邦科技,175,0,175,陽信-石牌,2024-03-15,8711
2617,台航,138,0,138,陽信-石牌,2024-03-15,8711
00941,中信上游半導體,139,7,132,陽信-石牌,2024-03-15,8711
00919,群益台灣精選高息,243,122,121,陽信-石牌,2024-03-15,8711
4304,勝昱,114,0,114,陽信-石牌,2024-03-15,8711
2618,長榮航,126,14,112,陽信-石牌,2024-03-15,8711
2303,聯電,132,25,107,陽信-石牌,2024-03-15,8711
00751B,元大AAA至A公司債,55,0,55,陽信-石牌,2024-03-15,8711
5386,青雲,50,0,50,陽信-石牌,2024-03-15,8711
2834,臺企銀,87,40,47,陽信-石牌,2024-03-15,8711
2882,國泰金,58,13,45,陽信-石牌,2024-03-15,8711
3163,波若威,46,1,45,陽信-石牌,2024-03-15,8711
00679B,元大美債20年,40,0,40,陽信-石牌,2024-03-15,8711
2888,新光金,43,3,40,陽信-石牌,2024-03-15,8711
2313,華通,52,15,37,陽信-石牌,2024-03-15,8711
3438,類比科,36,7,29,陽信-石牌,2024-03-15,8711
2603,長榮,55,29,26,陽信-石牌,2024-03-15,8711
2610,華航,37,11,26,陽信-石牌,2024-03-15,8711
00878,國泰永續高股息,35,10,25,陽信-石牌,2024-03-15,8711
00857B,永豐20年美公債,25,0,25,陽信-石牌,2024-03-15,8711
2344,華邦電,23,1,22,陽信-石牌,2024-03-15,8711
2354,鴻準,48,27,21,陽信-石牌,2024-03-15,8711
1714,和桐,20,0,20,陽信-石牌,2024-03-15,8711
2010,春源,21,1,20,陽信-石牌,2024-03-15,8711
3057,喬鼎,20,0,20,陽信-石牌,2024-03-15,8711
5351,鈺創,23,3,20,陽信-石牌,2024-03-15,8711
00687B,國泰20年美債,17,0,17,陽信-石牌,2024-03-15,8711
2353,宏��,17,0,17,陽信-石牌,2024-03-15,8711
2369,菱生,16,0,16,陽信-石牌,2024-03-15,8711
4432,銘旺實,16,0,16,陽信-石牌,2024-03-15,8711
4714,永捷,27,11,16,陽信-石牌,2024-03-15,8711
1513,中興電,18,4,14,陽信-石牌,2024-03-15,8711
1229,聯華,14,0,14,陽信-石牌,2024-03-15,8711
2615,萬海,16,2,14,陽信-石牌,2024-03-15,8711
5443,均豪,18,4,14,陽信-石牌,2024-03-15,8711
1515,力山,13,0,13,陽信-石牌,2024-03-15,8711
2542,興富發,13,0,13,陽信-石牌,2024-03-15,8711
00929,復華台灣科技優息,32,20,12,陽信-石牌,2024-03-15,8711
2002,中鋼,12,0,12,陽信-石牌,2024-03-15,8711
5515,建國,12,0,12,陽信-石牌,2024-03-15,8711
8163,達方,12,0,12,陽信-石牌,2024-03-15,8711
9917,中保科,14,2,12,陽信-石牌,2024-03-15,8711
2301,光寶科,12,1,11,陽信-石牌,2024-03-15,8711
2645,長榮航太,11,0,11,陽信-石牌,2024-03-15,8711
3005,神基,13,2,11,陽信-石牌,2024-03-15,8711
8093,保銳,11,0,11,陽信-石牌,2024-03-15,8711
00632R,元大台灣50反1,170,10,160,陽信-石牌,2024-03-18,8711
2887,台新金,158,1,157,陽信-石牌,2024-03-18,8711
00937B,群益ESG投等債20,163,10,153,陽信-石牌,2024-03-18,8711
2834,臺企銀,124,3,121,陽信-石牌,2024-03-18,8711
2884,玉山金,109,7,102,陽信-石牌,2024-03-18,8711
1722,台肥,100,0,100,陽信-石牌,2024-03-18,8711
00751B,元大AAA至A公司債,76,0,76,陽信-石牌,2024-03-18,8711
00929,復華台灣科技優息,77,15,62,陽信-石牌,2024-03-18,8711
2845,遠東銀,60,0,60,陽信-石牌,2024-03-18,8711
00941,中信上游半導體,56,1,55,陽信-石牌,2024-03-18,8711
2330,台積電,53,4,49,陽信-石牌,2024-03-18,8711
4304,勝昱,45,0,45,陽信-石牌,2024-03-18,8711
9917,中保科,36,0,36,陽信-石牌,2024-03-18,8711
00915,凱基優選高股息30,35,0,35,陽信-石牌,2024-03-18,8711
2885,元大金,34,0,34,陽信-石牌,2024-03-18,8711
2905,三商,30,0,30,陽信-石牌,2024-03-18,8711
8076,伍豐,29,0,29,陽信-石牌,2024-03-18,8711
2610,華航,29,1,28,陽信-石牌,2024-03-18,8711
3294,英濟,29,3,26,陽信-石牌,2024-03-18,8711
2409,友達,25,0,25,陽信-石牌,2024-03-18,8711
2816,旺旺保,22,0,22,陽信-石牌,2024-03-18,8711
2889,國票金,22,0,22,陽信-石牌,2024-03-18,8711
1504,東元,33,12,21,陽信-石牌,2024-03-18,8711
1789,神隆,20,0,20,陽信-石牌,2024-03-18,8711
3290,東浦,20,0,20,陽信-石牌,2024-03-18,8711
3419,譁裕,20,0,20,陽信-石牌,2024-03-18,8711
4142,國光生,20,0,20,陽信-石牌,2024-03-18,8711
4306,炎洲,20,0,20,陽信-石牌,2024-03-18,8711
6126,信音,20,3,17,陽信-石牌,2024-03-18,8711
2449,京元電子,17,1,16,陽信-石牌,2024-03-18,8711
1101,台泥,15,0,15,陽信-石牌,2024-03-18,8711
00720B,元大投資級公司債,15,0,15,陽信-石牌,2024-03-18,8711
2367,燿華,49,34,15,陽信-石牌,2024-03-18,8711
5706,鳳凰,16,1,15,陽信-石牌,2024-03-18,8711
00715L,期街口布蘭特正2,24,10,14,陽信-石牌,2024-03-18,8711
1513,中興電,40,26,14,陽信-石牌,2024-03-18,8711
4714,永捷,26,12,14,陽信-石牌,2024-03-18,8711
4967,十銓,17,3,14,陽信-石牌,2024-03-18,8711
6275,元山,22,8,14,陽信-石牌,2024-03-18,8711
6770,力積電,20,7,13,陽信-石牌,2024-03-18,8711
8011,台通,23,10,13,陽信-石牌,2024-03-18,8711
00933B,國泰10Y+金融債,27,15,12,陽信-石牌,2024-03-18,8711
3715,定穎投控,12,0,12,陽信-石牌,2024-03-18,8711
6104,創惟,12,0,12,陽信-石牌,2024-03-18,8711
6233,旺玖,18,7,11,陽信-石牌,2024-03-18,8711
00857B,永豐20年美公債,10,0,10,陽信-石牌,2024-03-18,8711
00706L,期元大S＆P日圓正2,10,0,10,陽信-石牌,2024-03-18,8711
1512,瑞利,10,0,10,陽信-石牌,2024-03-18,8711
2328,廣宇,10,0,10,陽信-石牌,2024-03-18,8711
2342,茂矽,10,0,10,陽信-石牌,2024-03-18,8711
1402,遠東新,202,0,202,陽信-石牌,2024-03-19,8711
1102,亞泥,124,0,124,陽信-石牌,2024-03-19,8711
2504,國產,120,0,120,陽信-石牌,2024-03-19,8711
2888,新光金,112,42,70,陽信-石牌,2024-03-19,8711
00857B,永豐20年美公債,49,2,47,陽信-石牌,2024-03-19,8711
2323,中環,46,4,42,陽信-石牌,2024-03-19,8711
00673R,期元大S＆P原油反1,35,0,35,陽信-石牌,2024-03-19,8711
00919,群益台灣精選高息,113,79,34,陽信-石牌,2024-03-19,8711
00918,大華優利高填息30,33,0,33,陽信-石牌,2024-03-19,8711
00941,中信上游半導體,35,5,30,陽信-石牌,2024-03-19,8711
2637,慧洋-KY,41,11,30,陽信-石牌,2024-03-19,8711
2367,燿華,33,5,28,陽信-石牌,2024-03-19,8711
2486,一詮,31,5,26,陽信-石牌,2024-03-19,8711
00687B,國泰20年美債,40,15,25,陽信-石牌,2024-03-19,8711
3481,群創,23,1,22,陽信-石牌,2024-03-19,8711
00922,國泰台灣領袖50,20,0,20,陽信-石牌,2024-03-19,8711
00706L,期元大S＆P日圓正2,30,10,20,陽信-石牌,2024-03-19,8711
2313,華通,27,7,20,陽信-石牌,2024-03-19,8711
2801,彰銀,20,0,20,陽信-石牌,2024-03-19,8711
2515,中工,31,12,19,陽信-石牌,2024-03-19,8711
6257,矽格,22,4,18,陽信-石牌,2024-03-19,8711
2885,元大金,15,0,15,陽信-石牌,2024-03-19,8711
3325,旭品,15,0,15,陽信-石牌,2024-03-19,8711
1503,士電,29,15,14,陽信-石牌,2024-03-19,8711
2371,大同,15,2,13,陽信-石牌,2024-03-19,8711
2476,鉅祥,13,0,13,陽信-石牌,2024-03-19,8711
2618,長榮航,13,0,13,陽信-石牌,2024-03-19,8711
3081,聯亞,19,6,13,陽信-石牌,2024-03-19,8711
3372,典範,18,6,12,陽信-石牌,2024-03-19,8711
1101,台泥,11,0,11,陽信-石牌,2024-03-19,8711
00751B,元大AAA至A公司債,41,30,11,陽信-石牌,2024-03-19,8711
2355,敬鵬,11,0,11,陽信-石牌,2024-03-19,8711
2363,矽統,11,0,11,陽信-石牌,2024-03-19,8711
2542,興富發,11,0,11,陽信-石牌,2024-03-19,8711
1582,信錦,15,5,10,陽信-石牌,2024-03-19,8711
2489,瑞軒,20,10,10,陽信-石牌,2024-03-19,8711
2905,三商,10,0,10,陽信-石牌,2024-03-19,8711
5465,富驊,10,0,10,陽信-石牌,2024-03-19,8711
5468,凱鈺,10,0,10,陽信-石牌,2024-03-19,8711
6026,福邦證,10,0,10,陽信-石牌,2024-03-19,8711
6190,萬泰科,10,0,10,陽信-石牌,2024-03-19,8711
7402,邑錡,10,0,10,陽信-石牌,2024-03-19,8711
8383,千附,10,0,10,陽信-石牌,2024-03-19,8711
1605,華新,9,0,9,陽信-石牌,2024-03-19,8711
2002,中鋼,10,1,9,陽信-石牌,2024-03-19,8711
2449,京元電子,29,20,9,陽信-石牌,2024-03-19,8711
2464,盟立,10,1,9,陽信-石牌,2024-03-19,8711
3312,弘憶股,28,19,9,陽信-石牌,2024-03-19,8711
8473,山林水,15,6,9,陽信-石牌,2024-03-19,8711
00933B,國泰10Y+金融債,8,0,8,陽信-石牌,2024-03-19,8711
00939,統一台灣高息動能,629,8,621,陽信-石牌,2024-03-20,8711
2617,台航,171,10,161,陽信-石牌,2024-03-20,8711
00706L,期元大S＆P日圓正2,120,0,120,陽信-石牌,2024-03-20,8711
0056,元大高股息,120,6,114,陽信-石牌,2024-03-20,8711
4714,永捷,357,279,78,陽信-石牌,2024-03-20,8711
0050,元大台灣50,70,0,70,陽信-石牌,2024-03-20,8711
2618,長榮航,66,3,63,陽信-石牌,2024-03-20,8711
1609,大亞,70,7,63,陽信-石牌,2024-03-20,8711
1714,和桐,60,0,60,陽信-石牌,2024-03-20,8711
00679B,元大美債20年,54,1,53,陽信-石牌,2024-03-20,8711
1722,台肥,41,0,41,陽信-石牌,2024-03-20,8711
2344,華邦電,39,0,39,陽信-石牌,2024-03-20,8711
2834,臺企銀,36,0,36,陽信-石牌,2024-03-20,8711
2208,台船,36,1,35,陽信-石牌,2024-03-20,8711
2317,鴻海,109,74,35,陽信-石牌,2024-03-20,8711
2354,鴻準,44,12,32,陽信-石牌,2024-03-20,8711
1434,福懋,31,0,31,陽信-石牌,2024-03-20,8711
2888,新光金,36,5,31,陽信-石牌,2024-03-20,8711
00712,復華富時不動產,40,10,30,陽信-石牌,2024-03-20,8711
1101,台泥,32,2,30,陽信-石牌,2024-03-20,8711
2323,中環,33,3,30,陽信-石牌,2024-03-20,8711
8028,昇陽半導體,30,1,29,陽信-石牌,2024-03-20,8711
3037,欣興,44,17,27,陽信-石牌,2024-03-20,8711
8011,台通,32,6,26,陽信-石牌,2024-03-20,8711
2801,彰銀,25,0,25,陽信-石牌,2024-03-20,8711
2330,台積電,33,9,24,陽信-石牌,2024-03-20,8711
00937B,群益ESG投等債20,26,3,23,陽信-石牌,2024-03-20,8711
2367,燿華,36,13,23,陽信-石牌,2024-03-20,8711
2374,佳能,24,1,23,陽信-石牌,2024-03-20,8711
5608,四維航,23,0,23,陽信-石牌,2024-03-20,8711
1815,富喬,21,0,21,陽信-石牌,2024-03-20,8711
5388,中磊,35,14,21,陽信-石牌,2024-03-20,8711
5425,台半,21,0,21,陽信-石牌,2024-03-20,8711
6278,台表科,24,3,21,陽信-石牌,2024-03-20,8711
00687B,國泰20年美債,35,15,20,陽信-石牌,2024-03-20,8711
2313,華通,44,24,20,陽信-石牌,2024-03-20,8711
2637,慧洋-KY,20,0,20,陽信-石牌,2024-03-20,8711
3036,文曄,23,3,20,陽信-石牌,2024-03-20,8711
2353,宏��,21,3,18,陽信-石牌,2024-03-20,8711
4958,臻鼎-KY,20,3,17,陽信-石牌,2024-03-20,8711
2002,中鋼,16,0,16,陽信-石牌,2024-03-20,8711
2337,旺宏,16,0,16,陽信-石牌,2024-03-20,8711
2603,長榮,29,13,16,陽信-石牌,2024-03-20,8711
4768,晶呈科技,16,0,16,陽信-石牌,2024-03-20,8711
00632R,元大台灣50反1,15,0,15,陽信-石牌,2024-03-20,8711
2109,華豐,15,0,15,陽信-石牌,2024-03-20,8711
2369,菱生,25,10,15,陽信-石牌,2024-03-20,8711
2820,華票,15,0,15,陽信-石牌,2024-03-20,8711
9939,宏全,15,0,15,陽信-石牌,2024-03-20,8711
2905,三商,14,0,14,陽信-石牌,2024-03-20,8711
00632R,元大台灣50反1,265,25,240,陽信-石牌,2024-03-21,8711
0056,元大高股息,200,2,198,陽信-石牌,2024-03-21,8711
00939,統一台灣高息動能,169,5,164,陽信-石牌,2024-03-21,8711
1802,台玻,101,0,101,陽信-石牌,2024-03-21,8711
00937B,群益ESG投等債20,76,3,73,陽信-石牌,2024-03-21,8711
1215,卜蜂,70,0,70,陽信-石牌,2024-03-21,8711
00878,國泰永續高股息,100,35,65,陽信-石牌,2024-03-21,8711
3169,亞信,59,0,59,陽信-石牌,2024-03-21,8711
00713,元大台灣高息低波,50,0,50,陽信-石牌,2024-03-21,8711
9105,泰金寶-DR,50,0,50,陽信-石牌,2024-03-21,8711
00687B,國泰20年美債,45,0,45,陽信-石牌,2024-03-21,8711
2617,台航,41,0,41,陽信-石牌,2024-03-21,8711
00931B,統一美債20年,39,0,39,陽信-石牌,2024-03-21,8711
2406,國碩,38,0,38,陽信-石牌,2024-03-21,8711
00688L,國泰20年美債正2,33,0,33,陽信-石牌,2024-03-21,8711
2905,三商,31,0,31,陽信-石牌,2024-03-21,8711
00679B,元大美債20年,27,0,27,陽信-石牌,2024-03-21,8711
2303,聯電,62,38,24,陽信-石牌,2024-03-21,8711
2301,光寶科,56,33,23,陽信-石牌,2024-03-21,8711
00919,群益台灣精選高息,60,37,23,陽信-石牌,2024-03-21,8711
2405,輔信,27,5,22,陽信-石牌,2024-03-21,8711
3037,欣興,39,18,21,陽信-石牌,2024-03-21,8711
1444,力麗,20,0,20,陽信-石牌,2024-03-21,8711
2530,華建,20,0,20,陽信-石牌,2024-03-21,8711
2889,國票金,20,0,20,陽信-石牌,2024-03-21,8711
4114,健喬,20,0,20,陽信-石牌,2024-03-21,8711
6488,環球晶,21,1,20,陽信-石牌,2024-03-21,8711
8271,宇瞻,20,1,19,陽信-石牌,2024-03-21,8711
3706,神達,83,66,17,陽信-石牌,2024-03-21,8711
2323,中環,18,2,16,陽信-石牌,2024-03-21,8711
3563,牧德,15,0,15,陽信-石牌,2024-03-21,8711
6265,方土昶,15,0,15,陽信-石牌,2024-03-21,8711
00720B,元大投資級公司債,15,1,14,陽信-石牌,2024-03-21,8711
3322,建舜電,14,1,13,陽信-石牌,2024-03-21,8711
00857B,永豐20年美公債,12,0,12,陽信-石牌,2024-03-21,8711
9958,世紀鋼,26,14,12,陽信-石牌,2024-03-21,8711
3032,偉訓,11,0,11,陽信-石牌,2024-03-21,8711
8213,志超,11,0,11,陽信-石牌,2024-03-21,8711
2338,光罩,10,0,10,陽信-石牌,2024-03-21,8711
2538,基泰,10,0,10,陽信-石牌,2024-03-21,8711
3081,聯亞,10,0,10,陽信-石牌,2024-03-21,8711
3594,磐儀,10,0,10,陽信-石牌,2024-03-21,8711
4721,美琪瑪,10,0,10,陽信-石牌,2024-03-21,8711
5426,振發,10,0,10,陽信-石牌,2024-03-21,8711
8422,可寧衛,10,0,10,陽信-石牌,2024-03-21,8711
2371,大同,19,10,9,陽信-石牌,2024-03-21,8711
2421,建準,10,1,9,陽信-石牌,2024-03-21,8711
4979,華星光,15,6,9,陽信-石牌,2024-03-21,8711
6188,廣明,31,23,8,陽信-石牌,2024-03-21,8711
00680L,元大美債20正2,7,0,7,陽信-石牌,2024-03-21,8711
2323,中環,118,0,118,陽信-石牌,2024-03-22,8711
00632R,元大台灣50反1,100,10,90,陽信-石牌,2024-03-22,8711
3576,聯合再生,80,0,80,陽信-石牌,2024-03-22,8711
00878,國泰永續高股息,102,32,70,陽信-石牌,2024-03-22,8711
1785,光洋科,70,10,60,陽信-石牌,2024-03-22,8711
8473,山林水,70,10,60,陽信-石牌,2024-03-22,8711
2344,華邦電,78,21,57,陽信-石牌,2024-03-22,8711
8222,寶一,59,12,47,陽信-石牌,2024-03-22,8711
2301,光寶科,48,3,45,陽信-石牌,2024-03-22,8711
1102,亞泥,40,0,40,陽信-石牌,2024-03-22,8711
6196,帆宣,40,3,37,陽信-石牌,2024-03-22,8711
8059,凱碩,38,1,37,陽信-石牌,2024-03-22,8711
2367,燿華,115,82,33,陽信-石牌,2024-03-22,8711
2617,台航,32,0,32,陽信-石牌,2024-03-22,8711
8112,至上,34,4,30,陽信-石牌,2024-03-22,8711
2891,中信金,30,1,29,陽信-石牌,2024-03-22,8711
00939,統一台灣高息動能,46,17,29,陽信-石牌,2024-03-22,8711
2303,聯電,38,13,25,陽信-石牌,2024-03-22,8711
3163,波若威,24,0,24,陽信-石牌,2024-03-22,8711
1319,東陽,26,3,23,陽信-石牌,2024-03-22,8711
2006,東和鋼鐵,21,0,21,陽信-石牌,2024-03-22,8711
2313,華通,24,3,21,陽信-石牌,2024-03-22,8711
3704,合勤控,23,2,21,陽信-石牌,2024-03-22,8711
5864,致和證,20,0,20,陽信-石牌,2024-03-22,8711
9917,中保科,20,0,20,陽信-石牌,2024-03-22,8711
6182,合晶,22,3,19,陽信-石牌,2024-03-22,8711
5871,中租-KY,18,0,18,陽信-石牌,2024-03-22,8711
00753L,中信中國50正2,18,0,18,陽信-石牌,2024-03-22,8711
6126,信音,20,3,17,陽信-石牌,2024-03-22,8711
5608,四維航,15,0,15,陽信-石牌,2024-03-22,8711
6443,元晶,29,14,15,陽信-石牌,2024-03-22,8711
6451,訊芯-KY,15,0,15,陽信-石牌,2024-03-22,8711
8271,宇瞻,17,2,15,陽信-石牌,2024-03-22,8711
5443,均豪,15,1,14,陽信-石牌,2024-03-22,8711
6257,矽格,14,0,14,陽信-石牌,2024-03-22,8711
2889,國票金,13,0,13,陽信-石牌,2024-03-22,8711
6147,頎邦,14,1,13,陽信-石牌,2024-03-22,8711
2365,昆盈,13,1,12,陽信-石牌,2024-03-22,8711
3083,網龍,15,3,12,陽信-石牌,2024-03-22,8711
3231,緯創,49,37,12,陽信-石牌,2024-03-22,8711
2886,兆豐金,11,0,11,陽信-石牌,2024-03-22,8711
1216,統一,11,0,11,陽信-石牌,2024-03-22,8711
2376,技嘉,18,7,11,陽信-石牌,2024-03-22,8711
6278,台表科,11,0,11,陽信-石牌,2024-03-22,8711
6712,長聖,11,0,11,陽信-石牌,2024-03-22,8711
1503,士電,29,19,10,陽信-石牌,2024-03-22,8711
00918,大華優利高填息30,10,0,10,陽信-石牌,2024-03-22,8711
00679B,元大美債20年,11,1,10,陽信-石牌,2024-03-22,8711
00664R,國泰臺灣加權反1,10,0,10,陽信-石牌,2024-03-22,8711
1618,合機,14,4,10,陽信-石牌,2024-03-22,8711
00941,中信上游半導體,162,5,157,陽信-石牌,2024-03-25,8711
2905,三商,109,0,109,陽信-石牌,2024-03-25,8711
00679B,元大美債20年,75,2,73,陽信-石牌,2024-03-25,8711
2882,國泰金,55,0,55,陽信-石牌,2024-03-25,8711
6451,訊芯-KY,36,0,36,陽信-石牌,2024-03-25,8711
1789,神隆,35,0,35,陽信-石牌,2024-03-25,8711
2356,英業達,126,92,34,陽信-石牌,2024-03-25,8711
1609,大亞,81,48,33,陽信-石牌,2024-03-25,8711
00939,統一台灣高息動能,33,5,28,陽信-石牌,2024-03-25,8711
2317,鴻海,76,49,27,陽信-石牌,2024-03-25,8711
1314,中石化,33,6,27,陽信-石牌,2024-03-25,8711
1727,中華化,28,1,27,陽信-石牌,2024-03-25,8711
2610,華航,38,11,27,陽信-石牌,2024-03-25,8711
2406,國碩,26,1,25,陽信-石牌,2024-03-25,8711
6188,廣明,27,6,21,陽信-石牌,2024-03-25,8711
1316,上曜,20,0,20,陽信-石牌,2024-03-25,8711
00895,富邦未來車,20,0,20,陽信-石牌,2024-03-25,8711
00753L,中信中國50正2,20,0,20,陽信-石牌,2024-03-25,8711
00665L,富邦�琤肭磪囓�2,32,12,20,陽信-石牌,2024-03-25,8711
3607,谷崧,20,0,20,陽信-石牌,2024-03-25,8711
4533,協易機,20,0,20,陽信-石牌,2024-03-25,8711
00919,群益台灣精選高息,37,18,19,陽信-石牌,2024-03-25,8711
3704,合勤控,19,0,19,陽信-石牌,2024-03-25,8711
6282,康舒,18,0,18,陽信-石牌,2024-03-25,8711
00929,復華台灣科技優息,45,28,17,陽信-石牌,2024-03-25,8711
2324,仁寶,18,2,16,陽信-石牌,2024-03-25,8711
2915,潤泰全,16,0,16,陽信-石牌,2024-03-25,8711
2637,慧洋-KY,20,6,14,陽信-石牌,2024-03-25,8711
02001L,富邦蘋果正二N,13,0,13,陽信-石牌,2024-03-25,8711
00687B,國泰20年美債,23,10,13,陽信-石牌,2024-03-25,8711
2834,臺企銀,13,0,13,陽信-石牌,2024-03-25,8711
3706,神達,17,4,13,陽信-石牌,2024-03-25,8711
00937B,群益ESG投等債20,12,0,12,陽信-石牌,2024-03-25,8711
1815,富喬,25,13,12,陽信-石牌,2024-03-25,8711
2449,京元電子,12,0,12,陽信-石牌,2024-03-25,8711
6278,台表科,12,0,12,陽信-石牌,2024-03-25,8711
1717,長興,21,10,11,陽信-石牌,2024-03-25,8711
2383,台光電,11,0,11,陽信-石牌,2024-03-25,8711
2464,盟立,42,31,11,陽信-石牌,2024-03-25,8711
2609,陽明,11,0,11,陽信-石牌,2024-03-25,8711
1711,永光,10,0,10,陽信-石牌,2024-03-25,8711
2006,東和鋼鐵,10,0,10,陽信-石牌,2024-03-25,8711
2352,佳世達,14,4,10,陽信-石牌,2024-03-25,8711
2409,友達,18,8,10,陽信-石牌,2024-03-25,8711
2457,飛宏,10,0,10,陽信-石牌,2024-03-25,8711
3520,華盈,10,0,10,陽信-石牌,2024-03-25,8711
4402,郡都開發,10,0,10,陽信-石牌,2024-03-25,8711
5608,四維航,10,0,10,陽信-石牌,2024-03-25,8711
6205,詮欣,15,5,10,陽信-石牌,2024-03-25,8711
8105,凌巨,10,0,10,陽信-石牌,2024-03-25,8711
00937B,群益ESG投等債20,357,4,353,陽信-石牌,2024-03-26,8711
2905,三商,141,0,141,陽信-石牌,2024-03-26,8711
00679B,元大美債20年,128,0,128,陽信-石牌,2024-03-26,8711
2834,臺企銀,127,0,127,陽信-石牌,2024-03-26,8711
2617,台航,110,0,110,陽信-石牌,2024-03-26,8711
00939,統一台灣高息動能,123,19,104,陽信-石牌,2024-03-26,8711
1301,台塑,104,2,102,陽信-石牌,2024-03-26,8711
00929,復華台灣科技優息,139,47,92,陽信-石牌,2024-03-26,8711
2610,華航,86,5,81,陽信-石牌,2024-03-26,8711
2618,長榮航,81,6,75,陽信-石牌,2024-03-26,8711
00941,中信上游半導體,84,12,72,陽信-石牌,2024-03-26,8711
1722,台肥,73,1,72,陽信-石牌,2024-03-26,8711
00706L,期元大S＆P日圓正2,70,0,70,陽信-石牌,2024-03-26,8711
2356,英業達,136,68,68,陽信-石牌,2024-03-26,8711
2606,裕民,58,0,58,陽信-石牌,2024-03-26,8711
8033,雷虎,56,1,55,陽信-石牌,2024-03-26,8711
2382,廣達,61,10,51,陽信-石牌,2024-03-26,8711
2892,第一金,50,0,50,陽信-石牌,2024-03-26,8711
2344,華邦電,52,9,43,陽信-石牌,2024-03-26,8711
1609,大亞,136,94,42,陽信-石牌,2024-03-26,8711
6189,豐藝,41,0,41,陽信-石牌,2024-03-26,8711
2369,菱生,30,0,30,陽信-石牌,2024-03-26,8711
2605,新興,30,0,30,陽信-石牌,2024-03-26,8711
4938,和碩,40,12,28,陽信-石牌,2024-03-26,8711
2388,威盛,30,4,26,陽信-石牌,2024-03-26,8711
2317,鴻海,66,41,25,陽信-石牌,2024-03-26,8711
6266,泰詠,24,0,24,陽信-石牌,2024-03-26,8711
2845,遠東銀,21,0,21,陽信-石牌,2024-03-26,8711
6207,雷科,21,0,21,陽信-石牌,2024-03-26,8711
2367,燿華,108,87,21,陽信-石牌,2024-03-26,8711
4707,磐亞,20,0,20,陽信-石牌,2024-03-26,8711
5608,四維航,20,0,20,陽信-石牌,2024-03-26,8711
6116,彩晶,20,0,20,陽信-石牌,2024-03-26,8711
6205,詮欣,20,0,20,陽信-石牌,2024-03-26,8711
9917,中保科,20,0,20,陽信-石牌,2024-03-26,8711
3231,緯創,73,54,19,陽信-石牌,2024-03-26,8711
6770,力積電,20,1,19,陽信-石牌,2024-03-26,8711
4533,協易機,18,0,18,陽信-石牌,2024-03-26,8711
6290,良維,20,2,18,陽信-石牌,2024-03-26,8711
1605,華新,21,4,17,陽信-石牌,2024-03-26,8711
3062,建漢,17,1,16,陽信-石牌,2024-03-26,8711
00696B,富邦美債20年,15,0,15,陽信-石牌,2024-03-26,8711
2303,聯電,22,7,15,陽信-石牌,2024-03-26,8711
4967,十銓,15,0,15,陽信-石牌,2024-03-26,8711
8271,宇瞻,20,5,15,陽信-石牌,2024-03-26,8711
2637,慧洋-KY,15,0,15,陽信-石牌,2024-03-26,8711
2371,大同,103,88,15,陽信-石牌,2024-03-26,8711
1529,樂事綠能,15,1,14,陽信-石牌,2024-03-26,8711
2417,圓剛,15,1,14,陽信-石牌,2024-03-26,8711
1514,亞力,39,25,14,陽信-石牌,2024-03-26,8711
00878,國泰永續高股息,394,8,386,陽信-石牌,2024-03-27,8711
1460,宏遠,166,0,166,陽信-石牌,2024-03-27,8711
00937B,群益ESG投等債20,123,0,123,陽信-石牌,2024-03-27,8711
2801,彰銀,105,0,105,陽信-石牌,2024-03-27,8711
1102,亞泥,100,0,100,陽信-石牌,2024-03-27,8711
2834,臺企銀,100,0,100,陽信-石牌,2024-03-27,8711
00632R,元大台灣50反1,100,10,90,陽信-石牌,2024-03-27,8711
00919,群益台灣精選高息,150,64,86,陽信-石牌,2024-03-27,8711
00939,統一台灣高息動能,92,19,73,陽信-石牌,2024-03-27,8711
2371,大同,145,79,66,陽信-石牌,2024-03-27,8711
00673R,期元大S＆P原油反1,42,0,42,陽信-石牌,2024-03-27,8711
2301,光寶科,37,6,31,陽信-石牌,2024-03-27,8711
6770,力積電,32,4,28,陽信-石牌,2024-03-27,8711
2601,益航,30,3,27,陽信-石牌,2024-03-27,8711
1609,大亞,63,36,27,陽信-石牌,2024-03-27,8711
2367,燿華,106,81,25,陽信-石牌,2024-03-27,8711
3564,其陽,30,5,25,陽信-石牌,2024-03-27,8711
00898,國泰基因免疫革命,24,2,22,陽信-石牌,2024-03-27,8711
00927,群益半導體收益,20,0,20,陽信-石牌,2024-03-27,8711
2006,東和鋼鐵,20,0,20,陽信-石牌,2024-03-27,8711
00929,復華台灣科技優息,16,0,16,陽信-石牌,2024-03-27,8711
3060,銘異,20,5,15,陽信-石牌,2024-03-27,8711
6274,台燿,21,6,15,陽信-石牌,2024-03-27,8711
2382,廣達,34,19,15,陽信-石牌,2024-03-27,8711
2352,佳世達,13,0,13,陽信-石牌,2024-03-27,8711
1789,神隆,12,0,12,陽信-石牌,2024-03-27,8711
2915,潤泰全,12,0,12,陽信-石牌,2024-03-27,8711
1301,台塑,11,0,11,陽信-石牌,2024-03-27,8711
2465,麗臺,12,1,11,陽信-石牌,2024-03-27,8711
2704,國賓,21,10,11,陽信-石牌,2024-03-27,8711
5521,工信,11,0,11,陽信-石牌,2024-03-27,8711
0050,元大台灣50,10,0,10,陽信-石牌,2024-03-27,8711
1220,台榮,10,0,10,陽信-石牌,2024-03-27,8711
1437,勤益控,10,0,10,陽信-石牌,2024-03-27,8711
2359,所羅門,15,5,10,陽信-石牌,2024-03-27,8711
3712,永崴投控,10,0,10,陽信-石牌,2024-03-27,8711
4127,天良,10,0,10,陽信-石牌,2024-03-27,8711
5289,宜鼎,10,0,10,陽信-石牌,2024-03-27,8711
6753,龍德造船,10,0,10,陽信-石牌,2024-03-27,8711
2308,台達電,11,2,9,陽信-石牌,2024-03-27,8711
2331,精英,29,20,9,陽信-石牌,2024-03-27,8711
3689,湧德,9,0,9,陽信-石牌,2024-03-27,8711
1513,中興電,32,24,8,陽信-石牌,2024-03-27,8711
3450,聯鈞,10,2,8,陽信-石牌,2024-03-27,8711
6188,廣明,9,1,8,陽信-石牌,2024-03-27,8711
8110,華東,8,0,8,陽信-石牌,2024-03-27,8711
1312,國喬,7,0,7,陽信-石牌,2024-03-27,8711
1603,華電,16,9,7,陽信-石牌,2024-03-27,8711
2358,廷鑫,7,0,7,陽信-石牌,2024-03-27,8711
00679B,元大美債20年,6,0,6,陽信-石牌,2024-03-27,8711
4714,永捷,351,198,153,陽信-石牌,2024-03-28,8711
3706,神達,98,0,98,陽信-石牌,2024-03-28,8711
0056,元大高股息,81,0,81,陽信-石牌,2024-03-28,8711
9105,泰金寶-DR,60,0,60,陽信-石牌,2024-03-28,8711
00937B,群益ESG投等債20,56,0,56,陽信-石牌,2024-03-28,8711
6120,達運,55,0,55,陽信-石牌,2024-03-28,8711
3058,立德,55,1,54,陽信-石牌,2024-03-28,8711
2354,鴻準,83,30,53,陽信-石牌,2024-03-28,8711
00929,復華台灣科技優息,113,65,48,陽信-石牌,2024-03-28,8711
1609,大亞,121,80,41,陽信-石牌,2024-03-28,8711
00679B,元大美債20年,52,13,39,陽信-石牌,2024-03-28,8711
2371,大同,127,92,35,陽信-石牌,2024-03-28,8711
00939,統一台灣高息動能,50,17,33,陽信-石牌,2024-03-28,8711
2301,光寶科,47,17,30,陽信-石牌,2024-03-28,8711
00665L,富邦�琤肭磪囓�2,78,48,30,陽信-石牌,2024-03-28,8711
2801,彰銀,30,0,30,陽信-石牌,2024-03-28,8711
3041,揚智,30,0,30,陽信-石牌,2024-03-28,8711
5469,瀚宇博,45,21,24,陽信-石牌,2024-03-28,8711
2369,菱生,23,0,23,陽信-石牌,2024-03-28,8711
2885,元大金,22,0,22,陽信-石牌,2024-03-28,8711
00712,復華富時不動產,20,0,20,陽信-石牌,2024-03-28,8711
2367,燿華,41,21,20,陽信-石牌,2024-03-28,8711
4927,泰鼎-KY,20,0,20,陽信-石牌,2024-03-28,8711
1316,上曜,21,2,19,陽信-石牌,2024-03-28,8711
1603,華電,30,11,19,陽信-石牌,2024-03-28,8711
2888,新光金,21,2,19,陽信-石牌,2024-03-28,8711
6770,力積電,25,7,18,陽信-石牌,2024-03-28,8711
00687B,國泰20年美債,25,9,16,陽信-石牌,2024-03-28,8711
8033,雷虎,25,9,16,陽信-石牌,2024-03-28,8711
1616,億泰,15,0,15,陽信-石牌,2024-03-28,8711
2388,威盛,15,0,15,陽信-石牌,2024-03-28,8711
2489,瑞軒,20,5,15,陽信-石牌,2024-03-28,8711
3234,光環,15,0,15,陽信-石牌,2024-03-28,8711
6505,台塑化,14,0,14,陽信-石牌,2024-03-28,8711
1608,華榮,21,9,12,陽信-石牌,2024-03-28,8711
2303,聯電,33,22,11,陽信-石牌,2024-03-28,8711
2442,新美齊,11,0,11,陽信-石牌,2024-03-28,8711
4961,天鈺,12,1,11,陽信-石牌,2024-03-28,8711
1101,台泥,10,0,10,陽信-石牌,2024-03-28,8711
2006,東和鋼鐵,10,0,10,陽信-石牌,2024-03-28,8711
2337,旺宏,11,1,10,陽信-石牌,2024-03-28,8711
2409,友達,10,0,10,陽信-石牌,2024-03-28,8711
2462,良得電,10,0,10,陽信-石牌,2024-03-28,8711
2471,資通,10,0,10,陽信-石牌,2024-03-28,8711
2882,國泰金,10,0,10,陽信-石牌,2024-03-28,8711
3673,TPK-KY,10,0,10,陽信-石牌,2024-03-28,8711
4114,健喬,10,0,10,陽信-石牌,2024-03-28,8711
4123,晟德,10,0,10,陽信-石牌,2024-03-28,8711
6196,帆宣,10,0,10,陽信-石牌,2024-03-28,8711
6214,精誠,10,0,10,陽信-石牌,2024-03-28,8711
00919,群益台灣精選高息,265,39,226,陽信-石牌,2024-03-29,8711
0056,元大高股息,202,1,201,陽信-石牌,2024-03-29,8711
9105,泰金寶-DR,186,43,143,陽信-石牌,2024-03-29,8711
2905,三商,100,0,100,陽信-石牌,2024-03-29,8711
2317,鴻海,138,57,81,陽信-石牌,2024-03-29,8711
2106,建大,60,0,60,陽信-石牌,2024-03-29,8711
2486,一詮,51,7,44,陽信-石牌,2024-03-29,8711
2359,所羅門,43,1,42,陽信-石牌,2024-03-29,8711
2324,仁寶,53,13,40,陽信-石牌,2024-03-29,8711
2356,英業達,268,229,39,陽信-石牌,2024-03-29,8711
6443,元晶,33,0,33,陽信-石牌,2024-03-29,8711
2208,台船,30,0,30,陽信-石牌,2024-03-29,8711
3710,連展投控,30,0,30,陽信-石牌,2024-03-29,8711
4927,泰鼎-KY,30,0,30,陽信-石牌,2024-03-29,8711
3047,訊舟,28,0,28,陽信-石牌,2024-03-29,8711
1504,東元,33,7,26,陽信-石牌,2024-03-29,8711
00939,統一台灣高息動能,26,0,26,陽信-石牌,2024-03-29,8711
2323,中環,25,0,25,陽信-石牌,2024-03-29,8711
00937B,群益ESG投等債20,42,19,23,陽信-石牌,2024-03-29,8711
1815,富喬,32,9,23,陽信-石牌,2024-03-29,8711
4714,永捷,41,19,22,陽信-石牌,2024-03-29,8711
4707,磐亞,21,0,21,陽信-石牌,2024-03-29,8711
2301,光寶科,50,30,20,陽信-石牌,2024-03-29,8711
1506,正道,20,0,20,陽信-石牌,2024-03-29,8711
2337,旺宏,20,0,20,陽信-石牌,2024-03-29,8711
00941,中信上游半導體,28,10,18,陽信-石牌,2024-03-29,8711
1905,華紙,31,13,18,陽信-石牌,2024-03-29,8711
2329,華泰,17,0,17,陽信-石牌,2024-03-29,8711
5388,中磊,16,0,16,陽信-石牌,2024-03-29,8711
3294,英濟,19,3,16,陽信-石牌,2024-03-29,8711
8085,福華,16,0,16,陽信-石牌,2024-03-29,8711
8096,擎亞,31,15,16,陽信-石牌,2024-03-29,8711
2303,聯電,42,26,16,陽信-石牌,2024-03-29,8711
6126,信音,46,31,15,陽信-石牌,2024-03-29,8711
2606,裕民,14,0,14,陽信-石牌,2024-03-29,8711
2834,臺企銀,28,15,13,陽信-石牌,2024-03-29,8711
6170,統振,14,1,13,陽信-石牌,2024-03-29,8711
3062,建漢,14,2,12,陽信-石牌,2024-03-29,8711
3005,神基,11,0,11,陽信-石牌,2024-03-29,8711
1432,大魯閣,11,0,11,陽信-石牌,2024-03-29,8711
2367,燿華,27,16,11,陽信-石牌,2024-03-29,8711
9945,潤泰新,10,0,10,陽信-石牌,2024-03-29,8711
2468,華經,10,0,10,陽信-石牌,2024-03-29,8711
2485,兆赫,10,0,10,陽信-石牌,2024-03-29,8711
3512,皇龍,15,5,10,陽信-石牌,2024-03-29,8711
9955,佳龍,23,13,10,陽信-石牌,2024-03-29,8711
2388,威盛,10,1,9,陽信-石牌,2024-03-29,8711
2605,新興,9,0,9,陽信-石牌,2024-03-29,8711
3481,群創,12,3,9,陽信-石牌,2024-03-29,8711
5309,系統電,9,0,9,陽信-石牌,2024-03-29,8711
00940,元大台灣價值高息,1345,21,1324,陽信-石牌,2024-04-01,8711
00929,復華台灣科技優息,212,10,202,陽信-石牌,2024-04-01,8711
00679B,元大美債20年,163,5,158,陽信-石牌,2024-04-01,8711
9105,泰金寶-DR,130,0,130,陽信-石牌,2024-04-01,8711
3188,鑫龍騰,102,0,102,陽信-石牌,2024-04-01,8711
3231,緯創,116,24,92,陽信-石牌,2024-04-01,8711
00937B,群益ESG投等債20,83,3,80,陽信-石牌,2024-04-01,8711
00939,統一台灣高息動能,76,0,76,陽信-石牌,2024-04-01,8711
0056,元大高股息,52,1,51,陽信-石牌,2024-04-01,8711
00706L,期元大S＆P日圓正2,50,0,50,陽信-石牌,2024-04-01,8711
00720B,元大投資級公司債,50,0,50,陽信-石牌,2024-04-01,8711
3711,日月光投控,60,18,42,陽信-石牌,2024-04-01,8711
4562,穎漢,37,5,32,陽信-石牌,2024-04-01,8711
02001L,富邦蘋果正二N,30,0,30,陽信-石牌,2024-04-01,8711
5864,致和證,30,0,30,陽信-石牌,2024-04-01,8711
00919,群益台灣精選高息,50,21,29,陽信-石牌,2024-04-01,8711
6198,瑞築,25,0,25,陽信-石牌,2024-04-01,8711
00923,群益台ESG低碳50,23,0,23,陽信-石牌,2024-04-01,8711
2605,新興,20,0,20,陽信-石牌,2024-04-01,8711
2615,萬海,20,0,20,陽信-石牌,2024-04-01,8711
3686,達能,20,0,20,陽信-石牌,2024-04-01,8711
3706,神達,21,1,20,陽信-石牌,2024-04-01,8711
8105,凌巨,20,0,20,陽信-石牌,2024-04-01,8711
3163,波若威,22,3,19,陽信-石牌,2024-04-01,8711
3617,碩天,20,1,19,陽信-石牌,2024-04-01,8711
2891,中信金,18,0,18,陽信-石牌,2024-04-01,8711
5483,中美晶,20,2,18,陽信-石牌,2024-04-01,8711
2444,兆勁,16,0,16,陽信-石牌,2024-04-01,8711
1582,信錦,15,0,15,陽信-石牌,2024-04-01,8711
2834,臺企銀,15,0,15,陽信-石牌,2024-04-01,8711
1504,東元,16,2,14,陽信-石牌,2024-04-01,8711
2109,華豐,14,0,14,陽信-石牌,2024-04-01,8711
2329,華泰,18,4,14,陽信-石牌,2024-04-01,8711
3481,群創,14,0,14,陽信-石牌,2024-04-01,8711
6451,訊芯-KY,15,1,14,陽信-石牌,2024-04-01,8711
00715L,期街口布蘭特正2,13,0,13,陽信-石牌,2024-04-01,8711
3583,辛耘,15,2,13,陽信-石牌,2024-04-01,8711
4938,和碩,15,2,13,陽信-石牌,2024-04-01,8711
6196,帆宣,13,1,12,陽信-石牌,2024-04-01,8711
2313,華通,24,12,12,陽信-石牌,2024-04-01,8711
2885,元大金,12,0,12,陽信-石牌,2024-04-01,8711
3704,合勤控,12,0,12,陽信-石牌,2024-04-01,8711
4303,信立,14,2,12,陽信-石牌,2024-04-01,8711
4966,譜瑞-KY,14,2,12,陽信-石牌,2024-04-01,8711
9921,巨大,12,0,12,陽信-石牌,2024-04-01,8711
2382,廣達,39,27,12,陽信-石牌,2024-04-01,8711
1319,東陽,12,1,11,陽信-石牌,2024-04-01,8711
6170,統振,11,0,11,陽信-石牌,2024-04-01,8711
00878,國泰永續高股息,12,2,10,陽信-石牌,2024-04-01,8711
00680L,元大美債20正2,10,0,10,陽信-石牌,2024-04-01,8711
00929,復華台灣科技優息,416,68,348,陽信-石牌,2024-04-02,8711
00632R,元大台灣50反1,304,2,302,陽信-石牌,2024-04-02,8711
00878,國泰永續高股息,225,10,215,陽信-石牌,2024-04-02,8711
00931B,統一美債20年,190,0,190,陽信-石牌,2024-04-02,8711
00733,富邦臺灣中小,159,0,159,陽信-石牌,2024-04-02,8711
00919,群益台灣精選高息,93,4,89,陽信-石牌,2024-04-02,8711
00937B,群益ESG投等債20,88,5,83,陽信-石牌,2024-04-02,8711
9105,泰金寶-DR,60,0,60,陽信-石牌,2024-04-02,8711
00941,中信上游半導體,57,2,55,陽信-石牌,2024-04-02,8711
00940,元大台灣價值高息,272,218,54,陽信-石牌,2024-04-02,8711
1722,台肥,51,0,51,陽信-石牌,2024-04-02,8711
00706L,期元大S＆P日圓正2,50,0,50,陽信-石牌,2024-04-02,8711
00751B,元大AAA至A公司債,43,0,43,陽信-石牌,2024-04-02,8711
00857B,永豐20年美公債,42,0,42,陽信-石牌,2024-04-02,8711
1905,華紙,35,0,35,陽信-石牌,2024-04-02,8711
00679B,元大美債20年,32,0,32,陽信-石牌,2024-04-02,8711
2367,燿華,32,1,31,陽信-石牌,2024-04-02,8711
3483,力致,32,2,30,陽信-石牌,2024-04-02,8711
6153,嘉聯益,40,10,30,陽信-石牌,2024-04-02,8711
00687B,國泰20年美債,67,40,27,陽信-石牌,2024-04-02,8711
00933B,國泰10Y+金融債,23,0,23,陽信-石牌,2024-04-02,8711
2371,大同,55,33,22,陽信-石牌,2024-04-02,8711
2603,長榮,26,4,22,陽信-石牌,2024-04-02,8711
1815,富喬,21,0,21,陽信-石牌,2024-04-02,8711
5386,青雲,21,0,21,陽信-石牌,2024-04-02,8711
6451,訊芯-KY,19,0,19,陽信-石牌,2024-04-02,8711
2354,鴻準,28,9,19,陽信-石牌,2024-04-02,8711
1513,中興電,21,2,19,陽信-石牌,2024-04-02,8711
6550,北極星藥業-KY,18,0,18,陽信-石牌,2024-04-02,8711
4966,譜瑞-KY,17,0,17,陽信-石牌,2024-04-02,8711
00939,統一台灣高息動能,17,1,16,陽信-石牌,2024-04-02,8711
2888,新光金,16,0,16,陽信-石牌,2024-04-02,8711
00773B,中信優先金融債,15,0,15,陽信-石牌,2024-04-02,8711
00688L,國泰20年美債正2,15,0,15,陽信-石牌,2024-04-02,8711
6188,廣明,17,2,15,陽信-石牌,2024-04-02,8711
3548,兆利,15,2,13,陽信-石牌,2024-04-02,8711
2637,慧洋-KY,13,0,13,陽信-石牌,2024-04-02,8711
00665L,富邦�琤肭磪囓�2,29,18,11,陽信-石牌,2024-04-02,8711
1609,大亞,120,109,11,陽信-石牌,2024-04-02,8711
3706,神達,16,5,11,陽信-石牌,2024-04-02,8711
2409,友達,11,0,11,陽信-石牌,2024-04-02,8711
00927,群益半導體收益,10,0,10,陽信-石牌,2024-04-02,8711
00795B,中信美國公債20年,10,0,10,陽信-石牌,2024-04-02,8711
1316,上曜,10,0,10,陽信-石牌,2024-04-02,8711
1432,大魯閣,10,0,10,陽信-石牌,2024-04-02,8711
2020,美亞,10,0,10,陽信-石牌,2024-04-02,8711
2025,千興,10,0,10,陽信-石牌,2024-04-02,8711
2349,錸德,10,0,10,陽信-石牌,2024-04-02,8711
3047,訊舟,10,0,10,陽信-石牌,2024-04-02,8711
6742,澤米,11,1,10,陽信-石牌,2024-04-02,8711
00929,復華台灣科技優息,203,1,202,陽信-石牌,2024-04-03,8711
2845,遠東銀,151,0,151,陽信-石牌,2024-04-03,8711
00940,元大台灣價值高息,119,4,115,陽信-石牌,2024-04-03,8711
2014,中鴻,112,1,111,陽信-石牌,2024-04-03,8711
00927,群益半導體收益,86,0,86,陽信-石牌,2024-04-03,8711
00937B,群益ESG投等債20,80,5,75,陽信-石牌,2024-04-03,8711
00931B,統一美債20年,62,0,62,陽信-石牌,2024-04-03,8711
2885,元大金,50,0,50,陽信-石牌,2024-04-03,8711
6438,迅得,47,0,47,陽信-石牌,2024-04-03,8711
00898,國泰基因免疫革命,45,1,44,陽信-石牌,2024-04-03,8711
3481,群創,40,0,40,陽信-石牌,2024-04-03,8711
9955,佳龍,42,3,39,陽信-石牌,2024-04-03,8711
6770,力積電,36,0,36,陽信-石牌,2024-04-03,8711
2618,長榮航,37,2,35,陽信-石牌,2024-04-03,8711
1789,神隆,39,5,34,陽信-石牌,2024-04-03,8711
2317,鴻海,89,58,31,陽信-石牌,2024-04-03,8711
00939,統一台灣高息動能,29,2,27,陽信-石牌,2024-04-03,8711
00673R,期元大S＆P原油反1,25,0,25,陽信-石牌,2024-04-03,8711
2547,日勝生,25,0,25,陽信-石牌,2024-04-03,8711
2801,彰銀,25,0,25,陽信-石牌,2024-04-03,8711
00679B,元大美債20年,24,1,23,陽信-石牌,2024-04-03,8711
2886,兆豐金,24,2,22,陽信-石牌,2024-04-03,8711
02001L,富邦蘋果正二N,22,0,22,陽信-石牌,2024-04-03,8711
00712,復華富時不動產,22,0,22,陽信-石牌,2024-04-03,8711
2881,富邦金,22,0,22,陽信-石牌,2024-04-03,8711
00688L,國泰20年美債正2,21,0,21,陽信-石牌,2024-04-03,8711
4157,太景*-KY,21,0,21,陽信-石牌,2024-04-03,8711
6235,華孚,20,1,19,陽信-石牌,2024-04-03,8711
2382,廣達,24,5,19,陽信-石牌,2024-04-03,8711
2344,華邦電,25,6,19,陽信-石牌,2024-04-03,8711
1609,大亞,33,16,17,陽信-石牌,2024-04-03,8711
2371,大同,47,30,17,陽信-石牌,2024-04-03,8711
2610,華航,16,0,16,陽信-石牌,2024-04-03,8711
1455,集盛,15,0,15,陽信-石牌,2024-04-03,8711
2408,南亞科,16,1,15,陽信-石牌,2024-04-03,8711
4533,協易機,15,0,15,陽信-石牌,2024-04-03,8711
4938,和碩,16,1,15,陽信-石牌,2024-04-03,8711
9105,泰金寶-DR,15,0,15,陽信-石牌,2024-04-03,8711
3036,文曄,16,2,14,陽信-石牌,2024-04-03,8711
00687B,國泰20年美債,15,2,13,陽信-石牌,2024-04-03,8711
2303,聯電,15,2,13,陽信-石牌,2024-04-03,8711
3715,定穎投控,17,4,13,陽信-石牌,2024-04-03,8711
6684,安格,18,5,13,陽信-石牌,2024-04-03,8711
2330,台積電,14,2,12,陽信-石牌,2024-04-03,8711
2368,金像電,16,4,12,陽信-石牌,2024-04-03,8711
4716,大立,12,0,12,陽信-石牌,2024-04-03,8711
00751B,元大AAA至A公司債,11,0,11,陽信-石牌,2024-04-03,8711
2834,臺企銀,11,0,11,陽信-石牌,2024-04-03,8711
8927,北基,11,0,11,陽信-石牌,2024-04-03,8711
00857B,永豐20年美公債,15,5,10,陽信-石牌,2024-04-03,8711
9105,泰金寶-DR,188,1,187,陽信-石牌,2024-04-08,8711
00937B,群益ESG投等債20,157,1,156,陽信-石牌,2024-04-08,8711
0052,富邦科技,130,0,130,陽信-石牌,2024-04-08,8711
00632R,元大台灣50反1,100,0,100,陽信-石牌,2024-04-08,8711
00940,元大台灣價值高息,112,22,90,陽信-石牌,2024-04-08,8711
2303,聯電,57,0,57,陽信-石牌,2024-04-08,8711
00857B,永豐20年美公債,56,0,56,陽信-石牌,2024-04-08,8711
5608,四維航,55,0,55,陽信-石牌,2024-04-08,8711
00706L,期元大S＆P日圓正2,50,0,50,陽信-石牌,2024-04-08,8711
6120,達運,51,6,45,陽信-石牌,2024-04-08,8711
2408,南亞科,51,9,42,陽信-石牌,2024-04-08,8711
3231,緯創,101,60,41,陽信-石牌,2024-04-08,8711
6209,今國光,40,0,40,陽信-石牌,2024-04-08,8711
00687B,國泰20年美債,35,0,35,陽信-石牌,2024-04-08,8711
3059,華晶科,64,32,32,陽信-石牌,2024-04-08,8711
2317,鴻海,71,41,30,陽信-石牌,2024-04-08,8711
3706,神達,36,7,29,陽信-石牌,2024-04-08,8711
2329,華泰,40,11,29,陽信-石牌,2024-04-08,8711
2368,金像電,27,1,26,陽信-石牌,2024-04-08,8711
00688L,國泰20年美債正2,25,0,25,陽信-石牌,2024-04-08,8711
00933B,國泰10Y+金融債,24,0,24,陽信-石牌,2024-04-08,8711
00679B,元大美債20年,51,27,24,陽信-石牌,2024-04-08,8711
00898,國泰基因免疫革命,24,1,23,陽信-石牌,2024-04-08,8711
00673R,期元大S＆P原油反1,23,0,23,陽信-石牌,2024-04-08,8711
2354,鴻準,26,3,23,陽信-石牌,2024-04-08,8711
2371,大同,40,18,22,陽信-石牌,2024-04-08,8711
4562,穎漢,21,0,21,陽信-石牌,2024-04-08,8711
0056,元大高股息,21,1,20,陽信-石牌,2024-04-08,8711
00696B,富邦美債20年,20,0,20,陽信-石牌,2024-04-08,8711
2436,偉詮電,20,0,20,陽信-石牌,2024-04-08,8711
2707,晶華,20,0,20,陽信-石牌,2024-04-08,8711
2888,新光金,24,4,20,陽信-石牌,2024-04-08,8711
00941,中信上游半導體,18,0,18,陽信-石牌,2024-04-08,8711
2486,一詮,27,9,18,陽信-石牌,2024-04-08,8711
1513,中興電,30,12,18,陽信-石牌,2024-04-08,8711
1612,宏泰,44,27,17,陽信-石牌,2024-04-08,8711
2618,長榮航,38,22,16,陽信-石牌,2024-04-08,8711
4716,大立,36,20,16,陽信-石牌,2024-04-08,8711
6189,豐藝,19,3,16,陽信-石牌,2024-04-08,8711
2704,國賓,15,0,15,陽信-石牌,2024-04-08,8711
5230,雷笛克光學,14,0,14,陽信-石牌,2024-04-08,8711
3036,文曄,13,0,13,陽信-石牌,2024-04-08,8711
3105,穩懋,19,6,13,陽信-石牌,2024-04-08,8711
8927,北基,13,0,13,陽信-石牌,2024-04-08,8711
2374,佳能,31,20,11,陽信-石牌,2024-04-08,8711
2409,友達,11,0,11,陽信-石牌,2024-04-08,8711
6235,華孚,10,0,10,陽信-石牌,2024-04-08,8711
00772B,中信高評級公司債,10,0,10,陽信-石牌,2024-04-08,8711
00751B,元大AAA至A公司債,10,0,10,陽信-石牌,2024-04-08,8711
1325,恆大,12,2,10,陽信-石牌,2024-04-08,8711
00632R,元大台灣50反1,353,1,352,陽信-石牌,2024-04-09,8711
00931B,統一美債20年,185,0,185,陽信-石牌,2024-04-09,8711
00929,復華台灣科技優息,177,0,177,陽信-石牌,2024-04-09,8711
00919,群益台灣精選高息,106,0,106,陽信-石牌,2024-04-09,8711
3231,緯創,124,41,83,陽信-石牌,2024-04-09,8711
6120,達運,84,1,83,陽信-石牌,2024-04-09,8711
6294,智基,68,0,68,陽信-石牌,2024-04-09,8711
2371,大同,86,38,48,陽信-石牌,2024-04-09,8711
2354,鴻準,51,9,42,陽信-石牌,2024-04-09,8711
2374,佳能,55,13,42,陽信-石牌,2024-04-09,8711
6005,群益證,42,0,42,陽信-石牌,2024-04-09,8711
4716,大立,42,1,41,陽信-石牌,2024-04-09,8711
6198,瑞築,35,0,35,陽信-石牌,2024-04-09,8711
00937B,群益ESG投等債20,54,23,31,陽信-石牌,2024-04-09,8711
2486,一詮,45,16,29,陽信-石牌,2024-04-09,8711
6026,福邦證,31,3,28,陽信-石牌,2024-04-09,8711
00687B,國泰20年美債,27,0,27,陽信-石牌,2024-04-09,8711
00733,富邦臺灣中小,27,0,27,陽信-石牌,2024-04-09,8711
00706L,期元大S＆P日圓正2,30,5,25,陽信-石牌,2024-04-09,8711
1605,華新,54,29,25,陽信-石牌,2024-04-09,8711
3013,晟銘電,71,47,24,陽信-石牌,2024-04-09,8711
1733,五鼎,22,0,22,陽信-石牌,2024-04-09,8711
4543,萬在,27,5,22,陽信-石牌,2024-04-09,8711
5426,振發,22,1,21,陽信-石牌,2024-04-09,8711
2012,春雨,20,0,20,陽信-石牌,2024-04-09,8711
2405,輔信,30,10,20,陽信-石牌,2024-04-09,8711
4157,太景*-KY,20,0,20,陽信-石牌,2024-04-09,8711
00940,元大台灣價值高息,20,1,19,陽信-石牌,2024-04-09,8711
6443,元晶,23,6,17,陽信-石牌,2024-04-09,8711
2453,凌群,16,0,16,陽信-石牌,2024-04-09,8711
4562,穎漢,16,0,16,陽信-石牌,2024-04-09,8711
6163,華電網,16,0,16,陽信-石牌,2024-04-09,8711
1725,元禎,15,0,15,陽信-石牌,2024-04-09,8711
2812,台中銀,15,0,15,陽信-石牌,2024-04-09,8711
8054,安國,26,11,15,陽信-石牌,2024-04-09,8711
2603,長榮,36,22,14,陽信-石牌,2024-04-09,8711
3234,光環,14,0,14,陽信-石牌,2024-04-09,8711
2009,第一銅,16,3,13,陽信-石牌,2024-04-09,8711
2610,華航,18,5,13,陽信-石牌,2024-04-09,8711
1504,東元,18,6,12,陽信-石牌,2024-04-09,8711
2368,金像電,12,0,12,陽信-石牌,2024-04-09,8711
2852,第一保,12,0,12,陽信-石牌,2024-04-09,8711
8227,巨有科技,12,0,12,陽信-石牌,2024-04-09,8711
2313,華通,13,2,11,陽信-石牌,2024-04-09,8711
00881,國泰台灣5G+,11,0,11,陽信-石牌,2024-04-09,8711
00898,國泰基因免疫革命,11,0,11,陽信-石牌,2024-04-09,8711
2506,太設,11,0,11,陽信-石牌,2024-04-09,8711
3703,欣陸,11,0,11,陽信-石牌,2024-04-09,8711
6179,亞通,16,5,11,陽信-石牌,2024-04-09,8711
3044,健鼎,11,0,11,陽信-石牌,2024-04-09,8711
6294,智基,120,0,120,陽信-石牌,2024-04-10,8711
2449,京元電子,103,2,101,陽信-石牌,2024-04-10,8711
1722,台肥,80,0,80,陽信-石牌,2024-04-10,8711
6770,力積電,111,33,78,陽信-石牌,2024-04-10,8711
00940,元大台灣價值高息,58,0,58,陽信-石牌,2024-04-10,8711
2515,中工,74,22,52,陽信-石牌,2024-04-10,8711
2888,新光金,113,66,47,陽信-石牌,2024-04-10,8711
00679B,元大美債20年,45,0,45,陽信-石牌,2024-04-10,8711
6192,巨路,47,5,42,陽信-石牌,2024-04-10,8711
3576,聯合再生,55,14,41,陽信-石牌,2024-04-10,8711
02001L,富邦蘋果正二N,39,0,39,陽信-石牌,2024-04-10,8711
2634,漢翔,50,11,39,陽信-石牌,2024-04-10,8711
9103,美德醫療-DR,36,0,36,陽信-石牌,2024-04-10,8711
3294,英濟,44,14,30,陽信-石牌,2024-04-10,8711
2603,長榮,30,1,29,陽信-石牌,2024-04-10,8711
2376,技嘉,32,7,25,陽信-石牌,2024-04-10,8711
2374,佳能,38,14,24,陽信-石牌,2024-04-10,8711
2610,華航,25,1,24,陽信-石牌,2024-04-10,8711
1503,士電,27,4,23,陽信-石牌,2024-04-10,8711
2885,元大金,23,0,23,陽信-石牌,2024-04-10,8711
8033,雷虎,24,1,23,陽信-石牌,2024-04-10,8711
2313,華通,29,8,21,陽信-石牌,2024-04-10,8711
00706L,期元大S＆P日圓正2,20,0,20,陽信-石牌,2024-04-10,8711
3004,豐達科,20,0,20,陽信-石牌,2024-04-10,8711
3095,及成,20,0,20,陽信-石牌,2024-04-10,8711
2317,鴻海,112,93,19,陽信-石牌,2024-04-10,8711
00915,凱基優選高股息30,19,0,19,陽信-石牌,2024-04-10,8711
2353,宏��,39,21,18,陽信-石牌,2024-04-10,8711
4804,大略-KY,18,0,18,陽信-石牌,2024-04-10,8711
00733,富邦臺灣中小,143,126,17,陽信-石牌,2024-04-10,8711
5465,富驊,16,0,16,陽信-石牌,2024-04-10,8711
1455,集盛,15,0,15,陽信-石牌,2024-04-10,8711
1808,潤隆,15,1,14,陽信-石牌,2024-04-10,8711
3484,崧騰,14,0,14,陽信-石牌,2024-04-10,8711
4916,事欣科,15,1,14,陽信-石牌,2024-04-10,8711
2405,輔信,16,3,13,陽信-石牌,2024-04-10,8711
6438,迅得,13,0,13,陽信-石牌,2024-04-10,8711
2301,光寶科,13,0,13,陽信-石牌,2024-04-10,8711
8096,擎亞,16,4,12,陽信-石牌,2024-04-10,8711
2383,台光電,12,1,11,陽信-石牌,2024-04-10,8711
2316,楠梓電,11,0,11,陽信-石牌,2024-04-10,8711
5009,榮剛,14,3,11,陽信-石牌,2024-04-10,8711
8046,南電,11,0,11,陽信-石牌,2024-04-10,8711
00937B,群益ESG投等債20,20,10,10,陽信-石牌,2024-04-10,8711
1514,亞力,30,20,10,陽信-石牌,2024-04-10,8711
3231,緯創,22,12,10,陽信-石牌,2024-04-10,8711
00651R,復華香港反1,10,0,10,陽信-石牌,2024-04-10,8711
1314,中石化,30,20,10,陽信-石牌,2024-04-10,8711
1603,華電,21,11,10,陽信-石牌,2024-04-10,8711
1608,華榮,20,10,10,陽信-石牌,2024-04-10,8711
00937B,群益ESG投等債20,650,4,646,陽信-石牌,2024-04-11,8711
00632R,元大台灣50反1,300,0,300,陽信-石牌,2024-04-11,8711
00940,元大台灣價值高息,179,14,165,陽信-石牌,2024-04-11,8711
3481,群創,141,0,141,陽信-石牌,2024-04-11,8711
00929,復華台灣科技優息,126,1,125,陽信-石牌,2024-04-11,8711
00931B,統一美債20年,124,0,124,陽信-石牌,2024-04-11,8711
2330,台積電,108,5,103,陽信-石牌,2024-04-11,8711
2371,大同,164,67,97,陽信-石牌,2024-04-11,8711
00679B,元大美債20年,116,31,85,陽信-石牌,2024-04-11,8711
00919,群益台灣精選高息,73,7,66,陽信-石牌,2024-04-11,8711
1229,聯華,60,0,60,陽信-石牌,2024-04-11,8711
00933B,國泰10Y+金融債,58,0,58,陽信-石牌,2024-04-11,8711
2882,國泰金,106,48,58,陽信-石牌,2024-04-11,8711
5347,世界,54,1,53,陽信-石牌,2024-04-11,8711
1102,亞泥,52,0,52,陽信-石牌,2024-04-11,8711
9105,泰金寶-DR,52,0,52,陽信-石牌,2024-04-11,8711
00633L,富邦上証正2,50,0,50,陽信-石牌,2024-04-11,8711
2606,裕民,41,0,41,陽信-石牌,2024-04-11,8711
2605,新興,47,8,39,陽信-石牌,2024-04-11,8711
3707,漢磊,55,22,33,陽信-石牌,2024-04-11,8711
2409,友達,32,0,32,陽信-石牌,2024-04-11,8711
2634,漢翔,97,66,31,陽信-石牌,2024-04-11,8711
00706L,期元大S＆P日圓正2,31,0,31,陽信-石牌,2024-04-11,8711
00720B,元大投資級公司債,30,0,30,陽信-石牌,2024-04-11,8711
1720,生達,30,0,30,陽信-石牌,2024-04-11,8711
3305,昇貿,26,0,26,陽信-石牌,2024-04-11,8711
2444,兆勁,24,0,24,陽信-石牌,2024-04-11,8711
2317,鴻海,108,84,24,陽信-石牌,2024-04-11,8711
00941,中信上游半導體,28,5,23,陽信-石牌,2024-04-11,8711
2486,一詮,33,10,23,陽信-石牌,2024-04-11,8711
00918,大華優利高填息30,22,0,22,陽信-石牌,2024-04-11,8711
0052,富邦科技,21,0,21,陽信-石牌,2024-04-11,8711
00687B,國泰20年美債,21,0,21,陽信-石牌,2024-04-11,8711
00878,國泰永續高股息,42,21,21,陽信-石牌,2024-04-11,8711
2530,華建,21,0,21,陽信-石牌,2024-04-11,8711
00898,國泰基因免疫革命,20,0,20,陽信-石牌,2024-04-11,8711
00696B,富邦美債20年,20,0,20,陽信-石牌,2024-04-11,8711
4157,太景*-KY,20,0,20,陽信-石牌,2024-04-11,8711
5876,上海商銀,20,0,20,陽信-石牌,2024-04-11,8711
6120,達運,20,0,20,陽信-石牌,2024-04-11,8711
6550,北極星藥業-KY,17,0,17,陽信-石牌,2024-04-11,8711
00680L,元大美債20正2,16,0,16,陽信-石牌,2024-04-11,8711
00751B,元大AAA至A公司債,16,0,16,陽信-石牌,2024-04-11,8711
2344,華邦電,21,5,16,陽信-石牌,2024-04-11,8711
00909,國泰數位支付服務,15,0,15,陽信-石牌,2024-04-11,8711
00688L,國泰20年美債正2,15,0,15,陽信-石牌,2024-04-11,8711
2390,云辰,15,0,15,陽信-石牌,2024-04-11,8711
5511,德昌,15,0,15,陽信-石牌,2024-04-11,8711
00665L,富邦�琤肭磪囓�2,44,30,14,陽信-石牌,2024-04-11,8711
2356,英業達,41,27,14,陽信-石牌,2024-04-11,8711
1611,中電,200,0,200,陽信-石牌,2024-04-12,8711
0056,元大高股息,132,0,132,陽信-石牌,2024-04-12,8711
00931B,統一美債20年,74,2,72,陽信-石牌,2024-04-12,8711
00706L,期元大S＆P日圓正2,70,0,70,陽信-石牌,2024-04-12,8711
00929,復華台灣科技優息,69,0,69,陽信-石牌,2024-04-12,8711
1229,聯華,59,0,59,陽信-石牌,2024-04-12,8711
2618,長榮航,56,2,54,陽信-石牌,2024-04-12,8711
00940,元大台灣價值高息,50,0,50,陽信-石牌,2024-04-12,8711
9105,泰金寶-DR,47,0,47,陽信-石牌,2024-04-12,8711
2353,宏��,79,36,43,陽信-石牌,2024-04-12,8711
3481,群創,50,8,42,陽信-石牌,2024-04-12,8711
1815,富喬,40,0,40,陽信-石牌,2024-04-12,8711
00937B,群益ESG投等債20,36,0,36,陽信-石牌,2024-04-12,8711
2409,友達,34,1,33,陽信-石牌,2024-04-12,8711
2530,華建,33,0,33,陽信-石牌,2024-04-12,8711
2303,聯電,32,0,32,陽信-石牌,2024-04-12,8711
00857B,永豐20年美公債,31,0,31,陽信-石牌,2024-04-12,8711
00674R,期元大S＆P黃金反1,30,0,30,陽信-石牌,2024-04-12,8711
2382,廣達,30,2,28,陽信-石牌,2024-04-12,8711
2313,華通,40,14,26,陽信-石牌,2024-04-12,8711
00773B,中信優先金融債,25,0,25,陽信-石牌,2024-04-12,8711
00751B,元大AAA至A公司債,25,0,25,陽信-石牌,2024-04-12,8711
1905,華紙,25,0,25,陽信-石牌,2024-04-12,8711
00687B,國泰20年美債,43,20,23,陽信-石牌,2024-04-12,8711
4967,十銓,30,7,23,陽信-石牌,2024-04-12,8711
0052,富邦科技,21,0,21,陽信-石牌,2024-04-12,8711
1504,東元,40,20,20,陽信-石牌,2024-04-12,8711
3518,柏騰,20,0,20,陽信-石牌,2024-04-12,8711
00878,國泰永續高股息,33,15,18,陽信-石牌,2024-04-12,8711
2324,仁寶,21,3,18,陽信-石牌,2024-04-12,8711
2886,兆豐金,20,2,18,陽信-石牌,2024-04-12,8711
2340,台亞,17,0,17,陽信-石牌,2024-04-12,8711
3715,定穎投控,17,0,17,陽信-石牌,2024-04-12,8711
4545,銘鈺,17,0,17,陽信-石牌,2024-04-12,8711
00936,台新永續高息中小,16,0,16,陽信-石牌,2024-04-12,8711
1455,集盛,16,0,16,陽信-石牌,2024-04-12,8711
4533,協易機,18,2,16,陽信-石牌,2024-04-12,8711
1789,神隆,19,4,15,陽信-石牌,2024-04-12,8711
6279,胡連,15,0,15,陽信-石牌,2024-04-12,8711
00795B,中信美國公債20年,14,0,14,陽信-石牌,2024-04-12,8711
4743,合一,14,0,14,陽信-石牌,2024-04-12,8711
4943,康控-KY,14,0,14,陽信-石牌,2024-04-12,8711
00772B,中信高評級公司債,13,0,13,陽信-石牌,2024-04-12,8711
1603,華電,38,25,13,陽信-石牌,2024-04-12,8711
2506,太設,18,5,13,陽信-石牌,2024-04-12,8711
6188,廣明,16,3,13,陽信-石牌,2024-04-12,8711
00665L,富邦�琤肭磪囓�2,30,18,12,陽信-石牌,2024-04-12,8711
00688L,國泰20年美債正2,12,0,12,陽信-石牌,2024-04-12,8711
2511,太子,11,0,11,陽信-石牌,2024-04-12,8711
3024,憶聲,11,0,11,陽信-石牌,2024-04-12,8711
00929,復華台灣科技優息,346,12,334,陽信-石牌,2024-04-15,8711
1609,大亞,178,40,138,陽信-石牌,2024-04-15,8711
2867,三商壽,139,12,127,陽信-石牌,2024-04-15,8711
2330,台積電,109,0,109,陽信-石牌,2024-04-15,8711
00706L,期元大S＆P日圓正2,82,0,82,陽信-石牌,2024-04-15,8711
9105,泰金寶-DR,81,0,81,陽信-石牌,2024-04-15,8711
1513,中興電,133,57,76,陽信-石牌,2024-04-15,8711
00941,中信上游半導體,65,8,57,陽信-石牌,2024-04-15,8711
2241,艾姆勒,55,0,55,陽信-石牌,2024-04-15,8711
00919,群益台灣精選高息,50,2,48,陽信-石牌,2024-04-15,8711
6438,迅得,51,5,46,陽信-石牌,2024-04-15,8711
00634R,富邦上証反1,45,0,45,陽信-石牌,2024-04-15,8711
00937B,群益ESG投等債20,54,12,42,陽信-石牌,2024-04-15,8711
2634,漢翔,68,28,40,陽信-石牌,2024-04-15,8711
5272,笙科,40,1,39,陽信-石牌,2024-04-15,8711
1608,華榮,68,31,37,陽信-石牌,2024-04-15,8711
2371,大同,312,279,33,陽信-石牌,2024-04-15,8711
00665L,富邦�琤肭磪囓�2,49,18,31,陽信-石牌,2024-04-15,8711
0052,富邦科技,30,0,30,陽信-石牌,2024-04-15,8711
2313,華通,37,7,30,陽信-石牌,2024-04-15,8711
2498,宏達電,30,0,30,陽信-石牌,2024-04-15,8711
2317,鴻海,66,36,30,陽信-石牌,2024-04-15,8711
1587,吉茂,28,1,27,陽信-石牌,2024-04-15,8711
2882,國泰金,28,1,27,陽信-石牌,2024-04-15,8711
3059,華晶科,34,8,26,陽信-石牌,2024-04-15,8711
6443,元晶,30,5,25,陽信-石牌,2024-04-15,8711
2427,三商電,24,0,24,陽信-石牌,2024-04-15,8711
3231,緯創,32,12,20,陽信-石牌,2024-04-15,8711
2618,長榮航,29,10,19,陽信-石牌,2024-04-15,8711
00939,統一台灣高息動能,18,0,18,陽信-石牌,2024-04-15,8711
1504,東元,25,7,18,陽信-石牌,2024-04-15,8711
2489,瑞軒,18,0,18,陽信-石牌,2024-04-15,8711
00918,大華優利高填息30,25,8,17,陽信-石牌,2024-04-15,8711
6282,康舒,27,10,17,陽信-石牌,2024-04-15,8711
02001L,富邦蘋果正二N,14,0,14,陽信-石牌,2024-04-15,8711
2002,中鋼,14,0,14,陽信-石牌,2024-04-15,8711
6477,安集,17,3,14,陽信-石牌,2024-04-15,8711
2369,菱生,13,0,13,陽信-石牌,2024-04-15,8711
3294,英濟,14,1,13,陽信-石牌,2024-04-15,8711
3484,崧騰,13,0,13,陽信-石牌,2024-04-15,8711
00933B,國泰10Y+金融債,12,0,12,陽信-石牌,2024-04-15,8711
3545,敦泰,12,0,12,陽信-石牌,2024-04-15,8711
3686,達能,12,0,12,陽信-石牌,2024-04-15,8711
6799,來頡,14,2,12,陽信-石牌,2024-04-15,8711
3508,位速,11,0,11,陽信-石牌,2024-04-15,8711
8358,金居,16,5,11,陽信-石牌,2024-04-15,8711
2101,南港,25,15,10,陽信-石牌,2024-04-15,8711
00898,國泰基因免疫革命,10,0,10,陽信-石牌,2024-04-15,8711
00738U,期元大道瓊白銀,10,0,10,陽信-石牌,2024-04-15,8711
00733,富邦臺灣中小,10,0,10,陽信-石牌,2024-04-15,8711
00940,元大台灣價值高息,531,30,501,陽信-石牌,2024-04-16,8711
00919,群益台灣精選高息,214,16,198,陽信-石牌,2024-04-16,8711
0056,元大高股息,151,27,124,陽信-石牌,2024-04-16,8711
00937B,群益ESG投等債20,97,0,97,陽信-石牌,2024-04-16,8711
2353,宏��,89,8,81,陽信-石牌,2024-04-16,8711
2303,聯電,90,12,78,陽信-石牌,2024-04-16,8711
2617,台航,77,0,77,陽信-石牌,2024-04-16,8711
00632R,元大台灣50反1,100,25,75,陽信-石牌,2024-04-16,8711
00931B,統一美債20年,72,0,72,陽信-石牌,2024-04-16,8711
2610,華航,72,0,72,陽信-石牌,2024-04-16,8711
00929,復華台灣科技優息,162,90,72,陽信-石牌,2024-04-16,8711
2027,大成鋼,72,2,70,陽信-石牌,2024-04-16,8711
2401,凌陽,70,2,68,陽信-石牌,2024-04-16,8711
1905,華紙,73,10,63,陽信-石牌,2024-04-16,8711
2344,華邦電,64,2,62,陽信-石牌,2024-04-16,8711
2618,長榮航,70,8,62,陽信-石牌,2024-04-16,8711
00941,中信上游半導體,66,5,61,陽信-石牌,2024-04-16,8711
1609,大亞,184,123,61,陽信-石牌,2024-04-16,8711
1802,台玻,58,1,57,陽信-石牌,2024-04-16,8711
9105,泰金寶-DR,57,0,57,陽信-石牌,2024-04-16,8711
3231,緯創,70,15,55,陽信-石牌,2024-04-16,8711
2845,遠東銀,55,0,55,陽信-石牌,2024-04-16,8711
1102,亞泥,50,0,50,陽信-石牌,2024-04-16,8711
6015,宏遠證,50,0,50,陽信-石牌,2024-04-16,8711
2317,鴻海,81,39,42,陽信-石牌,2024-04-16,8711
1229,聯華,42,0,42,陽信-石牌,2024-04-16,8711
00687B,國泰20年美債,40,0,40,陽信-石牌,2024-04-16,8711
00706L,期元大S＆P日圓正2,40,0,40,陽信-石牌,2024-04-16,8711
1722,台肥,40,0,40,陽信-石牌,2024-04-16,8711
2882,國泰金,44,4,40,陽信-石牌,2024-04-16,8711
2301,光寶科,44,5,39,陽信-石牌,2024-04-16,8711
1587,吉茂,44,10,34,陽信-石牌,2024-04-16,8711
2637,慧洋-KY,33,0,33,陽信-石牌,2024-04-16,8711
2886,兆豐金,33,0,33,陽信-石牌,2024-04-16,8711
2331,精英,30,0,30,陽信-石牌,2024-04-16,8711
5386,青雲,32,2,30,陽信-石牌,2024-04-16,8711
00939,統一台灣高息動能,29,0,29,陽信-石牌,2024-04-16,8711
2855,統一證,30,3,27,陽信-石牌,2024-04-16,8711
1513,中興電,69,42,27,陽信-石牌,2024-04-16,8711
00665L,富邦�琤肭磪囓�2,38,12,26,陽信-石牌,2024-04-16,8711
00751B,元大AAA至A公司債,21,0,21,陽信-石牌,2024-04-16,8711
2390,云辰,20,0,20,陽信-石牌,2024-04-16,8711
2405,輔信,45,25,20,陽信-石牌,2024-04-16,8711
2836,高雄銀,20,0,20,陽信-石牌,2024-04-16,8711
3631,晟楠,20,0,20,陽信-石牌,2024-04-16,8711
5512,力麒,20,0,20,陽信-石牌,2024-04-16,8711
2382,廣達,25,6,19,陽信-石牌,2024-04-16,8711
00713,元大台灣高息低波,19,0,19,陽信-石牌,2024-04-16,8711
2609,陽明,18,0,18,陽信-石牌,2024-04-16,8711
00720B,元大投資級公司債,18,0,18,陽信-石牌,2024-04-16,8711
00937B,群益ESG投等債20,346,140,206,陽信-石牌,2024-04-17,8711
00632R,元大台灣50反1,205,5,200,陽信-石牌,2024-04-17,8711
3231,緯創,160,24,136,陽信-石牌,2024-04-17,8711
00857B,永豐20年美公債,127,2,125,陽信-石牌,2024-04-17,8711
00931B,統一美債20年,91,0,91,陽信-石牌,2024-04-17,8711
1504,東元,144,54,90,陽信-石牌,2024-04-17,8711
00929,復華台灣科技優息,80,8,72,陽信-石牌,2024-04-17,8711
00940,元大台灣價值高息,130,60,70,陽信-石牌,2024-04-17,8711
2883,凱基金,70,0,70,陽信-石牌,2024-04-17,8711
0056,元大高股息,60,0,60,陽信-石牌,2024-04-17,8711
9105,泰金寶-DR,60,0,60,陽信-石牌,2024-04-17,8711
2881,富邦金,53,1,52,陽信-石牌,2024-04-17,8711
2867,三商壽,58,15,43,陽信-石牌,2024-04-17,8711
6770,力積電,54,12,42,陽信-石牌,2024-04-17,8711
00898,國泰基因免疫革命,40,0,40,陽信-石牌,2024-04-17,8711
2382,廣達,48,10,38,陽信-石牌,2024-04-17,8711
1229,聯華,31,0,31,陽信-石牌,2024-04-17,8711
2464,盟立,37,10,27,陽信-石牌,2024-04-17,8711
00751B,元大AAA至A公司債,25,0,25,陽信-石牌,2024-04-17,8711
2449,京元電子,26,1,25,陽信-石牌,2024-04-17,8711
00687B,國泰20年美債,24,0,24,陽信-石牌,2024-04-17,8711
2002,中鋼,23,0,23,陽信-石牌,2024-04-17,8711
2603,長榮,24,1,23,陽信-石牌,2024-04-17,8711
00919,群益台灣精選高息,45,23,22,陽信-石牌,2024-04-17,8711
2380,虹光,30,8,22,陽信-石牌,2024-04-17,8711
2618,長榮航,25,4,21,陽信-石牌,2024-04-17,8711
00891,中信關鍵半導體,20,0,20,陽信-石牌,2024-04-17,8711
2530,華建,20,0,20,陽信-石牌,2024-04-17,8711
2888,新光金,22,2,20,陽信-石牌,2024-04-17,8711
4157,太景*-KY,20,0,20,陽信-石牌,2024-04-17,8711
2409,友達,18,0,18,陽信-石牌,2024-04-17,8711
2891,中信金,20,2,18,陽信-石牌,2024-04-17,8711
2408,南亞科,23,5,18,陽信-石牌,2024-04-17,8711
00773B,中信優先金融債,16,0,16,陽信-石牌,2024-04-17,8711
00680L,元大美債20正2,16,0,16,陽信-石牌,2024-04-17,8711
2354,鴻準,33,17,16,陽信-石牌,2024-04-17,8711
3704,合勤控,16,0,16,陽信-石牌,2024-04-17,8711
2368,金像電,17,2,15,陽信-石牌,2024-04-17,8711
2534,宏盛,15,0,15,陽信-石牌,2024-04-17,8711
2882,國泰金,15,0,15,陽信-石牌,2024-04-17,8711
2356,英業達,26,12,14,陽信-石牌,2024-04-17,8711
00878,國泰永續高股息,14,1,13,陽信-石牌,2024-04-17,8711
2634,漢翔,13,0,13,陽信-石牌,2024-04-17,8711
2845,遠東銀,13,0,13,陽信-石牌,2024-04-17,8711
6290,良維,18,5,13,陽信-石牌,2024-04-17,8711
00688L,國泰20年美債正2,12,0,12,陽信-石牌,2024-04-17,8711
00725B,國泰投資級公司債,12,0,12,陽信-石牌,2024-04-17,8711
1455,集盛,12,0,12,陽信-石牌,2024-04-17,8711
2515,中工,12,0,12,陽信-石牌,2024-04-17,8711
00939,統一台灣高息動能,11,0,11,陽信-石牌,2024-04-17,8711
2371,大同,351,188,163,陽信-石牌,2024-04-18,8711
5230,雷笛克光學,160,11,149,陽信-石牌,2024-04-18,8711
3481,群創,120,2,118,陽信-石牌,2024-04-18,8711
0056,元大高股息,102,0,102,陽信-石牌,2024-04-18,8711
00929,復華台灣科技優息,91,4,87,陽信-石牌,2024-04-18,8711
1611,中電,113,31,82,陽信-石牌,2024-04-18,8711
00940,元大台灣價值高息,70,2,68,陽信-石牌,2024-04-18,8711
00937B,群益ESG投等債20,61,0,61,陽信-石牌,2024-04-18,8711
2102,泰豐,50,0,50,陽信-石牌,2024-04-18,8711
9105,泰金寶-DR,50,0,50,陽信-石牌,2024-04-18,8711
2634,漢翔,135,94,41,陽信-石牌,2024-04-18,8711
2605,新興,39,0,39,陽信-石牌,2024-04-18,8711
00941,中信上游半導體,38,1,37,陽信-石牌,2024-04-18,8711
00942B,台新美A公司債20+,35,0,35,陽信-石牌,2024-04-18,8711
6205,詮欣,32,0,32,陽信-石牌,2024-04-18,8711
1789,神隆,30,0,30,陽信-石牌,2024-04-18,8711
2617,台航,30,0,30,陽信-石牌,2024-04-18,8711
1229,聯華,29,0,29,陽信-石牌,2024-04-18,8711
2027,大成鋼,30,4,26,陽信-石牌,2024-04-18,8711
2344,華邦電,25,0,25,陽信-石牌,2024-04-18,8711
2365,昆盈,20,0,20,陽信-石牌,2024-04-18,8711
2515,中工,97,77,20,陽信-石牌,2024-04-18,8711
5876,上海商銀,20,0,20,陽信-石牌,2024-04-18,8711
2408,南亞科,19,0,19,陽信-石牌,2024-04-18,8711
1605,華新,71,53,18,陽信-石牌,2024-04-18,8711
1608,華榮,39,21,18,陽信-石牌,2024-04-18,8711
00680L,元大美債20正2,16,1,15,陽信-石牌,2024-04-18,8711
2637,慧洋-KY,15,0,15,陽信-石牌,2024-04-18,8711
6770,力積電,14,0,14,陽信-石牌,2024-04-18,8711
2353,宏��,13,0,13,陽信-石牌,2024-04-18,8711
3704,合勤控,13,0,13,陽信-石牌,2024-04-18,8711
1612,宏泰,27,15,12,陽信-石牌,2024-04-18,8711
2374,佳能,15,3,12,陽信-石牌,2024-04-18,8711
2409,友達,33,21,12,陽信-石牌,2024-04-18,8711
2330,台積電,14,4,10,陽信-石牌,2024-04-18,8711
00919,群益台灣精選高息,17,7,10,陽信-石牌,2024-04-18,8711
6147,頎邦,10,0,10,陽信-石牌,2024-04-18,8711
1103,嘉泥,10,0,10,陽信-石牌,2024-04-18,8711
00909,國泰數位支付服務,10,0,10,陽信-石牌,2024-04-18,8711
1455,集盛,10,0,10,陽信-石牌,2024-04-18,8711
1474,弘裕,10,0,10,陽信-石牌,2024-04-18,8711
2208,台船,10,0,10,陽信-石牌,2024-04-18,8711
2329,華泰,19,9,10,陽信-石牌,2024-04-18,8711
2332,友訊,10,0,10,陽信-石牌,2024-04-18,8711
2460,建通,10,0,10,陽信-石牌,2024-04-18,8711
2501,國建,35,25,10,陽信-石牌,2024-04-18,8711
2838,聯邦銀,10,0,10,陽信-石牌,2024-04-18,8711
3050,鈺德,10,0,10,陽信-石牌,2024-04-18,8711
3060,銘異,10,0,10,陽信-石牌,2024-04-18,8711
4562,穎漢,10,0,10,陽信-石牌,2024-04-18,8711
00929,復華台灣科技優息,417,14,403,陽信-石牌,2024-04-19,8711
1802,台玻,345,0,345,陽信-石牌,2024-04-19,8711
2515,中工,584,342,242,陽信-石牌,2024-04-19,8711
2330,台積電,193,4,189,陽信-石牌,2024-04-19,8711
1609,大亞,430,253,177,陽信-石牌,2024-04-19,8711
00919,群益台灣精選高息,148,8,140,陽信-石牌,2024-04-19,8711
2885,元大金,119,0,119,陽信-石牌,2024-04-19,8711
00940,元大台灣價值高息,225,138,87,陽信-石牌,2024-04-19,8711
2303,聯電,69,0,69,陽信-石牌,2024-04-19,8711
00713,元大台灣高息低波,66,0,66,陽信-石牌,2024-04-19,8711
2891,中信金,62,0,62,陽信-石牌,2024-04-19,8711
6244,茂迪,50,0,50,陽信-石牌,2024-04-19,8711
2405,輔信,42,0,42,陽信-石牌,2024-04-19,8711
00650L,復華香港正2,55,25,30,陽信-石牌,2024-04-19,8711
4306,炎洲,30,0,30,陽信-石牌,2024-04-19,8711
3231,緯創,63,33,30,陽信-石牌,2024-04-19,8711
1608,華榮,94,65,29,陽信-石牌,2024-04-19,8711
1612,宏泰,86,59,27,陽信-石牌,2024-04-19,8711
2367,燿華,37,10,27,陽信-石牌,2024-04-19,8711
2886,兆豐金,27,0,27,陽信-石牌,2024-04-19,8711
00665L,富邦�琤肭磪囓�2,44,18,26,陽信-石牌,2024-04-19,8711
00878,國泰永續高股息,27,2,25,陽信-石牌,2024-04-19,8711
00939,統一台灣高息動能,25,0,25,陽信-石牌,2024-04-19,8711
02001L,富邦蘋果正二N,24,0,24,陽信-石牌,2024-04-19,8711
2002,中鋼,26,2,24,陽信-石牌,2024-04-19,8711
3013,晟銘電,28,4,24,陽信-石牌,2024-04-19,8711
5512,力麒,55,31,24,陽信-石牌,2024-04-19,8711
6205,詮欣,23,0,23,陽信-石牌,2024-04-19,8711
2881,富邦金,22,0,22,陽信-石牌,2024-04-19,8711
2427,三商電,47,25,22,陽信-石牌,2024-04-19,8711
6196,帆宣,23,1,22,陽信-石牌,2024-04-19,8711
1229,聯華,21,0,21,陽信-石牌,2024-04-19,8711
2606,裕民,48,27,21,陽信-石牌,2024-04-19,8711
2317,鴻海,66,46,20,陽信-石牌,2024-04-19,8711
2409,友達,35,15,20,陽信-石牌,2024-04-19,8711
6163,華電網,20,0,20,陽信-石牌,2024-04-19,8711
2344,華邦電,28,9,19,陽信-石牌,2024-04-19,8711
1535,中宇,18,1,17,陽信-石牌,2024-04-19,8711
2324,仁寶,15,0,15,陽信-石牌,2024-04-19,8711
2547,日勝生,21,6,15,陽信-石牌,2024-04-19,8711
2867,三商壽,17,2,15,陽信-石牌,2024-04-19,8711
3484,崧騰,15,0,15,陽信-石牌,2024-04-19,8711
8927,北基,15,0,15,陽信-石牌,2024-04-19,8711
9902,台火,23,8,15,陽信-石牌,2024-04-19,8711
00715L,期街口布蘭特正2,27,13,14,陽信-石牌,2024-04-19,8711
1504,東元,42,28,14,陽信-石牌,2024-04-19,8711
2356,英業達,17,3,14,陽信-石牌,2024-04-19,8711
1603,華電,25,12,13,陽信-石牌,2024-04-19,8711
1712,興農,13,0,13,陽信-石牌,2024-04-19,8711
8033,雷虎,18,5,13,陽信-石牌,2024-04-19,8711
2303,聯電,155,7,148,陽信-石牌,2024-04-22,8711
2515,中工,294,150,144,陽信-石牌,2024-04-22,8711
00931B,統一美債20年,120,0,120,陽信-石牌,2024-04-22,8711
00929,復華台灣科技優息,172,67,105,陽信-石牌,2024-04-22,8711
1611,中電,101,5,96,陽信-石牌,2024-04-22,8711
1609,大亞,184,102,82,陽信-石牌,2024-04-22,8711
2367,燿華,82,20,62,陽信-石牌,2024-04-22,8711
3703,欣陸,78,20,58,陽信-石牌,2024-04-22,8711
1618,合機,62,5,57,陽信-石牌,2024-04-22,8711
2014,中鴻,52,0,52,陽信-石牌,2024-04-22,8711
2867,三商壽,50,0,50,陽信-石牌,2024-04-22,8711
9105,泰金寶-DR,50,0,50,陽信-石牌,2024-04-22,8711
00940,元大台灣價值高息,49,0,49,陽信-石牌,2024-04-22,8711
2634,漢翔,39,1,38,陽信-石牌,2024-04-22,8711
1102,亞泥,39,2,37,陽信-石牌,2024-04-22,8711
3231,緯創,61,25,36,陽信-石牌,2024-04-22,8711
8033,雷虎,46,12,34,陽信-石牌,2024-04-22,8711
2609,陽明,59,27,32,陽信-石牌,2024-04-22,8711
2356,英業達,47,17,30,陽信-石牌,2024-04-22,8711
00939,統一台灣高息動能,29,0,29,陽信-石牌,2024-04-22,8711
3032,偉訓,28,0,28,陽信-石牌,2024-04-22,8711
00857B,永豐20年美公債,26,0,26,陽信-石牌,2024-04-22,8711
1603,華電,25,0,25,陽信-石牌,2024-04-22,8711
2408,南亞科,27,2,25,陽信-石牌,2024-04-22,8711
2344,華邦電,33,10,23,陽信-石牌,2024-04-22,8711
5534,長虹,26,4,22,陽信-石牌,2024-04-22,8711
9902,台火,25,3,22,陽信-石牌,2024-04-22,8711
00688L,國泰20年美債正2,21,0,21,陽信-石牌,2024-04-22,8711
1215,卜蜂,20,0,20,陽信-石牌,2024-04-22,8711
2641,正德,20,0,20,陽信-石牌,2024-04-22,8711
1616,億泰,21,2,19,陽信-石牌,2024-04-22,8711
6233,旺玖,20,1,19,陽信-石牌,2024-04-22,8711
8054,安國,48,30,18,陽信-石牌,2024-04-22,8711
2371,大同,214,197,17,陽信-石牌,2024-04-22,8711
3017,奇鋐,24,7,17,陽信-石牌,2024-04-22,8711
00919,群益台灣精選高息,37,20,17,陽信-石牌,2024-04-22,8711
00673R,期元大S＆P原油反1,16,0,16,陽信-石牌,2024-04-22,8711
2538,基泰,25,10,15,陽信-石牌,2024-04-22,8711
2617,台航,20,5,15,陽信-石牌,2024-04-22,8711
2545,皇翔,20,6,14,陽信-石牌,2024-04-22,8711
4157,太景*-KY,13,0,13,陽信-石牌,2024-04-22,8711
00915,凱基優選高股息30,12,0,12,陽信-石牌,2024-04-22,8711
2329,華泰,12,0,12,陽信-石牌,2024-04-22,8711
1515,力山,21,10,11,陽信-石牌,2024-04-22,8711
4526,東台,11,0,11,陽信-石牌,2024-04-22,8711
00671R,富邦NASDAQ反1,10,0,10,陽信-石牌,2024-04-22,8711
00669R,國泰美國道瓊反1,10,0,10,陽信-石牌,2024-04-22,8711
00751B,元大AAA至A公司債,10,0,10,陽信-石牌,2024-04-22,8711
1733,五鼎,11,1,10,陽信-石牌,2024-04-22,8711
1810,和成,10,0,10,陽信-石牌,2024-04-22,8711
2371,大同,211,93,118,陽信-石牌,2024-04-23,8711
3024,憶聲,52,0,52,陽信-石牌,2024-04-23,8711
00941,中信上游半導體,51,0,51,陽信-石牌,2024-04-23,8711
2610,華航,65,15,50,陽信-石牌,2024-04-23,8711
3707,漢磊,49,0,49,陽信-石牌,2024-04-23,8711
2515,中工,191,145,46,陽信-石牌,2024-04-23,8711
4127,天良,40,0,40,陽信-石牌,2024-04-23,8711
1725,元禎,42,3,39,陽信-石牌,2024-04-23,8711
00937B,群益ESG投等債20,35,0,35,陽信-石牌,2024-04-23,8711
00632R,元大台灣50反1,55,20,35,陽信-石牌,2024-04-23,8711
00706L,期元大S＆P日圓正2,30,0,30,陽信-石牌,2024-04-23,8711
1515,力山,30,0,30,陽信-石牌,2024-04-23,8711
2031,新光鋼,30,0,30,陽信-石牌,2024-04-23,8711
3481,群創,54,25,29,陽信-石牌,2024-04-23,8711
5324,士開,22,0,22,陽信-石牌,2024-04-23,8711
6213,聯茂,21,1,20,陽信-石牌,2024-04-23,8711
1587,吉茂,20,1,19,陽信-石牌,2024-04-23,8711
2382,廣達,27,9,18,陽信-石牌,2024-04-23,8711
2367,燿華,88,71,17,陽信-石牌,2024-04-23,8711
00715L,期街口布蘭特正2,16,0,16,陽信-石牌,2024-04-23,8711
4157,太景*-KY,15,0,15,陽信-石牌,2024-04-23,8711
00929,復華台灣科技優息,18,4,14,陽信-石牌,2024-04-23,8711
00919,群益台灣精選高息,13,0,13,陽信-石牌,2024-04-23,8711
3015,全漢,13,0,13,陽信-石牌,2024-04-23,8711
4726,永昕,17,4,13,陽信-石牌,2024-04-23,8711
2303,聯電,17,5,12,陽信-石牌,2024-04-23,8711
6768,志強-KY,12,0,12,陽信-石牌,2024-04-23,8711
1314,中石化,12,1,11,陽信-石牌,2024-04-23,8711
2885,元大金,11,0,11,陽信-石牌,2024-04-23,8711
00651R,復華香港反1,10,0,10,陽信-石牌,2024-04-23,8711
00923,群益台ESG低碳50,10,0,10,陽信-石牌,2024-04-23,8711
1409,新纖,10,0,10,陽信-石牌,2024-04-23,8711
1504,東元,24,14,10,陽信-石牌,2024-04-23,8711
1616,億泰,10,0,10,陽信-石牌,2024-04-23,8711
2506,太設,30,20,10,陽信-石牌,2024-04-23,8711
2704,國賓,10,0,10,陽信-石牌,2024-04-23,8711
3441,聯一光,10,0,10,陽信-石牌,2024-04-23,8711
5512,力麒,17,7,10,陽信-石牌,2024-04-23,8711
6438,迅得,10,0,10,陽信-石牌,2024-04-23,8711
00940,元大台灣價值高息,22,12,10,陽信-石牌,2024-04-23,8711
2354,鴻準,22,13,9,陽信-石牌,2024-04-23,8711
1529,樂事綠能,14,5,9,陽信-石牌,2024-04-23,8711
1603,華電,10,1,9,陽信-石牌,2024-04-23,8711
2883,凱基金,10,1,9,陽信-石牌,2024-04-23,8711
9902,台火,9,0,9,陽信-石牌,2024-04-23,8711
2349,錸德,13,5,8,陽信-石牌,2024-04-23,8711
2889,國票金,8,0,8,陽信-石牌,2024-04-23,8711
4123,晟德,10,2,8,陽信-石牌,2024-04-23,8711
6120,達運,17,10,7,陽信-石牌,2024-04-23,8711
6125,廣運,23,16,7,陽信-石牌,2024-04-23,8711
00937B,群益ESG投等債20,185,0,185,陽信-石牌,2024-04-24,8711
00931B,統一美債20年,170,0,170,陽信-石牌,2024-04-24,8711
00893,國泰智能電動車,103,0,103,陽信-石牌,2024-04-24,8711
1609,大亞,249,163,86,陽信-石牌,2024-04-24,8711
2049,上銀,81,0,81,陽信-石牌,2024-04-24,8711
00919,群益台灣精選高息,69,1,68,陽信-石牌,2024-04-24,8711
2371,大同,594,528,66,陽信-石牌,2024-04-24,8711
2886,兆豐金,65,0,65,陽信-石牌,2024-04-24,8711
1802,台玻,50,0,50,陽信-石牌,2024-04-24,8711
2606,裕民,50,0,50,陽信-石牌,2024-04-24,8711
2887,台新金,41,0,41,陽信-石牌,2024-04-24,8711
1905,華紙,50,10,40,陽信-石牌,2024-04-24,8711
2102,泰豐,50,10,40,陽信-石牌,2024-04-24,8711
2845,遠東銀,40,0,40,陽信-石牌,2024-04-24,8711
2382,廣達,74,35,39,陽信-石牌,2024-04-24,8711
00674R,期元大S＆P黃金反1,33,0,33,陽信-石牌,2024-04-24,8711
1618,合機,64,31,33,陽信-石牌,2024-04-24,8711
00751B,元大AAA至A公司債,31,0,31,陽信-石牌,2024-04-24,8711
2890,永豐金,30,0,30,陽信-石牌,2024-04-24,8711
5324,士開,30,0,30,陽信-石牌,2024-04-24,8711
6192,巨路,27,0,27,陽信-石牌,2024-04-24,8711
3703,欣陸,35,11,24,陽信-石牌,2024-04-24,8711
1215,卜蜂,20,0,20,陽信-石牌,2024-04-24,8711
2031,新光鋼,20,0,20,陽信-石牌,2024-04-24,8711
00687B,國泰20年美債,23,4,19,陽信-石牌,2024-04-24,8711
2634,漢翔,20,1,19,陽信-石牌,2024-04-24,8711
2501,國建,40,24,16,陽信-石牌,2024-04-24,8711
5531,鄉林,16,1,15,陽信-石牌,2024-04-24,8711
1608,華榮,34,21,13,陽信-石牌,2024-04-24,8711
3707,漢磊,13,0,13,陽信-石牌,2024-04-24,8711
3715,定穎投控,21,8,13,陽信-石牌,2024-04-24,8711
8033,雷虎,20,7,13,陽信-石牌,2024-04-24,8711
2206,三陽工業,45,33,12,陽信-石牌,2024-04-24,8711
00773B,中信優先金融債,11,0,11,陽信-石牌,2024-04-24,8711
5388,中磊,11,0,11,陽信-石牌,2024-04-24,8711
9939,宏全,11,0,11,陽信-石牌,2024-04-24,8711
1101,台泥,10,0,10,陽信-石牌,2024-04-24,8711
00651R,復華香港反1,10,0,10,陽信-石牌,2024-04-24,8711
2534,宏盛,10,0,10,陽信-石牌,2024-04-24,8711
2538,基泰,10,0,10,陽信-石牌,2024-04-24,8711
3035,智原,12,2,10,陽信-石牌,2024-04-24,8711
3376,新日興,10,0,10,陽信-石牌,2024-04-24,8711
3605,宏致,10,0,10,陽信-石牌,2024-04-24,8711
4532,瑞智,14,4,10,陽信-石牌,2024-04-24,8711
8104,錸寶,10,0,10,陽信-石牌,2024-04-24,8711
8112,至上,12,2,10,陽信-石牌,2024-04-24,8711
6125,廣運,24,15,9,陽信-石牌,2024-04-24,8711
3711,日月光投控,9,0,9,陽信-石牌,2024-04-24,8711
1605,華新,8,0,8,陽信-石牌,2024-04-24,8711
2504,國產,17,9,8,陽信-石牌,2024-04-24,8711
00937B,群益ESG投等債20,134,0,134,陽信-石牌,2024-04-25,8711
00720B,元大投資級公司債,100,0,100,陽信-石牌,2024-04-25,8711
2887,台新金,100,0,100,陽信-石牌,2024-04-25,8711
2610,華航,106,11,95,陽信-石牌,2024-04-25,8711
3357,臺慶科,57,0,57,陽信-石牌,2024-04-25,8711
2801,彰銀,54,0,54,陽信-石牌,2024-04-25,8711
2371,大同,307,254,53,陽信-石牌,2024-04-25,8711
2881,富邦金,50,0,50,陽信-石牌,2024-04-25,8711
00929,復華台灣科技優息,38,1,37,陽信-石牌,2024-04-25,8711
2317,鴻海,41,6,35,陽信-石牌,2024-04-25,8711
2241,艾姆勒,33,1,32,陽信-石牌,2024-04-25,8711
2331,精英,31,0,31,陽信-石牌,2024-04-25,8711
00940,元大台灣價值高息,28,0,28,陽信-石牌,2024-04-25,8711
2618,長榮航,65,41,24,陽信-石牌,2024-04-25,8711
00857B,永豐20年美公債,21,0,21,陽信-石牌,2024-04-25,8711
3188,鑫龍騰,21,0,21,陽信-石牌,2024-04-25,8711
00753L,中信中國50正2,20,0,20,陽信-石牌,2024-04-25,8711
2885,元大金,20,0,20,陽信-石牌,2024-04-25,8711
6235,華孚,20,0,20,陽信-石牌,2024-04-25,8711
2382,廣達,42,23,19,陽信-石牌,2024-04-25,8711
2367,燿華,35,16,19,陽信-石牌,2024-04-25,8711
2303,聯電,34,16,18,陽信-石牌,2024-04-25,8711
4562,穎漢,22,4,18,陽信-石牌,2024-04-25,8711
4716,大立,32,14,18,陽信-石牌,2024-04-25,8711
6548,長科*,21,3,18,陽信-石牌,2024-04-25,8711
1905,華紙,22,5,17,陽信-石牌,2024-04-25,8711
2201,裕隆,19,2,17,陽信-石牌,2024-04-25,8711
8996,高力,22,5,17,陽信-石牌,2024-04-25,8711
00651R,復華香港反1,15,0,15,陽信-石牌,2024-04-25,8711
00751B,元大AAA至A公司債,15,0,15,陽信-石牌,2024-04-25,8711
1584,精剛,25,10,15,陽信-石牌,2024-04-25,8711
00715L,期街口布蘭特正2,16,2,14,陽信-石牌,2024-04-25,8711
00933B,國泰10Y+金融債,14,0,14,陽信-石牌,2024-04-25,8711
8404,百和興業-KY,14,0,14,陽信-石牌,2024-04-25,8711
00878,國泰永續高股息,15,1,14,陽信-石牌,2024-04-25,8711
00687B,國泰20年美債,13,0,13,陽信-石牌,2024-04-25,8711
00919,群益台灣精選高息,13,0,13,陽信-石牌,2024-04-25,8711
2359,所羅門,14,1,13,陽信-石牌,2024-04-25,8711
6141,柏承,13,0,13,陽信-石牌,2024-04-25,8711
8234,新漢,13,0,13,陽信-石牌,2024-04-25,8711
0050,元大台灣50,13,1,12,陽信-石牌,2024-04-25,8711
1440,南紡,19,7,12,陽信-石牌,2024-04-25,8711
3035,智原,17,5,12,陽信-石牌,2024-04-25,8711
6177,達麗,18,6,12,陽信-石牌,2024-04-25,8711
2883,凱基金,11,0,11,陽信-石牌,2024-04-25,8711
4958,臻鼎-KY,11,0,11,陽信-石牌,2024-04-25,8711
2330,台積電,12,1,11,陽信-石牌,2024-04-25,8711
2414,精技,10,0,10,陽信-石牌,2024-04-25,8711
2913,農林,10,0,10,陽信-石牌,2024-04-25,8711
3105,穩懋,10,0,10,陽信-石牌,2024-04-25,8711
2641,正德,213,2,211,陽信-石牌,2024-04-26,8711
00937B,群益ESG投等債20,165,6,159,陽信-石牌,2024-04-26,8711
00706L,期元大S＆P日圓正2,72,0,72,陽信-石牌,2024-04-26,8711
1440,南紡,144,100,44,陽信-石牌,2024-04-26,8711
3481,群創,50,6,44,陽信-石牌,2024-04-26,8711
00931B,統一美債20年,42,0,42,陽信-石牌,2024-04-26,8711
00898,國泰基因免疫革命,40,0,40,陽信-石牌,2024-04-26,8711
8027,鈦昇,39,0,39,陽信-石牌,2024-04-26,8711
8473,山林水,36,0,36,陽信-石牌,2024-04-26,8711
00679B,元大美債20年,34,0,34,陽信-石牌,2024-04-26,8711
2888,新光金,40,8,32,陽信-石牌,2024-04-26,8711
9945,潤泰新,30,0,30,陽信-石牌,2024-04-26,8711
2363,矽統,31,4,27,陽信-石牌,2024-04-26,8711
2367,燿華,37,15,22,陽信-石牌,2024-04-26,8711
00650L,復華香港正2,56,36,20,陽信-石牌,2024-04-26,8711
00665L,富邦�琤肭磪囓�2,74,54,20,陽信-石牌,2024-04-26,8711
2006,東和鋼鐵,20,0,20,陽信-石牌,2024-04-26,8711
5525,順天,20,3,17,陽信-石牌,2024-04-26,8711
8033,雷虎,17,0,17,陽信-石牌,2024-04-26,8711
00773B,中信優先金融債,16,0,16,陽信-石牌,2024-04-26,8711
4562,穎漢,23,7,16,陽信-石牌,2024-04-26,8711
2359,所羅門,27,12,15,陽信-石牌,2024-04-26,8711
00651R,復華香港反1,15,0,15,陽信-石牌,2024-04-26,8711
00751B,元大AAA至A公司債,15,0,15,陽信-石牌,2024-04-26,8711
3047,訊舟,15,0,15,陽信-石牌,2024-04-26,8711
3702,大聯大,15,0,15,陽信-石牌,2024-04-26,8711
2356,英業達,20,6,14,陽信-石牌,2024-04-26,8711
3044,健鼎,14,0,14,陽信-石牌,2024-04-26,8711
3706,神達,16,2,14,陽信-石牌,2024-04-26,8711
2505,國揚,16,3,13,陽信-石牌,2024-04-26,8711
2630,亞航,13,1,12,陽信-石牌,2024-04-26,8711
00687B,國泰20年美債,12,0,12,陽信-石牌,2024-04-26,8711
1584,精剛,12,0,12,陽信-石牌,2024-04-26,8711
3059,華晶科,11,0,11,陽信-石牌,2024-04-26,8711
00664R,國泰臺灣加權反1,10,0,10,陽信-石牌,2024-04-26,8711
00725B,國泰投資級公司債,10,0,10,陽信-石牌,2024-04-26,8711
2634,漢翔,16,6,10,陽信-石牌,2024-04-26,8711
2845,遠東銀,10,0,10,陽信-石牌,2024-04-26,8711
3037,欣興,10,0,10,陽信-石牌,2024-04-26,8711
3078,僑威,10,0,10,陽信-石牌,2024-04-26,8711
4967,十銓,27,17,10,陽信-石牌,2024-04-26,8711
5533,皇鼎,10,0,10,陽信-石牌,2024-04-26,8711
00909,國泰數位支付服務,9,0,9,陽信-石牌,2024-04-26,8711
00688L,國泰20年美債正2,9,0,9,陽信-石牌,2024-04-26,8711
1457,宜進,10,1,9,陽信-石牌,2024-04-26,8711
6190,萬泰科,10,1,9,陽信-石牌,2024-04-26,8711
6266,泰詠,9,0,9,陽信-石牌,2024-04-26,8711
6547,高端疫苗,9,0,9,陽信-石牌,2024-04-26,8711
9904,寶成,20,11,9,陽信-石牌,2024-04-26,8711
6116,彩晶,10,1,9,陽信-石牌,2024-04-26,8711
2374,佳能,127,4,123,陽信-石牌,2024-04-29,8711
2371,大同,179,97,82,陽信-石牌,2024-04-29,8711
00632R,元大台灣50反1,60,0,60,陽信-石牌,2024-04-29,8711
2547,日勝生,57,0,57,陽信-石牌,2024-04-29,8711
2610,華航,84,29,55,陽信-石牌,2024-04-29,8711
2516,新建,48,0,48,陽信-石牌,2024-04-29,8711
4157,太景*-KY,45,0,45,陽信-石牌,2024-04-29,8711
00929,復華台灣科技優息,45,5,40,陽信-石牌,2024-04-29,8711
2363,矽統,68,37,31,陽信-石牌,2024-04-29,8711
3483,力致,61,30,31,陽信-石牌,2024-04-29,8711
2883,凱基金,75,46,29,陽信-石牌,2024-04-29,8711
2101,南港,57,30,27,陽信-石牌,2024-04-29,8711
00919,群益台灣精選高息,54,30,24,陽信-石牌,2024-04-29,8711
2367,燿華,30,6,24,陽信-石牌,2024-04-29,8711
6190,萬泰科,22,0,22,陽信-石牌,2024-04-29,8711
5426,振發,21,0,21,陽信-石牌,2024-04-29,8711
00882,中信中國高股息,21,5,16,陽信-石牌,2024-04-29,8711
00751B,元大AAA至A公司債,15,0,15,陽信-石牌,2024-04-29,8711
3264,欣銓,27,12,15,陽信-石牌,2024-04-29,8711
2356,英業達,52,38,14,陽信-石牌,2024-04-29,8711
6215,和椿,29,15,14,陽信-石牌,2024-04-29,8711
2542,興富發,15,3,12,陽信-石牌,2024-04-29,8711
5534,長虹,20,9,11,陽信-石牌,2024-04-29,8711
00933B,國泰10Y+金融債,10,0,10,陽信-石牌,2024-04-29,8711
00650L,復華香港正2,68,58,10,陽信-石牌,2024-04-29,8711
2421,建準,23,13,10,陽信-石牌,2024-04-29,8711
2460,建通,10,0,10,陽信-石牌,2024-04-29,8711
2743,山富,15,5,10,陽信-石牌,2024-04-29,8711
5533,皇鼎,10,0,10,陽信-石牌,2024-04-29,8711
6015,宏遠證,18,8,10,陽信-石牌,2024-04-29,8711
6016,康和證,10,0,10,陽信-石牌,2024-04-29,8711
6026,福邦證,10,0,10,陽信-石牌,2024-04-29,8711
8234,新漢,10,0,10,陽信-石牌,2024-04-29,8711
9919,康那香,10,0,10,陽信-石牌,2024-04-29,8711
3056,富華新,10,1,9,陽信-石牌,2024-04-29,8711
2359,所羅門,11,2,9,陽信-石牌,2024-04-29,8711
1103,嘉泥,9,0,9,陽信-石牌,2024-04-29,8711
9945,潤泰新,14,5,9,陽信-石牌,2024-04-29,8711
3707,漢磊,13,5,8,陽信-石牌,2024-04-29,8711
4532,瑞智,18,10,8,陽信-石牌,2024-04-29,8711
8064,東捷,12,4,8,陽信-石牌,2024-04-29,8711
3035,智原,11,4,7,陽信-石牌,2024-04-29,8711
00687B,國泰20年美債,7,0,7,陽信-石牌,2024-04-29,8711
5230,雷笛克光學,8,1,7,陽信-石牌,2024-04-29,8711
5439,高技,9,2,7,陽信-石牌,2024-04-29,8711
6257,矽格,7,0,7,陽信-石牌,2024-04-29,8711
2301,光寶科,12,6,6,陽信-石牌,2024-04-29,8711
2313,華通,18,12,6,陽信-石牌,2024-04-29,8711
2409,友達,28,22,6,陽信-石牌,2024-04-29,8711
3027,盛達,6,0,6,陽信-石牌,2024-04-29,8711
2515,中工,259,134,125,陽信-石牌,2024-04-30,8711
1314,中石化,143,22,121,陽信-石牌,2024-04-30,8711
1722,台肥,60,0,60,陽信-石牌,2024-04-30,8711
00929,復華台灣科技優息,55,1,54,陽信-石牌,2024-04-30,8711
2344,華邦電,55,1,54,陽信-石牌,2024-04-30,8711
2885,元大金,31,0,31,陽信-石牌,2024-04-30,8711
00713,元大台灣高息低波,28,0,28,陽信-石牌,2024-04-30,8711
2888,新光金,51,24,27,陽信-石牌,2024-04-30,8711
3234,光環,28,1,27,陽信-石牌,2024-04-30,8711
5009,榮剛,32,6,26,陽信-石牌,2024-04-30,8711
6190,萬泰科,28,2,26,陽信-石牌,2024-04-30,8711
1618,合機,29,7,22,陽信-石牌,2024-04-30,8711
1215,卜蜂,20,0,20,陽信-石牌,2024-04-30,8711
2485,兆赫,20,0,20,陽信-石牌,2024-04-30,8711
2886,兆豐金,20,0,20,陽信-石牌,2024-04-30,8711
2317,鴻海,38,18,20,陽信-石牌,2024-04-30,8711
1101,台泥,18,0,18,陽信-石牌,2024-04-30,8711
3481,群創,20,3,17,陽信-石牌,2024-04-30,8711
1905,華紙,32,15,17,陽信-石牌,2024-04-30,8711
2637,慧洋-KY,15,0,15,陽信-石牌,2024-04-30,8711
2609,陽明,19,6,13,陽信-石牌,2024-04-30,8711
1504,東元,21,8,13,陽信-石牌,2024-04-30,8711
1725,元禎,23,10,13,陽信-石牌,2024-04-30,8711
2355,敬鵬,24,12,12,陽信-石牌,2024-04-30,8711
2537,聯上發,13,2,11,陽信-石牌,2024-04-30,8711
4127,天良,12,1,11,陽信-石牌,2024-04-30,8711
8103,瀚荃,11,0,11,陽信-石牌,2024-04-30,8711
00665L,富邦�琤肭磪囓�2,22,12,10,陽信-石牌,2024-04-30,8711
1455,集盛,18,8,10,陽信-石牌,2024-04-30,8711
1762,中化生,10,0,10,陽信-石牌,2024-04-30,8711
2301,光寶科,10,0,10,陽信-石牌,2024-04-30,8711
2520,冠德,53,43,10,陽信-石牌,2024-04-30,8711
2540,愛山林,10,0,10,陽信-石牌,2024-04-30,8711
3520,華盈,10,0,10,陽信-石牌,2024-04-30,8711
4726,永昕,10,0,10,陽信-石牌,2024-04-30,8711
5534,長虹,16,6,10,陽信-石牌,2024-04-30,8711
6552,易華電,10,0,10,陽信-石牌,2024-04-30,8711
2374,佳能,12,3,9,陽信-石牌,2024-04-30,8711
6451,訊芯-KY,11,2,9,陽信-石牌,2024-04-30,8711
1587,吉茂,12,3,9,陽信-石牌,2024-04-30,8711
2104,國際中橡,8,0,8,陽信-石牌,2024-04-30,8711
2353,宏��,9,1,8,陽信-石牌,2024-04-30,8711
3512,皇龍,13,5,8,陽信-石牌,2024-04-30,8711
3706,神達,15,7,8,陽信-石牌,2024-04-30,8711
6547,高端疫苗,8,0,8,陽信-石牌,2024-04-30,8711
2887,台新金,7,0,7,陽信-石牌,2024-04-30,8711
1605,華新,7,0,7,陽信-石牌,2024-04-30,8711
2913,農林,13,6,7,陽信-石牌,2024-04-30,8711
5426,振發,6,0,6,陽信-石牌,2024-04-30,8711
1522,堤維西,6,0,6,陽信-石牌,2024-04-30,8711
00632R,元大台灣50反1,1300,0,1300,陽信-石牌,2024-05-02,8711
00937B,群益ESG投等債20,175,0,175,陽信-石牌,2024-05-02,8711
9105,泰金寶-DR,151,7,144,陽信-石牌,2024-05-02,8711
1440,南紡,66,4,62,陽信-石牌,2024-05-02,8711
00878,國泰永續高股息,55,0,55,陽信-石牌,2024-05-02,8711
1314,中石化,59,6,53,陽信-石牌,2024-05-02,8711
00715L,期街口布蘭特正2,52,0,52,陽信-石牌,2024-05-02,8711
6244,茂迪,50,0,50,陽信-石牌,2024-05-02,8711
5009,榮剛,51,17,34,陽信-石牌,2024-05-02,8711
3041,揚智,30,1,29,陽信-石牌,2024-05-02,8711
00725B,國泰投資級公司債,30,2,28,陽信-石牌,2024-05-02,8711
1789,神隆,28,0,28,陽信-石牌,2024-05-02,8711
2885,元大金,29,1,28,陽信-石牌,2024-05-02,8711
2316,楠梓電,29,3,26,陽信-石牌,2024-05-02,8711
2538,基泰,25,0,25,陽信-石牌,2024-05-02,8711
2883,凱基金,35,10,25,陽信-石牌,2024-05-02,8711
4526,東台,25,0,25,陽信-石牌,2024-05-02,8711
3645,達邁,25,1,24,陽信-石牌,2024-05-02,8711
3021,鴻名,23,0,23,陽信-石牌,2024-05-02,8711
9945,潤泰新,35,12,23,陽信-石牌,2024-05-02,8711
2317,鴻海,43,21,22,陽信-石牌,2024-05-02,8711
00929,復華台灣科技優息,22,1,21,陽信-石牌,2024-05-02,8711
2371,大同,193,173,20,陽信-石牌,2024-05-02,8711
6264,富裔,20,1,19,陽信-石牌,2024-05-02,8711
1584,精剛,20,3,17,陽信-石牌,2024-05-02,8711
5525,順天,17,0,17,陽信-石牌,2024-05-02,8711
2330,台積電,17,1,16,陽信-石牌,2024-05-02,8711
2303,聯電,17,1,16,陽信-石牌,2024-05-02,8711
2409,友達,50,34,16,陽信-石牌,2024-05-02,8711
2501,國建,29,13,16,陽信-石牌,2024-05-02,8711
3483,力致,13,0,13,陽信-石牌,2024-05-02,8711
00651R,復華香港反1,12,0,12,陽信-石牌,2024-05-02,8711
00679B,元大美債20年,12,0,12,陽信-石牌,2024-05-02,8711
1612,宏泰,13,1,12,陽信-石牌,2024-05-02,8711
1725,元禎,12,0,12,陽信-石牌,2024-05-02,8711
2353,宏��,13,1,12,陽信-石牌,2024-05-02,8711
2609,陽明,28,17,11,陽信-石牌,2024-05-02,8711
00751B,元大AAA至A公司債,11,0,11,陽信-石牌,2024-05-02,8711
2882,國泰金,21,10,11,陽信-石牌,2024-05-02,8711
00909,國泰數位支付服務,10,0,10,陽信-石牌,2024-05-02,8711
00770,國泰北美科技,10,0,10,陽信-石牌,2024-05-02,8711
00687B,國泰20年美債,10,0,10,陽信-石牌,2024-05-02,8711
1215,卜蜂,10,0,10,陽信-石牌,2024-05-02,8711
2023,燁輝,10,0,10,陽信-石牌,2024-05-02,8711
2489,瑞軒,10,0,10,陽信-石牌,2024-05-02,8711
3049,精金,10,0,10,陽信-石牌,2024-05-02,8711
5457,宣德,10,0,10,陽信-石牌,2024-05-02,8711
6269,台郡,25,15,10,陽信-石牌,2024-05-02,8711
6743,安普新,10,0,10,陽信-石牌,2024-05-02,8711
2884,玉山金,10,0,10,陽信-石牌,2024-05-02,8711
00937B,群益ESG投等債20,227,25,202,陽信-石牌,2024-05-03,8711
2610,華航,90,13,77,陽信-石牌,2024-05-03,8711
5531,鄉林,79,2,77,陽信-石牌,2024-05-03,8711
2101,南港,82,32,50,陽信-石牌,2024-05-03,8711
2886,兆豐金,45,0,45,陽信-石牌,2024-05-03,8711
4114,健喬,41,0,41,陽信-石牌,2024-05-03,8711
6120,達運,41,0,41,陽信-石牌,2024-05-03,8711
3231,緯創,46,6,40,陽信-石牌,2024-05-03,8711
2344,華邦電,37,0,37,陽信-石牌,2024-05-03,8711
5324,士開,35,0,35,陽信-石牌,2024-05-03,8711
2102,泰豐,30,0,30,陽信-石牌,2024-05-03,8711
6290,良維,28,2,26,陽信-石牌,2024-05-03,8711
8033,雷虎,27,1,26,陽信-石牌,2024-05-03,8711
3615,安可,25,0,25,陽信-石牌,2024-05-03,8711
1714,和桐,24,0,24,陽信-石牌,2024-05-03,8711
5009,榮剛,24,0,24,陽信-石牌,2024-05-03,8711
2014,中鴻,22,0,22,陽信-石牌,2024-05-03,8711
2534,宏盛,31,9,22,陽信-石牌,2024-05-03,8711
1815,富喬,22,2,20,陽信-石牌,2024-05-03,8711
2461,光群雷,20,0,20,陽信-石牌,2024-05-03,8711
4157,太景*-KY,20,0,20,陽信-石牌,2024-05-03,8711
4714,永捷,28,8,20,陽信-石牌,2024-05-03,8711
1514,亞力,20,1,19,陽信-石牌,2024-05-03,8711
6190,萬泰科,20,1,19,陽信-石牌,2024-05-03,8711
1608,華榮,26,8,18,陽信-石牌,2024-05-03,8711
00680L,元大美債20正2,17,0,17,陽信-石牌,2024-05-03,8711
5512,力麒,64,47,17,陽信-石牌,2024-05-03,8711
2634,漢翔,16,0,16,陽信-石牌,2024-05-03,8711
3312,弘憶股,16,0,16,陽信-石牌,2024-05-03,8711
2501,國建,31,16,15,陽信-石牌,2024-05-03,8711
00929,復華台灣科技優息,15,0,15,陽信-石牌,2024-05-03,8711
00885,富邦越南,20,5,15,陽信-石牌,2024-05-03,8711
00878,國泰永續高股息,16,2,14,陽信-石牌,2024-05-03,8711
1603,華電,16,2,14,陽信-石牌,2024-05-03,8711
8112,至上,17,3,14,陽信-石牌,2024-05-03,8711
00941,中信上游半導體,13,0,13,陽信-石牌,2024-05-03,8711
6026,福邦證,13,0,13,陽信-石牌,2024-05-03,8711
6443,元晶,14,1,13,陽信-石牌,2024-05-03,8711
6770,力積電,56,43,13,陽信-石牌,2024-05-03,8711
00857B,永豐20年美公債,12,0,12,陽信-石牌,2024-05-03,8711
2885,元大金,32,20,12,陽信-石牌,2024-05-03,8711
2383,台光電,12,0,12,陽信-石牌,2024-05-03,8711
3234,光環,14,3,11,陽信-石牌,2024-05-03,8711
3264,欣銓,11,0,11,陽信-石牌,2024-05-03,8711
6113,亞矽,14,3,11,陽信-石牌,2024-05-03,8711
6278,台表科,11,0,11,陽信-石牌,2024-05-03,8711
1301,台塑,11,1,10,陽信-石牌,2024-05-03,8711
00671R,富邦NASDAQ反1,10,0,10,陽信-石牌,2024-05-03,8711
00923,群益台ESG低碳50,10,0,10,陽信-石牌,2024-05-03,8711
1474,弘裕,10,0,10,陽信-石牌,2024-05-03,8711
3033,威健,210,9,201,陽信-石牌,2024-05-06,8711
2888,新光金,146,45,101,陽信-石牌,2024-05-06,8711
00945B,凱基美國非投等債,141,56,85,陽信-石牌,2024-05-06,8711
6451,訊芯-KY,55,4,51,陽信-石牌,2024-05-06,8711
2241,艾姆勒,50,0,50,陽信-石牌,2024-05-06,8711
2542,興富發,51,10,41,陽信-石牌,2024-05-06,8711
6770,力積電,52,11,41,陽信-石牌,2024-05-06,8711
2014,中鴻,40,0,40,陽信-石牌,2024-05-06,8711
00731,復華富時高息低波,38,0,38,陽信-石牌,2024-05-06,8711
2891,中信金,40,5,35,陽信-石牌,2024-05-06,8711
00940,元大台灣價值高息,33,0,33,陽信-石牌,2024-05-06,8711
2371,大同,60,28,32,陽信-石牌,2024-05-06,8711
1815,富喬,30,0,30,陽信-石牌,2024-05-06,8711
2884,玉山金,52,22,30,陽信-石牌,2024-05-06,8711
9933,中鼎,33,5,28,陽信-石牌,2024-05-06,8711
2449,京元電子,32,5,27,陽信-石牌,2024-05-06,8711
2363,矽統,54,29,25,陽信-石牌,2024-05-06,8711
3060,銘異,30,9,21,陽信-石牌,2024-05-06,8711
00929,復華台灣科技優息,29,8,21,陽信-石牌,2024-05-06,8711
4157,太景*-KY,20,0,20,陽信-石牌,2024-05-06,8711
2605,新興,19,0,19,陽信-石牌,2024-05-06,8711
2356,英業達,25,6,19,陽信-石牌,2024-05-06,8711
0050,元大台灣50,20,1,19,陽信-石牌,2024-05-06,8711
2488,漢平,20,2,18,陽信-石牌,2024-05-06,8711
6179,亞通,18,0,18,陽信-石牌,2024-05-06,8711
1314,中石化,32,16,16,陽信-石牌,2024-05-06,8711
2610,華航,51,35,16,陽信-石牌,2024-05-06,8711
6257,矽格,18,2,16,陽信-石牌,2024-05-06,8711
2515,中工,17,2,15,陽信-石牌,2024-05-06,8711
1316,上曜,18,4,14,陽信-石牌,2024-05-06,8711
00715L,期街口布蘭特正2,11,0,11,陽信-石牌,2024-05-06,8711
3090,日電貿,11,0,11,陽信-石牌,2024-05-06,8711
00882,中信中國高股息,12,2,10,陽信-石牌,2024-05-06,8711
00680L,元大美債20正2,10,0,10,陽信-石牌,2024-05-06,8711
1444,力麗,10,0,10,陽信-石牌,2024-05-06,8711
2010,春源,10,0,10,陽信-石牌,2024-05-06,8711
2313,華通,11,1,10,陽信-石牌,2024-05-06,8711
2340,台亞,10,0,10,陽信-石牌,2024-05-06,8711
2369,菱生,10,0,10,陽信-石牌,2024-05-06,8711
2409,友達,10,0,10,陽信-石牌,2024-05-06,8711
3062,建漢,10,0,10,陽信-石牌,2024-05-06,8711
3105,穩懋,10,0,10,陽信-石牌,2024-05-06,8711
3224,三顧,10,0,10,陽信-石牌,2024-05-06,8711
3686,達能,10,0,10,陽信-石牌,2024-05-06,8711
5529,鉅陞,10,0,10,陽信-石牌,2024-05-06,8711
6547,高端疫苗,10,0,10,陽信-石牌,2024-05-06,8711
8039,台虹,10,0,10,陽信-石牌,2024-05-06,8711
1532,勤美,10,1,9,陽信-石牌,2024-05-06,8711
2892,第一金,15,6,9,陽信-石牌,2024-05-06,8711
6282,康舒,9,0,9,陽信-石牌,2024-05-06,8711
00632R,元大台灣50反1,200,0,200,陽信-石牌,2024-05-07,8711
2371,大同,175,59,116,陽信-石牌,2024-05-07,8711
2450,神腦,112,0,112,陽信-石牌,2024-05-07,8711
00878,國泰永續高股息,75,3,72,陽信-石牌,2024-05-07,8711
00933B,國泰10Y+金融債,56,0,56,陽信-石牌,2024-05-07,8711
2610,華航,52,2,50,陽信-石牌,2024-05-07,8711
2801,彰銀,50,0,50,陽信-石牌,2024-05-07,8711
1102,亞泥,50,1,49,陽信-石牌,2024-05-07,8711
2834,臺企銀,33,0,33,陽信-石牌,2024-05-07,8711
2405,輔信,30,0,30,陽信-石牌,2024-05-07,8711
2530,華建,32,5,27,陽信-石牌,2024-05-07,8711
2880,華南金,30,3,27,陽信-石牌,2024-05-07,8711
00929,復華台灣科技優息,25,0,25,陽信-石牌,2024-05-07,8711
00905,FT臺灣Smart,30,5,25,陽信-石牌,2024-05-07,8711
00706L,期元大S＆P日圓正2,24,0,24,陽信-石牌,2024-05-07,8711
00936,台新永續高息中小,23,0,23,陽信-石牌,2024-05-07,8711
2515,中工,30,7,23,陽信-石牌,2024-05-07,8711
1229,聯華,22,0,22,陽信-石牌,2024-05-07,8711
2241,艾姆勒,23,1,22,陽信-石牌,2024-05-07,8711
0050,元大台灣50,25,4,21,陽信-石牌,2024-05-07,8711
2812,台中銀,20,0,20,陽信-石牌,2024-05-07,8711
4903,聯光通,20,0,20,陽信-石牌,2024-05-07,8711
6451,訊芯-KY,22,2,20,陽信-石牌,2024-05-07,8711
2498,宏達電,21,3,18,陽信-石牌,2024-05-07,8711
6213,聯茂,28,12,16,陽信-石牌,2024-05-07,8711
2344,華邦電,23,7,16,陽信-石牌,2024-05-07,8711
2538,基泰,20,4,16,陽信-石牌,2024-05-07,8711
3294,英濟,16,0,16,陽信-石牌,2024-05-07,8711
3625,西勝,16,0,16,陽信-石牌,2024-05-07,8711
2353,宏��,18,3,15,陽信-石牌,2024-05-07,8711
6282,康舒,16,1,15,陽信-石牌,2024-05-07,8711
1608,華榮,39,25,14,陽信-石牌,2024-05-07,8711
1603,華電,14,1,13,陽信-石牌,2024-05-07,8711
2014,中鴻,13,0,13,陽信-石牌,2024-05-07,8711
2367,燿華,18,5,13,陽信-石牌,2024-05-07,8711
2545,皇翔,13,0,13,陽信-石牌,2024-05-07,8711
2354,鴻準,14,2,12,陽信-石牌,2024-05-07,8711
1442,名軒,14,2,12,陽信-石牌,2024-05-07,8711
1616,億泰,13,1,12,陽信-石牌,2024-05-07,8711
2504,國產,13,1,12,陽信-石牌,2024-05-07,8711
4306,炎洲,12,0,12,陽信-石牌,2024-05-07,8711
8033,雷虎,13,1,12,陽信-石牌,2024-05-07,8711
1514,亞力,13,2,11,陽信-石牌,2024-05-07,8711
2486,一詮,46,35,11,陽信-石牌,2024-05-07,8711
2603,長榮,12,1,11,陽信-石牌,2024-05-07,8711
6117,迎廣,16,5,11,陽信-石牌,2024-05-07,8711
6147,頎邦,11,0,11,陽信-石牌,2024-05-07,8711
6743,安普新,11,0,11,陽信-石牌,2024-05-07,8711
8089,康全電訊,12,1,11,陽信-石牌,2024-05-07,8711
4923,力士,11,0,11,陽信-石牌,2024-05-07,8711
00878,國泰永續高股息,228,4,224,陽信-石牌,2024-05-08,8711
2101,南港,138,15,123,陽信-石牌,2024-05-08,8711
0056,元大高股息,121,5,116,陽信-石牌,2024-05-08,8711
00940,元大台灣價值高息,66,1,65,陽信-石牌,2024-05-08,8711
00725B,國泰投資級公司債,60,0,60,陽信-石牌,2024-05-08,8711
1722,台肥,60,0,60,陽信-石牌,2024-05-08,8711
1529,樂事綠能,61,2,59,陽信-石牌,2024-05-08,8711
6770,力積電,58,0,58,陽信-石牌,2024-05-08,8711
3036,文曄,39,0,39,陽信-石牌,2024-05-08,8711
00941,中信上游半導體,39,0,39,陽信-石牌,2024-05-08,8711
1229,聯華,30,0,30,陽信-石牌,2024-05-08,8711
1718,中纖,30,0,30,陽信-石牌,2024-05-08,8711
2832,台產,30,0,30,陽信-石牌,2024-05-08,8711
2634,漢翔,29,0,29,陽信-石牌,2024-05-08,8711
2359,所羅門,50,24,26,陽信-石牌,2024-05-08,8711
2618,長榮航,73,48,25,陽信-石牌,2024-05-08,8711
5388,中磊,23,0,23,陽信-石牌,2024-05-08,8711
6282,康舒,32,9,23,陽信-石牌,2024-05-08,8711
2611,志信,36,14,22,陽信-石牌,2024-05-08,8711
2409,友達,21,0,21,陽信-石牌,2024-05-08,8711
3024,憶聲,21,0,21,陽信-石牌,2024-05-08,8711
4960,誠美材,21,0,21,陽信-石牌,2024-05-08,8711
6451,訊芯-KY,22,1,21,陽信-石牌,2024-05-08,8711
00882,中信中國高股息,20,0,20,陽信-石牌,2024-05-08,8711
2323,中環,20,0,20,陽信-石牌,2024-05-08,8711
2641,正德,20,0,20,陽信-石牌,2024-05-08,8711
5871,中租-KY,19,0,19,陽信-石牌,2024-05-08,8711
2313,華通,18,3,15,陽信-石牌,2024-05-08,8711
2515,中工,15,0,15,陽信-石牌,2024-05-08,8711
00919,群益台灣精選高息,15,1,14,陽信-石牌,2024-05-08,8711
2352,佳世達,26,12,14,陽信-石牌,2024-05-08,8711
2509,全坤建,14,0,14,陽信-石牌,2024-05-08,8711
4561,健椿,21,7,14,陽信-石牌,2024-05-08,8711
8222,寶一,14,0,14,陽信-石牌,2024-05-08,8711
2340,台亞,13,0,13,陽信-石牌,2024-05-08,8711
8096,擎亞,25,12,13,陽信-石牌,2024-05-08,8711
4967,十銓,24,12,12,陽信-石牌,2024-05-08,8711
00713,元大台灣高息低波,12,0,12,陽信-石牌,2024-05-08,8711
2530,華建,12,0,12,陽信-石牌,2024-05-08,8711
00929,復華台灣科技優息,32,21,11,陽信-石牌,2024-05-08,8711
6179,亞通,11,0,11,陽信-石牌,2024-05-08,8711
00932,兆豐永續高息等權,10,0,10,陽信-石牌,2024-05-08,8711
2027,大成鋼,10,0,10,陽信-石牌,2024-05-08,8711
2316,楠梓電,10,0,10,陽信-石牌,2024-05-08,8711
2610,華航,41,31,10,陽信-石牌,2024-05-08,8711
2736,富野,10,0,10,陽信-石牌,2024-05-08,8711
2883,凱基金,10,0,10,陽信-石牌,2024-05-08,8711
3707,漢磊,10,0,10,陽信-石牌,2024-05-08,8711
4306,炎洲,10,0,10,陽信-石牌,2024-05-08,8711
8150,南茂,10,0,10,陽信-石牌,2024-05-08,8711
00946,群益科技高息成長,228,50,178,陽信-石牌,2024-05-09,8711
2888,新光金,197,76,121,陽信-石牌,2024-05-09,8711
00720B,元大投資級公司債,100,0,100,陽信-石牌,2024-05-09,8711
6282,康舒,74,4,70,陽信-石牌,2024-05-09,8711
00713,元大台灣高息低波,68,0,68,陽信-石牌,2024-05-09,8711
2618,長榮航,63,0,63,陽信-石牌,2024-05-09,8711
2498,宏達電,60,0,60,陽信-石牌,2024-05-09,8711
6005,群益證,60,0,60,陽信-石牌,2024-05-09,8711
4973,廣穎,55,1,54,陽信-石牌,2024-05-09,8711
3231,緯創,57,5,52,陽信-石牌,2024-05-09,8711
00929,復華台灣科技優息,57,10,47,陽信-石牌,2024-05-09,8711
3060,銘異,78,36,42,陽信-石牌,2024-05-09,8711
00898,國泰基因免疫革命,37,0,37,陽信-石牌,2024-05-09,8711
2520,冠德,42,9,33,陽信-石牌,2024-05-09,8711
6451,訊芯-KY,32,1,31,陽信-石牌,2024-05-09,8711
2834,臺企銀,30,0,30,陽信-石牌,2024-05-09,8711
2408,南亞科,29,0,29,陽信-石牌,2024-05-09,8711
4960,誠美材,29,5,24,陽信-石牌,2024-05-09,8711
9103,美德醫療-DR,23,0,23,陽信-石牌,2024-05-09,8711
2101,南港,33,12,21,陽信-石牌,2024-05-09,8711
1515,力山,23,2,21,陽信-石牌,2024-05-09,8711
3036,文曄,20,0,20,陽信-石牌,2024-05-09,8711
00725B,國泰投資級公司債,20,0,20,陽信-石牌,2024-05-09,8711
00857B,永豐20年美公債,20,0,20,陽信-石牌,2024-05-09,8711
2538,基泰,20,0,20,陽信-石牌,2024-05-09,8711
3294,英濟,27,8,19,陽信-石牌,2024-05-09,8711
3260,威剛,21,3,18,陽信-石牌,2024-05-09,8711
2354,鴻準,22,5,17,陽信-石牌,2024-05-09,8711
1612,宏泰,31,15,16,陽信-石牌,2024-05-09,8711
00940,元大台灣價值高息,26,10,16,陽信-石牌,2024-05-09,8711
2515,中工,28,12,16,陽信-石牌,2024-05-09,8711
9945,潤泰新,37,22,15,陽信-石牌,2024-05-09,8711
2542,興富發,17,3,14,陽信-石牌,2024-05-09,8711
6189,豐藝,14,0,14,陽信-石牌,2024-05-09,8711
9958,世紀鋼,21,7,14,陽信-石牌,2024-05-09,8711
00937B,群益ESG投等債20,13,0,13,陽信-石牌,2024-05-09,8711
4533,協易機,13,0,13,陽信-石牌,2024-05-09,8711
5439,高技,13,0,13,陽信-石牌,2024-05-09,8711
2449,京元電子,25,13,12,陽信-石牌,2024-05-09,8711
00665L,富邦�琤肭磪囓�2,42,30,12,陽信-石牌,2024-05-09,8711
2002,中鋼,11,0,11,陽信-石牌,2024-05-09,8711
2388,威盛,11,0,11,陽信-石牌,2024-05-09,8711
3032,偉訓,16,5,11,陽信-石牌,2024-05-09,8711
2344,華邦電,13,2,11,陽信-石牌,2024-05-09,8711
1815,富喬,30,20,10,陽信-石牌,2024-05-09,8711
2488,漢平,10,0,10,陽信-石牌,2024-05-09,8711
3024,憶聲,15,5,10,陽信-石牌,2024-05-09,8711
3041,揚智,10,0,10,陽信-石牌,2024-05-09,8711
3230,錦明,10,0,10,陽信-石牌,2024-05-09,8711
6153,嘉聯益,10,0,10,陽信-石牌,2024-05-09,8711
00946,群益科技高息成長,95,0,95,陽信-石牌,2024-05-10,8711
00674R,期元大S＆P黃金反1,75,0,75,陽信-石牌,2024-05-10,8711
1714,和桐,82,15,67,陽信-石牌,2024-05-10,8711
1215,卜蜂,64,0,64,陽信-石牌,2024-05-10,8711
00937B,群益ESG投等債20,67,15,52,陽信-石牌,2024-05-10,8711
00632R,元大台灣50反1,105,55,50,陽信-石牌,2024-05-10,8711
9105,泰金寶-DR,50,1,49,陽信-石牌,2024-05-10,8711
2891,中信金,51,5,46,陽信-石牌,2024-05-10,8711
2881,富邦金,51,10,41,陽信-石牌,2024-05-10,8711
00878,國泰永續高股息,87,47,40,陽信-石牌,2024-05-10,8711
2344,華邦電,44,5,39,陽信-石牌,2024-05-10,8711
00929,復華台灣科技優息,54,17,37,陽信-石牌,2024-05-10,8711
8112,至上,39,3,36,陽信-石牌,2024-05-10,8711
2313,華通,45,10,35,陽信-石牌,2024-05-10,8711
2704,國賓,34,0,34,陽信-石牌,2024-05-10,8711
2317,鴻海,45,12,33,陽信-石牌,2024-05-10,8711
00706L,期元大S＆P日圓正2,30,0,30,陽信-石牌,2024-05-10,8711
00680L,元大美債20正2,30,0,30,陽信-石牌,2024-05-10,8711
2388,威盛,29,1,28,陽信-石牌,2024-05-10,8711
00753L,中信中國50正2,25,0,25,陽信-石牌,2024-05-10,8711
3481,群創,30,6,24,陽信-石牌,2024-05-10,8711
00934,中信成長高股息,20,0,20,陽信-石牌,2024-05-10,8711
00885,富邦越南,20,0,20,陽信-石牌,2024-05-10,8711
8150,南茂,20,0,20,陽信-石牌,2024-05-10,8711
1905,華紙,18,0,18,陽信-石牌,2024-05-10,8711
2540,愛山林,16,0,16,陽信-石牌,2024-05-10,8711
1785,光洋科,15,0,15,陽信-石牌,2024-05-10,8711
4909,新復興,19,4,15,陽信-石牌,2024-05-10,8711
3715,定穎投控,13,0,13,陽信-石牌,2024-05-10,8711
6026,福邦證,13,0,13,陽信-石牌,2024-05-10,8711
00651R,復華香港反1,12,0,12,陽信-石牌,2024-05-10,8711
3013,晟銘電,63,51,12,陽信-石牌,2024-05-10,8711
2316,楠梓電,11,0,11,陽信-石牌,2024-05-10,8711
2385,群光,11,0,11,陽信-石牌,2024-05-10,8711
3576,聯合再生,14,3,11,陽信-石牌,2024-05-10,8711
4543,萬在,11,0,11,陽信-石牌,2024-05-10,8711
2538,基泰,10,0,10,陽信-石牌,2024-05-10,8711
3231,緯創,20,10,10,陽信-石牌,2024-05-10,8711
4174,浩鼎,10,0,10,陽信-石牌,2024-05-10,8711
5519,隆大,10,0,10,陽信-石牌,2024-05-10,8711
8176,智捷,10,0,10,陽信-石牌,2024-05-10,8711
6163,華電網,10,1,9,陽信-石牌,2024-05-10,8711
1464,得力,8,0,8,陽信-石牌,2024-05-10,8711
2617,台航,14,6,8,陽信-石牌,2024-05-10,8711
4726,永昕,10,2,8,陽信-石牌,2024-05-10,8711
6179,亞通,8,0,8,陽信-石牌,2024-05-10,8711
6257,矽格,10,2,8,陽信-石牌,2024-05-10,8711
6770,力積電,9,1,8,陽信-石牌,2024-05-10,8711
2371,大同,52,45,7,陽信-石牌,2024-05-10,8711
3036,文曄,8,1,7,陽信-石牌,2024-05-10,8711
00937B,群益ESG投等債20,204,5,199,陽信-石牌,2024-05-13,8711
00930,永豐ESG低碳高息,180,1,179,陽信-石牌,2024-05-13,8711
2881,富邦金,165,0,165,陽信-石牌,2024-05-13,8711
2905,三商,141,2,139,陽信-石牌,2024-05-13,8711
2886,兆豐金,100,5,95,陽信-石牌,2024-05-13,8711
8093,保銳,96,2,94,陽信-石牌,2024-05-13,8711
00878,國泰永續高股息,141,62,79,陽信-石牌,2024-05-13,8711
00731,復華富時高息低波,62,0,62,陽信-石牌,2024-05-13,8711
2515,中工,65,9,56,陽信-石牌,2024-05-13,8711
2371,大同,178,130,48,陽信-石牌,2024-05-13,8711
2801,彰銀,48,0,48,陽信-石牌,2024-05-13,8711
2344,華邦電,47,3,44,陽信-石牌,2024-05-13,8711
00940,元大台灣價值高息,49,8,41,陽信-石牌,2024-05-13,8711
00857B,永豐20年美公債,40,0,40,陽信-石牌,2024-05-13,8711
2618,長榮航,52,17,35,陽信-石牌,2024-05-13,8711
3551,世禾,35,0,35,陽信-石牌,2024-05-13,8711
2888,新光金,34,1,33,陽信-石牌,2024-05-13,8711
2891,中信金,32,0,32,陽信-石牌,2024-05-13,8711
5521,工信,32,3,29,陽信-石牌,2024-05-13,8711
6547,高端疫苗,26,0,26,陽信-石牌,2024-05-13,8711
00679B,元大美債20年,23,0,23,陽信-石牌,2024-05-13,8711
00929,復華台灣科技優息,21,0,21,陽信-石牌,2024-05-13,8711
4916,事欣科,23,2,21,陽信-石牌,2024-05-13,8711
3032,偉訓,20,0,20,陽信-石牌,2024-05-13,8711
4157,太景*-KY,20,0,20,陽信-石牌,2024-05-13,8711
4707,磐亞,20,0,20,陽信-石牌,2024-05-13,8711
5468,凱鈺,19,0,19,陽信-石牌,2024-05-13,8711
4930,燦星網,18,0,18,陽信-石牌,2024-05-13,8711
2405,輔信,21,4,17,陽信-石牌,2024-05-13,8711
1215,卜蜂,16,0,16,陽信-石牌,2024-05-13,8711
3044,健鼎,19,3,16,陽信-石牌,2024-05-13,8711
3231,緯創,28,12,16,陽信-石牌,2024-05-13,8711
3260,威剛,17,1,16,陽信-石牌,2024-05-13,8711
4552,力達-KY,15,0,15,陽信-石牌,2024-05-13,8711
00919,群益台灣精選高息,15,1,14,陽信-石牌,2024-05-13,8711
3339,泰谷,14,0,14,陽信-石牌,2024-05-13,8711
5251,天鉞電,13,1,12,陽信-石牌,2024-05-13,8711
3312,弘憶股,11,0,11,陽信-石牌,2024-05-13,8711
00933B,國泰10Y+金融債,30,20,10,陽信-石牌,2024-05-13,8711
00882,中信中國高股息,10,0,10,陽信-石牌,2024-05-13,8711
00712,復華富時不動產,10,0,10,陽信-石牌,2024-05-13,8711
00673R,期元大S＆P原油反1,10,0,10,陽信-石牌,2024-05-13,8711
00669R,國泰美國道瓊反1,10,0,10,陽信-石牌,2024-05-13,8711
1305,華夏,10,0,10,陽信-石牌,2024-05-13,8711
1609,大亞,21,11,10,陽信-石牌,2024-05-13,8711
2611,志信,17,7,10,陽信-石牌,2024-05-13,8711
3036,文曄,18,8,10,陽信-石牌,2024-05-13,8711
3105,穩懋,10,0,10,陽信-石牌,2024-05-13,8711
3686,達能,10,0,10,陽信-石牌,2024-05-13,8711
4726,永昕,10,0,10,陽信-石牌,2024-05-13,8711
2504,國產,151,1,150,陽信-石牌,2024-05-14,8711
00878,國泰永續高股息,130,3,127,陽信-石牌,2024-05-14,8711
2356,英業達,123,60,63,陽信-石牌,2024-05-14,8711
2615,萬海,240,182,58,陽信-石牌,2024-05-14,8711
6451,訊芯-KY,74,21,53,陽信-石牌,2024-05-14,8711
2444,兆勁,49,0,49,陽信-石牌,2024-05-14,8711
1718,中纖,45,2,43,陽信-石牌,2024-05-14,8711
00937B,群益ESG投等債20,55,18,37,陽信-石牌,2024-05-14,8711
2317,鴻海,61,25,36,陽信-石牌,2024-05-14,8711
2534,宏盛,40,5,35,陽信-石牌,2024-05-14,8711
2891,中信金,40,5,35,陽信-石牌,2024-05-14,8711
2905,三商,49,16,33,陽信-石牌,2024-05-14,8711
9904,寶成,35,2,33,陽信-石牌,2024-05-14,8711
2548,華固,31,0,31,陽信-石牌,2024-05-14,8711
5521,工信,31,0,31,陽信-石牌,2024-05-14,8711
5608,四維航,53,23,30,陽信-石牌,2024-05-14,8711
8299,群聯,27,2,25,陽信-石牌,2024-05-14,8711
1517,利奇,25,0,25,陽信-石牌,2024-05-14,8711
6120,達運,25,0,25,陽信-石牌,2024-05-14,8711
2885,元大金,23,0,23,陽信-石牌,2024-05-14,8711
2890,永豐金,21,0,21,陽信-石牌,2024-05-14,8711
2009,第一銅,20,0,20,陽信-石牌,2024-05-14,8711
5534,長虹,22,2,20,陽信-石牌,2024-05-14,8711
2371,大同,42,23,19,陽信-石牌,2024-05-14,8711
2637,慧洋-KY,25,9,16,陽信-石牌,2024-05-14,8711
2355,敬鵬,17,2,15,陽信-石牌,2024-05-14,8711
2374,佳能,29,14,15,陽信-石牌,2024-05-14,8711
00940,元大台灣價值高息,37,22,15,陽信-石牌,2024-05-14,8711
00919,群益台灣精選高息,16,2,14,陽信-石牌,2024-05-14,8711
2618,長榮航,63,49,14,陽信-石牌,2024-05-14,8711
3706,神達,18,4,14,陽信-石牌,2024-05-14,8711
00933B,國泰10Y+金融債,12,0,12,陽信-石牌,2024-05-14,8711
2482,連宇,16,4,12,陽信-石牌,2024-05-14,8711
2851,中再保,12,0,12,陽信-石牌,2024-05-14,8711
3231,緯創,15,4,11,陽信-石牌,2024-05-14,8711
8426,紅木-KY,11,0,11,陽信-石牌,2024-05-14,8711
2880,華南金,10,0,10,陽信-石牌,2024-05-14,8711
9921,巨大,10,0,10,陽信-石牌,2024-05-14,8711
00664R,國泰臺灣加權反1,10,0,10,陽信-石牌,2024-05-14,8711
1227,佳格,10,0,10,陽信-石牌,2024-05-14,8711
1474,弘裕,10,0,10,陽信-石牌,2024-05-14,8711
1603,華電,10,0,10,陽信-石牌,2024-05-14,8711
3645,達邁,10,0,10,陽信-石牌,2024-05-14,8711
5880,合庫金,10,0,10,陽信-石牌,2024-05-14,8711
6005,群益證,10,0,10,陽信-石牌,2024-05-14,8711
6443,元晶,10,0,10,陽信-石牌,2024-05-14,8711
6743,安普新,10,0,10,陽信-石牌,2024-05-14,8711
00941,中信上游半導體,9,0,9,陽信-石牌,2024-05-14,8711
2801,彰銀,10,1,9,陽信-石牌,2024-05-14,8711
9103,美德醫療-DR,9,0,9,陽信-石牌,2024-05-14,8711
00915,凱基優選高股息30,400,0,400,陽信-石牌,2024-05-15,8711
2303,聯電,235,12,223,陽信-石牌,2024-05-15,8711
2504,國產,151,0,151,陽信-石牌,2024-05-15,8711
00929,復華台灣科技優息,139,2,137,陽信-石牌,2024-05-15,8711
00937B,群益ESG投等債20,131,8,123,陽信-石牌,2024-05-15,8711
2880,華南金,112,1,111,陽信-石牌,2024-05-15,8711
2884,玉山金,101,2,99,陽信-石牌,2024-05-15,8711
2356,英業達,117,51,66,陽信-石牌,2024-05-15,8711
2850,新產,51,0,51,陽信-石牌,2024-05-15,8711
00720B,元大投資級公司債,50,0,50,陽信-石牌,2024-05-15,8711
2836,高雄銀,50,0,50,陽信-石牌,2024-05-15,8711
1215,卜蜂,43,0,43,陽信-石牌,2024-05-15,8711
4903,聯光通,47,8,39,陽信-石牌,2024-05-15,8711
2609,陽明,162,124,38,陽信-石牌,2024-05-15,8711
2603,長榮,49,14,35,陽信-石牌,2024-05-15,8711
2323,中環,41,10,31,陽信-石牌,2024-05-15,8711
2548,華固,31,0,31,陽信-石牌,2024-05-15,8711
00680L,元大美債20正2,30,0,30,陽信-石牌,2024-05-15,8711
2515,中工,32,4,28,陽信-石牌,2024-05-15,8711
6188,廣明,42,15,27,陽信-石牌,2024-05-15,8711
2353,宏��,43,17,26,陽信-石牌,2024-05-15,8711
3706,神達,46,20,26,陽信-石牌,2024-05-15,8711
2605,新興,26,1,25,陽信-石牌,2024-05-15,8711
2542,興富發,23,0,23,陽信-石牌,2024-05-15,8711
1314,中石化,21,0,21,陽信-石牌,2024-05-15,8711
6197,佳必琪,22,1,21,陽信-石牌,2024-05-15,8711
00753L,中信中國50正2,20,0,20,陽信-石牌,2024-05-15,8711
4726,永昕,20,0,20,陽信-石牌,2024-05-15,8711
6548,長科*,20,1,19,陽信-石牌,2024-05-15,8711
2369,菱生,18,0,18,陽信-石牌,2024-05-15,8711
6163,華電網,24,6,18,陽信-石牌,2024-05-15,8711
1608,華榮,32,15,17,陽信-石牌,2024-05-15,8711
1312,國喬,16,0,16,陽信-石牌,2024-05-15,8711
5469,瀚宇博,17,1,16,陽信-石牌,2024-05-15,8711
00632R,元大台灣50反1,25,10,15,陽信-石牌,2024-05-15,8711
3230,錦明,15,0,15,陽信-石牌,2024-05-15,8711
8163,達方,15,0,15,陽信-石牌,2024-05-15,8711
3588,通嘉,14,0,14,陽信-石牌,2024-05-15,8711
6753,龍德造船,17,3,14,陽信-石牌,2024-05-15,8711
00932,兆豐永續高息等權,12,0,12,陽信-石牌,2024-05-15,8711
2449,京元電子,12,0,12,陽信-石牌,2024-05-15,8711
2617,台航,12,0,12,陽信-石牌,2024-05-15,8711
4533,協易機,19,7,12,陽信-石牌,2024-05-15,8711
3483,力致,16,5,11,陽信-石牌,2024-05-15,8711
4938,和碩,12,1,11,陽信-石牌,2024-05-15,8711
6290,良維,12,1,11,陽信-石牌,2024-05-15,8711
8210,勤誠,12,1,11,陽信-石牌,2024-05-15,8711
00633L,富邦上証正2,10,0,10,陽信-石牌,2024-05-15,8711
1310,台苯,10,0,10,陽信-石牌,2024-05-15,8711
2436,偉詮電,10,0,10,陽信-石牌,2024-05-15,8711
00680L,元大美債20正2,450,0,450,陽信-石牌,2024-05-16,8711
00919,群益台灣精選高息,151,25,126,陽信-石牌,2024-05-16,8711
00632R,元大台灣50反1,110,0,110,陽信-石牌,2024-05-16,8711
5609,中菲行,65,0,65,陽信-石牌,2024-05-16,8711
2520,冠德,123,64,59,陽信-石牌,2024-05-16,8711
2356,英業達,68,9,59,陽信-石牌,2024-05-16,8711
00720B,元大投資級公司債,50,0,50,陽信-石牌,2024-05-16,8711
8093,保銳,50,0,50,陽信-石牌,2024-05-16,8711
2317,鴻海,115,65,50,陽信-石牌,2024-05-16,8711
2542,興富發,51,1,50,陽信-石牌,2024-05-16,8711
2241,艾姆勒,54,7,47,陽信-石牌,2024-05-16,8711
4533,協易機,52,7,45,陽信-石牌,2024-05-16,8711
4566,時碩工業,43,0,43,陽信-石牌,2024-05-16,8711
1563,巧新,41,1,40,陽信-石牌,2024-05-16,8711
2881,富邦金,40,0,40,陽信-石牌,2024-05-16,8711
2382,廣達,53,14,39,陽信-石牌,2024-05-16,8711
2359,所羅門,52,16,36,陽信-石牌,2024-05-16,8711
2101,南港,73,41,32,陽信-石牌,2024-05-16,8711
00929,復華台灣科技優息,29,2,27,陽信-石牌,2024-05-16,8711
2371,大同,42,15,27,陽信-石牌,2024-05-16,8711
3313,斐成,30,4,26,陽信-石牌,2024-05-16,8711
2374,佳能,31,7,24,陽信-石牌,2024-05-16,8711
2836,高雄銀,24,0,24,陽信-石牌,2024-05-16,8711
5521,工信,22,0,22,陽信-石牌,2024-05-16,8711
00651R,復華香港反1,20,0,20,陽信-石牌,2024-05-16,8711
2406,國碩,32,12,20,陽信-石牌,2024-05-16,8711
2845,遠東銀,20,0,20,陽信-石牌,2024-05-16,8711
3066,李洲,20,0,20,陽信-石牌,2024-05-16,8711
8064,東捷,21,1,20,陽信-石牌,2024-05-16,8711
3059,華晶科,22,3,19,陽信-石牌,2024-05-16,8711
1514,亞力,22,4,18,陽信-石牌,2024-05-16,8711
3363,上詮,28,10,18,陽信-石牌,2024-05-16,8711
3231,緯創,64,47,17,陽信-石牌,2024-05-16,8711
6152,百一,16,0,16,陽信-石牌,2024-05-16,8711
2301,光寶科,16,1,15,陽信-石牌,2024-05-16,8711
2634,漢翔,15,0,15,陽信-石牌,2024-05-16,8711
00936,台新永續高息中小,14,0,14,陽信-石牌,2024-05-16,8711
2464,盟立,27,13,14,陽信-石牌,2024-05-16,8711
3455,由田,16,2,14,陽信-石牌,2024-05-16,8711
0050,元大台灣50,13,1,12,陽信-石牌,2024-05-16,8711
3483,力致,12,0,12,陽信-石牌,2024-05-16,8711
3390,旭軟,11,0,11,陽信-石牌,2024-05-16,8711
6451,訊芯-KY,13,2,11,陽信-石牌,2024-05-16,8711
6505,台塑化,12,1,11,陽信-石牌,2024-05-16,8711
6547,高端疫苗,11,0,11,陽信-石牌,2024-05-16,8711
1789,神隆,10,0,10,陽信-石牌,2024-05-16,8711
2006,東和鋼鐵,10,0,10,陽信-石牌,2024-05-16,8711
2340,台亞,10,0,10,陽信-石牌,2024-05-16,8711
2440,太空梭,10,0,10,陽信-石牌,2024-05-16,8711
2501,國建,24,14,10,陽信-石牌,2024-05-16,8711
00680L,元大美債20正2,130,0,130,陽信-石牌,2024-05-17,8711
2867,三商壽,110,6,104,陽信-石牌,2024-05-17,8711
00632R,元大台灣50反1,100,5,95,陽信-石牌,2024-05-17,8711
2504,國產,104,10,94,陽信-石牌,2024-05-17,8711
00878,國泰永續高股息,89,30,59,陽信-石牌,2024-05-17,8711
2317,鴻海,60,3,57,陽信-石牌,2024-05-17,8711
2836,高雄銀,55,0,55,陽信-石牌,2024-05-17,8711
00929,復華台灣科技優息,81,28,53,陽信-石牌,2024-05-17,8711
6244,茂迪,74,23,51,陽信-石牌,2024-05-17,8711
6147,頎邦,43,0,43,陽信-石牌,2024-05-17,8711
1215,卜蜂,40,0,40,陽信-石牌,2024-05-17,8711
3481,群創,41,3,38,陽信-石牌,2024-05-17,8711
00915,凱基優選高股息30,30,0,30,陽信-石牌,2024-05-17,8711
2380,虹光,30,0,30,陽信-石牌,2024-05-17,8711
5498,凱崴,40,10,30,陽信-石牌,2024-05-17,8711
2406,國碩,55,26,29,陽信-石牌,2024-05-17,8711
2349,錸德,29,1,28,陽信-石牌,2024-05-17,8711
3576,聯合再生,35,8,27,陽信-石牌,2024-05-17,8711
2606,裕民,26,0,26,陽信-石牌,2024-05-17,8711
00919,群益台灣精選高息,65,40,25,陽信-石牌,2024-05-17,8711
4167,松瑞藥,25,0,25,陽信-石牌,2024-05-17,8711
2337,旺宏,38,14,24,陽信-石牌,2024-05-17,8711
6257,矽格,24,0,24,陽信-石牌,2024-05-17,8711
00770,國泰北美科技,23,0,23,陽信-石牌,2024-05-17,8711
2489,瑞軒,28,6,22,陽信-石牌,2024-05-17,8711
3033,威健,34,12,22,陽信-石牌,2024-05-17,8711
1802,台玻,20,0,20,陽信-石牌,2024-05-17,8711
3211,順達,20,0,20,陽信-石牌,2024-05-17,8711
00679B,元大美債20年,19,0,19,陽信-石牌,2024-05-17,8711
6164,華興,24,5,19,陽信-石牌,2024-05-17,8711
00940,元大台灣價值高息,38,20,18,陽信-石牌,2024-05-17,8711
3060,銘異,92,74,18,陽信-石牌,2024-05-17,8711
1517,利奇,17,0,17,陽信-石牌,2024-05-17,8711
1618,合機,21,4,17,陽信-石牌,2024-05-17,8711
2302,麗正,15,0,15,陽信-石牌,2024-05-17,8711
2534,宏盛,20,5,15,陽信-石牌,2024-05-17,8711
3455,由田,15,0,15,陽信-石牌,2024-05-17,8711
2637,慧洋-KY,39,25,14,陽信-石牌,2024-05-17,8711
2101,南港,23,11,12,陽信-石牌,2024-05-17,8711
2329,華泰,14,2,12,陽信-石牌,2024-05-17,8711
2356,英業達,36,24,12,陽信-石牌,2024-05-17,8711
2801,彰銀,12,0,12,陽信-石牌,2024-05-17,8711
3024,憶聲,15,3,12,陽信-石牌,2024-05-17,8711
3047,訊舟,31,19,12,陽信-石牌,2024-05-17,8711
00665L,富邦�琤肭磪囓�2,16,5,11,陽信-石牌,2024-05-17,8711
3715,定穎投控,16,5,11,陽信-石牌,2024-05-17,8711
6770,力積電,28,17,11,陽信-石牌,2024-05-17,8711
00752,中信中國50,10,0,10,陽信-石牌,2024-05-17,8711
1309,台達化,10,0,10,陽信-石牌,2024-05-17,8711
1457,宜進,10,0,10,陽信-石牌,2024-05-17,8711
2881,富邦金,145,1,144,陽信-石牌,2024-05-20,8711
2610,華航,155,41,114,陽信-石牌,2024-05-20,8711
1605,華新,143,34,109,陽信-石牌,2024-05-20,8711
2618,長榮航,115,23,92,陽信-石牌,2024-05-20,8711
00929,復華台灣科技優息,140,52,88,陽信-石牌,2024-05-20,8711
2374,佳能,145,61,84,陽信-石牌,2024-05-20,8711
2867,三商壽,89,18,71,陽信-石牌,2024-05-20,8711
00712,復華富時不動產,61,0,61,陽信-石牌,2024-05-20,8711
2885,元大金,55,4,51,陽信-石牌,2024-05-20,8711
00680L,元大美債20正2,100,50,50,陽信-石牌,2024-05-20,8711
2836,高雄銀,50,0,50,陽信-石牌,2024-05-20,8711
1609,大亞,42,5,37,陽信-石牌,2024-05-20,8711
00919,群益台灣精選高息,75,41,34,陽信-石牌,2024-05-20,8711
00857B,永豐20年美公債,30,0,30,陽信-石牌,2024-05-20,8711
3576,聯合再生,104,74,30,陽信-石牌,2024-05-20,8711
2317,鴻海,33,8,25,陽信-石牌,2024-05-20,8711
1215,卜蜂,20,0,20,陽信-石牌,2024-05-20,8711
00753L,中信中國50正2,20,0,20,陽信-石牌,2024-05-20,8711
00931B,統一美債20年,20,0,20,陽信-石牌,2024-05-20,8711
1711,永光,20,0,20,陽信-石牌,2024-05-20,8711
2020,美亞,20,0,20,陽信-石牌,2024-05-20,8711
2606,裕民,21,1,20,陽信-石牌,2024-05-20,8711
1725,元禎,29,10,19,陽信-石牌,2024-05-20,8711
6264,富裔,19,0,19,陽信-石牌,2024-05-20,8711
4903,聯光通,18,0,18,陽信-石牌,2024-05-20,8711
2382,廣達,27,10,17,陽信-石牌,2024-05-20,8711
2363,矽統,45,28,17,陽信-石牌,2024-05-20,8711
2540,愛山林,16,0,16,陽信-石牌,2024-05-20,8711
00937B,群益ESG投等債20,25,10,15,陽信-石牌,2024-05-20,8711
3290,東浦,15,0,15,陽信-石牌,2024-05-20,8711
4109,加捷生醫,15,0,15,陽信-石牌,2024-05-20,8711
8033,雷虎,23,8,15,陽信-石牌,2024-05-20,8711
8071,能率網通,18,3,15,陽信-石牌,2024-05-20,8711
5468,凱鈺,14,0,14,陽信-石牌,2024-05-20,8711
0056,元大高股息,20,7,13,陽信-石牌,2024-05-20,8711
1563,巧新,20,7,13,陽信-石牌,2024-05-20,8711
1795,美時,25,12,13,陽信-石牌,2024-05-20,8711
00795B,中信美國公債20年,12,0,12,陽信-石牌,2024-05-20,8711
2449,京元電子,17,5,12,陽信-石牌,2024-05-20,8711
3312,弘憶股,27,15,12,陽信-石牌,2024-05-20,8711
00632R,元大台灣50反1,10,0,10,陽信-石牌,2024-05-20,8711
00646,元大S＆P500,10,0,10,陽信-石牌,2024-05-20,8711
00945B,凱基美國非投等債,10,0,10,陽信-石牌,2024-05-20,8711
02001L,富邦蘋果正二N,10,0,10,陽信-石牌,2024-05-20,8711
2426,鼎元,10,0,10,陽信-石牌,2024-05-20,8711
2515,中工,10,0,10,陽信-石牌,2024-05-20,8711
3060,銘異,31,21,10,陽信-石牌,2024-05-20,8711
3188,鑫龍騰,10,0,10,陽信-石牌,2024-05-20,8711
8163,達方,10,0,10,陽信-石牌,2024-05-20,8711
8222,寶一,10,0,10,陽信-石牌,2024-05-20,8711
3689,湧德,136,6,130,陽信-石牌,2024-05-21,8711
2836,高雄銀,100,0,100,陽信-石牌,2024-05-21,8711
2706,第一店,65,0,65,陽信-石牌,2024-05-21,8711
00882,中信中國高股息,64,4,60,陽信-石牌,2024-05-21,8711
2323,中環,59,0,59,陽信-石牌,2024-05-21,8711
00919,群益台灣精選高息,54,0,54,陽信-石牌,2024-05-21,8711
2850,新產,50,0,50,陽信-石牌,2024-05-21,8711
2371,大同,49,6,43,陽信-石牌,2024-05-21,8711
2832,台產,40,0,40,陽信-石牌,2024-05-21,8711
8033,雷虎,41,1,40,陽信-石牌,2024-05-21,8711
2888,新光金,42,3,39,陽信-石牌,2024-05-21,8711
1718,中纖,36,0,36,陽信-石牌,2024-05-21,8711
00878,國泰永續高股息,32,0,32,陽信-石牌,2024-05-21,8711
3673,TPK-KY,32,0,32,陽信-石牌,2024-05-21,8711
5386,青雲,31,0,31,陽信-石牌,2024-05-21,8711
2354,鴻準,58,28,30,陽信-石牌,2024-05-21,8711
2329,華泰,54,25,29,陽信-石牌,2024-05-21,8711
2027,大成鋼,56,33,23,陽信-石牌,2024-05-21,8711
2880,華南金,33,10,23,陽信-石牌,2024-05-21,8711
3015,全漢,23,0,23,陽信-石牌,2024-05-21,8711
1215,卜蜂,20,0,20,陽信-石牌,2024-05-21,8711
2548,華固,20,0,20,陽信-石牌,2024-05-21,8711
2317,鴻海,33,14,19,陽信-石牌,2024-05-21,8711
2382,廣達,22,3,19,陽信-石牌,2024-05-21,8711
8105,凌巨,20,1,19,陽信-石牌,2024-05-21,8711
8028,昇陽半導體,24,6,18,陽信-石牌,2024-05-21,8711
00929,復華台灣科技優息,17,0,17,陽信-石牌,2024-05-21,8711
00940,元大台灣價值高息,17,1,16,陽信-石牌,2024-05-21,8711
2376,技嘉,23,7,16,陽信-石牌,2024-05-21,8711
2385,群光,16,0,16,陽信-石牌,2024-05-21,8711
2885,元大金,16,0,16,陽信-石牌,2024-05-21,8711
1464,得力,15,0,15,陽信-石牌,2024-05-21,8711
3703,欣陸,16,1,15,陽信-石牌,2024-05-21,8711
2367,燿華,103,89,14,陽信-石牌,2024-05-21,8711
2332,友訊,14,0,14,陽信-石牌,2024-05-21,8711
2460,建通,13,0,13,陽信-石牌,2024-05-21,8711
2618,長榮航,40,27,13,陽信-石牌,2024-05-21,8711
3033,威健,17,4,13,陽信-石牌,2024-05-21,8711
3264,欣銓,13,0,13,陽信-石牌,2024-05-21,8711
5531,鄉林,13,0,13,陽信-石牌,2024-05-21,8711
8110,華東,15,2,13,陽信-石牌,2024-05-21,8711
2417,圓剛,12,0,12,陽信-石牌,2024-05-21,8711
5533,皇鼎,14,2,12,陽信-石牌,2024-05-21,8711
6180,橘子,12,0,12,陽信-石牌,2024-05-21,8711
3481,群創,11,0,11,陽信-石牌,2024-05-21,8711
1582,信錦,12,1,11,陽信-石牌,2024-05-21,8711
00857B,永豐20年美公債,10,0,10,陽信-石牌,2024-05-21,8711
00680L,元大美債20正2,60,50,10,陽信-石牌,2024-05-21,8711
00752,中信中國50,10,0,10,陽信-石牌,2024-05-21,8711
2002,中鋼,10,0,10,陽信-石牌,2024-05-21,8711
2504,國產,204,3,201,陽信-石牌,2024-05-22,8711
00919,群益台灣精選高息,196,74,122,陽信-石牌,2024-05-22,8711
2369,菱生,130,11,119,陽信-石牌,2024-05-22,8711
00907,永豐優息存股,100,0,100,陽信-石牌,2024-05-22,8711
1722,台肥,100,0,100,陽信-石牌,2024-05-22,8711
1605,華新,136,41,95,陽信-石牌,2024-05-22,8711
2548,華固,60,0,60,陽信-石牌,2024-05-22,8711
00937B,群益ESG投等債20,51,0,51,陽信-石牌,2024-05-22,8711
00946,群益科技高息成長,50,0,50,陽信-石牌,2024-05-22,8711
3481,群創,135,93,42,陽信-石牌,2024-05-22,8711
2706,第一店,36,0,36,陽信-石牌,2024-05-22,8711
3013,晟銘電,102,66,36,陽信-石牌,2024-05-22,8711
4960,誠美材,36,1,35,陽信-石牌,2024-05-22,8711
2547,日勝生,33,0,33,陽信-石牌,2024-05-22,8711
6584,南俊國際,35,2,33,陽信-石牌,2024-05-22,8711
6213,聯茂,39,6,33,陽信-石牌,2024-05-22,8711
2002,中鋼,32,0,32,陽信-石牌,2024-05-22,8711
2027,大成鋼,36,4,32,陽信-石牌,2024-05-22,8711
1515,力山,31,0,31,陽信-石牌,2024-05-22,8711
2836,高雄銀,31,0,31,陽信-石牌,2024-05-22,8711
6125,廣運,50,23,27,陽信-石牌,2024-05-22,8711
3491,昇達科,27,2,25,陽信-石牌,2024-05-22,8711
4938,和碩,31,6,25,陽信-石牌,2024-05-22,8711
5392,能率,60,35,25,陽信-石牌,2024-05-22,8711
1303,南亞,21,0,21,陽信-石牌,2024-05-22,8711
2421,建準,24,3,21,陽信-石牌,2024-05-22,8711
00665L,富邦�琤肭磪囓�2,25,5,20,陽信-石牌,2024-05-22,8711
1215,卜蜂,20,0,20,陽信-石牌,2024-05-22,8711
1416,廣豐,20,0,20,陽信-石牌,2024-05-22,8711
3047,訊舟,40,20,20,陽信-石牌,2024-05-22,8711
2801,彰銀,19,0,19,陽信-石牌,2024-05-22,8711
1314,中石化,18,0,18,陽信-石牌,2024-05-22,8711
8222,寶一,20,2,18,陽信-石牌,2024-05-22,8711
5347,世界,32,14,18,陽信-石牌,2024-05-22,8711
5309,系統電,20,3,17,陽信-石牌,2024-05-22,8711
2489,瑞軒,18,2,16,陽信-石牌,2024-05-22,8711
4543,萬在,28,12,16,陽信-石牌,2024-05-22,8711
00941,中信上游半導體,15,0,15,陽信-石牌,2024-05-22,8711
2367,燿華,55,40,15,陽信-石牌,2024-05-22,8711
2476,鉅祥,14,0,14,陽信-石牌,2024-05-22,8711
2316,楠梓電,14,1,13,陽信-石牌,2024-05-22,8711
6179,亞通,12,0,12,陽信-石牌,2024-05-22,8711
1608,華榮,33,22,11,陽信-石牌,2024-05-22,8711
4903,聯光通,11,0,11,陽信-石牌,2024-05-22,8711
5314,世紀,11,0,11,陽信-石牌,2024-05-22,8711
00731,復華富時高息低波,10,0,10,陽信-石牌,2024-05-22,8711
1440,南紡,10,0,10,陽信-石牌,2024-05-22,8711
1447,力鵬,10,0,10,陽信-石牌,2024-05-22,8711
1464,得力,10,0,10,陽信-石牌,2024-05-22,8711
1474,弘裕,10,0,10,陽信-石牌,2024-05-22,8711
00937B,群益ESG投等債20,406,1,405,陽信-石牌,2024-05-23,8711
2504,國產,103,3,100,陽信-石牌,2024-05-23,8711
2101,南港,93,12,81,陽信-石牌,2024-05-23,8711
00680L,元大美債20正2,70,0,70,陽信-石牌,2024-05-23,8711
3015,全漢,70,1,69,陽信-石牌,2024-05-23,8711
1789,神隆,54,0,54,陽信-石牌,2024-05-23,8711
2548,華固,48,0,48,陽信-石牌,2024-05-23,8711
2888,新光金,55,11,44,陽信-石牌,2024-05-23,8711
1215,卜蜂,41,0,41,陽信-石牌,2024-05-23,8711
2850,新產,40,0,40,陽信-石牌,2024-05-23,8711
2356,英業達,52,13,39,陽信-石牌,2024-05-23,8711
2601,益航,41,3,38,陽信-石牌,2024-05-23,8711
6209,今國光,53,16,37,陽信-石牌,2024-05-23,8711
1903,士紙,35,0,35,陽信-石牌,2024-05-23,8711
2401,凌陽,36,1,35,陽信-石牌,2024-05-23,8711
00715L,期街口布蘭特正2,32,0,32,陽信-石牌,2024-05-23,8711
1752,南光,30,0,30,陽信-石牌,2024-05-23,8711
2832,台產,30,0,30,陽信-石牌,2024-05-23,8711
5324,士開,30,0,30,陽信-石牌,2024-05-23,8711
3706,神達,34,4,30,陽信-石牌,2024-05-23,8711
2009,第一銅,29,0,29,陽信-石牌,2024-05-23,8711
3481,群創,49,21,28,陽信-石牌,2024-05-23,8711
2353,宏��,231,203,28,陽信-石牌,2024-05-23,8711
00918,大華優利高填息30,27,0,27,陽信-石牌,2024-05-23,8711
2464,盟立,42,16,26,陽信-石牌,2024-05-23,8711
2450,神腦,25,0,25,陽信-石牌,2024-05-23,8711
2890,永豐金,30,5,25,陽信-石牌,2024-05-23,8711
00940,元大台灣價值高息,43,20,23,陽信-石牌,2024-05-23,8711
2883,凱基金,25,2,23,陽信-石牌,2024-05-23,8711
4157,太景*-KY,23,0,23,陽信-石牌,2024-05-23,8711
6161,捷波,32,10,22,陽信-石牌,2024-05-23,8711
2002,中鋼,21,0,21,陽信-石牌,2024-05-23,8711
00941,中信上游半導體,20,0,20,陽信-石牌,2024-05-23,8711
2208,台船,20,0,20,陽信-石牌,2024-05-23,8711
2385,群光,20,0,20,陽信-石牌,2024-05-23,8711
3290,東浦,20,0,20,陽信-石牌,2024-05-23,8711
6265,方土昶,20,0,20,陽信-石牌,2024-05-23,8711
8093,保銳,20,1,19,陽信-石牌,2024-05-23,8711
1609,大亞,27,9,18,陽信-石牌,2024-05-23,8711
2489,瑞軒,20,2,18,陽信-石牌,2024-05-23,8711
8936,國統,18,0,18,陽信-石牌,2024-05-23,8711
2367,燿華,64,48,16,陽信-石牌,2024-05-23,8711
2449,京元電子,20,4,16,陽信-石牌,2024-05-23,8711
3032,偉訓,16,0,16,陽信-石牌,2024-05-23,8711
6235,華孚,21,5,16,陽信-石牌,2024-05-23,8711
1464,得力,17,2,15,陽信-石牌,2024-05-23,8711
6164,華興,15,0,15,陽信-石牌,2024-05-23,8711
1474,弘裕,14,0,14,陽信-石牌,2024-05-23,8711
1725,元禎,14,0,14,陽信-石牌,2024-05-23,8711
3047,訊舟,23,9,14,陽信-石牌,2024-05-23,8711
00919,群益台灣精選高息,263,6,257,陽信-石牌,2024-05-24,8711
2504,國產,100,1,99,陽信-石牌,2024-05-24,8711
2363,矽統,126,31,95,陽信-石牌,2024-05-24,8711
00712,復華富時不動產,94,0,94,陽信-石牌,2024-05-24,8711
6425,易發,64,0,64,陽信-石牌,2024-05-24,8711
2365,昆盈,109,48,61,陽信-石牌,2024-05-24,8711
2303,聯電,72,15,57,陽信-石牌,2024-05-24,8711
6770,力積電,50,0,50,陽信-石牌,2024-05-24,8711
00937B,群益ESG投等債20,68,20,48,陽信-石牌,2024-05-24,8711
2374,佳能,38,0,38,陽信-石牌,2024-05-24,8711
2884,玉山金,35,0,35,陽信-石牌,2024-05-24,8711
2892,第一金,34,0,34,陽信-石牌,2024-05-24,8711
2002,中鋼,25,0,25,陽信-石牌,2024-05-24,8711
1815,富喬,35,13,22,陽信-石牌,2024-05-24,8711
00946,群益科技高息成長,21,0,21,陽信-石牌,2024-05-24,8711
00680L,元大美債20正2,20,0,20,陽信-石牌,2024-05-24,8711
2010,春源,20,0,20,陽信-石牌,2024-05-24,8711
2020,美亞,20,0,20,陽信-石牌,2024-05-24,8711
2538,基泰,20,0,20,陽信-石牌,2024-05-24,8711
2891,中信金,20,0,20,陽信-石牌,2024-05-24,8711
8112,至上,19,0,19,陽信-石牌,2024-05-24,8711
1609,大亞,25,7,18,陽信-石牌,2024-05-24,8711
3163,波若威,36,18,18,陽信-石牌,2024-05-24,8711
00918,大華優利高填息30,17,0,17,陽信-石牌,2024-05-24,8711
6877,鏵友益,16,0,16,陽信-石牌,2024-05-24,8711
1582,信錦,16,0,16,陽信-石牌,2024-05-24,8711
00929,復華台灣科技優息,15,1,14,陽信-石牌,2024-05-24,8711
1314,中石化,13,0,13,陽信-石牌,2024-05-24,8711
4906,正文,13,0,13,陽信-石牌,2024-05-24,8711
6207,雷科,12,0,12,陽信-石牌,2024-05-24,8711
1216,統一,11,0,11,陽信-石牌,2024-05-24,8711
2316,楠梓電,11,0,11,陽信-石牌,2024-05-24,8711
6202,盛群,11,0,11,陽信-石牌,2024-05-24,8711
3013,晟銘電,33,23,10,陽信-石牌,2024-05-24,8711
1340,勝悅-KY,10,0,10,陽信-石牌,2024-05-24,8711
00665L,富邦�琤肭磪囓�2,10,0,10,陽信-石牌,2024-05-24,8711
00857B,永豐20年美公債,10,0,10,陽信-石牌,2024-05-24,8711
1215,卜蜂,10,0,10,陽信-石牌,2024-05-24,8711
1587,吉茂,10,0,10,陽信-石牌,2024-05-24,8711
1752,南光,10,0,10,陽信-石牌,2024-05-24,8711
2101,南港,30,20,10,陽信-石牌,2024-05-24,8711
2313,華通,11,1,10,陽信-石牌,2024-05-24,8711
2314,台揚,10,0,10,陽信-石牌,2024-05-24,8711
2630,亞航,10,0,10,陽信-石牌,2024-05-24,8711
2885,元大金,10,0,10,陽信-石牌,2024-05-24,8711
3105,穩懋,10,0,10,陽信-石牌,2024-05-24,8711
3380,明泰,13,3,10,陽信-石牌,2024-05-24,8711
6215,和椿,10,0,10,陽信-石牌,2024-05-24,8711
6579,研揚,10,0,10,陽信-石牌,2024-05-24,8711
8222,寶一,10,0,10,陽信-石牌,2024-05-24,8711
2303,聯電,338,176,162,陽信-石牌,2024-05-27,8711
2241,艾姆勒,171,11,160,陽信-石牌,2024-05-27,8711
1605,華新,161,5,156,陽信-石牌,2024-05-27,8711
2353,宏��,297,161,136,陽信-石牌,2024-05-27,8711
2371,大同,109,11,98,陽信-石牌,2024-05-27,8711
00713,元大台灣高息低波,91,2,89,陽信-石牌,2024-05-27,8711
6275,元山,93,7,86,陽信-石牌,2024-05-27,8711
00940,元大台灣價值高息,84,6,78,陽信-石牌,2024-05-27,8711
00946,群益科技高息成長,65,0,65,陽信-石牌,2024-05-27,8711
00937B,群益ESG投等債20,63,0,63,陽信-石牌,2024-05-27,8711
3041,揚智,57,0,57,陽信-石牌,2024-05-27,8711
2801,彰銀,50,0,50,陽信-石牌,2024-05-27,8711
2881,富邦金,50,0,50,陽信-石牌,2024-05-27,8711
2367,燿華,157,110,47,陽信-石牌,2024-05-27,8711
2882,國泰金,55,11,44,陽信-石牌,2024-05-27,8711
4157,太景*-KY,40,2,38,陽信-石牌,2024-05-27,8711
3033,威健,47,10,37,陽信-石牌,2024-05-27,8711
2615,萬海,51,15,36,陽信-石牌,2024-05-27,8711
8028,昇陽半導體,41,7,34,陽信-石牌,2024-05-27,8711
2408,南亞科,51,21,30,陽信-石牌,2024-05-27,8711
2444,兆勁,30,3,27,陽信-石牌,2024-05-27,8711
2609,陽明,47,24,23,陽信-石牌,2024-05-27,8711
6265,方土昶,33,10,23,陽信-石牌,2024-05-27,8711
8034,榮群,25,2,23,陽信-石牌,2024-05-27,8711
2405,輔信,27,5,22,陽信-石牌,2024-05-27,8711
1815,富喬,78,56,22,陽信-石牌,2024-05-27,8711
8096,擎亞,37,16,21,陽信-石牌,2024-05-27,8711
3380,明泰,20,0,20,陽信-石牌,2024-05-27,8711
2453,凌群,26,7,19,陽信-石牌,2024-05-27,8711
3060,銘異,32,13,19,陽信-石牌,2024-05-27,8711
3483,力致,27,8,19,陽信-石牌,2024-05-27,8711
3715,定穎投控,22,3,19,陽信-石牌,2024-05-27,8711
00931B,統一美債20年,20,5,15,陽信-石牌,2024-05-27,8711
2832,台產,15,0,15,陽信-石牌,2024-05-27,8711
3227,原相,20,5,15,陽信-石牌,2024-05-27,8711
6753,龍德造船,13,0,13,陽信-石牌,2024-05-27,8711
00857B,永豐20年美公債,15,3,12,陽信-石牌,2024-05-27,8711
00712,復華富時不動產,12,0,12,陽信-石牌,2024-05-27,8711
2352,佳世達,12,0,12,陽信-石牌,2024-05-27,8711
2892,第一金,12,0,12,陽信-石牌,2024-05-27,8711
6271,同欣電,16,4,12,陽信-石牌,2024-05-27,8711
00679B,元大美債20年,11,0,11,陽信-石牌,2024-05-27,8711
2331,精英,12,1,11,陽信-石牌,2024-05-27,8711
2404,漢唐,11,0,11,陽信-石牌,2024-05-27,8711
3019,亞光,11,0,11,陽信-石牌,2024-05-27,8711
3034,聯詠,12,1,11,陽信-石牌,2024-05-27,8711
3047,訊舟,14,3,11,陽信-石牌,2024-05-27,8711
8234,新漢,36,25,11,陽信-石牌,2024-05-27,8711
1215,卜蜂,10,0,10,陽信-石牌,2024-05-27,8711
00632R,元大台灣50反1,10,0,10,陽信-石牌,2024-05-27,8711
00919,群益台灣精選高息,124,21,103,陽信-石牌,2024-05-28,8711
2354,鴻準,203,118,85,陽信-石牌,2024-05-28,8711
00937B,群益ESG投等債20,98,13,85,陽信-石牌,2024-05-28,8711
00712,復華富時不動產,67,0,67,陽信-石牌,2024-05-28,8711
3450,聯鈞,68,5,63,陽信-石牌,2024-05-28,8711
2382,廣達,65,7,58,陽信-石牌,2024-05-28,8711
6188,廣明,97,42,55,陽信-石牌,2024-05-28,8711
3202,樺晟,54,1,53,陽信-石牌,2024-05-28,8711
00632R,元大台灣50反1,50,0,50,陽信-石牌,2024-05-28,8711
4157,太景*-KY,50,0,50,陽信-石牌,2024-05-28,8711
3673,TPK-KY,50,5,45,陽信-石牌,2024-05-28,8711
3483,力致,64,22,42,陽信-石牌,2024-05-28,8711
00940,元大台灣價值高息,63,22,41,陽信-石牌,2024-05-28,8711
5512,力麒,41,4,37,陽信-石牌,2024-05-28,8711
6472,保瑞,35,3,32,陽信-石牌,2024-05-28,8711
3122,笙泉,36,5,31,陽信-石牌,2024-05-28,8711
5522,遠雄,30,0,30,陽信-石牌,2024-05-28,8711
8112,至上,30,0,30,陽信-石牌,2024-05-28,8711
2442,新美齊,30,1,29,陽信-石牌,2024-05-28,8711
6213,聯茂,41,13,28,陽信-石牌,2024-05-28,8711
2615,萬海,31,4,27,陽信-石牌,2024-05-28,8711
2881,富邦金,31,4,27,陽信-石牌,2024-05-28,8711
3594,磐儀,38,13,25,陽信-石牌,2024-05-28,8711
2449,京元電子,25,3,22,陽信-石牌,2024-05-28,8711
1215,卜蜂,20,0,20,陽信-石牌,2024-05-28,8711
00665L,富邦�琤肭磪囓�2,55,35,20,陽信-石牌,2024-05-28,8711
3017,奇鋐,28,9,19,陽信-石牌,2024-05-28,8711
2301,光寶科,18,0,18,陽信-石牌,2024-05-28,8711
2324,仁寶,21,5,16,陽信-石牌,2024-05-28,8711
00650L,復華香港正2,15,0,15,陽信-石牌,2024-05-28,8711
2891,中信金,16,1,15,陽信-石牌,2024-05-28,8711
6128,上福,15,0,15,陽信-石牌,2024-05-28,8711
2406,國碩,14,0,14,陽信-石牌,2024-05-28,8711
3044,健鼎,15,1,14,陽信-石牌,2024-05-28,8711
3047,訊舟,26,12,14,陽信-石牌,2024-05-28,8711
5706,鳳凰,14,0,14,陽信-石牌,2024-05-28,8711
6133,金橋,14,0,14,陽信-石牌,2024-05-28,8711
2444,兆勁,13,0,13,陽信-石牌,2024-05-28,8711
5498,凱崴,15,2,13,陽信-石牌,2024-05-28,8711
00929,復華台灣科技優息,12,0,12,陽信-石牌,2024-05-28,8711
2349,錸德,20,8,12,陽信-石牌,2024-05-28,8711
3338,泰碩,13,1,12,陽信-石牌,2024-05-28,8711
5371,中光電,15,3,12,陽信-石牌,2024-05-28,8711
8222,寶一,15,3,12,陽信-石牌,2024-05-28,8711
9105,泰金寶-DR,32,20,12,陽信-石牌,2024-05-28,8711
1453,大將,11,0,11,陽信-石牌,2024-05-28,8711
1303,南亞,21,10,11,陽信-石牌,2024-05-28,8711
2363,矽統,44,33,11,陽信-石牌,2024-05-28,8711
2421,建準,18,7,11,陽信-石牌,2024-05-28,8711
2495,普安,11,0,11,陽信-石牌,2024-05-28,8711
00937B,群益ESG投等債20,551,20,531,陽信-石牌,2024-05-29,8711
2330,台積電,119,1,118,陽信-石牌,2024-05-29,8711
2867,三商壽,105,0,105,陽信-石牌,2024-05-29,8711
2489,瑞軒,373,276,97,陽信-石牌,2024-05-29,8711
00751B,元大AAA至A公司債,88,0,88,陽信-石牌,2024-05-29,8711
2353,宏��,221,138,83,陽信-石牌,2024-05-29,8711
2354,鴻準,276,210,66,陽信-石牌,2024-05-29,8711
2317,鴻海,74,16,58,陽信-石牌,2024-05-29,8711
3041,揚智,56,0,56,陽信-石牌,2024-05-29,8711
2601,益航,61,6,55,陽信-石牌,2024-05-29,8711
2520,冠德,54,0,54,陽信-石牌,2024-05-29,8711
00857B,永豐20年美公債,52,0,52,陽信-石牌,2024-05-29,8711
3202,樺晟,50,1,49,陽信-石牌,2024-05-29,8711
2885,元大金,40,1,39,陽信-石牌,2024-05-29,8711
2605,新興,77,40,37,陽信-石牌,2024-05-29,8711
3015,全漢,37,0,37,陽信-石牌,2024-05-29,8711
3047,訊舟,50,15,35,陽信-石牌,2024-05-29,8711
9105,泰金寶-DR,35,0,35,陽信-石牌,2024-05-29,8711
2408,南亞科,52,22,30,陽信-石牌,2024-05-29,8711
1215,卜蜂,30,0,30,陽信-石牌,2024-05-29,8711
2417,圓剛,41,11,30,陽信-石牌,2024-05-29,8711
00946,群益科技高息成長,26,0,26,陽信-石牌,2024-05-29,8711
1440,南紡,30,4,26,陽信-石牌,2024-05-29,8711
2836,高雄銀,25,0,25,陽信-石牌,2024-05-29,8711
00918,大華優利高填息30,34,10,24,陽信-石牌,2024-05-29,8711
00933B,國泰10Y+金融債,23,0,23,陽信-石牌,2024-05-29,8711
00673R,期元大S＆P原油反1,22,0,22,陽信-石牌,2024-05-29,8711
2515,中工,32,10,22,陽信-石牌,2024-05-29,8711
6125,廣運,33,12,21,陽信-石牌,2024-05-29,8711
00931B,統一美債20年,20,0,20,陽信-石牌,2024-05-29,8711
00650L,復華香港正2,20,0,20,陽信-石牌,2024-05-29,8711
2201,裕隆,21,1,20,陽信-石牌,2024-05-29,8711
2832,台產,20,0,20,陽信-石牌,2024-05-29,8711
5302,太欣,20,0,20,陽信-石牌,2024-05-29,8711
2340,台亞,20,1,19,陽信-石牌,2024-05-29,8711
2349,錸德,29,10,19,陽信-石牌,2024-05-29,8711
3380,明泰,22,3,19,陽信-石牌,2024-05-29,8711
2409,友達,18,0,18,陽信-石牌,2024-05-29,8711
2328,廣宇,25,8,17,陽信-石牌,2024-05-29,8711
2886,兆豐金,16,0,16,陽信-石牌,2024-05-29,8711
00772B,中信高評級公司債,15,0,15,陽信-石牌,2024-05-29,8711
00679B,元大美債20年,18,3,15,陽信-石牌,2024-05-29,8711
1905,華紙,15,0,15,陽信-石牌,2024-05-29,8711
2891,中信金,20,5,15,陽信-石牌,2024-05-29,8711
6189,豐藝,20,5,15,陽信-石牌,2024-05-29,8711
00712,復華富時不動產,14,0,14,陽信-石牌,2024-05-29,8711
2603,長榮,17,3,14,陽信-石牌,2024-05-29,8711
2883,凱基金,14,0,14,陽信-石牌,2024-05-29,8711
3021,鴻名,14,0,14,陽信-石牌,2024-05-29,8711
3231,緯創,29,15,14,陽信-石牌,2024-05-29,8711
00632R,元大台灣50反1,898,10,888,陽信-石牌,2024-05-30,8711
00937B,群益ESG投等債20,148,9,139,陽信-石牌,2024-05-30,8711
2330,台積電,116,0,116,陽信-石牌,2024-05-30,8711
3060,銘異,81,3,78,陽信-石牌,2024-05-30,8711
9105,泰金寶-DR,84,30,54,陽信-石牌,2024-05-30,8711
00680L,元大美債20正2,52,0,52,陽信-石牌,2024-05-30,8711
00650L,復華香港正2,50,3,47,陽信-石牌,2024-05-30,8711
6209,今國光,88,43,45,陽信-石牌,2024-05-30,8711
00929,復華台灣科技優息,36,0,36,陽信-石牌,2024-05-30,8711
00671R,富邦NASDAQ反1,35,0,35,陽信-石牌,2024-05-30,8711
1815,富喬,100,65,35,陽信-石牌,2024-05-30,8711
2365,昆盈,51,19,32,陽信-石牌,2024-05-30,8711
02001L,富邦蘋果正二N,31,0,31,陽信-石牌,2024-05-30,8711
2834,臺企銀,31,0,31,陽信-石牌,2024-05-30,8711
00681R,元大美債20反1,30,0,30,陽信-石牌,2024-05-30,8711
2353,宏��,85,55,30,陽信-石牌,2024-05-30,8711
2344,華邦電,31,2,29,陽信-石牌,2024-05-30,8711
00712,復華富時不動產,26,0,26,陽信-石牌,2024-05-30,8711
5230,雷笛克光學,49,23,26,陽信-石牌,2024-05-30,8711
5512,力麒,30,4,26,陽信-石牌,2024-05-30,8711
2317,鴻海,32,8,24,陽信-石牌,2024-05-30,8711
2303,聯電,42,18,24,陽信-石牌,2024-05-30,8711
2881,富邦金,25,1,24,陽信-石牌,2024-05-30,8711
2009,第一銅,24,1,23,陽信-石牌,2024-05-30,8711
2609,陽明,30,7,23,陽信-石牌,2024-05-30,8711
2634,漢翔,23,1,22,陽信-石牌,2024-05-30,8711
2885,元大金,22,0,22,陽信-石牌,2024-05-30,8711
2891,中信金,23,1,22,陽信-石牌,2024-05-30,8711
2356,英業達,30,9,21,陽信-石牌,2024-05-30,8711
4743,合一,21,0,21,陽信-石牌,2024-05-30,8711
4916,事欣科,21,0,21,陽信-石牌,2024-05-30,8711
00933B,國泰10Y+金融債,20,0,20,陽信-石牌,2024-05-30,8711
00898,國泰基因免疫革命,20,0,20,陽信-石牌,2024-05-30,8711
2886,兆豐金,19,0,19,陽信-石牌,2024-05-30,8711
6770,力積電,35,16,19,陽信-石牌,2024-05-30,8711
2002,中鋼,18,0,18,陽信-石牌,2024-05-30,8711
2615,萬海,22,4,18,陽信-石牌,2024-05-30,8711
00687B,國泰20年美債,17,0,17,陽信-石牌,2024-05-30,8711
2369,菱生,19,2,17,陽信-石牌,2024-05-30,8711
6290,良維,41,24,17,陽信-石牌,2024-05-30,8711
2371,大同,17,1,16,陽信-石牌,2024-05-30,8711
00857B,永豐20年美公債,16,0,16,陽信-石牌,2024-05-30,8711
6188,廣明,33,18,15,陽信-石牌,2024-05-30,8711
00665L,富邦�琤肭磪囓�2,15,0,15,陽信-石牌,2024-05-30,8711
00725B,國泰投資級公司債,15,0,15,陽信-石牌,2024-05-30,8711
1609,大亞,15,0,15,陽信-石牌,2024-05-30,8711
2331,精英,18,3,15,陽信-石牌,2024-05-30,8711
2618,長榮航,21,6,15,陽信-石牌,2024-05-30,8711
4401,東隆興,15,0,15,陽信-石牌,2024-05-30,8711
2328,廣宇,19,5,14,陽信-石牌,2024-05-30,8711
2609,陽明,317,129,188,陽信-石牌,2024-05-31,8711
2886,兆豐金,167,0,167,陽信-石牌,2024-05-31,8711
00919,群益台灣精選高息,161,12,149,陽信-石牌,2024-05-31,8711
2330,台積電,117,0,117,陽信-石牌,2024-05-31,8711
2317,鴻海,123,8,115,陽信-石牌,2024-05-31,8711
1314,中石化,110,0,110,陽信-石牌,2024-05-31,8711
00632R,元大台灣50反1,100,15,85,陽信-石牌,2024-05-31,8711
2303,聯電,82,2,80,陽信-石牌,2024-05-31,8711
2353,宏��,100,22,78,陽信-石牌,2024-05-31,8711
6188,廣明,108,49,59,陽信-石牌,2024-05-31,8711
2464,盟立,108,57,51,陽信-石牌,2024-05-31,8711
5475,德宏,50,0,50,陽信-石牌,2024-05-31,8711
3231,緯創,51,5,46,陽信-石牌,2024-05-31,8711
2367,燿華,58,16,42,陽信-石牌,2024-05-31,8711
3290,東浦,40,0,40,陽信-石牌,2024-05-31,8711
2344,華邦電,37,0,37,陽信-石牌,2024-05-31,8711
2349,錸德,34,0,34,陽信-石牌,2024-05-31,8711
1611,中電,32,2,30,陽信-石牌,2024-05-31,8711
2601,益航,30,0,30,陽信-石牌,2024-05-31,8711
3015,全漢,30,0,30,陽信-石牌,2024-05-31,8711
4142,國光生,30,0,30,陽信-石牌,2024-05-31,8711
1464,得力,27,0,27,陽信-石牌,2024-05-31,8711
1725,元禎,30,4,26,陽信-石牌,2024-05-31,8711
2328,廣宇,27,3,24,陽信-石牌,2024-05-31,8711
6290,良維,27,4,23,陽信-石牌,2024-05-31,8711
2409,友達,26,4,22,陽信-石牌,2024-05-31,8711
00929,復華台灣科技優息,45,23,22,陽信-石牌,2024-05-31,8711
2406,國碩,24,2,22,陽信-石牌,2024-05-31,8711
2002,中鋼,21,0,21,陽信-石牌,2024-05-31,8711
2449,京元電子,31,11,20,陽信-石牌,2024-05-31,8711
2610,華航,88,68,20,陽信-石牌,2024-05-31,8711
4157,太景*-KY,20,0,20,陽信-石牌,2024-05-31,8711
5410,國眾,20,0,20,陽信-石牌,2024-05-31,8711
9904,寶成,20,0,20,陽信-石牌,2024-05-31,8711
00946,群益科技高息成長,24,6,18,陽信-石牌,2024-05-31,8711
00918,大華優利高填息30,16,0,16,陽信-石牌,2024-05-31,8711
2356,英業達,24,8,16,陽信-石牌,2024-05-31,8711
1102,亞泥,15,0,15,陽信-石牌,2024-05-31,8711
1447,力鵬,15,0,15,陽信-石牌,2024-05-31,8711
3032,偉訓,16,1,15,陽信-石牌,2024-05-31,8711
6257,矽格,14,0,14,陽信-石牌,2024-05-31,8711
2615,萬海,22,9,13,陽信-石牌,2024-05-31,8711
1815,富喬,82,70,12,陽信-石牌,2024-05-31,8711
2369,菱生,22,10,12,陽信-石牌,2024-05-31,8711
4906,正文,23,11,12,陽信-石牌,2024-05-31,8711
6695,芯鼎,19,7,12,陽信-石牌,2024-05-31,8711
8096,擎亞,12,0,12,陽信-石牌,2024-05-31,8711
2376,技嘉,12,1,11,陽信-石牌,2024-05-31,8711
3380,明泰,13,2,11,陽信-石牌,2024-05-31,8711
6202,盛群,11,0,11,陽信-石牌,2024-05-31,8711
00919,群益台灣精選高息,191,3,188,陽信-石牌,2024-06-03,8711
00940,元大台灣價值高息,132,0,132,陽信-石牌,2024-06-03,8711
2888,新光金,153,30,123,陽信-石牌,2024-06-03,8711
9105,泰金寶-DR,124,10,114,陽信-石牌,2024-06-03,8711
2464,盟立,180,69,111,陽信-石牌,2024-06-03,8711
3059,華晶科,104,1,103,陽信-石牌,2024-06-03,8711
2504,國產,64,2,62,陽信-石牌,2024-06-03,8711
3202,樺晟,57,1,56,陽信-石牌,2024-06-03,8711
2886,兆豐金,43,0,43,陽信-石牌,2024-06-03,8711
00918,大華優利高填息30,41,0,41,陽信-石牌,2024-06-03,8711
2537,聯上發,50,9,41,陽信-石牌,2024-06-03,8711
2427,三商電,56,18,38,陽信-石牌,2024-06-03,8711
2371,大同,38,1,37,陽信-石牌,2024-06-03,8711
1464,得力,37,0,37,陽信-石牌,2024-06-03,8711
2303,聯電,55,20,35,陽信-石牌,2024-06-03,8711
2618,長榮航,34,1,33,陽信-石牌,2024-06-03,8711
00915,凱基優選高股息30,52,21,31,陽信-石牌,2024-06-03,8711
3231,緯創,46,16,30,陽信-石牌,2024-06-03,8711
4157,太景*-KY,30,0,30,陽信-石牌,2024-06-03,8711
2317,鴻海,35,9,26,陽信-石牌,2024-06-03,8711
2382,廣達,28,5,23,陽信-石牌,2024-06-03,8711
6213,聯茂,25,2,23,陽信-石牌,2024-06-03,8711
0056,元大高股息,23,1,22,陽信-石牌,2024-06-03,8711
6161,捷波,32,10,22,陽信-石牌,2024-06-03,8711
2601,益航,21,0,21,陽信-石牌,2024-06-03,8711
00665L,富邦�琤肭磪囓�2,45,25,20,陽信-石牌,2024-06-03,8711
2832,台產,20,0,20,陽信-石牌,2024-06-03,8711
2881,富邦金,20,0,20,陽信-石牌,2024-06-03,8711
8050,廣積,20,0,20,陽信-石牌,2024-06-03,8711
1504,東元,24,5,19,陽信-石牌,2024-06-03,8711
5371,中光電,24,6,18,陽信-石牌,2024-06-03,8711
00939,統一台灣高息動能,17,0,17,陽信-石牌,2024-06-03,8711
3483,力致,20,3,17,陽信-石牌,2024-06-03,8711
5465,富驊,16,0,16,陽信-石牌,2024-06-03,8711
2615,萬海,39,23,16,陽信-石牌,2024-06-03,8711
00688L,國泰20年美債正2,15,0,15,陽信-石牌,2024-06-03,8711
00753L,中信中國50正2,15,0,15,陽信-石牌,2024-06-03,8711
2408,南亞科,18,3,15,陽信-石牌,2024-06-03,8711
2201,裕隆,13,0,13,陽信-石牌,2024-06-03,8711
2534,宏盛,18,5,13,陽信-石牌,2024-06-03,8711
4562,穎漢,14,1,13,陽信-石牌,2024-06-03,8711
4726,永昕,13,0,13,陽信-石牌,2024-06-03,8711
6491,晶碩,24,11,13,陽信-石牌,2024-06-03,8711
8028,昇陽半導體,31,18,13,陽信-石牌,2024-06-03,8711
2002,中鋼,12,0,12,陽信-石牌,2024-06-03,8711
2489,瑞軒,15,4,11,陽信-石牌,2024-06-03,8711
1519,華城,15,4,11,陽信-石牌,2024-06-03,8711
1215,卜蜂,10,0,10,陽信-石牌,2024-06-03,8711
1514,亞力,10,0,10,陽信-石牌,2024-06-03,8711
2009,第一銅,10,0,10,陽信-石牌,2024-06-03,8711
2888,新光金,631,151,480,陽信-石牌,2024-06-04,8711
00919,群益台灣精選高息,106,4,102,陽信-石牌,2024-06-04,8711
2504,國產,97,1,96,陽信-石牌,2024-06-04,8711
2324,仁寶,116,21,95,陽信-石牌,2024-06-04,8711
00929,復華台灣科技優息,97,14,83,陽信-石牌,2024-06-04,8711
1802,台玻,72,0,72,陽信-石牌,2024-06-04,8711
00680L,元大美債20正2,60,0,60,陽信-石牌,2024-06-04,8711
2303,聯電,68,11,57,陽信-石牌,2024-06-04,8711
6112,邁達特,50,0,50,陽信-石牌,2024-06-04,8711
0056,元大高股息,48,0,48,陽信-石牌,2024-06-04,8711
00918,大華優利高填息30,47,0,47,陽信-石牌,2024-06-04,8711
2317,鴻海,68,22,46,陽信-石牌,2024-06-04,8711
2356,英業達,45,2,43,陽信-石牌,2024-06-04,8711
3481,群創,42,0,42,陽信-石牌,2024-06-04,8711
1234,黑松,41,0,41,陽信-石牌,2024-06-04,8711
4533,協易機,46,7,39,陽信-石牌,2024-06-04,8711
2354,鴻準,51,13,38,陽信-石牌,2024-06-04,8711
2312,金寶,44,10,34,陽信-石牌,2024-06-04,8711
2344,華邦電,42,8,34,陽信-石牌,2024-06-04,8711
2537,聯上發,44,11,33,陽信-石牌,2024-06-04,8711
1314,中石化,30,0,30,陽信-石牌,2024-06-04,8711
4707,磐亞,30,0,30,陽信-石牌,2024-06-04,8711
2486,一詮,39,13,26,陽信-石牌,2024-06-04,8711
6451,訊芯-KY,24,0,24,陽信-石牌,2024-06-04,8711
2367,燿華,58,35,23,陽信-石牌,2024-06-04,8711
5371,中光電,25,4,21,陽信-石牌,2024-06-04,8711
3024,憶聲,20,0,20,陽信-石牌,2024-06-04,8711
4927,泰鼎-KY,20,0,20,陽信-石牌,2024-06-04,8711
6770,力積電,20,0,20,陽信-石牌,2024-06-04,8711
8105,凌巨,20,0,20,陽信-石牌,2024-06-04,8711
2880,華南金,20,1,19,陽信-石牌,2024-06-04,8711
3715,定穎投控,18,0,18,陽信-石牌,2024-06-04,8711
3260,威剛,18,0,18,陽信-石牌,2024-06-04,8711
4562,穎漢,25,8,17,陽信-石牌,2024-06-04,8711
2332,友訊,17,0,17,陽信-石牌,2024-06-04,8711
6215,和椿,17,1,16,陽信-石牌,2024-06-04,8711
00632R,元大台灣50反1,25,10,15,陽信-石牌,2024-06-04,8711
2801,彰銀,15,0,15,陽信-石牌,2024-06-04,8711
3043,科風,15,0,15,陽信-石牌,2024-06-04,8711
3706,神達,20,5,15,陽信-石牌,2024-06-04,8711
1303,南亞,14,0,14,陽信-石牌,2024-06-04,8711
1785,光洋科,14,0,14,陽信-石牌,2024-06-04,8711
4526,東台,16,2,14,陽信-石牌,2024-06-04,8711
6120,達運,14,0,14,陽信-石牌,2024-06-04,8711
2002,中鋼,17,4,13,陽信-石牌,2024-06-04,8711
2409,友達,15,2,13,陽信-石牌,2024-06-04,8711
4903,聯光通,14,1,13,陽信-石牌,2024-06-04,8711
6126,信音,13,0,13,陽信-石牌,2024-06-04,8711
8107,大億金茂,13,0,13,陽信-石牌,2024-06-04,8711
00878,國泰永續高股息,13,0,13,陽信-石牌,2024-06-04,8711
00929,復華台灣科技優息,128,0,128,陽信-石牌,2024-06-05,8711
1464,得力,101,0,101,陽信-石牌,2024-06-05,8711
2303,聯電,97,12,85,陽信-石牌,2024-06-05,8711
2344,華邦電,66,0,66,陽信-石牌,2024-06-05,8711
00715L,期街口布蘭特正2,58,0,58,陽信-石牌,2024-06-05,8711
2495,普安,71,22,49,陽信-石牌,2024-06-05,8711
2892,第一金,50,5,45,陽信-石牌,2024-06-05,8711
6112,邁達特,40,0,40,陽信-石牌,2024-06-05,8711
6209,今國光,37,1,36,陽信-石牌,2024-06-05,8711
00936,台新永續高息中小,38,5,33,陽信-石牌,2024-06-05,8711
3060,銘異,49,16,33,陽信-石牌,2024-06-05,8711
3450,聯鈞,35,2,33,陽信-石牌,2024-06-05,8711
2867,三商壽,30,0,30,陽信-石牌,2024-06-05,8711
00878,國泰永續高股息,40,10,30,陽信-石牌,2024-06-05,8711
3483,力致,31,2,29,陽信-石牌,2024-06-05,8711
2009,第一銅,56,31,25,陽信-石牌,2024-06-05,8711
2836,高雄銀,25,0,25,陽信-石牌,2024-06-05,8711
4960,誠美材,25,0,25,陽信-石牌,2024-06-05,8711
3360,尚立,23,0,23,陽信-石牌,2024-06-05,8711
5608,四維航,25,3,22,陽信-石牌,2024-06-05,8711
3231,緯創,24,3,21,陽信-石牌,2024-06-05,8711
00665L,富邦�琤肭磪囓�2,45,25,20,陽信-石牌,2024-06-05,8711
9933,中鼎,18,0,18,陽信-石牌,2024-06-05,8711
2610,華航,23,7,16,陽信-石牌,2024-06-05,8711
2881,富邦金,20,4,16,陽信-石牌,2024-06-05,8711
3057,喬鼎,16,0,16,陽信-石牌,2024-06-05,8711
2105,正新,15,0,15,陽信-石牌,2024-06-05,8711
2352,佳世達,15,0,15,陽信-石牌,2024-06-05,8711
2504,國產,20,5,15,陽信-石牌,2024-06-05,8711
3032,偉訓,15,0,15,陽信-石牌,2024-06-05,8711
2101,南港,25,11,14,陽信-石牌,2024-06-05,8711
6695,芯鼎,14,0,14,陽信-石牌,2024-06-05,8711
00918,大華優利高填息30,13,0,13,陽信-石牌,2024-06-05,8711
3521,鴻翊,13,0,13,陽信-石牌,2024-06-05,8711
1802,台玻,12,0,12,陽信-石牌,2024-06-05,8711
2369,菱生,15,3,12,陽信-石牌,2024-06-05,8711
3372,典範,12,0,12,陽信-石牌,2024-06-05,8711
2406,國碩,11,0,11,陽信-石牌,2024-06-05,8711
3122,笙泉,11,0,11,陽信-石牌,2024-06-05,8711
6579,研揚,13,2,11,陽信-石牌,2024-06-05,8711
1301,台塑,10,0,10,陽信-石牌,2024-06-05,8711
3037,欣興,10,0,10,陽信-石牌,2024-06-05,8711
3017,奇鋐,13,3,10,陽信-石牌,2024-06-05,8711
00752,中信中國50,10,0,10,陽信-石牌,2024-06-05,8711
1584,精剛,10,0,10,陽信-石牌,2024-06-05,8711
2014,中鴻,10,0,10,陽信-石牌,2024-06-05,8711
2241,艾姆勒,10,0,10,陽信-石牌,2024-06-05,8711
3105,穩懋,10,0,10,陽信-石牌,2024-06-05,8711
3518,柏騰,10,0,10,陽信-石牌,2024-06-05,8711
3686,達能,10,0,10,陽信-石牌,2024-06-05,8711
1802,台玻,211,7,204,陽信-石牌,2024-06-06,8711
2882,國泰金,120,19,101,陽信-石牌,2024-06-06,8711
1304,台聚,68,0,68,陽信-石牌,2024-06-06,8711
2101,南港,62,2,60,陽信-石牌,2024-06-06,8711
00918,大華優利高填息30,57,6,51,陽信-石牌,2024-06-06,8711
2495,普安,60,11,49,陽信-石牌,2024-06-06,8711
2850,新產,47,0,47,陽信-石牌,2024-06-06,8711
2609,陽明,241,197,44,陽信-石牌,2024-06-06,8711
2409,友達,49,12,37,陽信-石牌,2024-06-06,8711
2331,精英,38,2,36,陽信-石牌,2024-06-06,8711
2601,益航,33,0,33,陽信-石牌,2024-06-06,8711
2365,昆盈,31,1,30,陽信-石牌,2024-06-06,8711
2208,台船,27,0,27,陽信-石牌,2024-06-06,8711
2478,大毅,26,0,26,陽信-石牌,2024-06-06,8711
3231,緯創,38,15,23,陽信-石牌,2024-06-06,8711
2312,金寶,58,35,23,陽信-石牌,2024-06-06,8711
2371,大同,22,1,21,陽信-石牌,2024-06-06,8711
8105,凌巨,21,0,21,陽信-石牌,2024-06-06,8711
00676R,富邦臺灣加權反1,20,0,20,陽信-石牌,2024-06-06,8711
2489,瑞軒,18,0,18,陽信-石牌,2024-06-06,8711
00713,元大台灣高息低波,18,1,17,陽信-石牌,2024-06-06,8711
5347,世界,48,32,16,陽信-石牌,2024-06-06,8711
6235,華孚,16,0,16,陽信-石牌,2024-06-06,8711
00936,台新永續高息中小,16,0,16,陽信-石牌,2024-06-06,8711
3062,建漢,16,1,15,陽信-石牌,2024-06-06,8711
6113,亞矽,15,0,15,陽信-石牌,2024-06-06,8711
9103,美德醫療-DR,16,2,14,陽信-石牌,2024-06-06,8711
2382,廣達,21,8,13,陽信-石牌,2024-06-06,8711
1101,台泥,13,0,13,陽信-石牌,2024-06-06,8711
00946,群益科技高息成長,13,0,13,陽信-石牌,2024-06-06,8711
2354,鴻準,28,15,13,陽信-石牌,2024-06-06,8711
2367,燿華,41,28,13,陽信-石牌,2024-06-06,8711
2427,三商電,17,4,13,陽信-石牌,2024-06-06,8711
1464,得力,12,0,12,陽信-石牌,2024-06-06,8711
1326,台化,11,0,11,陽信-石牌,2024-06-06,8711
6512,啟發電,11,0,11,陽信-石牌,2024-06-06,8711
2881,富邦金,20,10,10,陽信-石牌,2024-06-06,8711
1310,台苯,10,0,10,陽信-石牌,2024-06-06,8711
00665L,富邦�琤肭磪囓�2,15,5,10,陽信-石牌,2024-06-06,8711
1515,力山,10,0,10,陽信-石牌,2024-06-06,8711
2022,聚亨,10,0,10,陽信-石牌,2024-06-06,8711
2406,國碩,16,6,10,陽信-石牌,2024-06-06,8711
2425,承啟,10,0,10,陽信-石牌,2024-06-06,8711
5515,建國,10,0,10,陽信-石牌,2024-06-06,8711
5531,鄉林,10,0,10,陽信-石牌,2024-06-06,8711
1455,集盛,10,1,9,陽信-石牌,2024-06-06,8711
2611,志信,42,33,9,陽信-石牌,2024-06-06,8711
3706,神達,10,1,9,陽信-石牌,2024-06-06,8711
4961,天鈺,10,1,9,陽信-石牌,2024-06-06,8711
8027,鈦昇,11,2,9,陽信-石牌,2024-06-06,8711
2888,新光金,884,131,753,陽信-石牌,2024-06-07,8711
00664R,國泰臺灣加權反1,100,0,100,陽信-石牌,2024-06-07,8711
2317,鴻海,86,8,78,陽信-石牌,2024-06-07,8711
1440,南紡,62,2,60,陽信-石牌,2024-06-07,8711
2313,華通,64,9,55,陽信-石牌,2024-06-07,8711
1609,大亞,129,78,51,陽信-石牌,2024-06-07,8711
3015,全漢,50,0,50,陽信-石牌,2024-06-07,8711
2312,金寶,57,16,41,陽信-石牌,2024-06-07,8711
2852,第一保,40,0,40,陽信-石牌,2024-06-07,8711
6292,迅德,36,0,36,陽信-石牌,2024-06-07,8711
00929,復華台灣科技優息,37,2,35,陽信-石牌,2024-06-07,8711
00918,大華優利高填息30,34,0,34,陽信-石牌,2024-06-07,8711
3483,力致,43,10,33,陽信-石牌,2024-06-07,8711
0056,元大高股息,34,2,32,陽信-石牌,2024-06-07,8711
3231,緯創,34,2,32,陽信-石牌,2024-06-07,8711
2101,南港,40,8,32,陽信-石牌,2024-06-07,8711
8033,雷虎,30,0,30,陽信-石牌,2024-06-07,8711
00936,台新永續高息中小,29,0,29,陽信-石牌,2024-06-07,8711
1513,中興電,33,9,24,陽信-石牌,2024-06-07,8711
6257,矽格,24,0,24,陽信-石牌,2024-06-07,8711
02001L,富邦蘋果正二N,22,0,22,陽信-石牌,2024-06-07,8711
3372,典範,22,0,22,陽信-石牌,2024-06-07,8711
2634,漢翔,32,11,21,陽信-石牌,2024-06-07,8711
1785,光洋科,26,6,20,陽信-石牌,2024-06-07,8711
2208,台船,20,0,20,陽信-石牌,2024-06-07,8711
2832,台產,20,0,20,陽信-石牌,2024-06-07,8711
6244,茂迪,20,0,20,陽信-石牌,2024-06-07,8711
2464,盟立,25,6,19,陽信-石牌,2024-06-07,8711
2356,英業達,35,17,18,陽信-石牌,2024-06-07,8711
2385,群光,17,0,17,陽信-石牌,2024-06-07,8711
2330,台積電,18,1,17,陽信-石牌,2024-06-07,8711
6125,廣運,18,2,16,陽信-石牌,2024-06-07,8711
2301,光寶科,19,4,15,陽信-石牌,2024-06-07,8711
00937B,群益ESG投等債20,20,6,14,陽信-石牌,2024-06-07,8711
2324,仁寶,17,3,14,陽信-石牌,2024-06-07,8711
2382,廣達,14,2,12,陽信-石牌,2024-06-07,8711
1603,華電,23,11,12,陽信-石牌,2024-06-07,8711
2371,大同,18,6,12,陽信-石牌,2024-06-07,8711
2542,興富發,14,2,12,陽信-石牌,2024-06-07,8711
6005,群益證,12,0,12,陽信-石牌,2024-06-07,8711
6213,聯茂,13,1,12,陽信-石牌,2024-06-07,8711
6472,保瑞,24,12,12,陽信-石牌,2024-06-07,8711
8064,東捷,14,2,12,陽信-石牌,2024-06-07,8711
00830,國泰費城半導體,11,0,11,陽信-石牌,2024-06-07,8711
2881,富邦金,40,29,11,陽信-石牌,2024-06-07,8711
3060,銘異,29,18,11,陽信-石牌,2024-06-07,8711
00882,中信中國高股息,10,0,10,陽信-石牌,2024-06-07,8711
00651R,復華香港反1,10,0,10,陽信-石牌,2024-06-07,8711
00650L,復華香港正2,10,0,10,陽信-石牌,2024-06-07,8711
1702,南僑,10,0,10,陽信-石牌,2024-06-07,8711
9105,泰金寶-DR,250,5,245,陽信-石牌,2024-06-11,8711
00931B,統一美債20年,199,0,199,陽信-石牌,2024-06-11,8711
00937B,群益ESG投等債20,212,54,158,陽信-石牌,2024-06-11,8711
00936,台新永續高息中小,149,18,131,陽信-石牌,2024-06-11,8711
3202,樺晟,130,0,130,陽信-石牌,2024-06-11,8711
2609,陽明,252,135,117,陽信-石牌,2024-06-11,8711
00929,復華台灣科技優息,96,2,94,陽信-石牌,2024-06-11,8711
00919,群益台灣精選高息,84,0,84,陽信-石牌,2024-06-11,8711
2409,友達,70,5,65,陽信-石牌,2024-06-11,8711
2845,遠東銀,62,0,62,陽信-石牌,2024-06-11,8711
00687B,國泰20年美債,53,5,48,陽信-石牌,2024-06-11,8711
2323,中環,44,1,43,陽信-石牌,2024-06-11,8711
2615,萬海,92,50,42,陽信-石牌,2024-06-11,8711
2603,長榮,56,14,42,陽信-石牌,2024-06-11,8711
00795B,中信美國公債20年,31,0,31,陽信-石牌,2024-06-11,8711
2444,兆勁,41,10,31,陽信-石牌,2024-06-11,8711
1445,大宇,30,0,30,陽信-石牌,2024-06-11,8711
6113,亞矽,30,0,30,陽信-石牌,2024-06-11,8711
2537,聯上發,37,9,28,陽信-石牌,2024-06-11,8711
2356,英業達,31,4,27,陽信-石牌,2024-06-11,8711
1316,上曜,35,10,25,陽信-石牌,2024-06-11,8711
1301,台塑,25,2,23,陽信-石牌,2024-06-11,8711
2354,鴻準,29,6,23,陽信-石牌,2024-06-11,8711
2832,台產,22,0,22,陽信-石牌,2024-06-11,8711
1618,合機,32,11,21,陽信-石牌,2024-06-11,8711
2204,中華,21,0,21,陽信-石牌,2024-06-11,8711
3032,偉訓,21,0,21,陽信-石牌,2024-06-11,8711
6234,高僑,21,0,21,陽信-石牌,2024-06-11,8711
00680L,元大美債20正2,20,0,20,陽信-石牌,2024-06-11,8711
1616,億泰,21,1,20,陽信-石牌,2024-06-11,8711
2101,南港,20,0,20,陽信-石牌,2024-06-11,8711
2543,皇昌,21,1,20,陽信-石牌,2024-06-11,8711
4909,新復興,20,0,20,陽信-石牌,2024-06-11,8711
6270,倍微,20,0,20,陽信-石牌,2024-06-11,8711
8105,凌巨,20,0,20,陽信-石牌,2024-06-11,8711
00679B,元大美債20年,17,0,17,陽信-石牌,2024-06-11,8711
2515,中工,23,6,17,陽信-石牌,2024-06-11,8711
1514,亞力,37,21,16,陽信-石牌,2024-06-11,8711
00946,群益科技高息成長,21,6,15,陽信-石牌,2024-06-11,8711
2611,志信,20,5,15,陽信-石牌,2024-06-11,8711
4576,大銀微系統,15,0,15,陽信-石牌,2024-06-11,8711
9945,潤泰新,26,11,15,陽信-石牌,2024-06-11,8711
2374,佳能,35,20,15,陽信-石牌,2024-06-11,8711
2867,三商壽,15,1,14,陽信-石牌,2024-06-11,8711
3260,威剛,14,0,14,陽信-石牌,2024-06-11,8711
2002,中鋼,26,13,13,陽信-石牌,2024-06-11,8711
1815,富喬,79,66,13,陽信-石牌,2024-06-11,8711
00882,中信中國高股息,13,0,13,陽信-石牌,2024-06-11,8711
5426,振發,13,0,13,陽信-石牌,2024-06-11,8711
00942B,台新美A公司債20+,12,0,12,陽信-石牌,2024-06-11,8711
0050,元大台灣50,375,0,375,陽信-石牌,2024-06-12,8711
2367,燿華,209,103,106,陽信-石牌,2024-06-12,8711
1314,中石化,112,11,101,陽信-石牌,2024-06-12,8711
2851,中再保,70,0,70,陽信-石牌,2024-06-12,8711
2881,富邦金,57,0,57,陽信-石牌,2024-06-12,8711
4533,協易機,53,3,50,陽信-石牌,2024-06-12,8711
00715L,期街口布蘭特正2,67,20,47,陽信-石牌,2024-06-12,8711
00918,大華優利高填息30,52,5,47,陽信-石牌,2024-06-12,8711
2486,一詮,52,7,45,陽信-石牌,2024-06-12,8711
00919,群益台灣精選高息,45,1,44,陽信-石牌,2024-06-12,8711
00712,復華富時不動產,43,0,43,陽信-石牌,2024-06-12,8711
2409,友達,42,0,42,陽信-石牌,2024-06-12,8711
2201,裕隆,42,1,41,陽信-石牌,2024-06-12,8711
4157,太景*-KY,40,0,40,陽信-石牌,2024-06-12,8711
3481,群創,44,5,39,陽信-石牌,2024-06-12,8711
2101,南港,36,0,36,陽信-石牌,2024-06-12,8711
9103,美德醫療-DR,33,0,33,陽信-石牌,2024-06-12,8711
00948B,中信優息投資級債,31,0,31,陽信-石牌,2024-06-12,8711
2105,正新,64,36,28,陽信-石牌,2024-06-12,8711
2406,國碩,25,0,25,陽信-石牌,2024-06-12,8711
2482,連宇,23,0,23,陽信-石牌,2024-06-12,8711
2606,裕民,22,1,21,陽信-石牌,2024-06-12,8711
2331,精英,21,0,21,陽信-石牌,2024-06-12,8711
3202,樺晟,21,0,21,陽信-石牌,2024-06-12,8711
6770,力積電,20,1,19,陽信-石牌,2024-06-12,8711
2241,艾姆勒,17,0,17,陽信-石牌,2024-06-12,8711
6234,高僑,17,0,17,陽信-石牌,2024-06-12,8711
8110,華東,22,5,17,陽信-石牌,2024-06-12,8711
2888,新光金,21,5,16,陽信-石牌,2024-06-12,8711
2444,兆勁,15,0,15,陽信-石牌,2024-06-12,8711
3060,銘異,27,12,15,陽信-石牌,2024-06-12,8711
1514,亞力,18,5,13,陽信-石牌,2024-06-12,8711
1608,華榮,20,7,13,陽信-石牌,2024-06-12,8711
1609,大亞,13,0,13,陽信-石牌,2024-06-12,8711
6547,高端疫苗,13,0,13,陽信-石牌,2024-06-12,8711
2451,創見,14,2,12,陽信-石牌,2024-06-12,8711
3483,力致,12,0,12,陽信-石牌,2024-06-12,8711
6120,達運,12,0,12,陽信-石牌,2024-06-12,8711
1603,華電,12,1,11,陽信-石牌,2024-06-12,8711
2392,正崴,12,1,11,陽信-石牌,2024-06-12,8711
1215,卜蜂,10,0,10,陽信-石牌,2024-06-12,8711
00651R,復華香港反1,10,0,10,陽信-石牌,2024-06-12,8711
00687B,國泰20年美債,10,0,10,陽信-石牌,2024-06-12,8711
00795B,中信美國公債20年,10,0,10,陽信-石牌,2024-06-12,8711
00881,國泰台灣5G+,10,0,10,陽信-石牌,2024-06-12,8711
1444,力麗,10,0,10,陽信-石牌,2024-06-12,8711
1455,集盛,10,0,10,陽信-石牌,2024-06-12,8711
1598,岱宇,10,0,10,陽信-石牌,2024-06-12,8711
2538,基泰,10,0,10,陽信-石牌,2024-06-12,8711
2605,新興,39,29,10,陽信-石牌,2024-06-12,8711
1608,華榮,154,21,133,陽信-石牌,2024-06-13,8711
4157,太景*-KY,90,0,90,陽信-石牌,2024-06-13,8711
2891,中信金,74,0,74,陽信-石牌,2024-06-13,8711
2371,大同,81,18,63,陽信-石牌,2024-06-13,8711
5009,榮剛,60,0,60,陽信-石牌,2024-06-13,8711
00948B,中信優息投資級債,50,0,50,陽信-石牌,2024-06-13,8711
3015,全漢,50,0,50,陽信-石牌,2024-06-13,8711
6116,彩晶,50,0,50,陽信-石牌,2024-06-13,8711
00942B,台新美A公司債20+,40,0,40,陽信-石牌,2024-06-13,8711
5410,國眾,40,1,39,陽信-石牌,2024-06-13,8711
2867,三商壽,31,0,31,陽信-石牌,2024-06-13,8711
1229,聯華,30,0,30,陽信-石牌,2024-06-13,8711
3481,群創,36,6,30,陽信-石牌,2024-06-13,8711
1447,力鵬,30,2,28,陽信-石牌,2024-06-13,8711
2618,長榮航,33,5,28,陽信-石牌,2024-06-13,8711
6125,廣運,64,37,27,陽信-石牌,2024-06-13,8711
00946,群益科技高息成長,28,2,26,陽信-石牌,2024-06-13,8711
2356,英業達,109,83,26,陽信-石牌,2024-06-13,8711
5608,四維航,29,3,26,陽信-石牌,2024-06-13,8711
2105,正新,25,0,25,陽信-石牌,2024-06-13,8711
6290,良維,28,4,24,陽信-石牌,2024-06-13,8711
6526,達發,27,3,24,陽信-石牌,2024-06-13,8711
00929,復華台灣科技優息,27,5,22,陽信-石牌,2024-06-13,8711
6235,華孚,20,0,20,陽信-石牌,2024-06-13,8711
1215,卜蜂,20,0,20,陽信-石牌,2024-06-13,8711
6443,元晶,20,0,20,陽信-石牌,2024-06-13,8711
1514,亞力,22,3,19,陽信-石牌,2024-06-13,8711
00933B,國泰10Y+金融債,17,0,17,陽信-石牌,2024-06-13,8711
2603,長榮,27,10,17,陽信-石牌,2024-06-13,8711
1504,東元,30,14,16,陽信-石牌,2024-06-13,8711
8299,群聯,17,1,16,陽信-石牌,2024-06-13,8711
00927,群益半導體收益,15,0,15,陽信-石牌,2024-06-13,8711
9919,康那香,17,2,15,陽信-石牌,2024-06-13,8711
5258,虹堡,14,0,14,陽信-石牌,2024-06-13,8711
1605,華新,24,10,14,陽信-石牌,2024-06-13,8711
1725,元禎,14,0,14,陽信-石牌,2024-06-13,8711
2501,國建,15,1,14,陽信-石牌,2024-06-13,8711
6799,來頡,16,2,14,陽信-石牌,2024-06-13,8711
00937B,群益ESG投等債20,31,18,13,陽信-石牌,2024-06-13,8711
1815,富喬,35,23,12,陽信-石牌,2024-06-13,8711
2313,華通,29,17,12,陽信-石牌,2024-06-13,8711
2606,裕民,13,1,12,陽信-石牌,2024-06-13,8711
6274,台燿,12,0,12,陽信-石牌,2024-06-13,8711
3413,京鼎,12,0,12,陽信-石牌,2024-06-13,8711
2464,盟立,33,22,11,陽信-石牌,2024-06-13,8711
1522,堤維西,13,2,11,陽信-石牌,2024-06-13,8711
4967,十銓,23,12,11,陽信-石牌,2024-06-13,8711
00680L,元大美債20正2,15,5,10,陽信-石牌,2024-06-13,8711
00712,復華富時不動產,10,0,10,陽信-石牌,2024-06-13,8711
1616,億泰,10,0,10,陽信-石牌,2024-06-13,8711
2371,大同,337,179,158,陽信-石牌,2024-06-14,8711
00940,元大台灣價值高息,95,10,85,陽信-石牌,2024-06-14,8711
3202,樺晟,67,7,60,陽信-石牌,2024-06-14,8711
2313,華通,52,1,51,陽信-石牌,2024-06-14,8711
5234,達興材料,50,0,50,陽信-石牌,2024-06-14,8711
9904,寶成,49,0,49,陽信-石牌,2024-06-14,8711
1605,華新,54,7,47,陽信-石牌,2024-06-14,8711
2353,宏��,40,0,40,陽信-石牌,2024-06-14,8711
2637,慧洋-KY,40,0,40,陽信-石牌,2024-06-14,8711
00929,復華台灣科技優息,51,13,38,陽信-石牌,2024-06-14,8711
6125,廣運,40,3,37,陽信-石牌,2024-06-14,8711
00633L,富邦上証正2,32,0,32,陽信-石牌,2024-06-14,8711
6209,今國光,31,0,31,陽信-石牌,2024-06-14,8711
2344,華邦電,33,3,30,陽信-石牌,2024-06-14,8711
2538,基泰,30,0,30,陽信-石牌,2024-06-14,8711
3494,誠研,30,0,30,陽信-石牌,2024-06-14,8711
3048,益登,34,6,28,陽信-石牌,2024-06-14,8711
00919,群益台灣精選高息,55,29,26,陽信-石牌,2024-06-14,8711
00882,中信中國高股息,25,0,25,陽信-石牌,2024-06-14,8711
2367,燿華,105,80,25,陽信-石牌,2024-06-14,8711
2609,陽明,100,75,25,陽信-石牌,2024-06-14,8711
00687B,國泰20年美債,26,2,24,陽信-石牌,2024-06-14,8711
1325,恆大,33,10,23,陽信-石牌,2024-06-14,8711
00918,大華優利高填息30,27,4,23,陽信-石牌,2024-06-14,8711
2354,鴻準,36,15,21,陽信-石牌,2024-06-14,8711
2618,長榮航,29,8,21,陽信-石牌,2024-06-14,8711
2883,凱基金,21,0,21,陽信-石牌,2024-06-14,8711
2303,聯電,31,11,20,陽信-石牌,2024-06-14,8711
1722,台肥,20,0,20,陽信-石牌,2024-06-14,8711
2801,彰銀,20,0,20,陽信-石牌,2024-06-14,8711
6451,訊芯-KY,24,4,20,陽信-石牌,2024-06-14,8711
00679B,元大美債20年,18,0,18,陽信-石牌,2024-06-14,8711
2615,萬海,80,62,18,陽信-石牌,2024-06-14,8711
1447,力鵬,17,0,17,陽信-石牌,2024-06-14,8711
6491,晶碩,20,3,17,陽信-石牌,2024-06-14,8711
1587,吉茂,17,1,16,陽信-石牌,2024-06-14,8711
2324,仁寶,18,2,16,陽信-石牌,2024-06-14,8711
2547,日勝生,16,0,16,陽信-石牌,2024-06-14,8711
2881,富邦金,16,0,16,陽信-石牌,2024-06-14,8711
3483,力致,17,1,16,陽信-石牌,2024-06-14,8711
2105,正新,15,0,15,陽信-石牌,2024-06-14,8711
2201,裕隆,15,0,15,陽信-石牌,2024-06-14,8711
2363,矽統,17,2,15,陽信-石牌,2024-06-14,8711
2002,中鋼,14,0,14,陽信-石牌,2024-06-14,8711
1528,恩德,15,1,14,陽信-石牌,2024-06-14,8711
4543,萬在,15,2,13,陽信-石牌,2024-06-14,8711
5426,振發,13,0,13,陽信-石牌,2024-06-14,8711
2312,金寶,36,24,12,陽信-石牌,2024-06-14,8711
4979,華星光,12,1,11,陽信-石牌,2024-06-14,8711
6443,元晶,11,0,11,陽信-石牌,2024-06-14,8711
00679B,元大美債20年,528,21,507,陽信-石牌,2024-06-17,8711
00918,大華優利高填息30,397,2,395,陽信-石牌,2024-06-17,8711
3576,聯合再生,140,0,140,陽信-石牌,2024-06-17,8711
1102,亞泥,105,0,105,陽信-石牌,2024-06-17,8711
00720B,元大投資級公司債,75,0,75,陽信-石牌,2024-06-17,8711
00937B,群益ESG投等債20,73,1,72,陽信-石牌,2024-06-17,8711
1815,富喬,90,25,65,陽信-石牌,2024-06-17,8711
00772B,中信高評級公司債,75,11,64,陽信-石牌,2024-06-17,8711
00927,群益半導體收益,50,0,50,陽信-石牌,2024-06-17,8711
2515,中工,63,14,49,陽信-石牌,2024-06-17,8711
1234,黑松,80,35,45,陽信-石牌,2024-06-17,8711
2204,中華,42,1,41,陽信-石牌,2024-06-17,8711
2312,金寶,103,65,38,陽信-石牌,2024-06-17,8711
2615,萬海,91,57,34,陽信-石牌,2024-06-17,8711
4562,穎漢,55,21,34,陽信-石牌,2024-06-17,8711
00713,元大台灣高息低波,31,1,30,陽信-石牌,2024-06-17,8711
1608,華榮,28,2,26,陽信-石牌,2024-06-17,8711
6257,矽格,26,0,26,陽信-石牌,2024-06-17,8711
2323,中環,26,3,23,陽信-石牌,2024-06-17,8711
3041,揚智,43,20,23,陽信-石牌,2024-06-17,8711
2356,英業達,25,3,22,陽信-石牌,2024-06-17,8711
2486,一詮,24,2,22,陽信-石牌,2024-06-17,8711
3231,緯創,29,8,21,陽信-石牌,2024-06-17,8711
00933B,國泰10Y+金融債,31,10,21,陽信-石牌,2024-06-17,8711
2367,燿華,32,11,21,陽信-石牌,2024-06-17,8711
00712,復華富時不動產,20,0,20,陽信-石牌,2024-06-17,8711
1513,中興電,29,9,20,陽信-石牌,2024-06-17,8711
1528,恩德,25,5,20,陽信-石牌,2024-06-17,8711
6116,彩晶,21,1,20,陽信-石牌,2024-06-17,8711
6603,富強鑫,20,0,20,陽信-石牌,2024-06-17,8711
2317,鴻海,55,35,20,陽信-石牌,2024-06-17,8711
2101,南港,21,2,19,陽信-石牌,2024-06-17,8711
4908,前鼎,20,1,19,陽信-石牌,2024-06-17,8711
2002,中鋼,22,4,18,陽信-石牌,2024-06-17,8711
2834,臺企銀,23,6,17,陽信-石牌,2024-06-17,8711
2888,新光金,19,2,17,陽信-石牌,2024-06-17,8711
3024,憶聲,20,3,17,陽信-石牌,2024-06-17,8711
02001L,富邦蘋果正二N,16,0,16,陽信-石牌,2024-06-17,8711
00947,台新臺灣IC設計,17,1,16,陽信-石牌,2024-06-17,8711
2637,慧洋-KY,16,0,16,陽信-石牌,2024-06-17,8711
8085,福華,42,26,16,陽信-石牌,2024-06-17,8711
00929,復華台灣科技優息,24,9,15,陽信-石牌,2024-06-17,8711
5508,永信建,15,0,15,陽信-石牌,2024-06-17,8711
6213,聯茂,16,1,15,陽信-石牌,2024-06-17,8711
6806,森崴能源,15,0,15,陽信-石牌,2024-06-17,8711
6226,光鼎,14,0,14,陽信-石牌,2024-06-17,8711
1477,聚陽,12,0,12,陽信-石牌,2024-06-17,8711
1504,東元,14,2,12,陽信-石牌,2024-06-17,8711
00946,群益科技高息成長,11,0,11,陽信-石牌,2024-06-17,8711
6732,昇佳電子,11,0,11,陽信-石牌,2024-06-17,8711
1815,富喬,139,13,126,陽信-石牌,2024-06-18,8711
2504,國產,121,8,113,陽信-石牌,2024-06-18,8711
2882,國泰金,90,13,77,陽信-石牌,2024-06-18,8711
2303,聯電,110,36,74,陽信-石牌,2024-06-18,8711
9105,泰金寶-DR,72,3,69,陽信-石牌,2024-06-18,8711
00936,台新永續高息中小,67,1,66,陽信-石牌,2024-06-18,8711
1314,中石化,51,0,51,陽信-石牌,2024-06-18,8711
1504,東元,46,0,46,陽信-石牌,2024-06-18,8711
2548,華固,44,1,43,陽信-石牌,2024-06-18,8711
2371,大同,76,37,39,陽信-石牌,2024-06-18,8711
2367,燿華,55,17,38,陽信-石牌,2024-06-18,8711
911868,同方友友-DR,31,0,31,陽信-石牌,2024-06-18,8711
1718,中纖,30,0,30,陽信-石牌,2024-06-18,8711
4157,太景*-KY,30,0,30,陽信-石牌,2024-06-18,8711
2031,新光鋼,32,6,26,陽信-石牌,2024-06-18,8711
6505,台塑化,26,0,26,陽信-石牌,2024-06-18,8711
00929,復華台灣科技優息,26,3,23,陽信-石牌,2024-06-18,8711
2353,宏��,24,2,22,陽信-石牌,2024-06-18,8711
6547,高端疫苗,22,0,22,陽信-石牌,2024-06-18,8711
00637L,元大滬深300正2,21,0,21,陽信-石牌,2024-06-18,8711
2331,精英,23,2,21,陽信-石牌,2024-06-18,8711
00665L,富邦�琤肭磪囓�2,30,10,20,陽信-石牌,2024-06-18,8711
4927,泰鼎-KY,21,1,20,陽信-石牌,2024-06-18,8711
5443,均豪,40,20,20,陽信-石牌,2024-06-18,8711
4909,新復興,20,1,19,陽信-石牌,2024-06-18,8711
2206,三陽工業,20,2,18,陽信-石牌,2024-06-18,8711
5009,榮剛,80,62,18,陽信-石牌,2024-06-18,8711
00679B,元大美債20年,17,0,17,陽信-石牌,2024-06-18,8711
2301,光寶科,20,3,17,陽信-石牌,2024-06-18,8711
4562,穎漢,31,15,16,陽信-石牌,2024-06-18,8711
1909,榮成,16,0,16,陽信-石牌,2024-06-18,8711
3060,銘異,54,38,16,陽信-石牌,2024-06-18,8711
6270,倍微,16,0,16,陽信-石牌,2024-06-18,8711
8064,東捷,28,12,16,陽信-石牌,2024-06-18,8711
4566,時碩工業,28,13,15,陽信-石牌,2024-06-18,8711
00632R,元大台灣50反1,20,5,15,陽信-石牌,2024-06-18,8711
00946,群益科技高息成長,15,0,15,陽信-石牌,2024-06-18,8711
00918,大華優利高填息30,31,16,15,陽信-石牌,2024-06-18,8711
2547,日勝生,18,3,15,陽信-石牌,2024-06-18,8711
9921,巨大,15,0,15,陽信-石牌,2024-06-18,8711
4967,十銓,22,8,14,陽信-石牌,2024-06-18,8711
5522,遠雄,15,1,14,陽信-石牌,2024-06-18,8711
4543,萬在,13,0,13,陽信-石牌,2024-06-18,8711
1618,合機,13,1,12,陽信-石牌,2024-06-18,8711
2355,敬鵬,20,8,12,陽信-石牌,2024-06-18,8711
3665,貿聯-KY,12,0,12,陽信-石牌,2024-06-18,8711
8071,能率網通,17,5,12,陽信-石牌,2024-06-18,8711
2359,所羅門,23,12,11,陽信-石牌,2024-06-18,8711
1102,亞泥,11,0,11,陽信-石牌,2024-06-18,8711
3041,揚智,11,0,11,陽信-石牌,2024-06-18,8711
2344,華邦電,266,66,200,陽信-石牌,2024-06-19,8711
2801,彰銀,102,0,102,陽信-石牌,2024-06-19,8711
2606,裕民,100,1,99,陽信-石牌,2024-06-19,8711
2409,友達,96,2,94,陽信-石牌,2024-06-19,8711
2548,華固,91,1,90,陽信-石牌,2024-06-19,8711
1536,和大,80,0,80,陽信-石牌,2024-06-19,8711
2027,大成鋼,80,2,78,陽信-石牌,2024-06-19,8711
3494,誠研,58,0,58,陽信-石牌,2024-06-19,8711
6292,迅德,50,0,50,陽信-石牌,2024-06-19,8711
00936,台新永續高息中小,49,0,49,陽信-石牌,2024-06-19,8711
1802,台玻,76,28,48,陽信-石牌,2024-06-19,8711
2504,國產,44,0,44,陽信-石牌,2024-06-19,8711
3062,建漢,61,19,42,陽信-石牌,2024-06-19,8711
1215,卜蜂,40,0,40,陽信-石牌,2024-06-19,8711
2515,中工,34,0,34,陽信-石牌,2024-06-19,8711
2601,益航,31,0,31,陽信-石牌,2024-06-19,8711
4157,太景*-KY,31,0,31,陽信-石牌,2024-06-19,8711
00632R,元大台灣50反1,30,0,30,陽信-石牌,2024-06-19,8711
2204,中華,30,0,30,陽信-石牌,2024-06-19,8711
9103,美德醫療-DR,30,0,30,陽信-石牌,2024-06-19,8711
1514,亞力,67,38,29,陽信-石牌,2024-06-19,8711
00937B,群益ESG投等債20,44,17,27,陽信-石牌,2024-06-19,8711
2634,漢翔,26,0,26,陽信-石牌,2024-06-19,8711
4912,聯德控股-KY,26,0,26,陽信-石牌,2024-06-19,8711
00633L,富邦上証正2,25,0,25,陽信-石牌,2024-06-19,8711
8096,擎亞,43,18,25,陽信-石牌,2024-06-19,8711
6116,彩晶,50,26,24,陽信-石牌,2024-06-19,8711
8271,宇瞻,24,0,24,陽信-石牌,2024-06-19,8711
00935,野村臺灣新科技50,23,0,23,陽信-石牌,2024-06-19,8711
2367,燿華,34,13,21,陽信-石牌,2024-06-19,8711
6770,力積電,34,13,21,陽信-石牌,2024-06-19,8711
2545,皇翔,20,0,20,陽信-石牌,2024-06-19,8711
3229,晟鈦,20,0,20,陽信-石牌,2024-06-19,8711
4126,太醫,20,0,20,陽信-石牌,2024-06-19,8711
6234,高僑,20,0,20,陽信-石牌,2024-06-19,8711
6290,良維,19,1,18,陽信-石牌,2024-06-19,8711
2615,萬海,49,33,16,陽信-石牌,2024-06-19,8711
2538,基泰,15,0,15,陽信-石牌,2024-06-19,8711
2892,第一金,20,5,15,陽信-石牌,2024-06-19,8711
5522,遠雄,15,0,15,陽信-石牌,2024-06-19,8711
6207,雷科,15,0,15,陽信-石牌,2024-06-19,8711
8064,東捷,19,4,15,陽信-石牌,2024-06-19,8711
8099,大世科,20,5,15,陽信-石牌,2024-06-19,8711
0050,元大台灣50,16,2,14,陽信-石牌,2024-06-19,8711
4533,協易機,14,0,14,陽信-石牌,2024-06-19,8711
6451,訊芯-KY,16,2,14,陽信-石牌,2024-06-19,8711
3363,上詮,16,3,13,陽信-石牌,2024-06-19,8711
3379,彬台,13,0,13,陽信-石牌,2024-06-19,8711
5521,工信,13,0,13,陽信-石牌,2024-06-19,8711
6901,鑽石投資,41,28,13,陽信-石牌,2024-06-19,8711
00919,群益台灣精選高息,306,0,306,陽信-石牌,2024-06-20,8711
00937B,群益ESG投等債20,166,0,166,陽信-石牌,2024-06-20,8711
00706L,期元大S＆P日圓正2,70,0,70,陽信-石牌,2024-06-20,8711
1234,黑松,70,0,70,陽信-石牌,2024-06-20,8711
5009,榮剛,70,1,69,陽信-石牌,2024-06-20,8711
00940,元大台灣價值高息,76,30,46,陽信-石牌,2024-06-20,8711
2801,彰銀,40,0,40,陽信-石牌,2024-06-20,8711
8085,福華,44,5,39,陽信-石牌,2024-06-20,8711
2353,宏��,37,1,36,陽信-石牌,2024-06-20,8711
2707,晶華,31,0,31,陽信-石牌,2024-06-20,8711
2380,虹光,30,0,30,陽信-石牌,2024-06-20,8711
2548,華固,32,2,30,陽信-石牌,2024-06-20,8711
2891,中信金,30,0,30,陽信-石牌,2024-06-20,8711
6116,彩晶,30,0,30,陽信-石牌,2024-06-20,8711
3308,聯德,27,0,27,陽信-石牌,2024-06-20,8711
4126,太醫,25,0,25,陽信-石牌,2024-06-20,8711
5210,寶碩,25,0,25,陽信-石牌,2024-06-20,8711
2352,佳世達,24,0,24,陽信-石牌,2024-06-20,8711
00687B,國泰20年美債,23,0,23,陽信-石牌,2024-06-20,8711
2323,中環,25,2,23,陽信-石牌,2024-06-20,8711
00946,群益科技高息成長,22,0,22,陽信-石牌,2024-06-20,8711
4306,炎洲,22,1,21,陽信-石牌,2024-06-20,8711
6451,訊芯-KY,33,12,21,陽信-石牌,2024-06-20,8711
00931B,統一美債20年,20,0,20,陽信-石牌,2024-06-20,8711
00633L,富邦上証正2,20,0,20,陽信-石牌,2024-06-20,8711
00632R,元大台灣50反1,20,0,20,陽信-石牌,2024-06-20,8711
2426,鼎元,20,0,20,陽信-石牌,2024-06-20,8711
00637L,元大滬深300正2,20,1,19,陽信-石牌,2024-06-20,8711
00665L,富邦�琤肭磪囓�2,25,7,18,陽信-石牌,2024-06-20,8711
3481,群創,31,13,18,陽信-石牌,2024-06-20,8711
00936,台新永續高息中小,17,0,17,陽信-石牌,2024-06-20,8711
1215,卜蜂,57,40,17,陽信-石牌,2024-06-20,8711
3081,聯亞,18,1,17,陽信-石牌,2024-06-20,8711
2330,台積電,20,4,16,陽信-石牌,2024-06-20,8711
2409,友達,20,4,16,陽信-石牌,2024-06-20,8711
4979,華星光,16,1,15,陽信-石牌,2024-06-20,8711
3122,笙泉,15,0,15,陽信-石牌,2024-06-20,8711
9904,寶成,15,0,15,陽信-石牌,2024-06-20,8711
2371,大同,26,12,14,陽信-石牌,2024-06-20,8711
8064,東捷,24,10,14,陽信-石牌,2024-06-20,8711
8105,凌巨,26,12,14,陽信-石牌,2024-06-20,8711
00929,復華台灣科技優息,53,40,13,陽信-石牌,2024-06-20,8711
2489,瑞軒,13,0,13,陽信-石牌,2024-06-20,8711
6153,嘉聯益,13,0,13,陽信-石牌,2024-06-20,8711
6552,易華電,13,0,13,陽信-石牌,2024-06-20,8711
2002,中鋼,13,0,13,陽信-石牌,2024-06-20,8711
1503,士電,40,28,12,陽信-石牌,2024-06-20,8711
00939,統一台灣高息動能,15,4,11,陽信-石牌,2024-06-20,8711
2103,台橡,11,0,11,陽信-石牌,2024-06-20,8711
2377,微星,12,1,11,陽信-石牌,2024-06-20,8711
00937B,群益ESG投等債20,469,0,469,陽信-石牌,2024-06-21,8711
2504,國產,305,0,305,陽信-石牌,2024-06-21,8711
00637L,元大滬深300正2,80,1,79,陽信-石牌,2024-06-21,8711
6108,競國,70,0,70,陽信-石牌,2024-06-21,8711
2371,大同,64,2,62,陽信-石牌,2024-06-21,8711
3419,譁裕,60,1,59,陽信-石牌,2024-06-21,8711
00633L,富邦上証正2,45,0,45,陽信-石牌,2024-06-21,8711
2027,大成鋼,35,0,35,陽信-石牌,2024-06-21,8711
2492,華新科,33,0,33,陽信-石牌,2024-06-21,8711
2609,陽明,113,82,31,陽信-石牌,2024-06-21,8711
00930,永豐ESG低碳高息,30,0,30,陽信-石牌,2024-06-21,8711
00919,群益台灣精選高息,270,240,30,陽信-石牌,2024-06-21,8711
00706L,期元大S＆P日圓正2,30,0,30,陽信-石牌,2024-06-21,8711
2101,南港,31,1,30,陽信-石牌,2024-06-21,8711
4956,光鋐,32,2,30,陽信-石牌,2024-06-21,8711
6207,雷科,30,1,29,陽信-石牌,2024-06-21,8711
2317,鴻海,62,35,27,陽信-石牌,2024-06-21,8711
2382,廣達,38,11,27,陽信-石牌,2024-06-21,8711
2359,所羅門,34,9,25,陽信-石牌,2024-06-21,8711
00632R,元大台灣50反1,25,0,25,陽信-石牌,2024-06-21,8711
2603,長榮,24,1,23,陽信-石牌,2024-06-21,8711
8059,凱碩,23,0,23,陽信-石牌,2024-06-21,8711
8048,德勝,25,3,22,陽信-石牌,2024-06-21,8711
2020,美亞,20,0,20,陽信-石牌,2024-06-21,8711
2538,基泰,20,0,20,陽信-石牌,2024-06-21,8711
1301,台塑,21,3,18,陽信-石牌,2024-06-21,8711
2542,興富發,18,0,18,陽信-石牌,2024-06-21,8711
2388,威盛,19,1,18,陽信-石牌,2024-06-21,8711
6112,邁達特,21,4,17,陽信-石牌,2024-06-21,8711
6472,保瑞,50,33,17,陽信-石牌,2024-06-21,8711
00900,富邦特選高股息30,16,0,16,陽信-石牌,2024-06-21,8711
00907,永豐優息存股,16,0,16,陽信-石牌,2024-06-21,8711
2641,正德,22,6,16,陽信-石牌,2024-06-21,8711
2301,光寶科,46,31,15,陽信-石牌,2024-06-21,8711
00946,群益科技高息成長,15,0,15,陽信-石牌,2024-06-21,8711
1340,勝悅-KY,15,0,15,陽信-石牌,2024-06-21,8711
2892,第一金,15,0,15,陽信-石牌,2024-06-21,8711
6161,捷波,15,0,15,陽信-石牌,2024-06-21,8711
3312,弘憶股,17,3,14,陽信-石牌,2024-06-21,8711
6617,共信-KY,19,5,14,陽信-石牌,2024-06-21,8711
2330,台積電,20,7,13,陽信-石牌,2024-06-21,8711
2324,仁寶,21,8,13,陽信-石牌,2024-06-21,8711
3005,神基,15,2,13,陽信-石牌,2024-06-21,8711
3338,泰碩,15,2,13,陽信-石牌,2024-06-21,8711
02001L,富邦蘋果正二N,12,0,12,陽信-石牌,2024-06-21,8711
6216,居易,12,0,12,陽信-石牌,2024-06-21,8711
00947,台新臺灣IC設計,13,2,11,陽信-石牌,2024-06-21,8711
2606,裕民,16,5,11,陽信-石牌,2024-06-21,8711
4938,和碩,11,0,11,陽信-石牌,2024-06-21,8711
8996,高力,11,0,11,陽信-石牌,2024-06-21,8711
00632R,元大台灣50反1,998,15,983,陽信-石牌,2024-06-24,8711
3481,群創,925,179,746,陽信-石牌,2024-06-24,8711
00929,復華台灣科技優息,124,30,94,陽信-石牌,2024-06-24,8711
1785,光洋科,88,10,78,陽信-石牌,2024-06-24,8711
2409,友達,103,40,63,陽信-石牌,2024-06-24,8711
3062,建漢,81,27,54,陽信-石牌,2024-06-24,8711
8085,福華,60,7,53,陽信-石牌,2024-06-24,8711
5876,上海商銀,50,0,50,陽信-石牌,2024-06-24,8711
1314,中石化,51,5,46,陽信-石牌,2024-06-24,8711
1815,富喬,65,19,46,陽信-石牌,2024-06-24,8711
2353,宏��,49,4,45,陽信-石牌,2024-06-24,8711
6443,元晶,47,2,45,陽信-石牌,2024-06-24,8711
00637L,元大滬深300正2,61,20,41,陽信-石牌,2024-06-24,8711
00937B,群益ESG投等債20,61,24,37,陽信-石牌,2024-06-24,8711
3357,臺慶科,40,3,37,陽信-石牌,2024-06-24,8711
2882,國泰金,56,21,35,陽信-石牌,2024-06-24,8711
2365,昆盈,38,4,34,陽信-石牌,2024-06-24,8711
2888,新光金,104,70,34,陽信-石牌,2024-06-24,8711
2615,萬海,46,12,34,陽信-石牌,2024-06-24,8711
3231,緯創,48,18,30,陽信-石牌,2024-06-24,8711
2610,華航,34,4,30,陽信-石牌,2024-06-24,8711
2324,仁寶,39,10,29,陽信-石牌,2024-06-24,8711
2303,聯電,69,41,28,陽信-石牌,2024-06-24,8711
2330,台積電,39,11,28,陽信-石牌,2024-06-24,8711
2201,裕隆,25,0,25,陽信-石牌,2024-06-24,8711
2486,一詮,22,0,22,陽信-石牌,2024-06-24,8711
2641,正德,27,6,21,陽信-石牌,2024-06-24,8711
3615,安可,21,0,21,陽信-石牌,2024-06-24,8711
00753L,中信中國50正2,20,0,20,陽信-石牌,2024-06-24,8711
00907,永豐優息存股,20,0,20,陽信-石牌,2024-06-24,8711
2371,大同,26,6,20,陽信-石牌,2024-06-24,8711
6026,福邦證,20,0,20,陽信-石牌,2024-06-24,8711
2314,台揚,20,1,19,陽信-石牌,2024-06-24,8711
00936,台新永續高息中小,18,0,18,陽信-石牌,2024-06-24,8711
6257,矽格,21,3,18,陽信-石牌,2024-06-24,8711
2495,普安,17,0,17,陽信-石牌,2024-06-24,8711
1504,東元,16,0,16,陽信-石牌,2024-06-24,8711
6290,良維,16,0,16,陽信-石牌,2024-06-24,8711
00915,凱基優選高股息30,15,0,15,陽信-石牌,2024-06-24,8711
2356,英業達,29,14,15,陽信-石牌,2024-06-24,8711
3005,神基,18,3,15,陽信-石牌,2024-06-24,8711
3234,光環,15,0,15,陽信-石牌,2024-06-24,8711
4111,濟生,16,1,15,陽信-石牌,2024-06-24,8711
4977,眾達-KY,20,5,15,陽信-石牌,2024-06-24,8711
1227,佳格,18,4,14,陽信-石牌,2024-06-24,8711
2002,中鋼,15,1,14,陽信-石牌,2024-06-24,8711
2401,凌陽,17,3,14,陽信-石牌,2024-06-24,8711
6617,共信-KY,14,0,14,陽信-石牌,2024-06-24,8711
2382,廣達,34,20,14,陽信-石牌,2024-06-24,8711
3047,訊舟,41,28,13,陽信-石牌,2024-06-24,8711
2409,友達,325,1,324,陽信-石牌,2024-06-25,8711
2330,台積電,139,18,121,陽信-石牌,2024-06-25,8711
3481,群創,309,192,117,陽信-石牌,2024-06-25,8711
2303,聯電,75,9,66,陽信-石牌,2024-06-25,8711
00664R,國泰臺灣加權反1,46,0,46,陽信-石牌,2024-06-25,8711
00679B,元大美債20年,47,1,46,陽信-石牌,2024-06-25,8711
2406,國碩,47,1,46,陽信-石牌,2024-06-25,8711
1815,富喬,59,18,41,陽信-石牌,2024-06-25,8711
3037,欣興,32,0,32,陽信-石牌,2024-06-25,8711
00939,統一台灣高息動能,30,0,30,陽信-石牌,2024-06-25,8711
4157,太景*-KY,30,0,30,陽信-石牌,2024-06-25,8711
9103,美德醫療-DR,30,0,30,陽信-石牌,2024-06-25,8711
2618,長榮航,36,6,30,陽信-石牌,2024-06-25,8711
2603,長榮,36,7,29,陽信-石牌,2024-06-25,8711
00946,群益科技高息成長,26,0,26,陽信-石牌,2024-06-25,8711
1718,中纖,25,0,25,陽信-石牌,2024-06-25,8711
2444,兆勁,25,0,25,陽信-石牌,2024-06-25,8711
5272,笙科,27,2,25,陽信-石牌,2024-06-25,8711
1616,億泰,22,0,22,陽信-石牌,2024-06-25,8711
2324,仁寶,31,9,22,陽信-石牌,2024-06-25,8711
5452,佶優,23,1,22,陽信-石牌,2024-06-25,8711
2801,彰銀,20,0,20,陽信-石牌,2024-06-25,8711
2323,中環,20,1,19,陽信-石牌,2024-06-25,8711
1514,亞力,58,40,18,陽信-石牌,2024-06-25,8711
2352,佳世達,26,10,16,陽信-石牌,2024-06-25,8711
2449,京元電子,45,29,16,陽信-石牌,2024-06-25,8711
3105,穩懋,16,1,15,陽信-石牌,2024-06-25,8711
3231,緯創,23,9,14,陽信-石牌,2024-06-25,8711
2367,燿華,26,12,14,陽信-石牌,2024-06-25,8711
5534,長虹,15,1,14,陽信-石牌,2024-06-25,8711
2002,中鋼,13,0,13,陽信-石牌,2024-06-25,8711
2489,瑞軒,13,0,13,陽信-石牌,2024-06-25,8711
8110,華東,31,18,13,陽信-石牌,2024-06-25,8711
1909,榮成,12,0,12,陽信-石牌,2024-06-25,8711
00687B,國泰20年美債,29,18,11,陽信-石牌,2024-06-25,8711
1522,堤維西,11,0,11,陽信-石牌,2024-06-25,8711
2537,聯上發,13,2,11,陽信-石牌,2024-06-25,8711
3025,星通,16,5,11,陽信-石牌,2024-06-25,8711
3260,威剛,12,1,11,陽信-石牌,2024-06-25,8711
9927,泰銘,11,0,11,陽信-石牌,2024-06-25,8711
00665L,富邦�琤肭磪囓�2,30,20,10,陽信-石牌,2024-06-25,8711
2408,南亞科,11,1,10,陽信-石牌,2024-06-25,8711
2417,圓剛,10,0,10,陽信-石牌,2024-06-25,8711
2834,臺企銀,10,0,10,陽信-石牌,2024-06-25,8711
3313,斐成,10,0,10,陽信-石牌,2024-06-25,8711
3520,華盈,10,0,10,陽信-石牌,2024-06-25,8711
3535,晶彩科,11,1,10,陽信-石牌,2024-06-25,8711
3537,堡達,10,0,10,陽信-石牌,2024-06-25,8711
6505,台塑化,11,1,10,陽信-石牌,2024-06-25,8711
00947,台新臺灣IC設計,9,0,9,陽信-石牌,2024-06-25,8711
2409,友達,120,0,120,陽信-石牌,2024-06-26,8711
3512,皇龍,100,0,100,陽信-石牌,2024-06-26,8711
00679B,元大美債20年,94,20,74,陽信-石牌,2024-06-26,8711
00927,群益半導體收益,61,0,61,陽信-石牌,2024-06-26,8711
00637L,元大滬深300正2,60,0,60,陽信-石牌,2024-06-26,8711
00929,復華台灣科技優息,94,37,57,陽信-石牌,2024-06-26,8711
2603,長榮,51,0,51,陽信-石牌,2024-06-26,8711
2002,中鋼,43,0,43,陽信-石牌,2024-06-26,8711
2801,彰銀,40,2,38,陽信-石牌,2024-06-26,8711
2885,元大金,40,2,38,陽信-石牌,2024-06-26,8711
2355,敬鵬,36,1,35,陽信-石牌,2024-06-26,8711
1447,力鵬,33,3,30,陽信-石牌,2024-06-26,8711
00936,台新永續高息中小,28,0,28,陽信-石牌,2024-06-26,8711
2344,華邦電,33,5,28,陽信-石牌,2024-06-26,8711
6207,雷科,31,6,25,陽信-石牌,2024-06-26,8711
2353,宏��,26,2,24,陽信-石牌,2024-06-26,8711
2367,燿華,55,31,24,陽信-石牌,2024-06-26,8711
8085,福華,42,18,24,陽信-石牌,2024-06-26,8711
2880,華南金,23,0,23,陽信-石牌,2024-06-26,8711
5871,中租-KY,25,2,23,陽信-石牌,2024-06-26,8711
00664R,國泰臺灣加權反1,21,0,21,陽信-石牌,2024-06-26,8711
3060,銘異,21,0,21,陽信-石牌,2024-06-26,8711
00939,統一台灣高息動能,25,5,20,陽信-石牌,2024-06-26,8711
3202,樺晟,20,0,20,陽信-石牌,2024-06-26,8711
3624,光頡,20,0,20,陽信-石牌,2024-06-26,8711
5876,上海商銀,20,0,20,陽信-石牌,2024-06-26,8711
6257,矽格,20,0,20,陽信-石牌,2024-06-26,8711
2371,大同,22,3,19,陽信-石牌,2024-06-26,8711
2201,裕隆,18,0,18,陽信-石牌,2024-06-26,8711
00940,元大台灣價值高息,19,2,17,陽信-石牌,2024-06-26,8711
2337,旺宏,17,0,17,陽信-石牌,2024-06-26,8711
5452,佶優,32,15,17,陽信-石牌,2024-06-26,8711
8096,擎亞,18,1,17,陽信-石牌,2024-06-26,8711
00830,國泰費城半導體,16,0,16,陽信-石牌,2024-06-26,8711
6505,台塑化,16,0,16,陽信-石牌,2024-06-26,8711
1605,華新,20,5,15,陽信-石牌,2024-06-26,8711
2392,正崴,36,21,15,陽信-石牌,2024-06-26,8711
2618,長榮航,17,2,15,陽信-石牌,2024-06-26,8711
2882,國泰金,14,0,14,陽信-石牌,2024-06-26,8711
8112,至上,14,0,14,陽信-石牌,2024-06-26,8711
2316,楠梓電,18,5,13,陽信-石牌,2024-06-26,8711
2444,兆勁,13,0,13,陽信-石牌,2024-06-26,8711
2405,輔信,20,8,12,陽信-石牌,2024-06-26,8711
3231,緯創,18,6,12,陽信-石牌,2024-06-26,8711
3580,友威科,12,0,12,陽信-石牌,2024-06-26,8711
4526,東台,26,15,11,陽信-石牌,2024-06-26,8711
4562,穎漢,15,4,11,陽信-石牌,2024-06-26,8711
2892,第一金,11,0,11,陽信-石牌,2024-06-26,8711
1504,東元,10,0,10,陽信-石牌,2024-06-26,8711
1536,和大,10,0,10,陽信-石牌,2024-06-26,8711
00937B,群益ESG投等債20,416,47,369,陽信-石牌,2024-06-27,8711
2606,裕民,102,0,102,陽信-石牌,2024-06-27,8711
00795B,中信美國公債20年,153,60,93,陽信-石牌,2024-06-27,8711
2883,凱基金,81,3,78,陽信-石牌,2024-06-27,8711
00919,群益台灣精選高息,78,5,73,陽信-石牌,2024-06-27,8711
3576,聯合再生,84,13,71,陽信-石牌,2024-06-27,8711
1447,力鵬,55,5,50,陽信-石牌,2024-06-27,8711
2101,南港,44,0,44,陽信-石牌,2024-06-27,8711
2885,元大金,48,4,44,陽信-石牌,2024-06-27,8711
00687B,國泰20年美債,43,0,43,陽信-石牌,2024-06-27,8711
00688L,國泰20年美債正2,43,0,43,陽信-石牌,2024-06-27,8711
00929,復華台灣科技優息,38,0,38,陽信-石牌,2024-06-27,8711
1314,中石化,46,9,37,陽信-石牌,2024-06-27,8711
8071,能率網通,35,0,35,陽信-石牌,2024-06-27,8711
00939,統一台灣高息動能,34,0,34,陽信-石牌,2024-06-27,8711
2371,大同,47,14,33,陽信-石牌,2024-06-27,8711
2337,旺宏,32,0,32,陽信-石牌,2024-06-27,8711
2317,鴻海,60,31,29,陽信-石牌,2024-06-27,8711
02001L,富邦蘋果正二N,29,0,29,陽信-石牌,2024-06-27,8711
00725B,國泰投資級公司債,29,0,29,陽信-石牌,2024-06-27,8711
00650L,復華香港正2,25,0,25,陽信-石牌,2024-06-27,8711
3652,精聯,34,12,22,陽信-石牌,2024-06-27,8711
4938,和碩,21,1,20,陽信-石牌,2024-06-27,8711
1785,光洋科,23,3,20,陽信-石牌,2024-06-27,8711
3163,波若威,26,6,20,陽信-石牌,2024-06-27,8711
4142,國光生,20,0,20,陽信-石牌,2024-06-27,8711
5202,力新,21,1,20,陽信-石牌,2024-06-27,8711
6113,亞矽,20,0,20,陽信-石牌,2024-06-27,8711
1587,吉茂,18,0,18,陽信-石牌,2024-06-27,8711
3312,弘憶股,32,14,18,陽信-石牌,2024-06-27,8711
3013,晟銘電,17,0,17,陽信-石牌,2024-06-27,8711
3037,欣興,18,1,17,陽信-石牌,2024-06-27,8711
8076,伍豐,31,15,16,陽信-石牌,2024-06-27,8711
00878,國泰永續高股息,20,5,15,陽信-石牌,2024-06-27,8711
00946,群益科技高息成長,15,0,15,陽信-石牌,2024-06-27,8711
2201,裕隆,15,0,15,陽信-石牌,2024-06-27,8711
2344,華邦電,15,0,15,陽信-石牌,2024-06-27,8711
3231,緯創,26,11,15,陽信-石牌,2024-06-27,8711
2354,鴻準,17,3,14,陽信-石牌,2024-06-27,8711
6257,矽格,31,17,14,陽信-石牌,2024-06-27,8711
00918,大華優利高填息30,13,0,13,陽信-石牌,2024-06-27,8711
2009,第一銅,14,1,13,陽信-石牌,2024-06-27,8711
8110,華東,18,5,13,陽信-石牌,2024-06-27,8711
6770,力積電,14,1,13,陽信-石牌,2024-06-27,8711
3450,聯鈞,18,6,12,陽信-石牌,2024-06-27,8711
5210,寶碩,30,18,12,陽信-石牌,2024-06-27,8711
9136,巨騰-DR,12,0,12,陽信-石牌,2024-06-27,8711
1301,台塑,12,1,11,陽信-石牌,2024-06-27,8711
3060,銘異,11,0,11,陽信-石牌,2024-06-27,8711
00947,台新臺灣IC設計,10,0,10,陽信-石牌,2024-06-27,8711
1802,台玻,242,78,164,陽信-石牌,2024-06-28,8711
2618,長榮航,163,14,149,陽信-石牌,2024-06-28,8711
00936,台新永續高息中小,104,0,104,陽信-石牌,2024-06-28,8711
1504,東元,109,10,99,陽信-石牌,2024-06-28,8711
00937B,群益ESG投等債20,117,20,97,陽信-石牌,2024-06-28,8711
00706L,期元大S＆P日圓正2,50,0,50,陽信-石牌,2024-06-28,8711
00679B,元大美債20年,36,0,36,陽信-石牌,2024-06-28,8711
2349,錸德,37,2,35,陽信-石牌,2024-06-28,8711
2542,興富發,36,1,35,陽信-石牌,2024-06-28,8711
00712,復華富時不動產,32,0,32,陽信-石牌,2024-06-28,8711
4916,事欣科,29,0,29,陽信-石牌,2024-06-28,8711
1503,士電,38,10,28,陽信-石牌,2024-06-28,8711
8105,凌巨,30,4,26,陽信-石牌,2024-06-28,8711
1514,亞力,54,30,24,陽信-石牌,2024-06-28,8711
2374,佳能,45,21,24,陽信-石牌,2024-06-28,8711
8085,福華,24,0,24,陽信-石牌,2024-06-28,8711
00637L,元大滬深300正2,20,0,20,陽信-石牌,2024-06-28,8711
4956,光鋐,20,0,20,陽信-石牌,2024-06-28,8711
4968,立積,21,1,20,陽信-石牌,2024-06-28,8711
8027,鈦昇,32,12,20,陽信-石牌,2024-06-28,8711
2610,華航,44,26,18,陽信-石牌,2024-06-28,8711
1609,大亞,19,2,17,陽信-石牌,2024-06-28,8711
3576,聯合再生,107,90,17,陽信-石牌,2024-06-28,8711
2101,南港,18,2,16,陽信-石牌,2024-06-28,8711
2312,金寶,22,6,16,陽信-石牌,2024-06-28,8711
6770,力積電,29,13,16,陽信-石牌,2024-06-28,8711
4714,永捷,15,0,15,陽信-石牌,2024-06-28,8711
3483,力致,28,14,14,陽信-石牌,2024-06-28,8711
8421,旭源,15,1,14,陽信-石牌,2024-06-28,8711
2324,仁寶,16,3,13,陽信-石牌,2024-06-28,8711
4938,和碩,16,3,13,陽信-石牌,2024-06-28,8711
3059,華晶科,12,0,12,陽信-石牌,2024-06-28,8711
6753,龍德造船,14,2,12,陽信-石牌,2024-06-28,8711
8104,錸寶,12,0,12,陽信-石牌,2024-06-28,8711
2337,旺宏,12,1,11,陽信-石牌,2024-06-28,8711
5534,長虹,11,0,11,陽信-石牌,2024-06-28,8711
1316,上曜,10,0,10,陽信-石牌,2024-06-28,8711
00773B,中信優先金融債,10,0,10,陽信-石牌,2024-06-28,8711
1340,勝悅-KY,10,0,10,陽信-石牌,2024-06-28,8711
1605,華新,10,0,10,陽信-石牌,2024-06-28,8711
1734,杏輝,10,0,10,陽信-石牌,2024-06-28,8711
2363,矽統,14,4,10,陽信-石牌,2024-06-28,8711
2543,皇昌,10,0,10,陽信-石牌,2024-06-28,8711
2637,慧洋-KY,10,0,10,陽信-石牌,2024-06-28,8711
3508,位速,10,0,10,陽信-石牌,2024-06-28,8711
3707,漢磊,10,0,10,陽信-石牌,2024-06-28,8711
4977,眾達-KY,10,0,10,陽信-石牌,2024-06-28,8711
9910,豐泰,10,0,10,陽信-石牌,2024-06-28,8711
1463,強盛新,9,0,9,陽信-石牌,2024-06-28,8711
6207,雷科,9,0,9,陽信-石牌,2024-06-28,8711
2409,友達,308,9,299,陽信-石牌,2024-07-01,8711
0056,元大高股息,143,4,139,陽信-石牌,2024-07-01,8711
1563,巧新,134,0,134,陽信-石牌,2024-07-01,8711
00679B,元大美債20年,54,0,54,陽信-石牌,2024-07-01,8711
00637L,元大滬深300正2,50,0,50,陽信-石牌,2024-07-01,8711
9946,三發地產,50,0,50,陽信-石牌,2024-07-01,8711
2337,旺宏,48,4,44,陽信-石牌,2024-07-01,8711
00773B,中信優先金融債,40,0,40,陽信-石牌,2024-07-01,8711
2610,華航,108,69,39,陽信-石牌,2024-07-01,8711
3048,益登,47,11,36,陽信-石牌,2024-07-01,8711
2365,昆盈,115,80,35,陽信-石牌,2024-07-01,8711
2371,大同,38,3,35,陽信-石牌,2024-07-01,8711
6241,易通展,35,0,35,陽信-石牌,2024-07-01,8711
00935,野村臺灣新科技50,34,0,34,陽信-石牌,2024-07-01,8711
6589,台康生技,40,11,29,陽信-石牌,2024-07-01,8711
00687B,國泰20年美債,26,0,26,陽信-石牌,2024-07-01,8711
3360,尚立,26,0,26,陽信-石牌,2024-07-01,8711
9904,寶成,26,0,26,陽信-石牌,2024-07-01,8711
00936,台新永續高息中小,26,1,25,陽信-石牌,2024-07-01,8711
00688L,國泰20年美債正2,24,0,24,陽信-石牌,2024-07-01,8711
6770,力積電,45,24,21,陽信-石牌,2024-07-01,8711
2313,華通,25,5,20,陽信-石牌,2024-07-01,8711
00948B,中信優息投資級債,30,10,20,陽信-石牌,2024-07-01,8711
00706L,期元大S＆P日圓正2,20,0,20,陽信-石牌,2024-07-01,8711
3060,銘異,19,1,18,陽信-石牌,2024-07-01,8711
9945,潤泰新,16,0,16,陽信-石牌,2024-07-01,8711
2449,京元電子,26,11,15,陽信-石牌,2024-07-01,8711
6279,胡連,15,0,15,陽信-石牌,2024-07-01,8711
4566,時碩工業,21,7,14,陽信-石牌,2024-07-01,8711
4977,眾達-KY,15,1,14,陽信-石牌,2024-07-01,8711
2362,藍天,13,0,13,陽信-石牌,2024-07-01,8711
2609,陽明,34,21,13,陽信-石牌,2024-07-01,8711
6117,迎廣,17,4,13,陽信-石牌,2024-07-01,8711
00680L,元大美債20正2,12,0,12,陽信-石牌,2024-07-01,8711
2352,佳世達,15,3,12,陽信-石牌,2024-07-01,8711
3037,欣興,14,2,12,陽信-石牌,2024-07-01,8711
3376,新日興,12,0,12,陽信-石牌,2024-07-01,8711
5452,佶優,12,0,12,陽信-石牌,2024-07-01,8711
8085,福華,13,1,12,陽信-石牌,2024-07-01,8711
3481,群創,45,33,12,陽信-石牌,2024-07-01,8711
1709,和益,11,0,11,陽信-石牌,2024-07-01,8711
2406,國碩,12,1,11,陽信-石牌,2024-07-01,8711
3483,力致,17,6,11,陽信-石牌,2024-07-01,8711
5484,慧友,12,1,11,陽信-石牌,2024-07-01,8711
6127,九豪,11,0,11,陽信-石牌,2024-07-01,8711
6188,廣明,40,29,11,陽信-石牌,2024-07-01,8711
8076,伍豐,12,1,11,陽信-石牌,2024-07-01,8711
8096,擎亞,14,3,11,陽信-石牌,2024-07-01,8711
9910,豐泰,11,0,11,陽信-石牌,2024-07-01,8711
00882,中信中國高股息,10,0,10,陽信-石牌,2024-07-01,8711
00934,中信成長高股息,489,0,489,陽信-石牌,2024-07-02,8711
00931B,統一美債20年,300,0,300,陽信-石牌,2024-07-02,8711
5475,德宏,151,0,151,陽信-石牌,2024-07-02,8711
2317,鴻海,172,41,131,陽信-石牌,2024-07-02,8711
2412,中華電,126,0,126,陽信-石牌,2024-07-02,8711
2406,國碩,115,21,94,陽信-石牌,2024-07-02,8711
00687B,國泰20年美債,73,5,68,陽信-石牌,2024-07-02,8711
4562,穎漢,87,20,67,陽信-石牌,2024-07-02,8711
2349,錸德,87,27,60,陽信-石牌,2024-07-02,8711
6547,高端疫苗,53,0,53,陽信-石牌,2024-07-02,8711
2369,菱生,60,11,49,陽信-石牌,2024-07-02,8711
6244,茂迪,86,39,47,陽信-石牌,2024-07-02,8711
00942B,台新美A公司債20+,42,0,42,陽信-石牌,2024-07-02,8711
00751B,元大AAA至A公司債,41,0,41,陽信-石牌,2024-07-02,8711
2353,宏��,55,19,36,陽信-石牌,2024-07-02,8711
00949,復華日本龍頭,32,0,32,陽信-石牌,2024-07-02,8711
00688L,國泰20年美債正2,30,0,30,陽信-石牌,2024-07-02,8711
4157,太景*-KY,31,1,30,陽信-石牌,2024-07-02,8711
5425,台半,30,0,30,陽信-石牌,2024-07-02,8711
6116,彩晶,30,0,30,陽信-石牌,2024-07-02,8711
00679B,元大美債20年,34,5,29,陽信-石牌,2024-07-02,8711
2365,昆盈,93,66,27,陽信-石牌,2024-07-02,8711
1301,台塑,28,1,27,陽信-石牌,2024-07-02,8711
00948B,中信優息投資級債,25,0,25,陽信-石牌,2024-07-02,8711
2002,中鋼,22,0,22,陽信-石牌,2024-07-02,8711
2427,三商電,23,1,22,陽信-石牌,2024-07-02,8711
2851,中再保,22,0,22,陽信-石牌,2024-07-02,8711
6257,矽格,22,1,21,陽信-石牌,2024-07-02,8711
6505,台塑化,21,0,21,陽信-石牌,2024-07-02,8711
0056,元大高股息,20,0,20,陽信-石牌,2024-07-02,8711
6189,豐藝,23,3,20,陽信-石牌,2024-07-02,8711
8064,東捷,33,13,20,陽信-石牌,2024-07-02,8711
6477,安集,27,8,19,陽信-石牌,2024-07-02,8711
4968,立積,22,5,17,陽信-石牌,2024-07-02,8711
2495,普安,35,19,16,陽信-石牌,2024-07-02,8711
00935,野村臺灣新科技50,16,0,16,陽信-石牌,2024-07-02,8711
2356,英業達,18,2,16,陽信-石牌,2024-07-02,8711
6126,信音,17,1,16,陽信-石牌,2024-07-02,8711
1806,冠軍,15,0,15,陽信-石牌,2024-07-02,8711
3062,建漢,15,0,15,陽信-石牌,2024-07-02,8711
6472,保瑞,15,1,14,陽信-石牌,2024-07-02,8711
00936,台新永續高息中小,14,0,14,陽信-石牌,2024-07-02,8711
00947,台新臺灣IC設計,14,0,14,陽信-石牌,2024-07-02,8711
1708,東鹼,15,1,14,陽信-石牌,2024-07-02,8711
2258,鴻華先進-創,14,0,14,陽信-石牌,2024-07-02,8711
1447,力鵬,13,0,13,陽信-石牌,2024-07-02,8711
3059,華晶科,16,3,13,陽信-石牌,2024-07-02,8711
3376,新日興,13,0,13,陽信-石牌,2024-07-02,8711
4549,桓達,13,0,13,陽信-石牌,2024-07-02,8711
5452,佶優,29,16,13,陽信-石牌,2024-07-02,8711
9105,泰金寶-DR,192,11,181,陽信-石牌,2024-07-03,8711
2409,友達,166,3,163,陽信-石牌,2024-07-03,8711
2617,台航,123,9,114,陽信-石牌,2024-07-03,8711
00934,中信成長高股息,81,0,81,陽信-石牌,2024-07-03,8711
6491,晶碩,55,0,55,陽信-石牌,2024-07-03,8711
2412,中華電,50,0,50,陽信-石牌,2024-07-03,8711
5608,四維航,50,0,50,陽信-石牌,2024-07-03,8711
00679B,元大美債20年,46,0,46,陽信-石牌,2024-07-03,8711
3047,訊舟,69,25,44,陽信-石牌,2024-07-03,8711
2615,萬海,95,51,44,陽信-石牌,2024-07-03,8711
2317,鴻海,61,18,43,陽信-石牌,2024-07-03,8711
3005,神基,49,7,42,陽信-石牌,2024-07-03,8711
2405,輔信,50,11,39,陽信-石牌,2024-07-03,8711
00929,復華台灣科技優息,49,10,39,陽信-石牌,2024-07-03,8711
6443,元晶,66,28,38,陽信-石牌,2024-07-03,8711
0056,元大高股息,40,7,33,陽信-石牌,2024-07-03,8711
5475,德宏,33,0,33,陽信-石牌,2024-07-03,8711
00930,永豐ESG低碳高息,30,0,30,陽信-石牌,2024-07-03,8711
3686,達能,30,0,30,陽信-石牌,2024-07-03,8711
6547,高端疫苗,30,0,30,陽信-石牌,2024-07-03,8711
2303,聯電,48,22,26,陽信-石牌,2024-07-03,8711
2344,華邦電,51,25,26,陽信-石牌,2024-07-03,8711
6282,康舒,26,3,23,陽信-石牌,2024-07-03,8711
2369,菱生,20,0,20,陽信-石牌,2024-07-03,8711
3297,杭特,20,0,20,陽信-石牌,2024-07-03,8711
2402,毅嘉,25,6,19,陽信-石牌,2024-07-03,8711
3376,新日興,25,6,19,陽信-石牌,2024-07-03,8711
6538,倉和,20,2,18,陽信-石牌,2024-07-03,8711
00927,群益半導體收益,17,0,17,陽信-石牌,2024-07-03,8711
2464,盟立,32,15,17,陽信-石牌,2024-07-03,8711
00942B,台新美A公司債20+,15,0,15,陽信-石牌,2024-07-03,8711
3211,順達,15,0,15,陽信-石牌,2024-07-03,8711
8064,東捷,69,54,15,陽信-石牌,2024-07-03,8711
4938,和碩,15,1,14,陽信-石牌,2024-07-03,8711
2301,光寶科,33,20,13,陽信-石牌,2024-07-03,8711
5534,長虹,29,16,13,陽信-石牌,2024-07-03,8711
1529,樂事綠能,14,2,12,陽信-石牌,2024-07-03,8711
6235,華孚,13,2,11,陽信-石牌,2024-07-03,8711
00680L,元大美債20正2,10,0,10,陽信-石牌,2024-07-03,8711
1314,中石化,20,10,10,陽信-石牌,2024-07-03,8711
1326,台化,11,1,10,陽信-石牌,2024-07-03,8711
6117,迎廣,19,9,10,陽信-石牌,2024-07-03,8711
00665L,富邦�琤肭磪囓�2,20,11,9,陽信-石牌,2024-07-03,8711
02001L,富邦蘋果正二N,9,0,9,陽信-石牌,2024-07-03,8711
3048,益登,28,19,9,陽信-石牌,2024-07-03,8711
3265,台星科,10,1,9,陽信-石牌,2024-07-03,8711
6414,樺漢,9,0,9,陽信-石牌,2024-07-03,8711
2357,華碩,12,4,8,陽信-石牌,2024-07-03,8711
00948B,中信優息投資級債,8,0,8,陽信-石牌,2024-07-03,8711
2634,漢翔,8,0,8,陽信-石牌,2024-07-03,8711
2884,玉山金,150,1,149,陽信-石牌,2024-07-04,8711
2412,中華電,122,0,122,陽信-石牌,2024-07-04,8711
2891,中信金,105,5,100,陽信-石牌,2024-07-04,8711
2303,聯電,121,33,88,陽信-石牌,2024-07-04,8711
2617,台航,77,0,77,陽信-石牌,2024-07-04,8711
00929,復華台灣科技優息,66,3,63,陽信-石牌,2024-07-04,8711
00927,群益半導體收益,50,0,50,陽信-石牌,2024-07-04,8711
8049,晶采,50,0,50,陽信-石牌,2024-07-04,8711
1514,亞力,83,34,49,陽信-石牌,2024-07-04,8711
3715,定穎投控,45,2,43,陽信-石牌,2024-07-04,8711
00934,中信成長高股息,42,0,42,陽信-石牌,2024-07-04,8711
2405,輔信,69,28,41,陽信-石牌,2024-07-04,8711
4533,協易機,51,10,41,陽信-石牌,2024-07-04,8711
2444,兆勁,65,25,40,陽信-石牌,2024-07-04,8711
2312,金寶,53,14,39,陽信-石牌,2024-07-04,8711
2349,錸德,46,10,36,陽信-石牌,2024-07-04,8711
00632R,元大台灣50反1,45,10,35,陽信-石牌,2024-07-04,8711
1409,新纖,35,3,32,陽信-石牌,2024-07-04,8711
6443,元晶,50,18,32,陽信-石牌,2024-07-04,8711
2883,凱基金,37,6,31,陽信-石牌,2024-07-04,8711
3189,景碩,28,0,28,陽信-石牌,2024-07-04,8711
2882,國泰金,33,5,28,陽信-石牌,2024-07-04,8711
1785,光洋科,76,49,27,陽信-石牌,2024-07-04,8711
2618,長榮航,30,5,25,陽信-石牌,2024-07-04,8711
5347,世界,26,1,25,陽信-石牌,2024-07-04,8711
3231,緯創,29,4,25,陽信-石牌,2024-07-04,8711
6188,廣明,33,11,22,陽信-石牌,2024-07-04,8711
00878,國泰永續高股息,32,11,21,陽信-石牌,2024-07-04,8711
5202,力新,21,0,21,陽信-石牌,2024-07-04,8711
3041,揚智,30,10,20,陽信-石牌,2024-07-04,8711
2886,兆豐金,19,0,19,陽信-石牌,2024-07-04,8711
2888,新光金,88,69,19,陽信-石牌,2024-07-04,8711
00949,復華日本龍頭,18,0,18,陽信-石牌,2024-07-04,8711
2324,仁寶,38,20,18,陽信-石牌,2024-07-04,8711
3450,聯鈞,47,29,18,陽信-石牌,2024-07-04,8711
3297,杭特,17,0,17,陽信-石牌,2024-07-04,8711
4906,正文,21,4,17,陽信-石牌,2024-07-04,8711
2031,新光鋼,16,0,16,陽信-石牌,2024-07-04,8711
6547,高端疫苗,15,0,15,陽信-石牌,2024-07-04,8711
00936,台新永續高息中小,15,1,14,陽信-石牌,2024-07-04,8711
6235,華孚,14,0,14,陽信-石牌,2024-07-04,8711
2486,一詮,14,2,12,陽信-石牌,2024-07-04,8711
5243,乙盛-KY,12,0,12,陽信-石牌,2024-07-04,8711
6244,茂迪,47,35,12,陽信-石牌,2024-07-04,8711
8390,金益鼎,42,30,12,陽信-石牌,2024-07-04,8711
1815,富喬,33,22,11,陽信-石牌,2024-07-04,8711
2241,艾姆勒,19,8,11,陽信-石牌,2024-07-04,8711
2609,陽明,21,10,11,陽信-石牌,2024-07-04,8711
3622,洋華,12,1,11,陽信-石牌,2024-07-04,8711
6284,佳邦,11,0,11,陽信-石牌,2024-07-04,8711
2323,中環,370,1,369,陽信-石牌,2024-07-05,8711
00637L,元大滬深300正2,157,29,128,陽信-石牌,2024-07-05,8711
2610,華航,94,0,94,陽信-石牌,2024-07-05,8711
6152,百一,93,1,92,陽信-石牌,2024-07-05,8711
2453,凌群,100,9,91,陽信-石牌,2024-07-05,8711
2618,長榮航,85,3,82,陽信-石牌,2024-07-05,8711
00927,群益半導體收益,78,0,78,陽信-石牌,2024-07-05,8711
00898,國泰基因免疫革命,60,0,60,陽信-石牌,2024-07-05,8711
1722,台肥,60,0,60,陽信-石牌,2024-07-05,8711
2301,光寶科,60,13,47,陽信-石牌,2024-07-05,8711
2337,旺宏,67,21,46,陽信-石牌,2024-07-05,8711
5484,慧友,49,4,45,陽信-石牌,2024-07-05,8711
6189,豐藝,46,1,45,陽信-石牌,2024-07-05,8711
2344,華邦電,40,2,38,陽信-石牌,2024-07-05,8711
6116,彩晶,50,12,38,陽信-石牌,2024-07-05,8711
00934,中信成長高股息,34,0,34,陽信-石牌,2024-07-05,8711
1809,中釉,33,0,33,陽信-石牌,2024-07-05,8711
2615,萬海,64,31,33,陽信-石牌,2024-07-05,8711
5347,世界,39,6,33,陽信-石牌,2024-07-05,8711
5531,鄉林,32,0,32,陽信-石牌,2024-07-05,8711
8028,昇陽半導體,63,32,31,陽信-石牌,2024-07-05,8711
00930,永豐ESG低碳高息,30,0,30,陽信-石牌,2024-07-05,8711
2349,錸德,31,2,29,陽信-石牌,2024-07-05,8711
1504,東元,34,6,28,陽信-石牌,2024-07-05,8711
3037,欣興,33,5,28,陽信-石牌,2024-07-05,8711
00918,大華優利高填息30,27,0,27,陽信-石牌,2024-07-05,8711
2371,大同,35,11,24,陽信-石牌,2024-07-05,8711
3576,聯合再生,29,5,24,陽信-石牌,2024-07-05,8711
1326,台化,22,0,22,陽信-石牌,2024-07-05,8711
2603,長榮,21,0,21,陽信-石牌,2024-07-05,8711
00937B,群益ESG投等債20,21,0,21,陽信-石牌,2024-07-05,8711
00706L,期元大S＆P日圓正2,20,0,20,陽信-石牌,2024-07-05,8711
1540,喬福,26,6,20,陽信-石牌,2024-07-05,8711
911868,同方友友-DR,29,10,19,陽信-石牌,2024-07-05,8711
4561,健椿,18,0,18,陽信-石牌,2024-07-05,8711
1503,士電,20,3,17,陽信-石牌,2024-07-05,8711
5880,合庫金,22,5,17,陽信-石牌,2024-07-05,8711
00949,復華日本龍頭,16,0,16,陽信-石牌,2024-07-05,8711
3312,弘憶股,27,11,16,陽信-石牌,2024-07-05,8711
3645,達邁,18,2,16,陽信-石牌,2024-07-05,8711
3686,達能,15,0,15,陽信-石牌,2024-07-05,8711
4534,慶騰,17,2,15,陽信-石牌,2024-07-05,8711
2887,台新金,15,0,15,陽信-石牌,2024-07-05,8711
00687B,國泰20年美債,15,1,14,陽信-石牌,2024-07-05,8711
1517,利奇,19,5,14,陽信-石牌,2024-07-05,8711
4303,信立,14,0,14,陽信-石牌,2024-07-05,8711
8112,至上,25,11,14,陽信-石牌,2024-07-05,8711
1608,華榮,15,2,13,陽信-石牌,2024-07-05,8711
3630,新鉅科,12,0,12,陽信-石牌,2024-07-05,8711
4906,正文,22,10,12,陽信-石牌,2024-07-05,8711
00931B,統一美債20年,150,0,150,陽信-石牌,2024-07-08,8711
2409,友達,150,7,143,陽信-石牌,2024-07-08,8711
2867,三商壽,100,10,90,陽信-石牌,2024-07-08,8711
2609,陽明,108,20,88,陽信-石牌,2024-07-08,8711
00937B,群益ESG投等債20,90,5,85,陽信-石牌,2024-07-08,8711
4562,穎漢,89,17,72,陽信-石牌,2024-07-08,8711
3062,建漢,136,71,65,陽信-石牌,2024-07-08,8711
2365,昆盈,89,27,62,陽信-石牌,2024-07-08,8711
2538,基泰,58,0,58,陽信-石牌,2024-07-08,8711
912000,晨訊科-DR,54,0,54,陽信-石牌,2024-07-08,8711
2542,興富發,53,0,53,陽信-石牌,2024-07-08,8711
5511,德昌,51,0,51,陽信-石牌,2024-07-08,8711
1722,台肥,50,0,50,陽信-石牌,2024-07-08,8711
6282,康舒,51,3,48,陽信-石牌,2024-07-08,8711
2618,長榮航,56,10,46,陽信-石牌,2024-07-08,8711
6152,百一,148,103,45,陽信-石牌,2024-07-08,8711
00632R,元大台灣50反1,45,1,44,陽信-石牌,2024-07-08,8711
2617,台航,43,0,43,陽信-石牌,2024-07-08,8711
2444,兆勁,50,9,41,陽信-石牌,2024-07-08,8711
2354,鴻準,55,17,38,陽信-石牌,2024-07-08,8711
3033,威健,42,4,38,陽信-石牌,2024-07-08,8711
1725,元禎,36,0,36,陽信-石牌,2024-07-08,8711
2301,光寶科,56,20,36,陽信-石牌,2024-07-08,8711
6127,九豪,38,4,34,陽信-石牌,2024-07-08,8711
2344,華邦電,38,6,32,陽信-石牌,2024-07-08,8711
1514,亞力,33,2,31,陽信-石牌,2024-07-08,8711
2106,建大,30,0,30,陽信-石牌,2024-07-08,8711
2801,彰銀,30,0,30,陽信-石牌,2024-07-08,8711
6113,亞矽,30,0,30,陽信-石牌,2024-07-08,8711
00946,群益科技高息成長,28,0,28,陽信-石牌,2024-07-08,8711
911868,同方友友-DR,28,0,28,陽信-石牌,2024-07-08,8711
2606,裕民,27,0,27,陽信-石牌,2024-07-08,8711
6153,嘉聯益,30,3,27,陽信-石牌,2024-07-08,8711
2371,大同,30,5,25,陽信-石牌,2024-07-08,8711
2401,凌陽,31,6,25,陽信-石牌,2024-07-08,8711
2605,新興,26,1,25,陽信-石牌,2024-07-08,8711
4949,有成精密,22,0,22,陽信-石牌,2024-07-08,8711
1503,士電,22,1,21,陽信-石牌,2024-07-08,8711
3060,銘異,21,0,21,陽信-石牌,2024-07-08,8711
2408,南亞科,22,2,20,陽信-石牌,2024-07-08,8711
1802,台玻,20,0,20,陽信-石牌,2024-07-08,8711
1409,新纖,23,5,18,陽信-石牌,2024-07-08,8711
3535,晶彩科,31,13,18,陽信-石牌,2024-07-08,8711
5880,合庫金,20,2,18,陽信-石牌,2024-07-08,8711
00679B,元大美債20年,19,2,17,陽信-石牌,2024-07-08,8711
2101,南港,17,0,17,陽信-石牌,2024-07-08,8711
2363,矽統,61,44,17,陽信-石牌,2024-07-08,8711
00918,大華優利高填息30,16,0,16,陽信-石牌,2024-07-08,8711
6207,雷科,17,1,16,陽信-石牌,2024-07-08,8711
6213,聯茂,18,2,16,陽信-石牌,2024-07-08,8711
912000,晨訊科-DR,112,0,112,陽信-石牌,2024-07-09,8711
2884,玉山金,112,20,92,陽信-石牌,2024-07-09,8711
00937B,群益ESG投等債20,115,29,86,陽信-石牌,2024-07-09,8711
9105,泰金寶-DR,276,195,81,陽信-石牌,2024-07-09,8711
2312,金寶,162,84,78,陽信-石牌,2024-07-09,8711
3047,訊舟,103,29,74,陽信-石牌,2024-07-09,8711
3710,連展投控,72,0,72,陽信-石牌,2024-07-09,8711
00946,群益科技高息成長,70,0,70,陽信-石牌,2024-07-09,8711
2344,華邦電,65,0,65,陽信-石牌,2024-07-09,8711
00673R,期元大S＆P原油反1,63,0,63,陽信-石牌,2024-07-09,8711
00891,中信關鍵半導體,60,0,60,陽信-石牌,2024-07-09,8711
00936,台新永續高息中小,75,20,55,陽信-石牌,2024-07-09,8711
2367,燿華,134,79,55,陽信-石牌,2024-07-09,8711
2618,長榮航,58,6,52,陽信-石牌,2024-07-09,8711
1722,台肥,51,0,51,陽信-石牌,2024-07-09,8711
6201,亞弘電,50,0,50,陽信-石牌,2024-07-09,8711
2349,錸德,68,21,47,陽信-石牌,2024-07-09,8711
00940,元大台灣價值高息,76,31,45,陽信-石牌,2024-07-09,8711
3673,TPK-KY,57,14,43,陽信-石牌,2024-07-09,8711
2313,華通,49,8,41,陽信-石牌,2024-07-09,8711
2610,華航,41,4,37,陽信-石牌,2024-07-09,8711
2405,輔信,83,48,35,陽信-石牌,2024-07-09,8711
4157,太景*-KY,35,0,35,陽信-石牌,2024-07-09,8711
00934,中信成長高股息,34,0,34,陽信-石牌,2024-07-09,8711
6153,嘉聯益,37,3,34,陽信-石牌,2024-07-09,8711
2317,鴻海,67,34,33,陽信-石牌,2024-07-09,8711
2834,臺企銀,32,0,32,陽信-石牌,2024-07-09,8711
1815,富喬,55,25,30,陽信-石牌,2024-07-09,8711
2106,建大,30,0,30,陽信-石牌,2024-07-09,8711
3202,樺晟,30,0,30,陽信-石牌,2024-07-09,8711
6282,康舒,30,0,30,陽信-石牌,2024-07-09,8711
2353,宏��,30,2,28,陽信-石牌,2024-07-09,8711
2617,台航,28,0,28,陽信-石牌,2024-07-09,8711
4906,正文,30,2,28,陽信-石牌,2024-07-09,8711
8028,昇陽半導體,28,2,26,陽信-石牌,2024-07-09,8711
6215,和椿,45,20,25,陽信-石牌,2024-07-09,8711
1785,光洋科,76,51,25,陽信-石牌,2024-07-09,8711
00919,群益台灣精選高息,29,5,24,陽信-石牌,2024-07-09,8711
00927,群益半導體收益,22,0,22,陽信-石牌,2024-07-09,8711
3231,緯創,29,8,21,陽信-石牌,2024-07-09,8711
3062,建漢,27,7,20,陽信-石牌,2024-07-09,8711
3260,威剛,23,3,20,陽信-石牌,2024-07-09,8711
4916,事欣科,20,0,20,陽信-石牌,2024-07-09,8711
1314,中石化,20,1,19,陽信-石牌,2024-07-09,8711
2615,萬海,52,33,19,陽信-石牌,2024-07-09,8711
911868,同方友友-DR,19,0,19,陽信-石牌,2024-07-09,8711
1528,恩德,17,0,17,陽信-石牌,2024-07-09,8711
3037,欣興,36,20,16,陽信-石牌,2024-07-09,8711
1101,台泥,16,0,16,陽信-石牌,2024-07-09,8711
2609,陽明,51,35,16,陽信-石牌,2024-07-09,8711
00931B,統一美債20年,161,0,161,陽信-石牌,2024-07-10,8711
8105,凌巨,156,11,145,陽信-石牌,2024-07-10,8711
00937B,群益ESG投等債20,144,0,144,陽信-石牌,2024-07-10,8711
0056,元大高股息,141,2,139,陽信-石牌,2024-07-10,8711
2888,新光金,465,336,129,陽信-石牌,2024-07-10,8711
00927,群益半導體收益,106,0,106,陽信-石牌,2024-07-10,8711
00950B,凱基A級公司債,100,0,100,陽信-石牌,2024-07-10,8711
1785,光洋科,132,40,92,陽信-石牌,2024-07-10,8711
3673,TPK-KY,70,18,52,陽信-石牌,2024-07-10,8711
00945B,凱基美國非投等債,50,0,50,陽信-石牌,2024-07-10,8711
1616,億泰,52,2,50,陽信-石牌,2024-07-10,8711
00940,元大台灣價值高息,102,57,45,陽信-石牌,2024-07-10,8711
00939,統一台灣高息動能,44,0,44,陽信-石牌,2024-07-10,8711
2617,台航,40,0,40,陽信-石牌,2024-07-10,8711
3037,欣興,44,9,35,陽信-石牌,2024-07-10,8711
00929,復華台灣科技優息,55,20,35,陽信-石牌,2024-07-10,8711
00935,野村臺灣新科技50,31,0,31,陽信-石牌,2024-07-10,8711
4157,太景*-KY,31,0,31,陽信-石牌,2024-07-10,8711
9103,美德醫療-DR,30,0,30,陽信-石牌,2024-07-10,8711
911868,同方友友-DR,30,0,30,陽信-石牌,2024-07-10,8711
1569,濱川,37,9,28,陽信-石牌,2024-07-10,8711
2367,燿華,81,55,26,陽信-石牌,2024-07-10,8711
3360,尚立,26,0,26,陽信-石牌,2024-07-10,8711
8071,能率網通,26,0,26,陽信-石牌,2024-07-10,8711
3202,樺晟,35,10,25,陽信-石牌,2024-07-10,8711
2312,金寶,52,28,24,陽信-石牌,2024-07-10,8711
2615,萬海,27,4,23,陽信-石牌,2024-07-10,8711
00936,台新永續高息中小,35,13,22,陽信-石牌,2024-07-10,8711
00946,群益科技高息成長,22,0,22,陽信-石牌,2024-07-10,8711
9105,泰金寶-DR,32,10,22,陽信-石牌,2024-07-10,8711
2371,大同,26,5,21,陽信-石牌,2024-07-10,8711
3645,達邁,22,2,20,陽信-石牌,2024-07-10,8711
9902,台火,20,0,20,陽信-石牌,2024-07-10,8711
8390,金益鼎,20,1,19,陽信-石牌,2024-07-10,8711
2609,陽明,22,4,18,陽信-石牌,2024-07-10,8711
4510,高鋒,18,0,18,陽信-石牌,2024-07-10,8711
5426,振發,18,0,18,陽信-石牌,2024-07-10,8711
2331,精英,16,0,16,陽信-石牌,2024-07-10,8711
2392,正崴,64,49,15,陽信-石牌,2024-07-10,8711
2834,臺企銀,16,1,15,陽信-石牌,2024-07-10,8711
5392,能率,18,3,15,陽信-石牌,2024-07-10,8711
5880,合庫金,15,0,15,陽信-石牌,2024-07-10,8711
00688L,國泰20年美債正2,14,0,14,陽信-石牌,2024-07-10,8711
2344,華邦電,14,0,14,陽信-石牌,2024-07-10,8711
2301,光寶科,55,42,13,陽信-石牌,2024-07-10,8711
2449,京元電子,20,7,13,陽信-石牌,2024-07-10,8711
4960,誠美材,14,1,13,陽信-石牌,2024-07-10,8711
1519,華城,22,10,12,陽信-石牌,2024-07-10,8711
2892,第一金,15,3,12,陽信-石牌,2024-07-10,8711
3231,緯創,45,33,12,陽信-石牌,2024-07-10,8711
00687B,國泰20年美債,250,0,250,陽信-石牌,2024-07-11,8711
2888,新光金,251,57,194,陽信-石牌,2024-07-11,8711
2392,正崴,151,24,127,陽信-石牌,2024-07-11,8711
0056,元大高股息,141,42,99,陽信-石牌,2024-07-11,8711
00632R,元大台灣50反1,137,45,92,陽信-石牌,2024-07-11,8711
1722,台肥,90,0,90,陽信-石牌,2024-07-11,8711
3202,樺晟,87,0,87,陽信-石牌,2024-07-11,8711
00751B,元大AAA至A公司債,106,20,86,陽信-石牌,2024-07-11,8711
912000,晨訊科-DR,81,0,81,陽信-石牌,2024-07-11,8711
00934,中信成長高股息,83,10,73,陽信-石牌,2024-07-11,8711
9904,寶成,60,0,60,陽信-石牌,2024-07-11,8711
00857B,永豐20年美公債,53,0,53,陽信-石牌,2024-07-11,8711
00935,野村臺灣新科技50,50,0,50,陽信-石牌,2024-07-11,8711
00895,富邦未來車,50,0,50,陽信-石牌,2024-07-11,8711
6449,鈺邦,48,2,46,陽信-石牌,2024-07-11,8711
6806,森崴能源,60,17,43,陽信-石牌,2024-07-11,8711
1795,美時,38,3,35,陽信-石牌,2024-07-11,8711
1718,中纖,34,0,34,陽信-石牌,2024-07-11,8711
6116,彩晶,30,0,30,陽信-石牌,2024-07-11,8711
8085,福華,30,2,28,陽信-石牌,2024-07-11,8711
2365,昆盈,67,43,24,陽信-石牌,2024-07-11,8711
1503,士電,44,20,24,陽信-石牌,2024-07-11,8711
00715L,期街口布蘭特正2,37,14,23,陽信-石牌,2024-07-11,8711
2371,大同,61,39,22,陽信-石牌,2024-07-11,8711
2609,陽明,24,2,22,陽信-石牌,2024-07-11,8711
2867,三商壽,32,10,22,陽信-石牌,2024-07-11,8711
00937B,群益ESG投等債20,33,12,21,陽信-石牌,2024-07-11,8711
3312,弘憶股,47,26,21,陽信-石牌,2024-07-11,8711
2637,慧洋-KY,20,0,20,陽信-石牌,2024-07-11,8711
3494,誠研,20,0,20,陽信-石牌,2024-07-11,8711
8927,北基,20,0,20,陽信-石牌,2024-07-11,8711
3596,智易,19,0,19,陽信-石牌,2024-07-11,8711
9105,泰金寶-DR,37,18,19,陽信-石牌,2024-07-11,8711
2317,鴻海,74,55,19,陽信-石牌,2024-07-11,8711
1447,力鵬,20,2,18,陽信-石牌,2024-07-11,8711
5534,長虹,34,16,18,陽信-石牌,2024-07-11,8711
8107,大億金茂,34,16,18,陽信-石牌,2024-07-11,8711
1513,中興電,25,8,17,陽信-石牌,2024-07-11,8711
1785,光洋科,25,9,16,陽信-石牌,2024-07-11,8711
00651R,復華香港反1,15,0,15,陽信-石牌,2024-07-11,8711
2316,楠梓電,17,3,14,陽信-石牌,2024-07-11,8711
2610,華航,19,5,14,陽信-石牌,2024-07-11,8711
3631,晟楠,14,0,14,陽信-石牌,2024-07-11,8711
2408,南亞科,22,9,13,陽信-石牌,2024-07-11,8711
2495,普安,15,2,13,陽信-石牌,2024-07-11,8711
6472,保瑞,12,0,12,陽信-石牌,2024-07-11,8711
2745,五福,12,0,12,陽信-石牌,2024-07-11,8711
5371,中光電,11,0,11,陽信-石牌,2024-07-11,8711
2603,長榮,12,1,11,陽信-石牌,2024-07-11,8711
00936,台新永續高息中小,11,0,11,陽信-石牌,2024-07-11,8711
00688L,國泰20年美債正2,500,7,493,陽信-石牌,2024-07-12,8711
00680L,元大美債20正2,380,0,380,陽信-石牌,2024-07-12,8711
00929,復華台灣科技優息,346,4,342,陽信-石牌,2024-07-12,8711
2330,台積電,231,7,224,陽信-石牌,2024-07-12,8711
00937B,群益ESG投等債20,227,9,218,陽信-石牌,2024-07-12,8711
2892,第一金,187,0,187,陽信-石牌,2024-07-12,8711
2891,中信金,149,20,129,陽信-石牌,2024-07-12,8711
00720B,元大投資級公司債,100,0,100,陽信-石牌,2024-07-12,8711
2867,三商壽,149,56,93,陽信-石牌,2024-07-12,8711
00946,群益科技高息成長,89,0,89,陽信-石牌,2024-07-12,8711
2303,聯電,96,9,87,陽信-石牌,2024-07-12,8711
2312,金寶,204,135,69,陽信-石牌,2024-07-12,8711
00927,群益半導體收益,65,0,65,陽信-石牌,2024-07-12,8711
00919,群益台灣精選高息,93,34,59,陽信-石牌,2024-07-12,8711
00687B,國泰20年美債,55,2,53,陽信-石牌,2024-07-12,8711
9105,泰金寶-DR,82,29,53,陽信-石牌,2024-07-12,8711
1785,光洋科,52,4,48,陽信-石牌,2024-07-12,8711
00857B,永豐20年美公債,48,3,45,陽信-石牌,2024-07-12,8711
2464,盟立,46,8,38,陽信-石牌,2024-07-12,8711
00934,中信成長高股息,37,0,37,陽信-石牌,2024-07-12,8711
1316,上曜,49,13,36,陽信-石牌,2024-07-12,8711
2313,華通,56,21,35,陽信-石牌,2024-07-12,8711
2367,燿華,37,3,34,陽信-石牌,2024-07-12,8711
00715L,期街口布蘭特正2,31,0,31,陽信-石牌,2024-07-12,8711
00679B,元大美債20年,50,21,29,陽信-石牌,2024-07-12,8711
2356,英業達,97,73,24,陽信-石牌,2024-07-12,8711
9927,泰銘,24,0,24,陽信-石牌,2024-07-12,8711
3711,日月光投控,24,2,22,陽信-石牌,2024-07-12,8711
00651R,復華香港反1,20,0,20,陽信-石牌,2024-07-12,8711
02001L,富邦蘋果正二N,20,0,20,陽信-石牌,2024-07-12,8711
1447,力鵬,20,0,20,陽信-石牌,2024-07-12,8711
2501,國建,40,20,20,陽信-石牌,2024-07-12,8711
8071,能率網通,21,1,20,陽信-石牌,2024-07-12,8711
2317,鴻海,109,90,19,陽信-石牌,2024-07-12,8711
1337,再生-KY,22,3,19,陽信-石牌,2024-07-12,8711
3706,神達,30,11,19,陽信-石牌,2024-07-12,8711
00935,野村臺灣新科技50,18,0,18,陽信-石牌,2024-07-12,8711
3060,銘異,19,2,17,陽信-石牌,2024-07-12,8711
3494,誠研,17,0,17,陽信-石牌,2024-07-12,8711
4977,眾達-KY,21,4,17,陽信-石牌,2024-07-12,8711
4414,如興,16,0,16,陽信-石牌,2024-07-12,8711
3047,訊舟,17,2,15,陽信-石牌,2024-07-12,8711
4958,臻鼎-KY,34,19,15,陽信-石牌,2024-07-12,8711
5475,德宏,15,0,15,陽信-石牌,2024-07-12,8711
00690,兆豐藍籌30,14,0,14,陽信-石牌,2024-07-12,8711
2495,普安,20,6,14,陽信-石牌,2024-07-12,8711
4909,新復興,26,12,14,陽信-石牌,2024-07-12,8711
4927,泰鼎-KY,31,17,14,陽信-石牌,2024-07-12,8711
2383,台光電,14,0,14,陽信-石牌,2024-07-12,8711
00881,國泰台灣5G+,15,2,13,陽信-石牌,2024-07-12,8711
00931B,統一美債20年,362,0,362,陽信-石牌,2024-07-15,8711
00680L,元大美債20正2,335,0,335,陽信-石牌,2024-07-15,8711
1301,台塑,276,1,275,陽信-石牌,2024-07-15,8711
00688L,國泰20年美債正2,273,0,273,陽信-石牌,2024-07-15,8711
00795B,中信美國公債20年,202,0,202,陽信-石牌,2024-07-15,8711
2610,華航,116,3,113,陽信-石牌,2024-07-15,8711
00934,中信成長高股息,114,1,113,陽信-石牌,2024-07-15,8711
6770,力積電,109,0,109,陽信-石牌,2024-07-15,8711
6026,福邦證,100,0,100,陽信-石牌,2024-07-15,8711
2356,英業達,131,40,91,陽信-石牌,2024-07-15,8711
6005,群益證,91,0,91,陽信-石牌,2024-07-15,8711
2891,中信金,82,6,76,陽信-石牌,2024-07-15,8711
00857B,永豐20年美公債,70,0,70,陽信-石牌,2024-07-15,8711
2884,玉山金,67,0,67,陽信-石牌,2024-07-15,8711
00679B,元大美債20年,72,7,65,陽信-石牌,2024-07-15,8711
00948B,中信優息投資級債,60,0,60,陽信-石牌,2024-07-15,8711
1409,新纖,65,5,60,陽信-石牌,2024-07-15,8711
3078,僑威,54,0,54,陽信-石牌,2024-07-15,8711
2801,彰銀,50,0,50,陽信-石牌,2024-07-15,8711
4927,泰鼎-KY,50,0,50,陽信-石牌,2024-07-15,8711
8299,群聯,51,1,50,陽信-石牌,2024-07-15,8711
2481,強茂,70,24,46,陽信-石牌,2024-07-15,8711
00929,復華台灣科技優息,44,0,44,陽信-石牌,2024-07-15,8711
1708,東鹼,42,0,42,陽信-石牌,2024-07-15,8711
1609,大亞,119,81,38,陽信-石牌,2024-07-15,8711
2867,三商壽,290,252,38,陽信-石牌,2024-07-15,8711
00919,群益台灣精選高息,36,0,36,陽信-石牌,2024-07-15,8711
3060,銘異,38,4,34,陽信-石牌,2024-07-15,8711
00937B,群益ESG投等債20,32,0,32,陽信-石牌,2024-07-15,8711
3673,TPK-KY,35,3,32,陽信-石牌,2024-07-15,8711
4157,太景*-KY,30,0,30,陽信-石牌,2024-07-15,8711
6113,亞矽,30,0,30,陽信-石牌,2024-07-15,8711
6116,彩晶,30,0,30,陽信-石牌,2024-07-15,8711
9927,泰銘,30,1,29,陽信-石牌,2024-07-15,8711
2324,仁寶,52,24,28,陽信-石牌,2024-07-15,8711
2367,燿華,42,15,27,陽信-石牌,2024-07-15,8711
2352,佳世達,25,1,24,陽信-石牌,2024-07-15,8711
2542,興富發,50,27,23,陽信-石牌,2024-07-15,8711
1608,華榮,44,21,23,陽信-石牌,2024-07-15,8711
00940,元大台灣價值高息,25,2,23,陽信-石牌,2024-07-15,8711
6180,橘子,22,0,22,陽信-石牌,2024-07-15,8711
8103,瀚荃,27,5,22,陽信-石牌,2024-07-15,8711
3033,威健,22,1,21,陽信-石牌,2024-07-15,8711
3013,晟銘電,47,27,20,陽信-石牌,2024-07-15,8711
2023,燁輝,20,0,20,陽信-石牌,2024-07-15,8711
2104,國際中橡,20,0,20,陽信-石牌,2024-07-15,8711
3508,位速,20,0,20,陽信-石牌,2024-07-15,8711
2365,昆盈,53,34,19,陽信-石牌,2024-07-15,8711
2312,金寶,216,198,18,陽信-石牌,2024-07-15,8711
2618,長榮航,18,0,18,陽信-石牌,2024-07-15,8711
2323,中環,130,5,125,陽信-石牌,2024-07-16,8711
1402,遠東新,100,0,100,陽信-石牌,2024-07-16,8711
6026,福邦證,62,0,62,陽信-石牌,2024-07-16,8711
6116,彩晶,60,0,60,陽信-石牌,2024-07-16,8711
2501,國建,78,19,59,陽信-石牌,2024-07-16,8711
00929,復華台灣科技優息,52,0,52,陽信-石牌,2024-07-16,8711
00680L,元大美債20正2,50,0,50,陽信-石牌,2024-07-16,8711
2023,燁輝,50,0,50,陽信-石牌,2024-07-16,8711
2352,佳世達,49,6,43,陽信-石牌,2024-07-16,8711
2367,燿華,38,0,38,陽信-石牌,2024-07-16,8711
6290,良維,34,0,34,陽信-石牌,2024-07-16,8711
00915,凱基優選高股息30,33,0,33,陽信-石牌,2024-07-16,8711
3202,樺晟,33,0,33,陽信-石牌,2024-07-16,8711
00919,群益台灣精選高息,43,13,30,陽信-石牌,2024-07-16,8711
9103,美德醫療-DR,30,0,30,陽信-石牌,2024-07-16,8711
8473,山林水,28,0,28,陽信-石牌,2024-07-16,8711
0056,元大高股息,28,0,28,陽信-石牌,2024-07-16,8711
2354,鴻準,34,7,27,陽信-石牌,2024-07-16,8711
1616,億泰,31,6,25,陽信-石牌,2024-07-16,8711
2356,英業達,41,16,25,陽信-石牌,2024-07-16,8711
1319,東陽,23,0,23,陽信-石牌,2024-07-16,8711
3712,永崴投控,23,1,22,陽信-石牌,2024-07-16,8711
2891,中信金,20,0,20,陽信-石牌,2024-07-16,8711
00940,元大台灣價值高息,18,0,18,陽信-石牌,2024-07-16,8711
4526,東台,24,7,17,陽信-石牌,2024-07-16,8711
2329,華泰,16,0,16,陽信-石牌,2024-07-16,8711
3032,偉訓,15,0,15,陽信-石牌,2024-07-16,8711
3041,揚智,15,0,15,陽信-石牌,2024-07-16,8711
5309,系統電,20,5,15,陽信-石牌,2024-07-16,8711
2376,技嘉,14,0,14,陽信-石牌,2024-07-16,8711
6472,保瑞,19,5,14,陽信-石牌,2024-07-16,8711
1503,士電,26,13,13,陽信-石牌,2024-07-16,8711
2609,陽明,15,2,13,陽信-石牌,2024-07-16,8711
2534,宏盛,12,0,12,陽信-石牌,2024-07-16,8711
3078,僑威,12,0,12,陽信-石牌,2024-07-16,8711
6770,力積電,23,11,12,陽信-石牌,2024-07-16,8711
8011,台通,18,6,12,陽信-石牌,2024-07-16,8711
1102,亞泥,11,0,11,陽信-石牌,2024-07-16,8711
3312,弘憶股,21,10,11,陽信-石牌,2024-07-16,8711
4414,如興,11,0,11,陽信-石牌,2024-07-16,8711
5351,鈺創,11,0,11,陽信-石牌,2024-07-16,8711
00688L,國泰20年美債正2,10,0,10,陽信-石牌,2024-07-16,8711
00927,群益半導體收益,10,0,10,陽信-石牌,2024-07-16,8711
1514,亞力,16,6,10,陽信-石牌,2024-07-16,8711
2340,台亞,10,0,10,陽信-石牌,2024-07-16,8711
2486,一詮,10,0,10,陽信-石牌,2024-07-16,8711
3494,誠研,10,0,10,陽信-石牌,2024-07-16,8711
5533,皇鼎,10,0,10,陽信-石牌,2024-07-16,8711
6901,鑽石投資,10,0,10,陽信-石牌,2024-07-16,8711
911868,同方友友-DR,11,1,10,陽信-石牌,2024-07-16,8711
2884,玉山金,305,0,305,陽信-石牌,2024-07-17,8711
2330,台積電,231,1,230,陽信-石牌,2024-07-17,8711
00688L,國泰20年美債正2,145,25,120,陽信-石牌,2024-07-17,8711
2892,第一金,89,0,89,陽信-石牌,2024-07-17,8711
2542,興富發,92,4,88,陽信-石牌,2024-07-17,8711
00929,復華台灣科技優息,80,1,79,陽信-石牌,2024-07-17,8711
3231,緯創,95,26,69,陽信-石牌,2024-07-17,8711
1722,台肥,61,0,61,陽信-石牌,2024-07-17,8711
00673R,期元大S＆P原油反1,58,0,58,陽信-石牌,2024-07-17,8711
3706,神達,61,3,58,陽信-石牌,2024-07-17,8711
00937B,群益ESG投等債20,51,0,51,陽信-石牌,2024-07-17,8711
2801,彰銀,50,0,50,陽信-石牌,2024-07-17,8711
1402,遠東新,50,0,50,陽信-石牌,2024-07-17,8711
2317,鴻海,74,27,47,陽信-石牌,2024-07-17,8711
2312,金寶,84,44,40,陽信-石牌,2024-07-17,8711
1409,新纖,42,5,37,陽信-石牌,2024-07-17,8711
00946,群益科技高息成長,35,0,35,陽信-石牌,2024-07-17,8711
1609,大亞,116,81,35,陽信-石牌,2024-07-17,8711
00919,群益台灣精選高息,105,71,34,陽信-石牌,2024-07-17,8711
6139,亞翔,31,0,31,陽信-石牌,2024-07-17,8711
00930,永豐ESG低碳高息,30,0,30,陽信-石牌,2024-07-17,8711
5309,系統電,38,10,28,陽信-石牌,2024-07-17,8711
2845,遠東銀,27,0,27,陽信-石牌,2024-07-17,8711
00753L,中信中國50正2,25,0,25,陽信-石牌,2024-07-17,8711
4906,正文,29,4,25,陽信-石牌,2024-07-17,8711
8067,志旭,25,0,25,陽信-石牌,2024-07-17,8711
3013,晟銘電,42,20,22,陽信-石牌,2024-07-17,8711
9105,泰金寶-DR,55,33,22,陽信-石牌,2024-07-17,8711
0056,元大高股息,22,0,22,陽信-石牌,2024-07-17,8711
00878,國泰永續高股息,21,0,21,陽信-石牌,2024-07-17,8711
2408,南亞科,21,0,21,陽信-石牌,2024-07-17,8711
2515,中工,63,42,21,陽信-石牌,2024-07-17,8711
3056,富華新,23,2,21,陽信-石牌,2024-07-17,8711
3379,彬台,33,14,19,陽信-石牌,2024-07-17,8711
5388,中磊,20,1,19,陽信-石牌,2024-07-17,8711
00935,野村臺灣新科技50,18,1,17,陽信-石牌,2024-07-17,8711
2392,正崴,22,5,17,陽信-石牌,2024-07-17,8711
3494,誠研,17,0,17,陽信-石牌,2024-07-17,8711
2449,京元電子,19,2,17,陽信-石牌,2024-07-17,8711
00949,復華日本龍頭,21,5,16,陽信-石牌,2024-07-17,8711
2402,毅嘉,51,36,15,陽信-石牌,2024-07-17,8711
5202,力新,19,4,15,陽信-石牌,2024-07-17,8711
911868,同方友友-DR,15,0,15,陽信-石牌,2024-07-17,8711
4977,眾達-KY,21,7,14,陽信-石牌,2024-07-17,8711
2537,聯上發,49,36,13,陽信-石牌,2024-07-17,8711
6160,欣技,12,0,12,陽信-石牌,2024-07-17,8711
9946,三發地產,14,2,12,陽信-石牌,2024-07-17,8711
00690,兆豐藍籌30,11,0,11,陽信-石牌,2024-07-17,8711
00940,元大台灣價值高息,11,0,11,陽信-石牌,2024-07-17,8711
3294,英濟,17,6,11,陽信-石牌,2024-07-17,8711
6770,力積電,219,47,172,陽信-石牌,2024-07-18,8711
2330,台積電,141,21,120,陽信-石牌,2024-07-18,8711
2845,遠東銀,88,0,88,陽信-石牌,2024-07-18,8711
2888,新光金,87,8,79,陽信-石牌,2024-07-18,8711
2014,中鴻,75,0,75,陽信-石牌,2024-07-18,8711
00940,元大台灣價值高息,73,0,73,陽信-石牌,2024-07-18,8711
2317,鴻海,87,19,68,陽信-石牌,2024-07-18,8711
00720B,元大投資級公司債,65,0,65,陽信-石牌,2024-07-18,8711
00937B,群益ESG投等債20,83,19,64,陽信-石牌,2024-07-18,8711
2444,兆勁,104,41,63,陽信-石牌,2024-07-18,8711
00857B,永豐20年美公債,62,0,62,陽信-石牌,2024-07-18,8711
00715L,期街口布蘭特正2,58,0,58,陽信-石牌,2024-07-18,8711
2495,普安,70,15,55,陽信-石牌,2024-07-18,8711
3037,欣興,81,27,54,陽信-石牌,2024-07-18,8711
6116,彩晶,52,0,52,陽信-石牌,2024-07-18,8711
00929,復華台灣科技優息,77,28,49,陽信-石牌,2024-07-18,8711
1316,上曜,41,0,41,陽信-石牌,2024-07-18,8711
00948B,中信優息投資級債,40,0,40,陽信-石牌,2024-07-18,8711
3710,連展投控,40,1,39,陽信-石牌,2024-07-18,8711
3481,群創,144,110,34,陽信-石牌,2024-07-18,8711
00927,群益半導體收益,33,0,33,陽信-石牌,2024-07-18,8711
2618,長榮航,37,6,31,陽信-石牌,2024-07-18,8711
2867,三商壽,48,18,30,陽信-石牌,2024-07-18,8711
00878,國泰永續高股息,32,5,27,陽信-石牌,2024-07-18,8711
3060,銘異,45,18,27,陽信-石牌,2024-07-18,8711
0056,元大高股息,27,1,26,陽信-石牌,2024-07-18,8711
00738U,期元大道瓊白銀,26,0,26,陽信-石牌,2024-07-18,8711
1815,富喬,28,2,26,陽信-石牌,2024-07-18,8711
1597,直得,47,22,25,陽信-石牌,2024-07-18,8711
2634,漢翔,37,13,24,陽信-石牌,2024-07-18,8711
2887,台新金,26,2,24,陽信-石牌,2024-07-18,8711
00687B,國泰20年美債,23,0,23,陽信-石牌,2024-07-18,8711
2367,燿華,43,20,23,陽信-石牌,2024-07-18,8711
3494,誠研,23,0,23,陽信-石牌,2024-07-18,8711
3591,艾笛森,24,1,23,陽信-石牌,2024-07-18,8711
6177,達麗,23,0,23,陽信-石牌,2024-07-18,8711
2449,京元電子,25,3,22,陽信-石牌,2024-07-18,8711
3062,建漢,22,0,22,陽信-石牌,2024-07-18,8711
00669R,國泰美國道瓊反1,20,0,20,陽信-石牌,2024-07-18,8711
00665L,富邦�琤肭磪囓�2,40,20,20,陽信-石牌,2024-07-18,8711
00946,群益科技高息成長,20,0,20,陽信-石牌,2024-07-18,8711
02001L,富邦蘋果正二N,20,0,20,陽信-石牌,2024-07-18,8711
2409,友達,22,2,20,陽信-石牌,2024-07-18,8711
2501,國建,27,7,20,陽信-石牌,2024-07-18,8711
8105,凌巨,58,38,20,陽信-石牌,2024-07-18,8711
00935,野村臺灣新科技50,19,0,19,陽信-石牌,2024-07-18,8711
6290,良維,19,1,18,陽信-石牌,2024-07-18,8711
8085,福華,18,0,18,陽信-石牌,2024-07-18,8711
2609,陽明,19,1,18,陽信-石牌,2024-07-18,8711
3202,樺晟,17,0,17,陽信-石牌,2024-07-18,8711
00940,元大台灣價值高息,127,0,127,陽信-石牌,2024-07-19,8711
00878,國泰永續高股息,130,7,123,陽信-石牌,2024-07-19,8711
00919,群益台灣精選高息,124,2,122,陽信-石牌,2024-07-19,8711
6770,力積電,123,6,117,陽信-石牌,2024-07-19,8711
2890,永豐金,102,1,101,陽信-石牌,2024-07-19,8711
2888,新光金,105,13,92,陽信-石牌,2024-07-19,8711
00929,復華台灣科技優息,86,2,84,陽信-石牌,2024-07-19,8711
3260,威剛,81,1,80,陽信-石牌,2024-07-19,8711
2542,興富發,123,45,78,陽信-石牌,2024-07-19,8711
1609,大亞,118,52,66,陽信-石牌,2024-07-19,8711
3060,銘異,64,0,64,陽信-石牌,2024-07-19,8711
2884,玉山金,66,7,59,陽信-石牌,2024-07-19,8711
00673R,期元大S＆P原油反1,54,0,54,陽信-石牌,2024-07-19,8711
1722,台肥,50,0,50,陽信-石牌,2024-07-19,8711
0056,元大高股息,55,6,49,陽信-石牌,2024-07-19,8711
2330,台積電,65,17,48,陽信-石牌,2024-07-19,8711
2610,華航,50,3,47,陽信-石牌,2024-07-19,8711
6116,彩晶,44,0,44,陽信-石牌,2024-07-19,8711
2834,臺企銀,43,0,43,陽信-石牌,2024-07-19,8711
5425,台半,35,0,35,陽信-石牌,2024-07-19,8711
1718,中纖,32,0,32,陽信-石牌,2024-07-19,8711
4157,太景*-KY,32,0,32,陽信-石牌,2024-07-19,8711
2883,凱基金,31,0,31,陽信-石牌,2024-07-19,8711
00680L,元大美債20正2,30,0,30,陽信-石牌,2024-07-19,8711
2495,普安,46,16,30,陽信-石牌,2024-07-19,8711
9105,泰金寶-DR,34,4,30,陽信-石牌,2024-07-19,8711
6257,矽格,31,3,28,陽信-石牌,2024-07-19,8711
2845,遠東銀,27,0,27,陽信-石牌,2024-07-19,8711
2356,英業達,32,6,26,陽信-石牌,2024-07-19,8711
8299,群聯,25,0,25,陽信-石牌,2024-07-19,8711
2365,昆盈,63,38,25,陽信-石牌,2024-07-19,8711
3167,大量,25,0,25,陽信-石牌,2024-07-19,8711
2891,中信金,33,10,23,陽信-石牌,2024-07-19,8711
00753L,中信中國50正2,23,0,23,陽信-石牌,2024-07-19,8711
00937B,群益ESG投等債20,23,0,23,陽信-石牌,2024-07-19,8711
3231,緯創,34,11,23,陽信-石牌,2024-07-19,8711
2867,三商壽,45,23,22,陽信-石牌,2024-07-19,8711
4958,臻鼎-KY,30,8,22,陽信-石牌,2024-07-19,8711
1785,光洋科,25,4,21,陽信-石牌,2024-07-19,8711
2882,國泰金,21,0,21,陽信-石牌,2024-07-19,8711
3607,谷崧,21,0,21,陽信-石牌,2024-07-19,8711
00650L,復華香港正2,20,0,20,陽信-石牌,2024-07-19,8711
00738U,期元大道瓊白銀,20,0,20,陽信-石牌,2024-07-19,8711
3037,欣興,40,20,20,陽信-石牌,2024-07-19,8711
3710,連展投控,20,0,20,陽信-石牌,2024-07-19,8711
6290,良維,20,0,20,陽信-石牌,2024-07-19,8711
00713,元大台灣高息低波,20,1,19,陽信-石牌,2024-07-19,8711
2402,毅嘉,23,4,19,陽信-石牌,2024-07-19,8711
3481,群創,40,21,19,陽信-石牌,2024-07-19,8711
4916,事欣科,43,25,18,陽信-石牌,2024-07-19,8711
2888,新光金,270,27,243,陽信-石牌,2024-07-22,8711
3481,群創,215,23,192,陽信-石牌,2024-07-22,8711
00929,復華台灣科技優息,302,118,184,陽信-石牌,2024-07-22,8711
2409,友達,209,27,182,陽信-石牌,2024-07-22,8711
00940,元大台灣價值高息,182,2,180,陽信-石牌,2024-07-22,8711
00919,群益台灣精選高息,141,7,134,陽信-石牌,2024-07-22,8711
2883,凱基金,133,0,133,陽信-石牌,2024-07-22,8711
00878,國泰永續高股息,95,7,88,陽信-石牌,2024-07-22,8711
00946,群益科技高息成長,86,8,78,陽信-石牌,2024-07-22,8711
2317,鴻海,84,18,66,陽信-石牌,2024-07-22,8711
00715L,期街口布蘭特正2,60,0,60,陽信-石牌,2024-07-22,8711
6770,力積電,62,4,58,陽信-石牌,2024-07-22,8711
8473,山林水,89,31,58,陽信-石牌,2024-07-22,8711
00688L,國泰20年美債正2,55,0,55,陽信-石牌,2024-07-22,8711
1722,台肥,50,0,50,陽信-石牌,2024-07-22,8711
2419,仲琦,127,79,48,陽信-石牌,2024-07-22,8711
1714,和桐,47,2,45,陽信-石牌,2024-07-22,8711
4563,百德,40,0,40,陽信-石牌,2024-07-22,8711
1609,大亞,76,40,36,陽信-石牌,2024-07-22,8711
2312,金寶,78,52,26,陽信-石牌,2024-07-22,8711
5425,台半,31,5,26,陽信-石牌,2024-07-22,8711
0056,元大高股息,26,1,25,陽信-石牌,2024-07-22,8711
6116,彩晶,25,0,25,陽信-石牌,2024-07-22,8711
1314,中石化,21,0,21,陽信-石牌,2024-07-22,8711
2867,三商壽,28,7,21,陽信-石牌,2024-07-22,8711
3019,亞光,51,30,21,陽信-石牌,2024-07-22,8711
2444,兆勁,20,0,20,陽信-石牌,2024-07-22,8711
2495,普安,20,0,20,陽信-石牌,2024-07-22,8711
2637,慧洋-KY,20,0,20,陽信-石牌,2024-07-22,8711
2736,富野,20,0,20,陽信-石牌,2024-07-22,8711
2542,興富發,21,2,19,陽信-石牌,2024-07-22,8711
5512,力麒,33,14,19,陽信-石牌,2024-07-22,8711
1725,元禎,18,0,18,陽信-石牌,2024-07-22,8711
2337,旺宏,18,0,18,陽信-石牌,2024-07-22,8711
4927,泰鼎-KY,18,0,18,陽信-石牌,2024-07-22,8711
8064,東捷,48,31,17,陽信-石牌,2024-07-22,8711
9945,潤泰新,17,0,17,陽信-石牌,2024-07-22,8711
1514,亞力,21,5,16,陽信-石牌,2024-07-22,8711
2610,華航,16,0,16,陽信-石牌,2024-07-22,8711
2884,玉山金,16,0,16,陽信-石牌,2024-07-22,8711
00651R,復華香港反1,15,0,15,陽信-石牌,2024-07-22,8711
1616,億泰,16,1,15,陽信-石牌,2024-07-22,8711
3231,緯創,54,40,14,陽信-石牌,2024-07-22,8711
2027,大成鋼,36,23,13,陽信-石牌,2024-07-22,8711
3710,連展投控,13,0,13,陽信-石牌,2024-07-22,8711
6139,亞翔,15,2,13,陽信-石牌,2024-07-22,8711
00687B,國泰20年美債,12,0,12,陽信-石牌,2024-07-22,8711
3324,雙鴻,12,0,12,陽信-石牌,2024-07-22,8711
2324,仁寶,17,6,11,陽信-石牌,2024-07-22,8711
8104,錸寶,13,2,11,陽信-石牌,2024-07-22,8711
2409,友達,318,21,297,陽信-石牌,2024-07-23,8711
00937B,群益ESG投等債20,175,0,175,陽信-石牌,2024-07-23,8711
00878,國泰永續高股息,137,17,120,陽信-石牌,2024-07-23,8711
3481,群創,136,29,107,陽信-石牌,2024-07-23,8711
00929,復華台灣科技優息,97,2,95,陽信-石牌,2024-07-23,8711
00919,群益台灣精選高息,114,31,83,陽信-石牌,2024-07-23,8711
4916,事欣科,69,1,68,陽信-石牌,2024-07-23,8711
2330,台積電,71,16,55,陽信-石牌,2024-07-23,8711
2444,兆勁,69,15,54,陽信-石牌,2024-07-23,8711
6152,百一,54,0,54,陽信-石牌,2024-07-23,8711
00940,元大台灣價值高息,44,0,44,陽信-石牌,2024-07-23,8711
2367,燿華,42,0,42,陽信-石牌,2024-07-23,8711
1463,強盛新,41,0,41,陽信-石牌,2024-07-23,8711
2408,南亞科,38,0,38,陽信-石牌,2024-07-23,8711
00934,中信成長高股息,60,24,36,陽信-石牌,2024-07-23,8711
1717,長興,35,0,35,陽信-石牌,2024-07-23,8711
00930,永豐ESG低碳高息,34,0,34,陽信-石牌,2024-07-23,8711
2312,金寶,36,6,30,陽信-石牌,2024-07-23,8711
8440,綠電,42,15,27,陽信-石牌,2024-07-23,8711
2520,冠德,25,2,23,陽信-石牌,2024-07-23,8711
00857B,永豐20年美公債,21,0,21,陽信-石牌,2024-07-23,8711
2356,英業達,24,4,20,陽信-石牌,2024-07-23,8711
5876,上海商銀,20,0,20,陽信-石牌,2024-07-23,8711
00933B,國泰10Y+金融債,20,0,20,陽信-石牌,2024-07-23,8711
5534,長虹,83,64,19,陽信-石牌,2024-07-23,8711
2489,瑞軒,46,29,17,陽信-石牌,2024-07-23,8711
2359,所羅門,26,10,16,陽信-石牌,2024-07-23,8711
2464,盟立,16,0,16,陽信-石牌,2024-07-23,8711
2867,三商壽,20,4,16,陽信-石牌,2024-07-23,8711
1514,亞力,25,11,14,陽信-石牌,2024-07-23,8711
00946,群益科技高息成長,13,0,13,陽信-石牌,2024-07-23,8711
8064,東捷,24,11,13,陽信-石牌,2024-07-23,8711
1603,華電,12,0,12,陽信-石牌,2024-07-23,8711
8271,宇瞻,13,1,12,陽信-石牌,2024-07-23,8711
4533,協易機,11,0,11,陽信-石牌,2024-07-23,8711
4566,時碩工業,16,5,11,陽信-石牌,2024-07-23,8711
2406,國碩,10,0,10,陽信-石牌,2024-07-23,8711
3056,富華新,10,0,10,陽信-石牌,2024-07-23,8711
3060,銘異,10,0,10,陽信-石牌,2024-07-23,8711
3520,華盈,10,0,10,陽信-石牌,2024-07-23,8711
3607,谷崧,10,0,10,陽信-石牌,2024-07-23,8711
8176,智捷,10,0,10,陽信-石牌,2024-07-23,8711
2104,國際中橡,8,0,8,陽信-石牌,2024-07-23,8711
2344,華邦電,13,5,8,陽信-石牌,2024-07-23,8711
2301,光寶科,11,3,8,陽信-石牌,2024-07-23,8711
5202,力新,8,0,8,陽信-石牌,2024-07-23,8711
0050,元大台灣50,7,0,7,陽信-石牌,2024-07-23,8711
2349,錸德,7,0,7,陽信-石牌,2024-07-23,8711
3362,先進光,8,1,7,陽信-石牌,2024-07-23,8711
3673,TPK-KY,7,0,7,陽信-石牌,2024-07-23,8711
00650L,復華香港正2,265,16,249,陽信-石牌,2024-07-26,8711
2002,中鋼,207,5,202,陽信-石牌,2024-07-26,8711
00929,復華台灣科技優息,140,1,139,陽信-石牌,2024-07-26,8711
00937B,群益ESG投等債20,122,0,122,陽信-石牌,2024-07-26,8711
00919,群益台灣精選高息,86,2,84,陽信-石牌,2024-07-26,8711
2409,友達,80,0,80,陽信-石牌,2024-07-26,8711
00878,國泰永續高股息,80,8,72,陽信-石牌,2024-07-26,8711
00857B,永豐20年美公債,60,0,60,陽信-石牌,2024-07-26,8711
6770,力積電,66,10,56,陽信-石牌,2024-07-26,8711
00946,群益科技高息成長,51,0,51,陽信-石牌,2024-07-26,8711
00712,復華富時不動產,50,0,50,陽信-石牌,2024-07-26,8711
00933B,國泰10Y+金融債,50,0,50,陽信-石牌,2024-07-26,8711
2801,彰銀,50,0,50,陽信-石牌,2024-07-26,8711
00720B,元大投資級公司債,50,5,45,陽信-石牌,2024-07-26,8711
2349,錸德,41,1,40,陽信-石牌,2024-07-26,8711
2317,鴻海,48,10,38,陽信-石牌,2024-07-26,8711
00940,元大台灣價值高息,47,10,37,陽信-石牌,2024-07-26,8711
2330,台積電,43,7,36,陽信-石牌,2024-07-26,8711
2356,英業達,35,0,35,陽信-石牌,2024-07-26,8711
1216,統一,30,0,30,陽信-石牌,2024-07-26,8711
1309,台達化,30,0,30,陽信-石牌,2024-07-26,8711
00673R,期元大S＆P原油反1,48,21,27,陽信-石牌,2024-07-26,8711
00927,群益半導體收益,25,0,25,陽信-石牌,2024-07-26,8711
2486,一詮,26,1,25,陽信-石牌,2024-07-26,8711
3711,日月光投控,25,2,23,陽信-石牌,2024-07-26,8711
2344,華邦電,24,3,21,陽信-石牌,2024-07-26,8711
3231,緯創,21,1,20,陽信-石牌,2024-07-26,8711
4804,大略-KY,20,0,20,陽信-石牌,2024-07-26,8711
8105,凌巨,30,10,20,陽信-石牌,2024-07-26,8711
1503,士電,22,3,19,陽信-石牌,2024-07-26,8711
2884,玉山金,20,1,19,陽信-石牌,2024-07-26,8711
00882,中信中國高股息,21,2,19,陽信-石牌,2024-07-26,8711
1725,元禎,17,0,17,陽信-石牌,2024-07-26,8711
4743,合一,19,2,17,陽信-石牌,2024-07-26,8711
00881,國泰台灣5G+,16,0,16,陽信-石牌,2024-07-26,8711
0056,元大高股息,25,10,15,陽信-石牌,2024-07-26,8711
2436,偉詮電,15,0,15,陽信-石牌,2024-07-26,8711
6901,鑽石投資,15,0,15,陽信-石牌,2024-07-26,8711
1519,華城,19,5,14,陽信-石牌,2024-07-26,8711
00949,復華日本龍頭,14,0,14,陽信-石牌,2024-07-26,8711
8473,山林水,25,11,14,陽信-石牌,2024-07-26,8711
00936,台新永續高息中小,12,0,12,陽信-石牌,2024-07-26,8711
2337,旺宏,12,0,12,陽信-石牌,2024-07-26,8711
2382,廣達,18,7,11,陽信-石牌,2024-07-26,8711
00931B,統一美債20年,11,0,11,陽信-石牌,2024-07-26,8711
2891,中信金,16,5,11,陽信-石牌,2024-07-26,8711
00713,元大台灣高息低波,11,0,11,陽信-石牌,2024-07-26,8711
1785,光洋科,16,6,10,陽信-石牌,2024-07-26,8711
2365,昆盈,30,20,10,陽信-石牌,2024-07-26,8711
4716,大立,10,0,10,陽信-石牌,2024-07-26,8711
00929,復華台灣科技優息,161,4,157,陽信-石牌,2024-07-29,8711
00878,國泰永續高股息,116,16,100,陽信-石牌,2024-07-29,8711
00940,元大台灣價值高息,78,1,77,陽信-石牌,2024-07-29,8711
00715L,期街口布蘭特正2,65,0,65,陽信-石牌,2024-07-29,8711
6116,彩晶,61,0,61,陽信-石牌,2024-07-29,8711
2356,英業達,60,8,52,陽信-石牌,2024-07-29,8711
2331,精英,50,0,50,陽信-石牌,2024-07-29,8711
2444,兆勁,50,0,50,陽信-石牌,2024-07-29,8711
1815,富喬,49,0,49,陽信-石牌,2024-07-29,8711
00915,凱基優選高股息30,43,2,41,陽信-石牌,2024-07-29,8711
1309,台達化,40,0,40,陽信-石牌,2024-07-29,8711
00919,群益台灣精選高息,54,19,35,陽信-石牌,2024-07-29,8711
2867,三商壽,39,4,35,陽信-石牌,2024-07-29,8711
8473,山林水,36,8,28,陽信-石牌,2024-07-29,8711
6152,百一,25,0,25,陽信-石牌,2024-07-29,8711
1725,元禎,24,0,24,陽信-石牌,2024-07-29,8711
00946,群益科技高息成長,22,0,22,陽信-石牌,2024-07-29,8711
2515,中工,26,4,22,陽信-石牌,2024-07-29,8711
0056,元大高股息,29,8,21,陽信-石牌,2024-07-29,8711
2367,燿華,26,6,20,陽信-石牌,2024-07-29,8711
3057,喬鼎,20,0,20,陽信-石牌,2024-07-29,8711
8054,安國,25,6,19,陽信-石牌,2024-07-29,8711
1216,統一,19,0,19,陽信-石牌,2024-07-29,8711
3029,零壹,19,0,19,陽信-石牌,2024-07-29,8711
2501,國建,18,0,18,陽信-石牌,2024-07-29,8711
3013,晟銘電,18,0,18,陽信-石牌,2024-07-29,8711
4916,事欣科,40,22,18,陽信-石牌,2024-07-29,8711
2409,友達,27,10,17,陽信-石牌,2024-07-29,8711
2543,皇昌,21,4,17,陽信-石牌,2024-07-29,8711
6550,北極星藥業-KY,15,0,15,陽信-石牌,2024-07-29,8711
00934,中信成長高股息,15,1,14,陽信-石牌,2024-07-29,8711
2312,金寶,34,20,14,陽信-石牌,2024-07-29,8711
4526,東台,17,3,14,陽信-石牌,2024-07-29,8711
6472,保瑞,15,1,14,陽信-石牌,2024-07-29,8711
3037,欣興,18,5,13,陽信-石牌,2024-07-29,8711
2408,南亞科,16,3,13,陽信-石牌,2024-07-29,8711
2534,宏盛,31,18,13,陽信-石牌,2024-07-29,8711
2371,大同,15,3,12,陽信-石牌,2024-07-29,8711
2399,映泰,12,0,12,陽信-石牌,2024-07-29,8711
8064,東捷,24,12,12,陽信-石牌,2024-07-29,8711
4743,合一,12,1,11,陽信-石牌,2024-07-29,8711
2329,華泰,12,1,11,陽信-石牌,2024-07-29,8711
2845,遠東銀,11,0,11,陽信-石牌,2024-07-29,8711
3060,銘異,11,0,11,陽信-石牌,2024-07-29,8711
3260,威剛,11,0,11,陽信-石牌,2024-07-29,8711
1304,台聚,10,0,10,陽信-石牌,2024-07-29,8711
2316,楠梓電,10,0,10,陽信-石牌,2024-07-29,8711
2406,國碩,10,0,10,陽信-石牌,2024-07-29,8711
3591,艾笛森,11,1,10,陽信-石牌,2024-07-29,8711
3615,安可,10,0,10,陽信-石牌,2024-07-29,8711
00937B,群益ESG投等債20,279,0,279,陽信-石牌,2024-07-30,8711
00688L,國泰20年美債正2,250,0,250,陽信-石牌,2024-07-30,8711
00929,復華台灣科技優息,192,4,188,陽信-石牌,2024-07-30,8711
2409,友達,153,0,153,陽信-石牌,2024-07-30,8711
1337,再生-KY,94,0,94,陽信-石牌,2024-07-30,8711
00687B,國泰20年美債,85,0,85,陽信-石牌,2024-07-30,8711
00946,群益科技高息成長,84,1,83,陽信-石牌,2024-07-30,8711
1301,台塑,47,0,47,陽信-石牌,2024-07-30,8711
1216,統一,42,0,42,陽信-石牌,2024-07-30,8711
3673,TPK-KY,40,1,39,陽信-石牌,2024-07-30,8711
2017,官田鋼,38,0,38,陽信-石牌,2024-07-30,8711
00940,元大台灣價值高息,35,0,35,陽信-石牌,2024-07-30,8711
2303,聯電,33,1,32,陽信-石牌,2024-07-30,8711
00918,大華優利高填息30,31,0,31,陽信-石牌,2024-07-30,8711
2331,精英,30,0,30,陽信-石牌,2024-07-30,8711
6209,今國光,30,0,30,陽信-石牌,2024-07-30,8711
0056,元大高股息,35,6,29,陽信-石牌,2024-07-30,8711
3188,鑫龍騰,26,0,26,陽信-石牌,2024-07-30,8711
2317,鴻海,36,11,25,陽信-石牌,2024-07-30,8711
6451,訊芯-KY,28,3,25,陽信-石牌,2024-07-30,8711
00878,國泰永續高股息,32,9,23,陽信-石牌,2024-07-30,8711
00665L,富邦�琤肭磪囓�2,30,10,20,陽信-石牌,2024-07-30,8711
3019,亞光,32,12,20,陽信-石牌,2024-07-30,8711
3346,麗清,20,0,20,陽信-石牌,2024-07-30,8711
2464,盟立,22,4,18,陽信-石牌,2024-07-30,8711
3312,弘憶股,21,3,18,陽信-石牌,2024-07-30,8711
2002,中鋼,16,0,16,陽信-石牌,2024-07-30,8711
00915,凱基優選高股息30,15,0,15,陽信-石牌,2024-07-30,8711
00724B,群益投資級金融債,15,0,15,陽信-石牌,2024-07-30,8711
1609,大亞,28,13,15,陽信-石牌,2024-07-30,8711
2406,國碩,14,0,14,陽信-石牌,2024-07-30,8711
00679B,元大美債20年,17,4,13,陽信-石牌,2024-07-30,8711
1795,美時,13,0,13,陽信-石牌,2024-07-30,8711
2537,聯上發,15,2,13,陽信-石牌,2024-07-30,8711
00934,中信成長高股息,13,1,12,陽信-石牌,2024-07-30,8711
2344,華邦電,11,0,11,陽信-石牌,2024-07-30,8711
2610,華航,19,8,11,陽信-石牌,2024-07-30,8711
3189,景碩,21,10,11,陽信-石牌,2024-07-30,8711
00715L,期街口布蘭特正2,10,0,10,陽信-石牌,2024-07-30,8711
2478,大毅,10,0,10,陽信-石牌,2024-07-30,8711
2539,櫻花建,10,0,10,陽信-石牌,2024-07-30,8711
2880,華南金,10,0,10,陽信-石牌,2024-07-30,8711
2882,國泰金,10,0,10,陽信-石牌,2024-07-30,8711
3374,精材,23,13,10,陽信-石牌,2024-07-30,8711
5272,笙科,12,2,10,陽信-石牌,2024-07-30,8711
6224,聚鼎,10,0,10,陽信-石牌,2024-07-30,8711
2349,錸德,74,65,9,陽信-石牌,2024-07-30,8711
2408,南亞科,9,0,9,陽信-石牌,2024-07-30,8711
1598,岱宇,8,0,8,陽信-石牌,2024-07-30,8711
2891,中信金,14,6,8,陽信-石牌,2024-07-30,8711
00944,野村趨勢動能高息,100,0,100,陽信-石牌,2024-07-31,8711
00929,復華台灣科技優息,95,3,92,陽信-石牌,2024-07-31,8711
3481,群創,422,356,66,陽信-石牌,2024-07-31,8711
00940,元大台灣價值高息,62,0,62,陽信-石牌,2024-07-31,8711
6451,訊芯-KY,45,0,45,陽信-石牌,2024-07-31,8711
8201,無敵,41,0,41,陽信-石牌,2024-07-31,8711
2317,鴻海,52,16,36,陽信-石牌,2024-07-31,8711
6239,力成,33,0,33,陽信-石牌,2024-07-31,8711
00937B,群益ESG投等債20,32,0,32,陽信-石牌,2024-07-31,8711
8064,東捷,67,35,32,陽信-石牌,2024-07-31,8711
00715L,期街口布蘭特正2,31,0,31,陽信-石牌,2024-07-31,8711
6257,矽格,34,7,27,陽信-石牌,2024-07-31,8711
2204,中華,22,0,22,陽信-石牌,2024-07-31,8711
4123,晟德,21,0,21,陽信-石牌,2024-07-31,8711
2312,金寶,44,24,20,陽信-石牌,2024-07-31,8711
6282,康舒,20,0,20,陽信-石牌,2024-07-31,8711
00687B,國泰20年美債,20,2,18,陽信-石牌,2024-07-31,8711
3047,訊舟,107,90,17,陽信-石牌,2024-07-31,8711
02001L,富邦蘋果正二N,15,0,15,陽信-石牌,2024-07-31,8711
00724B,群益投資級金融債,15,0,15,陽信-石牌,2024-07-31,8711
2356,英業達,32,17,15,陽信-石牌,2024-07-31,8711
5443,均豪,44,29,15,陽信-石牌,2024-07-31,8711
5534,長虹,69,54,15,陽信-石牌,2024-07-31,8711
6116,彩晶,15,0,15,陽信-石牌,2024-07-31,8711
6216,居易,15,0,15,陽信-石牌,2024-07-31,8711
2330,台積電,17,2,15,陽信-石牌,2024-07-31,8711
1599,宏佳騰,14,0,14,陽信-石牌,2024-07-31,8711
2538,基泰,40,26,14,陽信-石牌,2024-07-31,8711
2527,宏璟,13,1,12,陽信-石牌,2024-07-31,8711
5328,華容,12,0,12,陽信-石牌,2024-07-31,8711
5512,力麒,16,4,12,陽信-石牌,2024-07-31,8711
8440,綠電,14,2,12,陽信-石牌,2024-07-31,8711
2349,錸德,61,50,11,陽信-石牌,2024-07-31,8711
3037,欣興,15,4,11,陽信-石牌,2024-07-31,8711
8046,南電,10,0,10,陽信-石牌,2024-07-31,8711
2399,映泰,10,0,10,陽信-石牌,2024-07-31,8711
2449,京元電子,13,3,10,陽信-石牌,2024-07-31,8711
3056,富華新,10,0,10,陽信-石牌,2024-07-31,8711
4726,永昕,10,0,10,陽信-石牌,2024-07-31,8711
4916,事欣科,10,0,10,陽信-石牌,2024-07-31,8711
4927,泰鼎-KY,10,0,10,陽信-石牌,2024-07-31,8711
6202,盛群,10,0,10,陽信-石牌,2024-07-31,8711
8076,伍豐,10,0,10,陽信-石牌,2024-07-31,8711
6869,雲豹能源,14,4,10,陽信-石牌,2024-07-31,8711
3060,銘異,31,22,9,陽信-石牌,2024-07-31,8711
5519,隆大,11,2,9,陽信-石牌,2024-07-31,8711
1314,中石化,10,1,9,陽信-石牌,2024-07-31,8711
3105,穩懋,11,3,8,陽信-石牌,2024-07-31,8711
1455,集盛,8,0,8,陽信-石牌,2024-07-31,8711
2883,凱基金,13,5,8,陽信-石牌,2024-07-31,8711
2886,兆豐金,100,1,99,陽信-石牌,2024-08-01,8711
9105,泰金寶-DR,83,23,60,陽信-石牌,2024-08-01,8711
3231,緯創,78,21,57,陽信-石牌,2024-08-01,8711
00673R,期元大S＆P原油反1,55,0,55,陽信-石牌,2024-08-01,8711
2890,永豐金,50,0,50,陽信-石牌,2024-08-01,8711
2881,富邦金,50,2,48,陽信-石牌,2024-08-01,8711
3019,亞光,50,2,48,陽信-石牌,2024-08-01,8711
00878,國泰永續高股息,40,5,35,陽信-石牌,2024-08-01,8711
00919,群益台灣精選高息,34,0,34,陽信-石牌,2024-08-01,8711
00934,中信成長高股息,32,0,32,陽信-石牌,2024-08-01,8711
2891,中信金,38,6,32,陽信-石牌,2024-08-01,8711
5521,工信,35,5,30,陽信-石牌,2024-08-01,8711
2515,中工,47,18,29,陽信-石牌,2024-08-01,8711
2538,基泰,44,20,24,陽信-石牌,2024-08-01,8711
2349,錸德,79,56,23,陽信-石牌,2024-08-01,8711
2887,台新金,22,0,22,陽信-石牌,2024-08-01,8711
2308,台達電,22,1,21,陽信-石牌,2024-08-01,8711
2910,統領,21,0,21,陽信-石牌,2024-08-01,8711
00930,永豐ESG低碳高息,20,0,20,陽信-石牌,2024-08-01,8711
3230,錦明,20,0,20,陽信-石牌,2024-08-01,8711
1711,永光,18,0,18,陽信-石牌,2024-08-01,8711
2736,富野,20,2,18,陽信-石牌,2024-08-01,8711
2382,廣達,49,31,18,陽信-石牌,2024-08-01,8711
2534,宏盛,20,5,15,陽信-石牌,2024-08-01,8711
3374,精材,16,2,14,陽信-石牌,2024-08-01,8711
2609,陽明,26,13,13,陽信-石牌,2024-08-01,8711
00687B,國泰20年美債,48,35,13,陽信-石牌,2024-08-01,8711
6451,訊芯-KY,23,10,13,陽信-石牌,2024-08-01,8711
2363,矽統,17,6,11,陽信-石牌,2024-08-01,8711
1513,中興電,12,1,11,陽信-石牌,2024-08-01,8711
1725,元禎,10,0,10,陽信-石牌,2024-08-01,8711
2610,華航,20,10,10,陽信-石牌,2024-08-01,8711
5474,聰泰,10,0,10,陽信-石牌,2024-08-01,8711
5533,皇鼎,10,0,10,陽信-石牌,2024-08-01,8711
6161,捷波,10,0,10,陽信-石牌,2024-08-01,8711
0052,富邦科技,9,0,9,陽信-石牌,2024-08-01,8711
2204,中華,11,2,9,陽信-石牌,2024-08-01,8711
4128,中天,10,1,9,陽信-石牌,2024-08-01,8711
6125,廣運,11,2,9,陽信-石牌,2024-08-01,8711
00923,群益台ESG低碳50,8,0,8,陽信-石牌,2024-08-01,8711
2324,仁寶,23,15,8,陽信-石牌,2024-08-01,8711
5905,南仁湖,8,0,8,陽信-石牌,2024-08-01,8711
6188,廣明,17,9,8,陽信-石牌,2024-08-01,8711
6901,鑽石投資,10,2,8,陽信-石牌,2024-08-01,8711
1540,喬福,7,0,7,陽信-石牌,2024-08-01,8711
3312,弘憶股,7,0,7,陽信-石牌,2024-08-01,8711
8028,昇陽半導體,16,9,7,陽信-石牌,2024-08-01,8711
8064,東捷,52,45,7,陽信-石牌,2024-08-01,8711
2454,聯發科,7,0,7,陽信-石牌,2024-08-01,8711
2383,台光電,7,1,6,陽信-石牌,2024-08-01,8711
00706L,期元大S＆P日圓正2,550,70,480,陽信-石牌,2024-08-02,8711
2886,兆豐金,166,0,166,陽信-石牌,2024-08-02,8711
2890,永豐金,155,5,150,陽信-石牌,2024-08-02,8711
00929,復華台灣科技優息,148,0,148,陽信-石牌,2024-08-02,8711
00878,國泰永續高股息,152,10,142,陽信-石牌,2024-08-02,8711
2344,華邦電,139,26,113,陽信-石牌,2024-08-02,8711
2317,鴻海,128,17,111,陽信-石牌,2024-08-02,8711
00650L,復華香港正2,110,0,110,陽信-石牌,2024-08-02,8711
1722,台肥,100,0,100,陽信-石牌,2024-08-02,8711
00715L,期街口布蘭特正2,76,0,76,陽信-石牌,2024-08-02,8711
6116,彩晶,75,0,75,陽信-石牌,2024-08-02,8711
00940,元大台灣價值高息,84,10,74,陽信-石牌,2024-08-02,8711
2303,聯電,75,3,72,陽信-石牌,2024-08-02,8711
00937B,群益ESG投等債20,72,0,72,陽信-石牌,2024-08-02,8711
00679B,元大美債20年,70,4,66,陽信-石牌,2024-08-02,8711
00919,群益台灣精選高息,74,10,64,陽信-石牌,2024-08-02,8711
2330,台積電,61,4,57,陽信-石牌,2024-08-02,8711
2615,萬海,80,24,56,陽信-石牌,2024-08-02,8711
2801,彰銀,50,0,50,陽信-石牌,2024-08-02,8711
2542,興富發,73,26,47,陽信-石牌,2024-08-02,8711
2530,華建,41,10,31,陽信-石牌,2024-08-02,8711
0056,元大高股息,31,0,31,陽信-石牌,2024-08-02,8711
1718,中纖,30,0,30,陽信-石牌,2024-08-02,8711
00923,群益台ESG低碳50,25,0,25,陽信-石牌,2024-08-02,8711
1597,直得,59,34,25,陽信-石牌,2024-08-02,8711
9105,泰金寶-DR,22,0,22,陽信-石牌,2024-08-02,8711
2603,長榮,25,4,21,陽信-石牌,2024-08-02,8711
2367,燿華,25,4,21,陽信-石牌,2024-08-02,8711
6202,盛群,20,0,20,陽信-石牌,2024-08-02,8711
6215,和椿,28,8,20,陽信-石牌,2024-08-02,8711
2408,南亞科,19,0,19,陽信-石牌,2024-08-02,8711
2501,國建,63,45,18,陽信-石牌,2024-08-02,8711
4526,東台,22,4,18,陽信-石牌,2024-08-02,8711
2382,廣達,26,9,17,陽信-石牌,2024-08-02,8711
3060,銘異,23,6,17,陽信-石牌,2024-08-02,8711
1316,上曜,24,8,16,陽信-石牌,2024-08-02,8711
3024,憶聲,18,2,16,陽信-石牌,2024-08-02,8711
00936,台新永續高息中小,15,0,15,陽信-石牌,2024-08-02,8711
2324,仁寶,16,1,15,陽信-石牌,2024-08-02,8711
2337,旺宏,19,4,15,陽信-石牌,2024-08-02,8711
3078,僑威,15,0,15,陽信-石牌,2024-08-02,8711
00934,中信成長高股息,14,0,14,陽信-石牌,2024-08-02,8711
2609,陽明,61,47,14,陽信-石牌,2024-08-02,8711
2634,漢翔,14,0,14,陽信-石牌,2024-08-02,8711
5534,長虹,38,24,14,陽信-石牌,2024-08-02,8711
2301,光寶科,35,22,13,陽信-石牌,2024-08-02,8711
00951,台新日本半導體,12,0,12,陽信-石牌,2024-08-02,8711
2891,中信金,17,5,12,陽信-石牌,2024-08-02,8711
3483,力致,12,0,12,陽信-石牌,2024-08-02,8711
00927,群益半導體收益,11,0,11,陽信-石牌,2024-08-02,8711
1802,台玻,528,0,528,陽信-石牌,2024-08-05,8711
00940,元大台灣價值高息,231,24,207,陽信-石牌,2024-08-05,8711
3105,穩懋,202,3,199,陽信-石牌,2024-08-05,8711
00680L,元大美債20正2,205,34,171,陽信-石牌,2024-08-05,8711
00687B,國泰20年美債,199,36,163,陽信-石牌,2024-08-05,8711
00929,復華台灣科技優息,214,74,140,陽信-石牌,2024-08-05,8711
00878,國泰永續高股息,148,16,132,陽信-石牌,2024-08-05,8711
2883,凱基金,123,4,119,陽信-石牌,2024-08-05,8711
2890,永豐金,106,0,106,陽信-石牌,2024-08-05,8711
00641R,富邦日本反1,103,0,103,陽信-石牌,2024-08-05,8711
2337,旺宏,112,11,101,陽信-石牌,2024-08-05,8711
2801,彰銀,101,0,101,陽信-石牌,2024-08-05,8711
2409,友達,105,5,100,陽信-石牌,2024-08-05,8711
2610,華航,164,86,78,陽信-石牌,2024-08-05,8711
00685L,群益臺灣加權正2,71,0,71,陽信-石牌,2024-08-05,8711
2845,遠東銀,73,5,68,陽信-石牌,2024-08-05,8711
00632R,元大台灣50反1,153,87,66,陽信-石牌,2024-08-05,8711
00919,群益台灣精選高息,80,16,64,陽信-石牌,2024-08-05,8711
00946,群益科技高息成長,59,0,59,陽信-石牌,2024-08-05,8711
00795B,中信美國公債20年,55,0,55,陽信-石牌,2024-08-05,8711
2330,台積電,84,33,51,陽信-石牌,2024-08-05,8711
2897,王道銀行,50,0,50,陽信-石牌,2024-08-05,8711
00669R,國泰美國道瓊反1,50,1,49,陽信-石牌,2024-08-05,8711
2317,鴻海,103,55,48,陽信-石牌,2024-08-05,8711
2606,裕民,47,0,47,陽信-石牌,2024-08-05,8711
3481,群創,174,128,46,陽信-石牌,2024-08-05,8711
00665L,富邦�琤肭磪囓�2,65,20,45,陽信-石牌,2024-08-05,8711
2886,兆豐金,44,0,44,陽信-石牌,2024-08-05,8711
2892,第一金,44,0,44,陽信-石牌,2024-08-05,8711
2515,中工,38,0,38,陽信-石牌,2024-08-05,8711
8076,伍豐,37,0,37,陽信-石牌,2024-08-05,8711
2312,金寶,37,3,34,陽信-石牌,2024-08-05,8711
2331,精英,32,0,32,陽信-石牌,2024-08-05,8711
6770,力積電,36,5,31,陽信-石牌,2024-08-05,8711
1605,華新,32,2,30,陽信-石牌,2024-08-05,8711
2356,英業達,49,20,29,陽信-石牌,2024-08-05,8711
2542,興富發,29,1,28,陽信-石牌,2024-08-05,8711
2834,臺企銀,32,4,28,陽信-石牌,2024-08-05,8711
1447,力鵬,26,0,26,陽信-石牌,2024-08-05,8711
2353,宏��,32,7,25,陽信-石牌,2024-08-05,8711
1301,台塑,29,5,24,陽信-石牌,2024-08-05,8711
00934,中信成長高股息,24,0,24,陽信-石牌,2024-08-05,8711
00941,中信上游半導體,24,0,24,陽信-石牌,2024-08-05,8711
4510,高鋒,49,26,23,陽信-石牌,2024-08-05,8711
2603,長榮,37,15,22,陽信-石牌,2024-08-05,8711
2885,元大金,62,40,22,陽信-石牌,2024-08-05,8711
2888,新光金,36,14,22,陽信-石牌,2024-08-05,8711
2201,裕隆,22,1,21,陽信-石牌,2024-08-05,8711
2880,華南金,21,0,21,陽信-石牌,2024-08-05,8711
3518,柏騰,22,1,21,陽信-石牌,2024-08-05,8711
1563,巧新,210,7,203,陽信-石牌,2024-08-06,8711
00929,復華台灣科技優息,177,25,152,陽信-石牌,2024-08-06,8711
00940,元大台灣價值高息,151,9,142,陽信-石牌,2024-08-06,8711
00632R,元大台灣50反1,165,40,125,陽信-石牌,2024-08-06,8711
00706L,期元大S＆P日圓正2,135,30,105,陽信-石牌,2024-08-06,8711
00641R,富邦日本反1,100,3,97,陽信-石牌,2024-08-06,8711
00680L,元大美債20正2,91,3,88,陽信-石牌,2024-08-06,8711
2547,日勝生,51,0,51,陽信-石牌,2024-08-06,8711
2409,友達,102,52,50,陽信-石牌,2024-08-06,8711
5512,力麒,51,4,47,陽信-石牌,2024-08-06,8711
2317,鴻海,113,70,43,陽信-石牌,2024-08-06,8711
9933,中鼎,52,11,41,陽信-石牌,2024-08-06,8711
3481,群創,66,27,39,陽信-石牌,2024-08-06,8711
2542,興富發,106,72,34,陽信-石牌,2024-08-06,8711
8054,安國,60,26,34,陽信-石牌,2024-08-06,8711
0050,元大台灣50,35,5,30,陽信-石牌,2024-08-06,8711
00857B,永豐20年美公債,61,35,26,陽信-石牌,2024-08-06,8711
00900,富邦特選高股息30,23,0,23,陽信-石牌,2024-08-06,8711
2745,五福,23,0,23,陽信-石牌,2024-08-06,8711
00878,國泰永續高股息,80,59,21,陽信-石牌,2024-08-06,8711
00937B,群益ESG投等債20,64,43,21,陽信-石牌,2024-08-06,8711
1598,岱宇,21,0,21,陽信-石牌,2024-08-06,8711
00905,FT臺灣Smart,20,0,20,陽信-石牌,2024-08-06,8711
3056,富華新,20,0,20,陽信-石牌,2024-08-06,8711
4909,新復興,48,28,20,陽信-石牌,2024-08-06,8711
00919,群益台灣精選高息,30,10,20,陽信-石牌,2024-08-06,8711
2356,英業達,31,12,19,陽信-石牌,2024-08-06,8711
5386,青雲,21,2,19,陽信-石牌,2024-08-06,8711
5347,世界,43,26,17,陽信-石牌,2024-08-06,8711
3312,弘憶股,18,2,16,陽信-石牌,2024-08-06,8711
3518,柏騰,17,1,16,陽信-石牌,2024-08-06,8711
4534,慶騰,16,0,16,陽信-石牌,2024-08-06,8711
2834,臺企銀,15,2,13,陽信-石牌,2024-08-06,8711
4906,正文,13,0,13,陽信-石牌,2024-08-06,8711
5534,長虹,62,49,13,陽信-石牌,2024-08-06,8711
0056,元大高股息,22,10,12,陽信-石牌,2024-08-06,8711
1718,中纖,12,0,12,陽信-石牌,2024-08-06,8711
2705,六福,12,0,12,陽信-石牌,2024-08-06,8711
2603,長榮,16,5,11,陽信-石牌,2024-08-06,8711
00679B,元大美債20年,11,0,11,陽信-石牌,2024-08-06,8711
00946,群益科技高息成長,11,0,11,陽信-石牌,2024-08-06,8711
2327,國巨,10,0,10,陽信-石牌,2024-08-06,8711
1537,廣隆,10,0,10,陽信-石牌,2024-08-06,8711
1617,榮星,10,0,10,陽信-石牌,2024-08-06,8711
2511,太子,10,0,10,陽信-石牌,2024-08-06,8711
2615,萬海,71,61,10,陽信-石牌,2024-08-06,8711
3605,宏致,10,0,10,陽信-石牌,2024-08-06,8711
6226,光鼎,10,0,10,陽信-石牌,2024-08-06,8711
8039,台虹,10,0,10,陽信-石牌,2024-08-06,8711
8176,智捷,10,0,10,陽信-石牌,2024-08-06,8711
00706L,期元大S＆P日圓正2,140,0,140,陽信-石牌,2024-08-07,8711
2883,凱基金,103,0,103,陽信-石牌,2024-08-07,8711
2845,遠東銀,100,0,100,陽信-石牌,2024-08-07,8711
00857B,永豐20年美公債,95,0,95,陽信-石牌,2024-08-07,8711
2886,兆豐金,126,34,92,陽信-石牌,2024-08-07,8711
2317,鴻海,133,47,86,陽信-石牌,2024-08-07,8711
2409,友達,126,40,86,陽信-石牌,2024-08-07,8711
00715L,期街口布蘭特正2,74,0,74,陽信-石牌,2024-08-07,8711
00680L,元大美債20正2,62,0,62,陽信-石牌,2024-08-07,8711
2892,第一金,60,0,60,陽信-石牌,2024-08-07,8711
2498,宏達電,60,1,59,陽信-石牌,2024-08-07,8711
2530,華建,79,28,51,陽信-石牌,2024-08-07,8711
2359,所羅門,71,22,49,陽信-石牌,2024-08-07,8711
1536,和大,102,56,46,陽信-石牌,2024-08-07,8711
3047,訊舟,46,4,42,陽信-石牌,2024-08-07,8711
00878,國泰永續高股息,80,39,41,陽信-石牌,2024-08-07,8711
6806,森崴能源,44,3,41,陽信-石牌,2024-08-07,8711
00632R,元大台灣50反1,55,15,40,陽信-石牌,2024-08-07,8711
4540,全球傳動,41,2,39,陽信-石牌,2024-08-07,8711
0050,元大台灣50,36,1,35,陽信-石牌,2024-08-07,8711
2880,華南金,25,0,25,陽信-石牌,2024-08-07,8711
00900,富邦特選高股息30,20,0,20,陽信-石牌,2024-08-07,8711
2408,南亞科,38,18,20,陽信-石牌,2024-08-07,8711
6492,生華科,20,0,20,陽信-石牌,2024-08-07,8711
2308,台達電,41,23,18,陽信-石牌,2024-08-07,8711
6274,台燿,30,12,18,陽信-石牌,2024-08-07,8711
3037,欣興,47,29,18,陽信-石牌,2024-08-07,8711
00919,群益台灣精選高息,22,6,16,陽信-石牌,2024-08-07,8711
00902,中信電池及儲能,15,0,15,陽信-石牌,2024-08-07,8711
6213,聯茂,27,12,15,陽信-石牌,2024-08-07,8711
00929,復華台灣科技優息,31,17,14,陽信-石牌,2024-08-07,8711
2324,仁寶,17,3,14,陽信-石牌,2024-08-07,8711
2615,萬海,99,86,13,陽信-石牌,2024-08-07,8711
00637L,元大滬深300正2,18,6,12,陽信-石牌,2024-08-07,8711
00927,群益半導體收益,11,0,11,陽信-石牌,2024-08-07,8711
00738U,期元大道瓊白銀,10,0,10,陽信-石牌,2024-08-07,8711
00664R,國泰臺灣加權反1,10,0,10,陽信-石牌,2024-08-07,8711
1314,中石化,20,10,10,陽信-石牌,2024-08-07,8711
3013,晟銘電,20,10,10,陽信-石牌,2024-08-07,8711
5009,榮剛,10,0,10,陽信-石牌,2024-08-07,8711
2641,正德,16,7,9,陽信-石牌,2024-08-07,8711
5388,中磊,9,0,9,陽信-石牌,2024-08-07,8711
00940,元大台灣價值高息,41,33,8,陽信-石牌,2024-08-07,8711
2548,華固,7,0,7,陽信-石牌,2024-08-07,8711
2887,台新金,7,0,7,陽信-石牌,2024-08-07,8711
3374,精材,29,22,7,陽信-石牌,2024-08-07,8711
8086,宏捷科,7,0,7,陽信-石牌,2024-08-07,8711
00931B,統一美債20年,9,3,6,陽信-石牌,2024-08-07,8711
00642U,期元大S＆P石油,6,0,6,陽信-石牌,2024-08-07,8711
00933B,國泰10Y+金融債,10,4,6,陽信-石牌,2024-08-07,8711
00948B,中信優息投資級債,300,0,300,陽信-石牌,2024-08-08,8711
00937B,群益ESG投等債20,105,19,86,陽信-石牌,2024-08-08,8711
00857B,永豐20年美公債,72,0,72,陽信-石牌,2024-08-08,8711
2834,臺企銀,68,1,67,陽信-石牌,2024-08-08,8711
2892,第一金,55,0,55,陽信-石牌,2024-08-08,8711
2881,富邦金,60,8,52,陽信-石牌,2024-08-08,8711
2317,鴻海,86,40,46,陽信-石牌,2024-08-08,8711
00878,國泰永續高股息,78,35,43,陽信-石牌,2024-08-08,8711
2886,兆豐金,41,0,41,陽信-石牌,2024-08-08,8711
2464,盟立,45,9,36,陽信-石牌,2024-08-08,8711
2609,陽明,40,7,33,陽信-石牌,2024-08-08,8711
2380,虹光,30,0,30,陽信-石牌,2024-08-08,8711
00894,中信小資高價30,30,0,30,陽信-石牌,2024-08-08,8711
5531,鄉林,30,0,30,陽信-石牌,2024-08-08,8711
00900,富邦特選高股息30,47,20,27,陽信-石牌,2024-08-08,8711
2365,昆盈,74,47,27,陽信-石牌,2024-08-08,8711
2330,台積電,31,5,26,陽信-石牌,2024-08-08,8711
2606,裕民,25,0,25,陽信-石牌,2024-08-08,8711
2367,燿華,31,6,25,陽信-石牌,2024-08-08,8711
2845,遠東銀,25,0,25,陽信-石牌,2024-08-08,8711
2382,廣達,32,9,23,陽信-石牌,2024-08-08,8711
00936,台新永續高息中小,23,0,23,陽信-石牌,2024-08-08,8711
2356,英業達,34,13,21,陽信-石牌,2024-08-08,8711
00751B,元大AAA至A公司債,20,0,20,陽信-石牌,2024-08-08,8711
2363,矽統,19,0,19,陽信-石牌,2024-08-08,8711
2349,錸德,68,51,17,陽信-石牌,2024-08-08,8711
2376,技嘉,33,17,16,陽信-石牌,2024-08-08,8711
1301,台塑,17,1,16,陽信-石牌,2024-08-08,8711
00881,國泰台灣5G+,15,0,15,陽信-石牌,2024-08-08,8711
00919,群益台灣精選高息,24,9,15,陽信-石牌,2024-08-08,8711
2538,基泰,33,18,15,陽信-石牌,2024-08-08,8711
5309,系統電,15,0,15,陽信-石牌,2024-08-08,8711
2308,台達電,14,0,14,陽信-石牌,2024-08-08,8711
2615,萬海,44,30,14,陽信-石牌,2024-08-08,8711
4958,臻鼎-KY,13,0,13,陽信-石牌,2024-08-08,8711
1785,光洋科,13,2,11,陽信-石牌,2024-08-08,8711
2486,一詮,13,2,11,陽信-石牌,2024-08-08,8711
4564,元翎,43,32,11,陽信-石牌,2024-08-08,8711
6806,森崴能源,13,2,11,陽信-石牌,2024-08-08,8711
8028,昇陽半導體,17,6,11,陽信-石牌,2024-08-08,8711
00905,FT臺灣Smart,10,0,10,陽信-石牌,2024-08-08,8711
1540,喬福,24,14,10,陽信-石牌,2024-08-08,8711
1560,中砂,10,0,10,陽信-石牌,2024-08-08,8711
1608,華榮,11,1,10,陽信-石牌,2024-08-08,8711
2736,富野,10,0,10,陽信-石牌,2024-08-08,8711
4114,健喬,10,0,10,陽信-石牌,2024-08-08,8711
6155,鈞寶,10,0,10,陽信-石牌,2024-08-08,8711
8112,至上,10,0,10,陽信-石牌,2024-08-08,8711
2618,長榮航,10,1,9,陽信-石牌,2024-08-08,8711
3060,銘異,17,8,9,陽信-石牌,2024-08-08,8711
00937B,群益ESG投等債20,652,0,652,陽信-石牌,2024-08-09,8711
00931B,統一美債20年,124,0,124,陽信-石牌,2024-08-09,8711
00933B,國泰10Y+金融債,82,0,82,陽信-石牌,2024-08-09,8711
2374,佳能,56,0,56,陽信-石牌,2024-08-09,8711
00673R,期元大S＆P原油反1,53,0,53,陽信-石牌,2024-08-09,8711
00795B,中信美國公債20年,153,100,53,陽信-石牌,2024-08-09,8711
00720B,元大投資級公司債,50,0,50,陽信-石牌,2024-08-09,8711
00857B,永豐20年美公債,46,0,46,陽信-石牌,2024-08-09,8711
00687B,國泰20年美債,41,0,41,陽信-石牌,2024-08-09,8711
00679B,元大美債20年,37,0,37,陽信-石牌,2024-08-09,8711
2882,國泰金,40,6,34,陽信-石牌,2024-08-09,8711
2603,長榮,36,5,31,陽信-石牌,2024-08-09,8711
2401,凌陽,32,2,30,陽信-石牌,2024-08-09,8711
1725,元禎,20,0,20,陽信-石牌,2024-08-09,8711
2836,高雄銀,20,0,20,陽信-石牌,2024-08-09,8711
2913,農林,20,0,20,陽信-石牌,2024-08-09,8711
6449,鈺邦,21,1,20,陽信-石牌,2024-08-09,8711
9958,世紀鋼,21,1,20,陽信-石牌,2024-08-09,8711
1711,永光,29,10,19,陽信-石牌,2024-08-09,8711
6274,台燿,22,4,18,陽信-石牌,2024-08-09,8711
2301,光寶科,34,16,18,陽信-石牌,2024-08-09,8711
6691,洋基工程,18,0,18,陽信-石牌,2024-08-09,8711
2615,萬海,67,50,17,陽信-石牌,2024-08-09,8711
3051,力特,16,0,16,陽信-石牌,2024-08-09,8711
2349,錸德,80,65,15,陽信-石牌,2024-08-09,8711
3230,錦明,15,0,15,陽信-石牌,2024-08-09,8711
00650L,復華香港正2,23,9,14,陽信-石牌,2024-08-09,8711
3044,健鼎,16,2,14,陽信-石牌,2024-08-09,8711
4979,華星光,25,11,14,陽信-石牌,2024-08-09,8711
2609,陽明,49,36,13,陽信-石牌,2024-08-09,8711
2881,富邦金,22,9,13,陽信-石牌,2024-08-09,8711
3450,聯鈞,67,54,13,陽信-石牌,2024-08-09,8711
4533,協易機,45,32,13,陽信-石牌,2024-08-09,8711
4564,元翎,21,8,13,陽信-石牌,2024-08-09,8711
00751B,元大AAA至A公司債,12,0,12,陽信-石牌,2024-08-09,8711
2369,菱生,12,0,12,陽信-石牌,2024-08-09,8711
3105,穩懋,12,0,12,陽信-石牌,2024-08-09,8711
4561,健椿,12,0,12,陽信-石牌,2024-08-09,8711
3231,緯創,44,32,12,陽信-石牌,2024-08-09,8711
2406,國碩,11,0,11,陽信-石牌,2024-08-09,8711
2481,強茂,13,2,11,陽信-石牌,2024-08-09,8711
2382,廣達,24,14,10,陽信-石牌,2024-08-09,8711
00941,中信上游半導體,10,0,10,陽信-石牌,2024-08-09,8711
1701,中化,10,0,10,陽信-石牌,2024-08-09,8711
2344,華邦電,43,33,10,陽信-石牌,2024-08-09,8711
3041,揚智,10,0,10,陽信-石牌,2024-08-09,8711
6207,雷科,10,0,10,陽信-石牌,2024-08-09,8711
6213,聯茂,21,11,10,陽信-石牌,2024-08-09,8711
6278,台表科,12,2,10,陽信-石牌,2024-08-09,8711
6603,富強鑫,10,0,10,陽信-石牌,2024-08-09,8711
5443,均豪,116,4,112,陽信-石牌,2024-08-12,8711
2312,金寶,104,38,66,陽信-石牌,2024-08-12,8711
2891,中信金,59,4,55,陽信-石牌,2024-08-12,8711
00923,群益台ESG低碳50,52,0,52,陽信-石牌,2024-08-12,8711
00687B,國泰20年美債,54,2,52,陽信-石牌,2024-08-12,8711
9105,泰金寶-DR,52,1,51,陽信-石牌,2024-08-12,8711
00632R,元大台灣50反1,60,10,50,陽信-石牌,2024-08-12,8711
00688L,國泰20年美債正2,50,0,50,陽信-石牌,2024-08-12,8711
2501,國建,133,100,33,陽信-石牌,2024-08-12,8711
00929,復華台灣科技優息,36,6,30,陽信-石牌,2024-08-12,8711
2352,佳世達,30,0,30,陽信-石牌,2024-08-12,8711
2883,凱基金,30,6,24,陽信-石牌,2024-08-12,8711
4562,穎漢,29,7,22,陽信-石牌,2024-08-12,8711
00900,富邦特選高股息30,22,0,22,陽信-石牌,2024-08-12,8711
2881,富邦金,25,3,22,陽信-石牌,2024-08-12,8711
00724B,群益投資級金融債,20,0,20,陽信-石牌,2024-08-12,8711
4903,聯光通,20,0,20,陽信-石牌,2024-08-12,8711
5876,上海商銀,20,0,20,陽信-石牌,2024-08-12,8711
6215,和椿,25,5,20,陽信-石牌,2024-08-12,8711
4927,泰鼎-KY,15,0,15,陽信-石牌,2024-08-12,8711
6603,富強鑫,15,0,15,陽信-石牌,2024-08-12,8711
00679B,元大美債20年,18,5,13,陽信-石牌,2024-08-12,8711
2101,南港,14,1,13,陽信-石牌,2024-08-12,8711
2610,華航,13,0,13,陽信-石牌,2024-08-12,8711
2359,所羅門,22,10,12,陽信-石牌,2024-08-12,8711
1455,集盛,12,0,12,陽信-石牌,2024-08-12,8711
2453,凌群,12,0,12,陽信-石牌,2024-08-12,8711
5202,力新,13,1,12,陽信-石牌,2024-08-12,8711
00673R,期元大S＆P原油反1,11,0,11,陽信-石牌,2024-08-12,8711
2887,台新金,11,0,11,陽信-石牌,2024-08-12,8711
3017,奇鋐,15,4,11,陽信-石牌,2024-08-12,8711
1515,力山,10,0,10,陽信-石牌,2024-08-12,8711
1711,永光,11,1,10,陽信-石牌,2024-08-12,8711
2495,普安,10,0,10,陽信-石牌,2024-08-12,8711
3535,晶彩科,12,3,9,陽信-石牌,2024-08-12,8711
3663,鑫科,31,22,9,陽信-石牌,2024-08-12,8711
3032,偉訓,9,0,9,陽信-石牌,2024-08-12,8711
5309,系統電,11,3,8,陽信-石牌,2024-08-12,8711
6691,洋基工程,8,0,8,陽信-石牌,2024-08-12,8711
8064,東捷,12,4,8,陽信-石牌,2024-08-12,8711
3374,精材,9,2,7,陽信-石牌,2024-08-12,8711
3522,御嵿,7,0,7,陽信-石牌,2024-08-12,8711
3715,定穎投控,9,2,7,陽信-石牌,2024-08-12,8711
2243,宏旭-KY,6,0,6,陽信-石牌,2024-08-12,8711
2406,國碩,6,0,6,陽信-石牌,2024-08-12,8711
4960,誠美材,6,0,6,陽信-石牌,2024-08-12,8711
6706,惠特,6,0,6,陽信-石牌,2024-08-12,8711
1597,直得,16,11,5,陽信-石牌,2024-08-12,8711
00881,國泰台灣5G+,10,5,5,陽信-石牌,2024-08-12,8711
1314,中石化,5,0,5,陽信-石牌,2024-08-12,8711
2880,華南金,298,0,298,陽信-石牌,2024-08-13,8711
1536,和大,159,59,100,陽信-石牌,2024-08-13,8711
00632R,元大台灣50反1,90,0,90,陽信-石牌,2024-08-13,8711
1314,中石化,80,0,80,陽信-石牌,2024-08-13,8711
9105,泰金寶-DR,91,12,79,陽信-石牌,2024-08-13,8711
2615,萬海,132,59,73,陽信-石牌,2024-08-13,8711
6207,雷科,72,10,62,陽信-石牌,2024-08-13,8711
2498,宏達電,50,0,50,陽信-石牌,2024-08-13,8711
1597,直得,56,21,35,陽信-石牌,2024-08-13,8711
3231,緯創,50,17,33,陽信-石牌,2024-08-13,8711
1718,中纖,30,0,30,陽信-石牌,2024-08-13,8711
4157,太景*-KY,30,0,30,陽信-石牌,2024-08-13,8711
8358,金居,30,0,30,陽信-石牌,2024-08-13,8711
2449,京元電子,26,0,26,陽信-石牌,2024-08-13,8711
1513,中興電,42,17,25,陽信-石牌,2024-08-13,8711
00679B,元大美債20年,21,0,21,陽信-石牌,2024-08-13,8711
2538,基泰,20,0,20,陽信-石牌,2024-08-13,8711
2834,臺企銀,19,0,19,陽信-石牌,2024-08-13,8711
00881,國泰台灣5G+,18,0,18,陽信-石牌,2024-08-13,8711
6127,九豪,25,8,17,陽信-石牌,2024-08-13,8711
00923,群益台ESG低碳50,16,0,16,陽信-石牌,2024-08-13,8711
00687B,國泰20年美債,20,4,16,陽信-石牌,2024-08-13,8711
2444,兆勁,15,0,15,陽信-石牌,2024-08-13,8711
3715,定穎投控,15,0,15,陽信-石牌,2024-08-13,8711
3033,威健,13,0,13,陽信-石牌,2024-08-13,8711
1540,喬福,13,1,12,陽信-石牌,2024-08-13,8711
2374,佳能,12,0,12,陽信-石牌,2024-08-13,8711
2886,兆豐金,13,1,12,陽信-石牌,2024-08-13,8711
3362,先進光,11,0,11,陽信-石牌,2024-08-13,8711
6770,力積電,12,1,11,陽信-石牌,2024-08-13,8711
2069,運錩,10,0,10,陽信-石牌,2024-08-13,8711
2610,華航,18,8,10,陽信-石牌,2024-08-13,8711
3060,銘異,24,14,10,陽信-石牌,2024-08-13,8711
3338,泰碩,10,0,10,陽信-石牌,2024-08-13,8711
6155,鈞寶,10,0,10,陽信-石牌,2024-08-13,8711
6215,和椿,14,4,10,陽信-石牌,2024-08-13,8711
2359,所羅門,16,6,10,陽信-石牌,2024-08-13,8711
2104,國際中橡,9,0,9,陽信-石牌,2024-08-13,8711
2324,仁寶,22,13,9,陽信-石牌,2024-08-13,8711
2486,一詮,14,5,9,陽信-石牌,2024-08-13,8711
3013,晟銘電,24,15,9,陽信-石牌,2024-08-13,8711
3706,神達,11,2,9,陽信-石牌,2024-08-13,8711
3711,日月光投控,12,3,9,陽信-石牌,2024-08-13,8711
2603,長榮,20,11,9,陽信-石牌,2024-08-13,8711
3037,欣興,20,12,8,陽信-石牌,2024-08-13,8711
6603,富強鑫,8,0,8,陽信-石牌,2024-08-13,8711
00665L,富邦�琤肭磪囓�2,22,15,7,陽信-石牌,2024-08-13,8711
00919,群益台灣精選高息,14,7,7,陽信-石牌,2024-08-13,8711
2103,台橡,7,0,7,陽信-石牌,2024-08-13,8711
2704,國賓,7,0,7,陽信-石牌,2024-08-13,8711
00929,復華台灣科技優息,110,8,102,陽信-石牌,2024-08-14,8711
00687B,國泰20年美債,130,35,95,陽信-石牌,2024-08-14,8711
00632R,元大台灣50反1,80,0,80,陽信-石牌,2024-08-14,8711
1563,巧新,80,0,80,陽信-石牌,2024-08-14,8711
2489,瑞軒,62,3,59,陽信-石牌,2024-08-14,8711
2356,英業達,104,52,52,陽信-石牌,2024-08-14,8711
00936,台新永續高息中小,48,2,46,陽信-石牌,2024-08-14,8711
2349,錸德,56,11,45,陽信-石牌,2024-08-14,8711
8011,台通,49,4,45,陽信-石牌,2024-08-14,8711
00881,國泰台灣5G+,61,17,44,陽信-石牌,2024-08-14,8711
2609,陽明,40,4,36,陽信-石牌,2024-08-14,8711
00934,中信成長高股息,39,4,35,陽信-石牌,2024-08-14,8711
00900,富邦特選高股息30,30,0,30,陽信-石牌,2024-08-14,8711
2495,普安,30,0,30,陽信-石牌,2024-08-14,8711
3060,銘異,27,0,27,陽信-石牌,2024-08-14,8711
8043,蜜望實,29,5,24,陽信-石牌,2024-08-14,8711
2851,中再保,22,0,22,陽信-石牌,2024-08-14,8711
8096,擎亞,25,3,22,陽信-石牌,2024-08-14,8711
2401,凌陽,25,4,21,陽信-石牌,2024-08-14,8711
4123,晟德,20,0,20,陽信-石牌,2024-08-14,8711
2308,台達電,23,3,20,陽信-石牌,2024-08-14,8711
2355,敬鵬,21,2,19,陽信-石牌,2024-08-14,8711
3374,精材,37,18,19,陽信-石牌,2024-08-14,8711
6472,保瑞,21,4,17,陽信-石牌,2024-08-14,8711
00641R,富邦日本反1,25,10,15,陽信-石牌,2024-08-14,8711
1101,台泥,16,1,15,陽信-石牌,2024-08-14,8711
1608,華榮,23,10,13,陽信-石牌,2024-08-14,8711
1609,大亞,21,9,12,陽信-石牌,2024-08-14,8711
2444,兆勁,12,0,12,陽信-石牌,2024-08-14,8711
6269,台郡,12,0,12,陽信-石牌,2024-08-14,8711
8028,昇陽半導體,17,5,12,陽信-石牌,2024-08-14,8711
00931B,統一美債20年,11,0,11,陽信-石牌,2024-08-14,8711
2615,萬海,82,72,10,陽信-石牌,2024-08-14,8711
00720B,元大投資級公司債,10,0,10,陽信-石牌,2024-08-14,8711
00772B,中信高評級公司債,10,0,10,陽信-石牌,2024-08-14,8711
00907,永豐優息存股,10,0,10,陽信-石牌,2024-08-14,8711
1109,信大,10,0,10,陽信-石牌,2024-08-14,8711
1474,弘裕,10,0,10,陽信-石牌,2024-08-14,8711
2331,精英,10,0,10,陽信-石牌,2024-08-14,8711
3413,京鼎,10,0,10,陽信-石牌,2024-08-14,8711
5309,系統電,10,0,10,陽信-石牌,2024-08-14,8711
6443,元晶,12,2,10,陽信-石牌,2024-08-14,8711
2402,毅嘉,10,1,9,陽信-石牌,2024-08-14,8711
2515,中工,9,0,9,陽信-石牌,2024-08-14,8711
3019,亞光,45,36,9,陽信-石牌,2024-08-14,8711
5905,南仁湖,19,10,9,陽信-石牌,2024-08-14,8711
2332,友訊,8,0,8,陽信-石牌,2024-08-14,8711
2834,臺企銀,8,0,8,陽信-石牌,2024-08-14,8711
00932,兆豐永續高息等權,7,0,7,陽信-石牌,2024-08-14,8711
00679B,元大美債20年,11,4,7,陽信-石牌,2024-08-14,8711
00878,國泰永續高股息,176,2,174,陽信-石牌,2024-08-15,8711
00687B,國泰20年美債,123,0,123,陽信-石牌,2024-08-15,8711
00900,富邦特選高股息30,113,6,107,陽信-石牌,2024-08-15,8711
5905,南仁湖,85,1,84,陽信-石牌,2024-08-15,8711
00680L,元大美債20正2,81,1,80,陽信-石牌,2024-08-15,8711
00929,復華台灣科技優息,69,4,65,陽信-石牌,2024-08-15,8711
3663,鑫科,70,7,63,陽信-石牌,2024-08-15,8711
00673R,期元大S＆P原油反1,62,0,62,陽信-石牌,2024-08-15,8711
4555,氣立,60,1,59,陽信-石牌,2024-08-15,8711
2801,彰銀,56,0,56,陽信-石牌,2024-08-15,8711
2605,新興,50,4,46,陽信-石牌,2024-08-15,8711
00679B,元大美債20年,48,5,43,陽信-石牌,2024-08-15,8711
2303,聯電,38,3,35,陽信-石牌,2024-08-15,8711
4561,健椿,53,18,35,陽信-石牌,2024-08-15,8711
1718,中纖,30,0,30,陽信-石牌,2024-08-15,8711
2317,鴻海,45,15,30,陽信-石牌,2024-08-15,8711
2344,華邦電,42,12,30,陽信-石牌,2024-08-15,8711
2610,華航,39,12,27,陽信-石牌,2024-08-15,8711
3711,日月光投控,22,0,22,陽信-石牌,2024-08-15,8711
00641R,富邦日本反1,21,0,21,陽信-石牌,2024-08-15,8711
9904,寶成,20,0,20,陽信-石牌,2024-08-15,8711
3202,樺晟,17,0,17,陽信-石牌,2024-08-15,8711
2637,慧洋-KY,16,0,16,陽信-石牌,2024-08-15,8711
2834,臺企銀,15,0,15,陽信-石牌,2024-08-15,8711
5443,均豪,36,21,15,陽信-石牌,2024-08-15,8711
9105,泰金寶-DR,62,48,14,陽信-石牌,2024-08-15,8711
4562,穎漢,25,11,14,陽信-石牌,2024-08-15,8711
00715L,期街口布蘭特正2,14,1,13,陽信-石牌,2024-08-15,8711
2352,佳世達,18,5,13,陽信-石牌,2024-08-15,8711
2329,華泰,12,0,12,陽信-石牌,2024-08-15,8711
3376,新日興,20,8,12,陽信-石牌,2024-08-15,8711
4566,時碩工業,25,13,12,陽信-石牌,2024-08-15,8711
00881,國泰台灣5G+,14,2,12,陽信-石牌,2024-08-15,8711
2408,南亞科,11,0,11,陽信-石牌,2024-08-15,8711
5484,慧友,15,4,11,陽信-石牌,2024-08-15,8711
5519,隆大,13,2,11,陽信-石牌,2024-08-15,8711
00932,兆豐永續高息等權,10,0,10,陽信-石牌,2024-08-15,8711
00720B,元大投資級公司債,10,0,10,陽信-石牌,2024-08-15,8711
1608,華榮,10,0,10,陽信-石牌,2024-08-15,8711
2101,南港,14,4,10,陽信-石牌,2024-08-15,8711
2323,中環,26,16,10,陽信-石牌,2024-08-15,8711
2340,台亞,10,0,10,陽信-石牌,2024-08-15,8711
2362,藍天,10,0,10,陽信-石牌,2024-08-15,8711
2520,冠德,70,60,10,陽信-石牌,2024-08-15,8711
2880,華南金,10,0,10,陽信-石牌,2024-08-15,8711
6224,聚鼎,10,0,10,陽信-石牌,2024-08-15,8711
9103,美德醫療-DR,10,0,10,陽信-石牌,2024-08-15,8711
3013,晟銘電,21,12,9,陽信-石牌,2024-08-15,8711
2365,昆盈,48,40,8,陽信-石牌,2024-08-15,8711
2442,新美齊,8,0,8,陽信-石牌,2024-08-15,8711
00687B,國泰20年美債,96,10,86,陽信-石牌,2024-08-16,8711
00679B,元大美債20年,77,0,77,陽信-石牌,2024-08-16,8711
1101,台泥,73,3,70,陽信-石牌,2024-08-16,8711
5443,均豪,173,120,53,陽信-石牌,2024-08-16,8711
00713,元大台灣高息低波,49,0,49,陽信-石牌,2024-08-16,8711
5309,系統電,58,27,31,陽信-石牌,2024-08-16,8711
5512,力麒,31,0,31,陽信-石牌,2024-08-16,8711
5905,南仁湖,31,0,31,陽信-石牌,2024-08-16,8711
00772B,中信高評級公司債,30,0,30,陽信-石牌,2024-08-16,8711
00931B,統一美債20年,29,0,29,陽信-石牌,2024-08-16,8711
00680L,元大美債20正2,21,0,21,陽信-石牌,2024-08-16,8711
00632R,元大台灣50反1,45,25,20,陽信-石牌,2024-08-16,8711
8927,北基,20,0,20,陽信-石牌,2024-08-16,8711
1785,光洋科,20,3,17,陽信-石牌,2024-08-16,8711
8096,擎亞,51,34,17,陽信-石牌,2024-08-16,8711
00795B,中信美國公債20年,14,0,14,陽信-石牌,2024-08-16,8711
00937B,群益ESG投等債20,14,0,14,陽信-石牌,2024-08-16,8711
5328,華容,20,6,14,陽信-石牌,2024-08-16,8711
00919,群益台灣精選高息,23,10,13,陽信-石牌,2024-08-16,8711
00725B,國泰投資級公司債,13,0,13,陽信-石牌,2024-08-16,8711
3048,益登,22,9,13,陽信-石牌,2024-08-16,8711
9958,世紀鋼,14,1,13,陽信-石牌,2024-08-16,8711
2867,三商壽,16,4,12,陽信-石牌,2024-08-16,8711
3019,亞光,35,23,12,陽信-石牌,2024-08-16,8711
3339,泰谷,12,0,12,陽信-石牌,2024-08-16,8711
00720B,元大投資級公司債,10,0,10,陽信-石牌,2024-08-16,8711
00651R,復華香港反1,10,0,10,陽信-石牌,2024-08-16,8711
2002,中鋼,12,2,10,陽信-石牌,2024-08-16,8711
2401,凌陽,10,0,10,陽信-石牌,2024-08-16,8711
2641,正德,10,0,10,陽信-石牌,2024-08-16,8711
4532,瑞智,10,0,10,陽信-石牌,2024-08-16,8711
6120,達運,10,0,10,陽信-石牌,2024-08-16,8711
8473,山林水,15,5,10,陽信-石牌,2024-08-16,8711
2736,富野,10,0,10,陽信-石牌,2024-08-16,8711
00641R,富邦日本反1,10,1,9,陽信-石牌,2024-08-16,8711
00933B,國泰10Y+金融債,10,1,9,陽信-石牌,2024-08-16,8711
1560,中砂,10,1,9,陽信-石牌,2024-08-16,8711
2397,友通,9,0,9,陽信-石牌,2024-08-16,8711
6108,競國,9,0,9,陽信-石牌,2024-08-16,8711
6462,神盾,22,13,9,陽信-石牌,2024-08-16,8711
6550,北極星藥業-KY,10,1,9,陽信-石牌,2024-08-16,8711
00939,統一台灣高息動能,10,2,8,陽信-石牌,2024-08-16,8711
1416,廣豐,8,0,8,陽信-石牌,2024-08-16,8711
6472,保瑞,13,5,8,陽信-石牌,2024-08-16,8711
6505,台塑化,8,0,8,陽信-石牌,2024-08-16,8711
2467,志聖,36,29,7,陽信-石牌,2024-08-16,8711
3051,力特,7,0,7,陽信-石牌,2024-08-16,8711
6117,迎廣,12,5,7,陽信-石牌,2024-08-16,8711
6188,廣明,7,0,7,陽信-石牌,2024-08-16,8711
2323,中環,45,39,6,陽信-石牌,2024-08-16,8711
00931B,統一美債20年,175,0,175,陽信-石牌,2024-08-19,8711
00937B,群益ESG投等債20,96,2,94,陽信-石牌,2024-08-19,8711
00632R,元大台灣50反1,72,0,72,陽信-石牌,2024-08-19,8711
2888,新光金,87,30,57,陽信-石牌,2024-08-19,8711
2359,所羅門,59,8,51,陽信-石牌,2024-08-19,8711
8234,新漢,53,7,46,陽信-石牌,2024-08-19,8711
3062,建漢,66,22,44,陽信-石牌,2024-08-19,8711
00679B,元大美債20年,40,0,40,陽信-石牌,2024-08-19,8711
2881,富邦金,38,0,38,陽信-石牌,2024-08-19,8711
00687B,國泰20年美債,38,0,38,陽信-石牌,2024-08-19,8711
00878,國泰永續高股息,36,3,33,陽信-石牌,2024-08-19,8711
2365,昆盈,134,101,33,陽信-石牌,2024-08-19,8711
00731,復華富時高息低波,30,0,30,陽信-石牌,2024-08-19,8711
00725B,國泰投資級公司債,30,0,30,陽信-石牌,2024-08-19,8711
2344,華邦電,42,12,30,陽信-石牌,2024-08-19,8711
3374,精材,33,6,27,陽信-石牌,2024-08-19,8711
2542,興富發,56,30,26,陽信-石牌,2024-08-19,8711
00929,復華台灣科技優息,28,6,22,陽信-石牌,2024-08-19,8711
00907,永豐優息存股,21,0,21,陽信-石牌,2024-08-19,8711
00857B,永豐20年美公債,20,0,20,陽信-石牌,2024-08-19,8711
1447,力鵬,20,0,20,陽信-石牌,2024-08-19,8711
3163,波若威,23,3,20,陽信-石牌,2024-08-19,8711
3231,緯創,30,11,19,陽信-石牌,2024-08-19,8711
8028,昇陽半導體,35,17,18,陽信-石牌,2024-08-19,8711
4927,泰鼎-KY,18,0,18,陽信-石牌,2024-08-19,8711
2489,瑞軒,23,6,17,陽信-石牌,2024-08-19,8711
3645,達邁,23,8,15,陽信-石牌,2024-08-19,8711
3037,欣興,15,1,14,陽信-石牌,2024-08-19,8711
00923,群益台ESG低碳50,13,0,13,陽信-石牌,2024-08-19,8711
2371,大同,14,1,13,陽信-石牌,2024-08-19,8711
6207,雷科,22,9,13,陽信-石牌,2024-08-19,8711
2062,橋椿,18,6,12,陽信-石牌,2024-08-19,8711
2704,國賓,12,0,12,陽信-石牌,2024-08-19,8711
3048,益登,16,4,12,陽信-石牌,2024-08-19,8711
8099,大世科,12,0,12,陽信-石牌,2024-08-19,8711
8374,羅昇,25,13,12,陽信-石牌,2024-08-19,8711
3339,泰谷,13,2,11,陽信-石牌,2024-08-19,8711
6492,生華科,11,0,11,陽信-石牌,2024-08-19,8711
00720B,元大投資級公司債,10,0,10,陽信-石牌,2024-08-19,8711
1444,力麗,10,0,10,陽信-石牌,2024-08-19,8711
1617,榮星,10,0,10,陽信-石牌,2024-08-19,8711
2506,太設,15,5,10,陽信-石牌,2024-08-19,8711
2610,華航,10,0,10,陽信-石牌,2024-08-19,8711
2887,台新金,10,0,10,陽信-石牌,2024-08-19,8711
3059,華晶科,22,12,10,陽信-石牌,2024-08-19,8711
3211,順達,10,0,10,陽信-石牌,2024-08-19,8711
3483,力致,10,0,10,陽信-石牌,2024-08-19,8711
6133,金橋,10,0,10,陽信-石牌,2024-08-19,8711
8049,晶采,10,0,10,陽信-石牌,2024-08-19,8711
0050,元大台灣50,10,1,9,陽信-石牌,2024-08-19,8711
1785,光洋科,171,11,160,陽信-石牌,2024-08-20,8711
00632R,元大台灣50反1,110,0,110,陽信-石牌,2024-08-20,8711
2017,官田鋼,100,0,100,陽信-石牌,2024-08-20,8711
00937B,群益ESG投等債20,77,0,77,陽信-石牌,2024-08-20,8711
00688L,國泰20年美債正2,100,25,75,陽信-石牌,2024-08-20,8711
00923,群益台ESG低碳50,71,0,71,陽信-石牌,2024-08-20,8711
00715L,期街口布蘭特正2,64,0,64,陽信-石牌,2024-08-20,8711
00713,元大台灣高息低波,50,0,50,陽信-石牌,2024-08-20,8711
5608,四維航,50,0,50,陽信-石牌,2024-08-20,8711
2356,英業達,56,11,45,陽信-石牌,2024-08-20,8711
00931B,統一美債20年,43,0,43,陽信-石牌,2024-08-20,8711
00936,台新永續高息中小,37,0,37,陽信-石牌,2024-08-20,8711
00687B,國泰20年美債,67,30,37,陽信-石牌,2024-08-20,8711
00679B,元大美債20年,28,0,28,陽信-石牌,2024-08-20,8711
2312,金寶,30,8,22,陽信-石牌,2024-08-20,8711
1784,訊聯,22,1,21,陽信-石牌,2024-08-20,8711
2520,冠德,35,14,21,陽信-石牌,2024-08-20,8711
2352,佳世達,22,3,19,陽信-石牌,2024-08-20,8711
2401,凌陽,41,22,19,陽信-石牌,2024-08-20,8711
3062,建漢,22,3,19,陽信-石牌,2024-08-20,8711
00919,群益台灣精選高息,19,2,17,陽信-石牌,2024-08-20,8711
2409,友達,17,0,17,陽信-石牌,2024-08-20,8711
2301,光寶科,21,5,16,陽信-石牌,2024-08-20,8711
3339,泰谷,33,17,16,陽信-石牌,2024-08-20,8711
2405,輔信,15,0,15,陽信-石牌,2024-08-20,8711
2444,兆勁,15,0,15,陽信-石牌,2024-08-20,8711
8107,大億金茂,49,35,14,陽信-石牌,2024-08-20,8711
2317,鴻海,34,20,14,陽信-石牌,2024-08-20,8711
2349,錸德,20,7,13,陽信-石牌,2024-08-20,8711
5484,慧友,17,4,13,陽信-石牌,2024-08-20,8711
6770,力積電,15,2,13,陽信-石牌,2024-08-20,8711
2542,興富發,13,1,12,陽信-石牌,2024-08-20,8711
00933B,國泰10Y+金融債,11,0,11,陽信-石牌,2024-08-20,8711
6125,廣運,17,6,11,陽信-石牌,2024-08-20,8711
6451,訊芯-KY,13,2,11,陽信-石牌,2024-08-20,8711
00939,統一台灣高息動能,10,0,10,陽信-石牌,2024-08-20,8711
1447,力鵬,10,0,10,陽信-石牌,2024-08-20,8711
1529,樂事綠能,21,11,10,陽信-石牌,2024-08-20,8711
2314,台揚,10,0,10,陽信-石牌,2024-08-20,8711
2637,慧洋-KY,11,1,10,陽信-石牌,2024-08-20,8711
4549,桓達,10,0,10,陽信-石牌,2024-08-20,8711
1310,台苯,12,3,9,陽信-石牌,2024-08-20,8711
2417,圓剛,14,5,9,陽信-石牌,2024-08-20,8711
2467,志聖,10,1,9,陽信-石牌,2024-08-20,8711
3060,銘異,12,3,9,陽信-石牌,2024-08-20,8711
2419,仲琦,10,2,8,陽信-石牌,2024-08-20,8711
4904,遠傳,8,0,8,陽信-石牌,2024-08-20,8711
6179,亞通,8,0,8,陽信-石牌,2024-08-20,8711
8070,長華*,9,1,8,陽信-石牌,2024-08-20,8711
2368,金像電,9,2,7,陽信-石牌,2024-08-20,8711
2891,中信金,142,12,130,陽信-石牌,2024-08-21,8711
00632R,元大台灣50反1,110,1,109,陽信-石牌,2024-08-21,8711
2344,華邦電,55,1,54,陽信-石牌,2024-08-21,8711
00878,國泰永續高股息,55,2,53,陽信-石牌,2024-08-21,8711
8064,東捷,110,61,49,陽信-石牌,2024-08-21,8711
9103,美德醫療-DR,46,0,46,陽信-石牌,2024-08-21,8711
2317,鴻海,43,9,34,陽信-石牌,2024-08-21,8711
3047,訊舟,92,59,33,陽信-石牌,2024-08-21,8711
3535,晶彩科,44,13,31,陽信-石牌,2024-08-21,8711
00923,群益台ESG低碳50,30,0,30,陽信-石牌,2024-08-21,8711
4157,太景*-KY,30,0,30,陽信-石牌,2024-08-21,8711
2371,大同,31,2,29,陽信-石牌,2024-08-21,8711
2610,華航,38,12,26,陽信-石牌,2024-08-21,8711
3037,欣興,37,11,26,陽信-石牌,2024-08-21,8711
00919,群益台灣精選高息,26,2,24,陽信-石牌,2024-08-21,8711
1513,中興電,47,24,23,陽信-石牌,2024-08-21,8711
3062,建漢,83,61,22,陽信-石牌,2024-08-21,8711
6443,元晶,22,1,21,陽信-石牌,2024-08-21,8711
2340,台亞,20,0,20,陽信-石牌,2024-08-21,8711
1409,新纖,20,0,20,陽信-石牌,2024-08-21,8711
1714,和桐,20,0,20,陽信-石牌,2024-08-21,8711
1905,華紙,20,0,20,陽信-石牌,2024-08-21,8711
2330,台積電,19,0,19,陽信-石牌,2024-08-21,8711
2382,廣達,19,1,18,陽信-石牌,2024-08-21,8711
2885,元大金,21,6,15,陽信-石牌,2024-08-21,8711
00929,復華台灣科技優息,20,6,14,陽信-石牌,2024-08-21,8711
2354,鴻準,26,13,13,陽信-石牌,2024-08-21,8711
3673,TPK-KY,14,1,13,陽信-石牌,2024-08-21,8711
2323,中環,12,0,12,陽信-石牌,2024-08-21,8711
3379,彬台,12,0,12,陽信-石牌,2024-08-21,8711
5347,世界,11,0,11,陽信-石牌,2024-08-21,8711
8028,昇陽半導體,28,17,11,陽信-石牌,2024-08-21,8711
9904,寶成,11,0,11,陽信-石牌,2024-08-21,8711
00934,中信成長高股息,10,0,10,陽信-石牌,2024-08-21,8711
00671R,富邦NASDAQ反1,10,0,10,陽信-石牌,2024-08-21,8711
3484,崧騰,10,0,10,陽信-石牌,2024-08-21,8711
3508,位速,10,0,10,陽信-石牌,2024-08-21,8711
8222,寶一,10,0,10,陽信-石牌,2024-08-21,8711
8440,綠電,17,7,10,陽信-石牌,2024-08-21,8711
0056,元大高股息,12,3,9,陽信-石牌,2024-08-21,8711
1529,樂事綠能,10,1,9,陽信-石牌,2024-08-21,8711
8070,長華*,11,2,9,陽信-石牌,2024-08-21,8711
8054,安國,19,11,8,陽信-石牌,2024-08-21,8711
00715L,期街口布蘭特正2,10,2,8,陽信-石牌,2024-08-21,8711
2313,華通,12,4,8,陽信-石牌,2024-08-21,8711
2417,圓剛,8,0,8,陽信-石牌,2024-08-21,8711
2634,漢翔,8,0,8,陽信-石牌,2024-08-21,8711
2705,六福,8,0,8,陽信-石牌,2024-08-21,8711
3374,精材,10,2,8,陽信-石牌,2024-08-21,8711
6462,神盾,8,0,8,陽信-石牌,2024-08-21,8711
00632R,元大台灣50反1,625,32,593,陽信-石牌,2024-08-22,8711
2891,中信金,203,16,187,陽信-石牌,2024-08-22,8711
00673R,期元大S＆P原油反1,58,1,57,陽信-石牌,2024-08-22,8711
9105,泰金寶-DR,77,30,47,陽信-石牌,2024-08-22,8711
2349,錸德,147,102,45,陽信-石牌,2024-08-22,8711
5443,均豪,74,32,42,陽信-石牌,2024-08-22,8711
2605,新興,50,8,42,陽信-石牌,2024-08-22,8711
00940,元大台灣價值高息,41,0,41,陽信-石牌,2024-08-22,8711
00878,國泰永續高股息,39,5,34,陽信-石牌,2024-08-22,8711
2317,鴻海,65,32,33,陽信-石牌,2024-08-22,8711
5371,中光電,43,15,28,陽信-石牌,2024-08-22,8711
2890,永豐金,26,0,26,陽信-石牌,2024-08-22,8711
2610,華航,24,0,24,陽信-石牌,2024-08-22,8711
3711,日月光投控,24,0,24,陽信-石牌,2024-08-22,8711
1514,亞力,37,17,20,陽信-石牌,2024-08-22,8711
1616,億泰,20,0,20,陽信-石牌,2024-08-22,8711
2464,盟立,31,11,20,陽信-石牌,2024-08-22,8711
2208,台船,30,12,18,陽信-石牌,2024-08-22,8711
2324,仁寶,22,5,17,陽信-石牌,2024-08-22,8711
3189,景碩,30,13,17,陽信-石牌,2024-08-22,8711
9921,巨大,17,0,17,陽信-石牌,2024-08-22,8711
00751B,元大AAA至A公司債,15,0,15,陽信-石牌,2024-08-22,8711
2352,佳世達,15,1,14,陽信-石牌,2024-08-22,8711
1513,中興電,19,6,13,陽信-石牌,2024-08-22,8711
2330,台積電,11,0,11,陽信-石牌,2024-08-22,8711
2497,怡利電,11,0,11,陽信-石牌,2024-08-22,8711
00680L,元大美債20正2,11,1,10,陽信-石牌,2024-08-22,8711
00934,中信成長高股息,10,0,10,陽信-石牌,2024-08-22,8711
1409,新纖,10,0,10,陽信-石牌,2024-08-22,8711
1522,堤維西,10,0,10,陽信-石牌,2024-08-22,8711
2316,楠梓電,10,0,10,陽信-石牌,2024-08-22,8711
4958,臻鼎-KY,10,0,10,陽信-石牌,2024-08-22,8711
8049,晶采,10,0,10,陽信-石牌,2024-08-22,8711
1735,日勝化,9,0,9,陽信-石牌,2024-08-22,8711
2002,中鋼,10,1,9,陽信-石牌,2024-08-22,8711
2312,金寶,11,2,9,陽信-石牌,2024-08-22,8711
1309,台達化,10,1,9,陽信-石牌,2024-08-22,8711
00919,群益台灣精選高息,15,6,9,陽信-石牌,2024-08-22,8711
00715L,期街口布蘭特正2,8,0,8,陽信-石牌,2024-08-22,8711
2062,橋椿,16,8,8,陽信-石牌,2024-08-22,8711
2444,兆勁,12,4,8,陽信-石牌,2024-08-22,8711
2867,三商壽,11,3,8,陽信-石牌,2024-08-22,8711
5328,華容,8,0,8,陽信-石牌,2024-08-22,8711
00937B,群益ESG投等債20,7,0,7,陽信-石牌,2024-08-22,8711
1101,台泥,7,0,7,陽信-石牌,2024-08-22,8711
3312,弘憶股,22,15,7,陽信-石牌,2024-08-22,8711
4566,時碩工業,7,0,7,陽信-石牌,2024-08-22,8711
6257,矽格,7,0,7,陽信-石牌,2024-08-22,8711
8043,蜜望實,18,11,7,陽信-石牌,2024-08-22,8711
2354,鴻準,16,9,7,陽信-石牌,2024-08-22,8711
00632R,元大台灣50反1,1200,0,1200,陽信-石牌,2024-08-23,8711
00931B,統一美債20年,228,0,228,陽信-石牌,2024-08-23,8711
2888,新光金,385,272,113,陽信-石牌,2024-08-23,8711
9105,泰金寶-DR,105,5,100,陽信-石牌,2024-08-23,8711
5309,系統電,102,16,86,陽信-石牌,2024-08-23,8711
1314,中石化,468,383,85,陽信-石牌,2024-08-23,8711
00715L,期街口布蘭特正2,79,0,79,陽信-石牌,2024-08-23,8711
00937B,群益ESG投等債20,78,5,73,陽信-石牌,2024-08-23,8711
00878,國泰永續高股息,70,0,70,陽信-石牌,2024-08-23,8711
00680L,元大美債20正2,66,0,66,陽信-石牌,2024-08-23,8711
2317,鴻海,68,6,62,陽信-石牌,2024-08-23,8711
2527,宏璟,60,0,60,陽信-石牌,2024-08-23,8711
00687B,國泰20年美債,58,0,58,陽信-石牌,2024-08-23,8711
00665L,富邦�琤肭磪囓�2,57,5,52,陽信-石牌,2024-08-23,8711
00929,復華台灣科技優息,48,3,45,陽信-石牌,2024-08-23,8711
3715,定穎投控,40,0,40,陽信-石牌,2024-08-23,8711
1714,和桐,37,0,37,陽信-石牌,2024-08-23,8711
4157,太景*-KY,30,0,30,陽信-石牌,2024-08-23,8711
00948B,中信優息投資級債,30,0,30,陽信-石牌,2024-08-23,8711
3019,亞光,67,41,26,陽信-石牌,2024-08-23,8711
2891,中信金,42,17,25,陽信-石牌,2024-08-23,8711
6150,撼訊,20,0,20,陽信-石牌,2024-08-23,8711
8064,東捷,98,78,20,陽信-石牌,2024-08-23,8711
2301,光寶科,21,2,19,陽信-石牌,2024-08-23,8711
2303,聯電,23,4,19,陽信-石牌,2024-08-23,8711
4729,熒茂,55,38,17,陽信-石牌,2024-08-23,8711
1447,力鵬,15,0,15,陽信-石牌,2024-08-23,8711
2845,遠東銀,15,0,15,陽信-石牌,2024-08-23,8711
8033,雷虎,15,0,15,陽信-石牌,2024-08-23,8711
5398,慕康生醫,20,6,14,陽信-石牌,2024-08-23,8711
2887,台新金,19,6,13,陽信-石牌,2024-08-23,8711
1316,上曜,13,0,13,陽信-石牌,2024-08-23,8711
1717,長興,13,0,13,陽信-石牌,2024-08-23,8711
6442,光聖,15,2,13,陽信-石牌,2024-08-23,8711
1326,台化,12,0,12,陽信-石牌,2024-08-23,8711
00934,中信成長高股息,11,0,11,陽信-石牌,2024-08-23,8711
2606,裕民,11,0,11,陽信-石牌,2024-08-23,8711
3645,達邁,19,8,11,陽信-石牌,2024-08-23,8711
4958,臻鼎-KY,11,0,11,陽信-石牌,2024-08-23,8711
5534,長虹,14,3,11,陽信-石牌,2024-08-23,8711
6179,亞通,11,0,11,陽信-石牌,2024-08-23,8711
6753,龍德造船,12,1,11,陽信-石牌,2024-08-23,8711
8440,綠電,10,0,10,陽信-石牌,2024-08-23,8711
00795B,中信美國公債20年,10,0,10,陽信-石牌,2024-08-23,8711
00671R,富邦NASDAQ反1,10,0,10,陽信-石牌,2024-08-23,8711
00936,台新永續高息中小,10,0,10,陽信-石牌,2024-08-23,8711
1515,力山,10,0,10,陽信-石牌,2024-08-23,8711
2340,台亞,15,5,10,陽信-石牌,2024-08-23,8711
2412,中華電,10,0,10,陽信-石牌,2024-08-23,8711
3202,樺晟,20,10,10,陽信-石牌,2024-08-23,8711
00632R,元大台灣50反1,515,0,515,陽信-石牌,2024-08-26,8711
2888,新光金,856,346,510,陽信-石牌,2024-08-26,8711
00687B,國泰20年美債,265,0,265,陽信-石牌,2024-08-26,8711
00706L,期元大S＆P日圓正2,141,0,141,陽信-石牌,2024-08-26,8711
00937B,群益ESG投等債20,113,3,110,陽信-石牌,2024-08-26,8711
3033,威健,85,6,79,陽信-石牌,2024-08-26,8711
2506,太設,61,8,53,陽信-石牌,2024-08-26,8711
2303,聯電,53,3,50,陽信-石牌,2024-08-26,8711
1714,和桐,40,0,40,陽信-石牌,2024-08-26,8711
2313,華通,33,3,30,陽信-石牌,2024-08-26,8711
00751B,元大AAA至A公司債,29,0,29,陽信-石牌,2024-08-26,8711
1314,中石化,24,0,24,陽信-石牌,2024-08-26,8711
3006,晶豪科,22,0,22,陽信-石牌,2024-08-26,8711
6108,競國,22,0,22,陽信-石牌,2024-08-26,8711
00948B,中信優息投資級債,21,0,21,陽信-石牌,2024-08-26,8711
2312,金寶,25,5,20,陽信-石牌,2024-08-26,8711
8021,尖點,45,25,20,陽信-石牌,2024-08-26,8711
1301,台塑,19,0,19,陽信-石牌,2024-08-26,8711
2467,志聖,32,16,16,陽信-石牌,2024-08-26,8711
6274,台燿,20,4,16,陽信-石牌,2024-08-26,8711
4513,福裕,39,23,16,陽信-石牌,2024-08-26,8711
1514,亞力,11,1,10,陽信-石牌,2024-08-26,8711
1540,喬福,10,0,10,陽信-石牌,2024-08-26,8711
2489,瑞軒,20,10,10,陽信-石牌,2024-08-26,8711
2890,永豐金,10,0,10,陽信-石牌,2024-08-26,8711
3060,銘異,10,0,10,陽信-石牌,2024-08-26,8711
6841,長佳智能,10,0,10,陽信-石牌,2024-08-26,8711
8049,晶采,10,0,10,陽信-石牌,2024-08-26,8711
1528,恩德,10,1,9,陽信-石牌,2024-08-26,8711
3013,晟銘電,11,2,9,陽信-石牌,2024-08-26,8711
3037,欣興,18,9,9,陽信-石牌,2024-08-26,8711
2409,友達,82,74,8,陽信-石牌,2024-08-26,8711
2449,京元電子,17,9,8,陽信-石牌,2024-08-26,8711
2537,聯上發,8,0,8,陽信-石牌,2024-08-26,8711
3376,新日興,11,3,8,陽信-石牌,2024-08-26,8711
4526,東台,29,21,8,陽信-石牌,2024-08-26,8711
2464,盟立,13,5,8,陽信-石牌,2024-08-26,8711
00919,群益台灣精選高息,33,26,7,陽信-石牌,2024-08-26,8711
1711,永光,76,69,7,陽信-石牌,2024-08-26,8711
2641,正德,10,3,7,陽信-石牌,2024-08-26,8711
1815,富喬,6,0,6,陽信-石牌,2024-08-26,8711
2062,橋椿,7,1,6,陽信-石牌,2024-08-26,8711
4967,十銓,7,1,6,陽信-石牌,2024-08-26,8711
2376,技嘉,14,8,6,陽信-石牌,2024-08-26,8711
3583,辛耘,5,0,5,陽信-石牌,2024-08-26,8711
1519,華城,7,2,5,陽信-石牌,2024-08-26,8711
00679B,元大美債20年,5,0,5,陽信-石牌,2024-08-26,8711
0055,元大MSCI金融,5,0,5,陽信-石牌,2024-08-26,8711
2371,大同,5,0,5,陽信-石牌,2024-08-26,8711
2530,華建,5,0,5,陽信-石牌,2024-08-26,8711
00688L,國泰20年美債正2,175,0,175,陽信-石牌,2024-08-27,8711
00687B,國泰20年美債,175,6,169,陽信-石牌,2024-08-27,8711
00931B,統一美債20年,169,0,169,陽信-石牌,2024-08-27,8711
00937B,群益ESG投等債20,165,4,161,陽信-石牌,2024-08-27,8711
2891,中信金,121,37,84,陽信-石牌,2024-08-27,8711
00673R,期元大S＆P原油反1,76,0,76,陽信-石牌,2024-08-27,8711
2845,遠東銀,75,0,75,陽信-石牌,2024-08-27,8711
2883,凱基金,68,0,68,陽信-石牌,2024-08-27,8711
2303,聯電,64,0,64,陽信-石牌,2024-08-27,8711
00919,群益台灣精選高息,51,3,48,陽信-石牌,2024-08-27,8711
1584,精剛,46,0,46,陽信-石牌,2024-08-27,8711
2208,台船,50,5,45,陽信-石牌,2024-08-27,8711
2344,華邦電,41,1,40,陽信-石牌,2024-08-27,8711
3550,聯穎,38,0,38,陽信-石牌,2024-08-27,8711
00948B,中信優息投資級債,28,0,28,陽信-石牌,2024-08-27,8711
2610,華航,34,8,26,陽信-石牌,2024-08-27,8711
3019,亞光,62,38,24,陽信-石牌,2024-08-27,8711
2897,王道銀行,20,0,20,陽信-石牌,2024-08-27,8711
5388,中磊,20,0,20,陽信-石牌,2024-08-27,8711
2609,陽明,46,27,19,陽信-石牌,2024-08-27,8711
1815,富喬,18,0,18,陽信-石牌,2024-08-27,8711
6116,彩晶,20,2,18,陽信-石牌,2024-08-27,8711
6150,撼訊,23,5,18,陽信-石牌,2024-08-27,8711
00662,富邦NASDAQ,17,0,17,陽信-石牌,2024-08-27,8711
00679B,元大美債20年,16,0,16,陽信-石牌,2024-08-27,8711
2349,錸德,27,12,15,陽信-石牌,2024-08-27,8711
2515,中工,115,100,15,陽信-石牌,2024-08-27,8711
2834,臺企銀,15,0,15,陽信-石牌,2024-08-27,8711
2520,冠德,25,11,14,陽信-石牌,2024-08-27,8711
3450,聯鈞,23,9,14,陽信-石牌,2024-08-27,8711
2481,強茂,15,2,13,陽信-石牌,2024-08-27,8711
2615,萬海,44,31,13,陽信-石牌,2024-08-27,8711
2317,鴻海,15,1,14,陽信-石牌,2024-08-27,8711
00929,復華台灣科技優息,13,1,12,陽信-石牌,2024-08-27,8711
3149,正達,13,1,12,陽信-石牌,2024-08-27,8711
00940,元大台灣價值高息,11,0,11,陽信-石牌,2024-08-27,8711
2887,台新金,113,103,10,陽信-石牌,2024-08-27,8711
00669R,國泰美國道瓊反1,10,0,10,陽信-石牌,2024-08-27,8711
2009,第一銅,10,0,10,陽信-石牌,2024-08-27,8711
2401,凌陽,10,0,10,陽信-石牌,2024-08-27,8711
2409,友達,10,0,10,陽信-石牌,2024-08-27,8711
2880,華南金,10,0,10,陽信-石牌,2024-08-27,8711
4916,事欣科,10,0,10,陽信-石牌,2024-08-27,8711
8039,台虹,38,29,9,陽信-石牌,2024-08-27,8711
2603,長榮,39,31,8,陽信-石牌,2024-08-27,8711
1316,上曜,13,5,8,陽信-石牌,2024-08-27,8711
1598,岱宇,8,0,8,陽信-石牌,2024-08-27,8711
3379,彬台,8,0,8,陽信-石牌,2024-08-27,8711
8070,長華*,10,2,8,陽信-石牌,2024-08-27,8711
1776,展宇,8,1,7,陽信-石牌,2024-08-27,8711
00687B,國泰20年美債,220,5,215,陽信-石牌,2024-08-28,8711
2897,王道銀行,60,0,60,陽信-石牌,2024-08-28,8711
2402,毅嘉,52,5,47,陽信-石牌,2024-08-28,8711
00937B,群益ESG投等債20,42,5,37,陽信-石牌,2024-08-28,8711
2464,盟立,36,3,33,陽信-石牌,2024-08-28,8711
2888,新光金,336,304,32,陽信-石牌,2024-08-28,8711
5328,華容,40,10,30,陽信-石牌,2024-08-28,8711
00713,元大台灣高息低波,25,0,25,陽信-石牌,2024-08-28,8711
00948B,中信優息投資級債,25,0,25,陽信-石牌,2024-08-28,8711
1611,中電,25,0,25,陽信-石牌,2024-08-28,8711
8064,東捷,33,8,25,陽信-石牌,2024-08-28,8711
5386,青雲,36,13,23,陽信-石牌,2024-08-28,8711
2409,友達,53,32,21,陽信-石牌,2024-08-28,8711
8927,北基,20,0,20,陽信-石牌,2024-08-28,8711
2891,中信金,24,7,17,陽信-石牌,2024-08-28,8711
2317,鴻海,68,53,15,陽信-石牌,2024-08-28,8711
00940,元大台灣價值高息,15,0,15,陽信-石牌,2024-08-28,8711
8112,至上,16,1,15,陽信-石牌,2024-08-28,8711
3017,奇鋐,17,3,14,陽信-石牌,2024-08-28,8711
5534,長虹,30,16,14,陽信-石牌,2024-08-28,8711
2421,建準,13,0,13,陽信-石牌,2024-08-28,8711
3122,笙泉,13,0,13,陽信-石牌,2024-08-28,8711
6127,九豪,12,0,12,陽信-石牌,2024-08-28,8711
2834,臺企銀,11,0,11,陽信-石牌,2024-08-28,8711
2880,華南金,11,0,11,陽信-石牌,2024-08-28,8711
3019,亞光,13,2,11,陽信-石牌,2024-08-28,8711
4533,協易機,15,4,11,陽信-石牌,2024-08-28,8711
4903,聯光通,12,1,11,陽信-石牌,2024-08-28,8711
4927,泰鼎-KY,12,1,11,陽信-石牌,2024-08-28,8711
6603,富強鑫,17,6,11,陽信-石牌,2024-08-28,8711
6770,力積電,13,3,10,陽信-石牌,2024-08-28,8711
2359,所羅門,10,0,10,陽信-石牌,2024-08-28,8711
00632R,元大台灣50反1,10,0,10,陽信-石牌,2024-08-28,8711
00959B,大華投等美債15Y+,30,20,10,陽信-石牌,2024-08-28,8711
00900,富邦特選高股息30,10,0,10,陽信-石牌,2024-08-28,8711
2324,仁寶,10,0,10,陽信-石牌,2024-08-28,8711
2362,藍天,10,0,10,陽信-石牌,2024-08-28,8711
2388,威盛,17,7,10,陽信-石牌,2024-08-28,8711
2431,聯昌,11,1,10,陽信-石牌,2024-08-28,8711
8403,盛弘,10,0,10,陽信-石牌,2024-08-28,8711
2344,華邦電,11,2,9,陽信-石牌,2024-08-28,8711
2408,南亞科,9,0,9,陽信-石牌,2024-08-28,8711
2426,鼎元,10,1,9,陽信-石牌,2024-08-28,8711
2530,華建,9,0,9,陽信-石牌,2024-08-28,8711
00919,群益台灣精選高息,14,5,9,陽信-石牌,2024-08-28,8711
00929,復華台灣科技優息,12,4,8,陽信-石牌,2024-08-28,8711
00679B,元大美債20年,8,0,8,陽信-石牌,2024-08-28,8711
3048,益登,8,0,8,陽信-石牌,2024-08-28,8711
4564,元翎,8,0,8,陽信-石牌,2024-08-28,8711
8070,長華*,19,11,8,陽信-石牌,2024-08-28,8711
00679B,元大美債20年,187,0,187,陽信-石牌,2024-08-29,8711
00929,復華台灣科技優息,138,2,136,陽信-石牌,2024-08-29,8711
00715L,期街口布蘭特正2,85,0,85,陽信-石牌,2024-08-29,8711
2303,聯電,58,0,58,陽信-石牌,2024-08-29,8711
2426,鼎元,91,47,44,陽信-石牌,2024-08-29,8711
2331,精英,41,0,41,陽信-石牌,2024-08-29,8711
2371,大同,40,4,36,陽信-石牌,2024-08-29,8711
2891,中信金,34,0,34,陽信-石牌,2024-08-29,8711
5443,均豪,69,37,32,陽信-石牌,2024-08-29,8711
2610,華航,33,3,30,陽信-石牌,2024-08-29,8711
00948B,中信優息投資級債,28,0,28,陽信-石牌,2024-08-29,8711
00937B,群益ESG投等債20,33,5,28,陽信-石牌,2024-08-29,8711
8440,綠電,28,0,28,陽信-石牌,2024-08-29,8711
4513,福裕,32,5,27,陽信-石牌,2024-08-29,8711
4566,時碩工業,24,0,24,陽信-石牌,2024-08-29,8711
2317,鴻海,48,25,23,陽信-石牌,2024-08-29,8711
00680L,元大美債20正2,21,0,21,陽信-石牌,2024-08-29,8711
5905,南仁湖,21,0,21,陽信-石牌,2024-08-29,8711
1721,三晃,33,13,20,陽信-石牌,2024-08-29,8711
2888,新光金,39,19,20,陽信-石牌,2024-08-29,8711
00650L,復華香港正2,18,0,18,陽信-石牌,2024-08-29,8711
00687B,國泰20年美債,17,0,17,陽信-石牌,2024-08-29,8711
1714,和桐,17,0,17,陽信-石牌,2024-08-29,8711
3380,明泰,18,2,16,陽信-石牌,2024-08-29,8711
3481,群創,18,3,15,陽信-石牌,2024-08-29,8711
2330,台積電,18,4,14,陽信-石牌,2024-08-29,8711
00878,國泰永續高股息,13,0,13,陽信-石牌,2024-08-29,8711
00753L,中信中國50正2,13,0,13,陽信-石牌,2024-08-29,8711
2377,微星,20,7,13,陽信-石牌,2024-08-29,8711
4510,高鋒,32,20,12,陽信-石牌,2024-08-29,8711
00688L,國泰20年美債正2,11,0,11,陽信-石牌,2024-08-29,8711
00923,群益台ESG低碳50,11,0,11,陽信-石牌,2024-08-29,8711
3060,銘異,16,5,11,陽信-石牌,2024-08-29,8711
1611,中電,10,0,10,陽信-石牌,2024-08-29,8711
3147,大綜,14,4,10,陽信-石牌,2024-08-29,8711
3231,緯創,20,10,10,陽信-石牌,2024-08-29,8711
3294,英濟,10,0,10,陽信-石牌,2024-08-29,8711
3576,聯合再生,10,0,10,陽信-石牌,2024-08-29,8711
8011,台通,50,40,10,陽信-石牌,2024-08-29,8711
2344,華邦電,21,11,10,陽信-石牌,2024-08-29,8711
2301,光寶科,20,11,9,陽信-石牌,2024-08-29,8711
1540,喬福,14,5,9,陽信-石牌,2024-08-29,8711
8096,擎亞,14,5,9,陽信-石牌,2024-08-29,8711
00919,群益台灣精選高息,11,3,8,陽信-石牌,2024-08-29,8711
2314,台揚,9,1,8,陽信-石牌,2024-08-29,8711
2634,漢翔,8,0,8,陽信-石牌,2024-08-29,8711
3450,聯鈞,41,33,8,陽信-石牌,2024-08-29,8711
5534,長虹,19,11,8,陽信-石牌,2024-08-29,8711
8027,鈦昇,8,0,8,陽信-石牌,2024-08-29,8711
00662,富邦NASDAQ,7,0,7,陽信-石牌,2024-08-29,8711
00929,復華台灣科技優息,171,67,104,陽信-石牌,2024-08-30,8711
1531,高林股,100,4,96,陽信-石牌,2024-08-30,8711
9105,泰金寶-DR,98,30,68,陽信-石牌,2024-08-30,8711
2313,華通,88,30,58,陽信-石牌,2024-08-30,8711
4526,東台,69,19,50,陽信-石牌,2024-08-30,8711
6541,泰福-KY,54,4,50,陽信-石牌,2024-08-30,8711
2409,友達,41,0,41,陽信-石牌,2024-08-30,8711
2324,仁寶,43,12,31,陽信-石牌,2024-08-30,8711
8107,大億金茂,36,5,31,陽信-石牌,2024-08-30,8711
3481,群創,54,24,30,陽信-石牌,2024-08-30,8711
00919,群益台灣精選高息,31,1,30,陽信-石牌,2024-08-30,8711
2102,泰豐,30,0,30,陽信-石牌,2024-08-30,8711
2891,中信金,26,1,25,陽信-石牌,2024-08-30,8711
3535,晶彩科,24,1,23,陽信-石牌,2024-08-30,8711
3062,建漢,32,10,22,陽信-石牌,2024-08-30,8711
2425,承啟,51,30,21,陽信-石牌,2024-08-30,8711
5905,南仁湖,21,0,21,陽信-石牌,2024-08-30,8711
2485,兆赫,20,0,20,陽信-石牌,2024-08-30,8711
00948B,中信優息投資級債,20,0,20,陽信-石牌,2024-08-30,8711
1708,東鹼,21,2,19,陽信-石牌,2024-08-30,8711
3374,精材,29,11,18,陽信-石牌,2024-08-30,8711
00679B,元大美債20年,18,0,18,陽信-石牌,2024-08-30,8711
00687B,國泰20年美債,18,0,18,陽信-石牌,2024-08-30,8711
4720,德淵,19,2,17,陽信-石牌,2024-08-30,8711
3189,景碩,20,4,16,陽信-石牌,2024-08-30,8711
1584,精剛,16,1,15,陽信-石牌,2024-08-30,8711
3015,全漢,14,0,14,陽信-石牌,2024-08-30,8711
4564,元翎,14,0,14,陽信-石牌,2024-08-30,8711
4960,誠美材,14,0,14,陽信-石牌,2024-08-30,8711
00715L,期街口布蘭特正2,98,85,13,陽信-石牌,2024-08-30,8711
3081,聯亞,17,5,12,陽信-石牌,2024-08-30,8711
8429,金麗-KY,12,0,12,陽信-石牌,2024-08-30,8711
00959B,大華投等美債15Y+,10,0,10,陽信-石牌,2024-08-30,8711
00671R,富邦NASDAQ反1,10,0,10,陽信-石牌,2024-08-30,8711
2439,美律,10,0,10,陽信-石牌,2024-08-30,8711
2851,中再保,10,0,10,陽信-石牌,2024-08-30,8711
2881,富邦金,10,0,10,陽信-石牌,2024-08-30,8711
4532,瑞智,10,0,10,陽信-石牌,2024-08-30,8711
5439,高技,10,0,10,陽信-石牌,2024-08-30,8711
6215,和椿,19,9,10,陽信-石牌,2024-08-30,8711
3013,晟銘電,14,5,9,陽信-石牌,2024-08-30,8711
3234,光環,9,0,9,陽信-石牌,2024-08-30,8711
6156,松上,10,1,9,陽信-石牌,2024-08-30,8711
9958,世紀鋼,11,2,9,陽信-石牌,2024-08-30,8711
3498,陽程,13,4,9,陽信-石牌,2024-08-30,8711
3202,樺晟,8,0,8,陽信-石牌,2024-08-30,8711
3673,TPK-KY,27,19,8,陽信-石牌,2024-08-30,8711
5443,均豪,46,38,8,陽信-石牌,2024-08-30,8711
5484,慧友,8,0,8,陽信-石牌,2024-08-30,8711
1326,台化,7,1,6,陽信-石牌,2024-08-30,8711
2542,興富發,104,0,104,陽信-石牌,2024-09-02,8711
00673R,期元大S＆P原油反1,65,0,65,陽信-石牌,2024-09-02,8711
1447,力鵬,44,0,44,陽信-石牌,2024-09-02,8711
00959B,大華投等美債15Y+,40,0,40,陽信-石牌,2024-09-02,8711
00919,群益台灣精選高息,40,6,34,陽信-石牌,2024-09-02,8711
3481,群創,68,37,31,陽信-石牌,2024-09-02,8711
00937B,群益ESG投等債20,36,7,29,陽信-石牌,2024-09-02,8711
00687B,國泰20年美債,29,0,29,陽信-石牌,2024-09-02,8711
2615,萬海,74,47,27,陽信-石牌,2024-09-02,8711
00915,凱基優選高股息30,22,0,22,陽信-石牌,2024-09-02,8711
00680L,元大美債20正2,23,2,21,陽信-石牌,2024-09-02,8711
00923,群益台ESG低碳50,19,0,19,陽信-石牌,2024-09-02,8711
2426,鼎元,21,2,19,陽信-石牌,2024-09-02,8711
3211,順達,20,1,19,陽信-石牌,2024-09-02,8711
8089,康全電訊,20,1,19,陽信-石牌,2024-09-02,8711
2609,陽明,24,7,17,陽信-石牌,2024-09-02,8711
4513,福裕,34,17,17,陽信-石牌,2024-09-02,8711
8086,宏捷科,31,15,16,陽信-石牌,2024-09-02,8711
00948B,中信優息投資級債,21,6,15,陽信-石牌,2024-09-02,8711
00918,大華優利高填息30,14,0,14,陽信-石牌,2024-09-02,8711
1540,喬福,15,1,14,陽信-石牌,2024-09-02,8711
3062,建漢,30,17,13,陽信-石牌,2024-09-02,8711
8111,立��,18,5,13,陽信-石牌,2024-09-02,8711
00679B,元大美債20年,12,0,12,陽信-石牌,2024-09-02,8711
2881,富邦金,15,3,12,陽信-石牌,2024-09-02,8711
3006,晶豪科,12,1,11,陽信-石牌,2024-09-02,8711
00753L,中信中國50正2,10,0,10,陽信-石牌,2024-09-02,8711
00632R,元大台灣50反1,10,0,10,陽信-石牌,2024-09-02,8711
2349,錸德,28,18,10,陽信-石牌,2024-09-02,8711
2399,映泰,10,0,10,陽信-石牌,2024-09-02,8711
4564,元翎,10,0,10,陽信-石牌,2024-09-02,8711
4714,永捷,23,13,10,陽信-石牌,2024-09-02,8711
5309,系統電,10,0,10,陽信-石牌,2024-09-02,8711
6113,亞矽,10,0,10,陽信-石牌,2024-09-02,8711
8222,寶一,10,0,10,陽信-石牌,2024-09-02,8711
2330,台積電,11,1,10,陽信-石牌,2024-09-02,8711
00633L,富邦上証正2,9,0,9,陽信-石牌,2024-09-02,8711
2312,金寶,10,1,9,陽信-石牌,2024-09-02,8711
2355,敬鵬,10,1,9,陽信-石牌,2024-09-02,8711
3033,威健,9,0,9,陽信-石牌,2024-09-02,8711
4903,聯光通,12,3,9,陽信-石牌,2024-09-02,8711
5483,中美晶,10,1,9,陽信-石牌,2024-09-02,8711
4510,高鋒,20,11,9,陽信-石牌,2024-09-02,8711
1808,潤隆,8,0,8,陽信-石牌,2024-09-02,8711
3149,正達,8,0,8,陽信-石牌,2024-09-02,8711
3390,旭軟,18,10,8,陽信-石牌,2024-09-02,8711
3645,達邁,8,0,8,陽信-石牌,2024-09-02,8711
2303,聯電,11,3,8,陽信-石牌,2024-09-02,8711
3189,景碩,11,4,7,陽信-石牌,2024-09-02,8711
3017,奇鋐,9,2,7,陽信-石牌,2024-09-02,8711
00679B,元大美債20年,103,0,103,陽信-石牌,2024-09-03,8711
00959B,大華投等美債15Y+,100,0,100,陽信-石牌,2024-09-03,8711
00937B,群益ESG投等債20,103,4,99,陽信-石牌,2024-09-03,8711
00715L,期街口布蘭特正2,82,6,76,陽信-石牌,2024-09-03,8711
2538,基泰,60,0,60,陽信-石牌,2024-09-03,8711
00687B,國泰20年美債,77,18,59,陽信-石牌,2024-09-03,8711
3062,建漢,92,50,42,陽信-石牌,2024-09-03,8711
00919,群益台灣精選高息,36,1,35,陽信-石牌,2024-09-03,8711
1727,中華化,35,0,35,陽信-石牌,2024-09-03,8711
4157,太景*-KY,30,0,30,陽信-石牌,2024-09-03,8711
2543,皇昌,31,4,27,陽信-石牌,2024-09-03,8711
3704,合勤控,30,3,27,陽信-石牌,2024-09-03,8711
5309,系統電,26,0,26,陽信-石牌,2024-09-03,8711
00915,凱基優選高股息30,23,1,22,陽信-石牌,2024-09-03,8711
00878,國泰永續高股息,21,0,21,陽信-石牌,2024-09-03,8711
00948B,中信優息投資級債,20,0,20,陽信-石牌,2024-09-03,8711
6108,競國,20,0,20,陽信-石牌,2024-09-03,8711
6213,聯茂,25,5,20,陽信-石牌,2024-09-03,8711
8440,綠電,20,0,20,陽信-石牌,2024-09-03,8711
3450,聯鈞,29,11,18,陽信-石牌,2024-09-03,8711
2363,矽統,17,0,17,陽信-石牌,2024-09-03,8711
3105,穩懋,22,5,17,陽信-石牌,2024-09-03,8711
2356,英業達,17,1,16,陽信-石牌,2024-09-03,8711
3715,定穎投控,26,11,15,陽信-石牌,2024-09-03,8711
3037,欣興,35,22,13,陽信-石牌,2024-09-03,8711
3048,益登,14,1,13,陽信-石牌,2024-09-03,8711
3360,尚立,13,0,13,陽信-石牌,2024-09-03,8711
4549,桓達,13,0,13,陽信-石牌,2024-09-03,8711
1513,中興電,12,0,12,陽信-石牌,2024-09-03,8711
2365,昆盈,26,14,12,陽信-石牌,2024-09-03,8711
2542,興富發,62,50,12,陽信-石牌,2024-09-03,8711
4714,永捷,22,10,12,陽信-石牌,2024-09-03,8711
00882,中信中國高股息,12,0,12,陽信-石牌,2024-09-03,8711
00929,復華台灣科技優息,52,41,11,陽信-石牌,2024-09-03,8711
2497,怡利電,12,1,11,陽信-石牌,2024-09-03,8711
5426,振發,11,0,11,陽信-石牌,2024-09-03,8711
6806,森崴能源,11,0,11,陽信-石牌,2024-09-03,8711
00946,群益科技高息成長,10,0,10,陽信-石牌,2024-09-03,8711
2323,中環,10,0,10,陽信-石牌,2024-09-03,8711
2352,佳世達,10,0,10,陽信-石牌,2024-09-03,8711
2834,臺企銀,10,0,10,陽信-石牌,2024-09-03,8711
3006,晶豪科,11,1,10,陽信-石牌,2024-09-03,8711
3260,威剛,10,0,10,陽信-石牌,2024-09-03,8711
3508,位速,10,0,10,陽信-石牌,2024-09-03,8711
2606,裕民,10,1,9,陽信-石牌,2024-09-03,8711
00650L,復華香港正2,9,0,9,陽信-石牌,2024-09-03,8711
0056,元大高股息,9,0,9,陽信-石牌,2024-09-03,8711
2537,聯上發,11,2,9,陽信-石牌,2024-09-03,8711
3548,兆利,12,3,9,陽信-石牌,2024-09-03,8711
1598,岱宇,8,0,8,陽信-石牌,2024-09-03,8711
00632R,元大台灣50反1,2813,157,2656,陽信-石牌,2024-09-04,8711
00919,群益台灣精選高息,277,12,265,陽信-石牌,2024-09-04,8711
2498,宏達電,115,0,115,陽信-石牌,2024-09-04,8711
1714,和桐,114,12,102,陽信-石牌,2024-09-04,8711
9105,泰金寶-DR,86,0,86,陽信-石牌,2024-09-04,8711
00878,國泰永續高股息,86,11,75,陽信-石牌,2024-09-04,8711
00918,大華優利高填息30,72,1,71,陽信-石牌,2024-09-04,8711
3481,群創,74,6,68,陽信-石牌,2024-09-04,8711
2330,台積電,77,10,67,陽信-石牌,2024-09-04,8711
2891,中信金,62,0,62,陽信-石牌,2024-09-04,8711
3062,建漢,62,2,60,陽信-石牌,2024-09-04,8711
0056,元大高股息,59,1,58,陽信-石牌,2024-09-04,8711
2897,王道銀行,50,0,50,陽信-石牌,2024-09-04,8711
1785,光洋科,46,2,44,陽信-石牌,2024-09-04,8711
2312,金寶,41,6,35,陽信-石牌,2024-09-04,8711
2610,華航,35,0,35,陽信-石牌,2024-09-04,8711
6274,台燿,33,1,32,陽信-石牌,2024-09-04,8711
6108,競國,31,0,31,陽信-石牌,2024-09-04,8711
2356,英業達,31,1,30,陽信-石牌,2024-09-04,8711
00948B,中信優息投資級債,30,0,30,陽信-石牌,2024-09-04,8711
00673R,期元大S＆P原油反1,29,0,29,陽信-石牌,2024-09-04,8711
00664R,國泰臺灣加權反1,25,0,25,陽信-石牌,2024-09-04,8711
00687B,國泰20年美債,23,0,23,陽信-石牌,2024-09-04,8711
5443,均豪,40,17,23,陽信-石牌,2024-09-04,8711
6770,力積電,23,1,22,陽信-石牌,2024-09-04,8711
00929,復華台灣科技優息,87,65,22,陽信-石牌,2024-09-04,8711
0050,元大台灣50,22,0,22,陽信-石牌,2024-09-04,8711
2382,廣達,43,21,22,陽信-石牌,2024-09-04,8711
4174,浩鼎,25,4,21,陽信-石牌,2024-09-04,8711
2801,彰銀,20,0,20,陽信-石牌,2024-09-04,8711
2834,臺企銀,20,0,20,陽信-石牌,2024-09-04,8711
4510,高鋒,51,31,20,陽信-石牌,2024-09-04,8711
00713,元大台灣高息低波,19,0,19,陽信-石牌,2024-09-04,8711
00923,群益台ESG低碳50,17,0,17,陽信-石牌,2024-09-04,8711
2371,大同,30,13,17,陽信-石牌,2024-09-04,8711
8076,伍豐,20,3,17,陽信-石牌,2024-09-04,8711
00915,凱基優選高股息30,16,0,16,陽信-石牌,2024-09-04,8711
2316,楠梓電,17,1,16,陽信-石牌,2024-09-04,8711
1409,新纖,15,0,15,陽信-石牌,2024-09-04,8711
3088,艾訊,15,0,15,陽信-石牌,2024-09-04,8711
4303,信立,17,2,15,陽信-石牌,2024-09-04,8711
4714,永捷,21,6,15,陽信-石牌,2024-09-04,8711
3231,緯創,32,17,15,陽信-石牌,2024-09-04,8711
2002,中鋼,14,0,14,陽信-石牌,2024-09-04,8711
00881,國泰台灣5G+,14,0,14,陽信-石牌,2024-09-04,8711
00946,群益科技高息成長,14,0,14,陽信-石牌,2024-09-04,8711
2615,萬海,79,65,14,陽信-石牌,2024-09-04,8711
2317,鴻海,54,40,14,陽信-石牌,2024-09-04,8711
2367,燿華,14,1,13,陽信-石牌,2024-09-04,8711
1442,名軒,12,0,12,陽信-石牌,2024-09-04,8711
00940,元大台灣價值高息,497,4,493,陽信-石牌,2024-09-05,8711
00632R,元大台灣50反1,407,23,384,陽信-石牌,2024-09-05,8711
00688L,國泰20年美債正2,300,3,297,陽信-石牌,2024-09-05,8711
00878,國泰永續高股息,115,5,110,陽信-石牌,2024-09-05,8711
00715L,期街口布蘭特正2,67,0,67,陽信-石牌,2024-09-05,8711
00929,復華台灣科技優息,118,52,66,陽信-石牌,2024-09-05,8711
00641R,富邦日本反1,60,0,60,陽信-石牌,2024-09-05,8711
2365,昆盈,63,12,51,陽信-石牌,2024-09-05,8711
00919,群益台灣精選高息,40,0,40,陽信-石牌,2024-09-05,8711
2356,英業達,35,0,35,陽信-石牌,2024-09-05,8711
00687B,國泰20年美債,30,0,30,陽信-石牌,2024-09-05,8711
2832,台產,30,0,30,陽信-石牌,2024-09-05,8711
00946,群益科技高息成長,28,0,28,陽信-石牌,2024-09-05,8711
2409,友達,45,20,25,陽信-石牌,2024-09-05,8711
3013,晟銘電,27,2,25,陽信-石牌,2024-09-05,8711
00637L,元大滬深300正2,23,0,23,陽信-石牌,2024-09-05,8711
00664R,國泰臺灣加權反1,23,0,23,陽信-石牌,2024-09-05,8711
00915,凱基優選高股息30,22,0,22,陽信-石牌,2024-09-05,8711
6133,金橋,22,0,22,陽信-石牌,2024-09-05,8711
2317,鴻海,73,51,22,陽信-石牌,2024-09-05,8711
3019,亞光,34,13,21,陽信-石牌,2024-09-05,8711
3481,群創,22,2,20,陽信-石牌,2024-09-05,8711
00936,台新永續高息中小,20,0,20,陽信-石牌,2024-09-05,8711
3037,欣興,25,7,18,陽信-石牌,2024-09-05,8711
3715,定穎投控,20,2,18,陽信-石牌,2024-09-05,8711
4513,福裕,15,0,15,陽信-石牌,2024-09-05,8711
1301,台塑,14,1,13,陽信-石牌,2024-09-05,8711
2367,燿華,13,0,13,陽信-石牌,2024-09-05,8711
2371,大同,13,0,13,陽信-石牌,2024-09-05,8711
2603,長榮,15,2,13,陽信-石牌,2024-09-05,8711
1539,巨庭,19,7,12,陽信-石牌,2024-09-05,8711
6197,佳必琪,12,0,12,陽信-石牌,2024-09-05,8711
8039,台虹,12,0,12,陽信-石牌,2024-09-05,8711
1303,南亞,11,0,11,陽信-石牌,2024-09-05,8711
1540,喬福,30,19,11,陽信-石牌,2024-09-05,8711
2344,華邦電,11,0,11,陽信-石牌,2024-09-05,8711
00918,大華優利高填息30,20,10,10,陽信-石牌,2024-09-05,8711
00952,凱基台灣AI50,10,0,10,陽信-石牌,2024-09-05,8711
2408,南亞科,10,0,10,陽信-石牌,2024-09-05,8711
2530,華建,10,0,10,陽信-石牌,2024-09-05,8711
3230,錦明,10,0,10,陽信-石牌,2024-09-05,8711
4563,百德,21,11,10,陽信-石牌,2024-09-05,8711
3051,力特,9,0,9,陽信-石牌,2024-09-05,8711
6278,台表科,9,0,9,陽信-石牌,2024-09-05,8711
9103,美德醫療-DR,9,0,9,陽信-石牌,2024-09-05,8711
00642U,期元大S＆P石油,8,0,8,陽信-石牌,2024-09-05,8711
1905,華紙,14,6,8,陽信-石牌,2024-09-05,8711
2312,金寶,8,0,8,陽信-石牌,2024-09-05,8711
2369,菱生,8,0,8,陽信-石牌,2024-09-05,8711
2497,怡利電,8,0,8,陽信-石牌,2024-09-05,8711
00632R,元大台灣50反1,550,20,530,陽信-石牌,2024-09-06,8711
00671R,富邦NASDAQ反1,202,0,202,陽信-石牌,2024-09-06,8711
00687B,國泰20年美債,170,10,160,陽信-石牌,2024-09-06,8711
00648R,元大S＆P500反1,138,0,138,陽信-石牌,2024-09-06,8711
00669R,國泰美國道瓊反1,112,0,112,陽信-石牌,2024-09-06,8711
2881,富邦金,103,1,102,陽信-石牌,2024-09-06,8711
00680L,元大美債20正2,87,0,87,陽信-石牌,2024-09-06,8711
00878,國泰永續高股息,86,13,73,陽信-石牌,2024-09-06,8711
00706L,期元大S＆P日圓正2,116,60,56,陽信-石牌,2024-09-06,8711
2356,英業達,61,11,50,陽信-石牌,2024-09-06,8711
00764B,群益25年美債,43,2,41,陽信-石牌,2024-09-06,8711
00664R,國泰臺灣加權反1,34,0,34,陽信-石牌,2024-09-06,8711
2897,王道銀行,30,0,30,陽信-石牌,2024-09-06,8711
1815,富喬,33,8,25,陽信-石牌,2024-09-06,8711
2891,中信金,24,0,24,陽信-石牌,2024-09-06,8711
4906,正文,22,0,22,陽信-石牌,2024-09-06,8711
00725B,國泰投資級公司債,20,0,20,陽信-石牌,2024-09-06,8711
3062,建漢,19,0,19,陽信-石牌,2024-09-06,8711
2312,金寶,16,0,16,陽信-石牌,2024-09-06,8711
8374,羅昇,23,7,16,陽信-石牌,2024-09-06,8711
1598,岱宇,15,0,15,陽信-石牌,2024-09-06,8711
2409,友達,15,0,15,陽信-石牌,2024-09-06,8711
2637,慧洋-KY,15,0,15,陽信-石牌,2024-09-06,8711
8440,綠電,20,5,15,陽信-石牌,2024-09-06,8711
2892,第一金,13,0,13,陽信-石牌,2024-09-06,8711
3374,精材,20,8,12,陽信-石牌,2024-09-06,8711
3017,奇鋐,17,5,12,陽信-石牌,2024-09-06,8711
3037,欣興,13,1,12,陽信-石牌,2024-09-06,8711
5225,東科-KY,13,1,12,陽信-石牌,2024-09-06,8711
5452,佶優,12,0,12,陽信-石牌,2024-09-06,8711
4510,高鋒,30,18,12,陽信-石牌,2024-09-06,8711
2344,華邦電,11,0,11,陽信-石牌,2024-09-06,8711
3051,力特,11,0,11,陽信-石牌,2024-09-06,8711
2495,普安,27,17,10,陽信-石牌,2024-09-06,8711
00715L,期街口布蘭特正2,10,0,10,陽信-石牌,2024-09-06,8711
00952,凱基台灣AI50,10,0,10,陽信-石牌,2024-09-06,8711
1444,力麗,10,0,10,陽信-石牌,2024-09-06,8711
1711,永光,34,24,10,陽信-石牌,2024-09-06,8711
2417,圓剛,10,0,10,陽信-石牌,2024-09-06,8711
3227,原相,11,1,10,陽信-石牌,2024-09-06,8711
3450,聯鈞,10,0,10,陽信-石牌,2024-09-06,8711
00940,元大台灣價值高息,9,0,9,陽信-石牌,2024-09-06,8711
00919,群益台灣精選高息,10,1,9,陽信-石牌,2024-09-06,8711
00720B,元大投資級公司債,9,0,9,陽信-石牌,2024-09-06,8711
00773B,中信優先金融債,8,0,8,陽信-石牌,2024-09-06,8711
2233,宇隆,8,0,8,陽信-石牌,2024-09-06,8711
5340,建榮,10,2,8,陽信-石牌,2024-09-06,8711
2349,錸德,9,2,7,陽信-石牌,2024-09-06,8711
2618,長榮航,13,6,7,陽信-石牌,2024-09-06,8711
6187,萬潤,10,3,7,陽信-石牌,2024-09-06,8711
00919,群益台灣精選高息,204,1,203,陽信-石牌,2024-09-09,8711
00931B,統一美債20年,188,0,188,陽信-石牌,2024-09-09,8711
9907,統一實,100,0,100,陽信-石牌,2024-09-09,8711
00715L,期街口布蘭特正2,65,0,65,陽信-石牌,2024-09-09,8711
00929,復華台灣科技優息,65,3,62,陽信-石牌,2024-09-09,8711
00687B,國泰20年美債,56,0,56,陽信-石牌,2024-09-09,8711
2609,陽明,43,4,39,陽信-石牌,2024-09-09,8711
00946,群益科技高息成長,37,0,37,陽信-石牌,2024-09-09,8711
00878,國泰永續高股息,37,4,33,陽信-石牌,2024-09-09,8711
3037,欣興,29,0,29,陽信-石牌,2024-09-09,8711
2313,華通,39,10,29,陽信-石牌,2024-09-09,8711
5905,南仁湖,36,7,29,陽信-石牌,2024-09-09,8711
2317,鴻海,40,13,27,陽信-石牌,2024-09-09,8711
6194,育富,31,4,27,陽信-石牌,2024-09-09,8711
00680L,元大美債20正2,25,0,25,陽信-石牌,2024-09-09,8711
2356,英業達,29,7,22,陽信-石牌,2024-09-09,8711
1326,台化,23,1,22,陽信-石牌,2024-09-09,8711
8374,羅昇,50,29,21,陽信-石牌,2024-09-09,8711
2017,官田鋼,20,0,20,陽信-石牌,2024-09-09,8711
3484,崧騰,20,0,20,陽信-石牌,2024-09-09,8711
3711,日月光投控,20,0,20,陽信-石牌,2024-09-09,8711
00948B,中信優息投資級債,19,0,19,陽信-石牌,2024-09-09,8711
00915,凱基優選高股息30,16,0,16,陽信-石牌,2024-09-09,8711
2330,台積電,20,4,16,陽信-石牌,2024-09-09,8711
00918,大華優利高填息30,15,0,15,陽信-石牌,2024-09-09,8711
00939,統一台灣高息動能,15,0,15,陽信-石牌,2024-09-09,8711
0056,元大高股息,14,0,14,陽信-石牌,2024-09-09,8711
00934,中信成長高股息,12,0,12,陽信-石牌,2024-09-09,8711
00637L,元大滬深300正2,14,2,12,陽信-石牌,2024-09-09,8711
2426,鼎元,22,10,12,陽信-石牌,2024-09-09,8711
2885,元大金,12,0,12,陽信-石牌,2024-09-09,8711
3481,群創,28,16,12,陽信-石牌,2024-09-09,8711
2349,錸德,11,0,11,陽信-石牌,2024-09-09,8711
00940,元大台灣價值高息,19,9,10,陽信-石牌,2024-09-09,8711
2891,中信金,15,5,10,陽信-石牌,2024-09-09,8711
1587,吉茂,10,0,10,陽信-石牌,2024-09-09,8711
1714,和桐,10,0,10,陽信-石牌,2024-09-09,8711
2637,慧洋-KY,10,0,10,陽信-石牌,2024-09-09,8711
2801,彰銀,10,0,10,陽信-石牌,2024-09-09,8711
2812,台中銀,10,0,10,陽信-石牌,2024-09-09,8711
3105,穩懋,10,0,10,陽信-石牌,2024-09-09,8711
4729,熒茂,13,3,10,陽信-石牌,2024-09-09,8711
4903,聯光通,10,0,10,陽信-石牌,2024-09-09,8711
4958,臻鼎-KY,10,0,10,陽信-石牌,2024-09-09,8711
5388,中磊,10,0,10,陽信-石牌,2024-09-09,8711
5531,鄉林,10,0,10,陽信-石牌,2024-09-09,8711
6770,力積電,18,8,10,陽信-石牌,2024-09-09,8711
2382,廣達,24,15,9,陽信-石牌,2024-09-09,8711
2002,中鋼,10,1,9,陽信-石牌,2024-09-09,8711
6443,元晶,9,0,9,陽信-石牌,2024-09-09,8711
00931B,統一美債20年,169,0,169,陽信-石牌,2024-09-10,8711
00688L,國泰20年美債正2,131,0,131,陽信-石牌,2024-09-10,8711
00937B,群益ESG投等債20,125,4,121,陽信-石牌,2024-09-10,8711
3481,群創,112,1,111,陽信-石牌,2024-09-10,8711
2881,富邦金,96,0,96,陽信-石牌,2024-09-10,8711
5460,同協,60,1,59,陽信-石牌,2024-09-10,8711
2497,怡利電,86,33,53,陽信-石牌,2024-09-10,8711
00664R,國泰臺灣加權反1,51,0,51,陽信-石牌,2024-09-10,8711
00929,復華台灣科技優息,46,0,46,陽信-石牌,2024-09-10,8711
8076,伍豐,45,1,44,陽信-石牌,2024-09-10,8711
2313,華通,52,12,40,陽信-石牌,2024-09-10,8711
00687B,國泰20年美債,99,60,39,陽信-石牌,2024-09-10,8711
2606,裕民,35,0,35,陽信-石牌,2024-09-10,8711
2891,中信金,38,5,33,陽信-石牌,2024-09-10,8711
2832,台產,30,0,30,陽信-石牌,2024-09-10,8711
2382,廣達,28,0,28,陽信-石牌,2024-09-10,8711
2344,華邦電,23,0,23,陽信-石牌,2024-09-10,8711
3062,建漢,41,20,21,陽信-石牌,2024-09-10,8711
00918,大華優利高填息30,20,0,20,陽信-石牌,2024-09-10,8711
00936,台新永續高息中小,20,0,20,陽信-石牌,2024-09-10,8711
1539,巨庭,20,0,20,陽信-石牌,2024-09-10,8711
1815,富喬,35,15,20,陽信-石牌,2024-09-10,8711
3518,柏騰,20,0,20,陽信-石牌,2024-09-10,8711
3037,欣興,23,5,18,陽信-石牌,2024-09-10,8711
2409,友達,19,2,17,陽信-石牌,2024-09-10,8711
00940,元大台灣價值高息,15,0,15,陽信-石牌,2024-09-10,8711
00673R,期元大S＆P原油反1,15,0,15,陽信-石牌,2024-09-10,8711
1442,名軒,15,0,15,陽信-石牌,2024-09-10,8711
2312,金寶,16,1,15,陽信-石牌,2024-09-10,8711
3060,銘異,15,0,15,陽信-石牌,2024-09-10,8711
6739,竹陞科技,15,0,15,陽信-石牌,2024-09-10,8711
8403,盛弘,15,0,15,陽信-石牌,2024-09-10,8711
9945,潤泰新,16,1,15,陽信-石牌,2024-09-10,8711
2363,矽統,15,1,14,陽信-石牌,2024-09-10,8711
3645,達邁,14,0,14,陽信-石牌,2024-09-10,8711
4714,永捷,15,1,14,陽信-石牌,2024-09-10,8711
1301,台塑,13,0,13,陽信-石牌,2024-09-10,8711
1316,上曜,13,0,13,陽信-石牌,2024-09-10,8711
3189,景碩,19,6,13,陽信-石牌,2024-09-10,8711
3362,先進光,14,1,13,陽信-石牌,2024-09-10,8711
2543,皇昌,14,2,12,陽信-石牌,2024-09-10,8711
1605,華新,11,0,11,陽信-石牌,2024-09-10,8711
2101,南港,11,0,11,陽信-石牌,2024-09-10,8711
2303,聯電,12,1,11,陽信-石牌,2024-09-10,8711
00919,群益台灣精選高息,17,7,10,陽信-石牌,2024-09-10,8711
1570,力肯,10,0,10,陽信-石牌,2024-09-10,8711
1616,億泰,10,0,10,陽信-石牌,2024-09-10,8711
2365,昆盈,11,1,10,陽信-石牌,2024-09-10,8711
2538,基泰,10,0,10,陽信-石牌,2024-09-10,8711
2540,愛山林,20,10,10,陽信-石牌,2024-09-10,8711
0050,元大台灣50,377,0,377,陽信-石牌,2024-09-11,8711
00688L,國泰20年美債正2,301,15,286,陽信-石牌,2024-09-11,8711
00687B,國泰20年美債,155,7,148,陽信-石牌,2024-09-11,8711
4510,高鋒,60,6,54,陽信-石牌,2024-09-11,8711
00915,凱基優選高股息30,51,0,51,陽信-石牌,2024-09-11,8711
2891,中信金,41,0,41,陽信-石牌,2024-09-11,8711
3312,弘憶股,49,8,41,陽信-石牌,2024-09-11,8711
00957B,兆豐US優選投等債,30,0,30,陽信-石牌,2024-09-11,8711
2530,華建,29,0,29,陽信-石牌,2024-09-11,8711
3360,尚立,31,2,29,陽信-石牌,2024-09-11,8711
2845,遠東銀,28,0,28,陽信-石牌,2024-09-11,8711
00715L,期街口布蘭特正2,25,0,25,陽信-石牌,2024-09-11,8711
00929,復華台灣科技優息,23,0,23,陽信-石牌,2024-09-11,8711
00943,兆豐電子高息等權,22,0,22,陽信-石牌,2024-09-11,8711
0056,元大高股息,21,0,21,陽信-石牌,2024-09-11,8711
2885,元大金,21,0,21,陽信-石牌,2024-09-11,8711
2707,晶華,20,0,20,陽信-石牌,2024-09-11,8711
3202,樺晟,20,0,20,陽信-石牌,2024-09-11,8711
3511,矽瑪,20,0,20,陽信-石牌,2024-09-11,8711
00946,群益科技高息成長,17,0,17,陽信-石牌,2024-09-11,8711
00878,國泰永續高股息,22,5,17,陽信-石牌,2024-09-11,8711
00940,元大台灣價值高息,16,0,16,陽信-石牌,2024-09-11,8711
00931B,統一美債20年,186,170,16,陽信-石牌,2024-09-11,8711
4562,穎漢,19,3,16,陽信-石牌,2024-09-11,8711
00673R,期元大S＆P原油反1,15,0,15,陽信-石牌,2024-09-11,8711
00882,中信中國高股息,15,0,15,陽信-石牌,2024-09-11,8711
00919,群益台灣精選高息,21,7,14,陽信-石牌,2024-09-11,8711
1442,名軒,13,0,13,陽信-石牌,2024-09-11,8711
2745,五福,13,0,13,陽信-石牌,2024-09-11,8711
00918,大華優利高填息30,12,0,12,陽信-石牌,2024-09-11,8711
2323,中環,13,1,12,陽信-石牌,2024-09-11,8711
2367,燿華,17,5,12,陽信-石牌,2024-09-11,8711
3707,漢磊,25,13,12,陽信-石牌,2024-09-11,8711
1301,台塑,11,0,11,陽信-石牌,2024-09-11,8711
2356,英業達,16,5,11,陽信-石牌,2024-09-11,8711
2539,櫻花建,11,0,11,陽信-石牌,2024-09-11,8711
4930,燦星網,11,0,11,陽信-石牌,2024-09-11,8711
6279,胡連,11,0,11,陽信-石牌,2024-09-11,8711
2002,中鋼,10,0,10,陽信-石牌,2024-09-11,8711
00696B,富邦美債20年,10,0,10,陽信-石牌,2024-09-11,8711
1611,中電,10,0,10,陽信-石牌,2024-09-11,8711
1721,三晃,10,0,10,陽信-石牌,2024-09-11,8711
2542,興富發,85,75,10,陽信-石牌,2024-09-11,8711
2832,台產,10,0,10,陽信-石牌,2024-09-11,8711
4979,華星光,16,6,10,陽信-石牌,2024-09-11,8711
6177,達麗,10,0,10,陽信-石牌,2024-09-11,8711
00948B,中信優息投資級債,9,0,9,陽信-石牌,2024-09-11,8711
2834,臺企銀,9,0,9,陽信-石牌,2024-09-11,8711
3062,建漢,9,1,8,陽信-石牌,2024-09-11,8711
00952,凱基台灣AI50,8,0,8,陽信-石牌,2024-09-11,8711
00664R,國泰臺灣加權反1,53,0,53,陽信-石牌,2024-09-12,8711
00641R,富邦日本反1,50,0,50,陽信-石牌,2024-09-12,8711
2464,盟立,50,3,47,陽信-石牌,2024-09-12,8711
1815,富喬,60,18,42,陽信-石牌,2024-09-12,8711
00634R,富邦上証反1,50,10,40,陽信-石牌,2024-09-12,8711
00857B,永豐20年美公債,35,0,35,陽信-石牌,2024-09-12,8711
2405,輔信,31,0,31,陽信-石牌,2024-09-12,8711
2330,台積電,54,29,25,陽信-石牌,2024-09-12,8711
5443,均豪,57,34,23,陽信-石牌,2024-09-12,8711
00655L,國泰中國A50正2,20,0,20,陽信-石牌,2024-09-12,8711
2349,錸德,40,20,20,陽信-石牌,2024-09-12,8711
3521,鴻翊,20,0,20,陽信-石牌,2024-09-12,8711
00919,群益台灣精選高息,32,15,17,陽信-石牌,2024-09-12,8711
2356,英業達,26,9,17,陽信-石牌,2024-09-12,8711
8374,羅昇,25,8,17,陽信-石牌,2024-09-12,8711
8112,至上,16,0,16,陽信-石牌,2024-09-12,8711
00933B,國泰10Y+金融債,21,6,15,陽信-石牌,2024-09-12,8711
3303,岱稜,37,23,14,陽信-石牌,2024-09-12,8711
00679B,元大美債20年,23,10,13,陽信-石牌,2024-09-12,8711
00931B,統一美債20年,61,49,12,陽信-石牌,2024-09-12,8711
6269,台郡,11,0,11,陽信-石牌,2024-09-12,8711
6278,台表科,11,0,11,陽信-石牌,2024-09-12,8711
9921,巨大,11,0,11,陽信-石牌,2024-09-12,8711
0056,元大高股息,21,11,10,陽信-石牌,2024-09-12,8711
1605,華新,10,0,10,陽信-石牌,2024-09-12,8711
2314,台揚,10,0,10,陽信-石牌,2024-09-12,8711
2489,瑞軒,12,2,10,陽信-石牌,2024-09-12,8711
2832,台產,10,0,10,陽信-石牌,2024-09-12,8711
3049,精金,10,0,10,陽信-石牌,2024-09-12,8711
6113,亞矽,10,0,10,陽信-石牌,2024-09-12,8711
6541,泰福-KY,10,0,10,陽信-石牌,2024-09-12,8711
9934,成霖,10,0,10,陽信-石牌,2024-09-12,8711
4903,聯光通,10,1,9,陽信-石牌,2024-09-12,8711
6108,競國,40,31,9,陽信-石牌,2024-09-12,8711
9103,美德醫療-DR,10,1,9,陽信-石牌,2024-09-12,8711
2399,映泰,21,13,8,陽信-石牌,2024-09-12,8711
2382,廣達,20,12,8,陽信-石牌,2024-09-12,8711
2739,寒舍,8,0,8,陽信-石牌,2024-09-12,8711
6753,龍德造船,8,0,8,陽信-石牌,2024-09-12,8711
2540,愛山林,9,2,7,陽信-石牌,2024-09-12,8711
3062,建漢,6,0,6,陽信-石牌,2024-09-12,8711
3607,谷崧,11,5,6,陽信-石牌,2024-09-12,8711
3686,達能,6,0,6,陽信-石牌,2024-09-12,8711
4113,聯上,9,3,6,陽信-石牌,2024-09-12,8711
4909,新復興,12,6,6,陽信-石牌,2024-09-12,8711
4916,事欣科,7,1,6,陽信-石牌,2024-09-12,8711
4927,泰鼎-KY,6,0,6,陽信-石牌,2024-09-12,8711
4958,臻鼎-KY,7,1,6,陽信-石牌,2024-09-12,8711
00712,復華富時不動產,5,0,5,陽信-石牌,2024-09-12,8711
1709,和益,5,0,5,陽信-石牌,2024-09-12,8711
00929,復華台灣科技優息,168,15,153,陽信-石牌,2024-09-13,8711
00637L,元大滬深300正2,91,0,91,陽信-石牌,2024-09-13,8711
00687B,國泰20年美債,90,1,89,陽信-石牌,2024-09-13,8711
6152,百一,64,0,64,陽信-石牌,2024-09-13,8711
3663,鑫科,104,45,59,陽信-石牌,2024-09-13,8711
4157,太景*-KY,50,0,50,陽信-石牌,2024-09-13,8711
8935,邦泰,40,0,40,陽信-石牌,2024-09-13,8711
00857B,永豐20年美公債,35,0,35,陽信-石牌,2024-09-13,8711
6838,台新藥,25,1,24,陽信-石牌,2024-09-13,8711
6541,泰福-KY,26,4,22,陽信-石牌,2024-09-13,8711
00918,大華優利高填息30,20,0,20,陽信-石牌,2024-09-13,8711
8049,晶采,20,0,20,陽信-石牌,2024-09-13,8711
9105,泰金寶-DR,40,20,20,陽信-石牌,2024-09-13,8711
6405,悅城,22,7,15,陽信-石牌,2024-09-13,8711
3379,彬台,14,0,14,陽信-石牌,2024-09-13,8711
6274,台燿,20,6,14,陽信-石牌,2024-09-13,8711
8039,台虹,44,30,14,陽信-石牌,2024-09-13,8711
00937B,群益ESG投等債20,15,2,13,陽信-石牌,2024-09-13,8711
2881,富邦金,20,7,13,陽信-石牌,2024-09-13,8711
00931B,統一美債20年,12,0,12,陽信-石牌,2024-09-13,8711
5347,世界,13,2,11,陽信-石牌,2024-09-13,8711
00715L,期街口布蘭特正2,10,0,10,陽信-石牌,2024-09-13,8711
00679B,元大美債20年,10,0,10,陽信-石牌,2024-09-13,8711
00632R,元大台灣50反1,10,0,10,陽信-石牌,2024-09-13,8711
1711,永光,18,8,10,陽信-石牌,2024-09-13,8711
2402,毅嘉,11,1,10,陽信-石牌,2024-09-13,8711
2832,台產,10,0,10,陽信-石牌,2024-09-13,8711
3230,錦明,10,0,10,陽信-石牌,2024-09-13,8711
6234,高僑,10,0,10,陽信-石牌,2024-09-13,8711
6530,創威,22,12,10,陽信-石牌,2024-09-13,8711
1307,三芳,9,0,9,陽信-石牌,2024-09-13,8711
1305,華夏,10,1,9,陽信-石牌,2024-09-13,8711
1795,美時,9,0,9,陽信-石牌,2024-09-13,8711
1326,台化,21,13,8,陽信-石牌,2024-09-13,8711
2329,華泰,8,0,8,陽信-石牌,2024-09-13,8711
3707,漢磊,8,0,8,陽信-石牌,2024-09-13,8711
1101,台泥,8,1,7,陽信-石牌,2024-09-13,8711
1477,聚陽,7,0,7,陽信-石牌,2024-09-13,8711
2891,中信金,7,0,7,陽信-石牌,2024-09-13,8711
6443,元晶,12,5,7,陽信-石牌,2024-09-13,8711
6612,奈米醫材,7,0,7,陽信-石牌,2024-09-13,8711
9921,巨大,7,0,7,陽信-石牌,2024-09-13,8711
00633L,富邦上証正2,6,0,6,陽信-石牌,2024-09-13,8711
00878,國泰永續高股息,6,0,6,陽信-石牌,2024-09-13,8711
00957B,兆豐US優選投等債,6,0,6,陽信-石牌,2024-09-13,8711
1584,精剛,6,0,6,陽信-石牌,2024-09-13,8711
2070,精湛,16,10,6,陽信-石牌,2024-09-13,8711
2399,映泰,22,16,6,陽信-石牌,2024-09-13,8711
3374,精材,11,5,6,陽信-石牌,2024-09-13,8711
6442,光聖,7,1,6,陽信-石牌,2024-09-13,8711
00937B,群益ESG投等債20,207,0,207,陽信-石牌,2024-09-16,8711
00857B,永豐20年美公債,61,0,61,陽信-石牌,2024-09-16,8711
00637L,元大滬深300正2,60,0,60,陽信-石牌,2024-09-16,8711
9105,泰金寶-DR,50,5,45,陽信-石牌,2024-09-16,8711
00931B,統一美債20年,40,0,40,陽信-石牌,2024-09-16,8711
2349,錸德,46,8,38,陽信-石牌,2024-09-16,8711
2344,華邦電,26,0,26,陽信-石牌,2024-09-16,8711
8039,台虹,25,0,25,陽信-石牌,2024-09-16,8711
00919,群益台灣精選高息,25,1,24,陽信-石牌,2024-09-16,8711
6187,萬潤,37,16,21,陽信-石牌,2024-09-16,8711
00915,凱基優選高股息30,21,1,20,陽信-石牌,2024-09-16,8711
00878,國泰永續高股息,17,0,17,陽信-石牌,2024-09-16,8711
1309,台達化,15,0,15,陽信-石牌,2024-09-16,8711
2888,新光金,47,32,15,陽信-石牌,2024-09-16,8711
00929,復華台灣科技優息,14,1,13,陽信-石牌,2024-09-16,8711
6270,倍微,13,0,13,陽信-石牌,2024-09-16,8711
8255,朋程,12,0,12,陽信-石牌,2024-09-16,8711
3029,零壹,11,0,11,陽信-石牌,2024-09-16,8711
6706,惠特,28,17,11,陽信-石牌,2024-09-16,8711
8027,鈦昇,11,0,11,陽信-石牌,2024-09-16,8711
8099,大世科,11,0,11,陽信-石牌,2024-09-16,8711
6152,百一,15,5,10,陽信-石牌,2024-09-16,8711
1540,喬福,12,2,10,陽信-石牌,2024-09-16,8711
2324,仁寶,20,10,10,陽信-石牌,2024-09-16,8711
2832,台產,10,0,10,陽信-石牌,2024-09-16,8711
3002,歐格,10,0,10,陽信-石牌,2024-09-16,8711
3019,亞光,11,1,10,陽信-石牌,2024-09-16,8711
3033,威健,10,0,10,陽信-石牌,2024-09-16,8711
4927,泰鼎-KY,10,0,10,陽信-石牌,2024-09-16,8711
6108,競國,20,10,10,陽信-石牌,2024-09-16,8711
6216,居易,10,0,10,陽信-石牌,2024-09-16,8711
8201,無敵,10,0,10,陽信-石牌,2024-09-16,8711
2330,台積電,11,1,10,陽信-石牌,2024-09-16,8711
2884,玉山金,10,1,9,陽信-石牌,2024-09-16,8711
00918,大華優利高填息30,8,0,8,陽信-石牌,2024-09-16,8711
2201,裕隆,13,5,8,陽信-石牌,2024-09-16,8711
3189,景碩,9,1,8,陽信-石牌,2024-09-16,8711
1721,三晃,7,0,7,陽信-石牌,2024-09-16,8711
4743,合一,7,0,7,陽信-石牌,2024-09-16,8711
6244,茂迪,7,0,7,陽信-石牌,2024-09-16,8711
8076,伍豐,10,3,7,陽信-石牌,2024-09-16,8711
00687B,國泰20年美債,11,5,6,陽信-石牌,2024-09-16,8711
2337,旺宏,6,0,6,陽信-石牌,2024-09-16,8711
6274,台燿,13,7,6,陽信-石牌,2024-09-16,8711
00948B,中信優息投資級債,5,0,5,陽信-石牌,2024-09-16,8711
00680L,元大美債20正2,5,0,5,陽信-石牌,2024-09-16,8711
00679B,元大美債20年,10,5,5,陽信-石牌,2024-09-16,8711
3305,昇貿,5,0,5,陽信-石牌,2024-09-16,8711
3597,映興,5,0,5,陽信-石牌,2024-09-16,8711
4417,金洲,5,0,5,陽信-石牌,2024-09-16,8711
00929,復華台灣科技優息,158,1,157,陽信-石牌,2024-09-18,8711
00937B,群益ESG投等債20,154,5,149,陽信-石牌,2024-09-18,8711
00918,大華優利高填息30,92,0,92,陽信-石牌,2024-09-18,8711
00919,群益台灣精選高息,61,1,60,陽信-石牌,2024-09-18,8711
2374,佳能,60,5,55,陽信-石牌,2024-09-18,8711
00637L,元大滬深300正2,53,3,50,陽信-石牌,2024-09-18,8711
2317,鴻海,54,10,44,陽信-石牌,2024-09-18,8711
5905,南仁湖,59,21,38,陽信-石牌,2024-09-18,8711
3711,日月光投控,37,0,37,陽信-石牌,2024-09-18,8711
00915,凱基優選高股息30,37,3,34,陽信-石牌,2024-09-18,8711
2888,新光金,63,32,31,陽信-石牌,2024-09-18,8711
2344,華邦電,29,0,29,陽信-石牌,2024-09-18,8711
3607,谷崧,32,4,28,陽信-石牌,2024-09-18,8711
00878,國泰永續高股息,30,3,27,陽信-石牌,2024-09-18,8711
02001L,富邦蘋果正二N,22,0,22,陽信-石牌,2024-09-18,8711
00948B,中信優息投資級債,22,0,22,陽信-石牌,2024-09-18,8711
4958,臻鼎-KY,23,1,22,陽信-石牌,2024-09-18,8711
2887,台新金,30,8,22,陽信-石牌,2024-09-18,8711
2313,華通,29,8,21,陽信-石牌,2024-09-18,8711
0056,元大高股息,21,1,20,陽信-石牌,2024-09-18,8711
2881,富邦金,20,3,17,陽信-石牌,2024-09-18,8711
00713,元大台灣高息低波,17,0,17,陽信-石牌,2024-09-18,8711
8039,台虹,20,4,16,陽信-石牌,2024-09-18,8711
2330,台積電,17,1,16,陽信-石牌,2024-09-18,8711
3484,崧騰,15,0,15,陽信-石牌,2024-09-18,8711
3033,威健,22,7,15,陽信-石牌,2024-09-18,8711
1785,光洋科,109,95,14,陽信-石牌,2024-09-18,8711
1905,華紙,13,0,13,陽信-石牌,2024-09-18,8711
2349,錸德,27,15,12,陽信-石牌,2024-09-18,8711
3294,英濟,12,0,12,陽信-石牌,2024-09-18,8711
4561,健椿,15,3,12,陽信-石牌,2024-09-18,8711
3062,建漢,47,36,11,陽信-石牌,2024-09-18,8711
6443,元晶,11,0,11,陽信-石牌,2024-09-18,8711
00940,元大台灣價值高息,10,0,10,陽信-石牌,2024-09-18,8711
00632R,元大台灣50反1,10,0,10,陽信-石牌,2024-09-18,8711
1515,力山,10,0,10,陽信-石牌,2024-09-18,8711
2208,台船,10,0,10,陽信-石牌,2024-09-18,8711
2323,中環,10,0,10,陽信-石牌,2024-09-18,8711
3041,揚智,10,0,10,陽信-石牌,2024-09-18,8711
3605,宏致,16,6,10,陽信-石牌,2024-09-18,8711
4113,聯上,10,0,10,陽信-石牌,2024-09-18,8711
5483,中美晶,10,0,10,陽信-石牌,2024-09-18,8711
8088,品安,10,0,10,陽信-石牌,2024-09-18,8711
2736,富野,9,0,9,陽信-石牌,2024-09-18,8711
5493,三聯,10,1,9,陽信-石牌,2024-09-18,8711
2382,廣達,8,0,8,陽信-石牌,2024-09-18,8711
6530,創威,30,22,8,陽信-石牌,2024-09-18,8711
00687B,國泰20年美債,7,0,7,陽信-石牌,2024-09-18,8711
1301,台塑,9,2,7,陽信-石牌,2024-09-18,8711
2542,興富發,15,8,7,陽信-石牌,2024-09-18,8711
00679B,元大美債20年,151,1,150,陽信-石牌,2024-09-19,8711
00715L,期街口布蘭特正2,78,0,78,陽信-石牌,2024-09-19,8711
00857B,永豐20年美公債,70,5,65,陽信-石牌,2024-09-19,8711
00919,群益台灣精選高息,67,5,62,陽信-石牌,2024-09-19,8711
00637L,元大滬深300正2,60,0,60,陽信-石牌,2024-09-19,8711
00958B,永豐ESG銀行債15,59,0,59,陽信-石牌,2024-09-19,8711
00706L,期元大S＆P日圓正2,45,0,45,陽信-石牌,2024-09-19,8711
2891,中信金,44,1,43,陽信-石牌,2024-09-19,8711
4157,太景*-KY,40,0,40,陽信-石牌,2024-09-19,8711
00937B,群益ESG投等債20,39,3,36,陽信-石牌,2024-09-19,8711
00651R,復華香港反1,50,20,30,陽信-石牌,2024-09-19,8711
1718,中纖,30,0,30,陽信-石牌,2024-09-19,8711
2497,怡利電,50,23,27,陽信-石牌,2024-09-19,8711
3363,上詮,56,29,27,陽信-石牌,2024-09-19,8711
00929,復華台灣科技優息,39,13,26,陽信-石牌,2024-09-19,8711
00680L,元大美債20正2,25,0,25,陽信-石牌,2024-09-19,8711
2889,國票金,30,5,25,陽信-石牌,2024-09-19,8711
2399,映泰,61,36,25,陽信-石牌,2024-09-19,8711
3711,日月光投控,22,0,22,陽信-石牌,2024-09-19,8711
8374,羅昇,24,5,19,陽信-石牌,2024-09-19,8711
2881,富邦金,21,5,16,陽信-石牌,2024-09-19,8711
3048,益登,16,0,16,陽信-石牌,2024-09-19,8711
6288,聯嘉,18,2,16,陽信-石牌,2024-09-19,8711
8011,台通,21,5,16,陽信-石牌,2024-09-19,8711
00687B,國泰20年美債,15,0,15,陽信-石牌,2024-09-19,8711
3062,建漢,125,111,14,陽信-石牌,2024-09-19,8711
2851,中再保,13,0,13,陽信-石牌,2024-09-19,8711
00948B,中信優息投資級債,12,0,12,陽信-石牌,2024-09-19,8711
00915,凱基優選高股息30,11,0,11,陽信-石牌,2024-09-19,8711
2610,華航,15,4,11,陽信-石牌,2024-09-19,8711
3037,欣興,25,14,11,陽信-石牌,2024-09-19,8711
4977,眾達-KY,20,9,11,陽信-石牌,2024-09-19,8711
5263,智崴,18,7,11,陽信-石牌,2024-09-19,8711
5443,均豪,65,54,11,陽信-石牌,2024-09-19,8711
1455,集盛,10,0,10,陽信-石牌,2024-09-19,8711
1517,利奇,10,0,10,陽信-石牌,2024-09-19,8711
1522,堤維西,10,0,10,陽信-石牌,2024-09-19,8711
1528,恩德,10,0,10,陽信-石牌,2024-09-19,8711
2025,千興,10,0,10,陽信-石牌,2024-09-19,8711
3494,誠研,10,0,10,陽信-石牌,2024-09-19,8711
3673,TPK-KY,10,0,10,陽信-石牌,2024-09-19,8711
3686,達能,10,0,10,陽信-石牌,2024-09-19,8711
9904,寶成,10,0,10,陽信-石牌,2024-09-19,8711
00751B,元大AAA至A公司債,9,0,9,陽信-石牌,2024-09-19,8711
1785,光洋科,45,36,9,陽信-石牌,2024-09-19,8711
3230,錦明,12,3,9,陽信-石牌,2024-09-19,8711
4916,事欣科,17,8,9,陽信-石牌,2024-09-19,8711
2349,錸德,11,3,8,陽信-石牌,2024-09-19,8711
2464,盟立,35,27,8,陽信-石牌,2024-09-19,8711
3211,順達,8,0,8,陽信-石牌,2024-09-19,8711
2504,國產,121,0,121,陽信-石牌,2024-09-20,8711
3360,尚立,115,2,113,陽信-石牌,2024-09-20,8711
2542,興富發,88,34,54,陽信-石牌,2024-09-20,8711
2101,南港,58,5,53,陽信-石牌,2024-09-20,8711
00940,元大台灣價值高息,50,0,50,陽信-石牌,2024-09-20,8711
3711,日月光投控,42,0,42,陽信-石牌,2024-09-20,8711
00919,群益台灣精選高息,159,120,39,陽信-石牌,2024-09-20,8711
1517,利奇,35,0,35,陽信-石牌,2024-09-20,8711
00632R,元大台灣50反1,33,0,33,陽信-石牌,2024-09-20,8711
2888,新光金,44,11,33,陽信-石牌,2024-09-20,8711
3049,精金,41,8,33,陽信-石牌,2024-09-20,8711
5905,南仁湖,38,7,31,陽信-石牌,2024-09-20,8711
00651R,復華香港反1,30,0,30,陽信-石牌,2024-09-20,8711
2405,輔信,32,2,30,陽信-石牌,2024-09-20,8711
2530,華建,30,0,30,陽信-石牌,2024-09-20,8711
5475,德宏,30,0,30,陽信-石牌,2024-09-20,8711
02001L,富邦蘋果正二N,26,0,26,陽信-石牌,2024-09-20,8711
1711,永光,136,111,25,陽信-石牌,2024-09-20,8711
6425,易發,29,5,24,陽信-石牌,2024-09-20,8711
8011,台通,23,0,23,陽信-石牌,2024-09-20,8711
00931B,統一美債20年,20,0,20,陽信-石牌,2024-09-20,8711
2509,全坤建,20,0,20,陽信-石牌,2024-09-20,8711
2867,三商壽,29,10,19,陽信-石牌,2024-09-20,8711
6530,創威,21,2,19,陽信-石牌,2024-09-20,8711
1785,光洋科,41,24,17,陽信-石牌,2024-09-20,8711
6177,達麗,17,0,17,陽信-石牌,2024-09-20,8711
3430,奇鈦科,17,1,16,陽信-石牌,2024-09-20,8711
4958,臻鼎-KY,16,0,16,陽信-石牌,2024-09-20,8711
3374,精材,22,7,15,陽信-石牌,2024-09-20,8711
2439,美律,15,0,15,陽信-石牌,2024-09-20,8711
8085,福華,15,0,15,陽信-石牌,2024-09-20,8711
00915,凱基優選高股息30,12,0,12,陽信-石牌,2024-09-20,8711
1721,三晃,29,17,12,陽信-石牌,2024-09-20,8711
2344,華邦電,12,0,12,陽信-石牌,2024-09-20,8711
2889,國票金,12,0,12,陽信-石牌,2024-09-20,8711
00878,國泰永續高股息,13,2,11,陽信-石牌,2024-09-20,8711
2316,楠梓電,11,0,11,陽信-石牌,2024-09-20,8711
3290,東浦,11,0,11,陽信-石牌,2024-09-20,8711
3673,TPK-KY,11,0,11,陽信-石牌,2024-09-20,8711
9105,泰金寶-DR,52,41,11,陽信-石牌,2024-09-20,8711
1316,上曜,10,0,10,陽信-石牌,2024-09-20,8711
1522,堤維西,10,0,10,陽信-石牌,2024-09-20,8711
2457,飛宏,10,0,10,陽信-石牌,2024-09-20,8711
2913,農林,10,0,10,陽信-石牌,2024-09-20,8711
3188,鑫龍騰,10,0,10,陽信-石牌,2024-09-20,8711
4109,加捷生醫,10,0,10,陽信-石牌,2024-09-20,8711
6216,居易,10,0,10,陽信-石牌,2024-09-20,8711
2356,英業達,12,3,9,陽信-石牌,2024-09-20,8711
4561,健椿,10,1,9,陽信-石牌,2024-09-20,8711
5202,力新,10,1,9,陽信-石牌,2024-09-20,8711
00937B,群益ESG投等債20,425,223,202,陽信-石牌,2024-09-23,8711
2888,新光金,159,86,73,陽信-石牌,2024-09-23,8711
00929,復華台灣科技優息,58,3,55,陽信-石牌,2024-09-23,8711
3715,定穎投控,63,17,46,陽信-石牌,2024-09-23,8711
4157,太景*-KY,40,0,40,陽信-石牌,2024-09-23,8711
2313,華通,39,2,37,陽信-石牌,2024-09-23,8711
1714,和桐,31,0,31,陽信-石牌,2024-09-23,8711
2884,玉山金,42,12,30,陽信-石牌,2024-09-23,8711
2637,慧洋-KY,30,0,30,陽信-石牌,2024-09-23,8711
6763,綠界科技*,30,0,30,陽信-石牌,2024-09-23,8711
00958B,永豐ESG銀行債15,25,0,25,陽信-石牌,2024-09-23,8711
1336,台翰,24,1,23,陽信-石牌,2024-09-23,8711
1727,中華化,39,18,21,陽信-石牌,2024-09-23,8711
3049,精金,21,0,21,陽信-石牌,2024-09-23,8711
3498,陽程,26,5,21,陽信-石牌,2024-09-23,8711
2409,友達,20,0,20,陽信-石牌,2024-09-23,8711
5475,德宏,20,0,20,陽信-石牌,2024-09-23,8711
2881,富邦金,24,8,16,陽信-石牌,2024-09-23,8711
3711,日月光投控,20,4,16,陽信-石牌,2024-09-23,8711
2069,運錩,15,0,15,陽信-石牌,2024-09-23,8711
2349,錸德,17,2,15,陽信-石牌,2024-09-23,8711
2538,基泰,15,0,15,陽信-石牌,2024-09-23,8711
6241,易通展,15,0,15,陽信-石牌,2024-09-23,8711
1785,光洋科,22,9,13,陽信-石牌,2024-09-23,8711
00715L,期街口布蘭特正2,12,0,12,陽信-石牌,2024-09-23,8711
6152,百一,22,10,12,陽信-石牌,2024-09-23,8711
1708,東鹼,11,0,11,陽信-石牌,2024-09-23,8711
00945B,凱基美國非投等債,10,0,10,陽信-石牌,2024-09-23,8711
00664R,國泰臺灣加權反1,10,0,10,陽信-石牌,2024-09-23,8711
00706L,期元大S＆P日圓正2,10,0,10,陽信-石牌,2024-09-23,8711
3094,聯傑,10,0,10,陽信-石牌,2024-09-23,8711
3303,岱稜,11,1,10,陽信-石牌,2024-09-23,8711
6113,亞矽,10,0,10,陽信-石牌,2024-09-23,8711
6117,迎廣,16,6,10,陽信-石牌,2024-09-23,8711
00795B,中信美國公債20年,10,1,9,陽信-石牌,2024-09-23,8711
3673,TPK-KY,10,1,9,陽信-石牌,2024-09-23,8711
00688L,國泰20年美債正2,12,4,8,陽信-石牌,2024-09-23,8711
2405,輔信,8,0,8,陽信-石牌,2024-09-23,8711
6691,洋基工程,8,0,8,陽信-石牌,2024-09-23,8711
8927,北基,18,10,8,陽信-石牌,2024-09-23,8711
0056,元大高股息,7,0,7,陽信-石牌,2024-09-23,8711
00687B,國泰20年美債,10,3,7,陽信-石牌,2024-09-23,8711
2610,華航,7,0,7,陽信-石牌,2024-09-23,8711
00915,凱基優選高股息30,8,2,6,陽信-石牌,2024-09-23,8711
00673R,期元大S＆P原油反1,6,0,6,陽信-石牌,2024-09-23,8711
2002,中鋼,6,0,6,陽信-石牌,2024-09-23,8711
2426,鼎元,11,5,6,陽信-石牌,2024-09-23,8711
2464,盟立,14,8,6,陽信-石牌,2024-09-23,8711
5243,乙盛-KY,6,0,6,陽信-石牌,2024-09-23,8711
6446,藥華藥,7,1,6,陽信-石牌,2024-09-23,8711
00632R,元大台灣50反1,254,10,244,陽信-石牌,2024-09-24,8711
00937B,群益ESG投等債20,163,56,107,陽信-石牌,2024-09-24,8711
00878,國泰永續高股息,95,7,88,陽信-石牌,2024-09-24,8711
00919,群益台灣精選高息,76,5,71,陽信-石牌,2024-09-24,8711
0056,元大高股息,55,0,55,陽信-石牌,2024-09-24,8711
2834,臺企銀,51,0,51,陽信-石牌,2024-09-24,8711
00680L,元大美債20正2,35,0,35,陽信-石牌,2024-09-24,8711
2891,中信金,37,4,33,陽信-石牌,2024-09-24,8711
6257,矽格,44,11,33,陽信-石牌,2024-09-24,8711
00929,復華台灣科技優息,30,0,30,陽信-石牌,2024-09-24,8711
1718,中纖,30,0,30,陽信-石牌,2024-09-24,8711
2888,新光金,33,3,30,陽信-石牌,2024-09-24,8711
3013,晟銘電,57,32,25,陽信-石牌,2024-09-24,8711
00922,國泰台灣領袖50,23,0,23,陽信-石牌,2024-09-24,8711
3711,日月光投控,25,3,22,陽信-石牌,2024-09-24,8711
3605,宏致,44,23,21,陽信-石牌,2024-09-24,8711
00651R,復華香港反1,20,0,20,陽信-石牌,2024-09-24,8711
00945B,凱基美國非投等債,20,0,20,陽信-石牌,2024-09-24,8711
5608,四維航,20,0,20,陽信-石牌,2024-09-24,8711
2455,全新,30,11,19,陽信-石牌,2024-09-24,8711
00948B,中信優息投資級債,17,0,17,陽信-石牌,2024-09-24,8711
2405,輔信,20,3,17,陽信-石牌,2024-09-24,8711
3062,建漢,45,28,17,陽信-石牌,2024-09-24,8711
3450,聯鈞,30,13,17,陽信-石牌,2024-09-24,8711
00679B,元大美債20年,19,5,14,陽信-石牌,2024-09-24,8711
1539,巨庭,15,1,14,陽信-石牌,2024-09-24,8711
1524,耿鼎,16,3,13,陽信-石牌,2024-09-24,8711
2313,華通,50,37,13,陽信-石牌,2024-09-24,8711
2464,盟立,23,10,13,陽信-石牌,2024-09-24,8711
8080,印鉐,13,0,13,陽信-石牌,2024-09-24,8711
00940,元大台灣價值高息,12,0,12,陽信-石牌,2024-09-24,8711
4157,太景*-KY,12,0,12,陽信-石牌,2024-09-24,8711
5531,鄉林,14,2,12,陽信-石牌,2024-09-24,8711
1446,宏和,11,0,11,陽信-石牌,2024-09-24,8711
3481,群創,12,1,11,陽信-石牌,2024-09-24,8711
5905,南仁湖,17,6,11,陽信-石牌,2024-09-24,8711
6451,訊芯-KY,13,2,11,陽信-石牌,2024-09-24,8711
6517,保勝光學,13,2,11,陽信-石牌,2024-09-24,8711
6830,汎銓,11,0,11,陽信-石牌,2024-09-24,8711
1617,榮星,10,0,10,陽信-石牌,2024-09-24,8711
2390,云辰,10,0,10,陽信-石牌,2024-09-24,8711
2444,兆勁,10,0,10,陽信-石牌,2024-09-24,8711
2610,華航,30,20,10,陽信-石牌,2024-09-24,8711
2887,台新金,10,0,10,陽信-石牌,2024-09-24,8711
3037,欣興,20,10,10,陽信-石牌,2024-09-24,8711
3363,上詮,11,1,10,陽信-石牌,2024-09-24,8711
3685,元創精密,10,0,10,陽信-石牌,2024-09-24,8711
3686,達能,10,0,10,陽信-石牌,2024-09-24,8711
4729,熒茂,34,24,10,陽信-石牌,2024-09-24,8711
6164,華興,10,0,10,陽信-石牌,2024-09-24,8711
00679B,元大美債20年,206,7,199,陽信-石牌,2024-09-25,8711
0056,元大高股息,111,8,103,陽信-石牌,2024-09-25,8711
00931B,統一美債20年,53,0,53,陽信-石牌,2024-09-25,8711
5608,四維航,50,0,50,陽信-石牌,2024-09-25,8711
1447,力鵬,40,0,40,陽信-石牌,2024-09-25,8711
5425,台半,40,1,39,陽信-石牌,2024-09-25,8711
2609,陽明,122,85,37,陽信-石牌,2024-09-25,8711
3550,聯穎,72,36,36,陽信-石牌,2024-09-25,8711
00687B,國泰20年美債,31,1,30,陽信-石牌,2024-09-25,8711
00960,野村全球航運龍頭,30,0,30,陽信-石牌,2024-09-25,8711
1711,永光,132,105,27,陽信-石牌,2024-09-25,8711
3360,尚立,24,2,22,陽信-石牌,2024-09-25,8711
2882,國泰金,61,39,22,陽信-石牌,2024-09-25,8711
00945B,凱基美國非投等債,20,0,20,陽信-石牌,2024-09-25,8711
00713,元大台灣高息低波,20,0,20,陽信-石牌,2024-09-25,8711
4729,熒茂,20,0,20,陽信-石牌,2024-09-25,8711
6199,天品,20,0,20,陽信-石牌,2024-09-25,8711
2415,錩新,20,2,18,陽信-石牌,2024-09-25,8711
2881,富邦金,21,3,18,陽信-石牌,2024-09-25,8711
2365,昆盈,26,9,17,陽信-石牌,2024-09-25,8711
4903,聯光通,36,19,17,陽信-石牌,2024-09-25,8711
2408,南亞科,16,2,14,陽信-石牌,2024-09-25,8711
3149,正達,14,1,13,陽信-石牌,2024-09-25,8711
1815,富喬,12,0,12,陽信-石牌,2024-09-25,8711
3363,上詮,24,12,12,陽信-石牌,2024-09-25,8711
3710,連展投控,12,0,12,陽信-石牌,2024-09-25,8711
3481,群創,13,2,11,陽信-石牌,2024-09-25,8711
00795B,中信美國公債20年,11,0,11,陽信-石牌,2024-09-25,8711
2605,新興,111,100,11,陽信-石牌,2024-09-25,8711
2618,長榮航,13,2,11,陽信-石牌,2024-09-25,8711
4510,高鋒,16,5,11,陽信-石牌,2024-09-25,8711
00673R,期元大S＆P原油反1,10,0,10,陽信-石牌,2024-09-25,8711
00720B,元大投資級公司債,10,0,10,陽信-石牌,2024-09-25,8711
00933B,國泰10Y+金融債,10,0,10,陽信-石牌,2024-09-25,8711
1514,亞力,10,0,10,陽信-石牌,2024-09-25,8711
2014,中鴻,10,0,10,陽信-石牌,2024-09-25,8711
2331,精英,10,0,10,陽信-石牌,2024-09-25,8711
2892,第一金,10,0,10,陽信-石牌,2024-09-25,8711
5498,凱崴,10,0,10,陽信-石牌,2024-09-25,8711
6739,竹陞科技,10,0,10,陽信-石牌,2024-09-25,8711
8240,華宏,10,0,10,陽信-石牌,2024-09-25,8711
2399,映泰,33,24,9,陽信-石牌,2024-09-25,8711
3227,原相,12,3,9,陽信-石牌,2024-09-25,8711
8070,長華*,19,10,9,陽信-石牌,2024-09-25,8711
8111,立��,20,11,9,陽信-石牌,2024-09-25,8711
1316,上曜,19,11,8,陽信-石牌,2024-09-25,8711
2402,毅嘉,10,2,8,陽信-石牌,2024-09-25,8711
2436,偉詮電,19,11,8,陽信-石牌,2024-09-25,8711
2497,怡利電,17,9,8,陽信-石牌,2024-09-25,8711
4979,華星光,20,12,8,陽信-石牌,2024-09-25,8711
00687B,國泰20年美債,341,55,286,陽信-石牌,2024-09-26,8711
00680L,元大美債20正2,185,0,185,陽信-石牌,2024-09-26,8711
2609,陽明,320,203,117,陽信-石牌,2024-09-26,8711
2344,華邦電,77,4,73,陽信-石牌,2024-09-26,8711
00632R,元大台灣50反1,70,0,70,陽信-石牌,2024-09-26,8711
00679B,元大美債20年,67,0,67,陽信-石牌,2024-09-26,8711
9105,泰金寶-DR,79,15,64,陽信-石牌,2024-09-26,8711
2610,華航,72,10,62,陽信-石牌,2024-09-26,8711
00673R,期元大S＆P原油反1,68,10,58,陽信-石牌,2024-09-26,8711
2312,金寶,86,31,55,陽信-石牌,2024-09-26,8711
2371,大同,64,14,50,陽信-石牌,2024-09-26,8711
00712,復華富時不動產,49,0,49,陽信-石牌,2024-09-26,8711
3019,亞光,41,4,37,陽信-石牌,2024-09-26,8711
2415,錩新,30,1,29,陽信-石牌,2024-09-26,8711
6451,訊芯-KY,32,9,23,陽信-石牌,2024-09-26,8711
1815,富喬,23,0,23,陽信-石牌,2024-09-26,8711
2436,偉詮電,32,10,22,陽信-石牌,2024-09-26,8711
3006,晶豪科,22,0,22,陽信-石牌,2024-09-26,8711
6869,雲豹能源,22,0,22,陽信-石牌,2024-09-26,8711
00945B,凱基美國非投等債,20,0,20,陽信-石牌,2024-09-26,8711
00655L,國泰中國A50正2,20,0,20,陽信-石牌,2024-09-26,8711
3673,TPK-KY,21,1,20,陽信-石牌,2024-09-26,8711
8110,華東,22,2,20,陽信-石牌,2024-09-26,8711
2359,所羅門,19,0,19,陽信-石牌,2024-09-26,8711
6197,佳必琪,20,2,18,陽信-石牌,2024-09-26,8711
6188,廣明,19,3,16,陽信-石牌,2024-09-26,8711
4526,東台,25,9,16,陽信-石牌,2024-09-26,8711
2408,南亞科,30,15,15,陽信-石牌,2024-09-26,8711
4916,事欣科,16,1,15,陽信-石牌,2024-09-26,8711
4903,聯光通,39,25,14,陽信-石牌,2024-09-26,8711
2405,輔信,30,17,13,陽信-石牌,2024-09-26,8711
6603,富強鑫,13,0,13,陽信-石牌,2024-09-26,8711
3711,日月光投控,14,2,12,陽信-石牌,2024-09-26,8711
00706L,期元大S＆P日圓正2,15,3,12,陽信-石牌,2024-09-26,8711
4743,合一,12,0,12,陽信-石牌,2024-09-26,8711
8076,伍豐,15,3,12,陽信-石牌,2024-09-26,8711
00915,凱基優選高股息30,11,0,11,陽信-石牌,2024-09-26,8711
2313,華通,11,0,11,陽信-石牌,2024-09-26,8711
2355,敬鵬,11,0,11,陽信-石牌,2024-09-26,8711
2613,中櫃,11,0,11,陽信-石牌,2024-09-26,8711
3714,富采,13,2,11,陽信-石牌,2024-09-26,8711
4534,慶騰,11,0,11,陽信-石牌,2024-09-26,8711
2324,仁寶,14,4,10,陽信-石牌,2024-09-26,8711
00669R,國泰美國道瓊反1,10,0,10,陽信-石牌,2024-09-26,8711
020034,元大IC設計N,10,0,10,陽信-石牌,2024-09-26,8711
3535,晶彩科,10,0,10,陽信-石牌,2024-09-26,8711
4157,太景*-KY,10,0,10,陽信-石牌,2024-09-26,8711
2618,長榮航,10,1,9,陽信-石牌,2024-09-26,8711
6108,競國,8,0,8,陽信-石牌,2024-09-26,8711
00918,大華優利高填息30,10,2,8,陽信-石牌,2024-09-26,8711
00715L,期街口布蘭特正2,133,10,123,陽信-石牌,2024-09-27,8711
1611,中電,100,0,100,陽信-石牌,2024-09-27,8711
2323,中環,100,10,90,陽信-石牌,2024-09-27,8711
00712,復華富時不動產,82,0,82,陽信-石牌,2024-09-27,8711
00655L,國泰中國A50正2,100,20,80,陽信-石牌,2024-09-27,8711
00931B,統一美債20年,72,0,72,陽信-石牌,2024-09-27,8711
2897,王道銀行,50,1,49,陽信-石牌,2024-09-27,8711
00687B,國泰20年美債,42,0,42,陽信-石牌,2024-09-27,8711
00933B,國泰10Y+金融債,40,0,40,陽信-石牌,2024-09-27,8711
1717,長興,40,2,38,陽信-石牌,2024-09-27,8711
8249,菱光,35,0,35,陽信-石牌,2024-09-27,8711
6108,競國,31,0,31,陽信-石牌,2024-09-27,8711
00945B,凱基美國非投等債,30,0,30,陽信-石牌,2024-09-27,8711
00650L,復華香港正2,48,18,30,陽信-石牌,2024-09-27,8711
2617,台航,30,0,30,陽信-石牌,2024-09-27,8711
4157,太景*-KY,30,0,30,陽信-石牌,2024-09-27,8711
00679B,元大美債20年,29,0,29,陽信-石牌,2024-09-27,8711
2609,陽明,79,51,28,陽信-石牌,2024-09-27,8711
2415,錩新,26,0,26,陽信-石牌,2024-09-27,8711
9958,世紀鋼,36,11,25,陽信-石牌,2024-09-27,8711
1305,華夏,25,2,23,陽信-石牌,2024-09-27,8711
2630,亞航,20,0,20,陽信-石牌,2024-09-27,8711
2888,新光金,20,0,20,陽信-石牌,2024-09-27,8711
2601,益航,19,0,19,陽信-石牌,2024-09-27,8711
3450,聯鈞,30,12,18,陽信-石牌,2024-09-27,8711
9105,泰金寶-DR,39,21,18,陽信-石牌,2024-09-27,8711
2891,中信金,21,4,17,陽信-石牌,2024-09-27,8711
3711,日月光投控,27,11,16,陽信-石牌,2024-09-27,8711
00937B,群益ESG投等債20,95,80,15,陽信-石牌,2024-09-27,8711
8473,山林水,15,0,15,陽信-石牌,2024-09-27,8711
00948B,中信優息投資級債,14,0,14,陽信-石牌,2024-09-27,8711
1802,台玻,15,1,14,陽信-石牌,2024-09-27,8711
2201,裕隆,14,0,14,陽信-石牌,2024-09-27,8711
2371,大同,20,6,14,陽信-石牌,2024-09-27,8711
5905,南仁湖,14,0,14,陽信-石牌,2024-09-27,8711
2313,華通,41,30,11,陽信-石牌,2024-09-27,8711
2886,兆豐金,11,0,11,陽信-石牌,2024-09-27,8711
4729,熒茂,41,30,11,陽信-石牌,2024-09-27,8711
2032,新鋼,10,0,10,陽信-石牌,2024-09-27,8711
2243,宏旭-KY,10,0,10,陽信-石牌,2024-09-27,8711
2340,台亞,10,0,10,陽信-石牌,2024-09-27,8711
2444,兆勁,10,0,10,陽信-石牌,2024-09-27,8711
2542,興富發,10,0,10,陽信-石牌,2024-09-27,8711
2880,華南金,10,0,10,陽信-石牌,2024-09-27,8711
6241,易通展,10,0,10,陽信-石牌,2024-09-27,8711
4903,聯光通,25,15,10,陽信-石牌,2024-09-27,8711
1308,亞聚,10,1,9,陽信-石牌,2024-09-27,8711
1517,利奇,10,1,9,陽信-石牌,2024-09-27,8711
2388,威盛,18,9,9,陽信-石牌,2024-09-27,8711
2436,偉詮電,9,0,9,陽信-石牌,2024-09-27,8711
00632R,元大台灣50反1,1019,49,970,陽信-石牌,2024-09-30,8711
00929,復華台灣科技優息,263,66,197,陽信-石牌,2024-09-30,8711
2605,新興,174,7,167,陽信-石牌,2024-09-30,8711
00919,群益台灣精選高息,125,0,125,陽信-石牌,2024-09-30,8711
00687B,國泰20年美債,108,8,100,陽信-石牌,2024-09-30,8711
00943,兆豐電子高息等權,92,0,92,陽信-石牌,2024-09-30,8711
00655L,國泰中國A50正2,80,0,80,陽信-石牌,2024-09-30,8711
2022,聚亨,71,14,57,陽信-石牌,2024-09-30,8711
00680L,元大美債20正2,53,0,53,陽信-石牌,2024-09-30,8711
0056,元大高股息,50,0,50,陽信-石牌,2024-09-30,8711
2888,新光金,51,1,50,陽信-石牌,2024-09-30,8711
6609,瀧澤科,53,4,49,陽信-石牌,2024-09-30,8711
00650L,復華香港正2,46,0,46,陽信-石牌,2024-09-30,8711
2330,台積電,46,1,45,陽信-石牌,2024-09-30,8711
02001L,富邦蘋果正二N,32,0,32,陽信-石牌,2024-09-30,8711
2606,裕民,44,13,31,陽信-石牌,2024-09-30,8711
2615,萬海,72,42,30,陽信-石牌,2024-09-30,8711
00753L,中信中國50正2,49,22,27,陽信-石牌,2024-09-30,8711
2014,中鴻,100,75,25,陽信-石牌,2024-09-30,8711
2028,威致,23,0,23,陽信-石牌,2024-09-30,8711
6257,矽格,20,0,20,陽信-石牌,2024-09-30,8711
912000,晨訊科-DR,20,0,20,陽信-石牌,2024-09-30,8711
2610,華航,21,2,19,陽信-石牌,2024-09-30,8711
1717,長興,28,10,18,陽信-石牌,2024-09-30,8711
00679B,元大美債20年,22,5,17,陽信-石牌,2024-09-30,8711
1517,利奇,17,0,17,陽信-石牌,2024-09-30,8711
2637,慧洋-KY,89,72,17,陽信-石牌,2024-09-30,8711
2353,宏��,16,0,16,陽信-石牌,2024-09-30,8711
00685L,群益臺灣加權正2,15,0,15,陽信-石牌,2024-09-30,8711
1605,華新,15,0,15,陽信-石牌,2024-09-30,8711
1905,華紙,15,0,15,陽信-石牌,2024-09-30,8711
2007,燁興,18,3,15,陽信-石牌,2024-09-30,8711
2038,海光,15,0,15,陽信-石牌,2024-09-30,8711
5398,慕康生醫,15,0,15,陽信-石牌,2024-09-30,8711
9939,宏全,15,0,15,陽信-石牌,2024-09-30,8711
00878,國泰永續高股息,14,0,14,陽信-石牌,2024-09-30,8711
2313,華通,15,2,13,陽信-石牌,2024-09-30,8711
00918,大華優利高填息30,13,0,13,陽信-石牌,2024-09-30,8711
2880,華南金,13,0,13,陽信-石牌,2024-09-30,8711
3231,緯創,15,2,13,陽信-石牌,2024-09-30,8711
3673,TPK-KY,13,0,13,陽信-石牌,2024-09-30,8711
00692,富邦公司治理,12,0,12,陽信-石牌,2024-09-30,8711
3037,欣興,12,0,12,陽信-石牌,2024-09-30,8711
2317,鴻海,38,27,11,陽信-石牌,2024-09-30,8711
1795,美時,11,0,11,陽信-石牌,2024-09-30,8711
1802,台玻,15,4,11,陽信-石牌,2024-09-30,8711
00935,野村臺灣新科技50,10,0,10,陽信-石牌,2024-09-30,8711
006205,富邦上証,10,0,10,陽信-石牌,2024-09-30,8711
00665L,富邦�琤肭磪囓�2,26,16,10,陽信-石牌,2024-09-30,8711
1309,台達化,41,31,10,陽信-石牌,2024-09-30,8711
00632R,元大台灣50反1,501,0,501,陽信-石牌,2024-10-01,8711
00688L,國泰20年美債正2,505,55,450,陽信-石牌,2024-10-01,8711
00937B,群益ESG投等債20,467,17,450,陽信-石牌,2024-10-01,8711
2801,彰銀,109,0,109,陽信-石牌,2024-10-01,8711
00922,國泰台灣領袖50,102,0,102,陽信-石牌,2024-10-01,8711
00715L,期街口布蘭特正2,91,12,79,陽信-石牌,2024-10-01,8711
00929,復華台灣科技優息,102,45,57,陽信-石牌,2024-10-01,8711
2344,華邦電,47,0,47,陽信-石牌,2024-10-01,8711
0056,元大高股息,46,8,38,陽信-石牌,2024-10-01,8711
1718,中纖,30,0,30,陽信-石牌,2024-10-01,8711
6116,彩晶,30,0,30,陽信-石牌,2024-10-01,8711
00679B,元大美債20年,50,23,27,陽信-石牌,2024-10-01,8711
2409,友達,35,10,25,陽信-石牌,2024-10-01,8711
00680L,元大美債20正2,24,0,24,陽信-石牌,2024-10-01,8711
3450,聯鈞,49,25,24,陽信-石牌,2024-10-01,8711
2455,全新,23,1,22,陽信-石牌,2024-10-01,8711
2880,華南金,22,1,21,陽信-石牌,2024-10-01,8711
00687B,國泰20年美債,21,3,18,陽信-石牌,2024-10-01,8711
1714,和桐,18,0,18,陽信-石牌,2024-10-01,8711
2630,亞航,20,2,18,陽信-石牌,2024-10-01,8711
8249,菱光,19,1,18,陽信-石牌,2024-10-01,8711
00878,國泰永續高股息,22,5,17,陽信-石牌,2024-10-01,8711
4526,東台,17,0,17,陽信-石牌,2024-10-01,8711
2363,矽統,27,10,17,陽信-石牌,2024-10-01,8711
00918,大華優利高填息30,16,0,16,陽信-石牌,2024-10-01,8711
2634,漢翔,20,4,16,陽信-石牌,2024-10-01,8711
6152,百一,15,0,15,陽信-石牌,2024-10-01,8711
912000,晨訊科-DR,15,0,15,陽信-石牌,2024-10-01,8711
5871,中租-KY,15,0,15,陽信-石牌,2024-10-01,8711
1605,華新,27,14,13,陽信-石牌,2024-10-01,8711
2101,南港,18,5,13,陽信-石牌,2024-10-01,8711
3362,先進光,13,0,13,陽信-石牌,2024-10-01,8711
6274,台燿,16,3,13,陽信-石牌,2024-10-01,8711
3047,訊舟,13,1,12,陽信-石牌,2024-10-01,8711
4977,眾達-KY,23,11,12,陽信-石牌,2024-10-01,8711
2402,毅嘉,14,2,12,陽信-石牌,2024-10-01,8711
00939,統一台灣高息動能,11,0,11,陽信-石牌,2024-10-01,8711
1711,永光,11,0,11,陽信-石牌,2024-10-01,8711
2371,大同,16,5,11,陽信-石牌,2024-10-01,8711
2408,南亞科,11,0,11,陽信-石牌,2024-10-01,8711
2028,威致,20,10,10,陽信-石牌,2024-10-01,8711
2312,金寶,10,0,10,陽信-石牌,2024-10-01,8711
2489,瑞軒,10,0,10,陽信-石牌,2024-10-01,8711
3041,揚智,10,0,10,陽信-石牌,2024-10-01,8711
3673,TPK-KY,11,1,10,陽信-石牌,2024-10-01,8711
3715,定穎投控,12,2,10,陽信-石牌,2024-10-01,8711
4989,榮科,10,0,10,陽信-石牌,2024-10-01,8711
8222,寶一,10,0,10,陽信-石牌,2024-10-01,8711
00919,群益台灣精選高息,9,0,9,陽信-石牌,2024-10-01,8711
1569,濱川,13,4,9,陽信-石牌,2024-10-01,8711
2888,新光金,233,25,208,陽信-石牌,2024-10-04,8711
00922,國泰台灣領袖50,149,0,149,陽信-石牌,2024-10-04,8711
00655L,國泰中國A50正2,110,0,110,陽信-石牌,2024-10-04,8711
1802,台玻,112,20,92,陽信-石牌,2024-10-04,8711
00919,群益台灣精選高息,77,2,75,陽信-石牌,2024-10-04,8711
6213,聯茂,70,2,68,陽信-石牌,2024-10-04,8711
2615,萬海,66,7,59,陽信-石牌,2024-10-04,8711
00929,復華台灣科技優息,61,6,55,陽信-石牌,2024-10-04,8711
2610,華航,45,0,45,陽信-石牌,2024-10-04,8711
00680L,元大美債20正2,35,0,35,陽信-石牌,2024-10-04,8711
1584,精剛,30,0,30,陽信-石牌,2024-10-04,8711
0056,元大高股息,26,0,26,陽信-石牌,2024-10-04,8711
00918,大華優利高填息30,21,0,21,陽信-石牌,2024-10-04,8711
2637,慧洋-KY,82,61,21,陽信-石牌,2024-10-04,8711
00706L,期元大S＆P日圓正2,20,0,20,陽信-石牌,2024-10-04,8711
2353,宏��,20,0,20,陽信-石牌,2024-10-04,8711
1513,中興電,19,1,18,陽信-石牌,2024-10-04,8711
00712,復華富時不動產,17,0,17,陽信-石牌,2024-10-04,8711
006205,富邦上証,17,0,17,陽信-石牌,2024-10-04,8711
00939,統一台灣高息動能,16,0,16,陽信-石牌,2024-10-04,8711
1309,台達化,26,10,16,陽信-石牌,2024-10-04,8711
4303,信立,17,1,16,陽信-石牌,2024-10-04,8711
2030,彰源,15,0,15,陽信-石牌,2024-10-04,8711
00636,國泰中國A50,14,0,14,陽信-石牌,2024-10-04,8711
2845,遠東銀,14,0,14,陽信-石牌,2024-10-04,8711
1340,勝悅-KY,13,0,13,陽信-石牌,2024-10-04,8711
1721,三晃,14,1,13,陽信-石牌,2024-10-04,8711
2070,精湛,13,0,13,陽信-石牌,2024-10-04,8711
2312,金寶,13,0,13,陽信-石牌,2024-10-04,8711
3048,益登,12,0,12,陽信-石牌,2024-10-04,8711
1301,台塑,23,12,11,陽信-石牌,2024-10-04,8711
2308,台達電,15,4,11,陽信-石牌,2024-10-04,8711
2618,長榮航,21,10,11,陽信-石牌,2024-10-04,8711
1442,名軒,14,3,11,陽信-石牌,2024-10-04,8711
1522,堤維西,11,0,11,陽信-石牌,2024-10-04,8711
1727,中華化,12,1,11,陽信-石牌,2024-10-04,8711
2038,海光,11,0,11,陽信-石牌,2024-10-04,8711
2880,華南金,11,0,11,陽信-石牌,2024-10-04,8711
4916,事欣科,12,1,11,陽信-石牌,2024-10-04,8711
2705,六福,10,0,10,陽信-石牌,2024-10-04,8711
2745,五福,10,0,10,陽信-石牌,2024-10-04,8711
3673,TPK-KY,12,2,10,陽信-石牌,2024-10-04,8711
4532,瑞智,11,1,10,陽信-石牌,2024-10-04,8711
6113,亞矽,10,0,10,陽信-石牌,2024-10-04,8711
8213,志超,10,0,10,陽信-石牌,2024-10-04,8711
2425,承啟,19,9,10,陽信-石牌,2024-10-04,8711
00878,國泰永續高股息,11,2,9,陽信-石牌,2024-10-04,8711
2884,玉山金,11,2,9,陽信-石牌,2024-10-04,8711
4157,太景*-KY,9,0,9,陽信-石牌,2024-10-04,8711
4526,東台,9,0,9,陽信-石牌,2024-10-04,8711
00931B,統一美債20年,251,0,251,陽信-石牌,2024-10-07,8711
00912,中信臺灣智慧50,228,0,228,陽信-石牌,2024-10-07,8711
00882,中信中國高股息,198,46,152,陽信-石牌,2024-10-07,8711
00752,中信中國50,102,0,102,陽信-石牌,2024-10-07,8711
2882,國泰金,100,0,100,陽信-石牌,2024-10-07,8711
00905,FT臺灣Smart,88,0,88,陽信-石牌,2024-10-07,8711
4157,太景*-KY,74,0,74,陽信-石牌,2024-10-07,8711
00715L,期街口布蘭特正2,69,10,59,陽信-石牌,2024-10-07,8711
00753L,中信中國50正2,67,16,51,陽信-石牌,2024-10-07,8711
2317,鴻海,91,50,41,陽信-石牌,2024-10-07,8711
00706L,期元大S＆P日圓正2,57,20,37,陽信-石牌,2024-10-07,8711
00679B,元大美債20年,31,0,31,陽信-石牌,2024-10-07,8711
6257,矽格,32,1,31,陽信-石牌,2024-10-07,8711
00687B,國泰20年美債,31,0,31,陽信-石牌,2024-10-07,8711
00712,復華富時不動產,30,0,30,陽信-石牌,2024-10-07,8711
2022,聚亨,26,0,26,陽信-石牌,2024-10-07,8711
5475,德宏,25,0,25,陽信-石牌,2024-10-07,8711
00651R,復華香港反1,35,11,24,陽信-石牌,2024-10-07,8711
00919,群益台灣精選高息,24,1,23,陽信-石牌,2024-10-07,8711
00636,國泰中國A50,50,29,21,陽信-石牌,2024-10-07,8711
3048,益登,41,20,21,陽信-石牌,2024-10-07,8711
5443,均豪,21,0,21,陽信-石牌,2024-10-07,8711
00656R,國泰中國A50反1,20,0,20,陽信-石牌,2024-10-07,8711
00655L,國泰中國A50正2,40,20,20,陽信-石牌,2024-10-07,8711
00942B,台新美A公司債20+,20,0,20,陽信-石牌,2024-10-07,8711
5230,雷笛克光學,20,0,20,陽信-石牌,2024-10-07,8711
0056,元大高股息,19,0,19,陽信-石牌,2024-10-07,8711
2316,楠梓電,23,4,19,陽信-石牌,2024-10-07,8711
2610,華航,26,8,18,陽信-石牌,2024-10-07,8711
8111,立��,64,47,17,陽信-石牌,2024-10-07,8711
4903,聯光通,23,7,16,陽信-石牌,2024-10-07,8711
00650L,復華香港正2,75,60,15,陽信-石牌,2024-10-07,8711
3481,群創,27,12,15,陽信-石牌,2024-10-07,8711
1301,台塑,15,2,13,陽信-石牌,2024-10-07,8711
00632R,元大台灣50反1,613,600,13,陽信-石牌,2024-10-07,8711
2313,華通,14,2,12,陽信-石牌,2024-10-07,8711
2337,旺宏,11,0,11,陽信-石牌,2024-10-07,8711
2495,普安,11,0,11,陽信-石牌,2024-10-07,8711
2887,台新金,11,0,11,陽信-石牌,2024-10-07,8711
2354,鴻準,12,2,10,陽信-石牌,2024-10-07,8711
6152,百一,50,40,10,陽信-石牌,2024-10-07,8711
00665L,富邦�琤肭磪囓�2,28,18,10,陽信-石牌,2024-10-07,8711
1789,神隆,10,0,10,陽信-石牌,2024-10-07,8711
2010,春源,10,0,10,陽信-石牌,2024-10-07,8711
6118,建達,10,0,10,陽信-石牌,2024-10-07,8711
6120,達運,10,0,10,陽信-石牌,2024-10-07,8711
1605,華新,10,1,9,陽信-石牌,2024-10-07,8711
2881,富邦金,10,1,9,陽信-石牌,2024-10-07,8711
1609,大亞,9,1,8,陽信-石牌,2024-10-07,8711
2408,南亞科,8,0,8,陽信-石牌,2024-10-07,8711
00948B,中信優息投資級債,207,3,204,陽信-石牌,2024-10-08,8711
00882,中信中國高股息,168,17,151,陽信-石牌,2024-10-08,8711
2409,友達,127,0,127,陽信-石牌,2024-10-08,8711
2892,第一金,126,1,125,陽信-石牌,2024-10-08,8711
8110,華東,113,0,113,陽信-石牌,2024-10-08,8711
00940,元大台灣價值高息,105,15,90,陽信-石牌,2024-10-08,8711
3481,群創,98,14,84,陽信-石牌,2024-10-08,8711
00929,復華台灣科技優息,71,0,71,陽信-石牌,2024-10-08,8711
00637L,元大滬深300正2,112,46,66,陽信-石牌,2024-10-08,8711
00636,國泰中國A50,59,0,59,陽信-石牌,2024-10-08,8711
2317,鴻海,116,58,58,陽信-石牌,2024-10-08,8711
00633L,富邦上証正2,320,270,50,陽信-石牌,2024-10-08,8711
0061,元大寶滬深,50,3,47,陽信-石牌,2024-10-08,8711
2371,大同,46,0,46,陽信-石牌,2024-10-08,8711
5381,合正,39,0,39,陽信-石牌,2024-10-08,8711
2101,南港,50,12,38,陽信-石牌,2024-10-08,8711
00687B,國泰20年美債,34,0,34,陽信-石牌,2024-10-08,8711
1309,台達化,37,4,33,陽信-石牌,2024-10-08,8711
00857B,永豐20年美公債,32,0,32,陽信-石牌,2024-10-08,8711
4157,太景*-KY,30,0,30,陽信-石牌,2024-10-08,8711
00919,群益台灣精選高息,26,0,26,陽信-石牌,2024-10-08,8711
00753L,中信中國50正2,40,14,26,陽信-石牌,2024-10-08,8711
00931B,統一美債20年,31,5,26,陽信-石牌,2024-10-08,8711
006205,富邦上証,25,0,25,陽信-石牌,2024-10-08,8711
00937B,群益ESG投等債20,26,2,24,陽信-石牌,2024-10-08,8711
2022,聚亨,33,10,23,陽信-石牌,2024-10-08,8711
2355,敬鵬,22,0,22,陽信-石牌,2024-10-08,8711
3049,精金,31,10,21,陽信-石牌,2024-10-08,8711
1711,永光,21,1,20,陽信-石牌,2024-10-08,8711
2801,彰銀,20,0,20,陽信-石牌,2024-10-08,8711
2886,兆豐金,20,0,20,陽信-石牌,2024-10-08,8711
912000,晨訊科-DR,20,0,20,陽信-石牌,2024-10-08,8711
9105,泰金寶-DR,34,15,19,陽信-石牌,2024-10-08,8711
2425,承啟,27,10,17,陽信-石牌,2024-10-08,8711
00922,國泰台灣領袖50,17,0,17,陽信-石牌,2024-10-08,8711
00946,群益科技高息成長,17,0,17,陽信-石牌,2024-10-08,8711
2880,華南金,16,0,16,陽信-石牌,2024-10-08,8711
2883,凱基金,16,0,16,陽信-石牌,2024-10-08,8711
3037,欣興,16,0,16,陽信-石牌,2024-10-08,8711
00878,國泰永續高股息,16,1,15,陽信-石牌,2024-10-08,8711
1539,巨庭,15,0,15,陽信-石牌,2024-10-08,8711
1721,三晃,13,0,13,陽信-石牌,2024-10-08,8711
2610,華航,13,0,13,陽信-石牌,2024-10-08,8711
9103,美德醫療-DR,12,0,12,陽信-石牌,2024-10-08,8711
00688L,國泰20年美債正2,16,5,11,陽信-石牌,2024-10-08,8711
3484,崧騰,11,0,11,陽信-石牌,2024-10-08,8711
5014,建錩,17,6,11,陽信-石牌,2024-10-08,8711
00725B,國泰投資級公司債,11,0,11,陽信-石牌,2024-10-08,8711
00918,大華優利高填息30,10,0,10,陽信-石牌,2024-10-08,8711
3508,位速,10,0,10,陽信-石牌,2024-10-08,8711
2601,益航,97,4,93,陽信-石牌,2024-10-09,8711
6152,百一,88,0,88,陽信-石牌,2024-10-09,8711
00931B,統一美債20年,61,0,61,陽信-石牌,2024-10-09,8711
2883,凱基金,50,0,50,陽信-石牌,2024-10-09,8711
2504,國產,50,0,50,陽信-石牌,2024-10-09,8711
00687B,國泰20年美債,48,5,43,陽信-石牌,2024-10-09,8711
00632R,元大台灣50反1,40,0,40,陽信-石牌,2024-10-09,8711
2618,長榮航,40,0,40,陽信-石牌,2024-10-09,8711
2313,華通,119,80,39,陽信-石牌,2024-10-09,8711
00688L,國泰20年美債正2,38,0,38,陽信-石牌,2024-10-09,8711
2399,映泰,124,86,38,陽信-石牌,2024-10-09,8711
2371,大同,37,0,37,陽信-石牌,2024-10-09,8711
00643,群益深証中小,33,0,33,陽信-石牌,2024-10-09,8711
2609,陽明,50,18,32,陽信-石牌,2024-10-09,8711
1714,和桐,29,0,29,陽信-石牌,2024-10-09,8711
2303,聯電,29,1,28,陽信-石牌,2024-10-09,8711
5014,建錩,80,52,28,陽信-石牌,2024-10-09,8711
00773B,中信優先金融債,26,0,26,陽信-石牌,2024-10-09,8711
00637L,元大滬深300正2,53,29,24,陽信-石牌,2024-10-09,8711
00940,元大台灣價值高息,23,0,23,陽信-石牌,2024-10-09,8711
2070,精湛,23,0,23,陽信-石牌,2024-10-09,8711
5381,合正,24,1,23,陽信-石牌,2024-10-09,8711
6274,台燿,25,2,23,陽信-石牌,2024-10-09,8711
4909,新復興,25,3,22,陽信-石牌,2024-10-09,8711
2022,聚亨,21,0,21,陽信-石牌,2024-10-09,8711
3013,晟銘電,43,22,21,陽信-石牌,2024-10-09,8711
00680L,元大美債20正2,20,0,20,陽信-石牌,2024-10-09,8711
006205,富邦上証,20,0,20,陽信-石牌,2024-10-09,8711
2637,慧洋-KY,20,0,20,陽信-石牌,2024-10-09,8711
6550,北極星藥業-KY,20,0,20,陽信-石牌,2024-10-09,8711
00929,復華台灣科技優息,24,5,19,陽信-石牌,2024-10-09,8711
00882,中信中國高股息,22,3,19,陽信-石牌,2024-10-09,8711
3481,群創,20,1,19,陽信-石牌,2024-10-09,8711
1301,台塑,18,0,18,陽信-石牌,2024-10-09,8711
3025,星通,32,14,18,陽信-石牌,2024-10-09,8711
00857B,永豐20年美公債,17,0,17,陽信-石牌,2024-10-09,8711
2537,聯上發,17,1,16,陽信-石牌,2024-10-09,8711
3483,力致,16,0,16,陽信-石牌,2024-10-09,8711
4729,熒茂,15,0,15,陽信-石牌,2024-10-09,8711
4908,前鼎,34,19,15,陽信-石牌,2024-10-09,8711
6742,澤米,20,5,15,陽信-石牌,2024-10-09,8711
3484,崧騰,14,0,14,陽信-石牌,2024-10-09,8711
1316,上曜,12,0,12,陽信-石牌,2024-10-09,8711
1721,三晃,12,0,12,陽信-石牌,2024-10-09,8711
2605,新興,17,5,12,陽信-石牌,2024-10-09,8711
3231,緯創,48,36,12,陽信-石牌,2024-10-09,8711
1584,精剛,11,0,11,陽信-石牌,2024-10-09,8711
2101,南港,18,7,11,陽信-石牌,2024-10-09,8711
2367,燿華,11,0,11,陽信-石牌,2024-10-09,8711
6443,元晶,11,0,11,陽信-石牌,2024-10-09,8711
00931B,統一美債20年,222,0,222,陽信-石牌,2024-10-11,8711
00882,中信中國高股息,100,0,100,陽信-石牌,2024-10-11,8711
3481,群創,91,4,87,陽信-石牌,2024-10-11,8711
00673R,期元大S＆P原油反1,84,0,84,陽信-石牌,2024-10-11,8711
3149,正達,167,102,65,陽信-石牌,2024-10-11,8711
2101,南港,64,1,63,陽信-石牌,2024-10-11,8711
00937B,群益ESG投等債20,67,15,52,陽信-石牌,2024-10-11,8711
00679B,元大美債20年,43,0,43,陽信-石牌,2024-10-11,8711
00637L,元大滬深300正2,55,12,43,陽信-石牌,2024-10-11,8711
2504,國產,40,0,40,陽信-石牌,2024-10-11,8711
00857B,永豐20年美公債,35,0,35,陽信-石牌,2024-10-11,8711
2881,富邦金,30,0,30,陽信-石牌,2024-10-11,8711
2344,華邦電,30,1,29,陽信-石牌,2024-10-11,8711
2313,華通,92,66,26,陽信-石牌,2024-10-11,8711
0056,元大高股息,21,1,20,陽信-石牌,2024-10-11,8711
2481,強茂,21,1,20,陽信-石牌,2024-10-11,8711
4726,永昕,20,0,20,陽信-石牌,2024-10-11,8711
2399,映泰,45,26,19,陽信-石牌,2024-10-11,8711
8039,台虹,20,1,19,陽信-石牌,2024-10-11,8711
2495,普安,30,12,18,陽信-石牌,2024-10-11,8711
2356,英業達,21,3,18,陽信-石牌,2024-10-11,8711
2834,臺企銀,18,0,18,陽信-石牌,2024-10-11,8711
00773B,中信優先金融債,15,0,15,陽信-石牌,2024-10-11,8711
00688L,國泰20年美債正2,15,0,15,陽信-石牌,2024-10-11,8711
00650L,復華香港正2,58,43,15,陽信-石牌,2024-10-11,8711
5443,均豪,17,3,14,陽信-石牌,2024-10-11,8711
3234,光環,19,6,13,陽信-石牌,2024-10-11,8711
3360,尚立,13,0,13,陽信-石牌,2024-10-11,8711
6108,競國,13,0,13,陽信-石牌,2024-10-11,8711
2351,順德,12,0,12,陽信-石牌,2024-10-11,8711
2601,益航,12,0,12,陽信-石牌,2024-10-11,8711
2887,台新金,12,0,12,陽信-石牌,2024-10-11,8711
3591,艾笛森,12,0,12,陽信-石牌,2024-10-11,8711
1515,力山,11,0,11,陽信-石牌,2024-10-11,8711
1795,美時,11,0,11,陽信-石牌,2024-10-11,8711
1815,富喬,11,0,11,陽信-石牌,2024-10-11,8711
2317,鴻海,44,33,11,陽信-石牌,2024-10-11,8711
1101,台泥,10,0,10,陽信-石牌,2024-10-11,8711
1540,喬福,10,0,10,陽信-石牌,2024-10-11,8711
1617,榮星,10,0,10,陽信-石牌,2024-10-11,8711
2538,基泰,10,0,10,陽信-石牌,2024-10-11,8711
2890,永豐金,10,0,10,陽信-石牌,2024-10-11,8711
6234,高僑,10,0,10,陽信-石牌,2024-10-11,8711
2363,矽統,24,15,9,陽信-石牌,2024-10-11,8711
5347,世界,13,4,9,陽信-石牌,2024-10-11,8711
6530,創威,9,0,9,陽信-石牌,2024-10-11,8711
8064,東捷,12,3,9,陽信-石牌,2024-10-11,8711
2464,盟立,12,4,8,陽信-石牌,2024-10-11,8711
00655L,國泰中國A50正2,30,22,8,陽信-石牌,2024-10-11,8711
3019,亞光,11,3,8,陽信-石牌,2024-10-11,8711
00679B,元大美債20年,115,0,115,陽信-石牌,2024-10-14,8711
00795B,中信美國公債20年,104,0,104,陽信-石牌,2024-10-14,8711
00940,元大台灣價值高息,101,11,90,陽信-石牌,2024-10-14,8711
00937B,群益ESG投等債20,67,0,67,陽信-石牌,2024-10-14,8711
6438,迅得,44,2,42,陽信-石牌,2024-10-14,8711
2344,華邦電,39,0,39,陽信-石牌,2024-10-14,8711
00887,永豐中國科技50大,37,0,37,陽信-石牌,2024-10-14,8711
4903,聯光通,35,1,34,陽信-石牌,2024-10-14,8711
1595,川寶,40,6,34,陽信-石牌,2024-10-14,8711
3049,精金,30,0,30,陽信-石牌,2024-10-14,8711
4157,太景*-KY,30,0,30,陽信-石牌,2024-10-14,8711
2312,金寶,63,35,28,陽信-石牌,2024-10-14,8711
00751B,元大AAA至A公司債,27,0,27,陽信-石牌,2024-10-14,8711
6108,競國,24,0,24,陽信-石牌,2024-10-14,8711
00857B,永豐20年美公債,21,0,21,陽信-石牌,2024-10-14,8711
5386,青雲,21,0,21,陽信-石牌,2024-10-14,8711
00655L,國泰中國A50正2,40,20,20,陽信-石牌,2024-10-14,8711
2611,志信,20,0,20,陽信-石牌,2024-10-14,8711
2887,台新金,25,5,20,陽信-石牌,2024-10-14,8711
4142,國光生,20,0,20,陽信-石牌,2024-10-14,8711
2421,建準,29,11,18,陽信-石牌,2024-10-14,8711
2426,鼎元,35,17,18,陽信-石牌,2024-10-14,8711
8111,立��,51,33,18,陽信-石牌,2024-10-14,8711
2002,中鋼,18,0,18,陽信-石牌,2024-10-14,8711
00720B,元大投資級公司債,17,0,17,陽信-石牌,2024-10-14,8711
1442,名軒,19,2,17,陽信-石牌,2024-10-14,8711
2618,長榮航,16,0,16,陽信-石牌,2024-10-14,8711
00687B,國泰20年美債,36,20,16,陽信-石牌,2024-10-14,8711
3380,明泰,17,1,16,陽信-石牌,2024-10-14,8711
5490,同亨,15,0,15,陽信-石牌,2024-10-14,8711
3481,群創,30,16,14,陽信-石牌,2024-10-14,8711
910861,神州-DR,14,0,14,陽信-石牌,2024-10-14,8711
00656R,國泰中國A50反1,12,0,12,陽信-石牌,2024-10-14,8711
00632R,元大台灣50反1,22,10,12,陽信-石牌,2024-10-14,8711
1785,光洋科,12,0,12,陽信-石牌,2024-10-14,8711
3234,光環,13,1,12,陽信-石牌,2024-10-14,8711
6547,高端疫苗,12,0,12,陽信-石牌,2024-10-14,8711
2881,富邦金,11,0,11,陽信-石牌,2024-10-14,8711
4303,信立,11,0,11,陽信-石牌,2024-10-14,8711
00912,中信臺灣智慧50,10,0,10,陽信-石牌,2024-10-14,8711
00772B,中信高評級公司債,10,0,10,陽信-石牌,2024-10-14,8711
1319,東陽,10,0,10,陽信-石牌,2024-10-14,8711
2634,漢翔,11,1,10,陽信-石牌,2024-10-14,8711
9105,泰金寶-DR,10,0,10,陽信-石牌,2024-10-14,8711
2101,南港,9,0,9,陽信-石牌,2024-10-14,8711
2834,臺企銀,10,1,9,陽信-石牌,2024-10-14,8711
3209,全科,9,0,9,陽信-石牌,2024-10-14,8711
3615,安可,10,1,9,陽信-石牌,2024-10-14,8711
2349,錸德,8,0,8,陽信-石牌,2024-10-14,8711
3227,原相,8,0,8,陽信-石牌,2024-10-14,8711
00937B,群益ESG投等債20,142,0,142,陽信-石牌,2024-10-15,8711
00639,富邦深100,100,0,100,陽信-石牌,2024-10-15,8711
1802,台玻,100,0,100,陽信-石牌,2024-10-15,8711
00696B,富邦美債20年,80,0,80,陽信-石牌,2024-10-15,8711
00715L,期街口布蘭特正2,53,1,52,陽信-石牌,2024-10-15,8711
2887,台新金,50,0,50,陽信-石牌,2024-10-15,8711
4903,聯光通,126,82,44,陽信-石牌,2024-10-15,8711
00948B,中信優息投資級債,42,0,42,陽信-石牌,2024-10-15,8711
2601,益航,42,2,40,陽信-石牌,2024-10-15,8711
2881,富邦金,42,2,40,陽信-石牌,2024-10-15,8711
00679B,元大美債20年,39,1,38,陽信-石牌,2024-10-15,8711
1815,富喬,39,1,38,陽信-石牌,2024-10-15,8711
00887,永豐中國科技50大,46,10,36,陽信-石牌,2024-10-15,8711
4979,華星光,39,8,31,陽信-石牌,2024-10-15,8711
1718,中纖,30,0,30,陽信-石牌,2024-10-15,8711
2504,國產,30,0,30,陽信-石牌,2024-10-15,8711
2538,基泰,30,0,30,陽信-石牌,2024-10-15,8711
0056,元大高股息,31,3,28,陽信-石牌,2024-10-15,8711
3062,建漢,67,41,26,陽信-石牌,2024-10-15,8711
3013,晟銘電,65,40,25,陽信-石牌,2024-10-15,8711
5388,中磊,25,0,25,陽信-石牌,2024-10-15,8711
1714,和桐,23,0,23,陽信-石牌,2024-10-15,8711
00915,凱基優選高股息30,22,0,22,陽信-石牌,2024-10-15,8711
6547,高端疫苗,22,0,22,陽信-石牌,2024-10-15,8711
2399,映泰,56,35,21,陽信-石牌,2024-10-15,8711
00939,統一台灣高息動能,20,0,20,陽信-石牌,2024-10-15,8711
1440,南紡,20,0,20,陽信-石牌,2024-10-15,8711
2530,華建,27,7,20,陽信-石牌,2024-10-15,8711
3710,連展投控,22,3,19,陽信-石牌,2024-10-15,8711
00673R,期元大S＆P原油反1,38,20,18,陽信-石牌,2024-10-15,8711
3048,益登,30,12,18,陽信-石牌,2024-10-15,8711
3715,定穎投控,18,1,17,陽信-石牌,2024-10-15,8711
2439,美律,16,0,16,陽信-石牌,2024-10-15,8711
00706L,期元大S＆P日圓正2,15,0,15,陽信-石牌,2024-10-15,8711
00680L,元大美債20正2,15,0,15,陽信-石牌,2024-10-15,8711
1528,恩德,15,0,15,陽信-石牌,2024-10-15,8711
2388,威盛,20,5,15,陽信-石牌,2024-10-15,8711
00632R,元大台灣50反1,14,0,14,陽信-石牌,2024-10-15,8711
2605,新興,14,0,14,陽信-石牌,2024-10-15,8711
2101,南港,14,1,13,陽信-石牌,2024-10-15,8711
4977,眾達-KY,20,7,13,陽信-石牌,2024-10-15,8711
6207,雷科,13,0,13,陽信-石牌,2024-10-15,8711
3149,正達,72,60,12,陽信-石牌,2024-10-15,8711
2426,鼎元,46,35,11,陽信-石牌,2024-10-15,8711
6443,元晶,11,0,11,陽信-石牌,2024-10-15,8711
00959B,大華投等美債15Y+,10,0,10,陽信-石牌,2024-10-15,8711
1609,大亞,10,0,10,陽信-石牌,2024-10-15,8711
1909,榮成,10,0,10,陽信-石牌,2024-10-15,8711
2342,茂矽,10,0,10,陽信-石牌,2024-10-15,8711
3548,兆利,12,2,10,陽信-石牌,2024-10-15,8711
2887,台新金,225,15,210,陽信-石牌,2024-10-16,8711
00687B,國泰20年美債,151,7,144,陽信-石牌,2024-10-16,8711
2883,凱基金,84,3,81,陽信-石牌,2024-10-16,8711
00679B,元大美債20年,75,2,73,陽信-石牌,2024-10-16,8711
00922,國泰台灣領袖50,70,0,70,陽信-石牌,2024-10-16,8711
00715L,期街口布蘭特正2,62,0,62,陽信-石牌,2024-10-16,8711
0056,元大高股息,40,0,40,陽信-石牌,2024-10-16,8711
3231,緯創,52,14,38,陽信-石牌,2024-10-16,8711
1101,台泥,33,0,33,陽信-石牌,2024-10-16,8711
6116,彩晶,31,1,30,陽信-石牌,2024-10-16,8711
8404,百和興業-KY,29,0,29,陽信-石牌,2024-10-16,8711
2530,華建,22,0,22,陽信-石牌,2024-10-16,8711
2330,台積電,25,4,21,陽信-石牌,2024-10-16,8711
1714,和桐,20,0,20,陽信-石牌,2024-10-16,8711
00961,FT臺灣永續高息,20,0,20,陽信-石牌,2024-10-16,8711
2344,華邦電,20,0,20,陽信-石牌,2024-10-16,8711
2880,華南金,20,0,20,陽信-石牌,2024-10-16,8711
00725B,國泰投資級公司債,20,1,19,陽信-石牌,2024-10-16,8711
00929,復華台灣科技優息,24,5,19,陽信-石牌,2024-10-16,8711
6491,晶碩,19,0,19,陽信-石牌,2024-10-16,8711
00639,富邦深100,18,0,18,陽信-石牌,2024-10-16,8711
00637L,元大滬深300正2,20,4,16,陽信-石牌,2024-10-16,8711
2258,鴻華先進-創,16,0,16,陽信-石牌,2024-10-16,8711
3437,榮創,22,6,16,陽信-石牌,2024-10-16,8711
2409,友達,15,0,15,陽信-石牌,2024-10-16,8711
2363,矽統,19,6,13,陽信-石牌,2024-10-16,8711
00713,元大台灣高息低波,13,0,13,陽信-石牌,2024-10-16,8711
2801,彰銀,12,0,12,陽信-石牌,2024-10-16,8711
00680L,元大美債20正2,11,0,11,陽信-石牌,2024-10-16,8711
00940,元大台灣價值高息,11,0,11,陽信-石牌,2024-10-16,8711
2349,錸德,24,13,11,陽信-石牌,2024-10-16,8711
2891,中信金,12,1,11,陽信-石牌,2024-10-16,8711
6770,力積電,117,107,10,陽信-石牌,2024-10-16,8711
1605,華新,10,0,10,陽信-石牌,2024-10-16,8711
2481,強茂,10,0,10,陽信-石牌,2024-10-16,8711
2538,基泰,10,0,10,陽信-石牌,2024-10-16,8711
2845,遠東銀,10,0,10,陽信-石牌,2024-10-16,8711
3305,昇貿,10,0,10,陽信-石牌,2024-10-16,8711
6164,華興,10,0,10,陽信-石牌,2024-10-16,8711
00665L,富邦�琤肭磪囓�2,157,148,9,陽信-石牌,2024-10-16,8711
2371,大同,13,4,9,陽信-石牌,2024-10-16,8711
2464,盟立,11,2,9,陽信-石牌,2024-10-16,8711
0061,元大寶滬深,8,0,8,陽信-石牌,2024-10-16,8711
1326,台化,7,0,7,陽信-石牌,2024-10-16,8711
00887,永豐中國科技50大,7,0,7,陽信-石牌,2024-10-16,8711
00921,兆豐龍頭等權重,7,0,7,陽信-石牌,2024-10-16,8711
1595,川寶,12,5,7,陽信-石牌,2024-10-16,8711
2365,昆盈,10,3,7,陽信-石牌,2024-10-16,8711
2542,興富發,7,0,7,陽信-石牌,2024-10-16,8711
4977,眾達-KY,19,12,7,陽信-石牌,2024-10-16,8711
2409,友達,127,28,99,陽信-石牌,2024-10-17,8711
00637L,元大滬深300正2,96,1,95,陽信-石牌,2024-10-17,8711
1447,力鵬,70,0,70,陽信-石牌,2024-10-17,8711
00909,國泰數位支付服務,50,0,50,陽信-石牌,2024-10-17,8711
2408,南亞科,50,0,50,陽信-石牌,2024-10-17,8711
3231,緯創,59,9,50,陽信-石牌,2024-10-17,8711
1528,恩德,53,5,48,陽信-石牌,2024-10-17,8711
0056,元大高股息,48,1,47,陽信-石牌,2024-10-17,8711
00922,國泰台灣領袖50,45,0,45,陽信-石牌,2024-10-17,8711
00887,永豐中國科技50大,30,2,28,陽信-石牌,2024-10-17,8711
2399,映泰,62,35,27,陽信-石牌,2024-10-17,8711
3047,訊舟,26,0,26,陽信-石牌,2024-10-17,8711
2312,金寶,92,67,25,陽信-石牌,2024-10-17,8711
2426,鼎元,42,20,22,陽信-石牌,2024-10-17,8711
2497,怡利電,21,0,21,陽信-石牌,2024-10-17,8711
2388,威盛,22,2,20,陽信-石牌,2024-10-17,8711
3711,日月光投控,21,2,19,陽信-石牌,2024-10-17,8711
00919,群益台灣精選高息,30,12,18,陽信-石牌,2024-10-17,8711
3591,艾笛森,19,2,17,陽信-石牌,2024-10-17,8711
2421,建準,26,10,16,陽信-石牌,2024-10-17,8711
8404,百和興業-KY,16,0,16,陽信-石牌,2024-10-17,8711
8110,華東,15,0,15,陽信-石牌,2024-10-17,8711
2881,富邦金,12,0,12,陽信-石牌,2024-10-17,8711
00937B,群益ESG投等債20,41,30,11,陽信-石牌,2024-10-17,8711
3615,安可,13,2,11,陽信-石牌,2024-10-17,8711
3710,連展投控,18,7,11,陽信-石牌,2024-10-17,8711
5452,佶優,17,6,11,陽信-石牌,2024-10-17,8711
1316,上曜,10,0,10,陽信-石牌,2024-10-17,8711
00892,富邦台灣半導體,10,0,10,陽信-石牌,2024-10-17,8711
1474,弘裕,10,0,10,陽信-石牌,2024-10-17,8711
1727,中華化,10,0,10,陽信-石牌,2024-10-17,8711
2007,燁興,10,0,10,陽信-石牌,2024-10-17,8711
2444,兆勁,10,0,10,陽信-石牌,2024-10-17,8711
2887,台新金,10,0,10,陽信-石牌,2024-10-17,8711
3508,位速,10,0,10,陽信-石牌,2024-10-17,8711
4729,熒茂,15,5,10,陽信-石牌,2024-10-17,8711
5498,凱崴,10,0,10,陽信-石牌,2024-10-17,8711
2313,華通,35,26,9,陽信-石牌,2024-10-17,8711
2493,揚博,11,2,9,陽信-石牌,2024-10-17,8711
6151,晉倫,10,1,9,陽信-石牌,2024-10-17,8711
6274,台燿,8,0,8,陽信-石牌,2024-10-17,8711
2344,華邦電,7,0,7,陽信-石牌,2024-10-17,8711
3413,京鼎,8,1,7,陽信-石牌,2024-10-17,8711
00946,群益科技高息成長,9,3,6,陽信-石牌,2024-10-17,8711
1721,三晃,35,29,6,陽信-石牌,2024-10-17,8711
4533,協易機,12,6,6,陽信-石牌,2024-10-17,8711
5484,慧友,6,0,6,陽信-石牌,2024-10-17,8711
6290,良維,6,0,6,陽信-石牌,2024-10-17,8711
6451,訊芯-KY,14,8,6,陽信-石牌,2024-10-17,8711
2464,盟立,23,17,6,陽信-石牌,2024-10-17,8711
2888,新光金,208,1,207,陽信-石牌,2024-10-18,8711
00931B,統一美債20年,162,0,162,陽信-石牌,2024-10-18,8711
0056,元大高股息,119,0,119,陽信-石牌,2024-10-18,8711
00632R,元大台灣50反1,181,102,79,陽信-石牌,2024-10-18,8711
00715L,期街口布蘭特正2,121,50,71,陽信-石牌,2024-10-18,8711
00937B,群益ESG投等債20,82,28,54,陽信-石牌,2024-10-18,8711
3149,正達,57,7,50,陽信-石牌,2024-10-18,8711
00687B,國泰20年美債,57,10,47,陽信-石牌,2024-10-18,8711
4991,環宇-KY,47,0,47,陽信-石牌,2024-10-18,8711
00712,復華富時不動產,40,0,40,陽信-石牌,2024-10-18,8711
4157,太景*-KY,40,0,40,陽信-石牌,2024-10-18,8711
6491,晶碩,40,4,36,陽信-石牌,2024-10-18,8711
00679B,元大美債20年,32,0,32,陽信-石牌,2024-10-18,8711
4903,聯光通,43,12,31,陽信-石牌,2024-10-18,8711
1447,力鵬,30,0,30,陽信-石牌,2024-10-18,8711
6547,高端疫苗,27,0,27,陽信-石牌,2024-10-18,8711
2303,聯電,25,0,25,陽信-石牌,2024-10-18,8711
3049,精金,26,1,25,陽信-石牌,2024-10-18,8711
6108,競國,25,0,25,陽信-石牌,2024-10-18,8711
2883,凱基金,37,14,23,陽信-石牌,2024-10-18,8711
1809,中釉,20,0,20,陽信-石牌,2024-10-18,8711
3710,連展投控,30,10,20,陽信-石牌,2024-10-18,8711
2449,京元電子,23,3,20,陽信-石牌,2024-10-18,8711
3551,世禾,26,7,19,陽信-石牌,2024-10-18,8711
2426,鼎元,20,3,17,陽信-石牌,2024-10-18,8711
2101,南港,20,4,16,陽信-石牌,2024-10-18,8711
3060,銘異,24,8,16,陽信-石牌,2024-10-18,8711
2881,富邦金,22,7,15,陽信-石牌,2024-10-18,8711
3037,欣興,21,6,15,陽信-石牌,2024-10-18,8711
9904,寶成,15,0,15,陽信-石牌,2024-10-18,8711
5347,世界,15,0,15,陽信-石牌,2024-10-18,8711
2355,敬鵬,14,0,14,陽信-石牌,2024-10-18,8711
4966,譜瑞-KY,19,5,14,陽信-石牌,2024-10-18,8711
5452,佶優,22,8,14,陽信-石牌,2024-10-18,8711
00948B,中信優息投資級債,13,0,13,陽信-石牌,2024-10-18,8711
2313,華通,49,36,13,陽信-石牌,2024-10-18,8711
2367,燿華,14,1,13,陽信-石牌,2024-10-18,8711
2609,陽明,15,2,13,陽信-石牌,2024-10-18,8711
3483,力致,15,2,13,陽信-石牌,2024-10-18,8711
8940,新天地,13,0,13,陽信-石牌,2024-10-18,8711
2867,三商壽,30,17,13,陽信-石牌,2024-10-18,8711
4977,眾達-KY,33,21,12,陽信-石牌,2024-10-18,8711
1442,名軒,13,1,12,陽信-石牌,2024-10-18,8711
2498,宏達電,14,2,12,陽信-石牌,2024-10-18,8711
00933B,國泰10Y+金融債,11,0,11,陽信-石牌,2024-10-18,8711
2070,精湛,23,12,11,陽信-石牌,2024-10-18,8711
2201,裕隆,11,0,11,陽信-石牌,2024-10-18,8711
2382,廣達,19,8,11,陽信-石牌,2024-10-18,8711
8210,勤誠,21,10,11,陽信-石牌,2024-10-18,8711
00930,永豐ESG低碳高息,10,0,10,陽信-石牌,2024-10-18,8711
00927,群益半導體收益,238,0,238,陽信-石牌,2024-10-21,8711
00937B,群益ESG投等債20,185,0,185,陽信-石牌,2024-10-21,8711
9105,泰金寶-DR,176,25,151,陽信-石牌,2024-10-21,8711
00919,群益台灣精選高息,116,24,92,陽信-石牌,2024-10-21,8711
2014,中鴻,90,0,90,陽信-石牌,2024-10-21,8711
00665L,富邦�琤肭磪囓�2,116,36,80,陽信-石牌,2024-10-21,8711
2388,威盛,81,9,72,陽信-石牌,2024-10-21,8711
2891,中信金,70,0,70,陽信-石牌,2024-10-21,8711
1802,台玻,60,2,58,陽信-石牌,2024-10-21,8711
2883,凱基金,57,9,48,陽信-石牌,2024-10-21,8711
5202,力新,48,1,47,陽信-石牌,2024-10-21,8711
00715L,期街口布蘭特正2,207,161,46,陽信-石牌,2024-10-21,8711
00933B,國泰10Y+金融債,30,0,30,陽信-石牌,2024-10-21,8711
3013,晟銘電,46,25,21,陽信-石牌,2024-10-21,8711
00655L,國泰中國A50正2,30,10,20,陽信-石牌,2024-10-21,8711
00687B,國泰20年美債,20,0,20,陽信-石牌,2024-10-21,8711
2880,華南金,20,0,20,陽信-石牌,2024-10-21,8711
1528,恩德,31,12,19,陽信-石牌,2024-10-21,8711
2610,華航,19,0,19,陽信-石牌,2024-10-21,8711
2882,國泰金,18,0,18,陽信-石牌,2024-10-21,8711
911622,泰聚亨-DR,17,0,17,陽信-石牌,2024-10-21,8711
3048,益登,22,8,14,陽信-石牌,2024-10-21,8711
2303,聯電,20,6,14,陽信-石牌,2024-10-21,8711
2881,富邦金,12,0,12,陽信-石牌,2024-10-21,8711
2426,鼎元,22,10,12,陽信-石牌,2024-10-21,8711
00751B,元大AAA至A公司債,11,0,11,陽信-石牌,2024-10-21,8711
00907,永豐優息存股,11,0,11,陽信-石牌,2024-10-21,8711
2101,南港,15,4,11,陽信-石牌,2024-10-21,8711
2888,新光金,16,5,11,陽信-石牌,2024-10-21,8711
6505,台塑化,11,0,11,陽信-石牌,2024-10-21,8711
9904,寶成,11,0,11,陽信-石牌,2024-10-21,8711
00888,永豐台灣ESG,10,0,10,陽信-石牌,2024-10-21,8711
1474,弘裕,10,0,10,陽信-石牌,2024-10-21,8711
2359,所羅門,10,0,10,陽信-石牌,2024-10-21,8711
2736,富野,10,0,10,陽信-石牌,2024-10-21,8711
3645,達邁,11,1,10,陽信-石牌,2024-10-21,8711
2885,元大金,10,1,9,陽信-石牌,2024-10-21,8711
4977,眾達-KY,12,3,9,陽信-石牌,2024-10-21,8711
8069,元太,10,1,9,陽信-石牌,2024-10-21,8711
00905,FT臺灣Smart,10,2,8,陽信-石牌,2024-10-21,8711
00948B,中信優息投資級債,8,0,8,陽信-石牌,2024-10-21,8711
2851,中再保,8,0,8,陽信-石牌,2024-10-21,8711
3011,今皓,9,1,8,陽信-石牌,2024-10-21,8711
4510,高鋒,12,4,8,陽信-石牌,2024-10-21,8711
6530,創威,8,0,8,陽信-石牌,2024-10-21,8711
3481,群創,33,25,8,陽信-石牌,2024-10-21,8711
00922,國泰台灣領袖50,7,0,7,陽信-石牌,2024-10-21,8711
00740B,富邦全球投等債,7,0,7,陽信-石牌,2024-10-21,8711
2421,建準,11,4,7,陽信-石牌,2024-10-21,8711
4541,晟田,7,0,7,陽信-石牌,2024-10-21,8711
00937B,群益ESG投等債20,419,2,417,陽信-石牌,2024-10-22,8711
00679B,元大美債20年,171,0,171,陽信-石牌,2024-10-22,8711
00687B,國泰20年美債,109,1,108,陽信-石牌,2024-10-22,8711
2888,新光金,106,3,103,陽信-石牌,2024-10-22,8711
00948B,中信優息投資級債,93,0,93,陽信-石牌,2024-10-22,8711
00795B,中信美國公債20年,85,0,85,陽信-石牌,2024-10-22,8711
2883,凱基金,64,0,64,陽信-石牌,2024-10-22,8711
00688L,國泰20年美債正2,55,0,55,陽信-石牌,2024-10-22,8711
00680L,元大美債20正2,49,0,49,陽信-石牌,2024-10-22,8711
00933B,國泰10Y+金融債,30,0,30,陽信-石牌,2024-10-22,8711
2543,皇昌,29,1,28,陽信-石牌,2024-10-22,8711
4729,熒茂,51,23,28,陽信-石牌,2024-10-22,8711
1605,華新,27,2,25,陽信-石牌,2024-10-22,8711
2303,聯電,24,1,23,陽信-石牌,2024-10-22,8711
2609,陽明,77,55,22,陽信-石牌,2024-10-22,8711
1447,力鵬,22,0,22,陽信-石牌,2024-10-22,8711
3715,定穎投控,44,22,22,陽信-石牌,2024-10-22,8711
2356,英業達,28,7,21,陽信-石牌,2024-10-22,8711
00712,復華富時不動產,20,0,20,陽信-石牌,2024-10-22,8711
2312,金寶,30,10,20,陽信-石牌,2024-10-22,8711
2399,映泰,33,14,19,陽信-石牌,2024-10-22,8711
4564,元翎,25,6,19,陽信-石牌,2024-10-22,8711
00632R,元大台灣50反1,18,0,18,陽信-石牌,2024-10-22,8711
00751B,元大AAA至A公司債,17,0,17,陽信-石牌,2024-10-22,8711
00929,復華台灣科技優息,16,0,16,陽信-石牌,2024-10-22,8711
2444,兆勁,16,0,16,陽信-石牌,2024-10-22,8711
3605,宏致,20,4,16,陽信-石牌,2024-10-22,8711
00773B,中信優先金融債,15,0,15,陽信-石牌,2024-10-22,8711
2022,聚亨,15,0,15,陽信-石牌,2024-10-22,8711
2363,矽統,21,6,15,陽信-石牌,2024-10-22,8711
6753,龍德造船,15,0,15,陽信-石牌,2024-10-22,8711
1316,上曜,13,0,13,陽信-石牌,2024-10-22,8711
2340,台亞,12,0,12,陽信-石牌,2024-10-22,8711
3149,正達,24,12,12,陽信-石牌,2024-10-22,8711
00655L,國泰中國A50正2,10,0,10,陽信-石牌,2024-10-22,8711
1711,永光,10,0,10,陽信-石牌,2024-10-22,8711
1727,中華化,10,0,10,陽信-石牌,2024-10-22,8711
2208,台船,10,0,10,陽信-石牌,2024-10-22,8711
2497,怡利電,10,0,10,陽信-石牌,2024-10-22,8711
2867,三商壽,10,0,10,陽信-石牌,2024-10-22,8711
3706,神達,10,0,10,陽信-石牌,2024-10-22,8711
5475,德宏,10,0,10,陽信-石牌,2024-10-22,8711
6224,聚鼎,10,0,10,陽信-石牌,2024-10-22,8711
6603,富強鑫,10,0,10,陽信-石牌,2024-10-22,8711
2537,聯上發,10,1,9,陽信-石牌,2024-10-22,8711
4540,全球傳動,11,2,9,陽信-石牌,2024-10-22,8711
6451,訊芯-KY,11,2,9,陽信-石牌,2024-10-22,8711
8076,伍豐,10,1,9,陽信-石牌,2024-10-22,8711
2489,瑞軒,10,2,8,陽信-石牌,2024-10-22,8711
2330,台積電,11,3,8,陽信-石牌,2024-10-22,8711
00937B,群益ESG投等債20,134,5,129,陽信-石牌,2024-10-23,8711
9105,泰金寶-DR,73,18,55,陽信-石牌,2024-10-23,8711
00712,復華富時不動產,52,0,52,陽信-石牌,2024-10-23,8711
00655L,國泰中國A50正2,40,0,40,陽信-石牌,2024-10-23,8711
1447,力鵬,38,0,38,陽信-石牌,2024-10-23,8711
2374,佳能,30,0,30,陽信-石牌,2024-10-23,8711
2610,華航,30,0,30,陽信-石牌,2024-10-23,8711
2303,聯電,29,1,28,陽信-石牌,2024-10-23,8711
1569,濱川,29,4,25,陽信-石牌,2024-10-23,8711
00687B,國泰20年美債,34,11,23,陽信-石牌,2024-10-23,8711
2337,旺宏,23,0,23,陽信-石牌,2024-10-23,8711
2891,中信金,23,0,23,陽信-石牌,2024-10-23,8711
1595,川寶,23,1,22,陽信-石牌,2024-10-23,8711
3221,台嘉碩,21,0,21,陽信-石牌,2024-10-23,8711
8404,百和興業-KY,21,0,21,陽信-石牌,2024-10-23,8711
00929,復華台灣科技優息,20,0,20,陽信-石牌,2024-10-23,8711
2887,台新金,19,0,19,陽信-石牌,2024-10-23,8711
2317,鴻海,37,18,19,陽信-石牌,2024-10-23,8711
0056,元大高股息,23,5,18,陽信-石牌,2024-10-23,8711
2329,華泰,43,25,18,陽信-石牌,2024-10-23,8711
00715L,期街口布蘭特正2,152,135,17,陽信-石牌,2024-10-23,8711
2431,聯昌,27,10,17,陽信-石牌,2024-10-23,8711
1514,亞力,20,4,16,陽信-石牌,2024-10-23,8711
2353,宏��,16,0,16,陽信-石牌,2024-10-23,8711
2359,所羅門,16,0,16,陽信-石牌,2024-10-23,8711
3494,誠研,15,0,15,陽信-石牌,2024-10-23,8711
8473,山林水,15,0,15,陽信-石牌,2024-10-23,8711
3481,群創,37,23,14,陽信-石牌,2024-10-23,8711
020034,元大IC設計N,14,0,14,陽信-石牌,2024-10-23,8711
1714,和桐,13,0,13,陽信-石牌,2024-10-23,8711
2618,長榮航,55,42,13,陽信-石牌,2024-10-23,8711
3710,連展投控,12,0,12,陽信-石牌,2024-10-23,8711
3715,定穎投控,33,21,12,陽信-石牌,2024-10-23,8711
6151,晉倫,14,2,12,陽信-石牌,2024-10-23,8711
6197,佳必琪,21,9,12,陽信-石牌,2024-10-23,8711
00900,富邦特選高股息30,11,0,11,陽信-石牌,2024-10-23,8711
6541,泰福-KY,11,0,11,陽信-石牌,2024-10-23,8711
00878,國泰永續高股息,11,1,10,陽信-石牌,2024-10-23,8711
3041,揚智,10,0,10,陽信-石牌,2024-10-23,8711
1905,華紙,10,0,10,陽信-石牌,2024-10-23,8711
2371,大同,17,7,10,陽信-石牌,2024-10-23,8711
2548,華固,10,0,10,陽信-石牌,2024-10-23,8711
6425,易發,10,0,10,陽信-石牌,2024-10-23,8711
6491,晶碩,11,1,10,陽信-石牌,2024-10-23,8711
2356,英業達,11,2,9,陽信-石牌,2024-10-23,8711
2426,鼎元,15,6,9,陽信-石牌,2024-10-23,8711
2542,興富發,10,1,9,陽信-石牌,2024-10-23,8711
5475,德宏,9,0,9,陽信-石牌,2024-10-23,8711
2383,台光電,11,2,9,陽信-石牌,2024-10-23,8711
00912,中信臺灣智慧50,8,0,8,陽信-石牌,2024-10-23,8711
00929,復華台灣科技優息,249,2,247,陽信-石牌,2024-10-24,8711
00665L,富邦�琤肭磪囓�2,167,12,155,陽信-石牌,2024-10-24,8711
2354,鴻準,197,95,102,陽信-石牌,2024-10-24,8711
5905,南仁湖,72,1,71,陽信-石牌,2024-10-24,8711
3715,定穎投控,65,7,58,陽信-石牌,2024-10-24,8711
2317,鴻海,81,23,58,陽信-石牌,2024-10-24,8711
00937B,群益ESG投等債20,82,25,57,陽信-石牌,2024-10-24,8711
3450,聯鈞,78,31,47,陽信-石牌,2024-10-24,8711
1802,台玻,54,7,47,陽信-石牌,2024-10-24,8711
00688L,國泰20年美債正2,45,0,45,陽信-石牌,2024-10-24,8711
2405,輔信,45,1,44,陽信-石牌,2024-10-24,8711
00959B,大華投等美債15Y+,40,0,40,陽信-石牌,2024-10-24,8711
6152,百一,35,0,35,陽信-石牌,2024-10-24,8711
00919,群益台灣精選高息,34,0,34,陽信-石牌,2024-10-24,8711
2601,益航,30,0,30,陽信-石牌,2024-10-24,8711
2399,映泰,106,78,28,陽信-石牌,2024-10-24,8711
3019,亞光,29,2,27,陽信-石牌,2024-10-24,8711
00878,國泰永續高股息,31,6,25,陽信-石牌,2024-10-24,8711
2371,大同,24,0,24,陽信-石牌,2024-10-24,8711
3209,全科,24,0,24,陽信-石牌,2024-10-24,8711
3167,大量,24,1,23,陽信-石牌,2024-10-24,8711
2382,廣達,24,3,21,陽信-石牌,2024-10-24,8711
0050,元大台灣50,24,3,21,陽信-石牌,2024-10-24,8711
2312,金寶,37,16,21,陽信-石牌,2024-10-24,8711
2369,菱生,30,9,21,陽信-石牌,2024-10-24,8711
3689,湧德,23,2,21,陽信-石牌,2024-10-24,8711
2303,聯電,21,0,21,陽信-石牌,2024-10-24,8711
00637L,元大滬深300正2,21,1,20,陽信-石牌,2024-10-24,8711
6753,龍德造船,20,0,20,陽信-石牌,2024-10-24,8711
1447,力鵬,20,1,19,陽信-石牌,2024-10-24,8711
00948B,中信優息投資級債,17,0,17,陽信-石牌,2024-10-24,8711
02001L,富邦蘋果正二N,17,0,17,陽信-石牌,2024-10-24,8711
3483,力致,17,0,17,陽信-石牌,2024-10-24,8711
4979,華星光,17,1,16,陽信-石牌,2024-10-24,8711
8064,東捷,33,17,16,陽信-石牌,2024-10-24,8711
00753L,中信中國50正2,15,0,15,陽信-石牌,2024-10-24,8711
00712,復華富時不動產,15,0,15,陽信-石牌,2024-10-24,8711
2444,兆勁,15,0,15,陽信-石牌,2024-10-24,8711
00632R,元大台灣50反1,14,0,14,陽信-石牌,2024-10-24,8711
3083,網龍,14,0,14,陽信-石牌,2024-10-24,8711
3149,正達,15,1,14,陽信-石牌,2024-10-24,8711
0056,元大高股息,16,3,13,陽信-石牌,2024-10-24,8711
1721,三晃,16,3,13,陽信-石牌,2024-10-24,8711
3294,英濟,13,0,13,陽信-石牌,2024-10-24,8711
1503,士電,14,2,12,陽信-石牌,2024-10-24,8711
2367,燿華,12,0,12,陽信-石牌,2024-10-24,8711
2515,中工,12,0,12,陽信-石牌,2024-10-24,8711
3481,群創,20,8,12,陽信-石牌,2024-10-24,8711
6239,力成,12,0,12,陽信-石牌,2024-10-24,8711
6270,倍微,12,0,12,陽信-石牌,2024-10-24,8711
2646,星宇航空,1045,250,795,陽信-石牌,2024-10-25,8711
00632R,元大台灣50反1,768,100,668,陽信-石牌,2024-10-25,8711
2887,台新金,200,1,199,陽信-石牌,2024-10-25,8711
00937B,群益ESG投等債20,381,280,101,陽信-石牌,2024-10-25,8711
00673R,期元大S＆P原油反1,82,0,82,陽信-石牌,2024-10-25,8711
2888,新光金,86,14,72,陽信-石牌,2024-10-25,8711
2313,華通,51,1,50,陽信-石牌,2024-10-25,8711
1314,中石化,40,0,40,陽信-石牌,2024-10-25,8711
00929,復華台灣科技優息,46,7,39,陽信-石牌,2024-10-25,8711
00687B,國泰20年美債,38,1,37,陽信-石牌,2024-10-25,8711
2369,菱生,34,2,32,陽信-石牌,2024-10-25,8711
2880,華南金,30,0,30,陽信-石牌,2024-10-25,8711
6116,彩晶,31,4,27,陽信-石牌,2024-10-25,8711
00887,永豐中國科技50大,25,0,25,陽信-石牌,2024-10-25,8711
1595,川寶,23,2,21,陽信-石牌,2024-10-25,8711
00959B,大華投等美債15Y+,20,0,20,陽信-石牌,2024-10-25,8711
2352,佳世達,20,0,20,陽信-石牌,2024-10-25,8711
2548,華固,20,0,20,陽信-石牌,2024-10-25,8711
2337,旺宏,20,1,19,陽信-石牌,2024-10-25,8711
2353,宏��,18,0,18,陽信-石牌,2024-10-25,8711
3062,建漢,34,19,15,陽信-石牌,2024-10-25,8711
3013,晟銘電,24,9,15,陽信-石牌,2024-10-25,8711
4743,合一,15,0,15,陽信-石牌,2024-10-25,8711
1815,富喬,16,2,14,陽信-石牌,2024-10-25,8711
2302,麗正,20,6,14,陽信-石牌,2024-10-25,8711
1802,台玻,14,1,13,陽信-石牌,2024-10-25,8711
2062,橋椿,14,1,13,陽信-石牌,2024-10-25,8711
6257,矽格,14,1,13,陽信-石牌,2024-10-25,8711
1711,永光,17,5,12,陽信-石牌,2024-10-25,8711
2464,盟立,21,9,12,陽信-石牌,2024-10-25,8711
6142,友勁,13,1,12,陽信-石牌,2024-10-25,8711
2303,聯電,11,0,11,陽信-石牌,2024-10-25,8711
3060,銘異,13,2,11,陽信-石牌,2024-10-25,8711
8404,百和興業-KY,11,0,11,陽信-石牌,2024-10-25,8711
00655L,國泰中國A50正2,10,0,10,陽信-石牌,2024-10-25,8711
2323,中環,10,0,10,陽信-石牌,2024-10-25,8711
2374,佳能,12,2,10,陽信-石牌,2024-10-25,8711
2509,全坤建,10,0,10,陽信-石牌,2024-10-25,8711
2834,臺企銀,10,0,10,陽信-石牌,2024-10-25,8711
3494,誠研,10,0,10,陽信-石牌,2024-10-25,8711
6224,聚鼎,10,0,10,陽信-石牌,2024-10-25,8711
8222,寶一,10,0,10,陽信-石牌,2024-10-25,8711
3029,零壹,11,2,9,陽信-石牌,2024-10-25,8711
6546,正基,9,0,9,陽信-石牌,2024-10-25,8711
8043,蜜望實,11,2,9,陽信-石牌,2024-10-25,8711
3189,景碩,10,1,9,陽信-石牌,2024-10-25,8711
3105,穩懋,8,0,8,陽信-石牌,2024-10-25,8711
6547,高端疫苗,8,0,8,陽信-石牌,2024-10-25,8711
2427,三商電,7,0,7,陽信-石牌,2024-10-25,8711
3630,新鉅科,7,0,7,陽信-石牌,2024-10-25,8711
00671R,富邦NASDAQ反1,600,0,600,陽信-石牌,2024-10-28,8711
00632R,元大台灣50反1,492,120,372,陽信-石牌,2024-10-28,8711
00878,國泰永續高股息,237,0,237,陽信-石牌,2024-10-28,8711
00937B,群益ESG投等債20,224,13,211,陽信-石牌,2024-10-28,8711
00706L,期元大S＆P日圓正2,87,10,77,陽信-石牌,2024-10-28,8711
2646,星宇航空,95,29,66,陽信-石牌,2024-10-28,8711
00857B,永豐20年美公債,60,0,60,陽信-石牌,2024-10-28,8711
00712,復華富時不動產,48,0,48,陽信-石牌,2024-10-28,8711
2489,瑞軒,45,0,45,陽信-石牌,2024-10-28,8711
2615,萬海,88,45,43,陽信-石牌,2024-10-28,8711
2337,旺宏,40,0,40,陽信-石牌,2024-10-28,8711
9914,美利達,50,13,37,陽信-石牌,2024-10-28,8711
5202,力新,52,17,35,陽信-石牌,2024-10-28,8711
2303,聯電,36,1,35,陽信-石牌,2024-10-28,8711
00687B,國泰20年美債,33,0,33,陽信-石牌,2024-10-28,8711
00688L,國泰20年美債正2,30,1,29,陽信-石牌,2024-10-28,8711
3062,建漢,29,2,27,陽信-石牌,2024-10-28,8711
00929,復華台灣科技優息,27,1,26,陽信-石牌,2024-10-28,8711
3715,定穎投控,24,0,24,陽信-石牌,2024-10-28,8711
3481,群創,35,13,22,陽信-石牌,2024-10-28,8711
3689,湧德,22,0,22,陽信-石牌,2024-10-28,8711
00948B,中信優息投資級債,21,0,21,陽信-石牌,2024-10-28,8711
2444,兆勁,21,0,21,陽信-石牌,2024-10-28,8711
00715L,期街口布蘭特正2,20,0,20,陽信-石牌,2024-10-28,8711
00795B,中信美國公債20年,20,0,20,陽信-石牌,2024-10-28,8711
00940,元大台灣價值高息,20,0,20,陽信-石牌,2024-10-28,8711
6152,百一,20,0,20,陽信-石牌,2024-10-28,8711
00679B,元大美債20年,19,0,19,陽信-石牌,2024-10-28,8711
911622,泰聚亨-DR,19,0,19,陽信-石牌,2024-10-28,8711
2369,菱生,18,0,18,陽信-石牌,2024-10-28,8711
3013,晟銘電,57,40,17,陽信-石牌,2024-10-28,8711
2330,台積電,22,5,17,陽信-石牌,2024-10-28,8711
00900,富邦特選高股息30,16,0,16,陽信-石牌,2024-10-28,8711
00773B,中信優先金融債,16,0,16,陽信-石牌,2024-10-28,8711
2356,英業達,18,3,15,陽信-石牌,2024-10-28,8711
00680L,元大美債20正2,15,0,15,陽信-石牌,2024-10-28,8711
00887,永豐中國科技50大,20,5,15,陽信-石牌,2024-10-28,8711
00751B,元大AAA至A公司債,15,0,15,陽信-石牌,2024-10-28,8711
00919,群益台灣精選高息,14,0,14,陽信-石牌,2024-10-28,8711
6438,迅得,16,2,14,陽信-石牌,2024-10-28,8711
3231,緯創,47,35,12,陽信-石牌,2024-10-28,8711
00673R,期元大S＆P原油反1,12,0,12,陽信-石牌,2024-10-28,8711
6207,雷科,12,0,12,陽信-石牌,2024-10-28,8711
1714,和桐,11,0,11,陽信-石牌,2024-10-28,8711
00772B,中信高評級公司債,10,0,10,陽信-石牌,2024-10-28,8711
00753L,中信中國50正2,10,0,10,陽信-石牌,2024-10-28,8711
1474,弘裕,10,0,10,陽信-石牌,2024-10-28,8711
1909,榮成,10,0,10,陽信-石牌,2024-10-28,8711
2062,橋椿,12,2,10,陽信-石牌,2024-10-28,8711
2316,楠梓電,10,0,10,陽信-石牌,2024-10-28,8711
00953B,群益優選非投等債,691,100,591,陽信-石牌,2024-10-29,8711
00632R,元大台灣50反1,801,636,165,陽信-石牌,2024-10-29,8711
2892,第一金,105,0,105,陽信-石牌,2024-10-29,8711
00648R,元大S＆P500反1,90,0,90,陽信-石牌,2024-10-29,8711
2431,聯昌,69,0,69,陽信-石牌,2024-10-29,8711
2882,國泰金,65,0,65,陽信-石牌,2024-10-29,8711
00929,復華台灣科技優息,65,1,64,陽信-石牌,2024-10-29,8711
9105,泰金寶-DR,58,0,58,陽信-石牌,2024-10-29,8711
00919,群益台灣精選高息,58,2,56,陽信-石牌,2024-10-29,8711
00655L,國泰中國A50正2,60,10,50,陽信-石牌,2024-10-29,8711
2439,美律,50,1,49,陽信-石牌,2024-10-29,8711
00715L,期街口布蘭特正2,50,5,45,陽信-石牌,2024-10-29,8711
2303,聯電,40,4,36,陽信-石牌,2024-10-29,8711
2409,友達,35,2,33,陽信-石牌,2024-10-29,8711
2489,瑞軒,32,3,29,陽信-石牌,2024-10-29,8711
2317,鴻海,106,83,23,陽信-石牌,2024-10-29,8711
00940,元大台灣價值高息,22,0,22,陽信-石牌,2024-10-29,8711
00922,國泰台灣領袖50,21,0,21,陽信-石牌,2024-10-29,8711
00918,大華優利高填息30,20,0,20,陽信-石牌,2024-10-29,8711
1447,力鵬,20,0,20,陽信-石牌,2024-10-29,8711
2392,正崴,20,0,20,陽信-石牌,2024-10-29,8711
2330,台積電,25,5,20,陽信-石牌,2024-10-29,8711
2313,華通,21,2,19,陽信-石牌,2024-10-29,8711
00687B,國泰20年美債,17,2,15,陽信-石牌,2024-10-29,8711
00878,國泰永續高股息,15,0,15,陽信-石牌,2024-10-29,8711
2642,宅配通,15,0,15,陽信-石牌,2024-10-29,8711
8107,大億金茂,21,6,15,陽信-石牌,2024-10-29,8711
2344,華邦電,15,1,14,陽信-石牌,2024-10-29,8711
6438,迅得,13,1,12,陽信-石牌,2024-10-29,8711
00946,群益科技高息成長,14,3,11,陽信-石牌,2024-10-29,8711
00887,永豐中國科技50大,12,1,11,陽信-石牌,2024-10-29,8711
2515,中工,11,0,11,陽信-石牌,2024-10-29,8711
3711,日月光投控,11,0,11,陽信-石牌,2024-10-29,8711
4720,德淵,11,0,11,陽信-石牌,2024-10-29,8711
2880,華南金,11,0,11,陽信-石牌,2024-10-29,8711
2646,星宇航空,47,37,10,陽信-石牌,2024-10-29,8711
3374,精材,34,24,10,陽信-石牌,2024-10-29,8711
00635U,期元大S＆P黃金,10,0,10,陽信-石牌,2024-10-29,8711
00907,永豐優息存股,10,0,10,陽信-石牌,2024-10-29,8711
1440,南紡,10,0,10,陽信-石牌,2024-10-29,8711
2316,楠梓電,10,0,10,陽信-石牌,2024-10-29,8711
2498,宏達電,10,0,10,陽信-石牌,2024-10-29,8711
2867,三商壽,16,6,10,陽信-石牌,2024-10-29,8711
3205,佰研,10,0,10,陽信-石牌,2024-10-29,8711
3710,連展投控,10,0,10,陽信-石牌,2024-10-29,8711
4174,浩鼎,10,0,10,陽信-石牌,2024-10-29,8711
4974,亞泰,11,1,10,陽信-石牌,2024-10-29,8711
6133,金橋,12,2,10,陽信-石牌,2024-10-29,8711
6152,百一,10,0,10,陽信-石牌,2024-10-29,8711
8111,立��,22,12,10,陽信-石牌,2024-10-29,8711
00715L,期街口布蘭特正2,165,45,120,陽信-石牌,2024-10-30,8711
2337,旺宏,106,0,106,陽信-石牌,2024-10-30,8711
2646,星宇航空,118,17,101,陽信-石牌,2024-10-30,8711
00632R,元大台灣50反1,90,20,70,陽信-石牌,2024-10-30,8711
2888,新光金,63,0,63,陽信-石牌,2024-10-30,8711
00671R,富邦NASDAQ反1,50,0,50,陽信-石牌,2024-10-30,8711
2887,台新金,50,0,50,陽信-石牌,2024-10-30,8711
2303,聯電,48,2,46,陽信-石牌,2024-10-30,8711
3013,晟銘電,102,60,42,陽信-石牌,2024-10-30,8711
6147,頎邦,36,0,36,陽信-石牌,2024-10-30,8711
00648R,元大S＆P500反1,30,0,30,陽信-石牌,2024-10-30,8711
3481,群創,67,39,28,陽信-石牌,2024-10-30,8711
6438,迅得,26,0,26,陽信-石牌,2024-10-30,8711
2498,宏達電,24,0,24,陽信-石牌,2024-10-30,8711
2313,華通,22,1,21,陽信-石牌,2024-10-30,8711
00946,群益科技高息成長,20,0,20,陽信-石牌,2024-10-30,8711
1447,力鵬,20,0,20,陽信-石牌,2024-10-30,8711
2344,華邦電,20,0,20,陽信-石牌,2024-10-30,8711
2409,友達,20,0,20,陽信-石牌,2024-10-30,8711
2537,聯上發,20,0,20,陽信-石牌,2024-10-30,8711
1516,川飛,18,0,18,陽信-石牌,2024-10-30,8711
00929,復華台灣科技優息,22,5,17,陽信-石牌,2024-10-30,8711
2442,新美齊,18,1,17,陽信-石牌,2024-10-30,8711
6257,矽格,15,0,15,陽信-石牌,2024-10-30,8711
00882,中信中國高股息,13,0,13,陽信-石牌,2024-10-30,8711
8027,鈦昇,17,4,13,陽信-石牌,2024-10-30,8711
4919,新唐,37,25,12,陽信-石牌,2024-10-30,8711
00637L,元大滬深300正2,15,3,12,陽信-石牌,2024-10-30,8711
2477,美隆電,13,1,12,陽信-石牌,2024-10-30,8711
6288,聯嘉,12,0,12,陽信-石牌,2024-10-30,8711
2327,國巨,11,0,11,陽信-石牌,2024-10-30,8711
1528,恩德,38,27,11,陽信-石牌,2024-10-30,8711
1815,富喬,11,0,11,陽信-石牌,2024-10-30,8711
3450,聯鈞,32,21,11,陽信-石牌,2024-10-30,8711
4564,元翎,11,0,11,陽信-石牌,2024-10-30,8711
00712,復華富時不動產,10,0,10,陽信-石牌,2024-10-30,8711
00919,群益台灣精選高息,16,6,10,陽信-石牌,2024-10-30,8711
0061,元大寶滬深,10,0,10,陽信-石牌,2024-10-30,8711
00936,台新永續高息中小,10,0,10,陽信-石牌,2024-10-30,8711
1314,中石化,10,0,10,陽信-石牌,2024-10-30,8711
1568,倉佑,12,2,10,陽信-石牌,2024-10-30,8711
2367,燿華,10,0,10,陽信-石牌,2024-10-30,8711
2387,精元,10,0,10,陽信-石牌,2024-10-30,8711
2881,富邦金,10,0,10,陽信-石牌,2024-10-30,8711
3029,零壹,10,0,10,陽信-石牌,2024-10-30,8711
6126,信音,10,0,10,陽信-石牌,2024-10-30,8711
8105,凌巨,10,0,10,陽信-石牌,2024-10-30,8711
4989,榮科,9,0,9,陽信-石牌,2024-10-30,8711
2634,漢翔,8,0,8,陽信-石牌,2024-10-30,8711
6108,競國,13,5,8,陽信-石牌,2024-10-30,8711
00632R,元大台灣50反1,2102,100,2002,陽信-石牌,2024-11-01,8711
2646,星宇航空,402,180,222,陽信-石牌,2024-11-01,8711
00937B,群益ESG投等債20,214,3,211,陽信-石牌,2024-11-01,8711
2891,中信金,137,5,132,陽信-石牌,2024-11-01,8711
2303,聯電,75,3,72,陽信-石牌,2024-11-01,8711
2354,鴻準,149,83,66,陽信-石牌,2024-11-01,8711
2353,宏��,48,0,48,陽信-石牌,2024-11-01,8711
00878,國泰永續高股息,46,0,46,陽信-石牌,2024-11-01,8711
3360,尚立,41,0,41,陽信-石牌,2024-11-01,8711
2337,旺宏,41,10,31,陽信-石牌,2024-11-01,8711
2882,國泰金,26,0,26,陽信-石牌,2024-11-01,8711
5202,力新,34,8,26,陽信-石牌,2024-11-01,8711
00919,群益台灣精選高息,35,11,24,陽信-石牌,2024-11-01,8711
5452,佶優,25,2,23,陽信-石牌,2024-11-01,8711
6108,競國,23,0,23,陽信-石牌,2024-11-01,8711
2317,鴻海,70,47,23,陽信-石牌,2024-11-01,8711
00725B,國泰投資級公司債,21,0,21,陽信-石牌,2024-11-01,8711
00907,永豐優息存股,21,0,21,陽信-石牌,2024-11-01,8711
2409,友達,29,8,21,陽信-石牌,2024-11-01,8711
00929,復華台灣科技優息,32,11,21,陽信-石牌,2024-11-01,8711
00946,群益科技高息成長,20,1,19,陽信-石牌,2024-11-01,8711
3686,達能,20,1,19,陽信-石牌,2024-11-01,8711
8421,旭源,19,0,19,陽信-石牌,2024-11-01,8711
3062,建漢,18,1,17,陽信-石牌,2024-11-01,8711
00712,復華富時不動產,16,0,16,陽信-石牌,2024-11-01,8711
1540,喬福,16,0,16,陽信-石牌,2024-11-01,8711
3481,群創,16,0,16,陽信-石牌,2024-11-01,8711
0056,元大高股息,14,0,14,陽信-石牌,2024-11-01,8711
8011,台通,13,0,13,陽信-石牌,2024-11-01,8711
2330,台積電,17,5,12,陽信-石牌,2024-11-01,8711
00882,中信中國高股息,12,0,12,陽信-石牌,2024-11-01,8711
2886,兆豐金,12,0,12,陽信-石牌,2024-11-01,8711
00673R,期元大S＆P原油反1,10,0,10,陽信-石牌,2024-11-01,8711
00918,大華優利高填息30,11,1,10,陽信-石牌,2024-11-01,8711
1802,台玻,10,0,10,陽信-石牌,2024-11-01,8711
2014,中鴻,10,0,10,陽信-石牌,2024-11-01,8711
3048,益登,10,0,10,陽信-石牌,2024-11-01,8711
5438,東友,13,3,10,陽信-石牌,2024-11-01,8711
00679B,元大美債20年,10,1,9,陽信-石牌,2024-11-01,8711
1477,聚陽,8,0,8,陽信-石牌,2024-11-01,8711
6185,幃翔,8,0,8,陽信-石牌,2024-11-01,8711
8069,元太,7,0,7,陽信-石牌,2024-11-01,8711
00953B,群益優選非投等債,7,0,7,陽信-石牌,2024-11-01,8711
2408,南亞科,7,0,7,陽信-石牌,2024-11-01,8711
2867,三商壽,7,1,6,陽信-石牌,2024-11-01,8711
5243,乙盛-KY,6,0,6,陽信-石牌,2024-11-01,8711
6153,嘉聯益,6,0,6,陽信-石牌,2024-11-01,8711
8044,網家,6,0,6,陽信-石牌,2024-11-01,8711
8404,百和興業-KY,6,0,6,陽信-石牌,2024-11-01,8711
006208,富邦台50,6,1,5,陽信-石牌,2024-11-01,8711
00937B,群益ESG投等債20,136,10,126,陽信-石牌,2024-11-04,8711
2337,旺宏,106,0,106,陽信-石牌,2024-11-04,8711
00751B,元大AAA至A公司債,102,0,102,陽信-石牌,2024-11-04,8711
00878,國泰永續高股息,82,0,82,陽信-石牌,2024-11-04,8711
2442,新美齊,72,0,72,陽信-石牌,2024-11-04,8711
00712,復華富時不動產,59,0,59,陽信-石牌,2024-11-04,8711
6451,訊芯-KY,63,8,55,陽信-石牌,2024-11-04,8711
2409,友達,43,0,43,陽信-石牌,2024-11-04,8711
2609,陽明,66,30,36,陽信-石牌,2024-11-04,8711
00936,台新永續高息中小,40,5,35,陽信-石牌,2024-11-04,8711
3019,亞光,37,2,35,陽信-石牌,2024-11-04,8711
3290,東浦,33,0,33,陽信-石牌,2024-11-04,8711
2646,星宇航空,337,305,32,陽信-石牌,2024-11-04,8711
3049,精金,29,4,25,陽信-石牌,2024-11-04,8711
4903,聯光通,32,8,24,陽信-石牌,2024-11-04,8711
00679B,元大美債20年,23,0,23,陽信-石牌,2024-11-04,8711
2303,聯電,23,0,23,陽信-石牌,2024-11-04,8711
00940,元大台灣價值高息,22,0,22,陽信-石牌,2024-11-04,8711
6108,競國,23,1,22,陽信-石牌,2024-11-04,8711
00929,復華台灣科技優息,57,36,21,陽信-石牌,2024-11-04,8711
00688L,國泰20年美債正2,21,0,21,陽信-石牌,2024-11-04,8711
00637L,元大滬深300正2,22,2,20,陽信-石牌,2024-11-04,8711
00671R,富邦NASDAQ反1,20,0,20,陽信-石牌,2024-11-04,8711
00933B,國泰10Y+金融債,20,0,20,陽信-石牌,2024-11-04,8711
00939,統一台灣高息動能,20,0,20,陽信-石牌,2024-11-04,8711
2349,錸德,20,0,20,陽信-石牌,2024-11-04,8711
2498,宏達電,20,1,19,陽信-石牌,2024-11-04,8711
2524,京城,19,2,17,陽信-石牌,2024-11-04,8711
3673,TPK-KY,15,1,14,陽信-石牌,2024-11-04,8711
6278,台表科,14,0,14,陽信-石牌,2024-11-04,8711
5202,力新,13,0,13,陽信-石牌,2024-11-04,8711
00943,兆豐電子高息等權,12,0,12,陽信-石牌,2024-11-04,8711
3105,穩懋,12,0,12,陽信-石牌,2024-11-04,8711
1449,佳和,11,0,11,陽信-石牌,2024-11-04,8711
4919,新唐,12,2,10,陽信-石牌,2024-11-04,8711
00725B,國泰投資級公司債,10,0,10,陽信-石牌,2024-11-04,8711
1815,富喬,10,0,10,陽信-石牌,2024-11-04,8711
2017,官田鋼,10,0,10,陽信-石牌,2024-11-04,8711
2392,正崴,10,0,10,陽信-石牌,2024-11-04,8711
2401,凌陽,11,1,10,陽信-石牌,2024-11-04,8711
2444,兆勁,10,0,10,陽信-石牌,2024-11-04,8711
2488,漢平,10,0,10,陽信-石牌,2024-11-04,8711
4174,浩鼎,24,14,10,陽信-石牌,2024-11-04,8711
4961,天鈺,10,0,10,陽信-石牌,2024-11-04,8711
6109,亞元,10,0,10,陽信-石牌,2024-11-04,8711
6125,廣運,10,0,10,陽信-石牌,2024-11-04,8711
6288,聯嘉,10,0,10,陽信-石牌,2024-11-04,8711
3037,欣興,12,2,10,陽信-石牌,2024-11-04,8711
1316,上曜,9,0,9,陽信-石牌,2024-11-04,8711
2413,環科,10,1,9,陽信-石牌,2024-11-04,8711
00673R,期元大S＆P原油反1,105,0,105,陽信-石牌,2024-11-05,8711
00632R,元大台灣50反1,100,0,100,陽信-石牌,2024-11-05,8711
2615,萬海,308,224,84,陽信-石牌,2024-11-05,8711
2646,星宇航空,112,47,65,陽信-石牌,2024-11-05,8711
2464,盟立,66,1,65,陽信-石牌,2024-11-05,8711
2637,慧洋-KY,55,0,55,陽信-石牌,2024-11-05,8711
9105,泰金寶-DR,59,10,49,陽信-石牌,2024-11-05,8711
3062,建漢,49,5,44,陽信-石牌,2024-11-05,8711
00679B,元大美債20年,51,10,41,陽信-石牌,2024-11-05,8711
00680L,元大美債20正2,36,0,36,陽信-石牌,2024-11-05,8711
2337,旺宏,30,1,29,陽信-石牌,2024-11-05,8711
6451,訊芯-KY,33,4,29,陽信-石牌,2024-11-05,8711
2610,華航,25,0,25,陽信-石牌,2024-11-05,8711
00878,國泰永續高股息,24,0,24,陽信-石牌,2024-11-05,8711
3711,日月光投控,25,1,24,陽信-石牌,2024-11-05,8711
3047,訊舟,22,0,22,陽信-石牌,2024-11-05,8711
3202,樺晟,22,0,22,陽信-石牌,2024-11-05,8711
8105,凌巨,20,0,20,陽信-石牌,2024-11-05,8711
3211,順達,20,1,19,陽信-石牌,2024-11-05,8711
2354,鴻準,102,84,18,陽信-石牌,2024-11-05,8711
00937B,群益ESG投等債20,15,0,15,陽信-石牌,2024-11-05,8711
3673,TPK-KY,15,0,15,陽信-石牌,2024-11-05,8711
00919,群益台灣精選高息,57,43,14,陽信-石牌,2024-11-05,8711
6108,競國,11,0,11,陽信-石牌,2024-11-05,8711
00915,凱基優選高股息30,10,0,10,陽信-石牌,2024-11-05,8711
00931B,統一美債20年,10,0,10,陽信-石牌,2024-11-05,8711
1714,和桐,10,0,10,陽信-石牌,2024-11-05,8711
2401,凌陽,10,0,10,陽信-石牌,2024-11-05,8711
2482,連宇,10,0,10,陽信-石牌,2024-11-05,8711
8429,金麗-KY,10,0,10,陽信-石牌,2024-11-05,8711
00929,復華台灣科技優息,17,8,9,陽信-石牌,2024-11-05,8711
3481,群創,10,1,9,陽信-石牌,2024-11-05,8711
2881,富邦金,10,2,8,陽信-石牌,2024-11-05,8711
1528,恩德,28,20,8,陽信-石牌,2024-11-05,8711
2369,菱生,8,0,8,陽信-石牌,2024-11-05,8711
3689,湧德,11,3,8,陽信-石牌,2024-11-05,8711
4174,浩鼎,7,0,7,陽信-石牌,2024-11-05,8711
4726,永昕,7,0,7,陽信-石牌,2024-11-05,8711
6191,精成科,6,0,6,陽信-石牌,2024-11-05,8711
6530,創威,41,35,6,陽信-石牌,2024-11-05,8711
6547,高端疫苗,6,0,6,陽信-石牌,2024-11-05,8711
00712,復華富時不動產,5,0,5,陽信-石牌,2024-11-05,8711
1409,新纖,5,0,5,陽信-石牌,2024-11-05,8711
1595,川寶,7,2,5,陽信-石牌,2024-11-05,8711
1597,直得,6,1,5,陽信-石牌,2024-11-05,8711
2328,廣宇,5,0,5,陽信-石牌,2024-11-05,8711
2520,冠德,13,8,5,陽信-石牌,2024-11-05,8711
2745,五福,5,0,5,陽信-石牌,2024-11-05,8711
2834,臺企銀,5,0,5,陽信-石牌,2024-11-05,8711
3219,倚強科,5,0,5,陽信-石牌,2024-11-05,8711
00937B,群益ESG投等債20,1060,589,471,陽信-石牌,2024-11-06,8711
00687B,國泰20年美債,342,2,340,陽信-石牌,2024-11-06,8711
2354,鴻準,189,101,88,陽信-石牌,2024-11-06,8711
2615,萬海,197,139,58,陽信-石牌,2024-11-06,8711
00857B,永豐20年美公債,43,0,43,陽信-石牌,2024-11-06,8711
5452,佶優,39,1,38,陽信-石牌,2024-11-06,8711
2303,聯電,43,6,37,陽信-石牌,2024-11-06,8711
2601,益航,33,0,33,陽信-石牌,2024-11-06,8711
3149,正達,62,31,31,陽信-石牌,2024-11-06,8711
5388,中磊,30,0,30,陽信-石牌,2024-11-06,8711
6108,競國,26,0,26,陽信-石牌,2024-11-06,8711
00688L,國泰20年美債正2,43,19,24,陽信-石牌,2024-11-06,8711
3202,樺晟,24,0,24,陽信-石牌,2024-11-06,8711
2881,富邦金,23,0,23,陽信-石牌,2024-11-06,8711
4958,臻鼎-KY,41,20,21,陽信-石牌,2024-11-06,8711
00679B,元大美債20年,20,0,20,陽信-石牌,2024-11-06,8711
3049,精金,20,0,20,陽信-石牌,2024-11-06,8711
6668,中揚光,20,0,20,陽信-石牌,2024-11-06,8711
1595,川寶,18,0,18,陽信-石牌,2024-11-06,8711
8027,鈦昇,24,6,18,陽信-石牌,2024-11-06,8711
5347,世界,20,3,17,陽信-石牌,2024-11-06,8711
2409,友達,25,10,15,陽信-石牌,2024-11-06,8711
6451,訊芯-KY,22,7,15,陽信-石牌,2024-11-06,8711
00725B,國泰投資級公司債,12,0,12,陽信-石牌,2024-11-06,8711
3290,東浦,12,0,12,陽信-石牌,2024-11-06,8711
5202,力新,27,15,12,陽信-石牌,2024-11-06,8711
2062,橋椿,22,11,11,陽信-石牌,2024-11-06,8711
2316,楠梓電,11,0,11,陽信-石牌,2024-11-06,8711
4919,新唐,21,11,10,陽信-石牌,2024-11-06,8711
4726,永昕,10,0,10,陽信-石牌,2024-11-06,8711
6757,台灣虎航,10,0,10,陽信-石牌,2024-11-06,8711
2101,南港,9,0,9,陽信-石牌,2024-11-06,8711
2618,長榮航,10,1,9,陽信-石牌,2024-11-06,8711
1519,華城,9,1,8,陽信-石牌,2024-11-06,8711
1721,三晃,8,0,8,陽信-石牌,2024-11-06,8711
6472,保瑞,8,0,8,陽信-石牌,2024-11-06,8711
6547,高端疫苗,8,0,8,陽信-石牌,2024-11-06,8711
8249,菱光,80,72,8,陽信-石牌,2024-11-06,8711
6438,迅得,12,5,7,陽信-石牌,2024-11-06,8711
1905,華紙,11,5,6,陽信-石牌,2024-11-06,8711
2070,精湛,6,0,6,陽信-石牌,2024-11-06,8711
2429,銘旺科,6,0,6,陽信-石牌,2024-11-06,8711
4979,華星光,12,6,6,陽信-石牌,2024-11-06,8711
00930,永豐ESG低碳高息,5,0,5,陽信-石牌,2024-11-06,8711
00753L,中信中國50正2,5,0,5,陽信-石牌,2024-11-06,8711
00673R,期元大S＆P原油反1,5,0,5,陽信-石牌,2024-11-06,8711
00948B,中信優息投資級債,5,0,5,陽信-石牌,2024-11-06,8711
2390,云辰,5,0,5,陽信-石牌,2024-11-06,8711
2417,圓剛,5,0,5,陽信-石牌,2024-11-06,8711
2745,五福,5,0,5,陽信-石牌,2024-11-06,8711
00878,國泰永續高股息,242,3,239,陽信-石牌,2024-11-07,8711
00931B,統一美債20年,221,0,221,陽信-石牌,2024-11-07,8711
00715L,期街口布蘭特正2,139,25,114,陽信-石牌,2024-11-07,8711
00706L,期元大S＆P日圓正2,98,0,98,陽信-石牌,2024-11-07,8711
00680L,元大美債20正2,97,0,97,陽信-石牌,2024-11-07,8711
2344,華邦電,53,2,51,陽信-石牌,2024-11-07,8711
00656R,國泰中國A50反1,50,0,50,陽信-石牌,2024-11-07,8711
2881,富邦金,50,0,50,陽信-石牌,2024-11-07,8711
3013,晟銘電,50,9,41,陽信-石牌,2024-11-07,8711
2888,新光金,41,10,31,陽信-石牌,2024-11-07,8711
1312,國喬,30,0,30,陽信-石牌,2024-11-07,8711
2890,永豐金,30,0,30,陽信-石牌,2024-11-07,8711
2303,聯電,37,10,27,陽信-石牌,2024-11-07,8711
3484,崧騰,27,0,27,陽信-石牌,2024-11-07,8711
5452,佶優,27,0,27,陽信-石牌,2024-11-07,8711
6763,綠界科技*,26,0,26,陽信-石牌,2024-11-07,8711
2489,瑞軒,25,2,23,陽信-石牌,2024-11-07,8711
00795B,中信美國公債20年,20,0,20,陽信-石牌,2024-11-07,8711
00885,富邦越南,20,0,20,陽信-石牌,2024-11-07,8711
3413,京鼎,29,10,19,陽信-石牌,2024-11-07,8711
5014,建錩,18,0,18,陽信-石牌,2024-11-07,8711
6288,聯嘉,32,16,16,陽信-石牌,2024-11-07,8711
2892,第一金,14,0,14,陽信-石牌,2024-11-07,8711
3060,銘異,19,5,14,陽信-石牌,2024-11-07,8711
2014,中鴻,13,0,13,陽信-石牌,2024-11-07,8711
3499,環天科,13,0,13,陽信-石牌,2024-11-07,8711
8070,長華*,18,6,12,陽信-石牌,2024-11-07,8711
6547,高端疫苗,13,1,12,陽信-石牌,2024-11-07,8711
3483,力致,15,4,11,陽信-石牌,2024-11-07,8711
8464,億豐,10,0,10,陽信-石牌,2024-11-07,8711
00940,元大台灣價值高息,10,0,10,陽信-石牌,2024-11-07,8711
00899,FT潔淨能源,10,0,10,陽信-石牌,2024-11-07,8711
00679B,元大美債20年,10,0,10,陽信-石牌,2024-11-07,8711
1515,力山,10,0,10,陽信-石牌,2024-11-07,8711
2444,兆勁,10,0,10,陽信-石牌,2024-11-07,8711
2887,台新金,15,5,10,陽信-石牌,2024-11-07,8711
3664,安瑞-KY,10,0,10,陽信-石牌,2024-11-07,8711
6235,華孚,10,0,10,陽信-石牌,2024-11-07,8711
6753,龍德造船,10,0,10,陽信-石牌,2024-11-07,8711
6757,台灣虎航,10,0,10,陽信-石牌,2024-11-07,8711
00688L,國泰20年美債正2,9,0,9,陽信-石牌,2024-11-07,8711
2419,仲琦,10,1,9,陽信-石牌,2024-11-07,8711
5347,世界,10,1,9,陽信-石牌,2024-11-07,8711
8069,元太,9,0,9,陽信-石牌,2024-11-07,8711
2467,志聖,8,0,8,陽信-石牌,2024-11-07,8711
4129,聯合,8,0,8,陽信-石牌,2024-11-07,8711
8404,百和興業-KY,8,0,8,陽信-石牌,2024-11-07,8711
2834,臺企銀,10,2,8,陽信-石牌,2024-11-07,8711
2601,益航,7,0,7,陽信-石牌,2024-11-07,8711
6244,茂迪,7,0,7,陽信-石牌,2024-11-07,8711
00632R,元大台灣50反1,1651,0,1651,陽信-石牌,2024-11-08,8711
00953B,群益優選非投等債,608,0,608,陽信-石牌,2024-11-08,8711
00918,大華優利高填息30,150,1,149,陽信-石牌,2024-11-08,8711
6182,合晶,151,5,146,陽信-石牌,2024-11-08,8711
00673R,期元大S＆P原油反1,105,0,105,陽信-石牌,2024-11-08,8711
2891,中信金,105,6,99,陽信-石牌,2024-11-08,8711
3062,建漢,78,11,67,陽信-石牌,2024-11-08,8711
00878,國泰永續高股息,58,0,58,陽信-石牌,2024-11-08,8711
2444,兆勁,56,0,56,陽信-石牌,2024-11-08,8711
2409,友達,40,0,40,陽信-石牌,2024-11-08,8711
3060,銘異,41,3,38,陽信-石牌,2024-11-08,8711
2419,仲琦,40,3,37,陽信-石牌,2024-11-08,8711
00943,兆豐電子高息等權,35,0,35,陽信-石牌,2024-11-08,8711
6116,彩晶,30,0,30,陽信-石牌,2024-11-08,8711
2354,鴻準,177,149,28,陽信-石牌,2024-11-08,8711
5309,系統電,24,0,24,陽信-石牌,2024-11-08,8711
6288,聯嘉,24,0,24,陽信-石牌,2024-11-08,8711
00679B,元大美債20年,33,11,22,陽信-石牌,2024-11-08,8711
6235,華孚,22,0,22,陽信-石牌,2024-11-08,8711
6763,綠界科技*,22,0,22,陽信-石牌,2024-11-08,8711
2312,金寶,28,7,21,陽信-石牌,2024-11-08,8711
6279,胡連,20,0,20,陽信-石牌,2024-11-08,8711
8107,大億金茂,20,0,20,陽信-石牌,2024-11-08,8711
2303,聯電,23,4,19,陽信-石牌,2024-11-08,8711
2101,南港,18,0,18,陽信-石牌,2024-11-08,8711
2646,星宇航空,17,0,17,陽信-石牌,2024-11-08,8711
2489,瑞軒,16,0,16,陽信-石牌,2024-11-08,8711
2543,皇昌,17,1,16,陽信-石牌,2024-11-08,8711
8110,華東,16,0,16,陽信-石牌,2024-11-08,8711
1711,永光,15,0,15,陽信-石牌,2024-11-08,8711
2363,矽統,32,17,15,陽信-石牌,2024-11-08,8711
2371,大同,17,2,15,陽信-石牌,2024-11-08,8711
3689,湧德,21,6,15,陽信-石牌,2024-11-08,8711
3714,富采,16,1,15,陽信-石牌,2024-11-08,8711
00945B,凱基美國非投等債,14,0,14,陽信-石牌,2024-11-08,8711
5243,乙盛-KY,14,0,14,陽信-石牌,2024-11-08,8711
6438,迅得,17,3,14,陽信-石牌,2024-11-08,8711
3362,先進光,13,0,13,陽信-石牌,2024-11-08,8711
2313,華通,19,7,12,陽信-石牌,2024-11-08,8711
2731,雄獅,12,0,12,陽信-石牌,2024-11-08,8711
3673,TPK-KY,12,0,12,陽信-石牌,2024-11-08,8711
2889,國票金,11,0,11,陽信-石牌,2024-11-08,8711
3209,全科,13,2,11,陽信-石牌,2024-11-08,8711
8261,富鼎,15,4,11,陽信-石牌,2024-11-08,8711
2356,英業達,43,33,10,陽信-石牌,2024-11-08,8711
2421,建準,10,0,10,陽信-石牌,2024-11-08,8711
2467,志聖,10,0,10,陽信-石牌,2024-11-08,8711
2610,華航,10,0,10,陽信-石牌,2024-11-08,8711
2745,五福,10,0,10,陽信-石牌,2024-11-08,8711
3042,晶技,10,0,10,陽信-石牌,2024-11-08,8711
2615,萬海,291,148,143,陽信-石牌,2024-11-11,8711
2891,中信金,110,1,109,陽信-石牌,2024-11-11,8711
2888,新光金,100,2,98,陽信-石牌,2024-11-11,8711
2883,凱基金,130,68,62,陽信-石牌,2024-11-11,8711
00671R,富邦NASDAQ反1,60,0,60,陽信-石牌,2024-11-11,8711
00706L,期元大S＆P日圓正2,50,0,50,陽信-石牌,2024-11-11,8711
2409,友達,35,0,35,陽信-石牌,2024-11-11,8711
00878,國泰永續高股息,56,23,33,陽信-石牌,2024-11-11,8711
2495,普安,40,10,30,陽信-石牌,2024-11-11,8711
2390,云辰,30,0,30,陽信-石牌,2024-11-11,8711
4916,事欣科,33,6,27,陽信-石牌,2024-11-11,8711
1815,富喬,44,18,26,陽信-石牌,2024-11-11,8711
3576,聯合再生,26,0,26,陽信-石牌,2024-11-11,8711
0056,元大高股息,25,0,25,陽信-石牌,2024-11-11,8711
1605,華新,24,0,24,陽信-石牌,2024-11-11,8711
00915,凱基優選高股息30,25,2,23,陽信-石牌,2024-11-11,8711
1449,佳和,34,11,23,陽信-石牌,2024-11-11,8711
00713,元大台灣高息低波,22,0,22,陽信-石牌,2024-11-11,8711
3481,群創,25,3,22,陽信-石牌,2024-11-11,8711
006205,富邦上証,20,0,20,陽信-石牌,2024-11-11,8711
5386,青雲,20,0,20,陽信-石牌,2024-11-11,8711
5880,合庫金,20,0,20,陽信-石牌,2024-11-11,8711
00929,復華台灣科技優息,20,3,17,陽信-石牌,2024-11-11,8711
4716,大立,18,2,16,陽信-石牌,2024-11-11,8711
6763,綠界科技*,18,2,16,陽信-石牌,2024-11-11,8711
2312,金寶,25,10,15,陽信-石牌,2024-11-11,8711
00919,群益台灣精選高息,16,2,14,陽信-石牌,2024-11-11,8711
00930,永豐ESG低碳高息,12,0,12,陽信-石牌,2024-11-11,8711
00946,群益科技高息成長,11,0,11,陽信-石牌,2024-11-11,8711
1326,台化,11,0,11,陽信-石牌,2024-11-11,8711
2419,仲琦,19,8,11,陽信-石牌,2024-11-11,8711
2426,鼎元,12,1,11,陽信-石牌,2024-11-11,8711
2603,長榮,11,0,11,陽信-石牌,2024-11-11,8711
6133,金橋,11,0,11,陽信-石牌,2024-11-11,8711
8021,尖點,12,1,11,陽信-石牌,2024-11-11,8711
8933,愛地雅,11,0,11,陽信-石牌,2024-11-11,8711
3041,揚智,12,1,11,陽信-石牌,2024-11-11,8711
3036,文曄,12,2,10,陽信-石牌,2024-11-11,8711
00952,凱基台灣AI50,10,0,10,陽信-石牌,2024-11-11,8711
00720B,元大投資級公司債,10,0,10,陽信-石牌,2024-11-11,8711
1440,南紡,10,0,10,陽信-石牌,2024-11-11,8711
4174,浩鼎,11,1,10,陽信-石牌,2024-11-11,8711
9943,好樂迪,10,0,10,陽信-石牌,2024-11-11,8711
2455,全新,10,0,10,陽信-石牌,2024-11-11,8711
2882,國泰金,9,0,9,陽信-石牌,2024-11-11,8711
6438,迅得,9,0,9,陽信-石牌,2024-11-11,8711
5871,中租-KY,9,0,9,陽信-石牌,2024-11-11,8711
6290,良維,10,1,9,陽信-石牌,2024-11-11,8711
2258,鴻華先進-創,8,0,8,陽信-石牌,2024-11-11,8711
2371,大同,15,7,8,陽信-石牌,2024-11-11,8711
2312,金寶,1011,0,1011,陽信-石牌,2024-11-12,8711
00953B,群益優選非投等債,604,0,604,陽信-石牌,2024-11-12,8711
00641R,富邦日本反1,160,0,160,陽信-石牌,2024-11-12,8711
00671R,富邦NASDAQ反1,154,0,154,陽信-石牌,2024-11-12,8711
00878,國泰永續高股息,150,0,150,陽信-石牌,2024-11-12,8711
00943,兆豐電子高息等權,133,33,100,陽信-石牌,2024-11-12,8711
6770,力積電,109,12,97,陽信-石牌,2024-11-12,8711
0056,元大高股息,79,0,79,陽信-石牌,2024-11-12,8711
2356,英業達,83,18,65,陽信-石牌,2024-11-12,8711
2609,陽明,260,197,63,陽信-石牌,2024-11-12,8711
00648R,元大S＆P500反1,60,0,60,陽信-石牌,2024-11-12,8711
6182,合晶,51,0,51,陽信-石牌,2024-11-12,8711
9105,泰金寶-DR,88,41,47,陽信-石牌,2024-11-12,8711
1447,力鵬,40,0,40,陽信-石牌,2024-11-12,8711
2885,元大金,37,0,37,陽信-石牌,2024-11-12,8711
2892,第一金,33,0,33,陽信-石牌,2024-11-12,8711
00715L,期街口布蘭特正2,31,0,31,陽信-石牌,2024-11-12,8711
1301,台塑,30,0,30,陽信-石牌,2024-11-12,8711
2409,友達,40,10,30,陽信-石牌,2024-11-12,8711
3481,群創,49,24,25,陽信-石牌,2024-11-12,8711
2317,鴻海,49,25,24,陽信-石牌,2024-11-12,8711
1605,華新,24,0,24,陽信-石牌,2024-11-12,8711
6547,高端疫苗,24,1,23,陽信-石牌,2024-11-12,8711
2353,宏��,23,1,22,陽信-石牌,2024-11-12,8711
00713,元大台灣高息低波,21,0,21,陽信-石牌,2024-11-12,8711
02001L,富邦蘋果正二N,20,0,20,陽信-石牌,2024-11-12,8711
2328,廣宇,82,62,20,陽信-石牌,2024-11-12,8711
3060,銘異,30,10,20,陽信-石牌,2024-11-12,8711
00930,永豐ESG低碳高息,19,0,19,陽信-石牌,2024-11-12,8711
5515,建國,19,0,19,陽信-石牌,2024-11-12,8711
1513,中興電,18,1,17,陽信-石牌,2024-11-12,8711
2349,錸德,26,9,17,陽信-石牌,2024-11-12,8711
0050,元大台灣50,17,0,17,陽信-石牌,2024-11-12,8711
00665L,富邦�琤肭磪囓�2,31,16,15,陽信-石牌,2024-11-12,8711
4950,牧東,15,0,15,陽信-石牌,2024-11-12,8711
9921,巨大,15,0,15,陽信-石牌,2024-11-12,8711
00915,凱基優選高股息30,14,0,14,陽信-石牌,2024-11-12,8711
2368,金像電,15,1,14,陽信-石牌,2024-11-12,8711
2369,菱生,14,0,14,陽信-石牌,2024-11-12,8711
5345,天揚,14,0,14,陽信-石牌,2024-11-12,8711
3689,湧德,14,1,13,陽信-石牌,2024-11-12,8711
5014,建錩,13,0,13,陽信-石牌,2024-11-12,8711
6763,綠界科技*,22,10,12,陽信-石牌,2024-11-12,8711
1101,台泥,13,2,11,陽信-石牌,2024-11-12,8711
2303,聯電,16,5,11,陽信-石牌,2024-11-12,8711
2852,第一保,11,0,11,陽信-石牌,2024-11-12,8711
4916,事欣科,16,5,11,陽信-石牌,2024-11-12,8711
6207,雷科,11,0,11,陽信-石牌,2024-11-12,8711
1314,中石化,10,0,10,陽信-石牌,2024-11-12,8711
1409,新纖,10,0,10,陽信-石牌,2024-11-12,8711
00878,國泰永續高股息,432,0,432,陽信-石牌,2024-11-13,8711
00937B,群益ESG投等債20,388,2,386,陽信-石牌,2024-11-13,8711
00931B,統一美債20年,200,10,190,陽信-石牌,2024-11-13,8711
1611,中電,187,0,187,陽信-石牌,2024-11-13,8711
00715L,期街口布蘭特正2,172,0,172,陽信-石牌,2024-11-13,8711
1802,台玻,150,1,149,陽信-石牌,2024-11-13,8711
2392,正崴,125,36,89,陽信-石牌,2024-11-13,8711
2882,國泰金,77,0,77,陽信-石牌,2024-11-13,8711
00669R,國泰美國道瓊反1,71,0,71,陽信-石牌,2024-11-13,8711
2883,凱基金,66,0,66,陽信-石牌,2024-11-13,8711
00671R,富邦NASDAQ反1,64,0,64,陽信-石牌,2024-11-13,8711
00687B,國泰20年美債,56,0,56,陽信-石牌,2024-11-13,8711
00676R,富邦臺灣加權反1,53,0,53,陽信-石牌,2024-11-13,8711
00753L,中信中國50正2,50,0,50,陽信-石牌,2024-11-13,8711
00648R,元大S＆P500反1,50,0,50,陽信-石牌,2024-11-13,8711
1605,華新,50,1,49,陽信-石牌,2024-11-13,8711
2609,陽明,150,102,48,陽信-石牌,2024-11-13,8711
3013,晟銘電,118,71,47,陽信-石牌,2024-11-13,8711
1203,味王,46,0,46,陽信-石牌,2024-11-13,8711
00639,富邦深100,38,0,38,陽信-石牌,2024-11-13,8711
2317,鴻海,52,14,38,陽信-石牌,2024-11-13,8711
6139,亞翔,37,0,37,陽信-石牌,2024-11-13,8711
00795B,中信美國公債20年,36,0,36,陽信-石牌,2024-11-13,8711
1909,榮成,30,0,30,陽信-石牌,2024-11-13,8711
3481,群創,29,2,27,陽信-石牌,2024-11-13,8711
00918,大華優利高填息30,23,0,23,陽信-石牌,2024-11-13,8711
2353,宏��,22,0,22,陽信-石牌,2024-11-13,8711
2330,台積電,22,1,21,陽信-石牌,2024-11-13,8711
00857B,永豐20年美公債,21,0,21,陽信-石牌,2024-11-13,8711
3260,威剛,21,0,21,陽信-石牌,2024-11-13,8711
00887,永豐中國科技50大,20,0,20,陽信-石牌,2024-11-13,8711
1449,佳和,37,17,20,陽信-石牌,2024-11-13,8711
1101,台泥,20,1,19,陽信-石牌,2024-11-13,8711
6770,力積電,22,3,19,陽信-石牌,2024-11-13,8711
2845,遠東銀,17,0,17,陽信-石牌,2024-11-13,8711
00679B,元大美債20年,16,0,16,陽信-石牌,2024-11-13,8711
4979,華星光,19,4,15,陽信-石牌,2024-11-13,8711
00641R,富邦日本反1,15,0,15,陽信-石牌,2024-11-13,8711
2444,兆勁,20,5,15,陽信-石牌,2024-11-13,8711
2834,臺企銀,12,0,12,陽信-石牌,2024-11-13,8711
0056,元大高股息,12,1,11,陽信-石牌,2024-11-13,8711
3062,建漢,13,2,11,陽信-石牌,2024-11-13,8711
00909,國泰數位支付服務,10,0,10,陽信-石牌,2024-11-13,8711
0061,元大寶滬深,10,0,10,陽信-石牌,2024-11-13,8711
00712,復華富時不動產,10,0,10,陽信-石牌,2024-11-13,8711
1323,永裕,10,0,10,陽信-石牌,2024-11-13,8711
2892,第一金,10,0,10,陽信-石牌,2024-11-13,8711
3484,崧騰,10,0,10,陽信-石牌,2024-11-13,8711
6443,元晶,10,0,10,陽信-石牌,2024-11-13,8711
2344,華邦電,10,1,9,陽信-石牌,2024-11-13,8711
9105,泰金寶-DR,211,76,135,陽信-石牌,2024-11-14,8711
00937B,群益ESG投等債20,502,383,119,陽信-石牌,2024-11-14,8711
00878,國泰永續高股息,106,0,106,陽信-石牌,2024-11-14,8711
00673R,期元大S＆P原油反1,90,0,90,陽信-石牌,2024-11-14,8711
3481,群創,77,2,75,陽信-石牌,2024-11-14,8711
2101,南港,47,0,47,陽信-石牌,2024-11-14,8711
00648R,元大S＆P500反1,40,0,40,陽信-石牌,2024-11-14,8711
00669R,國泰美國道瓊反1,38,0,38,陽信-石牌,2024-11-14,8711
00679B,元大美債20年,36,0,36,陽信-石牌,2024-11-14,8711
2615,萬海,46,10,36,陽信-石牌,2024-11-14,8711
00919,群益台灣精選高息,35,0,35,陽信-石牌,2024-11-14,8711
5522,遠雄,35,0,35,陽信-石牌,2024-11-14,8711
0056,元大高股息,32,0,32,陽信-石牌,2024-11-14,8711
1909,榮成,30,0,30,陽信-石牌,2024-11-14,8711
00929,復華台灣科技優息,33,5,28,陽信-石牌,2024-11-14,8711
2888,新光金,30,2,28,陽信-石牌,2024-11-14,8711
1447,力鵬,32,6,26,陽信-石牌,2024-11-14,8711
00671R,富邦NASDAQ反1,25,0,25,陽信-石牌,2024-11-14,8711
2882,國泰金,25,1,24,陽信-石牌,2024-11-14,8711
2312,金寶,167,145,22,陽信-石牌,2024-11-14,8711
2609,陽明,76,56,20,陽信-石牌,2024-11-14,8711
1101,台泥,20,0,20,陽信-石牌,2024-11-14,8711
00688L,國泰20年美債正2,20,0,20,陽信-石牌,2024-11-14,8711
00795B,中信美國公債20年,20,0,20,陽信-石牌,2024-11-14,8711
00857B,永豐20年美公債,20,0,20,陽信-石牌,2024-11-14,8711
3013,晟銘電,25,5,20,陽信-石牌,2024-11-14,8711
2354,鴻準,47,28,19,陽信-石牌,2024-11-14,8711
2303,聯電,20,2,18,陽信-石牌,2024-11-14,8711
3003,健和興,18,0,18,陽信-石牌,2024-11-14,8711
6547,高端疫苗,18,0,18,陽信-石牌,2024-11-14,8711
3231,緯創,36,19,17,陽信-石牌,2024-11-14,8711
2883,凱基金,16,0,16,陽信-石牌,2024-11-14,8711
3360,尚立,16,0,16,陽信-石牌,2024-11-14,8711
00915,凱基優選高股息30,15,0,15,陽信-石牌,2024-11-14,8711
00641R,富邦日本反1,15,0,15,陽信-石牌,2024-11-14,8711
1449,佳和,31,16,15,陽信-石牌,2024-11-14,8711
2890,永豐金,16,1,15,陽信-石牌,2024-11-14,8711
00943,兆豐電子高息等權,14,0,14,陽信-石牌,2024-11-14,8711
2504,國產,14,0,14,陽信-石牌,2024-11-14,8711
8011,台通,13,0,13,陽信-石牌,2024-11-14,8711
00940,元大台灣價值高息,13,0,13,陽信-石牌,2024-11-14,8711
1314,中石化,28,15,13,陽信-石牌,2024-11-14,8711
1513,中興電,13,0,13,陽信-石牌,2024-11-14,8711
3202,樺晟,13,0,13,陽信-石牌,2024-11-14,8711
4919,新唐,29,16,13,陽信-石牌,2024-11-14,8711
1455,集盛,11,0,11,陽信-石牌,2024-11-14,8711
2382,廣達,11,1,10,陽信-石牌,2024-11-14,8711
1474,弘裕,10,0,10,陽信-石牌,2024-11-14,8711
1711,永光,10,0,10,陽信-石牌,2024-11-14,8711
2017,官田鋼,10,0,10,陽信-石牌,2024-11-14,8711
00953B,群益優選非投等債,598,0,598,陽信-石牌,2024-11-15,8711
00878,國泰永續高股息,216,0,216,陽信-石牌,2024-11-15,8711
00932,兆豐永續高息等權,100,0,100,陽信-石牌,2024-11-15,8711
1402,遠東新,100,0,100,陽信-石牌,2024-11-15,8711
00929,復華台灣科技優息,116,20,96,陽信-石牌,2024-11-15,8711
2881,富邦金,82,3,79,陽信-石牌,2024-11-15,8711
3202,樺晟,71,0,71,陽信-石牌,2024-11-15,8711
1802,台玻,58,0,58,陽信-石牌,2024-11-15,8711
2354,鴻準,343,286,57,陽信-石牌,2024-11-15,8711
0056,元大高股息,55,0,55,陽信-石牌,2024-11-15,8711
00960,野村全球航運龍頭,50,0,50,陽信-石牌,2024-11-15,8711
6180,橘子,49,2,47,陽信-石牌,2024-11-15,8711
2317,鴻海,85,43,42,陽信-石牌,2024-11-15,8711
1611,中電,74,39,35,陽信-石牌,2024-11-15,8711
2002,中鋼,31,0,31,陽信-石牌,2024-11-15,8711
2382,廣達,52,28,24,陽信-石牌,2024-11-15,8711
00943,兆豐電子高息等權,23,0,23,陽信-石牌,2024-11-15,8711
00669R,國泰美國道瓊反1,20,0,20,陽信-石牌,2024-11-15,8711
2801,彰銀,20,0,20,陽信-石牌,2024-11-15,8711
5871,中租-KY,18,0,18,陽信-石牌,2024-11-15,8711
3706,神達,109,91,18,陽信-石牌,2024-11-15,8711
00679B,元大美債20年,17,0,17,陽信-石牌,2024-11-15,8711
3231,緯創,27,10,17,陽信-石牌,2024-11-15,8711
2880,華南金,16,0,16,陽信-石牌,2024-11-15,8711
2405,輔信,15,0,15,陽信-石牌,2024-11-15,8711
6199,天品,15,0,15,陽信-石牌,2024-11-15,8711
2303,聯電,15,3,12,陽信-石牌,2024-11-15,8711
2882,國泰金,17,5,12,陽信-石牌,2024-11-15,8711
4157,太景*-KY,11,0,11,陽信-石牌,2024-11-15,8711
6134,萬旭,11,0,11,陽信-石牌,2024-11-15,8711
3211,順達,11,1,10,陽信-石牌,2024-11-15,8711
00725B,國泰投資級公司債,10,0,10,陽信-石牌,2024-11-15,8711
5289,宜鼎,10,0,10,陽信-石牌,2024-11-15,8711
1203,味王,9,0,9,陽信-石牌,2024-11-15,8711
2439,美律,9,0,9,陽信-石牌,2024-11-15,8711
2520,冠德,16,7,9,陽信-石牌,2024-11-15,8711
2929,淘帝-KY,10,1,9,陽信-石牌,2024-11-15,8711
4979,華星光,19,10,9,陽信-石牌,2024-11-15,8711
3293,鈊象,9,0,9,陽信-石牌,2024-11-15,8711
2883,凱基金,11,3,8,陽信-石牌,2024-11-15,8711
6217,中探針,8,0,8,陽信-石牌,2024-11-15,8711
8431,匯鑽科,8,0,8,陽信-石牌,2024-11-15,8711
2449,京元電子,8,1,7,陽信-石牌,2024-11-15,8711
5285,界霖,7,0,7,陽信-石牌,2024-11-15,8711
00676R,富邦臺灣加權反1,6,0,6,陽信-石牌,2024-11-15,8711
1503,士電,6,0,6,陽信-石牌,2024-11-15,8711
1513,中興電,6,0,6,陽信-石牌,2024-11-15,8711
2613,中櫃,7,1,6,陽信-石牌,2024-11-15,8711
3037,欣興,7,1,6,陽信-石牌,2024-11-15,8711
4542,科嶠,6,0,6,陽信-石牌,2024-11-15,8711
00715L,期街口布蘭特正2,148,0,148,陽信-石牌,2024-11-18,8711
00878,國泰永續高股息,140,0,140,陽信-石牌,2024-11-18,8711
00887,永豐中國科技50大,100,0,100,陽信-石牌,2024-11-18,8711
2014,中鴻,70,0,70,陽信-石牌,2024-11-18,8711
00929,復華台灣科技優息,70,1,69,陽信-石牌,2024-11-18,8711
2312,金寶,144,83,61,陽信-石牌,2024-11-18,8711
00898,國泰基因免疫革命,60,0,60,陽信-石牌,2024-11-18,8711
2017,官田鋼,60,0,60,陽信-石牌,2024-11-18,8711
2606,裕民,60,1,59,陽信-石牌,2024-11-18,8711
2354,鴻準,394,344,50,陽信-石牌,2024-11-18,8711
2881,富邦金,49,1,48,陽信-石牌,2024-11-18,8711
0056,元大高股息,31,0,31,陽信-石牌,2024-11-18,8711
2344,華邦電,30,0,30,陽信-石牌,2024-11-18,8711
6451,訊芯-KY,25,0,25,陽信-石牌,2024-11-18,8711
1810,和成,25,0,25,陽信-石牌,2024-11-18,8711
2405,輔信,30,5,25,陽信-石牌,2024-11-18,8711
2027,大成鋼,24,0,24,陽信-石牌,2024-11-18,8711
2317,鴻海,41,18,23,陽信-石牌,2024-11-18,8711
2887,台新金,22,0,22,陽信-石牌,2024-11-18,8711
3062,建漢,30,9,21,陽信-石牌,2024-11-18,8711
2880,華南金,21,0,21,陽信-石牌,2024-11-18,8711
3689,湧德,27,6,21,陽信-石牌,2024-11-18,8711
2409,友達,20,0,20,陽信-石牌,2024-11-18,8711
2495,普安,30,10,20,陽信-石牌,2024-11-18,8711
6108,競國,20,0,20,陽信-石牌,2024-11-18,8711
2349,錸德,45,26,19,陽信-石牌,2024-11-18,8711
1785,光洋科,18,1,17,陽信-石牌,2024-11-18,8711
8996,高力,18,2,16,陽信-石牌,2024-11-18,8711
00687B,國泰20年美債,15,0,15,陽信-石牌,2024-11-18,8711
2324,仁寶,15,0,15,陽信-石牌,2024-11-18,8711
2369,菱生,14,0,14,陽信-石牌,2024-11-18,8711
3060,銘異,15,1,14,陽信-石牌,2024-11-18,8711
1802,台玻,21,8,13,陽信-石牌,2024-11-18,8711
2476,鉅祥,13,0,13,陽信-石牌,2024-11-18,8711
2330,台積電,13,1,12,陽信-石牌,2024-11-18,8711
2401,凌陽,12,0,12,陽信-石牌,2024-11-18,8711
2359,所羅門,11,0,11,陽信-石牌,2024-11-18,8711
2610,華航,21,10,11,陽信-石牌,2024-11-18,8711
3518,柏騰,12,1,11,陽信-石牌,2024-11-18,8711
00857B,永豐20年美公債,10,0,10,陽信-石牌,2024-11-18,8711
1815,富喬,11,1,10,陽信-石牌,2024-11-18,8711
2316,楠梓電,10,0,10,陽信-石牌,2024-11-18,8711
3290,東浦,20,10,10,陽信-石牌,2024-11-18,8711
8107,大億金茂,10,0,10,陽信-石牌,2024-11-18,8711
1560,中砂,9,0,9,陽信-石牌,2024-11-18,8711
00934,中信成長高股息,8,0,8,陽信-石牌,2024-11-18,8711
00943,兆豐電子高息等權,8,0,8,陽信-石牌,2024-11-18,8711
2303,聯電,11,3,8,陽信-石牌,2024-11-18,8711
2371,大同,10,2,8,陽信-石牌,2024-11-18,8711
2605,新興,8,0,8,陽信-石牌,2024-11-18,8711
3481,群創,114,12,102,陽信-石牌,2024-11-19,8711
6152,百一,100,0,100,陽信-石牌,2024-11-19,8711
2618,長榮航,95,15,80,陽信-石牌,2024-11-19,8711
2888,新光金,100,20,80,陽信-石牌,2024-11-19,8711
2405,輔信,52,0,52,陽信-石牌,2024-11-19,8711
2883,凱基金,50,0,50,陽信-石牌,2024-11-19,8711
00929,復華台灣科技優息,70,21,49,陽信-石牌,2024-11-19,8711
00632R,元大台灣50反1,50,8,42,陽信-石牌,2024-11-19,8711
00915,凱基優選高股息30,41,0,41,陽信-石牌,2024-11-19,8711
00937B,群益ESG投等債20,40,4,36,陽信-石牌,2024-11-19,8711
2615,萬海,111,78,33,陽信-石牌,2024-11-19,8711
00948B,中信優息投資級債,31,0,31,陽信-石牌,2024-11-19,8711
6282,康舒,30,0,30,陽信-石牌,2024-11-19,8711
00715L,期街口布蘭特正2,165,141,24,陽信-石牌,2024-11-19,8711
2344,華邦電,21,0,21,陽信-石牌,2024-11-19,8711
00898,國泰基因免疫革命,20,0,20,陽信-石牌,2024-11-19,8711
00887,永豐中國科技50大,53,35,18,陽信-石牌,2024-11-19,8711
3013,晟銘電,25,7,18,陽信-石牌,2024-11-19,8711
2317,鴻海,20,4,16,陽信-石牌,2024-11-19,8711
3047,訊舟,14,0,14,陽信-石牌,2024-11-19,8711
6770,力積電,20,6,14,陽信-石牌,2024-11-19,8711
9921,巨大,14,0,14,陽信-石牌,2024-11-19,8711
00878,國泰永續高股息,13,0,13,陽信-石牌,2024-11-19,8711
2382,廣達,12,0,12,陽信-石牌,2024-11-19,8711
00648R,元大S＆P500反1,10,0,10,陽信-石牌,2024-11-19,8711
00671R,富邦NASDAQ反1,10,0,10,陽信-石牌,2024-11-19,8711
1617,榮星,10,0,10,陽信-石牌,2024-11-19,8711
1736,喬山,10,0,10,陽信-石牌,2024-11-19,8711
2316,楠梓電,10,0,10,陽信-石牌,2024-11-19,8711
2399,映泰,13,3,10,陽信-石牌,2024-11-19,8711
2421,建準,10,0,10,陽信-石牌,2024-11-19,8711
2882,國泰金,10,0,10,陽信-石牌,2024-11-19,8711
2890,永豐金,10,0,10,陽信-石牌,2024-11-19,8711
5483,中美晶,11,1,10,陽信-石牌,2024-11-19,8711
6443,元晶,10,0,10,陽信-石牌,2024-11-19,8711
8105,凌巨,10,0,10,陽信-石牌,2024-11-19,8711
1611,中電,10,0,10,陽信-石牌,2024-11-19,8711
1301,台塑,16,7,9,陽信-石牌,2024-11-19,8711
3037,欣興,10,1,9,陽信-石牌,2024-11-19,8711
3231,緯創,11,2,9,陽信-石牌,2024-11-19,8711
9105,泰金寶-DR,84,75,9,陽信-石牌,2024-11-19,8711
1326,台化,10,1,9,陽信-石牌,2024-11-19,8711
1540,喬福,8,0,8,陽信-石牌,2024-11-19,8711
2605,新興,18,10,8,陽信-石牌,2024-11-19,8711
6547,高端疫苗,7,0,7,陽信-石牌,2024-11-19,8711
00688L,國泰20年美債正2,6,0,6,陽信-石牌,2024-11-19,8711
2465,麗臺,6,0,6,陽信-石牌,2024-11-19,8711
6472,保瑞,8,2,6,陽信-石牌,2024-11-19,8711
8415,大國鋼,8,2,6,陽信-石牌,2024-11-19,8711
00669R,國泰美國道瓊反1,5,0,5,陽信-石牌,2024-11-19,8711
00953B,群益優選非投等債,598,0,598,陽信-石牌,2024-11-20,8711
2349,錸德,139,32,107,陽信-石牌,2024-11-20,8711
00929,復華台灣科技優息,110,9,101,陽信-石牌,2024-11-20,8711
2354,鴻準,237,137,100,陽信-石牌,2024-11-20,8711
9105,泰金寶-DR,143,43,100,陽信-石牌,2024-11-20,8711
6282,康舒,73,19,54,陽信-石牌,2024-11-20,8711
0056,元大高股息,45,3,42,陽信-石牌,2024-11-20,8711
1815,富喬,41,5,36,陽信-石牌,2024-11-20,8711
00915,凱基優選高股息30,35,0,35,陽信-石牌,2024-11-20,8711
1447,力鵬,35,2,33,陽信-石牌,2024-11-20,8711
00648R,元大S＆P500反1,26,0,26,陽信-石牌,2024-11-20,8711
3625,西勝,25,1,24,陽信-石牌,2024-11-20,8711
5321,美而快,23,0,23,陽信-石牌,2024-11-20,8711
1605,華新,22,0,22,陽信-石牌,2024-11-20,8711
3167,大量,45,23,22,陽信-石牌,2024-11-20,8711
00919,群益台灣精選高息,23,2,21,陽信-石牌,2024-11-20,8711
2409,友達,21,0,21,陽信-石牌,2024-11-20,8711
2609,陽明,214,193,21,陽信-石牌,2024-11-20,8711
00927,群益半導體收益,20,0,20,陽信-石牌,2024-11-20,8711
3706,神達,90,72,18,陽信-石牌,2024-11-20,8711
2605,新興,18,1,17,陽信-石牌,2024-11-20,8711
3323,加百裕,17,1,16,陽信-石牌,2024-11-20,8711
00937B,群益ESG投等債20,15,0,15,陽信-石牌,2024-11-20,8711
2303,聯電,19,4,15,陽信-石牌,2024-11-20,8711
4916,事欣科,15,0,15,陽信-石牌,2024-11-20,8711
6438,迅得,23,8,15,陽信-石牌,2024-11-20,8711
0050,元大台灣50,14,0,14,陽信-石牌,2024-11-20,8711
2355,敬鵬,14,0,14,陽信-石牌,2024-11-20,8711
1203,味王,13,0,13,陽信-石牌,2024-11-20,8711
2882,國泰金,13,0,13,陽信-石牌,2024-11-20,8711
2027,大成鋼,14,2,12,陽信-石牌,2024-11-20,8711
00878,國泰永續高股息,13,1,12,陽信-石牌,2024-11-20,8711
00959B,大華投等美債15Y+,12,0,12,陽信-石牌,2024-11-20,8711
1316,上曜,12,0,12,陽信-石牌,2024-11-20,8711
2489,瑞軒,12,0,12,陽信-石牌,2024-11-20,8711
2330,台積電,14,2,12,陽信-石牌,2024-11-20,8711
00679B,元大美債20年,11,0,11,陽信-石牌,2024-11-20,8711
2312,金寶,60,49,11,陽信-石牌,2024-11-20,8711
3060,銘異,11,0,11,陽信-石牌,2024-11-20,8711
3447,展達,12,1,11,陽信-石牌,2024-11-20,8711
00687B,國泰20年美債,10,0,10,陽信-石牌,2024-11-20,8711
1304,台聚,10,0,10,陽信-石牌,2024-11-20,8711
00950B,凱基A級公司債,10,0,10,陽信-石牌,2024-11-20,8711
2369,菱生,10,0,10,陽信-石牌,2024-11-20,8711
2834,臺企銀,11,2,9,陽信-石牌,2024-11-20,8711
6505,台塑化,9,0,9,陽信-石牌,2024-11-20,8711
3189,景碩,9,0,9,陽信-石牌,2024-11-20,8711
3689,湧德,11,2,9,陽信-石牌,2024-11-20,8711
5309,系統電,11,2,9,陽信-石牌,2024-11-20,8711
5347,世界,9,0,9,陽信-石牌,2024-11-20,8711
1611,中電,115,0,115,陽信-石牌,2024-11-21,8711
0056,元大高股息,73,0,73,陽信-石牌,2024-11-21,8711
2356,英業達,114,63,51,陽信-石牌,2024-11-21,8711
2017,官田鋼,50,0,50,陽信-石牌,2024-11-21,8711
2882,國泰金,44,0,44,陽信-石牌,2024-11-21,8711
00671R,富邦NASDAQ反1,40,0,40,陽信-石牌,2024-11-21,8711
2890,永豐金,36,0,36,陽信-石牌,2024-11-21,8711
2881,富邦金,33,0,33,陽信-石牌,2024-11-21,8711
1609,大亞,41,11,30,陽信-石牌,2024-11-21,8711
2303,聯電,37,7,30,陽信-石牌,2024-11-21,8711
2618,長榮航,31,4,27,陽信-石牌,2024-11-21,8711
2332,友訊,30,3,27,陽信-石牌,2024-11-21,8711
02001L,富邦蘋果正二N,24,0,24,陽信-石牌,2024-11-21,8711
00929,復華台灣科技優息,55,32,23,陽信-石牌,2024-11-21,8711
1101,台泥,22,0,22,陽信-石牌,2024-11-21,8711
4968,立積,26,4,22,陽信-石牌,2024-11-21,8711
00878,國泰永續高股息,21,0,21,陽信-石牌,2024-11-21,8711
3037,欣興,34,13,21,陽信-石牌,2024-11-21,8711
00680L,元大美債20正2,20,0,20,陽信-石牌,2024-11-21,8711
00937B,群益ESG投等債20,17,0,17,陽信-石牌,2024-11-21,8711
00959B,大華投等美債15Y+,15,0,15,陽信-石牌,2024-11-21,8711
00915,凱基優選高股息30,15,0,15,陽信-石牌,2024-11-21,8711
2520,冠德,14,0,14,陽信-石牌,2024-11-21,8711
2317,鴻海,20,6,14,陽信-石牌,2024-11-21,8711
2204,中華,37,24,13,陽信-石牌,2024-11-21,8711
2330,台積電,13,0,13,陽信-石牌,2024-11-21,8711
2615,萬海,59,47,12,陽信-石牌,2024-11-21,8711
3202,樺晟,12,0,12,陽信-石牌,2024-11-21,8711
6126,信音,12,0,12,陽信-石牌,2024-11-21,8711
0050,元大台灣50,12,2,10,陽信-石牌,2024-11-21,8711
2464,盟立,11,1,10,陽信-石牌,2024-11-21,8711
5452,佶優,10,0,10,陽信-石牌,2024-11-21,8711
2429,銘旺科,9,0,9,陽信-石牌,2024-11-21,8711
2002,中鋼,11,2,9,陽信-石牌,2024-11-21,8711
3362,先進光,9,0,9,陽信-石牌,2024-11-21,8711
6757,台灣虎航,8,0,8,陽信-石牌,2024-11-21,8711
8104,錸寶,29,21,8,陽信-石牌,2024-11-21,8711
3049,精金,10,2,8,陽信-石牌,2024-11-21,8711
1721,三晃,7,0,7,陽信-石牌,2024-11-21,8711
8210,勤誠,7,0,7,陽信-石牌,2024-11-21,8711
2413,環科,8,2,6,陽信-石牌,2024-11-21,8711
3231,緯創,29,23,6,陽信-石牌,2024-11-21,8711
3322,建舜電,6,0,6,陽信-石牌,2024-11-21,8711
3450,聯鈞,16,10,6,陽信-石牌,2024-11-21,8711
6472,保瑞,8,2,6,陽信-石牌,2024-11-21,8711
00919,群益台灣精選高息,7,1,6,陽信-石牌,2024-11-21,8711
1301,台塑,5,0,5,陽信-石牌,2024-11-21,8711
00669R,國泰美國道瓊反1,5,0,5,陽信-石牌,2024-11-21,8711
00950B,凱基A級公司債,5,0,5,陽信-石牌,2024-11-21,8711
00923,群益台ESG低碳50,5,0,5,陽信-石牌,2024-11-21,8711
00919,群益台灣精選高息,85,2,83,陽信-石牌,2024-11-22,8711
00676R,富邦臺灣加權反1,62,0,62,陽信-石牌,2024-11-22,8711
2867,三商壽,58,0,58,陽信-石牌,2024-11-22,8711
2408,南亞科,63,10,53,陽信-石牌,2024-11-22,8711
4513,福裕,51,0,51,陽信-石牌,2024-11-22,8711
2504,國產,46,0,46,陽信-石牌,2024-11-22,8711
2615,萬海,82,37,45,陽信-石牌,2024-11-22,8711
00953B,群益優選非投等債,40,0,40,陽信-石牌,2024-11-22,8711
2303,聯電,42,3,39,陽信-石牌,2024-11-22,8711
3706,神達,100,65,35,陽信-石牌,2024-11-22,8711
1471,首利,30,0,30,陽信-石牌,2024-11-22,8711
5905,南仁湖,30,0,30,陽信-石牌,2024-11-22,8711
2609,陽明,180,152,28,陽信-石牌,2024-11-22,8711
2328,廣宇,30,8,22,陽信-石牌,2024-11-22,8711
8021,尖點,22,0,22,陽信-石牌,2024-11-22,8711
2317,鴻海,28,7,21,陽信-石牌,2024-11-22,8711
1319,東陽,21,0,21,陽信-石牌,2024-11-22,8711
00915,凱基優選高股息30,20,0,20,陽信-石牌,2024-11-22,8711
1449,佳和,40,20,20,陽信-石牌,2024-11-22,8711
1722,台肥,20,0,20,陽信-石牌,2024-11-22,8711
2413,環科,19,1,18,陽信-石牌,2024-11-22,8711
2429,銘旺科,18,0,18,陽信-石牌,2024-11-22,8711
2349,錸德,63,47,16,陽信-石牌,2024-11-22,8711
6456,GIS-KY,15,0,15,陽信-石牌,2024-11-22,8711
2883,凱基金,14,0,14,陽信-石牌,2024-11-22,8711
00878,國泰永續高股息,29,17,12,陽信-石牌,2024-11-22,8711
1314,中石化,15,3,12,陽信-石牌,2024-11-22,8711
2324,仁寶,13,1,12,陽信-石牌,2024-11-22,8711
3360,尚立,12,0,12,陽信-石牌,2024-11-22,8711
00930,永豐ESG低碳高息,10,0,10,陽信-石牌,2024-11-22,8711
2359,所羅門,11,1,10,陽信-石牌,2024-11-22,8711
2515,中工,10,0,10,陽信-石牌,2024-11-22,8711
2530,華建,10,0,10,陽信-石牌,2024-11-22,8711
3029,零壹,10,0,10,陽信-石牌,2024-11-22,8711
4563,百德,10,0,10,陽信-石牌,2024-11-22,8711
5309,系統電,34,24,10,陽信-石牌,2024-11-22,8711
8011,台通,12,2,10,陽信-石牌,2024-11-22,8711
9939,宏全,10,0,10,陽信-石牌,2024-11-22,8711
2409,友達,18,9,9,陽信-石牌,2024-11-22,8711
2417,圓剛,13,5,8,陽信-石牌,2024-11-22,8711
2882,國泰金,10,2,8,陽信-石牌,2024-11-22,8711
4903,聯光通,11,3,8,陽信-石牌,2024-11-22,8711
00753L,中信中國50正2,7,0,7,陽信-石牌,2024-11-22,8711
00637L,元大滬深300正2,14,7,7,陽信-石牌,2024-11-22,8711
2352,佳世達,7,0,7,陽信-石牌,2024-11-22,8711
2646,星宇航空,7,0,7,陽信-石牌,2024-11-22,8711
3234,光環,7,0,7,陽信-石牌,2024-11-22,8711
6285,啟��,7,0,7,陽信-石牌,2024-11-22,8711
2233,宇隆,8,2,6,陽信-石牌,2024-11-22,8711
2332,友訊,8,2,6,陽信-石牌,2024-11-22,8711
9105,泰金寶-DR,396,134,262,陽信-石牌,2024-11-25,8711
00919,群益台灣精選高息,201,3,198,陽信-石牌,2024-11-25,8711
1611,中電,110,16,94,陽信-石牌,2024-11-25,8711
00929,復華台灣科技優息,56,0,56,陽信-石牌,2024-11-25,8711
4991,環宇-KY,37,0,37,陽信-石牌,2024-11-25,8711
2312,金寶,184,149,35,陽信-石牌,2024-11-25,8711
2356,英業達,34,3,31,陽信-石牌,2024-11-25,8711
2431,聯昌,30,0,30,陽信-石牌,2024-11-25,8711
4916,事欣科,31,2,29,陽信-石牌,2024-11-25,8711
2609,陽明,156,129,27,陽信-石牌,2024-11-25,8711
2344,華邦電,25,2,23,陽信-石牌,2024-11-25,8711
00940,元大台灣價值高息,21,0,21,陽信-石牌,2024-11-25,8711
1524,耿鼎,21,1,20,陽信-石牌,2024-11-25,8711
3202,樺晟,20,0,20,陽信-石牌,2024-11-25,8711
2371,大同,33,15,18,陽信-石牌,2024-11-25,8711
1560,中砂,15,0,15,陽信-石牌,2024-11-25,8711
3013,晟銘電,16,1,15,陽信-石牌,2024-11-25,8711
0056,元大高股息,19,6,13,陽信-石牌,2024-11-25,8711
00959B,大華投等美債15Y+,13,0,13,陽信-石牌,2024-11-25,8711
3032,偉訓,23,11,12,陽信-石牌,2024-11-25,8711
3290,東浦,12,0,12,陽信-石牌,2024-11-25,8711
6451,訊芯-KY,15,3,12,陽信-石牌,2024-11-25,8711
2885,元大金,11,0,11,陽信-石牌,2024-11-25,8711
2303,聯電,17,7,10,陽信-石牌,2024-11-25,8711
2641,正德,10,0,10,陽信-石牌,2024-11-25,8711
3003,健和興,10,0,10,陽信-石牌,2024-11-25,8711
4934,太極,10,0,10,陽信-石牌,2024-11-25,8711
8404,百和興業-KY,10,0,10,陽信-石牌,2024-11-25,8711
2367,燿華,9,0,9,陽信-石牌,2024-11-25,8711
2603,長榮,21,13,8,陽信-石牌,2024-11-25,8711
2852,第一保,8,0,8,陽信-石牌,2024-11-25,8711
4174,浩鼎,8,0,8,陽信-石牌,2024-11-25,8711
2618,長榮航,12,5,7,陽信-石牌,2024-11-25,8711
00918,大華優利高填息30,7,0,7,陽信-石牌,2024-11-25,8711
2388,威盛,55,48,7,陽信-石牌,2024-11-25,8711
2421,建準,11,4,7,陽信-石牌,2024-11-25,8711
3029,零壹,50,43,7,陽信-石牌,2024-11-25,8711
1444,力麗,8,2,6,陽信-石牌,2024-11-25,8711
1455,集盛,6,0,6,陽信-石牌,2024-11-25,8711
1563,巧新,9,3,6,陽信-石牌,2024-11-25,8711
2409,友達,20,14,6,陽信-石牌,2024-11-25,8711
3481,群創,12,6,6,陽信-石牌,2024-11-25,8711
5871,中租-KY,7,2,5,陽信-石牌,2024-11-25,8711
1314,中石化,10,5,5,陽信-石牌,2024-11-25,8711
2413,環科,5,0,5,陽信-石牌,2024-11-25,8711
2449,京元電子,7,2,5,陽信-石牌,2024-11-25,8711
2736,富野,5,0,5,陽信-石牌,2024-11-25,8711
3027,盛達,5,0,5,陽信-石牌,2024-11-25,8711
3209,全科,5,0,5,陽信-石牌,2024-11-25,8711
3230,錦明,5,0,5,陽信-石牌,2024-11-25,8711
00929,復華台灣科技優息,155,0,155,陽信-石牌,2024-11-26,8711
00878,國泰永續高股息,91,1,90,陽信-石牌,2024-11-26,8711
0056,元大高股息,62,4,58,陽信-石牌,2024-11-26,8711
00919,群益台灣精選高息,57,2,55,陽信-石牌,2024-11-26,8711
1402,遠東新,50,0,50,陽信-石牌,2024-11-26,8711
00671R,富邦NASDAQ反1,40,0,40,陽信-石牌,2024-11-26,8711
3521,鴻翊,37,0,37,陽信-石牌,2024-11-26,8711
2890,永豐金,32,0,32,陽信-石牌,2024-11-26,8711
3231,緯創,51,19,32,陽信-石牌,2024-11-26,8711
02001L,富邦蘋果正二N,30,0,30,陽信-石牌,2024-11-26,8711
6213,聯茂,31,1,30,陽信-石牌,2024-11-26,8711
2312,金寶,137,110,27,陽信-石牌,2024-11-26,8711
5309,系統電,40,13,27,陽信-石牌,2024-11-26,8711
1802,台玻,24,1,23,陽信-石牌,2024-11-26,8711
00953B,群益優選非投等債,20,0,20,陽信-石牌,2024-11-26,8711
2601,益航,21,1,20,陽信-石牌,2024-11-26,8711
2637,慧洋-KY,20,0,20,陽信-石牌,2024-11-26,8711
3710,連展投控,20,0,20,陽信-石牌,2024-11-26,8711
2344,華邦電,18,0,18,陽信-石牌,2024-11-26,8711
2382,廣達,19,1,18,陽信-石牌,2024-11-26,8711
2888,新光金,20,3,17,陽信-石牌,2024-11-26,8711
6282,康舒,17,0,17,陽信-石牌,2024-11-26,8711
3037,欣興,17,1,16,陽信-石牌,2024-11-26,8711
1447,力鵬,15,0,15,陽信-石牌,2024-11-26,8711
6962,ITH-KY,20,6,14,陽信-石牌,2024-11-26,8711
2426,鼎元,28,16,12,陽信-石牌,2024-11-26,8711
3380,明泰,12,0,12,陽信-石牌,2024-11-26,8711
00951,台新日本半導體,11,0,11,陽信-石牌,2024-11-26,8711
00648R,元大S＆P500反1,11,0,11,陽信-石牌,2024-11-26,8711
2349,錸德,18,7,11,陽信-石牌,2024-11-26,8711
2419,仲琦,23,12,11,陽信-石牌,2024-11-26,8711
2330,台積電,12,1,11,陽信-石牌,2024-11-26,8711
00669R,國泰美國道瓊反1,10,0,10,陽信-石牌,2024-11-26,8711
006205,富邦上証,10,0,10,陽信-石牌,2024-11-26,8711
0061,元大寶滬深,10,0,10,陽信-石牌,2024-11-26,8711
1444,力麗,10,0,10,陽信-石牌,2024-11-26,8711
2367,燿華,11,1,10,陽信-石牌,2024-11-26,8711
3706,神達,63,53,10,陽信-石牌,2024-11-26,8711
6141,柏承,10,0,10,陽信-石牌,2024-11-26,8711
6958,日盛台駿,10,0,10,陽信-石牌,2024-11-26,8711
7705,三商餐飲,10,0,10,陽信-石牌,2024-11-26,8711
2303,聯電,11,2,9,陽信-石牌,2024-11-26,8711
3211,順達,9,0,9,陽信-石牌,2024-11-26,8711
6558,興能高,15,6,9,陽信-石牌,2024-11-26,8711
1815,富喬,102,93,9,陽信-石牌,2024-11-26,8711
2399,映泰,8,0,8,陽信-石牌,2024-11-26,8711
4966,譜瑞-KY,14,6,8,陽信-石牌,2024-11-26,8711
5905,南仁湖,10,2,8,陽信-石牌,2024-11-26,8711
020039,元大加權N,7,0,7,陽信-石牌,2024-11-26,8711
5284,jpp-KY,7,0,7,陽信-石牌,2024-11-26,8711
00673R,期元大S＆P原油反1,239,0,239,陽信-石牌,2024-11-27,8711
2603,長榮,121,12,109,陽信-石牌,2024-11-27,8711
0056,元大高股息,107,0,107,陽信-石牌,2024-11-27,8711
00919,群益台灣精選高息,96,14,82,陽信-石牌,2024-11-27,8711
2444,兆勁,75,10,65,陽信-石牌,2024-11-27,8711
00878,國泰永續高股息,67,4,63,陽信-石牌,2024-11-27,8711
1611,中電,61,0,61,陽信-石牌,2024-11-27,8711
2601,益航,54,2,52,陽信-石牌,2024-11-27,8711
3481,群創,71,28,43,陽信-石牌,2024-11-27,8711
2354,鴻準,95,56,39,陽信-石牌,2024-11-27,8711
9105,泰金寶-DR,68,29,39,陽信-石牌,2024-11-27,8711
00671R,富邦NASDAQ反1,35,0,35,陽信-石牌,2024-11-27,8711
02001L,富邦蘋果正二N,35,0,35,陽信-石牌,2024-11-27,8711
4927,泰鼎-KY,33,0,33,陽信-石牌,2024-11-27,8711
2891,中信金,32,1,31,陽信-石牌,2024-11-27,8711
2330,台積電,33,3,30,陽信-石牌,2024-11-27,8711
1605,華新,30,0,30,陽信-石牌,2024-11-27,8711
6116,彩晶,30,0,30,陽信-石牌,2024-11-27,8711
5905,南仁湖,24,0,24,陽信-石牌,2024-11-27,8711
00648R,元大S＆P500反1,22,0,22,陽信-石牌,2024-11-27,8711
3234,光環,28,6,22,陽信-石牌,2024-11-27,8711
00915,凱基優選高股息30,20,0,20,陽信-石牌,2024-11-27,8711
2369,菱生,20,0,20,陽信-石牌,2024-11-27,8711
4968,立積,26,6,20,陽信-石牌,2024-11-27,8711
1203,味王,18,0,18,陽信-石牌,2024-11-27,8711
00927,群益半導體收益,16,0,16,陽信-石牌,2024-11-27,8711
2834,臺企銀,17,1,16,陽信-石牌,2024-11-27,8711
3062,建漢,15,0,15,陽信-石牌,2024-11-27,8711
00940,元大台灣價值高息,15,0,15,陽信-石牌,2024-11-27,8711
2406,國碩,15,0,15,陽信-石牌,2024-11-27,8711
2809,京城銀,15,0,15,陽信-石牌,2024-11-27,8711
3290,東浦,22,7,15,陽信-石牌,2024-11-27,8711
6266,泰詠,15,0,15,陽信-石牌,2024-11-27,8711
00881,國泰台灣5G+,14,0,14,陽信-石牌,2024-11-27,8711
4562,穎漢,32,18,14,陽信-石牌,2024-11-27,8711
6438,迅得,14,1,13,陽信-石牌,2024-11-27,8711
2489,瑞軒,13,1,12,陽信-石牌,2024-11-27,8711
6770,力積電,54,43,11,陽信-石牌,2024-11-27,8711
2344,華邦電,13,2,11,陽信-石牌,2024-11-27,8711
4526,東台,20,9,11,陽信-石牌,2024-11-27,8711
9921,巨大,11,0,11,陽信-石牌,2024-11-27,8711
2882,國泰金,10,0,10,陽信-石牌,2024-11-27,8711
00669R,國泰美國道瓊反1,10,0,10,陽信-石牌,2024-11-27,8711
1447,力鵬,10,0,10,陽信-石牌,2024-11-27,8711
1909,榮成,10,0,10,陽信-石牌,2024-11-27,8711
2323,中環,10,0,10,陽信-石牌,2024-11-27,8711
2363,矽統,11,1,10,陽信-石牌,2024-11-27,8711
2409,友達,10,0,10,陽信-石牌,2024-11-27,8711
2417,圓剛,16,6,10,陽信-石牌,2024-11-27,8711
2426,鼎元,27,17,10,陽信-石牌,2024-11-27,8711
2888,新光金,302,2,300,陽信-石牌,2024-11-28,8711
00948B,中信優息投資級債,150,5,145,陽信-石牌,2024-11-28,8711
2312,金寶,151,40,111,陽信-石牌,2024-11-28,8711
00878,國泰永續高股息,87,5,82,陽信-石牌,2024-11-28,8711
006208,富邦台50,58,0,58,陽信-石牌,2024-11-28,8711
2017,官田鋼,50,0,50,陽信-石牌,2024-11-28,8711
00919,群益台灣精選高息,63,20,43,陽信-石牌,2024-11-28,8711
00918,大華優利高填息30,26,1,25,陽信-石牌,2024-11-28,8711
8171,天宇,28,3,25,陽信-石牌,2024-11-28,8711
00669R,國泰美國道瓊反1,23,0,23,陽信-石牌,2024-11-28,8711
2371,大同,26,3,23,陽信-石牌,2024-11-28,8711
3033,威健,23,0,23,陽信-石牌,2024-11-28,8711
8240,華宏,22,0,22,陽信-石牌,2024-11-28,8711
00671R,富邦NASDAQ反1,20,0,20,陽信-石牌,2024-11-28,8711
2409,友達,20,0,20,陽信-石牌,2024-11-28,8711
3706,神達,74,55,19,陽信-石牌,2024-11-28,8711
2332,友訊,25,7,18,陽信-石牌,2024-11-28,8711
2609,陽明,26,8,18,陽信-石牌,2024-11-28,8711
3211,順達,18,0,18,陽信-石牌,2024-11-28,8711
2317,鴻海,23,6,17,陽信-石牌,2024-11-28,8711
2867,三商壽,17,0,17,陽信-石牌,2024-11-28,8711
3231,緯創,23,7,16,陽信-石牌,2024-11-28,8711
0056,元大高股息,16,1,15,陽信-石牌,2024-11-28,8711
2444,兆勁,33,20,13,陽信-石牌,2024-11-28,8711
2615,萬海,12,0,12,陽信-石牌,2024-11-28,8711
5309,系統電,20,8,12,陽信-石牌,2024-11-28,8711
2303,聯電,59,47,12,陽信-石牌,2024-11-28,8711
5009,榮剛,11,0,11,陽信-石牌,2024-11-28,8711
00888,永豐台灣ESG,10,0,10,陽信-石牌,2024-11-28,8711
00641R,富邦日本反1,10,0,10,陽信-石牌,2024-11-28,8711
00715L,期街口布蘭特正2,146,136,10,陽信-石牌,2024-11-28,8711
00927,群益半導體收益,10,0,10,陽信-石牌,2024-11-28,8711
1605,華新,11,1,10,陽信-石牌,2024-11-28,8711
2530,華建,10,0,10,陽信-石牌,2024-11-28,8711
2611,志信,10,0,10,陽信-石牌,2024-11-28,8711
3060,銘異,13,3,10,陽信-石牌,2024-11-28,8711
3711,日月光投控,10,0,10,陽信-石牌,2024-11-28,8711
5603,陸海,10,0,10,陽信-石牌,2024-11-28,8711
1815,富喬,40,31,9,陽信-石牌,2024-11-28,8711
3037,欣興,22,13,9,陽信-石牌,2024-11-28,8711
4510,高鋒,47,39,8,陽信-石牌,2024-11-28,8711
5534,長虹,8,0,8,陽信-石牌,2024-11-28,8711
6451,訊芯-KY,13,5,8,陽信-石牌,2024-11-28,8711
3293,鈊象,7,0,7,陽信-石牌,2024-11-28,8711
1203,味王,7,0,7,陽信-石牌,2024-11-28,8711
2344,華邦電,9,2,7,陽信-石牌,2024-11-28,8711
3402,漢科,7,0,7,陽信-石牌,2024-11-28,8711
3419,譁裕,7,0,7,陽信-石牌,2024-11-28,8711
8033,雷虎,9,2,7,陽信-石牌,2024-11-28,8711
2356,英業達,12,6,6,陽信-石牌,2024-11-28,8711
2887,台新金,253,0,253,陽信-石牌,2024-11-29,8711
00878,國泰永續高股息,117,5,112,陽信-石牌,2024-11-29,8711
8171,天宇,128,58,70,陽信-石牌,2024-11-29,8711
1203,味王,67,0,67,陽信-石牌,2024-11-29,8711
1402,遠東新,55,0,55,陽信-石牌,2024-11-29,8711
00948B,中信優息投資級債,50,0,50,陽信-石牌,2024-11-29,8711
3033,威健,38,0,38,陽信-石牌,2024-11-29,8711
0056,元大高股息,30,0,30,陽信-石牌,2024-11-29,8711
1718,中纖,30,0,30,陽信-石牌,2024-11-29,8711
3013,晟銘電,30,0,30,陽信-石牌,2024-11-29,8711
6127,九豪,41,13,28,陽信-石牌,2024-11-29,8711
4510,高鋒,26,3,23,陽信-石牌,2024-11-29,8711
2344,華邦電,22,0,22,陽信-石牌,2024-11-29,8711
00953B,群益優選非投等債,20,0,20,陽信-石牌,2024-11-29,8711
00664R,國泰臺灣加權反1,20,0,20,陽信-石牌,2024-11-29,8711
9925,新保,20,0,20,陽信-石牌,2024-11-29,8711
9904,寶成,20,1,19,陽信-石牌,2024-11-29,8711
00919,群益台灣精選高息,18,0,18,陽信-石牌,2024-11-29,8711
00937B,群益ESG投等債20,30,13,17,陽信-石牌,2024-11-29,8711
5880,合庫金,17,0,17,陽信-石牌,2024-11-29,8711
0050,元大台灣50,16,0,16,陽信-石牌,2024-11-29,8711
2303,聯電,27,12,15,陽信-石牌,2024-11-29,8711
5871,中租-KY,15,1,14,陽信-石牌,2024-11-29,8711
2812,台中銀,15,1,14,陽信-石牌,2024-11-29,8711
5309,系統電,68,54,14,陽信-石牌,2024-11-29,8711
2317,鴻海,24,11,13,陽信-石牌,2024-11-29,8711
00887,永豐中國科技50大,15,3,12,陽信-石牌,2024-11-29,8711
2883,凱基金,12,0,12,陽信-石牌,2024-11-29,8711
2736,富野,11,0,11,陽信-石牌,2024-11-29,8711
3027,盛達,11,0,11,陽信-石牌,2024-11-29,8711
2330,台積電,10,0,10,陽信-石牌,2024-11-29,8711
00918,大華優利高填息30,10,0,10,陽信-石牌,2024-11-29,8711
1312,國喬,10,0,10,陽信-石牌,2024-11-29,8711
2609,陽明,26,16,10,陽信-石牌,2024-11-29,8711
6182,合晶,10,0,10,陽信-石牌,2024-11-29,8711
8105,凌巨,10,0,10,陽信-石牌,2024-11-29,8711
1301,台塑,10,0,10,陽信-石牌,2024-11-29,8711
2704,國賓,9,0,9,陽信-石牌,2024-11-29,8711
3521,鴻翊,8,0,8,陽信-石牌,2024-11-29,8711
4931,新盛力,20,12,8,陽信-石牌,2024-11-29,8711
1414,東和,7,0,7,陽信-石牌,2024-11-29,8711
2313,華通,7,0,7,陽信-石牌,2024-11-29,8711
3062,建漢,10,3,7,陽信-石牌,2024-11-29,8711
3447,展達,12,5,7,陽信-石牌,2024-11-29,8711
3707,漢磊,7,0,7,陽信-石牌,2024-11-29,8711
6175,立敦,6,0,6,陽信-石牌,2024-11-29,8711
1308,亞聚,5,0,5,陽信-石牌,2024-11-29,8711
00650L,復華香港正2,8,3,5,陽信-石牌,2024-11-29,8711
00641R,富邦日本反1,5,0,5,陽信-石牌,2024-11-29,8711
00634R,富邦上証反1,5,0,5,陽信-石牌,2024-11-29,8711
00937B,群益ESG投等債20,681,150,531,陽信-石牌,2024-12-02,8711
00715L,期街口布蘭特正2,196,0,196,陽信-石牌,2024-12-02,8711
00922,國泰台灣領袖50,88,0,88,陽信-石牌,2024-12-02,8711
5907,大洋-KY,103,20,83,陽信-石牌,2024-12-02,8711
00676R,富邦臺灣加權反1,71,0,71,陽信-石牌,2024-12-02,8711
1504,東元,46,0,46,陽信-石牌,2024-12-02,8711
2349,錸德,41,0,41,陽信-石牌,2024-12-02,8711
1536,和大,48,8,40,陽信-石牌,2024-12-02,8711
2354,鴻準,63,26,37,陽信-石牌,2024-12-02,8711
2834,臺企銀,50,17,33,陽信-石牌,2024-12-02,8711
5864,致和證,40,8,32,陽信-石牌,2024-12-02,8711
2337,旺宏,30,0,30,陽信-石牌,2024-12-02,8711
2312,金寶,221,196,25,陽信-石牌,2024-12-02,8711
2637,慧洋-KY,25,0,25,陽信-石牌,2024-12-02,8711
00953B,群益優選非投等債,23,0,23,陽信-石牌,2024-12-02,8711
2344,華邦電,35,13,22,陽信-石牌,2024-12-02,8711
2002,中鋼,20,0,20,陽信-石牌,2024-12-02,8711
2401,凌陽,20,0,20,陽信-石牌,2024-12-02,8711
3558,神準,20,0,20,陽信-石牌,2024-12-02,8711
5328,華容,36,16,20,陽信-石牌,2024-12-02,8711
3450,聯鈞,32,14,18,陽信-石牌,2024-12-02,8711
3033,威健,17,1,16,陽信-石牌,2024-12-02,8711
9904,寶成,17,4,13,陽信-石牌,2024-12-02,8711
1815,富喬,76,64,12,陽信-石牌,2024-12-02,8711
2070,精湛,12,0,12,陽信-石牌,2024-12-02,8711
2426,鼎元,12,0,12,陽信-石牌,2024-12-02,8711
4979,華星光,42,30,12,陽信-石牌,2024-12-02,8711
2356,英業達,19,8,11,陽信-石牌,2024-12-02,8711
6127,九豪,11,0,11,陽信-石牌,2024-12-02,8711
6770,力積電,31,20,11,陽信-石牌,2024-12-02,8711
4991,環宇-KY,13,3,10,陽信-石牌,2024-12-02,8711
00887,永豐中國科技50大,10,0,10,陽信-石牌,2024-12-02,8711
1308,亞聚,10,0,10,陽信-石牌,2024-12-02,8711
1714,和桐,10,0,10,陽信-石牌,2024-12-02,8711
2630,亞航,11,1,10,陽信-石牌,2024-12-02,8711
2881,富邦金,10,0,10,陽信-石牌,2024-12-02,8711
3114,好德,10,0,10,陽信-石牌,2024-12-02,8711
6288,聯嘉,10,0,10,陽信-石牌,2024-12-02,8711
2382,廣達,9,0,9,陽信-石牌,2024-12-02,8711
3211,順達,16,7,9,陽信-石牌,2024-12-02,8711
6443,元晶,8,0,8,陽信-石牌,2024-12-02,8711
2474,可成,8,0,8,陽信-石牌,2024-12-02,8711
1528,恩德,8,1,7,陽信-石牌,2024-12-02,8711
4919,新唐,7,0,7,陽信-石牌,2024-12-02,8711
5244,弘凱,24,17,7,陽信-石牌,2024-12-02,8711
5534,長虹,7,0,7,陽信-石牌,2024-12-02,8711
6176,瑞儀,8,1,7,陽信-石牌,2024-12-02,8711
1301,台塑,6,0,6,陽信-石牌,2024-12-02,8711
4927,泰鼎-KY,7,1,6,陽信-石牌,2024-12-02,8711
6757,台灣虎航,11,5,6,陽信-石牌,2024-12-02,8711
00919,群益台灣精選高息,373,101,272,陽信-石牌,2024-12-03,8711
00946,群益科技高息成長,102,0,102,陽信-石牌,2024-12-03,8711
00918,大華優利高填息30,89,1,88,陽信-石牌,2024-12-03,8711
00713,元大台灣高息低波,81,0,81,陽信-石牌,2024-12-03,8711
00632R,元大台灣50反1,100,32,68,陽信-石牌,2024-12-03,8711
00953B,群益優選非投等債,60,0,60,陽信-石牌,2024-12-03,8711
4971,IET-KY,45,1,44,陽信-石牌,2024-12-03,8711
2883,凱基金,50,11,39,陽信-石牌,2024-12-03,8711
3211,順達,61,25,36,陽信-石牌,2024-12-03,8711
2615,萬海,56,28,28,陽信-石牌,2024-12-03,8711
00887,永豐中國科技50大,22,0,22,陽信-石牌,2024-12-03,8711
2303,聯電,25,4,21,陽信-石牌,2024-12-03,8711
6235,華孚,20,0,20,陽信-石牌,2024-12-03,8711
6279,胡連,20,0,20,陽信-石牌,2024-12-03,8711
3447,展達,27,8,19,陽信-石牌,2024-12-03,8711
2476,鉅祥,16,4,12,陽信-石牌,2024-12-03,8711
4303,信立,15,3,12,陽信-石牌,2024-12-03,8711
2357,華碩,11,0,11,陽信-石牌,2024-12-03,8711
2327,國巨,12,1,11,陽信-石牌,2024-12-03,8711
2317,鴻海,67,56,11,陽信-石牌,2024-12-03,8711
00706L,期元大S＆P日圓正2,10,0,10,陽信-石牌,2024-12-03,8711
1532,勤美,10,0,10,陽信-石牌,2024-12-03,8711
1714,和桐,10,0,10,陽信-石牌,2024-12-03,8711
2344,華邦電,11,1,10,陽信-石牌,2024-12-03,8711
2867,三商壽,10,0,10,陽信-石牌,2024-12-03,8711
4123,晟德,20,10,10,陽信-石牌,2024-12-03,8711
4127,天良,10,0,10,陽信-石牌,2024-12-03,8711
6142,友勁,10,0,10,陽信-石牌,2024-12-03,8711
3090,日電貿,26,18,8,陽信-石牌,2024-12-03,8711
4938,和碩,10,2,8,陽信-石牌,2024-12-03,8711
8110,華東,10,2,8,陽信-石牌,2024-12-03,8711
8431,匯鑽科,8,0,8,陽信-石牌,2024-12-03,8711
00940,元大台灣價值高息,10,3,7,陽信-石牌,2024-12-03,8711
2258,鴻華先進-創,7,0,7,陽信-石牌,2024-12-03,8711
2426,鼎元,16,9,7,陽信-石牌,2024-12-03,8711
3037,欣興,15,8,7,陽信-石牌,2024-12-03,8711
4526,東台,7,0,7,陽信-石牌,2024-12-03,8711
6492,生華科,10,3,7,陽信-石牌,2024-12-03,8711
1815,富喬,18,12,6,陽信-石牌,2024-12-03,8711
3019,亞光,9,3,6,陽信-石牌,2024-12-03,8711
3558,神準,11,5,6,陽信-石牌,2024-12-03,8711
6491,晶碩,7,1,6,陽信-石牌,2024-12-03,8711
00641R,富邦日本反1,5,0,5,陽信-石牌,2024-12-03,8711
1477,聚陽,5,0,5,陽信-石牌,2024-12-03,8711
2034,允強,5,0,5,陽信-石牌,2024-12-03,8711
2353,宏��,6,1,5,陽信-石牌,2024-12-03,8711
2367,燿華,5,0,5,陽信-石牌,2024-12-03,8711
2405,輔信,10,5,5,陽信-石牌,2024-12-03,8711
3025,星通,9,4,5,陽信-石牌,2024-12-03,8711
3114,好德,5,0,5,陽信-石牌,2024-12-03,8711
00878,國泰永續高股息,93,5,88,陽信-石牌,2024-12-04,8711
00919,群益台灣精選高息,85,14,71,陽信-石牌,2024-12-04,8711
00918,大華優利高填息30,66,0,66,陽信-石牌,2024-12-04,8711
5309,系統電,123,64,59,陽信-石牌,2024-12-04,8711
3062,建漢,55,0,55,陽信-石牌,2024-12-04,8711
2312,金寶,187,135,52,陽信-石牌,2024-12-04,8711
2610,華航,89,58,31,陽信-石牌,2024-12-04,8711
9105,泰金寶-DR,112,84,28,陽信-石牌,2024-12-04,8711
1605,華新,27,0,27,陽信-石牌,2024-12-04,8711
3511,矽瑪,35,11,24,陽信-石牌,2024-12-04,8711
4916,事欣科,28,5,23,陽信-石牌,2024-12-04,8711
00937B,群益ESG投等債20,85,63,22,陽信-石牌,2024-12-04,8711
9904,寶成,31,10,21,陽信-石牌,2024-12-04,8711
00687B,國泰20年美債,20,0,20,陽信-石牌,2024-12-04,8711
2637,慧洋-KY,21,1,20,陽信-石牌,2024-12-04,8711
6127,九豪,36,17,19,陽信-石牌,2024-12-04,8711
6134,萬旭,16,0,16,陽信-石牌,2024-12-04,8711
00857B,永豐20年美公債,15,0,15,陽信-石牌,2024-12-04,8711
4729,熒茂,15,0,15,陽信-石牌,2024-12-04,8711
2888,新光金,16,2,14,陽信-石牌,2024-12-04,8711
6451,訊芯-KY,36,22,14,陽信-石牌,2024-12-04,8711
00887,永豐中國科技50大,11,0,11,陽信-石牌,2024-12-04,8711
0056,元大高股息,13,2,11,陽信-石牌,2024-12-04,8711
1308,亞聚,11,1,10,陽信-石牌,2024-12-04,8711
1711,永光,10,0,10,陽信-石牌,2024-12-04,8711
1714,和桐,10,0,10,陽信-石牌,2024-12-04,8711
2524,京城,10,0,10,陽信-石牌,2024-12-04,8711
2834,臺企銀,10,0,10,陽信-石牌,2024-12-04,8711
6265,方土昶,10,0,10,陽信-石牌,2024-12-04,8711
6443,元晶,10,0,10,陽信-石牌,2024-12-04,8711
6806,森崴能源,10,0,10,陽信-石牌,2024-12-04,8711
2382,廣達,11,1,10,陽信-石牌,2024-12-04,8711
4979,華星光,21,12,9,陽信-石牌,2024-12-04,8711
2388,威盛,10,2,8,陽信-石牌,2024-12-04,8711
5457,宣德,10,2,8,陽信-石牌,2024-12-04,8711
1519,華城,13,5,8,陽信-石牌,2024-12-04,8711
1316,上曜,8,0,8,陽信-石牌,2024-12-04,8711
00679B,元大美債20年,7,0,7,陽信-石牌,2024-12-04,8711
3032,偉訓,37,31,6,陽信-石牌,2024-12-04,8711
2543,皇昌,6,0,6,陽信-石牌,2024-12-04,8711
3706,神達,110,104,6,陽信-石牌,2024-12-04,8711
6173,信昌電,7,2,5,陽信-石牌,2024-12-04,8711
1503,士電,5,0,5,陽信-石牌,2024-12-04,8711
2444,兆勁,12,7,5,陽信-石牌,2024-12-04,8711
1314,中石化,5,0,5,陽信-石牌,2024-12-04,8711
00932,兆豐永續高息等權,5,0,5,陽信-石牌,2024-12-04,8711
00753L,中信中國50正2,5,0,5,陽信-石牌,2024-12-04,8711
1456,怡華,5,0,5,陽信-石牌,2024-12-04,8711
1513,中興電,5,0,5,陽信-石牌,2024-12-04,8711
2809,京城銀,5,0,5,陽信-石牌,2024-12-04,8711
1815,富喬,270,103,167,陽信-石牌,2024-12-05,8711
3481,群創,160,14,146,陽信-石牌,2024-12-05,8711
2444,兆勁,96,0,96,陽信-石牌,2024-12-05,8711
1611,中電,70,0,70,陽信-石牌,2024-12-05,8711
2476,鉅祥,68,3,65,陽信-石牌,2024-12-05,8711
2409,友達,61,0,61,陽信-石牌,2024-12-05,8711
1447,力鵬,52,2,50,陽信-石牌,2024-12-05,8711
2504,國產,44,0,44,陽信-石牌,2024-12-05,8711
2349,錸德,41,0,41,陽信-石牌,2024-12-05,8711
6451,訊芯-KY,57,22,35,陽信-石牌,2024-12-05,8711
0056,元大高股息,30,0,30,陽信-石牌,2024-12-05,8711
1718,中纖,30,0,30,陽信-石牌,2024-12-05,8711
2492,華新科,29,1,28,陽信-石牌,2024-12-05,8711
2303,聯電,53,27,26,陽信-石牌,2024-12-05,8711
1605,華新,25,0,25,陽信-石牌,2024-12-05,8711
2457,飛宏,31,6,25,陽信-石牌,2024-12-05,8711
4157,太景*-KY,20,0,20,陽信-石牌,2024-12-05,8711
3078,僑威,26,7,19,陽信-石牌,2024-12-05,8711
8171,天宇,23,5,18,陽信-石牌,2024-12-05,8711
2609,陽明,70,52,18,陽信-石牌,2024-12-05,8711
3450,聯鈞,22,5,17,陽信-石牌,2024-12-05,8711
1402,遠東新,17,0,17,陽信-石牌,2024-12-05,8711
3090,日電貿,39,24,15,陽信-石牌,2024-12-05,8711
3234,光環,12,0,12,陽信-石牌,2024-12-05,8711
5328,華容,37,25,12,陽信-石牌,2024-12-05,8711
5371,中光電,13,1,12,陽信-石牌,2024-12-05,8711
00918,大華優利高填息30,11,0,11,陽信-石牌,2024-12-05,8711
2070,精湛,11,0,11,陽信-石牌,2024-12-05,8711
2317,鴻海,79,69,10,陽信-石牌,2024-12-05,8711
00940,元大台灣價值高息,10,0,10,陽信-石牌,2024-12-05,8711
00665L,富邦�琤肭磪囓�2,20,10,10,陽信-石牌,2024-12-05,8711
1515,力山,10,0,10,陽信-石牌,2024-12-05,8711
2027,大成鋼,15,5,10,陽信-石牌,2024-12-05,8711
2538,基泰,10,0,10,陽信-石牌,2024-12-05,8711
2641,正德,10,0,10,陽信-石牌,2024-12-05,8711
2890,永豐金,10,0,10,陽信-石牌,2024-12-05,8711
3021,鴻名,10,0,10,陽信-石牌,2024-12-05,8711
3062,建漢,12,2,10,陽信-石牌,2024-12-05,8711
3550,聯穎,10,0,10,陽信-石牌,2024-12-05,8711
6438,迅得,10,0,10,陽信-石牌,2024-12-05,8711
6491,晶碩,10,0,10,陽信-石牌,2024-12-05,8711
8033,雷虎,10,0,10,陽信-石牌,2024-12-05,8711
1326,台化,10,0,10,陽信-石牌,2024-12-05,8711
4909,新復興,10,0,10,陽信-石牌,2024-12-05,8711
00909,國泰數位支付服務,10,1,9,陽信-石牌,2024-12-05,8711
4931,新盛力,36,27,9,陽信-石牌,2024-12-05,8711
6213,聯茂,12,3,9,陽信-石牌,2024-12-05,8711
6274,台燿,8,0,8,陽信-石牌,2024-12-05,8711
6806,森崴能源,8,0,8,陽信-石牌,2024-12-05,8711
2204,中華,7,0,7,陽信-石牌,2024-12-05,8711
00673R,期元大S＆P原油反1,237,0,237,陽信-石牌,2024-12-06,8711
00918,大華優利高填息30,215,0,215,陽信-石牌,2024-12-06,8711
00715L,期街口布蘭特正2,275,140,135,陽信-石牌,2024-12-06,8711
00676R,富邦臺灣加權反1,64,0,64,陽信-石牌,2024-12-06,8711
6763,綠界科技*,58,0,58,陽信-石牌,2024-12-06,8711
2405,輔信,64,7,57,陽信-石牌,2024-12-06,8711
3545,敦泰,38,1,37,陽信-石牌,2024-12-06,8711
2354,鴻準,256,219,37,陽信-石牌,2024-12-06,8711
00922,國泰台灣領袖50,31,0,31,陽信-石牌,2024-12-06,8711
2409,友達,30,0,30,陽信-石牌,2024-12-06,8711
9105,泰金寶-DR,30,0,30,陽信-石牌,2024-12-06,8711
00713,元大台灣高息低波,30,1,29,陽信-石牌,2024-12-06,8711
5309,系統電,70,43,27,陽信-石牌,2024-12-06,8711
3521,鴻翊,26,0,26,陽信-石牌,2024-12-06,8711
6472,保瑞,25,1,24,陽信-石牌,2024-12-06,8711
00878,國泰永續高股息,22,0,22,陽信-石牌,2024-12-06,8711
2352,佳世達,21,0,21,陽信-石牌,2024-12-06,8711
5880,合庫金,81,60,21,陽信-石牌,2024-12-06,8711
00919,群益台灣精選高息,21,0,21,陽信-石牌,2024-12-06,8711
00962,台新AI優息動能,20,0,20,陽信-石牌,2024-12-06,8711
2605,新興,20,0,20,陽信-石牌,2024-12-06,8711
4931,新盛力,49,29,20,陽信-石牌,2024-12-06,8711
6282,康舒,20,0,20,陽信-石牌,2024-12-06,8711
1802,台玻,28,10,18,陽信-石牌,2024-12-06,8711
2476,鉅祥,22,4,18,陽信-石牌,2024-12-06,8711
3706,神達,77,61,16,陽信-石牌,2024-12-06,8711
3078,僑威,20,5,15,陽信-石牌,2024-12-06,8711
4909,新復興,15,0,15,陽信-石牌,2024-12-06,8711
5371,中光電,13,0,13,陽信-石牌,2024-12-06,8711
3591,艾笛森,13,1,12,陽信-石牌,2024-12-06,8711
6541,泰福-KY,12,0,12,陽信-石牌,2024-12-06,8711
1203,味王,11,0,11,陽信-石牌,2024-12-06,8711
3043,科風,12,1,11,陽信-石牌,2024-12-06,8711
4916,事欣科,11,0,11,陽信-石牌,2024-12-06,8711
2337,旺宏,11,1,10,陽信-石牌,2024-12-06,8711
2349,錸德,10,0,10,陽信-石牌,2024-12-06,8711
3402,漢科,10,0,10,陽信-石牌,2024-12-06,8711
6133,金橋,10,0,10,陽信-石牌,2024-12-06,8711
6265,方土昶,10,0,10,陽信-石牌,2024-12-06,8711
7705,三商餐飲,10,0,10,陽信-石牌,2024-12-06,8711
2332,友訊,9,0,9,陽信-石牌,2024-12-06,8711
2444,兆勁,9,0,9,陽信-石牌,2024-12-06,8711
3625,西勝,10,1,9,陽信-石牌,2024-12-06,8711
2062,橋椿,21,13,8,陽信-石牌,2024-12-06,8711
2312,金寶,179,171,8,陽信-石牌,2024-12-06,8711
4956,光鋐,12,4,8,陽信-石牌,2024-12-06,8711
2317,鴻海,42,35,7,陽信-石牌,2024-12-06,8711
3015,全漢,8,1,7,陽信-石牌,2024-12-06,8711
3029,零壹,22,15,7,陽信-石牌,2024-12-06,8711
6491,晶碩,9,2,7,陽信-石牌,2024-12-06,8711
00715L,期街口布蘭特正2,210,0,210,陽信-石牌,2024-12-09,8711
2344,華邦電,201,1,200,陽信-石牌,2024-12-09,8711
9105,泰金寶-DR,123,36,87,陽信-石牌,2024-12-09,8711
3481,群創,200,126,74,陽信-石牌,2024-12-09,8711
2399,映泰,122,48,74,陽信-石牌,2024-12-09,8711
5880,合庫金,70,0,70,陽信-石牌,2024-12-09,8711
00953B,群益優選非投等債,666,601,65,陽信-石牌,2024-12-09,8711
2312,金寶,142,80,62,陽信-石牌,2024-12-09,8711
2615,萬海,60,5,55,陽信-石牌,2024-12-09,8711
2834,臺企銀,51,1,50,陽信-石牌,2024-12-09,8711
3003,健和興,60,13,47,陽信-石牌,2024-12-09,8711
00940,元大台灣價值高息,44,1,43,陽信-石牌,2024-12-09,8711
00959B,大華投等美債15Y+,30,0,30,陽信-石牌,2024-12-09,8711
5202,力新,31,2,29,陽信-石牌,2024-12-09,8711
00937B,群益ESG投等債20,30,2,28,陽信-石牌,2024-12-09,8711
2883,凱基金,26,0,26,陽信-石牌,2024-12-09,8711
9904,寶成,26,1,25,陽信-石牌,2024-12-09,8711
2374,佳能,22,0,22,陽信-石牌,2024-12-09,8711
2495,普安,46,25,21,陽信-石牌,2024-12-09,8711
3078,僑威,25,4,21,陽信-石牌,2024-12-09,8711
2436,偉詮電,21,1,20,陽信-石牌,2024-12-09,8711
2472,立隆電,20,0,20,陽信-石牌,2024-12-09,8711
2504,國產,20,0,20,陽信-石牌,2024-12-09,8711
2890,永豐金,25,5,20,陽信-石牌,2024-12-09,8711
8240,華宏,20,0,20,陽信-石牌,2024-12-09,8711
3211,順達,23,4,19,陽信-石牌,2024-12-09,8711
2317,鴻海,25,7,18,陽信-石牌,2024-12-09,8711
4968,立積,24,7,17,陽信-石牌,2024-12-09,8711
6426,統新,19,3,16,陽信-石牌,2024-12-09,8711
1711,永光,15,0,15,陽信-石牌,2024-12-09,8711
6140,訊達,15,0,15,陽信-石牌,2024-12-09,8711
8076,伍豐,15,0,15,陽信-石牌,2024-12-09,8711
1815,富喬,21,6,15,陽信-石牌,2024-12-09,8711
2520,冠德,15,1,14,陽信-石牌,2024-12-09,8711
1203,味王,11,0,11,陽信-石牌,2024-12-09,8711
1609,大亞,11,0,11,陽信-石牌,2024-12-09,8711
00932,兆豐永續高息等權,10,0,10,陽信-石牌,2024-12-09,8711
00713,元大台灣高息低波,10,0,10,陽信-石牌,2024-12-09,8711
2062,橋椿,10,0,10,陽信-石牌,2024-12-09,8711
2444,兆勁,20,10,10,陽信-石牌,2024-12-09,8711
4526,東台,10,0,10,陽信-石牌,2024-12-09,8711
6443,元晶,10,0,10,陽信-石牌,2024-12-09,8711
8105,凌巨,10,0,10,陽信-石牌,2024-12-09,8711
8110,華東,10,0,10,陽信-石牌,2024-12-09,8711
8150,南茂,10,0,10,陽信-石牌,2024-12-09,8711
6451,訊芯-KY,17,7,10,陽信-石牌,2024-12-09,8711
2884,玉山金,10,1,9,陽信-石牌,2024-12-09,8711
3041,揚智,10,1,9,陽信-石牌,2024-12-09,8711
3450,聯鈞,28,19,9,陽信-石牌,2024-12-09,8711
4909,新復興,10,1,9,陽信-石牌,2024-12-09,8711
2888,新光金,300,1,299,陽信-石牌,2024-12-10,8711
00673R,期元大S＆P原油反1,242,0,242,陽信-石牌,2024-12-10,8711
3481,群創,164,8,156,陽信-石牌,2024-12-10,8711
5880,合庫金,114,0,114,陽信-石牌,2024-12-10,8711
00665L,富邦�琤肭磪囓�2,150,50,100,陽信-石牌,2024-12-10,8711
8011,台通,90,0,90,陽信-石牌,2024-12-10,8711
2344,華邦電,114,31,83,陽信-石牌,2024-12-10,8711
2610,華航,93,11,82,陽信-石牌,2024-12-10,8711
00687B,國泰20年美債,75,0,75,陽信-石牌,2024-12-10,8711
2375,凱美,72,1,71,陽信-石牌,2024-12-10,8711
2605,新興,63,6,57,陽信-石牌,2024-12-10,8711
2609,陽明,315,259,56,陽信-石牌,2024-12-10,8711
2444,兆勁,40,0,40,陽信-石牌,2024-12-10,8711
1203,味王,38,0,38,陽信-石牌,2024-12-10,8711
00900,富邦特選高股息30,35,0,35,陽信-石牌,2024-12-10,8711
3615,安可,33,0,33,陽信-石牌,2024-12-10,8711
2618,長榮航,30,5,25,陽信-石牌,2024-12-10,8711
3706,神達,85,60,25,陽信-石牌,2024-12-10,8711
9904,寶成,25,0,25,陽信-石牌,2024-12-10,8711
2317,鴻海,33,12,21,陽信-石牌,2024-12-10,8711
8042,金山電,21,1,20,陽信-石牌,2024-12-10,8711
1449,佳和,27,8,19,陽信-石牌,2024-12-10,8711
3607,谷崧,33,16,17,陽信-石牌,2024-12-10,8711
6806,森崴能源,17,0,17,陽信-石牌,2024-12-10,8711
3450,聯鈞,30,14,16,陽信-石牌,2024-12-10,8711
1802,台玻,21,6,15,陽信-石牌,2024-12-10,8711
3521,鴻翊,15,0,15,陽信-石牌,2024-12-10,8711
00918,大華優利高填息30,14,0,14,陽信-石牌,2024-12-10,8711
00922,國泰台灣領袖50,15,1,14,陽信-石牌,2024-12-10,8711
1446,宏和,14,0,14,陽信-石牌,2024-12-10,8711
2312,金寶,34,20,14,陽信-石牌,2024-12-10,8711
8096,擎亞,14,0,14,陽信-石牌,2024-12-10,8711
00651R,復華香港反1,20,7,13,陽信-石牌,2024-12-10,8711
1815,富喬,20,9,11,陽信-石牌,2024-12-10,8711
3234,光環,11,0,11,陽信-石牌,2024-12-10,8711
3710,連展投控,12,1,11,陽信-石牌,2024-12-10,8711
1471,首利,10,0,10,陽信-石牌,2024-12-10,8711
1785,光洋科,16,6,10,陽信-石牌,2024-12-10,8711
2641,正德,10,0,10,陽信-石牌,2024-12-10,8711
2886,兆豐金,10,0,10,陽信-石牌,2024-12-10,8711
3360,尚立,10,0,10,陽信-石牌,2024-12-10,8711
4303,信立,11,1,10,陽信-石牌,2024-12-10,8711
4906,正文,10,0,10,陽信-石牌,2024-12-10,8711
4909,新復興,10,0,10,陽信-石牌,2024-12-10,8711
5603,陸海,10,0,10,陽信-石牌,2024-12-10,8711
6127,九豪,12,2,10,陽信-石牌,2024-12-10,8711
6472,保瑞,10,0,10,陽信-石牌,2024-12-10,8711
1612,宏泰,9,0,9,陽信-石牌,2024-12-10,8711
2399,映泰,31,22,9,陽信-石牌,2024-12-10,8711
2890,永豐金,9,0,9,陽信-石牌,2024-12-10,8711
0050,元大台灣50,376,0,376,陽信-石牌,2024-12-11,8711
2609,陽明,162,17,145,陽信-石牌,2024-12-11,8711
00715L,期街口布蘭特正2,144,60,84,陽信-石牌,2024-12-11,8711
00918,大華優利高填息30,66,0,66,陽信-石牌,2024-12-11,8711
6770,力積電,73,26,47,陽信-石牌,2024-12-11,8711
1611,中電,57,10,47,陽信-石牌,2024-12-11,8711
5880,合庫金,43,0,43,陽信-石牌,2024-12-11,8711
2317,鴻海,71,35,36,陽信-石牌,2024-12-11,8711
00900,富邦特選高股息30,35,0,35,陽信-石牌,2024-12-11,8711
00946,群益科技高息成長,33,0,33,陽信-石牌,2024-12-11,8711
3056,富華新,33,0,33,陽信-石牌,2024-12-11,8711
1605,華新,31,0,31,陽信-石牌,2024-12-11,8711
1449,佳和,43,15,28,陽信-石牌,2024-12-11,8711
5202,力新,28,1,27,陽信-石牌,2024-12-11,8711
3003,健和興,29,3,26,陽信-石牌,2024-12-11,8711
2344,華邦電,29,4,25,陽信-石牌,2024-12-11,8711
3481,群創,89,64,25,陽信-石牌,2024-12-11,8711
2605,新興,30,6,24,陽信-石牌,2024-12-11,8711
2201,裕隆,24,1,23,陽信-石牌,2024-12-11,8711
00671R,富邦NASDAQ反1,20,0,20,陽信-石牌,2024-12-11,8711
2845,遠東銀,20,0,20,陽信-石牌,2024-12-11,8711
00919,群益台灣精選高息,18,0,18,陽信-石牌,2024-12-11,8711
2303,聯電,24,6,18,陽信-石牌,2024-12-11,8711
3013,晟銘電,31,13,18,陽信-石牌,2024-12-11,8711
00922,國泰台灣領袖50,16,0,16,陽信-石牌,2024-12-11,8711
00688L,國泰20年美債正2,18,2,16,陽信-石牌,2024-12-11,8711
3234,光環,18,2,16,陽信-石牌,2024-12-11,8711
3521,鴻翊,15,0,15,陽信-石牌,2024-12-11,8711
3615,安可,20,5,15,陽信-石牌,2024-12-11,8711
6706,惠特,16,1,15,陽信-石牌,2024-12-11,8711
9904,寶成,14,0,14,陽信-石牌,2024-12-11,8711
2367,燿華,17,3,14,陽信-石牌,2024-12-11,8711
3231,緯創,14,1,13,陽信-石牌,2024-12-11,8711
4931,新盛力,16,4,12,陽信-石牌,2024-12-11,8711
2316,楠梓電,12,0,12,陽信-石牌,2024-12-11,8711
2363,矽統,28,17,11,陽信-石牌,2024-12-11,8711
0056,元大高股息,12,2,10,陽信-石牌,2024-12-11,8711
00952,凱基台灣AI50,10,0,10,陽信-石牌,2024-12-11,8711
00948B,中信優息投資級債,10,0,10,陽信-石牌,2024-12-11,8711
1474,弘裕,10,0,10,陽信-石牌,2024-12-11,8711
1519,華城,11,1,10,陽信-石牌,2024-12-11,8711
1711,永光,10,0,10,陽信-石牌,2024-12-11,8711
2006,東和鋼鐵,10,0,10,陽信-石牌,2024-12-11,8711
2538,基泰,10,0,10,陽信-石牌,2024-12-11,8711
5871,中租-KY,10,0,10,陽信-石牌,2024-12-11,8711
2371,大同,9,0,9,陽信-石牌,2024-12-11,8711
2488,漢平,10,1,9,陽信-石牌,2024-12-11,8711
2886,兆豐金,10,2,8,陽信-石牌,2024-12-11,8711
6112,邁達特,8,0,8,陽信-石牌,2024-12-11,8711
2382,廣達,9,2,7,陽信-石牌,2024-12-11,8711
00679B,元大美債20年,130,0,130,陽信-石牌,2024-12-12,8711
00713,元大台灣高息低波,64,0,64,陽信-石牌,2024-12-12,8711
2330,台積電,67,5,62,陽信-石牌,2024-12-12,8711
5880,合庫金,60,0,60,陽信-石牌,2024-12-12,8711
00915,凱基優選高股息30,50,0,50,陽信-石牌,2024-12-12,8711
00687B,國泰20年美債,49,0,49,陽信-石牌,2024-12-12,8711
2312,金寶,56,11,45,陽信-石牌,2024-12-12,8711
00857B,永豐20年美公債,40,0,40,陽信-石牌,2024-12-12,8711
2367,燿華,27,3,24,陽信-石牌,2024-12-12,8711
2344,華邦電,37,13,24,陽信-石牌,2024-12-12,8711
2354,鴻準,61,38,23,陽信-石牌,2024-12-12,8711
2371,大同,20,0,20,陽信-石牌,2024-12-12,8711
3049,精金,20,0,20,陽信-石牌,2024-12-12,8711
3056,富華新,20,0,20,陽信-石牌,2024-12-12,8711
4564,元翎,20,0,20,陽信-石牌,2024-12-12,8711
5871,中租-KY,17,0,17,陽信-石牌,2024-12-12,8711
1447,力鵬,16,0,16,陽信-石牌,2024-12-12,8711
3323,加百裕,21,5,16,陽信-石牌,2024-12-12,8711
00878,國泰永續高股息,18,3,15,陽信-石牌,2024-12-12,8711
00688L,國泰20年美債正2,15,0,15,陽信-石牌,2024-12-12,8711
1815,富喬,57,42,15,陽信-石牌,2024-12-12,8711
2303,聯電,36,21,15,陽信-石牌,2024-12-12,8711
5202,力新,15,0,15,陽信-石牌,2024-12-12,8711
1802,台玻,23,11,12,陽信-石牌,2024-12-12,8711
2886,兆豐金,12,0,12,陽信-石牌,2024-12-12,8711
3376,新日興,11,0,11,陽信-石牌,2024-12-12,8711
0056,元大高股息,10,0,10,陽信-石牌,2024-12-12,8711
1714,和桐,10,0,10,陽信-石牌,2024-12-12,8711
3189,景碩,10,0,10,陽信-石牌,2024-12-12,8711
3234,光環,11,1,10,陽信-石牌,2024-12-12,8711
4934,太極,10,0,10,陽信-石牌,2024-12-12,8711
6266,泰詠,10,0,10,陽信-石牌,2024-12-12,8711
1449,佳和,13,4,9,陽信-石牌,2024-12-12,8711
2314,台揚,10,1,9,陽信-石牌,2024-12-12,8711
2468,華經,24,15,9,陽信-石牌,2024-12-12,8711
2538,基泰,9,0,9,陽信-石牌,2024-12-12,8711
3211,順達,14,5,9,陽信-石牌,2024-12-12,8711
6108,競國,9,0,9,陽信-石牌,2024-12-12,8711
6451,訊芯-KY,13,4,9,陽信-石牌,2024-12-12,8711
6806,森崴能源,9,0,9,陽信-石牌,2024-12-12,8711
1504,東元,10,2,8,陽信-石牌,2024-12-12,8711
1442,名軒,8,0,8,陽信-石牌,2024-12-12,8711
2605,新興,8,0,8,陽信-石牌,2024-12-12,8711
3032,偉訓,13,5,8,陽信-石牌,2024-12-12,8711
2002,中鋼,7,0,7,陽信-石牌,2024-12-12,8711
3450,聯鈞,22,15,7,陽信-石牌,2024-12-12,8711
6505,台塑化,6,0,6,陽信-石牌,2024-12-12,8711
2221,大甲,6,0,6,陽信-石牌,2024-12-12,8711
2399,映泰,20,14,6,陽信-石牌,2024-12-12,8711
6257,矽格,6,0,6,陽信-石牌,2024-12-12,8711
00918,大華優利高填息30,373,0,373,陽信-石牌,2024-12-13,8711
3481,群創,261,1,260,陽信-石牌,2024-12-13,8711
00687B,國泰20年美債,52,0,52,陽信-石牌,2024-12-13,8711
00937B,群益ESG投等債20,59,21,38,陽信-石牌,2024-12-13,8711
2363,矽統,63,25,38,陽信-石牌,2024-12-13,8711
3037,欣興,44,9,35,陽信-石牌,2024-12-13,8711
3706,神達,182,147,35,陽信-石牌,2024-12-13,8711
3013,晟銘電,30,1,29,陽信-石牌,2024-12-13,8711
5202,力新,27,2,25,陽信-石牌,2024-12-13,8711
2354,鴻準,35,11,24,陽信-石牌,2024-12-13,8711
2867,三商壽,24,0,24,陽信-石牌,2024-12-13,8711
1316,上曜,39,17,22,陽信-石牌,2024-12-13,8711
3591,艾笛森,37,15,22,陽信-石牌,2024-12-13,8711
1442,名軒,21,0,21,陽信-石牌,2024-12-13,8711
2313,華通,40,19,21,陽信-石牌,2024-12-13,8711
00650L,復華香港正2,44,24,20,陽信-石牌,2024-12-13,8711
00673R,期元大S＆P原油反1,20,0,20,陽信-石牌,2024-12-13,8711
1605,華新,20,0,20,陽信-石牌,2024-12-13,8711
2002,中鋼,20,0,20,陽信-石牌,2024-12-13,8711
3078,僑威,20,0,20,陽信-石牌,2024-12-13,8711
00713,元大台灣高息低波,19,0,19,陽信-石牌,2024-12-13,8711
2504,國產,18,0,18,陽信-石牌,2024-12-13,8711
3714,富采,17,0,17,陽信-石牌,2024-12-13,8711
4303,信立,15,0,15,陽信-石牌,2024-12-13,8711
00915,凱基優選高股息30,14,0,14,陽信-石牌,2024-12-13,8711
8111,立��,14,0,14,陽信-石牌,2024-12-13,8711
1711,永光,13,0,13,陽信-石牌,2024-12-13,8711
4991,環宇-KY,18,5,13,陽信-石牌,2024-12-13,8711
2317,鴻海,26,14,12,陽信-石牌,2024-12-13,8711
00688L,國泰20年美債正2,12,0,12,陽信-石牌,2024-12-13,8711
2515,中工,21,9,12,陽信-石牌,2024-12-13,8711
6108,競國,13,1,12,陽信-石牌,2024-12-13,8711
00773B,中信優先金融債,11,0,11,陽信-石牌,2024-12-13,8711
1598,岱宇,11,0,11,陽信-石牌,2024-12-13,8711
2426,鼎元,11,0,11,陽信-石牌,2024-12-13,8711
3047,訊舟,11,0,11,陽信-石牌,2024-12-13,8711
3707,漢磊,11,0,11,陽信-石牌,2024-12-13,8711
9105,泰金寶-DR,50,39,11,陽信-石牌,2024-12-13,8711
2330,台積電,13,2,11,陽信-石牌,2024-12-13,8711
00679B,元大美債20年,10,0,10,陽信-石牌,2024-12-13,8711
00751B,元大AAA至A公司債,10,0,10,陽信-石牌,2024-12-13,8711
2409,友達,10,0,10,陽信-石牌,2024-12-13,8711
2610,華航,10,0,10,陽信-石牌,2024-12-13,8711
3234,光環,13,3,10,陽信-石牌,2024-12-13,8711
4526,東台,10,0,10,陽信-石牌,2024-12-13,8711
6443,元晶,10,0,10,陽信-石牌,2024-12-13,8711
2101,南港,9,0,9,陽信-石牌,2024-12-13,8711
2889,國票金,10,1,9,陽信-石牌,2024-12-13,8711
3062,建漢,9,0,9,陽信-石牌,2024-12-13,8711
5880,合庫金,10,1,9,陽信-石牌,2024-12-13,8711
00937B,群益ESG投等債20,382,10,372,陽信-石牌,2024-12-16,8711
00673R,期元大S＆P原油反1,295,0,295,陽信-石牌,2024-12-16,8711
2888,新光金,300,23,277,陽信-石牌,2024-12-16,8711
00918,大華優利高填息30,244,0,244,陽信-石牌,2024-12-16,8711
1104,環泥,100,0,100,陽信-石牌,2024-12-16,8711
00931B,統一美債20年,100,0,100,陽信-石牌,2024-12-16,8711
00713,元大台灣高息低波,91,0,91,陽信-石牌,2024-12-16,8711
3019,亞光,135,57,78,陽信-石牌,2024-12-16,8711
00915,凱基優選高股息30,67,0,67,陽信-石牌,2024-12-16,8711
00919,群益台灣精選高息,59,0,59,陽信-石牌,2024-12-16,8711
00687B,國泰20年美債,57,0,57,陽信-石牌,2024-12-16,8711
3481,群創,54,8,46,陽信-石牌,2024-12-16,8711
2611,志信,30,0,30,陽信-石牌,2024-12-16,8711
4934,太極,30,0,30,陽信-石牌,2024-12-16,8711
2409,友達,25,0,25,陽信-石牌,2024-12-16,8711
1447,力鵬,23,0,23,陽信-石牌,2024-12-16,8711
2504,國產,20,0,20,陽信-石牌,2024-12-16,8711
2354,鴻準,54,37,17,陽信-石牌,2024-12-16,8711
1414,東和,17,0,17,陽信-石牌,2024-12-16,8711
0056,元大高股息,21,5,16,陽信-石牌,2024-12-16,8711
2486,一詮,16,0,16,陽信-石牌,2024-12-16,8711
2609,陽明,395,380,15,陽信-石牌,2024-12-16,8711
00751B,元大AAA至A公司債,15,0,15,陽信-石牌,2024-12-16,8711
2312,金寶,47,32,15,陽信-石牌,2024-12-16,8711
3230,錦明,16,1,15,陽信-石牌,2024-12-16,8711
2615,萬海,16,2,14,陽信-石牌,2024-12-16,8711
00688L,國泰20年美債正2,14,0,14,陽信-石牌,2024-12-16,8711
4966,譜瑞-KY,15,1,14,陽信-石牌,2024-12-16,8711
00946,群益科技高息成長,13,0,13,陽信-石牌,2024-12-16,8711
00637L,元大滬深300正2,13,0,13,陽信-石牌,2024-12-16,8711
2405,輔信,15,2,13,陽信-石牌,2024-12-16,8711
3450,聯鈞,61,48,13,陽信-石牌,2024-12-16,8711
2002,中鋼,13,0,13,陽信-石牌,2024-12-16,8711
00679B,元大美債20年,12,0,12,陽信-石牌,2024-12-16,8711
6235,華孚,13,1,12,陽信-石牌,2024-12-16,8711
2324,仁寶,13,2,11,陽信-石牌,2024-12-16,8711
00878,國泰永續高股息,15,5,10,陽信-石牌,2024-12-16,8711
2408,南亞科,10,0,10,陽信-石牌,2024-12-16,8711
2492,華新科,10,0,10,陽信-石牌,2024-12-16,8711
2538,基泰,10,0,10,陽信-石牌,2024-12-16,8711
3419,譁裕,10,0,10,陽信-石牌,2024-12-16,8711
3518,柏騰,10,0,10,陽信-石牌,2024-12-16,8711
4916,事欣科,10,0,10,陽信-石牌,2024-12-16,8711
4974,亞泰,11,1,10,陽信-石牌,2024-12-16,8711
5880,合庫金,10,0,10,陽信-石牌,2024-12-16,8711
6127,九豪,10,0,10,陽信-石牌,2024-12-16,8711
9105,泰金寶-DR,140,130,10,陽信-石牌,2024-12-16,8711
5871,中租-KY,23,14,9,陽信-石牌,2024-12-16,8711
2426,鼎元,10,1,9,陽信-石牌,2024-12-16,8711
3025,星通,10,1,9,陽信-石牌,2024-12-16,8711
00953B,群益優選非投等債,167,5,162,陽信-石牌,2024-12-17,8711
3481,群創,163,9,154,陽信-石牌,2024-12-17,8711
00687B,國泰20年美債,71,0,71,陽信-石牌,2024-12-17,8711
00918,大華優利高填息30,66,0,66,陽信-石牌,2024-12-17,8711
00948B,中信優息投資級債,58,0,58,陽信-石牌,2024-12-17,8711
00937B,群益ESG投等債20,55,0,55,陽信-石牌,2024-12-17,8711
2409,友達,55,0,55,陽信-石牌,2024-12-17,8711
00915,凱基優選高股息30,57,3,54,陽信-石牌,2024-12-17,8711
2834,臺企銀,52,0,52,陽信-石牌,2024-12-17,8711
2374,佳能,63,30,33,陽信-石牌,2024-12-17,8711
00970B,新光BBB投等債20,30,0,30,陽信-石牌,2024-12-17,8711
2408,南亞科,29,4,25,陽信-石牌,2024-12-17,8711
4562,穎漢,23,3,20,陽信-石牌,2024-12-17,8711
6134,萬旭,20,0,20,陽信-石牌,2024-12-17,8711
1598,岱宇,19,0,19,陽信-石牌,2024-12-17,8711
2886,兆豐金,22,3,19,陽信-石牌,2024-12-17,8711
00751B,元大AAA至A公司債,18,0,18,陽信-石牌,2024-12-17,8711
3706,神達,31,13,18,陽信-石牌,2024-12-17,8711
00959B,大華投等美債15Y+,17,0,17,陽信-石牌,2024-12-17,8711
0056,元大高股息,17,1,16,陽信-石牌,2024-12-17,8711
1524,耿鼎,15,0,15,陽信-石牌,2024-12-17,8711
2609,陽明,83,68,15,陽信-石牌,2024-12-17,8711
3360,尚立,15,0,15,陽信-石牌,2024-12-17,8711
4968,立積,20,5,15,陽信-石牌,2024-12-17,8711
8111,立��,37,22,15,陽信-石牌,2024-12-17,8711
00713,元大台灣高息低波,14,0,14,陽信-石牌,2024-12-17,8711
1101,台泥,14,0,14,陽信-石牌,2024-12-17,8711
00679B,元大美債20年,15,2,13,陽信-石牌,2024-12-17,8711
02001L,富邦蘋果正二N,13,0,13,陽信-石牌,2024-12-17,8711
00676R,富邦臺灣加權反1,13,0,13,陽信-石牌,2024-12-17,8711
2515,中工,13,0,13,陽信-石牌,2024-12-17,8711
2317,鴻海,30,17,13,陽信-石牌,2024-12-17,8711
00680L,元大美債20正2,12,0,12,陽信-石牌,2024-12-17,8711
2881,富邦金,12,0,12,陽信-石牌,2024-12-17,8711
4576,大銀微系統,12,0,12,陽信-石牌,2024-12-17,8711
2356,英業達,14,3,11,陽信-石牌,2024-12-17,8711
6962,ITH-KY,13,2,11,陽信-石牌,2024-12-17,8711
6274,台燿,14,3,11,陽信-石牌,2024-12-17,8711
5871,中租-KY,12,2,10,陽信-石牌,2024-12-17,8711
00931B,統一美債20年,10,0,10,陽信-石牌,2024-12-17,8711
1314,中石化,12,2,10,陽信-石牌,2024-12-17,8711
1336,台翰,10,0,10,陽信-石牌,2024-12-17,8711
2062,橋椿,21,11,10,陽信-石牌,2024-12-17,8711
3017,奇鋐,11,1,10,陽信-石牌,2024-12-17,8711
3059,華晶科,11,1,10,陽信-石牌,2024-12-17,8711
4561,健椿,10,0,10,陽信-石牌,2024-12-17,8711
4956,光鋐,12,2,10,陽信-石牌,2024-12-17,8711
5244,弘凱,10,0,10,陽信-石牌,2024-12-17,8711
6108,競國,10,0,10,陽信-石牌,2024-12-17,8711
6505,台塑化,10,0,10,陽信-石牌,2024-12-17,8711
00918,大華優利高填息30,187,0,187,陽信-石牌,2024-12-18,8711
2890,永豐金,100,0,100,陽信-石牌,2024-12-18,8711
4991,環宇-KY,83,15,68,陽信-石牌,2024-12-18,8711
00919,群益台灣精選高息,61,0,61,陽信-石牌,2024-12-18,8711
1301,台塑,62,4,58,陽信-石牌,2024-12-18,8711
2303,聯電,77,22,55,陽信-石牌,2024-12-18,8711
6770,力積電,55,5,50,陽信-石牌,2024-12-18,8711
1447,力鵬,41,0,41,陽信-石牌,2024-12-18,8711
9105,泰金寶-DR,43,5,38,陽信-石牌,2024-12-18,8711
2615,萬海,30,3,27,陽信-石牌,2024-12-18,8711
2375,凱美,25,0,25,陽信-石牌,2024-12-18,8711
2409,友達,25,0,25,陽信-石牌,2024-12-18,8711
00948B,中信優息投資級債,22,0,22,陽信-石牌,2024-12-18,8711
2359,所羅門,26,5,21,陽信-石牌,2024-12-18,8711
2312,金寶,71,51,20,陽信-石牌,2024-12-18,8711
00712,復華富時不動產,20,0,20,陽信-石牌,2024-12-18,8711
2610,華航,43,24,19,陽信-石牌,2024-12-18,8711
02001L,富邦蘋果正二N,18,0,18,陽信-石牌,2024-12-18,8711
8249,菱光,48,32,16,陽信-石牌,2024-12-18,8711
2883,凱基金,14,0,14,陽信-石牌,2024-12-18,8711
6547,高端疫苗,14,0,14,陽信-石牌,2024-12-18,8711
6962,ITH-KY,18,4,14,陽信-石牌,2024-12-18,8711
00878,國泰永續高股息,14,1,13,陽信-石牌,2024-12-18,8711
3037,欣興,14,1,13,陽信-石牌,2024-12-18,8711
3041,揚智,106,93,13,陽信-石牌,2024-12-18,8711
5871,中租-KY,15,2,13,陽信-石牌,2024-12-18,8711
00953B,群益優選非投等債,12,0,12,陽信-石牌,2024-12-18,8711
1802,台玻,11,0,11,陽信-石牌,2024-12-18,8711
3122,笙泉,11,0,11,陽信-石牌,2024-12-18,8711
00751B,元大AAA至A公司債,10,0,10,陽信-石牌,2024-12-18,8711
00720B,元大投資級公司債,10,0,10,陽信-石牌,2024-12-18,8711
00673R,期元大S＆P原油反1,10,0,10,陽信-石牌,2024-12-18,8711
1598,岱宇,10,0,10,陽信-石牌,2024-12-18,8711
1609,大亞,10,0,10,陽信-石牌,2024-12-18,8711
4306,炎洲,10,0,10,陽信-石牌,2024-12-18,8711
5880,合庫金,10,0,10,陽信-石牌,2024-12-18,8711
6257,矽格,10,0,10,陽信-石牌,2024-12-18,8711
2356,英業達,10,1,9,陽信-石牌,2024-12-18,8711
3017,奇鋐,11,2,9,陽信-石牌,2024-12-18,8711
00937B,群益ESG投等債20,9,0,9,陽信-石牌,2024-12-18,8711
2062,橋椿,12,3,9,陽信-石牌,2024-12-18,8711
2885,元大金,9,0,9,陽信-石牌,2024-12-18,8711
00687B,國泰20年美債,8,0,8,陽信-石牌,2024-12-18,8711
4442,竣邦-KY,8,0,8,陽信-石牌,2024-12-18,8711
4540,全球傳動,24,16,8,陽信-石牌,2024-12-18,8711
3665,貿聯-KY,8,1,7,陽信-石牌,2024-12-18,8711
5202,力新,7,0,7,陽信-石牌,2024-12-18,8711
8171,天宇,8,1,7,陽信-石牌,2024-12-18,8711
1314,中石化,6,0,6,陽信-石牌,2024-12-18,8711
2609,陽明,40,34,6,陽信-石牌,2024-12-18,8711
00918,大華優利高填息30,247,0,247,陽信-石牌,2024-12-19,8711
2887,台新金,140,0,140,陽信-石牌,2024-12-19,8711
2504,國產,100,0,100,陽信-石牌,2024-12-19,8711
00937B,群益ESG投等債20,90,0,90,陽信-石牌,2024-12-19,8711
00687B,國泰20年美債,67,0,67,陽信-石牌,2024-12-19,8711
2323,中環,65,0,65,陽信-石牌,2024-12-19,8711
3481,群創,78,20,58,陽信-石牌,2024-12-19,8711
00857B,永豐20年美公債,54,0,54,陽信-石牌,2024-12-19,8711
2845,遠東銀,53,0,53,陽信-石牌,2024-12-19,8711
1301,台塑,84,38,46,陽信-石牌,2024-12-19,8711
00712,復華富時不動產,41,0,41,陽信-石牌,2024-12-19,8711
2618,長榮航,46,6,40,陽信-石牌,2024-12-19,8711
00680L,元大美債20正2,39,0,39,陽信-石牌,2024-12-19,8711
00878,國泰永續高股息,35,0,35,陽信-石牌,2024-12-19,8711
00915,凱基優選高股息30,31,0,31,陽信-石牌,2024-12-19,8711
00669R,國泰美國道瓊反1,30,0,30,陽信-石牌,2024-12-19,8711
2409,友達,29,0,29,陽信-石牌,2024-12-19,8711
2609,陽明,46,17,29,陽信-石牌,2024-12-19,8711
00679B,元大美債20年,28,0,28,陽信-石牌,2024-12-19,8711
00725B,國泰投資級公司債,26,0,26,陽信-石牌,2024-12-19,8711
00933B,國泰10Y+金融債,24,0,24,陽信-石牌,2024-12-19,8711
2317,鴻海,24,3,21,陽信-石牌,2024-12-19,8711
2884,玉山金,20,0,20,陽信-石牌,2024-12-19,8711
1442,名軒,20,0,20,陽信-石牌,2024-12-19,8711
1528,恩德,20,0,20,陽信-石牌,2024-12-19,8711
00926,凱基全球菁英55,20,1,19,陽信-石牌,2024-12-19,8711
00688L,國泰20年美債正2,18,0,18,陽信-石牌,2024-12-19,8711
6209,今國光,24,6,18,陽信-石牌,2024-12-19,8711
1785,光洋科,18,3,15,陽信-石牌,2024-12-19,8711
2385,群光,15,0,15,陽信-石牌,2024-12-19,8711
2419,仲琦,15,0,15,陽信-石牌,2024-12-19,8711
4510,高鋒,17,2,15,陽信-石牌,2024-12-19,8711
6770,力積電,22,7,15,陽信-石牌,2024-12-19,8711
4977,眾達-KY,19,5,14,陽信-石牌,2024-12-19,8711
00772B,中信高評級公司債,13,0,13,陽信-石牌,2024-12-19,8711
1540,喬福,13,0,13,陽信-石牌,2024-12-19,8711
2312,金寶,29,17,12,陽信-石牌,2024-12-19,8711
2834,臺企銀,12,0,12,陽信-石牌,2024-12-19,8711
2882,國泰金,12,0,12,陽信-石牌,2024-12-19,8711
2354,鴻準,22,11,11,陽信-石牌,2024-12-19,8711
2883,凱基金,16,5,11,陽信-石牌,2024-12-19,8711
2330,台積電,12,1,11,陽信-石牌,2024-12-19,8711
00720B,元大投資級公司債,10,0,10,陽信-石牌,2024-12-19,8711
00970B,新光BBB投等債20,10,0,10,陽信-石牌,2024-12-19,8711
1447,力鵬,10,0,10,陽信-石牌,2024-12-19,8711
1474,弘裕,10,0,10,陽信-石牌,2024-12-19,8711
2497,怡利電,10,0,10,陽信-石牌,2024-12-19,8711
2812,台中銀,10,0,10,陽信-石牌,2024-12-19,8711
3260,威剛,12,2,10,陽信-石牌,2024-12-19,8711
3264,欣銓,11,1,10,陽信-石牌,2024-12-19,8711
