Ticker,Name,buy,sell,diff,Branch,Date,Branch_Code
6133,金橋,115,0,115,群益金鼎-松山,2023-01-03,9103
6150,撼訊,60,0,60,群益金鼎-松山,2023-01-03,9103
2489,瑞軒,50,1,49,群益金鼎-松山,2023-01-03,9103
3508,位速,41,0,41,群益金鼎-松山,2023-01-03,9103
1612,宏泰,32,0,32,群益金鼎-松山,2023-01-03,9103
2426,鼎元,29,0,29,群益金鼎-松山,2023-01-03,9103
3535,晶彩科,24,0,24,群益金鼎-松山,2023-01-03,9103
3122,笙泉,23,0,23,群益金鼎-松山,2023-01-03,9103
2609,陽明,172,150,22,群益金鼎-松山,2023-01-03,9103
1783,和康生,20,0,20,群益金鼎-松山,2023-01-03,9103
2007,燁興,30,10,20,群益金鼎-松山,2023-01-03,9103
2038,海光,40,20,20,群益金鼎-松山,2023-01-03,9103
2028,威致,40,20,20,群益金鼎-松山,2023-01-03,9103
00885,富邦越南,19,0,19,群益金鼎-松山,2023-01-03,9103
2498,宏達電,27,8,19,群益金鼎-松山,2023-01-03,9103
5351,鈺創,20,2,18,群益金鼎-松山,2023-01-03,9103
1513,中興電,30,13,17,群益金鼎-松山,2023-01-03,9103
4763,材料-KY,19,4,15,群益金鼎-松山,2023-01-03,9103
4927,泰鼎-KY,15,0,15,群益金鼎-松山,2023-01-03,9103
6231,系微,14,0,14,群益金鼎-松山,2023-01-03,9103
8040,九暘,14,0,14,群益金鼎-松山,2023-01-03,9103
5009,榮剛,13,0,13,群益金鼎-松山,2023-01-03,9103
6205,詮欣,12,0,12,群益金鼎-松山,2023-01-03,9103
2023,燁輝,28,17,11,群益金鼎-松山,2023-01-03,9103
1319,東陽,10,0,10,群益金鼎-松山,2023-01-03,9103
00632R,元大台灣50反1,10,0,10,群益金鼎-松山,2023-01-03,9103
3693,營邦,10,0,10,群益金鼎-松山,2023-01-03,9103
5321,美而快,10,0,10,群益金鼎-松山,2023-01-03,9103
6180,橘子,10,0,10,群益金鼎-松山,2023-01-03,9103
00878,國泰永續高股息,9,0,9,群益金鼎-松山,2023-01-03,9103
2338,光罩,10,1,9,群益金鼎-松山,2023-01-03,9103
2388,威盛,30,21,9,群益金鼎-松山,2023-01-03,9103
2915,潤泰全,9,0,9,群益金鼎-松山,2023-01-03,9103
3687,歐買尬,9,0,9,群益金鼎-松山,2023-01-03,9103
4417,金洲,9,0,9,群益金鼎-松山,2023-01-03,9103
5425,台半,9,0,9,群益金鼎-松山,2023-01-03,9103
6213,聯茂,9,0,9,群益金鼎-松山,2023-01-03,9103
1240,茂生農經,8,0,8,群益金鼎-松山,2023-01-03,9103
2108,南帝,8,0,8,群益金鼎-松山,2023-01-03,9103
8171,天宇,11,3,8,群益金鼎-松山,2023-01-03,9103
2069,運錩,7,0,7,群益金鼎-松山,2023-01-03,9103
3221,台嘉碩,7,0,7,群益金鼎-松山,2023-01-03,9103
6138,茂達,7,0,7,群益金鼎-松山,2023-01-03,9103
5490,同亨,6,0,6,群益金鼎-松山,2023-01-03,9103
6435,大中,6,0,6,群益金鼎-松山,2023-01-03,9103
8931,大汽電,6,0,6,群益金鼎-松山,2023-01-03,9103
2615,萬海,8,3,5,群益金鼎-松山,2023-01-03,9103
3037,欣興,5,0,5,群益金鼎-松山,2023-01-03,9103
5706,鳳凰,5,0,5,群益金鼎-松山,2023-01-03,9103
6643,M31,7,2,5,群益金鼎-松山,2023-01-03,9103
6133,金橋,132,0,132,群益金鼎-松山,2023-01-04,9103
6213,聯茂,51,0,51,群益金鼎-松山,2023-01-04,9103
6244,茂迪,43,3,40,群益金鼎-松山,2023-01-04,9103
6235,華孚,49,22,27,群益金鼎-松山,2023-01-04,9103
4167,松瑞藥,43,21,22,群益金鼎-松山,2023-01-04,9103
1736,喬山,20,0,20,群益金鼎-松山,2023-01-04,9103
3592,瑞鼎,22,2,20,群益金鼎-松山,2023-01-04,9103
8222,寶一,20,0,20,群益金鼎-松山,2023-01-04,9103
3704,合勤控,37,19,18,群益金鼎-松山,2023-01-04,9103
2317,鴻海,17,0,17,群益金鼎-松山,2023-01-04,9103
5706,鳳凰,14,0,14,群益金鼎-松山,2023-01-04,9103
1752,南光,32,20,12,群益金鼎-松山,2023-01-04,9103
2704,國賓,11,0,11,群益金鼎-松山,2023-01-04,9103
3037,欣興,10,0,10,群益金鼎-松山,2023-01-04,9103
00632R,元大台灣50反1,10,0,10,群益金鼎-松山,2023-01-04,9103
2368,金像電,11,2,9,群益金鼎-松山,2023-01-04,9103
3046,建��,9,0,9,群益金鼎-松山,2023-01-04,9103
8069,元太,12,3,9,群益金鼎-松山,2023-01-04,9103
2884,玉山金,8,0,8,群益金鼎-松山,2023-01-04,9103
3479,安勤,13,5,8,群益金鼎-松山,2023-01-04,9103
6220,岳豐,8,0,8,群益金鼎-松山,2023-01-04,9103
8110,華東,8,0,8,群益金鼎-松山,2023-01-04,9103
1605,華新,27,21,6,群益金鼎-松山,2023-01-04,9103
2388,威盛,11,5,6,群益金鼎-松山,2023-01-04,9103
2069,運錩,5,0,5,群益金鼎-松山,2023-01-04,9103
1762,中化生,5,0,5,群益金鼎-松山,2023-01-04,9103
00881,國泰台灣5G+,5,0,5,群益金鼎-松山,2023-01-04,9103
00772B,中信高評級公司債,5,0,5,群益金鼎-松山,2023-01-04,9103
2530,華建,5,0,5,群益金鼎-松山,2023-01-04,9103
2748,雲品,5,0,5,群益金鼎-松山,2023-01-04,9103
5009,榮剛,5,0,5,群益金鼎-松山,2023-01-04,9103
6806,森崴能源,6,1,5,群益金鼎-松山,2023-01-04,9103
9103,美德醫療-DR,5,0,5,群益金鼎-松山,2023-01-04,9103
00680L,元大美債20正2,4,0,4,群益金鼎-松山,2023-01-04,9103
2702,華園,4,0,4,群益金鼎-松山,2023-01-04,9103
2882,國泰金,4,0,4,群益金鼎-松山,2023-01-04,9103
6231,系微,4,0,4,群益金鼎-松山,2023-01-04,9103
1810,和成,3,0,3,群益金鼎-松山,2023-01-04,9103
1414,東和,3,0,3,群益金鼎-松山,2023-01-04,9103
3289,宜特,3,0,3,群益金鼎-松山,2023-01-04,9103
5876,上海商銀,3,0,3,群益金鼎-松山,2023-01-04,9103
6125,廣運,3,0,3,群益金鼎-松山,2023-01-04,9103
6517,保勝光學,3,0,3,群益金鼎-松山,2023-01-04,9103
8046,南電,5,2,3,群益金鼎-松山,2023-01-04,9103
8050,廣積,3,0,3,群益金鼎-松山,2023-01-04,9103
1417,嘉裕,9,6,3,群益金鼎-松山,2023-01-04,9103
2330,台積電,5,2,3,群益金鼎-松山,2023-01-04,9103
1514,亞力,3,1,2,群益金鼎-松山,2023-01-04,9103
00893,國泰智能電動車,2,0,2,群益金鼎-松山,2023-01-04,9103
00882,中信中國高股息,2,0,2,群益金鼎-松山,2023-01-04,9103
6133,金橋,484,383,101,群益金鼎-松山,2023-01-05,9103
00902,中信電池及儲能,100,0,100,群益金鼎-松山,2023-01-05,9103
6213,聯茂,47,1,46,群益金鼎-松山,2023-01-05,9103
00900,富邦特選高股息30,38,0,38,群益金鼎-松山,2023-01-05,9103
3704,合勤控,35,0,35,群益金鼎-松山,2023-01-05,9103
3013,晟銘電,31,0,31,群益金鼎-松山,2023-01-05,9103
5351,鈺創,31,6,25,群益金鼎-松山,2023-01-05,9103
00671R,富邦NASDAQ反1,20,0,20,群益金鼎-松山,2023-01-05,9103
5014,建錩,18,0,18,群益金鼎-松山,2023-01-05,9103
6143,振曜,21,7,14,群益金鼎-松山,2023-01-05,9103
1513,中興電,23,10,13,群益金鼎-松山,2023-01-05,9103
6443,元晶,11,0,11,群益金鼎-松山,2023-01-05,9103
1503,士電,12,2,10,群益金鼎-松山,2023-01-05,9103
00903,富邦元宇宙,10,0,10,群益金鼎-松山,2023-01-05,9103
2634,漢翔,20,10,10,群益金鼎-松山,2023-01-05,9103
3707,漢磊,12,2,10,群益金鼎-松山,2023-01-05,9103
5309,系統電,10,0,10,群益金鼎-松山,2023-01-05,9103
6118,建達,25,15,10,群益金鼎-松山,2023-01-05,9103
8390,金益鼎,10,0,10,群益金鼎-松山,2023-01-05,9103
8436,大江,11,2,9,群益金鼎-松山,2023-01-05,9103
8215,明基材,10,2,8,群益金鼎-松山,2023-01-05,9103
2368,金像電,9,2,7,群益金鼎-松山,2023-01-05,9103
1527,鑽全,6,0,6,群益金鼎-松山,2023-01-05,9103
6679,鈺太,6,0,6,群益金鼎-松山,2023-01-05,9103
00673R,期元大S＆P原油反1,5,0,5,群益金鼎-松山,2023-01-05,9103
2313,華通,6,1,5,群益金鼎-松山,2023-01-05,9103
2352,佳世達,5,0,5,群益金鼎-松山,2023-01-05,9103
4747,強生,5,0,5,群益金鼎-松山,2023-01-05,9103
5258,虹堡,10,5,5,群益金鼎-松山,2023-01-05,9103
3189,景碩,6,2,4,群益金鼎-松山,2023-01-05,9103
3661,世芯-KY,15,11,4,群益金鼎-松山,2023-01-05,9103
6643,M31,6,2,4,群益金鼎-松山,2023-01-05,9103
8069,元太,18,14,4,群益金鼎-松山,2023-01-05,9103
1409,新纖,4,0,4,群益金鼎-松山,2023-01-05,9103
1701,中化,13,10,3,群益金鼎-松山,2023-01-05,9103
1752,南光,3,0,3,群益金鼎-松山,2023-01-05,9103
3406,玉晶光,3,0,3,群益金鼎-松山,2023-01-05,9103
6239,力成,3,0,3,群益金鼎-松山,2023-01-05,9103
3035,智原,4,2,2,群益金鼎-松山,2023-01-05,9103
6472,保瑞,3,1,2,群益金鼎-松山,2023-01-05,9103
00706L,期元大S＆P日圓正2,2,0,2,群益金鼎-松山,2023-01-05,9103
00680L,元大美債20正2,2,0,2,群益金鼎-松山,2023-01-05,9103
1529,樂事綠能,4,2,2,群益金鼎-松山,2023-01-05,9103
1464,得力,2,0,2,群益金鼎-松山,2023-01-05,9103
2208,台船,2,0,2,群益金鼎-松山,2023-01-05,9103
2354,鴻準,2,0,2,群益金鼎-松山,2023-01-05,9103
2419,仲琦,6,4,2,群益金鼎-松山,2023-01-05,9103
2547,日勝生,2,0,2,群益金鼎-松山,2023-01-05,9103
3037,欣興,4,2,2,群益金鼎-松山,2023-01-05,9103
3047,訊舟,2,0,2,群益金鼎-松山,2023-01-05,9103
1584,精剛,274,0,274,群益金鼎-松山,2023-01-06,9103
6133,金橋,463,200,263,群益金鼎-松山,2023-01-06,9103
2498,宏達電,55,3,52,群益金鼎-松山,2023-01-06,9103
1519,華城,31,10,21,群益金鼎-松山,2023-01-06,9103
6180,橘子,21,1,20,群益金鼎-松山,2023-01-06,9103
4167,松瑞藥,23,4,19,群益金鼎-松山,2023-01-06,9103
00720B,元大投資級公司債,18,0,18,群益金鼎-松山,2023-01-06,9103
3141,晶宏,19,1,18,群益金鼎-松山,2023-01-06,9103
2497,怡利電,15,0,15,群益金鼎-松山,2023-01-06,9103
4114,健喬,13,1,12,群益金鼎-松山,2023-01-06,9103
1701,中化,50,39,11,群益金鼎-松山,2023-01-06,9103
2014,中鴻,10,0,10,群益金鼎-松山,2023-01-06,9103
2312,金寶,10,0,10,群益金鼎-松山,2023-01-06,9103
4763,材料-KY,20,11,9,群益金鼎-松山,2023-01-06,9103
2637,慧洋-KY,7,1,6,群益金鼎-松山,2023-01-06,9103
1810,和成,9,3,6,群益金鼎-松山,2023-01-06,9103
4968,立積,6,0,6,群益金鼎-松山,2023-01-06,9103
8044,網家,6,0,6,群益金鼎-松山,2023-01-06,9103
00673R,期元大S＆P原油反1,5,0,5,群益金鼎-松山,2023-01-06,9103
00632R,元大台灣50反1,5,0,5,群益金鼎-松山,2023-01-06,9103
2352,佳世達,5,0,5,群益金鼎-松山,2023-01-06,9103
3576,聯合再生,5,0,5,群益金鼎-松山,2023-01-06,9103
5009,榮剛,5,0,5,群益金鼎-松山,2023-01-06,9103
5706,鳳凰,5,0,5,群益金鼎-松山,2023-01-06,9103
00878,國泰永續高股息,4,0,4,群益金鼎-松山,2023-01-06,9103
3704,合勤控,4,0,4,群益金鼎-松山,2023-01-06,9103
1417,嘉裕,5,1,4,群益金鼎-松山,2023-01-06,9103
1609,大亞,4,0,4,群益金鼎-松山,2023-01-06,9103
3406,玉晶光,5,1,4,群益金鼎-松山,2023-01-06,9103
6643,M31,5,1,4,群益金鼎-松山,2023-01-06,9103
3693,營邦,3,0,3,群益金鼎-松山,2023-01-06,9103
5225,東科-KY,3,0,3,群益金鼎-松山,2023-01-06,9103
6202,盛群,3,0,3,群益金鼎-松山,2023-01-06,9103
6290,良維,3,0,3,群益金鼎-松山,2023-01-06,9103
8105,凌巨,3,0,3,群益金鼎-松山,2023-01-06,9103
2332,友訊,3,0,3,群益金鼎-松山,2023-01-06,9103
2027,大成鋼,2,0,2,群益金鼎-松山,2023-01-06,9103
00908,富邦入息REITs+,2,0,2,群益金鼎-松山,2023-01-06,9103
00900,富邦特選高股息30,2,0,2,群益金鼎-松山,2023-01-06,9103
2612,中航,2,0,2,群益金鼎-松山,2023-01-06,9103
2731,雄獅,2,0,2,群益金鼎-松山,2023-01-06,9103
3552,同致,2,0,2,群益金鼎-松山,2023-01-06,9103
5321,美而快,2,0,2,群益金鼎-松山,2023-01-06,9103
5603,陸海,2,0,2,群益金鼎-松山,2023-01-06,9103
6129,普誠,2,0,2,群益金鼎-松山,2023-01-06,9103
2882,國泰金,1,0,1,群益金鼎-松山,2023-01-06,9103
2342,茂矽,1,0,1,群益金鼎-松山,2023-01-06,9103
006208,富邦台50,1,0,1,群益金鼎-松山,2023-01-06,9103
6446,藥華藥,1,0,1,群益金鼎-松山,2023-01-06,9103
2308,台達電,1,0,1,群益金鼎-松山,2023-01-06,9103
2608,嘉里大榮,125,0,125,群益金鼎-松山,2023-01-09,9103
2497,怡利電,126,2,124,群益金鼎-松山,2023-01-09,9103
00676R,富邦臺灣加權反1,105,0,105,群益金鼎-松山,2023-01-09,9103
00902,中信電池及儲能,100,0,100,群益金鼎-松山,2023-01-09,9103
00632R,元大台灣50反1,85,0,85,群益金鼎-松山,2023-01-09,9103
5351,鈺創,38,1,37,群益金鼎-松山,2023-01-09,9103
2353,宏��,30,0,30,群益金鼎-松山,2023-01-09,9103
3454,晶睿,26,3,23,群益金鼎-松山,2023-01-09,9103
3680,家登,20,0,20,群益金鼎-松山,2023-01-09,9103
3704,合勤控,23,3,20,群益金鼎-松山,2023-01-09,9103
2308,台達電,21,2,19,群益金鼎-松山,2023-01-09,9103
3715,定穎投控,17,0,17,群益金鼎-松山,2023-01-09,9103
00715L,期街口布蘭特正2,15,0,15,群益金鼎-松山,2023-01-09,9103
8069,元太,14,0,14,群益金鼎-松山,2023-01-09,9103
2603,長榮,15,2,13,群益金鼎-松山,2023-01-09,9103
2338,光罩,12,0,12,群益金鼎-松山,2023-01-09,9103
2352,佳世達,11,0,11,群益金鼎-松山,2023-01-09,9103
6290,良維,11,0,11,群益金鼎-松山,2023-01-09,9103
00647L,元大S＆P500正2,10,0,10,群益金鼎-松山,2023-01-09,9103
00637L,元大滬深300正2,10,0,10,群益金鼎-松山,2023-01-09,9103
3481,群創,10,1,9,群益金鼎-松山,2023-01-09,9103
2498,宏達電,12,5,7,群益金鼎-松山,2023-01-09,9103
2485,兆赫,6,0,6,群益金鼎-松山,2023-01-09,9103
2547,日勝生,6,0,6,群益金鼎-松山,2023-01-09,9103
3583,辛耘,6,0,6,群益金鼎-松山,2023-01-09,9103
8071,能率網通,6,0,6,群益金鼎-松山,2023-01-09,9103
1229,聯華,5,0,5,群益金鼎-松山,2023-01-09,9103
00881,國泰台灣5G+,10,5,5,群益金鼎-松山,2023-01-09,9103
3661,世芯-KY,14,9,5,群益金鼎-松山,2023-01-09,9103
4106,雃博,5,0,5,群益金鼎-松山,2023-01-09,9103
4168,醣聯,5,0,5,群益金鼎-松山,2023-01-09,9103
4551,智伸科,5,0,5,群益金鼎-松山,2023-01-09,9103
6104,創惟,7,2,5,群益金鼎-松山,2023-01-09,9103
6124,業強,5,0,5,群益金鼎-松山,2023-01-09,9103
00679B,元大美債20年,5,1,4,群益金鼎-松山,2023-01-09,9103
1233,天仁,4,0,4,群益金鼎-松山,2023-01-09,9103
3037,欣興,26,22,4,群益金鼎-松山,2023-01-09,9103
4961,天鈺,14,10,4,群益金鼎-松山,2023-01-09,9103
6461,益得,4,0,4,群益金鼎-松山,2023-01-09,9103
8050,廣積,4,0,4,群益金鼎-松山,2023-01-09,9103
6533,晶心科,6,2,4,群益金鼎-松山,2023-01-09,9103
9945,潤泰新,5,2,3,群益金鼎-松山,2023-01-09,9103
2419,仲琦,3,0,3,群益金鼎-松山,2023-01-09,9103
1560,中砂,5,2,3,群益金鼎-松山,2023-01-09,9103
1795,美時,7,4,3,群益金鼎-松山,2023-01-09,9103
2105,正新,3,0,3,群益金鼎-松山,2023-01-09,9103
3374,精材,3,0,3,群益金鼎-松山,2023-01-09,9103
3443,創意,12,9,3,群益金鼎-松山,2023-01-09,9103
6235,華孚,11,8,3,群益金鼎-松山,2023-01-09,9103
2614,東森,3,0,3,群益金鼎-松山,2023-01-09,9103
2409,友達,100,0,100,群益金鼎-松山,2023-01-10,9103
1514,亞力,37,6,31,群益金鼎-松山,2023-01-10,9103
3163,波若威,35,10,25,群益金鼎-松山,2023-01-10,9103
1513,中興電,27,3,24,群益金鼎-松山,2023-01-10,9103
00632R,元大台灣50反1,20,0,20,群益金鼎-松山,2023-01-10,9103
2353,宏��,20,0,20,群益金鼎-松山,2023-01-10,9103
3680,家登,15,0,15,群益金鼎-松山,2023-01-10,9103
2748,雲品,11,0,11,群益金鼎-松山,2023-01-10,9103
1736,喬山,10,0,10,群益金鼎-松山,2023-01-10,9103
00670L,富邦NASDAQ正2,10,0,10,群益金鼎-松山,2023-01-10,9103
2637,慧洋-KY,13,4,9,群益金鼎-松山,2023-01-10,9103
6213,聯茂,9,0,9,群益金鼎-松山,2023-01-10,9103
3234,光環,20,14,6,群益金鼎-松山,2023-01-10,9103
8436,大江,6,0,6,群益金鼎-松山,2023-01-10,9103
2312,金寶,5,0,5,群益金鼎-松山,2023-01-10,9103
4551,智伸科,5,0,5,群益金鼎-松山,2023-01-10,9103
4743,合一,6,1,5,群益金鼎-松山,2023-01-10,9103
4747,強生,5,0,5,群益金鼎-松山,2023-01-10,9103
4931,新盛力,5,0,5,群益金鼎-松山,2023-01-10,9103
5608,四維航,5,0,5,群益金鼎-松山,2023-01-10,9103
8433,弘帆,5,0,5,群益金鼎-松山,2023-01-10,9103
1326,台化,4,0,4,群益金鼎-松山,2023-01-10,9103
2352,佳世達,4,0,4,群益金鼎-松山,2023-01-10,9103
2636,台驊控股,4,0,4,群益金鼎-松山,2023-01-10,9103
3228,金麗科,8,4,4,群益金鼎-松山,2023-01-10,9103
6282,康舒,4,0,4,群益金鼎-松山,2023-01-10,9103
6585,鼎基,4,0,4,群益金鼎-松山,2023-01-10,9103
00888,永豐台灣ESG,3,0,3,群益金鼎-松山,2023-01-10,9103
2884,玉山金,2,0,2,群益金鼎-松山,2023-01-10,9103
6446,藥華藥,2,0,2,群益金鼎-松山,2023-01-10,9103
00919,群益台灣精選高息,2,0,2,群益金鼎-松山,2023-01-10,9103
2485,兆赫,22,20,2,群益金鼎-松山,2023-01-10,9103
2883,凱基金,2,0,2,群益金鼎-松山,2023-01-10,9103
3003,健和興,2,0,2,群益金鼎-松山,2023-01-10,9103
3027,盛達,37,35,2,群益金鼎-松山,2023-01-10,9103
3189,景碩,3,1,2,群益金鼎-松山,2023-01-10,9103
3454,晶睿,17,15,2,群益金鼎-松山,2023-01-10,9103
4736,泰博,2,0,2,群益金鼎-松山,2023-01-10,9103
5225,東科-KY,2,0,2,群益金鼎-松山,2023-01-10,9103
6244,茂迪,2,0,2,群益金鼎-松山,2023-01-10,9103
6589,台康生技,2,0,2,群益金鼎-松山,2023-01-10,9103
6643,M31,5,3,2,群益金鼎-松山,2023-01-10,9103
6789,采鈺,21,19,2,群益金鼎-松山,2023-01-10,9103
8933,愛地雅,2,0,2,群益金鼎-松山,2023-01-10,9103
9962,有益,2,0,2,群益金鼎-松山,2023-01-10,9103
2002,中鋼,2,0,2,群益金鼎-松山,2023-01-10,9103
2201,裕隆,2,1,1,群益金鼎-松山,2023-01-10,9103
1760,寶齡富錦,1,0,1,群益金鼎-松山,2023-01-10,9103
00918,大華優利高填息30,1,0,1,群益金鼎-松山,2023-01-10,9103
1231,聯華食,1,0,1,群益金鼎-松山,2023-01-10,9103
00885,富邦越南,80,1,79,群益金鼎-松山,2023-01-11,9103
4979,華星光,61,1,60,群益金鼎-松山,2023-01-11,9103
3037,欣興,73,23,50,群益金鼎-松山,2023-01-11,9103
6150,撼訊,45,15,30,群益金鼎-松山,2023-01-11,9103
9945,潤泰新,30,0,30,群益金鼎-松山,2023-01-11,9103
2610,華航,25,0,25,群益金鼎-松山,2023-01-11,9103
2408,南亞科,60,40,20,群益金鼎-松山,2023-01-11,9103
3363,上詮,14,0,14,群益金鼎-松山,2023-01-11,9103
2330,台積電,13,2,11,群益金鼎-松山,2023-01-11,9103
6118,建達,10,0,10,群益金鼎-松山,2023-01-11,9103
6188,廣明,10,0,10,群益金鼎-松山,2023-01-11,9103
1605,華新,10,1,9,群益金鼎-松山,2023-01-11,9103
8996,高力,11,3,8,群益金鼎-松山,2023-01-11,9103
6533,晶心科,10,3,7,群益金鼎-松山,2023-01-11,9103
2634,漢翔,6,0,6,群益金鼎-松山,2023-01-11,9103
5309,系統電,9,3,6,群益金鼎-松山,2023-01-11,9103
6213,聯茂,5,0,5,群益金鼎-松山,2023-01-11,9103
3508,位速,5,0,5,群益金鼎-松山,2023-01-11,9103
1417,嘉裕,6,1,5,群益金鼎-松山,2023-01-11,9103
2637,慧洋-KY,6,2,4,群益金鼎-松山,2023-01-11,9103
2888,新光金,4,0,4,群益金鼎-松山,2023-01-11,9103
6585,鼎基,4,0,4,群益金鼎-松山,2023-01-11,9103
00772B,中信高評級公司債,3,0,3,群益金鼎-松山,2023-01-11,9103
2359,所羅門,5,2,3,群益金鼎-松山,2023-01-11,9103
2382,廣達,3,0,3,群益金鼎-松山,2023-01-11,9103
2412,中華電,3,0,3,群益金鼎-松山,2023-01-11,9103
2883,凱基金,3,0,3,群益金鼎-松山,2023-01-11,9103
4162,智擎,3,0,3,群益金鼎-松山,2023-01-11,9103
9962,有益,7,4,3,群益金鼎-松山,2023-01-11,9103
6235,華孚,10,7,3,群益金鼎-松山,2023-01-11,9103
1795,美時,5,3,2,群益金鼎-松山,2023-01-11,9103
1519,華城,4,2,2,群益金鼎-松山,2023-01-11,9103
00679B,元大美債20年,2,0,2,群益金鼎-松山,2023-01-11,9103
00918,大華優利高填息30,2,0,2,群益金鼎-松山,2023-01-11,9103
2206,三陽工業,2,0,2,群益金鼎-松山,2023-01-11,9103
2468,華經,2,0,2,群益金鼎-松山,2023-01-11,9103
3003,健和興,2,0,2,群益金鼎-松山,2023-01-11,9103
3004,豐達科,2,0,2,群益金鼎-松山,2023-01-11,9103
3228,金麗科,5,3,2,群益金鼎-松山,2023-01-11,9103
3374,精材,2,0,2,群益金鼎-松山,2023-01-11,9103
3454,晶睿,7,5,2,群益金鼎-松山,2023-01-11,9103
4114,健喬,2,0,2,群益金鼎-松山,2023-01-11,9103
5009,榮剛,5,3,2,群益金鼎-松山,2023-01-11,9103
6442,光聖,2,0,2,群益金鼎-松山,2023-01-11,9103
6609,瀧澤科,20,18,2,群益金鼎-松山,2023-01-11,9103
6672,騰輝電子-KY,2,0,2,群益金鼎-松山,2023-01-11,9103
8071,能率網通,2,0,2,群益金鼎-松山,2023-01-11,9103
8358,金居,2,0,2,群益金鼎-松山,2023-01-11,9103
2342,茂矽,1,0,1,群益金鼎-松山,2023-01-11,9103
1215,卜蜂,1,0,1,群益金鼎-松山,2023-01-11,9103
00893,國泰智能電動車,80,0,80,群益金鼎-松山,2023-01-12,9103
00670L,富邦NASDAQ正2,57,2,55,群益金鼎-松山,2023-01-12,9103
00715L,期街口布蘭特正2,50,1,49,群益金鼎-松山,2023-01-12,9103
00706L,期元大S＆P日圓正2,43,0,43,群益金鼎-松山,2023-01-12,9103
00637L,元大滬深300正2,30,8,22,群益金鼎-松山,2023-01-12,9103
2889,國票金,20,0,20,群益金鼎-松山,2023-01-12,9103
00728,第一金工業30,20,0,20,群益金鼎-松山,2023-01-12,9103
1304,台聚,20,0,20,群益金鼎-松山,2023-01-12,9103
2007,燁興,30,11,19,群益金鼎-松山,2023-01-12,9103
2603,長榮,15,0,15,群益金鼎-松山,2023-01-12,9103
2313,華通,14,2,12,群益金鼎-松山,2023-01-12,9103
3163,波若威,12,0,12,群益金鼎-松山,2023-01-12,9103
00881,國泰台灣5G+,10,0,10,群益金鼎-松山,2023-01-12,9103
00830,國泰費城半導體,10,0,10,群益金鼎-松山,2023-01-12,9103
1417,嘉裕,10,0,10,群益金鼎-松山,2023-01-12,9103
6143,振曜,11,5,6,群益金鼎-松山,2023-01-12,9103
8071,能率網通,6,0,6,群益金鼎-松山,2023-01-12,9103
1810,和成,7,1,6,群益金鼎-松山,2023-01-12,9103
1101,台泥,7,2,5,群益金鼎-松山,2023-01-12,9103
2069,運錩,5,0,5,群益金鼎-松山,2023-01-12,9103
2892,第一金,5,0,5,群益金鼎-松山,2023-01-12,9103
4168,醣聯,5,0,5,群益金鼎-松山,2023-01-12,9103
006208,富邦台50,4,0,4,群益金鼎-松山,2023-01-12,9103
1229,聯華,4,0,4,群益金鼎-松山,2023-01-12,9103
5443,均豪,4,0,4,群益金鼎-松山,2023-01-12,9103
6237,驊訊,4,0,4,群益金鼎-松山,2023-01-12,9103
2367,燿華,3,0,3,群益金鼎-松山,2023-01-12,9103
2883,凱基金,3,0,3,群益金鼎-松山,2023-01-12,9103
4919,新唐,3,0,3,群益金鼎-松山,2023-01-12,9103
6443,元晶,3,0,3,群益金鼎-松山,2023-01-12,9103
2636,台驊控股,2,0,2,群益金鼎-松山,2023-01-12,9103
1736,喬山,2,0,2,群益金鼎-松山,2023-01-12,9103
1464,得力,2,0,2,群益金鼎-松山,2023-01-12,9103
00648R,元大S＆P500反1,2,0,2,群益金鼎-松山,2023-01-12,9103
00631L,元大台灣50正2,2,0,2,群益金鼎-松山,2023-01-12,9103
2208,台船,2,0,2,群益金鼎-松山,2023-01-12,9103
2498,宏達電,17,15,2,群益金鼎-松山,2023-01-12,9103
2543,皇昌,2,0,2,群益金鼎-松山,2023-01-12,9103
3003,健和興,2,0,2,群益金鼎-松山,2023-01-12,9103
3687,歐買尬,2,0,2,群益金鼎-松山,2023-01-12,9103
4106,雃博,2,0,2,群益金鼎-松山,2023-01-12,9103
4167,松瑞藥,2,0,2,群益金鼎-松山,2023-01-12,9103
5351,鈺創,2,0,2,群益金鼎-松山,2023-01-12,9103
6585,鼎基,2,0,2,群益金鼎-松山,2023-01-12,9103
8261,富鼎,2,0,2,群益金鼎-松山,2023-01-12,9103
8279,生展,2,0,2,群益金鼎-松山,2023-01-12,9103
5269,祥碩,2,0,2,群益金鼎-松山,2023-01-12,9103
2332,友訊,2,0,2,群益金鼎-松山,2023-01-12,9103
2308,台達電,1,0,1,群益金鼎-松山,2023-01-12,9103
2371,大同,1,0,1,群益金鼎-松山,2023-01-12,9103
00676R,富邦臺灣加權反1,205,0,205,群益金鼎-松山,2023-01-13,9103
8050,廣積,78,3,75,群益金鼎-松山,2023-01-13,9103
00637L,元大滬深300正2,65,2,63,群益金鼎-松山,2023-01-13,9103
00706L,期元大S＆P日圓正2,57,0,57,群益金鼎-松山,2023-01-13,9103
00632R,元大台灣50反1,55,5,50,群益金鼎-松山,2023-01-13,9103
00882,中信中國高股息,30,0,30,群益金鼎-松山,2023-01-13,9103
3034,聯詠,30,0,30,群益金鼎-松山,2023-01-13,9103
5347,世界,27,0,27,群益金鼎-松山,2023-01-13,9103
2358,廷鑫,13,1,12,群益金鼎-松山,2023-01-13,9103
00903,富邦元宇宙,10,0,10,群益金鼎-松山,2023-01-13,9103
6770,力積電,11,1,10,群益金鼎-松山,2023-01-13,9103
9928,中視,10,0,10,群益金鼎-松山,2023-01-13,9103
4106,雃博,6,0,6,群益金鼎-松山,2023-01-13,9103
1909,榮成,5,0,5,群益金鼎-松山,2023-01-13,9103
2312,金寶,5,0,5,群益金鼎-松山,2023-01-13,9103
6245,立端,5,0,5,群益金鼎-松山,2023-01-13,9103
6728,上洋,5,0,5,群益金鼎-松山,2023-01-13,9103
8071,能率網通,5,0,5,群益金鼎-松山,2023-01-13,9103
9945,潤泰新,5,0,5,群益金鼎-松山,2023-01-13,9103
1417,嘉裕,5,0,5,群益金鼎-松山,2023-01-13,9103
3163,波若威,6,2,4,群益金鼎-松山,2023-01-13,9103
3665,貿聯-KY,4,0,4,群益金鼎-松山,2023-01-13,9103
5353,台林,4,0,4,群益金鼎-松山,2023-01-13,9103
1101,台泥,8,5,3,群益金鼎-松山,2023-01-13,9103
00878,國泰永續高股息,3,0,3,群益金鼎-松山,2023-01-13,9103
2367,燿華,3,0,3,群益金鼎-松山,2023-01-13,9103
2610,華航,4,1,3,群益金鼎-松山,2023-01-13,9103
2748,雲品,3,0,3,群益金鼎-松山,2023-01-13,9103
3508,位速,3,0,3,群益金鼎-松山,2023-01-13,9103
8938,明安,3,0,3,群益金鼎-松山,2023-01-13,9103
2371,大同,3,0,3,群益金鼎-松山,2023-01-13,9103
3231,緯創,2,0,2,群益金鼎-松山,2023-01-13,9103
00738U,期元大道瓊白銀,2,0,2,群益金鼎-松山,2023-01-13,9103
2419,仲琦,2,0,2,群益金鼎-松山,2023-01-13,9103
2607,榮運,2,0,2,群益金鼎-松山,2023-01-13,9103
2753,八方雲集,2,0,2,群益金鼎-松山,2023-01-13,9103
3027,盛達,8,6,2,群益金鼎-松山,2023-01-13,9103
3047,訊舟,2,0,2,群益金鼎-松山,2023-01-13,9103
3406,玉晶光,3,1,2,群益金鼎-松山,2023-01-13,9103
3443,創意,3,1,2,群益金鼎-松山,2023-01-13,9103
3520,華盈,2,0,2,群益金鼎-松山,2023-01-13,9103
4919,新唐,2,0,2,群益金鼎-松山,2023-01-13,9103
5014,建錩,2,0,2,群益金鼎-松山,2023-01-13,9103
5905,南仁湖,2,0,2,群益金鼎-松山,2023-01-13,9103
6220,岳豐,2,0,2,群益金鼎-松山,2023-01-13,9103
8261,富鼎,2,0,2,群益金鼎-松山,2023-01-13,9103
3037,欣興,54,52,2,群益金鼎-松山,2023-01-13,9103
8033,雷虎,3,1,2,群益金鼎-松山,2023-01-13,9103
8069,元太,51,50,1,群益金鼎-松山,2023-01-13,9103
1701,中化,1,0,1,群益金鼎-松山,2023-01-13,9103
4977,眾達-KY,137,0,137,群益金鼎-松山,2023-01-16,9103
6133,金橋,94,0,94,群益金鼎-松山,2023-01-16,9103
8046,南電,71,2,69,群益金鼎-松山,2023-01-16,9103
00706L,期元大S＆P日圓正2,60,0,60,群益金鼎-松山,2023-01-16,9103
2449,京元電子,60,0,60,群益金鼎-松山,2023-01-16,9103
00830,國泰費城半導體,20,0,20,群益金鼎-松山,2023-01-16,9103
2425,承啟,20,0,20,群益金鼎-松山,2023-01-16,9103
2889,國票金,20,0,20,群益金鼎-松山,2023-01-16,9103
00878,國泰永續高股息,15,0,15,群益金鼎-松山,2023-01-16,9103
1605,華新,31,20,11,群益金鼎-松山,2023-01-16,9103
00655L,國泰中國A50正2,10,0,10,群益金鼎-松山,2023-01-16,9103
3035,智原,14,4,10,群益金鼎-松山,2023-01-16,9103
6139,亞翔,10,0,10,群益金鼎-松山,2023-01-16,9103
3680,家登,6,0,6,群益金鼎-松山,2023-01-16,9103
1417,嘉裕,6,0,6,群益金鼎-松山,2023-01-16,9103
00676R,富邦臺灣加權反1,5,0,5,群益金鼎-松山,2023-01-16,9103
00673R,期元大S＆P原油反1,5,0,5,群益金鼎-松山,2023-01-16,9103
00687B,國泰20年美債,5,0,5,群益金鼎-松山,2023-01-16,9103
2303,聯電,6,1,5,群益金鼎-松山,2023-01-16,9103
6150,撼訊,15,10,5,群益金鼎-松山,2023-01-16,9103
6782,視陽,5,0,5,群益金鼎-松山,2023-01-16,9103
00885,富邦越南,4,0,4,群益金鼎-松山,2023-01-16,9103
00905,FT臺灣Smart,4,0,4,群益金鼎-松山,2023-01-16,9103
00720B,元大投資級公司債,4,0,4,群益金鼎-松山,2023-01-16,9103
3228,金麗科,7,3,4,群益金鼎-松山,2023-01-16,9103
3521,鴻翊,5,1,4,群益金鼎-松山,2023-01-16,9103
4763,材料-KY,8,4,4,群益金鼎-松山,2023-01-16,9103
6015,宏遠證,4,0,4,群益金鼎-松山,2023-01-16,9103
6609,瀧澤科,4,0,4,群益金鼎-松山,2023-01-16,9103
6770,力積電,4,0,4,群益金鼎-松山,2023-01-16,9103
6806,森崴能源,4,0,4,群益金鼎-松山,2023-01-16,9103
6859,伯特光,4,0,4,群益金鼎-松山,2023-01-16,9103
8183,精星,4,0,4,群益金鼎-松山,2023-01-16,9103
00772B,中信高評級公司債,3,0,3,群益金鼎-松山,2023-01-16,9103
2317,鴻海,3,0,3,群益金鼎-松山,2023-01-16,9103
5014,建錩,3,0,3,群益金鼎-松山,2023-01-16,9103
5603,陸海,3,0,3,群益金鼎-松山,2023-01-16,9103
6550,北極星藥業-KY,3,0,3,群益金鼎-松山,2023-01-16,9103
9945,潤泰新,4,1,3,群益金鼎-松山,2023-01-16,9103
2002,中鋼,2,0,2,群益金鼎-松山,2023-01-16,9103
2359,所羅門,2,0,2,群益金鼎-松山,2023-01-16,9103
2428,興勤,2,0,2,群益金鼎-松山,2023-01-16,9103
2444,兆勁,2,0,2,群益金鼎-松山,2023-01-16,9103
5905,南仁湖,2,0,2,群益金鼎-松山,2023-01-16,9103
6585,鼎基,2,0,2,群益金鼎-松山,2023-01-16,9103
8933,愛地雅,2,0,2,群益金鼎-松山,2023-01-16,9103
8938,明安,2,0,2,群益金鼎-松山,2023-01-16,9103
2344,華邦電,1,0,1,群益金鼎-松山,2023-01-16,9103
1529,樂事綠能,1,0,1,群益金鼎-松山,2023-01-16,9103
3704,合勤控,1,0,1,群益金鼎-松山,2023-01-16,9103
5347,世界,505,1,504,群益金鼎-松山,2023-01-17,9103
6133,金橋,211,0,211,群益金鼎-松山,2023-01-17,9103
00830,國泰費城半導體,50,0,50,群益金鼎-松山,2023-01-17,9103
00770,國泰北美科技,37,0,37,群益金鼎-松山,2023-01-17,9103
2889,國票金,30,7,23,群益金鼎-松山,2023-01-17,9103
00670L,富邦NASDAQ正2,20,0,20,群益金鼎-松山,2023-01-17,9103
2867,三商壽,20,0,20,群益金鼎-松山,2023-01-17,9103
0050,元大台灣50,20,0,20,群益金鼎-松山,2023-01-17,9103
00773B,中信優先金融債,18,0,18,群益金鼎-松山,2023-01-17,9103
2338,光罩,12,0,12,群益金鼎-松山,2023-01-17,9103
00909,國泰數位支付服務,10,0,10,群益金鼎-松山,2023-01-17,9103
00647L,元大S＆P500正2,10,0,10,群益金鼎-松山,2023-01-17,9103
00902,中信電池及儲能,10,0,10,群益金鼎-松山,2023-01-17,9103
2888,新光金,10,0,10,群益金鼎-松山,2023-01-17,9103
5014,建錩,10,0,10,群益金鼎-松山,2023-01-17,9103
6188,廣明,10,0,10,群益金鼎-松山,2023-01-17,9103
2884,玉山金,9,0,9,群益金鼎-松山,2023-01-17,9103
5263,智崴,7,1,6,群益金鼎-松山,2023-01-17,9103
6589,台康生技,6,0,6,群益金鼎-松山,2023-01-17,9103
3704,合勤控,6,1,5,群益金鼎-松山,2023-01-17,9103
6770,力積電,6,1,5,群益金鼎-松山,2023-01-17,9103
00720B,元大投資級公司債,5,0,5,群益金鼎-松山,2023-01-17,9103
00687B,國泰20年美債,5,0,5,群益金鼎-松山,2023-01-17,9103
3693,營邦,21,16,5,群益金鼎-松山,2023-01-17,9103
4961,天鈺,11,6,5,群益金鼎-松山,2023-01-17,9103
2002,中鋼,4,0,4,群益金鼎-松山,2023-01-17,9103
3189,景碩,4,0,4,群益金鼎-松山,2023-01-17,9103
1810,和成,10,6,4,群益金鼎-松山,2023-01-17,9103
2317,鴻海,4,0,4,群益金鼎-松山,2023-01-17,9103
2023,燁輝,3,0,3,群益金鼎-松山,2023-01-17,9103
2105,正新,3,0,3,群益金鼎-松山,2023-01-17,9103
2618,長榮航,3,0,3,群益金鼎-松山,2023-01-17,9103
4153,鈺緯,4,1,3,群益金鼎-松山,2023-01-17,9103
4168,醣聯,3,0,3,群益金鼎-松山,2023-01-17,9103
4743,合一,7,4,3,群益金鼎-松山,2023-01-17,9103
6118,建達,3,0,3,群益金鼎-松山,2023-01-17,9103
1514,亞力,4,2,2,群益金鼎-松山,2023-01-17,9103
00679B,元大美債20年,2,0,2,群益金鼎-松山,2023-01-17,9103
1319,東陽,12,10,2,群益金鼎-松山,2023-01-17,9103
2059,川湖,2,0,2,群益金鼎-松山,2023-01-17,9103
2323,中環,2,0,2,群益金鼎-松山,2023-01-17,9103
2637,慧洋-KY,2,0,2,群益金鼎-松山,2023-01-17,9103
2883,凱基金,2,0,2,群益金鼎-松山,2023-01-17,9103
3483,力致,2,0,2,群益金鼎-松山,2023-01-17,9103
4163,鐿鈦,2,0,2,群益金鼎-松山,2023-01-17,9103
5443,均豪,2,0,2,群益金鼎-松山,2023-01-17,9103
6215,和椿,2,0,2,群益金鼎-松山,2023-01-17,9103
6290,良維,2,0,2,群益金鼎-松山,2023-01-17,9103
9958,世紀鋼,2,0,2,群益金鼎-松山,2023-01-17,9103
0056,元大高股息,1,0,1,群益金鼎-松山,2023-01-17,9103
2409,友達,111,0,111,群益金鼎-松山,2023-01-30,9103
00676R,富邦臺灣加權反1,100,0,100,群益金鼎-松山,2023-01-30,9103
00632R,元大台灣50反1,110,40,70,群益金鼎-松山,2023-01-30,9103
6133,金橋,56,0,56,群益金鼎-松山,2023-01-30,9103
1605,華新,90,37,53,群益金鼎-松山,2023-01-30,9103
00671R,富邦NASDAQ反1,50,0,50,群益金鼎-松山,2023-01-30,9103
00706L,期元大S＆P日圓正2,42,0,42,群益金鼎-松山,2023-01-30,9103
3708,上緯投控,40,1,39,群益金鼎-松山,2023-01-30,9103
0056,元大高股息,81,45,36,群益金鼎-松山,2023-01-30,9103
4979,華星光,32,0,32,群益金鼎-松山,2023-01-30,9103
2009,第一銅,60,30,30,群益金鼎-松山,2023-01-30,9103
2482,連宇,30,0,30,群益金鼎-松山,2023-01-30,9103
6150,撼訊,45,16,29,群益金鼎-松山,2023-01-30,9103
2465,麗臺,42,20,22,群益金鼎-松山,2023-01-30,9103
3027,盛達,24,2,22,群益金鼎-松山,2023-01-30,9103
3006,晶豪科,21,0,21,群益金鼎-松山,2023-01-30,9103
3704,合勤控,35,14,21,群益金鼎-松山,2023-01-30,9103
5258,虹堡,19,0,19,群益金鼎-松山,2023-01-30,9103
6118,建達,30,11,19,群益金鼎-松山,2023-01-30,9103
2886,兆豐金,14,0,14,群益金鼎-松山,2023-01-30,9103
2884,玉山金,16,2,14,群益金鼎-松山,2023-01-30,9103
3508,位速,12,0,12,群益金鼎-松山,2023-01-30,9103
6531,愛普*,12,1,11,群益金鼎-松山,2023-01-30,9103
2338,光罩,10,0,10,群益金鼎-松山,2023-01-30,9103
2356,英業達,10,0,10,群益金鼎-松山,2023-01-30,9103
9904,寶成,9,0,9,群益金鼎-松山,2023-01-30,9103
3228,金麗科,9,2,7,群益金鼎-松山,2023-01-30,9103
4155,訊映,7,0,7,群益金鼎-松山,2023-01-30,9103
006208,富邦台50,6,0,6,群益金鼎-松山,2023-01-30,9103
2313,華通,6,0,6,群益金鼎-松山,2023-01-30,9103
2317,鴻海,6,0,6,群益金鼎-松山,2023-01-30,9103
6279,胡連,6,0,6,群益金鼎-松山,2023-01-30,9103
6741,91APP*-KY,6,0,6,群益金鼎-松山,2023-01-30,9103
2498,宏達電,5,0,5,群益金鼎-松山,2023-01-30,9103
3515,華擎,16,11,5,群益金鼎-松山,2023-01-30,9103
3693,營邦,10,5,5,群益金鼎-松山,2023-01-30,9103
1460,宏遠,4,0,4,群益金鼎-松山,2023-01-30,9103
00878,國泰永續高股息,5,1,4,群益金鼎-松山,2023-01-30,9103
00733,富邦臺灣中小,4,0,4,群益金鼎-松山,2023-01-30,9103
2352,佳世達,4,0,4,群益金鼎-松山,2023-01-30,9103
2547,日勝生,4,0,4,群益金鼎-松山,2023-01-30,9103
6188,廣明,5,1,4,群益金鼎-松山,2023-01-30,9103
8171,天宇,5,1,4,群益金鼎-松山,2023-01-30,9103
00631L,元大台灣50正2,4,0,4,群益金鼎-松山,2023-01-30,9103
2637,慧洋-KY,5,2,3,群益金鼎-松山,2023-01-30,9103
00751B,元大AAA至A公司債,3,0,3,群益金鼎-松山,2023-01-30,9103
1734,杏輝,4,1,3,群益金鼎-松山,2023-01-30,9103
2236,百達-KY,3,0,3,群益金鼎-松山,2023-01-30,9103
2636,台驊控股,3,0,3,群益金鼎-松山,2023-01-30,9103
3661,世芯-KY,17,14,3,群益金鼎-松山,2023-01-30,9103
00673R,期元大S＆P原油反1,200,0,200,群益金鼎-松山,2023-01-31,9103
2354,鴻準,150,0,150,群益金鼎-松山,2023-01-31,9103
00637L,元大滬深300正2,76,0,76,群益金鼎-松山,2023-01-31,9103
6274,台燿,53,0,53,群益金鼎-松山,2023-01-31,9103
2455,全新,61,10,51,群益金鼎-松山,2023-01-31,9103
00671R,富邦NASDAQ反1,50,0,50,群益金鼎-松山,2023-01-31,9103
5009,榮剛,50,0,50,群益金鼎-松山,2023-01-31,9103
2007,燁興,100,50,50,群益金鼎-松山,2023-01-31,9103
2449,京元電子,46,10,36,群益金鼎-松山,2023-01-31,9103
8050,廣積,35,0,35,群益金鼎-松山,2023-01-31,9103
2028,威致,64,32,32,群益金鼎-松山,2023-01-31,9103
1612,宏泰,110,80,30,群益金鼎-松山,2023-01-31,9103
1101,台泥,30,0,30,群益金鼎-松山,2023-01-31,9103
2038,海光,60,30,30,群益金鼎-松山,2023-01-31,9103
4768,晶呈科技,31,1,30,群益金鼎-松山,2023-01-31,9103
1513,中興電,40,14,26,群益金鼎-松山,2023-01-31,9103
8215,明基材,26,0,26,群益金鼎-松山,2023-01-31,9103
00905,FT臺灣Smart,23,0,23,群益金鼎-松山,2023-01-31,9103
6244,茂迪,22,0,22,群益金鼎-松山,2023-01-31,9103
2340,台亞,21,0,21,群益金鼎-松山,2023-01-31,9103
3013,晟銘電,20,0,20,群益金鼎-松山,2023-01-31,9103
2892,第一金,17,0,17,群益金鼎-松山,2023-01-31,9103
1301,台塑,15,0,15,群益金鼎-松山,2023-01-31,9103
00720B,元大投資級公司債,11,0,11,群益金鼎-松山,2023-01-31,9103
00665L,富邦�琤肭磪囓�2,10,0,10,群益金鼎-松山,2023-01-31,9103
1321,大洋,10,0,10,群益金鼎-松山,2023-01-31,9103
8105,凌巨,10,0,10,群益金鼎-松山,2023-01-31,9103
4128,中天,10,1,9,群益金鼎-松山,2023-01-31,9103
2380,虹光,8,0,8,群益金鼎-松山,2023-01-31,9103
5871,中租-KY,8,0,8,群益金鼎-松山,2023-01-31,9103
8996,高力,21,13,8,群益金鼎-松山,2023-01-31,9103
00751B,元大AAA至A公司債,7,0,7,群益金鼎-松山,2023-01-31,9103
3041,揚智,7,0,7,群益金鼎-松山,2023-01-31,9103
3217,優群,7,0,7,群益金鼎-松山,2023-01-31,9103
8069,元太,7,0,7,群益金鼎-松山,2023-01-31,9103
00878,國泰永續高股息,7,0,7,群益金鼎-松山,2023-01-31,9103
2356,英業達,6,0,6,群益金鼎-松山,2023-01-31,9103
5014,建錩,6,0,6,群益金鼎-松山,2023-01-31,9103
5258,虹堡,22,16,6,群益金鼎-松山,2023-01-31,9103
5263,智崴,6,0,6,群益金鼎-松山,2023-01-31,9103
5905,南仁湖,6,0,6,群益金鼎-松山,2023-01-31,9103
6741,91APP*-KY,6,0,6,群益金鼎-松山,2023-01-31,9103
3693,營邦,5,0,5,群益金鼎-松山,2023-01-31,9103
4168,醣聯,5,0,5,群益金鼎-松山,2023-01-31,9103
5269,祥碩,6,1,5,群益金鼎-松山,2023-01-31,9103
1477,聚陽,5,1,4,群益金鼎-松山,2023-01-31,9103
0056,元大高股息,5,1,4,群益金鼎-松山,2023-01-31,9103
2313,華通,5,1,4,群益金鼎-松山,2023-01-31,9103
2349,錸德,4,0,4,群益金鼎-松山,2023-01-31,9103
3665,貿聯-KY,4,0,4,群益金鼎-松山,2023-01-31,9103
5328,華容,116,0,116,群益金鼎-松山,2023-02-01,9103
3704,合勤控,105,13,92,群益金鼎-松山,2023-02-01,9103
2444,兆勁,60,1,59,群益金鼎-松山,2023-02-01,9103
6213,聯茂,59,0,59,群益金鼎-松山,2023-02-01,9103
00671R,富邦NASDAQ反1,50,0,50,群益金鼎-松山,2023-02-01,9103
2014,中鴻,51,1,50,群益金鼎-松山,2023-02-01,9103
6282,康舒,41,2,39,群益金鼎-松山,2023-02-01,9103
5009,榮剛,39,2,37,群益金鼎-松山,2023-02-01,9103
6274,台燿,69,35,34,群益金鼎-松山,2023-02-01,9103
2834,臺企銀,30,0,30,群益金鼎-松山,2023-02-01,9103
4153,鈺緯,28,0,28,群益金鼎-松山,2023-02-01,9103
5258,虹堡,31,3,28,群益金鼎-松山,2023-02-01,9103
8440,綠電,28,0,28,群益金鼎-松山,2023-02-01,9103
6235,華孚,28,3,25,群益金鼎-松山,2023-02-01,9103
2884,玉山金,23,0,23,群益金鼎-松山,2023-02-01,9103
00720B,元大投資級公司債,22,0,22,群益金鼎-松山,2023-02-01,9103
3035,智原,28,7,21,群益金鼎-松山,2023-02-01,9103
00632R,元大台灣50反1,20,0,20,群益金鼎-松山,2023-02-01,9103
2634,漢翔,20,0,20,群益金鼎-松山,2023-02-01,9103
8121,越峰,20,1,19,群益金鼎-松山,2023-02-01,9103
3046,建��,18,0,18,群益金鼎-松山,2023-02-01,9103
2312,金寶,15,0,15,群益金鼎-松山,2023-02-01,9103
3141,晶宏,19,4,15,群益金鼎-松山,2023-02-01,9103
2201,裕隆,17,3,14,群益金鼎-松山,2023-02-01,9103
2375,凱美,17,4,13,群益金鼎-松山,2023-02-01,9103
2465,麗臺,18,6,12,群益金鼎-松山,2023-02-01,9103
3498,陽程,12,0,12,群益金鼎-松山,2023-02-01,9103
00902,中信電池及儲能,10,0,10,群益金鼎-松山,2023-02-01,9103
3090,日電貿,10,0,10,群益金鼎-松山,2023-02-01,9103
3454,晶睿,32,22,10,群益金鼎-松山,2023-02-01,9103
3479,安勤,10,0,10,群益金鼎-松山,2023-02-01,9103
4116,明基醫,10,0,10,群益金鼎-松山,2023-02-01,9103
5603,陸海,10,0,10,群益金鼎-松山,2023-02-01,9103
8261,富鼎,10,0,10,群益金鼎-松山,2023-02-01,9103
2609,陽明,14,5,9,群益金鼎-松山,2023-02-01,9103
3624,光頡,10,1,9,群益金鼎-松山,2023-02-01,9103
3684,榮昌,9,0,9,群益金鼎-松山,2023-02-01,9103
8996,高力,11,2,9,群益金鼎-松山,2023-02-01,9103
2906,高林,8,0,8,群益金鼎-松山,2023-02-01,9103
8433,弘帆,8,0,8,群益金鼎-松山,2023-02-01,9103
1524,耿鼎,6,0,6,群益金鼎-松山,2023-02-01,9103
4167,松瑞藥,6,0,6,群益金鼎-松山,2023-02-01,9103
5388,中磊,6,0,6,群益金鼎-松山,2023-02-01,9103
6187,萬潤,6,0,6,群益金鼎-松山,2023-02-01,9103
6741,91APP*-KY,6,0,6,群益金鼎-松山,2023-02-01,9103
2618,長榮航,10,5,5,群益金鼎-松山,2023-02-01,9103
1312,國喬,5,0,5,群益金鼎-松山,2023-02-01,9103
00676R,富邦臺灣加權反1,5,0,5,群益金鼎-松山,2023-02-01,9103
2882,國泰金,5,0,5,群益金鼎-松山,2023-02-01,9103
2883,凱基金,5,0,5,群益金鼎-松山,2023-02-01,9103
8215,明基材,602,369,233,群益金鼎-松山,2023-02-02,9103
00632R,元大台灣50反1,191,0,191,群益金鼎-松山,2023-02-02,9103
6274,台燿,125,0,125,群益金鼎-松山,2023-02-02,9103
3481,群創,101,1,100,群益金鼎-松山,2023-02-02,9103
00671R,富邦NASDAQ反1,50,0,50,群益金鼎-松山,2023-02-02,9103
2425,承啟,40,0,40,群益金鼎-松山,2023-02-02,9103
2329,華泰,37,0,37,群益金鼎-松山,2023-02-02,9103
00882,中信中國高股息,30,0,30,群益金鼎-松山,2023-02-02,9103
2436,偉詮電,30,0,30,群益金鼎-松山,2023-02-02,9103
1524,耿鼎,31,2,29,群益金鼎-松山,2023-02-02,9103
1605,華新,26,3,23,群益金鼎-松山,2023-02-02,9103
2497,怡利電,26,3,23,群益金鼎-松山,2023-02-02,9103
4979,華星光,36,13,23,群益金鼎-松山,2023-02-02,9103
3540,曜越,27,5,22,群益金鼎-松山,2023-02-02,9103
2009,第一銅,21,0,21,群益金鼎-松山,2023-02-02,9103
5203,訊連,18,0,18,群益金鼎-松山,2023-02-02,9103
2388,威盛,20,4,16,群益金鼎-松山,2023-02-02,9103
5351,鈺創,35,20,15,群益金鼎-松山,2023-02-02,9103
00878,國泰永續高股息,13,0,13,群益金鼎-松山,2023-02-02,9103
4968,立積,15,2,13,群益金鼎-松山,2023-02-02,9103
5371,中光電,13,0,13,群益金鼎-松山,2023-02-02,9103
2023,燁輝,12,0,12,群益金鼎-松山,2023-02-02,9103
1514,亞力,13,3,10,群益金鼎-松山,2023-02-02,9103
00903,富邦元宇宙,10,0,10,群益金鼎-松山,2023-02-02,9103
6133,金橋,10,0,10,群益金鼎-松山,2023-02-02,9103
6150,撼訊,14,4,10,群益金鼎-松山,2023-02-02,9103
8033,雷虎,11,1,10,群益金鼎-松山,2023-02-02,9103
2337,旺宏,11,2,9,群益金鼎-松山,2023-02-02,9103
4919,新唐,50,41,9,群益金鼎-松山,2023-02-02,9103
6770,力積電,12,4,8,群益金鼎-松山,2023-02-02,9103
2884,玉山金,7,0,7,群益金鼎-松山,2023-02-02,9103
2392,正崴,7,0,7,群益金鼎-松山,2023-02-02,9103
2014,中鴻,12,6,6,群益金鼎-松山,2023-02-02,9103
3205,佰研,6,0,6,群益金鼎-松山,2023-02-02,9103
3317,尼克森,10,4,6,群益金鼎-松山,2023-02-02,9103
4931,新盛力,6,0,6,群益金鼎-松山,2023-02-02,9103
8916,光隆,6,0,6,群益金鼎-松山,2023-02-02,9103
00687B,國泰20年美債,5,0,5,群益金鼎-松山,2023-02-02,9103
2379,瑞昱,6,1,5,群益金鼎-松山,2023-02-02,9103
2745,五福,5,0,5,群益金鼎-松山,2023-02-02,9103
2883,凱基金,5,0,5,群益金鼎-松山,2023-02-02,9103
3059,華晶科,5,0,5,群益金鼎-松山,2023-02-02,9103
4763,材料-KY,5,0,5,群益金鼎-松山,2023-02-02,9103
4906,正文,5,0,5,群益金鼎-松山,2023-02-02,9103
5434,崇越,5,0,5,群益金鼎-松山,2023-02-02,9103
8050,廣積,5,0,5,群益金鼎-松山,2023-02-02,9103
3141,晶宏,17,12,5,群益金鼎-松山,2023-02-02,9103
3037,欣興,10,5,5,群益金鼎-松山,2023-02-02,9103
00885,富邦越南,14,10,4,群益金鼎-松山,2023-02-02,9103
1417,嘉裕,5,1,4,群益金鼎-松山,2023-02-02,9103
00632R,元大台灣50反1,200,0,200,群益金鼎-松山,2023-02-03,9103
00674R,期元大S＆P黃金反1,100,0,100,群益金鼎-松山,2023-02-03,9103
00664R,國泰臺灣加權反1,100,0,100,群益金鼎-松山,2023-02-03,9103
2409,友達,200,100,100,群益金鼎-松山,2023-02-03,9103
00637L,元大滬深300正2,73,10,63,群益金鼎-松山,2023-02-03,9103
00671R,富邦NASDAQ反1,54,0,54,群益金鼎-松山,2023-02-03,9103
8084,巨虹,51,0,51,群益金鼎-松山,2023-02-03,9103
1605,華新,77,30,47,群益金鼎-松山,2023-02-03,9103
00878,國泰永續高股息,41,0,41,群益金鼎-松山,2023-02-03,9103
6274,台燿,39,0,39,群益金鼎-松山,2023-02-03,9103
00665L,富邦�琤肭磪囓�2,33,0,33,群益金鼎-松山,2023-02-03,9103
2485,兆赫,40,8,32,群益金鼎-松山,2023-02-03,9103
00882,中信中國高股息,22,0,22,群益金鼎-松山,2023-02-03,9103
8227,巨有科技,22,1,21,群益金鼎-松山,2023-02-03,9103
00830,國泰費城半導體,20,0,20,群益金鼎-松山,2023-02-03,9103
00919,群益台灣精選高息,20,0,20,群益金鼎-松山,2023-02-03,9103
8046,南電,20,0,20,群益金鼎-松山,2023-02-03,9103
9938,百和,20,0,20,群益金鼎-松山,2023-02-03,9103
00885,富邦越南,17,0,17,群益金鼎-松山,2023-02-03,9103
2609,陽明,22,5,17,群益金鼎-松山,2023-02-03,9103
3508,位速,17,0,17,群益金鼎-松山,2023-02-03,9103
0061,元大寶滬深,16,0,16,群益金鼎-松山,2023-02-03,9103
4931,新盛力,15,1,14,群益金鼎-松山,2023-02-03,9103
6104,創惟,36,23,13,群益金鼎-松山,2023-02-03,9103
6643,M31,15,2,13,群益金鼎-松山,2023-02-03,9103
8033,雷虎,13,0,13,群益金鼎-松山,2023-02-03,9103
0056,元大高股息,13,1,12,群益金鼎-松山,2023-02-03,9103
4915,致伸,24,12,12,群益金鼎-松山,2023-02-03,9103
6118,建達,49,37,12,群益金鼎-松山,2023-02-03,9103
2368,金像電,13,2,11,群益金鼎-松山,2023-02-03,9103
4168,醣聯,10,0,10,群益金鼎-松山,2023-02-03,9103
3708,上緯投控,10,0,10,群益金鼎-松山,2023-02-03,9103
00918,大華優利高填息30,10,0,10,群益金鼎-松山,2023-02-03,9103
00679B,元大美債20年,11,1,10,群益金鼎-松山,2023-02-03,9103
00670L,富邦NASDAQ正2,10,0,10,群益金鼎-松山,2023-02-03,9103
1701,中化,10,0,10,群益金鼎-松山,2023-02-03,9103
2388,威盛,63,53,10,群益金鼎-松山,2023-02-03,9103
3041,揚智,10,0,10,群益金鼎-松山,2023-02-03,9103
00633L,富邦上証正2,9,0,9,群益金鼎-松山,2023-02-03,9103
1608,華榮,10,1,9,群益金鼎-松山,2023-02-03,9103
6282,康舒,16,7,9,群益金鼎-松山,2023-02-03,9103
006206,元大上證50,8,0,8,群益金鼎-松山,2023-02-03,9103
2317,鴻海,8,0,8,群益金鼎-松山,2023-02-03,9103
6245,立端,17,9,8,群益金鼎-松山,2023-02-03,9103
6741,91APP*-KY,8,0,8,群益金鼎-松山,2023-02-03,9103
1712,興農,6,0,6,群益金鼎-松山,2023-02-03,9103
3515,華擎,10,4,6,群益金鼎-松山,2023-02-03,9103
6770,力積電,6,0,6,群益金鼎-松山,2023-02-03,9103
1326,台化,5,0,5,群益金鼎-松山,2023-02-03,9103
1762,中化生,5,0,5,群益金鼎-松山,2023-02-03,9103
00706L,期元大S＆P日圓正2,30,0,30,群益金鼎-松山,2023-02-06,9103
2436,偉詮電,28,0,28,群益金鼎-松山,2023-02-06,9103
1752,南光,36,10,26,群益金鼎-松山,2023-02-06,9103
00885,富邦越南,26,0,26,群益金鼎-松山,2023-02-06,9103
00878,國泰永續高股息,24,0,24,群益金鼎-松山,2023-02-06,9103
3021,鴻名,20,0,20,群益金鼎-松山,2023-02-06,9103
4979,華星光,20,0,20,群益金鼎-松山,2023-02-06,9103
6213,聯茂,20,0,20,群益金鼎-松山,2023-02-06,9103
3207,耀勝,19,1,18,群益金鼎-松山,2023-02-06,9103
6279,胡連,16,2,14,群益金鼎-松山,2023-02-06,9103
6282,康舒,16,3,13,群益金鼎-松山,2023-02-06,9103
6603,富強鑫,14,1,13,群益金鼎-松山,2023-02-06,9103
3037,欣興,19,7,12,群益金鼎-松山,2023-02-06,9103
1785,光洋科,11,0,11,群益金鼎-松山,2023-02-06,9103
6770,力積電,21,10,11,群益金鼎-松山,2023-02-06,9103
2340,台亞,10,0,10,群益金鼎-松山,2023-02-06,9103
00919,群益台灣精選高息,10,0,10,群益金鼎-松山,2023-02-06,9103
00680L,元大美債20正2,10,0,10,群益金鼎-松山,2023-02-06,9103
2301,光寶科,10,0,10,群益金鼎-松山,2023-02-06,9103
8069,元太,63,53,10,群益金鼎-松山,2023-02-06,9103
0061,元大寶滬深,9,0,9,群益金鼎-松山,2023-02-06,9103
2105,正新,9,0,9,群益金鼎-松山,2023-02-06,9103
2344,華邦電,9,0,9,群益金鼎-松山,2023-02-06,9103
6118,建達,22,13,9,群益金鼎-松山,2023-02-06,9103
006206,元大上證50,7,0,7,群益金鼎-松山,2023-02-06,9103
6470,宇智,7,0,7,群益金鼎-松山,2023-02-06,9103
2303,聯電,7,0,7,群益金鼎-松山,2023-02-06,9103
00633L,富邦上証正2,6,0,6,群益金鼎-松山,2023-02-06,9103
2014,中鴻,6,0,6,群益金鼎-松山,2023-02-06,9103
2454,聯發科,6,0,6,群益金鼎-松山,2023-02-06,9103
1762,中化生,5,0,5,群益金鼎-松山,2023-02-06,9103
3189,景碩,6,1,5,群益金鼎-松山,2023-02-06,9103
3289,宜特,7,2,5,群益金鼎-松山,2023-02-06,9103
6546,正基,5,0,5,群益金鼎-松山,2023-02-06,9103
2882,國泰金,5,0,5,群益金鼎-松山,2023-02-06,9103
3228,金麗科,4,0,4,群益金鼎-松山,2023-02-06,9103
5353,台林,4,0,4,群益金鼎-松山,2023-02-06,9103
3362,先進光,13,9,4,群益金鼎-松山,2023-02-06,9103
3596,智易,4,0,4,群益金鼎-松山,2023-02-06,9103
1707,葡萄王,3,0,3,群益金鼎-松山,2023-02-06,9103
1605,華新,30,27,3,群益金鼎-松山,2023-02-06,9103
1810,和成,3,0,3,群益金鼎-松山,2023-02-06,9103
2615,萬海,3,0,3,群益金鼎-松山,2023-02-06,9103
2636,台驊控股,3,0,3,群益金鼎-松山,2023-02-06,9103
3264,欣銓,3,0,3,群益金鼎-松山,2023-02-06,9103
3665,貿聯-KY,3,0,3,群益金鼎-松山,2023-02-06,9103
5203,訊連,3,0,3,群益金鼎-松山,2023-02-06,9103
5443,均豪,3,0,3,群益金鼎-松山,2023-02-06,9103
6244,茂迪,3,0,3,群益金鼎-松山,2023-02-06,9103
6782,視陽,3,0,3,群益金鼎-松山,2023-02-06,9103
8215,明基材,220,8,212,群益金鼎-松山,2023-02-07,9103
00669R,國泰美國道瓊反1,100,0,100,群益金鼎-松山,2023-02-07,9103
6547,高端疫苗,90,0,90,群益金鼎-松山,2023-02-07,9103
3162,精確,58,1,57,群益金鼎-松山,2023-02-07,9103
8084,巨虹,56,0,56,群益金鼎-松山,2023-02-07,9103
1701,中化,48,0,48,群益金鼎-松山,2023-02-07,9103
6443,元晶,32,0,32,群益金鼎-松山,2023-02-07,9103
6282,康舒,39,10,29,群益金鼎-松山,2023-02-07,9103
9928,中視,28,4,24,群益金鼎-松山,2023-02-07,9103
00680L,元大美債20正2,20,0,20,群益金鼎-松山,2023-02-07,9103
3454,晶睿,20,0,20,群益金鼎-松山,2023-02-07,9103
1301,台塑,20,1,19,群益金鼎-松山,2023-02-07,9103
2436,偉詮電,19,0,19,群益金鼎-松山,2023-02-07,9103
4763,材料-KY,23,7,16,群益金鼎-松山,2023-02-07,9103
6205,詮欣,20,5,15,群益金鼎-松山,2023-02-07,9103
6589,台康生技,15,1,14,群益金鼎-松山,2023-02-07,9103
2467,志聖,14,0,14,群益金鼎-松山,2023-02-07,9103
2201,裕隆,16,3,13,群益金鼎-松山,2023-02-07,9103
2609,陽明,12,0,12,群益金鼎-松山,2023-02-07,9103
00720B,元大投資級公司債,12,0,12,群益金鼎-松山,2023-02-07,9103
00773B,中信優先金融債,12,0,12,群益金鼎-松山,2023-02-07,9103
2465,麗臺,12,0,12,群益金鼎-松山,2023-02-07,9103
5309,系統電,12,0,12,群益金鼎-松山,2023-02-07,9103
00878,國泰永續高股息,12,1,11,群益金鼎-松山,2023-02-07,9103
2344,華邦電,11,0,11,群益金鼎-松山,2023-02-07,9103
4739,康普,11,0,11,群益金鼎-松山,2023-02-07,9103
3558,神準,10,0,10,群益金鼎-松山,2023-02-07,9103
6118,建達,10,0,10,群益金鼎-松山,2023-02-07,9103
6770,力積電,10,0,10,群益金鼎-松山,2023-02-07,9103
2105,正新,9,0,9,群益金鼎-松山,2023-02-07,9103
2454,聯發科,8,0,8,群益金鼎-松山,2023-02-07,9103
8105,凌巨,16,8,8,群益金鼎-松山,2023-02-07,9103
2380,虹光,7,0,7,群益金鼎-松山,2023-02-07,9103
3362,先進光,12,5,7,群益金鼎-松山,2023-02-07,9103
8433,弘帆,7,0,7,群益金鼎-松山,2023-02-07,9103
1795,美時,16,10,6,群益金鼎-松山,2023-02-07,9103
00772B,中信高評級公司債,5,0,5,群益金鼎-松山,2023-02-07,9103
2610,華航,10,5,5,群益金鼎-松山,2023-02-07,9103
3163,波若威,5,0,5,群益金鼎-松山,2023-02-07,9103
3576,聯合再生,5,0,5,群益金鼎-松山,2023-02-07,9103
3693,營邦,5,0,5,群益金鼎-松山,2023-02-07,9103
6150,撼訊,5,0,5,群益金鼎-松山,2023-02-07,9103
6202,盛群,5,0,5,群益金鼎-松山,2023-02-07,9103
2882,國泰金,5,0,5,群益金鼎-松山,2023-02-07,9103
00712,復華富時不動產,4,0,4,群益金鼎-松山,2023-02-07,9103
2498,宏達電,6,2,4,群益金鼎-松山,2023-02-07,9103
2889,國票金,4,0,4,群益金鼎-松山,2023-02-07,9103
2892,第一金,4,0,4,群益金鼎-松山,2023-02-07,9103
3587,閎康,4,0,4,群益金鼎-松山,2023-02-07,9103
6237,驊訊,4,0,4,群益金鼎-松山,2023-02-07,9103
00632R,元大台灣50反1,121,0,121,群益金鼎-松山,2023-02-08,9103
3362,先進光,75,8,67,群益金鼎-松山,2023-02-08,9103
00671R,富邦NASDAQ反1,50,0,50,群益金鼎-松山,2023-02-08,9103
3624,光頡,50,0,50,群益金鼎-松山,2023-02-08,9103
2401,凌陽,42,3,39,群益金鼎-松山,2023-02-08,9103
5351,鈺創,37,6,31,群益金鼎-松山,2023-02-08,9103
00830,國泰費城半導體,30,0,30,群益金鼎-松山,2023-02-08,9103
2376,技嘉,32,2,30,群益金鼎-松山,2023-02-08,9103
2498,宏達電,30,0,30,群益金鼎-松山,2023-02-08,9103
3596,智易,30,0,30,群益金鼎-松山,2023-02-08,9103
8155,博智,30,0,30,群益金鼎-松山,2023-02-08,9103
2034,允強,26,1,25,群益金鼎-松山,2023-02-08,9103
5425,台半,25,2,23,群益金鼎-松山,2023-02-08,9103
00773B,中信優先金融債,20,0,20,群益金鼎-松山,2023-02-08,9103
00670L,富邦NASDAQ正2,20,0,20,群益金鼎-松山,2023-02-08,9103
6712,長聖,20,0,20,群益金鼎-松山,2023-02-08,9103
2748,雲品,19,0,19,群益金鼎-松山,2023-02-08,9103
6789,采鈺,22,3,19,群益金鼎-松山,2023-02-08,9103
2425,承啟,19,1,18,群益金鼎-松山,2023-02-08,9103
6213,聯茂,16,0,16,群益金鼎-松山,2023-02-08,9103
6150,撼訊,22,7,15,群益金鼎-松山,2023-02-08,9103
4979,華星光,23,9,14,群益金鼎-松山,2023-02-08,9103
2405,輔信,13,0,13,群益金鼎-松山,2023-02-08,9103
1303,南亞,10,0,10,群益金鼎-松山,2023-02-08,9103
1101,台泥,10,0,10,群益金鼎-松山,2023-02-08,9103
00893,國泰智能電動車,10,0,10,群益金鼎-松山,2023-02-08,9103
00680L,元大美債20正2,10,0,10,群益金鼎-松山,2023-02-08,9103
2882,國泰金,10,0,10,群益金鼎-松山,2023-02-08,9103
00679B,元大美債20年,8,0,8,群益金鼎-松山,2023-02-08,9103
2337,旺宏,7,0,7,群益金鼎-松山,2023-02-08,9103
8271,宇瞻,7,0,7,群益金鼎-松山,2023-02-08,9103
2603,長榮,6,0,6,群益金鼎-松山,2023-02-08,9103
3231,緯創,11,5,6,群益金鼎-松山,2023-02-08,9103
00665L,富邦�琤肭磪囓�2,5,0,5,群益金鼎-松山,2023-02-08,9103
00878,國泰永續高股息,5,0,5,群益金鼎-松山,2023-02-08,9103
00683L,期元大美元指正2,5,0,5,群益金鼎-松山,2023-02-08,9103
1524,耿鼎,5,0,5,群益金鼎-松山,2023-02-08,9103
2363,矽統,5,0,5,群益金鼎-松山,2023-02-08,9103
2883,凱基金,5,0,5,群益金鼎-松山,2023-02-08,9103
3444,利機,5,0,5,群益金鼎-松山,2023-02-08,9103
3450,聯鈞,5,0,5,群益金鼎-松山,2023-02-08,9103
4919,新唐,5,0,5,群益金鼎-松山,2023-02-08,9103
5309,系統電,7,2,5,群益金鼎-松山,2023-02-08,9103
5706,鳳凰,5,0,5,群益金鼎-松山,2023-02-08,9103
3093,港建*,4,0,4,群益金鼎-松山,2023-02-08,9103
5263,智崴,4,0,4,群益金鼎-松山,2023-02-08,9103
5388,中磊,4,0,4,群益金鼎-松山,2023-02-08,9103
8171,天宇,4,0,4,群益金鼎-松山,2023-02-08,9103
3661,世芯-KY,7,3,4,群益金鼎-松山,2023-02-08,9103
6643,M31,3,0,3,群益金鼎-松山,2023-02-08,9103
2344,華邦電,305,2,303,群益金鼎-松山,2023-02-09,9103
00632R,元大台灣50反1,185,0,185,群益金鼎-松山,2023-02-09,9103
6133,金橋,101,0,101,群益金鼎-松山,2023-02-09,9103
2409,友達,100,0,100,群益金鼎-松山,2023-02-09,9103
6213,聯茂,83,0,83,群益金鼎-松山,2023-02-09,9103
8255,朋程,52,1,51,群益金鼎-松山,2023-02-09,9103
5475,德宏,50,0,50,群益金鼎-松山,2023-02-09,9103
3479,安勤,42,0,42,群益金鼎-松山,2023-02-09,9103
2359,所羅門,26,1,25,群益金鼎-松山,2023-02-09,9103
2401,凌陽,26,3,23,群益金鼎-松山,2023-02-09,9103
2376,技嘉,20,0,20,群益金鼎-松山,2023-02-09,9103
2748,雲品,19,0,19,群益金鼎-松山,2023-02-09,9103
6235,華孚,68,51,17,群益金鼎-松山,2023-02-09,9103
00673R,期元大S＆P原油反1,15,0,15,群益金鼎-松山,2023-02-09,9103
00878,國泰永續高股息,13,0,13,群益金鼎-松山,2023-02-09,9103
2328,廣宇,10,0,10,群益金鼎-松山,2023-02-09,9103
00679B,元大美債20年,10,0,10,群益金鼎-松山,2023-02-09,9103
2704,國賓,10,0,10,群益金鼎-松山,2023-02-09,9103
2882,國泰金,10,0,10,群益金鼎-松山,2023-02-09,9103
3705,永信,10,0,10,群益金鼎-松山,2023-02-09,9103
4736,泰博,10,0,10,群益金鼎-松山,2023-02-09,9103
6712,長聖,10,0,10,群益金鼎-松山,2023-02-09,9103
3711,日月光投控,10,0,10,群益金鼎-松山,2023-02-09,9103
8289,泰藝,10,1,9,群益金鼎-松山,2023-02-09,9103
3704,合勤控,10,2,8,群益金鼎-松山,2023-02-09,9103
8996,高力,10,2,8,群益金鼎-松山,2023-02-09,9103
1409,新纖,28,20,8,群益金鼎-松山,2023-02-09,9103
2436,偉詮電,8,0,8,群益金鼎-松山,2023-02-09,9103
6589,台康生技,18,10,8,群益金鼎-松山,2023-02-09,9103
6770,力積電,8,0,8,群益金鼎-松山,2023-02-09,9103
3508,位速,7,0,7,群益金鼎-松山,2023-02-09,9103
1760,寶齡富錦,6,0,6,群益金鼎-松山,2023-02-09,9103
3006,晶豪科,6,0,6,群益金鼎-松山,2023-02-09,9103
5263,智崴,6,0,6,群益金鼎-松山,2023-02-09,9103
6515,穎崴,9,3,6,群益金鼎-松山,2023-02-09,9103
2201,裕隆,7,2,5,群益金鼎-松山,2023-02-09,9103
00680L,元大美債20正2,5,0,5,群益金鼎-松山,2023-02-09,9103
2615,萬海,5,0,5,群益金鼎-松山,2023-02-09,9103
3707,漢磊,5,0,5,群益金鼎-松山,2023-02-09,9103
4747,強生,15,10,5,群益金鼎-松山,2023-02-09,9103
5388,中磊,4,0,4,群益金鼎-松山,2023-02-09,9103
6196,帆宣,4,0,4,群益金鼎-松山,2023-02-09,9103
2425,承啟,5,2,3,群益金鼎-松山,2023-02-09,9103
3162,精確,15,12,3,群益金鼎-松山,2023-02-09,9103
3228,金麗科,5,2,3,群益金鼎-松山,2023-02-09,9103
4763,材料-KY,37,34,3,群益金鼎-松山,2023-02-09,9103
4968,立積,8,5,3,群益金鼎-松山,2023-02-09,9103
6443,元晶,3,0,3,群益金鼎-松山,2023-02-09,9103
6531,愛普*,8,5,3,群益金鼎-松山,2023-02-09,9103
6830,汎銓,4,1,3,群益金鼎-松山,2023-02-09,9103
6133,金橋,201,0,201,群益金鼎-松山,2023-02-10,9103
2344,華邦電,104,3,101,群益金鼎-松山,2023-02-10,9103
2201,裕隆,100,7,93,群益金鼎-松山,2023-02-10,9103
3362,先進光,92,2,90,群益金鼎-松山,2023-02-10,9103
4979,華星光,61,6,55,群益金鼎-松山,2023-02-10,9103
3481,群創,154,100,54,群益金鼎-松山,2023-02-10,9103
00632R,元大台灣50反1,50,0,50,群益金鼎-松山,2023-02-10,9103
2303,聯電,40,11,29,群益金鼎-松山,2023-02-10,9103
2867,三商壽,30,5,25,群益金鼎-松山,2023-02-10,9103
2328,廣宇,20,0,20,群益金鼎-松山,2023-02-10,9103
2704,國賓,20,0,20,群益金鼎-松山,2023-02-10,9103
2884,玉山金,19,0,19,群益金鼎-松山,2023-02-10,9103
2436,偉詮電,21,5,16,群益金鼎-松山,2023-02-10,9103
1608,華榮,15,0,15,群益金鼎-松山,2023-02-10,9103
1313,聯成,14,0,14,群益金鼎-松山,2023-02-10,9103
1432,大魯閣,14,0,14,群益金鼎-松山,2023-02-10,9103
4114,健喬,17,3,14,群益金鼎-松山,2023-02-10,9103
00720B,元大投資級公司債,13,0,13,群益金鼎-松山,2023-02-10,9103
1762,中化生,12,0,12,群益金鼎-松山,2023-02-10,9103
2882,國泰金,11,0,11,群益金鼎-松山,2023-02-10,9103
6552,易華電,23,12,11,群益金鼎-松山,2023-02-10,9103
2101,南港,20,10,10,群益金鼎-松山,2023-02-10,9103
6770,力積電,10,0,10,群益金鼎-松山,2023-02-10,9103
1409,新纖,10,0,10,群益金鼎-松山,2023-02-10,9103
1314,中石化,10,0,10,群益金鼎-松山,2023-02-10,9103
00878,國泰永續高股息,10,0,10,群益金鼎-松山,2023-02-10,9103
2485,兆赫,10,0,10,群益金鼎-松山,2023-02-10,9103
4541,晟田,10,0,10,群益金鼎-松山,2023-02-10,9103
6101,寬魚國際,10,0,10,群益金鼎-松山,2023-02-10,9103
6104,創惟,12,2,10,群益金鼎-松山,2023-02-10,9103
6278,台表科,10,0,10,群益金鼎-松山,2023-02-10,9103
6558,興能高,22,13,9,群益金鼎-松山,2023-02-10,9103
3402,漢科,8,0,8,群益金鼎-松山,2023-02-10,9103
6129,普誠,8,0,8,群益金鼎-松山,2023-02-10,9103
8433,弘帆,8,0,8,群益金鼎-松山,2023-02-10,9103
3704,合勤控,14,6,8,群益金鼎-松山,2023-02-10,9103
2748,雲品,7,0,7,群益金鼎-松山,2023-02-10,9103
8222,寶一,9,2,7,群益金鼎-松山,2023-02-10,9103
3189,景碩,6,0,6,群益金鼎-松山,2023-02-10,9103
2609,陽明,10,5,5,群益金鼎-松山,2023-02-10,9103
2002,中鋼,5,0,5,群益金鼎-松山,2023-02-10,9103
00881,國泰台灣5G+,5,0,5,群益金鼎-松山,2023-02-10,9103
00680L,元大美債20正2,5,0,5,群益金鼎-松山,2023-02-10,9103
00895,富邦未來車,5,0,5,群益金鼎-松山,2023-02-10,9103
1795,美時,13,8,5,群益金鼎-松山,2023-02-10,9103
2492,華新科,5,0,5,群益金鼎-松山,2023-02-10,9103
3042,晶技,5,0,5,群益金鼎-松山,2023-02-10,9103
5263,智崴,5,0,5,群益金鼎-松山,2023-02-10,9103
5608,四維航,5,0,5,群益金鼎-松山,2023-02-10,9103
6213,聯茂,16,11,5,群益金鼎-松山,2023-02-10,9103
2609,陽明,108,3,105,群益金鼎-松山,2023-02-13,9103
5347,世界,101,0,101,群益金鼎-松山,2023-02-13,9103
4114,健喬,61,20,41,群益金鼎-松山,2023-02-13,9103
3624,光頡,29,0,29,群益金鼎-松山,2023-02-13,9103
6509,聚和,29,0,29,群益金鼎-松山,2023-02-13,9103
6235,華孚,54,31,23,群益金鼎-松山,2023-02-13,9103
2208,台船,20,0,20,群益金鼎-松山,2023-02-13,9103
2610,華航,20,0,20,群益金鼎-松山,2023-02-13,9103
8033,雷虎,18,1,17,群益金鼎-松山,2023-02-13,9103
2401,凌陽,18,2,16,群益金鼎-松山,2023-02-13,9103
2637,慧洋-KY,14,2,12,群益金鼎-松山,2023-02-13,9103
6770,力積電,12,0,12,群益金鼎-松山,2023-02-13,9103
1795,美時,17,6,11,群益金鼎-松山,2023-02-13,9103
2704,國賓,11,0,11,群益金鼎-松山,2023-02-13,9103
6282,康舒,12,1,11,群益金鼎-松山,2023-02-13,9103
2328,廣宇,11,0,11,群益金鼎-松山,2023-02-13,9103
2887,台新金,10,0,10,群益金鼎-松山,2023-02-13,9103
00773B,中信優先金融債,10,0,10,群益金鼎-松山,2023-02-13,9103
2889,國票金,10,0,10,群益金鼎-松山,2023-02-13,9103
5351,鈺創,10,0,10,群益金鼎-松山,2023-02-13,9103
2884,玉山金,10,1,9,群益金鼎-松山,2023-02-13,9103
00881,國泰台灣5G+,8,0,8,群益金鼎-松山,2023-02-13,9103
2352,佳世達,8,0,8,群益金鼎-松山,2023-02-13,9103
3162,精確,8,0,8,群益金鼎-松山,2023-02-13,9103
2031,新光鋼,7,0,7,群益金鼎-松山,2023-02-13,9103
8916,光隆,7,0,7,群益金鼎-松山,2023-02-13,9103
9938,百和,12,5,7,群益金鼎-松山,2023-02-13,9103
1810,和成,8,2,6,群益金鼎-松山,2023-02-13,9103
00772B,中信高評級公司債,6,0,6,群益金鼎-松山,2023-02-13,9103
5425,台半,10,4,6,群益金鼎-松山,2023-02-13,9103
8222,寶一,39,33,6,群益金鼎-松山,2023-02-13,9103
00637L,元大滬深300正2,5,0,5,群益金鼎-松山,2023-02-13,9103
1524,耿鼎,5,0,5,群益金鼎-松山,2023-02-13,9103
1734,杏輝,28,23,5,群益金鼎-松山,2023-02-13,9103
2618,長榮航,5,0,5,群益金鼎-松山,2023-02-13,9103
2886,兆豐金,5,0,5,群益金鼎-松山,2023-02-13,9103
5263,智崴,5,0,5,群益金鼎-松山,2023-02-13,9103
5608,四維航,5,0,5,群益金鼎-松山,2023-02-13,9103
1760,寶齡富錦,4,0,4,群益金鼎-松山,2023-02-13,9103
3520,華盈,4,0,4,群益金鼎-松山,2023-02-13,9103
2303,聯電,6,2,4,群益金鼎-松山,2023-02-13,9103
3661,世芯-KY,9,6,3,群益金鼎-松山,2023-02-13,9103
1717,長興,3,0,3,群益金鼎-松山,2023-02-13,9103
1316,上曜,3,0,3,群益金鼎-松山,2023-02-13,9103
2201,裕隆,5,2,3,群益金鼎-松山,2023-02-13,9103
2607,榮運,3,0,3,群益金鼎-松山,2023-02-13,9103
3189,景碩,3,0,3,群益金鼎-松山,2023-02-13,9103
4503,金雨,4,1,3,群益金鼎-松山,2023-02-13,9103
6531,愛普*,3,0,3,群益金鼎-松山,2023-02-13,9103
1584,精剛,2,0,2,群益金鼎-松山,2023-02-13,9103
6509,聚和,142,0,142,群益金鼎-松山,2023-02-14,9103
2409,友達,200,100,100,群益金鼎-松山,2023-02-14,9103
3481,群創,100,2,98,群益金鼎-松山,2023-02-14,9103
3704,合勤控,48,7,41,群益金鼎-松山,2023-02-14,9103
1701,中化,120,90,30,群益金鼎-松山,2023-02-14,9103
00671R,富邦NASDAQ反1,30,0,30,群益金鼎-松山,2023-02-14,9103
4909,新復興,41,13,28,群益金鼎-松山,2023-02-14,9103
3479,安勤,26,1,25,群益金鼎-松山,2023-02-14,9103
00878,國泰永續高股息,20,0,20,群益金鼎-松山,2023-02-14,9103
2704,國賓,20,0,20,群益金鼎-松山,2023-02-14,9103
6541,泰福-KY,20,0,20,群益金鼎-松山,2023-02-14,9103
2344,華邦電,20,2,18,群益金鼎-松山,2023-02-14,9103
2618,長榮航,15,0,15,群益金鼎-松山,2023-02-14,9103
3013,晟銘電,15,0,15,群益金鼎-松山,2023-02-14,9103
4551,智伸科,13,0,13,群益金鼎-松山,2023-02-14,9103
1321,大洋,10,0,10,群益金鼎-松山,2023-02-14,9103
2351,順德,10,0,10,群益金鼎-松山,2023-02-14,9103
2375,凱美,14,4,10,群益金鼎-松山,2023-02-14,9103
4746,台耀,10,0,10,群益金鼎-松山,2023-02-14,9103
5703,亞都,10,0,10,群益金鼎-松山,2023-02-14,9103
6188,廣明,10,0,10,群益金鼎-松山,2023-02-14,9103
6605,帝寶,10,0,10,群益金鼎-松山,2023-02-14,9103
8215,明基材,20,10,10,群益金鼎-松山,2023-02-14,9103
8171,天宇,12,3,9,群益金鼎-松山,2023-02-14,9103
6290,良維,19,13,6,群益金鼎-松山,2023-02-14,9103
00665L,富邦�琤肭磪囓�2,5,0,5,群益金鼎-松山,2023-02-14,9103
00673R,期元大S＆P原油反1,5,0,5,群益金鼎-松山,2023-02-14,9103
2201,裕隆,15,10,5,群益金鼎-松山,2023-02-14,9103
2405,輔信,5,0,5,群益金鼎-松山,2023-02-14,9103
2482,連宇,5,0,5,群益金鼎-松山,2023-02-14,9103
2497,怡利電,5,0,5,群益金鼎-松山,2023-02-14,9103
3594,磐儀,15,10,5,群益金鼎-松山,2023-02-14,9103
5258,虹堡,8,3,5,群益金鼎-松山,2023-02-14,9103
6664,群翊,5,0,5,群益金鼎-松山,2023-02-14,9103
8409,商之器,5,0,5,群益金鼎-松山,2023-02-14,9103
8478,東哥遊艇,6,1,5,群益金鼎-松山,2023-02-14,9103
2017,官田鋼,5,0,5,群益金鼎-松山,2023-02-14,9103
00679B,元大美債20年,4,0,4,群益金鼎-松山,2023-02-14,9103
00637L,元大滬深300正2,4,0,4,群益金鼎-松山,2023-02-14,9103
8222,寶一,33,29,4,群益金鼎-松山,2023-02-14,9103
1909,榮成,5,1,4,群益金鼎-松山,2023-02-14,9103
2327,國巨,4,0,4,群益金鼎-松山,2023-02-14,9103
2504,國產,4,1,3,群益金鼎-松山,2023-02-14,9103
1342,八貫,4,1,3,群益金鼎-松山,2023-02-14,9103
1101,台泥,6,3,3,群益金鼎-松山,2023-02-14,9103
1519,華城,4,1,3,群益金鼎-松山,2023-02-14,9103
2314,台揚,3,0,3,群益金鼎-松山,2023-02-14,9103
2609,陽明,3,0,3,群益金鼎-松山,2023-02-14,9103
3444,利機,3,0,3,群益金鼎-松山,2023-02-14,9103
6213,聯茂,4,1,3,群益金鼎-松山,2023-02-14,9103
2484,希華,343,0,343,群益金鼎-松山,2023-02-15,9103
3481,群創,56,3,53,群益金鼎-松山,2023-02-15,9103
2731,雄獅,20,0,20,群益金鼎-松山,2023-02-15,9103
6770,力積電,18,0,18,群益金鼎-松山,2023-02-15,9103
2206,三陽工業,18,2,16,群益金鼎-松山,2023-02-15,9103
2027,大成鋼,15,0,15,群益金鼎-松山,2023-02-15,9103
2405,輔信,14,0,14,群益金鼎-松山,2023-02-15,9103
2891,中信金,14,0,14,群益金鼎-松山,2023-02-15,9103
6164,華興,12,0,12,群益金鼎-松山,2023-02-15,9103
8171,天宇,14,2,12,群益金鼎-松山,2023-02-15,9103
4114,健喬,20,9,11,群益金鼎-松山,2023-02-15,9103
6541,泰福-KY,23,12,11,群益金鼎-松山,2023-02-15,9103
00881,國泰台灣5G+,10,0,10,群益金鼎-松山,2023-02-15,9103
2637,慧洋-KY,10,0,10,群益金鼎-松山,2023-02-15,9103
00720B,元大投資級公司債,8,0,8,群益金鼎-松山,2023-02-15,9103
8349,�矬�,8,0,8,群益金鼎-松山,2023-02-15,9103
2330,台積電,11,4,7,群益金鼎-松山,2023-02-15,9103
2401,凌陽,6,0,6,群益金鼎-松山,2023-02-15,9103
2743,山富,6,0,6,群益金鼎-松山,2023-02-15,9103
3189,景碩,8,2,6,群益金鼎-松山,2023-02-15,9103
4919,新唐,6,0,6,群益金鼎-松山,2023-02-15,9103
6244,茂迪,9,3,6,群益金鼎-松山,2023-02-15,9103
2609,陽明,7,2,5,群益金鼎-松山,2023-02-15,9103
1760,寶齡富錦,5,0,5,群益金鼎-松山,2023-02-15,9103
2888,新光金,5,0,5,群益金鼎-松山,2023-02-15,9103
3362,先進光,5,0,5,群益金鼎-松山,2023-02-15,9103
3479,安勤,6,1,5,群益金鼎-松山,2023-02-15,9103
6278,台表科,5,0,5,群益金鼎-松山,2023-02-15,9103
1513,中興電,24,19,5,群益金鼎-松山,2023-02-15,9103
1810,和成,6,2,4,群益金鼎-松山,2023-02-15,9103
00635U,期元大S＆P黃金,4,0,4,群益金鼎-松山,2023-02-15,9103
3406,玉晶光,5,1,4,群益金鼎-松山,2023-02-15,9103
6472,保瑞,4,0,4,群益金鼎-松山,2023-02-15,9103
8040,九暘,4,0,4,群益金鼎-松山,2023-02-15,9103
8121,越峰,5,1,4,群益金鼎-松山,2023-02-15,9103
0050,元大台灣50,3,0,3,群益金鼎-松山,2023-02-15,9103
2337,旺宏,3,0,3,群益金鼎-松山,2023-02-15,9103
2455,全新,3,0,3,群益金鼎-松山,2023-02-15,9103
3557,嘉威,3,0,3,群益金鼎-松山,2023-02-15,9103
4168,醣聯,3,0,3,群益金鼎-松山,2023-02-15,9103
5425,台半,6,3,3,群益金鼎-松山,2023-02-15,9103
6129,普誠,3,0,3,群益金鼎-松山,2023-02-15,9103
6643,M31,24,21,3,群益金鼎-松山,2023-02-15,9103
2208,台船,2,0,2,群益金鼎-松山,2023-02-15,9103
2049,上銀,2,0,2,群益金鼎-松山,2023-02-15,9103
00715L,期街口布蘭特正2,2,0,2,群益金鼎-松山,2023-02-15,9103
006208,富邦台50,2,0,2,群益金鼎-松山,2023-02-15,9103
00905,FT臺灣Smart,2,0,2,群益金鼎-松山,2023-02-15,9103
1560,中砂,2,0,2,群益金鼎-松山,2023-02-15,9103
2454,聯發科,2,0,2,群益金鼎-松山,2023-02-15,9103
2484,希華,809,19,790,群益金鼎-松山,2023-02-16,9103
1718,中纖,52,0,52,群益金鼎-松山,2023-02-16,9103
00830,國泰費城半導體,50,0,50,群益金鼎-松山,2023-02-16,9103
1417,嘉裕,53,12,41,群益金鼎-松山,2023-02-16,9103
1437,勤益控,36,0,36,群益金鼎-松山,2023-02-16,9103
2610,華航,100,66,34,群益金鼎-松山,2023-02-16,9103
1605,華新,80,52,28,群益金鼎-松山,2023-02-16,9103
2208,台船,30,2,28,群益金鼎-松山,2023-02-16,9103
2009,第一銅,57,30,27,群益金鼎-松山,2023-02-16,9103
2028,威致,26,0,26,群益金鼎-松山,2023-02-16,9103
6133,金橋,30,7,23,群益金鼎-松山,2023-02-16,9103
8069,元太,61,39,22,群益金鼎-松山,2023-02-16,9103
6719,力智,21,0,21,群益金鼎-松山,2023-02-16,9103
00671R,富邦NASDAQ反1,20,0,20,群益金鼎-松山,2023-02-16,9103
3037,欣興,17,0,17,群益金鼎-松山,2023-02-16,9103
00885,富邦越南,17,0,17,群益金鼎-松山,2023-02-16,9103
2705,六福,13,0,13,群益金鼎-松山,2023-02-16,9103
3454,晶睿,16,3,13,群益金鼎-松山,2023-02-16,9103
4967,十銓,13,0,13,群益金鼎-松山,2023-02-16,9103
3704,合勤控,20,7,13,群益金鼎-松山,2023-02-16,9103
0061,元大寶滬深,10,0,10,群益金鼎-松山,2023-02-16,9103
00670L,富邦NASDAQ正2,10,0,10,群益金鼎-松山,2023-02-16,9103
2027,大成鋼,10,0,10,群益金鼎-松山,2023-02-16,9103
2332,友訊,10,0,10,群益金鼎-松山,2023-02-16,9103
2355,敬鵬,10,0,10,群益金鼎-松山,2023-02-16,9103
4114,健喬,14,4,10,群益金鼎-松山,2023-02-16,9103
6185,幃翔,10,0,10,群益金鼎-松山,2023-02-16,9103
8421,旭源,10,0,10,群益金鼎-松山,2023-02-16,9103
1513,中興電,16,7,9,群益金鼎-松山,2023-02-16,9103
2492,華新科,30,21,9,群益金鼎-松山,2023-02-16,9103
3710,連展投控,9,0,9,群益金鼎-松山,2023-02-16,9103
4164,承業醫,20,11,9,群益金鼎-松山,2023-02-16,9103
6150,撼訊,15,6,9,群益金鼎-松山,2023-02-16,9103
6231,系微,9,0,9,群益金鼎-松山,2023-02-16,9103
9938,百和,10,1,9,群益金鼎-松山,2023-02-16,9103
4551,智伸科,10,3,7,群益金鼎-松山,2023-02-16,9103
8478,東哥遊艇,7,0,7,群益金鼎-松山,2023-02-16,9103
00679B,元大美債20年,6,0,6,群益金鼎-松山,2023-02-16,9103
00665L,富邦�琤肭磪囓�2,6,0,6,群益金鼎-松山,2023-02-16,9103
006206,元大上證50,6,0,6,群益金鼎-松山,2023-02-16,9103
8433,弘帆,6,0,6,群益金鼎-松山,2023-02-16,9103
1609,大亞,5,0,5,群益金鼎-松山,2023-02-16,9103
2313,華通,5,0,5,群益金鼎-松山,2023-02-16,9103
2364,倫飛,5,0,5,群益金鼎-松山,2023-02-16,9103
3005,神基,5,0,5,群益金鼎-松山,2023-02-16,9103
4303,信立,5,0,5,群益金鼎-松山,2023-02-16,9103
6278,台表科,5,0,5,群益金鼎-松山,2023-02-16,9103
6477,安集,12,7,5,群益金鼎-松山,2023-02-16,9103
6612,奈米醫材,5,0,5,群益金鼎-松山,2023-02-16,9103
6865,偉康科技,5,0,5,群益金鼎-松山,2023-02-16,9103
6116,彩晶,400,200,200,群益金鼎-松山,2023-02-17,9103
2618,長榮航,103,1,102,群益金鼎-松山,2023-02-17,9103
5701,劍湖山,100,0,100,群益金鼎-松山,2023-02-17,9103
6274,台燿,62,0,62,群益金鼎-松山,2023-02-17,9103
5009,榮剛,60,0,60,群益金鼎-松山,2023-02-17,9103
2706,第一店,50,0,50,群益金鼎-松山,2023-02-17,9103
2887,台新金,50,0,50,群益金鼎-松山,2023-02-17,9103
5388,中磊,50,0,50,群益金鼎-松山,2023-02-17,9103
6285,啟��,50,0,50,群益金鼎-松山,2023-02-17,9103
2736,富野,40,0,40,群益金鼎-松山,2023-02-17,9103
8033,雷虎,41,1,40,群益金鼎-松山,2023-02-17,9103
3481,群創,203,168,35,群益金鼎-松山,2023-02-17,9103
2208,台船,90,60,30,群益金鼎-松山,2023-02-17,9103
3058,立德,31,1,30,群益金鼎-松山,2023-02-17,9103
2375,凱美,89,65,24,群益金鼎-松山,2023-02-17,9103
4967,十銓,23,2,21,群益金鼎-松山,2023-02-17,9103
1342,八貫,41,21,20,群益金鼎-松山,2023-02-17,9103
2453,凌群,39,19,20,群益金鼎-松山,2023-02-17,9103
3027,盛達,30,10,20,群益金鼎-松山,2023-02-17,9103
5469,瀚宇博,30,10,20,群益金鼎-松山,2023-02-17,9103
8050,廣積,30,10,20,群益金鼎-松山,2023-02-17,9103
8215,明基材,20,0,20,群益金鼎-松山,2023-02-17,9103
2498,宏達電,20,1,19,群益金鼎-松山,2023-02-17,9103
2610,華航,29,11,18,群益金鼎-松山,2023-02-17,9103
4551,智伸科,18,0,18,群益金鼎-松山,2023-02-17,9103
00679B,元大美債20年,16,0,16,群益金鼎-松山,2023-02-17,9103
00885,富邦越南,14,0,14,群益金鼎-松山,2023-02-17,9103
1216,統一,14,0,14,群益金鼎-松山,2023-02-17,9103
2028,威致,12,0,12,群益金鼎-松山,2023-02-17,9103
00680L,元大美債20正2,11,0,11,群益金鼎-松山,2023-02-17,9103
6235,華孚,17,6,11,群益金鼎-松山,2023-02-17,9103
0056,元大高股息,10,0,10,群益金鼎-松山,2023-02-17,9103
2201,裕隆,37,27,10,群益金鼎-松山,2023-02-17,9103
3362,先進光,10,0,10,群益金鼎-松山,2023-02-17,9103
6556,勝品,10,0,10,群益金鼎-松山,2023-02-17,9103
6806,森崴能源,14,4,10,群益金鼎-松山,2023-02-17,9103
8222,寶一,28,18,10,群益金鼎-松山,2023-02-17,9103
9928,中視,10,0,10,群益金鼎-松山,2023-02-17,9103
9938,百和,10,0,10,群益金鼎-松山,2023-02-17,9103
4961,天鈺,26,17,9,群益金鼎-松山,2023-02-17,9103
6173,信昌電,20,11,9,群益金鼎-松山,2023-02-17,9103
8040,九暘,9,0,9,群益金鼎-松山,2023-02-17,9103
0061,元大寶滬深,8,0,8,群益金鼎-松山,2023-02-17,9103
2603,長榮,8,0,8,群益金鼎-松山,2023-02-17,9103
2615,萬海,9,2,7,群益金鼎-松山,2023-02-17,9103
2401,凌陽,8,1,7,群益金鼎-松山,2023-02-17,9103
2609,陽明,7,1,6,群益金鼎-松山,2023-02-17,9103
2867,三商壽,6,0,6,群益金鼎-松山,2023-02-17,9103
3705,永信,6,0,6,群益金鼎-松山,2023-02-17,9103
00638R,元大滬深300反1,5,0,5,群益金鼎-松山,2023-02-17,9103
6133,金橋,133,0,133,群益金鼎-松山,2023-02-20,9103
1605,華新,98,37,61,群益金鼎-松山,2023-02-20,9103
6122,擎邦,57,0,57,群益金鼎-松山,2023-02-20,9103
1504,東元,56,7,49,群益金鼎-松山,2023-02-20,9103
2009,第一銅,30,0,30,群益金鼎-松山,2023-02-20,9103
6235,華孚,30,1,29,群益金鼎-松山,2023-02-20,9103
2890,永豐金,25,0,25,群益金鼎-松山,2023-02-20,9103
2034,允強,22,0,22,群益金鼎-松山,2023-02-20,9103
6179,亞通,22,0,22,群益金鼎-松山,2023-02-20,9103
1810,和成,24,2,22,群益金鼎-松山,2023-02-20,9103
6282,康舒,21,2,19,群益金鼎-松山,2023-02-20,9103
5009,榮剛,18,0,18,群益金鼎-松山,2023-02-20,9103
5452,佶優,17,0,17,群益金鼎-松山,2023-02-20,9103
00671R,富邦NASDAQ反1,15,0,15,群益金鼎-松山,2023-02-20,9103
00885,富邦越南,14,0,14,群益金鼎-松山,2023-02-20,9103
2485,兆赫,14,0,14,群益金鼎-松山,2023-02-20,9103
1503,士電,43,30,13,群益金鼎-松山,2023-02-20,9103
2206,三陽工業,15,3,12,群益金鼎-松山,2023-02-20,9103
2637,慧洋-KY,11,0,11,群益金鼎-松山,2023-02-20,9103
4164,承業醫,31,20,11,群益金鼎-松山,2023-02-20,9103
00902,中信電池及儲能,10,0,10,群益金鼎-松山,2023-02-20,9103
00632R,元大台灣50反1,10,0,10,群益金鼎-松山,2023-02-20,9103
1216,統一,10,0,10,群益金鼎-松山,2023-02-20,9103
2323,中環,10,0,10,群益金鼎-松山,2023-02-20,9103
2338,光罩,11,1,10,群益金鼎-松山,2023-02-20,9103
2462,良得電,10,0,10,群益金鼎-松山,2023-02-20,9103
2906,高林,10,0,10,群益金鼎-松山,2023-02-20,9103
3675,德微,10,0,10,群益金鼎-松山,2023-02-20,9103
4163,鐿鈦,10,0,10,群益金鼎-松山,2023-02-20,9103
6143,振曜,25,15,10,群益金鼎-松山,2023-02-20,9103
6279,胡連,15,5,10,群益金鼎-松山,2023-02-20,9103
2317,鴻海,10,1,9,群益金鼎-松山,2023-02-20,9103
1319,東陽,10,1,9,群益金鼎-松山,2023-02-20,9103
6202,盛群,22,13,9,群益金鼎-松山,2023-02-20,9103
5258,虹堡,21,13,8,群益金鼎-松山,2023-02-20,9103
00637L,元大滬深300正2,20,13,7,群益金鼎-松山,2023-02-20,9103
1795,美時,24,17,7,群益金鼎-松山,2023-02-20,9103
1560,中砂,6,0,6,群益金鼎-松山,2023-02-20,9103
2455,全新,8,2,6,群益金鼎-松山,2023-02-20,9103
3484,崧騰,6,0,6,群益金鼎-松山,2023-02-20,9103
6792,詠業,8,2,6,群益金鼎-松山,2023-02-20,9103
1529,樂事綠能,6,1,5,群益金鼎-松山,2023-02-20,9103
006206,元大上證50,5,0,5,群益金鼎-松山,2023-02-20,9103
2634,漢翔,16,11,5,群益金鼎-松山,2023-02-20,9103
3017,奇鋐,5,0,5,群益金鼎-松山,2023-02-20,9103
3479,安勤,5,0,5,群益金鼎-松山,2023-02-20,9103
6274,台燿,10,5,5,群益金鼎-松山,2023-02-20,9103
6443,元晶,5,0,5,群益金鼎-松山,2023-02-20,9103
6865,偉康科技,5,0,5,群益金鼎-松山,2023-02-20,9103
8349,�矬�,6,1,5,群益金鼎-松山,2023-02-20,9103
2484,希華,506,225,281,群益金鼎-松山,2023-02-21,9103
3481,群創,204,39,165,群益金鼎-松山,2023-02-21,9103
6133,金橋,100,0,100,群益金鼎-松山,2023-02-21,9103
6213,聯茂,77,0,77,群益金鼎-松山,2023-02-21,9103
1513,中興電,129,64,65,群益金鼎-松山,2023-02-21,9103
8081,致新,113,51,62,群益金鼎-松山,2023-02-21,9103
5452,佶優,49,1,48,群益金鼎-松山,2023-02-21,9103
3037,欣興,41,0,41,群益金鼎-松山,2023-02-21,9103
6104,創惟,190,155,35,群益金鼎-松山,2023-02-21,9103
1108,幸福,30,0,30,群益金鼎-松山,2023-02-21,9103
2371,大同,30,0,30,群益金鼎-松山,2023-02-21,9103
3508,位速,30,0,30,群益金鼎-松山,2023-02-21,9103
4529,淳紳,30,0,30,群益金鼎-松山,2023-02-21,9103
3322,建舜電,30,1,29,群益金鼎-松山,2023-02-21,9103
2476,鉅祥,25,0,25,群益金鼎-松山,2023-02-21,9103
3027,盛達,68,43,25,群益金鼎-松山,2023-02-21,9103
2457,飛宏,45,21,24,群益金鼎-松山,2023-02-21,9103
6122,擎邦,24,0,24,群益金鼎-松山,2023-02-21,9103
6282,康舒,52,28,24,群益金鼎-松山,2023-02-21,9103
3078,僑威,23,0,23,群益金鼎-松山,2023-02-21,9103
2702,華園,20,0,20,群益金鼎-松山,2023-02-21,9103
3693,營邦,21,1,20,群益金鼎-松山,2023-02-21,9103
6120,達運,70,50,20,群益金鼎-松山,2023-02-21,9103
5344,立衛,18,0,18,群益金鼎-松山,2023-02-21,9103
8222,寶一,27,11,16,群益金鼎-松山,2023-02-21,9103
1432,大魯閣,15,0,15,群益金鼎-松山,2023-02-21,9103
00751B,元大AAA至A公司債,15,0,15,群益金鼎-松山,2023-02-21,9103
2885,元大金,15,0,15,群益金鼎-松山,2023-02-21,9103
8183,精星,15,0,15,群益金鼎-松山,2023-02-21,9103
2201,裕隆,20,5,15,群益金鼎-松山,2023-02-21,9103
00885,富邦越南,14,0,14,群益金鼎-松山,2023-02-21,9103
2603,長榮,18,6,12,群益金鼎-松山,2023-02-21,9103
2882,國泰金,21,10,11,群益金鼎-松山,2023-02-21,9103
1584,精剛,11,0,11,群益金鼎-松山,2023-02-21,9103
1701,中化,10,0,10,群益金鼎-松山,2023-02-21,9103
1321,大洋,10,0,10,群益金鼎-松山,2023-02-21,9103
6552,易華電,10,0,10,群益金鼎-松山,2023-02-21,9103
5258,虹堡,12,3,9,群益金鼎-松山,2023-02-21,9103
6026,福邦證,10,1,9,群益金鼎-松山,2023-02-21,9103
2641,正德,8,0,8,群益金鼎-松山,2023-02-21,9103
8358,金居,11,3,8,群益金鼎-松山,2023-02-21,9103
3128,昇銳,6,0,6,群益金鼎-松山,2023-02-21,9103
4968,立積,18,12,6,群益金鼎-松山,2023-02-21,9103
3704,合勤控,6,1,5,群益金鼎-松山,2023-02-21,9103
1503,士電,31,26,5,群益金鼎-松山,2023-02-21,9103
2027,大成鋼,5,0,5,群益金鼎-松山,2023-02-21,9103
2329,華泰,5,0,5,群益金鼎-松山,2023-02-21,9103
2405,輔信,5,0,5,群益金鼎-松山,2023-02-21,9103
2636,台驊控股,5,0,5,群益金鼎-松山,2023-02-21,9103
3224,三顧,5,0,5,群益金鼎-松山,2023-02-21,9103
00664R,國泰臺灣加權反1,150,0,150,群益金鼎-松山,2023-02-22,9103
8084,巨虹,48,0,48,群益金鼎-松山,2023-02-22,9103
6213,聯茂,35,0,35,群益金鼎-松山,2023-02-22,9103
5512,力麒,30,0,30,群益金鼎-松山,2023-02-22,9103
4960,誠美材,28,0,28,群益金鼎-松山,2023-02-22,9103
2208,台船,32,5,27,群益金鼎-松山,2023-02-22,9103
2485,兆赫,22,0,22,群益金鼎-松山,2023-02-22,9103
1437,勤益控,20,0,20,群益金鼎-松山,2023-02-22,9103
2886,兆豐金,20,0,20,群益金鼎-松山,2023-02-22,9103
6538,倉和,20,0,20,群益金鼎-松山,2023-02-22,9103
8222,寶一,50,30,20,群益金鼎-松山,2023-02-22,9103
8033,雷虎,23,4,19,群益金鼎-松山,2023-02-22,9103
5381,合正,18,0,18,群益金鼎-松山,2023-02-22,9103
2748,雲品,29,11,18,群益金鼎-松山,2023-02-22,9103
6104,創惟,16,0,16,群益金鼎-松山,2023-02-22,9103
8171,天宇,16,0,16,群益金鼎-松山,2023-02-22,9103
2436,偉詮電,15,0,15,群益金鼎-松山,2023-02-22,9103
2303,聯電,14,0,14,群益金鼎-松山,2023-02-22,9103
1584,精剛,24,10,14,群益金鼎-松山,2023-02-22,9103
00885,富邦越南,14,0,14,群益金鼎-松山,2023-02-22,9103
00878,國泰永續高股息,13,0,13,群益金鼎-松山,2023-02-22,9103
5452,佶優,13,1,12,群益金鼎-松山,2023-02-22,9103
6715,嘉基,12,0,12,群益金鼎-松山,2023-02-22,9103
5210,寶碩,11,0,11,群益金鼎-松山,2023-02-22,9103
00773B,中信優先金融債,10,0,10,群益金鼎-松山,2023-02-22,9103
2884,玉山金,10,0,10,群益金鼎-松山,2023-02-22,9103
4770,上品,10,0,10,群益金鼎-松山,2023-02-22,9103
5258,虹堡,16,6,10,群益金鼎-松山,2023-02-22,9103
6418,詠昇,10,0,10,群益金鼎-松山,2023-02-22,9103
8069,元太,12,2,10,群益金鼎-松山,2023-02-22,9103
3006,晶豪科,9,0,9,群益金鼎-松山,2023-02-22,9103
6257,矽格,9,0,9,群益金鼎-松山,2023-02-22,9103
6282,康舒,15,6,9,群益金鼎-松山,2023-02-22,9103
3704,合勤控,9,1,8,群益金鼎-松山,2023-02-22,9103
1216,統一,8,0,8,群益金鼎-松山,2023-02-22,9103
6770,力積電,17,9,8,群益金鼎-松山,2023-02-22,9103
1519,華城,15,8,7,群益金鼎-松山,2023-02-22,9103
1316,上曜,7,0,7,群益金鼎-松山,2023-02-22,9103
2476,鉅祥,7,0,7,群益金鼎-松山,2023-02-22,9103
3051,力特,7,0,7,群益金鼎-松山,2023-02-22,9103
5009,榮剛,8,1,7,群益金鼎-松山,2023-02-22,9103
8433,弘帆,8,1,7,群益金鼎-松山,2023-02-22,9103
0056,元大高股息,6,0,6,群益金鼎-松山,2023-02-22,9103
2034,允強,6,0,6,群益金鼎-松山,2023-02-22,9103
3228,金麗科,8,2,6,群益金鼎-松山,2023-02-22,9103
4106,雃博,6,0,6,群益金鼎-松山,2023-02-22,9103
3035,智原,30,25,5,群益金鼎-松山,2023-02-22,9103
3594,磐儀,6,1,5,群益金鼎-松山,2023-02-22,9103
1504,東元,5,0,5,群益金鼎-松山,2023-02-22,9103
00902,中信電池及儲能,5,0,5,群益金鼎-松山,2023-02-22,9103
00671R,富邦NASDAQ反1,135,0,135,群益金鼎-松山,2023-02-23,9103
00632R,元大台灣50反1,110,0,110,群益金鼎-松山,2023-02-23,9103
5608,四維航,61,5,56,群益金鼎-松山,2023-02-23,9103
3652,精聯,28,0,28,群益金鼎-松山,2023-02-23,9103
8940,新天地,27,0,27,群益金鼎-松山,2023-02-23,9103
2834,臺企銀,30,5,25,群益金鼎-松山,2023-02-23,9103
1762,中化生,40,16,24,群益金鼎-松山,2023-02-23,9103
5353,台林,26,4,22,群益金鼎-松山,2023-02-23,9103
2388,威盛,44,23,21,群益金鼎-松山,2023-02-23,9103
00668,國泰美國道瓊,20,0,20,群益金鼎-松山,2023-02-23,9103
3162,精確,42,22,20,群益金鼎-松山,2023-02-23,9103
2498,宏達電,24,7,17,群益金鼎-松山,2023-02-23,9103
8358,金居,18,1,17,群益金鼎-松山,2023-02-23,9103
8383,千附,20,3,17,群益金鼎-松山,2023-02-23,9103
00715L,期街口布蘭特正2,15,0,15,群益金鼎-松山,2023-02-23,9103
3710,連展投控,15,0,15,群益金鼎-松山,2023-02-23,9103
2201,裕隆,20,5,15,群益金鼎-松山,2023-02-23,9103
00885,富邦越南,14,0,14,群益金鼎-松山,2023-02-23,9103
5452,佶優,14,0,14,群益金鼎-松山,2023-02-23,9103
2618,長榮航,16,4,12,群益金鼎-松山,2023-02-23,9103
3362,先進光,14,3,11,群益金鼎-松山,2023-02-23,9103
6517,保勝光學,11,0,11,群益金鼎-松山,2023-02-23,9103
8409,商之器,11,0,11,群益金鼎-松山,2023-02-23,9103
2705,六福,10,0,10,群益金鼎-松山,2023-02-23,9103
2377,微星,10,0,10,群益金鼎-松山,2023-02-23,9103
2465,麗臺,16,6,10,群益金鼎-松山,2023-02-23,9103
2838,聯邦銀,10,0,10,群益金鼎-松山,2023-02-23,9103
2886,兆豐金,10,0,10,群益金鼎-松山,2023-02-23,9103
3324,雙鴻,10,0,10,群益金鼎-松山,2023-02-23,9103
2637,慧洋-KY,19,9,10,群益金鼎-松山,2023-02-23,9103
1103,嘉泥,9,0,9,群益金鼎-松山,2023-02-23,9103
6799,來頡,9,0,9,群益金鼎-松山,2023-02-23,9103
0061,元大寶滬深,8,0,8,群益金鼎-松山,2023-02-23,9103
00637L,元大滬深300正2,8,0,8,群益金鼎-松山,2023-02-23,9103
2881,富邦金,8,0,8,群益金鼎-松山,2023-02-23,9103
2882,國泰金,9,1,8,群益金鼎-松山,2023-02-23,9103
3027,盛達,7,0,7,群益金鼎-松山,2023-02-23,9103
2329,華泰,6,0,6,群益金鼎-松山,2023-02-23,9103
2471,資通,6,0,6,群益金鼎-松山,2023-02-23,9103
2482,連宇,11,5,6,群益金鼎-松山,2023-02-23,9103
3037,欣興,21,15,6,群益金鼎-松山,2023-02-23,9103
4931,新盛力,6,0,6,群益金鼎-松山,2023-02-23,9103
6122,擎邦,6,0,6,群益金鼎-松山,2023-02-23,9103
6768,志強-KY,6,0,6,群益金鼎-松山,2023-02-23,9103
006206,元大上證50,5,0,5,群益金鼎-松山,2023-02-23,9103
0056,元大高股息,5,0,5,群益金鼎-松山,2023-02-23,9103
00902,中信電池及儲能,5,0,5,群益金鼎-松山,2023-02-23,9103
2611,志信,5,0,5,群益金鼎-松山,2023-02-23,9103
2734,易飛網,5,0,5,群益金鼎-松山,2023-02-23,9103
2756,聯發國際,5,0,5,群益金鼎-松山,2023-02-23,9103
6133,金橋,307,0,307,群益金鼎-松山,2023-02-24,9103
3017,奇鋐,235,15,220,群益金鼎-松山,2023-02-24,9103
5347,世界,100,0,100,群益金鼎-松山,2023-02-24,9103
2023,燁輝,86,0,86,群益金鼎-松山,2023-02-24,9103
2641,正德,65,1,64,群益金鼎-松山,2023-02-24,9103
5512,力麒,152,100,52,群益金鼎-松山,2023-02-24,9103
2007,燁興,50,0,50,群益金鼎-松山,2023-02-24,9103
00679B,元大美債20年,40,0,40,群益金鼎-松山,2023-02-24,9103
2601,益航,40,0,40,群益金鼎-松山,2023-02-24,9103
5608,四維航,206,170,36,群益金鼎-松山,2023-02-24,9103
00915,凱基優選高股息30,30,0,30,群益金鼎-松山,2023-02-24,9103
00632R,元大台灣50反1,30,5,25,群益金鼎-松山,2023-02-24,9103
2317,鴻海,25,0,25,群益金鼎-松山,2023-02-24,9103
2612,中航,30,12,18,群益金鼎-松山,2023-02-24,9103
1584,精剛,18,0,18,群益金鼎-松山,2023-02-24,9103
1432,大魯閣,17,0,17,群益金鼎-松山,2023-02-24,9103
0056,元大高股息,17,0,17,群益金鼎-松山,2023-02-24,9103
6538,倉和,15,0,15,群益金鼎-松山,2023-02-24,9103
00885,富邦越南,14,0,14,群益金鼎-松山,2023-02-24,9103
3037,欣興,17,4,13,群益金鼎-松山,2023-02-24,9103
1314,中石化,12,0,12,群益金鼎-松山,2023-02-24,9103
2380,虹光,12,0,12,群益金鼎-松山,2023-02-24,9103
3624,光頡,13,1,12,群益金鼎-松山,2023-02-24,9103
1519,華城,11,0,11,群益金鼎-松山,2023-02-24,9103
3163,波若威,15,4,11,群益金鼎-松山,2023-02-24,9103
2637,慧洋-KY,56,45,11,群益金鼎-松山,2023-02-24,9103
1437,勤益控,10,0,10,群益金鼎-松山,2023-02-24,9103
00753L,中信中國50正2,10,0,10,群益金鼎-松山,2023-02-24,9103
00713,元大台灣高息低波,10,0,10,群益金鼎-松山,2023-02-24,9103
00633L,富邦上証正2,10,0,10,群益金鼎-松山,2023-02-24,9103
2607,榮運,10,0,10,群益金鼎-松山,2023-02-24,9103
3557,嘉威,10,0,10,群益金鼎-松山,2023-02-24,9103
2360,致茂,9,0,9,群益金鼎-松山,2023-02-24,9103
6443,元晶,9,0,9,群益金鼎-松山,2023-02-24,9103
00772B,中信高評級公司債,8,0,8,群益金鼎-松山,2023-02-24,9103
0061,元大寶滬深,8,0,8,群益金鼎-松山,2023-02-24,9103
2498,宏達電,12,4,8,群益金鼎-松山,2023-02-24,9103
6205,詮欣,8,0,8,群益金鼎-松山,2023-02-24,9103
2354,鴻準,7,0,7,群益金鼎-松山,2023-02-24,9103
2729,瓦城,7,0,7,群益金鼎-松山,2023-02-24,9103
4746,台耀,30,23,7,群益金鼎-松山,2023-02-24,9103
8033,雷虎,8,1,7,群益金鼎-松山,2023-02-24,9103
2603,長榮,8,2,6,群益金鼎-松山,2023-02-24,9103
4919,新唐,6,0,6,群益金鼎-松山,2023-02-24,9103
8478,東哥遊艇,6,0,6,群益金鼎-松山,2023-02-24,9103
006206,元大上證50,5,0,5,群益金鼎-松山,2023-02-24,9103
1321,大洋,5,0,5,群益金鼎-松山,2023-02-24,9103
2363,矽統,5,0,5,群益金鼎-松山,2023-02-24,9103
2399,映泰,5,0,5,群益金鼎-松山,2023-02-24,9103
2454,聯發科,8,3,5,群益金鼎-松山,2023-02-24,9103
00669R,國泰美國道瓊反1,1000,0,1000,群益金鼎-松山,2023-03-01,9103
3481,群創,201,101,100,群益金鼎-松山,2023-03-01,9103
5701,劍湖山,100,0,100,群益金鼎-松山,2023-03-01,9103
2344,華邦電,103,17,86,群益金鼎-松山,2023-03-01,9103
2609,陽明,66,5,61,群益金鼎-松山,2023-03-01,9103
2605,新興,115,64,51,群益金鼎-松山,2023-03-01,9103
1108,幸福,50,0,50,群益金鼎-松山,2023-03-01,9103
00715L,期街口布蘭特正2,50,0,50,群益金鼎-松山,2023-03-01,9103
2409,友達,160,122,38,群益金鼎-松山,2023-03-01,9103
2498,宏達電,38,5,33,群益金鼎-松山,2023-03-01,9103
3708,上緯投控,30,0,30,群益金鼎-松山,2023-03-01,9103
2388,威盛,76,49,27,群益金鼎-松山,2023-03-01,9103
2603,長榮,29,2,27,群益金鼎-松山,2023-03-01,9103
6150,撼訊,26,0,26,群益金鼎-松山,2023-03-01,9103
1605,華新,32,7,25,群益金鼎-松山,2023-03-01,9103
4915,致伸,23,0,23,群益金鼎-松山,2023-03-01,9103
3535,晶彩科,22,0,22,群益金鼎-松山,2023-03-01,9103
2368,金像電,25,4,21,群益金鼎-松山,2023-03-01,9103
2736,富野,20,0,20,群益金鼎-松山,2023-03-01,9103
2881,富邦金,20,0,20,群益金鼎-松山,2023-03-01,9103
9938,百和,20,0,20,群益金鼎-松山,2023-03-01,9103
00720B,元大投資級公司債,18,0,18,群益金鼎-松山,2023-03-01,9103
00885,富邦越南,18,0,18,群益金鼎-松山,2023-03-01,9103
4967,十銓,20,2,18,群益金鼎-松山,2023-03-01,9103
6118,建達,19,1,18,群益金鼎-松山,2023-03-01,9103
2489,瑞軒,17,0,17,群益金鼎-松山,2023-03-01,9103
00878,國泰永續高股息,16,0,16,群益金鼎-松山,2023-03-01,9103
6770,力積電,16,0,16,群益金鼎-松山,2023-03-01,9103
3207,耀勝,16,1,15,群益金鼎-松山,2023-03-01,9103
3362,先進光,55,40,15,群益金鼎-松山,2023-03-01,9103
4551,智伸科,15,0,15,群益金鼎-松山,2023-03-01,9103
5347,世界,17,2,15,群益金鼎-松山,2023-03-01,9103
6122,擎邦,15,0,15,群益金鼎-松山,2023-03-01,9103
6841,長佳智能,16,1,15,群益金鼎-松山,2023-03-01,9103
2637,慧洋-KY,34,21,13,群益金鼎-松山,2023-03-01,9103
2618,長榮航,13,1,12,群益金鼎-松山,2023-03-01,9103
3221,台嘉碩,12,0,12,群益金鼎-松山,2023-03-01,9103
8936,國統,14,3,11,群益金鼎-松山,2023-03-01,9103
2888,新光金,11,0,11,群益金鼎-松山,2023-03-01,9103
6443,元晶,11,0,11,群益金鼎-松山,2023-03-01,9103
00773B,中信優先金融債,10,0,10,群益金鼎-松山,2023-03-01,9103
2450,神腦,10,0,10,群益金鼎-松山,2023-03-01,9103
2610,華航,12,2,10,群益金鼎-松山,2023-03-01,9103
2712,遠雄來,10,0,10,群益金鼎-松山,2023-03-01,9103
3122,笙泉,10,0,10,群益金鼎-松山,2023-03-01,9103
4164,承業醫,10,0,10,群益金鼎-松山,2023-03-01,9103
6517,保勝光學,10,0,10,群益金鼎-松山,2023-03-01,9103
6768,志強-KY,10,0,10,群益金鼎-松山,2023-03-01,9103
1762,中化生,17,8,9,群益金鼎-松山,2023-03-01,9103
2419,仲琦,11,2,9,群益金鼎-松山,2023-03-01,9103
3481,群創,112,0,112,群益金鼎-松山,2023-03-02,9103
2641,正德,68,3,65,群益金鼎-松山,2023-03-02,9103
6122,擎邦,56,0,56,群益金鼎-松山,2023-03-02,9103
2007,燁興,50,0,50,群益金鼎-松山,2023-03-02,9103
2409,友達,45,2,43,群益金鼎-松山,2023-03-02,9103
6213,聯茂,45,3,42,群益金鼎-松山,2023-03-02,9103
00878,國泰永續高股息,35,2,33,群益金鼎-松山,2023-03-02,9103
5608,四維航,31,1,30,群益金鼎-松山,2023-03-02,9103
5014,建錩,29,0,29,群益金鼎-松山,2023-03-02,9103
8940,新天地,38,10,28,群益金鼎-松山,2023-03-02,9103
2484,希華,628,601,27,群益金鼎-松山,2023-03-02,9103
1605,華新,36,13,23,群益金鼎-松山,2023-03-02,9103
4557,永新-KY,23,0,23,群益金鼎-松山,2023-03-02,9103
1584,精剛,17,0,17,群益金鼎-松山,2023-03-02,9103
3704,合勤控,20,4,16,群益金鼎-松山,2023-03-02,9103
1321,大洋,15,0,15,群益金鼎-松山,2023-03-02,9103
00885,富邦越南,15,0,15,群益金鼎-松山,2023-03-02,9103
4155,訊映,14,0,14,群益金鼎-松山,2023-03-02,9103
3362,先進光,31,18,13,群益金鼎-松山,2023-03-02,9103
8048,德勝,13,0,13,群益金鼎-松山,2023-03-02,9103
2332,友訊,12,0,12,群益金鼎-松山,2023-03-02,9103
3162,精確,12,0,12,群益金鼎-松山,2023-03-02,9103
4153,鈺緯,12,0,12,群益金鼎-松山,2023-03-02,9103
5704,老爺知,30,18,12,群益金鼎-松山,2023-03-02,9103
8049,晶采,12,0,12,群益金鼎-松山,2023-03-02,9103
00772B,中信高評級公司債,11,0,11,群益金鼎-松山,2023-03-02,9103
00751B,元大AAA至A公司債,10,0,10,群益金鼎-松山,2023-03-02,9103
1503,士電,11,1,10,群益金鼎-松山,2023-03-02,9103
3058,立德,10,0,10,群益金鼎-松山,2023-03-02,9103
3260,威剛,10,0,10,群益金鼎-松山,2023-03-02,9103
4164,承業醫,20,10,10,群益金鼎-松山,2023-03-02,9103
5009,榮剛,10,0,10,群益金鼎-松山,2023-03-02,9103
5609,中菲行,10,0,10,群益金鼎-松山,2023-03-02,9103
8222,寶一,10,0,10,群益金鼎-松山,2023-03-02,9103
3265,台星科,10,1,9,群益金鼎-松山,2023-03-02,9103
6257,矽格,11,2,9,群益金鼎-松山,2023-03-02,9103
2610,華航,20,12,8,群益金鼎-松山,2023-03-02,9103
2748,雲品,31,23,8,群益金鼎-松山,2023-03-02,9103
6164,華興,8,0,8,群益金鼎-松山,2023-03-02,9103
8033,雷虎,20,13,7,群益金鼎-松山,2023-03-02,9103
8289,泰藝,7,0,7,群益金鼎-松山,2023-03-02,9103
4138,曜亞,6,0,6,群益金鼎-松山,2023-03-02,9103
6417,韋僑,6,0,6,群益金鼎-松山,2023-03-02,9103
6841,長佳智能,11,5,6,群益金鼎-松山,2023-03-02,9103
1342,八貫,5,0,5,群益金鼎-松山,2023-03-02,9103
1752,南光,5,0,5,群益金鼎-松山,2023-03-02,9103
1513,中興電,17,12,5,群益金鼎-松山,2023-03-02,9103
006206,元大上證50,5,0,5,群益金鼎-松山,2023-03-02,9103
2368,金像電,5,0,5,群益金鼎-松山,2023-03-02,9103
2892,第一金,5,0,5,群益金鼎-松山,2023-03-02,9103
2409,友達,500,321,179,群益金鼎-松山,2023-03-03,9103
1513,中興電,104,1,103,群益金鼎-松山,2023-03-03,9103
6133,金橋,101,0,101,群益金鼎-松山,2023-03-03,9103
6116,彩晶,100,0,100,群益金鼎-松山,2023-03-03,9103
2344,華邦電,76,5,71,群益金鼎-松山,2023-03-03,9103
6122,擎邦,67,0,67,群益金鼎-松山,2023-03-03,9103
2317,鴻海,37,0,37,群益金鼎-松山,2023-03-03,9103
8215,明基材,34,0,34,群益金鼎-松山,2023-03-03,9103
3035,智原,35,3,32,群益金鼎-松山,2023-03-03,9103
2427,三商電,30,0,30,群益金鼎-松山,2023-03-03,9103
3272,東碩,26,0,26,群益金鼎-松山,2023-03-03,9103
2388,威盛,28,4,24,群益金鼎-松山,2023-03-03,9103
2882,國泰金,22,0,22,群益金鼎-松山,2023-03-03,9103
6799,來頡,22,1,21,群益金鼎-松山,2023-03-03,9103
00632R,元大台灣50反1,20,0,20,群益金鼎-松山,2023-03-03,9103
2637,慧洋-KY,32,12,20,群益金鼎-松山,2023-03-03,9103
6164,華興,20,0,20,群益金鼎-松山,2023-03-03,9103
5410,國眾,17,0,17,群益金鼎-松山,2023-03-03,9103
00633L,富邦上証正2,15,0,15,群益金鼎-松山,2023-03-03,9103
00885,富邦越南,15,0,15,群益金鼎-松山,2023-03-03,9103
1795,美時,15,0,15,群益金鼎-松山,2023-03-03,9103
3362,先進光,47,33,14,群益金鼎-松山,2023-03-03,9103
1316,上曜,11,0,11,群益金鼎-松山,2023-03-03,9103
2374,佳能,23,12,11,群益金鼎-松山,2023-03-03,9103
2610,華航,11,0,11,群益金鼎-松山,2023-03-03,9103
3029,零壹,11,0,11,群益金鼎-松山,2023-03-03,9103
2020,美亞,10,0,10,群益金鼎-松山,2023-03-03,9103
2371,大同,10,0,10,群益金鼎-松山,2023-03-03,9103
2611,志信,10,0,10,群益金鼎-松山,2023-03-03,9103
2612,中航,10,0,10,群益金鼎-松山,2023-03-03,9103
3013,晟銘電,10,0,10,群益金鼎-松山,2023-03-03,9103
3322,建舜電,10,0,10,群益金鼎-松山,2023-03-03,9103
3432,台端,10,0,10,群益金鼎-松山,2023-03-03,9103
3504,揚明光,20,10,10,群益金鼎-松山,2023-03-03,9103
3652,精聯,20,10,10,群益金鼎-松山,2023-03-03,9103
5258,虹堡,18,8,10,群益金鼎-松山,2023-03-03,9103
5351,鈺創,10,0,10,群益金鼎-松山,2023-03-03,9103
6697,東捷資訊,10,0,10,群益金鼎-松山,2023-03-03,9103
6791,虎門科技,10,0,10,群益金鼎-松山,2023-03-03,9103
2891,中信金,9,0,9,群益金鼎-松山,2023-03-03,9103
2606,裕民,9,0,9,群益金鼎-松山,2023-03-03,9103
2739,寒舍,9,0,9,群益金鼎-松山,2023-03-03,9103
5014,建錩,9,0,9,群益金鼎-松山,2023-03-03,9103
0061,元大寶滬深,8,0,8,群益金鼎-松山,2023-03-03,9103
3006,晶豪科,8,0,8,群益金鼎-松山,2023-03-03,9103
2023,燁輝,7,0,7,群益金鼎-松山,2023-03-03,9103
6235,華孚,21,14,7,群益金鼎-松山,2023-03-03,9103
2413,環科,6,0,6,群益金鼎-松山,2023-03-03,9103
2729,瓦城,6,0,6,群益金鼎-松山,2023-03-03,9103
2886,兆豐金,6,0,6,群益金鼎-松山,2023-03-03,9103
6133,金橋,124,0,124,群益金鼎-松山,2023-03-06,9103
3049,精金,100,0,100,群益金鼎-松山,2023-03-06,9103
6509,聚和,90,0,90,群益金鼎-松山,2023-03-06,9103
1752,南光,62,0,62,群益金鼎-松山,2023-03-06,9103
2481,強茂,103,50,53,群益金鼎-松山,2023-03-06,9103
00632R,元大台灣50反1,40,0,40,群益金鼎-松山,2023-03-06,9103
3105,穩懋,35,1,34,群益金鼎-松山,2023-03-06,9103
1783,和康生,34,0,34,群益金鼎-松山,2023-03-06,9103
5512,力麒,33,0,33,群益金鼎-松山,2023-03-06,9103
8222,寶一,61,30,31,群益金鼎-松山,2023-03-06,9103
00673R,期元大S＆P原油反1,30,0,30,群益金鼎-松山,2023-03-06,9103
2028,威致,30,0,30,群益金鼎-松山,2023-03-06,9103
2030,彰源,30,0,30,群益金鼎-松山,2023-03-06,9103
2457,飛宏,34,7,27,群益金鼎-松山,2023-03-06,9103
6122,擎邦,27,1,26,群益金鼎-松山,2023-03-06,9103
2609,陽明,26,1,25,群益金鼎-松山,2023-03-06,9103
2482,連宇,26,3,23,群益金鼎-松山,2023-03-06,9103
5203,訊連,22,0,22,群益金鼎-松山,2023-03-06,9103
6290,良維,20,0,20,群益金鼎-松山,2023-03-06,9103
1810,和成,22,3,19,群益金鼎-松山,2023-03-06,9103
2605,新興,19,0,19,群益金鼎-松山,2023-03-06,9103
4746,台耀,40,23,17,群益金鼎-松山,2023-03-06,9103
1708,東鹼,19,3,16,群益金鼎-松山,2023-03-06,9103
00885,富邦越南,15,0,15,群益金鼎-松山,2023-03-06,9103
1503,士電,21,6,15,群益金鼎-松山,2023-03-06,9103
6438,迅得,15,0,15,群益金鼎-松山,2023-03-06,9103
4919,新唐,15,1,14,群益金鼎-松山,2023-03-06,9103
2913,農林,13,0,13,群益金鼎-松山,2023-03-06,9103
2375,凱美,12,1,11,群益金鼎-松山,2023-03-06,9103
1308,亞聚,10,0,10,群益金鼎-松山,2023-03-06,9103
2722,夏都,10,0,10,群益金鼎-松山,2023-03-06,9103
2834,臺企銀,20,10,10,群益金鼎-松山,2023-03-06,9103
3027,盛達,10,0,10,群益金鼎-松山,2023-03-06,9103
6164,華興,10,0,10,群益金鼎-松山,2023-03-06,9103
8176,智捷,10,0,10,群益金鼎-松山,2023-03-06,9103
2201,裕隆,16,7,9,群益金鼎-松山,2023-03-06,9103
3272,東碩,10,1,9,群益金鼎-松山,2023-03-06,9103
0061,元大寶滬深,8,0,8,群益金鼎-松山,2023-03-06,9103
2612,中航,18,10,8,群益金鼎-松山,2023-03-06,9103
3005,神基,7,0,7,群益金鼎-松山,2023-03-06,9103
00680L,元大美債20正2,6,0,6,群益金鼎-松山,2023-03-06,9103
2618,長榮航,7,1,6,群益金鼎-松山,2023-03-06,9103
00633L,富邦上証正2,5,0,5,群益金鼎-松山,2023-03-06,9103
006206,元大上證50,5,0,5,群益金鼎-松山,2023-03-06,9103
2453,凌群,10,5,5,群益金鼎-松山,2023-03-06,9103
2465,麗臺,5,0,5,群益金鼎-松山,2023-03-06,9103
2543,皇昌,5,0,5,群益金鼎-松山,2023-03-06,9103
3558,神準,25,20,5,群益金鼎-松山,2023-03-06,9103
3594,磐儀,5,0,5,群益金鼎-松山,2023-03-06,9103
3661,世芯-KY,5,0,5,群益金鼎-松山,2023-03-06,9103
3481,群創,213,0,213,群益金鼎-松山,2023-03-07,9103
6133,金橋,117,2,115,群益金鼎-松山,2023-03-07,9103
00650L,復華香港正2,100,0,100,群益金鼎-松山,2023-03-07,9103
2618,長榮航,100,0,100,群益金鼎-松山,2023-03-07,9103
6116,彩晶,100,0,100,群益金鼎-松山,2023-03-07,9103
3029,零壹,74,1,73,群益金鼎-松山,2023-03-07,9103
5302,太欣,50,0,50,群益金鼎-松山,2023-03-07,9103
5347,世界,50,0,50,群益金鼎-松山,2023-03-07,9103
6122,擎邦,42,0,42,群益金鼎-松山,2023-03-07,9103
2485,兆赫,40,0,40,群益金鼎-松山,2023-03-07,9103
00670L,富邦NASDAQ正2,30,0,30,群益金鼎-松山,2023-03-07,9103
2736,富野,30,0,30,群益金鼎-松山,2023-03-07,9103
2884,玉山金,26,2,24,群益金鼎-松山,2023-03-07,9103
2457,飛宏,46,24,22,群益金鼎-松山,2023-03-07,9103
6140,訊達,20,0,20,群益金鼎-松山,2023-03-07,9103
1513,中興電,135,118,17,群益金鼎-松山,2023-03-07,9103
3362,先進光,149,132,17,群益金鼎-松山,2023-03-07,9103
2482,連宇,24,8,16,群益金鼎-松山,2023-03-07,9103
6164,華興,15,0,15,群益金鼎-松山,2023-03-07,9103
1783,和康生,12,0,12,群益金鼎-松山,2023-03-07,9103
2605,新興,12,0,12,群益金鼎-松山,2023-03-07,9103
3019,亞光,26,14,12,群益金鼎-松山,2023-03-07,9103
1795,美時,23,12,11,群益金鼎-松山,2023-03-07,9103
4915,致伸,11,0,11,群益金鼎-松山,2023-03-07,9103
6589,台康生技,11,0,11,群益金鼎-松山,2023-03-07,9103
4164,承業醫,20,10,10,群益金鼎-松山,2023-03-07,9103
6799,來頡,11,1,10,群益金鼎-松山,2023-03-07,9103
00830,國泰費城半導體,10,0,10,群益金鼎-松山,2023-03-07,9103
00676R,富邦臺灣加權反1,10,0,10,群益金鼎-松山,2023-03-07,9103
0056,元大高股息,10,0,10,群益金鼎-松山,2023-03-07,9103
2349,錸德,10,0,10,群益金鼎-松山,2023-03-07,9103
2453,凌群,20,10,10,群益金鼎-松山,2023-03-07,9103
2455,全新,10,0,10,群益金鼎-松山,2023-03-07,9103
2838,聯邦銀,10,0,10,群益金鼎-松山,2023-03-07,9103
3046,建��,10,0,10,群益金鼎-松山,2023-03-07,9103
3058,立德,10,0,10,群益金鼎-松山,2023-03-07,9103
3149,正達,10,0,10,群益金鼎-松山,2023-03-07,9103
3528,安馳,10,0,10,群益金鼎-松山,2023-03-07,9103
5009,榮剛,14,4,10,群益金鼎-松山,2023-03-07,9103
5203,訊連,10,0,10,群益金鼎-松山,2023-03-07,9103
00885,富邦越南,8,0,8,群益金鼎-松山,2023-03-07,9103
6213,聯茂,8,0,8,群益金鼎-松山,2023-03-07,9103
2313,華通,8,1,7,群益金鼎-松山,2023-03-07,9103
2380,虹光,7,0,7,群益金鼎-松山,2023-03-07,9103
2492,華新科,10,3,7,群益金鼎-松山,2023-03-07,9103
6443,元晶,10,3,7,群益金鼎-松山,2023-03-07,9103
2748,雲品,11,5,6,群益金鼎-松山,2023-03-07,9103
8289,泰藝,6,0,6,群益金鼎-松山,2023-03-07,9103
00633L,富邦上証正2,5,0,5,群益金鼎-松山,2023-03-07,9103
0061,元大寶滬深,5,0,5,群益金鼎-松山,2023-03-07,9103
00669R,國泰美國道瓊反1,500,0,500,群益金鼎-松山,2023-03-08,9103
4967,十銓,124,1,123,群益金鼎-松山,2023-03-08,9103
2409,友達,101,0,101,群益金鼎-松山,2023-03-08,9103
1504,東元,100,0,100,群益金鼎-松山,2023-03-08,9103
00674R,期元大S＆P黃金反1,100,0,100,群益金鼎-松山,2023-03-08,9103
1762,中化生,116,16,100,群益金鼎-松山,2023-03-08,9103
3029,零壹,64,1,63,群益金鼎-松山,2023-03-08,9103
1524,耿鼎,54,0,54,群益金鼎-松山,2023-03-08,9103
2457,飛宏,153,111,42,群益金鼎-松山,2023-03-08,9103
00637L,元大滬深300正2,50,11,39,群益金鼎-松山,2023-03-08,9103
4541,晟田,35,0,35,群益金鼎-松山,2023-03-08,9103
1519,華城,54,22,32,群益金鼎-松山,2023-03-08,9103
2369,菱生,30,0,30,群益金鼎-松山,2023-03-08,9103
8085,福華,30,0,30,群益金鼎-松山,2023-03-08,9103
8087,麗升能源,30,0,30,群益金鼎-松山,2023-03-08,9103
2413,環科,29,1,28,群益金鼎-松山,2023-03-08,9103
2305,全友,23,0,23,群益金鼎-松山,2023-03-08,9103
2328,廣宇,20,0,20,群益金鼎-松山,2023-03-08,9103
2476,鉅祥,20,0,20,群益金鼎-松山,2023-03-08,9103
3675,德微,21,1,20,群益金鼎-松山,2023-03-08,9103
6118,建達,20,0,20,群益金鼎-松山,2023-03-08,9103
6751,智聯服務,20,0,20,群益金鼎-松山,2023-03-08,9103
8222,寶一,30,10,20,群益金鼎-松山,2023-03-08,9103
8940,新天地,20,0,20,群益金鼎-松山,2023-03-08,9103
3704,合勤控,20,0,20,群益金鼎-松山,2023-03-08,9103
2408,南亞科,20,2,18,群益金鼎-松山,2023-03-08,9103
2610,華航,20,2,18,群益金鼎-松山,2023-03-08,9103
2201,裕隆,24,7,17,群益金鼎-松山,2023-03-08,9103
8033,雷虎,20,4,16,群益金鼎-松山,2023-03-08,9103
00753L,中信中國50正2,15,0,15,群益金鼎-松山,2023-03-08,9103
2634,漢翔,46,32,14,群益金鼎-松山,2023-03-08,9103
6129,普誠,23,9,14,群益金鼎-松山,2023-03-08,9103
1605,華新,23,10,13,群益金鼎-松山,2023-03-08,9103
00706L,期元大S＆P日圓正2,13,0,13,群益金鼎-松山,2023-03-08,9103
5425,台半,15,2,13,群益金鼎-松山,2023-03-08,9103
8099,大世科,13,0,13,群益金鼎-松山,2023-03-08,9103
1101,台泥,12,0,12,群益金鼎-松山,2023-03-08,9103
2885,元大金,12,0,12,群益金鼎-松山,2023-03-08,9103
3558,神準,59,47,12,群益金鼎-松山,2023-03-08,9103
4736,泰博,12,0,12,群益金鼎-松山,2023-03-08,9103
2368,金像電,11,0,11,群益金鼎-松山,2023-03-08,9103
2454,聯發科,11,0,11,群益金鼎-松山,2023-03-08,9103
6799,來頡,14,3,11,群益金鼎-松山,2023-03-08,9103
00633L,富邦上証正2,10,0,10,群益金鼎-松山,2023-03-08,9103
1440,南紡,10,0,10,群益金鼎-松山,2023-03-08,9103
1609,大亞,15,5,10,群益金鼎-松山,2023-03-08,9103
1752,南光,10,0,10,群益金鼎-松山,2023-03-08,9103
2405,輔信,10,0,10,群益金鼎-松山,2023-03-08,9103
2485,兆赫,10,0,10,群益金鼎-松山,2023-03-08,9103
3027,盛達,10,0,10,群益金鼎-松山,2023-03-08,9103
1513,中興電,212,1,211,群益金鼎-松山,2023-03-09,9103
8112,至上,208,0,208,群益金鼎-松山,2023-03-09,9103
2344,華邦電,203,0,203,群益金鼎-松山,2023-03-09,9103
9105,泰金寶-DR,500,300,200,群益金鼎-松山,2023-03-09,9103
9103,美德醫療-DR,121,0,121,群益金鼎-松山,2023-03-09,9103
9110,越南控-DR,63,0,63,群益金鼎-松山,2023-03-09,9103
6290,良維,64,7,57,群益金鼎-松山,2023-03-09,9103
5347,世界,54,0,54,群益金鼎-松山,2023-03-09,9103
2359,所羅門,54,9,45,群益金鼎-松山,2023-03-09,9103
1605,華新,57,14,43,群益金鼎-松山,2023-03-09,9103
1432,大魯閣,40,1,39,群益金鼎-松山,2023-03-09,9103
1314,中石化,38,0,38,群益金鼎-松山,2023-03-09,9103
4746,台耀,37,1,36,群益金鼎-松山,2023-03-09,9103
2388,威盛,43,9,34,群益金鼎-松山,2023-03-09,9103
5512,力麒,34,0,34,群益金鼎-松山,2023-03-09,9103
3290,東浦,42,11,31,群益金鼎-松山,2023-03-09,9103
6164,華興,30,0,30,群益金鼎-松山,2023-03-09,9103
6122,擎邦,27,0,27,群益金鼎-松山,2023-03-09,9103
2476,鉅祥,44,20,24,群益金鼎-松山,2023-03-09,9103
3712,永崴投控,25,2,23,群益金鼎-松山,2023-03-09,9103
1762,中化生,21,0,21,群益金鼎-松山,2023-03-09,9103
2485,兆赫,20,0,20,群益金鼎-松山,2023-03-09,9103
2498,宏達電,45,25,20,群益金鼎-松山,2023-03-09,9103
5608,四維航,20,0,20,群益金鼎-松山,2023-03-09,9103
2634,漢翔,65,46,19,群益金鼎-松山,2023-03-09,9103
8936,國統,18,0,18,群益金鼎-松山,2023-03-09,9103
6139,亞翔,20,3,17,群益金鼎-松山,2023-03-09,9103
6531,愛普*,19,3,16,群益金鼎-松山,2023-03-09,9103
2609,陽明,15,0,15,群益金鼎-松山,2023-03-09,9103
6547,高端疫苗,14,0,14,群益金鼎-松山,2023-03-09,9103
2482,連宇,30,17,13,群益金鼎-松山,2023-03-09,9103
3066,李洲,40,29,11,群益金鼎-松山,2023-03-09,9103
6231,系微,12,1,11,群益金鼎-松山,2023-03-09,9103
1531,高林股,10,0,10,群益金鼎-松山,2023-03-09,9103
2014,中鴻,10,0,10,群益金鼎-松山,2023-03-09,9103
2722,夏都,10,0,10,群益金鼎-松山,2023-03-09,9103
2884,玉山金,10,0,10,群益金鼎-松山,2023-03-09,9103
2890,永豐金,10,0,10,群益金鼎-松山,2023-03-09,9103
3022,威強電,20,10,10,群益金鼎-松山,2023-03-09,9103
3035,智原,16,6,10,群益金鼎-松山,2023-03-09,9103
3508,位速,10,0,10,群益金鼎-松山,2023-03-09,9103
6841,長佳智能,11,1,10,群益金鼎-松山,2023-03-09,9103
9933,中鼎,10,0,10,群益金鼎-松山,2023-03-09,9103
1795,美時,9,0,9,群益金鼎-松山,2023-03-09,9103
1524,耿鼎,9,0,9,群益金鼎-松山,2023-03-09,9103
2317,鴻海,9,0,9,群益金鼎-松山,2023-03-09,9103
4142,國光生,11,2,9,群益金鼎-松山,2023-03-09,9103
6189,豐藝,9,0,9,群益金鼎-松山,2023-03-09,9103
2352,佳世達,8,0,8,群益金鼎-松山,2023-03-09,9103
6129,普誠,10,2,8,群益金鼎-松山,2023-03-09,9103
5347,世界,87,0,87,群益金鼎-松山,2023-03-10,9103
2882,國泰金,47,0,47,群益金鼎-松山,2023-03-10,9103
2610,華航,50,15,35,群益金鼎-松山,2023-03-10,9103
1584,精剛,36,5,31,群益金鼎-松山,2023-03-10,9103
6164,華興,30,0,30,群益金鼎-松山,2023-03-10,9103
6719,力智,123,99,24,群益金鼎-松山,2023-03-10,9103
2881,富邦金,23,0,23,群益金鼎-松山,2023-03-10,9103
2884,玉山金,23,0,23,群益金鼎-松山,2023-03-10,9103
3163,波若威,22,0,22,群益金鼎-松山,2023-03-10,9103
00713,元大台灣高息低波,21,0,21,群益金鼎-松山,2023-03-10,9103
1321,大洋,20,0,20,群益金鼎-松山,2023-03-10,9103
2889,國票金,20,0,20,群益金鼎-松山,2023-03-10,9103
3011,今皓,20,0,20,群益金鼎-松山,2023-03-10,9103
8176,智捷,20,0,20,群益金鼎-松山,2023-03-10,9103
5425,台半,19,1,18,群益金鼎-松山,2023-03-10,9103
6664,群翊,17,0,17,群益金鼎-松山,2023-03-10,9103
2371,大同,16,0,16,群益金鼎-松山,2023-03-10,9103
3027,盛達,66,50,16,群益金鼎-松山,2023-03-10,9103
2312,金寶,15,0,15,群益金鼎-松山,2023-03-10,9103
00923,群益台ESG低碳50,16,2,14,群益金鼎-松山,2023-03-10,9103
2303,聯電,13,1,12,群益金鼎-松山,2023-03-10,9103
6548,長科*,12,0,12,群益金鼎-松山,2023-03-10,9103
8033,雷虎,24,12,12,群益金鼎-松山,2023-03-10,9103
2497,怡利電,13,2,11,群益金鼎-松山,2023-03-10,9103
2330,台積電,10,0,10,群益金鼎-松山,2023-03-10,9103
1736,喬山,10,0,10,群益金鼎-松山,2023-03-10,9103
2317,鴻海,10,0,10,群益金鼎-松山,2023-03-10,9103
2641,正德,10,0,10,群益金鼎-松山,2023-03-10,9103
3022,威強電,15,5,10,群益金鼎-松山,2023-03-10,9103
5203,訊連,10,0,10,群益金鼎-松山,2023-03-10,9103
5609,中菲行,10,0,10,群益金鼎-松山,2023-03-10,9103
6799,來頡,11,1,10,群益金鼎-松山,2023-03-10,9103
9933,中鼎,10,0,10,群益金鼎-松山,2023-03-10,9103
00878,國泰永續高股息,9,0,9,群益金鼎-松山,2023-03-10,9103
1760,寶齡富錦,12,3,9,群益金鼎-松山,2023-03-10,9103
2449,京元電子,9,0,9,群益金鼎-松山,2023-03-10,9103
2615,萬海,11,2,9,群益金鼎-松山,2023-03-10,9103
6509,聚和,10,1,9,群益金鼎-松山,2023-03-10,9103
1605,華新,20,12,8,群益金鼎-松山,2023-03-10,9103
1711,永光,8,0,8,群益金鼎-松山,2023-03-10,9103
2457,飛宏,62,54,8,群益金鼎-松山,2023-03-10,9103
3675,德微,8,0,8,群益金鼎-松山,2023-03-10,9103
4551,智伸科,8,0,8,群益金鼎-松山,2023-03-10,9103
00712,復華富時不動產,7,0,7,群益金鼎-松山,2023-03-10,9103
2002,中鋼,11,4,7,群益金鼎-松山,2023-03-10,9103
2201,裕隆,7,1,6,群益金鼎-松山,2023-03-10,9103
1524,耿鼎,60,54,6,群益金鼎-松山,2023-03-10,9103
2375,凱美,7,1,6,群益金鼎-松山,2023-03-10,9103
2618,長榮航,7,1,6,群益金鼎-松山,2023-03-10,9103
3013,晟銘電,6,0,6,群益金鼎-松山,2023-03-10,9103
00632R,元大台灣50反1,230,75,155,群益金鼎-松山,2023-03-13,9103
3481,群創,311,201,110,群益金鼎-松山,2023-03-13,9103
6719,力智,71,1,70,群益金鼎-松山,2023-03-13,9103
6235,華孚,132,66,66,群益金鼎-松山,2023-03-13,9103
6248,沛波,60,0,60,群益金鼎-松山,2023-03-13,9103
00708L,期元大S＆P黃金正2,50,0,50,群益金鼎-松山,2023-03-13,9103
1314,中石化,50,0,50,群益金鼎-松山,2023-03-13,9103
4967,十銓,50,1,49,群益金鼎-松山,2023-03-13,9103
5347,世界,40,0,40,群益金鼎-松山,2023-03-13,9103
4746,台耀,34,0,34,群益金鼎-松山,2023-03-13,9103
3029,零壹,32,0,32,群益金鼎-松山,2023-03-13,9103
8349,�矬�,32,0,32,群益金鼎-松山,2023-03-13,9103
6164,華興,30,0,30,群益金鼎-松山,2023-03-13,9103
00878,國泰永續高股息,28,0,28,群益金鼎-松山,2023-03-13,9103
6231,系微,23,0,23,群益金鼎-松山,2023-03-13,9103
8940,新天地,20,0,20,群益金鼎-松山,2023-03-13,9103
2357,華碩,20,1,19,群益金鼎-松山,2023-03-13,9103
1504,東元,70,52,18,群益金鼎-松山,2023-03-13,9103
2457,飛宏,91,77,14,群益金鼎-松山,2023-03-13,9103
00882,中信中國高股息,12,0,12,群益金鼎-松山,2023-03-13,9103
6257,矽格,11,0,11,群益金鼎-松山,2023-03-13,9103
1605,華新,17,7,10,群益金鼎-松山,2023-03-13,9103
2606,裕民,10,0,10,群益金鼎-松山,2023-03-13,9103
2610,華航,10,0,10,群益金鼎-松山,2023-03-13,9103
2882,國泰金,10,0,10,群益金鼎-松山,2023-03-13,9103
6205,詮欣,10,0,10,群益金鼎-松山,2023-03-13,9103
1319,東陽,8,1,7,群益金鼎-松山,2023-03-13,9103
2344,華邦電,7,1,6,群益金鼎-松山,2023-03-13,9103
2405,輔信,6,0,6,群益金鼎-松山,2023-03-13,9103
2881,富邦金,6,0,6,群益金鼎-松山,2023-03-13,9103
6664,群翊,6,0,6,群益金鼎-松山,2023-03-13,9103
1591,駿吉-KY,5,0,5,群益金鼎-松山,2023-03-13,9103
1712,興農,5,0,5,群益金鼎-松山,2023-03-13,9103
00713,元大台灣高息低波,5,0,5,群益金鼎-松山,2023-03-13,9103
2208,台船,5,0,5,群益金鼎-松山,2023-03-13,9103
2302,麗正,5,0,5,群益金鼎-松山,2023-03-13,9103
2615,萬海,5,0,5,群益金鼎-松山,2023-03-13,9103
2754,亞洲藏壽司,5,0,5,群益金鼎-松山,2023-03-13,9103
5321,美而快,5,0,5,群益金鼎-松山,2023-03-13,9103
6245,立端,5,0,5,群益金鼎-松山,2023-03-13,9103
6470,宇智,5,0,5,群益金鼎-松山,2023-03-13,9103
6548,長科*,5,0,5,群益金鼎-松山,2023-03-13,9103
8105,凌巨,22,17,5,群益金鼎-松山,2023-03-13,9103
9945,潤泰新,5,0,5,群益金鼎-松山,2023-03-13,9103
6213,聯茂,9,5,4,群益金鼎-松山,2023-03-13,9103
00751B,元大AAA至A公司債,4,0,4,群益金鼎-松山,2023-03-13,9103
1795,美時,6,2,4,群益金鼎-松山,2023-03-13,9103
2312,金寶,4,0,4,群益金鼎-松山,2023-03-13,9103
2453,凌群,26,22,4,群益金鼎-松山,2023-03-13,9103
2884,玉山金,6,2,4,群益金鼎-松山,2023-03-13,9103
6133,金橋,201,32,169,群益金鼎-松山,2023-03-14,9103
2884,玉山金,123,10,113,群益金鼎-松山,2023-03-14,9103
3162,精確,99,32,67,群益金鼎-松山,2023-03-14,9103
2603,長榮,172,108,64,群益金鼎-松山,2023-03-14,9103
00878,國泰永續高股息,39,3,36,群益金鼎-松山,2023-03-14,9103
2618,長榮航,31,1,30,群益金鼎-松山,2023-03-14,9103
6164,華興,30,0,30,群益金鼎-松山,2023-03-14,9103
2359,所羅門,22,0,22,群益金鼎-松山,2023-03-14,9103
2883,凱基金,21,0,21,群益金鼎-松山,2023-03-14,9103
00773B,中信優先金融債,20,0,20,群益金鼎-松山,2023-03-14,9103
2888,新光金,20,0,20,群益金鼎-松山,2023-03-14,9103
2303,聯電,19,0,19,群益金鼎-松山,2023-03-14,9103
6282,康舒,19,2,17,群益金鼎-松山,2023-03-14,9103
2880,華南金,15,0,15,群益金鼎-松山,2023-03-14,9103
2376,技嘉,14,0,14,群益金鼎-松山,2023-03-14,9103
2889,國票金,14,0,14,群益金鼎-松山,2023-03-14,9103
6770,力積電,14,0,14,群益金鼎-松山,2023-03-14,9103
2892,第一金,13,0,13,群益金鼎-松山,2023-03-14,9103
00720B,元大投資級公司債,12,0,12,群益金鼎-松山,2023-03-14,9103
5371,中光電,12,0,12,群益金鼎-松山,2023-03-14,9103
2881,富邦金,11,0,11,群益金鼎-松山,2023-03-14,9103
2891,中信金,11,0,11,群益金鼎-松山,2023-03-14,9103
1440,南紡,10,0,10,群益金鼎-松山,2023-03-14,9103
1560,中砂,10,0,10,群益金鼎-松山,2023-03-14,9103
1810,和成,10,0,10,群益金鼎-松山,2023-03-14,9103
2028,威致,10,0,10,群益金鼎-松山,2023-03-14,9103
2302,麗正,10,0,10,群益金鼎-松山,2023-03-14,9103
2324,仁寶,10,0,10,群益金鼎-松山,2023-03-14,9103
2606,裕民,20,10,10,群益金鼎-松山,2023-03-14,9103
2637,慧洋-KY,12,2,10,群益金鼎-松山,2023-03-14,9103
3078,僑威,10,0,10,群益金鼎-松山,2023-03-14,9103
5608,四維航,20,10,10,群益金鼎-松山,2023-03-14,9103
5703,亞都,10,0,10,群益金鼎-松山,2023-03-14,9103
6150,撼訊,10,0,10,群益金鼎-松山,2023-03-14,9103
6213,聯茂,10,0,10,群益金鼎-松山,2023-03-14,9103
8033,雷虎,10,0,10,群益金鼎-松山,2023-03-14,9103
8349,�矬�,11,1,10,群益金鼎-松山,2023-03-14,9103
4164,承業醫,10,0,10,群益金鼎-松山,2023-03-14,9103
8222,寶一,11,2,9,群益金鼎-松山,2023-03-14,9103
2610,華航,10,2,8,群益金鼎-松山,2023-03-14,9103
2645,長榮航太,8,0,8,群益金鼎-松山,2023-03-14,9103
6548,長科*,8,0,8,群益金鼎-松山,2023-03-14,9103
1504,東元,8,1,7,群益金鼎-松山,2023-03-14,9103
00885,富邦越南,7,0,7,群益金鼎-松山,2023-03-14,9103
3011,今皓,6,0,6,群益金鼎-松山,2023-03-14,9103
00882,中信中國高股息,5,0,5,群益金鼎-松山,2023-03-14,9103
2852,第一保,5,0,5,群益金鼎-松山,2023-03-14,9103
3022,威強電,5,0,5,群益金鼎-松山,2023-03-14,9103
6138,茂達,5,0,5,群益金鼎-松山,2023-03-14,9103
6411,晶焱,5,0,5,群益金鼎-松山,2023-03-14,9103
3481,群創,301,20,281,群益金鼎-松山,2023-03-15,9103
00632R,元大台灣50反1,230,100,130,群益金鼎-松山,2023-03-15,9103
00885,富邦越南,100,0,100,群益金鼎-松山,2023-03-15,9103
00915,凱基優選高股息30,50,0,50,群益金鼎-松山,2023-03-15,9103
2605,新興,74,34,40,群益金鼎-松山,2023-03-15,9103
2014,中鴻,32,0,32,群益金鼎-松山,2023-03-15,9103
6271,同欣電,155,123,32,群益金鼎-松山,2023-03-15,9103
2017,官田鋼,30,0,30,群益金鼎-松山,2023-03-15,9103
5450,南良,30,0,30,群益金鼎-松山,2023-03-15,9103
5608,四維航,60,30,30,群益金鼎-松山,2023-03-15,9103
6531,愛普*,30,6,24,群益金鼎-松山,2023-03-15,9103
3576,聯合再生,27,3,24,群益金鼎-松山,2023-03-15,9103
2453,凌群,21,0,21,群益金鼎-松山,2023-03-15,9103
2634,漢翔,21,0,21,群益金鼎-松山,2023-03-15,9103
2891,中信金,18,0,18,群益金鼎-松山,2023-03-15,9103
2201,裕隆,23,8,15,群益金鼎-松山,2023-03-15,9103
4746,台耀,14,0,14,群益金鼎-松山,2023-03-15,9103
4967,十銓,15,1,14,群益金鼎-松山,2023-03-15,9103
8409,商之器,13,0,13,群益金鼎-松山,2023-03-15,9103
6190,萬泰科,14,2,12,群益金鼎-松山,2023-03-15,9103
00878,國泰永續高股息,13,2,11,群益金鼎-松山,2023-03-15,9103
6235,華孚,32,21,11,群益金鼎-松山,2023-03-15,9103
9933,中鼎,11,0,11,群益金鼎-松山,2023-03-15,9103
2359,所羅門,32,22,10,群益金鼎-松山,2023-03-15,9103
1609,大亞,10,0,10,群益金鼎-松山,2023-03-15,9103
1321,大洋,10,0,10,群益金鼎-松山,2023-03-15,9103
1417,嘉裕,10,0,10,群益金鼎-松山,2023-03-15,9103
00773B,中信優先金融債,10,0,10,群益金鼎-松山,2023-03-15,9103
2615,萬海,14,4,10,群益金鼎-松山,2023-03-15,9103
5347,世界,10,0,10,群益金鼎-松山,2023-03-15,9103
6248,沛波,10,0,10,群益金鼎-松山,2023-03-15,9103
9938,百和,10,0,10,群益金鼎-松山,2023-03-15,9103
2388,威盛,32,23,9,群益金鼎-松山,2023-03-15,9103
2027,大成鋼,7,0,7,群益金鼎-松山,2023-03-15,9103
00679B,元大美債20年,6,0,6,群益金鼎-松山,2023-03-15,9103
2881,富邦金,6,0,6,群益金鼎-松山,2023-03-15,9103
6533,晶心科,6,0,6,群益金鼎-松山,2023-03-15,9103
2614,東森,6,1,5,群益金鼎-松山,2023-03-15,9103
00720B,元大投資級公司債,5,0,5,群益金鼎-松山,2023-03-15,9103
00923,群益台ESG低碳50,5,0,5,群益金鼎-松山,2023-03-15,9103
2208,台船,5,0,5,群益金鼎-松山,2023-03-15,9103
2312,金寶,5,0,5,群益金鼎-松山,2023-03-15,9103
2886,兆豐金,5,0,5,群益金鼎-松山,2023-03-15,9103
3013,晟銘電,5,0,5,群益金鼎-松山,2023-03-15,9103
3078,僑威,5,0,5,群益金鼎-松山,2023-03-15,9103
4931,新盛力,5,0,5,群益金鼎-松山,2023-03-15,9103
6446,藥華藥,5,0,5,群益金鼎-松山,2023-03-15,9103
8050,廣積,5,0,5,群益金鼎-松山,2023-03-15,9103
5880,合庫金,5,1,4,群益金鼎-松山,2023-03-15,9103
1504,東元,11,7,4,群益金鼎-松山,2023-03-15,9103
1513,中興電,225,10,215,群益金鼎-松山,2023-03-16,9103
1762,中化生,69,0,69,群益金鼎-松山,2023-03-16,9103
00715L,期街口布蘭特正2,50,0,50,群益金鼎-松山,2023-03-16,9103
3046,建��,50,0,50,群益金鼎-松山,2023-03-16,9103
3673,TPK-KY,50,0,50,群益金鼎-松山,2023-03-16,9103
5347,世界,40,0,40,群益金鼎-松山,2023-03-16,9103
2884,玉山金,34,0,34,群益金鼎-松山,2023-03-16,9103
9103,美德醫療-DR,33,0,33,群益金鼎-松山,2023-03-16,9103
8349,�矬�,30,0,30,群益金鼎-松山,2023-03-16,9103
8409,商之器,29,0,29,群益金鼎-松山,2023-03-16,9103
2891,中信金,24,0,24,群益金鼎-松山,2023-03-16,9103
2453,凌群,31,10,21,群益金鼎-松山,2023-03-16,9103
4541,晟田,20,0,20,群益金鼎-松山,2023-03-16,9103
4934,太極,20,0,20,群益金鼎-松山,2023-03-16,9103
2834,臺企銀,19,0,19,群益金鼎-松山,2023-03-16,9103
3624,光頡,17,1,16,群益金鼎-松山,2023-03-16,9103
6143,振曜,48,32,16,群益金鼎-松山,2023-03-16,9103
6290,良維,17,1,16,群益金鼎-松山,2023-03-16,9103
2618,長榮航,14,0,14,群益金鼎-松山,2023-03-16,9103
00878,國泰永續高股息,13,0,13,群益金鼎-松山,2023-03-16,9103
00713,元大台灣高息低波,13,0,13,群益金鼎-松山,2023-03-16,9103
2637,慧洋-KY,14,2,12,群益金鼎-松山,2023-03-16,9103
1519,華城,11,1,10,群益金鼎-松山,2023-03-16,9103
1503,士電,10,0,10,群益金鼎-松山,2023-03-16,9103
2405,輔信,10,0,10,群益金鼎-松山,2023-03-16,9103
5425,台半,16,6,10,群益金鼎-松山,2023-03-16,9103
6109,亞元,10,0,10,群益金鼎-松山,2023-03-16,9103
6121,新普,9,0,9,群益金鼎-松山,2023-03-16,9103
2317,鴻海,10,2,8,群益金鼎-松山,2023-03-16,9103
2548,華固,8,0,8,群益金鼎-松山,2023-03-16,9103
2880,華南金,8,0,8,群益金鼎-松山,2023-03-16,9103
3664,安瑞-KY,8,0,8,群益金鼎-松山,2023-03-16,9103
6235,華孚,14,6,8,群益金鼎-松山,2023-03-16,9103
6768,志強-KY,7,0,7,群益金鼎-松山,2023-03-16,9103
8183,精星,7,0,7,群益金鼎-松山,2023-03-16,9103
2603,長榮,9,2,7,群益金鼎-松山,2023-03-16,9103
1560,中砂,7,1,6,群益金鼎-松山,2023-03-16,9103
2027,大成鋼,6,0,6,群益金鼎-松山,2023-03-16,9103
2883,凱基金,7,1,6,群益金鼎-松山,2023-03-16,9103
8046,南電,20,14,6,群益金鼎-松山,2023-03-16,9103
1609,大亞,5,0,5,群益金鼎-松山,2023-03-16,9103
1321,大洋,5,0,5,群益金鼎-松山,2023-03-16,9103
2002,中鋼,5,0,5,群益金鼎-松山,2023-03-16,9103
2465,麗臺,5,0,5,群益金鼎-松山,2023-03-16,9103
2888,新光金,5,0,5,群益金鼎-松山,2023-03-16,9103
3675,德微,6,1,5,群益金鼎-松山,2023-03-16,9103
4931,新盛力,5,0,5,群益金鼎-松山,2023-03-16,9103
5876,上海商銀,5,0,5,群益金鼎-松山,2023-03-16,9103
6122,擎邦,5,0,5,群益金鼎-松山,2023-03-16,9103
6223,旺矽,5,0,5,群益金鼎-松山,2023-03-16,9103
2344,華邦電,200,3,197,群益金鼎-松山,2023-03-17,9103
6116,彩晶,102,0,102,群益金鼎-松山,2023-03-17,9103
2409,友達,100,0,100,群益金鼎-松山,2023-03-17,9103
3481,群創,200,110,90,群益金鼎-松山,2023-03-17,9103
6244,茂迪,98,27,71,群益金鼎-松山,2023-03-17,9103
1762,中化生,57,0,57,群益金鼎-松山,2023-03-17,9103
3011,今皓,57,0,57,群益金鼎-松山,2023-03-17,9103
4967,十銓,50,4,46,群益金鼎-松山,2023-03-17,9103
00632R,元大台灣50反1,55,10,45,群益金鼎-松山,2023-03-17,9103
6235,華孚,63,22,41,群益金鼎-松山,2023-03-17,9103
3479,安勤,40,0,40,群益金鼎-松山,2023-03-17,9103
1432,大魯閣,30,0,30,群益金鼎-松山,2023-03-17,9103
2028,威致,28,0,28,群益金鼎-松山,2023-03-17,9103
00679B,元大美債20年,31,7,24,群益金鼎-松山,2023-03-17,9103
3362,先進光,30,7,23,群益金鼎-松山,2023-03-17,9103
3029,零壹,23,1,22,群益金鼎-松山,2023-03-17,9103
1609,大亞,20,0,20,群益金鼎-松山,2023-03-17,9103
2495,普安,20,0,20,群益金鼎-松山,2023-03-17,9103
2867,三商壽,20,0,20,群益金鼎-松山,2023-03-17,9103
3712,永崴投控,20,0,20,群益金鼎-松山,2023-03-17,9103
2457,飛宏,61,42,19,群益金鼎-松山,2023-03-17,9103
8222,寶一,21,3,18,群益金鼎-松山,2023-03-17,9103
8433,弘帆,18,0,18,群益金鼎-松山,2023-03-17,9103
2892,第一金,15,0,15,群益金鼎-松山,2023-03-17,9103
3441,聯一光,15,0,15,群益金鼎-松山,2023-03-17,9103
2482,連宇,28,16,12,群益金鼎-松山,2023-03-17,9103
2645,長榮航太,12,0,12,群益金鼎-松山,2023-03-17,9103
00670L,富邦NASDAQ正2,11,0,11,群益金鼎-松山,2023-03-17,9103
2886,兆豐金,11,0,11,群益金鼎-松山,2023-03-17,9103
2614,東森,10,0,10,群益金鼎-松山,2023-03-17,9103
1417,嘉裕,10,0,10,群益金鼎-松山,2023-03-17,9103
00830,國泰費城半導體,10,0,10,群益金鼎-松山,2023-03-17,9103
8033,雷虎,15,6,9,群益金鼎-松山,2023-03-17,9103
3035,智原,36,28,8,群益金鼎-松山,2023-03-17,9103
3402,漢科,8,0,8,群益金鼎-松山,2023-03-17,9103
8155,博智,11,4,7,群益金鼎-松山,2023-03-17,9103
8349,�矬�,14,7,7,群益金鼎-松山,2023-03-17,9103
5512,力麒,6,0,6,群益金鼎-松山,2023-03-17,9103
9921,巨大,6,0,6,群益金鼎-松山,2023-03-17,9103
2739,寒舍,5,0,5,群益金鼎-松山,2023-03-17,9103
3163,波若威,5,0,5,群益金鼎-松山,2023-03-17,9103
2338,光罩,6,2,4,群益金鼎-松山,2023-03-17,9103
2497,怡利電,4,0,4,群益金鼎-松山,2023-03-17,9103
2548,華固,4,0,4,群益金鼎-松山,2023-03-17,9103
2884,玉山金,4,0,4,群益金鼎-松山,2023-03-17,9103
3022,威強電,5,1,4,群益金鼎-松山,2023-03-17,9103
6792,詠業,4,0,4,群益金鼎-松山,2023-03-17,9103
9904,寶成,4,0,4,群益金鼎-松山,2023-03-17,9103
00706L,期元大S＆P日圓正2,3,0,3,群益金鼎-松山,2023-03-17,9103
1101,台泥,3,0,3,群益金鼎-松山,2023-03-17,9103
6443,元晶,344,3,341,群益金鼎-松山,2023-03-20,9103
1519,華城,83,31,52,群益金鼎-松山,2023-03-20,9103
6477,安集,51,0,51,群益金鼎-松山,2023-03-20,9103
3029,零壹,37,0,37,群益金鼎-松山,2023-03-20,9103
1514,亞力,127,91,36,群益金鼎-松山,2023-03-20,9103
3046,建��,36,1,35,群益金鼎-松山,2023-03-20,9103
2359,所羅門,33,0,33,群益金鼎-松山,2023-03-20,9103
8940,新天地,32,0,32,群益金鼎-松山,2023-03-20,9103
1605,華新,31,0,31,群益金鼎-松山,2023-03-20,9103
1589,永冠-KY,30,0,30,群益金鼎-松山,2023-03-20,9103
2338,光罩,35,6,29,群益金鼎-松山,2023-03-20,9103
2457,飛宏,40,11,29,群益金鼎-松山,2023-03-20,9103
3011,今皓,23,1,22,群益金鼎-松山,2023-03-20,9103
4551,智伸科,22,0,22,群益金鼎-松山,2023-03-20,9103
6799,來頡,25,5,20,群益金鼎-松山,2023-03-20,9103
3362,先進光,22,5,17,群益金鼎-松山,2023-03-20,9103
00715L,期街口布蘭特正2,16,0,16,群益金鼎-松山,2023-03-20,9103
00632R,元大台灣50反1,20,5,15,群益金鼎-松山,2023-03-20,9103
2388,威盛,12,1,11,群益金鼎-松山,2023-03-20,9103
2542,興富發,11,0,11,群益金鼎-松山,2023-03-20,9103
8028,昇陽半導體,11,0,11,群益金鼎-松山,2023-03-20,9103
8222,寶一,33,22,11,群益金鼎-松山,2023-03-20,9103
2330,台積電,10,0,10,群益金鼎-松山,2023-03-20,9103
00909,國泰數位支付服務,10,0,10,群益金鼎-松山,2023-03-20,9103
2324,仁寶,10,0,10,群益金鼎-松山,2023-03-20,9103
2617,台航,10,0,10,群益金鼎-松山,2023-03-20,9103
2838,聯邦銀,10,0,10,群益金鼎-松山,2023-03-20,9103
6235,華孚,93,83,10,群益金鼎-松山,2023-03-20,9103
6517,保勝光學,10,0,10,群益金鼎-松山,2023-03-20,9103
8016,矽創,10,0,10,群益金鼎-松山,2023-03-20,9103
1529,樂事綠能,11,2,9,群益金鼎-松山,2023-03-20,9103
5289,宜鼎,12,4,8,群益金鼎-松山,2023-03-20,9103
6706,惠特,10,2,8,群益金鼎-松山,2023-03-20,9103
6190,萬泰科,7,0,7,群益金鼎-松山,2023-03-20,9103
6752,叡揚,6,0,6,群益金鼎-松山,2023-03-20,9103
00665L,富邦�琤肭磪囓�2,5,0,5,群益金鼎-松山,2023-03-20,9103
2618,長榮航,5,0,5,群益金鼎-松山,2023-03-20,9103
6205,詮欣,10,5,5,群益金鼎-松山,2023-03-20,9103
00885,富邦越南,4,0,4,群益金鼎-松山,2023-03-20,9103
2471,資通,7,3,4,群益金鼎-松山,2023-03-20,9103
2891,中信金,4,0,4,群益金鼎-松山,2023-03-20,9103
3005,神基,4,0,4,群益金鼎-松山,2023-03-20,9103
3596,智易,4,0,4,群益金鼎-松山,2023-03-20,9103
4107,邦特,4,0,4,群益金鼎-松山,2023-03-20,9103
6712,長聖,4,0,4,群益金鼎-松山,2023-03-20,9103
6770,力積電,4,0,4,群益金鼎-松山,2023-03-20,9103
1218,泰山,3,0,3,群益金鼎-松山,2023-03-20,9103
1101,台泥,3,0,3,群益金鼎-松山,2023-03-20,9103
2427,三商電,3,0,3,群益金鼎-松山,2023-03-20,9103
2915,潤泰全,3,0,3,群益金鼎-松山,2023-03-20,9103
6443,元晶,303,22,281,群益金鼎-松山,2023-03-21,9103
3481,群創,600,400,200,群益金鼎-松山,2023-03-21,9103
3011,今皓,156,3,153,群益金鼎-松山,2023-03-21,9103
6477,安集,114,9,105,群益金鼎-松山,2023-03-21,9103
2402,毅嘉,112,30,82,群益金鼎-松山,2023-03-21,9103
00632R,元大台灣50反1,60,0,60,群益金鼎-松山,2023-03-21,9103
00878,國泰永續高股息,51,0,51,群益金鼎-松山,2023-03-21,9103
2409,友達,30,0,30,群益金鼎-松山,2023-03-21,9103
4746,台耀,30,0,30,群益金鼎-松山,2023-03-21,9103
2388,威盛,85,59,26,群益金鼎-松山,2023-03-21,9103
3545,敦泰,23,1,22,群益金鼎-松山,2023-03-21,9103
2634,漢翔,22,1,21,群益金鼎-松山,2023-03-21,9103
00725B,國泰投資級公司債,20,0,20,群益金鼎-松山,2023-03-21,9103
3272,東碩,16,0,16,群益金鼎-松山,2023-03-21,9103
6235,華孚,42,26,16,群益金鼎-松山,2023-03-21,9103
1513,中興電,121,106,15,群益金鼎-松山,2023-03-21,9103
1503,士電,16,2,14,群益金鼎-松山,2023-03-21,9103
5483,中美晶,11,0,11,群益金鼎-松山,2023-03-21,9103
1531,高林股,10,0,10,群益金鼎-松山,2023-03-21,9103
2337,旺宏,10,0,10,群益金鼎-松山,2023-03-21,9103
2739,寒舍,10,0,10,群益金鼎-松山,2023-03-21,9103
3515,華擎,15,5,10,群益金鼎-松山,2023-03-21,9103
00635U,期元大S＆P黃金,9,0,9,群益金鼎-松山,2023-03-21,9103
2457,飛宏,127,119,8,群益金鼎-松山,2023-03-21,9103
2888,新光金,8,0,8,群益金鼎-松山,2023-03-21,9103
3231,緯創,32,24,8,群益金鼎-松山,2023-03-21,9103
6799,來頡,8,0,8,群益金鼎-松山,2023-03-21,9103
6863,永道-KY,8,0,8,群益金鼎-松山,2023-03-21,9103
9945,潤泰新,9,1,8,群益金鼎-松山,2023-03-21,9103
1605,華新,8,2,6,群益金鼎-松山,2023-03-21,9103
2884,玉山金,6,0,6,群益金鼎-松山,2023-03-21,9103
2891,中信金,6,0,6,群益金鼎-松山,2023-03-21,9103
6752,叡揚,6,0,6,群益金鼎-松山,2023-03-21,9103
8936,國統,6,0,6,群益金鼎-松山,2023-03-21,9103
2449,京元電子,6,1,5,群益金鼎-松山,2023-03-21,9103
3362,先進光,5,0,5,群益金鼎-松山,2023-03-21,9103
3479,安勤,5,0,5,群益金鼎-松山,2023-03-21,9103
5403,中菲,5,0,5,群益金鼎-松山,2023-03-21,9103
6150,撼訊,10,5,5,群益金鼎-松山,2023-03-21,9103
6282,康舒,5,0,5,群益金鼎-松山,2023-03-21,9103
2305,全友,4,0,4,群益金鼎-松山,2023-03-21,9103
2352,佳世達,4,0,4,群益金鼎-松山,2023-03-21,9103
2482,連宇,39,35,4,群益金鼎-松山,2023-03-21,9103
3162,精確,7,3,4,群益金鼎-松山,2023-03-21,9103
3704,合勤控,4,0,4,群益金鼎-松山,2023-03-21,9103
5009,榮剛,6,2,4,群益金鼎-松山,2023-03-21,9103
6517,保勝光學,4,0,4,群益金鼎-松山,2023-03-21,9103
00885,富邦越南,3,0,3,群益金鼎-松山,2023-03-21,9103
00680L,元大美債20正2,3,0,3,群益金鼎-松山,2023-03-21,9103
006208,富邦台50,3,0,3,群益金鼎-松山,2023-03-21,9103
1513,中興電,302,4,298,群益金鼎-松山,2023-03-22,9103
6143,振曜,279,63,216,群益金鼎-松山,2023-03-22,9103
6443,元晶,201,17,184,群益金鼎-松山,2023-03-22,9103
00632R,元大台灣50反1,126,0,126,群益金鼎-松山,2023-03-22,9103
1504,東元,169,51,118,群益金鼎-松山,2023-03-22,9103
2413,環科,106,2,104,群益金鼎-松山,2023-03-22,9103
00902,中信電池及儲能,100,0,100,群益金鼎-松山,2023-03-22,9103
1524,耿鼎,117,63,54,群益金鼎-松山,2023-03-22,9103
00830,國泰費城半導體,50,0,50,群益金鼎-松山,2023-03-22,9103
3322,建舜電,90,40,50,群益金鼎-松山,2023-03-22,9103
4746,台耀,47,0,47,群益金鼎-松山,2023-03-22,9103
3011,今皓,37,0,37,群益金鼎-松山,2023-03-22,9103
5452,佶優,49,14,35,群益金鼎-松山,2023-03-22,9103
00670L,富邦NASDAQ正2,30,0,30,群益金鼎-松山,2023-03-22,9103
3710,連展投控,30,0,30,群益金鼎-松山,2023-03-22,9103
2634,漢翔,20,0,20,群益金鼎-松山,2023-03-22,9103
6477,安集,20,0,20,群益金鼎-松山,2023-03-22,9103
1529,樂事綠能,33,15,18,群益金鼎-松山,2023-03-22,9103
8349,�矬�,15,0,15,群益金鼎-松山,2023-03-22,9103
9945,潤泰新,17,3,14,群益金鼎-松山,2023-03-22,9103
3081,聯亞,18,4,14,群益金鼎-松山,2023-03-22,9103
2476,鉅祥,14,0,14,群益金鼎-松山,2023-03-22,9103
2388,威盛,28,16,12,群益金鼎-松山,2023-03-22,9103
3479,安勤,13,1,12,群益金鼎-松山,2023-03-22,9103
4432,銘旺實,12,0,12,群益金鼎-松山,2023-03-22,9103
2402,毅嘉,16,6,10,群益金鼎-松山,2023-03-22,9103
2482,連宇,58,48,10,群益金鼎-松山,2023-03-22,9103
3147,大綜,10,0,10,群益金鼎-松山,2023-03-22,9103
3228,金麗科,12,2,10,群益金鼎-松山,2023-03-22,9103
6133,金橋,10,0,10,群益金鼎-松山,2023-03-22,9103
6695,芯鼎,10,0,10,群益金鼎-松山,2023-03-22,9103
6791,虎門科技,10,0,10,群益金鼎-松山,2023-03-22,9103
4763,材料-KY,21,12,9,群益金鼎-松山,2023-03-22,9103
4106,雃博,8,0,8,群益金鼎-松山,2023-03-22,9103
5425,台半,29,21,8,群益金鼎-松山,2023-03-22,9103
8040,九暘,8,0,8,群益金鼎-松山,2023-03-22,9103
5211,蒙恬,38,31,7,群益金鼎-松山,2023-03-22,9103
2489,瑞軒,7,0,7,群益金鼎-松山,2023-03-22,9103
00715L,期街口布蘭特正2,6,0,6,群益金鼎-松山,2023-03-22,9103
4967,十銓,11,5,6,群益金鼎-松山,2023-03-22,9103
6664,群翊,6,0,6,群益金鼎-松山,2023-03-22,9103
00885,富邦越南,5,0,5,群益金鼎-松山,2023-03-22,9103
00650L,復華香港正2,5,0,5,群益金鼎-松山,2023-03-22,9103
00676R,富邦臺灣加權反1,5,0,5,群益金鼎-松山,2023-03-22,9103
2328,廣宇,5,0,5,群益金鼎-松山,2023-03-22,9103
2610,華航,5,0,5,群益金鼎-松山,2023-03-22,9103
2706,第一店,5,0,5,群益金鼎-松山,2023-03-22,9103
3017,奇鋐,6,1,5,群益金鼎-松山,2023-03-22,9103
3675,德微,6,1,5,群益金鼎-松山,2023-03-22,9103
6276,安鈦克,5,0,5,群益金鼎-松山,2023-03-22,9103
6288,聯嘉,160,32,128,群益金鼎-松山,2023-03-23,9103
2484,希華,125,0,125,群益金鼎-松山,2023-03-23,9103
00632R,元大台灣50反1,65,5,60,群益金鼎-松山,2023-03-23,9103
3011,今皓,75,15,60,群益金鼎-松山,2023-03-23,9103
1810,和成,53,0,53,群益金鼎-松山,2023-03-23,9103
5475,德宏,40,0,40,群益金鼎-松山,2023-03-23,9103
8201,無敵,40,0,40,群益金鼎-松山,2023-03-23,9103
6134,萬旭,75,39,36,群益金鼎-松山,2023-03-23,9103
2413,環科,30,0,30,群益金鼎-松山,2023-03-23,9103
3664,安瑞-KY,30,0,30,群益金鼎-松山,2023-03-23,9103
5484,慧友,30,0,30,群益金鼎-松山,2023-03-23,9103
8383,千附,30,0,30,群益金鼎-松山,2023-03-23,9103
6133,金橋,27,0,27,群益金鼎-松山,2023-03-23,9103
1342,八貫,36,15,21,群益金鼎-松山,2023-03-23,9103
3499,環天科,20,0,20,群益金鼎-松山,2023-03-23,9103
5452,佶優,25,6,19,群益金鼎-松山,2023-03-23,9103
4976,佳凌,32,14,18,群益金鼎-松山,2023-03-23,9103
2471,資通,16,1,15,群益金鼎-松山,2023-03-23,9103
6190,萬泰科,15,0,15,群益金鼎-松山,2023-03-23,9103
6664,群翊,12,0,12,群益金鼎-松山,2023-03-23,9103
6770,力積電,12,0,12,群益金鼎-松山,2023-03-23,9103
4919,新唐,26,15,11,群益金鼎-松山,2023-03-23,9103
3016,嘉晶,11,0,11,群益金鼎-松山,2023-03-23,9103
3362,先進光,24,13,11,群益金鼎-松山,2023-03-23,9103
6160,欣技,14,3,11,群益金鼎-松山,2023-03-23,9103
6244,茂迪,13,2,11,群益金鼎-松山,2023-03-23,9103
6290,良維,13,2,11,群益金鼎-松山,2023-03-23,9103
1589,永冠-KY,12,2,10,群益金鼎-松山,2023-03-23,9103
00631L,元大台灣50正2,20,10,10,群益金鼎-松山,2023-03-23,9103
2495,普安,10,0,10,群益金鼎-松山,2023-03-23,9103
3046,建��,10,0,10,群益金鼎-松山,2023-03-23,9103
3260,威剛,11,1,10,群益金鼎-松山,2023-03-23,9103
3624,光頡,13,3,10,群益金鼎-松山,2023-03-23,9103
6150,撼訊,10,0,10,群益金鼎-松山,2023-03-23,9103
6485,點序,10,0,10,群益金鼎-松山,2023-03-23,9103
6767,台微醫,10,0,10,群益金鼎-松山,2023-03-23,9103
8222,寶一,20,10,10,群益金鼎-松山,2023-03-23,9103
8289,泰藝,10,0,10,群益金鼎-松山,2023-03-23,9103
2889,國票金,18,9,9,群益金鼎-松山,2023-03-23,9103
1522,堤維西,10,2,8,群益金鼎-松山,2023-03-23,9103
4746,台耀,8,0,8,群益金鼎-松山,2023-03-23,9103
2201,裕隆,11,3,8,群益金鼎-松山,2023-03-23,9103
0050,元大台灣50,10,3,7,群益金鼎-松山,2023-03-23,9103
3081,聯亞,14,7,7,群益金鼎-松山,2023-03-23,9103
2344,華邦電,8,2,6,群益金鼎-松山,2023-03-23,9103
3013,晟銘電,11,5,6,群益金鼎-松山,2023-03-23,9103
3037,欣興,17,12,5,群益金鼎-松山,2023-03-23,9103
00676R,富邦臺灣加權反1,5,0,5,群益金鼎-松山,2023-03-23,9103
2353,宏��,5,0,5,群益金鼎-松山,2023-03-23,9103
2388,威盛,5,0,5,群益金鼎-松山,2023-03-23,9103
3704,合勤控,123,3,120,群益金鼎-松山,2023-03-24,9103
3481,群創,105,0,105,群益金鼎-松山,2023-03-24,9103
00753L,中信中國50正2,102,0,102,群益金鼎-松山,2023-03-24,9103
3231,緯創,91,9,82,群益金鼎-松山,2023-03-24,9103
2486,一詮,80,0,80,群益金鼎-松山,2023-03-24,9103
1609,大亞,150,84,66,群益金鼎-松山,2023-03-24,9103
2351,順德,72,12,60,群益金鼎-松山,2023-03-24,9103
2340,台亞,60,1,59,群益金鼎-松山,2023-03-24,9103
00830,國泰費城半導體,100,50,50,群益金鼎-松山,2023-03-24,9103
8349,�矬�,38,0,38,群益金鼎-松山,2023-03-24,9103
2303,聯電,36,2,34,群益金鼎-松山,2023-03-24,9103
6213,聯茂,34,1,33,群益金鼎-松山,2023-03-24,9103
3508,位速,30,0,30,群益金鼎-松山,2023-03-24,9103
3016,嘉晶,22,0,22,群益金鼎-松山,2023-03-24,9103
6269,台郡,21,0,21,群益金鼎-松山,2023-03-24,9103
6443,元晶,26,5,21,群益金鼎-松山,2023-03-24,9103
2014,中鴻,20,0,20,群益金鼎-松山,2023-03-24,9103
00632R,元大台灣50反1,20,0,20,群益金鼎-松山,2023-03-24,9103
2329,華泰,20,0,20,群益金鼎-松山,2023-03-24,9103
2338,光罩,50,30,20,群益金鼎-松山,2023-03-24,9103
2413,環科,20,0,20,群益金鼎-松山,2023-03-24,9103
1101,台泥,50,31,19,群益金鼎-松山,2023-03-24,9103
2634,漢翔,20,2,18,群益金鼎-松山,2023-03-24,9103
8171,天宇,18,0,18,群益金鼎-松山,2023-03-24,9103
3035,智原,32,14,18,群益金鼎-松山,2023-03-24,9103
2603,長榮,20,2,18,群益金鼎-松山,2023-03-24,9103
2305,全友,15,0,15,群益金鼎-松山,2023-03-24,9103
2883B,凱基金乙特,15,0,15,群益金鼎-松山,2023-03-24,9103
6290,良維,26,11,15,群益金鼎-松山,2023-03-24,9103
6477,安集,30,15,15,群益金鼎-松山,2023-03-24,9103
3680,家登,16,1,15,群益金鼎-松山,2023-03-24,9103
3694,海華,34,21,13,群益金鼎-松山,2023-03-24,9103
6134,萬旭,12,0,12,群益金鼎-松山,2023-03-24,9103
3011,今皓,16,5,11,群益金鼎-松山,2023-03-24,9103
8054,安國,11,0,11,群益金鼎-松山,2023-03-24,9103
2884,玉山金,12,1,11,群益金鼎-松山,2023-03-24,9103
2485,兆赫,20,10,10,群益金鼎-松山,2023-03-24,9103
2888,新光金,10,0,10,群益金鼎-松山,2023-03-24,9103
3363,上詮,30,20,10,群益金鼎-松山,2023-03-24,9103
3499,環天科,30,20,10,群益金鼎-松山,2023-03-24,9103
3710,連展投控,10,0,10,群益金鼎-松山,2023-03-24,9103
6122,擎邦,12,2,10,群益金鼎-松山,2023-03-24,9103
6235,華孚,11,1,10,群益金鼎-松山,2023-03-24,9103
4919,新唐,9,0,9,群益金鼎-松山,2023-03-24,9103
6231,系微,11,2,9,群益金鼎-松山,2023-03-24,9103
3714,富采,37,28,9,群益金鼎-松山,2023-03-24,9103
8038,長園科,8,0,8,群益金鼎-松山,2023-03-24,9103
4931,新盛力,9,1,8,群益金鼎-松山,2023-03-24,9103
8222,寶一,20,12,8,群益金鼎-松山,2023-03-24,9103
00631L,元大台灣50正2,7,0,7,群益金鼎-松山,2023-03-24,9103
00632R,元大台灣50反1,200,0,200,群益金鼎-松山,2023-03-27,9103
2409,友達,101,1,100,群益金鼎-松山,2023-03-27,9103
2344,華邦電,202,104,98,群益金鼎-松山,2023-03-27,9103
6244,茂迪,197,102,95,群益金鼎-松山,2023-03-27,9103
6235,華孚,98,17,81,群益金鼎-松山,2023-03-27,9103
3491,昇達科,150,73,77,群益金鼎-松山,2023-03-27,9103
2457,飛宏,71,6,65,群益金鼎-松山,2023-03-27,9103
3438,類比科,60,0,60,群益金鼎-松山,2023-03-27,9103
3339,泰谷,60,3,57,群益金鼎-松山,2023-03-27,9103
6213,聯茂,53,0,53,群益金鼎-松山,2023-03-27,9103
8222,寶一,88,52,36,群益金鼎-松山,2023-03-27,9103
8033,雷虎,45,10,35,群益金鼎-松山,2023-03-27,9103
1321,大洋,30,0,30,群益金鼎-松山,2023-03-27,9103
2455,全新,32,2,30,群益金鼎-松山,2023-03-27,9103
2605,新興,30,0,30,群益金鼎-松山,2023-03-27,9103
5608,四維航,30,0,30,群益金鼎-松山,2023-03-27,9103
1342,八貫,25,1,24,群益金鼎-松山,2023-03-27,9103
3228,金麗科,28,7,21,群益金鼎-松山,2023-03-27,9103
2484,希華,20,0,20,群益金鼎-松山,2023-03-27,9103
2889,國票金,18,0,18,群益金鼎-松山,2023-03-27,9103
4971,IET-KY,39,21,18,群益金鼎-松山,2023-03-27,9103
4116,明基醫,16,0,16,群益金鼎-松山,2023-03-27,9103
2465,麗臺,15,0,15,群益金鼎-松山,2023-03-27,9103
6664,群翊,15,0,15,群益金鼎-松山,2023-03-27,9103
8996,高力,17,2,15,群益金鼎-松山,2023-03-27,9103
2313,華通,15,1,14,群益金鼎-松山,2023-03-27,9103
6443,元晶,17,3,14,群益金鼎-松山,2023-03-27,9103
3479,安勤,13,0,13,群益金鼎-松山,2023-03-27,9103
6770,力積電,11,0,11,群益金鼎-松山,2023-03-27,9103
2009,第一銅,10,0,10,群益金鼎-松山,2023-03-27,9103
2421,建準,18,8,10,群益金鼎-松山,2023-03-27,9103
2883B,凱基金乙特,10,0,10,群益金鼎-松山,2023-03-27,9103
6830,汎銓,10,0,10,群益金鼎-松山,2023-03-27,9103
2330,台積電,10,0,10,群益金鼎-松山,2023-03-27,9103
1605,華新,26,17,9,群益金鼎-松山,2023-03-27,9103
2303,聯電,14,5,9,群益金鼎-松山,2023-03-27,9103
2726,雅茗-KY,9,0,9,群益金鼎-松山,2023-03-27,9103
8114,振樺電,8,0,8,群益金鼎-松山,2023-03-27,9103
3011,今皓,11,4,7,群益金鼎-松山,2023-03-27,9103
3691,碩禾,7,0,7,群益金鼎-松山,2023-03-27,9103
6470,宇智,6,0,6,群益金鼎-松山,2023-03-27,9103
1584,精剛,8,3,5,群益金鼎-松山,2023-03-27,9103
1591,駿吉-KY,5,0,5,群益金鼎-松山,2023-03-27,9103
1446,宏和,5,0,5,群益金鼎-松山,2023-03-27,9103
1795,美時,7,2,5,群益金鼎-松山,2023-03-27,9103
2006,東和鋼鐵,5,0,5,群益金鼎-松山,2023-03-27,9103
2302,麗正,5,0,5,群益金鼎-松山,2023-03-27,9103
2453,凌群,8,3,5,群益金鼎-松山,2023-03-27,9103
2888,新光金,5,0,5,群益金鼎-松山,2023-03-27,9103
6205,詮欣,5,0,5,群益金鼎-松山,2023-03-27,9103
2402,毅嘉,109,4,105,群益金鼎-松山,2023-03-28,9103
3011,今皓,85,0,85,群益金鼎-松山,2023-03-28,9103
8084,巨虹,62,0,62,群益金鼎-松山,2023-03-28,9103
6770,力積電,48,1,47,群益金鼎-松山,2023-03-28,9103
8349,�矬�,41,0,41,群益金鼎-松山,2023-03-28,9103
4916,事欣科,40,0,40,群益金鼎-松山,2023-03-28,9103
4953,緯軟,30,0,30,群益金鼎-松山,2023-03-28,9103
2201,裕隆,24,0,24,群益金鼎-松山,2023-03-28,9103
2313,華通,22,0,22,群益金鼎-松山,2023-03-28,9103
00773B,中信優先金融債,20,0,20,群益金鼎-松山,2023-03-28,9103
2485,兆赫,20,0,20,群益金鼎-松山,2023-03-28,9103
6213,聯茂,20,0,20,群益金鼎-松山,2023-03-28,9103
6477,安集,20,0,20,群益金鼎-松山,2023-03-28,9103
8289,泰藝,18,0,18,群益金鼎-松山,2023-03-28,9103
6150,撼訊,15,0,15,群益金鼎-松山,2023-03-28,9103
8171,天宇,16,1,15,群益金鼎-松山,2023-03-28,9103
2731,雄獅,23,9,14,群益金鼎-松山,2023-03-28,9103
2303,聯電,12,0,12,群益金鼎-松山,2023-03-28,9103
2476,鉅祥,11,0,11,群益金鼎-松山,2023-03-28,9103
2009,第一銅,10,0,10,群益金鼎-松山,2023-03-28,9103
2243,宏旭-KY,10,0,10,群益金鼎-松山,2023-03-28,9103
2408,南亞科,10,0,10,群益金鼎-松山,2023-03-28,9103
2929,淘帝-KY,10,0,10,群益金鼎-松山,2023-03-28,9103
4971,IET-KY,10,0,10,群益金鼎-松山,2023-03-28,9103
00679B,元大美債20年,8,0,8,群益金鼎-松山,2023-03-28,9103
6244,茂迪,21,13,8,群益金鼎-松山,2023-03-28,9103
8996,高力,8,0,8,群益金鼎-松山,2023-03-28,9103
2330,台積電,9,2,7,群益金鼎-松山,2023-03-28,9103
3231,緯創,17,10,7,群益金鼎-松山,2023-03-28,9103
2421,建準,7,1,6,群益金鼎-松山,2023-03-28,9103
3228,金麗科,8,2,6,群益金鼎-松山,2023-03-28,9103
1101,台泥,5,0,5,群益金鼎-松山,2023-03-28,9103
00751B,元大AAA至A公司債,5,0,5,群益金鼎-松山,2023-03-28,9103
00676R,富邦臺灣加權反1,5,0,5,群益金鼎-松山,2023-03-28,9103
1321,大洋,5,0,5,群益金鼎-松山,2023-03-28,9103
2405,輔信,5,0,5,群益金鼎-松山,2023-03-28,9103
2457,飛宏,6,1,5,群益金鼎-松山,2023-03-28,9103
2883B,凱基金乙特,5,0,5,群益金鼎-松山,2023-03-28,9103
3557,嘉威,5,0,5,群益金鼎-松山,2023-03-28,9103
6531,愛普*,9,4,5,群益金鼎-松山,2023-03-28,9103
6830,汎銓,5,0,5,群益金鼎-松山,2023-03-28,9103
8420,明揚,5,0,5,群益金鼎-松山,2023-03-28,9103
8938,明安,5,0,5,群益金鼎-松山,2023-03-28,9103
1539,巨庭,4,0,4,群益金鼎-松山,2023-03-28,9103
00631L,元大台灣50正2,11,7,4,群益金鼎-松山,2023-03-28,9103
2317,鴻海,4,0,4,群益金鼎-松山,2023-03-28,9103
3691,碩禾,4,0,4,群益金鼎-松山,2023-03-28,9103
3714,富采,6,2,4,群益金鼎-松山,2023-03-28,9103
5353,台林,7,3,4,群益金鼎-松山,2023-03-28,9103
6548,長科*,4,0,4,群益金鼎-松山,2023-03-28,9103
00632R,元大台灣50反1,300,0,300,群益金鼎-松山,2023-03-29,9103
2484,希華,112,10,102,群益金鼎-松山,2023-03-29,9103
3481,群創,100,18,82,群益金鼎-松山,2023-03-29,9103
1609,大亞,40,0,40,群益金鼎-松山,2023-03-29,9103
2208,台船,32,0,32,群益金鼎-松山,2023-03-29,9103
8349,�矬�,30,0,30,群益金鼎-松山,2023-03-29,9103
2368,金像電,31,3,28,群益金鼎-松山,2023-03-29,9103
4979,華星光,26,5,21,群益金鼎-松山,2023-03-29,9103
1591,駿吉-KY,20,0,20,群益金鼎-松山,2023-03-29,9103
3438,類比科,20,0,20,群益金鼎-松山,2023-03-29,9103
4551,智伸科,20,0,20,群益金鼎-松山,2023-03-29,9103
6477,安集,20,0,20,群益金鼎-松山,2023-03-29,9103
3624,光頡,20,2,18,群益金鼎-松山,2023-03-29,9103
00679B,元大美債20年,16,0,16,群益金鼎-松山,2023-03-29,9103
2371,大同,35,21,14,群益金鼎-松山,2023-03-29,9103
3047,訊舟,11,0,11,群益金鼎-松山,2023-03-29,9103
5871,中租-KY,11,0,11,群益金鼎-松山,2023-03-29,9103
2421,建準,10,0,10,群益金鼎-松山,2023-03-29,9103
2838,聯邦銀,10,0,10,群益金鼎-松山,2023-03-29,9103
3035,智原,15,7,8,群益金鼎-松山,2023-03-29,9103
2020,美亞,8,0,8,群益金鼎-松山,2023-03-29,9103
2340,台亞,13,5,8,群益金鼎-松山,2023-03-29,9103
3105,穩懋,8,1,7,群益金鼎-松山,2023-03-29,9103
8409,商之器,7,0,7,群益金鼎-松山,2023-03-29,9103
1618,合機,6,0,6,群益金鼎-松山,2023-03-29,9103
5289,宜鼎,6,0,6,群益金鼎-松山,2023-03-29,9103
6134,萬旭,16,10,6,群益金鼎-松山,2023-03-29,9103
2603,長榮,6,1,5,群益金鼎-松山,2023-03-29,9103
1605,華新,9,4,5,群益金鼎-松山,2023-03-29,9103
00673R,期元大S＆P原油反1,5,0,5,群益金鼎-松山,2023-03-29,9103
2712,遠雄來,5,0,5,群益金鼎-松山,2023-03-29,9103
2739,寒舍,5,0,5,群益金鼎-松山,2023-03-29,9103
3162,精確,5,0,5,群益金鼎-松山,2023-03-29,9103
4536,拓凱,5,0,5,群益金鼎-松山,2023-03-29,9103
4919,新唐,8,3,5,群益金鼎-松山,2023-03-29,9103
5475,德宏,5,0,5,群益金鼎-松山,2023-03-29,9103
6517,保勝光學,5,0,5,群益金鼎-松山,2023-03-29,9103
6841,長佳智能,5,0,5,群益金鼎-松山,2023-03-29,9103
2303,聯電,4,0,4,群益金鼎-松山,2023-03-29,9103
2891,中信金,4,0,4,群益金鼎-松山,2023-03-29,9103
3037,欣興,19,15,4,群益金鼎-松山,2023-03-29,9103
5222,全訊,8,4,4,群益金鼎-松山,2023-03-29,9103
6592,和潤企業,4,0,4,群益金鼎-松山,2023-03-29,9103
8926,台汽電,4,0,4,群益金鼎-松山,2023-03-29,9103
3715,定穎投控,17,14,3,群益金鼎-松山,2023-03-29,9103
1101,台泥,3,0,3,群益金鼎-松山,2023-03-29,9103
1717,長興,3,0,3,群益金鼎-松山,2023-03-29,9103
2324,仁寶,4,1,3,群益金鼎-松山,2023-03-29,9103
2497,怡利電,3,0,3,群益金鼎-松山,2023-03-29,9103
3508,位速,3,0,3,群益金鼎-松山,2023-03-29,9103
5347,世界,128,0,128,群益金鼎-松山,2023-03-30,9103
2409,友達,101,1,100,群益金鼎-松山,2023-03-30,9103
6443,元晶,94,3,91,群益金鼎-松山,2023-03-30,9103
3034,聯詠,65,1,64,群益金鼎-松山,2023-03-30,9103
6285,啟��,64,17,47,群益金鼎-松山,2023-03-30,9103
6231,系微,42,0,42,群益金鼎-松山,2023-03-30,9103
2889,國票金,41,2,39,群益金鼎-松山,2023-03-30,9103
00679B,元大美債20年,32,0,32,群益金鼎-松山,2023-03-30,9103
8050,廣積,46,21,25,群益金鼎-松山,2023-03-30,9103
8349,�矬�,24,0,24,群益金鼎-松山,2023-03-30,9103
00632R,元大台灣50反1,220,200,20,群益金鼎-松山,2023-03-30,9103
2453,凌群,21,1,20,群益金鼎-松山,2023-03-30,9103
4119,旭富,20,0,20,群益金鼎-松山,2023-03-30,9103
2359,所羅門,21,2,19,群益金鼎-松山,2023-03-30,9103
6235,華孚,18,2,16,群益金鼎-松山,2023-03-30,9103
2457,飛宏,20,5,15,群益金鼎-松山,2023-03-30,9103
5222,全訊,20,5,15,群益金鼎-松山,2023-03-30,9103
5243,乙盛-KY,17,2,15,群益金鼎-松山,2023-03-30,9103
6715,嘉基,16,1,15,群益金鼎-松山,2023-03-30,9103
8069,元太,22,7,15,群益金鼎-松山,2023-03-30,9103
3037,欣興,39,24,15,群益金鼎-松山,2023-03-30,9103
2338,光罩,16,2,14,群益金鼎-松山,2023-03-30,9103
2247,汎德永業,10,0,10,群益金鼎-松山,2023-03-30,9103
2482,連宇,21,11,10,群益金鼎-松山,2023-03-30,9103
2534,宏盛,10,0,10,群益金鼎-松山,2023-03-30,9103
4953,緯軟,10,0,10,群益金鼎-松山,2023-03-30,9103
6109,亞元,10,0,10,群益金鼎-松山,2023-03-30,9103
6245,立端,11,1,10,群益金鼎-松山,2023-03-30,9103
2331,精英,10,1,9,群益金鼎-松山,2023-03-30,9103
6143,振曜,27,18,9,群益金鼎-松山,2023-03-30,9103
8086,宏捷科,10,1,9,群益金鼎-松山,2023-03-30,9103
2376,技嘉,8,0,8,群益金鼎-松山,2023-03-30,9103
3218,大學光,8,0,8,群益金鼎-松山,2023-03-30,9103
8047,星雲,8,0,8,群益金鼎-松山,2023-03-30,9103
2618,長榮航,7,0,7,群益金鼎-松山,2023-03-30,9103
00637L,元大滬深300正2,7,0,7,群益金鼎-松山,2023-03-30,9103
3441,聯一光,7,0,7,群益金鼎-松山,2023-03-30,9103
6113,亞矽,7,0,7,群益金鼎-松山,2023-03-30,9103
1720,生達,6,0,6,群益金鼎-松山,2023-03-30,9103
2393,億光,6,0,6,群益金鼎-松山,2023-03-30,9103
5309,系統電,32,26,6,群益金鼎-松山,2023-03-30,9103
1605,華新,6,1,5,群益金鼎-松山,2023-03-30,9103
00923,群益台ESG低碳50,5,0,5,群益金鼎-松山,2023-03-30,9103
00676R,富邦臺灣加權反1,5,0,5,群益金鼎-松山,2023-03-30,9103
2610,華航,10,5,5,群益金鼎-松山,2023-03-30,9103
2706,第一店,5,0,5,群益金鼎-松山,2023-03-30,9103
3499,環天科,5,0,5,群益金鼎-松山,2023-03-30,9103
6282,康舒,7,2,5,群益金鼎-松山,2023-03-30,9103
6485,點序,5,0,5,群益金鼎-松山,2023-03-30,9103
6841,長佳智能,5,0,5,群益金鼎-松山,2023-03-30,9103
3491,昇達科,201,73,128,群益金鼎-松山,2023-03-31,9103
00830,國泰費城半導體,50,0,50,群益金鼎-松山,2023-03-31,9103
00670L,富邦NASDAQ正2,46,1,45,群益金鼎-松山,2023-03-31,9103
1605,華新,23,1,22,群益金鼎-松山,2023-03-31,9103
8255,朋程,16,0,16,群益金鼎-松山,2023-03-31,9103
00679B,元大美債20年,15,0,15,群益金鼎-松山,2023-03-31,9103
6143,振曜,30,17,13,群益金鼎-松山,2023-03-31,9103
8433,弘帆,13,0,13,群益金鼎-松山,2023-03-31,9103
2388,威盛,24,12,12,群益金鼎-松山,2023-03-31,9103
2889,國票金,11,0,11,群益金鼎-松山,2023-03-31,9103
6134,萬旭,11,0,11,群益金鼎-松山,2023-03-31,9103
6191,精成科,10,0,10,群益金鼎-松山,2023-03-31,9103
1591,駿吉-KY,10,0,10,群益金鼎-松山,2023-03-31,9103
00882,中信中國高股息,10,0,10,群益金鼎-松山,2023-03-31,9103
2453,凌群,20,10,10,群益金鼎-松山,2023-03-31,9103
2484,希華,10,0,10,群益金鼎-松山,2023-03-31,9103
3454,晶睿,10,0,10,群益金鼎-松山,2023-03-31,9103
4744,皇將,10,0,10,群益金鼎-松山,2023-03-31,9103
4973,廣穎,12,2,10,群益金鼎-松山,2023-03-31,9103
6643,M31,14,4,10,群益金鼎-松山,2023-03-31,9103
7402,邑錡,10,0,10,群益金鼎-松山,2023-03-31,9103
8299,群聯,11,1,10,群益金鼎-松山,2023-03-31,9103
00706L,期元大S＆P日圓正2,9,0,9,群益金鼎-松山,2023-03-31,9103
3260,威剛,24,15,9,群益金鼎-松山,2023-03-31,9103
2603,長榮,8,0,8,群益金鼎-松山,2023-03-31,9103
5309,系統電,26,18,8,群益金鼎-松山,2023-03-31,9103
3338,泰碩,10,3,7,群益金鼎-松山,2023-03-31,9103
00753L,中信中國50正2,6,0,6,群益金鼎-松山,2023-03-31,9103
9945,潤泰新,6,0,6,群益金鼎-松山,2023-03-31,9103
1589,永冠-KY,5,0,5,群益金鼎-松山,2023-03-31,9103
2027,大成鋼,15,10,5,群益金鼎-松山,2023-03-31,9103
3005,神基,6,1,5,群益金鼎-松山,2023-03-31,9103
3162,精確,5,0,5,群益金鼎-松山,2023-03-31,9103
6416,瑞祺電通,5,0,5,群益金鼎-松山,2023-03-31,9103
6741,91APP*-KY,5,0,5,群益金鼎-松山,2023-03-31,9103
1795,美時,4,0,4,群益金鼎-松山,2023-03-31,9103
6443,元晶,4,0,4,群益金鼎-松山,2023-03-31,9103
006208,富邦台50,3,0,3,群益金鼎-松山,2023-03-31,9103
2393,億光,3,0,3,群益金鼎-松山,2023-03-31,9103
2915,潤泰全,3,0,3,群益金鼎-松山,2023-03-31,9103
3011,今皓,3,0,3,群益金鼎-松山,2023-03-31,9103
3035,智原,9,6,3,群益金鼎-松山,2023-03-31,9103
3339,泰谷,3,0,3,群益金鼎-松山,2023-03-31,9103
3406,玉晶光,3,0,3,群益金鼎-松山,2023-03-31,9103
5706,鳳凰,7,4,3,群益金鼎-松山,2023-03-31,9103
6188,廣明,3,0,3,群益金鼎-松山,2023-03-31,9103
6446,藥華藥,3,0,3,群益金鼎-松山,2023-03-31,9103
8046,南電,8,6,2,群益金鼎-松山,2023-03-31,9103
6531,愛普*,2,0,2,群益金鼎-松山,2023-03-31,9103
1539,巨庭,2,0,2,群益金鼎-松山,2023-03-31,9103
2484,希華,1286,1019,267,群益金鼎-松山,2023-04-06,9103
2344,華邦電,123,0,123,群益金鼎-松山,2023-04-06,9103
2606,裕民,61,2,59,群益金鼎-松山,2023-04-06,9103
2208,台船,64,12,52,群益金鼎-松山,2023-04-06,9103
3025,星通,38,0,38,群益金鼎-松山,2023-04-06,9103
6248,沛波,30,0,30,群益金鼎-松山,2023-04-06,9103
2618,長榮航,25,0,25,群益金鼎-松山,2023-04-06,9103
6148,驊宏資,26,1,25,群益金鼎-松山,2023-04-06,9103
2402,毅嘉,24,0,24,群益金鼎-松山,2023-04-06,9103
2436,偉詮電,24,0,24,群益金鼎-松山,2023-04-06,9103
6163,華電網,24,0,24,群益金鼎-松山,2023-04-06,9103
2368,金像電,23,0,23,群益金鼎-松山,2023-04-06,9103
00673R,期元大S＆P原油反1,22,0,22,群益金鼎-松山,2023-04-06,9103
1560,中砂,24,2,22,群益金鼎-松山,2023-04-06,9103
8940,新天地,22,0,22,群益金鼎-松山,2023-04-06,9103
2408,南亞科,20,0,20,群益金鼎-松山,2023-04-06,9103
6026,福邦證,18,0,18,群益金鼎-松山,2023-04-06,9103
1732,毛寶,17,0,17,群益金鼎-松山,2023-04-06,9103
3205,佰研,17,0,17,群益金鼎-松山,2023-04-06,9103
2916,滿心,16,0,16,群益金鼎-松山,2023-04-06,9103
1539,巨庭,15,0,15,群益金鼎-松山,2023-04-06,9103
3447,展達,15,0,15,群益金鼎-松山,2023-04-06,9103
6186,新潤,14,0,14,群益金鼎-松山,2023-04-06,9103
3211,順達,13,0,13,群益金鼎-松山,2023-04-06,9103
00637L,元大滬深300正2,12,0,12,群益金鼎-松山,2023-04-06,9103
6197,佳必琪,11,0,11,群益金鼎-松山,2023-04-06,9103
2609,陽明,11,1,10,群益金鼎-松山,2023-04-06,9103
2719,燦星旅,10,0,10,群益金鼎-松山,2023-04-06,9103
3494,誠研,10,0,10,群益金鼎-松山,2023-04-06,9103
3707,漢磊,10,0,10,群益金鼎-松山,2023-04-06,9103
4171,瑞基,10,0,10,群益金鼎-松山,2023-04-06,9103
6231,系微,10,0,10,群益金鼎-松山,2023-04-06,9103
6237,驊訊,10,0,10,群益金鼎-松山,2023-04-06,9103
6625,必應,10,0,10,群益金鼎-松山,2023-04-06,9103
8433,弘帆,10,0,10,群益金鼎-松山,2023-04-06,9103
2739,寒舍,9,0,9,群益金鼎-松山,2023-04-06,9103
3029,零壹,10,1,9,群益金鼎-松山,2023-04-06,9103
4148,全宇生技-KY,9,0,9,群益金鼎-松山,2023-04-06,9103
1795,美時,13,5,8,群益金鼎-松山,2023-04-06,9103
3532,台勝科,8,0,8,群益金鼎-松山,2023-04-06,9103
4551,智伸科,11,3,8,群益金鼎-松山,2023-04-06,9103
00679B,元大美債20年,9,2,7,群益金鼎-松山,2023-04-06,9103
6213,聯茂,12,5,7,群益金鼎-松山,2023-04-06,9103
8097,常珵,7,0,7,群益金鼎-松山,2023-04-06,9103
8938,明安,7,0,7,群益金鼎-松山,2023-04-06,9103
1909,榮成,6,0,6,群益金鼎-松山,2023-04-06,9103
6220,岳豐,6,0,6,群益金鼎-松山,2023-04-06,9103
2603,長榮,5,0,5,群益金鼎-松山,2023-04-06,9103
2731,雄獅,5,0,5,群益金鼎-松山,2023-04-06,9103
3228,金麗科,9,4,5,群益金鼎-松山,2023-04-06,9103
2412,中華電,352,0,352,群益金鼎-松山,2023-04-07,9103
2409,友達,101,0,101,群益金鼎-松山,2023-04-07,9103
00664R,國泰臺灣加權反1,100,0,100,群益金鼎-松山,2023-04-07,9103
00688L,國泰20年美債正2,80,0,80,群益金鼎-松山,2023-04-07,9103
00680L,元大美債20正2,81,11,70,群益金鼎-松山,2023-04-07,9103
6213,聯茂,57,0,57,群益金鼎-松山,2023-04-07,9103
6164,華興,51,0,51,群益金鼎-松山,2023-04-07,9103
5328,華容,50,0,50,群益金鼎-松山,2023-04-07,9103
8084,巨虹,50,0,50,群益金鼎-松山,2023-04-07,9103
6244,茂迪,49,0,49,群益金鼎-松山,2023-04-07,9103
4968,立積,41,9,32,群益金鼎-松山,2023-04-07,9103
1609,大亞,32,1,31,群益金鼎-松山,2023-04-07,9103
5608,四維航,30,0,30,群益金鼎-松山,2023-04-07,9103
8271,宇瞻,30,0,30,群益金鼎-松山,2023-04-07,9103
2485,兆赫,20,0,20,群益金鼎-松山,2023-04-07,9103
3041,揚智,20,0,20,群益金鼎-松山,2023-04-07,9103
1760,寶齡富錦,15,0,15,群益金鼎-松山,2023-04-07,9103
3454,晶睿,15,0,15,群益金鼎-松山,2023-04-07,9103
3027,盛達,14,0,14,群益金鼎-松山,2023-04-07,9103
3231,緯創,15,1,14,群益金鼎-松山,2023-04-07,9103
00715L,期街口布蘭特正2,13,0,13,群益金鼎-松山,2023-04-07,9103
2355,敬鵬,12,0,12,群益金鼎-松山,2023-04-07,9103
4551,智伸科,12,0,12,群益金鼎-松山,2023-04-07,9103
00772B,中信高評級公司債,10,0,10,群益金鼎-松山,2023-04-07,9103
2345,智邦,10,0,10,群益金鼎-松山,2023-04-07,9103
2482,連宇,11,1,10,群益金鼎-松山,2023-04-07,9103
2618,長榮航,10,0,10,群益金鼎-松山,2023-04-07,9103
4164,承業醫,10,0,10,群益金鼎-松山,2023-04-07,9103
8289,泰藝,10,0,10,群益金鼎-松山,2023-04-07,9103
5222,全訊,9,0,9,群益金鼎-松山,2023-04-07,9103
6160,欣技,9,0,9,群益金鼎-松山,2023-04-07,9103
6235,華孚,17,8,9,群益金鼎-松山,2023-04-07,9103
8349,�矬�,9,0,9,群益金鼎-松山,2023-04-07,9103
6197,佳必琪,19,11,8,群益金鼎-松山,2023-04-07,9103
1218,泰山,8,0,8,群益金鼎-松山,2023-04-07,9103
6217,中探針,8,0,8,群益金鼎-松山,2023-04-07,9103
6416,瑞祺電通,8,0,8,群益金鼎-松山,2023-04-07,9103
4746,台耀,7,0,7,群益金鼎-松山,2023-04-07,9103
6220,岳豐,7,0,7,群益金鼎-松山,2023-04-07,9103
8028,昇陽半導體,8,1,7,群益金鼎-松山,2023-04-07,9103
2388,威盛,13,6,7,群益金鼎-松山,2023-04-07,9103
2201,裕隆,9,2,7,群益金鼎-松山,2023-04-07,9103
1504,東元,6,0,6,群益金鼎-松山,2023-04-07,9103
2457,飛宏,24,18,6,群益金鼎-松山,2023-04-07,9103
3228,金麗科,8,2,6,群益金鼎-松山,2023-04-07,9103
8255,朋程,6,0,6,群益金鼎-松山,2023-04-07,9103
00679B,元大美債20年,7,2,5,群益金鼎-松山,2023-04-07,9103
00725B,國泰投資級公司債,5,0,5,群益金鼎-松山,2023-04-07,9103
2364,倫飛,5,0,5,群益金鼎-松山,2023-04-07,9103
3025,星通,5,0,5,群益金鼎-松山,2023-04-07,9103
2402,毅嘉,62,0,62,群益金鼎-松山,2023-04-10,9103
2344,華邦電,63,4,59,群益金鼎-松山,2023-04-10,9103
3432,台端,50,1,49,群益金鼎-松山,2023-04-10,9103
3041,揚智,44,0,44,群益金鼎-松山,2023-04-10,9103
6160,欣技,34,0,34,群益金鼎-松山,2023-04-10,9103
8043,蜜望實,60,30,30,群益金鼎-松山,2023-04-10,9103
6209,今國光,28,0,28,群益金鼎-松山,2023-04-10,9103
6282,康舒,30,2,28,群益金鼎-松山,2023-04-10,9103
5403,中菲,23,0,23,群益金鼎-松山,2023-04-10,9103
6118,建達,23,0,23,群益金鼎-松山,2023-04-10,9103
6235,華孚,24,3,21,群益金鼎-松山,2023-04-10,9103
6799,來頡,24,4,20,群益金鼎-松山,2023-04-10,9103
2367,燿華,20,0,20,群益金鼎-松山,2023-04-10,9103
2340,台亞,18,0,18,群益金鼎-松山,2023-04-10,9103
2375,凱美,50,32,18,群益金鼎-松山,2023-04-10,9103
9942,茂順,16,0,16,群益金鼎-松山,2023-04-10,9103
00670L,富邦NASDAQ正2,15,0,15,群益金鼎-松山,2023-04-10,9103
1524,耿鼎,15,0,15,群益金鼎-松山,2023-04-10,9103
3141,晶宏,17,2,15,群益金鼎-松山,2023-04-10,9103
8033,雷虎,15,0,15,群益金鼎-松山,2023-04-10,9103
8271,宇瞻,15,0,15,群益金鼎-松山,2023-04-10,9103
8349,�矬�,16,3,13,群益金鼎-松山,2023-04-10,9103
1519,華城,29,18,11,群益金鼎-松山,2023-04-10,9103
00679B,元大美債20年,11,0,11,群益金鼎-松山,2023-04-10,9103
00919,群益台灣精選高息,10,0,10,群益金鼎-松山,2023-04-10,9103
1560,中砂,10,0,10,群益金鼎-松山,2023-04-10,9103
2317,鴻海,10,0,10,群益金鼎-松山,2023-04-10,9103
2637,慧洋-KY,10,0,10,群益金鼎-松山,2023-04-10,9103
2748,雲品,10,0,10,群益金鼎-松山,2023-04-10,9103
3027,盛達,24,14,10,群益金鼎-松山,2023-04-10,9103
3260,威剛,10,0,10,群益金鼎-松山,2023-04-10,9103
4153,鈺緯,10,0,10,群益金鼎-松山,2023-04-10,9103
6753,龍德造船,10,0,10,群益金鼎-松山,2023-04-10,9103
6874,倍力,10,0,10,群益金鼎-松山,2023-04-10,9103
8054,安國,10,0,10,群益金鼎-松山,2023-04-10,9103
2453,凌群,10,1,9,群益金鼎-松山,2023-04-10,9103
3324,雙鴻,9,0,9,群益金鼎-松山,2023-04-10,9103
1609,大亞,50,42,8,群益金鼎-松山,2023-04-10,9103
2302,麗正,8,1,7,群益金鼎-松山,2023-04-10,9103
6213,聯茂,12,5,7,群益金鼎-松山,2023-04-10,9103
8433,弘帆,7,0,7,群益金鼎-松山,2023-04-10,9103
8028,昇陽半導體,6,0,6,群益金鼎-松山,2023-04-10,9103
00772B,中信高評級公司債,5,0,5,群益金鼎-松山,2023-04-10,9103
2305,全友,5,0,5,群益金鼎-松山,2023-04-10,9103
3035,智原,14,9,5,群益金鼎-松山,2023-04-10,9103
3037,欣興,9,4,5,群益金鼎-松山,2023-04-10,9103
4551,智伸科,5,0,5,群益金鼎-松山,2023-04-10,9103
5284,jpp-KY,8,3,5,群益金鼎-松山,2023-04-10,9103
6279,胡連,5,0,5,群益金鼎-松山,2023-04-10,9103
6751,智聯服務,5,0,5,群益金鼎-松山,2023-04-10,9103
3011,今皓,205,0,205,群益金鼎-松山,2023-04-11,9103
2834,臺企銀,102,0,102,群益金鼎-松山,2023-04-11,9103
1609,大亞,84,1,83,群益金鼎-松山,2023-04-11,9103
6122,擎邦,57,0,57,群益金鼎-松山,2023-04-11,9103
6244,茂迪,52,3,49,群益金鼎-松山,2023-04-11,9103
3078,僑威,40,1,39,群益金鼎-松山,2023-04-11,9103
6248,沛波,36,4,32,群益金鼎-松山,2023-04-11,9103
1514,亞力,45,24,21,群益金鼎-松山,2023-04-11,9103
00916,國泰全球品牌50,20,0,20,群益金鼎-松山,2023-04-11,9103
6164,華興,20,0,20,群益金鼎-松山,2023-04-11,9103
2330,台積電,15,0,15,群益金鼎-松山,2023-04-11,9103
8261,富鼎,17,2,15,群益金鼎-松山,2023-04-11,9103
3006,晶豪科,23,10,13,群益金鼎-松山,2023-04-11,9103
6139,亞翔,13,0,13,群益金鼎-松山,2023-04-11,9103
8028,昇陽半導體,13,0,13,群益金鼎-松山,2023-04-11,9103
1605,華新,13,1,12,群益金鼎-松山,2023-04-11,9103
6443,元晶,12,0,12,群益金鼎-松山,2023-04-11,9103
2739,寒舍,11,0,11,群益金鼎-松山,2023-04-11,9103
1321,大洋,10,0,10,群益金鼎-松山,2023-04-11,9103
00725B,國泰投資級公司債,10,0,10,群益金鼎-松山,2023-04-11,9103
1783,和康生,10,0,10,群益金鼎-松山,2023-04-11,9103
2413,環科,10,0,10,群益金鼎-松山,2023-04-11,9103
6245,立端,10,0,10,群益金鼎-松山,2023-04-11,9103
9945,潤泰新,9,0,9,群益金鼎-松山,2023-04-11,9103
4147,中裕,11,3,8,群益金鼎-松山,2023-04-11,9103
6209,今國光,8,0,8,群益金鼎-松山,2023-04-11,9103
00706L,期元大S＆P日圓正2,7,0,7,群益金鼎-松山,2023-04-11,9103
00878,國泰永續高股息,6,0,6,群益金鼎-松山,2023-04-11,9103
00679B,元大美債20年,6,0,6,群益金鼎-松山,2023-04-11,9103
2344,華邦電,14,8,6,群益金鼎-松山,2023-04-11,9103
1524,耿鼎,7,2,5,群益金鼎-松山,2023-04-11,9103
3294,英濟,5,0,5,群益金鼎-松山,2023-04-11,9103
3673,TPK-KY,5,0,5,群益金鼎-松山,2023-04-11,9103
6140,訊達,5,0,5,群益金鼎-松山,2023-04-11,9103
6160,欣技,9,4,5,群益金鼎-松山,2023-04-11,9103
6233,旺玖,5,0,5,群益金鼎-松山,2023-04-11,9103
9942,茂順,5,0,5,群益金鼎-松山,2023-04-11,9103
006208,富邦台50,4,0,4,群益金鼎-松山,2023-04-11,9103
2402,毅嘉,4,0,4,群益金鼎-松山,2023-04-11,9103
3522,御嵿,4,0,4,群益金鼎-松山,2023-04-11,9103
6143,振曜,13,9,4,群益金鼎-松山,2023-04-11,9103
2201,裕隆,29,25,4,群益金鼎-松山,2023-04-11,9103
3231,緯創,10,7,3,群益金鼎-松山,2023-04-11,9103
1418,東華,3,0,3,群益金鼎-松山,2023-04-11,9103
1529,樂事綠能,5,2,3,群益金鼎-松山,2023-04-11,9103
00712,復華富時不動產,3,0,3,群益金鼎-松山,2023-04-11,9103
2327,國巨,3,0,3,群益金鼎-松山,2023-04-11,9103
3557,嘉威,3,0,3,群益金鼎-松山,2023-04-11,9103
5353,台林,3,0,3,群益金鼎-松山,2023-04-11,9103
5425,台半,505,502,3,群益金鼎-松山,2023-04-11,9103
1616,億泰,100,0,100,群益金鼎-松山,2023-04-12,9103
6477,安集,55,0,55,群益金鼎-松山,2023-04-12,9103
5309,系統電,53,0,53,群益金鼎-松山,2023-04-12,9103
3027,盛達,50,5,45,群益金鼎-松山,2023-04-12,9103
3078,僑威,40,0,40,群益金鼎-松山,2023-04-12,9103
6213,聯茂,40,0,40,群益金鼎-松山,2023-04-12,9103
2208,台船,95,63,32,群益金鼎-松山,2023-04-12,9103
3432,台端,50,20,30,群益金鼎-松山,2023-04-12,9103
6164,華興,30,0,30,群益金鼎-松山,2023-04-12,9103
1584,精剛,67,41,26,群益金鼎-松山,2023-04-12,9103
3176,基亞,26,0,26,群益金鼎-松山,2023-04-12,9103
8222,寶一,77,51,26,群益金鼎-松山,2023-04-12,9103
6147,頎邦,24,0,24,群益金鼎-松山,2023-04-12,9103
6233,旺玖,22,2,20,群益金鼎-松山,2023-04-12,9103
00878,國泰永續高股息,20,0,20,群益金鼎-松山,2023-04-12,9103
2340,台亞,20,1,19,群益金鼎-松山,2023-04-12,9103
3664,安瑞-KY,22,4,18,群益金鼎-松山,2023-04-12,9103
1514,亞力,123,106,17,群益金鼎-松山,2023-04-12,9103
8038,長園科,19,3,16,群益金鼎-松山,2023-04-12,9103
1529,樂事綠能,16,3,13,群益金鼎-松山,2023-04-12,9103
3624,光頡,17,4,13,群益金鼎-松山,2023-04-12,9103
2028,威致,12,0,12,群益金鼎-松山,2023-04-12,9103
2482,連宇,13,1,12,群益金鼎-松山,2023-04-12,9103
8033,雷虎,22,10,12,群益金鼎-松山,2023-04-12,9103
6806,森崴能源,26,15,11,群益金鼎-松山,2023-04-12,9103
2485,兆赫,10,0,10,群益金鼎-松山,2023-04-12,9103
3026,禾伸堂,10,0,10,群益金鼎-松山,2023-04-12,9103
3067,全域,10,0,10,群益金鼎-松山,2023-04-12,9103
3362,先進光,10,0,10,群益金鼎-松山,2023-04-12,9103
3714,富采,10,0,10,群益金鼎-松山,2023-04-12,9103
4164,承業醫,10,0,10,群益金鼎-松山,2023-04-12,9103
4551,智伸科,10,0,10,群益金鼎-松山,2023-04-12,9103
6248,沛波,40,30,10,群益金鼎-松山,2023-04-12,9103
8255,朋程,10,0,10,群益金鼎-松山,2023-04-12,9103
9945,潤泰新,10,0,10,群益金鼎-松山,2023-04-12,9103
5222,全訊,14,5,9,群益金鼎-松山,2023-04-12,9103
3028,增你強,8,0,8,群益金鼎-松山,2023-04-12,9103
4174,浩鼎,60,52,8,群益金鼎-松山,2023-04-12,9103
8183,精星,8,0,8,群益金鼎-松山,2023-04-12,9103
8210,勤誠,8,0,8,群益金鼎-松山,2023-04-12,9103
00706L,期元大S＆P日圓正2,6,0,6,群益金鼎-松山,2023-04-12,9103
2515,中工,6,0,6,群益金鼎-松山,2023-04-12,9103
1720,生達,5,0,5,群益金鼎-松山,2023-04-12,9103
1591,駿吉-KY,5,0,5,群益金鼎-松山,2023-04-12,9103
1321,大洋,5,0,5,群益金鼎-松山,2023-04-12,9103
00637L,元大滬深300正2,5,0,5,群益金鼎-松山,2023-04-12,9103
00636,國泰中國A50,5,0,5,群益金鼎-松山,2023-04-12,9103
2408,南亞科,5,0,5,群益金鼎-松山,2023-04-12,9103
2474,可成,5,0,5,群益金鼎-松山,2023-04-12,9103
3447,展達,5,0,5,群益金鼎-松山,2023-04-12,9103
3545,敦泰,402,1,401,群益金鼎-松山,2023-04-13,9103
1513,中興電,208,3,205,群益金鼎-松山,2023-04-13,9103
2603,長榮,201,13,188,群益金鼎-松山,2023-04-13,9103
6789,采鈺,134,0,134,群益金鼎-松山,2023-04-13,9103
6443,元晶,103,0,103,群益金鼎-松山,2023-04-13,9103
3481,群創,101,6,95,群益金鼎-松山,2023-04-13,9103
2443,昶虹,92,0,92,群益金鼎-松山,2023-04-13,9103
3494,誠研,88,0,88,群益金鼎-松山,2023-04-13,9103
2618,長榮航,81,0,81,群益金鼎-松山,2023-04-13,9103
2358,廷鑫,50,0,50,群益金鼎-松山,2023-04-13,9103
4979,華星光,67,18,49,群益金鼎-松山,2023-04-13,9103
8940,新天地,30,0,30,群益金鼎-松山,2023-04-13,9103
2201,裕隆,82,56,26,群益金鼎-松山,2023-04-13,9103
2206,三陽工業,23,0,23,群益金鼎-松山,2023-04-13,9103
1589,永冠-KY,21,0,21,群益金鼎-松山,2023-04-13,9103
7402,邑錡,21,0,21,群益金鼎-松山,2023-04-13,9103
2457,飛宏,65,45,20,群益金鼎-松山,2023-04-13,9103
4968,立積,36,16,20,群益金鼎-松山,2023-04-13,9103
1519,華城,82,63,19,群益金鼎-松山,2023-04-13,9103
00679B,元大美債20年,17,0,17,群益金鼎-松山,2023-04-13,9103
00878,國泰永續高股息,15,0,15,群益金鼎-松山,2023-04-13,9103
2368,金像電,15,0,15,群益金鼎-松山,2023-04-13,9103
1473,台南,14,0,14,群益金鼎-松山,2023-04-13,9103
5371,中光電,13,0,13,群益金鼎-松山,2023-04-13,9103
5465,富驊,20,7,13,群益金鼎-松山,2023-04-13,9103
6664,群翊,13,0,13,群益金鼎-松山,2023-04-13,9103
1611,中電,16,5,11,群益金鼎-松山,2023-04-13,9103
2515,中工,13,2,11,群益金鼎-松山,2023-04-13,9103
9105,泰金寶-DR,11,0,11,群益金鼎-松山,2023-04-13,9103
1504,東元,94,84,10,群益金鼎-松山,2023-04-13,9103
1310,台苯,10,0,10,群益金鼎-松山,2023-04-13,9103
00885,富邦越南,10,0,10,群益金鼎-松山,2023-04-13,9103
2331,精英,10,0,10,群益金鼎-松山,2023-04-13,9103
2739,寒舍,10,0,10,群益金鼎-松山,2023-04-13,9103
3624,光頡,11,1,10,群益金鼎-松山,2023-04-13,9103
4747,強生,30,20,10,群益金鼎-松山,2023-04-13,9103
5009,榮剛,31,21,10,群益金鼎-松山,2023-04-13,9103
6213,聯茂,15,5,10,群益金鼎-松山,2023-04-13,9103
6248,沛波,30,20,10,群益金鼎-松山,2023-04-13,9103
6470,宇智,10,0,10,群益金鼎-松山,2023-04-13,9103
6830,汎銓,10,0,10,群益金鼎-松山,2023-04-13,9103
00720B,元大投資級公司債,8,0,8,群益金鼎-松山,2023-04-13,9103
2428,興勤,8,0,8,群益金鼎-松山,2023-04-13,9103
4572,駐龍,8,0,8,群益金鼎-松山,2023-04-13,9103
6220,岳豐,8,0,8,群益金鼎-松山,2023-04-13,9103
2609,陽明,7,0,7,群益金鼎-松山,2023-04-13,9103
4147,中裕,31,24,7,群益金鼎-松山,2023-04-13,9103
5203,訊連,7,0,7,群益金鼎-松山,2023-04-13,9103
2028,威致,6,0,6,群益金鼎-松山,2023-04-13,9103
3522,御嵿,6,0,6,群益金鼎-松山,2023-04-13,9103
2303,聯電,572,0,572,群益金鼎-松山,2023-04-14,9103
6245,立端,556,191,365,群益金鼎-松山,2023-04-14,9103
2409,友達,301,0,301,群益金鼎-松山,2023-04-14,9103
1314,中石化,300,0,300,群益金鼎-松山,2023-04-14,9103
3481,群創,704,411,293,群益金鼎-松山,2023-04-14,9103
1513,中興電,202,0,202,群益金鼎-松山,2023-04-14,9103
2427,三商電,103,0,103,群益金鼎-松山,2023-04-14,9103
3029,零壹,130,60,70,群益金鼎-松山,2023-04-14,9103
1514,亞力,93,23,70,群益金鼎-松山,2023-04-14,9103
3011,今皓,54,0,54,群益金鼎-松山,2023-04-14,9103
1905,華紙,50,0,50,群益金鼎-松山,2023-04-14,9103
2344,華邦電,51,4,47,群益金鼎-松山,2023-04-14,9103
6244,茂迪,49,5,44,群益金鼎-松山,2023-04-14,9103
2208,台船,102,72,30,群益金鼎-松山,2023-04-14,9103
2402,毅嘉,31,6,25,群益金鼎-松山,2023-04-14,9103
6179,亞通,25,0,25,群益金鼎-松山,2023-04-14,9103
2368,金像電,29,5,24,群益金鼎-松山,2023-04-14,9103
8222,寶一,104,82,22,群益金鼎-松山,2023-04-14,9103
2482,連宇,41,21,20,群益金鼎-松山,2023-04-14,9103
2736,富野,20,0,20,群益金鼎-松山,2023-04-14,9103
3058,立德,20,1,19,群益金鼎-松山,2023-04-14,9103
9962,有益,21,2,19,群益金鼎-松山,2023-04-14,9103
2471,資通,20,2,18,群益金鼎-松山,2023-04-14,9103
1701,中化,20,3,17,群益金鼎-松山,2023-04-14,9103
3046,建��,18,1,17,群益金鼎-松山,2023-04-14,9103
2359,所羅門,34,18,16,群益金鼎-松山,2023-04-14,9103
5258,虹堡,20,4,16,群益金鼎-松山,2023-04-14,9103
00720B,元大投資級公司債,15,0,15,群益金鼎-松山,2023-04-14,9103
00706L,期元大S＆P日圓正2,15,0,15,群益金鼎-松山,2023-04-14,9103
5403,中菲,14,0,14,群益金鼎-松山,2023-04-14,9103
6590,普鴻,13,0,13,群益金鼎-松山,2023-04-14,9103
6547,高端疫苗,13,1,12,群益金鼎-松山,2023-04-14,9103
3176,基亞,11,0,11,群益金鼎-松山,2023-04-14,9103
8349,�矬�,11,0,11,群益金鼎-松山,2023-04-14,9103
00633L,富邦上証正2,10,0,10,群益金鼎-松山,2023-04-14,9103
1783,和康生,10,0,10,群益金鼎-松山,2023-04-14,9103
1784,訊聯,12,2,10,群益金鼎-松山,2023-04-14,9103
2302,麗正,15,5,10,群益金鼎-松山,2023-04-14,9103
2371,大同,10,0,10,群益金鼎-松山,2023-04-14,9103
2731,雄獅,10,0,10,群益金鼎-松山,2023-04-14,9103
3715,定穎投控,10,0,10,群益金鼎-松山,2023-04-14,9103
6753,龍德造船,10,0,10,群益金鼎-松山,2023-04-14,9103
8086,宏捷科,10,0,10,群益金鼎-松山,2023-04-14,9103
8941,關中,10,0,10,群益金鼎-松山,2023-04-14,9103
4168,醣聯,9,0,9,群益金鼎-松山,2023-04-14,9103
4931,新盛力,10,1,9,群益金鼎-松山,2023-04-14,9103
1504,東元,9,1,8,群益金鼎-松山,2023-04-14,9103
6509,聚和,12,4,8,群益金鼎-松山,2023-04-14,9103
2002,中鋼,7,0,7,群益金鼎-松山,2023-04-14,9103
5465,富驊,20,13,7,群益金鼎-松山,2023-04-14,9103
2409,友達,100,0,100,群益金鼎-松山,2023-04-17,9103
6005,群益證,300,208,92,群益金鼎-松山,2023-04-17,9103
3545,敦泰,184,100,84,群益金鼎-松山,2023-04-17,9103
1504,東元,134,53,81,群益金鼎-松山,2023-04-17,9103
3029,零壹,300,220,80,群益金鼎-松山,2023-04-17,9103
2359,所羅門,92,33,59,群益金鼎-松山,2023-04-17,9103
1434,福懋,50,0,50,群益金鼎-松山,2023-04-17,9103
2634,漢翔,158,117,41,群益金鼎-松山,2023-04-17,9103
3011,今皓,37,1,36,群益金鼎-松山,2023-04-17,9103
3712,永崴投控,41,5,36,群益金鼎-松山,2023-04-17,9103
1514,亞力,114,83,31,群益金鼎-松山,2023-04-17,9103
1215,卜蜂,30,0,30,群益金鼎-松山,2023-04-17,9103
8271,宇瞻,25,0,25,群益金鼎-松山,2023-04-17,9103
8038,長園科,24,0,24,群益金鼎-松山,2023-04-17,9103
2206,三陽工業,75,52,23,群益金鼎-松山,2023-04-17,9103
3058,立德,43,20,23,群益金鼎-松山,2023-04-17,9103
00725B,國泰投資級公司債,20,0,20,群益金鼎-松山,2023-04-17,9103
2453,凌群,20,0,20,群益金鼎-松山,2023-04-17,9103
6122,擎邦,30,10,20,群益金鼎-松山,2023-04-17,9103
00772B,中信高評級公司債,18,0,18,群益金鼎-松山,2023-04-17,9103
3003,健和興,18,1,17,群益金鼎-松山,2023-04-17,9103
1503,士電,76,60,16,群益金鼎-松山,2023-04-17,9103
2340,台亞,16,0,16,群益金鼎-松山,2023-04-17,9103
8097,常珵,14,0,14,群益金鼎-松山,2023-04-17,9103
4967,十銓,14,1,13,群益金鼎-松山,2023-04-17,9103
2314,台揚,13,1,12,群益金鼎-松山,2023-04-17,9103
2610,華航,12,0,12,群益金鼎-松山,2023-04-17,9103
6231,系微,14,2,12,群益金鼎-松山,2023-04-17,9103
00680L,元大美債20正2,11,0,11,群益金鼎-松山,2023-04-17,9103
2421,建準,11,0,11,群益金鼎-松山,2023-04-17,9103
2308,台達電,10,0,10,群益金鼎-松山,2023-04-17,9103
2324,仁寶,10,0,10,群益金鼎-松山,2023-04-17,9103
2367,燿華,10,0,10,群益金鼎-松山,2023-04-17,9103
3664,安瑞-KY,20,10,10,群益金鼎-松山,2023-04-17,9103
3682,亞太電,10,0,10,群益金鼎-松山,2023-04-17,9103
6285,啟��,10,0,10,群益金鼎-松山,2023-04-17,9103
8105,凌巨,32,22,10,群益金鼎-松山,2023-04-17,9103
1584,精剛,11,2,9,群益金鼎-松山,2023-04-17,9103
1519,華城,72,64,8,群益金鼎-松山,2023-04-17,9103
1618,合機,8,0,8,群益金鼎-松山,2023-04-17,9103
4541,晟田,11,3,8,群益金鼎-松山,2023-04-17,9103
8155,博智,15,7,8,群益金鼎-松山,2023-04-17,9103
8936,國統,8,0,8,群益金鼎-松山,2023-04-17,9103
8478,東哥遊艇,12,4,8,群益金鼎-松山,2023-04-17,9103
4114,健喬,7,0,7,群益金鼎-松山,2023-04-17,9103
2888,新光金,6,0,6,群益金鼎-松山,2023-04-17,9103
3380,明泰,6,0,6,群益金鼎-松山,2023-04-17,9103
8215,明基材,7,1,6,群益金鼎-松山,2023-04-17,9103
1605,華新,35,30,5,群益金鼎-松山,2023-04-17,9103
00720B,元大投資級公司債,5,0,5,群益金鼎-松山,2023-04-17,9103
4979,華星光,200,50,150,群益金鼎-松山,2023-04-18,9103
2382,廣達,102,0,102,群益金鼎-松山,2023-04-18,9103
3545,敦泰,100,0,100,群益金鼎-松山,2023-04-18,9103
00632R,元大台灣50反1,100,0,100,群益金鼎-松山,2023-04-18,9103
3029,零壹,110,12,98,群益金鼎-松山,2023-04-18,9103
1471,首利,101,10,91,群益金鼎-松山,2023-04-18,9103
6282,康舒,83,1,82,群益金鼎-松山,2023-04-18,9103
6209,今國光,49,0,49,群益金鼎-松山,2023-04-18,9103
8085,福華,50,5,45,群益金鼎-松山,2023-04-18,9103
1584,精剛,142,99,43,群益金鼎-松山,2023-04-18,9103
6732,昇佳電子,37,3,34,群益金鼎-松山,2023-04-18,9103
8349,�矬�,33,1,32,群益金鼎-松山,2023-04-18,9103
1215,卜蜂,30,0,30,群益金鼎-松山,2023-04-18,9103
2206,三陽工業,84,61,23,群益金鼎-松山,2023-04-18,9103
3712,永崴投控,24,1,23,群益金鼎-松山,2023-04-18,9103
2457,飛宏,202,181,21,群益金鼎-松山,2023-04-18,9103
3047,訊舟,20,0,20,群益金鼎-松山,2023-04-18,9103
00720B,元大投資級公司債,16,0,16,群益金鼎-松山,2023-04-18,9103
3078,僑威,16,0,16,群益金鼎-松山,2023-04-18,9103
3576,聯合再生,20,4,16,群益金鼎-松山,2023-04-18,9103
00680L,元大美債20正2,15,0,15,群益金鼎-松山,2023-04-18,9103
3708,上緯投控,15,0,15,群益金鼎-松山,2023-04-18,9103
6213,聯茂,18,3,15,群益金鼎-松山,2023-04-18,9103
2471,資通,55,42,13,群益金鼎-松山,2023-04-18,9103
2634,漢翔,145,132,13,群益金鼎-松山,2023-04-18,9103
1605,華新,15,3,12,群益金鼎-松山,2023-04-18,9103
6005,群益證,110,100,10,群益金鼎-松山,2023-04-18,9103
2485,兆赫,20,10,10,群益金鼎-松山,2023-04-18,9103
3338,泰碩,10,0,10,群益金鼎-松山,2023-04-18,9103
8941,關中,10,0,10,群益金鼎-松山,2023-04-18,9103
2330,台積電,10,1,9,群益金鼎-松山,2023-04-18,9103
3025,星通,41,32,9,群益金鼎-松山,2023-04-18,9103
3058,立德,14,5,9,群益金鼎-松山,2023-04-18,9103
1229,聯華,8,0,8,群益金鼎-松山,2023-04-18,9103
5211,蒙恬,8,0,8,群益金鼎-松山,2023-04-18,9103
5347,世界,8,0,8,群益金鼎-松山,2023-04-18,9103
2727,王品,13,6,7,群益金鼎-松山,2023-04-18,9103
8059,凱碩,7,0,7,群益金鼎-松山,2023-04-18,9103
2454,聯發科,7,0,7,群益金鼎-松山,2023-04-18,9103
2645,長榮航太,7,0,7,群益金鼎-松山,2023-04-18,9103
1529,樂事綠能,6,0,6,群益金鼎-松山,2023-04-18,9103
3017,奇鋐,6,0,6,群益金鼎-松山,2023-04-18,9103
3324,雙鴻,7,1,6,群益金鼎-松山,2023-04-18,9103
6266,泰詠,7,1,6,群益金鼎-松山,2023-04-18,9103
1591,駿吉-KY,5,0,5,群益金鼎-松山,2023-04-18,9103
00751B,元大AAA至A公司債,5,0,5,群益金鼎-松山,2023-04-18,9103
2231,為升,5,0,5,群益金鼎-松山,2023-04-18,9103
2375,凱美,5,0,5,群益金鼎-松山,2023-04-18,9103
2641,正德,5,0,5,群益金鼎-松山,2023-04-18,9103
4550,長佳,21,16,5,群益金鼎-松山,2023-04-18,9103
3481,群創,2115,0,2115,群益金鼎-松山,2023-04-19,9103
9105,泰金寶-DR,300,0,300,群益金鼎-松山,2023-04-19,9103
8084,巨虹,222,0,222,群益金鼎-松山,2023-04-19,9103
6005,群益證,211,3,208,群益金鼎-松山,2023-04-19,9103
3545,敦泰,203,3,200,群益金鼎-松山,2023-04-19,9103
3704,合勤控,50,6,44,群益金鼎-松山,2023-04-19,9103
1810,和成,39,0,39,群益金鼎-松山,2023-04-19,9103
1514,亞力,95,62,33,群益金鼎-松山,2023-04-19,9103
3005,神基,33,0,33,群益金鼎-松山,2023-04-19,9103
2748,雲品,34,2,32,群益金鼎-松山,2023-04-19,9103
4127,天良,32,0,32,群益金鼎-松山,2023-04-19,9103
1609,大亞,33,3,30,群益金鼎-松山,2023-04-19,9103
2317,鴻海,32,4,28,群益金鼎-松山,2023-04-19,9103
1504,東元,33,7,26,群益金鼎-松山,2023-04-19,9103
8059,凱碩,30,7,23,群益金鼎-松山,2023-04-19,9103
5371,中光電,24,3,21,群益金鼎-松山,2023-04-19,9103
1589,永冠-KY,40,20,20,群益金鼎-松山,2023-04-19,9103
00680L,元大美債20正2,20,0,20,群益金鼎-松山,2023-04-19,9103
3673,TPK-KY,30,10,20,群益金鼎-松山,2023-04-19,9103
3682,亞太電,20,0,20,群益金鼎-松山,2023-04-19,9103
8121,越峰,20,0,20,群益金鼎-松山,2023-04-19,9103
3011,今皓,18,0,18,群益金鼎-松山,2023-04-19,9103
3664,安瑞-KY,18,0,18,群益金鼎-松山,2023-04-19,9103
4174,浩鼎,21,3,18,群益金鼎-松山,2023-04-19,9103
2732,六角,15,0,15,群益金鼎-松山,2023-04-19,9103
6122,擎邦,20,5,15,群益金鼎-松山,2023-04-19,9103
2471,資通,35,21,14,群益金鼎-松山,2023-04-19,9103
2409,友達,315,302,13,群益金鼎-松山,2023-04-19,9103
2882,國泰金,12,0,12,群益金鼎-松山,2023-04-19,9103
00725B,國泰投資級公司債,12,0,12,群益金鼎-松山,2023-04-19,9103
6548,長科*,12,0,12,群益金鼎-松山,2023-04-19,9103
6863,永道-KY,12,0,12,群益金鼎-松山,2023-04-19,9103
2453,凌群,61,50,11,群益金鼎-松山,2023-04-19,9103
8222,寶一,27,16,11,群益金鼎-松山,2023-04-19,9103
1533,車王電,10,0,10,群益金鼎-松山,2023-04-19,9103
1513,中興電,22,12,10,群益金鼎-松山,2023-04-19,9103
3036,文曄,10,0,10,群益金鼎-松山,2023-04-19,9103
4128,中天,30,20,10,群益金鼎-松山,2023-04-19,9103
6209,今國光,10,0,10,群益金鼎-松山,2023-04-19,9103
6869,雲豹能源,10,0,10,群益金鼎-松山,2023-04-19,9103
8349,�矬�,10,0,10,群益金鼎-松山,2023-04-19,9103
8033,雷虎,56,46,10,群益金鼎-松山,2023-04-19,9103
8403,盛弘,10,1,9,群益金鼎-松山,2023-04-19,9103
2305,全友,8,0,8,群益金鼎-松山,2023-04-19,9103
3557,嘉威,13,5,8,群益金鼎-松山,2023-04-19,9103
6590,普鴻,9,1,8,群益金鼎-松山,2023-04-19,9103
2457,飛宏,94,87,7,群益金鼎-松山,2023-04-19,9103
00679B,元大美債20年,7,0,7,群益金鼎-松山,2023-04-19,9103
5243,乙盛-KY,11,4,7,群益金鼎-松山,2023-04-19,9103
5465,富驊,8,1,7,群益金鼎-松山,2023-04-19,9103
2382,廣達,202,0,202,群益金鼎-松山,2023-04-20,9103
9941,裕融,100,0,100,群益金鼎-松山,2023-04-20,9103
8084,巨虹,59,0,59,群益金鼎-松山,2023-04-20,9103
2303,聯電,62,5,57,群益金鼎-松山,2023-04-20,9103
00680L,元大美債20正2,50,0,50,群益金鼎-松山,2023-04-20,9103
4746,台耀,35,0,35,群益金鼎-松山,2023-04-20,9103
1611,中電,32,0,32,群益金鼎-松山,2023-04-20,9103
1101,台泥,30,0,30,群益金鼎-松山,2023-04-20,9103
1752,南光,39,11,28,群益金鼎-松山,2023-04-20,9103
6134,萬旭,24,0,24,群益金鼎-松山,2023-04-20,9103
6288,聯嘉,24,0,24,群益金鼎-松山,2023-04-20,9103
00923,群益台ESG低碳50,21,0,21,群益金鼎-松山,2023-04-20,9103
00687B,國泰20年美債,20,0,20,群益金鼎-松山,2023-04-20,9103
3682,亞太電,20,0,20,群益金鼎-松山,2023-04-20,9103
4164,承業醫,20,0,20,群益金鼎-松山,2023-04-20,9103
4931,新盛力,24,5,19,群益金鼎-松山,2023-04-20,9103
4129,聯合,18,0,18,群益金鼎-松山,2023-04-20,9103
6245,立端,62,44,18,群益金鼎-松山,2023-04-20,9103
6874,倍力,20,3,17,群益金鼎-松山,2023-04-20,9103
8349,�矬�,16,0,16,群益金鼎-松山,2023-04-20,9103
00772B,中信高評級公司債,15,0,15,群益金鼎-松山,2023-04-20,9103
2201,裕隆,13,1,12,群益金鼎-松山,2023-04-20,9103
5227,立凱-KY,12,0,12,群益金鼎-松山,2023-04-20,9103
6213,聯茂,11,0,11,群益金鼎-松山,2023-04-20,9103
1605,華新,13,3,10,群益金鼎-松山,2023-04-20,9103
00761B,國泰A級公司債,10,0,10,群益金鼎-松山,2023-04-20,9103
2204,中華,11,1,10,群益金鼎-松山,2023-04-20,9103
2485,兆赫,10,0,10,群益金鼎-松山,2023-04-20,9103
2889,國票金,10,0,10,群益金鼎-松山,2023-04-20,9103
8038,長園科,10,0,10,群益金鼎-松山,2023-04-20,9103
00715L,期街口布蘭特正2,8,0,8,群益金鼎-松山,2023-04-20,9103
1701,中化,10,2,8,群益金鼎-松山,2023-04-20,9103
2027,大成鋼,7,0,7,群益金鼎-松山,2023-04-20,9103
8028,昇陽半導體,16,9,7,群益金鼎-松山,2023-04-20,9103
00878,國泰永續高股息,6,0,6,群益金鼎-松山,2023-04-20,9103
1736,喬山,6,0,6,群益金鼎-松山,2023-04-20,9103
2230,泰茂,6,0,6,群益金鼎-松山,2023-04-20,9103
3058,立德,6,0,6,群益金鼎-松山,2023-04-20,9103
3685,元創精密,6,0,6,群益金鼎-松山,2023-04-20,9103
4147,中裕,21,15,6,群益金鼎-松山,2023-04-20,9103
4503,金雨,6,0,6,群益金鼎-松山,2023-04-20,9103
5465,富驊,8,2,6,群益金鼎-松山,2023-04-20,9103
6768,志強-KY,6,0,6,群益金鼎-松山,2023-04-20,9103
1760,寶齡富錦,15,10,5,群益金鼎-松山,2023-04-20,9103
1218,泰山,13,8,5,群益金鼎-松山,2023-04-20,9103
3013,晟銘電,13,8,5,群益金鼎-松山,2023-04-20,9103
3038,全台,5,0,5,群益金鼎-松山,2023-04-20,9103
3093,港建*,5,0,5,群益金鼎-松山,2023-04-20,9103
3545,敦泰,5,0,5,群益金鼎-松山,2023-04-20,9103
3624,光頡,7,2,5,群益金鼎-松山,2023-04-20,9103
6143,振曜,393,37,356,群益金鼎-松山,2023-04-21,9103
8084,巨虹,107,1,106,群益金鼎-松山,2023-04-21,9103
1524,耿鼎,105,0,105,群益金鼎-松山,2023-04-21,9103
2618,長榮航,103,0,103,群益金鼎-松山,2023-04-21,9103
5880,合庫金,100,0,100,群益金鼎-松山,2023-04-21,9103
3078,僑威,60,18,42,群益金鼎-松山,2023-04-21,9103
6282,康舒,150,110,40,群益金鼎-松山,2023-04-21,9103
4934,太極,32,0,32,群益金鼎-松山,2023-04-21,9103
1504,東元,31,0,31,群益金鼎-松山,2023-04-21,9103
2457,飛宏,39,8,31,群益金鼎-松山,2023-04-21,9103
00632R,元大台灣50反1,30,0,30,群益金鼎-松山,2023-04-21,9103
6244,茂迪,68,40,28,群益金鼎-松山,2023-04-21,9103
3092,鴻碩,28,3,25,群益金鼎-松山,2023-04-21,9103
6733,博晟生醫,26,1,25,群益金鼎-松山,2023-04-21,9103
4968,立積,40,16,24,群益金鼎-松山,2023-04-21,9103
5465,富驊,30,8,22,群益金鼎-松山,2023-04-21,9103
2634,漢翔,124,103,21,群益金鼎-松山,2023-04-21,9103
6517,保勝光學,23,3,20,群益金鼎-松山,2023-04-21,9103
1109,信大,50,30,20,群益金鼎-松山,2023-04-21,9103
2471,資通,20,0,20,群益金鼎-松山,2023-04-21,9103
2630,亞航,20,0,20,群益金鼎-松山,2023-04-21,9103
8222,寶一,43,26,17,群益金鼎-松山,2023-04-21,9103
3011,今皓,17,2,15,群益金鼎-松山,2023-04-21,9103
3324,雙鴻,15,0,15,群益金鼎-松山,2023-04-21,9103
5425,台半,17,2,15,群益金鼎-松山,2023-04-21,9103
6829,千附精密,15,0,15,群益金鼎-松山,2023-04-21,9103
9933,中鼎,15,0,15,群益金鼎-松山,2023-04-21,9103
2368,金像電,15,1,14,群益金鼎-松山,2023-04-21,9103
2888,新光金,19,5,14,群益金鼎-松山,2023-04-21,9103
2027,大成鋼,13,0,13,群益金鼎-松山,2023-04-21,9103
2313,華通,12,0,12,群益金鼎-松山,2023-04-21,9103
6213,聯茂,12,0,12,群益金鼎-松山,2023-04-21,9103
3680,家登,21,10,11,群益金鼎-松山,2023-04-21,9103
5469,瀚宇博,11,0,11,群益金鼎-松山,2023-04-21,9103
6245,立端,22,11,11,群益金鼎-松山,2023-04-21,9103
8033,雷虎,11,0,11,群益金鼎-松山,2023-04-21,9103
1519,華城,11,1,10,群益金鼎-松山,2023-04-21,9103
1784,訊聯,11,1,10,群益金鼎-松山,2023-04-21,9103
1904,正隆,42,32,10,群益金鼎-松山,2023-04-21,9103
2009,第一銅,10,0,10,群益金鼎-松山,2023-04-21,9103
2739,寒舍,10,0,10,群益金鼎-松山,2023-04-21,9103
2889,國票金,10,0,10,群益金鼎-松山,2023-04-21,9103
6625,必應,10,0,10,群益金鼎-松山,2023-04-21,9103
6768,志強-KY,10,0,10,群益金鼎-松山,2023-04-21,9103
6811,宏�硌穈T,10,0,10,群益金鼎-松山,2023-04-21,9103
8074,鉅橡,10,0,10,群益金鼎-松山,2023-04-21,9103
8086,宏捷科,10,0,10,群益金鼎-松山,2023-04-21,9103
1529,樂事綠能,50,41,9,群益金鼎-松山,2023-04-21,9103
6719,力智,11,2,9,群益金鼎-松山,2023-04-21,9103
5703,亞都,8,0,8,群益金鼎-松山,2023-04-21,9103
2031,新光鋼,75,0,75,群益金鼎-松山,2023-04-24,9103
2913,農林,137,81,56,群益金鼎-松山,2023-04-24,9103
2457,飛宏,36,3,33,群益金鼎-松山,2023-04-24,9103
1101,台泥,35,3,32,群益金鼎-松山,2023-04-24,9103
2382,廣達,30,0,30,群益金鼎-松山,2023-04-24,9103
1810,和成,52,30,22,群益金鼎-松山,2023-04-24,9103
4967,十銓,24,2,22,群益金鼎-松山,2023-04-24,9103
1519,華城,62,41,21,群益金鼎-松山,2023-04-24,9103
1514,亞力,72,51,21,群益金鼎-松山,2023-04-24,9103
1907,永豐餘,50,30,20,群益金鼎-松山,2023-04-24,9103
2455,全新,20,0,20,群益金鼎-松山,2023-04-24,9103
5425,台半,24,4,20,群益金鼎-松山,2023-04-24,9103
9941,裕融,18,0,18,群益金鼎-松山,2023-04-24,9103
1503,士電,51,35,16,群益金鼎-松山,2023-04-24,9103
3479,安勤,31,15,16,群益金鼎-松山,2023-04-24,9103
6869,雲豹能源,16,0,16,群益金鼎-松山,2023-04-24,9103
6689,伊雲谷,15,0,15,群益金鼎-松山,2023-04-24,9103
4129,聯合,12,0,12,群益金鼎-松山,2023-04-24,9103
5371,中光電,13,1,12,群益金鼎-松山,2023-04-24,9103
3035,智原,18,7,11,群益金鼎-松山,2023-04-24,9103
00637L,元大滬深300正2,16,5,11,群益金鼎-松山,2023-04-24,9103
2453,凌群,51,40,11,群益金鼎-松山,2023-04-24,9103
2645,長榮航太,11,0,11,群益金鼎-松山,2023-04-24,9103
2330,台積電,12,1,11,群益金鼎-松山,2023-04-24,9103
00633L,富邦上証正2,10,0,10,群益金鼎-松山,2023-04-24,9103
2630,亞航,30,20,10,群益金鼎-松山,2023-04-24,9103
8033,雷虎,20,10,10,群益金鼎-松山,2023-04-24,9103
8069,元太,9,0,9,群益金鼎-松山,2023-04-24,9103
2748,雲品,8,0,8,群益金鼎-松山,2023-04-24,9103
00706L,期元大S＆P日圓正2,6,0,6,群益金鼎-松山,2023-04-24,9103
2451,創見,6,0,6,群益金鼎-松山,2023-04-24,9103
1732,毛寶,5,0,5,群益金鼎-松山,2023-04-24,9103
1215,卜蜂,30,25,5,群益金鼎-松山,2023-04-24,9103
2312,金寶,5,0,5,群益金鼎-松山,2023-04-24,9103
6472,保瑞,8,3,5,群益金鼎-松山,2023-04-24,9103
6706,惠特,5,0,5,群益金鼎-松山,2023-04-24,9103
00878,國泰永續高股息,4,0,4,群益金鼎-松山,2023-04-24,9103
2885,元大金,4,0,4,群益金鼎-松山,2023-04-24,9103
4543,萬在,4,0,4,群益金鼎-松山,2023-04-24,9103
6443,元晶,4,0,4,群益金鼎-松山,2023-04-24,9103
6799,來頡,4,0,4,群益金鼎-松山,2023-04-24,9103
8150,南茂,4,0,4,群益金鼎-松山,2023-04-24,9103
8227,巨有科技,4,0,4,群益金鼎-松山,2023-04-24,9103
00679B,元大美債20年,3,0,3,群益金鼎-松山,2023-04-24,9103
1795,美時,3,0,3,群益金鼎-松山,2023-04-24,9103
2402,毅嘉,3,0,3,群益金鼎-松山,2023-04-24,9103
2495,普安,6,3,3,群益金鼎-松山,2023-04-24,9103
3413,京鼎,3,0,3,群益金鼎-松山,2023-04-24,9103
3685,元創精密,3,0,3,群益金鼎-松山,2023-04-24,9103
3715,定穎投控,5,2,3,群益金鼎-松山,2023-04-24,9103
00671R,富邦NASDAQ反1,200,0,200,群益金鼎-松山,2023-04-25,9103
00669R,國泰美國道瓊反1,150,0,150,群益金鼎-松山,2023-04-25,9103
9941,裕融,82,0,82,群益金鼎-松山,2023-04-25,9103
2382,廣達,76,1,75,群益金鼎-松山,2023-04-25,9103
6282,康舒,100,42,58,群益金鼎-松山,2023-04-25,9103
5009,榮剛,31,0,31,群益金鼎-松山,2023-04-25,9103
1909,榮成,30,0,30,群益金鼎-松山,2023-04-25,9103
6213,聯茂,26,0,26,群益金鼎-松山,2023-04-25,9103
2409,友達,36,15,21,群益金鼎-松山,2023-04-25,9103
1314,中石化,20,0,20,群益金鼎-松山,2023-04-25,9103
2206,三陽工業,65,45,20,群益金鼎-松山,2023-04-25,9103
2630,亞航,50,30,20,群益金鼎-松山,2023-04-25,9103
2889,國票金,20,0,20,群益金鼎-松山,2023-04-25,9103
8349,�矬�,20,0,20,群益金鼎-松山,2023-04-25,9103
1101,台泥,27,9,18,群益金鼎-松山,2023-04-25,9103
00637L,元大滬深300正2,22,5,17,群益金鼎-松山,2023-04-25,9103
3374,精材,16,0,16,群益金鼎-松山,2023-04-25,9103
2313,華通,15,0,15,群益金鼎-松山,2023-04-25,9103
1473,台南,14,0,14,群益金鼎-松山,2023-04-25,9103
1720,生達,14,0,14,群益金鼎-松山,2023-04-25,9103
6196,帆宣,14,0,14,群益金鼎-松山,2023-04-25,9103
00878,國泰永續高股息,12,0,12,群益金鼎-松山,2023-04-25,9103
2453,凌群,31,20,11,群益金鼎-松山,2023-04-25,9103
2303,聯電,15,5,10,群益金鼎-松山,2023-04-25,9103
5469,瀚宇博,10,0,10,群益金鼎-松山,2023-04-25,9103
6148,驊宏資,12,2,10,群益金鼎-松山,2023-04-25,9103
9904,寶成,10,0,10,群益金鼎-松山,2023-04-25,9103
2482,連宇,51,42,9,群益金鼎-松山,2023-04-25,9103
4121,優盛,10,1,9,群益金鼎-松山,2023-04-25,9103
00679B,元大美債20年,10,2,8,群益金鼎-松山,2023-04-25,9103
3163,波若威,8,0,8,群益金鼎-松山,2023-04-25,9103
2618,長榮航,7,0,7,群益金鼎-松山,2023-04-25,9103
6712,長聖,7,0,7,群益金鼎-松山,2023-04-25,9103
6753,龍德造船,7,0,7,群益金鼎-松山,2023-04-25,9103
8084,巨虹,7,0,7,群益金鼎-松山,2023-04-25,9103
1905,華紙,6,0,6,群益金鼎-松山,2023-04-25,9103
3093,港建*,6,0,6,群益金鼎-松山,2023-04-25,9103
4174,浩鼎,6,0,6,群益金鼎-松山,2023-04-25,9103
5222,全訊,21,15,6,群益金鼎-松山,2023-04-25,9103
3011,今皓,5,0,5,群益金鼎-松山,2023-04-25,9103
3013,晟銘電,5,0,5,群益金鼎-松山,2023-04-25,9103
3022,威強電,5,0,5,群益金鼎-松山,2023-04-25,9103
6706,惠特,5,0,5,群益金鼎-松山,2023-04-25,9103
6719,力智,7,2,5,群益金鼎-松山,2023-04-25,9103
8433,弘帆,5,0,5,群益金鼎-松山,2023-04-25,9103
00712,復華富時不動產,4,0,4,群益金鼎-松山,2023-04-25,9103
00706L,期元大S＆P日圓正2,4,0,4,群益金鼎-松山,2023-04-25,9103
00633L,富邦上証正2,20,16,4,群益金鼎-松山,2023-04-25,9103
00753L,中信中國50正2,4,0,4,群益金鼎-松山,2023-04-25,9103
1219,福壽,4,0,4,群益金鼎-松山,2023-04-25,9103
1104,環泥,70,1,69,群益金鼎-松山,2023-04-26,9103
3363,上詮,60,1,59,群益金鼎-松山,2023-04-26,9103
1504,東元,60,8,52,群益金鼎-松山,2023-04-26,9103
1810,和成,50,0,50,群益金鼎-松山,2023-04-26,9103
1216,統一,40,0,40,群益金鼎-松山,2023-04-26,9103
4968,立積,40,7,33,群益金鼎-松山,2023-04-26,9103
2634,漢翔,84,52,32,群益金鼎-松山,2023-04-26,9103
00923,群益台ESG低碳50,32,0,32,群益金鼎-松山,2023-04-26,9103
8222,寶一,33,2,31,群益金鼎-松山,2023-04-26,9103
1904,正隆,60,30,30,群益金鼎-松山,2023-04-26,9103
1310,台苯,33,5,28,群益金鼎-松山,2023-04-26,9103
2206,三陽工業,47,21,26,群益金鼎-松山,2023-04-26,9103
2204,中華,25,0,25,群益金鼎-松山,2023-04-26,9103
2303,聯電,23,1,22,群益金鼎-松山,2023-04-26,9103
1905,華紙,158,137,21,群益金鼎-松山,2023-04-26,9103
6282,康舒,24,3,21,群益金鼎-松山,2023-04-26,9103
1718,中纖,20,0,20,群益金鼎-松山,2023-04-26,9103
1584,精剛,67,49,18,群益金鼎-松山,2023-04-26,9103
2889,國票金,18,0,18,群益金鼎-松山,2023-04-26,9103
1519,華城,18,0,18,群益金鼎-松山,2023-04-26,9103
2002,中鋼,16,0,16,群益金鼎-松山,2023-04-26,9103
2031,新光鋼,15,0,15,群益金鼎-松山,2023-04-26,9103
6213,聯茂,15,0,15,群益金鼎-松山,2023-04-26,9103
3624,光頡,12,0,12,群益金鼎-松山,2023-04-26,9103
3035,智原,21,11,10,群益金鼎-松山,2023-04-26,9103
1710,東聯,10,0,10,群益金鼎-松山,2023-04-26,9103
00664R,國泰臺灣加權反1,10,0,10,群益金鼎-松山,2023-04-26,9103
00720B,元大投資級公司債,10,0,10,群益金鼎-松山,2023-04-26,9103
2610,華航,10,0,10,群益金鼎-松山,2023-04-26,9103
6164,華興,10,0,10,群益金鼎-松山,2023-04-26,9103
8403,盛弘,10,0,10,群益金鼎-松山,2023-04-26,9103
00706L,期元大S＆P日圓正2,8,0,8,群益金鼎-松山,2023-04-26,9103
3479,安勤,9,1,8,群益金鼎-松山,2023-04-26,9103
6752,叡揚,10,2,8,群益金鼎-松山,2023-04-26,9103
1503,士電,28,20,8,群益金鼎-松山,2023-04-26,9103
00637L,元大滬深300正2,7,0,7,群益金鼎-松山,2023-04-26,9103
6770,力積電,18,11,7,群益金鼎-松山,2023-04-26,9103
3011,今皓,6,0,6,群益金鼎-松山,2023-04-26,9103
2457,飛宏,12,6,6,群益金鼎-松山,2023-04-26,9103
6472,保瑞,8,2,6,群益金鼎-松山,2023-04-26,9103
2201,裕隆,7,1,6,群益金鼎-松山,2023-04-26,9103
2886,兆豐金,5,0,5,群益金鼎-松山,2023-04-26,9103
3017,奇鋐,5,0,5,群益金鼎-松山,2023-04-26,9103
3163,波若威,5,0,5,群益金鼎-松山,2023-04-26,9103
6153,嘉聯益,5,0,5,群益金鼎-松山,2023-04-26,9103
6163,華電網,5,0,5,群益金鼎-松山,2023-04-26,9103
6285,啟��,5,0,5,群益金鼎-松山,2023-04-26,9103
6791,虎門科技,5,0,5,群益金鼎-松山,2023-04-26,9103
2615,萬海,5,0,5,群益金鼎-松山,2023-04-26,9103
00679B,元大美債20年,5,1,4,群益金鼎-松山,2023-04-26,9103
2344,華邦電,100,0,100,群益金鼎-松山,2023-04-27,9103
2352,佳世達,80,2,78,群益金鼎-松山,2023-04-27,9103
3363,上詮,71,12,59,群益金鼎-松山,2023-04-27,9103
2630,亞航,50,0,50,群益金鼎-松山,2023-04-27,9103
2634,漢翔,97,52,45,群益金鼎-松山,2023-04-27,9103
3078,僑威,43,1,42,群益金鼎-松山,2023-04-27,9103
6244,茂迪,70,32,38,群益金鼎-松山,2023-04-27,9103
2201,裕隆,42,6,36,群益金鼎-松山,2023-04-27,9103
1907,永豐餘,30,0,30,群益金鼎-松山,2023-04-27,9103
3017,奇鋐,35,10,25,群益金鼎-松山,2023-04-27,9103
6248,沛波,25,0,25,群益金鼎-松山,2023-04-27,9103
2453,凌群,34,10,24,群益金鼎-松山,2023-04-27,9103
2889,國票金,20,0,20,群益金鼎-松山,2023-04-27,9103
3712,永崴投控,20,0,20,群益金鼎-松山,2023-04-27,9103
4510,高鋒,20,0,20,群益金鼎-松山,2023-04-27,9103
8033,雷虎,20,0,20,群益金鼎-松山,2023-04-27,9103
8403,盛弘,30,13,17,群益金鼎-松山,2023-04-27,9103
1710,東聯,20,4,16,群益金鼎-松山,2023-04-27,9103
00715L,期街口布蘭特正2,15,0,15,群益金鼎-松山,2023-04-27,9103
00680L,元大美債20正2,15,0,15,群益金鼎-松山,2023-04-27,9103
4968,立積,13,0,13,群益金鼎-松山,2023-04-27,9103
0056,元大高股息,11,0,11,群益金鼎-松山,2023-04-27,9103
8349,�矬�,11,0,11,群益金鼎-松山,2023-04-27,9103
2886,兆豐金,10,0,10,群益金鼎-松山,2023-04-27,9103
3228,金麗科,10,0,10,群益金鼎-松山,2023-04-27,9103
6733,博晟生醫,10,0,10,群益金鼎-松山,2023-04-27,9103
2327,國巨,10,0,10,群益金鼎-松山,2023-04-27,9103
4967,十銓,24,15,9,群益金鼎-松山,2023-04-27,9103
6148,驊宏資,8,0,8,群益金鼎-松山,2023-04-27,9103
8086,宏捷科,8,0,8,群益金鼎-松山,2023-04-27,9103
2002,中鋼,7,0,7,群益金鼎-松山,2023-04-27,9103
00679B,元大美債20年,9,2,7,群益金鼎-松山,2023-04-27,9103
6282,康舒,24,17,7,群益金鼎-松山,2023-04-27,9103
1101,台泥,6,0,6,群益金鼎-松山,2023-04-27,9103
2482,連宇,11,5,6,群益金鼎-松山,2023-04-27,9103
00881,國泰台灣5G+,5,0,5,群益金鼎-松山,2023-04-27,9103
2371,大同,5,0,5,群益金鼎-松山,2023-04-27,9103
3454,晶睿,5,0,5,群益金鼎-松山,2023-04-27,9103
4566,時碩工業,8,3,5,群益金鼎-松山,2023-04-27,9103
5299,杰力,5,0,5,群益金鼎-松山,2023-04-27,9103
00878,國泰永續高股息,4,0,4,群益金鼎-松山,2023-04-27,9103
00753L,中信中國50正2,4,0,4,群益金鼎-松山,2023-04-27,9103
2317,鴻海,4,0,4,群益金鼎-松山,2023-04-27,9103
3105,穩懋,4,0,4,群益金鼎-松山,2023-04-27,9103
4162,智擎,4,0,4,群益金鼎-松山,2023-04-27,9103
4746,台耀,4,0,4,群益金鼎-松山,2023-04-27,9103
4763,材料-KY,16,12,4,群益金鼎-松山,2023-04-27,9103
6517,保勝光學,14,10,4,群益金鼎-松山,2023-04-27,9103
00706L,期元大S＆P日圓正2,3,0,3,群益金鼎-松山,2023-04-27,9103
2359,所羅門,9,6,3,群益金鼎-松山,2023-04-27,9103
3481,群創,160,1,159,群益金鼎-松山,2023-04-28,9103
00632R,元大台灣50反1,185,27,158,群益金鼎-松山,2023-04-28,9103
2409,友達,129,0,129,群益金鼎-松山,2023-04-28,9103
6282,康舒,94,5,89,群益金鼎-松山,2023-04-28,9103
00687B,國泰20年美債,81,0,81,群益金鼎-松山,2023-04-28,9103
2457,飛宏,64,4,60,群益金鼎-松山,2023-04-28,9103
1310,台苯,50,0,50,群益金鼎-松山,2023-04-28,9103
1909,榮成,50,0,50,群益金鼎-松山,2023-04-28,9103
1504,東元,45,1,44,群益金鼎-松山,2023-04-28,9103
2484,希華,42,1,41,群益金鼎-松山,2023-04-28,9103
6248,沛波,40,0,40,群益金鼎-松山,2023-04-28,9103
3078,僑威,41,3,38,群益金鼎-松山,2023-04-28,9103
3011,今皓,50,13,37,群益金鼎-松山,2023-04-28,9103
2208,台船,33,3,30,群益金鼎-松山,2023-04-28,9103
3712,永崴投控,30,0,30,群益金鼎-松山,2023-04-28,9103
6235,華孚,26,3,23,群益金鼎-松山,2023-04-28,9103
1907,永豐餘,20,0,20,群益金鼎-松山,2023-04-28,9103
3058,立德,20,0,20,群益金鼎-松山,2023-04-28,9103
3308,聯德,20,0,20,群益金鼎-松山,2023-04-28,9103
6733,博晟生醫,30,10,20,群益金鼎-松山,2023-04-28,9103
1905,華紙,150,136,14,群益金鼎-松山,2023-04-28,9103
2603,長榮,14,0,14,群益金鼎-松山,2023-04-28,9103
2471,資通,56,45,11,群益金鼎-松山,2023-04-28,9103
3704,合勤控,15,4,11,群益金鼎-松山,2023-04-28,9103
1710,東聯,10,0,10,群益金鼎-松山,2023-04-28,9103
00725B,國泰投資級公司債,10,0,10,群益金鼎-松山,2023-04-28,9103
4147,中裕,20,10,10,群益金鼎-松山,2023-04-28,9103
6706,惠特,10,0,10,群益金鼎-松山,2023-04-28,9103
6111,大宇資,12,2,10,群益金鼎-松山,2023-04-28,9103
2489,瑞軒,12,2,10,群益金鼎-松山,2023-04-28,9103
00706L,期元大S＆P日圓正2,9,0,9,群益金鼎-松山,2023-04-28,9103
6806,森崴能源,11,2,9,群益金鼎-松山,2023-04-28,9103
00753L,中信中國50正2,8,0,8,群益金鼎-松山,2023-04-28,9103
2609,陽明,8,0,8,群益金鼎-松山,2023-04-28,9103
3071,協禧,8,0,8,群益金鼎-松山,2023-04-28,9103
7402,邑錡,8,0,8,群益金鼎-松山,2023-04-28,9103
6753,龍德造船,20,13,7,群益金鼎-松山,2023-04-28,9103
00679B,元大美債20年,7,1,6,群益金鼎-松山,2023-04-28,9103
3035,智原,23,17,6,群益金鼎-松山,2023-04-28,9103
4541,晟田,12,6,6,群益金鼎-松山,2023-04-28,9103
2884,玉山金,5,0,5,群益金鼎-松山,2023-04-28,9103
1752,南光,10,5,5,群益金鼎-松山,2023-04-28,9103
2206,三陽工業,45,40,5,群益金鼎-松山,2023-04-28,9103
4510,高鋒,5,0,5,群益金鼎-松山,2023-04-28,9103
4572,駐龍,18,13,5,群益金鼎-松山,2023-04-28,9103
6104,創惟,12,7,5,群益金鼎-松山,2023-04-28,9103
6288,聯嘉,6,1,5,群益金鼎-松山,2023-04-28,9103
6751,智聯服務,5,0,5,群益金鼎-松山,2023-04-28,9103
8046,南電,37,32,5,群益金鼎-松山,2023-04-28,9103
8222,寶一,29,24,5,群益金鼎-松山,2023-04-28,9103
3363,上詮,149,8,141,群益金鼎-松山,2023-05-02,9103
00680L,元大美債20正2,100,0,100,群益金鼎-松山,2023-05-02,9103
1417,嘉裕,100,0,100,群益金鼎-松山,2023-05-02,9103
3078,僑威,98,4,94,群益金鼎-松山,2023-05-02,9103
2884,玉山金,70,0,70,群益金鼎-松山,2023-05-02,9103
4510,高鋒,55,0,55,群益金鼎-松山,2023-05-02,9103
6214,精誠,51,0,51,群益金鼎-松山,2023-05-02,9103
2206,三陽工業,118,83,35,群益金鼎-松山,2023-05-02,9103
1215,卜蜂,30,0,30,群益金鼎-松山,2023-05-02,9103
3522,御嵿,30,0,30,群益金鼎-松山,2023-05-02,9103
5211,蒙恬,30,0,30,群益金鼎-松山,2023-05-02,9103
6806,森崴能源,54,31,23,群益金鼎-松山,2023-05-02,9103
00632R,元大台灣50反1,20,0,20,群益金鼎-松山,2023-05-02,9103
1529,樂事綠能,23,3,20,群益金鼎-松山,2023-05-02,9103
8403,盛弘,21,1,20,群益金鼎-松山,2023-05-02,9103
1514,亞力,116,97,19,群益金鼎-松山,2023-05-02,9103
2913,農林,17,0,17,群益金鼎-松山,2023-05-02,9103
6741,91APP*-KY,19,2,17,群益金鼎-松山,2023-05-02,9103
00696B,富邦美債20年,15,0,15,群益金鼎-松山,2023-05-02,9103
1539,巨庭,14,0,14,群益金鼎-松山,2023-05-02,9103
00720B,元大投資級公司債,13,0,13,群益金鼎-松山,2023-05-02,9103
2482,連宇,72,59,13,群益金鼎-松山,2023-05-02,9103
4979,華星光,16,4,12,群益金鼎-松山,2023-05-02,9103
6706,惠特,12,0,12,群益金鼎-松山,2023-05-02,9103
00712,復華富時不動產,11,0,11,群益金鼎-松山,2023-05-02,9103
1810,和成,11,0,11,群益金鼎-松山,2023-05-02,9103
2736,富野,11,0,11,群益金鼎-松山,2023-05-02,9103
2603,長榮,10,0,10,群益金鼎-松山,2023-05-02,9103
00706L,期元大S＆P日圓正2,10,0,10,群益金鼎-松山,2023-05-02,9103
2392,正崴,10,0,10,群益金鼎-松山,2023-05-02,9103
2889,國票金,10,0,10,群益金鼎-松山,2023-05-02,9103
3058,立德,30,20,10,群益金鼎-松山,2023-05-02,9103
3265,台星科,10,0,10,群益金鼎-松山,2023-05-02,9103
6101,寬魚國際,10,0,10,群益金鼎-松山,2023-05-02,9103
6234,高僑,11,1,10,群益金鼎-松山,2023-05-02,9103
6288,聯嘉,10,0,10,群益金鼎-松山,2023-05-02,9103
4168,醣聯,9,0,9,群益金鼎-松山,2023-05-02,9103
8222,寶一,36,27,9,群益金鼎-松山,2023-05-02,9103
6112,邁達特,12,4,8,群益金鼎-松山,2023-05-02,9103
6118,建達,8,0,8,群益金鼎-松山,2023-05-02,9103
2497,怡利電,7,0,7,群益金鼎-松山,2023-05-02,9103
3228,金麗科,8,1,7,群益金鼎-松山,2023-05-02,9103
3454,晶睿,7,0,7,群益金鼎-松山,2023-05-02,9103
8114,振樺電,7,0,7,群益金鼎-松山,2023-05-02,9103
3081,聯亞,8,2,6,群益金鼎-松山,2023-05-02,9103
4911,德英,6,0,6,群益金鼎-松山,2023-05-02,9103
8040,九暘,8,2,6,群益金鼎-松山,2023-05-02,9103
1785,光洋科,5,0,5,群益金鼎-松山,2023-05-02,9103
00751B,元大AAA至A公司債,5,0,5,群益金鼎-松山,2023-05-02,9103
1609,大亞,6,1,5,群益金鼎-松山,2023-05-02,9103
1711,永光,133,0,133,群益金鼎-松山,2023-05-03,9103
3715,定穎投控,100,0,100,群益金鼎-松山,2023-05-03,9103
2417,圓剛,60,0,60,群益金鼎-松山,2023-05-03,9103
2634,漢翔,81,33,48,群益金鼎-松山,2023-05-03,9103
1101,台泥,41,0,41,群益金鼎-松山,2023-05-03,9103
3682,亞太電,40,0,40,群益金鼎-松山,2023-05-03,9103
5225,東科-KY,38,0,38,群益金鼎-松山,2023-05-03,9103
1609,大亞,35,0,35,群益金鼎-松山,2023-05-03,9103
1584,精剛,28,0,28,群益金鼎-松山,2023-05-03,9103
3419,譁裕,31,3,28,群益金鼎-松山,2023-05-03,9103
8222,寶一,59,41,18,群益金鼎-松山,2023-05-03,9103
1784,訊聯,23,6,17,群益金鼎-松山,2023-05-03,9103
1514,亞力,39,22,17,群益金鼎-松山,2023-05-03,9103
8033,雷虎,24,10,14,群益金鼎-松山,2023-05-03,9103
1519,華城,23,10,13,群益金鼎-松山,2023-05-03,9103
3058,立德,42,30,12,群益金鼎-松山,2023-05-03,9103
2603,長榮,13,1,12,群益金鼎-松山,2023-05-03,9103
00696B,富邦美債20年,11,0,11,群益金鼎-松山,2023-05-03,9103
2009,第一銅,10,0,10,群益金鼎-松山,2023-05-03,9103
2889,國票金,10,0,10,群益金鼎-松山,2023-05-03,9103
4119,旭富,10,0,10,群益金鼎-松山,2023-05-03,9103
3078,僑威,14,5,9,群益金鼎-松山,2023-05-03,9103
6214,精誠,9,0,9,群益金鼎-松山,2023-05-03,9103
5465,富驊,12,4,8,群益金鼎-松山,2023-05-03,9103
6625,必應,17,9,8,群益金鼎-松山,2023-05-03,9103
2482,連宇,9,2,7,群益金鼎-松山,2023-05-03,9103
4746,台耀,10,3,7,群益金鼎-松山,2023-05-03,9103
4915,致伸,7,0,7,群益金鼎-松山,2023-05-03,9103
8349,�矬�,7,0,7,群益金鼎-松山,2023-05-03,9103
2368,金像電,11,5,6,群益金鼎-松山,2023-05-03,9103
5371,中光電,8,2,6,群益金鼎-松山,2023-05-03,9103
6282,康舒,11,5,6,群益金鼎-松山,2023-05-03,9103
6517,保勝光學,7,1,6,群益金鼎-松山,2023-05-03,9103
6829,千附精密,11,5,6,群益金鼎-松山,2023-05-03,9103
1440,南紡,5,0,5,群益金鼎-松山,2023-05-03,9103
4147,中裕,10,5,5,群益金鼎-松山,2023-05-03,9103
6288,聯嘉,5,0,5,群益金鼎-松山,2023-05-03,9103
00650L,復華香港正2,4,0,4,群益金鼎-松山,2023-05-03,9103
2206,三陽工業,22,18,4,群益金鼎-松山,2023-05-03,9103
2453,凌群,5,1,4,群益金鼎-松山,2023-05-03,9103
3017,奇鋐,4,0,4,群益金鼎-松山,2023-05-03,9103
6548,長科*,4,0,4,群益金鼎-松山,2023-05-03,9103
00715L,期街口布蘭特正2,3,0,3,群益金鼎-松山,2023-05-03,9103
4121,優盛,5,2,3,群益金鼎-松山,2023-05-03,9103
4728,雙美,3,0,3,群益金鼎-松山,2023-05-03,9103
2913,農林,3,1,2,群益金鼎-松山,2023-05-03,9103
00917,中信特選金融,2,0,2,群益金鼎-松山,2023-05-03,9103
00878,國泰永續高股息,2,0,2,群益金鼎-松山,2023-05-03,9103
00857B,永豐20年美公債,2,0,2,群益金鼎-松山,2023-05-03,9103
00795B,中信美國公債20年,2,0,2,群益金鼎-松山,2023-05-03,9103
00878,國泰永續高股息,90,0,90,群益金鼎-松山,2023-05-04,9103
5225,東科-KY,89,1,88,群益金鼎-松山,2023-05-04,9103
3481,群創,65,0,65,群益金鼎-松山,2023-05-04,9103
1905,華紙,51,0,51,群益金鼎-松山,2023-05-04,9103
2912,統一超,50,2,48,群益金鼎-松山,2023-05-04,9103
8121,越峰,40,0,40,群益金鼎-松山,2023-05-04,9103
1721,三晃,35,0,35,群益金鼎-松山,2023-05-04,9103
6733,博晟生醫,33,0,33,群益金鼎-松山,2023-05-04,9103
1731,美吾華,30,0,30,群益金鼎-松山,2023-05-04,9103
2031,新光鋼,30,0,30,群益金鼎-松山,2023-05-04,9103
2201,裕隆,30,0,30,群益金鼎-松山,2023-05-04,9103
4121,優盛,71,43,28,群益金鼎-松山,2023-05-04,9103
4174,浩鼎,23,0,23,群益金鼎-松山,2023-05-04,9103
00715L,期街口布蘭特正2,22,0,22,群益金鼎-松山,2023-05-04,9103
00632R,元大台灣50反1,20,0,20,群益金鼎-松山,2023-05-04,9103
3058,立德,50,30,20,群益金鼎-松山,2023-05-04,9103
1529,樂事綠能,92,73,19,群益金鼎-松山,2023-05-04,9103
3673,TPK-KY,25,6,19,群益金鼎-松山,2023-05-04,9103
8349,�矬�,20,1,19,群益金鼎-松山,2023-05-04,9103
1711,永光,20,4,16,群益金鼎-松山,2023-05-04,9103
1609,大亞,40,26,14,群益金鼎-松山,2023-05-04,9103
00696B,富邦美債20年,14,0,14,群益金鼎-松山,2023-05-04,9103
2489,瑞軒,22,10,12,群益金鼎-松山,2023-05-04,9103
2482,連宇,11,0,11,群益金鼎-松山,2023-05-04,9103
1528,恩德,10,0,10,群益金鼎-松山,2023-05-04,9103
2344,華邦電,10,0,10,群益金鼎-松山,2023-05-04,9103
2388,威盛,10,0,10,群益金鼎-松山,2023-05-04,9103
2495,普安,10,0,10,群益金鼎-松山,2023-05-04,9103
3005,神基,11,1,10,群益金鼎-松山,2023-05-04,9103
4119,旭富,10,0,10,群益金鼎-松山,2023-05-04,9103
8403,盛弘,70,61,9,群益金鼎-松山,2023-05-04,9103
3078,僑威,9,1,8,群益金鼎-松山,2023-05-04,9103
6548,長科*,8,0,8,群益金鼎-松山,2023-05-04,9103
8050,廣積,8,0,8,群益金鼎-松山,2023-05-04,9103
8069,元太,8,1,7,群益金鼎-松山,2023-05-04,9103
1514,亞力,12,6,6,群益金鼎-松山,2023-05-04,9103
1795,美時,13,7,6,群益金鼎-松山,2023-05-04,9103
2359,所羅門,6,0,6,群益金鼎-松山,2023-05-04,9103
2453,凌群,6,0,6,群益金鼎-松山,2023-05-04,9103
3016,嘉晶,6,0,6,群益金鼎-松山,2023-05-04,9103
3071,協禧,8,2,6,群益金鼎-松山,2023-05-04,9103
4746,台耀,12,6,6,群益金鼎-松山,2023-05-04,9103
5388,中磊,6,0,6,群益金鼎-松山,2023-05-04,9103
2204,中華,5,0,5,群益金鼎-松山,2023-05-04,9103
2702,華園,5,0,5,群益金鼎-松山,2023-05-04,9103
5009,榮剛,19,14,5,群益金鼎-松山,2023-05-04,9103
6104,創惟,5,0,5,群益金鼎-松山,2023-05-04,9103
6806,森崴能源,26,21,5,群益金鼎-松山,2023-05-04,9103
2023,燁輝,4,0,4,群益金鼎-松山,2023-05-04,9103
2609,陽明,4,0,4,群益金鼎-松山,2023-05-04,9103
6282,康舒,493,80,413,群益金鼎-松山,2023-05-05,9103
4114,健喬,417,50,367,群益金鼎-松山,2023-05-05,9103
2618,長榮航,200,0,200,群益金鼎-松山,2023-05-05,9103
6005,群益證,100,0,100,群益金鼎-松山,2023-05-05,9103
1609,大亞,127,35,92,群益金鼎-松山,2023-05-05,9103
00632R,元大台灣50反1,65,0,65,群益金鼎-松山,2023-05-05,9103
0056,元大高股息,50,7,43,群益金鼎-松山,2023-05-05,9103
00720B,元大投資級公司債,35,0,35,群益金鼎-松山,2023-05-05,9103
1584,精剛,32,0,32,群益金鼎-松山,2023-05-05,9103
1810,和成,30,0,30,群益金鼎-松山,2023-05-05,9103
4111,濟生,30,0,30,群益金鼎-松山,2023-05-05,9103
9962,有益,32,2,30,群益金鼎-松山,2023-05-05,9103
3005,神基,45,16,29,群益金鼎-松山,2023-05-05,9103
2457,飛宏,29,2,27,群益金鼎-松山,2023-05-05,9103
2727,王品,28,5,23,群益金鼎-松山,2023-05-05,9103
2886,兆豐金,21,0,21,群益金鼎-松山,2023-05-05,9103
6257,矽格,21,0,21,群益金鼎-松山,2023-05-05,9103
2471,資通,23,3,20,群益金鼎-松山,2023-05-05,9103
8349,�矬�,20,0,20,群益金鼎-松山,2023-05-05,9103
00696B,富邦美債20年,18,0,18,群益金鼎-松山,2023-05-05,9103
3017,奇鋐,23,8,15,群益金鼎-松山,2023-05-05,9103
2382,廣達,14,0,14,群益金鼎-松山,2023-05-05,9103
00772B,中信高評級公司債,12,0,12,群益金鼎-松山,2023-05-05,9103
8390,金益鼎,14,2,12,群益金鼎-松山,2023-05-05,9103
00878,國泰永續高股息,12,1,11,群益金鼎-松山,2023-05-05,9103
2542,興富發,11,0,11,群益金鼎-松山,2023-05-05,9103
3035,智原,13,2,11,群益金鼎-松山,2023-05-05,9103
1519,華城,33,23,10,群益金鼎-松山,2023-05-05,9103
4164,承業醫,10,0,10,群益金鼎-松山,2023-05-05,9103
8033,雷虎,10,0,10,群益金鼎-松山,2023-05-05,9103
1727,中華化,30,21,9,群益金鼎-松山,2023-05-05,9103
4541,晟田,12,3,9,群益金鼎-松山,2023-05-05,9103
2206,三陽工業,39,31,8,群益金鼎-松山,2023-05-05,9103
8403,盛弘,18,10,8,群益金鼎-松山,2023-05-05,9103
1513,中興電,11,4,7,群益金鼎-松山,2023-05-05,9103
2482,連宇,21,14,7,群益金鼎-松山,2023-05-05,9103
4743,合一,6,0,6,群益金鼎-松山,2023-05-05,9103
0050,元大台灣50,6,0,6,群益金鼎-松山,2023-05-05,9103
00715L,期街口布蘭特正2,6,0,6,群益金鼎-松山,2023-05-05,9103
1718,中纖,6,0,6,群益金鼎-松山,2023-05-05,9103
2353,宏��,6,0,6,群益金鼎-松山,2023-05-05,9103
2453,凌群,36,30,6,群益金鼎-松山,2023-05-05,9103
2614,東森,5,0,5,群益金鼎-松山,2023-05-05,9103
2609,陽明,5,0,5,群益金鼎-松山,2023-05-05,9103
2888,新光金,5,0,5,群益金鼎-松山,2023-05-05,9103
3558,神準,5,0,5,群益金鼎-松山,2023-05-05,9103
6218,豪勉,7,2,5,群益金鼎-松山,2023-05-05,9103
6266,泰詠,5,0,5,群益金鼎-松山,2023-05-05,9103
8121,越峰,5,0,5,群益金鼎-松山,2023-05-05,9103
1784,訊聯,9,5,4,群益金鼎-松山,2023-05-05,9103
2409,友達,300,201,99,群益金鼎-松山,2023-05-08,9103
00632R,元大台灣50反1,80,0,80,群益金鼎-松山,2023-05-08,9103
6770,力積電,70,0,70,群益金鼎-松山,2023-05-08,9103
0056,元大高股息,66,5,61,群益金鼎-松山,2023-05-08,9103
3029,零壹,85,32,53,群益金鼎-松山,2023-05-08,9103
2031,新光鋼,35,1,34,群益金鼎-松山,2023-05-08,9103
1605,華新,35,2,33,群益金鼎-松山,2023-05-08,9103
2883,凱基金,32,0,32,群益金鼎-松山,2023-05-08,9103
1907,永豐餘,30,0,30,群益金鼎-松山,2023-05-08,9103
2301,光寶科,30,0,30,群益金鼎-松山,2023-05-08,9103
3545,敦泰,31,1,30,群益金鼎-松山,2023-05-08,9103
1584,精剛,29,2,27,群益金鼎-松山,2023-05-08,9103
1218,泰山,22,0,22,群益金鼎-松山,2023-05-08,9103
6173,信昌電,21,0,21,群益金鼎-松山,2023-05-08,9103
2482,連宇,73,53,20,群益金鼎-松山,2023-05-08,9103
3362,先進光,20,0,20,群益金鼎-松山,2023-05-08,9103
2006,東和鋼鐵,20,0,20,群益金鼎-松山,2023-05-08,9103
8033,雷虎,54,36,18,群益金鼎-松山,2023-05-08,9103
3149,正達,15,0,15,群益金鼎-松山,2023-05-08,9103
2609,陽明,15,2,13,群益金鼎-松山,2023-05-08,9103
6274,台燿,13,1,12,群益金鼎-松山,2023-05-08,9103
2748,雲品,11,0,11,群益金鼎-松山,2023-05-08,9103
1513,中興電,42,31,11,群益金鼎-松山,2023-05-08,9103
00696B,富邦美債20年,10,0,10,群益金鼎-松山,2023-05-08,9103
6125,廣運,10,0,10,群益金鼎-松山,2023-05-08,9103
6290,良維,10,0,10,群益金鼎-松山,2023-05-08,9103
2104,國際中橡,10,1,9,群益金鼎-松山,2023-05-08,9103
5009,榮剛,31,22,9,群益金鼎-松山,2023-05-08,9103
0050,元大台灣50,10,2,8,群益金鼎-松山,2023-05-08,9103
1503,士電,45,37,8,群益金鼎-松山,2023-05-08,9103
2317,鴻海,8,0,8,群益金鼎-松山,2023-05-08,9103
00878,國泰永續高股息,7,0,7,群益金鼎-松山,2023-05-08,9103
5347,世界,7,0,7,群益金鼎-松山,2023-05-08,9103
00751B,元大AAA至A公司債,6,0,6,群益金鼎-松山,2023-05-08,9103
3228,金麗科,6,0,6,群益金鼎-松山,2023-05-08,9103
5211,蒙恬,6,0,6,群益金鼎-松山,2023-05-08,9103
5703,亞都,6,0,6,群益金鼎-松山,2023-05-08,9103
6625,必應,11,5,6,群益金鼎-松山,2023-05-08,9103
8040,九暘,6,0,6,群益金鼎-松山,2023-05-08,9103
8099,大世科,26,20,6,群益金鼎-松山,2023-05-08,9103
8349,�矬�,6,0,6,群益金鼎-松山,2023-05-08,9103
5321,美而快,8,2,6,群益金鼎-松山,2023-05-08,9103
00715L,期街口布蘭特正2,20,15,5,群益金鼎-松山,2023-05-08,9103
1785,光洋科,5,0,5,群益金鼎-松山,2023-05-08,9103
2702,華園,5,0,5,群益金鼎-松山,2023-05-08,9103
3056,富華新,5,0,5,群益金鼎-松山,2023-05-08,9103
3479,安勤,5,0,5,群益金鼎-松山,2023-05-08,9103
4147,中裕,10,5,5,群益金鼎-松山,2023-05-08,9103
6143,振曜,15,10,5,群益金鼎-松山,2023-05-08,9103
6470,宇智,5,0,5,群益金鼎-松山,2023-05-08,9103
00680L,元大美債20正2,136,0,136,群益金鼎-松山,2023-05-09,9103
1905,華紙,67,1,66,群益金鼎-松山,2023-05-09,9103
2031,新光鋼,55,0,55,群益金鼎-松山,2023-05-09,9103
1504,東元,66,26,40,群益金鼎-松山,2023-05-09,9103
1101,台泥,30,0,30,群益金鼎-松山,2023-05-09,9103
6282,康舒,30,0,30,群益金鼎-松山,2023-05-09,9103
00696B,富邦美債20年,21,0,21,群益金鼎-松山,2023-05-09,9103
00673R,期元大S＆P原油反1,20,0,20,群益金鼎-松山,2023-05-09,9103
00720B,元大投資級公司債,20,2,18,群益金鼎-松山,2023-05-09,9103
2421,建準,24,6,18,群益金鼎-松山,2023-05-09,9103
8040,九暘,20,2,18,群益金鼎-松山,2023-05-09,9103
4744,皇將,18,1,17,群益金鼎-松山,2023-05-09,9103
00632R,元大台灣50反1,10,0,10,群益金鼎-松山,2023-05-09,9103
2889,國票金,10,0,10,群益金鼎-松山,2023-05-09,9103
4164,承業醫,10,0,10,群益金鼎-松山,2023-05-09,9103
6173,信昌電,10,0,10,群益金鼎-松山,2023-05-09,9103
00882,中信中國高股息,10,1,9,群益金鼎-松山,2023-05-09,9103
3338,泰碩,12,3,9,群益金鼎-松山,2023-05-09,9103
3484,崧騰,9,0,9,群益金鼎-松山,2023-05-09,9103
4967,十銓,7,0,7,群益金鼎-松山,2023-05-09,9103
3693,營邦,12,5,7,群益金鼎-松山,2023-05-09,9103
3011,今皓,17,10,7,群益金鼎-松山,2023-05-09,9103
2022,聚亨,6,0,6,群益金鼎-松山,2023-05-09,9103
2851,中再保,6,0,6,群益金鼎-松山,2023-05-09,9103
6706,惠特,6,0,6,群益金鼎-松山,2023-05-09,9103
6770,力積電,13,7,6,群益金鼎-松山,2023-05-09,9103
6446,藥華藥,5,0,5,群益金鼎-松山,2023-05-09,9103
00751B,元大AAA至A公司債,5,0,5,群益金鼎-松山,2023-05-09,9103
1721,三晃,5,0,5,群益金鼎-松山,2023-05-09,9103
3078,僑威,5,0,5,群益金鼎-松山,2023-05-09,9103
3149,正達,5,0,5,群益金鼎-松山,2023-05-09,9103
4161,聿新科,5,0,5,群益金鼎-松山,2023-05-09,9103
4746,台耀,5,0,5,群益金鼎-松山,2023-05-09,9103
4768,晶呈科技,5,0,5,群益金鼎-松山,2023-05-09,9103
6122,擎邦,5,0,5,群益金鼎-松山,2023-05-09,9103
6127,九豪,5,0,5,群益金鼎-松山,2023-05-09,9103
6129,普誠,5,0,5,群益金鼎-松山,2023-05-09,9103
6791,虎門科技,5,0,5,群益金鼎-松山,2023-05-09,9103
8341,日友,5,0,5,群益金鼎-松山,2023-05-09,9103
1784,訊聯,5,1,4,群益金鼎-松山,2023-05-09,9103
3454,晶睿,6,2,4,群益金鼎-松山,2023-05-09,9103
3576,聯合再生,4,0,4,群益金鼎-松山,2023-05-09,9103
6016,康和證,4,0,4,群益金鼎-松山,2023-05-09,9103
6244,茂迪,7,3,4,群益金鼎-松山,2023-05-09,9103
6432,今展科,4,0,4,群益金鼎-松山,2023-05-09,9103
8349,�矬�,4,0,4,群益金鼎-松山,2023-05-09,9103
00772B,中信高評級公司債,3,0,3,群益金鼎-松山,2023-05-09,9103
1568,倉佑,3,0,3,群益金鼎-松山,2023-05-09,9103
1789,神隆,3,0,3,群益金鼎-松山,2023-05-09,9103
2913,農林,3,0,3,群益金鼎-松山,2023-05-09,9103
6213,聯茂,108,0,108,群益金鼎-松山,2023-05-10,9103
3481,群創,200,100,100,群益金鼎-松山,2023-05-10,9103
2376,技嘉,46,0,46,群益金鼎-松山,2023-05-10,9103
3232,昱捷,40,0,40,群益金鼎-松山,2023-05-10,9103
8403,盛弘,35,0,35,群益金鼎-松山,2023-05-10,9103
00680L,元大美債20正2,30,0,30,群益金鼎-松山,2023-05-10,9103
8940,新天地,29,0,29,群益金鼎-松山,2023-05-10,9103
2610,華航,25,1,24,群益金鼎-松山,2023-05-10,9103
2206,三陽工業,23,0,23,群益金鼎-松山,2023-05-10,9103
8222,寶一,39,17,22,群益金鼎-松山,2023-05-10,9103
6689,伊雲谷,21,0,21,群益金鼎-松山,2023-05-10,9103
6160,欣技,28,8,20,群益金鼎-松山,2023-05-10,9103
6770,力積電,20,0,20,群益金鼎-松山,2023-05-10,9103
1529,樂事綠能,20,0,20,群益金鼎-松山,2023-05-10,9103
1609,大亞,48,32,16,群益金鼎-松山,2023-05-10,9103
6443,元晶,16,1,15,群益金鼎-松山,2023-05-10,9103
3231,緯創,20,6,14,群益金鼎-松山,2023-05-10,9103
2489,瑞軒,14,1,13,群益金鼎-松山,2023-05-10,9103
2413,環科,12,0,12,群益金鼎-松山,2023-05-10,9103
6585,鼎基,12,0,12,群益金鼎-松山,2023-05-10,9103
00696B,富邦美債20年,11,0,11,群益金鼎-松山,2023-05-10,9103
2482,連宇,15,4,11,群益金鼎-松山,2023-05-10,9103
3011,今皓,14,3,11,群益金鼎-松山,2023-05-10,9103
8038,長園科,12,1,11,群益金鼎-松山,2023-05-10,9103
1752,南光,10,0,10,群益金鼎-松山,2023-05-10,9103
00633L,富邦上証正2,10,0,10,群益金鼎-松山,2023-05-10,9103
2337,旺宏,10,0,10,群益金鼎-松山,2023-05-10,9103
3013,晟銘電,10,0,10,群益金鼎-松山,2023-05-10,9103
4714,永捷,10,0,10,群益金鼎-松山,2023-05-10,9103
6191,精成科,10,0,10,群益金鼎-松山,2023-05-10,9103
00878,國泰永續高股息,9,0,9,群益金鼎-松山,2023-05-10,9103
2382,廣達,13,4,9,群益金鼎-松山,2023-05-10,9103
4744,皇將,8,0,8,群益金鼎-松山,2023-05-10,9103
1316,上曜,7,0,7,群益金鼎-松山,2023-05-10,9103
3044,健鼎,7,0,7,群益金鼎-松山,2023-05-10,9103
3093,港建*,7,0,7,群益金鼎-松山,2023-05-10,9103
6148,驊宏資,7,0,7,群益金鼎-松山,2023-05-10,9103
00687B,國泰20年美債,6,0,6,群益金鼎-松山,2023-05-10,9103
1611,中電,6,0,6,群益金鼎-松山,2023-05-10,9103
3078,僑威,6,0,6,群益金鼎-松山,2023-05-10,9103
6196,帆宣,6,0,6,群益金鼎-松山,2023-05-10,9103
6550,北極星藥業-KY,6,0,6,群益金鼎-松山,2023-05-10,9103
9945,潤泰新,6,0,6,群益金鼎-松山,2023-05-10,9103
2603,長榮,6,0,6,群益金鼎-松山,2023-05-10,9103
00720B,元大投資級公司債,5,0,5,群益金鼎-松山,2023-05-10,9103
00688L,國泰20年美債正2,5,0,5,群益金鼎-松山,2023-05-10,9103
00650L,復華香港正2,5,0,5,群益金鼎-松山,2023-05-10,9103
1503,士電,15,10,5,群益金鼎-松山,2023-05-10,9103
2888,新光金,5,0,5,群益金鼎-松山,2023-05-10,9103
6752,叡揚,5,0,5,群益金鼎-松山,2023-05-10,9103
3011,今皓,112,7,105,群益金鼎-松山,2023-05-11,9103
3481,群創,67,0,67,群益金鼎-松山,2023-05-11,9103
1101,台泥,30,0,30,群益金鼎-松山,2023-05-11,9103
4510,高鋒,30,0,30,群益金鼎-松山,2023-05-11,9103
6235,華孚,32,2,30,群益金鼎-松山,2023-05-11,9103
4967,十銓,21,0,21,群益金鼎-松山,2023-05-11,9103
1513,中興電,16,0,16,群益金鼎-松山,2023-05-11,9103
2634,漢翔,14,0,14,群益金鼎-松山,2023-05-11,9103
4503,金雨,15,2,13,群益金鼎-松山,2023-05-11,9103
6768,志強-KY,12,0,12,群益金鼎-松山,2023-05-11,9103
1514,亞力,11,0,11,群益金鼎-松山,2023-05-11,9103
00878,國泰永續高股息,11,0,11,群益金鼎-松山,2023-05-11,9103
2337,旺宏,11,0,11,群益金鼎-松山,2023-05-11,9103
1417,嘉裕,10,0,10,群益金鼎-松山,2023-05-11,9103
2312,金寶,10,0,10,群益金鼎-松山,2023-05-11,9103
2328,廣宇,10,0,10,群益金鼎-松山,2023-05-11,9103
2409,友達,20,10,10,群益金鼎-松山,2023-05-11,9103
2610,華航,110,100,10,群益金鼎-松山,2023-05-11,9103
2883,凱基金,10,0,10,群益金鼎-松山,2023-05-11,9103
3013,晟銘電,10,0,10,群益金鼎-松山,2023-05-11,9103
5347,世界,14,4,10,群益金鼎-松山,2023-05-11,9103
2208,台船,10,0,10,群益金鼎-松山,2023-05-11,9103
1591,駿吉-KY,8,0,8,群益金鼎-松山,2023-05-11,9103
6806,森崴能源,9,1,8,群益金鼎-松山,2023-05-11,9103
3596,智易,7,0,7,群益金鼎-松山,2023-05-11,9103
8038,長園科,6,0,6,群益金鼎-松山,2023-05-11,9103
00881,國泰台灣5G+,5,0,5,群益金鼎-松山,2023-05-11,9103
2376,技嘉,5,0,5,群益金鼎-松山,2023-05-11,9103
2405,輔信,5,0,5,群益金鼎-松山,2023-05-11,9103
3017,奇鋐,5,0,5,群益金鼎-松山,2023-05-11,9103
3035,智原,8,3,5,群益金鼎-松山,2023-05-11,9103
3092,鴻碩,5,0,5,群益金鼎-松山,2023-05-11,9103
3149,正達,5,0,5,群益金鼎-松山,2023-05-11,9103
3701,大眾控,5,0,5,群益金鼎-松山,2023-05-11,9103
4968,立積,7,2,5,群益金鼎-松山,2023-05-11,9103
6196,帆宣,5,0,5,群益金鼎-松山,2023-05-11,9103
2317,鴻海,4,0,4,群益金鼎-松山,2023-05-11,9103
1503,士電,4,0,4,群益金鼎-松山,2023-05-11,9103
00706L,期元大S＆P日圓正2,4,0,4,群益金鼎-松山,2023-05-11,9103
2106,建大,4,0,4,群益金鼎-松山,2023-05-11,9103
2542,興富發,4,0,4,群益金鼎-松山,2023-05-11,9103
9907,統一實,4,0,4,群益金鼎-松山,2023-05-11,9103
8084,巨虹,6,2,4,群益金鼎-松山,2023-05-11,9103
00720B,元大投資級公司債,3,0,3,群益金鼎-松山,2023-05-11,9103
1316,上曜,9,6,3,群益金鼎-松山,2023-05-11,9103
2413,環科,3,0,3,群益金鼎-松山,2023-05-11,9103
2645,長榮航太,3,0,3,群益金鼎-松山,2023-05-11,9103
2851,中再保,3,0,3,群益金鼎-松山,2023-05-11,9103
3037,欣興,3,0,3,群益金鼎-松山,2023-05-11,9103
3094,聯傑,3,0,3,群益金鼎-松山,2023-05-11,9103
2313,華通,200,0,200,群益金鼎-松山,2023-05-12,9103
5258,虹堡,52,4,48,群益金鼎-松山,2023-05-12,9103
3682,亞太電,40,0,40,群益金鼎-松山,2023-05-12,9103
2206,三陽工業,61,26,35,群益金鼎-松山,2023-05-12,9103
00680L,元大美債20正2,50,20,30,群益金鼎-松山,2023-05-12,9103
1609,大亞,30,2,28,群益金鼎-松山,2023-05-12,9103
1584,精剛,27,0,27,群益金鼎-松山,2023-05-12,9103
2634,漢翔,20,0,20,群益金鼎-松山,2023-05-12,9103
6213,聯茂,21,2,19,群益金鼎-松山,2023-05-12,9103
6570,維田,19,0,19,群益金鼎-松山,2023-05-12,9103
2457,飛宏,21,3,18,群益金鼎-松山,2023-05-12,9103
1742,台蠟,17,0,17,群益金鼎-松山,2023-05-12,9103
2421,建準,16,0,16,群益金鼎-松山,2023-05-12,9103
2882,國泰金,13,0,13,群益金鼎-松山,2023-05-12,9103
1503,士電,14,1,13,群益金鼎-松山,2023-05-12,9103
00878,國泰永續高股息,13,1,12,群益金鼎-松山,2023-05-12,9103
2889,國票金,11,0,11,群益金鼎-松山,2023-05-12,9103
1529,樂事綠能,32,22,10,群益金鼎-松山,2023-05-12,9103
2489,瑞軒,10,0,10,群益金鼎-松山,2023-05-12,9103
2610,華航,10,0,10,群益金鼎-松山,2023-05-12,9103
2913,農林,10,0,10,群益金鼎-松山,2023-05-12,9103
3011,今皓,10,0,10,群益金鼎-松山,2023-05-12,9103
6188,廣明,20,10,10,群益金鼎-松山,2023-05-12,9103
8085,福華,10,0,10,群益金鼎-松山,2023-05-12,9103
8099,大世科,12,2,10,群益金鼎-松山,2023-05-12,9103
9941,裕融,10,0,10,群益金鼎-松山,2023-05-12,9103
1519,華城,31,22,9,群益金鼎-松山,2023-05-12,9103
2888,新光金,8,0,8,群益金鼎-松山,2023-05-12,9103
3034,聯詠,8,0,8,群益金鼎-松山,2023-05-12,9103
6517,保勝光學,8,0,8,群益金鼎-松山,2023-05-12,9103
6282,康舒,7,0,7,群益金鼎-松山,2023-05-12,9103
1514,亞力,8,2,6,群益金鼎-松山,2023-05-12,9103
1605,華新,5,0,5,群益金鼎-松山,2023-05-12,9103
1736,喬山,5,0,5,群益金鼎-松山,2023-05-12,9103
1101,台泥,15,10,5,群益金鼎-松山,2023-05-12,9103
2317,鴻海,6,1,5,群益金鼎-松山,2023-05-12,9103
2603,長榮,5,0,5,群益金鼎-松山,2023-05-12,9103
4979,華星光,5,0,5,群益金鼎-松山,2023-05-12,9103
5498,凱崴,5,0,5,群益金鼎-松山,2023-05-12,9103
6515,穎崴,6,1,5,群益金鼎-松山,2023-05-12,9103
6625,必應,10,5,5,群益金鼎-松山,2023-05-12,9103
8227,巨有科技,5,0,5,群益金鼎-松山,2023-05-12,9103
8454,富邦媒,5,0,5,群益金鼎-松山,2023-05-12,9103
2883,凱基金,4,0,4,群益金鼎-松山,2023-05-12,9103
6223,旺矽,4,0,4,群益金鼎-松山,2023-05-12,9103
00754B,群益AAA-AA公司,4,0,4,群益金鼎-松山,2023-05-12,9103
1784,訊聯,6,2,4,群益金鼎-松山,2023-05-12,9103
2376,技嘉,3,0,3,群益金鼎-松山,2023-05-12,9103
2542,興富發,3,0,3,群益金鼎-松山,2023-05-12,9103
3058,立德,3,0,3,群益金鼎-松山,2023-05-12,9103
00632R,元大台灣50反1,160,0,160,群益金鼎-松山,2023-05-15,9103
3011,今皓,104,0,104,群益金鼎-松山,2023-05-15,9103
9941,裕融,90,0,90,群益金鼎-松山,2023-05-15,9103
1504,東元,55,31,24,群益金鼎-松山,2023-05-15,9103
1584,精剛,21,0,21,群益金鼎-松山,2023-05-15,9103
2201,裕隆,21,0,21,群益金鼎-松山,2023-05-15,9103
1727,中華化,28,11,17,群益金鼎-松山,2023-05-15,9103
3231,緯創,18,2,16,群益金鼎-松山,2023-05-15,9103
3701,大眾控,14,0,14,群益金鼎-松山,2023-05-15,9103
1101,台泥,12,1,11,群益金鼎-松山,2023-05-15,9103
8033,雷虎,11,0,11,群益金鼎-松山,2023-05-15,9103
8038,長園科,12,1,11,群益金鼎-松山,2023-05-15,9103
1711,永光,10,0,10,群益金鼎-松山,2023-05-15,9103
2009,第一銅,10,0,10,群益金鼎-松山,2023-05-15,9103
00633L,富邦上証正2,10,0,10,群益金鼎-松山,2023-05-15,9103
2412,中華電,10,0,10,群益金鼎-松山,2023-05-15,9103
8021,尖點,10,0,10,群益金鼎-松山,2023-05-15,9103
2356,英業達,10,1,9,群益金鼎-松山,2023-05-15,9103
8926,台汽電,10,1,9,群益金鼎-松山,2023-05-15,9103
2371,大同,51,44,7,群益金鼎-松山,2023-05-15,9103
6625,必應,12,5,7,群益金鼎-松山,2023-05-15,9103
2542,興富發,6,0,6,群益金鼎-松山,2023-05-15,9103
6235,華孚,19,13,6,群益金鼎-松山,2023-05-15,9103
6472,保瑞,13,7,6,群益金鼎-松山,2023-05-15,9103
5871,中租-KY,5,0,5,群益金鼎-松山,2023-05-15,9103
2457,飛宏,16,11,5,群益金鼎-松山,2023-05-15,9103
2482,連宇,5,0,5,群益金鼎-松山,2023-05-15,9103
3376,新日興,5,0,5,群益金鼎-松山,2023-05-15,9103
4967,十銓,16,11,5,群益金鼎-松山,2023-05-15,9103
4968,立積,5,0,5,群益金鼎-松山,2023-05-15,9103
6173,信昌電,5,0,5,群益金鼎-松山,2023-05-15,9103
8046,南電,9,4,5,群益金鼎-松山,2023-05-15,9103
8433,弘帆,5,0,5,群益金鼎-松山,2023-05-15,9103
2614,東森,5,0,5,群益金鼎-松山,2023-05-15,9103
00637L,元大滬深300正2,11,7,4,群益金鼎-松山,2023-05-15,9103
2250,IKKA-KY,4,0,4,群益金鼎-松山,2023-05-15,9103
2883,凱基金,4,0,4,群益金鼎-松山,2023-05-15,9103
6768,志強-KY,4,0,4,群益金鼎-松山,2023-05-15,9103
00830,國泰費城半導體,3,0,3,群益金鼎-松山,2023-05-15,9103
2382,廣達,6,3,3,群益金鼎-松山,2023-05-15,9103
4147,中裕,3,0,3,群益金鼎-松山,2023-05-15,9103
5283,禾聯碩,3,0,3,群益金鼎-松山,2023-05-15,9103
5347,世界,3,0,3,群益金鼎-松山,2023-05-15,9103
6122,擎邦,3,0,3,群益金鼎-松山,2023-05-15,9103
6143,振曜,3,0,3,群益金鼎-松山,2023-05-15,9103
6244,茂迪,3,0,3,群益金鼎-松山,2023-05-15,9103
8299,群聯,3,0,3,群益金鼎-松山,2023-05-15,9103
8409,商之器,3,0,3,群益金鼎-松山,2023-05-15,9103
2618,長榮航,16,13,3,群益金鼎-松山,2023-05-15,9103
2317,鴻海,2,0,2,群益金鼎-松山,2023-05-15,9103
00632R,元大台灣50反1,90,0,90,群益金鼎-松山,2023-05-16,9103
2884,玉山金,50,0,50,群益金鼎-松山,2023-05-16,9103
1584,精剛,46,0,46,群益金鼎-松山,2023-05-16,9103
00720B,元大投資級公司債,37,0,37,群益金鼎-松山,2023-05-16,9103
00680L,元大美債20正2,32,0,32,群益金鼎-松山,2023-05-16,9103
1905,華紙,31,0,31,群益金鼎-松山,2023-05-16,9103
2002,中鋼,25,0,25,群益金鼎-松山,2023-05-16,9103
5351,鈺創,25,2,23,群益金鼎-松山,2023-05-16,9103
00878,國泰永續高股息,27,5,22,群益金鼎-松山,2023-05-16,9103
1709,和益,20,0,20,群益金鼎-松山,2023-05-16,9103
3078,僑威,20,0,20,群益金鼎-松山,2023-05-16,9103
1519,華城,27,10,17,群益金鼎-松山,2023-05-16,9103
2482,連宇,20,4,16,群益金鼎-松山,2023-05-16,9103
8433,弘帆,13,2,11,群益金鼎-松山,2023-05-16,9103
2453,凌群,18,8,10,群益金鼎-松山,2023-05-16,9103
3308,聯德,10,0,10,群益金鼎-松山,2023-05-16,9103
6414,樺漢,10,0,10,群益金鼎-松山,2023-05-16,9103
8222,寶一,15,5,10,群益金鼎-松山,2023-05-16,9103
9933,中鼎,10,0,10,群益金鼎-松山,2023-05-16,9103
9934,成霖,10,0,10,群益金鼎-松山,2023-05-16,9103
2745,五福,9,0,9,群益金鼎-松山,2023-05-16,9103
6741,91APP*-KY,7,0,7,群益金鼎-松山,2023-05-16,9103
6791,虎門科技,7,0,7,群益金鼎-松山,2023-05-16,9103
00688L,國泰20年美債正2,6,0,6,群益金鼎-松山,2023-05-16,9103
3035,智原,8,2,6,群益金鼎-松山,2023-05-16,9103
4744,皇將,6,0,6,群益金鼎-松山,2023-05-16,9103
8069,元太,8,2,6,群益金鼎-松山,2023-05-16,9103
8155,博智,8,2,6,群益金鼎-松山,2023-05-16,9103
8349,�矬�,6,0,6,群益金鼎-松山,2023-05-16,9103
1711,永光,5,0,5,群益金鼎-松山,2023-05-16,9103
2359,所羅門,8,3,5,群益金鼎-松山,2023-05-16,9103
3624,光頡,10,5,5,群益金鼎-松山,2023-05-16,9103
4541,晟田,9,4,5,群益金鼎-松山,2023-05-16,9103
5425,台半,7,2,5,群益金鼎-松山,2023-05-16,9103
6148,驊宏資,18,13,5,群益金鼎-松山,2023-05-16,9103
6244,茂迪,8,3,5,群益金鼎-松山,2023-05-16,9103
6712,長聖,5,0,5,群益金鼎-松山,2023-05-16,9103
8050,廣積,5,0,5,群益金鼎-松山,2023-05-16,9103
00751B,元大AAA至A公司債,4,0,4,群益金鼎-松山,2023-05-16,9103
3693,營邦,11,7,4,群益金鼎-松山,2023-05-16,9103
8088,品安,5,1,4,群益金鼎-松山,2023-05-16,9103
00772B,中信高評級公司債,3,0,3,群益金鼎-松山,2023-05-16,9103
00756B,群益投等新興公債,3,0,3,群益金鼎-松山,2023-05-16,9103
1503,士電,13,10,3,群益金鼎-松山,2023-05-16,9103
3202,樺晟,3,0,3,群益金鼎-松山,2023-05-16,9103
3406,玉晶光,3,0,3,群益金鼎-松山,2023-05-16,9103
3701,大眾控,3,0,3,群益金鼎-松山,2023-05-16,9103
4106,雃博,3,0,3,群益金鼎-松山,2023-05-16,9103
5289,宜鼎,3,0,3,群益金鼎-松山,2023-05-16,9103
5465,富驊,3,0,3,群益金鼎-松山,2023-05-16,9103
00632R,元大台灣50反1,191,0,191,群益金鼎-松山,2023-05-17,9103
2495,普安,90,0,90,群益金鼎-松山,2023-05-17,9103
3078,僑威,82,0,82,群益金鼎-松山,2023-05-17,9103
2888,新光金,74,0,74,群益金鼎-松山,2023-05-17,9103
1101,台泥,70,10,60,群益金鼎-松山,2023-05-17,9103
1905,華紙,170,130,40,群益金鼎-松山,2023-05-17,9103
8033,雷虎,40,0,40,群益金鼎-松山,2023-05-17,9103
1810,和成,130,96,34,群益金鼎-松山,2023-05-17,9103
1721,三晃,30,0,30,群益金鼎-松山,2023-05-17,9103
2471,資通,30,0,30,群益金鼎-松山,2023-05-17,9103
2457,飛宏,49,26,23,群益金鼎-松山,2023-05-17,9103
00680L,元大美債20正2,21,0,21,群益金鼎-松山,2023-05-17,9103
2630,亞航,42,21,21,群益金鼎-松山,2023-05-17,9103
4976,佳凌,46,26,20,群益金鼎-松山,2023-05-17,9103
2886,兆豐金,30,10,20,群益金鼎-松山,2023-05-17,9103
00772B,中信高評級公司債,18,0,18,群益金鼎-松山,2023-05-17,9103
6589,台康生技,17,0,17,群益金鼎-松山,2023-05-17,9103
3032,偉訓,16,0,16,群益金鼎-松山,2023-05-17,9103
6290,良維,16,0,16,群益金鼎-松山,2023-05-17,9103
00878,國泰永續高股息,15,0,15,群益金鼎-松山,2023-05-17,9103
4968,立積,17,2,15,群益金鼎-松山,2023-05-17,9103
8050,廣積,15,0,15,群益金鼎-松山,2023-05-17,9103
1795,美時,18,7,11,群益金鼎-松山,2023-05-17,9103
2453,凌群,31,20,11,群益金鼎-松山,2023-05-17,9103
1312,國喬,10,0,10,群益金鼎-松山,2023-05-17,9103
1218,泰山,10,0,10,群益金鼎-松山,2023-05-17,9103
1904,正隆,30,20,10,群益金鼎-松山,2023-05-17,9103
2206,三陽工業,117,107,10,群益金鼎-松山,2023-05-17,9103
2485,兆赫,10,0,10,群益金鼎-松山,2023-05-17,9103
3088,艾訊,11,1,10,群益金鼎-松山,2023-05-17,9103
3035,智原,12,3,9,群益金鼎-松山,2023-05-17,9103
8433,弘帆,9,0,9,群益金鼎-松山,2023-05-17,9103
3231,緯創,20,12,8,群益金鼎-松山,2023-05-17,9103
6706,惠特,8,0,8,群益金鼎-松山,2023-05-17,9103
4541,晟田,12,5,7,群益金鼎-松山,2023-05-17,9103
6752,叡揚,10,3,7,群益金鼎-松山,2023-05-17,9103
00720B,元大投資級公司債,6,0,6,群益金鼎-松山,2023-05-17,9103
3034,聯詠,6,0,6,群益金鼎-松山,2023-05-17,9103
1605,華新,6,1,5,群益金鼎-松山,2023-05-17,9103
1711,永光,15,10,5,群益金鼎-松山,2023-05-17,9103
2352,佳世達,30,25,5,群益金鼎-松山,2023-05-17,9103
2377,微星,5,0,5,群益金鼎-松山,2023-05-17,9103
4967,十銓,10,5,5,群益金鼎-松山,2023-05-17,9103
5222,全訊,5,0,5,群益金鼎-松山,2023-05-17,9103
6198,瑞築,5,0,5,群益金鼎-松山,2023-05-17,9103
2633,台灣高鐵,5,0,5,群益金鼎-松山,2023-05-17,9103
00696B,富邦美債20年,4,0,4,群益金鼎-松山,2023-05-17,9103
1529,樂事綠能,24,20,4,群益金鼎-松山,2023-05-17,9103
2022,聚亨,4,0,4,群益金鼎-松山,2023-05-17,9103
2482,連宇,69,65,4,群益金鼎-松山,2023-05-17,9103
00632R,元大台灣50反1,236,0,236,群益金鼎-松山,2023-05-18,9103
00893,國泰智能電動車,139,0,139,群益金鼎-松山,2023-05-18,9103
2888,新光金,120,3,117,群益金鼎-松山,2023-05-18,9103
1514,亞力,71,4,67,群益金鼎-松山,2023-05-18,9103
2371,大同,65,4,61,群益金鼎-松山,2023-05-18,9103
3693,營邦,77,29,48,群益金鼎-松山,2023-05-18,9103
2634,漢翔,32,0,32,群益金鼎-松山,2023-05-18,9103
5211,蒙恬,30,0,30,群益金鼎-松山,2023-05-18,9103
1584,精剛,30,3,27,群益金鼎-松山,2023-05-18,9103
6148,驊宏資,27,0,27,群益金鼎-松山,2023-05-18,9103
00680L,元大美債20正2,25,0,25,群益金鼎-松山,2023-05-18,9103
3058,立德,26,1,25,群益金鼎-松山,2023-05-18,9103
3078,僑威,39,14,25,群益金鼎-松山,2023-05-18,9103
1609,大亞,130,107,23,群益金鼎-松山,2023-05-18,9103
4967,十銓,51,30,21,群益金鼎-松山,2023-05-18,9103
8271,宇瞻,20,0,20,群益金鼎-松山,2023-05-18,9103
00706L,期元大S＆P日圓正2,16,0,16,群益金鼎-松山,2023-05-18,9103
5243,乙盛-KY,16,0,16,群益金鼎-松山,2023-05-18,9103
1513,中興電,15,2,13,群益金鼎-松山,2023-05-18,9103
2495,普安,12,0,12,群益金鼎-松山,2023-05-18,9103
6266,泰詠,11,0,11,群益金鼎-松山,2023-05-18,9103
1503,士電,13,3,10,群益金鼎-松山,2023-05-18,9103
00690,兆豐藍籌30,10,0,10,群益金鼎-松山,2023-05-18,9103
8069,元太,11,2,9,群益金鼎-松山,2023-05-18,9103
2360,致茂,8,0,8,群益金鼎-松山,2023-05-18,9103
2498,宏達電,10,2,8,群益金鼎-松山,2023-05-18,9103
2745,五福,17,9,8,群益金鼎-松山,2023-05-18,9103
2201,裕隆,8,0,8,群益金鼎-松山,2023-05-18,9103
2542,興富發,7,0,7,群益金鼎-松山,2023-05-18,9103
3029,零壹,8,1,7,群益金鼎-松山,2023-05-18,9103
6191,精成科,6,0,6,群益金鼎-松山,2023-05-18,9103
00753L,中信中國50正2,6,0,6,群益金鼎-松山,2023-05-18,9103
2636,台驊控股,6,0,6,群益金鼎-松山,2023-05-18,9103
4968,立積,8,2,6,群益金鼎-松山,2023-05-18,9103
1504,東元,29,23,6,群益金鼎-松山,2023-05-18,9103
2247,汎德永業,13,8,5,群益金鼎-松山,2023-05-18,9103
3362,先進光,29,24,5,群益金鼎-松山,2023-05-18,9103
4147,中裕,5,0,5,群益金鼎-松山,2023-05-18,9103
5353,台林,5,0,5,群益金鼎-松山,2023-05-18,9103
6122,擎邦,5,0,5,群益金鼎-松山,2023-05-18,9103
6150,撼訊,5,0,5,群益金鼎-松山,2023-05-18,9103
6198,瑞築,5,0,5,群益金鼎-松山,2023-05-18,9103
6285,啟��,5,0,5,群益金鼎-松山,2023-05-18,9103
6589,台康生技,5,0,5,群益金鼎-松山,2023-05-18,9103
8924,大田,5,0,5,群益金鼎-松山,2023-05-18,9103
3019,亞光,4,0,4,群益金鼎-松山,2023-05-18,9103
3558,神準,6,2,4,群益金鼎-松山,2023-05-18,9103
6625,必應,17,13,4,群益金鼎-松山,2023-05-18,9103
8084,巨虹,10,6,4,群益金鼎-松山,2023-05-18,9103
00687B,國泰20年美債,103,100,3,群益金鼎-松山,2023-05-18,9103
2618,長榮航,292,18,274,群益金鼎-松山,2023-05-19,9103
3706,神達,120,2,118,群益金鼎-松山,2023-05-19,9103
2402,毅嘉,81,0,81,群益金鼎-松山,2023-05-19,9103
3025,星通,67,0,67,群益金鼎-松山,2023-05-19,9103
00632R,元大台灣50反1,260,210,50,群益金鼎-松山,2023-05-19,9103
00706L,期元大S＆P日圓正2,38,0,38,群益金鼎-松山,2023-05-19,9103
00662,富邦NASDAQ,36,0,36,群益金鼎-松山,2023-05-19,9103
00680L,元大美債20正2,30,0,30,群益金鼎-松山,2023-05-19,9103
5706,鳳凰,27,0,27,群益金鼎-松山,2023-05-19,9103
00637L,元大滬深300正2,30,5,25,群益金鼎-松山,2023-05-19,9103
6417,韋僑,31,9,22,群益金鼎-松山,2023-05-19,9103
2368,金像電,36,18,18,群益金鼎-松山,2023-05-19,9103
2457,飛宏,48,30,18,群益金鼎-松山,2023-05-19,9103
3029,零壹,49,32,17,群益金鼎-松山,2023-05-19,9103
3003,健和興,20,3,17,群益金鼎-松山,2023-05-19,9103
4551,智伸科,15,0,15,群益金鼎-松山,2023-05-19,9103
1609,大亞,52,40,12,群益金鼎-松山,2023-05-19,9103
1584,精剛,99,88,11,群益金鼎-松山,2023-05-19,9103
4541,晟田,23,12,11,群益金鼎-松山,2023-05-19,9103
3704,合勤控,15,5,10,群益金鼎-松山,2023-05-19,9103
00720B,元大投資級公司債,10,0,10,群益金鼎-松山,2023-05-19,9103
00773B,中信優先金融債,10,0,10,群益金鼎-松山,2023-05-19,9103
1783,和康生,10,0,10,群益金鼎-松山,2023-05-19,9103
2547,日勝生,10,0,10,群益金鼎-松山,2023-05-19,9103
2633,台灣高鐵,10,0,10,群益金鼎-松山,2023-05-19,9103
2883B,凱基金乙特,10,0,10,群益金鼎-松山,2023-05-19,9103
3033,威健,10,0,10,群益金鼎-松山,2023-05-19,9103
3045,台灣大,10,0,10,群益金鼎-松山,2023-05-19,9103
3308,聯德,10,0,10,群益金鼎-松山,2023-05-19,9103
4164,承業醫,10,0,10,群益金鼎-松山,2023-05-19,9103
1519,華城,31,22,9,群益金鼎-松山,2023-05-19,9103
3094,聯傑,10,1,9,群益金鼎-松山,2023-05-19,9103
4927,泰鼎-KY,10,1,9,群益金鼎-松山,2023-05-19,9103
2614,東森,8,0,8,群益金鼎-松山,2023-05-19,9103
6235,華孚,10,2,8,群益金鼎-松山,2023-05-19,9103
3362,先進光,11,3,8,群益金鼎-松山,2023-05-19,9103
4976,佳凌,8,0,8,群益金鼎-松山,2023-05-19,9103
2371,大同,64,58,6,群益金鼎-松山,2023-05-19,9103
00751B,元大AAA至A公司債,6,0,6,群益金鼎-松山,2023-05-19,9103
1905,華紙,6,0,6,群益金鼎-松山,2023-05-19,9103
2542,興富發,6,0,6,群益金鼎-松山,2023-05-19,9103
3162,精確,6,0,6,群益金鼎-松山,2023-05-19,9103
00687B,國泰20年美債,5,0,5,群益金鼎-松山,2023-05-19,9103
00753L,中信中國50正2,5,0,5,群益金鼎-松山,2023-05-19,9103
2465,麗臺,5,0,5,群益金鼎-松山,2023-05-19,9103
2739,寒舍,5,0,5,群益金鼎-松山,2023-05-19,9103
3664,安瑞-KY,5,0,5,群益金鼎-松山,2023-05-19,9103
6150,撼訊,5,0,5,群益金鼎-松山,2023-05-19,9103
3653,健策,5,1,4,群益金鼎-松山,2023-05-19,9103
6005,群益證,4,0,4,群益金鼎-松山,2023-05-19,9103
5324,士開,100,0,100,群益金鼎-松山,2023-05-22,9103
2353,宏��,80,3,77,群益金鼎-松山,2023-05-22,9103
2344,華邦電,60,1,59,群益金鼎-松山,2023-05-22,9103
2031,新光鋼,70,30,40,群益金鼎-松山,2023-05-22,9103
2408,南亞科,31,0,31,群益金鼎-松山,2023-05-22,9103
1784,訊聯,33,3,30,群益金鼎-松山,2023-05-22,9103
2482,連宇,31,1,30,群益金鼎-松山,2023-05-22,9103
8463,潤泰材,30,0,30,群益金鼎-松山,2023-05-22,9103
1609,大亞,90,60,30,群益金鼎-松山,2023-05-22,9103
8222,寶一,26,4,22,群益金鼎-松山,2023-05-22,9103
1529,樂事綠能,22,2,20,群益金鼎-松山,2023-05-22,9103
6148,驊宏資,20,0,20,群益金鼎-松山,2023-05-22,9103
8033,雷虎,20,0,20,群益金鼎-松山,2023-05-22,9103
1514,亞力,22,3,19,群益金鼎-松山,2023-05-22,9103
1504,東元,21,5,16,群益金鼎-松山,2023-05-22,9103
2498,宏達電,17,1,16,群益金鼎-松山,2023-05-22,9103
2645,長榮航太,20,4,16,群益金鼎-松山,2023-05-22,9103
00680L,元大美債20正2,15,0,15,群益金鼎-松山,2023-05-22,9103
6188,廣明,11,0,11,群益金鼎-松山,2023-05-22,9103
1783,和康生,10,0,10,群益金鼎-松山,2023-05-22,9103
00670L,富邦NASDAQ正2,10,0,10,群益金鼎-松山,2023-05-22,9103
2206,三陽工業,50,40,10,群益金鼎-松山,2023-05-22,9103
2701,萬企,10,0,10,群益金鼎-松山,2023-05-22,9103
2748,雲品,15,5,10,群益金鼎-松山,2023-05-22,9103
3664,安瑞-KY,10,0,10,群益金鼎-松山,2023-05-22,9103
5222,全訊,10,0,10,群益金鼎-松山,2023-05-22,9103
7402,邑錡,10,0,10,群益金鼎-松山,2023-05-22,9103
2317,鴻海,10,1,9,群益金鼎-松山,2023-05-22,9103
8105,凌巨,9,0,9,群益金鼎-松山,2023-05-22,9103
00772B,中信高評級公司債,8,0,8,群益金鼎-松山,2023-05-22,9103
3019,亞光,8,0,8,群益金鼎-松山,2023-05-22,9103
6235,華孚,10,2,8,群益金鼎-松山,2023-05-22,9103
1795,美時,20,13,7,群益金鼎-松山,2023-05-22,9103
2303,聯電,7,0,7,群益金鼎-松山,2023-05-22,9103
2356,英業達,7,0,7,群益金鼎-松山,2023-05-22,9103
2722,夏都,20,13,7,群益金鼎-松山,2023-05-22,9103
1513,中興電,35,29,6,群益金鼎-松山,2023-05-22,9103
00720B,元大投資級公司債,6,0,6,群益金鼎-松山,2023-05-22,9103
2630,亞航,26,20,6,群益金鼎-松山,2023-05-22,9103
2634,漢翔,6,0,6,群益金鼎-松山,2023-05-22,9103
3105,穩懋,6,0,6,群益金鼎-松山,2023-05-22,9103
3162,精確,6,0,6,群益金鼎-松山,2023-05-22,9103
00679B,元大美債20年,5,0,5,群益金鼎-松山,2023-05-22,9103
1618,合機,5,0,5,群益金鼎-松山,2023-05-22,9103
2367,燿華,5,0,5,群益金鼎-松山,2023-05-22,9103
4147,中裕,5,0,5,群益金鼎-松山,2023-05-22,9103
5284,jpp-KY,5,0,5,群益金鼎-松山,2023-05-22,9103
5907,大洋-KY,5,0,5,群益金鼎-松山,2023-05-22,9103
6417,韋僑,5,0,5,群益金鼎-松山,2023-05-22,9103
6585,鼎基,5,0,5,群益金鼎-松山,2023-05-22,9103
00632R,元大台灣50反1,100,0,100,群益金鼎-松山,2023-05-23,9103
2706,第一店,100,0,100,群益金鼎-松山,2023-05-23,9103
4541,晟田,52,0,52,群益金鼎-松山,2023-05-23,9103
4155,訊映,50,0,50,群益金鼎-松山,2023-05-23,9103
00680L,元大美債20正2,40,0,40,群益金鼎-松山,2023-05-23,9103
8111,立��,40,0,40,群益金鼎-松山,2023-05-23,9103
3078,僑威,65,33,32,群益金鼎-松山,2023-05-23,9103
1605,華新,30,0,30,群益金鼎-松山,2023-05-23,9103
6213,聯茂,30,0,30,群益金鼎-松山,2023-05-23,9103
2206,三陽工業,35,10,25,群益金鼎-松山,2023-05-23,9103
8940,新天地,24,0,24,群益金鼎-松山,2023-05-23,9103
2328,廣宇,22,0,22,群益金鼎-松山,2023-05-23,9103
00637L,元大滬深300正2,31,10,21,群益金鼎-松山,2023-05-23,9103
6282,康舒,25,4,21,群益金鼎-松山,2023-05-23,9103
2634,漢翔,36,16,20,群益金鼎-松山,2023-05-23,9103
5706,鳳凰,30,11,19,群益金鼎-松山,2023-05-23,9103
5351,鈺創,15,0,15,群益金鼎-松山,2023-05-23,9103
00706L,期元大S＆P日圓正2,13,0,13,群益金鼎-松山,2023-05-23,9103
2371,大同,12,0,12,群益金鼎-松山,2023-05-23,9103
2201,裕隆,18,6,12,群益金鼎-松山,2023-05-23,9103
1604,聲寶,10,0,10,群益金鼎-松山,2023-05-23,9103
1584,精剛,34,24,10,群益金鼎-松山,2023-05-23,9103
1218,泰山,10,0,10,群益金鼎-松山,2023-05-23,9103
00688L,國泰20年美債正2,10,0,10,群益金鼎-松山,2023-05-23,9103
2736,富野,10,0,10,群益金鼎-松山,2023-05-23,9103
2739,寒舍,10,0,10,群益金鼎-松山,2023-05-23,9103
3232,昱捷,20,10,10,群益金鼎-松山,2023-05-23,9103
2712,遠雄來,12,3,9,群益金鼎-松山,2023-05-23,9103
00687B,國泰20年美債,7,0,7,群益金鼎-松山,2023-05-23,9103
8084,巨虹,7,0,7,群益金鼎-松山,2023-05-23,9103
00878,國泰永續高股息,8,1,7,群益金鼎-松山,2023-05-23,9103
2630,亞航,6,0,6,群益金鼎-松山,2023-05-23,9103
3162,精確,6,0,6,群益金鼎-松山,2023-05-23,9103
5243,乙盛-KY,9,3,6,群益金鼎-松山,2023-05-23,9103
1528,恩德,5,0,5,群益金鼎-松山,2023-05-23,9103
2707,晶華,15,10,5,群益金鼎-松山,2023-05-23,9103
3035,智原,7,2,5,群益金鼎-松山,2023-05-23,9103
3454,晶睿,5,0,5,群益金鼎-松山,2023-05-23,9103
5227,立凱-KY,5,0,5,群益金鼎-松山,2023-05-23,9103
6234,高僑,5,0,5,群益金鼎-松山,2023-05-23,9103
6589,台康生技,5,0,5,群益金鼎-松山,2023-05-23,9103
1519,華城,43,38,5,群益金鼎-松山,2023-05-23,9103
2313,華通,4,0,4,群益金鼎-松山,2023-05-23,9103
2610,華航,12,8,4,群益金鼎-松山,2023-05-23,9103
2368,金像電,4,0,4,群益金鼎-松山,2023-05-23,9103
2453,凌群,4,1,3,群益金鼎-松山,2023-05-23,9103
3038,全台,4,1,3,群益金鼎-松山,2023-05-23,9103
3228,金麗科,3,0,3,群益金鼎-松山,2023-05-23,9103
3491,昇達科,6,3,3,群益金鼎-松山,2023-05-23,9103
6112,邁達特,5,2,3,群益金鼎-松山,2023-05-23,9103
5701,劍湖山,100,0,100,群益金鼎-松山,2023-05-24,9103
2492,華新科,94,0,94,群益金鼎-松山,2023-05-24,9103
1810,和成,52,0,52,群益金鼎-松山,2023-05-24,9103
2705,六福,100,50,50,群益金鼎-松山,2023-05-24,9103
2701,萬企,36,0,36,群益金鼎-松山,2023-05-24,9103
00637L,元大滬深300正2,40,5,35,群益金鼎-松山,2023-05-24,9103
00633L,富邦上証正2,30,0,30,群益金鼎-松山,2023-05-24,9103
2702,華園,30,0,30,群益金鼎-松山,2023-05-24,9103
1529,樂事綠能,31,6,25,群益金鼎-松山,2023-05-24,9103
6288,聯嘉,22,0,22,群益金鼎-松山,2023-05-24,9103
5364,力麗店,21,0,21,群益金鼎-松山,2023-05-24,9103
00688L,國泰20年美債正2,20,0,20,群益金鼎-松山,2023-05-24,9103
00680L,元大美債20正2,20,0,20,群益金鼎-松山,2023-05-24,9103
00923,群益台ESG低碳50,20,0,20,群益金鼎-松山,2023-05-24,9103
5483,中美晶,20,0,20,群益金鼎-松山,2023-05-24,9103
6213,聯茂,27,7,20,群益金鼎-松山,2023-05-24,9103
8033,雷虎,20,0,20,群益金鼎-松山,2023-05-24,9103
3011,今皓,15,0,15,群益金鼎-松山,2023-05-24,9103
2419,仲琦,13,0,13,群益金鼎-松山,2023-05-24,9103
2332,友訊,22,10,12,群益金鼎-松山,2023-05-24,9103
2739,寒舍,21,10,11,群益金鼎-松山,2023-05-24,9103
3260,威剛,22,11,11,群益金鼎-松山,2023-05-24,9103
1904,正隆,10,0,10,群益金鼎-松山,2023-05-24,9103
2457,飛宏,77,67,10,群益金鼎-松山,2023-05-24,9103
6148,驊宏資,10,0,10,群益金鼎-松山,2023-05-24,9103
2712,遠雄來,50,42,8,群益金鼎-松山,2023-05-24,9103
1784,訊聯,7,0,7,群益金鼎-松山,2023-05-24,9103
3617,碩天,7,0,7,群益金鼎-松山,2023-05-24,9103
6282,康舒,37,30,7,群益金鼎-松山,2023-05-24,9103
00878,國泰永續高股息,6,0,6,群益金鼎-松山,2023-05-24,9103
00679B,元大美債20年,6,0,6,群益金鼎-松山,2023-05-24,9103
2731,雄獅,6,0,6,群益金鼎-松山,2023-05-24,9103
6202,盛群,6,0,6,群益金鼎-松山,2023-05-24,9103
8121,越峰,6,0,6,群益金鼎-松山,2023-05-24,9103
00687B,國泰20年美債,5,0,5,群益金鼎-松山,2023-05-24,9103
1604,聲寶,5,0,5,群益金鼎-松山,2023-05-24,9103
2376,技嘉,5,0,5,群益金鼎-松山,2023-05-24,9103
2458,義隆,5,0,5,群益金鼎-松山,2023-05-24,9103
3024,憶聲,5,0,5,群益金鼎-松山,2023-05-24,9103
9802,鈺齊-KY,5,0,5,群益金鼎-松山,2023-05-24,9103
2748,雲品,44,39,5,群益金鼎-松山,2023-05-24,9103
1531,高林股,4,0,4,群益金鼎-松山,2023-05-24,9103
00882,中信中國高股息,4,0,4,群益金鼎-松山,2023-05-24,9103
2317,鴻海,4,0,4,群益金鼎-松山,2023-05-24,9103
3081,聯亞,6,2,4,群益金鼎-松山,2023-05-24,9103
5009,榮剛,4,0,4,群益金鼎-松山,2023-05-24,9103
2892,第一金,3,0,3,群益金鼎-松山,2023-05-24,9103
00720B,元大投資級公司債,3,0,3,群益金鼎-松山,2023-05-24,9103
1316,上曜,7,4,3,群益金鼎-松山,2023-05-24,9103
3714,富采,3,0,3,群益金鼎-松山,2023-05-24,9103
6417,韋僑,132,0,132,群益金鼎-松山,2023-05-25,9103
5328,華容,107,0,107,群益金鼎-松山,2023-05-25,9103
3715,定穎投控,107,2,105,群益金鼎-松山,2023-05-25,9103
00648R,元大S＆P500反1,100,0,100,群益金鼎-松山,2023-05-25,9103
00637L,元大滬深300正2,91,10,81,群益金鼎-松山,2023-05-25,9103
2706,第一店,150,100,50,群益金鼎-松山,2023-05-25,9103
5009,榮剛,51,1,50,群益金鼎-松山,2023-05-25,9103
00706L,期元大S＆P日圓正2,47,0,47,群益金鼎-松山,2023-05-25,9103
2371,大同,78,47,31,群益金鼎-松山,2023-05-25,9103
2103,台橡,30,0,30,群益金鼎-松山,2023-05-25,9103
4564,元翎,28,0,28,群益金鼎-松山,2023-05-25,9103
2618,長榮航,41,18,23,群益金鼎-松山,2023-05-25,9103
2201,裕隆,22,2,20,群益金鼎-松山,2023-05-25,9103
00680L,元大美債20正2,20,0,20,群益金鼎-松山,2023-05-25,9103
00633L,富邦上証正2,20,0,20,群益金鼎-松山,2023-05-25,9103
4543,萬在,20,0,20,群益金鼎-松山,2023-05-25,9103
2002,中鋼,20,0,20,群益金鼎-松山,2023-05-25,9103
6191,精成科,18,1,17,群益金鼎-松山,2023-05-25,9103
3037,欣興,33,16,17,群益金鼎-松山,2023-05-25,9103
6150,撼訊,16,0,16,群益金鼎-松山,2023-05-25,9103
3011,今皓,14,0,14,群益金鼎-松山,2023-05-25,9103
3025,星通,14,0,14,群益金鼎-松山,2023-05-25,9103
2330,台積電,23,12,11,群益金鼎-松山,2023-05-25,9103
6244,茂迪,10,0,10,群益金鼎-松山,2023-05-25,9103
2332,友訊,10,0,10,群益金鼎-松山,2023-05-25,9103
2413,環科,10,0,10,群益金鼎-松山,2023-05-25,9103
2485,兆赫,10,0,10,群益金鼎-松山,2023-05-25,9103
3706,神達,10,0,10,群益金鼎-松山,2023-05-25,9103
4953,緯軟,10,0,10,群益金鼎-松山,2023-05-25,9103
9933,中鼎,10,0,10,群益金鼎-松山,2023-05-25,9103
00687B,國泰20年美債,9,0,9,群益金鼎-松山,2023-05-25,9103
2748,雲品,21,13,8,群益金鼎-松山,2023-05-25,9103
1785,光洋科,10,3,7,群益金鼎-松山,2023-05-25,9103
1589,永冠-KY,8,1,7,群益金鼎-松山,2023-05-25,9103
1504,東元,7,0,7,群益金鼎-松山,2023-05-25,9103
1795,美時,17,10,7,群益金鼎-松山,2023-05-25,9103
2610,華航,7,0,7,群益金鼎-松山,2023-05-25,9103
00882,中信中國高股息,6,0,6,群益金鼎-松山,2023-05-25,9103
00857B,永豐20年美公債,6,0,6,群益金鼎-松山,2023-05-25,9103
3339,泰谷,6,0,6,群益金鼎-松山,2023-05-25,9103
5706,鳳凰,36,30,6,群益金鼎-松山,2023-05-25,9103
2882,國泰金,5,0,5,群益金鼎-松山,2023-05-25,9103
00928,中信上櫃ESG30,5,0,5,群益金鼎-松山,2023-05-25,9103
2328,廣宇,5,0,5,群益金鼎-松山,2023-05-25,9103
2884,玉山金,5,0,5,群益金鼎-松山,2023-05-25,9103
3029,零壹,9,4,5,群益金鼎-松山,2023-05-25,9103
3059,華晶科,5,0,5,群益金鼎-松山,2023-05-25,9103
3587,閎康,5,0,5,群益金鼎-松山,2023-05-25,9103
6123,上奇,5,0,5,群益金鼎-松山,2023-05-25,9103
6589,台康生技,5,0,5,群益金鼎-松山,2023-05-25,9103
3290,東浦,125,0,125,群益金鼎-松山,2023-05-26,9103
00664R,國泰臺灣加權反1,100,0,100,群益金鼎-松山,2023-05-26,9103
3481,群創,100,0,100,群益金鼎-松山,2023-05-26,9103
00637L,元大滬深300正2,38,0,38,群益金鼎-松山,2023-05-26,9103
1584,精剛,35,2,33,群益金鼎-松山,2023-05-26,9103
00668,國泰美國道瓊,30,0,30,群益金鼎-松山,2023-05-26,9103
00633L,富邦上証正2,30,0,30,群益金鼎-松山,2023-05-26,9103
4979,華星光,48,21,27,群益金鼎-松山,2023-05-26,9103
6217,中探針,22,0,22,群益金鼎-松山,2023-05-26,9103
00688L,國泰20年美債正2,20,0,20,群益金鼎-松山,2023-05-26,9103
2206,三陽工業,20,1,19,群益金鼎-松山,2023-05-26,9103
2371,大同,43,24,19,群益金鼎-松山,2023-05-26,9103
3704,合勤控,21,3,18,群益金鼎-松山,2023-05-26,9103
3011,今皓,17,0,17,群益金鼎-松山,2023-05-26,9103
00715L,期街口布蘭特正2,15,0,15,群益金鼎-松山,2023-05-26,9103
4564,元翎,18,5,13,群益金鼎-松山,2023-05-26,9103
00882,中信中國高股息,12,0,12,群益金鼎-松山,2023-05-26,9103
2606,裕民,12,1,11,群益金鼎-松山,2023-05-26,9103
3545,敦泰,10,0,10,群益金鼎-松山,2023-05-26,9103
6190,萬泰科,20,10,10,群益金鼎-松山,2023-05-26,9103
6213,聯茂,10,0,10,群益金鼎-松山,2023-05-26,9103
6285,啟��,10,0,10,群益金鼎-松山,2023-05-26,9103
5289,宜鼎,11,2,9,群益金鼎-松山,2023-05-26,9103
2641,正德,8,0,8,群益金鼎-松山,2023-05-26,9103
6122,擎邦,8,0,8,群益金鼎-松山,2023-05-26,9103
1905,華紙,8,1,7,群益金鼎-松山,2023-05-26,9103
2609,陽明,7,0,7,群益金鼎-松山,2023-05-26,9103
3264,欣銓,8,1,7,群益金鼎-松山,2023-05-26,9103
5469,瀚宇博,7,0,7,群益金鼎-松山,2023-05-26,9103
5512,力麒,7,0,7,群益金鼎-松山,2023-05-26,9103
6288,聯嘉,7,0,7,群益金鼎-松山,2023-05-26,9103
1785,光洋科,6,0,6,群益金鼎-松山,2023-05-26,9103
4995,晶達,6,0,6,群益金鼎-松山,2023-05-26,9103
6146,耕興,6,0,6,群益金鼎-松山,2023-05-26,9103
3587,閎康,6,0,6,群益金鼎-松山,2023-05-26,9103
1519,華城,8,2,6,群益金鼎-松山,2023-05-26,9103
00893,國泰智能電動車,5,0,5,群益金鼎-松山,2023-05-26,9103
1784,訊聯,5,0,5,群益金鼎-松山,2023-05-26,9103
1903,士紙,5,0,5,群益金鼎-松山,2023-05-26,9103
2408,南亞科,5,0,5,群益金鼎-松山,2023-05-26,9103
2707,晶華,5,0,5,群益金鼎-松山,2023-05-26,9103
3363,上詮,5,0,5,群益金鼎-松山,2023-05-26,9103
4164,承業醫,5,0,5,群益金鼎-松山,2023-05-26,9103
4908,前鼎,5,0,5,群益金鼎-松山,2023-05-26,9103
5871,中租-KY,5,0,5,群益金鼎-松山,2023-05-26,9103
6112,邁達特,5,0,5,群益金鼎-松山,2023-05-26,9103
6706,惠特,5,0,5,群益金鼎-松山,2023-05-26,9103
2002,中鋼,4,0,4,群益金鼎-松山,2023-05-26,9103
2356,英業達,4,0,4,群益金鼎-松山,2023-05-26,9103
2402,毅嘉,4,0,4,群益金鼎-松山,2023-05-26,9103
5302,太欣,100,0,100,群益金鼎-松山,2023-05-29,9103
2371,大同,101,9,92,群益金鼎-松山,2023-05-29,9103
2002,中鋼,63,0,63,群益金鼎-松山,2023-05-29,9103
6125,廣運,90,27,63,群益金鼎-松山,2023-05-29,9103
2324,仁寶,51,0,51,群益金鼎-松山,2023-05-29,9103
2353,宏��,51,0,51,群益金鼎-松山,2023-05-29,9103
3508,位速,50,0,50,群益金鼎-松山,2023-05-29,9103
0056,元大高股息,50,2,48,群益金鼎-松山,2023-05-29,9103
00706L,期元大S＆P日圓正2,41,0,41,群益金鼎-松山,2023-05-29,9103
2031,新光鋼,26,0,26,群益金鼎-松山,2023-05-29,9103
00680L,元大美債20正2,25,0,25,群益金鼎-松山,2023-05-29,9103
2323,中環,26,1,25,群益金鼎-松山,2023-05-29,9103
6438,迅得,22,0,22,群益金鼎-松山,2023-05-29,9103
6558,興能高,21,0,21,群益金鼎-松山,2023-05-29,9103
00671R,富邦NASDAQ反1,20,0,20,群益金鼎-松山,2023-05-29,9103
1608,華榮,20,1,19,群益金鼎-松山,2023-05-29,9103
2303,聯電,22,3,19,群益金鼎-松山,2023-05-29,9103
8222,寶一,45,27,18,群益金鼎-松山,2023-05-29,9103
00893,國泰智能電動車,18,1,17,群益金鼎-松山,2023-05-29,9103
3265,台星科,17,0,17,群益金鼎-松山,2023-05-29,9103
3594,磐儀,17,0,17,群益金鼎-松山,2023-05-29,9103
1440,南紡,15,0,15,群益金鼎-松山,2023-05-29,9103
2610,華航,32,18,14,群益金鼎-松山,2023-05-29,9103
1473,台南,14,0,14,群益金鼎-松山,2023-05-29,9103
8210,勤誠,13,0,13,群益金鼎-松山,2023-05-29,9103
3290,東浦,12,0,12,群益金鼎-松山,2023-05-29,9103
3706,神達,20,8,12,群益金鼎-松山,2023-05-29,9103
4564,元翎,13,1,12,群益金鼎-松山,2023-05-29,9103
00637L,元大滬深300正2,16,5,11,群益金鼎-松山,2023-05-29,9103
2449,京元電子,12,1,11,群益金鼎-松山,2023-05-29,9103
2457,飛宏,31,20,11,群益金鼎-松山,2023-05-29,9103
4977,眾達-KY,15,4,11,群益金鼎-松山,2023-05-29,9103
8150,南茂,10,0,10,群益金鼎-松山,2023-05-29,9103
1598,岱宇,10,0,10,群益金鼎-松山,2023-05-29,9103
2547,日勝生,10,0,10,群益金鼎-松山,2023-05-29,9103
2630,亞航,12,2,10,群益金鼎-松山,2023-05-29,9103
2748,雲品,10,0,10,群益金鼎-松山,2023-05-29,9103
4440,宜新實業,10,0,10,群益金鼎-松山,2023-05-29,9103
1513,中興電,14,5,9,群益金鼎-松山,2023-05-29,9103
3025,星通,26,18,8,群益金鼎-松山,2023-05-29,9103
5388,中磊,8,0,8,群益金鼎-松山,2023-05-29,9103
3231,緯創,22,14,8,群益金鼎-松山,2023-05-29,9103
3163,波若威,7,0,7,群益金鼎-松山,2023-05-29,9103
2332,友訊,11,4,7,群益金鼎-松山,2023-05-29,9103
2614,東森,7,0,7,群益金鼎-松山,2023-05-29,9103
00696B,富邦美債20年,6,0,6,群益金鼎-松山,2023-05-29,9103
4927,泰鼎-KY,6,0,6,群益金鼎-松山,2023-05-29,9103
5706,鳳凰,11,5,6,群益金鼎-松山,2023-05-29,9103
00903,富邦元宇宙,5,0,5,群益金鼎-松山,2023-05-29,9103
1795,美時,11,6,5,群益金鼎-松山,2023-05-29,9103
00637L,元大滬深300正2,50,0,50,群益金鼎-松山,2023-05-30,9103
2201,裕隆,82,34,48,群益金鼎-松山,2023-05-30,9103
2371,大同,131,107,24,群益金鼎-松山,2023-05-30,9103
2031,新光鋼,22,0,22,群益金鼎-松山,2023-05-30,9103
2317,鴻海,35,13,22,群益金鼎-松山,2023-05-30,9103
3078,僑威,22,1,21,群益金鼎-松山,2023-05-30,9103
2609,陽明,20,0,20,群益金鼎-松山,2023-05-30,9103
2610,華航,28,10,18,群益金鼎-松山,2023-05-30,9103
1608,華榮,16,0,16,群益金鼎-松山,2023-05-30,9103
1784,訊聯,15,0,15,群益金鼎-松山,2023-05-30,9103
2884,玉山金,15,0,15,群益金鼎-松山,2023-05-30,9103
00882,中信中國高股息,13,0,13,群益金鼎-松山,2023-05-30,9103
3035,智原,14,2,12,群益金鼎-松山,2023-05-30,9103
2883,凱基金,11,0,11,群益金鼎-松山,2023-05-30,9103
3005,神基,11,0,11,群益金鼎-松山,2023-05-30,9103
6282,康舒,12,1,11,群益金鼎-松山,2023-05-30,9103
2457,飛宏,24,14,10,群益金鼎-松山,2023-05-30,9103
2722,夏都,20,10,10,群益金鼎-松山,2023-05-30,9103
6531,愛普*,21,11,10,群益金鼎-松山,2023-05-30,9103
6244,茂迪,11,3,8,群益金鼎-松山,2023-05-30,9103
2388,威盛,28,21,7,群益金鼎-松山,2023-05-30,9103
2421,建準,12,5,7,群益金鼎-松山,2023-05-30,9103
8033,雷虎,8,1,7,群益金鼎-松山,2023-05-30,9103
00687B,國泰20年美債,6,0,6,群益金鼎-松山,2023-05-30,9103
2382,廣達,27,21,6,群益金鼎-松山,2023-05-30,9103
2618,長榮航,8,2,6,群益金鼎-松山,2023-05-30,9103
2637,慧洋-KY,5,0,5,群益金鼎-松山,2023-05-30,9103
1584,精剛,7,2,5,群益金鼎-松山,2023-05-30,9103
00751B,元大AAA至A公司債,5,0,5,群益金鼎-松山,2023-05-30,9103
2105,正新,15,10,5,群益金鼎-松山,2023-05-30,9103
4164,承業醫,5,0,5,群益金鼎-松山,2023-05-30,9103
4440,宜新實業,5,0,5,群益金鼎-松山,2023-05-30,9103
5703,亞都,5,0,5,群益金鼎-松山,2023-05-30,9103
6584,南俊國際,5,0,5,群益金鼎-松山,2023-05-30,9103
3037,欣興,6,2,4,群益金鼎-松山,2023-05-30,9103
1762,中化生,4,0,4,群益金鼎-松山,2023-05-30,9103
2504,國產,4,0,4,群益金鼎-松山,2023-05-30,9103
3049,精金,4,0,4,群益金鼎-松山,2023-05-30,9103
3363,上詮,6,2,4,群益金鼎-松山,2023-05-30,9103
4977,眾達-KY,5,1,4,群益金鼎-松山,2023-05-30,9103
6548,長科*,4,0,4,群益金鼎-松山,2023-05-30,9103
8409,商之器,4,0,4,群益金鼎-松山,2023-05-30,9103
2376,技嘉,5,2,3,群益金鼎-松山,2023-05-30,9103
00878,國泰永續高股息,14,11,3,群益金鼎-松山,2023-05-30,9103
2308,台達電,4,1,3,群益金鼎-松山,2023-05-30,9103
3306,鼎天,5,2,3,群益金鼎-松山,2023-05-30,9103
4162,智擎,3,0,3,群益金鼎-松山,2023-05-30,9103
5203,訊連,3,0,3,群益金鼎-松山,2023-05-30,9103
5425,台半,5,2,3,群益金鼎-松山,2023-05-30,9103
5439,高技,3,0,3,群益金鼎-松山,2023-05-30,9103
00640L,富邦日本正2,50,0,50,群益金鼎-松山,2023-05-31,9103
2328,廣宇,36,2,34,群益金鼎-松山,2023-05-31,9103
2739,寒舍,30,0,30,群益金鼎-松山,2023-05-31,9103
00637L,元大滬深300正2,22,0,22,群益金鼎-松山,2023-05-31,9103
00830,國泰費城半導體,20,0,20,群益金鼎-松山,2023-05-31,9103
00671R,富邦NASDAQ反1,20,0,20,群益金鼎-松山,2023-05-31,9103
00670L,富邦NASDAQ正2,20,0,20,群益金鼎-松山,2023-05-31,9103
00647L,元大S＆P500正2,20,0,20,群益金鼎-松山,2023-05-31,9103
3673,TPK-KY,20,0,20,群益金鼎-松山,2023-05-31,9103
00715L,期街口布蘭特正2,18,0,18,群益金鼎-松山,2023-05-31,9103
2382,廣達,20,2,18,群益金鼎-松山,2023-05-31,9103
1218,泰山,16,0,16,群益金鼎-松山,2023-05-31,9103
2630,亞航,26,12,14,群益金鼎-松山,2023-05-31,9103
00882,中信中國高股息,12,0,12,群益金鼎-松山,2023-05-31,9103
00706L,期元大S＆P日圓正2,11,0,11,群益金鼎-松山,2023-05-31,9103
2610,華航,14,3,11,群益金鼎-松山,2023-05-31,9103
4164,承業醫,10,0,10,群益金鼎-松山,2023-05-31,9103
3050,鈺德,10,0,10,群益金鼎-松山,2023-05-31,9103
3338,泰碩,12,2,10,群益金鼎-松山,2023-05-31,9103
4155,訊映,10,0,10,群益金鼎-松山,2023-05-31,9103
3078,僑威,10,1,9,群益金鼎-松山,2023-05-31,9103
00633L,富邦上証正2,9,0,9,群益金鼎-松山,2023-05-31,9103
3044,健鼎,9,0,9,群益金鼎-松山,2023-05-31,9103
5871,中租-KY,9,0,9,群益金鼎-松山,2023-05-31,9103
4106,雃博,8,0,8,群益金鼎-松山,2023-05-31,9103
9945,潤泰新,7,0,7,群益金鼎-松山,2023-05-31,9103
2603,長榮,6,0,6,群益金鼎-松山,2023-05-31,9103
3540,曜越,6,0,6,群益金鼎-松山,2023-05-31,9103
3706,神達,7,1,6,群益金鼎-松山,2023-05-31,9103
00680L,元大美債20正2,5,0,5,群益金鼎-松山,2023-05-31,9103
00751B,元大AAA至A公司債,5,0,5,群益金鼎-松山,2023-05-31,9103
1795,美時,5,0,5,群益金鼎-松山,2023-05-31,9103
2002,中鋼,5,0,5,群益金鼎-松山,2023-05-31,9103
2317,鴻海,6,1,5,群益金鼎-松山,2023-05-31,9103
2360,致茂,5,0,5,群益金鼎-松山,2023-05-31,9103
6285,啟��,5,0,5,群益金鼎-松山,2023-05-31,9103
8071,能率網通,5,0,5,群益金鼎-松山,2023-05-31,9103
8341,日友,4,0,4,群益金鼎-松山,2023-05-31,9103
00878,國泰永續高股息,4,0,4,群益金鼎-松山,2023-05-31,9103
2332,友訊,5,1,4,群益金鼎-松山,2023-05-31,9103
3189,景碩,4,0,4,群益金鼎-松山,2023-05-31,9103
5425,台半,6,2,4,群益金鼎-松山,2023-05-31,9103
6139,亞翔,4,0,4,群益金鼎-松山,2023-05-31,9103
6213,聯茂,14,10,4,群益金鼎-松山,2023-05-31,9103
8227,巨有科技,4,0,4,群益金鼎-松山,2023-05-31,9103
6531,愛普*,12,8,4,群益金鼎-松山,2023-05-31,9103
3704,合勤控,6,2,4,群益金鼎-松山,2023-05-31,9103
1101,台泥,3,0,3,群益金鼎-松山,2023-05-31,9103
1584,精剛,5,2,3,群益金鼎-松山,2023-05-31,9103
2352,佳世達,4,1,3,群益金鼎-松山,2023-05-31,9103
2618,長榮航,147,81,66,群益金鼎-松山,2023-06-01,9103
1905,華紙,138,80,58,群益金鼎-松山,2023-06-01,9103
9945,潤泰新,36,0,36,群益金鼎-松山,2023-06-01,9103
3673,TPK-KY,33,0,33,群益金鼎-松山,2023-06-01,9103
6213,聯茂,30,0,30,群益金鼎-松山,2023-06-01,9103
1904,正隆,32,3,29,群益金鼎-松山,2023-06-01,9103
1727,中華化,26,0,26,群益金鼎-松山,2023-06-01,9103
2002,中鋼,25,0,25,群益金鼎-松山,2023-06-01,9103
2328,廣宇,94,69,25,群益金鼎-松山,2023-06-01,9103
2610,華航,221,196,25,群益金鼎-松山,2023-06-01,9103
6133,金橋,25,0,25,群益金鼎-松山,2023-06-01,9103
3078,僑威,32,11,21,群益金鼎-松山,2023-06-01,9103
8222,寶一,25,5,20,群益金鼎-松山,2023-06-01,9103
2706,第一店,50,30,20,群益金鼎-松山,2023-06-01,9103
5258,虹堡,33,16,17,群益金鼎-松山,2023-06-01,9103
1218,泰山,16,0,16,群益金鼎-松山,2023-06-01,9103
2457,飛宏,55,39,16,群益金鼎-松山,2023-06-01,9103
3308,聯德,15,0,15,群益金鼎-松山,2023-06-01,9103
3362,先進光,24,9,15,群益金鼎-松山,2023-06-01,9103
5706,鳳凰,26,12,14,群益金鼎-松山,2023-06-01,9103
3272,東碩,13,0,13,群益金鼎-松山,2023-06-01,9103
6104,創惟,13,0,13,群益金鼎-松山,2023-06-01,9103
6160,欣技,20,7,13,群益金鼎-松山,2023-06-01,9103
8085,福華,13,0,13,群益金鼎-松山,2023-06-01,9103
00633L,富邦上証正2,11,0,11,群益金鼎-松山,2023-06-01,9103
2312,金寶,11,0,11,群益金鼎-松山,2023-06-01,9103
2630,亞航,47,36,11,群益金鼎-松山,2023-06-01,9103
3260,威剛,11,0,11,群益金鼎-松山,2023-06-01,9103
6134,萬旭,11,0,11,群益金鼎-松山,2023-06-01,9103
6188,廣明,21,10,11,群益金鼎-松山,2023-06-01,9103
00668,國泰美國道瓊,10,0,10,群益金鼎-松山,2023-06-01,9103
00715L,期街口布蘭特正2,10,0,10,群益金鼎-松山,2023-06-01,9103
2371,大同,25,15,10,群益金鼎-松山,2023-06-01,9103
5498,凱崴,10,0,10,群益金鼎-松山,2023-06-01,9103
2883,凱基金,10,0,10,群益金鼎-松山,2023-06-01,9103
3231,緯創,39,29,10,群益金鼎-松山,2023-06-01,9103
3035,智原,9,1,8,群益金鼎-松山,2023-06-01,9103
3141,晶宏,8,0,8,群益金鼎-松山,2023-06-01,9103
3289,宜特,8,0,8,群益金鼎-松山,2023-06-01,9103
3706,神達,177,169,8,群益金鼎-松山,2023-06-01,9103
4747,強生,8,0,8,群益金鼎-松山,2023-06-01,9103
3504,揚明光,8,0,8,群益金鼎-松山,2023-06-01,9103
00696B,富邦美債20年,7,0,7,群益金鼎-松山,2023-06-01,9103
2323,中環,8,1,7,群益金鼎-松山,2023-06-01,9103
2615,萬海,7,0,7,群益金鼎-松山,2023-06-01,9103
2745,五福,7,0,7,群益金鼎-松山,2023-06-01,9103
6625,必應,9,2,7,群益金鼎-松山,2023-06-01,9103
1762,中化生,6,0,6,群益金鼎-松山,2023-06-01,9103
00919,群益台灣精選高息,6,0,6,群益金鼎-松山,2023-06-01,9103
2498,宏達電,6,0,6,群益金鼎-松山,2023-06-01,9103
1514,亞力,61,5,56,群益金鼎-松山,2023-06-02,9103
2801,彰銀,50,0,50,群益金鼎-松山,2023-06-02,9103
00919,群益台灣精選高息,43,5,38,群益金鼎-松山,2023-06-02,9103
2331,精英,39,3,36,群益金鼎-松山,2023-06-02,9103
1609,大亞,35,4,31,群益金鼎-松山,2023-06-02,9103
2031,新光鋼,25,0,25,群益金鼎-松山,2023-06-02,9103
3363,上詮,25,4,21,群益金鼎-松山,2023-06-02,9103
00671R,富邦NASDAQ反1,20,0,20,群益金鼎-松山,2023-06-02,9103
3707,漢磊,20,0,20,群益金鼎-松山,2023-06-02,9103
8048,德勝,20,0,20,群益金鼎-松山,2023-06-02,9103
2498,宏達電,13,1,12,群益金鼎-松山,2023-06-02,9103
00878,國泰永續高股息,11,0,11,群益金鼎-松山,2023-06-02,9103
3591,艾笛森,11,0,11,群益金鼎-松山,2023-06-02,9103
00753L,中信中國50正2,10,0,10,群益金鼎-松山,2023-06-02,9103
1533,車王電,10,0,10,群益金鼎-松山,2023-06-02,9103
1218,泰山,10,0,10,群益金鼎-松山,2023-06-02,9103
2421,建準,10,0,10,群益金鼎-松山,2023-06-02,9103
2547,日勝生,10,0,10,群益金鼎-松山,2023-06-02,9103
3673,TPK-KY,10,0,10,群益金鼎-松山,2023-06-02,9103
2376,技嘉,21,12,9,群益金鼎-松山,2023-06-02,9103
3265,台星科,11,2,9,群益金鼎-松山,2023-06-02,9103
3017,奇鋐,9,0,9,群益金鼎-松山,2023-06-02,9103
2368,金像電,14,6,8,群益金鼎-松山,2023-06-02,9103
3532,台勝科,9,1,8,群益金鼎-松山,2023-06-02,9103
6517,保勝光學,8,0,8,群益金鼎-松山,2023-06-02,9103
2002,中鋼,8,0,8,群益金鼎-松山,2023-06-02,9103
1314,中石化,7,0,7,群益金鼎-松山,2023-06-02,9103
1513,中興電,23,16,7,群益金鼎-松山,2023-06-02,9103
00680L,元大美債20正2,6,0,6,群益金鼎-松山,2023-06-02,9103
6147,頎邦,6,0,6,群益金鼎-松山,2023-06-02,9103
2317,鴻海,8,2,6,群益金鼎-松山,2023-06-02,9103
2614,東森,6,0,6,群益金鼎-松山,2023-06-02,9103
2637,慧洋-KY,6,0,6,群益金鼎-松山,2023-06-02,9103
3044,健鼎,6,0,6,群益金鼎-松山,2023-06-02,9103
5498,凱崴,6,0,6,群益金鼎-松山,2023-06-02,9103
1504,東元,7,2,5,群益金鼎-松山,2023-06-02,9103
00633L,富邦上証正2,5,0,5,群益金鼎-松山,2023-06-02,9103
2337,旺宏,5,0,5,群益金鼎-松山,2023-06-02,9103
3011,今皓,5,0,5,群益金鼎-松山,2023-06-02,9103
3163,波若威,7,2,5,群益金鼎-松山,2023-06-02,9103
3444,利機,5,0,5,群益金鼎-松山,2023-06-02,9103
6227,茂綸,5,0,5,群益金鼎-松山,2023-06-02,9103
8040,九暘,5,0,5,群益金鼎-松山,2023-06-02,9103
2323,中環,15,10,5,群益金鼎-松山,2023-06-02,9103
3406,玉晶光,6,2,4,群益金鼎-松山,2023-06-02,9103
2489,瑞軒,29,25,4,群益金鼎-松山,2023-06-02,9103
2892,第一金,4,0,4,群益金鼎-松山,2023-06-02,9103
3019,亞光,4,0,4,群益金鼎-松山,2023-06-02,9103
4128,中天,4,0,4,群益金鼎-松山,2023-06-02,9103
8076,伍豐,6,2,4,群益金鼎-松山,2023-06-02,9103
2615,萬海,70,6,64,群益金鼎-松山,2023-06-05,9103
1609,大亞,92,30,62,群益金鼎-松山,2023-06-05,9103
3682,亞太電,50,0,50,群益金鼎-松山,2023-06-05,9103
8033,雷虎,48,5,43,群益金鼎-松山,2023-06-05,9103
2610,華航,46,8,38,群益金鼎-松山,2023-06-05,9103
4906,正文,37,1,36,群益金鼎-松山,2023-06-05,9103
2399,映泰,34,0,34,群益金鼎-松山,2023-06-05,9103
00720B,元大投資級公司債,31,0,31,群益金鼎-松山,2023-06-05,9103
00753L,中信中國50正2,30,0,30,群益金鼎-松山,2023-06-05,9103
2888,新光金,50,21,29,群益金鼎-松山,2023-06-05,9103
00919,群益台灣精選高息,22,1,21,群益金鼎-松山,2023-06-05,9103
1603,華電,20,0,20,群益金鼎-松山,2023-06-05,9103
00637L,元大滬深300正2,20,0,20,群益金鼎-松山,2023-06-05,9103
00671R,富邦NASDAQ反1,20,0,20,群益金鼎-松山,2023-06-05,9103
00706L,期元大S＆P日圓正2,20,1,19,群益金鼎-松山,2023-06-05,9103
6235,華孚,36,17,19,群益金鼎-松山,2023-06-05,9103
2323,中環,31,12,19,群益金鼎-松山,2023-06-05,9103
2353,宏��,25,7,18,群益金鼎-松山,2023-06-05,9103
6205,詮欣,16,0,16,群益金鼎-松山,2023-06-05,9103
3541,西柏,14,0,14,群益金鼎-松山,2023-06-05,9103
00679B,元大美債20年,13,1,12,群益金鼎-松山,2023-06-05,9103
2630,亞航,55,44,11,群益金鼎-松山,2023-06-05,9103
6213,聯茂,15,4,11,群益金鼎-松山,2023-06-05,9103
8222,寶一,50,39,11,群益金鼎-松山,2023-06-05,9103
2344,華邦電,13,3,10,群益金鼎-松山,2023-06-05,9103
2880,華南金,10,0,10,群益金鼎-松山,2023-06-05,9103
2913,農林,11,1,10,群益金鼎-松山,2023-06-05,9103
6118,建達,20,10,10,群益金鼎-松山,2023-06-05,9103
6134,萬旭,10,0,10,群益金鼎-松山,2023-06-05,9103
8021,尖點,10,0,10,群益金鼎-松山,2023-06-05,9103
8086,宏捷科,13,3,10,群益金鼎-松山,2023-06-05,9103
1519,華城,85,76,9,群益金鼎-松山,2023-06-05,9103
3025,星通,21,12,9,群益金鼎-松山,2023-06-05,9103
4979,華星光,24,15,9,群益金鼎-松山,2023-06-05,9103
5009,榮剛,20,11,9,群益金鼎-松山,2023-06-05,9103
6160,欣技,9,0,9,群益金鼎-松山,2023-06-05,9103
6223,旺矽,10,1,9,群益金鼎-松山,2023-06-05,9103
1513,中興電,11,3,8,群益金鼎-松山,2023-06-05,9103
3162,精確,11,3,8,群益金鼎-松山,2023-06-05,9103
3707,漢磊,8,0,8,群益金鼎-松山,2023-06-05,9103
6579,研揚,8,0,8,群益金鼎-松山,2023-06-05,9103
00687B,國泰20年美債,8,1,7,群益金鼎-松山,2023-06-05,9103
00696B,富邦美債20年,7,0,7,群益金鼎-松山,2023-06-05,9103
2404,漢唐,7,0,7,群益金鼎-松山,2023-06-05,9103
3706,神達,15,8,7,群益金鼎-松山,2023-06-05,9103
3078,僑威,32,26,6,群益金鼎-松山,2023-06-05,9103
3324,雙鴻,6,0,6,群益金鼎-松山,2023-06-05,9103
3689,湧德,6,0,6,群益金鼎-松山,2023-06-05,9103
8349,�矬�,6,0,6,群益金鼎-松山,2023-06-05,9103
1584,精剛,8,2,6,群益金鼎-松山,2023-06-05,9103
2610,華航,119,1,118,群益金鼎-松山,2023-06-06,9103
1907,永豐餘,51,21,30,群益金鼎-松山,2023-06-06,9103
6213,聯茂,26,0,26,群益金鼎-松山,2023-06-06,9103
2637,慧洋-KY,25,0,25,群益金鼎-松山,2023-06-06,9103
2402,毅嘉,25,2,23,群益金鼎-松山,2023-06-06,9103
6233,旺玖,22,0,22,群益金鼎-松山,2023-06-06,9103
2913,農林,21,0,21,群益金鼎-松山,2023-06-06,9103
1419,新紡,20,0,20,群益金鼎-松山,2023-06-06,9103
3673,TPK-KY,30,11,19,群益金鼎-松山,2023-06-06,9103
3711,日月光投控,20,2,18,群益金鼎-松山,2023-06-06,9103
3081,聯亞,18,2,16,群益金鼎-松山,2023-06-06,9103
1584,精剛,17,2,15,群益金鼎-松山,2023-06-06,9103
2457,飛宏,18,4,14,群益金鼎-松山,2023-06-06,9103
1218,泰山,11,0,11,群益金鼎-松山,2023-06-06,9103
00696B,富邦美債20年,10,0,10,群益金鼎-松山,2023-06-06,9103
006205,富邦上証,10,0,10,群益金鼎-松山,2023-06-06,9103
2413,環科,10,0,10,群益金鼎-松山,2023-06-06,9103
2736,富野,10,0,10,群益金鼎-松山,2023-06-06,9103
4931,新盛力,10,0,10,群益金鼎-松山,2023-06-06,9103
00882,中信中國高股息,10,0,10,群益金鼎-松山,2023-06-06,9103
3016,嘉晶,9,0,9,群益金鼎-松山,2023-06-06,9103
4533,協易機,9,0,9,群益金鼎-松山,2023-06-06,9103
3017,奇鋐,11,3,8,群益金鼎-松山,2023-06-06,9103
2485,兆赫,8,0,8,群益金鼎-松山,2023-06-06,9103
1795,美時,6,0,6,群益金鼎-松山,2023-06-06,9103
2201,裕隆,7,1,6,群益金鼎-松山,2023-06-06,9103
3013,晟銘電,12,6,6,群益金鼎-松山,2023-06-06,9103
2206,三陽工業,6,1,5,群益金鼎-松山,2023-06-06,9103
00923,群益台ESG低碳50,7,2,5,群益金鼎-松山,2023-06-06,9103
00922,國泰台灣領袖50,5,0,5,群益金鼎-松山,2023-06-06,9103
00633L,富邦上証正2,5,0,5,群益金鼎-松山,2023-06-06,9103
00680L,元大美債20正2,5,0,5,群益金鼎-松山,2023-06-06,9103
1503,士電,12,7,5,群益金鼎-松山,2023-06-06,9103
2603,長榮,5,0,5,群益金鼎-松山,2023-06-06,9103
2722,夏都,25,20,5,群益金鼎-松山,2023-06-06,9103
2743,山富,5,0,5,群益金鼎-松山,2023-06-06,9103
4714,永捷,5,0,5,群益金鼎-松山,2023-06-06,9103
6116,彩晶,210,205,5,群益金鼎-松山,2023-06-06,9103
6205,詮欣,5,0,5,群益金鼎-松山,2023-06-06,9103
6266,泰詠,5,0,5,群益金鼎-松山,2023-06-06,9103
6589,台康生技,5,0,5,群益金鼎-松山,2023-06-06,9103
8088,品安,7,2,5,群益金鼎-松山,2023-06-06,9103
8409,商之器,5,0,5,群益金鼎-松山,2023-06-06,9103
1514,亞力,5,1,4,群益金鼎-松山,2023-06-06,9103
00679B,元大美債20年,6,2,4,群益金鼎-松山,2023-06-06,9103
2228,劍麟,7,3,4,群益金鼎-松山,2023-06-06,9103
2317,鴻海,6,2,4,群益金鼎-松山,2023-06-06,9103
6143,振曜,5,1,4,群益金鼎-松山,2023-06-06,9103
6548,長科*,4,0,4,群益金鼎-松山,2023-06-06,9103
6235,華孚,6,2,4,群益金鼎-松山,2023-06-06,9103
2409,友達,215,0,215,群益金鼎-松山,2023-06-07,9103
2349,錸德,200,0,200,群益金鼎-松山,2023-06-07,9103
1560,中砂,80,0,80,群益金鼎-松山,2023-06-07,9103
3005,神基,57,0,57,群益金鼎-松山,2023-06-07,9103
1608,華榮,40,2,38,群益金鼎-松山,2023-06-07,9103
6188,廣明,39,2,37,群益金鼎-松山,2023-06-07,9103
6244,茂迪,29,0,29,群益金鼎-松山,2023-06-07,9103
6282,康舒,53,24,29,群益金鼎-松山,2023-06-07,9103
00637L,元大滬深300正2,32,5,27,群益金鼎-松山,2023-06-07,9103
2401,凌陽,25,1,24,群益金鼎-松山,2023-06-07,9103
3025,星通,30,6,24,群益金鼎-松山,2023-06-07,9103
2388,威盛,23,1,22,群益金鼎-松山,2023-06-07,9103
2888,新光金,40,22,18,群益金鼎-松山,2023-06-07,9103
00919,群益台灣精選高息,17,0,17,群益金鼎-松山,2023-06-07,9103
8426,紅木-KY,18,1,17,群益金鼎-松山,2023-06-07,9103
2618,長榮航,27,12,15,群益金鼎-松山,2023-06-07,9103
1519,華城,23,8,15,群益金鼎-松山,2023-06-07,9103
5706,鳳凰,20,8,12,群益金鼎-松山,2023-06-07,9103
0056,元大高股息,14,2,12,群益金鼎-松山,2023-06-07,9103
1584,精剛,13,2,11,群益金鼎-松山,2023-06-07,9103
00632R,元大台灣50反1,11,0,11,群益金鼎-松山,2023-06-07,9103
3003,健和興,12,1,11,群益金鼎-松山,2023-06-07,9103
00706L,期元大S＆P日圓正2,10,0,10,群益金鼎-松山,2023-06-07,9103
00668,國泰美國道瓊,10,0,10,群益金鼎-松山,2023-06-07,9103
2402,毅嘉,30,20,10,群益金鼎-松山,2023-06-07,9103
2889,國票金,10,0,10,群益金鼎-松山,2023-06-07,9103
3576,聯合再生,10,0,10,群益金鼎-松山,2023-06-07,9103
8349,�矬�,10,0,10,群益金鼎-松山,2023-06-07,9103
4543,萬在,10,0,10,群益金鼎-松山,2023-06-07,9103
3163,波若威,11,2,9,群益金鼎-松山,2023-06-07,9103
3293,鈊象,8,0,8,群益金鼎-松山,2023-06-07,9103
6456,GIS-KY,8,0,8,群益金鼎-松山,2023-06-07,9103
8341,日友,8,0,8,群益金鼎-松山,2023-06-07,9103
1609,大亞,39,32,7,群益金鼎-松山,2023-06-07,9103
1215,卜蜂,7,0,7,群益金鼎-松山,2023-06-07,9103
2748,雲品,11,4,7,群益金鼎-松山,2023-06-07,9103
6116,彩晶,7,0,7,群益金鼎-松山,2023-06-07,9103
6270,倍微,7,0,7,群益金鼎-松山,2023-06-07,9103
6789,采鈺,7,0,7,群益金鼎-松山,2023-06-07,9103
2201,裕隆,6,0,6,群益金鼎-松山,2023-06-07,9103
3324,雙鴻,6,0,6,群益金鼎-松山,2023-06-07,9103
00676R,富邦臺灣加權反1,5,0,5,群益金鼎-松山,2023-06-07,9103
1324,地球,5,0,5,群益金鼎-松山,2023-06-07,9103
1503,士電,26,21,5,群益金鼎-松山,2023-06-07,9103
2308,台達電,9,4,5,群益金鼎-松山,2023-06-07,9103
2353,宏��,25,20,5,群益金鼎-松山,2023-06-07,9103
2722,夏都,20,15,5,群益金鼎-松山,2023-06-07,9103
4572,駐龍,5,0,5,群益金鼎-松山,2023-06-07,9103
4931,新盛力,5,0,5,群益金鼎-松山,2023-06-07,9103
6122,擎邦,8,3,5,群益金鼎-松山,2023-06-07,9103
1609,大亞,87,37,50,群益金鼎-松山,2023-06-08,9103
00878,國泰永續高股息,43,0,43,群益金鼎-松山,2023-06-08,9103
00680L,元大美債20正2,35,1,34,群益金鼎-松山,2023-06-08,9103
3231,緯創,56,23,33,群益金鼎-松山,2023-06-08,9103
6233,旺玖,32,0,32,群益金鼎-松山,2023-06-08,9103
1101,台泥,41,10,31,群益金鼎-松山,2023-06-08,9103
1905,華紙,31,0,31,群益金鼎-松山,2023-06-08,9103
2482,連宇,71,41,30,群益金鼎-松山,2023-06-08,9103
2739,寒舍,40,10,30,群益金鼎-松山,2023-06-08,9103
1314,中石化,25,0,25,群益金鼎-松山,2023-06-08,9103
3046,建��,43,18,25,群益金鼎-松山,2023-06-08,9103
6203,海韻電,25,0,25,群益金鼎-松山,2023-06-08,9103
2323,中環,25,0,25,群益金鼎-松山,2023-06-08,9103
00720B,元大投資級公司債,22,0,22,群益金鼎-松山,2023-06-08,9103
3078,僑威,39,18,21,群益金鼎-松山,2023-06-08,9103
1432,大魯閣,20,0,20,群益金鼎-松山,2023-06-08,9103
2206,三陽工業,35,16,19,群益金鼎-松山,2023-06-08,9103
5227,立凱-KY,18,0,18,群益金鼎-松山,2023-06-08,9103
8358,金居,17,0,17,群益金鼎-松山,2023-06-08,9103
1584,精剛,31,16,15,群益金鼎-松山,2023-06-08,9103
2706,第一店,45,30,15,群益金鼎-松山,2023-06-08,9103
2401,凌陽,18,5,13,群益金鼎-松山,2023-06-08,9103
5364,力麗店,13,0,13,群益金鼎-松山,2023-06-08,9103
00679B,元大美債20年,13,1,12,群益金鼎-松山,2023-06-08,9103
3374,精材,17,6,11,群益金鼎-松山,2023-06-08,9103
1312,國喬,10,0,10,群益金鼎-松山,2023-06-08,9103
00919,群益台灣精選高息,10,0,10,群益金鼎-松山,2023-06-08,9103
00751B,元大AAA至A公司債,10,0,10,群益金鼎-松山,2023-06-08,9103
2495,普安,10,0,10,群益金鼎-松山,2023-06-08,9103
2834,臺企銀,10,0,10,群益金鼎-松山,2023-06-08,9103
2889,國票金,10,0,10,群益金鼎-松山,2023-06-08,9103
3025,星通,15,5,10,群益金鼎-松山,2023-06-08,9103
5864,致和證,10,0,10,群益金鼎-松山,2023-06-08,9103
6005,群益證,10,0,10,群益金鼎-松山,2023-06-08,9103
6015,宏遠證,10,0,10,群益金鼎-松山,2023-06-08,9103
6517,保勝光學,13,3,10,群益金鼎-松山,2023-06-08,9103
8926,台汽電,10,0,10,群益金鼎-松山,2023-06-08,9103
00637L,元大滬深300正2,9,0,9,群益金鼎-松山,2023-06-08,9103
2344,華邦電,12,3,9,群益金鼎-松山,2023-06-08,9103
2471,資通,24,15,9,群益金鼎-松山,2023-06-08,9103
5876,上海商銀,9,0,9,群益金鼎-松山,2023-06-08,9103
6150,撼訊,9,0,9,群益金鼎-松山,2023-06-08,9103
8222,寶一,15,6,9,群益金鼎-松山,2023-06-08,9103
00687B,國泰20年美債,9,1,8,群益金鼎-松山,2023-06-08,9103
2337,旺宏,8,0,8,群益金鼎-松山,2023-06-08,9103
2383,台光電,7,0,7,群益金鼎-松山,2023-06-08,9103
5284,jpp-KY,10,3,7,群益金鼎-松山,2023-06-08,9103
2324,仁寶,12,6,6,群益金鼎-松山,2023-06-08,9103
3081,聯亞,6,0,6,群益金鼎-松山,2023-06-08,9103
8426,紅木-KY,8,2,6,群益金鼎-松山,2023-06-08,9103
6163,華電網,194,0,194,群益金鼎-松山,2023-06-09,9103
5324,士開,110,0,110,群益金鼎-松山,2023-06-09,9103
00929,復華台灣科技優息,101,0,101,群益金鼎-松山,2023-06-09,9103
1815,富喬,160,60,100,群益金鼎-松山,2023-06-09,9103
8084,巨虹,84,0,84,群益金鼎-松山,2023-06-09,9103
2913,農林,101,20,81,群益金鼎-松山,2023-06-09,9103
9902,台火,70,0,70,群益金鼎-松山,2023-06-09,9103
2888,新光金,59,0,59,群益金鼎-松山,2023-06-09,9103
3231,緯創,84,30,54,群益金鼎-松山,2023-06-09,9103
6122,擎邦,56,4,52,群益金鼎-松山,2023-06-09,9103
00664R,國泰臺灣加權反1,50,0,50,群益金鼎-松山,2023-06-09,9103
6213,聯茂,35,0,35,群益金鼎-松山,2023-06-09,9103
1907,永豐餘,33,1,32,群益金鼎-松山,2023-06-09,9103
1419,新紡,30,0,30,群益金鼎-松山,2023-06-09,9103
1432,大魯閣,22,1,21,群益金鼎-松山,2023-06-09,9103
1903,士紙,20,0,20,群益金鼎-松山,2023-06-09,9103
2353,宏��,31,11,20,群益金鼎-松山,2023-06-09,9103
6276,安鈦克,20,0,20,群益金鼎-松山,2023-06-09,9103
8271,宇瞻,20,0,20,群益金鼎-松山,2023-06-09,9103
1752,南光,19,0,19,群益金鼎-松山,2023-06-09,9103
3363,上詮,25,6,19,群益金鼎-松山,2023-06-09,9103
3380,明泰,17,0,17,群益金鼎-松山,2023-06-09,9103
2356,英業達,50,34,16,群益金鼎-松山,2023-06-09,9103
1514,亞力,18,2,16,群益金鼎-松山,2023-06-09,9103
2388,威盛,20,5,15,群益金鼎-松山,2023-06-09,9103
2497,怡利電,17,3,14,群益金鼎-松山,2023-06-09,9103
5469,瀚宇博,13,0,13,群益金鼎-松山,2023-06-09,9103
6789,采鈺,18,6,12,群益金鼎-松山,2023-06-09,9103
8038,長園科,12,0,12,群益金鼎-松山,2023-06-09,9103
1605,華新,11,1,10,群益金鼎-松山,2023-06-09,9103
1236,宏亞,10,0,10,群益金鼎-松山,2023-06-09,9103
4207,環泰,10,0,10,群益金鼎-松山,2023-06-09,9103
6101,寬魚國際,10,0,10,群益金鼎-松山,2023-06-09,9103
6188,廣明,13,3,10,群益金鼎-松山,2023-06-09,9103
8048,德勝,10,0,10,群益金鼎-松山,2023-06-09,9103
1504,東元,18,9,9,群益金鼎-松山,2023-06-09,9103
2736,富野,9,0,9,群益金鼎-松山,2023-06-09,9103
9904,寶成,7,0,7,群益金鼎-松山,2023-06-09,9103
2383,台光電,7,0,7,群益金鼎-松山,2023-06-09,9103
3680,家登,7,1,6,群益金鼎-松山,2023-06-09,9103
2449,京元電子,5,0,5,群益金鼎-松山,2023-06-09,9103
00903,富邦元宇宙,5,0,5,群益金鼎-松山,2023-06-09,9103
2031,新光鋼,15,10,5,群益金鼎-松山,2023-06-09,9103
2701,萬企,5,0,5,群益金鼎-松山,2023-06-09,9103
4510,高鋒,5,0,5,群益金鼎-松山,2023-06-09,9103
4968,立積,10,5,5,群益金鼎-松山,2023-06-09,9103
8446,華研,16,11,5,群益金鼎-松山,2023-06-09,9103
8996,高力,8,3,5,群益金鼎-松山,2023-06-09,9103
2330,台積電,6,1,5,群益金鼎-松山,2023-06-09,9103
1795,美時,4,0,4,群益金鼎-松山,2023-06-09,9103
00893,國泰智能電動車,139,9,130,群益金鼎-松山,2023-06-12,9103
1524,耿鼎,105,1,104,群益金鼎-松山,2023-06-12,9103
3481,群創,102,1,101,群益金鼎-松山,2023-06-12,9103
1522,堤維西,85,0,85,群益金鼎-松山,2023-06-12,9103
8084,巨虹,55,0,55,群益金鼎-松山,2023-06-12,9103
0056,元大高股息,50,5,45,群益金鼎-松山,2023-06-12,9103
2888,新光金,105,64,41,群益金鼎-松山,2023-06-12,9103
3003,健和興,38,1,37,群益金鼎-松山,2023-06-12,9103
00720B,元大投資級公司債,35,0,35,群益金鼎-松山,2023-06-12,9103
2371,大同,35,3,32,群益金鼎-松山,2023-06-12,9103
1605,華新,24,0,24,群益金鼎-松山,2023-06-12,9103
6139,亞翔,24,0,24,群益金鼎-松山,2023-06-12,9103
4979,華星光,32,10,22,群益金鼎-松山,2023-06-12,9103
2884,玉山金,20,0,20,群益金鼎-松山,2023-06-12,9103
2204,中華,20,0,20,群益金鼎-松山,2023-06-12,9103
2485,兆赫,30,10,20,群益金鼎-松山,2023-06-12,9103
4533,協易機,18,0,18,群益金鼎-松山,2023-06-12,9103
8034,榮群,14,0,14,群益金鼎-松山,2023-06-12,9103
8358,金居,15,1,14,群益金鼎-松山,2023-06-12,9103
3027,盛達,14,1,13,群益金鼎-松山,2023-06-12,9103
1503,士電,21,10,11,群益金鼎-松山,2023-06-12,9103
00632R,元大台灣50反1,10,0,10,群益金鼎-松山,2023-06-12,9103
00878,國泰永續高股息,10,0,10,群益金鼎-松山,2023-06-12,9103
1218,泰山,10,0,10,群益金鼎-松山,2023-06-12,9103
6134,萬旭,10,0,10,群益金鼎-松山,2023-06-12,9103
6548,長科*,11,1,10,群益金鼎-松山,2023-06-12,9103
6585,鼎基,10,0,10,群益金鼎-松山,2023-06-12,9103
6596,寬宏藝術,10,0,10,群益金鼎-松山,2023-06-12,9103
3454,晶睿,12,3,9,群益金鼎-松山,2023-06-12,9103
3260,威剛,11,2,9,群益金鼎-松山,2023-06-12,9103
3231,緯創,127,118,9,群益金鼎-松山,2023-06-12,9103
2345,智邦,8,0,8,群益金鼎-松山,2023-06-12,9103
1905,華紙,10,2,8,群益金鼎-松山,2023-06-12,9103
2547,日勝生,8,0,8,群益金鼎-松山,2023-06-12,9103
3011,今皓,21,13,8,群益金鼎-松山,2023-06-12,9103
8081,致新,8,0,8,群益金鼎-松山,2023-06-12,9103
3078,僑威,56,48,8,群益金鼎-松山,2023-06-12,9103
2883,凱基金,7,0,7,群益金鼎-松山,2023-06-12,9103
9924,福興,7,0,7,群益金鼎-松山,2023-06-12,9103
2323,中環,20,13,7,群益金鼎-松山,2023-06-12,9103
1519,華城,13,7,6,群益金鼎-松山,2023-06-12,9103
00929,復華台灣科技優息,6,0,6,群益金鼎-松山,2023-06-12,9103
1527,鑽全,6,0,6,群益金鼎-松山,2023-06-12,9103
1711,永光,6,0,6,群益金鼎-松山,2023-06-12,9103
2637,慧洋-KY,6,0,6,群益金鼎-松山,2023-06-12,9103
6443,元晶,6,0,6,群益金鼎-松山,2023-06-12,9103
2324,仁寶,5,0,5,群益金鼎-松山,2023-06-12,9103
3081,聯亞,5,0,5,群益金鼎-松山,2023-06-12,9103
1591,駿吉-KY,5,0,5,群益金鼎-松山,2023-06-12,9103
00919,群益台灣精選高息,5,0,5,群益金鼎-松山,2023-06-12,9103
00919,群益台灣精選高息,140,0,140,群益金鼎-松山,2023-06-13,9103
2356,英業達,179,59,120,群益金鼎-松山,2023-06-13,9103
3231,緯創,82,43,39,群益金鼎-松山,2023-06-13,9103
1522,堤維西,40,2,38,群益金鼎-松山,2023-06-13,9103
2610,華航,50,15,35,群益金鼎-松山,2023-06-13,9103
6417,韋僑,68,34,34,群益金鼎-松山,2023-06-13,9103
1437,勤益控,24,0,24,群益金鼎-松山,2023-06-13,9103
1785,光洋科,20,0,20,群益金鼎-松山,2023-06-13,9103
6282,康舒,24,6,18,群益金鼎-松山,2023-06-13,9103
3363,上詮,20,4,16,群益金鼎-松山,2023-06-13,9103
00715L,期街口布蘭特正2,14,0,14,群益金鼎-松山,2023-06-13,9103
2328,廣宇,16,2,14,群益金鼎-松山,2023-06-13,9103
4533,協易機,21,7,14,群益金鼎-松山,2023-06-13,9103
2359,所羅門,13,0,13,群益金鼎-松山,2023-06-13,9103
5706,鳳凰,43,31,12,群益金鼎-松山,2023-06-13,9103
6139,亞翔,11,0,11,群益金鼎-松山,2023-06-13,9103
8926,台汽電,12,1,11,群益金鼎-松山,2023-06-13,9103
6191,精成科,11,0,11,群益金鼎-松山,2023-06-13,9103
00680L,元大美債20正2,10,0,10,群益金鼎-松山,2023-06-13,9103
00671R,富邦NASDAQ反1,10,0,10,群益金鼎-松山,2023-06-13,9103
00712,復華富時不動產,10,0,10,群益金鼎-松山,2023-06-13,9103
00706L,期元大S＆P日圓正2,10,0,10,群益金鼎-松山,2023-06-13,9103
00882,中信中國高股息,10,0,10,群益金鼎-松山,2023-06-13,9103
1909,榮成,10,0,10,群益金鼎-松山,2023-06-13,9103
2882,國泰金,10,0,10,群益金鼎-松山,2023-06-13,9103
3163,波若威,17,7,10,群益金鼎-松山,2023-06-13,9103
3312,弘憶股,10,0,10,群益金鼎-松山,2023-06-13,9103
6269,台郡,10,0,10,群益金鼎-松山,2023-06-13,9103
3011,今皓,7,0,7,群益金鼎-松山,2023-06-13,9103
6150,撼訊,7,0,7,群益金鼎-松山,2023-06-13,9103
2489,瑞軒,7,0,7,群益金鼎-松山,2023-06-13,9103
1519,華城,9,3,6,群益金鼎-松山,2023-06-13,9103
2376,技嘉,16,10,6,群益金鼎-松山,2023-06-13,9103
2851,中再保,6,0,6,群益金鼎-松山,2023-06-13,9103
2206,三陽工業,16,11,5,群益金鼎-松山,2023-06-13,9103
00751B,元大AAA至A公司債,5,0,5,群益金鼎-松山,2023-06-13,9103
1236,宏亞,5,0,5,群益金鼎-松山,2023-06-13,9103
2338,光罩,5,0,5,群益金鼎-松山,2023-06-13,9103
3289,宜特,6,1,5,群益金鼎-松山,2023-06-13,9103
3413,京鼎,5,0,5,群益金鼎-松山,2023-06-13,9103
3617,碩天,5,0,5,群益金鼎-松山,2023-06-13,9103
4746,台耀,5,0,5,群益金鼎-松山,2023-06-13,9103
4768,晶呈科技,11,6,5,群益金鼎-松山,2023-06-13,9103
6147,頎邦,6,1,5,群益金鼎-松山,2023-06-13,9103
2731,雄獅,5,1,4,群益金鼎-松山,2023-06-13,9103
4906,正文,4,0,4,群益金鼎-松山,2023-06-13,9103
5243,乙盛-KY,4,0,4,群益金鼎-松山,2023-06-13,9103
5434,崇越,4,0,4,群益金鼎-松山,2023-06-13,9103
8071,能率網通,4,0,4,群益金鼎-松山,2023-06-13,9103
8114,振樺電,19,15,4,群益金鼎-松山,2023-06-13,9103
5347,世界,140,0,140,群益金鼎-松山,2023-06-14,9103
2618,長榮航,376,299,77,群益金鼎-松山,2023-06-14,9103
1522,堤維西,95,46,49,群益金鼎-松山,2023-06-14,9103
00919,群益台灣精選高息,41,0,41,群益金鼎-松山,2023-06-14,9103
00680L,元大美債20正2,40,0,40,群益金鼎-松山,2023-06-14,9103
1907,永豐餘,31,0,31,群益金鼎-松山,2023-06-14,9103
00706L,期元大S＆P日圓正2,25,0,25,群益金鼎-松山,2023-06-14,9103
2630,亞航,27,5,22,群益金鼎-松山,2023-06-14,9103
3011,今皓,21,0,21,群益金鼎-松山,2023-06-14,9103
2705,六福,40,20,20,群益金鼎-松山,2023-06-14,9103
3147,大綜,17,0,17,群益金鼎-松山,2023-06-14,9103
2609,陽明,14,0,14,群益金鼎-松山,2023-06-14,9103
3260,威剛,14,1,13,群益金鼎-松山,2023-06-14,9103
3356,奇偶,12,0,12,群益金鼎-松山,2023-06-14,9103
4551,智伸科,12,0,12,群益金鼎-松山,2023-06-14,9103
2368,金像電,10,0,10,群益金鼎-松山,2023-06-14,9103
2736,富野,10,0,10,群益金鼎-松山,2023-06-14,9103
6205,詮欣,10,0,10,群益金鼎-松山,2023-06-14,9103
6150,撼訊,9,0,9,群益金鼎-松山,2023-06-14,9103
2382,廣達,11,3,8,群益金鼎-松山,2023-06-14,9103
2468,華經,8,0,8,群益金鼎-松山,2023-06-14,9103
2851,中再保,8,0,8,群益金鼎-松山,2023-06-14,9103
1591,駿吉-KY,7,0,7,群益金鼎-松山,2023-06-14,9103
00682U,期元大美元指數,7,0,7,群益金鼎-松山,2023-06-14,9103
2317,鴻海,7,0,7,群益金鼎-松山,2023-06-14,9103
3055,蔚華科,7,0,7,群益金鼎-松山,2023-06-14,9103
5258,虹堡,12,6,6,群益金鼎-松山,2023-06-14,9103
8446,華研,16,10,6,群益金鼎-松山,2023-06-14,9103
1609,大亞,12,7,5,群益金鼎-松山,2023-06-14,9103
00687B,國泰20年美債,5,0,5,群益金鼎-松山,2023-06-14,9103
2436,偉詮電,5,0,5,群益金鼎-松山,2023-06-14,9103
3617,碩天,5,0,5,群益金鼎-松山,2023-06-14,9103
00720B,元大投資級公司債,5,0,5,群益金鼎-松山,2023-06-14,9103
1236,宏亞,5,0,5,群益金鼎-松山,2023-06-14,9103
00676R,富邦臺灣加權反1,5,0,5,群益金鼎-松山,2023-06-14,9103
00671R,富邦NASDAQ反1,5,0,5,群益金鼎-松山,2023-06-14,9103
00696B,富邦美債20年,5,0,5,群益金鼎-松山,2023-06-14,9103
2313,華通,5,0,5,群益金鼎-松山,2023-06-14,9103
2884,玉山金,5,0,5,群益金鼎-松山,2023-06-14,9103
3081,聯亞,5,0,5,群益金鼎-松山,2023-06-14,9103
5236,凌陽創新,5,0,5,群益金鼎-松山,2023-06-14,9103
2614,東森,5,0,5,群益金鼎-松山,2023-06-14,9103
00712,復華富時不動產,5,1,4,群益金鼎-松山,2023-06-14,9103
2352,佳世達,4,0,4,群益金鼎-松山,2023-06-14,9103
2457,飛宏,10,6,4,群益金鼎-松山,2023-06-14,9103
2722,夏都,16,12,4,群益金鼎-松山,2023-06-14,9103
2888,新光金,4,0,4,群益金鼎-松山,2023-06-14,9103
3027,盛達,4,0,4,群益金鼎-松山,2023-06-14,9103
6015,宏遠證,4,0,4,群益金鼎-松山,2023-06-14,9103
6147,頎邦,4,0,4,群益金鼎-松山,2023-06-14,9103
2913,農林,621,5,616,群益金鼎-松山,2023-06-15,9103
3481,群創,115,3,112,群益金鼎-松山,2023-06-15,9103
5324,士開,100,0,100,群益金鼎-松山,2023-06-15,9103
00706L,期元大S＆P日圓正2,76,0,76,群益金鼎-松山,2023-06-15,9103
3078,僑威,53,0,53,群益金鼎-松山,2023-06-15,9103
4167,松瑞藥,50,0,50,群益金鼎-松山,2023-06-15,9103
1506,正道,49,0,49,群益金鼎-松山,2023-06-15,9103
1815,富喬,50,1,49,群益金鼎-松山,2023-06-15,9103
3013,晟銘電,47,0,47,群益金鼎-松山,2023-06-15,9103
2618,長榮航,290,247,43,群益金鼎-松山,2023-06-15,9103
3059,華晶科,34,0,34,群益金鼎-松山,2023-06-15,9103
00715L,期街口布蘭特正2,31,0,31,群益金鼎-松山,2023-06-15,9103
8926,台汽電,31,0,31,群益金鼎-松山,2023-06-15,9103
2356,英業達,172,141,31,群益金鼎-松山,2023-06-15,9103
1307,三芳,30,1,29,群益金鼎-松山,2023-06-15,9103
2610,華航,284,257,27,群益金鼎-松山,2023-06-15,9103
1519,華城,38,14,24,群益金鼎-松山,2023-06-15,9103
4938,和碩,23,2,21,群益金鼎-松山,2023-06-15,9103
00919,群益台灣精選高息,21,1,20,群益金鼎-松山,2023-06-15,9103
1905,華紙,30,10,20,群益金鼎-松山,2023-06-15,9103
2371,大同,74,54,20,群益金鼎-松山,2023-06-15,9103
1514,亞力,41,22,19,群益金鼎-松山,2023-06-15,9103
1504,東元,19,1,18,群益金鼎-松山,2023-06-15,9103
2482,連宇,22,4,18,群益金鼎-松山,2023-06-15,9103
2888,新光金,27,10,17,群益金鼎-松山,2023-06-15,9103
3025,星通,22,5,17,群益金鼎-松山,2023-06-15,9103
3706,神達,45,29,16,群益金鼎-松山,2023-06-15,9103
3346,麗清,16,0,16,群益金鼎-松山,2023-06-15,9103
2332,友訊,15,0,15,群益金鼎-松山,2023-06-15,9103
6143,振曜,15,0,15,群益金鼎-松山,2023-06-15,9103
6148,驊宏資,22,8,14,群益金鼎-松山,2023-06-15,9103
2317,鴻海,36,22,14,群益金鼎-松山,2023-06-15,9103
8033,雷虎,15,2,13,群益金鼎-松山,2023-06-15,9103
1218,泰山,11,0,11,群益金鼎-松山,2023-06-15,9103
1536,和大,11,0,11,群益金鼎-松山,2023-06-15,9103
3019,亞光,16,5,11,群益金鼎-松山,2023-06-15,9103
5351,鈺創,11,0,11,群益金鼎-松山,2023-06-15,9103
1903,士紙,10,0,10,群益金鼎-松山,2023-06-15,9103
2201,裕隆,11,1,10,群益金鼎-松山,2023-06-15,9103
2609,陽明,10,0,10,群益金鼎-松山,2023-06-15,9103
6015,宏遠證,10,0,10,群益金鼎-松山,2023-06-15,9103
3046,建��,12,2,10,群益金鼎-松山,2023-06-15,9103
2059,川湖,9,0,9,群益金鼎-松山,2023-06-15,9103
1503,士電,26,17,9,群益金鼎-松山,2023-06-15,9103
1795,美時,9,1,8,群益金鼎-松山,2023-06-15,9103
2630,亞航,9,1,8,群益金鼎-松山,2023-06-15,9103
3374,精材,10,2,8,群益金鼎-松山,2023-06-15,9103
3576,聯合再生,8,0,8,群益金鼎-松山,2023-06-15,9103
3033,威健,7,0,7,群益金鼎-松山,2023-06-15,9103
5443,均豪,7,0,7,群益金鼎-松山,2023-06-15,9103
2409,友達,100,16,84,群益金鼎-松山,2023-06-16,9103
5347,世界,75,3,72,群益金鼎-松山,2023-06-16,9103
1522,堤維西,69,10,59,群益金鼎-松山,2023-06-16,9103
5426,振發,55,0,55,群益金鼎-松山,2023-06-16,9103
1504,東元,50,9,41,群益金鼎-松山,2023-06-16,9103
2706,第一店,40,0,40,群益金鼎-松山,2023-06-16,9103
3706,神達,100,77,23,群益金鼎-松山,2023-06-16,9103
2634,漢翔,25,2,23,群益金鼎-松山,2023-06-16,9103
8085,福華,20,0,20,群益金鼎-松山,2023-06-16,9103
1605,華新,26,7,19,群益金鼎-松山,2023-06-16,9103
5469,瀚宇博,20,1,19,群益金鼎-松山,2023-06-16,9103
2630,亞航,25,7,18,群益金鼎-松山,2023-06-16,9103
2371,大同,131,115,16,群益金鼎-松山,2023-06-16,9103
3591,艾笛森,14,0,14,群益金鼎-松山,2023-06-16,9103
3005,神基,12,0,12,群益金鼎-松山,2023-06-16,9103
6148,驊宏資,12,0,12,群益金鼎-松山,2023-06-16,9103
3260,威剛,16,5,11,群益金鼎-松山,2023-06-16,9103
3707,漢磊,11,0,11,群益金鼎-松山,2023-06-16,9103
00639,富邦深100,10,0,10,群益金鼎-松山,2023-06-16,9103
00712,復華富時不動產,10,0,10,群益金鼎-松山,2023-06-16,9103
2014,中鴻,10,0,10,群益金鼎-松山,2023-06-16,9103
2615,萬海,10,0,10,群益金鼎-松山,2023-06-16,9103
1907,永豐餘,10,1,9,群益金鼎-松山,2023-06-16,9103
2201,裕隆,11,2,9,群益金鼎-松山,2023-06-16,9103
8358,金居,11,2,9,群益金鼎-松山,2023-06-16,9103
2301,光寶科,19,11,8,群益金鼎-松山,2023-06-16,9103
2382,廣達,23,16,7,群益金鼎-松山,2023-06-16,9103
3022,威強電,8,1,7,群益金鼎-松山,2023-06-16,9103
1784,訊聯,8,1,7,群益金鼎-松山,2023-06-16,9103
1727,中華化,8,2,6,群益金鼎-松山,2023-06-16,9103
2645,長榮航太,6,0,6,群益金鼎-松山,2023-06-16,9103
3081,聯亞,6,0,6,群益金鼎-松山,2023-06-16,9103
1316,上曜,5,0,5,群益金鼎-松山,2023-06-16,9103
2204,中華,5,0,5,群益金鼎-松山,2023-06-16,9103
2308,台達電,7,2,5,群益金鼎-松山,2023-06-16,9103
2743,山富,5,0,5,群益金鼎-松山,2023-06-16,9103
3346,麗清,5,0,5,群益金鼎-松山,2023-06-16,9103
5475,德宏,5,0,5,群益金鼎-松山,2023-06-16,9103
5907,大洋-KY,5,0,5,群益金鼎-松山,2023-06-16,9103
6167,久正,5,0,5,群益金鼎-松山,2023-06-16,9103
1101,台泥,5,0,5,群益金鼎-松山,2023-06-16,9103
2886,兆豐金,4,0,4,群益金鼎-松山,2023-06-16,9103
1229,聯華,5,1,4,群益金鼎-松山,2023-06-16,9103
1611,中電,4,0,4,群益金鼎-松山,2023-06-16,9103
2359,所羅門,4,0,4,群益金鼎-松山,2023-06-16,9103
2609,陽明,5,1,4,群益金鼎-松山,2023-06-16,9103
3046,建��,16,12,4,群益金鼎-松山,2023-06-16,9103
3406,玉晶光,4,0,4,群益金鼎-松山,2023-06-16,9103
4536,拓凱,4,0,4,群益金鼎-松山,2023-06-16,9103
5425,台半,4,0,4,群益金鼎-松山,2023-06-16,9103
2409,友達,300,159,141,群益金鼎-松山,2023-06-19,9103
6116,彩晶,328,212,116,群益金鼎-松山,2023-06-19,9103
00712,復華富時不動產,105,0,105,群益金鼎-松山,2023-06-19,9103
6214,精誠,189,100,89,群益金鼎-松山,2023-06-19,9103
2323,中環,80,10,70,群益金鼎-松山,2023-06-19,9103
6217,中探針,60,2,58,群益金鼎-松山,2023-06-19,9103
2104,國際中橡,54,5,49,群益金鼎-松山,2023-06-19,9103
2356,英業達,55,7,48,群益金鼎-松山,2023-06-19,9103
8033,雷虎,48,4,44,群益金鼎-松山,2023-06-19,9103
5364,力麗店,38,0,38,群益金鼎-松山,2023-06-19,9103
3006,晶豪科,36,2,34,群益金鼎-松山,2023-06-19,9103
2705,六福,33,3,30,群益金鼎-松山,2023-06-19,9103
1584,精剛,62,32,30,群益金鼎-松山,2023-06-19,9103
2634,漢翔,71,44,27,群益金鼎-松山,2023-06-19,9103
6203,海韻電,25,0,25,群益金鼎-松山,2023-06-19,9103
1513,中興電,59,36,23,群益金鼎-松山,2023-06-19,9103
2630,亞航,69,47,22,群益金鼎-松山,2023-06-19,9103
3003,健和興,23,2,21,群益金鼎-松山,2023-06-19,9103
00632R,元大台灣50反1,20,0,20,群益金鼎-松山,2023-06-19,9103
00706L,期元大S＆P日圓正2,20,0,20,群益金鼎-松山,2023-06-19,9103
2734,易飛網,19,0,19,群益金鼎-松山,2023-06-19,9103
2883,凱基金,19,0,19,群益金鼎-松山,2023-06-19,9103
1810,和成,17,0,17,群益金鼎-松山,2023-06-19,9103
6104,創惟,40,27,13,群益金鼎-松山,2023-06-19,9103
1605,華新,12,0,12,群益金鼎-松山,2023-06-19,9103
2888,新光金,12,0,12,群益金鼎-松山,2023-06-19,9103
5706,鳳凰,38,26,12,群益金鼎-松山,2023-06-19,9103
3228,金麗科,11,0,11,群益金鼎-松山,2023-06-19,9103
1591,駿吉-KY,10,0,10,群益金鼎-松山,2023-06-19,9103
1531,高林股,10,0,10,群益金鼎-松山,2023-06-19,9103
00720B,元大投資級公司債,10,0,10,群益金鼎-松山,2023-06-19,9103
1218,泰山,10,0,10,群益金鼎-松山,2023-06-19,9103
5353,台林,10,0,10,群益金鼎-松山,2023-06-19,9103
1440,南紡,8,0,8,群益金鼎-松山,2023-06-19,9103
2609,陽明,12,4,8,群益金鼎-松山,2023-06-19,9103
3025,星通,8,0,8,群益金鼎-松山,2023-06-19,9103
3372,典範,8,0,8,群益金鼎-松山,2023-06-19,9103
4707,磐亞,8,0,8,群益金鼎-松山,2023-06-19,9103
4938,和碩,9,1,8,群益金鼎-松山,2023-06-19,9103
1503,士電,34,27,7,群益金鼎-松山,2023-06-19,9103
2014,中鴻,7,0,7,群益金鼎-松山,2023-06-19,9103
2498,宏達電,9,2,7,群益金鼎-松山,2023-06-19,9103
3380,明泰,8,1,7,群益金鼎-松山,2023-06-19,9103
4916,事欣科,8,1,7,群益金鼎-松山,2023-06-19,9103
4967,十銓,16,9,7,群益金鼎-松山,2023-06-19,9103
2801,彰銀,7,0,7,群益金鼎-松山,2023-06-19,9103
2204,中華,127,120,7,群益金鼎-松山,2023-06-19,9103
2351,順德,6,0,6,群益金鼎-松山,2023-06-19,9103
2851,中再保,6,0,6,群益金鼎-松山,2023-06-19,9103
6125,廣運,8,2,6,群益金鼎-松山,2023-06-19,9103
2405,輔信,100,1,99,群益金鼎-松山,2023-06-20,9103
2706,第一店,90,30,60,群益金鼎-松山,2023-06-20,9103
2017,官田鋼,61,3,58,群益金鼎-松山,2023-06-20,9103
5531,鄉林,50,0,50,群益金鼎-松山,2023-06-20,9103
00706L,期元大S＆P日圓正2,41,0,41,群益金鼎-松山,2023-06-20,9103
3011,今皓,42,7,35,群益金鼎-松山,2023-06-20,9103
2356,英業達,34,4,30,群益金鼎-松山,2023-06-20,9103
1529,樂事綠能,29,1,28,群益金鼎-松山,2023-06-20,9103
1471,首利,31,3,28,群益金鼎-松山,2023-06-20,9103
6147,頎邦,25,0,25,群益金鼎-松山,2023-06-20,9103
8222,寶一,75,52,23,群益金鼎-松山,2023-06-20,9103
6101,寬魚國際,22,0,22,群益金鼎-松山,2023-06-20,9103
6290,良維,28,6,22,群益金鼎-松山,2023-06-20,9103
00671R,富邦NASDAQ反1,21,0,21,群益金鼎-松山,2023-06-20,9103
2634,漢翔,45,24,21,群益金鼎-松山,2023-06-20,9103
5469,瀚宇博,21,0,21,群益金鼎-松山,2023-06-20,9103
00680L,元大美債20正2,20,0,20,群益金鼎-松山,2023-06-20,9103
8085,福華,20,0,20,群益金鼎-松山,2023-06-20,9103
2104,國際中橡,20,1,19,群益金鼎-松山,2023-06-20,9103
2323,中環,43,24,19,群益金鼎-松山,2023-06-20,9103
1514,亞力,21,3,18,群益金鼎-松山,2023-06-20,9103
1528,恩德,23,6,17,群益金鼎-松山,2023-06-20,9103
3081,聯亞,15,0,15,群益金鼎-松山,2023-06-20,9103
3707,漢磊,13,0,13,群益金鼎-松山,2023-06-20,9103
3147,大綜,10,0,10,群益金鼎-松山,2023-06-20,9103
3287,廣寰科,10,0,10,群益金鼎-松山,2023-06-20,9103
5014,建錩,10,0,10,群益金鼎-松山,2023-06-20,9103
5475,德宏,10,0,10,群益金鼎-松山,2023-06-20,9103
5512,力麒,10,0,10,群益金鼎-松山,2023-06-20,9103
6213,聯茂,10,0,10,群益金鼎-松山,2023-06-20,9103
1519,華城,13,4,9,群益金鼎-松山,2023-06-20,9103
6016,康和證,9,0,9,群益金鼎-松山,2023-06-20,9103
00772B,中信高評級公司債,8,0,8,群益金鼎-松山,2023-06-20,9103
2206,三陽工業,14,6,8,群益金鼎-松山,2023-06-20,9103
3006,晶豪科,8,0,8,群益金鼎-松山,2023-06-20,9103
00878,國泰永續高股息,7,0,7,群益金鼎-松山,2023-06-20,9103
3231,緯創,52,45,7,群益金鼎-松山,2023-06-20,9103
4968,立積,9,2,7,群益金鼎-松山,2023-06-20,9103
8446,華研,7,0,7,群益金鼎-松山,2023-06-20,9103
2883,凱基金,6,0,6,群益金鼎-松山,2023-06-20,9103
3374,精材,6,0,6,群益金鼎-松山,2023-06-20,9103
6266,泰詠,6,0,6,群益金鼎-松山,2023-06-20,9103
3701,大眾控,5,0,5,群益金鼎-松山,2023-06-20,9103
2313,華通,5,0,5,群益金鼎-松山,2023-06-20,9103
2317,鴻海,5,0,5,群益金鼎-松山,2023-06-20,9103
2633,台灣高鐵,5,0,5,群益金鼎-松山,2023-06-20,9103
2712,遠雄來,10,5,5,群益金鼎-松山,2023-06-20,9103
3013,晟銘電,5,0,5,群益金鼎-松山,2023-06-20,9103
4931,新盛力,5,0,5,群益金鼎-松山,2023-06-20,9103
5443,均豪,5,0,5,群益金鼎-松山,2023-06-20,9103
1513,中興電,203,3,200,群益金鼎-松山,2023-06-21,9103
2312,金寶,101,0,101,群益金鼎-松山,2023-06-21,9103
3013,晟銘電,78,4,74,群益金鼎-松山,2023-06-21,9103
3049,精金,60,0,60,群益金鼎-松山,2023-06-21,9103
1909,榮成,100,53,47,群益金鼎-松山,2023-06-21,9103
2427,三商電,47,10,37,群益金鼎-松山,2023-06-21,9103
3011,今皓,39,5,34,群益金鼎-松山,2023-06-21,9103
4533,協易機,30,0,30,群益金鼎-松山,2023-06-21,9103
5364,力麗店,30,0,30,群益金鼎-松山,2023-06-21,9103
2468,華經,27,0,27,群益金鼎-松山,2023-06-21,9103
3078,僑威,24,2,22,群益金鼎-松山,2023-06-21,9103
2324,仁寶,20,0,20,群益金鼎-松山,2023-06-21,9103
2457,飛宏,27,7,20,群益金鼎-松山,2023-06-21,9103
2736,富野,20,0,20,群益金鼎-松山,2023-06-21,9103
1905,華紙,134,115,19,群益金鼎-松山,2023-06-21,9103
1514,亞力,42,27,15,群益金鼎-松山,2023-06-21,9103
3715,定穎投控,17,2,15,群益金鼎-松山,2023-06-21,9103
911868,同方友友-DR,15,0,15,群益金鼎-松山,2023-06-21,9103
2383,台光電,14,0,14,群益金鼎-松山,2023-06-21,9103
2748,雲品,22,10,12,群益金鼎-松山,2023-06-21,9103
3583,辛耘,12,0,12,群益金鼎-松山,2023-06-21,9103
3231,緯創,73,62,11,群益金鼎-松山,2023-06-21,9103
6214,精誠,12,1,11,群益金鼎-松山,2023-06-21,9103
1591,駿吉-KY,10,0,10,群益金鼎-松山,2023-06-21,9103
1519,華城,23,13,10,群益金鼎-松山,2023-06-21,9103
00671R,富邦NASDAQ反1,10,0,10,群益金鼎-松山,2023-06-21,9103
00706L,期元大S＆P日圓正2,10,0,10,群益金鼎-松山,2023-06-21,9103
2059,川湖,10,0,10,群益金鼎-松山,2023-06-21,9103
2485,兆赫,20,10,10,群益金鼎-松山,2023-06-21,9103
3264,欣銓,12,2,10,群益金鼎-松山,2023-06-21,9103
4538,大詠城,10,0,10,群益金鼎-松山,2023-06-21,9103
6125,廣運,14,4,10,群益金鼎-松山,2023-06-21,9103
00720B,元大投資級公司債,9,0,9,群益金鼎-松山,2023-06-21,9103
8086,宏捷科,9,0,9,群益金鼎-松山,2023-06-21,9103
00878,國泰永續高股息,8,0,8,群益金鼎-松山,2023-06-21,9103
2340,台亞,31,23,8,群益金鼎-松山,2023-06-21,9103
3511,矽瑪,7,0,7,群益金鼎-松山,2023-06-21,9103
6282,康舒,11,4,7,群益金鼎-松山,2023-06-21,9103
00772B,中信高評級公司債,6,0,6,群益金鼎-松山,2023-06-21,9103
2913,農林,6,0,6,群益金鼎-松山,2023-06-21,9103
3706,神達,10,4,6,群益金鼎-松山,2023-06-21,9103
6596,寬宏藝術,6,0,6,群益金鼎-松山,2023-06-21,9103
1795,美時,5,0,5,群益金鼎-松山,2023-06-21,9103
1103,嘉泥,5,0,5,群益金鼎-松山,2023-06-21,9103
2745,五福,5,0,5,群益金鼎-松山,2023-06-21,9103
2454,聯發科,4,0,4,群益金鼎-松山,2023-06-21,9103
2353,宏��,10,6,4,群益金鼎-松山,2023-06-21,9103
1229,聯華,5,1,4,群益金鼎-松山,2023-06-21,9103
1609,大亞,5,1,4,群益金鼎-松山,2023-06-21,9103
1608,華榮,4,0,4,群益金鼎-松山,2023-06-21,9103
00893,國泰智能電動車,100,0,100,群益金鼎-松山,2023-06-26,9103
00674R,期元大S＆P黃金反1,100,0,100,群益金鼎-松山,2023-06-26,9103
00895,富邦未來車,100,2,98,群益金鼎-松山,2023-06-26,9103
3033,威健,93,0,93,群益金鼎-松山,2023-06-26,9103
00830,國泰費城半導體,55,0,55,群益金鼎-松山,2023-06-26,9103
2618,長榮航,52,9,43,群益金鼎-松山,2023-06-26,9103
3003,健和興,38,0,38,群益金鼎-松山,2023-06-26,9103
9105,泰金寶-DR,25,0,25,群益金鼎-松山,2023-06-26,9103
1605,華新,23,0,23,群益金鼎-松山,2023-06-26,9103
00919,群益台灣精選高息,23,0,23,群益金鼎-松山,2023-06-26,9103
3706,神達,32,9,23,群益金鼎-松山,2023-06-26,9103
8358,金居,28,7,21,群益金鼎-松山,2023-06-26,9103
00670L,富邦NASDAQ正2,20,0,20,群益金鼎-松山,2023-06-26,9103
2812,台中銀,20,0,20,群益金鼎-松山,2023-06-26,9103
3006,晶豪科,20,0,20,群益金鼎-松山,2023-06-26,9103
3715,定穎投控,20,0,20,群益金鼎-松山,2023-06-26,9103
2332,友訊,20,0,20,群益金鼎-松山,2023-06-26,9103
6150,撼訊,17,0,17,群益金鼎-松山,2023-06-26,9103
00706L,期元大S＆P日圓正2,16,0,16,群益金鼎-松山,2023-06-26,9103
1513,中興電,27,12,15,群益金鼎-松山,2023-06-26,9103
00720B,元大投資級公司債,15,0,15,群益金鼎-松山,2023-06-26,9103
00712,復華富時不動產,14,0,14,群益金鼎-松山,2023-06-26,9103
1736,喬山,13,0,13,群益金鼎-松山,2023-06-26,9103
4503,金雨,12,0,12,群益金鼎-松山,2023-06-26,9103
2609,陽明,11,0,11,群益金鼎-松山,2023-06-26,9103
6695,芯鼎,10,0,10,群益金鼎-松山,2023-06-26,9103
1525,江申,10,0,10,群益金鼎-松山,2023-06-26,9103
00927,群益半導體收益,10,0,10,群益金鼎-松山,2023-06-26,9103
4538,大詠城,10,0,10,群益金鼎-松山,2023-06-26,9103
6265,方土昶,10,0,10,群益金鼎-松山,2023-06-26,9103
2383,台光電,9,0,9,群益金鼎-松山,2023-06-26,9103
2913,農林,10,1,9,群益金鼎-松山,2023-06-26,9103
3711,日月光投控,10,1,9,群益金鼎-松山,2023-06-26,9103
1218,泰山,8,0,8,群益金鼎-松山,2023-06-26,9103
1710,東聯,8,0,8,群益金鼎-松山,2023-06-26,9103
2887,台新金,10,2,8,群益金鼎-松山,2023-06-26,9103
6148,驊宏資,8,0,8,群益金鼎-松山,2023-06-26,9103
6176,瑞儀,8,0,8,群益金鼎-松山,2023-06-26,9103
1301,台塑,7,0,7,群益金鼎-松山,2023-06-26,9103
00640L,富邦日本正2,6,0,6,群益金鼎-松山,2023-06-26,9103
2250,IKKA-KY,6,0,6,群益金鼎-松山,2023-06-26,9103
2317,鴻海,16,10,6,群益金鼎-松山,2023-06-26,9103
2615,萬海,6,0,6,群益金鼎-松山,2023-06-26,9103
2634,漢翔,9,3,6,群益金鼎-松山,2023-06-26,9103
2734,易飛網,6,0,6,群益金鼎-松山,2023-06-26,9103
3454,晶睿,8,2,6,群益金鼎-松山,2023-06-26,9103
6244,茂迪,6,0,6,群益金鼎-松山,2023-06-26,9103
3013,晟銘電,5,0,5,群益金鼎-松山,2023-06-26,9103
2645,長榮航太,5,0,5,群益金鼎-松山,2023-06-26,9103
1591,駿吉-KY,5,0,5,群益金鼎-松山,2023-06-26,9103
1513,中興電,313,110,203,群益金鼎-松山,2023-06-27,9103
2603,長榮,110,4,106,群益金鼎-松山,2023-06-27,9103
3011,今皓,66,5,61,群益金鼎-松山,2023-06-27,9103
5483,中美晶,52,0,52,群益金鼎-松山,2023-06-27,9103
1314,中石化,50,0,50,群益金鼎-松山,2023-06-27,9103
00640L,富邦日本正2,50,0,50,群益金鼎-松山,2023-06-27,9103
3682,亞太電,50,0,50,群益金鼎-松山,2023-06-27,9103
2618,長榮航,134,94,40,群益金鼎-松山,2023-06-27,9103
5469,瀚宇博,40,0,40,群益金鼎-松山,2023-06-27,9103
8358,金居,55,19,36,群益金鼎-松山,2023-06-27,9103
2409,友達,28,0,28,群益金鼎-松山,2023-06-27,9103
3231,緯創,71,46,25,群益金鼎-松山,2023-06-27,9103
1605,華新,27,2,25,群益金鼎-松山,2023-06-27,9103
4174,浩鼎,23,0,23,群益金鼎-松山,2023-06-27,9103
2023,燁輝,20,0,20,群益金鼎-松山,2023-06-27,9103
2317,鴻海,21,1,20,群益金鼎-松山,2023-06-27,9103
2449,京元電子,20,1,19,群益金鼎-松山,2023-06-27,9103
2610,華航,141,125,16,群益金鼎-松山,2023-06-27,9103
2344,華邦電,16,0,16,群益金鼎-松山,2023-06-27,9103
3481,群創,20,4,16,群益金鼎-松山,2023-06-27,9103
1609,大亞,13,1,12,群益金鼎-松山,2023-06-27,9103
6456,GIS-KY,12,0,12,群益金鼎-松山,2023-06-27,9103
2303,聯電,14,2,12,群益金鼎-松山,2023-06-27,9103
3346,麗清,10,0,10,群益金鼎-松山,2023-06-27,9103
4979,華星光,12,2,10,群益金鼎-松山,2023-06-27,9103
6112,邁達特,10,0,10,群益金鼎-松山,2023-06-27,9103
8201,無敵,10,0,10,群益金鼎-松山,2023-06-27,9103
00878,國泰永續高股息,10,0,10,群益金鼎-松山,2023-06-27,9103
6150,撼訊,9,0,9,群益金鼎-松山,2023-06-27,9103
3122,笙泉,8,0,8,群益金鼎-松山,2023-06-27,9103
6016,康和證,10,2,8,群益金鼎-松山,2023-06-27,9103
6125,廣運,9,1,8,群益金鼎-松山,2023-06-27,9103
3042,晶技,7,0,7,群益金鼎-松山,2023-06-27,9103
1736,喬山,7,0,7,群益金鼎-松山,2023-06-27,9103
2883,凱基金,7,0,7,群益金鼎-松山,2023-06-27,9103
3454,晶睿,37,30,7,群益金鼎-松山,2023-06-27,9103
6235,華孚,7,0,7,群益金鼎-松山,2023-06-27,9103
2607,榮運,6,0,6,群益金鼎-松山,2023-06-27,9103
3006,晶豪科,14,8,6,群益金鼎-松山,2023-06-27,9103
4743,合一,10,4,6,群益金鼎-松山,2023-06-27,9103
6015,宏遠證,6,0,6,群益金鼎-松山,2023-06-27,9103
1591,駿吉-KY,5,0,5,群益金鼎-松山,2023-06-27,9103
00637L,元大滬深300正2,5,0,5,群益金鼎-松山,2023-06-27,9103
2301,光寶科,5,0,5,群益金鼎-松山,2023-06-27,9103
2745,五福,5,0,5,群益金鼎-松山,2023-06-27,9103
3037,欣興,5,0,5,群益金鼎-松山,2023-06-27,9103
3048,益登,5,0,5,群益金鼎-松山,2023-06-27,9103
4102,永日,5,0,5,群益金鼎-松山,2023-06-27,9103
4123,晟德,7,2,5,群益金鼎-松山,2023-06-27,9103
4147,中裕,5,0,5,群益金鼎-松山,2023-06-27,9103
2610,華航,151,56,95,群益金鼎-松山,2023-06-28,9103
2603,長榮,69,1,68,群益金鼎-松山,2023-06-28,9103
1605,華新,59,11,48,群益金鼎-松山,2023-06-28,9103
4906,正文,43,1,42,群益金鼎-松山,2023-06-28,9103
3078,僑威,51,10,41,群益金鼎-松山,2023-06-28,9103
00706L,期元大S＆P日圓正2,31,0,31,群益金鼎-松山,2023-06-28,9103
00715L,期街口布蘭特正2,30,0,30,群益金鼎-松山,2023-06-28,9103
2371,大同,62,32,30,群益金鼎-松山,2023-06-28,9103
4533,協易機,30,2,28,群益金鼎-松山,2023-06-28,9103
8222,寶一,37,10,27,群益金鼎-松山,2023-06-28,9103
6125,廣運,28,2,26,群益金鼎-松山,2023-06-28,9103
3042,晶技,22,0,22,群益金鼎-松山,2023-06-28,9103
2206,三陽工業,22,1,21,群益金鼎-松山,2023-06-28,9103
6245,立端,22,2,20,群益金鼎-松山,2023-06-28,9103
3682,亞太電,20,0,20,群益金鼎-松山,2023-06-28,9103
1473,台南,14,0,14,群益金鼎-松山,2023-06-28,9103
00671R,富邦NASDAQ反1,10,0,10,群益金鼎-松山,2023-06-28,9103
1101,台泥,10,0,10,群益金鼎-松山,2023-06-28,9103
2382,廣達,14,4,10,群益金鼎-松山,2023-06-28,9103
2906,高林,10,0,10,群益金鼎-松山,2023-06-28,9103
6005,群益證,10,0,10,群益金鼎-松山,2023-06-28,9103
2722,夏都,9,1,8,群益金鼎-松山,2023-06-28,9103
4538,大詠城,8,0,8,群益金鼎-松山,2023-06-28,9103
6244,茂迪,8,0,8,群益金鼎-松山,2023-06-28,9103
1444,力麗,8,1,7,群益金鼎-松山,2023-06-28,9103
2303,聯電,7,0,7,群益金鼎-松山,2023-06-28,9103
2745,五福,12,5,7,群益金鼎-松山,2023-06-28,9103
3252,海灣,7,0,7,群益金鼎-松山,2023-06-28,9103
4916,事欣科,6,0,6,群益金鼎-松山,2023-06-28,9103
00878,國泰永續高股息,6,0,6,群益金鼎-松山,2023-06-28,9103
2301,光寶科,16,10,6,群益金鼎-松山,2023-06-28,9103
2606,裕民,6,0,6,群益金鼎-松山,2023-06-28,9103
1783,和康生,5,0,5,群益金鼎-松山,2023-06-28,9103
00720B,元大投資級公司債,5,0,5,群益金鼎-松山,2023-06-28,9103
00919,群益台灣精選高息,5,0,5,群益金鼎-松山,2023-06-28,9103
1313,聯成,7,2,5,群益金鼎-松山,2023-06-28,9103
2323,中環,23,18,5,群益金鼎-松山,2023-06-28,9103
2449,京元電子,5,0,5,群益金鼎-松山,2023-06-28,9103
2641,正德,5,0,5,群益金鼎-松山,2023-06-28,9103
2743,山富,5,0,5,群益金鼎-松山,2023-06-28,9103
3036,文曄,5,0,5,群益金鼎-松山,2023-06-28,9103
3711,日月光投控,5,0,5,群益金鼎-松山,2023-06-28,9103
6196,帆宣,5,0,5,群益金鼎-松山,2023-06-28,9103
6625,必應,5,0,5,群益金鼎-松山,2023-06-28,9103
8446,華研,5,0,5,群益金鼎-松山,2023-06-28,9103
2330,台積電,4,0,4,群益金鼎-松山,2023-06-28,9103
2609,陽明,4,0,4,群益金鼎-松山,2023-06-28,9103
2748,雲品,4,0,4,群益金鼎-松山,2023-06-28,9103
3037,欣興,6,2,4,群益金鼎-松山,2023-06-28,9103
3081,聯亞,16,12,4,群益金鼎-松山,2023-06-28,9103
00893,國泰智能電動車,214,100,114,群益金鼎-松山,2023-06-29,9103
00674R,期元大S＆P黃金反1,100,0,100,群益金鼎-松山,2023-06-29,9103
2419,仲琦,78,5,73,群益金鼎-松山,2023-06-29,9103
00706L,期元大S＆P日圓正2,40,0,40,群益金鼎-松山,2023-06-29,9103
00637L,元大滬深300正2,40,5,35,群益金鼎-松山,2023-06-29,9103
6281,全國電,30,0,30,群益金鼎-松山,2023-06-29,9103
00679B,元大美債20年,27,0,27,群益金鼎-松山,2023-06-29,9103
2344,華邦電,101,74,27,群益金鼎-松山,2023-06-29,9103
2603,長榮,32,6,26,群益金鼎-松山,2023-06-29,9103
2323,中環,26,2,24,群益金鼎-松山,2023-06-29,9103
3231,緯創,68,44,24,群益金鼎-松山,2023-06-29,9103
00922,國泰台灣領袖50,23,0,23,群益金鼎-松山,2023-06-29,9103
2615,萬海,21,0,21,群益金鼎-松山,2023-06-29,9103
3356,奇偶,28,7,21,群益金鼎-松山,2023-06-29,9103
8358,金居,21,0,21,群益金鼎-松山,2023-06-29,9103
2408,南亞科,30,10,20,群益金鼎-松山,2023-06-29,9103
3078,僑威,20,1,19,群益金鼎-松山,2023-06-29,9103
2618,長榮航,41,23,18,群益金鼎-松山,2023-06-29,9103
2317,鴻海,16,1,15,群益金鼎-松山,2023-06-29,9103
2353,宏��,14,0,14,群益金鼎-松山,2023-06-29,9103
2745,五福,13,0,13,群益金鼎-松山,2023-06-29,9103
2609,陽明,12,0,12,群益金鼎-松山,2023-06-29,9103
3354,律勝,12,0,12,群益金鼎-松山,2023-06-29,9103
4533,協易機,12,0,12,群益金鼎-松山,2023-06-29,9103
6456,GIS-KY,12,0,12,群益金鼎-松山,2023-06-29,9103
6125,廣運,12,1,11,群益金鼎-松山,2023-06-29,9103
8033,雷虎,10,0,10,群益金鼎-松山,2023-06-29,9103
1528,恩德,10,0,10,群益金鼎-松山,2023-06-29,9103
00633L,富邦上証正2,10,0,10,群益金鼎-松山,2023-06-29,9103
00640L,富邦日本正2,10,0,10,群益金鼎-松山,2023-06-29,9103
2906,高林,10,0,10,群益金鼎-松山,2023-06-29,9103
3005,神基,11,1,10,群益金鼎-松山,2023-06-29,9103
3128,昇銳,10,0,10,群益金鼎-松山,2023-06-29,9103
3479,安勤,11,1,10,群益金鼎-松山,2023-06-29,9103
4167,松瑞藥,10,0,10,群益金鼎-松山,2023-06-29,9103
8446,華研,17,7,10,群益金鼎-松山,2023-06-29,9103
6112,邁達特,10,1,9,群益金鼎-松山,2023-06-29,9103
6235,華孚,8,0,8,群益金鼎-松山,2023-06-29,9103
8050,廣積,11,3,8,群益金鼎-松山,2023-06-29,9103
4583,台灣精銳,7,0,7,群益金鼎-松山,2023-06-29,9103
4967,十銓,10,3,7,群益金鼎-松山,2023-06-29,9103
1605,華新,6,0,6,群益金鼎-松山,2023-06-29,9103
2330,台積電,6,0,6,群益金鼎-松山,2023-06-29,9103
6213,聯茂,6,0,6,群益金鼎-松山,2023-06-29,9103
3711,日月光投控,6,0,6,群益金鼎-松山,2023-06-29,9103
6101,寬魚國際,10,4,6,群益金鼎-松山,2023-06-29,9103
00751B,元大AAA至A公司債,5,0,5,群益金鼎-松山,2023-06-29,9103
00712,復華富時不動產,5,0,5,群益金鼎-松山,2023-06-29,9103
00900,富邦特選高股息30,5,0,5,群益金鼎-松山,2023-06-29,9103
2883,凱基金,5,0,5,群益金鼎-松山,2023-06-29,9103
00830,國泰費城半導體,100,0,100,群益金鼎-松山,2023-06-30,9103
00680L,元大美債20正2,60,0,60,群益金鼎-松山,2023-06-30,9103
00640L,富邦日本正2,50,0,50,群益金鼎-松山,2023-06-30,9103
3202,樺晟,50,0,50,群益金鼎-松山,2023-06-30,9103
00893,國泰智能電動車,150,105,45,群益金鼎-松山,2023-06-30,9103
2603,長榮,90,52,38,群益金鼎-松山,2023-06-30,9103
5465,富驊,37,0,37,群益金鼎-松山,2023-06-30,9103
2610,華航,33,1,32,群益金鼎-松山,2023-06-30,9103
00670L,富邦NASDAQ正2,30,0,30,群益金鼎-松山,2023-06-30,9103
2618,長榮航,36,6,30,群益金鼎-松山,2023-06-30,9103
6281,全國電,30,0,30,群益金鼎-松山,2023-06-30,9103
00706L,期元大S＆P日圓正2,26,0,26,群益金鼎-松山,2023-06-30,9103
3483,力致,23,1,22,群益金鼎-松山,2023-06-30,9103
2368,金像電,19,3,16,群益金鼎-松山,2023-06-30,9103
8936,國統,20,4,16,群益金鼎-松山,2023-06-30,9103
3128,昇銳,15,0,15,群益金鼎-松山,2023-06-30,9103
3105,穩懋,14,0,14,群益金鼎-松山,2023-06-30,9103
2887,台新金,12,0,12,群益金鼎-松山,2023-06-30,9103
3011,今皓,13,1,12,群益金鼎-松山,2023-06-30,9103
8033,雷虎,12,0,12,群益金鼎-松山,2023-06-30,9103
00637L,元大滬深300正2,46,35,11,群益金鼎-松山,2023-06-30,9103
00720B,元大投資級公司債,11,0,11,群益金鼎-松山,2023-06-30,9103
2201,裕隆,11,0,11,群益金鼎-松山,2023-06-30,9103
2883,凱基金,11,0,11,群益金鼎-松山,2023-06-30,9103
1440,南紡,11,0,11,群益金鼎-松山,2023-06-30,9103
2344,華邦電,10,0,10,群益金鼎-松山,2023-06-30,9103
2609,陽明,31,21,10,群益金鼎-松山,2023-06-30,9103
8409,商之器,10,0,10,群益金鼎-松山,2023-06-30,9103
1605,華新,10,1,9,群益金鼎-松山,2023-06-30,9103
1905,華紙,7,0,7,群益金鼎-松山,2023-06-30,9103
4175,杏一,14,7,7,群益金鼎-松山,2023-06-30,9103
00878,國泰永續高股息,6,0,6,群益金鼎-松山,2023-06-30,9103
3017,奇鋐,12,6,6,群益金鼎-松山,2023-06-30,9103
3441,聯一光,6,0,6,群益金鼎-松山,2023-06-30,9103
8050,廣積,30,24,6,群益金鼎-松山,2023-06-30,9103
1504,東元,7,2,5,群益金鼎-松山,2023-06-30,9103
00715L,期街口布蘭特正2,5,0,5,群益金鼎-松山,2023-06-30,9103
00696B,富邦美債20年,5,0,5,群益金鼎-松山,2023-06-30,9103
2637,慧洋-KY,5,0,5,群益金鼎-松山,2023-06-30,9103
4147,中裕,10,5,5,群益金鼎-松山,2023-06-30,9103
4967,十銓,6,1,5,群益金鼎-松山,2023-06-30,9103
6593,台灣銘板,5,0,5,群益金鼎-松山,2023-06-30,9103
6625,必應,5,0,5,群益金鼎-松山,2023-06-30,9103
8429,金麗-KY,5,0,5,群益金鼎-松山,2023-06-30,9103
5864,致和證,4,0,4,群益金鼎-松山,2023-06-30,9103
8222,寶一,4,0,4,群益金鼎-松山,2023-06-30,9103
3013,晟銘電,4,0,4,群益金鼎-松山,2023-06-30,9103
2454,聯發科,3,0,3,群益金鼎-松山,2023-06-30,9103
3034,聯詠,3,0,3,群益金鼎-松山,2023-06-30,9103
1760,寶齡富錦,3,0,3,群益金鼎-松山,2023-06-30,9103
1611,中電,499,5,494,群益金鼎-松山,2023-07-03,9103
1727,中華化,246,1,245,群益金鼎-松山,2023-07-03,9103
3481,群創,200,0,200,群益金鼎-松山,2023-07-03,9103
1528,恩德,74,22,52,群益金鼎-松山,2023-07-03,9103
3652,精聯,31,0,31,群益金鼎-松山,2023-07-03,9103
2301,光寶科,31,1,30,群益金鼎-松山,2023-07-03,9103
2419,仲琦,41,12,29,群益金鼎-松山,2023-07-03,9103
2340,台亞,29,3,26,群益金鼎-松山,2023-07-03,9103
00671R,富邦NASDAQ反1,20,0,20,群益金鼎-松山,2023-07-03,9103
00632R,元大台灣50反1,20,0,20,群益金鼎-松山,2023-07-03,9103
3046,建��,19,2,17,群益金鼎-松山,2023-07-03,9103
2468,華經,15,0,15,群益金鼎-松山,2023-07-03,9103
2364,倫飛,14,0,14,群益金鼎-松山,2023-07-03,9103
6243,迅杰,14,0,14,群益金鼎-松山,2023-07-03,9103
1524,耿鼎,13,0,13,群益金鼎-松山,2023-07-03,9103
3356,奇偶,24,11,13,群益金鼎-松山,2023-07-03,9103
6126,信音,12,0,12,群益金鼎-松山,2023-07-03,9103
8048,德勝,12,1,11,群益金鼎-松山,2023-07-03,9103
2368,金像電,22,11,11,群益金鼎-松山,2023-07-03,9103
2392,正崴,10,0,10,群益金鼎-松山,2023-07-03,9103
2482,連宇,13,3,10,群益金鼎-松山,2023-07-03,9103
3078,僑威,16,6,10,群益金鼎-松山,2023-07-03,9103
4532,瑞智,10,0,10,群益金鼎-松山,2023-07-03,9103
5469,瀚宇博,10,0,10,群益金鼎-松山,2023-07-03,9103
6101,寬魚國際,10,0,10,群益金鼎-松山,2023-07-03,9103
6589,台康生技,10,0,10,群益金鼎-松山,2023-07-03,9103
1440,南紡,10,0,10,群益金鼎-松山,2023-07-03,9103
2337,旺宏,9,0,9,群益金鼎-松山,2023-07-03,9103
2365,昆盈,10,1,9,群益金鼎-松山,2023-07-03,9103
3006,晶豪科,10,1,9,群益金鼎-松山,2023-07-03,9103
4162,智擎,9,0,9,群益金鼎-松山,2023-07-03,9103
5706,鳳凰,11,2,9,群益金鼎-松山,2023-07-03,9103
2230,泰茂,8,0,8,群益金鼎-松山,2023-07-03,9103
2719,燦星旅,8,0,8,群益金鼎-松山,2023-07-03,9103
2884,玉山金,8,0,8,群益金鼎-松山,2023-07-03,9103
4306,炎洲,7,0,7,群益金鼎-松山,2023-07-03,9103
2609,陽明,48,41,7,群益金鼎-松山,2023-07-03,9103
2206,三陽工業,11,5,6,群益金鼎-松山,2023-07-03,9103
2201,裕隆,6,0,6,群益金鼎-松山,2023-07-03,9103
3711,日月光投控,7,1,6,群益金鼎-松山,2023-07-03,9103
3081,聯亞,6,0,6,群益金鼎-松山,2023-07-03,9103
3294,英濟,6,0,6,群益金鼎-松山,2023-07-03,9103
4123,晟德,6,0,6,群益金鼎-松山,2023-07-03,9103
4138,曜亞,5,0,5,群益金鼎-松山,2023-07-03,9103
6235,華孚,10,5,5,群益金鼎-松山,2023-07-03,9103
00903,富邦元宇宙,5,0,5,群益金鼎-松山,2023-07-03,9103
2015,豐興,5,0,5,群益金鼎-松山,2023-07-03,9103
2250,IKKA-KY,5,0,5,群益金鼎-松山,2023-07-03,9103
2303,聯電,7,2,5,群益金鼎-松山,2023-07-03,9103
2601,益航,5,0,5,群益金鼎-松山,2023-07-03,9103
3045,台灣大,503,0,503,群益金鼎-松山,2023-07-04,9103
1513,中興電,204,107,97,群益金鼎-松山,2023-07-04,9103
5465,富驊,74,0,74,群益金鼎-松山,2023-07-04,9103
6282,康舒,132,60,72,群益金鼎-松山,2023-07-04,9103
1522,堤維西,62,0,62,群益金鼎-松山,2023-07-04,9103
0056,元大高股息,70,14,56,群益金鼎-松山,2023-07-04,9103
2356,英業達,133,82,51,群益金鼎-松山,2023-07-04,9103
1314,中石化,50,0,50,群益金鼎-松山,2023-07-04,9103
3055,蔚華科,29,0,29,群益金鼎-松山,2023-07-04,9103
2610,華航,22,0,22,群益金鼎-松山,2023-07-04,9103
3706,神達,46,25,21,群益金鼎-松山,2023-07-04,9103
00632R,元大台灣50反1,20,0,20,群益金鼎-松山,2023-07-04,9103
2449,京元電子,23,5,18,群益金鼎-松山,2023-07-04,9103
2206,三陽工業,24,7,17,群益金鼎-松山,2023-07-04,9103
3374,精材,20,3,17,群益金鼎-松山,2023-07-04,9103
2376,技嘉,37,20,17,群益金鼎-松山,2023-07-04,9103
3032,偉訓,30,15,15,群益金鼎-松山,2023-07-04,9103
2371,大同,18,3,15,群益金鼎-松山,2023-07-04,9103
3704,合勤控,23,10,13,群益金鼎-松山,2023-07-04,9103
8446,華研,12,0,12,群益金鼎-松山,2023-07-04,9103
2888,新光金,12,0,12,群益金鼎-松山,2023-07-04,9103
5425,台半,13,2,11,群益金鼎-松山,2023-07-04,9103
2352,佳世達,10,0,10,群益金鼎-松山,2023-07-04,9103
2485,兆赫,10,0,10,群益金鼎-松山,2023-07-04,9103
2637,慧洋-KY,10,0,10,群益金鼎-松山,2023-07-04,9103
2915,潤泰全,10,0,10,群益金鼎-松山,2023-07-04,9103
8201,無敵,10,0,10,群益金鼎-松山,2023-07-04,9103
5706,鳳凰,11,2,9,群益金鼎-松山,2023-07-04,9103
4746,台耀,8,0,8,群益金鼎-松山,2023-07-04,9103
5351,鈺創,7,0,7,群益金鼎-松山,2023-07-04,9103
6589,台康生技,7,0,7,群益金鼎-松山,2023-07-04,9103
2851,中再保,6,0,6,群益金鼎-松山,2023-07-04,9103
3011,今皓,6,0,6,群益金鼎-松山,2023-07-04,9103
4906,正文,8,2,6,群益金鼎-松山,2023-07-04,9103
4979,華星光,14,8,6,群益金鼎-松山,2023-07-04,9103
6625,必應,14,8,6,群益金鼎-松山,2023-07-04,9103
2421,建準,8,3,5,群益金鼎-松山,2023-07-04,9103
2905,三商,5,0,5,群益金鼎-松山,2023-07-04,9103
3346,麗清,5,0,5,群益金鼎-松山,2023-07-04,9103
3362,先進光,5,0,5,群益金鼎-松山,2023-07-04,9103
3564,其陽,5,0,5,群益金鼎-松山,2023-07-04,9103
4958,臻鼎-KY,5,0,5,群益金鼎-松山,2023-07-04,9103
2419,仲琦,20,15,5,群益金鼎-松山,2023-07-04,9103
1609,大亞,7,3,4,群益金鼎-松山,2023-07-04,9103
3038,全台,4,0,4,群益金鼎-松山,2023-07-04,9103
6163,華電網,4,0,4,群益金鼎-松山,2023-07-04,9103
6593,台灣銘板,4,0,4,群益金鼎-松山,2023-07-04,9103
6596,寬宏藝術,4,0,4,群益金鼎-松山,2023-07-04,9103
8033,雷虎,6,2,4,群益金鼎-松山,2023-07-04,9103
9945,潤泰新,4,0,4,群益金鼎-松山,2023-07-04,9103
3481,群創,201,0,201,群益金鼎-松山,2023-07-05,9103
5009,榮剛,145,4,141,群益金鼎-松山,2023-07-05,9103
00929,復華台灣科技優息,56,0,56,群益金鼎-松山,2023-07-05,9103
6282,康舒,81,43,38,群益金鼎-松山,2023-07-05,9103
8234,新漢,30,0,30,群益金鼎-松山,2023-07-05,9103
2610,華航,26,4,22,群益金鼎-松山,2023-07-05,9103
3025,星通,24,2,22,群益金鼎-松山,2023-07-05,9103
3017,奇鋐,26,5,21,群益金鼎-松山,2023-07-05,9103
2603,長榮,25,4,21,群益金鼎-松山,2023-07-05,9103
3682,亞太電,20,0,20,群益金鼎-松山,2023-07-05,9103
6116,彩晶,20,0,20,群益金鼎-松山,2023-07-05,9103
3032,偉訓,17,0,17,群益金鼎-松山,2023-07-05,9103
3265,台星科,20,4,16,群益金鼎-松山,2023-07-05,9103
8099,大世科,15,0,15,群益金鼎-松山,2023-07-05,9103
6139,亞翔,14,0,14,群益金鼎-松山,2023-07-05,9103
4155,訊映,14,0,14,群益金鼎-松山,2023-07-05,9103
2399,映泰,14,1,13,群益金鼎-松山,2023-07-05,9103
2889,國票金,13,0,13,群益金鼎-松山,2023-07-05,9103
2301,光寶科,12,0,12,群益金鼎-松山,2023-07-05,9103
3591,艾笛森,13,1,12,群益金鼎-松山,2023-07-05,9103
5243,乙盛-KY,15,4,11,群益金鼎-松山,2023-07-05,9103
5706,鳳凰,13,2,11,群益金鼎-松山,2023-07-05,9103
8409,商之器,11,0,11,群益金鼎-松山,2023-07-05,9103
2382,廣達,14,4,10,群益金鼎-松山,2023-07-05,9103
3105,穩懋,10,0,10,群益金鼎-松山,2023-07-05,9103
3363,上詮,15,5,10,群益金鼎-松山,2023-07-05,9103
3372,典範,10,0,10,群益金鼎-松山,2023-07-05,9103
5351,鈺創,10,0,10,群益金鼎-松山,2023-07-05,9103
6150,撼訊,10,0,10,群益金鼎-松山,2023-07-05,9103
2356,英業達,10,1,9,群益金鼎-松山,2023-07-05,9103
2340,台亞,9,0,9,群益金鼎-松山,2023-07-05,9103
3346,麗清,10,1,9,群益金鼎-松山,2023-07-05,9103
1528,恩德,25,17,8,群益金鼎-松山,2023-07-05,9103
00919,群益台灣精選高息,8,0,8,群益金鼎-松山,2023-07-05,9103
1609,大亞,22,15,7,群益金鼎-松山,2023-07-05,9103
8277,商丞,7,0,7,群益金鼎-松山,2023-07-05,9103
4207,環泰,7,0,7,群益金鼎-松山,2023-07-05,9103
2106,建大,6,0,6,群益金鼎-松山,2023-07-05,9103
1303,南亞,11,5,6,群益金鼎-松山,2023-07-05,9103
2421,建準,7,1,6,群益金鼎-松山,2023-07-05,9103
1101,台泥,5,0,5,群益金鼎-松山,2023-07-05,9103
1513,中興電,15,10,5,群益金鼎-松山,2023-07-05,9103
2455,全新,11,6,5,群益金鼎-松山,2023-07-05,9103
2755,揚秦,5,0,5,群益金鼎-松山,2023-07-05,9103
3056,富華新,5,0,5,群益金鼎-松山,2023-07-05,9103
3163,波若威,7,2,5,群益金鼎-松山,2023-07-05,9103
3324,雙鴻,5,0,5,群益金鼎-松山,2023-07-05,9103
3430,奇鈦科,5,0,5,群益金鼎-松山,2023-07-05,9103
6168,宏齊,5,0,5,群益金鼎-松山,2023-07-05,9103
6176,瑞儀,5,0,5,群益金鼎-松山,2023-07-05,9103
2409,友達,201,1,200,群益金鼎-松山,2023-07-06,9103
6245,立端,73,0,73,群益金鼎-松山,2023-07-06,9103
00680L,元大美債20正2,67,0,67,群益金鼎-松山,2023-07-06,9103
5706,鳳凰,40,0,40,群益金鼎-松山,2023-07-06,9103
1591,駿吉-KY,30,0,30,群益金鼎-松山,2023-07-06,9103
2637,慧洋-KY,30,0,30,群益金鼎-松山,2023-07-06,9103
2317,鴻海,34,4,30,群益金鼎-松山,2023-07-06,9103
2609,陽明,39,11,28,群益金鼎-松山,2023-07-06,9103
2883,凱基金,27,0,27,群益金鼎-松山,2023-07-06,9103
2801,彰銀,22,0,22,群益金鼎-松山,2023-07-06,9103
00637L,元大滬深300正2,20,0,20,群益金鼎-松山,2023-07-06,9103
00725B,國泰投資級公司債,20,0,20,群益金鼎-松山,2023-07-06,9103
5876,上海商銀,20,0,20,群益金鼎-松山,2023-07-06,9103
8271,宇瞻,20,0,20,群益金鼎-松山,2023-07-06,9103
2399,映泰,30,12,18,群益金鼎-松山,2023-07-06,9103
2419,仲琦,20,2,18,群益金鼎-松山,2023-07-06,9103
2329,華泰,18,1,17,群益金鼎-松山,2023-07-06,9103
2486,一詮,23,7,16,群益金鼎-松山,2023-07-06,9103
6139,亞翔,21,5,16,群益金鼎-松山,2023-07-06,9103
00927,群益半導體收益,16,2,14,群益金鼎-松山,2023-07-06,9103
1611,中電,14,0,14,群益金鼎-松山,2023-07-06,9103
2618,長榮航,64,50,14,群益金鼎-松山,2023-07-06,9103
3715,定穎投控,15,2,13,群益金鼎-松山,2023-07-06,9103
2887,台新金,12,0,12,群益金鼎-松山,2023-07-06,9103
2748,雲品,13,1,12,群益金鼎-松山,2023-07-06,9103
2330,台積電,12,0,12,群益金鼎-松山,2023-07-06,9103
2301,光寶科,55,44,11,群益金鼎-松山,2023-07-06,9103
1101,台泥,11,0,11,群益金鼎-松山,2023-07-06,9103
9945,潤泰新,11,0,11,群益金鼎-松山,2023-07-06,9103
00882,中信中國高股息,11,0,11,群益金鼎-松山,2023-07-06,9103
00696B,富邦美債20年,10,0,10,群益金鼎-松山,2023-07-06,9103
2731,雄獅,10,0,10,群益金鼎-松山,2023-07-06,9103
4414,如興,10,0,10,群益金鼎-松山,2023-07-06,9103
6147,頎邦,10,0,10,群益金鼎-松山,2023-07-06,9103
2382,廣達,22,13,9,群益金鼎-松山,2023-07-06,9103
2851,中再保,8,0,8,群益金鼎-松山,2023-07-06,9103
2888,新光金,8,0,8,群益金鼎-松山,2023-07-06,9103
2889,國票金,8,0,8,群益金鼎-松山,2023-07-06,9103
2880,華南金,7,0,7,群益金鼎-松山,2023-07-06,9103
4566,時碩工業,7,0,7,群益金鼎-松山,2023-07-06,9103
0050,元大台灣50,6,0,6,群益金鼎-松山,2023-07-06,9103
2892,第一金,6,0,6,群益金鼎-松山,2023-07-06,9103
3128,昇銳,7,1,6,群益金鼎-松山,2023-07-06,9103
6276,安鈦克,9,3,6,群益金鼎-松山,2023-07-06,9103
3231,緯創,89,83,6,群益金鼎-松山,2023-07-06,9103
2603,長榮,7,2,5,群益金鼎-松山,2023-07-06,9103
3037,欣興,6,1,5,群益金鼎-松山,2023-07-06,9103
00929,復華台灣科技優息,5,0,5,群益金鼎-松山,2023-07-06,9103
1736,喬山,15,10,5,群益金鼎-松山,2023-07-06,9103
2449,京元電子,5,0,5,群益金鼎-松山,2023-07-06,9103
1101,台泥,102,0,102,群益金鼎-松山,2023-07-07,9103
3047,訊舟,100,0,100,群益金鼎-松山,2023-07-07,9103
1560,中砂,79,0,79,群益金鼎-松山,2023-07-07,9103
8201,無敵,60,0,60,群益金鼎-松山,2023-07-07,9103
1471,首利,41,0,41,群益金鼎-松山,2023-07-07,9103
6122,擎邦,33,0,33,群益金鼎-松山,2023-07-07,9103
2888,新光金,34,2,32,群益金鼎-松山,2023-07-07,9103
00680L,元大美債20正2,31,0,31,群益金鼎-松山,2023-07-07,9103
3481,群創,30,2,28,群益金鼎-松山,2023-07-07,9103
6282,康舒,56,30,26,群益金鼎-松山,2023-07-07,9103
2344,華邦電,22,0,22,群益金鼎-松山,2023-07-07,9103
4155,訊映,21,0,21,群益金鼎-松山,2023-07-07,9103
4510,高鋒,25,4,21,群益金鼎-松山,2023-07-07,9103
1717,長興,20,0,20,群益金鼎-松山,2023-07-07,9103
3305,昇貿,19,0,19,群益金鼎-松山,2023-07-07,9103
2323,中環,20,3,17,群益金鼎-松山,2023-07-07,9103
4566,時碩工業,16,0,16,群益金鼎-松山,2023-07-07,9103
5706,鳳凰,16,0,16,群益金鼎-松山,2023-07-07,9103
4551,智伸科,15,0,15,群益金鼎-松山,2023-07-07,9103
00878,國泰永續高股息,14,0,14,群益金鼎-松山,2023-07-07,9103
2883,凱基金,16,2,14,群益金鼎-松山,2023-07-07,9103
2745,五福,12,0,12,群益金鼎-松山,2023-07-07,9103
00722B,群益投資級電信債,11,0,11,群益金鼎-松山,2023-07-07,9103
2462,良得電,11,0,11,群益金鼎-松山,2023-07-07,9103
2495,普安,11,0,11,群益金鼎-松山,2023-07-07,9103
4414,如興,11,0,11,群益金鼎-松山,2023-07-07,9103
6485,點序,11,0,11,群益金鼎-松山,2023-07-07,9103
1519,華城,20,10,10,群益金鼎-松山,2023-07-07,9103
00637L,元大滬深300正2,10,0,10,群益金鼎-松山,2023-07-07,9103
2009,第一銅,10,0,10,群益金鼎-松山,2023-07-07,9103
2485,兆赫,10,0,10,群益金鼎-松山,2023-07-07,9103
2489,瑞軒,10,0,10,群益金鼎-松山,2023-07-07,9103
2882,國泰金,10,0,10,群益金鼎-松山,2023-07-07,9103
6426,統新,10,0,10,群益金鼎-松山,2023-07-07,9103
3011,今皓,9,0,9,群益金鼎-松山,2023-07-07,9103
6169,昱泉,9,0,9,群益金鼎-松山,2023-07-07,9103
6176,瑞儀,9,0,9,群益金鼎-松山,2023-07-07,9103
2382,廣達,20,12,8,群益金鼎-松山,2023-07-07,9103
8076,伍豐,10,2,8,群益金鼎-松山,2023-07-07,9103
2383,台光電,10,2,8,群益金鼎-松山,2023-07-07,9103
2743,山富,7,0,7,群益金鼎-松山,2023-07-07,9103
00687B,國泰20年美債,6,0,6,群益金鼎-松山,2023-07-07,9103
2453,凌群,6,0,6,群益金鼎-松山,2023-07-07,9103
3093,港建*,6,0,6,群益金鼎-松山,2023-07-07,9103
6147,頎邦,7,1,6,群益金鼎-松山,2023-07-07,9103
6456,GIS-KY,6,0,6,群益金鼎-松山,2023-07-07,9103
6548,長科*,6,0,6,群益金鼎-松山,2023-07-07,9103
8409,商之器,6,0,6,群益金鼎-松山,2023-07-07,9103
3701,大眾控,11,5,6,群益金鼎-松山,2023-07-07,9103
2880,華南金,5,0,5,群益金鼎-松山,2023-07-07,9103
1314,中石化,85,0,85,群益金鼎-松山,2023-07-10,9103
3346,麗清,36,0,36,群益金鼎-松山,2023-07-10,9103
2317,鴻海,21,0,21,群益金鼎-松山,2023-07-10,9103
5706,鳳凰,23,2,21,群益金鼎-松山,2023-07-10,9103
6426,統新,22,1,21,群益金鼎-松山,2023-07-10,9103
1319,東陽,20,0,20,群益金鼎-松山,2023-07-10,9103
1514,亞力,21,4,17,群益金鼎-松山,2023-07-10,9103
8084,巨虹,18,1,17,群益金鼎-松山,2023-07-10,9103
1736,喬山,16,0,16,群益金鼎-松山,2023-07-10,9103
1513,中興電,30,18,12,群益金鼎-松山,2023-07-10,9103
3707,漢磊,66,54,12,群益金鼎-松山,2023-07-10,9103
6122,擎邦,12,0,12,群益金鼎-松山,2023-07-10,9103
6285,啟��,11,0,11,群益金鼎-松山,2023-07-10,9103
00696B,富邦美債20年,10,0,10,群益金鼎-松山,2023-07-10,9103
2356,英業達,13,3,10,群益金鼎-松山,2023-07-10,9103
3047,訊舟,10,0,10,群益金鼎-松山,2023-07-10,9103
6117,迎廣,10,0,10,群益金鼎-松山,2023-07-10,9103
1503,士電,31,22,9,群益金鼎-松山,2023-07-10,9103
3013,晟銘電,9,0,9,群益金鼎-松山,2023-07-10,9103
3032,偉訓,9,0,9,群益金鼎-松山,2023-07-10,9103
3305,昇貿,9,0,9,群益金鼎-松山,2023-07-10,9103
3558,神準,10,2,8,群益金鼎-松山,2023-07-10,9103
00687B,國泰20年美債,8,0,8,群益金鼎-松山,2023-07-10,9103
2380,虹光,8,0,8,群益金鼎-松山,2023-07-10,9103
3479,安勤,8,0,8,群益金鼎-松山,2023-07-10,9103
6015,宏遠證,7,0,7,群益金鼎-松山,2023-07-10,9103
8358,金居,7,0,7,群益金鼎-松山,2023-07-10,9103
00679B,元大美債20年,6,0,6,群益金鼎-松山,2023-07-10,9103
1760,寶齡富錦,6,0,6,群益金鼎-松山,2023-07-10,9103
3005,神基,6,0,6,群益金鼎-松山,2023-07-10,9103
3324,雙鴻,7,1,6,群益金鼎-松山,2023-07-10,9103
3454,晶睿,8,2,6,群益金鼎-松山,2023-07-10,9103
4527,方土霖,6,0,6,群益金鼎-松山,2023-07-10,9103
8255,朋程,9,3,6,群益金鼎-松山,2023-07-10,9103
2342,茂矽,6,0,6,群益金鼎-松山,2023-07-10,9103
3017,奇鋐,5,0,5,群益金鼎-松山,2023-07-10,9103
3071,協禧,7,2,5,群益金鼎-松山,2023-07-10,9103
1609,大亞,14,9,5,群益金鼎-松山,2023-07-10,9103
00720B,元大投資級公司債,5,0,5,群益金鼎-松山,2023-07-10,9103
2201,裕隆,5,0,5,群益金鼎-松山,2023-07-10,9103
3430,奇鈦科,5,0,5,群益金鼎-松山,2023-07-10,9103
6266,泰詠,5,0,5,群益金鼎-松山,2023-07-10,9103
6703,軒郁,5,0,5,群益金鼎-松山,2023-07-10,9103
8097,常珵,5,0,5,群益金鼎-松山,2023-07-10,9103
6456,GIS-KY,4,0,4,群益金鼎-松山,2023-07-10,9103
0056,元大高股息,4,0,4,群益金鼎-松山,2023-07-10,9103
1101,台泥,4,0,4,群益金鼎-松山,2023-07-10,9103
2547,日勝生,4,0,4,群益金鼎-松山,2023-07-10,9103
8050,廣積,8,4,4,群益金鼎-松山,2023-07-10,9103
3693,營邦,5,1,4,群益金鼎-松山,2023-07-10,9103
00893,國泰智能電動車,200,0,200,群益金鼎-松山,2023-07-11,9103
2610,華航,408,234,174,群益金鼎-松山,2023-07-11,9103
1471,首利,100,0,100,群益金鼎-松山,2023-07-11,9103
1591,駿吉-KY,40,0,40,群益金鼎-松山,2023-07-11,9103
8201,無敵,34,0,34,群益金鼎-松山,2023-07-11,9103
00670L,富邦NASDAQ正2,30,0,30,群益金鼎-松山,2023-07-11,9103
6550,北極星藥業-KY,30,0,30,群益金鼎-松山,2023-07-11,9103
00652,富邦印度,26,0,26,群益金鼎-松山,2023-07-11,9103
00632R,元大台灣50反1,25,0,25,群益金鼎-松山,2023-07-11,9103
00715L,期街口布蘭特正2,22,0,22,群益金鼎-松山,2023-07-11,9103
5465,富驊,32,10,22,群益金鼎-松山,2023-07-11,9103
1529,樂事綠能,22,2,20,群益金鼎-松山,2023-07-11,9103
4164,承業醫,20,0,20,群益金鼎-松山,2023-07-11,9103
3025,星通,18,4,14,群益金鼎-松山,2023-07-11,9103
5230,雷笛克光學,13,0,13,群益金鼎-松山,2023-07-11,9103
6288,聯嘉,13,0,13,群益金鼎-松山,2023-07-11,9103
1618,合機,13,1,12,群益金鼎-松山,2023-07-11,9103
2745,五福,20,8,12,群益金鼎-松山,2023-07-11,9103
4123,晟德,12,0,12,群益金鼎-松山,2023-07-11,9103
6456,GIS-KY,12,0,12,群益金鼎-松山,2023-07-11,9103
3231,緯創,38,28,10,群益金鼎-松山,2023-07-11,9103
2603,長榮,12,2,10,群益金鼎-松山,2023-07-11,9103
00671R,富邦NASDAQ反1,10,0,10,群益金鼎-松山,2023-07-11,9103
1783,和康生,10,0,10,群益金鼎-松山,2023-07-11,9103
1604,聲寶,10,0,10,群益金鼎-松山,2023-07-11,9103
1810,和成,10,0,10,群益金鼎-松山,2023-07-11,9103
2382,廣達,24,14,10,群益金鼎-松山,2023-07-11,9103
2889,國票金,10,0,10,群益金鼎-松山,2023-07-11,9103
3701,大眾控,15,5,10,群益金鼎-松山,2023-07-11,9103
4532,瑞智,10,0,10,群益金鼎-松山,2023-07-11,9103
5512,力麒,10,0,10,群益金鼎-松山,2023-07-11,9103
6426,統新,10,0,10,群益金鼎-松山,2023-07-11,9103
8996,高力,10,0,10,群益金鼎-松山,2023-07-11,9103
2317,鴻海,10,1,9,群益金鼎-松山,2023-07-11,9103
3013,晟銘電,20,11,9,群益金鼎-松山,2023-07-11,9103
8927,北基,9,0,9,群益金鼎-松山,2023-07-11,9103
3078,僑威,10,2,8,群益金鼎-松山,2023-07-11,9103
3346,麗清,10,2,8,群益金鼎-松山,2023-07-11,9103
4162,智擎,8,0,8,群益金鼎-松山,2023-07-11,9103
5284,jpp-KY,8,0,8,群益金鼎-松山,2023-07-11,9103
2312,金寶,7,0,7,群益金鼎-松山,2023-07-11,9103
2359,所羅門,7,0,7,群益金鼎-松山,2023-07-11,9103
6235,華孚,18,11,7,群益金鼎-松山,2023-07-11,9103
2023,燁輝,6,0,6,群益金鼎-松山,2023-07-11,9103
2201,裕隆,6,0,6,群益金鼎-松山,2023-07-11,9103
2408,南亞科,6,0,6,群益金鼎-松山,2023-07-11,9103
8069,元太,5,0,5,群益金鼎-松山,2023-07-11,9103
3035,智原,8,3,5,群益金鼎-松山,2023-07-11,9103
2308,台達電,5,0,5,群益金鼎-松山,2023-07-11,9103
2340,台亞,6,1,5,群益金鼎-松山,2023-07-11,9103
3481,群創,200,127,73,群益金鼎-松山,2023-07-12,9103
2399,映泰,66,4,62,群益金鼎-松山,2023-07-12,9103
3088,艾訊,60,0,60,群益金鼎-松山,2023-07-12,9103
2609,陽明,51,0,51,群益金鼎-松山,2023-07-12,9103
2020,美亞,50,0,50,群益金鼎-松山,2023-07-12,9103
4533,協易機,50,0,50,群益金鼎-松山,2023-07-12,9103
2486,一詮,49,9,40,群益金鼎-松山,2023-07-12,9103
3706,神達,57,19,38,群益金鼎-松山,2023-07-12,9103
6188,廣明,83,45,38,群益金鼎-松山,2023-07-12,9103
1604,聲寶,31,0,31,群益金鼎-松山,2023-07-12,9103
6118,建達,31,1,30,群益金鼎-松山,2023-07-12,9103
2340,台亞,33,9,24,群益金鼎-松山,2023-07-12,9103
5371,中光電,31,10,21,群益金鼎-松山,2023-07-12,9103
00652,富邦印度,18,0,18,群益金鼎-松山,2023-07-12,9103
4162,智擎,16,1,15,群益金鼎-松山,2023-07-12,9103
2376,技嘉,22,9,13,群益金鼎-松山,2023-07-12,9103
2303,聯電,13,0,13,群益金鼎-松山,2023-07-12,9103
2204,中華,12,0,12,群益金鼎-松山,2023-07-12,9103
1513,中興電,258,246,12,群益金鼎-松山,2023-07-12,9103
6285,啟��,21,9,12,群益金鼎-松山,2023-07-12,9103
2323,中環,16,5,11,群益金鼎-松山,2023-07-12,9103
6168,宏齊,11,0,11,群益金鼎-松山,2023-07-12,9103
6548,長科*,11,0,11,群益金鼎-松山,2023-07-12,9103
1519,華城,47,36,11,群益金鼎-松山,2023-07-12,9103
1591,駿吉-KY,10,0,10,群益金鼎-松山,2023-07-12,9103
1503,士電,32,22,10,群益金鼎-松山,2023-07-12,9103
2402,毅嘉,10,0,10,群益金鼎-松山,2023-07-12,9103
3363,上詮,14,4,10,群益金鼎-松山,2023-07-12,9103
3540,曜越,25,15,10,群益金鼎-松山,2023-07-12,9103
8084,巨虹,10,0,10,群益金鼎-松山,2023-07-12,9103
8409,商之器,10,0,10,群益金鼎-松山,2023-07-12,9103
2383,台光電,9,0,9,群益金鼎-松山,2023-07-12,9103
4155,訊映,10,1,9,群益金鼎-松山,2023-07-12,9103
00752,中信中國50,8,0,8,群益金鼎-松山,2023-07-12,9103
3019,亞光,9,1,8,群益金鼎-松山,2023-07-12,9103
6112,邁達特,8,0,8,群益金鼎-松山,2023-07-12,9103
6223,旺矽,8,0,8,群益金鼎-松山,2023-07-12,9103
3624,光頡,7,0,7,群益金鼎-松山,2023-07-12,9103
6419,京晨科,7,0,7,群益金鼎-松山,2023-07-12,9103
3704,合勤控,7,0,7,群益金鼎-松山,2023-07-12,9103
8046,南電,7,1,6,群益金鼎-松山,2023-07-12,9103
2353,宏��,6,0,6,群益金鼎-松山,2023-07-12,9103
2356,英業達,202,196,6,群益金鼎-松山,2023-07-12,9103
2421,建準,6,0,6,群益金鼎-松山,2023-07-12,9103
2498,宏達電,48,42,6,群益金鼎-松山,2023-07-12,9103
00671R,富邦NASDAQ反1,5,0,5,群益金鼎-松山,2023-07-12,9103
2330,台積電,6,1,5,群益金鼎-松山,2023-07-12,9103
2637,慧洋-KY,5,0,5,群益金鼎-松山,2023-07-12,9103
2743,山富,6,1,5,群益金鼎-松山,2023-07-12,9103
4123,晟德,5,0,5,群益金鼎-松山,2023-07-12,9103
2409,友達,200,0,200,群益金鼎-松山,2023-07-13,9103
3481,群創,138,7,131,群益金鼎-松山,2023-07-13,9103
2382,廣達,161,62,99,群益金鼎-松山,2023-07-13,9103
00885,富邦越南,65,0,65,群益金鼎-松山,2023-07-13,9103
2344,華邦電,110,52,58,群益金鼎-松山,2023-07-13,9103
2329,華泰,55,1,54,群益金鼎-松山,2023-07-13,9103
2301,光寶科,128,74,54,群益金鼎-松山,2023-07-13,9103
4306,炎洲,34,0,34,群益金鼎-松山,2023-07-13,9103
2498,宏達電,36,5,31,群益金鼎-松山,2023-07-13,9103
6577,勁豐,31,0,31,群益金鼎-松山,2023-07-13,9103
00671R,富邦NASDAQ反1,30,0,30,群益金鼎-松山,2023-07-13,9103
2609,陽明,30,0,30,群益金鼎-松山,2023-07-13,9103
3037,欣興,42,15,27,群益金鼎-松山,2023-07-13,9103
8084,巨虹,28,1,27,群益金鼎-松山,2023-07-13,9103
5258,虹堡,22,2,20,群益金鼎-松山,2023-07-13,9103
3706,神達,24,5,19,群益金鼎-松山,2023-07-13,9103
3231,緯創,57,39,18,群益金鼎-松山,2023-07-13,9103
8040,九暘,18,0,18,群益金鼎-松山,2023-07-13,9103
6125,廣運,17,0,17,群益金鼎-松山,2023-07-13,9103
3011,今皓,16,0,16,群益金鼎-松山,2023-07-13,9103
3022,威強電,15,0,15,群益金鼎-松山,2023-07-13,9103
3363,上詮,28,14,14,群益金鼎-松山,2023-07-13,9103
1711,永光,12,0,12,群益金鼎-松山,2023-07-13,9103
3078,僑威,14,2,12,群益金鼎-松山,2023-07-13,9103
3583,辛耘,15,3,12,群益金鼎-松山,2023-07-13,9103
3693,營邦,12,0,12,群益金鼎-松山,2023-07-13,9103
00752,中信中國50,10,0,10,群益金鼎-松山,2023-07-13,9103
1440,南紡,10,0,10,群益金鼎-松山,2023-07-13,9103
2332,友訊,10,0,10,群益金鼎-松山,2023-07-13,9103
3033,威健,10,0,10,群益金鼎-松山,2023-07-13,9103
3228,金麗科,10,0,10,群益金鼎-松山,2023-07-13,9103
8349,�矬�,10,0,10,群益金鼎-松山,2023-07-13,9103
9945,潤泰新,10,0,10,群益金鼎-松山,2023-07-13,9103
2359,所羅門,12,3,9,群益金鼎-松山,2023-07-13,9103
2374,佳能,9,0,9,群益金鼎-松山,2023-07-13,9103
2312,金寶,11,3,8,群益金鼎-松山,2023-07-13,9103
5434,崇越,8,0,8,群益金鼎-松山,2023-07-13,9103
6415,矽力*-KY,7,0,7,群益金鼎-松山,2023-07-13,9103
1101,台泥,7,0,7,群益金鼎-松山,2023-07-13,9103
1560,中砂,8,1,7,群益金鼎-松山,2023-07-13,9103
3019,亞光,17,10,7,群益金鼎-松山,2023-07-13,9103
6016,康和證,7,0,7,群益金鼎-松山,2023-07-13,9103
1609,大亞,9,3,6,群益金鼎-松山,2023-07-13,9103
3163,波若威,6,0,6,群益金鼎-松山,2023-07-13,9103
00753L,中信中國50正2,5,0,5,群益金鼎-松山,2023-07-13,9103
1591,駿吉-KY,5,0,5,群益金鼎-松山,2023-07-13,9103
2002,中鋼,5,0,5,群益金鼎-松山,2023-07-13,9103
2383,台光電,7,2,5,群益金鼎-松山,2023-07-13,9103
2421,建準,25,20,5,群益金鼎-松山,2023-07-13,9103
3540,曜越,6,1,5,群益金鼎-松山,2023-07-13,9103
2888,新光金,371,0,371,群益金鼎-松山,2023-07-14,9103
00885,富邦越南,114,1,113,群益金鼎-松山,2023-07-14,9103
6609,瀧澤科,100,0,100,群益金鼎-松山,2023-07-14,9103
00878,國泰永續高股息,221,155,66,群益金鼎-松山,2023-07-14,9103
3231,緯創,94,54,40,群益金鼎-松山,2023-07-14,9103
2610,華航,46,10,36,群益金鼎-松山,2023-07-14,9103
8084,巨虹,32,0,32,群益金鼎-松山,2023-07-14,9103
00671R,富邦NASDAQ反1,30,0,30,群益金鼎-松山,2023-07-14,9103
1618,合機,30,0,30,群益金鼎-松山,2023-07-14,9103
3013,晟銘電,60,30,30,群益金鼎-松山,2023-07-14,9103
2382,廣達,90,61,29,群益金鼎-松山,2023-07-14,9103
3078,僑威,29,2,27,群益金鼎-松山,2023-07-14,9103
6274,台燿,37,10,27,群益金鼎-松山,2023-07-14,9103
3594,磐儀,22,0,22,群益金鼎-松山,2023-07-14,9103
2104,國際中橡,20,0,20,群益金鼎-松山,2023-07-14,9103
3088,艾訊,20,0,20,群益金鼎-松山,2023-07-14,9103
6412,群電,20,0,20,群益金鼎-松山,2023-07-14,9103
1504,東元,19,1,18,群益金鼎-松山,2023-07-14,9103
2618,長榮航,19,2,17,群益金鼎-松山,2023-07-14,9103
8050,廣積,23,7,16,群益金鼎-松山,2023-07-14,9103
3577,泓格,12,0,12,群益金鼎-松山,2023-07-14,9103
6125,廣運,12,0,12,群益金鼎-松山,2023-07-14,9103
6456,GIS-KY,12,0,12,群益金鼎-松山,2023-07-14,9103
6104,創惟,12,1,11,群益金鼎-松山,2023-07-14,9103
3715,定穎投控,16,5,11,群益金鼎-松山,2023-07-14,9103
1503,士電,48,38,10,群益金鼎-松山,2023-07-14,9103
2020,美亞,10,0,10,群益金鼎-松山,2023-07-14,9103
5258,虹堡,16,6,10,群益金鼎-松山,2023-07-14,9103
6276,安鈦克,11,1,10,群益金鼎-松山,2023-07-14,9103
2376,技嘉,17,7,10,群益金鼎-松山,2023-07-14,9103
2498,宏達電,40,31,9,群益金鼎-松山,2023-07-14,9103
4904,遠傳,10,1,9,群益金鼎-松山,2023-07-14,9103
2630,亞航,8,0,8,群益金鼎-松山,2023-07-14,9103
8028,昇陽半導體,11,3,8,群益金鼎-松山,2023-07-14,9103
2354,鴻準,7,0,7,群益金鼎-松山,2023-07-14,9103
00688L,國泰20年美債正2,6,0,6,群益金鼎-松山,2023-07-14,9103
2329,華泰,9,3,6,群益金鼎-松山,2023-07-14,9103
5483,中美晶,8,2,6,群益金鼎-松山,2023-07-14,9103
6168,宏齊,6,0,6,群益金鼎-松山,2023-07-14,9103
6187,萬潤,10,4,6,群益金鼎-松山,2023-07-14,9103
4979,華星光,5,0,5,群益金鼎-松山,2023-07-14,9103
2408,南亞科,5,0,5,群益金鼎-松山,2023-07-14,9103
3014,聯陽,5,0,5,群益金鼎-松山,2023-07-14,9103
3669,圓展,5,0,5,群益金鼎-松山,2023-07-14,9103
3704,合勤控,6,1,5,群益金鼎-松山,2023-07-14,9103
4538,大詠城,5,0,5,群益金鼎-松山,2023-07-14,9103
5907,大洋-KY,5,0,5,群益金鼎-松山,2023-07-14,9103
6118,建達,30,25,5,群益金鼎-松山,2023-07-14,9103
0050,元大台灣50,5,1,4,群益金鼎-松山,2023-07-14,9103
3032,偉訓,12,8,4,群益金鼎-松山,2023-07-14,9103
1513,中興電,642,216,426,群益金鼎-松山,2023-07-17,9103
2312,金寶,311,161,150,群益金鼎-松山,2023-07-17,9103
2362,藍天,110,2,108,群益金鼎-松山,2023-07-17,9103
1471,首利,100,0,100,群益金鼎-松山,2023-07-17,9103
2020,美亞,83,0,83,群益金鼎-松山,2023-07-17,9103
1605,華新,86,17,69,群益金鼎-松山,2023-07-17,9103
2353,宏��,75,6,69,群益金鼎-松山,2023-07-17,9103
00632R,元大台灣50反1,50,0,50,群益金鼎-松山,2023-07-17,9103
1815,富喬,40,0,40,群益金鼎-松山,2023-07-17,9103
2462,良得電,34,0,34,群益金鼎-松山,2023-07-17,9103
4306,炎洲,33,0,33,群益金鼎-松山,2023-07-17,9103
3231,緯創,108,75,33,群益金鼎-松山,2023-07-17,9103
00720B,元大投資級公司債,31,0,31,群益金鼎-松山,2023-07-17,9103
00751B,元大AAA至A公司債,31,0,31,群益金鼎-松山,2023-07-17,9103
8084,巨虹,28,0,28,群益金鼎-松山,2023-07-17,9103
3005,神基,50,23,27,群益金鼎-松山,2023-07-17,9103
1504,東元,47,24,23,群益金鼎-松山,2023-07-17,9103
5876,上海商銀,20,0,20,群益金鼎-松山,2023-07-17,9103
6412,群電,20,0,20,群益金鼎-松山,2023-07-17,9103
9907,統一實,20,0,20,群益金鼎-松山,2023-07-17,9103
2449,京元電子,23,4,19,群益金鼎-松山,2023-07-17,9103
3527,聚積,18,0,18,群益金鼎-松山,2023-07-17,9103
6470,宇智,25,7,18,群益金鼎-松山,2023-07-17,9103
6282,康舒,65,48,17,群益金鼎-松山,2023-07-17,9103
3583,辛耘,27,11,16,群益金鼎-松山,2023-07-17,9103
8071,能率網通,14,0,14,群益金鼎-松山,2023-07-17,9103
6609,瀧澤科,12,0,12,群益金鼎-松山,2023-07-17,9103
1514,亞力,23,12,11,群益金鼎-松山,2023-07-17,9103
6125,廣運,11,0,11,群益金鼎-松山,2023-07-17,9103
6276,安鈦克,11,0,11,群益金鼎-松山,2023-07-17,9103
00923,群益台ESG低碳50,10,0,10,群益金鼎-松山,2023-07-17,9103
1905,華紙,10,0,10,群益金鼎-松山,2023-07-17,9103
2014,中鴻,10,0,10,群益金鼎-松山,2023-07-17,9103
2323,中環,26,16,10,群益金鼎-松山,2023-07-17,9103
2355,敬鵬,10,0,10,群益金鼎-松山,2023-07-17,9103
2485,兆赫,20,10,10,群益金鼎-松山,2023-07-17,9103
3078,僑威,10,0,10,群益金鼎-松山,2023-07-17,9103
00722B,群益投資級電信債,8,0,8,群益金鼎-松山,2023-07-17,9103
2427,三商電,14,6,8,群益金鼎-松山,2023-07-17,9103
3540,曜越,10,2,8,群益金鼎-松山,2023-07-17,9103
4977,眾達-KY,8,0,8,群益金鼎-松山,2023-07-17,9103
2329,華泰,8,1,7,群益金鼎-松山,2023-07-17,9103
6112,邁達特,11,4,7,群益金鼎-松山,2023-07-17,9103
6235,華孚,7,0,7,群益金鼎-松山,2023-07-17,9103
6139,亞翔,7,1,6,群益金鼎-松山,2023-07-17,9103
6414,樺漢,6,0,6,群益金鼎-松山,2023-07-17,9103
2382,廣達,28,22,6,群益金鼎-松山,2023-07-17,9103
00696B,富邦美債20年,5,0,5,群益金鼎-松山,2023-07-17,9103
2745,五福,5,0,5,群益金鼎-松山,2023-07-17,9103
4538,大詠城,5,0,5,群益金鼎-松山,2023-07-17,9103
9941,裕融,156,0,156,群益金鼎-松山,2023-07-18,9103
2356,英業達,183,63,120,群益金鼎-松山,2023-07-18,9103
2344,華邦電,118,0,118,群益金鼎-松山,2023-07-18,9103
1513,中興電,105,0,105,群益金鼎-松山,2023-07-18,9103
1313,聯成,92,3,89,群益金鼎-松山,2023-07-18,9103
2324,仁寶,181,122,59,群益金鼎-松山,2023-07-18,9103
2371,大同,111,54,57,群益金鼎-松山,2023-07-18,9103
2615,萬海,50,0,50,群益金鼎-松山,2023-07-18,9103
5465,富驊,58,11,47,群益金鼎-松山,2023-07-18,9103
2352,佳世達,58,12,46,群益金鼎-松山,2023-07-18,9103
4938,和碩,160,118,42,群益金鼎-松山,2023-07-18,9103
00878,國泰永續高股息,440,401,39,群益金鼎-松山,2023-07-18,9103
6282,康舒,40,10,30,群益金鼎-松山,2023-07-18,9103
2425,承啟,31,2,29,群益金鼎-松山,2023-07-18,9103
1784,訊聯,28,0,28,群益金鼎-松山,2023-07-18,9103
00720B,元大投資級公司債,31,5,26,群益金鼎-松山,2023-07-18,9103
2603,長榮,25,1,24,群益金鼎-松山,2023-07-18,9103
3706,神達,110,87,23,群益金鼎-松山,2023-07-18,9103
1514,亞力,34,12,22,群益金鼎-松山,2023-07-18,9103
3338,泰碩,32,10,22,群益金鼎-松山,2023-07-18,9103
00751B,元大AAA至A公司債,20,0,20,群益金鼎-松山,2023-07-18,9103
00725B,國泰投資級公司債,20,0,20,群益金鼎-松山,2023-07-18,9103
00633L,富邦上証正2,20,0,20,群益金鼎-松山,2023-07-18,9103
1605,華新,25,5,20,群益金鼎-松山,2023-07-18,9103
2201,裕隆,20,0,20,群益金鼎-松山,2023-07-18,9103
3071,協禧,83,63,20,群益金鼎-松山,2023-07-18,9103
6412,群電,20,0,20,群益金鼎-松山,2023-07-18,9103
3032,偉訓,15,0,15,群益金鼎-松山,2023-07-18,9103
1712,興農,15,0,15,群益金鼎-松山,2023-07-18,9103
3013,晟銘電,65,50,15,群益金鼎-松山,2023-07-18,9103
6244,茂迪,15,0,15,群益金鼎-松山,2023-07-18,9103
3037,欣興,26,12,14,群益金鼎-松山,2023-07-18,9103
8050,廣積,46,34,12,群益金鼎-松山,2023-07-18,9103
1503,士電,22,11,11,群益金鼎-松山,2023-07-18,9103
00882,中信中國高股息,11,0,11,群益金鼎-松山,2023-07-18,9103
00923,群益台ESG低碳50,11,0,11,群益金鼎-松山,2023-07-18,9103
2889,國票金,11,0,11,群益金鼎-松山,2023-07-18,9103
4414,如興,11,0,11,群益金鼎-松山,2023-07-18,9103
4755,三福化,11,0,11,群益金鼎-松山,2023-07-18,9103
6202,盛群,11,0,11,群益金鼎-松山,2023-07-18,9103
1440,南紡,10,0,10,群益金鼎-松山,2023-07-18,9103
2485,兆赫,10,0,10,群益金鼎-松山,2023-07-18,9103
2801,彰銀,10,0,10,群益金鼎-松山,2023-07-18,9103
3088,艾訊,10,0,10,群益金鼎-松山,2023-07-18,9103
3432,台端,10,0,10,群益金鼎-松山,2023-07-18,9103
4162,智擎,10,0,10,群益金鼎-松山,2023-07-18,9103
6160,欣技,10,0,10,群益金鼎-松山,2023-07-18,9103
6546,正基,10,0,10,群益金鼎-松山,2023-07-18,9103
8084,巨虹,10,0,10,群益金鼎-松山,2023-07-18,9103
6625,必應,9,0,9,群益金鼎-松山,2023-07-18,9103
2405,輔信,115,6,109,群益金鼎-松山,2023-07-19,9103
9941,裕融,100,0,100,群益金鼎-松山,2023-07-19,9103
2603,長榮,62,0,62,群益金鼎-松山,2023-07-19,9103
2419,仲琦,84,33,51,群益金鼎-松山,2023-07-19,9103
5876,上海商銀,36,0,36,群益金鼎-松山,2023-07-19,9103
2382,廣達,33,6,27,群益金鼎-松山,2023-07-19,9103
6235,華孚,45,19,26,群益金鼎-松山,2023-07-19,9103
6412,群電,20,0,20,群益金鼎-松山,2023-07-19,9103
2301,光寶科,38,18,20,群益金鼎-松山,2023-07-19,9103
6168,宏齊,18,0,18,群益金鼎-松山,2023-07-19,9103
3305,昇貿,16,1,15,群益金鼎-松山,2023-07-19,9103
6657,華安,15,0,15,群益金鼎-松山,2023-07-19,9103
9105,泰金寶-DR,15,0,15,群益金鼎-松山,2023-07-19,9103
2383,台光電,17,2,15,群益金鼎-松山,2023-07-19,9103
4938,和碩,31,17,14,群益金鼎-松山,2023-07-19,9103
1473,台南,14,0,14,群益金鼎-松山,2023-07-19,9103
4533,協易機,18,6,12,群益金鼎-松山,2023-07-19,9103
1503,士電,12,1,11,群益金鼎-松山,2023-07-19,9103
00751B,元大AAA至A公司債,11,0,11,群益金鼎-松山,2023-07-19,9103
0056,元大高股息,10,0,10,群益金鼎-松山,2023-07-19,9103
3105,穩懋,10,0,10,群益金鼎-松山,2023-07-19,9103
2009,第一銅,10,0,10,群益金鼎-松山,2023-07-19,9103
2485,兆赫,10,0,10,群益金鼎-松山,2023-07-19,9103
2610,華航,10,0,10,群益金鼎-松山,2023-07-19,9103
2889,國票金,10,0,10,群益金鼎-松山,2023-07-19,9103
3481,群創,10,0,10,群益金鼎-松山,2023-07-19,9103
4768,晶呈科技,12,2,10,群益金鼎-松山,2023-07-19,9103
6451,訊芯-KY,44,34,10,群益金鼎-松山,2023-07-19,9103
8155,博智,11,1,10,群益金鼎-松山,2023-07-19,9103
4919,新唐,14,5,9,群益金鼎-松山,2023-07-19,9103
3022,威強電,9,0,9,群益金鼎-松山,2023-07-19,9103
1795,美時,9,1,8,群益金鼎-松山,2023-07-19,9103
2317,鴻海,8,0,8,群益金鼎-松山,2023-07-19,9103
2462,良得電,8,0,8,群益金鼎-松山,2023-07-19,9103
4138,曜亞,8,0,8,群益金鼎-松山,2023-07-19,9103
2368,金像電,8,1,7,群益金鼎-松山,2023-07-19,9103
2609,陽明,10,3,7,群益金鼎-松山,2023-07-19,9103
3163,波若威,7,0,7,群益金鼎-松山,2023-07-19,9103
5465,富驊,13,6,7,群益金鼎-松山,2023-07-19,9103
6104,創惟,8,1,7,群益金鼎-松山,2023-07-19,9103
8040,九暘,8,1,7,群益金鼎-松山,2023-07-19,9103
8349,�矬�,7,0,7,群益金鼎-松山,2023-07-19,9103
00720B,元大投資級公司債,6,0,6,群益金鼎-松山,2023-07-19,9103
4551,智伸科,6,0,6,群益金鼎-松山,2023-07-19,9103
4743,合一,6,0,6,群益金鼎-松山,2023-07-19,9103
6625,必應,13,7,6,群益金鼎-松山,2023-07-19,9103
8069,元太,6,0,6,群益金鼎-松山,2023-07-19,9103
00882,中信中國高股息,5,0,5,群益金鼎-松山,2023-07-19,9103
1101,台泥,5,0,5,群益金鼎-松山,2023-07-19,9103
1528,恩德,5,0,5,群益金鼎-松山,2023-07-19,9103
4906,正文,186,0,186,群益金鼎-松山,2023-07-20,9103
0056,元大高股息,71,1,70,群益金鼎-松山,2023-07-20,9103
00878,國泰永續高股息,207,145,62,群益金鼎-松山,2023-07-20,9103
2329,華泰,50,0,50,群益金鼎-松山,2023-07-20,9103
6213,聯茂,48,0,48,群益金鼎-松山,2023-07-20,9103
2353,宏��,61,19,42,群益金鼎-松山,2023-07-20,9103
2461,光群雷,38,0,38,群益金鼎-松山,2023-07-20,9103
4977,眾達-KY,37,2,35,群益金鼎-松山,2023-07-20,9103
8084,巨虹,32,0,32,群益金鼎-松山,2023-07-20,9103
00751B,元大AAA至A公司債,31,0,31,群益金鼎-松山,2023-07-20,9103
2356,英業達,137,111,26,群益金鼎-松山,2023-07-20,9103
2630,亞航,25,0,25,群益金鼎-松山,2023-07-20,9103
1529,樂事綠能,27,4,23,群益金鼎-松山,2023-07-20,9103
2303,聯電,22,1,21,群益金鼎-松山,2023-07-20,9103
3357,臺慶科,20,0,20,群益金鼎-松山,2023-07-20,9103
4543,萬在,21,1,20,群益金鼎-松山,2023-07-20,9103
6282,康舒,48,28,20,群益金鼎-松山,2023-07-20,9103
9941,裕融,320,300,20,群益金鼎-松山,2023-07-20,9103
2610,華航,29,10,19,群益金鼎-松山,2023-07-20,9103
3264,欣銓,18,2,16,群益金鼎-松山,2023-07-20,9103
3289,宜特,21,5,16,群益金鼎-松山,2023-07-20,9103
2405,輔信,47,31,16,群益金鼎-松山,2023-07-20,9103
2206,三陽工業,21,8,13,群益金鼎-松山,2023-07-20,9103
00720B,元大投資級公司債,21,9,12,群益金鼎-松山,2023-07-20,9103
1513,中興電,12,0,12,群益金鼎-松山,2023-07-20,9103
3163,波若威,12,0,12,群益金鼎-松山,2023-07-20,9103
3324,雙鴻,32,20,12,群益金鼎-松山,2023-07-20,9103
2312,金寶,11,0,11,群益金鼎-松山,2023-07-20,9103
6188,廣明,21,10,11,群益金鼎-松山,2023-07-20,9103
1304,台聚,10,0,10,群益金鼎-松山,2023-07-20,9103
1605,華新,10,0,10,群益金鼎-松山,2023-07-20,9103
1591,駿吉-KY,10,0,10,群益金鼎-松山,2023-07-20,9103
2409,友達,10,0,10,群益金鼎-松山,2023-07-20,9103
2743,山富,21,11,10,群益金鼎-松山,2023-07-20,9103
3051,力特,10,0,10,群益金鼎-松山,2023-07-20,9103
3483,力致,11,1,10,群益金鼎-松山,2023-07-20,9103
6187,萬潤,25,16,9,群益金鼎-松山,2023-07-20,9103
6158,禾昌,8,0,8,群益金鼎-松山,2023-07-20,9103
3013,晟銘電,140,133,7,群益金鼎-松山,2023-07-20,9103
1618,合機,12,5,7,群益金鼎-松山,2023-07-20,9103
00882,中信中國高股息,10,3,7,群益金鼎-松山,2023-07-20,9103
2618,長榮航,6,0,6,群益金鼎-松山,2023-07-20,9103
5469,瀚宇博,6,0,6,群益金鼎-松山,2023-07-20,9103
2402,毅嘉,6,0,6,群益金鼎-松山,2023-07-20,9103
3035,智原,11,5,6,群益金鼎-松山,2023-07-20,9103
2330,台積電,5,0,5,群益金鼎-松山,2023-07-20,9103
1514,亞力,23,18,5,群益金鼎-松山,2023-07-20,9103
1795,美時,5,0,5,群益金鼎-松山,2023-07-20,9103
1528,恩德,5,0,5,群益金鼎-松山,2023-07-20,9103
2748,雲品,12,7,5,群益金鼎-松山,2023-07-20,9103
8084,巨虹,47,0,47,群益金鼎-松山,2023-07-21,9103
2382,廣達,69,31,38,群益金鼎-松山,2023-07-21,9103
6274,台燿,36,2,34,群益金鼎-松山,2023-07-21,9103
6117,迎廣,23,0,23,群益金鼎-松山,2023-07-21,9103
1504,東元,28,7,21,群益金鼎-松山,2023-07-21,9103
6125,廣運,50,30,20,群益金鼎-松山,2023-07-21,9103
00633L,富邦上証正2,20,0,20,群益金鼎-松山,2023-07-21,9103
00725B,國泰投資級公司債,20,0,20,群益金鼎-松山,2023-07-21,9103
00720B,元大投資級公司債,16,0,16,群益金鼎-松山,2023-07-21,9103
2376,技嘉,31,15,16,群益金鼎-松山,2023-07-21,9103
6625,必應,16,0,16,群益金鼎-松山,2023-07-21,9103
2368,金像電,34,21,13,群益金鼎-松山,2023-07-21,9103
1513,中興電,64,53,11,群益金鼎-松山,2023-07-21,9103
2230,泰茂,15,5,10,群益金鼎-松山,2023-07-21,9103
0056,元大高股息,10,1,9,群益金鼎-松山,2023-07-21,9103
1519,華城,10,1,9,群益金鼎-松山,2023-07-21,9103
2303,聯電,9,0,9,群益金鼎-松山,2023-07-21,9103
4306,炎洲,9,0,9,群益金鼎-松山,2023-07-21,9103
6284,佳邦,9,0,9,群益金鼎-松山,2023-07-21,9103
2371,大同,24,15,9,群益金鼎-松山,2023-07-21,9103
2330,台積電,9,0,9,群益金鼎-松山,2023-07-21,9103
1760,寶齡富錦,8,0,8,群益金鼎-松山,2023-07-21,9103
2383,台光電,19,11,8,群益金鼎-松山,2023-07-21,9103
1101,台泥,11,4,7,群益金鼎-松山,2023-07-21,9103
2201,裕隆,7,0,7,群益金鼎-松山,2023-07-21,9103
6244,茂迪,7,0,7,群益金鼎-松山,2023-07-21,9103
2316,楠梓電,11,5,6,群益金鼎-松山,2023-07-21,9103
2393,億光,6,0,6,群益金鼎-松山,2023-07-21,9103
2405,輔信,7,1,6,群益金鼎-松山,2023-07-21,9103
3693,營邦,6,0,6,群益金鼎-松山,2023-07-21,9103
4916,事欣科,13,7,6,群益金鼎-松山,2023-07-21,9103
4953,緯軟,27,21,6,群益金鼎-松山,2023-07-21,9103
4979,華星光,16,10,6,群益金鼎-松山,2023-07-21,9103
2609,陽明,12,7,5,群益金鼎-松山,2023-07-21,9103
00637L,元大滬深300正2,5,0,5,群益金鼎-松山,2023-07-21,9103
2002,中鋼,5,0,5,群益金鼎-松山,2023-07-21,9103
2882,國泰金,5,0,5,群益金鼎-松山,2023-07-21,9103
3037,欣興,16,11,5,群益金鼎-松山,2023-07-21,9103
4155,訊映,5,0,5,群益金鼎-松山,2023-07-21,9103
4162,智擎,5,0,5,群益金鼎-松山,2023-07-21,9103
6202,盛群,6,1,5,群益金鼎-松山,2023-07-21,9103
6213,聯茂,5,0,5,群益金鼎-松山,2023-07-21,9103
2027,大成鋼,4,0,4,群益金鼎-松山,2023-07-21,9103
4743,合一,4,0,4,群益金鼎-松山,2023-07-21,9103
6472,保瑞,8,4,4,群益金鼎-松山,2023-07-21,9103
8050,廣積,4,0,4,群益金鼎-松山,2023-07-21,9103
4747,強生,3,0,3,群益金鼎-松山,2023-07-21,9103
8046,南電,3,0,3,群益金鼎-松山,2023-07-21,9103
1727,中華化,3,0,3,群益金鼎-松山,2023-07-21,9103
00772B,中信高評級公司債,3,0,3,群益金鼎-松山,2023-07-21,9103
1513,中興電,290,2,288,群益金鼎-松山,2023-07-24,9103
5469,瀚宇博,109,2,107,群益金鼎-松山,2023-07-24,9103
6161,捷波,61,0,61,群益金鼎-松山,2023-07-24,9103
3032,偉訓,70,15,55,群益金鼎-松山,2023-07-24,9103
2356,英業達,203,153,50,群益金鼎-松山,2023-07-24,9103
3305,昇貿,49,0,49,群益金鼎-松山,2023-07-24,9103
00878,國泰永續高股息,305,262,43,群益金鼎-松山,2023-07-24,9103
6168,宏齊,36,0,36,群益金鼎-松山,2023-07-24,9103
2461,光群雷,33,3,30,群益金鼎-松山,2023-07-24,9103
3306,鼎天,28,0,28,群益金鼎-松山,2023-07-24,9103
00885,富邦越南,27,0,27,群益金鼎-松山,2023-07-24,9103
00751B,元大AAA至A公司債,23,0,23,群益金鼎-松山,2023-07-24,9103
00720B,元大投資級公司債,17,0,17,群益金鼎-松山,2023-07-24,9103
1217,愛之味,16,0,16,群益金鼎-松山,2023-07-24,9103
1101,台泥,15,0,15,群益金鼎-松山,2023-07-24,9103
2801,彰銀,15,0,15,群益金鼎-松山,2023-07-24,9103
3017,奇鋐,64,49,15,群益金鼎-松山,2023-07-24,9103
2323,中環,15,1,14,群益金鼎-松山,2023-07-24,9103
6188,廣明,21,7,14,群益金鼎-松山,2023-07-24,9103
2352,佳世達,13,0,13,群益金鼎-松山,2023-07-24,9103
2371,大同,22,9,13,群益金鼎-松山,2023-07-24,9103
3706,神達,21,8,13,群益金鼎-松山,2023-07-24,9103
6112,邁達特,11,0,11,群益金鼎-松山,2023-07-24,9103
2303,聯電,10,0,10,群益金鼎-松山,2023-07-24,9103
2338,光罩,10,0,10,群益金鼎-松山,2023-07-24,9103
3483,力致,21,11,10,群益金鼎-松山,2023-07-24,9103
1711,永光,9,0,9,群益金鼎-松山,2023-07-24,9103
6811,宏�硌穈T,9,0,9,群益金鼎-松山,2023-07-24,9103
6148,驊宏資,8,0,8,群益金鼎-松山,2023-07-24,9103
3362,先進光,8,0,8,群益金鼎-松山,2023-07-24,9103
2316,楠梓電,14,7,7,群益金鼎-松山,2023-07-24,9103
2421,建準,62,55,7,群益金鼎-松山,2023-07-24,9103
2610,華航,7,0,7,群益金鼎-松山,2023-07-24,9103
3481,群創,10,3,7,群益金鼎-松山,2023-07-24,9103
2201,裕隆,7,1,6,群益金鼎-松山,2023-07-24,9103
6213,聯茂,11,5,6,群益金鼎-松山,2023-07-24,9103
6558,興能高,6,0,6,群益金鼎-松山,2023-07-24,9103
6625,必應,7,1,6,群益金鼎-松山,2023-07-24,9103
8071,能率網通,6,0,6,群益金鼎-松山,2023-07-24,9103
00632R,元大台灣50反1,5,0,5,群益金鼎-松山,2023-07-24,9103
4155,訊映,5,0,5,群益金鼎-松山,2023-07-24,9103
5388,中磊,6,1,5,群益金鼎-松山,2023-07-24,9103
5876,上海商銀,5,0,5,群益金鼎-松山,2023-07-24,9103
6177,達麗,5,0,5,群益金鼎-松山,2023-07-24,9103
6202,盛群,5,0,5,群益金鼎-松山,2023-07-24,9103
2357,華碩,11,6,5,群益金鼎-松山,2023-07-24,9103
1609,大亞,20,16,4,群益金鼎-松山,2023-07-24,9103
5425,台半,4,0,4,群益金鼎-松山,2023-07-24,9103
6593,台灣銘板,4,0,4,群益金鼎-松山,2023-07-24,9103
7556,意德士,3,0,3,群益金鼎-松山,2023-07-24,9103
3481,群創,334,136,198,群益金鼎-松山,2023-07-25,9103
00632R,元大台灣50反1,95,0,95,群益金鼎-松山,2023-07-25,9103
5324,士開,67,0,67,群益金鼎-松山,2023-07-25,9103
2353,宏��,117,63,54,群益金鼎-松山,2023-07-25,9103
2382,廣達,70,32,38,群益金鼎-松山,2023-07-25,9103
6125,廣運,37,6,31,群益金鼎-松山,2023-07-25,9103
5340,建榮,26,0,26,群益金鼎-松山,2023-07-25,9103
00885,富邦越南,23,0,23,群益金鼎-松山,2023-07-25,9103
4977,眾達-KY,21,0,21,群益金鼎-松山,2023-07-25,9103
1419,新紡,20,0,20,群益金鼎-松山,2023-07-25,9103
2206,三陽工業,20,0,20,群益金鼎-松山,2023-07-25,9103
5258,虹堡,21,1,20,群益金鼎-松山,2023-07-25,9103
00679B,元大美債20年,18,0,18,群益金鼎-松山,2023-07-25,9103
00706L,期元大S＆P日圓正2,18,0,18,群益金鼎-松山,2023-07-25,9103
1605,華新,16,0,16,群益金鼎-松山,2023-07-25,9103
3044,健鼎,28,13,15,群益金鼎-松山,2023-07-25,9103
00720B,元大投資級公司債,11,0,11,群益金鼎-松山,2023-07-25,9103
2323,中環,16,5,11,群益金鼎-松山,2023-07-25,9103
2377,微星,11,0,11,群益金鼎-松山,2023-07-25,9103
2609,陽明,15,4,11,群益金鼎-松山,2023-07-25,9103
3693,營邦,11,0,11,群益金鼎-松山,2023-07-25,9103
3324,雙鴻,54,44,10,群益金鼎-松山,2023-07-25,9103
2301,光寶科,15,5,10,群益金鼎-松山,2023-07-25,9103
1101,台泥,10,0,10,群益金鼎-松山,2023-07-25,9103
1519,華城,10,0,10,群益金鼎-松山,2023-07-25,9103
2743,山富,10,0,10,群益金鼎-松山,2023-07-25,9103
2812,台中銀,10,0,10,群益金鼎-松山,2023-07-25,9103
2887,台新金,10,0,10,群益金鼎-松山,2023-07-25,9103
3078,僑威,10,0,10,群益金鼎-松山,2023-07-25,9103
3702,大聯大,10,0,10,群益金鼎-松山,2023-07-25,9103
1905,華紙,10,1,9,群益金鼎-松山,2023-07-25,9103
00772B,中信高評級公司債,9,0,9,群益金鼎-松山,2023-07-25,9103
2324,仁寶,12,3,9,群益金鼎-松山,2023-07-25,9103
2745,五福,10,1,9,群益金鼎-松山,2023-07-25,9103
4162,智擎,9,0,9,群益金鼎-松山,2023-07-25,9103
6841,長佳智能,18,9,9,群益金鼎-松山,2023-07-25,9103
2419,仲琦,11,3,8,群益金鼎-松山,2023-07-25,9103
6143,振曜,11,3,8,群益金鼎-松山,2023-07-25,9103
9945,潤泰新,8,0,8,群益金鼎-松山,2023-07-25,9103
3515,華擎,15,8,7,群益金鼎-松山,2023-07-25,9103
2376,技嘉,19,13,6,群益金鼎-松山,2023-07-25,9103
6139,亞翔,8,2,6,群益金鼎-松山,2023-07-25,9103
4768,晶呈科技,5,0,5,群益金鼎-松山,2023-07-25,9103
1802,台玻,5,0,5,群益金鼎-松山,2023-07-25,9103
5388,中磊,6,1,5,群益金鼎-松山,2023-07-25,9103
2495,普安,5,0,5,群益金鼎-松山,2023-07-25,9103
2610,華航,6,1,5,群益金鼎-松山,2023-07-25,9103
3430,奇鈦科,5,0,5,群益金鼎-松山,2023-07-25,9103
4306,炎洲,5,0,5,群益金鼎-松山,2023-07-25,9103
6177,達麗,5,0,5,群益金鼎-松山,2023-07-25,9103
3481,群創,402,202,200,群益金鼎-松山,2023-07-26,9103
00878,國泰永續高股息,208,101,107,群益金鼎-松山,2023-07-26,9103
00665L,富邦�琤肭磪囓�2,100,0,100,群益金鼎-松山,2023-07-26,9103
2801,彰銀,100,0,100,群益金鼎-松山,2023-07-26,9103
2888,新光金,151,56,95,群益金鼎-松山,2023-07-26,9103
2371,大同,57,8,49,群益金鼎-松山,2023-07-26,9103
6188,廣明,43,7,36,群益金鼎-松山,2023-07-26,9103
2353,宏��,42,9,33,群益金鼎-松山,2023-07-26,9103
2031,新光鋼,30,0,30,群益金鼎-松山,2023-07-26,9103
00885,富邦越南,24,0,24,群益金鼎-松山,2023-07-26,9103
0056,元大高股息,21,0,21,群益金鼎-松山,2023-07-26,9103
6625,必應,20,0,20,群益金鼎-松山,2023-07-26,9103
6274,台燿,39,19,20,群益金鼎-松山,2023-07-26,9103
8028,昇陽半導體,20,0,20,群益金鼎-松山,2023-07-26,9103
6168,宏齊,16,0,16,群益金鼎-松山,2023-07-26,9103
1605,華新,15,0,15,群益金鼎-松山,2023-07-26,9103
2023,燁輝,15,0,15,群益金鼎-松山,2023-07-26,9103
2887,台新金,15,0,15,群益金鼎-松山,2023-07-26,9103
00751B,元大AAA至A公司債,11,0,11,群益金鼎-松山,2023-07-26,9103
00720B,元大投資級公司債,11,0,11,群益金鼎-松山,2023-07-26,9103
1471,首利,11,0,11,群益金鼎-松山,2023-07-26,9103
2449,京元電子,11,0,11,群益金鼎-松山,2023-07-26,9103
1314,中石化,10,0,10,群益金鼎-松山,2023-07-26,9103
2367,燿華,10,0,10,群益金鼎-松山,2023-07-26,9103
2610,華航,16,6,10,群益金鼎-松山,2023-07-26,9103
2734,易飛網,10,0,10,群益金鼎-松山,2023-07-26,9103
2736,富野,20,10,10,群益金鼎-松山,2023-07-26,9103
4414,如興,10,0,10,群益金鼎-松山,2023-07-26,9103
3483,力致,10,1,9,群益金鼎-松山,2023-07-26,9103
3583,辛耘,11,2,9,群益金鼎-松山,2023-07-26,9103
4162,智擎,9,0,9,群益金鼎-松山,2023-07-26,9103
00929,復華台灣科技優息,8,0,8,群益金鼎-松山,2023-07-26,9103
2421,建準,17,9,8,群益金鼎-松山,2023-07-26,9103
3706,神達,59,52,7,群益金鼎-松山,2023-07-26,9103
00679B,元大美債20年,7,0,7,群益金鼎-松山,2023-07-26,9103
2313,華通,7,0,7,群益金鼎-松山,2023-07-26,9103
2399,映泰,9,2,7,群益金鼎-松山,2023-07-26,9103
3663,鑫科,7,0,7,群益金鼎-松山,2023-07-26,9103
2603,長榮,39,32,7,群益金鼎-松山,2023-07-26,9103
2745,五福,10,4,6,群益金鼎-松山,2023-07-26,9103
00712,復華富時不動產,5,0,5,群益金鼎-松山,2023-07-26,9103
00696B,富邦美債20年,5,0,5,群益金鼎-松山,2023-07-26,9103
1101,台泥,5,0,5,群益金鼎-松山,2023-07-26,9103
1504,東元,46,41,5,群益金鼎-松山,2023-07-26,9103
1762,中化生,5,0,5,群益金鼎-松山,2023-07-26,9103
2201,裕隆,5,0,5,群益金鼎-松山,2023-07-26,9103
2211,長榮鋼,5,0,5,群益金鼎-松山,2023-07-26,9103
2465,麗臺,5,0,5,群益金鼎-松山,2023-07-26,9103
8086,宏捷科,6,1,5,群益金鼎-松山,2023-07-26,9103
3017,奇鋐,17,12,5,群益金鼎-松山,2023-07-26,9103
2409,友達,211,104,107,群益金鼎-松山,2023-07-27,9103
00665L,富邦�琤肭磪囓�2,100,0,100,群益金鼎-松山,2023-07-27,9103
3706,神達,59,2,57,群益金鼎-松山,2023-07-27,9103
1514,亞力,71,20,51,群益金鼎-松山,2023-07-27,9103
5410,國眾,40,0,40,群益金鼎-松山,2023-07-27,9103
4973,廣穎,36,0,36,群益金鼎-松山,2023-07-27,9103
2301,光寶科,38,7,31,群益金鼎-松山,2023-07-27,9103
8358,金居,23,1,22,群益金鼎-松山,2023-07-27,9103
8390,金益鼎,24,2,22,群益金鼎-松山,2023-07-27,9103
1513,中興電,23,2,21,群益金鼎-松山,2023-07-27,9103
00885,富邦越南,20,0,20,群益金鼎-松山,2023-07-27,9103
1503,士電,51,31,20,群益金鼎-松山,2023-07-27,9103
3044,健鼎,40,20,20,群益金鼎-松山,2023-07-27,9103
1529,樂事綠能,20,1,19,群益金鼎-松山,2023-07-27,9103
6104,創惟,20,2,18,群益金鼎-松山,2023-07-27,9103
3013,晟銘電,22,6,16,群益金鼎-松山,2023-07-27,9103
1618,合機,15,0,15,群益金鼎-松山,2023-07-27,9103
2353,宏��,15,1,14,群益金鼎-松山,2023-07-27,9103
2881,富邦金,15,3,12,群益金鼎-松山,2023-07-27,9103
00679B,元大美債20年,11,0,11,群益金鼎-松山,2023-07-27,9103
2357,華碩,11,0,11,群益金鼎-松山,2023-07-27,9103
00696B,富邦美債20年,10,0,10,群益金鼎-松山,2023-07-27,9103
1905,華紙,20,10,10,群益金鼎-松山,2023-07-27,9103
2408,南亞科,10,0,10,群益金鼎-松山,2023-07-27,9103
2722,夏都,10,0,10,群益金鼎-松山,2023-07-27,9103
2743,山富,20,10,10,群益金鼎-松山,2023-07-27,9103
3078,僑威,11,1,10,群益金鼎-松山,2023-07-27,9103
5425,台半,10,0,10,群益金鼎-松山,2023-07-27,9103
6125,廣運,18,8,10,群益金鼎-松山,2023-07-27,9103
6112,邁達特,15,5,10,群益金鼎-松山,2023-07-27,9103
5351,鈺創,10,0,10,群益金鼎-松山,2023-07-27,9103
2206,三陽工業,11,2,9,群益金鼎-松山,2023-07-27,9103
2317,鴻海,11,2,9,群益金鼎-松山,2023-07-27,9103
1903,士紙,10,2,8,群益金鼎-松山,2023-07-27,9103
00752,中信中國50,7,0,7,群益金鼎-松山,2023-07-27,9103
1710,東聯,7,0,7,群益金鼎-松山,2023-07-27,9103
2887,台新金,7,0,7,群益金鼎-松山,2023-07-27,9103
3128,昇銳,7,0,7,群益金鼎-松山,2023-07-27,9103
3483,力致,17,10,7,群益金鼎-松山,2023-07-27,9103
8050,廣積,7,0,7,群益金鼎-松山,2023-07-27,9103
2453,凌群,8,2,6,群益金鼎-松山,2023-07-27,9103
3260,威剛,9,3,6,群益金鼎-松山,2023-07-27,9103
8234,新漢,8,2,6,群益金鼎-松山,2023-07-27,9103
1605,華新,10,5,5,群益金鼎-松山,2023-07-27,9103
00720B,元大投資級公司債,5,0,5,群益金鼎-松山,2023-07-27,9103
00892,富邦台灣半導體,5,0,5,群益金鼎-松山,2023-07-27,9103
00661,元大日經225,5,0,5,群益金鼎-松山,2023-07-27,9103
00632R,元大台灣50反1,5,0,5,群益金鼎-松山,2023-07-27,9103
2312,金寶,10,5,5,群益金鼎-松山,2023-07-27,9103
3356,奇偶,9,4,5,群益金鼎-松山,2023-07-27,9103
00680L,元大美債20正2,56,0,56,群益金鼎-松山,2023-07-28,9103
2913,農林,106,59,47,群益金鼎-松山,2023-07-28,9103
00688L,國泰20年美債正2,45,0,45,群益金鼎-松山,2023-07-28,9103
2329,華泰,71,35,36,群益金鼎-松山,2023-07-28,9103
3032,偉訓,32,0,32,群益金鼎-松山,2023-07-28,9103
2405,輔信,30,1,29,群益金鼎-松山,2023-07-28,9103
6188,廣明,31,6,25,群益金鼎-松山,2023-07-28,9103
1905,華紙,308,285,23,群益金鼎-松山,2023-07-28,9103
00679B,元大美債20年,22,0,22,群益金鼎-松山,2023-07-28,9103
00885,富邦越南,26,4,22,群益金鼎-松山,2023-07-28,9103
3338,泰碩,22,0,22,群益金鼎-松山,2023-07-28,9103
1314,中石化,20,0,20,群益金鼎-松山,2023-07-28,9103
3014,聯陽,18,1,17,群益金鼎-松山,2023-07-28,9103
8358,金居,45,29,16,群益金鼎-松山,2023-07-28,9103
2409,友達,221,205,16,群益金鼎-松山,2023-07-28,9103
2745,五福,15,0,15,群益金鼎-松山,2023-07-28,9103
2368,金像電,15,1,14,群益金鼎-松山,2023-07-28,9103
6125,廣運,36,22,14,群益金鼎-松山,2023-07-28,9103
3231,緯創,73,59,14,群益金鼎-松山,2023-07-28,9103
6139,亞翔,13,0,13,群益金鼎-松山,2023-07-28,9103
6112,邁達特,13,0,13,群益金鼎-松山,2023-07-28,9103
3055,蔚華科,11,0,11,群益金鼎-松山,2023-07-28,9103
3706,神達,13,2,11,群益金鼎-松山,2023-07-28,9103
1519,華城,20,10,10,群益金鼎-松山,2023-07-28,9103
00696B,富邦美債20年,10,0,10,群益金鼎-松山,2023-07-28,9103
2734,易飛網,20,10,10,群益金鼎-松山,2023-07-28,9103
4961,天鈺,15,5,10,群益金鼎-松山,2023-07-28,9103
8084,巨虹,10,0,10,群益金鼎-松山,2023-07-28,9103
9945,潤泰新,10,0,10,群益金鼎-松山,2023-07-28,9103
2330,台積電,8,0,8,群益金鼎-松山,2023-07-28,9103
2357,華碩,16,9,7,群益金鼎-松山,2023-07-28,9103
6216,居易,7,0,7,群益金鼎-松山,2023-07-28,9103
6235,華孚,9,2,7,群益金鼎-松山,2023-07-28,9103
2344,華邦電,20,13,7,群益金鼎-松山,2023-07-28,9103
00687B,國泰20年美債,6,0,6,群益金鼎-松山,2023-07-28,9103
2609,陽明,6,0,6,群益金鼎-松山,2023-07-28,9103
3017,奇鋐,17,11,6,群益金鼎-松山,2023-07-28,9103
5289,宜鼎,6,0,6,群益金鼎-松山,2023-07-28,9103
6560,欣普羅,6,0,6,群益金鼎-松山,2023-07-28,9103
2323,中環,5,0,5,群益金鼎-松山,2023-07-28,9103
3558,神準,6,1,5,群益金鼎-松山,2023-07-28,9103
00632R,元大台灣50反1,5,0,5,群益金鼎-松山,2023-07-28,9103
1319,東陽,6,1,5,群益金鼎-松山,2023-07-28,9103
2303,聯電,6,1,5,群益金鼎-松山,2023-07-28,9103
2316,楠梓電,6,1,5,群益金鼎-松山,2023-07-28,9103
2637,慧洋-KY,5,0,5,群益金鼎-松山,2023-07-28,9103
2888,新光金,6,1,5,群益金鼎-松山,2023-07-28,9103
3059,華晶科,5,0,5,群益金鼎-松山,2023-07-28,9103
4931,新盛力,5,0,5,群益金鼎-松山,2023-07-28,9103
6548,長科*,5,0,5,群益金鼎-松山,2023-07-28,9103
3481,群創,200,14,186,群益金鼎-松山,2023-07-31,9103
2356,英業達,224,111,113,群益金鼎-松山,2023-07-31,9103
6412,群電,60,0,60,群益金鼎-松山,2023-07-31,9103
6282,康舒,107,54,53,群益金鼎-松山,2023-07-31,9103
6443,元晶,50,2,48,群益金鼎-松山,2023-07-31,9103
00878,國泰永續高股息,42,4,38,群益金鼎-松山,2023-07-31,9103
3088,艾訊,30,0,30,群益金鼎-松山,2023-07-31,9103
3078,僑威,27,0,27,群益金鼎-松山,2023-07-31,9103
4908,前鼎,27,1,26,群益金鼎-松山,2023-07-31,9103
4569,六方科-KY,25,0,25,群益金鼎-松山,2023-07-31,9103
6274,台燿,53,29,24,群益金鼎-松山,2023-07-31,9103
3231,緯創,55,32,23,群益金鼎-松山,2023-07-31,9103
2498,宏達電,20,0,20,群益金鼎-松山,2023-07-31,9103
3025,星通,30,10,20,群益金鼎-松山,2023-07-31,9103
3105,穩懋,17,1,16,群益金鼎-松山,2023-07-31,9103
6125,廣運,40,24,16,群益金鼎-松山,2023-07-31,9103
2344,華邦電,30,14,16,群益金鼎-松山,2023-07-31,9103
2383,台光電,15,0,15,群益金鼎-松山,2023-07-31,9103
00687B,國泰20年美債,14,0,14,群益金鼎-松山,2023-07-31,9103
3704,合勤控,24,10,14,群益金鼎-松山,2023-07-31,9103
4919,新唐,13,1,12,群益金鼎-松山,2023-07-31,9103
2002,中鋼,11,0,11,群益金鼎-松山,2023-07-31,9103
3260,威剛,12,1,11,群益金鼎-松山,2023-07-31,9103
6270,倍微,13,2,11,群益金鼎-松山,2023-07-31,9103
3374,精材,10,0,10,群益金鼎-松山,2023-07-31,9103
1218,泰山,10,0,10,群益金鼎-松山,2023-07-31,9103
3027,盛達,10,0,10,群益金鼎-松山,2023-07-31,9103
6235,華孚,14,5,9,群益金鼎-松山,2023-07-31,9103
3324,雙鴻,16,7,9,群益金鼎-松山,2023-07-31,9103
2388,威盛,8,0,8,群益金鼎-松山,2023-07-31,9103
2405,輔信,8,0,8,群益金鼎-松山,2023-07-31,9103
3346,麗清,9,1,8,群益金鼎-松山,2023-07-31,9103
00706L,期元大S＆P日圓正2,7,0,7,群益金鼎-松山,2023-07-31,9103
8234,新漢,7,0,7,群益金鼎-松山,2023-07-31,9103
2330,台積電,6,0,6,群益金鼎-松山,2023-07-31,9103
3023,信邦,6,0,6,群益金鼎-松山,2023-07-31,9103
3483,力致,31,25,6,群益金鼎-松山,2023-07-31,9103
4114,健喬,6,0,6,群益金鼎-松山,2023-07-31,9103
4906,正文,6,0,6,群益金鼎-松山,2023-07-31,9103
6187,萬潤,18,12,6,群益金鼎-松山,2023-07-31,9103
2382,廣達,68,62,6,群益金鼎-松山,2023-07-31,9103
1605,華新,5,0,5,群益金鼎-松山,2023-07-31,9103
2353,宏��,20,15,5,群益金鼎-松山,2023-07-31,9103
2363,矽統,5,0,5,群益金鼎-松山,2023-07-31,9103
3059,華晶科,8,3,5,群益金鼎-松山,2023-07-31,9103
3356,奇偶,9,4,5,群益金鼎-松山,2023-07-31,9103
3444,利機,5,0,5,群益金鼎-松山,2023-07-31,9103
5465,富驊,12,7,5,群益金鼎-松山,2023-07-31,9103
6148,驊宏資,12,7,5,群益金鼎-松山,2023-07-31,9103
6491,晶碩,5,0,5,群益金鼎-松山,2023-07-31,9103
00885,富邦越南,43,0,43,群益金鼎-松山,2023-08-01,9103
3706,神達,211,168,43,群益金鼎-松山,2023-08-01,9103
3013,晟銘電,46,5,41,群益金鼎-松山,2023-08-01,9103
1218,泰山,34,0,34,群益金鼎-松山,2023-08-01,9103
2301,光寶科,75,42,33,群益金鼎-松山,2023-08-01,9103
2637,慧洋-KY,32,0,32,群益金鼎-松山,2023-08-01,9103
1591,駿吉-KY,30,0,30,群益金鼎-松山,2023-08-01,9103
00673R,期元大S＆P原油反1,30,0,30,群益金鼎-松山,2023-08-01,9103
1108,幸福,28,0,28,群益金鼎-松山,2023-08-01,9103
1210,大成,27,1,26,群益金鼎-松山,2023-08-01,9103
00706L,期元大S＆P日圓正2,26,0,26,群益金鼎-松山,2023-08-01,9103
00632R,元大台灣50反1,25,0,25,群益金鼎-松山,2023-08-01,9103
5381,合正,25,0,25,群益金鼎-松山,2023-08-01,9103
1560,中砂,20,0,20,群益金鼎-松山,2023-08-01,9103
2485,兆赫,20,0,20,群益金鼎-松山,2023-08-01,9103
3011,今皓,18,0,18,群益金鼎-松山,2023-08-01,9103
2382,廣達,54,37,17,群益金鼎-松山,2023-08-01,9103
2388,威盛,44,27,17,群益金鼎-松山,2023-08-01,9103
3346,麗清,17,0,17,群益金鼎-松山,2023-08-01,9103
8084,巨虹,15,0,15,群益金鼎-松山,2023-08-01,9103
5864,致和證,19,5,14,群益金鼎-松山,2023-08-01,9103
3231,緯創,146,133,13,群益金鼎-松山,2023-08-01,9103
2498,宏達電,12,0,12,群益金鼎-松山,2023-08-01,9103
2329,華泰,124,113,11,群益金鼎-松山,2023-08-01,9103
5299,杰力,11,0,11,群益金鼎-松山,2023-08-01,9103
6218,豪勉,10,0,10,群益金鼎-松山,2023-08-01,9103
00671R,富邦NASDAQ反1,10,0,10,群益金鼎-松山,2023-08-01,9103
1815,富喬,10,0,10,群益金鼎-松山,2023-08-01,9103
2014,中鴻,10,0,10,群益金鼎-松山,2023-08-01,9103
3078,僑威,11,1,10,群益金鼎-松山,2023-08-01,9103
6160,欣技,10,0,10,群益金鼎-松山,2023-08-01,9103
8410,森田,10,0,10,群益金鼎-松山,2023-08-01,9103
2344,華邦電,9,0,9,群益金鼎-松山,2023-08-01,9103
8210,勤誠,20,11,9,群益金鼎-松山,2023-08-01,9103
3363,上詮,9,1,8,群益金鼎-松山,2023-08-01,9103
3558,神準,10,2,8,群益金鼎-松山,2023-08-01,9103
00878,國泰永續高股息,10,3,7,群益金鼎-松山,2023-08-01,9103
1605,華新,7,0,7,群益金鼎-松山,2023-08-01,9103
6150,撼訊,7,0,7,群益金鼎-松山,2023-08-01,9103
8016,矽創,7,0,7,群益金鼎-松山,2023-08-01,9103
00637L,元大滬深300正2,11,5,6,群益金鼎-松山,2023-08-01,9103
2736,富野,20,14,6,群益金鼎-松山,2023-08-01,9103
3023,信邦,6,0,6,群益金鼎-松山,2023-08-01,9103
3228,金麗科,6,0,6,群益金鼎-松山,2023-08-01,9103
3483,力致,6,0,6,群益金鼎-松山,2023-08-01,9103
6122,擎邦,12,6,6,群益金鼎-松山,2023-08-01,9103
6188,廣明,47,41,6,群益金鼎-松山,2023-08-01,9103
8040,九暘,6,0,6,群益金鼎-松山,2023-08-01,9103
2352,佳世達,5,0,5,群益金鼎-松山,2023-08-01,9103
1514,亞力,5,0,5,群益金鼎-松山,2023-08-01,9103
5608,四維航,220,0,220,群益金鼎-松山,2023-08-02,9103
3481,群創,404,209,195,群益金鼎-松山,2023-08-02,9103
3033,威健,90,0,90,群益金鼎-松山,2023-08-02,9103
1905,華紙,61,10,51,群益金鼎-松山,2023-08-02,9103
00680L,元大美債20正2,38,0,38,群益金鼎-松山,2023-08-02,9103
6215,和椿,36,0,36,群益金鼎-松山,2023-08-02,9103
1605,華新,59,28,31,群益金鼎-松山,2023-08-02,9103
00878,國泰永續高股息,128,101,27,群益金鼎-松山,2023-08-02,9103
00715L,期街口布蘭特正2,25,0,25,群益金鼎-松山,2023-08-02,9103
00885,富邦越南,22,0,22,群益金鼎-松山,2023-08-02,9103
2449,京元電子,22,0,22,群益金鼎-松山,2023-08-02,9103
6150,撼訊,21,0,21,群益金鼎-松山,2023-08-02,9103
6139,亞翔,20,0,20,群益金鼎-松山,2023-08-02,9103
2888,新光金,20,0,20,群益金鼎-松山,2023-08-02,9103
00687B,國泰20年美債,19,0,19,群益金鼎-松山,2023-08-02,9103
0056,元大高股息,17,1,16,群益金鼎-松山,2023-08-02,9103
5371,中光電,16,0,16,群益金鼎-松山,2023-08-02,9103
6412,群電,16,0,16,群益金鼎-松山,2023-08-02,9103
00706L,期元大S＆P日圓正2,15,0,15,群益金鼎-松山,2023-08-02,9103
3035,智原,14,0,14,群益金鼎-松山,2023-08-02,9103
3044,健鼎,16,2,14,群益金鼎-松山,2023-08-02,9103
3037,欣興,15,2,13,群益金鼎-松山,2023-08-02,9103
2801,彰銀,13,0,13,群益金鼎-松山,2023-08-02,9103
3022,威強電,13,0,13,群益金鼎-松山,2023-08-02,9103
2023,燁輝,12,0,12,群益金鼎-松山,2023-08-02,9103
6125,廣運,21,9,12,群益金鼎-松山,2023-08-02,9103
2206,三陽工業,13,2,11,群益金鼎-松山,2023-08-02,9103
3338,泰碩,11,0,11,群益金鼎-松山,2023-08-02,9103
00751B,元大AAA至A公司債,10,0,10,群益金鼎-松山,2023-08-02,9103
00679B,元大美債20年,10,0,10,群益金鼎-松山,2023-08-02,9103
2010,春源,10,0,10,群益金鼎-松山,2023-08-02,9103
3055,蔚華科,10,0,10,群益金鼎-松山,2023-08-02,9103
3264,欣銓,12,2,10,群益金鼎-松山,2023-08-02,9103
5876,上海商銀,10,0,10,群益金鼎-松山,2023-08-02,9103
6112,邁達特,20,10,10,群益金鼎-松山,2023-08-02,9103
9958,世紀鋼,20,10,10,群益金鼎-松山,2023-08-02,9103
3583,辛耘,20,12,8,群益金鼎-松山,2023-08-02,9103
2882,國泰金,11,4,7,群益金鼎-松山,2023-08-02,9103
1513,中興電,7,0,7,群益金鼎-松山,2023-08-02,9103
2883,凱基金,7,0,7,群益金鼎-松山,2023-08-02,9103
6625,必應,7,0,7,群益金鼎-松山,2023-08-02,9103
8071,能率網通,7,0,7,群益金鼎-松山,2023-08-02,9103
3017,奇鋐,20,14,6,群益金鼎-松山,2023-08-02,9103
2067,嘉鋼,6,0,6,群益金鼎-松山,2023-08-02,9103
2323,中環,6,0,6,群益金鼎-松山,2023-08-02,9103
2884,玉山金,7,1,6,群益金鼎-松山,2023-08-02,9103
5425,台半,9,3,6,群益金鼎-松山,2023-08-02,9103
6202,盛群,6,0,6,群益金鼎-松山,2023-08-02,9103
4746,台耀,8,2,6,群益金鼎-松山,2023-08-02,9103
2382,廣達,74,69,5,群益金鼎-松山,2023-08-02,9103
2409,友達,351,0,351,群益金鼎-松山,2023-08-04,9103
00878,國泰永續高股息,313,212,101,群益金鼎-松山,2023-08-04,9103
2913,農林,124,65,59,群益金鼎-松山,2023-08-04,9103
5608,四維航,55,0,55,群益金鼎-松山,2023-08-04,9103
00885,富邦越南,45,0,45,群益金鼎-松山,2023-08-04,9103
2637,慧洋-KY,41,0,41,群益金鼎-松山,2023-08-04,9103
2356,英業達,84,52,32,群益金鼎-松山,2023-08-04,9103
00923,群益台ESG低碳50,30,0,30,群益金鼎-松山,2023-08-04,9103
2630,亞航,30,0,30,群益金鼎-松山,2023-08-04,9103
00715L,期街口布蘭特正2,30,2,28,群益金鼎-松山,2023-08-04,9103
00687B,國泰20年美債,27,0,27,群益金鼎-松山,2023-08-04,9103
00773B,中信優先金融債,20,0,20,群益金鼎-松山,2023-08-04,9103
2316,楠梓電,20,0,20,群益金鼎-松山,2023-08-04,9103
00751B,元大AAA至A公司債,18,0,18,群益金鼎-松山,2023-08-04,9103
8084,巨虹,18,0,18,群益金鼎-松山,2023-08-04,9103
00679B,元大美債20年,17,1,16,群益金鼎-松山,2023-08-04,9103
2344,華邦電,15,0,15,群益金鼎-松山,2023-08-04,9103
00688L,國泰20年美債正2,15,0,15,群益金鼎-松山,2023-08-04,9103
6125,廣運,31,16,15,群益金鼎-松山,2023-08-04,9103
6214,精誠,15,0,15,群益金鼎-松山,2023-08-04,9103
1503,士電,20,7,13,群益金鼎-松山,2023-08-04,9103
2329,華泰,48,35,13,群益金鼎-松山,2023-08-04,9103
6285,啟��,14,1,13,群益金鼎-松山,2023-08-04,9103
2328,廣宇,11,0,11,群益金鼎-松山,2023-08-04,9103
2383,台光電,17,6,11,群益金鼎-松山,2023-08-04,9103
00706L,期元大S＆P日圓正2,10,0,10,群益金鼎-松山,2023-08-04,9103
00753L,中信中國50正2,10,0,10,群益金鼎-松山,2023-08-04,9103
2009,第一銅,10,0,10,群益金鼎-松山,2023-08-04,9103
3362,先進光,30,20,10,群益金鼎-松山,2023-08-04,9103
2301,光寶科,19,9,10,群益金鼎-松山,2023-08-04,9103
00680L,元大美債20正2,9,0,9,群益金鼎-松山,2023-08-04,9103
00696B,富邦美債20年,9,0,9,群益金鼎-松山,2023-08-04,9103
00720B,元大投資級公司債,9,0,9,群益金鼎-松山,2023-08-04,9103
8210,勤誠,9,0,9,群益金鼎-松山,2023-08-04,9103
6282,康舒,10,2,8,群益金鼎-松山,2023-08-04,9103
4533,協易機,8,0,8,群益金鼎-松山,2023-08-04,9103
6116,彩晶,10,2,8,群益金鼎-松山,2023-08-04,9103
1727,中華化,7,0,7,群益金鼎-松山,2023-08-04,9103
1504,東元,7,0,7,群益金鼎-松山,2023-08-04,9103
2457,飛宏,9,2,7,群益金鼎-松山,2023-08-04,9103
5371,中光電,7,0,7,群益金鼎-松山,2023-08-04,9103
00795B,中信美國公債20年,6,0,6,群益金鼎-松山,2023-08-04,9103
2610,華航,6,0,6,群益金鼎-松山,2023-08-04,9103
3131,弘塑,17,11,6,群益金鼎-松山,2023-08-04,9103
3558,神準,9,3,6,群益金鼎-松山,2023-08-04,9103
8215,明基材,6,0,6,群益金鼎-松山,2023-08-04,9103
2317,鴻海,11,5,6,群益金鼎-松山,2023-08-04,9103
00782B,國泰A級公用債,5,0,5,群益金鼎-松山,2023-08-04,9103
1319,東陽,10,5,5,群益金鼎-松山,2023-08-04,9103
1721,三晃,5,0,5,群益金鼎-松山,2023-08-04,9103
1217,愛之味,733,1,732,群益金鼎-松山,2023-08-07,9103
2913,農林,593,0,593,群益金鼎-松山,2023-08-07,9103
00878,國泰永續高股息,323,105,218,群益金鼎-松山,2023-08-07,9103
2312,金寶,161,0,161,群益金鼎-松山,2023-08-07,9103
2382,廣達,151,30,121,群益金鼎-松山,2023-08-07,9103
2009,第一銅,60,5,55,群益金鼎-松山,2023-08-07,9103
00687B,國泰20年美債,55,1,54,群益金鼎-松山,2023-08-07,9103
2329,華泰,63,16,47,群益金鼎-松山,2023-08-07,9103
3004,豐達科,24,0,24,群益金鼎-松山,2023-08-07,9103
2498,宏達電,21,0,21,群益金鼎-松山,2023-08-07,9103
1802,台玻,20,0,20,群益金鼎-松山,2023-08-07,9103
2377,微星,20,0,20,群益金鼎-松山,2023-08-07,9103
2388,威盛,54,34,20,群益金鼎-松山,2023-08-07,9103
3338,泰碩,20,0,20,群益金鼎-松山,2023-08-07,9103
3483,力致,25,5,20,群益金鼎-松山,2023-08-07,9103
3706,神達,140,124,16,群益金鼎-松山,2023-08-07,9103
6125,廣運,46,33,13,群益金鼎-松山,2023-08-07,9103
3013,晟銘電,35,24,11,群益金鼎-松山,2023-08-07,9103
3363,上詮,41,30,11,群益金鼎-松山,2023-08-07,9103
1609,大亞,10,0,10,群益金鼎-松山,2023-08-07,9103
00680L,元大美債20正2,10,0,10,群益金鼎-松山,2023-08-07,9103
6257,矽格,10,0,10,群益金鼎-松山,2023-08-07,9103
9958,世紀鋼,10,0,10,群益金鼎-松山,2023-08-07,9103
6187,萬潤,11,2,9,群益金鼎-松山,2023-08-07,9103
6274,台燿,34,25,9,群益金鼎-松山,2023-08-07,9103
8210,勤誠,24,15,9,群益金鼎-松山,2023-08-07,9103
3558,神準,15,6,9,群益金鼎-松山,2023-08-07,9103
3044,健鼎,35,27,8,群益金鼎-松山,2023-08-07,9103
6285,啟��,7,0,7,群益金鼎-松山,2023-08-07,9103
3515,華擎,11,5,6,群益金鼎-松山,2023-08-07,9103
4538,大詠城,6,0,6,群益金鼎-松山,2023-08-07,9103
00632R,元大台灣50反1,5,0,5,群益金鼎-松山,2023-08-07,9103
00696B,富邦美債20年,5,0,5,群益金鼎-松山,2023-08-07,9103
00882,中信中國高股息,5,0,5,群益金鼎-松山,2023-08-07,9103
00929,復華台灣科技優息,5,0,5,群益金鼎-松山,2023-08-07,9103
1560,中砂,5,0,5,群益金鼎-松山,2023-08-07,9103
3017,奇鋐,19,14,5,群益金鼎-松山,2023-08-07,9103
6016,康和證,5,0,5,群益金鼎-松山,2023-08-07,9103
6112,邁達特,7,2,5,群益金鼎-松山,2023-08-07,9103
6150,撼訊,5,0,5,群益金鼎-松山,2023-08-07,9103
6244,茂迪,5,0,5,群益金鼎-松山,2023-08-07,9103
6531,愛普*,5,0,5,群益金鼎-松山,2023-08-07,9103
1720,生達,4,0,4,群益金鼎-松山,2023-08-07,9103
2317,鴻海,4,0,4,群益金鼎-松山,2023-08-07,9103
2367,燿華,4,0,4,群益金鼎-松山,2023-08-07,9103
8046,南電,8,4,4,群益金鼎-松山,2023-08-07,9103
1525,江申,3,0,3,群益金鼎-松山,2023-08-07,9103
1304,台聚,3,0,3,群益金鼎-松山,2023-08-07,9103
2206,三陽工業,4,1,3,群益金鼎-松山,2023-08-07,9103
2610,華航,6,3,3,群益金鼎-松山,2023-08-07,9103
2382,廣達,291,110,181,群益金鼎-松山,2023-08-08,9103
00900,富邦特選高股息30,125,0,125,群益金鼎-松山,2023-08-08,9103
2356,英業達,208,161,47,群益金鼎-松山,2023-08-08,9103
00919,群益台灣精選高息,49,10,39,群益金鼎-松山,2023-08-08,9103
5469,瀚宇博,35,0,35,群益金鼎-松山,2023-08-08,9103
2301,光寶科,105,78,27,群益金鼎-松山,2023-08-08,9103
6282,康舒,30,3,27,群益金鼎-松山,2023-08-08,9103
6139,亞翔,24,0,24,群益金鼎-松山,2023-08-08,9103
1815,富喬,21,0,21,群益金鼎-松山,2023-08-08,9103
8084,巨虹,20,0,20,群益金鼎-松山,2023-08-08,9103
2368,金像電,21,2,19,群益金鼎-松山,2023-08-08,9103
2892,第一金,21,3,18,群益金鼎-松山,2023-08-08,9103
5284,jpp-KY,18,0,18,群益金鼎-松山,2023-08-08,9103
1305,華夏,13,0,13,群益金鼎-松山,2023-08-08,9103
2303,聯電,13,0,13,群益金鼎-松山,2023-08-08,9103
4174,浩鼎,12,0,12,群益金鼎-松山,2023-08-08,9103
1616,億泰,10,0,10,群益金鼎-松山,2023-08-08,9103
00885,富邦越南,10,0,10,群益金鼎-松山,2023-08-08,9103
00671R,富邦NASDAQ反1,10,0,10,群益金鼎-松山,2023-08-08,9103
2634,漢翔,12,2,10,群益金鼎-松山,2023-08-08,9103
3014,聯陽,10,0,10,群益金鼎-松山,2023-08-08,9103
5864,致和證,9,0,9,群益金鼎-松山,2023-08-08,9103
3032,偉訓,8,0,8,群益金鼎-松山,2023-08-08,9103
4551,智伸科,10,2,8,群益金鼎-松山,2023-08-08,9103
2367,燿華,8,1,7,群益金鼎-松山,2023-08-08,9103
3581,博磊,7,0,7,群益金鼎-松山,2023-08-08,9103
3035,智原,32,25,7,群益金鼎-松山,2023-08-08,9103
1326,台化,6,0,6,群益金鼎-松山,2023-08-08,9103
2317,鴻海,6,0,6,群益金鼎-松山,2023-08-08,9103
2344,華邦電,6,0,6,群益金鼎-松山,2023-08-08,9103
2357,華碩,6,0,6,群益金鼎-松山,2023-08-08,9103
00931B,統一美債20年,5,0,5,群益金鼎-松山,2023-08-08,9103
2352,佳世達,13,8,5,群益金鼎-松山,2023-08-08,9103
2801,彰銀,5,0,5,群益金鼎-松山,2023-08-08,9103
3515,華擎,10,5,5,群益金鼎-松山,2023-08-08,9103
6274,台燿,18,13,5,群益金鼎-松山,2023-08-08,9103
6531,愛普*,10,5,5,群益金鼎-松山,2023-08-08,9103
9958,世紀鋼,15,10,5,群益金鼎-松山,2023-08-08,9103
00687B,國泰20年美債,4,0,4,群益金鼎-松山,2023-08-08,9103
00929,復華台灣科技優息,4,0,4,群益金鼎-松山,2023-08-08,9103
2349,錸德,4,0,4,群益金鼎-松山,2023-08-08,9103
3402,漢科,4,0,4,群益金鼎-松山,2023-08-08,9103
4934,太極,5,1,4,群益金鼎-松山,2023-08-08,9103
5225,東科-KY,4,0,4,群益金鼎-松山,2023-08-08,9103
6579,研揚,8,4,4,群益金鼎-松山,2023-08-08,9103
6584,南俊國際,4,0,4,群益金鼎-松山,2023-08-08,9103
1519,華城,10,7,3,群益金鼎-松山,2023-08-08,9103
2206,三陽工業,3,0,3,群益金鼎-松山,2023-08-08,9103
2323,中環,3,0,3,群益金鼎-松山,2023-08-08,9103
2363,矽統,18,15,3,群益金鼎-松山,2023-08-08,9103
3481,群創,200,0,200,群益金鼎-松山,2023-08-09,9103
2888,新光金,200,0,200,群益金鼎-松山,2023-08-09,9103
2891,中信金,101,0,101,群益金鼎-松山,2023-08-09,9103
6125,廣運,50,0,50,群益金鼎-松山,2023-08-09,9103
2363,矽統,98,58,40,群益金鼎-松山,2023-08-09,9103
6147,頎邦,34,0,34,群益金鼎-松山,2023-08-09,9103
00900,富邦特選高股息30,29,0,29,群益金鼎-松山,2023-08-09,9103
00665L,富邦�琤肭磪囓�2,15,0,15,群益金鼎-松山,2023-08-09,9103
4974,亞泰,13,0,13,群益金鼎-松山,2023-08-09,9103
1795,美時,12,0,12,群益金鼎-松山,2023-08-09,9103
3454,晶睿,12,0,12,群益金鼎-松山,2023-08-09,9103
1513,中興電,21,10,11,群益金鼎-松山,2023-08-09,9103
2009,第一銅,10,0,10,群益金鼎-松山,2023-08-09,9103
1722,台肥,10,0,10,群益金鼎-松山,2023-08-09,9103
00680L,元大美債20正2,10,0,10,群益金鼎-松山,2023-08-09,9103
2352,佳世達,13,3,10,群益金鼎-松山,2023-08-09,9103
2388,威盛,11,1,10,群益金鼎-松山,2023-08-09,9103
2498,宏達電,10,0,10,群益金鼎-松山,2023-08-09,9103
3356,奇偶,10,0,10,群益金鼎-松山,2023-08-09,9103
2323,中環,8,0,8,群益金鼎-松山,2023-08-09,9103
6133,金橋,8,0,8,群益金鼎-松山,2023-08-09,9103
3362,先進光,7,0,7,群益金鼎-松山,2023-08-09,9103
6016,康和證,11,4,7,群益金鼎-松山,2023-08-09,9103
4439,冠星-KY,6,0,6,群益金鼎-松山,2023-08-09,9103
3548,兆利,6,0,6,群益金鼎-松山,2023-08-09,9103
6182,合晶,6,0,6,群益金鼎-松山,2023-08-09,9103
1514,亞力,5,0,5,群益金鼎-松山,2023-08-09,9103
2303,聯電,5,0,5,群益金鼎-松山,2023-08-09,9103
2516,新建,5,0,5,群益金鼎-松山,2023-08-09,9103
3014,聯陽,5,0,5,群益金鼎-松山,2023-08-09,9103
6213,聯茂,5,0,5,群益金鼎-松山,2023-08-09,9103
8086,宏捷科,6,1,5,群益金鼎-松山,2023-08-09,9103
8930,青鋼,7,2,5,群益金鼎-松山,2023-08-09,9103
1784,訊聯,7,3,4,群益金鼎-松山,2023-08-09,9103
5425,台半,4,0,4,群益金鼎-松山,2023-08-09,9103
6112,邁達特,4,0,4,群益金鼎-松山,2023-08-09,9103
6285,啟��,4,0,4,群益金鼎-松山,2023-08-09,9103
6417,韋僑,4,0,4,群益金鼎-松山,2023-08-09,9103
1504,東元,6,3,3,群益金鼎-松山,2023-08-09,9103
3034,聯詠,3,0,3,群益金鼎-松山,2023-08-09,9103
3042,晶技,3,0,3,群益金鼎-松山,2023-08-09,9103
3694,海華,3,0,3,群益金鼎-松山,2023-08-09,9103
6150,撼訊,3,0,3,群益金鼎-松山,2023-08-09,9103
6605,帝寶,3,0,3,群益金鼎-松山,2023-08-09,9103
3131,弘塑,3,0,3,群益金鼎-松山,2023-08-09,9103
1605,華新,3,0,3,群益金鼎-松山,2023-08-09,9103
2637,慧洋-KY,2,0,2,群益金鼎-松山,2023-08-09,9103
0050,元大台灣50,2,0,2,群益金鼎-松山,2023-08-09,9103
1710,東聯,2,0,2,群益金鼎-松山,2023-08-09,9103
00878,國泰永續高股息,2,0,2,群益金鼎-松山,2023-08-09,9103
2382,廣達,236,46,190,群益金鼎-松山,2023-08-10,9103
00900,富邦特選高股息30,36,0,36,群益金鼎-松山,2023-08-10,9103
00923,群益台ESG低碳50,25,0,25,群益金鼎-松山,2023-08-10,9103
3545,敦泰,25,0,25,群益金鼎-松山,2023-08-10,9103
8084,巨虹,25,0,25,群益金鼎-松山,2023-08-10,9103
2301,光寶科,61,40,21,群益金鼎-松山,2023-08-10,9103
3694,海華,20,0,20,群益金鼎-松山,2023-08-10,9103
00878,國泰永續高股息,17,0,17,群益金鼎-松山,2023-08-10,9103
3483,力致,69,52,17,群益金鼎-松山,2023-08-10,9103
3346,麗清,15,0,15,群益金鼎-松山,2023-08-10,9103
2376,技嘉,20,6,14,群益金鼎-松山,2023-08-10,9103
3481,群創,14,0,14,群益金鼎-松山,2023-08-10,9103
00919,群益台灣精選高息,11,0,11,群益金鼎-松山,2023-08-10,9103
2383,台光電,26,15,11,群益金鼎-松山,2023-08-10,9103
2406,國碩,11,0,11,群益金鼎-松山,2023-08-10,9103
3591,艾笛森,11,0,11,群益金鼎-松山,2023-08-10,9103
3044,健鼎,12,2,10,群益金鼎-松山,2023-08-10,9103
00715L,期街口布蘭特正2,10,0,10,群益金鼎-松山,2023-08-10,9103
1504,東元,10,0,10,群益金鼎-松山,2023-08-10,9103
1608,華榮,10,0,10,群益金鼎-松山,2023-08-10,9103
1304,台聚,10,0,10,群益金鼎-松山,2023-08-10,9103
00931B,統一美債20年,10,0,10,群益金鼎-松山,2023-08-10,9103
3022,威強電,10,0,10,群益金鼎-松山,2023-08-10,9103
6282,康舒,13,4,9,群益金鼎-松山,2023-08-10,9103
8155,博智,9,0,9,群益金鼎-松山,2023-08-10,9103
2329,華泰,8,0,8,群益金鼎-松山,2023-08-10,9103
8016,矽創,8,0,8,群益金鼎-松山,2023-08-10,9103
2409,友達,207,200,7,群益金鼎-松山,2023-08-10,9103
3257,虹冠電,27,20,7,群益金鼎-松山,2023-08-10,9103
00679B,元大美債20年,6,0,6,群益金鼎-松山,2023-08-10,9103
6168,宏齊,6,0,6,群益金鼎-松山,2023-08-10,9103
6188,廣明,6,0,6,群益金鼎-松山,2023-08-10,9103
1815,富喬,10,4,6,群益金鼎-松山,2023-08-10,9103
0056,元大高股息,5,0,5,群益金鼎-松山,2023-08-10,9103
6239,力成,5,0,5,群益金鼎-松山,2023-08-10,9103
00751B,元大AAA至A公司債,5,0,5,群益金鼎-松山,2023-08-10,9103
2323,中環,10,5,5,群益金鼎-松山,2023-08-10,9103
2324,仁寶,5,0,5,群益金鼎-松山,2023-08-10,9103
2328,廣宇,6,1,5,群益金鼎-松山,2023-08-10,9103
2419,仲琦,11,6,5,群益金鼎-松山,2023-08-10,9103
2548,華固,5,0,5,群益金鼎-松山,2023-08-10,9103
3013,晟銘電,6,1,5,群益金鼎-松山,2023-08-10,9103
6112,邁達特,5,0,5,群益金鼎-松山,2023-08-10,9103
6150,撼訊,5,0,5,群益金鼎-松山,2023-08-10,9103
6189,豐藝,5,0,5,群益金鼎-松山,2023-08-10,9103
6548,長科*,5,0,5,群益金鼎-松山,2023-08-10,9103
6695,芯鼎,5,0,5,群益金鼎-松山,2023-08-10,9103
8076,伍豐,5,0,5,群益金鼎-松山,2023-08-10,9103
1784,訊聯,9,5,4,群益金鼎-松山,2023-08-10,9103
2250,IKKA-KY,4,0,4,群益金鼎-松山,2023-08-10,9103
3032,偉訓,114,4,110,群益金鼎-松山,2023-08-11,9103
5608,四維航,100,0,100,群益金鼎-松山,2023-08-11,9103
2731,雄獅,25,4,21,群益金鼎-松山,2023-08-11,9103
00680L,元大美債20正2,20,0,20,群益金鼎-松山,2023-08-11,9103
6125,廣運,41,21,20,群益金鼎-松山,2023-08-11,9103
2363,矽統,51,33,18,群益金鼎-松山,2023-08-11,9103
3231,緯創,98,80,18,群益金鼎-松山,2023-08-11,9103
00931B,統一美債20年,16,0,16,群益金鼎-松山,2023-08-11,9103
00929,復華台灣科技優息,16,0,16,群益金鼎-松山,2023-08-11,9103
4164,承業醫,15,0,15,群益金鼎-松山,2023-08-11,9103
2388,威盛,24,10,14,群益金鼎-松山,2023-08-11,9103
8349,�矬�,12,0,12,群益金鼎-松山,2023-08-11,9103
00706L,期元大S＆P日圓正2,11,0,11,群益金鼎-松山,2023-08-11,9103
00696B,富邦美債20年,11,0,11,群益金鼎-松山,2023-08-11,9103
3362,先進光,25,14,11,群益金鼎-松山,2023-08-11,9103
2618,長榮航,15,4,11,群益金鼎-松山,2023-08-11,9103
2009,第一銅,10,0,10,群益金鼎-松山,2023-08-11,9103
2357,華碩,15,5,10,群益金鼎-松山,2023-08-11,9103
2645,長榮航太,10,0,10,群益金鼎-松山,2023-08-11,9103
2722,夏都,10,0,10,群益金鼎-松山,2023-08-11,9103
2838,聯邦銀,10,0,10,群益金鼎-松山,2023-08-11,9103
2892,第一金,10,0,10,群益金鼎-松山,2023-08-11,9103
3694,海華,10,0,10,群益金鼎-松山,2023-08-11,9103
4934,太極,10,0,10,群益金鼎-松山,2023-08-11,9103
2421,建準,10,1,9,群益金鼎-松山,2023-08-11,9103
6223,旺矽,9,0,9,群益金鼎-松山,2023-08-11,9103
1795,美時,8,0,8,群益金鼎-松山,2023-08-11,9103
6188,廣明,12,5,7,群益金鼎-松山,2023-08-11,9103
2301,光寶科,18,12,6,群益金鼎-松山,2023-08-11,9103
4306,炎洲,6,0,6,群益金鼎-松山,2023-08-11,9103
00751B,元大AAA至A公司債,5,0,5,群益金鼎-松山,2023-08-11,9103
2323,中環,5,0,5,群益金鼎-松山,2023-08-11,9103
2356,英業達,18,13,5,群益金鼎-松山,2023-08-11,9103
2406,國碩,5,0,5,群益金鼎-松山,2023-08-11,9103
2883,凱基金,5,0,5,群益金鼎-松山,2023-08-11,9103
2888,新光金,10,5,5,群益金鼎-松山,2023-08-11,9103
3483,力致,6,1,5,群益金鼎-松山,2023-08-11,9103
4979,華星光,5,0,5,群益金鼎-松山,2023-08-11,9103
5484,慧友,5,0,5,群益金鼎-松山,2023-08-11,9103
6625,必應,5,0,5,群益金鼎-松山,2023-08-11,9103
8050,廣積,5,0,5,群益金鼎-松山,2023-08-11,9103
2486,一詮,13,9,4,群益金鼎-松山,2023-08-11,9103
3706,神達,4,0,4,群益金鼎-松山,2023-08-11,9103
6176,瑞儀,4,0,4,群益金鼎-松山,2023-08-11,9103
8040,九暘,4,0,4,群益金鼎-松山,2023-08-11,9103
6770,力積電,4,0,4,群益金鼎-松山,2023-08-11,9103
00687B,國泰20年美債,3,0,3,群益金鼎-松山,2023-08-11,9103
1605,華新,3,0,3,群益金鼎-松山,2023-08-11,9103
00720B,元大投資級公司債,3,0,3,群益金鼎-松山,2023-08-11,9103
00679B,元大美債20年,3,0,3,群益金鼎-松山,2023-08-11,9103
2618,長榮航,460,0,460,群益金鼎-松山,2023-08-14,9103
2610,華航,108,0,108,群益金鼎-松山,2023-08-14,9103
00878,國泰永續高股息,37,0,37,群益金鼎-松山,2023-08-14,9103
4533,協易機,30,0,30,群益金鼎-松山,2023-08-14,9103
00929,復華台灣科技優息,25,0,25,群益金鼎-松山,2023-08-14,9103
0056,元大高股息,25,0,25,群益金鼎-松山,2023-08-14,9103
2344,華邦電,21,0,21,群益金鼎-松山,2023-08-14,9103
8349,�矬�,21,0,21,群益金鼎-松山,2023-08-14,9103
6125,廣運,37,17,20,群益金鼎-松山,2023-08-14,9103
9941,裕融,20,0,20,群益金鼎-松山,2023-08-14,9103
8084,巨虹,20,1,19,群益金鼎-松山,2023-08-14,9103
8941,關中,18,0,18,群益金鼎-松山,2023-08-14,9103
00900,富邦特選高股息30,16,1,15,群益金鼎-松山,2023-08-14,9103
2324,仁寶,22,8,14,群益金鼎-松山,2023-08-14,9103
1909,榮成,13,0,13,群益金鼎-松山,2023-08-14,9103
2382,廣達,27,14,13,群益金鼎-松山,2023-08-14,9103
3289,宜特,12,0,12,群益金鼎-松山,2023-08-14,9103
3483,力致,63,51,12,群益金鼎-松山,2023-08-14,9103
4174,浩鼎,12,0,12,群益金鼎-松山,2023-08-14,9103
2915,潤泰全,31,20,11,群益金鼎-松山,2023-08-14,9103
3363,上詮,15,4,11,群益金鼎-松山,2023-08-14,9103
2305,全友,15,5,10,群益金鼎-松山,2023-08-14,9103
2426,鼎元,10,0,10,群益金鼎-松山,2023-08-14,9103
2838,聯邦銀,10,0,10,群益金鼎-松山,2023-08-14,9103
2887,台新金,10,0,10,群益金鼎-松山,2023-08-14,9103
3581,博磊,10,0,10,群益金鼎-松山,2023-08-14,9103
8071,能率網通,10,0,10,群益金鼎-松山,2023-08-14,9103
9945,潤泰新,10,0,10,群益金鼎-松山,2023-08-14,9103
2363,矽統,45,36,9,群益金鼎-松山,2023-08-14,9103
3022,威強電,9,0,9,群益金鼎-松山,2023-08-14,9103
3044,健鼎,10,1,9,群益金鼎-松山,2023-08-14,9103
00637L,元大滬深300正2,9,1,8,群益金鼎-松山,2023-08-14,9103
2301,光寶科,10,2,8,群益金鼎-松山,2023-08-14,9103
3545,敦泰,8,0,8,群益金鼎-松山,2023-08-14,9103
2883,凱基金,7,0,7,群益金鼎-松山,2023-08-14,9103
2409,友達,7,0,7,群益金鼎-松山,2023-08-14,9103
2801,彰銀,7,0,7,群益金鼎-松山,2023-08-14,9103
5880,合庫金,7,0,7,群益金鼎-松山,2023-08-14,9103
5907,大洋-KY,7,0,7,群益金鼎-松山,2023-08-14,9103
2371,大同,7,1,6,群益金鼎-松山,2023-08-14,9103
00720B,元大投資級公司債,5,0,5,群益金鼎-松山,2023-08-14,9103
00753L,中信中國50正2,5,0,5,群益金鼎-松山,2023-08-14,9103
2312,金寶,7,2,5,群益金鼎-松山,2023-08-14,9103
2329,華泰,66,61,5,群益金鼎-松山,2023-08-14,9103
2406,國碩,5,0,5,群益金鼎-松山,2023-08-14,9103
2634,漢翔,5,0,5,群益金鼎-松山,2023-08-14,9103
2929,淘帝-KY,5,0,5,群益金鼎-松山,2023-08-14,9103
3043,科風,5,0,5,群益金鼎-松山,2023-08-14,9103
3264,欣銓,5,0,5,群益金鼎-松山,2023-08-14,9103
3362,先進光,46,41,5,群益金鼎-松山,2023-08-14,9103
1217,愛之味,2282,955,1327,群益金鼎-松山,2023-08-15,9103
00878,國泰永續高股息,125,5,120,群益金鼎-松山,2023-08-15,9103
1905,華紙,100,0,100,群益金鼎-松山,2023-08-15,9103
00706L,期元大S＆P日圓正2,50,0,50,群益金鼎-松山,2023-08-15,9103
1504,東元,40,0,40,群益金鼎-松山,2023-08-15,9103
00929,復華台灣科技優息,38,0,38,群益金鼎-松山,2023-08-15,9103
2356,英業達,61,26,35,群益金鼎-松山,2023-08-15,9103
2880,華南金,30,0,30,群益金鼎-松山,2023-08-15,9103
3163,波若威,46,16,30,群益金鼎-松山,2023-08-15,9103
2329,華泰,89,63,26,群益金鼎-松山,2023-08-15,9103
1503,士電,36,15,21,群益金鼎-松山,2023-08-15,9103
00923,群益台ESG低碳50,19,0,19,群益金鼎-松山,2023-08-15,9103
2498,宏達電,20,1,19,群益金鼎-松山,2023-08-15,9103
3013,晟銘電,33,14,19,群益金鼎-松山,2023-08-15,9103
5871,中租-KY,16,0,16,群益金鼎-松山,2023-08-15,9103
2323,中環,14,0,14,群益金鼎-松山,2023-08-15,9103
1513,中興電,12,0,12,群益金鼎-松山,2023-08-15,9103
2317,鴻海,10,0,10,群益金鼎-松山,2023-08-15,9103
2368,金像電,10,0,10,群益金鼎-松山,2023-08-15,9103
2399,映泰,10,0,10,群益金鼎-松山,2023-08-15,9103
3324,雙鴻,21,11,10,群益金鼎-松山,2023-08-15,9103
5426,振發,10,0,10,群益金鼎-松山,2023-08-15,9103
3363,上詮,29,20,9,群益金鼎-松山,2023-08-15,9103
3693,營邦,12,4,8,群益金鼎-松山,2023-08-15,9103
6282,康舒,14,7,7,群益金鼎-松山,2023-08-15,9103
1795,美時,7,0,7,群益金鼎-松山,2023-08-15,9103
5425,台半,7,0,7,群益金鼎-松山,2023-08-15,9103
00679B,元大美債20年,6,0,6,群益金鼎-松山,2023-08-15,9103
3043,科風,6,0,6,群益金鼎-松山,2023-08-15,9103
1722,台肥,5,0,5,群益金鼎-松山,2023-08-15,9103
00720B,元大投資級公司債,5,0,5,群益金鼎-松山,2023-08-15,9103
00687B,國泰20年美債,5,0,5,群益金鼎-松山,2023-08-15,9103
0056,元大高股息,5,0,5,群益金鼎-松山,2023-08-15,9103
2201,裕隆,5,0,5,群益金鼎-松山,2023-08-15,9103
3011,今皓,5,0,5,群益金鼎-松山,2023-08-15,9103
3044,健鼎,26,21,5,群益金鼎-松山,2023-08-15,9103
3264,欣銓,5,0,5,群益金鼎-松山,2023-08-15,9103
4979,華星光,5,0,5,群益金鼎-松山,2023-08-15,9103
3034,聯詠,4,0,4,群益金鼎-松山,2023-08-15,9103
3715,定穎投控,5,1,4,群益金鼎-松山,2023-08-15,9103
6274,台燿,7,3,4,群益金鼎-松山,2023-08-15,9103
6531,愛普*,4,0,4,群益金鼎-松山,2023-08-15,9103
6863,永道-KY,4,0,4,群益金鼎-松山,2023-08-15,9103
8941,關中,4,0,4,群益金鼎-松山,2023-08-15,9103
2603,長榮,3,0,3,群益金鼎-松山,2023-08-15,9103
006208,富邦台50,3,0,3,群益金鼎-松山,2023-08-15,9103
00882,中信中國高股息,3,0,3,群益金鼎-松山,2023-08-15,9103
2303,聯電,3,0,3,群益金鼎-松山,2023-08-15,9103
2618,長榮航,3,0,3,群益金鼎-松山,2023-08-15,9103
2634,漢翔,4,1,3,群益金鼎-松山,2023-08-15,9103
2610,華航,158,50,108,群益金鼎-松山,2023-08-16,9103
3645,達邁,50,0,50,群益金鼎-松山,2023-08-16,9103
4533,協易機,90,40,50,群益金鼎-松山,2023-08-16,9103
6275,元山,73,30,43,群益金鼎-松山,2023-08-16,9103
2363,矽統,36,3,33,群益金鼎-松山,2023-08-16,9103
3071,協禧,77,47,30,群益金鼎-松山,2023-08-16,9103
3706,神達,70,40,30,群益金鼎-松山,2023-08-16,9103
8084,巨虹,30,0,30,群益金鼎-松山,2023-08-16,9103
2421,建準,55,33,22,群益金鼎-松山,2023-08-16,9103
6188,廣明,50,30,20,群益金鼎-松山,2023-08-16,9103
3483,力致,63,45,18,群益金鼎-松山,2023-08-16,9103
2303,聯電,15,0,15,群益金鼎-松山,2023-08-16,9103
6579,研揚,14,0,14,群益金鼎-松山,2023-08-16,9103
4979,華星光,28,15,13,群益金鼎-松山,2023-08-16,9103
00923,群益台ESG低碳50,12,0,12,群益金鼎-松山,2023-08-16,9103
2887,台新金,11,0,11,群益金鼎-松山,2023-08-16,9103
00751B,元大AAA至A公司債,11,0,11,群益金鼎-松山,2023-08-16,9103
3044,健鼎,38,27,11,群益金鼎-松山,2023-08-16,9103
3583,辛耘,12,1,11,群益金鼎-松山,2023-08-16,9103
8433,弘帆,11,0,11,群益金鼎-松山,2023-08-16,9103
00795B,中信美國公債20年,10,0,10,群益金鼎-松山,2023-08-16,9103
2498,宏達電,10,0,10,群益金鼎-松山,2023-08-16,9103
2880,華南金,10,0,10,群益金鼎-松山,2023-08-16,9103
00900,富邦特選高股息30,8,0,8,群益金鼎-松山,2023-08-16,9103
3715,定穎投控,11,3,8,群益金鼎-松山,2023-08-16,9103
8210,勤誠,19,11,8,群益金鼎-松山,2023-08-16,9103
2891,中信金,17,10,7,群益金鼎-松山,2023-08-16,9103
1618,合機,7,0,7,群益金鼎-松山,2023-08-16,9103
3231,緯創,36,29,7,群益金鼎-松山,2023-08-16,9103
2885,元大金,6,0,6,群益金鼎-松山,2023-08-16,9103
2313,華通,6,0,6,群益金鼎-松山,2023-08-16,9103
2376,技嘉,22,16,6,群益金鼎-松山,2023-08-16,9103
8358,金居,21,15,6,群益金鼎-松山,2023-08-16,9103
1519,華城,22,17,5,群益金鼎-松山,2023-08-16,9103
2352,佳世達,5,0,5,群益金鼎-松山,2023-08-16,9103
3011,今皓,5,0,5,群益金鼎-松山,2023-08-16,9103
5876,上海商銀,5,0,5,群益金鼎-松山,2023-08-16,9103
5907,大洋-KY,5,0,5,群益金鼎-松山,2023-08-16,9103
2382,廣達,41,36,5,群益金鼎-松山,2023-08-16,9103
1464,得力,4,0,4,群益金鼎-松山,2023-08-16,9103
00772B,中信高評級公司債,4,0,4,群益金鼎-松山,2023-08-16,9103
2440,太空梭,4,0,4,群益金鼎-松山,2023-08-16,9103
2486,一詮,12,8,4,群益金鼎-松山,2023-08-16,9103
2892,第一金,4,0,4,群益金鼎-松山,2023-08-16,9103
3037,欣興,6,2,4,群益金鼎-松山,2023-08-16,9103
6244,茂迪,4,0,4,群益金鼎-松山,2023-08-16,9103
9945,潤泰新,4,0,4,群益金鼎-松山,2023-08-16,9103
2371,大同,4,1,3,群益金鼎-松山,2023-08-16,9103
2330,台積電,3,0,3,群益金鼎-松山,2023-08-16,9103
2886,兆豐金,3,0,3,群益金鼎-松山,2023-08-16,9103
3231,緯創,94,42,52,群益金鼎-松山,2023-08-17,9103
00664R,國泰臺灣加權反1,100,50,50,群益金鼎-松山,2023-08-17,9103
00923,群益台ESG低碳50,45,0,45,群益金鼎-松山,2023-08-17,9103
2402,毅嘉,40,0,40,群益金鼎-松山,2023-08-17,9103
6125,廣運,57,17,40,群益金鼎-松山,2023-08-17,9103
2316,楠梓電,30,0,30,群益金鼎-松山,2023-08-17,9103
3363,上詮,33,7,26,群益金鼎-松山,2023-08-17,9103
3088,艾訊,25,0,25,群益金鼎-松山,2023-08-17,9103
2301,光寶科,56,32,24,群益金鼎-松山,2023-08-17,9103
2498,宏達電,20,0,20,群益金鼎-松山,2023-08-17,9103
6285,啟��,41,21,20,群益金鼎-松山,2023-08-17,9103
1503,士電,20,1,19,群益金鼎-松山,2023-08-17,9103
2303,聯電,18,0,18,群益金鼎-松山,2023-08-17,9103
00929,復華台灣科技優息,18,1,17,群益金鼎-松山,2023-08-17,9103
6274,台燿,18,2,16,群益金鼎-松山,2023-08-17,9103
00751B,元大AAA至A公司債,15,0,15,群益金鼎-松山,2023-08-17,9103
6770,力積電,16,1,15,群益金鼎-松山,2023-08-17,9103
3306,鼎天,78,65,13,群益金鼎-松山,2023-08-17,9103
1513,中興電,32,21,11,群益金鼎-松山,2023-08-17,9103
2388,威盛,11,0,11,群益金鼎-松山,2023-08-17,9103
5608,四維航,10,0,10,群益金鼎-松山,2023-08-17,9103
5876,上海商銀,10,0,10,群益金鼎-松山,2023-08-17,9103
6187,萬潤,23,14,9,群益金鼎-松山,2023-08-17,9103
2324,仁寶,34,26,8,群益金鼎-松山,2023-08-17,9103
2880,華南金,8,0,8,群益金鼎-松山,2023-08-17,9103
6231,系微,9,1,8,群益金鼎-松山,2023-08-17,9103
9907,統一實,8,0,8,群益金鼎-松山,2023-08-17,9103
00679B,元大美債20年,7,0,7,群益金鼎-松山,2023-08-17,9103
2382,廣達,41,34,7,群益金鼎-松山,2023-08-17,9103
4746,台耀,9,2,7,群益金鼎-松山,2023-08-17,9103
6120,達運,10,3,7,群益金鼎-松山,2023-08-17,9103
6531,愛普*,7,0,7,群益金鼎-松山,2023-08-17,9103
1101,台泥,6,0,6,群益金鼎-松山,2023-08-17,9103
2344,華邦電,6,0,6,群益金鼎-松山,2023-08-17,9103
3044,健鼎,51,45,6,群益金鼎-松山,2023-08-17,9103
6005,群益證,6,0,6,群益金鼎-松山,2023-08-17,9103
00931B,統一美債20年,5,0,5,群益金鼎-松山,2023-08-17,9103
0056,元大高股息,5,0,5,群益金鼎-松山,2023-08-17,9103
00720B,元大投資級公司債,5,0,5,群益金鼎-松山,2023-08-17,9103
00706L,期元大S＆P日圓正2,5,0,5,群益金鼎-松山,2023-08-17,9103
2383,台光電,11,6,5,群益金鼎-松山,2023-08-17,9103
2883,凱基金,5,0,5,群益金鼎-松山,2023-08-17,9103
2915,潤泰全,5,0,5,群益金鼎-松山,2023-08-17,9103
3036,文曄,5,0,5,群益金鼎-松山,2023-08-17,9103
3694,海華,5,0,5,群益金鼎-松山,2023-08-17,9103
6269,台郡,5,0,5,群益金鼎-松山,2023-08-17,9103
8996,高力,8,3,5,群益金鼎-松山,2023-08-17,9103
9103,美德醫療-DR,5,0,5,群益金鼎-松山,2023-08-17,9103
2323,中環,4,0,4,群益金鼎-松山,2023-08-17,9103
2352,佳世達,4,0,4,群益金鼎-松山,2023-08-17,9103
2324,仁寶,179,59,120,群益金鼎-松山,2023-08-18,9103
2363,矽統,90,17,73,群益金鼎-松山,2023-08-18,9103
3033,威健,82,10,72,群益金鼎-松山,2023-08-18,9103
1217,愛之味,515,447,68,群益金鼎-松山,2023-08-18,9103
2356,英業達,208,156,52,群益金鼎-松山,2023-08-18,9103
1319,東陽,53,2,51,群益金鼎-松山,2023-08-18,9103
2359,所羅門,42,9,33,群益金鼎-松山,2023-08-18,9103
4950,牧東,26,0,26,群益金鼎-松山,2023-08-18,9103
2634,漢翔,20,0,20,群益金鼎-松山,2023-08-18,9103
8084,巨虹,19,0,19,群益金鼎-松山,2023-08-18,9103
00753L,中信中國50正2,15,0,15,群益金鼎-松山,2023-08-18,9103
2382,廣達,74,61,13,群益金鼎-松山,2023-08-18,9103
3362,先進光,35,23,12,群益金鼎-松山,2023-08-18,9103
8210,勤誠,21,9,12,群益金鼎-松山,2023-08-18,9103
00929,復華台灣科技優息,11,0,11,群益金鼎-松山,2023-08-18,9103
2880,華南金,11,0,11,群益金鼎-松山,2023-08-18,9103
2331,精英,10,0,10,群益金鼎-松山,2023-08-18,9103
2368,金像電,28,18,10,群益金鼎-松山,2023-08-18,9103
2399,映泰,10,0,10,群益金鼎-松山,2023-08-18,9103
3483,力致,70,61,9,群益金鼎-松山,2023-08-18,9103
6125,廣運,14,5,9,群益金鼎-松山,2023-08-18,9103
5203,訊連,8,0,8,群益金鼎-松山,2023-08-18,9103
2408,南亞科,7,0,7,群益金鼎-松山,2023-08-18,9103
2603,長榮,59,52,7,群益金鼎-松山,2023-08-18,9103
3056,富華新,7,0,7,群益金鼎-松山,2023-08-18,9103
8349,�矬�,7,0,7,群益金鼎-松山,2023-08-18,9103
4551,智伸科,6,0,6,群益金鼎-松山,2023-08-18,9103
3715,定穎投控,9,4,5,群益金鼎-松山,2023-08-18,9103
00751B,元大AAA至A公司債,5,0,5,群益金鼎-松山,2023-08-18,9103
2618,長榮航,5,0,5,群益金鼎-松山,2023-08-18,9103
5608,四維航,5,0,5,群益金鼎-松山,2023-08-18,9103
1301,台塑,4,0,4,群益金鼎-松山,2023-08-18,9103
00637L,元大滬深300正2,6,2,4,群益金鼎-松山,2023-08-18,9103
2383,台光電,7,3,4,群益金鼎-松山,2023-08-18,9103
3325,旭品,4,0,4,群益金鼎-松山,2023-08-18,9103
3704,合勤控,4,0,4,群益金鼎-松山,2023-08-18,9103
3706,神達,44,40,4,群益金鼎-松山,2023-08-18,9103
6625,必應,4,0,4,群益金鼎-松山,2023-08-18,9103
8028,昇陽半導體,4,0,4,群益金鼎-松山,2023-08-18,9103
8390,金益鼎,4,0,4,群益金鼎-松山,2023-08-18,9103
00713,元大台灣高息低波,3,0,3,群益金鼎-松山,2023-08-18,9103
1903,士紙,3,0,3,群益金鼎-松山,2023-08-18,9103
2457,飛宏,5,2,3,群益金鼎-松山,2023-08-18,9103
2548,華固,3,0,3,群益金鼎-松山,2023-08-18,9103
3416,融程電,3,0,3,群益金鼎-松山,2023-08-18,9103
4768,晶呈科技,3,0,3,群益金鼎-松山,2023-08-18,9103
5347,世界,3,0,3,群益金鼎-松山,2023-08-18,9103
6126,信音,3,0,3,群益金鼎-松山,2023-08-18,9103
6274,台燿,12,9,3,群益金鼎-松山,2023-08-18,9103
6719,力智,3,0,3,群益金鼎-松山,2023-08-18,9103
6191,精成科,41,0,41,群益金鼎-松山,2023-08-21,9103
3704,合勤控,40,0,40,群益金鼎-松山,2023-08-21,9103
5469,瀚宇博,40,0,40,群益金鼎-松山,2023-08-21,9103
2329,華泰,38,3,35,群益金鼎-松山,2023-08-21,9103
2605,新興,35,0,35,群益金鼎-松山,2023-08-21,9103
6285,啟��,35,4,31,群益金鼎-松山,2023-08-21,9103
1903,士紙,26,0,26,群益金鼎-松山,2023-08-21,9103
5608,四維航,21,0,21,群益金鼎-松山,2023-08-21,9103
2498,宏達電,20,0,20,群益金鼎-松山,2023-08-21,9103
3071,協禧,26,6,20,群益金鼎-松山,2023-08-21,9103
1535,中宇,19,0,19,群益金鼎-松山,2023-08-21,9103
2606,裕民,16,0,16,群益金鼎-松山,2023-08-21,9103
2382,廣達,23,7,16,群益金鼎-松山,2023-08-21,9103
1513,中興電,17,2,15,群益金鼎-松山,2023-08-21,9103
2634,漢翔,35,20,15,群益金鼎-松山,2023-08-21,9103
3163,波若威,22,7,15,群益金鼎-松山,2023-08-21,9103
2736,富野,14,0,14,群益金鼎-松山,2023-08-21,9103
1503,士電,21,11,10,群益金鼎-松山,2023-08-21,9103
00931B,統一美債20年,10,0,10,群益金鼎-松山,2023-08-21,9103
00923,群益台ESG低碳50,10,0,10,群益金鼎-松山,2023-08-21,9103
2332,友訊,14,4,10,群益金鼎-松山,2023-08-21,9103
2393,億光,10,0,10,群益金鼎-松山,2023-08-21,9103
3380,明泰,10,0,10,群益金鼎-松山,2023-08-21,9103
5340,建榮,10,0,10,群益金鼎-松山,2023-08-21,9103
2301,光寶科,37,28,9,群益金鼎-松山,2023-08-21,9103
00772B,中信高評級公司債,8,0,8,群益金鼎-松山,2023-08-21,9103
3324,雙鴻,8,0,8,群益金鼎-松山,2023-08-21,9103
8996,高力,8,0,8,群益金鼎-松山,2023-08-21,9103
00751B,元大AAA至A公司債,7,0,7,群益金鼎-松山,2023-08-21,9103
3207,耀勝,7,0,7,群益金鼎-松山,2023-08-21,9103
00687B,國泰20年美債,6,0,6,群益金鼎-松山,2023-08-21,9103
2610,華航,12,6,6,群益金鼎-松山,2023-08-21,9103
3231,緯創,22,16,6,群益金鼎-松山,2023-08-21,9103
8210,勤誠,11,5,6,群益金鼎-松山,2023-08-21,9103
3044,健鼎,39,34,5,群益金鼎-松山,2023-08-21,9103
2637,慧洋-KY,5,0,5,群益金鼎-松山,2023-08-21,9103
2204,中華,5,0,5,群益金鼎-松山,2023-08-21,9103
2345,智邦,5,0,5,群益金鼎-松山,2023-08-21,9103
2383,台光電,6,1,5,群益金鼎-松山,2023-08-21,9103
5876,上海商銀,5,0,5,群益金鼎-松山,2023-08-21,9103
00679B,元大美債20年,4,0,4,群益金鼎-松山,2023-08-21,9103
00637L,元大滬深300正2,4,0,4,群益金鼎-松山,2023-08-21,9103
00882,中信中國高股息,4,0,4,群益金鼎-松山,2023-08-21,9103
2243,宏旭-KY,4,0,4,群益金鼎-松山,2023-08-21,9103
2482,連宇,4,0,4,群益金鼎-松山,2023-08-21,9103
6625,必應,4,0,4,群益金鼎-松山,2023-08-21,9103
8040,九暘,4,0,4,群益金鼎-松山,2023-08-21,9103
9934,成霖,4,0,4,群益金鼎-松山,2023-08-21,9103
2250,IKKA-KY,3,0,3,群益金鼎-松山,2023-08-21,9103
3025,星通,11,8,3,群益金鼎-松山,2023-08-21,9103
2363,矽統,173,69,104,群益金鼎-松山,2023-08-22,9103
3032,偉訓,60,2,58,群益金鼎-松山,2023-08-22,9103
2359,所羅門,50,0,50,群益金鼎-松山,2023-08-22,9103
2449,京元電子,68,36,32,群益金鼎-松山,2023-08-22,9103
4533,協易機,30,0,30,群益金鼎-松山,2023-08-22,9103
6164,華興,30,0,30,群益金鼎-松山,2023-08-22,9103
6593,台灣銘板,25,4,21,群益金鼎-松山,2023-08-22,9103
2421,建準,53,36,17,群益金鼎-松山,2023-08-22,9103
00679B,元大美債20年,16,0,16,群益金鼎-松山,2023-08-22,9103
1709,和益,15,0,15,群益金鼎-松山,2023-08-22,9103
6125,廣運,91,77,14,群益金鼎-松山,2023-08-22,9103
2606,裕民,16,3,13,群益金鼎-松山,2023-08-22,9103
3013,晟銘電,121,108,13,群益金鼎-松山,2023-08-22,9103
8084,巨虹,13,0,13,群益金鼎-松山,2023-08-22,9103
2371,大同,13,1,12,群益金鼎-松山,2023-08-22,9103
3324,雙鴻,13,1,12,群益金鼎-松山,2023-08-22,9103
1905,華紙,10,0,10,群益金鼎-松山,2023-08-22,9103
1217,愛之味,10,0,10,群益金鼎-松山,2023-08-22,9103
00929,復華台灣科技優息,10,0,10,群益金鼎-松山,2023-08-22,9103
00696B,富邦美債20年,10,0,10,群益金鼎-松山,2023-08-22,9103
2388,威盛,22,12,10,群益金鼎-松山,2023-08-22,9103
2405,輔信,10,0,10,群益金鼎-松山,2023-08-22,9103
2530,華建,10,0,10,群益金鼎-松山,2023-08-22,9103
2913,農林,10,0,10,群益金鼎-松山,2023-08-22,9103
2915,潤泰全,10,0,10,群益金鼎-松山,2023-08-22,9103
3306,鼎天,10,0,10,群益金鼎-松山,2023-08-22,9103
3338,泰碩,10,0,10,群益金鼎-松山,2023-08-22,9103
6188,廣明,12,2,10,群益金鼎-松山,2023-08-22,9103
00687B,國泰20年美債,9,0,9,群益金鼎-松山,2023-08-22,9103
2344,華邦電,10,1,9,群益金鼎-松山,2023-08-22,9103
6531,愛普*,8,0,8,群益金鼎-松山,2023-08-22,9103
4906,正文,7,0,7,群益金鼎-松山,2023-08-22,9103
2002,中鋼,12,6,6,群益金鼎-松山,2023-08-22,9103
8358,金居,9,3,6,群益金鼎-松山,2023-08-22,9103
6139,亞翔,5,0,5,群益金鼎-松山,2023-08-22,9103
00720B,元大投資級公司債,5,0,5,群益金鼎-松山,2023-08-22,9103
00688L,國泰20年美債正2,5,0,5,群益金鼎-松山,2023-08-22,9103
00885,富邦越南,6,1,5,群益金鼎-松山,2023-08-22,9103
3017,奇鋐,6,1,5,群益金鼎-松山,2023-08-22,9103
3444,利機,5,0,5,群益金鼎-松山,2023-08-22,9103
3706,神達,7,2,5,群益金鼎-松山,2023-08-22,9103
8404,百和興業-KY,5,0,5,群益金鼎-松山,2023-08-22,9103
3035,智原,11,6,5,群益金鼎-松山,2023-08-22,9103
3044,健鼎,14,10,4,群益金鼎-松山,2023-08-22,9103
1701,中化,4,0,4,群益金鼎-松山,2023-08-22,9103
1802,台玻,4,0,4,群益金鼎-松山,2023-08-22,9103
00923,群益台ESG低碳50,4,0,4,群益金鼎-松山,2023-08-22,9103
1519,華城,15,11,4,群益金鼎-松山,2023-08-22,9103
1464,得力,4,0,4,群益金鼎-松山,2023-08-22,9103
2324,仁寶,4,0,4,群益金鼎-松山,2023-08-22,9103
1217,愛之味,1048,906,142,群益金鼎-松山,2023-08-23,9103
2367,燿華,120,5,115,群益金鼎-松山,2023-08-23,9103
3013,晟銘電,146,101,45,群益金鼎-松山,2023-08-23,9103
2301,光寶科,42,8,34,群益金鼎-松山,2023-08-23,9103
3051,力特,32,1,31,群益金鼎-松山,2023-08-23,9103
00671R,富邦NASDAQ反1,20,0,20,群益金鼎-松山,2023-08-23,9103
2610,華航,26,8,18,群益金鼎-松山,2023-08-23,9103
2880,華南金,15,0,15,群益金鼎-松山,2023-08-23,9103
3715,定穎投控,29,14,15,群益金鼎-松山,2023-08-23,9103
5284,jpp-KY,12,1,11,群益金鼎-松山,2023-08-23,9103
8033,雷虎,11,0,11,群益金鼎-松山,2023-08-23,9103
2405,輔信,10,0,10,群益金鼎-松山,2023-08-23,9103
2743,山富,10,0,10,群益金鼎-松山,2023-08-23,9103
3043,科風,20,10,10,群益金鼎-松山,2023-08-23,9103
3362,先進光,10,0,10,群益金鼎-松山,2023-08-23,9103
4906,正文,10,0,10,群益金鼎-松山,2023-08-23,9103
9904,寶成,10,0,10,群益金鼎-松山,2023-08-23,9103
6231,系微,9,1,8,群益金鼎-松山,2023-08-23,9103
3587,閎康,7,0,7,群益金鼎-松山,2023-08-23,9103
1519,華城,23,17,6,群益金鼎-松山,2023-08-23,9103
2382,廣達,19,13,6,群益金鼎-松山,2023-08-23,9103
2250,IKKA-KY,6,0,6,群益金鼎-松山,2023-08-23,9103
1477,聚陽,8,2,6,群益金鼎-松山,2023-08-23,9103
6122,擎邦,6,0,6,群益金鼎-松山,2023-08-23,9103
2357,華碩,7,1,6,群益金鼎-松山,2023-08-23,9103
2606,裕民,6,1,5,群益金鼎-松山,2023-08-23,9103
00931B,統一美債20年,5,0,5,群益金鼎-松山,2023-08-23,9103
1709,和益,5,0,5,群益金鼎-松山,2023-08-23,9103
1305,華夏,5,0,5,群益金鼎-松山,2023-08-23,9103
3583,辛耘,5,0,5,群益金鼎-松山,2023-08-23,9103
8222,寶一,91,86,5,群益金鼎-松山,2023-08-23,9103
1301,台塑,5,0,5,群益金鼎-松山,2023-08-23,9103
2329,華泰,37,33,4,群益金鼎-松山,2023-08-23,9103
1784,訊聯,4,0,4,群益金鼎-松山,2023-08-23,9103
00929,復華台灣科技優息,4,0,4,群益金鼎-松山,2023-08-23,9103
00907,永豐優息存股,4,0,4,群益金鼎-松山,2023-08-23,9103
2612,中航,4,0,4,群益金鼎-松山,2023-08-23,9103
2884,玉山金,4,0,4,群益金鼎-松山,2023-08-23,9103
6282,康舒,60,56,4,群益金鼎-松山,2023-08-23,9103
2388,威盛,6,3,3,群益金鼎-松山,2023-08-23,9103
2485,兆赫,14,11,3,群益金鼎-松山,2023-08-23,9103
2736,富野,3,0,3,群益金鼎-松山,2023-08-23,9103
6117,迎廣,6,3,3,群益金鼎-松山,2023-08-23,9103
6190,萬泰科,3,0,3,群益金鼎-松山,2023-08-23,9103
8027,鈦昇,3,0,3,群益金鼎-松山,2023-08-23,9103
8409,商之器,3,0,3,群益金鼎-松山,2023-08-23,9103
00712,復華富時不動產,2,0,2,群益金鼎-松山,2023-08-23,9103
00888,永豐台灣ESG,2,0,2,群益金鼎-松山,2023-08-23,9103
2548,華固,2,0,2,群益金鼎-松山,2023-08-23,9103
2618,長榮航,9,7,2,群益金鼎-松山,2023-08-23,9103
2363,矽統,199,122,77,群益金鼎-松山,2023-08-24,9103
3231,緯創,89,25,64,群益金鼎-松山,2023-08-24,9103
2231,為升,53,0,53,群益金鼎-松山,2023-08-24,9103
9958,世紀鋼,41,0,41,群益金鼎-松山,2023-08-24,9103
2630,亞航,34,0,34,群益金鼎-松山,2023-08-24,9103
00929,復華台灣科技優息,34,2,32,群益金鼎-松山,2023-08-24,9103
1217,愛之味,30,0,30,群益金鼎-松山,2023-08-24,9103
6164,華興,30,0,30,群益金鼎-松山,2023-08-24,9103
6202,盛群,30,0,30,群益金鼎-松山,2023-08-24,9103
8084,巨虹,30,0,30,群益金鼎-松山,2023-08-24,9103
1101,台泥,20,0,20,群益金鼎-松山,2023-08-24,9103
2605,新興,20,0,20,群益金鼎-松山,2023-08-24,9103
2449,京元電子,28,11,17,群益金鼎-松山,2023-08-24,9103
3706,神達,18,3,15,群益金鼎-松山,2023-08-24,9103
2324,仁寶,14,0,14,群益金鼎-松山,2023-08-24,9103
2382,廣達,89,76,13,群益金鼎-松山,2023-08-24,9103
00632R,元大台灣50反1,10,0,10,群益金鼎-松山,2023-08-24,9103
00917,中信特選金融,10,0,10,群益金鼎-松山,2023-08-24,9103
00909,國泰數位支付服務,10,0,10,群益金鼎-松山,2023-08-24,9103
2353,宏��,25,15,10,群益金鼎-松山,2023-08-24,9103
3032,偉訓,18,8,10,群益金鼎-松山,2023-08-24,9103
6205,詮欣,10,0,10,群益金鼎-松山,2023-08-24,9103
8349,�矬�,10,0,10,群益金鼎-松山,2023-08-24,9103
1473,台南,9,0,9,群益金鼎-松山,2023-08-24,9103
3011,今皓,11,2,9,群益金鼎-松山,2023-08-24,9103
2530,華建,8,0,8,群益金鼎-松山,2023-08-24,9103
3693,營邦,8,0,8,群益金鼎-松山,2023-08-24,9103
1736,喬山,6,0,6,群益金鼎-松山,2023-08-24,9103
2884,玉山金,6,0,6,群益金鼎-松山,2023-08-24,9103
3702,大聯大,6,0,6,群益金鼎-松山,2023-08-24,9103
8433,弘帆,6,0,6,群益金鼎-松山,2023-08-24,9103
1301,台塑,5,0,5,群益金鼎-松山,2023-08-24,9103
00919,群益台灣精選高息,5,0,5,群益金鼎-松山,2023-08-24,9103
3264,欣銓,7,2,5,群益金鼎-松山,2023-08-24,9103
6148,驊宏資,5,0,5,群益金鼎-松山,2023-08-24,9103
8409,商之器,5,0,5,群益金鼎-松山,2023-08-24,9103
2250,IKKA-KY,4,0,4,群益金鼎-松山,2023-08-24,9103
3346,麗清,4,0,4,群益金鼎-松山,2023-08-24,9103
3707,漢磊,4,0,4,群益金鼎-松山,2023-08-24,9103
5519,隆大,4,0,4,群益金鼎-松山,2023-08-24,9103
6257,矽格,4,0,4,群益金鼎-松山,2023-08-24,9103
2317,鴻海,5,2,3,群益金鼎-松山,2023-08-24,9103
00893,國泰智能電動車,3,0,3,群益金鼎-松山,2023-08-24,9103
2612,中航,3,0,3,群益金鼎-松山,2023-08-24,9103
2615,萬海,3,0,3,群益金鼎-松山,2023-08-24,9103
4543,萬在,6,3,3,群益金鼎-松山,2023-08-24,9103
6741,91APP*-KY,3,0,3,群益金鼎-松山,2023-08-24,9103
3680,家登,2,0,2,群益金鼎-松山,2023-08-24,9103
00633L,富邦上証正2,2,0,2,群益金鼎-松山,2023-08-24,9103
00923,群益台ESG低碳50,2,0,2,群益金鼎-松山,2023-08-24,9103
1217,愛之味,888,811,77,群益金鼎-松山,2023-08-25,9103
2634,漢翔,118,84,34,群益金鼎-松山,2023-08-25,9103
00878,國泰永續高股息,53,22,31,群益金鼎-松山,2023-08-25,9103
2363,矽統,93,66,27,群益金鼎-松山,2023-08-25,9103
2301,光寶科,47,22,25,群益金鼎-松山,2023-08-25,9103
2449,京元電子,52,30,22,群益金鼎-松山,2023-08-25,9103
2352,佳世達,20,0,20,群益金鼎-松山,2023-08-25,9103
4938,和碩,22,2,20,群益金鼎-松山,2023-08-25,9103
2382,廣達,61,41,20,群益金鼎-松山,2023-08-25,9103
2329,華泰,18,2,16,群益金鼎-松山,2023-08-25,9103
2486,一詮,15,0,15,群益金鼎-松山,2023-08-25,9103
2421,建準,37,25,12,群益金鼎-松山,2023-08-25,9103
00680L,元大美債20正2,10,0,10,群益金鼎-松山,2023-08-25,9103
2605,新興,10,0,10,群益金鼎-松山,2023-08-25,9103
3043,科風,20,10,10,群益金鼎-松山,2023-08-25,9103
5871,中租-KY,10,0,10,群益金鼎-松山,2023-08-25,9103
3704,合勤控,10,1,9,群益金鼎-松山,2023-08-25,9103
2353,宏��,8,0,8,群益金鼎-松山,2023-08-25,9103
5284,jpp-KY,9,1,8,群益金鼎-松山,2023-08-25,9103
3035,智原,17,10,7,群益金鼎-松山,2023-08-25,9103
00919,群益台灣精選高息,7,0,7,群益金鼎-松山,2023-08-25,9103
2330,台積電,6,0,6,群益金鼎-松山,2023-08-25,9103
2201,裕隆,6,0,6,群益金鼎-松山,2023-08-25,9103
2317,鴻海,6,0,6,群益金鼎-松山,2023-08-25,9103
2332,友訊,11,5,6,群益金鼎-松山,2023-08-25,9103
2530,華建,6,0,6,群益金鼎-松山,2023-08-25,9103
2618,長榮航,6,0,6,群益金鼎-松山,2023-08-25,9103
00900,富邦特選高股息30,5,0,5,群益金鼎-松山,2023-08-25,9103
00762,元大全球AI,5,0,5,群益金鼎-松山,2023-08-25,9103
2399,映泰,5,0,5,群益金鼎-松山,2023-08-25,9103
3037,欣興,7,2,5,群益金鼎-松山,2023-08-25,9103
5381,合正,6,1,5,群益金鼎-松山,2023-08-25,9103
5457,宣德,5,0,5,群益金鼎-松山,2023-08-25,9103
8409,商之器,5,0,5,群益金鼎-松山,2023-08-25,9103
8996,高力,5,0,5,群益金鼎-松山,2023-08-25,9103
9904,寶成,5,0,5,群益金鼎-松山,2023-08-25,9103
00929,復華台灣科技優息,5,1,4,群益金鼎-松山,2023-08-25,9103
2206,三陽工業,5,1,4,群益金鼎-松山,2023-08-25,9103
2312,金寶,4,0,4,群益金鼎-松山,2023-08-25,9103
5880,合庫金,4,0,4,群益金鼎-松山,2023-08-25,9103
8349,�矬�,4,0,4,群益金鼎-松山,2023-08-25,9103
2892,第一金,3,0,3,群益金鼎-松山,2023-08-25,9103
2915,潤泰全,3,0,3,群益金鼎-松山,2023-08-25,9103
3022,威強電,3,0,3,群益金鼎-松山,2023-08-25,9103
3027,盛達,3,0,3,群益金鼎-松山,2023-08-25,9103
4174,浩鼎,3,0,3,群益金鼎-松山,2023-08-25,9103
5347,世界,3,0,3,群益金鼎-松山,2023-08-25,9103
8046,南電,3,0,3,群益金鼎-松山,2023-08-25,9103
8289,泰藝,3,0,3,群益金鼎-松山,2023-08-25,9103
8433,弘帆,3,0,3,群益金鼎-松山,2023-08-25,9103
00929,復華台灣科技優息,205,0,205,群益金鼎-松山,2023-08-28,9103
4906,正文,170,1,169,群益金鼎-松山,2023-08-28,9103
5009,榮剛,90,0,90,群益金鼎-松山,2023-08-28,9103
00712,復華富時不動產,60,0,60,群益金鼎-松山,2023-08-28,9103
2356,英業達,67,12,55,群益金鼎-松山,2023-08-28,9103
4944,兆遠,48,0,48,群益金鼎-松山,2023-08-28,9103
00753L,中信中國50正2,35,0,35,群益金鼎-松山,2023-08-28,9103
3231,緯創,46,14,32,群益金鼎-松山,2023-08-28,9103
3583,辛耘,20,0,20,群益金鼎-松山,2023-08-28,9103
2645,長榮航太,16,0,16,群益金鼎-松山,2023-08-28,9103
2323,中環,15,0,15,群益金鼎-松山,2023-08-28,9103
8084,巨虹,15,0,15,群益金鼎-松山,2023-08-28,9103
6139,亞翔,14,0,14,群益金鼎-松山,2023-08-28,9103
6285,啟��,16,2,14,群益金鼎-松山,2023-08-28,9103
00637L,元大滬深300正2,26,13,13,群益金鼎-松山,2023-08-28,9103
5371,中光電,13,0,13,群益金鼎-松山,2023-08-28,9103
8028,昇陽半導體,12,0,12,群益金鼎-松山,2023-08-28,9103
2355,敬鵬,11,0,11,群益金鼎-松山,2023-08-28,9103
2425,承啟,11,0,11,群益金鼎-松山,2023-08-28,9103
2485,兆赫,12,1,11,群益金鼎-松山,2023-08-28,9103
6125,廣運,13,2,11,群益金鼎-松山,2023-08-28,9103
00632R,元大台灣50反1,10,0,10,群益金鼎-松山,2023-08-28,9103
2344,華邦電,10,0,10,群益金鼎-松山,2023-08-28,9103
5457,宣德,10,0,10,群益金鼎-松山,2023-08-28,9103
5534,長虹,10,0,10,群益金鼎-松山,2023-08-28,9103
6117,迎廣,10,0,10,群益金鼎-松山,2023-08-28,9103
6235,華孚,20,11,9,群益金鼎-松山,2023-08-28,9103
2352,佳世達,10,2,8,群益金鼎-松山,2023-08-28,9103
3311,閎暉,9,1,8,群益金鼎-松山,2023-08-28,9103
00878,國泰永續高股息,8,1,7,群益金鼎-松山,2023-08-28,9103
00706L,期元大S＆P日圓正2,17,10,7,群益金鼎-松山,2023-08-28,9103
3169,亞信,7,0,7,群益金鼎-松山,2023-08-28,9103
2371,大同,6,0,6,群益金鼎-松山,2023-08-28,9103
2421,建準,24,18,6,群益金鼎-松山,2023-08-28,9103
6188,廣明,8,2,6,群益金鼎-松山,2023-08-28,9103
3483,力致,8,2,6,群益金鼎-松山,2023-08-28,9103
1736,喬山,5,0,5,群益金鼎-松山,2023-08-28,9103
2393,億光,5,0,5,群益金鼎-松山,2023-08-28,9103
2399,映泰,5,0,5,群益金鼎-松山,2023-08-28,9103
2465,麗臺,5,0,5,群益金鼎-松山,2023-08-28,9103
3715,定穎投控,8,3,5,群益金鼎-松山,2023-08-28,9103
4977,眾達-KY,5,0,5,群益金鼎-松山,2023-08-28,9103
8349,�矬�,5,0,5,群益金鼎-松山,2023-08-28,9103
4979,華星光,15,10,5,群益金鼎-松山,2023-08-28,9103
2206,三陽工業,4,0,4,群益金鼎-松山,2023-08-28,9103
2363,矽統,43,39,4,群益金鼎-松山,2023-08-28,9103
2530,華建,4,0,4,群益金鼎-松山,2023-08-28,9103
2610,華航,4,0,4,群益金鼎-松山,2023-08-28,9103
2618,長榮航,4,0,4,群益金鼎-松山,2023-08-28,9103
3022,威強電,5,1,4,群益金鼎-松山,2023-08-28,9103
2888,新光金,200,0,200,群益金鼎-松山,2023-08-29,9103
4906,正文,100,20,80,群益金鼎-松山,2023-08-29,9103
00632R,元大台灣50反1,60,0,60,群益金鼎-松山,2023-08-29,9103
2881,富邦金,50,0,50,群益金鼎-松山,2023-08-29,9103
2402,毅嘉,51,5,46,群益金鼎-松山,2023-08-29,9103
6215,和椿,40,0,40,群益金鼎-松山,2023-08-29,9103
00712,復華富時不動產,33,1,32,群益金鼎-松山,2023-08-29,9103
2329,華泰,43,12,31,群益金鼎-松山,2023-08-29,9103
2363,矽統,118,87,31,群益金鼎-松山,2023-08-29,9103
2421,建準,28,2,26,群益金鼎-松山,2023-08-29,9103
8222,寶一,25,3,22,群益金鼎-松山,2023-08-29,9103
3044,健鼎,19,1,18,群益金鼎-松山,2023-08-29,9103
2340,台亞,17,0,17,群益金鼎-松山,2023-08-29,9103
2388,威盛,18,1,17,群益金鼎-松山,2023-08-29,9103
1460,宏遠,15,0,15,群益金鼎-松山,2023-08-29,9103
3362,先進光,26,11,15,群益金鼎-松山,2023-08-29,9103
3710,連展投控,12,0,12,群益金鼎-松山,2023-08-29,9103
2408,南亞科,10,0,10,群益金鼎-松山,2023-08-29,9103
3306,鼎天,10,0,10,群益金鼎-松山,2023-08-29,9103
3363,上詮,14,4,10,群益金鼎-松山,2023-08-29,9103
6274,台燿,23,13,10,群益金鼎-松山,2023-08-29,9103
8050,廣積,11,2,9,群益金鼎-松山,2023-08-29,9103
3037,欣興,13,5,8,群益金鼎-松山,2023-08-29,9103
8016,矽創,8,0,8,群益金鼎-松山,2023-08-29,9103
8183,精星,12,4,8,群益金鼎-松山,2023-08-29,9103
2317,鴻海,13,6,7,群益金鼎-松山,2023-08-29,9103
2379,瑞昱,6,0,6,群益金鼎-松山,2023-08-29,9103
6244,茂迪,6,0,6,群益金鼎-松山,2023-08-29,9103
1319,東陽,6,0,6,群益金鼎-松山,2023-08-29,9103
3017,奇鋐,5,0,5,群益金鼎-松山,2023-08-29,9103
2312,金寶,5,0,5,群益金鼎-松山,2023-08-29,9103
1477,聚陽,5,0,5,群益金鼎-松山,2023-08-29,9103
00679B,元大美債20年,5,0,5,群益金鼎-松山,2023-08-29,9103
2530,華建,5,0,5,群益金鼎-松山,2023-08-29,9103
2929,淘帝-KY,5,0,5,群益金鼎-松山,2023-08-29,9103
3583,辛耘,6,1,5,群益金鼎-松山,2023-08-29,9103
5907,大洋-KY,5,0,5,群益金鼎-松山,2023-08-29,9103
6443,元晶,9,4,5,群益金鼎-松山,2023-08-29,9103
3035,智原,15,11,4,群益金鼎-松山,2023-08-29,9103
4157,太景*-KY,4,0,4,群益金鼎-松山,2023-08-29,9103
4763,材料-KY,4,0,4,群益金鼎-松山,2023-08-29,9103
2880,華南金,3,0,3,群益金鼎-松山,2023-08-29,9103
00929,復華台灣科技優息,3,0,3,群益金鼎-松山,2023-08-29,9103
2250,IKKA-KY,3,0,3,群益金鼎-松山,2023-08-29,9103
2401,凌陽,3,0,3,群益金鼎-松山,2023-08-29,9103
4526,東台,3,0,3,群益金鼎-松山,2023-08-29,9103
4979,華星光,26,23,3,群益金鼎-松山,2023-08-29,9103
5301,寶得利,3,0,3,群益金鼎-松山,2023-08-29,9103
6202,盛群,4,1,3,群益金鼎-松山,2023-08-29,9103
2303,聯電,2,0,2,群益金鼎-松山,2023-08-29,9103
2888,新光金,321,0,321,群益金鼎-松山,2023-08-30,9103
2618,長榮航,201,0,201,群益金鼎-松山,2023-08-30,9103
5371,中光電,50,0,50,群益金鼎-松山,2023-08-30,9103
00673R,期元大S＆P原油反1,40,0,40,群益金鼎-松山,2023-08-30,9103
00637L,元大滬深300正2,44,5,39,群益金鼎-松山,2023-08-30,9103
2337,旺宏,151,119,32,群益金鼎-松山,2023-08-30,9103
2465,麗臺,30,0,30,群益金鼎-松山,2023-08-30,9103
2634,漢翔,50,24,26,群益金鼎-松山,2023-08-30,9103
2402,毅嘉,29,4,25,群益金鼎-松山,2023-08-30,9103
00929,復華台灣科技優息,23,0,23,群益金鼎-松山,2023-08-30,9103
6829,千附精密,21,0,21,群益金鼎-松山,2023-08-30,9103
00632R,元大台灣50反1,20,0,20,群益金鼎-松山,2023-08-30,9103
6164,華興,20,0,20,群益金鼎-松山,2023-08-30,9103
2468,華經,17,0,17,群益金鼎-松山,2023-08-30,9103
3596,智易,17,0,17,群益金鼎-松山,2023-08-30,9103
2455,全新,16,0,16,群益金鼎-松山,2023-08-30,9103
1591,駿吉-KY,15,0,15,群益金鼎-松山,2023-08-30,9103
2301,光寶科,16,1,15,群益金鼎-松山,2023-08-30,9103
3260,威剛,16,3,13,群益金鼎-松山,2023-08-30,9103
3044,健鼎,11,0,11,群益金鼎-松山,2023-08-30,9103
6625,必應,11,0,11,群益金鼎-松山,2023-08-30,9103
1903,士紙,10,0,10,群益金鼎-松山,2023-08-30,9103
1802,台玻,12,2,10,群益金鼎-松山,2023-08-30,9103
6205,詮欣,10,0,10,群益金鼎-松山,2023-08-30,9103
8084,巨虹,10,0,10,群益金鼎-松山,2023-08-30,9103
1314,中石化,8,0,8,群益金鼎-松山,2023-08-30,9103
3231,緯創,11,5,6,群益金鼎-松山,2023-08-30,9103
6271,同欣電,6,0,6,群益金鼎-松山,2023-08-30,9103
6416,瑞祺電通,9,3,6,群益金鼎-松山,2023-08-30,9103
8210,勤誠,19,13,6,群益金鼎-松山,2023-08-30,9103
1618,合機,5,0,5,群益金鼎-松山,2023-08-30,9103
2357,華碩,5,0,5,群益金鼎-松山,2023-08-30,9103
2610,華航,5,0,5,群益金鼎-松山,2023-08-30,9103
5876,上海商銀,5,0,5,群益金鼎-松山,2023-08-30,9103
00893,國泰智能電動車,4,0,4,群益金鼎-松山,2023-08-30,9103
2324,仁寶,4,0,4,群益金鼎-松山,2023-08-30,9103
2331,精英,7,3,4,群益金鼎-松山,2023-08-30,9103
2419,仲琦,10,6,4,群益金鼎-松山,2023-08-30,9103
2485,兆赫,27,23,4,群益金鼎-松山,2023-08-30,9103
3481,群創,4,0,4,群益金鼎-松山,2023-08-30,9103
5009,榮剛,4,0,4,群益金鼎-松山,2023-08-30,9103
6213,聯茂,6,2,4,群益金鼎-松山,2023-08-30,9103
3131,弘塑,3,0,3,群益金鼎-松山,2023-08-30,9103
3217,優群,3,0,3,群益金鼎-松山,2023-08-30,9103
4532,瑞智,3,0,3,群益金鼎-松山,2023-08-30,9103
9958,世紀鋼,3,0,3,群益金鼎-松山,2023-08-30,9103
2633,台灣高鐵,2,0,2,群益金鼎-松山,2023-08-30,9103
020022,元大電動車N,2,0,2,群益金鼎-松山,2023-08-30,9103
3013,晟銘電,8,6,2,群益金鼎-松山,2023-08-30,9103
3041,揚智,12,10,2,群益金鼎-松山,2023-08-30,9103
3715,定穎投控,192,7,185,群益金鼎-松山,2023-08-31,9103
00929,復華台灣科技優息,55,2,53,群益金鼎-松山,2023-08-31,9103
1319,東陽,37,4,33,群益金鼎-松山,2023-08-31,9103
3714,富采,34,2,32,群益金鼎-松山,2023-08-31,9103
8033,雷虎,31,0,31,群益金鼎-松山,2023-08-31,9103
8088,品安,31,1,30,群益金鼎-松山,2023-08-31,9103
2630,亞航,22,0,22,群益金鼎-松山,2023-08-31,9103
3078,僑威,23,3,20,群益金鼎-松山,2023-08-31,9103
2329,華泰,38,20,18,群益金鼎-松山,2023-08-31,9103
1605,華新,22,5,17,群益金鼎-松山,2023-08-31,9103
2376,技嘉,23,6,17,群益金鼎-松山,2023-08-31,9103
5871,中租-KY,15,0,15,群益金鼎-松山,2023-08-31,9103
2388,威盛,12,1,11,群益金鼎-松山,2023-08-31,9103
00633L,富邦上証正2,10,0,10,群益金鼎-松山,2023-08-31,9103
1784,訊聯,10,0,10,群益金鼎-松山,2023-08-31,9103
2349,錸德,10,0,10,群益金鼎-松山,2023-08-31,9103
2633,台灣高鐵,10,0,10,群益金鼎-松山,2023-08-31,9103
2704,國賓,10,0,10,群益金鼎-松山,2023-08-31,9103
2727,王品,10,0,10,群益金鼎-松山,2023-08-31,9103
3043,科風,10,0,10,群益金鼎-松山,2023-08-31,9103
6168,宏齊,10,0,10,群益金鼎-松山,2023-08-31,9103
6770,力積電,10,0,10,群益金鼎-松山,2023-08-31,9103
2002,中鋼,9,0,9,群益金鼎-松山,2023-08-31,9103
2883,凱基金,9,0,9,群益金鼎-松山,2023-08-31,9103
6605,帝寶,20,11,9,群益金鼎-松山,2023-08-31,9103
2383,台光電,20,12,8,群益金鼎-松山,2023-08-31,9103
2530,華建,8,0,8,群益金鼎-松山,2023-08-31,9103
2801,彰銀,8,0,8,群益金鼎-松山,2023-08-31,9103
6285,啟��,10,2,8,群益金鼎-松山,2023-08-31,9103
00693U,期街口S＆P黃豆,7,0,7,群益金鼎-松山,2023-08-31,9103
2409,友達,7,0,7,群益金鼎-松山,2023-08-31,9103
3483,力致,7,0,7,群益金鼎-松山,2023-08-31,9103
5876,上海商銀,7,0,7,群益金鼎-松山,2023-08-31,9103
00715L,期街口布蘭特正2,6,0,6,群益金鼎-松山,2023-08-31,9103
00637L,元大滬深300正2,6,0,6,群益金鼎-松山,2023-08-31,9103
2344,華邦電,6,0,6,群益金鼎-松山,2023-08-31,9103
2891,中信金,6,0,6,群益金鼎-松山,2023-08-31,9103
5457,宣德,6,0,6,群益金鼎-松山,2023-08-31,9103
3711,日月光投控,5,0,5,群益金鼎-松山,2023-08-31,9103
6111,大宇資,7,2,5,群益金鼎-松山,2023-08-31,9103
6546,正基,5,0,5,群益金鼎-松山,2023-08-31,9103
8016,矽創,5,0,5,群益金鼎-松山,2023-08-31,9103
00930,永豐ESG低碳高息,4,0,4,群益金鼎-松山,2023-08-31,9103
2250,IKKA-KY,4,0,4,群益金鼎-松山,2023-08-31,9103
2353,宏��,4,0,4,群益金鼎-松山,2023-08-31,9103
2455,全新,6,2,4,群益金鼎-松山,2023-08-31,9103
2618,長榮航,4,0,4,群益金鼎-松山,2023-08-31,9103
4532,瑞智,4,0,4,群益金鼎-松山,2023-08-31,9103
8996,高力,9,5,4,群益金鼎-松山,2023-08-31,9103
2301,光寶科,10,7,3,群益金鼎-松山,2023-08-31,9103
00919,群益台灣精選高息,59,0,59,群益金鼎-松山,2023-09-01,9103
2402,毅嘉,165,130,35,群益金鼎-松山,2023-09-01,9103
2206,三陽工業,27,1,26,群益金鼎-松山,2023-09-01,9103
2485,兆赫,57,31,26,群益金鼎-松山,2023-09-01,9103
6118,建達,26,0,26,群益金鼎-松山,2023-09-01,9103
3051,力特,30,8,22,群益金鼎-松山,2023-09-01,9103
2816,旺旺保,20,0,20,群益金鼎-松山,2023-09-01,9103
1529,樂事綠能,18,0,18,群益金鼎-松山,2023-09-01,9103
3163,波若威,23,5,18,群益金鼎-松山,2023-09-01,9103
3260,威剛,19,1,18,群益金鼎-松山,2023-09-01,9103
3664,安瑞-KY,18,0,18,群益金鼎-松山,2023-09-01,9103
2376,技嘉,42,24,18,群益金鼎-松山,2023-09-01,9103
2301,光寶科,37,20,17,群益金鼎-松山,2023-09-01,9103
00715L,期街口布蘭特正2,16,0,16,群益金鼎-松山,2023-09-01,9103
3325,旭品,16,0,16,群益金鼎-松山,2023-09-01,9103
6104,創惟,16,0,16,群益金鼎-松山,2023-09-01,9103
6276,安鈦克,16,0,16,群益金鼎-松山,2023-09-01,9103
8084,巨虹,15,0,15,群益金鼎-松山,2023-09-01,9103
6547,高端疫苗,17,2,15,群益金鼎-松山,2023-09-01,9103
3231,緯創,19,5,14,群益金鼎-松山,2023-09-01,9103
2382,廣達,19,6,13,群益金鼎-松山,2023-09-01,9103
3046,建��,12,0,12,群益金鼎-松山,2023-09-01,9103
2356,英業達,48,36,12,群益金鼎-松山,2023-09-01,9103
2482,連宇,12,0,12,群益金鼎-松山,2023-09-01,9103
6282,康舒,21,9,12,群益金鼎-松山,2023-09-01,9103
2371,大同,14,3,11,群益金鼎-松山,2023-09-01,9103
2368,金像電,12,1,11,群益金鼎-松山,2023-09-01,9103
3504,揚明光,11,0,11,群益金鼎-松山,2023-09-01,9103
00632R,元大台灣50反1,10,0,10,群益金鼎-松山,2023-09-01,9103
00753L,中信中國50正2,10,0,10,群益金鼎-松山,2023-09-01,9103
2316,楠梓電,10,0,10,群益金鼎-松山,2023-09-01,9103
2838,聯邦銀,10,0,10,群益金鼎-松山,2023-09-01,9103
6188,廣明,10,0,10,群益金鼎-松山,2023-09-01,9103
9945,潤泰新,10,0,10,群益金鼎-松山,2023-09-01,9103
2355,敬鵬,9,0,9,群益金鼎-松山,2023-09-01,9103
3011,今皓,11,2,9,群益金鼎-松山,2023-09-01,9103
6443,元晶,14,5,9,群益金鼎-松山,2023-09-01,9103
00878,國泰永續高股息,9,1,8,群益金鼎-松山,2023-09-01,9103
3205,佰研,8,0,8,群益金鼎-松山,2023-09-01,9103
4563,百德,8,0,8,群益金鼎-松山,2023-09-01,9103
5864,致和證,8,0,8,群益金鼎-松山,2023-09-01,9103
00735,國泰臺韓科技,7,0,7,群益金鼎-松山,2023-09-01,9103
6271,同欣電,7,0,7,群益金鼎-松山,2023-09-01,9103
6643,M31,7,0,7,群益金鼎-松山,2023-09-01,9103
8927,北基,8,1,7,群益金鼎-松山,2023-09-01,9103
00929,復華台灣科技優息,6,0,6,群益金鼎-松山,2023-09-01,9103
2324,仁寶,6,0,6,群益金鼎-松山,2023-09-01,9103
2359,所羅門,6,0,6,群益金鼎-松山,2023-09-01,9103
2634,漢翔,42,36,6,群益金鼎-松山,2023-09-01,9103
2745,五福,7,1,6,群益金鼎-松山,2023-09-01,9103
2462,良得電,150,0,150,群益金鼎-松山,2023-09-04,9103
2888,新光金,80,5,75,群益金鼎-松山,2023-09-04,9103
00929,復華台灣科技優息,71,0,71,群益金鼎-松山,2023-09-04,9103
1802,台玻,57,15,42,群益金鼎-松山,2023-09-04,9103
2371,大同,33,11,22,群益金鼎-松山,2023-09-04,9103
2363,矽統,57,37,20,群益金鼎-松山,2023-09-04,9103
5014,建錩,20,0,20,群益金鼎-松山,2023-09-04,9103
6213,聯茂,20,3,17,群益金鼎-松山,2023-09-04,9103
3231,緯創,23,9,14,群益金鼎-松山,2023-09-04,9103
00687B,國泰20年美債,13,0,13,群益金鼎-松山,2023-09-04,9103
2331,精英,13,0,13,群益金鼎-松山,2023-09-04,9103
2301,光寶科,27,15,12,群益金鼎-松山,2023-09-04,9103
3714,富采,12,0,12,群益金鼎-松山,2023-09-04,9103
2455,全新,18,7,11,群益金鼎-松山,2023-09-04,9103
6112,邁達特,34,23,11,群益金鼎-松山,2023-09-04,9103
00632R,元大台灣50反1,10,0,10,群益金鼎-松山,2023-09-04,9103
3306,鼎天,10,0,10,群益金鼎-松山,2023-09-04,9103
4746,台耀,12,2,10,群益金鼎-松山,2023-09-04,9103
3715,定穎投控,13,4,9,群益金鼎-松山,2023-09-04,9103
2891,中信金,9,0,9,群益金鼎-松山,2023-09-04,9103
9919,康那香,7,0,7,群益金鼎-松山,2023-09-04,9103
1609,大亞,6,0,6,群益金鼎-松山,2023-09-04,9103
3011,今皓,8,2,6,群益金鼎-松山,2023-09-04,9103
5439,高技,6,0,6,群益金鼎-松山,2023-09-04,9103
6125,廣運,6,0,6,群益金鼎-松山,2023-09-04,9103
8996,高力,8,2,6,群益金鼎-松山,2023-09-04,9103
2884,玉山金,5,0,5,群益金鼎-松山,2023-09-04,9103
00713,元大台灣高息低波,5,0,5,群益金鼎-松山,2023-09-04,9103
00751B,元大AAA至A公司債,5,0,5,群益金鼎-松山,2023-09-04,9103
00720B,元大投資級公司債,5,0,5,群益金鼎-松山,2023-09-04,9103
00931B,統一美債20年,5,0,5,群益金鼎-松山,2023-09-04,9103
00919,群益台灣精選高息,6,1,5,群益金鼎-松山,2023-09-04,9103
3036,文曄,5,0,5,群益金鼎-松山,2023-09-04,9103
3481,群創,5,0,5,群益金鼎-松山,2023-09-04,9103
4979,華星光,5,0,5,群益金鼎-松山,2023-09-04,9103
2376,技嘉,12,7,5,群益金鼎-松山,2023-09-04,9103
2323,中環,4,0,4,群益金鼎-松山,2023-09-04,9103
2401,凌陽,4,0,4,群益金鼎-松山,2023-09-04,9103
3545,敦泰,4,0,4,群益金鼎-松山,2023-09-04,9103
3706,神達,4,0,4,群益金鼎-松山,2023-09-04,9103
4763,材料-KY,4,0,4,群益金鼎-松山,2023-09-04,9103
6271,同欣電,4,0,4,群益金鼎-松山,2023-09-04,9103
6811,宏�硌穈T,8,4,4,群益金鼎-松山,2023-09-04,9103
8076,伍豐,4,0,4,群益金鼎-松山,2023-09-04,9103
6547,高端疫苗,4,0,4,群益金鼎-松山,2023-09-04,9103
1519,華城,7,4,3,群益金鼎-松山,2023-09-04,9103
2374,佳能,3,0,3,群益金鼎-松山,2023-09-04,9103
3049,精金,3,0,3,群益金鼎-松山,2023-09-04,9103
3059,華晶科,3,0,3,群益金鼎-松山,2023-09-04,9103
3290,東浦,3,0,3,群益金鼎-松山,2023-09-04,9103
00632R,元大台灣50反1,165,0,165,群益金鼎-松山,2023-09-05,9103
5469,瀚宇博,92,0,92,群益金鼎-松山,2023-09-05,9103
00929,復華台灣科技優息,87,2,85,群益金鼎-松山,2023-09-05,9103
00706L,期元大S＆P日圓正2,50,10,40,群益金鼎-松山,2023-09-05,9103
6456,GIS-KY,36,0,36,群益金鼎-松山,2023-09-05,9103
6191,精成科,37,2,35,群益金鼎-松山,2023-09-05,9103
2363,矽統,43,10,33,群益金鼎-松山,2023-09-05,9103
2485,兆赫,30,1,29,群益金鼎-松山,2023-09-05,9103
00919,群益台灣精選高息,24,0,24,群益金鼎-松山,2023-09-05,9103
2330,台積電,20,0,20,群益金鼎-松山,2023-09-05,9103
2382,廣達,20,1,19,群益金鼎-松山,2023-09-05,9103
8086,宏捷科,20,2,18,群益金鼎-松山,2023-09-05,9103
4746,台耀,12,0,12,群益金鼎-松山,2023-09-05,9103
2308,台達電,11,0,11,群益金鼎-松山,2023-09-05,9103
6235,華孚,18,7,11,群益金鼎-松山,2023-09-05,9103
6531,愛普*,13,2,11,群益金鼎-松山,2023-09-05,9103
2402,毅嘉,21,11,10,群益金鼎-松山,2023-09-05,9103
00713,元大台灣高息低波,10,0,10,群益金鼎-松山,2023-09-05,9103
3362,先進光,20,10,10,群益金鼎-松山,2023-09-05,9103
6205,詮欣,10,0,10,群益金鼎-松山,2023-09-05,9103
00878,國泰永續高股息,12,2,10,群益金鼎-松山,2023-09-05,9103
3231,緯創,11,3,8,群益金鼎-松山,2023-09-05,9103
3454,晶睿,8,0,8,群益金鼎-松山,2023-09-05,9103
8081,致新,8,0,8,群益金鼎-松山,2023-09-05,9103
2344,華邦電,7,0,7,群益金鼎-松山,2023-09-05,9103
2884,玉山金,7,0,7,群益金鼎-松山,2023-09-05,9103
2913,農林,7,0,7,群益金鼎-松山,2023-09-05,9103
3163,波若威,9,2,7,群益金鼎-松山,2023-09-05,9103
6188,廣明,9,2,7,群益金鼎-松山,2023-09-05,9103
1477,聚陽,6,0,6,群益金鼎-松山,2023-09-05,9103
5381,合正,10,4,6,群益金鼎-松山,2023-09-05,9103
6538,倉和,9,3,6,群益金鼎-松山,2023-09-05,9103
8084,巨虹,6,0,6,群益金鼎-松山,2023-09-05,9103
00918,大華優利高填息30,5,0,5,群益金鼎-松山,2023-09-05,9103
3047,訊舟,5,0,5,群益金鼎-松山,2023-09-05,9103
3406,玉晶光,5,0,5,群益金鼎-松山,2023-09-05,9103
4958,臻鼎-KY,5,0,5,群益金鼎-松山,2023-09-05,9103
5009,榮剛,5,0,5,群益金鼎-松山,2023-09-05,9103
6285,啟��,6,1,5,群益金鼎-松山,2023-09-05,9103
8033,雷虎,4,0,4,群益金鼎-松山,2023-09-05,9103
2409,友達,3,0,3,群益金鼎-松山,2023-09-05,9103
2301,光寶科,28,25,3,群益金鼎-松山,2023-09-05,9103
1305,華夏,3,0,3,群益金鼎-松山,2023-09-05,9103
1618,合機,7,4,3,群益金鼎-松山,2023-09-05,9103
2618,長榮航,3,0,3,群益金鼎-松山,2023-09-05,9103
2891,中信金,3,0,3,群益金鼎-松山,2023-09-05,9103
6643,M31,3,0,3,群益金鼎-松山,2023-09-05,9103
8409,商之器,3,0,3,群益金鼎-松山,2023-09-05,9103
2458,義隆,3,0,3,群益金鼎-松山,2023-09-05,9103
2645,長榮航太,2,0,2,群益金鼎-松山,2023-09-05,9103
2402,毅嘉,327,12,315,群益金鼎-松山,2023-09-06,9103
00929,復華台灣科技優息,85,23,62,群益金鼎-松山,2023-09-06,9103
6209,今國光,40,0,40,群益金鼎-松山,2023-09-06,9103
2401,凌陽,34,5,29,群益金鼎-松山,2023-09-06,9103
8112,至上,28,4,24,群益金鼎-松山,2023-09-06,9103
00713,元大台灣高息低波,20,0,20,群益金鼎-松山,2023-09-06,9103
00680L,元大美債20正2,20,0,20,群益金鼎-松山,2023-09-06,9103
6117,迎廣,29,9,20,群益金鼎-松山,2023-09-06,9103
2204,中華,20,0,20,群益金鼎-松山,2023-09-06,9103
2383,台光電,21,3,18,群益金鼎-松山,2023-09-06,9103
6285,啟��,24,6,18,群益金鼎-松山,2023-09-06,9103
8210,勤誠,20,3,17,群益金鼎-松山,2023-09-06,9103
1101,台泥,16,0,16,群益金鼎-松山,2023-09-06,9103
2308,台達電,14,0,14,群益金鼎-松山,2023-09-06,9103
5258,虹堡,25,12,13,群益金鼎-松山,2023-09-06,9103
8349,�矬�,13,0,13,群益金鼎-松山,2023-09-06,9103
6191,精成科,14,1,13,群益金鼎-松山,2023-09-06,9103
8150,南茂,10,0,10,群益金鼎-松山,2023-09-06,9103
1605,華新,10,0,10,群益金鼎-松山,2023-09-06,9103
00706L,期元大S＆P日圓正2,15,5,10,群益金鼎-松山,2023-09-06,9103
2409,友達,10,0,10,群益金鼎-松山,2023-09-06,9103
2880,華南金,10,0,10,群益金鼎-松山,2023-09-06,9103
3289,宜特,11,1,10,群益金鼎-松山,2023-09-06,9103
3704,合勤控,16,6,10,群益金鼎-松山,2023-09-06,9103
6416,瑞祺電通,10,0,10,群益金鼎-松山,2023-09-06,9103
5876,上海商銀,9,0,9,群益金鼎-松山,2023-09-06,9103
3481,群創,9,0,9,群益金鼎-松山,2023-09-06,9103
2618,長榮航,6,0,6,群益金鼎-松山,2023-09-06,9103
2884,玉山金,6,0,6,群益金鼎-松山,2023-09-06,9103
00696B,富邦美債20年,5,0,5,群益金鼎-松山,2023-09-06,9103
00751B,元大AAA至A公司債,5,0,5,群益金鼎-松山,2023-09-06,9103
00918,大華優利高填息30,5,0,5,群益金鼎-松山,2023-09-06,9103
00896,中信綠能及電動車,5,0,5,群益金鼎-松山,2023-09-06,9103
2323,中環,5,0,5,群益金鼎-松山,2023-09-06,9103
2356,英業達,5,0,5,群益金鼎-松山,2023-09-06,9103
3558,神準,5,0,5,群益金鼎-松山,2023-09-06,9103
6584,南俊國際,5,0,5,群益金鼎-松山,2023-09-06,9103
8234,新漢,5,0,5,群益金鼎-松山,2023-09-06,9103
3264,欣銓,5,0,5,群益金鼎-松山,2023-09-06,9103
2329,華泰,4,0,4,群益金鼎-松山,2023-09-06,9103
8996,高力,6,2,4,群益金鼎-松山,2023-09-06,9103
1216,統一,4,0,4,群益金鼎-松山,2023-09-06,9103
00931B,統一美債20年,4,0,4,群益金鼎-松山,2023-09-06,9103
2331,精英,5,1,4,群益金鼎-松山,2023-09-06,9103
2376,技嘉,5,1,4,群益金鼎-松山,2023-09-06,9103
3715,定穎投控,13,9,4,群益金鼎-松山,2023-09-06,9103
00882,中信中國高股息,3,0,3,群益金鼎-松山,2023-09-06,9103
2312,金寶,11,8,3,群益金鼎-松山,2023-09-06,9103
2355,敬鵬,4,1,3,群益金鼎-松山,2023-09-06,9103
2358,廷鑫,3,0,3,群益金鼎-松山,2023-09-06,9103
2401,凌陽,263,30,233,群益金鼎-松山,2023-09-07,9103
5225,東科-KY,60,0,60,群益金鼎-松山,2023-09-07,9103
00929,復華台灣科技優息,87,42,45,群益金鼎-松山,2023-09-07,9103
00915,凱基優選高股息30,45,1,44,群益金鼎-松山,2023-09-07,9103
2337,旺宏,40,0,40,群益金鼎-松山,2023-09-07,9103
3213,茂訊,39,1,38,群益金鼎-松山,2023-09-07,9103
2486,一詮,37,4,33,群益金鼎-松山,2023-09-07,9103
2363,矽統,51,21,30,群益金鼎-松山,2023-09-07,9103
2316,楠梓電,57,30,27,群益金鼎-松山,2023-09-07,9103
5469,瀚宇博,22,0,22,群益金鼎-松山,2023-09-07,9103
6274,台燿,35,15,20,群益金鼎-松山,2023-09-07,9103
8271,宇瞻,20,0,20,群益金鼎-松山,2023-09-07,9103
00919,群益台灣精選高息,23,5,18,群益金鼎-松山,2023-09-07,9103
3714,富采,19,3,16,群益金鼎-松山,2023-09-07,9103
1101,台泥,15,0,15,群益金鼎-松山,2023-09-07,9103
00633L,富邦上証正2,15,0,15,群益金鼎-松山,2023-09-07,9103
2362,藍天,15,1,14,群益金鼎-松山,2023-09-07,9103
6188,廣明,16,3,13,群益金鼎-松山,2023-09-07,9103
00637L,元大滬深300正2,12,0,12,群益金鼎-松山,2023-09-07,9103
2301,光寶科,20,8,12,群益金鼎-松山,2023-09-07,9103
2355,敬鵬,11,0,11,群益金鼎-松山,2023-09-07,9103
4977,眾達-KY,12,1,11,群益金鼎-松山,2023-09-07,9103
2408,南亞科,10,0,10,群益金鼎-松山,2023-09-07,9103
2887,台新金,10,0,10,群益金鼎-松山,2023-09-07,9103
4306,炎洲,10,0,10,群益金鼎-松山,2023-09-07,9103
2455,全新,20,11,9,群益金鼎-松山,2023-09-07,9103
6122,擎邦,9,0,9,群益金鼎-松山,2023-09-07,9103
3481,群創,9,0,9,群益金鼎-松山,2023-09-07,9103
3228,金麗科,8,0,8,群益金鼎-松山,2023-09-07,9103
8349,�矬�,8,0,8,群益金鼎-松山,2023-09-07,9103
3704,合勤控,10,3,7,群益金鼎-松山,2023-09-07,9103
6416,瑞祺電通,7,0,7,群益金鼎-松山,2023-09-07,9103
8084,巨虹,6,0,6,群益金鼎-松山,2023-09-07,9103
2402,毅嘉,13,8,5,群益金鼎-松山,2023-09-07,9103
00655L,國泰中國A50正2,5,0,5,群益金鼎-松山,2023-09-07,9103
2482,連宇,5,0,5,群益金鼎-松山,2023-09-07,9103
2618,長榮航,7,2,5,群益金鼎-松山,2023-09-07,9103
3013,晟銘電,12,7,5,群益金鼎-松山,2023-09-07,9103
3014,聯陽,5,0,5,群益金鼎-松山,2023-09-07,9103
4174,浩鼎,5,0,5,群益金鼎-松山,2023-09-07,9103
4533,協易機,48,43,5,群益金鼎-松山,2023-09-07,9103
8150,南茂,5,0,5,群益金鼎-松山,2023-09-07,9103
1736,喬山,4,0,4,群益金鼎-松山,2023-09-07,9103
2312,金寶,16,12,4,群益金鼎-松山,2023-09-07,9103
2457,飛宏,7,3,4,群益金鼎-松山,2023-09-07,9103
2614,東森,4,0,4,群益金鼎-松山,2023-09-07,9103
2645,長榮航太,4,0,4,群益金鼎-松山,2023-09-07,9103
3078,僑威,5,1,4,群益金鼎-松山,2023-09-07,9103
6456,GIS-KY,4,0,4,群益金鼎-松山,2023-09-07,9103
9927,泰銘,4,0,4,群益金鼎-松山,2023-09-07,9103
1522,堤維西,67,0,67,群益金鼎-松山,2023-09-08,9103
1217,愛之味,130,72,58,群益金鼎-松山,2023-09-08,9103
2630,亞航,42,0,42,群益金鼎-松山,2023-09-08,9103
1471,首利,36,2,34,群益金鼎-松山,2023-09-08,9103
3483,力致,34,13,21,群益金鼎-松山,2023-09-08,9103
2408,南亞科,20,0,20,群益金鼎-松山,2023-09-08,9103
2816,旺旺保,38,18,20,群益金鼎-松山,2023-09-08,9103
00919,群益台灣精選高息,18,1,17,群益金鼎-松山,2023-09-08,9103
2402,毅嘉,30,13,17,群益金鼎-松山,2023-09-08,9103
2313,華通,23,7,16,群益金鼎-松山,2023-09-08,9103
00637L,元大滬深300正2,16,0,16,群益金鼎-松山,2023-09-08,9103
2344,華邦電,16,0,16,群益金鼎-松山,2023-09-08,9103
2634,漢翔,15,1,14,群益金鼎-松山,2023-09-08,9103
2538,基泰,12,0,12,群益金鼎-松山,2023-09-08,9103
3027,盛達,12,0,12,群益金鼎-松山,2023-09-08,9103
5371,中光電,12,0,12,群益金鼎-松山,2023-09-08,9103
00918,大華優利高填息30,10,0,10,群益金鼎-松山,2023-09-08,9103
2385,群光,10,0,10,群益金鼎-松山,2023-09-08,9103
6274,台燿,32,25,7,群益金鼎-松山,2023-09-08,9103
00915,凱基優選高股息30,6,0,6,群益金鼎-松山,2023-09-08,9103
3011,今皓,6,0,6,群益金鼎-松山,2023-09-08,9103
3051,力特,6,0,6,群益金鼎-松山,2023-09-08,9103
3711,日月光投控,6,0,6,群益金鼎-松山,2023-09-08,9103
2482,連宇,5,0,5,群益金鼎-松山,2023-09-08,9103
3017,奇鋐,15,10,5,群益金鼎-松山,2023-09-08,9103
3163,波若威,7,2,5,群益金鼎-松山,2023-09-08,9103
6416,瑞祺電通,5,0,5,群益金鼎-松山,2023-09-08,9103
8210,勤誠,8,3,5,群益金鼎-松山,2023-09-08,9103
2449,京元電子,6,2,4,群益金鼎-松山,2023-09-08,9103
3013,晟銘電,9,5,4,群益金鼎-松山,2023-09-08,9103
3043,科風,6,2,4,群益金鼎-松山,2023-09-08,9103
3260,威剛,6,2,4,群益金鼎-松山,2023-09-08,9103
5225,東科-KY,5,1,4,群益金鼎-松山,2023-09-08,9103
6125,廣運,5,1,4,群益金鼎-松山,2023-09-08,9103
6584,南俊國際,4,0,4,群益金鼎-松山,2023-09-08,9103
8390,金益鼎,4,0,4,群益金鼎-松山,2023-09-08,9103
8433,弘帆,4,0,4,群益金鼎-松山,2023-09-08,9103
2356,英業達,4,1,3,群益金鼎-松山,2023-09-08,9103
3558,神準,3,0,3,群益金鼎-松山,2023-09-08,9103
1307,三芳,3,0,3,群益金鼎-松山,2023-09-08,9103
1514,亞力,3,0,3,群益金鼎-松山,2023-09-08,9103
2915,潤泰全,3,0,3,群益金鼎-松山,2023-09-08,9103
3162,精確,3,0,3,群益金鼎-松山,2023-09-08,9103
6187,萬潤,5,2,3,群益金鼎-松山,2023-09-08,9103
6593,台灣銘板,4,1,3,群益金鼎-松山,2023-09-08,9103
2376,技嘉,10,8,2,群益金鼎-松山,2023-09-08,9103
3037,欣興,2,0,2,群益金鼎-松山,2023-09-08,9103
1519,華城,2,0,2,群益金鼎-松山,2023-09-08,9103
1609,大亞,2,0,2,群益金鼎-松山,2023-09-08,9103
2201,裕隆,2,0,2,群益金鼎-松山,2023-09-08,9103
00929,復華台灣科技優息,116,0,116,群益金鼎-松山,2023-09-11,9103
00919,群益台灣精選高息,57,0,57,群益金鼎-松山,2023-09-11,9103
3213,茂訊,35,0,35,群益金鼎-松山,2023-09-11,9103
2630,亞航,37,3,34,群益金鼎-松山,2023-09-11,9103
00712,復華富時不動產,30,0,30,群益金鼎-松山,2023-09-11,9103
2485,兆赫,30,1,29,群益金鼎-松山,2023-09-11,9103
6150,撼訊,27,0,27,群益金鼎-松山,2023-09-11,9103
2915,潤泰全,25,0,25,群益金鼎-松山,2023-09-11,9103
2405,輔信,81,58,23,群益金鼎-松山,2023-09-11,9103
7402,邑錡,22,0,22,群益金鼎-松山,2023-09-11,9103
3260,威剛,26,12,14,群益金鼎-松山,2023-09-11,9103
6274,台燿,36,22,14,群益金鼎-松山,2023-09-11,9103
2883,凱基金,17,4,13,群益金鼎-松山,2023-09-11,9103
8033,雷虎,11,0,11,群益金鼎-松山,2023-09-11,9103
4533,協易機,10,0,10,群益金鼎-松山,2023-09-11,9103
2399,映泰,10,0,10,群益金鼎-松山,2023-09-11,9103
5512,力麒,10,0,10,群益金鼎-松山,2023-09-11,9103
6143,振曜,10,0,10,群益金鼎-松山,2023-09-11,9103
6205,詮欣,10,0,10,群益金鼎-松山,2023-09-11,9103
6222,上揚,10,0,10,群益金鼎-松山,2023-09-11,9103
8086,宏捷科,12,2,10,群益金鼎-松山,2023-09-11,9103
3027,盛達,21,12,9,群益金鼎-松山,2023-09-11,9103
6117,迎廣,9,0,9,群益金鼎-松山,2023-09-11,9103
00878,國泰永續高股息,25,16,9,群益金鼎-松山,2023-09-11,9103
6125,廣運,8,0,8,群益金鼎-松山,2023-09-11,9103
1795,美時,8,0,8,群益金鼎-松山,2023-09-11,9103
2344,華邦電,6,0,6,群益金鼎-松山,2023-09-11,9103
2427,三商電,6,0,6,群益金鼎-松山,2023-09-11,9103
3025,星通,6,0,6,群益金鼎-松山,2023-09-11,9103
5371,中光電,7,1,6,群益金鼎-松山,2023-09-11,9103
6416,瑞祺電通,7,1,6,群益金鼎-松山,2023-09-11,9103
8084,巨虹,6,0,6,群益金鼎-松山,2023-09-11,9103
8289,泰藝,6,0,6,群益金鼎-松山,2023-09-11,9103
00900,富邦特選高股息30,5,0,5,群益金鼎-松山,2023-09-11,9103
00918,大華優利高填息30,5,0,5,群益金鼎-松山,2023-09-11,9103
00706L,期元大S＆P日圓正2,5,0,5,群益金鼎-松山,2023-09-11,9103
2353,宏��,5,0,5,群益金鼎-松山,2023-09-11,9103
2887,台新金,5,0,5,群益金鼎-松山,2023-09-11,9103
8996,高力,8,3,5,群益金鼎-松山,2023-09-11,9103
2330,台積電,5,0,5,群益金鼎-松山,2023-09-11,9103
00715L,期街口布蘭特正2,4,0,4,群益金鼎-松山,2023-09-11,9103
00915,凱基優選高股息30,4,0,4,群益金鼎-松山,2023-09-11,9103
00907,永豐優息存股,4,0,4,群益金鼎-松山,2023-09-11,9103
00931B,統一美債20年,4,0,4,群益金鼎-松山,2023-09-11,9103
00930,永豐ESG低碳高息,4,0,4,群益金鼎-松山,2023-09-11,9103
00888,永豐台灣ESG,4,0,4,群益金鼎-松山,2023-09-11,9103
2371,大同,4,0,4,群益金鼎-松山,2023-09-11,9103
2388,威盛,4,0,4,群益金鼎-松山,2023-09-11,9103
3545,敦泰,5,1,4,群益金鼎-松山,2023-09-11,9103
3693,營邦,4,0,4,群益金鼎-松山,2023-09-11,9103
2355,敬鵬,235,0,235,群益金鼎-松山,2023-09-12,9103
6625,必應,35,0,35,群益金鼎-松山,2023-09-12,9103
00919,群益台灣精選高息,32,0,32,群益金鼎-松山,2023-09-12,9103
00715L,期街口布蘭特正2,30,0,30,群益金鼎-松山,2023-09-12,9103
6282,康舒,33,4,29,群益金鼎-松山,2023-09-12,9103
1471,首利,30,3,27,群益金鼎-松山,2023-09-12,9103
3231,緯創,27,5,22,群益金鼎-松山,2023-09-12,9103
3363,上詮,40,20,20,群益金鼎-松山,2023-09-12,9103
3376,新日興,20,0,20,群益金鼎-松山,2023-09-12,9103
4945,陞達科技,20,0,20,群益金鼎-松山,2023-09-12,9103
00929,復華台灣科技優息,18,0,18,群益金鼎-松山,2023-09-12,9103
2887,台新金,15,0,15,群益金鼎-松山,2023-09-12,9103
2405,輔信,41,30,11,群益金鼎-松山,2023-09-12,9103
2630,亞航,37,28,9,群益金鼎-松山,2023-09-12,9103
2316,楠梓電,28,20,8,群益金鼎-松山,2023-09-12,9103
2363,矽統,22,14,8,群益金鼎-松山,2023-09-12,9103
2402,毅嘉,14,6,8,群益金鼎-松山,2023-09-12,9103
00878,國泰永續高股息,7,0,7,群益金鼎-松山,2023-09-12,9103
6125,廣運,57,51,6,群益金鼎-松山,2023-09-12,9103
2645,長榮航太,12,6,6,群益金鼎-松山,2023-09-12,9103
2382,廣達,7,1,6,群益金鼎-松山,2023-09-12,9103
3545,敦泰,6,0,6,群益金鼎-松山,2023-09-12,9103
6120,達運,7,1,6,群益金鼎-松山,2023-09-12,9103
6274,台燿,8,2,6,群益金鼎-松山,2023-09-12,9103
8048,德勝,6,0,6,群益金鼎-松山,2023-09-12,9103
8234,新漢,6,0,6,群益金鼎-松山,2023-09-12,9103
2002,中鋼,5,0,5,群益金鼎-松山,2023-09-12,9103
1101,台泥,5,0,5,群益金鼎-松山,2023-09-12,9103
00632R,元大台灣50反1,5,0,5,群益金鼎-松山,2023-09-12,9103
00696B,富邦美債20年,5,0,5,群益金鼎-松山,2023-09-12,9103
00751B,元大AAA至A公司債,5,0,5,群益金鼎-松山,2023-09-12,9103
3715,定穎投控,5,0,5,群益金鼎-松山,2023-09-12,9103
4931,新盛力,5,0,5,群益金鼎-松山,2023-09-12,9103
5301,寶得利,5,0,5,群益金鼎-松山,2023-09-12,9103
5371,中光電,5,0,5,群益金鼎-松山,2023-09-12,9103
6176,瑞儀,5,0,5,群益金鼎-松山,2023-09-12,9103
6715,嘉基,5,0,5,群益金鼎-松山,2023-09-12,9103
8996,高力,7,2,5,群益金鼎-松山,2023-09-12,9103
7402,邑錡,6,1,5,群益金鼎-松山,2023-09-12,9103
00915,凱基優選高股息30,4,0,4,群益金鼎-松山,2023-09-12,9103
4533,協易機,4,0,4,群益金鼎-松山,2023-09-12,9103
4916,事欣科,14,10,4,群益金鼎-松山,2023-09-12,9103
9938,百和,4,0,4,群益金鼎-松山,2023-09-12,9103
1533,車王電,3,0,3,群益金鼎-松山,2023-09-12,9103
2356,英業達,5,2,3,群益金鼎-松山,2023-09-12,9103
3042,晶技,3,0,3,群益金鼎-松山,2023-09-12,9103
3162,精確,3,0,3,群益金鼎-松山,2023-09-12,9103
4906,正文,4,1,3,群益金鼎-松山,2023-09-12,9103
6188,廣明,5,2,3,群益金鼎-松山,2023-09-12,9103
8069,元太,3,0,3,群益金鼎-松山,2023-09-12,9103
1217,愛之味,135,0,135,群益金鼎-松山,2023-09-13,9103
3011,今皓,28,0,28,群益金鼎-松山,2023-09-13,9103
2442,新美齊,63,40,23,群益金鼎-松山,2023-09-13,9103
3005,神基,31,8,23,群益金鼎-松山,2023-09-13,9103
1524,耿鼎,29,9,20,群益金鼎-松山,2023-09-13,9103
2363,矽統,31,13,18,群益金鼎-松山,2023-09-13,9103
2387,精元,16,0,16,群益金鼎-松山,2023-09-13,9103
8150,南茂,14,0,14,群益金鼎-松山,2023-09-13,9103
2331,精英,11,0,11,群益金鼎-松山,2023-09-13,9103
00632R,元大台灣50反1,10,0,10,群益金鼎-松山,2023-09-13,9103
2313,華通,45,35,10,群益金鼎-松山,2023-09-13,9103
2485,兆赫,10,0,10,群益金鼎-松山,2023-09-13,9103
2838,聯邦銀,10,0,10,群益金鼎-松山,2023-09-13,9103
3685,元創精密,10,0,10,群益金鼎-松山,2023-09-13,9103
4960,誠美材,10,0,10,群益金鼎-松山,2023-09-13,9103
6285,啟��,10,0,10,群益金鼎-松山,2023-09-13,9103
2489,瑞軒,9,0,9,群益金鼎-松山,2023-09-13,9103
2383,台光電,12,3,9,群益金鼎-松山,2023-09-13,9103
3483,力致,10,2,8,群益金鼎-松山,2023-09-13,9103
3711,日月光投控,7,0,7,群益金鼎-松山,2023-09-13,9103
3290,東浦,7,0,7,群益金鼎-松山,2023-09-13,9103
2352,佳世達,8,2,6,群益金鼎-松山,2023-09-13,9103
1903,士紙,10,5,5,群益金鼎-松山,2023-09-13,9103
00637L,元大滬深300正2,5,0,5,群益金鼎-松山,2023-09-13,9103
00915,凱基優選高股息30,5,0,5,群益金鼎-松山,2023-09-13,9103
2317,鴻海,5,0,5,群益金鼎-松山,2023-09-13,9103
2344,華邦電,5,0,5,群益金鼎-松山,2023-09-13,9103
3163,波若威,7,2,5,群益金鼎-松山,2023-09-13,9103
3450,聯鈞,5,0,5,群益金鼎-松山,2023-09-13,9103
6188,廣明,7,2,5,群益金鼎-松山,2023-09-13,9103
6205,詮欣,5,0,5,群益金鼎-松山,2023-09-13,9103
6269,台郡,5,0,5,群益金鼎-松山,2023-09-13,9103
00930,永豐ESG低碳高息,5,0,5,群益金鼎-松山,2023-09-13,9103
00929,復華台灣科技優息,11,7,4,群益金鼎-松山,2023-09-13,9103
9924,福興,4,0,4,群益金鼎-松山,2023-09-13,9103
2301,光寶科,4,0,4,群益金鼎-松山,2023-09-13,9103
00888,永豐台灣ESG,4,0,4,群益金鼎-松山,2023-09-13,9103
3693,營邦,5,1,4,群益金鼎-松山,2023-09-13,9103
2201,裕隆,4,0,4,群益金鼎-松山,2023-09-13,9103
2610,華航,4,0,4,群益金鼎-松山,2023-09-13,9103
6414,樺漢,4,0,4,群益金鼎-松山,2023-09-13,9103
1101,台泥,3,0,3,群益金鼎-松山,2023-09-13,9103
1513,中興電,3,0,3,群益金鼎-松山,2023-09-13,9103
2356,英業達,3,0,3,群益金鼎-松山,2023-09-13,9103
3042,晶技,3,0,3,群益金鼎-松山,2023-09-13,9103
3213,茂訊,3,0,3,群益金鼎-松山,2023-09-13,9103
3231,緯創,5,2,3,群益金鼎-松山,2023-09-13,9103
3356,奇偶,3,0,3,群益金鼎-松山,2023-09-13,9103
3376,新日興,3,0,3,群益金鼎-松山,2023-09-13,9103
1319,東陽,5,3,2,群益金鼎-松山,2023-09-13,9103
1217,愛之味,519,365,154,群益金鼎-松山,2023-09-14,9103
00830,國泰費城半導體,100,0,100,群益金鼎-松山,2023-09-14,9103
2882,國泰金,100,0,100,群益金鼎-松山,2023-09-14,9103
00632R,元大台灣50反1,63,0,63,群益金鼎-松山,2023-09-14,9103
2371,大同,37,2,35,群益金鼎-松山,2023-09-14,9103
2485,兆赫,44,10,34,群益金鼎-松山,2023-09-14,9103
3265,台星科,35,3,32,群益金鼎-松山,2023-09-14,9103
00670L,富邦NASDAQ正2,30,0,30,群益金鼎-松山,2023-09-14,9103
00918,大華優利高填息30,30,0,30,群益金鼎-松山,2023-09-14,9103
3715,定穎投控,23,0,23,群益金鼎-松山,2023-09-14,9103
6285,啟��,48,25,23,群益金鼎-松山,2023-09-14,9103
2337,旺宏,22,0,22,群益金鼎-松山,2023-09-14,9103
3188,鑫龍騰,20,0,20,群益金鼎-松山,2023-09-14,9103
3231,緯創,24,4,20,群益金鼎-松山,2023-09-14,9103
2204,中華,30,11,19,群益金鼎-松山,2023-09-14,9103
3006,晶豪科,22,3,19,群益金鼎-松山,2023-09-14,9103
4906,正文,21,3,18,群益金鼎-松山,2023-09-14,9103
4967,十銓,18,0,18,群益金鼎-松山,2023-09-14,9103
3027,盛達,18,2,16,群益金鼎-松山,2023-09-14,9103
5608,四維航,15,0,15,群益金鼎-松山,2023-09-14,9103
3014,聯陽,16,3,13,群益金鼎-松山,2023-09-14,9103
2482,連宇,12,0,12,群益金鼎-松山,2023-09-14,9103
3306,鼎天,11,0,11,群益金鼎-松山,2023-09-14,9103
1522,堤維西,22,12,10,群益金鼎-松山,2023-09-14,9103
6223,旺矽,11,1,10,群益金鼎-松山,2023-09-14,9103
6235,華孚,18,8,10,群益金鼎-松山,2023-09-14,9103
3037,欣興,11,1,10,群益金鼎-松山,2023-09-14,9103
2409,友達,10,1,9,群益金鼎-松山,2023-09-14,9103
1319,東陽,8,0,8,群益金鼎-松山,2023-09-14,9103
3289,宜特,8,0,8,群益金鼎-松山,2023-09-14,9103
3356,奇偶,8,0,8,群益金鼎-松山,2023-09-14,9103
8240,華宏,9,1,8,群益金鼎-松山,2023-09-14,9103
6288,聯嘉,11,4,7,群益金鼎-松山,2023-09-14,9103
4916,事欣科,8,2,6,群益金鼎-松山,2023-09-14,9103
00923,群益台ESG低碳50,5,0,5,群益金鼎-松山,2023-09-14,9103
1339,昭輝,5,0,5,群益金鼎-松山,2023-09-14,9103
2645,長榮航太,5,0,5,群益金鼎-松山,2023-09-14,9103
3234,光環,5,0,5,群益金鼎-松山,2023-09-14,9103
6274,台燿,9,4,5,群益金鼎-松山,2023-09-14,9103
8150,南茂,15,10,5,群益金鼎-松山,2023-09-14,9103
6197,佳必琪,4,0,4,群益金鼎-松山,2023-09-14,9103
00715L,期街口布蘭特正2,4,0,4,群益金鼎-松山,2023-09-14,9103
2357,華碩,4,0,4,群益金鼎-松山,2023-09-14,9103
3284,太普高,4,0,4,群益金鼎-松山,2023-09-14,9103
9927,泰銘,4,0,4,群益金鼎-松山,2023-09-14,9103
3481,群創,7,4,3,群益金鼎-松山,2023-09-14,9103
00878,國泰永續高股息,3,0,3,群益金鼎-松山,2023-09-14,9103
2236,百達-KY,3,0,3,群益金鼎-松山,2023-09-14,9103
2913,農林,3,0,3,群益金鼎-松山,2023-09-14,9103
3346,麗清,3,0,3,群益金鼎-松山,2023-09-14,9103
2427,三商電,155,0,155,群益金鼎-松山,2023-09-15,9103
1522,堤維西,148,0,148,群益金鼎-松山,2023-09-15,9103
00929,復華台灣科技優息,153,20,133,群益金鼎-松山,2023-09-15,9103
00632R,元大台灣50反1,99,0,99,群益金鼎-松山,2023-09-15,9103
2880,華南金,50,0,50,群益金鼎-松山,2023-09-15,9103
2449,京元電子,48,2,46,群益金鼎-松山,2023-09-15,9103
8054,安國,40,1,39,群益金鼎-松山,2023-09-15,9103
4960,誠美材,29,0,29,群益金鼎-松山,2023-09-15,9103
3105,穩懋,27,2,25,群益金鼎-松山,2023-09-15,9103
3010,華立,21,0,21,群益金鼎-松山,2023-09-15,9103
00706L,期元大S＆P日圓正2,20,0,20,群益金鼎-松山,2023-09-15,9103
6530,創威,20,1,19,群益金鼎-松山,2023-09-15,9103
6168,宏齊,15,0,15,群益金鼎-松山,2023-09-15,9103
2313,華通,38,24,14,群益金鼎-松山,2023-09-15,9103
2618,長榮航,15,2,13,群益金鼎-松山,2023-09-15,9103
3363,上詮,58,45,13,群益金鼎-松山,2023-09-15,9103
8467,波力-KY,12,0,12,群益金鼎-松山,2023-09-15,9103
6456,GIS-KY,12,1,11,群益金鼎-松山,2023-09-15,9103
1802,台玻,10,0,10,群益金鼎-松山,2023-09-15,9103
2356,英業達,12,2,10,群益金鼎-松山,2023-09-15,9103
3483,力致,10,0,10,群益金鼎-松山,2023-09-15,9103
2388,威盛,14,5,9,群益金鼎-松山,2023-09-15,9103
2615,萬海,11,2,9,群益金鼎-松山,2023-09-15,9103
3037,欣興,11,3,8,群益金鼎-松山,2023-09-15,9103
2486,一詮,55,48,7,群益金鼎-松山,2023-09-15,9103
8409,商之器,7,0,7,群益金鼎-松山,2023-09-15,9103
3704,合勤控,7,1,6,群益金鼎-松山,2023-09-15,9103
00687B,國泰20年美債,6,0,6,群益金鼎-松山,2023-09-15,9103
1402,遠東新,6,0,6,群益金鼎-松山,2023-09-15,9103
2892,第一金,6,0,6,群益金鼎-松山,2023-09-15,9103
00751B,元大AAA至A公司債,5,0,5,群益金鼎-松山,2023-09-15,9103
1568,倉佑,7,2,5,群益金鼎-松山,2023-09-15,9103
2376,技嘉,5,0,5,群益金鼎-松山,2023-09-15,9103
2634,漢翔,6,1,5,群益金鼎-松山,2023-09-15,9103
3011,今皓,5,0,5,群益金鼎-松山,2023-09-15,9103
4739,康普,5,0,5,群益金鼎-松山,2023-09-15,9103
5009,榮剛,5,0,5,群益金鼎-松山,2023-09-15,9103
6120,達運,5,0,5,群益金鼎-松山,2023-09-15,9103
6205,詮欣,5,0,5,群益金鼎-松山,2023-09-15,9103
6443,元晶,5,0,5,群益金鼎-松山,2023-09-15,9103
9938,百和,7,2,5,群益金鼎-松山,2023-09-15,9103
3693,營邦,5,0,5,群益金鼎-松山,2023-09-15,9103
1513,中興電,4,0,4,群益金鼎-松山,2023-09-15,9103
2409,友達,6,2,4,群益金鼎-松山,2023-09-15,9103
2610,華航,5,1,4,群益金鼎-松山,2023-09-15,9103
2891,中信金,5,1,4,群益金鼎-松山,2023-09-15,9103
3013,晟銘電,54,50,4,群益金鼎-松山,2023-09-15,9103
3481,群創,5,1,4,群益金鼎-松山,2023-09-15,9103
4945,陞達科技,4,0,4,群益金鼎-松山,2023-09-15,9103
6122,擎邦,4,0,4,群益金鼎-松山,2023-09-15,9103
1217,愛之味,134,0,134,群益金鼎-松山,2023-09-18,9103
4128,中天,115,1,114,群益金鼎-松山,2023-09-18,9103
2425,承啟,60,0,60,群益金鼎-松山,2023-09-18,9103
2605,新興,42,0,42,群益金鼎-松山,2023-09-18,9103
00929,復華台灣科技優息,89,59,30,群益金鼎-松山,2023-09-18,9103
00878,國泰永續高股息,27,0,27,群益金鼎-松山,2023-09-18,9103
2363,矽統,30,3,27,群益金鼎-松山,2023-09-18,9103
4572,駐龍,20,0,20,群益金鼎-松山,2023-09-18,9103
8201,無敵,20,0,20,群益金鼎-松山,2023-09-18,9103
2330,台積電,18,0,18,群益金鼎-松山,2023-09-18,9103
00751B,元大AAA至A公司債,15,0,15,群益金鼎-松山,2023-09-18,9103
1522,堤維西,33,18,15,群益金鼎-松山,2023-09-18,9103
2316,楠梓電,27,12,15,群益金鼎-松山,2023-09-18,9103
5706,鳳凰,15,0,15,群益金鼎-松山,2023-09-18,9103
8358,金居,20,5,15,群益金鼎-松山,2023-09-18,9103
6530,創威,18,4,14,群益金鼎-松山,2023-09-18,9103
4979,華星光,17,4,13,群益金鼎-松山,2023-09-18,9103
2323,中環,12,0,12,群益金鼎-松山,2023-09-18,9103
1513,中興電,11,0,11,群益金鼎-松山,2023-09-18,9103
3017,奇鋐,13,2,11,群益金鼎-松山,2023-09-18,9103
6625,必應,11,0,11,群益金鼎-松山,2023-09-18,9103
2313,華通,63,53,10,群益金鼎-松山,2023-09-18,9103
2641,正德,10,0,10,群益金鼎-松山,2023-09-18,9103
6153,嘉聯益,10,0,10,群益金鼎-松山,2023-09-18,9103
2027,大成鋼,9,0,9,群益金鼎-松山,2023-09-18,9103
00679B,元大美債20年,9,0,9,群益金鼎-松山,2023-09-18,9103
2486,一詮,12,3,9,群益金鼎-松山,2023-09-18,9103
2367,燿華,8,0,8,群益金鼎-松山,2023-09-18,9103
2455,全新,8,0,8,群益金鼎-松山,2023-09-18,9103
2465,麗臺,8,0,8,群益金鼎-松山,2023-09-18,9103
2882,國泰金,10,2,8,群益金鼎-松山,2023-09-18,9103
6531,愛普*,12,4,8,群益金鼎-松山,2023-09-18,9103
2364,倫飛,11,5,6,群益金鼎-松山,2023-09-18,9103
2409,友達,6,0,6,群益金鼎-松山,2023-09-18,9103
3011,今皓,6,0,6,群益金鼎-松山,2023-09-18,9103
4569,六方科-KY,6,0,6,群益金鼎-松山,2023-09-18,9103
2421,建準,5,0,5,群益金鼎-松山,2023-09-18,9103
2637,慧洋-KY,5,0,5,群益金鼎-松山,2023-09-18,9103
3078,僑威,5,0,5,群益金鼎-松山,2023-09-18,9103
6451,訊芯-KY,5,0,5,群益金鼎-松山,2023-09-18,9103
2382,廣達,15,10,5,群益金鼎-松山,2023-09-18,9103
00687B,國泰20年美債,4,0,4,群益金鼎-松山,2023-09-18,9103
3260,威剛,25,21,4,群益金鼎-松山,2023-09-18,9103
4953,緯軟,4,0,4,群益金鼎-松山,2023-09-18,9103
6213,聯茂,4,0,4,群益金鼎-松山,2023-09-18,9103
8028,昇陽半導體,8,4,4,群益金鼎-松山,2023-09-18,9103
8467,波力-KY,4,0,4,群益金鼎-松山,2023-09-18,9103
3231,緯創,6,3,3,群益金鼎-松山,2023-09-18,9103
2383,台光電,5,2,3,群益金鼎-松山,2023-09-18,9103
00931B,統一美債20年,3,0,3,群益金鼎-松山,2023-09-18,9103
1217,愛之味,676,348,328,群益金鼎-松山,2023-09-19,9103
2344,華邦電,90,20,70,群益金鼎-松山,2023-09-19,9103
3036,文曄,62,11,51,群益金鼎-松山,2023-09-19,9103
5381,合正,50,0,50,群益金鼎-松山,2023-09-19,9103
00929,復華台灣科技優息,47,1,46,群益金鼎-松山,2023-09-19,9103
2313,華通,72,34,38,群益金鼎-松山,2023-09-19,9103
3078,僑威,32,2,30,群益金鼎-松山,2023-09-19,9103
6257,矽格,29,6,23,群益金鼎-松山,2023-09-19,9103
1584,精剛,22,0,22,群益金鼎-松山,2023-09-19,9103
00919,群益台灣精選高息,24,4,20,群益金鼎-松山,2023-09-19,9103
2408,南亞科,20,0,20,群益金鼎-松山,2023-09-19,9103
3058,立德,20,0,20,群益金鼎-松山,2023-09-19,9103
8112,至上,21,4,17,群益金鼎-松山,2023-09-19,9103
1513,中興電,16,0,16,群益金鼎-松山,2023-09-19,9103
00713,元大台灣高息低波,15,0,15,群益金鼎-松山,2023-09-19,9103
2485,兆赫,15,0,15,群益金鼎-松山,2023-09-19,9103
2354,鴻準,14,0,14,群益金鼎-松山,2023-09-19,9103
6901,鑽石投資,13,1,12,群益金鼎-松山,2023-09-19,9103
2330,台積電,12,1,11,群益金鼎-松山,2023-09-19,9103
00738U,期元大道瓊白銀,10,0,10,群益金鼎-松山,2023-09-19,9103
2316,楠梓電,10,0,10,群益金鼎-松山,2023-09-19,9103
2337,旺宏,10,0,10,群益金鼎-松山,2023-09-19,9103
3363,上詮,35,25,10,群益金鼎-松山,2023-09-19,9103
6143,振曜,10,0,10,群益金鼎-松山,2023-09-19,9103
9928,中視,10,0,10,群益金鼎-松山,2023-09-19,9103
1319,東陽,15,6,9,群益金鼎-松山,2023-09-19,9103
2641,正德,10,1,9,群益金鼎-松山,2023-09-19,9103
3122,笙泉,9,0,9,群益金鼎-松山,2023-09-19,9103
3163,波若威,12,3,9,群益金鼎-松山,2023-09-19,9103
00878,國泰永續高股息,9,0,9,群益金鼎-松山,2023-09-19,9103
4961,天鈺,7,0,7,群益金鼎-松山,2023-09-19,9103
1522,堤維西,9,3,6,群益金鼎-松山,2023-09-19,9103
3483,力致,10,4,6,群益金鼎-松山,2023-09-19,9103
6451,訊芯-KY,6,0,6,群益金鼎-松山,2023-09-19,9103
6546,正基,6,0,6,群益金鼎-松山,2023-09-19,9103
6625,必應,7,1,6,群益金鼎-松山,2023-09-19,9103
2359,所羅門,5,0,5,群益金鼎-松山,2023-09-19,9103
00687B,國泰20年美債,5,0,5,群益金鼎-松山,2023-09-19,9103
1591,駿吉-KY,5,0,5,群益金鼎-松山,2023-09-19,9103
2015,豐興,5,0,5,群益金鼎-松山,2023-09-19,9103
2436,偉詮電,5,0,5,群益金鼎-松山,2023-09-19,9103
2606,裕民,5,0,5,群益金鼎-松山,2023-09-19,9103
3017,奇鋐,5,0,5,群益金鼎-松山,2023-09-19,9103
3043,科風,5,0,5,群益金鼎-松山,2023-09-19,9103
3131,弘塑,5,0,5,群益金鼎-松山,2023-09-19,9103
3211,順達,5,0,5,群益金鼎-松山,2023-09-19,9103
3450,聯鈞,7,2,5,群益金鼎-松山,2023-09-19,9103
4306,炎洲,5,0,5,群益金鼎-松山,2023-09-19,9103
6205,詮欣,5,0,5,群益金鼎-松山,2023-09-19,9103
8271,宇瞻,5,0,5,群益金鼎-松山,2023-09-19,9103
00929,復華台灣科技優息,66,3,63,群益金鼎-松山,2023-09-20,9103
1605,華新,50,7,43,群益金鼎-松山,2023-09-20,9103
2515,中工,40,0,40,群益金鼎-松山,2023-09-20,9103
2641,正德,66,40,26,群益金鼎-松山,2023-09-20,9103
2201,裕隆,23,0,23,群益金鼎-松山,2023-09-20,9103
2409,友達,22,0,22,群益金鼎-松山,2023-09-20,9103
2605,新興,63,42,21,群益金鼎-松山,2023-09-20,9103
2330,台積電,20,0,20,群益金鼎-松山,2023-09-20,9103
5608,四維航,32,12,20,群益金鼎-松山,2023-09-20,9103
6205,詮欣,15,0,15,群益金鼎-松山,2023-09-20,9103
1802,台玻,14,0,14,群益金鼎-松山,2023-09-20,9103
2354,鴻準,18,4,14,群益金鼎-松山,2023-09-20,9103
3037,欣興,14,0,14,群益金鼎-松山,2023-09-20,9103
5475,德宏,14,0,14,群益金鼎-松山,2023-09-20,9103
6285,啟��,16,2,14,群益金鼎-松山,2023-09-20,9103
2401,凌陽,13,0,13,群益金鼎-松山,2023-09-20,9103
3682,亞太電,12,0,12,群益金鼎-松山,2023-09-20,9103
1513,中興電,11,0,11,群益金鼎-松山,2023-09-20,9103
3545,敦泰,11,0,11,群益金鼎-松山,2023-09-20,9103
00923,群益台ESG低碳50,10,0,10,群益金鼎-松山,2023-09-20,9103
2352,佳世達,10,0,10,群益金鼎-松山,2023-09-20,9103
2882,國泰金,10,0,10,群益金鼎-松山,2023-09-20,9103
3027,盛達,10,1,9,群益金鼎-松山,2023-09-20,9103
3715,定穎投控,34,26,8,群益金鼎-松山,2023-09-20,9103
2363,矽統,17,9,8,群益金鼎-松山,2023-09-20,9103
5009,榮剛,8,0,8,群益金鼎-松山,2023-09-20,9103
9921,巨大,7,0,7,群益金鼎-松山,2023-09-20,9103
1519,華城,6,0,6,群益金鼎-松山,2023-09-20,9103
1305,華夏,6,0,6,群益金鼎-松山,2023-09-20,9103
4916,事欣科,6,0,6,群益金鼎-松山,2023-09-20,9103
6125,廣運,6,0,6,群益金鼎-松山,2023-09-20,9103
8046,南電,6,0,6,群益金鼎-松山,2023-09-20,9103
00687B,國泰20年美債,5,0,5,群益金鼎-松山,2023-09-20,9103
3035,智原,7,2,5,群益金鼎-松山,2023-09-20,9103
00931B,統一美債20年,5,0,5,群益金鼎-松山,2023-09-20,9103
2353,宏��,10,5,5,群益金鼎-松山,2023-09-20,9103
2880,華南金,5,0,5,群益金鼎-松山,2023-09-20,9103
2454,聯發科,4,0,4,群益金鼎-松山,2023-09-20,9103
2364,倫飛,10,6,4,群益金鼎-松山,2023-09-20,9103
2610,華航,4,0,4,群益金鼎-松山,2023-09-20,9103
4931,新盛力,4,0,4,群益金鼎-松山,2023-09-20,9103
6625,必應,4,0,4,群益金鼎-松山,2023-09-20,9103
8034,榮群,4,0,4,群益金鼎-松山,2023-09-20,9103
9927,泰銘,4,0,4,群益金鼎-松山,2023-09-20,9103
00679B,元大美債20年,3,0,3,群益金鼎-松山,2023-09-20,9103
2301,光寶科,3,0,3,群益金鼎-松山,2023-09-20,9103
00772B,中信高評級公司債,3,0,3,群益金鼎-松山,2023-09-20,9103
2357,華碩,3,0,3,群益金鼎-松山,2023-09-20,9103
3042,晶技,3,0,3,群益金鼎-松山,2023-09-20,9103
3580,友威科,3,0,3,群益金鼎-松山,2023-09-20,9103
00632R,元大台灣50反1,360,40,320,群益金鼎-松山,2023-09-21,9103
4906,正文,150,0,150,群益金鼎-松山,2023-09-21,9103
1217,愛之味,173,98,75,群益金鼎-松山,2023-09-21,9103
1522,堤維西,55,5,50,群益金鼎-松山,2023-09-21,9103
4128,中天,41,0,41,群益金鼎-松山,2023-09-21,9103
00637L,元大滬深300正2,30,0,30,群益金鼎-松山,2023-09-21,9103
9928,中視,26,0,26,群益金鼎-松山,2023-09-21,9103
3231,緯創,37,13,24,群益金鼎-松山,2023-09-21,9103
2603,長榮,23,2,21,群益金鼎-松山,2023-09-21,9103
3058,立德,20,0,20,群益金鼎-松山,2023-09-21,9103
2880,華南金,18,0,18,群益金鼎-松山,2023-09-21,9103
00878,國泰永續高股息,18,3,15,群益金鼎-松山,2023-09-21,9103
1218,泰山,15,0,15,群益金鼎-松山,2023-09-21,9103
2882,國泰金,14,0,14,群益金鼎-松山,2023-09-21,9103
8467,波力-KY,13,1,12,群益金鼎-松山,2023-09-21,9103
4967,十銓,11,0,11,群益金鼎-松山,2023-09-21,9103
2027,大成鋼,10,0,10,群益金鼎-松山,2023-09-21,9103
1314,中石化,10,0,10,群益金鼎-松山,2023-09-21,9103
2485,兆赫,10,0,10,群益金鼎-松山,2023-09-21,9103
2888,新光金,10,0,10,群益金鼎-松山,2023-09-21,9103
3005,神基,10,0,10,群益金鼎-松山,2023-09-21,9103
3027,盛達,12,2,10,群益金鼎-松山,2023-09-21,9103
4961,天鈺,10,0,10,群益金鼎-松山,2023-09-21,9103
3715,定穎投控,12,3,9,群益金鼎-松山,2023-09-21,9103
2330,台積電,12,3,9,群益金鼎-松山,2023-09-21,9103
00772B,中信高評級公司債,8,0,8,群益金鼎-松山,2023-09-21,9103
2891,中信金,8,0,8,群益金鼎-松山,2023-09-21,9103
2892,第一金,8,0,8,群益金鼎-松山,2023-09-21,9103
6451,訊芯-KY,11,3,8,群益金鼎-松山,2023-09-21,9103
8028,昇陽半導體,8,0,8,群益金鼎-松山,2023-09-21,9103
0050,元大台灣50,7,0,7,群益金鼎-松山,2023-09-21,9103
1101,台泥,7,0,7,群益金鼎-松山,2023-09-21,9103
5880,合庫金,7,0,7,群益金鼎-松山,2023-09-21,9103
3042,晶技,6,0,6,群益金鼎-松山,2023-09-21,9103
2317,鴻海,6,0,6,群益金鼎-松山,2023-09-21,9103
2801,彰銀,6,0,6,群益金鼎-松山,2023-09-21,9103
3324,雙鴻,6,0,6,群益金鼎-松山,2023-09-21,9103
00679B,元大美債20年,5,0,5,群益金鼎-松山,2023-09-21,9103
00919,群益台灣精選高息,6,1,5,群益金鼎-松山,2023-09-21,9103
2002,中鋼,5,0,5,群益金鼎-松山,2023-09-21,9103
00927,群益半導體收益,5,0,5,群益金鼎-松山,2023-09-21,9103
1513,中興電,5,0,5,群益金鼎-松山,2023-09-21,9103
1711,永光,5,0,5,群益金鼎-松山,2023-09-21,9103
00706L,期元大S＆P日圓正2,10,5,5,群益金鼎-松山,2023-09-21,9103
2324,仁寶,5,0,5,群益金鼎-松山,2023-09-21,9103
2465,麗臺,5,0,5,群益金鼎-松山,2023-09-21,9103
2633,台灣高鐵,5,0,5,群益金鼎-松山,2023-09-21,9103
2637,慧洋-KY,5,0,5,群益金鼎-松山,2023-09-21,9103
2890,永豐金,5,0,5,群益金鼎-松山,2023-09-21,9103
3264,欣銓,5,0,5,群益金鼎-松山,2023-09-21,9103
00687B,國泰20年美債,311,0,311,群益金鼎-松山,2023-09-22,9103
00929,復華台灣科技優息,69,0,69,群益金鼎-松山,2023-09-22,9103
00830,國泰費城半導體,50,0,50,群益金鼎-松山,2023-09-22,9103
4908,前鼎,46,0,46,群益金鼎-松山,2023-09-22,9103
3615,安可,40,0,40,群益金鼎-松山,2023-09-22,9103
00670L,富邦NASDAQ正2,30,0,30,群益金鼎-松山,2023-09-22,9103
00712,復華富時不動產,30,0,30,群益金鼎-松山,2023-09-22,9103
00713,元大台灣高息低波,25,0,25,群益金鼎-松山,2023-09-22,9103
00679B,元大美債20年,21,0,21,群益金鼎-松山,2023-09-22,9103
1324,地球,21,0,21,群益金鼎-松山,2023-09-22,9103
3011,今皓,21,0,21,群益金鼎-松山,2023-09-22,9103
00688L,國泰20年美債正2,20,0,20,群益金鼎-松山,2023-09-22,9103
5488,松普,20,0,20,群益金鼎-松山,2023-09-22,9103
00720B,元大投資級公司債,15,0,15,群益金鼎-松山,2023-09-22,9103
2880,華南金,15,0,15,群益金鼎-松山,2023-09-22,9103
00931B,統一美債20年,14,0,14,群益金鼎-松山,2023-09-22,9103
2376,技嘉,16,3,13,群益金鼎-松山,2023-09-22,9103
00751B,元大AAA至A公司債,13,0,13,群益金鼎-松山,2023-09-22,9103
2388,威盛,23,10,13,群益金鼎-松山,2023-09-22,9103
3163,波若威,16,3,13,群益金鼎-松山,2023-09-22,9103
1519,華城,21,9,12,群益金鼎-松山,2023-09-22,9103
2317,鴻海,12,0,12,群益金鼎-松山,2023-09-22,9103
1314,中石化,10,0,10,群益金鼎-松山,2023-09-22,9103
2515,中工,10,0,10,群益金鼎-松山,2023-09-22,9103
2606,裕民,10,0,10,群益金鼎-松山,2023-09-22,9103
3036,文曄,19,9,10,群益金鼎-松山,2023-09-22,9103
3058,立德,30,20,10,群益金鼎-松山,2023-09-22,9103
3231,緯創,36,26,10,群益金鼎-松山,2023-09-22,9103
5381,合正,30,21,9,群益金鼎-松山,2023-09-22,9103
3454,晶睿,8,0,8,群益金鼎-松山,2023-09-22,9103
8222,寶一,7,0,7,群益金鼎-松山,2023-09-22,9103
4979,華星光,11,5,6,群益金鼎-松山,2023-09-22,9103
1236,宏亞,6,0,6,群益金鼎-松山,2023-09-22,9103
00888,永豐台灣ESG,6,0,6,群益金鼎-松山,2023-09-22,9103
00907,永豐優息存股,6,0,6,群益金鼎-松山,2023-09-22,9103
2316,楠梓電,16,10,6,群益金鼎-松山,2023-09-22,9103
5475,德宏,6,0,6,群益金鼎-松山,2023-09-22,9103
9927,泰銘,6,0,6,群益金鼎-松山,2023-09-22,9103
3711,日月光投控,5,0,5,群益金鼎-松山,2023-09-22,9103
00696B,富邦美債20年,5,0,5,群益金鼎-松山,2023-09-22,9103
2468,華經,6,1,5,群益金鼎-松山,2023-09-22,9103
2641,正德,5,0,5,群益金鼎-松山,2023-09-22,9103
2883,凱基金,5,0,5,群益金鼎-松山,2023-09-22,9103
2884,玉山金,5,0,5,群益金鼎-松山,2023-09-22,9103
3149,正達,5,0,5,群益金鼎-松山,2023-09-22,9103
3715,定穎投控,43,38,5,群益金鼎-松山,2023-09-22,9103
5213,亞昕,5,0,5,群益金鼎-松山,2023-09-22,9103
00900,富邦特選高股息30,4,0,4,群益金鼎-松山,2023-09-22,9103
3105,穩懋,4,0,4,群益金鼎-松山,2023-09-22,9103
4306,炎洲,4,0,4,群益金鼎-松山,2023-09-22,9103
1101,台泥,186,0,186,群益金鼎-松山,2023-09-25,9103
3450,聯鈞,63,5,58,群益金鼎-松山,2023-09-25,9103
2605,新興,35,5,30,群益金鼎-松山,2023-09-25,9103
2641,正德,29,0,29,群益金鼎-松山,2023-09-25,9103
6187,萬潤,28,4,24,群益金鼎-松山,2023-09-25,9103
6235,華孚,26,3,23,群益金鼎-松山,2023-09-25,9103
3036,文曄,26,5,21,群益金鼎-松山,2023-09-25,9103
2367,燿華,20,1,19,群益金鼎-松山,2023-09-25,9103
6451,訊芯-KY,19,1,18,群益金鼎-松山,2023-09-25,9103
8112,至上,20,2,18,群益金鼎-松山,2023-09-25,9103
3163,波若威,31,16,15,群益金鼎-松山,2023-09-25,9103
6271,同欣電,18,3,15,群益金鼎-松山,2023-09-25,9103
2330,台積電,12,0,12,群益金鼎-松山,2023-09-25,9103
2402,毅嘉,11,0,11,群益金鼎-松山,2023-09-25,9103
00632R,元大台灣50反1,10,0,10,群益金鼎-松山,2023-09-25,9103
00878,國泰永續高股息,10,0,10,群益金鼎-松山,2023-09-25,9103
2017,官田鋼,10,0,10,群益金鼎-松山,2023-09-25,9103
6117,迎廣,10,0,10,群益金鼎-松山,2023-09-25,9103
6125,廣運,14,4,10,群益金鼎-松山,2023-09-25,9103
2376,技嘉,22,12,10,群益金鼎-松山,2023-09-25,9103
00713,元大台灣高息低波,9,0,9,群益金鼎-松山,2023-09-25,9103
00888,永豐台灣ESG,8,0,8,群益金鼎-松山,2023-09-25,9103
3260,威剛,10,2,8,群益金鼎-松山,2023-09-25,9103
3714,富采,8,0,8,群益金鼎-松山,2023-09-25,9103
6274,台燿,12,4,8,群益金鼎-松山,2023-09-25,9103
2344,華邦電,7,0,7,群益金鼎-松山,2023-09-25,9103
00885,富邦越南,6,0,6,群益金鼎-松山,2023-09-25,9103
3583,辛耘,8,2,6,群益金鼎-松山,2023-09-25,9103
1513,中興電,13,8,5,群益金鼎-松山,2023-09-25,9103
1402,遠東新,5,0,5,群益金鼎-松山,2023-09-25,9103
2368,金像電,15,10,5,群益金鼎-松山,2023-09-25,9103
3481,群創,5,0,5,群益金鼎-松山,2023-09-25,9103
3483,力致,7,2,5,群益金鼎-松山,2023-09-25,9103
3706,神達,6,1,5,群益金鼎-松山,2023-09-25,9103
6275,元山,5,0,5,群益金鼎-松山,2023-09-25,9103
9103,美德醫療-DR,5,0,5,群益金鼎-松山,2023-09-25,9103
2323,中環,5,0,5,群益金鼎-松山,2023-09-25,9103
6531,愛普*,12,7,5,群益金鼎-松山,2023-09-25,9103
1584,精剛,4,0,4,群益金鼎-松山,2023-09-25,9103
00919,群益台灣精選高息,4,0,4,群益金鼎-松山,2023-09-25,9103
1236,宏亞,4,0,4,群益金鼎-松山,2023-09-25,9103
2530,華建,4,0,4,群益金鼎-松山,2023-09-25,9103
3708,上緯投控,4,0,4,群益金鼎-松山,2023-09-25,9103
6191,精成科,4,0,4,群益金鼎-松山,2023-09-25,9103
1464,得力,3,0,3,群益金鼎-松山,2023-09-25,9103
1605,華新,3,0,3,群益金鼎-松山,2023-09-25,9103
1784,訊聯,3,0,3,群益金鼎-松山,2023-09-25,9103
2421,建準,14,11,3,群益金鼎-松山,2023-09-25,9103
2610,華航,3,0,3,群益金鼎-松山,2023-09-25,9103
2748,雲品,3,0,3,群益金鼎-松山,2023-09-25,9103
4564,元翎,295,0,295,群益金鼎-松山,2023-09-26,9103
00687B,國泰20年美債,109,0,109,群益金鼎-松山,2023-09-26,9103
5880,合庫金,101,0,101,群益金鼎-松山,2023-09-26,9103
2538,基泰,52,3,49,群益金鼎-松山,2023-09-26,9103
1605,華新,40,2,38,群益金鼎-松山,2023-09-26,9103
1442,名軒,27,0,27,群益金鼎-松山,2023-09-26,9103
2610,華航,26,1,25,群益金鼎-松山,2023-09-26,9103
3714,富采,22,0,22,群益金鼎-松山,2023-09-26,9103
3231,緯創,24,3,21,群益金鼎-松山,2023-09-26,9103
00633L,富邦上証正2,20,0,20,群益金鼎-松山,2023-09-26,9103
00929,復華台灣科技優息,19,0,19,群益金鼎-松山,2023-09-26,9103
1815,富喬,31,12,19,群益金鼎-松山,2023-09-26,9103
6213,聯茂,18,0,18,群益金鼎-松山,2023-09-26,9103
6806,森崴能源,16,1,15,群益金鼎-松山,2023-09-26,9103
00679B,元大美債20年,14,0,14,群益金鼎-松山,2023-09-26,9103
00637L,元大滬深300正2,11,0,11,群益金鼎-松山,2023-09-26,9103
1314,中石化,10,0,10,群益金鼎-松山,2023-09-26,9103
00680L,元大美債20正2,10,0,10,群益金鼎-松山,2023-09-26,9103
2352,佳世達,10,0,10,群益金鼎-松山,2023-09-26,9103
2838,聯邦銀,10,0,10,群益金鼎-松山,2023-09-26,9103
2881,富邦金,10,0,10,群益金鼎-松山,2023-09-26,9103
2889,國票金,10,0,10,群益金鼎-松山,2023-09-26,9103
3444,利機,10,0,10,群益金鼎-松山,2023-09-26,9103
5475,德宏,10,0,10,群益金鼎-松山,2023-09-26,9103
6143,振曜,10,0,10,群益金鼎-松山,2023-09-26,9103
00878,國泰永續高股息,10,1,9,群益金鼎-松山,2023-09-26,9103
8150,南茂,9,0,9,群益金鼎-松山,2023-09-26,9103
1522,堤維西,9,0,9,群益金鼎-松山,2023-09-26,9103
3715,定穎投控,24,16,8,群益金鼎-松山,2023-09-26,9103
1503,士電,16,9,7,群益金鼎-松山,2023-09-26,9103
3322,建舜電,7,0,7,群益金鼎-松山,2023-09-26,9103
6274,台燿,16,9,7,群益金鼎-松山,2023-09-26,9103
2368,金像電,6,0,6,群益金鼎-松山,2023-09-26,9103
2376,技嘉,17,11,6,群益金鼎-松山,2023-09-26,9103
3483,力致,18,12,6,群益金鼎-松山,2023-09-26,9103
6122,擎邦,6,0,6,群益金鼎-松山,2023-09-26,9103
9927,泰銘,6,0,6,群益金鼎-松山,2023-09-26,9103
00751B,元大AAA至A公司債,5,0,5,群益金鼎-松山,2023-09-26,9103
00688L,國泰20年美債正2,5,0,5,群益金鼎-松山,2023-09-26,9103
2002,中鋼,5,0,5,群益金鼎-松山,2023-09-26,9103
2308,台達電,5,0,5,群益金鼎-松山,2023-09-26,9103
2363,矽統,14,9,5,群益金鼎-松山,2023-09-26,9103
2641,正德,10,5,5,群益金鼎-松山,2023-09-26,9103
5324,士開,5,0,5,群益金鼎-松山,2023-09-26,9103
8401,白紗科,5,0,5,群益金鼎-松山,2023-09-26,9103
9958,世紀鋼,6,1,5,群益金鼎-松山,2023-09-26,9103
6125,廣運,5,0,5,群益金鼎-松山,2023-09-26,9103
2382,廣達,15,11,4,群益金鼎-松山,2023-09-26,9103
00720B,元大投資級公司債,4,0,4,群益金鼎-松山,2023-09-26,9103
00915,凱基優選高股息30,4,0,4,群益金鼎-松山,2023-09-26,9103
1217,愛之味,556,410,146,群益金鼎-松山,2023-09-27,9103
2355,敬鵬,39,0,39,群益金鼎-松山,2023-09-27,9103
00637L,元大滬深300正2,30,0,30,群益金鼎-松山,2023-09-27,9103
5324,士開,30,5,25,群益金鼎-松山,2023-09-27,9103
2515,中工,16,0,16,群益金鼎-松山,2023-09-27,9103
3163,波若威,18,5,13,群益金鼎-松山,2023-09-27,9103
3374,精材,13,0,13,群益金鼎-松山,2023-09-27,9103
6274,台燿,27,14,13,群益金鼎-松山,2023-09-27,9103
1513,中興電,11,0,11,群益金鼎-松山,2023-09-27,9103
2204,中華,20,10,10,群益金鼎-松山,2023-09-27,9103
2641,正德,30,20,10,群益金鼎-松山,2023-09-27,9103
8420,明揚,37,27,10,群益金鼎-松山,2023-09-27,9103
3715,定穎投控,38,29,9,群益金鼎-松山,2023-09-27,9103
00712,復華富時不動產,8,0,8,群益金鼎-松山,2023-09-27,9103
1570,力肯,7,0,7,群益金鼎-松山,2023-09-27,9103
8299,群聯,7,0,7,群益金鼎-松山,2023-09-27,9103
1519,華城,24,18,6,群益金鼎-松山,2023-09-27,9103
00878,國泰永續高股息,6,0,6,群益金鼎-松山,2023-09-27,9103
00929,復華台灣科技優息,6,0,6,群益金鼎-松山,2023-09-27,9103
2313,華通,7,1,6,群益金鼎-松山,2023-09-27,9103
3025,星通,12,6,6,群益金鼎-松山,2023-09-27,9103
3042,晶技,5,0,5,群益金鼎-松山,2023-09-27,9103
2303,聯電,5,0,5,群益金鼎-松山,2023-09-27,9103
00881,國泰台灣5G+,5,0,5,群益金鼎-松山,2023-09-27,9103
2538,基泰,10,5,5,群益金鼎-松山,2023-09-27,9103
3005,神基,5,0,5,群益金鼎-松山,2023-09-27,9103
3006,晶豪科,5,0,5,群益金鼎-松山,2023-09-27,9103
3324,雙鴻,5,0,5,群益金鼎-松山,2023-09-27,9103
3682,亞太電,5,0,5,群益金鼎-松山,2023-09-27,9103
6112,邁達特,5,0,5,群益金鼎-松山,2023-09-27,9103
6125,廣運,9,4,5,群益金鼎-松山,2023-09-27,9103
9958,世紀鋼,5,0,5,群益金鼎-松山,2023-09-27,9103
2382,廣達,11,7,4,群益金鼎-松山,2023-09-27,9103
2606,裕民,4,0,4,群益金鼎-松山,2023-09-27,9103
2880,華南金,4,0,4,群益金鼎-松山,2023-09-27,9103
6625,必應,4,0,4,群益金鼎-松山,2023-09-27,9103
8433,弘帆,4,0,4,群益金鼎-松山,2023-09-27,9103
00679B,元大美債20年,3,0,3,群益金鼎-松山,2023-09-27,9103
2345,智邦,8,5,3,群益金鼎-松山,2023-09-27,9103
2377,微星,3,0,3,群益金鼎-松山,2023-09-27,9103
2634,漢翔,3,0,3,群益金鼎-松山,2023-09-27,9103
3037,欣興,4,1,3,群益金鼎-松山,2023-09-27,9103
3131,弘塑,3,0,3,群益金鼎-松山,2023-09-27,9103
4979,華星光,6,3,3,群益金鼎-松山,2023-09-27,9103
6546,正基,3,0,3,群益金鼎-松山,2023-09-27,9103
6770,力積電,3,0,3,群益金鼎-松山,2023-09-27,9103
2542,興富發,2,0,2,群益金鼎-松山,2023-09-27,9103
3693,營邦,3,1,2,群益金鼎-松山,2023-09-27,9103
00907,永豐優息存股,2,0,2,群益金鼎-松山,2023-09-27,9103
2425,承啟,2,0,2,群益金鼎-松山,2023-09-27,9103
00687B,國泰20年美債,305,0,305,群益金鼎-松山,2023-09-28,9103
1522,堤維西,170,1,169,群益金鼎-松山,2023-09-28,9103
00712,復華富時不動產,120,0,120,群益金鼎-松山,2023-09-28,9103
00671R,富邦NASDAQ反1,100,0,100,群益金鼎-松山,2023-09-28,9103
00637L,元大滬深300正2,70,0,70,群益金鼎-松山,2023-09-28,9103
3231,緯創,141,88,53,群益金鼎-松山,2023-09-28,9103
3032,偉訓,35,6,29,群益金鼎-松山,2023-09-28,9103
5225,東科-KY,30,1,29,群益金鼎-松山,2023-09-28,9103
2329,華泰,27,2,25,群益金鼎-松山,2023-09-28,9103
1815,富喬,21,0,21,群益金鼎-松山,2023-09-28,9103
2301,光寶科,18,0,18,群益金鼎-松山,2023-09-28,9103
2376,技嘉,22,4,18,群益金鼎-松山,2023-09-28,9103
2382,廣達,35,21,14,群益金鼎-松山,2023-09-28,9103
2388,威盛,17,4,13,群益金鼎-松山,2023-09-28,9103
00679B,元大美債20年,11,0,11,群益金鼎-松山,2023-09-28,9103
00696B,富邦美債20年,11,0,11,群益金鼎-松山,2023-09-28,9103
3011,今皓,11,0,11,群益金鼎-松山,2023-09-28,9103
3013,晟銘電,24,13,11,群益金鼎-松山,2023-09-28,9103
3213,茂訊,10,0,10,群益金鼎-松山,2023-09-28,9103
6806,森崴能源,11,1,10,群益金鼎-松山,2023-09-28,9103
3017,奇鋐,16,7,9,群益金鼎-松山,2023-09-28,9103
3545,敦泰,9,0,9,群益金鼎-松山,2023-09-28,9103
5871,中租-KY,10,1,9,群益金鼎-松山,2023-09-28,9103
2542,興富發,8,0,8,群益金鼎-松山,2023-09-28,9103
2891,中信金,8,0,8,群益金鼎-松山,2023-09-28,9103
3042,晶技,8,0,8,群益金鼎-松山,2023-09-28,9103
3483,力致,10,2,8,群益金鼎-松山,2023-09-28,9103
3617,碩天,8,0,8,群益金鼎-松山,2023-09-28,9103
6703,軒郁,7,0,7,群益金鼎-松山,2023-09-28,9103
1736,喬山,6,0,6,群益金鼎-松山,2023-09-28,9103
00878,國泰永續高股息,6,0,6,群益金鼎-松山,2023-09-28,9103
1609,大亞,9,3,6,群益金鼎-松山,2023-09-28,9103
00632R,元大台灣50反1,5,0,5,群益金鼎-松山,2023-09-28,9103
00693U,期街口S＆P黃豆,5,0,5,群益金鼎-松山,2023-09-28,9103
1326,台化,5,0,5,群益金鼎-松山,2023-09-28,9103
1503,士電,11,6,5,群益金鼎-松山,2023-09-28,9103
00929,復華台灣科技優息,5,0,5,群益金鼎-松山,2023-09-28,9103
1909,榮成,5,0,5,群益金鼎-松山,2023-09-28,9103
2324,仁寶,5,0,5,群益金鼎-松山,2023-09-28,9103
3338,泰碩,5,0,5,群益金鼎-松山,2023-09-28,9103
6117,迎廣,15,10,5,群益金鼎-松山,2023-09-28,9103
6158,禾昌,5,0,5,群益金鼎-松山,2023-09-28,9103
9103,美德醫療-DR,5,0,5,群益金鼎-松山,2023-09-28,9103
3037,欣興,5,1,4,群益金鼎-松山,2023-09-28,9103
2201,裕隆,6,2,4,群益金鼎-松山,2023-09-28,9103
2363,矽統,23,19,4,群益金鼎-松山,2023-09-28,9103
2377,微星,4,0,4,群益金鼎-松山,2023-09-28,9103
3025,星通,4,0,4,群益金鼎-松山,2023-09-28,9103
3078,僑威,7,3,4,群益金鼎-松山,2023-09-28,9103
3105,穩懋,4,0,4,群益金鼎-松山,2023-09-28,9103
1217,愛之味,303,90,213,群益金鼎-松山,2023-10-02,9103
1815,富喬,208,12,196,群益金鼎-松山,2023-10-02,9103
00878,國泰永續高股息,123,5,118,群益金鼎-松山,2023-10-02,9103
1736,喬山,47,0,47,群益金鼎-松山,2023-10-02,9103
2543,皇昌,35,1,34,群益金鼎-松山,2023-10-02,9103
2204,中華,31,0,31,群益金鼎-松山,2023-10-02,9103
3231,緯創,50,20,30,群益金鼎-松山,2023-10-02,9103
2605,新興,30,3,27,群益金鼎-松山,2023-10-02,9103
5225,東科-KY,25,0,25,群益金鼎-松山,2023-10-02,9103
00725B,國泰投資級公司債,20,0,20,群益金鼎-松山,2023-10-02,9103
2329,華泰,20,0,20,群益金鼎-松山,2023-10-02,9103
2492,華新科,20,0,20,群益金鼎-松山,2023-10-02,9103
3025,星通,27,7,20,群益金鼎-松山,2023-10-02,9103
6830,汎銓,20,0,20,群益金鼎-松山,2023-10-02,9103
00632R,元大台灣50反1,20,3,17,群益金鼎-松山,2023-10-02,9103
4543,萬在,19,2,17,群益金鼎-松山,2023-10-02,9103
00706L,期元大S＆P日圓正2,20,5,15,群益金鼎-松山,2023-10-02,9103
3567,逸昌,14,0,14,群益金鼎-松山,2023-10-02,9103
3017,奇鋐,28,16,12,群益金鼎-松山,2023-10-02,9103
6419,京晨科,11,0,11,群益金鼎-松山,2023-10-02,9103
00931B,統一美債20年,10,0,10,群益金鼎-松山,2023-10-02,9103
2002,中鋼,12,2,10,群益金鼎-松山,2023-10-02,9103
2027,大成鋼,10,0,10,群益金鼎-松山,2023-10-02,9103
2408,南亞科,10,0,10,群益金鼎-松山,2023-10-02,9103
2542,興富發,10,0,10,群益金鼎-松山,2023-10-02,9103
6125,廣運,14,4,10,群益金鼎-松山,2023-10-02,9103
4979,華星光,13,4,9,群益金鼎-松山,2023-10-02,9103
1605,華新,10,1,9,群益金鼎-松山,2023-10-02,9103
3141,晶宏,9,0,9,群益金鼎-松山,2023-10-02,9103
3363,上詮,37,28,9,群益金鼎-松山,2023-10-02,9103
3689,湧德,9,0,9,群益金鼎-松山,2023-10-02,9103
00908,富邦入息REITs+,8,0,8,群益金鼎-松山,2023-10-02,9103
6213,聯茂,11,3,8,群益金鼎-松山,2023-10-02,9103
6456,GIS-KY,12,4,8,群益金鼎-松山,2023-10-02,9103
3680,家登,10,2,8,群益金鼎-松山,2023-10-02,9103
2606,裕民,9,2,7,群益金鼎-松山,2023-10-02,9103
00751B,元大AAA至A公司債,7,0,7,群益金鼎-松山,2023-10-02,9103
2230,泰茂,7,0,7,群益金鼎-松山,2023-10-02,9103
3587,閎康,10,3,7,群益金鼎-松山,2023-10-02,9103
4905,台聯電,7,0,7,群益金鼎-松山,2023-10-02,9103
2363,矽統,14,8,6,群益金鼎-松山,2023-10-02,9103
1442,名軒,7,1,6,群益金鼎-松山,2023-10-02,9103
3310,佳穎,6,0,6,群益金鼎-松山,2023-10-02,9103
5347,世界,6,0,6,群益金鼎-松山,2023-10-02,9103
3037,欣興,10,4,6,群益金鼎-松山,2023-10-02,9103
2015,豐興,5,0,5,群益金鼎-松山,2023-10-02,9103
00712,復華富時不動產,5,0,5,群益金鼎-松山,2023-10-02,9103
00679B,元大美債20年,5,0,5,群益金鼎-松山,2023-10-02,9103
00671R,富邦NASDAQ反1,5,0,5,群益金鼎-松山,2023-10-02,9103
00696B,富邦美債20年,5,0,5,群益金鼎-松山,2023-10-02,9103
3325,旭品,154,6,148,群益金鼎-松山,2023-10-03,9103
3481,群創,200,100,100,群益金鼎-松山,2023-10-03,9103
6117,迎廣,100,0,100,群益金鼎-松山,2023-10-03,9103
00637L,元大滬深300正2,67,0,67,群益金鼎-松山,2023-10-03,9103
8358,金居,43,4,39,群益金鼎-松山,2023-10-03,9103
0056,元大高股息,43,8,35,群益金鼎-松山,2023-10-03,9103
8201,無敵,30,0,30,群益金鼎-松山,2023-10-03,9103
2408,南亞科,30,2,28,群益金鼎-松山,2023-10-03,9103
6442,光聖,27,0,27,群益金鼎-松山,2023-10-03,9103
3013,晟銘電,61,35,26,群益金鼎-松山,2023-10-03,9103
00640L,富邦日本正2,25,0,25,群益金鼎-松山,2023-10-03,9103
2323,中環,25,0,25,群益金鼎-松山,2023-10-03,9103
00706L,期元大S＆P日圓正2,21,0,21,群益金鼎-松山,2023-10-03,9103
3260,威剛,43,22,21,群益金鼎-松山,2023-10-03,9103
2329,華泰,17,0,17,群益金鼎-松山,2023-10-03,9103
2504,國產,15,0,15,群益金鼎-松山,2023-10-03,9103
6605,帝寶,15,0,15,群益金鼎-松山,2023-10-03,9103
8069,元太,15,0,15,群益金鼎-松山,2023-10-03,9103
00720B,元大投資級公司債,10,0,10,群益金鼎-松山,2023-10-03,9103
4564,元翎,10,0,10,群益金鼎-松山,2023-10-03,9103
6530,創威,10,0,10,群益金鼎-松山,2023-10-03,9103
2017,官田鋼,10,1,9,群益金鼎-松山,2023-10-03,9103
2383,台光電,9,0,9,群益金鼎-松山,2023-10-03,9103
00687B,國泰20年美債,8,0,8,群益金鼎-松山,2023-10-03,9103
00713,元大台灣高息低波,8,0,8,群益金鼎-松山,2023-10-03,9103
00712,復華富時不動產,8,0,8,群益金鼎-松山,2023-10-03,9103
2337,旺宏,8,0,8,群益金鼎-松山,2023-10-03,9103
3122,笙泉,10,2,8,群益金鼎-松山,2023-10-03,9103
3234,光環,10,2,8,群益金鼎-松山,2023-10-03,9103
3714,富采,8,0,8,群益金鼎-松山,2023-10-03,9103
2363,矽統,16,9,7,群益金鼎-松山,2023-10-03,9103
3324,雙鴻,9,2,7,群益金鼎-松山,2023-10-03,9103
6538,倉和,7,0,7,群益金鼎-松山,2023-10-03,9103
1605,華新,6,0,6,群益金鼎-松山,2023-10-03,9103
2409,友達,75,69,6,群益金鼎-松山,2023-10-03,9103
2427,三商電,22,16,6,群益金鼎-松山,2023-10-03,9103
1442,名軒,6,1,5,群益金鼎-松山,2023-10-03,9103
00931B,統一美債20年,5,0,5,群益金鼎-松山,2023-10-03,9103
1570,力肯,5,0,5,群益金鼎-松山,2023-10-03,9103
2421,建準,7,2,5,群益金鼎-松山,2023-10-03,9103
2515,中工,5,0,5,群益金鼎-松山,2023-10-03,9103
2891,中信金,5,0,5,群益金鼎-松山,2023-10-03,9103
3043,科風,5,0,5,群益金鼎-松山,2023-10-03,9103
2002,中鋼,4,0,4,群益金鼎-松山,2023-10-03,9103
00751B,元大AAA至A公司債,4,0,4,群益金鼎-松山,2023-10-03,9103
2206,三陽工業,4,0,4,群益金鼎-松山,2023-10-03,9103
3014,聯陽,4,0,4,群益金鼎-松山,2023-10-03,9103
3044,健鼎,5,1,4,群益金鼎-松山,2023-10-03,9103
6451,訊芯-KY,6,2,4,群益金鼎-松山,2023-10-03,9103
6806,森崴能源,4,0,4,群益金鼎-松山,2023-10-03,9103
00931B,統一美債20年,117,0,117,群益金鼎-松山,2023-10-04,9103
00687B,國泰20年美債,116,0,116,群益金鼎-松山,2023-10-04,9103
3481,群創,101,0,101,群益金鼎-松山,2023-10-04,9103
3715,定穎投控,25,4,21,群益金鼎-松山,2023-10-04,9103
00637L,元大滬深300正2,20,0,20,群益金鼎-松山,2023-10-04,9103
1217,愛之味,250,231,19,群益金鼎-松山,2023-10-04,9103
3234,光環,20,1,19,群益金鼎-松山,2023-10-04,9103
00679B,元大美債20年,16,0,16,群益金鼎-松山,2023-10-04,9103
00680L,元大美債20正2,15,0,15,群益金鼎-松山,2023-10-04,9103
00712,復華富時不動產,14,0,14,群益金鼎-松山,2023-10-04,9103
2455,全新,25,11,14,群益金鼎-松山,2023-10-04,9103
2388,威盛,17,4,13,群益金鼎-松山,2023-10-04,9103
1503,士電,12,0,12,群益金鼎-松山,2023-10-04,9103
8086,宏捷科,24,12,12,群益金鼎-松山,2023-10-04,9103
00919,群益台灣精選高息,10,0,10,群益金鼎-松山,2023-10-04,9103
00929,復華台灣科技優息,11,1,10,群益金鼎-松山,2023-10-04,9103
00772B,中信高評級公司債,10,0,10,群益金鼎-松山,2023-10-04,9103
2504,國產,10,0,10,群益金鼎-松山,2023-10-04,9103
2883,凱基金,10,0,10,群益金鼎-松山,2023-10-04,9103
2883B,凱基金乙特,10,0,10,群益金鼎-松山,2023-10-04,9103
6279,胡連,10,0,10,群益金鼎-松山,2023-10-04,9103
00720B,元大投資級公司債,11,2,9,群益金鼎-松山,2023-10-04,9103
6288,聯嘉,10,1,9,群益金鼎-松山,2023-10-04,9103
2330,台積電,19,10,9,群益金鼎-松山,2023-10-04,9103
2486,一詮,10,2,8,群益金鼎-松山,2023-10-04,9103
00878,國泰永續高股息,9,2,7,群益金鼎-松山,2023-10-04,9103
00927,群益半導體收益,7,0,7,群益金鼎-松山,2023-10-04,9103
00751B,元大AAA至A公司債,7,0,7,群益金鼎-松山,2023-10-04,9103
3037,欣興,7,0,7,群益金鼎-松山,2023-10-04,9103
2382,廣達,10,4,6,群益金鼎-松山,2023-10-04,9103
00696B,富邦美債20年,6,0,6,群益金鼎-松山,2023-10-04,9103
2344,華邦電,6,0,6,群益金鼎-松山,2023-10-04,9103
2530,華建,6,0,6,群益金鼎-松山,2023-10-04,9103
2641,正德,6,0,6,群益金鼎-松山,2023-10-04,9103
3006,晶豪科,31,25,6,群益金鼎-松山,2023-10-04,9103
8299,群聯,9,3,6,群益金鼎-松山,2023-10-04,9103
9945,潤泰新,6,0,6,群益金鼎-松山,2023-10-04,9103
0050,元大台灣50,5,0,5,群益金鼎-松山,2023-10-04,9103
1815,富喬,5,0,5,群益金鼎-松山,2023-10-04,9103
2419,仲琦,5,0,5,群益金鼎-松山,2023-10-04,9103
2515,中工,5,0,5,群益金鼎-松山,2023-10-04,9103
3042,晶技,5,0,5,群益金鼎-松山,2023-10-04,9103
3548,兆利,11,6,5,群益金鼎-松山,2023-10-04,9103
3669,圓展,5,0,5,群益金鼎-松山,2023-10-04,9103
4977,眾達-KY,5,0,5,群益金鼎-松山,2023-10-04,9103
6451,訊芯-KY,14,9,5,群益金鼎-松山,2023-10-04,9103
2618,長榮航,5,0,5,群益金鼎-松山,2023-10-04,9103
2412,中華電,4,0,4,群益金鼎-松山,2023-10-04,9103
2880,華南金,4,0,4,群益金鼎-松山,2023-10-04,9103
2884,玉山金,4,0,4,群益金鼎-松山,2023-10-04,9103
3715,定穎投控,121,20,101,群益金鼎-松山,2023-10-05,9103
2359,所羅門,33,0,33,群益金鼎-松山,2023-10-05,9103
1442,名軒,33,1,32,群益金鼎-松山,2023-10-05,9103
2538,基泰,34,2,32,群益金鼎-松山,2023-10-05,9103
6275,元山,27,0,27,群益金鼎-松山,2023-10-05,9103
2486,一詮,32,9,23,群益金鼎-松山,2023-10-05,9103
6187,萬潤,25,2,23,群益金鼎-松山,2023-10-05,9103
3234,光環,30,9,21,群益金鼎-松山,2023-10-05,9103
3701,大眾控,21,0,21,群益金鼎-松山,2023-10-05,9103
00632R,元大台灣50反1,20,0,20,群益金鼎-松山,2023-10-05,9103
00712,復華富時不動產,20,0,20,群益金鼎-松山,2023-10-05,9103
8210,勤誠,17,3,14,群益金鼎-松山,2023-10-05,9103
6451,訊芯-KY,22,9,13,群益金鼎-松山,2023-10-05,9103
3276,宇環,13,1,12,群益金鼎-松山,2023-10-05,9103
00919,群益台灣精選高息,11,0,11,群益金鼎-松山,2023-10-05,9103
00720B,元大投資級公司債,11,0,11,群益金鼎-松山,2023-10-05,9103
1324,地球,11,0,11,群益金鼎-松山,2023-10-05,9103
4967,十銓,10,0,10,群益金鼎-松山,2023-10-05,9103
00652,富邦印度,10,0,10,群益金鼎-松山,2023-10-05,9103
00715L,期街口布蘭特正2,10,0,10,群益金鼎-松山,2023-10-05,9103
5347,世界,10,0,10,群益金鼎-松山,2023-10-05,9103
1519,華城,16,7,9,群益金鼎-松山,2023-10-05,9103
6491,晶碩,8,0,8,群益金鼎-松山,2023-10-05,9103
6732,昇佳電子,8,0,8,群益金鼎-松山,2023-10-05,9103
6585,鼎基,9,2,7,群益金鼎-松山,2023-10-05,9103
3122,笙泉,28,22,6,群益金鼎-松山,2023-10-05,9103
3037,欣興,5,0,5,群益金鼎-松山,2023-10-05,9103
1605,華新,5,0,5,群益金鼎-松山,2023-10-05,9103
2515,中工,5,0,5,群益金鼎-松山,2023-10-05,9103
3005,神基,10,5,5,群益金鼎-松山,2023-10-05,9103
4564,元翎,5,0,5,群益金鼎-松山,2023-10-05,9103
6443,元晶,5,0,5,群益金鼎-松山,2023-10-05,9103
00878,國泰永續高股息,5,1,4,群益金鼎-松山,2023-10-05,9103
00907,永豐優息存股,4,0,4,群益金鼎-松山,2023-10-05,9103
00637L,元大滬深300正2,4,0,4,群益金鼎-松山,2023-10-05,9103
2888,新光金,4,0,4,群益金鼎-松山,2023-10-05,9103
5465,富驊,7,3,4,群益金鼎-松山,2023-10-05,9103
2454,聯發科,4,0,4,群益金鼎-松山,2023-10-05,9103
2317,鴻海,5,2,3,群益金鼎-松山,2023-10-05,9103
1514,亞力,4,1,3,群益金鼎-松山,2023-10-05,9103
00679B,元大美債20年,3,0,3,群益金鼎-松山,2023-10-05,9103
0056,元大高股息,3,0,3,群益金鼎-松山,2023-10-05,9103
2313,華通,8,5,3,群益金鼎-松山,2023-10-05,9103
2353,宏��,13,10,3,群益金鼎-松山,2023-10-05,9103
6120,達運,5,2,3,群益金鼎-松山,2023-10-05,9103
6244,茂迪,3,0,3,群益金鼎-松山,2023-10-05,9103
1717,長興,2,0,2,群益金鼎-松山,2023-10-05,9103
00888,永豐台灣ESG,2,0,2,群益金鼎-松山,2023-10-05,9103
1402,遠東新,2,0,2,群益金鼎-松山,2023-10-05,9103
2393,億光,2,0,2,群益金鼎-松山,2023-10-05,9103
1217,愛之味,175,0,175,群益金鼎-松山,2023-10-06,9103
00688L,國泰20年美債正2,100,0,100,群益金鼎-松山,2023-10-06,9103
3704,合勤控,100,1,99,群益金鼎-松山,2023-10-06,9103
2538,基泰,80,0,80,群益金鼎-松山,2023-10-06,9103
3715,定穎投控,103,36,67,群益金鼎-松山,2023-10-06,9103
2486,一詮,75,10,65,群益金鼎-松山,2023-10-06,9103
1515,力山,51,0,51,群益金鼎-松山,2023-10-06,9103
00715L,期街口布蘭特正2,50,5,45,群益金鼎-松山,2023-10-06,9103
2356,英業達,40,0,40,群益金鼎-松山,2023-10-06,9103
3260,威剛,44,12,32,群益金鼎-松山,2023-10-06,9103
4746,台耀,31,0,31,群益金鼎-松山,2023-10-06,9103
00632R,元大台灣50反1,30,0,30,群益金鼎-松山,2023-10-06,9103
1442,名軒,28,2,26,群益金鼎-松山,2023-10-06,9103
3006,晶豪科,36,11,25,群益金鼎-松山,2023-10-06,9103
2383,台光電,22,0,22,群益金鼎-松山,2023-10-06,9103
4564,元翎,20,0,20,群益金鼎-松山,2023-10-06,9103
9950,萬國通,19,1,18,群益金鼎-松山,2023-10-06,9103
8227,巨有科技,17,1,16,群益金鼎-松山,2023-10-06,9103
2329,華泰,14,0,14,群益金鼎-松山,2023-10-06,9103
3325,旭品,12,0,12,群益金鼎-松山,2023-10-06,9103
6451,訊芯-KY,18,6,12,群益金鼎-松山,2023-10-06,9103
00712,復華富時不動產,9,0,9,群益金鼎-松山,2023-10-06,9103
4503,金雨,9,0,9,群益金鼎-松山,2023-10-06,9103
3322,建舜電,8,0,8,群益金鼎-松山,2023-10-06,9103
3363,上詮,11,3,8,群益金鼎-松山,2023-10-06,9103
6188,廣明,11,3,8,群益金鼎-松山,2023-10-06,9103
2344,華邦電,6,0,6,群益金鼎-松山,2023-10-06,9103
6202,盛群,6,0,6,群益金鼎-松山,2023-10-06,9103
1609,大亞,5,0,5,群益金鼎-松山,2023-10-06,9103
00696B,富邦美債20年,5,0,5,群益金鼎-松山,2023-10-06,9103
00720B,元大投資級公司債,5,0,5,群益金鼎-松山,2023-10-06,9103
00751B,元大AAA至A公司債,5,0,5,群益金鼎-松山,2023-10-06,9103
4174,浩鼎,5,0,5,群益金鼎-松山,2023-10-06,9103
4931,新盛力,5,0,5,群益金鼎-松山,2023-10-06,9103
5907,大洋-KY,5,0,5,群益金鼎-松山,2023-10-06,9103
6122,擎邦,6,1,5,群益金鼎-松山,2023-10-06,9103
6414,樺漢,5,0,5,群益金鼎-松山,2023-10-06,9103
9958,世紀鋼,5,0,5,群益金鼎-松山,2023-10-06,9103
2493,揚博,4,0,4,群益金鼎-松山,2023-10-06,9103
3711,日月光投控,4,0,4,群益金鼎-松山,2023-10-06,9103
8046,南電,4,0,4,群益金鼎-松山,2023-10-06,9103
3042,晶技,3,0,3,群益金鼎-松山,2023-10-06,9103
2603,長榮,3,0,3,群益金鼎-松山,2023-10-06,9103
00878,國泰永續高股息,3,0,3,群益金鼎-松山,2023-10-06,9103
00929,復華台灣科技優息,3,0,3,群益金鼎-松山,2023-10-06,9103
1570,力肯,3,0,3,群益金鼎-松山,2023-10-06,9103
2002,中鋼,3,0,3,群益金鼎-松山,2023-10-06,9103
2419,仲琦,5,2,3,群益金鼎-松山,2023-10-06,9103
2427,三商電,3,0,3,群益金鼎-松山,2023-10-06,9103
8299,群聯,8,5,3,群益金鼎-松山,2023-10-06,9103
2338,光罩,52,0,52,群益金鼎-松山,2023-10-11,9103
00632R,元大台灣50反1,50,0,50,群益金鼎-松山,2023-10-11,9103
2630,亞航,40,0,40,群益金鼎-松山,2023-10-11,9103
2340,台亞,48,19,29,群益金鼎-松山,2023-10-11,9103
2376,技嘉,39,10,29,群益金鼎-松山,2023-10-11,9103
3234,光環,20,0,20,群益金鼎-松山,2023-10-11,9103
2603,長榮,20,2,18,群益金鼎-松山,2023-10-11,9103
5706,鳳凰,17,0,17,群益金鼎-松山,2023-10-11,9103
2382,廣達,36,22,14,群益金鼎-松山,2023-10-11,9103
8210,勤誠,15,2,13,群益金鼎-松山,2023-10-11,9103
2206,三陽工業,11,0,11,群益金鼎-松山,2023-10-11,9103
1591,駿吉-KY,10,0,10,群益金鼎-松山,2023-10-11,9103
2485,兆赫,10,0,10,群益金鼎-松山,2023-10-11,9103
2504,國產,10,0,10,群益金鼎-松山,2023-10-11,9103
3013,晟銘電,22,12,10,群益金鼎-松山,2023-10-11,9103
3017,奇鋐,12,2,10,群益金鼎-松山,2023-10-11,9103
3545,敦泰,10,0,10,群益金鼎-松山,2023-10-11,9103
4908,前鼎,13,3,10,群益金鼎-松山,2023-10-11,9103
6143,振曜,20,10,10,群益金鼎-松山,2023-10-11,9103
6202,盛群,10,0,10,群益金鼎-松山,2023-10-11,9103
6684,安格,12,2,10,群益金鼎-松山,2023-10-11,9103
2453,凌群,10,1,9,群益金鼎-松山,2023-10-11,9103
00637L,元大滬深300正2,8,0,8,群益金鼎-松山,2023-10-11,9103
3483,力致,23,15,8,群益金鼎-松山,2023-10-11,9103
3035,智原,30,22,8,群益金鼎-松山,2023-10-11,9103
1305,華夏,7,0,7,群益金鼎-松山,2023-10-11,9103
00922,國泰台灣領袖50,6,0,6,群益金鼎-松山,2023-10-11,9103
2368,金像電,7,2,5,群益金鼎-松山,2023-10-11,9103
2329,華泰,5,0,5,群益金鼎-松山,2023-10-11,9103
00725B,國泰投資級公司債,5,0,5,群益金鼎-松山,2023-10-11,9103
2324,仁寶,5,0,5,群益金鼎-松山,2023-10-11,9103
3022,威強電,5,0,5,群益金鼎-松山,2023-10-11,9103
4126,太醫,5,0,5,群益金鼎-松山,2023-10-11,9103
6216,居易,5,0,5,群益金鼎-松山,2023-10-11,9103
6271,同欣電,8,3,5,群益金鼎-松山,2023-10-11,9103
1504,東元,4,0,4,群益金鼎-松山,2023-10-11,9103
2345,智邦,8,4,4,群益金鼎-松山,2023-10-11,9103
2356,英業達,7,3,4,群益金鼎-松山,2023-10-11,9103
2497,怡利電,4,0,4,群益金鼎-松山,2023-10-11,9103
3376,新日興,5,1,4,群益金鼎-松山,2023-10-11,9103
6625,必應,5,1,4,群益金鼎-松山,2023-10-11,9103
8227,巨有科技,4,0,4,群益金鼎-松山,2023-10-11,9103
8390,金益鼎,4,0,4,群益金鼎-松山,2023-10-11,9103
00713,元大台灣高息低波,3,0,3,群益金鼎-松山,2023-10-11,9103
3027,盛達,3,0,3,群益金鼎-松山,2023-10-11,9103
3051,力特,3,0,3,群益金鼎-松山,2023-10-11,9103
3162,精確,3,0,3,群益金鼎-松山,2023-10-11,9103
3217,優群,3,0,3,群益金鼎-松山,2023-10-11,9103
3680,家登,3,0,3,群益金鼎-松山,2023-10-11,9103
6538,倉和,3,0,3,群益金鼎-松山,2023-10-11,9103
4906,正文,150,0,150,群益金鼎-松山,2023-10-12,9103
2890,永豐金,103,0,103,群益金鼎-松山,2023-10-12,9103
2465,麗臺,90,6,84,群益金鼎-松山,2023-10-12,9103
2363,矽統,118,56,62,群益金鼎-松山,2023-10-12,9103
2610,華航,50,0,50,群益金鼎-松山,2023-10-12,9103
00931B,統一美債20年,40,0,40,群益金鼎-松山,2023-10-12,9103
00673R,期元大S＆P原油反1,40,0,40,群益金鼎-松山,2023-10-12,9103
00637L,元大滬深300正2,33,5,28,群益金鼎-松山,2023-10-12,9103
00929,復華台灣科技優息,23,1,22,群益金鼎-松山,2023-10-12,9103
2204,中華,22,1,21,群益金鼎-松山,2023-10-12,9103
2383,台光電,19,0,19,群益金鼎-松山,2023-10-12,9103
3025,星通,32,15,17,群益金鼎-松山,2023-10-12,9103
00725B,國泰投資級公司債,15,0,15,群益金鼎-松山,2023-10-12,9103
3231,緯創,16,2,14,群益金鼎-松山,2023-10-12,9103
8996,高力,18,5,13,群益金鼎-松山,2023-10-12,9103
2371,大同,15,3,12,群益金鼎-松山,2023-10-12,9103
8349,�矬�,14,2,12,群益金鼎-松山,2023-10-12,9103
1591,駿吉-KY,10,0,10,群益金鼎-松山,2023-10-12,9103
2468,華經,12,2,10,群益金鼎-松山,2023-10-12,9103
3013,晟銘電,11,1,10,群益金鼎-松山,2023-10-12,9103
3234,光環,10,0,10,群益金鼎-松山,2023-10-12,9103
3325,旭品,10,0,10,群益金鼎-松山,2023-10-12,9103
8930,青鋼,10,0,10,群益金鼎-松山,2023-10-12,9103
3324,雙鴻,7,0,7,群益金鼎-松山,2023-10-12,9103
1301,台塑,6,0,6,群益金鼎-松山,2023-10-12,9103
1720,生達,6,0,6,群益金鼎-松山,2023-10-12,9103
2330,台積電,20,14,6,群益金鼎-松山,2023-10-12,9103
3701,大眾控,5,0,5,群益金鼎-松山,2023-10-12,9103
2382,廣達,5,0,5,群益金鼎-松山,2023-10-12,9103
3444,利機,5,0,5,群益金鼎-松山,2023-10-12,9103
6116,彩晶,5,0,5,群益金鼎-松山,2023-10-12,9103
6530,創威,5,0,5,群益金鼎-松山,2023-10-12,9103
6799,來頡,5,0,5,群益金鼎-松山,2023-10-12,9103
6148,驊宏資,6,2,4,群益金鼎-松山,2023-10-12,9103
8433,弘帆,4,0,4,群益金鼎-松山,2023-10-12,9103
9938,百和,4,0,4,群益金鼎-松山,2023-10-12,9103
00713,元大台灣高息低波,3,0,3,群益金鼎-松山,2023-10-12,9103
1584,精剛,5,2,3,群益金鼎-松山,2023-10-12,9103
1802,台玻,3,0,3,群益金鼎-松山,2023-10-12,9103
1732,毛寶,3,0,3,群益金鼎-松山,2023-10-12,9103
00632R,元大台灣50反1,3,0,3,群益金鼎-松山,2023-10-12,9103
6284,佳邦,4,1,3,群益金鼎-松山,2023-10-12,9103
3702,大聯大,3,0,3,群益金鼎-松山,2023-10-12,9103
4979,華星光,9,6,3,群益金鼎-松山,2023-10-12,9103
2329,華泰,34,32,2,群益金鼎-松山,2023-10-12,9103
6274,台燿,2,0,2,群益金鼎-松山,2023-10-12,9103
2645,長榮航太,2,0,2,群益金鼎-松山,2023-10-12,9103
1442,名軒,2,0,2,群益金鼎-松山,2023-10-12,9103
1524,耿鼎,2,0,2,群益金鼎-松山,2023-10-12,9103
00646,元大S＆P500,2,0,2,群益金鼎-松山,2023-10-12,9103
00878,國泰永續高股息,106,5,101,群益金鼎-松山,2023-10-13,9103
2618,長榮航,101,0,101,群益金鼎-松山,2023-10-13,9103
3025,星通,82,11,71,群益金鼎-松山,2023-10-13,9103
9928,中視,38,0,38,群益金鼎-松山,2023-10-13,9103
1217,愛之味,35,0,35,群益金鼎-松山,2023-10-13,9103
2363,矽統,78,49,29,群益金鼎-松山,2023-10-13,9103
2449,京元電子,30,1,29,群益金鼎-松山,2023-10-13,9103
6530,創威,28,0,28,群益金鼎-松山,2023-10-13,9103
3013,晟銘電,26,0,26,群益金鼎-松山,2023-10-13,9103
2388,威盛,56,34,22,群益金鼎-松山,2023-10-13,9103
6442,光聖,22,0,22,群益金鼎-松山,2023-10-13,9103
2301,光寶科,22,2,20,群益金鼎-松山,2023-10-13,9103
00633L,富邦上証正2,20,0,20,群益金鼎-松山,2023-10-13,9103
2305,全友,50,30,20,群益金鼎-松山,2023-10-13,9103
2344,華邦電,26,6,20,群益金鼎-松山,2023-10-13,9103
00640L,富邦日本正2,19,0,19,群益金鼎-松山,2023-10-13,9103
3715,定穎投控,34,20,14,群益金鼎-松山,2023-10-13,9103
8349,�矬�,13,0,13,群益金鼎-松山,2023-10-13,9103
2404,漢唐,11,0,11,群益金鼎-松山,2023-10-13,9103
3325,旭品,11,0,11,群益金鼎-松山,2023-10-13,9103
1337,再生-KY,10,0,10,群益金鼎-松山,2023-10-13,9103
1319,東陽,20,10,10,群益金鼎-松山,2023-10-13,9103
00751B,元大AAA至A公司債,10,0,10,群益金鼎-松山,2023-10-13,9103
00637L,元大滬深300正2,10,0,10,群益金鼎-松山,2023-10-13,9103
2316,楠梓電,10,0,10,群益金鼎-松山,2023-10-13,9103
2913,農林,10,0,10,群益金鼎-松山,2023-10-13,9103
3006,晶豪科,41,31,10,群益金鼎-松山,2023-10-13,9103
6485,點序,12,2,10,群益金鼎-松山,2023-10-13,9103
0056,元大高股息,10,1,9,群益金鼎-松山,2023-10-13,9103
3363,上詮,63,54,9,群益金鼎-松山,2023-10-13,9103
2603,長榮,8,0,8,群益金鼎-松山,2023-10-13,9103
2002,中鋼,8,0,8,群益金鼎-松山,2023-10-13,9103
8084,巨虹,8,0,8,群益金鼎-松山,2023-10-13,9103
3037,欣興,7,0,7,群益金鼎-松山,2023-10-13,9103
00929,復華台灣科技優息,8,1,7,群益金鼎-松山,2023-10-13,9103
2427,三商電,7,0,7,群益金鼎-松山,2023-10-13,9103
3017,奇鋐,7,0,7,群益金鼎-松山,2023-10-13,9103
4706,大恭,7,0,7,群益金鼎-松山,2023-10-13,9103
4979,華星光,28,22,6,群益金鼎-松山,2023-10-13,9103
3701,大眾控,6,1,5,群益金鼎-松山,2023-10-13,9103
1525,江申,10,5,5,群益金鼎-松山,2023-10-13,9103
00720B,元大投資級公司債,5,0,5,群益金鼎-松山,2023-10-13,9103
1905,華紙,5,0,5,群益金鼎-松山,2023-10-13,9103
3005,神基,10,5,5,群益金鼎-松山,2023-10-13,9103
3362,先進光,10,5,5,群益金鼎-松山,2023-10-13,9103
5907,大洋-KY,5,0,5,群益金鼎-松山,2023-10-13,9103
6148,驊宏資,10,5,5,群益金鼎-松山,2023-10-13,9103
6150,撼訊,5,0,5,群益金鼎-松山,2023-10-13,9103
9907,統一實,5,0,5,群益金鼎-松山,2023-10-13,9103
4961,天鈺,5,0,5,群益金鼎-松山,2023-10-13,9103
00679B,元大美債20年,500,0,500,群益金鼎-松山,2023-10-16,9103
3645,達邁,50,0,50,群益金鼎-松山,2023-10-16,9103
3231,緯創,23,0,23,群益金鼎-松山,2023-10-16,9103
4503,金雨,30,11,19,群益金鼎-松山,2023-10-16,9103
3483,力致,25,8,17,群益金鼎-松山,2023-10-16,9103
2344,華邦電,16,0,16,群益金鼎-松山,2023-10-16,9103
2201,裕隆,17,1,16,群益金鼎-松山,2023-10-16,9103
1605,華新,15,0,15,群益金鼎-松山,2023-10-16,9103
8996,高力,24,11,13,群益金鼎-松山,2023-10-16,9103
6643,M31,12,0,12,群益金鼎-松山,2023-10-16,9103
2486,一詮,11,1,10,群益金鼎-松山,2023-10-16,9103
2618,長榮航,15,5,10,群益金鼎-松山,2023-10-16,9103
3011,今皓,12,2,10,群益金鼎-松山,2023-10-16,9103
2516,新建,8,0,8,群益金鼎-松山,2023-10-16,9103
3188,鑫龍騰,8,0,8,群益金鼎-松山,2023-10-16,9103
6593,台灣銘板,8,0,8,群益金鼎-松山,2023-10-16,9103
0056,元大高股息,7,0,7,群益金鼎-松山,2023-10-16,9103
1303,南亞,7,0,7,群益金鼎-松山,2023-10-16,9103
3706,神達,8,1,7,群益金鼎-松山,2023-10-16,9103
2425,承啟,5,0,5,群益金鼎-松山,2023-10-16,9103
2743,山富,10,5,5,群益金鼎-松山,2023-10-16,9103
3042,晶技,6,1,5,群益金鼎-松山,2023-10-16,9103
3481,群創,5,0,5,群益金鼎-松山,2023-10-16,9103
4919,新唐,5,0,5,群益金鼎-松山,2023-10-16,9103
6625,必應,5,0,5,群益金鼎-松山,2023-10-16,9103
8210,勤誠,5,0,5,群益金鼎-松山,2023-10-16,9103
9907,統一實,5,0,5,群益金鼎-松山,2023-10-16,9103
1570,力肯,4,0,4,群益金鼎-松山,2023-10-16,9103
2383,台光電,5,1,4,群益金鼎-松山,2023-10-16,9103
3325,旭品,5,1,4,群益金鼎-松山,2023-10-16,9103
5348,正能量智能,10,6,4,群益金鼎-松山,2023-10-16,9103
8084,巨虹,4,0,4,群益金鼎-松山,2023-10-16,9103
8155,博智,5,1,4,群益金鼎-松山,2023-10-16,9103
3035,智原,12,8,4,群益金鼎-松山,2023-10-16,9103
00929,復華台灣科技優息,3,0,3,群益金鼎-松山,2023-10-16,9103
2206,三陽工業,3,0,3,群益金鼎-松山,2023-10-16,9103
00713,元大台灣高息低波,3,0,3,群益金鼎-松山,2023-10-16,9103
2399,映泰,3,0,3,群益金鼎-松山,2023-10-16,9103
3363,上詮,17,14,3,群益金鼎-松山,2023-10-16,9103
4979,華星光,10,7,3,群益金鼎-松山,2023-10-16,9103
6188,廣明,5,2,3,群益金鼎-松山,2023-10-16,9103
2903,遠百,3,0,3,群益金鼎-松山,2023-10-16,9103
1409,新纖,2,0,2,群益金鼎-松山,2023-10-16,9103
00712,復華富時不動產,2,0,2,群益金鼎-松山,2023-10-16,9103
2317,鴻海,2,0,2,群益金鼎-松山,2023-10-16,9103
2323,中環,2,0,2,群益金鼎-松山,2023-10-16,9103
2328,廣宇,2,0,2,群益金鼎-松山,2023-10-16,9103
2356,英業達,3,1,2,群益金鼎-松山,2023-10-16,9103
2388,威盛,19,17,2,群益金鼎-松山,2023-10-16,9103
2419,仲琦,2,0,2,群益金鼎-松山,2023-10-16,9103
00679B,元大美債20年,500,0,500,群益金鼎-松山,2023-10-17,9103
2371,大同,35,0,35,群益金鼎-松山,2023-10-17,9103
8088,品安,32,0,32,群益金鼎-松山,2023-10-17,9103
6104,創惟,30,0,30,群益金鼎-松山,2023-10-17,9103
8048,德勝,23,1,22,群益金鼎-松山,2023-10-17,9103
3036,文曄,23,2,21,群益金鼎-松山,2023-10-17,9103
2382,廣達,24,5,19,群益金鼎-松山,2023-10-17,9103
6148,驊宏資,15,0,15,群益金鼎-松山,2023-10-17,9103
1409,新纖,10,0,10,群益金鼎-松山,2023-10-17,9103
2605,新興,10,0,10,群益金鼎-松山,2023-10-17,9103
2913,農林,10,0,10,群益金鼎-松山,2023-10-17,9103
6485,點序,12,2,10,群益金鼎-松山,2023-10-17,9103
4977,眾達-KY,13,4,9,群益金鼎-松山,2023-10-17,9103
0056,元大高股息,9,2,7,群益金鼎-松山,2023-10-17,9103
2305,全友,8,1,7,群益金鼎-松山,2023-10-17,9103
2388,威盛,12,5,7,群益金鼎-松山,2023-10-17,9103
2324,仁寶,6,0,6,群益金鼎-松山,2023-10-17,9103
3706,神達,7,1,6,群益金鼎-松山,2023-10-17,9103
8084,巨虹,7,1,6,群益金鼎-松山,2023-10-17,9103
3481,群創,5,0,5,群益金鼎-松山,2023-10-17,9103
00687B,國泰20年美債,5,0,5,群益金鼎-松山,2023-10-17,9103
1903,士紙,5,0,5,群益金鼎-松山,2023-10-17,9103
00696B,富邦美債20年,5,0,5,群益金鼎-松山,2023-10-17,9103
00751B,元大AAA至A公司債,5,0,5,群益金鼎-松山,2023-10-17,9103
00720B,元大投資級公司債,5,0,5,群益金鼎-松山,2023-10-17,9103
3062,建漢,5,0,5,群益金鼎-松山,2023-10-17,9103
5215,科嘉-KY,10,5,5,群益金鼎-松山,2023-10-17,9103
6026,福邦證,5,0,5,群益金鼎-松山,2023-10-17,9103
3682,亞太電,10,6,4,群益金鼎-松山,2023-10-17,9103
3231,緯創,11,7,4,群益金鼎-松山,2023-10-17,9103
00919,群益台灣精選高息,4,0,4,群益金鼎-松山,2023-10-17,9103
00915,凱基優選高股息30,4,0,4,群益金鼎-松山,2023-10-17,9103
2618,長榮航,55,51,4,群益金鼎-松山,2023-10-17,9103
2634,漢翔,4,0,4,群益金鼎-松山,2023-10-17,9103
3714,富采,4,0,4,群益金鼎-松山,2023-10-17,9103
1570,力肯,3,0,3,群益金鼎-松山,2023-10-17,9103
00878,國泰永續高股息,3,0,3,群益金鼎-松山,2023-10-17,9103
00713,元大台灣高息低波,3,0,3,群益金鼎-松山,2023-10-17,9103
2353,宏��,3,0,3,群益金鼎-松山,2023-10-17,9103
2454,聯發科,4,1,3,群益金鼎-松山,2023-10-17,9103
2515,中工,3,0,3,群益金鼎-松山,2023-10-17,9103
2545,皇翔,3,0,3,群益金鼎-松山,2023-10-17,9103
2610,華航,3,0,3,群益金鼎-松山,2023-10-17,9103
3163,波若威,6,3,3,群益金鼎-松山,2023-10-17,9103
3709,鑫聯大投控,5,2,3,群益金鼎-松山,2023-10-17,9103
6285,啟��,3,0,3,群益金鼎-松山,2023-10-17,9103
3260,威剛,16,13,3,群益金鼎-松山,2023-10-17,9103
2867,三商壽,2,0,2,群益金鼎-松山,2023-10-17,9103
2002,中鋼,2,0,2,群益金鼎-松山,2023-10-17,9103
1584,精剛,2,0,2,群益金鼎-松山,2023-10-17,9103
1217,愛之味,372,185,187,群益金鼎-松山,2023-10-18,9103
3260,威剛,56,16,40,群益金鼎-松山,2023-10-18,9103
0056,元大高股息,37,0,37,群益金鼎-松山,2023-10-18,9103
6625,必應,35,0,35,群益金鼎-松山,2023-10-18,9103
00878,國泰永續高股息,35,2,33,群益金鼎-松山,2023-10-18,9103
1471,首利,32,1,31,群益金鼎-松山,2023-10-18,9103
00919,群益台灣精選高息,30,0,30,群益金鼎-松山,2023-10-18,9103
8349,�矬�,27,0,27,群益金鼎-松山,2023-10-18,9103
2330,台積電,23,0,23,群益金鼎-松山,2023-10-18,9103
1102,亞泥,20,0,20,群益金鼎-松山,2023-10-18,9103
3013,晟銘電,18,0,18,群益金鼎-松山,2023-10-18,9103
2344,華邦電,16,0,16,群益金鼎-松山,2023-10-18,9103
2634,漢翔,16,0,16,群益金鼎-松山,2023-10-18,9103
2388,威盛,34,19,15,群益金鼎-松山,2023-10-18,9103
2371,大同,15,1,14,群益金鼎-松山,2023-10-18,9103
3715,定穎投控,15,2,13,群益金鼎-松山,2023-10-18,9103
6150,撼訊,13,0,13,群益金鼎-松山,2023-10-18,9103
00929,復華台灣科技優息,13,1,12,群益金鼎-松山,2023-10-18,9103
3588,通嘉,13,1,12,群益金鼎-松山,2023-10-18,9103
6237,驊訊,12,0,12,群益金鼎-松山,2023-10-18,9103
1304,台聚,10,0,10,群益金鼎-松山,2023-10-18,9103
00687B,國泰20年美債,10,0,10,群益金鼎-松山,2023-10-18,9103
2204,中華,11,1,10,群益金鼎-松山,2023-10-18,9103
2355,敬鵬,10,0,10,群益金鼎-松山,2023-10-18,9103
3011,今皓,10,0,10,群益金鼎-松山,2023-10-18,9103
4561,健椿,10,0,10,群益金鼎-松山,2023-10-18,9103
9933,中鼎,10,0,10,群益金鼎-松山,2023-10-18,9103
2301,光寶科,10,1,9,群益金鼎-松山,2023-10-18,9103
1903,士紙,6,0,6,群益金鼎-松山,2023-10-18,9103
3317,尼克森,6,0,6,群益金鼎-松山,2023-10-18,9103
6168,宏齊,48,42,6,群益金鼎-松山,2023-10-18,9103
6274,台燿,8,2,6,群益金鼎-松山,2023-10-18,9103
00881,國泰台灣5G+,5,0,5,群益金鼎-松山,2023-10-18,9103
1711,永光,5,0,5,群益金鼎-松山,2023-10-18,9103
2314,台揚,5,0,5,群益金鼎-松山,2023-10-18,9103
2364,倫飛,9,4,5,群益金鼎-松山,2023-10-18,9103
2504,國產,5,0,5,群益金鼎-松山,2023-10-18,9103
2610,華航,5,0,5,群益金鼎-松山,2023-10-18,9103
3022,威強電,5,0,5,群益金鼎-松山,2023-10-18,9103
6643,M31,11,6,5,群益金鼎-松山,2023-10-18,9103
2363,矽統,35,30,5,群益金鼎-松山,2023-10-18,9103
2465,麗臺,5,1,4,群益金鼎-松山,2023-10-18,9103
00922,國泰台灣領袖50,4,0,4,群益金鼎-松山,2023-10-18,9103
00772B,中信高評級公司債,4,0,4,群益金鼎-松山,2023-10-18,9103
00713,元大台灣高息低波,4,0,4,群益金鼎-松山,2023-10-18,9103
2891,中信金,4,0,4,群益金鼎-松山,2023-10-18,9103
3042,晶技,5,1,4,群益金鼎-松山,2023-10-18,9103
3548,兆利,11,7,4,群益金鼎-松山,2023-10-18,9103
8155,博智,6,2,4,群益金鼎-松山,2023-10-18,9103
2645,長榮航太,3,0,3,群益金鼎-松山,2023-10-18,9103
00679B,元大美債20年,1016,0,1016,群益金鼎-松山,2023-10-19,9103
00687B,國泰20年美債,112,2,110,群益金鼎-松山,2023-10-19,9103
8176,智捷,78,0,78,群益金鼎-松山,2023-10-19,9103
4967,十銓,42,2,40,群益金鼎-松山,2023-10-19,9103
5608,四維航,20,0,20,群益金鼎-松山,2023-10-19,9103
9907,統一實,20,0,20,群益金鼎-松山,2023-10-19,9103
2816,旺旺保,19,3,16,群益金鼎-松山,2023-10-19,9103
00637L,元大滬深300正2,15,0,15,群益金鼎-松山,2023-10-19,9103
1305,華夏,15,0,15,群益金鼎-松山,2023-10-19,9103
8271,宇瞻,15,0,15,群益金鼎-松山,2023-10-19,9103
1101,台泥,12,1,11,群益金鼎-松山,2023-10-19,9103
9950,萬國通,11,0,11,群益金鼎-松山,2023-10-19,9103
1503,士電,11,0,11,群益金鼎-松山,2023-10-19,9103
2371,大同,10,0,10,群益金鼎-松山,2023-10-19,9103
2413,環科,10,0,10,群益金鼎-松山,2023-10-19,9103
4979,華星光,15,5,10,群益金鼎-松山,2023-10-19,9103
8054,安國,10,0,10,群益金鼎-松山,2023-10-19,9103
9945,潤泰新,8,0,8,群益金鼎-松山,2023-10-19,9103
3025,星通,22,15,7,群益金鼎-松山,2023-10-19,9103
3715,定穎投控,18,11,7,群益金鼎-松山,2023-10-19,9103
00720B,元大投資級公司債,9,2,7,群益金鼎-松山,2023-10-19,9103
2382,廣達,17,11,6,群益金鼎-松山,2023-10-19,9103
1304,台聚,6,0,6,群益金鼎-松山,2023-10-19,9103
1504,東元,6,0,6,群益金鼎-松山,2023-10-19,9103
2345,智邦,6,0,6,群益金鼎-松山,2023-10-19,9103
1524,耿鼎,14,9,5,群益金鼎-松山,2023-10-19,9103
00680L,元大美債20正2,5,0,5,群益金鼎-松山,2023-10-19,9103
00645,富邦日本,5,0,5,群益金鼎-松山,2023-10-19,9103
1409,新纖,5,0,5,群益金鼎-松山,2023-10-19,9103
2015,豐興,5,0,5,群益金鼎-松山,2023-10-19,9103
3003,健和興,5,0,5,群益金鼎-松山,2023-10-19,9103
1326,台化,4,0,4,群益金鼎-松山,2023-10-19,9103
2317,鴻海,5,1,4,群益金鼎-松山,2023-10-19,9103
2323,中環,4,0,4,群益金鼎-松山,2023-10-19,9103
2344,華邦電,5,1,4,群益金鼎-松山,2023-10-19,9103
2356,英業達,5,1,4,群益金鼎-松山,2023-10-19,9103
3042,晶技,4,0,4,群益金鼎-松山,2023-10-19,9103
5210,寶碩,5,1,4,群益金鼎-松山,2023-10-19,9103
6472,保瑞,5,1,4,群益金鼎-松山,2023-10-19,9103
3701,大眾控,3,0,3,群益金鼎-松山,2023-10-19,9103
8222,寶一,3,0,3,群益金鼎-松山,2023-10-19,9103
6669,緯穎,3,0,3,群益金鼎-松山,2023-10-19,9103
2301,光寶科,3,0,3,群益金鼎-松山,2023-10-19,9103
2377,微星,3,0,3,群益金鼎-松山,2023-10-19,9103
4911,德英,3,0,3,群益金鼎-松山,2023-10-19,9103
8227,巨有科技,3,0,3,群益金鼎-松山,2023-10-19,9103
8299,群聯,6,3,3,群益金鼎-松山,2023-10-19,9103
2353,宏��,5,2,3,群益金鼎-松山,2023-10-19,9103
2002,中鋼,2,0,2,群益金鼎-松山,2023-10-19,9103
2645,長榮航太,2,0,2,群益金鼎-松山,2023-10-19,9103
00680L,元大美債20正2,600,0,600,群益金鼎-松山,2023-10-20,9103
00679B,元大美債20年,510,0,510,群益金鼎-松山,2023-10-20,9103
1513,中興電,100,0,100,群益金鼎-松山,2023-10-20,9103
00664R,國泰臺灣加權反1,100,0,100,群益金鼎-松山,2023-10-20,9103
2618,長榮航,59,1,58,群益金鼎-松山,2023-10-20,9103
00919,群益台灣精選高息,40,0,40,群益金鼎-松山,2023-10-20,9103
00933B,國泰10Y+金融債,35,0,35,群益金鼎-松山,2023-10-20,9103
6235,華孚,23,0,23,群益金鼎-松山,2023-10-20,9103
3260,威剛,42,20,22,群益金鼎-松山,2023-10-20,9103
1471,首利,20,0,20,群益金鼎-松山,2023-10-20,9103
2363,矽統,42,22,20,群益金鼎-松山,2023-10-20,9103
2606,裕民,20,0,20,群益金鼎-松山,2023-10-20,9103
00712,復華富時不動產,18,0,18,群益金鼎-松山,2023-10-20,9103
9928,中視,20,2,18,群益金鼎-松山,2023-10-20,9103
6770,力積電,55,38,17,群益金鼎-松山,2023-10-20,9103
2371,大同,15,0,15,群益金鼎-松山,2023-10-20,9103
2891,中信金,15,0,15,群益金鼎-松山,2023-10-20,9103
1711,永光,15,2,13,群益金鼎-松山,2023-10-20,9103
2816,旺旺保,15,3,12,群益金鼎-松山,2023-10-20,9103
1903,士紙,10,0,10,群益金鼎-松山,2023-10-20,9103
2233,宇隆,10,0,10,群益金鼎-松山,2023-10-20,9103
3006,晶豪科,10,0,10,群益金鼎-松山,2023-10-20,9103
3294,英濟,10,0,10,群益金鼎-松山,2023-10-20,9103
6117,迎廣,10,0,10,群益金鼎-松山,2023-10-20,9103
6625,必應,10,0,10,群益金鼎-松山,2023-10-20,9103
00929,復華台灣科技優息,10,1,9,群益金鼎-松山,2023-10-20,9103
8176,智捷,11,2,9,群益金鼎-松山,2023-10-20,9103
4162,智擎,8,0,8,群益金鼎-松山,2023-10-20,9103
00878,國泰永續高股息,11,4,7,群益金鼎-松山,2023-10-20,9103
00772B,中信高評級公司債,7,0,7,群益金鼎-松山,2023-10-20,9103
2614,東森,7,0,7,群益金鼎-松山,2023-10-20,9103
3051,力特,9,2,7,群益金鼎-松山,2023-10-20,9103
3005,神基,6,0,6,群益金鼎-松山,2023-10-20,9103
3017,奇鋐,6,0,6,群益金鼎-松山,2023-10-20,9103
3041,揚智,9,3,6,群益金鼎-松山,2023-10-20,9103
2881,富邦金,6,1,5,群益金鼎-松山,2023-10-20,9103
00881,國泰台灣5G+,5,0,5,群益金鼎-松山,2023-10-20,9103
1409,新纖,5,0,5,群益金鼎-松山,2023-10-20,9103
0055,元大MSCI金融,5,0,5,群益金鼎-松山,2023-10-20,9103
2344,華邦電,5,0,5,群益金鼎-松山,2023-10-20,9103
2637,慧洋-KY,5,0,5,群益金鼎-松山,2023-10-20,9103
6150,撼訊,5,0,5,群益金鼎-松山,2023-10-20,9103
6432,今展科,7,2,5,群益金鼎-松山,2023-10-20,9103
2888,新光金,4,0,4,群益金鼎-松山,2023-10-20,9103
0056,元大高股息,7,3,4,群益金鼎-松山,2023-10-20,9103
2337,旺宏,4,0,4,群益金鼎-松山,2023-10-20,9103
3714,富采,4,0,4,群益金鼎-松山,2023-10-20,9103
8028,昇陽半導體,4,0,4,群益金鼎-松山,2023-10-20,9103
2886,兆豐金,4,0,4,群益金鼎-松山,2023-10-20,9103
2376,技嘉,3,0,3,群益金鼎-松山,2023-10-20,9103
00679B,元大美債20年,505,0,505,群益金鼎-松山,2023-10-23,9103
00680L,元大美債20正2,500,100,400,群益金鼎-松山,2023-10-23,9103
00671R,富邦NASDAQ反1,100,0,100,群益金鼎-松山,2023-10-23,9103
3701,大眾控,75,0,75,群益金鼎-松山,2023-10-23,9103
00929,復華台灣科技優息,44,0,44,群益金鼎-松山,2023-10-23,9103
3231,緯創,48,14,34,群益金鼎-松山,2023-10-23,9103
00919,群益台灣精選高息,31,0,31,群益金鼎-松山,2023-10-23,9103
6176,瑞儀,30,0,30,群益金鼎-松山,2023-10-23,9103
3051,力特,36,9,27,群益金鼎-松山,2023-10-23,9103
4944,兆遠,26,0,26,群益金鼎-松山,2023-10-23,9103
2605,新興,26,1,25,群益金鼎-松山,2023-10-23,9103
00712,復華富時不動產,21,0,21,群益金鼎-松山,2023-10-23,9103
2369,菱生,25,5,20,群益金鼎-松山,2023-10-23,9103
3450,聯鈞,20,0,20,群益金鼎-松山,2023-10-23,9103
8110,華東,20,0,20,群益金鼎-松山,2023-10-23,9103
3325,旭品,16,0,16,群益金鼎-松山,2023-10-23,9103
00882,中信中國高股息,15,0,15,群益金鼎-松山,2023-10-23,9103
00878,國泰永續高股息,15,0,15,群益金鼎-松山,2023-10-23,9103
6568,宏觀,11,0,11,群益金鼎-松山,2023-10-23,9103
2312,金寶,10,0,10,群益金鼎-松山,2023-10-23,9103
6164,華興,20,10,10,群益金鼎-松山,2023-10-23,9103
8926,台汽電,10,0,10,群益金鼎-松山,2023-10-23,9103
3017,奇鋐,10,1,9,群益金鼎-松山,2023-10-23,9103
2816,旺旺保,9,2,7,群益金鼎-松山,2023-10-23,9103
3557,嘉威,7,0,7,群益金鼎-松山,2023-10-23,9103
6168,宏齊,8,1,7,群益金鼎-松山,2023-10-23,9103
2233,宇隆,6,0,6,群益金鼎-松山,2023-10-23,9103
2427,三商電,6,0,6,群益金鼎-松山,2023-10-23,9103
6271,同欣電,6,0,6,群益金鼎-松山,2023-10-23,9103
6585,鼎基,6,0,6,群益金鼎-松山,2023-10-23,9103
8210,勤誠,7,1,6,群益金鼎-松山,2023-10-23,9103
2002,中鋼,6,1,5,群益金鼎-松山,2023-10-23,9103
2371,大同,5,0,5,群益金鼎-松山,2023-10-23,9103
2495,普安,5,0,5,群益金鼎-松山,2023-10-23,9103
2882,國泰金,5,0,5,群益金鼎-松山,2023-10-23,9103
3013,晟銘電,5,0,5,群益金鼎-松山,2023-10-23,9103
3708,上緯投控,5,0,5,群益金鼎-松山,2023-10-23,9103
3715,定穎投控,8,3,5,群益金鼎-松山,2023-10-23,9103
4304,勝昱,5,0,5,群益金鼎-松山,2023-10-23,9103
2356,英業達,4,0,4,群益金鼎-松山,2023-10-23,9103
3481,群創,4,0,4,群益金鼎-松山,2023-10-23,9103
8349,�矬�,4,0,4,群益金鼎-松山,2023-10-23,9103
9950,萬國通,4,0,4,群益金鼎-松山,2023-10-23,9103
2606,裕民,3,0,3,群益金鼎-松山,2023-10-23,9103
00637L,元大滬深300正2,3,0,3,群益金鼎-松山,2023-10-23,9103
00772B,中信高評級公司債,3,0,3,群益金鼎-松山,2023-10-23,9103
1519,華城,7,4,3,群益金鼎-松山,2023-10-23,9103
00931B,統一美債20年,3,0,3,群益金鼎-松山,2023-10-23,9103
2376,技嘉,3,0,3,群益金鼎-松山,2023-10-23,9103
2425,承啟,3,0,3,群益金鼎-松山,2023-10-23,9103
00664R,國泰臺灣加權反1,100,0,100,群益金鼎-松山,2023-10-24,9103
00830,國泰費城半導體,50,0,50,群益金鼎-松山,2023-10-24,9103
00919,群益台灣精選高息,50,0,50,群益金鼎-松山,2023-10-24,9103
6274,台燿,33,4,29,群益金鼎-松山,2023-10-24,9103
6625,必應,30,1,29,群益金鼎-松山,2023-10-24,9103
2388,威盛,31,3,28,群益金鼎-松山,2023-10-24,9103
2301,光寶科,25,0,25,群益金鼎-松山,2023-10-24,9103
00687B,國泰20年美債,25,1,24,群益金鼎-松山,2023-10-24,9103
3041,揚智,32,9,23,群益金鼎-松山,2023-10-24,9103
2104,國際中橡,20,0,20,群益金鼎-松山,2023-10-24,9103
1314,中石化,20,0,20,群益金鼎-松山,2023-10-24,9103
00788B,元大10年IG電能債,20,0,20,群益金鼎-松山,2023-10-24,9103
2382,廣達,17,0,17,群益金鼎-松山,2023-10-24,9103
2308,台達電,16,0,16,群益金鼎-松山,2023-10-24,9103
3025,星通,25,10,15,群益金鼎-松山,2023-10-24,9103
2305,全友,11,0,11,群益金鼎-松山,2023-10-24,9103
3363,上詮,20,9,11,群益金鼎-松山,2023-10-24,9103
2302,麗正,10,0,10,群益金鼎-松山,2023-10-24,9103
00637L,元大滬深300正2,9,0,9,群益金鼎-松山,2023-10-24,9103
2887,台新金,9,0,9,群益金鼎-松山,2023-10-24,9103
6164,華興,19,10,9,群益金鼎-松山,2023-10-24,9103
8349,�矬�,9,0,9,群益金鼎-松山,2023-10-24,9103
2884,玉山金,8,0,8,群益金鼎-松山,2023-10-24,9103
4908,前鼎,15,7,8,群益金鼎-松山,2023-10-24,9103
6147,頎邦,8,0,8,群益金鼎-松山,2023-10-24,9103
6901,鑽石投資,8,0,8,群益金鼎-松山,2023-10-24,9103
2317,鴻海,7,1,6,群益金鼎-松山,2023-10-24,9103
1795,美時,7,1,6,群益金鼎-松山,2023-10-24,9103
2344,華邦電,6,0,6,群益金鼎-松山,2023-10-24,9103
2345,智邦,6,0,6,群益金鼎-松山,2023-10-24,9103
3693,營邦,7,1,6,群益金鼎-松山,2023-10-24,9103
6197,佳必琪,7,1,6,群益金鼎-松山,2023-10-24,9103
1711,永光,5,0,5,群益金鼎-松山,2023-10-24,9103
1303,南亞,5,0,5,群益金鼎-松山,2023-10-24,9103
00645,富邦日本,5,0,5,群益金鼎-松山,2023-10-24,9103
00671R,富邦NASDAQ反1,5,0,5,群益金鼎-松山,2023-10-24,9103
2376,技嘉,11,6,5,群益金鼎-松山,2023-10-24,9103
2883,凱基金,5,0,5,群益金鼎-松山,2023-10-24,9103
6148,驊宏資,5,0,5,群益金鼎-松山,2023-10-24,9103
6168,宏齊,8,3,5,群益金鼎-松山,2023-10-24,9103
4542,科嶠,4,0,4,群益金鼎-松山,2023-10-24,9103
2468,華經,4,1,3,群益金鼎-松山,2023-10-24,9103
3011,今皓,3,0,3,群益金鼎-松山,2023-10-24,9103
3704,合勤控,5,2,3,群益金鼎-松山,2023-10-24,9103
5009,榮剛,3,0,3,群益金鼎-松山,2023-10-24,9103
4128,中天,2,0,2,群益金鼎-松山,2023-10-24,9103
0050,元大台灣50,2,0,2,群益金鼎-松山,2023-10-24,9103
1603,華電,2,0,2,群益金鼎-松山,2023-10-24,9103
00933B,國泰10Y+金融債,5,3,2,群益金鼎-松山,2023-10-24,9103
00907,永豐優息存股,2,0,2,群益金鼎-松山,2023-10-24,9103
3715,定穎投控,94,2,92,群益金鼎-松山,2023-10-25,9103
5469,瀚宇博,60,0,60,群益金鼎-松山,2023-10-25,9103
2476,鉅祥,55,0,55,群益金鼎-松山,2023-10-25,9103
00786B,元大10年IG銀行債,40,0,40,群益金鼎-松山,2023-10-25,9103
2399,映泰,39,2,37,群益金鼎-松山,2023-10-25,9103
00632R,元大台灣50反1,31,0,31,群益金鼎-松山,2023-10-25,9103
00751B,元大AAA至A公司債,30,0,30,群益金鼎-松山,2023-10-25,9103
3231,緯創,41,14,27,群益金鼎-松山,2023-10-25,9103
8110,華東,25,1,24,群益金鼎-松山,2023-10-25,9103
1815,富喬,24,2,22,群益金鼎-松山,2023-10-25,9103
2317,鴻海,22,1,21,群益金鼎-松山,2023-10-25,9103
2538,基泰,20,0,20,群益金鼎-松山,2023-10-25,9103
3265,台星科,20,0,20,群益金鼎-松山,2023-10-25,9103
2305,全友,30,11,19,群益金鼎-松山,2023-10-25,9103
3704,合勤控,26,8,18,群益金鼎-松山,2023-10-25,9103
3032,偉訓,17,0,17,群益金鼎-松山,2023-10-25,9103
3044,健鼎,17,0,17,群益金鼎-松山,2023-10-25,9103
3078,僑威,18,2,16,群益金鼎-松山,2023-10-25,9103
2888,新光金,13,0,13,群益金鼎-松山,2023-10-25,9103
2344,華邦電,11,0,11,群益金鼎-松山,2023-10-25,9103
2363,矽統,24,13,11,群益金鼎-松山,2023-10-25,9103
8210,勤誠,21,10,11,群益金鼎-松山,2023-10-25,9103
5272,笙科,10,0,10,群益金鼎-松山,2023-10-25,9103
2104,國際中橡,10,0,10,群益金鼎-松山,2023-10-25,9103
2485,兆赫,10,0,10,群益金鼎-松山,2023-10-25,9103
6197,佳必琪,15,6,9,群益金鼎-松山,2023-10-25,9103
3324,雙鴻,11,3,8,群益金鼎-松山,2023-10-25,9103
6223,旺矽,7,0,7,群益金鼎-松山,2023-10-25,9103
3693,營邦,13,6,7,群益金鼎-松山,2023-10-25,9103
00712,復華富時不動產,6,0,6,群益金鼎-松山,2023-10-25,9103
6472,保瑞,5,0,5,群益金鼎-松山,2023-10-25,9103
1524,耿鼎,41,36,5,群益金鼎-松山,2023-10-25,9103
00713,元大台灣高息低波,5,0,5,群益金鼎-松山,2023-10-25,9103
2883,凱基金,6,1,5,群益金鼎-松山,2023-10-25,9103
4979,華星光,6,1,5,群益金鼎-松山,2023-10-25,9103
6442,光聖,10,5,5,群益金鼎-松山,2023-10-25,9103
8936,國統,5,0,5,群益金鼎-松山,2023-10-25,9103
6531,愛普*,8,3,5,群益金鼎-松山,2023-10-25,9103
2882,國泰金,4,0,4,群益金鼎-松山,2023-10-25,9103
5258,虹堡,5,1,4,群益金鼎-松山,2023-10-25,9103
2201,裕隆,3,0,3,群益金鼎-松山,2023-10-25,9103
2493,揚博,3,0,3,群益金鼎-松山,2023-10-25,9103
2543,皇昌,3,0,3,群益金鼎-松山,2023-10-25,9103
2610,華航,3,0,3,群益金鼎-松山,2023-10-25,9103
2743,山富,8,5,3,群益金鼎-松山,2023-10-25,9103
3535,晶彩科,3,0,3,群益金鼎-松山,2023-10-25,9103
4908,前鼎,3,0,3,群益金鼎-松山,2023-10-25,9103
5210,寶碩,5,2,3,群益金鼎-松山,2023-10-25,9103
5351,鈺創,3,0,3,群益金鼎-松山,2023-10-25,9103
2886,兆豐金,2,0,2,群益金鼎-松山,2023-10-25,9103
00680L,元大美債20正2,1000,0,1000,群益金鼎-松山,2023-10-26,9103
00751B,元大AAA至A公司債,70,0,70,群益金鼎-松山,2023-10-26,9103
2412,中華電,63,0,63,群益金鼎-松山,2023-10-26,9103
00788B,元大10年IG電能債,60,0,60,群益金鼎-松山,2023-10-26,9103
8176,智捷,60,0,60,群益金鼎-松山,2023-10-26,9103
00786B,元大10年IG銀行債,40,0,40,群益金鼎-松山,2023-10-26,9103
00640L,富邦日本正2,30,0,30,群益金鼎-松山,2023-10-26,9103
2371,大同,28,0,28,群益金鼎-松山,2023-10-26,9103
2344,華邦電,24,0,24,群益金鼎-松山,2023-10-26,9103
00929,復華台灣科技優息,23,0,23,群益金鼎-松山,2023-10-26,9103
2816,旺旺保,44,22,22,群益金鼎-松山,2023-10-26,9103
6290,良維,22,0,22,群益金鼎-松山,2023-10-26,9103
3041,揚智,51,30,21,群益金鼎-松山,2023-10-26,9103
6113,亞矽,51,30,21,群益金鼎-松山,2023-10-26,9103
00679B,元大美債20年,20,0,20,群益金鼎-松山,2023-10-26,9103
00933B,國泰10Y+金融債,20,0,20,群益金鼎-松山,2023-10-26,9103
6168,宏齊,70,50,20,群益金鼎-松山,2023-10-26,9103
00878,國泰永續高股息,18,0,18,群益金鼎-松山,2023-10-26,9103
2399,映泰,18,0,18,群益金鼎-松山,2023-10-26,9103
2329,華泰,20,2,18,群益金鼎-松山,2023-10-26,9103
2465,麗臺,21,5,16,群益金鼎-松山,2023-10-26,9103
2330,台積電,16,0,16,群益金鼎-松山,2023-10-26,9103
2882,國泰金,15,0,15,群益金鼎-松山,2023-10-26,9103
6442,光聖,22,7,15,群益金鼎-松山,2023-10-26,9103
8201,無敵,13,0,13,群益金鼎-松山,2023-10-26,9103
00712,復華富時不動產,12,0,12,群益金鼎-松山,2023-10-26,9103
2201,裕隆,22,10,12,群益金鼎-松山,2023-10-26,9103
2303,聯電,17,5,12,群益金鼎-松山,2023-10-26,9103
2383,台光電,13,1,12,群益金鼎-松山,2023-10-26,9103
2337,旺宏,11,0,11,群益金鼎-松山,2023-10-26,9103
2485,兆赫,21,10,11,群益金鼎-松山,2023-10-26,9103
2883,凱基金,11,0,11,群益金鼎-松山,2023-10-26,9103
3290,東浦,11,0,11,群益金鼎-松山,2023-10-26,9103
00919,群益台灣精選高息,12,2,10,群益金鼎-松山,2023-10-26,9103
1711,永光,10,0,10,群益金鼎-松山,2023-10-26,9103
3058,立德,10,0,10,群益金鼎-松山,2023-10-26,9103
6133,金橋,10,0,10,群益金鼎-松山,2023-10-26,9103
6237,驊訊,57,47,10,群益金鼎-松山,2023-10-26,9103
6243,迅杰,20,10,10,群益金鼎-松山,2023-10-26,9103
3025,星通,16,8,8,群益金鼎-松山,2023-10-26,9103
6770,力積電,7,0,7,群益金鼎-松山,2023-10-26,9103
2633,台灣高鐵,6,0,6,群益金鼎-松山,2023-10-26,9103
2250,IKKA-KY,6,0,6,群益金鼎-松山,2023-10-26,9103
2390,云辰,6,0,6,群益金鼎-松山,2023-10-26,9103
2516,新建,6,0,6,群益金鼎-松山,2023-10-26,9103
1721,三晃,5,0,5,群益金鼎-松山,2023-10-26,9103
00696B,富邦美債20年,5,0,5,群益金鼎-松山,2023-10-26,9103
00720B,元大投資級公司債,5,0,5,群益金鼎-松山,2023-10-26,9103
2605,新興,6,1,5,群益金鼎-松山,2023-10-26,9103
3042,晶技,6,1,5,群益金鼎-松山,2023-10-26,9103
2369,菱生,60,0,60,群益金鼎-松山,2023-10-27,9103
1721,三晃,25,6,19,群益金鼎-松山,2023-10-27,9103
3032,偉訓,19,1,18,群益金鼎-松山,2023-10-27,9103
6589,台康生技,16,0,16,群益金鼎-松山,2023-10-27,9103
00712,復華富時不動產,15,0,15,群益金鼎-松山,2023-10-27,9103
2382,廣達,12,1,11,群益金鼎-松山,2023-10-27,9103
2230,泰茂,10,0,10,群益金鼎-松山,2023-10-27,9103
2031,新光鋼,10,0,10,群益金鼎-松山,2023-10-27,9103
2331,精英,10,0,10,群益金鼎-松山,2023-10-27,9103
2337,旺宏,10,0,10,群益金鼎-松山,2023-10-27,9103
2388,威盛,14,4,10,群益金鼎-松山,2023-10-27,9103
2408,南亞科,10,0,10,群益金鼎-松山,2023-10-27,9103
3058,立德,10,0,10,群益金鼎-松山,2023-10-27,9103
6150,撼訊,15,5,10,群益金鼎-松山,2023-10-27,9103
00687B,國泰20年美債,10,1,9,群益金鼎-松山,2023-10-27,9103
2409,友達,11,2,9,群益金鼎-松山,2023-10-27,9103
3264,欣銓,11,2,9,群益金鼎-松山,2023-10-27,9103
4162,智擎,12,4,8,群益金鼎-松山,2023-10-27,9103
00679B,元大美債20年,7,0,7,群益金鼎-松山,2023-10-27,9103
4908,前鼎,10,3,7,群益金鼎-松山,2023-10-27,9103
00671R,富邦NASDAQ反1,6,0,6,群益金鼎-松山,2023-10-27,9103
00919,群益台灣精選高息,6,1,5,群益金鼎-松山,2023-10-27,9103
1795,美時,11,6,5,群益金鼎-松山,2023-10-27,9103
2344,華邦電,5,0,5,群益金鼎-松山,2023-10-27,9103
2743,山富,15,10,5,群益金鼎-松山,2023-10-27,9103
2816,旺旺保,7,2,5,群益金鼎-松山,2023-10-27,9103
4743,合一,12,7,5,群益金鼎-松山,2023-10-27,9103
4977,眾達-KY,8,3,5,群益金鼎-松山,2023-10-27,9103
2886,兆豐金,16,12,4,群益金鼎-松山,2023-10-27,9103
3289,宜特,4,0,4,群益金鼎-松山,2023-10-27,9103
8227,巨有科技,4,0,4,群益金鼎-松山,2023-10-27,9103
1519,華城,4,1,3,群益金鼎-松山,2023-10-27,9103
00885,富邦越南,3,0,3,群益金鼎-松山,2023-10-27,9103
3078,僑威,3,0,3,群益金鼎-松山,2023-10-27,9103
3163,波若威,6,3,3,群益金鼎-松山,2023-10-27,9103
3557,嘉威,10,7,3,群益金鼎-松山,2023-10-27,9103
4128,中天,23,20,3,群益金鼎-松山,2023-10-27,9103
5289,宜鼎,3,0,3,群益金鼎-松山,2023-10-27,9103
6446,藥華藥,3,0,3,群益金鼎-松山,2023-10-27,9103
6531,愛普*,3,0,3,群益金鼎-松山,2023-10-27,9103
8068,全達,4,1,3,群益金鼎-松山,2023-10-27,9103
2454,聯發科,2,0,2,群益金鼎-松山,2023-10-27,9103
00892,富邦台灣半導體,2,0,2,群益金鼎-松山,2023-10-27,9103
1409,新纖,2,0,2,群益金鼎-松山,2023-10-27,9103
2250,IKKA-KY,2,0,2,群益金鼎-松山,2023-10-27,9103
2486,一詮,7,5,2,群益金鼎-松山,2023-10-27,9103
2618,長榮航,4,2,2,群益金鼎-松山,2023-10-27,9103
3014,聯陽,2,0,2,群益金鼎-松山,2023-10-27,9103
3276,宇環,7,5,2,群益金鼎-松山,2023-10-27,9103
3450,聯鈞,2,0,2,群益金鼎-松山,2023-10-27,9103
1522,堤維西,123,0,123,群益金鼎-松山,2023-10-30,9103
00786B,元大10年IG銀行債,90,0,90,群益金鼎-松山,2023-10-30,9103
2313,華通,50,1,49,群益金鼎-松山,2023-10-30,9103
3576,聯合再生,31,1,30,群益金鼎-松山,2023-10-30,9103
9928,中視,20,0,20,群益金鼎-松山,2023-10-30,9103
2328,廣宇,14,0,14,群益金鼎-松山,2023-10-30,9103
5215,科嘉-KY,16,3,13,群益金鼎-松山,2023-10-30,9103
2603,長榮,21,10,11,群益金鼎-松山,2023-10-30,9103
00712,復華富時不動產,10,0,10,群益金鼎-松山,2023-10-30,9103
2230,泰茂,10,0,10,群益金鼎-松山,2023-10-30,9103
2312,金寶,10,0,10,群益金鼎-松山,2023-10-30,9103
2636,台驊控股,10,0,10,群益金鼎-松山,2023-10-30,9103
2816,旺旺保,10,0,10,群益金鼎-松山,2023-10-30,9103
6237,驊訊,12,2,10,群益金鼎-松山,2023-10-30,9103
6278,台表科,11,1,10,群益金鼎-松山,2023-10-30,9103
2406,國碩,8,0,8,群益金鼎-松山,2023-10-30,9103
3041,揚智,26,19,7,群益金鼎-松山,2023-10-30,9103
8176,智捷,7,0,7,群益金鼎-松山,2023-10-30,9103
6442,光聖,6,0,6,群益金鼎-松山,2023-10-30,9103
6472,保瑞,9,3,6,群益金鼎-松山,2023-10-30,9103
1528,恩德,5,0,5,群益金鼎-松山,2023-10-30,9103
1785,光洋科,5,0,5,群益金鼎-松山,2023-10-30,9103
2883,凱基金,5,0,5,群益金鼎-松山,2023-10-30,9103
3014,聯陽,7,2,5,群益金鼎-松山,2023-10-30,9103
4934,太極,5,0,5,群益金鼎-松山,2023-10-30,9103
6150,撼訊,5,0,5,群益金鼎-松山,2023-10-30,9103
8088,品安,6,1,5,群益金鼎-松山,2023-10-30,9103
9907,統一實,5,0,5,群益金鼎-松山,2023-10-30,9103
01007T,兆豐國泰R2,4,0,4,群益金鼎-松山,2023-10-30,9103
1303,南亞,4,0,4,群益金鼎-松山,2023-10-30,9103
2885,元大金,4,0,4,群益金鼎-松山,2023-10-30,9103
3017,奇鋐,5,1,4,群益金鼎-松山,2023-10-30,9103
4162,智擎,8,4,4,群益金鼎-松山,2023-10-30,9103
9910,豐泰,4,0,4,群益金鼎-松山,2023-10-30,9103
0056,元大高股息,3,0,3,群益金鼎-松山,2023-10-30,9103
00671R,富邦NASDAQ反1,3,0,3,群益金鼎-松山,2023-10-30,9103
2250,IKKA-KY,3,0,3,群益金鼎-松山,2023-10-30,9103
2364,倫飛,14,11,3,群益金鼎-松山,2023-10-30,9103
2376,技嘉,8,5,3,群益金鼎-松山,2023-10-30,9103
6146,耕興,3,0,3,群益金鼎-松山,2023-10-30,9103
2419,仲琦,2,0,2,群益金鼎-松山,2023-10-30,9103
2886,兆豐金,2,0,2,群益金鼎-松山,2023-10-30,9103
4961,天鈺,4,2,2,群益金鼎-松山,2023-10-30,9103
00885,富邦越南,2,0,2,群益金鼎-松山,2023-10-30,9103
1609,大亞,2,0,2,群益金鼎-松山,2023-10-30,9103
2301,光寶科,2,0,2,群益金鼎-松山,2023-10-30,9103
2497,怡利電,2,0,2,群益金鼎-松山,2023-10-30,9103
2887,台新金,2,0,2,群益金鼎-松山,2023-10-30,9103
2891,中信金,2,0,2,群益金鼎-松山,2023-10-30,9103
3693,營邦,2,0,2,群益金鼎-松山,2023-10-30,9103
1217,愛之味,61,0,61,群益金鼎-松山,2023-10-31,9103
006206,元大上證50,50,0,50,群益金鼎-松山,2023-10-31,9103
00712,復華富時不動產,40,0,40,群益金鼎-松山,2023-10-31,9103
00788B,元大10年IG電能債,40,0,40,群益金鼎-松山,2023-10-31,9103
6235,華孚,34,0,34,群益金鼎-松山,2023-10-31,9103
1314,中石化,30,0,30,群益金鼎-松山,2023-10-31,9103
6213,聯茂,20,0,20,群益金鼎-松山,2023-10-31,9103
3704,合勤控,24,5,19,群益金鼎-松山,2023-10-31,9103
00679B,元大美債20年,14,0,14,群益金鼎-松山,2023-10-31,9103
2344,華邦電,13,0,13,群益金鼎-松山,2023-10-31,9103
2352,佳世達,11,0,11,群益金鼎-松山,2023-10-31,9103
3623,富晶通,11,0,11,群益金鼎-松山,2023-10-31,9103
9950,萬國通,13,2,11,群益金鼎-松山,2023-10-31,9103
3231,緯創,14,4,10,群益金鼎-松山,2023-10-31,9103
1605,華新,10,0,10,群益金鼎-松山,2023-10-31,9103
2002,中鋼,10,0,10,群益金鼎-松山,2023-10-31,9103
2399,映泰,10,0,10,群益金鼎-松山,2023-10-31,9103
2417,圓剛,11,1,10,群益金鼎-松山,2023-10-31,9103
4533,協易機,10,0,10,群益金鼎-松山,2023-10-31,9103
6143,振曜,11,1,10,群益金鼎-松山,2023-10-31,9103
8054,安國,11,2,9,群益金鼎-松山,2023-10-31,9103
2330,台積電,8,0,8,群益金鼎-松山,2023-10-31,9103
2353,宏��,8,0,8,群益金鼎-松山,2023-10-31,9103
3491,昇達科,9,1,8,群益金鼎-松山,2023-10-31,9103
2312,金寶,7,0,7,群益金鼎-松山,2023-10-31,9103
9945,潤泰新,7,0,7,群益金鼎-松山,2023-10-31,9103
00637L,元大滬深300正2,5,0,5,群益金鼎-松山,2023-10-31,9103
00878,國泰永續高股息,7,2,5,群益金鼎-松山,2023-10-31,9103
00713,元大台灣高息低波,5,0,5,群益金鼎-松山,2023-10-31,9103
1337,再生-KY,5,0,5,群益金鼎-松山,2023-10-31,9103
00929,復華台灣科技優息,5,0,5,群益金鼎-松山,2023-10-31,9103
3264,欣銓,5,0,5,群益金鼎-松山,2023-10-31,9103
4102,永日,5,0,5,群益金鼎-松山,2023-10-31,9103
5425,台半,5,0,5,群益金鼎-松山,2023-10-31,9103
6112,邁達特,5,0,5,群益金鼎-松山,2023-10-31,9103
6492,生華科,5,0,5,群益金鼎-松山,2023-10-31,9103
00922,國泰台灣領袖50,4,0,4,群益金鼎-松山,2023-10-31,9103
00687B,國泰20年美債,5,1,4,群益金鼎-松山,2023-10-31,9103
2390,云辰,5,1,4,群益金鼎-松山,2023-10-31,9103
2486,一詮,11,7,4,群益金鼎-松山,2023-10-31,9103
3380,明泰,4,0,4,群益金鼎-松山,2023-10-31,9103
5469,瀚宇博,4,0,4,群益金鼎-松山,2023-10-31,9103
6443,元晶,4,0,4,群益金鼎-松山,2023-10-31,9103
0050,元大台灣50,3,0,3,群益金鼎-松山,2023-10-31,9103
0056,元大高股息,3,0,3,群益金鼎-松山,2023-10-31,9103
3042,晶技,7,4,3,群益金鼎-松山,2023-10-31,9103
6531,愛普*,5,2,3,群益金鼎-松山,2023-10-31,9103
00715L,期街口布蘭特正2,3,0,3,群益金鼎-松山,2023-10-31,9103
2250,IKKA-KY,3,0,3,群益金鼎-松山,2023-10-31,9103
2392,正崴,3,0,3,群益金鼎-松山,2023-10-31,9103
00637L,元大滬深300正2,100,0,100,群益金鼎-松山,2023-11-01,9103
8936,國統,51,1,50,群益金鼎-松山,2023-11-01,9103
2313,華通,50,2,48,群益金鼎-松山,2023-11-01,9103
00751B,元大AAA至A公司債,40,0,40,群益金鼎-松山,2023-11-01,9103
00933B,國泰10Y+金融債,20,0,20,群益金鼎-松山,2023-11-01,9103
00786B,元大10年IG銀行債,20,0,20,群益金鼎-松山,2023-11-01,9103
3715,定穎投控,32,12,20,群益金鼎-松山,2023-11-01,9103
5608,四維航,20,0,20,群益金鼎-松山,2023-11-01,9103
4979,華星光,19,0,19,群益金鼎-松山,2023-11-01,9103
00679B,元大美債20年,18,0,18,群益金鼎-松山,2023-11-01,9103
00878,國泰永續高股息,17,0,17,群益金鼎-松山,2023-11-01,9103
00673R,期元大S＆P原油反1,16,0,16,群益金鼎-松山,2023-11-01,9103
3512,皇龍,15,0,15,群益金鼎-松山,2023-11-01,9103
3531,先益,15,0,15,群益金鼎-松山,2023-11-01,9103
2388,威盛,28,14,14,群益金鼎-松山,2023-11-01,9103
3308,聯德,13,0,13,群益金鼎-松山,2023-11-01,9103
3046,建��,11,0,11,群益金鼎-松山,2023-11-01,9103
6548,長科*,11,0,11,群益金鼎-松山,2023-11-01,9103
5469,瀚宇博,10,0,10,群益金鼎-松山,2023-11-01,9103
00680L,元大美債20正2,10,0,10,群益金鼎-松山,2023-11-01,9103
2363,矽統,20,10,10,群益金鼎-松山,2023-11-01,9103
4967,十銓,10,0,10,群益金鼎-松山,2023-11-01,9103
1589,永冠-KY,9,0,9,群益金鼎-松山,2023-11-01,9103
2496,卓越,9,0,9,群益金鼎-松山,2023-11-01,9103
2745,五福,9,0,9,群益金鼎-松山,2023-11-01,9103
3363,上詮,13,4,9,群益金鼎-松山,2023-11-01,9103
3596,智易,9,0,9,群益金鼎-松山,2023-11-01,9103
0056,元大高股息,8,0,8,群益金鼎-松山,2023-11-01,9103
5353,台林,8,0,8,群益金鼎-松山,2023-11-01,9103
2485,兆赫,7,0,7,群益金鼎-松山,2023-11-01,9103
2743,山富,17,10,7,群益金鼎-松山,2023-11-01,9103
4128,中天,7,0,7,群益金鼎-松山,2023-11-01,9103
6419,京晨科,7,0,7,群益金鼎-松山,2023-11-01,9103
2367,燿華,10,4,6,群益金鼎-松山,2023-11-01,9103
4162,智擎,6,0,6,群益金鼎-松山,2023-11-01,9103
2883,凱基金,6,0,6,群益金鼎-松山,2023-11-01,9103
00671R,富邦NASDAQ反1,5,0,5,群益金鼎-松山,2023-11-01,9103
1504,東元,5,0,5,群益金鼎-松山,2023-11-01,9103
2356,英業達,6,1,5,群益金鼎-松山,2023-11-01,9103
3213,茂訊,6,1,5,群益金鼎-松山,2023-11-01,9103
3545,敦泰,5,0,5,群益金鼎-松山,2023-11-01,9103
3682,亞太電,5,0,5,群益金鼎-松山,2023-11-01,9103
4743,合一,6,1,5,群益金鼎-松山,2023-11-01,9103
6150,撼訊,8,3,5,群益金鼎-松山,2023-11-01,9103
6173,信昌電,5,0,5,群益金鼎-松山,2023-11-01,9103
6245,立端,5,0,5,群益金鼎-松山,2023-11-01,9103
6446,藥華藥,5,0,5,群益金鼎-松山,2023-11-01,9103
6657,華安,5,0,5,群益金鼎-松山,2023-11-01,9103
3105,穩懋,5,1,4,群益金鼎-松山,2023-11-01,9103
1795,美時,4,0,4,群益金鼎-松山,2023-11-01,9103
1217,愛之味,932,721,211,群益金鼎-松山,2023-11-02,9103
6116,彩晶,200,0,200,群益金鼎-松山,2023-11-02,9103
00878,國泰永續高股息,124,0,124,群益金鼎-松山,2023-11-02,9103
3481,群創,119,1,118,群益金鼎-松山,2023-11-02,9103
2515,中工,100,0,100,群益金鼎-松山,2023-11-02,9103
1815,富喬,103,16,87,群益金鼎-松山,2023-11-02,9103
00919,群益台灣精選高息,82,0,82,群益金鼎-松山,2023-11-02,9103
2399,映泰,53,3,50,群益金鼎-松山,2023-11-02,9103
8936,國統,62,17,45,群益金鼎-松山,2023-11-02,9103
4188,安克,39,0,39,群益金鼎-松山,2023-11-02,9103
00712,復華富時不動產,38,4,34,群益金鼎-松山,2023-11-02,9103
2408,南亞科,30,0,30,群益金鼎-松山,2023-11-02,9103
1522,堤維西,25,0,25,群益金鼎-松山,2023-11-02,9103
8054,安國,40,16,24,群益金鼎-松山,2023-11-02,9103
00632R,元大台灣50反1,21,0,21,群益金鼎-松山,2023-11-02,9103
00720B,元大投資級公司債,20,0,20,群益金鼎-松山,2023-11-02,9103
4967,十銓,20,1,19,群益金鼎-松山,2023-11-02,9103
6531,愛普*,25,7,18,群益金鼎-松山,2023-11-02,9103
3260,威剛,18,2,16,群益金鼎-松山,2023-11-02,9103
2465,麗臺,15,0,15,群益金鼎-松山,2023-11-02,9103
5348,正能量智能,20,5,15,群益金鼎-松山,2023-11-02,9103
2363,矽統,39,26,13,群益金鼎-松山,2023-11-02,9103
6164,華興,11,0,11,群益金鼎-松山,2023-11-02,9103
8046,南電,12,1,11,群益金鼎-松山,2023-11-02,9103
2230,泰茂,10,0,10,群益金鼎-松山,2023-11-02,9103
00671R,富邦NASDAQ反1,10,0,10,群益金鼎-松山,2023-11-02,9103
00640L,富邦日本正2,10,0,10,群益金鼎-松山,2023-11-02,9103
3682,亞太電,10,0,10,群益金鼎-松山,2023-11-02,9103
4536,拓凱,10,0,10,群益金鼎-松山,2023-11-02,9103
8271,宇瞻,8,0,8,群益金鼎-松山,2023-11-02,9103
2356,英業達,7,0,7,群益金鼎-松山,2023-11-02,9103
2382,廣達,11,4,7,群益金鼎-松山,2023-11-02,9103
8150,南茂,7,0,7,群益金鼎-松山,2023-11-02,9103
8227,巨有科技,7,0,7,群益金鼎-松山,2023-11-02,9103
3025,星通,12,6,6,群益金鼎-松山,2023-11-02,9103
8084,巨虹,5,0,5,群益金鼎-松山,2023-11-02,9103
00637L,元大滬深300正2,5,0,5,群益金鼎-松山,2023-11-02,9103
3041,揚智,5,0,5,群益金鼎-松山,2023-11-02,9103
6150,撼訊,16,11,5,群益金鼎-松山,2023-11-02,9103
8210,勤誠,7,2,5,群益金鼎-松山,2023-11-02,9103
6191,精成科,22,18,4,群益金鼎-松山,2023-11-02,9103
1721,三晃,4,0,4,群益金鼎-松山,2023-11-02,9103
3363,上詮,7,3,4,群益金鼎-松山,2023-11-02,9103
4743,合一,4,0,4,群益金鼎-松山,2023-11-02,9103
8442,威宏-KY,4,0,4,群益金鼎-松山,2023-11-02,9103
1618,合機,3,0,3,群益金鼎-松山,2023-11-02,9103
1603,華電,3,0,3,群益金鼎-松山,2023-11-02,9103
2371,大同,5,2,3,群益金鼎-松山,2023-11-02,9103
3013,晟銘電,12,9,3,群益金鼎-松山,2023-11-02,9103
3346,麗清,3,0,3,群益金鼎-松山,2023-11-02,9103
2610,華航,117,3,114,群益金鼎-松山,2023-11-03,9103
2352,佳世達,60,5,55,群益金鼎-松山,2023-11-03,9103
00715L,期街口布蘭特正2,50,6,44,群益金鼎-松山,2023-11-03,9103
2816,旺旺保,47,6,41,群益金鼎-松山,2023-11-03,9103
2915,潤泰全,30,0,30,群益金鼎-松山,2023-11-03,9103
8432,東生華,28,0,28,群益金鼎-松山,2023-11-03,9103
3176,基亞,23,0,23,群益金鼎-松山,2023-11-03,9103
00830,國泰費城半導體,20,0,20,群益金鼎-松山,2023-11-03,9103
6213,聯茂,20,0,20,群益金鼎-松山,2023-11-03,9103
6235,華孚,22,3,19,群益金鼎-松山,2023-11-03,9103
2330,台積電,20,1,19,群益金鼎-松山,2023-11-03,9103
8936,國統,19,1,18,群益金鼎-松山,2023-11-03,9103
6204,艾華,16,0,16,群益金鼎-松山,2023-11-03,9103
3508,位速,15,0,15,群益金鼎-松山,2023-11-03,9103
00632R,元大台灣50反1,11,0,11,群益金鼎-松山,2023-11-03,9103
6531,愛普*,29,18,11,群益金鼎-松山,2023-11-03,9103
00929,復華台灣科技優息,10,0,10,群益金鼎-松山,2023-11-03,9103
00752,中信中國50,10,0,10,群益金鼎-松山,2023-11-03,9103
00720B,元大投資級公司債,10,0,10,群益金鼎-松山,2023-11-03,9103
00687B,國泰20年美債,10,0,10,群益金鼎-松山,2023-11-03,9103
00671R,富邦NASDAQ反1,10,0,10,群益金鼎-松山,2023-11-03,9103
00670L,富邦NASDAQ正2,10,0,10,群益金鼎-松山,2023-11-03,9103
2449,京元電子,10,0,10,群益金鼎-松山,2023-11-03,9103
3693,營邦,10,0,10,群益金鼎-松山,2023-11-03,9103
6125,廣運,10,0,10,群益金鼎-松山,2023-11-03,9103
6168,宏齊,10,0,10,群益金鼎-松山,2023-11-03,9103
3041,揚智,9,0,9,群益金鼎-松山,2023-11-03,9103
5344,立衛,9,0,9,群益金鼎-松山,2023-11-03,9103
2382,廣達,9,1,8,群益金鼎-松山,2023-11-03,9103
2371,大同,8,0,8,群益金鼎-松山,2023-11-03,9103
00934,中信成長高股息,7,0,7,群益金鼎-松山,2023-11-03,9103
2353,宏��,7,0,7,群益金鼎-松山,2023-11-03,9103
6112,邁達特,7,0,7,群益金鼎-松山,2023-11-03,9103
2317,鴻海,6,0,6,群益金鼎-松山,2023-11-03,9103
2458,義隆,6,1,5,群益金鼎-松山,2023-11-03,9103
1513,中興電,6,1,5,群益金鼎-松山,2023-11-03,9103
2344,華邦電,5,0,5,群益金鼎-松山,2023-11-03,9103
2743,山富,11,6,5,群益金鼎-松山,2023-11-03,9103
3058,立德,5,0,5,群益金鼎-松山,2023-11-03,9103
3376,新日興,6,1,5,群益金鼎-松山,2023-11-03,9103
3702,大聯大,5,0,5,群益金鼎-松山,2023-11-03,9103
8442,威宏-KY,5,0,5,群益金鼎-松山,2023-11-03,9103
2250,IKKA-KY,4,0,4,群益金鼎-松山,2023-11-03,9103
3014,聯陽,4,0,4,群益金鼎-松山,2023-11-03,9103
5348,正能量智能,4,0,4,群益金鼎-松山,2023-11-03,9103
8046,南電,4,0,4,群益金鼎-松山,2023-11-03,9103
1618,合機,3,0,3,群益金鼎-松山,2023-11-03,9103
2331,精英,3,0,3,群益金鼎-松山,2023-11-03,9103
1560,中砂,4,1,3,群益金鼎-松山,2023-11-03,9103
1519,華城,5,2,3,群益金鼎-松山,2023-11-03,9103
1815,富喬,207,3,204,群益金鼎-松山,2023-11-06,9103
1785,光洋科,160,0,160,群益金鼎-松山,2023-11-06,9103
2409,友達,100,0,100,群益金鼎-松山,2023-11-06,9103
3481,群創,100,0,100,群益金鼎-松山,2023-11-06,9103
2618,長榮航,92,1,91,群益金鼎-松山,2023-11-06,9103
2313,華通,53,1,52,群益金鼎-松山,2023-11-06,9103
00640L,富邦日本正2,30,0,30,群益金鼎-松山,2023-11-06,9103
1609,大亞,30,0,30,群益金鼎-松山,2023-11-06,9103
1605,華新,30,0,30,群益金鼎-松山,2023-11-06,9103
2303,聯電,35,10,25,群益金鼎-松山,2023-11-06,9103
8086,宏捷科,36,11,25,群益金鼎-松山,2023-11-06,9103
3217,優群,21,0,21,群益金鼎-松山,2023-11-06,9103
1591,駿吉-KY,20,0,20,群益金鼎-松山,2023-11-06,9103
3260,威剛,20,1,19,群益金鼎-松山,2023-11-06,9103
2376,技嘉,27,10,17,群益金鼎-松山,2023-11-06,9103
00931B,統一美債20年,15,0,15,群益金鼎-松山,2023-11-06,9103
2458,義隆,17,2,15,群益金鼎-松山,2023-11-06,9103
6806,森崴能源,14,0,14,群益金鼎-松山,2023-11-06,9103
4968,立積,12,0,12,群益金鼎-松山,2023-11-06,9103
00687B,國泰20年美債,12,1,11,群益金鼎-松山,2023-11-06,9103
2329,華泰,29,18,11,群益金鼎-松山,2023-11-06,9103
3022,威強電,11,0,11,群益金鼎-松山,2023-11-06,9103
8054,安國,30,19,11,群益金鼎-松山,2023-11-06,9103
6213,聯茂,30,20,10,群益金鼎-松山,2023-11-06,9103
00670L,富邦NASDAQ正2,20,10,10,群益金鼎-松山,2023-11-06,9103
3374,精材,11,1,10,群益金鼎-松山,2023-11-06,9103
3231,緯創,12,3,9,群益金鼎-松山,2023-11-06,9103
1514,亞力,20,12,8,群益金鼎-松山,2023-11-06,9103
5225,東科-KY,10,2,8,群益金鼎-松山,2023-11-06,9103
1519,華城,25,18,7,群益金鼎-松山,2023-11-06,9103
2363,矽統,64,57,7,群益金鼎-松山,2023-11-06,9103
3035,智原,10,3,7,群益金鼎-松山,2023-11-06,9103
00671R,富邦NASDAQ反1,6,0,6,群益金鼎-松山,2023-11-06,9103
6235,華孚,22,16,6,群益金鼎-松山,2023-11-06,9103
00919,群益台灣精選高息,5,0,5,群益金鼎-松山,2023-11-06,9103
1560,中砂,5,0,5,群益金鼎-松山,2023-11-06,9103
2399,映泰,5,0,5,群益金鼎-松山,2023-11-06,9103
2453,凌群,5,0,5,群益金鼎-松山,2023-11-06,9103
6269,台郡,5,0,5,群益金鼎-松山,2023-11-06,9103
6292,迅德,5,0,5,群益金鼎-松山,2023-11-06,9103
2201,裕隆,6,1,5,群益金鼎-松山,2023-11-06,9103
1529,樂事綠能,4,0,4,群益金鼎-松山,2023-11-06,9103
00715L,期街口布蘭特正2,4,0,4,群益金鼎-松山,2023-11-06,9103
00935,野村臺灣新科技50,4,0,4,群益金鼎-松山,2023-11-06,9103
3693,營邦,12,8,4,群益金鼎-松山,2023-11-06,9103
4763,材料-KY,4,0,4,群益金鼎-松山,2023-11-06,9103
6139,亞翔,4,0,4,群益金鼎-松山,2023-11-06,9103
00934,中信成長高股息,3,0,3,群益金鼎-松山,2023-11-06,9103
2344,華邦電,3,0,3,群益金鼎-松山,2023-11-06,9103
2486,一詮,13,10,3,群益金鼎-松山,2023-11-06,9103
8110,華東,311,0,311,群益金鼎-松山,2023-11-07,9103
2515,中工,300,0,300,群益金鼎-松山,2023-11-07,9103
2462,良得電,50,0,50,群益金鼎-松山,2023-11-07,9103
6290,良維,40,2,38,群益金鼎-松山,2023-11-07,9103
3376,新日興,31,0,31,群益金鼎-松山,2023-11-07,9103
6901,鑽石投資,28,0,28,群益金鼎-松山,2023-11-07,9103
3306,鼎天,26,0,26,群益金鼎-松山,2023-11-07,9103
3041,揚智,48,23,25,群益金鼎-松山,2023-11-07,9103
3006,晶豪科,20,0,20,群益金鼎-松山,2023-11-07,9103
2371,大同,17,0,17,群益金鼎-松山,2023-11-07,9103
3450,聯鈞,11,0,11,群益金鼎-松山,2023-11-07,9103
2312,金寶,10,0,10,群益金鼎-松山,2023-11-07,9103
2382,廣達,12,2,10,群益金鼎-松山,2023-11-07,9103
1514,亞力,41,31,10,群益金鼎-松山,2023-11-07,9103
9950,萬國通,34,26,8,群益金鼎-松山,2023-11-07,9103
2317,鴻海,7,0,7,群益金鼎-松山,2023-11-07,9103
2743,山富,17,10,7,群益金鼎-松山,2023-11-07,9103
6416,瑞祺電通,10,3,7,群益金鼎-松山,2023-11-07,9103
2344,華邦電,6,0,6,群益金鼎-松山,2023-11-07,9103
1795,美時,7,1,6,群益金鼎-松山,2023-11-07,9103
00725B,國泰投資級公司債,6,0,6,群益金鼎-松山,2023-11-07,9103
2610,華航,6,0,6,群益金鼎-松山,2023-11-07,9103
6462,神盾,6,0,6,群益金鼎-松山,2023-11-07,9103
00637L,元大滬深300正2,5,0,5,群益金鼎-松山,2023-11-07,9103
2363,矽統,40,35,5,群益金鼎-松山,2023-11-07,9103
2376,技嘉,25,20,5,群益金鼎-松山,2023-11-07,9103
2884,玉山金,5,0,5,群益金鼎-松山,2023-11-07,9103
3363,上詮,8,3,5,群益金鼎-松山,2023-11-07,9103
5225,東科-KY,5,0,5,群益金鼎-松山,2023-11-07,9103
6188,廣明,5,0,5,群益金鼎-松山,2023-11-07,9103
4968,立積,4,0,4,群益金鼎-松山,2023-11-07,9103
00929,復華台灣科技優息,4,0,4,群益金鼎-松山,2023-11-07,9103
00715L,期街口布蘭特正2,4,0,4,群益金鼎-松山,2023-11-07,9103
2486,一詮,4,0,4,群益金鼎-松山,2023-11-07,9103
3025,星通,12,8,4,群益金鼎-松山,2023-11-07,9103
6274,台燿,6,2,4,群益金鼎-松山,2023-11-07,9103
1524,耿鼎,4,1,3,群益金鼎-松山,2023-11-07,9103
1568,倉佑,3,0,3,群益金鼎-松山,2023-11-07,9103
2059,川湖,3,0,3,群益金鼎-松山,2023-11-07,9103
2816,旺旺保,5,2,3,群益金鼎-松山,2023-11-07,9103
4967,十銓,3,0,3,群益金鼎-松山,2023-11-07,9103
8069,元太,3,0,3,群益金鼎-松山,2023-11-07,9103
8210,勤誠,6,3,3,群益金鼎-松山,2023-11-07,9103
2201,裕隆,2,0,2,群益金鼎-松山,2023-11-07,9103
2618,長榮航,2,0,2,群益金鼎-松山,2023-11-07,9103
00687B,國泰20年美債,7,5,2,群益金鼎-松山,2023-11-07,9103
00679B,元大美債20年,2,0,2,群益金鼎-松山,2023-11-07,9103
2368,金像電,3,1,2,群益金鼎-松山,2023-11-07,9103
2453,凌群,5,3,2,群益金鼎-松山,2023-11-07,9103
3036,文曄,12,10,2,群益金鼎-松山,2023-11-07,9103
00878,國泰永續高股息,116,1,115,群益金鼎-松山,2023-11-08,9103
6213,聯茂,64,0,64,群益金鼎-松山,2023-11-08,9103
2363,矽統,57,18,39,群益金鼎-松山,2023-11-08,9103
6284,佳邦,42,4,38,群益金鼎-松山,2023-11-08,9103
2376,技嘉,27,4,23,群益金鼎-松山,2023-11-08,9103
3163,波若威,25,3,22,群益金鼎-松山,2023-11-08,9103
2399,映泰,20,1,19,群益金鼎-松山,2023-11-08,9103
3231,緯創,110,92,18,群益金鼎-松山,2023-11-08,9103
00715L,期街口布蘭特正2,17,0,17,群益金鼎-松山,2023-11-08,9103
8034,榮群,16,0,16,群益金鼎-松山,2023-11-08,9103
2610,華航,64,52,12,群益金鼎-松山,2023-11-08,9103
2355,敬鵬,11,0,11,群益金鼎-松山,2023-11-08,9103
6770,力積電,11,0,11,群益金鼎-松山,2023-11-08,9103
00934,中信成長高股息,10,0,10,群益金鼎-松山,2023-11-08,9103
00933B,國泰10Y+金融債,10,0,10,群益金鼎-松山,2023-11-08,9103
2739,寒舍,10,0,10,群益金鼎-松山,2023-11-08,9103
6443,元晶,10,0,10,群益金鼎-松山,2023-11-08,9103
2313,華通,30,21,9,群益金鼎-松山,2023-11-08,9103
1736,喬山,8,0,8,群益金鼎-松山,2023-11-08,9103
1471,首利,8,0,8,群益金鼎-松山,2023-11-08,9103
6901,鑽石投資,8,0,8,群益金鼎-松山,2023-11-08,9103
00632R,元大台灣50反1,10,3,7,群益金鼎-松山,2023-11-08,9103
3041,揚智,6,0,6,群益金鼎-松山,2023-11-08,9103
3444,利機,10,4,6,群益金鼎-松山,2023-11-08,9103
4167,松瑞藥,6,0,6,群益金鼎-松山,2023-11-08,9103
6133,金橋,6,0,6,群益金鼎-松山,2023-11-08,9103
2408,南亞科,5,0,5,群益金鼎-松山,2023-11-08,9103
2609,陽明,5,0,5,群益金鼎-松山,2023-11-08,9103
2614,東森,5,0,5,群益金鼎-松山,2023-11-08,9103
6117,迎廣,6,1,5,群益金鼎-松山,2023-11-08,9103
6122,擎邦,8,3,5,群益金鼎-松山,2023-11-08,9103
6546,正基,5,0,5,群益金鼎-松山,2023-11-08,9103
9950,萬國通,5,0,5,群益金鼎-松山,2023-11-08,9103
4906,正文,4,0,4,群益金鼎-松山,2023-11-08,9103
6274,台燿,7,4,3,群益金鼎-松山,2023-11-08,9103
1789,神隆,3,0,3,群益金鼎-松山,2023-11-08,9103
00929,復華台灣科技優息,3,0,3,群益金鼎-松山,2023-11-08,9103
2484,希華,3,0,3,群益金鼎-松山,2023-11-08,9103
3027,盛達,3,0,3,群益金鼎-松山,2023-11-08,9103
3693,營邦,8,5,3,群益金鼎-松山,2023-11-08,9103
3708,上緯投控,3,0,3,群益金鼎-松山,2023-11-08,9103
4510,高鋒,3,0,3,群益金鼎-松山,2023-11-08,9103
5215,科嘉-KY,3,0,3,群益金鼎-松山,2023-11-08,9103
6643,M31,4,1,3,群益金鼎-松山,2023-11-08,9103
3260,威剛,2,0,2,群益金鼎-松山,2023-11-08,9103
00936,台新永續高息中小,2,0,2,群益金鼎-松山,2023-11-08,9103
1519,華城,5,3,2,群益金鼎-松山,2023-11-08,9103
1529,樂事綠能,2,0,2,群益金鼎-松山,2023-11-08,9103
00679B,元大美債20年,2,0,2,群益金鼎-松山,2023-11-08,9103
2356,英業達,7,5,2,群益金鼎-松山,2023-11-08,9103
6901,鑽石投資,65,0,65,群益金鼎-松山,2023-11-09,9103
2618,長榮航,55,4,51,群益金鼎-松山,2023-11-09,9103
00830,國泰費城半導體,50,0,50,群益金鼎-松山,2023-11-09,9103
6122,擎邦,50,5,45,群益金鼎-松山,2023-11-09,9103
2329,華泰,66,25,41,群益金鼎-松山,2023-11-09,9103
00670L,富邦NASDAQ正2,30,0,30,群益金鼎-松山,2023-11-09,9103
2301,光寶科,31,1,30,群益金鼎-松山,2023-11-09,9103
3176,基亞,28,0,28,群益金鼎-松山,2023-11-09,9103
3122,笙泉,43,20,23,群益金鼎-松山,2023-11-09,9103
3306,鼎天,22,0,22,群益金鼎-松山,2023-11-09,9103
4128,中天,40,20,20,群益金鼎-松山,2023-11-09,9103
3025,星通,31,15,16,群益金鼎-松山,2023-11-09,9103
00687B,國泰20年美債,14,0,14,群益金鼎-松山,2023-11-09,9103
1324,地球,50,36,14,群益金鼎-松山,2023-11-09,9103
4906,正文,16,2,14,群益金鼎-松山,2023-11-09,9103
2462,良得電,13,0,13,群益金鼎-松山,2023-11-09,9103
5225,東科-KY,13,0,13,群益金鼎-松山,2023-11-09,9103
6546,正基,13,0,13,群益金鼎-松山,2023-11-09,9103
1582,信錦,10,0,10,群益金鼎-松山,2023-11-09,9103
3545,敦泰,20,10,10,群益金鼎-松山,2023-11-09,9103
2382,廣達,13,4,9,群益金鼎-松山,2023-11-09,9103
3217,優群,9,1,8,群益金鼎-松山,2023-11-09,9103
1477,聚陽,7,0,7,群益金鼎-松山,2023-11-09,9103
00929,復華台灣科技優息,7,0,7,群益金鼎-松山,2023-11-09,9103
3483,力致,28,21,7,群益金鼎-松山,2023-11-09,9103
5348,正能量智能,7,0,7,群益金鼎-松山,2023-11-09,9103
00715L,期街口布蘭特正2,6,0,6,群益金鼎-松山,2023-11-09,9103
5347,世界,7,1,6,群益金鼎-松山,2023-11-09,9103
1201,味全,5,0,5,群益金鼎-松山,2023-11-09,9103
2485,兆赫,5,0,5,群益金鼎-松山,2023-11-09,9103
2880,華南金,5,0,5,群益金鼎-松山,2023-11-09,9103
3211,順達,5,0,5,群益金鼎-松山,2023-11-09,9103
3693,營邦,5,0,5,群益金鼎-松山,2023-11-09,9103
1519,華城,7,3,4,群益金鼎-松山,2023-11-09,9103
00632R,元大台灣50反1,4,0,4,群益金鼎-松山,2023-11-09,9103
2331,精英,4,0,4,群益金鼎-松山,2023-11-09,9103
2486,一詮,11,7,4,群益金鼎-松山,2023-11-09,9103
3044,健鼎,4,0,4,群益金鼎-松山,2023-11-09,9103
8046,南電,4,0,4,群益金鼎-松山,2023-11-09,9103
9921,巨大,4,0,4,群益金鼎-松山,2023-11-09,9103
2542,興富發,3,0,3,群益金鼎-松山,2023-11-09,9103
3011,今皓,5,2,3,群益金鼎-松山,2023-11-09,9103
3014,聯陽,7,4,3,群益金鼎-松山,2023-11-09,9103
3037,欣興,5,2,3,群益金鼎-松山,2023-11-09,9103
5215,科嘉-KY,3,0,3,群益金鼎-松山,2023-11-09,9103
5258,虹堡,3,0,3,群益金鼎-松山,2023-11-09,9103
6789,采鈺,3,0,3,群益金鼎-松山,2023-11-09,9103
2308,台達電,2,0,2,群益金鼎-松山,2023-11-09,9103
2353,宏��,2,0,2,群益金鼎-松山,2023-11-09,9103
3704,合勤控,2,0,2,群益金鼎-松山,2023-11-09,9103
1217,愛之味,393,300,93,群益金鼎-松山,2023-11-10,9103
00632R,元大台灣50反1,80,0,80,群益金鼎-松山,2023-11-10,9103
3622,洋華,74,0,74,群益金鼎-松山,2023-11-10,9103
2324,仁寶,50,0,50,群益金鼎-松山,2023-11-10,9103
4128,中天,34,2,32,群益金鼎-松山,2023-11-10,9103
00679B,元大美債20年,29,0,29,群益金鼎-松山,2023-11-10,9103
2332,友訊,20,0,20,群益金鼎-松山,2023-11-10,9103
2538,基泰,20,0,20,群益金鼎-松山,2023-11-10,9103
00687B,國泰20年美債,21,5,16,群益金鼎-松山,2023-11-10,9103
6274,台燿,16,1,15,群益金鼎-松山,2023-11-10,9103
4743,合一,21,7,14,群益金鼎-松山,2023-11-10,9103
1304,台聚,13,0,13,群益金鼎-松山,2023-11-10,9103
2313,華通,180,167,13,群益金鼎-松山,2023-11-10,9103
1711,永光,11,0,11,群益金鼎-松山,2023-11-10,9103
2618,長榮航,19,8,11,群益金鼎-松山,2023-11-10,9103
3228,金麗科,10,0,10,群益金鼎-松山,2023-11-10,9103
2462,良得電,10,0,10,群益金鼎-松山,2023-11-10,9103
00680L,元大美債20正2,10,0,10,群益金鼎-松山,2023-11-10,9103
00933B,國泰10Y+金融債,10,0,10,群益金鼎-松山,2023-11-10,9103
00931B,統一美債20年,10,0,10,群益金鼎-松山,2023-11-10,9103
2201,裕隆,30,20,10,群益金鼎-松山,2023-11-10,9103
3260,威剛,12,2,10,群益金鼎-松山,2023-11-10,9103
5210,寶碩,10,0,10,群益金鼎-松山,2023-11-10,9103
5521,工信,10,0,10,群益金鼎-松山,2023-11-10,9103
8150,南茂,10,0,10,群益金鼎-松山,2023-11-10,9103
2383,台光電,10,1,9,群益金鼎-松山,2023-11-10,9103
6576,逸達,8,0,8,群益金鼎-松山,2023-11-10,9103
00929,復華台灣科技優息,6,0,6,群益金鼎-松山,2023-11-10,9103
2382,廣達,18,12,6,群益金鼎-松山,2023-11-10,9103
3715,定穎投控,7,1,6,群益金鼎-松山,2023-11-10,9103
2363,矽統,15,10,5,群益金鼎-松山,2023-11-10,9103
2399,映泰,26,21,5,群益金鼎-松山,2023-11-10,9103
3011,今皓,6,1,5,群益金鼎-松山,2023-11-10,9103
6442,光聖,5,0,5,群益金鼎-松山,2023-11-10,9103
2376,技嘉,4,0,4,群益金鼎-松山,2023-11-10,9103
5871,中租-KY,4,0,4,群益金鼎-松山,2023-11-10,9103
00936,台新永續高息中小,4,0,4,群益金鼎-松山,2023-11-10,9103
2301,光寶科,4,0,4,群益金鼎-松山,2023-11-10,9103
3013,晟銘電,4,0,4,群益金鼎-松山,2023-11-10,9103
3042,晶技,4,0,4,群益金鼎-松山,2023-11-10,9103
00878,國泰永續高股息,3,0,3,群益金鼎-松山,2023-11-10,9103
2317,鴻海,5,2,3,群益金鼎-松山,2023-11-10,9103
3324,雙鴻,5,2,3,群益金鼎-松山,2023-11-10,9103
5386,青雲,3,0,3,群益金鼎-松山,2023-11-10,9103
6550,北極星藥業-KY,3,0,3,群益金鼎-松山,2023-11-10,9103
0056,元大高股息,3,1,2,群益金鼎-松山,2023-11-10,9103
1529,樂事綠能,2,0,2,群益金鼎-松山,2023-11-10,9103
1584,精剛,2,0,2,群益金鼎-松山,2023-11-10,9103
00720B,元大投資級公司債,2,0,2,群益金鼎-松山,2023-11-10,9103
1503,士電,2,0,2,群益金鼎-松山,2023-11-10,9103
00935,野村臺灣新科技50,50,0,50,群益金鼎-松山,2023-11-13,9103
00934,中信成長高股息,50,10,40,群益金鼎-松山,2023-11-13,9103
00679B,元大美債20年,34,0,34,群益金鼎-松山,2023-11-13,9103
3622,洋華,34,0,34,群益金鼎-松山,2023-11-13,9103
3231,緯創,56,24,32,群益金鼎-松山,2023-11-13,9103
6901,鑽石投資,32,0,32,群益金鼎-松山,2023-11-13,9103
8936,國統,38,7,31,群益金鼎-松山,2023-11-13,9103
5258,虹堡,33,6,27,群益金鼎-松山,2023-11-13,9103
2382,廣達,37,10,27,群益金鼎-松山,2023-11-13,9103
3715,定穎投控,31,5,26,群益金鼎-松山,2023-11-13,9103
2882,國泰金,20,0,20,群益金鼎-松山,2023-11-13,9103
5351,鈺創,20,0,20,群益金鼎-松山,2023-11-13,9103
2388,威盛,20,3,17,群益金鼎-松山,2023-11-13,9103
3306,鼎天,18,2,16,群益金鼎-松山,2023-11-13,9103
8054,安國,24,9,15,群益金鼎-松山,2023-11-13,9103
1795,美時,15,1,14,群益金鼎-松山,2023-11-13,9103
2363,矽統,26,12,14,群益金鼎-松山,2023-11-13,9103
6139,亞翔,15,1,14,群益金鼎-松山,2023-11-13,9103
6290,良維,24,11,13,群益金鼎-松山,2023-11-13,9103
00632R,元大台灣50反1,21,10,11,群益金鼎-松山,2023-11-13,9103
6213,聯茂,11,0,11,群益金鼎-松山,2023-11-13,9103
3036,文曄,11,0,11,群益金鼎-松山,2023-11-13,9103
2376,技嘉,24,13,11,群益金鼎-松山,2023-11-13,9103
2331,精英,17,7,10,群益金鼎-松山,2023-11-13,9103
2739,寒舍,10,0,10,群益金鼎-松山,2023-11-13,9103
3037,欣興,10,0,10,群益金鼎-松山,2023-11-13,9103
8940,新天地,10,0,10,群益金鼎-松山,2023-11-13,9103
00878,國泰永續高股息,10,1,9,群益金鼎-松山,2023-11-13,9103
4967,十銓,11,2,9,群益金鼎-松山,2023-11-13,9103
3260,威剛,8,1,7,群益金鼎-松山,2023-11-13,9103
2439,美律,10,3,7,群益金鼎-松山,2023-11-13,9103
2449,京元電子,10,3,7,群益金鼎-松山,2023-11-13,9103
6143,振曜,13,7,6,群益金鼎-松山,2023-11-13,9103
8349,�矬�,6,0,6,群益金鼎-松山,2023-11-13,9103
4763,材料-KY,6,0,6,群益金鼎-松山,2023-11-13,9103
2637,慧洋-KY,5,0,5,群益金鼎-松山,2023-11-13,9103
2031,新光鋼,5,0,5,群益金鼎-松山,2023-11-13,9103
1442,名軒,5,0,5,群益金鼎-松山,2023-11-13,9103
2344,華邦電,5,0,5,群益金鼎-松山,2023-11-13,9103
4931,新盛力,5,0,5,群益金鼎-松山,2023-11-13,9103
6443,元晶,5,0,5,群益金鼎-松山,2023-11-13,9103
2408,南亞科,4,0,4,群益金鼎-松山,2023-11-13,9103
2369,菱生,4,0,4,群益金鼎-松山,2023-11-13,9103
2538,基泰,4,0,4,群益金鼎-松山,2023-11-13,9103
2745,五福,4,0,4,群益金鼎-松山,2023-11-13,9103
6462,神盾,4,0,4,群益金鼎-松山,2023-11-13,9103
3693,營邦,3,0,3,群益金鼎-松山,2023-11-13,9103
6284,佳邦,3,0,3,群益金鼎-松山,2023-11-13,9103
1519,華城,17,14,3,群益金鼎-松山,2023-11-13,9103
3032,偉訓,3,0,3,群益金鼎-松山,2023-11-13,9103
00687B,國泰20年美債,100,0,100,群益金鼎-松山,2023-11-14,9103
2425,承啟,64,0,64,群益金鼎-松山,2023-11-14,9103
2329,華泰,56,0,56,群益金鼎-松山,2023-11-14,9103
6213,聯茂,39,0,39,群益金鼎-松山,2023-11-14,9103
2313,華通,45,8,37,群益金鼎-松山,2023-11-14,9103
2603,長榮,33,0,33,群益金鼎-松山,2023-11-14,9103
00632R,元大台灣50反1,31,0,31,群益金鼎-松山,2023-11-14,9103
1784,訊聯,30,0,30,群益金鼎-松山,2023-11-14,9103
2915,潤泰全,40,12,28,群益金鼎-松山,2023-11-14,9103
3228,金麗科,26,0,26,群益金鼎-松山,2023-11-14,9103
9928,中視,25,0,25,群益金鼎-松山,2023-11-14,9103
9945,潤泰新,25,0,25,群益金鼎-松山,2023-11-14,9103
00878,國泰永續高股息,34,10,24,群益金鼎-松山,2023-11-14,9103
8088,品安,32,11,21,群益金鼎-松山,2023-11-14,9103
6187,萬潤,24,4,20,群益金鼎-松山,2023-11-14,9103
2330,台積電,20,1,19,群益金鼎-松山,2023-11-14,9103
3715,定穎投控,23,5,18,群益金鼎-松山,2023-11-14,9103
8936,國統,13,0,13,群益金鼎-松山,2023-11-14,9103
2357,華碩,28,17,11,群益金鼎-松山,2023-11-14,9103
2367,燿華,10,0,10,群益金鼎-松山,2023-11-14,9103
2816,旺旺保,10,0,10,群益金鼎-松山,2023-11-14,9103
2882,國泰金,10,0,10,群益金鼎-松山,2023-11-14,9103
6451,訊芯-KY,12,2,10,群益金鼎-松山,2023-11-14,9103
8940,新天地,20,10,10,群益金鼎-松山,2023-11-14,9103
9955,佳龍,10,0,10,群益金鼎-松山,2023-11-14,9103
6164,華興,9,0,9,群益金鼎-松山,2023-11-14,9103
2388,威盛,48,40,8,群益金鼎-松山,2023-11-14,9103
3702,大聯大,8,0,8,群益金鼎-松山,2023-11-14,9103
8054,安國,10,2,8,群益金鼎-松山,2023-11-14,9103
2610,華航,10,3,7,群益金鼎-松山,2023-11-14,9103
4967,十銓,9,2,7,群益金鼎-松山,2023-11-14,9103
2317,鴻海,20,13,7,群益金鼎-松山,2023-11-14,9103
2328,廣宇,6,0,6,群益金鼎-松山,2023-11-14,9103
2748,雲品,6,0,6,群益金鼎-松山,2023-11-14,9103
3483,力致,9,3,6,群益金鼎-松山,2023-11-14,9103
5348,正能量智能,6,0,6,群益金鼎-松山,2023-11-14,9103
1815,富喬,5,0,5,群益金鼎-松山,2023-11-14,9103
2324,仁寶,5,0,5,群益金鼎-松山,2023-11-14,9103
2364,倫飛,14,9,5,群益金鼎-松山,2023-11-14,9103
2880,華南金,5,0,5,群益金鼎-松山,2023-11-14,9103
6625,必應,10,5,5,群益金鼎-松山,2023-11-14,9103
6799,來頡,5,0,5,群益金鼎-松山,2023-11-14,9103
8349,�矬�,5,0,5,群益金鼎-松山,2023-11-14,9103
6806,森崴能源,4,0,4,群益金鼎-松山,2023-11-14,9103
2201,裕隆,4,1,3,群益金鼎-松山,2023-11-14,9103
1504,東元,3,0,3,群益金鼎-松山,2023-11-14,9103
1477,聚陽,3,0,3,群益金鼎-松山,2023-11-14,9103
2355,敬鵬,4,1,3,群益金鼎-松山,2023-11-14,9103
2454,聯發科,3,0,3,群益金鼎-松山,2023-11-14,9103
3017,奇鋐,9,6,3,群益金鼎-松山,2023-11-14,9103
4401,東隆興,101,0,101,群益金鼎-松山,2023-11-15,9103
2881,富邦金,100,2,98,群益金鼎-松山,2023-11-15,9103
8110,華東,100,40,60,群益金鼎-松山,2023-11-15,9103
2323,中環,60,4,56,群益金鼎-松山,2023-11-15,9103
2363,矽統,89,47,42,群益金鼎-松山,2023-11-15,9103
00680L,元大美債20正2,50,10,40,群益金鼎-松山,2023-11-15,9103
3711,日月光投控,41,5,36,群益金鼎-松山,2023-11-15,9103
2465,麗臺,34,0,34,群益金鼎-松山,2023-11-15,9103
6667,信紘科,31,0,31,群益金鼎-松山,2023-11-15,9103
4532,瑞智,29,1,28,群益金鼎-松山,2023-11-15,9103
6143,振曜,38,10,28,群益金鼎-松山,2023-11-15,9103
2332,友訊,30,7,23,群益金鼎-松山,2023-11-15,9103
2329,華泰,37,16,21,群益金鼎-松山,2023-11-15,9103
2383,台光電,21,0,21,群益金鼎-松山,2023-11-15,9103
00637L,元大滬深300正2,20,0,20,群益金鼎-松山,2023-11-15,9103
3363,上詮,21,3,18,群益金鼎-松山,2023-11-15,9103
3013,晟銘電,23,9,14,群益金鼎-松山,2023-11-15,9103
8936,國統,14,0,14,群益金鼎-松山,2023-11-15,9103
00679B,元大美債20年,12,0,12,群益金鼎-松山,2023-11-15,9103
4766,南寶,12,0,12,群益金鼎-松山,2023-11-15,9103
6691,洋基工程,12,1,11,群益金鼎-松山,2023-11-15,9103
1314,中石化,10,0,10,群益金鼎-松山,2023-11-15,9103
2312,金寶,10,0,10,群益金鼎-松山,2023-11-15,9103
3260,威剛,10,0,10,群益金鼎-松山,2023-11-15,9103
8086,宏捷科,10,0,10,群益金鼎-松山,2023-11-15,9103
2816,旺旺保,42,33,9,群益金鼎-松山,2023-11-15,9103
3044,健鼎,10,1,9,群益金鼎-松山,2023-11-15,9103
3017,奇鋐,10,2,8,群益金鼎-松山,2023-11-15,9103
3131,弘塑,8,0,8,群益金鼎-松山,2023-11-15,9103
3702,大聯大,7,0,7,群益金鼎-松山,2023-11-15,9103
1560,中砂,8,2,6,群益金鼎-松山,2023-11-15,9103
1815,富喬,6,0,6,群益金鼎-松山,2023-11-15,9103
6235,華孚,17,11,6,群益金鼎-松山,2023-11-15,9103
6526,達發,6,0,6,群益金鼎-松山,2023-11-15,9103
3062,建漢,5,0,5,群益金鼎-松山,2023-11-15,9103
3227,原相,5,0,5,群益金鼎-松山,2023-11-15,9103
6139,亞翔,5,0,5,群益金鼎-松山,2023-11-15,9103
6244,茂迪,5,0,5,群益金鼎-松山,2023-11-15,9103
2356,英業達,4,0,4,群益金鼎-松山,2023-11-15,9103
3014,聯陽,5,1,4,群益金鼎-松山,2023-11-15,9103
3324,雙鴻,7,3,4,群益金鼎-松山,2023-11-15,9103
5215,科嘉-KY,4,0,4,群益金鼎-松山,2023-11-15,9103
5351,鈺創,5,1,4,群益金鼎-松山,2023-11-15,9103
6168,宏齊,5,1,4,群益金鼎-松山,2023-11-15,9103
2449,京元電子,3,0,3,群益金鼎-松山,2023-11-15,9103
8299,群聯,3,0,3,群益金鼎-松山,2023-11-15,9103
1513,中興電,4,1,3,群益金鼎-松山,2023-11-15,9103
1524,耿鼎,6,3,3,群益金鼎-松山,2023-11-15,9103
2402,毅嘉,7,4,3,群益金鼎-松山,2023-11-15,9103
2609,陽明,3,0,3,群益金鼎-松山,2023-11-15,9103
2409,友達,100,0,100,群益金鼎-松山,2023-11-16,9103
00679B,元大美債20年,63,0,63,群益金鼎-松山,2023-11-16,9103
2412,中華電,50,0,50,群益金鼎-松山,2023-11-16,9103
3149,正達,50,0,50,群益金鼎-松山,2023-11-16,9103
4908,前鼎,43,3,40,群益金鼎-松山,2023-11-16,9103
2618,長榮航,107,70,37,群益金鼎-松山,2023-11-16,9103
2457,飛宏,31,1,30,群益金鼎-松山,2023-11-16,9103
3374,精材,22,0,22,群益金鼎-松山,2023-11-16,9103
2355,敬鵬,64,44,20,群益金鼎-松山,2023-11-16,9103
8467,波力-KY,20,0,20,群益金鼎-松山,2023-11-16,9103
2731,雄獅,21,2,19,群益金鼎-松山,2023-11-16,9103
2313,華通,20,4,16,群益金鼎-松山,2023-11-16,9103
3715,定穎投控,24,10,14,群益金鼎-松山,2023-11-16,9103
2748,雲品,23,10,13,群益金鼎-松山,2023-11-16,9103
1903,士紙,10,0,10,群益金鼎-松山,2023-11-16,9103
1432,大魯閣,10,0,10,群益金鼎-松山,2023-11-16,9103
00632R,元大台灣50反1,10,0,10,群益金鼎-松山,2023-11-16,9103
2882,國泰金,10,0,10,群益金鼎-松山,2023-11-16,9103
3325,旭品,18,8,10,群益金鼎-松山,2023-11-16,9103
6164,華興,10,0,10,群益金鼎-松山,2023-11-16,9103
3623,富晶通,9,0,9,群益金鼎-松山,2023-11-16,9103
6187,萬潤,11,2,9,群益金鼎-松山,2023-11-16,9103
5703,亞都,8,0,8,群益金鼎-松山,2023-11-16,9103
6235,華孚,13,5,8,群益金鼎-松山,2023-11-16,9103
00878,國泰永續高股息,9,2,7,群益金鼎-松山,2023-11-16,9103
2377,微星,6,0,6,群益金鼎-松山,2023-11-16,9103
2743,山富,6,0,6,群益金鼎-松山,2023-11-16,9103
3322,建舜電,7,1,6,群益金鼎-松山,2023-11-16,9103
4770,上品,6,0,6,群益金鼎-松山,2023-11-16,9103
00715L,期街口布蘭特正2,5,0,5,群益金鼎-松山,2023-11-16,9103
00680L,元大美債20正2,5,0,5,群益金鼎-松山,2023-11-16,9103
2352,佳世達,5,0,5,群益金鼎-松山,2023-11-16,9103
6150,撼訊,13,8,5,群益金鼎-松山,2023-11-16,9103
6515,穎崴,5,0,5,群益金鼎-松山,2023-11-16,9103
3252,海灣,4,0,4,群益金鼎-松山,2023-11-16,9103
4967,十銓,6,2,4,群益金鼎-松山,2023-11-16,9103
6015,宏遠證,4,0,4,群益金鼎-松山,2023-11-16,9103
6432,今展科,4,0,4,群益金鼎-松山,2023-11-16,9103
0056,元大高股息,3,0,3,群益金鼎-松山,2023-11-16,9103
00751B,元大AAA至A公司債,3,0,3,群益金鼎-松山,2023-11-16,9103
1515,力山,15,12,3,群益金鼎-松山,2023-11-16,9103
1442,名軒,3,0,3,群益金鼎-松山,2023-11-16,9103
1304,台聚,3,0,3,群益金鼎-松山,2023-11-16,9103
2548,華固,3,0,3,群益金鼎-松山,2023-11-16,9103
2609,陽明,3,0,3,群益金鼎-松山,2023-11-16,9103
3324,雙鴻,11,8,3,群益金鼎-松山,2023-11-16,9103
5258,虹堡,7,4,3,群益金鼎-松山,2023-11-16,9103
8155,博智,3,0,3,群益金鼎-松山,2023-11-16,9103
8940,新天地,3,0,3,群益金鼎-松山,2023-11-16,9103
8349,�矬�,3,0,3,群益金鼎-松山,2023-11-16,9103
2706,第一店,125,50,75,群益金鼎-松山,2023-11-17,9103
3041,揚智,119,49,70,群益金鼎-松山,2023-11-17,9103
00715L,期街口布蘭特正2,59,0,59,群益金鼎-松山,2023-11-17,9103
5469,瀚宇博,54,0,54,群益金鼎-松山,2023-11-17,9103
5701,劍湖山,53,0,53,群益金鼎-松山,2023-11-17,9103
00830,國泰費城半導體,50,0,50,群益金鼎-松山,2023-11-17,9103
2610,華航,51,1,50,群益金鼎-松山,2023-11-17,9103
2605,新興,32,0,32,群益金鼎-松山,2023-11-17,9103
00670L,富邦NASDAQ正2,30,0,30,群益金鼎-松山,2023-11-17,9103
00640L,富邦日本正2,24,0,24,群益金鼎-松山,2023-11-17,9103
2606,裕民,23,0,23,群益金鼎-松山,2023-11-17,9103
2401,凌陽,22,2,20,群益金鼎-松山,2023-11-17,9103
4768,晶呈科技,17,0,17,群益金鼎-松山,2023-11-17,9103
2405,輔信,16,0,16,群益金鼎-松山,2023-11-17,9103
3587,閎康,16,0,16,群益金鼎-松山,2023-11-17,9103
5706,鳳凰,17,1,16,群益金鼎-松山,2023-11-17,9103
2436,偉詮電,15,0,15,群益金鼎-松山,2023-11-17,9103
8940,新天地,12,0,12,群益金鼎-松山,2023-11-17,9103
8996,高力,16,4,12,群益金鼎-松山,2023-11-17,9103
9950,萬國通,15,4,11,群益金鼎-松山,2023-11-17,9103
00931B,統一美債20年,10,0,10,群益金鼎-松山,2023-11-17,9103
2704,國賓,10,0,10,群益金鼎-松山,2023-11-17,9103
2913,農林,10,0,10,群益金鼎-松山,2023-11-17,9103
3483,力致,10,0,10,群益金鼎-松山,2023-11-17,9103
6589,台康生技,12,2,10,群益金鼎-松山,2023-11-17,9103
00637L,元大滬深300正2,9,0,9,群益金鼎-松山,2023-11-17,9103
6164,華興,8,0,8,群益金鼎-松山,2023-11-17,9103
6799,來頡,8,0,8,群益金鼎-松山,2023-11-17,9103
1515,力山,10,3,7,群益金鼎-松山,2023-11-17,9103
00878,國泰永續高股息,7,0,7,群益金鼎-松山,2023-11-17,9103
2388,威盛,54,47,7,群益金鼎-松山,2023-11-17,9103
3444,利機,10,4,6,群益金鼎-松山,2023-11-17,9103
3228,金麗科,6,0,6,群益金鼎-松山,2023-11-17,9103
3037,欣興,5,0,5,群益金鼎-松山,2023-11-17,9103
00671R,富邦NASDAQ反1,5,0,5,群益金鼎-松山,2023-11-17,9103
00751B,元大AAA至A公司債,5,0,5,群益金鼎-松山,2023-11-17,9103
2328,廣宇,5,0,5,群益金鼎-松山,2023-11-17,9103
2354,鴻準,5,0,5,群益金鼎-松山,2023-11-17,9103
6269,台郡,5,0,5,群益金鼎-松山,2023-11-17,9103
6415,矽力*-KY,10,5,5,群益金鼎-松山,2023-11-17,9103
6756,威鋒電子,5,0,5,群益金鼎-松山,2023-11-17,9103
2379,瑞昱,4,0,4,群益金鼎-松山,2023-11-17,9103
2630,亞航,4,0,4,群益金鼎-松山,2023-11-17,9103
2634,漢翔,4,0,4,群益金鼎-松山,2023-11-17,9103
2707,晶華,6,2,4,群益金鼎-松山,2023-11-17,9103
4535,至興,4,0,4,群益金鼎-松山,2023-11-17,9103
4967,十銓,4,0,4,群益金鼎-松山,2023-11-17,9103
5607,遠雄港,4,0,4,群益金鼎-松山,2023-11-17,9103
6274,台燿,5,2,3,群益金鼎-松山,2023-11-17,9103
1717,長興,3,0,3,群益金鼎-松山,2023-11-17,9103
2402,毅嘉,110,0,110,群益金鼎-松山,2023-11-20,9103
6108,競國,102,1,101,群益金鼎-松山,2023-11-20,9103
2371,大同,91,1,90,群益金鼎-松山,2023-11-20,9103
6233,旺玖,81,0,81,群益金鼎-松山,2023-11-20,9103
3380,明泰,80,0,80,群益金鼎-松山,2023-11-20,9103
2313,華通,105,47,58,群益金鼎-松山,2023-11-20,9103
6125,廣運,63,10,53,群益金鼎-松山,2023-11-20,9103
6274,台燿,52,2,50,群益金鼎-松山,2023-11-20,9103
8261,富鼎,34,0,34,群益金鼎-松山,2023-11-20,9103
00679B,元大美債20年,31,0,31,群益金鼎-松山,2023-11-20,9103
2618,長榮航,39,10,29,群益金鼎-松山,2023-11-20,9103
2888,新光金,29,0,29,群益金鼎-松山,2023-11-20,9103
8227,巨有科技,27,0,27,群益金鼎-松山,2023-11-20,9103
2739,寒舍,21,0,21,群益金鼎-松山,2023-11-20,9103
3013,晟銘電,26,5,21,群益金鼎-松山,2023-11-20,9103
2516,新建,20,0,20,群益金鼎-松山,2023-11-20,9103
4908,前鼎,23,3,20,群益金鼎-松山,2023-11-20,9103
2303,聯電,18,0,18,群益金鼎-松山,2023-11-20,9103
5236,凌陽創新,20,5,15,群益金鼎-松山,2023-11-20,9103
6213,聯茂,25,10,15,群益金鼎-松山,2023-11-20,9103
3035,智原,51,38,13,群益金鼎-松山,2023-11-20,9103
6164,華興,12,0,12,群益金鼎-松山,2023-11-20,9103
8936,國統,20,8,12,群益金鼎-松山,2023-11-20,9103
2330,台積電,31,20,11,群益金鼎-松山,2023-11-20,9103
1903,士紙,11,0,11,群益金鼎-松山,2023-11-20,9103
2408,南亞科,43,32,11,群益金鼎-松山,2023-11-20,9103
00632R,元大台灣50反1,10,0,10,群益金鼎-松山,2023-11-20,9103
1314,中石化,10,0,10,群益金鼎-松山,2023-11-20,9103
2498,宏達電,10,0,10,群益金鼎-松山,2023-11-20,9103
2705,六福,10,0,10,群益金鼎-松山,2023-11-20,9103
2719,燦星旅,10,0,10,群益金鼎-松山,2023-11-20,9103
5210,寶碩,10,0,10,群益金鼎-松山,2023-11-20,9103
2329,華泰,21,12,9,群益金鼎-松山,2023-11-20,9103
6451,訊芯-KY,10,1,9,群益金鼎-松山,2023-11-20,9103
2743,山富,8,0,8,群益金鼎-松山,2023-11-20,9103
2748,雲品,21,13,8,群益金鼎-松山,2023-11-20,9103
2201,裕隆,28,20,8,群益金鼎-松山,2023-11-20,9103
1605,華新,14,7,7,群益金鼎-松山,2023-11-20,9103
2382,廣達,6,0,6,群益金鼎-松山,2023-11-20,9103
4129,聯合,6,0,6,群益金鼎-松山,2023-11-20,9103
2236,百達-KY,5,0,5,群益金鼎-松山,2023-11-20,9103
00687B,國泰20年美債,5,0,5,群益金鼎-松山,2023-11-20,9103
00637L,元大滬深300正2,5,0,5,群益金鼎-松山,2023-11-20,9103
2352,佳世達,5,0,5,群益金鼎-松山,2023-11-20,9103
2915,潤泰全,5,0,5,群益金鼎-松山,2023-11-20,9103
6669,緯穎,7,2,5,群益金鼎-松山,2023-11-20,9103
9945,潤泰新,5,0,5,群益金鼎-松山,2023-11-20,9103
3715,定穎投控,22,18,4,群益金鼎-松山,2023-11-20,9103
6863,永道-KY,4,0,4,群益金鼎-松山,2023-11-20,9103
00878,國泰永續高股息,3,0,3,群益金鼎-松山,2023-11-20,9103
00680L,元大美債20正2,226,40,186,群益金鼎-松山,2023-11-21,9103
2402,毅嘉,175,36,139,群益金鼎-松山,2023-11-21,9103
2888,新光金,100,0,100,群益金鼎-松山,2023-11-21,9103
00640L,富邦日本正2,50,0,50,群益金鼎-松山,2023-11-21,9103
2383,台光電,31,1,30,群益金鼎-松山,2023-11-21,9103
00712,復華富時不動產,30,0,30,群益金鼎-松山,2023-11-21,9103
3706,神達,30,5,25,群益金鼎-松山,2023-11-21,9103
6161,捷波,29,5,24,群益金鼎-松山,2023-11-21,9103
00632R,元大台灣50反1,22,0,22,群益金鼎-松山,2023-11-21,9103
2316,楠梓電,42,21,21,群益金鼎-松山,2023-11-21,9103
3041,揚智,64,43,21,群益金鼎-松山,2023-11-21,9103
1815,富喬,25,5,20,群益金鼎-松山,2023-11-21,9103
00688L,國泰20年美債正2,20,0,20,群益金鼎-松山,2023-11-21,9103
3032,偉訓,20,0,20,群益金鼎-松山,2023-11-21,9103
4976,佳凌,20,0,20,群益金鼎-松山,2023-11-21,9103
2748,雲品,32,13,19,群益金鼎-松山,2023-11-21,9103
3025,星通,25,6,19,群益金鼎-松山,2023-11-21,9103
2882,國泰金,20,2,18,群益金鼎-松山,2023-11-21,9103
6237,驊訊,43,25,18,群益金鼎-松山,2023-11-21,9103
3037,欣興,23,6,17,群益金鼎-松山,2023-11-21,9103
5236,凌陽創新,27,11,16,群益金鼎-松山,2023-11-21,9103
3059,華晶科,55,40,15,群益金鼎-松山,2023-11-21,9103
00673R,期元大S＆P原油反1,15,0,15,群益金鼎-松山,2023-11-21,9103
3047,訊舟,30,15,15,群益金鼎-松山,2023-11-21,9103
3152,璟德,14,0,14,群益金鼎-松山,2023-11-21,9103
3376,新日興,15,1,14,群益金鼎-松山,2023-11-21,9103
5258,虹堡,23,10,13,群益金鼎-松山,2023-11-21,9103
8086,宏捷科,12,0,12,群益金鼎-松山,2023-11-21,9103
2618,長榮航,12,1,11,群益金鼎-松山,2023-11-21,9103
3260,威剛,12,1,11,群益金鼎-松山,2023-11-21,9103
00679B,元大美債20年,10,0,10,群益金鼎-松山,2023-11-21,9103
00650L,復華香港正2,10,0,10,群益金鼎-松山,2023-11-21,9103
2337,旺宏,10,0,10,群益金鼎-松山,2023-11-21,9103
3044,健鼎,10,0,10,群益金鼎-松山,2023-11-21,9103
4933,友輝,10,0,10,群益金鼎-松山,2023-11-21,9103
4979,華星光,20,10,10,群益金鼎-松山,2023-11-21,9103
6158,禾昌,30,20,10,群益金鼎-松山,2023-11-21,9103
2352,佳世達,18,10,8,群益金鼎-松山,2023-11-21,9103
2883,凱基金,309,301,8,群益金鼎-松山,2023-11-21,9103
4960,誠美材,10,2,8,群益金鼎-松山,2023-11-21,9103
5292,華懋,8,0,8,群益金鼎-松山,2023-11-21,9103
6548,長科*,8,0,8,群益金鼎-松山,2023-11-21,9103
00719B,元大美債1-3,6,0,6,群益金鼎-松山,2023-11-21,9103
2421,建準,6,0,6,群益金鼎-松山,2023-11-21,9103
6282,康舒,10,4,6,群益金鼎-松山,2023-11-21,9103
1903,士紙,5,0,5,群益金鼎-松山,2023-11-21,9103
1519,華城,8,3,5,群益金鼎-松山,2023-11-21,9103
2236,百達-KY,5,0,5,群益金鼎-松山,2023-11-21,9103
2344,華邦電,5,0,5,群益金鼎-松山,2023-11-21,9103
2356,英業達,18,13,5,群益金鼎-松山,2023-11-21,9103
5302,太欣,75,0,75,群益金鼎-松山,2023-11-22,9103
5351,鈺創,130,80,50,群益金鼎-松山,2023-11-22,9103
2498,宏達電,40,0,40,群益金鼎-松山,2023-11-22,9103
6129,普誠,90,50,40,群益金鼎-松山,2023-11-22,9103
2436,偉詮電,42,2,40,群益金鼎-松山,2023-11-22,9103
2405,輔信,56,18,38,群益金鼎-松山,2023-11-22,9103
6243,迅杰,31,1,30,群益金鼎-松山,2023-11-22,9103
2834,臺企銀,31,1,30,群益金鼎-松山,2023-11-22,9103
2201,裕隆,28,0,28,群益金鼎-松山,2023-11-22,9103
00632R,元大台灣50反1,31,3,28,群益金鼎-松山,2023-11-22,9103
00637L,元大滬深300正2,31,5,26,群益金鼎-松山,2023-11-22,9103
3013,晟銘電,25,0,25,群益金鼎-松山,2023-11-22,9103
4953,緯軟,24,0,24,群益金鼎-松山,2023-11-22,9103
3325,旭品,46,24,22,群益金鼎-松山,2023-11-22,9103
2492,華新科,20,0,20,群益金鼎-松山,2023-11-22,9103
3057,喬鼎,20,0,20,群益金鼎-松山,2023-11-22,9103
6558,興能高,20,0,20,群益金鼎-松山,2023-11-22,9103
2355,敬鵬,21,2,19,群益金鼎-松山,2023-11-22,9103
2363,矽統,46,27,19,群益金鼎-松山,2023-11-22,9103
2401,凌陽,130,111,19,群益金鼎-松山,2023-11-22,9103
3362,先進光,21,3,18,群益金鼎-松山,2023-11-22,9103
6451,訊芯-KY,18,1,17,群益金鼎-松山,2023-11-22,9103
3587,閎康,17,2,15,群益金鼎-松山,2023-11-22,9103
6576,逸達,15,0,15,群益金鼎-松山,2023-11-22,9103
2610,華航,15,3,12,群益金鼎-松山,2023-11-22,9103
8227,巨有科技,12,0,12,群益金鼎-松山,2023-11-22,9103
00720B,元大投資級公司債,11,0,11,群益金鼎-松山,2023-11-22,9103
8261,富鼎,22,11,11,群益金鼎-松山,2023-11-22,9103
1305,華夏,10,0,10,群益金鼎-松山,2023-11-22,9103
00932,兆豐永續高息等權,10,0,10,群益金鼎-松山,2023-11-22,9103
00712,復華富時不動產,10,0,10,群益金鼎-松山,2023-11-22,9103
1903,士紙,10,0,10,群益金鼎-松山,2023-11-22,9103
6411,晶焱,10,0,10,群益金鼎-松山,2023-11-22,9103
3363,上詮,41,32,9,群益金鼎-松山,2023-11-22,9103
3504,揚明光,9,0,9,群益金鼎-松山,2023-11-22,9103
8011,台通,10,1,9,群益金鼎-松山,2023-11-22,9103
2002,中鋼,10,3,7,群益金鼎-松山,2023-11-22,9103
00679B,元大美債20年,7,0,7,群益金鼎-松山,2023-11-22,9103
2883,凱基金,307,300,7,群益金鼎-松山,2023-11-22,9103
3163,波若威,17,10,7,群益金鼎-松山,2023-11-22,9103
4979,華星光,13,6,7,群益金鼎-松山,2023-11-22,9103
6125,廣運,7,0,7,群益金鼎-松山,2023-11-22,9103
3231,緯創,31,24,7,群益金鼎-松山,2023-11-22,9103
2382,廣達,7,1,6,群益金鼎-松山,2023-11-22,9103
2465,麗臺,10,4,6,群益金鼎-松山,2023-11-22,9103
2745,五福,7,1,6,群益金鼎-松山,2023-11-22,9103
3059,華晶科,21,15,6,群益金鼎-松山,2023-11-22,9103
3189,景碩,6,0,6,群益金鼎-松山,2023-11-22,9103
3583,辛耘,18,12,6,群益金鼎-松山,2023-11-22,9103
6282,康舒,20,14,6,群益金鼎-松山,2023-11-22,9103
9105,泰金寶-DR,140,0,140,群益金鼎-松山,2023-11-23,9103
6245,立端,61,0,61,群益金鼎-松山,2023-11-23,9103
2457,飛宏,84,31,53,群益金鼎-松山,2023-11-23,9103
8111,立��,50,0,50,群益金鼎-松山,2023-11-23,9103
3078,僑威,61,13,48,群益金鼎-松山,2023-11-23,9103
2610,華航,35,2,33,群益金鼎-松山,2023-11-23,9103
1471,首利,34,8,26,群益金鼎-松山,2023-11-23,9103
1314,中石化,20,0,20,群益金鼎-松山,2023-11-23,9103
2609,陽明,20,0,20,群益金鼎-松山,2023-11-23,9103
4927,泰鼎-KY,20,0,20,群益金鼎-松山,2023-11-23,9103
2421,建準,19,0,19,群益金鼎-松山,2023-11-23,9103
5225,東科-KY,20,1,19,群益金鼎-松山,2023-11-23,9103
6237,驊訊,27,11,16,群益金鼎-松山,2023-11-23,9103
6291,沛亨,14,0,14,群益金鼎-松山,2023-11-23,9103
2344,華邦電,62,50,12,群益金鼎-松山,2023-11-23,9103
2356,英業達,12,0,12,群益金鼎-松山,2023-11-23,9103
6274,台燿,14,2,12,群益金鼎-松山,2023-11-23,9103
00919,群益台灣精選高息,11,0,11,群益金鼎-松山,2023-11-23,9103
2363,矽統,19,8,11,群益金鼎-松山,2023-11-23,9103
2739,寒舍,11,0,11,群益金鼎-松山,2023-11-23,9103
5880,合庫金,11,0,11,群益金鼎-松山,2023-11-23,9103
3059,華晶科,32,22,10,群益金鼎-松山,2023-11-23,9103
00671R,富邦NASDAQ反1,10,0,10,群益金鼎-松山,2023-11-23,9103
2485,兆赫,10,0,10,群益金鼎-松山,2023-11-23,9103
2881,富邦金,10,0,10,群益金鼎-松山,2023-11-23,9103
3041,揚智,23,13,10,群益金鼎-松山,2023-11-23,9103
3176,基亞,10,0,10,群益金鼎-松山,2023-11-23,9103
3535,晶彩科,10,0,10,群益金鼎-松山,2023-11-23,9103
6112,邁達特,11,1,10,群益金鼎-松山,2023-11-23,9103
6485,點序,11,1,10,群益金鼎-松山,2023-11-23,9103
6492,生華科,10,0,10,群益金鼎-松山,2023-11-23,9103
8040,九暘,42,32,10,群益金鼎-松山,2023-11-23,9103
8089,康全電訊,10,0,10,群益金鼎-松山,2023-11-23,9103
00632R,元大台灣50反1,21,12,9,群益金鼎-松山,2023-11-23,9103
2542,興富發,10,1,9,群益金鼎-松山,2023-11-23,9103
00637L,元大滬深300正2,8,0,8,群益金鼎-松山,2023-11-23,9103
3324,雙鴻,14,6,8,群益金鼎-松山,2023-11-23,9103
4908,前鼎,11,3,8,群益金鼎-松山,2023-11-23,9103
6125,廣運,45,37,8,群益金鼎-松山,2023-11-23,9103
2317,鴻海,6,0,6,群益金鼎-松山,2023-11-23,9103
3376,新日興,7,1,6,群益金鼎-松山,2023-11-23,9103
00929,復華台灣科技優息,5,0,5,群益金鼎-松山,2023-11-23,9103
00931B,統一美債20年,5,0,5,群益金鼎-松山,2023-11-23,9103
1513,中興電,6,1,5,群益金鼎-松山,2023-11-23,9103
1731,美吾華,5,0,5,群益金鼎-松山,2023-11-23,9103
2313,華通,20,15,5,群益金鼎-松山,2023-11-23,9103
2537,聯上發,5,0,5,群益金鼎-松山,2023-11-23,9103
3010,華立,5,0,5,群益金鼎-松山,2023-11-23,9103
6117,迎廣,73,68,5,群益金鼎-松山,2023-11-23,9103
6243,迅杰,8,3,5,群益金鼎-松山,2023-11-23,9103
6139,亞翔,165,0,165,群益金鼎-松山,2023-11-24,9103
00720B,元大投資級公司債,40,0,40,群益金鼎-松山,2023-11-24,9103
5483,中美晶,40,0,40,群益金鼎-松山,2023-11-24,9103
5351,鈺創,90,54,36,群益金鼎-松山,2023-11-24,9103
1471,首利,30,0,30,群益金鼎-松山,2023-11-24,9103
1503,士電,71,44,27,群益金鼎-松山,2023-11-24,9103
1815,富喬,26,0,26,群益金鼎-松山,2023-11-24,9103
1605,華新,32,12,20,群益金鼎-松山,2023-11-24,9103
2457,飛宏,45,25,20,群益金鼎-松山,2023-11-24,9103
6770,力積電,20,0,20,群益金鼎-松山,2023-11-24,9103
6235,華孚,21,3,18,群益金鼎-松山,2023-11-24,9103
2382,廣達,20,2,18,群益金鼎-松山,2023-11-24,9103
4931,新盛力,18,2,16,群益金鼎-松山,2023-11-24,9103
6462,神盾,15,0,15,群益金鼎-松山,2023-11-24,9103
2634,漢翔,12,0,12,群益金鼎-松山,2023-11-24,9103
1519,華城,41,30,11,群益金鼎-松山,2023-11-24,9103
00687B,國泰20年美債,11,0,11,群益金鼎-松山,2023-11-24,9103
5225,東科-KY,10,0,10,群益金鼎-松山,2023-11-24,9103
6138,茂達,11,1,10,群益金鼎-松山,2023-11-24,9103
8089,康全電訊,10,0,10,群益金鼎-松山,2023-11-24,9103
3217,優群,10,1,9,群益金鼎-松山,2023-11-24,9103
3548,兆利,9,0,9,群益金鼎-松山,2023-11-24,9103
2542,興富發,10,1,9,群益金鼎-松山,2023-11-24,9103
2330,台積電,8,0,8,群益金鼎-松山,2023-11-24,9103
4906,正文,8,0,8,群益金鼎-松山,2023-11-24,9103
6901,鑽石投資,8,0,8,群益金鼎-松山,2023-11-24,9103
6278,台表科,7,0,7,群益金鼎-松山,2023-11-24,9103
6470,宇智,7,0,7,群益金鼎-松山,2023-11-24,9103
6789,采鈺,12,6,6,群益金鼎-松山,2023-11-24,9103
2353,宏��,6,0,6,群益金鼎-松山,2023-11-24,9103
00929,復華台灣科技優息,6,0,6,群益金鼎-松山,2023-11-24,9103
2367,燿華,10,4,6,群益金鼎-松山,2023-11-24,9103
4908,前鼎,9,3,6,群益金鼎-松山,2023-11-24,9103
00652,富邦印度,5,0,5,群益金鼎-松山,2023-11-24,9103
2610,華航,7,2,5,群益金鼎-松山,2023-11-24,9103
3037,欣興,5,0,5,群益金鼎-松山,2023-11-24,9103
3706,神達,5,0,5,群益金鼎-松山,2023-11-24,9103
4541,晟田,5,0,5,群益金鼎-松山,2023-11-24,9103
5236,凌陽創新,5,0,5,群益金鼎-松山,2023-11-24,9103
6150,撼訊,5,0,5,群益金鼎-松山,2023-11-24,9103
2363,矽統,9,5,4,群益金鼎-松山,2023-11-24,9103
3704,合勤控,10,6,4,群益金鼎-松山,2023-11-24,9103
4121,優盛,5,1,4,群益金鼎-松山,2023-11-24,9103
4188,安克,4,0,4,群益金鼎-松山,2023-11-24,9103
5880,合庫金,5,1,4,群益金鼎-松山,2023-11-24,9103
2618,長榮航,7,3,4,群益金鼎-松山,2023-11-24,9103
00712,復華富時不動產,3,0,3,群益金鼎-松山,2023-11-24,9103
00680L,元大美債20正2,3,0,3,群益金鼎-松山,2023-11-24,9103
00933B,國泰10Y+金融債,3,0,3,群益金鼎-松山,2023-11-24,9103
3228,金麗科,5,2,3,群益金鼎-松山,2023-11-24,9103
2382,廣達,306,11,295,群益金鼎-松山,2023-11-27,9103
3374,精材,301,30,271,群益金鼎-松山,2023-11-27,9103
4114,健喬,75,0,75,群益金鼎-松山,2023-11-27,9103
2476,鉅祥,54,2,52,群益金鼎-松山,2023-11-27,9103
1514,亞力,144,92,52,群益金鼎-松山,2023-11-27,9103
1752,南光,50,0,50,群益金鼎-松山,2023-11-27,9103
00679B,元大美債20年,38,0,38,群益金鼎-松山,2023-11-27,9103
1513,中興電,60,27,33,群益金鼎-松山,2023-11-27,9103
1815,富喬,50,17,33,群益金鼎-松山,2023-11-27,9103
2401,凌陽,51,20,31,群益金鼎-松山,2023-11-27,9103
1795,美時,108,84,24,群益金鼎-松山,2023-11-27,9103
2405,輔信,21,1,20,群益金鼎-松山,2023-11-27,9103
5230,雷笛克光學,20,0,20,群益金鼎-松山,2023-11-27,9103
3035,智原,38,22,16,群益金鼎-松山,2023-11-27,9103
2883,凱基金,13,0,13,群益金鼎-松山,2023-11-27,9103
1582,信錦,10,0,10,群益金鼎-松山,2023-11-27,9103
00919,群益台灣精選高息,10,0,10,群益金鼎-松山,2023-11-27,9103
2337,旺宏,10,0,10,群益金鼎-松山,2023-11-27,9103
2882,國泰金,10,0,10,群益金鼎-松山,2023-11-27,9103
3176,基亞,20,10,10,群益金鼎-松山,2023-11-27,9103
6901,鑽石投資,10,0,10,群益金鼎-松山,2023-11-27,9103
3041,揚智,54,45,9,群益金鼎-松山,2023-11-27,9103
3483,力致,11,2,9,群益金鼎-松山,2023-11-27,9103
2457,飛宏,29,21,8,群益金鼎-松山,2023-11-27,9103
00720B,元大投資級公司債,7,0,7,群益金鼎-松山,2023-11-27,9103
1503,士電,31,25,6,群益金鼎-松山,2023-11-27,9103
00687B,國泰20年美債,6,0,6,群益金鼎-松山,2023-11-27,9103
3017,奇鋐,6,0,6,群益金鼎-松山,2023-11-27,9103
3325,旭品,6,0,6,群益金鼎-松山,2023-11-27,9103
4909,新復興,6,0,6,群益金鼎-松山,2023-11-27,9103
8111,立��,37,31,6,群益金鼎-松山,2023-11-27,9103
2327,國巨,5,0,5,群益金鼎-松山,2023-11-27,9103
2485,兆赫,15,10,5,群益金鼎-松山,2023-11-27,9103
4188,安克,9,4,5,群益金鼎-松山,2023-11-27,9103
5880,合庫金,5,0,5,群益金鼎-松山,2023-11-27,9103
4162,智擎,8,3,5,群益金鼎-松山,2023-11-27,9103
2303,聯電,4,0,4,群益金鼎-松山,2023-11-27,9103
0056,元大高股息,4,0,4,群益金鼎-松山,2023-11-27,9103
00632R,元大台灣50反1,4,0,4,群益金鼎-松山,2023-11-27,9103
2618,長榮航,6,2,4,群益金鼎-松山,2023-11-27,9103
3437,榮創,4,0,4,群益金鼎-松山,2023-11-27,9103
6143,振曜,9,5,4,群益金鼎-松山,2023-11-27,9103
6278,台表科,4,0,4,群益金鼎-松山,2023-11-27,9103
2330,台積電,3,0,3,群益金鼎-松山,2023-11-27,9103
3231,緯創,3,0,3,群益金鼎-松山,2023-11-27,9103
8086,宏捷科,24,21,3,群益金鼎-松山,2023-11-27,9103
00680L,元大美債20正2,3,0,3,群益金鼎-松山,2023-11-27,9103
00878,國泰永續高股息,3,0,3,群益金鼎-松山,2023-11-27,9103
1442,名軒,3,0,3,群益金鼎-松山,2023-11-27,9103
2731,雄獅,3,0,3,群益金鼎-松山,2023-11-27,9103
2382,廣達,407,11,396,群益金鼎-松山,2023-11-28,9103
2412,中華電,52,1,51,群益金鼎-松山,2023-11-28,9103
5351,鈺創,57,6,51,群益金鼎-松山,2023-11-28,9103
00640L,富邦日本正2,50,0,50,群益金鼎-松山,2023-11-28,9103
2641,正德,75,25,50,群益金鼎-松山,2023-11-28,9103
6164,華興,50,0,50,群益金鼎-松山,2023-11-28,9103
2363,矽統,45,3,42,群益金鼎-松山,2023-11-28,9103
2605,新興,103,61,42,群益金鼎-松山,2023-11-28,9103
3260,威剛,42,0,42,群益金鼎-松山,2023-11-28,9103
6462,神盾,43,1,42,群益金鼎-松山,2023-11-28,9103
3041,揚智,41,6,35,群益金鼎-松山,2023-11-28,9103
2367,燿華,37,3,34,群益金鼎-松山,2023-11-28,9103
1321,大洋,30,0,30,群益金鼎-松山,2023-11-28,9103
00670L,富邦NASDAQ正2,30,0,30,群益金鼎-松山,2023-11-28,9103
00830,國泰費城半導體,30,0,30,群益金鼎-松山,2023-11-28,9103
2375,凱美,22,0,22,群益金鼎-松山,2023-11-28,9103
00671R,富邦NASDAQ反1,20,0,20,群益金鼎-松山,2023-11-28,9103
00900,富邦特選高股息30,20,0,20,群益金鼎-松山,2023-11-28,9103
1701,中化,40,22,18,群益金鼎-松山,2023-11-28,9103
1101,台泥,18,2,16,群益金鼎-松山,2023-11-28,9103
2383,台光電,16,1,15,群益金鼎-松山,2023-11-28,9103
2606,裕民,75,61,14,群益金鼎-松山,2023-11-28,9103
3105,穩懋,12,1,11,群益金鼎-松山,2023-11-28,9103
00712,復華富時不動產,11,0,11,群益金鼎-松山,2023-11-28,9103
6278,台表科,11,0,11,群益金鼎-松山,2023-11-28,9103
1903,士紙,10,0,10,群益金鼎-松山,2023-11-28,9103
00850,元大臺灣ESG永續,10,0,10,群益金鼎-松山,2023-11-28,9103
2355,敬鵬,11,1,10,群益金鼎-松山,2023-11-28,9103
2478,大毅,10,0,10,群益金鼎-松山,2023-11-28,9103
2892,第一金,10,0,10,群益金鼎-松山,2023-11-28,9103
3006,晶豪科,10,0,10,群益金鼎-松山,2023-11-28,9103
5347,世界,10,0,10,群益金鼎-松山,2023-11-28,9103
6129,普誠,10,0,10,群益金鼎-松山,2023-11-28,9103
2881,富邦金,10,0,10,群益金鼎-松山,2023-11-28,9103
00637L,元大滬深300正2,9,0,9,群益金鼎-松山,2023-11-28,9103
6125,廣運,11,2,9,群益金鼎-松山,2023-11-28,9103
2353,宏��,8,0,8,群益金鼎-松山,2023-11-28,9103
4945,陞達科技,9,1,8,群益金鼎-松山,2023-11-28,9103
3228,金麗科,8,1,7,群益金鼎-松山,2023-11-28,9103
6243,迅杰,10,4,6,群益金鼎-松山,2023-11-28,9103
4746,台耀,6,0,6,群益金鼎-松山,2023-11-28,9103
00878,國泰永續高股息,6,0,6,群益金鼎-松山,2023-11-28,9103
0056,元大高股息,6,0,6,群益金鼎-松山,2023-11-28,9103
3051,力特,6,0,6,群益金鼎-松山,2023-11-28,9103
3231,緯創,6,0,6,群益金鼎-松山,2023-11-28,9103
00632R,元大台灣50反1,5,0,5,群益金鼎-松山,2023-11-28,9103
00713,元大台灣高息低波,5,0,5,群益金鼎-松山,2023-11-28,9103
00919,群益台灣精選高息,5,0,5,群益金鼎-松山,2023-11-28,9103
2376,技嘉,10,5,5,群益金鼎-松山,2023-11-28,9103
3010,華立,5,0,5,群益金鼎-松山,2023-11-28,9103
00680L,元大美債20正2,175,0,175,群益金鼎-松山,2023-11-29,9103
5328,華容,120,69,51,群益金鼎-松山,2023-11-29,9103
8096,擎亞,51,0,51,群益金鼎-松山,2023-11-29,9103
2369,菱生,96,46,50,群益金鼎-松山,2023-11-29,9103
5608,四維航,50,0,50,群益金鼎-松山,2023-11-29,9103
6271,同欣電,53,3,50,群益金鼎-松山,2023-11-29,9103
2301,光寶科,43,0,43,群益金鼎-松山,2023-11-29,9103
3624,光頡,72,31,41,群益金鼎-松山,2023-11-29,9103
3530,晶相光,30,0,30,群益金鼎-松山,2023-11-29,9103
6180,橘子,30,0,30,群益金鼎-松山,2023-11-29,9103
2465,麗臺,28,0,28,群益金鼎-松山,2023-11-29,9103
2399,映泰,25,0,25,群益金鼎-松山,2023-11-29,9103
8121,越峰,25,0,25,群益金鼎-松山,2023-11-29,9103
1603,華電,24,0,24,群益金鼎-松山,2023-11-29,9103
2457,飛宏,23,0,23,群益金鼎-松山,2023-11-29,9103
1815,富喬,29,6,23,群益金鼎-松山,2023-11-29,9103
00665L,富邦�琤肭磪囓�2,20,0,20,群益金鼎-松山,2023-11-29,9103
00655L,國泰中國A50正2,20,0,20,群益金鼎-松山,2023-11-29,9103
3016,嘉晶,20,0,20,群益金鼎-松山,2023-11-29,9103
3149,正達,20,0,20,群益金鼎-松山,2023-11-29,9103
3372,典範,114,94,20,群益金鼎-松山,2023-11-29,9103
5706,鳳凰,20,0,20,群益金鼎-松山,2023-11-29,9103
8112,至上,21,1,20,群益金鼎-松山,2023-11-29,9103
2504,國產,15,0,15,群益金鼎-松山,2023-11-29,9103
3032,偉訓,20,5,15,群益金鼎-松山,2023-11-29,9103
5292,華懋,13,0,13,群益金鼎-松山,2023-11-29,9103
1605,華新,11,0,11,群益金鼎-松山,2023-11-29,9103
2883,凱基金,13,3,10,群益金鼎-松山,2023-11-29,9103
1516,川飛,10,0,10,群益金鼎-松山,2023-11-29,9103
2332,友訊,10,0,10,群益金鼎-松山,2023-11-29,9103
2882,國泰金,10,0,10,群益金鼎-松山,2023-11-29,9103
3026,禾伸堂,20,10,10,群益金鼎-松山,2023-11-29,9103
3504,揚明光,10,0,10,群益金鼎-松山,2023-11-29,9103
5347,世界,10,0,10,群益金鼎-松山,2023-11-29,9103
6451,訊芯-KY,26,16,10,群益金鼎-松山,2023-11-29,9103
6695,芯鼎,31,21,10,群益金鼎-松山,2023-11-29,9103
6789,采鈺,12,2,10,群益金鼎-松山,2023-11-29,9103
8068,全達,11,1,10,群益金鼎-松山,2023-11-29,9103
8261,富鼎,20,10,10,群益金鼎-松山,2023-11-29,9103
00637L,元大滬深300正2,9,0,9,群益金鼎-松山,2023-11-29,9103
00720B,元大投資級公司債,9,0,9,群益金鼎-松山,2023-11-29,9103
3037,欣興,12,3,9,群益金鼎-松山,2023-11-29,9103
00772B,中信高評級公司債,8,0,8,群益金鼎-松山,2023-11-29,9103
3694,海華,9,1,8,群益金鼎-松山,2023-11-29,9103
4945,陞達科技,8,0,8,群益金鼎-松山,2023-11-29,9103
2353,宏��,9,2,7,群益金鼎-松山,2023-11-29,9103
3004,豐達科,6,0,6,群益金鼎-松山,2023-11-29,9103
00719B,元大美債1-3,6,0,6,群益金鼎-松山,2023-11-29,9103
2002,中鋼,206,200,6,群益金鼎-松山,2023-11-29,9103
2610,華航,7,1,6,群益金鼎-松山,2023-11-29,9103
1514,亞力,115,40,75,群益金鼎-松山,2023-11-30,9103
2329,華泰,181,114,67,群益金鼎-松山,2023-11-30,9103
2605,新興,70,25,45,群益金鼎-松山,2023-11-30,9103
5425,台半,42,0,42,群益金鼎-松山,2023-11-30,9103
2338,光罩,42,1,41,群益金鼎-松山,2023-11-30,9103
00632R,元大台灣50反1,36,0,36,群益金鼎-松山,2023-11-30,9103
1582,信錦,37,2,35,群益金鼎-松山,2023-11-30,9103
2915,潤泰全,30,0,30,群益金鼎-松山,2023-11-30,9103
5608,四維航,80,50,30,群益金鼎-松山,2023-11-30,9103
2313,華通,37,10,27,群益金鼎-松山,2023-11-30,9103
00720B,元大投資級公司債,25,0,25,群益金鼎-松山,2023-11-30,9103
00679B,元大美債20年,21,0,21,群益金鼎-松山,2023-11-30,9103
2492,華新科,31,10,21,群益金鼎-松山,2023-11-30,9103
3707,漢磊,21,0,21,群益金鼎-松山,2023-11-30,9103
00655L,國泰中國A50正2,20,0,20,群益金鼎-松山,2023-11-30,9103
2606,裕民,51,31,20,群益金鼎-松山,2023-11-30,9103
2637,慧洋-KY,20,0,20,群益金鼎-松山,2023-11-30,9103
3624,光頡,83,63,20,群益金鼎-松山,2023-11-30,9103
6485,點序,19,3,16,群益金鼎-松山,2023-11-30,9103
6733,博晟生醫,15,0,15,群益金鼎-松山,2023-11-30,9103
3711,日月光投控,14,0,14,群益金鼎-松山,2023-11-30,9103
3231,緯創,13,3,10,群益金鼎-松山,2023-11-30,9103
00645,富邦日本,10,0,10,群益金鼎-松山,2023-11-30,9103
2612,中航,10,0,10,群益金鼎-松山,2023-11-30,9103
3483,力致,12,2,10,群益金鼎-松山,2023-11-30,9103
1321,大洋,10,1,9,群益金鼎-松山,2023-11-30,9103
2883,凱基金,14,5,9,群益金鼎-松山,2023-11-30,9103
2353,宏��,13,5,8,群益金鼎-松山,2023-11-30,9103
2388,威盛,24,17,7,群益金鼎-松山,2023-11-30,9103
3293,鈊象,7,0,7,群益金鼎-松山,2023-11-30,9103
6117,迎廣,7,0,7,群益金鼎-松山,2023-11-30,9103
2337,旺宏,6,0,6,群益金鼎-松山,2023-11-30,9103
6933,AMAX-KY,6,0,6,群益金鼎-松山,2023-11-30,9103
8210,勤誠,7,2,5,群益金鼎-松山,2023-11-30,9103
2201,裕隆,5,0,5,群益金鼎-松山,2023-11-30,9103
1513,中興電,12,7,5,群益金鼎-松山,2023-11-30,9103
2485,兆赫,5,0,5,群益金鼎-松山,2023-11-30,9103
3022,威強電,7,2,5,群益金鼎-松山,2023-11-30,9103
4923,力士,5,0,5,群益金鼎-松山,2023-11-30,9103
6161,捷波,5,0,5,群益金鼎-松山,2023-11-30,9103
6168,宏齊,5,0,5,群益金鼎-松山,2023-11-30,9103
4904,遠傳,5,0,5,群益金鼎-松山,2023-11-30,9103
00636,國泰中國A50,4,0,4,群益金鼎-松山,2023-11-30,9103
00665L,富邦�琤肭磪囓�2,4,0,4,群益金鼎-松山,2023-11-30,9103
00934,中信成長高股息,4,0,4,群益金鼎-松山,2023-11-30,9103
2421,建準,12,8,4,群益金鼎-松山,2023-11-30,9103
3228,金麗科,10,6,4,群益金鼎-松山,2023-11-30,9103
6257,矽格,4,0,4,群益金鼎-松山,2023-11-30,9103
3035,智原,19,15,4,群益金鼎-松山,2023-11-30,9103
3704,合勤控,8,5,3,群益金鼎-松山,2023-11-30,9103
2883,凱基金,200,0,200,群益金鼎-松山,2023-12-01,9103
3481,群創,200,0,200,群益金鼎-松山,2023-12-01,9103
2369,菱生,110,10,100,群益金鼎-松山,2023-12-01,9103
2409,友達,100,0,100,群益金鼎-松山,2023-12-01,9103
5351,鈺創,63,10,53,群益金鼎-松山,2023-12-01,9103
5608,四維航,122,70,52,群益金鼎-松山,2023-12-01,9103
2344,華邦電,53,2,51,群益金鼎-松山,2023-12-01,9103
6233,旺玖,51,0,51,群益金鼎-松山,2023-12-01,9103
3450,聯鈞,50,1,49,群益金鼎-松山,2023-12-01,9103
2641,正德,53,5,48,群益金鼎-松山,2023-12-01,9103
8121,越峰,63,15,48,群益金鼎-松山,2023-12-01,9103
2516,新建,44,0,44,群益金鼎-松山,2023-12-01,9103
8176,智捷,37,0,37,群益金鼎-松山,2023-12-01,9103
1815,富喬,36,3,33,群益金鼎-松山,2023-12-01,9103
5439,高技,32,1,31,群益金鼎-松山,2023-12-01,9103
8155,博智,30,2,28,群益金鼎-松山,2023-12-01,9103
00919,群益台灣精選高息,27,0,27,群益金鼎-松山,2023-12-01,9103
3013,晟銘電,31,5,26,群益金鼎-松山,2023-12-01,9103
3346,麗清,25,0,25,群益金鼎-松山,2023-12-01,9103
4164,承業醫,33,10,23,群益金鼎-松山,2023-12-01,9103
5347,世界,22,0,22,群益金鼎-松山,2023-12-01,9103
3071,協禧,21,0,21,群益金鼎-松山,2023-12-01,9103
1584,精剛,20,0,20,群益金鼎-松山,2023-12-01,9103
2612,中航,20,0,20,群益金鼎-松山,2023-12-01,9103
3713,新晶投控,20,0,20,群益金鼎-松山,2023-12-01,9103
4533,協易機,45,25,20,群益金鼎-松山,2023-12-01,9103
1529,樂事綠能,19,0,19,群益金鼎-松山,2023-12-01,9103
6257,矽格,18,0,18,群益金鼎-松山,2023-12-01,9103
2543,皇昌,17,0,17,群益金鼎-松山,2023-12-01,9103
6733,博晟生醫,15,0,15,群益金鼎-松山,2023-12-01,9103
8222,寶一,16,1,15,群益金鼎-松山,2023-12-01,9103
8932,智通*,15,0,15,群益金鼎-松山,2023-12-01,9103
3555,博士旺,14,0,14,群益金鼎-松山,2023-12-01,9103
5230,雷笛克光學,30,16,14,群益金鼎-松山,2023-12-01,9103
1799,易威,13,0,13,群益金鼎-松山,2023-12-01,9103
8349,�矬�,13,0,13,群益金鼎-松山,2023-12-01,9103
1582,信錦,25,14,11,群益金鼎-松山,2023-12-01,9103
2356,英業達,13,2,11,群益金鼎-松山,2023-12-01,9103
2453,凌群,11,0,11,群益金鼎-松山,2023-12-01,9103
3260,威剛,11,0,11,群益金鼎-松山,2023-12-01,9103
2881,富邦金,10,0,10,群益金鼎-松山,2023-12-01,9103
00878,國泰永續高股息,10,0,10,群益金鼎-松山,2023-12-01,9103
00933B,國泰10Y+金融債,10,0,10,群益金鼎-松山,2023-12-01,9103
00680L,元大美債20正2,10,0,10,群益金鼎-松山,2023-12-01,9103
00918,大華優利高填息30,10,0,10,群益金鼎-松山,2023-12-01,9103
2332,友訊,10,0,10,群益金鼎-松山,2023-12-01,9103
2413,環科,40,30,10,群益金鼎-松山,2023-12-01,9103
2882,國泰金,10,0,10,群益金鼎-松山,2023-12-01,9103
3546,宇峻,10,0,10,群益金鼎-松山,2023-12-01,9103
5014,建錩,10,0,10,群益金鼎-松山,2023-12-01,9103
00687B,國泰20年美債,283,3,280,群益金鼎-松山,2023-12-04,9103
6116,彩晶,239,0,239,群益金鼎-松山,2023-12-04,9103
2409,友達,200,100,100,群益金鼎-松山,2023-12-04,9103
2617,台航,100,0,100,群益金鼎-松山,2023-12-04,9103
2883,凱基金,105,6,99,群益金鼎-松山,2023-12-04,9103
3481,群創,328,230,98,群益金鼎-松山,2023-12-04,9103
00679B,元大美債20年,83,0,83,群益金鼎-松山,2023-12-04,9103
2641,正德,54,0,54,群益金鼎-松山,2023-12-04,9103
4533,協易機,101,51,50,群益金鼎-松山,2023-12-04,9103
3264,欣銓,52,6,46,群益金鼎-松山,2023-12-04,9103
6164,華興,30,0,30,群益金鼎-松山,2023-12-04,9103
8433,弘帆,30,0,30,群益金鼎-松山,2023-12-04,9103
5328,華容,31,2,29,群益金鼎-松山,2023-12-04,9103
00665L,富邦�琤肭磪囓�2,25,0,25,群益金鼎-松山,2023-12-04,9103
3228,金麗科,29,6,23,群益金鼎-松山,2023-12-04,9103
6125,廣運,28,6,22,群益金鼎-松山,2023-12-04,9103
1513,中興電,40,19,21,群益金鼎-松山,2023-12-04,9103
00933B,國泰10Y+金融債,20,0,20,群益金鼎-松山,2023-12-04,9103
00891,中信關鍵半導體,20,0,20,群益金鼎-松山,2023-12-04,9103
00720B,元大投資級公司債,20,0,20,群益金鼎-松山,2023-12-04,9103
6547,高端疫苗,20,0,20,群益金鼎-松山,2023-12-04,9103
2314,台揚,20,3,17,群益金鼎-松山,2023-12-04,9103
8038,長園科,20,3,17,群益金鼎-松山,2023-12-04,9103
9919,康那香,22,5,17,群益金鼎-松山,2023-12-04,9103
2637,慧洋-KY,83,67,16,群益金鼎-松山,2023-12-04,9103
8436,大江,16,1,15,群益金鼎-松山,2023-12-04,9103
1809,中釉,14,0,14,群益金鼎-松山,2023-12-04,9103
6426,統新,13,0,13,群益金鼎-松山,2023-12-04,9103
2014,中鴻,12,0,12,群益金鼎-松山,2023-12-04,9103
2606,裕民,44,32,12,群益金鼎-松山,2023-12-04,9103
3017,奇鋐,12,0,12,群益金鼎-松山,2023-12-04,9103
4961,天鈺,26,15,11,群益金鼎-松山,2023-12-04,9103
2542,興富發,11,0,11,群益金鼎-松山,2023-12-04,9103
3105,穩懋,22,11,11,群益金鼎-松山,2023-12-04,9103
6276,安鈦克,11,0,11,群益金鼎-松山,2023-12-04,9103
00637L,元大滬深300正2,10,0,10,群益金鼎-松山,2023-12-04,9103
2305,全友,10,0,10,群益金鼎-松山,2023-12-04,9103
5225,東科-KY,10,0,10,群益金鼎-松山,2023-12-04,9103
1321,大洋,9,0,9,群益金鼎-松山,2023-12-04,9103
6126,信音,8,0,8,群益金鼎-松山,2023-12-04,9103
2330,台積電,8,1,7,群益金鼎-松山,2023-12-04,9103
1514,亞力,62,55,7,群益金鼎-松山,2023-12-04,9103
2612,中航,17,10,7,群益金鼎-松山,2023-12-04,9103
4979,華星光,10,3,7,群益金鼎-松山,2023-12-04,9103
00919,群益台灣精選高息,8,2,6,群益金鼎-松山,2023-12-04,9103
3163,波若威,6,0,6,群益金鼎-松山,2023-12-04,9103
3588,通嘉,9,3,6,群益金鼎-松山,2023-12-04,9103
6139,亞翔,6,0,6,群益金鼎-松山,2023-12-04,9103
00715L,期街口布蘭特正2,5,0,5,群益金鼎-松山,2023-12-04,9103
2485,兆赫,10,5,5,群益金鼎-松山,2023-12-04,9103
1504,東元,276,0,276,群益金鼎-松山,2023-12-05,9103
00687B,國泰20年美債,150,0,150,群益金鼎-松山,2023-12-05,9103
9103,美德醫療-DR,100,10,90,群益金鼎-松山,2023-12-05,9103
2641,正德,271,214,57,群益金鼎-松山,2023-12-05,9103
2457,飛宏,51,1,50,群益金鼎-松山,2023-12-05,9103
1513,中興電,68,28,40,群益金鼎-松山,2023-12-05,9103
00720B,元大投資級公司債,40,0,40,群益金鼎-松山,2023-12-05,9103
5864,致和證,32,0,32,群益金鼎-松山,2023-12-05,9103
2883,凱基金,31,0,31,群益金鼎-松山,2023-12-05,9103
5608,四維航,186,156,30,群益金鼎-松山,2023-12-05,9103
6282,康舒,31,1,30,群益金鼎-松山,2023-12-05,9103
1815,富喬,29,8,21,群益金鼎-松山,2023-12-05,9103
00915,凱基優選高股息30,20,0,20,群益金鼎-松山,2023-12-05,9103
2353,宏��,20,0,20,群益金鼎-松山,2023-12-05,9103
6485,點序,20,2,18,群益金鼎-松山,2023-12-05,9103
1905,華紙,27,10,17,群益金鼎-松山,2023-12-05,9103
1325,恆大,36,20,16,群益金鼎-松山,2023-12-05,9103
1503,士電,25,9,16,群益金鼎-松山,2023-12-05,9103
3511,矽瑪,15,0,15,群益金鼎-松山,2023-12-05,9103
4908,前鼎,12,0,12,群益金鼎-松山,2023-12-05,9103
00919,群益台灣精選高息,11,0,11,群益金鼎-松山,2023-12-05,9103
00918,大華優利高填息30,11,0,11,群益金鼎-松山,2023-12-05,9103
2329,華泰,52,41,11,群益金鼎-松山,2023-12-05,9103
00850,元大臺灣ESG永續,10,0,10,群益金鼎-松山,2023-12-05,9103
00665L,富邦�琤肭磪囓�2,10,0,10,群益金鼎-松山,2023-12-05,9103
2892,第一金,10,0,10,群益金鼎-松山,2023-12-05,9103
8433,弘帆,10,0,10,群益金鼎-松山,2023-12-05,9103
3035,智原,18,9,9,群益金鼎-松山,2023-12-05,9103
2354,鴻準,9,0,9,群益金鼎-松山,2023-12-05,9103
1605,華新,12,4,8,群益金鼎-松山,2023-12-05,9103
8349,�矬�,8,0,8,群益金鼎-松山,2023-12-05,9103
00637L,元大滬深300正2,7,0,7,群益金鼎-松山,2023-12-05,9103
6233,旺玖,7,0,7,群益金鼎-松山,2023-12-05,9103
2312,金寶,6,0,6,群益金鼎-松山,2023-12-05,9103
2363,矽統,7,1,6,群益金鼎-松山,2023-12-05,9103
2376,技嘉,6,0,6,群益金鼎-松山,2023-12-05,9103
3093,港建*,6,0,6,群益金鼎-松山,2023-12-05,9103
4533,協易機,6,0,6,群益金鼎-松山,2023-12-05,9103
2355,敬鵬,12,7,5,群益金鼎-松山,2023-12-05,9103
1519,華城,10,5,5,群益金鼎-松山,2023-12-05,9103
00738U,期元大道瓊白銀,5,0,5,群益金鼎-松山,2023-12-05,9103
2887,台新金,5,0,5,群益金鼎-松山,2023-12-05,9103
3390,旭軟,5,0,5,群益金鼎-松山,2023-12-05,9103
3693,營邦,5,0,5,群益金鼎-松山,2023-12-05,9103
4979,華星光,5,0,5,群益金鼎-松山,2023-12-05,9103
6148,驊宏資,7,2,5,群益金鼎-松山,2023-12-05,9103
9939,宏全,5,0,5,群益金鼎-松山,2023-12-05,9103
1440,南紡,5,1,4,群益金鼎-松山,2023-12-05,9103
00929,復華台灣科技優息,4,0,4,群益金鼎-松山,2023-12-05,9103
2313,華通,10,6,4,群益金鼎-松山,2023-12-05,9103
00687B,國泰20年美債,232,2,230,群益金鼎-松山,2023-12-06,9103
2605,新興,225,57,168,群益金鼎-松山,2023-12-06,9103
2323,中環,101,0,101,群益金鼎-松山,2023-12-06,9103
00674R,期元大S＆P黃金反1,100,0,100,群益金鼎-松山,2023-12-06,9103
00680L,元大美債20正2,100,0,100,群益金鼎-松山,2023-12-06,9103
5426,振發,100,0,100,群益金鼎-松山,2023-12-06,9103
3374,精材,80,2,78,群益金鼎-松山,2023-12-06,9103
9919,康那香,52,1,51,群益金鼎-松山,2023-12-06,9103
00830,國泰費城半導體,50,0,50,群益金鼎-松山,2023-12-06,9103
00679B,元大美債20年,47,0,47,群益金鼎-松山,2023-12-06,9103
1506,正道,31,0,31,群益金鼎-松山,2023-12-06,9103
00670L,富邦NASDAQ正2,30,0,30,群益金鼎-松山,2023-12-06,9103
1529,樂事綠能,92,63,29,群益金鼎-松山,2023-12-06,9103
6213,聯茂,25,0,25,群益金鼎-松山,2023-12-06,9103
1605,華新,24,0,24,群益金鼎-松山,2023-12-06,9103
9958,世紀鋼,32,8,24,群益金鼎-松山,2023-12-06,9103
2371,大同,20,0,20,群益金鼎-松山,2023-12-06,9103
2375,凱美,20,0,20,群益金鼎-松山,2023-12-06,9103
1519,華城,37,17,20,群益金鼎-松山,2023-12-06,9103
1514,亞力,99,81,18,群益金鼎-松山,2023-12-06,9103
1616,億泰,18,1,17,群益金鼎-松山,2023-12-06,9103
1781,合世,18,1,17,群益金鼎-松山,2023-12-06,9103
1325,恆大,25,10,15,群益金鼎-松山,2023-12-06,9103
5292,華懋,13,0,13,群益金鼎-松山,2023-12-06,9103
8349,�矬�,13,0,13,群益金鼎-松山,2023-12-06,9103
2606,裕民,13,2,11,群益金鼎-松山,2023-12-06,9103
2612,中航,39,28,11,群益金鼎-松山,2023-12-06,9103
00715L,期街口布蘭特正2,10,0,10,群益金鼎-松山,2023-12-06,9103
2368,金像電,10,0,10,群益金鼎-松山,2023-12-06,9103
2489,瑞軒,10,0,10,群益金鼎-松山,2023-12-06,9103
2542,興富發,10,0,10,群益金鼎-松山,2023-12-06,9103
00632R,元大台灣50反1,9,0,9,群益金鼎-松山,2023-12-06,9103
3093,港建*,9,0,9,群益金鼎-松山,2023-12-06,9103
3228,金麗科,9,0,9,群益金鼎-松山,2023-12-06,9103
5243,乙盛-KY,8,0,8,群益金鼎-松山,2023-12-06,9103
1503,士電,55,47,8,群益金鼎-松山,2023-12-06,9103
6643,M31,7,0,7,群益金鼎-松山,2023-12-06,9103
6805,富世達,6,0,6,群益金鼎-松山,2023-12-06,9103
1314,中石化,6,0,6,群益金鼎-松山,2023-12-06,9103
00933B,國泰10Y+金融債,6,0,6,群益金鼎-松山,2023-12-06,9103
2363,矽統,17,11,6,群益金鼎-松山,2023-12-06,9103
3029,零壹,6,0,6,群益金鼎-松山,2023-12-06,9103
3081,聯亞,10,4,6,群益金鼎-松山,2023-12-06,9103
5871,中租-KY,6,0,6,群益金鼎-松山,2023-12-06,9103
6243,迅杰,18,12,6,群益金鼎-松山,2023-12-06,9103
00665L,富邦�琤肭磪囓�2,5,0,5,群益金鼎-松山,2023-12-06,9103
00637L,元大滬深300正2,5,0,5,群益金鼎-松山,2023-12-06,9103
00688L,國泰20年美債正2,5,0,5,群益金鼎-松山,2023-12-06,9103
2485,兆赫,5,0,5,群益金鼎-松山,2023-12-06,9103
3338,泰碩,5,0,5,群益金鼎-松山,2023-12-06,9103
2312,金寶,200,1,199,群益金鼎-松山,2023-12-07,9103
00715L,期街口布蘭特正2,107,0,107,群益金鼎-松山,2023-12-07,9103
2371,大同,78,0,78,群益金鼎-松山,2023-12-07,9103
8277,商丞,60,0,60,群益金鼎-松山,2023-12-07,9103
00640L,富邦日本正2,50,0,50,群益金鼎-松山,2023-12-07,9103
2331,精英,33,3,30,群益金鼎-松山,2023-12-07,9103
8028,昇陽半導體,24,0,24,群益金鼎-松山,2023-12-07,9103
00712,復華富時不動產,20,0,20,群益金鼎-松山,2023-12-07,9103
2375,凱美,20,0,20,群益金鼎-松山,2023-12-07,9103
2465,麗臺,20,0,20,群益金鼎-松山,2023-12-07,9103
3432,台端,20,0,20,群益金鼎-松山,2023-12-07,9103
2882,國泰金,19,0,19,群益金鼎-松山,2023-12-07,9103
1603,華電,19,2,17,群益金鼎-松山,2023-12-07,9103
6150,撼訊,22,6,16,群益金鼎-松山,2023-12-07,9103
2376,技嘉,27,12,15,群益金鼎-松山,2023-12-07,9103
3041,揚智,50,35,15,群益金鼎-松山,2023-12-07,9103
1522,堤維西,36,23,13,群益金鼎-松山,2023-12-07,9103
3479,安勤,20,7,13,群益金鼎-松山,2023-12-07,9103
5347,世界,12,0,12,群益金鼎-松山,2023-12-07,9103
1514,亞力,83,71,12,群益金鼎-松山,2023-12-07,9103
00919,群益台灣精選高息,11,0,11,群益金鼎-松山,2023-12-07,9103
00772B,中信高評級公司債,10,0,10,群益金鼎-松山,2023-12-07,9103
1815,富喬,10,0,10,群益金鼎-松山,2023-12-07,9103
2324,仁寶,10,0,10,群益金鼎-松山,2023-12-07,9103
2883,凱基金,10,0,10,群益金鼎-松山,2023-12-07,9103
6274,台燿,10,0,10,群益金鼎-松山,2023-12-07,9103
8433,弘帆,10,0,10,群益金鼎-松山,2023-12-07,9103
8936,國統,53,44,9,群益金鼎-松山,2023-12-07,9103
1781,合世,26,18,8,群益金鼎-松山,2023-12-07,9103
2211,長榮鋼,11,4,7,群益金鼎-松山,2023-12-07,9103
2344,華邦電,11,4,7,群益金鼎-松山,2023-12-07,9103
6243,迅杰,19,12,7,群益金鼎-松山,2023-12-07,9103
2329,華泰,29,23,6,群益金鼎-松山,2023-12-07,9103
1560,中砂,6,0,6,群益金鼎-松山,2023-12-07,9103
2382,廣達,30,24,6,群益金鼎-松山,2023-12-07,9103
2405,輔信,6,0,6,群益金鼎-松山,2023-12-07,9103
4164,承業醫,6,0,6,群益金鼎-松山,2023-12-07,9103
4536,拓凱,6,0,6,群益金鼎-松山,2023-12-07,9103
6901,鑽石投資,6,0,6,群益金鼎-松山,2023-12-07,9103
8054,安國,22,16,6,群益金鼎-松山,2023-12-07,9103
8349,�矬�,9,3,6,群益金鼎-松山,2023-12-07,9103
00687B,國泰20年美債,12,7,5,群益金鼎-松山,2023-12-07,9103
2355,敬鵬,16,11,5,群益金鼎-松山,2023-12-07,9103
2476,鉅祥,5,0,5,群益金鼎-松山,2023-12-07,9103
2612,中航,15,10,5,群益金鼎-松山,2023-12-07,9103
5880,合庫金,5,0,5,群益金鼎-松山,2023-12-07,9103
2881,富邦金,4,0,4,群益金鼎-松山,2023-12-07,9103
00936,台新永續高息中小,4,0,4,群益金鼎-松山,2023-12-07,9103
00931B,統一美債20年,4,0,4,群益金鼎-松山,2023-12-07,9103
1616,億泰,4,0,4,群益金鼎-松山,2023-12-07,9103
2641,正德,100,0,100,群益金鼎-松山,2023-12-08,9103
2888,新光金,100,0,100,群益金鼎-松山,2023-12-08,9103
1506,正道,57,0,57,群益金鼎-松山,2023-12-08,9103
2314,台揚,52,2,50,群益金鼎-松山,2023-12-08,9103
6462,神盾,37,0,37,群益金鼎-松山,2023-12-08,9103
2615,萬海,30,0,30,群益金鼎-松山,2023-12-08,9103
3527,聚積,30,0,30,群益金鼎-松山,2023-12-08,9103
2405,輔信,30,1,29,群益金鼎-松山,2023-12-08,9103
3006,晶豪科,22,1,21,群益金鼎-松山,2023-12-08,9103
1325,恆大,30,10,20,群益金鼎-松山,2023-12-08,9103
00929,復華台灣科技優息,20,0,20,群益金鼎-松山,2023-12-08,9103
2606,裕民,20,0,20,群益金鼎-松山,2023-12-08,9103
3711,日月光投控,22,3,19,群益金鼎-松山,2023-12-08,9103
2201,裕隆,20,2,18,群益金鼎-松山,2023-12-08,9103
3260,威剛,41,25,16,群益金鼎-松山,2023-12-08,9103
00715L,期街口布蘭特正2,13,0,13,群益金鼎-松山,2023-12-08,9103
8054,安國,67,54,13,群益金鼎-松山,2023-12-08,9103
2736,富野,12,0,12,群益金鼎-松山,2023-12-08,9103
00919,群益台灣精選高息,11,0,11,群益金鼎-松山,2023-12-08,9103
1605,華新,11,0,11,群益金鼎-松山,2023-12-08,9103
8112,至上,13,2,11,群益金鼎-松山,2023-12-08,9103
00706L,期元大S＆P日圓正2,10,0,10,群益金鼎-松山,2023-12-08,9103
2882,國泰金,10,0,10,群益金鼎-松山,2023-12-08,9103
5425,台半,10,0,10,群益金鼎-松山,2023-12-08,9103
6274,台燿,12,2,10,群益金鼎-松山,2023-12-08,9103
8086,宏捷科,11,1,10,群益金鼎-松山,2023-12-08,9103
9919,康那香,100,90,10,群益金鼎-松山,2023-12-08,9103
2363,矽統,16,7,9,群益金鼎-松山,2023-12-08,9103
00937B,群益ESG投等債20,10,2,8,群益金鼎-松山,2023-12-08,9103
3032,偉訓,10,3,7,群益金鼎-松山,2023-12-08,9103
5608,四維航,7,0,7,群益金鼎-松山,2023-12-08,9103
2739,寒舍,6,0,6,群益金鼎-松山,2023-12-08,9103
5704,老爺知,6,0,6,群益金鼎-松山,2023-12-08,9103
00665L,富邦�琤肭磪囓�2,5,0,5,群益金鼎-松山,2023-12-08,9103
00636,國泰中國A50,5,0,5,群益金鼎-松山,2023-12-08,9103
00632R,元大台灣50反1,5,0,5,群益金鼎-松山,2023-12-08,9103
00679B,元大美債20年,5,0,5,群益金鼎-松山,2023-12-08,9103
00688L,國泰20年美債正2,5,0,5,群益金鼎-松山,2023-12-08,9103
1795,美時,5,0,5,群益金鼎-松山,2023-12-08,9103
1903,士紙,5,0,5,群益金鼎-松山,2023-12-08,9103
2323,中環,5,0,5,群益金鼎-松山,2023-12-08,9103
2401,凌陽,5,0,5,群益金鼎-松山,2023-12-08,9103
3483,力致,7,2,5,群益金鼎-松山,2023-12-08,9103
4306,炎洲,5,0,5,群益金鼎-松山,2023-12-08,9103
4533,協易機,5,0,5,群益金鼎-松山,2023-12-08,9103
5236,凌陽創新,10,5,5,群益金鼎-松山,2023-12-08,9103
5706,鳳凰,5,0,5,群益金鼎-松山,2023-12-08,9103
6207,雷科,5,0,5,群益金鼎-松山,2023-12-08,9103
6239,力成,5,0,5,群益金鼎-松山,2023-12-08,9103
6414,樺漢,5,0,5,群益金鼎-松山,2023-12-08,9103
00633L,富邦上証正2,110,0,110,群益金鼎-松山,2023-12-11,9103
2002,中鋼,100,0,100,群益金鼎-松山,2023-12-11,9103
1618,合機,57,2,55,群益金鼎-松山,2023-12-11,9103
2412,中華電,50,0,50,群益金鼎-松山,2023-12-11,9103
2605,新興,50,10,40,群益金鼎-松山,2023-12-11,9103
00933B,國泰10Y+金融債,37,0,37,群益金鼎-松山,2023-12-11,9103
2330,台積電,30,0,30,群益金鼎-松山,2023-12-11,9103
8936,國統,28,0,28,群益金鼎-松山,2023-12-11,9103
8112,至上,60,33,27,群益金鼎-松山,2023-12-11,9103
2388,威盛,50,24,26,群益金鼎-松山,2023-12-11,9103
6538,倉和,26,0,26,群益金鼎-松山,2023-12-11,9103
00931B,統一美債20年,24,0,24,群益金鼎-松山,2023-12-11,9103
6462,神盾,22,0,22,群益金鼎-松山,2023-12-11,9103
3312,弘憶股,22,1,21,群益金鼎-松山,2023-12-11,9103
1605,華新,20,0,20,群益金鼎-松山,2023-12-11,9103
00929,復華台灣科技優息,20,0,20,群益金鼎-松山,2023-12-11,9103
2504,國產,20,0,20,群益金鼎-松山,2023-12-11,9103
6285,啟��,26,6,20,群益金鼎-松山,2023-12-11,9103
9928,中視,20,0,20,群益金鼎-松山,2023-12-11,9103
2375,凱美,20,2,18,群益金鼎-松山,2023-12-11,9103
2324,仁寶,16,2,14,群益金鼎-松山,2023-12-11,9103
2368,金像電,13,0,13,群益金鼎-松山,2023-12-11,9103
00878,國泰永續高股息,22,10,12,群益金鼎-松山,2023-12-11,9103
1560,中砂,11,0,11,群益金鼎-松山,2023-12-11,9103
2405,輔信,41,30,11,群益金鼎-松山,2023-12-11,9103
2882,國泰金,10,0,10,群益金鼎-松山,2023-12-11,9103
6164,華興,10,0,10,群益金鼎-松山,2023-12-11,9103
6533,晶心科,9,0,9,群益金鼎-松山,2023-12-11,9103
8227,巨有科技,8,0,8,群益金鼎-松山,2023-12-11,9103
2451,創見,8,0,8,群益金鼎-松山,2023-12-11,9103
2888,新光金,8,0,8,群益金鼎-松山,2023-12-11,9103
4979,華星光,16,8,8,群益金鼎-松山,2023-12-11,9103
8028,昇陽半導體,8,0,8,群益金鼎-松山,2023-12-11,9103
2618,長榮航,11,4,7,群益金鼎-松山,2023-12-11,9103
00937B,群益ESG投等債20,9,3,6,群益金鼎-松山,2023-12-11,9103
2383,台光電,6,0,6,群益金鼎-松山,2023-12-11,9103
2610,華航,6,0,6,群益金鼎-松山,2023-12-11,9103
8210,勤誠,14,8,6,群益金鼎-松山,2023-12-11,9103
1519,華城,9,4,5,群益金鼎-松山,2023-12-11,9103
00665L,富邦�琤肭磪囓�2,5,0,5,群益金鼎-松山,2023-12-11,9103
00679B,元大美債20年,8,3,5,群益金鼎-松山,2023-12-11,9103
5348,正能量智能,5,0,5,群益金鼎-松山,2023-12-11,9103
8054,安國,17,12,5,群益金鼎-松山,2023-12-11,9103
00882,中信中國高股息,4,0,4,群益金鼎-松山,2023-12-11,9103
2323,中環,4,0,4,群益金鼎-松山,2023-12-11,9103
3013,晟銘電,5,1,4,群益金鼎-松山,2023-12-11,9103
3093,港建*,4,0,4,群益金鼎-松山,2023-12-11,9103
6220,岳豐,4,0,4,群益金鼎-松山,2023-12-11,9103
8426,紅木-KY,4,0,4,群益金鼎-松山,2023-12-11,9103
2327,國巨,5,1,4,群益金鼎-松山,2023-12-11,9103
5521,工信,302,30,272,群益金鼎-松山,2023-12-12,9103
00919,群益台灣精選高息,136,2,134,群益金鼎-松山,2023-12-12,9103
00929,復華台灣科技優息,105,0,105,群益金鼎-松山,2023-12-12,9103
8011,台通,140,69,71,群益金鼎-松山,2023-12-12,9103
00680L,元大美債20正2,100,40,60,群益金鼎-松山,2023-12-12,9103
00640L,富邦日本正2,50,0,50,群益金鼎-松山,2023-12-12,9103
00830,國泰費城半導體,50,0,50,群益金鼎-松山,2023-12-12,9103
2427,三商電,44,2,42,群益金鼎-松山,2023-12-12,9103
2374,佳能,38,0,38,群益金鼎-松山,2023-12-12,9103
3712,永崴投控,43,7,36,群益金鼎-松山,2023-12-12,9103
8936,國統,30,1,29,群益金鼎-松山,2023-12-12,9103
6488,環球晶,26,0,26,群益金鼎-松山,2023-12-12,9103
00878,國泰永續高股息,40,20,20,群益金鼎-松山,2023-12-12,9103
3532,台勝科,20,0,20,群益金鼎-松山,2023-12-12,9103
4768,晶呈科技,44,25,19,群益金鼎-松山,2023-12-12,9103
00687B,國泰20年美債,18,2,16,群益金鼎-松山,2023-12-12,9103
4909,新復興,20,6,14,群益金鼎-松山,2023-12-12,9103
4908,前鼎,18,5,13,群益金鼎-松山,2023-12-12,9103
6182,合晶,14,2,12,群益金鼎-松山,2023-12-12,9103
00937B,群益ESG投等債20,11,0,11,群益金鼎-松山,2023-12-12,9103
1503,士電,11,0,11,群益金鼎-松山,2023-12-12,9103
1513,中興電,12,2,10,群益金鼎-松山,2023-12-12,9103
00688L,國泰20年美債正2,10,0,10,群益金鼎-松山,2023-12-12,9103
2606,裕民,10,0,10,群益金鼎-松山,2023-12-12,9103
3006,晶豪科,11,1,10,群益金鼎-松山,2023-12-12,9103
6164,華興,10,0,10,群益金鼎-松山,2023-12-12,9103
9105,泰金寶-DR,10,0,10,群益金鼎-松山,2023-12-12,9103
2344,華邦電,10,1,9,群益金鼎-松山,2023-12-12,9103
2383,台光電,9,0,9,群益金鼎-松山,2023-12-12,9103
6282,康舒,10,1,9,群益金鼎-松山,2023-12-12,9103
00637L,元大滬深300正2,10,2,8,群益金鼎-松山,2023-12-12,9103
8096,擎亞,15,7,8,群益金鼎-松山,2023-12-12,9103
1584,精剛,9,2,7,群益金鼎-松山,2023-12-12,9103
2313,華通,20,14,6,群益金鼎-松山,2023-12-12,9103
00935,野村臺灣新科技50,5,0,5,群益金鼎-松山,2023-12-12,9103
00753L,中信中國50正2,5,0,5,群益金鼎-松山,2023-12-12,9103
2323,中環,5,0,5,群益金鼎-松山,2023-12-12,9103
2399,映泰,5,0,5,群益金鼎-松山,2023-12-12,9103
2520,冠德,5,0,5,群益金鼎-松山,2023-12-12,9103
2612,中航,5,0,5,群益金鼎-松山,2023-12-12,9103
3041,揚智,14,9,5,群益金鼎-松山,2023-12-12,9103
3228,金麗科,5,0,5,群益金鼎-松山,2023-12-12,9103
5907,大洋-KY,5,0,5,群益金鼎-松山,2023-12-12,9103
6138,茂達,6,2,4,群益金鼎-松山,2023-12-12,9103
2059,川湖,4,0,4,群益金鼎-松山,2023-12-12,9103
3032,偉訓,4,0,4,群益金鼎-松山,2023-12-12,9103
3149,正達,4,0,4,群益金鼎-松山,2023-12-12,9103
3711,日月光投控,4,0,4,群益金鼎-松山,2023-12-12,9103
6139,亞翔,6,2,4,群益金鼎-松山,2023-12-12,9103
6278,台表科,4,0,4,群益金鼎-松山,2023-12-12,9103
00715L,期街口布蘭特正2,111,0,111,群益金鼎-松山,2023-12-13,9103
2515,中工,103,0,103,群益金鼎-松山,2023-12-13,9103
9103,美德醫療-DR,100,0,100,群益金鼎-松山,2023-12-13,9103
00919,群益台灣精選高息,60,0,60,群益金鼎-松山,2023-12-13,9103
00679B,元大美債20年,50,0,50,群益金鼎-松山,2023-12-13,9103
3712,永崴投控,28,0,28,群益金鼎-松山,2023-12-13,9103
2449,京元電子,25,3,22,群益金鼎-松山,2023-12-13,9103
9919,康那香,20,0,20,群益金鼎-松山,2023-12-13,9103
3706,神達,73,55,18,群益金鼎-松山,2023-12-13,9103
00929,復華台灣科技優息,23,6,17,群益金鼎-松山,2023-12-13,9103
2399,映泰,20,5,15,群益金鼎-松山,2023-12-13,9103
3231,緯創,14,3,11,群益金鼎-松山,2023-12-13,9103
2603,長榮,10,0,10,群益金鼎-松山,2023-12-13,9103
00725B,國泰投資級公司債,10,0,10,群益金鼎-松山,2023-12-13,9103
2882,國泰金,10,0,10,群益金鼎-松山,2023-12-13,9103
3013,晟銘電,15,5,10,群益金鼎-松山,2023-12-13,9103
6182,合晶,10,0,10,群益金鼎-松山,2023-12-13,9103
9105,泰金寶-DR,10,0,10,群益金鼎-松山,2023-12-13,9103
1618,合機,10,1,9,群益金鼎-松山,2023-12-13,9103
2313,華通,26,17,9,群益金鼎-松山,2023-12-13,9103
00687B,國泰20年美債,8,0,8,群益金鼎-松山,2023-12-13,9103
2002,中鋼,7,0,7,群益金鼎-松山,2023-12-13,9103
4909,新復興,7,0,7,群益金鼎-松山,2023-12-13,9103
1785,光洋科,6,0,6,群益金鼎-松山,2023-12-13,9103
2451,創見,6,0,6,群益金鼎-松山,2023-12-13,9103
3178,公準,6,0,6,群益金鼎-松山,2023-12-13,9103
6462,神盾,6,0,6,群益金鼎-松山,2023-12-13,9103
2330,台積電,36,31,5,群益金鼎-松山,2023-12-13,9103
00665L,富邦�琤肭磪囓�2,5,0,5,群益金鼎-松山,2023-12-13,9103
00632R,元大台灣50反1,5,0,5,群益金鼎-松山,2023-12-13,9103
2542,興富發,5,0,5,群益金鼎-松山,2023-12-13,9103
3322,建舜電,5,0,5,群益金鼎-松山,2023-12-13,9103
4908,前鼎,16,11,5,群益金鼎-松山,2023-12-13,9103
5880,合庫金,5,0,5,群益金鼎-松山,2023-12-13,9103
6122,擎邦,10,5,5,群益金鼎-松山,2023-12-13,9103
6150,撼訊,10,5,5,群益金鼎-松山,2023-12-13,9103
6168,宏齊,5,0,5,群益金鼎-松山,2023-12-13,9103
3702,大聯大,5,0,5,群益金鼎-松山,2023-12-13,9103
8349,�矬�,10,5,5,群益金鼎-松山,2023-12-13,9103
2371,大同,4,0,4,群益金鼎-松山,2023-12-13,9103
3521,鴻翊,4,0,4,群益金鼎-松山,2023-12-13,9103
3623,富晶通,4,0,4,群益金鼎-松山,2023-12-13,9103
6278,台表科,4,0,4,群益金鼎-松山,2023-12-13,9103
2425,承啟,6,3,3,群益金鼎-松山,2023-12-13,9103
2516,新建,3,0,3,群益金鼎-松山,2023-12-13,9103
4402,郡都開發,3,0,3,群益金鼎-松山,2023-12-13,9103
4763,材料-KY,3,0,3,群益金鼎-松山,2023-12-13,9103
6208,日揚,3,0,3,群益金鼎-松山,2023-12-13,9103
1560,中砂,3,0,3,群益金鼎-松山,2023-12-13,9103
3059,華晶科,2,0,2,群益金鼎-松山,2023-12-13,9103
2363,矽統,252,138,114,群益金鼎-松山,2023-12-14,9103
2886,兆豐金,100,0,100,群益金鼎-松山,2023-12-14,9103
3380,明泰,95,0,95,群益金鼎-松山,2023-12-14,9103
9945,潤泰新,92,0,92,群益金鼎-松山,2023-12-14,9103
2891,中信金,100,25,75,群益金鼎-松山,2023-12-14,9103
2615,萬海,60,0,60,群益金鼎-松山,2023-12-14,9103
00679B,元大美債20年,59,0,59,群益金鼎-松山,2023-12-14,9103
2881,富邦金,60,9,51,群益金鼎-松山,2023-12-14,9103
1905,華紙,55,5,50,群益金鼎-松山,2023-12-14,9103
3005,神基,51,3,48,群益金鼎-松山,2023-12-14,9103
3325,旭品,46,0,46,群益金鼎-松山,2023-12-14,9103
00919,群益台灣精選高息,56,12,44,群益金鼎-松山,2023-12-14,9103
3290,東浦,40,0,40,群益金鼎-松山,2023-12-14,9103
3211,順達,40,0,40,群益金鼎-松山,2023-12-14,9103
5425,台半,42,3,39,群益金鼎-松山,2023-12-14,9103
00632R,元大台灣50反1,38,0,38,群益金鼎-松山,2023-12-14,9103
2882,國泰金,75,40,35,群益金鼎-松山,2023-12-14,9103
3260,威剛,40,6,34,群益金鼎-松山,2023-12-14,9103
2606,裕民,31,0,31,群益金鼎-松山,2023-12-14,9103
00751B,元大AAA至A公司債,30,0,30,群益金鼎-松山,2023-12-14,9103
2812,台中銀,30,0,30,群益金鼎-松山,2023-12-14,9103
3265,台星科,30,0,30,群益金鼎-松山,2023-12-14,9103
8096,擎亞,30,1,29,群益金鼎-松山,2023-12-14,9103
1325,恆大,27,0,27,群益金鼎-松山,2023-12-14,9103
00878,國泰永續高股息,30,3,27,群益金鼎-松山,2023-12-14,9103
3712,永崴投控,41,14,27,群益金鼎-松山,2023-12-14,9103
00687B,國泰20年美債,36,13,23,群益金鼎-松山,2023-12-14,9103
2449,京元電子,37,16,21,群益金鼎-松山,2023-12-14,9103
1342,八貫,20,0,20,群益金鼎-松山,2023-12-14,9103
5347,世界,20,0,20,群益金鼎-松山,2023-12-14,9103
00929,復華台灣科技優息,19,0,19,群益金鼎-松山,2023-12-14,9103
1503,士電,31,12,19,群益金鼎-松山,2023-12-14,9103
5871,中租-KY,18,0,18,群益金鼎-松山,2023-12-14,9103
1413,宏洲,17,0,17,群益金鼎-松山,2023-12-14,9103
1906,寶隆,16,0,16,群益金鼎-松山,2023-12-14,9103
1531,高林股,15,0,15,群益金鼎-松山,2023-12-14,9103
1474,弘裕,13,0,13,群益金鼎-松山,2023-12-14,9103
2025,千興,13,0,13,群益金鼎-松山,2023-12-14,9103
6789,采鈺,13,0,13,群益金鼎-松山,2023-12-14,9103
2387,精元,11,0,11,群益金鼎-松山,2023-12-14,9103
2107,厚生,11,0,11,群益金鼎-松山,2023-12-14,9103
3025,星通,13,3,10,群益金鼎-松山,2023-12-14,9103
00680L,元大美債20正2,10,0,10,群益金鼎-松山,2023-12-14,9103
00891,中信關鍵半導體,10,0,10,群益金鼎-松山,2023-12-14,9103
2109,華豐,10,0,10,群益金鼎-松山,2023-12-14,9103
2511,太子,10,0,10,群益金鼎-松山,2023-12-14,9103
2641,正德,15,5,10,群益金鼎-松山,2023-12-14,9103
2887,台新金,10,0,10,群益金鼎-松山,2023-12-14,9103
9105,泰金寶-DR,10,0,10,群益金鼎-松山,2023-12-14,9103
1455,集盛,9,0,9,群益金鼎-松山,2023-12-14,9103
2515,中工,501,200,301,群益金鼎-松山,2023-12-15,9103
6443,元晶,238,2,236,群益金鼎-松山,2023-12-15,9103
3374,精材,179,10,169,群益金鼎-松山,2023-12-15,9103
00937B,群益ESG投等債20,100,25,75,群益金鼎-松山,2023-12-15,9103
9105,泰金寶-DR,50,0,50,群益金鼎-松山,2023-12-15,9103
4908,前鼎,52,3,49,群益金鼎-松山,2023-12-15,9103
2356,英業達,87,48,39,群益金鼎-松山,2023-12-15,9103
00679B,元大美債20年,36,1,35,群益金鼎-松山,2023-12-15,9103
2516,新建,33,0,33,群益金鼎-松山,2023-12-15,9103
00720B,元大投資級公司債,30,0,30,群益金鼎-松山,2023-12-15,9103
2009,第一銅,30,0,30,群益金鼎-松山,2023-12-15,9103
2530,華建,30,0,30,群益金鼎-松山,2023-12-15,9103
2371,大同,25,0,25,群益金鼎-松山,2023-12-15,9103
3707,漢磊,20,0,20,群益金鼎-松山,2023-12-15,9103
3712,永崴投控,20,0,20,群益金鼎-松山,2023-12-15,9103
6164,華興,20,0,20,群益金鼎-松山,2023-12-15,9103
3231,緯創,17,0,17,群益金鼎-松山,2023-12-15,9103
00929,復華台灣科技優息,17,2,15,群益金鼎-松山,2023-12-15,9103
00935,野村臺灣新科技50,15,0,15,群益金鼎-松山,2023-12-15,9103
2201,裕隆,15,1,14,群益金鼎-松山,2023-12-15,9103
3390,旭軟,13,0,13,群益金鼎-松山,2023-12-15,9103
3702,大聯大,12,0,12,群益金鼎-松山,2023-12-15,9103
2388,威盛,15,3,12,群益金鼎-松山,2023-12-15,9103
2382,廣達,12,1,11,群益金鼎-松山,2023-12-15,9103
3715,定穎投控,12,1,11,群益金鼎-松山,2023-12-15,9103
8433,弘帆,13,2,11,群益金鼎-松山,2023-12-15,9103
00696B,富邦美債20年,10,0,10,群益金鼎-松山,2023-12-15,9103
3321,同泰,10,0,10,群益金鼎-松山,2023-12-15,9103
2314,台揚,9,0,9,群益金鼎-松山,2023-12-15,9103
3006,晶豪科,21,12,9,群益金鼎-松山,2023-12-15,9103
2949,欣新網,9,1,8,群益金鼎-松山,2023-12-15,9103
5014,建錩,8,0,8,群益金鼎-松山,2023-12-15,9103
9958,世紀鋼,14,7,7,群益金鼎-松山,2023-12-15,9103
00632R,元大台灣50反1,6,0,6,群益金鼎-松山,2023-12-15,9103
00857B,永豐20年美公債,6,0,6,群益金鼎-松山,2023-12-15,9103
2002,中鋼,6,0,6,群益金鼎-松山,2023-12-15,9103
2421,建準,6,0,6,群益金鼎-松山,2023-12-15,9103
5904,寶雅,6,0,6,群益金鼎-松山,2023-12-15,9103
6140,訊達,6,0,6,群益金鼎-松山,2023-12-15,9103
3059,華晶科,7,2,5,群益金鼎-松山,2023-12-15,9103
1560,中砂,5,0,5,群益金鼎-松山,2023-12-15,9103
2723,美食-KY,5,0,5,群益金鼎-松山,2023-12-15,9103
3163,波若威,5,0,5,群益金鼎-松山,2023-12-15,9103
5222,全訊,5,0,5,群益金鼎-松山,2023-12-15,9103
6695,芯鼎,5,0,5,群益金鼎-松山,2023-12-15,9103
2352,佳世達,4,0,4,群益金鼎-松山,2023-12-15,9103
00900,富邦特選高股息30,4,0,4,群益金鼎-松山,2023-12-15,9103
00636,國泰中國A50,4,0,4,群益金鼎-松山,2023-12-15,9103
3014,聯陽,6,2,4,群益金鼎-松山,2023-12-15,9103
6127,九豪,12,8,4,群益金鼎-松山,2023-12-15,9103
2014,中鴻,210,10,200,群益金鼎-松山,2023-12-18,9103
00929,復華台灣科技優息,136,25,111,群益金鼎-松山,2023-12-18,9103
00715L,期街口布蘭特正2,100,0,100,群益金鼎-松山,2023-12-18,9103
9103,美德醫療-DR,100,0,100,群益金鼎-松山,2023-12-18,9103
2353,宏��,103,5,98,群益金鼎-松山,2023-12-18,9103
2324,仁寶,97,5,92,群益金鼎-松山,2023-12-18,9103
00680L,元大美債20正2,106,20,86,群益金鼎-松山,2023-12-18,9103
2516,新建,100,23,77,群益金鼎-松山,2023-12-18,9103
2007,燁興,70,0,70,群益金鼎-松山,2023-12-18,9103
2002,中鋼,61,4,57,群益金鼎-松山,2023-12-18,9103
6164,華興,54,0,54,群益金鼎-松山,2023-12-18,9103
2027,大成鋼,50,0,50,群益金鼎-松山,2023-12-18,9103
00933B,國泰10Y+金融債,50,0,50,群益金鼎-松山,2023-12-18,9103
2010,春源,50,0,50,群益金鼎-松山,2023-12-18,9103
2028,威致,102,52,50,群益金鼎-松山,2023-12-18,9103
2641,正德,53,3,50,群益金鼎-松山,2023-12-18,9103
5608,四維航,50,0,50,群益金鼎-松山,2023-12-18,9103
9919,康那香,126,77,49,群益金鼎-松山,2023-12-18,9103
2023,燁輝,201,154,47,群益金鼎-松山,2023-12-18,9103
3006,晶豪科,120,81,39,群益金鼎-松山,2023-12-18,9103
00919,群益台灣精選高息,35,0,35,群益金鼎-松山,2023-12-18,9103
6546,正基,40,13,27,群益金鼎-松山,2023-12-18,9103
2603,長榮,28,4,24,群益金鼎-松山,2023-12-18,9103
2030,彰源,50,30,20,群益金鼎-松山,2023-12-18,9103
2375,凱美,20,0,20,群益金鼎-松山,2023-12-18,9103
2612,中航,20,0,20,群益金鼎-松山,2023-12-18,9103
00688L,國泰20年美債正2,17,0,17,群益金鼎-松山,2023-12-18,9103
6485,點序,16,0,16,群益金鼎-松山,2023-12-18,9103
4306,炎洲,16,0,16,群益金鼎-松山,2023-12-18,9103
2356,英業達,15,0,15,群益金鼎-松山,2023-12-18,9103
5425,台半,15,1,14,群益金鼎-松山,2023-12-18,9103
1325,恆大,30,17,13,群益金鼎-松山,2023-12-18,9103
00931B,統一美債20年,16,4,12,群益金鼎-松山,2023-12-18,9103
1217,愛之味,10,0,10,群益金鼎-松山,2023-12-18,9103
2606,裕民,10,0,10,群益金鼎-松山,2023-12-18,9103
3432,台端,10,0,10,群益金鼎-松山,2023-12-18,9103
6239,力成,10,0,10,群益金鼎-松山,2023-12-18,9103
6657,華安,10,0,10,群益金鼎-松山,2023-12-18,9103
1605,華新,16,8,8,群益金鼎-松山,2023-12-18,9103
2303,聯電,10,3,7,群益金鼎-松山,2023-12-18,9103
1465,偉全,7,0,7,群益金鼎-松山,2023-12-18,9103
1413,宏洲,7,0,7,群益金鼎-松山,2023-12-18,9103
2809,京城銀,7,0,7,群益金鼎-松山,2023-12-18,9103
3231,緯創,8,1,7,群益金鼎-松山,2023-12-18,9103
6244,茂迪,7,0,7,群益金鼎-松山,2023-12-18,9103
00751B,元大AAA至A公司債,6,0,6,群益金鼎-松山,2023-12-18,9103
2465,麗臺,6,0,6,群益金鼎-松山,2023-12-18,9103
2888,新光金,6,0,6,群益金鼎-松山,2023-12-18,9103
3532,台勝科,6,0,6,群益金鼎-松山,2023-12-18,9103
1513,中興電,5,0,5,群益金鼎-松山,2023-12-18,9103
2515,中工,113,8,105,群益金鼎-松山,2023-12-19,9103
5521,工信,100,5,95,群益金鼎-松山,2023-12-19,9103
2038,海光,55,0,55,群益金鼎-松山,2023-12-19,9103
2615,萬海,90,40,50,群益金鼎-松山,2023-12-19,9103
6164,華興,50,0,50,群益金鼎-松山,2023-12-19,9103
5222,全訊,48,0,48,群益金鼎-松山,2023-12-19,9103
4908,前鼎,44,8,36,群益金鼎-松山,2023-12-19,9103
2032,新鋼,50,20,30,群益金鼎-松山,2023-12-19,9103
1605,華新,33,8,25,群益金鼎-松山,2023-12-19,9103
5469,瀚宇博,20,0,20,群益金鼎-松山,2023-12-19,9103
00687B,國泰20年美債,20,0,20,群益金鼎-松山,2023-12-19,9103
2031,新光鋼,23,3,20,群益金鼎-松山,2023-12-19,9103
1413,宏洲,16,0,16,群益金鼎-松山,2023-12-19,9103
00706L,期元大S＆P日圓正2,15,0,15,群益金鼎-松山,2023-12-19,9103
1905,華紙,15,0,15,群益金鼎-松山,2023-12-19,9103
00680L,元大美債20正2,13,0,13,群益金鼎-松山,2023-12-19,9103
2609,陽明,30,19,11,群益金鼎-松山,2023-12-19,9103
3715,定穎投控,13,2,11,群益金鼎-松山,2023-12-19,9103
00688L,國泰20年美債正2,10,0,10,群益金鼎-松山,2023-12-19,9103
1465,偉全,10,0,10,群益金鼎-松山,2023-12-19,9103
1432,大魯閣,10,0,10,群益金鼎-松山,2023-12-19,9103
1531,高林股,10,0,10,群益金鼎-松山,2023-12-19,9103
3432,台端,10,0,10,群益金鼎-松山,2023-12-19,9103
5706,鳳凰,10,0,10,群益金鼎-松山,2023-12-19,9103
6156,松上,21,11,10,群益金鼎-松山,2023-12-19,9103
2025,千興,9,0,9,群益金鼎-松山,2023-12-19,9103
2607,榮運,33,24,9,群益金鼎-松山,2023-12-19,9103
5210,寶碩,10,1,9,群益金鼎-松山,2023-12-19,9103
1414,東和,8,0,8,群益金鼎-松山,2023-12-19,9103
1906,寶隆,8,0,8,群益金鼎-松山,2023-12-19,9103
2888,新光金,8,0,8,群益金鼎-松山,2023-12-19,9103
2356,英業達,7,0,7,群益金鼎-松山,2023-12-19,9103
1455,集盛,6,0,6,群益金鼎-松山,2023-12-19,9103
1582,信錦,7,1,6,群益金鼎-松山,2023-12-19,9103
2442,新美齊,6,0,6,群益金鼎-松山,2023-12-19,9103
2511,太子,6,0,6,群益金鼎-松山,2023-12-19,9103
3532,台勝科,6,0,6,群益金鼎-松山,2023-12-19,9103
3042,晶技,5,0,5,群益金鼎-松山,2023-12-19,9103
00937B,群益ESG投等債20,5,0,5,群益金鼎-松山,2023-12-19,9103
1709,和益,5,0,5,群益金鼎-松山,2023-12-19,9103
2109,華豐,5,0,5,群益金鼎-松山,2023-12-19,9103
2301,光寶科,5,0,5,群益金鼎-松山,2023-12-19,9103
2323,中環,5,0,5,群益金鼎-松山,2023-12-19,9103
3511,矽瑪,5,0,5,群益金鼎-松山,2023-12-19,9103
6205,詮欣,10,5,5,群益金鼎-松山,2023-12-19,9103
6244,茂迪,5,0,5,群益金鼎-松山,2023-12-19,9103
6657,華安,5,0,5,群益金鼎-松山,2023-12-19,9103
1451,年興,4,0,4,群益金鼎-松山,2023-12-19,9103
1506,正道,4,0,4,群益金鼎-松山,2023-12-19,9103
1735,日勝化,4,0,4,群益金鼎-松山,2023-12-19,9103
2312,金寶,204,5,199,群益金鼎-松山,2023-12-20,9103
00934,中信成長高股息,167,0,167,群益金鼎-松山,2023-12-20,9103
2605,新興,130,1,129,群益金鼎-松山,2023-12-20,9103
2002,中鋼,101,0,101,群益金鼎-松山,2023-12-20,9103
2641,正德,100,0,100,群益金鼎-松山,2023-12-20,9103
5521,工信,100,0,100,群益金鼎-松山,2023-12-20,9103
8201,無敵,73,0,73,群益金鼎-松山,2023-12-20,9103
2356,英業達,129,78,51,群益金鼎-松山,2023-12-20,9103
5608,四維航,50,0,50,群益金鼎-松山,2023-12-20,9103
2392,正崴,50,1,49,群益金鼎-松山,2023-12-20,9103
2515,中工,60,12,48,群益金鼎-松山,2023-12-20,9103
2201,裕隆,43,0,43,群益金鼎-松山,2023-12-20,9103
3006,晶豪科,42,0,42,群益金鼎-松山,2023-12-20,9103
2324,仁寶,110,75,35,群益金鼎-松山,2023-12-20,9103
00696B,富邦美債20年,33,0,33,群益金鼎-松山,2023-12-20,9103
4938,和碩,33,1,32,群益金鼎-松山,2023-12-20,9103
1781,合世,25,0,25,群益金鼎-松山,2023-12-20,9103
2230,泰茂,20,0,20,群益金鼎-松山,2023-12-20,9103
2882,國泰金,20,0,20,群益金鼎-松山,2023-12-20,9103
2023,燁輝,18,0,18,群益金鼎-松山,2023-12-20,9103
00929,復華台灣科技優息,15,0,15,群益金鼎-松山,2023-12-20,9103
4908,前鼎,54,39,15,群益金鼎-松山,2023-12-20,9103
2748,雲品,14,0,14,群益金鼎-松山,2023-12-20,9103
8028,昇陽半導體,12,0,12,群益金鼎-松山,2023-12-20,9103
00637L,元大滬深300正2,10,0,10,群益金鼎-松山,2023-12-20,9103
00753L,中信中國50正2,10,0,10,群益金鼎-松山,2023-12-20,9103
1432,大魯閣,10,0,10,群益金鼎-松山,2023-12-20,9103
2020,美亞,10,0,10,群益金鼎-松山,2023-12-20,9103
2913,農林,10,0,10,群益金鼎-松山,2023-12-20,9103
2353,宏��,61,52,9,群益金鼎-松山,2023-12-20,9103
8054,安國,14,5,9,群益金鼎-松山,2023-12-20,9103
1474,弘裕,8,0,8,群益金鼎-松山,2023-12-20,9103
1414,東和,8,0,8,群益金鼎-松山,2023-12-20,9103
3105,穩懋,16,8,8,群益金鼎-松山,2023-12-20,9103
4979,華星光,9,1,8,群益金鼎-松山,2023-12-20,9103
8085,福華,10,2,8,群益金鼎-松山,2023-12-20,9103
3081,聯亞,7,0,7,群益金鼎-松山,2023-12-20,9103
5515,建國,7,0,7,群益金鼎-松山,2023-12-20,9103
2542,興富發,6,0,6,群益金鼎-松山,2023-12-20,9103
2607,榮運,6,0,6,群益金鼎-松山,2023-12-20,9103
00706L,期元大S＆P日圓正2,5,0,5,群益金鼎-松山,2023-12-20,9103
3444,利機,5,0,5,群益金鼎-松山,2023-12-20,9103
3707,漢磊,5,0,5,群益金鼎-松山,2023-12-20,9103
5236,凌陽創新,5,0,5,群益金鼎-松山,2023-12-20,9103
5478,智冠,5,0,5,群益金鼎-松山,2023-12-20,9103
1413,宏洲,4,0,4,群益金鼎-松山,2023-12-20,9103
2636,台驊控股,5,1,4,群益金鼎-松山,2023-12-20,9103
4545,銘鈺,4,0,4,群益金鼎-松山,2023-12-20,9103
6278,台表科,8,4,4,群益金鼎-松山,2023-12-20,9103
1616,億泰,3,0,3,群益金鼎-松山,2023-12-20,9103
1314,中石化,263,134,129,群益金鼎-松山,2023-12-21,9103
2324,仁寶,124,18,106,群益金鼎-松山,2023-12-21,9103
5521,工信,101,0,101,群益金鼎-松山,2023-12-21,9103
2353,宏��,112,51,61,群益金鼎-松山,2023-12-21,9103
9929,秋雨,60,0,60,群益金鼎-松山,2023-12-21,9103
6164,華興,100,50,50,群益金鼎-松山,2023-12-21,9103
2007,燁興,50,0,50,群益金鼎-松山,2023-12-21,9103
00696B,富邦美債20年,33,0,33,群益金鼎-松山,2023-12-21,9103
2312,金寶,32,0,32,群益金鼎-松山,2023-12-21,9103
2371,大同,30,0,30,群益金鼎-松山,2023-12-21,9103
8088,品安,30,0,30,群益金鼎-松山,2023-12-21,9103
2362,藍天,30,2,28,群益金鼎-松山,2023-12-21,9103
00900,富邦特選高股息30,25,0,25,群益金鼎-松山,2023-12-21,9103
2014,中鴻,40,15,25,群益金鼎-松山,2023-12-21,9103
3006,晶豪科,25,0,25,群益金鼎-松山,2023-12-21,9103
3231,緯創,34,10,24,群益金鼎-松山,2023-12-21,9103
2027,大成鋼,20,0,20,群益金鼎-松山,2023-12-21,9103
2882,國泰金,20,0,20,群益金鼎-松山,2023-12-21,9103
9105,泰金寶-DR,20,0,20,群益金鼎-松山,2023-12-21,9103
00919,群益台灣精選高息,14,0,14,群益金鼎-松山,2023-12-21,9103
3081,聯亞,14,0,14,群益金鼎-松山,2023-12-21,9103
00929,復華台灣科技優息,13,0,13,群益金鼎-松山,2023-12-21,9103
8054,安國,32,19,13,群益金鼎-松山,2023-12-21,9103
00937B,群益ESG投等債20,11,0,11,群益金鼎-松山,2023-12-21,9103
3432,台端,10,0,10,群益金鼎-松山,2023-12-21,9103
2330,台積電,10,0,10,群益金鼎-松山,2023-12-21,9103
6138,茂達,9,0,9,群益金鼎-松山,2023-12-21,9103
2603,長榮,14,6,8,群益金鼎-松山,2023-12-21,9103
00715L,期街口布蘭特正2,8,0,8,群益金鼎-松山,2023-12-21,9103
00936,台新永續高息中小,7,0,7,群益金鼎-松山,2023-12-21,9103
9958,世紀鋼,9,2,7,群益金鼎-松山,2023-12-21,9103
1907,永豐餘,8,2,6,群益金鼎-松山,2023-12-21,9103
2344,華邦電,6,0,6,群益金鼎-松山,2023-12-21,9103
3011,今皓,6,0,6,群益金鼎-松山,2023-12-21,9103
6156,松上,10,4,6,群益金鼎-松山,2023-12-21,9103
00850,元大臺灣ESG永續,5,0,5,群益金鼎-松山,2023-12-21,9103
00665L,富邦�琤肭磪囓�2,5,0,5,群益金鼎-松山,2023-12-21,9103
00918,大華優利高填息30,5,0,5,群益金鼎-松山,2023-12-21,9103
2636,台驊控股,13,8,5,群益金鼎-松山,2023-12-21,9103
2913,農林,5,0,5,群益金鼎-松山,2023-12-21,9103
3017,奇鋐,5,0,5,群益金鼎-松山,2023-12-21,9103
3042,晶技,8,3,5,群益金鼎-松山,2023-12-21,9103
3694,海華,5,0,5,群益金鼎-松山,2023-12-21,9103
4908,前鼎,12,7,5,群益金鼎-松山,2023-12-21,9103
5425,台半,5,0,5,群益金鼎-松山,2023-12-21,9103
5880,合庫金,5,0,5,群益金鼎-松山,2023-12-21,9103
6244,茂迪,5,0,5,群益金鼎-松山,2023-12-21,9103
3035,智原,14,10,4,群益金鼎-松山,2023-12-21,9103
1582,信錦,4,0,4,群益金鼎-松山,2023-12-21,9103
2801,彰銀,4,0,4,群益金鼎-松山,2023-12-21,9103
6116,彩晶,100,0,100,群益金鼎-松山,2023-12-22,9103
2515,中工,101,5,96,群益金鼎-松山,2023-12-22,9103
8054,安國,88,26,62,群益金鼎-松山,2023-12-22,9103
6462,神盾,51,1,50,群益金鼎-松山,2023-12-22,9103
2324,仁寶,136,91,45,群益金鼎-松山,2023-12-22,9103
3006,晶豪科,48,4,44,群益金鼎-松山,2023-12-22,9103
6799,來頡,33,1,32,群益金鼎-松山,2023-12-22,9103
2618,長榮航,40,10,30,群益金鼎-松山,2023-12-22,9103
2605,新興,30,0,30,群益金鼎-松山,2023-12-22,9103
00687B,國泰20年美債,29,0,29,群益金鼎-松山,2023-12-22,9103
00919,群益台灣精選高息,28,0,28,群益金鼎-松山,2023-12-22,9103
5222,全訊,27,0,27,群益金鼎-松山,2023-12-22,9103
6231,系微,31,5,26,群益金鼎-松山,2023-12-22,9103
1325,恆大,20,1,19,群益金鼎-松山,2023-12-22,9103
2031,新光鋼,18,0,18,群益金鼎-松山,2023-12-22,9103
6243,迅杰,24,6,18,群益金鼎-松山,2023-12-22,9103
3231,緯創,16,1,15,群益金鼎-松山,2023-12-22,9103
3178,公準,14,0,14,群益金鼎-松山,2023-12-22,9103
2353,宏��,85,73,12,群益金鼎-松山,2023-12-22,9103
1591,駿吉-KY,10,0,10,群益金鼎-松山,2023-12-22,9103
2882,國泰金,10,0,10,群益金鼎-松山,2023-12-22,9103
2883,凱基金,10,0,10,群益金鼎-松山,2023-12-22,9103
4908,前鼎,25,15,10,群益金鼎-松山,2023-12-22,9103
6168,宏齊,10,0,10,群益金鼎-松山,2023-12-22,9103
6205,詮欣,14,4,10,群益金鼎-松山,2023-12-22,9103
2344,華邦電,11,2,9,群益金鼎-松山,2023-12-22,9103
4906,正文,10,1,9,群益金鼎-松山,2023-12-22,9103
2355,敬鵬,19,12,7,群益金鼎-松山,2023-12-22,9103
2610,華航,26,19,7,群益金鼎-松山,2023-12-22,9103
3532,台勝科,7,0,7,群益金鼎-松山,2023-12-22,9103
4909,新復興,9,3,6,群益金鼎-松山,2023-12-22,9103
4968,立積,28,22,6,群益金鼎-松山,2023-12-22,9103
6111,大宇資,6,0,6,群益金鼎-松山,2023-12-22,9103
8088,品安,9,3,6,群益金鼎-松山,2023-12-22,9103
00632R,元大台灣50反1,5,0,5,群益金鼎-松山,2023-12-22,9103
00665L,富邦�琤肭磪囓�2,5,0,5,群益金鼎-松山,2023-12-22,9103
2201,裕隆,9,4,5,群益金鼎-松山,2023-12-22,9103
2520,冠德,5,0,5,群益金鼎-松山,2023-12-22,9103
2641,正德,55,50,5,群益金鼎-松山,2023-12-22,9103
3374,精材,5,0,5,群益金鼎-松山,2023-12-22,9103
5534,長虹,5,0,5,群益金鼎-松山,2023-12-22,9103
1808,潤隆,4,0,4,群益金鼎-松山,2023-12-22,9103
5009,榮剛,4,0,4,群益金鼎-松山,2023-12-22,9103
5439,高技,5,1,4,群益金鼎-松山,2023-12-22,9103
5515,建國,4,0,4,群益金鼎-松山,2023-12-22,9103
6278,台表科,4,0,4,群益金鼎-松山,2023-12-22,9103
6719,力智,4,0,4,群益金鼎-松山,2023-12-22,9103
2313,華通,12,9,3,群益金鼎-松山,2023-12-22,9103
2250,IKKA-KY,3,0,3,群益金鼎-松山,2023-12-22,9103
4967,十銓,5,2,3,群益金鼎-松山,2023-12-22,9103
3481,群創,462,3,459,群益金鼎-松山,2023-12-25,9103
5521,工信,202,1,201,群益金鼎-松山,2023-12-25,9103
00929,復華台灣科技優息,155,0,155,群益金鼎-松山,2023-12-25,9103
2353,宏��,160,86,74,群益金鼎-松山,2023-12-25,9103
3231,緯創,86,22,64,群益金鼎-松山,2023-12-25,9103
00919,群益台灣精選高息,38,0,38,群益金鼎-松山,2023-12-25,9103
8088,品安,32,1,31,群益金鼎-松山,2023-12-25,9103
2031,新光鋼,21,0,21,群益金鼎-松山,2023-12-25,9103
2356,英業達,28,7,21,群益金鼎-松山,2023-12-25,9103
00891,中信關鍵半導體,20,0,20,群益金鼎-松山,2023-12-25,9103
6237,驊訊,29,11,18,群益金鼎-松山,2023-12-25,9103
00937B,群益ESG投等債20,20,3,17,群益金鼎-松山,2023-12-25,9103
2603,長榮,20,6,14,群益金鼎-松山,2023-12-25,9103
2331,精英,12,0,12,群益金鼎-松山,2023-12-25,9103
3479,安勤,13,1,12,群益金鼎-松山,2023-12-25,9103
1514,亞力,28,17,11,群益金鼎-松山,2023-12-25,9103
1503,士電,11,1,10,群益金鼎-松山,2023-12-25,9103
1432,大魯閣,10,0,10,群益金鼎-松山,2023-12-25,9103
2027,大成鋼,10,0,10,群益金鼎-松山,2023-12-25,9103
2332,友訊,10,0,10,群益金鼎-松山,2023-12-25,9103
2516,新建,10,0,10,群益金鼎-松山,2023-12-25,9103
2882,國泰金,10,0,10,群益金鼎-松山,2023-12-25,9103
3706,神達,10,0,10,群益金鼎-松山,2023-12-25,9103
8099,大世科,10,0,10,群益金鼎-松山,2023-12-25,9103
2615,萬海,101,93,8,群益金鼎-松山,2023-12-25,9103
1312,國喬,10,2,8,群益金鼎-松山,2023-12-25,9103
2465,麗臺,8,0,8,群益金鼎-松山,2023-12-25,9103
00679B,元大美債20年,7,0,7,群益金鼎-松山,2023-12-25,9103
00715L,期街口布蘭特正2,7,0,7,群益金鼎-松山,2023-12-25,9103
5222,全訊,7,0,7,群益金鼎-松山,2023-12-25,9103
1720,生達,6,0,6,群益金鼎-松山,2023-12-25,9103
3217,優群,6,0,6,群益金鼎-松山,2023-12-25,9103
3264,欣銓,7,1,6,群益金鼎-松山,2023-12-25,9103
1305,華夏,5,0,5,群益金鼎-松山,2023-12-25,9103
00918,大華優利高填息30,5,0,5,群益金鼎-松山,2023-12-25,9103
2913,農林,5,0,5,群益金鼎-松山,2023-12-25,9103
6117,迎廣,11,6,5,群益金鼎-松山,2023-12-25,9103
3540,曜越,4,0,4,群益金鼎-松山,2023-12-25,9103
2250,IKKA-KY,4,0,4,群益金鼎-松山,2023-12-25,9103
2405,輔信,6,2,4,群益金鼎-松山,2023-12-25,9103
2606,裕民,44,40,4,群益金鼎-松山,2023-12-25,9103
2618,長榮航,4,0,4,群益金鼎-松山,2023-12-25,9103
3081,聯亞,4,0,4,群益金鼎-松山,2023-12-25,9103
8349,�矬�,6,2,4,群益金鼎-松山,2023-12-25,9103
8936,國統,4,0,4,群益金鼎-松山,2023-12-25,9103
00632R,元大台灣50反1,3,0,3,群益金鼎-松山,2023-12-25,9103
2313,華通,11,8,3,群益金鼎-松山,2023-12-25,9103
2421,建準,7,4,3,群益金鼎-松山,2023-12-25,9103
2637,慧洋-KY,3,0,3,群益金鼎-松山,2023-12-25,9103
3037,欣興,3,0,3,群益金鼎-松山,2023-12-25,9103
2409,友達,601,11,590,群益金鼎-松山,2023-12-26,9103
00878,國泰永續高股息,300,15,285,群益金鼎-松山,2023-12-26,9103
00934,中信成長高股息,200,0,200,群益金鼎-松山,2023-12-26,9103
6116,彩晶,100,0,100,群益金鼎-松山,2023-12-26,9103
2605,新興,50,0,50,群益金鼎-松山,2023-12-26,9103
2641,正德,50,0,50,群益金鼎-松山,2023-12-26,9103
6164,華興,50,0,50,群益金鼎-松山,2023-12-26,9103
2356,英業達,44,11,33,群益金鼎-松山,2023-12-26,9103
2377,微星,32,1,31,群益金鼎-松山,2023-12-26,9103
5608,四維航,30,0,30,群益金鼎-松山,2023-12-26,9103
4961,天鈺,23,0,23,群益金鼎-松山,2023-12-26,9103
8089,康全電訊,23,1,22,群益金鼎-松山,2023-12-26,9103
00936,台新永續高息中小,22,0,22,群益金鼎-松山,2023-12-26,9103
1582,信錦,21,0,21,群益金鼎-松山,2023-12-26,9103
00937B,群益ESG投等債20,21,0,21,群益金鼎-松山,2023-12-26,9103
3231,緯創,22,4,18,群益金鼎-松山,2023-12-26,9103
3042,晶技,20,3,17,群益金鼎-松山,2023-12-26,9103
3006,晶豪科,23,8,15,群益金鼎-松山,2023-12-26,9103
4919,新唐,15,0,15,群益金鼎-松山,2023-12-26,9103
5203,訊連,12,0,12,群益金鼎-松山,2023-12-26,9103
6143,振曜,12,0,12,群益金鼎-松山,2023-12-26,9103
00680L,元大美債20正2,10,0,10,群益金鼎-松山,2023-12-26,9103
00929,復華台灣科技優息,21,11,10,群益金鼎-松山,2023-12-26,9103
5521,工信,10,0,10,群益金鼎-松山,2023-12-26,9103
6546,正基,10,0,10,群益金鼎-松山,2023-12-26,9103
2388,威盛,13,4,9,群益金鼎-松山,2023-12-26,9103
00885,富邦越南,8,0,8,群益金鼎-松山,2023-12-26,9103
2465,麗臺,8,0,8,群益金鼎-松山,2023-12-26,9103
6285,啟��,9,1,8,群益金鼎-松山,2023-12-26,9103
1312,國喬,8,0,8,群益金鼎-松山,2023-12-26,9103
2610,華航,7,0,7,群益金鼎-松山,2023-12-26,9103
1519,華城,7,2,5,群益金鼎-松山,2023-12-26,9103
2408,南亞科,5,0,5,群益金鼎-松山,2023-12-26,9103
3346,麗清,5,0,5,群益金鼎-松山,2023-12-26,9103
3017,奇鋐,5,0,5,群益金鼎-松山,2023-12-26,9103
00632R,元大台灣50反1,4,0,4,群益金鼎-松山,2023-12-26,9103
6245,立端,4,0,4,群益金鼎-松山,2023-12-26,9103
6576,逸達,4,0,4,群益金鼎-松山,2023-12-26,9103
2382,廣達,3,0,3,群益金鼎-松山,2023-12-26,9103
3380,明泰,9,6,3,群益金鼎-松山,2023-12-26,9103
6196,帆宣,3,0,3,群益金鼎-松山,2023-12-26,9103
1584,精剛,5,2,3,群益金鼎-松山,2023-12-26,9103
00882,中信中國高股息,3,0,3,群益金鼎-松山,2023-12-26,9103
2109,華豐,3,0,3,群益金鼎-松山,2023-12-26,9103
2402,毅嘉,3,0,3,群益金鼎-松山,2023-12-26,9103
3019,亞光,8,5,3,群益金鼎-松山,2023-12-26,9103
3479,安勤,17,14,3,群益金鼎-松山,2023-12-26,9103
3511,矽瑪,3,0,3,群益金鼎-松山,2023-12-26,9103
3645,達邁,3,0,3,群益金鼎-松山,2023-12-26,9103
5483,中美晶,6,3,3,群益金鼎-松山,2023-12-26,9103
00935,野村臺灣新科技50,208,0,208,群益金鼎-松山,2023-12-27,9103
3338,泰碩,100,0,100,群益金鼎-松山,2023-12-27,9103
00937B,群益ESG投等債20,66,2,64,群益金鼎-松山,2023-12-27,9103
4906,正文,52,0,52,群益金鼎-松山,2023-12-27,9103
4938,和碩,49,1,48,群益金鼎-松山,2023-12-27,9103
3694,海華,29,1,28,群益金鼎-松山,2023-12-27,9103
2353,宏��,59,32,27,群益金鼎-松山,2023-12-27,9103
2324,仁寶,94,68,26,群益金鼎-松山,2023-12-27,9103
2867,三商壽,20,0,20,群益金鼎-松山,2023-12-27,9103
6164,華興,20,0,20,群益金鼎-松山,2023-12-27,9103
2356,英業達,68,50,18,群益金鼎-松山,2023-12-27,9103
5347,世界,39,22,17,群益金鼎-松山,2023-12-27,9103
00632R,元大台灣50反1,12,0,12,群益金鼎-松山,2023-12-27,9103
3093,港建*,12,0,12,群益金鼎-松山,2023-12-27,9103
1582,信錦,11,0,11,群益金鼎-松山,2023-12-27,9103
1815,富喬,10,0,10,群益金鼎-松山,2023-12-27,9103
00885,富邦越南,10,0,10,群益金鼎-松山,2023-12-27,9103
2340,台亞,10,0,10,群益金鼎-松山,2023-12-27,9103
2515,中工,10,0,10,群益金鼎-松山,2023-12-27,9103
6546,正基,10,0,10,群益金鼎-松山,2023-12-27,9103
8049,晶采,10,0,10,群益金鼎-松山,2023-12-27,9103
8433,弘帆,10,0,10,群益金鼎-松山,2023-12-27,9103
3390,旭軟,9,0,9,群益金鼎-松山,2023-12-27,9103
3013,晟銘電,8,0,8,群益金鼎-松山,2023-12-27,9103
9958,世紀鋼,9,1,8,群益金鼎-松山,2023-12-27,9103
5210,寶碩,7,0,7,群益金鼎-松山,2023-12-27,9103
5515,建國,7,0,7,群益金鼎-松山,2023-12-27,9103
00719B,元大美債1-3,6,0,6,群益金鼎-松山,2023-12-27,9103
6799,來頡,6,0,6,群益金鼎-松山,2023-12-27,9103
6901,鑽石投資,6,0,6,群益金鼎-松山,2023-12-27,9103
2609,陽明,7,1,6,群益金鼎-松山,2023-12-27,9103
2636,台驊控股,5,0,5,群益金鼎-松山,2023-12-27,9103
1513,中興電,5,0,5,群益金鼎-松山,2023-12-27,9103
1618,合機,5,0,5,群益金鼎-松山,2023-12-27,9103
00757,統一FANG+,5,0,5,群益金鼎-松山,2023-12-27,9103
00713,元大台灣高息低波,5,0,5,群益金鼎-松山,2023-12-27,9103
2250,IKKA-KY,5,0,5,群益金鼎-松山,2023-12-27,9103
2337,旺宏,7,2,5,群益金鼎-松山,2023-12-27,9103
2501,國建,5,0,5,群益金鼎-松山,2023-12-27,9103
3006,晶豪科,8,3,5,群益金鼎-松山,2023-12-27,9103
6443,元晶,15,10,5,群益金鼎-松山,2023-12-27,9103
8349,�矬�,7,2,5,群益金鼎-松山,2023-12-27,9103
6679,鈺太,4,0,4,群益金鼎-松山,2023-12-27,9103
00680L,元大美債20正2,4,0,4,群益金鼎-松山,2023-12-27,9103
3228,金麗科,4,0,4,群益金鼎-松山,2023-12-27,9103
3624,光頡,4,0,4,群益金鼎-松山,2023-12-27,9103
6245,立端,4,0,4,群益金鼎-松山,2023-12-27,9103
3105,穩懋,4,1,3,群益金鼎-松山,2023-12-27,9103
5483,中美晶,4,1,3,群益金鼎-松山,2023-12-27,9103
5534,長虹,3,0,3,群益金鼎-松山,2023-12-27,9103
00680L,元大美債20正2,300,100,200,群益金鼎-松山,2023-12-28,9103
00665L,富邦�琤肭磪囓�2,100,0,100,群益金鼎-松山,2023-12-28,9103
3450,聯鈞,110,11,99,群益金鼎-松山,2023-12-28,9103
1513,中興電,95,5,90,群益金鼎-松山,2023-12-28,9103
1815,富喬,72,0,72,群益金鼎-松山,2023-12-28,9103
3706,神達,135,76,59,群益金鼎-松山,2023-12-28,9103
8936,國統,32,0,32,群益金鼎-松山,2023-12-28,9103
2303,聯電,86,56,30,群益金鼎-松山,2023-12-28,9103
2007,燁興,30,0,30,群益金鼎-松山,2023-12-28,9103
2436,偉詮電,29,0,29,群益金鼎-松山,2023-12-28,9103
9945,潤泰新,30,2,28,群益金鼎-松山,2023-12-28,9103
00918,大華優利高填息30,23,0,23,群益金鼎-松山,2023-12-28,9103
00655L,國泰中國A50正2,20,0,20,群益金鼎-松山,2023-12-28,9103
2009,第一銅,20,0,20,群益金鼎-松山,2023-12-28,9103
2014,中鴻,20,0,20,群益金鼎-松山,2023-12-28,9103
2606,裕民,20,0,20,群益金鼎-松山,2023-12-28,9103
3576,聯合再生,20,0,20,群益金鼎-松山,2023-12-28,9103
5324,士開,20,0,20,群益金鼎-松山,2023-12-28,9103
6719,力智,23,3,20,群益金鼎-松山,2023-12-28,9103
4979,華星光,35,18,17,群益金鼎-松山,2023-12-28,9103
00900,富邦特選高股息30,15,0,15,群益金鼎-松山,2023-12-28,9103
1514,亞力,27,12,15,群益金鼎-松山,2023-12-28,9103
6415,矽力*-KY,16,1,15,群益金鼎-松山,2023-12-28,9103
1529,樂事綠能,16,2,14,群益金鼎-松山,2023-12-28,9103
8039,台虹,15,1,14,群益金鼎-松山,2023-12-28,9103
00937B,群益ESG投等債20,11,0,11,群益金鼎-松山,2023-12-28,9103
3715,定穎投控,10,0,10,群益金鼎-松山,2023-12-28,9103
00679B,元大美債20年,10,0,10,群益金鼎-松山,2023-12-28,9103
00919,群益台灣精選高息,10,0,10,群益金鼎-松山,2023-12-28,9103
3325,旭品,10,0,10,群益金鼎-松山,2023-12-28,9103
4909,新復興,12,3,9,群益金鼎-松山,2023-12-28,9103
6805,富世達,9,0,9,群益金鼎-松山,2023-12-28,9103
2603,長榮,11,2,9,群益金鼎-松山,2023-12-28,9103
2365,昆盈,16,8,8,群益金鼎-松山,2023-12-28,9103
8433,弘帆,8,0,8,群益金鼎-松山,2023-12-28,9103
3622,洋華,7,0,7,群益金鼎-松山,2023-12-28,9103
5351,鈺創,7,0,7,群益金鼎-松山,2023-12-28,9103
00719B,元大美債1-3,6,0,6,群益金鼎-松山,2023-12-28,9103
2324,仁寶,110,104,6,群益金鼎-松山,2023-12-28,9103
2637,慧洋-KY,6,0,6,群益金鼎-松山,2023-12-28,9103
6789,采鈺,6,0,6,群益金鼎-松山,2023-12-28,9103
2636,台驊控股,5,0,5,群益金鼎-松山,2023-12-28,9103
00632R,元大台灣50反1,5,0,5,群益金鼎-松山,2023-12-28,9103
2022,聚亨,5,0,5,群益金鼎-松山,2023-12-28,9103
3041,揚智,5,0,5,群益金鼎-松山,2023-12-28,9103
3346,麗清,5,0,5,群益金鼎-松山,2023-12-28,9103
5210,寶碩,5,0,5,群益金鼎-松山,2023-12-28,9103
6756,威鋒電子,6,1,5,群益金鼎-松山,2023-12-28,9103
0050,元大台灣50,5,0,5,群益金鼎-松山,2023-12-28,9103
2101,南港,5,0,5,群益金鼎-松山,2023-12-28,9103
2303,聯電,1010,0,1010,群益金鼎-松山,2023-12-29,9103
00878,國泰永續高股息,203,1,202,群益金鼎-松山,2023-12-29,9103
00936,台新永續高息中小,52,0,52,群益金鼎-松山,2023-12-29,9103
3624,光頡,38,0,38,群益金鼎-松山,2023-12-29,9103
2356,英業達,30,2,28,群益金鼎-松山,2023-12-29,9103
2362,藍天,23,2,21,群益金鼎-松山,2023-12-29,9103
9105,泰金寶-DR,20,0,20,群益金鼎-松山,2023-12-29,9103
3017,奇鋐,31,14,17,群益金鼎-松山,2023-12-29,9103
00919,群益台灣精選高息,16,0,16,群益金鼎-松山,2023-12-29,9103
00937B,群益ESG投等債20,12,0,12,群益金鼎-松山,2023-12-29,9103
00850,元大臺灣ESG永續,10,0,10,群益金鼎-松山,2023-12-29,9103
00632R,元大台灣50反1,10,0,10,群益金鼎-松山,2023-12-29,9103
2312,金寶,10,0,10,群益金鼎-松山,2023-12-29,9103
2542,興富發,10,0,10,群益金鼎-松山,2023-12-29,9103
5225,東科-KY,9,0,9,群益金鼎-松山,2023-12-29,9103
2382,廣達,13,4,9,群益金鼎-松山,2023-12-29,9103
00645,富邦日本,8,0,8,群益金鼎-松山,2023-12-29,9103
1503,士電,24,17,7,群益金鼎-松山,2023-12-29,9103
1605,華新,7,0,7,群益金鼎-松山,2023-12-29,9103
2405,輔信,7,0,7,群益金鼎-松山,2023-12-29,9103
6188,廣明,7,0,7,群益金鼎-松山,2023-12-29,9103
00646,元大S＆P500,6,0,6,群益金鼎-松山,2023-12-29,9103
2547,日勝生,6,0,6,群益金鼎-松山,2023-12-29,9103
2230,泰茂,5,0,5,群益金鼎-松山,2023-12-29,9103
2743,山富,5,0,5,群益金鼎-松山,2023-12-29,9103
3041,揚智,5,0,5,群益金鼎-松山,2023-12-29,9103
3356,奇偶,5,0,5,群益金鼎-松山,2023-12-29,9103
5210,寶碩,5,0,5,群益金鼎-松山,2023-12-29,9103
00688L,國泰20年美債正2,4,0,4,群益金鼎-松山,2023-12-29,9103
3211,順達,4,0,4,群益金鼎-松山,2023-12-29,9103
2330,台積電,3,0,3,群益金鼎-松山,2023-12-29,9103
00680L,元大美債20正2,3,0,3,群益金鼎-松山,2023-12-29,9103
2609,陽明,3,0,3,群益金鼎-松山,2023-12-29,9103
1609,大亞,3,0,3,群益金鼎-松山,2023-12-29,9103
00679B,元大美債20年,3,0,3,群益金鼎-松山,2023-12-29,9103
2419,仲琦,3,0,3,群益金鼎-松山,2023-12-29,9103
2727,王品,3,0,3,群益金鼎-松山,2023-12-29,9103
2729,瓦城,3,0,3,群益金鼎-松山,2023-12-29,9103
6789,采鈺,3,0,3,群益金鼎-松山,2023-12-29,9103
8039,台虹,3,0,3,群益金鼎-松山,2023-12-29,9103
9945,潤泰新,3,0,3,群益金鼎-松山,2023-12-29,9103
00933B,國泰10Y+金融債,2,0,2,群益金鼎-松山,2023-12-29,9103
1519,華城,15,13,2,群益金鼎-松山,2023-12-29,9103
00882,中信中國高股息,2,0,2,群益金鼎-松山,2023-12-29,9103
1103,嘉泥,2,0,2,群益金鼎-松山,2023-12-29,9103
00687B,國泰20年美債,2,0,2,群益金鼎-松山,2023-12-29,9103
1808,潤隆,2,0,2,群益金鼎-松山,2023-12-29,9103
2059,川湖,2,0,2,群益金鼎-松山,2023-12-29,9103
2324,仁寶,21,19,2,群益金鼎-松山,2023-12-29,9103
2371,大同,2,0,2,群益金鼎-松山,2023-12-29,9103
00680L,元大美債20正2,90,0,90,群益金鼎-松山,2024-01-02,9103
00937B,群益ESG投等債20,54,0,54,群益金鼎-松山,2024-01-02,9103
5608,四維航,56,3,53,群益金鼎-松山,2024-01-02,9103
00706L,期元大S＆P日圓正2,50,0,50,群益金鼎-松山,2024-01-02,9103
2605,新興,50,0,50,群益金鼎-松山,2024-01-02,9103
2641,正德,50,0,50,群益金鼎-松山,2024-01-02,9103
2618,長榮航,106,71,35,群益金鼎-松山,2024-01-02,9103
00929,復華台灣科技優息,32,0,32,群益金鼎-松山,2024-01-02,9103
2606,裕民,30,0,30,群益金鼎-松山,2024-01-02,9103
6695,芯鼎,26,1,25,群益金鼎-松山,2024-01-02,9103
2727,王品,26,2,24,群益金鼎-松山,2024-01-02,9103
2421,建準,23,1,22,群益金鼎-松山,2024-01-02,9103
5344,立衛,22,0,22,群益金鼎-松山,2024-01-02,9103
2736,富野,41,20,21,群益金鼎-松山,2024-01-02,9103
3715,定穎投控,21,1,20,群益金鼎-松山,2024-01-02,9103
5230,雷笛克光學,20,0,20,群益金鼎-松山,2024-01-02,9103
5347,世界,21,1,20,群益金鼎-松山,2024-01-02,9103
6237,驊訊,18,0,18,群益金鼎-松山,2024-01-02,9103
1514,亞力,41,25,16,群益金鼎-松山,2024-01-02,9103
1752,南光,14,0,14,群益金鼎-松山,2024-01-02,9103
3231,緯創,38,25,13,群益金鼎-松山,2024-01-02,9103
00720B,元大投資級公司債,12,0,12,群益金鼎-松山,2024-01-02,9103
2450,神腦,12,0,12,群益金鼎-松山,2024-01-02,9103
2344,華邦電,11,0,11,群益金鼎-松山,2024-01-02,9103
3306,鼎天,11,0,11,群益金鼎-松山,2024-01-02,9103
00918,大華優利高填息30,10,0,10,群益金鼎-松山,2024-01-02,9103
1519,華城,10,0,10,群益金鼎-松山,2024-01-02,9103
2312,金寶,10,0,10,群益金鼎-松山,2024-01-02,9103
2383,台光電,8,0,8,群益金鼎-松山,2024-01-02,9103
1762,中化生,8,0,8,群益金鼎-松山,2024-01-02,9103
5704,老爺知,8,0,8,群益金鼎-松山,2024-01-02,9103
6263,普萊德,8,0,8,群益金鼎-松山,2024-01-02,9103
5515,建國,7,0,7,群益金鼎-松山,2024-01-02,9103
9945,潤泰新,10,3,7,群益金鼎-松山,2024-01-02,9103
2482,連宇,6,0,6,群益金鼎-松山,2024-01-02,9103
8059,凱碩,6,0,6,群益金鼎-松山,2024-01-02,9103
00687B,國泰20年美債,5,0,5,群益金鼎-松山,2024-01-02,9103
2352,佳世達,9,4,5,群益金鼎-松山,2024-01-02,9103
2439,美律,5,0,5,群益金鼎-松山,2024-01-02,9103
2739,寒舍,5,0,5,群益金鼎-松山,2024-01-02,9103
2753,八方雲集,5,0,5,群益金鼎-松山,2024-01-02,9103
2888,新光金,5,0,5,群益金鼎-松山,2024-01-02,9103
3406,玉晶光,5,0,5,群益金鼎-松山,2024-01-02,9103
3673,TPK-KY,5,0,5,群益金鼎-松山,2024-01-02,9103
6108,競國,5,0,5,群益金鼎-松山,2024-01-02,9103
6770,力積電,5,0,5,群益金鼎-松山,2024-01-02,9103
3035,智原,4,0,4,群益金鼎-松山,2024-01-02,9103
1326,台化,4,0,4,群益金鼎-松山,2024-01-02,9103
2607,榮運,4,0,4,群益金鼎-松山,2024-01-02,9103
2722,夏都,4,0,4,群益金鼎-松山,2024-01-02,9103
2303,聯電,1008,0,1008,群益金鼎-松山,2024-01-03,9103
2618,長榮航,65,3,62,群益金鼎-松山,2024-01-03,9103
2330,台積電,56,0,56,群益金鼎-松山,2024-01-03,9103
00937B,群益ESG投等債20,46,0,46,群益金鼎-松山,2024-01-03,9103
00680L,元大美債20正2,45,0,45,群益金鼎-松山,2024-01-03,9103
00929,復華台灣科技優息,69,30,39,群益金鼎-松山,2024-01-03,9103
0056,元大高股息,25,0,25,群益金鼎-松山,2024-01-03,9103
2352,佳世達,17,0,17,群益金鼎-松山,2024-01-03,9103
00878,國泰永續高股息,15,0,15,群益金鼎-松山,2024-01-03,9103
00931B,統一美債20年,15,0,15,群益金鼎-松山,2024-01-03,9103
00900,富邦特選高股息30,15,0,15,群益金鼎-松山,2024-01-03,9103
2727,王品,25,10,15,群益金鼎-松山,2024-01-03,9103
2748,雲品,15,0,15,群益金鼎-松山,2024-01-03,9103
3588,通嘉,16,1,15,群益金鼎-松山,2024-01-03,9103
6695,芯鼎,20,5,15,群益金鼎-松山,2024-01-03,9103
2467,志聖,16,2,14,群益金鼎-松山,2024-01-03,9103
00918,大華優利高填息30,13,0,13,群益金鼎-松山,2024-01-03,9103
6117,迎廣,15,2,13,群益金鼎-松山,2024-01-03,9103
2603,長榮,16,3,13,群益金鼎-松山,2024-01-03,9103
2324,仁寶,12,0,12,群益金鼎-松山,2024-01-03,9103
3624,光頡,12,0,12,群益金鼎-松山,2024-01-03,9103
3706,神達,11,0,11,群益金鼎-松山,2024-01-03,9103
8349,�矬�,11,0,11,群益金鼎-松山,2024-01-03,9103
5425,台半,12,2,10,群益金鼎-松山,2024-01-03,9103
2377,微星,10,1,9,群益金鼎-松山,2024-01-03,9103
00919,群益台灣精選高息,8,0,8,群益金鼎-松山,2024-01-03,9103
00688L,國泰20年美債正2,8,0,8,群益金鼎-松山,2024-01-03,9103
2409,友達,7,1,6,群益金鼎-松山,2024-01-03,9103
3217,優群,7,1,6,群益金鼎-松山,2024-01-03,9103
00706L,期元大S＆P日圓正2,5,0,5,群益金鼎-松山,2024-01-03,9103
1101,台泥,5,0,5,群益金鼎-松山,2024-01-03,9103
2002,中鋼,5,0,5,群益金鼎-松山,2024-01-03,9103
2421,建準,13,8,5,群益金鼎-松山,2024-01-03,9103
2892,第一金,5,0,5,群益金鼎-松山,2024-01-03,9103
5515,建國,5,0,5,群益金鼎-松山,2024-01-03,9103
8039,台虹,5,0,5,群益金鼎-松山,2024-01-03,9103
1605,華新,4,0,4,群益金鼎-松山,2024-01-03,9103
1326,台化,4,0,4,群益金鼎-松山,2024-01-03,9103
2105,正新,4,0,4,群益金鼎-松山,2024-01-03,9103
2383,台光電,4,0,4,群益金鼎-松山,2024-01-03,9103
2610,華航,7,3,4,群益金鼎-松山,2024-01-03,9103
2736,富野,20,16,4,群益金鼎-松山,2024-01-03,9103
8059,凱碩,4,0,4,群益金鼎-松山,2024-01-03,9103
8069,元太,3,0,3,群益金鼎-松山,2024-01-03,9103
1216,統一,3,0,3,群益金鼎-松山,2024-01-03,9103
1905,華紙,3,0,3,群益金鼎-松山,2024-01-03,9103
3037,欣興,3,0,3,群益金鼎-松山,2024-01-03,9103
6679,鈺太,3,0,3,群益金鼎-松山,2024-01-03,9103
2885,元大金,8,5,3,群益金鼎-松山,2024-01-03,9103
2881,富邦金,2,0,2,群益金鼎-松山,2024-01-03,9103
5521,工信,201,8,193,群益金鼎-松山,2024-01-04,9103
00830,國泰費城半導體,100,0,100,群益金鼎-松山,2024-01-04,9103
2022,聚亨,74,0,74,群益金鼎-松山,2024-01-04,9103
2007,燁興,55,5,50,群益金鼎-松山,2024-01-04,9103
6290,良維,50,3,47,群益金鼎-松山,2024-01-04,9103
2609,陽明,75,29,46,群益金鼎-松山,2024-01-04,9103
2605,新興,110,69,41,群益金鼎-松山,2024-01-04,9103
00706L,期元大S＆P日圓正2,30,0,30,群益金鼎-松山,2024-01-04,9103
00670L,富邦NASDAQ正2,30,0,30,群益金鼎-松山,2024-01-04,9103
2038,海光,66,36,30,群益金鼎-松山,2024-01-04,9103
5706,鳳凰,30,0,30,群益金鼎-松山,2024-01-04,9103
8088,品安,28,0,28,群益金鼎-松山,2024-01-04,9103
8089,康全電訊,28,0,28,群益金鼎-松山,2024-01-04,9103
2009,第一銅,60,33,27,群益金鼎-松山,2024-01-04,9103
2882,國泰金,26,0,26,群益金鼎-松山,2024-01-04,9103
1903,士紙,25,0,25,群益金鼎-松山,2024-01-04,9103
5225,東科-KY,22,0,22,群益金鼎-松山,2024-01-04,9103
2303,聯電,22,0,22,群益金鼎-松山,2024-01-04,9103
00655L,國泰中國A50正2,21,0,21,群益金鼎-松山,2024-01-04,9103
6546,正基,20,0,20,群益金鼎-松山,2024-01-04,9103
2486,一詮,17,1,16,群益金鼎-松山,2024-01-04,9103
4908,前鼎,15,0,15,群益金鼎-松山,2024-01-04,9103
2368,金像電,14,0,14,群益金鼎-松山,2024-01-04,9103
00715L,期街口布蘭特正2,12,0,12,群益金鼎-松山,2024-01-04,9103
8467,波力-KY,12,0,12,群益金鼎-松山,2024-01-04,9103
2615,萬海,13,2,11,群益金鼎-松山,2024-01-04,9103
2312,金寶,10,0,10,群益金鼎-松山,2024-01-04,9103
00720B,元大投資級公司債,10,0,10,群益金鼎-松山,2024-01-04,9103
00927,群益半導體收益,10,0,10,群益金鼎-松山,2024-01-04,9103
5515,建國,10,0,10,群益金鼎-松山,2024-01-04,9103
2636,台驊控股,10,1,9,群益金鼎-松山,2024-01-04,9103
6173,信昌電,9,0,9,群益金鼎-松山,2024-01-04,9103
00929,復華台灣科技優息,8,0,8,群益金鼎-松山,2024-01-04,9103
1815,富喬,8,0,8,群益金鼎-松山,2024-01-04,9103
2250,IKKA-KY,7,0,7,群益金鼎-松山,2024-01-04,9103
1513,中興電,8,2,6,群益金鼎-松山,2024-01-04,9103
00919,群益台灣精選高息,6,0,6,群益金鼎-松山,2024-01-04,9103
1781,合世,6,0,6,群益金鼎-松山,2024-01-04,9103
2362,藍天,33,27,6,群益金鼎-松山,2024-01-04,9103
6138,茂達,6,0,6,群益金鼎-松山,2024-01-04,9103
00753L,中信中國50正2,5,0,5,群益金鼎-松山,2024-01-04,9103
2421,建準,8,3,5,群益金鼎-松山,2024-01-04,9103
6245,立端,5,0,5,群益金鼎-松山,2024-01-04,9103
3037,欣興,5,1,4,群益金鼎-松山,2024-01-04,9103
2617,台航,4,0,4,群益金鼎-松山,2024-01-04,9103
2748,雲品,4,0,4,群益金鼎-松山,2024-01-04,9103
5348,正能量智能,4,0,4,群益金鼎-松山,2024-01-04,9103
6125,廣運,4,0,4,群益金鼎-松山,2024-01-04,9103
6278,台表科,4,0,4,群益金鼎-松山,2024-01-04,9103
6285,啟��,4,0,4,群益金鼎-松山,2024-01-04,9103
6770,力積電,118,18,100,群益金鼎-松山,2024-01-05,9103
3481,群創,101,6,95,群益金鼎-松山,2024-01-05,9103
2303,聯電,76,1,75,群益金鼎-松山,2024-01-05,9103
2609,陽明,109,57,52,群益金鼎-松山,2024-01-05,9103
5608,四維航,50,0,50,群益金鼎-松山,2024-01-05,9103
6164,華興,50,0,50,群益金鼎-松山,2024-01-05,9103
00679B,元大美債20年,36,0,36,群益金鼎-松山,2024-01-05,9103
00706L,期元大S＆P日圓正2,35,0,35,群益金鼎-松山,2024-01-05,9103
1325,恆大,33,0,33,群益金鼎-松山,2024-01-05,9103
8085,福華,25,0,25,群益金鼎-松山,2024-01-05,9103
1815,富喬,24,3,21,群益金鼎-松山,2024-01-05,9103
3260,威剛,22,1,21,群益金鼎-松山,2024-01-05,9103
00929,復華台灣科技優息,19,0,19,群益金鼎-松山,2024-01-05,9103
2362,藍天,27,9,18,群益金鼎-松山,2024-01-05,9103
2329,華泰,20,3,17,群益金鼎-松山,2024-01-05,9103
3264,欣銓,15,0,15,群益金鼎-松山,2024-01-05,9103
4945,陞達科技,17,2,15,群益金鼎-松山,2024-01-05,9103
5225,東科-KY,15,0,15,群益金鼎-松山,2024-01-05,9103
00937B,群益ESG投等債20,14,0,14,群益金鼎-松山,2024-01-05,9103
00720B,元大投資級公司債,12,0,12,群益金鼎-松山,2024-01-05,9103
00919,群益台灣精選高息,11,0,11,群益金鼎-松山,2024-01-05,9103
3006,晶豪科,11,0,11,群益金鼎-松山,2024-01-05,9103
6462,神盾,19,8,11,群益金鼎-松山,2024-01-05,9103
2330,台積電,10,0,10,群益金鼎-松山,2024-01-05,9103
00633L,富邦上証正2,10,0,10,群益金鼎-松山,2024-01-05,9103
00688L,國泰20年美債正2,10,0,10,群益金鼎-松山,2024-01-05,9103
4747,強生,10,0,10,群益金鼎-松山,2024-01-05,9103
2449,京元電子,9,0,9,群益金鼎-松山,2024-01-05,9103
00885,富邦越南,8,0,8,群益金鼎-松山,2024-01-05,9103
4979,華星光,12,4,8,群益金鼎-松山,2024-01-05,9103
1795,美時,9,2,7,群益金鼎-松山,2024-01-05,9103
1802,台玻,6,0,6,群益金鼎-松山,2024-01-05,9103
3042,晶技,7,1,6,群益金鼎-松山,2024-01-05,9103
6576,逸達,6,0,6,群益金鼎-松山,2024-01-05,9103
00715L,期街口布蘭特正2,5,0,5,群益金鼎-松山,2024-01-05,9103
2038,海光,5,0,5,群益金鼎-松山,2024-01-05,9103
2357,華碩,5,0,5,群益金鼎-松山,2024-01-05,9103
2364,倫飛,5,0,5,群益金鼎-松山,2024-01-05,9103
2379,瑞昱,5,0,5,群益金鼎-松山,2024-01-05,9103
2421,建準,7,2,5,群益金鼎-松山,2024-01-05,9103
2637,慧洋-KY,12,7,5,群益金鼎-松山,2024-01-05,9103
2722,夏都,10,5,5,群益金鼎-松山,2024-01-05,9103
3232,昱捷,5,0,5,群益金鼎-松山,2024-01-05,9103
4908,前鼎,13,8,5,群益金鼎-松山,2024-01-05,9103
6684,安格,5,0,5,群益金鼎-松山,2024-01-05,9103
00904,新光臺灣半導體30,4,0,4,群益金鼎-松山,2024-01-05,9103
2324,仁寶,5,1,4,群益金鼎-松山,2024-01-05,9103
5483,中美晶,4,0,4,群益金鼎-松山,2024-01-05,9103
5515,建國,5,1,4,群益金鼎-松山,2024-01-05,9103
6188,廣明,3,0,3,群益金鼎-松山,2024-01-05,9103
1449,佳和,100,0,100,群益金鼎-松山,2024-01-08,9103
2409,友達,307,210,97,群益金鼎-松山,2024-01-08,9103
2362,藍天,122,33,89,群益金鼎-松山,2024-01-08,9103
2605,新興,80,10,70,群益金鼎-松山,2024-01-08,9103
2609,陽明,93,43,50,群益金鼎-松山,2024-01-08,9103
1815,富喬,44,0,44,群益金鼎-松山,2024-01-08,9103
9928,中視,40,0,40,群益金鼎-松山,2024-01-08,9103
00670L,富邦NASDAQ正2,30,0,30,群益金鼎-松山,2024-01-08,9103
8085,福華,25,0,25,群益金鼎-松山,2024-01-08,9103
00633L,富邦上証正2,22,0,22,群益金鼎-松山,2024-01-08,9103
2607,榮運,21,0,21,群益金鼎-松山,2024-01-08,9103
2736,富野,21,0,21,群益金鼎-松山,2024-01-08,9103
5347,世界,21,0,21,群益金鼎-松山,2024-01-08,9103
2882,國泰金,20,1,19,群益金鼎-松山,2024-01-08,9103
4746,台耀,20,1,19,群益金鼎-松山,2024-01-08,9103
3017,奇鋐,16,0,16,群益金鼎-松山,2024-01-08,9103
2722,夏都,42,26,16,群益金鼎-松山,2024-01-08,9103
6742,澤米,16,0,16,群益金鼎-松山,2024-01-08,9103
00929,復華台灣科技優息,15,0,15,群益金鼎-松山,2024-01-08,9103
2382,廣達,16,1,15,群益金鼎-松山,2024-01-08,9103
3231,緯創,17,3,14,群益金鼎-松山,2024-01-08,9103
4909,新復興,20,6,14,群益金鼎-松山,2024-01-08,9103
3704,合勤控,13,0,13,群益金鼎-松山,2024-01-08,9103
6684,安格,22,9,13,群益金鼎-松山,2024-01-08,9103
00720B,元大投資級公司債,12,0,12,群益金鼎-松山,2024-01-08,9103
2636,台驊控股,11,0,11,群益金鼎-松山,2024-01-08,9103
00671R,富邦NASDAQ反1,10,0,10,群益金鼎-松山,2024-01-08,9103
6143,振曜,15,5,10,群益金鼎-松山,2024-01-08,9103
00931B,統一美債20年,9,0,9,群益金鼎-松山,2024-01-08,9103
2603,長榮,17,8,9,群益金鼎-松山,2024-01-08,9103
3025,星通,13,5,8,群益金鼎-松山,2024-01-08,9103
3645,達邁,8,0,8,群益金鼎-松山,2024-01-08,9103
8227,巨有科技,8,0,8,群益金鼎-松山,2024-01-08,9103
9929,秋雨,7,0,7,群益金鼎-松山,2024-01-08,9103
5210,寶碩,6,0,6,群益金鼎-松山,2024-01-08,9103
1519,華城,9,4,5,群益金鼎-松山,2024-01-08,9103
3042,晶技,5,0,5,群益金鼎-松山,2024-01-08,9103
00665L,富邦�琤肭磪囓�2,5,0,5,群益金鼎-松山,2024-01-08,9103
2637,慧洋-KY,6,1,5,群益金鼎-松山,2024-01-08,9103
2743,山富,5,0,5,群益金鼎-松山,2024-01-08,9103
3694,海華,5,0,5,群益金鼎-松山,2024-01-08,9103
5609,中菲行,5,0,5,群益金鼎-松山,2024-01-08,9103
6244,茂迪,15,10,5,群益金鼎-松山,2024-01-08,9103
3702,大聯大,4,0,4,群益金鼎-松山,2024-01-08,9103
4747,強生,4,0,4,群益金鼎-松山,2024-01-08,9103
00885,富邦越南,6,3,3,群益金鼎-松山,2024-01-08,9103
1312,國喬,3,0,3,群益金鼎-松山,2024-01-08,9103
00772B,中信高評級公司債,3,0,3,群益金鼎-松山,2024-01-08,9103
3715,定穎投控,5,2,3,群益金鼎-松山,2024-01-08,9103
6462,神盾,11,8,3,群益金鼎-松山,2024-01-08,9103
00929,復華台灣科技優息,210,100,110,群益金鼎-松山,2024-01-09,9103
4909,新復興,61,14,47,群益金鼎-松山,2024-01-09,9103
1514,亞力,44,3,41,群益金鼎-松山,2024-01-09,9103
2329,華泰,30,0,30,群益金鼎-松山,2024-01-09,9103
2324,仁寶,39,10,29,群益金鼎-松山,2024-01-09,9103
00715L,期街口布蘭特正2,23,0,23,群益金鼎-松山,2024-01-09,9103
8227,巨有科技,26,4,22,群益金鼎-松山,2024-01-09,9103
3025,星通,54,35,19,群益金鼎-松山,2024-01-09,9103
6462,神盾,22,3,19,群益金鼎-松山,2024-01-09,9103
00900,富邦特選高股息30,17,0,17,群益金鼎-松山,2024-01-09,9103
2615,萬海,16,0,16,群益金鼎-松山,2024-01-09,9103
2637,慧洋-KY,15,0,15,群益金鼎-松山,2024-01-09,9103
2352,佳世達,15,2,13,群益金鼎-松山,2024-01-09,9103
1605,華新,12,0,12,群益金鼎-松山,2024-01-09,9103
3231,緯創,51,41,10,群益金鼎-松山,2024-01-09,9103
6576,逸達,10,0,10,群益金鼎-松山,2024-01-09,9103
00919,群益台灣精選高息,11,2,9,群益金鼎-松山,2024-01-09,9103
00937B,群益ESG投等債20,9,0,9,群益金鼎-松山,2024-01-09,9103
3324,雙鴻,9,0,9,群益金鼎-松山,2024-01-09,9103
4908,前鼎,13,4,9,群益金鼎-松山,2024-01-09,9103
2376,技嘉,10,2,8,群益金鼎-松山,2024-01-09,9103
1432,大魯閣,8,0,8,群益金鼎-松山,2024-01-09,9103
8085,福華,7,0,7,群益金鼎-松山,2024-01-09,9103
2609,陽明,18,12,6,群益金鼎-松山,2024-01-09,9103
2421,建準,9,3,6,群益金鼎-松山,2024-01-09,9103
5609,中菲行,6,0,6,群益金鼎-松山,2024-01-09,9103
6695,芯鼎,15,9,6,群益金鼎-松山,2024-01-09,9103
9929,秋雨,6,0,6,群益金鼎-松山,2024-01-09,9103
2313,華通,5,0,5,群益金鼎-松山,2024-01-09,9103
2634,漢翔,5,0,5,群益金鼎-松山,2024-01-09,9103
6223,旺矽,6,1,5,群益金鼎-松山,2024-01-09,9103
6742,澤米,5,0,5,群益金鼎-松山,2024-01-09,9103
2383,台光電,4,0,4,群益金鼎-松山,2024-01-09,9103
2610,華航,6,2,4,群益金鼎-松山,2024-01-09,9103
3051,力特,5,1,4,群益金鼎-松山,2024-01-09,9103
3711,日月光投控,4,0,4,群益金鼎-松山,2024-01-09,9103
6140,訊達,4,0,4,群益金鼎-松山,2024-01-09,9103
6235,華孚,6,2,4,群益金鼎-松山,2024-01-09,9103
1312,國喬,3,0,3,群益金鼎-松山,2024-01-09,9103
1301,台塑,3,0,3,群益金鼎-松山,2024-01-09,9103
00927,群益半導體收益,3,0,3,群益金鼎-松山,2024-01-09,9103
1504,東元,3,0,3,群益金鼎-松山,2024-01-09,9103
1568,倉佑,3,0,3,群益金鼎-松山,2024-01-09,9103
1618,合機,3,0,3,群益金鼎-松山,2024-01-09,9103
2023,燁輝,3,0,3,群益金鼎-松山,2024-01-09,9103
2359,所羅門,5,2,3,群益金鼎-松山,2024-01-09,9103
2497,怡利電,3,0,3,群益金鼎-松山,2024-01-09,9103
3011,今皓,3,0,3,群益金鼎-松山,2024-01-09,9103
3715,定穎投控,3,0,3,群益金鼎-松山,2024-01-09,9103
4919,新唐,6,3,3,群益金鼎-松山,2024-01-09,9103
00664R,國泰臺灣加權反1,200,0,200,群益金鼎-松山,2024-01-10,9103
2230,泰茂,100,0,100,群益金鼎-松山,2024-01-10,9103
6625,必應,68,3,65,群益金鼎-松山,2024-01-10,9103
8046,南電,25,0,25,群益金鼎-松山,2024-01-10,9103
6695,芯鼎,31,9,22,群益金鼎-松山,2024-01-10,9103
3013,晟銘電,20,0,20,群益金鼎-松山,2024-01-10,9103
3622,洋華,20,0,20,群益金鼎-松山,2024-01-10,9103
6243,迅杰,23,4,19,群益金鼎-松山,2024-01-10,9103
3706,神達,32,15,17,群益金鼎-松山,2024-01-10,9103
2331,精英,16,0,16,群益金鼎-松山,2024-01-10,9103
00679B,元大美債20年,15,0,15,群益金鼎-松山,2024-01-10,9103
2301,光寶科,15,0,15,群益金鼎-松山,2024-01-10,9103
4945,陞達科技,16,1,15,群益金鼎-松山,2024-01-10,9103
2637,慧洋-KY,15,1,14,群益金鼎-松山,2024-01-10,9103
8089,康全電訊,27,14,13,群益金鼎-松山,2024-01-10,9103
2329,華泰,12,1,11,群益金鼎-松山,2024-01-10,9103
2888,新光金,10,0,10,群益金鼎-松山,2024-01-10,9103
2332,友訊,10,0,10,群益金鼎-松山,2024-01-10,9103
2353,宏��,10,0,10,群益金鼎-松山,2024-01-10,9103
5521,工信,10,0,10,群益金鼎-松山,2024-01-10,9103
6204,艾華,10,0,10,群益金鼎-松山,2024-01-10,9103
00929,復華台灣科技優息,9,0,9,群益金鼎-松山,2024-01-10,9103
2356,英業達,8,0,8,群益金鼎-松山,2024-01-10,9103
00937B,群益ESG投等債20,7,0,7,群益金鼎-松山,2024-01-10,9103
00900,富邦特選高股息30,7,0,7,群益金鼎-松山,2024-01-10,9103
1795,美時,8,2,6,群益金鼎-松山,2024-01-10,9103
2547,日勝生,6,0,6,群益金鼎-松山,2024-01-10,9103
3042,晶技,6,0,6,群益金鼎-松山,2024-01-10,9103
6446,藥華藥,6,0,6,群益金鼎-松山,2024-01-10,9103
3545,敦泰,6,0,6,群益金鼎-松山,2024-01-10,9103
5706,鳳凰,5,0,5,群益金鼎-松山,2024-01-10,9103
2352,佳世達,5,0,5,群益金鼎-松山,2024-01-10,9103
1515,力山,5,0,5,群益金鼎-松山,2024-01-10,9103
00688L,國泰20年美債正2,5,0,5,群益金鼎-松山,2024-01-10,9103
2379,瑞昱,5,0,5,群益金鼎-松山,2024-01-10,9103
2368,金像電,5,1,4,群益金鼎-松山,2024-01-10,9103
00680L,元大美債20正2,4,0,4,群益金鼎-松山,2024-01-10,9103
2250,IKKA-KY,4,0,4,群益金鼎-松山,2024-01-10,9103
2324,仁寶,16,12,4,群益金鼎-松山,2024-01-10,9103
2615,萬海,4,0,4,群益金鼎-松山,2024-01-10,9103
2618,長榮航,8,4,4,群益金鼎-松山,2024-01-10,9103
3025,星通,5,1,4,群益金鼎-松山,2024-01-10,9103
3094,聯傑,4,0,4,群益金鼎-松山,2024-01-10,9103
6805,富世達,5,1,4,群益金鼎-松山,2024-01-10,9103
00919,群益台灣精選高息,3,0,3,群益金鼎-松山,2024-01-10,9103
0056,元大高股息,3,0,3,群益金鼎-松山,2024-01-10,9103
00933B,國泰10Y+金融債,3,0,3,群益金鼎-松山,2024-01-10,9103
00725B,國泰投資級公司債,3,0,3,群益金鼎-松山,2024-01-10,9103
2383,台光電,3,0,3,群益金鼎-松山,2024-01-10,9103
3027,盛達,3,0,3,群益金鼎-松山,2024-01-10,9103
2409,友達,100,1,99,群益金鼎-松山,2024-01-11,9103
6854,錼創科技-KY創,63,0,63,群益金鼎-松山,2024-01-11,9103
2353,宏��,73,21,52,群益金鼎-松山,2024-01-11,9103
00830,國泰費城半導體,50,0,50,群益金鼎-松山,2024-01-11,9103
2606,裕民,50,0,50,群益金鼎-松山,2024-01-11,9103
6164,華興,50,0,50,群益金鼎-松山,2024-01-11,9103
2301,光寶科,40,0,40,群益金鼎-松山,2024-01-11,9103
2457,飛宏,30,1,29,群益金鼎-松山,2024-01-11,9103
2890,永豐金,29,0,29,群益金鼎-松山,2024-01-11,9103
2344,華邦電,26,0,26,群益金鼎-松山,2024-01-11,9103
2324,仁寶,56,33,23,群益金鼎-松山,2024-01-11,9103
4908,前鼎,116,96,20,群益金鼎-松山,2024-01-11,9103
8433,弘帆,20,0,20,群益金鼎-松山,2024-01-11,9103
5347,世界,20,1,19,群益金鼎-松山,2024-01-11,9103
00929,復華台灣科技優息,17,0,17,群益金鼎-松山,2024-01-11,9103
5351,鈺創,28,11,17,群益金鼎-松山,2024-01-11,9103
3231,緯創,31,15,16,群益金鼎-松山,2024-01-11,9103
00706L,期元大S＆P日圓正2,15,0,15,群益金鼎-松山,2024-01-11,9103
8111,立��,15,0,15,群益金鼎-松山,2024-01-11,9103
8096,擎亞,13,0,13,群益金鼎-松山,2024-01-11,9103
6239,力成,13,1,12,群益金鼎-松山,2024-01-11,9103
5258,虹堡,15,4,11,群益金鼎-松山,2024-01-11,9103
2520,冠德,11,1,10,群益金鼎-松山,2024-01-11,9103
2748,雲品,10,0,10,群益金鼎-松山,2024-01-11,9103
2882,國泰金,10,0,10,群益金鼎-松山,2024-01-11,9103
2883,凱基金,10,0,10,群益金鼎-松山,2024-01-11,9103
3450,聯鈞,11,1,10,群益金鼎-松山,2024-01-11,9103
6263,普萊德,10,0,10,群益金鼎-松山,2024-01-11,9103
3706,神達,11,2,9,群益金鼎-松山,2024-01-11,9103
4979,華星光,13,4,9,群益金鼎-松山,2024-01-11,9103
6451,訊芯-KY,13,4,9,群益金鼎-松山,2024-01-11,9103
2388,威盛,8,0,8,群益金鼎-松山,2024-01-11,9103
6231,系微,8,1,7,群益金鼎-松山,2024-01-11,9103
2382,廣達,10,3,7,群益金鼎-松山,2024-01-11,9103
00933B,國泰10Y+金融債,6,0,6,群益金鼎-松山,2024-01-11,9103
2371,大同,6,0,6,群益金鼎-松山,2024-01-11,9103
2376,技嘉,11,5,6,群益金鼎-松山,2024-01-11,9103
8050,廣積,6,0,6,群益金鼎-松山,2024-01-11,9103
00679B,元大美債20年,5,0,5,群益金鼎-松山,2024-01-11,9103
0055,元大MSCI金融,5,0,5,群益金鼎-松山,2024-01-11,9103
1736,喬山,5,0,5,群益金鼎-松山,2024-01-11,9103
2637,慧洋-KY,5,0,5,群益金鼎-松山,2024-01-11,9103
2743,山富,10,5,5,群益金鼎-松山,2024-01-11,9103
5521,工信,5,0,5,群益金鼎-松山,2024-01-11,9103
5609,中菲行,5,0,5,群益金鼎-松山,2024-01-11,9103
9958,世紀鋼,5,0,5,群益金鼎-松山,2024-01-11,9103
2062,橋椿,4,0,4,群益金鼎-松山,2024-01-11,9103
2423,固緯,5,1,4,群益金鼎-松山,2024-01-11,9103
8936,國統,5,1,4,群益金鼎-松山,2024-01-11,9103
00680L,元大美債20正2,3,0,3,群益金鼎-松山,2024-01-11,9103
6625,必應,101,0,101,群益金鼎-松山,2024-01-12,9103
2891,中信金,80,0,80,群益金鼎-松山,2024-01-12,9103
2356,英業達,39,7,32,群益金鼎-松山,2024-01-12,9103
6530,創威,25,0,25,群益金鼎-松山,2024-01-12,9103
2609,陽明,29,5,24,群益金鼎-松山,2024-01-12,9103
2371,大同,16,0,16,群益金鼎-松山,2024-01-12,9103
2888,新光金,15,0,15,群益金鼎-松山,2024-01-12,9103
8349,�矬�,14,0,14,群益金鼎-松山,2024-01-12,9103
9929,秋雨,14,0,14,群益金鼎-松山,2024-01-12,9103
2634,漢翔,13,2,11,群益金鼎-松山,2024-01-12,9103
00904,新光臺灣半導體30,10,0,10,群益金鼎-松山,2024-01-12,9103
2332,友訊,10,0,10,群益金鼎-松山,2024-01-12,9103
6546,正基,10,0,10,群益金鼎-松山,2024-01-12,9103
2476,鉅祥,10,1,9,群益金鼎-松山,2024-01-12,9103
2643,捷迅,8,0,8,群益金鼎-松山,2024-01-12,9103
3325,旭品,8,0,8,群益金鼎-松山,2024-01-12,9103
0056,元大高股息,6,0,6,群益金鼎-松山,2024-01-12,9103
2882,國泰金,6,0,6,群益金鼎-松山,2024-01-12,9103
5425,台半,6,0,6,群益金鼎-松山,2024-01-12,9103
8937,合騏,6,0,6,群益金鼎-松山,2024-01-12,9103
00918,大華優利高填息30,5,0,5,群益金鼎-松山,2024-01-12,9103
2610,華航,5,0,5,群益金鼎-松山,2024-01-12,9103
2250,IKKA-KY,4,0,4,群益金鼎-松山,2024-01-12,9103
00919,群益台灣精選高息,9,5,4,群益金鼎-松山,2024-01-12,9103
00693U,期街口S＆P黃豆,4,0,4,群益金鼎-松山,2024-01-12,9103
2362,藍天,6,2,4,群益金鼎-松山,2024-01-12,9103
2455,全新,4,0,4,群益金鼎-松山,2024-01-12,9103
3702,大聯大,4,0,4,群益金鼎-松山,2024-01-12,9103
6231,系微,4,0,4,群益金鼎-松山,2024-01-12,9103
6456,GIS-KY,4,0,4,群益金鼎-松山,2024-01-12,9103
8076,伍豐,4,0,4,群益金鼎-松山,2024-01-12,9103
8227,巨有科技,17,13,4,群益金鼎-松山,2024-01-12,9103
5236,凌陽創新,3,0,3,群益金鼎-松山,2024-01-12,9103
00885,富邦越南,6,3,3,群益金鼎-松山,2024-01-12,9103
2329,華泰,4,1,3,群益金鼎-松山,2024-01-12,9103
2379,瑞昱,3,0,3,群益金鼎-松山,2024-01-12,9103
2892,第一金,3,0,3,群益金鼎-松山,2024-01-12,9103
3443,創意,4,1,3,群益金鼎-松山,2024-01-12,9103
3556,禾瑞亞,3,0,3,群益金鼎-松山,2024-01-12,9103
5515,建國,3,0,3,群益金鼎-松山,2024-01-12,9103
8150,南茂,5,2,3,群益金鼎-松山,2024-01-12,9103
3037,欣興,2,0,2,群益金鼎-松山,2024-01-12,9103
2002,中鋼,2,0,2,群益金鼎-松山,2024-01-12,9103
00930,永豐ESG低碳高息,2,0,2,群益金鼎-松山,2024-01-12,9103
00637L,元大滬深300正2,2,0,2,群益金鼎-松山,2024-01-12,9103
00770,國泰北美科技,2,0,2,群益金鼎-松山,2024-01-12,9103
2324,仁寶,5,3,2,群益金鼎-松山,2024-01-12,9103
2393,億光,2,0,2,群益金鼎-松山,2024-01-12,9103
2442,新美齊,2,0,2,群益金鼎-松山,2024-01-12,9103
3025,星通,39,37,2,群益金鼎-松山,2024-01-12,9103
3481,群創,450,0,450,群益金鼎-松山,2024-01-15,9103
3231,緯創,86,7,79,群益金鼎-松山,2024-01-15,9103
00679B,元大美債20年,59,0,59,群益金鼎-松山,2024-01-15,9103
1514,亞力,67,17,50,群益金鼎-松山,2024-01-15,9103
8085,福華,50,2,48,群益金鼎-松山,2024-01-15,9103
6243,迅杰,46,5,41,群益金鼎-松山,2024-01-15,9103
6451,訊芯-KY,42,2,40,群益金鼎-松山,2024-01-15,9103
1560,中砂,32,2,30,群益金鼎-松山,2024-01-15,9103
2371,大同,28,0,28,群益金鼎-松山,2024-01-15,9103
2454,聯發科,25,0,25,群益金鼎-松山,2024-01-15,9103
2382,廣達,37,12,25,群益金鼎-松山,2024-01-15,9103
3664,安瑞-KY,20,0,20,群益金鼎-松山,2024-01-15,9103
3588,通嘉,19,1,18,群益金鼎-松山,2024-01-15,9103
3017,奇鋐,21,6,15,群益金鼎-松山,2024-01-15,9103
3548,兆利,15,0,15,群益金鼎-松山,2024-01-15,9103
9958,世紀鋼,20,6,14,群益金鼎-松山,2024-01-15,9103
2618,長榮航,20,6,14,群益金鼎-松山,2024-01-15,9103
2353,宏��,13,1,12,群益金鼎-松山,2024-01-15,9103
00927,群益半導體收益,10,0,10,群益金鼎-松山,2024-01-15,9103
1503,士電,21,11,10,群益金鼎-松山,2024-01-15,9103
2332,友訊,10,0,10,群益金鼎-松山,2024-01-15,9103
2428,興勤,10,0,10,群益金鼎-松山,2024-01-15,9103
1513,中興電,10,1,9,群益金鼎-松山,2024-01-15,9103
1783,和康生,10,1,9,群益金鼎-松山,2024-01-15,9103
1609,大亞,15,6,9,群益金鼎-松山,2024-01-15,9103
6742,澤米,9,0,9,群益金鼎-松山,2024-01-15,9103
4979,華星光,10,2,8,群益金鼎-松山,2024-01-15,9103
00929,復華台灣科技優息,17,10,7,群益金鼎-松山,2024-01-15,9103
2882,國泰金,7,0,7,群益金鼎-松山,2024-01-15,9103
8433,弘帆,7,0,7,群益金鼎-松山,2024-01-15,9103
2892,第一金,7,0,7,群益金鼎-松山,2024-01-15,9103
3325,旭品,6,0,6,群益金鼎-松山,2024-01-15,9103
2002,中鋼,6,0,6,群益金鼎-松山,2024-01-15,9103
2363,矽統,6,0,6,群益金鼎-松山,2024-01-15,9103
3715,定穎投控,8,2,6,群益金鼎-松山,2024-01-15,9103
1216,統一,5,0,5,群益金鼎-松山,2024-01-15,9103
00719B,元大美債1-3,5,0,5,群益金鼎-松山,2024-01-15,9103
00770,國泰北美科技,5,0,5,群益金鼎-松山,2024-01-15,9103
00687B,國泰20年美債,5,0,5,群益金鼎-松山,2024-01-15,9103
00683L,期元大美元指正2,5,0,5,群益金鼎-松山,2024-01-15,9103
00632R,元大台灣50反1,5,0,5,群益金鼎-松山,2024-01-15,9103
2362,藍天,5,0,5,群益金鼎-松山,2024-01-15,9103
2605,新興,5,0,5,群益金鼎-松山,2024-01-15,9103
2610,華航,5,0,5,群益金鼎-松山,2024-01-15,9103
3105,穩懋,8,3,5,群益金鼎-松山,2024-01-15,9103
6005,群益證,5,0,5,群益金鼎-松山,2024-01-15,9103
0056,元大高股息,5,0,5,群益金鼎-松山,2024-01-15,9103
00918,大華優利高填息30,4,0,4,群益金鼎-松山,2024-01-15,9103
1519,華城,12,8,4,群益金鼎-松山,2024-01-15,9103
2352,佳世達,5,1,4,群益金鼎-松山,2024-01-15,9103
2374,佳能,69,0,69,群益金鼎-松山,2024-01-16,9103
6164,華興,50,0,50,群益金鼎-松山,2024-01-16,9103
1815,富喬,36,8,28,群益金鼎-松山,2024-01-16,9103
3036,文曄,35,8,27,群益金鼎-松山,2024-01-16,9103
00706L,期元大S＆P日圓正2,20,0,20,群益金鼎-松山,2024-01-16,9103
2405,輔信,20,1,19,群益金鼎-松山,2024-01-16,9103
2748,雲品,18,0,18,群益金鼎-松山,2024-01-16,9103
00679B,元大美債20年,17,0,17,群益金鼎-松山,2024-01-16,9103
2486,一詮,22,5,17,群益金鼎-松山,2024-01-16,9103
00632R,元大台灣50反1,20,5,15,群益金鼎-松山,2024-01-16,9103
2476,鉅祥,15,0,15,群益金鼎-松山,2024-01-16,9103
9945,潤泰新,15,0,15,群益金鼎-松山,2024-01-16,9103
6285,啟��,15,1,14,群益金鼎-松山,2024-01-16,9103
1529,樂事綠能,12,0,12,群益金鼎-松山,2024-01-16,9103
3035,智原,23,12,11,群益金鼎-松山,2024-01-16,9103
1216,統一,10,0,10,群益金鼎-松山,2024-01-16,9103
2454,聯發科,10,1,9,群益金鼎-松山,2024-01-16,9103
2362,藍天,9,0,9,群益金鼎-松山,2024-01-16,9103
3708,上緯投控,9,0,9,群益金鼎-松山,2024-01-16,9103
6270,倍微,11,2,9,群益金鼎-松山,2024-01-16,9103
00688L,國泰20年美債正2,8,0,8,群益金鼎-松山,2024-01-16,9103
00680L,元大美債20正2,7,0,7,群益金鼎-松山,2024-01-16,9103
2603,長榮,8,1,7,群益金鼎-松山,2024-01-16,9103
2892,第一金,7,0,7,群益金鼎-松山,2024-01-16,9103
6558,興能高,7,0,7,群益金鼎-松山,2024-01-16,9103
00878,國泰永續高股息,16,10,6,群益金鼎-松山,2024-01-16,9103
00929,復華台灣科技優息,6,0,6,群益金鼎-松山,2024-01-16,9103
00904,新光臺灣半導體30,6,0,6,群益金鼎-松山,2024-01-16,9103
2015,豐興,6,0,6,群益金鼎-松山,2024-01-16,9103
2331,精英,6,0,6,群益金鼎-松山,2024-01-16,9103
2371,大同,24,18,6,群益金鼎-松山,2024-01-16,9103
2636,台驊控股,6,0,6,群益金鼎-松山,2024-01-16,9103
2883,凱基金,6,0,6,群益金鼎-松山,2024-01-16,9103
3059,華晶科,6,0,6,群益金鼎-松山,2024-01-16,9103
6231,系微,6,0,6,群益金鼎-松山,2024-01-16,9103
0056,元大高股息,5,0,5,群益金鼎-松山,2024-01-16,9103
1568,倉佑,5,0,5,群益金鼎-松山,2024-01-16,9103
2002,中鋼,5,0,5,群益金鼎-松山,2024-01-16,9103
3013,晟銘電,5,0,5,群益金鼎-松山,2024-01-16,9103
3023,信邦,5,0,5,群益金鼎-松山,2024-01-16,9103
4563,百德,5,0,5,群益金鼎-松山,2024-01-16,9103
8349,�矬�,5,0,5,群益金鼎-松山,2024-01-16,9103
00888,永豐台灣ESG,4,0,4,群益金鼎-松山,2024-01-16,9103
2023,燁輝,4,0,4,群益金鼎-松山,2024-01-16,9103
2241,艾姆勒,4,0,4,群益金鼎-松山,2024-01-16,9103
2731,雄獅,4,0,4,群益金鼎-松山,2024-01-16,9103
6015,宏遠證,4,0,4,群益金鼎-松山,2024-01-16,9103
6505,台塑化,4,0,4,群益金鼎-松山,2024-01-16,9103
8034,榮群,5,1,4,群益金鼎-松山,2024-01-16,9103
00919,群益台灣精選高息,4,1,3,群益金鼎-松山,2024-01-16,9103
00937B,群益ESG投等債20,500,23,477,群益金鼎-松山,2024-01-17,9103
4960,誠美材,452,1,451,群益金鼎-松山,2024-01-17,9103
00664R,國泰臺灣加權反1,200,0,200,群益金鼎-松山,2024-01-17,9103
6026,福邦證,70,0,70,群益金鼎-松山,2024-01-17,9103
2344,華邦電,57,5,52,群益金鼎-松山,2024-01-17,9103
6164,華興,50,0,50,群益金鼎-松山,2024-01-17,9103
2486,一詮,57,15,42,群益金鼎-松山,2024-01-17,9103
00919,群益台灣精選高息,36,0,36,群益金鼎-松山,2024-01-17,9103
8085,福華,36,2,34,群益金鼎-松山,2024-01-17,9103
2371,大同,33,0,33,群益金鼎-松山,2024-01-17,9103
3228,金麗科,33,1,32,群益金鼎-松山,2024-01-17,9103
2454,聯發科,31,2,29,群益金鼎-松山,2024-01-17,9103
2382,廣達,48,19,29,群益金鼎-松山,2024-01-17,9103
00882,中信中國高股息,26,0,26,群益金鼎-松山,2024-01-17,9103
3036,文曄,36,11,25,群益金鼎-松山,2024-01-17,9103
00706L,期元大S＆P日圓正2,25,0,25,群益金鼎-松山,2024-01-17,9103
5222,全訊,25,0,25,群益金鼎-松山,2024-01-17,9103
00900,富邦特選高股息30,24,0,24,群益金鼎-松山,2024-01-17,9103
6770,力積電,22,0,22,群益金鼎-松山,2024-01-17,9103
00878,國泰永續高股息,20,0,20,群益金鼎-松山,2024-01-17,9103
00929,復華台灣科技優息,18,0,18,群益金鼎-松山,2024-01-17,9103
1605,華新,20,2,18,群益金鼎-松山,2024-01-17,9103
3324,雙鴻,24,6,18,群益金鼎-松山,2024-01-17,9103
6425,易發,18,0,18,群益金鼎-松山,2024-01-17,9103
00679B,元大美債20年,17,0,17,群益金鼎-松山,2024-01-17,9103
1312,國喬,16,0,16,群益金鼎-松山,2024-01-17,9103
8096,擎亞,18,2,16,群益金鼎-松山,2024-01-17,9103
2352,佳世達,15,2,13,群益金鼎-松山,2024-01-17,9103
2609,陽明,16,3,13,群益金鼎-松山,2024-01-17,9103
2303,聯電,12,0,12,群益金鼎-松山,2024-01-17,9103
00687B,國泰20年美債,12,0,12,群益金鼎-松山,2024-01-17,9103
1815,富喬,14,2,12,群益金鼎-松山,2024-01-17,9103
3450,聯鈞,12,0,12,群益金鼎-松山,2024-01-17,9103
5880,合庫金,12,0,12,群益金鼎-松山,2024-01-17,9103
0056,元大高股息,11,0,11,群益金鼎-松山,2024-01-17,9103
2882,國泰金,10,0,10,群益金鼎-松山,2024-01-17,9103
6472,保瑞,10,0,10,群益金鼎-松山,2024-01-17,9103
2208,台船,10,0,10,群益金鼎-松山,2024-01-17,9103
2428,興勤,10,0,10,群益金鼎-松山,2024-01-17,9103
4551,智伸科,10,0,10,群益金鼎-松山,2024-01-17,9103
2323,中環,9,0,9,群益金鼎-松山,2024-01-17,9103
2349,錸德,9,0,9,群益金鼎-松山,2024-01-17,9103
2362,藍天,15,6,9,群益金鼎-松山,2024-01-17,9103
2748,雲品,8,0,8,群益金鼎-松山,2024-01-17,9103
6533,晶心科,8,0,8,群益金鼎-松山,2024-01-17,9103
2383,台光電,7,0,7,群益金鼎-松山,2024-01-17,9103
2603,長榮,7,0,7,群益金鼎-松山,2024-01-17,9103
2892,第一金,7,0,7,群益金鼎-松山,2024-01-17,9103
3011,今皓,7,0,7,群益金鼎-松山,2024-01-17,9103
5515,建國,7,0,7,群益金鼎-松山,2024-01-17,9103
2409,友達,103,2,101,群益金鼎-松山,2024-01-18,9103
00706L,期元大S＆P日圓正2,61,0,61,群益金鼎-松山,2024-01-18,9103
3694,海華,70,10,60,群益金鼎-松山,2024-01-18,9103
6120,達運,62,2,60,群益金鼎-松山,2024-01-18,9103
2324,仁寶,152,99,53,群益金鼎-松山,2024-01-18,9103
00882,中信中國高股息,50,0,50,群益金鼎-松山,2024-01-18,9103
00929,復華台灣科技優息,47,0,47,群益金鼎-松山,2024-01-18,9103
2353,宏��,91,51,40,群益金鼎-松山,2024-01-18,9103
6179,亞通,40,0,40,群益金鼎-松山,2024-01-18,9103
2618,長榮航,31,0,31,群益金鼎-松山,2024-01-18,9103
3715,定穎投控,22,1,21,群益金鼎-松山,2024-01-18,9103
00633L,富邦上証正2,14,0,14,群益金鼎-松山,2024-01-18,9103
3325,旭品,14,0,14,群益金鼎-松山,2024-01-18,9103
2382,廣達,13,0,13,群益金鼎-松山,2024-01-18,9103
00878,國泰永續高股息,12,0,12,群益金鼎-松山,2024-01-18,9103
2882,國泰金,11,0,11,群益金鼎-松山,2024-01-18,9103
3017,奇鋐,11,0,11,群益金鼎-松山,2024-01-18,9103
00720B,元大投資級公司債,10,0,10,群益金鼎-松山,2024-01-18,9103
00637L,元大滬深300正2,10,0,10,群益金鼎-松山,2024-01-18,9103
2408,南亞科,10,0,10,群益金鼎-松山,2024-01-18,9103
2427,三商電,10,0,10,群益金鼎-松山,2024-01-18,9103
2886,兆豐金,10,0,10,群益金鼎-松山,2024-01-18,9103
2888,新光金,8,0,8,群益金鼎-松山,2024-01-18,9103
4188,安克,8,0,8,群益金鼎-松山,2024-01-18,9103
2201,裕隆,6,0,6,群益金鼎-松山,2024-01-18,9103
3105,穩懋,6,0,6,群益金鼎-松山,2024-01-18,9103
6742,澤米,6,0,6,群益金鼎-松山,2024-01-18,9103
00665L,富邦�琤肭磪囓�2,5,0,5,群益金鼎-松山,2024-01-18,9103
2606,裕民,5,0,5,群益金鼎-松山,2024-01-18,9103
2884,玉山金,5,0,5,群益金鼎-松山,2024-01-18,9103
3231,緯創,16,11,5,群益金鼎-松山,2024-01-18,9103
5609,中菲行,5,0,5,群益金鼎-松山,2024-01-18,9103
8076,伍豐,5,0,5,群益金鼎-松山,2024-01-18,9103
8936,國統,5,0,5,群益金鼎-松山,2024-01-18,9103
2368,金像電,4,0,4,群益金鼎-松山,2024-01-18,9103
3037,欣興,4,0,4,群益金鼎-松山,2024-01-18,9103
00671R,富邦NASDAQ反1,4,0,4,群益金鼎-松山,2024-01-18,9103
2887,台新金,4,0,4,群益金鼎-松山,2024-01-18,9103
4960,誠美材,5,1,4,群益金鼎-松山,2024-01-18,9103
5348,正能量智能,4,0,4,群益金鼎-松山,2024-01-18,9103
5425,台半,4,0,4,群益金鼎-松山,2024-01-18,9103
6278,台表科,4,0,4,群益金鼎-松山,2024-01-18,9103
6669,緯穎,3,0,3,群益金鼎-松山,2024-01-18,9103
00679B,元大美債20年,3,0,3,群益金鼎-松山,2024-01-18,9103
00688L,國泰20年美債正2,3,0,3,群益金鼎-松山,2024-01-18,9103
3032,偉訓,3,0,3,群益金鼎-松山,2024-01-18,9103
5426,振發,20,17,3,群益金鼎-松山,2024-01-18,9103
5608,四維航,3,0,3,群益金鼎-松山,2024-01-18,9103
6213,聯茂,3,0,3,群益金鼎-松山,2024-01-18,9103
6558,興能高,3,0,3,群益金鼎-松山,2024-01-18,9103
00680L,元大美債20正2,3025,0,3025,群益金鼎-松山,2024-01-19,9103
00935,野村臺灣新科技50,200,0,200,群益金鼎-松山,2024-01-19,9103
00878,國泰永續高股息,209,60,149,群益金鼎-松山,2024-01-19,9103
2356,英業達,119,12,107,群益金鼎-松山,2024-01-19,9103
2324,仁寶,104,1,103,群益金鼎-松山,2024-01-19,9103
00632R,元大台灣50反1,91,0,91,群益金鼎-松山,2024-01-19,9103
00706L,期元大S＆P日圓正2,80,0,80,群益金鼎-松山,2024-01-19,9103
2888,新光金,71,0,71,群益金鼎-松山,2024-01-19,9103
8027,鈦昇,70,1,69,群益金鼎-松山,2024-01-19,9103
3231,緯創,97,42,55,群益金鼎-松山,2024-01-19,9103
5222,全訊,50,0,50,群益金鼎-松山,2024-01-19,9103
3481,群創,53,10,43,群益金鼎-松山,2024-01-19,9103
2329,華泰,42,4,38,群益金鼎-松山,2024-01-19,9103
00687B,國泰20年美債,34,0,34,群益金鼎-松山,2024-01-19,9103
2363,矽統,30,2,28,群益金鼎-松山,2024-01-19,9103
6233,旺玖,29,1,28,群益金鼎-松山,2024-01-19,9103
00937B,群益ESG投等債20,25,0,25,群益金鼎-松山,2024-01-19,9103
2376,技嘉,25,3,22,群益金鼎-松山,2024-01-19,9103
00720B,元大投資級公司債,22,0,22,群益金鼎-松山,2024-01-19,9103
00655L,國泰中國A50正2,20,0,20,群益金鼎-松山,2024-01-19,9103
3042,晶技,20,0,20,群益金鼎-松山,2024-01-19,9103
00679B,元大美債20年,18,0,18,群益金鼎-松山,2024-01-19,9103
00929,復華台灣科技優息,19,1,18,群益金鼎-松山,2024-01-19,9103
8040,九暘,20,2,18,群益金鼎-松山,2024-01-19,9103
00919,群益台灣精選高息,11,0,11,群益金鼎-松山,2024-01-19,9103
2460,建通,10,0,10,群益金鼎-松山,2024-01-19,9103
5225,東科-KY,10,0,10,群益金鼎-松山,2024-01-19,9103
0056,元大高股息,9,0,9,群益金鼎-松山,2024-01-19,9103
2382,廣達,31,23,8,群益金鼎-松山,2024-01-19,9103
4956,光鋐,9,2,7,群益金鼎-松山,2024-01-19,9103
00650L,復華香港正2,6,0,6,群益金鼎-松山,2024-01-19,9103
00882,中信中國高股息,6,0,6,群益金鼎-松山,2024-01-19,9103
2303,聯電,7,1,6,群益金鼎-松山,2024-01-19,9103
2637,慧洋-KY,6,0,6,群益金鼎-松山,2024-01-19,9103
3380,明泰,6,0,6,群益金鼎-松山,2024-01-19,9103
3548,兆利,6,0,6,群益金鼎-松山,2024-01-19,9103
00931B,統一美債20年,5,0,5,群益金鼎-松山,2024-01-19,9103
00671R,富邦NASDAQ反1,5,0,5,群益金鼎-松山,2024-01-19,9103
2636,台驊控股,5,0,5,群益金鼎-松山,2024-01-19,9103
4414,如興,5,0,5,群益金鼎-松山,2024-01-19,9103
5328,華容,5,0,5,群益金鼎-松山,2024-01-19,9103
5452,佶優,5,0,5,群益金鼎-松山,2024-01-19,9103
5876,上海商銀,5,0,5,群益金鼎-松山,2024-01-19,9103
6005,群益證,5,0,5,群益金鼎-松山,2024-01-19,9103
6531,愛普*,7,2,5,群益金鼎-松山,2024-01-19,9103
6679,鈺太,5,0,5,群益金鼎-松山,2024-01-19,9103
8085,福華,5,0,5,群益金鼎-松山,2024-01-19,9103
2344,華邦電,5,1,4,群益金鼎-松山,2024-01-19,9103
2106,建大,3,0,3,群益金鼎-松山,2024-01-19,9103
3287,廣寰科,3,0,3,群益金鼎-松山,2024-01-19,9103
00680L,元大美債20正2,260,0,260,群益金鼎-松山,2024-01-22,9103
3481,群創,109,8,101,群益金鼎-松山,2024-01-22,9103
2359,所羅門,81,2,79,群益金鼎-松山,2024-01-22,9103
00937B,群益ESG投等債20,70,0,70,群益金鼎-松山,2024-01-22,9103
2353,宏��,75,14,61,群益金鼎-松山,2024-01-22,9103
00927,群益半導體收益,50,0,50,群益金鼎-松山,2024-01-22,9103
2316,楠梓電,42,0,42,群益金鼎-松山,2024-01-22,9103
5351,鈺創,41,2,39,群益金鼎-松山,2024-01-22,9103
2362,藍天,32,0,32,群益金鼎-松山,2024-01-22,9103
2641,正德,30,0,30,群益金鼎-松山,2024-01-22,9103
5608,四維航,30,0,30,群益金鼎-松山,2024-01-22,9103
4533,協易機,20,0,20,群益金鼎-松山,2024-01-22,9103
2465,麗臺,20,1,19,群益金鼎-松山,2024-01-22,9103
2383,台光電,16,0,16,群益金鼎-松山,2024-01-22,9103
00665L,富邦�琤肭磪囓�2,15,0,15,群益金鼎-松山,2024-01-22,9103
1605,華新,15,1,14,群益金鼎-松山,2024-01-22,9103
8085,福華,26,12,14,群益金鼎-松山,2024-01-22,9103
4960,誠美材,13,0,13,群益金鼎-松山,2024-01-22,9103
00919,群益台灣精選高息,12,0,12,群益金鼎-松山,2024-01-22,9103
00882,中信中國高股息,11,0,11,群益金鼎-松山,2024-01-22,9103
1503,士電,21,10,11,群益金鼎-松山,2024-01-22,9103
00632R,元大台灣50反1,10,0,10,群益金鼎-松山,2024-01-22,9103
0056,元大高股息,20,10,10,群益金鼎-松山,2024-01-22,9103
00830,國泰費城半導體,10,0,10,群益金鼎-松山,2024-01-22,9103
1432,大魯閣,10,0,10,群益金鼎-松山,2024-01-22,9103
3712,永崴投控,30,20,10,群益金鼎-松山,2024-01-22,9103
4543,萬在,10,0,10,群益金鼎-松山,2024-01-22,9103
8938,明安,10,0,10,群益金鼎-松山,2024-01-22,9103
2376,技嘉,29,19,10,群益金鼎-松山,2024-01-22,9103
3011,今皓,9,0,9,群益金鼎-松山,2024-01-22,9103
3037,欣興,10,2,8,群益金鼎-松山,2024-01-22,9103
2377,微星,10,2,8,群益金鼎-松山,2024-01-22,9103
3324,雙鴻,20,13,7,群益金鼎-松山,2024-01-22,9103
2002,中鋼,6,0,6,群益金鼎-松山,2024-01-22,9103
3289,宜特,6,0,6,群益金鼎-松山,2024-01-22,9103
2313,華通,5,0,5,群益金鼎-松山,2024-01-22,9103
2516,新建,5,0,5,群益金鼎-松山,2024-01-22,9103
2603,長榮,6,1,5,群益金鼎-松山,2024-01-22,9103
3693,營邦,7,2,5,群益金鼎-松山,2024-01-22,9103
4414,如興,5,0,5,群益金鼎-松山,2024-01-22,9103
6274,台燿,5,0,5,群益金鼎-松山,2024-01-22,9103
2609,陽明,9,5,4,群益金鼎-松山,2024-01-22,9103
00929,復華台灣科技優息,4,0,4,群益金鼎-松山,2024-01-22,9103
2540,愛山林,4,0,4,群益金鼎-松山,2024-01-22,9103
2892,第一金,4,0,4,群益金鼎-松山,2024-01-22,9103
4743,合一,4,0,4,群益金鼎-松山,2024-01-22,9103
6125,廣運,13,9,4,群益金鼎-松山,2024-01-22,9103
8936,國統,5,1,4,群益金鼎-松山,2024-01-22,9103
00850,元大臺灣ESG永續,3,0,3,群益金鼎-松山,2024-01-22,9103
2201,裕隆,3,0,3,群益金鼎-松山,2024-01-22,9103
2353,宏��,101,2,99,群益金鼎-松山,2024-01-23,9103
6239,力成,58,6,52,群益金鼎-松山,2024-01-23,9103
6164,華興,50,0,50,群益金鼎-松山,2024-01-23,9103
3673,TPK-KY,30,0,30,群益金鼎-松山,2024-01-23,9103
3149,正達,30,3,27,群益金鼎-松山,2024-01-23,9103
00706L,期元大S＆P日圓正2,20,0,20,群益金鼎-松山,2024-01-23,9103
2421,建準,37,17,20,群益金鼎-松山,2024-01-23,9103
3563,牧德,20,0,20,群益金鼎-松山,2024-01-23,9103
6188,廣明,20,0,20,群益金鼎-松山,2024-01-23,9103
2363,矽統,19,1,18,群益金鼎-松山,2024-01-23,9103
3324,雙鴻,25,7,18,群益金鼎-松山,2024-01-23,9103
2486,一詮,11,0,11,群益金鼎-松山,2024-01-23,9103
4960,誠美材,11,0,11,群益金鼎-松山,2024-01-23,9103
6127,九豪,13,2,11,群益金鼎-松山,2024-01-23,9103
3260,威剛,10,1,9,群益金鼎-松山,2024-01-23,9103
6150,撼訊,9,0,9,群益金鼎-松山,2024-01-23,9103
6237,驊訊,12,3,9,群益金鼎-松山,2024-01-23,9103
6799,來頡,9,0,9,群益金鼎-松山,2024-01-23,9103
2880,華南金,8,0,8,群益金鼎-松山,2024-01-23,9103
4979,華星光,10,2,8,群益金鼎-松山,2024-01-23,9103
3702,大聯大,7,0,7,群益金鼎-松山,2024-01-23,9103
00637L,元大滬深300正2,7,0,7,群益金鼎-松山,2024-01-23,9103
00937B,群益ESG投等債20,8,1,7,群益金鼎-松山,2024-01-23,9103
2454,聯發科,7,0,7,群益金鼎-松山,2024-01-23,9103
2884,玉山金,7,0,7,群益金鼎-松山,2024-01-23,9103
8155,博智,6,0,6,群益金鼎-松山,2024-01-23,9103
2409,友達,613,608,5,群益金鼎-松山,2024-01-23,9103
1524,耿鼎,5,0,5,群益金鼎-松山,2024-01-23,9103
2607,榮運,5,0,5,群益金鼎-松山,2024-01-23,9103
4414,如興,5,0,5,群益金鼎-松山,2024-01-23,9103
4968,立積,7,2,5,群益金鼎-松山,2024-01-23,9103
6233,旺玖,5,0,5,群益金鼎-松山,2024-01-23,9103
8068,全達,5,0,5,群益金鼎-松山,2024-01-23,9103
1720,生達,4,0,4,群益金鼎-松山,2024-01-23,9103
00751B,元大AAA至A公司債,6,2,4,群益金鼎-松山,2024-01-23,9103
2329,華泰,4,0,4,群益金鼎-松山,2024-01-23,9103
2408,南亞科,4,0,4,群益金鼎-松山,2024-01-23,9103
2892,第一金,4,0,4,群益金鼎-松山,2024-01-23,9103
3055,蔚華科,7,3,4,群益金鼎-松山,2024-01-23,9103
5269,祥碩,5,1,4,群益金鼎-松山,2024-01-23,9103
6278,台表科,4,0,4,群益金鼎-松山,2024-01-23,9103
8085,福華,6,2,4,群益金鼎-松山,2024-01-23,9103
2314,台揚,3,0,3,群益金鼎-松山,2024-01-23,9103
2106,建大,3,0,3,群益金鼎-松山,2024-01-23,9103
2465,麗臺,7,4,3,群益金鼎-松山,2024-01-23,9103
6770,力積電,3,0,3,群益金鼎-松山,2024-01-23,9103
8096,擎亞,6,3,3,群益金鼎-松山,2024-01-23,9103
8936,國統,3,0,3,群益金鼎-松山,2024-01-23,9103
6531,愛普*,3,1,2,群益金鼎-松山,2024-01-23,9103
00881,國泰台灣5G+,2,0,2,群益金鼎-松山,2024-01-23,9103
00680L,元大美債20正2,2000,0,2000,群益金鼎-松山,2024-01-24,9103
2409,友達,442,1,441,群益金鼎-松山,2024-01-24,9103
2353,宏��,205,4,201,群益金鼎-松山,2024-01-24,9103
2906,高林,200,0,200,群益金鼎-松山,2024-01-24,9103
6116,彩晶,115,0,115,群益金鼎-松山,2024-01-24,9103
00937B,群益ESG投等債20,55,0,55,群益金鼎-松山,2024-01-24,9103
3481,群創,52,3,49,群益金鼎-松山,2024-01-24,9103
3694,海華,33,5,28,群益金鼎-松山,2024-01-24,9103
6770,力積電,25,1,24,群益金鼎-松山,2024-01-24,9103
3374,精材,22,0,22,群益金鼎-松山,2024-01-24,9103
3324,雙鴻,15,0,15,群益金鼎-松山,2024-01-24,9103
2465,麗臺,14,0,14,群益金鼎-松山,2024-01-24,9103
3623,富晶通,11,0,11,群益金鼎-松山,2024-01-24,9103
6237,驊訊,24,13,11,群益金鼎-松山,2024-01-24,9103
2324,仁寶,13,3,10,群益金鼎-松山,2024-01-24,9103
1905,華紙,10,0,10,群益金鼎-松山,2024-01-24,9103
00927,群益半導體收益,10,0,10,群益金鼎-松山,2024-01-24,9103
2332,友訊,10,0,10,群益金鼎-松山,2024-01-24,9103
3622,洋華,70,60,10,群益金鼎-松山,2024-01-24,9103
1514,亞力,12,5,7,群益金鼎-松山,2024-01-24,9103
3443,創意,6,0,6,群益金鼎-松山,2024-01-24,9103
3035,智原,8,2,6,群益金鼎-松山,2024-01-24,9103
8936,國統,12,6,6,群益金鼎-松山,2024-01-24,9103
2302,麗正,5,0,5,群益金鼎-松山,2024-01-24,9103
00929,復華台灣科技優息,5,0,5,群益金鼎-松山,2024-01-24,9103
00885,富邦越南,5,0,5,群益金鼎-松山,2024-01-24,9103
2356,英業達,25,20,5,群益金鼎-松山,2024-01-24,9103
3025,星通,16,11,5,群益金鼎-松山,2024-01-24,9103
3406,玉晶光,5,0,5,群益金鼎-松山,2024-01-24,9103
4414,如興,5,0,5,群益金鼎-松山,2024-01-24,9103
5871,中租-KY,5,0,5,群益金鼎-松山,2024-01-24,9103
6274,台燿,11,6,5,群益金鼎-松山,2024-01-24,9103
8050,廣積,6,1,5,群益金鼎-松山,2024-01-24,9103
6531,愛普*,5,1,4,群益金鼎-松山,2024-01-24,9103
00633L,富邦上証正2,4,0,4,群益金鼎-松山,2024-01-24,9103
2880,華南金,4,0,4,群益金鼎-松山,2024-01-24,9103
3706,神達,7,3,4,群益金鼎-松山,2024-01-24,9103
6789,采鈺,6,2,4,群益金鼎-松山,2024-01-24,9103
00632R,元大台灣50反1,5,2,3,群益金鼎-松山,2024-01-24,9103
2884,玉山金,3,0,3,群益金鼎-松山,2024-01-24,9103
3051,力特,3,0,3,群益金鼎-松山,2024-01-24,9103
5457,宣德,3,0,3,群益金鼎-松山,2024-01-24,9103
6127,九豪,6,3,3,群益金鼎-松山,2024-01-24,9103
8089,康全電訊,3,0,3,群益金鼎-松山,2024-01-24,9103
1301,台塑,2,0,2,群益金鼎-松山,2024-01-24,9103
00902,中信電池及儲能,2,0,2,群益金鼎-松山,2024-01-24,9103
00720B,元大投資級公司債,2,0,2,群益金鼎-松山,2024-01-24,9103
00636,國泰中國A50,2,0,2,群益金鼎-松山,2024-01-24,9103
2369,菱生,37,35,2,群益金鼎-松山,2024-01-24,9103
2892,第一金,2,0,2,群益金鼎-松山,2024-01-24,9103
00935,野村臺灣新科技50,200,0,200,群益金鼎-松山,2024-01-25,9103
2365,昆盈,77,12,65,群益金鼎-松山,2024-01-25,9103
00929,復華台灣科技優息,65,0,65,群益金鼎-松山,2024-01-25,9103
3376,新日興,60,5,55,群益金鼎-松山,2024-01-25,9103
00665L,富邦�琤肭磪囓�2,52,0,52,群益金鼎-松山,2024-01-25,9103
00687B,國泰20年美債,30,0,30,群益金鼎-松山,2024-01-25,9103
3481,群創,145,117,28,群益金鼎-松山,2024-01-25,9103
00680L,元大美債20正2,22,0,22,群益金鼎-松山,2024-01-25,9103
00753L,中信中國50正2,20,0,20,群益金鼎-松山,2024-01-25,9103
3490,單井,20,0,20,群益金鼎-松山,2024-01-25,9103
00640L,富邦日本正2,16,0,16,群益金鼎-松山,2024-01-25,9103
00751B,元大AAA至A公司債,15,0,15,群益金鼎-松山,2024-01-25,9103
00637L,元大滬深300正2,14,0,14,群益金鼎-松山,2024-01-25,9103
00885,富邦越南,14,0,14,群益金鼎-松山,2024-01-25,9103
3694,海華,17,4,13,群益金鼎-松山,2024-01-25,9103
00696B,富邦美債20年,11,0,11,群益金鼎-松山,2024-01-25,9103
2383,台光電,11,0,11,群益金鼎-松山,2024-01-25,9103
3563,牧德,11,0,11,群益金鼎-松山,2024-01-25,9103
00830,國泰費城半導體,10,0,10,群益金鼎-松山,2024-01-25,9103
00679B,元大美債20年,11,1,10,群益金鼎-松山,2024-01-25,9103
00650L,復華香港正2,10,0,10,群益金鼎-松山,2024-01-25,9103
00670L,富邦NASDAQ正2,10,0,10,群益金鼎-松山,2024-01-25,9103
2603,長榮,11,1,10,群益金鼎-松山,2024-01-25,9103
3548,兆利,11,3,8,群益金鼎-松山,2024-01-25,9103
00632R,元大台灣50反1,7,0,7,群益金鼎-松山,2024-01-25,9103
6111,大宇資,7,0,7,群益金鼎-松山,2024-01-25,9103
2636,台驊控股,6,0,6,群益金鼎-松山,2024-01-25,9103
3017,奇鋐,6,0,6,群益金鼎-松山,2024-01-25,9103
00715L,期街口布蘭特正2,5,0,5,群益金鼎-松山,2024-01-25,9103
6235,華孚,5,0,5,群益金鼎-松山,2024-01-25,9103
00937B,群益ESG投等債20,7,2,5,群益金鼎-松山,2024-01-25,9103
1560,中砂,5,0,5,群益金鼎-松山,2024-01-25,9103
2615,萬海,5,0,5,群益金鼎-松山,2024-01-25,9103
4956,光鋐,6,1,5,群益金鼎-松山,2024-01-25,9103
1409,新纖,4,0,4,群益金鼎-松山,2024-01-25,9103
1589,永冠-KY,4,0,4,群益金鼎-松山,2024-01-25,9103
2423,固緯,4,0,4,群益金鼎-松山,2024-01-25,9103
3042,晶技,4,0,4,群益金鼎-松山,2024-01-25,9103
3615,安可,5,1,4,群益金鼎-松山,2024-01-25,9103
3693,營邦,4,0,4,群益金鼎-松山,2024-01-25,9103
3702,大聯大,4,0,4,群益金鼎-松山,2024-01-25,9103
6799,來頡,4,0,4,群益金鼎-松山,2024-01-25,9103
00919,群益台灣精選高息,3,0,3,群益金鼎-松山,2024-01-25,9103
00688L,國泰20年美債正2,3,0,3,群益金鼎-松山,2024-01-25,9103
1809,中釉,3,0,3,群益金鼎-松山,2024-01-25,9103
2313,華通,3,0,3,群益金鼎-松山,2024-01-25,9103
2609,陽明,3,0,3,群益金鼎-松山,2024-01-25,9103
2892,第一金,3,0,3,群益金鼎-松山,2024-01-25,9103
3354,律勝,4,1,3,群益金鼎-松山,2024-01-25,9103
3605,宏致,3,0,3,群益金鼎-松山,2024-01-25,9103
9105,泰金寶-DR,211,1,210,群益金鼎-松山,2024-01-26,9103
6116,彩晶,100,0,100,群益金鼎-松山,2024-01-26,9103
8936,國統,102,6,96,群益金鼎-松山,2024-01-26,9103
3374,精材,65,0,65,群益金鼎-松山,2024-01-26,9103
2867,三商壽,40,0,40,群益金鼎-松山,2024-01-26,9103
6229,研通,30,0,30,群益金鼎-松山,2024-01-26,9103
00900,富邦特選高股息30,25,0,25,群益金鼎-松山,2024-01-26,9103
3545,敦泰,20,0,20,群益金鼎-松山,2024-01-26,9103
00632R,元大台灣50反1,17,0,17,群益金鼎-松山,2024-01-26,9103
2412,中華電,16,0,16,群益金鼎-松山,2024-01-26,9103
6732,昇佳電子,16,0,16,群益金鼎-松山,2024-01-26,9103
1722,台肥,15,0,15,群益金鼎-松山,2024-01-26,9103
2303,聯電,46,32,14,群益金鼎-松山,2024-01-26,9103
6274,台燿,11,0,11,群益金鼎-松山,2024-01-26,9103
00830,國泰費城半導體,10,0,10,群益金鼎-松山,2024-01-26,9103
1909,榮成,10,0,10,群益金鼎-松山,2024-01-26,9103
00679B,元大美債20年,10,0,10,群益金鼎-松山,2024-01-26,9103
00637L,元大滬深300正2,10,0,10,群益金鼎-松山,2024-01-26,9103
00762,元大全球AI,10,0,10,群益金鼎-松山,2024-01-26,9103
00753L,中信中國50正2,10,0,10,群益金鼎-松山,2024-01-26,9103
00933B,國泰10Y+金融債,10,0,10,群益金鼎-松山,2024-01-26,9103
2377,微星,10,0,10,群益金鼎-松山,2024-01-26,9103
2603,長榮,10,0,10,群益金鼎-松山,2024-01-26,9103
3376,新日興,10,0,10,群益金鼎-松山,2024-01-26,9103
3694,海華,31,21,10,群益金鼎-松山,2024-01-26,9103
4746,台耀,10,0,10,群益金鼎-松山,2024-01-26,9103
4968,立積,12,3,9,群益金鼎-松山,2024-01-26,9103
3380,明泰,11,3,8,群益金鼎-松山,2024-01-26,9103
00918,大華優利高填息30,7,0,7,群益金鼎-松山,2024-01-26,9103
00687B,國泰20年美債,7,0,7,群益金鼎-松山,2024-01-26,9103
6462,神盾,9,2,7,群益金鼎-松山,2024-01-26,9103
2486,一詮,9,3,6,群益金鼎-松山,2024-01-26,9103
3360,尚立,16,10,6,群益金鼎-松山,2024-01-26,9103
00927,群益半導體收益,5,0,5,群益金鼎-松山,2024-01-26,9103
00882,中信中國高股息,10,5,5,群益金鼎-松山,2024-01-26,9103
2313,華通,5,0,5,群益金鼎-松山,2024-01-26,9103
2543,皇昌,5,0,5,群益金鼎-松山,2024-01-26,9103
3356,奇偶,5,0,5,群益金鼎-松山,2024-01-26,9103
3035,智原,4,0,4,群益金鼎-松山,2024-01-26,9103
0056,元大高股息,5,1,4,群益金鼎-松山,2024-01-26,9103
00696B,富邦美債20年,5,1,4,群益金鼎-松山,2024-01-26,9103
00665L,富邦�琤肭磪囓�2,4,0,4,群益金鼎-松山,2024-01-26,9103
00934,中信成長高股息,4,0,4,群益金鼎-松山,2024-01-26,9103
2344,華邦電,4,0,4,群益金鼎-松山,2024-01-26,9103
2382,廣達,6,2,4,群益金鼎-松山,2024-01-26,9103
4162,智擎,4,0,4,群益金鼎-松山,2024-01-26,9103
6113,亞矽,6,2,4,群益金鼎-松山,2024-01-26,9103
6235,華孚,4,0,4,群益金鼎-松山,2024-01-26,9103
8096,擎亞,6,2,4,群益金鼎-松山,2024-01-26,9103
3653,健策,4,1,3,群益金鼎-松山,2024-01-26,9103
3481,群創,102,12,90,群益金鼎-松山,2024-01-29,9103
4968,立積,60,21,39,群益金鼎-松山,2024-01-29,9103
00885,富邦越南,30,0,30,群益金鼎-松山,2024-01-29,9103
00933B,國泰10Y+金融債,30,0,30,群益金鼎-松山,2024-01-29,9103
6274,台燿,25,1,24,群益金鼎-松山,2024-01-29,9103
2454,聯發科,23,0,23,群益金鼎-松山,2024-01-29,9103
6829,千附精密,20,0,20,群益金鼎-松山,2024-01-29,9103
6425,易發,18,0,18,群益金鼎-松山,2024-01-29,9103
6679,鈺太,18,2,16,群益金鼎-松山,2024-01-29,9103
8050,廣積,16,0,16,群益金鼎-松山,2024-01-29,9103
2748,雲品,13,0,13,群益金鼎-松山,2024-01-29,9103
8054,安國,16,3,13,群益金鼎-松山,2024-01-29,9103
2412,中華電,12,0,12,群益金鼎-松山,2024-01-29,9103
00687B,國泰20年美債,11,0,11,群益金鼎-松山,2024-01-29,9103
1514,亞力,14,4,10,群益金鼎-松山,2024-01-29,9103
00706L,期元大S＆P日圓正2,10,0,10,群益金鼎-松山,2024-01-29,9103
2606,裕民,10,0,10,群益金鼎-松山,2024-01-29,9103
3623,富晶通,10,0,10,群益金鼎-松山,2024-01-29,9103
6229,研通,11,1,10,群益金鼎-松山,2024-01-29,9103
00633L,富邦上証正2,9,0,9,群益金鼎-松山,2024-01-29,9103
1722,台肥,10,1,9,群益金鼎-松山,2024-01-29,9103
6546,正基,10,1,9,群益金鼎-松山,2024-01-29,9103
4908,前鼎,14,6,8,群益金鼎-松山,2024-01-29,9103
6451,訊芯-KY,8,0,8,群益金鼎-松山,2024-01-29,9103
3296,勝德,7,0,7,群益金鼎-松山,2024-01-29,9103
2303,聯電,7,1,6,群益金鼎-松山,2024-01-29,9103
6432,今展科,6,0,6,群益金鼎-松山,2024-01-29,9103
1795,美時,5,0,5,群益金鼎-松山,2024-01-29,9103
1319,東陽,6,1,5,群益金鼎-松山,2024-01-29,9103
00919,群益台灣精選高息,5,0,5,群益金鼎-松山,2024-01-29,9103
6143,振曜,15,10,5,群益金鼎-松山,2024-01-29,9103
2368,金像電,7,2,5,群益金鼎-松山,2024-01-29,9103
00720B,元大投資級公司債,4,0,4,群益金鼎-松山,2024-01-29,9103
2486,一詮,5,2,3,群益金鼎-松山,2024-01-29,9103
3645,達邁,4,1,3,群益金鼎-松山,2024-01-29,9103
4763,材料-KY,3,0,3,群益金鼎-松山,2024-01-29,9103
6278,台表科,4,1,3,群益金鼎-松山,2024-01-29,9103
3704,合勤控,2,0,2,群益金鼎-松山,2024-01-29,9103
2327,國巨,2,0,2,群益金鼎-松山,2024-01-29,9103
00751B,元大AAA至A公司債,2,0,2,群益金鼎-松山,2024-01-29,9103
2201,裕隆,2,0,2,群益金鼎-松山,2024-01-29,9103
2355,敬鵬,3,1,2,群益金鼎-松山,2024-01-29,9103
2356,英業達,15,13,2,群益金鼎-松山,2024-01-29,9103
2393,億光,2,0,2,群益金鼎-松山,2024-01-29,9103
2421,建準,20,18,2,群益金鼎-松山,2024-01-29,9103
2605,新興,2,0,2,群益金鼎-松山,2024-01-29,9103
3228,金麗科,2,0,2,群益金鼎-松山,2024-01-29,9103
3294,英濟,2,0,2,群益金鼎-松山,2024-01-29,9103
3535,晶彩科,6,4,2,群益金鼎-松山,2024-01-29,9103
4909,新復興,4,2,2,群益金鼎-松山,2024-01-29,9103
9105,泰金寶-DR,100,0,100,群益金鼎-松山,2024-01-30,9103
3715,定穎投控,89,5,84,群益金鼎-松山,2024-01-30,9103
4908,前鼎,99,40,59,群益金鼎-松山,2024-01-30,9103
00662,富邦NASDAQ,30,0,30,群益金鼎-松山,2024-01-30,9103
3265,台星科,30,0,30,群益金鼎-松山,2024-01-30,9103
2330,台積電,31,1,30,群益金鼎-松山,2024-01-30,9103
00687B,國泰20年美債,25,0,25,群益金鼎-松山,2024-01-30,9103
6592,和潤企業,21,0,21,群益金鼎-松山,2024-01-30,9103
00637L,元大滬深300正2,21,1,20,群益金鼎-松山,2024-01-30,9103
2316,楠梓電,20,0,20,群益金鼎-松山,2024-01-30,9103
2399,映泰,20,0,20,群益金鼎-松山,2024-01-30,9103
4533,協易機,20,0,20,群益金鼎-松山,2024-01-30,9103
2329,華泰,22,4,18,群益金鼎-松山,2024-01-30,9103
00885,富邦越南,17,0,17,群益金鼎-松山,2024-01-30,9103
2383,台光電,25,11,14,群益金鼎-松山,2024-01-30,9103
3231,緯創,42,29,13,群益金鼎-松山,2024-01-30,9103
3702,大聯大,16,4,12,群益金鼎-松山,2024-01-30,9103
00929,復華台灣科技優息,11,0,11,群益金鼎-松山,2024-01-30,9103
00632R,元大台灣50反1,20,9,11,群益金鼎-松山,2024-01-30,9103
00753L,中信中國50正2,10,0,10,群益金鼎-松山,2024-01-30,9103
00882,中信中國高股息,10,0,10,群益金鼎-松山,2024-01-30,9103
2301,光寶科,10,0,10,群益金鼎-松山,2024-01-30,9103
4746,台耀,10,0,10,群益金鼎-松山,2024-01-30,9103
6425,易發,10,0,10,群益金鼎-松山,2024-01-30,9103
9929,秋雨,10,0,10,群益金鼎-松山,2024-01-30,9103
8227,巨有科技,10,1,9,群益金鼎-松山,2024-01-30,9103
2369,菱生,11,4,7,群益金鼎-松山,2024-01-30,9103
3025,星通,13,6,7,群益金鼎-松山,2024-01-30,9103
3360,尚立,38,31,7,群益金鼎-松山,2024-01-30,9103
2882,國泰金,6,0,6,群益金鼎-松山,2024-01-30,9103
00919,群益台灣精選高息,6,0,6,群益金鼎-松山,2024-01-30,9103
5213,亞昕,6,0,6,群益金鼎-松山,2024-01-30,9103
00715L,期街口布蘭特正2,5,0,5,群益金鼎-松山,2024-01-30,9103
1503,士電,11,6,5,群益金鼎-松山,2024-01-30,9103
1605,華新,5,0,5,群益金鼎-松山,2024-01-30,9103
1313,聯成,5,0,5,群益金鼎-松山,2024-01-30,9103
2460,建通,5,0,5,群益金鼎-松山,2024-01-30,9103
3006,晶豪科,10,5,5,群益金鼎-松山,2024-01-30,9103
3017,奇鋐,10,5,5,群益金鼎-松山,2024-01-30,9103
3312,弘憶股,5,0,5,群益金鼎-松山,2024-01-30,9103
3548,兆利,8,3,5,群益金鼎-松山,2024-01-30,9103
3693,營邦,10,5,5,群益金鼎-松山,2024-01-30,9103
6150,撼訊,15,10,5,群益金鼎-松山,2024-01-30,9103
6546,正基,5,0,5,群益金鼎-松山,2024-01-30,9103
6695,芯鼎,7,2,5,群益金鼎-松山,2024-01-30,9103
8076,伍豐,5,0,5,群益金鼎-松山,2024-01-30,9103
3443,創意,5,1,4,群益金鼎-松山,2024-01-30,9103
2515,中工,4,0,4,群益金鼎-松山,2024-01-30,9103
3545,敦泰,4,0,4,群益金鼎-松山,2024-01-30,9103
00937B,群益ESG投等債20,3,0,3,群益金鼎-松山,2024-01-30,9103
6592,和潤企業,79,0,79,群益金鼎-松山,2024-01-31,9103
00882,中信中國高股息,60,0,60,群益金鼎-松山,2024-01-31,9103
00679B,元大美債20年,53,0,53,群益金鼎-松山,2024-01-31,9103
00830,國泰費城半導體,52,0,52,群益金鼎-松山,2024-01-31,9103
8936,國統,56,19,37,群益金鼎-松山,2024-01-31,9103
4968,立積,41,5,36,群益金鼎-松山,2024-01-31,9103
3545,敦泰,32,0,32,群益金鼎-松山,2024-01-31,9103
1432,大魯閣,30,0,30,群益金鼎-松山,2024-01-31,9103
6530,創威,28,0,28,群益金鼎-松山,2024-01-31,9103
2301,光寶科,23,1,22,群益金鼎-松山,2024-01-31,9103
00670L,富邦NASDAQ正2,20,0,20,群益金鼎-松山,2024-01-31,9103
00900,富邦特選高股息30,20,0,20,群益金鼎-松山,2024-01-31,9103
2352,佳世達,15,0,15,群益金鼎-松山,2024-01-31,9103
2383,台光電,18,3,15,群益金鼎-松山,2024-01-31,9103
3520,華盈,16,1,15,群益金鼎-松山,2024-01-31,9103
00919,群益台灣精選高息,20,7,13,群益金鼎-松山,2024-01-31,9103
2465,麗臺,19,6,13,群益金鼎-松山,2024-01-31,9103
00929,復華台灣科技優息,11,0,11,群益金鼎-松山,2024-01-31,9103
2382,廣達,16,5,11,群益金鼎-松山,2024-01-31,9103
3013,晟銘電,11,0,11,群益金鼎-松山,2024-01-31,9103
00706L,期元大S＆P日圓正2,10,0,10,群益金鼎-松山,2024-01-31,9103
5425,台半,10,0,10,群益金鼎-松山,2024-01-31,9103
5432,新門,10,0,10,群益金鼎-松山,2024-01-31,9103
6425,易發,10,0,10,群益金鼎-松山,2024-01-31,9103
00715L,期街口布蘭特正2,9,0,9,群益金鼎-松山,2024-01-31,9103
1418,東華,11,2,9,群益金鼎-松山,2024-01-31,9103
2329,華泰,10,1,9,群益金鼎-松山,2024-01-31,9103
3231,緯創,19,11,8,群益金鼎-松山,2024-01-31,9103
2303,聯電,9,1,8,群益金鼎-松山,2024-01-31,9103
3037,欣興,10,2,8,群益金鼎-松山,2024-01-31,9103
00795B,中信美國公債20年,6,0,6,群益金鼎-松山,2024-01-31,9103
6546,正基,11,5,6,群益金鼎-松山,2024-01-31,9103
00632R,元大台灣50反1,10,5,5,群益金鼎-松山,2024-01-31,9103
00693U,期街口S＆P黃豆,5,0,5,群益金鼎-松山,2024-01-31,9103
00680L,元大美債20正2,5,0,5,群益金鼎-松山,2024-01-31,9103
5348,正能量智能,5,0,5,群益金鼎-松山,2024-01-31,9103
2355,敬鵬,4,0,4,群益金鼎-松山,2024-01-31,9103
4174,浩鼎,4,0,4,群益金鼎-松山,2024-01-31,9103
6180,橘子,4,0,4,群益金鼎-松山,2024-01-31,9103
8096,擎亞,12,8,4,群益金鼎-松山,2024-01-31,9103
9929,秋雨,4,0,4,群益金鼎-松山,2024-01-31,9103
2356,英業達,25,22,3,群益金鼎-松山,2024-01-31,9103
2353,宏��,3,0,3,群益金鼎-松山,2024-01-31,9103
4979,華星光,5,2,3,群益金鼎-松山,2024-01-31,9103
8076,伍豐,3,0,3,群益金鼎-松山,2024-01-31,9103
2308,台達電,2,0,2,群益金鼎-松山,2024-01-31,9103
1584,精剛,2,0,2,群益金鼎-松山,2024-01-31,9103
00712,復華富時不動產,2,0,2,群益金鼎-松山,2024-01-31,9103
00687B,國泰20年美債,2,0,2,群益金鼎-松山,2024-01-31,9103
2328,廣宇,2,0,2,群益金鼎-松山,2024-01-31,9103
6282,康舒,152,17,135,群益金鼎-松山,2024-02-01,9103
6164,華興,100,0,100,群益金鼎-松山,2024-02-01,9103
3376,新日興,55,7,48,群益金鼎-松山,2024-02-01,9103
1513,中興電,46,2,44,群益金鼎-松山,2024-02-01,9103
00712,復華富時不動產,43,0,43,群益金鼎-松山,2024-02-01,9103
1503,士電,48,8,40,群益金鼎-松山,2024-02-01,9103
3265,台星科,30,0,30,群益金鼎-松山,2024-02-01,9103
3694,海華,35,5,30,群益金鼎-松山,2024-02-01,9103
00885,富邦越南,28,1,27,群益金鼎-松山,2024-02-01,9103
6180,橘子,30,4,26,群益金鼎-松山,2024-02-01,9103
00878,國泰永續高股息,31,10,21,群益金鼎-松山,2024-02-01,9103
00706L,期元大S＆P日圓正2,20,0,20,群益金鼎-松山,2024-02-01,9103
2461,光群雷,20,0,20,群益金鼎-松山,2024-02-01,9103
6274,台燿,19,0,19,群益金鼎-松山,2024-02-01,9103
00665L,富邦�琤肭磪囓�2,15,0,15,群益金鼎-松山,2024-02-01,9103
00929,復華台灣科技優息,16,1,15,群益金鼎-松山,2024-02-01,9103
5609,中菲行,15,0,15,群益金鼎-松山,2024-02-01,9103
3025,星通,24,10,14,群益金鼎-松山,2024-02-01,9103
3540,曜越,14,0,14,群益金鼎-松山,2024-02-01,9103
2468,華經,13,0,13,群益金鼎-松山,2024-02-01,9103
2421,建準,21,9,12,群益金鼎-松山,2024-02-01,9103
4116,明基醫,12,0,12,群益金鼎-松山,2024-02-01,9103
4543,萬在,12,0,12,群益金鼎-松山,2024-02-01,9103
4744,皇將,12,0,12,群益金鼎-松山,2024-02-01,9103
2454,聯發科,13,2,11,群益金鼎-松山,2024-02-01,9103
6148,驊宏資,12,1,11,群益金鼎-松山,2024-02-01,9103
2014,中鴻,11,1,10,群益金鼎-松山,2024-02-01,9103
8210,勤誠,12,2,10,群益金鼎-松山,2024-02-01,9103
1432,大魯閣,10,0,10,群益金鼎-松山,2024-02-01,9103
1514,亞力,13,3,10,群益金鼎-松山,2024-02-01,9103
2607,榮運,10,0,10,群益金鼎-松山,2024-02-01,9103
2812,台中銀,11,1,10,群益金鼎-松山,2024-02-01,9103
5009,榮剛,10,0,10,群益金鼎-松山,2024-02-01,9103
5230,雷笛克光學,10,0,10,群益金鼎-松山,2024-02-01,9103
5272,笙科,10,0,10,群益金鼎-松山,2024-02-01,9103
5344,立衛,10,0,10,群益金鼎-松山,2024-02-01,9103
5512,力麒,10,0,10,群益金鼎-松山,2024-02-01,9103
5706,鳳凰,10,0,10,群益金鼎-松山,2024-02-01,9103
6285,啟��,10,0,10,群益金鼎-松山,2024-02-01,9103
6548,長科*,10,0,10,群益金鼎-松山,2024-02-01,9103
6684,安格,16,6,10,群益金鼎-松山,2024-02-01,9103
2453,凌群,9,0,9,群益金鼎-松山,2024-02-01,9103
4533,協易機,9,0,9,群益金鼎-松山,2024-02-01,9103
5871,中租-KY,10,1,9,群益金鼎-松山,2024-02-01,9103
2884,玉山金,8,0,8,群益金鼎-松山,2024-02-01,9103
3324,雙鴻,15,7,8,群益金鼎-松山,2024-02-01,9103
5210,寶碩,8,0,8,群益金鼎-松山,2024-02-01,9103
2482,連宇,7,0,7,群益金鼎-松山,2024-02-01,9103
6111,大宇資,7,0,7,群益金鼎-松山,2024-02-01,9103
2303,聯電,8,2,6,群益金鼎-松山,2024-02-01,9103
3374,精材,295,159,136,群益金鼎-松山,2024-02-02,9103
8996,高力,51,1,50,群益金鼎-松山,2024-02-02,9103
3548,兆利,46,13,33,群益金鼎-松山,2024-02-02,9103
00933B,國泰10Y+金融債,30,0,30,群益金鼎-松山,2024-02-02,9103
2645,長榮航太,30,0,30,群益金鼎-松山,2024-02-02,9103
4533,協易機,30,0,30,群益金鼎-松山,2024-02-02,9103
5272,笙科,28,0,28,群益金鼎-松山,2024-02-02,9103
6229,研通,28,0,28,群益金鼎-松山,2024-02-02,9103
00885,富邦越南,26,0,26,群益金鼎-松山,2024-02-02,9103
8085,福華,23,0,23,群益金鼎-松山,2024-02-02,9103
1815,富喬,20,0,20,群益金鼎-松山,2024-02-02,9103
00937B,群益ESG投等債20,20,2,18,群益金鼎-松山,2024-02-02,9103
2882,國泰金,16,0,16,群益金鼎-松山,2024-02-02,9103
2884,玉山金,16,0,16,群益金鼎-松山,2024-02-02,9103
3231,緯創,25,9,16,群益金鼎-松山,2024-02-02,9103
5225,東科-KY,16,1,15,群益金鼎-松山,2024-02-02,9103
8028,昇陽半導體,14,0,14,群益金鼎-松山,2024-02-02,9103
2421,建準,29,16,13,群益金鼎-松山,2024-02-02,9103
3006,晶豪科,12,0,12,群益金鼎-松山,2024-02-02,9103
6805,富世達,12,1,11,群益金鼎-松山,2024-02-02,9103
00712,復華富時不動產,10,0,10,群益金鼎-松山,2024-02-02,9103
00706L,期元大S＆P日圓正2,10,0,10,群益金鼎-松山,2024-02-02,9103
3055,蔚華科,12,2,10,群益金鼎-松山,2024-02-02,9103
3508,位速,10,0,10,群益金鼎-松山,2024-02-02,9103
4543,萬在,42,32,10,群益金鼎-松山,2024-02-02,9103
3376,新日興,12,3,9,群益金鼎-松山,2024-02-02,9103
6180,橘子,9,0,9,群益金鼎-松山,2024-02-02,9103
6118,建達,40,32,8,群益金鼎-松山,2024-02-02,9103
3360,尚立,7,0,7,群益金鼎-松山,2024-02-02,9103
3615,安可,12,5,7,群益金鼎-松山,2024-02-02,9103
6584,南俊國際,9,2,7,群益金鼎-松山,2024-02-02,9103
8069,元太,7,0,7,群益金鼎-松山,2024-02-02,9103
8076,伍豐,7,0,7,群益金鼎-松山,2024-02-02,9103
5347,世界,6,0,6,群益金鼎-松山,2024-02-02,9103
6243,迅杰,14,8,6,群益金鼎-松山,2024-02-02,9103
2201,裕隆,5,0,5,群益金鼎-松山,2024-02-02,9103
2362,藍天,5,0,5,群益金鼎-松山,2024-02-02,9103
2606,裕民,5,0,5,群益金鼎-松山,2024-02-02,9103
3025,星通,10,5,5,群益金鼎-松山,2024-02-02,9103
3033,威健,5,0,5,群益金鼎-松山,2024-02-02,9103
0056,元大高股息,5,1,4,群益金鼎-松山,2024-02-02,9103
2329,華泰,34,30,4,群益金鼎-松山,2024-02-02,9103
2465,麗臺,5,1,4,群益金鼎-松山,2024-02-02,9103
3712,永崴投控,4,0,4,群益金鼎-松山,2024-02-02,9103
8086,宏捷科,4,0,4,群益金鼎-松山,2024-02-02,9103
3711,日月光投控,3,0,3,群益金鼎-松山,2024-02-02,9103
00751B,元大AAA至A公司債,3,0,3,群益金鼎-松山,2024-02-02,9103
00919,群益台灣精選高息,6,3,3,群益金鼎-松山,2024-02-02,9103
2250,IKKA-KY,3,0,3,群益金鼎-松山,2024-02-02,9103
2344,華邦電,4,1,3,群益金鼎-松山,2024-02-02,9103
00712,復華富時不動產,130,0,130,群益金鼎-松山,2024-02-05,9103
3481,群創,120,2,118,群益金鼎-松山,2024-02-05,9103
00937B,群益ESG投等債20,91,0,91,群益金鼎-松山,2024-02-05,9103
2888,新光金,72,0,72,群益金鼎-松山,2024-02-05,9103
00706L,期元大S＆P日圓正2,70,0,70,群益金鼎-松山,2024-02-05,9103
00680L,元大美債20正2,66,0,66,群益金鼎-松山,2024-02-05,9103
00665L,富邦�琤肭磪囓�2,64,0,64,群益金鼎-松山,2024-02-05,9103
2618,長榮航,60,5,55,群益金鼎-松山,2024-02-05,9103
00715L,期街口布蘭特正2,54,0,54,群益金鼎-松山,2024-02-05,9103
3289,宜特,55,2,53,群益金鼎-松山,2024-02-05,9103
00830,國泰費城半導體,50,0,50,群益金鼎-松山,2024-02-05,9103
00687B,國泰20年美債,51,10,41,群益金鼎-松山,2024-02-05,9103
00640L,富邦日本正2,40,0,40,群益金鼎-松山,2024-02-05,9103
00678,群益那斯達克生技,30,0,30,群益金鼎-松山,2024-02-05,9103
8936,國統,30,0,30,群益金鼎-松山,2024-02-05,9103
00885,富邦越南,25,0,25,群益金鼎-松山,2024-02-05,9103
1605,華新,25,0,25,群益金鼎-松山,2024-02-05,9103
00670L,富邦NASDAQ正2,20,0,20,群益金鼎-松山,2024-02-05,9103
4960,誠美材,20,0,20,群益金鼎-松山,2024-02-05,9103
2421,建準,21,3,18,群益金鼎-松山,2024-02-05,9103
2892,第一金,16,0,16,群益金鼎-松山,2024-02-05,9103
2388,威盛,17,3,14,群益金鼎-松山,2024-02-05,9103
2884,玉山金,14,0,14,群益金鼎-松山,2024-02-05,9103
8054,安國,13,0,13,群益金鼎-松山,2024-02-05,9103
2352,佳世達,12,0,12,群益金鼎-松山,2024-02-05,9103
2331,精英,11,0,11,群益金鼎-松山,2024-02-05,9103
00754B,群益AAA-AA公司,10,0,10,群益金鼎-松山,2024-02-05,9103
2889,國票金,10,0,10,群益金鼎-松山,2024-02-05,9103
3380,明泰,10,0,10,群益金鼎-松山,2024-02-05,9103
3680,家登,10,0,10,群益金鼎-松山,2024-02-05,9103
6546,正基,12,2,10,群益金鼎-松山,2024-02-05,9103
6684,安格,10,0,10,群益金鼎-松山,2024-02-05,9103
8358,金居,10,0,10,群益金鼎-松山,2024-02-05,9103
00632R,元大台灣50反1,20,11,9,群益金鼎-松山,2024-02-05,9103
3037,欣興,9,0,9,群益金鼎-松山,2024-02-05,9103
5426,振發,9,0,9,群益金鼎-松山,2024-02-05,9103
6229,研通,10,1,9,群益金鼎-松山,2024-02-05,9103
6143,振曜,28,20,8,群益金鼎-松山,2024-02-05,9103
8349,�矬�,8,0,8,群益金鼎-松山,2024-02-05,9103
6533,晶心科,10,3,7,群益金鼎-松山,2024-02-05,9103
8076,伍豐,7,0,7,群益金鼎-松山,2024-02-05,9103
2363,矽統,7,1,6,群益金鼎-松山,2024-02-05,9103
2609,陽明,6,0,6,群益金鼎-松山,2024-02-05,9103
3011,今皓,6,0,6,群益金鼎-松山,2024-02-05,9103
00679B,元大美債20年,5,0,5,群益金鼎-松山,2024-02-05,9103
2485,兆赫,5,0,5,群益金鼎-松山,2024-02-05,9103
2615,萬海,5,0,5,群益金鼎-松山,2024-02-05,9103
3025,星通,11,6,5,群益金鼎-松山,2024-02-05,9103
3105,穩懋,5,0,5,群益金鼎-松山,2024-02-05,9103
5512,力麒,5,0,5,群益金鼎-松山,2024-02-05,9103
00680L,元大美債20正2,153,0,153,群益金鼎-松山,2024-02-15,9103
00937B,群益ESG投等債20,138,3,135,群益金鼎-松山,2024-02-15,9103
00712,復華富時不動產,121,0,121,群益金鼎-松山,2024-02-15,9103
00706L,期元大S＆P日圓正2,101,0,101,群益金鼎-松山,2024-02-15,9103
2505,國揚,100,0,100,群益金鼎-松山,2024-02-15,9103
2881,富邦金,100,3,97,群益金鼎-松山,2024-02-15,9103
00679B,元大美債20年,90,5,85,群益金鼎-松山,2024-02-15,9103
00687B,國泰20年美債,68,0,68,群益金鼎-松山,2024-02-15,9103
2455,全新,61,0,61,群益金鼎-松山,2024-02-15,9103
1522,堤維西,60,0,60,群益金鼎-松山,2024-02-15,9103
00878,國泰永續高股息,48,1,47,群益金鼎-松山,2024-02-15,9103
00919,群益台灣精選高息,34,0,34,群益金鼎-松山,2024-02-15,9103
8349,�矬�,33,0,33,群益金鼎-松山,2024-02-15,9103
4960,誠美材,31,0,31,群益金鼎-松山,2024-02-15,9103
00632R,元大台灣50反1,29,0,29,群益金鼎-松山,2024-02-15,9103
3044,健鼎,31,4,27,群益金鼎-松山,2024-02-15,9103
5521,工信,25,0,25,群益金鼎-松山,2024-02-15,9103
2634,漢翔,24,0,24,群益金鼎-松山,2024-02-15,9103
00885,富邦越南,21,0,21,群益金鼎-松山,2024-02-15,9103
2329,華泰,34,13,21,群益金鼎-松山,2024-02-15,9103
4147,中裕,20,0,20,群益金鼎-松山,2024-02-15,9103
3035,智原,29,10,19,群益金鼎-松山,2024-02-15,9103
8936,國統,20,3,17,群益金鼎-松山,2024-02-15,9103
00720B,元大投資級公司債,16,0,16,群益金鼎-松山,2024-02-15,9103
00933B,國泰10Y+金融債,20,6,14,群益金鼎-松山,2024-02-15,9103
8210,勤誠,25,12,13,群益金鼎-松山,2024-02-15,9103
1319,東陽,13,1,12,群益金鼎-松山,2024-02-15,9103
00665L,富邦�琤肭磪囓�2,12,0,12,群益金鼎-松山,2024-02-15,9103
2609,陽明,12,1,11,群益金鼎-松山,2024-02-15,9103
3036,文曄,12,2,10,群益金鼎-松山,2024-02-15,9103
3032,偉訓,12,2,10,群益金鼎-松山,2024-02-15,9103
3680,家登,11,1,10,群益金鼎-松山,2024-02-15,9103
3691,碩禾,10,0,10,群益金鼎-松山,2024-02-15,9103
4927,泰鼎-KY,10,0,10,群益金鼎-松山,2024-02-15,9103
8070,長華*,10,0,10,群益金鼎-松山,2024-02-15,9103
3481,群創,112,103,9,群益金鼎-松山,2024-02-15,9103
6204,艾華,7,0,7,群益金鼎-松山,2024-02-15,9103
3228,金麗科,7,0,7,群益金鼎-松山,2024-02-15,9103
00696B,富邦美債20年,6,0,6,群益金鼎-松山,2024-02-15,9103
2353,宏��,7,1,6,群益金鼎-松山,2024-02-15,9103
3483,力致,10,4,6,群益金鼎-松山,2024-02-15,9103
3511,矽瑪,6,0,6,群益金鼎-松山,2024-02-15,9103
3704,合勤控,6,0,6,群益金鼎-松山,2024-02-15,9103
6245,立端,6,0,6,群益金鼎-松山,2024-02-15,9103
6806,森崴能源,6,0,6,群益金鼎-松山,2024-02-15,9103
8054,安國,21,16,5,群益金鼎-松山,2024-02-15,9103
2250,IKKA-KY,5,0,5,群益金鼎-松山,2024-02-15,9103
5432,新門,5,0,5,群益金鼎-松山,2024-02-15,9103
6143,振曜,5,0,5,群益金鼎-松山,2024-02-15,9103
8409,商之器,5,0,5,群益金鼎-松山,2024-02-15,9103
00680L,元大美債20正2,2002,0,2002,群益金鼎-松山,2024-02-16,9103
3450,聯鈞,100,2,98,群益金鼎-松山,2024-02-16,9103
00929,復華台灣科技優息,112,15,97,群益金鼎-松山,2024-02-16,9103
8358,金居,100,4,96,群益金鼎-松山,2024-02-16,9103
6245,立端,67,0,67,群益金鼎-松山,2024-02-16,9103
1522,堤維西,60,0,60,群益金鼎-松山,2024-02-16,9103
3372,典範,100,51,49,群益金鼎-松山,2024-02-16,9103
00687B,國泰20年美債,46,0,46,群益金鼎-松山,2024-02-16,9103
3587,閎康,40,0,40,群益金鼎-松山,2024-02-16,9103
00720B,元大投資級公司債,40,0,40,群益金鼎-松山,2024-02-16,9103
2486,一詮,36,5,31,群益金鼎-松山,2024-02-16,9103
00706L,期元大S＆P日圓正2,30,0,30,群益金鼎-松山,2024-02-16,9103
3413,京鼎,30,0,30,群益金鼎-松山,2024-02-16,9103
1503,士電,53,26,27,群益金鼎-松山,2024-02-16,9103
2363,矽統,27,1,26,群益金鼎-松山,2024-02-16,9103
2329,華泰,74,50,24,群益金鼎-松山,2024-02-16,9103
00885,富邦越南,21,0,21,群益金鼎-松山,2024-02-16,9103
00888,永豐台灣ESG,20,0,20,群益金鼎-松山,2024-02-16,9103
00881,國泰台灣5G+,20,0,20,群益金鼎-松山,2024-02-16,9103
2457,飛宏,20,0,20,群益金鼎-松山,2024-02-16,9103
2884,玉山金,20,0,20,群益金鼎-松山,2024-02-16,9103
3617,碩天,20,0,20,群益金鼎-松山,2024-02-16,9103
00937B,群益ESG投等債20,20,1,19,群益金鼎-松山,2024-02-16,9103
3338,泰碩,19,0,19,群益金鼎-松山,2024-02-16,9103
2399,映泰,18,0,18,群益金鼎-松山,2024-02-16,9103
2353,宏��,55,40,15,群益金鼎-松山,2024-02-16,9103
2640,大車隊,17,2,15,群益金鼎-松山,2024-02-16,9103
6189,豐藝,21,6,15,群益金鼎-松山,2024-02-16,9103
2609,陽明,15,1,14,群益金鼎-松山,2024-02-16,9103
00665L,富邦�琤肭磪囓�2,16,5,11,群益金鼎-松山,2024-02-16,9103
00931B,統一美債20年,11,0,11,群益金鼎-松山,2024-02-16,9103
5871,中租-KY,10,0,10,群益金鼎-松山,2024-02-16,9103
2206,三陽工業,10,0,10,群益金鼎-松山,2024-02-16,9103
1101,台泥,40,30,10,群益金鼎-松山,2024-02-16,9103
00632R,元大台灣50反1,10,0,10,群益金鼎-松山,2024-02-16,9103
2383,台光電,12,2,10,群益金鼎-松山,2024-02-16,9103
5210,寶碩,10,0,10,群益金鼎-松山,2024-02-16,9103
6213,聯茂,12,2,10,群益金鼎-松山,2024-02-16,9103
8070,長華*,10,0,10,群益金鼎-松山,2024-02-16,9103
8210,勤誠,33,25,8,群益金鼎-松山,2024-02-16,9103
3044,健鼎,9,2,7,群益金鼎-松山,2024-02-16,9103
8054,安國,32,25,7,群益金鼎-松山,2024-02-16,9103
2204,中華,7,1,6,群益金鼎-松山,2024-02-16,9103
4939,亞電,6,0,6,群益金鼎-松山,2024-02-16,9103
3443,創意,11,6,5,群益金鼎-松山,2024-02-16,9103
2382,廣達,17,12,5,群益金鼎-松山,2024-02-16,9103
00795B,中信美國公債20年,5,0,5,群益金鼎-松山,2024-02-16,9103
3530,晶相光,15,10,5,群益金鼎-松山,2024-02-16,9103
3680,家登,6,1,5,群益金鼎-松山,2024-02-16,9103
6222,上揚,5,0,5,群益金鼎-松山,2024-02-16,9103
2409,友達,200,2,198,群益金鼎-松山,2024-02-19,9103
8277,商丞,97,0,97,群益金鼎-松山,2024-02-19,9103
3363,上詮,111,25,86,群益金鼎-松山,2024-02-19,9103
6125,廣運,89,7,82,群益金鼎-松山,2024-02-19,9103
00937B,群益ESG投等債20,79,10,69,群益金鼎-松山,2024-02-19,9103
3708,上緯投控,61,0,61,群益金鼎-松山,2024-02-19,9103
2365,昆盈,71,19,52,群益金鼎-松山,2024-02-19,9103
6290,良維,63,11,52,群益金鼎-松山,2024-02-19,9103
1710,東聯,50,0,50,群益金鼎-松山,2024-02-19,9103
8086,宏捷科,51,1,50,群益金鼎-松山,2024-02-19,9103
2367,燿華,42,0,42,群益金鼎-松山,2024-02-19,9103
2258,鴻華先進-創,40,0,40,群益金鼎-松山,2024-02-19,9103
6757,台灣虎航,40,0,40,群益金鼎-松山,2024-02-19,9103
8111,立��,40,0,40,群益金鼎-松山,2024-02-19,9103
2884,玉山金,39,4,35,群益金鼎-松山,2024-02-19,9103
6170,統振,51,20,31,群益金鼎-松山,2024-02-19,9103
2014,中鴻,30,0,30,群益金鼎-松山,2024-02-19,9103
4968,立積,31,1,30,群益金鼎-松山,2024-02-19,9103
6442,光聖,30,0,30,群益金鼎-松山,2024-02-19,9103
00878,國泰永續高股息,26,1,25,群益金鼎-松山,2024-02-19,9103
3623,富晶通,52,27,25,群益金鼎-松山,2024-02-19,9103
00687B,國泰20年美債,24,0,24,群益金鼎-松山,2024-02-19,9103
6789,采鈺,28,7,21,群益金鼎-松山,2024-02-19,9103
00720B,元大投資級公司債,20,0,20,群益金鼎-松山,2024-02-19,9103
00680L,元大美債20正2,20,0,20,群益金鼎-松山,2024-02-19,9103
2329,華泰,110,91,19,群益金鼎-松山,2024-02-19,9103
1514,亞力,74,56,18,群益金鼎-松山,2024-02-19,9103
2457,飛宏,18,2,16,群益金鼎-松山,2024-02-19,9103
3321,同泰,16,0,16,群益金鼎-松山,2024-02-19,9103
2399,映泰,15,0,15,群益金鼎-松山,2024-02-19,9103
1513,中興電,48,35,13,群益金鼎-松山,2024-02-19,9103
2201,裕隆,23,10,13,群益金鼎-松山,2024-02-19,9103
3356,奇偶,14,1,13,群益金鼎-松山,2024-02-19,9103
4909,新復興,19,6,13,群益金鼎-松山,2024-02-19,9103
4979,華星光,16,3,13,群益金鼎-松山,2024-02-19,9103
1815,富喬,13,1,12,群益金鼎-松山,2024-02-19,9103
2406,國碩,12,0,12,群益金鼎-松山,2024-02-19,9103
1609,大亞,11,0,11,群益金鼎-松山,2024-02-19,9103
00919,群益台灣精選高息,11,0,11,群益金鼎-松山,2024-02-19,9103
00637L,元大滬深300正2,10,0,10,群益金鼎-松山,2024-02-19,9103
00632R,元大台灣50反1,10,0,10,群益金鼎-松山,2024-02-19,9103
00933B,國泰10Y+金融債,10,0,10,群益金鼎-松山,2024-02-19,9103
2485,兆赫,10,0,10,群益金鼎-松山,2024-02-19,9103
4414,如興,10,0,10,群益金鼎-松山,2024-02-19,9103
4768,晶呈科技,10,0,10,群益金鼎-松山,2024-02-19,9103
5607,遠雄港,10,0,10,群益金鼎-松山,2024-02-19,9103
6535,順藥,10,0,10,群益金鼎-松山,2024-02-19,9103
8064,東捷,20,10,10,群益金鼎-松山,2024-02-19,9103
8093,保銳,10,0,10,群益金鼎-松山,2024-02-19,9103
9929,秋雨,10,0,10,群益金鼎-松山,2024-02-19,9103
00929,復華台灣科技優息,210,2,208,群益金鼎-松山,2024-02-20,9103
3481,群創,103,2,101,群益金鼎-松山,2024-02-20,9103
00830,國泰費城半導體,100,0,100,群益金鼎-松山,2024-02-20,9103
3005,神基,60,0,60,群益金鼎-松山,2024-02-20,9103
00937B,群益ESG投等債20,55,0,55,群益金鼎-松山,2024-02-20,9103
1447,力鵬,50,0,50,群益金鼎-松山,2024-02-20,9103
2049,上銀,41,0,41,群益金鼎-松山,2024-02-20,9103
1414,東和,43,3,40,群益金鼎-松山,2024-02-20,9103
2009,第一銅,40,0,40,群益金鼎-松山,2024-02-20,9103
2465,麗臺,50,10,40,群益金鼎-松山,2024-02-20,9103
4714,永捷,42,5,37,群益金鼎-松山,2024-02-20,9103
00706L,期元大S＆P日圓正2,31,0,31,群益金鼎-松山,2024-02-20,9103
2365,昆盈,61,31,30,群益金鼎-松山,2024-02-20,9103
2884,玉山金,24,0,24,群益金鼎-松山,2024-02-20,9103
3231,緯創,25,6,19,群益金鼎-松山,2024-02-20,9103
8096,擎亞,25,6,19,群益金鼎-松山,2024-02-20,9103
1605,華新,16,0,16,群益金鼎-松山,2024-02-20,9103
2637,慧洋-KY,21,5,16,群益金鼎-松山,2024-02-20,9103
00725B,國泰投資級公司債,15,0,15,群益金鼎-松山,2024-02-20,9103
2382,廣達,15,2,13,群益金鼎-松山,2024-02-20,9103
2476,鉅祥,13,0,13,群益金鼎-松山,2024-02-20,9103
5014,建錩,13,0,13,群益金鼎-松山,2024-02-20,9103
00687B,國泰20年美債,12,0,12,群益金鼎-松山,2024-02-20,9103
1589,永冠-KY,12,0,12,群益金鼎-松山,2024-02-20,9103
00720B,元大投資級公司債,11,0,11,群益金鼎-松山,2024-02-20,9103
00891,中信關鍵半導體,11,0,11,群益金鼎-松山,2024-02-20,9103
2353,宏��,11,0,11,群益金鼎-松山,2024-02-20,9103
2376,技嘉,14,3,11,群益金鼎-松山,2024-02-20,9103
1455,集盛,10,0,10,群益金鼎-松山,2024-02-20,9103
1303,南亞,10,0,10,群益金鼎-松山,2024-02-20,9103
00665L,富邦�琤肭磪囓�2,10,0,10,群益金鼎-松山,2024-02-20,9103
2377,微星,10,0,10,群益金鼎-松山,2024-02-20,9103
2421,建準,13,3,10,群益金鼎-松山,2024-02-20,9103
2882,國泰金,10,0,10,群益金鼎-松山,2024-02-20,9103
1815,富喬,10,1,9,群益金鼎-松山,2024-02-20,9103
6288,聯嘉,9,0,9,群益金鼎-松山,2024-02-20,9103
6695,芯鼎,9,0,9,群益金鼎-松山,2024-02-20,9103
00652,富邦印度,7,0,7,群益金鼎-松山,2024-02-20,9103
00688L,國泰20年美債正2,7,0,7,群益金鼎-松山,2024-02-20,9103
5225,東科-KY,7,0,7,群益金鼎-松山,2024-02-20,9103
3017,奇鋐,7,1,6,群益金鼎-松山,2024-02-20,9103
8936,國統,6,0,6,群益金鼎-松山,2024-02-20,9103
2368,金像電,5,0,5,群益金鼎-松山,2024-02-20,9103
00795B,中信美國公債20年,5,0,5,群益金鼎-松山,2024-02-20,9103
00680L,元大美債20正2,5,0,5,群益金鼎-松山,2024-02-20,9103
00881,國泰台灣5G+,5,0,5,群益金鼎-松山,2024-02-20,9103
2332,友訊,5,0,5,群益金鼎-松山,2024-02-20,9103
3025,星通,35,30,5,群益金鼎-松山,2024-02-20,9103
3042,晶技,5,0,5,群益金鼎-松山,2024-02-20,9103
3708,上緯投控,5,0,5,群益金鼎-松山,2024-02-20,9103
1806,冠軍,100,0,100,群益金鼎-松山,2024-02-21,9103
00712,復華富時不動產,62,0,62,群益金鼎-松山,2024-02-21,9103
00937B,群益ESG投等債20,58,0,58,群益金鼎-松山,2024-02-21,9103
00687B,國泰20年美債,52,0,52,群益金鼎-松山,2024-02-21,9103
2884,玉山金,51,0,51,群益金鼎-松山,2024-02-21,9103
5608,四維航,50,0,50,群益金鼎-松山,2024-02-21,9103
3376,新日興,48,3,45,群益金鼎-松山,2024-02-21,9103
00878,國泰永續高股息,41,0,41,群益金鼎-松山,2024-02-21,9103
2609,陽明,43,2,41,群益金鼎-松山,2024-02-21,9103
00655L,國泰中國A50正2,30,0,30,群益金鼎-松山,2024-02-21,9103
1514,亞力,30,1,29,群益金鼎-松山,2024-02-21,9103
6189,豐藝,27,1,26,群益金鼎-松山,2024-02-21,9103
5381,合正,25,1,24,群益金鼎-松山,2024-02-21,9103
3234,光環,23,0,23,群益金鼎-松山,2024-02-21,9103
5225,東科-KY,19,0,19,群益金鼎-松山,2024-02-21,9103
6125,廣運,20,2,18,群益金鼎-松山,2024-02-21,9103
3231,緯創,25,8,17,群益金鼎-松山,2024-02-21,9103
3702,大聯大,20,4,16,群益金鼎-松山,2024-02-21,9103
8433,弘帆,14,0,14,群益金鼎-松山,2024-02-21,9103
00679B,元大美債20年,13,0,13,群益金鼎-松山,2024-02-21,9103
6196,帆宣,13,0,13,群益金鼎-松山,2024-02-21,9103
6735,美達科技,13,0,13,群益金鼎-松山,2024-02-21,9103
00919,群益台灣精選高息,12,0,12,群益金鼎-松山,2024-02-21,9103
2383,台光電,11,0,11,群益金鼎-松山,2024-02-21,9103
3483,力致,14,3,11,群益金鼎-松山,2024-02-21,9103
1301,台塑,10,0,10,群益金鼎-松山,2024-02-21,9103
00665L,富邦�琤肭磪囓�2,10,0,10,群益金鼎-松山,2024-02-21,9103
00725B,國泰投資級公司債,10,0,10,群益金鼎-松山,2024-02-21,9103
00795B,中信美國公債20年,10,0,10,群益金鼎-松山,2024-02-21,9103
3265,台星科,10,0,10,群益金鼎-松山,2024-02-21,9103
4414,如興,10,0,10,群益金鼎-松山,2024-02-21,9103
8085,福華,51,41,10,群益金鼎-松山,2024-02-21,9103
2489,瑞軒,10,1,9,群益金鼎-松山,2024-02-21,9103
3163,波若威,18,9,9,群益金鼎-松山,2024-02-21,9103
3443,創意,10,2,8,群益金鼎-松山,2024-02-21,9103
4147,中裕,8,0,8,群益金鼎-松山,2024-02-21,9103
00891,中信關鍵半導體,7,0,7,群益金鼎-松山,2024-02-21,9103
2882,國泰金,7,0,7,群益金鼎-松山,2024-02-21,9103
3055,蔚華科,9,2,7,群益金鼎-松山,2024-02-21,9103
8054,安國,6,0,6,群益金鼎-松山,2024-02-21,9103
00637L,元大滬深300正2,10,5,5,群益金鼎-松山,2024-02-21,9103
00881,國泰台灣5G+,5,0,5,群益金鼎-松山,2024-02-21,9103
00830,國泰費城半導體,5,0,5,群益金鼎-松山,2024-02-21,9103
00762,元大全球AI,5,0,5,群益金鼎-松山,2024-02-21,9103
00752,中信中國50,5,0,5,群益金鼎-松山,2024-02-21,9103
2606,裕民,6,1,5,群益金鼎-松山,2024-02-21,9103
3094,聯傑,5,0,5,群益金鼎-松山,2024-02-21,9103
3324,雙鴻,6,1,5,群益金鼎-松山,2024-02-21,9103
3532,台勝科,4,0,4,群益金鼎-松山,2024-02-21,9103
6153,嘉聯益,4,0,4,群益金鼎-松山,2024-02-21,9103
00929,復華台灣科技優息,411,201,210,群益金鼎-松山,2024-02-22,9103
3706,神達,203,3,200,群益金鼎-松山,2024-02-22,9103
8926,台汽電,130,0,130,群益金鼎-松山,2024-02-22,9103
00650L,復華香港正2,100,0,100,群益金鼎-松山,2024-02-22,9103
6164,華興,201,101,100,群益金鼎-松山,2024-02-22,9103
00937B,群益ESG投等債20,64,0,64,群益金鼎-松山,2024-02-22,9103
2355,敬鵬,58,3,55,群益金鼎-松山,2024-02-22,9103
2367,燿華,50,0,50,群益金鼎-松山,2024-02-22,9103
2884,玉山金,45,0,45,群益金鼎-松山,2024-02-22,9103
2385,群光,40,0,40,群益金鼎-松山,2024-02-22,9103
00706L,期元大S＆P日圓正2,40,0,40,群益金鼎-松山,2024-02-22,9103
3013,晟銘電,41,2,39,群益金鼎-松山,2024-02-22,9103
2882,國泰金,35,3,32,群益金鼎-松山,2024-02-22,9103
00725B,國泰投資級公司債,31,0,31,群益金鼎-松山,2024-02-22,9103
3390,旭軟,30,0,30,群益金鼎-松山,2024-02-22,9103
4563,百德,40,10,30,群益金鼎-松山,2024-02-22,9103
00665L,富邦�琤肭磪囓�2,24,0,24,群益金鼎-松山,2024-02-22,9103
2329,華泰,89,65,24,群益金鼎-松山,2024-02-22,9103
00679B,元大美債20年,23,0,23,群益金鼎-松山,2024-02-22,9103
3483,力致,25,3,22,群益金鼎-松山,2024-02-22,9103
2399,映泰,20,0,20,群益金鼎-松山,2024-02-22,9103
5607,遠雄港,20,0,20,群益金鼎-松山,2024-02-22,9103
8089,康全電訊,18,0,18,群益金鼎-松山,2024-02-22,9103
3376,新日興,19,1,18,群益金鼎-松山,2024-02-22,9103
6125,廣運,16,0,16,群益金鼎-松山,2024-02-22,9103
8105,凌巨,16,1,15,群益金鼎-松山,2024-02-22,9103
1815,富喬,15,1,14,群益金鼎-松山,2024-02-22,9103
3231,緯創,22,8,14,群益金鼎-松山,2024-02-22,9103
00757,統一FANG+,14,1,13,群益金鼎-松山,2024-02-22,9103
1503,士電,56,44,12,群益金鼎-松山,2024-02-22,9103
3217,優群,12,0,12,群益金鼎-松山,2024-02-22,9103
00915,凱基優選高股息30,10,0,10,群益金鼎-松山,2024-02-22,9103
00933B,國泰10Y+金融債,10,0,10,群益金鼎-松山,2024-02-22,9103
1702,南僑,10,0,10,群益金鼎-松山,2024-02-22,9103
3036,文曄,12,2,10,群益金鼎-松山,2024-02-22,9103
3042,晶技,10,0,10,群益金鼎-松山,2024-02-22,9103
4414,如興,10,0,10,群益金鼎-松山,2024-02-22,9103
4909,新復興,11,1,10,群益金鼎-松山,2024-02-22,9103
6117,迎廣,14,4,10,群益金鼎-松山,2024-02-22,9103
6141,柏承,10,0,10,群益金鼎-松山,2024-02-22,9103
00687B,國泰20年美債,9,0,9,群益金鼎-松山,2024-02-22,9103
6138,茂達,9,0,9,群益金鼎-松山,2024-02-22,9103
9921,巨大,10,1,9,群益金鼎-松山,2024-02-22,9103
00720B,元大投資級公司債,8,0,8,群益金鼎-松山,2024-02-22,9103
3308,聯德,10,2,8,群益金鼎-松山,2024-02-22,9103
6462,神盾,10,2,8,群益金鼎-松山,2024-02-22,9103
6789,采鈺,7,0,7,群益金鼎-松山,2024-02-22,9103
00652,富邦印度,7,0,7,群益金鼎-松山,2024-02-22,9103
2353,宏��,7,0,7,群益金鼎-松山,2024-02-22,9103
6187,萬潤,10,3,7,群益金鼎-松山,2024-02-22,9103
2891,中信金,100,0,100,群益金鼎-松山,2024-02-23,9103
00637L,元大滬深300正2,85,2,83,群益金鼎-松山,2024-02-23,9103
00937B,群益ESG投等債20,51,0,51,群益金鼎-松山,2024-02-23,9103
1806,冠軍,50,0,50,群益金鼎-松山,2024-02-23,9103
6530,創威,45,1,44,群益金鼎-松山,2024-02-23,9103
8926,台汽電,68,25,43,群益金鼎-松山,2024-02-23,9103
00891,中信關鍵半導體,40,0,40,群益金鼎-松山,2024-02-23,9103
2884,玉山金,40,0,40,群益金鼎-松山,2024-02-23,9103
3037,欣興,43,4,39,群益金鼎-松山,2024-02-23,9103
00706L,期元大S＆P日圓正2,35,0,35,群益金鼎-松山,2024-02-23,9103
1514,亞力,93,58,35,群益金鼎-松山,2024-02-23,9103
8936,國統,34,1,33,群益金鼎-松山,2024-02-23,9103
00687B,國泰20年美債,27,0,27,群益金鼎-松山,2024-02-23,9103
00679B,元大美債20年,21,0,21,群益金鼎-松山,2024-02-23,9103
00931B,統一美債20年,20,0,20,群益金鼎-松山,2024-02-23,9103
1529,樂事綠能,20,0,20,群益金鼎-松山,2024-02-23,9103
2379,瑞昱,24,4,20,群益金鼎-松山,2024-02-23,9103
6189,豐藝,21,1,20,群益金鼎-松山,2024-02-23,9103
6465,威潤,20,0,20,群益金鼎-松山,2024-02-23,9103
1605,華新,18,0,18,群益金鼎-松山,2024-02-23,9103
3010,華立,16,0,16,群益金鼎-松山,2024-02-23,9103
2324,仁寶,15,0,15,群益金鼎-松山,2024-02-23,9103
3011,今皓,15,0,15,群益金鼎-松山,2024-02-23,9103
2313,華通,83,69,14,群益金鼎-松山,2024-02-23,9103
4908,前鼎,21,7,14,群益金鼎-松山,2024-02-23,9103
6257,矽格,14,1,13,群益金鼎-松山,2024-02-23,9103
00757,統一FANG+,13,0,13,群益金鼎-松山,2024-02-23,9103
3017,奇鋐,17,5,12,群益金鼎-松山,2024-02-23,9103
2382,廣達,21,10,11,群益金鼎-松山,2024-02-23,9103
3036,文曄,15,4,11,群益金鼎-松山,2024-02-23,9103
00725B,國泰投資級公司債,10,0,10,群益金鼎-松山,2024-02-23,9103
00665L,富邦�琤肭磪囓�2,10,0,10,群益金鼎-松山,2024-02-23,9103
1524,耿鼎,10,0,10,群益金鼎-松山,2024-02-23,9103
2206,三陽工業,11,1,10,群益金鼎-松山,2024-02-23,9103
3118,進階,10,0,10,群益金鼎-松山,2024-02-23,9103
3360,尚立,50,40,10,群益金鼎-松山,2024-02-23,9103
3551,世禾,10,0,10,群益金鼎-松山,2024-02-23,9103
6270,倍微,10,0,10,群益金鼎-松山,2024-02-23,9103
9105,泰金寶-DR,10,0,10,群益金鼎-松山,2024-02-23,9103
6531,愛普*,9,0,9,群益金鼎-松山,2024-02-23,9103
3312,弘憶股,18,9,9,群益金鼎-松山,2024-02-23,9103
3019,亞光,8,0,8,群益金鼎-松山,2024-02-23,9103
4205,中華食,8,0,8,群益金鼎-松山,2024-02-23,9103
8163,達方,8,0,8,群益金鼎-松山,2024-02-23,9103
2421,建準,11,4,7,群益金鼎-松山,2024-02-23,9103
4714,永捷,7,0,7,群益金鼎-松山,2024-02-23,9103
2486,一詮,15,9,6,群益金鼎-松山,2024-02-23,9103
00652,富邦印度,6,0,6,群益金鼎-松山,2024-02-23,9103
2062,橋椿,7,1,6,群益金鼎-松山,2024-02-23,9103
3131,弘塑,6,0,6,群益金鼎-松山,2024-02-23,9103
00937B,群益ESG投等債20,279,0,279,群益金鼎-松山,2024-02-26,9103
5388,中磊,100,0,100,群益金鼎-松山,2024-02-26,9103
2884,玉山金,82,0,82,群益金鼎-松山,2024-02-26,9103
00764B,群益25年美債,62,0,62,群益金鼎-松山,2024-02-26,9103
6274,台燿,52,0,52,群益金鼎-松山,2024-02-26,9103
2641,正德,51,0,51,群益金鼎-松山,2024-02-26,9103
2031,新光鋼,41,1,40,群益金鼎-松山,2024-02-26,9103
6668,中揚光,40,0,40,群益金鼎-松山,2024-02-26,9103
8085,福華,55,19,36,群益金鼎-松山,2024-02-26,9103
5381,合正,32,1,31,群益金鼎-松山,2024-02-26,9103
1513,中興電,72,42,30,群益金鼎-松山,2024-02-26,9103
4953,緯軟,30,1,29,群益金鼎-松山,2024-02-26,9103
3708,上緯投控,30,1,29,群益金鼎-松山,2024-02-26,9103
6168,宏齊,30,1,29,群益金鼎-松山,2024-02-26,9103
00878,國泰永續高股息,42,15,27,群益金鼎-松山,2024-02-26,9103
8210,勤誠,25,3,22,群益金鼎-松山,2024-02-26,9103
00933B,國泰10Y+金融債,21,0,21,群益金鼎-松山,2024-02-26,9103
00665L,富邦�琤肭磪囓�2,20,0,20,群益金鼎-松山,2024-02-26,9103
2605,新興,20,0,20,群益金鼎-松山,2024-02-26,9103
3041,揚智,20,0,20,群益金鼎-松山,2024-02-26,9103
3360,尚立,30,10,20,群益金鼎-松山,2024-02-26,9103
4746,台耀,20,0,20,群益金鼎-松山,2024-02-26,9103
6164,華興,50,30,20,群益金鼎-松山,2024-02-26,9103
6270,倍微,20,0,20,群益金鼎-松山,2024-02-26,9103
2329,華泰,21,2,19,群益金鼎-松山,2024-02-26,9103
2363,矽統,113,94,19,群益金鼎-松山,2024-02-26,9103
3325,旭品,16,0,16,群益金鼎-松山,2024-02-26,9103
6806,森崴能源,16,1,15,群益金鼎-松山,2024-02-26,9103
3712,永崴投控,21,6,15,群益金鼎-松山,2024-02-26,9103
2892,第一金,15,0,15,群益金鼎-松山,2024-02-26,9103
3702,大聯大,16,4,12,群益金鼎-松山,2024-02-26,9103
3363,上詮,14,2,12,群益金鼎-松山,2024-02-26,9103
3227,原相,12,1,11,群益金鼎-松山,2024-02-26,9103
6684,安格,41,30,11,群益金鼎-松山,2024-02-26,9103
6462,神盾,20,10,10,群益金鼎-松山,2024-02-26,9103
00725B,國泰投資級公司債,10,0,10,群益金鼎-松山,2024-02-26,9103
1815,富喬,11,1,10,群益金鼎-松山,2024-02-26,9103
2457,飛宏,10,0,10,群益金鼎-松山,2024-02-26,9103
2887,台新金,10,0,10,群益金鼎-松山,2024-02-26,9103
3032,偉訓,10,0,10,群益金鼎-松山,2024-02-26,9103
6425,易發,20,10,10,群益金鼎-松山,2024-02-26,9103
3530,晶相光,10,0,10,群益金鼎-松山,2024-02-26,9103
6288,聯嘉,8,0,8,群益金鼎-松山,2024-02-26,9103
8147,正淩,8,0,8,群益金鼎-松山,2024-02-26,9103
2609,陽明,10,3,7,群益金鼎-松山,2024-02-26,9103
00652,富邦印度,7,0,7,群益金鼎-松山,2024-02-26,9103
2206,三陽工業,9,2,7,群益金鼎-松山,2024-02-26,9103
6290,良維,22,15,7,群益金鼎-松山,2024-02-26,9103
3228,金麗科,6,0,6,群益金鼎-松山,2024-02-26,9103
2353,宏��,7,1,6,群益金鼎-松山,2024-02-26,9103
4526,東台,124,0,124,群益金鼎-松山,2024-02-27,9103
2324,仁寶,223,171,52,群益金鼎-松山,2024-02-27,9103
2845,遠東銀,50,0,50,群益金鼎-松山,2024-02-27,9103
00687B,國泰20年美債,47,2,45,群益金鼎-松山,2024-02-27,9103
00706L,期元大S＆P日圓正2,40,0,40,群益金鼎-松山,2024-02-27,9103
00712,復華富時不動產,37,0,37,群益金鼎-松山,2024-02-27,9103
00937B,群益ESG投等債20,35,0,35,群益金鼎-松山,2024-02-27,9103
6770,力積電,42,10,32,群益金鼎-松山,2024-02-27,9103
00919,群益台灣精選高息,39,14,25,群益金鼎-松山,2024-02-27,9103
00878,國泰永續高股息,131,109,22,群益金鼎-松山,2024-02-27,9103
3645,達邁,22,0,22,群益金鼎-松山,2024-02-27,9103
2609,陽明,21,0,21,群益金鼎-松山,2024-02-27,9103
5351,鈺創,21,1,20,群益金鼎-松山,2024-02-27,9103
9105,泰金寶-DR,20,0,20,群益金鼎-松山,2024-02-27,9103
2383,台光電,17,0,17,群益金鼎-松山,2024-02-27,9103
6005,群益證,17,0,17,群益金鼎-松山,2024-02-27,9103
8271,宇瞻,16,0,16,群益金鼎-松山,2024-02-27,9103
1785,光洋科,15,0,15,群益金鼎-松山,2024-02-27,9103
3689,湧德,17,2,15,群益金鼎-松山,2024-02-27,9103
6282,康舒,15,0,15,群益金鼎-松山,2024-02-27,9103
2882,國泰金,21,7,14,群益金鼎-松山,2024-02-27,9103
00680L,元大美債20正2,13,0,13,群益金鼎-松山,2024-02-27,9103
8096,擎亞,34,23,11,群益金鼎-松山,2024-02-27,9103
2405,輔信,10,0,10,群益金鼎-松山,2024-02-27,9103
4542,科嶠,20,10,10,群益金鼎-松山,2024-02-27,9103
4908,前鼎,13,3,10,群益金鼎-松山,2024-02-27,9103
6284,佳邦,10,0,10,群益金鼎-松山,2024-02-27,9103
1418,東華,9,0,9,群益金鼎-松山,2024-02-27,9103
3483,力致,12,3,9,群益金鼎-松山,2024-02-27,9103
6451,訊芯-KY,15,6,9,群益金鼎-松山,2024-02-27,9103
8084,巨虹,10,1,9,群益金鼎-松山,2024-02-27,9103
0056,元大高股息,8,0,8,群益金鼎-松山,2024-02-27,9103
4770,上品,8,0,8,群益金鼎-松山,2024-02-27,9103
6208,日揚,9,1,8,群益金鼎-松山,2024-02-27,9103
6531,愛普*,11,3,8,群益金鼎-松山,2024-02-27,9103
00652,富邦印度,7,0,7,群益金鼎-松山,2024-02-27,9103
00929,復華台灣科技優息,23,16,7,群益金鼎-松山,2024-02-27,9103
1727,中華化,9,2,7,群益金鼎-松山,2024-02-27,9103
2301,光寶科,28,21,7,群益金鼎-松山,2024-02-27,9103
6245,立端,288,281,7,群益金鼎-松山,2024-02-27,9103
1795,美時,6,0,6,群益金鼎-松山,2024-02-27,9103
1101,台泥,6,0,6,群益金鼎-松山,2024-02-27,9103
6138,茂達,13,7,6,群益金鼎-松山,2024-02-27,9103
00632R,元大台灣50反1,5,0,5,群益金鼎-松山,2024-02-27,9103
1711,永光,5,0,5,群益金鼎-松山,2024-02-27,9103
2316,楠梓電,6,1,5,群益金鼎-松山,2024-02-27,9103
2399,映泰,5,0,5,群益金鼎-松山,2024-02-27,9103
2636,台驊控股,5,0,5,群益金鼎-松山,2024-02-27,9103
4414,如興,5,0,5,群益金鼎-松山,2024-02-27,9103
4906,正文,5,0,5,群益金鼎-松山,2024-02-27,9103
1603,華電,90,0,90,群益金鼎-松山,2024-02-29,9103
8936,國統,72,3,69,群益金鼎-松山,2024-02-29,9103
2330,台積電,54,0,54,群益金鼎-松山,2024-02-29,9103
2637,慧洋-KY,69,18,51,群益金鼎-松山,2024-02-29,9103
1316,上曜,50,0,50,群益金鼎-松山,2024-02-29,9103
9105,泰金寶-DR,44,0,44,群益金鼎-松山,2024-02-29,9103
3312,弘憶股,52,12,40,群益金鼎-松山,2024-02-29,9103
1514,亞力,92,58,34,群益金鼎-松山,2024-02-29,9103
6143,振曜,40,6,34,群益金鼎-松山,2024-02-29,9103
2371,大同,56,25,31,群益金鼎-松山,2024-02-29,9103
2365,昆盈,30,0,30,群益金鼎-松山,2024-02-29,9103
4714,永捷,30,0,30,群益金鼎-松山,2024-02-29,9103
6901,鑽石投資,30,0,30,群益金鼎-松山,2024-02-29,9103
1504,東元,30,1,29,群益金鼎-松山,2024-02-29,9103
00919,群益台灣精選高息,27,0,27,群益金鼎-松山,2024-02-29,9103
1325,恆大,26,1,25,群益金鼎-松山,2024-02-29,9103
1503,士電,58,33,25,群益金鼎-松山,2024-02-29,9103
8996,高力,24,1,23,群益金鼎-松山,2024-02-29,9103
1529,樂事綠能,22,0,22,群益金鼎-松山,2024-02-29,9103
1522,堤維西,38,17,21,群益金鼎-松山,2024-02-29,9103
2375,凱美,33,13,20,群益金鼎-松山,2024-02-29,9103
2453,凌群,20,0,20,群益金鼎-松山,2024-02-29,9103
2486,一詮,25,5,20,群益金鼎-松山,2024-02-29,9103
4968,立積,20,0,20,群益金鼎-松山,2024-02-29,9103
5202,力新,20,0,20,群益金鼎-松山,2024-02-29,9103
00687B,國泰20年美債,17,0,17,群益金鼎-松山,2024-02-29,9103
2355,敬鵬,15,0,15,群益金鼎-松山,2024-02-29,9103
4513,福裕,12,0,12,群益金鼎-松山,2024-02-29,9103
3481,群創,11,0,11,群益金鼎-松山,2024-02-29,9103
3515,華擎,12,1,11,群益金鼎-松山,2024-02-29,9103
00665L,富邦�琤肭磪囓�2,10,0,10,群益金鼎-松山,2024-02-29,9103
00639,富邦深100,10,0,10,群益金鼎-松山,2024-02-29,9103
00725B,國泰投資級公司債,10,0,10,群益金鼎-松山,2024-02-29,9103
2328,廣宇,10,0,10,群益金鼎-松山,2024-02-29,9103
2465,麗臺,15,5,10,群益金鼎-松山,2024-02-29,9103
2607,榮運,10,0,10,群益金鼎-松山,2024-02-29,9103
5225,東科-KY,10,0,10,群益金鼎-松山,2024-02-29,9103
5381,合正,10,0,10,群益金鼎-松山,2024-02-29,9103
8433,弘帆,10,0,10,群益金鼎-松山,2024-02-29,9103
3025,星通,16,7,9,群益金鼎-松山,2024-02-29,9103
6138,茂達,9,0,9,群益金鼎-松山,2024-02-29,9103
6789,采鈺,9,1,8,群益金鼎-松山,2024-02-29,9103
00751B,元大AAA至A公司債,7,0,7,群益金鼎-松山,2024-02-29,9103
1815,富喬,20,13,7,群益金鼎-松山,2024-02-29,9103
2603,長榮,11,4,7,群益金鼎-松山,2024-02-29,9103
3313,斐成,7,0,7,群益金鼎-松山,2024-02-29,9103
3551,世禾,7,0,7,群益金鼎-松山,2024-02-29,9103
8080,印鉐,7,0,7,群益金鼎-松山,2024-02-29,9103
2454,聯發科,8,1,7,群益金鼎-松山,2024-02-29,9103
6179,亞通,6,0,6,群益金鼎-松山,2024-02-29,9103
3036,文曄,100,12,88,群益金鼎-松山,2024-03-01,9103
1513,中興電,136,61,75,群益金鼎-松山,2024-03-01,9103
6229,研通,67,1,66,群益金鼎-松山,2024-03-01,9103
3035,智原,55,5,50,群益金鼎-松山,2024-03-01,9103
4966,譜瑞-KY,50,0,50,群益金鼎-松山,2024-03-01,9103
3005,神基,56,7,49,群益金鼎-松山,2024-03-01,9103
00919,群益台灣精選高息,68,21,47,群益金鼎-松山,2024-03-01,9103
00929,復華台灣科技優息,41,0,41,群益金鼎-松山,2024-03-01,9103
00937B,群益ESG投等債20,38,0,38,群益金鼎-松山,2024-03-01,9103
2881,富邦金,32,0,32,群益金鼎-松山,2024-03-01,9103
8086,宏捷科,33,1,32,群益金鼎-松山,2024-03-01,9103
00891,中信關鍵半導體,30,0,30,群益金鼎-松山,2024-03-01,9103
2031,新光鋼,30,0,30,群益金鼎-松山,2024-03-01,9103
6125,廣運,51,21,30,群益金鼎-松山,2024-03-01,9103
2609,陽明,25,0,25,群益金鼎-松山,2024-03-01,9103
2371,大同,35,10,25,群益金鼎-松山,2024-03-01,9103
3376,新日興,30,6,24,群益金鼎-松山,2024-03-01,9103
6120,達運,22,0,22,群益金鼎-松山,2024-03-01,9103
6143,振曜,42,20,22,群益金鼎-松山,2024-03-01,9103
00687B,國泰20年美債,24,3,21,群益金鼎-松山,2024-03-01,9103
2610,華航,21,0,21,群益金鼎-松山,2024-03-01,9103
1615,大山,20,0,20,群益金鼎-松山,2024-03-01,9103
2736,富野,20,0,20,群益金鼎-松山,2024-03-01,9103
5488,松普,20,0,20,群益金鼎-松山,2024-03-01,9103
6270,倍微,20,0,20,群益金鼎-松山,2024-03-01,9103
8028,昇陽半導體,21,1,20,群益金鼎-松山,2024-03-01,9103
6531,愛普*,22,3,19,群益金鼎-松山,2024-03-01,9103
2855,統一證,18,0,18,群益金鼎-松山,2024-03-01,9103
6005,群益證,18,0,18,群益金鼎-松山,2024-03-01,9103
1528,恩德,17,0,17,群益金鼎-松山,2024-03-01,9103
3708,上緯投控,19,2,17,群益金鼎-松山,2024-03-01,9103
3702,大聯大,16,0,16,群益金鼎-松山,2024-03-01,9103
4147,中裕,16,0,16,群益金鼎-松山,2024-03-01,9103
6282,康舒,20,4,16,群益金鼎-松山,2024-03-01,9103
2399,映泰,19,4,15,群益金鼎-松山,2024-03-01,9103
4906,正文,15,0,15,群益金鼎-松山,2024-03-01,9103
4956,光鋐,15,0,15,群益金鼎-松山,2024-03-01,9103
1303,南亞,14,0,14,群益金鼎-松山,2024-03-01,9103
6139,亞翔,15,1,14,群益金鼎-松山,2024-03-01,9103
2745,五福,12,0,12,群益金鼎-松山,2024-03-01,9103
2913,農林,12,0,12,群益金鼎-松山,2024-03-01,9103
6167,久正,17,5,12,群益金鼎-松山,2024-03-01,9103
6462,神盾,18,6,12,群益金鼎-松山,2024-03-01,9103
3038,全台,11,0,11,群益金鼎-松山,2024-03-01,9103
3046,建��,11,0,11,群益金鼎-松山,2024-03-01,9103
3081,聯亞,11,0,11,群益金鼎-松山,2024-03-01,9103
1101,台泥,10,0,10,群益金鼎-松山,2024-03-01,9103
2348,海悅,10,0,10,群益金鼎-松山,2024-03-01,9103
2743,山富,10,0,10,群益金鼎-松山,2024-03-01,9103
2890,永豐金,10,0,10,群益金鼎-松山,2024-03-01,9103
2367,燿華,302,3,299,群益金鼎-松山,2024-03-04,9103
2353,宏��,301,7,294,群益金鼎-松山,2024-03-04,9103
00937B,群益ESG投等債20,191,0,191,群益金鼎-松山,2024-03-04,9103
3481,群創,100,1,99,群益金鼎-松山,2024-03-04,9103
6026,福邦證,100,2,98,群益金鼎-松山,2024-03-04,9103
6016,康和證,100,2,98,群益金鼎-松山,2024-03-04,9103
6015,宏遠證,100,5,95,群益金鼎-松山,2024-03-04,9103
2313,華通,99,9,90,群益金鼎-松山,2024-03-04,9103
1513,中興電,106,55,51,群益金鼎-松山,2024-03-04,9103
2455,全新,46,1,45,群益金鼎-松山,2024-03-04,9103
6770,力積電,54,12,42,群益金鼎-松山,2024-03-04,9103
1522,堤維西,42,2,40,群益金鼎-松山,2024-03-04,9103
4714,永捷,40,0,40,群益金鼎-松山,2024-03-04,9103
8349,�矬�,33,0,33,群益金鼎-松山,2024-03-04,9103
5234,達興材料,32,0,32,群益金鼎-松山,2024-03-04,9103
2344,華邦電,32,1,31,群益金鼎-松山,2024-03-04,9103
3312,弘憶股,30,2,28,群益金鼎-松山,2024-03-04,9103
2329,華泰,29,1,28,群益金鼎-松山,2024-03-04,9103
8085,福華,68,42,26,群益金鼎-松山,2024-03-04,9103
6546,正基,41,15,26,群益金鼎-松山,2024-03-04,9103
9105,泰金寶-DR,22,0,22,群益金鼎-松山,2024-03-04,9103
00915,凱基優選高股息30,20,0,20,群益金鼎-松山,2024-03-04,9103
00830,國泰費城半導體,20,0,20,群益金鼎-松山,2024-03-04,9103
1524,耿鼎,20,0,20,群益金鼎-松山,2024-03-04,9103
3622,洋華,20,0,20,群益金鼎-松山,2024-03-04,9103
4543,萬在,23,3,20,群益金鼎-松山,2024-03-04,9103
8996,高力,22,3,19,群益金鼎-松山,2024-03-04,9103
5443,均豪,21,3,18,群益金鼎-松山,2024-03-04,9103
00673R,期元大S＆P原油反1,16,0,16,群益金鼎-松山,2024-03-04,9103
6127,九豪,35,22,13,群益金鼎-松山,2024-03-04,9103
6143,振曜,32,19,13,群益金鼎-松山,2024-03-04,9103
1312,國喬,12,0,12,群益金鼎-松山,2024-03-04,9103
3268,海德威,20,8,12,群益金鼎-松山,2024-03-04,9103
3556,禾瑞亞,12,0,12,群益金鼎-松山,2024-03-04,9103
8054,安國,12,0,12,群益金鼎-松山,2024-03-04,9103
3356,奇偶,11,0,11,群益金鼎-松山,2024-03-04,9103
6290,良維,29,18,11,群益金鼎-松山,2024-03-04,9103
00632R,元大台灣50反1,10,0,10,群益金鼎-松山,2024-03-04,9103
1432,大魯閣,10,0,10,群益金鼎-松山,2024-03-04,9103
2903,遠百,10,0,10,群益金鼎-松山,2024-03-04,9103
4147,中裕,10,0,10,群益金鼎-松山,2024-03-04,9103
5381,合正,10,0,10,群益金鼎-松山,2024-03-04,9103
5521,工信,10,0,10,群益金鼎-松山,2024-03-04,9103
6425,易發,10,0,10,群益金鼎-松山,2024-03-04,9103
6715,嘉基,10,0,10,群益金鼎-松山,2024-03-04,9103
3443,創意,11,2,9,群益金鼎-松山,2024-03-04,9103
8011,台通,11,2,9,群益金鼎-松山,2024-03-04,9103
00919,群益台灣精選高息,8,0,8,群益金鼎-松山,2024-03-04,9103
3147,大綜,8,0,8,群益金鼎-松山,2024-03-04,9103
3217,優群,8,0,8,群益金鼎-松山,2024-03-04,9103
1409,新纖,1007,0,1007,群益金鼎-松山,2024-03-05,9103
6245,立端,134,3,131,群益金鼎-松山,2024-03-05,9103
8926,台汽電,112,0,112,群益金鼎-松山,2024-03-05,9103
3702,大聯大,76,4,72,群益金鼎-松山,2024-03-05,9103
3231,緯創,72,8,64,群益金鼎-松山,2024-03-05,9103
3694,海華,57,3,54,群益金鼎-松山,2024-03-05,9103
3691,碩禾,50,0,50,群益金鼎-松山,2024-03-05,9103
1514,亞力,68,38,30,群益金鼎-松山,2024-03-05,9103
1314,中石化,30,0,30,群益金鼎-松山,2024-03-05,9103
6161,捷波,28,0,28,群益金鼎-松山,2024-03-05,9103
6217,中探針,26,1,25,群益金鼎-松山,2024-03-05,9103
00929,復華台灣科技優息,21,0,21,群益金鼎-松山,2024-03-05,9103
00632R,元大台灣50反1,21,0,21,群益金鼎-松山,2024-03-05,9103
1727,中華化,21,0,21,群益金鼎-松山,2024-03-05,9103
2485,兆赫,19,0,19,群益金鼎-松山,2024-03-05,9103
2317,鴻海,19,2,17,群益金鼎-松山,2024-03-05,9103
3556,禾瑞亞,16,0,16,群益金鼎-松山,2024-03-05,9103
6274,台燿,17,1,16,群益金鼎-松山,2024-03-05,9103
3163,波若威,19,5,14,群益金鼎-松山,2024-03-05,9103
3515,華擎,15,1,14,群益金鼎-松山,2024-03-05,9103
00679B,元大美債20年,12,0,12,群益金鼎-松山,2024-03-05,9103
3265,台星科,12,0,12,群益金鼎-松山,2024-03-05,9103
2206,三陽工業,10,0,10,群益金鼎-松山,2024-03-05,9103
3693,營邦,12,2,10,群益金鼎-松山,2024-03-05,9103
4588,玖鼎電力,15,5,10,群益金鼎-松山,2024-03-05,9103
5607,遠雄港,10,0,10,群益金鼎-松山,2024-03-05,9103
6806,森崴能源,16,6,10,群益金鼎-松山,2024-03-05,9103
3376,新日興,32,23,9,群益金鼎-松山,2024-03-05,9103
0056,元大高股息,9,0,9,群益金鼎-松山,2024-03-05,9103
2892,第一金,9,0,9,群益金鼎-松山,2024-03-05,9103
8210,勤誠,10,1,9,群益金鼎-松山,2024-03-05,9103
3147,大綜,8,0,8,群益金鼎-松山,2024-03-05,9103
3297,杭特,9,1,8,群益金鼎-松山,2024-03-05,9103
3592,瑞鼎,8,0,8,群益金鼎-松山,2024-03-05,9103
6138,茂達,9,1,8,群益金鼎-松山,2024-03-05,9103
9945,潤泰新,7,0,7,群益金鼎-松山,2024-03-05,9103
1342,八貫,6,0,6,群益金鼎-松山,2024-03-05,9103
1519,華城,7,1,6,群益金鼎-松山,2024-03-05,9103
1905,華紙,6,0,6,群益金鼎-松山,2024-03-05,9103
2543,皇昌,6,0,6,群益金鼎-松山,2024-03-05,9103
3526,凡甲,8,2,6,群益金鼎-松山,2024-03-05,9103
6576,逸達,6,0,6,群益金鼎-松山,2024-03-05,9103
2884,玉山金,5,0,5,群益金鼎-松山,2024-03-05,9103
2002,中鋼,5,0,5,群益金鼎-松山,2024-03-05,9103
2314,台揚,5,0,5,群益金鼎-松山,2024-03-05,9103
2324,仁寶,6,1,5,群益金鼎-松山,2024-03-05,9103
2371,大同,7,2,5,群益金鼎-松山,2024-03-05,9103
2605,新興,10,5,5,群益金鼎-松山,2024-03-05,9103
2743,山富,5,0,5,群益金鼎-松山,2024-03-05,9103
3564,其陽,5,0,5,群益金鼎-松山,2024-03-05,9103
2515,中工,525,3,522,群益金鼎-松山,2024-03-06,9103
1717,長興,112,3,109,群益金鼎-松山,2024-03-06,9103
5388,中磊,102,1,101,群益金鼎-松山,2024-03-06,9103
1319,東陽,101,0,101,群益金鼎-松山,2024-03-06,9103
6164,華興,100,0,100,群益金鼎-松山,2024-03-06,9103
00712,復華富時不動產,73,0,73,群益金鼎-松山,2024-03-06,9103
6213,聯茂,60,0,60,群益金鼎-松山,2024-03-06,9103
00915,凱基優選高股息30,55,0,55,群益金鼎-松山,2024-03-06,9103
3035,智原,54,2,52,群益金鼎-松山,2024-03-06,9103
8936,國統,51,0,51,群益金鼎-松山,2024-03-06,9103
8110,華東,50,0,50,群益金鼎-松山,2024-03-06,9103
6125,廣運,84,38,46,群益金鼎-松山,2024-03-06,9103
9907,統一實,40,0,40,群益金鼎-松山,2024-03-06,9103
2609,陽明,43,3,40,群益金鼎-松山,2024-03-06,9103
6179,亞通,51,12,39,群益金鼎-松山,2024-03-06,9103
1513,中興電,58,28,30,群益金鼎-松山,2024-03-06,9103
2516,新建,30,0,30,群益金鼎-松山,2024-03-06,9103
2615,萬海,30,0,30,群益金鼎-松山,2024-03-06,9103
5351,鈺創,30,0,30,群益金鼎-松山,2024-03-06,9103
00919,群益台灣精選高息,26,0,26,群益金鼎-松山,2024-03-06,9103
2845,遠東銀,26,1,25,群益金鼎-松山,2024-03-06,9103
6117,迎廣,48,24,24,群益金鼎-松山,2024-03-06,9103
6189,豐藝,25,1,24,群益金鼎-松山,2024-03-06,9103
6698,旭暉應材,34,10,24,群益金鼎-松山,2024-03-06,9103
2352,佳世達,25,2,23,群益金鼎-松山,2024-03-06,9103
2637,慧洋-KY,20,0,20,群益金鼎-松山,2024-03-06,9103
3321,同泰,20,0,20,群益金鼎-松山,2024-03-06,9103
4714,永捷,70,50,20,群益金鼎-松山,2024-03-06,9103
5356,協益,20,0,20,群益金鼎-松山,2024-03-06,9103
6290,良維,49,29,20,群益金鼎-松山,2024-03-06,9103
3376,新日興,31,12,19,群益金鼎-松山,2024-03-06,9103
8349,�矬�,32,14,18,群益金鼎-松山,2024-03-06,9103
2371,大同,24,7,17,群益金鼎-松山,2024-03-06,9103
6799,來頡,18,1,17,群益金鼎-松山,2024-03-06,9103
8054,安國,51,34,17,群益金鼎-松山,2024-03-06,9103
00632R,元大台灣50反1,25,10,15,群益金鼎-松山,2024-03-06,9103
2332,友訊,15,0,15,群益金鼎-松山,2024-03-06,9103
3363,上詮,15,0,15,群益金鼎-松山,2024-03-06,9103
8996,高力,19,5,14,群益金鼎-松山,2024-03-06,9103
3081,聯亞,12,0,12,群益金鼎-松山,2024-03-06,9103
4543,萬在,15,3,12,群益金鼎-松山,2024-03-06,9103
5488,松普,16,4,12,群益金鼎-松山,2024-03-06,9103
2330,台積電,65,54,11,群益金鼎-松山,2024-03-06,9103
6442,光聖,16,5,11,群益金鼎-松山,2024-03-06,9103
6684,安格,11,0,11,群益金鼎-松山,2024-03-06,9103
2421,建準,33,22,11,群益金鼎-松山,2024-03-06,9103
2465,麗臺,10,0,10,群益金鼎-松山,2024-03-06,9103
2485,兆赫,20,10,10,群益金鼎-松山,2024-03-06,9103
6270,倍微,10,0,10,群益金鼎-松山,2024-03-06,9103
6532,瑞耘,10,0,10,群益金鼎-松山,2024-03-06,9103
2367,燿華,358,162,196,群益金鼎-松山,2024-03-07,9103
2382,廣達,202,18,184,群益金鼎-松山,2024-03-07,9103
00680L,元大美債20正2,120,0,120,群益金鼎-松山,2024-03-07,9103
1316,上曜,67,12,55,群益金鼎-松山,2024-03-07,9103
00919,群益台灣精選高息,77,26,51,群益金鼎-松山,2024-03-07,9103
6164,華興,50,0,50,群益金鼎-松山,2024-03-07,9103
6143,振曜,47,6,41,群益金鼎-松山,2024-03-07,9103
00918,大華優利高填息30,32,1,31,群益金鼎-松山,2024-03-07,9103
1815,富喬,29,2,27,群益金鼎-松山,2024-03-07,9103
3013,晟銘電,48,22,26,群益金鼎-松山,2024-03-07,9103
3234,光環,25,0,25,群益金鼎-松山,2024-03-07,9103
2352,佳世達,23,0,23,群益金鼎-松山,2024-03-07,9103
6274,台燿,30,8,22,群益金鼎-松山,2024-03-07,9103
2486,一詮,20,0,20,群益金鼎-松山,2024-03-07,9103
6202,盛群,18,0,18,群益金鼎-松山,2024-03-07,9103
00706L,期元大S＆P日圓正2,17,0,17,群益金鼎-松山,2024-03-07,9103
3118,進階,17,0,17,群益金鼎-松山,2024-03-07,9103
8349,�矬�,20,8,12,群益金鼎-松山,2024-03-07,9103
2388,威盛,15,4,11,群益金鼎-松山,2024-03-07,9103
3356,奇偶,10,0,10,群益金鼎-松山,2024-03-07,9103
1455,集盛,10,0,10,群益金鼎-松山,2024-03-07,9103
1432,大魯閣,10,0,10,群益金鼎-松山,2024-03-07,9103
00632R,元大台灣50反1,35,25,10,群益金鼎-松山,2024-03-07,9103
00720B,元大投資級公司債,10,0,10,群益金鼎-松山,2024-03-07,9103
1535,中宇,10,0,10,群益金鼎-松山,2024-03-07,9103
6270,倍微,10,0,10,群益金鼎-松山,2024-03-07,9103
6526,達發,12,2,10,群益金鼎-松山,2024-03-07,9103
2356,英業達,10,0,10,群益金鼎-松山,2024-03-07,9103
2417,圓剛,10,1,9,群益金鼎-松山,2024-03-07,9103
00929,復華台灣科技優息,25,17,8,群益金鼎-松山,2024-03-07,9103
2324,仁寶,9,1,8,群益金鼎-松山,2024-03-07,9103
3169,亞信,10,2,8,群益金鼎-松山,2024-03-07,9103
3037,欣興,7,0,7,群益金鼎-松山,2024-03-07,9103
2495,普安,11,4,7,群益金鼎-松山,2024-03-07,9103
00915,凱基優選高股息30,6,0,6,群益金鼎-松山,2024-03-07,9103
2201,裕隆,6,0,6,群益金鼎-松山,2024-03-07,9103
6239,力成,7,1,6,群益金鼎-松山,2024-03-07,9103
6933,AMAX-KY,6,0,6,群益金鼎-松山,2024-03-07,9103
3042,晶技,7,1,6,群益金鼎-松山,2024-03-07,9103
2409,友達,6,1,5,群益金鼎-松山,2024-03-07,9103
2331,精英,5,0,5,群益金鼎-松山,2024-03-07,9103
2465,麗臺,20,15,5,群益金鼎-松山,2024-03-07,9103
2613,中櫃,5,0,5,群益金鼎-松山,2024-03-07,9103
2845,遠東銀,5,0,5,群益金鼎-松山,2024-03-07,9103
4128,中天,7,2,5,群益金鼎-松山,2024-03-07,9103
4979,華星光,8,3,5,群益金鼎-松山,2024-03-07,9103
6118,建達,5,0,5,群益金鼎-松山,2024-03-07,9103
6191,精成科,5,0,5,群益金鼎-松山,2024-03-07,9103
6695,芯鼎,5,0,5,群益金鼎-松山,2024-03-07,9103
6770,力積電,5,0,5,群益金鼎-松山,2024-03-07,9103
1513,中興電,254,13,241,群益金鼎-松山,2024-03-08,9103
8926,台汽電,255,40,215,群益金鼎-松山,2024-03-08,9103
3715,定穎投控,75,4,71,群益金鼎-松山,2024-03-08,9103
1725,元禎,50,0,50,群益金鼎-松山,2024-03-08,9103
3313,斐成,50,0,50,群益金鼎-松山,2024-03-08,9103
8349,�矬�,33,1,32,群益金鼎-松山,2024-03-08,9103
00632R,元大台灣50反1,35,5,30,群益金鼎-松山,2024-03-08,9103
6576,逸達,30,0,30,群益金鼎-松山,2024-03-08,9103
3711,日月光投控,51,29,22,群益金鼎-松山,2024-03-08,9103
6546,正基,20,0,20,群益金鼎-松山,2024-03-08,9103
2888,新光金,19,0,19,群益金鼎-松山,2024-03-08,9103
2597,潤弘,20,4,16,群益金鼎-松山,2024-03-08,9103
5469,瀚宇博,15,0,15,群益金鼎-松山,2024-03-08,9103
5225,東科-KY,13,0,13,群益金鼎-松山,2024-03-08,9103
6125,廣運,22,9,13,群益金鼎-松山,2024-03-08,9103
8076,伍豐,12,0,12,群益金鼎-松山,2024-03-08,9103
2405,輔信,11,0,11,群益金鼎-松山,2024-03-08,9103
00643,群益深証中小,10,0,10,群益金鼎-松山,2024-03-08,9103
00639,富邦深100,10,0,10,群益金鼎-松山,2024-03-08,9103
00700,富邦�琤肭磪�,10,0,10,群益金鼎-松山,2024-03-08,9103
2355,敬鵬,12,2,10,群益金鼎-松山,2024-03-08,9103
2383,台光電,14,4,10,群益金鼎-松山,2024-03-08,9103
2611,志信,10,0,10,群益金鼎-松山,2024-03-08,9103
7402,邑錡,10,0,10,群益金鼎-松山,2024-03-08,9103
2352,佳世達,10,1,9,群益金鼎-松山,2024-03-08,9103
00687B,國泰20年美債,21,12,9,群益金鼎-松山,2024-03-08,9103
1442,名軒,9,0,9,群益金鼎-松山,2024-03-08,9103
3005,神基,9,1,8,群益金鼎-松山,2024-03-08,9103
3147,大綜,8,0,8,群益金鼎-松山,2024-03-08,9103
6462,神盾,21,13,8,群益金鼎-松山,2024-03-08,9103
2332,友訊,7,0,7,群益金鼎-松山,2024-03-08,9103
2376,技嘉,8,1,7,群益金鼎-松山,2024-03-08,9103
2382,廣達,11,4,7,群益金鼎-松山,2024-03-08,9103
3290,東浦,7,0,7,群益金鼎-松山,2024-03-08,9103
4147,中裕,7,0,7,群益金鼎-松山,2024-03-08,9103
6239,力成,30,23,7,群益金鼎-松山,2024-03-08,9103
1341,富林-KY,6,0,6,群益金鼎-松山,2024-03-08,9103
2329,華泰,12,6,6,群益金鼎-松山,2024-03-08,9103
2855,統一證,9,3,6,群益金鼎-松山,2024-03-08,9103
2884,玉山金,6,0,6,群益金鼎-松山,2024-03-08,9103
8054,安國,10,5,5,群益金鼎-松山,2024-03-08,9103
00710B,復華彭博非投等債,5,0,5,群益金鼎-松山,2024-03-08,9103
1535,中宇,15,10,5,群益金鼎-松山,2024-03-08,9103
1702,南僑,5,0,5,群益金鼎-松山,2024-03-08,9103
2449,京元電子,11,6,5,群益金鼎-松山,2024-03-08,9103
2540,愛山林,5,0,5,群益金鼎-松山,2024-03-08,9103
3036,文曄,5,0,5,群益金鼎-松山,2024-03-08,9103
6443,元晶,5,0,5,群益金鼎-松山,2024-03-08,9103
6770,力積電,55,50,5,群益金鼎-松山,2024-03-08,9103
8071,能率網通,5,0,5,群益金鼎-松山,2024-03-08,9103
3481,群創,252,0,252,群益金鼎-松山,2024-03-11,9103
2330,台積電,65,1,64,群益金鼎-松山,2024-03-11,9103
2367,燿華,51,0,51,群益金鼎-松山,2024-03-11,9103
6546,正基,51,0,51,群益金鼎-松山,2024-03-11,9103
00929,復華台灣科技優息,48,0,48,群益金鼎-松山,2024-03-11,9103
3163,波若威,51,4,47,群益金鼎-松山,2024-03-11,9103
3450,聯鈞,45,0,45,群益金鼎-松山,2024-03-11,9103
2317,鴻海,53,8,45,群益金鼎-松山,2024-03-11,9103
3356,奇偶,40,0,40,群益金鼎-松山,2024-03-11,9103
6625,必應,37,0,37,群益金鼎-松山,2024-03-11,9103
6770,力積電,50,15,35,群益金鼎-松山,2024-03-11,9103
2313,華通,85,55,30,群益金鼎-松山,2024-03-11,9103
2736,富野,30,0,30,群益金鼎-松山,2024-03-11,9103
4714,永捷,30,0,30,群益金鼎-松山,2024-03-11,9103
5234,達興材料,27,0,27,群益金鼎-松山,2024-03-11,9103
1513,中興電,23,1,22,群益金鼎-松山,2024-03-11,9103
00687B,國泰20年美債,21,0,21,群益金鼎-松山,2024-03-11,9103
5443,均豪,51,31,20,群益金鼎-松山,2024-03-11,9103
00640L,富邦日本正2,20,0,20,群益金鼎-松山,2024-03-11,9103
3669,圓展,20,0,20,群益金鼎-松山,2024-03-11,9103
6589,台康生技,20,0,20,群益金鼎-松山,2024-03-11,9103
2883,凱基金,22,3,19,群益金鼎-松山,2024-03-11,9103
3702,大聯大,31,12,19,群益金鼎-松山,2024-03-11,9103
8349,�矬�,17,0,17,群益金鼎-松山,2024-03-11,9103
1815,富喬,16,0,16,群益金鼎-松山,2024-03-11,9103
4961,天鈺,17,1,16,群益金鼎-松山,2024-03-11,9103
2609,陽明,15,0,15,群益金鼎-松山,2024-03-11,9103
1514,亞力,12,0,12,群益金鼎-松山,2024-03-11,9103
2603,長榮,15,3,12,群益金鼎-松山,2024-03-11,9103
6667,信紘科,11,0,11,群益金鼎-松山,2024-03-11,9103
3548,兆利,14,4,10,群益金鼎-松山,2024-03-11,9103
2369,菱生,10,0,10,群益金鼎-松山,2024-03-11,9103
2516,新建,10,0,10,群益金鼎-松山,2024-03-11,9103
00706L,期元大S＆P日圓正2,10,0,10,群益金鼎-松山,2024-03-11,9103
2365,昆盈,10,0,10,群益金鼎-松山,2024-03-11,9103
2382,廣達,18,8,10,群益金鼎-松山,2024-03-11,9103
2745,五福,10,0,10,群益金鼎-松山,2024-03-11,9103
5511,德昌,10,0,10,群益金鼎-松山,2024-03-11,9103
6227,茂綸,10,0,10,群益金鼎-松山,2024-03-11,9103
8996,高力,12,2,10,群益金鼎-松山,2024-03-11,9103
3260,威剛,31,22,9,群益金鼎-松山,2024-03-11,9103
1608,華榮,9,0,9,群益金鼎-松山,2024-03-11,9103
3231,緯創,56,48,8,群益金鼎-松山,2024-03-11,9103
6789,采鈺,8,0,8,群益金鼎-松山,2024-03-11,9103
00919,群益台灣精選高息,22,14,8,群益金鼎-松山,2024-03-11,9103
2345,智邦,7,0,7,群益金鼎-松山,2024-03-11,9103
2543,皇昌,7,0,7,群益金鼎-松山,2024-03-11,9103
6143,振曜,7,0,7,群益金鼎-松山,2024-03-11,9103
0052,富邦科技,6,0,6,群益金鼎-松山,2024-03-11,9103
3131,弘塑,7,1,6,群益金鼎-松山,2024-03-11,9103
00929,復華台灣科技優息,291,24,267,群益金鼎-松山,2024-03-12,9103
6164,華興,130,0,130,群益金鼎-松山,2024-03-12,9103
6026,福邦證,100,0,100,群益金鼎-松山,2024-03-12,9103
2888,新光金,100,0,100,群益金鼎-松山,2024-03-12,9103
2317,鴻海,105,25,80,群益金鼎-松山,2024-03-12,9103
00900,富邦特選高股息30,100,30,70,群益金鼎-松山,2024-03-12,9103
2313,華通,60,23,37,群益金鼎-松山,2024-03-12,9103
3372,典範,36,0,36,群益金鼎-松山,2024-03-12,9103
1905,華紙,30,0,30,群益金鼎-松山,2024-03-12,9103
2611,志信,30,0,30,群益金鼎-松山,2024-03-12,9103
8349,�矬�,36,6,30,群益金鼎-松山,2024-03-12,9103
8096,擎亞,34,8,26,群益金鼎-松山,2024-03-12,9103
8112,至上,33,7,26,群益金鼎-松山,2024-03-12,9103
6285,啟��,25,0,25,群益金鼎-松山,2024-03-12,9103
1815,富喬,21,0,21,群益金鼎-松山,2024-03-12,9103
2399,映泰,42,22,20,群益金鼎-松山,2024-03-12,9103
3312,弘憶股,20,0,20,群益金鼎-松山,2024-03-12,9103
6584,南俊國際,20,0,20,群益金鼎-松山,2024-03-12,9103
3540,曜越,20,1,19,群益金鼎-松山,2024-03-12,9103
1503,士電,38,21,17,群益金鼎-松山,2024-03-12,9103
6125,廣運,24,9,15,群益金鼎-松山,2024-03-12,9103
00919,群益台灣精選高息,19,5,14,群益金鼎-松山,2024-03-12,9103
00752,中信中國50,13,0,13,群益金鼎-松山,2024-03-12,9103
3013,晟銘電,12,0,12,群益金鼎-松山,2024-03-12,9103
3325,旭品,16,4,12,群益金鼎-松山,2024-03-12,9103
5483,中美晶,11,0,11,群益金鼎-松山,2024-03-12,9103
1903,士紙,11,0,11,群益金鼎-松山,2024-03-12,9103
2883,凱基金,20,9,11,群益金鼎-松山,2024-03-12,9103
6147,頎邦,31,20,11,群益金鼎-松山,2024-03-12,9103
8059,凱碩,15,4,11,群益金鼎-松山,2024-03-12,9103
1515,力山,11,1,10,群益金鼎-松山,2024-03-12,9103
2353,宏��,20,10,10,群益金鼎-松山,2024-03-12,9103
2392,正崴,10,0,10,群益金鼎-松山,2024-03-12,9103
2613,中櫃,10,0,10,群益金鼎-松山,2024-03-12,9103
3294,英濟,10,0,10,群益金鼎-松山,2024-03-12,9103
6416,瑞祺電通,10,0,10,群益金鼎-松山,2024-03-12,9103
6684,安格,10,0,10,群益金鼎-松山,2024-03-12,9103
6139,亞翔,10,1,9,群益金鼎-松山,2024-03-12,9103
6143,振曜,19,10,9,群益金鼎-松山,2024-03-12,9103
1519,華城,14,6,8,群益金鼎-松山,2024-03-12,9103
2303,聯電,12,4,8,群益金鼎-松山,2024-03-12,9103
1303,南亞,8,0,8,群益金鼎-松山,2024-03-12,9103
6573,虹揚-KY,8,0,8,群益金鼎-松山,2024-03-12,9103
2383,台光電,11,4,7,群益金鼎-松山,2024-03-12,9103
2352,佳世達,6,0,6,群益金鼎-松山,2024-03-12,9103
3548,兆利,9,3,6,群益金鼎-松山,2024-03-12,9103
3163,波若威,7,2,5,群益金鼎-松山,2024-03-12,9103
00937B,群益ESG投等債20,5,0,5,群益金鼎-松山,2024-03-12,9103
2009,第一銅,5,0,5,群益金鼎-松山,2024-03-12,9103
2204,中華,5,0,5,群益金鼎-松山,2024-03-12,9103
2354,鴻準,139,9,130,群益金鼎-松山,2024-03-13,9103
00915,凱基優選高股息30,111,0,111,群益金鼎-松山,2024-03-13,9103
2610,華航,200,100,100,群益金鼎-松山,2024-03-13,9103
00664R,國泰臺灣加權反1,100,0,100,群益金鼎-松山,2024-03-13,9103
00900,富邦特選高股息30,200,102,98,群益金鼎-松山,2024-03-13,9103
9907,統一實,58,0,58,群益金鼎-松山,2024-03-13,9103
00680L,元大美債20正2,53,0,53,群益金鼎-松山,2024-03-13,9103
2317,鴻海,157,115,42,群益金鼎-松山,2024-03-13,9103
1316,上曜,40,0,40,群益金鼎-松山,2024-03-13,9103
3013,晟銘電,33,0,33,群益金鼎-松山,2024-03-13,9103
3211,順達,31,0,31,群益金鼎-松山,2024-03-13,9103
00893,國泰智能電動車,30,0,30,群益金鼎-松山,2024-03-13,9103
00903,富邦元宇宙,30,0,30,群益金鼎-松山,2024-03-13,9103
3025,星通,28,0,28,群益金鼎-松山,2024-03-13,9103
1314,中石化,25,0,25,群益金鼎-松山,2024-03-13,9103
00687B,國泰20年美債,24,1,23,群益金鼎-松山,2024-03-13,9103
8112,至上,23,1,22,群益金鼎-松山,2024-03-13,9103
9958,世紀鋼,22,0,22,群益金鼎-松山,2024-03-13,9103
2615,萬海,20,0,20,群益金鼎-松山,2024-03-13,9103
4303,信立,20,0,20,群益金鼎-松山,2024-03-13,9103
6164,華興,20,0,20,群益金鼎-松山,2024-03-13,9103
1514,亞力,36,18,18,群益金鼎-松山,2024-03-13,9103
8089,康全電訊,16,1,15,群益金鼎-松山,2024-03-13,9103
00918,大華優利高填息30,15,0,15,群益金鼎-松山,2024-03-13,9103
3163,波若威,44,29,15,群益金鼎-松山,2024-03-13,9103
3294,英濟,15,0,15,群益金鼎-松山,2024-03-13,9103
6217,中探針,14,0,14,群益金鼎-松山,2024-03-13,9103
00679B,元大美債20年,13,0,13,群益金鼎-松山,2024-03-13,9103
1503,士電,71,59,12,群益金鼎-松山,2024-03-13,9103
2884,玉山金,11,0,11,群益金鼎-松山,2024-03-13,9103
1409,新纖,10,0,10,群益金鼎-松山,2024-03-13,9103
00937B,群益ESG投等債20,10,0,10,群益金鼎-松山,2024-03-13,9103
2332,友訊,10,0,10,群益金鼎-松山,2024-03-13,9103
2392,正崴,10,0,10,群益金鼎-松山,2024-03-13,9103
2443,昶虹,10,0,10,群益金鼎-松山,2024-03-13,9103
6933,AMAX-KY,10,0,10,群益金鼎-松山,2024-03-13,9103
1303,南亞,9,0,9,群益金鼎-松山,2024-03-13,9103
3702,大聯大,16,8,8,群益金鼎-松山,2024-03-13,9103
1513,中興電,20,13,7,群益金鼎-松山,2024-03-13,9103
1802,台玻,6,0,6,群益金鼎-松山,2024-03-13,9103
6282,康舒,6,0,6,群益金鼎-松山,2024-03-13,9103
5469,瀚宇博,5,0,5,群益金鼎-松山,2024-03-13,9103
00878,國泰永續高股息,5,0,5,群益金鼎-松山,2024-03-13,9103
2365,昆盈,7,2,5,群益金鼎-松山,2024-03-13,9103
2385,群光,5,0,5,群益金鼎-松山,2024-03-13,9103
2485,兆赫,5,0,5,群益金鼎-松山,2024-03-13,9103
2505,國揚,5,0,5,群益金鼎-松山,2024-03-13,9103
2743,山富,5,0,5,群益金鼎-松山,2024-03-13,9103
2368,金像電,4,0,4,群益金鼎-松山,2024-03-13,9103
3231,緯創,6,2,4,群益金鼎-松山,2024-03-13,9103
2883,凱基金,317,16,301,群益金鼎-松山,2024-03-14,9103
2890,永豐金,200,0,200,群益金鼎-松山,2024-03-14,9103
2353,宏��,121,20,101,群益金鼎-松山,2024-03-14,9103
00919,群益台灣精選高息,90,12,78,群益金鼎-松山,2024-03-14,9103
2363,矽統,76,1,75,群益金鼎-松山,2024-03-14,9103
1522,堤維西,55,0,55,群益金鼎-松山,2024-03-14,9103
4966,譜瑞-KY,55,1,54,群益金鼎-松山,2024-03-14,9103
3702,大聯大,40,0,40,群益金鼎-松山,2024-03-14,9103
2603,長榮,57,20,37,群益金鼎-松山,2024-03-14,9103
2609,陽明,32,10,22,群益金鼎-松山,2024-03-14,9103
00915,凱基優選高股息30,22,0,22,群益金鼎-松山,2024-03-14,9103
6285,啟��,25,4,21,群益金鼎-松山,2024-03-14,9103
1503,士電,79,59,20,群益金鼎-松山,2024-03-14,9103
1524,耿鼎,20,0,20,群益金鼎-松山,2024-03-14,9103
3013,晟銘電,19,1,18,群益金鼎-松山,2024-03-14,9103
00918,大華優利高填息30,16,0,16,群益金鼎-松山,2024-03-14,9103
6217,中探針,14,1,13,群益金鼎-松山,2024-03-14,9103
3450,聯鈞,12,0,12,群益金鼎-松山,2024-03-14,9103
1808,潤隆,12,1,11,群益金鼎-松山,2024-03-14,9103
2382,廣達,11,0,11,群益金鼎-松山,2024-03-14,9103
1519,華城,14,4,10,群益金鼎-松山,2024-03-14,9103
00632R,元大台灣50反1,15,5,10,群益金鼎-松山,2024-03-14,9103
00878,國泰永續高股息,11,1,10,群益金鼎-松山,2024-03-14,9103
1314,中石化,10,0,10,群益金鼎-松山,2024-03-14,9103
1616,億泰,10,0,10,群益金鼎-松山,2024-03-14,9103
2915,潤泰全,11,1,10,群益金鼎-松山,2024-03-14,9103
3294,英濟,10,0,10,群益金鼎-松山,2024-03-14,9103
3680,家登,10,0,10,群益金鼎-松山,2024-03-14,9103
4768,晶呈科技,10,0,10,群益金鼎-松山,2024-03-14,9103
4938,和碩,10,0,10,群益金鼎-松山,2024-03-14,9103
6679,鈺太,10,0,10,群益金鼎-松山,2024-03-14,9103
8112,至上,10,0,10,群益金鼎-松山,2024-03-14,9103
3708,上緯投控,9,0,9,群益金鼎-松山,2024-03-14,9103
6770,力積電,9,1,8,群益金鼎-松山,2024-03-14,9103
8054,安國,8,0,8,群益金鼎-松山,2024-03-14,9103
2250,IKKA-KY,7,0,7,群益金鼎-松山,2024-03-14,9103
2356,英業達,11,4,7,群益金鼎-松山,2024-03-14,9103
3413,京鼎,7,0,7,群益金鼎-松山,2024-03-14,9103
3596,智易,7,0,7,群益金鼎-松山,2024-03-14,9103
4961,天鈺,16,9,7,群益金鼎-松山,2024-03-14,9103
6005,群益證,9,2,7,群益金鼎-松山,2024-03-14,9103
8064,東捷,7,0,7,群益金鼎-松山,2024-03-14,9103
1457,宜進,6,0,6,群益金鼎-松山,2024-03-14,9103
2884,玉山金,6,0,6,群益金鼎-松山,2024-03-14,9103
6231,系微,6,0,6,群益金鼎-松山,2024-03-14,9103
6416,瑞祺電通,16,10,6,群益金鼎-松山,2024-03-14,9103
3231,緯創,9,4,5,群益金鼎-松山,2024-03-14,9103
2454,聯發科,6,1,5,群益金鼎-松山,2024-03-14,9103
00757,統一FANG+,5,0,5,群益金鼎-松山,2024-03-14,9103
00665L,富邦�琤肭磪囓�2,5,0,5,群益金鼎-松山,2024-03-14,9103
1815,富喬,475,0,475,群益金鼎-松山,2024-03-15,9103
1513,中興電,243,31,212,群益金鼎-松山,2024-03-15,9103
00687B,國泰20年美債,147,0,147,群益金鼎-松山,2024-03-15,9103
2330,台積電,88,1,87,群益金鼎-松山,2024-03-15,9103
00632R,元大台灣50反1,100,15,85,群益金鼎-松山,2024-03-15,9103
00919,群益台灣精選高息,100,33,67,群益金鼎-松山,2024-03-15,9103
4958,臻鼎-KY,65,0,65,群益金鼎-松山,2024-03-15,9103
3163,波若威,62,1,61,群益金鼎-松山,2024-03-15,9103
00665L,富邦�琤肭磪囓�2,50,0,50,群益金鼎-松山,2024-03-15,9103
2354,鴻準,60,27,33,群益金鼎-松山,2024-03-15,9103
2356,英業達,23,1,22,群益金鼎-松山,2024-03-15,9103
8076,伍豐,20,0,20,群益金鼎-松山,2024-03-15,9103
2329,華泰,19,0,19,群益金鼎-松山,2024-03-15,9103
2486,一詮,19,0,19,群益金鼎-松山,2024-03-15,9103
3622,洋華,19,0,19,群益金鼎-松山,2024-03-15,9103
00679B,元大美債20年,20,2,18,群益金鼎-松山,2024-03-15,9103
2317,鴻海,58,43,15,群益金鼎-松山,2024-03-15,9103
2362,藍天,15,0,15,群益金鼎-松山,2024-03-15,9103
6415,矽力*-KY,14,0,14,群益金鼎-松山,2024-03-15,9103
3017,奇鋐,27,14,13,群益金鼎-松山,2024-03-15,9103
00941,中信上游半導體,26,14,12,群益金鼎-松山,2024-03-15,9103
3481,群創,17,7,10,群益金鼎-松山,2024-03-15,9103
5351,鈺創,10,0,10,群益金鼎-松山,2024-03-15,9103
2419,仲琦,9,0,9,群益金鼎-松山,2024-03-15,9103
1519,華城,20,11,9,群益金鼎-松山,2024-03-15,9103
00918,大華優利高填息30,11,2,9,群益金鼎-松山,2024-03-15,9103
6263,普萊德,10,1,9,群益金鼎-松山,2024-03-15,9103
6584,南俊國際,10,1,9,群益金鼎-松山,2024-03-15,9103
3376,新日興,16,8,8,群益金鼎-松山,2024-03-15,9103
9945,潤泰新,13,5,8,群益金鼎-松山,2024-03-15,9103
2376,技嘉,9,2,7,群益金鼎-松山,2024-03-15,9103
2204,中華,8,1,7,群益金鼎-松山,2024-03-15,9103
2610,華航,6,0,6,群益金鼎-松山,2024-03-15,9103
4961,天鈺,10,4,6,群益金鼎-松山,2024-03-15,9103
6143,振曜,6,0,6,群益金鼎-松山,2024-03-15,9103
6163,華電網,6,0,6,群益金鼎-松山,2024-03-15,9103
2618,長榮航,6,0,6,群益金鼎-松山,2024-03-15,9103
1303,南亞,5,0,5,群益金鼎-松山,2024-03-15,9103
00933B,國泰10Y+金融債,7,2,5,群益金鼎-松山,2024-03-15,9103
2201,裕隆,5,0,5,群益金鼎-松山,2024-03-15,9103
2616,山隆,5,0,5,群益金鼎-松山,2024-03-15,9103
2637,慧洋-KY,5,0,5,群益金鼎-松山,2024-03-15,9103
3036,文曄,6,1,5,群益金鼎-松山,2024-03-15,9103
3162,精確,5,0,5,群益金鼎-松山,2024-03-15,9103
4766,南寶,5,0,5,群益金鼎-松山,2024-03-15,9103
5515,建國,5,0,5,群益金鼎-松山,2024-03-15,9103
6125,廣運,5,0,5,群益金鼎-松山,2024-03-15,9103
6933,AMAX-KY,5,0,5,群益金鼎-松山,2024-03-15,9103
00937B,群益ESG投等債20,6,1,5,群益金鼎-松山,2024-03-15,9103
2382,廣達,30,25,5,群益金鼎-松山,2024-03-15,9103
3622,洋華,313,28,285,群益金鼎-松山,2024-03-18,9103
2891,中信金,100,10,90,群益金鼎-松山,2024-03-18,9103
3694,海華,83,0,83,群益金鼎-松山,2024-03-18,9103
00929,復華台灣科技優息,101,30,71,群益金鼎-松山,2024-03-18,9103
1522,堤維西,56,3,53,群益金鼎-松山,2024-03-18,9103
3481,群創,45,0,45,群益金鼎-松山,2024-03-18,9103
00687B,國泰20年美債,41,0,41,群益金鼎-松山,2024-03-18,9103
2354,鴻準,37,0,37,群益金鼎-松山,2024-03-18,9103
00706L,期元大S＆P日圓正2,35,0,35,群益金鼎-松山,2024-03-18,9103
6143,振曜,37,2,35,群益金鼎-松山,2024-03-18,9103
8936,國統,36,5,31,群益金鼎-松山,2024-03-18,9103
00680L,元大美債20正2,31,3,28,群益金鼎-松山,2024-03-18,9103
9907,統一實,26,1,25,群益金鼎-松山,2024-03-18,9103
00857B,永豐20年美公債,24,0,24,群益金鼎-松山,2024-03-18,9103
6164,華興,23,0,23,群益金鼎-松山,2024-03-18,9103
1514,亞力,35,15,20,群益金鼎-松山,2024-03-18,9103
1524,耿鼎,30,10,20,群益金鼎-松山,2024-03-18,9103
00665L,富邦�琤肭磪囓�2,20,0,20,群益金鼎-松山,2024-03-18,9103
4303,信立,15,0,15,群益金鼎-松山,2024-03-18,9103
6806,森崴能源,14,0,14,群益金鼎-松山,2024-03-18,9103
2637,慧洋-KY,15,2,13,群益金鼎-松山,2024-03-18,9103
00919,群益台灣精選高息,33,21,12,群益金鼎-松山,2024-03-18,9103
3013,晟銘電,17,6,11,群益金鼎-松山,2024-03-18,9103
2409,友達,13,3,10,群益金鼎-松山,2024-03-18,9103
00639,富邦深100,10,0,10,群益金鼎-松山,2024-03-18,9103
1711,永光,10,0,10,群益金鼎-松山,2024-03-18,9103
2303,聯電,10,0,10,群益金鼎-松山,2024-03-18,9103
2449,京元電子,11,1,10,群益金鼎-松山,2024-03-18,9103
2465,麗臺,15,5,10,群益金鼎-松山,2024-03-18,9103
2501,國建,10,0,10,群益金鼎-松山,2024-03-18,9103
2542,興富發,10,0,10,群益金鼎-松山,2024-03-18,9103
6462,神盾,10,0,10,群益金鼎-松山,2024-03-18,9103
2885,元大金,9,0,9,群益金鼎-松山,2024-03-18,9103
00633L,富邦上証正2,10,1,9,群益金鼎-松山,2024-03-18,9103
2204,中華,9,0,9,群益金鼎-松山,2024-03-18,9103
2467,志聖,9,0,9,群益金鼎-松山,2024-03-18,9103
2834,臺企銀,210,201,9,群益金鼎-松山,2024-03-18,9103
6735,美達科技,9,0,9,群益金鼎-松山,2024-03-18,9103
3548,兆利,10,2,8,群益金鼎-松山,2024-03-18,9103
2329,華泰,44,36,8,群益金鼎-松山,2024-03-18,9103
2353,宏��,8,0,8,群益金鼎-松山,2024-03-18,9103
3702,大聯大,12,4,8,群益金鼎-松山,2024-03-18,9103
00941,中信上游半導體,6,0,6,群益金鼎-松山,2024-03-18,9103
00918,大華優利高填息30,16,10,6,群益金鼎-松山,2024-03-18,9103
2324,仁寶,6,0,6,群益金鼎-松山,2024-03-18,9103
3025,星通,7,1,6,群益金鼎-松山,2024-03-18,9103
6125,廣運,15,9,6,群益金鼎-松山,2024-03-18,9103
2367,燿華,5,0,5,群益金鼎-松山,2024-03-18,9103
00896,中信綠能及電動車,5,0,5,群益金鼎-松山,2024-03-18,9103
3005,神基,5,0,5,群益金鼎-松山,2024-03-18,9103
00680L,元大美債20正2,203,0,203,群益金鼎-松山,2024-03-19,9103
00915,凱基優選高股息30,100,2,98,群益金鼎-松山,2024-03-19,9103
2464,盟立,100,4,96,群益金鼎-松山,2024-03-19,9103
6164,華興,97,1,96,群益金鼎-松山,2024-03-19,9103
3706,神達,81,9,72,群益金鼎-松山,2024-03-19,9103
00919,群益台灣精選高息,117,50,67,群益金鼎-松山,2024-03-19,9103
3163,波若威,60,0,60,群益金鼎-松山,2024-03-19,9103
3312,弘憶股,58,2,56,群益金鼎-松山,2024-03-19,9103
4966,譜瑞-KY,52,0,52,群益金鼎-松山,2024-03-19,9103
2486,一詮,63,12,51,群益金鼎-松山,2024-03-19,9103
00902,中信電池及儲能,50,0,50,群益金鼎-松山,2024-03-19,9103
2328,廣宇,50,0,50,群益金鼎-松山,2024-03-19,9103
6770,力積電,50,0,50,群益金鼎-松山,2024-03-19,9103
3289,宜特,42,0,42,群益金鼎-松山,2024-03-19,9103
8064,東捷,39,1,38,群益金鼎-松山,2024-03-19,9103
3481,群創,37,0,37,群益金鼎-松山,2024-03-19,9103
4768,晶呈科技,33,1,32,群益金鼎-松山,2024-03-19,9103
8926,台汽電,33,1,32,群益金鼎-松山,2024-03-19,9103
00706L,期元大S＆P日圓正2,30,0,30,群益金鼎-松山,2024-03-19,9103
2362,藍天,30,1,29,群益金鼎-松山,2024-03-19,9103
3005,神基,25,3,22,群益金鼎-松山,2024-03-19,9103
2845,遠東銀,20,0,20,群益金鼎-松山,2024-03-19,9103
4938,和碩,25,7,18,群益金鼎-松山,2024-03-19,9103
3231,緯創,23,7,16,群益金鼎-松山,2024-03-19,9103
1503,士電,44,28,16,群益金鼎-松山,2024-03-19,9103
1101,台泥,15,0,15,群益金鼎-松山,2024-03-19,9103
3014,聯陽,15,0,15,群益金鼎-松山,2024-03-19,9103
3264,欣銓,15,0,15,群益金鼎-松山,2024-03-19,9103
2303,聯電,87,73,14,群益金鼎-松山,2024-03-19,9103
00679B,元大美債20年,12,0,12,群益金鼎-松山,2024-03-19,9103
1326,台化,12,0,12,群益金鼎-松山,2024-03-19,9103
1301,台塑,11,0,11,群益金鼎-松山,2024-03-19,9103
00687B,國泰20年美債,11,0,11,群益金鼎-松山,2024-03-19,9103
5009,榮剛,11,0,11,群益金鼎-松山,2024-03-19,9103
00693U,期街口S＆P黃豆,10,0,10,群益金鼎-松山,2024-03-19,9103
00665L,富邦�琤肭磪囓�2,10,0,10,群益金鼎-松山,2024-03-19,9103
6158,禾昌,10,0,10,群益金鼎-松山,2024-03-19,9103
8040,九暘,10,0,10,群益金鼎-松山,2024-03-19,9103
3017,奇鋐,11,2,9,群益金鼎-松山,2024-03-19,9103
3680,家登,10,1,9,群益金鼎-松山,2024-03-19,9103
5483,中美晶,25,16,9,群益金鼎-松山,2024-03-19,9103
2748,雲品,8,0,8,群益金鼎-松山,2024-03-19,9103
00933B,國泰10Y+金融債,7,0,7,群益金鼎-松山,2024-03-19,9103
2382,廣達,10,3,7,群益金鼎-松山,2024-03-19,9103
3702,大聯大,28,21,7,群益金鼎-松山,2024-03-19,9103
8112,至上,9,2,7,群益金鼎-松山,2024-03-19,9103
2353,宏��,6,0,6,群益金鼎-松山,2024-03-19,9103
2542,興富發,6,0,6,群益金鼎-松山,2024-03-19,9103
1457,宜進,5,0,5,群益金鼎-松山,2024-03-19,9103
00937B,群益ESG投等債20,5,0,5,群益金鼎-松山,2024-03-19,9103
1513,中興電,229,18,211,群益金鼎-松山,2024-03-20,9103
00664R,國泰臺灣加權反1,187,0,187,群益金鼎-松山,2024-03-20,9103
1587,吉茂,100,0,100,群益金鼎-松山,2024-03-20,9103
00937B,群益ESG投等債20,76,0,76,群益金鼎-松山,2024-03-20,9103
2374,佳能,68,0,68,群益金鼎-松山,2024-03-20,9103
00939,統一台灣高息動能,83,25,58,群益金鼎-松山,2024-03-20,9103
6164,華興,50,0,50,群益金鼎-松山,2024-03-20,9103
00919,群益台灣精選高息,236,199,37,群益金鼎-松山,2024-03-20,9103
1785,光洋科,35,3,32,群益金鼎-松山,2024-03-20,9103
1905,華紙,50,20,30,群益金鼎-松山,2024-03-20,9103
2303,聯電,50,20,30,群益金鼎-松山,2024-03-20,9103
3265,台星科,31,2,29,群益金鼎-松山,2024-03-20,9103
2881,富邦金,28,0,28,群益金鼎-松山,2024-03-20,9103
6191,精成科,26,3,23,群益金鼎-松山,2024-03-20,9103
00680L,元大美債20正2,20,0,20,群益金鼎-松山,2024-03-20,9103
2331,精英,20,0,20,群益金鼎-松山,2024-03-20,9103
3481,群創,20,0,20,群益金鼎-松山,2024-03-20,9103
4915,致伸,21,1,20,群益金鼎-松山,2024-03-20,9103
6202,盛群,19,0,19,群益金鼎-松山,2024-03-20,9103
2332,友訊,18,0,18,群益金鼎-松山,2024-03-20,9103
2353,宏��,42,25,17,群益金鼎-松山,2024-03-20,9103
2467,志聖,17,0,17,群益金鼎-松山,2024-03-20,9103
4958,臻鼎-KY,20,4,16,群益金鼎-松山,2024-03-20,9103
00930,永豐ESG低碳高息,15,0,15,群益金鼎-松山,2024-03-20,9103
5706,鳳凰,15,0,15,群益金鼎-松山,2024-03-20,9103
1301,台塑,15,0,15,群益金鼎-松山,2024-03-20,9103
2330,台積電,15,1,14,群益金鼎-松山,2024-03-20,9103
5443,均豪,15,2,13,群益金鼎-松山,2024-03-20,9103
00934,中信成長高股息,12,0,12,群益金鼎-松山,2024-03-20,9103
6278,台表科,11,0,11,群益金鼎-松山,2024-03-20,9103
1303,南亞,10,0,10,群益金鼎-松山,2024-03-20,9103
00712,復華富時不動產,10,0,10,群益金鼎-松山,2024-03-20,9103
2208,台船,10,0,10,群益金鼎-松山,2024-03-20,9103
2449,京元電子,12,2,10,群益金鼎-松山,2024-03-20,9103
2485,兆赫,10,0,10,群益金鼎-松山,2024-03-20,9103
2834,臺企銀,10,0,10,群益金鼎-松山,2024-03-20,9103
2845,遠東銀,10,0,10,群益金鼎-松山,2024-03-20,9103
4938,和碩,42,33,9,群益金鼎-松山,2024-03-20,9103
00941,中信上游半導體,8,0,8,群益金鼎-松山,2024-03-20,9103
2049,上銀,9,1,8,群益金鼎-松山,2024-03-20,9103
2610,華航,10,2,8,群益金鼎-松山,2024-03-20,9103
3013,晟銘電,9,1,8,群益金鼎-松山,2024-03-20,9103
3231,緯創,37,30,7,群益金鼎-松山,2024-03-20,9103
2883,凱基金,8,1,7,群益金鼎-松山,2024-03-20,9103
3498,陽程,7,0,7,群益金鼎-松山,2024-03-20,9103
3702,大聯大,16,9,7,群益金鼎-松山,2024-03-20,9103
6462,神盾,13,6,7,群益金鼎-松山,2024-03-20,9103
00896,中信綠能及電動車,6,0,6,群益金鼎-松山,2024-03-20,9103
2355,敬鵬,7,1,6,群益金鼎-松山,2024-03-20,9103
2618,長榮航,6,0,6,群益金鼎-松山,2024-03-20,9103
3481,群創,303,3,300,群益金鼎-松山,2024-03-21,9103
2883,凱基金,200,4,196,群益金鼎-松山,2024-03-21,9103
2890,永豐金,119,0,119,群益金鼎-松山,2024-03-21,9103
2408,南亞科,102,0,102,群益金鼎-松山,2024-03-21,9103
00941,中信上游半導體,100,0,100,群益金鼎-松山,2024-03-21,9103
8110,華東,100,0,100,群益金鼎-松山,2024-03-21,9103
8277,商丞,100,0,100,群益金鼎-松山,2024-03-21,9103
6026,福邦證,100,1,99,群益金鼎-松山,2024-03-21,9103
00632R,元大台灣50反1,89,0,89,群益金鼎-松山,2024-03-21,9103
2344,華邦電,104,26,78,群益金鼎-松山,2024-03-21,9103
6164,華興,70,0,70,群益金鼎-松山,2024-03-21,9103
6215,和椿,64,1,63,群益金鼎-松山,2024-03-21,9103
00939,統一台灣高息動能,65,3,62,群益金鼎-松山,2024-03-21,9103
3322,建舜電,60,0,60,群益金鼎-松山,2024-03-21,9103
1609,大亞,50,0,50,群益金鼎-松山,2024-03-21,9103
00919,群益台灣精選高息,55,9,46,群益金鼎-松山,2024-03-21,9103
00830,國泰費城半導體,50,5,45,群益金鼎-松山,2024-03-21,9103
2882,國泰金,52,12,40,群益金鼎-松山,2024-03-21,9103
1504,東元,40,5,35,群益金鼎-松山,2024-03-21,9103
8349,�矬�,35,0,35,群益金鼎-松山,2024-03-21,9103
1514,亞力,64,34,30,群益金鼎-松山,2024-03-21,9103
3037,欣興,31,2,29,群益金鼎-松山,2024-03-21,9103
4958,臻鼎-KY,31,2,29,群益金鼎-松山,2024-03-21,9103
3033,威健,47,21,26,群益金鼎-松山,2024-03-21,9103
00795B,中信美國公債20年,25,0,25,群益金鼎-松山,2024-03-21,9103
4906,正文,25,0,25,群益金鼎-松山,2024-03-21,9103
2367,燿華,22,1,21,群益金鼎-松山,2024-03-21,9103
2371,大同,30,11,19,群益金鼎-松山,2024-03-21,9103
3694,海華,19,1,18,群益金鼎-松山,2024-03-21,9103
2206,三陽工業,16,0,16,群益金鼎-松山,2024-03-21,9103
2363,矽統,17,1,16,群益金鼎-松山,2024-03-21,9103
3260,威剛,17,2,15,群益金鼎-松山,2024-03-21,9103
6147,頎邦,25,10,15,群益金鼎-松山,2024-03-21,9103
8210,勤誠,17,2,15,群益金鼎-松山,2024-03-21,9103
6139,亞翔,22,8,14,群益金鼎-松山,2024-03-21,9103
00679B,元大美債20年,12,0,12,群益金鼎-松山,2024-03-21,9103
5706,鳳凰,11,0,11,群益金鼎-松山,2024-03-21,9103
6753,龍德造船,21,10,11,群益金鼎-松山,2024-03-21,9103
8433,弘帆,13,2,11,群益金鼎-松山,2024-03-21,9103
4945,陞達科技,10,0,10,群益金鼎-松山,2024-03-21,9103
4967,十銓,11,1,10,群益金鼎-松山,2024-03-21,9103
2426,鼎元,10,0,10,群益金鼎-松山,2024-03-21,9103
4938,和碩,21,12,9,群益金鼎-松山,2024-03-21,9103
00687B,國泰20年美債,8,0,8,群益金鼎-松山,2024-03-21,9103
3014,聯陽,8,0,8,群益金鼎-松山,2024-03-21,9103
6789,采鈺,8,0,8,群益金鼎-松山,2024-03-21,9103
6239,力成,10,3,7,群益金鼎-松山,2024-03-21,9103
6244,茂迪,10,3,7,群益金鼎-松山,2024-03-21,9103
3029,零壹,6,0,6,群益金鼎-松山,2024-03-21,9103
00937B,群益ESG投等債20,6,0,6,群益金鼎-松山,2024-03-21,9103
3481,群創,210,1,209,群益金鼎-松山,2024-03-22,9103
2358,廷鑫,200,0,200,群益金鼎-松山,2024-03-22,9103
2881,富邦金,100,1,99,群益金鼎-松山,2024-03-22,9103
2367,燿華,160,89,71,群益金鼎-松山,2024-03-22,9103
3450,聯鈞,65,6,59,群益金鼎-松山,2024-03-22,9103
00939,統一台灣高息動能,62,19,43,群益金鼎-松山,2024-03-22,9103
3013,晟銘電,43,1,42,群益金鼎-松山,2024-03-22,9103
6164,華興,40,0,40,群益金鼎-松山,2024-03-22,9103
00919,群益台灣精選高息,80,45,35,群益金鼎-松山,2024-03-22,9103
2353,宏��,83,54,29,群益金鼎-松山,2024-03-22,9103
2362,藍天,31,2,29,群益金鼎-松山,2024-03-22,9103
2408,南亞科,61,32,29,群益金鼎-松山,2024-03-22,9103
2354,鴻準,25,0,25,群益金鼎-松山,2024-03-22,9103
6235,華孚,25,0,25,群益金鼎-松山,2024-03-22,9103
2317,鴻海,56,34,22,群益金鼎-松山,2024-03-22,9103
2376,技嘉,21,3,18,群益金鼎-松山,2024-03-22,9103
2634,漢翔,22,4,18,群益金鼎-松山,2024-03-22,9103
8349,�矬�,24,6,18,群益金鼎-松山,2024-03-22,9103
00937B,群益ESG投等債20,18,0,18,群益金鼎-松山,2024-03-22,9103
8210,勤誠,15,0,15,群益金鼎-松山,2024-03-22,9103
1503,士電,29,18,11,群益金鼎-松山,2024-03-22,9103
2359,所羅門,14,3,11,群益金鼎-松山,2024-03-22,9103
2630,亞航,12,1,11,群益金鼎-松山,2024-03-22,9103
8183,精星,11,0,11,群益金鼎-松山,2024-03-22,9103
8222,寶一,12,1,11,群益金鼎-松山,2024-03-22,9103
00632R,元大台灣50反1,10,0,10,群益金鼎-松山,2024-03-22,9103
00665L,富邦�琤肭磪囓�2,24,14,10,群益金鼎-松山,2024-03-22,9103
00637L,元大滬深300正2,15,5,10,群益金鼎-松山,2024-03-22,9103
2603,長榮,14,4,10,群益金鼎-松山,2024-03-22,9103
2834,臺企銀,10,0,10,群益金鼎-松山,2024-03-22,9103
6244,茂迪,10,0,10,群益金鼎-松山,2024-03-22,9103
6806,森崴能源,10,2,8,群益金鼎-松山,2024-03-22,9103
2006,東和鋼鐵,7,0,7,群益金鼎-松山,2024-03-22,9103
00636,國泰中國A50,7,0,7,群益金鼎-松山,2024-03-22,9103
2204,中華,7,0,7,群益金鼎-松山,2024-03-22,9103
3526,凡甲,7,0,7,群益金鼎-松山,2024-03-22,9103
3702,大聯大,13,6,7,群益金鼎-松山,2024-03-22,9103
6667,信紘科,7,0,7,群益金鼎-松山,2024-03-22,9103
1513,中興電,14,8,6,群益金鼎-松山,2024-03-22,9103
5469,瀚宇博,11,5,6,群益金鼎-松山,2024-03-22,9103
00687B,國泰20年美債,7,1,6,群益金鼎-松山,2024-03-22,9103
6139,亞翔,8,2,6,群益金鼎-松山,2024-03-22,9103
00673R,期元大S＆P原油反1,5,0,5,群益金鼎-松山,2024-03-22,9103
1605,華新,5,0,5,群益金鼎-松山,2024-03-22,9103
00650L,復華香港正2,5,0,5,群益金鼎-松山,2024-03-22,9103
1101,台泥,5,0,5,群益金鼎-松山,2024-03-22,9103
1736,喬山,5,0,5,群益金鼎-松山,2024-03-22,9103
2303,聯電,8,3,5,群益金鼎-松山,2024-03-22,9103
3290,東浦,5,0,5,群益金鼎-松山,2024-03-22,9103
3548,兆利,5,0,5,群益金鼎-松山,2024-03-22,9103
2890,永豐金,500,0,500,群益金鼎-松山,2024-03-25,9103
2464,盟立,187,1,186,群益金鼎-松山,2024-03-25,9103
2367,燿華,237,102,135,群益金鼎-松山,2024-03-25,9103
2382,廣達,100,1,99,群益金鼎-松山,2024-03-25,9103
6164,華興,75,0,75,群益金鼎-松山,2024-03-25,9103
2356,英業達,83,15,68,群益金鼎-松山,2024-03-25,9103
1609,大亞,97,47,50,群益金鼎-松山,2024-03-25,9103
8936,國統,35,0,35,群益金鼎-松山,2024-03-25,9103
1605,華新,32,0,32,群益金鼎-松山,2024-03-25,9103
9907,統一實,32,0,32,群益金鼎-松山,2024-03-25,9103
1514,亞力,36,5,31,群益金鼎-松山,2024-03-25,9103
00687B,國泰20年美債,31,1,30,群益金鼎-松山,2024-03-25,9103
3312,弘憶股,33,3,30,群益金鼎-松山,2024-03-25,9103
4714,永捷,30,0,30,群益金鼎-松山,2024-03-25,9103
8033,雷虎,22,0,22,群益金鼎-松山,2024-03-25,9103
2354,鴻準,22,1,21,群益金鼎-松山,2024-03-25,9103
2303,聯電,24,4,20,群益金鼎-松山,2024-03-25,9103
3376,新日興,20,0,20,群益金鼎-松山,2024-03-25,9103
3622,洋華,20,0,20,群益金鼎-松山,2024-03-25,9103
8040,九暘,40,20,20,群益金鼎-松山,2024-03-25,9103
1597,直得,19,0,19,群益金鼎-松山,2024-03-25,9103
00941,中信上游半導體,22,4,18,群益金鼎-松山,2024-03-25,9103
2301,光寶科,17,0,17,群益金鼎-松山,2024-03-25,9103
00939,統一台灣高息動能,66,50,16,群益金鼎-松山,2024-03-25,9103
6189,豐藝,15,0,15,群益金鼎-松山,2024-03-25,9103
2317,鴻海,38,27,11,群益金鼎-松山,2024-03-25,9103
1316,上曜,10,0,10,群益金鼎-松山,2024-03-25,9103
1101,台泥,10,0,10,群益金鼎-松山,2024-03-25,9103
1560,中砂,10,0,10,群益金鼎-松山,2024-03-25,9103
2027,大成鋼,10,0,10,群益金鼎-松山,2024-03-25,9103
3680,家登,10,0,10,群益金鼎-松山,2024-03-25,9103
6533,晶心科,10,0,10,群益金鼎-松山,2024-03-25,9103
8086,宏捷科,10,0,10,群益金鼎-松山,2024-03-25,9103
8234,新漢,10,0,10,群益金鼎-松山,2024-03-25,9103
5222,全訊,10,0,10,群益金鼎-松山,2024-03-25,9103
2330,台積電,10,0,10,群益金鼎-松山,2024-03-25,9103
00706L,期元大S＆P日圓正2,10,1,9,群益金鼎-松山,2024-03-25,9103
3055,蔚華科,10,1,9,群益金鼎-松山,2024-03-25,9103
6202,盛群,8,0,8,群益金鼎-松山,2024-03-25,9103
4977,眾達-KY,8,0,8,群益金鼎-松山,2024-03-25,9103
3706,神達,10,3,7,群益金鼎-松山,2024-03-25,9103
6126,信音,6,0,6,群益金鼎-松山,2024-03-25,9103
6414,樺漢,7,1,6,群益金鼎-松山,2024-03-25,9103
6753,龍德造船,8,2,6,群益金鼎-松山,2024-03-25,9103
1905,華紙,5,0,5,群益金鼎-松山,2024-03-25,9103
00764B,群益25年美債,5,0,5,群益金鼎-松山,2024-03-25,9103
1808,潤隆,5,0,5,群益金鼎-松山,2024-03-25,9103
2323,中環,5,0,5,群益金鼎-松山,2024-03-25,9103
2359,所羅門,6,1,5,群益金鼎-松山,2024-03-25,9103
2465,麗臺,5,0,5,群益金鼎-松山,2024-03-25,9103
2883,凱基金,200,0,200,群益金鼎-松山,2024-03-26,9103
6015,宏遠證,100,0,100,群益金鼎-松山,2024-03-26,9103
1513,中興電,274,192,82,群益金鼎-松山,2024-03-26,9103
4919,新唐,75,13,62,群益金鼎-松山,2024-03-26,9103
6164,華興,55,0,55,群益金鼎-松山,2024-03-26,9103
3231,緯創,60,6,54,群益金鼎-松山,2024-03-26,9103
9904,寶成,54,0,54,群益金鼎-松山,2024-03-26,9103
2371,大同,263,216,47,群益金鼎-松山,2024-03-26,9103
00939,統一台灣高息動能,68,22,46,群益金鼎-松山,2024-03-26,9103
1597,直得,40,0,40,群益金鼎-松山,2024-03-26,9103
2330,台積電,50,11,39,群益金鼎-松山,2024-03-26,9103
2486,一詮,36,3,33,群益金鼎-松山,2024-03-26,9103
4906,正文,40,8,32,群益金鼎-松山,2024-03-26,9103
2303,聯電,33,2,31,群益金鼎-松山,2024-03-26,9103
3041,揚智,30,0,30,群益金鼎-松山,2024-03-26,9103
2884,玉山金,30,0,30,群益金鼎-松山,2024-03-26,9103
1795,美時,26,0,26,群益金鼎-松山,2024-03-26,9103
00715L,期街口布蘭特正2,25,1,24,群益金鼎-松山,2024-03-26,9103
1504,東元,22,0,22,群益金鼎-松山,2024-03-26,9103
2399,映泰,20,0,20,群益金鼎-松山,2024-03-26,9103
2453,凌群,20,0,20,群益金鼎-松山,2024-03-26,9103
3450,聯鈞,100,81,19,群益金鼎-松山,2024-03-26,9103
3406,玉晶光,21,6,15,群益金鼎-松山,2024-03-26,9103
00929,復華台灣科技優息,21,7,14,群益金鼎-松山,2024-03-26,9103
4979,華星光,14,0,14,群益金鼎-松山,2024-03-26,9103
2609,陽明,13,0,13,群益金鼎-松山,2024-03-26,9103
1616,億泰,13,0,13,群益金鼎-松山,2024-03-26,9103
00919,群益台灣精選高息,31,19,12,群益金鼎-松山,2024-03-26,9103
2313,華通,11,0,11,群益金鼎-松山,2024-03-26,9103
00706L,期元大S＆P日圓正2,11,0,11,群益金鼎-松山,2024-03-26,9103
6546,正基,11,0,11,群益金鼎-松山,2024-03-26,9103
2049,上銀,20,10,10,群益金鼎-松山,2024-03-26,9103
5009,榮剛,10,0,10,群益金鼎-松山,2024-03-26,9103
5234,達興材料,10,0,10,群益金鼎-松山,2024-03-26,9103
00632R,元大台灣50反1,25,16,9,群益金鼎-松山,2024-03-26,9103
2388,威盛,34,25,9,群益金鼎-松山,2024-03-26,9103
8183,精星,9,0,9,群益金鼎-松山,2024-03-26,9103
1809,中釉,8,0,8,群益金鼎-松山,2024-03-26,9103
2250,IKKA-KY,7,0,7,群益金鼎-松山,2024-03-26,9103
3042,晶技,7,0,7,群益金鼎-松山,2024-03-26,9103
1342,八貫,7,0,7,群益金鼎-松山,2024-03-26,9103
2404,漢唐,8,1,7,群益金鼎-松山,2024-03-26,9103
6163,華電網,7,0,7,群益金鼎-松山,2024-03-26,9103
6290,良維,9,2,7,群益金鼎-松山,2024-03-26,9103
2417,圓剛,11,4,7,群益金鼎-松山,2024-03-26,9103
2301,光寶科,7,1,6,群益金鼎-松山,2024-03-26,9103
3022,威強電,6,0,6,群益金鼎-松山,2024-03-26,9103
4743,合一,11,5,6,群益金鼎-松山,2024-03-26,9103
6789,采鈺,7,1,6,群益金鼎-松山,2024-03-26,9103
2359,所羅門,10,4,6,群益金鼎-松山,2024-03-26,9103
2883,凱基金,781,200,581,群益金鼎-松山,2024-03-27,9103
00929,復華台灣科技優息,253,1,252,群益金鼎-松山,2024-03-27,9103
2355,敬鵬,199,2,197,群益金鼎-松山,2024-03-27,9103
6026,福邦證,100,0,100,群益金鼎-松山,2024-03-27,9103
2634,漢翔,82,5,77,群益金鼎-松山,2024-03-27,9103
2618,長榮航,58,2,56,群益金鼎-松山,2024-03-27,9103
4966,譜瑞-KY,50,0,50,群益金鼎-松山,2024-03-27,9103
4746,台耀,40,0,40,群益金鼎-松山,2024-03-27,9103
1609,大亞,24,2,22,群益金鼎-松山,2024-03-27,9103
2038,海光,21,0,21,群益金鼎-松山,2024-03-27,9103
1903,士紙,32,16,16,群益金鼎-松山,2024-03-27,9103
2241,艾姆勒,15,0,15,群益金鼎-松山,2024-03-27,9103
8349,�矬�,15,0,15,群益金鼎-松山,2024-03-27,9103
6290,良維,15,1,14,群益金鼎-松山,2024-03-27,9103
6188,廣明,12,0,12,群益金鼎-松山,2024-03-27,9103
2301,光寶科,11,0,11,群益金鼎-松山,2024-03-27,9103
2371,大同,50,39,11,群益金鼎-松山,2024-03-27,9103
2486,一詮,12,2,10,群益金鼎-松山,2024-03-27,9103
6668,中揚光,10,0,10,群益金鼎-松山,2024-03-27,9103
00896,中信綠能及電動車,9,0,9,群益金鼎-松山,2024-03-27,9103
1808,潤隆,11,2,9,群益金鼎-松山,2024-03-27,9103
3013,晟銘電,16,7,9,群益金鼎-松山,2024-03-27,9103
00706L,期元大S＆P日圓正2,8,0,8,群益金鼎-松山,2024-03-27,9103
1341,富林-KY,8,0,8,群益金鼎-松山,2024-03-27,9103
3312,弘憶股,8,1,7,群益金鼎-松山,2024-03-27,9103
6239,力成,6,0,6,群益金鼎-松山,2024-03-27,9103
2382,廣達,11,5,6,群益金鼎-松山,2024-03-27,9103
3376,新日興,9,3,6,群益金鼎-松山,2024-03-27,9103
3533,嘉澤,8,2,6,群益金鼎-松山,2024-03-27,9103
4526,東台,6,0,6,群益金鼎-松山,2024-03-27,9103
6121,新普,6,0,6,群益金鼎-松山,2024-03-27,9103
8222,寶一,17,11,6,群益金鼎-松山,2024-03-27,9103
1316,上曜,5,0,5,群益金鼎-松山,2024-03-27,9103
1337,再生-KY,5,0,5,群益金鼎-松山,2024-03-27,9103
00830,國泰費城半導體,5,0,5,群益金鼎-松山,2024-03-27,9103
00795B,中信美國公債20年,5,0,5,群益金鼎-松山,2024-03-27,9103
3231,緯創,5,0,5,群益金鼎-松山,2024-03-27,9103
6535,順藥,5,0,5,群益金鼎-松山,2024-03-27,9103
2330,台積電,4,0,4,群益金鼎-松山,2024-03-27,9103
00919,群益台灣精選高息,14,10,4,群益金鼎-松山,2024-03-27,9103
00687B,國泰20年美債,5,1,4,群益金鼎-松山,2024-03-27,9103
1603,華電,4,0,4,群益金鼎-松山,2024-03-27,9103
2465,麗臺,4,0,4,群益金鼎-松山,2024-03-27,9103
2886,兆豐金,4,0,4,群益金鼎-松山,2024-03-27,9103
5426,振發,4,0,4,群益金鼎-松山,2024-03-27,9103
5876,上海商銀,4,0,4,群益金鼎-松山,2024-03-27,9103
6288,聯嘉,4,0,4,群益金鼎-松山,2024-03-27,9103
1608,華榮,43,40,3,群益金鼎-松山,2024-03-27,9103
2201,裕隆,3,0,3,群益金鼎-松山,2024-03-27,9103
2630,亞航,13,10,3,群益金鼎-松山,2024-03-27,9103
6215,和椿,135,0,135,群益金鼎-松山,2024-03-28,9103
2634,漢翔,91,4,87,群益金鼎-松山,2024-03-28,9103
3042,晶技,381,299,82,群益金鼎-松山,2024-03-28,9103
7402,邑錡,61,1,60,群益金鼎-松山,2024-03-28,9103
2337,旺宏,50,0,50,群益金鼎-松山,2024-03-28,9103
1785,光洋科,50,0,50,群益金鼎-松山,2024-03-28,9103
4966,譜瑞-KY,50,0,50,群益金鼎-松山,2024-03-28,9103
2492,華新科,45,0,45,群益金鼎-松山,2024-03-28,9103
1522,堤維西,48,5,43,群益金鼎-松山,2024-03-28,9103
3004,豐達科,42,1,41,群益金鼎-松山,2024-03-28,9103
2354,鴻準,88,51,37,群益金鼎-松山,2024-03-28,9103
1513,中興電,47,12,35,群益金鼎-松山,2024-03-28,9103
4958,臻鼎-KY,36,5,31,群益金鼎-松山,2024-03-28,9103
2630,亞航,28,2,26,群益金鼎-松山,2024-03-28,9103
3707,漢磊,26,3,23,群益金鼎-松山,2024-03-28,9103
2453,凌群,20,0,20,群益金鼎-松山,2024-03-28,9103
3622,洋華,20,0,20,群益金鼎-松山,2024-03-28,9103
8054,安國,12,0,12,群益金鼎-松山,2024-03-28,9103
00706L,期元大S＆P日圓正2,11,0,11,群益金鼎-松山,2024-03-28,9103
2408,南亞科,11,0,11,群益金鼎-松山,2024-03-28,9103
00937B,群益ESG投等債20,10,0,10,群益金鼎-松山,2024-03-28,9103
1504,東元,10,0,10,群益金鼎-松山,2024-03-28,9103
2106,建大,10,0,10,群益金鼎-松山,2024-03-28,9103
2301,光寶科,12,2,10,群益金鼎-松山,2024-03-28,9103
2352,佳世達,10,0,10,群益金鼎-松山,2024-03-28,9103
2353,宏��,10,0,10,群益金鼎-松山,2024-03-28,9103
5512,力麒,10,0,10,群益金鼎-松山,2024-03-28,9103
6188,廣明,20,10,10,群益金鼎-松山,2024-03-28,9103
6875,國邑*,10,0,10,群益金鼎-松山,2024-03-28,9103
00673R,期元大S＆P原油反1,9,0,9,群益金鼎-松山,2024-03-28,9103
3062,建漢,11,2,9,群益金鼎-松山,2024-03-28,9103
6143,振曜,8,0,8,群益金鼎-松山,2024-03-28,9103
1802,台玻,6,0,6,群益金鼎-松山,2024-03-28,9103
2241,艾姆勒,8,2,6,群益金鼎-松山,2024-03-28,9103
1341,富林-KY,5,0,5,群益金鼎-松山,2024-03-28,9103
00882,中信中國高股息,5,0,5,群益金鼎-松山,2024-03-28,9103
2303,聯電,5,0,5,群益金鼎-松山,2024-03-28,9103
2485,兆赫,5,0,5,群益金鼎-松山,2024-03-28,9103
2618,長榮航,5,0,5,群益金鼎-松山,2024-03-28,9103
3088,艾訊,5,0,5,群益金鼎-松山,2024-03-28,9103
3338,泰碩,5,0,5,群益金鼎-松山,2024-03-28,9103
3694,海華,5,0,5,群益金鼎-松山,2024-03-28,9103
3706,神達,9,4,5,群益金鼎-松山,2024-03-28,9103
5443,均豪,5,0,5,群益金鼎-松山,2024-03-28,9103
1618,合機,5,1,4,群益金鼎-松山,2024-03-28,9103
3017,奇鋐,5,1,4,群益金鼎-松山,2024-03-28,9103
1514,亞力,5,1,4,群益金鼎-松山,2024-03-28,9103
1303,南亞,4,0,4,群益金鼎-松山,2024-03-28,9103
2458,義隆,4,0,4,群益金鼎-松山,2024-03-28,9103
3260,威剛,6,2,4,群益金鼎-松山,2024-03-28,9103
2353,宏��,100,5,95,群益金鼎-松山,2024-03-29,9103
2356,英業達,153,68,85,群益金鼎-松山,2024-03-29,9103
00679B,元大美債20年,70,0,70,群益金鼎-松山,2024-03-29,9103
2317,鴻海,106,38,68,群益金鼎-松山,2024-03-29,9103
2371,大同,74,24,50,群益金鼎-松山,2024-03-29,9103
3312,弘憶股,36,0,36,群益金鼎-松山,2024-03-29,9103
2421,建準,35,4,31,群益金鼎-松山,2024-03-29,9103
3376,新日興,32,8,24,群益金鼎-松山,2024-03-29,9103
8110,華東,20,0,20,群益金鼎-松山,2024-03-29,9103
2603,長榮,37,19,18,群益金鼎-松山,2024-03-29,9103
8033,雷虎,22,4,18,群益金鼎-松山,2024-03-29,9103
3498,陽程,16,0,16,群益金鼎-松山,2024-03-29,9103
2376,技嘉,16,1,15,群益金鼎-松山,2024-03-29,9103
2637,慧洋-KY,15,0,15,群益金鼎-松山,2024-03-29,9103
3289,宜特,15,0,15,群益金鼎-松山,2024-03-29,9103
3062,建漢,15,3,12,群益金鼎-松山,2024-03-29,9103
2301,光寶科,15,4,11,群益金鼎-松山,2024-03-29,9103
1903,士紙,10,0,10,群益金鼎-松山,2024-03-29,9103
2101,南港,10,0,10,群益金鼎-松山,2024-03-29,9103
2634,漢翔,10,0,10,群益金鼎-松山,2024-03-29,9103
3011,今皓,10,0,10,群益金鼎-松山,2024-03-29,9103
3702,大聯大,27,17,10,群益金鼎-松山,2024-03-29,9103
1316,上曜,10,1,9,群益金鼎-松山,2024-03-29,9103
2465,麗臺,9,0,9,群益金鼎-松山,2024-03-29,9103
2548,華固,10,1,9,群益金鼎-松山,2024-03-29,9103
6150,撼訊,9,0,9,群益金鼎-松山,2024-03-29,9103
6531,愛普*,8,0,8,群益金鼎-松山,2024-03-29,9103
6462,神盾,16,10,6,群益金鼎-松山,2024-03-29,9103
6643,M31,6,0,6,群益金鼎-松山,2024-03-29,9103
00650L,復華香港正2,5,0,5,群益金鼎-松山,2024-03-29,9103
1616,億泰,5,0,5,群益金鼎-松山,2024-03-29,9103
1702,南僑,5,0,5,群益金鼎-松山,2024-03-29,9103
2106,建大,5,0,5,群益金鼎-松山,2024-03-29,9103
2241,艾姆勒,5,0,5,群益金鼎-松山,2024-03-29,9103
2505,國揚,5,0,5,群益金鼎-松山,2024-03-29,9103
3025,星通,15,10,5,群益金鼎-松山,2024-03-29,9103
3563,牧德,5,0,5,群益金鼎-松山,2024-03-29,9103
3622,洋華,5,0,5,群益金鼎-松山,2024-03-29,9103
3701,大眾控,5,0,5,群益金鼎-松山,2024-03-29,9103
8112,至上,5,0,5,群益金鼎-松山,2024-03-29,9103
8210,勤誠,5,0,5,群益金鼎-松山,2024-03-29,9103
1605,華新,4,0,4,群益金鼎-松山,2024-03-29,9103
00937B,群益ESG投等債20,4,0,4,群益金鼎-松山,2024-03-29,9103
1808,潤隆,4,0,4,群益金鼎-松山,2024-03-29,9103
3036,文曄,4,0,4,群益金鼎-松山,2024-03-29,9103
00929,復華台灣科技優息,3,0,3,群益金鼎-松山,2024-03-29,9103
00935,野村臺灣新科技50,3,0,3,群益金鼎-松山,2024-03-29,9103
00770,國泰北美科技,3,0,3,群益金鼎-松山,2024-03-29,9103
00715L,期街口布蘭特正2,3,0,3,群益金鼎-松山,2024-03-29,9103
3689,湧德,3,0,3,群益金鼎-松山,2024-03-29,9103
00940,元大台灣價值高息,338,30,308,群益金鼎-松山,2024-04-01,9103
6026,福邦證,287,0,287,群益金鼎-松山,2024-04-01,9103
6015,宏遠證,200,4,196,群益金鼎-松山,2024-04-01,9103
6016,康和證,181,0,181,群益金鼎-松山,2024-04-01,9103
1513,中興電,111,12,99,群益金鼎-松山,2024-04-01,9103
2382,廣達,83,14,69,群益金鼎-松山,2024-04-01,9103
00939,統一台灣高息動能,69,11,58,群益金鼎-松山,2024-04-01,9103
00929,復華台灣科技優息,54,0,54,群益金鼎-松山,2024-04-01,9103
00655L,國泰中國A50正2,50,0,50,群益金鼎-松山,2024-04-01,9103
00909,國泰數位支付服務,50,0,50,群益金鼎-松山,2024-04-01,9103
00919,群益台灣精選高息,107,72,35,群益金鼎-松山,2024-04-01,9103
00639,富邦深100,30,0,30,群益金鼎-松山,2024-04-01,9103
3289,宜特,30,0,30,群益金鼎-松山,2024-04-01,9103
1608,華榮,30,1,29,群益金鼎-松山,2024-04-01,9103
3042,晶技,26,0,26,群益金鼎-松山,2024-04-01,9103
6197,佳必琪,28,2,26,群益金鼎-松山,2024-04-01,9103
6213,聯茂,61,35,26,群益金鼎-松山,2024-04-01,9103
5351,鈺創,36,11,25,群益金鼎-松山,2024-04-01,9103
4939,亞電,23,0,23,群益金鼎-松山,2024-04-01,9103
2241,艾姆勒,22,0,22,群益金鼎-松山,2024-04-01,9103
1731,美吾華,21,0,21,群益金鼎-松山,2024-04-01,9103
1903,士紙,18,0,18,群益金鼎-松山,2024-04-01,9103
4127,天良,18,0,18,群益金鼎-松山,2024-04-01,9103
6668,中揚光,20,2,18,群益金鼎-松山,2024-04-01,9103
3231,緯創,23,6,17,群益金鼎-松山,2024-04-01,9103
6547,高端疫苗,17,0,17,群益金鼎-松山,2024-04-01,9103
3702,大聯大,29,13,16,群益金鼎-松山,2024-04-01,9103
2504,國產,15,0,15,群益金鼎-松山,2024-04-01,9103
2603,長榮,16,3,13,群益金鼎-松山,2024-04-01,9103
6244,茂迪,13,0,13,群益金鼎-松山,2024-04-01,9103
3406,玉晶光,11,0,11,群益金鼎-松山,2024-04-01,9103
00632R,元大台灣50反1,10,0,10,群益金鼎-松山,2024-04-01,9103
2474,可成,10,0,10,群益金鼎-松山,2024-04-01,9103
4205,中華食,10,0,10,群益金鼎-松山,2024-04-01,9103
8040,九暘,14,4,10,群益金鼎-松山,2024-04-01,9103
8432,東生華,10,0,10,群益金鼎-松山,2024-04-01,9103
1560,中砂,10,1,9,群益金鼎-松山,2024-04-01,9103
1808,潤隆,8,0,8,群益金鼎-松山,2024-04-01,9103
2425,承啟,8,0,8,群益金鼎-松山,2024-04-01,9103
6462,神盾,22,14,8,群益金鼎-松山,2024-04-01,9103
00706L,期元大S＆P日圓正2,10,3,7,群益金鼎-松山,2024-04-01,9103
00680L,元大美債20正2,7,0,7,群益金鼎-松山,2024-04-01,9103
2301,光寶科,8,1,7,群益金鼎-松山,2024-04-01,9103
3025,星通,7,0,7,群益金鼎-松山,2024-04-01,9103
3036,文曄,7,0,7,群益金鼎-松山,2024-04-01,9103
3689,湧德,13,6,7,群益金鼎-松山,2024-04-01,9103
9911,櫻花,7,0,7,群益金鼎-松山,2024-04-01,9103
2723,美食-KY,6,0,6,群益金鼎-松山,2024-04-01,9103
2850,新產,6,0,6,群益金鼎-松山,2024-04-01,9103
8147,正淩,6,0,6,群益金鼎-松山,2024-04-01,9103
00680L,元大美債20正2,201,1,200,群益金鼎-松山,2024-04-02,9103
3481,群創,200,1,199,群益金鼎-松山,2024-04-02,9103
2515,中工,201,3,198,群益金鼎-松山,2024-04-02,9103
5324,士開,100,0,100,群益金鼎-松山,2024-04-02,9103
5864,致和證,100,0,100,群益金鼎-松山,2024-04-02,9103
00665L,富邦�琤肭磪囓�2,90,0,90,群益金鼎-松山,2024-04-02,9103
4906,正文,58,0,58,群益金鼎-松山,2024-04-02,9103
4966,譜瑞-KY,50,0,50,群益金鼎-松山,2024-04-02,9103
4939,亞電,39,0,39,群益金鼎-松山,2024-04-02,9103
2354,鴻準,37,2,35,群益金鼎-松山,2024-04-02,9103
1522,堤維西,38,4,34,群益金鼎-松山,2024-04-02,9103
00936,台新永續高息中小,32,0,32,群益金鼎-松山,2024-04-02,9103
00929,復華台灣科技優息,46,15,31,群益金鼎-松山,2024-04-02,9103
3013,晟銘電,35,8,27,群益金鼎-松山,2024-04-02,9103
2367,燿華,25,0,25,群益金鼎-松山,2024-04-02,9103
5439,高技,21,0,21,群益金鼎-松山,2024-04-02,9103
00720B,元大投資級公司債,20,0,20,群益金鼎-松山,2024-04-02,9103
3622,洋華,20,1,19,群益金鼎-松山,2024-04-02,9103
6120,達運,19,2,17,群益金鼎-松山,2024-04-02,9103
1515,力山,16,2,14,群益金鼎-松山,2024-04-02,9103
00940,元大台灣價值高息,13,0,13,群益金鼎-松山,2024-04-02,9103
1808,潤隆,13,0,13,群益金鼎-松山,2024-04-02,9103
00933B,國泰10Y+金融債,23,10,13,群益金鼎-松山,2024-04-02,9103
3466,德晉,13,0,13,群益金鼎-松山,2024-04-02,9103
2408,南亞科,12,0,12,群益金鼎-松山,2024-04-02,9103
3025,星通,13,1,12,群益金鼎-松山,2024-04-02,9103
00633L,富邦上証正2,10,0,10,群益金鼎-松山,2024-04-02,9103
2485,兆赫,10,0,10,群益金鼎-松山,2024-04-02,9103
3308,聯德,10,0,10,群益金鼎-松山,2024-04-02,9103
6188,廣明,20,10,10,群益金鼎-松山,2024-04-02,9103
1903,士紙,10,1,9,群益金鼎-松山,2024-04-02,9103
3042,晶技,9,0,9,群益金鼎-松山,2024-04-02,9103
6125,廣運,13,5,8,群益金鼎-松山,2024-04-02,9103
00637L,元大滬深300正2,15,8,7,群益金鼎-松山,2024-04-02,9103
2618,長榮航,7,0,7,群益金鼎-松山,2024-04-02,9103
6207,雷科,6,0,6,群益金鼎-松山,2024-04-02,9103
2537,聯上發,7,1,6,群益金鼎-松山,2024-04-02,9103
8054,安國,22,17,5,群益金鼎-松山,2024-04-02,9103
6515,穎崴,6,1,5,群益金鼎-松山,2024-04-02,9103
4938,和碩,6,1,5,群益金鼎-松山,2024-04-02,9103
00937B,群益ESG投等債20,5,0,5,群益金鼎-松山,2024-04-02,9103
00931B,統一美債20年,5,0,5,群益金鼎-松山,2024-04-02,9103
00670L,富邦NASDAQ正2,5,0,5,群益金鼎-松山,2024-04-02,9103
3257,虹冠電,5,0,5,群益金鼎-松山,2024-04-02,9103
3686,達能,5,0,5,群益金鼎-松山,2024-04-02,9103
5211,蒙恬,5,0,5,群益金鼎-松山,2024-04-02,9103
8064,東捷,5,0,5,群益金鼎-松山,2024-04-02,9103
2352,佳世達,5,0,5,群益金鼎-松山,2024-04-02,9103
2603,長榮,7,2,5,群益金鼎-松山,2024-04-02,9103
00679B,元大美債20年,4,0,4,群益金鼎-松山,2024-04-02,9103
00680L,元大美債20正2,260,0,260,群益金鼎-松山,2024-04-03,9103
00929,復華台灣科技優息,130,10,120,群益金鼎-松山,2024-04-03,9103
5512,力麒,100,0,100,群益金鼎-松山,2024-04-03,9103
00940,元大台灣價值高息,76,0,76,群益金鼎-松山,2024-04-03,9103
3010,華立,66,5,61,群益金鼎-松山,2024-04-03,9103
6770,力積電,61,0,61,群益金鼎-松山,2024-04-03,9103
3450,聯鈞,61,3,58,群益金鼎-松山,2024-04-03,9103
2330,台積電,45,0,45,群益金鼎-松山,2024-04-03,9103
3363,上詮,40,0,40,群益金鼎-松山,2024-04-03,9103
3013,晟銘電,57,19,38,群益金鼎-松山,2024-04-03,9103
6438,迅得,36,1,35,群益金鼎-松山,2024-04-03,9103
8349,�矬�,36,1,35,群益金鼎-松山,2024-04-03,9103
2486,一詮,112,81,31,群益金鼎-松山,2024-04-03,9103
6442,光聖,30,0,30,群益金鼎-松山,2024-04-03,9103
00919,群益台灣精選高息,22,0,22,群益金鼎-松山,2024-04-03,9103
4908,前鼎,23,1,22,群益金鼎-松山,2024-04-03,9103
2537,聯上發,20,1,19,群益金鼎-松山,2024-04-03,9103
6668,中揚光,69,50,19,群益金鼎-松山,2024-04-03,9103
3588,通嘉,18,0,18,群益金鼎-松山,2024-04-03,9103
6213,聯茂,18,0,18,群益金鼎-松山,2024-04-03,9103
6189,豐藝,16,0,16,群益金鼎-松山,2024-04-03,9103
3032,偉訓,15,1,14,群益金鼎-松山,2024-04-03,9103
2382,廣達,23,11,12,群益金鼎-松山,2024-04-03,9103
2301,光寶科,12,1,11,群益金鼎-松山,2024-04-03,9103
00720B,元大投資級公司債,10,0,10,群益金鼎-松山,2024-04-03,9103
00632R,元大台灣50反1,210,200,10,群益金鼎-松山,2024-04-03,9103
00795B,中信美國公債20年,10,0,10,群益金鼎-松山,2024-04-03,9103
00923,群益台ESG低碳50,10,0,10,群益金鼎-松山,2024-04-03,9103
1802,台玻,10,0,10,群益金鼎-松山,2024-04-03,9103
2324,仁寶,10,0,10,群益金鼎-松山,2024-04-03,9103
3308,聯德,10,0,10,群益金鼎-松山,2024-04-03,9103
4542,科嶠,20,10,10,群益金鼎-松山,2024-04-03,9103
8033,雷虎,10,0,10,群益金鼎-松山,2024-04-03,9103
2388,威盛,10,1,9,群益金鼎-松山,2024-04-03,9103
8210,勤誠,10,1,9,群益金鼎-松山,2024-04-03,9103
00937B,群益ESG投等債20,8,0,8,群益金鼎-松山,2024-04-03,9103
3406,玉晶光,9,1,8,群益金鼎-松山,2024-04-03,9103
3042,晶技,7,0,7,群益金鼎-松山,2024-04-03,9103
00687B,國泰20年美債,6,0,6,群益金鼎-松山,2024-04-03,9103
1609,大亞,6,0,6,群益金鼎-松山,2024-04-03,9103
0056,元大高股息,6,0,6,群益金鼎-松山,2024-04-03,9103
6432,今展科,6,0,6,群益金鼎-松山,2024-04-03,9103
00830,國泰費城半導體,5,0,5,群益金鼎-松山,2024-04-03,9103
1341,富林-KY,5,0,5,群益金鼎-松山,2024-04-03,9103
2474,可成,5,0,5,群益金鼎-松山,2024-04-03,9103
2485,兆赫,5,0,5,群益金鼎-松山,2024-04-03,9103
6288,聯嘉,10,5,5,群益金鼎-松山,2024-04-03,9103
6416,瑞祺電通,5,0,5,群益金鼎-松山,2024-04-03,9103
3289,宜特,7,2,5,群益金鼎-松山,2024-04-03,9103
00936,台新永續高息中小,4,0,4,群益金鼎-松山,2024-04-03,9103
3045,台灣大,500,0,500,群益金鼎-松山,2024-04-08,9103
6016,康和證,217,0,217,群益金鼎-松山,2024-04-08,9103
2371,大同,195,16,179,群益金鼎-松山,2024-04-08,9103
6005,群益證,170,0,170,群益金鼎-松山,2024-04-08,9103
6015,宏遠證,200,38,162,群益金鼎-松山,2024-04-08,9103
2505,國揚,100,0,100,群益金鼎-松山,2024-04-08,9103
2855,統一證,101,1,100,群益金鼎-松山,2024-04-08,9103
3715,定穎投控,82,7,75,群益金鼎-松山,2024-04-08,9103
6166,凌華,60,0,60,群益金鼎-松山,2024-04-08,9103
8358,金居,62,3,59,群益金鼎-松山,2024-04-08,9103
2545,皇翔,50,0,50,群益金鼎-松山,2024-04-08,9103
6020,大展證,50,0,50,群益金鼎-松山,2024-04-08,9103
2374,佳能,46,2,44,群益金鼎-松山,2024-04-08,9103
3042,晶技,121,84,37,群益金鼎-松山,2024-04-08,9103
1522,堤維西,30,0,30,群益金鼎-松山,2024-04-08,9103
3013,晟銘電,43,13,30,群益金鼎-松山,2024-04-08,9103
00929,復華台灣科技優息,27,0,27,群益金鼎-松山,2024-04-08,9103
2317,鴻海,32,8,24,群益金鼎-松山,2024-04-08,9103
00687B,國泰20年美債,20,0,20,群益金鼎-松山,2024-04-08,9103
5439,高技,20,0,20,群益金鼎-松山,2024-04-08,9103
00919,群益台灣精選高息,26,9,17,群益金鼎-松山,2024-04-08,9103
1702,南僑,15,0,15,群益金鼎-松山,2024-04-08,9103
00679B,元大美債20年,13,0,13,群益金鼎-松山,2024-04-08,9103
00680L,元大美債20正2,11,0,11,群益金鼎-松山,2024-04-08,9103
00688L,國泰20年美債正2,11,0,11,群益金鼎-松山,2024-04-08,9103
8349,�矬�,11,0,11,群益金鼎-松山,2024-04-08,9103
2002,中鋼,10,0,10,群益金鼎-松山,2024-04-08,9103
00632R,元大台灣50反1,10,0,10,群益金鼎-松山,2024-04-08,9103
00909,國泰數位支付服務,10,0,10,群益金鼎-松山,2024-04-08,9103
1806,冠軍,10,0,10,群益金鼎-松山,2024-04-08,9103
2345,智邦,11,1,10,群益金鼎-松山,2024-04-08,9103
2465,麗臺,10,0,10,群益金鼎-松山,2024-04-08,9103
2609,陽明,10,0,10,群益金鼎-松山,2024-04-08,9103
2885,元大金,10,0,10,群益金鼎-松山,2024-04-08,9103
3702,大聯大,10,0,10,群益金鼎-松山,2024-04-08,9103
6449,鈺邦,10,0,10,群益金鼎-松山,2024-04-08,9103
2637,慧洋-KY,9,0,9,群益金鼎-松山,2024-04-08,9103
1503,士電,19,11,8,群益金鼎-松山,2024-04-08,9103
3466,德晉,8,0,8,群益金鼎-松山,2024-04-08,9103
3617,碩天,8,0,8,群益金鼎-松山,2024-04-08,9103
6125,廣運,15,7,8,群益金鼎-松山,2024-04-08,9103
00939,統一台灣高息動能,7,0,7,群益金鼎-松山,2024-04-08,9103
00937B,群益ESG投等債20,7,0,7,群益金鼎-松山,2024-04-08,9103
3036,文曄,7,0,7,群益金鼎-松山,2024-04-08,9103
1514,亞力,12,5,7,群益金鼎-松山,2024-04-08,9103
00933B,國泰10Y+金融債,6,0,6,群益金鼎-松山,2024-04-08,9103
1341,富林-KY,6,0,6,群益金鼎-松山,2024-04-08,9103
00830,國泰費城半導體,5,0,5,群益金鼎-松山,2024-04-08,9103
1808,潤隆,5,0,5,群益金鼎-松山,2024-04-08,9103
2454,聯發科,5,0,5,群益金鼎-松山,2024-04-08,9103
00680L,元大美債20正2,1510,22,1488,群益金鼎-松山,2024-04-09,9103
3481,群創,323,104,219,群益金鼎-松山,2024-04-09,9103
2025,千興,100,0,100,群益金鼎-松山,2024-04-09,9103
2501,國建,120,20,100,群益金鼎-松山,2024-04-09,9103
5531,鄉林,100,0,100,群益金鼎-松山,2024-04-09,9103
6026,福邦證,92,0,92,群益金鼎-松山,2024-04-09,9103
2363,矽統,265,210,55,群益金鼎-松山,2024-04-09,9103
3231,緯創,54,2,52,群益金鼎-松山,2024-04-09,9103
5371,中光電,40,2,38,群益金鼎-松山,2024-04-09,9103
2367,燿華,22,1,21,群益金鼎-松山,2024-04-09,9103
2548,華固,20,0,20,群益金鼎-松山,2024-04-09,9103
5324,士開,20,0,20,群益金鼎-松山,2024-04-09,9103
6213,聯茂,18,0,18,群益金鼎-松山,2024-04-09,9103
2383,台光電,18,2,16,群益金鼎-松山,2024-04-09,9103
5014,建錩,16,0,16,群益金鼎-松山,2024-04-09,9103
3025,星通,14,0,14,群益金鼎-松山,2024-04-09,9103
4588,玖鼎電力,14,0,14,群益金鼎-松山,2024-04-09,9103
5222,全訊,14,1,13,群益金鼎-松山,2024-04-09,9103
1720,生達,12,0,12,群益金鼎-松山,2024-04-09,9103
3617,碩天,12,0,12,群益金鼎-松山,2024-04-09,9103
3005,神基,11,0,11,群益金鼎-松山,2024-04-09,9103
3535,晶彩科,11,0,11,群益金鼎-松山,2024-04-09,9103
6188,廣明,27,16,11,群益金鼎-松山,2024-04-09,9103
6416,瑞祺電通,11,0,11,群益金鼎-松山,2024-04-09,9103
1301,台塑,10,0,10,群益金鼎-松山,2024-04-09,9103
1314,中石化,10,0,10,群益金鼎-松山,2024-04-09,9103
1702,南僑,10,0,10,群益金鼎-松山,2024-04-09,9103
1733,五鼎,10,0,10,群益金鼎-松山,2024-04-09,9103
2471,資通,10,0,10,群益金鼎-松山,2024-04-09,9103
2884,玉山金,10,0,10,群益金鼎-松山,2024-04-09,9103
3289,宜特,10,0,10,群益金鼎-松山,2024-04-09,9103
3691,碩禾,10,0,10,群益金鼎-松山,2024-04-09,9103
6546,正基,20,10,10,群益金鼎-松山,2024-04-09,9103
6937,天虹,10,0,10,群益金鼎-松山,2024-04-09,9103
6414,樺漢,10,1,9,群益金鼎-松山,2024-04-09,9103
8011,台通,10,1,9,群益金鼎-松山,2024-04-09,9103
1341,富林-KY,7,0,7,群益金鼎-松山,2024-04-09,9103
6535,順藥,7,0,7,群益金鼎-松山,2024-04-09,9103
4533,協易機,9,2,7,群益金鼎-松山,2024-04-09,9103
2330,台積電,31,24,7,群益金鼎-松山,2024-04-09,9103
6117,迎廣,7,1,6,群益金鼎-松山,2024-04-09,9103
1587,吉茂,9,3,6,群益金鼎-松山,2024-04-09,9103
3163,波若威,6,0,6,群益金鼎-松山,2024-04-09,9103
4129,聯合,6,0,6,群益金鼎-松山,2024-04-09,9103
6126,信音,11,5,6,群益金鼎-松山,2024-04-09,9103
00929,復華台灣科技優息,5,0,5,群益金鼎-松山,2024-04-09,9103
1618,合機,13,8,5,群益金鼎-松山,2024-04-09,9103
00706L,期元大S＆P日圓正2,5,0,5,群益金鼎-松山,2024-04-09,9103
2634,漢翔,16,11,5,群益金鼎-松山,2024-04-09,9103
4137,麗豐-KY,5,0,5,群益金鼎-松山,2024-04-09,9103
1513,中興電,218,40,178,群益金鼎-松山,2024-04-10,9103
2891,中信金,120,0,120,群益金鼎-松山,2024-04-10,9103
2547,日勝生,100,0,100,群益金鼎-松山,2024-04-10,9103
2537,聯上發,101,2,99,群益金鼎-松山,2024-04-10,9103
6213,聯茂,98,2,96,群益金鼎-松山,2024-04-10,9103
1786,科妍,82,0,82,群益金鼎-松山,2024-04-10,9103
2408,南亞科,90,23,67,群益金鼎-松山,2024-04-10,9103
2439,美律,61,0,61,群益金鼎-松山,2024-04-10,9103
4945,陞達科技,50,0,50,群益金鼎-松山,2024-04-10,9103
5371,中光電,45,1,44,群益金鼎-松山,2024-04-10,9103
5531,鄉林,144,100,44,群益金鼎-松山,2024-04-10,9103
3231,緯創,38,2,36,群益金鼎-松山,2024-04-10,9103
3609,三一東林,35,0,35,群益金鼎-松山,2024-04-10,9103
3617,碩天,30,0,30,群益金鼎-松山,2024-04-10,9103
8349,�矬�,28,0,28,群益金鼎-松山,2024-04-10,9103
3213,茂訊,26,1,25,群益金鼎-松山,2024-04-10,9103
2329,華泰,23,0,23,群益金鼎-松山,2024-04-10,9103
00706L,期元大S＆P日圓正2,20,0,20,群益金鼎-松山,2024-04-10,9103
3622,洋華,20,0,20,群益金鼎-松山,2024-04-10,9103
2382,廣達,17,0,17,群益金鼎-松山,2024-04-10,9103
00896,中信綠能及電動車,12,0,12,群益金鼎-松山,2024-04-10,9103
00687B,國泰20年美債,12,0,12,群益金鼎-松山,2024-04-10,9103
3059,華晶科,16,4,12,群益金鼎-松山,2024-04-10,9103
00679B,元大美債20年,15,4,11,群益金鼎-松山,2024-04-10,9103
1316,上曜,10,0,10,群益金鼎-松山,2024-04-10,9103
00637L,元大滬深300正2,10,0,10,群益金鼎-松山,2024-04-10,9103
2359,所羅門,30,20,10,群益金鼎-松山,2024-04-10,9103
3122,笙泉,10,0,10,群益金鼎-松山,2024-04-10,9103
6113,亞矽,10,0,10,群益金鼎-松山,2024-04-10,9103
2376,技嘉,11,2,9,群益金鼎-松山,2024-04-10,9103
6143,振曜,21,12,9,群益金鼎-松山,2024-04-10,9103
2317,鴻海,13,4,9,群益金鼎-松山,2024-04-10,9103
1514,亞力,57,49,8,群益金鼎-松山,2024-04-10,9103
2330,台積電,10,2,8,群益金鼎-松山,2024-04-10,9103
2354,鴻準,8,0,8,群益金鼎-松山,2024-04-10,9103
2637,慧洋-KY,9,1,8,群益金鼎-松山,2024-04-10,9103
6117,迎廣,19,11,8,群益金鼎-松山,2024-04-10,9103
6125,廣運,8,0,8,群益金鼎-松山,2024-04-10,9103
3211,順達,6,0,6,群益金鼎-松山,2024-04-10,9103
4588,玖鼎電力,20,14,6,群益金鼎-松山,2024-04-10,9103
5222,全訊,6,0,6,群益金鼎-松山,2024-04-10,9103
1605,華新,7,2,5,群益金鼎-松山,2024-04-10,9103
2609,陽明,6,1,5,群益金鼎-松山,2024-04-10,9103
3551,世禾,5,0,5,群益金鼎-松山,2024-04-10,9103
3706,神達,5,0,5,群益金鼎-松山,2024-04-10,9103
6215,和椿,5,0,5,群益金鼎-松山,2024-04-10,9103
8028,昇陽半導體,5,0,5,群益金鼎-松山,2024-04-10,9103
2002,中鋼,5,1,4,群益金鼎-松山,2024-04-10,9103
6197,佳必琪,5,1,4,群益金鼎-松山,2024-04-10,9103
2069,運錩,4,0,4,群益金鼎-松山,2024-04-10,9103
2618,長榮航,163,6,157,群益金鼎-松山,2024-04-11,9103
4533,協易機,165,34,131,群益金鼎-松山,2024-04-11,9103
2363,矽統,181,53,128,群益金鼎-松山,2024-04-11,9103
2547,日勝生,100,0,100,群益金鼎-松山,2024-04-11,9103
5512,力麒,96,10,86,群益金鼎-松山,2024-04-11,9103
3217,優群,87,20,67,群益金鼎-松山,2024-04-11,9103
3609,三一東林,65,0,65,群益金鼎-松山,2024-04-11,9103
8349,�矬�,59,2,57,群益金鼎-松山,2024-04-11,9103
6122,擎邦,53,0,53,群益金鼎-松山,2024-04-11,9103
2501,國建,80,31,49,群益金鼎-松山,2024-04-11,9103
2834,臺企銀,46,0,46,群益金鼎-松山,2024-04-11,9103
2301,光寶科,40,0,40,群益金鼎-松山,2024-04-11,9103
00939,統一台灣高息動能,37,3,34,群益金鼎-松山,2024-04-11,9103
1504,東元,23,0,23,群益金鼎-松山,2024-04-11,9103
0056,元大高股息,21,0,21,群益金鼎-松山,2024-04-11,9103
2731,雄獅,21,1,20,群益金鼎-松山,2024-04-11,9103
3380,明泰,20,0,20,群益金鼎-松山,2024-04-11,9103
5607,遠雄港,20,0,20,群益金鼎-松山,2024-04-11,9103
2515,中工,18,2,16,群益金鼎-松山,2024-04-11,9103
8033,雷虎,15,0,15,群益金鼎-松山,2024-04-11,9103
6274,台燿,16,1,15,群益金鼎-松山,2024-04-11,9103
8210,勤誠,16,1,15,群益金鼎-松山,2024-04-11,9103
2505,國揚,13,0,13,群益金鼎-松山,2024-04-11,9103
1608,華榮,12,0,12,群益金鼎-松山,2024-04-11,9103
5351,鈺創,12,0,12,群益金鼎-松山,2024-04-11,9103
00937B,群益ESG投等債20,11,0,11,群益金鼎-松山,2024-04-11,9103
5465,富驊,11,0,11,群益金鼎-松山,2024-04-11,9103
6245,立端,11,0,11,群益金鼎-松山,2024-04-11,9103
00637L,元大滬深300正2,20,10,10,群益金鼎-松山,2024-04-11,9103
1603,華電,10,0,10,群益金鼎-松山,2024-04-11,9103
2009,第一銅,13,3,10,群益金鼎-松山,2024-04-11,9103
3071,協禧,10,0,10,群益金鼎-松山,2024-04-11,9103
3546,宇峻,10,0,10,群益金鼎-松山,2024-04-11,9103
5426,振發,10,0,10,群益金鼎-松山,2024-04-11,9103
2331,精英,9,0,9,群益金鼎-松山,2024-04-11,9103
2353,宏��,24,15,9,群益金鼎-松山,2024-04-11,9103
3483,力致,9,0,9,群益金鼎-松山,2024-04-11,9103
5263,智崴,9,0,9,群益金鼎-松山,2024-04-11,9103
00687B,國泰20年美債,9,1,8,群益金鼎-松山,2024-04-11,9103
3013,晟銘電,17,9,8,群益金鼎-松山,2024-04-11,9103
3025,星通,8,0,8,群益金鼎-松山,2024-04-11,9103
6117,迎廣,19,11,8,群益金鼎-松山,2024-04-11,9103
6937,天虹,8,0,8,群益金鼎-松山,2024-04-11,9103
00679B,元大美債20年,7,0,7,群益金鼎-松山,2024-04-11,9103
2605,新興,7,0,7,群益金鼎-松山,2024-04-11,9103
3231,緯創,7,0,7,群益金鼎-松山,2024-04-11,9103
00688L,國泰20年美債正2,6,0,6,群益金鼎-松山,2024-04-11,9103
2425,承啟,6,0,6,群益金鼎-松山,2024-04-11,9103
3450,聯鈞,7,1,6,群益金鼎-松山,2024-04-11,9103
6727,亞泰金屬,6,0,6,群益金鼎-松山,2024-04-11,9103
00680L,元大美債20正2,1505,0,1505,群益金鼎-松山,2024-04-12,9103
3045,台灣大,645,0,645,群益金鼎-松山,2024-04-12,9103
2353,宏��,236,51,185,群益金鼎-松山,2024-04-12,9103
5512,力麒,250,117,133,群益金鼎-松山,2024-04-12,9103
1506,正道,109,0,109,群益金鼎-松山,2024-04-12,9103
2363,矽統,304,201,103,群益金鼎-松山,2024-04-12,9103
2506,太設,100,0,100,群益金鼎-松山,2024-04-12,9103
6164,華興,100,0,100,群益金鼎-松山,2024-04-12,9103
1504,東元,128,36,92,群益金鼎-松山,2024-04-12,9103
3450,聯鈞,92,0,92,群益金鼎-松山,2024-04-12,9103
6217,中探針,73,2,71,群益金鼎-松山,2024-04-12,9103
1815,富喬,64,13,51,群益金鼎-松山,2024-04-12,9103
2340,台亞,69,20,49,群益金鼎-松山,2024-04-12,9103
2382,廣達,56,10,46,群益金鼎-松山,2024-04-12,9103
8349,�矬�,43,0,43,群益金鼎-松山,2024-04-12,9103
6290,良維,42,0,42,群益金鼎-松山,2024-04-12,9103
2453,凌群,40,0,40,群益金鼎-松山,2024-04-12,9103
1616,億泰,31,0,31,群益金鼎-松山,2024-04-12,9103
1529,樂事綠能,30,0,30,群益金鼎-松山,2024-04-12,9103
8271,宇瞻,31,1,30,群益金鼎-松山,2024-04-12,9103
2606,裕民,30,1,29,群益金鼎-松山,2024-04-12,9103
2388,威盛,30,4,26,群益金鼎-松山,2024-04-12,9103
2465,麗臺,31,5,26,群益金鼎-松山,2024-04-12,9103
2610,華航,31,5,26,群益金鼎-松山,2024-04-12,9103
00720B,元大投資級公司債,22,0,22,群益金鼎-松山,2024-04-12,9103
1532,勤美,20,0,20,群益金鼎-松山,2024-04-12,9103
00940,元大台灣價值高息,22,2,20,群益金鼎-松山,2024-04-12,9103
2630,亞航,20,0,20,群益金鼎-松山,2024-04-12,9103
1453,大將,20,0,20,群益金鼎-松山,2024-04-12,9103
00688L,國泰20年美債正2,17,0,17,群益金鼎-松山,2024-04-12,9103
6213,聯茂,17,0,17,群益金鼎-松山,2024-04-12,9103
6125,廣運,19,3,16,群益金鼎-松山,2024-04-12,9103
6143,振曜,18,2,16,群益金鼎-松山,2024-04-12,9103
2241,艾姆勒,15,0,15,群益金鼎-松山,2024-04-12,9103
00632R,元大台灣50反1,13,0,13,群益金鼎-松山,2024-04-12,9103
2881,富邦金,13,1,12,群益金鼎-松山,2024-04-12,9103
1903,士紙,12,0,12,群益金鼎-松山,2024-04-12,9103
2501,國建,64,52,12,群益金鼎-松山,2024-04-12,9103
6117,迎廣,12,0,12,群益金鼎-松山,2024-04-12,9103
2009,第一銅,43,32,11,群益金鼎-松山,2024-04-12,9103
3025,星通,11,0,11,群益金鼎-松山,2024-04-12,9103
6139,亞翔,11,0,11,群益金鼎-松山,2024-04-12,9103
6415,矽力*-KY,10,0,10,群益金鼎-松山,2024-04-12,9103
5607,遠雄港,10,0,10,群益金鼎-松山,2024-04-12,9103
6449,鈺邦,10,0,10,群益金鼎-松山,2024-04-12,9103
6530,創威,10,0,10,群益金鼎-松山,2024-04-12,9103
8028,昇陽半導體,10,0,10,群益金鼎-松山,2024-04-12,9103
1503,士電,25,17,8,群益金鼎-松山,2024-04-12,9103
00679B,元大美債20年,8,0,8,群益金鼎-松山,2024-04-12,9103
00687B,國泰20年美債,8,0,8,群益金鼎-松山,2024-04-12,9103
3045,台灣大,500,0,500,群益金鼎-松山,2024-04-15,9103
2515,中工,300,1,299,群益金鼎-松山,2024-04-15,9103
2888,新光金,200,0,200,群益金鼎-松山,2024-04-15,9103
2610,華航,200,0,200,群益金鼎-松山,2024-04-15,9103
2337,旺宏,150,0,150,群益金鼎-松山,2024-04-15,9103
00655L,國泰中國A50正2,100,0,100,群益金鼎-松山,2024-04-15,9103
2014,中鴻,100,0,100,群益金鼎-松山,2024-04-15,9103
1616,億泰,130,31,99,群益金鼎-松山,2024-04-15,9103
00665L,富邦�琤肭磪囓�2,50,0,50,群益金鼎-松山,2024-04-15,9103
2388,威盛,81,31,50,群益金鼎-松山,2024-04-15,9103
4966,譜瑞-KY,50,0,50,群益金鼎-松山,2024-04-15,9103
6438,迅得,42,0,42,群益金鼎-松山,2024-04-15,9103
00878,國泰永續高股息,37,0,37,群益金鼎-松山,2024-04-15,9103
00939,統一台灣高息動能,36,0,36,群益金鼎-松山,2024-04-15,9103
1612,宏泰,117,82,35,群益金鼎-松山,2024-04-15,9103
1815,富喬,33,0,33,群益金鼎-松山,2024-04-15,9103
1608,華榮,134,105,29,群益金鼎-松山,2024-04-15,9103
2367,燿華,132,104,28,群益金鼎-松山,2024-04-15,9103
3708,上緯投控,30,5,25,群益金鼎-松山,2024-04-15,9103
2374,佳能,58,35,23,群益金鼎-松山,2024-04-15,9103
8349,�矬�,28,6,22,群益金鼎-松山,2024-04-15,9103
6770,力積電,21,0,21,群益金鼎-松山,2024-04-15,9103
2453,凌群,20,0,20,群益金鼎-松山,2024-04-15,9103
1503,士電,47,30,17,群益金鼎-松山,2024-04-15,9103
1789,神隆,15,0,15,群益金鼎-松山,2024-04-15,9103
00674R,期元大S＆P黃金反1,14,0,14,群益金鼎-松山,2024-04-15,9103
5381,合正,14,1,13,群益金鼎-松山,2024-04-15,9103
2408,南亞科,11,0,11,群益金鼎-松山,2024-04-15,9103
3260,威剛,11,0,11,群益金鼎-松山,2024-04-15,9103
2867,三商壽,10,0,10,群益金鼎-松山,2024-04-15,9103
00673R,期元大S＆P原油反1,10,0,10,群益金鼎-松山,2024-04-15,9103
2101,南港,10,0,10,群益金鼎-松山,2024-04-15,9103
3032,偉訓,10,0,10,群益金鼎-松山,2024-04-15,9103
4768,晶呈科技,15,5,10,群益金鼎-松山,2024-04-15,9103
8462,柏文,10,0,10,群益金鼎-松山,2024-04-15,9103
2208,台船,10,0,10,群益金鼎-松山,2024-04-15,9103
00919,群益台灣精選高息,9,0,9,群益金鼎-松山,2024-04-15,9103
00941,中信上游半導體,9,0,9,群益金鼎-松山,2024-04-15,9103
3013,晟銘電,15,6,9,群益金鼎-松山,2024-04-15,9103
3546,宇峻,7,0,7,群益金鼎-松山,2024-04-15,9103
2454,聯發科,6,0,6,群益金鼎-松山,2024-04-15,9103
1301,台塑,6,0,6,群益金鼎-松山,2024-04-15,9103
2313,華通,7,1,6,群益金鼎-松山,2024-04-15,9103
3217,優群,6,0,6,群益金鼎-松山,2024-04-15,9103
6213,聯茂,6,0,6,群益金鼎-松山,2024-04-15,9103
6477,安集,9,3,6,群益金鼎-松山,2024-04-15,9103
2330,台積電,6,0,6,群益金鼎-松山,2024-04-15,9103
2382,廣達,5,0,5,群益金鼎-松山,2024-04-15,9103
2353,宏��,5,0,5,群益金鼎-松山,2024-04-15,9103
3532,台勝科,5,0,5,群益金鼎-松山,2024-04-15,9103
3045,台灣大,516,0,516,群益金鼎-松山,2024-04-16,9103
2337,旺宏,235,0,235,群益金鼎-松山,2024-04-16,9103
2371,大同,165,16,149,群益金鼎-松山,2024-04-16,9103
00712,復華富時不動產,120,0,120,群益金鼎-松山,2024-04-16,9103
00680L,元大美債20正2,122,10,112,群益金鼎-松山,2024-04-16,9103
00664R,國泰臺灣加權反1,100,0,100,群益金鼎-松山,2024-04-16,9103
00940,元大台灣價值高息,89,13,76,群益金鼎-松山,2024-04-16,9103
00720B,元大投資級公司債,48,0,48,群益金鼎-松山,2024-04-16,9103
2009,第一銅,64,23,41,群益金鼎-松山,2024-04-16,9103
6274,台燿,40,0,40,群益金鼎-松山,2024-04-16,9103
8349,�矬�,34,0,34,群益金鼎-松山,2024-04-16,9103
3481,群創,25,0,25,群益金鼎-松山,2024-04-16,9103
2330,台積電,38,13,25,群益金鼎-松山,2024-04-16,9103
2317,鴻海,25,2,23,群益金鼎-松山,2024-04-16,9103
1609,大亞,219,196,23,群益金鼎-松山,2024-04-16,9103
2365,昆盈,30,8,22,群益金鼎-松山,2024-04-16,9103
2881,富邦金,17,0,17,群益金鼎-松山,2024-04-16,9103
2408,南亞科,16,0,16,群益金鼎-松山,2024-04-16,9103
3025,星通,16,0,16,群益金鼎-松山,2024-04-16,9103
00687B,國泰20年美債,17,2,15,群益金鼎-松山,2024-04-16,9103
2352,佳世達,14,0,14,群益金鼎-松山,2024-04-16,9103
2882,國泰金,14,0,14,群益金鼎-松山,2024-04-16,9103
2618,長榮航,13,0,13,群益金鼎-松山,2024-04-16,9103
2355,敬鵬,12,0,12,群益金鼎-松山,2024-04-16,9103
6719,力智,12,0,12,群益金鼎-松山,2024-04-16,9103
2887,台新金,11,0,11,群益金鼎-松山,2024-04-16,9103
00896,中信綠能及電動車,11,0,11,群益金鼎-松山,2024-04-16,9103
2888,新光金,11,0,11,群益金鼎-松山,2024-04-16,9103
00929,復華台灣科技優息,31,21,10,群益金鼎-松山,2024-04-16,9103
1102,亞泥,10,0,10,群益金鼎-松山,2024-04-16,9103
2328,廣宇,10,0,10,群益金鼎-松山,2024-04-16,9103
2891,中信金,10,0,10,群益金鼎-松山,2024-04-16,9103
4564,元翎,10,0,10,群益金鼎-松山,2024-04-16,9103
2002,中鋼,10,1,9,群益金鼎-松山,2024-04-16,9103
00878,國泰永續高股息,10,2,8,群益金鼎-松山,2024-04-16,9103
2353,宏��,8,0,8,群益金鼎-松山,2024-04-16,9103
3013,晟銘電,14,6,8,群益金鼎-松山,2024-04-16,9103
3546,宇峻,8,0,8,群益金鼎-松山,2024-04-16,9103
5222,全訊,8,0,8,群益金鼎-松山,2024-04-16,9103
6416,瑞祺電通,8,0,8,群益金鼎-松山,2024-04-16,9103
9962,有益,8,0,8,群益金鼎-松山,2024-04-16,9103
6143,振曜,9,2,7,群益金鼎-松山,2024-04-16,9103
1605,華新,7,0,7,群益金鼎-松山,2024-04-16,9103
1815,富喬,23,16,7,群益金鼎-松山,2024-04-16,9103
2889,國票金,7,0,7,群益金鼎-松山,2024-04-16,9103
3022,威強電,7,0,7,群益金鼎-松山,2024-04-16,9103
3206,志豐,7,0,7,群益金鼎-松山,2024-04-16,9103
6257,矽格,7,0,7,群益金鼎-松山,2024-04-16,9103
2834,臺企銀,6,0,6,群益金鼎-松山,2024-04-16,9103
1326,台化,6,0,6,群益金鼎-松山,2024-04-16,9103
2888,新光金,160,1,159,群益金鼎-松山,2024-04-17,9103
3045,台灣大,139,0,139,群益金鼎-松山,2024-04-17,9103
1453,大將,100,0,100,群益金鼎-松山,2024-04-17,9103
2363,矽統,95,3,92,群益金鼎-松山,2024-04-17,9103
3015,全漢,75,0,75,群益金鼎-松山,2024-04-17,9103
2317,鴻海,61,9,52,群益金鼎-松山,2024-04-17,9103
5371,中光電,55,4,51,群益金鼎-松山,2024-04-17,9103
2501,國建,50,5,45,群益金鼎-松山,2024-04-17,9103
00937B,群益ESG投等債20,38,0,38,群益金鼎-松山,2024-04-17,9103
3708,上緯投控,36,0,36,群益金鼎-松山,2024-04-17,9103
4532,瑞智,30,0,30,群益金鼎-松山,2024-04-17,9103
5009,榮剛,26,0,26,群益金鼎-松山,2024-04-17,9103
2891,中信金,25,0,25,群益金鼎-松山,2024-04-17,9103
8349,�矬�,40,16,24,群益金鼎-松山,2024-04-17,9103
1514,亞力,48,26,22,群益金鼎-松山,2024-04-17,9103
1810,和成,24,2,22,群益金鼎-松山,2024-04-17,9103
1608,華榮,31,10,21,群益金鼎-松山,2024-04-17,9103
00706L,期元大S＆P日圓正2,20,0,20,群益金鼎-松山,2024-04-17,9103
3003,健和興,20,0,20,群益金鼎-松山,2024-04-17,9103
1503,士電,29,9,20,群益金鼎-松山,2024-04-17,9103
1612,宏泰,20,1,19,群益金鼎-松山,2024-04-17,9103
1513,中興電,20,4,16,群益金鼎-松山,2024-04-17,9103
00773B,中信優先金融債,15,0,15,群益金鼎-松山,2024-04-17,9103
6531,愛普*,15,0,15,群益金鼎-松山,2024-04-17,9103
8210,勤誠,21,6,15,群益金鼎-松山,2024-04-17,9103
0056,元大高股息,20,5,15,群益金鼎-松山,2024-04-17,9103
6770,力積電,24,10,14,群益金鼎-松山,2024-04-17,9103
3715,定穎投控,14,0,14,群益金鼎-松山,2024-04-17,9103
00712,復華富時不動產,13,0,13,群益金鼎-松山,2024-04-17,9103
00720B,元大投資級公司債,26,15,11,群益金鼎-松山,2024-04-17,9103
2371,大同,143,132,11,群益金鼎-松山,2024-04-17,9103
00940,元大台灣價值高息,17,7,10,群益金鼎-松山,2024-04-17,9103
00665L,富邦�琤肭磪囓�2,10,0,10,群益金鼎-松山,2024-04-17,9103
2537,聯上發,10,0,10,群益金鼎-松山,2024-04-17,9103
3005,神基,10,0,10,群益金鼎-松山,2024-04-17,9103
2356,英業達,17,7,10,群益金鼎-松山,2024-04-17,9103
6150,撼訊,9,0,9,群益金鼎-松山,2024-04-17,9103
6125,廣運,9,0,9,群益金鼎-松山,2024-04-17,9103
00725B,國泰投資級公司債,8,0,8,群益金鼎-松山,2024-04-17,9103
00931B,統一美債20年,8,0,8,群益金鼎-松山,2024-04-17,9103
2359,所羅門,10,2,8,群益金鼎-松山,2024-04-17,9103
3380,明泰,8,0,8,群益金鼎-松山,2024-04-17,9103
6789,采鈺,7,0,7,群益金鼎-松山,2024-04-17,9103
3037,欣興,6,0,6,群益金鼎-松山,2024-04-17,9103
3312,弘憶股,11,5,6,群益金鼎-松山,2024-04-17,9103
3339,泰谷,6,0,6,群益金鼎-松山,2024-04-17,9103
6605,帝寶,6,0,6,群益金鼎-松山,2024-04-17,9103
00929,復華台灣科技優息,6,1,5,群益金鼎-松山,2024-04-17,9103
2353,宏��,5,0,5,群益金鼎-松山,2024-04-17,9103
2485,兆赫,10,5,5,群益金鼎-松山,2024-04-17,9103
2515,中工,155,0,155,群益金鼎-松山,2024-04-18,9103
3266,昇陽,127,0,127,群益金鼎-松山,2024-04-18,9103
2516,新建,100,0,100,群益金鼎-松山,2024-04-18,9103
2534,宏盛,60,0,60,群益金鼎-松山,2024-04-18,9103
2374,佳能,85,27,58,群益金鼎-松山,2024-04-18,9103
3217,優群,90,42,48,群益金鼎-松山,2024-04-18,9103
1532,勤美,40,0,40,群益金鼎-松山,2024-04-18,9103
2548,華固,36,0,36,群益金鼎-松山,2024-04-18,9103
3703,欣陸,35,0,35,群益金鼎-松山,2024-04-18,9103
2505,國揚,30,0,30,群益金鼎-松山,2024-04-18,9103
2538,基泰,30,0,30,群益金鼎-松山,2024-04-18,9103
2542,興富發,30,0,30,群益金鼎-松山,2024-04-18,9103
5522,遠雄,30,0,30,群益金鼎-松山,2024-04-18,9103
6219,富旺,30,0,30,群益金鼎-松山,2024-04-18,9103
9955,佳龍,31,1,30,群益金鼎-松山,2024-04-18,9103
1504,東元,32,8,24,群益金鼎-松山,2024-04-18,9103
1903,士紙,23,0,23,群益金鼎-松山,2024-04-18,9103
8349,�矬�,27,4,23,群益金鼎-松山,2024-04-18,9103
1603,華電,23,1,22,群益金鼎-松山,2024-04-18,9103
5515,建國,52,30,22,群益金鼎-松山,2024-04-18,9103
00664R,國泰臺灣加權反1,20,0,20,群益金鼎-松山,2024-04-18,9103
2101,南港,20,0,20,群益金鼎-松山,2024-04-18,9103
2537,聯上發,20,0,20,群益金鼎-松山,2024-04-18,9103
5534,長虹,29,9,20,群益金鼎-松山,2024-04-18,9103
6782,視陽,19,0,19,群益金鼎-松山,2024-04-18,9103
00706L,期元大S＆P日圓正2,18,0,18,群益金鼎-松山,2024-04-18,9103
8930,青鋼,18,0,18,群益金鼎-松山,2024-04-18,9103
5529,鉅陞,17,0,17,群益金鼎-松山,2024-04-18,9103
00632R,元大台灣50反1,75,60,15,群益金鼎-松山,2024-04-18,9103
1608,華榮,137,123,14,群益金鼎-松山,2024-04-18,9103
1612,宏泰,89,76,13,群益金鼎-松山,2024-04-18,9103
1605,華新,122,110,12,群益金鼎-松山,2024-04-18,9103
2382,廣達,12,0,12,群益金鼎-松山,2024-04-18,9103
3702,大聯大,12,0,12,群益金鼎-松山,2024-04-18,9103
1615,大山,11,0,11,群益金鼎-松山,2024-04-18,9103
2504,國產,91,80,11,群益金鼎-松山,2024-04-18,9103
3016,嘉晶,13,2,11,群益金鼎-松山,2024-04-18,9103
3441,聯一光,11,0,11,群益金鼎-松山,2024-04-18,9103
3294,英濟,10,0,10,群益金鼎-松山,2024-04-18,9103
3325,旭品,10,0,10,群益金鼎-松山,2024-04-18,9103
5608,四維航,10,0,10,群益金鼎-松山,2024-04-18,9103
6770,力積電,10,0,10,群益金鼎-松山,2024-04-18,9103
1303,南亞,9,0,9,群益金鼎-松山,2024-04-18,9103
2201,裕隆,29,20,9,群益金鼎-松山,2024-04-18,9103
2630,亞航,50,41,9,群益金鼎-松山,2024-04-18,9103
00927,群益半導體收益,8,0,8,群益金鼎-松山,2024-04-18,9103
3708,上緯投控,17,9,8,群益金鼎-松山,2024-04-18,9103
2317,鴻海,6,0,6,群益金鼎-松山,2024-04-18,9103
2353,宏��,6,0,6,群益金鼎-松山,2024-04-18,9103
2467,志聖,7,1,6,群益金鼎-松山,2024-04-18,9103
2330,台積電,134,2,132,群益金鼎-松山,2024-04-19,9103
5512,力麒,111,10,101,群益金鼎-松山,2024-04-19,9103
2547,日勝生,300,200,100,群益金鼎-松山,2024-04-19,9103
5531,鄉林,400,300,100,群益金鼎-松山,2024-04-19,9103
5521,工信,402,306,96,群益金鼎-松山,2024-04-19,9103
2337,旺宏,95,0,95,群益金鼎-松山,2024-04-19,9103
2101,南港,132,70,62,群益金鼎-松山,2024-04-19,9103
00939,統一台灣高息動能,58,0,58,群益金鼎-松山,2024-04-19,9103
00940,元大台灣價值高息,110,56,54,群益金鼎-松山,2024-04-19,9103
1609,大亞,164,114,50,群益金鼎-松山,2024-04-19,9103
4966,譜瑞-KY,50,0,50,群益金鼎-松山,2024-04-19,9103
3363,上詮,31,0,31,群益金鼎-松山,2024-04-19,9103
2520,冠德,81,51,30,群益金鼎-松山,2024-04-19,9103
1514,亞力,25,0,25,群益金鼎-松山,2024-04-19,9103
00929,復華台灣科技優息,24,0,24,群益金鼎-松山,2024-04-19,9103
2009,第一銅,50,27,23,群益金鼎-松山,2024-04-19,9103
00922,國泰台灣領袖50,21,0,21,群益金鼎-松山,2024-04-19,9103
3450,聯鈞,21,0,21,群益金鼎-松山,2024-04-19,9103
2881,富邦金,20,0,20,群益金鼎-松山,2024-04-19,9103
2328,廣宇,20,0,20,群益金鼎-松山,2024-04-19,9103
4588,玖鼎電力,20,0,20,群益金鼎-松山,2024-04-19,9103
8349,�矬�,37,17,20,群益金鼎-松山,2024-04-19,9103
2303,聯電,20,2,18,群益金鼎-松山,2024-04-19,9103
00878,國泰永續高股息,15,0,15,群益金鼎-松山,2024-04-19,9103
3022,威強電,15,0,15,群益金鼎-松山,2024-04-19,9103
3231,緯創,15,0,15,群益金鼎-松山,2024-04-19,9103
5009,榮剛,20,6,14,群益金鼎-松山,2024-04-19,9103
00919,群益台灣精選高息,25,11,14,群益金鼎-松山,2024-04-19,9103
2367,燿華,13,0,13,群益金鼎-松山,2024-04-19,9103
3707,漢磊,13,0,13,群益金鼎-松山,2024-04-19,9103
6274,台燿,13,1,12,群益金鼎-松山,2024-04-19,9103
2618,長榮航,12,1,11,群益金鼎-松山,2024-04-19,9103
00935,野村臺灣新科技50,10,0,10,群益金鼎-松山,2024-04-19,9103
00934,中信成長高股息,10,0,10,群益金鼎-松山,2024-04-19,9103
00733,富邦臺灣中小,10,0,10,群益金鼎-松山,2024-04-19,9103
00669R,國泰美國道瓊反1,10,0,10,群益金鼎-松山,2024-04-19,9103
1717,長興,10,0,10,群益金鼎-松山,2024-04-19,9103
2038,海光,10,0,10,群益金鼎-松山,2024-04-19,9103
3033,威健,10,0,10,群益金鼎-松山,2024-04-19,9103
6230,尼得科超眾,10,0,10,群益金鼎-松山,2024-04-19,9103
00687B,國泰20年美債,10,1,9,群益金鼎-松山,2024-04-19,9103
2884,玉山金,10,1,9,群益金鼎-松山,2024-04-19,9103
2454,聯發科,8,0,8,群益金鼎-松山,2024-04-19,9103
2630,亞航,21,13,8,群益金鼎-松山,2024-04-19,9103
3037,欣興,7,0,7,群益金鼎-松山,2024-04-19,9103
3481,群創,8,1,7,群益金鼎-松山,2024-04-19,9103
00706L,期元大S＆P日圓正2,7,0,7,群益金鼎-松山,2024-04-19,9103
00650L,復華香港正2,7,0,7,群益金鼎-松山,2024-04-19,9103
3017,奇鋐,19,12,7,群益金鼎-松山,2024-04-19,9103
6005,群益證,8,1,7,群益金鼎-松山,2024-04-19,9103
2516,新建,200,0,200,群益金鼎-松山,2024-04-22,9103
1513,中興電,152,41,111,群益金鼎-松山,2024-04-22,9103
2618,長榮航,100,1,99,群益金鼎-松山,2024-04-22,9103
00937B,群益ESG投等債20,95,0,95,群益金鼎-松山,2024-04-22,9103
1617,榮星,62,2,60,群益金鼎-松山,2024-04-22,9103
1618,合機,57,1,56,群益金鼎-松山,2024-04-22,9103
2501,國建,81,30,51,群益金鼎-松山,2024-04-22,9103
00674R,期元大S＆P黃金反1,50,0,50,群益金鼎-松山,2024-04-22,9103
2363,矽統,37,1,36,群益金鼎-松山,2024-04-22,9103
3708,上緯投控,35,0,35,群益金鼎-松山,2024-04-22,9103
4157,太景*-KY,33,3,30,群益金鼎-松山,2024-04-22,9103
5529,鉅陞,30,0,30,群益金鼎-松山,2024-04-22,9103
3703,欣陸,108,80,28,群益金鼎-松山,2024-04-22,9103
00929,復華台灣科技優息,31,6,25,群益金鼎-松山,2024-04-22,9103
8349,�矬�,23,0,23,群益金鼎-松山,2024-04-22,9103
3013,晟銘電,44,22,22,群益金鼎-松山,2024-04-22,9103
2465,麗臺,22,1,21,群益金鼎-松山,2024-04-22,9103
5351,鈺創,20,0,20,群益金鼎-松山,2024-04-22,9103
00940,元大台灣價值高息,17,0,17,群益金鼎-松山,2024-04-22,9103
9945,潤泰新,21,7,14,群益金鼎-松山,2024-04-22,9103
2520,冠德,194,181,13,群益金鼎-松山,2024-04-22,9103
1609,大亞,93,81,12,群益金鼎-松山,2024-04-22,9103
2303,聯電,11,1,10,群益金鼎-松山,2024-04-22,9103
1409,新纖,10,0,10,群益金鼎-松山,2024-04-22,9103
2328,廣宇,10,0,10,群益金鼎-松山,2024-04-22,9103
2344,華邦電,10,0,10,群益金鼎-松山,2024-04-22,9103
2408,南亞科,10,0,10,群益金鼎-松山,2024-04-22,9103
6869,雲豹能源,10,0,10,群益金鼎-松山,2024-04-22,9103
2597,潤弘,9,0,9,群益金鼎-松山,2024-04-22,9103
00878,國泰永續高股息,8,0,8,群益金鼎-松山,2024-04-22,9103
3231,緯創,6,0,6,群益金鼎-松山,2024-04-22,9103
2425,承啟,6,0,6,群益金鼎-松山,2024-04-22,9103
5230,雷笛克光學,36,30,6,群益金鼎-松山,2024-04-22,9103
3042,晶技,5,0,5,群益金鼎-松山,2024-04-22,9103
2379,瑞昱,5,0,5,群益金鼎-松山,2024-04-22,9103
00896,中信綠能及電動車,5,0,5,群益金鼎-松山,2024-04-22,9103
2867,三商壽,5,0,5,群益金鼎-松山,2024-04-22,9103
2884,玉山金,10,5,5,群益金鼎-松山,2024-04-22,9103
3450,聯鈞,5,0,5,群益金鼎-松山,2024-04-22,9103
3609,三一東林,5,0,5,群益金鼎-松山,2024-04-22,9103
3706,神達,5,0,5,群益金鼎-松山,2024-04-22,9103
5009,榮剛,5,0,5,群益金鼎-松山,2024-04-22,9103
6120,達運,9,4,5,群益金鼎-松山,2024-04-22,9103
8163,達方,5,0,5,群益金鼎-松山,2024-04-22,9103
9919,康那香,8,3,5,群益金鼎-松山,2024-04-22,9103
1504,東元,7,3,4,群益金鼎-松山,2024-04-22,9103
00725B,國泰投資級公司債,5,1,4,群益金鼎-松山,2024-04-22,9103
2329,華泰,5,1,4,群益金鼎-松山,2024-04-22,9103
2331,精英,6,2,4,群益金鼎-松山,2024-04-22,9103
2393,億光,7,3,4,群益金鼎-松山,2024-04-22,9103
2618,長榮航,183,7,176,群益金鼎-松山,2024-04-23,9103
2511,太子,401,300,101,群益金鼎-松山,2024-04-23,9103
2888,新光金,100,0,100,群益金鼎-松山,2024-04-23,9103
6770,力積電,57,0,57,群益金鼎-松山,2024-04-23,9103
5531,鄉林,50,0,50,群益金鼎-松山,2024-04-23,9103
2374,佳能,43,2,41,群益金鼎-松山,2024-04-23,9103
1453,大將,30,0,30,群益金鼎-松山,2024-04-23,9103
1608,華榮,116,86,30,群益金鼎-松山,2024-04-23,9103
9955,佳龍,27,0,27,群益金鼎-松山,2024-04-23,9103
2330,台積電,22,1,21,群益金鼎-松山,2024-04-23,9103
00733,富邦臺灣中小,20,0,20,群益金鼎-松山,2024-04-23,9103
4533,協易機,20,0,20,群益金鼎-松山,2024-04-23,9103
4966,譜瑞-KY,16,0,16,群益金鼎-松山,2024-04-23,9103
8349,�矬�,28,12,16,群益金鼎-松山,2024-04-23,9103
3706,神達,15,0,15,群益金鼎-松山,2024-04-23,9103
5529,鉅陞,15,0,15,群益金鼎-松山,2024-04-23,9103
00929,復華台灣科技優息,24,10,14,群益金鼎-松山,2024-04-23,9103
2206,三陽工業,51,37,14,群益金鼎-松山,2024-04-23,9103
2303,聯電,14,0,14,群益金鼎-松山,2024-04-23,9103
8054,安國,30,17,13,群益金鼎-松山,2024-04-23,9103
5324,士開,12,0,12,群益金鼎-松山,2024-04-23,9103
1605,華新,10,0,10,群益金鼎-松山,2024-04-23,9103
1733,五鼎,10,0,10,群益金鼎-松山,2024-04-23,9103
2312,金寶,10,0,10,群益金鼎-松山,2024-04-23,9103
2462,良得電,10,0,10,群益金鼎-松山,2024-04-23,9103
4924,欣厚-KY,10,0,10,群益金鼎-松山,2024-04-23,9103
8027,鈦昇,10,0,10,群益金鼎-松山,2024-04-23,9103
2915,潤泰全,9,0,9,群益金鼎-松山,2024-04-23,9103
2313,華通,8,0,8,群益金鼎-松山,2024-04-23,9103
6143,振曜,7,0,7,群益金鼎-松山,2024-04-23,9103
00878,國泰永續高股息,7,1,6,群益金鼎-松山,2024-04-23,9103
3036,文曄,6,0,6,群益金鼎-松山,2024-04-23,9103
3622,洋華,6,0,6,群益金鼎-松山,2024-04-23,9103
00919,群益台灣精選高息,5,0,5,群益金鼎-松山,2024-04-23,9103
00632R,元大台灣50反1,15,10,5,群益金鼎-松山,2024-04-23,9103
6187,萬潤,5,0,5,群益金鼎-松山,2024-04-23,9103
1609,大亞,96,92,4,群益金鼎-松山,2024-04-23,9103
2809,京城銀,4,0,4,群益金鼎-松山,2024-04-23,9103
3231,緯創,6,2,4,群益金鼎-松山,2024-04-23,9103
6282,康舒,4,0,4,群益金鼎-松山,2024-04-23,9103
9945,潤泰新,4,0,4,群益金鼎-松山,2024-04-23,9103
00940,元大台灣價值高息,4,1,3,群益金鼎-松山,2024-04-23,9103
1720,生達,3,0,3,群益金鼎-松山,2024-04-23,9103
2317,鴻海,5,2,3,群益金鼎-松山,2024-04-23,9103
2357,華碩,3,0,3,群益金鼎-松山,2024-04-23,9103
3289,宜特,3,0,3,群益金鼎-松山,2024-04-23,9103
3312,弘憶股,3,0,3,群益金鼎-松山,2024-04-23,9103
3491,昇達科,7,4,3,群益金鼎-松山,2024-04-23,9103
6139,亞翔,3,0,3,群益金鼎-松山,2024-04-23,9103
8936,國統,11,8,3,群益金鼎-松山,2024-04-23,9103
2618,長榮航,126,17,109,群益金鼎-松山,2024-04-24,9103
5521,工信,100,0,100,群益金鼎-松山,2024-04-24,9103
2888,新光金,102,61,41,群益金鼎-松山,2024-04-24,9103
4533,協易機,51,20,31,群益金鼎-松山,2024-04-24,9103
1532,勤美,30,0,30,群益金鼎-松山,2024-04-24,9103
3260,威剛,32,2,30,群益金鼎-松山,2024-04-24,9103
8463,潤泰材,30,0,30,群益金鼎-松山,2024-04-24,9103
3231,緯創,37,10,27,群益金鼎-松山,2024-04-24,9103
3715,定穎投控,24,1,23,群益金鼎-松山,2024-04-24,9103
1618,合機,103,81,22,群益金鼎-松山,2024-04-24,9103
00632R,元大台灣50反1,21,0,21,群益金鼎-松山,2024-04-24,9103
2201,裕隆,21,0,21,群益金鼎-松山,2024-04-24,9103
1617,榮星,50,30,20,群益金鼎-松山,2024-04-24,9103
00687B,國泰20年美債,20,0,20,群益金鼎-松山,2024-04-24,9103
5522,遠雄,20,0,20,群益金鼎-松山,2024-04-24,9103
2317,鴻海,77,58,19,群益金鼎-松山,2024-04-24,9103
00900,富邦特選高股息30,17,0,17,群益金鼎-松山,2024-04-24,9103
00940,元大台灣價值高息,15,0,15,群益金鼎-松山,2024-04-24,9103
6120,達運,22,9,13,群益金鼎-松山,2024-04-24,9103
2501,國建,17,5,12,群益金鼎-松山,2024-04-24,9103
3059,華晶科,13,1,12,群益金鼎-松山,2024-04-24,9103
5348,正能量智能,12,0,12,群益金鼎-松山,2024-04-24,9103
1903,士紙,11,0,11,群益金鼎-松山,2024-04-24,9103
1609,大亞,55,44,11,群益金鼎-松山,2024-04-24,9103
1514,亞力,12,1,11,群益金鼎-松山,2024-04-24,9103
2367,燿華,13,2,11,群益金鼎-松山,2024-04-24,9103
8349,�矬�,19,8,11,群益金鼎-松山,2024-04-24,9103
00733,富邦臺灣中小,10,0,10,群益金鼎-松山,2024-04-24,9103
1608,華榮,91,81,10,群益金鼎-松山,2024-04-24,9103
2537,聯上發,10,0,10,群益金鼎-松山,2024-04-24,9103
3583,辛耘,12,4,8,群益金鼎-松山,2024-04-24,9103
1605,華新,8,0,8,群益金鼎-松山,2024-04-24,9103
2059,川湖,8,0,8,群益金鼎-松山,2024-04-24,9103
2637,慧洋-KY,8,0,8,群益金鼎-松山,2024-04-24,9103
1217,愛之味,7,0,7,群益金鼎-松山,2024-04-24,9103
3312,弘憶股,7,0,7,群益金鼎-松山,2024-04-24,9103
6462,神盾,6,0,6,群益金鼎-松山,2024-04-24,9103
2406,國碩,6,0,6,群益金鼎-松山,2024-04-24,9103
3703,欣陸,6,0,6,群益金鼎-松山,2024-04-24,9103
6187,萬潤,16,10,6,群益金鼎-松山,2024-04-24,9103
8936,國統,5,0,5,群益金鼎-松山,2024-04-24,9103
2383,台光電,11,6,5,群益金鼎-松山,2024-04-24,9103
2812,台中銀,5,0,5,群益金鼎-松山,2024-04-24,9103
5432,新門,5,0,5,群益金鼎-松山,2024-04-24,9103
6143,振曜,5,0,5,群益金鼎-松山,2024-04-24,9103
6239,力成,5,0,5,群益金鼎-松山,2024-04-24,9103
8070,長華*,5,0,5,群益金鼎-松山,2024-04-24,9103
6547,高端疫苗,5,1,4,群益金鼎-松山,2024-04-24,9103
2376,技嘉,8,4,4,群益金鼎-松山,2024-04-24,9103
2536,宏普,4,0,4,群益金鼎-松山,2024-04-24,9103
2206,三陽工業,57,16,41,群益金鼎-松山,2024-04-25,9103
2374,佳能,31,0,31,群益金鼎-松山,2024-04-25,9103
2504,國產,32,1,31,群益金鼎-松山,2024-04-25,9103
2520,冠德,120,90,30,群益金鼎-松山,2024-04-25,9103
2888,新光金,30,0,30,群益金鼎-松山,2024-04-25,9103
8349,�矬�,39,11,28,群益金鼎-松山,2024-04-25,9103
00919,群益台灣精選高息,25,0,25,群益金鼎-松山,2024-04-25,9103
2630,亞航,23,1,22,群益金鼎-松山,2024-04-25,9103
2501,國建,108,87,21,群益金鼎-松山,2024-04-25,9103
3013,晟銘電,27,8,19,群益金鼎-松山,2024-04-25,9103
2891,中信金,18,0,18,群益金鼎-松山,2024-04-25,9103
2363,矽統,151,134,17,群益金鼎-松山,2024-04-25,9103
2317,鴻海,19,3,16,群益金鼎-松山,2024-04-25,9103
2371,大同,35,21,14,群益金鼎-松山,2024-04-25,9103
6606,建德工業,14,0,14,群益金鼎-松山,2024-04-25,9103
2330,台積電,14,0,14,群益金鼎-松山,2024-04-25,9103
5348,正能量智能,11,0,11,群益金鼎-松山,2024-04-25,9103
6770,力積電,11,0,11,群益金鼎-松山,2024-04-25,9103
00706L,期元大S＆P日圓正2,10,0,10,群益金鼎-松山,2024-04-25,9103
00891,中信關鍵半導體,10,0,10,群益金鼎-松山,2024-04-25,9103
2355,敬鵬,10,0,10,群益金鼎-松山,2024-04-25,9103
2609,陽明,10,0,10,群益金鼎-松山,2024-04-25,9103
2743,山富,10,0,10,群益金鼎-松山,2024-04-25,9103
8033,雷虎,10,0,10,群益金鼎-松山,2024-04-25,9103
9907,統一實,10,0,10,群益金鼎-松山,2024-04-25,9103
2731,雄獅,10,1,9,群益金鼎-松山,2024-04-25,9103
00939,統一台灣高息動能,11,3,8,群益金鼎-松山,2024-04-25,9103
6782,視陽,8,0,8,群益金鼎-松山,2024-04-25,9103
2009,第一銅,9,2,7,群益金鼎-松山,2024-04-25,9103
2241,艾姆勒,8,1,7,群益金鼎-松山,2024-04-25,9103
00878,國泰永續高股息,6,0,6,群益金鼎-松山,2024-04-25,9103
1587,吉茂,6,0,6,群益金鼎-松山,2024-04-25,9103
2362,藍天,9,3,6,群益金鼎-松山,2024-04-25,9103
5511,德昌,6,0,6,群益金鼎-松山,2024-04-25,9103
00896,中信綠能及電動車,5,0,5,群益金鼎-松山,2024-04-25,9103
00935,野村臺灣新科技50,5,0,5,群益金鼎-松山,2024-04-25,9103
00687B,國泰20年美債,5,0,5,群益金鼎-松山,2024-04-25,9103
1608,華榮,9,4,5,群益金鼎-松山,2024-04-25,9103
1808,潤隆,5,0,5,群益金鼎-松山,2024-04-25,9103
2312,金寶,5,0,5,群益金鼎-松山,2024-04-25,9103
3044,健鼎,5,0,5,群益金鼎-松山,2024-04-25,9103
3178,公準,114,109,5,群益金鼎-松山,2024-04-25,9103
3532,台勝科,5,0,5,群益金鼎-松山,2024-04-25,9103
3702,大聯大,5,0,5,群益金鼎-松山,2024-04-25,9103
4716,大立,20,15,5,群益金鼎-松山,2024-04-25,9103
4956,光鋐,5,0,5,群益金鼎-松山,2024-04-25,9103
5432,新門,5,0,5,群益金鼎-松山,2024-04-25,9103
6530,創威,5,0,5,群益金鼎-松山,2024-04-25,9103
2618,長榮航,16,11,5,群益金鼎-松山,2024-04-25,9103
1419,新紡,4,0,4,群益金鼎-松山,2024-04-25,9103
1417,嘉裕,100,0,100,群益金鼎-松山,2024-04-26,9103
1447,力鵬,100,0,100,群益金鼎-松山,2024-04-26,9103
5009,榮剛,101,1,100,群益金鼎-松山,2024-04-26,9103
2506,太設,100,1,99,群益金鼎-松山,2024-04-26,9103
2511,太子,200,101,99,群益金鼎-松山,2024-04-26,9103
1444,力麗,85,0,85,群益金鼎-松山,2024-04-26,9103
00937B,群益ESG投等債20,70,0,70,群益金鼎-松山,2024-04-26,9103
2618,長榮航,118,54,64,群益金鼎-松山,2024-04-26,9103
1104,環泥,50,0,50,群益金鼎-松山,2024-04-26,9103
1532,勤美,50,0,50,群益金鼎-松山,2024-04-26,9103
1609,大亞,75,26,49,群益金鼎-松山,2024-04-26,9103
1440,南紡,52,6,46,群益金鼎-松山,2024-04-26,9103
5324,士開,46,0,46,群益金鼎-松山,2024-04-26,9103
2545,皇翔,35,0,35,群益金鼎-松山,2024-04-26,9103
1612,宏泰,33,0,33,群益金鼎-松山,2024-04-26,9103
3030,德律,33,0,33,群益金鼎-松山,2024-04-26,9103
3266,昇陽,30,0,30,群益金鼎-松山,2024-04-26,9103
3703,欣陸,35,5,30,群益金鼎-松山,2024-04-26,9103
2615,萬海,30,1,29,群益金鼎-松山,2024-04-26,9103
2241,艾姆勒,42,15,27,群益金鼎-松山,2024-04-26,9103
1522,堤維西,25,0,25,群益金鼎-松山,2024-04-26,9103
3450,聯鈞,22,0,22,群益金鼎-松山,2024-04-26,9103
8349,�矬�,28,6,22,群益金鼎-松山,2024-04-26,9103
1513,中興電,22,1,21,群益金鼎-松山,2024-04-26,9103
2371,大同,60,40,20,群益金鼎-松山,2024-04-26,9103
3622,洋華,20,0,20,群益金鼎-松山,2024-04-26,9103
5347,世界,20,0,20,群益金鼎-松山,2024-04-26,9103
8210,勤誠,23,5,18,群益金鼎-松山,2024-04-26,9103
2101,南港,23,8,15,群益金鼎-松山,2024-04-26,9103
1903,士紙,13,0,13,群益金鼎-松山,2024-04-26,9103
5522,遠雄,22,10,12,群益金鼎-松山,2024-04-26,9103
2356,英業達,11,0,11,群益金鼎-松山,2024-04-26,9103
2359,所羅門,13,2,11,群益金鼎-松山,2024-04-26,9103
2363,矽統,73,62,11,群益金鼎-松山,2024-04-26,9103
1337,再生-KY,10,0,10,群益金鼎-松山,2024-04-26,9103
2376,技嘉,11,1,10,群益金鼎-松山,2024-04-26,9103
2408,南亞科,10,0,10,群益金鼎-松山,2024-04-26,9103
2542,興富發,50,40,10,群益金鼎-松山,2024-04-26,9103
3025,星通,10,0,10,群益金鼎-松山,2024-04-26,9103
3059,華晶科,10,0,10,群益金鼎-松山,2024-04-26,9103
5608,四維航,10,0,10,群益金鼎-松山,2024-04-26,9103
8409,商之器,10,0,10,群益金鼎-松山,2024-04-26,9103
00725B,國泰投資級公司債,8,0,8,群益金鼎-松山,2024-04-26,9103
00632R,元大台灣50反1,12,4,8,群益金鼎-松山,2024-04-26,9103
2033,佳大,8,0,8,群益金鼎-松山,2024-04-26,9103
3686,達能,10,2,8,群益金鼎-松山,2024-04-26,9103
00679B,元大美債20年,7,0,7,群益金鼎-松山,2024-04-26,9103
3466,德晉,10,3,7,群益金鼎-松山,2024-04-26,9103
5534,長虹,11,4,7,群益金鼎-松山,2024-04-26,9103
00885,富邦越南,6,0,6,群益金鼎-松山,2024-04-26,9103
2409,友達,200,0,200,群益金鼎-松山,2024-04-29,9103
6217,中探針,159,0,159,群益金鼎-松山,2024-04-29,9103
5512,力麒,100,0,100,群益金鼎-松山,2024-04-29,9103
3266,昇陽,100,30,70,群益金鼎-松山,2024-04-29,9103
00929,復華台灣科技優息,50,0,50,群益金鼎-松山,2024-04-29,9103
00919,群益台灣精選高息,50,0,50,群益金鼎-松山,2024-04-29,9103
9945,潤泰新,51,1,50,群益金鼎-松山,2024-04-29,9103
2913,農林,51,10,41,群益金鼎-松山,2024-04-29,9103
2618,長榮航,44,4,40,群益金鼎-松山,2024-04-29,9103
1722,台肥,150,111,39,群益金鼎-松山,2024-04-29,9103
2505,國揚,30,0,30,群益金鼎-松山,2024-04-29,9103
4533,協易機,30,0,30,群益金鼎-松山,2024-04-29,9103
2645,長榮航太,26,0,26,群益金鼎-松山,2024-04-29,9103
00632R,元大台灣50反1,35,10,25,群益金鼎-松山,2024-04-29,9103
1522,堤維西,25,1,24,群益金鼎-松山,2024-04-29,9103
3532,台勝科,20,0,20,群益金鼎-松山,2024-04-29,9103
2458,義隆,20,1,19,群益金鼎-松山,2024-04-29,9103
2637,慧洋-KY,31,12,19,群益金鼎-松山,2024-04-29,9103
2903,遠百,20,1,19,群益金鼎-松山,2024-04-29,9103
9907,統一實,20,1,19,群益金鼎-松山,2024-04-29,9103
8349,�矬�,19,2,17,群益金鼎-松山,2024-04-29,9103
2603,長榮,25,8,17,群益金鼎-松山,2024-04-29,9103
3013,晟銘電,21,5,16,群益金鼎-松山,2024-04-29,9103
2542,興富發,30,17,13,群益金鼎-松山,2024-04-29,9103
1608,華榮,13,1,12,群益金鼎-松山,2024-04-29,9103
2376,技嘉,12,0,12,群益金鼎-松山,2024-04-29,9103
6143,振曜,26,15,11,群益金鼎-松山,2024-04-29,9103
5522,遠雄,30,20,10,群益金鼎-松山,2024-04-29,9103
1312,國喬,10,0,10,群益金鼎-松山,2024-04-29,9103
00650L,復華香港正2,10,0,10,群益金鼎-松山,2024-04-29,9103
2705,六福,10,0,10,群益金鼎-松山,2024-04-29,9103
5864,致和證,10,0,10,群益金鼎-松山,2024-04-29,9103
2317,鴻海,32,22,10,群益金鼎-松山,2024-04-29,9103
1815,富喬,15,6,9,群益金鼎-松山,2024-04-29,9103
8110,華東,9,0,9,群益金鼎-松山,2024-04-29,9103
1457,宜進,10,1,9,群益金鼎-松山,2024-04-29,9103
6005,群益證,11,4,7,群益金鼎-松山,2024-04-29,9103
6125,廣運,13,6,7,群益金鼎-松山,2024-04-29,9103
00655L,國泰中國A50正2,6,0,6,群益金鼎-松山,2024-04-29,9103
1560,中砂,6,0,6,群益金鼎-松山,2024-04-29,9103
2328,廣宇,5,0,5,群益金鼎-松山,2024-04-29,9103
2201,裕隆,5,0,5,群益金鼎-松山,2024-04-29,9103
2890,永豐金,5,0,5,群益金鼎-松山,2024-04-29,9103
4536,拓凱,5,0,5,群益金鼎-松山,2024-04-29,9103
8096,擎亞,5,0,5,群益金鼎-松山,2024-04-29,9103
3443,創意,6,1,5,群益金鼎-松山,2024-04-29,9103
6244,茂迪,5,0,5,群益金鼎-松山,2024-04-29,9103
1707,葡萄王,4,0,4,群益金鼎-松山,2024-04-29,9103
3483,力致,8,4,4,群益金鼎-松山,2024-04-29,9103
3512,皇龍,4,0,4,群益金鼎-松山,2024-04-29,9103
2515,中工,203,1,202,群益金鼎-松山,2024-04-30,9103
1513,中興電,204,4,200,群益金鼎-松山,2024-04-30,9103
8096,擎亞,61,11,50,群益金鼎-松山,2024-04-30,9103
3376,新日興,48,3,45,群益金鼎-松山,2024-04-30,9103
1314,中石化,45,3,42,群益金鼎-松山,2024-04-30,9103
8349,�矬�,39,9,30,群益金鼎-松山,2024-04-30,9103
3363,上詮,28,1,27,群益金鼎-松山,2024-04-30,9103
2501,國建,98,74,24,群益金鼎-松山,2024-04-30,9103
1609,大亞,35,13,22,群益金鼎-松山,2024-04-30,9103
2312,金寶,20,0,20,群益金鼎-松山,2024-04-30,9103
00929,復華台灣科技優息,20,1,19,群益金鼎-松山,2024-04-30,9103
4968,立積,23,4,19,群益金鼎-松山,2024-04-30,9103
4915,致伸,18,0,18,群益金鼎-松山,2024-04-30,9103
2363,矽統,100,84,16,群益金鼎-松山,2024-04-30,9103
3715,定穎投控,16,5,11,群益金鼎-松山,2024-04-30,9103
2201,裕隆,40,30,10,群益金鼎-松山,2024-04-30,9103
2406,國碩,10,0,10,群益金鼎-松山,2024-04-30,9103
2476,鉅祥,10,0,10,群益金鼎-松山,2024-04-30,9103
2534,宏盛,10,0,10,群益金鼎-松山,2024-04-30,9103
6143,振曜,20,10,10,群益金鼎-松山,2024-04-30,9103
6526,達發,10,1,9,群益金鼎-松山,2024-04-30,9103
3450,聯鈞,6,0,6,群益金鼎-松山,2024-04-30,9103
6768,志強-KY,6,0,6,群益金鼎-松山,2024-04-30,9103
1810,和成,5,0,5,群益金鼎-松山,2024-04-30,9103
5469,瀚宇博,5,0,5,群益金鼎-松山,2024-04-30,9103
6150,撼訊,5,0,5,群益金鼎-松山,2024-04-30,9103
6443,元晶,5,0,5,群益金鼎-松山,2024-04-30,9103
1725,元禎,4,0,4,群益金鼎-松山,2024-04-30,9103
2603,長榮,5,1,4,群益金鼎-松山,2024-04-30,9103
2645,長榮航太,5,1,4,群益金鼎-松山,2024-04-30,9103
3483,力致,6,2,4,群益金鼎-松山,2024-04-30,9103
1316,上曜,12,9,3,群益金鼎-松山,2024-04-30,9103
2317,鴻海,11,8,3,群益金鼎-松山,2024-04-30,9103
2342,茂矽,3,0,3,群益金鼎-松山,2024-04-30,9103
2537,聯上發,105,102,3,群益金鼎-松山,2024-04-30,9103
3512,皇龍,4,1,3,群益金鼎-松山,2024-04-30,9103
3617,碩天,3,0,3,群益金鼎-松山,2024-04-30,9103
4760,勤凱,3,0,3,群益金鼎-松山,2024-04-30,9103
6776,展�眥篕�,3,0,3,群益金鼎-松山,2024-04-30,9103
6856,鑫傳,3,0,3,群益金鼎-松山,2024-04-30,9103
1102,亞泥,2,0,2,群益金鼎-松山,2024-04-30,9103
8028,昇陽半導體,2,0,2,群益金鼎-松山,2024-04-30,9103
00940,元大台灣價值高息,2,0,2,群益金鼎-松山,2024-04-30,9103
00918,大華優利高填息30,2,0,2,群益金鼎-松山,2024-04-30,9103
00713,元大台灣高息低波,2,0,2,群益金鼎-松山,2024-04-30,9103
00637L,元大滬深300正2,7,5,2,群益金鼎-松山,2024-04-30,9103
2359,所羅門,3,1,2,群益金鼎-松山,2024-04-30,9103
2423,固緯,4,2,2,群益金鼎-松山,2024-04-30,9103
2851,中再保,2,0,2,群益金鼎-松山,2024-04-30,9103
3441,聯一光,2,0,2,群益金鼎-松山,2024-04-30,9103
1314,中石化,243,46,197,群益金鼎-松山,2024-05-02,9103
2906,高林,150,0,150,群益金鼎-松山,2024-05-02,9103
2913,農林,141,11,130,群益金鼎-松山,2024-05-02,9103
1440,南紡,102,0,102,群益金鼎-松山,2024-05-02,9103
1447,力鵬,100,0,100,群益金鼎-松山,2024-05-02,9103
1417,嘉裕,100,0,100,群益金鼎-松山,2024-05-02,9103
2547,日勝生,100,0,100,群益金鼎-松山,2024-05-02,9103
5512,力麒,101,2,99,群益金鼎-松山,2024-05-02,9103
3033,威健,86,3,83,群益金鼎-松山,2024-05-02,9103
2501,國建,189,118,71,群益金鼎-松山,2024-05-02,9103
00940,元大台灣價值高息,62,0,62,群益金鼎-松山,2024-05-02,9103
1414,東和,58,0,58,群益金鼎-松山,2024-05-02,9103
3703,欣陸,181,125,56,群益金鼎-松山,2024-05-02,9103
1459,聯發,50,0,50,群益金鼎-松山,2024-05-02,9103
2534,宏盛,60,10,50,群益金鼎-松山,2024-05-02,9103
1808,潤隆,50,3,47,群益金鼎-松山,2024-05-02,9103
3031,佰鴻,40,0,40,群益金鼎-松山,2024-05-02,9103
2615,萬海,38,1,37,群益金鼎-松山,2024-05-02,9103
2618,長榮航,54,21,33,群益金鼎-松山,2024-05-02,9103
9945,潤泰新,70,38,32,群益金鼎-松山,2024-05-02,9103
1444,力麗,31,0,31,群益金鼎-松山,2024-05-02,9103
2915,潤泰全,53,22,31,群益金鼎-松山,2024-05-02,9103
00830,國泰費城半導體,35,5,30,群益金鼎-松山,2024-05-02,9103
00670L,富邦NASDAQ正2,30,0,30,群益金鼎-松山,2024-05-02,9103
1722,台肥,30,0,30,群益金鼎-松山,2024-05-02,9103
2486,一詮,32,2,30,群益金鼎-松山,2024-05-02,9103
9902,台火,30,0,30,群益金鼎-松山,2024-05-02,9103
0056,元大高股息,30,2,28,群益金鼎-松山,2024-05-02,9103
5515,建國,38,10,28,群益金鼎-松山,2024-05-02,9103
2101,南港,31,4,27,群益金鼎-松山,2024-05-02,9103
2504,國產,41,15,26,群益金鼎-松山,2024-05-02,9103
2520,冠德,42,16,26,群益金鼎-松山,2024-05-02,9103
00753L,中信中國50正2,25,0,25,群益金鼎-松山,2024-05-02,9103
2201,裕隆,24,0,24,群益金鼎-松山,2024-05-02,9103
2383,台光電,23,0,23,群益金鼎-松山,2024-05-02,9103
5519,隆大,21,0,21,群益金鼎-松山,2024-05-02,9103
2545,皇翔,20,0,20,群益金鼎-松山,2024-05-02,9103
4109,加捷生醫,20,0,20,群益金鼎-松山,2024-05-02,9103
5607,遠雄港,20,0,20,群益金鼎-松山,2024-05-02,9103
9955,佳龍,20,0,20,群益金鼎-松山,2024-05-02,9103
6606,建德工業,19,0,19,群益金鼎-松山,2024-05-02,9103
00945B,凱基美國非投等債,18,0,18,群益金鼎-松山,2024-05-02,9103
00878,國泰永續高股息,15,0,15,群益金鼎-松山,2024-05-02,9103
00650L,復華香港正2,15,0,15,群益金鼎-松山,2024-05-02,9103
1473,台南,15,0,15,群益金鼎-松山,2024-05-02,9103
2603,長榮,16,3,13,群益金鼎-松山,2024-05-02,9103
3266,昇陽,39,26,13,群益金鼎-松山,2024-05-02,9103
5465,富驊,12,0,12,群益金鼎-松山,2024-05-02,9103
5608,四維航,12,0,12,群益金鼎-松山,2024-05-02,9103
2303,聯電,11,0,11,群益金鼎-松山,2024-05-02,9103
1316,上曜,167,44,123,群益金鼎-松山,2024-05-03,9103
2537,聯上發,221,100,121,群益金鼎-松山,2024-05-03,9103
5531,鄉林,202,100,102,群益金鼎-松山,2024-05-03,9103
00664R,國泰臺灣加權反1,100,0,100,群益金鼎-松山,2024-05-03,9103
2506,太設,200,100,100,群益金鼎-松山,2024-05-03,9103
2511,太子,201,101,100,群益金鼎-松山,2024-05-03,9103
2516,新建,100,0,100,群益金鼎-松山,2024-05-03,9103
2371,大同,87,4,83,群益金鼎-松山,2024-05-03,9103
5324,士開,75,0,75,群益金鼎-松山,2024-05-03,9103
00945B,凱基美國非投等債,58,0,58,群益金鼎-松山,2024-05-03,9103
1616,億泰,50,0,50,群益金鼎-松山,2024-05-03,9103
2409,友達,50,0,50,群益金鼎-松山,2024-05-03,9103
9945,潤泰新,92,50,42,群益金鼎-松山,2024-05-03,9103
1514,亞力,44,5,39,群益金鼎-松山,2024-05-03,9103
1532,勤美,90,60,30,群益金鼎-松山,2024-05-03,9103
2492,華新科,30,0,30,群益金鼎-松山,2024-05-03,9103
1446,宏和,67,40,27,群益金鼎-松山,2024-05-03,9103
3266,昇陽,124,104,20,群益金鼎-松山,2024-05-03,9103
4961,天鈺,22,2,20,群益金鼎-松山,2024-05-03,9103
2545,皇翔,60,41,19,群益金鼎-松山,2024-05-03,9103
2363,矽統,75,58,17,群益金鼎-松山,2024-05-03,9103
2388,威盛,15,0,15,群益金鼎-松山,2024-05-03,9103
5347,世界,15,0,15,群益金鼎-松山,2024-05-03,9103
1608,華榮,16,2,14,群益金鼎-松山,2024-05-03,9103
2382,廣達,13,2,11,群益金鼎-松山,2024-05-03,9103
3289,宜特,11,0,11,群益金鼎-松山,2024-05-03,9103
00940,元大台灣價值高息,10,0,10,群益金鼎-松山,2024-05-03,9103
00687B,國泰20年美債,10,0,10,群益金鼎-松山,2024-05-03,9103
2505,國揚,26,16,10,群益金鼎-松山,2024-05-03,9103
3313,斐成,10,0,10,群益金鼎-松山,2024-05-03,9103
6768,志強-KY,10,0,10,群益金鼎-松山,2024-05-03,9103
2367,燿華,10,1,9,群益金鼎-松山,2024-05-03,9103
6606,建德工業,9,0,9,群益金鼎-松山,2024-05-03,9103
2201,裕隆,10,2,8,群益金鼎-松山,2024-05-03,9103
6278,台表科,8,0,8,群益金鼎-松山,2024-05-03,9103
2327,國巨,15,7,8,群益金鼎-松山,2024-05-03,9103
6207,雷科,10,3,7,群益金鼎-松山,2024-05-03,9103
6451,訊芯-KY,7,1,6,群益金鼎-松山,2024-05-03,9103
2609,陽明,6,0,6,群益金鼎-松山,2024-05-03,9103
2548,華固,6,0,6,群益金鼎-松山,2024-05-03,9103
2855,統一證,7,1,6,群益金鼎-松山,2024-05-03,9103
3483,力致,6,0,6,群益金鼎-松山,2024-05-03,9103
5508,永信建,6,0,6,群益金鼎-松山,2024-05-03,9103
6271,同欣電,7,1,6,群益金鼎-松山,2024-05-03,9103
8349,�矬�,9,3,6,群益金鼎-松山,2024-05-03,9103
00706L,期元大S＆P日圓正2,5,0,5,群益金鼎-松山,2024-05-03,9103
2540,愛山林,5,0,5,群益金鼎-松山,2024-05-03,9103
3231,緯創,5,0,5,群益金鼎-松山,2024-05-03,9103
3481,群創,5,0,5,群益金鼎-松山,2024-05-03,9103
4583,台灣精銳,5,0,5,群益金鼎-松山,2024-05-03,9103
3178,公準,207,62,145,群益金鼎-松山,2024-05-06,9103
2855,統一證,130,0,130,群益金鼎-松山,2024-05-06,9103
6015,宏遠證,100,0,100,群益金鼎-松山,2024-05-06,9103
3312,弘憶股,115,19,96,群益金鼎-松山,2024-05-06,9103
6005,群益證,60,1,59,群益金鼎-松山,2024-05-06,9103
2538,基泰,151,100,51,群益金鼎-松山,2024-05-06,9103
00945B,凱基美國非投等債,40,0,40,群益金鼎-松山,2024-05-06,9103
3289,宜特,38,0,38,群益金鼎-松山,2024-05-06,9103
2201,裕隆,32,2,30,群益金鼎-松山,2024-05-06,9103
2630,亞航,30,0,30,群益金鼎-松山,2024-05-06,9103
2367,燿華,58,31,27,群益金鼎-松山,2024-05-06,9103
1617,榮星,30,4,26,群益金鼎-松山,2024-05-06,9103
2363,矽統,62,40,22,群益金鼎-松山,2024-05-06,9103
3715,定穎投控,20,0,20,群益金鼎-松山,2024-05-06,9103
1229,聯華,20,0,20,群益金鼎-松山,2024-05-06,9103
00857B,永豐20年美公債,20,0,20,群益金鼎-松山,2024-05-06,9103
2399,映泰,20,0,20,群益金鼎-松山,2024-05-06,9103
5522,遠雄,56,36,20,群益金鼎-松山,2024-05-06,9103
00632R,元大台灣50反1,29,10,19,群益金鼎-松山,2024-05-06,9103
2101,南港,38,20,18,群益金鼎-松山,2024-05-06,9103
6442,光聖,23,5,18,群益金鼎-松山,2024-05-06,9103
2330,台積電,31,13,18,群益金鼎-松山,2024-05-06,9103
3025,星通,18,1,17,群益金鼎-松山,2024-05-06,9103
3363,上詮,19,3,16,群益金鼎-松山,2024-05-06,9103
9904,寶成,16,0,16,群益金鼎-松山,2024-05-06,9103
1808,潤隆,15,0,15,群益金鼎-松山,2024-05-06,9103
2634,漢翔,15,0,15,群益金鼎-松山,2024-05-06,9103
00929,復華台灣科技優息,16,2,14,群益金鼎-松山,2024-05-06,9103
2486,一詮,43,29,14,群益金鼎-松山,2024-05-06,9103
5347,世界,10,0,10,群益金鼎-松山,2024-05-06,9103
00725B,國泰投資級公司債,10,0,10,群益金鼎-松山,2024-05-06,9103
00919,群益台灣精選高息,10,0,10,群益金鼎-松山,2024-05-06,9103
1903,士紙,10,0,10,群益金鼎-松山,2024-05-06,9103
2440,太空梭,10,0,10,群益金鼎-松山,2024-05-06,9103
6546,正基,10,0,10,群益金鼎-松山,2024-05-06,9103
2352,佳世達,9,0,9,群益金鼎-松山,2024-05-06,9103
6173,信昌電,10,1,9,群益金鼎-松山,2024-05-06,9103
8110,華東,9,0,9,群益金鼎-松山,2024-05-06,9103
2543,皇昌,10,2,8,群益金鼎-松山,2024-05-06,9103
3583,辛耘,13,5,8,群益金鼎-松山,2024-05-06,9103
6606,建德工業,8,0,8,群益金鼎-松山,2024-05-06,9103
00940,元大台灣價值高息,7,0,7,群益金鼎-松山,2024-05-06,9103
00936,台新永續高息中小,7,0,7,群益金鼎-松山,2024-05-06,9103
2501,國建,61,54,7,群益金鼎-松山,2024-05-06,9103
00878,國泰永續高股息,6,1,5,群益金鼎-松山,2024-05-06,9103
00895,富邦未來車,5,0,5,群益金鼎-松山,2024-05-06,9103
00637L,元大滬深300正2,5,0,5,群益金鼎-松山,2024-05-06,9103
2465,麗臺,6,1,5,群益金鼎-松山,2024-05-06,9103
2609,陽明,5,0,5,群益金鼎-松山,2024-05-06,9103
3013,晟銘電,25,20,5,群益金鼎-松山,2024-05-06,9103
2883,凱基金,200,0,200,群益金鼎-松山,2024-05-07,9103
3033,威健,62,1,61,群益金鼎-松山,2024-05-07,9103
8096,擎亞,112,54,58,群益金鼎-松山,2024-05-07,9103
2367,燿華,53,2,51,群益金鼎-松山,2024-05-07,9103
00929,復華台灣科技優息,44,1,43,群益金鼎-松山,2024-05-07,9103
4967,十銓,28,2,26,群益金鼎-松山,2024-05-07,9103
2520,冠德,20,2,18,群益金鼎-松山,2024-05-07,9103
5371,中光電,15,0,15,群益金鼎-松山,2024-05-07,9103
00632R,元大台灣50反1,20,8,12,群益金鼎-松山,2024-05-07,9103
6606,建德工業,12,0,12,群益金鼎-松山,2024-05-07,9103
2913,農林,11,0,11,群益金鼎-松山,2024-05-07,9103
6207,雷科,11,0,11,群益金鼎-松山,2024-05-07,9103
1314,中石化,11,0,11,群益金鼎-松山,2024-05-07,9103
3363,上詮,12,2,10,群益金鼎-松山,2024-05-07,9103
4533,協易機,10,0,10,群益金鼎-松山,2024-05-07,9103
5009,榮剛,10,0,10,群益金鼎-松山,2024-05-07,9103
2537,聯上發,31,23,8,群益金鼎-松山,2024-05-07,9103
8089,康全電訊,8,0,8,群益金鼎-松山,2024-05-07,9103
3312,弘憶股,7,0,7,群益金鼎-松山,2024-05-07,9103
1440,南紡,7,0,7,群益金鼎-松山,2024-05-07,9103
1609,大亞,18,11,7,群益金鼎-松山,2024-05-07,9103
6125,廣運,11,4,7,群益金鼎-松山,2024-05-07,9103
6274,台燿,8,1,7,群益金鼎-松山,2024-05-07,9103
1513,中興電,8,2,6,群益金鼎-松山,2024-05-07,9103
3287,廣寰科,6,0,6,群益金鼎-松山,2024-05-07,9103
8928,鉅明,6,0,6,群益金鼎-松山,2024-05-07,9103
00937B,群益ESG投等債20,5,0,5,群益金鼎-松山,2024-05-07,9103
2204,中華,5,0,5,群益金鼎-松山,2024-05-07,9103
2402,毅嘉,5,0,5,群益金鼎-松山,2024-05-07,9103
2465,麗臺,11,6,5,群益金鼎-松山,2024-05-07,9103
2608,嘉里大榮,5,0,5,群益金鼎-松山,2024-05-07,9103
2906,高林,5,0,5,群益金鼎-松山,2024-05-07,9103
3706,神達,5,0,5,群益金鼎-松山,2024-05-07,9103
4923,力士,5,0,5,群益金鼎-松山,2024-05-07,9103
6173,信昌電,5,0,5,群益金鼎-松山,2024-05-07,9103
6442,光聖,7,2,5,群益金鼎-松山,2024-05-07,9103
1216,統一,4,0,4,群益金鼎-松山,2024-05-07,9103
1808,潤隆,4,0,4,群益金鼎-松山,2024-05-07,9103
2356,英業達,4,0,4,群益金鼎-松山,2024-05-07,9103
2887,台新金,4,0,4,群益金鼎-松山,2024-05-07,9103
4927,泰鼎-KY,4,0,4,群益金鼎-松山,2024-05-07,9103
5522,遠雄,25,21,4,群益金鼎-松山,2024-05-07,9103
8163,達方,4,0,4,群益金鼎-松山,2024-05-07,9103
1905,華紙,3,0,3,群益金鼎-松山,2024-05-07,9103
2363,矽統,19,16,3,群益金鼎-松山,2024-05-07,9103
2543,皇昌,3,0,3,群益金鼎-松山,2024-05-07,9103
2597,潤弘,3,0,3,群益金鼎-松山,2024-05-07,9103
2634,漢翔,3,0,3,群益金鼎-松山,2024-05-07,9103
2888,新光金,5,2,3,群益金鼎-松山,2024-05-07,9103
3176,基亞,3,0,3,群益金鼎-松山,2024-05-07,9103
9945,潤泰新,56,3,53,群益金鼎-松山,2024-05-08,9103
2641,正德,100,50,50,群益金鼎-松山,2024-05-08,9103
2486,一詮,44,5,39,群益金鼎-松山,2024-05-08,9103
2344,華邦電,40,2,38,群益金鼎-松山,2024-05-08,9103
2605,新興,40,8,32,群益金鼎-松山,2024-05-08,9103
4967,十銓,36,6,30,群益金鼎-松山,2024-05-08,9103
2542,興富發,30,2,28,群益金鼎-松山,2024-05-08,9103
00940,元大台灣價值高息,24,0,24,群益金鼎-松山,2024-05-08,9103
2317,鴻海,33,12,21,群益金鼎-松山,2024-05-08,9103
8473,山林水,21,0,21,群益金鼎-松山,2024-05-08,9103
1582,信錦,20,0,20,群益金鼎-松山,2024-05-08,9103
5608,四維航,247,227,20,群益金鼎-松山,2024-05-08,9103
3363,上詮,21,3,18,群益金鼎-松山,2024-05-08,9103
8089,康全電訊,16,0,16,群益金鼎-松山,2024-05-08,9103
3036,文曄,15,0,15,群益金鼎-松山,2024-05-08,9103
4968,立積,15,1,14,群益金鼎-松山,2024-05-08,9103
2069,運錩,12,0,12,群益金鼎-松山,2024-05-08,9103
2476,鉅祥,12,0,12,群益金鼎-松山,2024-05-08,9103
2603,長榮,31,20,11,群益金鼎-松山,2024-05-08,9103
1453,大將,10,0,10,群益金鼎-松山,2024-05-08,9103
1314,中石化,10,0,10,群益金鼎-松山,2024-05-08,9103
00665L,富邦�琤肭磪囓�2,10,0,10,群益金鼎-松山,2024-05-08,9103
00857B,永豐20年美公債,10,0,10,群益金鼎-松山,2024-05-08,9103
2520,冠德,10,0,10,群益金鼎-松山,2024-05-08,9103
2612,中航,10,0,10,群益金鼎-松山,2024-05-08,9103
9919,康那香,10,0,10,群益金鼎-松山,2024-05-08,9103
5871,中租-KY,9,0,9,群益金鼎-松山,2024-05-08,9103
3376,新日興,21,12,9,群益金鼎-松山,2024-05-08,9103
00919,群益台灣精選高息,8,0,8,群益金鼎-松山,2024-05-08,9103
1808,潤隆,8,0,8,群益金鼎-松山,2024-05-08,9103
4912,聯德控股-KY,8,0,8,群益金鼎-松山,2024-05-08,9103
8431,匯鑽科,8,0,8,群益金鼎-松山,2024-05-08,9103
6015,宏遠證,7,0,7,群益金鼎-松山,2024-05-08,9103
1618,合機,9,3,6,群益金鼎-松山,2024-05-08,9103
2597,潤弘,6,0,6,群益金鼎-松山,2024-05-08,9103
4927,泰鼎-KY,6,0,6,群益金鼎-松山,2024-05-08,9103
3702,大聯大,9,3,6,群益金鼎-松山,2024-05-08,9103
00878,國泰永續高股息,6,1,5,群益金鼎-松山,2024-05-08,9103
00941,中信上游半導體,5,0,5,群益金鼎-松山,2024-05-08,9103
00795B,中信美國公債20年,5,0,5,群益金鼎-松山,2024-05-08,9103
2204,中華,5,0,5,群益金鼎-松山,2024-05-08,9103
2399,映泰,5,0,5,群益金鼎-松山,2024-05-08,9103
2704,國賓,5,0,5,群益金鼎-松山,2024-05-08,9103
3234,光環,5,0,5,群益金鼎-松山,2024-05-08,9103
3703,欣陸,5,0,5,群益金鼎-松山,2024-05-08,9103
5432,新門,5,0,5,群益金鼎-松山,2024-05-08,9103
6125,廣運,10,5,5,群益金鼎-松山,2024-05-08,9103
6215,和椿,8,3,5,群益金鼎-松山,2024-05-08,9103
1702,南僑,4,0,4,群益金鼎-松山,2024-05-08,9103
3290,東浦,4,0,4,群益金鼎-松山,2024-05-08,9103
2883,凱基金,300,3,297,群益金鼎-松山,2024-05-09,9103
2515,中工,202,10,192,群益金鼎-松山,2024-05-09,9103
2367,燿華,109,16,93,群益金鼎-松山,2024-05-09,9103
5351,鈺創,70,0,70,群益金鼎-松山,2024-05-09,9103
00937B,群益ESG投等債20,30,0,30,群益金鼎-松山,2024-05-09,9103
2371,大同,35,5,30,群益金鼎-松山,2024-05-09,9103
2330,台積電,30,0,30,群益金鼎-松山,2024-05-09,9103
1605,華新,26,0,26,群益金鼎-松山,2024-05-09,9103
2427,三商電,25,1,24,群益金鼎-松山,2024-05-09,9103
1453,大將,32,10,22,群益金鼎-松山,2024-05-09,9103
2002,中鋼,20,0,20,群益金鼎-松山,2024-05-09,9103
2834,臺企銀,20,0,20,群益金鼎-松山,2024-05-09,9103
3037,欣興,21,2,19,群益金鼎-松山,2024-05-09,9103
4533,協易機,20,1,19,群益金鼎-松山,2024-05-09,9103
2317,鴻海,37,19,18,群益金鼎-松山,2024-05-09,9103
3702,大聯大,25,8,17,群益金鼎-松山,2024-05-09,9103
00929,復華台灣科技優息,17,2,15,群益金鼎-松山,2024-05-09,9103
1614,三洋電,27,12,15,群益金鼎-松山,2024-05-09,9103
5014,建錩,15,0,15,群益金鼎-松山,2024-05-09,9103
2476,鉅祥,14,0,14,群益金鼎-松山,2024-05-09,9103
00946,群益科技高息成長,13,0,13,群益金鼎-松山,2024-05-09,9103
2641,正德,63,50,13,群益金鼎-松山,2024-05-09,9103
2363,矽統,28,16,12,群益金鼎-松山,2024-05-09,9103
4768,晶呈科技,11,0,11,群益金鼎-松山,2024-05-09,9103
3036,文曄,12,1,11,群益金鼎-松山,2024-05-09,9103
5880,合庫金,11,0,11,群益金鼎-松山,2024-05-09,9103
2323,中環,10,0,10,群益金鼎-松山,2024-05-09,9103
00752,中信中國50,10,0,10,群益金鼎-松山,2024-05-09,9103
00700,富邦�琤肭磪�,10,0,10,群益金鼎-松山,2024-05-09,9103
1337,再生-KY,10,0,10,群益金鼎-松山,2024-05-09,9103
2634,漢翔,10,0,10,群益金鼎-松山,2024-05-09,9103
5439,高技,10,0,10,群益金鼎-松山,2024-05-09,9103
6290,良維,10,0,10,群益金鼎-松山,2024-05-09,9103
8277,商丞,10,0,10,群益金鼎-松山,2024-05-09,9103
9945,潤泰新,10,0,10,群益金鼎-松山,2024-05-09,9103
2312,金寶,10,1,9,群益金鼎-松山,2024-05-09,9103
8349,�矬�,12,4,8,群益金鼎-松山,2024-05-09,9103
9924,福興,8,0,8,群益金鼎-松山,2024-05-09,9103
00944,野村趨勢動能高息,7,0,7,群益金鼎-松山,2024-05-09,9103
2501,國建,7,0,7,群益金鼎-松山,2024-05-09,9103
8433,弘帆,7,0,7,群益金鼎-松山,2024-05-09,9103
5871,中租-KY,6,0,6,群益金鼎-松山,2024-05-09,9103
2618,長榮航,13,7,6,群益金鼎-松山,2024-05-09,9103
00687B,國泰20年美債,6,0,6,群益金鼎-松山,2024-05-09,9103
1815,富喬,6,0,6,群益金鼎-松山,2024-05-09,9103
2313,華通,19,13,6,群益金鼎-松山,2024-05-09,9103
2705,六福,6,0,6,群益金鼎-松山,2024-05-09,9103
2887,台新金,6,0,6,群益金鼎-松山,2024-05-09,9103
3689,湧德,12,6,6,群益金鼎-松山,2024-05-09,9103
2489,瑞軒,6,0,6,群益金鼎-松山,2024-05-09,9103
2610,華航,194,19,175,群益金鼎-松山,2024-05-10,9103
2888,新光金,101,0,101,群益金鼎-松山,2024-05-10,9103
3481,群創,101,0,101,群益金鼎-松山,2024-05-10,9103
1101,台泥,100,0,100,群益金鼎-松山,2024-05-10,9103
2641,正德,196,110,86,群益金鼎-松山,2024-05-10,9103
2313,華通,84,30,54,群益金鼎-松山,2024-05-10,9103
2906,高林,50,0,50,群益金鼎-松山,2024-05-10,9103
2617,台航,80,32,48,群益金鼎-松山,2024-05-10,9103
2101,南港,31,0,31,群益金鼎-松山,2024-05-10,9103
3706,神達,35,4,31,群益金鼎-松山,2024-05-10,9103
2501,國建,33,3,30,群益金鼎-松山,2024-05-10,9103
2605,新興,87,59,28,群益金鼎-松山,2024-05-10,9103
8349,�矬�,32,6,26,群益金鼎-松山,2024-05-10,9103
1442,名軒,25,0,25,群益金鼎-松山,2024-05-10,9103
1722,台肥,20,0,20,群益金鼎-松山,2024-05-10,9103
2612,中航,21,1,20,群益金鼎-松山,2024-05-10,9103
3703,欣陸,20,0,20,群益金鼎-松山,2024-05-10,9103
8462,柏文,20,0,20,群益金鼎-松山,2024-05-10,9103
9945,潤泰新,30,10,20,群益金鼎-松山,2024-05-10,9103
00632R,元大台灣50反1,19,0,19,群益金鼎-松山,2024-05-10,9103
9950,萬國通,18,0,18,群益金鼎-松山,2024-05-10,9103
1903,士紙,17,0,17,群益金鼎-松山,2024-05-10,9103
1314,中石化,15,0,15,群益金鼎-松山,2024-05-10,9103
2704,國賓,15,0,15,群益金鼎-松山,2024-05-10,9103
8473,山林水,12,0,12,群益金鼎-松山,2024-05-10,9103
1808,潤隆,12,1,11,群益金鼎-松山,2024-05-10,9103
5347,世界,11,1,10,群益金鼎-松山,2024-05-10,9103
00946,群益科技高息成長,10,0,10,群益金鼎-松山,2024-05-10,9103
2353,宏��,10,0,10,群益金鼎-松山,2024-05-10,9103
2801,彰銀,10,0,10,群益金鼎-松山,2024-05-10,9103
2887,台新金,10,1,9,群益金鼎-松山,2024-05-10,9103
00929,復華台灣科技優息,13,5,8,群益金鼎-松山,2024-05-10,9103
3105,穩懋,7,0,7,群益金鼎-松山,2024-05-10,9103
5225,東科-KY,7,0,7,群益金鼎-松山,2024-05-10,9103
6143,振曜,10,3,7,群益金鼎-松山,2024-05-10,9103
8433,弘帆,7,0,7,群益金鼎-松山,2024-05-10,9103
1446,宏和,6,0,6,群益金鼎-松山,2024-05-10,9103
2022,聚亨,6,0,6,群益金鼎-松山,2024-05-10,9103
3036,文曄,7,1,6,群益金鼎-松山,2024-05-10,9103
4147,中裕,6,0,6,群益金鼎-松山,2024-05-10,9103
4967,十銓,7,1,6,群益金鼎-松山,2024-05-10,9103
9924,福興,6,0,6,群益金鼎-松山,2024-05-10,9103
00878,國泰永續高股息,5,0,5,群益金鼎-松山,2024-05-10,9103
2324,仁寶,5,0,5,群益金鼎-松山,2024-05-10,9103
3042,晶技,5,0,5,群益金鼎-松山,2024-05-10,9103
3312,弘憶股,5,0,5,群益金鼎-松山,2024-05-10,9103
3551,世禾,5,0,5,群益金鼎-松山,2024-05-10,9103
5348,正能量智能,5,0,5,群益金鼎-松山,2024-05-10,9103
6606,建德工業,5,0,5,群益金鼎-松山,2024-05-10,9103
8110,華東,5,0,5,群益金鼎-松山,2024-05-10,9103
1513,中興電,155,2,153,群益金鼎-松山,2024-05-13,9103
2367,燿華,179,89,90,群益金鼎-松山,2024-05-13,9103
1522,堤維西,52,2,50,群益金鼎-松山,2024-05-13,9103
9945,潤泰新,66,31,35,群益金鼎-松山,2024-05-13,9103
00937B,群益ESG投等債20,30,0,30,群益金鼎-松山,2024-05-13,9103
2915,潤泰全,70,45,25,群益金鼎-松山,2024-05-13,9103
8349,�矬�,30,6,24,群益金鼎-松山,2024-05-13,9103
2371,大同,39,15,24,群益金鼎-松山,2024-05-13,9103
1524,耿鼎,21,0,21,群益金鼎-松山,2024-05-13,9103
3363,上詮,24,4,20,群益金鼎-松山,2024-05-13,9103
00929,復華台灣科技優息,16,0,16,群益金鼎-松山,2024-05-13,9103
00878,國泰永續高股息,15,0,15,群益金鼎-松山,2024-05-13,9103
8110,華東,15,0,15,群益金鼎-松山,2024-05-13,9103
3231,緯創,12,0,12,群益金鼎-松山,2024-05-13,9103
00632R,元大台灣50反1,20,8,12,群益金鼎-松山,2024-05-13,9103
2606,裕民,24,13,11,群益金鼎-松山,2024-05-13,9103
3013,晟銘電,20,9,11,群益金鼎-松山,2024-05-13,9103
00671R,富邦NASDAQ反1,10,0,10,群益金鼎-松山,2024-05-13,9103
2101,南港,20,10,10,群益金鼎-松山,2024-05-13,9103
2201,裕隆,10,0,10,群益金鼎-松山,2024-05-13,9103
6274,台燿,12,2,10,群益金鼎-松山,2024-05-13,9103
1314,中石化,10,1,9,群益金鼎-松山,2024-05-13,9103
2474,可成,10,1,9,群益金鼎-松山,2024-05-13,9103
6290,良維,10,1,9,群益金鼎-松山,2024-05-13,9103
2376,技嘉,8,0,8,群益金鼎-松山,2024-05-13,9103
3702,大聯大,8,0,8,群益金鼎-松山,2024-05-13,9103
6546,正基,9,1,8,群益金鼎-松山,2024-05-13,9103
2313,華通,7,0,7,群益金鼎-松山,2024-05-13,9103
5348,正能量智能,7,0,7,群益金鼎-松山,2024-05-13,9103
2891,中信金,7,0,7,群益金鼎-松山,2024-05-13,9103
2356,英業達,7,1,6,群益金鼎-松山,2024-05-13,9103
3035,智原,6,0,6,群益金鼎-松山,2024-05-13,9103
4533,協易機,17,11,6,群益金鼎-松山,2024-05-13,9103
3260,威剛,5,0,5,群益金鼎-松山,2024-05-13,9103
1337,再生-KY,5,0,5,群益金鼎-松山,2024-05-13,9103
2359,所羅門,5,0,5,群益金鼎-松山,2024-05-13,9103
3693,營邦,5,0,5,群益金鼎-松山,2024-05-13,9103
8028,昇陽半導體,5,0,5,群益金鼎-松山,2024-05-13,9103
5522,遠雄,14,10,4,群益金鼎-松山,2024-05-13,9103
00946,群益科技高息成長,4,0,4,群益金鼎-松山,2024-05-13,9103
1582,信錦,6,2,4,群益金鼎-松山,2024-05-13,9103
6024,群益期,4,0,4,群益金鼎-松山,2024-05-13,9103
6684,安格,4,0,4,群益金鼎-松山,2024-05-13,9103
8103,瀚荃,4,0,4,群益金鼎-松山,2024-05-13,9103
2250,IKKA-KY,3,0,3,群益金鼎-松山,2024-05-13,9103
2353,宏��,6,3,3,群益金鼎-松山,2024-05-13,9103
3583,辛耘,3,0,3,群益金鼎-松山,2024-05-13,9103
2409,友達,3,0,3,群益金鼎-松山,2024-05-13,9103
2486,一詮,13,10,3,群益金鼎-松山,2024-05-13,9103
2605,新興,118,115,3,群益金鼎-松山,2024-05-13,9103
1101,台泥,101,0,101,群益金鼎-松山,2024-05-14,9103
2641,正德,102,55,47,群益金鼎-松山,2024-05-14,9103
2303,聯電,50,4,46,群益金鼎-松山,2024-05-14,9103
9945,潤泰新,36,0,36,群益金鼎-松山,2024-05-14,9103
2324,仁寶,41,6,35,群益金鼎-松山,2024-05-14,9103
2353,宏��,47,15,32,群益金鼎-松山,2024-05-14,9103
00937B,群益ESG投等債20,30,0,30,群益金鼎-松山,2024-05-14,9103
6770,力積電,30,0,30,群益金鼎-松山,2024-05-14,9103
9934,成霖,30,2,28,群益金鼎-松山,2024-05-14,9103
2365,昆盈,20,0,20,群益金鼎-松山,2024-05-14,9103
6188,廣明,20,1,19,群益金鼎-松山,2024-05-14,9103
1326,台化,20,2,18,群益金鼎-松山,2024-05-14,9103
5608,四維航,68,55,13,群益金鼎-松山,2024-05-14,9103
3363,上詮,15,3,12,群益金鼎-松山,2024-05-14,9103
2615,萬海,66,54,12,群益金鼎-松山,2024-05-14,9103
00632R,元大台灣50反1,12,1,11,群益金鼎-松山,2024-05-14,9103
2382,廣達,42,31,11,群益金鼎-松山,2024-05-14,9103
1312,國喬,10,0,10,群益金鼎-松山,2024-05-14,9103
3013,晟銘電,11,1,10,群益金鼎-松山,2024-05-14,9103
3515,華擎,10,0,10,群益金鼎-松山,2024-05-14,9103
5213,亞昕,10,0,10,群益金鼎-松山,2024-05-14,9103
8234,新漢,10,0,10,群益金鼎-松山,2024-05-14,9103
2356,英業達,56,47,9,群益金鼎-松山,2024-05-14,9103
5348,正能量智能,9,0,9,群益金鼎-松山,2024-05-14,9103
2323,中環,8,0,8,群益金鼎-松山,2024-05-14,9103
2606,裕民,60,52,8,群益金鼎-松山,2024-05-14,9103
8349,�矬�,15,7,8,群益金鼎-松山,2024-05-14,9103
2342,茂矽,7,0,7,群益金鼎-松山,2024-05-14,9103
2408,南亞科,7,0,7,群益金鼎-松山,2024-05-14,9103
3702,大聯大,7,0,7,群益金鼎-松山,2024-05-14,9103
1442,名軒,6,0,6,群益金鼎-松山,2024-05-14,9103
1712,興農,6,0,6,群益金鼎-松山,2024-05-14,9103
4912,聯德控股-KY,6,0,6,群益金鼎-松山,2024-05-14,9103
6546,正基,9,3,6,群益金鼎-松山,2024-05-14,9103
1513,中興電,7,2,5,群益金鼎-松山,2024-05-14,9103
00725B,國泰投資級公司債,5,0,5,群益金鼎-松山,2024-05-14,9103
2359,所羅門,15,10,5,群益金鼎-松山,2024-05-14,9103
2637,慧洋-KY,10,5,5,群益金鼎-松山,2024-05-14,9103
2704,國賓,5,0,5,群益金鼎-松山,2024-05-14,9103
3202,樺晟,5,0,5,群益金鼎-松山,2024-05-14,9103
8927,北基,5,0,5,群益金鼎-松山,2024-05-14,9103
2371,大同,4,0,4,群益金鼎-松山,2024-05-14,9103
1323,永裕,4,0,4,群益金鼎-松山,2024-05-14,9103
3029,零壹,4,0,4,群益金鼎-松山,2024-05-14,9103
6462,神盾,4,0,4,群益金鼎-松山,2024-05-14,9103
2317,鴻海,32,29,3,群益金鼎-松山,2024-05-14,9103
2882,國泰金,3,0,3,群益金鼎-松山,2024-05-14,9103
1455,集盛,3,0,3,群益金鼎-松山,2024-05-14,9103
2374,佳能,9,6,3,群益金鼎-松山,2024-05-14,9103
2427,三商電,3,0,3,群益金鼎-松山,2024-05-14,9103
2618,長榮航,118,0,118,群益金鼎-松山,2024-05-15,9103
2409,友達,100,10,90,群益金鼎-松山,2024-05-15,9103
9904,寶成,80,0,80,群益金鼎-松山,2024-05-15,9103
2605,新興,70,13,57,群益金鼎-松山,2024-05-15,9103
00940,元大台灣價值高息,56,0,56,群益金鼎-松山,2024-05-15,9103
2609,陽明,65,17,48,群益金鼎-松山,2024-05-15,9103
1522,堤維西,50,4,46,群益金鼎-松山,2024-05-15,9103
3363,上詮,55,10,45,群益金鼎-松山,2024-05-15,9103
2367,燿華,114,72,42,群益金鼎-松山,2024-05-15,9103
2324,仁寶,40,0,40,群益金鼎-松山,2024-05-15,9103
2353,宏��,98,64,34,群益金鼎-松山,2024-05-15,9103
00632R,元大台灣50反1,49,19,30,群益金鼎-松山,2024-05-15,9103
2399,映泰,30,0,30,群益金鼎-松山,2024-05-15,9103
8096,擎亞,27,1,26,群益金鼎-松山,2024-05-15,9103
8349,�矬�,35,10,25,群益金鼎-松山,2024-05-15,9103
2915,潤泰全,64,40,24,群益金鼎-松山,2024-05-15,9103
2603,長榮,23,1,22,群益金鼎-松山,2024-05-15,9103
2355,敬鵬,21,0,21,群益金鼎-松山,2024-05-15,9103
1503,士電,20,0,20,群益金鼎-松山,2024-05-15,9103
3294,英濟,20,0,20,群益金鼎-松山,2024-05-15,9103
6150,撼訊,20,0,20,群益金鼎-松山,2024-05-15,9103
6282,康舒,20,0,20,群益金鼎-松山,2024-05-15,9103
2615,萬海,48,31,17,群益金鼎-松山,2024-05-15,9103
4533,協易機,102,86,16,群益金鼎-松山,2024-05-15,9103
2542,興富發,15,0,15,群益金鼎-松山,2024-05-15,9103
3483,力致,15,0,15,群益金鼎-松山,2024-05-15,9103
2637,慧洋-KY,15,2,13,群益金鼎-松山,2024-05-15,9103
00878,國泰永續高股息,13,0,13,群益金鼎-松山,2024-05-15,9103
00929,復華台灣科技優息,12,0,12,群益金鼎-松山,2024-05-15,9103
2606,裕民,12,0,12,群益金鼎-松山,2024-05-15,9103
6449,鈺邦,12,0,12,群益金鼎-松山,2024-05-15,9103
1903,士紙,11,0,11,群益金鼎-松山,2024-05-15,9103
6290,良維,15,5,10,群益金鼎-松山,2024-05-15,9103
1323,永裕,9,0,9,群益金鼎-松山,2024-05-15,9103
00919,群益台灣精選高息,9,0,9,群益金鼎-松山,2024-05-15,9103
2530,華建,8,0,8,群益金鼎-松山,2024-05-15,9103
8927,北基,8,0,8,群益金鼎-松山,2024-05-15,9103
3702,大聯大,10,3,7,群益金鼎-松山,2024-05-15,9103
3706,神達,10,3,7,群益金鼎-松山,2024-05-15,9103
6605,帝寶,7,0,7,群益金鼎-松山,2024-05-15,9103
2368,金像電,7,1,6,群益金鼎-松山,2024-05-15,9103
6143,振曜,6,0,6,群益金鼎-松山,2024-05-15,9103
00937B,群益ESG投等債20,5,0,5,群益金鼎-松山,2024-05-15,9103
00671R,富邦NASDAQ反1,5,0,5,群益金鼎-松山,2024-05-15,9103
1444,力麗,5,0,5,群益金鼎-松山,2024-05-15,9103
2009,第一銅,15,10,5,群益金鼎-松山,2024-05-15,9103
2303,聯電,5,0,5,群益金鼎-松山,2024-05-15,9103
2412,中華電,5,0,5,群益金鼎-松山,2024-05-15,9103
2601,益航,5,0,5,群益金鼎-松山,2024-05-15,9103
3234,光環,5,0,5,群益金鼎-松山,2024-05-15,9103
1316,上曜,100,0,100,群益金鼎-松山,2024-05-16,9103
5531,鄉林,100,0,100,群益金鼎-松山,2024-05-16,9103
00937B,群益ESG投等債20,101,3,98,群益金鼎-松山,2024-05-16,9103
2915,潤泰全,60,0,60,群益金鼎-松山,2024-05-16,9103
2615,萬海,77,24,53,群益金鼎-松山,2024-05-16,9103
2317,鴻海,67,29,38,群益金鼎-松山,2024-05-16,9103
4572,駐龍,31,0,31,群益金鼎-松山,2024-05-16,9103
6125,廣運,32,4,28,群益金鼎-松山,2024-05-16,9103
00882,中信中國高股息,27,0,27,群益金鼎-松山,2024-05-16,9103
2520,冠德,50,23,27,群益金鼎-松山,2024-05-16,9103
00878,國泰永續高股息,23,1,22,群益金鼎-松山,2024-05-16,9103
2329,華泰,27,5,22,群益金鼎-松山,2024-05-16,9103
4533,協易機,66,44,22,群益金鼎-松山,2024-05-16,9103
1326,台化,20,0,20,群益金鼎-松山,2024-05-16,9103
1532,勤美,31,11,20,群益金鼎-松山,2024-05-16,9103
2101,南港,21,1,20,群益金鼎-松山,2024-05-16,9103
2545,皇翔,40,20,20,群益金鼎-松山,2024-05-16,9103
2514,龍邦,19,0,19,群益金鼎-松山,2024-05-16,9103
8096,擎亞,20,1,19,群益金鼎-松山,2024-05-16,9103
8358,金居,20,4,16,群益金鼎-松山,2024-05-16,9103
3363,上詮,25,14,11,群益金鼎-松山,2024-05-16,9103
2399,映泰,11,0,11,群益金鼎-松山,2024-05-16,9103
3231,緯創,11,0,11,群益金鼎-松山,2024-05-16,9103
8349,�矬�,13,3,10,群益金鼎-松山,2024-05-16,9103
00637L,元大滬深300正2,10,0,10,群益金鼎-松山,2024-05-16,9103
00857B,永豐20年美公債,10,0,10,群益金鼎-松山,2024-05-16,9103
2465,麗臺,23,13,10,群益金鼎-松山,2024-05-16,9103
3312,弘憶股,11,1,10,群益金鼎-松山,2024-05-16,9103
9934,成霖,10,0,10,群益金鼎-松山,2024-05-16,9103
2330,台積電,20,11,9,群益金鼎-松山,2024-05-16,9103
5508,永信建,9,0,9,群益金鼎-松山,2024-05-16,9103
2605,新興,40,32,8,群益金鼎-松山,2024-05-16,9103
00929,復華台灣科技優息,7,0,7,群益金鼎-松山,2024-05-16,9103
1903,士紙,20,13,7,群益金鼎-松山,2024-05-16,9103
3702,大聯大,7,0,7,群益金鼎-松山,2024-05-16,9103
6213,聯茂,11,4,7,群益金鼎-松山,2024-05-16,9103
6290,良維,7,0,7,群益金鼎-松山,2024-05-16,9103
00687B,國泰20年美債,16,10,6,群益金鼎-松山,2024-05-16,9103
00719B,元大美債1-3,6,0,6,群益金鼎-松山,2024-05-16,9103
1582,信錦,12,6,6,群益金鼎-松山,2024-05-16,9103
2002,中鋼,10,4,6,群益金鼎-松山,2024-05-16,9103
2301,光寶科,6,0,6,群益金鼎-松山,2024-05-16,9103
3025,星通,6,0,6,群益金鼎-松山,2024-05-16,9103
3284,太普高,6,0,6,群益金鼎-松山,2024-05-16,9103
6415,矽力*-KY,6,0,6,群益金鼎-松山,2024-05-16,9103
1312,國喬,6,0,6,群益金鼎-松山,2024-05-16,9103
1905,華紙,5,0,5,群益金鼎-松山,2024-05-16,9103
2324,仁寶,5,0,5,群益金鼎-松山,2024-05-16,9103
3706,神達,5,0,5,群益金鼎-松山,2024-05-16,9103
4721,美琪瑪,5,0,5,群益金鼎-松山,2024-05-16,9103
3312,弘憶股,217,116,101,群益金鼎-松山,2024-05-17,9103
2618,長榮航,104,6,98,群益金鼎-松山,2024-05-17,9103
2915,潤泰全,70,1,69,群益金鼎-松山,2024-05-17,9103
2514,龍邦,82,16,66,群益金鼎-松山,2024-05-17,9103
00940,元大台灣價值高息,68,10,58,群益金鼎-松山,2024-05-17,9103
5324,士開,57,0,57,群益金鼎-松山,2024-05-17,9103
2609,陽明,63,18,45,群益金鼎-松山,2024-05-17,9103
2313,華通,41,1,40,群益金鼎-松山,2024-05-17,9103
3266,昇陽,40,0,40,群益金鼎-松山,2024-05-17,9103
2367,燿華,82,48,34,群益金鼎-松山,2024-05-17,9103
2363,矽統,57,30,27,群益金鼎-松山,2024-05-17,9103
1446,宏和,21,0,21,群益金鼎-松山,2024-05-17,9103
9945,潤泰新,50,30,20,群益金鼎-松山,2024-05-17,9103
00929,復華台灣科技優息,20,1,19,群益金鼎-松山,2024-05-17,9103
4572,駐龍,19,0,19,群益金鼎-松山,2024-05-17,9103
2374,佳能,38,20,18,群益金鼎-松山,2024-05-17,9103
00679B,元大美債20年,17,0,17,群益金鼎-松山,2024-05-17,9103
8110,華東,27,12,15,群益金鼎-松山,2024-05-17,9103
8054,安國,11,0,11,群益金鼎-松山,2024-05-17,9103
00946,群益科技高息成長,10,0,10,群益金鼎-松山,2024-05-17,9103
1808,潤隆,10,0,10,群益金鼎-松山,2024-05-17,9103
2543,皇昌,11,1,10,群益金鼎-松山,2024-05-17,9103
6016,康和證,10,0,10,群益金鼎-松山,2024-05-17,9103
6188,廣明,11,3,8,群益金鼎-松山,2024-05-17,9103
8422,可寧衛,8,0,8,群益金鼎-松山,2024-05-17,9103
2376,技嘉,8,0,8,群益金鼎-松山,2024-05-17,9103
1532,勤美,30,23,7,群益金鼎-松山,2024-05-17,9103
2359,所羅門,14,7,7,群益金鼎-松山,2024-05-17,9103
2516,新建,7,0,7,群益金鼎-松山,2024-05-17,9103
6189,豐藝,7,0,7,群益金鼎-松山,2024-05-17,9103
00878,國泰永續高股息,27,20,7,群益金鼎-松山,2024-05-17,9103
2537,聯上發,6,0,6,群益金鼎-松山,2024-05-17,9103
00762,元大全球AI,5,0,5,群益金鼎-松山,2024-05-17,9103
00896,中信綠能及電動車,5,0,5,群益金鼎-松山,2024-05-17,9103
1314,中石化,5,0,5,群益金鼎-松山,2024-05-17,9103
1725,元禎,6,1,5,群益金鼎-松山,2024-05-17,9103
2010,春源,5,0,5,群益金鼎-松山,2024-05-17,9103
2323,中環,7,2,5,群益金鼎-松山,2024-05-17,9103
3013,晟銘電,11,6,5,群益金鼎-松山,2024-05-17,9103
3059,華晶科,34,29,5,群益金鼎-松山,2024-05-17,9103
1419,新紡,13,9,4,群益金鼎-松山,2024-05-17,9103
2428,興勤,5,1,4,群益金鼎-松山,2024-05-17,9103
3033,威健,4,0,4,群益金鼎-松山,2024-05-17,9103
5348,正能量智能,4,0,4,群益金鼎-松山,2024-05-17,9103
1217,愛之味,3,0,3,群益金鼎-松山,2024-05-17,9103
00937B,群益ESG投等債20,3,0,3,群益金鼎-松山,2024-05-17,9103
2301,光寶科,5,2,3,群益金鼎-松山,2024-05-17,9103
2637,慧洋-KY,5,2,3,群益金鼎-松山,2024-05-17,9103
3025,星通,3,0,3,群益金鼎-松山,2024-05-17,9103
3376,新日興,5,2,3,群益金鼎-松山,2024-05-17,9103
00929,復華台灣科技優息,321,2,319,群益金鼎-松山,2024-05-20,9103
2867,三商壽,110,0,110,群益金鼎-松山,2024-05-20,9103
2025,千興,100,0,100,群益金鼎-松山,2024-05-20,9103
3178,公準,175,121,54,群益金鼎-松山,2024-05-20,9103
00655L,國泰中國A50正2,50,1,49,群益金鼎-松山,2024-05-20,9103
2313,華通,40,1,39,群益金鼎-松山,2024-05-20,9103
2323,中環,31,0,31,群益金鼎-松山,2024-05-20,9103
2520,冠德,30,0,30,群益金鼎-松山,2024-05-20,9103
5309,系統電,30,0,30,群益金鼎-松山,2024-05-20,9103
2009,第一銅,36,6,30,群益金鼎-松山,2024-05-20,9103
1605,華新,81,52,29,群益金鼎-松山,2024-05-20,9103
2363,矽統,87,58,29,群益金鼎-松山,2024-05-20,9103
2027,大成鋼,64,36,28,群益金鼎-松山,2024-05-20,9103
5392,能率,31,3,28,群益金鼎-松山,2024-05-20,9103
2915,潤泰全,30,3,27,群益金鼎-松山,2024-05-20,9103
8358,金居,40,20,20,群益金鼎-松山,2024-05-20,9103
4549,桓達,15,0,15,群益金鼎-松山,2024-05-20,9103
2367,燿華,40,26,14,群益金鼎-松山,2024-05-20,9103
00878,國泰永續高股息,13,0,13,群益金鼎-松山,2024-05-20,9103
2609,陽明,14,1,13,群益金鼎-松山,2024-05-20,9103
3380,明泰,13,0,13,群益金鼎-松山,2024-05-20,9103
1514,亞力,18,6,12,群益金鼎-松山,2024-05-20,9103
1608,華榮,30,19,11,群益金鼎-松山,2024-05-20,9103
2359,所羅門,41,30,11,群益金鼎-松山,2024-05-20,9103
00633L,富邦上証正2,10,0,10,群益金鼎-松山,2024-05-20,9103
00919,群益台灣精選高息,10,0,10,群益金鼎-松山,2024-05-20,9103
3047,訊舟,11,1,10,群益金鼎-松山,2024-05-20,9103
6016,康和證,10,0,10,群益金鼎-松山,2024-05-20,9103
9945,潤泰新,12,2,10,群益金鼎-松山,2024-05-20,9103
3010,華立,8,0,8,群益金鼎-松山,2024-05-20,9103
1456,怡華,7,0,7,群益金鼎-松山,2024-05-20,9103
2362,藍天,7,0,7,群益金鼎-松山,2024-05-20,9103
3483,力致,16,9,7,群益金鼎-松山,2024-05-20,9103
8028,昇陽半導體,8,1,7,群益金鼎-松山,2024-05-20,9103
1101,台泥,7,1,6,群益金鼎-松山,2024-05-20,9103
2317,鴻海,9,3,6,群益金鼎-松山,2024-05-20,9103
00679B,元大美債20年,6,0,6,群益金鼎-松山,2024-05-20,9103
1582,信錦,7,1,6,群益金鼎-松山,2024-05-20,9103
2610,華航,14,8,6,群益金鼎-松山,2024-05-20,9103
2634,漢翔,11,5,6,群益金鼎-松山,2024-05-20,9103
3294,英濟,8,2,6,群益金鼎-松山,2024-05-20,9103
3312,弘憶股,12,6,6,群益金鼎-松山,2024-05-20,9103
3231,緯創,6,1,5,群益金鼎-松山,2024-05-20,9103
1402,遠東新,5,0,5,群益金鼎-松山,2024-05-20,9103
1442,名軒,6,1,5,群益金鼎-松山,2024-05-20,9103
00885,富邦越南,5,0,5,群益金鼎-松山,2024-05-20,9103
00937B,群益ESG投等債20,5,0,5,群益金鼎-松山,2024-05-20,9103
00713,元大台灣高息低波,5,0,5,群益金鼎-松山,2024-05-20,9103
0056,元大高股息,5,0,5,群益金鼎-松山,2024-05-20,9103
1609,大亞,12,7,5,群益金鼎-松山,2024-05-20,9103
1314,中石化,200,0,200,群益金鼎-松山,2024-05-21,9103
1101,台泥,120,1,119,群益金鼎-松山,2024-05-21,9103
2007,燁興,100,0,100,群益金鼎-松山,2024-05-21,9103
2884,玉山金,70,0,70,群益金鼎-松山,2024-05-21,9103
2359,所羅門,76,27,49,群益金鼎-松山,2024-05-21,9103
5392,能率,86,46,40,群益金鼎-松山,2024-05-21,9103
5426,振發,40,6,34,群益金鼎-松山,2024-05-21,9103
1522,堤維西,40,10,30,群益金鼎-松山,2024-05-21,9103
6188,廣明,62,34,28,群益金鼎-松山,2024-05-21,9103
3702,大聯大,33,6,27,群益金鼎-松山,2024-05-21,9103
2329,華泰,30,10,20,群益金鼎-松山,2024-05-21,9103
2457,飛宏,20,0,20,群益金鼎-松山,2024-05-21,9103
2834,臺企銀,20,0,20,群益金鼎-松山,2024-05-21,9103
3622,洋華,20,0,20,群益金鼎-松山,2024-05-21,9103
4967,十銓,20,1,19,群益金鼎-松山,2024-05-21,9103
3033,威健,21,3,18,群益金鼎-松山,2024-05-21,9103
1616,億泰,17,0,17,群益金鼎-松山,2024-05-21,9103
00940,元大台灣價值高息,46,30,16,群益金鼎-松山,2024-05-21,9103
3178,公準,21,6,15,群益金鼎-松山,2024-05-21,9103
2317,鴻海,13,1,12,群益金鼎-松山,2024-05-21,9103
6462,神盾,14,3,11,群益金鼎-松山,2024-05-21,9103
8064,東捷,12,1,11,群益金鼎-松山,2024-05-21,9103
00665L,富邦�琤肭磪囓�2,10,0,10,群益金鼎-松山,2024-05-21,9103
2337,旺宏,10,0,10,群益金鼎-松山,2024-05-21,9103
8086,宏捷科,10,0,10,群益金鼎-松山,2024-05-21,9103
2368,金像電,10,1,9,群益金鼎-松山,2024-05-21,9103
2486,一詮,51,42,9,群益金鼎-松山,2024-05-21,9103
2465,麗臺,11,3,8,群益金鼎-松山,2024-05-21,9103
2515,中工,8,0,8,群益金鼎-松山,2024-05-21,9103
2618,長榮航,9,1,8,群益金鼎-松山,2024-05-21,9103
4533,協易機,80,72,8,群益金鼎-松山,2024-05-21,9103
2027,大成鋼,37,30,7,群益金鼎-松山,2024-05-21,9103
8349,�矬�,14,7,7,群益金鼎-松山,2024-05-21,9103
00753L,中信中國50正2,6,0,6,群益金鼎-松山,2024-05-21,9103
6584,南俊國際,7,1,6,群益金鼎-松山,2024-05-21,9103
2882,國泰金,5,0,5,群益金鼎-松山,2024-05-21,9103
1587,吉茂,18,13,5,群益金鼎-松山,2024-05-21,9103
2885,元大金,5,0,5,群益金鼎-松山,2024-05-21,9103
2915,潤泰全,5,0,5,群益金鼎-松山,2024-05-21,9103
4768,晶呈科技,5,0,5,群益金鼎-松山,2024-05-21,9103
00878,國泰永續高股息,5,0,5,群益金鼎-松山,2024-05-21,9103
1217,愛之味,4,0,4,群益金鼎-松山,2024-05-21,9103
1808,潤隆,5,1,4,群益金鼎-松山,2024-05-21,9103
3017,奇鋐,6,2,4,群益金鼎-松山,2024-05-21,9103
6190,萬泰科,4,0,4,群益金鼎-松山,2024-05-21,9103
9910,豐泰,4,0,4,群益金鼎-松山,2024-05-21,9103
00720B,元大投資級公司債,3,0,3,群益金鼎-松山,2024-05-21,9103
1513,中興電,3,0,3,群益金鼎-松山,2024-05-21,9103
1785,光洋科,3,0,3,群益金鼎-松山,2024-05-21,9103
1810,和成,3,0,3,群益金鼎-松山,2024-05-21,9103
1815,富喬,165,43,122,群益金鼎-松山,2024-05-22,9103
00650L,復華香港正2,100,0,100,群益金鼎-松山,2024-05-22,9103
3312,弘憶股,313,236,77,群益金鼎-松山,2024-05-22,9103
6213,聯茂,62,3,59,群益金鼎-松山,2024-05-22,9103
2353,宏��,105,58,47,群益金鼎-松山,2024-05-22,9103
5426,振發,40,0,40,群益金鼎-松山,2024-05-22,9103
3483,力致,39,2,37,群益金鼎-松山,2024-05-22,9103
00632R,元大台灣50反1,144,109,35,群益金鼎-松山,2024-05-22,9103
2356,英業達,32,2,30,群益金鼎-松山,2024-05-22,9103
3013,晟銘電,71,41,30,群益金鼎-松山,2024-05-22,9103
3321,同泰,25,0,25,群益金鼎-松山,2024-05-22,9103
2362,藍天,50,27,23,群益金鼎-松山,2024-05-22,9103
6125,廣運,29,6,23,群益金鼎-松山,2024-05-22,9103
00936,台新永續高息中小,22,0,22,群益金鼎-松山,2024-05-22,9103
00680L,元大美債20正2,20,0,20,群益金鼎-松山,2024-05-22,9103
1809,中釉,20,0,20,群益金鼎-松山,2024-05-22,9103
2606,裕民,30,10,20,群益金鼎-松山,2024-05-22,9103
3294,英濟,20,0,20,群益金鼎-松山,2024-05-22,9103
1605,華新,20,0,20,群益金鼎-松山,2024-05-22,9103
1303,南亞,13,0,13,群益金鼎-松山,2024-05-22,9103
2002,中鋼,13,0,13,群益金鼎-松山,2024-05-22,9103
3006,晶豪科,16,3,13,群益金鼎-松山,2024-05-22,9103
2609,陽明,15,2,13,群益金鼎-松山,2024-05-22,9103
00882,中信中國高股息,11,0,11,群益金鼎-松山,2024-05-22,9103
5009,榮剛,13,2,11,群益金鼎-松山,2024-05-22,9103
3481,群創,12,1,11,群益金鼎-松山,2024-05-22,9103
5347,世界,10,0,10,群益金鼎-松山,2024-05-22,9103
1301,台塑,10,0,10,群益金鼎-松山,2024-05-22,9103
2020,美亞,10,0,10,群益金鼎-松山,2024-05-22,9103
4760,勤凱,10,0,10,群益金鼎-松山,2024-05-22,9103
8054,安國,23,13,10,群益金鼎-松山,2024-05-22,9103
1217,愛之味,9,0,9,群益金鼎-松山,2024-05-22,9103
6188,廣明,40,31,9,群益金鼎-松山,2024-05-22,9103
3376,新日興,9,1,8,群益金鼎-松山,2024-05-22,9103
00665L,富邦�琤肭磪囓�2,8,0,8,群益金鼎-松山,2024-05-22,9103
2359,所羅門,12,4,8,群益金鼎-松山,2024-05-22,9103
6209,今國光,13,5,8,群益金鼎-松山,2024-05-22,9103
8163,達方,9,1,8,群益金鼎-松山,2024-05-22,9103
2501,國建,7,0,7,群益金鼎-松山,2024-05-22,9103
3060,銘異,17,10,7,群益金鼎-松山,2024-05-22,9103
3498,陽程,7,0,7,群益金鼎-松山,2024-05-22,9103
3702,大聯大,8,1,7,群益金鼎-松山,2024-05-22,9103
4129,聯合,7,0,7,群益金鼎-松山,2024-05-22,9103
6117,迎廣,9,2,7,群益金鼎-松山,2024-05-22,9103
8069,元太,8,1,7,群益金鼎-松山,2024-05-22,9103
8349,�矬�,12,5,7,群益金鼎-松山,2024-05-22,9103
3176,基亞,7,1,6,群益金鼎-松山,2024-05-22,9103
3357,臺慶科,6,0,6,群益金鼎-松山,2024-05-22,9103
3537,堡達,6,0,6,群益金鼎-松山,2024-05-22,9103
5314,世紀,6,0,6,群益金鼎-松山,2024-05-22,9103
1314,中石化,104,0,104,群益金鼎-松山,2024-05-23,9103
9945,潤泰新,96,8,88,群益金鼎-松山,2024-05-23,9103
00946,群益科技高息成長,150,70,80,群益金鼎-松山,2024-05-23,9103
2377,微星,52,0,52,群益金鼎-松山,2024-05-23,9103
2353,宏��,112,76,36,群益金鼎-松山,2024-05-23,9103
1101,台泥,30,0,30,群益金鼎-松山,2024-05-23,9103
3455,由田,30,0,30,群益金鼎-松山,2024-05-23,9103
1301,台塑,27,0,27,群益金鼎-松山,2024-05-23,9103
2002,中鋼,25,0,25,群益金鼎-松山,2024-05-23,9103
3294,英濟,22,0,22,群益金鼎-松山,2024-05-23,9103
8150,南茂,20,0,20,群益金鼎-松山,2024-05-23,9103
2597,潤弘,18,0,18,群益金鼎-松山,2024-05-23,9103
1605,華新,17,1,16,群益金鼎-松山,2024-05-23,9103
2009,第一銅,16,0,16,群益金鼎-松山,2024-05-23,9103
5608,四維航,16,0,16,群益金鼎-松山,2024-05-23,9103
8936,國統,21,5,16,群益金鼎-松山,2024-05-23,9103
3450,聯鈞,15,2,13,群益金鼎-松山,2024-05-23,9103
5371,中光電,16,3,13,群益金鼎-松山,2024-05-23,9103
3312,弘憶股,17,4,13,群益金鼎-松山,2024-05-23,9103
2367,燿華,29,17,12,群益金鼎-松山,2024-05-23,9103
3706,神達,12,0,12,群益金鼎-松山,2024-05-23,9103
2352,佳世達,10,0,10,群益金鼎-松山,2024-05-23,9103
1308,亞聚,10,0,10,群益金鼎-松山,2024-05-23,9103
2486,一詮,28,18,10,群益金鼎-松山,2024-05-23,9103
2603,長榮,11,1,10,群益金鼎-松山,2024-05-23,9103
3481,群創,15,5,10,群益金鼎-松山,2024-05-23,9103
2915,潤泰全,21,11,10,群益金鼎-松山,2024-05-23,9103
4306,炎洲,9,0,9,群益金鼎-松山,2024-05-23,9103
4552,力達-KY,9,0,9,群益金鼎-松山,2024-05-23,9103
5348,正能量智能,9,0,9,群益金鼎-松山,2024-05-23,9103
2241,艾姆勒,8,0,8,群益金鼎-松山,2024-05-23,9103
3483,力致,12,4,8,群益金鼎-松山,2024-05-23,9103
8028,昇陽半導體,8,0,8,群益金鼎-松山,2024-05-23,9103
1808,潤隆,7,0,7,群益金鼎-松山,2024-05-23,9103
2357,華碩,10,3,7,群益金鼎-松山,2024-05-23,9103
3013,晟銘電,44,37,7,群益金鼎-松山,2024-05-23,9103
3033,威健,8,1,7,群益金鼎-松山,2024-05-23,9103
6147,頎邦,7,0,7,群益金鼎-松山,2024-05-23,9103
3363,上詮,13,6,7,群益金鼎-松山,2024-05-23,9103
2504,國產,10,4,6,群益金鼎-松山,2024-05-23,9103
3665,貿聯-KY,6,0,6,群益金鼎-松山,2024-05-23,9103
00936,台新永續高息中小,6,0,6,群益金鼎-松山,2024-05-23,9103
1456,怡華,6,0,6,群益金鼎-松山,2024-05-23,9103
2348,海悅,6,0,6,群益金鼎-松山,2024-05-23,9103
4543,萬在,6,0,6,群益金鼎-松山,2024-05-23,9103
6126,信音,6,0,6,群益金鼎-松山,2024-05-23,9103
1442,名軒,5,0,5,群益金鼎-松山,2024-05-23,9103
1337,再生-KY,5,0,5,群益金鼎-松山,2024-05-23,9103
00671R,富邦NASDAQ反1,5,0,5,群益金鼎-松山,2024-05-23,9103
1569,濱川,5,0,5,群益金鼎-松山,2024-05-23,9103
00946,群益科技高息成長,253,50,203,群益金鼎-松山,2024-05-24,9103
00940,元大台灣價值高息,101,0,101,群益金鼎-松山,2024-05-24,9103
2375,凱美,101,0,101,群益金鼎-松山,2024-05-24,9103
1522,堤維西,81,0,81,群益金鼎-松山,2024-05-24,9103
1815,富喬,136,69,67,群益金鼎-松山,2024-05-24,9103
2303,聯電,110,52,58,群益金鼎-松山,2024-05-24,9103
4967,十銓,45,6,39,群益金鼎-松山,2024-05-24,9103
2302,麗正,50,20,30,群益金鼎-松山,2024-05-24,9103
2486,一詮,52,24,28,群益金鼎-松山,2024-05-24,9103
3363,上詮,33,9,24,群益金鼎-松山,2024-05-24,9103
2464,盟立,35,12,23,群益金鼎-松山,2024-05-24,9103
6209,今國光,33,10,23,群益金鼎-松山,2024-05-24,9103
1303,南亞,26,4,22,群益金鼎-松山,2024-05-24,9103
3055,蔚華科,39,17,22,群益金鼎-松山,2024-05-24,9103
2609,陽明,26,4,22,群益金鼎-松山,2024-05-24,9103
2324,仁寶,20,0,20,群益金鼎-松山,2024-05-24,9103
3231,緯創,23,3,20,群益金鼎-松山,2024-05-24,9103
2362,藍天,40,21,19,群益金鼎-松山,2024-05-24,9103
3260,威剛,20,1,19,群益金鼎-松山,2024-05-24,9103
3376,新日興,19,1,18,群益金鼎-松山,2024-05-24,9103
4979,華星光,17,1,16,群益金鼎-松山,2024-05-24,9103
6188,廣明,34,18,16,群益金鼎-松山,2024-05-24,9103
3013,晟銘電,66,52,14,群益金鼎-松山,2024-05-24,9103
5289,宜鼎,15,1,14,群益金鼎-松山,2024-05-24,9103
1446,宏和,12,0,12,群益金鼎-松山,2024-05-24,9103
2392,正崴,11,0,11,群益金鼎-松山,2024-05-24,9103
8349,�矬�,17,6,11,群益金鼎-松山,2024-05-24,9103
1503,士電,10,0,10,群益金鼎-松山,2024-05-24,9103
00720B,元大投資級公司債,10,0,10,群益金鼎-松山,2024-05-24,9103
00753L,中信中國50正2,10,0,10,群益金鼎-松山,2024-05-24,9103
00773B,中信優先金融債,10,0,10,群益金鼎-松山,2024-05-24,9103
3033,威健,10,0,10,群益金鼎-松山,2024-05-24,9103
3483,力致,13,3,10,群益金鼎-松山,2024-05-24,9103
3706,神達,13,3,10,群益金鼎-松山,2024-05-24,9103
4533,協易機,11,1,10,群益金鼎-松山,2024-05-24,9103
2615,萬海,9,0,9,群益金鼎-松山,2024-05-24,9103
2365,昆盈,14,5,9,群益金鼎-松山,2024-05-24,9103
2107,厚生,9,0,9,群益金鼎-松山,2024-05-24,9103
00757,統一FANG+,8,0,8,群益金鼎-松山,2024-05-24,9103
1312,國喬,7,0,7,群益金鼎-松山,2024-05-24,9103
2363,矽統,24,17,7,群益金鼎-松山,2024-05-24,9103
2368,金像電,7,0,7,群益金鼎-松山,2024-05-24,9103
2359,所羅門,28,22,6,群益金鼎-松山,2024-05-24,9103
00679B,元大美債20年,6,0,6,群益金鼎-松山,2024-05-24,9103
1442,名軒,6,0,6,群益金鼎-松山,2024-05-24,9103
2492,華新科,6,0,6,群益金鼎-松山,2024-05-24,9103
3060,銘異,7,1,6,群益金鼎-松山,2024-05-24,9103
3665,貿聯-KY,6,0,6,群益金鼎-松山,2024-05-24,9103
1101,台泥,5,0,5,群益金鼎-松山,2024-05-24,9103
00725B,國泰投資級公司債,5,0,5,群益金鼎-松山,2024-05-24,9103
00946,群益科技高息成長,211,0,211,群益金鼎-松山,2024-05-27,9103
2409,友達,201,4,197,群益金鼎-松山,2024-05-27,9103
3178,公準,159,0,159,群益金鼎-松山,2024-05-27,9103
3481,群創,102,2,100,群益金鼎-松山,2024-05-27,9103
2363,矽統,114,49,65,群益金鼎-松山,2024-05-27,9103
1453,大將,66,7,59,群益金鼎-松山,2024-05-27,9103
6591,動力-KY,140,90,50,群益金鼎-松山,2024-05-27,9103
3499,環天科,50,0,50,群益金鼎-松山,2024-05-27,9103
6770,力積電,50,1,49,群益金鼎-松山,2024-05-27,9103
2354,鴻準,61,17,44,群益金鼎-松山,2024-05-27,9103
1522,堤維西,40,0,40,群益金鼎-松山,2024-05-27,9103
8028,昇陽半導體,51,14,37,群益金鼎-松山,2024-05-27,9103
3055,蔚華科,38,7,31,群益金鼎-松山,2024-05-27,9103
2501,國建,30,0,30,群益金鼎-松山,2024-05-27,9103
00665L,富邦�琤肭磪囓�2,28,0,28,群益金鼎-松山,2024-05-27,9103
8084,巨虹,27,0,27,群益金鼎-松山,2024-05-27,9103
2330,台積電,32,5,27,群益金鼎-松山,2024-05-27,9103
6189,豐藝,29,3,26,群益金鼎-松山,2024-05-27,9103
2401,凌陽,34,10,24,群益金鼎-松山,2024-05-27,9103
6526,達發,22,0,22,群益金鼎-松山,2024-05-27,9103
00929,復華台灣科技優息,20,0,20,群益金鼎-松山,2024-05-27,9103
2329,華泰,20,0,20,群益金鼎-松山,2024-05-27,9103
2615,萬海,38,21,17,群益金鼎-松山,2024-05-27,9103
00632R,元大台灣50反1,31,15,16,群益金鼎-松山,2024-05-27,9103
2352,佳世達,20,4,16,群益金鼎-松山,2024-05-27,9103
3234,光環,20,4,16,群益金鼎-松山,2024-05-27,9103
5371,中光電,15,0,15,群益金鼎-松山,2024-05-27,9103
2645,長榮航太,14,0,14,群益金鼎-松山,2024-05-27,9103
2301,光寶科,42,30,12,群益金鼎-松山,2024-05-27,9103
2392,正崴,41,30,11,群益金鼎-松山,2024-05-27,9103
2489,瑞軒,14,3,11,群益金鼎-松山,2024-05-27,9103
00864B,中信美國公債0-1,10,0,10,群益金鼎-松山,2024-05-27,9103
1903,士紙,15,5,10,群益金鼎-松山,2024-05-27,9103
2375,凱美,10,0,10,群益金鼎-松山,2024-05-27,9103
2485,兆赫,30,20,10,群益金鼎-松山,2024-05-27,9103
2543,皇昌,10,0,10,群益金鼎-松山,2024-05-27,9103
4147,中裕,10,0,10,群益金鼎-松山,2024-05-27,9103
6271,同欣電,10,0,10,群益金鼎-松山,2024-05-27,9103
00919,群益台灣精選高息,12,3,9,群益金鼎-松山,2024-05-27,9103
2101,南港,9,0,9,群益金鼎-松山,2024-05-27,9103
2486,一詮,23,14,9,群益金鼎-松山,2024-05-27,9103
3005,神基,10,1,9,群益金鼎-松山,2024-05-27,9103
3535,晶彩科,9,0,9,群益金鼎-松山,2024-05-27,9103
00945B,凱基美國非投等債,8,0,8,群益金鼎-松山,2024-05-27,9103
2002,中鋼,9,1,8,群益金鼎-松山,2024-05-27,9103
6125,廣運,26,18,8,群益金鼎-松山,2024-05-27,9103
3231,緯創,10,3,7,群益金鼎-松山,2024-05-27,9103
4906,正文,7,0,7,群益金鼎-松山,2024-05-27,9103
2609,陽明,35,29,6,群益金鼎-松山,2024-05-27,9103
8210,勤誠,6,0,6,群益金鼎-松山,2024-05-27,9103
00946,群益科技高息成長,152,50,102,群益金鼎-松山,2024-05-28,9103
2885,元大金,100,0,100,群益金鼎-松山,2024-05-28,9103
3149,正達,100,0,100,群益金鼎-松山,2024-05-28,9103
6591,動力-KY,88,0,88,群益金鼎-松山,2024-05-28,9103
2353,宏��,82,0,82,群益金鼎-松山,2024-05-28,9103
8084,巨虹,54,0,54,群益金鼎-松山,2024-05-28,9103
3594,磐儀,43,0,43,群益金鼎-松山,2024-05-28,9103
2324,仁寶,47,5,42,群益金鼎-松山,2024-05-28,9103
2401,凌陽,75,35,40,群益金鼎-松山,2024-05-28,9103
1522,堤維西,41,2,39,群益金鼎-松山,2024-05-28,9103
2486,一詮,38,3,35,群益金鼎-松山,2024-05-28,9103
3013,晟銘電,51,19,32,群益金鼎-松山,2024-05-28,9103
1785,光洋科,30,0,30,群益金鼎-松山,2024-05-28,9103
2340,台亞,30,0,30,群益金鼎-松山,2024-05-28,9103
2603,長榮,30,1,29,群益金鼎-松山,2024-05-28,9103
6188,廣明,40,14,26,群益金鼎-松山,2024-05-28,9103
3005,神基,22,0,22,群益金鼎-松山,2024-05-28,9103
2338,光罩,25,5,20,群益金鼎-松山,2024-05-28,9103
3609,三一東林,20,0,20,群益金鼎-松山,2024-05-28,9103
6164,華興,20,0,20,群益金鼎-松山,2024-05-28,9103
912000,晨訊科-DR,20,0,20,群益金鼎-松山,2024-05-28,9103
3055,蔚華科,32,13,19,群益金鼎-松山,2024-05-28,9103
2317,鴻海,22,4,18,群益金鼎-松山,2024-05-28,9103
1582,信錦,29,12,17,群益金鼎-松山,2024-05-28,9103
2383,台光電,16,0,16,群益金鼎-松山,2024-05-28,9103
3466,德晉,15,1,14,群益金鼎-松山,2024-05-28,9103
3202,樺晟,13,0,13,群益金鼎-松山,2024-05-28,9103
3231,緯創,38,25,13,群益金鼎-松山,2024-05-28,9103
2352,佳世達,12,0,12,群益金鼎-松山,2024-05-28,9103
00929,復華台灣科技優息,52,40,12,群益金鼎-松山,2024-05-28,9103
3033,威健,14,2,12,群益金鼎-松山,2024-05-28,9103
3450,聯鈞,16,4,12,群益金鼎-松山,2024-05-28,9103
4979,華星光,18,6,12,群益金鼎-松山,2024-05-28,9103
3289,宜特,11,0,11,群益金鼎-松山,2024-05-28,9103
1587,吉茂,10,0,10,群益金鼎-松山,2024-05-28,9103
00679B,元大美債20年,10,0,10,群益金鼎-松山,2024-05-28,9103
2009,第一銅,20,10,10,群益金鼎-松山,2024-05-28,9103
2618,長榮航,19,9,10,群益金鼎-松山,2024-05-28,9103
00919,群益台灣精選高息,9,0,9,群益金鼎-松山,2024-05-28,9103
3689,湧德,10,1,9,群益金鼎-松山,2024-05-28,9103
2467,志聖,9,1,8,群益金鼎-松山,2024-05-28,9103
3306,鼎天,11,3,8,群益金鼎-松山,2024-05-28,9103
6526,達發,16,8,8,群益金鼎-松山,2024-05-28,9103
2392,正崴,32,25,7,群益金鼎-松山,2024-05-28,9103
6161,捷波,7,0,7,群益金鼎-松山,2024-05-28,9103
9910,豐泰,8,1,7,群益金鼎-松山,2024-05-28,9103
00632R,元大台灣50反1,6,0,6,群益金鼎-松山,2024-05-28,9103
1605,華新,10,4,6,群益金鼎-松山,2024-05-28,9103
2101,南港,6,0,6,群益金鼎-松山,2024-05-28,9103
5347,世界,6,0,6,群益金鼎-松山,2024-05-28,9103
2881,富邦金,98,0,98,群益金鼎-松山,2024-05-29,9103
2489,瑞軒,98,36,62,群益金鼎-松山,2024-05-29,9103
00937B,群益ESG投等債20,58,3,55,群益金鼎-松山,2024-05-29,9103
1303,南亞,52,1,51,群益金鼎-松山,2024-05-29,9103
2883,凱基金,44,0,44,群益金鼎-松山,2024-05-29,9103
1101,台泥,42,0,42,群益金鼎-松山,2024-05-29,9103
2887,台新金,41,0,41,群益金鼎-松山,2024-05-29,9103
6117,迎廣,44,11,33,群益金鼎-松山,2024-05-29,9103
6125,廣運,59,28,31,群益金鼎-松山,2024-05-29,9103
00679B,元大美債20年,31,0,31,群益金鼎-松山,2024-05-29,9103
2867,三商壽,30,0,30,群益金鼎-松山,2024-05-29,9103
2362,藍天,27,0,27,群益金鼎-松山,2024-05-29,9103
2884,玉山金,20,0,20,群益金鼎-松山,2024-05-29,9103
5880,合庫金,20,0,20,群益金鼎-松山,2024-05-29,9103
6233,旺玖,53,33,20,群益金鼎-松山,2024-05-29,9103
2352,佳世達,32,13,19,群益金鼎-松山,2024-05-29,9103
3338,泰碩,18,1,17,群益金鼎-松山,2024-05-29,9103
2317,鴻海,16,0,16,群益金鼎-松山,2024-05-29,9103
00857B,永豐20年美公債,16,0,16,群益金鼎-松山,2024-05-29,9103
3702,大聯大,15,0,15,群益金鼎-松山,2024-05-29,9103
6274,台燿,17,2,15,群益金鼎-松山,2024-05-29,9103
4533,協易機,23,9,14,群益金鼎-松山,2024-05-29,9103
00687B,國泰20年美債,14,0,14,群益金鼎-松山,2024-05-29,9103
3689,湧德,12,0,12,群益金鼎-松山,2024-05-29,9103
3450,聯鈞,14,3,11,群益金鼎-松山,2024-05-29,9103
00665L,富邦�琤肭磪囓�2,10,0,10,群益金鼎-松山,2024-05-29,9103
00773B,中信優先金融債,10,0,10,群益金鼎-松山,2024-05-29,9103
00720B,元大投資級公司債,10,0,10,群益金鼎-松山,2024-05-29,9103
2354,鴻準,137,127,10,群益金鼎-松山,2024-05-29,9103
2405,輔信,10,0,10,群益金鼎-松山,2024-05-29,9103
2636,台驊控股,12,2,10,群益金鼎-松山,2024-05-29,9103
5519,隆大,10,0,10,群益金鼎-松山,2024-05-29,9103
6160,欣技,12,2,10,群益金鼎-松山,2024-05-29,9103
9904,寶成,10,0,10,群益金鼎-松山,2024-05-29,9103
00725B,國泰投資級公司債,10,0,10,群益金鼎-松山,2024-05-29,9103
2615,萬海,54,45,9,群益金鼎-松山,2024-05-29,9103
00632R,元大台灣50反1,54,45,9,群益金鼎-松山,2024-05-29,9103
2436,偉詮電,10,1,9,群益金鼎-松山,2024-05-29,9103
2514,龍邦,9,0,9,群益金鼎-松山,2024-05-29,9103
3552,同致,9,0,9,群益金鼎-松山,2024-05-29,9103
3037,欣興,10,1,9,群益金鼎-松山,2024-05-29,9103
00940,元大台灣價值高息,8,0,8,群益金鼎-松山,2024-05-29,9103
2365,昆盈,9,1,8,群益金鼎-松山,2024-05-29,9103
6488,環球晶,8,0,8,群益金鼎-松山,2024-05-29,9103
8064,東捷,8,0,8,群益金鼎-松山,2024-05-29,9103
3013,晟銘電,50,43,7,群益金鼎-松山,2024-05-29,9103
3025,星通,7,0,7,群益金鼎-松山,2024-05-29,9103
2313,華通,6,0,6,群益金鼎-松山,2024-05-29,9103
2329,華泰,6,0,6,群益金鼎-松山,2024-05-29,9103
2472,立隆電,6,0,6,群益金鼎-松山,2024-05-29,9103
1785,光洋科,111,2,109,群益金鼎-松山,2024-05-30,9103
3499,環天科,80,0,80,群益金鼎-松山,2024-05-30,9103
3013,晟銘電,109,35,74,群益金鼎-松山,2024-05-30,9103
2371,大同,69,9,60,群益金鼎-松山,2024-05-30,9103
2497,怡利電,60,0,60,群益金鼎-松山,2024-05-30,9103
2605,新興,54,2,52,群益金鼎-松山,2024-05-30,9103
2537,聯上發,60,10,50,群益金鼎-松山,2024-05-30,9103
6164,華興,50,0,50,群益金鼎-松山,2024-05-30,9103
6695,芯鼎,50,0,50,群益金鼎-松山,2024-05-30,9103
4562,穎漢,37,0,37,群益金鼎-松山,2024-05-30,9103
6117,迎廣,35,2,33,群益金鼎-松山,2024-05-30,9103
1471,首利,30,0,30,群益金鼎-松山,2024-05-30,9103
1303,南亞,32,4,28,群益金鼎-松山,2024-05-30,9103
2317,鴻海,27,0,27,群益金鼎-松山,2024-05-30,9103
2887,台新金,26,0,26,群益金鼎-松山,2024-05-30,9103
1101,台泥,30,5,25,群益金鼎-松山,2024-05-30,9103
6125,廣運,44,21,23,群益金鼎-松山,2024-05-30,9103
8349,�矬�,23,0,23,群益金鼎-松山,2024-05-30,9103
1808,潤隆,21,0,21,群益金鼎-松山,2024-05-30,9103
6591,動力-KY,21,0,21,群益金鼎-松山,2024-05-30,9103
2888,新光金,20,0,20,群益金鼎-松山,2024-05-30,9103
8092,建暐,20,0,20,群益金鼎-松山,2024-05-30,9103
2464,盟立,23,4,19,群益金鼎-松山,2024-05-30,9103
00937B,群益ESG投等債20,18,0,18,群益金鼎-松山,2024-05-30,9103
2353,宏��,17,2,15,群益金鼎-松山,2024-05-30,9103
3537,堡達,15,0,15,群益金鼎-松山,2024-05-30,9103
00665L,富邦�琤肭磪囓�2,13,0,13,群益金鼎-松山,2024-05-30,9103
2313,華通,13,0,13,群益金鼎-松山,2024-05-30,9103
8028,昇陽半導體,13,0,13,群益金鼎-松山,2024-05-30,9103
8054,安國,60,49,11,群益金鼎-松山,2024-05-30,9103
2324,仁寶,15,4,11,群益金鼎-松山,2024-05-30,9103
4903,聯光通,11,0,11,群益金鼎-松山,2024-05-30,9103
00713,元大台灣高息低波,10,0,10,群益金鼎-松山,2024-05-30,9103
2915,潤泰全,10,0,10,群益金鼎-松山,2024-05-30,9103
3356,奇偶,11,1,10,群益金鼎-松山,2024-05-30,9103
2330,台積電,41,31,10,群益金鼎-松山,2024-05-30,9103
2603,長榮,9,0,9,群益金鼎-松山,2024-05-30,9103
00929,復華台灣科技優息,9,0,9,群益金鼎-松山,2024-05-30,9103
2548,華固,8,0,8,群益金鼎-松山,2024-05-30,9103
3055,蔚華科,27,19,8,群益金鼎-松山,2024-05-30,9103
4721,美琪瑪,8,0,8,群益金鼎-松山,2024-05-30,9103
6143,振曜,9,1,8,群益金鼎-松山,2024-05-30,9103
2201,裕隆,7,0,7,群益金鼎-松山,2024-05-30,9103
00946,群益科技高息成長,6,0,6,群益金鼎-松山,2024-05-30,9103
3033,威健,7,1,6,群益金鼎-松山,2024-05-30,9103
4561,健椿,6,0,6,群益金鼎-松山,2024-05-30,9103
8227,巨有科技,5,0,5,群益金鼎-松山,2024-05-30,9103
00679B,元大美債20年,5,0,5,群益金鼎-松山,2024-05-30,9103
00753L,中信中國50正2,5,0,5,群益金鼎-松山,2024-05-30,9103
00830,國泰費城半導體,5,0,5,群益金鼎-松山,2024-05-30,9103
1218,泰山,107,1,106,群益金鼎-松山,2024-05-31,9103
6264,富裔,87,0,87,群益金鼎-松山,2024-05-31,9103
2606,裕民,61,1,60,群益金鼎-松山,2024-05-31,9103
2352,佳世達,36,0,36,群益金鼎-松山,2024-05-31,9103
2641,正德,40,4,36,群益金鼎-松山,2024-05-31,9103
2317,鴻海,36,4,32,群益金鼎-松山,2024-05-31,9103
5351,鈺創,30,0,30,群益金鼎-松山,2024-05-31,9103
3231,緯創,21,0,21,群益金鼎-松山,2024-05-31,9103
6695,芯鼎,58,37,21,群益金鼎-松山,2024-05-31,9103
00939,統一台灣高息動能,20,0,20,群益金鼎-松山,2024-05-31,9103
1446,宏和,20,0,20,群益金鼎-松山,2024-05-31,9103
2520,冠德,20,0,20,群益金鼎-松山,2024-05-31,9103
1473,台南,15,0,15,群益金鼎-松山,2024-05-31,9103
00665L,富邦�琤肭磪囓�2,20,5,15,群益金鼎-松山,2024-05-31,9103
2501,國建,32,18,14,群益金鼎-松山,2024-05-31,9103
5608,四維航,19,5,14,群益金鼎-松山,2024-05-31,9103
2609,陽明,21,8,13,群益金鼎-松山,2024-05-31,9103
2303,聯電,12,0,12,群益金鼎-松山,2024-05-31,9103
4552,力達-KY,12,0,12,群益金鼎-松山,2024-05-31,9103
5903,全家,12,0,12,群益金鼎-松山,2024-05-31,9103
2354,鴻準,155,143,12,群益金鼎-松山,2024-05-31,9103
00929,復華台灣科技優息,11,0,11,群益金鼎-松山,2024-05-31,9103
00931B,統一美債20年,10,0,10,群益金鼎-松山,2024-05-31,9103
00679B,元大美債20年,10,0,10,群益金鼎-松山,2024-05-31,9103
1591,駿吉-KY,10,0,10,群益金鼎-松山,2024-05-31,9103
3268,海德威,10,0,10,群益金鼎-松山,2024-05-31,9103
3312,弘憶股,31,21,10,群益金鼎-松山,2024-05-31,9103
6177,達麗,10,0,10,群益金鼎-松山,2024-05-31,9103
6606,建德工業,10,0,10,群益金鼎-松山,2024-05-31,9103
00919,群益台灣精選高息,9,0,9,群益金鼎-松山,2024-05-31,9103
3712,永崴投控,10,1,9,群益金鼎-松山,2024-05-31,9103
5522,遠雄,10,1,9,群益金鼎-松山,2024-05-31,9103
6188,廣明,23,14,9,群益金鼎-松山,2024-05-31,9103
00946,群益科技高息成長,8,0,8,群益金鼎-松山,2024-05-31,9103
5371,中光電,8,0,8,群益金鼎-松山,2024-05-31,9103
5508,永信建,8,0,8,群益金鼎-松山,2024-05-31,9103
1903,士紙,10,3,7,群益金鼎-松山,2024-05-31,9103
6770,力積電,7,0,7,群益金鼎-松山,2024-05-31,9103
8028,昇陽半導體,9,2,7,群益金鼎-松山,2024-05-31,9103
1504,東元,10,4,6,群益金鼎-松山,2024-05-31,9103
1522,堤維西,6,0,6,群益金鼎-松山,2024-05-31,9103
00652,富邦印度,6,0,6,群益金鼎-松山,2024-05-31,9103
00632R,元大台灣50反1,20,15,5,群益金鼎-松山,2024-05-31,9103
1560,中砂,5,0,5,群益金鼎-松山,2024-05-31,9103
1201,味全,5,0,5,群益金鼎-松山,2024-05-31,9103
2375,凱美,5,0,5,群益金鼎-松山,2024-05-31,9103
2399,映泰,7,2,5,群益金鼎-松山,2024-05-31,9103
2405,輔信,5,0,5,群益金鼎-松山,2024-05-31,9103
3033,威健,5,0,5,群益金鼎-松山,2024-05-31,9103
3537,堡達,20,15,5,群益金鼎-松山,2024-05-31,9103
2515,中工,403,0,403,群益金鼎-松山,2024-06-03,9103
3481,群創,218,2,216,群益金鼎-松山,2024-06-03,9103
1815,富喬,159,5,154,群益金鼎-松山,2024-06-03,9103
6112,邁達特,147,1,146,群益金鼎-松山,2024-06-03,9103
6005,群益證,111,1,110,群益金鼎-松山,2024-06-03,9103
2867,三商壽,110,0,110,群益金鼎-松山,2024-06-03,9103
2409,友達,100,0,100,群益金鼎-松山,2024-06-03,9103
2353,宏��,75,31,44,群益金鼎-松山,2024-06-03,9103
3703,欣陸,34,0,34,群益金鼎-松山,2024-06-03,9103
3708,上緯投控,33,0,33,群益金鼎-松山,2024-06-03,9103
1453,大將,30,0,30,群益金鼎-松山,2024-06-03,9103
1532,勤美,30,0,30,群益金鼎-松山,2024-06-03,9103
2606,裕民,30,0,30,群益金鼎-松山,2024-06-03,9103
3266,昇陽,30,0,30,群益金鼎-松山,2024-06-03,9103
3455,由田,30,0,30,群益金鼎-松山,2024-06-03,9103
4533,協易機,64,37,27,群益金鼎-松山,2024-06-03,9103
2362,藍天,40,18,22,群益金鼎-松山,2024-06-03,9103
3380,明泰,22,0,22,群益金鼎-松山,2024-06-03,9103
00895,富邦未來車,20,0,20,群益金鼎-松山,2024-06-03,9103
2365,昆盈,70,50,20,群益金鼎-松山,2024-06-03,9103
2615,萬海,59,39,20,群益金鼎-松山,2024-06-03,9103
4513,福裕,20,0,20,群益金鼎-松山,2024-06-03,9103
5347,世界,20,0,20,群益金鼎-松山,2024-06-03,9103
5531,鄉林,20,0,20,群益金鼎-松山,2024-06-03,9103
3025,星通,22,3,19,群益金鼎-松山,2024-06-03,9103
2427,三商電,18,0,18,群益金鼎-松山,2024-06-03,9103
2486,一詮,23,6,17,群益金鼎-松山,2024-06-03,9103
5251,天鉞電,17,0,17,群益金鼎-松山,2024-06-03,9103
3537,堡達,25,10,15,群益金鼎-松山,2024-06-03,9103
5230,雷笛克光學,16,1,15,群益金鼎-松山,2024-06-03,9103
1303,南亞,25,11,14,群益金鼎-松山,2024-06-03,9103
1810,和成,13,0,13,群益金鼎-松山,2024-06-03,9103
00929,復華台灣科技優息,12,0,12,群益金鼎-松山,2024-06-03,9103
1605,華新,12,0,12,群益金鼎-松山,2024-06-03,9103
2303,聯電,12,0,12,群益金鼎-松山,2024-06-03,9103
2363,矽統,18,7,11,群益金鼎-松山,2024-06-03,9103
2509,全坤建,11,0,11,群益金鼎-松山,2024-06-03,9103
3483,力致,14,3,11,群益金鼎-松山,2024-06-03,9103
2412,中華電,11,0,11,群益金鼎-松山,2024-06-03,9103
1337,再生-KY,10,0,10,群益金鼎-松山,2024-06-03,9103
00918,大華優利高填息30,10,0,10,群益金鼎-松山,2024-06-03,9103
1218,泰山,10,0,10,群益金鼎-松山,2024-06-03,9103
00650L,復華香港正2,10,0,10,群益金鼎-松山,2024-06-03,9103
00632R,元大台灣50反1,25,15,10,群益金鼎-松山,2024-06-03,9103
1783,和康生,10,0,10,群益金鼎-松山,2024-06-03,9103
2313,華通,10,0,10,群益金鼎-松山,2024-06-03,9103
2618,長榮航,10,0,10,群益金鼎-松山,2024-06-03,9103
2401,凌陽,9,0,9,群益金鼎-松山,2024-06-03,9103
2603,長榮,12,3,9,群益金鼎-松山,2024-06-03,9103
3540,曜越,20,11,9,群益金鼎-松山,2024-06-03,9103
2888,新光金,237,0,237,群益金鼎-松山,2024-06-04,9103
00919,群益台灣精選高息,111,0,111,群益金鼎-松山,2024-06-04,9103
1815,富喬,170,62,108,群益金鼎-松山,2024-06-04,9103
3013,晟銘電,97,11,86,群益金鼎-松山,2024-06-04,9103
6591,動力-KY,60,0,60,群益金鼎-松山,2024-06-04,9103
00936,台新永續高息中小,50,0,50,群益金鼎-松山,2024-06-04,9103
2641,正德,40,0,40,群益金鼎-松山,2024-06-04,9103
2354,鴻準,97,67,30,群益金鼎-松山,2024-06-04,9103
00632R,元大台灣50反1,240,215,25,群益金鼎-松山,2024-06-04,9103
00830,國泰費城半導體,25,0,25,群益金鼎-松山,2024-06-04,9103
2317,鴻海,27,3,24,群益金鼎-松山,2024-06-04,9103
00929,復華台灣科技優息,23,0,23,群益金鼎-松山,2024-06-04,9103
1303,南亞,26,4,22,群益金鼎-松山,2024-06-04,9103
3289,宜特,23,1,22,群益金鼎-松山,2024-06-04,9103
3260,威剛,23,2,21,群益金鼎-松山,2024-06-04,9103
6770,力積電,18,0,18,群益金鼎-松山,2024-06-04,9103
1515,力山,16,0,16,群益金鼎-松山,2024-06-04,9103
5230,雷笛克光學,16,0,16,群益金鼎-松山,2024-06-04,9103
2501,國建,21,6,15,群益金鼎-松山,2024-06-04,9103
8936,國統,15,0,15,群益金鼎-松山,2024-06-04,9103
2330,台積電,15,1,14,群益金鼎-松山,2024-06-04,9103
6462,神盾,22,8,14,群益金鼎-松山,2024-06-04,9103
6538,倉和,15,3,12,群益金鼎-松山,2024-06-04,9103
0056,元大高股息,11,0,11,群益金鼎-松山,2024-06-04,9103
2465,麗臺,23,12,11,群益金鼎-松山,2024-06-04,9103
4726,永昕,11,0,11,群益金鼎-松山,2024-06-04,9103
8028,昇陽半導體,11,0,11,群益金鼎-松山,2024-06-04,9103
1312,國喬,10,0,10,群益金鼎-松山,2024-06-04,9103
2453,凌群,13,3,10,群益金鼎-松山,2024-06-04,9103
2515,中工,12,2,10,群益金鼎-松山,2024-06-04,9103
5519,隆大,30,20,10,群益金鼎-松山,2024-06-04,9103
6177,達麗,10,0,10,群益金鼎-松山,2024-06-04,9103
2012,春雨,9,0,9,群益金鼎-松山,2024-06-04,9103
4973,廣穎,9,0,9,群益金鼎-松山,2024-06-04,9103
8454,富邦媒,9,1,8,群益金鼎-松山,2024-06-04,9103
2313,華通,7,0,7,群益金鼎-松山,2024-06-04,9103
2324,仁寶,9,2,7,群益金鼎-松山,2024-06-04,9103
3356,奇偶,8,1,7,群益金鼎-松山,2024-06-04,9103
4160,訊聯基因,7,0,7,群益金鼎-松山,2024-06-04,9103
8155,博智,7,0,7,群益金鼎-松山,2024-06-04,9103
00878,國泰永續高股息,8,1,7,群益金鼎-松山,2024-06-04,9103
00940,元大台灣價值高息,6,0,6,群益金鼎-松山,2024-06-04,9103
1702,南僑,6,0,6,群益金鼎-松山,2024-06-04,9103
3294,英濟,14,8,6,群益金鼎-松山,2024-06-04,9103
3443,創意,6,1,5,群益金鼎-松山,2024-06-04,9103
00725B,國泰投資級公司債,5,0,5,群益金鼎-松山,2024-06-04,9103
00637L,元大滬深300正2,10,5,5,群益金鼎-松山,2024-06-04,9103
1605,華新,5,0,5,群益金鼎-松山,2024-06-04,9103
2637,慧洋-KY,6,1,5,群益金鼎-松山,2024-06-04,9103
3062,建漢,5,0,5,群益金鼎-松山,2024-06-04,9103
2888,新光金,212,0,212,群益金鼎-松山,2024-06-05,9103
00664R,國泰臺灣加權反1,100,0,100,群益金鼎-松山,2024-06-05,9103
6591,動力-KY,60,0,60,群益金鼎-松山,2024-06-05,9103
1815,富喬,219,169,50,群益金鼎-松山,2024-06-05,9103
2887,台新金,50,0,50,群益金鼎-松山,2024-06-05,9103
2317,鴻海,54,7,47,群益金鼎-松山,2024-06-05,9103
3372,典範,36,0,36,群益金鼎-松山,2024-06-05,9103
2352,佳世達,32,0,32,群益金鼎-松山,2024-06-05,9103
2353,宏��,92,61,31,群益金鼎-松山,2024-06-05,9103
9945,潤泰新,31,0,31,群益金鼎-松山,2024-06-05,9103
3708,上緯投控,31,3,28,群益金鼎-松山,2024-06-05,9103
5392,能率,61,33,28,群益金鼎-松山,2024-06-05,9103
4533,協易機,48,26,22,群益金鼎-松山,2024-06-05,9103
4562,穎漢,25,3,22,群益金鼎-松山,2024-06-05,9103
2374,佳能,20,0,20,群益金鼎-松山,2024-06-05,9103
2611,志信,20,0,20,群益金鼎-松山,2024-06-05,9103
5213,亞昕,20,0,20,群益金鼎-松山,2024-06-05,9103
00919,群益台灣精選高息,15,1,14,群益金鼎-松山,2024-06-05,9103
3362,先進光,25,11,14,群益金鼎-松山,2024-06-05,9103
3013,晟銘電,16,3,13,群益金鼎-松山,2024-06-05,9103
00878,國泰永續高股息,13,0,13,群益金鼎-松山,2024-06-05,9103
2303,聯電,12,0,12,群益金鼎-松山,2024-06-05,9103
9943,好樂迪,12,0,12,群益金鼎-松山,2024-06-05,9103
00929,復華台灣科技優息,14,3,11,群益金鼎-松山,2024-06-05,9103
3540,曜越,12,1,11,群益金鼎-松山,2024-06-05,9103
5522,遠雄,11,0,11,群益金鼎-松山,2024-06-05,9103
1101,台泥,10,0,10,群益金鼎-松山,2024-06-05,9103
1326,台化,10,0,10,群益金鼎-松山,2024-06-05,9103
00895,富邦未來車,10,0,10,群益金鼎-松山,2024-06-05,9103
00752,中信中國50,10,0,10,群益金鼎-松山,2024-06-05,9103
2524,京城,10,0,10,群益金鼎-松山,2024-06-05,9103
2539,櫻花建,10,0,10,群益金鼎-松山,2024-06-05,9103
3202,樺晟,10,0,10,群益金鼎-松山,2024-06-05,9103
5880,合庫金,10,0,10,群益金鼎-松山,2024-06-05,9103
8033,雷虎,10,0,10,群益金鼎-松山,2024-06-05,9103
1802,台玻,10,1,9,群益金鼎-松山,2024-06-05,9103
3048,益登,11,2,9,群益金鼎-松山,2024-06-05,9103
2417,圓剛,10,2,8,群益金鼎-松山,2024-06-05,9103
6290,良維,8,1,7,群益金鼎-松山,2024-06-05,9103
2329,華泰,6,0,6,群益金鼎-松山,2024-06-05,9103
2464,盟立,6,0,6,群益金鼎-松山,2024-06-05,9103
4123,晟德,12,6,6,群益金鼎-松山,2024-06-05,9103
4721,美琪瑪,6,0,6,群益金鼎-松山,2024-06-05,9103
6143,振曜,8,2,6,群益金鼎-松山,2024-06-05,9103
8349,�矬�,9,3,6,群益金鼎-松山,2024-06-05,9103
00632R,元大台灣50反1,110,105,5,群益金鼎-松山,2024-06-05,9103
1609,大亞,5,0,5,群益金鼎-松山,2024-06-05,9103
2002,中鋼,5,0,5,群益金鼎-松山,2024-06-05,9103
2109,華豐,5,0,5,群益金鼎-松山,2024-06-05,9103
2323,中環,10,5,5,群益金鼎-松山,2024-06-05,9103
2883,凱基金,401,20,381,群益金鼎-松山,2024-06-06,9103
4906,正文,112,7,105,群益金鼎-松山,2024-06-06,9103
2885,元大金,101,0,101,群益金鼎-松山,2024-06-06,9103
3178,公準,85,25,60,群益金鼎-松山,2024-06-06,9103
2313,華通,50,0,50,群益金鼎-松山,2024-06-06,9103
00632R,元大台灣50反1,55,10,45,群益金鼎-松山,2024-06-06,9103
00946,群益科技高息成長,41,0,41,群益金鼎-松山,2024-06-06,9103
1314,中石化,40,0,40,群益金鼎-松山,2024-06-06,9103
2605,新興,33,3,30,群益金鼎-松山,2024-06-06,9103
6770,力積電,22,0,22,群益金鼎-松山,2024-06-06,9103
00895,富邦未來車,20,0,20,群益金鼎-松山,2024-06-06,9103
2375,凱美,20,0,20,群益金鼎-松山,2024-06-06,9103
2537,聯上發,22,2,20,群益金鼎-松山,2024-06-06,9103
2809,京城銀,20,0,20,群益金鼎-松山,2024-06-06,9103
4513,福裕,17,0,17,群益金鼎-松山,2024-06-06,9103
3013,晟銘電,52,36,16,群益金鼎-松山,2024-06-06,9103
3149,正達,16,0,16,群益金鼎-松山,2024-06-06,9103
00692,富邦公司治理,15,0,15,群益金鼎-松山,2024-06-06,9103
3022,威強電,15,0,15,群益金鼎-松山,2024-06-06,9103
4123,晟德,20,5,15,群益金鼎-松山,2024-06-06,9103
2101,南港,16,2,14,群益金鼎-松山,2024-06-06,9103
6213,聯茂,14,1,13,群益金鼎-松山,2024-06-06,9103
00679B,元大美債20年,12,0,12,群益金鼎-松山,2024-06-06,9103
1513,中興電,12,1,11,群益金鼎-松山,2024-06-06,9103
1103,嘉泥,10,0,10,群益金鼎-松山,2024-06-06,9103
00724B,群益投資級金融債,10,0,10,群益金鼎-松山,2024-06-06,9103
2392,正崴,10,0,10,群益金鼎-松山,2024-06-06,9103
6546,正基,10,0,10,群益金鼎-松山,2024-06-06,9103
6742,澤米,10,0,10,群益金鼎-松山,2024-06-06,9103
8093,保銳,10,0,10,群益金鼎-松山,2024-06-06,9103
1476,儒鴻,9,0,9,群益金鼎-松山,2024-06-06,9103
4908,前鼎,10,1,9,群益金鼎-松山,2024-06-06,9103
8071,能率網通,10,1,9,群益金鼎-松山,2024-06-06,9103
2427,三商電,12,4,8,群益金鼎-松山,2024-06-06,9103
2330,台積電,15,7,8,群益金鼎-松山,2024-06-06,9103
3062,建漢,8,1,7,群益金鼎-松山,2024-06-06,9103
4566,時碩工業,8,1,7,群益金鼎-松山,2024-06-06,9103
00671R,富邦NASDAQ反1,6,0,6,群益金鼎-松山,2024-06-06,9103
00929,復華台灣科技優息,6,0,6,群益金鼎-松山,2024-06-06,9103
2345,智邦,6,0,6,群益金鼎-松山,2024-06-06,9103
2501,國建,7,1,6,群益金鼎-松山,2024-06-06,9103
1218,泰山,5,0,5,群益金鼎-松山,2024-06-06,9103
00830,國泰費城半導體,5,0,5,群益金鼎-松山,2024-06-06,9103
00795B,中信美國公債20年,5,0,5,群益金鼎-松山,2024-06-06,9103
2250,IKKA-KY,5,0,5,群益金鼎-松山,2024-06-06,9103
2356,英業達,5,0,5,群益金鼎-松山,2024-06-06,9103
2603,長榮,14,9,5,群益金鼎-松山,2024-06-06,9103
2743,山富,5,0,5,群益金鼎-松山,2024-06-06,9103
3481,群創,5,0,5,群益金鼎-松山,2024-06-06,9103
4576,大銀微系統,5,0,5,群益金鼎-松山,2024-06-06,9103
1453,大將,341,33,308,群益金鼎-松山,2024-06-07,9103
3481,群創,208,0,208,群益金鼎-松山,2024-06-07,9103
2610,華航,141,0,141,群益金鼎-松山,2024-06-07,9103
2834,臺企銀,105,0,105,群益金鼎-松山,2024-06-07,9103
3149,正達,42,0,42,群益金鼎-松山,2024-06-07,9103
1612,宏泰,40,0,40,群益金鼎-松山,2024-06-07,9103
00936,台新永續高息中小,54,16,38,群益金鼎-松山,2024-06-07,9103
2352,佳世達,34,0,34,群益金鼎-松山,2024-06-07,9103
2009,第一銅,27,2,25,群益金鼎-松山,2024-06-07,9103
2615,萬海,40,18,22,群益金鼎-松山,2024-06-07,9103
1532,勤美,20,0,20,群益金鼎-松山,2024-06-07,9103
2365,昆盈,20,0,20,群益金鼎-松山,2024-06-07,9103
2545,皇翔,20,0,20,群益金鼎-松山,2024-06-07,9103
2313,華通,35,16,19,群益金鼎-松山,2024-06-07,9103
1316,上曜,28,10,18,群益金鼎-松山,2024-06-07,9103
2867,三商壽,16,0,16,群益金鼎-松山,2024-06-07,9103
00881,國泰台灣5G+,15,0,15,群益金鼎-松山,2024-06-07,9103
6143,振曜,66,52,14,群益金鼎-松山,2024-06-07,9103
1815,富喬,130,117,13,群益金鼎-松山,2024-06-07,9103
2603,長榮,14,2,12,群益金鼎-松山,2024-06-07,9103
3363,上詮,13,2,11,群益金鼎-松山,2024-06-07,9103
2330,台積電,10,0,10,群益金鼎-松山,2024-06-07,9103
1101,台泥,10,0,10,群益金鼎-松山,2024-06-07,9103
00919,群益台灣精選高息,11,1,10,群益金鼎-松山,2024-06-07,9103
00895,富邦未來車,10,0,10,群益金鼎-松山,2024-06-07,9103
1903,士紙,10,0,10,群益金鼎-松山,2024-06-07,9103
2331,精英,10,0,10,群益金鼎-松山,2024-06-07,9103
2453,凌群,10,0,10,群益金鼎-松山,2024-06-07,9103
2636,台驊控股,10,0,10,群益金鼎-松山,2024-06-07,9103
4303,信立,11,1,10,群益金鼎-松山,2024-06-07,9103
5519,隆大,21,11,10,群益金鼎-松山,2024-06-07,9103
3037,欣興,9,0,9,群益金鼎-松山,2024-06-07,9103
6282,康舒,8,0,8,群益金鼎-松山,2024-06-07,9103
4566,時碩工業,13,5,8,群益金鼎-松山,2024-06-07,9103
00929,復華台灣科技優息,7,0,7,群益金鼎-松山,2024-06-07,9103
2486,一詮,12,5,7,群益金鼎-松山,2024-06-07,9103
3376,新日興,22,15,7,群益金鼎-松山,2024-06-07,9103
2371,大同,7,1,6,群益金鼎-松山,2024-06-07,9103
3706,神達,6,0,6,群益金鼎-松山,2024-06-07,9103
1442,名軒,5,0,5,群益金鼎-松山,2024-06-07,9103
00673R,期元大S＆P原油反1,5,0,5,群益金鼎-松山,2024-06-07,9103
00795B,中信美國公債20年,5,0,5,群益金鼎-松山,2024-06-07,9103
1582,信錦,5,0,5,群益金鼎-松山,2024-06-07,9103
2312,金寶,21,16,5,群益金鼎-松山,2024-06-07,9103
2354,鴻準,5,0,5,群益金鼎-松山,2024-06-07,9103
2539,櫻花建,5,0,5,群益金鼎-松山,2024-06-07,9103
2637,慧洋-KY,5,0,5,群益金鼎-松山,2024-06-07,9103
3019,亞光,5,0,5,群益金鼎-松山,2024-06-07,9103
3025,星通,6,1,5,群益金鼎-松山,2024-06-07,9103
3062,建漢,6,1,5,群益金鼎-松山,2024-06-07,9103
1513,中興電,289,3,286,群益金鼎-松山,2024-06-11,9103
00712,復華富時不動產,200,0,200,群益金鼎-松山,2024-06-11,9103
00680L,元大美債20正2,151,0,151,群益金鼎-松山,2024-06-11,9103
2610,華航,141,0,141,群益金鼎-松山,2024-06-11,9103
00937B,群益ESG投等債20,98,1,97,群益金鼎-松山,2024-06-11,9103
4979,華星光,41,2,39,群益金鼎-松山,2024-06-11,9103
2606,裕民,31,0,31,群益金鼎-松山,2024-06-11,9103
1608,華榮,34,4,30,群益金鼎-松山,2024-06-11,9103
2330,台積電,31,1,30,群益金鼎-松山,2024-06-11,9103
2351,順德,31,1,30,群益金鼎-松山,2024-06-11,9103
2501,國建,27,1,26,群益金鼎-松山,2024-06-11,9103
00632R,元大台灣50反1,74,50,24,群益金鼎-松山,2024-06-11,9103
3059,華晶科,26,2,24,群益金鼎-松山,2024-06-11,9103
3703,欣陸,23,0,23,群益金鼎-松山,2024-06-11,9103
00946,群益科技高息成長,20,0,20,群益金鼎-松山,2024-06-11,9103
00679B,元大美債20年,20,0,20,群益金鼎-松山,2024-06-11,9103
2354,鴻準,40,20,20,群益金鼎-松山,2024-06-11,9103
2520,冠德,20,0,20,群益金鼎-松山,2024-06-11,9103
5519,隆大,30,10,20,群益金鼎-松山,2024-06-11,9103
8936,國統,17,0,17,群益金鼎-松山,2024-06-11,9103
3548,兆利,16,1,15,群益金鼎-松山,2024-06-11,9103
2352,佳世達,18,3,15,群益金鼎-松山,2024-06-11,9103
00929,復華台灣科技優息,13,0,13,群益金鼎-松山,2024-06-11,9103
2438,翔耀,12,0,12,群益金鼎-松山,2024-06-11,9103
8084,巨虹,13,1,12,群益金鼎-松山,2024-06-11,9103
1218,泰山,11,0,11,群益金鼎-松山,2024-06-11,9103
2002,中鋼,11,0,11,群益金鼎-松山,2024-06-11,9103
3376,新日興,17,6,11,群益金鼎-松山,2024-06-11,9103
00939,統一台灣高息動能,10,0,10,群益金鼎-松山,2024-06-11,9103
00942B,台新美A公司債20+,10,0,10,群益金鼎-松山,2024-06-11,9103
2323,中環,10,0,10,群益金鼎-松山,2024-06-11,9103
2453,凌群,20,10,10,群益金鼎-松山,2024-06-11,9103
2524,京城,10,0,10,群益金鼎-松山,2024-06-11,9103
2888,新光金,10,0,10,群益金鼎-松山,2024-06-11,9103
4562,穎漢,10,0,10,群益金鼎-松山,2024-06-11,9103
00687B,國泰20年美債,9,0,9,群益金鼎-松山,2024-06-11,9103
1808,潤隆,9,0,9,群益金鼎-松山,2024-06-11,9103
2367,燿華,9,0,9,群益金鼎-松山,2024-06-11,9103
3188,鑫龍騰,11,2,9,群益金鼎-松山,2024-06-11,9103
6789,采鈺,10,1,9,群益金鼎-松山,2024-06-11,9103
00665L,富邦�琤肭磪囓�2,8,0,8,群益金鼎-松山,2024-06-11,9103
3047,訊舟,14,6,8,群益金鼎-松山,2024-06-11,9103
5608,四維航,42,34,8,群益金鼎-松山,2024-06-11,9103
2303,聯電,10,3,7,群益金鼎-松山,2024-06-11,9103
3189,景碩,7,0,7,群益金鼎-松山,2024-06-11,9103
4147,中裕,15,8,7,群益金鼎-松山,2024-06-11,9103
00713,元大台灣高息低波,6,0,6,群益金鼎-松山,2024-06-11,9103
00637L,元大滬深300正2,6,0,6,群益金鼎-松山,2024-06-11,9103
2355,敬鵬,9,3,6,群益金鼎-松山,2024-06-11,9103
3691,碩禾,6,0,6,群益金鼎-松山,2024-06-11,9103
00946,群益科技高息成長,218,0,218,群益金鼎-松山,2024-06-12,9103
00712,復華富時不動產,200,0,200,群益金鼎-松山,2024-06-12,9103
00947,台新臺灣IC設計,150,0,150,群益金鼎-松山,2024-06-12,9103
3455,由田,110,0,110,群益金鼎-松山,2024-06-12,9103
00929,復華台灣科技優息,103,0,103,群益金鼎-松山,2024-06-12,9103
00915,凱基優選高股息30,100,0,100,群益金鼎-松山,2024-06-12,9103
4716,大立,100,0,100,群益金鼎-松山,2024-06-12,9103
00948B,中信優息投資級債,58,0,58,群益金鼎-松山,2024-06-12,9103
6164,華興,50,0,50,群益金鼎-松山,2024-06-12,9103
2605,新興,50,1,49,群益金鼎-松山,2024-06-12,9103
2303,聯電,51,3,48,群益金鼎-松山,2024-06-12,9103
2637,慧洋-KY,40,0,40,群益金鼎-松山,2024-06-12,9103
2883,凱基金,41,6,35,群益金鼎-松山,2024-06-12,9103
3363,上詮,48,16,32,群益金鼎-松山,2024-06-12,9103
2365,昆盈,90,60,30,群益金鼎-松山,2024-06-12,9103
6841,長佳智能,30,0,30,群益金鼎-松山,2024-06-12,9103
2353,宏��,28,0,28,群益金鼎-松山,2024-06-12,9103
00937B,群益ESG投等債20,22,0,22,群益金鼎-松山,2024-06-12,9103
2498,宏達電,21,0,21,群益金鼎-松山,2024-06-12,9103
6207,雷科,22,3,19,群益金鼎-松山,2024-06-12,9103
00715L,期街口布蘭特正2,16,0,16,群益金鼎-松山,2024-06-12,9103
2359,所羅門,50,36,14,群益金鼎-松山,2024-06-12,9103
2867,三商壽,14,0,14,群益金鼎-松山,2024-06-12,9103
1618,合機,16,3,13,群益金鼎-松山,2024-06-12,9103
6125,廣運,13,0,13,群益金鼎-松山,2024-06-12,9103
3047,訊舟,21,9,12,群益金鼎-松山,2024-06-12,9103
3374,精材,12,1,11,群益金鼎-松山,2024-06-12,9103
3376,新日興,16,5,11,群益金鼎-松山,2024-06-12,9103
00753L,中信中國50正2,10,0,10,群益金鼎-松山,2024-06-12,9103
1217,愛之味,10,0,10,群益金鼎-松山,2024-06-12,9103
1303,南亞,10,0,10,群益金鼎-松山,2024-06-12,9103
1591,駿吉-KY,10,0,10,群益金鼎-松山,2024-06-12,9103
2356,英業達,10,0,10,群益金鼎-松山,2024-06-12,9103
2606,裕民,10,0,10,群益金鼎-松山,2024-06-12,9103
2615,萬海,61,51,10,群益金鼎-松山,2024-06-12,9103
2891,中信金,11,1,10,群益金鼎-松山,2024-06-12,9103
3312,弘憶股,10,0,10,群益金鼎-松山,2024-06-12,9103
3537,堡達,20,10,10,群益金鼎-松山,2024-06-12,9103
4979,華星光,12,2,10,群益金鼎-松山,2024-06-12,9103
6188,廣明,14,4,10,群益金鼎-松山,2024-06-12,9103
2201,裕隆,9,0,9,群益金鼎-松山,2024-06-12,9103
2351,順德,10,1,9,群益金鼎-松山,2024-06-12,9103
4561,健椿,9,0,9,群益金鼎-松山,2024-06-12,9103
6187,萬潤,12,3,9,群益金鼎-松山,2024-06-12,9103
2348,海悅,8,0,8,群益金鼎-松山,2024-06-12,9103
6021,美好證,8,0,8,群益金鼎-松山,2024-06-12,9103
3231,緯創,9,2,7,群益金鼎-松山,2024-06-12,9103
3406,玉晶光,15,8,7,群益金鼎-松山,2024-06-12,9103
2603,長榮,28,22,6,群益金鼎-松山,2024-06-12,9103
1325,恆大,8,2,6,群益金鼎-松山,2024-06-12,9103
00664R,國泰臺灣加權反1,200,0,200,群益金鼎-松山,2024-06-13,9103
00878,國泰永續高股息,101,8,93,群益金鼎-松山,2024-06-13,9103
00929,復華台灣科技優息,206,120,86,群益金鼎-松山,2024-06-13,9103
00948B,中信優息投資級債,80,0,80,群益金鼎-松山,2024-06-13,9103
6625,必應,71,10,61,群益金鼎-松山,2024-06-13,9103
4534,慶騰,54,1,53,群益金鼎-松山,2024-06-13,9103
4716,大立,51,0,51,群益金鼎-松山,2024-06-13,9103
2609,陽明,41,0,41,群益金鼎-松山,2024-06-13,9103
1522,堤維西,32,0,32,群益金鼎-松山,2024-06-13,9103
4714,永捷,31,0,31,群益金鼎-松山,2024-06-13,9103
00895,富邦未來車,30,0,30,群益金鼎-松山,2024-06-13,9103
2323,中環,25,0,25,群益金鼎-松山,2024-06-13,9103
6207,雷科,27,6,21,群益金鼎-松山,2024-06-13,9103
8021,尖點,20,0,20,群益金鼎-松山,2024-06-13,9103
2354,鴻準,40,21,19,群益金鼎-松山,2024-06-13,9103
2455,全新,20,2,18,群益金鼎-松山,2024-06-13,9103
2383,台光電,19,4,15,群益金鼎-松山,2024-06-13,9103
3234,光環,15,0,15,群益金鼎-松山,2024-06-13,9103
2230,泰茂,13,0,13,群益金鼎-松山,2024-06-13,9103
5608,四維航,13,0,13,群益金鼎-松山,2024-06-13,9103
00679B,元大美債20年,12,0,12,群益金鼎-松山,2024-06-13,9103
6112,邁達特,11,0,11,群益金鼎-松山,2024-06-13,9103
00891,中信關鍵半導體,10,0,10,群益金鼎-松山,2024-06-13,9103
00919,群益台灣精選高息,12,2,10,群益金鼎-松山,2024-06-13,9103
00671R,富邦NASDAQ反1,10,0,10,群益金鼎-松山,2024-06-13,9103
00795B,中信美國公債20年,10,0,10,群益金鼎-松山,2024-06-13,9103
1806,冠軍,10,0,10,群益金鼎-松山,2024-06-13,9103
2464,盟立,22,12,10,群益金鼎-松山,2024-06-13,9103
2465,麗臺,20,10,10,群益金鼎-松山,2024-06-13,9103
6245,立端,10,0,10,群益金鼎-松山,2024-06-13,9103
6416,瑞祺電通,10,0,10,群益金鼎-松山,2024-06-13,9103
912000,晨訊科-DR,10,0,10,群益金鼎-松山,2024-06-13,9103
6197,佳必琪,10,0,10,群益金鼎-松山,2024-06-13,9103
2867,三商壽,9,0,9,群益金鼎-松山,2024-06-13,9103
3025,星通,12,3,9,群益金鼎-松山,2024-06-13,9103
00770,國泰北美科技,8,0,8,群益金鼎-松山,2024-06-13,9103
6143,振曜,20,12,8,群益金鼎-松山,2024-06-13,9103
1514,亞力,23,16,7,群益金鼎-松山,2024-06-13,9103
2356,英業達,12,5,7,群益金鼎-松山,2024-06-13,9103
8110,華東,18,11,7,群益金鼎-松山,2024-06-13,9103
3665,貿聯-KY,11,4,7,群益金鼎-松山,2024-06-13,9103
1815,富喬,6,0,6,群益金鼎-松山,2024-06-13,9103
2476,鉅祥,16,10,6,群益金鼎-松山,2024-06-13,9103
2618,長榮航,6,0,6,群益金鼎-松山,2024-06-13,9103
3037,欣興,6,0,6,群益金鼎-松山,2024-06-13,9103
4123,晟德,8,2,6,群益金鼎-松山,2024-06-13,9103
4566,時碩工業,12,6,6,群益金鼎-松山,2024-06-13,9103
4909,新復興,7,1,6,群益金鼎-松山,2024-06-13,9103
00724B,群益投資級金融債,5,0,5,群益金鼎-松山,2024-06-13,9103
00896,中信綠能及電動車,5,0,5,群益金鼎-松山,2024-06-13,9103
6187,萬潤,103,2,101,群益金鼎-松山,2024-06-14,9103
00948B,中信優息投資級債,70,0,70,群益金鼎-松山,2024-06-14,9103
2303,聯電,60,2,58,群益金鼎-松山,2024-06-14,9103
00857B,永豐20年美公債,55,0,55,群益金鼎-松山,2024-06-14,9103
00881,國泰台灣5G+,61,6,55,群益金鼎-松山,2024-06-14,9103
2031,新光鋼,50,0,50,群益金鼎-松山,2024-06-14,9103
3362,先進光,45,2,43,群益金鼎-松山,2024-06-14,9103
1785,光洋科,54,23,31,群益金鼎-松山,2024-06-14,9103
2330,台積電,32,2,30,群益金鼎-松山,2024-06-14,9103
2605,新興,30,1,29,群益金鼎-松山,2024-06-14,9103
2392,正崴,62,34,28,群益金鼎-松山,2024-06-14,9103
2501,國建,30,3,27,群益金鼎-松山,2024-06-14,9103
6213,聯茂,46,19,27,群益金鼎-松山,2024-06-14,9103
00946,群益科技高息成長,25,0,25,群益金鼎-松山,2024-06-14,9103
8028,昇陽半導體,44,20,24,群益金鼎-松山,2024-06-14,9103
00878,國泰永續高股息,22,0,22,群益金鼎-松山,2024-06-14,9103
8926,台汽電,20,0,20,群益金鼎-松山,2024-06-14,9103
2486,一詮,23,3,20,群益金鼎-松山,2024-06-14,9103
5381,合正,20,0,20,群益金鼎-松山,2024-06-14,9103
8277,商丞,19,0,19,群益金鼎-松山,2024-06-14,9103
00929,復華台灣科技優息,17,0,17,群益金鼎-松山,2024-06-14,9103
8103,瀚荃,14,0,14,群益金鼎-松山,2024-06-14,9103
1609,大亞,25,11,14,群益金鼎-松山,2024-06-14,9103
2367,燿華,15,2,13,群益金鼎-松山,2024-06-14,9103
8084,巨虹,24,11,13,群益金鼎-松山,2024-06-14,9103
00919,群益台灣精選高息,11,0,11,群益金鼎-松山,2024-06-14,9103
6163,華電網,11,0,11,群益金鼎-松山,2024-06-14,9103
8147,正淩,11,0,11,群益金鼎-松山,2024-06-14,9103
1444,力麗,11,0,11,群益金鼎-松山,2024-06-14,9103
6245,立端,11,1,10,群益金鼎-松山,2024-06-14,9103
1314,中石化,10,0,10,群益金鼎-松山,2024-06-14,9103
00637L,元大滬深300正2,10,0,10,群益金鼎-松山,2024-06-14,9103
0056,元大高股息,10,0,10,群益金鼎-松山,2024-06-14,9103
2002,中鋼,10,0,10,群益金鼎-松山,2024-06-14,9103
2324,仁寶,10,0,10,群益金鼎-松山,2024-06-14,9103
2704,國賓,10,0,10,群益金鼎-松山,2024-06-14,9103
2845,遠東銀,10,0,10,群益金鼎-松山,2024-06-14,9103
4533,協易機,10,0,10,群益金鼎-松山,2024-06-14,9103
5519,隆大,20,10,10,群益金鼎-松山,2024-06-14,9103
6875,國邑*,10,0,10,群益金鼎-松山,2024-06-14,9103
2313,華通,8,0,8,群益金鼎-松山,2024-06-14,9103
2615,萬海,66,58,8,群益金鼎-松山,2024-06-14,9103
8096,擎亞,9,1,8,群益金鼎-松山,2024-06-14,9103
2382,廣達,11,3,8,群益金鼎-松山,2024-06-14,9103
2363,矽統,16,9,7,群益金鼎-松山,2024-06-14,9103
1587,吉茂,9,2,7,群益金鼎-松山,2024-06-14,9103
5608,四維航,10,3,7,群益金鼎-松山,2024-06-14,9103
1503,士電,22,16,6,群益金鼎-松山,2024-06-14,9103
00692,富邦公司治理,5,0,5,群益金鼎-松山,2024-06-14,9103
1323,永裕,5,0,5,群益金鼎-松山,2024-06-14,9103
2888,新光金,120,0,120,群益金鼎-松山,2024-06-17,9103
4716,大立,106,1,105,群益金鼎-松山,2024-06-17,9103
00650L,復華香港正2,100,0,100,群益金鼎-松山,2024-06-17,9103
6770,力積電,100,13,87,群益金鼎-松山,2024-06-17,9103
00937B,群益ESG投等債20,79,0,79,群益金鼎-松山,2024-06-17,9103
2537,聯上發,32,2,30,群益金鼎-松山,2024-06-17,9103
00946,群益科技高息成長,28,0,28,群益金鼎-松山,2024-06-17,9103
9945,潤泰新,28,0,28,群益金鼎-松山,2024-06-17,9103
00929,復華台灣科技優息,29,2,27,群益金鼎-松山,2024-06-17,9103
3540,曜越,24,0,24,群益金鼎-松山,2024-06-17,9103
1617,榮星,23,0,23,群益金鼎-松山,2024-06-17,9103
6546,正基,23,0,23,群益金鼎-松山,2024-06-17,9103
2362,藍天,20,0,20,群益金鼎-松山,2024-06-17,9103
2504,國產,20,0,20,群益金鼎-松山,2024-06-17,9103
3703,欣陸,20,0,20,群益金鼎-松山,2024-06-17,9103
6695,芯鼎,20,0,20,群益金鼎-松山,2024-06-17,9103
4968,立積,30,10,20,群益金鼎-松山,2024-06-17,9103
2371,大同,243,224,19,群益金鼎-松山,2024-06-17,9103
6164,華興,18,0,18,群益金鼎-松山,2024-06-17,9103
00632R,元大台灣50反1,16,0,16,群益金鼎-松山,2024-06-17,9103
9904,寶成,15,0,15,群益金鼎-松山,2024-06-17,9103
1514,亞力,19,6,13,群益金鼎-松山,2024-06-17,9103
3105,穩懋,12,0,12,群益金鼎-松山,2024-06-17,9103
5284,jpp-KY,12,0,12,群益金鼎-松山,2024-06-17,9103
3062,建漢,11,0,11,群益金鼎-松山,2024-06-17,9103
2455,全新,11,1,10,群益金鼎-松山,2024-06-17,9103
00931B,統一美債20年,10,0,10,群益金鼎-松山,2024-06-17,9103
2101,南港,10,0,10,群益金鼎-松山,2024-06-17,9103
2414,精技,10,0,10,群益金鼎-松山,2024-06-17,9103
2515,中工,10,0,10,群益金鼎-松山,2024-06-17,9103
2884,玉山金,10,0,10,群益金鼎-松山,2024-06-17,9103
2892,第一金,10,0,10,群益金鼎-松山,2024-06-17,9103
3312,弘憶股,29,19,10,群益金鼎-松山,2024-06-17,9103
3710,連展投控,10,0,10,群益金鼎-松山,2024-06-17,9103
5213,亞昕,10,0,10,群益金鼎-松山,2024-06-17,9103
5243,乙盛-KY,11,1,10,群益金鼎-松山,2024-06-17,9103
1303,南亞,9,0,9,群益金鼎-松山,2024-06-17,9103
6117,迎廣,9,0,9,群益金鼎-松山,2024-06-17,9103
00919,群益台灣精選高息,8,0,8,群益金鼎-松山,2024-06-17,9103
2009,第一銅,8,0,8,群益金鼎-松山,2024-06-17,9103
2323,中環,8,0,8,群益金鼎-松山,2024-06-17,9103
2348,海悅,8,0,8,群益金鼎-松山,2024-06-17,9103
4966,譜瑞-KY,7,0,7,群益金鼎-松山,2024-06-17,9103
3675,德微,7,0,7,群益金鼎-松山,2024-06-17,9103
4726,永昕,7,0,7,群益金鼎-松山,2024-06-17,9103
6890,來億-KY,7,0,7,群益金鼎-松山,2024-06-17,9103
3665,貿聯-KY,15,9,6,群益金鼎-松山,2024-06-17,9103
5009,榮剛,6,0,6,群益金鼎-松山,2024-06-17,9103
2317,鴻海,21,16,5,群益金鼎-松山,2024-06-17,9103
2359,所羅門,9,4,5,群益金鼎-松山,2024-06-17,9103
6190,萬泰科,309,5,304,群益金鼎-松山,2024-06-18,9103
2888,新光金,206,10,196,群益金鼎-松山,2024-06-18,9103
2031,新光鋼,154,4,150,群益金鼎-松山,2024-06-18,9103
2618,長榮航,152,14,138,群益金鼎-松山,2024-06-18,9103
2515,中工,100,10,90,群益金鼎-松山,2024-06-18,9103
00937B,群益ESG投等債20,70,0,70,群益金鼎-松山,2024-06-18,9103
2449,京元電子,60,0,60,群益金鼎-松山,2024-06-18,9103
4123,晟德,67,12,55,群益金鼎-松山,2024-06-18,9103
1522,堤維西,50,0,50,群益金鼎-松山,2024-06-18,9103
2408,南亞科,60,11,49,群益金鼎-松山,2024-06-18,9103
00946,群益科技高息成長,40,0,40,群益金鼎-松山,2024-06-18,9103
1453,大將,35,0,35,群益金鼎-松山,2024-06-18,9103
8076,伍豐,31,0,31,群益金鼎-松山,2024-06-18,9103
9945,潤泰新,30,0,30,群益金鼎-松山,2024-06-18,9103
5439,高技,32,3,29,群益金鼎-松山,2024-06-18,9103
8085,福華,22,0,22,群益金鼎-松山,2024-06-18,9103
2392,正崴,21,0,21,群益金鼎-松山,2024-06-18,9103
2498,宏達電,20,0,20,群益金鼎-松山,2024-06-18,9103
00936,台新永續高息中小,25,6,19,群益金鼎-松山,2024-06-18,9103
00632R,元大台灣50反1,17,0,17,群益金鼎-松山,2024-06-18,9103
3374,精材,20,3,17,群益金鼎-松山,2024-06-18,9103
3622,洋華,17,0,17,群益金鼎-松山,2024-06-18,9103
8084,巨虹,26,10,16,群益金鼎-松山,2024-06-18,9103
4566,時碩工業,24,10,14,群益金鼎-松山,2024-06-18,9103
2301,光寶科,12,0,12,群益金鼎-松山,2024-06-18,9103
2606,裕民,12,0,12,群益金鼎-松山,2024-06-18,9103
00929,復華台灣科技優息,11,0,11,群益金鼎-松山,2024-06-18,9103
00918,大華優利高填息30,11,0,11,群益金鼎-松山,2024-06-18,9103
3047,訊舟,11,0,11,群益金鼎-松山,2024-06-18,9103
4726,永昕,11,0,11,群益金鼎-松山,2024-06-18,9103
00895,富邦未來車,10,0,10,群益金鼎-松山,2024-06-18,9103
00687B,國泰20年美債,10,0,10,群益金鼎-松山,2024-06-18,9103
00942B,台新美A公司債20+,10,0,10,群益金鼎-松山,2024-06-18,9103
2324,仁寶,10,0,10,群益金鼎-松山,2024-06-18,9103
2537,聯上發,10,0,10,群益金鼎-松山,2024-06-18,9103
5213,亞昕,10,0,10,群益金鼎-松山,2024-06-18,9103
5258,虹堡,10,0,10,群益金鼎-松山,2024-06-18,9103
6005,群益證,10,0,10,群益金鼎-松山,2024-06-18,9103
6546,正基,10,0,10,群益金鼎-松山,2024-06-18,9103
8093,保銳,10,0,10,群益金鼎-松山,2024-06-18,9103
9105,泰金寶-DR,10,0,10,群益金鼎-松山,2024-06-18,9103
1524,耿鼎,10,2,8,群益金鼎-松山,2024-06-18,9103
1504,東元,7,0,7,群益金鼎-松山,2024-06-18,9103
1303,南亞,7,0,7,群益金鼎-松山,2024-06-18,9103
3036,文曄,7,0,7,群益金鼎-松山,2024-06-18,9103
8096,擎亞,13,6,7,群益金鼎-松山,2024-06-18,9103
2009,第一銅,6,0,6,群益金鼎-松山,2024-06-18,9103
00680L,元大美債20正2,5,0,5,群益金鼎-松山,2024-06-18,9103
1570,力肯,8,3,5,群益金鼎-松山,2024-06-18,9103
2609,陽明,11,6,5,群益金鼎-松山,2024-06-18,9103
00937B,群益ESG投等債20,101,0,101,群益金鼎-松山,2024-06-19,9103
5512,力麒,100,0,100,群益金鼎-松山,2024-06-19,9103
6770,力積電,101,14,87,群益金鼎-松山,2024-06-19,9103
00936,台新永續高息中小,70,0,70,群益金鼎-松山,2024-06-19,9103
2609,陽明,70,0,70,群益金鼎-松山,2024-06-19,9103
00650L,復華香港正2,50,0,50,群益金鼎-松山,2024-06-19,9103
2371,大同,56,8,48,群益金鼎-松山,2024-06-19,9103
00946,群益科技高息成長,45,0,45,群益金鼎-松山,2024-06-19,9103
00632R,元大台灣50反1,237,200,37,群益金鼎-松山,2024-06-19,9103
2505,國揚,35,0,35,群益金鼎-松山,2024-06-19,9103
2365,昆盈,32,2,30,群益金鼎-松山,2024-06-19,9103
00720B,元大投資級公司債,30,0,30,群益金鼎-松山,2024-06-19,9103
3231,緯創,30,3,27,群益金鼎-松山,2024-06-19,9103
00929,復華台灣科技優息,26,0,26,群益金鼎-松山,2024-06-19,9103
2615,萬海,43,21,22,群益金鼎-松山,2024-06-19,9103
00940,元大台灣價值高息,21,0,21,群益金鼎-松山,2024-06-19,9103
00944,野村趨勢動能高息,20,0,20,群益金鼎-松山,2024-06-19,9103
1301,台塑,17,1,16,群益金鼎-松山,2024-06-19,9103
2408,南亞科,15,0,15,群益金鼎-松山,2024-06-19,9103
00679B,元大美債20年,15,0,15,群益金鼎-松山,2024-06-19,9103
00673R,期元大S＆P原油反1,14,0,14,群益金鼎-松山,2024-06-19,9103
2610,華航,16,4,12,群益金鼎-松山,2024-06-19,9103
3147,大綜,12,0,12,群益金鼎-松山,2024-06-19,9103
00947,台新臺灣IC設計,12,0,12,群益金鼎-松山,2024-06-19,9103
2392,正崴,11,0,11,群益金鼎-松山,2024-06-19,9103
3017,奇鋐,16,5,11,群益金鼎-松山,2024-06-19,9103
1710,東聯,10,0,10,群益金鼎-松山,2024-06-19,9103
2548,華固,10,0,10,群益金鼎-松山,2024-06-19,9103
3036,文曄,10,0,10,群益金鼎-松山,2024-06-19,9103
5213,亞昕,10,0,10,群益金鼎-松山,2024-06-19,9103
5347,世界,10,0,10,群益金鼎-松山,2024-06-19,9103
6625,必應,10,0,10,群益金鼎-松山,2024-06-19,9103
3363,上詮,12,3,9,群益金鼎-松山,2024-06-19,9103
2606,裕民,8,0,8,群益金鼎-松山,2024-06-19,9103
3013,晟銘電,21,13,8,群益金鼎-松山,2024-06-19,9103
3019,亞光,8,0,8,群益金鼎-松山,2024-06-19,9103
4968,立積,11,3,8,群益金鼎-松山,2024-06-19,9103
00896,中信綠能及電動車,7,0,7,群益金鼎-松山,2024-06-19,9103
00680L,元大美債20正2,7,0,7,群益金鼎-松山,2024-06-19,9103
1586,和勤,7,0,7,群益金鼎-松山,2024-06-19,9103
2438,翔耀,7,0,7,群益金鼎-松山,2024-06-19,9103
2597,潤弘,7,0,7,群益金鼎-松山,2024-06-19,9103
8028,昇陽半導體,8,1,7,群益金鼎-松山,2024-06-19,9103
8085,福華,14,7,7,群益金鼎-松山,2024-06-19,9103
8112,至上,7,0,7,群益金鼎-松山,2024-06-19,9103
00948B,中信優息投資級債,6,0,6,群益金鼎-松山,2024-06-19,9103
2352,佳世達,6,0,6,群益金鼎-松山,2024-06-19,9103
6282,康舒,7,1,6,群益金鼎-松山,2024-06-19,9103
6743,安普新,6,0,6,群益金鼎-松山,2024-06-19,9103
00715L,期街口布蘭特正2,5,0,5,群益金鼎-松山,2024-06-19,9103
1611,中電,356,0,356,群益金鼎-松山,2024-06-20,9103
5512,力麒,100,0,100,群益金鼎-松山,2024-06-20,9103
2344,華邦電,100,6,94,群益金鼎-松山,2024-06-20,9103
2888,新光金,100,10,90,群益金鼎-松山,2024-06-20,9103
3363,上詮,77,8,69,群益金鼎-松山,2024-06-20,9103
00948B,中信優息投資級債,64,0,64,群益金鼎-松山,2024-06-20,9103
2330,台積電,47,0,47,群益金鼎-松山,2024-06-20,9103
3706,神達,40,0,40,群益金鼎-松山,2024-06-20,9103
00720B,元大投資級公司債,30,0,30,群益金鼎-松山,2024-06-20,9103
1785,光洋科,24,0,24,群益金鼎-松山,2024-06-20,9103
2009,第一銅,32,10,22,群益金鼎-松山,2024-06-20,9103
00919,群益台灣精選高息,29,8,21,群益金鼎-松山,2024-06-20,9103
2495,普安,21,0,21,群益金鼎-松山,2024-06-20,9103
3673,TPK-KY,22,1,21,群益金鼎-松山,2024-06-20,9103
2324,仁寶,20,1,19,群益金鼎-松山,2024-06-20,9103
3483,力致,40,22,18,群益金鼎-松山,2024-06-20,9103
8028,昇陽半導體,24,6,18,群益金鼎-松山,2024-06-20,9103
6451,訊芯-KY,22,5,17,群益金鼎-松山,2024-06-20,9103
2356,英業達,18,2,16,群益金鼎-松山,2024-06-20,9103
1314,中石化,15,0,15,群益金鼎-松山,2024-06-20,9103
5263,智崴,15,0,15,群益金鼎-松山,2024-06-20,9103
2354,鴻準,33,19,14,群益金鼎-松山,2024-06-20,9103
2303,聯電,20,8,12,群益金鼎-松山,2024-06-20,9103
3356,奇偶,12,0,12,群益金鼎-松山,2024-06-20,9103
6282,康舒,11,0,11,群益金鼎-松山,2024-06-20,9103
00940,元大台灣價值高息,12,1,11,群益金鼎-松山,2024-06-20,9103
3006,晶豪科,21,10,11,群益金鼎-松山,2024-06-20,9103
6753,龍德造船,11,0,11,群益金鼎-松山,2024-06-20,9103
00881,國泰台灣5G+,10,0,10,群益金鼎-松山,2024-06-20,9103
2891,中信金,10,0,10,群益金鼎-松山,2024-06-20,9103
4306,炎洲,10,0,10,群益金鼎-松山,2024-06-20,9103
6668,中揚光,10,0,10,群益金鼎-松山,2024-06-20,9103
8054,安國,12,2,10,群益金鼎-松山,2024-06-20,9103
8085,福華,10,0,10,群益金鼎-松山,2024-06-20,9103
8093,保銳,10,0,10,群益金鼎-松山,2024-06-20,9103
3035,智原,11,1,10,群益金鼎-松山,2024-06-20,9103
2382,廣達,52,43,9,群益金鼎-松山,2024-06-20,9103
1609,大亞,10,1,9,群益金鼎-松山,2024-06-20,9103
2301,光寶科,16,7,9,群益金鼎-松山,2024-06-20,9103
2329,華泰,11,2,9,群益金鼎-松山,2024-06-20,9103
00632R,元大台灣50反1,28,20,8,群益金鼎-松山,2024-06-20,9103
2352,佳世達,14,6,8,群益金鼎-松山,2024-06-20,9103
6768,志強-KY,8,0,8,群益金鼎-松山,2024-06-20,9103
2498,宏達電,10,2,8,群益金鼎-松山,2024-06-20,9103
1503,士電,28,21,7,群益金鼎-松山,2024-06-20,9103
3042,晶技,7,0,7,群益金鼎-松山,2024-06-20,9103
00671R,富邦NASDAQ反1,6,0,6,群益金鼎-松山,2024-06-20,9103
2408,南亞科,20,14,6,群益金鼎-松山,2024-06-20,9103
3019,亞光,6,0,6,群益金鼎-松山,2024-06-20,9103
5439,高技,20,14,6,群益金鼎-松山,2024-06-20,9103
2867,三商壽,300,0,300,群益金鼎-松山,2024-06-21,9103
2409,友達,213,18,195,群益金鼎-松山,2024-06-21,9103
00937B,群益ESG投等債20,167,10,157,群益金鼎-松山,2024-06-21,9103
9105,泰金寶-DR,130,5,125,群益金鼎-松山,2024-06-21,9103
2801,彰銀,51,0,51,群益金鼎-松山,2024-06-21,9103
1608,華榮,30,0,30,群益金鼎-松山,2024-06-21,9103
2303,聯電,29,0,29,群益金鼎-松山,2024-06-21,9103
00929,復華台灣科技優息,26,1,25,群益金鼎-松山,2024-06-21,9103
2609,陽明,75,51,24,群益金鼎-松山,2024-06-21,9103
8096,擎亞,22,0,22,群益金鼎-松山,2024-06-21,9103
2330,台積電,22,1,21,群益金鼎-松山,2024-06-21,9103
00948B,中信優息投資級債,20,0,20,群益金鼎-松山,2024-06-21,9103
6217,中探針,20,0,20,群益金鼎-松山,2024-06-21,9103
00946,群益科技高息成長,17,0,17,群益金鼎-松山,2024-06-21,9103
1314,中石化,15,1,14,群益金鼎-松山,2024-06-21,9103
2317,鴻海,28,15,13,群益金鼎-松山,2024-06-21,9103
3374,精材,12,0,12,群益金鼎-松山,2024-06-21,9103
2329,華泰,12,1,11,群益金鼎-松山,2024-06-21,9103
00895,富邦未來車,10,0,10,群益金鼎-松山,2024-06-21,9103
1605,華新,10,0,10,群益金鼎-松山,2024-06-21,9103
3006,晶豪科,10,0,10,群益金鼎-松山,2024-06-21,9103
6269,台郡,10,0,10,群益金鼎-松山,2024-06-21,9103
1101,台泥,11,2,9,群益金鼎-松山,2024-06-21,9103
00665L,富邦�琤肭磪囓�2,9,0,9,群益金鼎-松山,2024-06-21,9103
2392,正崴,13,4,9,群益金鼎-松山,2024-06-21,9103
2455,全新,10,1,9,群益金鼎-松山,2024-06-21,9103
5392,能率,9,0,9,群益金鼎-松山,2024-06-21,9103
00679B,元大美債20年,8,0,8,群益金鼎-松山,2024-06-21,9103
2206,三陽工業,10,2,8,群益金鼎-松山,2024-06-21,9103
3702,大聯大,8,0,8,群益金鼎-松山,2024-06-21,9103
00881,國泰台灣5G+,7,0,7,群益金鼎-松山,2024-06-21,9103
00753L,中信中國50正2,7,0,7,群益金鼎-松山,2024-06-21,9103
1434,福懋,7,0,7,群益金鼎-松山,2024-06-21,9103
3289,宜特,8,1,7,群益金鼎-松山,2024-06-21,9103
3708,上緯投控,10,3,7,群益金鼎-松山,2024-06-21,9103
6598,ABC-KY,7,0,7,群益金鼎-松山,2024-06-21,9103
5243,乙盛-KY,10,4,6,群益金鼎-松山,2024-06-21,9103
6462,神盾,11,5,6,群益金鼎-松山,2024-06-21,9103
6890,來億-KY,6,0,6,群益金鼎-松山,2024-06-21,9103
8374,羅昇,20,14,6,群益金鼎-松山,2024-06-21,9103
1337,再生-KY,5,0,5,群益金鼎-松山,2024-06-21,9103
00632R,元大台灣50反1,105,100,5,群益金鼎-松山,2024-06-21,9103
2027,大成鋼,5,0,5,群益金鼎-松山,2024-06-21,9103
2414,精技,5,0,5,群益金鼎-松山,2024-06-21,9103
2489,瑞軒,5,0,5,群益金鼎-松山,2024-06-21,9103
2520,冠德,25,20,5,群益金鼎-松山,2024-06-21,9103
2606,裕民,15,10,5,群益金鼎-松山,2024-06-21,9103
3048,益登,6,1,5,群益金鼎-松山,2024-06-21,9103
3622,洋華,5,0,5,群益金鼎-松山,2024-06-21,9103
4545,銘鈺,5,0,5,群益金鼎-松山,2024-06-21,9103
00929,復華台灣科技優息,185,1,184,群益金鼎-松山,2024-06-24,9103
00937B,群益ESG投等債20,90,0,90,群益金鼎-松山,2024-06-24,9103
00919,群益台灣精選高息,88,1,87,群益金鼎-松山,2024-06-24,9103
2330,台積電,78,1,77,群益金鼎-松山,2024-06-24,9103
2883,凱基金,50,0,50,群益金鼎-松山,2024-06-24,9103
00706L,期元大S＆P日圓正2,40,0,40,群益金鼎-松山,2024-06-24,9103
1303,南亞,37,0,37,群益金鼎-松山,2024-06-24,9103
2368,金像電,35,0,35,群益金鼎-松山,2024-06-24,9103
3081,聯亞,35,0,35,群益金鼎-松山,2024-06-24,9103
2609,陽明,90,56,34,群益金鼎-松山,2024-06-24,9103
5439,高技,30,0,30,群益金鼎-松山,2024-06-24,9103
6753,龍德造船,30,0,30,群益金鼎-松山,2024-06-24,9103
2027,大成鋼,28,0,28,群益金鼎-松山,2024-06-24,9103
3062,建漢,53,25,28,群益金鼎-松山,2024-06-24,9103
8112,至上,21,0,21,群益金鼎-松山,2024-06-24,9103
00948B,中信優息投資級債,20,0,20,群益金鼎-松山,2024-06-24,9103
00680L,元大美債20正2,20,0,20,群益金鼎-松山,2024-06-24,9103
00881,國泰台灣5G+,19,0,19,群益金鼎-松山,2024-06-24,9103
3037,欣興,18,0,18,群益金鼎-松山,2024-06-24,9103
3706,神達,20,3,17,群益金鼎-松山,2024-06-24,9103
5263,智崴,30,15,15,群益金鼎-松山,2024-06-24,9103
3036,文曄,15,1,14,群益金鼎-松山,2024-06-24,9103
3481,群創,323,309,14,群益金鼎-松山,2024-06-24,9103
2615,萬海,43,31,12,群益金鼎-松山,2024-06-24,9103
5328,華容,12,0,12,群益金鼎-松山,2024-06-24,9103
8085,福華,12,0,12,群益金鼎-松山,2024-06-24,9103
00878,國泰永續高股息,12,1,11,群益金鼎-松山,2024-06-24,9103
8271,宇瞻,11,0,11,群益金鼎-松山,2024-06-24,9103
00632R,元大台灣50反1,315,305,10,群益金鼎-松山,2024-06-24,9103
2020,美亞,10,0,10,群益金鼎-松山,2024-06-24,9103
2323,中環,10,0,10,群益金鼎-松山,2024-06-24,9103
2337,旺宏,10,0,10,群益金鼎-松山,2024-06-24,9103
2467,志聖,11,1,10,群益金鼎-松山,2024-06-24,9103
6125,廣運,15,5,10,群益金鼎-松山,2024-06-24,9103
6139,亞翔,13,3,10,群益金鼎-松山,2024-06-24,9103
00946,群益科技高息成長,10,1,9,群益金鼎-松山,2024-06-24,9103
1514,亞力,10,1,9,群益金鼎-松山,2024-06-24,9103
4909,新復興,11,2,9,群益金鼎-松山,2024-06-24,9103
2344,華邦電,8,0,8,群益金鼎-松山,2024-06-24,9103
2439,美律,10,2,8,群益金鼎-松山,2024-06-24,9103
2888,新光金,8,0,8,群益金鼎-松山,2024-06-24,9103
1815,富喬,8,1,7,群益金鼎-松山,2024-06-24,9103
6625,必應,7,0,7,群益金鼎-松山,2024-06-24,9103
1326,台化,6,0,6,群益金鼎-松山,2024-06-24,9103
00896,中信綠能及電動車,6,0,6,群益金鼎-松山,2024-06-24,9103
2258,鴻華先進-創,6,0,6,群益金鼎-松山,2024-06-24,9103
2347,聯強,6,0,6,群益金鼎-松山,2024-06-24,9103
2002,中鋼,5,0,5,群益金鼎-松山,2024-06-24,9103
2409,友達,113,108,5,群益金鼎-松山,2024-06-24,9103
2812,台中銀,5,0,5,群益金鼎-松山,2024-06-24,9103
1785,光洋科,125,12,113,群益金鼎-松山,2024-06-25,9103
3357,臺慶科,77,0,77,群益金鼎-松山,2024-06-25,9103
4123,晟德,54,0,54,群益金鼎-松山,2024-06-25,9103
3081,聯亞,43,4,39,群益金鼎-松山,2024-06-25,9103
6164,華興,28,0,28,群益金鼎-松山,2024-06-25,9103
3450,聯鈞,29,2,27,群益金鼎-松山,2024-06-25,9103
1570,力肯,26,0,26,群益金鼎-松山,2024-06-25,9103
2002,中鋼,24,0,24,群益金鼎-松山,2024-06-25,9103
2317,鴻海,36,14,22,群益金鼎-松山,2024-06-25,9103
2883,凱基金,21,0,21,群益金鼎-松山,2024-06-25,9103
2316,楠梓電,23,5,18,群益金鼎-松山,2024-06-25,9103
3481,群創,19,4,15,群益金鼎-松山,2024-06-25,9103
2449,京元電子,16,2,14,群益金鼎-松山,2024-06-25,9103
3285,微端,14,0,14,群益金鼎-松山,2024-06-25,9103
3545,敦泰,12,0,12,群益金鼎-松山,2024-06-25,9103
4566,時碩工業,17,5,12,群益金鼎-松山,2024-06-25,9103
1815,富喬,15,4,11,群益金鼎-松山,2024-06-25,9103
3049,精金,10,0,10,群益金鼎-松山,2024-06-25,9103
3663,鑫科,10,0,10,群益金鼎-松山,2024-06-25,9103
5452,佶優,14,4,10,群益金鼎-松山,2024-06-25,9103
5481,新華,10,0,10,群益金鼎-松山,2024-06-25,9103
8183,精星,10,0,10,群益金鼎-松山,2024-06-25,9103
1513,中興電,12,3,9,群益金鼎-松山,2024-06-25,9103
2885,元大金,9,0,9,群益金鼎-松山,2024-06-25,9103
3005,神基,8,0,8,群益金鼎-松山,2024-06-25,9103
3189,景碩,8,0,8,群益金鼎-松山,2024-06-25,9103
2308,台達電,9,2,7,群益金鼎-松山,2024-06-25,9103
2610,華航,7,0,7,群益金鼎-松山,2024-06-25,9103
2618,長榮航,7,0,7,群益金鼎-松山,2024-06-25,9103
6451,訊芯-KY,6,0,6,群益金鼎-松山,2024-06-25,9103
1301,台塑,6,0,6,群益金鼎-松山,2024-06-25,9103
3665,貿聯-KY,15,9,6,群益金鼎-松山,2024-06-25,9103
4526,東台,7,1,6,群益金鼎-松山,2024-06-25,9103
6462,神盾,8,2,6,群益金鼎-松山,2024-06-25,9103
8085,福華,11,5,6,群益金鼎-松山,2024-06-25,9103
00671R,富邦NASDAQ反1,5,0,5,群益金鼎-松山,2024-06-25,9103
00652,富邦印度,5,0,5,群益金鼎-松山,2024-06-25,9103
00940,元大台灣價值高息,17,12,5,群益金鼎-松山,2024-06-25,9103
1303,南亞,5,0,5,群益金鼎-松山,2024-06-25,9103
2323,中環,5,0,5,群益金鼎-松山,2024-06-25,9103
2520,冠德,5,0,5,群益金鼎-松山,2024-06-25,9103
2886,兆豐金,5,0,5,群益金鼎-松山,2024-06-25,9103
3022,威強電,5,0,5,群益金鼎-松山,2024-06-25,9103
3297,杭特,5,0,5,群益金鼎-松山,2024-06-25,9103
3622,洋華,5,0,5,群益金鼎-松山,2024-06-25,9103
4533,協易機,9,4,5,群益金鼎-松山,2024-06-25,9103
4967,十銓,5,0,5,群益金鼎-松山,2024-06-25,9103
5469,瀚宇博,5,0,5,群益金鼎-松山,2024-06-25,9103
6125,廣運,5,0,5,群益金鼎-松山,2024-06-25,9103
6186,新潤,5,0,5,群益金鼎-松山,2024-06-25,9103
3357,臺慶科,111,5,106,群益金鼎-松山,2024-06-26,9103
3450,聯鈞,86,1,85,群益金鼎-松山,2024-06-26,9103
6117,迎廣,78,12,66,群益金鼎-松山,2024-06-26,9103
2888,新光金,53,0,53,群益金鼎-松山,2024-06-26,9103
2352,佳世達,52,0,52,群益金鼎-松山,2024-06-26,9103
1609,大亞,53,1,52,群益金鼎-松山,2024-06-26,9103
6207,雷科,43,1,42,群益金鼎-松山,2024-06-26,9103
1785,光洋科,35,4,31,群益金鼎-松山,2024-06-26,9103
3163,波若威,26,3,23,群益金鼎-松山,2024-06-26,9103
8028,昇陽半導體,25,3,22,群益金鼎-松山,2024-06-26,9103
00632R,元大台灣50反1,30,10,20,群益金鼎-松山,2024-06-26,9103
2201,裕隆,20,0,20,群益金鼎-松山,2024-06-26,9103
2408,南亞科,20,0,20,群益金鼎-松山,2024-06-26,9103
8096,擎亞,22,2,20,群益金鼎-松山,2024-06-26,9103
1795,美時,19,1,18,群益金鼎-松山,2024-06-26,9103
6282,康舒,18,0,18,群益金鼎-松山,2024-06-26,9103
00929,復華台灣科技優息,16,0,16,群益金鼎-松山,2024-06-26,9103
2609,陽明,35,20,15,群益金鼎-松山,2024-06-26,9103
00919,群益台灣精選高息,14,1,13,群益金鼎-松山,2024-06-26,9103
2353,宏��,13,0,13,群益金鼎-松山,2024-06-26,9103
3481,群創,114,101,13,群益金鼎-松山,2024-06-26,9103
2615,萬海,23,11,12,群益金鼎-松山,2024-06-26,9103
00895,富邦未來車,10,0,10,群益金鼎-松山,2024-06-26,9103
1605,華新,10,0,10,群益金鼎-松山,2024-06-26,9103
2337,旺宏,10,0,10,群益金鼎-松山,2024-06-26,9103
2495,普安,10,0,10,群益金鼎-松山,2024-06-26,9103
2537,聯上發,10,0,10,群益金鼎-松山,2024-06-26,9103
3006,晶豪科,10,0,10,群益金鼎-松山,2024-06-26,9103
6266,泰詠,10,0,10,群益金鼎-松山,2024-06-26,9103
8093,保銳,10,0,10,群益金鼎-松山,2024-06-26,9103
3691,碩禾,9,0,9,群益金鼎-松山,2024-06-26,9103
2002,中鋼,9,0,9,群益金鼎-松山,2024-06-26,9103
00715L,期街口布蘭特正2,8,0,8,群益金鼎-松山,2024-06-26,9103
3285,微端,10,2,8,群益金鼎-松山,2024-06-26,9103
2348,海悅,7,0,7,群益金鼎-松山,2024-06-26,9103
3374,精材,14,7,7,群益金鼎-松山,2024-06-26,9103
8085,福華,16,9,7,群益金鼎-松山,2024-06-26,9103
2834,臺企銀,6,0,6,群益金鼎-松山,2024-06-26,9103
3290,東浦,7,1,6,群益金鼎-松山,2024-06-26,9103
3380,明泰,6,0,6,群益金鼎-松山,2024-06-26,9103
3413,京鼎,6,0,6,群益金鼎-松山,2024-06-26,9103
4123,晟德,6,0,6,群益金鼎-松山,2024-06-26,9103
4909,新復興,8,2,6,群益金鼎-松山,2024-06-26,9103
5536,聖暉*,6,0,6,群益金鼎-松山,2024-06-26,9103
9945,潤泰新,6,0,6,群益金鼎-松山,2024-06-26,9103
1303,南亞,5,0,5,群益金鼎-松山,2024-06-26,9103
00720B,元大投資級公司債,5,0,5,群益金鼎-松山,2024-06-26,9103
00652,富邦印度,5,0,5,群益金鼎-松山,2024-06-26,9103
00940,元大台灣價值高息,5,0,5,群益金鼎-松山,2024-06-26,9103
1436,華友聯,5,0,5,群益金鼎-松山,2024-06-26,9103
9105,泰金寶-DR,201,101,100,群益金鼎-松山,2024-06-27,9103
00948B,中信優息投資級債,43,0,43,群益金鼎-松山,2024-06-27,9103
5443,均豪,67,24,43,群益金鼎-松山,2024-06-27,9103
3622,洋華,40,1,39,群益金鼎-松山,2024-06-27,9103
6443,元晶,141,106,35,群益金鼎-松山,2024-06-27,9103
6139,亞翔,33,1,32,群益金鼎-松山,2024-06-27,9103
3450,聯鈞,33,2,31,群益金鼎-松山,2024-06-27,9103
8064,東捷,25,0,25,群益金鼎-松山,2024-06-27,9103
2409,友達,22,0,22,群益金鼎-松山,2024-06-27,9103
00665L,富邦�琤肭磪囓�2,22,0,22,群益金鼎-松山,2024-06-27,9103
3290,東浦,20,0,20,群益金鼎-松山,2024-06-27,9103
4167,松瑞藥,22,2,20,群益金鼎-松山,2024-06-27,9103
8085,福華,20,0,20,群益金鼎-松山,2024-06-27,9103
6451,訊芯-KY,25,8,17,群益金鼎-松山,2024-06-27,9103
1418,東華,15,1,14,群益金鼎-松山,2024-06-27,9103
2352,佳世達,14,0,14,群益金鼎-松山,2024-06-27,9103
2609,陽明,15,1,14,群益金鼎-松山,2024-06-27,9103
3055,蔚華科,36,22,14,群益金鼎-松山,2024-06-27,9103
2317,鴻海,21,9,12,群益金鼎-松山,2024-06-27,9103
1101,台泥,11,0,11,群益金鼎-松山,2024-06-27,9103
00688L,國泰20年美債正2,10,0,10,群益金鼎-松山,2024-06-27,9103
2467,志聖,20,10,10,群益金鼎-松山,2024-06-27,9103
3356,奇偶,10,0,10,群益金鼎-松山,2024-06-27,9103
5534,長虹,10,0,10,群益金鼎-松山,2024-06-27,9103
3047,訊舟,10,1,9,群益金鼎-松山,2024-06-27,9103
3624,光頡,9,0,9,群益金鼎-松山,2024-06-27,9103
5251,天鉞電,9,0,9,群益金鼎-松山,2024-06-27,9103
5530,龍巖,10,1,9,群益金鼎-松山,2024-06-27,9103
1605,華新,10,2,8,群益金鼎-松山,2024-06-27,9103
3289,宜特,9,1,8,群益金鼎-松山,2024-06-27,9103
2101,南港,7,0,7,群益金鼎-松山,2024-06-27,9103
00940,元大台灣價值高息,6,0,6,群益金鼎-松山,2024-06-27,9103
3297,杭特,21,15,6,群益金鼎-松山,2024-06-27,9103
9904,寶成,6,0,6,群益金鼎-松山,2024-06-27,9103
1503,士電,17,12,5,群益金鼎-松山,2024-06-27,9103
1437,勤益控,5,0,5,群益金鼎-松山,2024-06-27,9103
00720B,元大投資級公司債,5,0,5,群益金鼎-松山,2024-06-27,9103
00687B,國泰20年美債,5,0,5,群益金鼎-松山,2024-06-27,9103
00881,國泰台灣5G+,5,0,5,群益金鼎-松山,2024-06-27,9103
0056,元大高股息,5,0,5,群益金鼎-松山,2024-06-27,9103
00652,富邦印度,5,0,5,群益金鼎-松山,2024-06-27,9103
00946,群益科技高息成長,6,1,5,群益金鼎-松山,2024-06-27,9103
2367,燿華,6,1,5,群益金鼎-松山,2024-06-27,9103
2540,愛山林,5,0,5,群益金鼎-松山,2024-06-27,9103
2885,元大金,5,0,5,群益金鼎-松山,2024-06-27,9103
3025,星通,5,0,5,群益金鼎-松山,2024-06-27,9103
4976,佳凌,5,0,5,群益金鼎-松山,2024-06-27,9103
5478,智冠,5,0,5,群益金鼎-松山,2024-06-27,9103
6166,凌華,5,0,5,群益金鼎-松山,2024-06-27,9103
8099,大世科,5,0,5,群益金鼎-松山,2024-06-27,9103
00937B,群益ESG投等債20,242,0,242,群益金鼎-松山,2024-06-28,9103
2888,新光金,150,0,150,群益金鼎-松山,2024-06-28,9103
2323,中環,103,0,103,群益金鼎-松山,2024-06-28,9103
2867,三商壽,102,0,102,群益金鼎-松山,2024-06-28,9103
6244,茂迪,83,12,71,群益金鼎-松山,2024-06-28,9103
3379,彬台,40,0,40,群益金鼎-松山,2024-06-28,9103
2406,國碩,53,17,36,群益金鼎-松山,2024-06-28,9103
00632R,元大台灣50反1,38,4,34,群益金鼎-松山,2024-06-28,9103
6125,廣運,34,0,34,群益金鼎-松山,2024-06-28,9103
6477,安集,46,15,31,群益金鼎-松山,2024-06-28,9103
8064,東捷,66,38,28,群益金鼎-松山,2024-06-28,9103
2520,冠德,25,0,25,群益金鼎-松山,2024-06-28,9103
00706L,期元大S＆P日圓正2,20,0,20,群益金鼎-松山,2024-06-28,9103
2392,正崴,19,0,19,群益金鼎-松山,2024-06-28,9103
2374,佳能,22,4,18,群益金鼎-松山,2024-06-28,9103
3312,弘憶股,27,9,18,群益金鼎-松山,2024-06-28,9103
6161,捷波,15,0,15,群益金鼎-松山,2024-06-28,9103
2618,長榮航,14,0,14,群益金鼎-松山,2024-06-28,9103
3362,先進光,30,18,12,群益金鼎-松山,2024-06-28,9103
3576,聯合再生,13,1,12,群益金鼎-松山,2024-06-28,9103
00919,群益台灣精選高息,11,0,11,群益金鼎-松山,2024-06-28,9103
1795,美時,10,0,10,群益金鼎-松山,2024-06-28,9103
1785,光洋科,10,0,10,群益金鼎-松山,2024-06-28,9103
3041,揚智,10,0,10,群益金鼎-松山,2024-06-28,9103
3520,華盈,10,0,10,群益金鼎-松山,2024-06-28,9103
8473,山林水,10,0,10,群益金鼎-松山,2024-06-28,9103
00929,復華台灣科技優息,9,0,9,群益金鼎-松山,2024-06-28,9103
3583,辛耘,10,1,9,群益金鼎-松山,2024-06-28,9103
8105,凌巨,9,0,9,群益金鼎-松山,2024-06-28,9103
2230,泰茂,8,0,8,群益金鼎-松山,2024-06-28,9103
2301,光寶科,13,5,8,群益金鼎-松山,2024-06-28,9103
5443,均豪,13,5,8,群益金鼎-松山,2024-06-28,9103
6152,百一,8,0,8,群益金鼎-松山,2024-06-28,9103
6806,森崴能源,8,0,8,群益金鼎-松山,2024-06-28,9103
3048,益登,13,6,7,群益金鼎-松山,2024-06-28,9103
3149,正達,7,0,7,群益金鼎-松山,2024-06-28,9103
4533,協易機,16,9,7,群益金鼎-松山,2024-06-28,9103
4561,健椿,6,0,6,群益金鼎-松山,2024-06-28,9103
5347,世界,36,30,6,群益金鼎-松山,2024-06-28,9103
8349,�矬�,10,4,6,群益金鼎-松山,2024-06-28,9103
00931B,統一美債20年,5,0,5,群益金鼎-松山,2024-06-28,9103
00652,富邦印度,5,0,5,群益金鼎-松山,2024-06-28,9103
2201,裕隆,5,0,5,群益金鼎-松山,2024-06-28,9103
2258,鴻華先進-創,5,0,5,群益金鼎-松山,2024-06-28,9103
2303,聯電,5,0,5,群益金鼎-松山,2024-06-28,9103
2363,矽統,5,0,5,群益金鼎-松山,2024-06-28,9103
4967,十銓,5,0,5,群益金鼎-松山,2024-06-28,9103
5439,高技,5,0,5,群益金鼎-松山,2024-06-28,9103
6873,泓德能源,10,5,5,群益金鼎-松山,2024-06-28,9103
8040,九暘,5,0,5,群益金鼎-松山,2024-06-28,9103
00946,群益科技高息成長,223,3,220,群益金鼎-松山,2024-07-01,9103
00680L,元大美債20正2,106,0,106,群益金鼎-松山,2024-07-01,9103
2867,三商壽,100,1,99,群益金鼎-松山,2024-07-01,9103
2316,楠梓電,100,4,96,群益金鼎-松山,2024-07-01,9103
2317,鴻海,78,14,64,群益金鼎-松山,2024-07-01,9103
6625,必應,51,0,51,群益金鼎-松山,2024-07-01,9103
2888,新光金,50,0,50,群益金鼎-松山,2024-07-01,9103
00948B,中信優息投資級債,34,0,34,群益金鼎-松山,2024-07-01,9103
00764B,群益25年美債,30,0,30,群益金鼎-松山,2024-07-01,9103
2501,國建,40,10,30,群益金鼎-松山,2024-07-01,9103
2548,華固,28,0,28,群益金鼎-松山,2024-07-01,9103
3450,聯鈞,38,11,27,群益金鼎-松山,2024-07-01,9103
8383,千附,24,0,24,群益金鼎-松山,2024-07-01,9103
00929,復華台灣科技優息,47,26,21,群益金鼎-松山,2024-07-01,9103
00720B,元大投資級公司債,20,0,20,群益金鼎-松山,2024-07-01,9103
00688L,國泰20年美債正2,20,0,20,群益金鼎-松山,2024-07-01,9103
2031,新光鋼,30,10,20,群益金鼎-松山,2024-07-01,9103
00937B,群益ESG投等債20,19,0,19,群益金鼎-松山,2024-07-01,9103
3402,漢科,25,8,17,群益金鼎-松山,2024-07-01,9103
3624,光頡,19,3,16,群益金鼎-松山,2024-07-01,9103
2359,所羅門,19,4,15,群益金鼎-松山,2024-07-01,9103
1515,力山,15,0,15,群益金鼎-松山,2024-07-01,9103
00687B,國泰20年美債,14,0,14,群益金鼎-松山,2024-07-01,9103
3545,敦泰,12,0,12,群益金鼎-松山,2024-07-01,9103
2367,燿華,17,6,11,群益金鼎-松山,2024-07-01,9103
3051,力特,11,0,11,群益金鼎-松山,2024-07-01,9103
4562,穎漢,14,3,11,群益金鼎-松山,2024-07-01,9103
8085,福華,25,14,11,群益金鼎-松山,2024-07-01,9103
1326,台化,10,0,10,群益金鼎-松山,2024-07-01,9103
00696B,富邦美債20年,10,0,10,群益金鼎-松山,2024-07-01,9103
1513,中興電,15,5,10,群益金鼎-松山,2024-07-01,9103
2349,錸德,10,0,10,群益金鼎-松山,2024-07-01,9103
2539,櫻花建,10,0,10,群益金鼎-松山,2024-07-01,9103
2820,華票,10,0,10,群益金鼎-松山,2024-07-01,9103
3520,華盈,10,0,10,群益金鼎-松山,2024-07-01,9103
8996,高力,9,0,9,群益金鼎-松山,2024-07-01,9103
2369,菱生,9,0,9,群益金鼎-松山,2024-07-01,9103
4909,新復興,12,3,9,群益金鼎-松山,2024-07-01,9103
8064,東捷,62,54,8,群益金鼎-松山,2024-07-01,9103
8048,德勝,8,0,8,群益金鼎-松山,2024-07-01,9103
2313,華通,14,7,7,群益金鼎-松山,2024-07-01,9103
2455,全新,8,1,7,群益金鼎-松山,2024-07-01,9103
1799,易威,6,0,6,群益金鼎-松山,2024-07-01,9103
2882,國泰金,6,0,6,群益金鼎-松山,2024-07-01,9103
3363,上詮,10,4,6,群益金鼎-松山,2024-07-01,9103
4167,松瑞藥,7,1,6,群益金鼎-松山,2024-07-01,9103
5009,榮剛,8,2,6,群益金鼎-松山,2024-07-01,9103
00637L,元大滬深300正2,5,0,5,群益金鼎-松山,2024-07-01,9103
1338,廣華-KY,5,0,5,群益金鼎-松山,2024-07-01,9103
2438,翔耀,5,0,5,群益金鼎-松山,2024-07-01,9103
00664R,國泰臺灣加權反1,200,0,200,群益金鼎-松山,2024-07-02,9103
00680L,元大美債20正2,110,0,110,群益金鼎-松山,2024-07-02,9103
2888,新光金,110,1,109,群益金鼎-松山,2024-07-02,9103
2881,富邦金,108,0,108,群益金鼎-松山,2024-07-02,9103
4123,晟德,91,25,66,群益金鼎-松山,2024-07-02,9103
00946,群益科技高息成長,107,50,57,群益金鼎-松山,2024-07-02,9103
2303,聯電,54,0,54,群益金鼎-松山,2024-07-02,9103
9910,豐泰,50,0,50,群益金鼎-松山,2024-07-02,9103
3702,大聯大,44,4,40,群益金鼎-松山,2024-07-02,9103
2406,國碩,78,40,38,群益金鼎-松山,2024-07-02,9103
2317,鴻海,43,12,31,群益金鼎-松山,2024-07-02,9103
00687B,國泰20年美債,31,0,31,群益金鼎-松山,2024-07-02,9103
6278,台表科,30,3,27,群益金鼎-松山,2024-07-02,9103
2365,昆盈,25,4,21,群益金鼎-松山,2024-07-02,9103
00929,復華台灣科技優息,20,0,20,群益金鼎-松山,2024-07-02,9103
3712,永崴投控,20,0,20,群益金鼎-松山,2024-07-02,9103
2605,新興,22,2,20,群益金鼎-松山,2024-07-02,9103
00934,中信成長高股息,20,1,19,群益金鼎-松山,2024-07-02,9103
6139,亞翔,45,28,17,群益金鼎-松山,2024-07-02,9103
00673R,期元大S＆P原油反1,15,0,15,群益金鼎-松山,2024-07-02,9103
3520,華盈,15,0,15,群益金鼎-松山,2024-07-02,9103
00762,元大全球AI,16,3,13,群益金鼎-松山,2024-07-02,9103
6477,安集,65,52,13,群益金鼎-松山,2024-07-02,9103
1514,亞力,13,1,12,群益金鼎-松山,2024-07-02,9103
6538,倉和,18,7,11,群益金鼎-松山,2024-07-02,9103
00948B,中信優息投資級債,10,0,10,群益金鼎-松山,2024-07-02,9103
00688L,國泰20年美債正2,10,0,10,群益金鼎-松山,2024-07-02,9103
2637,慧洋-KY,10,0,10,群益金鼎-松山,2024-07-02,9103
3219,倚強科,10,0,10,群益金鼎-松山,2024-07-02,9103
4726,永昕,10,0,10,群益金鼎-松山,2024-07-02,9103
6186,新潤,10,0,10,群益金鼎-松山,2024-07-02,9103
8076,伍豐,20,10,10,群益金鼎-松山,2024-07-02,9103
3583,辛耘,13,4,9,群益金鼎-松山,2024-07-02,9103
5289,宜鼎,9,0,9,群益金鼎-松山,2024-07-02,9103
00795B,中信美國公債20年,8,0,8,群益金鼎-松山,2024-07-02,9103
3376,新日興,15,8,7,群益金鼎-松山,2024-07-02,9103
6806,森崴能源,29,22,7,群益金鼎-松山,2024-07-02,9103
6869,雲豹能源,11,5,6,群益金鼎-松山,2024-07-02,9103
2603,長榮,8,2,6,群益金鼎-松山,2024-07-02,9103
3545,敦泰,8,2,6,群益金鼎-松山,2024-07-02,9103
1503,士電,8,2,6,群益金鼎-松山,2024-07-02,9103
2359,所羅門,14,8,6,群益金鼎-松山,2024-07-02,9103
2382,廣達,6,1,5,群益金鼎-松山,2024-07-02,9103
1436,華友聯,5,0,5,群益金鼎-松山,2024-07-02,9103
1338,廣華-KY,5,0,5,群益金鼎-松山,2024-07-02,9103
0052,富邦科技,5,0,5,群益金鼎-松山,2024-07-02,9103
00881,國泰台灣5G+,5,0,5,群益金鼎-松山,2024-07-02,9103
00919,群益台灣精選高息,5,0,5,群益金鼎-松山,2024-07-02,9103
2353,宏��,5,0,5,群益金鼎-松山,2024-07-02,9103
2428,興勤,5,0,5,群益金鼎-松山,2024-07-02,9103
2867,三商壽,300,0,300,群益金鼎-松山,2024-07-03,9103
2323,中環,519,315,204,群益金鼎-松山,2024-07-03,9103
2883,凱基金,210,27,183,群益金鼎-松山,2024-07-03,9103
00680L,元大美債20正2,100,0,100,群益金鼎-松山,2024-07-03,9103
6443,元晶,71,3,68,群益金鼎-松山,2024-07-03,9103
2481,強茂,60,0,60,群益金鼎-松山,2024-07-03,9103
2888,新光金,160,101,59,群益金鼎-松山,2024-07-03,9103
2464,盟立,104,50,54,群益金鼎-松山,2024-07-03,9103
4958,臻鼎-KY,51,0,51,群益金鼎-松山,2024-07-03,9103
1785,光洋科,47,11,36,群益金鼎-松山,2024-07-03,9103
3520,華盈,50,15,35,群益金鼎-松山,2024-07-03,9103
5443,均豪,42,7,35,群益金鼎-松山,2024-07-03,9103
2352,佳世達,32,0,32,群益金鼎-松山,2024-07-03,9103
8028,昇陽半導體,37,11,26,群益金鼎-松山,2024-07-03,9103
3005,神基,26,2,24,群益金鼎-松山,2024-07-03,9103
5525,順天,22,0,22,群益金鼎-松山,2024-07-03,9103
6147,頎邦,21,0,21,群益金鼎-松山,2024-07-03,9103
2601,益航,20,0,20,群益金鼎-松山,2024-07-03,9103
3322,建舜電,20,0,20,群益金鼎-松山,2024-07-03,9103
3297,杭特,20,1,19,群益金鼎-松山,2024-07-03,9103
6244,茂迪,53,34,19,群益金鼎-松山,2024-07-03,9103
3622,洋華,20,2,18,群益金鼎-松山,2024-07-03,9103
6282,康舒,16,0,16,群益金鼎-松山,2024-07-03,9103
2317,鴻海,17,4,13,群益金鼎-松山,2024-07-03,9103
1777,生泰,13,0,13,群益金鼎-松山,2024-07-03,9103
00632R,元大台灣50反1,20,8,12,群益金鼎-松山,2024-07-03,9103
2486,一詮,12,0,12,群益金鼎-松山,2024-07-03,9103
2603,長榮,13,2,11,群益金鼎-松山,2024-07-03,9103
1326,台化,10,0,10,群益金鼎-松山,2024-07-03,9103
00931B,統一美債20年,10,0,10,群益金鼎-松山,2024-07-03,9103
2414,精技,10,0,10,群益金鼎-松山,2024-07-03,9103
2542,興富發,10,0,10,群益金鼎-松山,2024-07-03,9103
6509,聚和,10,0,10,群益金鼎-松山,2024-07-03,9103
2417,圓剛,10,1,9,群益金鼎-松山,2024-07-03,9103
00762,元大全球AI,8,0,8,群益金鼎-松山,2024-07-03,9103
3576,聯合再生,110,102,8,群益金鼎-松山,2024-07-03,9103
8093,保銳,10,2,8,群益金鼎-松山,2024-07-03,9103
5880,合庫金,8,0,8,群益金鼎-松山,2024-07-03,9103
1799,易威,7,0,7,群益金鼎-松山,2024-07-03,9103
3081,聯亞,8,1,7,群益金鼎-松山,2024-07-03,9103
3374,精材,8,1,7,群益金鼎-松山,2024-07-03,9103
3706,神達,6,0,6,群益金鼎-松山,2024-07-03,9103
6117,迎廣,20,14,6,群益金鼎-松山,2024-07-03,9103
1303,南亞,9,4,5,群益金鼎-松山,2024-07-03,9103
00671R,富邦NASDAQ反1,5,0,5,群益金鼎-松山,2024-07-03,9103
2101,南港,5,0,5,群益金鼎-松山,2024-07-03,9103
2609,陽明,7,2,5,群益金鼎-松山,2024-07-03,9103
3234,光環,5,0,5,群益金鼎-松山,2024-07-03,9103
4744,皇將,5,0,5,群益金鼎-松山,2024-07-03,9103
4968,立積,5,0,5,群益金鼎-松山,2024-07-03,9103
2888,新光金,212,2,210,群益金鼎-松山,2024-07-04,9103
2886,兆豐金,102,0,102,群益金鼎-松山,2024-07-04,9103
6538,倉和,102,0,102,群益金鼎-松山,2024-07-04,9103
2312,金寶,51,1,50,群益金鼎-松山,2024-07-04,9103
4934,太極,50,0,50,群益金鼎-松山,2024-07-04,9103
9910,豐泰,50,0,50,群益金鼎-松山,2024-07-04,9103
2439,美律,48,4,44,群益金鼎-松山,2024-07-04,9103
6443,元晶,49,6,43,群益金鼎-松山,2024-07-04,9103
2542,興富發,40,0,40,群益金鼎-松山,2024-07-04,9103
00949,復華日本龍頭,32,0,32,群益金鼎-松山,2024-07-04,9103
6207,雷科,38,6,32,群益金鼎-松山,2024-07-04,9103
00632R,元大台灣50反1,31,0,31,群益金鼎-松山,2024-07-04,9103
00895,富邦未來車,30,0,30,群益金鼎-松山,2024-07-04,9103
00929,復華台灣科技優息,29,0,29,群益金鼎-松山,2024-07-04,9103
3450,聯鈞,39,14,25,群益金鼎-松山,2024-07-04,9103
5608,四維航,23,0,23,群益金鼎-松山,2024-07-04,9103
5443,均豪,21,0,21,群益金鼎-松山,2024-07-04,9103
3059,華晶科,20,0,20,群益金鼎-松山,2024-07-04,9103
3652,精聯,20,0,20,群益金鼎-松山,2024-07-04,9103
3706,神達,20,0,20,群益金鼎-松山,2024-07-04,9103
9945,潤泰新,38,20,18,群益金鼎-松山,2024-07-04,9103
8234,新漢,20,3,17,群益金鼎-松山,2024-07-04,9103
2455,全新,15,0,15,群益金鼎-松山,2024-07-04,9103
8383,千附,15,0,15,群益金鼎-松山,2024-07-04,9103
2313,華通,36,22,14,群益金鼎-松山,2024-07-04,9103
6127,九豪,12,0,12,群益金鼎-松山,2024-07-04,9103
00725B,國泰投資級公司債,11,0,11,群益金鼎-松山,2024-07-04,9103
2467,志聖,17,6,11,群益金鼎-松山,2024-07-04,9103
2486,一詮,29,18,11,群益金鼎-松山,2024-07-04,9103
5351,鈺創,11,0,11,群益金鼎-松山,2024-07-04,9103
6147,頎邦,11,0,11,群益金鼎-松山,2024-07-04,9103
1514,亞力,18,7,11,群益金鼎-松山,2024-07-04,9103
2382,廣達,10,0,10,群益金鼎-松山,2024-07-04,9103
2417,圓剛,22,12,10,群益金鼎-松山,2024-07-04,9103
2485,兆赫,10,0,10,群益金鼎-松山,2024-07-04,9103
3025,星通,10,0,10,群益金鼎-松山,2024-07-04,9103
3163,波若威,10,0,10,群益金鼎-松山,2024-07-04,9103
3322,建舜電,10,0,10,群益金鼎-松山,2024-07-04,9103
6188,廣明,11,1,10,群益金鼎-松山,2024-07-04,9103
8440,綠電,30,20,10,群益金鼎-松山,2024-07-04,9103
1503,士電,13,4,9,群益金鼎-松山,2024-07-04,9103
3189,景碩,17,9,8,群益金鼎-松山,2024-07-04,9103
1436,華友聯,8,0,8,群益金鼎-松山,2024-07-04,9103
1777,生泰,8,0,8,群益金鼎-松山,2024-07-04,9103
2405,輔信,10,2,8,群益金鼎-松山,2024-07-04,9103
4533,協易機,11,3,8,群益金鼎-松山,2024-07-04,9103
4906,正文,10,2,8,群益金鼎-松山,2024-07-04,9103
4967,十銓,8,0,8,群益金鼎-松山,2024-07-04,9103
6125,廣運,10,3,7,群益金鼎-松山,2024-07-04,9103
2412,中華電,6,0,6,群益金鼎-松山,2024-07-04,9103
9105,泰金寶-DR,300,0,300,群益金鼎-松山,2024-07-05,9103
00949,復華日本龍頭,177,0,177,群益金鼎-松山,2024-07-05,9103
3686,達能,60,0,60,群益金鼎-松山,2024-07-05,9103
2486,一詮,55,5,50,群益金鼎-松山,2024-07-05,9103
2312,金寶,50,0,50,群益金鼎-松山,2024-07-05,9103
2363,矽統,64,24,40,群益金鼎-松山,2024-07-05,9103
3027,盛達,30,0,30,群益金鼎-松山,2024-07-05,9103
6477,安集,30,0,30,群益金鼎-松山,2024-07-05,9103
8050,廣積,30,1,29,群益金鼎-松山,2024-07-05,9103
8076,伍豐,30,1,29,群益金鼎-松山,2024-07-05,9103
4526,東台,30,3,27,群益金鼎-松山,2024-07-05,9103
2637,慧洋-KY,26,0,26,群益金鼎-松山,2024-07-05,9103
2455,全新,25,1,24,群益金鼎-松山,2024-07-05,9103
3149,正達,31,7,24,群益金鼎-松山,2024-07-05,9103
6451,訊芯-KY,27,6,21,群益金鼎-松山,2024-07-05,9103
2615,萬海,21,0,21,群益金鼎-松山,2024-07-05,9103
2365,昆盈,25,4,21,群益金鼎-松山,2024-07-05,9103
00679B,元大美債20年,20,0,20,群益金鼎-松山,2024-07-05,9103
2401,凌陽,21,1,20,群益金鼎-松山,2024-07-05,9103
3356,奇偶,20,0,20,群益金鼎-松山,2024-07-05,9103
6213,聯茂,21,2,19,群益金鼎-松山,2024-07-05,9103
2301,光寶科,23,5,18,群益金鼎-松山,2024-07-05,9103
2317,鴻海,18,1,17,群益金鼎-松山,2024-07-05,9103
00878,國泰永續高股息,16,0,16,群益金鼎-松山,2024-07-05,9103
3481,群創,15,0,15,群益金鼎-松山,2024-07-05,9103
6125,廣運,27,12,15,群益金鼎-松山,2024-07-05,9103
1777,生泰,14,0,14,群益金鼎-松山,2024-07-05,9103
2609,陽明,12,0,12,群益金鼎-松山,2024-07-05,9103
1301,台塑,11,0,11,群益金鼎-松山,2024-07-05,9103
2329,華泰,21,10,11,群益金鼎-松山,2024-07-05,9103
2888,新光金,15,4,11,群益金鼎-松山,2024-07-05,9103
8104,錸寶,21,10,11,群益金鼎-松山,2024-07-05,9103
8028,昇陽半導體,13,3,10,群益金鼎-松山,2024-07-05,9103
00857B,永豐20年美公債,10,0,10,群益金鼎-松山,2024-07-05,9103
1802,台玻,10,0,10,群益金鼎-松山,2024-07-05,9103
2324,仁寶,10,0,10,群益金鼎-松山,2024-07-05,9103
2385,群光,10,0,10,群益金鼎-松山,2024-07-05,9103
2641,正德,10,0,10,群益金鼎-松山,2024-07-05,9103
4533,協易機,10,0,10,群益金鼎-松山,2024-07-05,9103
4979,華星光,22,12,10,群益金鼎-松山,2024-07-05,9103
6179,亞通,22,12,10,群益金鼎-松山,2024-07-05,9103
6788,華景電,10,0,10,群益金鼎-松山,2024-07-05,9103
3580,友威科,15,6,9,群益金鼎-松山,2024-07-05,9103
4588,玖鼎電力,10,1,9,群益金鼎-松山,2024-07-05,9103
4968,立積,10,1,9,群益金鼎-松山,2024-07-05,9103
00942B,台新美A公司債20+,8,0,8,群益金鼎-松山,2024-07-05,9103
00881,國泰台灣5G+,8,0,8,群益金鼎-松山,2024-07-05,9103
00665L,富邦�琤肭磪囓�2,8,0,8,群益金鼎-松山,2024-07-05,9103
2405,輔信,14,6,8,群益金鼎-松山,2024-07-05,9103
3702,大聯大,8,0,8,群益金鼎-松山,2024-07-05,9103
2108,南帝,420,1,419,群益金鼎-松山,2024-07-08,9103
6582,申豐,100,0,100,群益金鼎-松山,2024-07-08,9103
9105,泰金寶-DR,400,300,100,群益金鼎-松山,2024-07-08,9103
1513,中興電,87,3,84,群益金鼎-松山,2024-07-08,9103
2352,佳世達,68,7,61,群益金鼎-松山,2024-07-08,9103
2427,三商電,58,0,58,群益金鼎-松山,2024-07-08,9103
2618,長榮航,48,1,47,群益金鼎-松山,2024-07-08,9103
2374,佳能,40,1,39,群益金鼎-松山,2024-07-08,9103
2301,光寶科,61,26,35,群益金鼎-松山,2024-07-08,9103
2392,正崴,32,1,31,群益金鼎-松山,2024-07-08,9103
1314,中石化,200,170,30,群益金鼎-松山,2024-07-08,9103
2634,漢翔,30,0,30,群益金鼎-松山,2024-07-08,9103
3703,欣陸,30,0,30,群益金鼎-松山,2024-07-08,9103
2449,京元電子,35,5,30,群益金鼎-松山,2024-07-08,9103
3374,精材,32,3,29,群益金鼎-松山,2024-07-08,9103
2606,裕民,25,0,25,群益金鼎-松山,2024-07-08,9103
2867,三商壽,22,0,22,群益金鼎-松山,2024-07-08,9103
3535,晶彩科,23,1,22,群益金鼎-松山,2024-07-08,9103
5452,佶優,22,1,21,群益金鼎-松山,2024-07-08,9103
6213,聯茂,22,1,21,群益金鼎-松山,2024-07-08,9103
2637,慧洋-KY,20,0,20,群益金鼎-松山,2024-07-08,9103
6111,大宇資,20,0,20,群益金鼎-松山,2024-07-08,9103
6125,廣運,33,14,19,群益金鼎-松山,2024-07-08,9103
3624,光頡,18,0,18,群益金鼎-松山,2024-07-08,9103
2313,華通,42,24,18,群益金鼎-松山,2024-07-08,9103
8064,東捷,38,21,17,群益金鼎-松山,2024-07-08,9103
00895,富邦未來車,16,0,16,群益金鼎-松山,2024-07-08,9103
00632R,元大台灣50反1,16,0,16,群益金鼎-松山,2024-07-08,9103
8111,立��,16,0,16,群益金鼎-松山,2024-07-08,9103
2383,台光電,15,0,15,群益金鼎-松山,2024-07-08,9103
1718,中纖,15,0,15,群益金鼎-松山,2024-07-08,9103
1736,喬山,16,1,15,群益金鼎-松山,2024-07-08,9103
2365,昆盈,22,7,15,群益金鼎-松山,2024-07-08,9103
1409,新纖,20,6,14,群益金鼎-松山,2024-07-08,9103
00929,復華台灣科技優息,13,0,13,群益金鼎-松山,2024-07-08,9103
3312,弘憶股,15,2,13,群益金鼎-松山,2024-07-08,9103
1709,和益,13,1,12,群益金鼎-松山,2024-07-08,9103
3498,陽程,23,11,12,群益金鼎-松山,2024-07-08,9103
3702,大聯大,12,0,12,群益金鼎-松山,2024-07-08,9103
1618,合機,16,5,11,群益金鼎-松山,2024-07-08,9103
1783,和康生,10,0,10,群益金鼎-松山,2024-07-08,9103
2349,錸德,10,0,10,群益金鼎-松山,2024-07-08,9103
2464,盟立,61,51,10,群益金鼎-松山,2024-07-08,9103
2888,新光金,12,2,10,群益金鼎-松山,2024-07-08,9103
3202,樺晟,10,0,10,群益金鼎-松山,2024-07-08,9103
3527,聚積,10,0,10,群益金鼎-松山,2024-07-08,9103
4562,穎漢,14,4,10,群益金鼎-松山,2024-07-08,9103
3483,力致,11,2,9,群益金鼎-松山,2024-07-08,9103
4543,萬在,20,11,9,群益金鼎-松山,2024-07-08,9103
5309,系統電,9,0,9,群益金鼎-松山,2024-07-08,9103
4716,大立,420,0,420,群益金鼎-松山,2024-07-09,9103
2883,凱基金,411,0,411,群益金鼎-松山,2024-07-09,9103
2349,錸德,313,0,313,群益金鼎-松山,2024-07-09,9103
2867,三商壽,134,1,133,群益金鼎-松山,2024-07-09,9103
5309,系統電,152,33,119,群益金鼎-松山,2024-07-09,9103
2312,金寶,354,254,100,群益金鼎-松山,2024-07-09,9103
6213,聯茂,100,0,100,群益金鼎-松山,2024-07-09,9103
6112,邁達特,84,0,84,群益金鼎-松山,2024-07-09,9103
6218,豪勉,62,0,62,群益金鼎-松山,2024-07-09,9103
00950B,凱基A級公司債,60,0,60,群益金鼎-松山,2024-07-09,9103
1522,堤維西,51,0,51,群益金鼎-松山,2024-07-09,9103
2002,中鋼,51,0,51,群益金鼎-松山,2024-07-09,9103
00946,群益科技高息成長,50,0,50,群益金鼎-松山,2024-07-09,9103
2618,長榮航,50,0,50,群益金鼎-松山,2024-07-09,9103
4123,晟德,50,0,50,群益金鼎-松山,2024-07-09,9103
2520,冠德,38,0,38,群益金鼎-松山,2024-07-09,9103
2405,輔信,91,54,37,群益金鼎-松山,2024-07-09,9103
3029,零壹,31,1,30,群益金鼎-松山,2024-07-09,9103
00896,中信綠能及電動車,22,0,22,群益金鼎-松山,2024-07-09,9103
2356,英業達,22,0,22,群益金鼎-松山,2024-07-09,9103
00937B,群益ESG投等債20,20,0,20,群益金鼎-松山,2024-07-09,9103
2634,漢翔,20,0,20,群益金鼎-松山,2024-07-09,9103
3363,上詮,23,3,20,群益金鼎-松山,2024-07-09,9103
5243,乙盛-KY,21,1,20,群益金鼎-松山,2024-07-09,9103
3013,晟銘電,32,13,19,群益金鼎-松山,2024-07-09,9103
6811,宏�硌穈T,18,0,18,群益金鼎-松山,2024-07-09,9103
1605,華新,17,0,17,群益金鼎-松山,2024-07-09,9103
1785,光洋科,30,13,17,群益金鼎-松山,2024-07-09,9103
2641,正德,17,0,17,群益金鼎-松山,2024-07-09,9103
2609,陽明,16,0,16,群益金鼎-松山,2024-07-09,9103
6806,森崴能源,21,5,16,群益金鼎-松山,2024-07-09,9103
8105,凌巨,17,1,16,群益金鼎-松山,2024-07-09,9103
1101,台泥,15,0,15,群益金鼎-松山,2024-07-09,9103
8111,立��,14,0,14,群益金鼎-松山,2024-07-09,9103
1454,台富,13,0,13,群益金鼎-松山,2024-07-09,9103
2367,燿華,23,11,12,群益金鼎-松山,2024-07-09,9103
2387,精元,12,0,12,群益金鼎-松山,2024-07-09,9103
2537,聯上發,12,0,12,群益金鼎-松山,2024-07-09,9103
00881,國泰台灣5G+,11,0,11,群益金鼎-松山,2024-07-09,9103
3062,建漢,11,1,10,群益金鼎-松山,2024-07-09,9103
1217,愛之味,10,0,10,群益金鼎-松山,2024-07-09,9103
1802,台玻,10,0,10,群益金鼎-松山,2024-07-09,9103
2323,中環,10,0,10,群益金鼎-松山,2024-07-09,9103
2353,宏��,10,0,10,群益金鼎-松山,2024-07-09,9103
2392,正崴,31,21,10,群益金鼎-松山,2024-07-09,9103
2485,兆赫,10,0,10,群益金鼎-松山,2024-07-09,9103
2606,裕民,10,0,10,群益金鼎-松山,2024-07-09,9103
3537,堡達,50,40,10,群益金鼎-松山,2024-07-09,9103
2352,佳世達,9,0,9,群益金鼎-松山,2024-07-09,9103
3481,群創,112,103,9,群益金鼎-松山,2024-07-09,9103
2867,三商壽,675,106,569,群益金鼎-松山,2024-07-10,9103
00949,復華日本龍頭,288,0,288,群益金鼎-松山,2024-07-10,9103
2888,新光金,302,117,185,群益金鼎-松山,2024-07-10,9103
00950B,凱基A級公司債,156,0,156,群益金鼎-松山,2024-07-10,9103
00947,台新臺灣IC設計,150,0,150,群益金鼎-松山,2024-07-10,9103
2542,興富發,120,2,118,群益金鼎-松山,2024-07-10,9103
00929,復華台灣科技優息,103,0,103,群益金鼎-松山,2024-07-10,9103
00937B,群益ESG投等債20,101,0,101,群益金鼎-松山,2024-07-10,9103
2108,南帝,101,1,100,群益金鼎-松山,2024-07-10,9103
6164,華興,100,0,100,群益金鼎-松山,2024-07-10,9103
6187,萬潤,102,8,94,群益金鼎-松山,2024-07-10,9103
6177,達麗,60,1,59,群益金鼎-松山,2024-07-10,9103
3363,上詮,48,6,42,群益金鼎-松山,2024-07-10,9103
00895,富邦未來車,35,0,35,群益金鼎-松山,2024-07-10,9103
2353,宏��,43,9,34,群益金鼎-松山,2024-07-10,9103
5475,德宏,30,0,30,群益金鼎-松山,2024-07-10,9103
2618,長榮航,33,4,29,群益金鼎-松山,2024-07-10,9103
1522,堤維西,30,1,29,群益金鼎-松山,2024-07-10,9103
2489,瑞軒,23,0,23,群益金鼎-松山,2024-07-10,9103
2745,五福,24,1,23,群益金鼎-松山,2024-07-10,9103
8440,綠電,23,0,23,群益金鼎-松山,2024-07-10,9103
2537,聯上發,20,1,19,群益金鼎-松山,2024-07-10,9103
5443,均豪,22,5,17,群益金鼎-松山,2024-07-10,9103
00762,元大全球AI,16,0,16,群益金鼎-松山,2024-07-10,9103
2453,凌群,14,0,14,群益金鼎-松山,2024-07-10,9103
1618,合機,14,1,13,群益金鼎-松山,2024-07-10,9103
2316,楠梓電,13,0,13,群益金鼎-松山,2024-07-10,9103
6139,亞翔,15,3,12,群益金鼎-松山,2024-07-10,9103
2101,南港,12,0,12,群益金鼎-松山,2024-07-10,9103
2359,所羅門,33,21,12,群益金鼎-松山,2024-07-10,9103
1785,光洋科,44,34,10,群益金鼎-松山,2024-07-10,9103
4588,玖鼎電力,10,0,10,群益金鼎-松山,2024-07-10,9103
2323,中環,10,0,10,群益金鼎-松山,2024-07-10,9103
2509,全坤建,10,0,10,群益金鼎-松山,2024-07-10,9103
2637,慧洋-KY,10,0,10,群益金鼎-松山,2024-07-10,9103
2888A,新光金甲特,10,0,10,群益金鼎-松山,2024-07-10,9103
3019,亞光,20,10,10,群益金鼎-松山,2024-07-10,9103
3059,華晶科,10,0,10,群益金鼎-松山,2024-07-10,9103
3535,晶彩科,10,0,10,群益金鼎-松山,2024-07-10,9103
4563,百德,10,0,10,群益金鼎-松山,2024-07-10,9103
4976,佳凌,10,0,10,群益金鼎-松山,2024-07-10,9103
6605,帝寶,10,0,10,群益金鼎-松山,2024-07-10,9103
8050,廣積,10,0,10,群益金鼎-松山,2024-07-10,9103
8358,金居,11,1,10,群益金鼎-松山,2024-07-10,9103
5876,上海商銀,9,0,9,群益金鼎-松山,2024-07-10,9103
2609,陽明,9,0,9,群益金鼎-松山,2024-07-10,9103
00881,國泰台灣5G+,8,0,8,群益金鼎-松山,2024-07-10,9103
2891,中信金,8,0,8,群益金鼎-松山,2024-07-10,9103
3673,TPK-KY,8,0,8,群益金鼎-松山,2024-07-10,9103
5439,高技,8,0,8,群益金鼎-松山,2024-07-10,9103
9105,泰金寶-DR,700,200,500,群益金鼎-松山,2024-07-11,9103
00946,群益科技高息成長,193,9,184,群益金鼎-松山,2024-07-11,9103
00650L,復華香港正2,100,0,100,群益金鼎-松山,2024-07-11,9103
00936,台新永續高息中小,82,0,82,群益金鼎-松山,2024-07-11,9103
00950B,凱基A級公司債,80,0,80,群益金鼎-松山,2024-07-11,9103
2520,冠德,63,0,63,群益金鼎-松山,2024-07-11,9103
2356,英業達,62,4,58,群益金鼎-松山,2024-07-11,9103
00944,野村趨勢動能高息,57,1,56,群益金鼎-松山,2024-07-11,9103
2349,錸德,58,6,52,群益金鼎-松山,2024-07-11,9103
6625,必應,52,0,52,群益金鼎-松山,2024-07-11,9103
3363,上詮,56,5,51,群益金鼎-松山,2024-07-11,9103
2002,中鋼,50,0,50,群益金鼎-松山,2024-07-11,9103
6770,力積電,50,0,50,群益金鼎-松山,2024-07-11,9103
8084,巨虹,56,10,46,群益金鼎-松山,2024-07-11,9103
00919,群益台灣精選高息,42,1,41,群益金鼎-松山,2024-07-11,9103
8050,廣積,40,0,40,群益金鼎-松山,2024-07-11,9103
2303,聯電,30,0,30,群益金鼎-松山,2024-07-11,9103
2615,萬海,30,0,30,群益金鼎-松山,2024-07-11,9103
00929,復華台灣科技優息,30,2,28,群益金鼎-松山,2024-07-11,9103
4716,大立,26,0,26,群益金鼎-松山,2024-07-11,9103
8064,東捷,46,23,23,群益金鼎-松山,2024-07-11,9103
4958,臻鼎-KY,22,0,22,群益金鼎-松山,2024-07-11,9103
1319,東陽,20,0,20,群益金鼎-松山,2024-07-11,9103
1432,大魯閣,20,0,20,群益金鼎-松山,2024-07-11,9103
00895,富邦未來車,20,0,20,群益金鼎-松山,2024-07-11,9103
00943,兆豐電子高息等權,20,0,20,群益金鼎-松山,2024-07-11,9103
5452,佶優,20,0,20,群益金鼎-松山,2024-07-11,9103
9919,康那香,20,0,20,群益金鼎-松山,2024-07-11,9103
6112,邁達特,20,1,19,群益金鼎-松山,2024-07-11,9103
2323,中環,15,0,15,群益金鼎-松山,2024-07-11,9103
6126,信音,15,0,15,群益金鼎-松山,2024-07-11,9103
2365,昆盈,55,41,14,群益金鼎-松山,2024-07-11,9103
2374,佳能,14,0,14,群益金鼎-松山,2024-07-11,9103
1568,倉佑,13,0,13,群益金鼎-松山,2024-07-11,9103
2308,台達電,15,3,12,群益金鼎-松山,2024-07-11,9103
2489,瑞軒,20,8,12,群益金鼎-松山,2024-07-11,9103
4927,泰鼎-KY,12,0,12,群益金鼎-松山,2024-07-11,9103
3312,弘憶股,23,12,11,群益金鼎-松山,2024-07-11,9103
2312,金寶,10,0,10,群益金鼎-松山,2024-07-11,9103
2395,研華,10,0,10,群益金鼎-松山,2024-07-11,9103
2539,櫻花建,10,0,10,群益金鼎-松山,2024-07-11,9103
2545,皇翔,10,0,10,群益金鼎-松山,2024-07-11,9103
2603,長榮,10,0,10,群益金鼎-松山,2024-07-11,9103
2618,長榮航,10,0,10,群益金鼎-松山,2024-07-11,9103
3535,晶彩科,10,0,10,群益金鼎-松山,2024-07-11,9103
5243,乙盛-KY,10,0,10,群益金鼎-松山,2024-07-11,9103
8011,台通,10,0,10,群益金鼎-松山,2024-07-11,9103
2409,友達,10,1,9,群益金鼎-松山,2024-07-11,9103
1785,光洋科,11,2,9,群益金鼎-松山,2024-07-11,9103
2352,佳世達,16,7,9,群益金鼎-松山,2024-07-11,9103
2867,三商壽,910,701,209,群益金鼎-松山,2024-07-12,9103
3481,群創,600,416,184,群益金鼎-松山,2024-07-12,9103
00949,復華日本龍頭,129,0,129,群益金鼎-松山,2024-07-12,9103
3673,TPK-KY,118,0,118,群益金鼎-松山,2024-07-12,9103
6116,彩晶,200,100,100,群益金鼎-松山,2024-07-12,9103
2312,金寶,277,194,83,群益金鼎-松山,2024-07-12,9103
00929,復華台灣科技優息,80,1,79,群益金鼎-松山,2024-07-12,9103
00946,群益科技高息成長,78,0,78,群益金鼎-松山,2024-07-12,9103
00919,群益台灣精選高息,73,0,73,群益金鼎-松山,2024-07-12,9103
1809,中釉,72,0,72,群益金鼎-松山,2024-07-12,9103
2349,錸德,76,6,70,群益金鼎-松山,2024-07-12,9103
3686,達能,70,0,70,群益金鼎-松山,2024-07-12,9103
3711,日月光投控,47,0,47,群益金鼎-松山,2024-07-12,9103
3037,欣興,47,8,39,群益金鼎-松山,2024-07-12,9103
00936,台新永續高息中小,38,0,38,群益金鼎-松山,2024-07-12,9103
6219,富旺,35,0,35,群益金鼎-松山,2024-07-12,9103
2330,台積電,54,20,34,群益金鼎-松山,2024-07-12,9103
2317,鴻海,42,8,34,群益金鼎-松山,2024-07-12,9103
6443,元晶,31,0,31,群益金鼎-松山,2024-07-12,9103
3624,光頡,26,1,25,群益金鼎-松山,2024-07-12,9103
3013,晟銘電,37,15,22,群益金鼎-松山,2024-07-12,9103
3048,益登,22,1,21,群益金鼎-松山,2024-07-12,9103
8105,凌巨,25,4,21,群益金鼎-松山,2024-07-12,9103
3047,訊舟,53,33,20,群益金鼎-松山,2024-07-12,9103
3498,陽程,20,0,20,群益金鼎-松山,2024-07-12,9103
3652,精聯,50,30,20,群益金鼎-松山,2024-07-12,9103
8084,巨虹,20,0,20,群益金鼎-松山,2024-07-12,9103
4562,穎漢,57,41,16,群益金鼎-松山,2024-07-12,9103
0056,元大高股息,15,0,15,群益金鼎-松山,2024-07-12,9103
00927,群益半導體收益,13,0,13,群益金鼎-松山,2024-07-12,9103
2313,華通,15,2,13,群益金鼎-松山,2024-07-12,9103
2455,全新,15,2,13,群益金鼎-松山,2024-07-12,9103
4109,加捷生醫,11,0,11,群益金鼎-松山,2024-07-12,9103
6788,華景電,10,0,10,群益金鼎-松山,2024-07-12,9103
00944,野村趨勢動能高息,10,0,10,群益金鼎-松山,2024-07-12,9103
00934,中信成長高股息,10,0,10,群益金鼎-松山,2024-07-12,9103
00680L,元大美債20正2,10,0,10,群益金鼎-松山,2024-07-12,9103
00706L,期元大S＆P日圓正2,20,10,10,群益金鼎-松山,2024-07-12,9103
2337,旺宏,10,0,10,群益金鼎-松山,2024-07-12,9103
2606,裕民,10,0,10,群益金鼎-松山,2024-07-12,9103
5225,東科-KY,10,0,10,群益金鼎-松山,2024-07-12,9103
5443,均豪,10,0,10,群益金鼎-松山,2024-07-12,9103
5484,慧友,10,0,10,群益金鼎-松山,2024-07-12,9103
6226,光鼎,10,0,10,群益金鼎-松山,2024-07-12,9103
8249,菱光,10,0,10,群益金鼎-松山,2024-07-12,9103
8462,柏文,10,0,10,群益金鼎-松山,2024-07-12,9103
2464,盟立,77,68,9,群益金鼎-松山,2024-07-12,9103
4721,美琪瑪,9,0,9,群益金鼎-松山,2024-07-12,9103
2609,陽明,8,0,8,群益金鼎-松山,2024-07-12,9103
3036,文曄,8,0,8,群益金鼎-松山,2024-07-12,9103
2888,新光金,327,7,320,群益金鼎-松山,2024-07-15,9103
2538,基泰,200,0,200,群益金鼎-松山,2024-07-15,9103
9945,潤泰新,220,33,187,群益金鼎-松山,2024-07-15,9103
2489,瑞軒,207,22,185,群益金鼎-松山,2024-07-15,9103
2349,錸德,155,20,135,群益金鼎-松山,2024-07-15,9103
2002,中鋼,100,0,100,群益金鼎-松山,2024-07-15,9103
00945B,凱基美國非投等債,96,0,96,群益金鼎-松山,2024-07-15,9103
00680L,元大美債20正2,75,0,75,群益金鼎-松山,2024-07-15,9103
6177,達麗,60,1,59,群益金鼎-松山,2024-07-15,9103
00929,復華台灣科技優息,60,4,56,群益金鼎-松山,2024-07-15,9103
1326,台化,50,0,50,群益金鼎-松山,2024-07-15,9103
2834,臺企銀,50,0,50,群益金鼎-松山,2024-07-15,9103
4906,正文,50,0,50,群益金鼎-松山,2024-07-15,9103
3022,威強電,36,1,35,群益金鼎-松山,2024-07-15,9103
1721,三晃,32,0,32,群益金鼎-松山,2024-07-15,9103
2545,皇翔,30,0,30,群益金鼎-松山,2024-07-15,9103
1304,台聚,22,0,22,群益金鼎-松山,2024-07-15,9103
3535,晶彩科,24,2,22,群益金鼎-松山,2024-07-15,9103
2399,映泰,21,0,21,群益金鼎-松山,2024-07-15,9103
2891,中信金,33,12,21,群益金鼎-松山,2024-07-15,9103
6111,大宇資,20,0,20,群益金鼎-松山,2024-07-15,9103
0056,元大高股息,18,0,18,群益金鼎-松山,2024-07-15,9103
3624,光頡,18,0,18,群益金鼎-松山,2024-07-15,9103
8433,弘帆,16,0,16,群益金鼎-松山,2024-07-15,9103
6139,亞翔,17,2,15,群益金鼎-松山,2024-07-15,9103
4909,新復興,20,5,15,群益金鼎-松山,2024-07-15,9103
1608,華榮,14,0,14,群益金鼎-松山,2024-07-15,9103
00919,群益台灣精選高息,12,0,12,群益金鼎-松山,2024-07-15,9103
1309,台達化,12,0,12,群益金鼎-松山,2024-07-15,9103
00679B,元大美債20年,251,240,11,群益金鼎-松山,2024-07-15,9103
00688L,國泰20年美債正2,11,0,11,群益金鼎-松山,2024-07-15,9103
3581,博磊,22,11,11,群益金鼎-松山,2024-07-15,9103
5439,高技,11,0,11,群益金鼎-松山,2024-07-15,9103
6147,頎邦,11,0,11,群益金鼎-松山,2024-07-15,9103
00720B,元大投資級公司債,10,0,10,群益金鼎-松山,2024-07-15,9103
1503,士電,12,2,10,群益金鼎-松山,2024-07-15,9103
2397,友通,10,0,10,群益金鼎-松山,2024-07-15,9103
2886,兆豐金,10,0,10,群益金鼎-松山,2024-07-15,9103
3047,訊舟,50,40,10,群益金鼎-松山,2024-07-15,9103
3289,宜特,10,0,10,群益金鼎-松山,2024-07-15,9103
4168,醣聯,10,0,10,群益金鼎-松山,2024-07-15,9103
6164,華興,10,0,10,群益金鼎-松山,2024-07-15,9103
6625,必應,10,0,10,群益金鼎-松山,2024-07-15,9103
8421,旭源,10,0,10,群益金鼎-松山,2024-07-15,9103
2405,輔信,9,0,9,群益金鼎-松山,2024-07-15,9103
2881,富邦金,9,0,9,群益金鼎-松山,2024-07-15,9103
3055,蔚華科,14,5,9,群益金鼎-松山,2024-07-15,9103
3163,波若威,12,3,9,群益金鼎-松山,2024-07-15,9103
3663,鑫科,11,2,9,群益金鼎-松山,2024-07-15,9103
1802,台玻,8,0,8,群益金鼎-松山,2024-07-15,9103
2317,鴻海,89,5,84,群益金鼎-松山,2024-07-16,9103
00929,復華台灣科技優息,63,0,63,群益金鼎-松山,2024-07-16,9103
4123,晟德,41,0,41,群益金鼎-松山,2024-07-16,9103
2027,大成鋼,40,0,40,群益金鼎-松山,2024-07-16,9103
1513,中興電,72,34,38,群益金鼎-松山,2024-07-16,9103
8054,安國,34,0,34,群益金鼎-松山,2024-07-16,9103
2356,英業達,23,2,21,群益金鼎-松山,2024-07-16,9103
5328,華容,81,60,21,群益金鼎-松山,2024-07-16,9103
5443,均豪,24,3,21,群益金鼎-松山,2024-07-16,9103
3234,光環,20,0,20,群益金鼎-松山,2024-07-16,9103
2486,一詮,20,0,20,群益金鼎-松山,2024-07-16,9103
3535,晶彩科,20,2,18,群益金鼎-松山,2024-07-16,9103
5263,智崴,18,0,18,群益金鼎-松山,2024-07-16,9103
3013,晟銘電,16,1,15,群益金鼎-松山,2024-07-16,9103
6658,聯策,15,0,15,群益金鼎-松山,2024-07-16,9103
2409,友達,14,0,14,群益金鼎-松山,2024-07-16,9103
2455,全新,12,0,12,群益金鼎-松山,2024-07-16,9103
3708,上緯投控,12,0,12,群益金鼎-松山,2024-07-16,9103
1514,亞力,14,3,11,群益金鼎-松山,2024-07-16,9103
2495,普安,11,0,11,群益金鼎-松山,2024-07-16,9103
2891,中信金,11,0,11,群益金鼎-松山,2024-07-16,9103
8011,台通,11,0,11,群益金鼎-松山,2024-07-16,9103
00934,中信成長高股息,11,0,11,群益金鼎-松山,2024-07-16,9103
00949,復華日本龍頭,10,0,10,群益金鼎-松山,2024-07-16,9103
1436,華友聯,10,0,10,群益金鼎-松山,2024-07-16,9103
2609,陽明,10,0,10,群益金鼎-松山,2024-07-16,9103
6226,光鼎,10,0,10,群益金鼎-松山,2024-07-16,9103
00665L,富邦�琤肭磪囓�2,9,0,9,群益金鼎-松山,2024-07-16,9103
3231,緯創,26,17,9,群益金鼎-松山,2024-07-16,9103
8227,巨有科技,9,0,9,群益金鼎-松山,2024-07-16,9103
2465,麗臺,13,5,8,群益金鼎-松山,2024-07-16,9103
3036,文曄,8,0,8,群益金鼎-松山,2024-07-16,9103
5310,天剛,8,0,8,群益金鼎-松山,2024-07-16,9103
8433,弘帆,8,0,8,群益金鼎-松山,2024-07-16,9103
2303,聯電,10,3,7,群益金鼎-松山,2024-07-16,9103
2405,輔信,7,0,7,群益金鼎-松山,2024-07-16,9103
0056,元大高股息,6,0,6,群益金鼎-松山,2024-07-16,9103
2301,光寶科,7,1,6,群益金鼎-松山,2024-07-16,9103
2367,燿華,7,1,6,群益金鼎-松山,2024-07-16,9103
3025,星通,6,0,6,群益金鼎-松山,2024-07-16,9103
5876,上海商銀,14,8,6,群益金鼎-松山,2024-07-16,9103
6005,群益證,6,0,6,群益金鼎-松山,2024-07-16,9103
2363,矽統,7,1,6,群益金鼎-松山,2024-07-16,9103
00919,群益台灣精選高息,6,1,5,群益金鼎-松山,2024-07-16,9103
2342,茂矽,5,0,5,群益金鼎-松山,2024-07-16,9103
1447,力鵬,5,0,5,群益金鼎-松山,2024-07-16,9103
00725B,國泰投資級公司債,5,0,5,群益金鼎-松山,2024-07-16,9103
00650L,復華香港正2,5,0,5,群益金鼎-松山,2024-07-16,9103
2302,麗正,5,0,5,群益金鼎-松山,2024-07-16,9103
2312,金寶,7,2,5,群益金鼎-松山,2024-07-16,9103
2888,新光金,802,1,801,群益金鼎-松山,2024-07-17,9103
2883,凱基金,300,3,297,群益金鼎-松山,2024-07-17,9103
2409,友達,200,0,200,群益金鼎-松山,2024-07-17,9103
8936,國統,92,7,85,群益金鼎-松山,2024-07-17,9103
00933B,國泰10Y+金融債,70,0,70,群益金鼎-松山,2024-07-17,9103
4960,誠美材,51,0,51,群益金鼎-松山,2024-07-17,9103
00946,群益科技高息成長,50,0,50,群益金鼎-松山,2024-07-17,9103
2882,國泰金,50,1,49,群益金鼎-松山,2024-07-17,9103
3711,日月光投控,46,3,43,群益金鼎-松山,2024-07-17,9103
2330,台積電,44,2,42,群益金鼎-松山,2024-07-17,9103
6125,廣運,43,7,36,群益金鼎-松山,2024-07-17,9103
00929,復華台灣科技優息,34,0,34,群益金鼎-松山,2024-07-17,9103
2405,輔信,30,0,30,群益金鼎-松山,2024-07-17,9103
5876,上海商銀,30,0,30,群益金鼎-松山,2024-07-17,9103
00919,群益台灣精選高息,28,0,28,群益金鼎-松山,2024-07-17,9103
2317,鴻海,66,38,28,群益金鼎-松山,2024-07-17,9103
2464,盟立,38,11,27,群益金鼎-松山,2024-07-17,9103
2497,怡利電,30,5,25,群益金鼎-松山,2024-07-17,9103
1319,東陽,20,0,20,群益金鼎-松山,2024-07-17,9103
1513,中興電,21,3,18,群益金鼎-松山,2024-07-17,9103
4958,臻鼎-KY,44,26,18,群益金鼎-松山,2024-07-17,9103
4967,十銓,21,3,18,群益金鼎-松山,2024-07-17,9103
2542,興富發,16,0,16,群益金鼎-松山,2024-07-17,9103
3047,訊舟,16,1,15,群益金鼎-松山,2024-07-17,9103
2449,京元電子,15,1,14,群益金鼎-松山,2024-07-17,9103
3005,神基,14,0,14,群益金鼎-松山,2024-07-17,9103
3312,弘憶股,15,1,14,群益金鼎-松山,2024-07-17,9103
3702,大聯大,13,0,13,群益金鼎-松山,2024-07-17,9103
00896,中信綠能及電動車,12,0,12,群益金鼎-松山,2024-07-17,9103
2501,國建,43,31,12,群益金鼎-松山,2024-07-17,9103
4566,時碩工業,14,2,12,群益金鼎-松山,2024-07-17,9103
4906,正文,12,1,11,群益金鼎-松山,2024-07-17,9103
5522,遠雄,11,0,11,群益金鼎-松山,2024-07-17,9103
00934,中信成長高股息,10,0,10,群益金鼎-松山,2024-07-17,9103
00937B,群益ESG投等債20,10,0,10,群益金鼎-松山,2024-07-17,9103
00894,中信小資高價30,10,0,10,群益金鼎-松山,2024-07-17,9103
1784,訊聯,15,5,10,群益金鼎-松山,2024-07-17,9103
2539,櫻花建,10,0,10,群益金鼎-松山,2024-07-17,9103
3535,晶彩科,21,11,10,群益金鼎-松山,2024-07-17,9103
3624,光頡,10,0,10,群益金鼎-松山,2024-07-17,9103
4562,穎漢,40,30,10,群益金鼎-松山,2024-07-17,9103
5213,亞昕,10,0,10,群益金鼎-松山,2024-07-17,9103
5484,慧友,10,0,10,群益金鼎-松山,2024-07-17,9103
6658,聯策,10,0,10,群益金鼎-松山,2024-07-17,9103
6684,安格,12,2,10,群益金鼎-松山,2024-07-17,9103
8104,錸寶,10,0,10,群益金鼎-松山,2024-07-17,9103
1609,大亞,29,20,9,群益金鼎-松山,2024-07-17,9103
2383,台光電,9,0,9,群益金鼎-松山,2024-07-17,9103
3062,建漢,11,2,9,群益金鼎-松山,2024-07-17,9103
2241,艾姆勒,8,0,8,群益金鼎-松山,2024-07-17,9103
1513,中興電,356,0,356,群益金鼎-松山,2024-07-18,9103
00933B,國泰10Y+金融債,70,0,70,群益金鼎-松山,2024-07-18,9103
2528,皇普,60,0,60,群益金鼎-松山,2024-07-18,9103
00830,國泰費城半導體,62,5,57,群益金鼎-松山,2024-07-18,9103
2520,冠德,117,67,50,群益金鼎-松山,2024-07-18,9103
2524,京城,42,0,42,群益金鼎-松山,2024-07-18,9103
2317,鴻海,58,17,41,群益金鼎-松山,2024-07-18,9103
2330,台積電,56,24,32,群益金鼎-松山,2024-07-18,9103
5213,亞昕,36,5,31,群益金鼎-松山,2024-07-18,9103
1721,三晃,30,2,28,群益金鼎-松山,2024-07-18,9103
2362,藍天,57,30,27,群益金鼎-松山,2024-07-18,9103
5876,上海商銀,26,0,26,群益金鼎-松山,2024-07-18,9103
2453,凌群,25,0,25,群益金鼎-松山,2024-07-18,9103
3689,湧德,25,2,23,群益金鼎-松山,2024-07-18,9103
1442,名軒,20,0,20,群益金鼎-松山,2024-07-18,9103
2312,金寶,100,81,19,群益金鼎-松山,2024-07-18,9103
0056,元大高股息,17,0,17,群益金鼎-松山,2024-07-18,9103
00946,群益科技高息成長,16,0,16,群益金鼎-松山,2024-07-18,9103
3013,晟銘電,29,13,16,群益金鼎-松山,2024-07-18,9103
6770,力積電,23,8,15,群益金鼎-松山,2024-07-18,9103
1785,光洋科,36,23,13,群益金鼎-松山,2024-07-18,9103
1319,東陽,12,0,12,群益金鼎-松山,2024-07-18,9103
2548,華固,12,0,12,群益金鼎-松山,2024-07-18,9103
5452,佶優,12,0,12,群益金鼎-松山,2024-07-18,9103
00751B,元大AAA至A公司債,11,0,11,群益金鼎-松山,2024-07-18,9103
2365,昆盈,96,85,11,群益金鼎-松山,2024-07-18,9103
2489,瑞軒,16,5,11,群益金鼎-松山,2024-07-18,9103
3062,建漢,14,3,11,群益金鼎-松山,2024-07-18,9103
6462,神盾,28,18,10,群益金鼎-松山,2024-07-18,9103
00945B,凱基美國非投等債,10,0,10,群益金鼎-松山,2024-07-18,9103
00706L,期元大S＆P日圓正2,30,20,10,群益金鼎-松山,2024-07-18,9103
2867,三商壽,10,0,10,群益金鼎-松山,2024-07-18,9103
6869,雲豹能源,15,5,10,群益金鼎-松山,2024-07-18,9103
912000,晨訊科-DR,10,0,10,群益金鼎-松山,2024-07-18,9103
9904,寶成,30,20,10,群益金鼎-松山,2024-07-18,9103
3037,欣興,39,30,9,群益金鼎-松山,2024-07-18,9103
00878,國泰永續高股息,9,0,9,群益金鼎-松山,2024-07-18,9103
00713,元大台灣高息低波,9,0,9,群益金鼎-松山,2024-07-18,9103
1102,亞泥,9,0,9,群益金鼎-松山,2024-07-18,9103
2540,愛山林,14,5,9,群益金鼎-松山,2024-07-18,9103
00934,中信成長高股息,8,0,8,群益金鼎-松山,2024-07-18,9103
1611,中電,9,2,7,群益金鼎-松山,2024-07-18,9103
2348,海悅,18,11,7,群益金鼎-松山,2024-07-18,9103
2382,廣達,12,6,6,群益金鼎-松山,2024-07-18,9103
2250,IKKA-KY,6,0,6,群益金鼎-松山,2024-07-18,9103
6130,上亞科技,6,0,6,群益金鼎-松山,2024-07-18,9103
6488,環球晶,6,0,6,群益金鼎-松山,2024-07-18,9103
3374,精材,5,0,5,群益金鼎-松山,2024-07-18,9103
00949,復華日本龍頭,5,0,5,群益金鼎-松山,2024-07-18,9103
1815,富喬,6,1,5,群益金鼎-松山,2024-07-18,9103
5309,系統電,151,3,148,群益金鼎-松山,2024-07-19,9103
2349,錸德,100,30,70,群益金鼎-松山,2024-07-19,9103
2603,長榮,57,0,57,群益金鼎-松山,2024-07-19,9103
2524,京城,42,0,42,群益金鼎-松山,2024-07-19,9103
00919,群益台灣精選高息,40,0,40,群益金鼎-松山,2024-07-19,9103
5443,均豪,56,19,37,群益金鼎-松山,2024-07-19,9103
3015,全漢,31,0,31,群益金鼎-松山,2024-07-19,9103
00939,統一台灣高息動能,25,0,25,群益金鼎-松山,2024-07-19,9103
8104,錸寶,35,10,25,群益金鼎-松山,2024-07-19,9103
00665L,富邦�琤肭磪囓�2,24,0,24,群益金鼎-松山,2024-07-19,9103
4588,玖鼎電力,21,0,21,群益金鼎-松山,2024-07-19,9103
5512,力麒,21,0,21,群益金鼎-松山,2024-07-19,9103
2330,台積電,38,18,20,群益金鼎-松山,2024-07-19,9103
1513,中興電,110,91,19,群益金鼎-松山,2024-07-19,9103
5263,智崴,18,0,18,群益金鼎-松山,2024-07-19,9103
2542,興富發,20,4,16,群益金鼎-松山,2024-07-19,9103
00945B,凱基美國非投等債,15,0,15,群益金鼎-松山,2024-07-19,9103
00687B,國泰20年美債,16,1,15,群益金鼎-松山,2024-07-19,9103
2323,中環,15,0,15,群益金鼎-松山,2024-07-19,9103
2610,華航,15,0,15,群益金鼎-松山,2024-07-19,9103
2915,潤泰全,15,0,15,群益金鼎-松山,2024-07-19,9103
4534,慶騰,15,0,15,群益金鼎-松山,2024-07-19,9103
4564,元翎,15,0,15,群益金鼎-松山,2024-07-19,9103
00929,復華台灣科技優息,24,10,14,群益金鼎-松山,2024-07-19,9103
2520,冠德,24,10,14,群益金鼎-松山,2024-07-19,9103
2884,玉山金,20,6,14,群益金鼎-松山,2024-07-19,9103
0056,元大高股息,13,0,13,群益金鼎-松山,2024-07-19,9103
00940,元大台灣價值高息,14,2,12,群益金鼎-松山,2024-07-19,9103
2834,臺企銀,16,4,12,群益金鼎-松山,2024-07-19,9103
1709,和益,25,13,12,群益金鼎-松山,2024-07-19,9103
1514,亞力,15,4,11,群益金鼎-松山,2024-07-19,9103
2337,旺宏,11,0,11,群益金鼎-松山,2024-07-19,9103
6806,森崴能源,24,13,11,群益金鼎-松山,2024-07-19,9103
2371,大同,10,0,10,群益金鼎-松山,2024-07-19,9103
1314,中石化,10,0,10,群益金鼎-松山,2024-07-19,9103
00949,復華日本龍頭,10,0,10,群益金鼎-松山,2024-07-19,9103
2485,兆赫,10,0,10,群益金鼎-松山,2024-07-19,9103
4927,泰鼎-KY,10,0,10,群益金鼎-松山,2024-07-19,9103
6227,茂綸,10,0,10,群益金鼎-松山,2024-07-19,9103
5876,上海商銀,9,0,9,群益金鼎-松山,2024-07-19,9103
2356,英業達,9,0,9,群益金鼎-松山,2024-07-19,9103
2338,光罩,8,0,8,群益金鼎-松山,2024-07-19,9103
6462,神盾,17,9,8,群益金鼎-松山,2024-07-19,9103
6625,必應,8,0,8,群益金鼎-松山,2024-07-19,9103
9945,潤泰新,10,2,8,群益金鼎-松山,2024-07-19,9103
2538,基泰,6,0,6,群益金鼎-松山,2024-07-19,9103
3231,緯創,7,1,6,群益金鼎-松山,2024-07-19,9103
3481,群創,14,8,6,群益金鼎-松山,2024-07-19,9103
3518,柏騰,7,1,6,群益金鼎-松山,2024-07-19,9103
3702,大聯大,6,0,6,群益金鼎-松山,2024-07-19,9103
3481,群創,221,3,218,群益金鼎-松山,2024-07-22,9103
6147,頎邦,100,0,100,群益金鼎-松山,2024-07-22,9103
00712,復華富時不動產,47,0,47,群益金鼎-松山,2024-07-22,9103
2402,毅嘉,47,0,47,群益金鼎-松山,2024-07-22,9103
00929,復華台灣科技優息,40,0,40,群益金鼎-松山,2024-07-22,9103
2330,台積電,41,5,36,群益金鼎-松山,2024-07-22,9103
2884,玉山金,34,0,34,群益金鼎-松山,2024-07-22,9103
00940,元大台灣價值高息,33,1,32,群益金鼎-松山,2024-07-22,9103
2537,聯上發,30,0,30,群益金鼎-松山,2024-07-22,9103
00919,群益台灣精選高息,27,0,27,群益金鼎-松山,2024-07-22,9103
2365,昆盈,94,77,17,群益金鼎-松山,2024-07-22,9103
0056,元大高股息,16,0,16,群益金鼎-松山,2024-07-22,9103
912000,晨訊科-DR,15,0,15,群益金鼎-松山,2024-07-22,9103
2371,大同,15,2,13,群益金鼎-松山,2024-07-22,9103
5876,上海商銀,13,0,13,群益金鼎-松山,2024-07-22,9103
2603,長榮,13,1,12,群益金鼎-松山,2024-07-22,9103
2359,所羅門,24,13,11,群益金鼎-松山,2024-07-22,9103
00923,群益台ESG低碳50,10,0,10,群益金鼎-松山,2024-07-22,9103
1319,東陽,10,0,10,群益金鼎-松山,2024-07-22,9103
2618,長榮航,10,0,10,群益金鼎-松山,2024-07-22,9103
3037,欣興,16,6,10,群益金鼎-松山,2024-07-22,9103
3207,耀勝,10,0,10,群益金鼎-松山,2024-07-22,9103
3466,德晉,10,0,10,群益金鼎-松山,2024-07-22,9103
5484,慧友,10,0,10,群益金鼎-松山,2024-07-22,9103
2609,陽明,10,0,10,群益金鼎-松山,2024-07-22,9103
2891,中信金,10,1,9,群益金鼎-松山,2024-07-22,9103
3535,晶彩科,18,9,9,群益金鼎-松山,2024-07-22,9103
6625,必應,9,0,9,群益金鼎-松山,2024-07-22,9103
3686,達能,9,1,8,群益金鼎-松山,2024-07-22,9103
2442,新美齊,6,0,6,群益金鼎-松山,2024-07-22,9103
2867,三商壽,6,0,6,群益金鼎-松山,2024-07-22,9103
3624,光頡,6,0,6,群益金鼎-松山,2024-07-22,9103
4566,時碩工業,11,5,6,群益金鼎-松山,2024-07-22,9103
4927,泰鼎-KY,6,0,6,群益金鼎-松山,2024-07-22,9103
2453,凌群,5,0,5,群益金鼎-松山,2024-07-22,9103
3019,亞光,5,0,5,群益金鼎-松山,2024-07-22,9103
3552,同致,5,0,5,群益金鼎-松山,2024-07-22,9103
4533,協易機,5,0,5,群益金鼎-松山,2024-07-22,9103
5469,瀚宇博,5,0,5,群益金鼎-松山,2024-07-22,9103
2250,IKKA-KY,5,0,5,群益金鼎-松山,2024-07-22,9103
2308,台達電,4,0,4,群益金鼎-松山,2024-07-22,9103
1447,力鵬,4,0,4,群益金鼎-松山,2024-07-22,9103
1605,華新,4,0,4,群益金鼎-松山,2024-07-22,9103
3015,全漢,4,0,4,群益金鼎-松山,2024-07-22,9103
3105,穩懋,5,1,4,群益金鼎-松山,2024-07-22,9103
5905,南仁湖,4,0,4,群益金鼎-松山,2024-07-22,9103
6213,聯茂,4,0,4,群益金鼎-松山,2024-07-22,9103
6605,帝寶,4,0,4,群益金鼎-松山,2024-07-22,9103
8935,邦泰,4,0,4,群益金鼎-松山,2024-07-22,9103
8996,高力,4,0,4,群益金鼎-松山,2024-07-22,9103
00949,復華日本龍頭,196,60,136,群益金鼎-松山,2024-07-23,9103
2888,新光金,53,7,46,群益金鼎-松山,2024-07-23,9103
3686,達能,51,9,42,群益金鼎-松山,2024-07-23,9103
8103,瀚荃,42,0,42,群益金鼎-松山,2024-07-23,9103
1522,堤維西,40,0,40,群益金鼎-松山,2024-07-23,9103
00632R,元大台灣50反1,30,0,30,群益金鼎-松山,2024-07-23,9103
6177,達麗,26,2,24,群益金鼎-松山,2024-07-23,9103
2520,冠德,34,13,21,群益金鼎-松山,2024-07-23,9103
2349,錸德,150,130,20,群益金鼎-松山,2024-07-23,9103
2609,陽明,20,0,20,群益金鼎-松山,2024-07-23,9103
4123,晟德,20,0,20,群益金鼎-松山,2024-07-23,9103
2356,英業達,20,1,19,群益金鼎-松山,2024-07-23,9103
3037,欣興,18,0,18,群益金鼎-松山,2024-07-23,9103
8089,康全電訊,20,3,17,群益金鼎-松山,2024-07-23,9103
00945B,凱基美國非投等債,15,0,15,群益金鼎-松山,2024-07-23,9103
6829,千附精密,15,0,15,群益金鼎-松山,2024-07-23,9103
2317,鴻海,30,16,14,群益金鼎-松山,2024-07-23,9103
4916,事欣科,14,1,13,群益金鼎-松山,2024-07-23,9103
00929,復華台灣科技優息,13,0,13,群益金鼎-松山,2024-07-23,9103
3481,群創,16,4,12,群益金鼎-松山,2024-07-23,9103
1447,力鵬,11,0,11,群益金鼎-松山,2024-07-23,9103
00940,元大台灣價值高息,11,0,11,群益金鼎-松山,2024-07-23,9103
3062,建漢,11,0,11,群益金鼎-松山,2024-07-23,9103
00939,統一台灣高息動能,10,0,10,群益金鼎-松山,2024-07-23,9103
2630,亞航,10,0,10,群益金鼎-松山,2024-07-23,9103
3047,訊舟,10,0,10,群益金鼎-松山,2024-07-23,9103
5534,長虹,10,0,10,群益金鼎-松山,2024-07-23,9103
8105,凌巨,15,5,10,群益金鼎-松山,2024-07-23,9103
3019,亞光,10,1,9,群益金鼎-松山,2024-07-23,9103
3702,大聯大,13,4,9,群益金鼎-松山,2024-07-23,9103
2408,南亞科,8,0,8,群益金鼎-松山,2024-07-23,9103
00671R,富邦NASDAQ反1,5,0,5,群益金鼎-松山,2024-07-23,9103
00751B,元大AAA至A公司債,5,0,5,群益金鼎-松山,2024-07-23,9103
2323,中環,5,0,5,群益金鼎-松山,2024-07-23,9103
2537,聯上發,35,30,5,群益金鼎-松山,2024-07-23,9103
2618,長榮航,5,0,5,群益金鼎-松山,2024-07-23,9103
3580,友威科,9,4,5,群益金鼎-松山,2024-07-23,9103
3712,永崴投控,5,0,5,群益金鼎-松山,2024-07-23,9103
4533,協易機,5,0,5,群益金鼎-松山,2024-07-23,9103
4562,穎漢,21,16,5,群益金鼎-松山,2024-07-23,9103
6213,聯茂,8,3,5,群益金鼎-松山,2024-07-23,9103
8038,長園科,5,0,5,群益金鼎-松山,2024-07-23,9103
8076,伍豐,5,0,5,群益金鼎-松山,2024-07-23,9103
2312,金寶,56,52,4,群益金鼎-松山,2024-07-23,9103
2489,瑞軒,4,0,4,群益金鼎-松山,2024-07-23,9103
5905,南仁湖,4,0,4,群益金鼎-松山,2024-07-23,9103
8028,昇陽半導體,5,1,4,群益金鼎-松山,2024-07-23,9103
00878,國泰永續高股息,5,1,4,群益金鼎-松山,2024-07-23,9103
9945,潤泰新,5,2,3,群益金鼎-松山,2024-07-23,9103
2379,瑞昱,3,0,3,群益金鼎-松山,2024-07-23,9103
4716,大立,145,0,145,群益金鼎-松山,2024-07-26,9103
2834,臺企銀,83,1,82,群益金鼎-松山,2024-07-26,9103
00680L,元大美債20正2,61,0,61,群益金鼎-松山,2024-07-26,9103
00935,野村臺灣新科技50,53,0,53,群益金鼎-松山,2024-07-26,9103
00929,復華台灣科技優息,46,1,45,群益金鼎-松山,2024-07-26,9103
3189,景碩,45,0,45,群益金鼎-松山,2024-07-26,9103
00937B,群益ESG投等債20,45,1,44,群益金鼎-松山,2024-07-26,9103
4958,臻鼎-KY,45,2,43,群益金鼎-松山,2024-07-26,9103
2524,京城,42,0,42,群益金鼎-松山,2024-07-26,9103
2002,中鋼,50,10,40,群益金鼎-松山,2024-07-26,9103
8043,蜜望實,38,0,38,群益金鼎-松山,2024-07-26,9103
8046,南電,46,10,36,群益金鼎-松山,2024-07-26,9103
2330,台積電,39,6,33,群益金鼎-松山,2024-07-26,9103
2323,中環,30,0,30,群益金鼎-松山,2024-07-26,9103
3260,威剛,30,0,30,群益金鼎-松山,2024-07-26,9103
4967,十銓,30,2,28,群益金鼎-松山,2024-07-26,9103
00878,國泰永續高股息,27,2,25,群益金鼎-松山,2024-07-26,9103
6177,達麗,24,0,24,群益金鼎-松山,2024-07-26,9103
2317,鴻海,26,4,22,群益金鼎-松山,2024-07-26,9103
2520,冠德,54,32,22,群益金鼎-松山,2024-07-26,9103
00919,群益台灣精選高息,21,0,21,群益金鼎-松山,2024-07-26,9103
2365,昆盈,21,4,17,群益金鼎-松山,2024-07-26,9103
00949,復華日本龍頭,14,0,14,群益金鼎-松山,2024-07-26,9103
4566,時碩工業,24,11,13,群益金鼎-松山,2024-07-26,9103
1103,嘉泥,10,0,10,群益金鼎-松山,2024-07-26,9103
00712,復華富時不動產,10,0,10,群益金鼎-松山,2024-07-26,9103
00830,國泰費城半導體,10,0,10,群益金鼎-松山,2024-07-26,9103
00927,群益半導體收益,10,0,10,群益金鼎-松山,2024-07-26,9103
2464,盟立,12,2,10,群益金鼎-松山,2024-07-26,9103
2481,強茂,10,0,10,群益金鼎-松山,2024-07-26,9103
2867,三商壽,10,0,10,群益金鼎-松山,2024-07-26,9103
3580,友威科,17,7,10,群益金鼎-松山,2024-07-26,9103
4746,台耀,10,0,10,群益金鼎-松山,2024-07-26,9103
3380,明泰,8,0,8,群益金鼎-松山,2024-07-26,9103
00940,元大台灣價值高息,7,0,7,群益金鼎-松山,2024-07-26,9103
00923,群益台ESG低碳50,10,3,7,群益金鼎-松山,2024-07-26,9103
2884,玉山金,7,0,7,群益金鼎-松山,2024-07-26,9103
1560,中砂,6,0,6,群益金鼎-松山,2024-07-26,9103
00687B,國泰20年美債,6,0,6,群益金鼎-松山,2024-07-26,9103
006205,富邦上証,6,0,6,群益金鼎-松山,2024-07-26,9103
2382,廣達,6,0,6,群益金鼎-松山,2024-07-26,9103
2515,中工,6,0,6,群益金鼎-松山,2024-07-26,9103
2618,長榮航,6,0,6,群益金鼎-松山,2024-07-26,9103
5512,力麒,6,0,6,群益金鼎-松山,2024-07-26,9103
6143,振曜,7,1,6,群益金鼎-松山,2024-07-26,9103
6175,立敦,6,0,6,群益金鼎-松山,2024-07-26,9103
2597,潤弘,5,0,5,群益金鼎-松山,2024-07-26,9103
00713,元大台灣高息低波,5,0,5,群益金鼎-松山,2024-07-26,9103
2486,一詮,6,1,5,群益金鼎-松山,2024-07-26,9103
2501,國建,5,0,5,群益金鼎-松山,2024-07-26,9103
1316,上曜,100,7,93,群益金鼎-松山,2024-07-29,9103
8028,昇陽半導體,73,9,64,群益金鼎-松山,2024-07-29,9103
00929,復華台灣科技優息,53,0,53,群益金鼎-松山,2024-07-29,9103
00632R,元大台灣50反1,58,18,40,群益金鼎-松山,2024-07-29,9103
2520,冠德,73,33,40,群益金鼎-松山,2024-07-29,9103
8043,蜜望實,31,0,31,群益金鼎-松山,2024-07-29,9103
5351,鈺創,20,0,20,群益金鼎-松山,2024-07-29,9103
6625,必應,21,1,20,群益金鼎-松山,2024-07-29,9103
1808,潤隆,20,2,18,群益金鼎-松山,2024-07-29,9103
3380,明泰,20,2,18,群益金鼎-松山,2024-07-29,9103
3689,湧德,17,0,17,群益金鼎-松山,2024-07-29,9103
0056,元大高股息,11,0,11,群益金鼎-松山,2024-07-29,9103
3711,日月光投控,11,1,10,群益金鼎-松山,2024-07-29,9103
2363,矽統,10,0,10,群益金鼎-松山,2024-07-29,9103
2548,華固,10,0,10,群益金鼎-松山,2024-07-29,9103
3037,欣興,10,0,10,群益金鼎-松山,2024-07-29,9103
6462,神盾,12,2,10,群益金鼎-松山,2024-07-29,9103
8349,�矬�,18,8,10,群益金鼎-松山,2024-07-29,9103
2367,燿華,20,11,9,群益金鼎-松山,2024-07-29,9103
00878,國泰永續高股息,8,0,8,群益金鼎-松山,2024-07-29,9103
2891,中信金,8,0,8,群益金鼎-松山,2024-07-29,9103
3376,新日興,9,2,7,群益金鼎-松山,2024-07-29,9103
2317,鴻海,9,3,6,群益金鼎-松山,2024-07-29,9103
3211,順達,6,0,6,群益金鼎-松山,2024-07-29,9103
6117,迎廣,9,3,6,群益金鼎-松山,2024-07-29,9103
2250,IKKA-KY,5,0,5,群益金鼎-松山,2024-07-29,9103
6282,康舒,5,0,5,群益金鼎-松山,2024-07-29,9103
2201,裕隆,5,0,5,群益金鼎-松山,2024-07-29,9103
2428,興勤,5,0,5,群益金鼎-松山,2024-07-29,9103
2453,凌群,5,0,5,群益金鼎-松山,2024-07-29,9103
2509,全坤建,5,0,5,群益金鼎-松山,2024-07-29,9103
2537,聯上發,5,0,5,群益金鼎-松山,2024-07-29,9103
3022,威強電,5,0,5,群益金鼎-松山,2024-07-29,9103
4157,太景*-KY,5,0,5,群益金鼎-松山,2024-07-29,9103
4933,友輝,5,0,5,群益金鼎-松山,2024-07-29,9103
5512,力麒,6,1,5,群益金鼎-松山,2024-07-29,9103
8111,立��,5,0,5,群益金鼎-松山,2024-07-29,9103
1532,勤美,4,0,4,群益金鼎-松山,2024-07-29,9103
1815,富喬,4,0,4,群益金鼎-松山,2024-07-29,9103
2356,英業達,4,0,4,群益金鼎-松山,2024-07-29,9103
2379,瑞昱,4,0,4,群益金鼎-松山,2024-07-29,9103
2455,全新,4,0,4,群益金鼎-松山,2024-07-29,9103
3324,雙鴻,6,2,4,群益金鼎-松山,2024-07-29,9103
4721,美琪瑪,4,0,4,群益金鼎-松山,2024-07-29,9103
4956,光鋐,4,0,4,群益金鼎-松山,2024-07-29,9103
5203,訊連,4,0,4,群益金鼎-松山,2024-07-29,9103
2884,玉山金,3,0,3,群益金鼎-松山,2024-07-29,9103
00935,野村臺灣新科技50,3,0,3,群益金鼎-松山,2024-07-29,9103
1217,愛之味,3,0,3,群益金鼎-松山,2024-07-29,9103
2301,光寶科,11,8,3,群益金鼎-松山,2024-07-29,9103
3481,群創,108,21,87,群益金鼎-松山,2024-07-30,9103
1522,堤維西,60,0,60,群益金鼎-松山,2024-07-30,9103
8064,東捷,42,5,37,群益金鼎-松山,2024-07-30,9103
00929,復華台灣科技優息,35,1,34,群益金鼎-松山,2024-07-30,9103
1540,喬福,32,0,32,群益金鼎-松山,2024-07-30,9103
4927,泰鼎-KY,32,0,32,群益金鼎-松山,2024-07-30,9103
2881,富邦金,30,0,30,群益金鼎-松山,2024-07-30,9103
9940,信義,30,0,30,群益金鼎-松山,2024-07-30,9103
2884,玉山金,25,0,25,群益金鼎-松山,2024-07-30,9103
3022,威強電,25,0,25,群益金鼎-松山,2024-07-30,9103
00637L,元大滬深300正2,20,0,20,群益金鼎-松山,2024-07-30,9103
2323,中環,20,0,20,群益金鼎-松山,2024-07-30,9103
2609,陽明,20,0,20,群益金鼎-松山,2024-07-30,9103
2368,金像電,15,0,15,群益金鼎-松山,2024-07-30,9103
3535,晶彩科,35,20,15,群益金鼎-松山,2024-07-30,9103
6147,頎邦,15,0,15,群益金鼎-松山,2024-07-30,9103
3289,宜特,12,0,12,群益金鼎-松山,2024-07-30,9103
00940,元大台灣價值高息,12,1,11,群益金鼎-松山,2024-07-30,9103
2330,台積電,14,3,11,群益金鼎-松山,2024-07-30,9103
0056,元大高股息,10,0,10,群益金鼎-松山,2024-07-30,9103
3374,精材,31,21,10,群益金鼎-松山,2024-07-30,9103
2520,冠德,50,40,10,群益金鼎-松山,2024-07-30,9103
5484,慧友,10,0,10,群益金鼎-松山,2024-07-30,9103
9945,潤泰新,10,0,10,群益金鼎-松山,2024-07-30,9103
3665,貿聯-KY,9,0,9,群益金鼎-松山,2024-07-30,9103
2349,錸德,8,0,8,群益金鼎-松山,2024-07-30,9103
3013,晟銘電,8,0,8,群益金鼎-松山,2024-07-30,9103
4979,華星光,8,0,8,群益金鼎-松山,2024-07-30,9103
6869,雲豹能源,20,12,8,群益金鼎-松山,2024-07-30,9103
00919,群益台灣精選高息,8,0,8,群益金鼎-松山,2024-07-30,9103
6462,神盾,7,0,7,群益金鼎-松山,2024-07-30,9103
8147,正淩,7,0,7,群益金鼎-松山,2024-07-30,9103
00946,群益科技高息成長,6,0,6,群益金鼎-松山,2024-07-30,9103
2449,京元電子,6,0,6,群益金鼎-松山,2024-07-30,9103
3705,永信,6,0,6,群益金鼎-松山,2024-07-30,9103
6133,金橋,6,0,6,群益金鼎-松山,2024-07-30,9103
0055,元大MSCI金融,5,0,5,群益金鼎-松山,2024-07-30,9103
00933B,國泰10Y+金融債,5,0,5,群益金鼎-松山,2024-07-30,9103
00922,國泰台灣領袖50,5,0,5,群益金鼎-松山,2024-07-30,9103
2371,大同,5,0,5,群益金鼎-松山,2024-07-30,9103
00878,國泰永續高股息,5,0,5,群益金鼎-松山,2024-07-30,9103
00935,野村臺灣新科技50,4,0,4,群益金鼎-松山,2024-07-30,9103
3702,大聯大,6,2,4,群益金鼎-松山,2024-07-30,9103
4967,十銓,4,0,4,群益金鼎-松山,2024-07-30,9103
6546,正基,6,2,4,群益金鼎-松山,2024-07-30,9103
00896,中信綠能及電動車,3,0,3,群益金鼎-松山,2024-07-30,9103
2363,矽統,5,2,3,群益金鼎-松山,2024-07-30,9103
2438,翔耀,3,0,3,群益金鼎-松山,2024-07-30,9103
2464,盟立,4,1,3,群益金鼎-松山,2024-07-30,9103
2618,長榮航,5,2,3,群益金鼎-松山,2024-07-30,9103
2887,台新金,305,0,305,群益金鼎-松山,2024-07-31,9103
2888,新光金,300,101,199,群益金鼎-松山,2024-07-31,9103
6505,台塑化,90,0,90,群益金鼎-松山,2024-07-31,9103
2349,錸德,110,50,60,群益金鼎-松山,2024-07-31,9103
0056,元大高股息,51,0,51,群益金鼎-松山,2024-07-31,9103
2337,旺宏,121,71,50,群益金鼎-松山,2024-07-31,9103
00878,國泰永續高股息,47,0,47,群益金鼎-松山,2024-07-31,9103
1717,長興,30,0,30,群益金鼎-松山,2024-07-31,9103
2388,威盛,30,0,30,群益金鼎-松山,2024-07-31,9103
2504,國產,46,20,26,群益金鼎-松山,2024-07-31,9103
2486,一詮,25,3,22,群益金鼎-松山,2024-07-31,9103
5213,亞昕,17,1,16,群益金鼎-松山,2024-07-31,9103
2365,昆盈,15,1,14,群益金鼎-松山,2024-07-31,9103
00687B,國泰20年美債,11,0,11,群益金鼎-松山,2024-07-31,9103
2464,盟立,14,3,11,群益金鼎-松山,2024-07-31,9103
3036,文曄,11,0,11,群益金鼎-松山,2024-07-31,9103
00665L,富邦�琤肭磪囓�2,10,0,10,群益金鼎-松山,2024-07-31,9103
00706L,期元大S＆P日圓正2,10,0,10,群益金鼎-松山,2024-07-31,9103
00946,群益科技高息成長,10,0,10,群益金鼎-松山,2024-07-31,9103
00945B,凱基美國非投等債,10,0,10,群益金鼎-松山,2024-07-31,9103
2377,微星,10,0,10,群益金鼎-松山,2024-07-31,9103
2442,新美齊,10,0,10,群益金鼎-松山,2024-07-31,9103
2548,華固,10,0,10,群益金鼎-松山,2024-07-31,9103
2867,三商壽,10,0,10,群益金鼎-松山,2024-07-31,9103
3703,欣陸,10,0,10,群益金鼎-松山,2024-07-31,9103
5484,慧友,20,10,10,群益金鼎-松山,2024-07-31,9103
00929,復華台灣科技優息,10,1,9,群益金鼎-松山,2024-07-31,9103
4927,泰鼎-KY,9,0,9,群益金鼎-松山,2024-07-31,9103
6187,萬潤,9,0,9,群益金鼎-松山,2024-07-31,9103
2308,台達電,9,0,9,群益金鼎-松山,2024-07-31,9103
2429,銘旺科,8,0,8,群益金鼎-松山,2024-07-31,9103
3047,訊舟,12,4,8,群益金鼎-松山,2024-07-31,9103
00923,群益台ESG低碳50,7,0,7,群益金鼎-松山,2024-07-31,9103
3693,營邦,6,0,6,群益金鼎-松山,2024-07-31,9103
3105,穩懋,16,10,6,群益金鼎-松山,2024-07-31,9103
1809,中釉,6,0,6,群益金鼎-松山,2024-07-31,9103
2455,全新,6,0,6,群益金鼎-松山,2024-07-31,9103
6186,新潤,6,0,6,群益金鼎-松山,2024-07-31,9103
8210,勤誠,6,0,6,群益金鼎-松山,2024-07-31,9103
2317,鴻海,42,37,5,群益金鼎-松山,2024-07-31,9103
00713,元大台灣高息低波,5,0,5,群益金鼎-松山,2024-07-31,9103
1337,再生-KY,5,0,5,群益金鼎-松山,2024-07-31,9103
00933B,國泰10Y+金融債,5,0,5,群益金鼎-松山,2024-07-31,9103
00937B,群益ESG投等債20,10,5,5,群益金鼎-松山,2024-07-31,9103
1618,合機,5,0,5,群益金鼎-松山,2024-07-31,9103
2412,中華電,5,0,5,群益金鼎-松山,2024-07-31,9103
2515,中工,5,0,5,群益金鼎-松山,2024-07-31,9103
2537,聯上發,5,0,5,群益金鼎-松山,2024-07-31,9103
3025,星通,5,0,5,群益金鼎-松山,2024-07-31,9103
3363,上詮,15,10,5,群益金鼎-松山,2024-07-31,9103
2887,台新金,300,0,300,群益金鼎-松山,2024-08-01,9103
00936,台新永續高息中小,137,0,137,群益金鼎-松山,2024-08-01,9103
00929,復華台灣科技優息,141,5,136,群益金鼎-松山,2024-08-01,9103
00946,群益科技高息成長,104,0,104,群益金鼎-松山,2024-08-01,9103
00943,兆豐電子高息等權,98,0,98,群益金鼎-松山,2024-08-01,9103
2884,玉山金,97,10,87,群益金鼎-松山,2024-08-01,9103
2528,皇普,47,0,47,群益金鼎-松山,2024-08-01,9103
2615,萬海,43,1,42,群益金鼎-松山,2024-08-01,9103
2537,聯上發,35,0,35,群益金鼎-松山,2024-08-01,9103
2527,宏璟,31,0,31,群益金鼎-松山,2024-08-01,9103
1453,大將,30,0,30,群益金鼎-松山,2024-08-01,9103
4113,聯上,30,0,30,群益金鼎-松山,2024-08-01,9103
5519,隆大,30,0,30,群益金鼎-松山,2024-08-01,9103
6770,力積電,30,0,30,群益金鼎-松山,2024-08-01,9103
9945,潤泰新,32,2,30,群益金鼎-松山,2024-08-01,9103
2204,中華,27,0,27,群益金鼎-松山,2024-08-01,9103
4927,泰鼎-KY,28,3,25,群益金鼎-松山,2024-08-01,9103
2545,皇翔,24,0,24,群益金鼎-松山,2024-08-01,9103
00944,野村趨勢動能高息,22,0,22,群益金鼎-松山,2024-08-01,9103
9919,康那香,22,0,22,群益金鼎-松山,2024-08-01,9103
00923,群益台ESG低碳50,20,0,20,群益金鼎-松山,2024-08-01,9103
6505,台塑化,20,0,20,群益金鼎-松山,2024-08-01,9103
3689,湧德,18,0,18,群益金鼎-松山,2024-08-01,9103
2365,昆盈,20,3,17,群益金鼎-松山,2024-08-01,9103
2409,友達,17,0,17,群益金鼎-松山,2024-08-01,9103
1325,恆大,15,0,15,群益金鼎-松山,2024-08-01,9103
00878,國泰永續高股息,20,5,15,群益金鼎-松山,2024-08-01,9103
00632R,元大台灣50反1,15,0,15,群益金鼎-松山,2024-08-01,9103
3624,光頡,21,6,15,群益金鼎-松山,2024-08-01,9103
4533,協易機,15,0,15,群益金鼎-松山,2024-08-01,9103
6122,擎邦,15,0,15,群益金鼎-松山,2024-08-01,9103
6462,神盾,22,9,13,群益金鼎-松山,2024-08-01,9103
00687B,國泰20年美債,12,0,12,群益金鼎-松山,2024-08-01,9103
6188,廣明,32,20,12,群益金鼎-松山,2024-08-01,9103
3037,欣興,12,1,11,群益金鼎-松山,2024-08-01,9103
5340,建榮,11,0,11,群益金鼎-松山,2024-08-01,9103
00933B,國泰10Y+金融債,11,0,11,群益金鼎-松山,2024-08-01,9103
3163,波若威,12,1,11,群益金鼎-松山,2024-08-01,9103
2492,華新科,10,0,10,群益金鼎-松山,2024-08-01,9103
00795B,中信美國公債20年,10,0,10,群益金鼎-松山,2024-08-01,9103
00725B,國泰投資級公司債,10,0,10,群益金鼎-松山,2024-08-01,9103
00724B,群益投資級金融債,10,0,10,群益金鼎-松山,2024-08-01,9103
00720B,元大投資級公司債,10,0,10,群益金鼎-松山,2024-08-01,9103
3312,弘憶股,10,0,10,群益金鼎-松山,2024-08-01,9103
3379,彬台,20,10,10,群益金鼎-松山,2024-08-01,9103
4128,中天,10,0,10,群益金鼎-松山,2024-08-01,9103
4979,華星光,11,1,10,群益金鼎-松山,2024-08-01,9103
5469,瀚宇博,10,0,10,群益金鼎-松山,2024-08-01,9103
5522,遠雄,10,0,10,群益金鼎-松山,2024-08-01,9103
6546,正基,10,0,10,群益金鼎-松山,2024-08-01,9103
2888,新光金,702,5,697,群益金鼎-松山,2024-08-02,9103
1809,中釉,128,0,128,群益金鼎-松山,2024-08-02,9103
1513,中興電,100,0,100,群益金鼎-松山,2024-08-02,9103
1316,上曜,104,5,99,群益金鼎-松山,2024-08-02,9103
00929,復華台灣科技優息,97,0,97,群益金鼎-松山,2024-08-02,9103
00948B,中信優息投資級債,88,0,88,群益金鼎-松山,2024-08-02,9103
00878,國泰永續高股息,81,0,81,群益金鼎-松山,2024-08-02,9103
2317,鴻海,73,7,66,群益金鼎-松山,2024-08-02,9103
00946,群益科技高息成長,61,0,61,群益金鼎-松山,2024-08-02,9103
00940,元大台灣價值高息,56,0,56,群益金鼎-松山,2024-08-02,9103
00936,台新永續高息中小,55,0,55,群益金鼎-松山,2024-08-02,9103
00951,台新日本半導體,55,0,55,群益金鼎-松山,2024-08-02,9103
2002,中鋼,52,0,52,群益金鼎-松山,2024-08-02,9103
0056,元大高股息,50,0,50,群益金鼎-松山,2024-08-02,9103
00680L,元大美債20正2,50,0,50,群益金鼎-松山,2024-08-02,9103
2330,台積電,64,15,49,群益金鼎-松山,2024-08-02,9103
00945B,凱基美國非投等債,48,0,48,群益金鼎-松山,2024-08-02,9103
00830,國泰費城半導體,46,0,46,群益金鼎-松山,2024-08-02,9103
4908,前鼎,46,0,46,群益金鼎-松山,2024-08-02,9103
4927,泰鼎-KY,42,1,41,群益金鼎-松山,2024-08-02,9103
00919,群益台灣精選高息,34,0,34,群益金鼎-松山,2024-08-02,9103
2884,玉山金,32,0,32,群益金鼎-松山,2024-08-02,9103
6122,擎邦,27,3,24,群益金鼎-松山,2024-08-02,9103
2610,華航,23,0,23,群益金鼎-松山,2024-08-02,9103
00670L,富邦NASDAQ正2,21,0,21,群益金鼎-松山,2024-08-02,9103
4123,晟德,20,0,20,群益金鼎-松山,2024-08-02,9103
5351,鈺創,20,0,20,群益金鼎-松山,2024-08-02,9103
5484,慧友,20,0,20,群益金鼎-松山,2024-08-02,9103
6239,力成,19,0,19,群益金鼎-松山,2024-08-02,9103
3048,益登,23,5,18,群益金鼎-松山,2024-08-02,9103
2362,藍天,42,25,17,群益金鼎-松山,2024-08-02,9103
5469,瀚宇博,15,0,15,群益金鼎-松山,2024-08-02,9103
2301,光寶科,15,2,13,群益金鼎-松山,2024-08-02,9103
00687B,國泰20年美債,22,10,12,群益金鼎-松山,2024-08-02,9103
2455,全新,11,0,11,群益金鼎-松山,2024-08-02,9103
5443,均豪,15,4,11,群益金鼎-松山,2024-08-02,9103
9906,欣巴巴,12,1,11,群益金鼎-松山,2024-08-02,9103
00902,中信電池及儲能,11,1,10,群益金鼎-松山,2024-08-02,9103
1303,南亞,10,0,10,群益金鼎-松山,2024-08-02,9103
1605,華新,10,0,10,群益金鼎-松山,2024-08-02,9103
2539,櫻花建,10,0,10,群益金鼎-松山,2024-08-02,9103
2834,臺企銀,10,0,10,群益金鼎-松山,2024-08-02,9103
6505,台塑化,10,0,10,群益金鼎-松山,2024-08-02,9103
9902,台火,10,0,10,群益金鼎-松山,2024-08-02,9103
2891,中信金,9,0,9,群益金鼎-松山,2024-08-02,9103
5876,上海商銀,9,0,9,群益金鼎-松山,2024-08-02,9103
00922,國泰台灣領袖50,8,0,8,群益金鼎-松山,2024-08-02,9103
00949,復華日本龍頭,8,0,8,群益金鼎-松山,2024-08-02,9103
0050,元大台灣50,8,1,7,群益金鼎-松山,2024-08-02,9103
6143,振曜,9,2,7,群益金鼎-松山,2024-08-02,9103
1513,中興電,219,0,219,群益金鼎-松山,2024-08-05,9103
4716,大立,92,0,92,群益金鼎-松山,2024-08-05,9103
00940,元大台灣價值高息,79,2,77,群益金鼎-松山,2024-08-05,9103
00919,群益台灣精選高息,70,0,70,群益金鼎-松山,2024-08-05,9103
00878,國泰永續高股息,65,3,62,群益金鼎-松山,2024-08-05,9103
6592,和潤企業,51,0,51,群益金鼎-松山,2024-08-05,9103
1314,中石化,50,0,50,群益金鼎-松山,2024-08-05,9103
2884,玉山金,50,0,50,群益金鼎-松山,2024-08-05,9103
00929,復華台灣科技優息,61,16,45,群益金鼎-松山,2024-08-05,9103
9934,成霖,40,0,40,群益金鼎-松山,2024-08-05,9103
6770,力積電,39,0,39,群益金鼎-松山,2024-08-05,9103
1304,台聚,40,1,39,群益金鼎-松山,2024-08-05,9103
2362,藍天,36,0,36,群益金鼎-松山,2024-08-05,9103
2881,富邦金,82,50,32,群益金鼎-松山,2024-08-05,9103
2520,冠德,30,0,30,群益金鼎-松山,2024-08-05,9103
2317,鴻海,63,33,30,群益金鼎-松山,2024-08-05,9103
00902,中信電池及儲能,30,1,29,群益金鼎-松山,2024-08-05,9103
0056,元大高股息,29,1,28,群益金鼎-松山,2024-08-05,9103
6143,振曜,28,2,26,群益金鼎-松山,2024-08-05,9103
2453,凌群,25,0,25,群益金鼎-松山,2024-08-05,9103
2330,台積電,52,30,22,群益金鼎-松山,2024-08-05,9103
1569,濱川,22,0,22,群益金鼎-松山,2024-08-05,9103
1605,華新,21,0,21,群益金鼎-松山,2024-08-05,9103
2313,華通,21,0,21,群益金鼎-松山,2024-08-05,9103
6122,擎邦,21,0,21,群益金鼎-松山,2024-08-05,9103
3006,晶豪科,20,0,20,群益金鼎-松山,2024-08-05,9103
3481,群創,33,13,20,群益金鼎-松山,2024-08-05,9103
3710,連展投控,20,0,20,群益金鼎-松山,2024-08-05,9103
4908,前鼎,20,0,20,群益金鼎-松山,2024-08-05,9103
1337,再生-KY,15,0,15,群益金鼎-松山,2024-08-05,9103
2323,中環,15,0,15,群益金鼎-松山,2024-08-05,9103
2610,華航,20,6,14,群益金鼎-松山,2024-08-05,9103
3037,欣興,14,0,14,群益金鼎-松山,2024-08-05,9103
2352,佳世達,12,0,12,群益金鼎-松山,2024-08-05,9103
2348,海悅,16,5,11,群益金鼎-松山,2024-08-05,9103
2801,彰銀,11,0,11,群益金鼎-松山,2024-08-05,9103
9945,潤泰新,10,0,10,群益金鼎-松山,2024-08-05,9103
00665L,富邦�琤肭磪囓�2,10,0,10,群益金鼎-松山,2024-08-05,9103
2537,聯上發,10,0,10,群益金鼎-松山,2024-08-05,9103
2645,長榮航太,9,0,9,群益金鼎-松山,2024-08-05,9103
3078,僑威,10,1,9,群益金鼎-松山,2024-08-05,9103
2834,臺企銀,8,0,8,群益金鼎-松山,2024-08-05,9103
00751B,元大AAA至A公司債,8,0,8,群益金鼎-松山,2024-08-05,9103
0050,元大台灣50,12,4,8,群益金鼎-松山,2024-08-05,9103
00918,大華優利高填息30,7,0,7,群益金鼎-松山,2024-08-05,9103
9904,寶成,7,0,7,群益金鼎-松山,2024-08-05,9103
1301,台塑,7,1,6,群益金鼎-松山,2024-08-05,9103
2409,友達,6,0,6,群益金鼎-松山,2024-08-05,9103
2618,長榮航,7,1,6,群益金鼎-松山,2024-08-05,9103
3704,合勤控,6,0,6,群益金鼎-松山,2024-08-05,9103
00712,復華富時不動產,300,0,300,群益金鼎-松山,2024-08-06,9103
2888,新光金,500,201,299,群益金鼎-松山,2024-08-06,9103
3357,臺慶科,138,15,123,群益金鼎-松山,2024-08-06,9103
00940,元大台灣價值高息,97,2,95,群益金鼎-松山,2024-08-06,9103
00900,富邦特選高股息30,94,0,94,群益金鼎-松山,2024-08-06,9103
00632R,元大台灣50反1,100,10,90,群益金鼎-松山,2024-08-06,9103
00878,國泰永續高股息,85,3,82,群益金鼎-松山,2024-08-06,9103
2317,鴻海,110,67,43,群益金鼎-松山,2024-08-06,9103
6841,長佳智能,30,0,30,群益金鼎-松山,2024-08-06,9103
2365,昆盈,87,65,22,群益金鼎-松山,2024-08-06,9103
2609,陽明,44,22,22,群益金鼎-松山,2024-08-06,9103
2520,冠德,20,0,20,群益金鼎-松山,2024-08-06,9103
2313,華通,18,0,18,群益金鼎-松山,2024-08-06,9103
0056,元大高股息,17,0,17,群益金鼎-松山,2024-08-06,9103
2597,潤弘,16,0,16,群益金鼎-松山,2024-08-06,9103
5309,系統電,16,0,16,群益金鼎-松山,2024-08-06,9103
2615,萬海,41,25,16,群益金鼎-松山,2024-08-06,9103
3013,晟銘電,18,3,15,群益金鼎-松山,2024-08-06,9103
2368,金像電,24,10,14,群益金鼎-松山,2024-08-06,9103
2349,錸德,51,38,13,群益金鼎-松山,2024-08-06,9103
2884,玉山金,12,0,12,群益金鼎-松山,2024-08-06,9103
1808,潤隆,11,0,11,群益金鼎-松山,2024-08-06,9103
2374,佳能,11,0,11,群益金鼎-松山,2024-08-06,9103
2603,長榮,12,1,11,群益金鼎-松山,2024-08-06,9103
4908,前鼎,11,0,11,群益金鼎-松山,2024-08-06,9103
8433,弘帆,11,0,11,群益金鼎-松山,2024-08-06,9103
1447,力鵬,10,0,10,群益金鼎-松山,2024-08-06,9103
00671R,富邦NASDAQ反1,10,0,10,群益金鼎-松山,2024-08-06,9103
1611,中電,10,0,10,群益金鼎-松山,2024-08-06,9103
2059,川湖,11,1,10,群益金鼎-松山,2024-08-06,9103
3294,英濟,10,0,10,群益金鼎-松山,2024-08-06,9103
3483,力致,10,0,10,群益金鼎-松山,2024-08-06,9103
2357,華碩,9,0,9,群益金鼎-松山,2024-08-06,9103
00937B,群益ESG投等債20,21,12,9,群益金鼎-松山,2024-08-06,9103
3289,宜特,10,1,9,群益金鼎-松山,2024-08-06,9103
2382,廣達,13,5,8,群益金鼎-松山,2024-08-06,9103
9945,潤泰新,9,1,8,群益金鼎-松山,2024-08-06,9103
00949,復華日本龍頭,8,1,7,群益金鼎-松山,2024-08-06,9103
6274,台燿,25,18,7,群益金鼎-松山,2024-08-06,9103
2327,國巨,6,0,6,群益金鼎-松山,2024-08-06,9103
00919,群益台灣精選高息,11,5,6,群益金鼎-松山,2024-08-06,9103
4979,華星光,6,0,6,群益金鼎-松山,2024-08-06,9103
6111,大宇資,8,2,6,群益金鼎-松山,2024-08-06,9103
6125,廣運,7,1,6,群益金鼎-松山,2024-08-06,9103
1319,東陽,5,0,5,群益金鼎-松山,2024-08-06,9103
00637L,元大滬深300正2,5,0,5,群益金鼎-松山,2024-08-06,9103
2204,中華,5,0,5,群益金鼎-松山,2024-08-06,9103
2481,強茂,10,5,5,群益金鼎-松山,2024-08-06,9103
3022,威強電,5,0,5,群益金鼎-松山,2024-08-06,9103
3037,欣興,6,1,5,群益金鼎-松山,2024-08-06,9103
2344,華邦電,150,0,150,群益金鼎-松山,2024-08-07,9103
00687B,國泰20年美債,141,2,139,群益金鼎-松山,2024-08-07,9103
00632R,元大台灣50反1,131,0,131,群益金鼎-松山,2024-08-07,9103
2882,國泰金,101,5,96,群益金鼎-松山,2024-08-07,9103
2455,全新,85,0,85,群益金鼎-松山,2024-08-07,9103
00937B,群益ESG投等債20,55,0,55,群益金鼎-松山,2024-08-07,9103
2402,毅嘉,45,1,44,群益金鼎-松山,2024-08-07,9103
00679B,元大美債20年,42,0,42,群益金鼎-松山,2024-08-07,9103
2891,中信金,41,0,41,群益金鼎-松山,2024-08-07,9103
00929,復華台灣科技優息,39,3,36,群益金鼎-松山,2024-08-07,9103
2376,技嘉,32,1,31,群益金鼎-松山,2024-08-07,9103
1785,光洋科,30,1,29,群益金鼎-松山,2024-08-07,9103
00706L,期元大S＆P日圓正2,25,0,25,群益金鼎-松山,2024-08-07,9103
6213,聯茂,26,1,25,群益金鼎-松山,2024-08-07,9103
2330,台積電,38,15,23,群益金鼎-松山,2024-08-07,9103
3363,上詮,27,4,23,群益金鼎-松山,2024-08-07,9103
3711,日月光投控,25,4,21,群益金鼎-松山,2024-08-07,9103
3481,群創,19,1,18,群益金鼎-松山,2024-08-07,9103
2317,鴻海,43,28,15,群益金鼎-松山,2024-08-07,9103
00946,群益科技高息成長,15,0,15,群益金鼎-松山,2024-08-07,9103
8349,�矬�,18,3,15,群益金鼎-松山,2024-08-07,9103
00688L,國泰20年美債正2,13,0,13,群益金鼎-松山,2024-08-07,9103
00795B,中信美國公債20年,12,0,12,群益金鼎-松山,2024-08-07,9103
3702,大聯大,12,0,12,群益金鼎-松山,2024-08-07,9103
6274,台燿,12,0,12,群益金鼎-松山,2024-08-07,9103
8105,凌巨,12,0,12,群益金鼎-松山,2024-08-07,9103
9906,欣巴巴,12,0,12,群益金鼎-松山,2024-08-07,9103
1597,直得,13,2,11,群益金鼎-松山,2024-08-07,9103
2534,宏盛,11,0,11,群益金鼎-松山,2024-08-07,9103
00680L,元大美債20正2,10,0,10,群益金鼎-松山,2024-08-07,9103
3019,亞光,14,4,10,群益金鼎-松山,2024-08-07,9103
5432,新門,10,0,10,群益金鼎-松山,2024-08-07,9103
3231,緯創,10,0,10,群益金鼎-松山,2024-08-07,9103
00878,國泰永續高股息,61,52,9,群益金鼎-松山,2024-08-07,9103
2363,矽統,11,3,8,群益金鼎-松山,2024-08-07,9103
6873,泓德能源,7,0,7,群益金鼎-松山,2024-08-07,9103
00751B,元大AAA至A公司債,6,0,6,群益金鼎-松山,2024-08-07,9103
2201,裕隆,5,0,5,群益金鼎-松山,2024-08-07,9103
2204,中華,5,0,5,群益金鼎-松山,2024-08-07,9103
2603,長榮,5,0,5,群益金鼎-松山,2024-08-07,9103
1326,台化,4,0,4,群益金鼎-松山,2024-08-07,9103
1216,統一,4,0,4,群益金鼎-松山,2024-08-07,9103
2867,三商壽,4,0,4,群益金鼎-松山,2024-08-07,9103
2880,華南金,4,0,4,群益金鼎-松山,2024-08-07,9103
3062,建漢,4,0,4,群益金鼎-松山,2024-08-07,9103
3289,宜特,5,1,4,群益金鼎-松山,2024-08-07,9103
3450,聯鈞,5,1,4,群益金鼎-松山,2024-08-07,9103
00905,FT臺灣Smart,3,0,3,群益金鼎-松山,2024-08-07,9103
2501,國建,3,0,3,群益金鼎-松山,2024-08-07,9103
2609,陽明,3,0,3,群益金鼎-松山,2024-08-07,9103
00882,中信中國高股息,400,50,350,群益金鼎-松山,2024-08-08,9103
8096,擎亞,102,25,77,群益金鼎-松山,2024-08-08,9103
00937B,群益ESG投等債20,72,0,72,群益金鼎-松山,2024-08-08,9103
00680L,元大美債20正2,60,0,60,群益金鼎-松山,2024-08-08,9103
1597,直得,36,1,35,群益金鼎-松山,2024-08-08,9103
00720B,元大投資級公司債,35,0,35,群益金鼎-松山,2024-08-08,9103
00933B,國泰10Y+金融債,32,0,32,群益金鼎-松山,2024-08-08,9103
00830,國泰費城半導體,30,0,30,群益金鼎-松山,2024-08-08,9103
4562,穎漢,110,82,28,群益金鼎-松山,2024-08-08,9103
00919,群益台灣精選高息,26,0,26,群益金鼎-松山,2024-08-08,9103
2301,光寶科,22,0,22,群益金鼎-松山,2024-08-08,9103
8064,東捷,25,4,21,群益金鼎-松山,2024-08-08,9103
2313,華通,20,0,20,群益金鼎-松山,2024-08-08,9103
2337,旺宏,40,20,20,群益金鼎-松山,2024-08-08,9103
2349,錸德,60,40,20,群益金鼎-松山,2024-08-08,9103
3715,定穎投控,24,4,20,群益金鼎-松山,2024-08-08,9103
6187,萬潤,20,0,20,群益金鼎-松山,2024-08-08,9103
2353,宏��,20,2,18,群益金鼎-松山,2024-08-08,9103
00940,元大台灣價值高息,16,1,15,群益金鼎-松山,2024-08-08,9103
5481,新華,15,0,15,群益金鼎-松山,2024-08-08,9103
6143,振曜,15,0,15,群益金鼎-松山,2024-08-08,9103
2609,陽明,33,20,13,群益金鼎-松山,2024-08-08,9103
00929,復華台灣科技優息,13,0,13,群益金鼎-松山,2024-08-08,9103
3481,群創,14,1,13,群益金鼎-松山,2024-08-08,9103
2464,盟立,22,10,12,群益金鼎-松山,2024-08-08,9103
2886,兆豐金,15,3,12,群益金鼎-松山,2024-08-08,9103
9906,欣巴巴,12,0,12,群益金鼎-松山,2024-08-08,9103
1522,堤維西,61,50,11,群益金鼎-松山,2024-08-08,9103
5443,均豪,11,0,11,群益金鼎-松山,2024-08-08,9103
2882,國泰金,11,1,10,群益金鼎-松山,2024-08-08,9103
0056,元大高股息,10,0,10,群益金鼎-松山,2024-08-08,9103
2201,裕隆,10,0,10,群益金鼎-松山,2024-08-08,9103
4746,台耀,10,0,10,群益金鼎-松山,2024-08-08,9103
5484,慧友,10,0,10,群益金鼎-松山,2024-08-08,9103
1513,中興電,10,1,9,群益金鼎-松山,2024-08-08,9103
00751B,元大AAA至A公司債,9,0,9,群益金鼎-松山,2024-08-08,9103
4510,高鋒,9,0,9,群益金鼎-松山,2024-08-08,9103
2486,一詮,10,2,8,群益金鼎-松山,2024-08-08,9103
3019,亞光,11,3,8,群益金鼎-松山,2024-08-08,9103
6290,良維,8,0,8,群益金鼎-松山,2024-08-08,9103
1808,潤隆,7,0,7,群益金鼎-松山,2024-08-08,9103
2365,昆盈,103,96,7,群益金鼎-松山,2024-08-08,9103
2368,金像電,10,3,7,群益金鼎-松山,2024-08-08,9103
3312,弘憶股,10,3,7,群益金鼎-松山,2024-08-08,9103
00878,國泰永續高股息,7,1,6,群益金鼎-松山,2024-08-08,9103
2330,台積電,9,3,6,群益金鼎-松山,2024-08-08,9103
00949,復華日本龍頭,6,0,6,群益金鼎-松山,2024-08-08,9103
2485,兆赫,6,0,6,群益金鼎-松山,2024-08-08,9103
2515,中工,6,0,6,群益金鼎-松山,2024-08-08,9103
2618,長榮航,10,4,6,群益金鼎-松山,2024-08-08,9103
2888,新光金,604,2,602,群益金鼎-松山,2024-08-09,9103
2867,三商壽,300,0,300,群益金鼎-松山,2024-08-09,9103
9105,泰金寶-DR,300,0,300,群益金鼎-松山,2024-08-09,9103
00680L,元大美債20正2,203,0,203,群益金鼎-松山,2024-08-09,9103
3481,群創,204,2,202,群益金鼎-松山,2024-08-09,9103
5880,合庫金,150,0,150,群益金鼎-松山,2024-08-09,9103
00929,復華台灣科技優息,67,0,67,群益金鼎-松山,2024-08-09,9103
00720B,元大投資級公司債,55,0,55,群益金鼎-松山,2024-08-09,9103
00632R,元大台灣50反1,50,0,50,群益金鼎-松山,2024-08-09,9103
2881,富邦金,50,0,50,群益金鼎-松山,2024-08-09,9103
00948B,中信優息投資級債,48,0,48,群益金鼎-松山,2024-08-09,9103
2365,昆盈,78,33,45,群益金鼎-松山,2024-08-09,9103
00679B,元大美債20年,42,0,42,群益金鼎-松山,2024-08-09,9103
00937B,群益ESG投等債20,38,0,38,群益金鼎-松山,2024-08-09,9103
00687B,國泰20年美債,36,0,36,群益金鼎-松山,2024-08-09,9103
2362,藍天,73,38,35,群益金鼎-松山,2024-08-09,9103
3044,健鼎,36,1,35,群益金鼎-松山,2024-08-09,9103
2520,冠德,30,0,30,群益金鼎-松山,2024-08-09,9103
3294,英濟,30,0,30,群益金鼎-松山,2024-08-09,9103
00940,元大台灣價值高息,28,0,28,群益金鼎-松山,2024-08-09,9103
9945,潤泰新,22,1,21,群益金鼎-松山,2024-08-09,9103
3260,威剛,31,10,21,群益金鼎-松山,2024-08-09,9103
2301,光寶科,20,0,20,群益金鼎-松山,2024-08-09,9103
6603,富強鑫,20,0,20,群益金鼎-松山,2024-08-09,9103
8089,康全電訊,21,1,20,群益金鼎-松山,2024-08-09,9103
3708,上緯投控,15,0,15,群益金鼎-松山,2024-08-09,9103
2317,鴻海,30,17,13,群益金鼎-松山,2024-08-09,9103
1447,力鵬,15,3,12,群益金鼎-松山,2024-08-09,9103
2609,陽明,62,50,12,群益金鼎-松山,2024-08-09,9103
00931B,統一美債20年,11,0,11,群益金鼎-松山,2024-08-09,9103
00688L,國泰20年美債正2,11,1,10,群益金鼎-松山,2024-08-09,9103
2312,金寶,10,0,10,群益金鼎-松山,2024-08-09,9103
2915,潤泰全,10,0,10,群益金鼎-松山,2024-08-09,9103
3178,公準,11,1,10,群益金鼎-松山,2024-08-09,9103
6112,邁達特,10,0,10,群益金鼎-松山,2024-08-09,9103
2603,長榮,10,1,9,群益金鼎-松山,2024-08-09,9103
1514,亞力,22,13,9,群益金鼎-松山,2024-08-09,9103
3013,晟銘電,21,12,9,群益金鼎-松山,2024-08-09,9103
5309,系統電,10,1,9,群益金鼎-松山,2024-08-09,9103
00725B,國泰投資級公司債,8,0,8,群益金鼎-松山,2024-08-09,9103
1504,東元,8,0,8,群益金鼎-松山,2024-08-09,9103
2511,太子,8,0,8,群益金鼎-松山,2024-08-09,9103
8433,弘帆,8,0,8,群益金鼎-松山,2024-08-09,9103
1597,直得,7,0,7,群益金鼎-松山,2024-08-09,9103
3017,奇鋐,9,2,7,群益金鼎-松山,2024-08-09,9103
3715,定穎投控,30,23,7,群益金鼎-松山,2024-08-09,9103
00904,新光臺灣半導體30,6,0,6,群益金鼎-松山,2024-08-09,9103
2489,瑞軒,11,5,6,群益金鼎-松山,2024-08-09,9103
4979,華星光,6,0,6,群益金鼎-松山,2024-08-09,9103
8084,巨虹,6,0,6,群益金鼎-松山,2024-08-09,9103
00664R,國泰臺灣加權反1,200,0,200,群益金鼎-松山,2024-08-12,9103
2349,錸德,101,0,101,群益金鼎-松山,2024-08-12,9103
3046,建��,50,0,50,群益金鼎-松山,2024-08-12,9103
5880,合庫金,50,0,50,群益金鼎-松山,2024-08-12,9103
2365,昆盈,74,26,48,群益金鼎-松山,2024-08-12,9103
00632R,元大台灣50反1,40,0,40,群益金鼎-松山,2024-08-12,9103
2615,萬海,50,12,38,群益金鼎-松山,2024-08-12,9103
00936,台新永續高息中小,22,0,22,群益金鼎-松山,2024-08-12,9103
6213,聯茂,42,20,22,群益金鼎-松山,2024-08-12,9103
3013,晟銘電,26,5,21,群益金鼎-松山,2024-08-12,9103
00948B,中信優息投資級債,20,0,20,群益金鼎-松山,2024-08-12,9103
2905,三商,20,0,20,群益金鼎-松山,2024-08-12,9103
3019,亞光,45,25,20,群益金鼎-松山,2024-08-12,9103
2204,中華,20,0,20,群益金鼎-松山,2024-08-12,9103
00919,群益台灣精選高息,15,0,15,群益金鼎-松山,2024-08-12,9103
00929,復華台灣科技優息,40,25,15,群益金鼎-松山,2024-08-12,9103
3522,御嵿,15,0,15,群益金鼎-松山,2024-08-12,9103
8349,�矬�,13,1,12,群益金鼎-松山,2024-08-12,9103
00713,元大台灣高息低波,10,0,10,群益金鼎-松山,2024-08-12,9103
00637L,元大滬深300正2,10,0,10,群益金鼎-松山,2024-08-12,9103
00937B,群益ESG投等債20,10,0,10,群益金鼎-松山,2024-08-12,9103
1316,上曜,10,0,10,群益金鼎-松山,2024-08-12,9103
2548,華固,10,0,10,群益金鼎-松山,2024-08-12,9103
3062,建漢,10,0,10,群益金鼎-松山,2024-08-12,9103
4564,元翎,10,0,10,群益金鼎-松山,2024-08-12,9103
6274,台燿,12,2,10,群益金鼎-松山,2024-08-12,9103
2609,陽明,61,52,9,群益金鼎-松山,2024-08-12,9103
5263,智崴,9,0,9,群益金鼎-松山,2024-08-12,9103
2312,金寶,13,5,8,群益金鼎-松山,2024-08-12,9103
3227,原相,9,1,8,群益金鼎-松山,2024-08-12,9103
2359,所羅門,8,1,7,群益金鼎-松山,2024-08-12,9103
3535,晶彩科,8,1,7,群益金鼎-松山,2024-08-12,9103
1612,宏泰,6,0,6,群益金鼎-松山,2024-08-12,9103
2382,廣達,27,21,6,群益金鼎-松山,2024-08-12,9103
4958,臻鼎-KY,6,0,6,群益金鼎-松山,2024-08-12,9103
5425,台半,6,0,6,群益金鼎-松山,2024-08-12,9103
8105,凌巨,16,10,6,群益金鼎-松山,2024-08-12,9103
1519,華城,7,2,5,群益金鼎-松山,2024-08-12,9103
00923,群益台ESG低碳50,5,0,5,群益金鼎-松山,2024-08-12,9103
00688L,國泰20年美債正2,5,0,5,群益金鼎-松山,2024-08-12,9103
2201,裕隆,5,0,5,群益金鼎-松山,2024-08-12,9103
2348,海悅,5,0,5,群益金鼎-松山,2024-08-12,9103
3056,富華新,5,0,5,群益金鼎-松山,2024-08-12,9103
4746,台耀,5,0,5,群益金鼎-松山,2024-08-12,9103
5876,上海商銀,5,0,5,群益金鼎-松山,2024-08-12,9103
2520,冠德,10,5,5,群益金鼎-松山,2024-08-12,9103
00671R,富邦NASDAQ反1,4,0,4,群益金鼎-松山,2024-08-12,9103
1531,高林股,4,0,4,群益金鼎-松山,2024-08-12,9103
2354,鴻準,4,0,4,群益金鼎-松山,2024-08-12,9103
2383,台光電,5,1,4,群益金鼎-松山,2024-08-12,9103
00680L,元大美債20正2,320,0,320,群益金鼎-松山,2024-08-13,9103
1513,中興電,213,2,211,群益金鼎-松山,2024-08-13,9103
2610,華航,200,0,200,群益金鼎-松山,2024-08-13,9103
00632R,元大台灣50反1,110,0,110,群益金鼎-松山,2024-08-13,9103
3481,群創,108,2,106,群益金鼎-松山,2024-08-13,9103
00946,群益科技高息成長,100,0,100,群益金鼎-松山,2024-08-13,9103
00664R,國泰臺灣加權反1,100,0,100,群益金鼎-松山,2024-08-13,9103
00712,復華富時不動產,100,0,100,群益金鼎-松山,2024-08-13,9103
9945,潤泰新,22,0,22,群益金鼎-松山,2024-08-13,9103
00687B,國泰20年美債,21,0,21,群益金鼎-松山,2024-08-13,9103
5443,均豪,33,14,19,群益金鼎-松山,2024-08-13,9103
2915,潤泰全,16,0,16,群益金鼎-松山,2024-08-13,9103
0050,元大台灣50,15,1,14,群益金鼎-松山,2024-08-13,9103
2597,潤弘,14,0,14,群益金鼎-松山,2024-08-13,9103
00919,群益台灣精選高息,15,2,13,群益金鼎-松山,2024-08-13,9103
00907,永豐優息存股,11,0,11,群益金鼎-松山,2024-08-13,9103
2520,冠德,46,35,11,群益金鼎-松山,2024-08-13,9103
2891,中信金,13,3,10,群益金鼎-松山,2024-08-13,9103
00665L,富邦�琤肭磪囓�2,10,0,10,群益金鼎-松山,2024-08-13,9103
6294,智基,10,0,10,群益金鼎-松山,2024-08-13,9103
2352,佳世達,10,1,9,群益金鼎-松山,2024-08-13,9103
00937B,群益ESG投等債20,9,0,9,群益金鼎-松山,2024-08-13,9103
8349,�矬�,10,1,9,群益金鼎-松山,2024-08-13,9103
2603,長榮,22,14,8,群益金鼎-松山,2024-08-13,9103
2330,台積電,10,3,7,群益金鼎-松山,2024-08-13,9103
00940,元大台灣價值高息,6,0,6,群益金鼎-松山,2024-08-13,9103
3289,宜特,6,0,6,群益金鼎-松山,2024-08-13,9103
3339,泰谷,6,0,6,群益金鼎-松山,2024-08-13,9103
00637L,元大滬深300正2,5,0,5,群益金鼎-松山,2024-08-13,9103
00751B,元大AAA至A公司債,5,0,5,群益金鼎-松山,2024-08-13,9103
2324,仁寶,15,10,5,群益金鼎-松山,2024-08-13,9103
2383,台光電,5,0,5,群益金鼎-松山,2024-08-13,9103
2615,萬海,31,26,5,群益金鼎-松山,2024-08-13,9103
2743,山富,5,0,5,群益金鼎-松山,2024-08-13,9103
3036,文曄,5,0,5,群益金鼎-松山,2024-08-13,9103
3056,富華新,5,0,5,群益金鼎-松山,2024-08-13,9103
3227,原相,11,6,5,群益金鼎-松山,2024-08-13,9103
3265,台星科,5,0,5,群益金鼎-松山,2024-08-13,9103
3324,雙鴻,21,16,5,群益金鼎-松山,2024-08-13,9103
4564,元翎,5,0,5,群益金鼎-松山,2024-08-13,9103
6215,和椿,6,1,5,群益金鼎-松山,2024-08-13,9103
6742,澤米,5,0,5,群益金鼎-松山,2024-08-13,9103
8028,昇陽半導體,6,1,5,群益金鼎-松山,2024-08-13,9103
3013,晟銘電,17,13,4,群益金鼎-松山,2024-08-13,9103
2376,技嘉,5,1,4,群益金鼎-松山,2024-08-13,9103
2542,興富發,4,0,4,群益金鼎-松山,2024-08-13,9103
2880,華南金,6,2,4,群益金鼎-松山,2024-08-13,9103
5309,系統電,4,0,4,群益金鼎-松山,2024-08-13,9103
5425,台半,4,0,4,群益金鼎-松山,2024-08-13,9103
5519,隆大,6,2,4,群益金鼎-松山,2024-08-13,9103
2888,新光金,300,2,298,群益金鼎-松山,2024-08-14,9103
00948B,中信優息投資級債,100,0,100,群益金鼎-松山,2024-08-14,9103
2365,昆盈,119,23,96,群益金鼎-松山,2024-08-14,9103
1301,台塑,50,0,50,群益金鼎-松山,2024-08-14,9103
8064,東捷,50,12,38,群益金鼎-松山,2024-08-14,9103
00632R,元大台灣50反1,61,30,31,群益金鼎-松山,2024-08-14,9103
00936,台新永續高息中小,28,2,26,群益金鼎-松山,2024-08-14,9103
00929,復華台灣科技優息,32,10,22,群益金鼎-松山,2024-08-14,9103
8011,台通,22,0,22,群益金鼎-松山,2024-08-14,9103
00892,富邦台灣半導體,20,1,19,群益金鼎-松山,2024-08-14,9103
2324,仁寶,25,6,19,群益金鼎-松山,2024-08-14,9103
6451,訊芯-KY,19,1,18,群益金鼎-松山,2024-08-14,9103
3019,亞光,52,35,17,群益金鼎-松山,2024-08-14,9103
2317,鴻海,51,36,15,群益金鼎-松山,2024-08-14,9103
4555,氣立,15,0,15,群益金鼎-松山,2024-08-14,9103
1101,台泥,13,0,13,群益金鼎-松山,2024-08-14,9103
00900,富邦特選高股息30,13,0,13,群益金鼎-松山,2024-08-14,9103
3522,御嵿,12,0,12,群益金鼎-松山,2024-08-14,9103
4562,穎漢,17,5,12,群益金鼎-松山,2024-08-14,9103
2337,旺宏,11,0,11,群益金鼎-松山,2024-08-14,9103
00679B,元大美債20年,10,0,10,群益金鼎-松山,2024-08-14,9103
00864B,中信美國公債0-1,10,0,10,群益金鼎-松山,2024-08-14,9103
00719B,元大美債1-3,10,0,10,群益金鼎-松山,2024-08-14,9103
00902,中信電池及儲能,10,0,10,群益金鼎-松山,2024-08-14,9103
2362,藍天,50,40,10,群益金鼎-松山,2024-08-14,9103
2442,新美齊,10,0,10,群益金鼎-松山,2024-08-14,9103
6217,中探針,10,0,10,群益金鼎-松山,2024-08-14,9103
9943,好樂迪,10,0,10,群益金鼎-松山,2024-08-14,9103
6968,萬達寵物,9,0,9,群益金鼎-松山,2024-08-14,9103
2356,英業達,7,0,7,群益金鼎-松山,2024-08-14,9103
2359,所羅門,12,5,7,群益金鼎-松山,2024-08-14,9103
00945B,凱基美國非投等債,6,0,6,群益金鼎-松山,2024-08-14,9103
2397,友通,6,0,6,群益金鼎-松山,2024-08-14,9103
3005,神基,6,0,6,群益金鼎-松山,2024-08-14,9103
3036,文曄,6,0,6,群益金鼎-松山,2024-08-14,9103
1536,和大,6,1,5,群益金鼎-松山,2024-08-14,9103
2115,六暉-KY,5,0,5,群益金鼎-松山,2024-08-14,9103
3062,建漢,5,0,5,群益金鼎-松山,2024-08-14,9103
3312,弘憶股,7,2,5,群益金鼎-松山,2024-08-14,9103
6282,康舒,5,0,5,群益金鼎-松山,2024-08-14,9103
6546,正基,5,0,5,群益金鼎-松山,2024-08-14,9103
3260,威剛,5,0,5,群益金鼎-松山,2024-08-14,9103
1815,富喬,5,1,4,群益金鼎-松山,2024-08-14,9103
2524,京城,9,5,4,群益金鼎-松山,2024-08-14,9103
2603,長榮,5,1,4,群益金鼎-松山,2024-08-14,9103
3702,大聯大,4,0,4,群益金鼎-松山,2024-08-14,9103
6244,茂迪,4,0,4,群益金鼎-松山,2024-08-14,9103
8096,擎亞,7,3,4,群益金鼎-松山,2024-08-14,9103
8349,�矬�,5,1,4,群益金鼎-松山,2024-08-14,9103
6446,藥華藥,5,1,4,群益金鼎-松山,2024-08-14,9103
00687B,國泰20年美債,55,0,55,群益金鼎-松山,2024-08-15,9103
00632R,元大台灣50反1,70,20,50,群益金鼎-松山,2024-08-15,9103
00891,中信關鍵半導體,48,0,48,群益金鼎-松山,2024-08-15,9103
00680L,元大美債20正2,40,0,40,群益金鼎-松山,2024-08-15,9103
5905,南仁湖,35,3,32,群益金鼎-松山,2024-08-15,9103
3374,精材,46,16,30,群益金鼎-松山,2024-08-15,9103
4113,聯上,25,0,25,群益金鼎-松山,2024-08-15,9103
1605,華新,24,0,24,群益金鼎-松山,2024-08-15,9103
00679B,元大美債20年,21,0,21,群益金鼎-松山,2024-08-15,9103
00929,復華台灣科技優息,21,1,20,群益金鼎-松山,2024-08-15,9103
00937B,群益ESG投等債20,20,0,20,群益金鼎-松山,2024-08-15,9103
1513,中興電,82,62,20,群益金鼎-松山,2024-08-15,9103
2891,中信金,20,0,20,群益金鼎-松山,2024-08-15,9103
2905,三商,20,0,20,群益金鼎-松山,2024-08-15,9103
2887,台新金,19,1,18,群益金鼎-松山,2024-08-15,9103
9945,潤泰新,20,3,17,群益金鼎-松山,2024-08-15,9103
1799,易威,15,0,15,群益金鼎-松山,2024-08-15,9103
6442,光聖,12,0,12,群益金鼎-松山,2024-08-15,9103
00932,兆豐永續高息等權,11,0,11,群益金鼎-松山,2024-08-15,9103
00923,群益台ESG低碳50,11,0,11,群益金鼎-松山,2024-08-15,9103
2801,彰銀,11,0,11,群益金鼎-松山,2024-08-15,9103
5443,均豪,24,14,10,群益金鼎-松山,2024-08-15,9103
2337,旺宏,10,1,9,群益金鼎-松山,2024-08-15,9103
4540,全球傳動,13,4,9,群益金鼎-松山,2024-08-15,9103
3260,威剛,9,0,9,群益金鼎-松山,2024-08-15,9103
1216,統一,8,0,8,群益金鼎-松山,2024-08-15,9103
2442,新美齊,11,3,8,群益金鼎-松山,2024-08-15,9103
00795B,中信美國公債20年,11,3,8,群益金鼎-松山,2024-08-15,9103
00881,國泰台灣5G+,7,0,7,群益金鼎-松山,2024-08-15,9103
2884,玉山金,7,0,7,群益金鼎-松山,2024-08-15,9103
6186,新潤,8,1,7,群益金鼎-松山,2024-08-15,9103
8349,�矬�,11,4,7,群益金鼎-松山,2024-08-15,9103
00900,富邦特選高股息30,5,0,5,群益金鼎-松山,2024-08-15,9103
2548,華固,5,0,5,群益金鼎-松山,2024-08-15,9103
3532,台勝科,8,3,5,群益金鼎-松山,2024-08-15,9103
3673,TPK-KY,5,0,5,群益金鼎-松山,2024-08-15,9103
4566,時碩工業,9,4,5,群益金鼎-松山,2024-08-15,9103
5484,慧友,5,0,5,群益金鼎-松山,2024-08-15,9103
6282,康舒,5,0,5,群益金鼎-松山,2024-08-15,9103
2353,宏��,5,0,5,群益金鼎-松山,2024-08-15,9103
2352,佳世達,4,0,4,群益金鼎-松山,2024-08-15,9103
2362,藍天,26,22,4,群益金鼎-松山,2024-08-15,9103
3702,大聯大,4,0,4,群益金鼎-松山,2024-08-15,9103
4977,眾達-KY,4,0,4,群益金鼎-松山,2024-08-15,9103
5263,智崴,4,0,4,群益金鼎-松山,2024-08-15,9103
5439,高技,4,0,4,群益金鼎-松山,2024-08-15,9103
2379,瑞昱,3,0,3,群益金鼎-松山,2024-08-15,9103
2489,瑞軒,4,1,3,群益金鼎-松山,2024-08-15,9103
2634,漢翔,3,0,3,群益金鼎-松山,2024-08-15,9103
2845,遠東銀,3,0,3,群益金鼎-松山,2024-08-15,9103
00632R,元大台灣50反1,190,1,189,群益金鼎-松山,2024-08-16,9103
00680L,元大美債20正2,100,0,100,群益金鼎-松山,2024-08-16,9103
2344,華邦電,100,0,100,群益金鼎-松山,2024-08-16,9103
4716,大立,63,0,63,群益金鼎-松山,2024-08-16,9103
9935,慶豐富,51,0,51,群益金鼎-松山,2024-08-16,9103
2312,金寶,54,4,50,群益金鼎-松山,2024-08-16,9103
5263,智崴,45,0,45,群益金鼎-松山,2024-08-16,9103
00706L,期元大S＆P日圓正2,95,60,35,群益金鼎-松山,2024-08-16,9103
6177,達麗,24,0,24,群益金鼎-松山,2024-08-16,9103
00679B,元大美債20年,23,0,23,群益金鼎-松山,2024-08-16,9103
5309,系統電,25,4,21,群益金鼎-松山,2024-08-16,9103
1453,大將,20,0,20,群益金鼎-松山,2024-08-16,9103
1785,光洋科,20,0,20,群益金鼎-松山,2024-08-16,9103
6188,廣明,20,0,20,群益金鼎-松山,2024-08-16,9103
6788,華景電,18,0,18,群益金鼎-松山,2024-08-16,9103
2062,橋椿,34,17,17,群益金鼎-松山,2024-08-16,9103
8071,能率網通,30,13,17,群益金鼎-松山,2024-08-16,9103
00945B,凱基美國非投等債,16,0,16,群益金鼎-松山,2024-08-16,9103
3013,晟銘電,30,15,15,群益金鼎-松山,2024-08-16,9103
2363,矽統,25,14,11,群益金鼎-松山,2024-08-16,9103
2489,瑞軒,11,0,11,群益金鼎-松山,2024-08-16,9103
6244,茂迪,11,0,11,群益金鼎-松山,2024-08-16,9103
00933B,國泰10Y+金融債,10,0,10,群益金鼎-松山,2024-08-16,9103
00688L,國泰20年美債正2,10,0,10,群益金鼎-松山,2024-08-16,9103
1514,亞力,13,3,10,群益金鼎-松山,2024-08-16,9103
1513,中興電,11,1,10,群益金鼎-松山,2024-08-16,9103
2485,兆赫,10,0,10,群益金鼎-松山,2024-08-16,9103
2537,聯上發,10,0,10,群益金鼎-松山,2024-08-16,9103
5534,長虹,10,0,10,群益金鼎-松山,2024-08-16,9103
6742,澤米,10,0,10,群益金鼎-松山,2024-08-16,9103
2486,一詮,14,5,9,群益金鼎-松山,2024-08-16,9103
6143,振曜,10,1,9,群益金鼎-松山,2024-08-16,9103
1609,大亞,12,4,8,群益金鼎-松山,2024-08-16,9103
00878,國泰永續高股息,7,0,7,群益金鼎-松山,2024-08-16,9103
00881,國泰台灣5G+,7,0,7,群益金鼎-松山,2024-08-16,9103
3663,鑫科,11,4,7,群益金鼎-松山,2024-08-16,9103
2374,佳能,6,0,6,群益金鼎-松山,2024-08-16,9103
6021,美好證,6,0,6,群益金鼎-松山,2024-08-16,9103
6869,雲豹能源,6,0,6,群益金鼎-松山,2024-08-16,9103
8096,擎亞,12,6,6,群益金鼎-松山,2024-08-16,9103
00752,中信中國50,5,0,5,群益金鼎-松山,2024-08-16,9103
2324,仁寶,7,2,5,群益金鼎-松山,2024-08-16,9103
2371,大同,5,0,5,群益金鼎-松山,2024-08-16,9103
2520,冠德,5,0,5,群益金鼎-松山,2024-08-16,9103
4104,佳醫,5,0,5,群益金鼎-松山,2024-08-16,9103
5225,東科-KY,5,0,5,群益金鼎-松山,2024-08-16,9103
1709,和益,4,0,4,群益金鼎-松山,2024-08-16,9103
2467,志聖,5,1,4,群益金鼎-松山,2024-08-16,9103
3005,神基,4,0,4,群益金鼎-松山,2024-08-16,9103
3217,優群,4,0,4,群益金鼎-松山,2024-08-16,9103
00929,復華台灣科技優息,86,5,81,群益金鼎-松山,2024-08-19,9103
2892,第一金,77,0,77,群益金鼎-松山,2024-08-19,9103
2542,興富發,61,0,61,群益金鼎-松山,2024-08-19,9103
1522,堤維西,35,0,35,群益金鼎-松山,2024-08-19,9103
3707,漢磊,35,3,32,群益金鼎-松山,2024-08-19,9103
2392,正崴,26,0,26,群益金鼎-松山,2024-08-19,9103
6177,達麗,26,2,24,群益金鼎-松山,2024-08-19,9103
2442,新美齊,20,0,20,群益金鼎-松山,2024-08-19,9103
2545,皇翔,20,0,20,群益金鼎-松山,2024-08-19,9103
4510,高鋒,20,0,20,群益金鼎-松山,2024-08-19,9103
3231,緯創,17,0,17,群益金鼎-松山,2024-08-19,9103
3363,上詮,21,4,17,群益金鼎-松山,2024-08-19,9103
3047,訊舟,21,5,16,群益金鼎-松山,2024-08-19,9103
00725B,國泰投資級公司債,13,0,13,群益金鼎-松山,2024-08-19,9103
00687B,國泰20年美債,13,0,13,群益金鼎-松山,2024-08-19,9103
2915,潤泰全,12,0,12,群益金鼎-松山,2024-08-19,9103
1591,駿吉-KY,11,0,11,群益金鼎-松山,2024-08-19,9103
00720B,元大投資級公司債,10,0,10,群益金鼎-松山,2024-08-19,9103
00706L,期元大S＆P日圓正2,30,20,10,群益金鼎-松山,2024-08-19,9103
1453,大將,10,0,10,群益金鼎-松山,2024-08-19,9103
6269,台郡,10,0,10,群益金鼎-松山,2024-08-19,9103
3062,建漢,12,2,10,群益金鼎-松山,2024-08-19,9103
1101,台泥,10,1,9,群益金鼎-松山,2024-08-19,9103
8112,至上,9,0,9,群益金鼎-松山,2024-08-19,9103
00945B,凱基美國非投等債,8,0,8,群益金鼎-松山,2024-08-19,9103
1605,華新,8,0,8,群益金鼎-松山,2024-08-19,9103
2002,中鋼,10,2,8,群益金鼎-松山,2024-08-19,9103
2359,所羅門,32,24,8,群益金鼎-松山,2024-08-19,9103
5484,慧友,8,0,8,群益金鼎-松山,2024-08-19,9103
2317,鴻海,12,5,7,群益金鼎-松山,2024-08-19,9103
4128,中天,6,0,6,群益金鼎-松山,2024-08-19,9103
1338,廣華-KY,6,0,6,群益金鼎-松山,2024-08-19,9103
00931B,統一美債20年,6,0,6,群益金鼎-松山,2024-08-19,9103
6187,萬潤,6,0,6,群益金鼎-松山,2024-08-19,9103
6415,矽力*-KY,6,0,6,群益金鼎-松山,2024-08-19,9103
00907,永豐優息存股,5,0,5,群益金鼎-松山,2024-08-19,9103
00722B,群益投資級電信債,5,0,5,群益金鼎-松山,2024-08-19,9103
00764B,群益25年美債,5,0,5,群益金鼎-松山,2024-08-19,9103
00933B,國泰10Y+金融債,5,0,5,群益金鼎-松山,2024-08-19,9103
00679B,元大美債20年,6,1,5,群益金鼎-松山,2024-08-19,9103
2388,威盛,5,0,5,群益金鼎-松山,2024-08-19,9103
2420,新巨,5,0,5,群益金鼎-松山,2024-08-19,9103
3013,晟銘電,15,10,5,群益金鼎-松山,2024-08-19,9103
3036,文曄,5,0,5,群益金鼎-松山,2024-08-19,9103
3491,昇達科,5,0,5,群益金鼎-松山,2024-08-19,9103
3702,大聯大,5,0,5,群益金鼎-松山,2024-08-19,9103
2365,昆盈,36,32,4,群益金鼎-松山,2024-08-19,9103
2464,盟立,23,19,4,群益金鼎-松山,2024-08-19,9103
3522,御嵿,4,0,4,群益金鼎-松山,2024-08-19,9103
4562,穎漢,15,11,4,群益金鼎-松山,2024-08-19,9103
2330,台積電,151,11,140,群益金鼎-松山,2024-08-20,9103
2883,凱基金,129,7,122,群益金鼎-松山,2024-08-20,9103
00664R,國泰臺灣加權反1,103,0,103,群益金鼎-松山,2024-08-20,9103
00882,中信中國高股息,100,0,100,群益金鼎-松山,2024-08-20,9103
2374,佳能,147,50,97,群益金鼎-松山,2024-08-20,9103
3357,臺慶科,217,121,96,群益金鼎-松山,2024-08-20,9103
3450,聯鈞,75,2,73,群益金鼎-松山,2024-08-20,9103
8086,宏捷科,50,0,50,群益金鼎-松山,2024-08-20,9103
00687B,國泰20年美債,46,0,46,群益金鼎-松山,2024-08-20,9103
2888,新光金,573,530,43,群益金鼎-松山,2024-08-20,9103
2520,冠德,41,0,41,群益金鼎-松山,2024-08-20,9103
3167,大量,43,4,39,群益金鼎-松山,2024-08-20,9103
4303,信立,37,0,37,群益金鼎-松山,2024-08-20,9103
6164,華興,30,0,30,群益金鼎-松山,2024-08-20,9103
3689,湧德,40,11,29,群益金鼎-松山,2024-08-20,9103
2485,兆赫,25,0,25,群益金鼎-松山,2024-08-20,9103
2070,精湛,24,0,24,群益金鼎-松山,2024-08-20,9103
2453,凌群,20,0,20,群益金鼎-松山,2024-08-20,9103
2354,鴻準,45,29,16,群益金鼎-松山,2024-08-20,9103
6442,光聖,15,0,15,群益金鼎-松山,2024-08-20,9103
00929,復華台灣科技優息,17,3,14,群益金鼎-松山,2024-08-20,9103
2367,燿華,12,0,12,群益金鼎-松山,2024-08-20,9103
2038,海光,12,0,12,群益金鼎-松山,2024-08-20,9103
3707,漢磊,28,16,12,群益金鼎-松山,2024-08-20,9103
00937B,群益ESG投等債20,12,1,11,群益金鼎-松山,2024-08-20,9103
2515,中工,11,0,11,群益金鼎-松山,2024-08-20,9103
3312,弘憶股,13,2,11,群益金鼎-松山,2024-08-20,9103
6505,台塑化,10,0,10,群益金鼎-松山,2024-08-20,9103
00948B,中信優息投資級債,10,0,10,群益金鼎-松山,2024-08-20,9103
00706L,期元大S＆P日圓正2,10,0,10,群益金鼎-松山,2024-08-20,9103
2352,佳世達,10,0,10,群益金鼎-松山,2024-08-20,9103
2442,新美齊,10,0,10,群益金鼎-松山,2024-08-20,9103
2615,萬海,10,0,10,群益金鼎-松山,2024-08-20,9103
9958,世紀鋼,20,10,10,群益金鼎-松山,2024-08-20,9103
00679B,元大美債20年,9,0,9,群益金鼎-松山,2024-08-20,9103
5347,世界,10,1,9,群益金鼎-松山,2024-08-20,9103
3062,建漢,9,1,8,群益金鼎-松山,2024-08-20,9103
3663,鑫科,11,3,8,群益金鼎-松山,2024-08-20,9103
4958,臻鼎-KY,8,0,8,群益金鼎-松山,2024-08-20,9103
5203,訊連,9,1,8,群益金鼎-松山,2024-08-20,9103
6125,廣運,19,11,8,群益金鼎-松山,2024-08-20,9103
2486,一詮,11,4,7,群益金鼎-松山,2024-08-20,9103
2317,鴻海,12,5,7,群益金鼎-松山,2024-08-20,9103
4909,新復興,6,0,6,群益金鼎-松山,2024-08-20,9103
2449,京元電子,6,0,6,群益金鼎-松山,2024-08-20,9103
2489,瑞軒,19,13,6,群益金鼎-松山,2024-08-20,9103
2618,長榮航,6,0,6,群益金鼎-松山,2024-08-20,9103
3339,泰谷,6,0,6,群益金鼎-松山,2024-08-20,9103
2356,英業達,6,1,5,群益金鼎-松山,2024-08-20,9103
6806,森崴能源,5,0,5,群益金鼎-松山,2024-08-20,9103
2888,新光金,880,599,281,群益金鼎-松山,2024-08-21,9103
5309,系統電,129,14,115,群益金鼎-松山,2024-08-21,9103
9105,泰金寶-DR,206,102,104,群益金鼎-松山,2024-08-21,9103
6757,台灣虎航,75,0,75,群益金鼎-松山,2024-08-21,9103
3686,達能,74,2,72,群益金鼎-松山,2024-08-21,9103
2891,中信金,54,0,54,群益金鼎-松山,2024-08-21,9103
00878,國泰永續高股息,36,0,36,群益金鼎-松山,2024-08-21,9103
00919,群益台灣精選高息,31,0,31,群益金鼎-松山,2024-08-21,9103
00795B,中信美國公債20年,30,0,30,群益金鼎-松山,2024-08-21,9103
3707,漢磊,30,1,29,群益金鼎-松山,2024-08-21,9103
00688L,國泰20年美債正2,21,0,21,群益金鼎-松山,2024-08-21,9103
4526,東台,21,0,21,群益金鼎-松山,2024-08-21,9103
4760,勤凱,21,0,21,群益金鼎-松山,2024-08-21,9103
00632R,元大台灣50反1,40,20,20,群益金鼎-松山,2024-08-21,9103
00927,群益半導體收益,20,0,20,群益金鼎-松山,2024-08-21,9103
2374,佳能,20,0,20,群益金鼎-松山,2024-08-21,9103
2417,圓剛,22,2,20,群益金鼎-松山,2024-08-21,9103
6570,維田,20,0,20,群益金鼎-松山,2024-08-21,9103
5443,均豪,43,23,20,群益金鼎-松山,2024-08-21,9103
8440,綠電,49,32,17,群益金鼎-松山,2024-08-21,9103
2317,鴻海,17,1,16,群益金鼎-松山,2024-08-21,9103
4174,浩鼎,15,0,15,群益金鼎-松山,2024-08-21,9103
2330,台積電,15,0,15,群益金鼎-松山,2024-08-21,9103
3227,原相,14,0,14,群益金鼎-松山,2024-08-21,9103
6664,群翊,12,0,12,群益金鼎-松山,2024-08-21,9103
00945B,凱基美國非投等債,11,0,11,群益金鼎-松山,2024-08-21,9103
2442,新美齊,11,0,11,群益金鼎-松山,2024-08-21,9103
2337,旺宏,10,0,10,群益金鼎-松山,2024-08-21,9103
1609,大亞,10,0,10,群益金鼎-松山,2024-08-21,9103
00665L,富邦�琤肭磪囓�2,10,0,10,群益金鼎-松山,2024-08-21,9103
00881,國泰台灣5G+,10,0,10,群益金鼎-松山,2024-08-21,9103
00937B,群益ESG投等債20,10,0,10,群益金鼎-松山,2024-08-21,9103
1718,中纖,10,0,10,群益金鼎-松山,2024-08-21,9103
2634,漢翔,10,0,10,群益金鼎-松山,2024-08-21,9103
2897,王道銀行,10,0,10,群益金鼎-松山,2024-08-21,9103
4979,華星光,11,1,10,群益金鼎-松山,2024-08-21,9103
5525,順天,10,0,10,群益金鼎-松山,2024-08-21,9103
8182,加高,10,0,10,群益金鼎-松山,2024-08-21,9103
00923,群益台ESG低碳50,9,0,9,群益金鼎-松山,2024-08-21,9103
2356,英業達,9,0,9,群益金鼎-松山,2024-08-21,9103
5905,南仁湖,11,2,9,群益金鼎-松山,2024-08-21,9103
6269,台郡,9,0,9,群益金鼎-松山,2024-08-21,9103
8104,錸寶,21,12,9,群益金鼎-松山,2024-08-21,9103
3450,聯鈞,16,8,8,群益金鼎-松山,2024-08-21,9103
4564,元翎,8,0,8,群益金鼎-松山,2024-08-21,9103
8064,東捷,10,4,6,群益金鼎-松山,2024-08-21,9103
1338,廣華-KY,5,0,5,群益金鼎-松山,2024-08-21,9103
2020,美亞,5,0,5,群益金鼎-松山,2024-08-21,9103
2420,新巨,5,0,5,群益金鼎-松山,2024-08-21,9103
2485,兆赫,5,0,5,群益金鼎-松山,2024-08-21,9103
8096,擎亞,127,5,122,群益金鼎-松山,2024-08-22,9103
2409,友達,100,0,100,群益金鼎-松山,2024-08-22,9103
1316,上曜,82,1,81,群益金鼎-松山,2024-08-22,9103
00937B,群益ESG投等債20,40,2,38,群益金鼎-松山,2024-08-22,9103
00953B,群益優選非投等債,34,0,34,群益金鼎-松山,2024-08-22,9103
2349,錸德,120,87,33,群益金鼎-松山,2024-08-22,9103
1609,大亞,32,0,32,群益金鼎-松山,2024-08-22,9103
1608,華榮,30,0,30,群益金鼎-松山,2024-08-22,9103
8089,康全電訊,30,3,27,群益金鼎-松山,2024-08-22,9103
6570,維田,21,0,21,群益金鼎-松山,2024-08-22,9103
8043,蜜望實,21,0,21,群益金鼎-松山,2024-08-22,9103
00945B,凱基美國非投等債,18,0,18,群益金鼎-松山,2024-08-22,9103
1503,士電,19,1,18,群益金鼎-松山,2024-08-22,9103
1773,勝一,12,0,12,群益金鼎-松山,2024-08-22,9103
2062,橋椿,13,2,11,群益金鼎-松山,2024-08-22,9103
1714,和桐,10,0,10,群益金鼎-松山,2024-08-22,9103
2353,宏��,10,0,10,群益金鼎-松山,2024-08-22,9103
2515,中工,10,0,10,群益金鼎-松山,2024-08-22,9103
8182,加高,10,0,10,群益金鼎-松山,2024-08-22,9103
1808,潤隆,9,0,9,群益金鼎-松山,2024-08-22,9103
6133,金橋,9,0,9,群益金鼎-松山,2024-08-22,9103
6224,聚鼎,10,1,9,群益金鼎-松山,2024-08-22,9103
6462,神盾,9,0,9,群益金鼎-松山,2024-08-22,9103
5364,力麗店,8,0,8,群益金鼎-松山,2024-08-22,9103
6125,廣運,18,10,8,群益金鼎-松山,2024-08-22,9103
2317,鴻海,21,14,7,群益金鼎-松山,2024-08-22,9103
1513,中興電,7,1,6,群益金鼎-松山,2024-08-22,9103
3665,貿聯-KY,7,1,6,群益金鼎-松山,2024-08-22,9103
1605,華新,5,0,5,群益金鼎-松山,2024-08-22,9103
00919,群益台灣精選高息,5,0,5,群益金鼎-松山,2024-08-22,9103
00881,國泰台灣5G+,5,0,5,群益金鼎-松山,2024-08-22,9103
2484,希華,5,0,5,群益金鼎-松山,2024-08-22,9103
3673,TPK-KY,5,0,5,群益金鼎-松山,2024-08-22,9103
5525,順天,5,0,5,群益金鼎-松山,2024-08-22,9103
6182,合晶,5,0,5,群益金鼎-松山,2024-08-22,9103
6757,台灣虎航,5,0,5,群益金鼎-松山,2024-08-22,9103
8367,建新國際,5,0,5,群益金鼎-松山,2024-08-22,9103
2330,台積電,5,0,5,群益金鼎-松山,2024-08-22,9103
2542,興富發,6,2,4,群益金鼎-松山,2024-08-22,9103
3019,亞光,7,3,4,群益金鼎-松山,2024-08-22,9103
5469,瀚宇博,4,0,4,群益金鼎-松山,2024-08-22,9103
8349,�矬�,7,3,4,群益金鼎-松山,2024-08-22,9103
1708,東鹼,3,0,3,群益金鼎-松山,2024-08-22,9103
00715L,期街口布蘭特正2,3,0,3,群益金鼎-松山,2024-08-22,9103
2312,金寶,3,0,3,群益金鼎-松山,2024-08-22,9103
2467,志聖,6,3,3,群益金鼎-松山,2024-08-22,9103
3073,天方能源,3,0,3,群益金鼎-松山,2024-08-22,9103
4162,智擎,3,0,3,群益金鼎-松山,2024-08-22,9103
4303,信立,3,0,3,群益金鼎-松山,2024-08-22,9103
8028,昇陽半導體,13,10,3,群益金鼎-松山,2024-08-22,9103
2888,新光金,866,517,349,群益金鼎-松山,2024-08-23,9103
00664R,國泰臺灣加權反1,100,0,100,群益金鼎-松山,2024-08-23,9103
8039,台虹,60,2,58,群益金鼎-松山,2024-08-23,9103
00680L,元大美債20正2,55,0,55,群益金鼎-松山,2024-08-23,9103
1314,中石化,50,0,50,群益金鼎-松山,2024-08-23,9103
2349,錸德,31,0,31,群益金鼎-松山,2024-08-23,9103
3189,景碩,35,7,28,群益金鼎-松山,2024-08-23,9103
3363,上詮,38,12,26,群益金鼎-松山,2024-08-23,9103
00632R,元大台灣50反1,20,0,20,群益金鼎-松山,2024-08-23,9103
3498,陽程,20,0,20,群益金鼎-松山,2024-08-23,9103
6213,聯茂,21,1,20,群益金鼎-松山,2024-08-23,9103
5263,智崴,18,1,17,群益金鼎-松山,2024-08-23,9103
2330,台積電,17,1,16,群益金鼎-松山,2024-08-23,9103
00956,中信日經高股息,16,0,16,群益金鼎-松山,2024-08-23,9103
4174,浩鼎,17,1,16,群益金鼎-松山,2024-08-23,9103
2891,中信金,16,0,16,群益金鼎-松山,2024-08-23,9103
00687B,國泰20年美債,15,0,15,群益金鼎-松山,2024-08-23,9103
2887,台新金,14,1,13,群益金鼎-松山,2024-08-23,9103
1711,永光,25,14,11,群益金鼎-松山,2024-08-23,9103
00688L,國泰20年美債正2,11,0,11,群益金鼎-松山,2024-08-23,9103
2392,正崴,11,0,11,群益金鼎-松山,2024-08-23,9103
3580,友威科,26,15,11,群益金鼎-松山,2024-08-23,9103
6505,台塑化,10,0,10,群益金鼎-松山,2024-08-23,9103
6770,力積電,10,0,10,群益金鼎-松山,2024-08-23,9103
2317,鴻海,14,4,10,群益金鼎-松山,2024-08-23,9103
00955,中信日本商社,8,0,8,群益金鼎-松山,2024-08-23,9103
3583,辛耘,14,6,8,群益金鼎-松山,2024-08-23,9103
8071,能率網通,20,12,8,群益金鼎-松山,2024-08-23,9103
2464,盟立,22,15,7,群益金鼎-松山,2024-08-23,9103
3615,安可,11,4,7,群益金鼎-松山,2024-08-23,9103
00919,群益台灣精選高息,6,0,6,群益金鼎-松山,2024-08-23,9103
00715L,期街口布蘭特正2,6,0,6,群益金鼎-松山,2024-08-23,9103
2438,翔耀,6,0,6,群益金鼎-松山,2024-08-23,9103
00940,元大台灣價值高息,5,0,5,群益金鼎-松山,2024-08-23,9103
6244,茂迪,5,0,5,群益金鼎-松山,2024-08-23,9103
00896,中信綠能及電動車,5,0,5,群益金鼎-松山,2024-08-23,9103
00881,國泰台灣5G+,5,0,5,群益金鼎-松山,2024-08-23,9103
2324,仁寶,15,10,5,群益金鼎-松山,2024-08-23,9103
2537,聯上發,5,0,5,群益金鼎-松山,2024-08-23,9103
3047,訊舟,5,0,5,群益金鼎-松山,2024-08-23,9103
3312,弘憶股,5,0,5,群益金鼎-松山,2024-08-23,9103
3712,永崴投控,5,0,5,群益金鼎-松山,2024-08-23,9103
4953,緯軟,5,0,5,群益金鼎-松山,2024-08-23,9103
5525,順天,5,0,5,群益金鼎-松山,2024-08-23,9103
6207,雷科,5,0,5,群益金鼎-松山,2024-08-23,9103
6224,聚鼎,10,5,5,群益金鼎-松山,2024-08-23,9103
9955,佳龍,5,0,5,群益金鼎-松山,2024-08-23,9103
00751B,元大AAA至A公司債,4,0,4,群益金鼎-松山,2024-08-23,9103
00953B,群益優選非投等債,4,0,4,群益金鼎-松山,2024-08-23,9103
2250,IKKA-KY,4,0,4,群益金鼎-松山,2024-08-23,9103
3481,群創,180,10,170,群益金鼎-松山,2024-08-26,9103
6505,台塑化,120,0,120,群益金鼎-松山,2024-08-26,9103
2867,三商壽,210,100,110,群益金鼎-松山,2024-08-26,9103
2891,中信金,66,1,65,群益金鼎-松山,2024-08-26,9103
8039,台虹,61,0,61,群益金鼎-松山,2024-08-26,9103
2354,鴻準,50,0,50,群益金鼎-松山,2024-08-26,9103
2349,錸德,150,110,40,群益金鼎-松山,2024-08-26,9103
2365,昆盈,33,3,30,群益金鼎-松山,2024-08-26,9103
3707,漢磊,30,0,30,群益金鼎-松山,2024-08-26,9103
6768,志強-KY,25,0,25,群益金鼎-松山,2024-08-26,9103
2882,國泰金,25,2,23,群益金鼎-松山,2024-08-26,9103
5481,新華,21,0,21,群益金鼎-松山,2024-08-26,9103
2615,萬海,20,2,18,群益金鼎-松山,2024-08-26,9103
00929,復華台灣科技優息,15,0,15,群益金鼎-松山,2024-08-26,9103
00894,中信小資高價30,15,0,15,群益金鼎-松山,2024-08-26,9103
2377,微星,14,0,14,群益金鼎-松山,2024-08-26,9103
00881,國泰台灣5G+,12,0,12,群益金鼎-松山,2024-08-26,9103
1785,光洋科,12,1,11,群益金鼎-松山,2024-08-26,9103
3374,精材,13,2,11,群益金鼎-松山,2024-08-26,9103
2603,長榮,10,0,10,群益金鼎-松山,2024-08-26,9103
8354,冠好,10,0,10,群益金鼎-松山,2024-08-26,9103
3081,聯亞,10,2,8,群益金鼎-松山,2024-08-26,9103
8028,昇陽半導體,38,31,7,群益金鼎-松山,2024-08-26,9103
8349,�矬�,16,9,7,群益金鼎-松山,2024-08-26,9103
2542,興富發,7,0,7,群益金鼎-松山,2024-08-26,9103
3581,博磊,6,0,6,群益金鼎-松山,2024-08-26,9103
5306,桂盟,6,0,6,群益金鼎-松山,2024-08-26,9103
6957,裕慶-KY,6,0,6,群益金鼎-松山,2024-08-26,9103
2520,冠德,15,10,5,群益金鼎-松山,2024-08-26,9103
00715L,期街口布蘭特正2,4,0,4,群益金鼎-松山,2024-08-26,9103
1325,恆大,4,0,4,群益金鼎-松山,2024-08-26,9103
2331,精英,4,0,4,群益金鼎-松山,2024-08-26,9103
2438,翔耀,4,0,4,群益金鼎-松山,2024-08-26,9103
2888A,新光金甲特,4,0,4,群益金鼎-松山,2024-08-26,9103
6186,新潤,4,0,4,群益金鼎-松山,2024-08-26,9103
9945,潤泰新,5,1,4,群益金鼎-松山,2024-08-26,9103
1216,統一,3,0,3,群益金鼎-松山,2024-08-26,9103
2312,金寶,6,3,3,群益金鼎-松山,2024-08-26,9103
2401,凌陽,3,0,3,群益金鼎-松山,2024-08-26,9103
3019,亞光,3,0,3,群益金鼎-松山,2024-08-26,9103
3231,緯創,4,1,3,群益金鼎-松山,2024-08-26,9103
3324,雙鴻,6,3,3,群益金鼎-松山,2024-08-26,9103
3673,TPK-KY,3,0,3,群益金鼎-松山,2024-08-26,9103
3694,海華,3,0,3,群益金鼎-松山,2024-08-26,9103
5009,榮剛,3,0,3,群益金鼎-松山,2024-08-26,9103
5364,力麗店,3,0,3,群益金鼎-松山,2024-08-26,9103
8043,蜜望實,3,0,3,群益金鼎-松山,2024-08-26,9103
8367,建新國際,3,0,3,群益金鼎-松山,2024-08-26,9103
8374,羅昇,3,0,3,群益金鼎-松山,2024-08-26,9103
8438,昶昕,3,0,3,群益金鼎-松山,2024-08-26,9103
1314,中石化,250,80,170,群益金鼎-松山,2024-08-27,9103
2891,中信金,111,0,111,群益金鼎-松山,2024-08-27,9103
2409,友達,100,0,100,群益金鼎-松山,2024-08-27,9103
8070,長華*,64,1,63,群益金鼎-松山,2024-08-27,9103
2888,新光金,60,8,52,群益金鼎-松山,2024-08-27,9103
2464,盟立,45,4,41,群益金鼎-松山,2024-08-27,9103
3686,達能,41,0,41,群益金鼎-松山,2024-08-27,9103
6213,聯茂,41,0,41,群益金鼎-松山,2024-08-27,9103
2365,昆盈,57,25,32,群益金鼎-松山,2024-08-27,9103
2402,毅嘉,30,0,30,群益金鼎-松山,2024-08-27,9103
8937,合騏,30,0,30,群益金鼎-松山,2024-08-27,9103
5392,能率,20,0,20,群益金鼎-松山,2024-08-27,9103
3498,陽程,30,12,18,群益金鼎-松山,2024-08-27,9103
3379,彬台,16,0,16,群益金鼎-松山,2024-08-27,9103
5484,慧友,15,0,15,群益金鼎-松山,2024-08-27,9103
2359,所羅門,25,10,15,群益金鼎-松山,2024-08-27,9103
00688L,國泰20年美債正2,13,0,13,群益金鼎-松山,2024-08-27,9103
00680L,元大美債20正2,13,0,13,群益金鼎-松山,2024-08-27,9103
5876,上海商銀,12,0,12,群益金鼎-松山,2024-08-27,9103
1519,華城,13,2,11,群益金鼎-松山,2024-08-27,9103
00929,復華台灣科技優息,11,0,11,群益金鼎-松山,2024-08-27,9103
2324,仁寶,15,5,10,群益金鼎-松山,2024-08-27,9103
3492,長盛,10,0,10,群益金鼎-松山,2024-08-27,9103
3663,鑫科,28,18,10,群益金鼎-松山,2024-08-27,9103
4906,正文,10,0,10,群益金鼎-松山,2024-08-27,9103
6125,廣運,10,0,10,群益金鼎-松山,2024-08-27,9103
8440,綠電,10,0,10,群益金鼎-松山,2024-08-27,9103
2524,京城,20,10,10,群益金鼎-松山,2024-08-27,9103
3481,群創,117,108,9,群益金鼎-松山,2024-08-27,9103
3149,正達,30,22,8,群益金鼎-松山,2024-08-27,9103
6244,茂迪,7,0,7,群益金鼎-松山,2024-08-27,9103
2317,鴻海,7,0,7,群益金鼎-松山,2024-08-27,9103
2610,華航,6,0,6,群益金鼎-松山,2024-08-27,9103
3680,家登,7,1,6,群益金鼎-松山,2024-08-27,9103
5203,訊連,6,0,6,群益金鼎-松山,2024-08-27,9103
6869,雲豹能源,6,0,6,群益金鼎-松山,2024-08-27,9103
8043,蜜望實,7,1,6,群益金鼎-松山,2024-08-27,9103
2383,台光電,6,1,5,群益金鼎-松山,2024-08-27,9103
2465,麗臺,5,0,5,群益金鼎-松山,2024-08-27,9103
2609,陽明,5,0,5,群益金鼎-松山,2024-08-27,9103
3073,天方能源,10,5,5,群益金鼎-松山,2024-08-27,9103
5309,系統電,5,0,5,群益金鼎-松山,2024-08-27,9103
5351,鈺創,5,0,5,群益金鼎-松山,2024-08-27,9103
6186,新潤,5,0,5,群益金鼎-松山,2024-08-27,9103
6187,萬潤,8,3,5,群益金鼎-松山,2024-08-27,9103
6269,台郡,5,0,5,群益金鼎-松山,2024-08-27,9103
2887,台新金,4,0,4,群益金鼎-松山,2024-08-27,9103
2330,台積電,6,2,4,群益金鼎-松山,2024-08-27,9103
2354,鴻準,4,0,4,群益金鼎-松山,2024-08-27,9103
2603,長榮,4,0,4,群益金鼎-松山,2024-08-27,9103
2891,中信金,379,2,377,群益金鼎-松山,2024-08-28,9103
3481,群創,282,111,171,群益金鼎-松山,2024-08-28,9103
5225,東科-KY,42,1,41,群益金鼎-松山,2024-08-28,9103
4534,慶騰,30,0,30,群益金鼎-松山,2024-08-28,9103
020033,統一�琤肮黕篾,23,0,23,群益金鼎-松山,2024-08-28,9103
2313,華通,33,11,22,群益金鼎-松山,2024-08-28,9103
00706L,期元大S＆P日圓正2,20,0,20,群益金鼎-松山,2024-08-28,9103
2867,三商壽,20,0,20,群益金鼎-松山,2024-08-28,9103
6143,振曜,32,12,20,群益金鼎-松山,2024-08-28,9103
8473,山林水,20,0,20,群益金鼎-松山,2024-08-28,9103
2317,鴻海,28,12,16,群益金鼎-松山,2024-08-28,9103
00953B,群益優選非投等債,16,0,16,群益金鼎-松山,2024-08-28,9103
2324,仁寶,15,0,15,群益金鼎-松山,2024-08-28,9103
5443,均豪,28,14,14,群益金鼎-松山,2024-08-28,9103
5481,新華,13,0,13,群益金鼎-松山,2024-08-28,9103
3483,力致,12,0,12,群益金鼎-松山,2024-08-28,9103
9958,世紀鋼,12,0,12,群益金鼎-松山,2024-08-28,9103
2888,新光金,21,10,11,群益金鼎-松山,2024-08-28,9103
8091,翔名,11,0,11,群益金鼎-松山,2024-08-28,9103
00936,台新永續高息中小,10,0,10,群益金鼎-松山,2024-08-28,9103
4562,穎漢,64,54,10,群益金鼎-松山,2024-08-28,9103
5234,達興材料,9,0,9,群益金鼎-松山,2024-08-28,9103
00941,中信上游半導體,10,2,8,群益金鼎-松山,2024-08-28,9103
8182,加高,7,0,7,群益金鼎-松山,2024-08-28,9103
8374,羅昇,22,15,7,群益金鼎-松山,2024-08-28,9103
00919,群益台灣精選高息,6,0,6,群益金鼎-松山,2024-08-28,9103
00881,國泰台灣5G+,6,0,6,群益金鼎-松山,2024-08-28,9103
00940,元大台灣價值高息,5,0,5,群益金鼎-松山,2024-08-28,9103
00679B,元大美債20年,5,0,5,群益金鼎-松山,2024-08-28,9103
00713,元大台灣高息低波,5,0,5,群益金鼎-松山,2024-08-28,9103
2401,凌陽,5,0,5,群益金鼎-松山,2024-08-28,9103
2467,志聖,19,14,5,群益金鼎-松山,2024-08-28,9103
2520,冠德,25,20,5,群益金鼎-松山,2024-08-28,9103
2542,興富發,5,0,5,群益金鼎-松山,2024-08-28,9103
3010,華立,5,0,5,群益金鼎-松山,2024-08-28,9103
3231,緯創,5,0,5,群益金鼎-松山,2024-08-28,9103
3673,TPK-KY,7,2,5,群益金鼎-松山,2024-08-28,9103
6757,台灣虎航,5,0,5,群益金鼎-松山,2024-08-28,9103
2354,鴻準,4,0,4,群益金鼎-松山,2024-08-28,9103
3078,僑威,4,0,4,群益金鼎-松山,2024-08-28,9103
5251,天鉞電,5,1,4,群益金鼎-松山,2024-08-28,9103
6016,康和證,4,0,4,群益金鼎-松山,2024-08-28,9103
00680L,元大美債20正2,3,0,3,群益金鼎-松山,2024-08-28,9103
2540,愛山林,3,0,3,群益金鼎-松山,2024-08-28,9103
3522,御嵿,3,0,3,群益金鼎-松山,2024-08-28,9103
3545,敦泰,6,3,3,群益金鼎-松山,2024-08-28,9103
4729,熒茂,3,0,3,群益金鼎-松山,2024-08-28,9103
5905,南仁湖,5,2,3,群益金鼎-松山,2024-08-28,9103
6139,亞翔,5,2,3,群益金鼎-松山,2024-08-28,9103
6187,萬潤,9,6,3,群益金鼎-松山,2024-08-28,9103
1314,中石化,150,5,145,群益金鼎-松山,2024-08-29,9103
3481,群創,106,2,104,群益金鼎-松山,2024-08-29,9103
4563,百德,101,0,101,群益金鼎-松山,2024-08-29,9103
00664R,國泰臺灣加權反1,100,0,100,群益金鼎-松山,2024-08-29,9103
1727,中華化,63,2,61,群益金鼎-松山,2024-08-29,9103
2402,毅嘉,61,0,61,群益金鼎-松山,2024-08-29,9103
2891,中信金,64,4,60,群益金鼎-松山,2024-08-29,9103
1316,上曜,112,60,52,群益金鼎-松山,2024-08-29,9103
3011,今皓,51,0,51,群益金鼎-松山,2024-08-29,9103
2867,三商壽,50,0,50,群益金鼎-松山,2024-08-29,9103
2881,富邦金,47,0,47,群益金鼎-松山,2024-08-29,9103
4303,信立,48,3,45,群益金鼎-松山,2024-08-29,9103
4526,東台,60,26,34,群益金鼎-松山,2024-08-29,9103
2618,長榮航,40,7,33,群益金鼎-松山,2024-08-29,9103
2537,聯上發,60,30,30,群益金鼎-松山,2024-08-29,9103
3294,英濟,30,0,30,群益金鼎-松山,2024-08-29,9103
6603,富強鑫,30,0,30,群益金鼎-松山,2024-08-29,9103
8064,東捷,31,3,28,群益金鼎-松山,2024-08-29,9103
2313,華通,36,11,25,群益金鼎-松山,2024-08-29,9103
1453,大將,20,0,20,群益金鼎-松山,2024-08-29,9103
2431,聯昌,20,0,20,群益金鼎-松山,2024-08-29,9103
2520,冠德,40,20,20,群益金鼎-松山,2024-08-29,9103
4174,浩鼎,20,1,19,群益金鼎-松山,2024-08-29,9103
4909,新復興,34,18,16,群益金鼎-松山,2024-08-29,9103
2330,台積電,27,11,16,群益金鼎-松山,2024-08-29,9103
00706L,期元大S＆P日圓正2,55,40,15,群益金鼎-松山,2024-08-29,9103
1718,中纖,10,0,10,群益金鼎-松山,2024-08-29,9103
2340,台亞,10,0,10,群益金鼎-松山,2024-08-29,9103
3580,友威科,12,2,10,群益金鼎-松山,2024-08-29,9103
6147,頎邦,10,0,10,群益金鼎-松山,2024-08-29,9103
8050,廣積,10,0,10,群益金鼎-松山,2024-08-29,9103
00830,國泰費城半導體,9,0,9,群益金鼎-松山,2024-08-29,9103
5234,達興材料,9,0,9,群益金鼎-松山,2024-08-29,9103
6679,鈺太,9,0,9,群益金鼎-松山,2024-08-29,9103
8091,翔名,9,0,9,群益金鼎-松山,2024-08-29,9103
00936,台新永續高息中小,7,0,7,群益金鼎-松山,2024-08-29,9103
2383,台光電,8,1,7,群益金鼎-松山,2024-08-29,9103
00679B,元大美債20年,6,0,6,群益金鼎-松山,2024-08-29,9103
2401,凌陽,6,0,6,群益金鼎-松山,2024-08-29,9103
3265,台星科,6,0,6,群益金鼎-松山,2024-08-29,9103
6143,振曜,26,20,6,群益金鼎-松山,2024-08-29,9103
8028,昇陽半導體,25,19,6,群益金鼎-松山,2024-08-29,9103
1540,喬福,5,0,5,群益金鼎-松山,2024-08-29,9103
00923,群益台ESG低碳50,5,0,5,群益金鼎-松山,2024-08-29,9103
5481,新華,5,0,5,群益金鼎-松山,2024-08-29,9103
5876,上海商銀,5,0,5,群益金鼎-松山,2024-08-29,9103
6187,萬潤,9,4,5,群益金鼎-松山,2024-08-29,9103
3324,雙鴻,4,0,4,群益金鼎-松山,2024-08-29,9103
00680L,元大美債20正2,4,0,4,群益金鼎-松山,2024-08-29,9103
3019,亞光,5,1,4,群益金鼎-松山,2024-08-29,9103
2891,中信金,217,0,217,群益金鼎-松山,2024-08-30,9103
1314,中石化,100,0,100,群益金鼎-松山,2024-08-30,9103
00882,中信中國高股息,100,0,100,群益金鼎-松山,2024-08-30,9103
00830,國泰費城半導體,50,0,50,群益金鼎-松山,2024-08-30,9103
1785,光洋科,62,12,50,群益金鼎-松山,2024-08-30,9103
3363,上詮,52,5,47,群益金鼎-松山,2024-08-30,9103
4958,臻鼎-KY,32,1,31,群益金鼎-松山,2024-08-30,9103
2425,承啟,33,3,30,群益金鼎-松山,2024-08-30,9103
2545,皇翔,30,0,30,群益金鼎-松山,2024-08-30,9103
2605,新興,30,0,30,群益金鼎-松山,2024-08-30,9103
3706,神達,30,0,30,群益金鼎-松山,2024-08-30,9103
6245,立端,30,0,30,群益金鼎-松山,2024-08-30,9103
2520,冠德,25,0,25,群益金鼎-松山,2024-08-30,9103
1453,大將,23,0,23,群益金鼎-松山,2024-08-30,9103
2362,藍天,22,0,22,群益金鼎-松山,2024-08-30,9103
2330,台積電,30,10,20,群益金鼎-松山,2024-08-30,9103
00946,群益科技高息成長,20,0,20,群益金鼎-松山,2024-08-30,9103
2363,矽統,25,6,19,群益金鼎-松山,2024-08-30,9103
3450,聯鈞,31,16,15,群益金鼎-松山,2024-08-30,9103
3707,漢磊,15,0,15,群益金鼎-松山,2024-08-30,9103
1711,永光,68,55,13,群益金鼎-松山,2024-08-30,9103
8182,加高,12,0,12,群益金鼎-松山,2024-08-30,9103
3017,奇鋐,10,0,10,群益金鼎-松山,2024-08-30,9103
3374,精材,10,0,10,群益金鼎-松山,2024-08-30,9103
6509,聚和,10,0,10,群益金鼎-松山,2024-08-30,9103
00918,大華優利高填息30,9,0,9,群益金鼎-松山,2024-08-30,9103
8085,福華,15,6,9,群益金鼎-松山,2024-08-30,9103
6770,力積電,8,0,8,群益金鼎-松山,2024-08-30,9103
6143,振曜,22,16,6,群益金鼎-松山,2024-08-30,9103
2618,長榮航,8,2,6,群益金鼎-松山,2024-08-30,9103
6215,和椿,24,18,6,群益金鼎-松山,2024-08-30,9103
8349,�矬�,8,2,6,群益金鼎-松山,2024-08-30,9103
00937B,群益ESG投等債20,5,0,5,群益金鼎-松山,2024-08-30,9103
2405,輔信,5,0,5,群益金鼎-松山,2024-08-30,9103
2455,全新,5,0,5,群益金鼎-松山,2024-08-30,9103
2637,慧洋-KY,5,0,5,群益金鼎-松山,2024-08-30,9103
3234,光環,5,0,5,群益金鼎-松山,2024-08-30,9103
4526,東台,7,2,5,群益金鼎-松山,2024-08-30,9103
5876,上海商銀,5,0,5,群益金鼎-松山,2024-08-30,9103
6156,松上,5,0,5,群益金鼎-松山,2024-08-30,9103
6757,台灣虎航,15,10,5,群益金鼎-松山,2024-08-30,9103
3062,建漢,10,6,4,群益金鼎-松山,2024-08-30,9103
3673,TPK-KY,4,0,4,群益金鼎-松山,2024-08-30,9103
4536,拓凱,4,0,4,群益金鼎-松山,2024-08-30,9103
4583,台灣精銳,8,4,4,群益金鼎-松山,2024-08-30,9103
6451,訊芯-KY,12,8,4,群益金鼎-松山,2024-08-30,9103
2401,凌陽,3,0,3,群益金鼎-松山,2024-08-30,9103
5464,霖宏,3,0,3,群益金鼎-松山,2024-08-30,9103
6526,達發,3,0,3,群益金鼎-松山,2024-08-30,9103
6577,勁豐,3,0,3,群益金鼎-松山,2024-08-30,9103
6770,力積電,110,0,110,群益金鼎-松山,2024-09-02,9103
5426,振發,60,0,60,群益金鼎-松山,2024-09-02,9103
2431,聯昌,29,0,29,群益金鼎-松山,2024-09-02,9103
3450,聯鈞,48,21,27,群益金鼎-松山,2024-09-02,9103
2352,佳世達,26,0,26,群益金鼎-松山,2024-09-02,9103
00948B,中信優息投資級債,20,0,20,群益金鼎-松山,2024-09-02,9103
2520,冠德,20,0,20,群益金鼎-松山,2024-09-02,9103
2891,中信金,27,10,17,群益金鼎-松山,2024-09-02,9103
2486,一詮,18,2,16,群益金鼎-松山,2024-09-02,9103
6125,廣運,16,0,16,群益金鼎-松山,2024-09-02,9103
00665L,富邦�琤肭磪囓�2,15,0,15,群益金鼎-松山,2024-09-02,9103
3003,健和興,18,3,15,群益金鼎-松山,2024-09-02,9103
00637L,元大滬深300正2,12,0,12,群益金鼎-松山,2024-09-02,9103
3306,鼎天,11,0,11,群益金鼎-松山,2024-09-02,9103
6658,聯策,12,1,11,群益金鼎-松山,2024-09-02,9103
00919,群益台灣精選高息,20,10,10,群益金鼎-松山,2024-09-02,9103
00632R,元大台灣50反1,10,0,10,群益金鼎-松山,2024-09-02,9103
2312,金寶,10,0,10,群益金鼎-松山,2024-09-02,9103
2392,正崴,10,0,10,群益金鼎-松山,2024-09-02,9103
3010,華立,10,0,10,群益金鼎-松山,2024-09-02,9103
3231,緯創,10,0,10,群益金鼎-松山,2024-09-02,9103
3588,通嘉,10,0,10,群益金鼎-松山,2024-09-02,9103
6757,台灣虎航,10,0,10,群益金鼎-松山,2024-09-02,9103
8086,宏捷科,16,6,10,群益金鼎-松山,2024-09-02,9103
8104,錸寶,10,0,10,群益金鼎-松山,2024-09-02,9103
9907,統一實,10,0,10,群益金鼎-松山,2024-09-02,9103
6186,新潤,10,1,9,群益金鼎-松山,2024-09-02,9103
3374,精材,8,0,8,群益金鼎-松山,2024-09-02,9103
4542,科嶠,7,0,7,群益金鼎-松山,2024-09-02,9103
00688L,國泰20年美債正2,6,0,6,群益金鼎-松山,2024-09-02,9103
2408,南亞科,6,0,6,群益金鼎-松山,2024-09-02,9103
2421,建準,6,0,6,群益金鼎-松山,2024-09-02,9103
3189,景碩,8,2,6,群益金鼎-松山,2024-09-02,9103
2884,玉山金,6,0,6,群益金鼎-松山,2024-09-02,9103
00687B,國泰20年美債,5,0,5,群益金鼎-松山,2024-09-02,9103
00680L,元大美債20正2,5,0,5,群益金鼎-松山,2024-09-02,9103
2383,台光電,7,2,5,群益金鼎-松山,2024-09-02,9103
2388,威盛,5,0,5,群益金鼎-松山,2024-09-02,9103
3073,天方能源,5,0,5,群益金鼎-松山,2024-09-02,9103
3712,永崴投控,5,0,5,群益金鼎-松山,2024-09-02,9103
8436,大江,5,0,5,群益金鼎-松山,2024-09-02,9103
00937B,群益ESG投等債20,5,1,4,群益金鼎-松山,2024-09-02,9103
1808,潤隆,4,0,4,群益金鼎-松山,2024-09-02,9103
2890,永豐金,4,0,4,群益金鼎-松山,2024-09-02,9103
3363,上詮,13,9,4,群益金鼎-松山,2024-09-02,9103
3483,力致,4,0,4,群益金鼎-松山,2024-09-02,9103
4534,慶騰,4,0,4,群益金鼎-松山,2024-09-02,9103
6451,訊芯-KY,9,5,4,群益金鼎-松山,2024-09-02,9103
6547,高端疫苗,4,0,4,群益金鼎-松山,2024-09-02,9103
6546,正基,3,0,3,群益金鼎-松山,2024-09-02,9103
00919,群益台灣精選高息,173,0,173,群益金鼎-松山,2024-09-03,9103
00795B,中信美國公債20年,100,0,100,群益金鼎-松山,2024-09-03,9103
2537,聯上發,80,0,80,群益金鼎-松山,2024-09-03,9103
00680L,元大美債20正2,73,0,73,群益金鼎-松山,2024-09-03,9103
4906,正文,51,0,51,群益金鼎-松山,2024-09-03,9103
1708,東鹼,52,2,50,群益金鼎-松山,2024-09-03,9103
3228,金麗科,38,2,36,群益金鼎-松山,2024-09-03,9103
00959B,大華投等美債15Y+,32,0,32,群益金鼎-松山,2024-09-03,9103
00830,國泰費城半導體,30,0,30,群益金鼎-松山,2024-09-03,9103
2368,金像電,30,0,30,群益金鼎-松山,2024-09-03,9103
6164,華興,30,0,30,群益金鼎-松山,2024-09-03,9103
00929,復華台灣科技優息,21,0,21,群益金鼎-松山,2024-09-03,9103
1101,台泥,21,0,21,群益金鼎-松山,2024-09-03,9103
00948B,中信優息投資級債,20,0,20,群益金鼎-松山,2024-09-03,9103
2241,艾姆勒,20,0,20,群益金鼎-松山,2024-09-03,9103
2392,正崴,15,0,15,群益金鼎-松山,2024-09-03,9103
2637,慧洋-KY,15,0,15,群益金鼎-松山,2024-09-03,9103
6186,新潤,14,0,14,群益金鼎-松山,2024-09-03,9103
6770,力積電,14,0,14,群益金鼎-松山,2024-09-03,9103
2420,新巨,12,0,12,群益金鼎-松山,2024-09-03,9103
00665L,富邦�琤肭磪囓�2,10,0,10,群益金鼎-松山,2024-09-03,9103
00937B,群益ESG投等債20,10,0,10,群益金鼎-松山,2024-09-03,9103
2323,中環,10,0,10,群益金鼎-松山,2024-09-03,9103
3092,鴻碩,10,0,10,群益金鼎-松山,2024-09-03,9103
6215,和椿,20,10,10,群益金鼎-松山,2024-09-03,9103
8043,蜜望實,19,10,9,群益金鼎-松山,2024-09-03,9103
1304,台聚,8,0,8,群益金鼎-松山,2024-09-03,9103
1718,中纖,7,0,7,群益金鼎-松山,2024-09-03,9103
2885,元大金,6,0,6,群益金鼎-松山,2024-09-03,9103
3450,聯鈞,8,2,6,群益金鼎-松山,2024-09-03,9103
2486,一詮,11,5,6,群益金鼎-松山,2024-09-03,9103
00693U,期街口S＆P黃豆,5,0,5,群益金鼎-松山,2024-09-03,9103
00881,國泰台灣5G+,5,0,5,群益金鼎-松山,2024-09-03,9103
2344,華邦電,5,0,5,群益金鼎-松山,2024-09-03,9103
2383,台光電,7,2,5,群益金鼎-松山,2024-09-03,9103
3265,台星科,5,0,5,群益金鼎-松山,2024-09-03,9103
5443,均豪,27,22,5,群益金鼎-松山,2024-09-03,9103
6743,安普新,5,0,5,群益金鼎-松山,2024-09-03,9103
8367,建新國際,5,0,5,群益金鼎-松山,2024-09-03,9103
1301,台塑,4,0,4,群益金鼎-松山,2024-09-03,9103
1305,華夏,4,0,4,群益金鼎-松山,2024-09-03,9103
2881,富邦金,4,0,4,群益金鼎-松山,2024-09-03,9103
3532,台勝科,4,0,4,群益金鼎-松山,2024-09-03,9103
4967,十銓,5,1,4,群益金鼎-松山,2024-09-03,9103
5309,系統電,4,0,4,群益金鼎-松山,2024-09-03,9103
8110,華東,4,0,4,群益金鼎-松山,2024-09-03,9103
6187,萬潤,10,7,3,群益金鼎-松山,2024-09-03,9103
1711,永光,4,1,3,群益金鼎-松山,2024-09-03,9103
1777,生泰,3,0,3,群益金鼎-松山,2024-09-03,9103
1808,潤隆,3,0,3,群益金鼎-松山,2024-09-03,9103
2888,新光金,91,30,61,群益金鼎-松山,2024-09-04,9103
00940,元大台灣價值高息,51,0,51,群益金鼎-松山,2024-09-04,9103
00857B,永豐20年美公債,50,0,50,群益金鼎-松山,2024-09-04,9103
6164,華興,50,5,45,群益金鼎-松山,2024-09-04,9103
3357,臺慶科,44,0,44,群益金鼎-松山,2024-09-04,9103
00878,國泰永續高股息,38,0,38,群益金鼎-松山,2024-09-04,9103
00919,群益台灣精選高息,36,0,36,群益金鼎-松山,2024-09-04,9103
4303,信立,32,0,32,群益金鼎-松山,2024-09-04,9103
1717,長興,30,0,30,群益金鼎-松山,2024-09-04,9103
00929,復華台灣科技優息,34,10,24,群益金鼎-松山,2024-09-04,9103
2330,台積電,34,15,19,群益金鼎-松山,2024-09-04,9103
2420,新巨,15,1,14,群益金鼎-松山,2024-09-04,9103
00830,國泰費城半導體,12,0,12,群益金鼎-松山,2024-09-04,9103
0056,元大高股息,11,0,11,群益金鼎-松山,2024-09-04,9103
2002,中鋼,13,2,11,群益金鼎-松山,2024-09-04,9103
2838,聯邦銀,11,0,11,群益金鼎-松山,2024-09-04,9103
2884,玉山金,10,0,10,群益金鼎-松山,2024-09-04,9103
020033,統一�琤肮黕篾,10,0,10,群益金鼎-松山,2024-09-04,9103
1314,中石化,60,50,10,群益金鼎-松山,2024-09-04,9103
00881,國泰台灣5G+,10,0,10,群益金鼎-松山,2024-09-04,9103
1718,中纖,10,0,10,群益金鼎-松山,2024-09-04,9103
4534,慶騰,10,0,10,群益金鼎-松山,2024-09-04,9103
6111,大宇資,10,0,10,群益金鼎-松山,2024-09-04,9103
3035,智原,9,0,9,群益金鼎-松山,2024-09-04,9103
00918,大華優利高填息30,9,0,9,群益金鼎-松山,2024-09-04,9103
2382,廣達,9,1,8,群益金鼎-松山,2024-09-04,9103
2645,長榮航太,8,0,8,群益金鼎-松山,2024-09-04,9103
8043,蜜望實,9,1,8,群益金鼎-松山,2024-09-04,9103
1612,宏泰,7,0,7,群益金鼎-松山,2024-09-04,9103
2867,三商壽,7,0,7,群益金鼎-松山,2024-09-04,9103
3265,台星科,8,1,7,群益金鼎-松山,2024-09-04,9103
3491,昇達科,7,0,7,群益金鼎-松山,2024-09-04,9103
4562,穎漢,51,44,7,群益金鼎-松山,2024-09-04,9103
8349,�矬�,7,0,7,群益金鼎-松山,2024-09-04,9103
00900,富邦特選高股息30,6,0,6,群益金鼎-松山,2024-09-04,9103
1785,光洋科,6,0,6,群益金鼎-松山,2024-09-04,9103
2392,正崴,6,0,6,群益金鼎-松山,2024-09-04,9103
4561,健椿,8,2,6,群益金鼎-松山,2024-09-04,9103
6530,創威,6,0,6,群益金鼎-松山,2024-09-04,9103
2250,IKKA-KY,5,0,5,群益金鼎-松山,2024-09-04,9103
2317,鴻海,17,12,5,群益金鼎-松山,2024-09-04,9103
1503,士電,5,0,5,群益金鼎-松山,2024-09-04,9103
1605,華新,5,0,5,群益金鼎-松山,2024-09-04,9103
2062,橋椿,5,0,5,群益金鼎-松山,2024-09-04,9103
2887,台新金,5,0,5,群益金鼎-松山,2024-09-04,9103
3163,波若威,6,1,5,群益金鼎-松山,2024-09-04,9103
4707,磐亞,5,0,5,群益金鼎-松山,2024-09-04,9103
8076,伍豐,9,4,5,群益金鼎-松山,2024-09-04,9103
9907,統一實,5,0,5,群益金鼎-松山,2024-09-04,9103
0050,元大台灣50,6,2,4,群益金鼎-松山,2024-09-04,9103
1532,勤美,50,0,50,群益金鼎-松山,2024-09-05,9103
4716,大立,40,0,40,群益金鼎-松山,2024-09-05,9103
2609,陽明,30,0,30,群益金鼎-松山,2024-09-05,9103
3022,威強電,25,1,24,群益金鼎-松山,2024-09-05,9103
00687B,國泰20年美債,30,7,23,群益金鼎-松山,2024-09-05,9103
1326,台化,22,0,22,群益金鼎-松山,2024-09-05,9103
3231,緯創,20,0,20,群益金鼎-松山,2024-09-05,9103
5309,系統電,20,0,20,群益金鼎-松山,2024-09-05,9103
6757,台灣虎航,80,60,20,群益金鼎-松山,2024-09-05,9103
00946,群益科技高息成長,18,0,18,群益金鼎-松山,2024-09-05,9103
5213,亞昕,15,0,15,群益金鼎-松山,2024-09-05,9103
00929,復華台灣科技優息,13,0,13,群益金鼎-松山,2024-09-05,9103
8070,長華*,13,0,13,群益金鼎-松山,2024-09-05,9103
00952,凱基台灣AI50,16,5,11,群益金鼎-松山,2024-09-05,9103
5225,東科-KY,11,0,11,群益金鼎-松山,2024-09-05,9103
1802,台玻,10,0,10,群益金鼎-松山,2024-09-05,9103
3227,原相,10,0,10,群益金鼎-松山,2024-09-05,9103
3312,弘憶股,10,0,10,群益金鼎-松山,2024-09-05,9103
00881,國泰台灣5G+,7,0,7,群益金鼎-松山,2024-09-05,9103
8349,�矬�,25,18,7,群益金鼎-松山,2024-09-05,9103
00857B,永豐20年美公債,6,0,6,群益金鼎-松山,2024-09-05,9103
2062,橋椿,7,1,6,群益金鼎-松山,2024-09-05,9103
6202,盛群,8,2,6,群益金鼎-松山,2024-09-05,9103
6213,聯茂,9,3,6,群益金鼎-松山,2024-09-05,9103
00919,群益台灣精選高息,6,0,6,群益金鼎-松山,2024-09-05,9103
1785,光洋科,5,0,5,群益金鼎-松山,2024-09-05,9103
2392,正崴,5,0,5,群益金鼎-松山,2024-09-05,9103
2520,冠德,5,0,5,群益金鼎-松山,2024-09-05,9103
2542,興富發,5,0,5,群益金鼎-松山,2024-09-05,9103
3047,訊舟,13,8,5,群益金鼎-松山,2024-09-05,9103
3707,漢磊,5,0,5,群益金鼎-松山,2024-09-05,9103
4510,高鋒,10,5,5,群益金鼎-松山,2024-09-05,9103
6143,振曜,21,16,5,群益金鼎-松山,2024-09-05,9103
2317,鴻海,19,14,5,群益金鼎-松山,2024-09-05,9103
00715L,期街口布蘭特正2,4,0,4,群益金鼎-松山,2024-09-05,9103
1304,台聚,4,0,4,群益金鼎-松山,2024-09-05,9103
3189,景碩,4,0,4,群益金鼎-松山,2024-09-05,9103
3363,上詮,7,3,4,群益金鼎-松山,2024-09-05,9103
3687,歐買尬,4,0,4,群益金鼎-松山,2024-09-05,9103
8027,鈦昇,4,0,4,群益金鼎-松山,2024-09-05,9103
8071,能率網通,5,1,4,群益金鼎-松山,2024-09-05,9103
1702,南僑,3,0,3,群益金鼎-松山,2024-09-05,9103
00905,FT臺灣Smart,3,0,3,群益金鼎-松山,2024-09-05,9103
2348,海悅,3,0,3,群益金鼎-松山,2024-09-05,9103
3045,台灣大,3,0,3,群益金鼎-松山,2024-09-05,9103
3086,華義,3,0,3,群益金鼎-松山,2024-09-05,9103
4303,信立,4,1,3,群益金鼎-松山,2024-09-05,9103
6244,茂迪,3,0,3,群益金鼎-松山,2024-09-05,9103
6863,永道-KY,3,0,3,群益金鼎-松山,2024-09-05,9103
9958,世紀鋼,4,1,3,群益金鼎-松山,2024-09-05,9103
00632R,元大台灣50反1,40,0,40,群益金鼎-松山,2024-09-06,9103
2537,聯上發,40,0,40,群益金鼎-松山,2024-09-06,9103
00687B,國泰20年美債,31,1,30,群益金鼎-松山,2024-09-06,9103
00940,元大台灣價值高息,30,0,30,群益金鼎-松山,2024-09-06,9103
1522,堤維西,30,1,29,群益金鼎-松山,2024-09-06,9103
3003,健和興,18,1,17,群益金鼎-松山,2024-09-06,9103
2426,鼎元,15,0,15,群益金鼎-松山,2024-09-06,9103
3357,臺慶科,18,3,15,群益金鼎-松山,2024-09-06,9103
2464,盟立,13,1,12,群益金鼎-松山,2024-09-06,9103
5481,新華,11,0,11,群益金鼎-松山,2024-09-06,9103
020033,統一�琤肮黕篾,10,0,10,群益金鼎-松山,2024-09-06,9103
3265,台星科,7,0,7,群益金鼎-松山,2024-09-06,9103
2382,廣達,11,5,6,群益金鼎-松山,2024-09-06,9103
2888,新光金,6,0,6,群益金鼎-松山,2024-09-06,9103
3062,建漢,6,0,6,群益金鼎-松山,2024-09-06,9103
5443,均豪,31,26,5,群益金鼎-松山,2024-09-06,9103
00945B,凱基美國非投等債,5,0,5,群益金鼎-松山,2024-09-06,9103
1605,華新,10,5,5,群益金鼎-松山,2024-09-06,9103
2524,京城,5,0,5,群益金鼎-松山,2024-09-06,9103
4566,時碩工業,5,0,5,群益金鼎-松山,2024-09-06,9103
6757,台灣虎航,60,55,5,群益金鼎-松山,2024-09-06,9103
1815,富喬,6,2,4,群益金鼎-松山,2024-09-06,9103
00919,群益台灣精選高息,4,0,4,群益金鼎-松山,2024-09-06,9103
2365,昆盈,4,0,4,群益金鼎-松山,2024-09-06,9103
2540,愛山林,4,0,4,群益金鼎-松山,2024-09-06,9103
2615,萬海,4,0,4,群益金鼎-松山,2024-09-06,9103
3044,健鼎,4,0,4,群益金鼎-松山,2024-09-06,9103
0056,元大高股息,4,0,4,群益金鼎-松山,2024-09-06,9103
2438,翔耀,3,0,3,群益金鼎-松山,2024-09-06,9103
2881,富邦金,5,2,3,群益金鼎-松山,2024-09-06,9103
3029,零壹,3,0,3,群益金鼎-松山,2024-09-06,9103
3714,富采,3,0,3,群益金鼎-松山,2024-09-06,9103
8349,�矬�,3,0,3,群益金鼎-松山,2024-09-06,9103
8374,羅昇,4,1,3,群益金鼎-松山,2024-09-06,9103
8927,北基,6,3,3,群益金鼎-松山,2024-09-06,9103
2330,台積電,2,0,2,群益金鼎-松山,2024-09-06,9103
3324,雙鴻,2,0,2,群益金鼎-松山,2024-09-06,9103
3017,奇鋐,5,3,2,群益金鼎-松山,2024-09-06,9103
2317,鴻海,4,2,2,群益金鼎-松山,2024-09-06,9103
1777,生泰,2,0,2,群益金鼎-松山,2024-09-06,9103
2312,金寶,2,0,2,群益金鼎-松山,2024-09-06,9103
00937B,群益ESG投等債20,2,0,2,群益金鼎-松山,2024-09-06,9103
00878,國泰永續高股息,2,0,2,群益金鼎-松山,2024-09-06,9103
00697B,元大美債7-10,2,0,2,群益金鼎-松山,2024-09-06,9103
2327,國巨,2,0,2,群益金鼎-松山,2024-09-06,9103
2352,佳世達,2,0,2,群益金鼎-松山,2024-09-06,9103
2645,長榮航太,2,0,2,群益金鼎-松山,2024-09-06,9103
3036,文曄,2,0,2,群益金鼎-松山,2024-09-06,9103
3189,景碩,2,0,2,群益金鼎-松山,2024-09-06,9103
3294,英濟,2,0,2,群益金鼎-松山,2024-09-06,9103
2881,富邦金,1005,0,1005,群益金鼎-松山,2024-09-09,9103
2888,新光金,227,4,223,群益金鼎-松山,2024-09-09,9103
2889,國票金,94,50,44,群益金鼎-松山,2024-09-09,9103
3450,聯鈞,44,2,42,群益金鼎-松山,2024-09-09,9103
00632R,元大台灣50反1,80,40,40,群益金鼎-松山,2024-09-09,9103
6405,悅城,41,1,40,群益金鼎-松山,2024-09-09,9103
6757,台灣虎航,40,5,35,群益金鼎-松山,2024-09-09,9103
00830,國泰費城半導體,30,0,30,群益金鼎-松山,2024-09-09,9103
4303,信立,30,4,26,群益金鼎-松山,2024-09-09,9103
2408,南亞科,25,0,25,群益金鼎-松山,2024-09-09,9103
2420,新巨,24,0,24,群益金鼎-松山,2024-09-09,9103
00919,群益台灣精選高息,21,0,21,群益金鼎-松山,2024-09-09,9103
00670L,富邦NASDAQ正2,20,0,20,群益金鼎-松山,2024-09-09,9103
00687B,國泰20年美債,20,0,20,群益金鼎-松山,2024-09-09,9103
2897,王道銀行,20,0,20,群益金鼎-松山,2024-09-09,9103
4989,榮科,20,0,20,群益金鼎-松山,2024-09-09,9103
2464,盟立,43,23,20,群益金鼎-松山,2024-09-09,9103
00918,大華優利高填息30,19,0,19,群益金鼎-松山,2024-09-09,9103
3715,定穎投控,19,0,19,群益金鼎-松山,2024-09-09,9103
2330,台積電,19,1,18,群益金鼎-松山,2024-09-09,9103
00929,復華台灣科技優息,27,10,17,群益金鼎-松山,2024-09-09,9103
2365,昆盈,40,24,16,群益金鼎-松山,2024-09-09,9103
00946,群益科技高息成長,15,0,15,群益金鼎-松山,2024-09-09,9103
2344,華邦電,15,0,15,群益金鼎-松山,2024-09-09,9103
3413,京鼎,14,0,14,群益金鼎-松山,2024-09-09,9103
6546,正基,14,0,14,群益金鼎-松山,2024-09-09,9103
1326,台化,13,0,13,群益金鼎-松山,2024-09-09,9103
3081,聯亞,13,0,13,群益金鼎-松山,2024-09-09,9103
6104,創惟,15,2,13,群益金鼎-松山,2024-09-09,9103
2317,鴻海,14,2,12,群益金鼎-松山,2024-09-09,9103
00940,元大台灣價值高息,10,0,10,群益金鼎-松山,2024-09-09,9103
00688L,國泰20年美債正2,10,0,10,群益金鼎-松山,2024-09-09,9103
00720B,元大投資級公司債,10,0,10,群益金鼎-松山,2024-09-09,9103
2376,技嘉,10,0,10,群益金鼎-松山,2024-09-09,9103
2610,華航,10,0,10,群益金鼎-松山,2024-09-09,9103
3092,鴻碩,10,0,10,群益金鼎-松山,2024-09-09,9103
3498,陽程,10,0,10,群益金鼎-松山,2024-09-09,9103
3227,原相,9,0,9,群益金鼎-松山,2024-09-09,9103
3003,健和興,9,0,9,群益金鼎-松山,2024-09-09,9103
6139,亞翔,12,3,9,群益金鼎-松山,2024-09-09,9103
1808,潤隆,8,0,8,群益金鼎-松山,2024-09-09,9103
00878,國泰永續高股息,12,5,7,群益金鼎-松山,2024-09-09,9103
6770,力積電,7,0,7,群益金鼎-松山,2024-09-09,9103
6937,天虹,6,0,6,群益金鼎-松山,2024-09-09,9103
1524,耿鼎,5,0,5,群益金鼎-松山,2024-09-09,9103
1337,再生-KY,5,0,5,群益金鼎-松山,2024-09-09,9103
00706L,期元大S＆P日圓正2,5,0,5,群益金鼎-松山,2024-09-09,9103
00751B,元大AAA至A公司債,5,0,5,群益金鼎-松山,2024-09-09,9103
1785,光洋科,5,0,5,群益金鼎-松山,2024-09-09,9103
2352,佳世達,5,0,5,群益金鼎-松山,2024-09-09,9103
00918,大華優利高填息30,78,10,68,群益金鼎-松山,2024-09-10,9103
00632R,元大台灣50反1,77,20,57,群益金鼎-松山,2024-09-10,9103
3062,建漢,51,6,45,群益金鼎-松山,2024-09-10,9103
0056,元大高股息,40,0,40,群益金鼎-松山,2024-09-10,9103
00878,國泰永續高股息,33,0,33,群益金鼎-松山,2024-09-10,9103
2365,昆盈,57,26,31,群益金鼎-松山,2024-09-10,9103
2376,技嘉,30,0,30,群益金鼎-松山,2024-09-10,9103
6104,創惟,30,0,30,群益金鼎-松山,2024-09-10,9103
3081,聯亞,28,0,28,群益金鼎-松山,2024-09-10,9103
2888,新光金,27,0,27,群益金鼎-松山,2024-09-10,9103
2891,中信金,26,0,26,群益金鼎-松山,2024-09-10,9103
00929,復華台灣科技優息,34,12,22,群益金鼎-松山,2024-09-10,9103
00687B,國泰20年美債,20,0,20,群益金鼎-松山,2024-09-10,9103
3708,上緯投控,20,0,20,群益金鼎-松山,2024-09-10,9103
1582,信錦,15,0,15,群益金鼎-松山,2024-09-10,9103
00919,群益台灣精選高息,25,10,15,群益金鼎-松山,2024-09-10,9103
3227,原相,18,4,14,群益金鼎-松山,2024-09-10,9103
2303,聯電,14,0,14,群益金鼎-松山,2024-09-10,9103
3090,日電貿,14,0,14,群益金鼎-松山,2024-09-10,9103
4909,新復興,24,10,14,群益金鼎-松山,2024-09-10,9103
2615,萬海,12,0,12,群益金鼎-松山,2024-09-10,9103
3017,奇鋐,12,0,12,群益金鼎-松山,2024-09-10,9103
2250,IKKA-KY,12,0,12,群益金鼎-松山,2024-09-10,9103
1605,華新,11,0,11,群益金鼎-松山,2024-09-10,9103
020033,統一�琤肮黕篾,10,0,10,群益金鼎-松山,2024-09-10,9103
00864B,中信美國公債0-1,10,0,10,群益金鼎-松山,2024-09-10,9103
00937B,群益ESG投等債20,10,0,10,群益金鼎-松山,2024-09-10,9103
1815,富喬,16,6,10,群益金鼎-松山,2024-09-10,9103
2520,冠德,10,0,10,群益金鼎-松山,2024-09-10,9103
2884,玉山金,10,0,10,群益金鼎-松山,2024-09-10,9103
2897,王道銀行,10,0,10,群益金鼎-松山,2024-09-10,9103
3702,大聯大,10,0,10,群益金鼎-松山,2024-09-10,9103
4908,前鼎,13,3,10,群益金鼎-松山,2024-09-10,9103
1303,南亞,10,1,9,群益金鼎-松山,2024-09-10,9103
3583,辛耘,8,0,8,群益金鼎-松山,2024-09-10,9103
2317,鴻海,10,3,7,群益金鼎-松山,2024-09-10,9103
00915,凱基優選高股息30,7,0,7,群益金鼎-松山,2024-09-10,9103
6148,驊宏資,6,0,6,群益金鼎-松山,2024-09-10,9103
1304,台聚,5,0,5,群益金鼎-松山,2024-09-10,9103
2312,金寶,5,0,5,群益金鼎-松山,2024-09-10,9103
2313,華通,5,0,5,群益金鼎-松山,2024-09-10,9103
2537,聯上發,5,0,5,群益金鼎-松山,2024-09-10,9103
3706,神達,5,0,5,群益金鼎-松山,2024-09-10,9103
9945,潤泰新,4,0,4,群益金鼎-松山,2024-09-10,9103
6546,正基,9,5,4,群益金鼎-松山,2024-09-10,9103
2070,精湛,3,0,3,群益金鼎-松山,2024-09-10,9103
2233,宇隆,3,0,3,群益金鼎-松山,2024-09-10,9103
2348,海悅,3,0,3,群益金鼎-松山,2024-09-10,9103
2618,長榮航,3,0,3,群益金鼎-松山,2024-09-10,9103
3025,星通,3,0,3,群益金鼎-松山,2024-09-10,9103
2888,新光金,403,319,84,群益金鼎-松山,2024-09-11,9103
4562,穎漢,38,0,38,群益金鼎-松山,2024-09-11,9103
00632R,元大台灣50反1,30,0,30,群益金鼎-松山,2024-09-11,9103
3081,聯亞,28,1,27,群益金鼎-松山,2024-09-11,9103
4566,時碩工業,16,0,16,群益金鼎-松山,2024-09-11,9103
00719B,元大美債1-3,12,0,12,群益金鼎-松山,2024-09-11,9103
3289,宜特,15,5,10,群益金鼎-松山,2024-09-11,9103
00688L,國泰20年美債正2,10,0,10,群益金鼎-松山,2024-09-11,9103
00907,永豐優息存股,10,0,10,群益金鼎-松山,2024-09-11,9103
020033,統一�琤肮黕篾,10,0,10,群益金鼎-松山,2024-09-11,9103
2344,華邦電,10,0,10,群益金鼎-松山,2024-09-11,9103
2897,王道銀行,10,0,10,群益金鼎-松山,2024-09-11,9103
3189,景碩,10,0,10,群益金鼎-松山,2024-09-11,9103
6215,和椿,10,0,10,群益金鼎-松山,2024-09-11,9103
2360,致茂,9,0,9,群益金鼎-松山,2024-09-11,9103
3481,群創,11,3,8,群益金鼎-松山,2024-09-11,9103
4909,新復興,8,0,8,群益金鼎-松山,2024-09-11,9103
00919,群益台灣精選高息,8,2,6,群益金鼎-松山,2024-09-11,9103
2540,愛山林,6,0,6,群益金鼎-松山,2024-09-11,9103
2883,凱基金,6,0,6,群益金鼎-松山,2024-09-11,9103
9927,泰銘,6,0,6,群益金鼎-松山,2024-09-11,9103
2891,中信金,5,0,5,群益金鼎-松山,2024-09-11,9103
00715L,期街口布蘭特正2,5,0,5,群益金鼎-松山,2024-09-11,9103
1447,力鵬,5,0,5,群益金鼎-松山,2024-09-11,9103
2314,台揚,5,0,5,群益金鼎-松山,2024-09-11,9103
2382,廣達,5,0,5,群益金鼎-松山,2024-09-11,9103
3073,天方能源,5,0,5,群益金鼎-松山,2024-09-11,9103
3312,弘憶股,5,0,5,群益金鼎-松山,2024-09-11,9103
9945,潤泰新,5,0,5,群益金鼎-松山,2024-09-11,9103
3376,新日興,4,0,4,群益金鼎-松山,2024-09-11,9103
2250,IKKA-KY,3,0,3,群益金鼎-松山,2024-09-11,9103
00930,永豐ESG低碳高息,3,0,3,群益金鼎-松山,2024-09-11,9103
2201,裕隆,4,1,3,群益金鼎-松山,2024-09-11,9103
2425,承啟,3,0,3,群益金鼎-松山,2024-09-11,9103
2438,翔耀,3,0,3,群益金鼎-松山,2024-09-11,9103
2457,飛宏,3,0,3,群益金鼎-松山,2024-09-11,9103
4583,台灣精銳,6,3,3,群益金鼎-松山,2024-09-11,9103
5443,均豪,16,13,3,群益金鼎-松山,2024-09-11,9103
6143,振曜,16,13,3,群益金鼎-松山,2024-09-11,9103
6257,矽格,3,0,3,群益金鼎-松山,2024-09-11,9103
8071,能率網通,3,0,3,群益金鼎-松山,2024-09-11,9103
6139,亞翔,2,0,2,群益金鼎-松山,2024-09-11,9103
5215,科嘉-KY,2,0,2,群益金鼎-松山,2024-09-11,9103
1446,宏和,2,0,2,群益金鼎-松山,2024-09-11,9103
00929,復華台灣科技優息,2,0,2,群益金鼎-松山,2024-09-11,9103
00940,元大台灣價值高息,2,0,2,群益金鼎-松山,2024-09-11,9103
00939,統一台灣高息動能,2,0,2,群益金鼎-松山,2024-09-11,9103
00713,元大台灣高息低波,2,0,2,群益金鼎-松山,2024-09-11,9103
00679B,元大美債20年,2,0,2,群益金鼎-松山,2024-09-11,9103
1522,堤維西,4,2,2,群益金鼎-松山,2024-09-11,9103
00632R,元大台灣50反1,183,100,83,群益金鼎-松山,2024-09-12,9103
2891,中信金,31,0,31,群益金鼎-松山,2024-09-12,9103
5443,均豪,45,23,22,群益金鼎-松山,2024-09-12,9103
4909,新復興,34,12,22,群益金鼎-松山,2024-09-12,9103
3360,尚立,16,0,16,群益金鼎-松山,2024-09-12,9103
2392,正崴,12,0,12,群益金鼎-松山,2024-09-12,9103
2464,盟立,12,0,12,群益金鼎-松山,2024-09-12,9103
3374,精材,14,3,11,群益金鼎-松山,2024-09-12,9103
1785,光洋科,23,12,11,群益金鼎-松山,2024-09-12,9103
2542,興富發,10,0,10,群益金鼎-松山,2024-09-12,9103
3037,欣興,10,0,10,群益金鼎-松山,2024-09-12,9103
5234,達興材料,10,0,10,群益金鼎-松山,2024-09-12,9103
3550,聯穎,9,0,9,群益金鼎-松山,2024-09-12,9103
4908,前鼎,25,16,9,群益金鼎-松山,2024-09-12,9103
8039,台虹,9,0,9,群益金鼎-松山,2024-09-12,9103
8043,蜜望實,9,0,9,群益金鼎-松山,2024-09-12,9103
00830,國泰費城半導體,20,12,8,群益金鼎-松山,2024-09-12,9103
00712,復華富時不動產,8,0,8,群益金鼎-松山,2024-09-12,9103
1540,喬福,7,0,7,群益金鼎-松山,2024-09-12,9103
2888,新光金,15,8,7,群益金鼎-松山,2024-09-12,9103
6187,萬潤,17,10,7,群益金鼎-松山,2024-09-12,9103
6643,M31,7,1,6,群益金鼎-松山,2024-09-12,9103
6451,訊芯-KY,8,3,5,群益金鼎-松山,2024-09-12,9103
3260,威剛,6,1,5,群益金鼎-松山,2024-09-12,9103
1808,潤隆,5,0,5,群益金鼎-松山,2024-09-12,9103
020033,統一�琤肮黕篾,5,0,5,群益金鼎-松山,2024-09-12,9103
00706L,期元大S＆P日圓正2,5,0,5,群益金鼎-松山,2024-09-12,9103
00772B,中信高評級公司債,5,0,5,群益金鼎-松山,2024-09-12,9103
00751B,元大AAA至A公司債,5,0,5,群益金鼎-松山,2024-09-12,9103
2420,新巨,5,0,5,群益金鼎-松山,2024-09-12,9103
3312,弘憶股,11,6,5,群益金鼎-松山,2024-09-12,9103
3607,谷崧,5,0,5,群益金鼎-松山,2024-09-12,9103
3673,TPK-KY,9,4,5,群益金鼎-松山,2024-09-12,9103
3706,神達,5,0,5,群益金鼎-松山,2024-09-12,9103
6269,台郡,5,0,5,群益金鼎-松山,2024-09-12,9103
8358,金居,5,0,5,群益金鼎-松山,2024-09-12,9103
2342,茂矽,4,0,4,群益金鼎-松山,2024-09-12,9103
2417,圓剛,4,0,4,群益金鼎-松山,2024-09-12,9103
4935,茂林-KY,4,0,4,群益金鼎-松山,2024-09-12,9103
00664R,國泰臺灣加權反1,3,0,3,群益金鼎-松山,2024-09-12,9103
2324,仁寶,6,3,3,群益金鼎-松山,2024-09-12,9103
3036,文曄,3,0,3,群益金鼎-松山,2024-09-12,9103
3707,漢磊,3,0,3,群益金鼎-松山,2024-09-12,9103
4536,拓凱,3,0,3,群益金鼎-松山,2024-09-12,9103
5469,瀚宇博,3,0,3,群益金鼎-松山,2024-09-12,9103
6111,大宇資,5,2,3,群益金鼎-松山,2024-09-12,9103
5460,同協,2,0,2,群益金鼎-松山,2024-09-12,9103
00715L,期街口布蘭特正2,2,0,2,群益金鼎-松山,2024-09-12,9103
00919,群益台灣精選高息,2,0,2,群益金鼎-松山,2024-09-12,9103
1727,中華化,2,0,2,群益金鼎-松山,2024-09-12,9103
2891,中信金,100,0,100,群益金鼎-松山,2024-09-13,9103
00919,群益台灣精選高息,62,1,61,群益金鼎-松山,2024-09-13,9103
1532,勤美,30,0,30,群益金鼎-松山,2024-09-13,9103
3050,鈺德,30,0,30,群益金鼎-松山,2024-09-13,9103
6757,台灣虎航,37,10,27,群益金鼎-松山,2024-09-13,9103
8104,錸寶,25,0,25,群益金鼎-松山,2024-09-13,9103
00687B,國泰20年美債,23,0,23,群益金鼎-松山,2024-09-13,9103
2392,正崴,20,0,20,群益金鼎-松山,2024-09-13,9103
2408,南亞科,18,0,18,群益金鼎-松山,2024-09-13,9103
3081,聯亞,18,0,18,群益金鼎-松山,2024-09-13,9103
2425,承啟,23,10,13,群益金鼎-松山,2024-09-13,9103
2420,新巨,19,7,12,群益金鼎-松山,2024-09-13,9103
2455,全新,16,5,11,群益金鼎-松山,2024-09-13,9103
3498,陽程,11,0,11,群益金鼎-松山,2024-09-13,9103
8088,品安,11,0,11,群益金鼎-松山,2024-09-13,9103
00924,復華S＆P500成長,10,0,10,群益金鼎-松山,2024-09-13,9103
020033,統一�琤肮黕篾,10,0,10,群益金鼎-松山,2024-09-13,9103
2542,興富發,10,0,10,群益金鼎-松山,2024-09-13,9103
3706,神達,10,0,10,群益金鼎-松山,2024-09-13,9103
4908,前鼎,10,0,10,群益金鼎-松山,2024-09-13,9103
6104,創惟,11,1,10,群益金鼎-松山,2024-09-13,9103
3227,原相,11,1,10,群益金鼎-松山,2024-09-13,9103
5443,均豪,23,14,9,群益金鼎-松山,2024-09-13,9103
2365,昆盈,20,11,9,群益金鼎-松山,2024-09-13,9103
5236,凌陽創新,9,0,9,群益金鼎-松山,2024-09-13,9103
2360,致茂,9,0,9,群益金鼎-松山,2024-09-13,9103
6111,大宇資,12,4,8,群益金鼎-松山,2024-09-13,9103
1524,耿鼎,6,0,6,群益金鼎-松山,2024-09-13,9103
8349,�矬�,10,4,6,群益金鼎-松山,2024-09-13,9103
00688L,國泰20年美債正2,6,1,5,群益金鼎-松山,2024-09-13,9103
00637L,元大滬深300正2,5,0,5,群益金鼎-松山,2024-09-13,9103
2383,台光電,6,1,5,群益金鼎-松山,2024-09-13,9103
2524,京城,6,1,5,群益金鼎-松山,2024-09-13,9103
3035,智原,5,0,5,群益金鼎-松山,2024-09-13,9103
4707,磐亞,5,0,5,群益金鼎-松山,2024-09-13,9103
5475,德宏,5,0,5,群益金鼎-松山,2024-09-13,9103
6224,聚鼎,5,0,5,群益金鼎-松山,2024-09-13,9103
6742,澤米,5,0,5,群益金鼎-松山,2024-09-13,9103
9955,佳龍,5,0,5,群益金鼎-松山,2024-09-13,9103
3013,晟銘電,6,2,4,群益金鼎-松山,2024-09-13,9103
3044,健鼎,4,0,4,群益金鼎-松山,2024-09-13,9103
00857B,永豐20年美公債,3,0,3,群益金鼎-松山,2024-09-13,9103
2303,聯電,6,3,3,群益金鼎-松山,2024-09-13,9103
2348,海悅,3,0,3,群益金鼎-松山,2024-09-13,9103
3005,神基,3,0,3,群益金鼎-松山,2024-09-13,9103
4510,高鋒,23,20,3,群益金鼎-松山,2024-09-13,9103
6829,千附精密,3,0,3,群益金鼎-松山,2024-09-13,9103
8374,羅昇,8,5,3,群益金鼎-松山,2024-09-13,9103
2317,鴻海,5,3,2,群益金鼎-松山,2024-09-13,9103
00935,野村臺灣新科技50,2,0,2,群益金鼎-松山,2024-09-13,9103
2891,中信金,200,10,190,群益金鼎-松山,2024-09-16,9103
2349,錸德,150,87,63,群益金鼎-松山,2024-09-16,9103
00680L,元大美債20正2,60,0,60,群益金鼎-松山,2024-09-16,9103
1785,光洋科,63,7,56,群益金鼎-松山,2024-09-16,9103
2007,燁興,50,0,50,群益金鼎-松山,2024-09-16,9103
00687B,國泰20年美債,55,15,40,群益金鼎-松山,2024-09-16,9103
3360,尚立,38,6,32,群益金鼎-松山,2024-09-16,9103
2204,中華,30,0,30,群益金鼎-松山,2024-09-16,9103
3021,鴻名,30,0,30,群益金鼎-松山,2024-09-16,9103
6274,台燿,33,3,30,群益金鼎-松山,2024-09-16,9103
00930,永豐ESG低碳高息,29,0,29,群益金鼎-松山,2024-09-16,9103
3081,聯亞,27,0,27,群益金鼎-松山,2024-09-16,9103
4935,茂林-KY,24,0,24,群益金鼎-松山,2024-09-16,9103
3714,富采,21,0,21,群益金鼎-松山,2024-09-16,9103
00688L,國泰20年美債正2,20,0,20,群益金鼎-松山,2024-09-16,9103
4903,聯光通,20,0,20,群益金鼎-松山,2024-09-16,9103
4909,新復興,23,6,17,群益金鼎-松山,2024-09-16,9103
3450,聯鈞,17,0,17,群益金鼎-松山,2024-09-16,9103
1605,華新,15,0,15,群益金鼎-松山,2024-09-16,9103
2455,全新,16,1,15,群益金鼎-松山,2024-09-16,9103
1773,勝一,13,0,13,群益金鼎-松山,2024-09-16,9103
5905,南仁湖,11,0,11,群益金鼎-松山,2024-09-16,9103
1721,三晃,10,0,10,群益金鼎-松山,2024-09-16,9103
00637L,元大滬深300正2,25,15,10,群益金鼎-松山,2024-09-16,9103
00948B,中信優息投資級債,10,0,10,群益金鼎-松山,2024-09-16,9103
1802,台玻,10,0,10,群益金鼎-松山,2024-09-16,9103
3607,谷崧,13,3,10,群益金鼎-松山,2024-09-16,9103
4526,東台,10,0,10,群益金鼎-松山,2024-09-16,9103
1216,統一,9,0,9,群益金鼎-松山,2024-09-16,9103
00878,國泰永續高股息,9,0,9,群益金鼎-松山,2024-09-16,9103
2477,美隆電,9,0,9,群益金鼎-松山,2024-09-16,9103
4536,拓凱,12,3,9,群益金鼎-松山,2024-09-16,9103
8111,立��,27,18,9,群益金鼎-松山,2024-09-16,9103
2243,宏旭-KY,7,0,7,群益金鼎-松山,2024-09-16,9103
00919,群益台灣精選高息,6,0,6,群益金鼎-松山,2024-09-16,9103
5263,智崴,6,0,6,群益金鼎-松山,2024-09-16,9103
00665L,富邦�琤肭磪囓�2,5,0,5,群益金鼎-松山,2024-09-16,9103
2344,華邦電,5,0,5,群益金鼎-松山,2024-09-16,9103
3019,亞光,5,0,5,群益金鼎-松山,2024-09-16,9103
4958,臻鼎-KY,5,0,5,群益金鼎-松山,2024-09-16,9103
5443,均豪,19,14,5,群益金鼎-松山,2024-09-16,9103
6148,驊宏資,5,0,5,群益金鼎-松山,2024-09-16,9103
1309,台達化,4,0,4,群益金鼎-松山,2024-09-16,9103
2888,新光金,6,2,4,群益金鼎-松山,2024-09-16,9103
6789,采鈺,4,0,4,群益金鼎-松山,2024-09-16,9103
1303,南亞,3,0,3,群益金鼎-松山,2024-09-16,9103
1314,中石化,3,0,3,群益金鼎-松山,2024-09-16,9103
00857B,永豐20年美公債,3,0,3,群益金鼎-松山,2024-09-16,9103
00715L,期街口布蘭特正2,4,1,3,群益金鼎-松山,2024-09-16,9103
2379,瑞昱,3,0,3,群益金鼎-松山,2024-09-16,9103
4903,聯光通,111,0,111,群益金鼎-松山,2024-09-18,9103
2618,長榮航,111,10,101,群益金鼎-松山,2024-09-18,9103
8070,長華*,101,0,101,群益金鼎-松山,2024-09-18,9103
2409,友達,100,0,100,群益金鼎-松山,2024-09-18,9103
00930,永豐ESG低碳高息,50,0,50,群益金鼎-松山,2024-09-18,9103
2014,中鴻,50,0,50,群益金鼎-松山,2024-09-18,9103
00680L,元大美債20正2,55,13,42,群益金鼎-松山,2024-09-18,9103
2537,聯上發,40,0,40,群益金鼎-松山,2024-09-18,9103
2349,錸德,102,63,39,群益金鼎-松山,2024-09-18,9103
2351,順德,30,0,30,群益金鼎-松山,2024-09-18,9103
6143,振曜,29,2,27,群益金鼎-松山,2024-09-18,9103
2520,冠德,25,0,25,群益金鼎-松山,2024-09-18,9103
1301,台塑,21,0,21,群益金鼎-松山,2024-09-18,9103
00687B,國泰20年美債,20,0,20,群益金鼎-松山,2024-09-18,9103
1532,勤美,20,0,20,群益金鼎-松山,2024-09-18,9103
2201,裕隆,30,10,20,群益金鼎-松山,2024-09-18,9103
00919,群益台灣精選高息,20,1,19,群益金鼎-松山,2024-09-18,9103
6139,亞翔,20,1,19,群益金鼎-松山,2024-09-18,9103
3450,聯鈞,17,0,17,群益金鼎-松山,2024-09-18,9103
2431,聯昌,31,15,16,群益金鼎-松山,2024-09-18,9103
1582,信錦,17,2,15,群益金鼎-松山,2024-09-18,9103
3202,樺晟,15,0,15,群益金鼎-松山,2024-09-18,9103
2317,鴻海,18,4,14,群益金鼎-松山,2024-09-18,9103
2324,仁寶,16,3,13,群益金鼎-松山,2024-09-18,9103
1519,華城,15,3,12,群益金鼎-松山,2024-09-18,9103
6442,光聖,14,2,12,群益金鼎-松山,2024-09-18,9103
00688L,國泰20年美債正2,10,0,10,群益金鼎-松山,2024-09-18,9103
1409,新纖,10,0,10,群益金鼎-松山,2024-09-18,9103
2313,華通,10,0,10,群益金鼎-松山,2024-09-18,9103
2392,正崴,10,0,10,群益金鼎-松山,2024-09-18,9103
2542,興富發,10,0,10,群益金鼎-松山,2024-09-18,9103
2897,王道銀行,10,0,10,群益金鼎-松山,2024-09-18,9103
1773,勝一,9,0,9,群益金鼎-松山,2024-09-18,9103
3062,建漢,17,8,9,群益金鼎-松山,2024-09-18,9103
3498,陽程,20,11,9,群益金鼎-松山,2024-09-18,9103
3605,宏致,42,33,9,群益金鼎-松山,2024-09-18,9103
4526,東台,9,0,9,群益金鼎-松山,2024-09-18,9103
00937B,群益ESG投等債20,8,0,8,群益金鼎-松山,2024-09-18,9103
3081,聯亞,9,1,8,群益金鼎-松山,2024-09-18,9103
1612,宏泰,7,0,7,群益金鼎-松山,2024-09-18,9103
2887,台新金,7,0,7,群益金鼎-松山,2024-09-18,9103
3014,聯陽,14,8,6,群益金鼎-松山,2024-09-18,9103
3230,錦明,6,0,6,群益金鼎-松山,2024-09-18,9103
8249,菱光,6,0,6,群益金鼎-松山,2024-09-18,9103
00637L,元大滬深300正2,20,15,5,群益金鼎-松山,2024-09-18,9103
00933B,國泰10Y+金融債,5,0,5,群益金鼎-松山,2024-09-18,9103
1514,亞力,8,3,5,群益金鼎-松山,2024-09-18,9103
2524,京城,5,0,5,群益金鼎-松山,2024-09-18,9103
3040,遠見,5,0,5,群益金鼎-松山,2024-09-18,9103
3607,谷崧,5,0,5,群益金鼎-松山,2024-09-18,9103
4303,信立,150,0,150,群益金鼎-松山,2024-09-19,9103
00632R,元大台灣50反1,140,20,120,群益金鼎-松山,2024-09-19,9103
2891,中信金,103,5,98,群益金鼎-松山,2024-09-19,9103
1785,光洋科,69,24,45,群益金鼎-松山,2024-09-19,9103
6104,創惟,46,1,45,群益金鼎-松山,2024-09-19,9103
3450,聯鈞,48,4,44,群益金鼎-松山,2024-09-19,9103
8011,台通,40,0,40,群益金鼎-松山,2024-09-19,9103
00680L,元大美債20正2,34,0,34,群益金鼎-松山,2024-09-19,9103
00688L,國泰20年美債正2,30,0,30,群益金鼎-松山,2024-09-19,9103
00670L,富邦NASDAQ正2,30,0,30,群益金鼎-松山,2024-09-19,9103
00830,國泰費城半導體,30,0,30,群益金鼎-松山,2024-09-19,9103
3550,聯穎,30,0,30,群益金鼎-松山,2024-09-19,9103
2351,順德,30,1,29,群益金鼎-松山,2024-09-19,9103
3227,原相,24,1,23,群益金鼎-松山,2024-09-19,9103
3481,群創,22,0,22,群益金鼎-松山,2024-09-19,9103
4716,大立,21,0,21,群益金鼎-松山,2024-09-19,9103
1303,南亞,20,0,20,群益金鼎-松山,2024-09-19,9103
2317,鴻海,22,2,20,群益金鼎-松山,2024-09-19,9103
3021,鴻名,30,10,20,群益金鼎-松山,2024-09-19,9103
00919,群益台灣精選高息,25,10,15,群益金鼎-松山,2024-09-19,9103
2420,新巨,15,0,15,群益金鼎-松山,2024-09-19,9103
00929,復華台灣科技優息,14,0,14,群益金鼎-松山,2024-09-19,9103
0056,元大高股息,15,1,14,群益金鼎-松山,2024-09-19,9103
6246,臺龍,14,0,14,群益金鼎-松山,2024-09-19,9103
00930,永豐ESG低碳高息,12,0,12,群益金鼎-松山,2024-09-19,9103
2465,麗臺,10,0,10,群益金鼎-松山,2024-09-19,9103
2504,國產,10,0,10,群益金鼎-松山,2024-09-19,9103
2524,京城,20,10,10,群益金鼎-松山,2024-09-19,9103
3535,晶彩科,16,6,10,群益金鼎-松山,2024-09-19,9103
3580,友威科,17,7,10,群益金鼎-松山,2024-09-19,9103
6216,居易,10,0,10,群益金鼎-松山,2024-09-19,9103
00664R,國泰臺灣加權反1,9,0,9,群益金鼎-松山,2024-09-19,9103
4551,智伸科,9,0,9,群益金鼎-松山,2024-09-19,9103
5443,均豪,15,6,9,群益金鼎-松山,2024-09-19,9103
2330,台積電,10,1,9,群益金鼎-松山,2024-09-19,9103
6148,驊宏資,8,0,8,群益金鼎-松山,2024-09-19,9103
6609,瀧澤科,13,5,8,群益金鼎-松山,2024-09-19,9103
2467,志聖,8,2,6,群益金鼎-松山,2024-09-19,9103
3491,昇達科,6,0,6,群益金鼎-松山,2024-09-19,9103
4513,福裕,6,0,6,群益金鼎-松山,2024-09-19,9103
4935,茂林-KY,10,4,6,群益金鼎-松山,2024-09-19,9103
8996,高力,9,3,6,群益金鼎-松山,2024-09-19,9103
00637L,元大滬深300正2,25,20,5,群益金鼎-松山,2024-09-19,9103
00706L,期元大S＆P日圓正2,5,0,5,群益金鼎-松山,2024-09-19,9103
2233,宇隆,5,0,5,群益金鼎-松山,2024-09-19,9103
2344,華邦電,5,0,5,群益金鼎-松山,2024-09-19,9103
2359,所羅門,8,3,5,群益金鼎-松山,2024-09-19,9103
2520,冠德,5,0,5,群益金鼎-松山,2024-09-19,9103
3312,弘憶股,5,0,5,群益金鼎-松山,2024-09-19,9103
5905,南仁湖,6,1,5,群益金鼎-松山,2024-09-19,9103
00687B,國泰20年美債,119,0,119,群益金鼎-松山,2024-09-20,9103
2409,友達,200,106,94,群益金鼎-松山,2024-09-20,9103
3481,群創,201,142,59,群益金鼎-松山,2024-09-20,9103
2520,冠德,64,20,44,群益金鼎-松山,2024-09-20,9103
3715,定穎投控,41,6,35,群益金鼎-松山,2024-09-20,9103
1785,光洋科,34,2,32,群益金鼎-松山,2024-09-20,9103
00680L,元大美債20正2,23,0,23,群益金鼎-松山,2024-09-20,9103
2939,永邑-KY,21,0,21,群益金鼎-松山,2024-09-20,9103
3390,旭軟,21,0,21,群益金鼎-松山,2024-09-20,9103
1456,怡華,20,0,20,群益金鼎-松山,2024-09-20,9103
4716,大立,20,0,20,群益金鼎-松山,2024-09-20,9103
3714,富采,23,5,18,群益金鼎-松山,2024-09-20,9103
8070,長華*,41,25,16,群益金鼎-松山,2024-09-20,9103
3455,由田,15,0,15,群益金鼎-松山,2024-09-20,9103
2542,興富發,14,0,14,群益金鼎-松山,2024-09-20,9103
4935,茂林-KY,14,0,14,群益金鼎-松山,2024-09-20,9103
1808,潤隆,12,0,12,群益金鼎-松山,2024-09-20,9103
2062,橋椿,11,0,11,群益金鼎-松山,2024-09-20,9103
4551,智伸科,11,0,11,群益金鼎-松山,2024-09-20,9103
00738U,期元大道瓊白銀,10,0,10,群益金鼎-松山,2024-09-20,9103
2365,昆盈,18,8,10,群益金鼎-松山,2024-09-20,9103
2537,聯上發,10,0,10,群益金鼎-松山,2024-09-20,9103
3498,陽程,30,20,10,群益金鼎-松山,2024-09-20,9103
5243,乙盛-KY,10,0,10,群益金鼎-松山,2024-09-20,9103
6023,元大期,10,0,10,群益金鼎-松山,2024-09-20,9103
6188,廣明,32,22,10,群益金鼎-松山,2024-09-20,9103
6245,立端,10,0,10,群益金鼎-松山,2024-09-20,9103
6664,群翊,10,0,10,群益金鼎-松山,2024-09-20,9103
8011,台通,10,0,10,群益金鼎-松山,2024-09-20,9103
00679B,元大美債20年,11,2,9,群益金鼎-松山,2024-09-20,9103
2464,盟立,26,17,9,群益金鼎-松山,2024-09-20,9103
2477,美隆電,9,0,9,群益金鼎-松山,2024-09-20,9103
8064,東捷,19,10,9,群益金鼎-松山,2024-09-20,9103
3450,聯鈞,11,3,8,群益金鼎-松山,2024-09-20,9103
2201,裕隆,8,0,8,群益金鼎-松山,2024-09-20,9103
3354,律勝,7,0,7,群益金鼎-松山,2024-09-20,9103
2303,聯電,6,0,6,群益金鼎-松山,2024-09-20,9103
3062,建漢,19,13,6,群益金鼎-松山,2024-09-20,9103
3491,昇達科,7,1,6,群益金鼎-松山,2024-09-20,9103
00929,復華台灣科技優息,5,0,5,群益金鼎-松山,2024-09-20,9103
1603,華電,5,0,5,群益金鼎-松山,2024-09-20,9103
1608,華榮,5,0,5,群益金鼎-松山,2024-09-20,9103
00635U,期元大S＆P黃金,5,0,5,群益金鼎-松山,2024-09-20,9103
00632R,元大台灣50反1,10,5,5,群益金鼎-松山,2024-09-20,9103
00933B,國泰10Y+金融債,5,0,5,群益金鼎-松山,2024-09-20,9103
3073,天方能源,5,0,5,群益金鼎-松山,2024-09-20,9103
5460,同協,5,0,5,群益金鼎-松山,2024-09-20,9103
8084,巨虹,5,0,5,群益金鼎-松山,2024-09-20,9103
8085,福華,5,0,5,群益金鼎-松山,2024-09-20,9103
8255,朋程,9,4,5,群益金鼎-松山,2024-09-20,9103
2888,新光金,57,3,54,群益金鼎-松山,2024-09-23,9103
2349,錸德,90,52,38,群益金鼎-松山,2024-09-23,9103
2883,凱基金,40,2,38,群益金鼎-松山,2024-09-23,9103
3050,鈺德,34,0,34,群益金鼎-松山,2024-09-23,9103
3149,正達,33,2,31,群益金鼎-松山,2024-09-23,9103
3689,湧德,30,0,30,群益金鼎-松山,2024-09-23,9103
3715,定穎投控,51,25,26,群益金鼎-松山,2024-09-23,9103
00929,復華台灣科技優息,23,0,23,群益金鼎-松山,2024-09-23,9103
1905,華紙,23,0,23,群益金鼎-松山,2024-09-23,9103
3450,聯鈞,38,15,23,群益金鼎-松山,2024-09-23,9103
3714,富采,18,0,18,群益金鼎-松山,2024-09-23,9103
00919,群益台灣精選高息,30,13,17,群益金鼎-松山,2024-09-23,9103
3202,樺晟,16,0,16,群益金鼎-松山,2024-09-23,9103
2420,新巨,11,0,11,群益金鼎-松山,2024-09-23,9103
00915,凱基優選高股息30,10,0,10,群益金鼎-松山,2024-09-23,9103
00632R,元大台灣50反1,10,0,10,群益金鼎-松山,2024-09-23,9103
2228,劍麟,10,0,10,群益金鼎-松山,2024-09-23,9103
2399,映泰,11,1,10,群益金鼎-松山,2024-09-23,9103
2485,兆赫,20,10,10,群益金鼎-松山,2024-09-23,9103
2530,華建,10,0,10,群益金鼎-松山,2024-09-23,9103
4729,熒茂,10,0,10,群益金鼎-松山,2024-09-23,9103
5876,上海商銀,10,0,10,群益金鼎-松山,2024-09-23,9103
6505,台塑化,10,0,10,群益金鼎-松山,2024-09-23,9103
1514,亞力,10,0,10,群益金鼎-松山,2024-09-23,9103
00687B,國泰20年美債,9,0,9,群益金鼎-松山,2024-09-23,9103
3580,友威科,15,6,9,群益金鼎-松山,2024-09-23,9103
4979,華星光,14,7,7,群益金鼎-松山,2024-09-23,9103
6138,茂達,9,2,7,群益金鼎-松山,2024-09-23,9103
3167,大量,6,0,6,群益金鼎-松山,2024-09-23,9103
3675,德微,7,1,6,群益金鼎-松山,2024-09-23,9103
6405,悅城,6,0,6,群益金鼎-松山,2024-09-23,9103
8033,雷虎,6,0,6,群益金鼎-松山,2024-09-23,9103
8390,金益鼎,10,4,6,群益金鼎-松山,2024-09-23,9103
1503,士電,9,4,5,群益金鼎-松山,2024-09-23,9103
00674R,期元大S＆P黃金反1,5,0,5,群益金鼎-松山,2024-09-23,9103
00635U,期元大S＆P黃金,5,0,5,群益金鼎-松山,2024-09-23,9103
2915,潤泰全,5,0,5,群益金鼎-松山,2024-09-23,9103
3062,建漢,12,7,5,群益金鼎-松山,2024-09-23,9103
6805,富世達,8,3,5,群益金鼎-松山,2024-09-23,9103
1722,台肥,4,0,4,群益金鼎-松山,2024-09-23,9103
4935,茂林-KY,10,6,4,群益金鼎-松山,2024-09-23,9103
5905,南仁湖,4,0,4,群益金鼎-松山,2024-09-23,9103
6143,振曜,15,11,4,群益金鼎-松山,2024-09-23,9103
8104,錸寶,4,0,4,群益金鼎-松山,2024-09-23,9103
1702,南僑,3,0,3,群益金鼎-松山,2024-09-23,9103
1609,大亞,12,9,3,群益金鼎-松山,2024-09-23,9103
1725,元禎,3,0,3,群益金鼎-松山,2024-09-23,9103
1808,潤隆,3,0,3,群益金鼎-松山,2024-09-23,9103
2385,群光,3,0,3,群益金鼎-松山,2024-09-23,9103
2497,怡利電,3,0,3,群益金鼎-松山,2024-09-23,9103
00919,群益台灣精選高息,201,1,200,群益金鼎-松山,2024-09-24,9103
00670L,富邦NASDAQ正2,60,0,60,群益金鼎-松山,2024-09-24,9103
4303,信立,58,0,58,群益金鼎-松山,2024-09-24,9103
6506,雙邦,55,0,55,群益金鼎-松山,2024-09-24,9103
00830,國泰費城半導體,51,0,51,群益金鼎-松山,2024-09-24,9103
8111,立��,50,0,50,群益金鼎-松山,2024-09-24,9103
3013,晟銘電,69,24,45,群益金鼎-松山,2024-09-24,9103
2605,新興,31,2,29,群益金鼎-松山,2024-09-24,9103
6213,聯茂,26,0,26,群益金鼎-松山,2024-09-24,9103
00680L,元大美債20正2,23,0,23,群益金鼎-松山,2024-09-24,9103
2436,偉詮電,20,0,20,群益金鼎-松山,2024-09-24,9103
2383,台光電,19,0,19,群益金鼎-松山,2024-09-24,9103
6138,茂達,18,0,18,群益金鼎-松山,2024-09-24,9103
6757,台灣虎航,17,0,17,群益金鼎-松山,2024-09-24,9103
2317,鴻海,27,11,16,群益金鼎-松山,2024-09-24,9103
00688L,國泰20年美債正2,14,0,14,群益金鼎-松山,2024-09-24,9103
3149,正達,16,3,13,群益金鼎-松山,2024-09-24,9103
00637L,元大滬深300正2,22,11,11,群益金鼎-松山,2024-09-24,9103
2615,萬海,71,60,11,群益金鼎-松山,2024-09-24,9103
00878,國泰永續高股息,10,0,10,群益金鼎-松山,2024-09-24,9103
00700,富邦�琤肭磪�,10,0,10,群益金鼎-松山,2024-09-24,9103
8070,長華*,10,0,10,群益金鼎-松山,2024-09-24,9103
9955,佳龍,10,0,10,群益金鼎-松山,2024-09-24,9103
2603,長榮,33,24,9,群益金鼎-松山,2024-09-24,9103
00687B,國泰20年美債,8,0,8,群益金鼎-松山,2024-09-24,9103
2897,王道銀行,8,0,8,群益金鼎-松山,2024-09-24,9103
3673,TPK-KY,13,5,8,群益金鼎-松山,2024-09-24,9103
3036,文曄,6,0,6,群益金鼎-松山,2024-09-24,9103
4536,拓凱,6,0,6,群益金鼎-松山,2024-09-24,9103
6649,台生材,6,0,6,群益金鼎-松山,2024-09-24,9103
00752,中信中國50,5,0,5,群益金鼎-松山,2024-09-24,9103
1720,生達,5,0,5,群益金鼎-松山,2024-09-24,9103
2371,大同,5,0,5,群益金鼎-松山,2024-09-24,9103
2906,高林,5,0,5,群益金鼎-松山,2024-09-24,9103
6405,悅城,5,0,5,群益金鼎-松山,2024-09-24,9103
6906,現觀科,5,0,5,群益金鼎-松山,2024-09-24,9103
5443,均豪,5,1,4,群益金鼎-松山,2024-09-24,9103
1584,精剛,8,4,4,群益金鼎-松山,2024-09-24,9103
2891,中信金,4,0,4,群益金鼎-松山,2024-09-24,9103
5371,中光電,6,2,4,群益金鼎-松山,2024-09-24,9103
00929,復華台灣科技優息,3,0,3,群益金鼎-松山,2024-09-24,9103
1815,富喬,3,0,3,群益金鼎-松山,2024-09-24,9103
6446,藥華藥,3,0,3,群益金鼎-松山,2024-09-24,9103
00664R,國泰臺灣加權反1,3,0,3,群益金鼎-松山,2024-09-24,9103
2313,華通,3,0,3,群益金鼎-松山,2024-09-24,9103
3081,聯亞,6,3,3,群益金鼎-松山,2024-09-24,9103
3188,鑫龍騰,3,0,3,群益金鼎-松山,2024-09-24,9103
6442,光聖,5,2,3,群益金鼎-松山,2024-09-24,9103
6443,元晶,3,0,3,群益金鼎-松山,2024-09-24,9103
2915,潤泰全,2,0,2,群益金鼎-松山,2024-09-24,9103
2891,中信金,306,4,302,群益金鼎-松山,2024-09-25,9103
00882,中信中國高股息,150,0,150,群益金鼎-松山,2024-09-25,9103
00687B,國泰20年美債,57,0,57,群益金鼎-松山,2024-09-25,9103
00795B,中信美國公債20年,50,0,50,群益金鼎-松山,2024-09-25,9103
6257,矽格,43,2,41,群益金鼎-松山,2024-09-25,9103
00632R,元大台灣50反1,35,0,35,群益金鼎-松山,2024-09-25,9103
3609,三一東林,35,0,35,群益金鼎-松山,2024-09-25,9103
2609,陽明,155,121,34,群益金鼎-松山,2024-09-25,9103
2543,皇昌,36,6,30,群益金鼎-松山,2024-09-25,9103
3019,亞光,38,14,24,群益金鼎-松山,2024-09-25,9103
2317,鴻海,63,41,22,群益金鼎-松山,2024-09-25,9103
4526,東台,21,0,21,群益金鼎-松山,2024-09-25,9103
00633L,富邦上証正2,20,0,20,群益金鼎-松山,2024-09-25,9103
00680L,元大美債20正2,20,0,20,群益金鼎-松山,2024-09-25,9103
6215,和椿,58,38,20,群益金鼎-松山,2024-09-25,9103
2382,廣達,32,13,19,群益金鼎-松山,2024-09-25,9103
3047,訊舟,41,24,17,群益金鼎-松山,2024-09-25,9103
00639,富邦深100,15,0,15,群益金鼎-松山,2024-09-25,9103
2365,昆盈,60,48,12,群益金鼎-松山,2024-09-25,9103
00679B,元大美債20年,11,0,11,群益金鼎-松山,2024-09-25,9103
1785,光洋科,12,1,11,群益金鼎-松山,2024-09-25,9103
1337,再生-KY,10,0,10,群益金鼎-松山,2024-09-25,9103
2537,聯上發,10,0,10,群益金鼎-松山,2024-09-25,9103
3312,弘憶股,16,6,10,群益金鼎-松山,2024-09-25,9103
3498,陽程,11,1,10,群益金鼎-松山,2024-09-25,9103
3588,通嘉,10,0,10,群益金鼎-松山,2024-09-25,9103
4716,大立,10,0,10,群益金鼎-松山,2024-09-25,9103
5481,新華,10,0,10,群益金鼎-松山,2024-09-25,9103
6546,正基,13,3,10,群益金鼎-松山,2024-09-25,9103
8046,南電,10,0,10,群益金鼎-松山,2024-09-25,9103
2464,盟立,17,8,9,群益金鼎-松山,2024-09-25,9103
2467,志聖,12,3,9,群益金鼎-松山,2024-09-25,9103
3049,精金,10,1,9,群益金鼎-松山,2024-09-25,9103
4551,智伸科,8,0,8,群益金鼎-松山,2024-09-25,9103
4931,新盛力,8,0,8,群益金鼎-松山,2024-09-25,9103
1808,潤隆,7,0,7,群益金鼎-松山,2024-09-25,9103
3265,台星科,9,2,7,群益金鼎-松山,2024-09-25,9103
1612,宏泰,6,0,6,群益金鼎-松山,2024-09-25,9103
3714,富采,6,0,6,群益金鼎-松山,2024-09-25,9103
6906,現觀科,6,0,6,群益金鼎-松山,2024-09-25,9103
00945B,凱基美國非投等債,5,0,5,群益金鼎-松山,2024-09-25,9103
2359,所羅門,13,8,5,群益金鼎-松山,2024-09-25,9103
2371,大同,5,0,5,群益金鼎-松山,2024-09-25,9103
3663,鑫科,9,4,5,群益金鼎-松山,2024-09-25,9103
8043,蜜望實,10,5,5,群益金鼎-松山,2024-09-25,9103
1216,統一,4,0,4,群益金鼎-松山,2024-09-25,9103
3149,正達,5,1,4,群益金鼎-松山,2024-09-25,9103
6143,振曜,5,1,4,群益金鼎-松山,2024-09-25,9103
3178,公準,4,1,3,群益金鼎-松山,2024-09-25,9103
3303,岱稜,3,0,3,群益金鼎-松山,2024-09-25,9103
2891,中信金,199,0,199,群益金鼎-松山,2024-09-26,9103
00650L,復華香港正2,100,0,100,群益金鼎-松山,2024-09-26,9103
2409,友達,100,0,100,群益金鼎-松山,2024-09-26,9103
8111,立��,118,23,95,群益金鼎-松山,2024-09-26,9103
2408,南亞科,56,0,56,群益金鼎-松山,2024-09-26,9103
4303,信立,50,0,50,群益金鼎-松山,2024-09-26,9103
00937B,群益ESG投等債20,40,0,40,群益金鼎-松山,2024-09-26,9103
00633L,富邦上証正2,40,0,40,群益金鼎-松山,2024-09-26,9103
00637L,元大滬深300正2,40,1,39,群益金鼎-松山,2024-09-26,9103
00687B,國泰20年美債,33,0,33,群益金鼎-松山,2024-09-26,9103
00960,野村全球航運龍頭,32,0,32,群益金鼎-松山,2024-09-26,9103
2929,淘帝-KY,30,0,30,群益金鼎-松山,2024-09-26,9103
912000,晨訊科-DR,25,0,25,群益金鼎-松山,2024-09-26,9103
00720B,元大投資級公司債,22,0,22,群益金鼎-松山,2024-09-26,9103
2362,藍天,24,2,22,群益金鼎-松山,2024-09-26,9103
4935,茂林-KY,23,1,22,群益金鼎-松山,2024-09-26,9103
1540,喬福,20,0,20,群益金鼎-松山,2024-09-26,9103
2374,佳能,20,0,20,群益金鼎-松山,2024-09-26,9103
2543,皇昌,40,20,20,群益金鼎-松山,2024-09-26,9103
2897,王道銀行,20,0,20,群益金鼎-松山,2024-09-26,9103
3622,洋華,30,10,20,群益金鼎-松山,2024-09-26,9103
5328,華容,20,0,20,群益金鼎-松山,2024-09-26,9103
6117,迎廣,20,0,20,群益金鼎-松山,2024-09-26,9103
2615,萬海,31,12,19,群益金鼎-松山,2024-09-26,9103
2317,鴻海,26,9,17,群益金鼎-松山,2024-09-26,9103
3260,威剛,17,1,16,群益金鼎-松山,2024-09-26,9103
00957B,兆豐US優選投等債,16,0,16,群益金鼎-松山,2024-09-26,9103
3019,亞光,16,1,15,群益金鼎-松山,2024-09-26,9103
00665L,富邦�琤肭磪囓�2,40,25,15,群益金鼎-松山,2024-09-26,9103
2324,仁寶,15,0,15,群益金鼎-松山,2024-09-26,9103
3588,通嘉,12,0,12,群益金鼎-松山,2024-09-26,9103
6546,正基,14,2,12,群益金鼎-松山,2024-09-26,9103
00632R,元大台灣50反1,10,0,10,群益金鼎-松山,2024-09-26,9103
00674R,期元大S＆P黃金反1,10,0,10,群益金鼎-松山,2024-09-26,9103
00706L,期元大S＆P日圓正2,10,0,10,群益金鼎-松山,2024-09-26,9103
00700,富邦�琤肭磪�,10,0,10,群益金鼎-松山,2024-09-26,9103
00688L,國泰20年美債正2,10,0,10,群益金鼎-松山,2024-09-26,9103
1513,中興電,10,0,10,群益金鼎-松山,2024-09-26,9103
1514,亞力,13,3,10,群益金鼎-松山,2024-09-26,9103
2312,金寶,18,8,10,群益金鼎-松山,2024-09-26,9103
4967,十銓,13,3,10,群益金鼎-松山,2024-09-26,9103
6246,臺龍,10,0,10,群益金鼎-松山,2024-09-26,9103
9907,統一實,10,0,10,群益金鼎-松山,2024-09-26,9103
3149,正達,14,6,8,群益金鼎-松山,2024-09-26,9103
6757,台灣虎航,13,5,8,群益金鼎-松山,2024-09-26,9103
2250,IKKA-KY,6,0,6,群益金鼎-松山,2024-09-26,9103
5243,乙盛-KY,12,6,6,群益金鼎-松山,2024-09-26,9103
6719,力智,6,0,6,群益金鼎-松山,2024-09-26,9103
3702,大聯大,6,0,6,群益金鼎-松山,2024-09-26,9103
00680L,元大美債20正2,5,0,5,群益金鼎-松山,2024-09-26,9103
2022,聚亨,609,437,172,群益金鼎-松山,2024-09-27,9103
2002,中鋼,180,10,170,群益金鼎-松山,2024-09-27,9103
2014,中鴻,175,70,105,群益金鼎-松山,2024-09-27,9103
8111,立��,203,101,102,群益金鼎-松山,2024-09-27,9103
2609,陽明,97,12,85,群益金鼎-松山,2024-09-27,9103
2605,新興,71,11,60,群益金鼎-松山,2024-09-27,9103
6462,神盾,52,3,49,群益金鼎-松山,2024-09-27,9103
00687B,國泰20年美債,35,1,34,群益金鼎-松山,2024-09-27,9103
2618,長榮航,35,3,32,群益金鼎-松山,2024-09-27,9103
8028,昇陽半導體,35,4,31,群益金鼎-松山,2024-09-27,9103
1301,台塑,30,0,30,群益金鼎-松山,2024-09-27,9103
5871,中租-KY,30,4,26,群益金鼎-松山,2024-09-27,9103
2023,燁輝,80,56,24,群益金鼎-松山,2024-09-27,9103
2606,裕民,21,0,21,群益金鼎-松山,2024-09-27,9103
00720B,元大投資級公司債,20,0,20,群益金鼎-松山,2024-09-27,9103
00960,野村全球航運龍頭,17,0,17,群益金鼎-松山,2024-09-27,9103
00937B,群益ESG投等債20,17,0,17,群益金鼎-松山,2024-09-27,9103
2009,第一銅,50,33,17,群益金鼎-松山,2024-09-27,9103
8150,南茂,17,0,17,群益金鼎-松山,2024-09-27,9103
00931B,統一美債20年,15,0,15,群益金鼎-松山,2024-09-27,9103
3081,聯亞,15,1,14,群益金鼎-松山,2024-09-27,9103
6546,正基,13,1,12,群益金鼎-松山,2024-09-27,9103
00679B,元大美債20年,14,2,12,群益金鼎-松山,2024-09-27,9103
00957B,兆豐US優選投等債,10,0,10,群益金鼎-松山,2024-09-27,9103
00700,富邦�琤肭磪�,10,0,10,群益金鼎-松山,2024-09-27,9103
2344,華邦電,10,0,10,群益金鼎-松山,2024-09-27,9103
2883,凱基金,10,0,10,群益金鼎-松山,2024-09-27,9103
2897,王道銀行,10,0,10,群益金鼎-松山,2024-09-27,9103
3037,欣興,20,11,9,群益金鼎-松山,2024-09-27,9103
00945B,凱基美國非投等債,8,0,8,群益金鼎-松山,2024-09-27,9103
1307,三芳,8,0,8,群益金鼎-松山,2024-09-27,9103
1409,新纖,18,10,8,群益金鼎-松山,2024-09-27,9103
6138,茂達,10,3,7,群益金鼎-松山,2024-09-27,9103
3163,波若威,11,5,6,群益金鼎-松山,2024-09-27,9103
6415,矽力*-KY,6,0,6,群益金鼎-松山,2024-09-27,9103
2891,中信金,17,12,5,群益金鼎-松山,2024-09-27,9103
3260,威剛,6,1,5,群益金鼎-松山,2024-09-27,9103
4919,新唐,5,0,5,群益金鼎-松山,2024-09-27,9103
6757,台灣虎航,5,0,5,群益金鼎-松山,2024-09-27,9103
6869,雲豹能源,5,0,5,群益金鼎-松山,2024-09-27,9103
2548,華固,5,0,5,群益金鼎-松山,2024-09-27,9103
3450,聯鈞,6,2,4,群益金鼎-松山,2024-09-27,9103
1216,統一,4,0,4,群益金鼎-松山,2024-09-27,9103
00933B,國泰10Y+金融債,5,1,4,群益金鼎-松山,2024-09-27,9103
3013,晟銘電,4,0,4,群益金鼎-松山,2024-09-27,9103
8043,蜜望實,4,0,4,群益金鼎-松山,2024-09-27,9103
00881,國泰台灣5G+,5,2,3,群益金鼎-松山,2024-09-27,9103
1720,生達,3,0,3,群益金鼎-松山,2024-09-27,9103
2612,中航,3,0,3,群益金鼎-松山,2024-09-27,9103
3607,谷崧,3,0,3,群益金鼎-松山,2024-09-27,9103
00637L,元大滬深300正2,400,266,134,群益金鼎-松山,2024-09-30,9103
00940,元大台灣價值高息,121,3,118,群益金鼎-松山,2024-09-30,9103
2014,中鴻,230,128,102,群益金鼎-松山,2024-09-30,9103
2330,台積電,94,2,92,群益金鼎-松山,2024-09-30,9103
1802,台玻,99,10,89,群益金鼎-松山,2024-09-30,9103
00687B,國泰20年美債,63,0,63,群益金鼎-松山,2024-09-30,9103
00753L,中信中國50正2,66,12,54,群益金鼎-松山,2024-09-30,9103
6462,神盾,52,0,52,群益金鼎-松山,2024-09-30,9103
00919,群益台灣精選高息,50,5,45,群益金鼎-松山,2024-09-30,9103
5014,建錩,36,0,36,群益金鼎-松山,2024-09-30,9103
9935,慶豐富,124,89,35,群益金鼎-松山,2024-09-30,9103
2609,陽明,45,17,28,群益金鼎-松山,2024-09-30,9103
00929,復華台灣科技優息,25,0,25,群益金鼎-松山,2024-09-30,9103
1905,華紙,23,0,23,群益金鼎-松山,2024-09-30,9103
2605,新興,64,41,23,群益金鼎-松山,2024-09-30,9103
2891,中信金,32,9,23,群益金鼎-松山,2024-09-30,9103
00937B,群益ESG投等債20,42,20,22,群益金鼎-松山,2024-09-30,9103
00752,中信中國50,20,0,20,群益金鼎-松山,2024-09-30,9103
2897,王道銀行,20,0,20,群益金鼎-松山,2024-09-30,9103
2615,萬海,24,5,19,群益金鼎-松山,2024-09-30,9103
2033,佳大,18,0,18,群益金鼎-松山,2024-09-30,9103
6438,迅得,20,3,17,群益金鼎-松山,2024-09-30,9103
1605,華新,16,0,16,群益金鼎-松山,2024-09-30,9103
2383,台光電,16,1,15,群益金鼎-松山,2024-09-30,9103
00639,富邦深100,13,0,13,群益金鼎-松山,2024-09-30,9103
3588,通嘉,14,3,11,群益金鼎-松山,2024-09-30,9103
00857B,永豐20年美公債,10,0,10,群益金鼎-松山,2024-09-30,9103
00688L,國泰20年美債正2,10,0,10,群益金鼎-松山,2024-09-30,9103
00959B,大華投等美債15Y+,10,0,10,群益金鼎-松山,2024-09-30,9103
00934,中信成長高股息,10,0,10,群益金鼎-松山,2024-09-30,9103
1467,南緯,10,0,10,群益金鼎-松山,2024-09-30,9103
2103,台橡,10,0,10,群益金鼎-松山,2024-09-30,9103
2420,新巨,12,2,10,群益金鼎-松山,2024-09-30,9103
2929,淘帝-KY,10,0,10,群益金鼎-松山,2024-09-30,9103
3017,奇鋐,10,0,10,群益金鼎-松山,2024-09-30,9103
3189,景碩,10,0,10,群益金鼎-松山,2024-09-30,9103
00878,國泰永續高股息,10,0,10,群益金鼎-松山,2024-09-30,9103
00715L,期街口布蘭特正2,9,0,9,群益金鼎-松山,2024-09-30,9103
00948B,中信優息投資級債,9,0,9,群益金鼎-松山,2024-09-30,9103
1569,濱川,9,0,9,群益金鼎-松山,2024-09-30,9103
6143,振曜,11,2,9,群益金鼎-松山,2024-09-30,9103
00923,群益台ESG低碳50,7,0,7,群益金鼎-松山,2024-09-30,9103
3041,揚智,7,0,7,群益金鼎-松山,2024-09-30,9103
00918,大華優利高填息30,6,0,6,群益金鼎-松山,2024-09-30,9103
00960,野村全球航運龍頭,6,0,6,群益金鼎-松山,2024-09-30,9103
5608,四維航,36,30,6,群益金鼎-松山,2024-09-30,9103
6288,聯嘉,6,0,6,群益金鼎-松山,2024-09-30,9103
9907,統一實,6,0,6,群益金鼎-松山,2024-09-30,9103
00945B,凱基美國非投等債,5,0,5,群益金鼎-松山,2024-09-30,9103
00896,中信綠能及電動車,5,0,5,群益金鼎-松山,2024-09-30,9103
00665L,富邦�琤肭磪囓�2,771,0,771,群益金鼎-松山,2024-10-01,9103
00637L,元大滬深300正2,536,0,536,群益金鼎-松山,2024-10-01,9103
00633L,富邦上証正2,326,0,326,群益金鼎-松山,2024-10-01,9103
00960,野村全球航運龍頭,120,0,120,群益金鼎-松山,2024-10-01,9103
0056,元大高股息,68,0,68,群益金鼎-松山,2024-10-01,9103
00929,復華台灣科技優息,33,0,33,群益金鼎-松山,2024-10-01,9103
020033,統一�琤肮黕篾,30,0,30,群益金鼎-松山,2024-10-01,9103
2613,中櫃,36,6,30,群益金鼎-松山,2024-10-01,9103
6218,豪勉,21,0,21,群益金鼎-松山,2024-10-01,9103
1467,南緯,20,0,20,群益金鼎-松山,2024-10-01,9103
3025,星通,20,0,20,群益金鼎-松山,2024-10-01,9103
2417,圓剛,18,0,18,群益金鼎-松山,2024-10-01,9103
8349,�矬�,20,2,18,群益金鼎-松山,2024-10-01,9103
3450,聯鈞,18,3,15,群益金鼎-松山,2024-10-01,9103
2365,昆盈,11,0,11,群益金鼎-松山,2024-10-01,9103
2486,一詮,15,4,11,群益金鼎-松山,2024-10-01,9103
1802,台玻,10,0,10,群益金鼎-松山,2024-10-01,9103
2362,藍天,10,0,10,群益金鼎-松山,2024-10-01,9103
6239,力成,20,12,8,群益金鼎-松山,2024-10-01,9103
6438,迅得,15,7,8,群益金鼎-松山,2024-10-01,9103
2250,IKKA-KY,7,0,7,群益金鼎-松山,2024-10-01,9103
3615,安可,8,1,7,群益金鼎-松山,2024-10-01,9103
4716,大立,8,1,7,群益金鼎-松山,2024-10-01,9103
5876,上海商銀,9,2,7,群益金鼎-松山,2024-10-01,9103
8104,錸寶,7,0,7,群益金鼎-松山,2024-10-01,9103
8249,菱光,7,0,7,群益金鼎-松山,2024-10-01,9103
4979,華星光,15,9,6,群益金鼎-松山,2024-10-01,9103
2317,鴻海,13,7,6,群益金鼎-松山,2024-10-01,9103
1595,川寶,6,0,6,群益金鼎-松山,2024-10-01,9103
2363,矽統,8,2,6,群益金鼎-松山,2024-10-01,9103
3149,正達,10,4,6,群益金鼎-松山,2024-10-01,9103
3624,光頡,14,8,6,群益金鼎-松山,2024-10-01,9103
2002,中鋼,5,0,5,群益金鼎-松山,2024-10-01,9103
00927,群益半導體收益,5,0,5,群益金鼎-松山,2024-10-01,9103
00752,中信中國50,5,0,5,群益金鼎-松山,2024-10-01,9103
2313,華通,5,0,5,群益金鼎-松山,2024-10-01,9103
2425,承啟,5,0,5,群益金鼎-松山,2024-10-01,9103
2520,冠德,5,0,5,群益金鼎-松山,2024-10-01,9103
2537,聯上發,5,0,5,群益金鼎-松山,2024-10-01,9103
3312,弘憶股,5,0,5,群益金鼎-松山,2024-10-01,9103
3540,曜越,6,1,5,群益金鼎-松山,2024-10-01,9103
6491,晶碩,5,0,5,群益金鼎-松山,2024-10-01,9103
1815,富喬,6,1,5,群益金鼎-松山,2024-10-01,9103
00715L,期街口布蘭特正2,4,0,4,群益金鼎-松山,2024-10-01,9103
2383,台光電,9,5,4,群益金鼎-松山,2024-10-01,9103
2929,淘帝-KY,14,10,4,群益金鼎-松山,2024-10-01,9103
3041,揚智,4,0,4,群益金鼎-松山,2024-10-01,9103
3430,奇鈦科,4,0,4,群益金鼎-松山,2024-10-01,9103
4909,新復興,6,2,4,群益金鼎-松山,2024-10-01,9103
5432,新門,4,0,4,群益金鼎-松山,2024-10-01,9103
00665L,富邦�琤肭磪囓�2,470,50,420,群益金鼎-松山,2024-10-04,9103
2498,宏達電,110,0,110,群益金鼎-松山,2024-10-04,9103
00960,野村全球航運龍頭,98,0,98,群益金鼎-松山,2024-10-04,9103
00940,元大台灣價值高息,73,0,73,群益金鼎-松山,2024-10-04,9103
00919,群益台灣精選高息,73,0,73,群益金鼎-松山,2024-10-04,9103
2014,中鴻,64,0,64,群益金鼎-松山,2024-10-04,9103
00918,大華優利高填息30,50,0,50,群益金鼎-松山,2024-10-04,9103
00929,復華台灣科技優息,47,0,47,群益金鼎-松山,2024-10-04,9103
00939,統一台灣高息動能,40,0,40,群益金鼎-松山,2024-10-04,9103
0056,元大高股息,38,0,38,群益金鼎-松山,2024-10-04,9103
1301,台塑,30,0,30,群益金鼎-松山,2024-10-04,9103
2349,錸德,60,30,30,群益金鼎-松山,2024-10-04,9103
2030,彰源,94,65,29,群益金鼎-松山,2024-10-04,9103
2022,聚亨,85,59,26,群益金鼎-松山,2024-10-04,9103
2897,王道銀行,25,0,25,群益金鼎-松山,2024-10-04,9103
00878,國泰永續高股息,22,0,22,群益金鼎-松山,2024-10-04,9103
8349,�矬�,26,5,21,群益金鼎-松山,2024-10-04,9103
1309,台達化,20,0,20,群益金鼎-松山,2024-10-04,9103
2891,中信金,17,0,17,群益金鼎-松山,2024-10-04,9103
00687B,國泰20年美債,18,1,17,群益金鼎-松山,2024-10-04,9103
00753L,中信中國50正2,15,0,15,群益金鼎-松山,2024-10-04,9103
00905,FT臺灣Smart,14,0,14,群益金鼎-松山,2024-10-04,9103
2929,淘帝-KY,24,10,14,群益金鼎-松山,2024-10-04,9103
2351,順德,12,0,12,群益金鼎-松山,2024-10-04,9103
2603,長榮,44,32,12,群益金鼎-松山,2024-10-04,9103
2637,慧洋-KY,12,0,12,群益金鼎-松山,2024-10-04,9103
2884,玉山金,12,0,12,群益金鼎-松山,2024-10-04,9103
00688L,國泰20年美債正2,11,0,11,群益金鼎-松山,2024-10-04,9103
6425,易發,19,8,11,群益金鼎-松山,2024-10-04,9103
8039,台虹,12,1,11,群益金鼎-松山,2024-10-04,9103
1467,南緯,10,0,10,群益金鼎-松山,2024-10-04,9103
1605,華新,10,0,10,群益金鼎-松山,2024-10-04,9103
2103,台橡,10,0,10,群益金鼎-松山,2024-10-04,9103
3374,精材,12,2,10,群益金鼎-松山,2024-10-04,9103
3455,由田,10,0,10,群益金鼎-松山,2024-10-04,9103
6246,臺龍,10,0,10,群益金鼎-松山,2024-10-04,9103
6505,台塑化,10,0,10,群益金鼎-松山,2024-10-04,9103
00882,中信中國高股息,27,18,9,群益金鼎-松山,2024-10-04,9103
3624,光頡,11,2,9,群益金鼎-松山,2024-10-04,9103
00907,永豐優息存股,8,0,8,群益金鼎-松山,2024-10-04,9103
3090,日電貿,8,0,8,群益金鼎-松山,2024-10-04,9103
00679B,元大美債20年,7,0,7,群益金鼎-松山,2024-10-04,9103
1569,濱川,12,5,7,群益金鼎-松山,2024-10-04,9103
2425,承啟,12,5,7,群益金鼎-松山,2024-10-04,9103
5351,鈺創,9,2,7,群益金鼎-松山,2024-10-04,9103
00706L,期元大S＆P日圓正2,6,0,6,群益金鼎-松山,2024-10-04,9103
3481,群創,106,100,6,群益金鼎-松山,2024-10-04,9103
3615,安可,6,0,6,群益金鼎-松山,2024-10-04,9103
4938,和碩,14,8,6,群益金鼎-松山,2024-10-04,9103
5871,中租-KY,6,0,6,群益金鼎-松山,2024-10-04,9103
00637L,元大滬深300正2,937,2,935,群益金鼎-松山,2024-10-07,9103
00665L,富邦�琤肭磪囓�2,801,101,700,群益金鼎-松山,2024-10-07,9103
2891,中信金,210,13,197,群益金鼎-松山,2024-10-07,9103
00633L,富邦上証正2,176,20,156,群益金鼎-松山,2024-10-07,9103
00650L,復華香港正2,125,10,115,群益金鼎-松山,2024-10-07,9103
0061,元大寶滬深,111,0,111,群益金鼎-松山,2024-10-07,9103
1909,榮成,110,0,110,群益金鼎-松山,2024-10-07,9103
1314,中石化,98,0,98,群益金鼎-松山,2024-10-07,9103
3363,上詮,64,12,52,群益金鼎-松山,2024-10-07,9103
00877,復華中國5G,50,0,50,群益金鼎-松山,2024-10-07,9103
2897,王道銀行,45,0,45,群益金鼎-松山,2024-10-07,9103
3019,亞光,35,1,34,群益金鼎-松山,2024-10-07,9103
00960,野村全球航運龍頭,30,0,30,群益金鼎-松山,2024-10-07,9103
00830,國泰費城半導體,30,0,30,群益金鼎-松山,2024-10-07,9103
4303,信立,30,0,30,群益金鼎-松山,2024-10-07,9103
2486,一詮,37,13,24,群益金鼎-松山,2024-10-07,9103
2609,陽明,27,3,24,群益金鼎-松山,2024-10-07,9103
6202,盛群,23,0,23,群益金鼎-松山,2024-10-07,9103
00725B,國泰投資級公司債,22,0,22,群益金鼎-松山,2024-10-07,9103
00706L,期元大S＆P日圓正2,21,0,21,群益金鼎-松山,2024-10-07,9103
2313,華通,24,3,21,群益金鼎-松山,2024-10-07,9103
8064,東捷,21,0,21,群益金鼎-松山,2024-10-07,9103
2903,遠百,20,0,20,群益金鼎-松山,2024-10-07,9103
2615,萬海,21,2,19,群益金鼎-松山,2024-10-07,9103
3049,精金,20,1,19,群益金鼎-松山,2024-10-07,9103
00919,群益台灣精選高息,18,0,18,群益金鼎-松山,2024-10-07,9103
2360,致茂,19,1,18,群益金鼎-松山,2024-10-07,9103
00688L,國泰20年美債正2,15,0,15,群益金鼎-松山,2024-10-07,9103
00632R,元大台灣50反1,15,0,15,群益金鼎-松山,2024-10-07,9103
2371,大同,15,0,15,群益金鼎-松山,2024-10-07,9103
2543,皇昌,13,0,13,群益金鼎-松山,2024-10-07,9103
8349,�矬�,13,0,13,群益金鼎-松山,2024-10-07,9103
5443,均豪,29,17,12,群益金鼎-松山,2024-10-07,9103
00680L,元大美債20正2,10,0,10,群益金鼎-松山,2024-10-07,9103
3081,聯亞,15,5,10,群益金鼎-松山,2024-10-07,9103
1210,大成,10,0,10,群益金鼎-松山,2024-10-07,9103
00687B,國泰20年美債,10,0,10,群益金鼎-松山,2024-10-07,9103
00720B,元大投資級公司債,10,0,10,群益金鼎-松山,2024-10-07,9103
00795B,中信美國公債20年,10,0,10,群益金鼎-松山,2024-10-07,9103
1467,南緯,10,0,10,群益金鼎-松山,2024-10-07,9103
2258,鴻華先進-創,10,0,10,群益金鼎-松山,2024-10-07,9103
2884,玉山金,10,0,10,群益金鼎-松山,2024-10-07,9103
2906,高林,10,0,10,群益金鼎-松山,2024-10-07,9103
3041,揚智,12,2,10,群益金鼎-松山,2024-10-07,9103
4716,大立,10,0,10,群益金鼎-松山,2024-10-07,9103
6416,瑞祺電通,10,0,10,群益金鼎-松山,2024-10-07,9103
00651R,復華香港反1,9,0,9,群益金鼎-松山,2024-10-07,9103
00887,永豐中國科技50大,24,15,9,群益金鼎-松山,2024-10-07,9103
6279,胡連,9,0,9,群益金鼎-松山,2024-10-07,9103
4979,華星光,13,5,8,群益金鼎-松山,2024-10-07,9103
00665L,富邦�琤肭磪囓�2,356,10,346,群益金鼎-松山,2024-10-08,9103
00753L,中信中國50正2,240,10,230,群益金鼎-松山,2024-10-08,9103
0061,元大寶滬深,221,9,212,群益金鼎-松山,2024-10-08,9103
3149,正達,279,107,172,群益金鼎-松山,2024-10-08,9103
00637L,元大滬深300正2,222,97,125,群益金鼎-松山,2024-10-08,9103
00882,中信中國高股息,102,8,94,群益金鼎-松山,2024-10-08,9103
2363,矽統,83,8,75,群益金鼎-松山,2024-10-08,9103
00633L,富邦上証正2,79,16,63,群益金鼎-松山,2024-10-08,9103
00887,永豐中國科技50大,56,3,53,群益金鼎-松山,2024-10-08,9103
3036,文曄,53,2,51,群益金鼎-松山,2024-10-08,9103
2897,王道銀行,35,0,35,群益金鼎-松山,2024-10-08,9103
00919,群益台灣精選高息,31,0,31,群益金鼎-松山,2024-10-08,9103
3209,全科,36,5,31,群益金鼎-松山,2024-10-08,9103
00881,國泰台灣5G+,29,1,28,群益金鼎-松山,2024-10-08,9103
2601,益航,31,3,28,群益金鼎-松山,2024-10-08,9103
3363,上詮,31,6,25,群益金鼎-松山,2024-10-08,9103
4303,信立,22,0,22,群益金鼎-松山,2024-10-08,9103
5876,上海商銀,19,0,19,群益金鼎-松山,2024-10-08,9103
2356,英業達,17,0,17,群益金鼎-松山,2024-10-08,9103
00929,復華台灣科技優息,16,0,16,群益金鼎-松山,2024-10-08,9103
4935,茂林-KY,15,0,15,群益金鼎-松山,2024-10-08,9103
00918,大華優利高填息30,13,0,13,群益金鼎-松山,2024-10-08,9103
6138,茂達,13,0,13,群益金鼎-松山,2024-10-08,9103
00878,國泰永續高股息,13,0,13,群益金鼎-松山,2024-10-08,9103
8070,長華*,12,0,12,群益金鼎-松山,2024-10-08,9103
8349,�矬�,11,0,11,群益金鼎-松山,2024-10-08,9103
00937B,群益ESG投等債20,10,0,10,群益金鼎-松山,2024-10-08,9103
00725B,國泰投資級公司債,10,0,10,群益金鼎-松山,2024-10-08,9103
00795B,中信美國公債20年,10,0,10,群益金鼎-松山,2024-10-08,9103
00632R,元大台灣50反1,10,0,10,群益金鼎-松山,2024-10-08,9103
2316,楠梓電,11,1,10,群益金鼎-松山,2024-10-08,9103
3615,安可,11,1,10,群益金鼎-松山,2024-10-08,9103
2317,鴻海,11,3,8,群益金鼎-松山,2024-10-08,9103
4551,智伸科,8,0,8,群益金鼎-松山,2024-10-08,9103
0056,元大高股息,7,0,7,群益金鼎-松山,2024-10-08,9103
6143,振曜,7,0,7,群益金鼎-松山,2024-10-08,9103
2467,志聖,7,0,7,群益金鼎-松山,2024-10-08,9103
2609,陽明,6,0,6,群益金鼎-松山,2024-10-08,9103
4938,和碩,8,2,6,群益金鼎-松山,2024-10-08,9103
5483,中美晶,6,0,6,群益金鼎-松山,2024-10-08,9103
8097,常珵,6,0,6,群益金鼎-松山,2024-10-08,9103
6546,正基,5,0,5,群益金鼎-松山,2024-10-08,9103
00912,中信臺灣智慧50,5,0,5,群益金鼎-松山,2024-10-08,9103
00896,中信綠能及電動車,5,0,5,群益金鼎-松山,2024-10-08,9103
00673R,期元大S＆P原油反1,5,0,5,群益金鼎-松山,2024-10-08,9103
2344,華邦電,5,0,5,群益金鼎-松山,2024-10-08,9103
2485,兆赫,45,40,5,群益金鼎-松山,2024-10-08,9103
3025,星通,19,14,5,群益金鼎-松山,2024-10-08,9103
3048,益登,6,1,5,群益金鼎-松山,2024-10-08,9103
6125,廣運,5,0,5,群益金鼎-松山,2024-10-08,9103
00650L,復華香港正2,230,30,200,群益金鼎-松山,2024-10-09,9103
3049,精金,102,2,100,群益金鼎-松山,2024-10-09,9103
2609,陽明,83,0,83,群益金鼎-松山,2024-10-09,9103
4303,信立,52,0,52,群益金鼎-松山,2024-10-09,9103
2449,京元電子,62,11,51,群益金鼎-松山,2024-10-09,9103
00907,永豐優息存股,41,0,41,群益金鼎-松山,2024-10-09,9103
00830,國泰費城半導體,31,0,31,群益金鼎-松山,2024-10-09,9103
00687B,國泰20年美債,26,0,26,群益金鼎-松山,2024-10-09,9103
2897,王道銀行,25,0,25,群益金鼎-松山,2024-10-09,9103
00633L,富邦上証正2,70,50,20,群益金鼎-松山,2024-10-09,9103
6215,和椿,27,7,20,群益金鼎-松山,2024-10-09,9103
00688L,國泰20年美債正2,98,80,18,群益金鼎-松山,2024-10-09,9103
5309,系統電,18,0,18,群益金鼎-松山,2024-10-09,9103
00960,野村全球航運龍頭,17,0,17,群益金鼎-松山,2024-10-09,9103
3706,神達,17,0,17,群益金鼎-松山,2024-10-09,9103
6937,天虹,16,1,15,群益金鼎-松山,2024-10-09,9103
2884,玉山金,15,1,14,群益金鼎-松山,2024-10-09,9103
6187,萬潤,18,5,13,群益金鼎-松山,2024-10-09,9103
2362,藍天,26,14,12,群益金鼎-松山,2024-10-09,9103
5871,中租-KY,13,2,11,群益金鼎-松山,2024-10-09,9103
1605,華新,17,6,11,群益金鼎-松山,2024-10-09,9103
00670L,富邦NASDAQ正2,10,0,10,群益金鼎-松山,2024-10-09,9103
00697B,元大美債7-10,10,0,10,群益金鼎-松山,2024-10-09,9103
2543,皇昌,10,0,10,群益金鼎-松山,2024-10-09,9103
3455,由田,10,0,10,群益金鼎-松山,2024-10-09,9103
3605,宏致,10,0,10,群益金鼎-松山,2024-10-09,9103
2399,映泰,21,12,9,群益金鼎-松山,2024-10-09,9103
8081,致新,9,0,9,群益金鼎-松山,2024-10-09,9103
3450,聯鈞,43,34,9,群益金鼎-松山,2024-10-09,9103
1909,榮成,8,0,8,群益金鼎-松山,2024-10-09,9103
3481,群創,9,1,8,群益金鼎-松山,2024-10-09,9103
1582,信錦,8,1,7,群益金鼎-松山,2024-10-09,9103
2313,華通,7,0,7,群益金鼎-松山,2024-10-09,9103
2603,長榮,7,0,7,群益金鼎-松山,2024-10-09,9103
3030,德律,7,0,7,群益金鼎-松山,2024-10-09,9103
00957B,兆豐US優選投等債,6,0,6,群益金鼎-松山,2024-10-09,9103
2002,中鋼,6,0,6,群益金鼎-松山,2024-10-09,9103
3406,玉晶光,6,0,6,群益金鼎-松山,2024-10-09,9103
6533,晶心科,6,0,6,群益金鼎-松山,2024-10-09,9103
3661,世芯-KY,5,0,5,群益金鼎-松山,2024-10-09,9103
00673R,期元大S＆P原油反1,5,0,5,群益金鼎-松山,2024-10-09,9103
2101,南港,5,0,5,群益金鼎-松山,2024-10-09,9103
2405,輔信,5,0,5,群益金鼎-松山,2024-10-09,9103
2637,慧洋-KY,5,0,5,群益金鼎-松山,2024-10-09,9103
4971,IET-KY,26,21,5,群益金鼎-松山,2024-10-09,9103
5871A,中租-KY甲特,5,0,5,群益金鼎-松山,2024-10-09,9103
2250,IKKA-KY,4,0,4,群益金鼎-松山,2024-10-09,9103
5392,能率,4,0,4,群益金鼎-松山,2024-10-09,9103
00887,永豐中國科技50大,44,40,4,群益金鼎-松山,2024-10-09,9103
2303,聯電,4,0,4,群益金鼎-松山,2024-10-09,9103
3149,正達,432,107,325,群益金鼎-松山,2024-10-11,9103
00929,復華台灣科技優息,274,4,270,群益金鼎-松山,2024-10-11,9103
3209,全科,203,1,202,群益金鼎-松山,2024-10-11,9103
00882,中信中國高股息,106,0,106,群益金鼎-松山,2024-10-11,9103
00687B,國泰20年美債,118,23,95,群益金鼎-松山,2024-10-11,9103
00650L,復華香港正2,50,0,50,群益金鼎-松山,2024-10-11,9103
00958B,永豐ESG銀行債15,40,0,40,群益金鼎-松山,2024-10-11,9103
2897,王道銀行,40,0,40,群益金鼎-松山,2024-10-11,9103
4956,光鋐,43,5,38,群益金鼎-松山,2024-10-11,9103
00753L,中信中國50正2,28,0,28,群益金鼎-松山,2024-10-11,9103
00665L,富邦�琤肭磪囓�2,24,0,24,群益金鼎-松山,2024-10-11,9103
2049,上銀,17,0,17,群益金鼎-松山,2024-10-11,9103
2903,遠百,15,0,15,群益金鼎-松山,2024-10-11,9103
3289,宜特,17,2,15,群益金鼎-松山,2024-10-11,9103
3025,星通,16,2,14,群益金鼎-松山,2024-10-11,9103
6416,瑞祺電通,16,3,13,群益金鼎-松山,2024-10-11,9103
8349,�矬�,11,0,11,群益金鼎-松山,2024-10-11,9103
2382,廣達,12,1,11,群益金鼎-松山,2024-10-11,9103
00912,中信臺灣智慧50,10,0,10,群益金鼎-松山,2024-10-11,9103
00795B,中信美國公債20年,10,0,10,群益金鼎-松山,2024-10-11,9103
00773B,中信優先金融債,10,0,10,群益金鼎-松山,2024-10-11,9103
00713,元大台灣高息低波,10,0,10,群益金鼎-松山,2024-10-11,9103
1532,勤美,10,0,10,群益金鼎-松山,2024-10-11,9103
1467,南緯,10,0,10,群益金鼎-松山,2024-10-11,9103
2101,南港,10,0,10,群益金鼎-松山,2024-10-11,9103
2520,冠德,10,0,10,群益金鼎-松山,2024-10-11,9103
5536,聖暉*,10,0,10,群益金鼎-松山,2024-10-11,9103
6863,永道-KY,9,0,9,群益金鼎-松山,2024-10-11,9103
5324,士開,8,0,8,群益金鼎-松山,2024-10-11,9103
2317,鴻海,16,9,7,群益金鼎-松山,2024-10-11,9103
00957B,兆豐US優選投等債,6,0,6,群益金鼎-松山,2024-10-11,9103
1802,台玻,6,0,6,群益金鼎-松山,2024-10-11,9103
5603,陸海,24,18,6,群益金鼎-松山,2024-10-11,9103
8111,立��,12,6,6,群益金鼎-松山,2024-10-11,9103
00633L,富邦上証正2,5,0,5,群益金鼎-松山,2024-10-11,9103
3663,鑫科,5,0,5,群益金鼎-松山,2024-10-11,9103
00673R,期元大S＆P原油反1,5,0,5,群益金鼎-松山,2024-10-11,9103
00907,永豐優息存股,5,0,5,群益金鼎-松山,2024-10-11,9103
1605,華新,5,0,5,群益金鼎-松山,2024-10-11,9103
2392,正崴,5,0,5,群益金鼎-松山,2024-10-11,9103
2528,皇普,5,0,5,群益金鼎-松山,2024-10-11,9103
5438,東友,5,0,5,群益金鼎-松山,2024-10-11,9103
2250,IKKA-KY,4,0,4,群益金鼎-松山,2024-10-11,9103
2454,聯發科,8,4,4,群益金鼎-松山,2024-10-11,9103
00881,國泰台灣5G+,10,7,3,群益金鼎-松山,2024-10-11,9103
1590,亞德客-KY,3,0,3,群益金鼎-松山,2024-10-11,9103
1720,生達,3,0,3,群益金鼎-松山,2024-10-11,9103
2405,輔信,3,0,3,群益金鼎-松山,2024-10-11,9103
2455,全新,3,0,3,群益金鼎-松山,2024-10-11,9103
2464,盟立,7,4,3,群益金鼎-松山,2024-10-11,9103
9105,泰金寶-DR,105,0,105,群益金鼎-松山,2024-10-14,9103
6451,訊芯-KY,74,3,71,群益金鼎-松山,2024-10-14,9103
00887,永豐中國科技50大,67,5,62,群益金鼎-松山,2024-10-14,9103
3450,聯鈞,60,18,42,群益金鼎-松山,2024-10-14,9103
3380,明泰,40,0,40,群益金鼎-松山,2024-10-14,9103
00958B,永豐ESG銀行債15,36,0,36,群益金鼎-松山,2024-10-14,9103
2007,燁興,85,50,35,群益金鼎-松山,2024-10-14,9103
00665L,富邦�琤肭磪囓�2,33,0,33,群益金鼎-松山,2024-10-14,9103
00633L,富邦上証正2,30,0,30,群益金鼎-松山,2024-10-14,9103
5324,士開,30,0,30,群益金鼎-松山,2024-10-14,9103
6142,友勁,30,0,30,群益金鼎-松山,2024-10-14,9103
00753L,中信中國50正2,34,8,26,群益金鼎-松山,2024-10-14,9103
3049,精金,23,0,23,群益金鼎-松山,2024-10-14,9103
2362,藍天,22,0,22,群益金鼎-松山,2024-10-14,9103
00679B,元大美債20年,22,1,21,群益金鼎-松山,2024-10-14,9103
00639,富邦深100,20,0,20,群益金鼎-松山,2024-10-14,9103
00700,富邦�琤肭磪�,20,0,20,群益金鼎-松山,2024-10-14,9103
8349,�矬�,18,0,18,群益金鼎-松山,2024-10-14,9103
00725B,國泰投資級公司債,15,0,15,群益金鼎-松山,2024-10-14,9103
9958,世紀鋼,18,3,15,群益金鼎-松山,2024-10-14,9103
00907,永豐優息存股,11,0,11,群益金鼎-松山,2024-10-14,9103
2543,皇昌,12,1,11,群益金鼎-松山,2024-10-14,9103
2363,矽統,10,0,10,群益金鼎-松山,2024-10-14,9103
00795B,中信美國公債20年,10,0,10,群益金鼎-松山,2024-10-14,9103
00773B,中信優先金融債,10,0,10,群益金鼎-松山,2024-10-14,9103
00764B,群益25年美債,10,0,10,群益金鼎-松山,2024-10-14,9103
00945B,凱基美國非投等債,10,0,10,群益金鼎-松山,2024-10-14,9103
00934,中信成長高股息,10,0,10,群益金鼎-松山,2024-10-14,9103
00720B,元大投資級公司債,10,0,10,群益金鼎-松山,2024-10-14,9103
2028,威致,10,0,10,群益金鼎-松山,2024-10-14,9103
8111,立��,22,12,10,群益金鼎-松山,2024-10-14,9103
3040,遠見,9,0,9,群益金鼎-松山,2024-10-14,9103
4908,前鼎,13,4,9,群益金鼎-松山,2024-10-14,9103
2388,威盛,15,8,7,群益金鼎-松山,2024-10-14,9103
2399,映泰,7,0,7,群益金鼎-松山,2024-10-14,9103
4303,信立,10,3,7,群益金鼎-松山,2024-10-14,9103
8996,高力,15,9,6,群益金鼎-松山,2024-10-14,9103
2906,高林,15,9,6,群益金鼎-松山,2024-10-14,9103
00680L,元大美債20正2,5,0,5,群益金鼎-松山,2024-10-14,9103
2344,華邦電,5,0,5,群益金鼎-松山,2024-10-14,9103
2371,大同,5,0,5,群益金鼎-松山,2024-10-14,9103
3167,大量,5,0,5,群益金鼎-松山,2024-10-14,9103
5876,上海商銀,5,0,5,群益金鼎-松山,2024-10-14,9103
6187,萬潤,7,2,5,群益金鼎-松山,2024-10-14,9103
6202,盛群,6,1,5,群益金鼎-松山,2024-10-14,9103
00931B,統一美債20年,5,1,4,群益金鼎-松山,2024-10-14,9103
00830,國泰費城半導體,30,26,4,群益金鼎-松山,2024-10-14,9103
1720,生達,4,0,4,群益金鼎-松山,2024-10-14,9103
2427,三商電,4,0,4,群益金鼎-松山,2024-10-14,9103
2745,五福,4,0,4,群益金鼎-松山,2024-10-14,9103
00887,永豐中國科技50大,55,0,55,群益金鼎-松山,2024-10-15,9103
00680L,元大美債20正2,40,0,40,群益金鼎-松山,2024-10-15,9103
020033,統一�琤肮黕篾,37,0,37,群益金鼎-松山,2024-10-15,9103
3059,華晶科,37,0,37,群益金鼎-松山,2024-10-15,9103
00753L,中信中國50正2,41,10,31,群益金鼎-松山,2024-10-15,9103
00830,國泰費城半導體,30,0,30,群益金鼎-松山,2024-10-15,9103
00670L,富邦NASDAQ正2,30,0,30,群益金鼎-松山,2024-10-15,9103
2402,毅嘉,30,0,30,群益金鼎-松山,2024-10-15,9103
6451,訊芯-KY,33,4,29,群益金鼎-松山,2024-10-15,9103
6829,千附精密,25,0,25,群益金鼎-松山,2024-10-15,9103
00665L,富邦�琤肭磪囓�2,23,0,23,群益金鼎-松山,2024-10-15,9103
3033,威健,25,3,22,群益金鼎-松山,2024-10-15,9103
4526,東台,20,0,20,群益金鼎-松山,2024-10-15,9103
8097,常珵,20,0,20,群益金鼎-松山,2024-10-15,9103
2455,全新,24,6,18,群益金鼎-松山,2024-10-15,9103
3710,連展投控,15,0,15,群益金鼎-松山,2024-10-15,9103
6138,茂達,16,2,14,群益金鼎-松山,2024-10-15,9103
00960,野村全球航運龍頭,13,0,13,群益金鼎-松山,2024-10-15,9103
2405,輔信,13,1,12,群益金鼎-松山,2024-10-15,9103
6274,台燿,13,1,12,群益金鼎-松山,2024-10-15,9103
1467,南緯,10,0,10,群益金鼎-松山,2024-10-15,9103
00655L,國泰中國A50正2,10,0,10,群益金鼎-松山,2024-10-15,9103
1605,華新,10,0,10,群益金鼎-松山,2024-10-15,9103
2059,川湖,10,0,10,群益金鼎-松山,2024-10-15,9103
2465,麗臺,10,0,10,群益金鼎-松山,2024-10-15,9103
2485,兆赫,20,10,10,群益金鼎-松山,2024-10-15,9103
3029,零壹,10,0,10,群益金鼎-松山,2024-10-15,9103
6150,撼訊,10,0,10,群益金鼎-松山,2024-10-15,9103
6215,和椿,18,8,10,群益金鼎-松山,2024-10-15,9103
6488,環球晶,10,0,10,群益金鼎-松山,2024-10-15,9103
8147,正淩,10,0,10,群益金鼎-松山,2024-10-15,9103
00713,元大台灣高息低波,9,0,9,群益金鼎-松山,2024-10-15,9103
3624,光頡,9,0,9,群益金鼎-松山,2024-10-15,9103
00687B,國泰20年美債,8,0,8,群益金鼎-松山,2024-10-15,9103
2049,上銀,9,1,8,群益金鼎-松山,2024-10-15,9103
0056,元大高股息,8,1,7,群益金鼎-松山,2024-10-15,9103
2388,威盛,16,9,7,群益金鼎-松山,2024-10-15,9103
2438,翔耀,7,0,7,群益金鼎-松山,2024-10-15,9103
8374,羅昇,12,5,7,群益金鼎-松山,2024-10-15,9103
2905,三商,24,18,6,群益金鼎-松山,2024-10-15,9103
1447,力鵬,5,0,5,群益金鼎-松山,2024-10-15,9103
00949,復華日本龍頭,5,0,5,群益金鼎-松山,2024-10-15,9103
00688L,國泰20年美債正2,5,0,5,群益金鼎-松山,2024-10-15,9103
00912,中信臺灣智慧50,5,0,5,群益金鼎-松山,2024-10-15,9103
2383,台光電,5,0,5,群益金鼎-松山,2024-10-15,9103
2537,聯上發,5,0,5,群益金鼎-松山,2024-10-15,9103
4716,大立,6,1,5,群益金鼎-松山,2024-10-15,9103
5443,均豪,24,19,5,群益金鼎-松山,2024-10-15,9103
6505,台塑化,5,0,5,群益金鼎-松山,2024-10-15,9103
2312,金寶,106,101,5,群益金鼎-松山,2024-10-15,9103
3710,連展投控,312,7,305,群益金鼎-松山,2024-10-16,9103
2883,凱基金,200,0,200,群益金鼎-松山,2024-10-16,9103
3481,群創,200,0,200,群益金鼎-松山,2024-10-16,9103
9105,泰金寶-DR,382,274,108,群益金鼎-松山,2024-10-16,9103
3591,艾笛森,70,0,70,群益金鼎-松山,2024-10-16,9103
6156,松上,65,0,65,群益金鼎-松山,2024-10-16,9103
00907,永豐優息存股,53,0,53,群益金鼎-松山,2024-10-16,9103
2312,金寶,50,6,44,群益金鼎-松山,2024-10-16,9103
00887,永豐中國科技50大,45,5,40,群益金鼎-松山,2024-10-16,9103
2897,王道銀行,40,0,40,群益金鼎-松山,2024-10-16,9103
00637L,元大滬深300正2,53,20,33,群益金鼎-松山,2024-10-16,9103
00633L,富邦上証正2,31,1,30,群益金鼎-松山,2024-10-16,9103
2449,京元電子,34,7,27,群益金鼎-松山,2024-10-16,9103
00687B,國泰20年美債,25,0,25,群益金鼎-松山,2024-10-16,9103
2882,國泰金,25,0,25,群益金鼎-松山,2024-10-16,9103
2002,中鋼,23,0,23,群益金鼎-松山,2024-10-16,9103
3049,精金,22,0,22,群益金鼎-松山,2024-10-16,9103
0056,元大高股息,21,0,21,群益金鼎-松山,2024-10-16,9103
00706L,期元大S＆P日圓正2,20,0,20,群益金鼎-松山,2024-10-16,9103
3060,銘異,20,0,20,群益金鼎-松山,2024-10-16,9103
4510,高鋒,35,15,20,群益金鼎-松山,2024-10-16,9103
3580,友威科,20,1,19,群益金鼎-松山,2024-10-16,9103
2344,華邦電,17,0,17,群益金鼎-松山,2024-10-16,9103
2330,台積電,36,21,15,群益金鼎-松山,2024-10-16,9103
6274,台燿,15,0,15,群益金鼎-松山,2024-10-16,9103
00753L,中信中國50正2,15,0,15,群益金鼎-松山,2024-10-16,9103
2365,昆盈,58,43,15,群益金鼎-松山,2024-10-16,9103
6742,澤米,15,0,15,群益金鼎-松山,2024-10-16,9103
00960,野村全球航運龍頭,14,0,14,群益金鼎-松山,2024-10-16,9103
00922,國泰台灣領袖50,14,0,14,群益金鼎-松山,2024-10-16,9103
1605,華新,13,0,13,群益金鼎-松山,2024-10-16,9103
8349,�矬�,15,2,13,群益金鼎-松山,2024-10-16,9103
00919,群益台灣精選高息,11,0,11,群益金鼎-松山,2024-10-16,9103
2888,新光金,12,1,11,群益金鼎-松山,2024-10-16,9103
5876,上海商銀,10,0,10,群益金鼎-松山,2024-10-16,9103
00943,兆豐電子高息等權,10,0,10,群益金鼎-松山,2024-10-16,9103
00929,復華台灣科技優息,10,0,10,群益金鼎-松山,2024-10-16,9103
00639,富邦深100,10,0,10,群益金鼎-松山,2024-10-16,9103
00857B,永豐20年美公債,10,0,10,群益金鼎-松山,2024-10-16,9103
2027,大成鋼,10,0,10,群益金鼎-松山,2024-10-16,9103
3209,全科,12,2,10,群益金鼎-松山,2024-10-16,9103
6164,華興,10,0,10,群益金鼎-松山,2024-10-16,9103
2421,建準,15,6,9,群益金鼎-松山,2024-10-16,9103
3661,世芯-KY,9,1,8,群益金鼎-松山,2024-10-16,9103
4542,科嶠,12,5,7,群益金鼎-松山,2024-10-16,9103
3450,聯鈞,11,5,6,群益金鼎-松山,2024-10-16,9103
5234,達興材料,6,0,6,群益金鼎-松山,2024-10-16,9103
6756,威鋒電子,10,4,6,群益金鼎-松山,2024-10-16,9103
6770,力積電,7,1,6,群益金鼎-松山,2024-10-16,9103
6829,千附精密,6,0,6,群益金鼎-松山,2024-10-16,9103
3710,連展投控,461,12,449,群益金鼎-松山,2024-10-17,9103
00959B,大華投等美債15Y+,145,0,145,群益金鼎-松山,2024-10-17,9103
00953B,群益優選非投等債,140,0,140,群益金鼎-松山,2024-10-17,9103
00650L,復華香港正2,100,0,100,群益金鼎-松山,2024-10-17,9103
00637L,元大滬深300正2,92,15,77,群益金鼎-松山,2024-10-17,9103
00887,永豐中國科技50大,54,0,54,群益金鼎-松山,2024-10-17,9103
00958B,永豐ESG銀行債15,44,0,44,群益金鼎-松山,2024-10-17,9103
6156,松上,37,0,37,群益金鼎-松山,2024-10-17,9103
00934,中信成長高股息,30,0,30,群益金鼎-松山,2024-10-17,9103
2402,毅嘉,30,1,29,群益金鼎-松山,2024-10-17,9103
9938,百和,26,2,24,群益金鼎-松山,2024-10-17,9103
00929,復華台灣科技優息,23,0,23,群益金鼎-松山,2024-10-17,9103
00633L,富邦上証正2,20,0,20,群益金鼎-松山,2024-10-17,9103
00950B,凱基A級公司債,20,0,20,群益金鼎-松山,2024-10-17,9103
020033,統一�琤肮黕篾,20,0,20,群益金鼎-松山,2024-10-17,9103
00639,富邦深100,20,0,20,群益金鼎-松山,2024-10-17,9103
3037,欣興,21,1,20,群益金鼎-松山,2024-10-17,9103
5309,系統電,20,6,14,群益金鼎-松山,2024-10-17,9103
8349,�矬�,13,0,13,群益金鼎-松山,2024-10-17,9103
8097,常珵,12,0,12,群益金鼎-松山,2024-10-17,9103
00945B,凱基美國非投等債,14,3,11,群益金鼎-松山,2024-10-17,9103
6125,廣運,23,12,11,群益金鼎-松山,2024-10-17,9103
00706L,期元大S＆P日圓正2,10,0,10,群益金鼎-松山,2024-10-17,9103
3374,精材,13,3,10,群益金鼎-松山,2024-10-17,9103
3379,彬台,20,10,10,群益金鼎-松山,2024-10-17,9103
6416,瑞祺電通,15,5,10,群益金鼎-松山,2024-10-17,9103
6829,千附精密,10,0,10,群益金鼎-松山,2024-10-17,9103
2449,京元電子,13,5,8,群益金鼎-松山,2024-10-17,9103
00922,國泰台灣領袖50,6,0,6,群益金鼎-松山,2024-10-17,9103
3062,建漢,7,1,6,群益金鼎-松山,2024-10-17,9103
00753L,中信中國50正2,5,0,5,群益金鼎-松山,2024-10-17,9103
1447,力鵬,5,0,5,群益金鼎-松山,2024-10-17,9103
1524,耿鼎,5,0,5,群益金鼎-松山,2024-10-17,9103
00665L,富邦�琤肭磪囓�2,5,0,5,群益金鼎-松山,2024-10-17,9103
00881,國泰台灣5G+,5,0,5,群益金鼎-松山,2024-10-17,9103
2520,冠德,5,0,5,群益金鼎-松山,2024-10-17,9103
2897,王道銀行,5,0,5,群益金鼎-松山,2024-10-17,9103
3081,聯亞,5,0,5,群益金鼎-松山,2024-10-17,9103
3354,律勝,5,0,5,群益金鼎-松山,2024-10-17,9103
6023,元大期,5,0,5,群益金鼎-松山,2024-10-17,9103
00907,永豐優息存股,4,0,4,群益金鼎-松山,2024-10-17,9103
1582,信錦,6,2,4,群益金鼎-松山,2024-10-17,9103
1528,恩德,14,11,3,群益金鼎-松山,2024-10-17,9103
0056,元大高股息,3,0,3,群益金鼎-松山,2024-10-17,9103
00912,中信臺灣智慧50,3,0,3,群益金鼎-松山,2024-10-17,9103
3209,全科,13,10,3,群益金鼎-松山,2024-10-17,9103
3312,弘憶股,3,0,3,群益金鼎-松山,2024-10-17,9103
3346,麗清,3,0,3,群益金鼎-松山,2024-10-17,9103
5452,佶優,3,0,3,群益金鼎-松山,2024-10-17,9103
6856,鑫傳,3,0,3,群益金鼎-松山,2024-10-17,9103
3481,群創,966,281,685,群益金鼎-松山,2024-10-18,9103
00929,復華台灣科技優息,66,0,66,群益金鼎-松山,2024-10-18,9103
9938,百和,60,0,60,群益金鼎-松山,2024-10-18,9103
00688L,國泰20年美債正2,45,0,45,群益金鼎-松山,2024-10-18,9103
00650L,復華香港正2,80,40,40,群益金鼎-松山,2024-10-18,9103
5481,新華,40,0,40,群益金鼎-松山,2024-10-18,9103
00959B,大華投等美債15Y+,38,0,38,群益金鼎-松山,2024-10-18,9103
00706L,期元大S＆P日圓正2,30,0,30,群益金鼎-松山,2024-10-18,9103
3374,精材,30,0,30,群益金鼎-松山,2024-10-18,9103
00960,野村全球航運龍頭,27,0,27,群益金鼎-松山,2024-10-18,9103
6151,晉倫,25,0,25,群益金鼎-松山,2024-10-18,9103
2303,聯電,22,0,22,群益金鼎-松山,2024-10-18,9103
3312,弘憶股,24,3,21,群益金鼎-松山,2024-10-18,9103
00881,國泰台灣5G+,20,0,20,群益金鼎-松山,2024-10-18,9103
020033,統一�琤肮黕篾,19,0,19,群益金鼎-松山,2024-10-18,9103
1806,冠軍,20,1,19,群益金鼎-松山,2024-10-18,9103
00958B,永豐ESG銀行債15,18,0,18,群益金鼎-松山,2024-10-18,9103
2109,華豐,18,0,18,群益金鼎-松山,2024-10-18,9103
4545,銘鈺,18,3,15,群益金鼎-松山,2024-10-18,9103
4510,高鋒,30,16,14,群益金鼎-松山,2024-10-18,9103
00957B,兆豐US優選投等債,12,0,12,群益金鼎-松山,2024-10-18,9103
4562,穎漢,22,10,12,群益金鼎-松山,2024-10-18,9103
2382,廣達,14,2,12,群益金鼎-松山,2024-10-18,9103
2609,陽明,11,0,11,群益金鼎-松山,2024-10-18,9103
006206,元大上證50,10,0,10,群益金鼎-松山,2024-10-18,9103
1414,東和,10,0,10,群益金鼎-松山,2024-10-18,9103
1308,亞聚,10,0,10,群益金鼎-松山,2024-10-18,9103
00720B,元大投資級公司債,10,0,10,群益金鼎-松山,2024-10-18,9103
00639,富邦深100,10,0,10,群益金鼎-松山,2024-10-18,9103
00632R,元大台灣50反1,15,5,10,群益金鼎-松山,2024-10-18,9103
1785,光洋科,10,0,10,群益金鼎-松山,2024-10-18,9103
2025,千興,10,0,10,群益金鼎-松山,2024-10-18,9103
2455,全新,10,0,10,群益金鼎-松山,2024-10-18,9103
6152,百一,10,0,10,群益金鼎-松山,2024-10-18,9103
6207,雷科,10,0,10,群益金鼎-松山,2024-10-18,9103
00687B,國泰20年美債,9,1,8,群益金鼎-松山,2024-10-18,9103
1735,日勝化,8,0,8,群益金鼎-松山,2024-10-18,9103
2062,橋椿,8,0,8,群益金鼎-松山,2024-10-18,9103
6274,台燿,7,0,7,群益金鼎-松山,2024-10-18,9103
00679B,元大美債20年,7,0,7,群益金鼎-松山,2024-10-18,9103
8097,常珵,7,0,7,群益金鼎-松山,2024-10-18,9103
00919,群益台灣精選高息,6,0,6,群益金鼎-松山,2024-10-18,9103
00637L,元大滬深300正2,6,0,6,群益金鼎-松山,2024-10-18,9103
1455,集盛,6,0,6,群益金鼎-松山,2024-10-18,9103
00725B,國泰投資級公司債,6,0,6,群益金鼎-松山,2024-10-18,9103
2008,高興昌,6,0,6,群益金鼎-松山,2024-10-18,9103
2477,美隆電,6,0,6,群益金鼎-松山,2024-10-18,9103
3550,聯穎,6,0,6,群益金鼎-松山,2024-10-18,9103
3552,同致,6,0,6,群益金鼎-松山,2024-10-18,9103
6538,倉和,6,0,6,群益金鼎-松山,2024-10-18,9103
3710,連展投控,201,8,193,群益金鼎-松山,2024-10-21,9103
00950B,凱基A級公司債,164,0,164,群益金鼎-松山,2024-10-21,9103
00637L,元大滬深300正2,116,0,116,群益金鼎-松山,2024-10-21,9103
00665L,富邦�琤肭磪囓�2,100,0,100,群益金鼎-松山,2024-10-21,9103
2409,友達,100,3,97,群益金鼎-松山,2024-10-21,9103
00959B,大華投等美債15Y+,86,0,86,群益金鼎-松山,2024-10-21,9103
00953B,群益優選非投等債,70,0,70,群益金鼎-松山,2024-10-21,9103
1528,恩德,52,2,50,群益金鼎-松山,2024-10-21,9103
020033,統一�琤肮黕篾,38,0,38,群益金鼎-松山,2024-10-21,9103
3011,今皓,58,25,33,群益金鼎-松山,2024-10-21,9103
8064,東捷,37,6,31,群益金鼎-松山,2024-10-21,9103
5481,新華,30,0,30,群益金鼎-松山,2024-10-21,9103
6138,茂達,23,2,21,群益金鼎-松山,2024-10-21,9103
00650L,復華香港正2,20,0,20,群益金鼎-松山,2024-10-21,9103
00725B,國泰投資級公司債,20,0,20,群益金鼎-松山,2024-10-21,9103
3062,建漢,20,1,19,群益金鼎-松山,2024-10-21,9103
4526,東台,32,13,19,群益金鼎-松山,2024-10-21,9103
00919,群益台灣精選高息,18,0,18,群益金鼎-松山,2024-10-21,9103
4583,台灣精銳,18,0,18,群益金鼎-松山,2024-10-21,9103
6753,龍德造船,17,0,17,群益金鼎-松山,2024-10-21,9103
4545,銘鈺,16,0,16,群益金鼎-松山,2024-10-21,9103
1597,直得,21,5,16,群益金鼎-松山,2024-10-21,9103
00929,復華台灣科技優息,15,0,15,群益金鼎-松山,2024-10-21,9103
2486,一詮,15,1,14,群益金鼎-松山,2024-10-21,9103
00881,國泰台灣5G+,13,0,13,群益金鼎-松山,2024-10-21,9103
2069,運錩,12,0,12,群益金鼎-松山,2024-10-21,9103
2884,玉山金,10,0,10,群益金鼎-松山,2024-10-21,9103
00795B,中信美國公債20年,10,0,10,群益金鼎-松山,2024-10-21,9103
2897,王道銀行,10,0,10,群益金鼎-松山,2024-10-21,9103
3498,陽程,10,0,10,群益金鼎-松山,2024-10-21,9103
9907,統一實,10,0,10,群益金鼎-松山,2024-10-21,9103
2317,鴻海,15,5,10,群益金鼎-松山,2024-10-21,9103
2615,萬海,12,3,9,群益金鼎-松山,2024-10-21,9103
3149,正達,40,31,9,群益金鼎-松山,2024-10-21,9103
6127,九豪,9,0,9,群益金鼎-松山,2024-10-21,9103
00687B,國泰20年美債,13,5,8,群益金鼎-松山,2024-10-21,9103
2634,漢翔,8,0,8,群益金鼎-松山,2024-10-21,9103
6579,研揚,19,11,8,群益金鼎-松山,2024-10-21,9103
00887,永豐中國科技50大,14,7,7,群益金鼎-松山,2024-10-21,9103
00688L,國泰20年美債正2,7,0,7,群益金鼎-松山,2024-10-21,9103
3663,鑫科,10,3,7,群益金鼎-松山,2024-10-21,9103
00830,國泰費城半導體,5,0,5,群益金鼎-松山,2024-10-21,9103
00895,富邦未來車,5,0,5,群益金鼎-松山,2024-10-21,9103
2420,新巨,5,0,5,群益金鼎-松山,2024-10-21,9103
3607,谷崧,5,0,5,群益金鼎-松山,2024-10-21,9103
4542,科嶠,5,0,5,群益金鼎-松山,2024-10-21,9103
5014,建錩,5,0,5,群益金鼎-松山,2024-10-21,9103
6270,倍微,5,0,5,群益金鼎-松山,2024-10-21,9103
3450,聯鈞,7,3,4,群益金鼎-松山,2024-10-21,9103
2881,富邦金,4,0,4,群益金鼎-松山,2024-10-21,9103
2883,凱基金,152,0,152,群益金鼎-松山,2024-10-22,9103
00637L,元大滬深300正2,113,14,99,群益金鼎-松山,2024-10-22,9103
00950B,凱基A級公司債,84,0,84,群益金鼎-松山,2024-10-22,9103
00929,復華台灣科技優息,58,2,56,群益金鼎-松山,2024-10-22,9103
00953B,群益優選非投等債,60,4,56,群益金鼎-松山,2024-10-22,9103
00937B,群益ESG投等債20,106,56,50,群益金鼎-松山,2024-10-22,9103
3390,旭軟,50,0,50,群益金鼎-松山,2024-10-22,9103
3037,欣興,49,3,46,群益金鼎-松山,2024-10-22,9103
00650L,復華香港正2,40,0,40,群益金鼎-松山,2024-10-22,9103
00725B,國泰投資級公司債,39,0,39,群益金鼎-松山,2024-10-22,9103
3257,虹冠電,42,4,38,群益金鼎-松山,2024-10-22,9103
2486,一詮,30,7,23,群益金鼎-松山,2024-10-22,9103
00959B,大華投等美債15Y+,21,0,21,群益金鼎-松山,2024-10-22,9103
4164,承業醫,20,0,20,群益金鼎-松山,2024-10-22,9103
1815,富喬,20,1,19,群益金鼎-松山,2024-10-22,9103
00687B,國泰20年美債,23,6,17,群益金鼎-松山,2024-10-22,9103
3141,晶宏,15,1,14,群益金鼎-松山,2024-10-22,9103
00795B,中信美國公債20年,12,0,12,群益金鼎-松山,2024-10-22,9103
3665,貿聯-KY,12,0,12,群益金鼎-松山,2024-10-22,9103
00907,永豐優息存股,11,0,11,群益金鼎-松山,2024-10-22,9103
00688L,國泰20年美債正2,11,0,11,群益金鼎-松山,2024-10-22,9103
3715,定穎投控,19,8,11,群益金鼎-松山,2024-10-22,9103
00706L,期元大S＆P日圓正2,10,0,10,群益金鼎-松山,2024-10-22,9103
2362,藍天,10,0,10,群益金鼎-松山,2024-10-22,9103
2363,矽統,17,7,10,群益金鼎-松山,2024-10-22,9103
2615,萬海,10,0,10,群益金鼎-松山,2024-10-22,9103
2929,淘帝-KY,10,0,10,群益金鼎-松山,2024-10-22,9103
3580,友威科,24,14,10,群益金鼎-松山,2024-10-22,9103
6165,浪凡,10,0,10,群益金鼎-松山,2024-10-22,9103
6416,瑞祺電通,12,2,10,群益金鼎-松山,2024-10-22,9103
8085,福華,10,0,10,群益金鼎-松山,2024-10-22,9103
00958B,永豐ESG銀行債15,8,0,8,群益金鼎-松山,2024-10-22,9103
00772B,中信高評級公司債,7,0,7,群益金鼎-松山,2024-10-22,9103
6290,良維,7,0,7,群益金鼎-松山,2024-10-22,9103
2449,京元電子,12,6,6,群益金鼎-松山,2024-10-22,9103
1720,生達,6,0,6,群益金鼎-松山,2024-10-22,9103
8110,華東,6,0,6,群益金鼎-松山,2024-10-22,9103
9955,佳龍,6,0,6,群益金鼎-松山,2024-10-22,9103
1595,川寶,6,1,5,群益金鼎-松山,2024-10-22,9103
1314,中石化,5,0,5,群益金鼎-松山,2024-10-22,9103
2313,華通,5,0,5,群益金鼎-松山,2024-10-22,9103
2340,台亞,5,0,5,群益金鼎-松山,2024-10-22,9103
2485,兆赫,5,0,5,群益金鼎-松山,2024-10-22,9103
2915,潤泰全,5,0,5,群益金鼎-松山,2024-10-22,9103
3520,華盈,5,0,5,群益金鼎-松山,2024-10-22,9103
5284,jpp-KY,5,0,5,群益金鼎-松山,2024-10-22,9103
6470,宇智,5,0,5,群益金鼎-松山,2024-10-22,9103
8097,常珵,5,0,5,群益金鼎-松山,2024-10-22,9103
00941,中信上游半導體,4,0,4,群益金鼎-松山,2024-10-22,9103
00949,復華日本龍頭,4,0,4,群益金鼎-松山,2024-10-22,9103
00665L,富邦�琤肭磪囓�2,150,20,130,群益金鼎-松山,2024-10-23,9103
2891,中信金,117,0,117,群益金鼎-松山,2024-10-23,9103
00959B,大華投等美債15Y+,44,0,44,群益金鼎-松山,2024-10-23,9103
3481,群創,43,1,42,群益金鼎-松山,2024-10-23,9103
6197,佳必琪,50,8,42,群益金鼎-松山,2024-10-23,9103
1522,堤維西,40,0,40,群益金鼎-松山,2024-10-23,9103
00795B,中信美國公債20年,30,0,30,群益金鼎-松山,2024-10-23,9103
3622,洋華,20,0,20,群益金鼎-松山,2024-10-23,9103
00945B,凱基美國非投等債,18,0,18,群益金鼎-松山,2024-10-23,9103
00937B,群益ESG投等債20,17,0,17,群益金鼎-松山,2024-10-23,9103
3702,大聯大,13,0,13,群益金鼎-松山,2024-10-23,9103
4935,茂林-KY,14,1,13,群益金鼎-松山,2024-10-23,9103
3055,蔚華科,22,10,12,群益金鼎-松山,2024-10-23,9103
2884,玉山金,11,0,11,群益金鼎-松山,2024-10-23,9103
00633L,富邦上証正2,10,0,10,群益金鼎-松山,2024-10-23,9103
2362,藍天,11,1,10,群益金鼎-松山,2024-10-23,9103
2537,聯上發,10,0,10,群益金鼎-松山,2024-10-23,9103
2615,萬海,10,0,10,群益金鼎-松山,2024-10-23,9103
4707,磐亞,10,0,10,群益金鼎-松山,2024-10-23,9103
2330,台積電,16,7,9,群益金鼎-松山,2024-10-23,9103
3357,臺慶科,11,2,9,群益金鼎-松山,2024-10-23,9103
6405,悅城,15,6,9,群益金鼎-松山,2024-10-23,9103
1467,南緯,8,0,8,群益金鼎-松山,2024-10-23,9103
00700,富邦�琤肭磪�,8,0,8,群益金鼎-松山,2024-10-23,9103
2881,富邦金,11,3,8,群益金鼎-松山,2024-10-23,9103
4938,和碩,10,2,8,群益金鼎-松山,2024-10-23,9103
8081,致新,8,0,8,群益金鼎-松山,2024-10-23,9103
9910,豐泰,20,12,8,群益金鼎-松山,2024-10-23,9103
0056,元大高股息,8,1,7,群益金鼎-松山,2024-10-23,9103
00878,國泰永續高股息,7,0,7,群益金鼎-松山,2024-10-23,9103
1304,台聚,6,0,6,群益金鼎-松山,2024-10-23,9103
00929,復華台灣科技優息,6,0,6,群益金鼎-松山,2024-10-23,9103
5452,佶優,12,6,6,群益金鼎-松山,2024-10-23,9103
8064,東捷,14,8,6,群益金鼎-松山,2024-10-23,9103
3037,欣興,11,6,5,群益金鼎-松山,2024-10-23,9103
00688L,國泰20年美債正2,5,0,5,群益金鼎-松山,2024-10-23,9103
00687B,國泰20年美債,5,0,5,群益金鼎-松山,2024-10-23,9103
00673R,期元大S＆P原油反1,5,0,5,群益金鼎-松山,2024-10-23,9103
00830,國泰費城半導體,5,0,5,群益金鼎-松山,2024-10-23,9103
1337,再生-KY,5,0,5,群益金鼎-松山,2024-10-23,9103
1605,華新,5,0,5,群益金鼎-松山,2024-10-23,9103
1785,光洋科,5,0,5,群益金鼎-松山,2024-10-23,9103
2633,台灣高鐵,5,0,5,群益金鼎-松山,2024-10-23,9103
2897,王道銀行,5,0,5,群益金鼎-松山,2024-10-23,9103
3450,聯鈞,8,3,5,群益金鼎-松山,2024-10-23,9103
8249,菱光,4,0,4,群益金鼎-松山,2024-10-23,9103
00953B,群益優選非投等債,4,0,4,群益金鼎-松山,2024-10-23,9103
2880,華南金,4,0,4,群益金鼎-松山,2024-10-23,9103
2883,凱基金,4,0,4,群益金鼎-松山,2024-10-23,9103
3704,合勤控,4,0,4,群益金鼎-松山,2024-10-23,9103
2887,台新金,199,0,199,群益金鼎-松山,2024-10-24,9103
6451,訊芯-KY,121,1,120,群益金鼎-松山,2024-10-24,9103
00637L,元大滬深300正2,80,5,75,群益金鼎-松山,2024-10-24,9103
00937B,群益ESG投等債20,38,0,38,群益金鼎-松山,2024-10-24,9103
5880,合庫金,35,0,35,群益金鼎-松山,2024-10-24,9103
6170,統振,35,0,35,群益金鼎-松山,2024-10-24,9103
2892,第一金,34,0,34,群益金鼎-松山,2024-10-24,9103
6156,松上,34,2,32,群益金鼎-松山,2024-10-24,9103
020033,統一�琤肮黕篾,30,0,30,群益金鼎-松山,2024-10-24,9103
3037,欣興,28,3,25,群益金鼎-松山,2024-10-24,9103
2520,冠德,25,0,25,群益金鼎-松山,2024-10-24,9103
00706L,期元大S＆P日圓正2,16,0,16,群益金鼎-松山,2024-10-24,9103
3689,湧德,16,1,15,群益金鼎-松山,2024-10-24,9103
00688L,國泰20年美債正2,15,0,15,群益金鼎-松山,2024-10-24,9103
2495,普安,15,0,15,群益金鼎-松山,2024-10-24,9103
4162,智擎,15,2,13,群益金鼎-松山,2024-10-24,9103
00887,永豐中國科技50大,12,0,12,群益金鼎-松山,2024-10-24,9103
00960,野村全球航運龍頭,12,0,12,群益金鼎-松山,2024-10-24,9103
2486,一詮,16,4,12,群益金鼎-松山,2024-10-24,9103
4935,茂林-KY,13,1,12,群益金鼎-松山,2024-10-24,9103
00929,復華台灣科技優息,12,1,11,群益金鼎-松山,2024-10-24,9103
00648R,元大S＆P500反1,10,0,10,群益金鼎-松山,2024-10-24,9103
3550,聯穎,10,0,10,群益金鼎-松山,2024-10-24,9103
4526,東台,30,20,10,群益金鼎-松山,2024-10-24,9103
1809,中釉,9,0,9,群益金鼎-松山,2024-10-24,9103
00946,群益科技高息成長,7,0,7,群益金鼎-松山,2024-10-24,9103
2884,玉山金,7,0,7,群益金鼎-松山,2024-10-24,9103
5315,光聯,7,0,7,群益金鼎-松山,2024-10-24,9103
2383,台光電,6,0,6,群益金鼎-松山,2024-10-24,9103
2405,輔信,7,1,6,群益金鼎-松山,2024-10-24,9103
3041,揚智,6,0,6,群益金鼎-松山,2024-10-24,9103
8349,�矬�,9,3,6,群益金鼎-松山,2024-10-24,9103
00959B,大華投等美債15Y+,5,0,5,群益金鼎-松山,2024-10-24,9103
00674R,期元大S＆P黃金反1,5,0,5,群益金鼎-松山,2024-10-24,9103
0056,元大高股息,5,0,5,群益金鼎-松山,2024-10-24,9103
00945B,凱基美國非投等債,5,0,5,群益金鼎-松山,2024-10-24,9103
00895,富邦未來車,5,0,5,群益金鼎-松山,2024-10-24,9103
2344,華邦電,5,0,5,群益金鼎-松山,2024-10-24,9103
2455,全新,5,0,5,群益金鼎-松山,2024-10-24,9103
2485,兆赫,5,0,5,群益金鼎-松山,2024-10-24,9103
2891,中信金,5,0,5,群益金鼎-松山,2024-10-24,9103
2897,王道銀行,5,0,5,群益金鼎-松山,2024-10-24,9103
3025,星通,7,2,5,群益金鼎-松山,2024-10-24,9103
3178,公準,5,0,5,群益金鼎-松山,2024-10-24,9103
3354,律勝,5,0,5,群益金鼎-松山,2024-10-24,9103
8462,柏文,5,0,5,群益金鼎-松山,2024-10-24,9103
1711,永光,5,0,5,群益金鼎-松山,2024-10-24,9103
00919,群益台灣精選高息,4,0,4,群益金鼎-松山,2024-10-24,9103
00950B,凱基A級公司債,4,0,4,群益金鼎-松山,2024-10-24,9103
00715L,期街口布蘭特正2,4,0,4,群益金鼎-松山,2024-10-24,9103
1314,中石化,100,0,100,群益金鼎-松山,2024-10-25,9103
2409,友達,100,0,100,群益金鼎-松山,2024-10-25,9103
00637L,元大滬深300正2,100,25,75,群益金鼎-松山,2024-10-25,9103
00959B,大華投等美債15Y+,72,0,72,群益金鼎-松山,2024-10-25,9103
6170,統振,63,0,63,群益金鼎-松山,2024-10-25,9103
00937B,群益ESG投等債20,55,0,55,群益金鼎-松山,2024-10-25,9103
2351,順德,45,0,45,群益金鼎-松山,2024-10-25,9103
2354,鴻準,51,6,45,群益金鼎-松山,2024-10-25,9103
00922,國泰台灣領袖50,30,0,30,群益金鼎-松山,2024-10-25,9103
3019,亞光,31,1,30,群益金鼎-松山,2024-10-25,9103
6285,啟��,30,0,30,群益金鼎-松山,2024-10-25,9103
3231,緯創,55,27,28,群益金鼎-松山,2024-10-25,9103
2495,普安,26,1,25,群益金鼎-松山,2024-10-25,9103
00945B,凱基美國非投等債,20,0,20,群益金鼎-松山,2024-10-25,9103
00680L,元大美債20正2,20,0,20,群益金鼎-松山,2024-10-25,9103
00712,復華富時不動產,20,0,20,群益金鼎-松山,2024-10-25,9103
2867,三商壽,20,0,20,群益金鼎-松山,2024-10-25,9103
4919,新唐,23,5,18,群益金鼎-松山,2024-10-25,9103
1806,冠軍,15,0,15,群益金鼎-松山,2024-10-25,9103
00738U,期元大道瓊白銀,15,0,15,群益金鼎-松山,2024-10-25,9103
2477,美隆電,15,0,15,群益金鼎-松山,2024-10-25,9103
00942B,台新美A公司債20+,12,0,12,群益金鼎-松山,2024-10-25,9103
00958B,永豐ESG銀行債15,12,0,12,群益金鼎-松山,2024-10-25,9103
6416,瑞祺電通,13,1,12,群益金鼎-松山,2024-10-25,9103
3081,聯亞,13,3,10,群益金鼎-松山,2024-10-25,9103
1533,車王電,10,0,10,群益金鼎-松山,2024-10-25,9103
2891,中信金,10,0,10,群益金鼎-松山,2024-10-25,9103
3149,正達,10,0,10,群益金鼎-松山,2024-10-25,9103
4545,銘鈺,13,3,10,群益金鼎-松山,2024-10-25,9103
2344,華邦電,9,0,9,群益金鼎-松山,2024-10-25,9103
2365,昆盈,9,0,9,群益金鼎-松山,2024-10-25,9103
3450,聯鈞,12,3,9,群益金鼎-松山,2024-10-25,9103
6143,振曜,7,0,7,群益金鼎-松山,2024-10-25,9103
00720B,元大投資級公司債,7,0,7,群益金鼎-松山,2024-10-25,9103
6531,愛普*,7,0,7,群益金鼎-松山,2024-10-25,9103
8249,菱光,9,2,7,群益金鼎-松山,2024-10-25,9103
00953B,群益優選非投等債,6,0,6,群益金鼎-松山,2024-10-25,9103
2884,玉山金,6,0,6,群益金鼎-松山,2024-10-25,9103
3013,晟銘電,15,9,6,群益金鼎-松山,2024-10-25,9103
00715L,期街口布蘭特正2,5,0,5,群益金鼎-松山,2024-10-25,9103
00960,野村全球航運龍頭,5,0,5,群益金鼎-松山,2024-10-25,9103
2208,台船,5,0,5,群益金鼎-松山,2024-10-25,9103
2528,皇普,5,0,5,群益金鼎-松山,2024-10-25,9103
3037,欣興,6,1,5,群益金鼎-松山,2024-10-25,9103
3294,英濟,5,0,5,群益金鼎-松山,2024-10-25,9103
5452,佶優,5,0,5,群益金鼎-松山,2024-10-25,9103
6138,茂達,5,0,5,群益金鼎-松山,2024-10-25,9103
00950B,凱基A級公司債,4,0,4,群益金鼎-松山,2024-10-25,9103
4974,亞泰,4,0,4,群益金鼎-松山,2024-10-25,9103
5263,智崴,4,0,4,群益金鼎-松山,2024-10-25,9103
2883,凱基金,82,2,80,群益金鼎-松山,2024-10-28,9103
00665L,富邦�琤肭磪囓�2,54,0,54,群益金鼎-松山,2024-10-28,9103
2354,鴻準,49,22,27,群益金鼎-松山,2024-10-28,9103
00687B,國泰20年美債,22,0,22,群益金鼎-松山,2024-10-28,9103
2646,星宇航空,22,2,20,群益金鼎-松山,2024-10-28,9103
00633L,富邦上証正2,20,0,20,群益金鼎-松山,2024-10-28,9103
00650L,復華香港正2,20,0,20,群益金鼎-松山,2024-10-28,9103
2323,中環,20,0,20,群益金鼎-松山,2024-10-28,9103
2543,皇昌,20,0,20,群益金鼎-松山,2024-10-28,9103
00959B,大華投等美債15Y+,18,0,18,群益金鼎-松山,2024-10-28,9103
3704,合勤控,22,4,18,群益金鼎-松山,2024-10-28,9103
3715,定穎投控,20,3,17,群益金鼎-松山,2024-10-28,9103
00679B,元大美債20年,15,0,15,群益金鼎-松山,2024-10-28,9103
020033,統一�琤肮黕篾,15,0,15,群益金鼎-松山,2024-10-28,9103
00919,群益台灣精選高息,14,0,14,群益金鼎-松山,2024-10-28,9103
6763,綠界科技*,13,0,13,群益金鼎-松山,2024-10-28,9103
00937B,群益ESG投等債20,11,0,11,群益金鼎-松山,2024-10-28,9103
1605,華新,11,0,11,群益金鼎-松山,2024-10-28,9103
4545,銘鈺,11,0,11,群益金鼎-松山,2024-10-28,9103
6579,研揚,23,12,11,群益金鼎-松山,2024-10-28,9103
6658,聯策,16,5,11,群益金鼎-松山,2024-10-28,9103
00887,永豐中國科技50大,10,0,10,群益金鼎-松山,2024-10-28,9103
00945B,凱基美國非投等債,10,0,10,群益金鼎-松山,2024-10-28,9103
1314,中石化,10,0,10,群益金鼎-松山,2024-10-28,9103
0056,元大高股息,10,0,10,群益金鼎-松山,2024-10-28,9103
00648R,元大S＆P500反1,10,0,10,群益金鼎-松山,2024-10-28,9103
00720B,元大投資級公司債,10,0,10,群益金鼎-松山,2024-10-28,9103
2897,王道銀行,10,0,10,群益金鼎-松山,2024-10-28,9103
4162,智擎,15,5,10,群益金鼎-松山,2024-10-28,9103
00773B,中信優先金融債,9,0,9,群益金鼎-松山,2024-10-28,9103
4111,濟生,16,7,9,群益金鼎-松山,2024-10-28,9103
3357,臺慶科,16,8,8,群益金鼎-松山,2024-10-28,9103
8021,尖點,8,0,8,群益金鼎-松山,2024-10-28,9103
2317,鴻海,14,7,7,群益金鼎-松山,2024-10-28,9103
3481,群創,10,3,7,群益金鼎-松山,2024-10-28,9103
00950B,凱基A級公司債,6,0,6,群益金鼎-松山,2024-10-28,9103
2345,智邦,6,0,6,群益金鼎-松山,2024-10-28,9103
00680L,元大美債20正2,5,0,5,群益金鼎-松山,2024-10-28,9103
1416,廣豐,5,0,5,群益金鼎-松山,2024-10-28,9103
1305,華夏,5,0,5,群益金鼎-松山,2024-10-28,9103
2388,威盛,13,8,5,群益金鼎-松山,2024-10-28,9103
2603,長榮,15,10,5,群益金鼎-松山,2024-10-28,9103
4542,科嶠,5,0,5,群益金鼎-松山,2024-10-28,9103
4768,晶呈科技,5,0,5,群益金鼎-松山,2024-10-28,9103
8107,大億金茂,11,6,5,群益金鼎-松山,2024-10-28,9103
6143,振曜,4,0,4,群益金鼎-松山,2024-10-28,9103
00961,FT臺灣永續高息,4,0,4,群益金鼎-松山,2024-10-28,9103
00636,國泰中國A50,4,0,4,群益金鼎-松山,2024-10-28,9103
00795B,中信美國公債20年,3,0,3,群益金鼎-松山,2024-10-28,9103
1449,佳和,3,0,3,群益金鼎-松山,2024-10-28,9103
2887,台新金,196,0,196,群益金鼎-松山,2024-10-29,9103
00687B,國泰20年美債,112,0,112,群益金鼎-松山,2024-10-29,9103
2409,友達,100,0,100,群益金鼎-松山,2024-10-29,9103
3704,合勤控,78,1,77,群益金鼎-松山,2024-10-29,9103
1314,中石化,100,50,50,群益金鼎-松山,2024-10-29,9103
00639,富邦深100,42,0,42,群益金鼎-松山,2024-10-29,9103
2646,星宇航空,41,5,36,群益金鼎-松山,2024-10-29,9103
2312,金寶,32,2,30,群益金鼎-松山,2024-10-29,9103
2317,鴻海,33,7,26,群益金鼎-松山,2024-10-29,9103
00887,永豐中國科技50大,25,0,25,群益金鼎-松山,2024-10-29,9103
00712,復華富時不動產,22,0,22,群益金鼎-松山,2024-10-29,9103
00878,國泰永續高股息,21,0,21,群益金鼎-松山,2024-10-29,9103
00940,元大台灣價值高息,20,0,20,群益金鼎-松山,2024-10-29,9103
4919,新唐,36,16,20,群益金鼎-松山,2024-10-29,9103
00929,復華台灣科技優息,15,0,15,群益金鼎-松山,2024-10-29,9103
2892,第一金,14,0,14,群益金鼎-松山,2024-10-29,9103
6143,振曜,12,1,11,群益金鼎-松山,2024-10-29,9103
5880,合庫金,11,0,11,群益金鼎-松山,2024-10-29,9103
6170,統振,11,0,11,群益金鼎-松山,2024-10-29,9103
00670L,富邦NASDAQ正2,10,0,10,群益金鼎-松山,2024-10-29,9103
1326,台化,10,0,10,群益金鼎-松山,2024-10-29,9103
2537,聯上發,10,0,10,群益金鼎-松山,2024-10-29,9103
6274,台燿,10,0,10,群益金鼎-松山,2024-10-29,9103
020033,統一�琤肮黕篾,8,0,8,群益金鼎-松山,2024-10-29,9103
2303,聯電,7,0,7,群益金鼎-松山,2024-10-29,9103
6133,金橋,7,0,7,群益金鼎-松山,2024-10-29,9103
00953B,群益優選非投等債,7,0,7,群益金鼎-松山,2024-10-29,9103
6770,力積電,7,0,7,群益金鼎-松山,2024-10-29,9103
8097,常珵,7,0,7,群益金鼎-松山,2024-10-29,9103
00960,野村全球航運龍頭,6,0,6,群益金鼎-松山,2024-10-29,9103
1605,華新,6,0,6,群益金鼎-松山,2024-10-29,9103
00713,元大台灣高息低波,5,0,5,群益金鼎-松山,2024-10-29,9103
5392,能率,5,0,5,群益金鼎-松山,2024-10-29,9103
0050,元大台灣50,5,0,5,群益金鼎-松山,2024-10-29,9103
00922,國泰台灣領袖50,5,0,5,群益金鼎-松山,2024-10-29,9103
00715L,期街口布蘭特正2,5,0,5,群益金鼎-松山,2024-10-29,9103
6197,佳必琪,5,0,5,群益金鼎-松山,2024-10-29,9103
6239,力成,7,2,5,群益金鼎-松山,2024-10-29,9103
6244,茂迪,5,0,5,群益金鼎-松山,2024-10-29,9103
6742,澤米,5,0,5,群益金鼎-松山,2024-10-29,9103
8110,華東,5,0,5,群益金鼎-松山,2024-10-29,9103
2330,台積電,6,1,5,群益金鼎-松山,2024-10-29,9103
2883,凱基金,4,0,4,群益金鼎-松山,2024-10-29,9103
3705,永信,4,0,4,群益金鼎-松山,2024-10-29,9103
6245,立端,4,0,4,群益金鼎-松山,2024-10-29,9103
8071,能率網通,4,0,4,群益金鼎-松山,2024-10-29,9103
2250,IKKA-KY,3,0,3,群益金鼎-松山,2024-10-29,9103
006208,富邦台50,3,0,3,群益金鼎-松山,2024-10-29,9103
0056,元大高股息,3,0,3,群益金鼎-松山,2024-10-29,9103
2357,華碩,3,0,3,群益金鼎-松山,2024-10-29,9103
2880,華南金,50,0,50,群益金鼎-松山,2024-10-30,9103
4919,新唐,36,5,31,群益金鼎-松山,2024-10-30,9103
2354,鴻準,142,111,31,群益金鼎-松山,2024-10-30,9103
4569,六方科-KY,30,0,30,群益金鼎-松山,2024-10-30,9103
00753L,中信中國50正2,20,0,20,群益金鼎-松山,2024-10-30,9103
2392,正崴,20,2,18,群益金鼎-松山,2024-10-30,9103
00712,復華富時不動產,17,0,17,群益金鼎-松山,2024-10-30,9103
00887,永豐中國科技50大,13,0,13,群益金鼎-松山,2024-10-30,9103
00919,群益台灣精選高息,12,0,12,群益金鼎-松山,2024-10-30,9103
2330,台積電,22,10,12,群益金鼎-松山,2024-10-30,9103
00937B,群益ESG投等債20,12,0,12,群益金鼎-松山,2024-10-30,9103
3037,欣興,19,7,12,群益金鼎-松山,2024-10-30,9103
00713,元大台灣高息低波,10,0,10,群益金鼎-松山,2024-10-30,9103
020033,統一�琤肮黕篾,10,0,10,群益金鼎-松山,2024-10-30,9103
00961,FT臺灣永續高息,10,0,10,群益金鼎-松山,2024-10-30,9103
1718,中纖,10,0,10,群益金鼎-松山,2024-10-30,9103
2537,聯上發,10,0,10,群益金鼎-松山,2024-10-30,9103
2382,廣達,10,0,10,群益金鼎-松山,2024-10-30,9103
00929,復華台灣科技優息,8,0,8,群益金鼎-松山,2024-10-30,9103
00960,野村全球航運龍頭,8,0,8,群益金鼎-松山,2024-10-30,9103
3702,大聯大,8,0,8,群益金鼎-松山,2024-10-30,9103
00878,國泰永續高股息,7,0,7,群益金鼎-松山,2024-10-30,9103
5398,慕康生醫,7,0,7,群益金鼎-松山,2024-10-30,9103
00953B,群益優選非投等債,6,0,6,群益金鼎-松山,2024-10-30,9103
3687,歐買尬,6,0,6,群益金鼎-松山,2024-10-30,9103
8390,金益鼎,8,2,6,群益金鼎-松山,2024-10-30,9103
3481,群創,6,0,6,群益金鼎-松山,2024-10-30,9103
0050,元大台灣50,5,0,5,群益金鼎-松山,2024-10-30,9103
00693U,期街口S＆P黃豆,5,0,5,群益金鼎-松山,2024-10-30,9103
00632R,元大台灣50反1,10,5,5,群益金鼎-松山,2024-10-30,9103
00915,凱基優選高股息30,5,0,5,群益金鼎-松山,2024-10-30,9103
2455,全新,5,0,5,群益金鼎-松山,2024-10-30,9103
6269,台郡,5,0,5,群益金鼎-松山,2024-10-30,9103
6510,精測,6,1,5,群益金鼎-松山,2024-10-30,9103
1308,亞聚,4,0,4,群益金鼎-松山,2024-10-30,9103
3661,世芯-KY,6,2,4,群益金鼎-松山,2024-10-30,9103
5603,陸海,15,11,4,群益金鼎-松山,2024-10-30,9103
00715L,期街口布蘭特正2,3,0,3,群益金鼎-松山,2024-10-30,9103
2301,光寶科,3,0,3,群益金鼎-松山,2024-10-30,9103
3017,奇鋐,5,2,3,群益金鼎-松山,2024-10-30,9103
3450,聯鈞,6,3,3,群益金鼎-松山,2024-10-30,9103
4768,晶呈科技,3,0,3,群益金鼎-松山,2024-10-30,9103
6108,競國,9,6,3,群益金鼎-松山,2024-10-30,9103
6213,聯茂,3,0,3,群益金鼎-松山,2024-10-30,9103
6288,聯嘉,5,2,3,群益金鼎-松山,2024-10-30,9103
6290,良維,3,0,3,群益金鼎-松山,2024-10-30,9103
2887,台新金,2,0,2,群益金鼎-松山,2024-10-30,9103
2327,國巨,2,0,2,群益金鼎-松山,2024-10-30,9103
00934,中信成長高股息,2,0,2,群益金鼎-松山,2024-10-30,9103
2313,華通,2,0,2,群益金鼎-松山,2024-10-30,9103
00830,國泰費城半導體,68,0,68,群益金鼎-松山,2024-11-01,9103
00929,復華台灣科技優息,41,5,36,群益金鼎-松山,2024-11-01,9103
00712,復華富時不動產,36,0,36,群益金鼎-松山,2024-11-01,9103
00687B,國泰20年美債,34,1,33,群益金鼎-松山,2024-11-01,9103
2892,第一金,24,0,24,群益金鼎-松山,2024-11-01,9103
00950B,凱基A級公司債,22,0,22,群益金鼎-松山,2024-11-01,9103
2317,鴻海,39,17,22,群益金鼎-松山,2024-11-01,9103
00706L,期元大S＆P日圓正2,20,0,20,群益金鼎-松山,2024-11-01,9103
00670L,富邦NASDAQ正2,20,0,20,群益金鼎-松山,2024-11-01,9103
00719B,元大美債1-3,20,0,20,群益金鼎-松山,2024-11-01,9103
2323,中環,20,0,20,群益金鼎-松山,2024-11-01,9103
2397,友通,20,0,20,群益金鼎-松山,2024-11-01,9103
00937B,群益ESG投等債20,18,0,18,群益金鼎-松山,2024-11-01,9103
2303,聯電,18,0,18,群益金鼎-松山,2024-11-01,9103
4714,永捷,17,0,17,群益金鼎-松山,2024-11-01,9103
1436,華友聯,15,0,15,群益金鼎-松山,2024-11-01,9103
3167,大量,15,0,15,群益金鼎-松山,2024-11-01,9103
8937,合騏,15,0,15,群益金鼎-松山,2024-11-01,9103
3149,正達,24,10,14,群益金鼎-松山,2024-11-01,9103
00919,群益台灣精選高息,12,0,12,群益金鼎-松山,2024-11-01,9103
00945B,凱基美國非投等債,12,0,12,群益金鼎-松山,2024-11-01,9103
3013,晟銘電,13,1,12,群益金鼎-松山,2024-11-01,9103
2543,皇昌,11,0,11,群益金鼎-松山,2024-11-01,9103
3588,通嘉,11,0,11,群益金鼎-松山,2024-11-01,9103
00878,國泰永續高股息,11,0,11,群益金鼎-松山,2024-11-01,9103
1301,台塑,10,0,10,群益金鼎-松山,2024-11-01,9103
020033,統一�琤肮黕篾,10,0,10,群益金鼎-松山,2024-11-01,9103
00738U,期元大道瓊白銀,10,0,10,群益金鼎-松山,2024-11-01,9103
2637,慧洋-KY,10,0,10,群益金鼎-松山,2024-11-01,9103
2883B,凱基金乙特,10,0,10,群益金鼎-松山,2024-11-01,9103
3623,富晶通,10,0,10,群益金鼎-松山,2024-11-01,9103
4303,信立,10,0,10,群益金鼎-松山,2024-11-01,9103
6187,萬潤,18,8,10,群益金鼎-松山,2024-11-01,9103
00887,永豐中國科技50大,43,34,9,群益金鼎-松山,2024-11-01,9103
00940,元大台灣價值高息,9,0,9,群益金鼎-松山,2024-11-01,9103
00959B,大華投等美債15Y+,9,0,9,群益金鼎-松山,2024-11-01,9103
4562,穎漢,9,0,9,群益金鼎-松山,2024-11-01,9103
00942B,台新美A公司債20+,8,0,8,群益金鼎-松山,2024-11-01,9103
2465,麗臺,10,3,7,群益金鼎-松山,2024-11-01,9103
2646,星宇航空,7,0,7,群益金鼎-松山,2024-11-01,9103
3037,欣興,7,1,6,群益金鼎-松山,2024-11-01,9103
4966,譜瑞-KY,6,0,6,群益金鼎-松山,2024-11-01,9103
6117,迎廣,6,0,6,群益金鼎-松山,2024-11-01,9103
8085,福華,6,0,6,群益金鼎-松山,2024-11-01,9103
9907,統一實,6,0,6,群益金鼎-松山,2024-11-01,9103
00713,元大台灣高息低波,5,0,5,群益金鼎-松山,2024-11-01,9103
00877,復華中國5G,5,0,5,群益金鼎-松山,2024-11-01,9103
0056,元大高股息,5,0,5,群益金鼎-松山,2024-11-01,9103
1809,中釉,5,0,5,群益金鼎-松山,2024-11-01,9103
1810,和成,18,13,5,群益金鼎-松山,2024-11-01,9103
00687B,國泰20年美債,87,0,87,群益金鼎-松山,2024-11-04,9103
6164,華興,60,0,60,群益金鼎-松山,2024-11-04,9103
00891,中信關鍵半導體,55,0,55,群益金鼎-松山,2024-11-04,9103
00953B,群益優選非投等債,41,0,41,群益金鼎-松山,2024-11-04,9103
00719B,元大美債1-3,25,0,25,群益金鼎-松山,2024-11-04,9103
00878,國泰永續高股息,25,1,24,群益金鼎-松山,2024-11-04,9103
3230,錦明,23,1,22,群益金鼎-松山,2024-11-04,9103
2646,星宇航空,23,7,16,群益金鼎-松山,2024-11-04,9103
6151,晉倫,15,0,15,群益金鼎-松山,2024-11-04,9103
00919,群益台灣精選高息,12,0,12,群益金鼎-松山,2024-11-04,9103
00648R,元大S＆P500反1,12,0,12,群益金鼎-松山,2024-11-04,9103
00945B,凱基美國非投等債,12,0,12,群益金鼎-松山,2024-11-04,9103
6438,迅得,12,0,12,群益金鼎-松山,2024-11-04,9103
00929,復華台灣科技優息,10,0,10,群益金鼎-松山,2024-11-04,9103
1605,華新,10,0,10,群益金鼎-松山,2024-11-04,9103
00712,復華富時不動產,10,0,10,群益金鼎-松山,2024-11-04,9103
3702,大聯大,10,0,10,群益金鼎-松山,2024-11-04,9103
3715,定穎投控,10,0,10,群益金鼎-松山,2024-11-04,9103
8249,菱光,11,1,10,群益金鼎-松山,2024-11-04,9103
8111,立��,11,2,9,群益金鼎-松山,2024-11-04,9103
3665,貿聯-KY,7,0,7,群益金鼎-松山,2024-11-04,9103
2345,智邦,6,0,6,群益金鼎-松山,2024-11-04,9103
2609,陽明,8,2,6,群益金鼎-松山,2024-11-04,9103
2883B,凱基金乙特,6,0,6,群益金鼎-松山,2024-11-04,9103
9945,潤泰新,6,0,6,群益金鼎-松山,2024-11-04,9103
00934,中信成長高股息,5,0,5,群益金鼎-松山,2024-11-04,9103
0061,元大寶滬深,5,0,5,群益金鼎-松山,2024-11-04,9103
2303,聯電,5,0,5,群益金鼎-松山,2024-11-04,9103
2449,京元電子,5,0,5,群益金鼎-松山,2024-11-04,9103
2467,志聖,5,0,5,群益金鼎-松山,2024-11-04,9103
2486,一詮,5,0,5,群益金鼎-松山,2024-11-04,9103
2528,皇普,5,0,5,群益金鼎-松山,2024-11-04,9103
3219,倚強科,6,1,5,群益金鼎-松山,2024-11-04,9103
6177,達麗,5,0,5,群益金鼎-松山,2024-11-04,9103
2603,長榮,4,0,4,群益金鼎-松山,2024-11-04,9103
00795B,中信美國公債20年,4,0,4,群益金鼎-松山,2024-11-04,9103
00948B,中信優息投資級債,4,0,4,群益金鼎-松山,2024-11-04,9103
2618,長榮航,5,1,4,群益金鼎-松山,2024-11-04,9103
3040,遠見,4,0,4,群益金鼎-松山,2024-11-04,9103
6510,精測,4,0,4,群益金鼎-松山,2024-11-04,9103
6856,鑫傳,5,1,4,群益金鼎-松山,2024-11-04,9103
00887,永豐中國科技50大,3,0,3,群益金鼎-松山,2024-11-04,9103
00715L,期街口布蘭特正2,3,0,3,群益金鼎-松山,2024-11-04,9103
1216,統一,4,1,3,群益金鼎-松山,2024-11-04,9103
0056,元大高股息,3,0,3,群益金鼎-松山,2024-11-04,9103
00665L,富邦�琤肭磪囓�2,3,0,3,群益金鼎-松山,2024-11-04,9103
00922,國泰台灣領袖50,3,0,3,群益金鼎-松山,2024-11-04,9103
2314,台揚,3,0,3,群益金鼎-松山,2024-11-04,9103
2388,威盛,3,0,3,群益金鼎-松山,2024-11-04,9103
5392,能率,3,0,3,群益金鼎-松山,2024-11-04,9103
00665L,富邦�琤肭磪囓�2,100,0,100,群益金鼎-松山,2024-11-05,9103
3450,聯鈞,78,14,64,群益金鼎-松山,2024-11-05,9103
00632R,元大台灣50反1,30,0,30,群益金鼎-松山,2024-11-05,9103
3013,晟銘電,27,5,22,群益金鼎-松山,2024-11-05,9103
3374,精材,21,0,21,群益金鼎-松山,2024-11-05,9103
00664R,國泰臺灣加權反1,20,0,20,群益金鼎-松山,2024-11-05,9103
8261,富鼎,20,0,20,群益金鼎-松山,2024-11-05,9103
00633L,富邦上証正2,20,0,20,群益金鼎-松山,2024-11-05,9103
00688L,國泰20年美債正2,15,0,15,群益金鼎-松山,2024-11-05,9103
3498,陽程,15,0,15,群益金鼎-松山,2024-11-05,9103
00919,群益台灣精選高息,13,0,13,群益金鼎-松山,2024-11-05,9103
2905,三商,33,20,13,群益金鼎-松山,2024-11-05,9103
2365,昆盈,21,10,11,群益金鼎-松山,2024-11-05,9103
1304,台聚,10,0,10,群益金鼎-松山,2024-11-05,9103
3149,正達,22,12,10,群益金鼎-松山,2024-11-05,9103
2615,萬海,11,4,7,群益金鼎-松山,2024-11-05,9103
2354,鴻準,30,24,6,群益金鼎-松山,2024-11-05,9103
2646,星宇航空,6,0,6,群益金鼎-松山,2024-11-05,9103
6191,精成科,6,0,6,群益金鼎-松山,2024-11-05,9103
8163,達方,6,0,6,群益金鼎-松山,2024-11-05,9103
5258,虹堡,6,0,6,群益金鼎-松山,2024-11-05,9103
0056,元大高股息,5,0,5,群益金鼎-松山,2024-11-05,9103
4760,勤凱,5,0,5,群益金鼎-松山,2024-11-05,9103
6288,聯嘉,5,0,5,群益金鼎-松山,2024-11-05,9103
00929,復華台灣科技優息,4,0,4,群益金鼎-松山,2024-11-05,9103
3163,波若威,4,0,4,群益金鼎-松山,2024-11-05,9103
5347,世界,4,0,4,群益金鼎-松山,2024-11-05,9103
6856,鑫傳,4,0,4,群益金鼎-松山,2024-11-05,9103
2376,技嘉,5,2,3,群益金鼎-松山,2024-11-05,9103
00712,復華富時不動產,3,0,3,群益金鼎-松山,2024-11-05,9103
2337,旺宏,3,0,3,群益金鼎-松山,2024-11-05,9103
2406,國碩,3,0,3,群益金鼎-松山,2024-11-05,9103
2745,五福,3,0,3,群益金鼎-松山,2024-11-05,9103
3049,精金,33,30,3,群益金鼎-松山,2024-11-05,9103
3665,貿聯-KY,3,0,3,群益金鼎-松山,2024-11-05,9103
3702,大聯大,3,0,3,群益金鼎-松山,2024-11-05,9103
6679,鈺太,3,0,3,群益金鼎-松山,2024-11-05,9103
8028,昇陽半導體,10,7,3,群益金鼎-松山,2024-11-05,9103
8044,網家,3,0,3,群益金鼎-松山,2024-11-05,9103
8097,常珵,3,0,3,群益金鼎-松山,2024-11-05,9103
00648R,元大S＆P500反1,2,0,2,群益金鼎-松山,2024-11-05,9103
00934,中信成長高股息,2,0,2,群益金鼎-松山,2024-11-05,9103
1618,合機,2,0,2,群益金鼎-松山,2024-11-05,9103
2355,敬鵬,2,0,2,群益金鼎-松山,2024-11-05,9103
2497,怡利電,2,0,2,群益金鼎-松山,2024-11-05,9103
2612,中航,2,0,2,群益金鼎-松山,2024-11-05,9103
2883B,凱基金乙特,2,0,2,群益金鼎-松山,2024-11-05,9103
2903,遠百,2,0,2,群益金鼎-松山,2024-11-05,9103
3010,華立,2,0,2,群益金鼎-松山,2024-11-05,9103
3062,建漢,23,21,2,群益金鼎-松山,2024-11-05,9103
00687B,國泰20年美債,203,50,153,群益金鼎-松山,2024-11-06,9103
00679B,元大美債20年,89,0,89,群益金鼎-松山,2024-11-06,9103
2609,陽明,42,2,40,群益金鼎-松山,2024-11-06,9103
2356,英業達,46,14,32,群益金鼎-松山,2024-11-06,9103
9907,統一實,30,1,29,群益金鼎-松山,2024-11-06,9103
00632R,元大台灣50反1,22,0,22,群益金鼎-松山,2024-11-06,9103
4919,新唐,17,0,17,群益金鼎-松山,2024-11-06,9103
3013,晟銘電,19,4,15,群益金鼎-松山,2024-11-06,9103
00680L,元大美債20正2,15,0,15,群益金鼎-松山,2024-11-06,9103
4510,高鋒,30,16,14,群益金鼎-松山,2024-11-06,9103
2615,萬海,16,3,13,群益金鼎-松山,2024-11-06,9103
1560,中砂,12,0,12,群益金鼎-松山,2024-11-06,9103
020033,統一�琤肮黕篾,10,0,10,群益金鼎-松山,2024-11-06,9103
00647L,元大S＆P500正2,10,0,10,群益金鼎-松山,2024-11-06,9103
00671R,富邦NASDAQ反1,10,0,10,群益金鼎-松山,2024-11-06,9103
00706L,期元大S＆P日圓正2,10,0,10,群益金鼎-松山,2024-11-06,9103
2314,台揚,10,0,10,群益金鼎-松山,2024-11-06,9103
2634,漢翔,10,0,10,群益金鼎-松山,2024-11-06,9103
6416,瑞祺電通,10,0,10,群益金鼎-松山,2024-11-06,9103
2354,鴻準,36,27,9,群益金鼎-松山,2024-11-06,9103
2324,仁寶,41,35,6,群益金鼎-松山,2024-11-06,9103
6151,晉倫,6,0,6,群益金鼎-松山,2024-11-06,9103
2303,聯電,6,1,5,群益金鼎-松山,2024-11-06,9103
2328,廣宇,5,0,5,群益金鼎-松山,2024-11-06,9103
2351,順德,5,0,5,群益金鼎-松山,2024-11-06,9103
3163,波若威,8,3,5,群益金鼎-松山,2024-11-06,9103
4562,穎漢,10,5,5,群益金鼎-松山,2024-11-06,9103
6856,鑫傳,5,0,5,群益金鼎-松山,2024-11-06,9103
00795B,中信美國公債20年,4,0,4,群益金鼎-松山,2024-11-06,9103
1436,華友聯,4,0,4,群益金鼎-松山,2024-11-06,9103
2031,新光鋼,4,0,4,群益金鼎-松山,2024-11-06,9103
2745,五福,4,0,4,群益金鼎-松山,2024-11-06,9103
3167,大量,7,3,4,群益金鼎-松山,2024-11-06,9103
3289,宜特,4,0,4,群益金鼎-松山,2024-11-06,9103
6134,萬旭,4,0,4,群益金鼎-松山,2024-11-06,9103
8084,巨虹,4,0,4,群益金鼎-松山,2024-11-06,9103
4561,健椿,4,0,4,群益金鼎-松山,2024-11-06,9103
6438,迅得,4,1,3,群益金鼎-松山,2024-11-06,9103
2603,長榮,4,1,3,群益金鼎-松山,2024-11-06,9103
1216,統一,3,0,3,群益金鼎-松山,2024-11-06,9103
00664R,國泰臺灣加權反1,3,0,3,群益金鼎-松山,2024-11-06,9103
0061,元大寶滬深,3,0,3,群益金鼎-松山,2024-11-06,9103
2059,川湖,3,0,3,群益金鼎-松山,2024-11-06,9103
2399,映泰,3,0,3,群益金鼎-松山,2024-11-06,9103
2883,凱基金,3,0,3,群益金鼎-松山,2024-11-06,9103
4906,正文,3,0,3,群益金鼎-松山,2024-11-06,9103
6550,北極星藥業-KY,3,0,3,群益金鼎-松山,2024-11-06,9103
2385,群光,2,0,2,群益金鼎-松山,2024-11-06,9103
3042,晶技,2,0,2,群益金鼎-松山,2024-11-06,9103
00715L,期街口布蘭特正2,2,0,2,群益金鼎-松山,2024-11-06,9103
9105,泰金寶-DR,250,101,149,群益金鼎-松山,2024-11-07,9103
3481,群創,200,109,91,群益金鼎-松山,2024-11-07,9103
00887,永豐中國科技50大,50,0,50,群益金鼎-松山,2024-11-07,9103
2313,華通,47,1,46,群益金鼎-松山,2024-11-07,9103
8033,雷虎,42,0,42,群益金鼎-松山,2024-11-07,9103
1522,堤維西,40,2,38,群益金鼎-松山,2024-11-07,9103
00632R,元大台灣50反1,32,0,32,群益金鼎-松山,2024-11-07,9103
2634,漢翔,33,1,32,群益金鼎-松山,2024-11-07,9103
3374,精材,35,3,32,群益金鼎-松山,2024-11-07,9103
00753L,中信中國50正2,30,4,26,群益金鼎-松山,2024-11-07,9103
00830,國泰費城半導體,30,5,25,群益金鼎-松山,2024-11-07,9103
00665L,富邦�琤肭磪囓�2,20,0,20,群益金鼎-松山,2024-11-07,9103
00639,富邦深100,20,0,20,群益金鼎-松山,2024-11-07,9103
2392,正崴,22,2,20,群益金鼎-松山,2024-11-07,9103
2419,仲琦,20,0,20,群益金鼎-松山,2024-11-07,9103
2332,友訊,20,1,19,群益金鼎-松山,2024-11-07,9103
2230,泰茂,15,0,15,群益金鼎-松山,2024-11-07,9103
00650L,復華香港正2,10,0,10,群益金鼎-松山,2024-11-07,9103
00919,群益台灣精選高息,10,0,10,群益金鼎-松山,2024-11-07,9103
00670L,富邦NASDAQ正2,30,20,10,群益金鼎-松山,2024-11-07,9103
2038,海光,10,0,10,群益金鼎-松山,2024-11-07,9103
2353,宏��,10,0,10,群益金鼎-松山,2024-11-07,9103
2520,冠德,10,0,10,群益金鼎-松山,2024-11-07,9103
3025,星通,10,0,10,群益金鼎-松山,2024-11-07,9103
3498,陽程,20,10,10,群益金鼎-松山,2024-11-07,9103
3706,神達,15,5,10,群益金鼎-松山,2024-11-07,9103
6829,千附精密,10,0,10,群益金鼎-松山,2024-11-07,9103
6753,龍德造船,12,3,9,群益金鼎-松山,2024-11-07,9103
2603,長榮,9,1,8,群益金鼎-松山,2024-11-07,9103
00795B,中信美國公債20年,8,0,8,群益金鼎-松山,2024-11-07,9103
3712,永崴投控,8,0,8,群益金鼎-松山,2024-11-07,9103
2330,台積電,19,11,8,群益金鼎-松山,2024-11-07,9103
00687B,國泰20年美債,6,0,6,群益金鼎-松山,2024-11-07,9103
00931B,統一美債20年,6,0,6,群益金鼎-松山,2024-11-07,9103
1815,富喬,10,4,6,群益金鼎-松山,2024-11-07,9103
2312,金寶,40,34,6,群益金鼎-松山,2024-11-07,9103
2387,精元,6,0,6,群益金鼎-松山,2024-11-07,9103
6438,迅得,7,1,6,群益金鼎-松山,2024-11-07,9103
6187,萬潤,5,0,5,群益金鼎-松山,2024-11-07,9103
00909,國泰數位支付服務,5,0,5,群益金鼎-松山,2024-11-07,9103
00770,國泰北美科技,5,0,5,群益金鼎-松山,2024-11-07,9103
2892,第一金,6,1,5,群益金鼎-松山,2024-11-07,9103
6151,晉倫,5,0,5,群益金鼎-松山,2024-11-07,9103
6207,雷科,5,0,5,群益金鼎-松山,2024-11-07,9103
00937B,群益ESG投等債20,4,0,4,群益金鼎-松山,2024-11-07,9103
2399,映泰,4,0,4,群益金鼎-松山,2024-11-07,9103
6416,瑞祺電通,4,0,4,群益金鼎-松山,2024-11-07,9103
8043,蜜望實,4,0,4,群益金鼎-松山,2024-11-07,9103
8064,東捷,4,0,4,群益金鼎-松山,2024-11-07,9103
00712,復華富時不動產,3,0,3,群益金鼎-松山,2024-11-07,9103
3062,建漢,104,2,102,群益金鼎-松山,2024-11-08,9103
2867,三商壽,99,0,99,群益金鼎-松山,2024-11-08,9103
00632R,元大台灣50反1,56,5,51,群益金鼎-松山,2024-11-08,9103
00665L,富邦�琤肭磪囓�2,50,0,50,群益金鼎-松山,2024-11-08,9103
3303,岱稜,30,0,30,群益金鼎-松山,2024-11-08,9103
00753L,中信中國50正2,28,5,23,群益金鼎-松山,2024-11-08,9103
1514,亞力,20,0,20,群益金鼎-松山,2024-11-08,9103
1522,堤維西,20,0,20,群益金鼎-松山,2024-11-08,9103
2344,華邦電,24,5,19,群益金鼎-松山,2024-11-08,9103
6753,龍德造船,18,0,18,群益金鼎-松山,2024-11-08,9103
1308,亞聚,16,0,16,群益金鼎-松山,2024-11-08,9103
4979,華星光,26,10,16,群益金鼎-松山,2024-11-08,9103
6416,瑞祺電通,20,4,16,群益金鼎-松山,2024-11-08,9103
00662,富邦NASDAQ,15,0,15,群益金鼎-松山,2024-11-08,9103
3558,神準,15,0,15,群益金鼎-松山,2024-11-08,9103
2317,鴻海,17,5,12,群益金鼎-松山,2024-11-08,9103
5243,乙盛-KY,12,0,12,群益金鼎-松山,2024-11-08,9103
6770,力積電,11,0,11,群益金鼎-松山,2024-11-08,9103
00706L,期元大S＆P日圓正2,10,0,10,群益金鼎-松山,2024-11-08,9103
00679B,元大美債20年,10,0,10,群益金鼎-松山,2024-11-08,9103
00635U,期元大S＆P黃金,10,0,10,群益金鼎-松山,2024-11-08,9103
2362,藍天,11,1,10,群益金鼎-松山,2024-11-08,9103
3297,杭特,10,0,10,群益金鼎-松山,2024-11-08,9103
2892,第一金,9,0,9,群益金鼎-松山,2024-11-08,9103
4956,光鋐,8,0,8,群益金鼎-松山,2024-11-08,9103
4909,新復興,9,2,7,群益金鼎-松山,2024-11-08,9103
5438,東友,17,10,7,群益金鼎-松山,2024-11-08,9103
3227,原相,6,0,6,群益金鼎-松山,2024-11-08,9103
1815,富喬,7,1,6,群益金鼎-松山,2024-11-08,9103
6207,雷科,6,0,6,群益金鼎-松山,2024-11-08,9103
00637L,元大滬深300正2,35,30,5,群益金鼎-松山,2024-11-08,9103
2352,佳世達,5,0,5,群益金鼎-松山,2024-11-08,9103
2745,五福,5,0,5,群益金鼎-松山,2024-11-08,9103
3532,台勝科,5,0,5,群益金鼎-松山,2024-11-08,9103
5457,宣德,5,0,5,群益金鼎-松山,2024-11-08,9103
2303,聯電,5,1,4,群益金鼎-松山,2024-11-08,9103
00878,國泰永續高股息,5,1,4,群益金鼎-松山,2024-11-08,9103
1216,統一,4,0,4,群益金鼎-松山,2024-11-08,9103
1785,光洋科,4,0,4,群益金鼎-松山,2024-11-08,9103
2314,台揚,4,0,4,群益金鼎-松山,2024-11-08,9103
2497,怡利電,4,0,4,群益金鼎-松山,2024-11-08,9103
2891,中信金,4,0,4,群益金鼎-松山,2024-11-08,9103
3593,力銘,4,0,4,群益金鼎-松山,2024-11-08,9103
4935,茂林-KY,5,1,4,群益金鼎-松山,2024-11-08,9103
1264,德麥,3,0,3,群益金鼎-松山,2024-11-08,9103
2316,楠梓電,3,0,3,群益金鼎-松山,2024-11-08,9103
3257,虹冠電,3,0,3,群益金鼎-松山,2024-11-08,9103
3290,東浦,3,0,3,群益金鼎-松山,2024-11-08,9103
4558,寶緯,3,0,3,群益金鼎-松山,2024-11-08,9103
4903,聯光通,5,2,3,群益金鼎-松山,2024-11-08,9103
2409,友達,100,0,100,群益金鼎-松山,2024-11-11,9103
3706,神達,50,7,43,群益金鼎-松山,2024-11-11,9103
00830,國泰費城半導體,30,0,30,群益金鼎-松山,2024-11-11,9103
3211,順達,30,0,30,群益金鼎-松山,2024-11-11,9103
2520,冠德,28,0,28,群益金鼎-松山,2024-11-11,9103
00712,復華富時不動產,25,0,25,群益金鼎-松山,2024-11-11,9103
6285,啟��,22,0,22,群益金鼎-松山,2024-11-11,9103
2455,全新,21,0,21,群益金鼎-松山,2024-11-11,9103
00753L,中信中國50正2,20,0,20,群益金鼎-松山,2024-11-11,9103
2609,陽明,20,0,20,群益金鼎-松山,2024-11-11,9103
3025,星通,26,6,20,群益金鼎-松山,2024-11-11,9103
1532,勤美,18,0,18,群益金鼎-松山,2024-11-11,9103
2444,兆勁,18,0,18,群益金鼎-松山,2024-11-11,9103
3303,岱稜,17,0,17,群益金鼎-松山,2024-11-11,9103
00852L,國泰美國道瓊正2,15,0,15,群益金鼎-松山,2024-11-11,9103
2486,一詮,19,5,14,群益金鼎-松山,2024-11-11,9103
2915,潤泰全,25,12,13,群益金鼎-松山,2024-11-11,9103
2330,台積電,30,17,13,群益金鼎-松山,2024-11-11,9103
3357,臺慶科,20,7,13,群益金鼎-松山,2024-11-11,9103
00891,中信關鍵半導體,10,0,10,群益金鼎-松山,2024-11-11,9103
00650L,復華香港正2,10,0,10,群益金鼎-松山,2024-11-11,9103
00670L,富邦NASDAQ正2,10,0,10,群益金鼎-松山,2024-11-11,9103
1527,鑽全,10,0,10,群益金鼎-松山,2024-11-11,9103
2431,聯昌,40,30,10,群益金鼎-松山,2024-11-11,9103
3042,晶技,10,0,10,群益金鼎-松山,2024-11-11,9103
9945,潤泰新,10,0,10,群益金鼎-松山,2024-11-11,9103
2449,京元電子,10,0,10,群益金鼎-松山,2024-11-11,9103
3501,維熹,9,0,9,群益金鼎-松山,2024-11-11,9103
6763,綠界科技*,9,1,8,群益金鼎-松山,2024-11-11,9103
3032,偉訓,7,0,7,群益金鼎-松山,2024-11-11,9103
8076,伍豐,7,0,7,群益金鼎-松山,2024-11-11,9103
9921,巨大,6,0,6,群益金鼎-松山,2024-11-11,9103
00665L,富邦�琤肭磪囓�2,5,0,5,群益金鼎-松山,2024-11-11,9103
4760,勤凱,5,0,5,群益金鼎-松山,2024-11-11,9103
6165,浪凡,5,0,5,群益金鼎-松山,2024-11-11,9103
4958,臻鼎-KY,4,0,4,群益金鼎-松山,2024-11-11,9103
4916,事欣科,4,0,4,群益金鼎-松山,2024-11-11,9103
2324,仁寶,15,11,4,群益金鼎-松山,2024-11-11,9103
2524,京城,5,1,4,群益金鼎-松山,2024-11-11,9103
6405,悅城,4,0,4,群益金鼎-松山,2024-11-11,9103
2885,元大金,4,0,4,群益金鼎-松山,2024-11-11,9103
1264,德麥,3,0,3,群益金鼎-松山,2024-11-11,9103
00881,國泰台灣5G+,3,0,3,群益金鼎-松山,2024-11-11,9103
00878,國泰永續高股息,3,0,3,群益金鼎-松山,2024-11-11,9103
1605,華新,13,10,3,群益金鼎-松山,2024-11-11,9103
2313,華通,3,0,3,群益金鼎-松山,2024-11-11,9103
2353,宏��,3,0,3,群益金鼎-松山,2024-11-11,9103
2369,菱生,3,0,3,群益金鼎-松山,2024-11-11,9103
2382,廣達,14,11,3,群益金鼎-松山,2024-11-11,9103
3290,東浦,3,0,3,群益金鼎-松山,2024-11-11,9103
3706,神達,230,146,84,群益金鼎-松山,2024-11-12,9103
4931,新盛力,52,0,52,群益金鼎-松山,2024-11-12,9103
2609,陽明,43,15,28,群益金鼎-松山,2024-11-12,9103
00881,國泰台灣5G+,27,0,27,群益金鼎-松山,2024-11-12,9103
2330,台積電,28,2,26,群益金鼎-松山,2024-11-12,9103
2892,第一金,26,2,24,群益金鼎-松山,2024-11-12,9103
0056,元大高股息,21,0,21,群益金鼎-松山,2024-11-12,9103
1717,長興,20,0,20,群益金鼎-松山,2024-11-12,9103
2543,皇昌,20,0,20,群益金鼎-松山,2024-11-12,9103
2867,三商壽,20,0,20,群益金鼎-松山,2024-11-12,9103
1605,華新,16,0,16,群益金鼎-松山,2024-11-12,9103
00878,國泰永續高股息,13,0,13,群益金鼎-松山,2024-11-12,9103
00891,中信關鍵半導體,13,0,13,群益金鼎-松山,2024-11-12,9103
2603,長榮,22,11,11,群益金鼎-松山,2024-11-12,9103
00919,群益台灣精選高息,10,0,10,群益金鼎-松山,2024-11-12,9103
1304,台聚,10,0,10,群益金鼎-松山,2024-11-12,9103
1446,宏和,10,0,10,群益金鼎-松山,2024-11-12,9103
2332,友訊,10,0,10,群益金鼎-松山,2024-11-12,9103
2485,兆赫,10,0,10,群益金鼎-松山,2024-11-12,9103
9934,成霖,10,0,10,群益金鼎-松山,2024-11-12,9103
2317,鴻海,45,36,9,群益金鼎-松山,2024-11-12,9103
2106,建大,9,0,9,群益金鼎-松山,2024-11-12,9103
2455,全新,9,0,9,群益金鼎-松山,2024-11-12,9103
3558,神準,9,0,9,群益金鼎-松山,2024-11-12,9103
2897,王道銀行,8,0,8,群益金鼎-松山,2024-11-12,9103
3289,宜特,7,0,7,群益金鼎-松山,2024-11-12,9103
00922,國泰台灣領袖50,7,0,7,群益金鼎-松山,2024-11-12,9103
3032,偉訓,7,0,7,群益金鼎-松山,2024-11-12,9103
2353,宏��,9,3,6,群益金鼎-松山,2024-11-12,9103
2884,玉山金,6,0,6,群益金鼎-松山,2024-11-12,9103
00934,中信成長高股息,6,0,6,群益金鼎-松山,2024-11-12,9103
1326,台化,6,0,6,群益金鼎-松山,2024-11-12,9103
2542,興富發,6,0,6,群益金鼎-松山,2024-11-12,9103
00887,永豐中國科技50大,5,0,5,群益金鼎-松山,2024-11-12,9103
00665L,富邦�琤肭磪囓�2,5,0,5,群益金鼎-松山,2024-11-12,9103
00650L,復華香港正2,15,10,5,群益金鼎-松山,2024-11-12,9103
1101,台泥,5,0,5,群益金鼎-松山,2024-11-12,9103
1909,榮成,5,0,5,群益金鼎-松山,2024-11-12,9103
2201,裕隆,5,0,5,群益金鼎-松山,2024-11-12,9103
3013,晟銘電,9,4,5,群益金鼎-松山,2024-11-12,9103
5014,建錩,5,0,5,群益金鼎-松山,2024-11-12,9103
6625,必應,5,0,5,群益金鼎-松山,2024-11-12,9103
2356,英業達,10,5,5,群益金鼎-松山,2024-11-12,9103
5871,中租-KY,4,0,4,群益金鼎-松山,2024-11-12,9103
2382,廣達,4,0,4,群益金鼎-松山,2024-11-12,9103
3290,東浦,4,0,4,群益金鼎-松山,2024-11-12,9103
3552,同致,4,0,4,群益金鼎-松山,2024-11-12,9103
5522,遠雄,5,1,4,群益金鼎-松山,2024-11-12,9103
6763,綠界科技*,4,0,4,群益金鼎-松山,2024-11-12,9103
9945,潤泰新,4,0,4,群益金鼎-松山,2024-11-12,9103
2867,三商壽,200,0,200,群益金鼎-松山,2024-11-13,9103
00933B,國泰10Y+金融債,142,0,142,群益金鼎-松山,2024-11-13,9103
00639,富邦深100,60,0,60,群益金鼎-松山,2024-11-13,9103
9910,豐泰,42,0,42,群益金鼎-松山,2024-11-13,9103
5009,榮剛,32,0,32,群益金鼎-松山,2024-11-13,9103
5426,振發,30,0,30,群益金鼎-松山,2024-11-13,9103
00753L,中信中國50正2,20,0,20,群益金鼎-松山,2024-11-13,9103
00891,中信關鍵半導體,20,0,20,群益金鼎-松山,2024-11-13,9103
2312,金寶,32,13,19,群益金鼎-松山,2024-11-13,9103
6438,迅得,18,1,17,群益金鼎-松山,2024-11-13,9103
4958,臻鼎-KY,16,0,16,群益金鼎-松山,2024-11-13,9103
3003,健和興,16,2,14,群益金鼎-松山,2024-11-13,9103
1727,中華化,12,0,12,群益金鼎-松山,2024-11-13,9103
2603,長榮,12,1,11,群益金鼎-松山,2024-11-13,9103
00706L,期元大S＆P日圓正2,11,0,11,群益金鼎-松山,2024-11-13,9103
00878,國泰永續高股息,11,0,11,群益金鼎-松山,2024-11-13,9103
00919,群益台灣精選高息,10,0,10,群益金鼎-松山,2024-11-13,9103
00635U,期元大S＆P黃金,10,0,10,群益金鼎-松山,2024-11-13,9103
00664R,國泰臺灣加權反1,10,0,10,群益金鼎-松山,2024-11-13,9103
00937B,群益ESG投等債20,10,0,10,群益金鼎-松山,2024-11-13,9103
1717,長興,10,0,10,群益金鼎-松山,2024-11-13,9103
4569,六方科-KY,9,0,9,群益金鼎-松山,2024-11-13,9103
2330,台積電,8,0,8,群益金鼎-松山,2024-11-13,9103
1301,台塑,8,0,8,群益金鼎-松山,2024-11-13,9103
00852L,國泰美國道瓊正2,7,0,7,群益金鼎-松山,2024-11-13,9103
2317,鴻海,7,1,6,群益金鼎-松山,2024-11-13,9103
1605,華新,6,0,6,群益金鼎-松山,2024-11-13,9103
1785,光洋科,6,0,6,群益金鼎-松山,2024-11-13,9103
5258,虹堡,6,0,6,群益金鼎-松山,2024-11-13,9103
8028,昇陽半導體,6,0,6,群益金鼎-松山,2024-11-13,9103
2344,華邦電,10,5,5,群益金鼎-松山,2024-11-13,9103
00680L,元大美債20正2,5,0,5,群益金鼎-松山,2024-11-13,9103
00665L,富邦�琤肭磪囓�2,5,0,5,群益金鼎-松山,2024-11-13,9103
2637,慧洋-KY,5,0,5,群益金鼎-松山,2024-11-13,9103
2892,第一金,5,0,5,群益金鼎-松山,2024-11-13,9103
3041,揚智,5,0,5,群益金鼎-松山,2024-11-13,9103
8163,達方,5,0,5,群益金鼎-松山,2024-11-13,9103
3545,敦泰,6,2,4,群益金鼎-松山,2024-11-13,9103
5263,智崴,4,0,4,群益金鼎-松山,2024-11-13,9103
00935,野村臺灣新科技50,3,0,3,群益金鼎-松山,2024-11-13,9103
2834,臺企銀,3,0,3,群益金鼎-松山,2024-11-13,9103
2888,新光金,3,0,3,群益金鼎-松山,2024-11-13,9103
3017,奇鋐,3,0,3,群益金鼎-松山,2024-11-13,9103
3558,神準,6,3,3,群益金鼎-松山,2024-11-13,9103
5347,世界,3,0,3,群益金鼎-松山,2024-11-13,9103
3013,晟銘電,19,16,3,群益金鼎-松山,2024-11-13,9103
5871,中租-KY,2,0,2,群益金鼎-松山,2024-11-13,9103
2377,微星,3,1,2,群益金鼎-松山,2024-11-13,9103
0050,元大台灣50,2,0,2,群益金鼎-松山,2024-11-13,9103
2881,富邦金,2,0,2,群益金鼎-松山,2024-11-13,9103
00878,國泰永續高股息,51,0,51,群益金鼎-松山,2024-11-14,9103
6164,華興,50,0,50,群益金鼎-松山,2024-11-14,9103
6757,台灣虎航,45,0,45,群益金鼎-松山,2024-11-14,9103
00933B,國泰10Y+金融債,40,0,40,群益金鼎-松山,2024-11-14,9103
2892,第一金,34,0,34,群益金鼎-松山,2024-11-14,9103
00929,復華台灣科技優息,30,0,30,群益金鼎-松山,2024-11-14,9103
00891,中信關鍵半導體,20,0,20,群益金鼎-松山,2024-11-14,9103
1717,長興,20,0,20,群益金鼎-松山,2024-11-14,9103
1734,杏輝,20,0,20,群益金鼎-松山,2024-11-14,9103
2915,潤泰全,25,5,20,群益金鼎-松山,2024-11-14,9103
6416,瑞祺電通,20,0,20,群益金鼎-松山,2024-11-14,9103
2317,鴻海,13,1,12,群益金鼎-松山,2024-11-14,9103
2867,三商壽,12,0,12,群益金鼎-松山,2024-11-14,9103
00706L,期元大S＆P日圓正2,10,0,10,群益金鼎-松山,2024-11-14,9103
2897,王道銀行,10,0,10,群益金鼎-松山,2024-11-14,9103
4569,六方科-KY,10,0,10,群益金鼎-松山,2024-11-14,9103
6245,立端,10,1,9,群益金鼎-松山,2024-11-14,9103
3062,建漢,31,22,9,群益金鼎-松山,2024-11-14,9103
2330,台積電,10,2,8,群益金鼎-松山,2024-11-14,9103
0056,元大高股息,8,0,8,群益金鼎-松山,2024-11-14,9103
9910,豐泰,8,0,8,群益金鼎-松山,2024-11-14,9103
2382,廣達,9,2,7,群益金鼎-松山,2024-11-14,9103
00959B,大華投等美債15Y+,8,1,7,群益金鼎-松山,2024-11-14,9103
2353,宏��,7,0,7,群益金鼎-松山,2024-11-14,9103
3711,日月光投控,7,1,6,群益金鼎-松山,2024-11-14,9103
6121,新普,8,2,6,群益金鼎-松山,2024-11-14,9103
2337,旺宏,15,10,5,群益金鼎-松山,2024-11-14,9103
2883,凱基金,5,0,5,群益金鼎-松山,2024-11-14,9103
00665L,富邦�琤肭磪囓�2,5,0,5,群益金鼎-松山,2024-11-14,9103
00909,國泰數位支付服務,5,0,5,群益金鼎-松山,2024-11-14,9103
020033,統一�琤肮黕篾,5,0,5,群益金鼎-松山,2024-11-14,9103
4938,和碩,10,5,5,群益金鼎-松山,2024-11-14,9103
5243,乙盛-KY,5,0,5,群益金鼎-松山,2024-11-14,9103
6197,佳必琪,5,0,5,群益金鼎-松山,2024-11-14,9103
6505,台塑化,5,0,5,群益金鼎-松山,2024-11-14,9103
6548,長科*,5,0,5,群益金鼎-松山,2024-11-14,9103
2603,長榮,21,16,5,群益金鼎-松山,2024-11-14,9103
3324,雙鴻,6,1,5,群益金鼎-松山,2024-11-14,9103
00919,群益台灣精選高息,4,0,4,群益金鼎-松山,2024-11-14,9103
00687B,國泰20年美債,4,0,4,群益金鼎-松山,2024-11-14,9103
1304,台聚,4,0,4,群益金鼎-松山,2024-11-14,9103
00960,野村全球航運龍頭,4,0,4,群益金鼎-松山,2024-11-14,9103
2477,美隆電,4,0,4,群益金鼎-松山,2024-11-14,9103
2405,輔信,4,1,3,群益金鼎-松山,2024-11-14,9103
3048,益登,3,0,3,群益金鼎-松山,2024-11-14,9103
5263,智崴,3,0,3,群益金鼎-松山,2024-11-14,9103
5392,能率,3,0,3,群益金鼎-松山,2024-11-14,9103
6125,廣運,3,0,3,群益金鼎-松山,2024-11-14,9103
6153,嘉聯益,3,0,3,群益金鼎-松山,2024-11-14,9103
6202,盛群,3,0,3,群益金鼎-松山,2024-11-14,9103
9105,泰金寶-DR,301,201,100,群益金鼎-松山,2024-11-15,9103
00943,兆豐電子高息等權,88,0,88,群益金鼎-松山,2024-11-15,9103
2354,鴻準,176,104,72,群益金鼎-松山,2024-11-15,9103
9921,巨大,51,0,51,群益金鼎-松山,2024-11-15,9103
00887,永豐中國科技50大,50,0,50,群益金鼎-松山,2024-11-15,9103
3090,日電貿,48,2,46,群益金鼎-松山,2024-11-15,9103
00830,國泰費城半導體,32,0,32,群益金鼎-松山,2024-11-15,9103
2349,錸德,62,30,32,群益金鼎-松山,2024-11-15,9103
1101,台泥,30,0,30,群益金鼎-松山,2024-11-15,9103
3211,順達,29,0,29,群益金鼎-松山,2024-11-15,9103
2605,新興,30,2,28,群益金鼎-松山,2024-11-15,9103
00922,國泰台灣領袖50,23,0,23,群益金鼎-松山,2024-11-15,9103
00670L,富邦NASDAQ正2,22,0,22,群益金鼎-松山,2024-11-15,9103
2317,鴻海,23,2,21,群益金鼎-松山,2024-11-15,9103
00671R,富邦NASDAQ反1,20,0,20,群益金鼎-松山,2024-11-15,9103
00891,中信關鍵半導體,20,0,20,群益金鼎-松山,2024-11-15,9103
2520,冠德,20,0,20,群益金鼎-松山,2024-11-15,9103
1522,堤維西,20,1,19,群益金鼎-松山,2024-11-15,9103
00878,國泰永續高股息,16,0,16,群益金鼎-松山,2024-11-15,9103
00948B,中信優息投資級債,15,0,15,群益金鼎-松山,2024-11-15,9103
00664R,國泰臺灣加權反1,14,0,14,群益金鼎-松山,2024-11-15,9103
1513,中興電,12,0,12,群益金鼎-松山,2024-11-15,9103
6282,康舒,32,20,12,群益金鼎-松山,2024-11-15,9103
1314,中石化,10,0,10,群益金鼎-松山,2024-11-15,9103
00937B,群益ESG投等債20,10,0,10,群益金鼎-松山,2024-11-15,9103
1446,宏和,10,0,10,群益金鼎-松山,2024-11-15,9103
2009,第一銅,10,0,10,群益金鼎-松山,2024-11-15,9103
2357,華碩,12,2,10,群益金鼎-松山,2024-11-15,9103
2613,中櫃,10,0,10,群益金鼎-松山,2024-11-15,9103
2855,統一證,10,0,10,群益金鼎-松山,2024-11-15,9103
5324,士開,10,0,10,群益金鼎-松山,2024-11-15,9103
6781,AES-KY,9,0,9,群益金鼎-松山,2024-11-15,9103
3580,友威科,20,12,8,群益金鼎-松山,2024-11-15,9103
00852L,國泰美國道瓊正2,7,0,7,群益金鼎-松山,2024-11-15,9103
1560,中砂,7,0,7,群益金鼎-松山,2024-11-15,9103
2606,裕民,6,0,6,群益金鼎-松山,2024-11-15,9103
00637L,元大滬深300正2,10,5,5,群益金鼎-松山,2024-11-15,9103
00909,國泰數位支付服務,5,0,5,群益金鼎-松山,2024-11-15,9103
2105,正新,6,1,5,群益金鼎-松山,2024-11-15,9103
2324,仁寶,15,10,5,群益金鼎-松山,2024-11-15,9103
2615,萬海,5,0,5,群益金鼎-松山,2024-11-15,9103
6245,立端,5,0,5,群益金鼎-松山,2024-11-15,9103
6443,元晶,5,0,5,群益金鼎-松山,2024-11-15,9103
8070,長華*,5,0,5,群益金鼎-松山,2024-11-15,9103
8374,羅昇,7,2,5,群益金鼎-松山,2024-11-15,9103
1319,東陽,7,3,4,群益金鼎-松山,2024-11-15,9103
00632R,元大台灣50反1,5,1,4,群益金鼎-松山,2024-11-15,9103
6438,迅得,5,1,4,群益金鼎-松山,2024-11-15,9103
2312,金寶,125,121,4,群益金鼎-松山,2024-11-15,9103
00773B,中信優先金融債,3,0,3,群益金鼎-松山,2024-11-15,9103
00682U,期元大美元指數,339,0,339,群益金鼎-松山,2024-11-18,9103
2881,富邦金,107,1,106,群益金鼎-松山,2024-11-18,9103
00918,大華優利高填息30,24,0,24,群益金鼎-松山,2024-11-18,9103
00878,國泰永續高股息,24,1,23,群益金鼎-松山,2024-11-18,9103
2605,新興,21,0,21,群益金鼎-松山,2024-11-18,9103
2354,鴻準,68,49,19,群益金鼎-松山,2024-11-18,9103
00959B,大華投等美債15Y+,16,0,16,群益金鼎-松山,2024-11-18,9103
2312,金寶,40,27,13,群益金鼎-松山,2024-11-18,9103
3706,神達,41,28,13,群益金鼎-松山,2024-11-18,9103
2383,台光電,11,0,11,群益金鼎-松山,2024-11-18,9103
00887,永豐中國科技50大,10,0,10,群益金鼎-松山,2024-11-18,9103
00891,中信關鍵半導體,10,0,10,群益金鼎-松山,2024-11-18,9103
00919,群益台灣精選高息,10,0,10,群益金鼎-松山,2024-11-18,9103
00650L,復華香港正2,10,0,10,群益金鼎-松山,2024-11-18,9103
0056,元大高股息,10,0,10,群益金鼎-松山,2024-11-18,9103
3310,佳穎,10,0,10,群益金鼎-松山,2024-11-18,9103
4707,磐亞,10,0,10,群益金鼎-松山,2024-11-18,9103
5243,乙盛-KY,10,0,10,群益金鼎-松山,2024-11-18,9103
9105,泰金寶-DR,210,201,9,群益金鼎-松山,2024-11-18,9103
2317,鴻海,69,61,8,群益金鼎-松山,2024-11-18,9103
6548,長科*,6,0,6,群益金鼎-松山,2024-11-18,9103
00753L,中信中國50正2,5,0,5,群益金鼎-松山,2024-11-18,9103
2371,大同,15,10,5,群益金鼎-松山,2024-11-18,9103
6288,聯嘉,5,0,5,群益金鼎-松山,2024-11-18,9103
8249,菱光,5,0,5,群益金鼎-松山,2024-11-18,9103
2646,星宇航空,5,0,5,群益金鼎-松山,2024-11-18,9103
3374,精材,4,0,4,群益金鼎-松山,2024-11-18,9103
00631L,元大台灣50正2,4,0,4,群益金鼎-松山,2024-11-18,9103
00922,國泰台灣領袖50,4,0,4,群益金鼎-松山,2024-11-18,9103
5392,能率,4,0,4,群益金鼎-松山,2024-11-18,9103
6245,立端,4,0,4,群益金鼎-松山,2024-11-18,9103
6492,生華科,4,0,4,群益金鼎-松山,2024-11-18,9103
2603,長榮,3,0,3,群益金鼎-松山,2024-11-18,9103
3293,鈊象,3,0,3,群益金鼎-松山,2024-11-18,9103
1471,首利,3,0,3,群益金鼎-松山,2024-11-18,9103
2250,IKKA-KY,3,0,3,群益金鼎-松山,2024-11-18,9103
2908,特力,3,0,3,群益金鼎-松山,2024-11-18,9103
3149,正達,8,5,3,群益金鼎-松山,2024-11-18,9103
3289,宜特,3,0,3,群益金鼎-松山,2024-11-18,9103
4743,合一,3,0,3,群益金鼎-松山,2024-11-18,9103
6856,鑫傳,3,0,3,群益金鼎-松山,2024-11-18,9103
8043,蜜望實,3,0,3,群益金鼎-松山,2024-11-18,9103
8110,華東,3,0,3,群益金鼎-松山,2024-11-18,9103
8390,金益鼎,3,0,3,群益金鼎-松山,2024-11-18,9103
1519,華城,2,0,2,群益金鼎-松山,2024-11-18,9103
3450,聯鈞,7,5,2,群益金鼎-松山,2024-11-18,9103
6643,M31,2,0,2,群益金鼎-松山,2024-11-18,9103
00752,中信中國50,2,0,2,群益金鼎-松山,2024-11-18,9103
1722,台肥,2,0,2,群益金鼎-松山,2024-11-18,9103
2367,燿華,2,0,2,群益金鼎-松山,2024-11-18,9103
2887,台新金,300,0,300,群益金鼎-松山,2024-11-19,9103
2867,三商壽,100,0,100,群益金鼎-松山,2024-11-19,9103
00687B,國泰20年美債,51,0,51,群益金鼎-松山,2024-11-19,9103
2349,錸德,37,2,35,群益金鼎-松山,2024-11-19,9103
3711,日月光投控,30,0,30,群益金鼎-松山,2024-11-19,9103
00878,國泰永續高股息,22,0,22,群益金鼎-松山,2024-11-19,9103
00953B,群益優選非投等債,20,0,20,群益金鼎-松山,2024-11-19,9103
2615,萬海,20,0,20,群益金鼎-松山,2024-11-19,9103
00940,元大台灣價值高息,20,1,19,群益金鼎-松山,2024-11-19,9103
00713,元大台灣高息低波,15,0,15,群益金鼎-松山,2024-11-19,9103
3363,上詮,17,3,14,群益金鼎-松山,2024-11-19,9103
2486,一詮,17,4,13,群益金鼎-松山,2024-11-19,9103
4542,科嶠,16,4,12,群益金鼎-松山,2024-11-19,9103
2357,華碩,13,2,11,群益金鼎-松山,2024-11-19,9103
00632R,元大台灣50反1,10,0,10,群益金鼎-松山,2024-11-19,9103
00706L,期元大S＆P日圓正2,10,0,10,群益金鼎-松山,2024-11-19,9103
2485,兆赫,10,0,10,群益金鼎-松山,2024-11-19,9103
6505,台塑化,12,2,10,群益金鼎-松山,2024-11-19,9103
2204,中華,8,0,8,群益金鼎-松山,2024-11-19,9103
2609,陽明,22,14,8,群益金鼎-松山,2024-11-19,9103
00887,永豐中國科技50大,10,3,7,群益金鼎-松山,2024-11-19,9103
3481,群創,8,2,6,群益金鼎-松山,2024-11-19,9103
4562,穎漢,10,4,6,群益金鼎-松山,2024-11-19,9103
6901,鑽石投資,6,0,6,群益金鼎-松山,2024-11-19,9103
2548,華固,5,0,5,群益金鼎-松山,2024-11-19,9103
3289,宜特,5,0,5,群益金鼎-松山,2024-11-19,9103
3702,大聯大,6,1,5,群益金鼎-松山,2024-11-19,9103
6186,新潤,5,0,5,群益金鼎-松山,2024-11-19,9103
6443,元晶,5,0,5,群益金鼎-松山,2024-11-19,9103
8104,錸寶,6,1,5,群益金鼎-松山,2024-11-19,9103
2382,廣達,5,1,4,群益金鼎-松山,2024-11-19,9103
1304,台聚,4,0,4,群益金鼎-松山,2024-11-19,9103
2356,英業達,4,0,4,群益金鼎-松山,2024-11-19,9103
2718,全心投控,4,0,4,群益金鼎-松山,2024-11-19,9103
3019,亞光,4,0,4,群益金鼎-松山,2024-11-19,9103
3025,星通,12,8,4,群益金鼎-松山,2024-11-19,9103
4931,新盛力,4,0,4,群益金鼎-松山,2024-11-19,9103
6282,康舒,5,1,4,群益金鼎-松山,2024-11-19,9103
00708L,期元大S＆P黃金正2,3,0,3,群益金鼎-松山,2024-11-19,9103
00679B,元大美債20年,3,0,3,群益金鼎-松山,2024-11-19,9103
2354,鴻準,30,27,3,群益金鼎-松山,2024-11-19,9103
3661,世芯-KY,5,2,3,群益金鼎-松山,2024-11-19,9103
4956,光鋐,4,1,3,群益金鼎-松山,2024-11-19,9103
4958,臻鼎-KY,3,0,3,群益金鼎-松山,2024-11-19,9103
5269,祥碩,3,0,3,群益金鼎-松山,2024-11-19,9103
6278,台表科,3,0,3,群益金鼎-松山,2024-11-19,9103
8299,群聯,2,0,2,群益金鼎-松山,2024-11-19,9103
0050,元大台灣50,2,0,2,群益金鼎-松山,2024-11-19,9103
9921,巨大,2,0,2,群益金鼎-松山,2024-11-19,9103
1216,統一,6,4,2,群益金鼎-松山,2024-11-19,9103
00959B,大華投等美債15Y+,200,0,200,群益金鼎-松山,2024-11-20,9103
2409,友達,100,0,100,群益金鼎-松山,2024-11-20,9103
9105,泰金寶-DR,100,0,100,群益金鼎-松山,2024-11-20,9103
00682U,期元大美元指數,51,0,51,群益金鼎-松山,2024-11-20,9103
2312,金寶,50,0,50,群益金鼎-松山,2024-11-20,9103
2444,兆勁,31,0,31,群益金鼎-松山,2024-11-20,9103
2030,彰源,30,0,30,群益金鼎-松山,2024-11-20,9103
3050,鈺德,60,30,30,群益金鼎-松山,2024-11-20,9103
2324,仁寶,15,0,15,群益金鼎-松山,2024-11-20,9103
2354,鴻準,37,23,14,群益金鼎-松山,2024-11-20,9103
2330,台積電,13,1,12,群益金鼎-松山,2024-11-20,9103
1605,華新,11,0,11,群益金鼎-松山,2024-11-20,9103
3081,聯亞,20,10,10,群益金鼎-松山,2024-11-20,9103
00910,第一金太空衛星,10,0,10,群益金鼎-松山,2024-11-20,9103
00679B,元大美債20年,20,10,10,群益金鼎-松山,2024-11-20,9103
2349,錸德,88,79,9,群益金鼎-松山,2024-11-20,9103
2303,聯電,9,0,9,群益金鼎-松山,2024-11-20,9103
2404,漢唐,9,2,7,群益金鼎-松山,2024-11-20,9103
3706,神達,48,41,7,群益金鼎-松山,2024-11-20,9103
8047,星雲,7,0,7,群益金鼎-松山,2024-11-20,9103
8249,菱光,12,5,7,群益金鼎-松山,2024-11-20,9103
2603,長榮,11,4,7,群益金鼎-松山,2024-11-20,9103
1815,富喬,9,3,6,群益金鼎-松山,2024-11-20,9103
00940,元大台灣價值高息,6,0,6,群益金鼎-松山,2024-11-20,9103
2356,英業達,7,1,6,群益金鼎-松山,2024-11-20,9103
2609,陽明,147,141,6,群益金鼎-松山,2024-11-20,9103
2439,美律,5,0,5,群益金鼎-松山,2024-11-20,9103
00631L,元大台灣50正2,9,4,5,群益金鼎-松山,2024-11-20,9103
00937B,群益ESG投等債20,5,0,5,群益金鼎-松山,2024-11-20,9103
2524,京城,5,0,5,群益金鼎-松山,2024-11-20,9103
9907,統一實,5,0,5,群益金鼎-松山,2024-11-20,9103
3552,同致,5,0,5,群益金鼎-松山,2024-11-20,9103
1436,華友聯,4,0,4,群益金鼎-松山,2024-11-20,9103
2486,一詮,6,2,4,群益金鼎-松山,2024-11-20,9103
2597,潤弘,4,0,4,群益金鼎-松山,2024-11-20,9103
3323,加百裕,10,6,4,群益金鼎-松山,2024-11-20,9103
3363,上詮,6,2,4,群益金鼎-松山,2024-11-20,9103
3447,展達,5,1,4,群益金鼎-松山,2024-11-20,9103
5876,上海商銀,4,0,4,群益金鼎-松山,2024-11-20,9103
1618,合機,3,0,3,群益金鼎-松山,2024-11-20,9103
00687B,國泰20年美債,3,0,3,群益金鼎-松山,2024-11-20,9103
1326,台化,3,0,3,群益金鼎-松山,2024-11-20,9103
2408,南亞科,3,0,3,群益金鼎-松山,2024-11-20,9103
2481,強茂,6,3,3,群益金鼎-松山,2024-11-20,9103
3591,艾笛森,3,0,3,群益金鼎-松山,2024-11-20,9103
3663,鑫科,3,0,3,群益金鼎-松山,2024-11-20,9103
4707,磐亞,3,0,3,群益金鼎-松山,2024-11-20,9103
6573,虹揚-KY,3,0,3,群益金鼎-松山,2024-11-20,9103
8358,金居,3,0,3,群益金鼎-松山,2024-11-20,9103
6153,嘉聯益,2,0,2,群益金鼎-松山,2024-11-20,9103
9921,巨大,50,0,50,群益金鼎-松山,2024-11-21,9103
911868,同方友友-DR,46,0,46,群益金鼎-松山,2024-11-21,9103
00950B,凱基A級公司債,44,0,44,群益金鼎-松山,2024-11-21,9103
00959B,大華投等美債15Y+,42,0,42,群益金鼎-松山,2024-11-21,9103
3450,聯鈞,35,2,33,群益金鼎-松山,2024-11-21,9103
00953B,群益優選非投等債,32,0,32,群益金鼎-松山,2024-11-21,9103
2605,新興,30,0,30,群益金鼎-松山,2024-11-21,9103
4968,立積,27,0,27,群益金鼎-松山,2024-11-21,9103
00919,群益台灣精選高息,20,0,20,群益金鼎-松山,2024-11-21,9103
4931,新盛力,18,0,18,群益金鼎-松山,2024-11-21,9103
2615,萬海,56,40,16,群益金鼎-松山,2024-11-21,9103
3081,聯亞,22,8,14,群益金鼎-松山,2024-11-21,9103
00878,國泰永續高股息,13,0,13,群益金鼎-松山,2024-11-21,9103
1537,廣隆,10,0,10,群益金鼎-松山,2024-11-21,9103
2485,兆赫,10,0,10,群益金鼎-松山,2024-11-21,9103
2867,三商壽,10,0,10,群益金鼎-松山,2024-11-21,9103
00958B,永豐ESG銀行債15,8,0,8,群益金鼎-松山,2024-11-21,9103
6138,茂達,7,0,7,群益金鼎-松山,2024-11-21,9103
3025,星通,10,3,7,群益金鼎-松山,2024-11-21,9103
2891,中信金,6,0,6,群益金鼎-松山,2024-11-21,9103
2330,台積電,5,0,5,群益金鼎-松山,2024-11-21,9103
00830,國泰費城半導體,5,0,5,群益金鼎-松山,2024-11-21,9103
00753L,中信中國50正2,5,0,5,群益金鼎-松山,2024-11-21,9103
00881,國泰台灣5G+,5,0,5,群益金鼎-松山,2024-11-21,9103
6443,元晶,5,0,5,群益金鼎-松山,2024-11-21,9103
2457,飛宏,4,0,4,群益金鼎-松山,2024-11-21,9103
2501,國建,6,2,4,群益金鼎-松山,2024-11-21,9103
2881,富邦金,5,1,4,群益金鼎-松山,2024-11-21,9103
2353,宏��,4,0,4,群益金鼎-松山,2024-11-21,9103
3019,亞光,3,0,3,群益金鼎-松山,2024-11-21,9103
3032,偉訓,3,0,3,群益金鼎-松山,2024-11-21,9103
5269,祥碩,4,1,3,群益金鼎-松山,2024-11-21,9103
6856,鑫傳,3,0,3,群益金鼎-松山,2024-11-21,9103
8038,長園科,3,0,3,群益金鼎-松山,2024-11-21,9103
00922,國泰台灣領袖50,2,0,2,群益金鼎-松山,2024-11-21,9103
1446,宏和,2,0,2,群益金鼎-松山,2024-11-21,9103
2348,海悅,3,1,2,群益金鼎-松山,2024-11-21,9103
2356,英業達,3,1,2,群益金鼎-松山,2024-11-21,9103
2718,全心投控,2,0,2,群益金鼎-松山,2024-11-21,9103
2890,永豐金,2,0,2,群益金鼎-松山,2024-11-21,9103
3363,上詮,2,0,2,群益金鼎-松山,2024-11-21,9103
3413,京鼎,2,0,2,群益金鼎-松山,2024-11-21,9103
3702,大聯大,2,0,2,群益金鼎-松山,2024-11-21,9103
5508,永信建,2,0,2,群益金鼎-松山,2024-11-21,9103
6125,廣運,2,0,2,群益金鼎-松山,2024-11-21,9103
6244,茂迪,2,0,2,群益金鼎-松山,2024-11-21,9103
3625,西勝,2,0,2,群益金鼎-松山,2024-11-21,9103
2383,台光電,2,0,2,群益金鼎-松山,2024-11-21,9103
2308,台達電,1,0,1,群益金鼎-松山,2024-11-21,9103
1709,和益,1,0,1,群益金鼎-松山,2024-11-21,9103
2501,國建,100,0,100,群益金鼎-松山,2024-11-22,9103
2392,正崴,66,3,63,群益金鼎-松山,2024-11-22,9103
2371,大同,60,25,35,群益金鼎-松山,2024-11-22,9103
2615,萬海,41,15,26,群益金鼎-松山,2024-11-22,9103
2891,中信金,22,0,22,群益金鼎-松山,2024-11-22,9103
00632R,元大台灣50反1,20,0,20,群益金鼎-松山,2024-11-22,9103
3702,大聯大,18,0,18,群益金鼎-松山,2024-11-22,9103
2486,一詮,19,2,17,群益金鼎-松山,2024-11-22,9103
2354,鴻準,26,11,15,群益金鼎-松山,2024-11-22,9103
00960,野村全球航運龍頭,13,0,13,群益金鼎-松山,2024-11-22,9103
5443,均豪,16,4,12,群益金鼎-松山,2024-11-22,9103
3025,星通,15,4,11,群益金鼎-松山,2024-11-22,9103
2867,三商壽,10,0,10,群益金鼎-松山,2024-11-22,9103
1446,宏和,10,0,10,群益金鼎-松山,2024-11-22,9103
3041,揚智,10,0,10,群益金鼎-松山,2024-11-22,9103
4510,高鋒,22,12,10,群益金鼎-松山,2024-11-22,9103
6269,台郡,10,0,10,群益金鼎-松山,2024-11-22,9103
6768,志強-KY,10,0,10,群益金鼎-松山,2024-11-22,9103
912000,晨訊科-DR,10,0,10,群益金鼎-松山,2024-11-22,9103
020033,統一�琤肮黕篾,9,0,9,群益金鼎-松山,2024-11-22,9103
3211,順達,9,0,9,群益金鼎-松山,2024-11-22,9103
3705,永信,8,0,8,群益金鼎-松山,2024-11-22,9103
2365,昆盈,35,28,7,群益金鼎-松山,2024-11-22,9103
8163,達方,7,0,7,群益金鼎-松山,2024-11-22,9103
00637L,元大滬深300正2,6,0,6,群益金鼎-松山,2024-11-22,9103
00679B,元大美債20年,6,0,6,群益金鼎-松山,2024-11-22,9103
1304,台聚,6,0,6,群益金鼎-松山,2024-11-22,9103
2637,慧洋-KY,6,0,6,群益金鼎-松山,2024-11-22,9103
6121,新普,6,0,6,群益金鼎-松山,2024-11-22,9103
6438,迅得,8,2,6,群益金鼎-松山,2024-11-22,9103
00909,國泰數位支付服務,5,0,5,群益金鼎-松山,2024-11-22,9103
00895,富邦未來車,5,0,5,群益金鼎-松山,2024-11-22,9103
00893,國泰智能電動車,5,0,5,群益金鼎-松山,2024-11-22,9103
00935,野村臺灣新科技50,5,0,5,群益金鼎-松山,2024-11-22,9103
00929,復華台灣科技優息,5,0,5,群益金鼎-松山,2024-11-22,9103
00700,富邦�琤肭磪�,5,0,5,群益金鼎-松山,2024-11-22,9103
00687B,國泰20年美債,5,0,5,群益金鼎-松山,2024-11-22,9103
2348,海悅,5,0,5,群益金鼎-松山,2024-11-22,9103
2356,英業達,10,5,5,群益金鼎-松山,2024-11-22,9103
3147,大綜,5,0,5,群益金鼎-松山,2024-11-22,9103
3483,力致,5,0,5,群益金鼎-松山,2024-11-22,9103
5309,系統電,20,15,5,群益金鼎-松山,2024-11-22,9103
5488,松普,5,0,5,群益金鼎-松山,2024-11-22,9103
6165,浪凡,5,0,5,群益金鼎-松山,2024-11-22,9103
8374,羅昇,7,2,5,群益金鼎-松山,2024-11-22,9103
2609,陽明,27,23,4,群益金鼎-松山,2024-11-22,9103
1536,和大,4,0,4,群益金鼎-松山,2024-11-22,9103
2903,遠百,4,0,4,群益金鼎-松山,2024-11-22,9103
3289,宜特,4,0,4,群益金鼎-松山,2024-11-22,9103
4558,寶緯,4,0,4,群益金鼎-松山,2024-11-22,9103
5876,上海商銀,123,5,118,群益金鼎-松山,2024-11-25,9103
2609,陽明,112,1,111,群益金鼎-松山,2024-11-25,9103
3481,群創,103,0,103,群益金鼎-松山,2024-11-25,9103
2392,正崴,69,19,50,群益金鼎-松山,2024-11-25,9103
3380,明泰,50,0,50,群益金鼎-松山,2024-11-25,9103
9105,泰金寶-DR,98,49,49,群益金鼎-松山,2024-11-25,9103
2344,華邦電,34,0,34,群益金鼎-松山,2024-11-25,9103
00943,兆豐電子高息等權,33,0,33,群益金鼎-松山,2024-11-25,9103
2618,長榮航,33,0,33,群益金鼎-松山,2024-11-25,9103
1506,正道,30,0,30,群益金鼎-松山,2024-11-25,9103
8163,達方,30,0,30,群益金鼎-松山,2024-11-25,9103
1815,富喬,46,23,23,群益金鼎-松山,2024-11-25,9103
2349,錸德,50,30,20,群益金鼎-松山,2024-11-25,9103
2615,萬海,20,0,20,群益金鼎-松山,2024-11-25,9103
3511,矽瑪,20,0,20,群益金鼎-松山,2024-11-25,9103
4526,東台,40,20,20,群益金鼎-松山,2024-11-25,9103
6757,台灣虎航,20,0,20,群益金鼎-松山,2024-11-25,9103
3090,日電貿,20,4,16,群益金鼎-松山,2024-11-25,9103
020033,統一�琤肮黕篾,15,0,15,群益金鼎-松山,2024-11-25,9103
2351,順德,15,0,15,群益金鼎-松山,2024-11-25,9103
2455,全新,24,10,14,群益金鼎-松山,2024-11-25,9103
3450,聯鈞,25,11,14,群益金鼎-松山,2024-11-25,9103
8104,錸寶,15,3,12,群益金鼎-松山,2024-11-25,9103
2010,春源,11,0,11,群益金鼎-松山,2024-11-25,9103
3289,宜特,11,0,11,群益金鼎-松山,2024-11-25,9103
00637L,元大滬深300正2,16,6,10,群益金鼎-松山,2024-11-25,9103
1587,吉茂,10,0,10,群益金鼎-松山,2024-11-25,9103
2365,昆盈,44,34,10,群益金鼎-松山,2024-11-25,9103
2485,兆赫,30,20,10,群益金鼎-松山,2024-11-25,9103
3147,大綜,10,0,10,群益金鼎-松山,2024-11-25,9103
3374,精材,10,0,10,群益金鼎-松山,2024-11-25,9103
4562,穎漢,15,5,10,群益金鼎-松山,2024-11-25,9103
2367,燿華,9,0,9,群益金鼎-松山,2024-11-25,9103
00887,永豐中國科技50大,10,2,8,群益金鼎-松山,2024-11-25,9103
6443,元晶,8,0,8,群益金鼎-松山,2024-11-25,9103
3702,大聯大,9,2,7,群益金鼎-松山,2024-11-25,9103
00946,群益科技高息成長,6,0,6,群益金鼎-松山,2024-11-25,9103
00945B,凱基美國非投等債,6,0,6,群益金鼎-松山,2024-11-25,9103
2312,金寶,119,113,6,群益金鼎-松山,2024-11-25,9103
4729,熒茂,6,0,6,群益金鼎-松山,2024-11-25,9103
5608,四維航,6,0,6,群益金鼎-松山,2024-11-25,9103
2303,聯電,5,0,5,群益金鼎-松山,2024-11-25,9103
00633L,富邦上証正2,7,2,5,群益金鼎-松山,2024-11-25,9103
1101,台泥,11,6,5,群益金鼎-松山,2024-11-25,9103
2359,所羅門,5,0,5,群益金鼎-松山,2024-11-25,9103
6669,緯穎,7,2,5,群益金鼎-松山,2024-11-25,9103
00674R,期元大S＆P黃金反1,4,0,4,群益金鼎-松山,2024-11-25,9103
1563,巧新,4,0,4,群益金鼎-松山,2024-11-25,9103
2421,建準,4,0,4,群益金鼎-松山,2024-11-25,9103
4510,高鋒,18,14,4,群益金鼎-松山,2024-11-25,9103
2881,富邦金,171,0,171,群益金鼎-松山,2024-11-26,9103
2027,大成鋼,138,5,133,群益金鼎-松山,2024-11-26,9103
2409,友達,100,0,100,群益金鼎-松山,2024-11-26,9103
2317,鴻海,66,0,66,群益金鼎-松山,2024-11-26,9103
2419,仲琦,84,33,51,群益金鼎-松山,2024-11-26,9103
1815,富喬,129,80,49,群益金鼎-松山,2024-11-26,9103
3380,明泰,50,3,47,群益金鼎-松山,2024-11-26,9103
2351,順德,30,0,30,群益金鼎-松山,2024-11-26,9103
2312,金寶,42,16,26,群益金鼎-松山,2024-11-26,9103
4968,立積,29,10,19,群益金鼎-松山,2024-11-26,9103
5452,佶優,35,20,15,群益金鼎-松山,2024-11-26,9103
1584,精剛,14,0,14,群益金鼎-松山,2024-11-26,9103
3450,聯鈞,18,5,13,群益金鼎-松山,2024-11-26,9103
2392,正崴,16,3,13,群益金鼎-松山,2024-11-26,9103
00878,國泰永續高股息,13,0,13,群益金鼎-松山,2024-11-26,9103
2352,佳世達,12,0,12,群益金鼎-松山,2024-11-26,9103
2486,一詮,11,1,10,群益金鼎-松山,2024-11-26,9103
00753L,中信中國50正2,20,10,10,群益金鼎-松山,2024-11-26,9103
2426,鼎元,40,30,10,群益金鼎-松山,2024-11-26,9103
3564,其陽,10,0,10,群益金鼎-松山,2024-11-26,9103
8171,天宇,10,0,10,群益金鼎-松山,2024-11-26,9103
6104,創惟,38,30,8,群益金鼎-松山,2024-11-26,9103
00635U,期元大S＆P黃金,6,0,6,群益金鼎-松山,2024-11-26,9103
3363,上詮,10,4,6,群益金鼎-松山,2024-11-26,9103
6873,泓德能源,5,0,5,群益金鼎-松山,2024-11-26,9103
00915,凱基優選高股息30,5,0,5,群益金鼎-松山,2024-11-26,9103
3041,揚智,5,0,5,群益金鼎-松山,2024-11-26,9103
3597,映興,5,0,5,群益金鼎-松山,2024-11-26,9103
6768,志強-KY,5,0,5,群益金鼎-松山,2024-11-26,9103
0050,元大台灣50,4,0,4,群益金鼎-松山,2024-11-26,9103
4576,大銀微系統,4,0,4,群益金鼎-松山,2024-11-26,9103
1587,吉茂,3,0,3,群益金鼎-松山,2024-11-26,9103
1808,潤隆,3,0,3,群益金鼎-松山,2024-11-26,9103
2464,盟立,3,0,3,群益金鼎-松山,2024-11-26,9103
2497,怡利電,3,0,3,群益金鼎-松山,2024-11-26,9103
2520,冠德,3,0,3,群益金鼎-松山,2024-11-26,9103
2890,永豐金,3,0,3,群益金鼎-松山,2024-11-26,9103
2915,潤泰全,3,0,3,群益金鼎-松山,2024-11-26,9103
3055,蔚華科,3,0,3,群益金鼎-松山,2024-11-26,9103
3231,緯創,7,4,3,群益金鼎-松山,2024-11-26,9103
5353,台林,3,0,3,群益金鼎-松山,2024-11-26,9103
6187,萬潤,3,0,3,群益金鼎-松山,2024-11-26,9103
9904,寶成,3,0,3,群益金鼎-松山,2024-11-26,9103
9945,潤泰新,3,0,3,群益金鼎-松山,2024-11-26,9103
2330,台積電,5,3,2,群益金鼎-松山,2024-11-26,9103
00930,永豐ESG低碳高息,2,0,2,群益金鼎-松山,2024-11-26,9103
00922,國泰台灣領袖50,2,0,2,群益金鼎-松山,2024-11-26,9103
2233,宇隆,2,0,2,群益金鼎-松山,2024-11-26,9103
2385,群光,2,0,2,群益金鼎-松山,2024-11-26,9103
2634,漢翔,4,2,2,群益金鼎-松山,2024-11-26,9103
2881,富邦金,435,0,435,群益金鼎-松山,2024-11-27,9103
2646,星宇航空,40,0,40,群益金鼎-松山,2024-11-27,9103
2312,金寶,65,32,33,群益金鼎-松山,2024-11-27,9103
00919,群益台灣精選高息,25,0,25,群益金鼎-松山,2024-11-27,9103
4562,穎漢,52,29,23,群益金鼎-松山,2024-11-27,9103
00929,復華台灣科技優息,22,0,22,群益金鼎-松山,2024-11-27,9103
00921,兆豐龍頭等權重,22,0,22,群益金鼎-松山,2024-11-27,9103
2610,華航,50,29,21,群益金鼎-松山,2024-11-27,9103
2891,中信金,20,5,15,群益金鼎-松山,2024-11-27,9103
00687B,國泰20年美債,32,18,14,群益金鼎-松山,2024-11-27,9103
2915,潤泰全,14,0,14,群益金鼎-松山,2024-11-27,9103
3231,緯創,15,1,14,群益金鼎-松山,2024-11-27,9103
0056,元大高股息,13,0,13,群益金鼎-松山,2024-11-27,9103
2367,燿華,15,2,13,群益金鼎-松山,2024-11-27,9103
2409,友達,13,0,13,群益金鼎-松山,2024-11-27,9103
00950B,凱基A級公司債,12,0,12,群益金鼎-松山,2024-11-27,9103
1605,華新,12,0,12,群益金鼎-松山,2024-11-27,9103
2324,仁寶,11,0,11,群益金鼎-松山,2024-11-27,9103
8163,達方,11,0,11,群益金鼎-松山,2024-11-27,9103
00637L,元大滬深300正2,10,0,10,群益金鼎-松山,2024-11-27,9103
00915,凱基優選高股息30,10,0,10,群益金鼎-松山,2024-11-27,9103
1308,亞聚,10,0,10,群益金鼎-松山,2024-11-27,9103
4968,立積,10,0,10,群益金鼎-松山,2024-11-27,9103
6505,台塑化,10,0,10,群益金鼎-松山,2024-11-27,9103
8064,東捷,15,5,10,群益金鼎-松山,2024-11-27,9103
00878,國泰永續高股息,9,0,9,群益金鼎-松山,2024-11-27,9103
00922,國泰台灣領袖50,9,0,9,群益金鼎-松山,2024-11-27,9103
4979,華星光,33,25,8,群益金鼎-松山,2024-11-27,9103
2603,長榮,9,1,8,群益金鼎-松山,2024-11-27,9103
2303,聯電,8,0,8,群益金鼎-松山,2024-11-27,9103
2405,輔信,8,0,8,群益金鼎-松山,2024-11-27,9103
6282,康舒,8,0,8,群益金鼎-松山,2024-11-27,9103
3037,欣興,7,0,7,群益金鼎-松山,2024-11-27,9103
4971,IET-KY,7,0,7,群益金鼎-松山,2024-11-27,9103
1808,潤隆,7,0,7,群益金鼎-松山,2024-11-27,9103
00881,國泰台灣5G+,6,0,6,群益金鼎-松山,2024-11-27,9103
2834,臺企銀,6,0,6,群益金鼎-松山,2024-11-27,9103
6770,力積電,6,0,6,群益金鼎-松山,2024-11-27,9103
00887,永豐中國科技50大,5,0,5,群益金鼎-松山,2024-11-27,9103
2485,兆赫,5,0,5,群益金鼎-松山,2024-11-27,9103
3022,威強電,5,0,5,群益金鼎-松山,2024-11-27,9103
4938,和碩,6,1,5,群益金鼎-松山,2024-11-27,9103
6288,聯嘉,6,1,5,群益金鼎-松山,2024-11-27,9103
7402,邑錡,5,0,5,群益金鼎-松山,2024-11-27,9103
006208,富邦台50,4,0,4,群益金鼎-松山,2024-11-27,9103
3042,晶技,4,0,4,群益金鼎-松山,2024-11-27,9103
1709,和益,4,0,4,群益金鼎-松山,2024-11-27,9103
2356,英業達,4,0,4,群益金鼎-松山,2024-11-27,9103
2618,長榮航,6,2,4,群益金鼎-松山,2024-11-27,9103
2718,全心投控,4,0,4,群益金鼎-松山,2024-11-27,9103
2881,富邦金,203,0,203,群益金鼎-松山,2024-11-28,9103
00687B,國泰20年美債,65,0,65,群益金鼎-松山,2024-11-28,9103
2367,燿華,34,0,34,群益金鼎-松山,2024-11-28,9103
2426,鼎元,94,60,34,群益金鼎-松山,2024-11-28,9103
1101,台泥,30,0,30,群益金鼎-松山,2024-11-28,9103
2543,皇昌,30,0,30,群益金鼎-松山,2024-11-28,9103
4979,華星光,35,11,24,群益金鼎-松山,2024-11-28,9103
3706,神達,70,51,19,群益金鼎-松山,2024-11-28,9103
3702A,大聯大甲特,16,0,16,群益金鼎-松山,2024-11-28,9103
00919,群益台灣精選高息,15,0,15,群益金鼎-松山,2024-11-28,9103
2646,星宇航空,15,0,15,群益金鼎-松山,2024-11-28,9103
6757,台灣虎航,15,0,15,群益金鼎-松山,2024-11-28,9103
00878,國泰永續高股息,13,0,13,群益金鼎-松山,2024-11-28,9103
1815,富喬,31,18,13,群益金鼎-松山,2024-11-28,9103
2382,廣達,14,1,13,群益金鼎-松山,2024-11-28,9103
3591,艾笛森,12,0,12,群益金鼎-松山,2024-11-28,9103
00924,復華S＆P500成長,11,0,11,群益金鼎-松山,2024-11-28,9103
2101,南港,10,0,10,群益金鼎-松山,2024-11-28,9103
3032,偉訓,10,0,10,群益金鼎-松山,2024-11-28,9103
4569,六方科-KY,10,0,10,群益金鼎-松山,2024-11-28,9103
6213,聯茂,10,0,10,群益金鼎-松山,2024-11-28,9103
2330,台積電,9,0,9,群益金鼎-松山,2024-11-28,9103
2915,潤泰全,8,0,8,群益金鼎-松山,2024-11-28,9103
2891,中信金,7,0,7,群益金鼎-松山,2024-11-28,9103
2455,全新,30,24,6,群益金鼎-松山,2024-11-28,9103
3374,精材,6,0,6,群益金鼎-松山,2024-11-28,9103
6164,華興,11,5,6,群益金鼎-松山,2024-11-28,9103
1514,亞力,5,0,5,群益金鼎-松山,2024-11-28,9103
1337,再生-KY,5,0,5,群益金鼎-松山,2024-11-28,9103
2348,海悅,5,0,5,群益金鼎-松山,2024-11-28,9103
2897,王道銀行,5,0,5,群益金鼎-松山,2024-11-28,9103
3022,威強電,5,0,5,群益金鼎-松山,2024-11-28,9103
5371,中光電,5,0,5,群益金鼎-松山,2024-11-28,9103
6768,志強-KY,5,0,5,群益金鼎-松山,2024-11-28,9103
8038,長園科,5,0,5,群益金鼎-松山,2024-11-28,9103
8929,富堡,5,0,5,群益金鼎-松山,2024-11-28,9103
8942,森鉅,5,0,5,群益金鼎-松山,2024-11-28,9103
9105,泰金寶-DR,305,300,5,群益金鼎-松山,2024-11-28,9103
2250,IKKA-KY,4,0,4,群益金鼎-松山,2024-11-28,9103
00918,大華優利高填息30,4,0,4,群益金鼎-松山,2024-11-28,9103
1808,潤隆,4,0,4,群益金鼎-松山,2024-11-28,9103
2303,聯電,4,0,4,群益金鼎-松山,2024-11-28,9103
2718,全心投控,4,0,4,群益金鼎-松山,2024-11-28,9103
5392,能率,4,0,4,群益金鼎-松山,2024-11-28,9103
6770,力積電,4,0,4,群益金鼎-松山,2024-11-28,9103
2317,鴻海,22,19,3,群益金鼎-松山,2024-11-28,9103
00915,凱基優選高股息30,3,0,3,群益金鼎-松山,2024-11-28,9103
1446,宏和,3,0,3,群益金鼎-松山,2024-11-28,9103
6021,美好證,3,0,3,群益金鼎-松山,2024-11-28,9103
6505,台塑化,3,0,3,群益金鼎-松山,2024-11-28,9103
2881,富邦金,104,1,103,群益金鼎-松山,2024-11-29,9103
6757,台灣虎航,60,0,60,群益金鼎-松山,2024-11-29,9103
3013,晟銘電,35,4,31,群益金鼎-松山,2024-11-29,9103
2543,皇昌,30,0,30,群益金鼎-松山,2024-11-29,9103
2312,金寶,51,24,27,群益金鼎-松山,2024-11-29,9103
00632R,元大台灣50反1,23,0,23,群益金鼎-松山,2024-11-29,9103
00918,大華優利高填息30,22,0,22,群益金鼎-松山,2024-11-29,9103
00940,元大台灣價值高息,21,0,21,群益金鼎-松山,2024-11-29,9103
2002,中鋼,21,0,21,群益金鼎-松山,2024-11-29,9103
8171,天宇,20,1,19,群益金鼎-松山,2024-11-29,9103
1815,富喬,35,16,19,群益金鼎-松山,2024-11-29,9103
00878,國泰永續高股息,13,0,13,群益金鼎-松山,2024-11-29,9103
3665,貿聯-KY,12,0,12,群益金鼎-松山,2024-11-29,9103
4979,華星光,15,4,11,群益金鼎-松山,2024-11-29,9103
5469,瀚宇博,10,0,10,群益金鼎-松山,2024-11-29,9103
1312,國喬,10,0,10,群益金鼎-松山,2024-11-29,9103
2524,京城,10,0,10,群益金鼎-松山,2024-11-29,9103
3078,僑威,10,0,10,群益金鼎-松山,2024-11-29,9103
3310,佳穎,10,0,10,群益金鼎-松山,2024-11-29,9103
2915,潤泰全,9,0,9,群益金鼎-松山,2024-11-29,9103
00692,富邦公司治理,6,0,6,群益金鼎-松山,2024-11-29,9103
1216,統一,6,0,6,群益金鼎-松山,2024-11-29,9103
1618,合機,6,0,6,群益金鼎-松山,2024-11-29,9103
00919,群益台灣精選高息,5,0,5,群益金鼎-松山,2024-11-29,9103
00937B,群益ESG投等債20,5,0,5,群益金鼎-松山,2024-11-29,9103
2867,三商壽,5,0,5,群益金鼎-松山,2024-11-29,9103
3022,威強電,5,0,5,群益金鼎-松山,2024-11-29,9103
8163,達方,5,0,5,群益金鼎-松山,2024-11-29,9103
3481,群創,5,1,4,群益金鼎-松山,2024-11-29,9103
00946,群益科技高息成長,4,0,4,群益金鼎-松山,2024-11-29,9103
1304,台聚,4,0,4,群益金鼎-松山,2024-11-29,9103
2495,普安,5,1,4,群益金鼎-松山,2024-11-29,9103
3032,偉訓,4,0,4,群益金鼎-松山,2024-11-29,9103
5871,中租-KY,3,0,3,群益金鼎-松山,2024-11-29,9103
0050,元大台灣50,3,0,3,群益金鼎-松山,2024-11-29,9103
00762,元大全球AI,3,0,3,群益金鼎-松山,2024-11-29,9103
1569,濱川,3,0,3,群益金鼎-松山,2024-11-29,9103
2402,毅嘉,3,0,3,群益金鼎-松山,2024-11-29,9103
2597,潤弘,3,0,3,群益金鼎-松山,2024-11-29,9103
2646,星宇航空,3,0,3,群益金鼎-松山,2024-11-29,9103
3706,神達,49,46,3,群益金鼎-松山,2024-11-29,9103
4571,鈞興-KY,3,0,3,群益金鼎-松山,2024-11-29,9103
8942,森鉅,3,0,3,群益金鼎-松山,2024-11-29,9103
1514,亞力,3,0,3,群益金鼎-松山,2024-11-29,9103
0056,元大高股息,2,0,2,群益金鼎-松山,2024-11-29,9103
2317,鴻海,7,5,2,群益金鼎-松山,2024-11-29,9103
2891,中信金,2,0,2,群益金鼎-松山,2024-11-29,9103
00713,元大台灣高息低波,2,0,2,群益金鼎-松山,2024-11-29,9103
00751B,元大AAA至A公司債,2,0,2,群益金鼎-松山,2024-11-29,9103
00675L,富邦臺灣加權正2,2,0,2,群益金鼎-松山,2024-11-29,9103
6770,力積電,102,12,90,群益金鼎-松山,2024-12-02,9103
5439,高技,90,10,80,群益金鼎-松山,2024-12-02,9103
2883,凱基金,100,30,70,群益金鼎-松山,2024-12-02,9103
2324,仁寶,78,10,68,群益金鼎-松山,2024-12-02,9103
3702A,大聯大甲特,62,0,62,群益金鼎-松山,2024-12-02,9103
00687B,國泰20年美債,50,4,46,群益金鼎-松山,2024-12-02,9103
00918,大華優利高填息30,44,0,44,群益金鼎-松山,2024-12-02,9103
2610,華航,40,5,35,群益金鼎-松山,2024-12-02,9103
1569,濱川,29,0,29,群益金鼎-松山,2024-12-02,9103
2312,金寶,22,0,22,群益金鼎-松山,2024-12-02,9103
6164,華興,22,0,22,群益金鼎-松山,2024-12-02,9103
2329,華泰,19,0,19,群益金鼎-松山,2024-12-02,9103
00950B,凱基A級公司債,20,2,18,群益金鼎-松山,2024-12-02,9103
00965,元大航太防衛科技,18,0,18,群益金鼎-松山,2024-12-02,9103
3706,神達,19,1,18,群益金鼎-松山,2024-12-02,9103
2345,智邦,36,20,16,群益金鼎-松山,2024-12-02,9103
1528,恩德,15,0,15,群益金鼎-松山,2024-12-02,9103
2369,菱生,15,0,15,群益金鼎-松山,2024-12-02,9103
2891,中信金,21,6,15,群益金鼎-松山,2024-12-02,9103
2241,艾姆勒,12,0,12,群益金鼎-松山,2024-12-02,9103
2464,盟立,13,1,12,群益金鼎-松山,2024-12-02,9103
3211,順達,16,4,12,群益金鼎-松山,2024-12-02,9103
6715,嘉基,12,0,12,群益金鼎-松山,2024-12-02,9103
4303,信立,15,4,11,群益金鼎-松山,2024-12-02,9103
2101,南港,10,0,10,群益金鼎-松山,2024-12-02,9103
2344,華邦電,10,0,10,群益金鼎-松山,2024-12-02,9103
5230,雷笛克光學,10,0,10,群益金鼎-松山,2024-12-02,9103
8085,福華,10,0,10,群益金鼎-松山,2024-12-02,9103
9105,泰金寶-DR,10,0,10,群益金鼎-松山,2024-12-02,9103
5351,鈺創,9,0,9,群益金鼎-松山,2024-12-02,9103
4523,永彰,8,0,8,群益金鼎-松山,2024-12-02,9103
5371,中光電,9,1,8,群益金鼎-松山,2024-12-02,9103
8112,至上,7,0,7,群益金鼎-松山,2024-12-02,9103
1605,華新,22,15,7,群益金鼎-松山,2024-12-02,9103
5309,系統電,8,1,7,群益金鼎-松山,2024-12-02,9103
6706,惠特,7,0,7,群益金鼎-松山,2024-12-02,9103
8033,雷虎,7,0,7,群益金鼎-松山,2024-12-02,9103
2885,元大金,8,1,7,群益金鼎-松山,2024-12-02,9103
020033,統一�琤肮黕篾,6,0,6,群益金鼎-松山,2024-12-02,9103
2062,橋椿,6,0,6,群益金鼎-松山,2024-12-02,9103
2388,威盛,6,0,6,群益金鼎-松山,2024-12-02,9103
3454,晶睿,6,0,6,群益金鼎-松山,2024-12-02,9103
3025,星通,13,7,6,群益金鼎-松山,2024-12-02,9103
2337,旺宏,5,0,5,群益金鼎-松山,2024-12-02,9103
3006,晶豪科,5,0,5,群益金鼎-松山,2024-12-02,9103
3036,文曄,5,0,5,群益金鼎-松山,2024-12-02,9103
5009,榮剛,5,0,5,群益金鼎-松山,2024-12-02,9103
8086,宏捷科,6,1,5,群益金鼎-松山,2024-12-02,9103
8374,羅昇,5,0,5,群益金鼎-松山,2024-12-02,9103
8054,安國,4,0,4,群益金鼎-松山,2024-12-02,9103
9105,泰金寶-DR,300,110,190,群益金鼎-松山,2024-12-03,9103
4906,正文,120,0,120,群益金鼎-松山,2024-12-03,9103
00687B,國泰20年美債,67,2,65,群益金鼎-松山,2024-12-03,9103
00919,群益台灣精選高息,57,2,55,群益金鼎-松山,2024-12-03,9103
3558,神準,46,3,43,群益金鼎-松山,2024-12-03,9103
2002,中鋼,40,0,40,群益金鼎-松山,2024-12-03,9103
2520,冠德,16,0,16,群益金鼎-松山,2024-12-03,9103
4979,華星光,45,29,16,群益金鼎-松山,2024-12-03,9103
2618,長榮航,51,36,15,群益金鼎-松山,2024-12-03,9103
00950B,凱基A級公司債,14,0,14,群益金鼎-松山,2024-12-03,9103
2382,廣達,13,0,13,群益金鼎-松山,2024-12-03,9103
3040,遠見,13,0,13,群益金鼎-松山,2024-12-03,9103
3231,緯創,11,0,11,群益金鼎-松山,2024-12-03,9103
1446,宏和,10,0,10,群益金鼎-松山,2024-12-03,9103
00650L,復華香港正2,10,0,10,群益金鼎-松山,2024-12-03,9103
00632R,元大台灣50反1,10,0,10,群益金鼎-松山,2024-12-03,9103
2376,技嘉,10,0,10,群益金鼎-松山,2024-12-03,9103
9945,潤泰新,10,0,10,群益金鼎-松山,2024-12-03,9103
6757,台灣虎航,9,0,9,群益金鼎-松山,2024-12-03,9103
6805,富世達,6,0,6,群益金鼎-松山,2024-12-03,9103
00900,富邦特選高股息30,6,0,6,群益金鼎-松山,2024-12-03,9103
3025,星通,8,2,6,群益金鼎-松山,2024-12-03,9103
2368,金像電,5,0,5,群益金鼎-松山,2024-12-03,9103
3702,大聯大,5,0,5,群益金鼎-松山,2024-12-03,9103
6205,詮欣,5,0,5,群益金鼎-松山,2024-12-03,9103
00713,元大台灣高息低波,4,0,4,群益金鼎-松山,2024-12-03,9103
2718,全心投控,4,0,4,群益金鼎-松山,2024-12-03,9103
6176,瑞儀,4,0,4,群益金鼎-松山,2024-12-03,9103
6443,元晶,4,0,4,群益金鼎-松山,2024-12-03,9103
00757,統一FANG+,3,0,3,群益金鼎-松山,2024-12-03,9103
1449,佳和,4,1,3,群益金鼎-松山,2024-12-03,9103
2020,美亞,3,0,3,群益金鼎-松山,2024-12-03,9103
2474,可成,3,0,3,群益金鼎-松山,2024-12-03,9103
2845,遠東銀,3,0,3,群益金鼎-松山,2024-12-03,9103
2887,台新金,3,0,3,群益金鼎-松山,2024-12-03,9103
3712,永崴投控,6,3,3,群益金鼎-松山,2024-12-03,9103
4542,科嶠,3,0,3,群益金鼎-松山,2024-12-03,9103
8299,群聯,2,0,2,群益金鼎-松山,2024-12-03,9103
00946,群益科技高息成長,2,0,2,群益金鼎-松山,2024-12-03,9103
00670L,富邦NASDAQ正2,2,0,2,群益金鼎-松山,2024-12-03,9103
00915,凱基優選高股息30,2,0,2,群益金鼎-松山,2024-12-03,9103
2006,東和鋼鐵,2,0,2,群益金鼎-松山,2024-12-03,9103
2324,仁寶,3,1,2,群益金鼎-松山,2024-12-03,9103
2348,海悅,2,0,2,群益金鼎-松山,2024-12-03,9103
2409,友達,2,0,2,群益金鼎-松山,2024-12-03,9103
2486,一詮,4,2,2,群益金鼎-松山,2024-12-03,9103
3624,光頡,2,0,2,群益金鼎-松山,2024-12-03,9103
3661,世芯-KY,2,0,2,群益金鼎-松山,2024-12-03,9103
3702A,大聯大甲特,2,0,2,群益金鼎-松山,2024-12-03,9103
5508,永信建,2,0,2,群益金鼎-松山,2024-12-03,9103
1815,富喬,162,20,142,群益金鼎-松山,2024-12-04,9103
00953B,群益優選非投等債,81,0,81,群益金鼎-松山,2024-12-04,9103
5439,高技,38,4,34,群益金鼎-松山,2024-12-04,9103
2426,鼎元,35,2,33,群益金鼎-松山,2024-12-04,9103
00830,國泰費城半導體,30,0,30,群益金鼎-松山,2024-12-04,9103
2615,萬海,30,0,30,群益金鼎-松山,2024-12-04,9103
8043,蜜望實,30,0,30,群益金鼎-松山,2024-12-04,9103
2542,興富發,31,2,29,群益金鼎-松山,2024-12-04,9103
4549,桓達,30,4,26,群益金鼎-松山,2024-12-04,9103
2610,華航,25,1,24,群益金鼎-松山,2024-12-04,9103
2375,凱美,34,12,22,群益金鼎-松山,2024-12-04,9103
3029,零壹,22,0,22,群益金鼎-松山,2024-12-04,9103
00950B,凱基A級公司債,21,0,21,群益金鼎-松山,2024-12-04,9103
00720B,元大投資級公司債,20,0,20,群益金鼎-松山,2024-12-04,9103
2392,正崴,20,0,20,群益金鼎-松山,2024-12-04,9103
3231,緯創,20,0,20,群益金鼎-松山,2024-12-04,9103
4510,高鋒,20,0,20,群益金鼎-松山,2024-12-04,9103
5309,系統電,46,26,20,群益金鼎-松山,2024-12-04,9103
2646,星宇航空,20,2,18,群益金鼎-松山,2024-12-04,9103
00918,大華優利高填息30,18,0,18,群益金鼎-松山,2024-12-04,9103
2887,台新金,16,0,16,群益金鼎-松山,2024-12-04,9103
00679B,元大美債20年,15,0,15,群益金鼎-松山,2024-12-04,9103
1605,華新,13,0,13,群益金鼎-松山,2024-12-04,9103
1808,潤隆,13,0,13,群益金鼎-松山,2024-12-04,9103
5871,中租-KY,12,0,12,群益金鼎-松山,2024-12-04,9103
2363,矽統,12,0,12,群益金鼎-松山,2024-12-04,9103
00670L,富邦NASDAQ正2,10,0,10,群益金鼎-松山,2024-12-04,9103
3025,星通,16,6,10,群益金鼎-松山,2024-12-04,9103
00687B,國泰20年美債,11,2,9,群益金鼎-松山,2024-12-04,9103
2472,立隆電,9,0,9,群益金鼎-松山,2024-12-04,9103
4562,穎漢,19,10,9,群益金鼎-松山,2024-12-04,9103
6732,昇佳電子,9,0,9,群益金鼎-松山,2024-12-04,9103
3702A,大聯大甲特,8,0,8,群益金鼎-松山,2024-12-04,9103
1314,中石化,7,0,7,群益金鼎-松山,2024-12-04,9103
2449,京元電子,6,0,6,群益金鼎-松山,2024-12-04,9103
3040,遠見,8,2,6,群益金鼎-松山,2024-12-04,9103
3511,矽瑪,6,0,6,群益金鼎-松山,2024-12-04,9103
2891,中信金,6,1,5,群益金鼎-松山,2024-12-04,9103
5347,世界,5,0,5,群益金鼎-松山,2024-12-04,9103
6862,三集瑞-KY,5,0,5,群益金鼎-松山,2024-12-04,9103
8111,立��,5,0,5,群益金鼎-松山,2024-12-04,9103
00712,復華富時不動產,4,0,4,群益金鼎-松山,2024-12-04,9103
2368,金像電,4,0,4,群益金鼎-松山,2024-12-04,9103
2429,銘旺科,4,0,4,群益金鼎-松山,2024-12-04,9103
2540,愛山林,4,0,4,群益金鼎-松山,2024-12-04,9103
2545,皇翔,4,0,4,群益金鼎-松山,2024-12-04,9103
4958,臻鼎-KY,4,0,4,群益金鼎-松山,2024-12-04,9103
5244,弘凱,6,2,4,群益金鼎-松山,2024-12-04,9103
6789,采鈺,5,1,4,群益金鼎-松山,2024-12-04,9103
2020,美亞,3,0,3,群益金鼎-松山,2024-12-04,9103
00918,大華優利高填息30,300,0,300,群益金鼎-松山,2024-12-05,9103
3481,群創,200,100,100,群益金鼎-松山,2024-12-05,9103
2354,鴻準,140,47,93,群益金鼎-松山,2024-12-05,9103
00919,群益台灣精選高息,105,15,90,群益金鼎-松山,2024-12-05,9103
4908,前鼎,95,7,88,群益金鼎-松山,2024-12-05,9103
00650L,復華香港正2,40,0,40,群益金鼎-松山,2024-12-05,9103
1785,光洋科,30,0,30,群益金鼎-松山,2024-12-05,9103
2542,興富發,30,3,27,群益金鼎-松山,2024-12-05,9103
2317,鴻海,26,1,25,群益金鼎-松山,2024-12-05,9103
3289,宜特,25,1,24,群益金鼎-松山,2024-12-05,9103
2615,萬海,21,0,21,群益金鼎-松山,2024-12-05,9103
2845,遠東銀,21,0,21,群益金鼎-松山,2024-12-05,9103
6127,九豪,21,0,21,群益金鼎-松山,2024-12-05,9103
3029,零壹,20,0,20,群益金鼎-松山,2024-12-05,9103
00637L,元大滬深300正2,15,0,15,群益金鼎-松山,2024-12-05,9103
3702,大聯大,15,0,15,群益金鼎-松山,2024-12-05,9103
2399,映泰,14,1,13,群益金鼎-松山,2024-12-05,9103
00946,群益科技高息成長,12,0,12,群益金鼎-松山,2024-12-05,9103
2313,華通,12,0,12,群益金鼎-松山,2024-12-05,9103
3032,偉訓,12,0,12,群益金鼎-松山,2024-12-05,9103
2374,佳能,11,0,11,群益金鼎-松山,2024-12-05,9103
3043,科風,11,0,11,群益金鼎-松山,2024-12-05,9103
1446,宏和,10,0,10,群益金鼎-松山,2024-12-05,9103
3025,星通,13,3,10,群益金鼎-松山,2024-12-05,9103
3041,揚智,10,0,10,群益金鼎-松山,2024-12-05,9103
2324,仁寶,9,0,9,群益金鼎-松山,2024-12-05,9103
2603,長榮,10,1,9,群益金鼎-松山,2024-12-05,9103
2887,台新金,9,0,9,群益金鼎-松山,2024-12-05,9103
3090,日電貿,10,2,8,群益金鼎-松山,2024-12-05,9103
3323,加百裕,10,2,8,群益金鼎-松山,2024-12-05,9103
6895,宏碩系統,8,0,8,群益金鼎-松山,2024-12-05,9103
00631L,元大台灣50正2,6,0,6,群益金鼎-松山,2024-12-05,9103
2204,中華,6,0,6,群益金鼎-松山,2024-12-05,9103
3078,僑威,6,0,6,群益金鼎-松山,2024-12-05,9103
4123,晟德,13,7,6,群益金鼎-松山,2024-12-05,9103
5269,祥碩,6,0,6,群益金鼎-松山,2024-12-05,9103
1806,冠軍,5,0,5,群益金鼎-松山,2024-12-05,9103
00878,國泰永續高股息,5,0,5,群益金鼎-松山,2024-12-05,9103
2303,聯電,7,2,5,群益金鼎-松山,2024-12-05,9103
2485,兆赫,10,5,5,群益金鼎-松山,2024-12-05,9103
6235,華孚,5,0,5,群益金鼎-松山,2024-12-05,9103
6913,鴻呈,5,0,5,群益金鼎-松山,2024-12-05,9103
1304,台聚,4,0,4,群益金鼎-松山,2024-12-05,9103
2376,技嘉,5,1,4,群益金鼎-松山,2024-12-05,9103
3163,波若威,11,7,4,群益金鼎-松山,2024-12-05,9103
3211,順達,28,24,4,群益金鼎-松山,2024-12-05,9103
4927,泰鼎-KY,4,0,4,群益金鼎-松山,2024-12-05,9103
6770,力積電,4,0,4,群益金鼎-松山,2024-12-05,9103
5328,華容,5,1,4,群益金鼎-松山,2024-12-05,9103
1513,中興電,3,0,3,群益金鼎-松山,2024-12-05,9103
2409,友達,300,100,200,群益金鼎-松山,2024-12-06,9103
9105,泰金寶-DR,205,101,104,群益金鼎-松山,2024-12-06,9103
2883,凱基金,100,9,91,群益金鼎-松山,2024-12-06,9103
3706,神達,110,44,66,群益金鼎-松山,2024-12-06,9103
2354,鴻準,64,11,53,群益金鼎-松山,2024-12-06,9103
1785,光洋科,31,0,31,群益金鼎-松山,2024-12-06,9103
8261,富鼎,31,0,31,群益金鼎-松山,2024-12-06,9103
1532,勤美,30,0,30,群益金鼎-松山,2024-12-06,9103
5284,jpp-KY,30,0,30,群益金鼎-松山,2024-12-06,9103
1815,富喬,49,20,29,群益金鼎-松山,2024-12-06,9103
6426,統新,22,1,21,群益金鼎-松山,2024-12-06,9103
00918,大華優利高填息30,20,0,20,群益金鼎-松山,2024-12-06,9103
00670L,富邦NASDAQ正2,20,0,20,群益金鼎-松山,2024-12-06,9103
00639,富邦深100,20,0,20,群益金鼎-松山,2024-12-06,9103
00953B,群益優選非投等債,20,0,20,群益金鼎-松山,2024-12-06,9103
5457,宣德,21,1,20,群益金鼎-松山,2024-12-06,9103
3702A,大聯大甲特,15,0,15,群益金鼎-松山,2024-12-06,9103
2375,凱美,25,13,12,群益金鼎-松山,2024-12-06,9103
6937,天虹,12,1,11,群益金鼎-松山,2024-12-06,9103
00909,國泰數位支付服務,20,10,10,群益金鼎-松山,2024-12-06,9103
006206,元大上證50,10,0,10,群益金鼎-松山,2024-12-06,9103
2915,潤泰全,10,0,10,群益金鼎-松山,2024-12-06,9103
5522,遠雄,10,0,10,群益金鼎-松山,2024-12-06,9103
6288,聯嘉,10,0,10,群益金鼎-松山,2024-12-06,9103
8064,東捷,15,5,10,群益金鼎-松山,2024-12-06,9103
4755,三福化,10,1,9,群益金鼎-松山,2024-12-06,9103
2337,旺宏,11,2,9,群益金鼎-松山,2024-12-06,9103
2367,燿華,7,0,7,群益金鼎-松山,2024-12-06,9103
2371,大同,7,0,7,群益金鼎-松山,2024-12-06,9103
3025,星通,10,3,7,群益金鼎-松山,2024-12-06,9103
2597,潤弘,6,0,6,群益金鼎-松山,2024-12-06,9103
3231,緯創,13,7,6,群益金鼎-松山,2024-12-06,9103
3689,湧德,9,3,6,群益金鼎-松山,2024-12-06,9103
3466,德晉,5,0,5,群益金鼎-松山,2024-12-06,9103
4552,力達-KY,5,0,5,群益金鼎-松山,2024-12-06,9103
4721,美琪瑪,5,0,5,群益金鼎-松山,2024-12-06,9103
4919,新唐,10,5,5,群益金鼎-松山,2024-12-06,9103
00631L,元大台灣50正2,5,1,4,群益金鼎-松山,2024-12-06,9103
3032,偉訓,5,1,4,群益金鼎-松山,2024-12-06,9103
3265,台星科,5,1,4,群益金鼎-松山,2024-12-06,9103
6186,新潤,4,0,4,群益金鼎-松山,2024-12-06,9103
1436,華友聯,5,2,3,群益金鼎-松山,2024-12-06,9103
1449,佳和,9,6,3,群益金鼎-松山,2024-12-06,9103
2385,群光,3,0,3,群益金鼎-松山,2024-12-06,9103
2405,輔信,10,7,3,群益金鼎-松山,2024-12-06,9103
2439,美律,3,0,3,群益金鼎-松山,2024-12-06,9103
3010,華立,3,0,3,群益金鼎-松山,2024-12-06,9103
3290,東浦,3,0,3,群益金鼎-松山,2024-12-06,9103
3548,兆利,3,0,3,群益金鼎-松山,2024-12-06,9103
3450,聯鈞,6,3,3,群益金鼎-松山,2024-12-06,9103
2883,凱基金,202,0,202,群益金鼎-松山,2024-12-09,9103
00885,富邦越南,100,0,100,群益金鼎-松山,2024-12-09,9103
2324,仁寶,149,62,87,群益金鼎-松山,2024-12-09,9103
1785,光洋科,83,0,83,群益金鼎-松山,2024-12-09,9103
00968B,元大優息投等債,33,0,33,群益金鼎-松山,2024-12-09,9103
2605,新興,78,48,30,群益金鼎-松山,2024-12-09,9103
4968,立積,32,3,29,群益金鼎-松山,2024-12-09,9103
2337,旺宏,27,0,27,群益金鼎-松山,2024-12-09,9103
2367,燿華,24,0,24,群益金鼎-松山,2024-12-09,9103
6202,盛群,22,0,22,群益金鼎-松山,2024-12-09,9103
00830,國泰費城半導體,20,0,20,群益金鼎-松山,2024-12-09,9103
00637L,元大滬深300正2,25,5,20,群益金鼎-松山,2024-12-09,9103
5481,新華,20,0,20,群益金鼎-松山,2024-12-09,9103
8261,富鼎,22,2,20,群益金鼎-松山,2024-12-09,9103
6937,天虹,18,0,18,群益金鼎-松山,2024-12-09,9103
2383,台光電,18,1,17,群益金鼎-松山,2024-12-09,9103
00878,國泰永續高股息,15,0,15,群益金鼎-松山,2024-12-09,9103
2002,中鋼,14,0,14,群益金鼎-松山,2024-12-09,9103
1464,得力,10,0,10,群益金鼎-松山,2024-12-09,9103
2537,聯上發,10,0,10,群益金鼎-松山,2024-12-09,9103
2545,皇翔,10,0,10,群益金鼎-松山,2024-12-09,9103
2887,台新金,10,0,10,群益金鼎-松山,2024-12-09,9103
2915,潤泰全,10,0,10,群益金鼎-松山,2024-12-09,9103
3437,榮創,10,0,10,群益金鼎-松山,2024-12-09,9103
3694,海華,10,0,10,群益金鼎-松山,2024-12-09,9103
6962,ITH-KY,10,0,10,群益金鼎-松山,2024-12-09,9103
006208,富邦台50,9,0,9,群益金鼎-松山,2024-12-09,9103
6451,訊芯-KY,10,1,9,群益金鼎-松山,2024-12-09,9103
00737,國泰AI+Robo,8,0,8,群益金鼎-松山,2024-12-09,9103
3024,憶聲,8,0,8,群益金鼎-松山,2024-12-09,9103
2317,鴻海,10,2,8,群益金鼎-松山,2024-12-09,9103
2891,中信金,7,0,7,群益金鼎-松山,2024-12-09,9103
4721,美琪瑪,7,0,7,群益金鼎-松山,2024-12-09,9103
2617,台航,6,0,6,群益金鼎-松山,2024-12-09,9103
6442,光聖,7,1,6,群益金鼎-松山,2024-12-09,9103
0055,元大MSCI金融,5,0,5,群益金鼎-松山,2024-12-09,9103
1513,中興電,5,0,5,群益金鼎-松山,2024-12-09,9103
1732,毛寶,5,0,5,群益金鼎-松山,2024-12-09,9103
2348,海悅,5,0,5,群益金鼎-松山,2024-12-09,9103
2357,華碩,5,0,5,群益金鼎-松山,2024-12-09,9103
2481,強茂,5,0,5,群益金鼎-松山,2024-12-09,9103
3032,偉訓,24,19,5,群益金鼎-松山,2024-12-09,9103
3260,威剛,5,0,5,群益金鼎-松山,2024-12-09,9103
3702A,大聯大甲特,11,6,5,群益金鼎-松山,2024-12-09,9103
6138,茂達,5,0,5,群益金鼎-松山,2024-12-09,9103
6209,今國光,5,0,5,群益金鼎-松山,2024-12-09,9103
6243,迅杰,5,0,5,群益金鼎-松山,2024-12-09,9103
2399,映泰,5,1,4,群益金鼎-松山,2024-12-09,9103
2603,長榮,31,27,4,群益金鼎-松山,2024-12-09,9103
2801,彰銀,4,0,4,群益金鼎-松山,2024-12-09,9103
6015,宏遠證,234,0,234,群益金鼎-松山,2024-12-10,9103
00968B,元大優息投等債,106,0,106,群益金鼎-松山,2024-12-10,9103
00650L,復華香港正2,30,0,30,群益金鼎-松山,2024-12-10,9103
2349,錸德,60,30,30,群益金鼎-松山,2024-12-10,9103
2615,萬海,30,0,30,群益金鼎-松山,2024-12-10,9103
1605,華新,25,5,20,群益金鼎-松山,2024-12-10,9103
2646,星宇航空,20,0,20,群益金鼎-松山,2024-12-10,9103
8261,富鼎,20,0,20,群益金鼎-松山,2024-12-10,9103
2317,鴻海,16,0,16,群益金鼎-松山,2024-12-10,9103
3260,威剛,15,0,15,群益金鼎-松山,2024-12-10,9103
1301,台塑,12,0,12,群益金鼎-松山,2024-12-10,9103
6442,光聖,13,2,11,群益金鼎-松山,2024-12-10,9103
4909,新復興,11,0,11,群益金鼎-松山,2024-12-10,9103
00909,國泰數位支付服務,10,0,10,群益金鼎-松山,2024-12-10,9103
1326,台化,10,0,10,群益金鼎-松山,2024-12-10,9103
00915,凱基優選高股息30,10,0,10,群益金鼎-松山,2024-12-10,9103
2329,華泰,10,0,10,群益金鼎-松山,2024-12-10,9103
0056,元大高股息,9,0,9,群益金鼎-松山,2024-12-10,9103
2888,新光金,9,0,9,群益金鼎-松山,2024-12-10,9103
8096,擎亞,9,0,9,群益金鼎-松山,2024-12-10,9103
2801,彰銀,8,0,8,群益金鼎-松山,2024-12-10,9103
3305,昇貿,8,0,8,群益金鼎-松山,2024-12-10,9103
3211,順達,15,8,7,群益金鼎-松山,2024-12-10,9103
2337,旺宏,16,10,6,群益金鼎-松山,2024-12-10,9103
2399,映泰,6,0,6,群益金鼎-松山,2024-12-10,9103
6215,和椿,6,0,6,群益金鼎-松山,2024-12-10,9103
6695,芯鼎,6,0,6,群益金鼎-松山,2024-12-10,9103
1446,宏和,5,0,5,群益金鼎-松山,2024-12-10,9103
00937B,群益ESG投等債20,5,0,5,群益金鼎-松山,2024-12-10,9103
00645,富邦日本,5,0,5,群益金鼎-松山,2024-12-10,9103
2915,潤泰全,5,0,5,群益金鼎-松山,2024-12-10,9103
3055,蔚華科,5,0,5,群益金鼎-松山,2024-12-10,9103
3289,宜特,5,0,5,群益金鼎-松山,2024-12-10,9103
4966,譜瑞-KY,5,0,5,群益金鼎-松山,2024-12-10,9103
6288,聯嘉,5,0,5,群益金鼎-松山,2024-12-10,9103
00631L,元大台灣50正2,6,1,5,群益金鼎-松山,2024-12-10,9103
1449,佳和,8,4,4,群益金鼎-松山,2024-12-10,9103
00950B,凱基A級公司債,4,0,4,群益金鼎-松山,2024-12-10,9103
2328,廣宇,6,2,4,群益金鼎-松山,2024-12-10,9103
2355,敬鵬,3,0,3,群益金鼎-松山,2024-12-10,9103
2520,冠德,3,0,3,群益金鼎-松山,2024-12-10,9103
2618,長榮航,3,0,3,群益金鼎-松山,2024-12-10,9103
3705,永信,3,0,3,群益金鼎-松山,2024-12-10,9103
4536,拓凱,3,0,3,群益金鼎-松山,2024-12-10,9103
5392,能率,3,0,3,群益金鼎-松山,2024-12-10,9103
8942,森鉅,3,0,3,群益金鼎-松山,2024-12-10,9103
3029,零壹,9,6,3,群益金鼎-松山,2024-12-10,9103
6206,飛捷,3,0,3,群益金鼎-松山,2024-12-10,9103
00918,大華優利高填息30,2,0,2,群益金鼎-松山,2024-12-10,9103
00662,富邦NASDAQ,2,0,2,群益金鼎-松山,2024-12-10,9103
9105,泰金寶-DR,200,101,99,群益金鼎-松山,2024-12-11,9103
2313,華通,97,7,90,群益金鼎-松山,2024-12-11,9103
6015,宏遠證,56,0,56,群益金鼎-松山,2024-12-11,9103
1301,台塑,50,0,50,群益金鼎-松山,2024-12-11,9103
8111,立��,57,11,46,群益金鼎-松山,2024-12-11,9103
4991,環宇-KY,45,0,45,群益金鼎-松山,2024-12-11,9103
2368,金像電,42,2,40,群益金鼎-松山,2024-12-11,9103
6442,光聖,36,3,33,群益金鼎-松山,2024-12-11,9103
2344,華邦電,34,11,23,群益金鼎-松山,2024-12-11,9103
1815,富喬,41,20,21,群益金鼎-松山,2024-12-11,9103
1717,長興,20,0,20,群益金鼎-松山,2024-12-11,9103
4510,高鋒,20,0,20,群益金鼎-松山,2024-12-11,9103
6220,岳豐,20,0,20,群益金鼎-松山,2024-12-11,9103
2609,陽明,22,10,12,群益金鼎-松山,2024-12-11,9103
4931,新盛力,32,20,12,群益金鼎-松山,2024-12-11,9103
3260,威剛,12,0,12,群益金鼎-松山,2024-12-11,9103
00919,群益台灣精選高息,11,0,11,群益金鼎-松山,2024-12-11,9103
00918,大華優利高填息30,11,0,11,群益金鼎-松山,2024-12-11,9103
1808,潤隆,11,0,11,群益金鼎-松山,2024-12-11,9103
00929,復華台灣科技優息,12,2,10,群益金鼎-松山,2024-12-11,9103
00953B,群益優選非投等債,10,0,10,群益金鼎-松山,2024-12-11,9103
2915,潤泰全,10,0,10,群益金鼎-松山,2024-12-11,9103
4562,穎漢,11,1,10,群益金鼎-松山,2024-12-11,9103
6770,力積電,10,0,10,群益金鼎-松山,2024-12-11,9103
00687B,國泰20年美債,10,1,9,群益金鼎-松山,2024-12-11,9103
2317,鴻海,11,2,9,群益金鼎-松山,2024-12-11,9103
1609,大亞,8,0,8,群益金鼎-松山,2024-12-11,9103
2204,中華,8,0,8,群益金鼎-松山,2024-12-11,9103
2897,王道銀行,8,0,8,群益金鼎-松山,2024-12-11,9103
6456,GIS-KY,8,0,8,群益金鼎-松山,2024-12-11,9103
2382,廣達,18,10,8,群益金鼎-松山,2024-12-11,9103
3594,磐儀,9,2,7,群益金鼎-松山,2024-12-11,9103
1326,台化,6,0,6,群益金鼎-松山,2024-12-11,9103
3712,永崴投控,6,0,6,群益金鼎-松山,2024-12-11,9103
2891,中信金,6,0,6,群益金鼎-松山,2024-12-11,9103
00878,國泰永續高股息,5,0,5,群益金鼎-松山,2024-12-11,9103
00887,永豐中國科技50大,5,0,5,群益金鼎-松山,2024-12-11,9103
00688L,國泰20年美債正2,5,0,5,群益金鼎-松山,2024-12-11,9103
020033,統一�琤肮黕篾,5,0,5,群益金鼎-松山,2024-12-11,9103
1446,宏和,5,0,5,群益金鼎-松山,2024-12-11,9103
3296,勝德,5,0,5,群益金鼎-松山,2024-12-11,9103
2412,中華電,4,0,4,群益金鼎-松山,2024-12-11,9103
2801,彰銀,4,0,4,群益金鼎-松山,2024-12-11,9103
4721,美琪瑪,4,0,4,群益金鼎-松山,2024-12-11,9103
8054,安國,6,2,4,群益金鼎-松山,2024-12-11,9103
8249,菱光,5,1,4,群益金鼎-松山,2024-12-11,9103
1519,華城,3,0,3,群益金鼎-松山,2024-12-11,9103
1402,遠東新,3,0,3,群益金鼎-松山,2024-12-11,9103
00968B,元大優息投等債,3,0,3,群益金鼎-松山,2024-12-11,9103
00922,國泰台灣領袖50,3,0,3,群益金鼎-松山,2024-12-11,9103
6015,宏遠證,110,0,110,群益金鼎-松山,2024-12-12,9103
4426,利勤,92,0,92,群益金鼎-松山,2024-12-12,9103
1108,幸福,85,0,85,群益金鼎-松山,2024-12-12,9103
3706,神達,88,14,74,群益金鼎-松山,2024-12-12,9103
1444,力麗,64,0,64,群益金鼎-松山,2024-12-12,9103
00687B,國泰20年美債,63,0,63,群益金鼎-松山,2024-12-12,9103
3164,景岳,45,0,45,群益金鼎-松山,2024-12-12,9103
1522,堤維西,45,1,44,群益金鼎-松山,2024-12-12,9103
1451,年興,43,0,43,群益金鼎-松山,2024-12-12,9103
1468,昶和,41,0,41,群益金鼎-松山,2024-12-12,9103
1219,福壽,40,0,40,群益金鼎-松山,2024-12-12,9103
1454,台富,38,0,38,群益金鼎-松山,2024-12-12,9103
1109,信大,36,0,36,群益金鼎-松山,2024-12-12,9103
1324,地球,35,0,35,群益金鼎-松山,2024-12-12,9103
3357,臺慶科,42,7,35,群益金鼎-松山,2024-12-12,9103
1201,味全,33,0,33,群益金鼎-松山,2024-12-12,9103
2616,山隆,32,0,32,群益金鼎-松山,2024-12-12,9103
1434,福懋,31,0,31,群益金鼎-松山,2024-12-12,9103
1465,偉全,31,0,31,群益金鼎-松山,2024-12-12,9103
2483,百容,28,0,28,群益金鼎-松山,2024-12-12,9103
6164,華興,28,0,28,群益金鼎-松山,2024-12-12,9103
1301,台塑,25,0,25,群益金鼎-松山,2024-12-12,9103
8072,陞泰,25,0,25,群益金鼎-松山,2024-12-12,9103
2029,盛餘,22,0,22,群益金鼎-松山,2024-12-12,9103
1236,宏亞,21,0,21,群益金鼎-松山,2024-12-12,9103
2365,昆盈,30,10,20,群益金鼎-松山,2024-12-12,9103
00679B,元大美債20年,19,0,19,群益金鼎-松山,2024-12-12,9103
1521,大億,19,0,19,群益金鼎-松山,2024-12-12,9103
1437,勤益控,18,0,18,群益金鼎-松山,2024-12-12,9103
2467,志聖,20,2,18,群益金鼎-松山,2024-12-12,9103
00918,大華優利高填息30,17,0,17,群益金鼎-松山,2024-12-12,9103
4999,鑫禾,17,0,17,群益金鼎-松山,2024-12-12,9103
2904,匯僑,16,0,16,群益金鼎-松山,2024-12-12,9103
3311,閎暉,16,0,16,群益金鼎-松山,2024-12-12,9103
4106,雃博,16,0,16,群益金鼎-松山,2024-12-12,9103
1323,永裕,15,0,15,群益金鼎-松山,2024-12-12,9103
2417,圓剛,19,4,15,群益金鼎-松山,2024-12-12,9103
6186,新潤,15,0,15,群益金鼎-松山,2024-12-12,9103
2615,萬海,22,10,12,群益金鼎-松山,2024-12-12,9103
2344,華邦電,21,10,11,群益金鼎-松山,2024-12-12,9103
2603,長榮,11,0,11,群益金鼎-松山,2024-12-12,9103
00700,富邦�琤肭磪�,10,0,10,群益金鼎-松山,2024-12-12,9103
1460,宏遠,10,0,10,群益金鼎-松山,2024-12-12,9103
2258,鴻華先進-創,10,0,10,群益金鼎-松山,2024-12-12,9103
2471,資通,43,33,10,群益金鼎-松山,2024-12-12,9103
2897,王道銀行,10,0,10,群益金鼎-松山,2024-12-12,9103
4534,慶騰,10,0,10,群益金鼎-松山,2024-12-12,9103
6112,邁達特,10,0,10,群益金鼎-松山,2024-12-12,9103
2317,鴻海,9,0,9,群益金鼎-松山,2024-12-12,9103
2945,三商家購,9,0,9,群益金鼎-松山,2024-12-12,9103
9105,泰金寶-DR,102,0,102,群益金鼎-松山,2024-12-13,9103
6015,宏遠證,100,0,100,群益金鼎-松山,2024-12-13,9103
1460,宏遠,86,0,86,群益金鼎-松山,2024-12-13,9103
1324,地球,80,0,80,群益金鼎-松山,2024-12-13,9103
3357,臺慶科,78,4,74,群益金鼎-松山,2024-12-13,9103
1459,聯發,63,0,63,群益金鼎-松山,2024-12-13,9103
3706,神達,94,44,50,群益金鼎-松山,2024-12-13,9103
6558,興能高,52,2,50,群益金鼎-松山,2024-12-13,9103
4931,新盛力,44,3,41,群益金鼎-松山,2024-12-13,9103
4106,雃博,36,4,32,群益金鼎-松山,2024-12-13,9103
6136,富爾特,28,0,28,群益金鼎-松山,2024-12-13,9103
1506,正道,27,0,27,群益金鼎-松山,2024-12-13,9103
2901,欣欣,23,0,23,群益金鼎-松山,2024-12-13,9103
00919,群益台灣精選高息,23,1,22,群益金鼎-松山,2024-12-13,9103
00929,復華台灣科技優息,21,0,21,群益金鼎-松山,2024-12-13,9103
2897,王道銀行,20,0,20,群益金鼎-松山,2024-12-13,9103
4534,慶騰,30,10,20,群益金鼎-松山,2024-12-13,9103
3029,零壹,23,3,20,群益金鼎-松山,2024-12-13,9103
00687B,國泰20年美債,17,0,17,群益金鼎-松山,2024-12-13,9103
00637L,元大滬深300正2,16,0,16,群益金鼎-松山,2024-12-13,9103
2317,鴻海,16,0,16,群益金鼎-松山,2024-12-13,9103
00937B,群益ESG投等債20,15,0,15,群益金鼎-松山,2024-12-13,9103
4426,利勤,15,0,15,群益金鼎-松山,2024-12-13,9103
00878,國泰永續高股息,14,0,14,群益金鼎-松山,2024-12-13,9103
1108,幸福,14,0,14,群益金鼎-松山,2024-12-13,9103
1452,宏益,14,0,14,群益金鼎-松山,2024-12-13,9103
2467,志聖,15,1,14,群益金鼎-松山,2024-12-13,9103
1234,黑松,13,0,13,群益金鼎-松山,2024-12-13,9103
5522,遠雄,15,2,13,群益金鼎-松山,2024-12-13,9103
2430,燦坤,12,0,12,群益金鼎-松山,2024-12-13,9103
6184,大豐電,12,0,12,群益金鼎-松山,2024-12-13,9103
00918,大華優利高填息30,11,0,11,群益金鼎-松山,2024-12-13,9103
1444,力麗,11,0,11,群益金鼎-松山,2024-12-13,9103
1583,程泰,11,0,11,群益金鼎-松山,2024-12-13,9103
2324,仁寶,21,10,11,群益金鼎-松山,2024-12-13,9103
4974,亞泰,11,0,11,群益金鼎-松山,2024-12-13,9103
4979,華星光,12,1,11,群益金鼎-松山,2024-12-13,9103
6128,上福,11,0,11,群益金鼎-松山,2024-12-13,9103
2471,資通,12,2,10,群益金鼎-松山,2024-12-13,9103
2486,一詮,10,0,10,群益金鼎-松山,2024-12-13,9103
6488,環球晶,10,0,10,群益金鼎-松山,2024-12-13,9103
1605,華新,14,5,9,群益金鼎-松山,2024-12-13,9103
1808,潤隆,9,0,9,群益金鼎-松山,2024-12-13,9103
1236,宏亞,8,0,8,群益金鼎-松山,2024-12-13,9103
2542,興富發,8,0,8,群益金鼎-松山,2024-12-13,9103
1451,年興,7,0,7,群益金鼎-松山,2024-12-13,9103
1465,偉全,7,0,7,群益金鼎-松山,2024-12-13,9103
1468,昶和,7,0,7,群益金鼎-松山,2024-12-13,9103
1525,江申,7,0,7,群益金鼎-松山,2024-12-13,9103
2029,盛餘,7,0,7,群益金鼎-松山,2024-12-13,9103
6015,宏遠證,965,0,965,群益金鼎-松山,2024-12-16,9103
5481,新華,74,2,72,群益金鼎-松山,2024-12-16,9103
5439,高技,74,4,70,群益金鼎-松山,2024-12-16,9103
00679B,元大美債20年,63,0,63,群益金鼎-松山,2024-12-16,9103
6164,華興,50,0,50,群益金鼎-松山,2024-12-16,9103
6770,力積電,51,1,50,群益金鼎-松山,2024-12-16,9103
00959B,大華投等美債15Y+,44,0,44,群益金鼎-松山,2024-12-16,9103
2455,全新,43,10,33,群益金鼎-松山,2024-12-16,9103
2609,陽明,30,3,27,群益金鼎-松山,2024-12-16,9103
00637L,元大滬深300正2,26,5,21,群益金鼎-松山,2024-12-16,9103
2883B,凱基金乙特,20,0,20,群益金鼎-松山,2024-12-16,9103
3357,臺慶科,21,1,20,群益金鼎-松山,2024-12-16,9103
2615,萬海,15,0,15,群益金鼎-松山,2024-12-16,9103
3484,崧騰,19,4,15,群益金鼎-松山,2024-12-16,9103
00687B,國泰20年美債,14,0,14,群益金鼎-松山,2024-12-16,9103
3032,偉訓,26,12,14,群益金鼎-松山,2024-12-16,9103
2363,矽統,11,0,11,群益金鼎-松山,2024-12-16,9103
00937B,群益ESG投等債20,10,0,10,群益金鼎-松山,2024-12-16,9103
1459,聯發,10,0,10,群益金鼎-松山,2024-12-16,9103
2425,承啟,10,0,10,群益金鼎-松山,2024-12-16,9103
6244,茂迪,10,0,10,群益金鼎-松山,2024-12-16,9103
6829,千附精密,10,0,10,群益金鼎-松山,2024-12-16,9103
2454,聯發科,11,1,10,群益金鼎-松山,2024-12-16,9103
3164,景岳,9,0,9,群益金鼎-松山,2024-12-16,9103
2317,鴻海,30,22,8,群益金鼎-松山,2024-12-16,9103
3081,聯亞,8,1,7,群益金鼎-松山,2024-12-16,9103
6548,長科*,7,0,7,群益金鼎-松山,2024-12-16,9103
1465,偉全,6,0,6,群益金鼎-松山,2024-12-16,9103
1506,正道,6,0,6,群益金鼎-松山,2024-12-16,9103
2345,智邦,7,1,6,群益金鼎-松山,2024-12-16,9103
2379,瑞昱,6,0,6,群益金鼎-松山,2024-12-16,9103
2431,聯昌,6,0,6,群益金鼎-松山,2024-12-16,9103
6136,富爾特,6,0,6,群益金鼎-松山,2024-12-16,9103
1451,年興,5,0,5,群益金鼎-松山,2024-12-16,9103
1236,宏亞,5,0,5,群益金鼎-松山,2024-12-16,9103
1906,寶隆,5,0,5,群益金鼎-松山,2024-12-16,9103
2483,百容,5,0,5,群益金鼎-松山,2024-12-16,9103
2616,山隆,5,0,5,群益金鼎-松山,2024-12-16,9103
2901,欣欣,5,0,5,群益金鼎-松山,2024-12-16,9103
00878,國泰永續高股息,4,0,4,群益金鼎-松山,2024-12-16,9103
2382,廣達,14,10,4,群益金鼎-松山,2024-12-16,9103
0056,元大高股息,4,0,4,群益金鼎-松山,2024-12-16,9103
00929,復華台灣科技優息,4,0,4,群益金鼎-松山,2024-12-16,9103
00940,元大台灣價值高息,4,0,4,群益金鼎-松山,2024-12-16,9103
1301,台塑,18,14,4,群益金鼎-松山,2024-12-16,9103
2904,匯僑,4,0,4,群益金鼎-松山,2024-12-16,9103
3042,晶技,4,0,4,群益金鼎-松山,2024-12-16,9103
4979,華星光,7,3,4,群益金鼎-松山,2024-12-16,9103
8054,安國,5,1,4,群益金鼎-松山,2024-12-16,9103
3017,奇鋐,4,1,3,群益金鼎-松山,2024-12-16,9103
6015,宏遠證,178,0,178,群益金鼎-松山,2024-12-17,9103
00905,FT臺灣Smart,158,0,158,群益金鼎-松山,2024-12-17,9103
2883,凱基金,101,0,101,群益金鼎-松山,2024-12-17,9103
2409,友達,100,0,100,群益金鼎-松山,2024-12-17,9103
3041,揚智,60,6,54,群益金鼎-松山,2024-12-17,9103
2882,國泰金,32,0,32,群益金鼎-松山,2024-12-17,9103
9945,潤泰新,32,0,32,群益金鼎-松山,2024-12-17,9103
3035,智原,41,10,31,群益金鼎-松山,2024-12-17,9103
4510,高鋒,32,1,31,群益金鼎-松山,2024-12-17,9103
2303,聯電,28,2,26,群益金鼎-松山,2024-12-17,9103
00918,大華優利高填息30,22,0,22,群益金鼎-松山,2024-12-17,9103
8097,常珵,21,0,21,群益金鼎-松山,2024-12-17,9103
4919,新唐,20,0,20,群益金鼎-松山,2024-12-17,9103
4931,新盛力,20,0,20,群益金鼎-松山,2024-12-17,9103
8131,福懋科,15,0,15,群益金鼎-松山,2024-12-17,9103
2915,潤泰全,14,0,14,群益金鼎-松山,2024-12-17,9103
2354,鴻準,13,0,13,群益金鼎-松山,2024-12-17,9103
3706,神達,23,11,12,群益金鼎-松山,2024-12-17,9103
1605,華新,16,5,11,群益金鼎-松山,2024-12-17,9103
00706L,期元大S＆P日圓正2,10,0,10,群益金鼎-松山,2024-12-17,9103
00915,凱基優選高股息30,10,0,10,群益金鼎-松山,2024-12-17,9103
00960,野村全球航運龍頭,10,0,10,群益金鼎-松山,2024-12-17,9103
2363,矽統,11,1,10,群益金鼎-松山,2024-12-17,9103
2897,王道銀行,10,0,10,群益金鼎-松山,2024-12-17,9103
4562,穎漢,18,8,10,群益金鼎-松山,2024-12-17,9103
1216,統一,8,0,8,群益金鼎-松山,2024-12-17,9103
2801,彰銀,8,0,8,群益金鼎-松山,2024-12-17,9103
8249,菱光,10,2,8,群益金鼎-松山,2024-12-17,9103
1514,亞力,8,1,7,群益金鼎-松山,2024-12-17,9103
2365,昆盈,56,49,7,群益金鼎-松山,2024-12-17,9103
3443,創意,9,2,7,群益金鼎-松山,2024-12-17,9103
5371,中光電,9,2,7,群益金鼎-松山,2024-12-17,9103
2371,大同,7,0,7,群益金鼎-松山,2024-12-17,9103
2520,冠德,6,0,6,群益金鼎-松山,2024-12-17,9103
2834,臺企銀,6,0,6,群益金鼎-松山,2024-12-17,9103
00650L,復華香港正2,5,0,5,群益金鼎-松山,2024-12-17,9103
1301,台塑,5,0,5,群益金鼎-松山,2024-12-17,9103
00948B,中信優息投資級債,5,0,5,群益金鼎-松山,2024-12-17,9103
2062,橋椿,10,5,5,群益金鼎-松山,2024-12-17,9103
2609,陽明,5,0,5,群益金鼎-松山,2024-12-17,9103
2883B,凱基金乙特,5,0,5,群益金鼎-松山,2024-12-17,9103
2887,台新金,5,0,5,群益金鼎-松山,2024-12-17,9103
3481,群創,5,0,5,群益金鼎-松山,2024-12-17,9103
00921,兆豐龍頭等權重,4,0,4,群益金鼎-松山,2024-12-17,9103
2375,凱美,4,0,4,群益金鼎-松山,2024-12-17,9103
3712,永崴投控,5,1,4,群益金鼎-松山,2024-12-17,9103
4526,東台,4,0,4,群益金鼎-松山,2024-12-17,9103
4536,拓凱,4,0,4,群益金鼎-松山,2024-12-17,9103
6257,矽格,4,0,4,群益金鼎-松山,2024-12-17,9103
8374,羅昇,14,10,4,群益金鼎-松山,2024-12-17,9103
2867,三商壽,202,2,200,群益金鼎-松山,2024-12-18,9103
6015,宏遠證,200,0,200,群益金鼎-松山,2024-12-18,9103
1314,中石化,100,0,100,群益金鼎-松山,2024-12-18,9103
5531,鄉林,100,0,100,群益金鼎-松山,2024-12-18,9103
3481,群創,101,3,98,群益金鼎-松山,2024-12-18,9103
00953B,群益優選非投等債,72,0,72,群益金鼎-松山,2024-12-18,9103
4540,全球傳動,61,1,60,群益金鼎-松山,2024-12-18,9103
2359,所羅門,69,9,60,群益金鼎-松山,2024-12-18,9103
2049,上銀,52,2,50,群益金鼎-松山,2024-12-18,9103
00687B,國泰20年美債,43,0,43,群益金鼎-松山,2024-12-18,9103
3357,臺慶科,44,2,42,群益金鼎-松山,2024-12-18,9103
2337,旺宏,32,0,32,群益金鼎-松山,2024-12-18,9103
00830,國泰費城半導體,30,0,30,群益金鼎-松山,2024-12-18,9103
00950B,凱基A級公司債,30,0,30,群益金鼎-松山,2024-12-18,9103
00919,群益台灣精選高息,32,5,27,群益金鼎-松山,2024-12-18,9103
00959B,大華投等美債15Y+,20,0,20,群益金鼎-松山,2024-12-18,9103
00881,國泰台灣5G+,22,5,17,群益金鼎-松山,2024-12-18,9103
00670L,富邦NASDAQ正2,15,0,15,群益金鼎-松山,2024-12-18,9103
3260,威剛,16,1,15,群益金鼎-松山,2024-12-18,9103
00926,凱基全球菁英55,13,0,13,群益金鼎-松山,2024-12-18,9103
6505,台塑化,17,4,13,群益金鼎-松山,2024-12-18,9103
3211,順達,32,20,12,群益金鼎-松山,2024-12-18,9103
2467,志聖,11,0,11,群益金鼎-松山,2024-12-18,9103
00715L,期街口布蘭特正2,10,0,10,群益金鼎-松山,2024-12-18,9103
2330,台積電,12,2,10,群益金鼎-松山,2024-12-18,9103
2471,資通,29,19,10,群益金鼎-松山,2024-12-18,9103
2915,潤泰全,10,0,10,群益金鼎-松山,2024-12-18,9103
3289,宜特,10,0,10,群益金鼎-松山,2024-12-18,9103
3437,榮創,10,0,10,群益金鼎-松山,2024-12-18,9103
4967,十銓,10,0,10,群益金鼎-松山,2024-12-18,9103
5278,尚凡*,10,0,10,群益金鼎-松山,2024-12-18,9103
5522,遠雄,10,0,10,群益金鼎-松山,2024-12-18,9103
6209,今國光,10,0,10,群益金鼎-松山,2024-12-18,9103
2303,聯電,20,11,9,群益金鼎-松山,2024-12-18,9103
1817,凱撒衛,8,0,8,群益金鼎-松山,2024-12-18,9103
2881,富邦金,11,3,8,群益金鼎-松山,2024-12-18,9103
00918,大華優利高填息30,8,1,7,群益金鼎-松山,2024-12-18,9103
4106,雃博,7,0,7,群益金鼎-松山,2024-12-18,9103
2382,廣達,6,0,6,群益金鼎-松山,2024-12-18,9103
00937B,群益ESG投等債20,6,0,6,群益金鼎-松山,2024-12-18,9103
2429,銘旺科,6,0,6,群益金鼎-松山,2024-12-18,9103
2014,中鴻,5,0,5,群益金鼎-松山,2024-12-18,9103
2027,大成鋼,5,0,5,群益金鼎-松山,2024-12-18,9103
5880,合庫金,5,0,5,群益金鼎-松山,2024-12-18,9103
6138,茂達,6,1,5,群益金鼎-松山,2024-12-18,9103
6214,精誠,6,1,5,群益金鼎-松山,2024-12-18,9103
3665,貿聯-KY,5,1,4,群益金鼎-松山,2024-12-18,9103
00968B,元大優息投等債,4,0,4,群益金鼎-松山,2024-12-18,9103
00966B,統一ESG投等債15,4,0,4,群益金鼎-松山,2024-12-18,9103
2002,中鋼,3,0,3,群益金鼎-松山,2024-12-18,9103
00687B,國泰20年美債,196,0,196,群益金鼎-松山,2024-12-19,9103
3704,合勤控,190,1,189,群益金鼎-松山,2024-12-19,9103
4991,環宇-KY,96,2,94,群益金鼎-松山,2024-12-19,9103
00937B,群益ESG投等債20,68,0,68,群益金鼎-松山,2024-12-19,9103
5244,弘凱,40,0,40,群益金鼎-松山,2024-12-19,9103
4571,鈞興-KY,36,0,36,群益金鼎-松山,2024-12-19,9103
2883,凱基金,32,0,32,群益金鼎-松山,2024-12-19,9103
8249,菱光,31,0,31,群益金鼎-松山,2024-12-19,9103
4931,新盛力,40,10,30,群益金鼎-松山,2024-12-19,9103
6188,廣明,28,1,27,群益金鼎-松山,2024-12-19,9103
2609,陽明,26,0,26,群益金鼎-松山,2024-12-19,9103
3706,神達,62,41,21,群益金鼎-松山,2024-12-19,9103
00959B,大華投等美債15Y+,20,0,20,群益金鼎-松山,2024-12-19,9103
4562,穎漢,30,10,20,群益金鼎-松山,2024-12-19,9103
00918,大華優利高填息30,19,0,19,群益金鼎-松山,2024-12-19,9103
2049,上銀,19,3,16,群益金鼎-松山,2024-12-19,9103
00950B,凱基A級公司債,11,0,11,群益金鼎-松山,2024-12-19,9103
2845,遠東銀,11,0,11,群益金鼎-松山,2024-12-19,9103
00795B,中信美國公債20年,10,0,10,群益金鼎-松山,2024-12-19,9103
00720B,元大投資級公司債,10,0,10,群益金鼎-松山,2024-12-19,9103
1102,亞泥,10,0,10,群益金鼎-松山,2024-12-19,9103
2897,王道銀行,10,0,10,群益金鼎-松山,2024-12-19,9103
3059,華晶科,10,0,10,群益金鼎-松山,2024-12-19,9103
5278,尚凡*,10,0,10,群益金鼎-松山,2024-12-19,9103
00712,復華富時不動產,9,0,9,群益金鼎-松山,2024-12-19,9103
00830,國泰費城半導體,9,0,9,群益金鼎-松山,2024-12-19,9103
2365,昆盈,10,1,9,群益金鼎-松山,2024-12-19,9103
2317,鴻海,41,32,9,群益金鼎-松山,2024-12-19,9103
4977,眾達-KY,22,15,7,群益金鼎-松山,2024-12-19,9103
00647L,元大S＆P500正2,6,0,6,群益金鼎-松山,2024-12-19,9103
2371,大同,6,0,6,群益金鼎-松山,2024-12-19,9103
6209,今國光,7,1,6,群益金鼎-松山,2024-12-19,9103
9945,潤泰新,6,0,6,群益金鼎-松山,2024-12-19,9103
00881,國泰台灣5G+,5,0,5,群益金鼎-松山,2024-12-19,9103
2485,兆赫,5,0,5,群益金鼎-松山,2024-12-19,9103
2486,一詮,5,0,5,群益金鼎-松山,2024-12-19,9103
2883B,凱基金乙特,5,0,5,群益金鼎-松山,2024-12-19,9103
3607,谷崧,5,0,5,群益金鼎-松山,2024-12-19,9103
5469,瀚宇博,5,0,5,群益金鼎-松山,2024-12-19,9103
8111,立��,8,3,5,群益金鼎-松山,2024-12-19,9103
00970B,新光BBB投等債20,4,0,4,群益金鼎-松山,2024-12-19,9103
00922,國泰台灣領袖50,4,0,4,群益金鼎-松山,2024-12-19,9103
1465,偉全,4,0,4,群益金鼎-松山,2024-12-19,9103
2204,中華,5,1,4,群益金鼎-松山,2024-12-19,9103
2618,長榮航,4,0,4,群益金鼎-松山,2024-12-19,9103
2892,第一金,4,0,4,群益金鼎-松山,2024-12-19,9103
2915,潤泰全,4,0,4,群益金鼎-松山,2024-12-19,9103
1815,富喬,6,3,3,群益金鼎-松山,2024-12-19,9103
00631L,元大台灣50正2,5,2,3,群益金鼎-松山,2024-12-19,9103
00933B,國泰10Y+金融債,3,0,3,群益金鼎-松山,2024-12-19,9103
