Ticker,Name,buy,sell,diff,Branch,Date,Branch_Code
00632R,元大台灣50反1,55,10,45,群益金鼎-桃園,2023-01-03,9189
1701,中化,50,6,44,群益金鼎-桃園,2023-01-03,9189
4171,瑞基,62,21,41,群益金鼎-桃園,2023-01-03,9189
2801,彰銀,50,10,40,群益金鼎-桃園,2023-01-03,9189
00720B,元大投資級公司債,38,0,38,群益金鼎-桃園,2023-01-03,9189
6180,橘子,47,10,37,群益金鼎-桃園,2023-01-03,9189
2845,遠東銀,20,0,20,群益金鼎-桃園,2023-01-03,9189
3234,光環,20,0,20,群益金鼎-桃園,2023-01-03,9189
3704,合勤控,22,2,20,群益金鼎-桃園,2023-01-03,9189
2423,固緯,41,23,18,群益金鼎-桃園,2023-01-03,9189
2498,宏達電,43,26,17,群益金鼎-桃園,2023-01-03,9189
2882,國泰金,16,0,16,群益金鼎-桃園,2023-01-03,9189
6282,康舒,13,0,13,群益金鼎-桃園,2023-01-03,9189
2886,兆豐金,13,0,13,群益金鼎-桃園,2023-01-03,9189
1101,台泥,12,0,12,群益金鼎-桃園,2023-01-03,9189
1605,華新,18,6,12,群益金鼎-桃園,2023-01-03,9189
1519,華城,29,17,12,群益金鼎-桃園,2023-01-03,9189
5227,立凱-KY,12,0,12,群益金鼎-桃園,2023-01-03,9189
4979,華星光,13,1,12,群益金鼎-桃園,2023-01-03,9189
1720,生達,11,0,11,群益金鼎-桃園,2023-01-03,9189
3702,大聯大,10,0,10,群益金鼎-桃園,2023-01-03,9189
00885,富邦越南,67,57,10,群益金鼎-桃園,2023-01-03,9189
9904,寶成,8,0,8,群益金鼎-桃園,2023-01-03,9189
6643,M31,12,4,8,群益金鼎-桃園,2023-01-03,9189
00878,國泰永續高股息,8,0,8,群益金鼎-桃園,2023-01-03,9189
2606,裕民,7,0,7,群益金鼎-桃園,2023-01-03,9189
1783,和康生,7,0,7,群益金鼎-桃園,2023-01-03,9189
2890,永豐金,7,0,7,群益金鼎-桃園,2023-01-03,9189
1514,亞力,6,0,6,群益金鼎-桃園,2023-01-03,9189
6451,訊芯-KY,6,0,6,群益金鼎-桃園,2023-01-03,9189
5483,中美晶,6,0,6,群益金鼎-桃園,2023-01-03,9189
2317,鴻海,21,16,5,群益金鼎-桃園,2023-01-03,9189
0056,元大高股息,12,7,5,群益金鼎-桃園,2023-01-03,9189
4919,新唐,5,0,5,群益金鼎-桃園,2023-01-03,9189
2485,兆赫,5,0,5,群益金鼎-桃園,2023-01-03,9189
3017,奇鋐,5,0,5,群益金鼎-桃園,2023-01-03,9189
9136,巨騰-DR,5,0,5,群益金鼎-桃園,2023-01-03,9189
00674R,期元大S＆P黃金反1,5,0,5,群益金鼎-桃園,2023-01-03,9189
6129,普誠,5,0,5,群益金鼎-桃園,2023-01-03,9189
2331,精英,5,0,5,群益金鼎-桃園,2023-01-03,9189
1307,三芳,5,0,5,群益金鼎-桃園,2023-01-03,9189
5011,久陽,5,0,5,群益金鼎-桃園,2023-01-03,9189
3044,健鼎,5,0,5,群益金鼎-桃園,2023-01-03,9189
00631L,元大台灣50正2,5,0,5,群益金鼎-桃園,2023-01-03,9189
3027,盛達,8,4,4,群益金鼎-桃園,2023-01-03,9189
4934,太極,4,0,4,群益金鼎-桃園,2023-01-03,9189
2312,金寶,4,0,4,群益金鼎-桃園,2023-01-03,9189
5469,瀚宇博,4,0,4,群益金鼎-桃園,2023-01-03,9189
1417,嘉裕,7,3,4,群益金鼎-桃園,2023-01-03,9189
6150,撼訊,31,27,4,群益金鼎-桃園,2023-01-03,9189
00680L,元大美債20正2,102,0,102,群益金鼎-桃園,2023-01-04,9189
1711,永光,60,0,60,群益金鼎-桃園,2023-01-04,9189
2317,鴻海,51,6,45,群益金鼎-桃園,2023-01-04,9189
00665L,富邦�琤肭磪囓�2,43,1,42,群益金鼎-桃園,2023-01-04,9189
00878,國泰永續高股息,28,0,28,群益金鼎-桃園,2023-01-04,9189
2609,陽明,29,3,26,群益金鼎-桃園,2023-01-04,9189
8046,南電,59,38,21,群益金鼎-桃園,2023-01-04,9189
1720,生達,20,0,20,群益金鼎-桃園,2023-01-04,9189
2884,玉山金,18,1,17,群益金鼎-桃園,2023-01-04,9189
8033,雷虎,17,0,17,群益金鼎-桃園,2023-01-04,9189
00893,國泰智能電動車,13,0,13,群益金鼎-桃園,2023-01-04,9189
2615,萬海,23,10,13,群益金鼎-桃園,2023-01-04,9189
2303,聯電,13,2,11,群益金鼎-桃園,2023-01-04,9189
8105,凌巨,10,0,10,群益金鼎-桃園,2023-01-04,9189
3162,精確,17,7,10,群益金鼎-桃園,2023-01-04,9189
3264,欣銓,10,0,10,群益金鼎-桃園,2023-01-04,9189
2888,新光金,10,0,10,群益金鼎-桃園,2023-01-04,9189
2929,淘帝-KY,10,0,10,群益金鼎-桃園,2023-01-04,9189
2312,金寶,10,0,10,群益金鼎-桃園,2023-01-04,9189
3630,新鉅科,10,1,9,群益金鼎-桃園,2023-01-04,9189
3380,明泰,16,7,9,群益金鼎-桃園,2023-01-04,9189
6118,建達,48,39,9,群益金鼎-桃園,2023-01-04,9189
1810,和成,10,1,9,群益金鼎-桃園,2023-01-04,9189
2637,慧洋-KY,11,2,9,群益金鼎-桃園,2023-01-04,9189
2465,麗臺,24,16,8,群益金鼎-桃園,2023-01-04,9189
2748,雲品,8,0,8,群益金鼎-桃園,2023-01-04,9189
1417,嘉裕,20,12,8,群益金鼎-桃園,2023-01-04,9189
6806,森崴能源,39,31,8,群益金鼎-桃園,2023-01-04,9189
00679B,元大美債20年,8,0,8,群益金鼎-桃園,2023-01-04,9189
00902,中信電池及儲能,8,1,7,群益金鼎-桃園,2023-01-04,9189
5009,榮剛,7,0,7,群益金鼎-桃園,2023-01-04,9189
4104,佳醫,7,0,7,群益金鼎-桃園,2023-01-04,9189
2204,中華,7,0,7,群益金鼎-桃園,2023-01-04,9189
9136,巨騰-DR,6,0,6,群益金鼎-桃園,2023-01-04,9189
6288,聯嘉,7,1,6,群益金鼎-桃園,2023-01-04,9189
00637L,元大滬深300正2,9,3,6,群益金鼎-桃園,2023-01-04,9189
3228,金麗科,7,1,6,群益金鼎-桃園,2023-01-04,9189
2618,長榮航,7,1,6,群益金鼎-桃園,2023-01-04,9189
1303,南亞,6,0,6,群益金鼎-桃園,2023-01-04,9189
2368,金像電,8,3,5,群益金鼎-桃園,2023-01-04,9189
3037,欣興,11,6,5,群益金鼎-桃園,2023-01-04,9189
2211,長榮鋼,6,1,5,群益金鼎-桃園,2023-01-04,9189
8255,朋程,5,0,5,群益金鼎-桃園,2023-01-04,9189
6129,普誠,5,0,5,群益金鼎-桃園,2023-01-04,9189
00655L,國泰中國A50正2,5,0,5,群益金鼎-桃園,2023-01-04,9189
3693,營邦,12,7,5,群益金鼎-桃園,2023-01-04,9189
6269,台郡,5,0,5,群益金鼎-桃園,2023-01-04,9189
5426,振發,5,0,5,群益金鼎-桃園,2023-01-04,9189
00632R,元大台灣50反1,15,10,5,群益金鼎-桃園,2023-01-04,9189
2243,宏旭-KY,5,0,5,群益金鼎-桃園,2023-01-04,9189
1701,中化,242,3,239,群益金鼎-桃園,2023-01-05,9189
00676R,富邦臺灣加權反1,150,0,150,群益金鼎-桃園,2023-01-05,9189
5009,榮剛,58,0,58,群益金鼎-桃園,2023-01-05,9189
00641R,富邦日本反1,40,6,34,群益金鼎-桃園,2023-01-05,9189
00878,國泰永續高股息,32,5,27,群益金鼎-桃園,2023-01-05,9189
1736,喬山,26,2,24,群益金鼎-桃園,2023-01-05,9189
2748,雲品,20,2,18,群益金鼎-桃園,2023-01-05,9189
2409,友達,16,0,16,群益金鼎-桃園,2023-01-05,9189
2303,聯電,25,11,14,群益金鼎-桃園,2023-01-05,9189
1529,樂事綠能,54,43,11,群益金鼎-桃園,2023-01-05,9189
3260,威剛,11,1,10,群益金鼎-桃園,2023-01-05,9189
6770,力積電,10,0,10,群益金鼎-桃園,2023-01-05,9189
2867,三商壽,10,0,10,群益金鼎-桃園,2023-01-05,9189
2308,台達電,18,9,9,群益金鼎-桃園,2023-01-05,9189
1810,和成,11,2,9,群益金鼎-桃園,2023-01-05,9189
5608,四維航,10,1,9,群益金鼎-桃園,2023-01-05,9189
2834,臺企銀,10,1,9,群益金鼎-桃園,2023-01-05,9189
00715L,期街口布蘭特正2,10,1,9,群益金鼎-桃園,2023-01-05,9189
2317,鴻海,18,9,9,群益金鼎-桃園,2023-01-05,9189
2368,金像電,8,0,8,群益金鼎-桃園,2023-01-05,9189
2605,新興,8,0,8,群益金鼎-桃園,2023-01-05,9189
2851,中再保,8,0,8,群益金鼎-桃園,2023-01-05,9189
1609,大亞,9,1,8,群益金鼎-桃園,2023-01-05,9189
1605,華新,20,13,7,群益金鼎-桃園,2023-01-05,9189
3013,晟銘電,8,1,7,群益金鼎-桃園,2023-01-05,9189
2383,台光電,9,2,7,群益金鼎-桃園,2023-01-05,9189
3380,明泰,9,2,7,群益金鼎-桃園,2023-01-05,9189
2892,第一金,7,1,6,群益金鼎-桃園,2023-01-05,9189
00642U,期元大S＆P石油,6,0,6,群益金鼎-桃園,2023-01-05,9189
9958,世紀鋼,6,0,6,群益金鼎-桃園,2023-01-05,9189
4721,美琪瑪,5,0,5,群益金鼎-桃園,2023-01-05,9189
00706L,期元大S＆P日圓正2,5,0,5,群益金鼎-桃園,2023-01-05,9189
3479,安勤,13,8,5,群益金鼎-桃園,2023-01-05,9189
1905,華紙,5,0,5,群益金鼎-桃園,2023-01-05,9189
6695,芯鼎,5,0,5,群益金鼎-桃園,2023-01-05,9189
2313,華通,9,4,5,群益金鼎-桃園,2023-01-05,9189
1720,生達,6,1,5,群益金鼎-桃園,2023-01-05,9189
2596,綠意,5,0,5,群益金鼎-桃園,2023-01-05,9189
2230,泰茂,8,3,5,群益金鼎-桃園,2023-01-05,9189
9904,寶成,5,0,5,群益金鼎-桃園,2023-01-05,9189
2243,宏旭-KY,5,0,5,群益金鼎-桃園,2023-01-05,9189
4133,亞諾法,5,0,5,群益金鼎-桃園,2023-01-05,9189
00670L,富邦NASDAQ正2,5,0,5,群益金鼎-桃園,2023-01-05,9189
4130,健亞,7,2,5,群益金鼎-桃園,2023-01-05,9189
2915,潤泰全,4,0,4,群益金鼎-桃園,2023-01-05,9189
3037,欣興,14,10,4,群益金鼎-桃園,2023-01-05,9189
3406,玉晶光,4,0,4,群益金鼎-桃園,2023-01-05,9189
6443,元晶,10,6,4,群益金鼎-桃園,2023-01-05,9189
2634,漢翔,4,0,4,群益金鼎-桃園,2023-01-05,9189
1709,和益,4,0,4,群益金鼎-桃園,2023-01-05,9189
00632R,元大台灣50反1,774,7,767,群益金鼎-桃園,2023-01-06,9189
6806,森崴能源,57,0,57,群益金鼎-桃園,2023-01-06,9189
2748,雲品,36,1,35,群益金鼎-桃園,2023-01-06,9189
6244,茂迪,36,2,34,群益金鼎-桃園,2023-01-06,9189
8076,伍豐,32,0,32,群益金鼎-桃園,2023-01-06,9189
3704,合勤控,23,2,21,群益金鼎-桃園,2023-01-06,9189
1101,台泥,21,0,21,群益金鼎-桃園,2023-01-06,9189
6111,大宇資,14,0,14,群益金鼎-桃園,2023-01-06,9189
1720,生達,12,0,12,群益金鼎-桃園,2023-01-06,9189
5475,德宏,13,1,12,群益金鼎-桃園,2023-01-06,9189
6282,康舒,13,1,12,群益金鼎-桃園,2023-01-06,9189
5284,jpp-KY,13,2,11,群益金鼎-桃園,2023-01-06,9189
1417,嘉裕,10,0,10,群益金鼎-桃園,2023-01-06,9189
00882,中信中國高股息,13,3,10,群益金鼎-桃園,2023-01-06,9189
6142,友勁,10,0,10,群益金鼎-桃園,2023-01-06,9189
2332,友訊,10,0,10,群益金鼎-桃園,2023-01-06,9189
00670L,富邦NASDAQ正2,9,0,9,群益金鼎-桃園,2023-01-06,9189
2317,鴻海,10,2,8,群益金鼎-桃園,2023-01-06,9189
6589,台康生技,9,1,8,群益金鼎-桃園,2023-01-06,9189
1513,中興電,23,15,8,群益金鼎-桃園,2023-01-06,9189
8069,元太,15,8,7,群益金鼎-桃園,2023-01-06,9189
00888,永豐台灣ESG,7,0,7,群益金鼎-桃園,2023-01-06,9189
6443,元晶,8,1,7,群益金鼎-桃園,2023-01-06,9189
00706L,期元大S＆P日圓正2,7,0,7,群益金鼎-桃園,2023-01-06,9189
8105,凌巨,7,1,6,群益金鼎-桃園,2023-01-06,9189
4116,明基醫,6,0,6,群益金鼎-桃園,2023-01-06,9189
00772B,中信高評級公司債,6,0,6,群益金鼎-桃園,2023-01-06,9189
00664R,國泰臺灣加權反1,6,0,6,群益金鼎-桃園,2023-01-06,9189
8028,昇陽半導體,6,0,6,群益金鼎-桃園,2023-01-06,9189
1736,喬山,7,1,6,群益金鼎-桃園,2023-01-06,9189
3706,神達,6,0,6,群益金鼎-桃園,2023-01-06,9189
4306,炎洲,6,0,6,群益金鼎-桃園,2023-01-06,9189
5351,鈺創,22,16,6,群益金鼎-桃園,2023-01-06,9189
00679B,元大美債20年,6,0,6,群益金鼎-桃園,2023-01-06,9189
2886,兆豐金,5,0,5,群益金鼎-桃園,2023-01-06,9189
8033,雷虎,5,0,5,群益金鼎-桃園,2023-01-06,9189
00655L,國泰中國A50正2,5,0,5,群益金鼎-桃園,2023-01-06,9189
6451,訊芯-KY,5,0,5,群益金鼎-桃園,2023-01-06,9189
3090,日電貿,5,0,5,群益金鼎-桃園,2023-01-06,9189
00720B,元大投資級公司債,5,0,5,群益金鼎-桃園,2023-01-06,9189
00674R,期元大S＆P黃金反1,5,0,5,群益金鼎-桃園,2023-01-06,9189
00900,富邦特選高股息30,5,0,5,群益金鼎-桃園,2023-01-06,9189
2891,中信金,4,0,4,群益金鼎-桃園,2023-01-06,9189
4171,瑞基,4,0,4,群益金鼎-桃園,2023-01-06,9189
6176,瑞儀,4,0,4,群益金鼎-桃園,2023-01-06,9189
8171,天宇,20,16,4,群益金鼎-桃園,2023-01-06,9189
6196,帆宣,4,0,4,群益金鼎-桃園,2023-01-06,9189
5608,四維航,4,0,4,群益金鼎-桃園,2023-01-06,9189
4167,松瑞藥,13,9,4,群益金鼎-桃園,2023-01-06,9189
1789,神隆,4,0,4,群益金鼎-桃園,2023-01-06,9189
00632R,元大台灣50反1,743,2,741,群益金鼎-桃園,2023-01-09,9189
4763,材料-KY,43,6,37,群益金鼎-桃園,2023-01-09,9189
00665L,富邦�琤肭磪囓�2,30,0,30,群益金鼎-桃園,2023-01-09,9189
00715L,期街口布蘭特正2,31,2,29,群益金鼎-桃園,2023-01-09,9189
1605,華新,103,75,28,群益金鼎-桃園,2023-01-09,9189
2603,長榮,26,2,24,群益金鼎-桃園,2023-01-09,9189
2317,鴻海,28,4,24,群益金鼎-桃園,2023-01-09,9189
6129,普誠,27,4,23,群益金鼎-桃園,2023-01-09,9189
1595,川寶,30,9,21,群益金鼎-桃園,2023-01-09,9189
1513,中興電,29,9,20,群益金鼎-桃園,2023-01-09,9189
2010,春源,19,0,19,群益金鼎-桃園,2023-01-09,9189
2748,雲品,20,1,19,群益金鼎-桃園,2023-01-09,9189
6153,嘉聯益,19,1,18,群益金鼎-桃園,2023-01-09,9189
2409,友達,26,8,18,群益金鼎-桃園,2023-01-09,9189
00671R,富邦NASDAQ反1,15,0,15,群益金鼎-桃園,2023-01-09,9189
8105,凌巨,15,0,15,群益金鼎-桃園,2023-01-09,9189
1609,大亞,14,1,13,群益金鼎-桃園,2023-01-09,9189
8050,廣積,16,3,13,群益金鼎-桃園,2023-01-09,9189
00882,中信中國高股息,14,1,13,群益金鼎-桃園,2023-01-09,9189
9933,中鼎,12,0,12,群益金鼎-桃園,2023-01-09,9189
2457,飛宏,23,11,12,群益金鼎-桃園,2023-01-09,9189
00680L,元大美債20正2,11,0,11,群益金鼎-桃園,2023-01-09,9189
1618,合機,11,0,11,群益金鼎-桃園,2023-01-09,9189
6282,康舒,10,0,10,群益金鼎-桃園,2023-01-09,9189
2880,華南金,10,0,10,群益金鼎-桃園,2023-01-09,9189
2615,萬海,13,3,10,群益金鼎-桃園,2023-01-09,9189
6142,友勁,10,0,10,群益金鼎-桃園,2023-01-09,9189
6143,振曜,16,6,10,群益金鼎-桃園,2023-01-09,9189
2030,彰源,10,0,10,群益金鼎-桃園,2023-01-09,9189
6806,森崴能源,10,0,10,群益金鼎-桃園,2023-01-09,9189
00683L,期元大美元指正2,10,0,10,群益金鼎-桃園,2023-01-09,9189
00885,富邦越南,16,7,9,群益金鼎-桃園,2023-01-09,9189
2498,宏達電,21,12,9,群益金鼎-桃園,2023-01-09,9189
4114,健喬,16,7,9,群益金鼎-桃園,2023-01-09,9189
3128,昇銳,8,0,8,群益金鼎-桃園,2023-01-09,9189
4116,明基醫,7,0,7,群益金鼎-桃園,2023-01-09,9189
3265,台星科,7,0,7,群益金鼎-桃園,2023-01-09,9189
1720,生達,9,2,7,群益金鼎-桃園,2023-01-09,9189
3576,聯合再生,7,0,7,群益金鼎-桃園,2023-01-09,9189
6139,亞翔,15,8,7,群益金鼎-桃園,2023-01-09,9189
2208,台船,6,0,6,群益金鼎-桃園,2023-01-09,9189
8938,明安,6,0,6,群益金鼎-桃園,2023-01-09,9189
3535,晶彩科,11,5,6,群益金鼎-桃園,2023-01-09,9189
4961,天鈺,16,10,6,群益金鼎-桃園,2023-01-09,9189
6477,安集,6,0,6,群益金鼎-桃園,2023-01-09,9189
5388,中磊,8,2,6,群益金鼎-桃園,2023-01-09,9189
8069,元太,11,5,6,群益金鼎-桃園,2023-01-09,9189
2915,潤泰全,6,1,5,群益金鼎-桃園,2023-01-09,9189
3508,位速,5,0,5,群益金鼎-桃園,2023-01-09,9189
9939,宏全,5,0,5,群益金鼎-桃園,2023-01-09,9189
00632R,元大台灣50反1,115,3,112,群益金鼎-桃園,2023-01-10,9189
2010,春源,50,0,50,群益金鼎-桃園,2023-01-10,9189
6153,嘉聯益,41,0,41,群益金鼎-桃園,2023-01-10,9189
1513,中興電,44,15,29,群益金鼎-桃園,2023-01-10,9189
2317,鴻海,31,2,29,群益金鼎-桃園,2023-01-10,9189
00885,富邦越南,30,2,28,群益金鼎-桃園,2023-01-10,9189
9955,佳龍,26,0,26,群益金鼎-桃園,2023-01-10,9189
00642U,期元大S＆P石油,20,0,20,群益金鼎-桃園,2023-01-10,9189
00720B,元大投資級公司債,21,1,20,群益金鼎-桃園,2023-01-10,9189
2028,威致,20,0,20,群益金鼎-桃園,2023-01-10,9189
00882,中信中國高股息,19,1,18,群益金鼎-桃園,2023-01-10,9189
8390,金益鼎,15,0,15,群益金鼎-桃園,2023-01-10,9189
6244,茂迪,13,1,12,群益金鼎-桃園,2023-01-10,9189
3141,晶宏,17,5,12,群益金鼎-桃園,2023-01-10,9189
8171,天宇,16,5,11,群益金鼎-桃園,2023-01-10,9189
1609,大亞,11,1,10,群益金鼎-桃園,2023-01-10,9189
2338,光罩,10,0,10,群益金鼎-桃園,2023-01-10,9189
3583,辛耘,12,2,10,群益金鼎-桃園,2023-01-10,9189
3290,東浦,10,0,10,群益金鼎-桃園,2023-01-10,9189
3036,文曄,10,0,10,群益金鼎-桃園,2023-01-10,9189
1339,昭輝,10,0,10,群益金鼎-桃園,2023-01-10,9189
2030,彰源,10,0,10,群益金鼎-桃園,2023-01-10,9189
2353,宏��,10,0,10,群益金鼎-桃園,2023-01-10,9189
2009,第一銅,12,2,10,群益金鼎-桃園,2023-01-10,9189
3265,台星科,10,0,10,群益金鼎-桃園,2023-01-10,9189
00680L,元大美債20正2,10,0,10,群益金鼎-桃園,2023-01-10,9189
00715L,期街口布蘭特正2,8,0,8,群益金鼎-桃園,2023-01-10,9189
9945,潤泰新,12,4,8,群益金鼎-桃園,2023-01-10,9189
4114,健喬,7,0,7,群益金鼎-桃園,2023-01-10,9189
6214,精誠,7,0,7,群益金鼎-桃園,2023-01-10,9189
6770,力積電,28,21,7,群益金鼎-桃園,2023-01-10,9189
8105,凌巨,21,14,7,群益金鼎-桃園,2023-01-10,9189
2882,國泰金,12,6,6,群益金鼎-桃園,2023-01-10,9189
1536,和大,6,0,6,群益金鼎-桃園,2023-01-10,9189
1708,東鹼,6,0,6,群益金鼎-桃園,2023-01-10,9189
3498,陽程,6,0,6,群益金鼎-桃園,2023-01-10,9189
2634,漢翔,10,4,6,群益金鼎-桃園,2023-01-10,9189
2354,鴻準,6,0,6,群益金鼎-桃園,2023-01-10,9189
1732,毛寶,5,0,5,群益金鼎-桃園,2023-01-10,9189
6213,聯茂,5,0,5,群益金鼎-桃園,2023-01-10,9189
3532,台勝科,5,0,5,群益金鼎-桃園,2023-01-10,9189
6695,芯鼎,5,0,5,群益金鼎-桃園,2023-01-10,9189
6768,志強-KY,5,0,5,群益金鼎-桃園,2023-01-10,9189
1702,南僑,5,0,5,群益金鼎-桃園,2023-01-10,9189
8081,致新,9,4,5,群益金鼎-桃園,2023-01-10,9189
1605,華新,25,20,5,群益金鼎-桃園,2023-01-10,9189
2313,華通,4,0,4,群益金鼎-桃園,2023-01-10,9189
1810,和成,4,0,4,群益金鼎-桃園,2023-01-10,9189
8996,高力,9,5,4,群益金鼎-桃園,2023-01-10,9189
1584,精剛,5,1,4,群益金鼎-桃園,2023-01-10,9189
00680L,元大美債20正2,82,0,82,群益金鼎-桃園,2023-01-11,9189
3025,星通,50,0,50,群益金鼎-桃園,2023-01-11,9189
2010,春源,50,3,47,群益金鼎-桃園,2023-01-11,9189
2618,長榮航,71,28,43,群益金鼎-桃園,2023-01-11,9189
6806,森崴能源,42,3,39,群益金鼎-桃園,2023-01-11,9189
3704,合勤控,41,8,33,群益金鼎-桃園,2023-01-11,9189
1227,佳格,25,0,25,群益金鼎-桃園,2023-01-11,9189
2748,雲品,20,0,20,群益金鼎-桃園,2023-01-11,9189
2102,泰豐,20,0,20,群益金鼎-桃園,2023-01-11,9189
2884,玉山金,22,2,20,群益金鼎-桃園,2023-01-11,9189
1584,精剛,21,4,17,群益金鼎-桃園,2023-01-11,9189
2610,華航,22,7,15,群益金鼎-桃園,2023-01-11,9189
1605,華新,75,60,15,群益金鼎-桃園,2023-01-11,9189
00701,國泰股利精選30,15,0,15,群益金鼎-桃園,2023-01-11,9189
6182,合晶,16,1,15,群益金鼎-桃園,2023-01-11,9189
3443,創意,15,1,14,群益金鼎-桃園,2023-01-11,9189
1595,川寶,14,0,14,群益金鼎-桃園,2023-01-11,9189
2614,東森,15,2,13,群益金鼎-桃園,2023-01-11,9189
5351,鈺創,14,2,12,群益金鼎-桃園,2023-01-11,9189
2002,中鋼,12,0,12,群益金鼎-桃園,2023-01-11,9189
2609,陽明,18,7,11,群益金鼎-桃園,2023-01-11,9189
5880,合庫金,11,0,11,群益金鼎-桃園,2023-01-11,9189
3265,台星科,11,0,11,群益金鼎-桃園,2023-01-11,9189
8390,金益鼎,10,0,10,群益金鼎-桃園,2023-01-11,9189
9955,佳龍,11,1,10,群益金鼎-桃園,2023-01-11,9189
00895,富邦未來車,10,0,10,群益金鼎-桃園,2023-01-11,9189
6244,茂迪,10,0,10,群益金鼎-桃園,2023-01-11,9189
2028,威致,10,0,10,群益金鼎-桃園,2023-01-11,9189
0056,元大高股息,9,0,9,群益金鼎-桃園,2023-01-11,9189
4167,松瑞藥,11,2,9,群益金鼎-桃園,2023-01-11,9189
00665L,富邦�琤肭磪囓�2,10,1,9,群益金鼎-桃園,2023-01-11,9189
2413,環科,25,17,8,群益金鼎-桃園,2023-01-11,9189
4417,金洲,8,0,8,群益金鼎-桃園,2023-01-11,9189
00642U,期元大S＆P石油,10,2,8,群益金鼎-桃園,2023-01-11,9189
00878,國泰永續高股息,12,4,8,群益金鼎-桃園,2023-01-11,9189
00900,富邦特選高股息30,7,0,7,群益金鼎-桃園,2023-01-11,9189
1789,神隆,7,0,7,群益金鼎-桃園,2023-01-11,9189
00715L,期街口布蘭特正2,7,0,7,群益金鼎-桃園,2023-01-11,9189
2313,華通,14,7,7,群益金鼎-桃園,2023-01-11,9189
6469,大樹,7,0,7,群益金鼎-桃園,2023-01-11,9189
6609,瀧澤科,7,0,7,群益金鼎-桃園,2023-01-11,9189
6691,洋基工程,6,0,6,群益金鼎-桃園,2023-01-11,9189
1319,東陽,6,0,6,群益金鼎-桃園,2023-01-11,9189
2383,台光電,5,0,5,群益金鼎-桃園,2023-01-11,9189
2615,萬海,8,3,5,群益金鼎-桃園,2023-01-11,9189
4904,遠傳,5,0,5,群益金鼎-桃園,2023-01-11,9189
3701,大眾控,5,0,5,群益金鼎-桃園,2023-01-11,9189
1702,南僑,5,0,5,群益金鼎-桃園,2023-01-11,9189
3687,歐買尬,5,0,5,群益金鼎-桃園,2023-01-11,9189
00671R,富邦NASDAQ反1,5,0,5,群益金鼎-桃園,2023-01-11,9189
2010,春源,60,0,60,群益金鼎-桃園,2023-01-12,9189
2609,陽明,48,13,35,群益金鼎-桃園,2023-01-12,9189
00673R,期元大S＆P原油反1,32,0,32,群益金鼎-桃園,2023-01-12,9189
2027,大成鋼,31,5,26,群益金鼎-桃園,2023-01-12,9189
00753L,中信中國50正2,31,6,25,群益金鼎-桃園,2023-01-12,9189
3704,合勤控,29,6,23,群益金鼎-桃園,2023-01-12,9189
9933,中鼎,20,0,20,群益金鼎-桃園,2023-01-12,9189
1595,川寶,20,0,20,群益金鼎-桃園,2023-01-12,9189
9103,美德醫療-DR,20,0,20,群益金鼎-桃園,2023-01-12,9189
6118,建達,35,16,19,群益金鼎-桃園,2023-01-12,9189
3693,營邦,19,2,17,群益金鼎-桃園,2023-01-12,9189
3576,聯合再生,16,0,16,群益金鼎-桃園,2023-01-12,9189
2388,威盛,12,0,12,群益金鼎-桃園,2023-01-12,9189
2009,第一銅,27,15,12,群益金鼎-桃園,2023-01-12,9189
6244,茂迪,16,5,11,群益金鼎-桃園,2023-01-12,9189
2498,宏達電,26,15,11,群益金鼎-桃園,2023-01-12,9189
3702,大聯大,10,0,10,群益金鼎-桃園,2023-01-12,9189
2617,台航,10,0,10,群益金鼎-桃園,2023-01-12,9189
3036,文曄,10,0,10,群益金鼎-桃園,2023-01-12,9189
2897,王道銀行,10,0,10,群益金鼎-桃園,2023-01-12,9189
2610,華航,10,0,10,群益金鼎-桃園,2023-01-12,9189
2409,友達,10,1,9,群益金鼎-桃園,2023-01-12,9189
4979,華星光,25,16,9,群益金鼎-桃園,2023-01-12,9189
6788,華景電,13,4,9,群益金鼎-桃園,2023-01-12,9189
5009,榮剛,22,13,9,群益金鼎-桃園,2023-01-12,9189
2603,長榮,10,2,8,群益金鼎-桃園,2023-01-12,9189
3037,欣興,13,5,8,群益金鼎-桃園,2023-01-12,9189
3228,金麗科,12,4,8,群益金鼎-桃園,2023-01-12,9189
00885,富邦越南,8,0,8,群益金鼎-桃園,2023-01-12,9189
6274,台燿,9,1,8,群益金鼎-桃園,2023-01-12,9189
6245,立端,31,23,8,群益金鼎-桃園,2023-01-12,9189
2358,廷鑫,26,18,8,群益金鼎-桃園,2023-01-12,9189
4746,台耀,8,1,7,群益金鼎-桃園,2023-01-12,9189
2338,光罩,13,6,7,群益金鼎-桃園,2023-01-12,9189
2481,強茂,7,0,7,群益金鼎-桃園,2023-01-12,9189
2317,鴻海,7,1,6,群益金鼎-桃園,2023-01-12,9189
3515,華擎,16,10,6,群益金鼎-桃園,2023-01-12,9189
6290,良維,6,0,6,群益金鼎-桃園,2023-01-12,9189
6548,長科*,6,0,6,群益金鼎-桃園,2023-01-12,9189
00701,國泰股利精選30,6,0,6,群益金鼎-桃園,2023-01-12,9189
3013,晟銘電,6,0,6,群益金鼎-桃園,2023-01-12,9189
2347,聯強,6,1,5,群益金鼎-桃園,2023-01-12,9189
2867,三商壽,5,0,5,群益金鼎-桃園,2023-01-12,9189
00905,FT臺灣Smart,5,0,5,群益金鼎-桃園,2023-01-12,9189
2495,普安,7,2,5,群益金鼎-桃園,2023-01-12,9189
3583,辛耘,5,0,5,群益金鼎-桃園,2023-01-12,9189
00881,國泰台灣5G+,5,0,5,群益金鼎-桃園,2023-01-12,9189
2618,長榮航,13,8,5,群益金鼎-桃園,2023-01-12,9189
1227,佳格,5,0,5,群益金鼎-桃園,2023-01-12,9189
8440,綠電,5,0,5,群益金鼎-桃園,2023-01-12,9189
00632R,元大台灣50反1,230,83,147,群益金鼎-桃園,2023-01-13,9189
2891,中信金,101,30,71,群益金鼎-桃園,2023-01-13,9189
2010,春源,60,0,60,群益金鼎-桃園,2023-01-13,9189
1584,精剛,86,43,43,群益金鼎-桃園,2023-01-13,9189
3707,漢磊,31,1,30,群益金鼎-桃園,2023-01-13,9189
3704,合勤控,40,13,27,群益金鼎-桃園,2023-01-13,9189
2313,華通,27,2,25,群益金鼎-桃園,2023-01-13,9189
00665L,富邦�琤肭磪囓�2,32,10,22,群益金鼎-桃園,2023-01-13,9189
9103,美德醫療-DR,20,0,20,群益金鼎-桃園,2023-01-13,9189
6806,森崴能源,20,0,20,群益金鼎-桃園,2023-01-13,9189
00773B,中信優先金融債,20,1,19,群益金鼎-桃園,2023-01-13,9189
6118,建達,21,4,17,群益金鼎-桃園,2023-01-13,9189
2363,矽統,16,0,16,群益金鼎-桃園,2023-01-13,9189
4417,金洲,15,0,15,群益金鼎-桃園,2023-01-13,9189
2498,宏達電,17,3,14,群益金鼎-桃園,2023-01-13,9189
2014,中鴻,17,4,13,群益金鼎-桃園,2023-01-13,9189
9955,佳龍,11,0,11,群益金鼎-桃園,2023-01-13,9189
1609,大亞,11,0,11,群益金鼎-桃園,2023-01-13,9189
00642U,期元大S＆P石油,10,0,10,群益金鼎-桃園,2023-01-13,9189
4147,中裕,10,0,10,群益金鼎-桃園,2023-01-13,9189
6788,華景電,22,12,10,群益金鼎-桃園,2023-01-13,9189
5351,鈺創,27,18,9,群益金鼎-桃園,2023-01-13,9189
2385,群光,9,0,9,群益金鼎-桃園,2023-01-13,9189
6182,合晶,10,1,9,群益金鼎-桃園,2023-01-13,9189
6150,撼訊,13,4,9,群益金鼎-桃園,2023-01-13,9189
00680L,元大美債20正2,11,2,9,群益金鼎-桃園,2023-01-13,9189
2606,裕民,10,1,9,群益金鼎-桃園,2023-01-13,9189
2609,陽明,11,4,7,群益金鼎-桃園,2023-01-13,9189
4979,華星光,12,5,7,群益金鼎-桃園,2023-01-13,9189
8081,致新,7,0,7,群益金鼎-桃園,2023-01-13,9189
3576,聯合再生,7,0,7,群益金鼎-桃園,2023-01-13,9189
4167,松瑞藥,10,3,7,群益金鼎-桃園,2023-01-13,9189
00673R,期元大S＆P原油反1,7,0,7,群益金鼎-桃園,2023-01-13,9189
00882,中信中國高股息,9,2,7,群益金鼎-桃園,2023-01-13,9189
1605,華新,13,6,7,群益金鼎-桃園,2023-01-13,9189
2388,威盛,6,0,6,群益金鼎-桃園,2023-01-13,9189
2929,淘帝-KY,6,0,6,群益金鼎-桃園,2023-01-13,9189
1618,合機,6,0,6,群益金鼎-桃園,2023-01-13,9189
8033,雷虎,6,0,6,群益金鼎-桃園,2023-01-13,9189
1734,杏輝,5,0,5,群益金鼎-桃園,2023-01-13,9189
2033,佳大,8,3,5,群益金鼎-桃園,2023-01-13,9189
6213,聯茂,5,0,5,群益金鼎-桃園,2023-01-13,9189
3715,定穎投控,5,0,5,群益金鼎-桃園,2023-01-13,9189
9958,世紀鋼,5,0,5,群益金鼎-桃園,2023-01-13,9189
00893,國泰智能電動車,10,5,5,群益金鼎-桃園,2023-01-13,9189
2359,所羅門,5,0,5,群益金鼎-桃園,2023-01-13,9189
8358,金居,9,4,5,群益金鼎-桃園,2023-01-13,9189
00772B,中信高評級公司債,4,0,4,群益金鼎-桃園,2023-01-13,9189
6274,台燿,5,1,4,群益金鼎-桃園,2023-01-13,9189
00728,第一金工業30,4,0,4,群益金鼎-桃園,2023-01-13,9189
00632R,元大台灣50反1,162,0,162,群益金鼎-桃園,2023-01-16,9189
00637L,元大滬深300正2,127,34,93,群益金鼎-桃園,2023-01-16,9189
00673R,期元大S＆P原油反1,73,0,73,群益金鼎-桃園,2023-01-16,9189
00715L,期街口布蘭特正2,56,2,54,群益金鼎-桃園,2023-01-16,9189
2010,春源,51,0,51,群益金鼎-桃園,2023-01-16,9189
8930,青鋼,38,0,38,群益金鼎-桃園,2023-01-16,9189
00878,國泰永續高股息,57,24,33,群益金鼎-桃園,2023-01-16,9189
2615,萬海,28,3,25,群益金鼎-桃園,2023-01-16,9189
2748,雲品,20,0,20,群益金鼎-桃園,2023-01-16,9189
3705,永信,20,1,19,群益金鼎-桃園,2023-01-16,9189
6770,力積電,20,3,17,群益金鼎-桃園,2023-01-16,9189
9103,美德醫療-DR,15,0,15,群益金鼎-桃園,2023-01-16,9189
5284,jpp-KY,35,21,14,群益金鼎-桃園,2023-01-16,9189
00877,復華中國5G,23,10,13,群益金鼎-桃園,2023-01-16,9189
2886,兆豐金,13,0,13,群益金鼎-桃園,2023-01-16,9189
6141,柏承,15,3,12,群益金鼎-桃園,2023-01-16,9189
2618,長榮航,115,103,12,群益金鼎-桃園,2023-01-16,9189
1560,中砂,12,1,11,群益金鼎-桃園,2023-01-16,9189
00701,國泰股利精選30,11,0,11,群益金鼎-桃園,2023-01-16,9189
5009,榮剛,10,0,10,群益金鼎-桃園,2023-01-16,9189
00669R,國泰美國道瓊反1,10,0,10,群益金鼎-桃園,2023-01-16,9189
00680L,元大美債20正2,10,0,10,群益金鼎-桃園,2023-01-16,9189
2461,光群雷,11,1,10,群益金鼎-桃園,2023-01-16,9189
00679B,元大美債20年,10,0,10,群益金鼎-桃園,2023-01-16,9189
6182,合晶,9,0,9,群益金鼎-桃園,2023-01-16,9189
3664,安瑞-KY,8,0,8,群益金鼎-桃園,2023-01-16,9189
6151,晉倫,8,0,8,群益金鼎-桃園,2023-01-16,9189
00772B,中信高評級公司債,7,0,7,群益金鼎-桃園,2023-01-16,9189
8916,光隆,7,0,7,群益金鼎-桃園,2023-01-16,9189
5011,久陽,6,0,6,群益金鼎-桃園,2023-01-16,9189
00905,FT臺灣Smart,6,0,6,群益金鼎-桃園,2023-01-16,9189
1339,昭輝,6,0,6,群益金鼎-桃園,2023-01-16,9189
00674R,期元大S＆P黃金反1,5,0,5,群益金鼎-桃園,2023-01-16,9189
1444,力麗,5,0,5,群益金鼎-桃園,2023-01-16,9189
2208,台船,5,0,5,群益金鼎-桃園,2023-01-16,9189
1443,立益物流,5,0,5,群益金鼎-桃園,2023-01-16,9189
2243,宏旭-KY,5,0,5,群益金鼎-桃園,2023-01-16,9189
2543,皇昌,5,0,5,群益金鼎-桃園,2023-01-16,9189
2892,第一金,5,0,5,群益金鼎-桃園,2023-01-16,9189
1210,大成,5,0,5,群益金鼎-桃園,2023-01-16,9189
3551,世禾,5,0,5,群益金鼎-桃園,2023-01-16,9189
1219,福壽,5,0,5,群益金鼎-桃園,2023-01-16,9189
3013,晟銘電,7,3,4,群益金鼎-桃園,2023-01-16,9189
3317,尼克森,4,0,4,群益金鼎-桃園,2023-01-16,9189
3034,聯詠,7,3,4,群益金鼎-桃園,2023-01-16,9189
3221,台嘉碩,4,0,4,群益金鼎-桃園,2023-01-16,9189
4440,宜新實業,4,0,4,群益金鼎-桃園,2023-01-16,9189
1618,合機,4,0,4,群益金鼎-桃園,2023-01-16,9189
8081,致新,3,0,3,群益金鼎-桃園,2023-01-16,9189
2481,強茂,4,1,3,群益金鼎-桃園,2023-01-16,9189
00715L,期街口布蘭特正2,88,12,76,群益金鼎-桃園,2023-01-17,9189
2010,春源,60,0,60,群益金鼎-桃園,2023-01-17,9189
00770,國泰北美科技,46,0,46,群益金鼎-桃園,2023-01-17,9189
6141,柏承,38,0,38,群益金鼎-桃園,2023-01-17,9189
0056,元大高股息,38,0,38,群益金鼎-桃園,2023-01-17,9189
2884,玉山金,34,1,33,群益金鼎-桃園,2023-01-17,9189
2374,佳能,32,0,32,群益金鼎-桃園,2023-01-17,9189
6806,森崴能源,33,1,32,群益金鼎-桃園,2023-01-17,9189
2634,漢翔,31,0,31,群益金鼎-桃園,2023-01-17,9189
6535,順藥,30,0,30,群益金鼎-桃園,2023-01-17,9189
9955,佳龍,36,13,23,群益金鼎-桃園,2023-01-17,9189
9933,中鼎,22,0,22,群益金鼎-桃園,2023-01-17,9189
00637L,元大滬深300正2,22,1,21,群益金鼎-桃園,2023-01-17,9189
8044,網家,24,4,20,群益金鼎-桃園,2023-01-17,9189
8069,元太,23,4,19,群益金鼎-桃園,2023-01-17,9189
2883,凱基金,19,2,17,群益金鼎-桃園,2023-01-17,9189
2409,友達,14,0,14,群益金鼎-桃園,2023-01-17,9189
00878,國泰永續高股息,14,2,12,群益金鼎-桃園,2023-01-17,9189
8016,矽創,12,1,11,群益金鼎-桃園,2023-01-17,9189
1101,台泥,11,1,10,群益金鼎-桃園,2023-01-17,9189
2352,佳世達,10,0,10,群益金鼎-桃園,2023-01-17,9189
00773B,中信優先金融債,10,0,10,群益金鼎-桃園,2023-01-17,9189
4128,中天,12,2,10,群益金鼎-桃園,2023-01-17,9189
1806,冠軍,10,0,10,群益金鼎-桃園,2023-01-17,9189
1210,大成,10,0,10,群益金鼎-桃園,2023-01-17,9189
4979,華星光,40,30,10,群益金鼎-桃園,2023-01-17,9189
00680L,元大美債20正2,12,3,9,群益金鼎-桃園,2023-01-17,9189
5608,四維航,11,3,8,群益金鼎-桃園,2023-01-17,9189
1339,昭輝,8,0,8,群益金鼎-桃園,2023-01-17,9189
2886,兆豐金,8,0,8,群益金鼎-桃園,2023-01-17,9189
1783,和康生,7,0,7,群益金鼎-桃園,2023-01-17,9189
1519,華城,7,0,7,群益金鼎-桃園,2023-01-17,9189
2882,國泰金,10,4,6,群益金鼎-桃園,2023-01-17,9189
3498,陽程,6,0,6,群益金鼎-桃園,2023-01-17,9189
2618,長榮航,8,2,6,群益金鼎-桃園,2023-01-17,9189
6533,晶心科,6,0,6,群益金鼎-桃園,2023-01-17,9189
1722,台肥,6,0,6,群益金鼎-桃園,2023-01-17,9189
3024,憶聲,5,0,5,群益金鼎-桃園,2023-01-17,9189
1595,川寶,5,0,5,群益金鼎-桃園,2023-01-17,9189
00655L,國泰中國A50正2,5,0,5,群益金鼎-桃園,2023-01-17,9189
1227,佳格,5,0,5,群益金鼎-桃園,2023-01-17,9189
6829,千附精密,5,0,5,群益金鼎-桃園,2023-01-17,9189
2482,連宇,7,2,5,群益金鼎-桃園,2023-01-17,9189
00679B,元大美債20年,5,0,5,群益金鼎-桃園,2023-01-17,9189
00673R,期元大S＆P原油反1,5,0,5,群益金鼎-桃園,2023-01-17,9189
1734,杏輝,5,0,5,群益金鼎-桃園,2023-01-17,9189
4114,健喬,7,3,4,群益金鼎-桃園,2023-01-17,9189
2368,金像電,4,0,4,群益金鼎-桃園,2023-01-17,9189
6531,愛普*,4,0,4,群益金鼎-桃園,2023-01-17,9189
3693,營邦,24,20,4,群益金鼎-桃園,2023-01-17,9189
2891,中信金,202,4,198,群益金鼎-桃園,2023-01-30,9189
2317,鴻海,82,2,80,群益金鼎-桃園,2023-01-30,9189
00632R,元大台灣50反1,105,45,60,群益金鼎-桃園,2023-01-30,9189
00902,中信電池及儲能,100,49,51,群益金鼎-桃園,2023-01-30,9189
3576,聯合再生,47,2,45,群益金鼎-桃園,2023-01-30,9189
8930,青鋼,42,0,42,群益金鼎-桃園,2023-01-30,9189
00688L,國泰20年美債正2,36,0,36,群益金鼎-桃園,2023-01-30,9189
2748,雲品,30,0,30,群益金鼎-桃園,2023-01-30,9189
2204,中華,32,6,26,群益金鼎-桃園,2023-01-30,9189
8086,宏捷科,23,0,23,群益金鼎-桃園,2023-01-30,9189
2014,中鴻,25,6,19,群益金鼎-桃園,2023-01-30,9189
2618,長榮航,22,5,17,群益金鼎-桃園,2023-01-30,9189
2915,潤泰全,22,6,16,群益金鼎-桃園,2023-01-30,9189
5009,榮剛,10,0,10,群益金鼎-桃園,2023-01-30,9189
4532,瑞智,10,0,10,群益金鼎-桃園,2023-01-30,9189
4943,康控-KY,10,0,10,群益金鼎-桃園,2023-01-30,9189
2017,官田鋼,10,0,10,群益金鼎-桃園,2023-01-30,9189
2368,金像電,20,10,10,群益金鼎-桃園,2023-01-30,9189
4958,臻鼎-KY,10,0,10,群益金鼎-桃園,2023-01-30,9189
00905,FT臺灣Smart,10,1,9,群益金鼎-桃園,2023-01-30,9189
2413,環科,9,0,9,群益金鼎-桃園,2023-01-30,9189
1104,環泥,8,0,8,群益金鼎-桃園,2023-01-30,9189
2484,希華,8,0,8,群益金鼎-桃園,2023-01-30,9189
00882,中信中國高股息,9,2,7,群益金鼎-桃園,2023-01-30,9189
8996,高力,18,11,7,群益金鼎-桃園,2023-01-30,9189
1734,杏輝,7,0,7,群益金鼎-桃園,2023-01-30,9189
2313,華通,20,13,7,群益金鼎-桃園,2023-01-30,9189
00720B,元大投資級公司債,7,0,7,群益金鼎-桃園,2023-01-30,9189
2603,長榮,6,0,6,群益金鼎-桃園,2023-01-30,9189
8044,網家,8,2,6,群益金鼎-桃園,2023-01-30,9189
8069,元太,14,9,5,群益金鼎-桃園,2023-01-30,9189
2610,華航,18,13,5,群益金鼎-桃園,2023-01-30,9189
9945,潤泰新,15,10,5,群益金鼎-桃園,2023-01-30,9189
2236,百達-KY,5,0,5,群益金鼎-桃園,2023-01-30,9189
3558,神準,5,0,5,群益金鼎-桃園,2023-01-30,9189
1802,台玻,5,0,5,群益金鼎-桃園,2023-01-30,9189
00653L,富邦印度正2,5,0,5,群益金鼎-桃園,2023-01-30,9189
1815,富喬,5,0,5,群益金鼎-桃園,2023-01-30,9189
3189,景碩,6,1,5,群益金鼎-桃園,2023-01-30,9189
00674R,期元大S＆P黃金反1,5,0,5,群益金鼎-桃園,2023-01-30,9189
00641R,富邦日本反1,5,0,5,群益金鼎-桃園,2023-01-30,9189
3047,訊舟,5,0,5,群益金鼎-桃園,2023-01-30,9189
4909,新復興,5,0,5,群益金鼎-桃園,2023-01-30,9189
2031,新光鋼,4,0,4,群益金鼎-桃園,2023-01-30,9189
1611,中電,6,2,4,群益金鼎-桃園,2023-01-30,9189
1616,億泰,4,0,4,群益金鼎-桃園,2023-01-30,9189
6782,視陽,4,0,4,群益金鼎-桃園,2023-01-30,9189
6830,汎銓,4,0,4,群益金鼎-桃園,2023-01-30,9189
3218,大學光,4,0,4,群益金鼎-桃園,2023-01-30,9189
4105,東洋,4,0,4,群益金鼎-桃園,2023-01-30,9189
00905,FT臺灣Smart,42,0,42,群益金鼎-桃園,2023-01-31,9189
00882,中信中國高股息,31,0,31,群益金鼎-桃園,2023-01-31,9189
00632R,元大台灣50反1,40,10,30,群益金鼎-桃園,2023-01-31,9189
2301,光寶科,31,1,30,群益金鼎-桃園,2023-01-31,9189
6770,力積電,40,11,29,群益金鼎-桃園,2023-01-31,9189
3017,奇鋐,26,0,26,群益金鼎-桃園,2023-01-31,9189
4128,中天,22,0,22,群益金鼎-桃園,2023-01-31,9189
4726,永昕,20,0,20,群益金鼎-桃園,2023-01-31,9189
00669R,國泰美國道瓊反1,20,0,20,群益金鼎-桃園,2023-01-31,9189
00680L,元大美債20正2,20,0,20,群益金鼎-桃園,2023-01-31,9189
8930,青鋼,20,0,20,群益金鼎-桃園,2023-01-31,9189
2002,中鋼,20,0,20,群益金鼎-桃園,2023-01-31,9189
2892,第一金,19,0,19,群益金鼎-桃園,2023-01-31,9189
6443,元晶,32,13,19,群益金鼎-桃園,2023-01-31,9189
2884,玉山金,19,0,19,群益金鼎-桃園,2023-01-31,9189
5880,合庫金,18,0,18,群益金鼎-桃園,2023-01-31,9189
00720B,元大投資級公司債,18,0,18,群益金鼎-桃園,2023-01-31,9189
2354,鴻準,17,0,17,群益金鼎-桃園,2023-01-31,9189
00878,國泰永續高股息,23,7,16,群益金鼎-桃園,2023-01-31,9189
2482,連宇,54,37,17,群益金鼎-桃園,2023-01-31,9189
8038,長園科,17,1,16,群益金鼎-桃園,2023-01-31,9189
2014,中鴻,31,17,14,群益金鼎-桃園,2023-01-31,9189
4536,拓凱,14,0,14,群益金鼎-桃園,2023-01-31,9189
9933,中鼎,15,1,14,群益金鼎-桃園,2023-01-31,9189
8034,榮群,13,0,13,群益金鼎-桃園,2023-01-31,9189
9945,潤泰新,16,4,12,群益金鼎-桃園,2023-01-31,9189
3380,明泰,12,0,12,群益金鼎-桃園,2023-01-31,9189
2317,鴻海,46,34,12,群益金鼎-桃園,2023-01-31,9189
2201,裕隆,32,21,11,群益金鼎-桃園,2023-01-31,9189
3059,華晶科,11,0,11,群益金鼎-桃園,2023-01-31,9189
3217,優群,11,0,11,群益金鼎-桃園,2023-01-31,9189
2105,正新,11,0,11,群益金鼎-桃園,2023-01-31,9189
2882,國泰金,11,1,10,群益金鼎-桃園,2023-01-31,9189
2340,台亞,10,0,10,群益金鼎-桃園,2023-01-31,9189
1514,亞力,10,0,10,群益金鼎-桃園,2023-01-31,9189
1795,美時,14,4,10,群益金鼎-桃園,2023-01-31,9189
6235,華孚,16,6,10,群益金鼎-桃園,2023-01-31,9189
00671R,富邦NASDAQ反1,20,10,10,群益金鼎-桃園,2023-01-31,9189
00895,富邦未來車,10,0,10,群益金鼎-桃園,2023-01-31,9189
2007,燁興,10,1,9,群益金鼎-桃園,2023-01-31,9189
4746,台耀,9,0,9,群益金鼎-桃園,2023-01-31,9189
5871,中租-KY,13,5,8,群益金鼎-桃園,2023-01-31,9189
4938,和碩,8,0,8,群益金鼎-桃園,2023-01-31,9189
1608,華榮,11,3,8,群益金鼎-桃園,2023-01-31,9189
6806,森崴能源,11,3,8,群益金鼎-桃園,2023-01-31,9189
4133,亞諾法,7,0,7,群益金鼎-桃園,2023-01-31,9189
2352,佳世達,10,3,7,群益金鼎-桃園,2023-01-31,9189
2885,元大金,7,0,7,群益金鼎-桃園,2023-01-31,9189
3321,同泰,7,0,7,群益金鼎-桃園,2023-01-31,9189
2890,永豐金,8,2,6,群益金鼎-桃園,2023-01-31,9189
6806,森崴能源,84,5,79,群益金鼎-桃園,2023-02-01,9189
2009,第一銅,71,12,59,群益金鼎-桃園,2023-02-01,9189
00673R,期元大S＆P原油反1,53,0,53,群益金鼎-桃園,2023-02-01,9189
00715L,期街口布蘭特正2,50,12,38,群益金鼎-桃園,2023-02-01,9189
00891,中信關鍵半導體,30,0,30,群益金鼎-桃園,2023-02-01,9189
00905,FT臺灣Smart,28,0,28,群益金鼎-桃園,2023-02-01,9189
5425,台半,86,58,28,群益金鼎-桃園,2023-02-01,9189
00632R,元大台灣50反1,35,7,28,群益金鼎-桃園,2023-02-01,9189
3521,鴻翊,25,0,25,群益金鼎-桃園,2023-02-01,9189
6235,華孚,23,0,23,群益金鼎-桃園,2023-02-01,9189
2317,鴻海,22,1,21,群益金鼎-桃園,2023-02-01,9189
3083,網龍,21,1,20,群益金鼎-桃園,2023-02-01,9189
2014,中鴻,42,23,19,群益金鼎-桃園,2023-02-01,9189
6197,佳必琪,21,3,18,群益金鼎-桃園,2023-02-01,9189
2486,一詮,18,0,18,群益金鼎-桃園,2023-02-01,9189
2609,陽明,20,4,16,群益金鼎-桃園,2023-02-01,9189
1513,中興電,23,8,15,群益金鼎-桃園,2023-02-01,9189
3558,神準,31,16,15,群益金鼎-桃園,2023-02-01,9189
00720B,元大投資級公司債,15,0,15,群益金鼎-桃園,2023-02-01,9189
1536,和大,15,0,15,群益金鼎-桃園,2023-02-01,9189
00637L,元大滬深300正2,32,18,14,群益金鼎-桃園,2023-02-01,9189
2481,強茂,14,1,13,群益金鼎-桃園,2023-02-01,9189
2402,毅嘉,13,0,13,群益金鼎-桃園,2023-02-01,9189
00680L,元大美債20正2,13,0,13,群益金鼎-桃園,2023-02-01,9189
1701,中化,18,6,12,群益金鼎-桃園,2023-02-01,9189
2881,富邦金,11,0,11,群益金鼎-桃園,2023-02-01,9189
9925,新保,11,0,11,群益金鼎-桃園,2023-02-01,9189
00728,第一金工業30,11,0,11,群益金鼎-桃園,2023-02-01,9189
2454,聯發科,13,2,11,群益金鼎-桃園,2023-02-01,9189
2891,中信金,10,0,10,群益金鼎-桃園,2023-02-01,9189
4931,新盛力,11,1,10,群益金鼎-桃園,2023-02-01,9189
2345,智邦,10,0,10,群益金鼎-桃園,2023-02-01,9189
2882,國泰金,11,1,10,群益金鼎-桃園,2023-02-01,9189
2027,大成鋼,25,15,10,群益金鼎-桃園,2023-02-01,9189
3675,德微,16,6,10,群益金鼎-桃園,2023-02-01,9189
2332,友訊,10,0,10,群益金鼎-桃園,2023-02-01,9189
2329,華泰,10,0,10,群益金鼎-桃園,2023-02-01,9189
00679B,元大美債20年,10,0,10,群益金鼎-桃園,2023-02-01,9189
4743,合一,17,8,9,群益金鼎-桃園,2023-02-01,9189
1529,樂事綠能,12,3,9,群益金鼎-桃園,2023-02-01,9189
1609,大亞,24,15,9,群益金鼎-桃園,2023-02-01,9189
3027,盛達,8,0,8,群益金鼎-桃園,2023-02-01,9189
00878,國泰永續高股息,8,0,8,群益金鼎-桃園,2023-02-01,9189
3037,欣興,24,16,8,群益金鼎-桃園,2023-02-01,9189
1605,華新,22,14,8,群益金鼎-桃園,2023-02-01,9189
6206,飛捷,8,1,7,群益金鼎-桃園,2023-02-01,9189
4904,遠傳,7,0,7,群益金鼎-桃園,2023-02-01,9189
1584,精剛,9,2,7,群益金鼎-桃園,2023-02-01,9189
4736,泰博,7,0,7,群益金鼎-桃園,2023-02-01,9189
2383,台光電,8,1,7,群益金鼎-桃園,2023-02-01,9189
00632R,元大台灣50反1,250,0,250,群益金鼎-桃園,2023-02-02,9189
00902,中信電池及儲能,100,0,100,群益金鼎-桃園,2023-02-02,9189
8403,盛弘,104,5,99,群益金鼎-桃園,2023-02-02,9189
2882,國泰金,105,25,80,群益金鼎-桃園,2023-02-02,9189
1815,富喬,60,0,60,群益金鼎-桃園,2023-02-02,9189
00715L,期街口布蘭特正2,59,0,59,群益金鼎-桃園,2023-02-02,9189
00878,國泰永續高股息,61,5,56,群益金鼎-桃園,2023-02-02,9189
00664R,國泰臺灣加權反1,54,0,54,群益金鼎-桃園,2023-02-02,9189
2867,三商壽,51,0,51,群益金鼎-桃園,2023-02-02,9189
6443,元晶,72,32,40,群益金鼎-桃園,2023-02-02,9189
2511,太子,33,0,33,群益金鼎-桃園,2023-02-02,9189
00665L,富邦�琤肭磪囓�2,30,0,30,群益金鼎-桃園,2023-02-02,9189
6126,信音,30,0,30,群益金鼎-桃園,2023-02-02,9189
2317,鴻海,53,26,27,群益金鼎-桃園,2023-02-02,9189
2891,中信金,22,0,22,群益金鼎-桃園,2023-02-02,9189
00896,中信綠能及電動車,21,0,21,群益金鼎-桃園,2023-02-02,9189
6111,大宇資,23,3,20,群益金鼎-桃園,2023-02-02,9189
00882,中信中國高股息,20,0,20,群益金鼎-桃園,2023-02-02,9189
4130,健亞,22,2,20,群益金鼎-桃園,2023-02-02,9189
8930,青鋼,20,0,20,群益金鼎-桃園,2023-02-02,9189
2457,飛宏,21,2,19,群益金鼎-桃園,2023-02-02,9189
3481,群創,20,1,19,群益金鼎-桃園,2023-02-02,9189
5258,虹堡,23,4,19,群益金鼎-桃園,2023-02-02,9189
2609,陽明,35,17,18,群益金鼎-桃園,2023-02-02,9189
3264,欣銓,24,6,18,群益金鼎-桃園,2023-02-02,9189
9945,潤泰新,40,23,17,群益金鼎-桃園,2023-02-02,9189
2887,台新金,16,0,16,群益金鼎-桃園,2023-02-02,9189
00720B,元大投資級公司債,26,10,16,群益金鼎-桃園,2023-02-02,9189
2801,彰銀,16,0,16,群益金鼎-桃園,2023-02-02,9189
2618,長榮航,78,62,16,群益金鼎-桃園,2023-02-02,9189
00903,富邦元宇宙,15,0,15,群益金鼎-桃園,2023-02-02,9189
9933,中鼎,14,0,14,群益金鼎-桃園,2023-02-02,9189
3491,昇達科,14,0,14,群益金鼎-桃園,2023-02-02,9189
00671R,富邦NASDAQ反1,15,1,14,群益金鼎-桃園,2023-02-02,9189
6432,今展科,14,0,14,群益金鼎-桃園,2023-02-02,9189
2014,中鴻,14,1,13,群益金鼎-桃園,2023-02-02,9189
3624,光頡,15,3,12,群益金鼎-桃園,2023-02-02,9189
1785,光洋科,13,1,12,群益金鼎-桃園,2023-02-02,9189
5425,台半,18,7,11,群益金鼎-桃園,2023-02-02,9189
4979,華星光,23,12,11,群益金鼎-桃園,2023-02-02,9189
2023,燁輝,11,0,11,群益金鼎-桃園,2023-02-02,9189
4114,健喬,27,16,11,群益金鼎-桃園,2023-02-02,9189
6806,森崴能源,15,5,10,群益金鼎-桃園,2023-02-02,9189
5284,jpp-KY,11,1,10,群益金鼎-桃園,2023-02-02,9189
5353,台林,13,3,10,群益金鼎-桃園,2023-02-02,9189
2885,元大金,10,0,10,群益金鼎-桃園,2023-02-02,9189
3715,定穎投控,10,0,10,群益金鼎-桃園,2023-02-02,9189
006205,富邦上証,10,0,10,群益金鼎-桃園,2023-02-02,9189
0056,元大高股息,15,6,9,群益金鼎-桃園,2023-02-02,9189
3017,奇鋐,14,5,9,群益金鼎-桃園,2023-02-02,9189
00878,國泰永續高股息,246,15,231,群益金鼎-桃園,2023-02-03,9189
2891,中信金,221,5,216,群益金鼎-桃園,2023-02-03,9189
2892,第一金,200,2,198,群益金鼎-桃園,2023-02-03,9189
2886,兆豐金,203,11,192,群益金鼎-桃園,2023-02-03,9189
00632R,元大台灣50反1,136,30,106,群益金鼎-桃園,2023-02-03,9189
1101,台泥,105,1,104,群益金鼎-桃園,2023-02-03,9189
2884,玉山金,101,0,101,群益金鼎-桃園,2023-02-03,9189
2002,中鋼,101,2,99,群益金鼎-桃園,2023-02-03,9189
5009,榮剛,95,20,75,群益金鼎-桃園,2023-02-03,9189
6235,華孚,101,30,71,群益金鼎-桃園,2023-02-03,9189
2498,宏達電,139,70,69,群益金鼎-桃園,2023-02-03,9189
00753L,中信中國50正2,58,0,58,群益金鼎-桃園,2023-02-03,9189
00637L,元大滬深300正2,254,202,52,群益金鼎-桃園,2023-02-03,9189
2736,富野,36,0,36,群益金鼎-桃園,2023-02-03,9189
3037,欣興,38,6,32,群益金鼎-桃園,2023-02-03,9189
1417,嘉裕,30,0,30,群益金鼎-桃園,2023-02-03,9189
4979,華星光,39,9,30,群益金鼎-桃園,2023-02-03,9189
2332,友訊,30,0,30,群益金鼎-桃園,2023-02-03,9189
00650L,復華香港正2,26,0,26,群益金鼎-桃園,2023-02-03,9189
00683L,期元大美元指正2,29,3,26,群益金鼎-桃園,2023-02-03,9189
00903,富邦元宇宙,25,2,23,群益金鼎-桃園,2023-02-03,9189
6118,建達,40,17,23,群益金鼎-桃園,2023-02-03,9189
00642U,期元大S＆P石油,22,0,22,群益金鼎-桃園,2023-02-03,9189
5608,四維航,37,16,21,群益金鼎-桃園,2023-02-03,9189
3704,合勤控,23,2,21,群益金鼎-桃園,2023-02-03,9189
00752,中信中國50,20,0,20,群益金鼎-桃園,2023-02-03,9189
00710B,復華彭博非投等債,20,0,20,群益金鼎-桃園,2023-02-03,9189
00671R,富邦NASDAQ反1,20,0,20,群益金鼎-桃園,2023-02-03,9189
3481,群創,24,5,19,群益金鼎-桃園,2023-02-03,9189
1216,統一,18,0,18,群益金鼎-桃園,2023-02-03,9189
8046,南電,22,4,18,群益金鼎-桃園,2023-02-03,9189
2201,裕隆,20,3,17,群益金鼎-桃園,2023-02-03,9189
6245,立端,29,12,17,群益金鼎-桃園,2023-02-03,9189
1810,和成,15,0,15,群益金鼎-桃園,2023-02-03,9189
3289,宜特,15,0,15,群益金鼎-桃園,2023-02-03,9189
1513,中興電,19,5,14,群益金鼎-桃園,2023-02-03,9189
4116,明基醫,22,8,14,群益金鼎-桃園,2023-02-03,9189
6190,萬泰科,16,2,14,群益金鼎-桃園,2023-02-03,9189
2388,威盛,27,13,14,群益金鼎-桃園,2023-02-03,9189
2383,台光電,15,1,14,群益金鼎-桃園,2023-02-03,9189
2317,鴻海,43,30,13,群益金鼎-桃園,2023-02-03,9189
2444,兆勁,13,0,13,群益金鼎-桃園,2023-02-03,9189
3322,建舜電,13,0,13,群益金鼎-桃園,2023-02-03,9189
3047,訊舟,13,0,13,群益金鼎-桃園,2023-02-03,9189
3189,景碩,13,1,12,群益金鼎-桃園,2023-02-03,9189
1443,立益物流,14,3,11,群益金鼎-桃園,2023-02-03,9189
00772B,中信高評級公司債,11,0,11,群益金鼎-桃園,2023-02-03,9189
2634,漢翔,21,10,11,群益金鼎-桃園,2023-02-03,9189
1305,華夏,11,0,11,群益金鼎-桃園,2023-02-03,9189
2880,華南金,11,0,11,群益金鼎-桃園,2023-02-03,9189
00878,國泰永續高股息,83,13,70,群益金鼎-桃園,2023-02-06,9189
4114,健喬,54,3,51,群益金鼎-桃園,2023-02-06,9189
00715L,期街口布蘭特正2,47,0,47,群益金鼎-桃園,2023-02-06,9189
1605,華新,48,8,40,群益金鼎-桃園,2023-02-06,9189
2618,長榮航,63,25,38,群益金鼎-桃園,2023-02-06,9189
00637L,元大滬深300正2,42,5,37,群益金鼎-桃園,2023-02-06,9189
00720B,元大投資級公司債,36,0,36,群益金鼎-桃園,2023-02-06,9189
00772B,中信高評級公司債,30,0,30,群益金鼎-桃園,2023-02-06,9189
00903,富邦元宇宙,27,0,27,群益金鼎-桃園,2023-02-06,9189
1711,永光,25,0,25,群益金鼎-桃園,2023-02-06,9189
2344,華邦電,21,0,21,群益金鼎-桃園,2023-02-06,9189
9945,潤泰新,21,2,19,群益金鼎-桃園,2023-02-06,9189
6770,力積電,21,3,18,群益金鼎-桃園,2023-02-06,9189
00665L,富邦�琤肭磪囓�2,18,0,18,群益金鼎-桃園,2023-02-06,9189
2890,永豐金,25,7,18,群益金鼎-桃園,2023-02-06,9189
9958,世紀鋼,117,100,17,群益金鼎-桃園,2023-02-06,9189
2103,台橡,17,0,17,群益金鼎-桃園,2023-02-06,9189
6016,康和證,18,2,16,群益金鼎-桃園,2023-02-06,9189
00679B,元大美債20年,16,0,16,群益金鼎-桃園,2023-02-06,9189
2609,陽明,30,15,15,群益金鼎-桃園,2023-02-06,9189
1101,台泥,31,16,15,群益金鼎-桃園,2023-02-06,9189
9105,泰金寶-DR,15,0,15,群益金鼎-桃園,2023-02-06,9189
00753L,中信中國50正2,25,10,15,群益金鼎-桃園,2023-02-06,9189
2303,聯電,44,30,14,群益金鼎-桃園,2023-02-06,9189
2354,鴻準,17,4,13,群益金鼎-桃園,2023-02-06,9189
6548,長科*,13,0,13,群益金鼎-桃園,2023-02-06,9189
00882,中信中國高股息,12,0,12,群益金鼎-桃園,2023-02-06,9189
2436,偉詮電,15,3,12,群益金鼎-桃園,2023-02-06,9189
00885,富邦越南,45,33,12,群益金鼎-桃園,2023-02-06,9189
2368,金像電,16,4,12,群益金鼎-桃園,2023-02-06,9189
6546,正基,20,9,11,群益金鼎-桃園,2023-02-06,9189
4979,華星光,16,6,10,群益金鼎-桃園,2023-02-06,9189
2101,南港,10,0,10,群益金鼎-桃園,2023-02-06,9189
1718,中纖,10,0,10,群益金鼎-桃園,2023-02-06,9189
2897,王道銀行,10,0,10,群益金鼎-桃園,2023-02-06,9189
3093,港建*,10,0,10,群益金鼎-桃園,2023-02-06,9189
2855,統一證,10,0,10,群益金鼎-桃園,2023-02-06,9189
8227,巨有科技,11,1,10,群益金鼎-桃園,2023-02-06,9189
2603,長榮,20,12,8,群益金鼎-桃園,2023-02-06,9189
8996,高力,13,5,8,群益金鼎-桃園,2023-02-06,9189
2888,新光金,8,0,8,群益金鼎-桃園,2023-02-06,9189
00900,富邦特選高股息30,8,0,8,群益金鼎-桃園,2023-02-06,9189
1513,中興電,12,5,7,群益金鼎-桃園,2023-02-06,9189
00642U,期元大S＆P石油,7,0,7,群益金鼎-桃園,2023-02-06,9189
1783,和康生,48,41,7,群益金鼎-桃園,2023-02-06,9189
2444,兆勁,7,0,7,群益金鼎-桃園,2023-02-06,9189
6829,千附精密,7,0,7,群益金鼎-桃園,2023-02-06,9189
3037,欣興,18,11,7,群益金鼎-桃園,2023-02-06,9189
8046,南電,7,1,6,群益金鼎-桃園,2023-02-06,9189
00631L,元大台灣50正2,6,0,6,群益金鼎-桃園,2023-02-06,9189
00680L,元大美債20正2,136,0,136,群益金鼎-桃園,2023-02-07,9189
2610,華航,122,3,119,群益金鼎-桃園,2023-02-07,9189
3624,光頡,84,5,79,群益金鼎-桃園,2023-02-07,9189
1605,華新,124,72,52,群益金鼎-桃園,2023-02-07,9189
2891,中信金,31,0,31,群益金鼎-桃園,2023-02-07,9189
00878,國泰永續高股息,29,0,29,群益金鼎-桃園,2023-02-07,9189
2317,鴻海,32,3,29,群益金鼎-桃園,2023-02-07,9189
00891,中信關鍵半導體,26,0,26,群益金鼎-桃園,2023-02-07,9189
2007,燁興,24,0,24,群益金鼎-桃園,2023-02-07,9189
3481,群創,51,27,24,群益金鼎-桃園,2023-02-07,9189
00642U,期元大S＆P石油,22,0,22,群益金鼎-桃園,2023-02-07,9189
1701,中化,35,14,21,群益金鼎-桃園,2023-02-07,9189
00679B,元大美債20年,21,0,21,群益金鼎-桃園,2023-02-07,9189
2332,友訊,20,0,20,群益金鼎-桃園,2023-02-07,9189
6129,普誠,21,3,18,群益金鼎-桃園,2023-02-07,9189
2498,宏達電,39,21,18,群益金鼎-桃園,2023-02-07,9189
00720B,元大投資級公司債,18,1,17,群益金鼎-桃園,2023-02-07,9189
3548,兆利,16,0,16,群益金鼎-桃園,2023-02-07,9189
0056,元大高股息,15,0,15,群益金鼎-桃園,2023-02-07,9189
4726,永昕,18,4,14,群益金鼎-桃園,2023-02-07,9189
00772B,中信高評級公司債,14,0,14,群益金鼎-桃園,2023-02-07,9189
2884,玉山金,13,0,13,群益金鼎-桃園,2023-02-07,9189
6806,森崴能源,13,0,13,群益金鼎-桃園,2023-02-07,9189
2609,陽明,14,2,12,群益金鼎-桃園,2023-02-07,9189
6541,泰福-KY,12,0,12,群益金鼎-桃園,2023-02-07,9189
8426,紅木-KY,12,0,12,群益金鼎-桃園,2023-02-07,9189
3047,訊舟,12,0,12,群益金鼎-桃園,2023-02-07,9189
4114,健喬,36,24,12,群益金鼎-桃園,2023-02-07,9189
4107,邦特,11,0,11,群益金鼎-桃園,2023-02-07,9189
3093,港建*,17,7,10,群益金鼎-桃園,2023-02-07,9189
5353,台林,11,1,10,群益金鼎-桃園,2023-02-07,9189
2368,金像電,13,3,10,群益金鼎-桃園,2023-02-07,9189
6278,台表科,20,10,10,群益金鼎-桃園,2023-02-07,9189
4908,前鼎,10,0,10,群益金鼎-桃園,2023-02-07,9189
00893,國泰智能電動車,16,6,10,群益金鼎-桃園,2023-02-07,9189
2903,遠百,10,0,10,群益金鼎-桃園,2023-02-07,9189
2484,希華,13,3,10,群益金鼎-桃園,2023-02-07,9189
5464,霖宏,10,0,10,群益金鼎-桃園,2023-02-07,9189
2330,台積電,15,6,9,群益金鼎-桃園,2023-02-07,9189
2888,新光金,10,1,9,群益金鼎-桃園,2023-02-07,9189
1417,嘉裕,22,13,9,群益金鼎-桃園,2023-02-07,9189
2608,嘉里大榮,8,0,8,群益金鼎-桃園,2023-02-07,9189
1795,美時,26,18,8,群益金鼎-桃園,2023-02-07,9189
6282,康舒,21,13,8,群益金鼎-桃園,2023-02-07,9189
9958,世紀鋼,8,0,8,群益金鼎-桃園,2023-02-07,9189
2313,華通,7,0,7,群益金鼎-桃園,2023-02-07,9189
8069,元太,9,2,7,群益金鼎-桃園,2023-02-07,9189
2388,威盛,7,0,7,群益金鼎-桃園,2023-02-07,9189
6509,聚和,10,3,7,群益金鼎-桃園,2023-02-07,9189
00885,富邦越南,8,1,7,群益金鼎-桃園,2023-02-07,9189
00680L,元大美債20正2,248,0,248,群益金鼎-桃園,2023-02-08,9189
00632R,元大台灣50反1,178,0,178,群益金鼎-桃園,2023-02-08,9189
00674R,期元大S＆P黃金反1,150,0,150,群益金鼎-桃園,2023-02-08,9189
8930,青鋼,52,0,52,群益金鼎-桃園,2023-02-08,9189
2204,中華,50,0,50,群益金鼎-桃園,2023-02-08,9189
00715L,期街口布蘭特正2,89,46,43,群益金鼎-桃園,2023-02-08,9189
2888,新光金,41,0,41,群益金鼎-桃園,2023-02-08,9189
5009,榮剛,39,0,39,群益金鼎-桃園,2023-02-08,9189
2457,飛宏,40,1,39,群益金鼎-桃園,2023-02-08,9189
00679B,元大美債20年,35,0,35,群益金鼎-桃園,2023-02-08,9189
2317,鴻海,24,2,22,群益金鼎-桃園,2023-02-08,9189
6244,茂迪,22,0,22,群益金鼎-桃園,2023-02-08,9189
9958,世紀鋼,22,0,22,群益金鼎-桃園,2023-02-08,9189
4116,明基醫,22,1,21,群益金鼎-桃園,2023-02-08,9189
4726,永昕,24,3,21,群益金鼎-桃園,2023-02-08,9189
1905,華紙,20,0,20,群益金鼎-桃園,2023-02-08,9189
00895,富邦未來車,20,0,20,群益金鼎-桃園,2023-02-08,9189
4114,健喬,56,37,19,群益金鼎-桃園,2023-02-08,9189
00671R,富邦NASDAQ反1,20,2,18,群益金鼎-桃園,2023-02-08,9189
6118,建達,21,3,18,群益金鼎-桃園,2023-02-08,9189
2338,光罩,21,4,17,群益金鼎-桃園,2023-02-08,9189
2883,凱基金,17,0,17,群益金鼎-桃園,2023-02-08,9189
5439,高技,17,0,17,群益金鼎-桃園,2023-02-08,9189
2498,宏達電,22,8,14,群益金鼎-桃園,2023-02-08,9189
2474,可成,33,20,13,群益金鼎-桃園,2023-02-08,9189
2014,中鴻,13,0,13,群益金鼎-桃園,2023-02-08,9189
00637L,元大滬深300正2,15,2,13,群益金鼎-桃園,2023-02-08,9189
1513,中興電,20,8,12,群益金鼎-桃園,2023-02-08,9189
3022,威強電,17,5,12,群益金鼎-桃園,2023-02-08,9189
1605,華新,33,22,11,群益金鼎-桃園,2023-02-08,9189
6153,嘉聯益,11,0,11,群益金鼎-桃園,2023-02-08,9189
3576,聯合再生,11,0,11,群益金鼎-桃園,2023-02-08,9189
8050,廣積,12,1,11,群益金鼎-桃園,2023-02-08,9189
00772B,中信高評級公司債,10,0,10,群益金鼎-桃園,2023-02-08,9189
2867,三商壽,10,0,10,群益金鼎-桃園,2023-02-08,9189
3013,晟銘電,15,5,10,群益金鼎-桃園,2023-02-08,9189
1599,宏佳騰,10,0,10,群益金鼎-桃園,2023-02-08,9189
3322,建舜電,10,0,10,群益金鼎-桃園,2023-02-08,9189
3701,大眾控,10,0,10,群益金鼎-桃園,2023-02-08,9189
2892,第一金,10,0,10,群益金鼎-桃園,2023-02-08,9189
2393,億光,10,0,10,群益金鼎-桃園,2023-02-08,9189
00780B,國泰A級金融債,10,0,10,群益金鼎-桃園,2023-02-08,9189
2344,華邦電,12,2,10,群益金鼎-桃園,2023-02-08,9189
2607,榮運,10,1,9,群益金鼎-桃園,2023-02-08,9189
3624,光頡,9,0,9,群益金鼎-桃園,2023-02-08,9189
00720B,元大投資級公司債,9,0,9,群益金鼎-桃園,2023-02-08,9189
9925,新保,8,0,8,群益金鼎-桃園,2023-02-08,9189
2929,淘帝-KY,8,0,8,群益金鼎-桃園,2023-02-08,9189
6546,正基,8,0,8,群益金鼎-桃園,2023-02-08,9189
3521,鴻翊,7,0,7,群益金鼎-桃園,2023-02-08,9189
2801,彰銀,150,1,149,群益金鼎-桃園,2023-02-09,9189
00683L,期元大美元指正2,50,0,50,群益金鼎-桃園,2023-02-09,9189
8930,青鋼,46,0,46,群益金鼎-桃園,2023-02-09,9189
1802,台玻,43,1,42,群益金鼎-桃園,2023-02-09,9189
2376,技嘉,41,0,41,群益金鼎-桃園,2023-02-09,9189
1301,台塑,36,0,36,群益金鼎-桃園,2023-02-09,9189
2388,威盛,62,27,35,群益金鼎-桃園,2023-02-09,9189
00878,國泰永續高股息,37,2,35,群益金鼎-桃園,2023-02-09,9189
2313,華通,31,0,31,群益金鼎-桃園,2023-02-09,9189
1216,統一,30,0,30,群益金鼎-桃園,2023-02-09,9189
2888,新光金,23,0,23,群益金鼎-桃園,2023-02-09,9189
1734,杏輝,22,0,22,群益金鼎-桃園,2023-02-09,9189
3624,光頡,17,0,17,群益金鼎-桃園,2023-02-09,9189
6443,元晶,20,5,15,群益金鼎-桃園,2023-02-09,9189
1737,臺鹽,15,0,15,群益金鼎-桃園,2023-02-09,9189
2492,華新科,15,0,15,群益金鼎-桃園,2023-02-09,9189
5351,鈺創,17,3,14,群益金鼎-桃園,2023-02-09,9189
00772B,中信高評級公司債,14,0,14,群益金鼎-桃園,2023-02-09,9189
6603,富強鑫,14,0,14,群益金鼎-桃園,2023-02-09,9189
4736,泰博,16,2,14,群益金鼎-桃園,2023-02-09,9189
4726,永昕,14,0,14,群益金鼎-桃園,2023-02-09,9189
2368,金像電,17,3,14,群益金鼎-桃園,2023-02-09,9189
2610,華航,33,20,13,群益金鼎-桃園,2023-02-09,9189
6118,建達,28,15,13,群益金鼎-桃園,2023-02-09,9189
2603,長榮,14,2,12,群益金鼎-桃園,2023-02-09,9189
1101,台泥,15,3,12,群益金鼎-桃園,2023-02-09,9189
6202,盛群,12,1,11,群益金鼎-桃園,2023-02-09,9189
5475,德宏,11,0,11,群益金鼎-桃園,2023-02-09,9189
00632R,元大台灣50反1,141,130,11,群益金鼎-桃園,2023-02-09,9189
2353,宏��,12,1,11,群益金鼎-桃園,2023-02-09,9189
2002,中鋼,11,1,10,群益金鼎-桃園,2023-02-09,9189
00751B,元大AAA至A公司債,10,0,10,群益金鼎-桃園,2023-02-09,9189
6023,元大期,10,0,10,群益金鼎-桃園,2023-02-09,9189
2497,怡利電,10,0,10,群益金鼎-桃園,2023-02-09,9189
5315,光聯,10,0,10,群益金鼎-桃園,2023-02-09,9189
1618,合機,10,0,10,群益金鼎-桃園,2023-02-09,9189
6174,安��,10,0,10,群益金鼎-桃園,2023-02-09,9189
6442,光聖,10,0,10,群益金鼎-桃園,2023-02-09,9189
6206,飛捷,10,0,10,群益金鼎-桃園,2023-02-09,9189
8255,朋程,10,0,10,群益金鼎-桃園,2023-02-09,9189
6129,普誠,57,47,10,群益金鼎-桃園,2023-02-09,9189
8033,雷虎,15,5,10,群益金鼎-桃園,2023-02-09,9189
00720B,元大投資級公司債,9,0,9,群益金鼎-桃園,2023-02-09,9189
2618,長榮航,40,31,9,群益金鼎-桃園,2023-02-09,9189
9958,世紀鋼,8,0,8,群益金鼎-桃園,2023-02-09,9189
4116,明基醫,9,1,8,群益金鼎-桃園,2023-02-09,9189
8069,元太,13,5,8,群益金鼎-桃園,2023-02-09,9189
2453,凌群,8,0,8,群益金鼎-桃園,2023-02-09,9189
1795,美時,24,17,7,群益金鼎-桃園,2023-02-09,9189
8046,南電,7,0,7,群益金鼎-桃園,2023-02-09,9189
6443,元晶,47,3,44,群益金鼎-桃園,2023-02-10,9189
00878,國泰永續高股息,71,33,38,群益金鼎-桃園,2023-02-10,9189
00683L,期元大美元指正2,31,0,31,群益金鼎-桃園,2023-02-10,9189
2498,宏達電,36,5,31,群益金鼎-桃園,2023-02-10,9189
3029,零壹,27,0,27,群益金鼎-桃園,2023-02-10,9189
2882,國泰金,33,7,26,群益金鼎-桃園,2023-02-10,9189
2888,新光金,25,0,25,群益金鼎-桃園,2023-02-10,9189
3022,威強電,23,0,23,群益金鼎-桃園,2023-02-10,9189
00751B,元大AAA至A公司債,21,0,21,群益金鼎-桃園,2023-02-10,9189
1451,年興,20,0,20,群益金鼎-桃園,2023-02-10,9189
00753L,中信中國50正2,20,0,20,群益金鼎-桃園,2023-02-10,9189
00772B,中信高評級公司債,20,0,20,群益金鼎-桃園,2023-02-10,9189
1218,泰山,18,0,18,群益金鼎-桃園,2023-02-10,9189
0056,元大高股息,23,5,18,群益金鼎-桃園,2023-02-10,9189
00637L,元大滬深300正2,17,0,17,群益金鼎-桃園,2023-02-10,9189
2534,宏盛,17,0,17,群益金鼎-桃園,2023-02-10,9189
00679B,元大美債20年,16,0,16,群益金鼎-桃園,2023-02-10,9189
2609,陽明,21,6,15,群益金鼎-桃園,2023-02-10,9189
2344,華邦電,18,3,15,群益金鼎-桃園,2023-02-10,9189
2388,威盛,21,6,15,群益金鼎-桃園,2023-02-10,9189
1529,樂事綠能,15,0,15,群益金鼎-桃園,2023-02-10,9189
2329,華泰,15,0,15,群益金鼎-桃園,2023-02-10,9189
6116,彩晶,14,0,14,群益金鼎-桃園,2023-02-10,9189
2892,第一金,18,4,14,群益金鼎-桃園,2023-02-10,9189
2607,榮運,14,1,13,群益金鼎-桃園,2023-02-10,9189
00715L,期街口布蘭特正2,14,1,13,群益金鼎-桃園,2023-02-10,9189
3710,連展投控,22,10,12,群益金鼎-桃園,2023-02-10,9189
8046,南電,11,0,11,群益金鼎-桃園,2023-02-10,9189
2409,友達,24,13,11,群益金鼎-桃園,2023-02-10,9189
1210,大成,11,0,11,群益金鼎-桃園,2023-02-10,9189
3047,訊舟,13,2,11,群益金鼎-桃園,2023-02-10,9189
4164,承業醫,11,0,11,群益金鼎-桃園,2023-02-10,9189
6188,廣明,11,0,11,群益金鼎-桃園,2023-02-10,9189
5243,乙盛-KY,11,0,11,群益金鼎-桃園,2023-02-10,9189
3356,奇偶,13,2,11,群益金鼎-桃園,2023-02-10,9189
6269,台郡,11,0,11,群益金鼎-桃園,2023-02-10,9189
3701,大眾控,11,0,11,群益金鼎-桃園,2023-02-10,9189
6118,建達,12,1,11,群益金鼎-桃園,2023-02-10,9189
2618,長榮航,75,65,10,群益金鼎-桃園,2023-02-10,9189
6721,信實,10,0,10,群益金鼎-桃園,2023-02-10,9189
6153,嘉聯益,10,0,10,群益金鼎-桃園,2023-02-10,9189
2109,華豐,10,0,10,群益金鼎-桃園,2023-02-10,9189
3147,大綜,10,0,10,群益金鼎-桃園,2023-02-10,9189
2801,彰銀,10,0,10,群益金鼎-桃園,2023-02-10,9189
3494,誠研,10,0,10,群益金鼎-桃園,2023-02-10,9189
1101,台泥,12,2,10,群益金鼎-桃園,2023-02-10,9189
6552,易華電,10,1,9,群益金鼎-桃園,2023-02-10,9189
00900,富邦特選高股息30,10,1,9,群益金鼎-桃園,2023-02-10,9189
2915,潤泰全,9,0,9,群益金鼎-桃園,2023-02-10,9189
2208,台船,12,3,9,群益金鼎-桃園,2023-02-10,9189
2303,聯電,83,22,61,群益金鼎-桃園,2023-02-13,9189
2618,長榮航,43,1,42,群益金鼎-桃園,2023-02-13,9189
00772B,中信高評級公司債,32,0,32,群益金鼎-桃園,2023-02-13,9189
4130,健亞,33,2,31,群益金鼎-桃園,2023-02-13,9189
1810,和成,33,2,31,群益金鼎-桃園,2023-02-13,9189
1217,愛之味,30,0,30,群益金鼎-桃園,2023-02-13,9189
8222,寶一,154,124,30,群益金鼎-桃園,2023-02-13,9189
00679B,元大美債20年,24,0,24,群益金鼎-桃園,2023-02-13,9189
2610,華航,33,9,24,群益金鼎-桃園,2023-02-13,9189
3013,晟銘電,24,0,24,群益金鼎-桃園,2023-02-13,9189
2352,佳世達,23,0,23,群益金鼎-桃園,2023-02-13,9189
00751B,元大AAA至A公司債,22,0,22,群益金鼎-桃園,2023-02-13,9189
00878,國泰永續高股息,53,32,21,群益金鼎-桃園,2023-02-13,9189
2316,楠梓電,20,0,20,群益金鼎-桃園,2023-02-13,9189
4979,華星光,32,15,17,群益金鼎-桃園,2023-02-13,9189
6266,泰詠,28,12,16,群益金鼎-桃園,2023-02-13,9189
00680L,元大美債20正2,16,0,16,群益金鼎-桃園,2023-02-13,9189
00648R,元大S＆P500反1,15,0,15,群益金鼎-桃園,2023-02-13,9189
00720B,元大投資級公司債,14,0,14,群益金鼎-桃園,2023-02-13,9189
3289,宜特,16,2,14,群益金鼎-桃園,2023-02-13,9189
00830,國泰費城半導體,11,0,11,群益金鼎-桃園,2023-02-13,9189
00900,富邦特選高股息30,11,0,11,群益金鼎-桃園,2023-02-13,9189
3515,華擎,11,1,10,群益金鼎-桃園,2023-02-13,9189
6116,彩晶,10,0,10,群益金鼎-桃園,2023-02-13,9189
00673R,期元大S＆P原油反1,10,0,10,群益金鼎-桃園,2023-02-13,9189
2485,兆赫,10,0,10,群益金鼎-桃園,2023-02-13,9189
2365,昆盈,10,0,10,群益金鼎-桃園,2023-02-13,9189
1599,宏佳騰,10,0,10,群益金鼎-桃園,2023-02-13,9189
3498,陽程,9,0,9,群益金鼎-桃園,2023-02-13,9189
00773B,中信優先金融債,9,0,9,群益金鼎-桃園,2023-02-13,9189
5009,榮剛,11,3,8,群益金鼎-桃園,2023-02-13,9189
00915,凱基優選高股息30,8,0,8,群益金鼎-桃園,2023-02-13,9189
3265,台星科,8,0,8,群益金鼎-桃園,2023-02-13,9189
2329,華泰,8,0,8,群益金鼎-桃園,2023-02-13,9189
6142,友勁,8,0,8,群益金鼎-桃園,2023-02-13,9189
2009,第一銅,9,1,8,群益金鼎-桃園,2023-02-13,9189
00885,富邦越南,9,1,8,群益金鼎-桃園,2023-02-13,9189
3037,欣興,8,1,7,群益金鼎-桃園,2023-02-13,9189
1513,中興電,13,6,7,群益金鼎-桃園,2023-02-13,9189
1529,樂事綠能,8,1,7,群益金鼎-桃園,2023-02-13,9189
1734,杏輝,25,18,7,群益金鼎-桃園,2023-02-13,9189
6605,帝寶,10,3,7,群益金鼎-桃園,2023-02-13,9189
4114,健喬,40,33,7,群益金鼎-桃園,2023-02-13,9189
8069,元太,12,6,6,群益金鼎-桃園,2023-02-13,9189
6235,華孚,19,13,6,群益金鼎-桃園,2023-02-13,9189
4739,康普,6,0,6,群益金鼎-桃園,2023-02-13,9189
00895,富邦未來車,11,5,6,群益金鼎-桃園,2023-02-13,9189
1752,南光,9,3,6,群益金鼎-桃園,2023-02-13,9189
8249,菱光,6,0,6,群益金鼎-桃園,2023-02-13,9189
8440,綠電,5,0,5,群益金鼎-桃園,2023-02-13,9189
00632R,元大台灣50反1,153,0,153,群益金鼎-桃園,2023-02-14,9189
6116,彩晶,41,0,41,群益金鼎-桃園,2023-02-14,9189
8222,寶一,55,27,28,群益金鼎-桃園,2023-02-14,9189
2453,凌群,94,71,23,群益金鼎-桃園,2023-02-14,9189
00720B,元大投資級公司債,21,0,21,群益金鼎-桃園,2023-02-14,9189
00637L,元大滬深300正2,30,10,20,群益金鼎-桃園,2023-02-14,9189
4114,健喬,62,44,18,群益金鼎-桃園,2023-02-14,9189
3693,營邦,17,0,17,群益金鼎-桃園,2023-02-14,9189
5222,全訊,15,0,15,群益金鼎-桃園,2023-02-14,9189
2610,華航,60,45,15,群益金鼎-桃園,2023-02-14,9189
1605,華新,60,45,15,群益金鼎-桃園,2023-02-14,9189
2748,雲品,23,12,11,群益金鼎-桃園,2023-02-14,9189
00679B,元大美債20年,12,0,12,群益金鼎-桃園,2023-02-14,9189
3481,群創,71,60,11,群益金鼎-桃園,2023-02-14,9189
2888,新光金,11,0,11,群益金鼎-桃園,2023-02-14,9189
5880,合庫金,11,0,11,群益金鼎-桃園,2023-02-14,9189
2891,中信金,31,21,10,群益金鼎-桃園,2023-02-14,9189
00878,國泰永續高股息,27,17,10,群益金鼎-桃園,2023-02-14,9189
2897,王道銀行,10,0,10,群益金鼎-桃園,2023-02-14,9189
4726,永昕,10,0,10,群益金鼎-桃園,2023-02-14,9189
00648R,元大S＆P500反1,10,0,10,群益金鼎-桃園,2023-02-14,9189
00671R,富邦NASDAQ反1,10,0,10,群益金鼎-桃園,2023-02-14,9189
1701,中化,43,33,10,群益金鼎-桃園,2023-02-14,9189
2486,一詮,11,1,10,群益金鼎-桃園,2023-02-14,9189
4552,力達-KY,10,0,10,群益金鼎-桃園,2023-02-14,9189
6462,神盾,11,1,10,群益金鼎-桃園,2023-02-14,9189
2892,第一金,10,0,10,群益金鼎-桃園,2023-02-14,9189
2353,宏��,10,1,9,群益金鼎-桃園,2023-02-14,9189
2883,凱基金,9,0,9,群益金鼎-桃園,2023-02-14,9189
2393,億光,11,2,9,群益金鼎-桃園,2023-02-14,9189
2497,怡利電,8,0,8,群益金鼎-桃園,2023-02-14,9189
00673R,期元大S＆P原油反1,8,0,8,群益金鼎-桃園,2023-02-14,9189
2413,環科,8,0,8,群益金鼎-桃園,2023-02-14,9189
3189,景碩,13,5,8,群益金鼎-桃園,2023-02-14,9189
6770,力積電,7,0,7,群益金鼎-桃園,2023-02-14,9189
2312,金寶,7,0,7,群益金鼎-桃園,2023-02-14,9189
00631L,元大台灣50正2,7,0,7,群益金鼎-桃園,2023-02-14,9189
8050,廣積,7,0,7,群益金鼎-桃園,2023-02-14,9189
00916,國泰全球品牌50,7,0,7,群益金鼎-桃園,2023-02-14,9189
3661,世芯-KY,6,0,6,群益金鼎-桃園,2023-02-14,9189
8215,明基材,6,0,6,群益金鼎-桃園,2023-02-14,9189
6509,聚和,6,0,6,群益金鼎-桃園,2023-02-14,9189
6182,合晶,15,9,6,群益金鼎-桃園,2023-02-14,9189
2368,金像電,9,3,6,群益金鼎-桃園,2023-02-14,9189
8930,青鋼,6,0,6,群益金鼎-桃園,2023-02-14,9189
1708,東鹼,5,0,5,群益金鼎-桃園,2023-02-14,9189
3558,神準,5,0,5,群益金鼎-桃園,2023-02-14,9189
00907,永豐優息存股,5,0,5,群益金鼎-桃園,2023-02-14,9189
1796,金穎生技,5,0,5,群益金鼎-桃園,2023-02-14,9189
3704,合勤控,13,8,5,群益金鼎-桃園,2023-02-14,9189
00878,國泰永續高股息,240,54,186,群益金鼎-桃園,2023-02-15,9189
8930,青鋼,71,0,71,群益金鼎-桃園,2023-02-15,9189
00671R,富邦NASDAQ反1,61,0,61,群益金鼎-桃園,2023-02-15,9189
6282,康舒,44,0,44,群益金鼎-桃園,2023-02-15,9189
2330,台積電,43,4,39,群益金鼎-桃園,2023-02-15,9189
2884,玉山金,33,0,33,群益金鼎-桃園,2023-02-15,9189
2891,中信金,37,5,32,群益金鼎-桃園,2023-02-15,9189
00673R,期元大S＆P原油反1,32,0,32,群益金鼎-桃園,2023-02-15,9189
2883,凱基金,25,0,25,群益金鼎-桃園,2023-02-15,9189
00882,中信中國高股息,30,5,25,群益金鼎-桃園,2023-02-15,9189
2888,新光金,22,0,22,群益金鼎-桃園,2023-02-15,9189
00720B,元大投資級公司債,21,0,21,群益金鼎-桃園,2023-02-15,9189
00637L,元大滬深300正2,121,100,21,群益金鼎-桃園,2023-02-15,9189
5608,四維航,30,9,21,群益金鼎-桃園,2023-02-15,9189
2889,國票金,20,0,20,群益金鼎-桃園,2023-02-15,9189
2457,飛宏,20,0,20,群益金鼎-桃園,2023-02-15,9189
6285,啟��,20,0,20,群益金鼎-桃園,2023-02-15,9189
2882,國泰金,21,2,19,群益金鼎-桃園,2023-02-15,9189
6535,順藥,19,0,19,群益金鼎-桃園,2023-02-15,9189
00679B,元大美債20年,16,0,16,群益金鼎-桃園,2023-02-15,9189
9945,潤泰新,22,8,14,群益金鼎-桃園,2023-02-15,9189
2206,三陽工業,31,17,14,群益金鼎-桃園,2023-02-15,9189
2610,華航,53,39,14,群益金鼎-桃園,2023-02-15,9189
3481,群創,64,51,13,群益金鼎-桃園,2023-02-15,9189
00885,富邦越南,13,0,13,群益金鼎-桃園,2023-02-15,9189
6188,廣明,13,0,13,群益金鼎-桃園,2023-02-15,9189
1536,和大,12,0,12,群益金鼎-桃園,2023-02-15,9189
2723,美食-KY,14,2,12,群益金鼎-桃園,2023-02-15,9189
6235,華孚,33,22,11,群益金鼎-桃園,2023-02-15,9189
006208,富邦台50,11,1,10,群益金鼎-桃園,2023-02-15,9189
2471,資通,101,91,10,群益金鼎-桃園,2023-02-15,9189
00706L,期元大S＆P日圓正2,10,0,10,群益金鼎-桃園,2023-02-15,9189
00648R,元大S＆P500反1,10,0,10,群益金鼎-桃園,2023-02-15,9189
00738U,期元大道瓊白銀,10,0,10,群益金鼎-桃園,2023-02-15,9189
8928,鉅明,10,0,10,群益金鼎-桃園,2023-02-15,9189
2897,王道銀行,10,0,10,群益金鼎-桃園,2023-02-15,9189
1760,寶齡富錦,12,3,9,群益金鼎-桃園,2023-02-15,9189
2484,希華,23,14,9,群益金鼎-桃園,2023-02-15,9189
00650L,復華香港正2,9,0,9,群益金鼎-桃園,2023-02-15,9189
2834,臺企銀,10,1,9,群益金鼎-桃園,2023-02-15,9189
00753L,中信中國50正2,9,0,9,群益金鼎-桃園,2023-02-15,9189
6278,台表科,9,0,9,群益金鼎-桃園,2023-02-15,9189
2707,晶華,9,0,9,群益金鼎-桃園,2023-02-15,9189
2498,宏達電,29,21,8,群益金鼎-桃園,2023-02-15,9189
5203,訊連,8,0,8,群益金鼎-桃園,2023-02-15,9189
3122,笙泉,10,2,8,群益金鼎-桃園,2023-02-15,9189
6721,信實,8,0,8,群益金鼎-桃園,2023-02-15,9189
8046,南電,12,4,8,群益金鼎-桃園,2023-02-15,9189
00631L,元大台灣50正2,7,0,7,群益金鼎-桃園,2023-02-15,9189
2915,潤泰全,7,0,7,群益金鼎-桃園,2023-02-15,9189
00632R,元大台灣50反1,210,0,210,群益金鼎-桃園,2023-02-16,9189
2888,新光金,119,0,119,群益金鼎-桃園,2023-02-16,9189
3035,智原,122,22,100,群益金鼎-桃園,2023-02-16,9189
00878,國泰永續高股息,90,34,56,群益金鼎-桃園,2023-02-16,9189
00679B,元大美債20年,49,1,48,群益金鼎-桃園,2023-02-16,9189
1609,大亞,50,15,35,群益金鼎-桃園,2023-02-16,9189
3710,連展投控,36,10,26,群益金鼎-桃園,2023-02-16,9189
4439,冠星-KY,26,1,25,群益金鼎-桃園,2023-02-16,9189
8183,精星,26,1,25,群益金鼎-桃園,2023-02-16,9189
00671R,富邦NASDAQ反1,24,0,24,群益金鼎-桃園,2023-02-16,9189
1513,中興電,35,15,20,群益金鼎-桃園,2023-02-16,9189
2867,三商壽,20,0,20,群益金鼎-桃園,2023-02-16,9189
2399,映泰,20,0,20,群益金鼎-桃園,2023-02-16,9189
4977,眾達-KY,20,1,19,群益金鼎-桃園,2023-02-16,9189
2337,旺宏,21,2,19,群益金鼎-桃園,2023-02-16,9189
3537,堡達,18,0,18,群益金鼎-桃園,2023-02-16,9189
2882,國泰金,27,10,17,群益金鼎-桃園,2023-02-16,9189
00772B,中信高評級公司債,17,0,17,群益金鼎-桃園,2023-02-16,9189
00773B,中信優先金融債,16,0,16,群益金鼎-桃園,2023-02-16,9189
2359,所羅門,15,0,15,群益金鼎-桃園,2023-02-16,9189
00780B,國泰A級金融債,14,0,14,群益金鼎-桃園,2023-02-16,9189
2707,晶華,14,1,13,群益金鼎-桃園,2023-02-16,9189
3013,晟銘電,16,4,12,群益金鼎-桃園,2023-02-16,9189
00751B,元大AAA至A公司債,11,0,11,群益金鼎-桃園,2023-02-16,9189
6005,群益證,11,0,11,群益金鼎-桃園,2023-02-16,9189
6285,啟��,11,0,11,群益金鼎-桃園,2023-02-16,9189
00724B,群益投資級金融債,10,0,10,群益金鼎-桃園,2023-02-16,9189
3322,建舜電,10,0,10,群益金鼎-桃園,2023-02-16,9189
3711,日月光投控,10,0,10,群益金鼎-桃園,2023-02-16,9189
00882,中信中國高股息,10,0,10,群益金鼎-桃園,2023-02-16,9189
8930,青鋼,10,0,10,群益金鼎-桃園,2023-02-16,9189
00719B,元大美債1-3,10,0,10,群益金鼎-桃園,2023-02-16,9189
1503,士電,23,13,10,群益金鼎-桃園,2023-02-16,9189
3024,憶聲,20,10,10,群益金鼎-桃園,2023-02-16,9189
9912,偉聯,10,0,10,群益金鼎-桃園,2023-02-16,9189
5905,南仁湖,10,0,10,群益金鼎-桃園,2023-02-16,9189
4155,訊映,10,0,10,群益金鼎-桃園,2023-02-16,9189
4743,合一,13,3,10,群益金鼎-桃園,2023-02-16,9189
5471,松翰,10,0,10,群益金鼎-桃園,2023-02-16,9189
1701,中化,13,4,9,群益金鼎-桃園,2023-02-16,9189
00680L,元大美債20正2,9,0,9,群益金鼎-桃園,2023-02-16,9189
1522,堤維西,9,0,9,群益金鼎-桃園,2023-02-16,9189
6770,力積電,10,1,9,群益金鼎-桃園,2023-02-16,9189
1591,駿吉-KY,8,0,8,群益金鼎-桃園,2023-02-16,9189
5703,亞都,8,0,8,群益金鼎-桃園,2023-02-16,9189
2449,京元電子,8,0,8,群益金鼎-桃園,2023-02-16,9189
3162,精確,12,4,8,群益金鼎-桃園,2023-02-16,9189
4804,大略-KY,8,0,8,群益金鼎-桃園,2023-02-16,9189
2915,潤泰全,8,1,7,群益金鼎-桃園,2023-02-16,9189
00687B,國泰20年美債,7,0,7,群益金鼎-桃園,2023-02-16,9189
00683L,期元大美元指正2,151,0,151,群益金鼎-桃園,2023-02-17,9189
00878,國泰永續高股息,83,17,66,群益金鼎-桃園,2023-02-17,9189
3037,欣興,62,4,58,群益金鼎-桃園,2023-02-17,9189
3704,合勤控,60,8,52,群益金鼎-桃園,2023-02-17,9189
3035,智原,52,4,48,群益金鼎-桃園,2023-02-17,9189
4726,永昕,48,5,43,群益金鼎-桃園,2023-02-17,9189
1101,台泥,50,8,42,群益金鼎-桃園,2023-02-17,9189
2498,宏達電,47,12,35,群益金鼎-桃園,2023-02-17,9189
00895,富邦未來車,35,0,35,群益金鼎-桃園,2023-02-17,9189
00680L,元大美債20正2,34,0,34,群益金鼎-桃園,2023-02-17,9189
00893,國泰智能電動車,36,5,31,群益金鼎-桃園,2023-02-17,9189
2330,台積電,30,6,24,群益金鼎-桃園,2023-02-17,9189
00772B,中信高評級公司債,22,0,22,群益金鼎-桃園,2023-02-17,9189
1810,和成,29,7,22,群益金鼎-桃園,2023-02-17,9189
2897,王道銀行,20,0,20,群益金鼎-桃園,2023-02-17,9189
2344,華邦電,28,10,18,群益金鼎-桃園,2023-02-17,9189
00882,中信中國高股息,17,0,17,群益金鼎-桃園,2023-02-17,9189
8940,新天地,18,1,17,群益金鼎-桃園,2023-02-17,9189
00679B,元大美債20年,16,0,16,群益金鼎-桃園,2023-02-17,9189
4128,中天,23,8,15,群益金鼎-桃園,2023-02-17,9189
6796,晉弘,15,0,15,群益金鼎-桃園,2023-02-17,9189
6005,群益證,14,0,14,群益金鼎-桃園,2023-02-17,9189
2618,長榮航,14,1,13,群益金鼎-桃園,2023-02-17,9189
00637L,元大滬深300正2,131,119,12,群益金鼎-桃園,2023-02-17,9189
6118,建達,12,0,12,群益金鼎-桃園,2023-02-17,9189
00720B,元大投資級公司債,11,0,11,群益金鼎-桃園,2023-02-17,9189
8358,金居,17,6,11,群益金鼎-桃園,2023-02-17,9189
6239,力成,11,0,11,群益金鼎-桃園,2023-02-17,9189
6120,達運,21,10,11,群益金鼎-桃園,2023-02-17,9189
1342,八貫,20,10,10,群益金鼎-桃園,2023-02-17,9189
3024,憶聲,10,0,10,群益金鼎-桃園,2023-02-17,9189
00642U,期元大S＆P石油,10,0,10,群益金鼎-桃園,2023-02-17,9189
00753L,中信中國50正2,10,0,10,群益金鼎-桃園,2023-02-17,9189
8222,寶一,30,20,10,群益金鼎-桃園,2023-02-17,9189
6234,高僑,10,0,10,群益金鼎-桃園,2023-02-17,9189
2413,環科,10,0,10,群益金鼎-桃園,2023-02-17,9189
8255,朋程,10,0,10,群益金鼎-桃園,2023-02-17,9189
00724B,群益投資級金融債,10,0,10,群益金鼎-桃園,2023-02-17,9189
6179,亞通,9,0,9,群益金鼎-桃園,2023-02-17,9189
2388,威盛,13,4,9,群益金鼎-桃園,2023-02-17,9189
6770,力積電,14,5,9,群益金鼎-桃園,2023-02-17,9189
2883,凱基金,10,1,9,群益金鼎-桃園,2023-02-17,9189
6271,同欣電,14,6,8,群益金鼎-桃園,2023-02-17,9189
00696B,富邦美債20年,8,0,8,群益金鼎-桃園,2023-02-17,9189
00673R,期元大S＆P原油反1,8,0,8,群益金鼎-桃園,2023-02-17,9189
3224,三顧,8,0,8,群益金鼎-桃園,2023-02-17,9189
00751B,元大AAA至A公司債,8,0,8,群益金鼎-桃園,2023-02-17,9189
6217,中探針,8,0,8,群益金鼎-桃園,2023-02-17,9189
4999,鑫禾,7,0,7,群益金鼎-桃園,2023-02-17,9189
00650L,復華香港正2,10,3,7,群益金鼎-桃園,2023-02-17,9189
3290,東浦,419,0,419,群益金鼎-桃園,2023-02-20,9189
2610,華航,293,70,223,群益金鼎-桃園,2023-02-20,9189
6109,亞元,70,0,70,群益金鼎-桃園,2023-02-20,9189
1101,台泥,55,0,55,群益金鼎-桃園,2023-02-20,9189
2607,榮運,49,0,49,群益金鼎-桃園,2023-02-20,9189
00632R,元大台灣50反1,86,37,49,群益金鼎-桃園,2023-02-20,9189
3466,德晉,40,0,40,群益金鼎-桃園,2023-02-20,9189
00882,中信中國高股息,37,0,37,群益金鼎-桃園,2023-02-20,9189
1519,華城,49,17,32,群益金鼎-桃園,2023-02-20,9189
4128,中天,36,5,31,群益金鼎-桃園,2023-02-20,9189
6111,大宇資,31,2,29,群益金鼎-桃園,2023-02-20,9189
4960,誠美材,29,2,27,群益金鼎-桃園,2023-02-20,9189
00753L,中信中國50正2,26,0,26,群益金鼎-桃園,2023-02-20,9189
1314,中石化,32,6,26,群益金鼎-桃園,2023-02-20,9189
3022,威強電,35,9,26,群益金鼎-桃園,2023-02-20,9189
2206,三陽工業,29,5,24,群益金鼎-桃園,2023-02-20,9189
3162,精確,23,1,22,群益金鼎-桃園,2023-02-20,9189
2885,元大金,21,0,21,群益金鼎-桃園,2023-02-20,9189
00715L,期街口布蘭特正2,35,14,21,群益金鼎-桃園,2023-02-20,9189
4726,永昕,20,0,20,群益金鼎-桃園,2023-02-20,9189
00919,群益台灣精選高息,30,10,20,群益金鼎-桃園,2023-02-20,9189
00679B,元大美債20年,20,0,20,群益金鼎-桃園,2023-02-20,9189
5512,力麒,19,0,19,群益金鼎-桃園,2023-02-20,9189
6461,益得,18,1,17,群益金鼎-桃園,2023-02-20,9189
2633,台灣高鐵,17,0,17,群益金鼎-桃園,2023-02-20,9189
2323,中環,20,4,16,群益金鼎-桃園,2023-02-20,9189
4164,承業醫,25,9,16,群益金鼎-桃園,2023-02-20,9189
8215,明基材,18,3,15,群益金鼎-桃園,2023-02-20,9189
6285,啟��,15,0,15,群益金鼎-桃園,2023-02-20,9189
6550,北極星藥業-KY,14,0,14,群益金鼎-桃園,2023-02-20,9189
1503,士電,42,29,13,群益金鼎-桃園,2023-02-20,9189
8358,金居,21,8,13,群益金鼎-桃園,2023-02-20,9189
5284,jpp-KY,17,5,12,群益金鼎-桃園,2023-02-20,9189
9919,康那香,12,0,12,群益金鼎-桃園,2023-02-20,9189
6541,泰福-KY,12,0,12,群益金鼎-桃園,2023-02-20,9189
6197,佳必琪,13,2,11,群益金鼎-桃園,2023-02-20,9189
00780B,國泰A級金融債,11,0,11,群益金鼎-桃園,2023-02-20,9189
3037,欣興,17,7,10,群益金鼎-桃園,2023-02-20,9189
2484,希華,10,0,10,群益金鼎-桃園,2023-02-20,9189
4439,冠星-KY,10,0,10,群益金鼎-桃園,2023-02-20,9189
4746,台耀,24,14,10,群益金鼎-桃園,2023-02-20,9189
2916,滿心,10,0,10,群益金鼎-桃園,2023-02-20,9189
2399,映泰,24,15,9,群益金鼎-桃園,2023-02-20,9189
00637L,元大滬深300正2,34,25,9,群益金鼎-桃園,2023-02-20,9189
00706L,期元大S＆P日圓正2,9,0,9,群益金鼎-桃園,2023-02-20,9189
4804,大略-KY,8,0,8,群益金鼎-桃園,2023-02-20,9189
2453,凌群,8,0,8,群益金鼎-桃園,2023-02-20,9189
1760,寶齡富錦,15,7,8,群益金鼎-桃園,2023-02-20,9189
6143,振曜,20,12,8,群益金鼎-桃園,2023-02-20,9189
2208,台船,9,1,8,群益金鼎-桃園,2023-02-20,9189
2884,玉山金,189,18,171,群益金鼎-桃園,2023-02-21,9189
00878,國泰永續高股息,66,0,66,群益金鼎-桃園,2023-02-21,9189
2352,佳世達,62,8,54,群益金鼎-桃園,2023-02-21,9189
2609,陽明,62,13,49,群益金鼎-桃園,2023-02-21,9189
6288,聯嘉,70,34,36,群益金鼎-桃園,2023-02-21,9189
5880,合庫金,35,0,35,群益金鼎-桃園,2023-02-21,9189
5210,寶碩,34,0,34,群益金鼎-桃園,2023-02-21,9189
2883,凱基金,36,5,31,群益金鼎-桃園,2023-02-21,9189
2929,淘帝-KY,30,0,30,群益金鼎-桃園,2023-02-21,9189
00885,富邦越南,30,0,30,群益金鼎-桃園,2023-02-21,9189
6266,泰詠,40,11,29,群益金鼎-桃園,2023-02-21,9189
1810,和成,43,18,25,群益金鼎-桃園,2023-02-21,9189
8930,青鋼,25,0,25,群益金鼎-桃園,2023-02-21,9189
1437,勤益控,27,2,25,群益金鼎-桃園,2023-02-21,9189
3704,合勤控,24,0,24,群益金鼎-桃園,2023-02-21,9189
2618,長榮航,38,16,22,群益金鼎-桃園,2023-02-21,9189
3594,磐儀,40,20,20,群益金鼎-桃園,2023-02-21,9189
6220,岳豐,18,0,18,群益金鼎-桃園,2023-02-21,9189
6443,元晶,18,0,18,群益金鼎-桃園,2023-02-21,9189
3290,東浦,16,0,16,群益金鼎-桃園,2023-02-21,9189
5284,jpp-KY,16,2,14,群益金鼎-桃園,2023-02-21,9189
6806,森崴能源,15,1,14,群益金鼎-桃園,2023-02-21,9189
8033,雷虎,15,1,14,群益金鼎-桃園,2023-02-21,9189
8936,國統,37,24,13,群益金鼎-桃園,2023-02-21,9189
6118,建達,38,25,13,群益金鼎-桃園,2023-02-21,9189
3035,智原,18,6,12,群益金鼎-桃園,2023-02-21,9189
2504,國產,12,0,12,群益金鼎-桃園,2023-02-21,9189
3624,光頡,17,5,12,群益金鼎-桃園,2023-02-21,9189
4167,松瑞藥,12,0,12,群益金鼎-桃園,2023-02-21,9189
2633,台灣高鐵,12,0,12,群益金鼎-桃園,2023-02-21,9189
6185,幃翔,11,0,11,群益金鼎-桃園,2023-02-21,9189
2369,菱生,11,0,11,群益金鼎-桃園,2023-02-21,9189
4439,冠星-KY,11,0,11,群益金鼎-桃園,2023-02-21,9189
6741,91APP*-KY,12,1,11,群益金鼎-桃園,2023-02-21,9189
1513,中興電,57,46,11,群益金鼎-桃園,2023-02-21,9189
1326,台化,10,0,10,群益金鼎-桃園,2023-02-21,9189
9958,世紀鋼,11,1,10,群益金鼎-桃園,2023-02-21,9189
1727,中華化,10,0,10,群益金鼎-桃園,2023-02-21,9189
2497,怡利電,10,0,10,群益金鼎-桃園,2023-02-21,9189
2408,南亞科,10,0,10,群益金鼎-桃園,2023-02-21,9189
00632R,元大台灣50反1,10,0,10,群益金鼎-桃園,2023-02-21,9189
2485,兆赫,10,0,10,群益金鼎-桃園,2023-02-21,9189
1444,力麗,10,0,10,群益金鼎-桃園,2023-02-21,9189
6129,普誠,11,1,10,群益金鼎-桃園,2023-02-21,9189
6285,啟��,11,2,9,群益金鼎-桃園,2023-02-21,9189
2732,六角,10,1,9,群益金鼎-桃園,2023-02-21,9189
8222,寶一,40,31,9,群益金鼎-桃園,2023-02-21,9189
4960,誠美材,23,14,9,群益金鼎-桃園,2023-02-21,9189
2357,華碩,8,0,8,群益金鼎-桃園,2023-02-21,9189
2206,三陽工業,17,9,8,群益金鼎-桃園,2023-02-21,9189
3290,東浦,313,1,312,群益金鼎-桃園,2023-02-22,9189
6288,聯嘉,89,1,88,群益金鼎-桃園,2023-02-22,9189
00878,國泰永續高股息,88,0,88,群益金鼎-桃園,2023-02-22,9189
8033,雷虎,101,19,82,群益金鼎-桃園,2023-02-22,9189
2498,宏達電,73,7,66,群益金鼎-桃園,2023-02-22,9189
3035,智原,52,3,49,群益金鼎-桃園,2023-02-22,9189
2303,聯電,56,10,46,群益金鼎-桃園,2023-02-22,9189
4726,永昕,41,0,41,群益金鼎-桃園,2023-02-22,9189
3037,欣興,44,5,39,群益金鼎-桃園,2023-02-22,9189
2618,長榮航,43,6,37,群益金鼎-桃園,2023-02-22,9189
00720B,元大投資級公司債,26,0,26,群益金鼎-桃園,2023-02-22,9189
1522,堤維西,34,10,24,群益金鼎-桃園,2023-02-22,9189
2883,凱基金,26,2,24,群益金鼎-桃園,2023-02-22,9189
00725B,國泰投資級公司債,23,0,23,群益金鼎-桃園,2023-02-22,9189
2603,長榮,28,6,22,群益金鼎-桃園,2023-02-22,9189
2344,華邦電,27,6,21,群益金鼎-桃園,2023-02-22,9189
2882,國泰金,23,3,20,群益金鼎-桃園,2023-02-22,9189
5701,劍湖山,20,0,20,群益金鼎-桃園,2023-02-22,9189
6806,森崴能源,32,12,20,群益金鼎-桃園,2023-02-22,9189
2408,南亞科,18,1,17,群益金鼎-桃園,2023-02-22,9189
6443,元晶,21,4,17,群益金鼎-桃園,2023-02-22,9189
3675,德微,20,4,16,群益金鼎-桃園,2023-02-22,9189
2457,飛宏,24,9,15,群益金鼎-桃園,2023-02-22,9189
00751B,元大AAA至A公司債,15,0,15,群益金鼎-桃園,2023-02-22,9189
6282,康舒,28,13,15,群益金鼎-桃園,2023-02-22,9189
2330,台積電,17,3,14,群益金鼎-桃園,2023-02-22,9189
2317,鴻海,14,0,14,群益金鼎-桃園,2023-02-22,9189
0056,元大高股息,22,8,14,群益金鼎-桃園,2023-02-22,9189
4564,元翎,15,1,14,群益金鼎-桃園,2023-02-22,9189
1605,華新,29,16,13,群益金鼎-桃園,2023-02-22,9189
6279,胡連,13,0,13,群益金鼎-桃園,2023-02-22,9189
00830,國泰費城半導體,12,0,12,群益金鼎-桃園,2023-02-22,9189
00760B,復華新興企業債,12,0,12,群益金鼎-桃園,2023-02-22,9189
6116,彩晶,52,40,12,群益金鼎-桃園,2023-02-22,9189
2504,國產,12,0,12,群益金鼎-桃園,2023-02-22,9189
1519,華城,61,49,12,群益金鼎-桃園,2023-02-22,9189
1609,大亞,20,8,12,群益金鼎-桃園,2023-02-22,9189
8261,富鼎,12,0,12,群益金鼎-桃園,2023-02-22,9189
2705,六福,16,4,12,群益金鼎-桃園,2023-02-22,9189
4977,眾達-KY,13,1,12,群益金鼎-桃園,2023-02-22,9189
2201,裕隆,13,2,11,群益金鼎-桃園,2023-02-22,9189
2329,華泰,17,6,11,群益金鼎-桃園,2023-02-22,9189
2368,金像電,11,0,11,群益金鼎-桃園,2023-02-22,9189
3321,同泰,11,0,11,群益金鼎-桃園,2023-02-22,9189
3034,聯詠,11,1,10,群益金鼎-桃園,2023-02-22,9189
3430,奇鈦科,10,0,10,群益金鼎-桃園,2023-02-22,9189
4167,松瑞藥,10,0,10,群益金鼎-桃園,2023-02-22,9189
8930,青鋼,10,0,10,群益金鼎-桃園,2023-02-22,9189
1504,東元,10,0,10,群益金鼎-桃園,2023-02-22,9189
3419,譁裕,20,10,10,群益金鼎-桃園,2023-02-22,9189
00632R,元大台灣50反1,208,11,197,群益金鼎-桃園,2023-02-23,9189
00715L,期街口布蘭特正2,81,0,81,群益金鼎-桃園,2023-02-23,9189
1444,力麗,85,8,77,群益金鼎-桃園,2023-02-23,9189
6136,富爾特,55,0,55,群益金鼎-桃園,2023-02-23,9189
2748,雲品,127,84,43,群益金鼎-桃園,2023-02-23,9189
2409,友達,37,0,37,群益金鼎-桃園,2023-02-23,9189
8033,雷虎,47,12,35,群益金鼎-桃園,2023-02-23,9189
2344,華邦電,40,5,35,群益金鼎-桃園,2023-02-23,9189
8358,金居,36,2,34,群益金鼎-桃園,2023-02-23,9189
3058,立德,31,5,26,群益金鼎-桃園,2023-02-23,9189
3094,聯傑,72,47,25,群益金鼎-桃園,2023-02-23,9189
2484,希華,30,5,25,群益金鼎-桃園,2023-02-23,9189
3013,晟銘電,24,0,24,群益金鼎-桃園,2023-02-23,9189
00902,中信電池及儲能,23,0,23,群益金鼎-桃園,2023-02-23,9189
2641,正德,36,13,23,群益金鼎-桃園,2023-02-23,9189
2701,萬企,21,0,21,群益金鼎-桃園,2023-02-23,9189
00686R,群益臺灣加權反1,20,0,20,群益金鼎-桃園,2023-02-23,9189
6508,惠光,20,0,20,群益金鼎-桃園,2023-02-23,9189
00720B,元大投資級公司債,21,2,19,群益金鼎-桃園,2023-02-23,9189
3037,欣興,24,6,18,群益金鼎-桃園,2023-02-23,9189
2002,中鋼,17,0,17,群益金鼎-桃園,2023-02-23,9189
2610,華航,26,10,16,群益金鼎-桃園,2023-02-23,9189
3466,德晉,15,1,14,群益金鼎-桃園,2023-02-23,9189
00637L,元大滬深300正2,17,3,14,群益金鼎-桃園,2023-02-23,9189
8111,立��,16,2,14,群益金鼎-桃園,2023-02-23,9189
2882,國泰金,22,8,14,群益金鼎-桃園,2023-02-23,9189
3481,群創,120,106,14,群益金鼎-桃園,2023-02-23,9189
2329,華泰,14,1,13,群益金鼎-桃園,2023-02-23,9189
6245,立端,15,2,13,群益金鼎-桃園,2023-02-23,9189
8996,高力,18,6,12,群益金鼎-桃園,2023-02-23,9189
2369,菱生,12,0,12,群益金鼎-桃園,2023-02-23,9189
2834,臺企銀,32,21,11,群益金鼎-桃園,2023-02-23,9189
2017,官田鋼,11,0,11,群益金鼎-桃園,2023-02-23,9189
3673,TPK-KY,14,3,11,群益金鼎-桃園,2023-02-23,9189
00664R,國泰臺灣加權反1,11,0,11,群益金鼎-桃園,2023-02-23,9189
2337,旺宏,11,0,11,群益金鼎-桃園,2023-02-23,9189
2023,燁輝,11,0,11,群益金鼎-桃園,2023-02-23,9189
3703,欣陸,10,0,10,群益金鼎-桃園,2023-02-23,9189
6470,宇智,10,0,10,群益金鼎-桃園,2023-02-23,9189
1103,嘉泥,10,0,10,群益金鼎-桃園,2023-02-23,9189
5284,jpp-KY,10,0,10,群益金鼎-桃園,2023-02-23,9189
2493,揚博,10,0,10,群益金鼎-桃園,2023-02-23,9189
2462,良得電,11,1,10,群益金鼎-桃園,2023-02-23,9189
1218,泰山,10,0,10,群益金鼎-桃園,2023-02-23,9189
8076,伍豐,10,0,10,群益金鼎-桃園,2023-02-23,9189
2609,陽明,29,19,10,群益金鼎-桃園,2023-02-23,9189
00885,富邦越南,9,0,9,群益金鼎-桃園,2023-02-23,9189
00773B,中信優先金融債,9,0,9,群益金鼎-桃園,2023-02-23,9189
4440,宜新實業,9,0,9,群益金鼎-桃園,2023-02-23,9189
4433,興采,10,1,9,群益金鼎-桃園,2023-02-23,9189
5512,力麒,260,151,109,群益金鼎-桃園,2023-02-24,9189
2610,華航,115,11,104,群益金鼎-桃園,2023-02-24,9189
3037,欣興,73,5,68,群益金鼎-桃園,2023-02-24,9189
00885,富邦越南,73,11,62,群益金鼎-桃園,2023-02-24,9189
2883,凱基金,67,8,59,群益金鼎-桃園,2023-02-24,9189
1314,中石化,51,0,51,群益金鼎-桃園,2023-02-24,9189
00637L,元大滬深300正2,74,30,44,群益金鼎-桃園,2023-02-24,9189
00878,國泰永續高股息,50,10,40,群益金鼎-桃園,2023-02-24,9189
2618,長榮航,41,2,39,群益金鼎-桃園,2023-02-24,9189
5009,榮剛,76,37,39,群益金鼎-桃園,2023-02-24,9189
2498,宏達電,51,13,38,群益金鼎-桃園,2023-02-24,9189
2344,華邦電,37,0,37,群益金鼎-桃園,2023-02-24,9189
6111,大宇資,30,0,30,群益金鼎-桃園,2023-02-24,9189
2363,矽統,31,1,30,群益金鼎-桃園,2023-02-24,9189
1513,中興電,44,15,29,群益金鼎-桃園,2023-02-24,9189
2317,鴻海,32,3,29,群益金鼎-桃園,2023-02-24,9189
3515,華擎,34,6,28,群益金鼎-桃園,2023-02-24,9189
3710,連展投控,24,1,23,群益金鼎-桃園,2023-02-24,9189
00642U,期元大S＆P石油,25,5,20,群益金鼎-桃園,2023-02-24,9189
6109,亞元,20,0,20,群益金鼎-桃園,2023-02-24,9189
3027,盛達,25,6,19,群益金鼎-桃園,2023-02-24,9189
2707,晶華,21,3,18,群益金鼎-桃園,2023-02-24,9189
0056,元大高股息,26,8,18,群益金鼎-桃園,2023-02-24,9189
2353,宏��,18,0,18,群益金鼎-桃園,2023-02-24,9189
2603,長榮,26,9,17,群益金鼎-桃園,2023-02-24,9189
00882,中信中國高股息,16,0,16,群益金鼎-桃園,2023-02-24,9189
3693,營邦,17,2,15,群益金鼎-桃園,2023-02-24,9189
00753L,中信中國50正2,15,0,15,群益金鼎-桃園,2023-02-24,9189
2408,南亞科,20,5,15,群益金鼎-桃園,2023-02-24,9189
00905,FT臺灣Smart,15,0,15,群益金鼎-桃園,2023-02-24,9189
2712,遠雄來,15,0,15,群益金鼎-桃園,2023-02-24,9189
4114,健喬,26,11,15,群益金鼎-桃園,2023-02-24,9189
3558,神準,18,4,14,群益金鼎-桃園,2023-02-24,9189
2601,益航,18,4,14,群益金鼎-桃園,2023-02-24,9189
2425,承啟,33,19,14,群益金鼎-桃園,2023-02-24,9189
3652,精聯,18,5,13,群益金鼎-桃園,2023-02-24,9189
00900,富邦特選高股息30,15,2,13,群益金鼎-桃園,2023-02-24,9189
00655L,國泰中國A50正2,17,5,12,群益金鼎-桃園,2023-02-24,9189
4763,材料-KY,27,15,12,群益金鼎-桃園,2023-02-24,9189
1701,中化,42,30,12,群益金鼎-桃園,2023-02-24,9189
8930,青鋼,12,0,12,群益金鼎-桃園,2023-02-24,9189
3093,港建*,11,0,11,群益金鼎-桃園,2023-02-24,9189
6153,嘉聯益,11,0,11,群益金鼎-桃園,2023-02-24,9189
2474,可成,25,15,10,群益金鼎-桃園,2023-02-24,9189
2347,聯強,10,0,10,群益金鼎-桃園,2023-02-24,9189
2892,第一金,10,0,10,群益金鼎-桃園,2023-02-24,9189
00902,中信電池及儲能,10,0,10,群益金鼎-桃園,2023-02-24,9189
3036,文曄,10,0,10,群益金鼎-桃園,2023-02-24,9189
00686R,群益臺灣加權反1,10,0,10,群益金鼎-桃園,2023-02-24,9189
3556,禾瑞亞,10,0,10,群益金鼎-桃園,2023-02-24,9189
3290,東浦,214,7,207,群益金鼎-桃園,2023-03-01,9189
1605,華新,189,14,175,群益金鼎-桃園,2023-03-01,9189
00878,國泰永續高股息,85,11,74,群益金鼎-桃園,2023-03-01,9189
00632R,元大台灣50反1,172,109,63,群益金鼎-桃園,2023-03-01,9189
2618,長榮航,59,5,54,群益金鼎-桃園,2023-03-01,9189
2605,新興,143,112,31,群益金鼎-桃園,2023-03-01,9189
6234,高僑,31,0,31,群益金鼎-桃園,2023-03-01,9189
2892,第一金,31,2,29,群益金鼎-桃園,2023-03-01,9189
8088,品安,21,0,21,群益金鼎-桃園,2023-03-01,9189
6282,康舒,45,24,21,群益金鼎-桃園,2023-03-01,9189
2607,榮運,21,0,21,群益金鼎-桃園,2023-03-01,9189
2020,美亞,20,0,20,群益金鼎-桃園,2023-03-01,9189
9945,潤泰新,20,0,20,群益金鼎-桃園,2023-03-01,9189
1789,神隆,20,0,20,群益金鼎-桃園,2023-03-01,9189
00650L,復華香港正2,20,0,20,群益金鼎-桃園,2023-03-01,9189
00720B,元大投資級公司債,18,0,18,群益金鼎-桃園,2023-03-01,9189
6541,泰福-KY,17,0,17,群益金鼎-桃園,2023-03-01,9189
2610,華航,43,26,17,群益金鼎-桃園,2023-03-01,9189
8050,廣積,17,1,16,群益金鼎-桃園,2023-03-01,9189
5464,霖宏,41,25,16,群益金鼎-桃園,2023-03-01,9189
2867,三商壽,15,0,15,群益金鼎-桃園,2023-03-01,9189
2359,所羅門,18,3,15,群益金鼎-桃園,2023-03-01,9189
1101,台泥,15,0,15,群益金鼎-桃園,2023-03-01,9189
1342,八貫,18,4,14,群益金鼎-桃園,2023-03-01,9189
2408,南亞科,15,1,14,群益金鼎-桃園,2023-03-01,9189
2606,裕民,22,9,13,群益金鼎-桃園,2023-03-01,9189
2371,大同,13,0,13,群益金鼎-桃園,2023-03-01,9189
6185,幃翔,13,0,13,群益金鼎-桃園,2023-03-01,9189
2409,友達,13,0,13,群益金鼎-桃園,2023-03-01,9189
1303,南亞,12,0,12,群益金鼎-桃園,2023-03-01,9189
00772B,中信高評級公司債,12,0,12,群益金鼎-桃園,2023-03-01,9189
6188,廣明,16,4,12,群益金鼎-桃園,2023-03-01,9189
5608,四維航,23,11,12,群益金鼎-桃園,2023-03-01,9189
2331,精英,11,0,11,群益金鼎-桃園,2023-03-01,9189
6118,建達,18,7,11,群益金鼎-桃園,2023-03-01,9189
2465,麗臺,11,0,11,群益金鼎-桃園,2023-03-01,9189
4979,華星光,11,0,11,群益金鼎-桃園,2023-03-01,9189
6477,安集,10,0,10,群益金鼎-桃園,2023-03-01,9189
3094,聯傑,10,0,10,群益金鼎-桃園,2023-03-01,9189
6129,普誠,10,0,10,群益金鼎-桃園,2023-03-01,9189
3556,禾瑞亞,10,0,10,群益金鼎-桃園,2023-03-01,9189
1513,中興電,15,6,9,群益金鼎-桃園,2023-03-01,9189
2317,鴻海,18,9,9,群益金鼎-桃園,2023-03-01,9189
2388,威盛,11,3,8,群益金鼎-桃園,2023-03-01,9189
1504,東元,10,2,8,群益金鼎-桃園,2023-03-01,9189
2883,凱基金,9,1,8,群益金鼎-桃園,2023-03-01,9189
4167,松瑞藥,11,3,8,群益金鼎-桃園,2023-03-01,9189
8289,泰藝,8,0,8,群益金鼎-桃園,2023-03-01,9189
2002,中鋼,11,4,7,群益金鼎-桃園,2023-03-01,9189
3652,精聯,18,11,7,群益金鼎-桃園,2023-03-01,9189
2303,聯電,161,12,149,群益金鼎-桃園,2023-03-02,9189
00680L,元大美債20正2,121,0,121,群益金鼎-桃園,2023-03-02,9189
00878,國泰永續高股息,78,1,77,群益金鼎-桃園,2023-03-02,9189
2834,臺企銀,65,6,59,群益金鼎-桃園,2023-03-02,9189
2409,友達,34,0,34,群益金鼎-桃園,2023-03-02,9189
2884,玉山金,33,0,33,群益金鼎-桃園,2023-03-02,9189
8176,智捷,30,0,30,群益金鼎-桃園,2023-03-02,9189
8034,榮群,30,0,30,群益金鼎-桃園,2023-03-02,9189
1734,杏輝,32,3,29,群益金鼎-桃園,2023-03-02,9189
1752,南光,45,16,29,群益金鼎-桃園,2023-03-02,9189
1101,台泥,25,0,25,群益金鼎-桃園,2023-03-02,9189
3022,威強電,25,0,25,群益金鼎-桃園,2023-03-02,9189
1605,華新,71,48,23,群益金鼎-桃園,2023-03-02,9189
2883,凱基金,21,0,21,群益金鼎-桃園,2023-03-02,9189
2748,雲品,24,4,20,群益金鼎-桃園,2023-03-02,9189
8049,晶采,21,1,20,群益金鼎-桃園,2023-03-02,9189
2485,兆赫,20,0,20,群益金鼎-桃園,2023-03-02,9189
6235,華孚,42,26,16,群益金鼎-桃園,2023-03-02,9189
00895,富邦未來車,15,0,15,群益金鼎-桃園,2023-03-02,9189
4915,致伸,19,4,15,群益金鼎-桃園,2023-03-02,9189
5258,虹堡,42,28,14,群益金鼎-桃園,2023-03-02,9189
5512,力麒,15,2,13,群益金鼎-桃園,2023-03-02,9189
2482,連宇,16,3,13,群益金鼎-桃園,2023-03-02,9189
1210,大成,15,3,12,群益金鼎-桃園,2023-03-02,9189
2605,新興,60,48,12,群益金鼎-桃園,2023-03-02,9189
2498,宏達電,32,20,12,群益金鼎-桃園,2023-03-02,9189
6806,森崴能源,11,0,11,群益金鼎-桃園,2023-03-02,9189
3701,大眾控,11,0,11,群益金鼎-桃園,2023-03-02,9189
5464,霖宏,21,10,11,群益金鼎-桃園,2023-03-02,9189
3646,艾恩特,12,1,11,群益金鼎-桃園,2023-03-02,9189
2891,中信金,11,0,11,群益金鼎-桃園,2023-03-02,9189
6118,建達,11,0,11,群益金鼎-桃園,2023-03-02,9189
3081,聯亞,13,2,11,群益金鼎-桃園,2023-03-02,9189
2458,義隆,10,0,10,群益金鼎-桃園,2023-03-02,9189
2484,希華,10,0,10,群益金鼎-桃園,2023-03-02,9189
1584,精剛,10,0,10,群益金鼎-桃園,2023-03-02,9189
00901,永豐智能車供應鏈,10,0,10,群益金鼎-桃園,2023-03-02,9189
2332,友訊,10,0,10,群益金鼎-桃園,2023-03-02,9189
6153,嘉聯益,10,0,10,群益金鼎-桃園,2023-03-02,9189
2888B,新光金乙特,10,0,10,群益金鼎-桃園,2023-03-02,9189
6109,亞元,10,0,10,群益金鼎-桃園,2023-03-02,9189
00679B,元大美債20年,10,0,10,群益金鼎-桃園,2023-03-02,9189
8401,白紗科,10,0,10,群益金鼎-桃園,2023-03-02,9189
6509,聚和,10,0,10,群益金鼎-桃園,2023-03-02,9189
6005,群益證,10,0,10,群益金鼎-桃園,2023-03-02,9189
2889,國票金,10,1,9,群益金鼎-桃園,2023-03-02,9189
2801,彰銀,10,1,9,群益金鼎-桃園,2023-03-02,9189
2607,榮運,14,5,9,群益金鼎-桃園,2023-03-02,9189
4190,佐登-KY,9,0,9,群益金鼎-桃園,2023-03-02,9189
4931,新盛力,12,3,9,群益金鼎-桃園,2023-03-02,9189
00632R,元大台灣50反1,255,0,255,群益金鼎-桃園,2023-03-03,9189
3290,東浦,105,4,101,群益金鼎-桃園,2023-03-03,9189
2388,威盛,65,20,45,群益金鼎-桃園,2023-03-03,9189
2498,宏達電,47,6,41,群益金鼎-桃園,2023-03-03,9189
00680L,元大美債20正2,35,0,35,群益金鼎-桃園,2023-03-03,9189
2845,遠東銀,28,0,28,群益金鼎-桃園,2023-03-03,9189
6282,康舒,36,14,22,群益金鼎-桃園,2023-03-03,9189
4763,材料-KY,40,19,21,群益金鼎-桃園,2023-03-03,9189
00772B,中信高評級公司債,20,0,20,群益金鼎-桃園,2023-03-03,9189
1402,遠東新,20,0,20,群益金鼎-桃園,2023-03-03,9189
2745,五福,20,0,20,群益金鼎-桃園,2023-03-03,9189
3037,欣興,35,18,17,群益金鼎-桃園,2023-03-03,9189
2615,萬海,18,3,15,群益金鼎-桃園,2023-03-03,9189
00650L,復華香港正2,15,0,15,群益金鼎-桃園,2023-03-03,9189
8358,金居,15,1,14,群益金鼎-桃園,2023-03-03,9189
00878,國泰永續高股息,19,6,13,群益金鼎-桃園,2023-03-03,9189
00901,永豐智能車供應鏈,13,0,13,群益金鼎-桃園,2023-03-03,9189
8930,青鋼,13,0,13,群益金鼎-桃園,2023-03-03,9189
2891,中信金,12,0,12,群益金鼎-桃園,2023-03-03,9189
2915,潤泰全,17,5,12,群益金鼎-桃園,2023-03-03,9189
2606,裕民,14,2,12,群益金鼎-桃園,2023-03-03,9189
2457,飛宏,28,17,11,群益金鼎-桃園,2023-03-03,9189
3027,盛達,36,25,11,群益金鼎-桃園,2023-03-03,9189
00751B,元大AAA至A公司債,11,0,11,群益金鼎-桃園,2023-03-03,9189
00919,群益台灣精選高息,11,0,11,群益金鼎-桃園,2023-03-03,9189
5512,力麒,11,0,11,群益金鼎-桃園,2023-03-03,9189
1734,杏輝,10,0,10,群益金鼎-桃園,2023-03-03,9189
1789,神隆,10,0,10,群益金鼎-桃園,2023-03-03,9189
2851,中再保,10,0,10,群益金鼎-桃園,2023-03-03,9189
8401,白紗科,10,0,10,群益金鼎-桃園,2023-03-03,9189
2462,良得電,10,0,10,群益金鼎-桃園,2023-03-03,9189
4977,眾達-KY,10,0,10,群益金鼎-桃園,2023-03-03,9189
5371,中光電,10,0,10,群益金鼎-桃園,2023-03-03,9189
3661,世芯-KY,14,4,10,群益金鼎-桃園,2023-03-03,9189
2732,六角,13,4,9,群益金鼎-桃園,2023-03-03,9189
4979,華星光,10,1,9,群益金鼎-桃園,2023-03-03,9189
2485,兆赫,10,1,9,群益金鼎-桃園,2023-03-03,9189
3322,建舜電,9,0,9,群益金鼎-桃園,2023-03-03,9189
4915,致伸,10,1,9,群益金鼎-桃園,2023-03-03,9189
00679B,元大美債20年,8,0,8,群益金鼎-桃園,2023-03-03,9189
3388,崇越電,8,0,8,群益金鼎-桃園,2023-03-03,9189
00713,元大台灣高息低波,8,1,7,群益金鼎-桃園,2023-03-03,9189
2617,台航,8,1,7,群益金鼎-桃園,2023-03-03,9189
2014,中鴻,27,20,7,群益金鼎-桃園,2023-03-03,9189
1513,中興電,20,14,6,群益金鼎-桃園,2023-03-03,9189
3675,德微,10,4,6,群益金鼎-桃園,2023-03-03,9189
3707,漢磊,7,1,6,群益金鼎-桃園,2023-03-03,9189
2610,華航,10,4,6,群益金鼎-桃園,2023-03-03,9189
2884,玉山金,6,0,6,群益金鼎-桃園,2023-03-03,9189
00877,復華中國5G,6,0,6,群益金鼎-桃園,2023-03-03,9189
00632R,元大台灣50反1,156,0,156,群益金鼎-桃園,2023-03-06,9189
2344,華邦電,87,24,63,群益金鼎-桃園,2023-03-06,9189
00637L,元大滬深300正2,112,59,53,群益金鼎-桃園,2023-03-06,9189
00673R,期元大S＆P原油反1,49,0,49,群益金鼎-桃園,2023-03-06,9189
00680L,元大美債20正2,51,2,49,群益金鼎-桃園,2023-03-06,9189
2609,陽明,62,23,39,群益金鼎-桃園,2023-03-06,9189
2892,第一金,38,0,38,群益金鼎-桃園,2023-03-06,9189
1708,東鹼,38,3,35,群益金鼎-桃園,2023-03-06,9189
2812,台中銀,28,0,28,群益金鼎-桃園,2023-03-06,9189
00753L,中信中國50正2,25,0,25,群益金鼎-桃園,2023-03-06,9189
1503,士電,27,2,25,群益金鼎-桃園,2023-03-06,9189
3305,昇貿,25,1,24,群益金鼎-桃園,2023-03-06,9189
8930,青鋼,22,0,22,群益金鼎-桃園,2023-03-06,9189
2891,中信金,21,0,21,群益金鼎-桃園,2023-03-06,9189
2485,兆赫,24,3,21,群益金鼎-桃園,2023-03-06,9189
5880,合庫金,21,0,21,群益金鼎-桃園,2023-03-06,9189
2637,慧洋-KY,22,2,20,群益金鼎-桃園,2023-03-06,9189
2605,新興,27,7,20,群益金鼎-桃園,2023-03-06,9189
8110,華東,20,0,20,群益金鼎-桃園,2023-03-06,9189
1707,葡萄王,20,0,20,群益金鼎-桃園,2023-03-06,9189
2337,旺宏,23,5,18,群益金鼎-桃園,2023-03-06,9189
00713,元大台灣高息低波,17,0,17,群益金鼎-桃園,2023-03-06,9189
2610,華航,18,2,16,群益金鼎-桃園,2023-03-06,9189
6231,系微,15,0,15,群益金鼎-桃園,2023-03-06,9189
3049,精金,15,0,15,群益金鼎-桃園,2023-03-06,9189
3022,威強電,19,7,12,群益金鼎-桃園,2023-03-06,9189
1444,力麗,10,0,10,群益金鼎-桃園,2023-03-06,9189
5351,鈺創,11,1,10,群益金鼎-桃園,2023-03-06,9189
2618,長榮航,9,0,9,群益金鼎-桃園,2023-03-06,9189
3264,欣銓,10,1,9,群益金鼎-桃園,2023-03-06,9189
2607,榮運,10,1,9,群益金鼎-桃園,2023-03-06,9189
00655L,國泰中國A50正2,9,0,9,群益金鼎-桃園,2023-03-06,9189
1514,亞力,11,2,9,群益金鼎-桃園,2023-03-06,9189
2617,台航,9,0,9,群益金鼎-桃園,2023-03-06,9189
4934,太極,9,0,9,群益金鼎-桃園,2023-03-06,9189
8176,智捷,9,1,8,群益金鼎-桃園,2023-03-06,9189
6191,精成科,9,1,8,群益金鼎-桃園,2023-03-06,9189
8046,南電,11,3,8,群益金鼎-桃園,2023-03-06,9189
1539,巨庭,20,12,8,群益金鼎-桃園,2023-03-06,9189
3704,合勤控,12,4,8,群益金鼎-桃園,2023-03-06,9189
2313,華通,10,2,8,群益金鼎-桃園,2023-03-06,9189
2606,裕民,11,3,8,群益金鼎-桃園,2023-03-06,9189
1605,華新,19,11,8,群益金鼎-桃園,2023-03-06,9189
2615,萬海,13,6,7,群益金鼎-桃園,2023-03-06,9189
3374,精材,9,2,7,群益金鼎-桃園,2023-03-06,9189
3675,德微,10,3,7,群益金鼎-桃園,2023-03-06,9189
3272,東碩,7,0,7,群益金鼎-桃園,2023-03-06,9189
2328,廣宇,10,3,7,群益金鼎-桃園,2023-03-06,9189
0056,元大高股息,12,6,6,群益金鼎-桃園,2023-03-06,9189
3362,先進光,20,14,6,群益金鼎-桃園,2023-03-06,9189
00673R,期元大S＆P原油反1,90,0,90,群益金鼎-桃園,2023-03-07,9189
00632R,元大台灣50反1,93,10,83,群益金鼎-桃園,2023-03-07,9189
3481,群創,75,13,62,群益金鼎-桃園,2023-03-07,9189
2882,國泰金,60,1,59,群益金鼎-桃園,2023-03-07,9189
2542,興富發,50,0,50,群益金鼎-桃園,2023-03-07,9189
1434,福懋,35,0,35,群益金鼎-桃園,2023-03-07,9189
00878,國泰永續高股息,44,11,33,群益金鼎-桃園,2023-03-07,9189
8930,青鋼,32,0,32,群益金鼎-桃園,2023-03-07,9189
1560,中砂,32,1,31,群益金鼎-桃園,2023-03-07,9189
8110,華東,31,0,31,群益金鼎-桃園,2023-03-07,9189
00680L,元大美債20正2,30,0,30,群益金鼎-桃園,2023-03-07,9189
6234,高僑,50,20,30,群益金鼎-桃園,2023-03-07,9189
2409,友達,47,23,24,群益金鼎-桃園,2023-03-07,9189
3013,晟銘電,51,27,24,群益金鼎-桃園,2023-03-07,9189
4979,華星光,28,5,23,群益金鼎-桃園,2023-03-07,9189
4927,泰鼎-KY,22,0,22,群益金鼎-桃園,2023-03-07,9189
9941,裕融,22,0,22,群益金鼎-桃園,2023-03-07,9189
6477,安集,20,0,20,群益金鼎-桃園,2023-03-07,9189
2023,燁輝,23,4,19,群益金鼎-桃園,2023-03-07,9189
3305,昇貿,18,0,18,群益金鼎-桃園,2023-03-07,9189
5009,榮剛,36,18,18,群益金鼎-桃園,2023-03-07,9189
00664R,國泰臺灣加權反1,17,0,17,群益金鼎-桃園,2023-03-07,9189
8261,富鼎,17,0,17,群益金鼎-桃園,2023-03-07,9189
2388,威盛,19,3,16,群益金鼎-桃園,2023-03-07,9189
1909,榮成,15,0,15,群益金鼎-桃園,2023-03-07,9189
2504,國產,15,0,15,群益金鼎-桃園,2023-03-07,9189
5263,智崴,14,0,14,群益金鼎-桃園,2023-03-07,9189
5512,力麒,43,31,12,群益金鼎-桃園,2023-03-07,9189
6116,彩晶,24,12,12,群益金鼎-桃園,2023-03-07,9189
4119,旭富,12,0,12,群益金鼎-桃園,2023-03-07,9189
6118,建達,12,0,12,群益金鼎-桃園,2023-03-07,9189
4167,松瑞藥,13,2,11,群益金鼎-桃園,2023-03-07,9189
6509,聚和,13,2,11,群益金鼎-桃園,2023-03-07,9189
3617,碩天,11,1,10,群益金鼎-桃園,2023-03-07,9189
2431,聯昌,10,0,10,群益金鼎-桃園,2023-03-07,9189
2881,富邦金,10,0,10,群益金鼎-桃園,2023-03-07,9189
4976,佳凌,37,27,10,群益金鼎-桃園,2023-03-07,9189
2464,盟立,10,0,10,群益金鼎-桃園,2023-03-07,9189
5222,全訊,10,0,10,群益金鼎-桃園,2023-03-07,9189
6245,立端,10,0,10,群益金鼎-桃園,2023-03-07,9189
9919,康那香,10,0,10,群益金鼎-桃園,2023-03-07,9189
6432,今展科,33,24,9,群益金鼎-桃園,2023-03-07,9189
2493,揚博,9,0,9,群益金鼎-桃園,2023-03-07,9189
2353,宏��,10,1,9,群益金鼎-桃園,2023-03-07,9189
00637L,元大滬深300正2,40,31,9,群益金鼎-桃園,2023-03-07,9189
2457,飛宏,30,21,9,群益金鼎-桃園,2023-03-07,9189
6269,台郡,8,0,8,群益金鼎-桃園,2023-03-07,9189
3037,欣興,20,12,8,群益金鼎-桃園,2023-03-07,9189
8341,日友,8,0,8,群益金鼎-桃園,2023-03-07,9189
2009,第一銅,11,3,8,群益金鼎-桃園,2023-03-07,9189
2891,中信金,98,1,97,群益金鼎-桃園,2023-03-08,9189
2610,華航,88,2,86,群益金鼎-桃園,2023-03-08,9189
6282,康舒,95,21,74,群益金鼎-桃園,2023-03-08,9189
00637L,元大滬深300正2,174,106,68,群益金鼎-桃園,2023-03-08,9189
00878,國泰永續高股息,72,8,64,群益金鼎-桃園,2023-03-08,9189
00706L,期元大S＆P日圓正2,61,2,59,群益金鼎-桃園,2023-03-08,9189
1605,華新,82,29,53,群益金鼎-桃園,2023-03-08,9189
2542,興富發,50,0,50,群益金鼎-桃園,2023-03-08,9189
3028,增你強,45,0,45,群益金鼎-桃園,2023-03-08,9189
2484,希華,45,1,44,群益金鼎-桃園,2023-03-08,9189
3029,零壹,56,16,40,群益金鼎-桃園,2023-03-08,9189
5009,榮剛,44,6,38,群益金鼎-桃園,2023-03-08,9189
5608,四維航,42,6,36,群益金鼎-桃園,2023-03-08,9189
3290,東浦,51,17,34,群益金鼎-桃園,2023-03-08,9189
6113,亞矽,30,0,30,群益金鼎-桃園,2023-03-08,9189
2344,華邦電,30,3,27,群益金鼎-桃園,2023-03-08,9189
2888,新光金,34,10,24,群益金鼎-桃園,2023-03-08,9189
00655L,國泰中國A50正2,23,0,23,群益金鼎-桃園,2023-03-08,9189
4934,太極,23,0,23,群益金鼎-桃園,2023-03-08,9189
00753L,中信中國50正2,22,0,22,群益金鼎-桃園,2023-03-08,9189
00901,永豐智能車供應鏈,22,0,22,群益金鼎-桃園,2023-03-08,9189
1504,東元,43,22,21,群益金鼎-桃園,2023-03-08,9189
8930,青鋼,20,0,20,群益金鼎-桃園,2023-03-08,9189
4736,泰博,21,1,20,群益金鼎-桃園,2023-03-08,9189
2634,漢翔,72,53,19,群益金鼎-桃園,2023-03-08,9189
3022,威強電,20,2,18,群益金鼎-桃園,2023-03-08,9189
6005,群益證,19,2,17,群益金鼎-桃園,2023-03-08,9189
1102,亞泥,16,0,16,群益金鼎-桃園,2023-03-08,9189
2603,長榮,27,11,16,群益金鼎-桃園,2023-03-08,9189
3092,鴻碩,15,0,15,群益金鼎-桃園,2023-03-08,9189
8105,凌巨,15,0,15,群益金鼎-桃園,2023-03-08,9189
00650L,復華香港正2,14,0,14,群益金鼎-桃園,2023-03-08,9189
00895,富邦未來車,13,0,13,群益金鼎-桃園,2023-03-08,9189
4976,佳凌,58,45,13,群益金鼎-桃園,2023-03-08,9189
2605,新興,13,0,13,群益金鼎-桃園,2023-03-08,9189
1709,和益,16,3,13,群益金鼎-桃園,2023-03-08,9189
00900,富邦特選高股息30,14,2,12,群益金鼎-桃園,2023-03-08,9189
3264,欣銓,18,6,12,群益金鼎-桃園,2023-03-08,9189
2722,夏都,21,9,12,群益金鼎-桃園,2023-03-08,9189
3013,晟銘電,27,15,12,群益金鼎-桃園,2023-03-08,9189
6290,良維,13,1,12,群益金鼎-桃園,2023-03-08,9189
2371,大同,15,3,12,群益金鼎-桃園,2023-03-08,9189
1503,士電,38,26,12,群益金鼎-桃園,2023-03-08,9189
00713,元大台灣高息低波,13,2,11,群益金鼎-桃園,2023-03-08,9189
6129,普誠,29,18,11,群益金鼎-桃園,2023-03-08,9189
00885,富邦越南,11,0,11,群益金鼎-桃園,2023-03-08,9189
6506,雙邦,10,0,10,群益金鼎-桃園,2023-03-08,9189
6196,帆宣,10,0,10,群益金鼎-桃園,2023-03-08,9189
3234,光環,10,0,10,群益金鼎-桃園,2023-03-08,9189
2482,連宇,31,21,10,群益金鼎-桃園,2023-03-08,9189
1540,喬福,72,0,72,群益金鼎-桃園,2023-03-09,9189
3481,群創,79,17,62,群益金鼎-桃園,2023-03-09,9189
2359,所羅門,103,48,55,群益金鼎-桃園,2023-03-09,9189
00878,國泰永續高股息,65,10,55,群益金鼎-桃園,2023-03-09,9189
2516,新建,50,0,50,群益金鼎-桃園,2023-03-09,9189
2408,南亞科,39,0,39,群益金鼎-桃園,2023-03-09,9189
2884,玉山金,37,0,37,群益金鼎-桃園,2023-03-09,9189
2618,長榮航,43,11,32,群益金鼎-桃園,2023-03-09,9189
4167,松瑞藥,32,0,32,群益金鼎-桃園,2023-03-09,9189
4130,健亞,35,4,31,群益金鼎-桃園,2023-03-09,9189
3046,建��,47,17,30,群益金鼎-桃園,2023-03-09,9189
2486,一詮,90,60,30,群益金鼎-桃園,2023-03-09,9189
2069,運錩,29,0,29,群益金鼎-桃園,2023-03-09,9189
2891,中信金,27,0,27,群益金鼎-桃園,2023-03-09,9189
6770,力積電,56,29,27,群益金鼎-桃園,2023-03-09,9189
2409,友達,77,50,27,群益金鼎-桃園,2023-03-09,9189
3356,奇偶,32,7,25,群益金鼎-桃園,2023-03-09,9189
6285,啟��,28,4,24,群益金鼎-桃園,2023-03-09,9189
3035,智原,83,59,24,群益金鼎-桃園,2023-03-09,9189
1513,中興電,68,46,22,群益金鼎-桃園,2023-03-09,9189
912000,晨訊科-DR,22,0,22,群益金鼎-桃園,2023-03-09,9189
2605,新興,23,2,21,群益金鼎-桃園,2023-03-09,9189
3712,永崴投控,40,20,20,群益金鼎-桃園,2023-03-09,9189
4979,華星光,30,10,20,群益金鼎-桃園,2023-03-09,9189
8930,青鋼,20,0,20,群益金鼎-桃園,2023-03-09,9189
3576,聯合再生,33,13,20,群益金鼎-桃園,2023-03-09,9189
6185,幃翔,20,0,20,群益金鼎-桃園,2023-03-09,9189
2736,富野,20,1,19,群益金鼎-桃園,2023-03-09,9189
2888,新光金,19,0,19,群益金鼎-桃園,2023-03-09,9189
2482,連宇,71,53,18,群益金鼎-桃園,2023-03-09,9189
2385,群光,17,0,17,群益金鼎-桃園,2023-03-09,9189
6129,普誠,25,8,17,群益金鼎-桃園,2023-03-09,9189
00637L,元大滬深300正2,31,14,17,群益金鼎-桃園,2023-03-09,9189
2607,榮運,16,0,16,群益金鼎-桃園,2023-03-09,9189
1605,華新,22,6,16,群益金鼎-桃園,2023-03-09,9189
9958,世紀鋼,15,0,15,群益金鼎-桃園,2023-03-09,9189
2368,金像電,17,2,15,群益金鼎-桃園,2023-03-09,9189
5464,霖宏,15,0,15,群益金鼎-桃園,2023-03-09,9189
3059,華晶科,15,1,14,群益金鼎-桃園,2023-03-09,9189
3022,威強電,15,1,14,群益金鼎-桃園,2023-03-09,9189
2634,漢翔,56,42,14,群益金鼎-桃園,2023-03-09,9189
2489,瑞軒,15,1,14,群益金鼎-桃園,2023-03-09,9189
5608,四維航,19,6,13,群益金鼎-桃園,2023-03-09,9189
2010,春源,13,0,13,群益金鼎-桃園,2023-03-09,9189
3362,先進光,26,14,12,群益金鼎-桃園,2023-03-09,9189
1584,精剛,13,1,12,群益金鼎-桃園,2023-03-09,9189
2312,金寶,12,0,12,群益金鼎-桃園,2023-03-09,9189
5443,均豪,11,0,11,群益金鼎-桃園,2023-03-09,9189
2880,華南金,11,0,11,群益金鼎-桃園,2023-03-09,9189
3704,合勤控,40,29,11,群益金鼎-桃園,2023-03-09,9189
3290,東浦,325,10,315,群益金鼎-桃園,2023-03-10,9189
00715L,期街口布蘭特正2,160,2,158,群益金鼎-桃園,2023-03-10,9189
00878,國泰永續高股息,145,11,134,群益金鼎-桃園,2023-03-10,9189
2610,華航,141,43,98,群益金鼎-桃園,2023-03-10,9189
3481,群創,133,57,76,群益金鼎-桃園,2023-03-10,9189
3046,建��,80,17,63,群益金鼎-桃園,2023-03-10,9189
2609,陽明,163,104,59,群益金鼎-桃園,2023-03-10,9189
3548,兆利,53,1,52,群益金鼎-桃園,2023-03-10,9189
4958,臻鼎-KY,50,0,50,群益金鼎-桃園,2023-03-10,9189
00683L,期元大美元指正2,50,0,50,群益金鼎-桃園,2023-03-10,9189
2344,華邦電,54,5,49,群益金鼎-桃園,2023-03-10,9189
4979,華星光,51,3,48,群益金鼎-桃園,2023-03-10,9189
2618,長榮航,68,23,45,群益金鼎-桃園,2023-03-10,9189
2453,凌群,100,55,45,群益金鼎-桃園,2023-03-10,9189
00753L,中信中國50正2,44,0,44,群益金鼎-桃園,2023-03-10,9189
2891,中信金,39,0,39,群益金鼎-桃園,2023-03-10,9189
8069,元太,40,6,34,群益金鼎-桃園,2023-03-10,9189
1605,華新,36,4,32,群益金鼎-桃園,2023-03-10,9189
00637L,元大滬深300正2,50,19,31,群益金鼎-桃園,2023-03-10,9189
2023,燁輝,29,0,29,群益金鼎-桃園,2023-03-10,9189
3712,永崴投控,35,6,29,群益金鼎-桃園,2023-03-10,9189
2884,玉山金,29,1,28,群益金鼎-桃園,2023-03-10,9189
2613,中櫃,30,2,28,群益金鼎-桃園,2023-03-10,9189
3576,聯合再生,31,3,28,群益金鼎-桃園,2023-03-10,9189
6274,台燿,76,50,26,群益金鼎-桃園,2023-03-10,9189
2534,宏盛,23,0,23,群益金鼎-桃園,2023-03-10,9189
00642U,期元大S＆P石油,23,0,23,群益金鼎-桃園,2023-03-10,9189
9945,潤泰新,23,0,23,群益金鼎-桃園,2023-03-10,9189
2882,國泰金,22,0,22,群益金鼎-桃園,2023-03-10,9189
00923,群益台ESG低碳50,52,30,22,群益金鼎-桃園,2023-03-10,9189
3441,聯一光,23,1,22,群益金鼎-桃園,2023-03-10,9189
2337,旺宏,22,0,22,群益金鼎-桃園,2023-03-10,9189
2330,台積電,21,1,20,群益金鼎-桃園,2023-03-10,9189
6190,萬泰科,20,0,20,群益金鼎-桃園,2023-03-10,9189
4908,前鼎,20,0,20,群益金鼎-桃園,2023-03-10,9189
1504,東元,40,20,20,群益金鼎-桃園,2023-03-10,9189
6109,亞元,20,0,20,群益金鼎-桃園,2023-03-10,9189
5258,虹堡,34,15,19,群益金鼎-桃園,2023-03-10,9189
2423,固緯,63,44,19,群益金鼎-桃園,2023-03-10,9189
2855,統一證,18,0,18,群益金鼎-桃園,2023-03-10,9189
6282,康舒,25,7,18,群益金鼎-桃園,2023-03-10,9189
2413,環科,81,63,18,群益金鼎-桃園,2023-03-10,9189
3037,欣興,18,1,17,群益金鼎-桃園,2023-03-10,9189
2409,友達,17,0,17,群益金鼎-桃園,2023-03-10,9189
2329,華泰,16,0,16,群益金鼎-桃園,2023-03-10,9189
6142,友勁,16,0,16,群益金鼎-桃園,2023-03-10,9189
6770,力積電,19,3,16,群益金鼎-桃園,2023-03-10,9189
2367,燿華,17,1,16,群益金鼎-桃園,2023-03-10,9189
2606,裕民,33,18,15,群益金鼎-桃園,2023-03-10,9189
2880,華南金,14,0,14,群益金鼎-桃園,2023-03-10,9189
00751B,元大AAA至A公司債,180,0,180,群益金鼎-桃園,2023-03-13,9189
00715L,期街口布蘭特正2,121,7,114,群益金鼎-桃園,2023-03-13,9189
2891,中信金,82,1,81,群益金鼎-桃園,2023-03-13,9189
2303,聯電,91,10,81,群益金鼎-桃園,2023-03-13,9189
00878,國泰永續高股息,142,83,59,群益金鼎-桃園,2023-03-13,9189
2888,新光金,55,1,54,群益金鼎-桃園,2023-03-13,9189
3024,憶聲,53,10,43,群益金鼎-桃園,2023-03-13,9189
2613,中櫃,34,0,34,群益金鼎-桃園,2023-03-13,9189
5014,建錩,30,0,30,群益金鼎-桃園,2023-03-13,9189
9105,泰金寶-DR,30,0,30,群益金鼎-桃園,2023-03-13,9189
00671R,富邦NASDAQ反1,30,0,30,群益金鼎-桃園,2023-03-13,9189
2363,矽統,29,1,28,群益金鼎-桃園,2023-03-13,9189
00923,群益台ESG低碳50,28,1,27,群益金鼎-桃園,2023-03-13,9189
911868,同方友友-DR,25,0,25,群益金鼎-桃園,2023-03-13,9189
1709,和益,31,9,22,群益金鼎-桃園,2023-03-13,9189
1504,東元,26,4,22,群益金鼎-桃園,2023-03-13,9189
1108,幸福,20,0,20,群益金鼎-桃園,2023-03-13,9189
6109,亞元,20,0,20,群益金鼎-桃園,2023-03-13,9189
2609,陽明,50,31,19,群益金鼎-桃園,2023-03-13,9189
00902,中信電池及儲能,18,0,18,群益金鼎-桃園,2023-03-13,9189
4958,臻鼎-KY,17,0,17,群益金鼎-桃園,2023-03-13,9189
1524,耿鼎,18,3,15,群益金鼎-桃園,2023-03-13,9189
2881,富邦金,14,0,14,群益金鼎-桃園,2023-03-13,9189
6235,華孚,23,9,14,群益金鼎-桃園,2023-03-13,9189
2634,漢翔,18,4,14,群益金鼎-桃園,2023-03-13,9189
3704,合勤控,20,7,13,群益金鼎-桃園,2023-03-13,9189
6122,擎邦,14,1,13,群益金鼎-桃園,2023-03-13,9189
2388,威盛,44,31,13,群益金鼎-桃園,2023-03-13,9189
4906,正文,12,0,12,群益金鼎-桃園,2023-03-13,9189
6182,合晶,12,0,12,群益金鼎-桃園,2023-03-13,9189
1339,昭輝,12,0,12,群益金鼎-桃園,2023-03-13,9189
6239,力成,11,0,11,群益金鼎-桃園,2023-03-13,9189
2023,燁輝,10,0,10,群益金鼎-桃園,2023-03-13,9189
2504,國產,10,0,10,群益金鼎-桃園,2023-03-13,9189
00877,復華中國5G,10,0,10,群益金鼎-桃園,2023-03-13,9189
3710,連展投控,10,0,10,群益金鼎-桃園,2023-03-13,9189
6274,台燿,15,5,10,群益金鼎-桃園,2023-03-13,9189
5230,雷笛克光學,10,0,10,群益金鼎-桃園,2023-03-13,9189
3520,華盈,10,0,10,群益金鼎-桃園,2023-03-13,9189
2464,盟立,10,0,10,群益金鼎-桃園,2023-03-13,9189
2359,所羅門,11,1,10,群益金鼎-桃園,2023-03-13,9189
6874,倍力,9,0,9,群益金鼎-桃園,2023-03-13,9189
5439,高技,12,3,9,群益金鼎-桃園,2023-03-13,9189
4979,華星光,10,1,9,群益金鼎-桃園,2023-03-13,9189
6568,宏觀,9,0,9,群益金鼎-桃園,2023-03-13,9189
2605,新興,32,23,9,群益金鼎-桃園,2023-03-13,9189
00907,永豐優息存股,8,0,8,群益金鼎-桃園,2023-03-13,9189
1609,大亞,8,0,8,群益金鼎-桃園,2023-03-13,9189
1319,東陽,9,1,8,群益金鼎-桃園,2023-03-13,9189
3521,鴻翊,8,0,8,群益金鼎-桃園,2023-03-13,9189
2633,台灣高鐵,442,0,442,群益金鼎-桃園,2023-03-14,9189
2610,華航,178,25,153,群益金鼎-桃園,2023-03-14,9189
00715L,期街口布蘭特正2,137,0,137,群益金鼎-桃園,2023-03-14,9189
00878,國泰永續高股息,158,30,128,群益金鼎-桃園,2023-03-14,9189
2618,長榮航,140,15,125,群益金鼎-桃園,2023-03-14,9189
6477,安集,110,8,102,群益金鼎-桃園,2023-03-14,9189
2891,中信金,75,0,75,群益金鼎-桃園,2023-03-14,9189
3576,聯合再生,145,88,57,群益金鼎-桃園,2023-03-14,9189
4167,松瑞藥,61,5,56,群益金鼎-桃園,2023-03-14,9189
2542,興富發,50,0,50,群益金鼎-桃園,2023-03-14,9189
00753L,中信中國50正2,47,0,47,群益金鼎-桃園,2023-03-14,9189
00642U,期元大S＆P石油,39,0,39,群益金鼎-桃園,2023-03-14,9189
00751B,元大AAA至A公司債,39,0,39,群益金鼎-桃園,2023-03-14,9189
00712,復華富時不動產,33,0,33,群益金鼎-桃園,2023-03-14,9189
5880,合庫金,32,0,32,群益金鼎-桃園,2023-03-14,9189
00655L,國泰中國A50正2,36,5,31,群益金鼎-桃園,2023-03-14,9189
2027,大成鋼,61,30,31,群益金鼎-桃園,2023-03-14,9189
2883,凱基金,44,14,30,群益金鼎-桃園,2023-03-14,9189
00893,國泰智能電動車,29,0,29,群益金鼎-桃園,2023-03-14,9189
1513,中興電,47,18,29,群益金鼎-桃園,2023-03-14,9189
3264,欣銓,35,7,28,群益金鼎-桃園,2023-03-14,9189
2889,國票金,26,1,25,群益金鼎-桃園,2023-03-14,9189
00637L,元大滬深300正2,53,30,23,群益金鼎-桃園,2023-03-14,9189
2359,所羅門,23,0,23,群益金鼎-桃園,2023-03-14,9189
2892,第一金,32,9,23,群益金鼎-桃園,2023-03-14,9189
00895,富邦未來車,22,0,22,群益金鼎-桃園,2023-03-14,9189
00713,元大台灣高息低波,22,1,21,群益金鼎-桃園,2023-03-14,9189
9934,成霖,20,0,20,群益金鼎-桃園,2023-03-14,9189
6163,華電網,22,2,20,群益金鼎-桃園,2023-03-14,9189
5284,jpp-KY,20,0,20,群益金鼎-桃園,2023-03-14,9189
1707,葡萄王,20,1,19,群益金鼎-桃園,2023-03-14,9189
4114,健喬,21,2,19,群益金鼎-桃園,2023-03-14,9189
00679B,元大美債20年,45,27,18,群益金鼎-桃園,2023-03-14,9189
8222,寶一,40,24,16,群益金鼎-桃園,2023-03-14,9189
00882,中信中國高股息,16,0,16,群益金鼎-桃園,2023-03-14,9189
1314,中石化,15,0,15,群益金鼎-桃園,2023-03-14,9189
4707,磐亞,15,0,15,群益金鼎-桃園,2023-03-14,9189
2457,飛宏,52,37,15,群益金鼎-桃園,2023-03-14,9189
00885,富邦越南,14,0,14,群益金鼎-桃園,2023-03-14,9189
2882,國泰金,13,0,13,群益金鼎-桃園,2023-03-14,9189
3712,永崴投控,22,10,12,群益金鼎-桃園,2023-03-14,9189
6275,元山,12,0,12,群益金鼎-桃園,2023-03-14,9189
2887,台新金,11,0,11,群益金鼎-桃園,2023-03-14,9189
1712,興農,11,0,11,群益金鼎-桃園,2023-03-14,9189
2388,威盛,60,49,11,群益金鼎-桃園,2023-03-14,9189
1605,華新,14,3,11,群益金鼎-桃園,2023-03-14,9189
6153,嘉聯益,11,0,11,群益金鼎-桃園,2023-03-14,9189
3013,晟銘電,11,0,11,群益金鼎-桃園,2023-03-14,9189
2495,普安,19,8,11,群益金鼎-桃園,2023-03-14,9189
2017,官田鋼,11,0,11,群益金鼎-桃園,2023-03-14,9189
2888,新光金,227,20,207,群益金鼎-桃園,2023-03-15,9189
00680L,元大美債20正2,201,0,201,群益金鼎-桃園,2023-03-15,9189
2891,中信金,107,0,107,群益金鼎-桃園,2023-03-15,9189
00632R,元大台灣50反1,128,55,73,群益金鼎-桃園,2023-03-15,9189
2313,華通,71,1,70,群益金鼎-桃園,2023-03-15,9189
00878,國泰永續高股息,67,8,59,群益金鼎-桃園,2023-03-15,9189
00715L,期街口布蘭特正2,57,1,56,群益金鼎-桃園,2023-03-15,9189
2542,興富發,55,1,54,群益金鼎-桃園,2023-03-15,9189
2603,長榮,120,75,45,群益金鼎-桃園,2023-03-15,9189
00637L,元大滬深300正2,94,52,42,群益金鼎-桃園,2023-03-15,9189
3712,永崴投控,40,1,39,群益金鼎-桃園,2023-03-15,9189
2515,中工,31,1,30,群益金鼎-桃園,2023-03-15,9189
6109,亞元,30,0,30,群益金鼎-桃園,2023-03-15,9189
2609,陽明,55,27,28,群益金鼎-桃園,2023-03-15,9189
2481,強茂,30,4,26,群益金鼎-桃園,2023-03-15,9189
2409,友達,25,0,25,群益金鼎-桃園,2023-03-15,9189
2880,華南金,22,0,22,群益金鼎-桃園,2023-03-15,9189
4903,聯光通,20,0,20,群益金鼎-桃園,2023-03-15,9189
5464,霖宏,20,0,20,群益金鼎-桃園,2023-03-15,9189
00642U,期元大S＆P石油,22,2,20,群益金鼎-桃園,2023-03-15,9189
2915,潤泰全,37,19,18,群益金鼎-桃園,2023-03-15,9189
1519,華城,20,2,18,群益金鼎-桃園,2023-03-15,9189
2317,鴻海,17,0,17,群益金鼎-桃園,2023-03-15,9189
6163,華電網,40,23,17,群益金鼎-桃園,2023-03-15,9189
9945,潤泰新,17,0,17,群益金鼎-桃園,2023-03-15,9189
2633,台灣高鐵,17,1,16,群益金鼎-桃園,2023-03-15,9189
3264,欣銓,22,6,16,群益金鼎-桃園,2023-03-15,9189
2883,凱基金,15,0,15,群益金鼎-桃園,2023-03-15,9189
00712,復華富時不動產,15,0,15,群益金鼎-桃園,2023-03-15,9189
6111,大宇資,14,0,14,群益金鼎-桃園,2023-03-15,9189
2889,國票金,14,0,14,群益金鼎-桃園,2023-03-15,9189
2892,第一金,31,18,13,群益金鼎-桃園,2023-03-15,9189
5880,合庫金,17,5,12,群益金鼎-桃園,2023-03-15,9189
00713,元大台灣高息低波,13,1,12,群益金鼎-桃園,2023-03-15,9189
2413,環科,17,5,12,群益金鼎-桃園,2023-03-15,9189
00679B,元大美債20年,12,0,12,群益金鼎-桃園,2023-03-15,9189
3005,神基,12,0,12,群益金鼎-桃園,2023-03-15,9189
4129,聯合,12,0,12,群益金鼎-桃園,2023-03-15,9189
2845,遠東銀,14,2,12,群益金鼎-桃園,2023-03-15,9189
8936,國統,11,0,11,群益金鼎-桃園,2023-03-15,9189
3217,優群,11,0,11,群益金鼎-桃園,2023-03-15,9189
9910,豐泰,10,0,10,群益金鼎-桃園,2023-03-15,9189
2613,中櫃,10,0,10,群益金鼎-桃園,2023-03-15,9189
00888,永豐台灣ESG,10,0,10,群益金鼎-桃園,2023-03-15,9189
1536,和大,10,0,10,群益金鼎-桃園,2023-03-15,9189
00897,富邦基因免疫生技,10,0,10,群益金鼎-桃園,2023-03-15,9189
6283,淳安,10,0,10,群益金鼎-桃園,2023-03-15,9189
00772B,中信高評級公司債,8,0,8,群益金鼎-桃園,2023-03-15,9189
6228,全譜,8,0,8,群益金鼎-桃園,2023-03-15,9189
6142,友勁,8,0,8,群益金鼎-桃園,2023-03-15,9189
2834,臺企銀,196,13,183,群益金鼎-桃園,2023-03-16,9189
2888,新光金,148,4,144,群益金鼎-桃園,2023-03-16,9189
2884,玉山金,102,0,102,群益金鼎-桃園,2023-03-16,9189
5515,建國,100,0,100,群益金鼎-桃園,2023-03-16,9189
00878,國泰永續高股息,96,1,95,群益金鼎-桃園,2023-03-16,9189
2891,中信金,64,5,59,群益金鼎-桃園,2023-03-16,9189
2883,凱基金,63,5,58,群益金鼎-桃園,2023-03-16,9189
2489,瑞軒,55,0,55,群益金鼎-桃園,2023-03-16,9189
2603,長榮,56,8,48,群益金鼎-桃園,2023-03-16,9189
1301,台塑,46,0,46,群益金鼎-桃園,2023-03-16,9189
2609,陽明,66,21,45,群益金鼎-桃園,2023-03-16,9189
2010,春源,50,5,45,群益金鼎-桃園,2023-03-16,9189
2605,新興,58,17,41,群益金鼎-桃園,2023-03-16,9189
00689R,國泰20年美債反1,41,0,41,群益金鼎-桃園,2023-03-16,9189
00642U,期元大S＆P石油,41,0,41,群益金鼎-桃園,2023-03-16,9189
2498,宏達電,38,3,35,群益金鼎-桃園,2023-03-16,9189
3264,欣銓,33,0,33,群益金鼎-桃園,2023-03-16,9189
2618,長榮航,40,8,32,群益金鼎-桃園,2023-03-16,9189
5464,霖宏,30,0,30,群益金鼎-桃園,2023-03-16,9189
4934,太極,36,9,27,群益金鼎-桃園,2023-03-16,9189
8936,國統,28,1,27,群益金鼎-桃園,2023-03-16,9189
1504,東元,36,9,27,群益金鼎-桃園,2023-03-16,9189
1711,永光,25,0,25,群益金鼎-桃園,2023-03-16,9189
1605,華新,25,2,23,群益金鼎-桃園,2023-03-16,9189
2887,台新金,25,4,21,群益金鼎-桃園,2023-03-16,9189
2610,華航,44,24,20,群益金鼎-桃園,2023-03-16,9189
6271,同欣電,25,5,20,群益金鼎-桃園,2023-03-16,9189
3707,漢磊,21,1,20,群益金鼎-桃園,2023-03-16,9189
3047,訊舟,19,0,19,群益金鼎-桃園,2023-03-16,9189
1533,車王電,39,21,18,群益金鼎-桃園,2023-03-16,9189
2880,華南金,18,0,18,群益金鼎-桃園,2023-03-16,9189
2402,毅嘉,19,2,17,群益金鼎-桃園,2023-03-16,9189
2545,皇翔,17,0,17,群益金鼎-桃園,2023-03-16,9189
6244,茂迪,31,14,17,群益金鼎-桃園,2023-03-16,9189
2606,裕民,16,0,16,群益金鼎-桃園,2023-03-16,9189
3710,連展投控,15,0,15,群益金鼎-桃園,2023-03-16,9189
00712,復華富時不動產,15,2,13,群益金鼎-桃園,2023-03-16,9189
2845,遠東銀,13,0,13,群益金鼎-桃園,2023-03-16,9189
2313,華通,14,1,13,群益金鼎-桃園,2023-03-16,9189
9955,佳龍,14,2,12,群益金鼎-桃園,2023-03-16,9189
00923,群益台ESG低碳50,12,0,12,群益金鼎-桃園,2023-03-16,9189
2889,國票金,12,0,12,群益金鼎-桃園,2023-03-16,9189
1611,中電,70,58,12,群益金鼎-桃園,2023-03-16,9189
2027,大成鋼,14,2,12,群益金鼎-桃園,2023-03-16,9189
2886,兆豐金,14,2,12,群益金鼎-桃園,2023-03-16,9189
00713,元大台灣高息低波,16,5,11,群益金鼎-桃園,2023-03-16,9189
4128,中天,13,2,11,群益金鼎-桃園,2023-03-16,9189
6470,宇智,11,0,11,群益金鼎-桃園,2023-03-16,9189
6116,彩晶,17,6,11,群益金鼎-桃園,2023-03-16,9189
6283,淳安,11,0,11,群益金鼎-桃園,2023-03-16,9189
3035,智原,154,81,73,群益金鼎-桃園,2023-03-17,9189
00878,國泰永續高股息,72,0,72,群益金鼎-桃園,2023-03-17,9189
2010,春源,60,0,60,群益金鼎-桃園,2023-03-17,9189
2891,中信金,88,42,46,群益金鼎-桃園,2023-03-17,9189
2409,友達,106,67,39,群益金鼎-桃園,2023-03-17,9189
8171,天宇,32,0,32,群益金鼎-桃園,2023-03-17,9189
00715L,期街口布蘭特正2,139,108,31,群益金鼎-桃園,2023-03-17,9189
1519,華城,36,6,30,群益金鼎-桃園,2023-03-17,9189
2610,華航,60,32,28,群益金鼎-桃園,2023-03-17,9189
00679B,元大美債20年,27,0,27,群益金鼎-桃園,2023-03-17,9189
00671R,富邦NASDAQ反1,25,0,25,群益金鼎-桃園,2023-03-17,9189
2888,新光金,26,2,24,群益金鼎-桃園,2023-03-17,9189
2399,映泰,33,9,24,群益金鼎-桃園,2023-03-17,9189
6185,幃翔,23,0,23,群益金鼎-桃園,2023-03-17,9189
6215,和椿,23,0,23,群益金鼎-桃園,2023-03-17,9189
3209,全科,21,1,20,群益金鼎-桃園,2023-03-17,9189
4915,致伸,20,1,19,群益金鼎-桃園,2023-03-17,9189
3264,欣銓,26,7,19,群益金鼎-桃園,2023-03-17,9189
8222,寶一,29,10,19,群益金鼎-桃園,2023-03-17,9189
00642U,期元大S＆P石油,20,2,18,群益金鼎-桃園,2023-03-17,9189
2834,臺企銀,29,13,16,群益金鼎-桃園,2023-03-17,9189
00646,元大S＆P500,15,0,15,群益金鼎-桃園,2023-03-17,9189
4736,泰博,15,1,14,群益金鼎-桃園,2023-03-17,9189
00713,元大台灣高息低波,13,0,13,群益金鼎-桃園,2023-03-17,9189
3653,健策,12,0,12,群益金鼎-桃園,2023-03-17,9189
2889,國票金,12,0,12,群益金鼎-桃園,2023-03-17,9189
00923,群益台ESG低碳50,11,0,11,群益金鼎-桃園,2023-03-17,9189
3710,連展投控,11,0,11,群益金鼎-桃園,2023-03-17,9189
1308,亞聚,11,0,11,群益金鼎-桃園,2023-03-17,9189
2482,連宇,15,5,10,群益金鼎-桃園,2023-03-17,9189
00665L,富邦�琤肭磪囓�2,10,0,10,群益金鼎-桃園,2023-03-17,9189
3704,合勤控,15,5,10,群益金鼎-桃園,2023-03-17,9189
4903,聯光通,10,0,10,群益金鼎-桃園,2023-03-17,9189
2812,台中銀,9,0,9,群益金鼎-桃園,2023-03-17,9189
3260,威剛,10,1,9,群益金鼎-桃園,2023-03-17,9189
00631L,元大台灣50正2,9,0,9,群益金鼎-桃園,2023-03-17,9189
3236,千如,10,1,9,群益金鼎-桃園,2023-03-17,9189
1210,大成,8,0,8,群益金鼎-桃園,2023-03-17,9189
6226,光鼎,7,0,7,群益金鼎-桃園,2023-03-17,9189
6188,廣明,8,1,7,群益金鼎-桃園,2023-03-17,9189
6125,廣運,11,4,7,群益金鼎-桃園,2023-03-17,9189
6116,彩晶,7,0,7,群益金鼎-桃園,2023-03-17,9189
4979,華星光,7,0,7,群益金鼎-桃園,2023-03-17,9189
6111,大宇資,7,0,7,群益金鼎-桃園,2023-03-17,9189
8033,雷虎,7,0,7,群益金鼎-桃園,2023-03-17,9189
2324,仁寶,7,1,6,群益金鼎-桃園,2023-03-17,9189
6271,同欣電,7,1,6,群益金鼎-桃園,2023-03-17,9189
8050,廣積,7,1,6,群益金鼎-桃園,2023-03-17,9189
00647L,元大S＆P500正2,6,0,6,群益金鼎-桃園,2023-03-17,9189
6129,普誠,8,2,6,群益金鼎-桃園,2023-03-17,9189
1605,華新,158,0,158,群益金鼎-桃園,2023-03-20,9189
00637L,元大滬深300正2,149,19,130,群益金鼎-桃園,2023-03-20,9189
00772B,中信高評級公司債,88,0,88,群益金鼎-桃園,2023-03-20,9189
00878,國泰永續高股息,82,0,82,群益金鼎-桃園,2023-03-20,9189
00753L,中信中國50正2,65,4,61,群益金鼎-桃園,2023-03-20,9189
2485,兆赫,55,0,55,群益金鼎-桃園,2023-03-20,9189
00632R,元大台灣50反1,50,0,50,群益金鼎-桃園,2023-03-20,9189
00712,復華富時不動產,60,13,47,群益金鼎-桃園,2023-03-20,9189
4979,華星光,49,7,42,群益金鼎-桃園,2023-03-20,9189
8222,寶一,73,32,41,群益金鼎-桃園,2023-03-20,9189
2888,新光金,42,2,40,群益金鼎-桃園,2023-03-20,9189
3013,晟銘電,32,0,32,群益金鼎-桃園,2023-03-20,9189
1514,亞力,37,11,26,群益金鼎-桃園,2023-03-20,9189
3027,盛達,53,27,26,群益金鼎-桃園,2023-03-20,9189
00642U,期元大S＆P石油,25,0,25,群益金鼎-桃園,2023-03-20,9189
2915,潤泰全,24,0,24,群益金鼎-桃園,2023-03-20,9189
2891,中信金,23,0,23,群益金鼎-桃園,2023-03-20,9189
5512,力麒,43,20,23,群益金鼎-桃園,2023-03-20,9189
2882,國泰金,26,5,21,群益金鼎-桃園,2023-03-20,9189
00900,富邦特選高股息30,21,1,20,群益金鼎-桃園,2023-03-20,9189
9945,潤泰新,35,18,17,群益金鼎-桃園,2023-03-20,9189
1108,幸福,29,12,17,群益金鼎-桃園,2023-03-20,9189
3290,東浦,35,19,16,群益金鼎-桃園,2023-03-20,9189
2481,強茂,24,8,16,群益金鼎-桃園,2023-03-20,9189
1304,台聚,14,0,14,群益金鼎-桃園,2023-03-20,9189
2834,臺企銀,21,9,12,群益金鼎-桃園,2023-03-20,9189
2352,佳世達,22,10,12,群益金鼎-桃園,2023-03-20,9189
2387,精元,13,1,12,群益金鼎-桃園,2023-03-20,9189
5347,世界,13,1,12,群益金鼎-桃園,2023-03-20,9189
6235,華孚,18,6,12,群益金鼎-桃園,2023-03-20,9189
00905,FT臺灣Smart,11,0,11,群益金鼎-桃園,2023-03-20,9189
3029,零壹,25,15,10,群益金鼎-桃園,2023-03-20,9189
00917,中信特選金融,10,0,10,群益金鼎-桃園,2023-03-20,9189
00881,國泰台灣5G+,10,0,10,群益金鼎-桃園,2023-03-20,9189
3466,德晉,10,0,10,群益金鼎-桃園,2023-03-20,9189
3209,全科,10,0,10,群益金鼎-桃園,2023-03-20,9189
5478,智冠,10,0,10,群益金鼎-桃園,2023-03-20,9189
8215,明基材,10,0,10,群益金鼎-桃園,2023-03-20,9189
00882,中信中國高股息,10,0,10,群益金鼎-桃園,2023-03-20,9189
2482,連宇,36,26,10,群益金鼎-桃園,2023-03-20,9189
2457,飛宏,37,28,9,群益金鼎-桃園,2023-03-20,9189
00689R,國泰20年美債反1,8,0,8,群益金鼎-桃園,2023-03-20,9189
3380,明泰,8,0,8,群益金鼎-桃園,2023-03-20,9189
2731,雄獅,10,2,8,群益金鼎-桃園,2023-03-20,9189
3707,漢磊,16,8,8,群益金鼎-桃園,2023-03-20,9189
0050,元大台灣50,7,0,7,群益金鼎-桃園,2023-03-20,9189
1609,大亞,20,13,7,群益金鼎-桃園,2023-03-20,9189
2302,麗正,7,0,7,群益金鼎-桃園,2023-03-20,9189
3511,矽瑪,7,0,7,群益金鼎-桃園,2023-03-20,9189
2459,敦吉,6,0,6,群益金鼎-桃園,2023-03-20,9189
00720B,元大投資級公司債,378,0,378,群益金鼎-桃園,2023-03-21,9189
2891,中信金,210,0,210,群益金鼎-桃園,2023-03-21,9189
3051,力特,150,51,99,群益金鼎-桃園,2023-03-21,9189
2834,臺企銀,90,2,88,群益金鼎-桃園,2023-03-21,9189
00680L,元大美債20正2,60,0,60,群益金鼎-桃園,2023-03-21,9189
00715L,期街口布蘭特正2,126,69,57,群益金鼎-桃園,2023-03-21,9189
2010,春源,50,0,50,群益金鼎-桃園,2023-03-21,9189
6282,康舒,53,18,35,群益金鼎-桃園,2023-03-21,9189
2344,華邦電,44,14,30,群益金鼎-桃園,2023-03-21,9189
4109,加捷生醫,28,0,28,群益金鼎-桃園,2023-03-21,9189
2601,益航,30,3,27,群益金鼎-桃園,2023-03-21,9189
9933,中鼎,26,0,26,群益金鼎-桃園,2023-03-21,9189
6214,精誠,26,1,25,群益金鼎-桃園,2023-03-21,9189
2481,強茂,25,1,24,群益金鼎-桃園,2023-03-21,9189
3628,盈正,23,0,23,群益金鼎-桃園,2023-03-21,9189
00671R,富邦NASDAQ反1,23,0,23,群益金鼎-桃園,2023-03-21,9189
4167,松瑞藥,21,0,21,群益金鼎-桃園,2023-03-21,9189
2882,國泰金,23,3,20,群益金鼎-桃園,2023-03-21,9189
2408,南亞科,20,0,20,群益金鼎-桃園,2023-03-21,9189
3702,大聯大,20,1,19,群益金鼎-桃園,2023-03-21,9189
9939,宏全,20,1,19,群益金鼎-桃園,2023-03-21,9189
5203,訊連,19,1,18,群益金鼎-桃園,2023-03-21,9189
7402,邑錡,17,0,17,群益金鼎-桃園,2023-03-21,9189
00878,國泰永續高股息,22,6,16,群益金鼎-桃園,2023-03-21,9189
1605,華新,20,6,14,群益金鼎-桃園,2023-03-21,9189
3209,全科,15,2,13,群益金鼎-桃園,2023-03-21,9189
00888,永豐台灣ESG,13,0,13,群益金鼎-桃園,2023-03-21,9189
5211,蒙恬,12,0,12,群益金鼎-桃園,2023-03-21,9189
1519,華城,24,13,11,群益金鼎-桃園,2023-03-21,9189
1611,中電,12,1,11,群益金鼎-桃園,2023-03-21,9189
1603,華電,17,6,11,群益金鼎-桃園,2023-03-21,9189
3022,威強電,13,2,11,群益金鼎-桃園,2023-03-21,9189
00885,富邦越南,11,1,10,群益金鼎-桃園,2023-03-21,9189
2609,陽明,14,4,10,群益金鼎-桃園,2023-03-21,9189
00902,中信電池及儲能,10,0,10,群益金鼎-桃園,2023-03-21,9189
2328,廣宇,10,0,10,群益金鼎-桃園,2023-03-21,9189
00830,國泰費城半導體,10,0,10,群益金鼎-桃園,2023-03-21,9189
1504,東元,23,13,10,群益金鼎-桃園,2023-03-21,9189
3058,立德,10,0,10,群益金鼎-桃園,2023-03-21,9189
5347,世界,10,0,10,群益金鼎-桃園,2023-03-21,9189
2402,毅嘉,33,23,10,群益金鼎-桃園,2023-03-21,9189
00891,中信關鍵半導體,15,5,10,群益金鼎-桃園,2023-03-21,9189
4960,誠美材,12,2,10,群益金鼎-桃園,2023-03-21,9189
6283,淳安,10,0,10,群益金鼎-桃園,2023-03-21,9189
8050,廣積,10,0,10,群益金鼎-桃園,2023-03-21,9189
6191,精成科,19,9,10,群益金鼎-桃園,2023-03-21,9189
5425,台半,15,5,10,群益金鼎-桃園,2023-03-21,9189
1101,台泥,9,0,9,群益金鼎-桃園,2023-03-21,9189
00882,中信中國高股息,9,0,9,群益金鼎-桃園,2023-03-21,9189
2634,漢翔,23,14,9,群益金鼎-桃園,2023-03-21,9189
00632R,元大台灣50反1,203,0,203,群益金鼎-桃園,2023-03-22,9189
2605,新興,87,25,62,群益金鼎-桃園,2023-03-22,9189
6443,元晶,66,7,59,群益金鼎-桃園,2023-03-22,9189
00680L,元大美債20正2,47,3,44,群益金鼎-桃園,2023-03-22,9189
2485,兆赫,40,5,35,群益金鼎-桃園,2023-03-22,9189
2402,毅嘉,50,18,32,群益金鼎-桃園,2023-03-22,9189
3481,群創,32,1,31,群益金鼎-桃園,2023-03-22,9189
00686R,群益臺灣加權反1,30,0,30,群益金鼎-桃園,2023-03-22,9189
00671R,富邦NASDAQ反1,30,4,26,群益金鼎-桃園,2023-03-22,9189
2495,普安,37,11,26,群益金鼎-桃園,2023-03-22,9189
5009,榮剛,27,2,25,群益金鼎-桃園,2023-03-22,9189
3094,聯傑,26,1,25,群益金鼎-桃園,2023-03-22,9189
2409,友達,27,3,24,群益金鼎-桃園,2023-03-22,9189
4915,致伸,24,0,24,群益金鼎-桃園,2023-03-22,9189
4976,佳凌,25,1,24,群益金鼎-桃園,2023-03-22,9189
4167,松瑞藥,25,2,23,群益金鼎-桃園,2023-03-22,9189
8215,明基材,22,1,21,群益金鼎-桃園,2023-03-22,9189
4306,炎洲,22,1,21,群益金鼎-桃園,2023-03-22,9189
3563,牧德,20,0,20,群益金鼎-桃園,2023-03-22,9189
00706L,期元大S＆P日圓正2,20,0,20,群益金鼎-桃園,2023-03-22,9189
2482,連宇,102,82,20,群益金鼎-桃園,2023-03-22,9189
3027,盛達,46,27,19,群益金鼎-桃園,2023-03-22,9189
3037,欣興,27,9,18,群益金鼎-桃園,2023-03-22,9189
1304,台聚,18,0,18,群益金鼎-桃園,2023-03-22,9189
9904,寶成,17,0,17,群益金鼎-桃園,2023-03-22,9189
1529,樂事綠能,40,23,17,群益金鼎-桃園,2023-03-22,9189
00715L,期街口布蘭特正2,98,81,17,群益金鼎-桃園,2023-03-22,9189
1524,耿鼎,27,11,16,群益金鼎-桃園,2023-03-22,9189
6116,彩晶,15,0,15,群益金鼎-桃園,2023-03-22,9189
1316,上曜,16,1,15,群益金鼎-桃園,2023-03-22,9189
1584,精剛,15,1,14,群益金鼎-桃園,2023-03-22,9189
6140,訊達,13,0,13,群益金鼎-桃園,2023-03-22,9189
8936,國統,13,0,13,群益金鼎-桃園,2023-03-22,9189
3715,定穎投控,16,3,13,群益金鼎-桃園,2023-03-22,9189
4906,正文,13,1,12,群益金鼎-桃園,2023-03-22,9189
2206,三陽工業,14,2,12,群益金鼎-桃園,2023-03-22,9189
6477,安集,12,0,12,群益金鼎-桃園,2023-03-22,9189
6148,驊宏資,11,0,11,群益金鼎-桃園,2023-03-22,9189
3058,立德,11,0,11,群益金鼎-桃園,2023-03-22,9189
6531,愛普*,13,2,11,群益金鼎-桃園,2023-03-22,9189
5531,鄉林,10,0,10,群益金鼎-桃園,2023-03-22,9189
2439,美律,10,0,10,群益金鼎-桃園,2023-03-22,9189
3305,昇貿,10,0,10,群益金鼎-桃園,2023-03-22,9189
3705,永信,10,0,10,群益金鼎-桃園,2023-03-22,9189
6829,千附精密,10,0,10,群益金鼎-桃園,2023-03-22,9189
2867,三商壽,10,0,10,群益金鼎-桃園,2023-03-22,9189
6142,友勁,12,3,9,群益金鼎-桃園,2023-03-22,9189
2618,長榮航,12,3,9,群益金鼎-桃園,2023-03-22,9189
2855,統一證,9,0,9,群益金鼎-桃園,2023-03-22,9189
3666,光耀,10,1,9,群益金鼎-桃園,2023-03-22,9189
00632R,元大台灣50反1,325,91,234,群益金鼎-桃園,2023-03-23,9189
5425,台半,102,25,77,群益金鼎-桃園,2023-03-23,9189
3483,力致,69,2,67,群益金鼎-桃園,2023-03-23,9189
2637,慧洋-KY,50,2,48,群益金鼎-桃園,2023-03-23,9189
2402,毅嘉,221,178,43,群益金鼎-桃園,2023-03-23,9189
5475,德宏,40,2,38,群益金鼎-桃園,2023-03-23,9189
00715L,期街口布蘭特正2,52,15,37,群益金鼎-桃園,2023-03-23,9189
6109,亞元,36,0,36,群益金鼎-桃園,2023-03-23,9189
4979,華星光,41,8,33,群益金鼎-桃園,2023-03-23,9189
1513,中興電,41,9,32,群益金鼎-桃園,2023-03-23,9189
1314,中石化,32,0,32,群益金鼎-桃園,2023-03-23,9189
6153,嘉聯益,31,1,30,群益金鼎-桃園,2023-03-23,9189
5328,華容,30,0,30,群益金鼎-桃園,2023-03-23,9189
8358,金居,31,2,29,群益金鼎-桃園,2023-03-23,9189
6223,旺矽,50,22,28,群益金鼎-桃園,2023-03-23,9189
6288,聯嘉,31,10,21,群益金鼎-桃園,2023-03-23,9189
2605,新興,18,0,18,群益金鼎-桃園,2023-03-23,9189
4167,松瑞藥,18,0,18,群益金鼎-桃園,2023-03-23,9189
6148,驊宏資,27,10,17,群益金鼎-桃園,2023-03-23,9189
00664R,國泰臺灣加權反1,16,0,16,群益金鼎-桃園,2023-03-23,9189
5222,全訊,19,3,16,群益金鼎-桃園,2023-03-23,9189
3624,光頡,16,0,16,群益金鼎-桃園,2023-03-23,9189
8215,明基材,17,1,16,群益金鼎-桃園,2023-03-23,9189
2430,燦坤,15,0,15,群益金鼎-桃園,2023-03-23,9189
1560,中砂,17,3,14,群益金鼎-桃園,2023-03-23,9189
2481,強茂,28,14,14,群益金鼎-桃園,2023-03-23,9189
3029,零壹,17,3,14,群益金鼎-桃園,2023-03-23,9189
3630,新鉅科,13,0,13,群益金鼎-桃園,2023-03-23,9189
2609,陽明,22,9,13,群益金鼎-桃園,2023-03-23,9189
1319,東陽,21,10,11,群益金鼎-桃園,2023-03-23,9189
1795,美時,14,3,11,群益金鼎-桃園,2023-03-23,9189
3703,欣陸,11,0,11,群益金鼎-桃園,2023-03-23,9189
00885,富邦越南,11,0,11,群益金鼎-桃園,2023-03-23,9189
3031,佰鴻,11,0,11,群益金鼎-桃園,2023-03-23,9189
6279,胡連,13,2,11,群益金鼎-桃園,2023-03-23,9189
2482,連宇,43,33,10,群益金鼎-桃園,2023-03-23,9189
6142,友勁,10,0,10,群益金鼎-桃園,2023-03-23,9189
00686R,群益臺灣加權反1,10,0,10,群益金鼎-桃園,2023-03-23,9189
2303,聯電,42,32,10,群益金鼎-桃園,2023-03-23,9189
3499,環天科,35,25,10,群益金鼎-桃園,2023-03-23,9189
3625,西勝,12,2,10,群益金鼎-桃園,2023-03-23,9189
911868,同方友友-DR,10,0,10,群益金鼎-桃園,2023-03-23,9189
2453,凌群,21,11,10,群益金鼎-桃園,2023-03-23,9189
6134,萬旭,12,2,10,群益金鼎-桃園,2023-03-23,9189
3059,華晶科,19,9,10,群益金鼎-桃園,2023-03-23,9189
2887,台新金,17,8,9,群益金鼎-桃園,2023-03-23,9189
00713,元大台灣高息低波,11,2,9,群益金鼎-桃園,2023-03-23,9189
8930,青鋼,9,0,9,群益金鼎-桃園,2023-03-23,9189
2476,鉅祥,10,1,9,群益金鼎-桃園,2023-03-23,9189
2457,飛宏,21,12,9,群益金鼎-桃園,2023-03-23,9189
2891,中信金,106,2,104,群益金鼎-桃園,2023-03-24,9189
2353,宏��,84,3,81,群益金鼎-桃園,2023-03-24,9189
2883B,凱基金乙特,80,0,80,群益金鼎-桃園,2023-03-24,9189
6005,群益證,61,1,60,群益金鼎-桃園,2023-03-24,9189
5475,德宏,70,10,60,群益金鼎-桃園,2023-03-24,9189
00635U,期元大S＆P黃金,50,0,50,群益金鼎-桃園,2023-03-24,9189
1218,泰山,50,0,50,群益金鼎-桃園,2023-03-24,9189
6770,力積電,39,2,37,群益金鼎-桃園,2023-03-24,9189
2731,雄獅,30,0,30,群益金鼎-桃園,2023-03-24,9189
3558,神準,35,8,27,群益金鼎-桃園,2023-03-24,9189
2482,連宇,37,15,22,群益金鼎-桃園,2023-03-24,9189
1560,中砂,23,1,22,群益金鼎-桃園,2023-03-24,9189
2618,長榮航,21,0,21,群益金鼎-桃園,2023-03-24,9189
2351,順德,29,8,21,群益金鼎-桃園,2023-03-24,9189
1326,台化,20,0,20,群益金鼎-桃園,2023-03-24,9189
4953,緯軟,27,8,19,群益金鼎-桃園,2023-03-24,9189
2388,威盛,64,46,18,群益金鼎-桃園,2023-03-24,9189
4979,華星光,21,4,17,群益金鼎-桃園,2023-03-24,9189
00637L,元大滬深300正2,32,15,17,群益金鼎-桃園,2023-03-24,9189
8046,南電,40,23,17,群益金鼎-桃園,2023-03-24,9189
5464,霖宏,20,5,15,群益金鼎-桃園,2023-03-24,9189
8930,青鋼,15,0,15,群益金鼎-桃園,2023-03-24,9189
2883,凱基金,15,1,14,群益金鼎-桃園,2023-03-24,9189
9945,潤泰新,13,0,13,群益金鼎-桃園,2023-03-24,9189
5351,鈺創,18,5,13,群益金鼎-桃園,2023-03-24,9189
2329,華泰,13,0,13,群益金鼎-桃園,2023-03-24,9189
3499,環天科,52,39,13,群益金鼎-桃園,2023-03-24,9189
9904,寶成,12,0,12,群益金鼎-桃園,2023-03-24,9189
2014,中鴻,11,0,11,群益金鼎-桃園,2023-03-24,9189
4702,中美實,10,0,10,群益金鼎-桃園,2023-03-24,9189
2332,友訊,10,0,10,群益金鼎-桃園,2023-03-24,9189
6122,擎邦,36,26,10,群益金鼎-桃園,2023-03-24,9189
00680L,元大美債20正2,10,0,10,群益金鼎-桃園,2023-03-24,9189
00671R,富邦NASDAQ反1,10,0,10,群益金鼎-桃園,2023-03-24,9189
3013,晟銘電,17,7,10,群益金鼎-桃園,2023-03-24,9189
00751B,元大AAA至A公司債,10,0,10,群益金鼎-桃園,2023-03-24,9189
3563,牧德,10,0,10,群益金鼎-桃園,2023-03-24,9189
1513,中興電,13,4,9,群益金鼎-桃園,2023-03-24,9189
3628,盈正,9,0,9,群益金鼎-桃園,2023-03-24,9189
2204,中華,11,2,9,群益金鼎-桃園,2023-03-24,9189
4536,拓凱,10,1,9,群益金鼎-桃園,2023-03-24,9189
2425,承啟,10,1,9,群益金鼎-桃園,2023-03-24,9189
6182,合晶,9,0,9,群益金鼎-桃園,2023-03-24,9189
6163,華電網,20,11,9,群益金鼎-桃園,2023-03-24,9189
3479,安勤,9,0,9,群益金鼎-桃園,2023-03-24,9189
4167,松瑞藥,9,0,9,群益金鼎-桃園,2023-03-24,9189
6806,森崴能源,11,3,8,群益金鼎-桃園,2023-03-24,9189
6751,智聯服務,8,0,8,群益金鼎-桃園,2023-03-24,9189
1304,台聚,8,0,8,群益金鼎-桃園,2023-03-24,9189
1708,東鹼,8,0,8,群益金鼎-桃園,2023-03-24,9189
00632R,元大台灣50反1,117,17,100,群益金鼎-桃園,2023-03-27,9189
00637L,元大滬深300正2,116,40,76,群益金鼎-桃園,2023-03-27,9189
1605,華新,84,32,52,群益金鼎-桃園,2023-03-27,9189
8926,台汽電,51,5,46,群益金鼎-桃園,2023-03-27,9189
3624,光頡,46,1,45,群益金鼎-桃園,2023-03-27,9189
2890,永豐金,44,6,38,群益金鼎-桃園,2023-03-27,9189
2731,雄獅,31,3,28,群益金鼎-桃園,2023-03-27,9189
00753L,中信中國50正2,54,30,24,群益金鼎-桃園,2023-03-27,9189
00882,中信中國高股息,22,0,22,群益金鼎-桃園,2023-03-27,9189
00900,富邦特選高股息30,21,0,21,群益金鼎-桃園,2023-03-27,9189
6530,創威,22,2,20,群益金鼎-桃園,2023-03-27,9189
3481,群創,23,3,20,群益金鼎-桃園,2023-03-27,9189
3710,連展投控,20,0,20,群益金鼎-桃園,2023-03-27,9189
1720,生達,20,0,20,群益金鼎-桃園,2023-03-27,9189
00671R,富邦NASDAQ反1,17,0,17,群益金鼎-桃園,2023-03-27,9189
2468,華經,19,3,16,群益金鼎-桃園,2023-03-27,9189
9907,統一實,17,2,15,群益金鼎-桃園,2023-03-27,9189
6185,幃翔,15,0,15,群益金鼎-桃園,2023-03-27,9189
00901,永豐智能車供應鏈,15,0,15,群益金鼎-桃園,2023-03-27,9189
1314,中石化,13,0,13,群益金鼎-桃園,2023-03-27,9189
1513,中興電,19,6,13,群益金鼎-桃園,2023-03-27,9189
1101,台泥,17,5,12,群益金鼎-桃園,2023-03-27,9189
2409,友達,13,1,12,群益金鼎-桃園,2023-03-27,9189
00720B,元大投資級公司債,12,0,12,群益金鼎-桃園,2023-03-27,9189
6874,倍力,12,0,12,群益金鼎-桃園,2023-03-27,9189
2303,聯電,16,4,12,群益金鼎-桃園,2023-03-27,9189
6290,良維,11,0,11,群益金鼎-桃園,2023-03-27,9189
00830,國泰費城半導體,11,0,11,群益金鼎-桃園,2023-03-27,9189
3029,零壹,12,1,11,群益金鼎-桃園,2023-03-27,9189
00772B,中信高評級公司債,11,0,11,群益金鼎-桃園,2023-03-27,9189
3714,富采,35,25,10,群益金鼎-桃園,2023-03-27,9189
3511,矽瑪,10,0,10,群益金鼎-桃園,2023-03-27,9189
00782B,國泰A級公用債,10,0,10,群益金鼎-桃園,2023-03-27,9189
2314,台揚,10,0,10,群益金鼎-桃園,2023-03-27,9189
3058,立德,10,0,10,群益金鼎-桃園,2023-03-27,9189
3576,聯合再生,25,15,10,群益金鼎-桃園,2023-03-27,9189
3607,谷崧,10,0,10,群益金鼎-桃園,2023-03-27,9189
5355,佳總,10,0,10,群益金鼎-桃園,2023-03-27,9189
4102,永日,10,0,10,群益金鼎-桃園,2023-03-27,9189
00781B,國泰A級科技債,10,0,10,群益金鼎-桃園,2023-03-27,9189
4121,優盛,10,0,10,群益金鼎-桃園,2023-03-27,9189
4916,事欣科,30,20,10,群益金鼎-桃園,2023-03-27,9189
2317,鴻海,11,2,9,群益金鼎-桃園,2023-03-27,9189
5425,台半,17,8,9,群益金鼎-桃園,2023-03-27,9189
00715L,期街口布蘭特正2,16,7,9,群益金鼎-桃園,2023-03-27,9189
2107,厚生,9,0,9,群益金鼎-桃園,2023-03-27,9189
2201,裕隆,12,3,9,群益金鼎-桃園,2023-03-27,9189
4906,正文,10,1,9,群益金鼎-桃園,2023-03-27,9189
0056,元大高股息,13,4,9,群益金鼎-桃園,2023-03-27,9189
6279,胡連,8,0,8,群益金鼎-桃園,2023-03-27,9189
00878,國泰永續高股息,132,23,109,群益金鼎-桃園,2023-03-28,9189
00632R,元大台灣50反1,479,385,94,群益金鼎-桃園,2023-03-28,9189
1609,大亞,75,4,71,群益金鼎-桃園,2023-03-28,9189
00680L,元大美債20正2,65,0,65,群益金鼎-桃園,2023-03-28,9189
3552,同致,64,3,61,群益金鼎-桃園,2023-03-28,9189
00882,中信中國高股息,41,0,41,群益金鼎-桃園,2023-03-28,9189
00753L,中信中國50正2,41,0,41,群益金鼎-桃園,2023-03-28,9189
1504,東元,78,39,39,群益金鼎-桃園,2023-03-28,9189
5521,工信,35,0,35,群益金鼎-桃園,2023-03-28,9189
9945,潤泰新,31,0,31,群益金鼎-桃園,2023-03-28,9189
3037,欣興,44,15,29,群益金鼎-桃園,2023-03-28,9189
2342,茂矽,54,29,25,群益金鼎-桃園,2023-03-28,9189
1605,華新,49,24,25,群益金鼎-桃園,2023-03-28,9189
00679B,元大美債20年,25,0,25,群益金鼎-桃園,2023-03-28,9189
2010,春源,21,0,21,群益金鼎-桃園,2023-03-28,9189
2610,華航,36,16,20,群益金鼎-桃園,2023-03-28,9189
3380,明泰,20,0,20,群益金鼎-桃園,2023-03-28,9189
3272,東碩,22,3,19,群益金鼎-桃園,2023-03-28,9189
2634,漢翔,29,10,19,群益金鼎-桃園,2023-03-28,9189
6168,宏齊,30,12,18,群益金鼎-桃園,2023-03-28,9189
2332,友訊,28,10,18,群益金鼎-桃園,2023-03-28,9189
00900,富邦特選高股息30,16,0,16,群益金鼎-桃園,2023-03-28,9189
2498,宏達電,36,20,16,群益金鼎-桃園,2023-03-28,9189
3624,光頡,75,60,15,群益金鼎-桃園,2023-03-28,9189
8046,南電,23,8,15,群益金鼎-桃園,2023-03-28,9189
9904,寶成,15,0,15,群益金鼎-桃園,2023-03-28,9189
3607,谷崧,17,2,15,群益金鼎-桃園,2023-03-28,9189
1513,中興電,19,4,15,群益金鼎-桃園,2023-03-28,9189
0056,元大高股息,26,11,15,群益金鼎-桃園,2023-03-28,9189
2423,固緯,59,45,14,群益金鼎-桃園,2023-03-28,9189
2421,建準,15,1,14,群益金鼎-桃園,2023-03-28,9189
6698,旭暉應材,23,9,14,群益金鼎-桃園,2023-03-28,9189
00751B,元大AAA至A公司債,15,2,13,群益金鼎-桃園,2023-03-28,9189
6142,友勁,13,0,13,群益金鼎-桃園,2023-03-28,9189
00720B,元大投資級公司債,13,1,12,群益金鼎-桃園,2023-03-28,9189
2609,陽明,15,3,12,群益金鼎-桃園,2023-03-28,9189
1810,和成,14,2,12,群益金鼎-桃園,2023-03-28,9189
8403,盛弘,12,0,12,群益金鼎-桃園,2023-03-28,9189
00923,群益台ESG低碳50,11,0,11,群益金鼎-桃園,2023-03-28,9189
00772B,中信高評級公司債,11,1,10,群益金鼎-桃園,2023-03-28,9189
1584,精剛,32,22,10,群益金鼎-桃園,2023-03-28,9189
00650L,復華香港正2,10,0,10,群益金鼎-桃園,2023-03-28,9189
2476,鉅祥,10,0,10,群益金鼎-桃園,2023-03-28,9189
5258,虹堡,10,0,10,群益金鼎-桃園,2023-03-28,9189
00917,中信特選金融,10,0,10,群益金鼎-桃園,2023-03-28,9189
5011,久陽,11,1,10,群益金鼎-桃園,2023-03-28,9189
6770,力積電,10,0,10,群益金鼎-桃園,2023-03-28,9189
2834,臺企銀,10,0,10,群益金鼎-桃園,2023-03-28,9189
8105,凌巨,10,0,10,群益金鼎-桃園,2023-03-28,9189
00891,中信關鍵半導體,10,0,10,群益金鼎-桃園,2023-03-28,9189
2359,所羅門,106,7,99,群益金鼎-桃園,2023-03-29,9189
3715,定穎投控,218,181,37,群益金鼎-桃園,2023-03-29,9189
3051,力特,35,0,35,群益金鼎-桃園,2023-03-29,9189
2010,春源,30,0,30,群益金鼎-桃園,2023-03-29,9189
3432,台端,23,0,23,群益金鼎-桃園,2023-03-29,9189
1503,士電,22,0,22,群益金鼎-桃園,2023-03-29,9189
2535,達欣工,21,0,21,群益金鼎-桃園,2023-03-29,9189
6282,康舒,23,2,21,群益金鼎-桃園,2023-03-29,9189
1451,年興,20,0,20,群益金鼎-桃園,2023-03-29,9189
3624,光頡,25,5,20,群益金鼎-桃園,2023-03-29,9189
2845,遠東銀,20,0,20,群益金鼎-桃園,2023-03-29,9189
3552,同致,21,3,18,群益金鼎-桃園,2023-03-29,9189
6185,幃翔,18,0,18,群益金鼎-桃園,2023-03-29,9189
2316,楠梓電,17,0,17,群益金鼎-桃園,2023-03-29,9189
8478,東哥遊艇,16,0,16,群益金鼎-桃園,2023-03-29,9189
2342,茂矽,126,110,16,群益金鼎-桃園,2023-03-29,9189
00922,國泰台灣領袖50,15,0,15,群益金鼎-桃園,2023-03-29,9189
2722,夏都,17,2,15,群益金鼎-桃園,2023-03-29,9189
00901,永豐智能車供應鏈,15,0,15,群益金鼎-桃園,2023-03-29,9189
00772B,中信高評級公司債,17,2,15,群益金鼎-桃園,2023-03-29,9189
8222,寶一,22,8,14,群益金鼎-桃園,2023-03-29,9189
3231,緯創,12,0,12,群益金鼎-桃園,2023-03-29,9189
3034,聯詠,12,1,11,群益金鼎-桃園,2023-03-29,9189
3630,新鉅科,11,0,11,群益金鼎-桃園,2023-03-29,9189
2063,世鎧,11,0,11,群益金鼎-桃園,2023-03-29,9189
1314,中石化,11,0,11,群益金鼎-桃園,2023-03-29,9189
6274,台燿,13,2,11,群益金鼎-桃園,2023-03-29,9189
1310,台苯,11,0,11,群益金鼎-桃園,2023-03-29,9189
00720B,元大投資級公司債,11,0,11,群益金鼎-桃園,2023-03-29,9189
00923,群益台ESG低碳50,10,0,10,群益金鼎-桃園,2023-03-29,9189
2303,聯電,25,15,10,群益金鼎-桃園,2023-03-29,9189
6142,友勁,10,0,10,群益金鼎-桃園,2023-03-29,9189
00782B,國泰A級公用債,10,0,10,群益金鼎-桃園,2023-03-29,9189
00781B,國泰A級科技債,10,0,10,群益金鼎-桃園,2023-03-29,9189
00686R,群益臺灣加權反1,10,0,10,群益金鼎-桃園,2023-03-29,9189
2609,陽明,10,1,9,群益金鼎-桃園,2023-03-29,9189
2206,三陽工業,11,2,9,群益金鼎-桃園,2023-03-29,9189
2243,宏旭-KY,9,0,9,群益金鼎-桃園,2023-03-29,9189
2707,晶華,10,1,9,群益金鼎-桃園,2023-03-29,9189
6244,茂迪,19,10,9,群益金鼎-桃園,2023-03-29,9189
5388,中磊,11,2,9,群益金鼎-桃園,2023-03-29,9189
3005,神基,10,2,8,群益金鼎-桃園,2023-03-29,9189
6485,點序,10,2,8,群益金鼎-桃園,2023-03-29,9189
8112,至上,10,2,8,群益金鼎-桃園,2023-03-29,9189
00673R,期元大S＆P原油反1,8,0,8,群益金鼎-桃園,2023-03-29,9189
5203,訊連,8,0,8,群益金鼎-桃園,2023-03-29,9189
6432,今展科,8,0,8,群益金鼎-桃園,2023-03-29,9189
7402,邑錡,7,0,7,群益金鼎-桃園,2023-03-29,9189
8940,新天地,7,0,7,群益金鼎-桃園,2023-03-29,9189
00679B,元大美債20年,6,0,6,群益金鼎-桃園,2023-03-29,9189
911868,同方友友-DR,500,15,485,群益金鼎-桃園,2023-03-30,9189
00632R,元大台灣50反1,122,0,122,群益金鼎-桃園,2023-03-30,9189
2303,聯電,87,36,51,群益金鼎-桃園,2023-03-30,9189
00680L,元大美債20正2,50,0,50,群益金鼎-桃園,2023-03-30,9189
6113,亞矽,38,0,38,群益金鼎-桃園,2023-03-30,9189
00882,中信中國高股息,33,0,33,群益金鼎-桃園,2023-03-30,9189
2010,春源,30,0,30,群益金鼎-桃園,2023-03-30,9189
2534,宏盛,28,0,28,群益金鼎-桃園,2023-03-30,9189
00753L,中信中國50正2,25,1,24,群益金鼎-桃園,2023-03-30,9189
3483,力致,21,1,20,群益金鼎-桃園,2023-03-30,9189
8215,明基材,20,0,20,群益金鼎-桃園,2023-03-30,9189
6770,力積電,21,2,19,群益金鼎-桃園,2023-03-30,9189
1605,華新,21,3,18,群益金鼎-桃園,2023-03-30,9189
1504,東元,22,5,17,群益金鼎-桃園,2023-03-30,9189
5309,系統電,19,3,16,群益金鼎-桃園,2023-03-30,9189
1101,台泥,16,0,16,群益金鼎-桃園,2023-03-30,9189
1618,合機,31,16,15,群益金鼎-桃園,2023-03-30,9189
00715L,期街口布蘭特正2,116,101,15,群益金鼎-桃園,2023-03-30,9189
3272,東碩,16,1,15,群益金鼎-桃園,2023-03-30,9189
2883,凱基金,19,5,14,群益金鼎-桃園,2023-03-30,9189
6179,亞通,24,10,14,群益金鼎-桃園,2023-03-30,9189
2618,長榮航,22,9,13,群益金鼎-桃園,2023-03-30,9189
6290,良維,13,0,13,群益金鼎-桃園,2023-03-30,9189
00673R,期元大S＆P原油反1,13,0,13,群益金鼎-桃園,2023-03-30,9189
00679B,元大美債20年,12,0,12,群益金鼎-桃園,2023-03-30,9189
6116,彩晶,12,0,12,群益金鼎-桃園,2023-03-30,9189
8028,昇陽半導體,13,1,12,群益金鼎-桃園,2023-03-30,9189
2889,國票金,12,0,12,群益金鼎-桃園,2023-03-30,9189
2353,宏��,11,0,11,群益金鼎-桃園,2023-03-30,9189
1609,大亞,20,9,11,群益金鼎-桃園,2023-03-30,9189
8088,品安,32,21,11,群益金鼎-桃園,2023-03-30,9189
00922,國泰台灣領袖50,10,0,10,群益金鼎-桃園,2023-03-30,9189
3022,威強電,10,0,10,群益金鼎-桃園,2023-03-30,9189
1712,興農,10,0,10,群益金鼎-桃園,2023-03-30,9189
4909,新復興,10,0,10,群益金鼎-桃園,2023-03-30,9189
2206,三陽工業,10,0,10,群益金鼎-桃園,2023-03-30,9189
3694,海華,10,0,10,群益金鼎-桃園,2023-03-30,9189
00686R,群益臺灣加權反1,10,0,10,群益金鼎-桃園,2023-03-30,9189
3234,光環,10,0,10,群益金鼎-桃園,2023-03-30,9189
1326,台化,10,0,10,群益金鼎-桃園,2023-03-30,9189
2890,永豐金,10,0,10,群益金鼎-桃園,2023-03-30,9189
2331,精英,11,1,10,群益金鼎-桃園,2023-03-30,9189
2409,友達,14,5,9,群益金鼎-桃園,2023-03-30,9189
2421,建準,10,1,9,群益金鼎-桃園,2023-03-30,9189
2243,宏旭-KY,9,0,9,群益金鼎-桃園,2023-03-30,9189
8271,宇瞻,10,1,9,群益金鼎-桃園,2023-03-30,9189
3704,合勤控,8,0,8,群益金鼎-桃園,2023-03-30,9189
6753,龍德造船,8,0,8,群益金鼎-桃園,2023-03-30,9189
6180,橘子,8,0,8,群益金鼎-桃園,2023-03-30,9189
8478,東哥遊艇,8,0,8,群益金鼎-桃園,2023-03-30,9189
00632R,元大台灣50反1,244,0,244,群益金鼎-桃園,2023-03-31,9189
1605,華新,57,4,53,群益金鼎-桃園,2023-03-31,9189
2344,華邦電,140,91,49,群益金鼎-桃園,2023-03-31,9189
2302,麗正,32,1,31,群益金鼎-桃園,2023-03-31,9189
2010,春源,30,0,30,群益金鼎-桃園,2023-03-31,9189
8046,南電,40,12,28,群益金鼎-桃園,2023-03-31,9189
8050,廣積,31,6,25,群益金鼎-桃園,2023-03-31,9189
00680L,元大美債20正2,25,0,25,群益金鼎-桃園,2023-03-31,9189
3209,全科,25,0,25,群益金鼎-桃園,2023-03-31,9189
00673R,期元大S＆P原油反1,25,0,25,群益金鼎-桃園,2023-03-31,9189
1504,東元,37,15,22,群益金鼎-桃園,2023-03-31,9189
6182,合晶,22,1,21,群益金鼎-桃園,2023-03-31,9189
8086,宏捷科,24,4,20,群益金鼎-桃園,2023-03-31,9189
6712,長聖,23,5,18,群益金鼎-桃園,2023-03-31,9189
2908,特力,18,0,18,群益金鼎-桃園,2023-03-31,9189
6485,點序,19,2,17,群益金鼎-桃園,2023-03-31,9189
00772B,中信高評級公司債,16,0,16,群益金鼎-桃園,2023-03-31,9189
2603,長榮,16,2,14,群益金鼎-桃園,2023-03-31,9189
2482,連宇,19,5,14,群益金鼎-桃園,2023-03-31,9189
6196,帆宣,12,0,12,群益金鼎-桃園,2023-03-31,9189
6841,長佳智能,12,0,12,群益金鼎-桃園,2023-03-31,9189
2615,萬海,15,3,12,群益金鼎-桃園,2023-03-31,9189
3714,富采,11,0,11,群益金鼎-桃園,2023-03-31,9189
6443,元晶,12,1,11,群益金鼎-桃園,2023-03-31,9189
2891,中信金,15,5,10,群益金鼎-桃園,2023-03-31,9189
00782B,國泰A級公用債,10,0,10,群益金鼎-桃園,2023-03-31,9189
9105,泰金寶-DR,10,0,10,群益金鼎-桃園,2023-03-31,9189
1473,台南,10,0,10,群益金鼎-桃園,2023-03-31,9189
6185,幃翔,10,0,10,群益金鼎-桃園,2023-03-31,9189
00686R,群益臺灣加權反1,10,0,10,群益金鼎-桃園,2023-03-31,9189
00671R,富邦NASDAQ反1,10,0,10,群益金鼎-桃園,2023-03-31,9189
6191,精成科,11,1,10,群益金鼎-桃園,2023-03-31,9189
2731,雄獅,12,2,10,群益金鼎-桃園,2023-03-31,9189
00655L,國泰中國A50正2,10,0,10,群益金鼎-桃園,2023-03-31,9189
00917,中信特選金融,10,0,10,群益金鼎-桃園,2023-03-31,9189
1701,中化,10,0,10,群益金鼎-桃園,2023-03-31,9189
3664,安瑞-KY,11,1,10,群益金鼎-桃園,2023-03-31,9189
1339,昭輝,10,1,9,群益金鼎-桃園,2023-03-31,9189
1609,大亞,10,1,9,群益金鼎-桃園,2023-03-31,9189
5211,蒙恬,12,3,9,群益金鼎-桃園,2023-03-31,9189
3324,雙鴻,10,1,9,群益金鼎-桃園,2023-03-31,9189
3027,盛達,20,11,9,群益金鼎-桃園,2023-03-31,9189
8277,商丞,9,0,9,群益金鼎-桃園,2023-03-31,9189
4960,誠美材,8,0,8,群益金鼎-桃園,2023-03-31,9189
00679B,元大美債20年,8,0,8,群益金鼎-桃園,2023-03-31,9189
00675L,富邦臺灣加權正2,8,0,8,群益金鼎-桃園,2023-03-31,9189
2428,興勤,8,0,8,群益金鼎-桃園,2023-03-31,9189
8234,新漢,8,0,8,群益金鼎-桃園,2023-03-31,9189
3013,晟銘電,7,0,7,群益金鼎-桃園,2023-03-31,9189
5243,乙盛-KY,7,0,7,群益金鼎-桃園,2023-03-31,9189
2610,華航,208,5,203,群益金鼎-桃園,2023-04-06,9189
00673R,期元大S＆P原油反1,77,0,77,群益金鼎-桃園,2023-04-06,9189
00679B,元大美債20年,44,2,42,群益金鼎-桃園,2023-04-06,9189
3056,富華新,42,2,40,群益金鼎-桃園,2023-04-06,9189
00878,國泰永續高股息,68,30,38,群益金鼎-桃園,2023-04-06,9189
00894,中信小資高價30,31,0,31,群益金鼎-桃園,2023-04-06,9189
2010,春源,30,0,30,群益金鼎-桃園,2023-04-06,9189
1795,美時,60,31,29,群益金鼎-桃園,2023-04-06,9189
8069,元太,35,6,29,群益金鼎-桃園,2023-04-06,9189
2884,玉山金,34,7,27,群益金鼎-桃園,2023-04-06,9189
00830,國泰費城半導體,25,0,25,群益金鼎-桃園,2023-04-06,9189
00882,中信中國高股息,25,0,25,群益金鼎-桃園,2023-04-06,9189
6477,安集,28,4,24,群益金鼎-桃園,2023-04-06,9189
00923,群益台ESG低碳50,23,0,23,群益金鼎-桃園,2023-04-06,9189
1584,精剛,26,4,22,群益金鼎-桃園,2023-04-06,9189
8215,明基材,20,0,20,群益金鼎-桃園,2023-04-06,9189
2104,國際中橡,20,0,20,群益金鼎-桃園,2023-04-06,9189
00753L,中信中國50正2,29,10,19,群益金鼎-桃園,2023-04-06,9189
00637L,元大滬深300正2,23,5,18,群益金鼎-桃園,2023-04-06,9189
8222,寶一,21,4,17,群益金鼎-桃園,2023-04-06,9189
5340,建榮,15,0,15,群益金鼎-桃園,2023-04-06,9189
3078,僑威,16,1,15,群益金鼎-桃園,2023-04-06,9189
2504,國產,15,0,15,群益金鼎-桃園,2023-04-06,9189
2834,臺企銀,14,0,14,群益金鼎-桃園,2023-04-06,9189
1618,合機,13,0,13,群益金鼎-桃園,2023-04-06,9189
8234,新漢,13,0,13,群益金鼎-桃園,2023-04-06,9189
00893,國泰智能電動車,12,0,12,群益金鼎-桃園,2023-04-06,9189
00895,富邦未來車,12,0,12,群益金鼎-桃園,2023-04-06,9189
1519,華城,18,6,12,群益金鼎-桃園,2023-04-06,9189
6770,力積電,11,1,10,群益金鼎-桃園,2023-04-06,9189
2489,瑞軒,10,0,10,群益金鼎-桃園,2023-04-06,9189
5309,系統電,12,2,10,群益金鼎-桃園,2023-04-06,9189
4167,松瑞藥,11,1,10,群益金鼎-桃園,2023-04-06,9189
2402,毅嘉,15,5,10,群益金鼎-桃園,2023-04-06,9189
3515,華擎,10,0,10,群益金鼎-桃園,2023-04-06,9189
2618,長榮航,51,41,10,群益金鼎-桃園,2023-04-06,9189
9105,泰金寶-DR,10,0,10,群益金鼎-桃園,2023-04-06,9189
2243,宏旭-KY,10,0,10,群益金鼎-桃園,2023-04-06,9189
00720B,元大投資級公司債,12,2,10,群益金鼎-桃園,2023-04-06,9189
00713,元大台灣高息低波,9,0,9,群益金鼎-桃園,2023-04-06,9189
2609,陽明,14,5,9,群益金鼎-桃園,2023-04-06,9189
6116,彩晶,9,0,9,群益金鼎-桃園,2023-04-06,9189
3430,奇鈦科,14,5,9,群益金鼎-桃園,2023-04-06,9189
2356,英業達,21,13,8,群益金鼎-桃園,2023-04-06,9189
3037,欣興,13,5,8,群益金鼎-桃園,2023-04-06,9189
3652,精聯,8,0,8,群益金鼎-桃園,2023-04-06,9189
1707,葡萄王,8,0,8,群益金鼎-桃園,2023-04-06,9189
6869,雲豹能源,8,0,8,群益金鼎-桃園,2023-04-06,9189
2344,華邦電,19,11,8,群益金鼎-桃園,2023-04-06,9189
2605,新興,16,8,8,群益金鼎-桃園,2023-04-06,9189
2610,華航,303,0,303,群益金鼎-桃園,2023-04-07,9189
00632R,元大台灣50反1,93,0,93,群益金鼎-桃園,2023-04-07,9189
2313,華通,62,0,62,群益金鼎-桃園,2023-04-07,9189
2352,佳世達,63,10,53,群益金鼎-桃園,2023-04-07,9189
4114,健喬,43,1,42,群益金鼎-桃園,2023-04-07,9189
1314,中石化,38,0,38,群益金鼎-桃園,2023-04-07,9189
2886,兆豐金,33,0,33,群益金鼎-桃園,2023-04-07,9189
2010,春源,30,0,30,群益金鼎-桃園,2023-04-07,9189
2884,玉山金,28,0,28,群益金鼎-桃園,2023-04-07,9189
8028,昇陽半導體,43,16,27,群益金鼎-桃園,2023-04-07,9189
3013,晟銘電,26,0,26,群益金鼎-桃園,2023-04-07,9189
2706,第一店,20,0,20,群益金鼎-桃園,2023-04-07,9189
2701,萬企,20,0,20,群益金鼎-桃園,2023-04-07,9189
1718,中纖,20,0,20,群益金鼎-桃園,2023-04-07,9189
6285,啟��,18,0,18,群益金鼎-桃園,2023-04-07,9189
6156,松上,22,4,18,群益金鼎-桃園,2023-04-07,9189
6288,聯嘉,22,5,17,群益金鼎-桃園,2023-04-07,9189
2324,仁寶,18,2,16,群益金鼎-桃園,2023-04-07,9189
00882,中信中國高股息,16,0,16,群益金鼎-桃園,2023-04-07,9189
5258,虹堡,15,0,15,群益金鼎-桃園,2023-04-07,9189
2009,第一銅,17,2,15,群益金鼎-桃園,2023-04-07,9189
3004,豐達科,18,3,15,群益金鼎-桃園,2023-04-07,9189
6142,友勁,15,0,15,群益金鼎-桃園,2023-04-07,9189
00712,復華富時不動產,14,0,14,群益金鼎-桃園,2023-04-07,9189
00922,國泰台灣領袖50,14,0,14,群益金鼎-桃園,2023-04-07,9189
00885,富邦越南,14,0,14,群益金鼎-桃園,2023-04-07,9189
3664,安瑞-KY,15,1,14,群益金鼎-桃園,2023-04-07,9189
1589,永冠-KY,17,5,12,群益金鼎-桃園,2023-04-07,9189
6191,精成科,11,0,11,群益金鼎-桃園,2023-04-07,9189
3521,鴻翊,11,0,11,群益金鼎-桃園,2023-04-07,9189
2453,凌群,17,6,11,群益金鼎-桃園,2023-04-07,9189
3022,威強電,13,2,11,群益金鼎-桃園,2023-04-07,9189
6133,金橋,11,0,11,群益金鼎-桃園,2023-04-07,9189
0056,元大高股息,16,6,10,群益金鼎-桃園,2023-04-07,9189
00878,國泰永續高股息,10,0,10,群益金鼎-桃園,2023-04-07,9189
911868,同方友友-DR,10,0,10,群益金鼎-桃園,2023-04-07,9189
5284,jpp-KY,44,34,10,群益金鼎-桃園,2023-04-07,9189
4916,事欣科,10,0,10,群益金鼎-桃園,2023-04-07,9189
4908,前鼎,10,0,10,群益金鼎-桃園,2023-04-07,9189
3483,力致,10,0,10,群益金鼎-桃園,2023-04-07,9189
2308,台達電,10,0,10,群益金鼎-桃園,2023-04-07,9189
8930,青鋼,10,0,10,群益金鼎-桃園,2023-04-07,9189
9934,成霖,10,0,10,群益金鼎-桃園,2023-04-07,9189
2303,聯電,12,2,10,群益金鼎-桃園,2023-04-07,9189
3231,緯創,11,2,9,群益金鼎-桃園,2023-04-07,9189
2882,國泰金,12,2,10,群益金鼎-桃園,2023-04-07,9189
2367,燿華,9,0,9,群益金鼎-桃園,2023-04-07,9189
3628,盈正,10,1,9,群益金鼎-桃園,2023-04-07,9189
3708,上緯投控,10,1,9,群益金鼎-桃園,2023-04-07,9189
3260,威剛,24,16,8,群益金鼎-桃園,2023-04-07,9189
2812,台中銀,861,0,861,群益金鼎-桃園,2023-04-10,9189
00632R,元大台灣50反1,75,10,65,群益金鼎-桃園,2023-04-10,9189
00712,復華富時不動產,44,0,44,群益金鼎-桃園,2023-04-10,9189
2208,台船,39,9,30,群益金鼎-桃園,2023-04-10,9189
1718,中纖,30,0,30,群益金鼎-桃園,2023-04-10,9189
2010,春源,30,0,30,群益金鼎-桃園,2023-04-10,9189
5222,全訊,40,11,29,群益金鼎-桃園,2023-04-10,9189
3022,威強電,32,3,29,群益金鼎-桃園,2023-04-10,9189
6770,力積電,28,1,27,群益金鼎-桃園,2023-04-10,9189
5475,德宏,25,0,25,群益金鼎-桃園,2023-04-10,9189
3013,晟銘電,25,4,21,群益金鼎-桃園,2023-04-10,9189
2303,聯電,20,0,20,群益金鼎-桃園,2023-04-10,9189
2419,仲琦,20,0,20,群益金鼎-桃園,2023-04-10,9189
00679B,元大美債20年,19,0,19,群益金鼎-桃園,2023-04-10,9189
6756,威鋒電子,19,1,18,群益金鼎-桃園,2023-04-10,9189
2609,陽明,26,8,18,群益金鼎-桃園,2023-04-10,9189
6278,台表科,20,3,17,群益金鼎-桃園,2023-04-10,9189
3715,定穎投控,26,10,16,群益金鼎-桃園,2023-04-10,9189
00882,中信中國高股息,15,0,15,群益金鼎-桃園,2023-04-10,9189
3576,聯合再生,15,0,15,群益金鼎-桃園,2023-04-10,9189
8926,台汽電,15,0,15,群益金鼎-桃園,2023-04-10,9189
3499,環天科,14,0,14,群益金鼎-桃園,2023-04-10,9189
3006,晶豪科,17,4,13,群益金鼎-桃園,2023-04-10,9189
2423,固緯,42,29,13,群益金鼎-桃園,2023-04-10,9189
8050,廣積,13,0,13,群益金鼎-桃園,2023-04-10,9189
2605,新興,20,8,12,群益金鼎-桃園,2023-04-10,9189
4153,鈺緯,12,0,12,群益金鼎-桃園,2023-04-10,9189
00673R,期元大S＆P原油反1,12,0,12,群益金鼎-桃園,2023-04-10,9189
4967,十銓,22,11,11,群益金鼎-桃園,2023-04-10,9189
3027,盛達,11,0,11,群益金鼎-桃園,2023-04-10,9189
6156,松上,12,1,11,群益金鼎-桃園,2023-04-10,9189
1473,台南,10,0,10,群益金鼎-桃園,2023-04-10,9189
5340,建榮,10,0,10,群益金鼎-桃園,2023-04-10,9189
4128,中天,10,0,10,群益金鼎-桃園,2023-04-10,9189
1309,台達化,10,0,10,群益金鼎-桃園,2023-04-10,9189
00781B,國泰A級科技債,10,0,10,群益金鼎-桃園,2023-04-10,9189
1342,八貫,12,2,10,群益金鼎-桃園,2023-04-10,9189
2359,所羅門,10,0,10,群益金鼎-桃園,2023-04-10,9189
2420,新巨,10,0,10,群益金鼎-桃園,2023-04-10,9189
00912,中信臺灣智慧50,10,0,10,群益金鼎-桃園,2023-04-10,9189
8930,青鋼,10,0,10,群益金鼎-桃園,2023-04-10,9189
8409,商之器,12,3,9,群益金鼎-桃園,2023-04-10,9189
6127,九豪,11,2,9,群益金鼎-桃園,2023-04-10,9189
2408,南亞科,9,0,9,群益金鼎-桃園,2023-04-10,9189
5425,台半,20,12,8,群益金鼎-桃園,2023-04-10,9189
2206,三陽工業,15,7,8,群益金鼎-桃園,2023-04-10,9189
8028,昇陽半導體,12,4,8,群益金鼎-桃園,2023-04-10,9189
4114,健喬,9,1,8,群益金鼎-桃園,2023-04-10,9189
2328,廣宇,8,0,8,群益金鼎-桃園,2023-04-10,9189
6285,啟��,10,2,8,群益金鼎-桃園,2023-04-10,9189
2812,台中銀,468,0,468,群益金鼎-桃園,2023-04-11,9189
00632R,元大台灣50反1,120,5,115,群益金鼎-桃園,2023-04-11,9189
2349,錸德,92,0,92,群益金鼎-桃園,2023-04-11,9189
2881,富邦金,79,1,78,群益金鼎-桃園,2023-04-11,9189
00673R,期元大S＆P原油反1,74,0,74,群益金鼎-桃園,2023-04-11,9189
1504,東元,111,43,68,群益金鼎-桃園,2023-04-11,9189
2363,矽統,61,0,61,群益金鼎-桃園,2023-04-11,9189
2867,三商壽,50,0,50,群益金鼎-桃園,2023-04-11,9189
1718,中纖,50,0,50,群益金鼎-桃園,2023-04-11,9189
00680L,元大美債20正2,41,0,41,群益金鼎-桃園,2023-04-11,9189
2618,長榮航,41,6,35,群益金鼎-桃園,2023-04-11,9189
2303,聯電,37,4,33,群益金鼎-桃園,2023-04-11,9189
2399,映泰,32,0,32,群益金鼎-桃園,2023-04-11,9189
6770,力積電,43,11,32,群益金鼎-桃園,2023-04-11,9189
00712,復華富時不動產,25,0,25,群益金鼎-桃園,2023-04-11,9189
4111,濟生,20,0,20,群益金鼎-桃園,2023-04-11,9189
6285,啟��,19,0,19,群益金鼎-桃園,2023-04-11,9189
2457,飛宏,33,14,19,群益金鼎-桃園,2023-04-11,9189
1609,大亞,63,44,19,群益金鼎-桃園,2023-04-11,9189
8222,寶一,24,6,18,群益金鼎-桃園,2023-04-11,9189
4927,泰鼎-KY,17,1,16,群益金鼎-桃園,2023-04-11,9189
00637L,元大滬深300正2,44,28,16,群益金鼎-桃園,2023-04-11,9189
00679B,元大美債20年,15,0,15,群益金鼎-桃園,2023-04-11,9189
2423,固緯,104,89,15,群益金鼎-桃園,2023-04-11,9189
2498,宏達電,24,10,14,群益金鼎-桃園,2023-04-11,9189
2206,三陽工業,61,47,14,群益金鼎-桃園,2023-04-11,9189
2323,中環,13,0,13,群益金鼎-桃園,2023-04-11,9189
8088,品安,23,10,13,群益金鼎-桃園,2023-04-11,9189
3078,僑威,29,17,12,群益金鼎-桃園,2023-04-11,9189
3491,昇達科,13,1,12,群益金鼎-桃園,2023-04-11,9189
6603,富強鑫,12,0,12,群益金鼎-桃園,2023-04-11,9189
2615,萬海,12,0,12,群益金鼎-桃園,2023-04-11,9189
3231,緯創,17,6,11,群益金鼎-桃園,2023-04-11,9189
6125,廣運,12,1,11,群益金鼎-桃園,2023-04-11,9189
3715,定穎投控,14,3,11,群益金鼎-桃園,2023-04-11,9189
2027,大成鋼,12,1,11,群益金鼎-桃園,2023-04-11,9189
2634,漢翔,40,30,10,群益金鼎-桃園,2023-04-11,9189
4979,華星光,19,9,10,群益金鼎-桃園,2023-04-11,9189
6152,百一,10,0,10,群益金鼎-桃園,2023-04-11,9189
8936,國統,10,0,10,群益金鼎-桃園,2023-04-11,9189
2302,麗正,10,0,10,群益金鼎-桃園,2023-04-11,9189
3625,西勝,10,0,10,群益金鼎-桃園,2023-04-11,9189
1108,幸福,19,9,10,群益金鼎-桃園,2023-04-11,9189
2888,新光金,10,0,10,群益金鼎-桃園,2023-04-11,9189
3047,訊舟,9,0,9,群益金鼎-桃園,2023-04-11,9189
5465,富驊,10,1,9,群益金鼎-桃園,2023-04-11,9189
6209,今國光,11,2,9,群益金鼎-桃園,2023-04-11,9189
4971,IET-KY,9,0,9,群益金鼎-桃園,2023-04-11,9189
00753L,中信中國50正2,20,11,9,群益金鼎-桃園,2023-04-11,9189
6129,普誠,12,3,9,群益金鼎-桃園,2023-04-11,9189
2891,中信金,141,30,111,群益金鼎-桃園,2023-04-12,9189
1591,駿吉-KY,57,0,57,群益金鼎-桃園,2023-04-12,9189
00680L,元大美債20正2,59,3,56,群益金鼎-桃園,2023-04-12,9189
2303,聯電,89,38,51,群益金鼎-桃園,2023-04-12,9189
00637L,元大滬深300正2,43,2,41,群益金鼎-桃園,2023-04-12,9189
8038,長園科,33,1,32,群益金鼎-桃園,2023-04-12,9189
00753L,中信中國50正2,30,3,27,群益金鼎-桃園,2023-04-12,9189
00712,復華富時不動產,25,0,25,群益金鼎-桃園,2023-04-12,9189
8222,寶一,75,50,25,群益金鼎-桃園,2023-04-12,9189
6217,中探針,34,10,24,群益金鼎-桃園,2023-04-12,9189
00673R,期元大S＆P原油反1,33,10,23,群益金鼎-桃園,2023-04-12,9189
3209,全科,21,0,21,群益金鼎-桃園,2023-04-12,9189
6416,瑞祺電通,21,1,20,群益金鼎-桃園,2023-04-12,9189
6148,驊宏資,22,3,19,群益金鼎-桃園,2023-04-12,9189
6240,松崗,19,0,19,群益金鼎-桃園,2023-04-12,9189
00632R,元大台灣50反1,18,0,18,群益金鼎-桃園,2023-04-12,9189
2408,南亞科,40,22,18,群益金鼎-桃園,2023-04-12,9189
3027,盛達,48,31,17,群益金鼎-桃園,2023-04-12,9189
8150,南茂,18,2,16,群益金鼎-桃園,2023-04-12,9189
2330,台積電,17,1,16,群益金鼎-桃園,2023-04-12,9189
1560,中砂,16,1,15,群益金鼎-桃園,2023-04-12,9189
2634,漢翔,65,51,14,群益金鼎-桃園,2023-04-12,9189
6234,高僑,15,1,14,群益金鼎-桃園,2023-04-12,9189
2317,鴻海,16,2,14,群益金鼎-桃園,2023-04-12,9189
00713,元大台灣高息低波,14,1,13,群益金鼎-桃園,2023-04-12,9189
3322,建舜電,14,1,13,群益金鼎-桃園,2023-04-12,9189
3005,神基,13,0,13,群益金鼎-桃園,2023-04-12,9189
2481,強茂,15,3,12,群益金鼎-桃園,2023-04-12,9189
2233,宇隆,12,0,12,群益金鼎-桃園,2023-04-12,9189
6185,幃翔,12,0,12,群益金鼎-桃園,2023-04-12,9189
6125,廣運,11,0,11,群益金鼎-桃園,2023-04-12,9189
2492,華新科,11,0,11,群益金鼎-桃園,2023-04-12,9189
6223,旺矽,13,2,11,群益金鼎-桃園,2023-04-12,9189
3078,僑威,29,19,10,群益金鼎-桃園,2023-04-12,9189
1734,杏輝,10,0,10,群益金鼎-桃園,2023-04-12,9189
3702,大聯大,10,0,10,群益金鼎-桃園,2023-04-12,9189
2023,燁輝,10,0,10,群益金鼎-桃園,2023-04-12,9189
5203,訊連,14,4,10,群益金鼎-桃園,2023-04-12,9189
3287,廣寰科,10,0,10,群益金鼎-桃園,2023-04-12,9189
2342,茂矽,10,0,10,群益金鼎-桃園,2023-04-12,9189
6215,和椿,10,0,10,群益金鼎-桃園,2023-04-12,9189
8234,新漢,12,2,10,群益金鼎-桃園,2023-04-12,9189
3682,亞太電,10,0,10,群益金鼎-桃園,2023-04-12,9189
2820,華票,10,0,10,群益金鼎-桃園,2023-04-12,9189
6485,點序,13,3,10,群益金鼎-桃園,2023-04-12,9189
6477,安集,21,11,10,群益金鼎-桃園,2023-04-12,9189
6285,啟��,9,0,9,群益金鼎-桃園,2023-04-12,9189
3594,磐儀,11,2,9,群益金鼎-桃園,2023-04-12,9189
00642U,期元大S＆P石油,9,0,9,群益金鼎-桃園,2023-04-12,9189
8069,元太,8,0,8,群益金鼎-桃園,2023-04-12,9189
2399,映泰,83,8,75,群益金鼎-桃園,2023-04-13,9189
1609,大亞,93,32,61,群益金鼎-桃園,2023-04-13,9189
1591,駿吉-KY,53,0,53,群益金鼎-桃園,2023-04-13,9189
00712,復華富時不動產,46,0,46,群益金鼎-桃園,2023-04-13,9189
8234,新漢,36,0,36,群益金鼎-桃園,2023-04-13,9189
1513,中興電,150,118,32,群益金鼎-桃園,2023-04-13,9189
3236,千如,30,0,30,群益金鼎-桃園,2023-04-13,9189
00923,群益台ESG低碳50,29,0,29,群益金鼎-桃園,2023-04-13,9189
00679B,元大美債20年,28,0,28,群益金鼎-桃園,2023-04-13,9189
1519,華城,37,11,26,群益金鼎-桃園,2023-04-13,9189
1584,精剛,51,26,25,群益金鼎-桃園,2023-04-13,9189
4541,晟田,29,5,24,群益金鼎-桃園,2023-04-13,9189
00673R,期元大S＆P原油反1,22,0,22,群益金鼎-桃園,2023-04-13,9189
6158,禾昌,22,0,22,群益金鼎-桃園,2023-04-13,9189
1605,華新,44,23,21,群益金鼎-桃園,2023-04-13,9189
5203,訊連,23,2,21,群益金鼎-桃園,2023-04-13,9189
5009,榮剛,43,23,20,群益金鼎-桃園,2023-04-13,9189
2402,毅嘉,34,14,20,群益金鼎-桃園,2023-04-13,9189
6163,華電網,48,28,20,群益金鼎-桃園,2023-04-13,9189
2330,台積電,19,0,19,群益金鼎-桃園,2023-04-13,9189
3481,群創,120,102,18,群益金鼎-桃園,2023-04-13,9189
00900,富邦特選高股息30,17,0,17,群益金鼎-桃園,2023-04-13,9189
2303,聯電,17,0,17,群益金鼎-桃園,2023-04-13,9189
5706,鳳凰,18,2,16,群益金鼎-桃園,2023-04-13,9189
6182,合晶,17,1,16,群益金鼎-桃園,2023-04-13,9189
3035,智原,41,26,15,群益金鼎-桃園,2023-04-13,9189
6443,元晶,19,4,15,群益金鼎-桃園,2023-04-13,9189
3624,光頡,16,2,14,群益金鼎-桃園,2023-04-13,9189
3711,日月光投控,13,0,13,群益金鼎-桃園,2023-04-13,9189
6753,龍德造船,15,2,13,群益金鼎-桃園,2023-04-13,9189
6791,虎門科技,13,0,13,群益金鼎-桃園,2023-04-13,9189
2208,台船,34,21,13,群益金鼎-桃園,2023-04-13,9189
8088,品安,22,10,12,群益金鼎-桃園,2023-04-13,9189
5222,全訊,38,26,12,群益金鼎-桃園,2023-04-13,9189
3715,定穎投控,15,3,12,群益金鼎-桃園,2023-04-13,9189
00753L,中信中國50正2,63,51,12,群益金鼎-桃園,2023-04-13,9189
00830,國泰費城半導體,11,0,11,群益金鼎-桃園,2023-04-13,9189
1503,士電,22,11,11,群益金鼎-桃園,2023-04-13,9189
5371,中光電,21,10,11,群益金鼎-桃園,2023-04-13,9189
4164,承業醫,18,7,11,群益金鼎-桃園,2023-04-13,9189
2324,仁寶,16,5,11,群益金鼎-桃園,2023-04-13,9189
3094,聯傑,14,3,11,群益金鼎-桃園,2023-04-13,9189
2388,威盛,19,8,11,群益金鼎-桃園,2023-04-13,9189
2017,官田鋼,11,0,11,群益金鼎-桃園,2023-04-13,9189
3552,同致,11,0,11,群益金鼎-桃園,2023-04-13,9189
2427,三商電,11,0,11,群益金鼎-桃園,2023-04-13,9189
3693,營邦,26,15,11,群益金鼎-桃園,2023-04-13,9189
3006,晶豪科,14,4,10,群益金鼎-桃園,2023-04-13,9189
9921,巨大,14,4,10,群益金鼎-桃園,2023-04-13,9189
1708,東鹼,10,0,10,群益金鼎-桃園,2023-04-13,9189
00632R,元大台灣50反1,242,20,222,群益金鼎-桃園,2023-04-14,9189
2634,漢翔,134,77,57,群益金鼎-桃園,2023-04-14,9189
2208,台船,133,77,56,群益金鼎-桃園,2023-04-14,9189
2399,映泰,50,0,50,群益金鼎-桃園,2023-04-14,9189
2324,仁寶,41,0,41,群益金鼎-桃園,2023-04-14,9189
3231,緯創,48,10,38,群益金鼎-桃園,2023-04-14,9189
00679B,元大美債20年,39,0,39,群益金鼎-桃園,2023-04-14,9189
8034,榮群,37,0,37,群益金鼎-桃園,2023-04-14,9189
4142,國光生,37,2,35,群益金鼎-桃園,2023-04-14,9189
1721,三晃,30,0,30,群益金鼎-桃園,2023-04-14,9189
2883,凱基金,36,11,25,群益金鼎-桃園,2023-04-14,9189
2739,寒舍,25,0,25,群益金鼎-桃園,2023-04-14,9189
1314,中石化,22,0,22,群益金鼎-桃園,2023-04-14,9189
3712,永崴投控,23,1,22,群益金鼎-桃園,2023-04-14,9189
00712,復華富時不動產,21,0,21,群益金鼎-桃園,2023-04-14,9189
3576,聯合再生,21,1,20,群益金鼎-桃園,2023-04-14,9189
2913,農林,20,0,20,群益金鼎-桃園,2023-04-14,9189
00680L,元大美債20正2,20,0,20,群益金鼎-桃園,2023-04-14,9189
1504,東元,48,28,20,群益金鼎-桃園,2023-04-14,9189
00673R,期元大S＆P原油反1,20,0,20,群益金鼎-桃園,2023-04-14,9189
2880,華南金,20,0,20,群益金鼎-桃園,2023-04-14,9189
2382,廣達,21,2,19,群益金鼎-桃園,2023-04-14,9189
1762,中化生,25,6,19,群益金鼎-桃園,2023-04-14,9189
5465,富驊,22,3,19,群益金鼎-桃園,2023-04-14,9189
00772B,中信高評級公司債,17,0,17,群益金鼎-桃園,2023-04-14,9189
00893,國泰智能電動車,17,0,17,群益金鼎-桃園,2023-04-14,9189
00664R,國泰臺灣加權反1,16,0,16,群益金鼎-桃園,2023-04-14,9189
3062,建漢,21,6,15,群益金鼎-桃園,2023-04-14,9189
4540,全球傳動,13,0,13,群益金鼎-桃園,2023-04-14,9189
2881,富邦金,15,2,13,群益金鼎-桃園,2023-04-14,9189
2885,元大金,12,0,12,群益金鼎-桃園,2023-04-14,9189
2482,連宇,15,3,12,群益金鼎-桃園,2023-04-14,9189
2331,精英,15,3,12,群益金鼎-桃園,2023-04-14,9189
1519,華城,17,5,12,群益金鼎-桃園,2023-04-14,9189
5425,台半,12,0,12,群益金鼎-桃園,2023-04-14,9189
4114,健喬,24,12,12,群益金鼎-桃園,2023-04-14,9189
00878,國泰永續高股息,18,6,12,群益金鼎-桃園,2023-04-14,9189
5258,虹堡,21,9,12,群益金鼎-桃園,2023-04-14,9189
6509,聚和,24,12,12,群益金鼎-桃園,2023-04-14,9189
3715,定穎投控,12,0,12,群益金鼎-桃園,2023-04-14,9189
4541,晟田,21,9,12,群益金鼎-桃園,2023-04-14,9189
3481,群創,28,16,12,群益金鼎-桃園,2023-04-14,9189
00795B,中信美國公債20年,11,0,11,群益金鼎-桃園,2023-04-14,9189
00720B,元大投資級公司債,12,1,11,群益金鼎-桃園,2023-04-14,9189
2610,華航,12,1,11,群益金鼎-桃園,2023-04-14,9189
2748,雲品,22,11,11,群益金鼎-桃園,2023-04-14,9189
3209,全科,13,2,11,群益金鼎-桃園,2023-04-14,9189
1701,中化,21,10,11,群益金鼎-桃園,2023-04-14,9189
3289,宜特,15,4,11,群益金鼎-桃園,2023-04-14,9189
3702,大聯大,10,0,10,群益金鼎-桃園,2023-04-14,9189
6288,聯嘉,70,8,62,群益金鼎-桃園,2023-04-17,9189
2634,漢翔,125,66,59,群益金鼎-桃園,2023-04-17,9189
00680L,元大美債20正2,58,0,58,群益金鼎-桃園,2023-04-17,9189
3013,晟銘電,70,16,54,群益金鼎-桃園,2023-04-17,9189
00720B,元大投資級公司債,40,0,40,群益金鼎-桃園,2023-04-17,9189
1514,亞力,47,8,39,群益金鼎-桃園,2023-04-17,9189
2312,金寶,40,4,36,群益金鼎-桃園,2023-04-17,9189
2359,所羅門,40,7,33,群益金鼎-桃園,2023-04-17,9189
1471,首利,32,3,29,群益金鼎-桃園,2023-04-17,9189
1314,中石化,28,0,28,群益金鼎-桃園,2023-04-17,9189
5203,訊連,30,3,27,群益金鼎-桃園,2023-04-17,9189
00712,復華富時不動產,21,0,21,群益金鼎-桃園,2023-04-17,9189
00687B,國泰20年美債,21,0,21,群益金鼎-桃園,2023-04-17,9189
1605,華新,34,13,21,群益金鼎-桃園,2023-04-17,9189
2002,中鋼,22,2,20,群益金鼎-桃園,2023-04-17,9189
2382,廣達,20,0,20,群益金鼎-桃園,2023-04-17,9189
5488,松普,20,0,20,群益金鼎-桃園,2023-04-17,9189
2324,仁寶,18,0,18,群益金鼎-桃園,2023-04-17,9189
1444,力麗,23,6,17,群益金鼎-桃園,2023-04-17,9189
3029,零壹,53,37,16,群益金鼎-桃園,2023-04-17,9189
1712,興農,15,0,15,群益金鼎-桃園,2023-04-17,9189
00885,富邦越南,15,0,15,群益金鼎-桃園,2023-04-17,9189
1731,美吾華,15,0,15,群益金鼎-桃園,2023-04-17,9189
00632R,元大台灣50反1,19,5,14,群益金鼎-桃園,2023-04-17,9189
2610,華航,41,27,14,群益金鼎-桃園,2023-04-17,9189
2230,泰茂,13,0,13,群益金鼎-桃園,2023-04-17,9189
6477,安集,15,2,13,群益金鼎-桃園,2023-04-17,9189
3576,聯合再生,12,0,12,群益金鼎-桃園,2023-04-17,9189
5258,虹堡,20,8,12,群益金鼎-桃園,2023-04-17,9189
00679B,元大美債20年,11,0,11,群益金鼎-桃園,2023-04-17,9189
2449,京元電子,13,2,11,群益金鼎-桃園,2023-04-17,9189
00888,永豐台灣ESG,11,0,11,群益金鼎-桃園,2023-04-17,9189
1609,大亞,13,2,11,群益金鼎-桃園,2023-04-17,9189
2442,新美齊,10,0,10,群益金鼎-桃園,2023-04-17,9189
4533,協易機,10,0,10,群益金鼎-桃園,2023-04-17,9189
006205,富邦上証,10,0,10,群益金鼎-桃園,2023-04-17,9189
3682,亞太電,10,0,10,群益金鼎-桃園,2023-04-17,9189
2363,矽統,10,0,10,群益金鼎-桃園,2023-04-17,9189
3030,德律,10,0,10,群益金鼎-桃園,2023-04-17,9189
5284,jpp-KY,14,4,10,群益金鼎-桃園,2023-04-17,9189
4551,智伸科,10,0,10,群益金鼎-桃園,2023-04-17,9189
6443,元晶,10,0,10,群益金鼎-桃園,2023-04-17,9189
8222,寶一,24,14,10,群益金鼎-桃園,2023-04-17,9189
6235,華孚,98,89,9,群益金鼎-桃園,2023-04-17,9189
2891,中信金,11,2,9,群益金鼎-桃園,2023-04-17,9189
1809,中釉,13,5,8,群益金鼎-桃園,2023-04-17,9189
1734,杏輝,10,2,8,群益金鼎-桃園,2023-04-17,9189
2049,上銀,8,0,8,群益金鼎-桃園,2023-04-17,9189
00878,國泰永續高股息,19,12,7,群益金鼎-桃園,2023-04-17,9189
2454,聯發科,9,2,7,群益金鼎-桃園,2023-04-17,9189
2888,新光金,202,0,202,群益金鼎-桃園,2023-04-18,9189
00680L,元大美債20正2,88,0,88,群益金鼎-桃園,2023-04-18,9189
3576,聯合再生,161,85,76,群益金鼎-桃園,2023-04-18,9189
2323,中環,70,0,70,群益金鼎-桃園,2023-04-18,9189
2883,凱基金,61,4,57,群益金鼎-桃園,2023-04-18,9189
00720B,元大投資級公司債,49,0,49,群益金鼎-桃園,2023-04-18,9189
3013,晟銘電,57,16,41,群益金鼎-桃園,2023-04-18,9189
2349,錸德,41,0,41,群益金鼎-桃園,2023-04-18,9189
1605,華新,96,58,38,群益金鼎-桃園,2023-04-18,9189
3046,建��,52,15,37,群益金鼎-桃園,2023-04-18,9189
00679B,元大美債20年,40,3,37,群益金鼎-桃園,2023-04-18,9189
2338,光罩,36,0,36,群益金鼎-桃園,2023-04-18,9189
6148,驊宏資,65,30,35,群益金鼎-桃園,2023-04-18,9189
6585,鼎基,34,0,34,群益金鼎-桃園,2023-04-18,9189
2834,臺企銀,33,0,33,群益金鼎-桃園,2023-04-18,9189
6244,茂迪,67,35,32,群益金鼎-桃園,2023-04-18,9189
5315,光聯,32,0,32,群益金鼎-桃園,2023-04-18,9189
00712,復華富時不動產,32,0,32,群益金鼎-桃園,2023-04-18,9189
00687B,國泰20年美債,32,0,32,群益金鼎-桃園,2023-04-18,9189
3058,立德,33,2,31,群益金鼎-桃園,2023-04-18,9189
4109,加捷生醫,30,0,30,群益金鼎-桃園,2023-04-18,9189
6271,同欣電,36,11,25,群益金鼎-桃園,2023-04-18,9189
8234,新漢,27,2,25,群益金鼎-桃園,2023-04-18,9189
4566,時碩工業,37,12,25,群益金鼎-桃園,2023-04-18,9189
8105,凌巨,30,5,25,群益金鼎-桃園,2023-04-18,9189
2313,華通,33,9,24,群益金鼎-桃園,2023-04-18,9189
1314,中石化,23,0,23,群益金鼎-桃園,2023-04-18,9189
6179,亞通,25,3,22,群益金鼎-桃園,2023-04-18,9189
3441,聯一光,21,0,21,群益金鼎-桃園,2023-04-18,9189
3078,僑威,23,4,19,群益金鼎-桃園,2023-04-18,9189
3231,緯創,25,8,17,群益金鼎-桃園,2023-04-18,9189
6470,宇智,19,2,17,群益金鼎-桃園,2023-04-18,9189
3481,群創,25,8,17,群益金鼎-桃園,2023-04-18,9189
00878,國泰永續高股息,19,2,17,群益金鼎-桃園,2023-04-18,9189
00772B,中信高評級公司債,16,0,16,群益金鼎-桃園,2023-04-18,9189
8931,大汽電,17,1,16,群益金鼎-桃園,2023-04-18,9189
2609,陽明,21,6,15,群益金鼎-桃園,2023-04-18,9189
3624,光頡,32,17,15,群益金鼎-桃園,2023-04-18,9189
2402,毅嘉,19,4,15,群益金鼎-桃園,2023-04-18,9189
3588,通嘉,17,3,14,群益金鼎-桃園,2023-04-18,9189
3693,營邦,17,3,14,群益金鼎-桃園,2023-04-18,9189
00673R,期元大S＆P原油反1,14,0,14,群益金鼎-桃園,2023-04-18,9189
2324,仁寶,13,0,13,群益金鼎-桃園,2023-04-18,9189
2453,凌群,22,9,13,群益金鼎-桃園,2023-04-18,9189
2637,慧洋-KY,12,0,12,群益金鼎-桃園,2023-04-18,9189
6122,擎邦,28,16,12,群益金鼎-桃園,2023-04-18,9189
2413,環科,13,1,12,群益金鼎-桃園,2023-04-18,9189
2344,華邦電,21,9,12,群益金鼎-桃園,2023-04-18,9189
3380,明泰,19,7,12,群益金鼎-桃園,2023-04-18,9189
3025,星通,19,8,11,群益金鼎-桃園,2023-04-18,9189
00632R,元大台灣50反1,218,96,122,群益金鼎-桃園,2023-04-19,9189
00720B,元大投資級公司債,89,0,89,群益金鼎-桃園,2023-04-19,9189
1513,中興電,55,0,55,群益金鼎-桃園,2023-04-19,9189
1701,中化,56,1,55,群益金鼎-桃園,2023-04-19,9189
3022,威強電,60,8,52,群益金鼎-桃園,2023-04-19,9189
4726,永昕,55,4,51,群益金鼎-桃園,2023-04-19,9189
6161,捷波,40,0,40,群益金鼎-桃園,2023-04-19,9189
00772B,中信高評級公司債,31,0,31,群益金鼎-桃園,2023-04-19,9189
4566,時碩工業,31,3,28,群益金鼎-桃園,2023-04-19,9189
3287,廣寰科,30,2,28,群益金鼎-桃園,2023-04-19,9189
1444,力麗,27,0,27,群益金鼎-桃園,2023-04-19,9189
6606,建德工業,26,0,26,群益金鼎-桃園,2023-04-19,9189
6134,萬旭,25,0,25,群益金鼎-桃園,2023-04-19,9189
8038,長園科,24,1,23,群益金鼎-桃園,2023-04-19,9189
3189,景碩,25,3,22,群益金鼎-桃園,2023-04-19,9189
2801,彰銀,22,0,22,群益金鼎-桃園,2023-04-19,9189
2889,國票金,21,0,21,群益金鼎-桃園,2023-04-19,9189
8930,青鋼,21,0,21,群益金鼎-桃園,2023-04-19,9189
3092,鴻碩,21,1,20,群益金鼎-桃園,2023-04-19,9189
1731,美吾華,20,0,20,群益金鼎-桃園,2023-04-19,9189
5340,建榮,20,0,20,群益金鼎-桃園,2023-04-19,9189
3673,TPK-KY,24,4,20,群益金鼎-桃園,2023-04-19,9189
2471,資通,23,3,20,群益金鼎-桃園,2023-04-19,9189
6231,系微,22,2,20,群益金鼎-桃園,2023-04-19,9189
2323,中環,26,7,19,群益金鼎-桃園,2023-04-19,9189
6770,力積電,24,5,19,群益金鼎-桃園,2023-04-19,9189
2303,聯電,21,3,18,群益金鼎-桃園,2023-04-19,9189
00923,群益台ESG低碳50,18,0,18,群益金鼎-桃園,2023-04-19,9189
2498,宏達電,19,1,18,群益金鼎-桃園,2023-04-19,9189
2882,國泰金,20,3,17,群益金鼎-桃園,2023-04-19,9189
4540,全球傳動,17,0,17,群益金鼎-桃園,2023-04-19,9189
3221,台嘉碩,17,0,17,群益金鼎-桃園,2023-04-19,9189
4746,台耀,32,15,17,群益金鼎-桃園,2023-04-19,9189
1528,恩德,19,2,17,群益金鼎-桃園,2023-04-19,9189
9955,佳龍,16,0,16,群益金鼎-桃園,2023-04-19,9189
5488,松普,15,0,15,群益金鼎-桃園,2023-04-19,9189
8222,寶一,50,35,15,群益金鼎-桃園,2023-04-19,9189
1720,生達,18,4,14,群益金鼎-桃園,2023-04-19,9189
1802,台玻,16,2,14,群益金鼎-桃園,2023-04-19,9189
2338,光罩,14,0,14,群益金鼎-桃園,2023-04-19,9189
6153,嘉聯益,15,1,14,群益金鼎-桃園,2023-04-19,9189
1503,士電,19,6,13,群益金鼎-桃園,2023-04-19,9189
1533,車王電,17,4,13,群益金鼎-桃園,2023-04-19,9189
6791,虎門科技,13,0,13,群益金鼎-桃園,2023-04-19,9189
00753L,中信中國50正2,22,10,12,群益金鼎-桃園,2023-04-19,9189
6116,彩晶,17,5,12,群益金鼎-桃園,2023-04-19,9189
00650L,復華香港正2,12,0,12,群益金鼎-桃園,2023-04-19,9189
8069,元太,12,0,12,群益金鼎-桃園,2023-04-19,9189
2457,飛宏,63,52,11,群益金鼎-桃園,2023-04-19,9189
8091,翔名,15,4,11,群益金鼎-桃園,2023-04-19,9189
3576,聯合再生,184,1,183,群益金鼎-桃園,2023-04-20,9189
00772B,中信高評級公司債,101,0,101,群益金鼎-桃園,2023-04-20,9189
2801,彰銀,80,0,80,群益金鼎-桃園,2023-04-20,9189
4121,優盛,81,10,71,群益金鼎-桃園,2023-04-20,9189
1201,味全,50,0,50,群益金鼎-桃園,2023-04-20,9189
1402,遠東新,50,0,50,群益金鼎-桃園,2023-04-20,9189
3047,訊舟,46,0,46,群益金鼎-桃園,2023-04-20,9189
3078,僑威,55,11,44,群益金鼎-桃園,2023-04-20,9189
2498,宏達電,41,3,38,群益金鼎-桃園,2023-04-20,9189
3521,鴻翊,37,0,37,群益金鼎-桃園,2023-04-20,9189
2323,中環,35,0,35,群益金鼎-桃園,2023-04-20,9189
00753L,中信中國50正2,62,28,34,群益金鼎-桃園,2023-04-20,9189
00912,中信臺灣智慧50,30,0,30,群益金鼎-桃園,2023-04-20,9189
2890,永豐金,30,0,30,群益金鼎-桃園,2023-04-20,9189
2457,飛宏,36,9,27,群益金鼎-桃園,2023-04-20,9189
3094,聯傑,29,2,27,群益金鼎-桃園,2023-04-20,9189
2634,漢翔,68,43,25,群益金鼎-桃園,2023-04-20,9189
6244,茂迪,70,45,25,群益金鼎-桃園,2023-04-20,9189
3673,TPK-KY,25,0,25,群益金鼎-桃園,2023-04-20,9189
1909,榮成,30,7,23,群益金鼎-桃園,2023-04-20,9189
2337,旺宏,23,0,23,群益金鼎-桃園,2023-04-20,9189
3234,光環,31,10,21,群益金鼎-桃園,2023-04-20,9189
1711,永光,20,0,20,群益金鼎-桃園,2023-04-20,9189
8222,寶一,37,18,19,群益金鼎-桃園,2023-04-20,9189
3664,安瑞-KY,17,0,17,群益金鼎-桃園,2023-04-20,9189
6285,啟��,18,1,17,群益金鼎-桃園,2023-04-20,9189
3714,富采,16,0,16,群益金鼎-桃園,2023-04-20,9189
1605,華新,26,10,16,群益金鼎-桃園,2023-04-20,9189
4934,太極,17,1,16,群益金鼎-桃園,2023-04-20,9189
1810,和成,110,94,16,群益金鼎-桃園,2023-04-20,9189
2324,仁寶,16,0,16,群益金鼎-桃園,2023-04-20,9189
2885,元大金,15,0,15,群益金鼎-桃園,2023-04-20,9189
2302,麗正,15,0,15,群益金鼎-桃園,2023-04-20,9189
6290,良維,15,0,15,群益金鼎-桃園,2023-04-20,9189
6235,華孚,16,2,14,群益金鼎-桃園,2023-04-20,9189
2409,友達,14,0,14,群益金鼎-桃園,2023-04-20,9189
6768,志強-KY,14,0,14,群益金鼎-桃園,2023-04-20,9189
6215,和椿,14,1,13,群益金鼎-桃園,2023-04-20,9189
1612,宏泰,13,0,13,群益金鼎-桃園,2023-04-20,9189
9958,世紀鋼,16,3,13,群益金鼎-桃園,2023-04-20,9189
1904,正隆,18,6,12,群益金鼎-桃園,2023-04-20,9189
3466,德晉,13,1,12,群益金鼎-桃園,2023-04-20,9189
6165,浪凡,12,0,12,群益金鼎-桃園,2023-04-20,9189
2515,中工,22,10,12,群益金鼎-桃園,2023-04-20,9189
1734,杏輝,12,0,12,群益金鼎-桃園,2023-04-20,9189
8383,千附,13,2,11,群益金鼎-桃園,2023-04-20,9189
2727,王品,24,13,11,群益金鼎-桃園,2023-04-20,9189
00891,中信關鍵半導體,11,0,11,群益金鼎-桃園,2023-04-20,9189
2367,燿華,11,0,11,群益金鼎-桃園,2023-04-20,9189
1504,東元,22,11,11,群益金鼎-桃園,2023-04-20,9189
00632R,元大台灣50反1,200,29,171,群益金鼎-桃園,2023-04-21,9189
2913,農林,143,50,93,群益金鼎-桃園,2023-04-21,9189
6733,博晟生醫,51,8,43,群益金鼎-桃園,2023-04-21,9189
6770,力積電,42,0,42,群益金鼎-桃園,2023-04-21,9189
2323,中環,42,0,42,群益金鼎-桃園,2023-04-21,9189
3380,明泰,46,13,33,群益金鼎-桃園,2023-04-21,9189
2882,國泰金,31,0,31,群益金鼎-桃園,2023-04-21,9189
00753L,中信中國50正2,30,0,30,群益金鼎-桃園,2023-04-21,9189
00680L,元大美債20正2,31,1,30,群益金鼎-桃園,2023-04-21,9189
6874,倍力,33,7,26,群益金鼎-桃園,2023-04-21,9189
4979,華星光,29,4,25,群益金鼎-桃園,2023-04-21,9189
2329,華泰,24,0,24,群益金鼎-桃園,2023-04-21,9189
1611,中電,40,16,24,群益金鼎-桃園,2023-04-21,9189
2303,聯電,23,1,22,群益金鼎-桃園,2023-04-21,9189
2838,聯邦銀,20,0,20,群益金鼎-桃園,2023-04-21,9189
3501,維熹,20,0,20,群益金鼎-桃園,2023-04-21,9189
6244,茂迪,56,36,20,群益金鼎-桃園,2023-04-21,9189
3029,零壹,20,1,19,群益金鼎-桃園,2023-04-21,9189
00679B,元大美債20年,16,1,15,群益金鼎-桃園,2023-04-21,9189
8931,大汽電,15,0,15,群益金鼎-桃園,2023-04-21,9189
3308,聯德,15,0,15,群益金鼎-桃園,2023-04-21,9189
6603,富強鑫,15,0,15,群益金鼎-桃園,2023-04-21,9189
2630,亞航,17,2,15,群益金鼎-桃園,2023-04-21,9189
1605,華新,19,5,14,群益金鼎-桃園,2023-04-21,9189
2615,萬海,14,0,14,群益金鼎-桃園,2023-04-21,9189
6781,AES-KY,14,0,14,群益金鼎-桃園,2023-04-21,9189
00900,富邦特選高股息30,14,0,14,群益金鼎-桃園,2023-04-21,9189
00713,元大台灣高息低波,13,0,13,群益金鼎-桃園,2023-04-21,9189
2534,宏盛,12,0,12,群益金鼎-桃園,2023-04-21,9189
3047,訊舟,17,5,12,群益金鼎-桃園,2023-04-21,9189
00891,中信關鍵半導體,11,0,11,群益金鼎-桃園,2023-04-21,9189
00895,富邦未來車,11,0,11,群益金鼎-桃園,2023-04-21,9189
2328,廣宇,11,0,11,群益金鼎-桃園,2023-04-21,9189
2705,六福,12,1,11,群益金鼎-桃園,2023-04-21,9189
6163,華電網,42,31,11,群益金鼎-桃園,2023-04-21,9189
2618,長榮航,28,18,10,群益金鼎-桃園,2023-04-21,9189
1760,寶齡富錦,11,1,10,群益金鼎-桃園,2023-04-21,9189
8050,廣積,12,2,10,群益金鼎-桃園,2023-04-21,9189
1907,永豐餘,24,14,10,群益金鼎-桃園,2023-04-21,9189
4572,駐龍,10,0,10,群益金鼎-桃園,2023-04-21,9189
6142,友勁,10,0,10,群益金鼎-桃園,2023-04-21,9189
00877,復華中國5G,10,0,10,群益金鼎-桃園,2023-04-21,9189
1718,中纖,10,0,10,群益金鼎-桃園,2023-04-21,9189
4138,曜亞,10,0,10,群益金鼎-桃園,2023-04-21,9189
3664,安瑞-KY,10,0,10,群益金鼎-桃園,2023-04-21,9189
3441,聯一光,10,0,10,群益金鼎-桃園,2023-04-21,9189
4707,磐亞,10,0,10,群益金鼎-桃園,2023-04-21,9189
5475,德宏,10,0,10,群益金鼎-桃園,2023-04-21,9189
6161,捷波,10,0,10,群益金鼎-桃園,2023-04-21,9189
3049,精金,10,0,10,群益金鼎-桃園,2023-04-21,9189
00637L,元大滬深300正2,138,10,128,群益金鼎-桃園,2023-04-24,9189
2884,玉山金,101,6,95,群益金鼎-桃園,2023-04-24,9189
2913,農林,215,143,72,群益金鼎-桃園,2023-04-24,9189
00753L,中信中國50正2,47,0,47,群益金鼎-桃園,2023-04-24,9189
1907,永豐餘,53,10,43,群益金鼎-桃園,2023-04-24,9189
4510,高鋒,41,3,38,群益金鼎-桃園,2023-04-24,9189
2515,中工,35,0,35,群益金鼎-桃園,2023-04-24,9189
6218,豪勉,46,12,34,群益金鼎-桃園,2023-04-24,9189
00902,中信電池及儲能,32,0,32,群益金鼎-桃園,2023-04-24,9189
2495,普安,32,0,32,群益金鼎-桃園,2023-04-24,9189
2363,矽統,32,0,32,群益金鼎-桃園,2023-04-24,9189
6134,萬旭,32,4,28,群益金鼎-桃園,2023-04-24,9189
00830,國泰費城半導體,24,0,24,群益金鼎-桃園,2023-04-24,9189
00878,國泰永續高股息,32,8,24,群益金鼎-桃園,2023-04-24,9189
2313,華通,22,0,22,群益金鼎-桃園,2023-04-24,9189
1101,台泥,48,29,19,群益金鼎-桃園,2023-04-24,9189
1905,華紙,64,45,19,群益金鼎-桃園,2023-04-24,9189
2634,漢翔,59,42,17,群益金鼎-桃園,2023-04-24,9189
3035,智原,72,55,17,群益金鼎-桃園,2023-04-24,9189
00679B,元大美債20年,14,0,14,群益金鼎-桃園,2023-04-24,9189
2324,仁寶,15,1,14,群益金鼎-桃園,2023-04-24,9189
9958,世紀鋼,15,1,14,群益金鼎-桃園,2023-04-24,9189
00923,群益台ESG低碳50,14,0,14,群益金鼎-桃園,2023-04-24,9189
00713,元大台灣高息低波,13,0,13,群益金鼎-桃園,2023-04-24,9189
3058,立德,15,2,13,群益金鼎-桃園,2023-04-24,9189
1314,中石化,12,0,12,群益金鼎-桃園,2023-04-24,9189
4128,中天,11,0,11,群益金鼎-桃園,2023-04-24,9189
2409,友達,13,2,11,群益金鼎-桃園,2023-04-24,9189
00893,國泰智能電動車,10,0,10,群益金鼎-桃園,2023-04-24,9189
00772B,中信高評級公司債,10,0,10,群益金鼎-桃園,2023-04-24,9189
2501,國建,10,0,10,群益金鼎-桃園,2023-04-24,9189
4739,康普,10,0,10,群益金鼎-桃園,2023-04-24,9189
00639,富邦深100,10,0,10,群益金鼎-桃園,2023-04-24,9189
00680L,元大美債20正2,10,0,10,群益金鼎-桃園,2023-04-24,9189
00907,永豐優息存股,10,0,10,群益金鼎-桃園,2023-04-24,9189
3013,晟銘電,18,8,10,群益金鼎-桃園,2023-04-24,9189
6189,豐藝,10,0,10,群益金鼎-桃園,2023-04-24,9189
3030,德律,10,0,10,群益金鼎-桃園,2023-04-24,9189
2228,劍麟,10,0,10,群益金鼎-桃園,2023-04-24,9189
1584,精剛,14,4,10,群益金鼎-桃園,2023-04-24,9189
3078,僑威,19,9,10,群益金鼎-桃園,2023-04-24,9189
8033,雷虎,11,1,10,群益金鼎-桃園,2023-04-24,9189
4968,立積,18,10,8,群益金鼎-桃園,2023-04-24,9189
2330,台積電,8,0,8,群益金鼎-桃園,2023-04-24,9189
4960,誠美材,8,0,8,群益金鼎-桃園,2023-04-24,9189
2457,飛宏,19,11,8,群益金鼎-桃園,2023-04-24,9189
2498,宏達電,14,6,8,群益金鼎-桃園,2023-04-24,9189
2323,中環,10,2,8,群益金鼎-桃園,2023-04-24,9189
6125,廣運,10,3,7,群益金鼎-桃園,2023-04-24,9189
6233,旺玖,7,0,7,群益金鼎-桃園,2023-04-24,9189
2610,華航,128,9,119,群益金鼎-桃園,2023-04-25,9189
00679B,元大美債20年,99,2,97,群益金鼎-桃園,2023-04-25,9189
2363,矽統,90,0,90,群益金鼎-桃園,2023-04-25,9189
2368,金像電,77,0,77,群益金鼎-桃園,2023-04-25,9189
2489,瑞軒,67,0,67,群益金鼎-桃園,2023-04-25,9189
8093,保銳,54,1,53,群益金鼎-桃園,2023-04-25,9189
0056,元大高股息,61,12,49,群益金鼎-桃園,2023-04-25,9189
3481,群創,58,19,39,群益金鼎-桃園,2023-04-25,9189
1101,台泥,55,17,38,群益金鼎-桃園,2023-04-25,9189
00753L,中信中國50正2,41,4,37,群益金鼎-桃園,2023-04-25,9189
4121,優盛,35,0,35,群益金鼎-桃園,2023-04-25,9189
6116,彩晶,35,1,34,群益金鼎-桃園,2023-04-25,9189
2303,聯電,40,7,33,群益金鼎-桃園,2023-04-25,9189
2883,凱基金,62,35,27,群益金鼎-桃園,2023-04-25,9189
3033,威健,25,1,24,群益金鼎-桃園,2023-04-25,9189
1714,和桐,48,25,23,群益金鼎-桃園,2023-04-25,9189
3521,鴻翊,22,0,22,群益金鼎-桃園,2023-04-25,9189
00715L,期街口布蘭特正2,34,12,22,群益金鼎-桃園,2023-04-25,9189
6283,淳安,21,0,21,群益金鼎-桃園,2023-04-25,9189
2367,燿華,21,0,21,群益金鼎-桃園,2023-04-25,9189
3231,緯創,43,22,21,群益金鼎-桃園,2023-04-25,9189
8426,紅木-KY,20,0,20,群益金鼎-桃園,2023-04-25,9189
00923,群益台ESG低碳50,22,2,20,群益金鼎-桃園,2023-04-25,9189
1591,駿吉-KY,20,0,20,群益金鼎-桃園,2023-04-25,9189
911868,同方友友-DR,20,0,20,群益金鼎-桃園,2023-04-25,9189
6282,康舒,23,4,19,群益金鼎-桃園,2023-04-25,9189
00713,元大台灣高息低波,19,0,19,群益金鼎-桃園,2023-04-25,9189
00900,富邦特選高股息30,17,0,17,群益金鼎-桃園,2023-04-25,9189
2882,國泰金,20,3,17,群益金鼎-桃園,2023-04-25,9189
2337,旺宏,22,5,17,群益金鼎-桃園,2023-04-25,9189
3094,聯傑,16,0,16,群益金鼎-桃園,2023-04-25,9189
9955,佳龍,20,4,16,群益金鼎-桃園,2023-04-25,9189
2634,漢翔,133,118,15,群益金鼎-桃園,2023-04-25,9189
00902,中信電池及儲能,15,0,15,群益金鼎-桃園,2023-04-25,9189
2027,大成鋼,15,1,14,群益金鼎-桃園,2023-04-25,9189
3005,神基,15,1,14,群益金鼎-桃園,2023-04-25,9189
2332,友訊,14,0,14,群益金鼎-桃園,2023-04-25,9189
4726,永昕,14,0,14,群益金鼎-桃園,2023-04-25,9189
5425,台半,13,0,13,群益金鼎-桃園,2023-04-25,9189
5880,合庫金,13,0,13,群益金鼎-桃園,2023-04-25,9189
9933,中鼎,13,0,13,群益金鼎-桃園,2023-04-25,9189
8222,寶一,25,12,13,群益金鼎-桃園,2023-04-25,9189
1611,中電,17,5,12,群益金鼎-桃園,2023-04-25,9189
2002,中鋼,12,0,12,群益金鼎-桃園,2023-04-25,9189
2323,中環,12,0,12,群益金鼎-桃園,2023-04-25,9189
2302,麗正,12,0,12,群益金鼎-桃園,2023-04-25,9189
3322,建舜電,11,0,11,群益金鼎-桃園,2023-04-25,9189
3019,亞光,11,0,11,群益金鼎-桃園,2023-04-25,9189
2449,京元電子,11,0,11,群益金鼎-桃園,2023-04-25,9189
00642U,期元大S＆P石油,11,0,11,群益金鼎-桃園,2023-04-25,9189
00679B,元大美債20年,116,3,113,群益金鼎-桃園,2023-04-26,9189
8222,寶一,146,43,103,群益金鼎-桃園,2023-04-26,9189
8086,宏捷科,75,0,75,群益金鼎-桃園,2023-04-26,9189
2313,華通,43,5,38,群益金鼎-桃園,2023-04-26,9189
2303,聯電,36,0,36,群益金鼎-桃園,2023-04-26,9189
00878,國泰永續高股息,40,6,34,群益金鼎-桃園,2023-04-26,9189
2515,中工,34,0,34,群益金鼎-桃園,2023-04-26,9189
1101,台泥,34,5,29,群益金鼎-桃園,2023-04-26,9189
00676R,富邦臺灣加權反1,25,0,25,群益金鼎-桃園,2023-04-26,9189
9933,中鼎,25,0,25,群益金鼎-桃園,2023-04-26,9189
00891,中信關鍵半導體,24,0,24,群益金鼎-桃園,2023-04-26,9189
2634,漢翔,36,13,23,群益金鼎-桃園,2023-04-26,9189
2368,金像電,22,0,22,群益金鼎-桃園,2023-04-26,9189
00830,國泰費城半導體,21,0,21,群益金鼎-桃園,2023-04-26,9189
3078,僑威,24,3,21,群益金鼎-桃園,2023-04-26,9189
3011,今皓,20,0,20,群益金鼎-桃園,2023-04-26,9189
6134,萬旭,24,4,20,群益金鼎-桃園,2023-04-26,9189
2002,中鋼,30,10,20,群益金鼎-桃園,2023-04-26,9189
2609,陽明,20,4,16,群益金鼎-桃園,2023-04-26,9189
00712,復華富時不動產,15,0,15,群益金鼎-桃園,2023-04-26,9189
2603,長榮,15,0,15,群益金鼎-桃園,2023-04-26,9189
1718,中纖,15,0,15,群益金鼎-桃園,2023-04-26,9189
1721,三晃,25,10,15,群益金鼎-桃園,2023-04-26,9189
2393,億光,17,2,15,群益金鼎-桃園,2023-04-26,9189
1529,樂事綠能,16,2,14,群益金鼎-桃園,2023-04-26,9189
2618,長榮航,14,0,14,群益金鼎-桃園,2023-04-26,9189
0056,元大高股息,16,3,13,群益金鼎-桃園,2023-04-26,9189
3035,智原,79,66,13,群益金鼎-桃園,2023-04-26,9189
2211,長榮鋼,13,0,13,群益金鼎-桃園,2023-04-26,9189
00909,國泰數位支付服務,12,0,12,群益金鼎-桃園,2023-04-26,9189
6418,詠昇,12,0,12,群益金鼎-桃園,2023-04-26,9189
1310,台苯,23,12,11,群益金鼎-桃園,2023-04-26,9189
6829,千附精密,18,7,11,群益金鼎-桃園,2023-04-26,9189
2314,台揚,11,0,11,群益金鼎-桃園,2023-04-26,9189
6129,普誠,10,0,10,群益金鼎-桃園,2023-04-26,9189
4207,環泰,10,0,10,群益金鼎-桃園,2023-04-26,9189
00877,復華中國5G,10,0,10,群益金鼎-桃園,2023-04-26,9189
911868,同方友友-DR,10,0,10,群益金鼎-桃園,2023-04-26,9189
2201,裕隆,13,3,10,群益金鼎-桃園,2023-04-26,9189
6770,力積電,9,0,9,群益金鼎-桃園,2023-04-26,9189
2495,普安,16,7,9,群益金鼎-桃園,2023-04-26,9189
5211,蒙恬,10,1,9,群益金鼎-桃園,2023-04-26,9189
2455,全新,8,0,8,群益金鼎-桃園,2023-04-26,9189
00900,富邦特選高股息30,11,4,7,群益金鼎-桃園,2023-04-26,9189
6806,森崴能源,9,2,7,群益金鼎-桃園,2023-04-26,9189
4931,新盛力,7,0,7,群益金鼎-桃園,2023-04-26,9189
00919,群益台灣精選高息,6,0,6,群益金鼎-桃園,2023-04-26,9189
2610,華航,22,16,6,群益金鼎-桃園,2023-04-26,9189
00885,富邦越南,6,0,6,群益金鼎-桃園,2023-04-26,9189
1584,精剛,9,3,6,群益金鼎-桃園,2023-04-26,9189
2867,三商壽,100,0,100,群益金鼎-桃園,2023-04-27,9189
00753L,中信中國50正2,75,0,75,群益金鼎-桃園,2023-04-27,9189
00715L,期街口布蘭特正2,71,0,71,群益金鼎-桃園,2023-04-27,9189
2002,中鋼,47,2,45,群益金鼎-桃園,2023-04-27,9189
4111,濟生,45,2,43,群益金鼎-桃園,2023-04-27,9189
00679B,元大美債20年,50,10,40,群益金鼎-桃園,2023-04-27,9189
4763,材料-KY,66,30,36,群益金鼎-桃園,2023-04-27,9189
2349,錸德,35,0,35,群益金鼎-桃園,2023-04-27,9189
00885,富邦越南,27,0,27,群益金鼎-桃園,2023-04-27,9189
2484,希華,25,0,25,群益金鼎-桃園,2023-04-27,9189
1710,東聯,54,31,23,群益金鼎-桃園,2023-04-27,9189
0056,元大高股息,22,0,22,群益金鼎-桃園,2023-04-27,9189
2423,固緯,120,98,22,群益金鼎-桃園,2023-04-27,9189
6509,聚和,21,0,21,群益金鼎-桃園,2023-04-27,9189
2610,華航,39,18,21,群益金鼎-桃園,2023-04-27,9189
5880,合庫金,20,0,20,群益金鼎-桃園,2023-04-27,9189
6134,萬旭,20,0,20,群益金鼎-桃園,2023-04-27,9189
9955,佳龍,20,0,20,群益金鼎-桃園,2023-04-27,9189
1711,永光,44,25,19,群益金鼎-桃園,2023-04-27,9189
00632R,元大台灣50反1,19,0,19,群益金鼎-桃園,2023-04-27,9189
6163,華電網,20,1,19,群益金鼎-桃園,2023-04-27,9189
2317,鴻海,15,0,15,群益金鼎-桃園,2023-04-27,9189
1731,美吾華,15,0,15,群益金鼎-桃園,2023-04-27,9189
5425,台半,17,2,15,群益金鼎-桃園,2023-04-27,9189
1709,和益,19,5,14,群益金鼎-桃園,2023-04-27,9189
00687B,國泰20年美債,14,0,14,群益金鼎-桃園,2023-04-27,9189
6244,茂迪,18,4,14,群益金鼎-桃園,2023-04-27,9189
00878,國泰永續高股息,29,15,14,群益金鼎-桃園,2023-04-27,9189
2393,億光,13,0,13,群益金鼎-桃園,2023-04-27,9189
2204,中華,22,9,13,群益金鼎-桃園,2023-04-27,9189
5211,蒙恬,16,3,13,群益金鼎-桃園,2023-04-27,9189
00712,復華富時不動產,12,0,12,群益金鼎-桃園,2023-04-27,9189
4167,松瑞藥,12,0,12,群益金鼎-桃園,2023-04-27,9189
6139,亞翔,12,0,12,群益金鼎-桃園,2023-04-27,9189
2324,仁寶,11,0,11,群益金鼎-桃園,2023-04-27,9189
2603,長榮,11,1,10,群益金鼎-桃園,2023-04-27,9189
9105,泰金寶-DR,10,0,10,群益金鼎-桃園,2023-04-27,9189
00922,國泰台灣領袖50,10,0,10,群益金鼎-桃園,2023-04-27,9189
00894,中信小資高價30,10,0,10,群益金鼎-桃園,2023-04-27,9189
00830,國泰費城半導體,10,0,10,群益金鼎-桃園,2023-04-27,9189
3033,威健,10,0,10,群益金鼎-桃園,2023-04-27,9189
3703,欣陸,10,0,10,群益金鼎-桃園,2023-04-27,9189
2027,大成鋼,12,2,10,群益金鼎-桃園,2023-04-27,9189
00895,富邦未來車,10,0,10,群益金鼎-桃園,2023-04-27,9189
00671R,富邦NASDAQ反1,10,0,10,群益金鼎-桃園,2023-04-27,9189
1560,中砂,10,0,10,群益金鼎-桃園,2023-04-27,9189
4979,華星光,25,16,9,群益金鼎-桃園,2023-04-27,9189
3035,智原,74,65,9,群益金鼎-桃園,2023-04-27,9189
2615,萬海,10,1,9,群益金鼎-桃園,2023-04-27,9189
4566,時碩工業,17,8,9,群益金鼎-桃園,2023-04-27,9189
2880,華南金,800,7,793,群益金鼎-桃園,2023-04-28,9189
2867,三商壽,400,0,400,群益金鼎-桃園,2023-04-28,9189
2359,所羅門,53,1,52,群益金鼎-桃園,2023-04-28,9189
00878,國泰永續高股息,58,7,51,群益金鼎-桃園,2023-04-28,9189
2409,友達,51,4,47,群益金鼎-桃園,2023-04-28,9189
1905,華紙,60,13,47,群益金鼎-桃園,2023-04-28,9189
00680L,元大美債20正2,42,0,42,群益金鼎-桃園,2023-04-28,9189
2344,華邦電,36,2,34,群益金鼎-桃園,2023-04-28,9189
00671R,富邦NASDAQ反1,30,0,30,群益金鼎-桃園,2023-04-28,9189
2882,國泰金,31,3,28,群益金鼎-桃園,2023-04-28,9189
1721,三晃,26,0,26,群益金鼎-桃園,2023-04-28,9189
3231,緯創,54,29,25,群益金鼎-桃園,2023-04-28,9189
4108,懷特,22,0,22,群益金鼎-桃園,2023-04-28,9189
3071,協禧,50,30,20,群益金鼎-桃園,2023-04-28,9189
4129,聯合,20,0,20,群益金鼎-桃園,2023-04-28,9189
1815,富喬,20,0,20,群益金鼎-桃園,2023-04-28,9189
2881,富邦金,22,2,20,群益金鼎-桃園,2023-04-28,9189
5009,榮剛,40,21,19,群益金鼎-桃園,2023-04-28,9189
00772B,中信高評級公司債,17,0,17,群益金鼎-桃園,2023-04-28,9189
1727,中華化,65,48,17,群益金鼎-桃園,2023-04-28,9189
2903,遠百,17,0,17,群益金鼎-桃園,2023-04-28,9189
2515,中工,22,5,17,群益金鼎-桃園,2023-04-28,9189
6535,順藥,14,0,14,群益金鼎-桃園,2023-04-28,9189
4931,新盛力,14,0,14,群益金鼎-桃園,2023-04-28,9189
00679B,元大美債20年,13,0,13,群益金鼎-桃園,2023-04-28,9189
4114,健喬,17,4,13,群益金鼎-桃園,2023-04-28,9189
00795B,中信美國公債20年,12,0,12,群益金鼎-桃園,2023-04-28,9189
1504,東元,20,9,11,群益金鼎-桃園,2023-04-28,9189
00900,富邦特選高股息30,11,0,11,群益金鼎-桃園,2023-04-28,9189
3704,合勤控,18,8,10,群益金鼎-桃園,2023-04-28,9189
3481,群創,10,0,10,群益金鼎-桃園,2023-04-28,9189
5512,力麒,10,0,10,群益金鼎-桃園,2023-04-28,9189
6147,頎邦,10,0,10,群益金鼎-桃園,2023-04-28,9189
3419,譁裕,14,4,10,群益金鼎-桃園,2023-04-28,9189
6182,合晶,10,0,10,群益金鼎-桃園,2023-04-28,9189
1731,美吾華,15,5,10,群益金鼎-桃園,2023-04-28,9189
3712,永崴投控,10,0,10,群益金鼎-桃園,2023-04-28,9189
2429,銘旺科,10,0,10,群益金鼎-桃園,2023-04-28,9189
1101,台泥,25,16,9,群益金鼎-桃園,2023-04-28,9189
1104,環泥,11,2,9,群益金鼎-桃園,2023-04-28,9189
8110,華東,10,1,9,群益金鼎-桃園,2023-04-28,9189
4121,優盛,12,3,9,群益金鼎-桃園,2023-04-28,9189
0050,元大台灣50,9,1,8,群益金鼎-桃園,2023-04-28,9189
2449,京元電子,8,0,8,群益金鼎-桃園,2023-04-28,9189
3081,聯亞,8,0,8,群益金鼎-桃園,2023-04-28,9189
2349,錸德,8,0,8,群益金鼎-桃園,2023-04-28,9189
8171,天宇,8,0,8,群益金鼎-桃園,2023-04-28,9189
6244,茂迪,11,3,8,群益金鼎-桃園,2023-04-28,9189
3664,安瑞-KY,8,0,8,群益金鼎-桃園,2023-04-28,9189
2007,燁興,8,0,8,群益金鼎-桃園,2023-04-28,9189
2867,三商壽,200,1,199,群益金鼎-桃園,2023-05-02,9189
8234,新漢,100,0,100,群益金鼎-桃園,2023-05-02,9189
4111,濟生,70,6,64,群益金鼎-桃園,2023-05-02,9189
2883B,凱基金乙特,50,0,50,群益金鼎-桃園,2023-05-02,9189
00632R,元大台灣50反1,56,7,49,群益金鼎-桃園,2023-05-02,9189
2603,長榮,51,3,48,群益金鼎-桃園,2023-05-02,9189
1314,中石化,46,0,46,群益金鼎-桃園,2023-05-02,9189
1727,中華化,58,12,46,群益金鼎-桃園,2023-05-02,9189
6282,康舒,48,2,46,群益金鼎-桃園,2023-05-02,9189
00715L,期街口布蘭特正2,59,15,44,群益金鼎-桃園,2023-05-02,9189
6116,彩晶,40,0,40,群益金鼎-桃園,2023-05-02,9189
5009,榮剛,37,1,36,群益金鼎-桃園,2023-05-02,9189
00680L,元大美債20正2,33,0,33,群益金鼎-桃園,2023-05-02,9189
00753L,中信中國50正2,52,23,29,群益金鼎-桃園,2023-05-02,9189
6770,力積電,37,13,24,群益金鼎-桃園,2023-05-02,9189
00772B,中信高評級公司債,24,0,24,群益金鼎-桃園,2023-05-02,9189
2534,宏盛,20,0,20,群益金鼎-桃園,2023-05-02,9189
00671R,富邦NASDAQ反1,20,0,20,群益金鼎-桃園,2023-05-02,9189
3325,旭品,20,0,20,群益金鼎-桃園,2023-05-02,9189
1734,杏輝,20,0,20,群益金鼎-桃園,2023-05-02,9189
5381,合正,20,0,20,群益金鼎-桃園,2023-05-02,9189
5701,劍湖山,20,0,20,群益金鼎-桃園,2023-05-02,9189
4916,事欣科,61,43,18,群益金鼎-桃園,2023-05-02,9189
6185,幃翔,20,2,18,群益金鼎-桃園,2023-05-02,9189
2402,毅嘉,21,3,18,群益金鼎-桃園,2023-05-02,9189
6111,大宇資,36,19,17,群益金鼎-桃園,2023-05-02,9189
8403,盛弘,18,1,17,群益金鼎-桃園,2023-05-02,9189
2413,環科,32,16,16,群益金鼎-桃園,2023-05-02,9189
6167,久正,17,2,15,群益金鼎-桃園,2023-05-02,9189
6443,元晶,15,2,13,群益金鼎-桃園,2023-05-02,9189
6190,萬泰科,20,7,13,群益金鼎-桃園,2023-05-02,9189
00882,中信中國高股息,12,0,12,群益金鼎-桃園,2023-05-02,9189
2308,台達電,13,2,11,群益金鼎-桃園,2023-05-02,9189
2884,玉山金,11,0,11,群益金鼎-桃園,2023-05-02,9189
2482,連宇,43,32,11,群益金鼎-桃園,2023-05-02,9189
1720,生達,15,4,11,群益金鼎-桃園,2023-05-02,9189
3419,譁裕,25,15,10,群益金鼎-桃園,2023-05-02,9189
2609,陽明,14,4,10,群益金鼎-桃園,2023-05-02,9189
2323,中環,10,0,10,群益金鼎-桃園,2023-05-02,9189
2022,聚亨,10,0,10,群益金鼎-桃園,2023-05-02,9189
2324,仁寶,10,0,10,群益金鼎-桃園,2023-05-02,9189
4173,久裕,10,0,10,群益金鼎-桃園,2023-05-02,9189
00706L,期元大S＆P日圓正2,10,0,10,群益金鼎-桃園,2023-05-02,9189
2429,銘旺科,10,0,10,群益金鼎-桃園,2023-05-02,9189
911868,同方友友-DR,11,1,10,群益金鼎-桃園,2023-05-02,9189
1460,宏遠,10,0,10,群益金鼎-桃園,2023-05-02,9189
1584,精剛,10,1,9,群益金鼎-桃園,2023-05-02,9189
00720B,元大投資級公司債,9,0,9,群益金鼎-桃園,2023-05-02,9189
2471,資通,51,42,9,群益金鼎-桃園,2023-05-02,9189
00751B,元大AAA至A公司債,9,0,9,群益金鼎-桃園,2023-05-02,9189
2867,三商壽,100,0,100,群益金鼎-桃園,2023-05-03,9189
00715L,期街口布蘭特正2,76,0,76,群益金鼎-桃園,2023-05-03,9189
3231,緯創,58,5,53,群益金鼎-桃園,2023-05-03,9189
00637L,元大滬深300正2,47,4,43,群益金鼎-桃園,2023-05-03,9189
2603,長榮,38,1,37,群益金鼎-桃園,2023-05-03,9189
00878,國泰永續高股息,75,42,33,群益金鼎-桃園,2023-05-03,9189
00712,復華富時不動產,32,0,32,群益金鼎-桃園,2023-05-03,9189
00706L,期元大S＆P日圓正2,30,0,30,群益金鼎-桃園,2023-05-03,9189
1905,華紙,87,61,26,群益金鼎-桃園,2023-05-03,9189
9933,中鼎,25,0,25,群益金鼎-桃園,2023-05-03,9189
2609,陽明,36,11,25,群益金鼎-桃園,2023-05-03,9189
6167,久正,67,44,23,群益金鼎-桃園,2023-05-03,9189
6111,大宇資,33,10,23,群益金鼎-桃園,2023-05-03,9189
2812,台中銀,22,0,22,群益金鼎-桃園,2023-05-03,9189
4915,致伸,22,1,21,群益金鼎-桃園,2023-05-03,9189
9955,佳龍,21,2,19,群益金鼎-桃園,2023-05-03,9189
1514,亞力,38,20,18,群益金鼎-桃園,2023-05-03,9189
1314,中石化,17,0,17,群益金鼎-桃園,2023-05-03,9189
2634,漢翔,62,46,16,群益金鼎-桃園,2023-05-03,9189
2352,佳世達,21,6,15,群益金鼎-桃園,2023-05-03,9189
1529,樂事綠能,18,3,15,群益金鼎-桃園,2023-05-03,9189
00650L,復華香港正2,15,0,15,群益金鼎-桃園,2023-05-03,9189
3522,御嵿,15,0,15,群益金鼎-桃園,2023-05-03,9189
2402,毅嘉,16,2,14,群益金鼎-桃園,2023-05-03,9189
3032,偉訓,27,13,14,群益金鼎-桃園,2023-05-03,9189
2002,中鋼,15,2,13,群益金鼎-桃園,2023-05-03,9189
6116,彩晶,13,0,13,群益金鼎-桃園,2023-05-03,9189
6185,幃翔,12,0,12,群益金鼎-桃園,2023-05-03,9189
4109,加捷生醫,15,3,12,群益金鼎-桃園,2023-05-03,9189
1524,耿鼎,12,0,12,群益金鼎-桃園,2023-05-03,9189
2368,金像電,15,4,11,群益金鼎-桃園,2023-05-03,9189
2201,裕隆,12,1,11,群益金鼎-桃園,2023-05-03,9189
4121,優盛,24,14,10,群益金鼎-桃園,2023-05-03,9189
00671R,富邦NASDAQ反1,10,0,10,群益金鼎-桃園,2023-05-03,9189
5475,德宏,10,0,10,群益金鼎-桃園,2023-05-03,9189
2243,宏旭-KY,10,0,10,群益金鼎-桃園,2023-05-03,9189
2637,慧洋-KY,10,0,10,群益金鼎-桃園,2023-05-03,9189
6532,瑞耘,10,0,10,群益金鼎-桃園,2023-05-03,9189
3078,僑威,35,25,10,群益金鼎-桃園,2023-05-03,9189
6282,康舒,11,1,10,群益金鼎-桃園,2023-05-03,9189
3006,晶豪科,9,0,9,群益金鼎-桃園,2023-05-03,9189
6234,高僑,36,27,9,群益金鼎-桃園,2023-05-03,9189
2313,華通,11,2,9,群益金鼎-桃園,2023-05-03,9189
2206,三陽工業,17,8,9,群益金鼎-桃園,2023-05-03,9189
1513,中興電,25,16,9,群益金鼎-桃園,2023-05-03,9189
8222,寶一,23,14,9,群益金鼎-桃園,2023-05-03,9189
2417,圓剛,8,0,8,群益金鼎-桃園,2023-05-03,9189
6180,橘子,8,0,8,群益金鼎-桃園,2023-05-03,9189
4566,時碩工業,13,5,8,群益金鼎-桃園,2023-05-03,9189
2457,飛宏,32,24,8,群益金鼎-桃園,2023-05-03,9189
00715L,期街口布蘭特正2,216,6,210,群益金鼎-桃園,2023-05-04,9189
2867,三商壽,200,0,200,群益金鼎-桃園,2023-05-04,9189
4911,德英,115,1,114,群益金鼎-桃園,2023-05-04,9189
3715,定穎投控,81,18,63,群益金鼎-桃園,2023-05-04,9189
1608,華榮,36,0,36,群益金鼎-桃園,2023-05-04,9189
00642U,期元大S＆P石油,32,0,32,群益金鼎-桃園,2023-05-04,9189
2313,華通,31,0,31,群益金鼎-桃園,2023-05-04,9189
00648R,元大S＆P500反1,30,0,30,群益金鼎-桃園,2023-05-04,9189
2457,飛宏,38,9,29,群益金鼎-桃園,2023-05-04,9189
00891,中信關鍵半導體,29,1,28,群益金鼎-桃園,2023-05-04,9189
2368,金像電,28,1,27,群益金鼎-桃園,2023-05-04,9189
4111,濟生,27,0,27,群益金鼎-桃園,2023-05-04,9189
3479,安勤,28,6,22,群益金鼎-桃園,2023-05-04,9189
00878,國泰永續高股息,24,2,22,群益金鼎-桃園,2023-05-04,9189
3006,晶豪科,23,1,22,群益金鼎-桃園,2023-05-04,9189
4129,聯合,21,0,21,群益金鼎-桃園,2023-05-04,9189
1314,中石化,20,0,20,群益金鼎-桃園,2023-05-04,9189
6152,百一,20,0,20,群益金鼎-桃園,2023-05-04,9189
2303,聯電,18,0,18,群益金鼎-桃園,2023-05-04,9189
3013,晟銘電,16,1,15,群益金鼎-桃園,2023-05-04,9189
00679B,元大美債20年,18,3,15,群益金鼎-桃園,2023-05-04,9189
6112,邁達特,31,17,14,群益金鼎-桃園,2023-05-04,9189
1734,杏輝,54,40,14,群益金鼎-桃園,2023-05-04,9189
1514,亞力,16,4,12,群益金鼎-桃園,2023-05-04,9189
6116,彩晶,12,0,12,群益金鼎-桃園,2023-05-04,9189
2881,富邦金,11,0,11,群益金鼎-桃園,2023-05-04,9189
6142,友勁,10,0,10,群益金鼎-桃園,2023-05-04,9189
9958,世紀鋼,10,0,10,群益金鼎-桃園,2023-05-04,9189
3481,群創,12,2,10,群益金鼎-桃園,2023-05-04,9189
2489,瑞軒,17,8,9,群益金鼎-桃園,2023-05-04,9189
3231,緯創,60,51,9,群益金鼎-桃園,2023-05-04,9189
00690,兆豐藍籌30,9,0,9,群益金鼎-桃園,2023-05-04,9189
6234,高僑,21,12,9,群益金鼎-桃園,2023-05-04,9189
8086,宏捷科,9,0,9,群益金鼎-桃園,2023-05-04,9189
1710,東聯,9,0,9,群益金鼎-桃園,2023-05-04,9189
6148,驊宏資,92,83,9,群益金鼎-桃園,2023-05-04,9189
3037,欣興,12,3,9,群益金鼎-桃園,2023-05-04,9189
2201,裕隆,8,0,8,群益金鼎-桃園,2023-05-04,9189
3005,神基,9,1,8,群益金鼎-桃園,2023-05-04,9189
6712,長聖,14,6,8,群益金鼎-桃園,2023-05-04,9189
4968,立積,9,1,8,群益金鼎-桃園,2023-05-04,9189
3209,全科,7,0,7,群益金鼎-桃園,2023-05-04,9189
5309,系統電,8,1,7,群益金鼎-桃園,2023-05-04,9189
2615,萬海,9,2,7,群益金鼎-桃園,2023-05-04,9189
3673,TPK-KY,17,10,7,群益金鼎-桃園,2023-05-04,9189
6114,久威,6,0,6,群益金鼎-桃園,2023-05-04,9189
6111,大宇資,32,26,6,群益金鼎-桃園,2023-05-04,9189
6288,聯嘉,6,0,6,群益金鼎-桃園,2023-05-04,9189
8222,寶一,31,25,6,群益金鼎-桃園,2023-05-04,9189
6209,今國光,8,2,6,群益金鼎-桃園,2023-05-04,9189
1528,恩德,200,5,195,群益金鼎-桃園,2023-05-05,9189
2634,漢翔,82,24,58,群益金鼎-桃園,2023-05-05,9189
00632R,元大台灣50反1,50,0,50,群益金鼎-桃園,2023-05-05,9189
00878,國泰永續高股息,53,5,48,群益金鼎-桃園,2023-05-05,9189
2358,廷鑫,40,0,40,群益金鼎-桃園,2023-05-05,9189
3663,鑫科,46,6,40,群益金鼎-桃園,2023-05-05,9189
00715L,期街口布蘭特正2,39,5,34,群益金鼎-桃園,2023-05-05,9189
6142,友勁,30,0,30,群益金鼎-桃園,2023-05-05,9189
3094,聯傑,25,0,25,群益金鼎-桃園,2023-05-05,9189
2515,中工,24,0,24,群益金鼎-桃園,2023-05-05,9189
00712,復華富時不動產,32,10,22,群益金鼎-桃園,2023-05-05,9189
1609,大亞,69,47,22,群益金鼎-桃園,2023-05-05,9189
6218,豪勉,24,3,21,群益金鼎-桃園,2023-05-05,9189
4173,久裕,20,0,20,群益金鼎-桃園,2023-05-05,9189
2903,遠百,20,0,20,群益金鼎-桃園,2023-05-05,9189
2885,元大金,20,0,20,群益金鼎-桃園,2023-05-05,9189
1605,華新,25,5,20,群益金鼎-桃園,2023-05-05,9189
4129,聯合,22,3,19,群益金鼎-桃園,2023-05-05,9189
3356,奇偶,22,3,19,群益金鼎-桃園,2023-05-05,9189
1504,東元,90,71,19,群益金鼎-桃園,2023-05-05,9189
1905,華紙,24,6,18,群益金鼎-桃園,2023-05-05,9189
2457,飛宏,20,2,18,群益金鼎-桃園,2023-05-05,9189
2882,國泰金,20,3,17,群益金鼎-桃園,2023-05-05,9189
1909,榮成,20,3,17,群益金鼎-桃園,2023-05-05,9189
6244,茂迪,22,5,17,群益金鼎-桃園,2023-05-05,9189
2344,華邦電,25,9,16,群益金鼎-桃園,2023-05-05,9189
2609,陽明,20,4,16,群益金鼎-桃園,2023-05-05,9189
8215,明基材,19,4,15,群益金鼎-桃園,2023-05-05,9189
1584,精剛,20,5,15,群益金鼎-桃園,2023-05-05,9189
9933,中鼎,15,0,15,群益金鼎-桃園,2023-05-05,9189
5356,協益,19,6,13,群益金鼎-桃園,2023-05-05,9189
00751B,元大AAA至A公司債,12,0,12,群益金鼎-桃園,2023-05-05,9189
2031,新光鋼,12,0,12,群益金鼎-桃園,2023-05-05,9189
6527,明達醫,13,1,12,群益金鼎-桃園,2023-05-05,9189
4909,新復興,11,0,11,群益金鼎-桃園,2023-05-05,9189
6191,精成科,69,58,11,群益金鼎-桃園,2023-05-05,9189
6573,虹揚-KY,10,0,10,群益金鼎-桃園,2023-05-05,9189
00642U,期元大S＆P石油,10,0,10,群益金鼎-桃園,2023-05-05,9189
5285,界霖,10,0,10,群益金鼎-桃園,2023-05-05,9189
00830,國泰費城半導體,11,1,10,群益金鼎-桃園,2023-05-05,9189
3093,港建*,10,0,10,群益金鼎-桃園,2023-05-05,9189
2913,農林,10,0,10,群益金鼎-桃園,2023-05-05,9189
2547,日勝生,10,0,10,群益金鼎-桃園,2023-05-05,9189
5608,四維航,10,0,10,群益金鼎-桃園,2023-05-05,9189
6134,萬旭,10,0,10,群益金鼎-桃園,2023-05-05,9189
00713,元大台灣高息低波,9,0,9,群益金鼎-桃園,2023-05-05,9189
6770,力積電,10,1,9,群益金鼎-桃園,2023-05-05,9189
00725B,國泰投資級公司債,9,0,9,群益金鼎-桃園,2023-05-05,9189
8463,潤泰材,9,0,9,群益金鼎-桃園,2023-05-05,9189
1783,和康生,11,2,9,群益金鼎-桃園,2023-05-05,9189
00632R,元大台灣50反1,424,0,424,群益金鼎-桃園,2023-05-08,9189
8403,盛弘,205,2,203,群益金鼎-桃園,2023-05-08,9189
911868,同方友友-DR,215,33,182,群益金鼎-桃園,2023-05-08,9189
00715L,期街口布蘭特正2,104,28,76,群益金鼎-桃園,2023-05-08,9189
2883B,凱基金乙特,75,0,75,群益金鼎-桃園,2023-05-08,9189
1605,華新,76,10,66,群益金鼎-桃園,2023-05-08,9189
00680L,元大美債20正2,58,0,58,群益金鼎-桃園,2023-05-08,9189
00679B,元大美債20年,59,1,58,群益金鼎-桃園,2023-05-08,9189
2887,台新金,100,45,55,群益金鼎-桃園,2023-05-08,9189
9105,泰金寶-DR,47,0,47,群益金鼎-桃園,2023-05-08,9189
00878,國泰永續高股息,59,12,47,群益金鼎-桃園,2023-05-08,9189
2408,南亞科,41,1,40,群益金鼎-桃園,2023-05-08,9189
2883,凱基金,48,17,31,群益金鼎-桃園,2023-05-08,9189
2812,台中銀,31,0,31,群益金鼎-桃園,2023-05-08,9189
3481,群創,31,3,28,群益金鼎-桃園,2023-05-08,9189
1720,生達,31,4,27,群益金鼎-桃園,2023-05-08,9189
3042,晶技,25,0,25,群益金鼎-桃園,2023-05-08,9189
3013,晟銘電,27,2,25,群益金鼎-桃園,2023-05-08,9189
1314,中石化,29,5,24,群益金鼎-桃園,2023-05-08,9189
00725B,國泰投資級公司債,23,0,23,群益金鼎-桃園,2023-05-08,9189
3029,零壹,52,29,23,群益金鼎-桃園,2023-05-08,9189
3715,定穎投控,45,24,21,群益金鼎-桃園,2023-05-08,9189
3663,鑫科,20,0,20,群益金鼎-桃園,2023-05-08,9189
1708,東鹼,20,0,20,群益金鼎-桃園,2023-05-08,9189
3714,富采,18,0,18,群益金鼎-桃園,2023-05-08,9189
2352,佳世達,19,2,17,群益金鼎-桃園,2023-05-08,9189
4173,久裕,35,18,17,群益金鼎-桃園,2023-05-08,9189
3264,欣銓,15,0,15,群益金鼎-桃園,2023-05-08,9189
5483,中美晶,18,3,15,群益金鼎-桃園,2023-05-08,9189
6443,元晶,18,4,14,群益金鼎-桃園,2023-05-08,9189
1721,三晃,13,0,13,群益金鼎-桃園,2023-05-08,9189
2609,陽明,29,16,13,群益金鼎-桃園,2023-05-08,9189
8033,雷虎,21,8,13,群益金鼎-桃園,2023-05-08,9189
6180,橘子,15,2,13,群益金鼎-桃園,2023-05-08,9189
2208,台船,12,0,12,群益金鼎-桃園,2023-05-08,9189
9962,有益,21,9,12,群益金鼎-桃園,2023-05-08,9189
9958,世紀鋼,12,0,12,群益金鼎-桃園,2023-05-08,9189
2482,連宇,14,2,12,群益金鼎-桃園,2023-05-08,9189
00687B,國泰20年美債,11,0,11,群益金鼎-桃園,2023-05-08,9189
6129,普誠,11,0,11,群益金鼎-桃園,2023-05-08,9189
1513,中興電,40,30,10,群益金鼎-桃園,2023-05-08,9189
6116,彩晶,10,0,10,群益金鼎-桃園,2023-05-08,9189
8105,凌巨,10,0,10,群益金鼎-桃園,2023-05-08,9189
3051,力特,10,0,10,群益金鼎-桃園,2023-05-08,9189
3682,亞太電,10,0,10,群益金鼎-桃園,2023-05-08,9189
4702,中美實,10,0,10,群益金鼎-桃園,2023-05-08,9189
3305,昇貿,10,0,10,群益金鼎-桃園,2023-05-08,9189
1218,泰山,24,14,10,群益金鼎-桃園,2023-05-08,9189
1467,南緯,10,0,10,群益金鼎-桃園,2023-05-08,9189
6134,萬旭,10,0,10,群益金鼎-桃園,2023-05-08,9189
911868,同方友友-DR,185,0,185,群益金鼎-桃園,2023-05-09,9189
00680L,元大美債20正2,85,0,85,群益金鼎-桃園,2023-05-09,9189
9105,泰金寶-DR,53,0,53,群益金鼎-桃園,2023-05-09,9189
4911,德英,50,0,50,群益金鼎-桃園,2023-05-09,9189
3290,東浦,45,1,44,群益金鼎-桃園,2023-05-09,9189
5907,大洋-KY,40,0,40,群益金鼎-桃園,2023-05-09,9189
3027,盛達,40,4,36,群益金鼎-桃園,2023-05-09,9189
00772B,中信高評級公司債,34,0,34,群益金鼎-桃園,2023-05-09,9189
1513,中興電,61,31,30,群益金鼎-桃園,2023-05-09,9189
4919,新唐,30,0,30,群益金鼎-桃園,2023-05-09,9189
00751B,元大AAA至A公司債,27,0,27,群益金鼎-桃園,2023-05-09,9189
00687B,國泰20年美債,26,0,26,群益金鼎-桃園,2023-05-09,9189
00679B,元大美債20年,25,0,25,群益金鼎-桃園,2023-05-09,9189
1316,上曜,25,0,25,群益金鼎-桃園,2023-05-09,9189
6244,茂迪,28,4,24,群益金鼎-桃園,2023-05-09,9189
2913,農林,28,5,23,群益金鼎-桃園,2023-05-09,9189
3014,聯陽,28,5,23,群益金鼎-桃園,2023-05-09,9189
3576,聯合再生,30,7,23,群益金鼎-桃園,2023-05-09,9189
3664,安瑞-KY,23,1,22,群益金鼎-桃園,2023-05-09,9189
2409,友達,113,91,22,群益金鼎-桃園,2023-05-09,9189
8926,台汽電,24,3,21,群益金鼎-桃園,2023-05-09,9189
00795B,中信美國公債20年,20,0,20,群益金鼎-桃園,2023-05-09,9189
1605,華新,29,9,20,群益金鼎-桃園,2023-05-09,9189
3149,正達,20,0,20,群益金鼎-桃園,2023-05-09,9189
2618,長榮航,28,8,20,群益金鼎-桃園,2023-05-09,9189
1101,台泥,23,4,19,群益金鼎-桃園,2023-05-09,9189
00720B,元大投資級公司債,19,0,19,群益金鼎-桃園,2023-05-09,9189
3078,僑威,21,2,19,群益金鼎-桃園,2023-05-09,9189
4114,健喬,20,1,19,群益金鼎-桃園,2023-05-09,9189
6443,元晶,21,3,18,群益金鼎-桃園,2023-05-09,9189
6167,久正,18,0,18,群益金鼎-桃園,2023-05-09,9189
1612,宏泰,19,2,17,群益金鼎-桃園,2023-05-09,9189
2421,建準,29,13,16,群益金鼎-桃園,2023-05-09,9189
2887,台新金,19,3,16,群益金鼎-桃園,2023-05-09,9189
8933,愛地雅,15,0,15,群益金鼎-桃園,2023-05-09,9189
4726,永昕,20,5,15,群益金鼎-桃園,2023-05-09,9189
006208,富邦台50,15,0,15,群益金鼎-桃園,2023-05-09,9189
00641R,富邦日本反1,15,0,15,群益金鼎-桃園,2023-05-09,9189
1310,台苯,15,0,15,群益金鼎-桃園,2023-05-09,9189
1504,東元,88,73,15,群益金鼎-桃園,2023-05-09,9189
3715,定穎投控,42,28,14,群益金鼎-桃園,2023-05-09,9189
4768,晶呈科技,14,0,14,群益金鼎-桃園,2023-05-09,9189
00773B,中信優先金融債,12,0,12,群益金鼎-桃園,2023-05-09,9189
00632R,元大台灣50反1,39,27,12,群益金鼎-桃園,2023-05-09,9189
8436,大江,12,1,11,群益金鼎-桃園,2023-05-09,9189
3017,奇鋐,16,5,11,群益金鼎-桃園,2023-05-09,9189
1529,樂事綠能,18,7,11,群益金鼎-桃園,2023-05-09,9189
6245,立端,12,1,11,群益金鼎-桃園,2023-05-09,9189
6282,康舒,13,3,10,群益金鼎-桃園,2023-05-09,9189
2355,敬鵬,10,0,10,群益金鼎-桃園,2023-05-09,9189
00878,國泰永續高股息,227,102,125,群益金鼎-桃園,2023-05-10,9189
3325,旭品,105,0,105,群益金鼎-桃園,2023-05-10,9189
00715L,期街口布蘭特正2,74,19,55,群益金鼎-桃園,2023-05-10,9189
00680L,元大美債20正2,47,0,47,群益金鼎-桃園,2023-05-10,9189
3231,緯創,64,25,39,群益金鼎-桃園,2023-05-10,9189
3013,晟銘電,41,3,38,群益金鼎-桃園,2023-05-10,9189
2834,臺企銀,30,0,30,群益金鼎-桃園,2023-05-10,9189
00753L,中信中國50正2,28,0,28,群益金鼎-桃園,2023-05-10,9189
3027,盛達,26,0,26,群益金鼎-桃園,2023-05-10,9189
6160,欣技,27,3,24,群益金鼎-桃園,2023-05-10,9189
00637L,元大滬深300正2,25,1,24,群益金鼎-桃園,2023-05-10,9189
6276,安鈦克,34,12,22,群益金鼎-桃園,2023-05-10,9189
00687B,國泰20年美債,21,0,21,群益金鼎-桃園,2023-05-10,9189
6167,久正,21,0,21,群益金鼎-桃園,2023-05-10,9189
6213,聯茂,20,0,20,群益金鼎-桃園,2023-05-10,9189
1905,華紙,34,14,20,群益金鼎-桃園,2023-05-10,9189
00679B,元大美債20年,19,0,19,群益金鼎-桃園,2023-05-10,9189
5608,四維航,19,0,19,群益金鼎-桃園,2023-05-10,9189
1101,台泥,17,0,17,群益金鼎-桃園,2023-05-10,9189
2303,聯電,23,6,17,群益金鼎-桃園,2023-05-10,9189
1609,大亞,39,22,17,群益金鼎-桃園,2023-05-10,9189
2402,毅嘉,16,1,15,群益金鼎-桃園,2023-05-10,9189
00650L,復華香港正2,14,0,14,群益金鼎-桃園,2023-05-10,9189
5309,系統電,16,2,14,群益金鼎-桃園,2023-05-10,9189
6125,廣運,13,0,13,群益金鼎-桃園,2023-05-10,9189
6625,必應,15,2,13,群益金鼎-桃園,2023-05-10,9189
2356,英業達,12,0,12,群益金鼎-桃園,2023-05-10,9189
3202,樺晟,14,2,12,群益金鼎-桃園,2023-05-10,9189
1815,富喬,11,0,11,群益金鼎-桃園,2023-05-10,9189
6282,康舒,10,0,10,群益金鼎-桃園,2023-05-10,9189
4564,元翎,10,0,10,群益金鼎-桃園,2023-05-10,9189
8933,愛地雅,10,0,10,群益金鼎-桃園,2023-05-10,9189
6432,今展科,10,0,10,群益金鼎-桃園,2023-05-10,9189
5353,台林,10,0,10,群益金鼎-桃園,2023-05-10,9189
3664,安瑞-KY,10,0,10,群益金鼎-桃園,2023-05-10,9189
6548,長科*,10,0,10,群益金鼎-桃園,2023-05-10,9189
0056,元大高股息,24,15,9,群益金鼎-桃園,2023-05-10,9189
1584,精剛,9,0,9,群益金鼎-桃園,2023-05-10,9189
8222,寶一,18,11,7,群益金鼎-桃園,2023-05-10,9189
2330,台積電,7,0,7,群益金鼎-桃園,2023-05-10,9189
3078,僑威,7,0,7,群益金鼎-桃園,2023-05-10,9189
5425,台半,7,0,7,群益金鼎-桃園,2023-05-10,9189
1611,中電,11,4,7,群益金鼎-桃園,2023-05-10,9189
3005,神基,7,0,7,群益金鼎-桃園,2023-05-10,9189
8436,大江,7,1,6,群益金鼎-桃園,2023-05-10,9189
3313,斐成,6,0,6,群益金鼎-桃園,2023-05-10,9189
9939,宏全,7,1,6,群益金鼎-桃園,2023-05-10,9189
3047,訊舟,8,2,6,群益金鼎-桃園,2023-05-10,9189
4931,新盛力,11,5,6,群益金鼎-桃園,2023-05-10,9189
2344,華邦電,8,2,6,群益金鼎-桃園,2023-05-10,9189
2368,金像電,72,0,72,群益金鼎-桃園,2023-05-11,9189
2542,興富發,70,7,63,群益金鼎-桃園,2023-05-11,9189
4919,新唐,48,2,46,群益金鼎-桃園,2023-05-11,9189
00680L,元大美債20正2,42,0,42,群益金鼎-桃園,2023-05-11,9189
6285,啟��,38,4,34,群益金鼎-桃園,2023-05-11,9189
2313,華通,32,0,32,群益金鼎-桃園,2023-05-11,9189
2610,華航,43,12,31,群益金鼎-桃園,2023-05-11,9189
6142,友勁,30,4,26,群益金鼎-桃園,2023-05-11,9189
00753L,中信中國50正2,44,20,24,群益金鼎-桃園,2023-05-11,9189
2409,友達,35,13,22,群益金鼎-桃園,2023-05-11,9189
9907,統一實,34,12,22,群益金鼎-桃園,2023-05-11,9189
6806,森崴能源,26,5,21,群益金鼎-桃園,2023-05-11,9189
1108,幸福,23,2,21,群益金鼎-桃園,2023-05-11,9189
00891,中信關鍵半導體,20,0,20,群益金鼎-桃園,2023-05-11,9189
3037,欣興,23,3,20,群益金鼎-桃園,2023-05-11,9189
6116,彩晶,19,0,19,群益金鼎-桃園,2023-05-11,9189
8446,華研,19,0,19,群益金鼎-桃園,2023-05-11,9189
00878,國泰永續高股息,39,21,18,群益金鼎-桃園,2023-05-11,9189
8924,大田,16,0,16,群益金鼎-桃園,2023-05-11,9189
3664,安瑞-KY,16,0,16,群益金鼎-桃園,2023-05-11,9189
1795,美時,43,27,16,群益金鼎-桃園,2023-05-11,9189
3323,加百裕,15,0,15,群益金鼎-桃園,2023-05-11,9189
2472,立隆電,14,0,14,群益金鼎-桃園,2023-05-11,9189
1802,台玻,14,0,14,群益金鼎-桃園,2023-05-11,9189
1905,華紙,27,14,13,群益金鼎-桃園,2023-05-11,9189
3027,盛達,15,2,13,群益金鼎-桃園,2023-05-11,9189
3693,營邦,13,0,13,群益金鼎-桃園,2023-05-11,9189
5388,中磊,14,1,13,群益金鼎-桃園,2023-05-11,9189
6274,台燿,12,0,12,群益金鼎-桃園,2023-05-11,9189
3202,樺晟,13,1,12,群益金鼎-桃園,2023-05-11,9189
8933,愛地雅,12,0,12,群益金鼎-桃園,2023-05-11,9189
3322,建舜電,12,0,12,群益金鼎-桃園,2023-05-11,9189
5009,榮剛,13,1,12,群益金鼎-桃園,2023-05-11,9189
2618,長榮航,92,81,11,群益金鼎-桃園,2023-05-11,9189
1605,華新,16,5,11,群益金鼎-桃園,2023-05-11,9189
3481,群創,27,16,11,群益金鼎-桃園,2023-05-11,9189
8390,金益鼎,11,0,11,群益金鼎-桃園,2023-05-11,9189
6213,聯茂,11,0,11,群益金鼎-桃園,2023-05-11,9189
2228,劍麟,10,0,10,群益金鼎-桃園,2023-05-11,9189
1452,宏益,10,0,10,群益金鼎-桃園,2023-05-11,9189
6160,欣技,14,4,10,群益金鼎-桃園,2023-05-11,9189
1789,神隆,10,0,10,群益金鼎-桃園,2023-05-11,9189
5511,德昌,10,0,10,群益金鼎-桃園,2023-05-11,9189
3094,聯傑,10,0,10,群益金鼎-桃園,2023-05-11,9189
2031,新光鋼,10,0,10,群益金鼎-桃園,2023-05-11,9189
2534,宏盛,10,0,10,群益金鼎-桃園,2023-05-11,9189
2603,長榮,9,0,9,群益金鼎-桃園,2023-05-11,9189
00772B,中信高評級公司債,9,0,9,群益金鼎-桃園,2023-05-11,9189
00662,富邦NASDAQ,9,0,9,群益金鼎-桃園,2023-05-11,9189
1504,東元,64,55,9,群益金鼎-桃園,2023-05-11,9189
6005,群益證,60,2,58,群益金鼎-桃園,2023-05-12,9189
3481,群創,53,2,51,群益金鼎-桃園,2023-05-12,9189
00878,國泰永續高股息,60,9,51,群益金鼎-桃園,2023-05-12,9189
2888,新光金,56,10,46,群益金鼎-桃園,2023-05-12,9189
2368,金像電,46,0,46,群益金鼎-桃園,2023-05-12,9189
00642U,期元大S＆P石油,34,3,31,群益金鼎-桃園,2023-05-12,9189
2317,鴻海,29,0,29,群益金鼎-桃園,2023-05-12,9189
8076,伍豐,26,1,25,群益金鼎-桃園,2023-05-12,9189
6191,精成科,25,0,25,群益金鼎-桃園,2023-05-12,9189
00715L,期街口布蘭特正2,53,32,21,群益金鼎-桃園,2023-05-12,9189
4919,新唐,20,0,20,群益金鼎-桃園,2023-05-12,9189
2337,旺宏,20,0,20,群益金鼎-桃園,2023-05-12,9189
2313,華通,21,1,20,群益金鼎-桃園,2023-05-12,9189
6109,亞元,20,1,19,群益金鼎-桃園,2023-05-12,9189
1101,台泥,20,1,19,群益金鼎-桃園,2023-05-12,9189
8011,台通,18,0,18,群益金鼎-桃園,2023-05-12,9189
6285,啟��,22,4,18,群益金鼎-桃園,2023-05-12,9189
2883,凱基金,17,0,17,群益金鼎-桃園,2023-05-12,9189
0056,元大高股息,16,2,14,群益金鼎-桃園,2023-05-12,9189
4439,冠星-KY,14,0,14,群益金鼎-桃園,2023-05-12,9189
1314,中石化,14,0,14,群益金鼎-桃園,2023-05-12,9189
2886,兆豐金,13,0,13,群益金鼎-桃園,2023-05-12,9189
3202,樺晟,15,2,13,群益金鼎-桃園,2023-05-12,9189
1560,中砂,13,0,13,群益金鼎-桃園,2023-05-12,9189
6129,普誠,12,0,12,群益金鼎-桃園,2023-05-12,9189
2890,永豐金,12,0,12,群益金鼎-桃園,2023-05-12,9189
2031,新光鋼,13,1,12,群益金鼎-桃園,2023-05-12,9189
00637L,元大滬深300正2,15,3,12,群益金鼎-桃園,2023-05-12,9189
1608,華榮,11,0,11,群益金鼎-桃園,2023-05-12,9189
1310,台苯,11,0,11,群益金鼎-桃園,2023-05-12,9189
4934,太極,10,0,10,群益金鼎-桃園,2023-05-12,9189
2409,友達,12,2,10,群益金鼎-桃園,2023-05-12,9189
3005,神基,11,1,10,群益金鼎-桃園,2023-05-12,9189
5009,榮剛,11,1,10,群益金鼎-桃園,2023-05-12,9189
6134,萬旭,10,0,10,群益金鼎-桃園,2023-05-12,9189
2891,中信金,10,0,10,群益金鼎-桃園,2023-05-12,9189
3013,晟銘電,10,1,9,群益金鼎-桃園,2023-05-12,9189
6125,廣運,9,0,9,群益金鼎-桃園,2023-05-12,9189
3596,智易,10,1,9,群益金鼎-桃園,2023-05-12,9189
6101,寬魚國際,8,0,8,群益金鼎-桃園,2023-05-12,9189
1108,幸福,7,0,7,群益金鼎-桃園,2023-05-12,9189
2014,中鴻,7,0,7,群益金鼎-桃園,2023-05-12,9189
4979,華星光,15,8,7,群益金鼎-桃園,2023-05-12,9189
4744,皇將,10,3,7,群益金鼎-桃園,2023-05-12,9189
6116,彩晶,6,0,6,群益金鼎-桃園,2023-05-12,9189
3664,安瑞-KY,6,0,6,群益金鼎-桃園,2023-05-12,9189
00675L,富邦臺灣加權正2,6,0,6,群益金鼎-桃園,2023-05-12,9189
3576,聯合再生,6,0,6,群益金鼎-桃園,2023-05-12,9189
5483,中美晶,6,0,6,群益金鼎-桃園,2023-05-12,9189
4106,雃博,6,0,6,群益金鼎-桃園,2023-05-12,9189
2489,瑞軒,150,9,141,群益金鼎-桃園,2023-05-15,9189
2303,聯電,70,0,70,群益金鼎-桃園,2023-05-15,9189
00642U,期元大S＆P石油,62,0,62,群益金鼎-桃園,2023-05-15,9189
00878,國泰永續高股息,64,19,45,群益金鼎-桃園,2023-05-15,9189
4919,新唐,41,1,40,群益金鼎-桃園,2023-05-15,9189
00637L,元大滬深300正2,74,42,32,群益金鼎-桃園,2023-05-15,9189
9955,佳龍,25,1,24,群益金鼎-桃園,2023-05-15,9189
2883,凱基金,34,11,23,群益金鼎-桃園,2023-05-15,9189
3231,緯創,32,11,21,群益金鼎-桃園,2023-05-15,9189
4533,協易機,21,0,21,群益金鼎-桃園,2023-05-15,9189
00715L,期街口布蘭特正2,24,3,21,群益金鼎-桃園,2023-05-15,9189
6122,擎邦,29,9,20,群益金鼎-桃園,2023-05-15,9189
8446,華研,23,4,19,群益金鼎-桃園,2023-05-15,9189
00882,中信中國高股息,18,1,17,群益金鼎-桃園,2023-05-15,9189
2353,宏��,17,1,16,群益金鼎-桃園,2023-05-15,9189
1409,新纖,16,0,16,群益金鼎-桃園,2023-05-15,9189
3105,穩懋,16,0,16,群益金鼎-桃園,2023-05-15,9189
2317,鴻海,17,2,15,群益金鼎-桃園,2023-05-15,9189
9958,世紀鋼,15,0,15,群益金鼎-桃園,2023-05-15,9189
1504,東元,244,231,13,群益金鼎-桃園,2023-05-15,9189
6185,幃翔,12,0,12,群益金鼎-桃園,2023-05-15,9189
2542,興富發,13,1,12,群益金鼎-桃園,2023-05-15,9189
3078,僑威,12,1,11,群益金鼎-桃園,2023-05-15,9189
3002,歐格,15,4,11,群益金鼎-桃園,2023-05-15,9189
6589,台康生技,11,0,11,群益金鼎-桃園,2023-05-15,9189
6147,頎邦,11,0,11,群益金鼎-桃園,2023-05-15,9189
2455,全新,10,0,10,群益金鼎-桃園,2023-05-15,9189
1733,五鼎,10,0,10,群益金鼎-桃園,2023-05-15,9189
00650L,復華香港正2,10,0,10,群益金鼎-桃園,2023-05-15,9189
3325,旭品,12,2,10,群益金鼎-桃園,2023-05-15,9189
2419,仲琦,10,0,10,群益金鼎-桃園,2023-05-15,9189
2888,新光金,10,0,10,群益金鼎-桃園,2023-05-15,9189
00895,富邦未來車,10,0,10,群益金鼎-桃園,2023-05-15,9189
3596,智易,10,0,10,群益金鼎-桃園,2023-05-15,9189
00753L,中信中國50正2,10,0,10,群益金鼎-桃園,2023-05-15,9189
1460,宏遠,10,0,10,群益金鼎-桃園,2023-05-15,9189
6109,亞元,10,0,10,群益金鼎-桃園,2023-05-15,9189
2482,連宇,10,1,9,群益金鼎-桃園,2023-05-15,9189
00923,群益台ESG低碳50,9,0,9,群益金鼎-桃園,2023-05-15,9189
4121,優盛,11,3,8,群益金鼎-桃園,2023-05-15,9189
0056,元大高股息,8,0,8,群益金鼎-桃園,2023-05-15,9189
2344,華邦電,8,0,8,群益金鼎-桃園,2023-05-15,9189
3038,全台,8,0,8,群益金鼎-桃園,2023-05-15,9189
00900,富邦特選高股息30,7,0,7,群益金鼎-桃園,2023-05-15,9189
1101,台泥,8,1,7,群益金鼎-桃園,2023-05-15,9189
5490,同亨,7,0,7,群益金鼎-桃園,2023-05-15,9189
00680L,元大美債20正2,7,0,7,群益金鼎-桃園,2023-05-15,9189
1609,大亞,19,12,7,群益金鼎-桃園,2023-05-15,9189
00720B,元大投資級公司債,6,0,6,群益金鼎-桃園,2023-05-15,9189
5907,大洋-KY,6,0,6,群益金鼎-桃園,2023-05-15,9189
00680L,元大美債20正2,196,0,196,群益金鼎-桃園,2023-05-16,9189
00632R,元大台灣50反1,102,8,94,群益金鼎-桃園,2023-05-16,9189
2313,華通,64,1,63,群益金鼎-桃園,2023-05-16,9189
00878,國泰永續高股息,132,80,52,群益金鼎-桃園,2023-05-16,9189
2323,中環,54,10,44,群益金鼎-桃園,2023-05-16,9189
8234,新漢,40,0,40,群益金鼎-桃園,2023-05-16,9189
2368,金像電,36,0,36,群益金鼎-桃園,2023-05-16,9189
8930,青鋼,40,4,36,群益金鼎-桃園,2023-05-16,9189
00751B,元大AAA至A公司債,36,0,36,群益金鼎-桃園,2023-05-16,9189
2534,宏盛,29,0,29,群益金鼎-桃園,2023-05-16,9189
1905,華紙,34,6,28,群益金鼎-桃園,2023-05-16,9189
4303,信立,26,0,26,群益金鼎-桃園,2023-05-16,9189
5009,榮剛,26,2,24,群益金鼎-桃園,2023-05-16,9189
00772B,中信高評級公司債,23,0,23,群益金鼎-桃園,2023-05-16,9189
1504,東元,135,112,23,群益金鼎-桃園,2023-05-16,9189
2538,基泰,22,0,22,群益金鼎-桃園,2023-05-16,9189
00679B,元大美債20年,23,1,22,群益金鼎-桃園,2023-05-16,9189
2427,三商電,103,82,21,群益金鼎-桃園,2023-05-16,9189
3483,力致,20,0,20,群益金鼎-桃園,2023-05-16,9189
1806,冠軍,20,0,20,群益金鼎-桃園,2023-05-16,9189
00687B,國泰20年美債,20,0,20,群益金鼎-桃園,2023-05-16,9189
1560,中砂,20,1,19,群益金鼎-桃園,2023-05-16,9189
4934,太極,18,0,18,群益金鼎-桃園,2023-05-16,9189
2409,友達,17,0,17,群益金鼎-桃園,2023-05-16,9189
2603,長榮,17,1,16,群益金鼎-桃園,2023-05-16,9189
3013,晟銘電,26,11,15,群益金鼎-桃園,2023-05-16,9189
5225,東科-KY,12,0,12,群益金鼎-桃園,2023-05-16,9189
1513,中興電,13,1,12,群益金鼎-桃園,2023-05-16,9189
2399,映泰,12,0,12,群益金鼎-桃園,2023-05-16,9189
2883B,凱基金乙特,12,0,12,群益金鼎-桃園,2023-05-16,9189
3202,樺晟,16,5,11,群益金鼎-桃園,2023-05-16,9189
5425,台半,12,1,11,群益金鼎-桃園,2023-05-16,9189
00720B,元大投資級公司債,11,1,10,群益金鼎-桃園,2023-05-16,9189
3236,千如,10,0,10,群益金鼎-桃園,2023-05-16,9189
6153,嘉聯益,10,0,10,群益金鼎-桃園,2023-05-16,9189
1309,台達化,10,0,10,群益金鼎-桃園,2023-05-16,9189
6721,信實,10,0,10,群益金鼎-桃園,2023-05-16,9189
6142,友勁,10,0,10,群益金鼎-桃園,2023-05-16,9189
6806,森崴能源,10,0,10,群益金鼎-桃園,2023-05-16,9189
9105,泰金寶-DR,10,0,10,群益金鼎-桃園,2023-05-16,9189
2736,富野,37,28,9,群益金鼎-桃園,2023-05-16,9189
1609,大亞,15,6,9,群益金鼎-桃園,2023-05-16,9189
6418,詠昇,12,3,9,群益金鼎-桃園,2023-05-16,9189
00664R,國泰臺灣加權反1,8,0,8,群益金鼎-桃園,2023-05-16,9189
3231,緯創,16,8,8,群益金鼎-桃園,2023-05-16,9189
6477,安集,8,0,8,群益金鼎-桃園,2023-05-16,9189
8081,致新,8,0,8,群益金鼎-桃園,2023-05-16,9189
6712,長聖,8,1,7,群益金鼎-桃園,2023-05-16,9189
6165,浪凡,7,0,7,群益金鼎-桃園,2023-05-16,9189
8426,紅木-KY,18,11,7,群益金鼎-桃園,2023-05-16,9189
00632R,元大台灣50反1,371,0,371,群益金鼎-桃園,2023-05-17,9189
2887,台新金,100,42,58,群益金鼎-桃園,2023-05-17,9189
00637L,元大滬深300正2,45,0,45,群益金鼎-桃園,2023-05-17,9189
6285,啟��,41,0,41,群益金鼎-桃園,2023-05-17,9189
1337,再生-KY,31,0,31,群益金鼎-桃園,2023-05-17,9189
00878,國泰永續高股息,49,18,31,群益金鼎-桃園,2023-05-17,9189
00882,中信中國高股息,27,0,27,群益金鼎-桃園,2023-05-17,9189
00715L,期街口布蘭特正2,27,2,25,群益金鼎-桃園,2023-05-17,9189
4950,牧東,23,0,23,群益金鼎-桃園,2023-05-17,9189
00680L,元大美債20正2,22,0,22,群益金鼎-桃園,2023-05-17,9189
3715,定穎投控,28,6,22,群益金鼎-桃園,2023-05-17,9189
3483,力致,20,0,20,群益金鼎-桃園,2023-05-17,9189
9919,康那香,20,0,20,群益金鼎-桃園,2023-05-17,9189
2377,微星,21,1,20,群益金鼎-桃園,2023-05-17,9189
2734,易飛網,21,2,19,群益金鼎-桃園,2023-05-17,9189
00712,復華富時不動產,18,0,18,群益金鼎-桃園,2023-05-17,9189
2402,毅嘉,76,59,17,群益金鼎-桃園,2023-05-17,9189
3013,晟銘電,28,11,17,群益金鼎-桃園,2023-05-17,9189
2903,遠百,17,0,17,群益金鼎-桃園,2023-05-17,9189
2331,精英,16,0,16,群益金鼎-桃園,2023-05-17,9189
00664R,國泰臺灣加權反1,16,0,16,群益金鼎-桃園,2023-05-17,9189
00720B,元大投資級公司債,15,0,15,群益金鼎-桃園,2023-05-17,9189
00686R,群益臺灣加權反1,15,0,15,群益金鼎-桃園,2023-05-17,9189
00772B,中信高評級公司債,15,0,15,群益金鼎-桃園,2023-05-17,9189
1727,中華化,15,2,13,群益金鼎-桃園,2023-05-17,9189
00751B,元大AAA至A公司債,13,0,13,群益金鼎-桃園,2023-05-17,9189
2634,漢翔,20,8,12,群益金鼎-桃園,2023-05-17,9189
3707,漢磊,11,0,11,群益金鼎-桃園,2023-05-17,9189
1503,士電,11,0,11,群益金鼎-桃園,2023-05-17,9189
2034,允強,11,0,11,群益金鼎-桃園,2023-05-17,9189
2538,基泰,10,0,10,群益金鼎-桃園,2023-05-17,9189
1904,正隆,10,0,10,群益金鼎-桃園,2023-05-17,9189
8936,國統,10,0,10,群益金鼎-桃園,2023-05-17,9189
2340,台亞,10,0,10,群益金鼎-桃園,2023-05-17,9189
3034,聯詠,10,0,10,群益金鼎-桃園,2023-05-17,9189
2603,長榮,10,0,10,群益金鼎-桃園,2023-05-17,9189
8446,華研,15,6,9,群益金鼎-桃園,2023-05-17,9189
3011,今皓,10,2,8,群益金鼎-桃園,2023-05-17,9189
1326,台化,11,3,8,群益金鼎-桃園,2023-05-17,9189
2313,華通,7,0,7,群益金鼎-桃園,2023-05-17,9189
3002,歐格,10,3,7,群益金鼎-桃園,2023-05-17,9189
2204,中華,19,12,7,群益金鼎-桃園,2023-05-17,9189
3504,揚明光,9,2,7,群益金鼎-桃園,2023-05-17,9189
6691,洋基工程,6,0,6,群益金鼎-桃園,2023-05-17,9189
3479,安勤,13,7,6,群益金鼎-桃園,2023-05-17,9189
6112,邁達特,13,7,6,群益金鼎-桃園,2023-05-17,9189
2495,普安,6,0,6,群益金鼎-桃園,2023-05-17,9189
3202,樺晟,6,0,6,群益金鼎-桃園,2023-05-17,9189
00650L,復華香港正2,6,0,6,群益金鼎-桃園,2023-05-17,9189
5351,鈺創,10,4,6,群益金鼎-桃園,2023-05-17,9189
00674R,期元大S＆P黃金反1,200,0,200,群益金鼎-桃園,2023-05-18,9189
00680L,元大美債20正2,101,0,101,群益金鼎-桃園,2023-05-18,9189
2409,友達,55,0,55,群益金鼎-桃園,2023-05-18,9189
3481,群創,60,10,50,群益金鼎-桃園,2023-05-18,9189
3056,富華新,43,0,43,群益金鼎-桃園,2023-05-18,9189
8234,新漢,42,5,37,群益金鼎-桃園,2023-05-18,9189
6163,華電網,36,0,36,群益金鼎-桃園,2023-05-18,9189
00712,復華富時不動產,36,0,36,群益金鼎-桃園,2023-05-18,9189
2371,大同,57,23,34,群益金鼎-桃園,2023-05-18,9189
4123,晟德,31,0,31,群益金鼎-桃園,2023-05-18,9189
1314,中石化,36,5,31,群益金鼎-桃園,2023-05-18,9189
00690,兆豐藍籌30,30,0,30,群益金鼎-桃園,2023-05-18,9189
6122,擎邦,48,23,25,群益金鼎-桃園,2023-05-18,9189
00671R,富邦NASDAQ反1,25,1,24,群益金鼎-桃園,2023-05-18,9189
00882,中信中國高股息,22,0,22,群益金鼎-桃園,2023-05-18,9189
00679B,元大美債20年,21,0,21,群益金鼎-桃園,2023-05-18,9189
2427,三商電,24,3,21,群益金鼎-桃園,2023-05-18,9189
3325,旭品,20,1,19,群益金鼎-桃園,2023-05-18,9189
8050,廣積,18,0,18,群益金鼎-桃園,2023-05-18,9189
4744,皇將,34,17,17,群益金鼎-桃園,2023-05-18,9189
2630,亞航,39,23,16,群益金鼎-桃園,2023-05-18,9189
6443,元晶,17,1,16,群益金鼎-桃園,2023-05-18,9189
8933,愛地雅,15,0,15,群益金鼎-桃園,2023-05-18,9189
1609,大亞,50,35,15,群益金鼎-桃園,2023-05-18,9189
00706L,期元大S＆P日圓正2,15,0,15,群益金鼎-桃園,2023-05-18,9189
6244,茂迪,29,14,15,群益金鼎-桃園,2023-05-18,9189
00687B,國泰20年美債,14,0,14,群益金鼎-桃園,2023-05-18,9189
3046,建��,14,0,14,群益金鼎-桃園,2023-05-18,9189
8069,元太,13,0,13,群益金鼎-桃園,2023-05-18,9189
1904,正隆,12,0,12,群益金鼎-桃園,2023-05-18,9189
2801,彰銀,12,0,12,群益金鼎-桃園,2023-05-18,9189
3043,科風,20,8,12,群益金鼎-桃園,2023-05-18,9189
00720B,元大投資級公司債,13,1,12,群益金鼎-桃園,2023-05-18,9189
9955,佳龍,11,0,11,群益金鼎-桃園,2023-05-18,9189
00664R,國泰臺灣加權反1,12,2,10,群益金鼎-桃園,2023-05-18,9189
1522,堤維西,10,0,10,群益金鼎-桃園,2023-05-18,9189
1529,樂事綠能,30,20,10,群益金鼎-桃園,2023-05-18,9189
00641R,富邦日本反1,10,0,10,群益金鼎-桃園,2023-05-18,9189
6697,東捷資訊,10,0,10,群益金鼎-桃園,2023-05-18,9189
4104,佳醫,10,0,10,群益金鼎-桃園,2023-05-18,9189
3058,立德,17,7,10,群益金鼎-桃園,2023-05-18,9189
2328,廣宇,16,6,10,群益金鼎-桃園,2023-05-18,9189
9933,中鼎,10,0,10,群益金鼎-桃園,2023-05-18,9189
2332,友訊,12,2,10,群益金鼎-桃園,2023-05-18,9189
6142,友勁,10,0,10,群益金鼎-桃園,2023-05-18,9189
2614,東森,10,0,10,群益金鼎-桃園,2023-05-18,9189
00631L,元大台灣50正2,10,1,9,群益金鼎-桃園,2023-05-18,9189
1101,台泥,10,1,9,群益金鼎-桃園,2023-05-18,9189
00751B,元大AAA至A公司債,9,1,8,群益金鼎-桃園,2023-05-18,9189
8033,雷虎,8,0,8,群益金鼎-桃園,2023-05-18,9189
2409,友達,1500,57,1443,群益金鼎-桃園,2023-05-19,9189
00632R,元大台灣50反1,388,0,388,群益金鼎-桃園,2023-05-19,9189
00680L,元大美債20正2,54,0,54,群益金鼎-桃園,2023-05-19,9189
00753L,中信中國50正2,46,0,46,群益金鼎-桃園,2023-05-19,9189
00687B,國泰20年美債,43,0,43,群益金鼎-桃園,2023-05-19,9189
1734,杏輝,42,0,42,群益金鼎-桃園,2023-05-19,9189
3029,零壹,46,13,33,群益金鼎-桃園,2023-05-19,9189
2332,友訊,44,15,29,群益金鼎-桃園,2023-05-19,9189
00706L,期元大S＆P日圓正2,27,0,27,群益金鼎-桃園,2023-05-19,9189
3141,晶宏,26,0,26,群益金鼎-桃園,2023-05-19,9189
00882,中信中國高股息,26,0,26,群益金鼎-桃園,2023-05-19,9189
5009,榮剛,54,31,23,群益金鼎-桃園,2023-05-19,9189
6288,聯嘉,55,33,22,群益金鼎-桃園,2023-05-19,9189
1905,華紙,26,5,21,群益金鼎-桃園,2023-05-19,9189
2457,飛宏,29,8,21,群益金鼎-桃園,2023-05-19,9189
00772B,中信高評級公司債,20,0,20,群益金鼎-桃園,2023-05-19,9189
9943,好樂迪,21,1,20,群益金鼎-桃園,2023-05-19,9189
2208,台船,20,0,20,群益金鼎-桃園,2023-05-19,9189
1524,耿鼎,20,0,20,群益金鼎-桃園,2023-05-19,9189
00708L,期元大S＆P黃金正2,25,5,20,群益金鼎-桃園,2023-05-19,9189
00715L,期街口布蘭特正2,21,1,20,群益金鼎-桃園,2023-05-19,9189
2442,新美齊,20,1,19,群益金鼎-桃園,2023-05-19,9189
3479,安勤,24,6,18,群益金鼎-桃園,2023-05-19,9189
00637L,元大滬深300正2,51,33,18,群益金鼎-桃園,2023-05-19,9189
1609,大亞,26,9,17,群益金鼎-桃園,2023-05-19,9189
6443,元晶,17,1,16,群益金鼎-桃園,2023-05-19,9189
4130,健亞,15,0,15,群益金鼎-桃園,2023-05-19,9189
1519,華城,38,24,14,群益金鼎-桃園,2023-05-19,9189
00655L,國泰中國A50正2,13,0,13,群益金鼎-桃園,2023-05-19,9189
4931,新盛力,28,15,13,群益金鼎-桃園,2023-05-19,9189
3014,聯陽,15,2,13,群益金鼎-桃園,2023-05-19,9189
2731,雄獅,13,0,13,群益金鼎-桃園,2023-05-19,9189
4744,皇將,13,0,13,群益金鼎-桃園,2023-05-19,9189
6234,高僑,18,5,13,群益金鼎-桃園,2023-05-19,9189
9955,佳龍,12,0,12,群益金鼎-桃園,2023-05-19,9189
00751B,元大AAA至A公司債,11,0,11,群益金鼎-桃園,2023-05-19,9189
1314,中石化,11,0,11,群益金鼎-桃園,2023-05-19,9189
2402,毅嘉,16,5,11,群益金鼎-桃園,2023-05-19,9189
1904,正隆,11,1,10,群益金鼎-桃園,2023-05-19,9189
2331,精英,10,0,10,群益金鼎-桃園,2023-05-19,9189
2538,基泰,10,0,10,群益金鼎-桃園,2023-05-19,9189
4153,鈺緯,10,0,10,群益金鼎-桃園,2023-05-19,9189
2302,麗正,10,0,10,群益金鼎-桃園,2023-05-19,9189
5483,中美晶,10,0,10,群益金鼎-桃園,2023-05-19,9189
4163,鐿鈦,16,6,10,群益金鼎-桃園,2023-05-19,9189
00690,兆豐藍籌30,10,0,10,群益金鼎-桃園,2023-05-19,9189
3704,合勤控,35,25,10,群益金鼎-桃園,2023-05-19,9189
6182,合晶,10,0,10,群益金鼎-桃園,2023-05-19,9189
2603,長榮,13,3,10,群益金鼎-桃園,2023-05-19,9189
1605,華新,25,16,9,群益金鼎-桃園,2023-05-19,9189
3518,柏騰,181,0,181,群益金鼎-桃園,2023-05-22,9189
3481,群創,117,11,106,群益金鼎-桃園,2023-05-22,9189
00715L,期街口布蘭特正2,74,5,69,群益金鼎-桃園,2023-05-22,9189
1314,中石化,61,1,60,群益金鼎-桃園,2023-05-22,9189
6153,嘉聯益,50,0,50,群益金鼎-桃園,2023-05-22,9189
2303,聯電,53,8,45,群益金鼎-桃園,2023-05-22,9189
3032,偉訓,63,22,41,群益金鼎-桃園,2023-05-22,9189
5324,士開,38,0,38,群益金鼎-桃園,2023-05-22,9189
00671R,富邦NASDAQ反1,30,0,30,群益金鼎-桃園,2023-05-22,9189
00687B,國泰20年美債,31,1,30,群益金鼎-桃園,2023-05-22,9189
1608,華榮,66,38,28,群益金鼎-桃園,2023-05-22,9189
00751B,元大AAA至A公司債,25,0,25,群益金鼎-桃園,2023-05-22,9189
2344,華邦電,34,10,24,群益金鼎-桃園,2023-05-22,9189
2888,新光金,25,1,24,群益金鼎-桃園,2023-05-22,9189
2442,新美齊,25,2,23,群益金鼎-桃園,2023-05-22,9189
5905,南仁湖,20,0,20,群益金鼎-桃園,2023-05-22,9189
6188,廣明,21,2,19,群益金鼎-桃園,2023-05-22,9189
1609,大亞,54,35,19,群益金鼎-桃園,2023-05-22,9189
6235,華孚,32,15,17,群益金鼎-桃園,2023-05-22,9189
2438,翔耀,17,0,17,群益金鼎-桃園,2023-05-22,9189
00882,中信中國高股息,17,0,17,群益金鼎-桃園,2023-05-22,9189
3037,欣興,23,8,15,群益金鼎-桃園,2023-05-22,9189
2206,三陽工業,22,8,14,群益金鼎-桃園,2023-05-22,9189
4908,前鼎,15,1,14,群益金鼎-桃園,2023-05-22,9189
3105,穩懋,18,5,13,群益金鼎-桃園,2023-05-22,9189
00680L,元大美債20正2,12,0,12,群益金鼎-桃園,2023-05-22,9189
2890,永豐金,12,0,12,群益金鼎-桃園,2023-05-22,9189
3419,譁裕,12,0,12,群益金鼎-桃園,2023-05-22,9189
5398,慕康生醫,11,0,11,群益金鼎-桃園,2023-05-22,9189
5258,虹堡,14,3,11,群益金鼎-桃園,2023-05-22,9189
5469,瀚宇博,11,0,11,群益金鼎-桃園,2023-05-22,9189
5284,jpp-KY,11,1,10,群益金鼎-桃園,2023-05-22,9189
1905,華紙,17,7,10,群益金鼎-桃園,2023-05-22,9189
6283,淳安,10,0,10,群益金鼎-桃園,2023-05-22,9189
00706L,期元大S＆P日圓正2,10,0,10,群益金鼎-桃園,2023-05-22,9189
8478,東哥遊艇,13,3,10,群益金鼎-桃園,2023-05-22,9189
2634,漢翔,26,16,10,群益金鼎-桃園,2023-05-22,9189
2329,華泰,10,0,10,群益金鼎-桃園,2023-05-22,9189
3231,緯創,26,17,9,群益金鼎-桃園,2023-05-22,9189
3558,神準,9,0,9,群益金鼎-桃園,2023-05-22,9189
2421,建準,22,13,9,群益金鼎-桃園,2023-05-22,9189
6111,大宇資,10,1,9,群益金鼎-桃園,2023-05-22,9189
00679B,元大美債20年,8,0,8,群益金鼎-桃園,2023-05-22,9189
3290,東浦,7,0,7,群益金鼎-桃園,2023-05-22,9189
3205,佰研,10,3,7,群益金鼎-桃園,2023-05-22,9189
2382,廣達,9,2,7,群益金鼎-桃園,2023-05-22,9189
2356,英業達,6,0,6,群益金鼎-桃園,2023-05-22,9189
1734,杏輝,6,0,6,群益金鼎-桃園,2023-05-22,9189
2482,連宇,8,2,6,群益金鼎-桃園,2023-05-22,9189
3017,奇鋐,7,1,6,群益金鼎-桃園,2023-05-22,9189
2890,永豐金,654,13,641,群益金鼎-桃園,2023-05-23,9189
00632R,元大台灣50反1,132,2,130,群益金鼎-桃園,2023-05-23,9189
3518,柏騰,90,0,90,群益金鼎-桃園,2023-05-23,9189
00680L,元大美債20正2,51,0,51,群益金鼎-桃園,2023-05-23,9189
5880,合庫金,50,2,48,群益金鼎-桃園,2023-05-23,9189
1513,中興電,99,52,47,群益金鼎-桃園,2023-05-23,9189
00882,中信中國高股息,30,0,30,群益金鼎-桃園,2023-05-23,9189
2208,台船,30,0,30,群益金鼎-桃園,2023-05-23,9189
1314,中石化,28,0,28,群益金鼎-桃園,2023-05-23,9189
1609,大亞,41,13,28,群益金鼎-桃園,2023-05-23,9189
2313,華通,31,3,28,群益金鼎-桃園,2023-05-23,9189
00637L,元大滬深300正2,44,20,24,群益金鼎-桃園,2023-05-23,9189
00687B,國泰20年美債,23,0,23,群益金鼎-桃園,2023-05-23,9189
3058,立德,31,8,23,群益金鼎-桃園,2023-05-23,9189
2359,所羅門,21,0,21,群益金鼎-桃園,2023-05-23,9189
3231,緯創,53,33,20,群益金鼎-桃園,2023-05-23,9189
1904,正隆,21,1,20,群益金鼎-桃園,2023-05-23,9189
2356,英業達,21,1,20,群益金鼎-桃園,2023-05-23,9189
8926,台汽電,20,1,19,群益金鼎-桃園,2023-05-23,9189
2409,友達,20,2,18,群益金鼎-桃園,2023-05-23,9189
1504,東元,38,22,16,群益金鼎-桃園,2023-05-23,9189
2888,新光金,19,4,15,群益金鼎-桃園,2023-05-23,9189
2739,寒舍,16,1,15,群益金鼎-桃園,2023-05-23,9189
2303,聯電,17,4,13,群益金鼎-桃園,2023-05-23,9189
3022,威強電,22,10,12,群益金鼎-桃園,2023-05-23,9189
4173,久裕,13,1,12,群益金鼎-桃園,2023-05-23,9189
2630,亞航,12,0,12,群益金鼎-桃園,2023-05-23,9189
4763,材料-KY,14,3,11,群益金鼎-桃園,2023-05-23,9189
1605,華新,10,0,10,群益金鼎-桃園,2023-05-23,9189
2634,漢翔,39,29,10,群益金鼎-桃園,2023-05-23,9189
2030,彰源,10,0,10,群益金鼎-桃園,2023-05-23,9189
2706,第一店,10,0,10,群益金鼎-桃園,2023-05-23,9189
5324,士開,10,0,10,群益金鼎-桃園,2023-05-23,9189
5347,世界,10,0,10,群益金鼎-桃園,2023-05-23,9189
5512,力麒,10,0,10,群益金鼎-桃園,2023-05-23,9189
6446,藥華藥,13,4,9,群益金鼎-桃園,2023-05-23,9189
6112,邁達特,34,25,9,群益金鼎-桃園,2023-05-23,9189
3002,歐格,11,2,9,群益金鼎-桃園,2023-05-23,9189
00902,中信電池及儲能,11,2,9,群益金鼎-桃園,2023-05-23,9189
6218,豪勉,12,3,9,群益金鼎-桃園,2023-05-23,9189
2344,華邦電,9,0,9,群益金鼎-桃園,2023-05-23,9189
00706L,期元大S＆P日圓正2,8,0,8,群益金鼎-桃園,2023-05-23,9189
4744,皇將,10,2,8,群益金鼎-桃園,2023-05-23,9189
2453,凌群,9,1,8,群益金鼎-桃園,2023-05-23,9189
2332,友訊,9,1,8,群益金鼎-桃園,2023-05-23,9189
2025,千興,8,0,8,群益金鼎-桃園,2023-05-23,9189
2701,萬企,18,10,8,群益金鼎-桃園,2023-05-23,9189
4541,晟田,21,13,8,群益金鼎-桃園,2023-05-23,9189
3587,閎康,10,2,8,群益金鼎-桃園,2023-05-23,9189
4130,健亞,8,0,8,群益金鼎-桃園,2023-05-23,9189
2611,志信,110,10,100,群益金鼎-桃園,2023-05-24,9189
00882,中信中國高股息,86,0,86,群益金鼎-桃園,2023-05-24,9189
2739,寒舍,58,1,57,群益金鼎-桃園,2023-05-24,9189
00637L,元大滬深300正2,60,5,55,群益金鼎-桃園,2023-05-24,9189
5009,榮剛,78,33,45,群益金鼎-桃園,2023-05-24,9189
1616,億泰,43,0,43,群益金鼎-桃園,2023-05-24,9189
00655L,國泰中國A50正2,40,0,40,群益金鼎-桃園,2023-05-24,9189
1608,華榮,47,9,38,群益金鼎-桃園,2023-05-24,9189
2413,環科,30,0,30,群益金鼎-桃園,2023-05-24,9189
00680L,元大美債20正2,32,2,30,群益金鼎-桃園,2023-05-24,9189
3518,柏騰,30,0,30,群益金鼎-桃園,2023-05-24,9189
8176,智捷,27,0,27,群益金鼎-桃園,2023-05-24,9189
2890,永豐金,24,0,24,群益金鼎-桃園,2023-05-24,9189
6148,驊宏資,27,3,24,群益金鼎-桃園,2023-05-24,9189
2323,中環,37,15,22,群益金鼎-桃園,2023-05-24,9189
5701,劍湖山,20,0,20,群益金鼎-桃園,2023-05-24,9189
2913,農林,20,1,19,群益金鼎-桃園,2023-05-24,9189
2471,資通,19,0,19,群益金鼎-桃園,2023-05-24,9189
1513,中興電,87,69,18,群益金鼎-桃園,2023-05-24,9189
2645,長榮航太,20,2,18,群益金鼎-桃園,2023-05-24,9189
2313,華通,18,1,17,群益金鼎-桃園,2023-05-24,9189
1605,華新,18,2,16,群益金鼎-桃園,2023-05-24,9189
1809,中釉,65,49,16,群益金鼎-桃園,2023-05-24,9189
1504,東元,59,43,16,群益金鼎-桃園,2023-05-24,9189
1540,喬福,15,0,15,群益金鼎-桃園,2023-05-24,9189
5464,霖宏,16,1,15,群益金鼎-桃園,2023-05-24,9189
3443,創意,17,3,14,群益金鼎-桃園,2023-05-24,9189
6163,華電網,15,1,14,群益金鼎-桃園,2023-05-24,9189
1904,正隆,15,1,14,群益金鼎-桃園,2023-05-24,9189
8446,華研,17,4,13,群益金鼎-桃園,2023-05-24,9189
2702,華園,15,2,13,群益金鼎-桃園,2023-05-24,9189
4919,新唐,13,0,13,群益金鼎-桃園,2023-05-24,9189
2206,三陽工業,16,3,13,群益金鼎-桃園,2023-05-24,9189
8926,台汽電,13,0,13,群益金鼎-桃園,2023-05-24,9189
5398,慕康生醫,12,0,12,群益金鼎-桃園,2023-05-24,9189
3701,大眾控,29,18,11,群益金鼎-桃園,2023-05-24,9189
3481,群創,11,0,11,群益金鼎-桃園,2023-05-24,9189
4564,元翎,37,26,11,群益金鼎-桃園,2023-05-24,9189
2442,新美齊,13,2,11,群益金鼎-桃園,2023-05-24,9189
3058,立德,14,3,11,群益金鼎-桃園,2023-05-24,9189
2812,台中銀,10,0,10,群益金鼎-桃園,2023-05-24,9189
6589,台康生技,10,0,10,群益金鼎-桃園,2023-05-24,9189
00679B,元大美債20年,29,19,10,群益金鼎-桃園,2023-05-24,9189
2537,聯上發,10,0,10,群益金鼎-桃園,2023-05-24,9189
2480,敦陽科,10,0,10,群益金鼎-桃園,2023-05-24,9189
1337,再生-KY,10,0,10,群益金鼎-桃園,2023-05-24,9189
3558,神準,16,7,9,群益金鼎-桃園,2023-05-24,9189
3363,上詮,12,3,9,群益金鼎-桃園,2023-05-24,9189
2314,台揚,10,1,9,群益金鼎-桃園,2023-05-24,9189
00772B,中信高評級公司債,10,1,9,群益金鼎-桃園,2023-05-24,9189
00632R,元大台灣50反1,276,30,246,群益金鼎-桃園,2023-05-25,9189
2618,長榮航,147,69,78,群益金鼎-桃園,2023-05-25,9189
00882,中信中國高股息,84,20,64,群益金鼎-桃園,2023-05-25,9189
3419,譁裕,68,9,59,群益金鼎-桃園,2023-05-25,9189
1609,大亞,59,11,48,群益金鼎-桃園,2023-05-25,9189
2371,大同,46,10,36,群益金鼎-桃園,2023-05-25,9189
1528,恩德,35,0,35,群益金鼎-桃園,2023-05-25,9189
2337,旺宏,30,0,30,群益金鼎-桃園,2023-05-25,9189
2610,華航,55,27,28,群益金鼎-桃園,2023-05-25,9189
3013,晟銘電,48,20,28,群益金鼎-桃園,2023-05-25,9189
00637L,元大滬深300正2,55,27,28,群益金鼎-桃園,2023-05-25,9189
4564,元翎,49,23,26,群益金鼎-桃園,2023-05-25,9189
2609,陽明,25,0,25,群益金鼎-桃園,2023-05-25,9189
00753L,中信中國50正2,35,10,25,群益金鼎-桃園,2023-05-25,9189
2002,中鋼,24,1,23,群益金鼎-桃園,2023-05-25,9189
6244,茂迪,37,15,22,群益金鼎-桃園,2023-05-25,9189
2890,永豐金,27,5,22,群益金鼎-桃園,2023-05-25,9189
1316,上曜,20,0,20,群益金鼎-桃園,2023-05-25,9189
00706L,期元大S＆P日圓正2,20,0,20,群益金鼎-桃園,2023-05-25,9189
00680L,元大美債20正2,19,0,19,群益金鼎-桃園,2023-05-25,9189
00751B,元大AAA至A公司債,18,0,18,群益金鼎-桃園,2023-05-25,9189
6446,藥華藥,21,4,17,群益金鼎-桃園,2023-05-25,9189
00673R,期元大S＆P原油反1,16,0,16,群益金鼎-桃園,2023-05-25,9189
3518,柏騰,16,0,16,群益金鼎-桃園,2023-05-25,9189
4552,力達-KY,16,0,16,群益金鼎-桃園,2023-05-25,9189
00679B,元大美債20年,17,2,15,群益金鼎-桃園,2023-05-25,9189
3141,晶宏,15,0,15,群益金鼎-桃園,2023-05-25,9189
2603,長榮,15,1,14,群益金鼎-桃園,2023-05-25,9189
2344,華邦電,31,17,14,群益金鼎-桃園,2023-05-25,9189
3046,建��,14,0,14,群益金鼎-桃園,2023-05-25,9189
2303,聯電,18,5,13,群益金鼎-桃園,2023-05-25,9189
00795B,中信美國公債20年,14,1,13,群益金鼎-桃園,2023-05-25,9189
2377,微星,14,2,12,群益金鼎-桃園,2023-05-25,9189
6274,台燿,24,12,12,群益金鼎-桃園,2023-05-25,9189
8049,晶采,11,0,11,群益金鼎-桃園,2023-05-25,9189
2637,慧洋-KY,15,4,11,群益金鼎-桃園,2023-05-25,9189
1513,中興電,41,31,10,群益金鼎-桃園,2023-05-25,9189
1314,中石化,10,0,10,群益金鼎-桃園,2023-05-25,9189
1589,永冠-KY,16,6,10,群益金鼎-桃園,2023-05-25,9189
2537,聯上發,10,0,10,群益金鼎-桃園,2023-05-25,9189
2739,寒舍,10,0,10,群益金鼎-桃園,2023-05-25,9189
6589,台康生技,10,0,10,群益金鼎-桃園,2023-05-25,9189
2301,光寶科,10,0,10,群益金鼎-桃園,2023-05-25,9189
1701,中化,10,0,10,群益金鼎-桃園,2023-05-25,9189
6170,統振,10,0,10,群益金鼎-桃園,2023-05-25,9189
6438,迅得,11,1,10,群益金鼎-桃園,2023-05-25,9189
5706,鳳凰,70,61,9,群益金鼎-桃園,2023-05-25,9189
2014,中鴻,10,1,9,群益金鼎-桃園,2023-05-25,9189
4915,致伸,19,10,9,群益金鼎-桃園,2023-05-25,9189
2427,三商電,11,3,8,群益金鼎-桃園,2023-05-25,9189
00632R,元大台灣50反1,321,0,321,群益金鼎-桃園,2023-05-26,9189
2511,太子,250,0,250,群益金鼎-桃園,2023-05-26,9189
2834,臺企銀,101,20,81,群益金鼎-桃園,2023-05-26,9189
5009,榮剛,111,32,79,群益金鼎-桃園,2023-05-26,9189
2883,凱基金,69,1,68,群益金鼎-桃園,2023-05-26,9189
00715L,期街口布蘭特正2,64,13,51,群益金鼎-桃園,2023-05-26,9189
1201,味全,50,0,50,群益金鼎-桃園,2023-05-26,9189
3518,柏騰,50,0,50,群益金鼎-桃園,2023-05-26,9189
00772B,中信高評級公司債,45,0,45,群益金鼎-桃園,2023-05-26,9189
2409,友達,35,0,35,群益金鼎-桃園,2023-05-26,9189
1326,台化,34,1,33,群益金鼎-桃園,2023-05-26,9189
00712,復華富時不動產,32,0,32,群益金鼎-桃園,2023-05-26,9189
5443,均豪,33,3,30,群益金鼎-桃園,2023-05-26,9189
3029,零壹,41,14,27,群益金鼎-桃園,2023-05-26,9189
2888,新光金,27,0,27,群益金鼎-桃園,2023-05-26,9189
2363,矽統,25,0,25,群益金鼎-桃園,2023-05-26,9189
1608,華榮,52,28,24,群益金鼎-桃園,2023-05-26,9189
1701,中化,23,0,23,群益金鼎-桃園,2023-05-26,9189
00680L,元大美債20正2,23,0,23,群益金鼎-桃園,2023-05-26,9189
2421,建準,67,45,22,群益金鼎-桃園,2023-05-26,9189
3265,台星科,23,2,21,群益金鼎-桃園,2023-05-26,9189
9955,佳龍,20,0,20,群益金鼎-桃園,2023-05-26,9189
1760,寶齡富錦,20,0,20,群益金鼎-桃園,2023-05-26,9189
2382,廣達,31,11,20,群益金鼎-桃園,2023-05-26,9189
2317,鴻海,20,1,19,群益金鼎-桃園,2023-05-26,9189
6005,群益證,19,0,19,群益金鼎-桃園,2023-05-26,9189
00882,中信中國高股息,17,0,17,群益金鼎-桃園,2023-05-26,9189
1314,中石化,17,0,17,群益金鼎-桃園,2023-05-26,9189
5243,乙盛-KY,23,7,16,群益金鼎-桃園,2023-05-26,9189
3287,廣寰科,16,0,16,群益金鼎-桃園,2023-05-26,9189
2882,國泰金,15,0,15,群益金鼎-桃園,2023-05-26,9189
00753L,中信中國50正2,15,0,15,群益金鼎-桃園,2023-05-26,9189
2441,超豐,16,1,15,群益金鼎-桃園,2023-05-26,9189
00795B,中信美國公債20年,14,0,14,群益金鼎-桃園,2023-05-26,9189
6124,業強,16,2,14,群益金鼎-桃園,2023-05-26,9189
3324,雙鴻,32,18,14,群益金鼎-桃園,2023-05-26,9189
2637,慧洋-KY,15,2,13,群益金鼎-桃園,2023-05-26,9189
00751B,元大AAA至A公司債,13,0,13,群益金鼎-桃園,2023-05-26,9189
3704,合勤控,14,1,13,群益金鼎-桃園,2023-05-26,9189
2457,飛宏,26,13,13,群益金鼎-桃園,2023-05-26,9189
2376,技嘉,42,30,12,群益金鼎-桃園,2023-05-26,9189
3576,聯合再生,12,0,12,群益金鼎-桃園,2023-05-26,9189
2453,凌群,20,8,12,群益金鼎-桃園,2023-05-26,9189
8926,台汽電,12,0,12,群益金鼎-桃園,2023-05-26,9189
2645,長榮航太,13,1,12,群益金鼎-桃園,2023-05-26,9189
00664R,國泰臺灣加權反1,12,1,11,群益金鼎-桃園,2023-05-26,9189
2609,陽明,14,3,11,群益金鼎-桃園,2023-05-26,9189
8403,盛弘,11,0,11,群益金鼎-桃園,2023-05-26,9189
3037,欣興,32,22,10,群益金鼎-桃園,2023-05-26,9189
3483,力致,41,31,10,群益金鼎-桃園,2023-05-26,9189
00632R,元大台灣50反1,298,25,273,群益金鼎-桃園,2023-05-29,9189
00882,中信中國高股息,87,7,80,群益金鼎-桃園,2023-05-29,9189
3706,神達,65,8,57,群益金鼎-桃園,2023-05-29,9189
00706L,期元大S＆P日圓正2,52,0,52,群益金鼎-桃園,2023-05-29,9189
2382,廣達,54,6,48,群益金鼎-桃園,2023-05-29,9189
2323,中環,66,23,43,群益金鼎-桃園,2023-05-29,9189
00680L,元大美債20正2,42,2,40,群益金鼎-桃園,2023-05-29,9189
00679B,元大美債20年,47,7,40,群益金鼎-桃園,2023-05-29,9189
3231,緯創,175,144,31,群益金鼎-桃園,2023-05-29,9189
3037,欣興,49,18,31,群益金鼎-桃園,2023-05-29,9189
2425,承啟,38,9,29,群益金鼎-桃園,2023-05-29,9189
0056,元大高股息,37,8,29,群益金鼎-桃園,2023-05-29,9189
1806,冠軍,30,3,27,群益金鼎-桃園,2023-05-29,9189
3625,西勝,27,0,27,群益金鼎-桃園,2023-05-29,9189
2356,英業達,43,18,25,群益金鼎-桃園,2023-05-29,9189
00878,國泰永續高股息,33,8,25,群益金鼎-桃園,2023-05-29,9189
2393,億光,25,0,25,群益金鼎-桃園,2023-05-29,9189
6485,點序,22,0,22,群益金鼎-桃園,2023-05-29,9189
00753L,中信中國50正2,21,0,21,群益金鼎-桃園,2023-05-29,9189
6285,啟��,21,0,21,群益金鼎-桃園,2023-05-29,9189
5381,合正,20,0,20,群益金鼎-桃園,2023-05-29,9189
1304,台聚,20,0,20,群益金鼎-桃園,2023-05-29,9189
8054,安國,20,0,20,群益金鼎-桃園,2023-05-29,9189
6016,康和證,20,1,19,群益金鼎-桃園,2023-05-29,9189
2883,凱基金,19,0,19,群益金鼎-桃園,2023-05-29,9189
8069,元太,36,19,17,群益金鼎-桃園,2023-05-29,9189
4716,大立,17,0,17,群益金鼎-桃園,2023-05-29,9189
2301,光寶科,18,1,17,群益金鼎-桃園,2023-05-29,9189
6191,精成科,15,0,15,群益金鼎-桃園,2023-05-29,9189
1810,和成,15,1,14,群益金鼎-桃園,2023-05-29,9189
8222,寶一,24,10,14,群益金鼎-桃園,2023-05-29,9189
00673R,期元大S＆P原油反1,13,0,13,群益金鼎-桃園,2023-05-29,9189
3558,神準,22,9,13,群益金鼎-桃園,2023-05-29,9189
00772B,中信高評級公司債,13,0,13,群益金鼎-桃園,2023-05-29,9189
3032,偉訓,18,6,12,群益金鼎-桃園,2023-05-29,9189
2399,映泰,12,1,11,群益金鼎-桃園,2023-05-29,9189
6163,華電網,10,0,10,群益金鼎-桃園,2023-05-29,9189
4562,穎漢,10,0,10,群益金鼎-桃園,2023-05-29,9189
3556,禾瑞亞,10,0,10,群益金鼎-桃園,2023-05-29,9189
2537,聯上發,10,0,10,群益金鼎-桃園,2023-05-29,9189
9103,美德醫療-DR,10,0,10,群益金鼎-桃園,2023-05-29,9189
6153,嘉聯益,10,0,10,群益金鼎-桃園,2023-05-29,9189
3232,昱捷,10,0,10,群益金鼎-桃園,2023-05-29,9189
6835,圓裕,10,0,10,群益金鼎-桃園,2023-05-29,9189
2888,新光金,11,2,9,群益金鼎-桃園,2023-05-29,9189
2609,陽明,18,9,9,群益金鼎-桃園,2023-05-29,9189
2495,普安,17,8,9,群益金鼎-桃園,2023-05-29,9189
2634,漢翔,22,13,9,群益金鼎-桃園,2023-05-29,9189
2331,精英,8,0,8,群益金鼎-桃園,2023-05-29,9189
3205,佰研,8,0,8,群益金鼎-桃園,2023-05-29,9189
3231,緯創,238,121,117,群益金鼎-桃園,2023-05-30,9189
00882,中信中國高股息,68,0,68,群益金鼎-桃園,2023-05-30,9189
1721,三晃,58,0,58,群益金鼎-桃園,2023-05-30,9189
2371,大同,91,33,58,群益金鼎-桃園,2023-05-30,9189
00637L,元大滬深300正2,60,3,57,群益金鼎-桃園,2023-05-30,9189
3518,柏騰,50,2,48,群益金鼎-桃園,2023-05-30,9189
6285,啟��,36,1,35,群益金鼎-桃園,2023-05-30,9189
2302,麗正,34,1,33,群益金鼎-桃園,2023-05-30,9189
00706L,期元大S＆P日圓正2,32,0,32,群益金鼎-桃園,2023-05-30,9189
8277,商丞,30,0,30,群益金鼎-桃園,2023-05-30,9189
8040,九暘,33,5,28,群益金鼎-桃園,2023-05-30,9189
5009,榮剛,27,1,26,群益金鼎-桃園,2023-05-30,9189
6112,邁達特,26,2,24,群益金鼎-桃園,2023-05-30,9189
2402,毅嘉,31,8,23,群益金鼎-桃園,2023-05-30,9189
00632R,元大台灣50反1,33,11,22,群益金鼎-桃園,2023-05-30,9189
2615,萬海,20,0,20,群益金鼎-桃園,2023-05-30,9189
6227,茂綸,20,0,20,群益金鼎-桃園,2023-05-30,9189
0056,元大高股息,34,14,20,群益金鼎-桃園,2023-05-30,9189
8076,伍豐,22,4,18,群益金鼎-桃園,2023-05-30,9189
1605,華新,16,0,16,群益金鼎-桃園,2023-05-30,9189
2471,資通,20,4,16,群益金鼎-桃園,2023-05-30,9189
3094,聯傑,39,23,16,群益金鼎-桃園,2023-05-30,9189
8033,雷虎,17,2,15,群益金鼎-桃園,2023-05-30,9189
6125,廣運,15,0,15,群益金鼎-桃園,2023-05-30,9189
2393,億光,16,1,15,群益金鼎-桃園,2023-05-30,9189
3704,合勤控,16,2,14,群益金鼎-桃園,2023-05-30,9189
2388,威盛,22,9,13,群益金鼎-桃園,2023-05-30,9189
3234,光環,13,0,13,群益金鼎-桃園,2023-05-30,9189
2313,華通,15,2,13,群益金鼎-桃園,2023-05-30,9189
9955,佳龍,12,0,12,群益金鼎-桃園,2023-05-30,9189
3058,立德,13,1,12,群益金鼎-桃園,2023-05-30,9189
8054,安國,32,20,12,群益金鼎-桃園,2023-05-30,9189
2382,廣達,36,24,12,群益金鼎-桃園,2023-05-30,9189
2356,英業達,149,137,12,群益金鼎-桃園,2023-05-30,9189
2504,國產,11,0,11,群益金鼎-桃園,2023-05-30,9189
2353,宏��,11,0,11,群益金鼎-桃園,2023-05-30,9189
2634,漢翔,13,2,11,群益金鼎-桃園,2023-05-30,9189
5465,富驊,11,0,11,群益金鼎-桃園,2023-05-30,9189
3014,聯陽,11,0,11,群益金鼎-桃園,2023-05-30,9189
2201,裕隆,26,15,11,群益金鼎-桃園,2023-05-30,9189
3011,今皓,10,0,10,群益金鼎-桃園,2023-05-30,9189
2609,陽明,12,2,10,群益金鼎-桃園,2023-05-30,9189
2484,希華,10,0,10,群益金鼎-桃園,2023-05-30,9189
2301,光寶科,10,0,10,群益金鼎-桃園,2023-05-30,9189
4994,傳奇,10,0,10,群益金鼎-桃園,2023-05-30,9189
00894,中信小資高價30,10,0,10,群益金鼎-桃園,2023-05-30,9189
3078,僑威,10,0,10,群益金鼎-桃園,2023-05-30,9189
1718,中纖,10,0,10,群益金鼎-桃園,2023-05-30,9189
00680L,元大美債20正2,10,0,10,群益金鼎-桃園,2023-05-30,9189
6244,茂迪,13,3,10,群益金鼎-桃園,2023-05-30,9189
00715L,期街口布蘭特正2,71,1,70,群益金鼎-桃園,2023-05-31,9189
4915,致伸,61,5,56,群益金鼎-桃園,2023-05-31,9189
00642U,期元大S＆P石油,53,0,53,群益金鼎-桃園,2023-05-31,9189
00882,中信中國高股息,43,0,43,群益金鼎-桃園,2023-05-31,9189
3006,晶豪科,40,16,24,群益金鼎-桃園,2023-05-31,9189
2371,大同,37,14,23,群益金鼎-桃園,2023-05-31,9189
1785,光洋科,22,0,22,群益金鼎-桃園,2023-05-31,9189
6229,研通,21,0,21,群益金鼎-桃園,2023-05-31,9189
2471,資通,20,0,20,群益金鼎-桃園,2023-05-31,9189
3706,神達,27,7,20,群益金鼎-桃園,2023-05-31,9189
3715,定穎投控,20,1,19,群益金鼎-桃園,2023-05-31,9189
1524,耿鼎,26,10,16,群益金鼎-桃園,2023-05-31,9189
3094,聯傑,15,0,15,群益金鼎-桃園,2023-05-31,9189
2630,亞航,20,5,15,群益金鼎-桃園,2023-05-31,9189
00680L,元大美債20正2,14,0,14,群益金鼎-桃園,2023-05-31,9189
2388,威盛,15,1,14,群益金鼎-桃園,2023-05-31,9189
1326,台化,13,0,13,群益金鼎-桃園,2023-05-31,9189
2609,陽明,15,2,13,群益金鼎-桃園,2023-05-31,9189
1721,三晃,13,0,13,群益金鼎-桃園,2023-05-31,9189
3078,僑威,20,7,13,群益金鼎-桃園,2023-05-31,9189
2382,廣達,16,5,11,群益金鼎-桃園,2023-05-31,9189
2002,中鋼,12,1,11,群益金鼎-桃園,2023-05-31,9189
6191,精成科,11,0,11,群益金鼎-桃園,2023-05-31,9189
2317,鴻海,11,1,10,群益金鼎-桃園,2023-05-31,9189
6187,萬潤,15,5,10,群益金鼎-桃園,2023-05-31,9189
4909,新復興,10,0,10,群益金鼎-桃園,2023-05-31,9189
2484,希華,10,0,10,群益金鼎-桃園,2023-05-31,9189
8438,昶昕,10,0,10,群益金鼎-桃園,2023-05-31,9189
3031,佰鴻,12,2,10,群益金鼎-桃園,2023-05-31,9189
00706L,期元大S＆P日圓正2,10,0,10,群益金鼎-桃園,2023-05-31,9189
4550,長佳,10,0,10,群益金鼎-桃園,2023-05-31,9189
00679B,元大美債20年,10,1,9,群益金鼎-桃園,2023-05-31,9189
2886,兆豐金,9,0,9,群益金鼎-桃園,2023-05-31,9189
3043,科風,15,6,9,群益金鼎-桃園,2023-05-31,9189
00893,國泰智能電動車,24,16,8,群益金鼎-桃園,2023-05-31,9189
6531,愛普*,23,14,9,群益金鼎-桃園,2023-05-31,9189
1609,大亞,9,1,8,群益金鼎-桃園,2023-05-31,9189
2329,華泰,9,1,8,群益金鼎-桃園,2023-05-31,9189
6023,元大期,8,0,8,群益金鼎-桃園,2023-05-31,9189
6188,廣明,19,11,8,群益金鼎-桃園,2023-05-31,9189
2330,台積電,12,4,8,群益金鼎-桃園,2023-05-31,9189
2331,精英,13,6,7,群益金鼎-桃園,2023-05-31,9189
2615,萬海,7,0,7,群益金鼎-桃園,2023-05-31,9189
3356,奇偶,8,1,7,群益金鼎-桃園,2023-05-31,9189
3363,上詮,11,4,7,群益金鼎-桃園,2023-05-31,9189
3703,欣陸,7,0,7,群益金鼎-桃園,2023-05-31,9189
5498,凱崴,7,0,7,群益金鼎-桃園,2023-05-31,9189
1101,台泥,8,2,6,群益金鼎-桃園,2023-05-31,9189
5706,鳳凰,16,10,6,群益金鼎-桃園,2023-05-31,9189
1310,台苯,6,0,6,群益金鼎-桃園,2023-05-31,9189
3231,緯創,350,152,198,群益金鼎-桃園,2023-06-01,9189
3704,合勤控,57,0,57,群益金鼎-桃園,2023-06-01,9189
3706,神達,192,139,53,群益金鼎-桃園,2023-06-01,9189
3006,晶豪科,54,2,52,群益金鼎-桃園,2023-06-01,9189
2834,臺企銀,50,1,49,群益金鼎-桃園,2023-06-01,9189
00715L,期街口布蘭特正2,52,4,48,群益金鼎-桃園,2023-06-01,9189
2892,第一金,35,0,35,群益金鼎-桃園,2023-06-01,9189
1733,五鼎,31,0,31,群益金鼎-桃園,2023-06-01,9189
2801,彰銀,31,0,31,群益金鼎-桃園,2023-06-01,9189
3035,智原,88,58,30,群益金鼎-桃園,2023-06-01,9189
4564,元翎,47,19,28,群益金鼎-桃園,2023-06-01,9189
00882,中信中國高股息,28,0,28,群益金鼎-桃園,2023-06-01,9189
2408,南亞科,27,0,27,群益金鼎-桃園,2023-06-01,9189
5324,士開,27,0,27,群益金鼎-桃園,2023-06-01,9189
2332,友訊,26,0,26,群益金鼎-桃園,2023-06-01,9189
2421,建準,26,3,23,群益金鼎-桃園,2023-06-01,9189
8420,明揚,21,0,21,群益金鼎-桃園,2023-06-01,9189
3715,定穎投控,20,0,20,群益金鼎-桃園,2023-06-01,9189
3013,晟銘電,125,106,19,群益金鼎-桃園,2023-06-01,9189
2356,英業達,31,13,18,群益金鼎-桃園,2023-06-01,9189
5351,鈺創,19,3,16,群益金鼎-桃園,2023-06-01,9189
00642U,期元大S＆P石油,15,0,15,群益金鼎-桃園,2023-06-01,9189
3031,佰鴻,16,1,15,群益金鼎-桃園,2023-06-01,9189
2883,凱基金,15,0,15,群益金鼎-桃園,2023-06-01,9189
2425,承啟,21,7,14,群益金鼎-桃園,2023-06-01,9189
8489,三貝德,14,0,14,群益金鼎-桃園,2023-06-01,9189
00687B,國泰20年美債,14,0,14,群益金鼎-桃園,2023-06-01,9189
00878,國泰永續高股息,20,7,13,群益金鼎-桃園,2023-06-01,9189
6589,台康生技,12,0,12,群益金鼎-桃園,2023-06-01,9189
5483,中美晶,12,0,12,群益金鼎-桃園,2023-06-01,9189
2515,中工,13,1,12,群益金鼎-桃園,2023-06-01,9189
6197,佳必琪,11,0,11,群益金鼎-桃園,2023-06-01,9189
6443,元晶,12,1,11,群益金鼎-桃園,2023-06-01,9189
00720B,元大投資級公司債,11,0,11,群益金鼎-桃園,2023-06-01,9189
6278,台表科,11,0,11,群益金鼎-桃園,2023-06-01,9189
8277,商丞,10,0,10,群益金鼎-桃園,2023-06-01,9189
2912,統一超,10,0,10,群益金鼎-桃園,2023-06-01,9189
2371,大同,25,15,10,群益金鼎-桃園,2023-06-01,9189
2916,滿心,9,0,9,群益金鼎-桃園,2023-06-01,9189
2608,嘉里大榮,10,1,9,群益金鼎-桃園,2023-06-01,9189
3163,波若威,9,0,9,群益金鼎-桃園,2023-06-01,9189
6191,精成科,10,1,9,群益金鼎-桃園,2023-06-01,9189
6509,聚和,15,6,9,群益金鼎-桃園,2023-06-01,9189
1101,台泥,12,4,8,群益金鼎-桃園,2023-06-01,9189
1584,精剛,12,4,8,群益金鼎-桃園,2023-06-01,9189
00893,國泰智能電動車,12,4,8,群益金鼎-桃園,2023-06-01,9189
2731,雄獅,19,11,8,群益金鼎-桃園,2023-06-01,9189
3094,聯傑,10,2,8,群益金鼎-桃園,2023-06-01,9189
2330,台積電,9,1,8,群益金鼎-桃園,2023-06-01,9189
2105,正新,7,0,7,群益金鼎-桃園,2023-06-01,9189
00919,群益台灣精選高息,154,0,154,群益金鼎-桃園,2023-06-02,9189
00878,國泰永續高股息,141,24,117,群益金鼎-桃園,2023-06-02,9189
2610,華航,333,218,115,群益金鼎-桃園,2023-06-02,9189
00632R,元大台灣50反1,190,85,105,群益金鼎-桃園,2023-06-02,9189
3481,群創,101,5,96,群益金鼎-桃園,2023-06-02,9189
00679B,元大美債20年,65,0,65,群益金鼎-桃園,2023-06-02,9189
00751B,元大AAA至A公司債,60,0,60,群益金鼎-桃園,2023-06-02,9189
4173,久裕,50,0,50,群益金鼎-桃園,2023-06-02,9189
6015,宏遠證,50,0,50,群益金鼎-桃園,2023-06-02,9189
3715,定穎投控,54,10,44,群益金鼎-桃園,2023-06-02,9189
1905,華紙,140,96,44,群益金鼎-桃園,2023-06-02,9189
5478,智冠,43,3,40,群益金鼎-桃園,2023-06-02,9189
2888,新光金,35,0,35,群益金鼎-桃園,2023-06-02,9189
2328,廣宇,39,7,32,群益金鼎-桃園,2023-06-02,9189
1504,東元,88,56,32,群益金鼎-桃園,2023-06-02,9189
3630,新鉅科,32,1,31,群益金鼎-桃園,2023-06-02,9189
6456,GIS-KY,30,0,30,群益金鼎-桃園,2023-06-02,9189
1815,富喬,30,0,30,群益金鼎-桃園,2023-06-02,9189
00715L,期街口布蘭特正2,94,64,30,群益金鼎-桃園,2023-06-02,9189
6026,福邦證,30,1,29,群益金鼎-桃園,2023-06-02,9189
5351,鈺創,29,3,26,群益金鼎-桃園,2023-06-02,9189
2484,希華,45,20,25,群益金鼎-桃園,2023-06-02,9189
1608,華榮,30,7,23,群益金鼎-桃園,2023-06-02,9189
2892,第一金,23,0,23,群益金鼎-桃園,2023-06-02,9189
00752,中信中國50,24,1,23,群益金鼎-桃園,2023-06-02,9189
2367,燿華,23,0,23,群益金鼎-桃園,2023-06-02,9189
00664R,國泰臺灣加權反1,22,0,22,群益金鼎-桃園,2023-06-02,9189
3011,今皓,22,0,22,群益金鼎-桃園,2023-06-02,9189
2363,矽統,20,0,20,群益金鼎-桃園,2023-06-02,9189
1721,三晃,20,0,20,群益金鼎-桃園,2023-06-02,9189
6120,達運,20,0,20,群益金鼎-桃園,2023-06-02,9189
2421,建準,53,34,19,群益金鼎-桃園,2023-06-02,9189
2630,亞航,19,0,19,群益金鼎-桃園,2023-06-02,9189
2427,三商電,18,0,18,群益金鼎-桃園,2023-06-02,9189
6235,華孚,22,4,18,群益金鼎-桃園,2023-06-02,9189
6509,聚和,18,0,18,群益金鼎-桃園,2023-06-02,9189
6470,宇智,20,2,18,群益金鼎-桃園,2023-06-02,9189
8940,新天地,20,2,18,群益金鼎-桃園,2023-06-02,9189
00772B,中信高評級公司債,16,0,16,群益金鼎-桃園,2023-06-02,9189
6185,幃翔,22,7,15,群益金鼎-桃園,2023-06-02,9189
00902,中信電池及儲能,20,6,14,群益金鼎-桃園,2023-06-02,9189
3231,緯創,207,194,13,群益金鼎-桃園,2023-06-02,9189
00882,中信中國高股息,13,1,12,群益金鼎-桃園,2023-06-02,9189
3363,上詮,23,11,12,群益金鼎-桃園,2023-06-02,9189
4503,金雨,12,0,12,群益金鼎-桃園,2023-06-02,9189
1611,中電,12,0,12,群益金鼎-桃園,2023-06-02,9189
6443,元晶,25,13,12,群益金鼎-桃園,2023-06-02,9189
4121,優盛,11,0,11,群益金鼎-桃園,2023-06-02,9189
6168,宏齊,11,0,11,群益金鼎-桃園,2023-06-02,9189
6143,振曜,22,11,11,群益金鼎-桃園,2023-06-02,9189
2610,華航,177,70,107,群益金鼎-桃園,2023-06-05,9189
3481,群創,143,69,74,群益金鼎-桃園,2023-06-05,9189
6125,廣運,112,39,73,群益金鼎-桃園,2023-06-05,9189
00706L,期元大S＆P日圓正2,63,0,63,群益金鼎-桃園,2023-06-05,9189
2607,榮運,61,0,61,群益金鼎-桃園,2023-06-05,9189
4960,誠美材,60,0,60,群益金鼎-桃園,2023-06-05,9189
2855,統一證,59,0,59,群益金鼎-桃園,2023-06-05,9189
1529,樂事綠能,67,16,51,群益金鼎-桃園,2023-06-05,9189
00919,群益台灣精選高息,50,0,50,群益金鼎-桃園,2023-06-05,9189
4306,炎洲,50,0,50,群益金鼎-桃園,2023-06-05,9189
00679B,元大美債20年,51,2,49,群益金鼎-桃園,2023-06-05,9189
00882,中信中國高股息,69,22,47,群益金鼎-桃園,2023-06-05,9189
1528,恩德,50,3,47,群益金鼎-桃園,2023-06-05,9189
5907,大洋-KY,46,0,46,群益金鼎-桃園,2023-06-05,9189
3438,類比科,40,0,40,群益金鼎-桃園,2023-06-05,9189
4915,致伸,41,2,39,群益金鼎-桃園,2023-06-05,9189
2331,精英,31,0,31,群益金鼎-桃園,2023-06-05,9189
1513,中興電,28,6,22,群益金鼎-桃園,2023-06-05,9189
2603,長榮,24,2,22,群益金鼎-桃園,2023-06-05,9189
00687B,國泰20年美債,19,0,19,群益金鼎-桃園,2023-06-05,9189
2014,中鴻,20,2,18,群益金鼎-桃園,2023-06-05,9189
00673R,期元大S＆P原油反1,17,0,17,群益金鼎-桃園,2023-06-05,9189
2353,宏��,56,40,16,群益金鼎-桃園,2023-06-05,9189
2882,國泰金,21,5,16,群益金鼎-桃園,2023-06-05,9189
3033,威健,25,10,15,群益金鼎-桃園,2023-06-05,9189
1714,和桐,17,2,15,群益金鼎-桃園,2023-06-05,9189
0056,元大高股息,27,13,14,群益金鼎-桃園,2023-06-05,9189
2201,裕隆,14,0,14,群益金鼎-桃園,2023-06-05,9189
2382,廣達,19,5,14,群益金鼎-桃園,2023-06-05,9189
1905,華紙,39,26,13,群益金鼎-桃園,2023-06-05,9189
8033,雷虎,14,1,13,群益金鼎-桃園,2023-06-05,9189
5284,jpp-KY,13,0,13,群益金鼎-桃園,2023-06-05,9189
6245,立端,13,0,13,群益金鼎-桃園,2023-06-05,9189
00713,元大台灣高息低波,13,0,13,群益金鼎-桃園,2023-06-05,9189
1514,亞力,113,101,12,群益金鼎-桃園,2023-06-05,9189
2206,三陽工業,25,13,12,群益金鼎-桃園,2023-06-05,9189
00637L,元大滬深300正2,12,0,12,群益金鼎-桃園,2023-06-05,9189
3576,聯合再生,12,0,12,群益金鼎-桃園,2023-06-05,9189
1806,冠軍,16,5,11,群益金鼎-桃園,2023-06-05,9189
2468,華經,11,0,11,群益金鼎-桃園,2023-06-05,9189
6114,久威,11,0,11,群益金鼎-桃園,2023-06-05,9189
1760,寶齡富錦,10,0,10,群益金鼎-桃園,2023-06-05,9189
3059,華晶科,12,2,10,群益金鼎-桃園,2023-06-05,9189
1471,首利,10,0,10,群益金鼎-桃園,2023-06-05,9189
6180,橘子,21,11,10,群益金鼎-桃園,2023-06-05,9189
6142,友勁,10,0,10,群益金鼎-桃園,2023-06-05,9189
2338,光罩,10,0,10,群益金鼎-桃園,2023-06-05,9189
1409,新纖,10,0,10,群益金鼎-桃園,2023-06-05,9189
6160,欣技,12,2,10,群益金鼎-桃園,2023-06-05,9189
00671R,富邦NASDAQ反1,10,0,10,群益金鼎-桃園,2023-06-05,9189
3035,智原,91,0,91,群益金鼎-桃園,2023-06-06,9189
2913,農林,82,3,79,群益金鼎-桃園,2023-06-06,9189
6270,倍微,70,0,70,群益金鼎-桃園,2023-06-06,9189
1519,華城,67,10,57,群益金鼎-桃園,2023-06-06,9189
5439,高技,53,3,50,群益金鼎-桃園,2023-06-06,9189
6015,宏遠證,45,2,43,群益金鼎-桃園,2023-06-06,9189
00632R,元大台灣50反1,53,14,39,群益金鼎-桃園,2023-06-06,9189
00679B,元大美債20年,36,0,36,群益金鼎-桃園,2023-06-06,9189
6026,福邦證,40,6,34,群益金鼎-桃園,2023-06-06,9189
2337,旺宏,30,1,29,群益金鼎-桃園,2023-06-06,9189
6290,良維,28,6,22,群益金鼎-桃園,2023-06-06,9189
2888,新光金,31,10,21,群益金鼎-桃園,2023-06-06,9189
1104,環泥,26,5,21,群益金鼎-桃園,2023-06-06,9189
3006,晶豪科,21,0,21,群益金鼎-桃園,2023-06-06,9189
3706,神達,21,1,20,群益金鼎-桃園,2023-06-06,9189
2349,錸德,20,0,20,群益金鼎-桃園,2023-06-06,9189
1605,華新,37,17,20,群益金鼎-桃園,2023-06-06,9189
3037,欣興,33,14,19,群益金鼎-桃園,2023-06-06,9189
4533,協易機,41,23,18,群益金鼎-桃園,2023-06-06,9189
5907,大洋-KY,18,0,18,群益金鼎-桃園,2023-06-06,9189
1609,大亞,152,134,18,群益金鼎-桃園,2023-06-06,9189
1101,台泥,28,11,17,群益金鼎-桃園,2023-06-06,9189
6101,寬魚國際,17,1,16,群益金鼎-桃園,2023-06-06,9189
3363,上詮,23,8,15,群益金鼎-桃園,2023-06-06,9189
1503,士電,18,4,14,群益金鼎-桃園,2023-06-06,9189
2353,宏��,17,3,14,群益金鼎-桃園,2023-06-06,9189
1904,正隆,16,2,14,群益金鼎-桃園,2023-06-06,9189
4564,元翎,15,2,13,群益金鼎-桃園,2023-06-06,9189
00715L,期街口布蘭特正2,31,18,13,群益金鼎-桃園,2023-06-06,9189
00713,元大台灣高息低波,13,0,13,群益金鼎-桃園,2023-06-06,9189
9945,潤泰新,17,5,12,群益金鼎-桃園,2023-06-06,9189
8011,台通,12,0,12,群益金鼎-桃園,2023-06-06,9189
2388,威盛,33,21,12,群益金鼎-桃園,2023-06-06,9189
1711,永光,12,0,12,群益金鼎-桃園,2023-06-06,9189
8050,廣積,12,0,12,群益金鼎-桃園,2023-06-06,9189
4931,新盛力,18,7,11,群益金鼎-桃園,2023-06-06,9189
1527,鑽全,11,0,11,群益金鼎-桃園,2023-06-06,9189
2472,立隆電,11,0,11,群益金鼎-桃園,2023-06-06,9189
3141,晶宏,11,0,11,群益金鼎-桃園,2023-06-06,9189
3704,合勤控,11,0,11,群益金鼎-桃園,2023-06-06,9189
8105,凌巨,20,9,11,群益金鼎-桃園,2023-06-06,9189
3715,定穎投控,15,4,11,群益金鼎-桃園,2023-06-06,9189
6770,力積電,11,0,11,群益金鼎-桃園,2023-06-06,9189
00712,復華富時不動產,10,0,10,群益金鼎-桃園,2023-06-06,9189
2485,兆赫,10,0,10,群益金鼎-桃園,2023-06-06,9189
3680,家登,10,0,10,群益金鼎-桃園,2023-06-06,9189
3325,旭品,10,0,10,群益金鼎-桃園,2023-06-06,9189
3483,力致,58,48,10,群益金鼎-桃園,2023-06-06,9189
2460,建通,10,0,10,群益金鼎-桃園,2023-06-06,9189
2399,映泰,35,25,10,群益金鼎-桃園,2023-06-06,9189
00878,國泰永續高股息,135,40,95,群益金鼎-桃園,2023-06-07,9189
2618,長榮航,86,9,77,群益金鼎-桃園,2023-06-07,9189
00715L,期街口布蘭特正2,66,2,64,群益金鼎-桃園,2023-06-07,9189
3511,矽瑪,65,6,59,群益金鼎-桃園,2023-06-07,9189
2701,萬企,66,7,59,群益金鼎-桃園,2023-06-07,9189
1519,華城,61,7,54,群益金鼎-桃園,2023-06-07,9189
5439,高技,51,0,51,群益金鼎-桃園,2023-06-07,9189
1417,嘉裕,40,0,40,群益金鼎-桃園,2023-06-07,9189
5907,大洋-KY,37,0,37,群益金鼎-桃園,2023-06-07,9189
00919,群益台灣精選高息,32,0,32,群益金鼎-桃園,2023-06-07,9189
3037,欣興,45,13,32,群益金鼎-桃園,2023-06-07,9189
5531,鄉林,32,2,30,群益金鼎-桃園,2023-06-07,9189
2427,三商電,45,19,26,群益金鼎-桃園,2023-06-07,9189
1612,宏泰,32,6,26,群益金鼎-桃園,2023-06-07,9189
2104,國際中橡,25,0,25,群益金鼎-桃園,2023-06-07,9189
1514,亞力,26,2,24,群益金鼎-桃園,2023-06-07,9189
2337,旺宏,24,2,22,群益金鼎-桃園,2023-06-07,9189
6120,達運,20,0,20,群益金鼎-桃園,2023-06-07,9189
4155,訊映,21,1,20,群益金鼎-桃園,2023-06-07,9189
4543,萬在,19,0,19,群益金鼎-桃園,2023-06-07,9189
3038,全台,27,9,18,群益金鼎-桃園,2023-06-07,9189
5443,均豪,21,5,16,群益金鼎-桃園,2023-06-07,9189
2402,毅嘉,21,5,16,群益金鼎-桃園,2023-06-07,9189
3532,台勝科,14,0,14,群益金鼎-桃園,2023-06-07,9189
3305,昇貿,14,0,14,群益金鼎-桃園,2023-06-07,9189
6125,廣運,50,37,13,群益金鼎-桃園,2023-06-07,9189
3094,聯傑,13,0,13,群益金鼎-桃園,2023-06-07,9189
8358,金居,17,5,12,群益金鼎-桃園,2023-06-07,9189
3260,威剛,13,1,12,群益金鼎-桃園,2023-06-07,9189
6243,迅杰,23,11,12,群益金鼎-桃園,2023-06-07,9189
3078,僑威,15,3,12,群益金鼎-桃園,2023-06-07,9189
3715,定穎投控,12,0,12,群益金鼎-桃園,2023-06-07,9189
2204,中華,12,1,11,群益金鼎-桃園,2023-06-07,9189
2347,聯強,12,1,11,群益金鼎-桃園,2023-06-07,9189
3025,星通,17,6,11,群益金鼎-桃園,2023-06-07,9189
1599,宏佳騰,10,0,10,群益金鼎-桃園,2023-06-07,9189
4960,誠美材,10,0,10,群益金鼎-桃園,2023-06-07,9189
1103,嘉泥,10,0,10,群益金鼎-桃園,2023-06-07,9189
6235,華孚,16,6,10,群益金鼎-桃園,2023-06-07,9189
1527,鑽全,10,0,10,群益金鼎-桃園,2023-06-07,9189
5009,榮剛,47,37,10,群益金鼎-桃園,2023-06-07,9189
7402,邑錡,11,1,10,群益金鼎-桃園,2023-06-07,9189
3702,大聯大,10,0,10,群益金鼎-桃園,2023-06-07,9189
2353,宏��,12,2,10,群益金鼎-桃園,2023-06-07,9189
2486,一詮,28,18,10,群益金鼎-桃園,2023-06-07,9189
00664R,國泰臺灣加權反1,9,0,9,群益金鼎-桃園,2023-06-07,9189
1785,光洋科,22,13,9,群益金鼎-桃園,2023-06-07,9189
2603,長榮,9,0,9,群益金鼎-桃園,2023-06-07,9189
8088,品安,9,0,9,群益金鼎-桃園,2023-06-07,9189
00882,中信中國高股息,14,5,9,群益金鼎-桃園,2023-06-07,9189
00706L,期元大S＆P日圓正2,140,30,110,群益金鼎-桃園,2023-06-08,9189
00641R,富邦日本反1,100,0,100,群益金鼎-桃園,2023-06-08,9189
2881,富邦金,91,0,91,群益金鼎-桃園,2023-06-08,9189
3037,欣興,67,11,56,群益金鼎-桃園,2023-06-08,9189
00679B,元大美債20年,52,0,52,群益金鼎-桃園,2023-06-08,9189
2888,新光金,48,0,48,群益金鼎-桃園,2023-06-08,9189
2618,長榮航,53,8,45,群益金鼎-桃園,2023-06-08,9189
00919,群益台灣精選高息,45,0,45,群益金鼎-桃園,2023-06-08,9189
3006,晶豪科,53,12,41,群益金鼎-桃園,2023-06-08,9189
1616,億泰,50,11,39,群益金鼎-桃園,2023-06-08,9189
1612,宏泰,64,28,36,群益金鼎-桃園,2023-06-08,9189
1104,環泥,35,4,31,群益金鼎-桃園,2023-06-08,9189
6285,啟��,41,11,30,群益金鼎-桃園,2023-06-08,9189
2601,益航,30,3,27,群益金鼎-桃園,2023-06-08,9189
3027,盛達,31,4,27,群益金鼎-桃園,2023-06-08,9189
4958,臻鼎-KY,26,0,26,群益金鼎-桃園,2023-06-08,9189
4533,協易機,29,5,24,群益金鼎-桃園,2023-06-08,9189
2344,華邦電,26,2,24,群益金鼎-桃園,2023-06-08,9189
00772B,中信高評級公司債,23,0,23,群益金鼎-桃園,2023-06-08,9189
00673R,期元大S＆P原油反1,23,0,23,群益金鼎-桃園,2023-06-08,9189
4931,新盛力,22,0,22,群益金鼎-桃園,2023-06-08,9189
1609,大亞,173,151,22,群益金鼎-桃園,2023-06-08,9189
2312,金寶,27,6,21,群益金鼎-桃園,2023-06-08,9189
2425,承啟,23,4,19,群益金鼎-桃園,2023-06-08,9189
00720B,元大投資級公司債,18,0,18,群益金鼎-桃園,2023-06-08,9189
3029,零壹,19,1,18,群益金鼎-桃園,2023-06-08,9189
2317,鴻海,18,1,17,群益金鼎-桃園,2023-06-08,9189
2882,國泰金,19,2,17,群益金鼎-桃園,2023-06-08,9189
00680L,元大美債20正2,16,0,16,群益金鼎-桃園,2023-06-08,9189
6191,精成科,17,1,16,群益金鼎-桃園,2023-06-08,9189
2332,友訊,16,0,16,群益金鼎-桃園,2023-06-08,9189
0056,元大高股息,19,4,15,群益金鼎-桃園,2023-06-08,9189
1733,五鼎,15,0,15,群益金鼎-桃園,2023-06-08,9189
1417,嘉裕,20,5,15,群益金鼎-桃園,2023-06-08,9189
1710,東聯,29,14,15,群益金鼎-桃園,2023-06-08,9189
6125,廣運,31,16,15,群益金鼎-桃園,2023-06-08,9189
5905,南仁湖,19,5,14,群益金鼎-桃園,2023-06-08,9189
4960,誠美材,14,0,14,群益金鼎-桃園,2023-06-08,9189
1605,華新,24,11,13,群益金鼎-桃園,2023-06-08,9189
1101,台泥,13,1,12,群益金鼎-桃園,2023-06-08,9189
8924,大田,12,0,12,群益金鼎-桃園,2023-06-08,9189
2408,南亞科,12,0,12,群益金鼎-桃園,2023-06-08,9189
6185,幃翔,12,0,12,群益金鼎-桃園,2023-06-08,9189
00713,元大台灣高息低波,12,0,12,群益金鼎-桃園,2023-06-08,9189
3038,全台,11,0,11,群益金鼎-桃園,2023-06-08,9189
1524,耿鼎,38,27,11,群益金鼎-桃園,2023-06-08,9189
3189,景碩,11,1,10,群益金鼎-桃園,2023-06-08,9189
00893,國泰智能電動車,10,0,10,群益金鼎-桃園,2023-06-08,9189
1409,新纖,10,0,10,群益金鼎-桃園,2023-06-08,9189
00892,富邦台灣半導體,10,0,10,群益金鼎-桃園,2023-06-08,9189
00632R,元大台灣50反1,145,10,135,群益金鼎-桃園,2023-06-09,9189
2888,新光金,121,19,102,群益金鼎-桃園,2023-06-09,9189
00751B,元大AAA至A公司債,60,0,60,群益金鼎-桃園,2023-06-09,9189
2618,長榮航,85,28,57,群益金鼎-桃園,2023-06-09,9189
00919,群益台灣精選高息,57,5,52,群益金鼎-桃園,2023-06-09,9189
2630,亞航,86,45,41,群益金鼎-桃園,2023-06-09,9189
6668,中揚光,40,0,40,群益金鼎-桃園,2023-06-09,9189
1806,冠軍,46,7,39,群益金鼎-桃園,2023-06-09,9189
00715L,期街口布蘭特正2,59,20,39,群益金鼎-桃園,2023-06-09,9189
6282,康舒,47,9,38,群益金鼎-桃園,2023-06-09,9189
2323,中環,67,29,38,群益金鼎-桃園,2023-06-09,9189
00642U,期元大S＆P石油,37,0,37,群益金鼎-桃園,2023-06-09,9189
00929,復華台灣科技優息,34,0,34,群益金鼎-桃園,2023-06-09,9189
1605,華新,34,3,31,群益金鼎-桃園,2023-06-09,9189
2363,矽統,30,0,30,群益金鼎-桃園,2023-06-09,9189
2353,宏��,70,41,29,群益金鼎-桃園,2023-06-09,9189
2377,微星,47,20,27,群益金鼎-桃園,2023-06-09,9189
8418,捷必勝-KY,34,9,25,群益金鼎-桃園,2023-06-09,9189
00706L,期元大S＆P日圓正2,25,0,25,群益金鼎-桃園,2023-06-09,9189
1710,東聯,35,11,24,群益金鼎-桃園,2023-06-09,9189
9943,好樂迪,34,10,24,群益金鼎-桃園,2023-06-09,9189
3483,力致,24,0,24,群益金鼎-桃園,2023-06-09,9189
2337,旺宏,23,0,23,群益金鼎-桃園,2023-06-09,9189
3046,建��,45,23,22,群益金鼎-桃園,2023-06-09,9189
5328,華容,22,0,22,群益金鼎-桃園,2023-06-09,9189
2610,華航,25,5,20,群益金鼎-桃園,2023-06-09,9189
1417,嘉裕,20,0,20,群益金鼎-桃園,2023-06-09,9189
6185,幃翔,25,7,18,群益金鼎-桃園,2023-06-09,9189
1504,東元,122,105,17,群益金鼎-桃園,2023-06-09,9189
2368,金像電,22,6,16,群益金鼎-桃園,2023-06-09,9189
3189,景碩,20,4,16,群益金鼎-桃園,2023-06-09,9189
3005,神基,16,2,14,群益金鼎-桃園,2023-06-09,9189
2745,五福,16,2,14,群益金鼎-桃園,2023-06-09,9189
2712,遠雄來,15,1,14,群益金鼎-桃園,2023-06-09,9189
1802,台玻,15,1,14,群益金鼎-桃園,2023-06-09,9189
2705,六福,23,10,13,群益金鼎-桃園,2023-06-09,9189
00882,中信中國高股息,12,0,12,群益金鼎-桃園,2023-06-09,9189
9945,潤泰新,14,2,12,群益金鼎-桃園,2023-06-09,9189
2425,承啟,16,4,12,群益金鼎-桃園,2023-06-09,9189
2634,漢翔,24,13,11,群益金鼎-桃園,2023-06-09,9189
2449,京元電子,11,0,11,群益金鼎-桃園,2023-06-09,9189
6664,群翊,11,0,11,群益金鼎-桃園,2023-06-09,9189
3702,大聯大,11,0,11,群益金鼎-桃園,2023-06-09,9189
00645,富邦日本,10,0,10,群益金鼎-桃園,2023-06-09,9189
3028,增你強,10,0,10,群益金鼎-桃園,2023-06-09,9189
2495,普安,10,0,10,群益金鼎-桃園,2023-06-09,9189
1218,泰山,10,0,10,群益金鼎-桃園,2023-06-09,9189
00680L,元大美債20正2,10,0,10,群益金鼎-桃園,2023-06-09,9189
3481,群創,17,7,10,群益金鼎-桃園,2023-06-09,9189
4726,永昕,10,0,10,群益金鼎-桃園,2023-06-09,9189
8114,振樺電,132,2,130,群益金鼎-桃園,2023-06-12,9189
00715L,期街口布蘭特正2,110,0,110,群益金鼎-桃園,2023-06-12,9189
00632R,元大台灣50反1,94,0,94,群益金鼎-桃園,2023-06-12,9189
00893,國泰智能電動車,96,6,90,群益金鼎-桃園,2023-06-12,9189
2436,偉詮電,87,4,83,群益金鼎-桃園,2023-06-12,9189
00919,群益台灣精選高息,83,5,78,群益金鼎-桃園,2023-06-12,9189
2356,英業達,128,52,76,群益金鼎-桃園,2023-06-12,9189
4123,晟德,75,2,73,群益金鼎-桃園,2023-06-12,9189
4510,高鋒,52,0,52,群益金鼎-桃園,2023-06-12,9189
3231,緯創,124,80,44,群益金鼎-桃園,2023-06-12,9189
2312,金寶,68,28,40,群益金鼎-桃園,2023-06-12,9189
2515,中工,50,11,39,群益金鼎-桃園,2023-06-12,9189
1536,和大,35,0,35,群益金鼎-桃園,2023-06-12,9189
2618,長榮航,62,32,30,群益金鼎-桃園,2023-06-12,9189
2457,飛宏,43,13,30,群益金鼎-桃園,2023-06-12,9189
00753L,中信中國50正2,30,0,30,群益金鼎-桃園,2023-06-12,9189
0056,元大高股息,71,41,30,群益金鼎-桃園,2023-06-12,9189
2363,矽統,30,1,29,群益金鼎-桃園,2023-06-12,9189
8358,金居,36,7,29,群益金鼎-桃園,2023-06-12,9189
3037,欣興,36,8,28,群益金鼎-桃園,2023-06-12,9189
00642U,期元大S＆P石油,28,2,26,群益金鼎-桃園,2023-06-12,9189
6126,信音,25,0,25,群益金鼎-桃園,2023-06-12,9189
00878,國泰永續高股息,36,11,25,群益金鼎-桃園,2023-06-12,9189
6122,擎邦,26,2,24,群益金鼎-桃園,2023-06-12,9189
1815,富喬,25,2,23,群益金鼎-桃園,2023-06-12,9189
1310,台苯,22,0,22,群益金鼎-桃園,2023-06-12,9189
00929,復華台灣科技優息,22,0,22,群益金鼎-桃園,2023-06-12,9189
00907,永豐優息存股,20,0,20,群益金鼎-桃園,2023-06-12,9189
6214,精誠,20,0,20,群益金鼎-桃園,2023-06-12,9189
2427,三商電,22,3,19,群益金鼎-桃園,2023-06-12,9189
3707,漢磊,21,3,18,群益金鼎-桃園,2023-06-12,9189
2382,廣達,39,22,17,群益金鼎-桃園,2023-06-12,9189
3046,建��,17,1,16,群益金鼎-桃園,2023-06-12,9189
5009,榮剛,38,22,16,群益金鼎-桃園,2023-06-12,9189
3374,精材,19,4,15,群益金鼎-桃園,2023-06-12,9189
3438,類比科,15,0,15,群益金鼎-桃園,2023-06-12,9189
2891,中信金,15,1,14,群益金鼎-桃園,2023-06-12,9189
2745,五福,14,0,14,群益金鼎-桃園,2023-06-12,9189
2705,六福,22,9,13,群益金鼎-桃園,2023-06-12,9189
2421,建準,39,26,13,群益金鼎-桃園,2023-06-12,9189
2392,正崴,12,0,12,群益金鼎-桃園,2023-06-12,9189
4564,元翎,11,0,11,群益金鼎-桃園,2023-06-12,9189
1471,首利,11,0,11,群益金鼎-桃園,2023-06-12,9189
3363,上詮,11,0,11,群益金鼎-桃園,2023-06-12,9189
1524,耿鼎,17,6,11,群益金鼎-桃園,2023-06-12,9189
1609,大亞,20,10,10,群益金鼎-桃園,2023-06-12,9189
9945,潤泰新,13,3,10,群益金鼎-桃園,2023-06-12,9189
00921,兆豐龍頭等權重,10,0,10,群益金鼎-桃園,2023-06-12,9189
00671R,富邦NASDAQ反1,10,0,10,群益金鼎-桃園,2023-06-12,9189
6546,正基,10,0,10,群益金鼎-桃園,2023-06-12,9189
00632R,元大台灣50反1,313,20,293,群益金鼎-桃園,2023-06-13,9189
2610,華航,426,272,154,群益金鼎-桃園,2023-06-13,9189
3481,群創,163,9,154,群益金鼎-桃園,2023-06-13,9189
00878,國泰永續高股息,193,70,123,群益金鼎-桃園,2023-06-13,9189
00642U,期元大S＆P石油,105,0,105,群益金鼎-桃園,2023-06-13,9189
1326,台化,67,4,63,群益金鼎-桃園,2023-06-13,9189
2449,京元電子,96,41,55,群益金鼎-桃園,2023-06-13,9189
00715L,期街口布蘭特正2,60,7,53,群益金鼎-桃園,2023-06-13,9189
2888,新光金,59,10,49,群益金鼎-桃園,2023-06-13,9189
8926,台汽電,35,1,34,群益金鼎-桃園,2023-06-13,9189
1609,大亞,37,4,33,群益金鼎-桃園,2023-06-13,9189
3498,陽程,45,13,32,群益金鼎-桃園,2023-06-13,9189
4552,力達-KY,30,0,30,群益金鼎-桃園,2023-06-13,9189
2425,承啟,31,2,29,群益金鼎-桃園,2023-06-13,9189
2883,凱基金,28,0,28,群益金鼎-桃園,2023-06-13,9189
00637L,元大滬深300正2,26,0,26,群益金鼎-桃園,2023-06-13,9189
00919,群益台灣精選高息,27,3,24,群益金鼎-桃園,2023-06-13,9189
1802,台玻,24,0,24,群益金鼎-桃園,2023-06-13,9189
2312,金寶,30,7,23,群益金鼎-桃園,2023-06-13,9189
2382,廣達,54,31,23,群益金鼎-桃園,2023-06-13,9189
9958,世紀鋼,22,0,22,群益金鼎-桃園,2023-06-13,9189
8234,新漢,23,1,22,群益金鼎-桃園,2023-06-13,9189
3494,誠研,20,0,20,群益金鼎-桃園,2023-06-13,9189
8114,振樺電,25,5,20,群益金鼎-桃園,2023-06-13,9189
2338,光罩,32,12,20,群益金鼎-桃園,2023-06-13,9189
3231,緯創,120,102,18,群益金鼎-桃園,2023-06-13,9189
8016,矽創,16,0,16,群益金鼎-桃園,2023-06-13,9189
2323,中環,33,17,16,群益金鼎-桃園,2023-06-13,9189
2890,永豐金,16,0,16,群益金鼎-桃園,2023-06-13,9189
2031,新光鋼,14,0,14,群益金鼎-桃園,2023-06-13,9189
3441,聯一光,20,7,13,群益金鼎-桃園,2023-06-13,9189
9904,寶成,15,2,13,群益金鼎-桃園,2023-06-13,9189
2885,元大金,12,0,12,群益金鼎-桃園,2023-06-13,9189
3356,奇偶,22,12,10,群益金鼎-桃園,2023-06-13,9189
3011,今皓,10,0,10,群益金鼎-桃園,2023-06-13,9189
2495,普安,10,0,10,群益金鼎-桃園,2023-06-13,9189
2543,皇昌,10,0,10,群益金鼎-桃園,2023-06-13,9189
2743,山富,11,1,10,群益金鼎-桃園,2023-06-13,9189
3209,全科,10,0,10,群益金鼎-桃園,2023-06-13,9189
2705,六福,18,8,10,群益金鼎-桃園,2023-06-13,9189
2881,富邦金,10,0,10,群益金鼎-桃園,2023-06-13,9189
6125,廣運,30,20,10,群益金鼎-桃園,2023-06-13,9189
5315,光聯,10,0,10,群益金鼎-桃園,2023-06-13,9189
5014,建錩,10,0,10,群益金鼎-桃園,2023-06-13,9189
6122,擎邦,26,16,10,群益金鼎-桃園,2023-06-13,9189
3682,亞太電,10,0,10,群益金鼎-桃園,2023-06-13,9189
5498,凱崴,10,0,10,群益金鼎-桃園,2023-06-13,9189
4744,皇將,10,0,10,群益金鼎-桃園,2023-06-13,9189
4510,高鋒,10,0,10,群益金鼎-桃園,2023-06-13,9189
8110,華東,10,0,10,群益金鼎-桃園,2023-06-13,9189
00706L,期元大S＆P日圓正2,110,0,110,群益金鼎-桃園,2023-06-14,9189
2409,友達,103,1,102,群益金鼎-桃園,2023-06-14,9189
3481,群創,52,8,44,群益金鼎-桃園,2023-06-14,9189
2382,廣達,56,16,40,群益金鼎-桃園,2023-06-14,9189
6122,擎邦,59,20,39,群益金鼎-桃園,2023-06-14,9189
4533,協易機,80,44,36,群益金鼎-桃園,2023-06-14,9189
2515,中工,35,0,35,群益金鼎-桃園,2023-06-14,9189
2356,英業達,270,236,34,群益金鼎-桃園,2023-06-14,9189
5014,建錩,30,0,30,群益金鼎-桃園,2023-06-14,9189
3078,僑威,73,44,29,群益金鼎-桃園,2023-06-14,9189
00893,國泰智能電動車,43,17,26,群益金鼎-桃園,2023-06-14,9189
1609,大亞,32,7,25,群益金鼎-桃園,2023-06-14,9189
4510,高鋒,43,18,25,群益金鼎-桃園,2023-06-14,9189
2104,國際中橡,25,0,25,群益金鼎-桃園,2023-06-14,9189
2888,新光金,31,7,24,群益金鼎-桃園,2023-06-14,9189
5706,鳳凰,40,17,23,群益金鼎-桃園,2023-06-14,9189
6167,久正,26,5,21,群益金鼎-桃園,2023-06-14,9189
8069,元太,40,20,20,群益金鼎-桃園,2023-06-14,9189
00751B,元大AAA至A公司債,20,0,20,群益金鼎-桃園,2023-06-14,9189
2609,陽明,24,5,19,群益金鼎-桃園,2023-06-14,9189
3308,聯德,21,3,18,群益金鼎-桃園,2023-06-14,9189
2439,美律,16,0,16,群益金鼎-桃園,2023-06-14,9189
00882,中信中國高股息,16,0,16,群益金鼎-桃園,2023-06-14,9189
6118,建達,21,5,16,群益金鼎-桃園,2023-06-14,9189
1504,東元,59,43,16,群益金鼎-桃園,2023-06-14,9189
6274,台燿,22,7,15,群益金鼎-桃園,2023-06-14,9189
3682,亞太電,15,0,15,群益金鼎-桃園,2023-06-14,9189
00919,群益台灣精選高息,18,3,15,群益金鼎-桃園,2023-06-14,9189
00713,元大台灣高息低波,15,0,15,群益金鼎-桃園,2023-06-14,9189
00924,復華S＆P500成長,14,0,14,群益金鼎-桃園,2023-06-14,9189
00927,群益半導體收益,13,0,13,群益金鼎-桃園,2023-06-14,9189
5340,建榮,15,2,13,群益金鼎-桃園,2023-06-14,9189
6768,志強-KY,13,0,13,群益金鼎-桃園,2023-06-14,9189
2201,裕隆,13,0,13,群益金鼎-桃園,2023-06-14,9189
00679B,元大美債20年,13,0,13,群益金鼎-桃園,2023-06-14,9189
5425,台半,16,3,13,群益金鼎-桃園,2023-06-14,9189
2206,三陽工業,16,4,12,群益金鼎-桃園,2023-06-14,9189
5905,南仁湖,12,0,12,群益金鼎-桃園,2023-06-14,9189
1529,樂事綠能,33,21,12,群益金鼎-桃園,2023-06-14,9189
5443,均豪,18,6,12,群益金鼎-桃園,2023-06-14,9189
9958,世紀鋼,11,0,11,群益金鼎-桃園,2023-06-14,9189
6546,正基,16,5,11,群益金鼎-桃園,2023-06-14,9189
00720B,元大投資級公司債,10,0,10,群益金鼎-桃園,2023-06-14,9189
2739,寒舍,10,0,10,群益金鼎-桃園,2023-06-14,9189
6187,萬潤,14,4,10,群益金鼎-桃園,2023-06-14,9189
2486,一詮,10,0,10,群益金鼎-桃園,2023-06-14,9189
4720,德淵,9,0,9,群益金鼎-桃園,2023-06-14,9189
2328,廣宇,9,0,9,群益金鼎-桃園,2023-06-14,9189
4157,太景*-KY,9,0,9,群益金鼎-桃園,2023-06-14,9189
6147,頎邦,10,1,9,群益金鼎-桃園,2023-06-14,9189
00632R,元大台灣50反1,352,5,347,群益金鼎-桃園,2023-06-15,9189
00706L,期元大S＆P日圓正2,145,0,145,群益金鼎-桃園,2023-06-15,9189
2888,新光金,129,5,124,群益金鼎-桃園,2023-06-15,9189
2356,英業達,234,121,113,群益金鼎-桃園,2023-06-15,9189
3481,群創,119,13,106,群益金鼎-桃園,2023-06-15,9189
2409,友達,110,10,100,群益金鼎-桃園,2023-06-15,9189
00919,群益台灣精選高息,94,1,93,群益金鼎-桃園,2023-06-15,9189
00715L,期街口布蘭特正2,152,99,53,群益金鼎-桃園,2023-06-15,9189
3013,晟銘電,66,24,42,群益金鼎-桃園,2023-06-15,9189
2405,輔信,32,0,32,群益金鼎-桃園,2023-06-15,9189
2332,友訊,53,21,32,群益金鼎-桃園,2023-06-15,9189
1210,大成,33,1,32,群益金鼎-桃園,2023-06-15,9189
9940,信義,31,0,31,群益金鼎-桃園,2023-06-15,9189
1721,三晃,27,0,27,群益金鼎-桃園,2023-06-15,9189
00712,復華富時不動產,29,2,27,群益金鼎-桃園,2023-06-15,9189
1815,富喬,32,5,27,群益金鼎-桃園,2023-06-15,9189
3289,宜特,23,1,22,群益金鼎-桃園,2023-06-15,9189
2363,矽統,22,0,22,群益金鼎-桃園,2023-06-15,9189
00720B,元大投資級公司債,36,15,21,群益金鼎-桃園,2023-06-15,9189
3055,蔚華科,24,3,21,群益金鼎-桃園,2023-06-15,9189
2388,威盛,23,6,17,群益金鼎-桃園,2023-06-15,9189
8076,伍豐,32,15,17,群益金鼎-桃園,2023-06-15,9189
2453,凌群,75,59,16,群益金鼎-桃園,2023-06-15,9189
2515,中工,15,0,15,群益金鼎-桃園,2023-06-15,9189
1519,華城,34,20,14,群益金鼎-桃園,2023-06-15,9189
2887,台新金,14,0,14,群益金鼎-桃園,2023-06-15,9189
2413,環科,14,0,14,群益金鼎-桃園,2023-06-15,9189
2468,華經,29,16,13,群益金鼎-桃園,2023-06-15,9189
4916,事欣科,13,1,12,群益金鼎-桃園,2023-06-15,9189
1611,中電,17,6,11,群益金鼎-桃園,2023-06-15,9189
00882,中信中國高股息,11,0,11,群益金鼎-桃園,2023-06-15,9189
2719,燦星旅,11,0,11,群益金鼎-桃園,2023-06-15,9189
3290,東浦,10,0,10,群益金鼎-桃園,2023-06-15,9189
1445,大宇,10,0,10,群益金鼎-桃園,2023-06-15,9189
1319,東陽,10,0,10,群益金鼎-桃園,2023-06-15,9189
2425,承啟,14,4,10,群益金鼎-桃園,2023-06-15,9189
00895,富邦未來車,10,0,10,群益金鼎-桃園,2023-06-15,9189
00645,富邦日本,10,0,10,群益金鼎-桃園,2023-06-15,9189
6175,立敦,10,0,10,群益金鼎-桃園,2023-06-15,9189
1471,首利,10,0,10,群益金鼎-桃園,2023-06-15,9189
2882,國泰金,10,0,10,群益金鼎-桃園,2023-06-15,9189
6142,友勁,10,0,10,群益金鼎-桃園,2023-06-15,9189
00713,元大台灣高息低波,10,0,10,群益金鼎-桃園,2023-06-15,9189
2402,毅嘉,10,1,9,群益金鼎-桃園,2023-06-15,9189
5425,台半,10,1,9,群益金鼎-桃園,2023-06-15,9189
2482,連宇,33,24,9,群益金鼎-桃園,2023-06-15,9189
2743,山富,9,0,9,群益金鼎-桃園,2023-06-15,9189
2609,陽明,17,8,9,群益金鼎-桃園,2023-06-15,9189
8033,雷虎,8,0,8,群益金鼎-桃園,2023-06-15,9189
00664R,國泰臺灣加權反1,9,1,8,群益金鼎-桃園,2023-06-15,9189
2409,友達,405,9,396,群益金鼎-桃園,2023-06-16,9189
3481,群創,183,26,157,群益金鼎-桃園,2023-06-16,9189
2301,光寶科,134,8,126,群益金鼎-桃園,2023-06-16,9189
2353,宏��,127,20,107,群益金鼎-桃園,2023-06-16,9189
2801,彰銀,105,0,105,群益金鼎-桃園,2023-06-16,9189
2610,華航,308,219,89,群益金鼎-桃園,2023-06-16,9189
2888,新光金,128,50,78,群益金鼎-桃園,2023-06-16,9189
2371,大同,122,45,77,群益金鼎-桃園,2023-06-16,9189
00919,群益台灣精選高息,88,12,76,群益金鼎-桃園,2023-06-16,9189
3706,神達,197,146,51,群益金鼎-桃園,2023-06-16,9189
6282,康舒,63,13,50,群益金鼎-桃園,2023-06-16,9189
8926,台汽電,42,1,41,群益金鼎-桃園,2023-06-16,9189
2014,中鴻,52,11,41,群益金鼎-桃園,2023-06-16,9189
00712,復華富時不動產,37,0,37,群益金鼎-桃園,2023-06-16,9189
1609,大亞,107,71,36,群益金鼎-桃園,2023-06-16,9189
3035,智原,53,18,35,群益金鼎-桃園,2023-06-16,9189
1605,華新,69,38,31,群益金鼎-桃園,2023-06-16,9189
5498,凱崴,30,0,30,群益金鼎-桃園,2023-06-16,9189
1326,台化,30,0,30,群益金鼎-桃園,2023-06-16,9189
6188,廣明,34,5,29,群益金鼎-桃園,2023-06-16,9189
1905,華紙,39,12,27,群益金鼎-桃園,2023-06-16,9189
3356,奇偶,26,0,26,群益金鼎-桃園,2023-06-16,9189
1314,中石化,27,1,26,群益金鼎-桃園,2023-06-16,9189
2401,凌陽,30,4,26,群益金鼎-桃園,2023-06-16,9189
9105,泰金寶-DR,25,0,25,群益金鼎-桃園,2023-06-16,9189
00888,永豐台灣ESG,22,0,22,群益金鼎-桃園,2023-06-16,9189
1907,永豐餘,23,3,20,群益金鼎-桃園,2023-06-16,9189
8931,大汽電,20,0,20,群益金鼎-桃園,2023-06-16,9189
1611,中電,30,10,20,群益金鼎-桃園,2023-06-16,9189
5324,士開,20,0,20,群益金鼎-桃園,2023-06-16,9189
1307,三芳,23,4,19,群益金鼎-桃園,2023-06-16,9189
1104,環泥,20,1,19,群益金鼎-桃園,2023-06-16,9189
2883,凱基金,18,0,18,群益金鼎-桃園,2023-06-16,9189
00752,中信中國50,18,0,18,群益金鼎-桃園,2023-06-16,9189
2913,農林,22,4,18,群益金鼎-桃園,2023-06-16,9189
6122,擎邦,21,3,18,群益金鼎-桃園,2023-06-16,9189
00924,復華S＆P500成長,16,0,16,群益金鼎-桃園,2023-06-16,9189
6248,沛波,16,0,16,群益金鼎-桃園,2023-06-16,9189
1319,東陽,15,0,15,群益金鼎-桃園,2023-06-16,9189
2367,燿華,15,0,15,群益金鼎-桃園,2023-06-16,9189
2363,矽統,14,0,14,群益金鼎-桃園,2023-06-16,9189
6191,精成科,17,3,14,群益金鼎-桃園,2023-06-16,9189
2382,廣達,32,18,14,群益金鼎-桃園,2023-06-16,9189
1101,台泥,15,1,14,群益金鼎-桃園,2023-06-16,9189
9945,潤泰新,13,0,13,群益金鼎-桃園,2023-06-16,9189
2630,亞航,21,8,13,群益金鼎-桃園,2023-06-16,9189
2369,菱生,25,12,13,群益金鼎-桃園,2023-06-16,9189
8076,伍豐,20,7,13,群益金鼎-桃園,2023-06-16,9189
6470,宇智,29,16,13,群益金鼎-桃園,2023-06-16,9189
6278,台表科,15,3,12,群益金鼎-桃園,2023-06-16,9189
6153,嘉聯益,100,0,100,群益金鼎-桃園,2023-06-19,9189
00706L,期元大S＆P日圓正2,68,0,68,群益金鼎-桃園,2023-06-19,9189
3017,奇鋐,78,12,66,群益金鼎-桃園,2023-06-19,9189
2610,華航,128,73,55,群益金鼎-桃園,2023-06-19,9189
6005,群益證,51,0,51,群益金鼎-桃園,2023-06-19,9189
2324,仁寶,50,8,42,群益金鼎-桃園,2023-06-19,9189
00673R,期元大S＆P原油反1,42,0,42,群益金鼎-桃園,2023-06-19,9189
2468,華經,49,11,38,群益金鼎-桃園,2023-06-19,9189
2104,國際中橡,34,1,33,群益金鼎-桃園,2023-06-19,9189
6116,彩晶,58,26,32,群益金鼎-桃園,2023-06-19,9189
00929,復華台灣科技優息,31,0,31,群益金鼎-桃園,2023-06-19,9189
1528,恩德,37,7,30,群益金鼎-桃園,2023-06-19,9189
8930,青鋼,30,0,30,群益金鼎-桃園,2023-06-19,9189
5498,凱崴,29,0,29,群益金鼎-桃園,2023-06-19,9189
9919,康那香,31,3,28,群益金鼎-桃園,2023-06-19,9189
2402,毅嘉,28,1,27,群益金鼎-桃園,2023-06-19,9189
2376,技嘉,31,5,26,群益金鼎-桃園,2023-06-19,9189
1605,華新,39,13,26,群益金鼎-桃園,2023-06-19,9189
2603,長榮,31,5,26,群益金鼎-桃園,2023-06-19,9189
2498,宏達電,26,1,25,群益金鼎-桃園,2023-06-19,9189
2388,威盛,33,9,24,群益金鼎-桃園,2023-06-19,9189
2883,凱基金,22,1,21,群益金鼎-桃園,2023-06-19,9189
8996,高力,21,0,21,群益金鼎-桃園,2023-06-19,9189
8277,商丞,20,0,20,群益金鼎-桃園,2023-06-19,9189
2459,敦吉,20,0,20,群益金鼎-桃園,2023-06-19,9189
2421,建準,35,15,20,群益金鼎-桃園,2023-06-19,9189
4720,德淵,19,0,19,群益金鼎-桃園,2023-06-19,9189
6185,幃翔,25,7,18,群益金鼎-桃園,2023-06-19,9189
4162,智擎,18,0,18,群益金鼎-桃園,2023-06-19,9189
6443,元晶,18,1,17,群益金鼎-桃園,2023-06-19,9189
8234,新漢,17,0,17,群益金鼎-桃園,2023-06-19,9189
3006,晶豪科,19,2,17,群益金鼎-桃園,2023-06-19,9189
2312,金寶,68,52,16,群益金鼎-桃園,2023-06-19,9189
6120,達運,61,45,16,群益金鼎-桃園,2023-06-19,9189
3027,盛達,16,1,15,群益金鼎-桃園,2023-06-19,9189
2323,中環,45,30,15,群益金鼎-桃園,2023-06-19,9189
1101,台泥,17,2,15,群益金鼎-桃園,2023-06-19,9189
1513,中興電,96,82,14,群益金鼎-桃園,2023-06-19,9189
00752,中信中國50,14,0,14,群益金鼎-桃園,2023-06-19,9189
8050,廣積,12,0,12,群益金鼎-桃園,2023-06-19,9189
5907,大洋-KY,12,0,12,群益金鼎-桃園,2023-06-19,9189
1584,精剛,12,0,12,群益金鼎-桃園,2023-06-19,9189
1802,台玻,14,3,11,群益金鼎-桃園,2023-06-19,9189
2609,陽明,24,13,11,群益金鼎-桃園,2023-06-19,9189
6191,精成科,13,2,11,群益金鼎-桃園,2023-06-19,9189
00713,元大台灣高息低波,12,1,11,群益金鼎-桃園,2023-06-19,9189
2353,宏��,11,1,10,群益金鼎-桃園,2023-06-19,9189
1710,東聯,10,0,10,群益金鼎-桃園,2023-06-19,9189
1514,亞力,20,10,10,群益金鼎-桃園,2023-06-19,9189
3189,景碩,11,1,10,群益金鼎-桃園,2023-06-19,9189
2356,英業達,139,15,124,群益金鼎-桃園,2023-06-20,9189
5498,凱崴,100,0,100,群益金鼎-桃園,2023-06-20,9189
00706L,期元大S＆P日圓正2,100,0,100,群益金鼎-桃園,2023-06-20,9189
2610,華航,202,104,98,群益金鼎-桃園,2023-06-20,9189
5009,榮剛,93,1,92,群益金鼎-桃園,2023-06-20,9189
1519,華城,72,10,62,群益金鼎-桃園,2023-06-20,9189
1471,首利,52,1,51,群益金鼎-桃園,2023-06-20,9189
2618,長榮航,65,15,50,群益金鼎-桃園,2023-06-20,9189
5425,台半,67,18,49,群益金鼎-桃園,2023-06-20,9189
00878,國泰永續高股息,64,16,48,群益金鼎-桃園,2023-06-20,9189
1103,嘉泥,73,31,42,群益金鼎-桃園,2023-06-20,9189
2883,凱基金,37,1,36,群益金鼎-桃園,2023-06-20,9189
3682,亞太電,35,0,35,群益金鼎-桃園,2023-06-20,9189
5225,東科-KY,34,1,33,群益金鼎-桃園,2023-06-20,9189
2337,旺宏,34,5,29,群益金鼎-桃園,2023-06-20,9189
6290,良維,43,15,28,群益金鼎-桃園,2023-06-20,9189
2634,漢翔,80,52,28,群益金鼎-桃園,2023-06-20,9189
2104,國際中橡,25,0,25,群益金鼎-桃園,2023-06-20,9189
1101,台泥,21,0,21,群益金鼎-桃園,2023-06-20,9189
3712,永崴投控,20,0,20,群益金鼎-桃園,2023-06-20,9189
3325,旭品,31,11,20,群益金鼎-桃園,2023-06-20,9189
8222,寶一,35,16,19,群益金鼎-桃園,2023-06-20,9189
2421,建準,36,19,17,群益金鼎-桃園,2023-06-20,9189
4564,元翎,21,4,17,群益金鼎-桃園,2023-06-20,9189
00712,復華富時不動產,17,1,16,群益金鼎-桃園,2023-06-20,9189
2382,廣達,24,9,15,群益金鼎-桃園,2023-06-20,9189
2845,遠東銀,15,0,15,群益金鼎-桃園,2023-06-20,9189
3205,佰研,15,1,14,群益金鼎-桃園,2023-06-20,9189
6142,友勁,14,0,14,群益金鼎-桃園,2023-06-20,9189
2201,裕隆,17,3,14,群益金鼎-桃園,2023-06-20,9189
3006,晶豪科,13,0,13,群益金鼎-桃園,2023-06-20,9189
3013,晟銘電,32,19,13,群益金鼎-桃園,2023-06-20,9189
00901,永豐智能車供應鏈,13,0,13,群益金鼎-桃園,2023-06-20,9189
1584,精剛,33,20,13,群益金鼎-桃園,2023-06-20,9189
8996,高力,13,0,13,群益金鼎-桃園,2023-06-20,9189
2454,聯發科,14,1,13,群益金鼎-桃園,2023-06-20,9189
6282,康舒,18,6,12,群益金鼎-桃園,2023-06-20,9189
2515,中工,12,0,12,群益金鼎-桃園,2023-06-20,9189
1612,宏泰,37,25,12,群益金鼎-桃園,2023-06-20,9189
2609,陽明,16,4,12,群益金鼎-桃園,2023-06-20,9189
7402,邑錡,21,9,12,群益金鼎-桃園,2023-06-20,9189
2328,廣宇,12,1,11,群益金鼎-桃園,2023-06-20,9189
2312,金寶,15,4,11,群益金鼎-桃園,2023-06-20,9189
2603,長榮,13,3,10,群益金鼎-桃園,2023-06-20,9189
1742,台蠟,10,0,10,群益金鼎-桃園,2023-06-20,9189
00892,富邦台灣半導體,10,0,10,群益金鼎-桃園,2023-06-20,9189
6170,統振,10,0,10,群益金鼎-桃園,2023-06-20,9189
3293,鈊象,11,1,10,群益金鼎-桃園,2023-06-20,9189
00680L,元大美債20正2,10,0,10,群益金鼎-桃園,2023-06-20,9189
4716,大立,10,0,10,群益金鼎-桃園,2023-06-20,9189
2371,大同,337,54,283,群益金鼎-桃園,2023-06-21,9189
3481,群創,221,137,84,群益金鼎-桃園,2023-06-21,9189
2313,華通,80,0,80,群益金鼎-桃園,2023-06-21,9189
6125,廣運,93,17,76,群益金鼎-桃園,2023-06-21,9189
00632R,元大台灣50反1,75,5,70,群益金鼎-桃園,2023-06-21,9189
2618,長榮航,122,53,69,群益金鼎-桃園,2023-06-21,9189
2303,聯電,95,43,52,群益金鼎-桃園,2023-06-21,9189
2609,陽明,44,5,39,群益金鼎-桃園,2023-06-21,9189
1519,華城,50,11,39,群益金鼎-桃園,2023-06-21,9189
4916,事欣科,77,39,38,群益金鼎-桃園,2023-06-21,9189
5425,台半,37,5,32,群益金鼎-桃園,2023-06-21,9189
00919,群益台灣精選高息,60,30,30,群益金鼎-桃園,2023-06-21,9189
9950,萬國通,30,0,30,群益金鼎-桃園,2023-06-21,9189
2705,六福,56,27,29,群益金鼎-桃園,2023-06-21,9189
1711,永光,28,0,28,群益金鼎-桃園,2023-06-21,9189
2603,長榮,35,8,27,群益金鼎-桃園,2023-06-21,9189
2634,漢翔,101,76,25,群益金鼎-桃園,2023-06-21,9189
6282,康舒,47,24,23,群益金鼎-桃園,2023-06-21,9189
1609,大亞,74,52,22,群益金鼎-桃園,2023-06-21,9189
2302,麗正,22,0,22,群益金鼎-桃園,2023-06-21,9189
1605,華新,22,1,21,群益金鼎-桃園,2023-06-21,9189
2369,菱生,20,0,20,群益金鼎-桃園,2023-06-21,9189
3038,全台,31,11,20,群益金鼎-桃園,2023-06-21,9189
2337,旺宏,21,1,20,群益金鼎-桃園,2023-06-21,9189
3325,旭品,54,35,19,群益金鼎-桃園,2023-06-21,9189
3094,聯傑,19,0,19,群益金鼎-桃園,2023-06-21,9189
2888,新光金,28,11,17,群益金鼎-桃園,2023-06-21,9189
2425,承啟,16,1,15,群益金鼎-桃園,2023-06-21,9189
3706,神達,21,6,15,群益金鼎-桃園,2023-06-21,9189
00753L,中信中國50正2,15,0,15,群益金鼎-桃園,2023-06-21,9189
5364,力麗店,13,0,13,群益金鼎-桃園,2023-06-21,9189
1216,統一,12,0,12,群益金鼎-桃園,2023-06-21,9189
2399,映泰,16,4,12,群益金鼎-桃園,2023-06-21,9189
2615,萬海,11,0,11,群益金鼎-桃園,2023-06-21,9189
9907,統一實,10,0,10,群益金鼎-桃園,2023-06-21,9189
2838A,聯邦銀甲特,10,0,10,群益金鼎-桃園,2023-06-21,9189
2547,日勝生,10,0,10,群益金鼎-桃園,2023-06-21,9189
3380,明泰,10,0,10,群益金鼎-桃園,2023-06-21,9189
8024,佑華,10,0,10,群益金鼎-桃園,2023-06-21,9189
2471,資通,12,2,10,群益金鼎-桃園,2023-06-21,9189
6275,元山,21,11,10,群益金鼎-桃園,2023-06-21,9189
3689,湧德,10,0,10,群益金鼎-桃園,2023-06-21,9189
3682,亞太電,10,0,10,群益金鼎-桃園,2023-06-21,9189
8438,昶昕,10,0,10,群益金鼎-桃園,2023-06-21,9189
1810,和成,12,2,10,群益金鼎-桃園,2023-06-21,9189
2365,昆盈,10,0,10,群益金鼎-桃園,2023-06-21,9189
1734,杏輝,10,0,10,群益金鼎-桃園,2023-06-21,9189
6142,友勁,9,0,9,群益金鼎-桃園,2023-06-21,9189
4543,萬在,12,3,9,群益金鼎-桃園,2023-06-21,9189
8927,北基,9,0,9,群益金鼎-桃園,2023-06-21,9189
5498,凱崴,221,30,191,群益金鼎-桃園,2023-06-26,9189
00706L,期元大S＆P日圓正2,158,0,158,群益金鼎-桃園,2023-06-26,9189
00637L,元大滬深300正2,158,15,143,群益金鼎-桃園,2023-06-26,9189
2888,新光金,110,5,105,群益金鼎-桃園,2023-06-26,9189
2356,英業達,110,9,101,群益金鼎-桃園,2023-06-26,9189
3481,群創,118,35,83,群益金鼎-桃園,2023-06-26,9189
00715L,期街口布蘭特正2,82,0,82,群益金鼎-桃園,2023-06-26,9189
2610,華航,105,24,81,群益金鼎-桃園,2023-06-26,9189
00919,群益台灣精選高息,64,0,64,群益金鼎-桃園,2023-06-26,9189
6005,群益證,51,9,42,群益金鼎-桃園,2023-06-26,9189
2409,友達,64,26,38,群益金鼎-桃園,2023-06-26,9189
6282,康舒,43,8,35,群益金鼎-桃園,2023-06-26,9189
1101,台泥,50,19,31,群益金鼎-桃園,2023-06-26,9189
8358,金居,43,12,31,群益金鼎-桃園,2023-06-26,9189
2308,台達電,39,11,28,群益金鼎-桃園,2023-06-26,9189
3372,典範,26,0,26,群益金鼎-桃園,2023-06-26,9189
1802,台玻,37,12,25,群益金鼎-桃園,2023-06-26,9189
1605,華新,30,6,24,群益金鼎-桃園,2023-06-26,9189
5324,士開,24,0,24,群益金鼎-桃園,2023-06-26,9189
2382,廣達,32,9,23,群益金鼎-桃園,2023-06-26,9189
5465,富驊,41,18,23,群益金鼎-桃園,2023-06-26,9189
2618,長榮航,46,24,22,群益金鼎-桃園,2023-06-26,9189
2340,台亞,41,20,21,群益金鼎-桃園,2023-06-26,9189
6180,橘子,25,4,21,群益金鼎-桃園,2023-06-26,9189
4938,和碩,21,0,21,群益金鼎-桃園,2023-06-26,9189
00753L,中信中國50正2,30,10,20,群益金鼎-桃園,2023-06-26,9189
8930,青鋼,20,0,20,群益金鼎-桃園,2023-06-26,9189
6285,啟��,20,0,20,群益金鼎-桃園,2023-06-26,9189
2349,錸德,20,0,20,群益金鼎-桃園,2023-06-26,9189
00882,中信中國高股息,19,0,19,群益金鼎-桃園,2023-06-26,9189
3032,偉訓,25,7,18,群益金鼎-桃園,2023-06-26,9189
2421,建準,19,1,18,群益金鼎-桃園,2023-06-26,9189
3673,TPK-KY,22,5,17,群益金鼎-桃園,2023-06-26,9189
00893,國泰智能電動車,17,2,15,群益金鼎-桃園,2023-06-26,9189
00642U,期元大S＆P石油,15,0,15,群益金鼎-桃園,2023-06-26,9189
2371,大同,38,23,15,群益金鼎-桃園,2023-06-26,9189
4562,穎漢,12,0,12,群益金鼎-桃園,2023-06-26,9189
2408,南亞科,12,0,12,群益金鼎-桃園,2023-06-26,9189
2324,仁寶,12,0,12,群益金鼎-桃園,2023-06-26,9189
3013,晟銘電,44,33,11,群益金鼎-桃園,2023-06-26,9189
4720,德淵,11,0,11,群益金鼎-桃園,2023-06-26,9189
2609,陽明,19,8,11,群益金鼎-桃園,2023-06-26,9189
2457,飛宏,13,2,11,群益金鼎-桃園,2023-06-26,9189
1905,華紙,51,40,11,群益金鼎-桃園,2023-06-26,9189
8210,勤誠,12,2,10,群益金鼎-桃園,2023-06-26,9189
3055,蔚華科,10,0,10,群益金鼎-桃園,2023-06-26,9189
4979,華星光,14,4,10,群益金鼎-桃園,2023-06-26,9189
2867,三商壽,10,0,10,群益金鼎-桃園,2023-06-26,9189
00680L,元大美債20正2,15,5,10,群益金鼎-桃園,2023-06-26,9189
1326,台化,10,0,10,群益金鼎-桃園,2023-06-26,9189
2888,新光金,161,2,159,群益金鼎-桃園,2023-06-27,9189
2303,聯電,113,2,111,群益金鼎-桃園,2023-06-27,9189
2610,華航,176,66,110,群益金鼎-桃園,2023-06-27,9189
2371,大同,147,53,94,群益金鼎-桃園,2023-06-27,9189
2356,英業達,75,11,64,群益金鼎-桃園,2023-06-27,9189
1101,台泥,62,1,61,群益金鼎-桃園,2023-06-27,9189
8926,台汽電,58,0,58,群益金鼎-桃園,2023-06-27,9189
2409,友達,70,15,55,群益金鼎-桃園,2023-06-27,9189
2323,中環,130,84,46,群益金鼎-桃園,2023-06-27,9189
6005,群益證,52,6,46,群益金鼎-桃園,2023-06-27,9189
4526,東台,41,1,40,群益金鼎-桃園,2023-06-27,9189
2618,長榮航,92,53,39,群益金鼎-桃園,2023-06-27,9189
1605,華新,49,12,37,群益金鼎-桃園,2023-06-27,9189
2883,凱基金,33,2,31,群益金鼎-桃園,2023-06-27,9189
2317,鴻海,39,8,31,群益金鼎-桃園,2023-06-27,9189
1504,東元,35,4,31,群益金鼎-桃園,2023-06-27,9189
2365,昆盈,28,1,27,群益金鼎-桃園,2023-06-27,9189
00715L,期街口布蘭特正2,30,4,26,群益金鼎-桃園,2023-06-27,9189
3038,全台,40,15,25,群益金鼎-桃園,2023-06-27,9189
2369,菱生,25,0,25,群益金鼎-桃園,2023-06-27,9189
2402,毅嘉,26,2,24,群益金鼎-桃園,2023-06-27,9189
8415,大國鋼,23,0,23,群益金鼎-桃園,2023-06-27,9189
00885,富邦越南,20,0,20,群益金鼎-桃園,2023-06-27,9189
6438,迅得,20,0,20,群益金鼎-桃園,2023-06-27,9189
2634,漢翔,33,14,19,群益金鼎-桃園,2023-06-27,9189
2027,大成鋼,30,11,19,群益金鼎-桃園,2023-06-27,9189
1514,亞力,26,7,19,群益金鼎-桃園,2023-06-27,9189
3231,緯創,60,42,18,群益金鼎-桃園,2023-06-27,9189
1734,杏輝,27,9,18,群益金鼎-桃園,2023-06-27,9189
6470,宇智,40,22,18,群益金鼎-桃園,2023-06-27,9189
4564,元翎,23,6,17,群益金鼎-桃園,2023-06-27,9189
1609,大亞,34,17,17,群益金鼎-桃園,2023-06-27,9189
2408,南亞科,15,0,15,群益金鼎-桃園,2023-06-27,9189
3047,訊舟,18,3,15,群益金鼎-桃園,2023-06-27,9189
2388,威盛,16,1,15,群益金鼎-桃園,2023-06-27,9189
6185,幃翔,15,2,13,群益金鼎-桃園,2023-06-27,9189
2515,中工,13,0,13,群益金鼎-桃園,2023-06-27,9189
2886,兆豐金,12,0,12,群益金鼎-桃園,2023-06-27,9189
4147,中裕,16,4,12,群益金鼎-桃園,2023-06-27,9189
3128,昇銳,30,18,12,群益金鼎-桃園,2023-06-27,9189
6282,康舒,14,3,11,群益金鼎-桃園,2023-06-27,9189
5465,富驊,13,2,11,群益金鼎-桃園,2023-06-27,9189
2009,第一銅,11,0,11,群益金鼎-桃園,2023-06-27,9189
6191,精成科,26,15,11,群益金鼎-桃園,2023-06-27,9189
6271,同欣電,16,5,11,群益金鼎-桃園,2023-06-27,9189
8070,長華*,12,1,11,群益金鼎-桃園,2023-06-27,9189
3498,陽程,11,0,11,群益金鼎-桃園,2023-06-27,9189
1304,台聚,11,0,11,群益金鼎-桃園,2023-06-27,9189
6139,亞翔,11,0,11,群益金鼎-桃園,2023-06-27,9189
3447,展達,11,0,11,群益金鼎-桃園,2023-06-27,9189
00715L,期街口布蘭特正2,262,0,262,群益金鼎-桃園,2023-06-28,9189
2888,新光金,189,0,189,群益金鼎-桃園,2023-06-28,9189
00706L,期元大S＆P日圓正2,95,0,95,群益金鼎-桃園,2023-06-28,9189
00642U,期元大S＆P石油,82,0,82,群益金鼎-桃園,2023-06-28,9189
1605,華新,66,11,55,群益金鼎-桃園,2023-06-28,9189
6546,正基,32,0,32,群益金鼎-桃園,2023-06-28,9189
2457,飛宏,33,2,31,群益金鼎-桃園,2023-06-28,9189
2734,易飛網,28,1,27,群益金鼎-桃園,2023-06-28,9189
2371,大同,44,20,24,群益金鼎-桃園,2023-06-28,9189
4175,杏一,20,0,20,群益金鼎-桃園,2023-06-28,9189
2845,遠東銀,20,0,20,群益金鼎-桃園,2023-06-28,9189
1802,台玻,20,1,19,群益金鼎-桃園,2023-06-28,9189
5009,榮剛,40,21,19,群益金鼎-桃園,2023-06-28,9189
1314,中石化,18,1,17,群益金鼎-桃園,2023-06-28,9189
1609,大亞,17,0,17,群益金鼎-桃園,2023-06-28,9189
8021,尖點,16,0,16,群益金鼎-桃園,2023-06-28,9189
3037,欣興,15,0,15,群益金鼎-桃園,2023-06-28,9189
2427,三商電,16,1,15,群益金鼎-桃園,2023-06-28,9189
1528,恩德,21,6,15,群益金鼎-桃園,2023-06-28,9189
2419,仲琦,15,0,15,群益金鼎-桃園,2023-06-28,9189
1301,台塑,13,0,13,群益金鼎-桃園,2023-06-28,9189
2405,輔信,22,9,13,群益金鼎-桃園,2023-06-28,9189
6461,益得,12,0,12,群益金鼎-桃園,2023-06-28,9189
2892,第一金,11,0,11,群益金鼎-桃園,2023-06-28,9189
2603,長榮,16,5,11,群益金鼎-桃園,2023-06-28,9189
2356,英業達,30,19,11,群益金鼎-桃園,2023-06-28,9189
1326,台化,11,0,11,群益金鼎-桃園,2023-06-28,9189
2337,旺宏,11,0,11,群益金鼎-桃園,2023-06-28,9189
4121,優盛,14,3,11,群益金鼎-桃園,2023-06-28,9189
5258,虹堡,12,2,10,群益金鼎-桃園,2023-06-28,9189
8926,台汽電,11,1,10,群益金鼎-桃園,2023-06-28,9189
1513,中興電,32,22,10,群益金鼎-桃園,2023-06-28,9189
1216,統一,10,0,10,群益金鼎-桃園,2023-06-28,9189
2344,華邦電,10,0,10,群益金鼎-桃園,2023-06-28,9189
6179,亞通,11,1,10,群益金鼎-桃園,2023-06-28,9189
5531,鄉林,10,0,10,群益金鼎-桃園,2023-06-28,9189
2014,中鴻,9,0,9,群益金鼎-桃園,2023-06-28,9189
2820,華票,9,0,9,群益金鼎-桃園,2023-06-28,9189
3189,景碩,11,2,9,群益金鼎-桃園,2023-06-28,9189
5353,台林,10,1,9,群益金鼎-桃園,2023-06-28,9189
1529,樂事綠能,12,4,8,群益金鼎-桃園,2023-06-28,9189
6125,廣運,11,3,8,群益金鼎-桃園,2023-06-28,9189
2913,農林,8,0,8,群益金鼎-桃園,2023-06-28,9189
6169,昱泉,13,5,8,群益金鼎-桃園,2023-06-28,9189
6187,萬潤,8,0,8,群益金鼎-桃園,2023-06-28,9189
2705,六福,14,6,8,群益金鼎-桃園,2023-06-28,9189
2736,富野,13,6,7,群益金鼎-桃園,2023-06-28,9189
2027,大成鋼,7,0,7,群益金鼎-桃園,2023-06-28,9189
5469,瀚宇博,10,3,7,群益金鼎-桃園,2023-06-28,9189
3664,安瑞-KY,6,0,6,群益金鼎-桃園,2023-06-28,9189
1605,華新,125,11,114,群益金鼎-桃園,2023-06-29,9189
00632R,元大台灣50反1,111,31,80,群益金鼎-桃園,2023-06-29,9189
4526,東台,86,17,69,群益金鼎-桃園,2023-06-29,9189
00706L,期元大S＆P日圓正2,59,0,59,群益金鼎-桃園,2023-06-29,9189
1528,恩德,45,5,40,群益金鼎-桃園,2023-06-29,9189
2618,長榮航,111,74,37,群益金鼎-桃園,2023-06-29,9189
3481,群創,110,73,37,群益金鼎-桃園,2023-06-29,9189
00878,國泰永續高股息,44,8,36,群益金鼎-桃園,2023-06-29,9189
2371,大同,104,68,36,群益金鼎-桃園,2023-06-29,9189
1721,三晃,35,0,35,群益金鼎-桃園,2023-06-29,9189
00891,中信關鍵半導體,35,0,35,群益金鼎-桃園,2023-06-29,9189
2609,陽明,41,7,34,群益金鼎-桃園,2023-06-29,9189
00715L,期街口布蘭特正2,67,33,34,群益金鼎-桃園,2023-06-29,9189
2883,凱基金,32,0,32,群益金鼎-桃園,2023-06-29,9189
0056,元大高股息,32,2,30,群益金鼎-桃園,2023-06-29,9189
2369,菱生,30,1,29,群益金鼎-桃園,2023-06-29,9189
00637L,元大滬深300正2,40,15,25,群益金鼎-桃園,2023-06-29,9189
2634,漢翔,25,2,23,群益金鼎-桃園,2023-06-29,9189
00919,群益台灣精選高息,23,1,22,群益金鼎-桃園,2023-06-29,9189
2301,光寶科,22,0,22,群益金鼎-桃園,2023-06-29,9189
1314,中石化,20,0,20,群益金鼎-桃園,2023-06-29,9189
2867,三商壽,20,0,20,群益金鼎-桃園,2023-06-29,9189
8222,寶一,21,4,17,群益金鼎-桃園,2023-06-29,9189
1609,大亞,24,7,17,群益金鼎-桃園,2023-06-29,9189
00712,復華富時不動產,16,0,16,群益金鼎-桃園,2023-06-29,9189
2915,潤泰全,15,0,15,群益金鼎-桃園,2023-06-29,9189
8255,朋程,21,7,14,群益金鼎-桃園,2023-06-29,9189
3038,全台,21,7,14,群益金鼎-桃園,2023-06-29,9189
4967,十銓,33,19,14,群益金鼎-桃園,2023-06-29,9189
6112,邁達特,24,10,14,群益金鼎-桃園,2023-06-29,9189
2388,威盛,17,4,13,群益金鼎-桃園,2023-06-29,9189
4958,臻鼎-KY,13,0,13,群益金鼎-桃園,2023-06-29,9189
4168,醣聯,13,0,13,群益金鼎-桃園,2023-06-29,9189
2603,長榮,42,30,12,群益金鼎-桃園,2023-06-29,9189
2888,新光金,12,0,12,群益金鼎-桃園,2023-06-29,9189
2457,飛宏,14,3,11,群益金鼎-桃園,2023-06-29,9189
3011,今皓,15,4,11,群益金鼎-桃園,2023-06-29,9189
2027,大成鋼,11,0,11,群益金鼎-桃園,2023-06-29,9189
00720B,元大投資級公司債,11,0,11,群益金鼎-桃園,2023-06-29,9189
00753L,中信中國50正2,11,0,11,群益金鼎-桃園,2023-06-29,9189
8446,華研,11,1,10,群益金鼎-桃園,2023-06-29,9189
3234,光環,10,0,10,群益金鼎-桃園,2023-06-29,9189
6142,友勁,11,1,10,群益金鼎-桃園,2023-06-29,9189
00892,富邦台灣半導體,10,0,10,群益金鼎-桃園,2023-06-29,9189
6139,亞翔,10,0,10,群益金鼎-桃園,2023-06-29,9189
1616,億泰,10,0,10,群益金鼎-桃園,2023-06-29,9189
2892,第一金,10,0,10,群益金鼎-桃園,2023-06-29,9189
6719,力智,10,0,10,群益金鼎-桃園,2023-06-29,9189
4533,協易機,10,0,10,群益金鼎-桃園,2023-06-29,9189
6517,保勝光學,10,0,10,群益金鼎-桃園,2023-06-29,9189
2888,新光金,102,0,102,群益金鼎-桃園,2023-06-30,9189
6142,友勁,103,4,99,群益金鼎-桃園,2023-06-30,9189
2515,中工,62,2,60,群益金鼎-桃園,2023-06-30,9189
2368,金像電,62,7,55,群益金鼎-桃園,2023-06-30,9189
2344,華邦電,57,11,46,群益金鼎-桃園,2023-06-30,9189
4526,東台,37,0,37,群益金鼎-桃園,2023-06-30,9189
2892,第一金,31,0,31,群益金鼎-桃園,2023-06-30,9189
1760,寶齡富錦,29,0,29,群益金鼎-桃園,2023-06-30,9189
00680L,元大美債20正2,29,1,28,群益金鼎-桃園,2023-06-30,9189
2603,長榮,87,60,27,群益金鼎-桃園,2023-06-30,9189
4167,松瑞藥,26,1,25,群益金鼎-桃園,2023-06-30,9189
4168,醣聯,37,12,25,群益金鼎-桃園,2023-06-30,9189
4164,承業醫,29,5,24,群益金鼎-桃園,2023-06-30,9189
3481,群創,44,20,24,群益金鼎-桃園,2023-06-30,9189
1313,聯成,24,0,24,群益金鼎-桃園,2023-06-30,9189
2317,鴻海,37,15,22,群益金鼎-桃園,2023-06-30,9189
2427,三商電,23,2,21,群益金鼎-桃園,2023-06-30,9189
00927,群益半導體收益,20,0,20,群益金鼎-桃園,2023-06-30,9189
2883,凱基金,18,0,18,群益金鼎-桃園,2023-06-30,9189
4116,明基醫,18,0,18,群益金鼎-桃園,2023-06-30,9189
2408,南亞科,18,0,18,群益金鼎-桃園,2023-06-30,9189
2913,農林,20,3,17,群益金鼎-桃園,2023-06-30,9189
1533,車王電,30,14,16,群益金鼎-桃園,2023-06-30,9189
3207,耀勝,26,11,15,群益金鼎-桃園,2023-06-30,9189
4121,優盛,20,5,15,群益金鼎-桃園,2023-06-30,9189
00878,國泰永續高股息,24,9,15,群益金鼎-桃園,2023-06-30,9189
6185,幃翔,24,10,14,群益金鼎-桃園,2023-06-30,9189
2332,友訊,22,8,14,群益金鼎-桃園,2023-06-30,9189
2610,華航,70,57,13,群益金鼎-桃園,2023-06-30,9189
4157,太景*-KY,17,4,13,群益金鼎-桃園,2023-06-30,9189
4128,中天,13,0,13,群益金鼎-桃園,2023-06-30,9189
8050,廣積,36,23,13,群益金鼎-桃園,2023-06-30,9189
5258,虹堡,15,3,12,群益金鼎-桃園,2023-06-30,9189
2887,台新金,12,0,12,群益金鼎-桃園,2023-06-30,9189
6148,驊宏資,16,5,11,群益金鼎-桃園,2023-06-30,9189
2369,菱生,11,0,11,群益金鼎-桃園,2023-06-30,9189
2412,中華電,17,6,11,群益金鼎-桃園,2023-06-30,9189
1513,中興電,40,29,11,群益金鼎-桃園,2023-06-30,9189
6153,嘉聯益,31,21,10,群益金鼎-桃園,2023-06-30,9189
6284,佳邦,10,0,10,群益金鼎-桃園,2023-06-30,9189
3447,展達,15,5,10,群益金鼎-桃園,2023-06-30,9189
00919,群益台灣精選高息,10,0,10,群益金鼎-桃園,2023-06-30,9189
4934,太極,10,0,10,群益金鼎-桃園,2023-06-30,9189
3576,聯合再生,10,0,10,群益金鼎-桃園,2023-06-30,9189
2365,昆盈,10,0,10,群益金鼎-桃園,2023-06-30,9189
6016,康和證,10,0,10,群益金鼎-桃園,2023-06-30,9189
3673,TPK-KY,10,0,10,群益金鼎-桃園,2023-06-30,9189
3372,典範,10,0,10,群益金鼎-桃園,2023-06-30,9189
4939,亞電,10,0,10,群益金鼎-桃園,2023-06-30,9189
2442,新美齊,10,0,10,群益金鼎-桃園,2023-06-30,9189
2888,新光金,109,1,108,群益金鼎-桃園,2023-07-03,9189
6217,中探針,99,10,89,群益金鼎-桃園,2023-07-03,9189
2409,友達,72,0,72,群益金鼎-桃園,2023-07-03,9189
1722,台肥,50,0,50,群益金鼎-桃園,2023-07-03,9189
2845,遠東銀,50,2,48,群益金鼎-桃園,2023-07-03,9189
6770,力積電,51,3,48,群益金鼎-桃園,2023-07-03,9189
2382,廣達,62,21,41,群益金鼎-桃園,2023-07-03,9189
3231,緯創,106,71,35,群益金鼎-桃園,2023-07-03,9189
3105,穩懋,37,5,32,群益金鼎-桃園,2023-07-03,9189
0056,元大高股息,47,16,31,群益金鼎-桃園,2023-07-03,9189
3078,僑威,55,25,30,群益金鼎-桃園,2023-07-03,9189
1314,中石化,34,5,29,群益金鼎-桃園,2023-07-03,9189
2486,一詮,30,5,25,群益金鼎-桃園,2023-07-03,9189
3666,光耀,25,0,25,群益金鼎-桃園,2023-07-03,9189
4934,太極,25,0,25,群益金鼎-桃園,2023-07-03,9189
5309,系統電,30,5,25,群益金鼎-桃園,2023-07-03,9189
1609,大亞,37,13,24,群益金鼎-桃園,2023-07-03,9189
2365,昆盈,25,1,24,群益金鼎-桃園,2023-07-03,9189
2354,鴻準,23,0,23,群益金鼎-桃園,2023-07-03,9189
00901,永豐智能車供應鏈,22,0,22,群益金鼎-桃園,2023-07-03,9189
4906,正文,29,7,22,群益金鼎-桃園,2023-07-03,9189
1528,恩德,30,10,20,群益金鼎-桃園,2023-07-03,9189
2369,菱生,20,0,20,群益金鼎-桃園,2023-07-03,9189
2481,強茂,21,1,20,群益金鼎-桃園,2023-07-03,9189
2887,台新金,20,1,19,群益金鼎-桃園,2023-07-03,9189
8926,台汽電,24,6,18,群益金鼎-桃園,2023-07-03,9189
2610,華航,38,20,18,群益金鼎-桃園,2023-07-03,9189
8450,霹靂,17,0,17,群益金鼎-桃園,2023-07-03,9189
2330,台積電,19,3,16,群益金鼎-桃園,2023-07-03,9189
4538,大詠城,18,2,16,群益金鼎-桃園,2023-07-03,9189
4167,松瑞藥,16,0,16,群益金鼎-桃園,2023-07-03,9189
2201,裕隆,19,3,16,群益金鼎-桃園,2023-07-03,9189
4915,致伸,17,1,16,群益金鼎-桃園,2023-07-03,9189
1464,得力,15,0,15,群益金鼎-桃園,2023-07-03,9189
3046,建��,16,1,15,群益金鼎-桃園,2023-07-03,9189
6142,友勁,20,6,14,群益金鼎-桃園,2023-07-03,9189
1514,亞力,29,16,13,群益金鼎-桃園,2023-07-03,9189
2419,仲琦,30,17,13,群益金鼎-桃園,2023-07-03,9189
2402,毅嘉,47,35,12,群益金鼎-桃園,2023-07-03,9189
6205,詮欣,12,0,12,群益金鼎-桃園,2023-07-03,9189
6182,合晶,14,2,12,群益金鼎-桃園,2023-07-03,9189
00878,國泰永續高股息,14,2,12,群益金鼎-桃園,2023-07-03,9189
5465,富驊,12,1,11,群益金鼎-桃園,2023-07-03,9189
5706,鳳凰,14,3,11,群益金鼎-桃園,2023-07-03,9189
2352,佳世達,15,4,11,群益金鼎-桃園,2023-07-03,9189
8086,宏捷科,21,10,11,群益金鼎-桃園,2023-07-03,9189
1519,華城,10,0,10,群益金鼎-桃園,2023-07-03,9189
2105,正新,10,0,10,群益金鼎-桃園,2023-07-03,9189
2459,敦吉,10,0,10,群益金鼎-桃園,2023-07-03,9189
2328,廣宇,12,2,10,群益金鼎-桃園,2023-07-03,9189
00632R,元大台灣50反1,146,2,144,群益金鼎-桃園,2023-07-04,9189
4155,訊映,147,10,137,群益金鼎-桃園,2023-07-04,9189
2888,新光金,106,1,105,群益金鼎-桃園,2023-07-04,9189
2883,凱基金,99,0,99,群益金鼎-桃園,2023-07-04,9189
2609,陽明,128,52,76,群益金鼎-桃園,2023-07-04,9189
2603,長榮,127,71,56,群益金鼎-桃園,2023-07-04,9189
2010,春源,50,0,50,群益金鼎-桃園,2023-07-04,9189
2323,中環,70,20,50,群益金鼎-桃園,2023-07-04,9189
2317,鴻海,61,12,49,群益金鼎-桃園,2023-07-04,9189
1522,堤維西,90,45,45,群益金鼎-桃園,2023-07-04,9189
1101,台泥,51,7,44,群益金鼎-桃園,2023-07-04,9189
1609,大亞,52,8,44,群益金鼎-桃園,2023-07-04,9189
5426,振發,43,6,37,群益金鼎-桃園,2023-07-04,9189
1314,中石化,34,0,34,群益金鼎-桃園,2023-07-04,9189
2486,一詮,41,10,31,群益金鼎-桃園,2023-07-04,9189
2618,長榮航,60,30,30,群益金鼎-桃園,2023-07-04,9189
3017,奇鋐,37,8,29,群益金鼎-桃園,2023-07-04,9189
3481,群創,57,30,27,群益金鼎-桃園,2023-07-04,9189
6282,康舒,83,58,25,群益金鼎-桃園,2023-07-04,9189
1513,中興電,74,50,24,群益金鼎-桃園,2023-07-04,9189
3013,晟銘電,37,13,24,群益金鼎-桃園,2023-07-04,9189
6589,台康生技,22,0,22,群益金鼎-桃園,2023-07-04,9189
2482,連宇,26,5,21,群益金鼎-桃園,2023-07-04,9189
2913,農林,32,12,20,群益金鼎-桃園,2023-07-04,9189
1536,和大,20,0,20,群益金鼎-桃園,2023-07-04,9189
2820,華票,20,0,20,群益金鼎-桃園,2023-07-04,9189
1528,恩德,35,16,19,群益金鼎-桃園,2023-07-04,9189
5347,世界,17,0,17,群益金鼎-桃園,2023-07-04,9189
3265,台星科,24,8,16,群益金鼎-桃園,2023-07-04,9189
1783,和康生,16,1,15,群益金鼎-桃園,2023-07-04,9189
2515,中工,15,0,15,群益金鼎-桃園,2023-07-04,9189
01001T,土銀富邦R1,15,0,15,群益金鼎-桃園,2023-07-04,9189
2444,兆勁,17,2,15,群益金鼎-桃園,2023-07-04,9189
1598,岱宇,14,0,14,群益金鼎-桃園,2023-07-04,9189
6288,聯嘉,20,6,14,群益金鼎-桃園,2023-07-04,9189
1326,台化,13,0,13,群益金鼎-桃園,2023-07-04,9189
00673R,期元大S＆P原油反1,13,0,13,群益金鼎-桃園,2023-07-04,9189
8076,伍豐,15,2,13,群益金鼎-桃園,2023-07-04,9189
2705,六福,17,5,12,群益金鼎-桃園,2023-07-04,9189
6279,胡連,19,7,12,群益金鼎-桃園,2023-07-04,9189
5439,高技,12,0,12,群益金鼎-桃園,2023-07-04,9189
3029,零壹,12,1,11,群益金鼎-桃園,2023-07-04,9189
4523,永彰,11,0,11,群益金鼎-桃園,2023-07-04,9189
6188,廣明,23,12,11,群益金鼎-桃園,2023-07-04,9189
6274,台燿,12,2,10,群益金鼎-桃園,2023-07-04,9189
3189,景碩,11,1,10,群益金鼎-桃園,2023-07-04,9189
3701,大眾控,10,0,10,群益金鼎-桃園,2023-07-04,9189
8048,德勝,18,8,10,群益金鼎-桃園,2023-07-04,9189
2031,新光鋼,10,0,10,群益金鼎-桃園,2023-07-04,9189
4979,華星光,44,34,10,群益金鼎-桃園,2023-07-04,9189
4155,訊映,312,6,306,群益金鼎-桃園,2023-07-05,9189
2609,陽明,193,59,134,群益金鼎-桃園,2023-07-05,9189
00673R,期元大S＆P原油反1,71,4,67,群益金鼎-桃園,2023-07-05,9189
0056,元大高股息,66,6,60,群益金鼎-桃園,2023-07-05,9189
2356,英業達,87,38,49,群益金鼎-桃園,2023-07-05,9189
1314,中石化,42,0,42,群益金鼎-桃園,2023-07-05,9189
2610,華航,118,81,37,群益金鼎-桃園,2023-07-05,9189
00929,復華台灣科技優息,39,6,33,群益金鼎-桃園,2023-07-05,9189
2369,菱生,45,12,33,群益金鼎-桃園,2023-07-05,9189
1905,華紙,33,1,32,群益金鼎-桃園,2023-07-05,9189
4927,泰鼎-KY,31,1,30,群益金鼎-桃園,2023-07-05,9189
2317,鴻海,35,6,29,群益金鼎-桃園,2023-07-05,9189
6486,互動,25,0,25,群益金鼎-桃園,2023-07-05,9189
00878,國泰永續高股息,42,19,23,群益金鼎-桃園,2023-07-05,9189
1514,亞力,23,0,23,群益金鼎-桃園,2023-07-05,9189
2010,春源,22,0,22,群益金鼎-桃園,2023-07-05,9189
3481,群創,20,0,20,群益金鼎-桃園,2023-07-05,9189
00753L,中信中國50正2,20,0,20,群益金鼎-桃園,2023-07-05,9189
4960,誠美材,20,0,20,群益金鼎-桃園,2023-07-05,9189
1806,冠軍,20,1,19,群益金鼎-桃園,2023-07-05,9189
2329,華泰,54,35,19,群益金鼎-桃園,2023-07-05,9189
3037,欣興,27,8,19,群益金鼎-桃園,2023-07-05,9189
4533,協易機,19,1,18,群益金鼎-桃園,2023-07-05,9189
5907,大洋-KY,18,0,18,群益金鼎-桃園,2023-07-05,9189
2409,友達,18,1,17,群益金鼎-桃園,2023-07-05,9189
00927,群益半導體收益,21,4,17,群益金鼎-桃園,2023-07-05,9189
6282,康舒,76,60,16,群益金鼎-桃園,2023-07-05,9189
00722B,群益投資級電信債,16,0,16,群益金鼎-桃園,2023-07-05,9189
3071,協禧,19,4,15,群益金鼎-桃園,2023-07-05,9189
2485,兆赫,17,2,15,群益金鼎-桃園,2023-07-05,9189
2371,大同,62,48,14,群益金鼎-桃園,2023-07-05,9189
2344,華邦電,17,3,14,群益金鼎-桃園,2023-07-05,9189
6188,廣明,22,8,14,群益金鼎-桃園,2023-07-05,9189
6142,友勁,15,2,13,群益金鼎-桃園,2023-07-05,9189
2412,中華電,14,1,13,群益金鼎-桃園,2023-07-05,9189
7402,邑錡,13,0,13,群益金鼎-桃園,2023-07-05,9189
1605,華新,12,0,12,群益金鼎-桃園,2023-07-05,9189
3252,海灣,12,0,12,群益金鼎-桃園,2023-07-05,9189
2913,農林,12,0,12,群益金鼎-桃園,2023-07-05,9189
1513,中興電,16,5,11,群益金鼎-桃園,2023-07-05,9189
6243,迅杰,11,0,11,群益金鼎-桃園,2023-07-05,9189
4904,遠傳,11,0,11,群益金鼎-桃園,2023-07-05,9189
5876,上海商銀,11,0,11,群益金鼎-桃園,2023-07-05,9189
2367,燿華,12,1,11,群益金鼎-桃園,2023-07-05,9189
9938,百和,11,0,11,群益金鼎-桃園,2023-07-05,9189
1504,東元,12,1,11,群益金鼎-桃園,2023-07-05,9189
5425,台半,16,5,11,群益金鼎-桃園,2023-07-05,9189
6163,華電網,11,0,11,群益金鼎-桃園,2023-07-05,9189
3013,晟銘電,33,22,11,群益金鼎-桃園,2023-07-05,9189
2534,宏盛,11,0,11,群益金鼎-桃園,2023-07-05,9189
00673R,期元大S＆P原油反1,242,0,242,群益金鼎-桃園,2023-07-06,9189
4155,訊映,195,7,188,群益金鼎-桃園,2023-07-06,9189
3013,晟銘電,177,58,119,群益金鼎-桃園,2023-07-06,9189
2317,鴻海,104,10,94,群益金鼎-桃園,2023-07-06,9189
2356,英業達,104,14,90,群益金鼎-桃園,2023-07-06,9189
2880,華南金,67,0,67,群益金鼎-桃園,2023-07-06,9189
00878,國泰永續高股息,67,8,59,群益金鼎-桃園,2023-07-06,9189
6532,瑞耘,57,0,57,群益金鼎-桃園,2023-07-06,9189
2883,凱基金,98,46,52,群益金鼎-桃園,2023-07-06,9189
2888,新光金,71,20,51,群益金鼎-桃園,2023-07-06,9189
2002,中鋼,45,1,44,群益金鼎-桃園,2023-07-06,9189
8050,廣積,48,6,42,群益金鼎-桃園,2023-07-06,9189
2609,陽明,55,15,40,群益金鼎-桃園,2023-07-06,9189
8215,明基材,66,28,38,群益金鼎-桃園,2023-07-06,9189
00929,復華台灣科技優息,43,6,37,群益金鼎-桃園,2023-07-06,9189
3035,智原,45,8,37,群益金鼎-桃園,2023-07-06,9189
1101,台泥,37,0,37,群益金鼎-桃園,2023-07-06,9189
5009,榮剛,36,1,35,群益金鼎-桃園,2023-07-06,9189
2618,長榮航,57,24,33,群益金鼎-桃園,2023-07-06,9189
3231,緯創,96,64,32,群益金鼎-桃園,2023-07-06,9189
00753L,中信中國50正2,33,3,30,群益金鼎-桃園,2023-07-06,9189
2371,大同,99,71,28,群益金鼎-桃園,2023-07-06,9189
3037,欣興,50,22,28,群益金鼎-桃園,2023-07-06,9189
2614,東森,30,3,27,群益金鼎-桃園,2023-07-06,9189
5258,虹堡,39,13,26,群益金鼎-桃園,2023-07-06,9189
2882,國泰金,24,0,24,群益金鼎-桃園,2023-07-06,9189
4167,松瑞藥,24,0,24,群益金鼎-桃園,2023-07-06,9189
00882,中信中國高股息,38,15,23,群益金鼎-桃園,2023-07-06,9189
2421,建準,24,2,22,群益金鼎-桃園,2023-07-06,9189
2801,彰銀,22,0,22,群益金鼎-桃園,2023-07-06,9189
4564,元翎,21,0,21,群益金鼎-桃園,2023-07-06,9189
2881,富邦金,21,0,21,群益金鼎-桃園,2023-07-06,9189
1528,恩德,27,7,20,群益金鼎-桃園,2023-07-06,9189
2313,華通,29,9,20,群益金鼎-桃園,2023-07-06,9189
4938,和碩,24,4,20,群益金鼎-桃園,2023-07-06,9189
1721,三晃,20,0,20,群益金鼎-桃園,2023-07-06,9189
3078,僑威,30,11,19,群益金鼎-桃園,2023-07-06,9189
6282,康舒,38,19,19,群益金鼎-桃園,2023-07-06,9189
2482,連宇,24,5,19,群益金鼎-桃園,2023-07-06,9189
2891,中信金,19,0,19,群益金鼎-桃園,2023-07-06,9189
2419,仲琦,35,17,18,群益金鼎-桃園,2023-07-06,9189
2610,華航,20,2,18,群益金鼎-桃園,2023-07-06,9189
2208,台船,20,3,17,群益金鼎-桃園,2023-07-06,9189
8092,建暐,17,0,17,群益金鼎-桃園,2023-07-06,9189
1471,首利,21,4,17,群益金鼎-桃園,2023-07-06,9189
3362,先進光,31,14,17,群益金鼎-桃園,2023-07-06,9189
1326,台化,17,0,17,群益金鼎-桃園,2023-07-06,9189
2308,台達電,17,1,16,群益金鼎-桃園,2023-07-06,9189
2027,大成鋼,16,0,16,群益金鼎-桃園,2023-07-06,9189
6116,彩晶,20,4,16,群益金鼎-桃園,2023-07-06,9189
00929,復華台灣科技優息,242,5,237,群益金鼎-桃園,2023-07-07,9189
3715,定穎投控,104,0,104,群益金鼎-桃園,2023-07-07,9189
00665L,富邦�琤肭磪囓�2,67,0,67,群益金鼎-桃園,2023-07-07,9189
00637L,元大滬深300正2,68,3,65,群益金鼎-桃園,2023-07-07,9189
2498,宏達電,60,0,60,群益金鼎-桃園,2023-07-07,9189
00680L,元大美債20正2,59,0,59,群益金鼎-桃園,2023-07-07,9189
6152,百一,49,0,49,群益金鼎-桃園,2023-07-07,9189
00927,群益半導體收益,47,3,44,群益金鼎-桃園,2023-07-07,9189
4207,環泰,43,2,41,群益金鼎-桃園,2023-07-07,9189
2449,京元電子,47,7,40,群益金鼎-桃園,2023-07-07,9189
2609,陽明,36,3,33,群益金鼎-桃園,2023-07-07,9189
3025,星通,49,18,31,群益金鼎-桃園,2023-07-07,9189
00753L,中信中國50正2,50,20,30,群益金鼎-桃園,2023-07-07,9189
8076,伍豐,33,3,30,群益金鼎-桃園,2023-07-07,9189
8034,榮群,30,2,28,群益金鼎-桃園,2023-07-07,9189
6190,萬泰科,28,0,28,群益金鼎-桃園,2023-07-07,9189
00679B,元大美債20年,27,0,27,群益金鼎-桃園,2023-07-07,9189
00882,中信中國高股息,29,3,26,群益金鼎-桃園,2023-07-07,9189
6806,森崴能源,28,2,26,群益金鼎-桃園,2023-07-07,9189
6191,精成科,29,3,26,群益金鼎-桃園,2023-07-07,9189
3380,明泰,43,17,26,群益金鼎-桃園,2023-07-07,9189
2891,中信金,36,10,26,群益金鼎-桃園,2023-07-07,9189
1522,堤維西,25,0,25,群益金鼎-桃園,2023-07-07,9189
2369,菱生,33,8,25,群益金鼎-桃園,2023-07-07,9189
3481,群創,25,0,25,群益金鼎-桃園,2023-07-07,9189
2618,長榮航,43,20,23,群益金鼎-桃園,2023-07-07,9189
2409,友達,26,4,22,群益金鼎-桃園,2023-07-07,9189
6129,普誠,21,0,21,群益金鼎-桃園,2023-07-07,9189
4533,協易機,23,4,19,群益金鼎-桃園,2023-07-07,9189
0056,元大高股息,31,13,18,群益金鼎-桃園,2023-07-07,9189
3689,湧德,22,4,18,群益金鼎-桃園,2023-07-07,9189
3362,先進光,26,8,18,群益金鼎-桃園,2023-07-07,9189
1314,中石化,19,1,18,群益金鼎-桃園,2023-07-07,9189
2308,台達電,17,0,17,群益金鼎-桃園,2023-07-07,9189
3189,景碩,22,5,17,群益金鼎-桃園,2023-07-07,9189
2890,永豐金,17,0,17,群益金鼎-桃園,2023-07-07,9189
1326,台化,16,0,16,群益金鼎-桃園,2023-07-07,9189
2887,台新金,32,16,16,群益金鼎-桃園,2023-07-07,9189
2915,潤泰全,18,3,15,群益金鼎-桃園,2023-07-07,9189
2344,華邦電,19,4,15,群益金鼎-桃園,2023-07-07,9189
4934,太極,24,10,14,群益金鼎-桃園,2023-07-07,9189
6114,久威,14,0,14,群益金鼎-桃園,2023-07-07,9189
3037,欣興,16,3,13,群益金鼎-桃園,2023-07-07,9189
4155,訊映,14,1,13,群益金鼎-桃園,2023-07-07,9189
6185,幃翔,12,0,12,群益金鼎-桃園,2023-07-07,9189
6117,迎廣,44,32,12,群益金鼎-桃園,2023-07-07,9189
2801,彰銀,12,0,12,群益金鼎-桃園,2023-07-07,9189
2913,農林,13,1,12,群益金鼎-桃園,2023-07-07,9189
6288,聯嘉,24,12,12,群益金鼎-桃園,2023-07-07,9189
6282,康舒,37,25,12,群益金鼎-桃園,2023-07-07,9189
6005,群益證,372,3,369,群益金鼎-桃園,2023-07-10,9189
3231,緯創,289,62,227,群益金鼎-桃園,2023-07-10,9189
2356,英業達,152,36,116,群益金鼎-桃園,2023-07-10,9189
2888,新光金,71,5,66,群益金鼎-桃園,2023-07-10,9189
3038,全台,60,0,60,群益金鼎-桃園,2023-07-10,9189
2883,凱基金,87,29,58,群益金鼎-桃園,2023-07-10,9189
3022,威強電,53,1,52,群益金鼎-桃園,2023-07-10,9189
00673R,期元大S＆P原油反1,50,0,50,群益金鼎-桃園,2023-07-10,9189
2609,陽明,71,22,49,群益金鼎-桃園,2023-07-10,9189
2324,仁寶,49,6,43,群益金鼎-桃園,2023-07-10,9189
00632R,元大台灣50反1,117,76,41,群益金鼎-桃園,2023-07-10,9189
00878,國泰永續高股息,49,8,41,群益金鼎-桃園,2023-07-10,9189
6550,北極星藥業-KY,42,2,40,群益金鼎-桃園,2023-07-10,9189
8096,擎亞,40,0,40,群益金鼎-桃園,2023-07-10,9189
8403,盛弘,40,0,40,群益金鼎-桃園,2023-07-10,9189
2313,華通,39,1,38,群益金鼎-桃園,2023-07-10,9189
2302,麗正,36,0,36,群益金鼎-桃園,2023-07-10,9189
00706L,期元大S＆P日圓正2,110,78,32,群益金鼎-桃園,2023-07-10,9189
2388,威盛,58,26,32,群益金鼎-桃園,2023-07-10,9189
00665L,富邦�琤肭磪囓�2,45,15,30,群益金鼎-桃園,2023-07-10,9189
2317,鴻海,35,5,30,群益金鼎-桃園,2023-07-10,9189
3149,正達,29,0,29,群益金鼎-桃園,2023-07-10,9189
2457,飛宏,27,3,24,群益金鼎-桃園,2023-07-10,9189
00929,復華台灣科技優息,24,0,24,群益金鼎-桃園,2023-07-10,9189
00679B,元大美債20年,22,1,21,群益金鼎-桃園,2023-07-10,9189
1785,光洋科,27,6,21,群益金鼎-桃園,2023-07-10,9189
00751B,元大AAA至A公司債,22,1,21,群益金鼎-桃園,2023-07-10,9189
6733,博晟生醫,21,1,20,群益金鼎-桃園,2023-07-10,9189
1402,遠東新,20,0,20,群益金鼎-桃園,2023-07-10,9189
6015,宏遠證,20,0,20,群益金鼎-桃園,2023-07-10,9189
00927,群益半導體收益,30,10,20,群益金鼎-桃園,2023-07-10,9189
5880,合庫金,20,1,19,群益金鼎-桃園,2023-07-10,9189
2331,精英,20,1,19,群益金鼎-桃園,2023-07-10,9189
6282,康舒,55,39,16,群益金鼎-桃園,2023-07-10,9189
5243,乙盛-KY,16,0,16,群益金鼎-桃園,2023-07-10,9189
2365,昆盈,20,5,15,群益金鼎-桃園,2023-07-10,9189
3105,穩懋,16,1,15,群益金鼎-桃園,2023-07-10,9189
00680L,元大美債20正2,14,0,14,群益金鼎-桃園,2023-07-10,9189
00882,中信中國高股息,29,15,14,群益金鼎-桃園,2023-07-10,9189
2605,新興,19,5,14,群益金鼎-桃園,2023-07-10,9189
2353,宏��,14,1,13,群益金鼎-桃園,2023-07-10,9189
4908,前鼎,17,4,13,群益金鼎-桃園,2023-07-10,9189
2801,彰銀,12,0,12,群益金鼎-桃園,2023-07-10,9189
6662,樂斯科,12,0,12,群益金鼎-桃園,2023-07-10,9189
00720B,元大投資級公司債,14,2,12,群益金鼎-桃園,2023-07-10,9189
2603,長榮,21,10,11,群益金鼎-桃園,2023-07-10,9189
1444,力麗,11,0,11,群益金鼎-桃園,2023-07-10,9189
1540,喬福,18,7,11,群益金鼎-桃園,2023-07-10,9189
2038,海光,11,0,11,群益金鼎-桃園,2023-07-10,9189
6125,廣運,12,1,11,群益金鼎-桃園,2023-07-10,9189
2891,中信金,110,5,105,群益金鼎-桃園,2023-07-11,9189
00632R,元大台灣50反1,110,5,105,群益金鼎-桃園,2023-07-11,9189
2609,陽明,102,6,96,群益金鼎-桃園,2023-07-11,9189
00715L,期街口布蘭特正2,156,75,81,群益金鼎-桃園,2023-07-11,9189
00665L,富邦�琤肭磪囓�2,50,0,50,群益金鼎-桃園,2023-07-11,9189
00885,富邦越南,41,3,38,群益金鼎-桃園,2023-07-11,9189
5328,華容,35,0,35,群益金鼎-桃園,2023-07-11,9189
1604,聲寶,34,1,33,群益金鼎-桃園,2023-07-11,9189
4526,東台,114,85,29,群益金鼎-桃園,2023-07-11,9189
2457,飛宏,40,12,28,群益金鼎-桃園,2023-07-11,9189
5009,榮剛,26,0,26,群益金鼎-桃園,2023-07-11,9189
2888,新光金,46,22,24,群益金鼎-桃園,2023-07-11,9189
1314,中石化,24,0,24,群益金鼎-桃園,2023-07-11,9189
2614,東森,35,12,23,群益金鼎-桃園,2023-07-11,9189
2368,金像電,34,12,22,群益金鼎-桃園,2023-07-11,9189
4533,協易機,23,1,22,群益金鼎-桃園,2023-07-11,9189
2515,中工,22,0,22,群益金鼎-桃園,2023-07-11,9189
3034,聯詠,22,0,22,群益金鼎-桃園,2023-07-11,9189
5439,高技,31,10,21,群益金鼎-桃園,2023-07-11,9189
2104,國際中橡,21,0,21,群益金鼎-桃園,2023-07-11,9189
2316,楠梓電,20,1,19,群益金鼎-桃園,2023-07-11,9189
4532,瑞智,54,35,19,群益金鼎-桃園,2023-07-11,9189
1101,台泥,23,5,18,群益金鼎-桃園,2023-07-11,9189
1905,華紙,22,5,17,群益金鼎-桃園,2023-07-11,9189
1605,華新,28,11,17,群益金鼎-桃園,2023-07-11,9189
1609,大亞,26,10,16,群益金鼎-桃園,2023-07-11,9189
6120,達運,35,19,16,群益金鼎-桃園,2023-07-11,9189
2618,長榮航,72,57,15,群益金鼎-桃園,2023-07-11,9189
2383,台光電,22,7,15,群益金鼎-桃園,2023-07-11,9189
6806,森崴能源,17,2,15,群益金鼎-桃園,2023-07-11,9189
6185,幃翔,18,4,14,群益金鼎-桃園,2023-07-11,9189
1540,喬福,14,0,14,群益金鼎-桃園,2023-07-11,9189
3029,零壹,13,0,13,群益金鼎-桃園,2023-07-11,9189
6188,廣明,25,12,13,群益金鼎-桃園,2023-07-11,9189
00679B,元大美債20年,12,0,12,群益金鼎-桃園,2023-07-11,9189
2603,長榮,20,8,12,群益金鼎-桃園,2023-07-11,9189
3037,欣興,24,12,12,群益金鼎-桃園,2023-07-11,9189
00673R,期元大S＆P原油反1,12,0,12,群益金鼎-桃園,2023-07-11,9189
4164,承業醫,13,1,12,群益金鼎-桃園,2023-07-11,9189
1795,美時,12,1,11,群益金鼎-桃園,2023-07-11,9189
6153,嘉聯益,11,0,11,群益金鼎-桃園,2023-07-11,9189
8210,勤誠,15,4,11,群益金鼎-桃園,2023-07-11,9189
1810,和成,11,0,11,群益金鼎-桃園,2023-07-11,9189
2201,裕隆,11,0,11,群益金鼎-桃園,2023-07-11,9189
6142,友勁,11,0,11,群益金鼎-桃園,2023-07-11,9189
00795B,中信美國公債20年,11,0,11,群益金鼎-桃園,2023-07-11,9189
2340,台亞,74,63,11,群益金鼎-桃園,2023-07-11,9189
5880,合庫金,11,0,11,群益金鼎-桃園,2023-07-11,9189
3006,晶豪科,14,3,11,群益金鼎-桃園,2023-07-11,9189
4908,前鼎,12,2,10,群益金鼎-桃園,2023-07-11,9189
5512,力麒,100,0,100,群益金鼎-桃園,2023-07-12,9189
2609,陽明,86,14,72,群益金鼎-桃園,2023-07-12,9189
2356,英業達,169,101,68,群益金鼎-桃園,2023-07-12,9189
1447,力鵬,50,0,50,群益金鼎-桃園,2023-07-12,9189
00632R,元大台灣50反1,62,18,44,群益金鼎-桃園,2023-07-12,9189
6282,康舒,66,23,43,群益金鼎-桃園,2023-07-12,9189
2344,華邦電,49,13,36,群益金鼎-桃園,2023-07-12,9189
4564,元翎,36,1,35,群益金鼎-桃園,2023-07-12,9189
2303,聯電,37,3,34,群益金鼎-桃園,2023-07-12,9189
5328,華容,36,3,33,群益金鼎-桃園,2023-07-12,9189
2399,映泰,45,13,32,群益金鼎-桃園,2023-07-12,9189
2329,華泰,41,12,29,群益金鼎-桃園,2023-07-12,9189
00673R,期元大S＆P原油反1,27,0,27,群益金鼎-桃園,2023-07-12,9189
1314,中石化,30,4,26,群益金鼎-桃園,2023-07-12,9189
8092,建暐,33,7,26,群益金鼎-桃園,2023-07-12,9189
3521,鴻翊,25,0,25,群益金鼎-桃園,2023-07-12,9189
3704,合勤控,47,24,23,群益金鼎-桃園,2023-07-12,9189
6274,台燿,42,19,23,群益金鼎-桃園,2023-07-12,9189
5009,榮剛,22,0,22,群益金鼎-桃園,2023-07-12,9189
3231,緯創,114,93,21,群益金鼎-桃園,2023-07-12,9189
2534,宏盛,20,0,20,群益金鼎-桃園,2023-07-12,9189
4716,大立,22,2,20,群益金鼎-桃園,2023-07-12,9189
6470,宇智,19,0,19,群益金鼎-桃園,2023-07-12,9189
6218,豪勉,51,34,17,群益金鼎-桃園,2023-07-12,9189
6806,森崴能源,16,0,16,群益金鼎-桃園,2023-07-12,9189
1905,華紙,20,5,15,群益金鼎-桃園,2023-07-12,9189
2302,麗正,18,3,15,群益金鼎-桃園,2023-07-12,9189
2481,強茂,30,16,14,群益金鼎-桃園,2023-07-12,9189
5388,中磊,16,2,14,群益金鼎-桃園,2023-07-12,9189
00722B,群益投資級電信債,12,0,12,群益金鼎-桃園,2023-07-12,9189
2881,富邦金,15,4,11,群益金鼎-桃園,2023-07-12,9189
3162,精確,11,0,11,群益金鼎-桃園,2023-07-12,9189
5353,台林,11,0,11,群益金鼎-桃園,2023-07-12,9189
1101,台泥,13,2,11,群益金鼎-桃園,2023-07-12,9189
5299,杰力,10,0,10,群益金鼎-桃園,2023-07-12,9189
9919,康那香,10,0,10,群益金鼎-桃園,2023-07-12,9189
3265,台星科,12,2,10,群益金鼎-桃園,2023-07-12,9189
3511,矽瑪,10,0,10,群益金鼎-桃園,2023-07-12,9189
6142,友勁,10,0,10,群益金鼎-桃園,2023-07-12,9189
6187,萬潤,17,8,9,群益金鼎-桃園,2023-07-12,9189
4726,永昕,9,0,9,群益金鼎-桃園,2023-07-12,9189
3624,光頡,9,0,9,群益金鼎-桃園,2023-07-12,9189
00687B,國泰20年美債,9,0,9,群益金鼎-桃園,2023-07-12,9189
2603,長榮,19,10,9,群益金鼎-桃園,2023-07-12,9189
3013,晟銘電,9,1,8,群益金鼎-桃園,2023-07-12,9189
1402,遠東新,8,0,8,群益金鼎-桃園,2023-07-12,9189
4157,太景*-KY,8,0,8,群益金鼎-桃園,2023-07-12,9189
2888,新光金,8,0,8,群益金鼎-桃園,2023-07-12,9189
2342,茂矽,10,2,8,群益金鼎-桃園,2023-07-12,9189
6706,惠特,8,0,8,群益金鼎-桃園,2023-07-12,9189
2610,華航,237,85,152,群益金鼎-桃園,2023-07-13,9189
2891,中信金,101,0,101,群益金鼎-桃園,2023-07-13,9189
2618,長榮航,159,66,93,群益金鼎-桃園,2023-07-13,9189
2368,金像電,95,15,80,群益金鼎-桃園,2023-07-13,9189
2884,玉山金,64,0,64,群益金鼎-桃園,2023-07-13,9189
4526,東台,57,0,57,群益金鼎-桃園,2023-07-13,9189
00930,永豐ESG低碳高息,57,0,57,群益金鼎-桃園,2023-07-13,9189
9958,世紀鋼,55,2,53,群益金鼎-桃園,2023-07-13,9189
2609,陽明,78,31,47,群益金鼎-桃園,2023-07-13,9189
2883,凱基金,43,0,43,群益金鼎-桃園,2023-07-13,9189
2399,映泰,61,18,43,群益金鼎-桃園,2023-07-13,9189
3078,僑威,42,5,37,群益金鼎-桃園,2023-07-13,9189
2486,一詮,50,13,37,群益金鼎-桃園,2023-07-13,9189
5439,高技,58,24,34,群益金鼎-桃園,2023-07-13,9189
2449,京元電子,47,14,33,群益金鼎-桃園,2023-07-13,9189
2633,台灣高鐵,31,0,31,群益金鼎-桃園,2023-07-13,9189
5347,世界,30,0,30,群益金鼎-桃園,2023-07-13,9189
6806,森崴能源,29,1,28,群益金鼎-桃園,2023-07-13,9189
2329,華泰,53,26,27,群益金鼎-桃園,2023-07-13,9189
00687B,國泰20年美債,26,0,26,群益金鼎-桃園,2023-07-13,9189
00751B,元大AAA至A公司債,26,0,26,群益金鼎-桃園,2023-07-13,9189
00679B,元大美債20年,38,14,24,群益金鼎-桃園,2023-07-13,9189
3231,緯創,123,99,24,群益金鼎-桃園,2023-07-13,9189
00664R,國泰臺灣加權反1,19,0,19,群益金鼎-桃園,2023-07-13,9189
1524,耿鼎,20,1,19,群益金鼎-桃園,2023-07-13,9189
3265,台星科,30,12,18,群益金鼎-桃園,2023-07-13,9189
2913,農林,18,0,18,群益金鼎-桃園,2023-07-13,9189
3508,位速,17,0,17,群益金鼎-桃園,2023-07-13,9189
1795,美時,22,6,16,群益金鼎-桃園,2023-07-13,9189
5483,中美晶,17,1,16,群益金鼎-桃園,2023-07-13,9189
00632R,元大台灣50反1,165,149,16,群益金鼎-桃園,2023-07-13,9189
6015,宏遠證,15,0,15,群益金鼎-桃園,2023-07-13,9189
6257,矽格,15,0,15,群益金鼎-桃園,2023-07-13,9189
6139,亞翔,33,19,14,群益金鼎-桃園,2023-07-13,9189
8016,矽創,14,0,14,群益金鼎-桃園,2023-07-13,9189
00671R,富邦NASDAQ反1,14,0,14,群益金鼎-桃園,2023-07-13,9189
6170,統振,15,1,14,群益金鼎-桃園,2023-07-13,9189
6288,聯嘉,14,0,14,群益金鼎-桃園,2023-07-13,9189
00673R,期元大S＆P原油反1,19,6,13,群益金鼎-桃園,2023-07-13,9189
2425,承啟,25,12,13,群益金鼎-桃園,2023-07-13,9189
6185,幃翔,15,2,13,群益金鼎-桃園,2023-07-13,9189
3025,星通,22,10,12,群益金鼎-桃園,2023-07-13,9189
2359,所羅門,15,3,12,群益金鼎-桃園,2023-07-13,9189
4974,亞泰,11,0,11,群益金鼎-桃園,2023-07-13,9189
5426,振發,12,1,11,群益金鼎-桃園,2023-07-13,9189
1304,台聚,11,0,11,群益金鼎-桃園,2023-07-13,9189
6190,萬泰科,34,23,11,群益金鼎-桃園,2023-07-13,9189
8028,昇陽半導體,14,3,11,群益金鼎-桃園,2023-07-13,9189
6782,視陽,11,1,10,群益金鼎-桃園,2023-07-13,9189
6278,台表科,11,1,10,群益金鼎-桃園,2023-07-13,9189
2324,仁寶,174,7,167,群益金鼎-桃園,2023-07-14,9189
2618,長榮航,222,112,110,群益金鼎-桃園,2023-07-14,9189
2610,華航,132,51,81,群益金鼎-桃園,2023-07-14,9189
6207,雷科,71,1,70,群益金鼎-桃園,2023-07-14,9189
2867,三商壽,52,0,52,群益金鼎-桃園,2023-07-14,9189
9958,世紀鋼,55,4,51,群益金鼎-桃園,2023-07-14,9189
2329,華泰,79,29,50,群益金鼎-桃園,2023-07-14,9189
2845,遠東銀,50,0,50,群益金鼎-桃園,2023-07-14,9189
00715L,期街口布蘭特正2,57,9,48,群益金鼎-桃園,2023-07-14,9189
2498,宏達電,43,5,38,群益金鼎-桃園,2023-07-14,9189
3624,光頡,37,2,35,群益金鼎-桃園,2023-07-14,9189
00930,永豐ESG低碳高息,31,1,30,群益金鼎-桃園,2023-07-14,9189
2382,廣達,127,99,28,群益金鼎-桃園,2023-07-14,9189
2338,光罩,31,3,28,群益金鼎-桃園,2023-07-14,9189
3481,群創,39,11,28,群益金鼎-桃園,2023-07-14,9189
4526,東台,36,11,25,群益金鼎-桃園,2023-07-14,9189
5443,均豪,36,12,24,群益金鼎-桃園,2023-07-14,9189
2208,台船,22,0,22,群益金鼎-桃園,2023-07-14,9189
5340,建榮,21,0,21,群益金鼎-桃園,2023-07-14,9189
1609,大亞,47,27,20,群益金鼎-桃園,2023-07-14,9189
1210,大成,20,0,20,群益金鼎-桃園,2023-07-14,9189
1504,東元,59,39,20,群益金鼎-桃園,2023-07-14,9189
8277,商丞,20,0,20,群益金鼎-桃園,2023-07-14,9189
2301,光寶科,81,61,20,群益金鼎-桃園,2023-07-14,9189
3035,智原,45,26,19,群益金鼎-桃園,2023-07-14,9189
00882,中信中國高股息,23,4,19,群益金鼎-桃園,2023-07-14,9189
6190,萬泰科,25,6,19,群益金鼎-桃園,2023-07-14,9189
2454,聯發科,18,0,18,群益金鼎-桃園,2023-07-14,9189
5864,致和證,20,3,17,群益金鼎-桃園,2023-07-14,9189
2206,三陽工業,17,1,16,群益金鼎-桃園,2023-07-14,9189
00671R,富邦NASDAQ反1,16,0,16,群益金鼎-桃園,2023-07-14,9189
2630,亞航,17,1,16,群益金鼎-桃園,2023-07-14,9189
00917,中信特選金融,15,0,15,群益金鼎-桃園,2023-07-14,9189
3058,立德,15,0,15,群益金鼎-桃園,2023-07-14,9189
3032,偉訓,16,1,15,群益金鼎-桃園,2023-07-14,9189
1605,華新,22,7,15,群益金鼎-桃園,2023-07-14,9189
2419,仲琦,47,32,15,群益金鼎-桃園,2023-07-14,9189
3060,銘異,17,3,14,群益金鼎-桃園,2023-07-14,9189
00673R,期元大S＆P原油反1,13,0,13,群益金鼎-桃園,2023-07-14,9189
6235,華孚,20,7,13,群益金鼎-桃園,2023-07-14,9189
3016,嘉晶,13,0,13,群益金鼎-桃園,2023-07-14,9189
3363,上詮,37,24,13,群益金鼎-桃園,2023-07-14,9189
00929,復華台灣科技優息,13,0,13,群益金鼎-桃園,2023-07-14,9189
2486,一詮,15,3,12,群益金鼎-桃園,2023-07-14,9189
2313,華通,16,4,12,群益金鼎-桃園,2023-07-14,9189
2436,偉詮電,42,30,12,群益金鼎-桃園,2023-07-14,9189
2371,大同,78,66,12,群益金鼎-桃園,2023-07-14,9189
1313,聯成,13,2,11,群益金鼎-桃園,2023-07-14,9189
1337,再生-KY,11,0,11,群益金鼎-桃園,2023-07-14,9189
2344,華邦電,19,8,11,群益金鼎-桃園,2023-07-14,9189
3231,緯創,144,18,126,群益金鼎-桃園,2023-07-17,9189
0056,元大高股息,268,176,92,群益金鼎-桃園,2023-07-17,9189
2883,凱基金,115,31,84,群益金鼎-桃園,2023-07-17,9189
00929,復華台灣科技優息,71,3,68,群益金鼎-桃園,2023-07-17,9189
2399,映泰,84,20,64,群益金鼎-桃園,2023-07-17,9189
6191,精成科,90,29,61,群益金鼎-桃園,2023-07-17,9189
8299,群聯,59,0,59,群益金鼎-桃園,2023-07-17,9189
5009,榮剛,81,23,58,群益金鼎-桃園,2023-07-17,9189
2855,統一證,53,0,53,群益金鼎-桃園,2023-07-17,9189
2486,一詮,53,1,52,群益金鼎-桃園,2023-07-17,9189
6550,北極星藥業-KY,53,10,43,群益金鼎-桃園,2023-07-17,9189
3576,聯合再生,43,0,43,群益金鼎-桃園,2023-07-17,9189
2371,大同,73,31,42,群益金鼎-桃園,2023-07-17,9189
2353,宏��,74,32,42,群益金鼎-桃園,2023-07-17,9189
00878,國泰永續高股息,51,13,38,群益金鼎-桃園,2023-07-17,9189
00713,元大台灣高息低波,37,2,35,群益金鼎-桃園,2023-07-17,9189
00632R,元大台灣50反1,35,3,32,群益金鼎-桃園,2023-07-17,9189
00882,中信中國高股息,33,2,31,群益金鼎-桃園,2023-07-17,9189
2402,毅嘉,28,2,26,群益金鼎-桃園,2023-07-17,9189
00858,永豐美國500大,25,0,25,群益金鼎-桃園,2023-07-17,9189
2610,華航,33,9,24,群益金鼎-桃園,2023-07-17,9189
00712,復華富時不動產,50,27,23,群益金鼎-桃園,2023-07-17,9189
2419,仲琦,52,29,23,群益金鼎-桃園,2023-07-17,9189
2457,飛宏,45,23,22,群益金鼎-桃園,2023-07-17,9189
2329,華泰,32,10,22,群益金鼎-桃園,2023-07-17,9189
00905,FT臺灣Smart,20,0,20,群益金鼎-桃園,2023-07-17,9189
5426,振發,21,1,20,群益金鼎-桃園,2023-07-17,9189
3704,合勤控,45,26,19,群益金鼎-桃園,2023-07-17,9189
5907,大洋-KY,19,0,19,群益金鼎-桃園,2023-07-17,9189
6290,良維,19,1,18,群益金鼎-桃園,2023-07-17,9189
9802,鈺齊-KY,18,0,18,群益金鼎-桃園,2023-07-17,9189
2328,廣宇,28,11,17,群益金鼎-桃園,2023-07-17,9189
1402,遠東新,17,0,17,群益金鼎-桃園,2023-07-17,9189
1528,恩德,17,0,17,群益金鼎-桃園,2023-07-17,9189
2323,中環,20,4,16,群益金鼎-桃園,2023-07-17,9189
1314,中石化,15,0,15,群益金鼎-桃園,2023-07-17,9189
2356,英業達,97,83,14,群益金鼎-桃園,2023-07-17,9189
6111,大宇資,28,14,14,群益金鼎-桃園,2023-07-17,9189
1605,華新,20,6,14,群益金鼎-桃園,2023-07-17,9189
1336,台翰,18,5,13,群益金鼎-桃園,2023-07-17,9189
3624,光頡,13,0,13,群益金鼎-桃園,2023-07-17,9189
00752,中信中國50,11,0,11,群益金鼎-桃園,2023-07-17,9189
8033,雷虎,11,0,11,群益金鼎-桃園,2023-07-17,9189
3325,旭品,15,5,10,群益金鼎-桃園,2023-07-17,9189
8155,博智,13,3,10,群益金鼎-桃園,2023-07-17,9189
3038,全台,11,1,10,群益金鼎-桃園,2023-07-17,9189
8110,華東,10,0,10,群益金鼎-桃園,2023-07-17,9189
4934,太極,16,6,10,群益金鼎-桃園,2023-07-17,9189
1434,福懋,9,0,9,群益金鼎-桃園,2023-07-17,9189
6691,洋基工程,9,0,9,群益金鼎-桃園,2023-07-17,9189
0056,元大高股息,240,28,212,群益金鼎-桃園,2023-07-18,9189
2618,長榮航,254,59,195,群益金鼎-桃園,2023-07-18,9189
00882,中信中國高股息,120,5,115,群益金鼎-桃園,2023-07-18,9189
2457,飛宏,74,4,70,群益金鼎-桃園,2023-07-18,9189
2104,國際中橡,60,0,60,群益金鼎-桃園,2023-07-18,9189
3163,波若威,84,28,56,群益金鼎-桃園,2023-07-18,9189
3231,緯創,76,24,52,群益金鼎-桃園,2023-07-18,9189
00929,復華台灣科技優息,76,25,51,群益金鼎-桃園,2023-07-18,9189
2486,一詮,52,3,49,群益金鼎-桃園,2023-07-18,9189
2352,佳世達,71,25,46,群益金鼎-桃園,2023-07-18,9189
2609,陽明,61,15,46,群益金鼎-桃園,2023-07-18,9189
2329,華泰,124,85,39,群益金鼎-桃園,2023-07-18,9189
2885,元大金,37,0,37,群益金鼎-桃園,2023-07-18,9189
4938,和碩,84,54,30,群益金鼎-桃園,2023-07-18,9189
00692,富邦公司治理,30,0,30,群益金鼎-桃園,2023-07-18,9189
2402,毅嘉,35,8,27,群益金鼎-桃園,2023-07-18,9189
2515,中工,25,0,25,群益金鼎-桃園,2023-07-18,9189
3715,定穎投控,39,14,25,群益金鼎-桃園,2023-07-18,9189
8033,雷虎,24,1,23,群益金鼎-桃園,2023-07-18,9189
4106,雃博,20,0,20,群益金鼎-桃園,2023-07-18,9189
5309,系統電,20,0,20,群益金鼎-桃園,2023-07-18,9189
6265,方土昶,20,0,20,群益金鼎-桃園,2023-07-18,9189
2317,鴻海,26,7,19,群益金鼎-桃園,2023-07-18,9189
6235,華孚,19,0,19,群益金鼎-桃園,2023-07-18,9189
5340,建榮,20,1,19,群益金鼎-桃園,2023-07-18,9189
8930,青鋼,19,0,19,群益金鼎-桃園,2023-07-18,9189
3032,偉訓,19,1,18,群益金鼎-桃園,2023-07-18,9189
6191,精成科,38,20,18,群益金鼎-桃園,2023-07-18,9189
2449,京元電子,37,19,18,群益金鼎-桃園,2023-07-18,9189
2409,友達,18,1,17,群益金鼎-桃園,2023-07-18,9189
3441,聯一光,20,3,17,群益金鼎-桃園,2023-07-18,9189
3014,聯陽,18,1,17,群益金鼎-桃園,2023-07-18,9189
3024,憶聲,25,8,17,群益金鼎-桃園,2023-07-18,9189
2301,光寶科,41,24,17,群益金鼎-桃園,2023-07-18,9189
3027,盛達,16,0,16,群益金鼎-桃園,2023-07-18,9189
1337,再生-KY,16,0,16,群益金鼎-桃園,2023-07-18,9189
6530,創威,16,0,16,群益金鼎-桃園,2023-07-18,9189
1611,中電,16,0,16,群益金鼎-桃園,2023-07-18,9189
6806,森崴能源,27,11,16,群益金鼎-桃園,2023-07-18,9189
1789,神隆,16,1,15,群益金鼎-桃園,2023-07-18,9189
6016,康和證,22,7,15,群益金鼎-桃園,2023-07-18,9189
6188,廣明,35,21,14,群益金鼎-桃園,2023-07-18,9189
4105,東洋,16,2,14,群益金鼎-桃園,2023-07-18,9189
3025,星通,23,9,14,群益金鼎-桃園,2023-07-18,9189
5439,高技,16,2,14,群益金鼎-桃園,2023-07-18,9189
3706,神達,131,117,14,群益金鼎-桃園,2023-07-18,9189
3081,聯亞,13,0,13,群益金鼎-桃園,2023-07-18,9189
2425,承啟,28,15,13,群益金鼎-桃園,2023-07-18,9189
3078,僑威,89,77,12,群益金鼎-桃園,2023-07-18,9189
3521,鴻翊,17,5,12,群益金鼎-桃園,2023-07-18,9189
2324,仁寶,207,52,155,群益金鼎-桃園,2023-07-19,9189
00929,復華台灣科技優息,72,2,70,群益金鼎-桃園,2023-07-19,9189
6282,康舒,86,25,61,群益金鼎-桃園,2023-07-19,9189
6806,森崴能源,61,1,60,群益金鼎-桃園,2023-07-19,9189
2313,華通,79,22,57,群益金鼎-桃園,2023-07-19,9189
2382,廣達,75,24,51,群益金鼎-桃園,2023-07-19,9189
1513,中興電,45,0,45,群益金鼎-桃園,2023-07-19,9189
00715L,期街口布蘭特正2,50,6,44,群益金鼎-桃園,2023-07-19,9189
2423,固緯,126,82,44,群益金鼎-桃園,2023-07-19,9189
00882,中信中國高股息,52,10,42,群益金鼎-桃園,2023-07-19,9189
1313,聯成,44,2,42,群益金鼎-桃園,2023-07-19,9189
9105,泰金寶-DR,42,1,41,群益金鼎-桃園,2023-07-19,9189
8930,青鋼,40,0,40,群益金鼎-桃園,2023-07-19,9189
2457,飛宏,58,18,40,群益金鼎-桃園,2023-07-19,9189
2303,聯電,46,6,40,群益金鼎-桃園,2023-07-19,9189
2353,宏��,101,66,35,群益金鼎-桃園,2023-07-19,9189
1314,中石化,33,0,33,群益金鼎-桃園,2023-07-19,9189
1609,大亞,42,10,32,群益金鼎-桃園,2023-07-19,9189
2461,光群雷,40,8,32,群益金鼎-桃園,2023-07-19,9189
1101,台泥,31,0,31,群益金鼎-桃園,2023-07-19,9189
3022,威強電,34,3,31,群益金鼎-桃園,2023-07-19,9189
4938,和碩,44,14,30,群益金鼎-桃園,2023-07-19,9189
3231,緯創,44,14,30,群益金鼎-桃園,2023-07-19,9189
2883,凱基金,58,28,30,群益金鼎-桃園,2023-07-19,9189
2515,中工,27,2,25,群益金鼎-桃園,2023-07-19,9189
1504,東元,52,29,23,群益金鼎-桃園,2023-07-19,9189
00753L,中信中國50正2,22,0,22,群益金鼎-桃園,2023-07-19,9189
2834,臺企銀,25,3,22,群益金鼎-桃園,2023-07-19,9189
2459,敦吉,20,0,20,群益金鼎-桃園,2023-07-19,9189
4566,時碩工業,38,18,20,群益金鼎-桃園,2023-07-19,9189
5009,榮剛,20,0,20,群益金鼎-桃園,2023-07-19,9189
6691,洋基工程,21,2,19,群益金鼎-桃園,2023-07-19,9189
2332,友訊,25,6,19,群益金鼎-桃園,2023-07-19,9189
2891,中信金,24,6,18,群益金鼎-桃園,2023-07-19,9189
2340,台亞,31,15,16,群益金鼎-桃園,2023-07-19,9189
00671R,富邦NASDAQ反1,16,0,16,群益金鼎-桃園,2023-07-19,9189
2801,彰銀,24,9,15,群益金鼎-桃園,2023-07-19,9189
6128,上福,15,0,15,群益金鼎-桃園,2023-07-19,9189
1785,光洋科,15,0,15,群益金鼎-桃園,2023-07-19,9189
2419,仲琦,63,48,15,群益金鼎-桃園,2023-07-19,9189
3232,昱捷,15,0,15,群益金鼎-桃園,2023-07-19,9189
2881,富邦金,17,2,15,群益金鼎-桃園,2023-07-19,9189
00900,富邦特選高股息30,20,6,14,群益金鼎-桃園,2023-07-19,9189
1471,首利,18,5,13,群益金鼎-桃園,2023-07-19,9189
5388,中磊,12,0,12,群益金鼎-桃園,2023-07-19,9189
2603,長榮,15,3,12,群益金鼎-桃園,2023-07-19,9189
3105,穩懋,24,12,12,群益金鼎-桃園,2023-07-19,9189
1227,佳格,12,0,12,群益金鼎-桃園,2023-07-19,9189
5328,華容,12,0,12,群益金鼎-桃園,2023-07-19,9189
00632R,元大台灣50反1,56,45,11,群益金鼎-桃園,2023-07-19,9189
00878,國泰永續高股息,312,9,303,群益金鼎-桃園,2023-07-20,9189
2303,聯電,90,7,83,群益金鼎-桃園,2023-07-20,9189
3035,智原,118,43,75,群益金鼎-桃園,2023-07-20,9189
00665L,富邦�琤肭磪囓�2,70,4,66,群益金鼎-桃園,2023-07-20,9189
00929,復華台灣科技優息,59,2,57,群益金鼎-桃園,2023-07-20,9189
2405,輔信,59,12,47,群益金鼎-桃園,2023-07-20,9189
2329,華泰,59,20,39,群益金鼎-桃園,2023-07-20,9189
2316,楠梓電,69,34,35,群益金鼎-桃園,2023-07-20,9189
6282,康舒,138,105,33,群益金鼎-桃園,2023-07-20,9189
3289,宜特,33,6,27,群益金鼎-桃園,2023-07-20,9189
3588,通嘉,38,11,27,群益金鼎-桃園,2023-07-20,9189
4123,晟德,39,15,24,群益金鼎-桃園,2023-07-20,9189
4116,明基醫,25,1,24,群益金鼎-桃園,2023-07-20,9189
1227,佳格,30,6,24,群益金鼎-桃園,2023-07-20,9189
6806,森崴能源,22,0,22,群益金鼎-桃園,2023-07-20,9189
4934,太極,22,0,22,群益金鼎-桃園,2023-07-20,9189
2027,大成鋼,31,9,22,群益金鼎-桃園,2023-07-20,9189
3581,博磊,21,0,21,群益金鼎-桃園,2023-07-20,9189
2634,漢翔,30,10,20,群益金鼎-桃園,2023-07-20,9189
6120,達運,24,5,19,群益金鼎-桃園,2023-07-20,9189
2352,佳世達,46,28,18,群益金鼎-桃園,2023-07-20,9189
3037,欣興,37,20,17,群益金鼎-桃園,2023-07-20,9189
1513,中興電,17,0,17,群益金鼎-桃園,2023-07-20,9189
6116,彩晶,15,0,15,群益金鼎-桃園,2023-07-20,9189
2801,彰銀,15,0,15,群益金鼎-桃園,2023-07-20,9189
6235,華孚,22,8,14,群益金鼎-桃園,2023-07-20,9189
3380,明泰,17,4,13,群益金鼎-桃園,2023-07-20,9189
1102,亞泥,12,0,12,群益金鼎-桃園,2023-07-20,9189
6706,惠特,12,0,12,群益金鼎-桃園,2023-07-20,9189
6188,廣明,52,40,12,群益金鼎-桃園,2023-07-20,9189
00893,國泰智能電動車,11,0,11,群益金鼎-桃園,2023-07-20,9189
3032,偉訓,36,26,10,群益金鼎-桃園,2023-07-20,9189
00664R,國泰臺灣加權反1,10,0,10,群益金鼎-桃園,2023-07-20,9189
1605,華新,12,2,10,群益金鼎-桃園,2023-07-20,9189
2834,臺企銀,10,0,10,群益金鼎-桃園,2023-07-20,9189
1785,光洋科,10,0,10,群益金鼎-桃園,2023-07-20,9189
4746,台耀,18,8,10,群益金鼎-桃園,2023-07-20,9189
3071,協禧,42,32,10,群益金鼎-桃園,2023-07-20,9189
2608,嘉里大榮,10,0,10,群益金鼎-桃園,2023-07-20,9189
2109,華豐,10,0,10,群益金鼎-桃園,2023-07-20,9189
6227,茂綸,10,0,10,群益金鼎-桃園,2023-07-20,9189
2461,光群雷,40,31,9,群益金鼎-桃園,2023-07-20,9189
3515,華擎,10,1,9,群益金鼎-桃園,2023-07-20,9189
1786,科妍,18,9,9,群益金鼎-桃園,2023-07-20,9189
4175,杏一,9,0,9,群益金鼎-桃園,2023-07-20,9189
6451,訊芯-KY,11,2,9,群益金鼎-桃園,2023-07-20,9189
6531,愛普*,8,0,8,群益金鼎-桃園,2023-07-20,9189
2436,偉詮電,16,8,8,群益金鼎-桃園,2023-07-20,9189
6288,聯嘉,11,3,8,群益金鼎-桃園,2023-07-20,9189
2610,華航,53,46,7,群益金鼎-桃園,2023-07-20,9189
3591,艾笛森,190,0,190,群益金鼎-桃園,2023-07-21,9189
00671R,富邦NASDAQ反1,148,0,148,群益金鼎-桃園,2023-07-21,9189
2883,凱基金,104,2,102,群益金鼎-桃園,2023-07-21,9189
2618,長榮航,142,62,80,群益金鼎-桃園,2023-07-21,9189
1513,中興電,136,60,76,群益金鼎-桃園,2023-07-21,9189
00885,富邦越南,76,2,74,群益金鼎-桃園,2023-07-21,9189
2303,聯電,66,6,60,群益金鼎-桃園,2023-07-21,9189
2887,台新金,59,0,59,群益金鼎-桃園,2023-07-21,9189
6806,森崴能源,54,6,48,群益金鼎-桃園,2023-07-21,9189
00927,群益半導體收益,48,0,48,群益金鼎-桃園,2023-07-21,9189
8033,雷虎,42,3,39,群益金鼎-桃園,2023-07-21,9189
4958,臻鼎-KY,34,0,34,群益金鼎-桃園,2023-07-21,9189
6274,台燿,37,3,34,群益金鼎-桃園,2023-07-21,9189
00679B,元大美債20年,32,0,32,群益金鼎-桃園,2023-07-21,9189
2027,大成鋼,32,2,30,群益金鼎-桃園,2023-07-21,9189
2301,光寶科,62,34,28,群益金鼎-桃園,2023-07-21,9189
2421,建準,37,12,25,群益金鼎-桃園,2023-07-21,9189
2605,新興,25,0,25,群益金鼎-桃園,2023-07-21,9189
1605,華新,34,9,25,群益金鼎-桃園,2023-07-21,9189
2609,陽明,38,14,24,群益金鼎-桃園,2023-07-21,9189
911868,同方友友-DR,20,0,20,群益金鼎-桃園,2023-07-21,9189
2357,華碩,21,2,19,群益金鼎-桃園,2023-07-21,9189
4532,瑞智,28,9,19,群益金鼎-桃園,2023-07-21,9189
4123,晟德,37,18,19,群益金鼎-桃園,2023-07-21,9189
3037,欣興,63,45,18,群益金鼎-桃園,2023-07-21,9189
00893,國泰智能電動車,18,0,18,群益金鼎-桃園,2023-07-21,9189
6187,萬潤,27,10,17,群益金鼎-桃園,2023-07-21,9189
5340,建榮,20,3,17,群益金鼎-桃園,2023-07-21,9189
2376,技嘉,39,22,17,群益金鼎-桃園,2023-07-21,9189
1217,愛之味,20,5,15,群益金鼎-桃園,2023-07-21,9189
1102,亞泥,15,0,15,群益金鼎-桃園,2023-07-21,9189
00919,群益台灣精選高息,14,0,14,群益金鼎-桃園,2023-07-21,9189
2206,三陽工業,34,21,13,群益金鼎-桃園,2023-07-21,9189
3324,雙鴻,18,5,13,群益金鼎-桃園,2023-07-21,9189
5443,均豪,14,1,13,群益金鼎-桃園,2023-07-21,9189
2739,寒舍,12,0,12,群益金鼎-桃園,2023-07-21,9189
3444,利機,15,3,12,群益金鼎-桃園,2023-07-21,9189
1101,台泥,19,7,12,群益金鼎-桃園,2023-07-21,9189
6244,茂迪,12,1,11,群益金鼎-桃園,2023-07-21,9189
6155,鈞寶,10,0,10,群益金鼎-桃園,2023-07-21,9189
4188,安克,10,0,10,群益金鼎-桃園,2023-07-21,9189
2208,台船,10,0,10,群益金鼎-桃園,2023-07-21,9189
2344,華邦電,10,0,10,群益金鼎-桃園,2023-07-21,9189
2382,廣達,64,55,9,群益金鼎-桃園,2023-07-21,9189
8046,南電,12,3,9,群益金鼎-桃園,2023-07-21,9189
2515,中工,9,0,9,群益金鼎-桃園,2023-07-21,9189
00892,富邦台灣半導體,9,0,9,群益金鼎-桃園,2023-07-21,9189
0050,元大台灣50,10,2,8,群益金鼎-桃園,2023-07-21,9189
8155,博智,11,3,8,群益金鼎-桃園,2023-07-21,9189
6190,萬泰科,8,0,8,群益金鼎-桃園,2023-07-21,9189
2883,凱基金,111,12,99,群益金鼎-桃園,2023-07-24,9189
2014,中鴻,98,22,76,群益金鼎-桃園,2023-07-24,9189
4720,德淵,60,0,60,群益金鼎-桃園,2023-07-24,9189
5880,合庫金,56,0,56,群益金鼎-桃園,2023-07-24,9189
2887,台新金,58,9,49,群益金鼎-桃園,2023-07-24,9189
2303,聯電,55,13,42,群益金鼎-桃園,2023-07-24,9189
2329,華泰,80,39,41,群益金鼎-桃園,2023-07-24,9189
00927,群益半導體收益,36,1,35,群益金鼎-桃園,2023-07-24,9189
1227,佳格,33,0,33,群益金鼎-桃園,2023-07-24,9189
3706,神達,46,15,31,群益金鼎-桃園,2023-07-24,9189
3689,湧德,53,25,28,群益金鼎-桃園,2023-07-24,9189
2301,光寶科,64,36,28,群益金鼎-桃園,2023-07-24,9189
4116,明基醫,24,1,23,群益金鼎-桃園,2023-07-24,9189
1609,大亞,68,45,23,群益金鼎-桃園,2023-07-24,9189
2618,長榮航,54,32,22,群益金鼎-桃園,2023-07-24,9189
00679B,元大美債20年,23,2,21,群益金鼎-桃園,2023-07-24,9189
1524,耿鼎,21,0,21,群益金鼎-桃園,2023-07-24,9189
00753L,中信中國50正2,21,0,21,群益金鼎-桃園,2023-07-24,9189
3481,群創,41,21,20,群益金鼎-桃園,2023-07-24,9189
3051,力特,21,1,20,群益金鼎-桃園,2023-07-24,9189
2884,玉山金,27,8,19,群益金鼎-桃園,2023-07-24,9189
6806,森崴能源,18,0,18,群益金鼎-桃園,2023-07-24,9189
2461,光群雷,23,5,18,群益金鼎-桃園,2023-07-24,9189
3231,緯創,43,26,17,群益金鼎-桃園,2023-07-24,9189
3037,欣興,72,55,17,群益金鼎-桃園,2023-07-24,9189
1528,恩德,21,4,17,群益金鼎-桃園,2023-07-24,9189
2352,佳世達,24,8,16,群益金鼎-桃園,2023-07-24,9189
5309,系統電,15,0,15,群益金鼎-桃園,2023-07-24,9189
2834,臺企銀,15,1,14,群益金鼎-桃園,2023-07-24,9189
2882,國泰金,30,16,14,群益金鼎-桃園,2023-07-24,9189
1504,東元,31,17,14,群益金鼎-桃園,2023-07-24,9189
4533,協易機,18,6,12,群益金鼎-桃園,2023-07-24,9189
00713,元大台灣高息低波,12,1,11,群益金鼎-桃園,2023-07-24,9189
1732,毛寶,11,0,11,群益金鼎-桃園,2023-07-24,9189
6443,元晶,11,0,11,群益金鼎-桃園,2023-07-24,9189
2357,華碩,18,8,10,群益金鼎-桃園,2023-07-24,9189
6120,達運,10,0,10,群益金鼎-桃園,2023-07-24,9189
3564,其陽,12,2,10,群益金鼎-桃園,2023-07-24,9189
3092,鴻碩,10,0,10,群益金鼎-桃園,2023-07-24,9189
4958,臻鼎-KY,10,0,10,群益金鼎-桃園,2023-07-24,9189
00671R,富邦NASDAQ反1,10,0,10,群益金鼎-桃園,2023-07-24,9189
00772B,中信高評級公司債,10,0,10,群益金鼎-桃園,2023-07-24,9189
1102,亞泥,9,0,9,群益金鼎-桃園,2023-07-24,9189
2338,光罩,10,1,9,群益金鼎-桃園,2023-07-24,9189
2002,中鋼,9,0,9,群益金鼎-桃園,2023-07-24,9189
2353,宏��,35,27,8,群益金鼎-桃園,2023-07-24,9189
2880,華南金,8,0,8,群益金鼎-桃園,2023-07-24,9189
2493,揚博,8,0,8,群益金鼎-桃園,2023-07-24,9189
8103,瀚荃,10,2,8,群益金鼎-桃園,2023-07-24,9189
2881,富邦金,13,5,8,群益金鼎-桃園,2023-07-24,9189
00679B,元大美債20年,125,0,125,群益金鼎-桃園,2023-07-25,9189
1101,台泥,104,5,99,群益金鼎-桃園,2023-07-25,9189
2382,廣達,149,54,95,群益金鼎-桃園,2023-07-25,9189
2891,中信金,93,1,92,群益金鼎-桃園,2023-07-25,9189
00632R,元大台灣50反1,138,50,88,群益金鼎-桃園,2023-07-25,9189
1905,華紙,94,27,67,群益金鼎-桃園,2023-07-25,9189
2913,農林,57,0,57,群益金鼎-桃園,2023-07-25,9189
00706L,期元大S＆P日圓正2,51,0,51,群益金鼎-桃園,2023-07-25,9189
2405,輔信,62,27,35,群益金鼎-桃園,2023-07-25,9189
3037,欣興,60,27,33,群益金鼎-桃園,2023-07-25,9189
6190,萬泰科,28,0,28,群益金鼎-桃園,2023-07-25,9189
3035,智原,31,3,28,群益金鼎-桃園,2023-07-25,9189
2303,聯電,50,23,27,群益金鼎-桃園,2023-07-25,9189
00671R,富邦NASDAQ反1,26,0,26,群益金鼎-桃園,2023-07-25,9189
3702,大聯大,22,0,22,群益金鼎-桃園,2023-07-25,9189
6188,廣明,56,34,22,群益金鼎-桃園,2023-07-25,9189
3231,緯創,30,8,22,群益金鼎-桃園,2023-07-25,9189
8358,金居,91,70,21,群益金鼎-桃園,2023-07-25,9189
2634,漢翔,27,6,21,群益金鼎-桃園,2023-07-25,9189
2002,中鋼,19,0,19,群益金鼎-桃園,2023-07-25,9189
2376,技嘉,66,48,18,群益金鼎-桃園,2023-07-25,9189
00720B,元大投資級公司債,15,0,15,群益金鼎-桃園,2023-07-25,9189
2609,陽明,16,1,15,群益金鼎-桃園,2023-07-25,9189
5432,新門,15,0,15,群益金鼎-桃園,2023-07-25,9189
3032,偉訓,41,26,15,群益金鼎-桃園,2023-07-25,9189
2324,仁寶,42,27,15,群益金鼎-桃園,2023-07-25,9189
1314,中石化,14,0,14,群益金鼎-桃園,2023-07-25,9189
2887,台新金,30,16,14,群益金鼎-桃園,2023-07-25,9189
2495,普安,14,1,13,群益金鼎-桃園,2023-07-25,9189
00673R,期元大S＆P原油反1,13,0,13,群益金鼎-桃園,2023-07-25,9189
2888,新光金,13,1,12,群益金鼎-桃園,2023-07-25,9189
2915,潤泰全,11,0,11,群益金鼎-桃園,2023-07-25,9189
3537,堡達,10,0,10,群益金鼎-桃園,2023-07-25,9189
1455,集盛,10,0,10,群益金鼎-桃園,2023-07-25,9189
8436,大江,10,0,10,群益金鼎-桃園,2023-07-25,9189
911868,同方友友-DR,10,0,10,群益金鼎-桃園,2023-07-25,9189
2388,威盛,10,1,9,群益金鼎-桃園,2023-07-25,9189
00919,群益台灣精選高息,22,13,9,群益金鼎-桃園,2023-07-25,9189
2393,億光,10,1,9,群益金鼎-桃園,2023-07-25,9189
3071,協禧,25,16,9,群益金鼎-桃園,2023-07-25,9189
2610,華航,15,7,8,群益金鼎-桃園,2023-07-25,9189
3324,雙鴻,20,12,8,群益金鼎-桃園,2023-07-25,9189
2607,榮運,9,1,8,群益金鼎-桃園,2023-07-25,9189
2515,中工,8,0,8,群益金鼎-桃園,2023-07-25,9189
2353,宏��,37,29,8,群益金鼎-桃園,2023-07-25,9189
2481,強茂,9,1,8,群益金鼎-桃園,2023-07-25,9189
3363,上詮,12,4,8,群益金鼎-桃園,2023-07-25,9189
6187,萬潤,30,22,8,群益金鼎-桃園,2023-07-25,9189
4510,高鋒,11,3,8,群益金鼎-桃園,2023-07-25,9189
2356,英業達,44,37,7,群益金鼎-桃園,2023-07-25,9189
2834,臺企銀,181,6,175,群益金鼎-桃園,2023-07-26,9189
00715L,期街口布蘭特正2,172,46,126,群益金鼎-桃園,2023-07-26,9189
2884,玉山金,168,43,125,群益金鼎-桃園,2023-07-26,9189
1504,東元,272,160,112,群益金鼎-桃園,2023-07-26,9189
3481,群創,117,21,96,群益金鼎-桃園,2023-07-26,9189
00927,群益半導體收益,84,0,84,群益金鼎-桃園,2023-07-26,9189
2303,聯電,63,2,61,群益金鼎-桃園,2023-07-26,9189
3035,智原,44,0,44,群益金鼎-桃園,2023-07-26,9189
00929,復華台灣科技優息,43,0,43,群益金鼎-桃園,2023-07-26,9189
1760,寶齡富錦,42,0,42,群益金鼎-桃園,2023-07-26,9189
4116,明基醫,36,0,36,群益金鼎-桃園,2023-07-26,9189
2344,華邦電,30,0,30,群益金鼎-桃園,2023-07-26,9189
2468,華經,37,8,29,群益金鼎-桃園,2023-07-26,9189
2354,鴻準,33,10,23,群益金鼎-桃園,2023-07-26,9189
00772B,中信高評級公司債,23,0,23,群益金鼎-桃園,2023-07-26,9189
4129,聯合,23,1,22,群益金鼎-桃園,2023-07-26,9189
3689,湧德,73,51,22,群益金鼎-桃園,2023-07-26,9189
2027,大成鋼,25,3,22,群益金鼎-桃園,2023-07-26,9189
2357,華碩,25,3,22,群益金鼎-桃園,2023-07-26,9189
6841,長佳智能,27,6,21,群益金鼎-桃園,2023-07-26,9189
4934,太極,20,0,20,群益金鼎-桃園,2023-07-26,9189
6188,廣明,35,16,19,群益金鼎-桃園,2023-07-26,9189
2891,中信金,25,6,19,群益金鼎-桃園,2023-07-26,9189
00720B,元大投資級公司債,19,0,19,群益金鼎-桃園,2023-07-26,9189
4188,安克,26,10,16,群益金鼎-桃園,2023-07-26,9189
2313,華通,18,2,16,群益金鼎-桃園,2023-07-26,9189
2376,技嘉,28,12,16,群益金鼎-桃園,2023-07-26,9189
00679B,元大美債20年,14,0,14,群益金鼎-桃園,2023-07-26,9189
8011,台通,14,0,14,群益金鼎-桃園,2023-07-26,9189
4153,鈺緯,24,10,14,群益金鼎-桃園,2023-07-26,9189
6274,台燿,37,24,13,群益金鼎-桃園,2023-07-26,9189
2371,大同,16,3,13,群益金鼎-桃園,2023-07-26,9189
5483,中美晶,16,3,13,群益金鼎-桃園,2023-07-26,9189
4938,和碩,17,5,12,群益金鼎-桃園,2023-07-26,9189
2002,中鋼,12,0,12,群益金鼎-桃園,2023-07-26,9189
00752,中信中國50,12,0,12,群益金鼎-桃園,2023-07-26,9189
00892,富邦台灣半導體,12,0,12,群益金鼎-桃園,2023-07-26,9189
3521,鴻翊,12,0,12,群益金鼎-桃園,2023-07-26,9189
3706,神達,12,1,11,群益金鼎-桃園,2023-07-26,9189
1101,台泥,13,2,11,群益金鼎-桃園,2023-07-26,9189
3024,憶聲,12,1,11,群益金鼎-桃園,2023-07-26,9189
3016,嘉晶,12,1,11,群益金鼎-桃園,2023-07-26,9189
6426,統新,11,0,11,群益金鼎-桃園,2023-07-26,9189
2328,廣宇,11,0,11,群益金鼎-桃園,2023-07-26,9189
2883,凱基金,31,20,11,群益金鼎-桃園,2023-07-26,9189
1795,美時,20,10,10,群益金鼎-桃園,2023-07-26,9189
2388,威盛,10,0,10,群益金鼎-桃園,2023-07-26,9189
1312,國喬,10,0,10,群益金鼎-桃園,2023-07-26,9189
6257,矽格,10,0,10,群益金鼎-桃園,2023-07-26,9189
6227,茂綸,10,0,10,群益金鼎-桃園,2023-07-26,9189
00632R,元大台灣50反1,93,0,93,群益金鼎-桃園,2023-07-27,9189
6116,彩晶,120,31,89,群益金鼎-桃園,2023-07-27,9189
00878,國泰永續高股息,87,20,67,群益金鼎-桃園,2023-07-27,9189
1701,中化,53,0,53,群益金鼎-桃園,2023-07-27,9189
00679B,元大美債20年,53,1,52,群益金鼎-桃園,2023-07-27,9189
6026,福邦證,50,0,50,群益金鼎-桃園,2023-07-27,9189
2002,中鋼,33,1,32,群益金鼎-桃園,2023-07-27,9189
3037,欣興,50,19,31,群益金鼎-桃園,2023-07-27,9189
2382,廣達,67,37,30,群益金鼎-桃園,2023-07-27,9189
3045,台灣大,30,0,30,群益金鼎-桃園,2023-07-27,9189
2412,中華電,30,1,29,群益金鼎-桃園,2023-07-27,9189
3013,晟銘電,37,10,27,群益金鼎-桃園,2023-07-27,9189
5340,建榮,27,1,26,群益金鼎-桃園,2023-07-27,9189
2104,國際中橡,25,0,25,群益金鼎-桃園,2023-07-27,9189
00919,群益台灣精選高息,30,6,24,群益金鼎-桃園,2023-07-27,9189
2425,承啟,32,8,24,群益金鼎-桃園,2023-07-27,9189
6690,安�硌穈T,25,3,22,群益金鼎-桃園,2023-07-27,9189
2471,資通,44,22,22,群益金鼎-桃園,2023-07-27,9189
6203,海韻電,25,4,21,群益金鼎-桃園,2023-07-27,9189
00673R,期元大S＆P原油反1,20,0,20,群益金鼎-桃園,2023-07-27,9189
3035,智原,28,8,20,群益金鼎-桃園,2023-07-27,9189
2884,玉山金,19,1,18,群益金鼎-桃園,2023-07-27,9189
00655L,國泰中國A50正2,18,0,18,群益金鼎-桃園,2023-07-27,9189
1504,東元,42,24,18,群益金鼎-桃園,2023-07-27,9189
2354,鴻準,18,0,18,群益金鼎-桃園,2023-07-27,9189
2881,富邦金,23,7,16,群益金鼎-桃園,2023-07-27,9189
1522,堤維西,21,5,16,群益金鼎-桃園,2023-07-27,9189
1815,富喬,36,21,15,群益金鼎-桃園,2023-07-27,9189
1785,光洋科,15,0,15,群益金鼎-桃園,2023-07-27,9189
5388,中磊,16,1,15,群益金鼎-桃園,2023-07-27,9189
8358,金居,67,52,15,群益金鼎-桃園,2023-07-27,9189
4533,協易機,56,42,14,群益金鼎-桃園,2023-07-27,9189
4934,太極,14,0,14,群益金鼎-桃園,2023-07-27,9189
6185,幃翔,13,0,13,群益金鼎-桃園,2023-07-27,9189
1313,聯成,19,6,13,群益金鼎-桃園,2023-07-27,9189
2359,所羅門,15,3,12,群益金鼎-桃園,2023-07-27,9189
3056,富華新,22,10,12,群益金鼎-桃園,2023-07-27,9189
6485,點序,12,0,12,群益金鼎-桃園,2023-07-27,9189
3711,日月光投控,13,1,12,群益金鼎-桃園,2023-07-27,9189
5258,虹堡,13,2,11,群益金鼎-桃園,2023-07-27,9189
00893,國泰智能電動車,13,3,10,群益金鼎-桃園,2023-07-27,9189
2353,宏��,19,9,10,群益金鼎-桃園,2023-07-27,9189
4938,和碩,11,1,10,群益金鼎-桃園,2023-07-27,9189
2501,國建,10,0,10,群益金鼎-桃園,2023-07-27,9189
6603,富強鑫,10,0,10,群益金鼎-桃園,2023-07-27,9189
1454,台富,10,0,10,群益金鼎-桃園,2023-07-27,9189
6015,宏遠證,16,6,10,群益金鼎-桃園,2023-07-27,9189
6182,合晶,15,5,10,群益金鼎-桃園,2023-07-27,9189
2357,華碩,11,1,10,群益金鼎-桃園,2023-07-27,9189
5009,榮剛,15,6,9,群益金鼎-桃園,2023-07-27,9189
2888,新光金,405,34,371,群益金鼎-桃園,2023-07-28,9189
00679B,元大美債20年,109,0,109,群益金鼎-桃園,2023-07-28,9189
1905,華紙,219,151,68,群益金鼎-桃園,2023-07-28,9189
2027,大成鋼,65,2,63,群益金鼎-桃園,2023-07-28,9189
2405,輔信,55,0,55,群益金鼎-桃園,2023-07-28,9189
2329,華泰,130,77,53,群益金鼎-桃園,2023-07-28,9189
2637,慧洋-KY,52,0,52,群益金鼎-桃園,2023-07-28,9189
2883,凱基金,59,13,46,群益金鼎-桃園,2023-07-28,9189
6535,順藥,42,7,35,群益金鼎-桃園,2023-07-28,9189
00712,復華富時不動產,33,0,33,群益金鼎-桃園,2023-07-28,9189
1802,台玻,47,18,29,群益金鼎-桃園,2023-07-28,9189
3037,欣興,39,13,26,群益金鼎-桃園,2023-07-28,9189
1504,東元,85,60,25,群益金鼎-桃園,2023-07-28,9189
3521,鴻翊,24,0,24,群益金鼎-桃園,2023-07-28,9189
6770,力積電,27,5,22,群益金鼎-桃園,2023-07-28,9189
00680L,元大美債20正2,22,0,22,群益金鼎-桃園,2023-07-28,9189
6125,廣運,33,11,22,群益金鼎-桃園,2023-07-28,9189
00632R,元大台灣50反1,85,64,21,群益金鼎-桃園,2023-07-28,9189
2610,華航,77,57,20,群益金鼎-桃園,2023-07-28,9189
3038,全台,20,0,20,群益金鼎-桃園,2023-07-28,9189
3056,富華新,29,10,19,群益金鼎-桃園,2023-07-28,9189
2340,台亞,22,4,18,群益金鼎-桃園,2023-07-28,9189
00655L,國泰中國A50正2,17,0,17,群益金鼎-桃園,2023-07-28,9189
00706L,期元大S＆P日圓正2,15,0,15,群益金鼎-桃園,2023-07-28,9189
5388,中磊,14,0,14,群益金鼎-桃園,2023-07-28,9189
8050,廣積,22,8,14,群益金鼎-桃園,2023-07-28,9189
2352,佳世達,51,38,13,群益金鼎-桃園,2023-07-28,9189
4919,新唐,27,14,13,群益金鼎-桃園,2023-07-28,9189
2002,中鋼,12,0,12,群益金鼎-桃園,2023-07-28,9189
6806,森崴能源,11,0,11,群益金鼎-桃園,2023-07-28,9189
4934,太極,11,0,11,群益金鼎-桃園,2023-07-28,9189
1701,中化,10,0,10,群益金鼎-桃園,2023-07-28,9189
4116,明基醫,10,0,10,群益金鼎-桃園,2023-07-28,9189
2731,雄獅,12,2,10,群益金鼎-桃園,2023-07-28,9189
2820,華票,10,0,10,群益金鼎-桃園,2023-07-28,9189
6213,聯茂,17,7,10,群益金鼎-桃園,2023-07-28,9189
2606,裕民,11,1,10,群益金鼎-桃園,2023-07-28,9189
5386,青雲,24,14,10,群益金鼎-桃園,2023-07-28,9189
2892,第一金,10,0,10,群益金鼎-桃園,2023-07-28,9189
3013,晟銘電,25,16,9,群益金鼎-桃園,2023-07-28,9189
2402,毅嘉,45,36,9,群益金鼎-桃園,2023-07-28,9189
9919,康那香,9,0,9,群益金鼎-桃園,2023-07-28,9189
6279,胡連,10,1,9,群益金鼎-桃園,2023-07-28,9189
2453,凌群,14,6,8,群益金鼎-桃園,2023-07-28,9189
4726,永昕,8,0,8,群益金鼎-桃園,2023-07-28,9189
3228,金麗科,8,0,8,群益金鼎-桃園,2023-07-28,9189
3191,雲嘉南,10,2,8,群益金鼎-桃園,2023-07-28,9189
6126,信音,8,0,8,群益金鼎-桃園,2023-07-28,9189
1513,中興電,11,4,7,群益金鼎-桃園,2023-07-28,9189
00720B,元大投資級公司債,7,0,7,群益金鼎-桃園,2023-07-28,9189
2801,彰銀,255,1,254,群益金鼎-桃園,2023-07-31,9189
2405,輔信,104,11,93,群益金鼎-桃園,2023-07-31,9189
00900,富邦特選高股息30,91,3,88,群益金鼎-桃園,2023-07-31,9189
00878,國泰永續高股息,108,36,72,群益金鼎-桃園,2023-07-31,9189
2352,佳世達,87,26,61,群益金鼎-桃園,2023-07-31,9189
00706L,期元大S＆P日圓正2,58,0,58,群益金鼎-桃園,2023-07-31,9189
2883,凱基金,70,14,56,群益金鼎-桃園,2023-07-31,9189
2382,廣達,114,59,55,群益金鼎-桃園,2023-07-31,9189
2104,國際中橡,54,0,54,群益金鼎-桃園,2023-07-31,9189
3055,蔚華科,50,8,42,群益金鼎-桃園,2023-07-31,9189
2609,陽明,52,12,40,群益金鼎-桃園,2023-07-31,9189
3706,神達,46,7,39,群益金鼎-桃園,2023-07-31,9189
1802,台玻,71,32,39,群益金鼎-桃園,2023-07-31,9189
5340,建榮,56,19,37,群益金鼎-桃園,2023-07-31,9189
00673R,期元大S＆P原油反1,31,0,31,群益金鼎-桃園,2023-07-31,9189
6188,廣明,45,19,26,群益金鼎-桃園,2023-07-31,9189
6584,南俊國際,25,0,25,群益金鼎-桃園,2023-07-31,9189
2883B,凱基金乙特,22,0,22,群益金鼎-桃園,2023-07-31,9189
6274,台燿,51,30,21,群益金鼎-桃園,2023-07-31,9189
00645,富邦日本,21,0,21,群益金鼎-桃園,2023-07-31,9189
2455,全新,27,6,21,群益金鼎-桃園,2023-07-31,9189
2610,華航,28,7,21,群益金鼎-桃園,2023-07-31,9189
00679B,元大美債20年,25,5,20,群益金鼎-桃園,2023-07-31,9189
8068,全達,20,0,20,群益金鼎-桃園,2023-07-31,9189
00795B,中信美國公債20年,20,1,19,群益金鼎-桃園,2023-07-31,9189
2419,仲琦,45,26,19,群益金鼎-桃園,2023-07-31,9189
00919,群益台灣精選高息,18,0,18,群益金鼎-桃園,2023-07-31,9189
2208,台船,18,0,18,群益金鼎-桃園,2023-07-31,9189
4938,和碩,23,6,17,群益金鼎-桃園,2023-07-31,9189
1721,三晃,17,0,17,群益金鼎-桃園,2023-07-31,9189
2323,中環,17,0,17,群益金鼎-桃園,2023-07-31,9189
2357,華碩,44,27,17,群益金鼎-桃園,2023-07-31,9189
1809,中釉,16,1,15,群益金鼎-桃園,2023-07-31,9189
5443,均豪,29,14,15,群益金鼎-桃園,2023-07-31,9189
2495,普安,14,0,14,群益金鼎-桃園,2023-07-31,9189
8050,廣積,26,12,14,群益金鼎-桃園,2023-07-31,9189
2748,雲品,26,12,14,群益金鼎-桃園,2023-07-31,9189
6182,合晶,17,3,14,群益金鼎-桃園,2023-07-31,9189
2453,凌群,20,6,14,群益金鼎-桃園,2023-07-31,9189
2002,中鋼,15,2,13,群益金鼎-桃園,2023-07-31,9189
2356,英業達,34,21,13,群益金鼎-桃園,2023-07-31,9189
2317,鴻海,16,4,12,群益金鼎-桃園,2023-07-31,9189
1806,冠軍,12,0,12,群益金鼎-桃園,2023-07-31,9189
6185,幃翔,12,0,12,群益金鼎-桃園,2023-07-31,9189
00655L,國泰中國A50正2,22,10,12,群益金鼎-桃園,2023-07-31,9189
00687B,國泰20年美債,12,0,12,群益金鼎-桃園,2023-07-31,9189
3306,鼎天,13,1,12,群益金鼎-桃園,2023-07-31,9189
5009,榮剛,12,0,12,群益金鼎-桃園,2023-07-31,9189
2027,大成鋼,14,2,12,群益金鼎-桃園,2023-07-31,9189
3583,辛耘,18,7,11,群益金鼎-桃園,2023-07-31,9189
00878,國泰永續高股息,312,128,184,群益金鼎-桃園,2023-08-01,9189
2301,光寶科,166,72,94,群益金鼎-桃園,2023-08-01,9189
3013,晟銘電,75,6,69,群益金鼎-桃園,2023-08-01,9189
2313,華通,66,0,66,群益金鼎-桃園,2023-08-01,9189
2883,凱基金,83,20,63,群益金鼎-桃園,2023-08-01,9189
00929,復華台灣科技優息,52,2,50,群益金鼎-桃園,2023-08-01,9189
2489,瑞軒,50,2,48,群益金鼎-桃園,2023-08-01,9189
2324,仁寶,54,7,47,群益金鼎-桃園,2023-08-01,9189
00753L,中信中國50正2,73,31,42,群益金鼎-桃園,2023-08-01,9189
8358,金居,42,5,37,群益金鼎-桃園,2023-08-01,9189
2329,華泰,41,6,35,群益金鼎-桃園,2023-08-01,9189
00632R,元大台灣50反1,160,126,34,群益金鼎-桃園,2023-08-01,9189
00885,富邦越南,46,14,32,群益金鼎-桃園,2023-08-01,9189
3011,今皓,37,7,30,群益金鼎-桃園,2023-08-01,9189
2801,彰銀,28,0,28,群益金鼎-桃園,2023-08-01,9189
2027,大成鋼,28,0,28,群益金鼎-桃園,2023-08-01,9189
1905,華紙,86,59,27,群益金鼎-桃園,2023-08-01,9189
1513,中興電,49,24,25,群益金鼎-桃園,2023-08-01,9189
6282,康舒,74,49,25,群益金鼎-桃園,2023-08-01,9189
2890,永豐金,26,1,25,群益金鼎-桃園,2023-08-01,9189
3078,僑威,27,2,25,群益金鼎-桃園,2023-08-01,9189
3711,日月光投控,23,0,23,群益金鼎-桃園,2023-08-01,9189
2369,菱生,23,0,23,群益金鼎-桃園,2023-08-01,9189
2352,佳世達,28,7,21,群益金鼎-桃園,2023-08-01,9189
6191,精成科,20,0,20,群益金鼎-桃園,2023-08-01,9189
00751B,元大AAA至A公司債,20,0,20,群益金鼎-桃園,2023-08-01,9189
2338,光罩,20,2,18,群益金鼎-桃園,2023-08-01,9189
2328,廣宇,16,0,16,群益金鼎-桃園,2023-08-01,9189
3325,旭品,17,1,16,群益金鼎-桃園,2023-08-01,9189
3105,穩懋,22,7,15,群益金鼎-桃園,2023-08-01,9189
2606,裕民,15,0,15,群益金鼎-桃園,2023-08-01,9189
3580,友威科,16,1,15,群益金鼎-桃園,2023-08-01,9189
1504,東元,16,2,14,群益金鼎-桃園,2023-08-01,9189
6234,高僑,16,2,14,群益金鼎-桃園,2023-08-01,9189
2323,中環,13,0,13,群益金鼎-桃園,2023-08-01,9189
3257,虹冠電,13,0,13,群益金鼎-桃園,2023-08-01,9189
8222,寶一,13,1,12,群益金鼎-桃園,2023-08-01,9189
3583,辛耘,36,24,12,群益金鼎-桃園,2023-08-01,9189
2402,毅嘉,31,19,12,群益金鼎-桃園,2023-08-01,9189
1904,正隆,14,2,12,群益金鼎-桃園,2023-08-01,9189
3231,緯創,82,70,12,群益金鼎-桃園,2023-08-01,9189
6770,力積電,12,1,11,群益金鼎-桃園,2023-08-01,9189
6239,力成,11,0,11,群益金鼎-桃園,2023-08-01,9189
8027,鈦昇,16,5,11,群益金鼎-桃園,2023-08-01,9189
2344,華邦電,21,10,11,群益金鼎-桃園,2023-08-01,9189
6125,廣運,26,16,10,群益金鼎-桃園,2023-08-01,9189
00642U,期元大S＆P石油,10,0,10,群益金鼎-桃園,2023-08-01,9189
5531,鄉林,10,0,10,群益金鼎-桃園,2023-08-01,9189
2913,農林,60,50,10,群益金鼎-桃園,2023-08-01,9189
00665L,富邦�琤肭磪囓�2,10,0,10,群益金鼎-桃園,2023-08-01,9189
00878,國泰永續高股息,395,87,308,群益金鼎-桃園,2023-08-02,9189
2812,台中銀,294,0,294,群益金鼎-桃園,2023-08-02,9189
00706L,期元大S＆P日圓正2,140,0,140,群益金鼎-桃園,2023-08-02,9189
1609,大亞,186,86,100,群益金鼎-桃園,2023-08-02,9189
00929,復華台灣科技優息,100,9,91,群益金鼎-桃園,2023-08-02,9189
00680L,元大美債20正2,110,30,80,群益金鼎-桃園,2023-08-02,9189
6535,順藥,63,0,63,群益金鼎-桃園,2023-08-02,9189
3481,群創,76,14,62,群益金鼎-桃園,2023-08-02,9189
00923,群益台ESG低碳50,61,0,61,群益金鼎-桃園,2023-08-02,9189
2888,新光金,91,30,61,群益金鼎-桃園,2023-08-02,9189
6285,啟��,75,18,57,群益金鼎-桃園,2023-08-02,9189
3231,緯創,115,71,44,群益金鼎-桃園,2023-08-02,9189
3037,欣興,65,21,44,群益金鼎-桃園,2023-08-02,9189
00900,富邦特選高股息30,42,1,41,群益金鼎-桃園,2023-08-02,9189
2402,毅嘉,62,25,37,群益金鼎-桃園,2023-08-02,9189
2883,凱基金,45,8,37,群益金鼎-桃園,2023-08-02,9189
00882,中信中國高股息,40,4,36,群益金鼎-桃園,2023-08-02,9189
2308,台達電,42,9,33,群益金鼎-桃園,2023-08-02,9189
2324,仁寶,40,7,33,群益金鼎-桃園,2023-08-02,9189
4155,訊映,32,0,32,群益金鼎-桃園,2023-08-02,9189
2618,長榮航,44,14,30,群益金鼎-桃園,2023-08-02,9189
2409,友達,41,12,29,群益金鼎-桃園,2023-08-02,9189
00772B,中信高評級公司債,28,0,28,群益金鼎-桃園,2023-08-02,9189
00892,富邦台灣半導體,26,0,26,群益金鼎-桃園,2023-08-02,9189
2313,華通,28,2,26,群益金鼎-桃園,2023-08-02,9189
2038,海光,25,0,25,群益金鼎-桃園,2023-08-02,9189
2615,萬海,34,11,23,群益金鼎-桃園,2023-08-02,9189
2880,華南金,22,0,22,群益金鼎-桃園,2023-08-02,9189
2371,大同,20,0,20,群益金鼎-桃園,2023-08-02,9189
3094,聯傑,20,0,20,群益金鼎-桃園,2023-08-02,9189
3078,僑威,24,5,19,群益金鼎-桃園,2023-08-02,9189
3583,辛耘,27,8,19,群益金鼎-桃園,2023-08-02,9189
1513,中興電,33,15,18,群益金鼎-桃園,2023-08-02,9189
2382,廣達,80,62,18,群益金鼎-桃園,2023-08-02,9189
3711,日月光投控,18,0,18,群益金鼎-桃園,2023-08-02,9189
2801,彰銀,18,0,18,群益金鼎-桃園,2023-08-02,9189
3033,威健,17,0,17,群益金鼎-桃園,2023-08-02,9189
00687B,國泰20年美債,17,0,17,群益金鼎-桃園,2023-08-02,9189
0056,元大高股息,63,47,16,群益金鼎-桃園,2023-08-02,9189
2206,三陽工業,28,13,15,群益金鼎-桃園,2023-08-02,9189
2345,智邦,14,0,14,群益金鼎-桃園,2023-08-02,9189
6125,廣運,22,8,14,群益金鼎-桃園,2023-08-02,9189
1742,台蠟,13,0,13,群益金鼎-桃園,2023-08-02,9189
1217,愛之味,14,2,12,群益金鼎-桃園,2023-08-02,9189
00696B,富邦美債20年,12,0,12,群益金鼎-桃園,2023-08-02,9189
2002,中鋼,12,0,12,群益金鼎-桃園,2023-08-02,9189
8936,國統,12,0,12,群益金鼎-桃園,2023-08-02,9189
2303,聯電,13,2,11,群益金鼎-桃園,2023-08-02,9189
2317,鴻海,22,11,11,群益金鼎-桃園,2023-08-02,9189
00773B,中信優先金融債,11,0,11,群益金鼎-桃園,2023-08-02,9189
2891,中信金,345,0,345,群益金鼎-桃園,2023-08-04,9189
00680L,元大美債20正2,174,2,172,群益金鼎-桃園,2023-08-04,9189
00929,復華台灣科技優息,112,2,110,群益金鼎-桃園,2023-08-04,9189
00679B,元大美債20年,73,4,69,群益金鼎-桃園,2023-08-04,9189
2883,凱基金,75,11,64,群益金鼎-桃園,2023-08-04,9189
1605,華新,73,10,63,群益金鼎-桃園,2023-08-04,9189
3231,緯創,216,164,52,群益金鼎-桃園,2023-08-04,9189
00923,群益台ESG低碳50,53,4,49,群益金鼎-桃園,2023-08-04,9189
2344,華邦電,46,4,42,群益金鼎-桃園,2023-08-04,9189
3013,晟銘電,41,0,41,群益金鼎-桃園,2023-08-04,9189
00720B,元大投資級公司債,41,0,41,群益金鼎-桃園,2023-08-04,9189
00687B,國泰20年美債,39,0,39,群益金鼎-桃園,2023-08-04,9189
3021,鴻名,36,0,36,群益金鼎-桃園,2023-08-04,9189
00722B,群益投資級電信債,35,0,35,群益金鼎-桃園,2023-08-04,9189
1710,東聯,30,0,30,群益金鼎-桃園,2023-08-04,9189
2455,全新,33,4,29,群益金鼎-桃園,2023-08-04,9189
1210,大成,28,2,26,群益金鼎-桃園,2023-08-04,9189
00850,元大臺灣ESG永續,25,0,25,群益金鼎-桃園,2023-08-04,9189
8930,青鋼,25,0,25,群益金鼎-桃園,2023-08-04,9189
1905,華紙,40,16,24,群益金鼎-桃園,2023-08-04,9189
3047,訊舟,24,0,24,群益金鼎-桃園,2023-08-04,9189
3029,零壹,31,9,22,群益金鼎-桃園,2023-08-04,9189
2371,大同,42,20,22,群益金鼎-桃園,2023-08-04,9189
2329,華泰,30,8,22,群益金鼎-桃園,2023-08-04,9189
00706L,期元大S＆P日圓正2,20,0,20,群益金鼎-桃園,2023-08-04,9189
2014,中鴻,22,3,19,群益金鼎-桃園,2023-08-04,9189
3032,偉訓,23,4,19,群益金鼎-桃園,2023-08-04,9189
00772B,中信高評級公司債,19,2,17,群益金鼎-桃園,2023-08-04,9189
00696B,富邦美債20年,16,0,16,群益金鼎-桃園,2023-08-04,9189
00885,富邦越南,20,4,16,群益金鼎-桃園,2023-08-04,9189
2330,台積電,16,0,16,群益金鼎-桃園,2023-08-04,9189
00893,國泰智能電動車,21,6,15,群益金鼎-桃園,2023-08-04,9189
1904,正隆,15,0,15,群益金鼎-桃園,2023-08-04,9189
2485,兆赫,15,0,15,群益金鼎-桃園,2023-08-04,9189
4533,協易機,37,23,14,群益金鼎-桃園,2023-08-04,9189
4746,台耀,15,1,14,群益金鼎-桃園,2023-08-04,9189
2369,菱生,14,0,14,群益金鼎-桃園,2023-08-04,9189
2352,佳世達,15,1,14,群益金鼎-桃園,2023-08-04,9189
2913,農林,22,9,13,群益金鼎-桃園,2023-08-04,9189
2618,長榮航,19,7,12,群益金鼎-桃園,2023-08-04,9189
3576,聯合再生,12,0,12,群益金鼎-桃園,2023-08-04,9189
3037,欣興,17,6,11,群益金鼎-桃園,2023-08-04,9189
1603,華電,12,1,11,群益金鼎-桃園,2023-08-04,9189
00900,富邦特選高股息30,10,0,10,群益金鼎-桃園,2023-08-04,9189
00895,富邦未來車,10,0,10,群益金鼎-桃園,2023-08-04,9189
2009,第一銅,10,0,10,群益金鼎-桃園,2023-08-04,9189
00688L,國泰20年美債正2,10,0,10,群益金鼎-桃園,2023-08-04,9189
3305,昇貿,11,1,10,群益金鼎-桃園,2023-08-04,9189
5533,皇鼎,10,0,10,群益金鼎-桃園,2023-08-04,9189
6139,亞翔,10,0,10,群益金鼎-桃園,2023-08-04,9189
1216,統一,101,0,101,群益金鼎-桃園,2023-08-07,9189
2618,長榮航,133,40,93,群益金鼎-桃園,2023-08-07,9189
00931B,統一美債20年,107,15,92,群益金鼎-桃園,2023-08-07,9189
2913,農林,72,5,67,群益金鼎-桃園,2023-08-07,9189
2609,陽明,57,13,44,群益金鼎-桃園,2023-08-07,9189
2301,光寶科,91,48,43,群益金鼎-桃園,2023-08-07,9189
00706L,期元大S＆P日圓正2,40,0,40,群益金鼎-桃園,2023-08-07,9189
3576,聯合再生,33,0,33,群益金鼎-桃園,2023-08-07,9189
6274,台燿,72,49,23,群益金鼎-桃園,2023-08-07,9189
00772B,中信高評級公司債,22,0,22,群益金鼎-桃園,2023-08-07,9189
2317,鴻海,32,10,22,群益金鼎-桃園,2023-08-07,9189
2356,英業達,67,46,21,群益金鼎-桃園,2023-08-07,9189
00923,群益台ESG低碳50,21,0,21,群益金鼎-桃園,2023-08-07,9189
00679B,元大美債20年,31,10,21,群益金鼎-桃園,2023-08-07,9189
1618,合機,20,0,20,群益金鼎-桃園,2023-08-07,9189
2368,金像電,28,8,20,群益金鼎-桃園,2023-08-07,9189
2332,友訊,20,0,20,群益金鼎-桃園,2023-08-07,9189
8358,金居,20,1,19,群益金鼎-桃園,2023-08-07,9189
3013,晟銘電,25,7,18,群益金鼎-桃園,2023-08-07,9189
00882,中信中國高股息,18,0,18,群益金鼎-桃園,2023-08-07,9189
1609,大亞,28,10,18,群益金鼎-桃園,2023-08-07,9189
00900,富邦特選高股息30,27,10,17,群益金鼎-桃園,2023-08-07,9189
00720B,元大投資級公司債,17,1,16,群益金鼎-桃園,2023-08-07,9189
6703,軒郁,16,0,16,群益金鼎-桃園,2023-08-07,9189
2455,全新,16,0,16,群益金鼎-桃園,2023-08-07,9189
6015,宏遠證,15,0,15,群益金鼎-桃園,2023-08-07,9189
00637L,元大滬深300正2,15,0,15,群益金鼎-桃園,2023-08-07,9189
1616,億泰,15,0,15,群益金鼎-桃園,2023-08-07,9189
2891,中信金,15,1,14,群益金鼎-桃園,2023-08-07,9189
2329,華泰,26,12,14,群益金鼎-桃園,2023-08-07,9189
6125,廣運,31,18,13,群益金鼎-桃園,2023-08-07,9189
1701,中化,13,0,13,群益金鼎-桃園,2023-08-07,9189
2610,華航,32,19,13,群益金鼎-桃園,2023-08-07,9189
1513,中興電,11,0,11,群益金鼎-桃園,2023-08-07,9189
3706,神達,32,21,11,群益金鼎-桃園,2023-08-07,9189
1905,華紙,98,87,11,群益金鼎-桃園,2023-08-07,9189
2409,友達,114,103,11,群益金鼎-桃園,2023-08-07,9189
00795B,中信美國公債20年,10,0,10,群益金鼎-桃園,2023-08-07,9189
4207,環泰,10,0,10,群益金鼎-桃園,2023-08-07,9189
2402,毅嘉,53,43,10,群益金鼎-桃園,2023-08-07,9189
4953,緯軟,11,1,10,群益金鼎-桃園,2023-08-07,9189
1314,中石化,15,5,10,群益金鼎-桃園,2023-08-07,9189
2363,矽統,10,0,10,群益金鼎-桃園,2023-08-07,9189
3669,圓展,10,0,10,群益金鼎-桃園,2023-08-07,9189
3032,偉訓,36,26,10,群益金鼎-桃園,2023-08-07,9189
00927,群益半導體收益,10,0,10,群益金鼎-桃園,2023-08-07,9189
6128,上福,10,0,10,群益金鼎-桃園,2023-08-07,9189
6188,廣明,31,21,10,群益金鼎-桃園,2023-08-07,9189
00751B,元大AAA至A公司債,9,0,9,群益金鼎-桃園,2023-08-07,9189
1533,車王電,10,1,9,群益金鼎-桃園,2023-08-07,9189
00673R,期元大S＆P原油反1,243,0,243,群益金鼎-桃園,2023-08-08,9189
2303,聯電,198,11,187,群益金鼎-桃園,2023-08-08,9189
00706L,期元大S＆P日圓正2,125,0,125,群益金鼎-桃園,2023-08-08,9189
2356,英業達,150,60,90,群益金鼎-桃園,2023-08-08,9189
00931B,統一美債20年,47,0,47,群益金鼎-桃園,2023-08-08,9189
00929,復華台灣科技優息,39,0,39,群益金鼎-桃園,2023-08-08,9189
00900,富邦特選高股息30,39,4,35,群益金鼎-桃園,2023-08-08,9189
00680L,元大美債20正2,32,0,32,群益金鼎-桃園,2023-08-08,9189
2206,三陽工業,52,20,32,群益金鼎-桃園,2023-08-08,9189
2883,凱基金,30,0,30,群益金鼎-桃園,2023-08-08,9189
5452,佶優,42,14,28,群益金鼎-桃園,2023-08-08,9189
5009,榮剛,23,0,23,群益金鼎-桃園,2023-08-08,9189
1217,愛之味,26,3,23,群益金鼎-桃園,2023-08-08,9189
00927,群益半導體收益,22,0,22,群益金鼎-桃園,2023-08-08,9189
6278,台表科,22,0,22,群益金鼎-桃園,2023-08-08,9189
0056,元大高股息,27,5,22,群益金鼎-桃園,2023-08-08,9189
6147,頎邦,21,0,21,群益金鼎-桃園,2023-08-08,9189
6112,邁達特,25,4,21,群益金鼎-桃園,2023-08-08,9189
00772B,中信高評級公司債,20,0,20,群益金鼎-桃園,2023-08-08,9189
6191,精成科,22,2,20,群益金鼎-桃園,2023-08-08,9189
2438,翔耀,20,0,20,群益金鼎-桃園,2023-08-08,9189
8433,弘帆,35,16,19,群益金鼎-桃園,2023-08-08,9189
00923,群益台ESG低碳50,21,2,19,群益金鼎-桃園,2023-08-08,9189
2634,漢翔,30,11,19,群益金鼎-桃園,2023-08-08,9189
00753L,中信中國50正2,28,10,18,群益金鼎-桃園,2023-08-08,9189
3207,耀勝,18,0,18,群益金鼎-桃園,2023-08-08,9189
6279,胡連,21,3,18,群益金鼎-桃園,2023-08-08,9189
6116,彩晶,18,1,17,群益金鼎-桃園,2023-08-08,9189
3706,神達,25,8,17,群益金鼎-桃園,2023-08-08,9189
2388,威盛,22,6,16,群益金鼎-桃園,2023-08-08,9189
5864,致和證,17,1,16,群益金鼎-桃園,2023-08-08,9189
1609,大亞,19,4,15,群益金鼎-桃園,2023-08-08,9189
1529,樂事綠能,17,2,15,群益金鼎-桃園,2023-08-08,9189
5483,中美晶,16,1,15,群益金鼎-桃園,2023-08-08,9189
2371,大同,39,26,13,群益金鼎-桃園,2023-08-08,9189
8234,新漢,13,0,13,群益金鼎-桃園,2023-08-08,9189
1504,東元,14,1,13,群益金鼎-桃園,2023-08-08,9189
2352,佳世達,18,6,12,群益金鼎-桃園,2023-08-08,9189
00892,富邦台灣半導體,12,0,12,群益金鼎-桃園,2023-08-08,9189
3027,盛達,12,0,12,群益金鼎-桃園,2023-08-08,9189
4768,晶呈科技,12,0,12,群益金鼎-桃園,2023-08-08,9189
6806,森崴能源,14,3,11,群益金鼎-桃園,2023-08-08,9189
4915,致伸,11,0,11,群益金鼎-桃園,2023-08-08,9189
2743,山富,16,5,11,群益金鼎-桃園,2023-08-08,9189
2886,兆豐金,11,0,11,群益金鼎-桃園,2023-08-08,9189
2462,良得電,21,10,11,群益金鼎-桃園,2023-08-08,9189
00895,富邦未來車,10,0,10,群益金鼎-桃園,2023-08-08,9189
2329,華泰,45,35,10,群益金鼎-桃園,2023-08-08,9189
2801,彰銀,10,0,10,群益金鼎-桃園,2023-08-08,9189
2377,微星,14,4,10,群益金鼎-桃園,2023-08-08,9189
00680L,元大美債20正2,60,5,55,群益金鼎-桃園,2023-08-09,9189
00900,富邦特選高股息30,54,0,54,群益金鼎-桃園,2023-08-09,9189
2888,新光金,42,0,42,群益金鼎-桃園,2023-08-09,9189
3163,波若威,42,8,34,群益金鼎-桃園,2023-08-09,9189
00929,復華台灣科技優息,30,0,30,群益金鼎-桃園,2023-08-09,9189
5880,合庫金,29,6,23,群益金鼎-桃園,2023-08-09,9189
1210,大成,25,3,22,群益金鼎-桃園,2023-08-09,9189
00671R,富邦NASDAQ反1,21,0,21,群益金鼎-桃園,2023-08-09,9189
8433,弘帆,21,0,21,群益金鼎-桃園,2023-08-09,9189
2464,盟立,21,0,21,群益金鼎-桃園,2023-08-09,9189
1605,華新,20,1,19,群益金鼎-桃園,2023-08-09,9189
00673R,期元大S＆P原油反1,16,0,16,群益金鼎-桃園,2023-08-09,9189
3209,全科,16,1,15,群益金鼎-桃園,2023-08-09,9189
2890,永豐金,17,3,14,群益金鼎-桃園,2023-08-09,9189
6274,台燿,21,7,14,群益金鼎-桃園,2023-08-09,9189
6605,帝寶,17,3,14,群益金鼎-桃園,2023-08-09,9189
00893,國泰智能電動車,22,9,13,群益金鼎-桃園,2023-08-09,9189
6147,頎邦,14,1,13,群益金鼎-桃園,2023-08-09,9189
00722B,群益投資級電信債,13,0,13,群益金鼎-桃園,2023-08-09,9189
6412,群電,12,0,12,群益金鼎-桃園,2023-08-09,9189
3038,全台,12,0,12,群益金鼎-桃園,2023-08-09,9189
1609,大亞,16,5,11,群益金鼎-桃園,2023-08-09,9189
1595,川寶,11,0,11,群益金鼎-桃園,2023-08-09,9189
4768,晶呈科技,10,0,10,群益金鼎-桃園,2023-08-09,9189
2365,昆盈,10,0,10,群益金鼎-桃園,2023-08-09,9189
2438,翔耀,10,0,10,群益金鼎-桃園,2023-08-09,9189
2323,中環,10,0,10,群益金鼎-桃園,2023-08-09,9189
3630,新鉅科,10,0,10,群益金鼎-桃園,2023-08-09,9189
00923,群益台ESG低碳50,10,0,10,群益金鼎-桃園,2023-08-09,9189
1905,華紙,14,4,10,群益金鼎-桃園,2023-08-09,9189
4906,正文,16,6,10,群益金鼎-桃園,2023-08-09,9189
3346,麗清,9,0,9,群益金鼎-桃園,2023-08-09,9189
3055,蔚華科,9,0,9,群益金鼎-桃園,2023-08-09,9189
1314,中石化,9,0,9,群益金鼎-桃園,2023-08-09,9189
1615,大山,9,0,9,群益金鼎-桃園,2023-08-09,9189
6279,胡連,9,0,9,群益金鼎-桃園,2023-08-09,9189
3014,聯陽,10,1,9,群益金鼎-桃園,2023-08-09,9189
6282,康舒,12,4,8,群益金鼎-桃園,2023-08-09,9189
2303,聯電,13,5,8,群益金鼎-桃園,2023-08-09,9189
9943,好樂迪,11,3,8,群益金鼎-桃園,2023-08-09,9189
3338,泰碩,10,3,7,群益金鼎-桃園,2023-08-09,9189
3011,今皓,7,0,7,群益金鼎-桃園,2023-08-09,9189
00753L,中信中國50正2,27,20,7,群益金鼎-桃園,2023-08-09,9189
1514,亞力,7,0,7,群益金鼎-桃園,2023-08-09,9189
2834,臺企銀,10,3,7,群益金鼎-桃園,2023-08-09,9189
00927,群益半導體收益,6,0,6,群益金鼎-桃園,2023-08-09,9189
2637,慧洋-KY,7,1,6,群益金鼎-桃園,2023-08-09,9189
2027,大成鋼,6,0,6,群益金鼎-桃園,2023-08-09,9189
3419,譁裕,6,0,6,群益金鼎-桃園,2023-08-09,9189
2462,良得電,6,0,6,群益金鼎-桃園,2023-08-09,9189
00878,國泰永續高股息,313,32,281,群益金鼎-桃園,2023-08-10,9189
2812,台中銀,150,0,150,群益金鼎-桃園,2023-08-10,9189
2883,凱基金,147,3,144,群益金鼎-桃園,2023-08-10,9189
2610,華航,147,28,119,群益金鼎-桃園,2023-08-10,9189
00900,富邦特選高股息30,136,30,106,群益金鼎-桃園,2023-08-10,9189
00929,復華台灣科技優息,80,0,80,群益金鼎-桃園,2023-08-10,9189
2382,廣達,85,26,59,群益金鼎-桃園,2023-08-10,9189
5880,合庫金,64,12,52,群益金鼎-桃園,2023-08-10,9189
6605,帝寶,57,9,48,群益金鼎-桃園,2023-08-10,9189
0056,元大高股息,249,204,45,群益金鼎-桃園,2023-08-10,9189
00671R,富邦NASDAQ反1,41,0,41,群益金鼎-桃園,2023-08-10,9189
00772B,中信高評級公司債,35,0,35,群益金鼎-桃園,2023-08-10,9189
2408,南亞科,35,0,35,群益金鼎-桃園,2023-08-10,9189
5907,大洋-KY,33,0,33,群益金鼎-桃園,2023-08-10,9189
00923,群益台ESG低碳50,32,2,30,群益金鼎-桃園,2023-08-10,9189
2609,陽明,28,1,27,群益金鼎-桃園,2023-08-10,9189
9945,潤泰新,26,0,26,群益金鼎-桃園,2023-08-10,9189
3231,緯創,309,284,25,群益金鼎-桃園,2023-08-10,9189
2014,中鴻,35,10,25,群益金鼎-桃園,2023-08-10,9189
2376,技嘉,32,8,24,群益金鼎-桃園,2023-08-10,9189
00706L,期元大S＆P日圓正2,23,0,23,群益金鼎-桃園,2023-08-10,9189
3032,偉訓,24,3,21,群益金鼎-桃園,2023-08-10,9189
3014,聯陽,25,4,21,群益金鼎-桃園,2023-08-10,9189
2515,中工,21,0,21,群益金鼎-桃園,2023-08-10,9189
4938,和碩,20,0,20,群益金鼎-桃園,2023-08-10,9189
00927,群益半導體收益,20,0,20,群益金鼎-桃園,2023-08-10,9189
3583,辛耘,27,7,20,群益金鼎-桃園,2023-08-10,9189
6015,宏遠證,20,0,20,群益金鼎-桃園,2023-08-10,9189
1815,富喬,20,1,19,群益金鼎-桃園,2023-08-10,9189
2328,廣宇,19,0,19,群益金鼎-桃園,2023-08-10,9189
2886,兆豐金,18,0,18,群益金鼎-桃園,2023-08-10,9189
00919,群益台灣精選高息,17,0,17,群益金鼎-桃園,2023-08-10,9189
5340,建榮,16,1,15,群益金鼎-桃園,2023-08-10,9189
2367,燿華,15,1,14,群益金鼎-桃園,2023-08-10,9189
3013,晟銘電,21,7,14,群益金鼎-桃園,2023-08-10,9189
00673R,期元大S＆P原油反1,34,20,14,群益金鼎-桃園,2023-08-10,9189
6282,康舒,63,50,13,群益金鼎-桃園,2023-08-10,9189
3037,欣興,26,13,13,群益金鼎-桃園,2023-08-10,9189
2313,華通,12,0,12,群益金鼎-桃園,2023-08-10,9189
2027,大成鋼,12,0,12,群益金鼎-桃園,2023-08-10,9189
1314,中石化,11,0,11,群益金鼎-桃園,2023-08-10,9189
6116,彩晶,11,0,11,群益金鼎-桃園,2023-08-10,9189
1504,東元,11,0,11,群益金鼎-桃園,2023-08-10,9189
2377,微星,11,0,11,群益金鼎-桃園,2023-08-10,9189
6140,訊達,11,0,11,群益金鼎-桃園,2023-08-10,9189
2892,第一金,12,1,11,群益金鼎-桃園,2023-08-10,9189
00895,富邦未來車,11,1,10,群益金鼎-桃園,2023-08-10,9189
3057,喬鼎,10,0,10,群益金鼎-桃園,2023-08-10,9189
2324,仁寶,20,10,10,群益金鼎-桃園,2023-08-10,9189
2855,統一證,10,0,10,群益金鼎-桃園,2023-08-10,9189
00665L,富邦�琤肭磪囓�2,340,0,340,群益金鼎-桃園,2023-08-11,9189
00929,復華台灣科技優息,83,4,79,群益金鼎-桃園,2023-08-11,9189
00632R,元大台灣50反1,111,35,76,群益金鼎-桃園,2023-08-11,9189
00706L,期元大S＆P日圓正2,65,0,65,群益金鼎-桃園,2023-08-11,9189
4173,久裕,62,0,62,群益金鼎-桃園,2023-08-11,9189
2883,凱基金,70,10,60,群益金鼎-桃園,2023-08-11,9189
00900,富邦特選高股息30,56,0,56,群益金鼎-桃園,2023-08-11,9189
00753L,中信中國50正2,71,20,51,群益金鼎-桃園,2023-08-11,9189
00673R,期元大S＆P原油反1,50,3,47,群益金鼎-桃園,2023-08-11,9189
00931B,統一美債20年,44,0,44,群益金鼎-桃園,2023-08-11,9189
00923,群益台ESG低碳50,40,0,40,群益金鼎-桃園,2023-08-11,9189
1734,杏輝,33,1,32,群益金鼎-桃園,2023-08-11,9189
00927,群益半導體收益,31,0,31,群益金鼎-桃園,2023-08-11,9189
3231,緯創,389,358,31,群益金鼎-桃園,2023-08-11,9189
2356,英業達,45,15,30,群益金鼎-桃園,2023-08-11,9189
2888,新光金,32,3,29,群益金鼎-桃園,2023-08-11,9189
2886,兆豐金,27,0,27,群益金鼎-桃園,2023-08-11,9189
6605,帝寶,35,9,26,群益金鼎-桃園,2023-08-11,9189
6125,廣運,38,13,25,群益金鼎-桃園,2023-08-11,9189
5880,合庫金,25,0,25,群益金鼎-桃園,2023-08-11,9189
6015,宏遠證,25,0,25,群益金鼎-桃園,2023-08-11,9189
6116,彩晶,24,0,24,群益金鼎-桃園,2023-08-11,9189
00882,中信中國高股息,25,3,22,群益金鼎-桃園,2023-08-11,9189
2543,皇昌,22,0,22,群益金鼎-桃園,2023-08-11,9189
00885,富邦越南,22,0,22,群益金鼎-桃園,2023-08-11,9189
2312,金寶,42,21,21,群益金鼎-桃園,2023-08-11,9189
2317,鴻海,23,2,21,群益金鼎-桃園,2023-08-11,9189
1310,台苯,20,0,20,群益金鼎-桃園,2023-08-11,9189
1524,耿鼎,16,0,16,群益金鼎-桃園,2023-08-11,9189
1504,東元,25,9,16,群益金鼎-桃園,2023-08-11,9189
2014,中鴻,32,17,15,群益金鼎-桃園,2023-08-11,9189
4958,臻鼎-KY,14,0,14,群益金鼎-桃園,2023-08-11,9189
2344,華邦電,15,2,13,群益金鼎-桃園,2023-08-11,9189
2002,中鋼,14,1,13,群益金鼎-桃園,2023-08-11,9189
3694,海華,12,0,12,群益金鼎-桃園,2023-08-11,9189
3264,欣銓,12,0,12,群益金鼎-桃園,2023-08-11,9189
3011,今皓,12,0,12,群益金鼎-桃園,2023-08-11,9189
3715,定穎投控,15,3,12,群益金鼎-桃園,2023-08-11,9189
1802,台玻,13,2,11,群益金鼎-桃園,2023-08-11,9189
0050,元大台灣50,17,6,11,群益金鼎-桃園,2023-08-11,9189
2881,富邦金,11,1,10,群益金鼎-桃園,2023-08-11,9189
00772B,中信高評級公司債,10,0,10,群益金鼎-桃園,2023-08-11,9189
3024,憶聲,21,11,10,群益金鼎-桃園,2023-08-11,9189
0056,元大高股息,19,9,10,群益金鼎-桃園,2023-08-11,9189
2357,華碩,10,0,10,群益金鼎-桃園,2023-08-11,9189
5351,鈺創,10,0,10,群益金鼎-桃園,2023-08-11,9189
3163,波若威,15,5,10,群益金鼎-桃園,2023-08-11,9189
2459,敦吉,10,0,10,群益金鼎-桃園,2023-08-11,9189
2731,雄獅,10,0,10,群益金鼎-桃園,2023-08-11,9189
5353,台林,10,0,10,群益金鼎-桃園,2023-08-11,9189
2324,仁寶,405,210,195,群益金鼎-桃園,2023-08-14,9189
00878,國泰永續高股息,185,34,151,群益金鼎-桃園,2023-08-14,9189
2610,華航,137,7,130,群益金鼎-桃園,2023-08-14,9189
00900,富邦特選高股息30,125,5,120,群益金鼎-桃園,2023-08-14,9189
00929,復華台灣科技優息,115,1,114,群益金鼎-桃園,2023-08-14,9189
00692,富邦公司治理,105,0,105,群益金鼎-桃園,2023-08-14,9189
00923,群益台ESG低碳50,75,2,73,群益金鼎-桃園,2023-08-14,9189
2609,陽明,72,10,62,群益金鼎-桃園,2023-08-14,9189
00673R,期元大S＆P原油反1,46,0,46,群益金鼎-桃園,2023-08-14,9189
2888,新光金,44,1,43,群益金鼎-桃園,2023-08-14,9189
1513,中興電,48,8,40,群益金鼎-桃園,2023-08-14,9189
2618,長榮航,51,14,37,群益金鼎-桃園,2023-08-14,9189
1721,三晃,36,0,36,群益金鼎-桃園,2023-08-14,9189
2883,凱基金,35,2,33,群益金鼎-桃園,2023-08-14,9189
3231,緯創,379,346,33,群益金鼎-桃園,2023-08-14,9189
2323,中環,37,5,32,群益金鼎-桃園,2023-08-14,9189
2014,中鴻,32,4,28,群益金鼎-桃園,2023-08-14,9189
2313,華通,28,1,27,群益金鼎-桃園,2023-08-14,9189
2801,彰銀,26,0,26,群益金鼎-桃園,2023-08-14,9189
00894,中信小資高價30,25,0,25,群益金鼎-桃園,2023-08-14,9189
00637L,元大滬深300正2,24,1,23,群益金鼎-桃園,2023-08-14,9189
2002,中鋼,22,0,22,群益金鼎-桃園,2023-08-14,9189
2409,友達,20,0,20,群益金鼎-桃園,2023-08-14,9189
8936,國統,20,0,20,群益金鼎-桃園,2023-08-14,9189
2329,華泰,26,7,19,群益金鼎-桃園,2023-08-14,9189
1210,大成,21,2,19,群益金鼎-桃園,2023-08-14,9189
00665L,富邦�琤肭磪囓�2,28,10,18,群益金鼎-桃園,2023-08-14,9189
2423,固緯,171,153,18,群益金鼎-桃園,2023-08-14,9189
0050,元大台灣50,17,0,17,群益金鼎-桃園,2023-08-14,9189
2344,華邦電,16,0,16,群益金鼎-桃園,2023-08-14,9189
2330,台積電,19,3,16,群益金鼎-桃園,2023-08-14,9189
00881,國泰台灣5G+,16,1,15,群益金鼎-桃園,2023-08-14,9189
2201,裕隆,15,0,15,群益金鼎-桃園,2023-08-14,9189
2834,臺企銀,15,0,15,群益金鼎-桃園,2023-08-14,9189
1605,華新,23,8,15,群益金鼎-桃園,2023-08-14,9189
8011,台通,15,0,15,群益金鼎-桃園,2023-08-14,9189
2515,中工,17,2,15,群益金鼎-桃園,2023-08-14,9189
3047,訊舟,20,5,15,群益金鼎-桃園,2023-08-14,9189
2303,聯電,18,4,14,群益金鼎-桃園,2023-08-14,9189
6140,訊達,14,0,14,群益金鼎-桃園,2023-08-14,9189
5328,華容,14,0,14,群益金鼎-桃園,2023-08-14,9189
00882,中信中國高股息,25,12,13,群益金鼎-桃園,2023-08-14,9189
9945,潤泰新,48,35,13,群益金鼎-桃園,2023-08-14,9189
3078,僑威,54,41,13,群益金鼎-桃園,2023-08-14,9189
3576,聯合再生,20,8,12,群益金鼎-桃園,2023-08-14,9189
2897,王道銀行,12,0,12,群益金鼎-桃園,2023-08-14,9189
2208,台船,12,0,12,群益金鼎-桃園,2023-08-14,9189
00915,凱基優選高股息30,12,0,12,群益金鼎-桃園,2023-08-14,9189
00919,群益台灣精選高息,14,2,12,群益金鼎-桃園,2023-08-14,9189
2421,建準,15,3,12,群益金鼎-桃園,2023-08-14,9189
2891,中信金,317,0,317,群益金鼎-桃園,2023-08-15,9189
3231,緯創,482,349,133,群益金鼎-桃園,2023-08-15,9189
00929,復華台灣科技優息,127,10,117,群益金鼎-桃園,2023-08-15,9189
00923,群益台ESG低碳50,102,0,102,群益金鼎-桃園,2023-08-15,9189
2104,國際中橡,95,0,95,群益金鼎-桃園,2023-08-15,9189
2883,凱基金,64,2,62,群益金鼎-桃園,2023-08-15,9189
2324,仁寶,232,171,61,群益金鼎-桃園,2023-08-15,9189
2317,鴻海,56,10,46,群益金鼎-桃園,2023-08-15,9189
2363,矽統,79,45,34,群益金鼎-桃園,2023-08-15,9189
00900,富邦特選高股息30,37,4,33,群益金鼎-桃園,2023-08-15,9189
2886,兆豐金,27,1,26,群益金鼎-桃園,2023-08-15,9189
2002,中鋼,25,1,24,群益金鼎-桃園,2023-08-15,9189
2014,中鴻,23,0,23,群益金鼎-桃園,2023-08-15,9189
2409,友達,25,2,23,群益金鼎-桃園,2023-08-15,9189
2609,陽明,24,2,22,群益金鼎-桃園,2023-08-15,9189
2329,華泰,24,3,21,群益金鼎-桃園,2023-08-15,9189
2801,彰銀,21,0,21,群益金鼎-桃園,2023-08-15,9189
2458,義隆,20,0,20,群益金鼎-桃園,2023-08-15,9189
4967,十銓,17,1,16,群益金鼎-桃園,2023-08-15,9189
00671R,富邦NASDAQ反1,14,0,14,群益金鼎-桃園,2023-08-15,9189
2834,臺企銀,19,5,14,群益金鼎-桃園,2023-08-15,9189
6770,力積電,13,1,12,群益金鼎-桃園,2023-08-15,9189
2303,聯電,20,9,11,群益金鼎-桃園,2023-08-15,9189
6129,普誠,11,0,11,群益金鼎-桃園,2023-08-15,9189
1905,華紙,22,11,11,群益金鼎-桃園,2023-08-15,9189
8069,元太,10,0,10,群益金鼎-桃園,2023-08-15,9189
2313,華通,10,0,10,群益金鼎-桃園,2023-08-15,9189
9105,泰金寶-DR,10,0,10,群益金鼎-桃園,2023-08-15,9189
00927,群益半導體收益,10,0,10,群益金鼎-桃園,2023-08-15,9189
8121,越峰,10,0,10,群益金鼎-桃園,2023-08-15,9189
2883B,凱基金乙特,10,0,10,群益金鼎-桃園,2023-08-15,9189
6116,彩晶,10,0,10,群益金鼎-桃園,2023-08-15,9189
2402,毅嘉,20,10,10,群益金鼎-桃園,2023-08-15,9189
3306,鼎天,10,1,9,群益金鼎-桃園,2023-08-15,9189
00907,永豐優息存股,9,0,9,群益金鼎-桃園,2023-08-15,9189
00679B,元大美債20年,9,0,9,群益金鼎-桃園,2023-08-15,9189
3481,群創,45,37,8,群益金鼎-桃園,2023-08-15,9189
2913,農林,10,2,8,群益金鼎-桃園,2023-08-15,9189
5880,合庫金,7,0,7,群益金鼎-桃園,2023-08-15,9189
00713,元大台灣高息低波,8,1,7,群益金鼎-桃園,2023-08-15,9189
1312,國喬,7,0,7,群益金鼎-桃園,2023-08-15,9189
00931B,統一美債20年,7,0,7,群益金鼎-桃園,2023-08-15,9189
5907,大洋-KY,7,0,7,群益金鼎-桃園,2023-08-15,9189
2421,建準,10,3,7,群益金鼎-桃園,2023-08-15,9189
1504,東元,7,0,7,群益金鼎-桃園,2023-08-15,9189
6188,廣明,14,7,7,群益金鼎-桃園,2023-08-15,9189
3689,湧德,9,2,7,群益金鼎-桃園,2023-08-15,9189
6204,艾華,7,0,7,群益金鼎-桃園,2023-08-15,9189
00772B,中信高評級公司債,6,0,6,群益金鼎-桃園,2023-08-15,9189
2208,台船,6,0,6,群益金鼎-桃園,2023-08-15,9189
2303,聯電,135,2,133,群益金鼎-桃園,2023-08-16,9189
00632R,元大台灣50反1,131,10,121,群益金鼎-桃園,2023-08-16,9189
2610,華航,132,30,102,群益金鼎-桃園,2023-08-16,9189
00878,國泰永續高股息,147,54,93,群益金鼎-桃園,2023-08-16,9189
2891,中信金,72,21,51,群益金鼎-桃園,2023-08-16,9189
2010,春源,50,0,50,群益金鼎-桃園,2023-08-16,9189
00900,富邦特選高股息30,62,16,46,群益金鼎-桃園,2023-08-16,9189
00929,復華台灣科技優息,40,0,40,群益金鼎-桃園,2023-08-16,9189
2801,彰銀,37,0,37,群益金鼎-桃園,2023-08-16,9189
2883,凱基金,36,0,36,群益金鼎-桃園,2023-08-16,9189
4909,新復興,37,1,36,群益金鼎-桃園,2023-08-16,9189
2834,臺企銀,33,0,33,群益金鼎-桃園,2023-08-16,9189
2609,陽明,43,11,32,群益金鼎-桃園,2023-08-16,9189
2618,長榮航,39,7,32,群益金鼎-桃園,2023-08-16,9189
1802,台玻,29,1,28,群益金鼎-桃園,2023-08-16,9189
00923,群益台ESG低碳50,40,15,25,群益金鼎-桃園,2023-08-16,9189
6153,嘉聯益,25,0,25,群益金鼎-桃園,2023-08-16,9189
00931B,統一美債20年,22,0,22,群益金鼎-桃園,2023-08-16,9189
00882,中信中國高股息,19,0,19,群益金鼎-桃園,2023-08-16,9189
2324,仁寶,57,38,19,群益金鼎-桃園,2023-08-16,9189
3706,神達,19,1,18,群益金鼎-桃園,2023-08-16,9189
2002,中鋼,17,0,17,群益金鼎-桃園,2023-08-16,9189
9919,康那香,27,10,17,群益金鼎-桃園,2023-08-16,9189
2892,第一金,14,0,14,群益金鼎-桃園,2023-08-16,9189
2027,大成鋼,24,10,14,群益金鼎-桃園,2023-08-16,9189
00712,復華富時不動產,14,0,14,群益金鼎-桃園,2023-08-16,9189
00713,元大台灣高息低波,12,0,12,群益金鼎-桃園,2023-08-16,9189
1326,台化,12,0,12,群益金鼎-桃園,2023-08-16,9189
00893,國泰智能電動車,11,0,11,群益金鼎-桃園,2023-08-16,9189
3306,鼎天,15,4,11,群益金鼎-桃園,2023-08-16,9189
3037,欣興,53,43,10,群益金鼎-桃園,2023-08-16,9189
00927,群益半導體收益,10,0,10,群益金鼎-桃園,2023-08-16,9189
00690,兆豐藍籌30,10,0,10,群益金鼎-桃園,2023-08-16,9189
4414,如興,10,0,10,群益金鼎-桃園,2023-08-16,9189
2884,玉山金,10,0,10,群益金鼎-桃園,2023-08-16,9189
2887,台新金,11,1,10,群益金鼎-桃園,2023-08-16,9189
2890,永豐金,19,10,9,群益金鼎-桃園,2023-08-16,9189
00795B,中信美國公債20年,10,1,9,群益金鼎-桃園,2023-08-16,9189
2880,華南金,9,0,9,群益金鼎-桃園,2023-08-16,9189
1529,樂事綠能,10,1,9,群益金鼎-桃園,2023-08-16,9189
6757,台灣虎航,9,0,9,群益金鼎-桃園,2023-08-16,9189
6806,森崴能源,9,1,8,群益金鼎-桃園,2023-08-16,9189
2323,中環,28,20,8,群益金鼎-桃園,2023-08-16,9189
5876,上海商銀,8,0,8,群益金鼎-桃園,2023-08-16,9189
8358,金居,43,35,8,群益金鼎-桃園,2023-08-16,9189
2332,友訊,18,11,7,群益金鼎-桃園,2023-08-16,9189
1471,首利,7,0,7,群益金鼎-桃園,2023-08-16,9189
6279,胡連,6,0,6,群益金鼎-桃園,2023-08-16,9189
00772B,中信高評級公司債,6,0,6,群益金鼎-桃園,2023-08-16,9189
2330,台積電,6,0,6,群益金鼎-桃園,2023-08-16,9189
3231,緯創,699,208,491,群益金鼎-桃園,2023-08-17,9189
2888,新光金,84,25,59,群益金鼎-桃園,2023-08-17,9189
00929,復華台灣科技優息,56,0,56,群益金鼎-桃園,2023-08-17,9189
2891,中信金,55,1,54,群益金鼎-桃園,2023-08-17,9189
2883,凱基金,55,1,54,群益金鼎-桃園,2023-08-17,9189
2303,聯電,57,7,50,群益金鼎-桃園,2023-08-17,9189
2010,春源,48,0,48,群益金鼎-桃園,2023-08-17,9189
00671R,富邦NASDAQ反1,42,0,42,群益金鼎-桃園,2023-08-17,9189
00692,富邦公司治理,35,0,35,群益金鼎-桃園,2023-08-17,9189
00795B,中信美國公債20年,30,0,30,群益金鼎-桃園,2023-08-17,9189
2323,中環,57,30,27,群益金鼎-桃園,2023-08-17,9189
3548,兆利,33,7,26,群益金鼎-桃園,2023-08-17,9189
2393,億光,25,0,25,群益金鼎-桃園,2023-08-17,9189
00881,國泰台灣5G+,25,0,25,群益金鼎-桃園,2023-08-17,9189
1609,大亞,26,2,24,群益金鼎-桃園,2023-08-17,9189
2886,兆豐金,24,0,24,群益金鼎-桃園,2023-08-17,9189
2324,仁寶,190,168,22,群益金鼎-桃園,2023-08-17,9189
00893,國泰智能電動車,22,1,21,群益金鼎-桃園,2023-08-17,9189
2382,廣達,62,41,21,群益金鼎-桃園,2023-08-17,9189
2002,中鋼,20,0,20,群益金鼎-桃園,2023-08-17,9189
8034,榮群,20,0,20,群益金鼎-桃園,2023-08-17,9189
2845,遠東銀,20,0,20,群益金鼎-桃園,2023-08-17,9189
4744,皇將,20,0,20,群益金鼎-桃園,2023-08-17,9189
1301,台塑,18,0,18,群益金鼎-桃園,2023-08-17,9189
00913,兆豐台灣晶圓製造,16,0,16,群益金鼎-桃園,2023-08-17,9189
2363,矽統,62,47,15,群益金鼎-桃園,2023-08-17,9189
6188,廣明,17,3,14,群益金鼎-桃園,2023-08-17,9189
4958,臻鼎-KY,14,0,14,群益金鼎-桃園,2023-08-17,9189
9945,潤泰新,28,15,13,群益金鼎-桃園,2023-08-17,9189
1605,華新,16,4,12,群益金鼎-桃園,2023-08-17,9189
00680L,元大美債20正2,12,1,11,群益金鼎-桃園,2023-08-17,9189
4999,鑫禾,10,0,10,群益金鼎-桃園,2023-08-17,9189
2486,一詮,10,0,10,群益金鼎-桃園,2023-08-17,9189
2812,台中銀,10,0,10,群益金鼎-桃園,2023-08-17,9189
8048,德勝,10,0,10,群益金鼎-桃園,2023-08-17,9189
00907,永豐優息存股,10,0,10,群益金鼎-桃園,2023-08-17,9189
00687B,國泰20年美債,10,0,10,群益金鼎-桃園,2023-08-17,9189
2547,日勝生,10,0,10,群益金鼎-桃園,2023-08-17,9189
1608,華榮,10,0,10,群益金鼎-桃園,2023-08-17,9189
5608,四維航,10,0,10,群益金鼎-桃園,2023-08-17,9189
2801,彰銀,10,0,10,群益金鼎-桃園,2023-08-17,9189
3005,神基,11,1,10,群益金鼎-桃園,2023-08-17,9189
6275,元山,11,1,10,群益金鼎-桃園,2023-08-17,9189
2032,新鋼,10,0,10,群益金鼎-桃園,2023-08-17,9189
5353,台林,10,0,10,群益金鼎-桃園,2023-08-17,9189
2489,瑞軒,10,0,10,群益金鼎-桃園,2023-08-17,9189
00878,國泰永續高股息,162,153,9,群益金鼎-桃園,2023-08-17,9189
6187,萬潤,13,4,9,群益金鼎-桃園,2023-08-17,9189
1314,中石化,13,4,9,群益金鼎-桃園,2023-08-17,9189
00696B,富邦美債20年,9,0,9,群益金鼎-桃園,2023-08-17,9189
2888,新光金,221,9,212,群益金鼎-桃園,2023-08-18,9189
00878,國泰永續高股息,213,17,196,群益金鼎-桃園,2023-08-18,9189
00665L,富邦�琤肭磪囓�2,122,0,122,群益金鼎-桃園,2023-08-18,9189
2323,中環,119,10,109,群益金鼎-桃園,2023-08-18,9189
00929,復華台灣科技優息,206,112,94,群益金鼎-桃園,2023-08-18,9189
2010,春源,60,0,60,群益金鼎-桃園,2023-08-18,9189
2332,友訊,65,8,57,群益金鼎-桃園,2023-08-18,9189
2363,矽統,184,131,53,群益金鼎-桃園,2023-08-18,9189
4402,郡都開發,50,0,50,群益金鼎-桃園,2023-08-18,9189
2610,華航,52,2,50,群益金鼎-桃園,2023-08-18,9189
5880,合庫金,33,0,33,群益金鼎-桃園,2023-08-18,9189
2382,廣達,84,51,33,群益金鼎-桃園,2023-08-18,9189
2356,英業達,56,26,30,群益金鼎-桃園,2023-08-18,9189
3163,波若威,107,78,29,群益金鼎-桃園,2023-08-18,9189
00712,復華富時不動產,31,3,28,群益金鼎-桃園,2023-08-18,9189
1760,寶齡富錦,27,0,27,群益金鼎-桃園,2023-08-18,9189
2601,益航,30,6,24,群益金鼎-桃園,2023-08-18,9189
00885,富邦越南,23,0,23,群益金鼎-桃園,2023-08-18,9189
1609,大亞,37,16,21,群益金鼎-桃園,2023-08-18,9189
4967,十銓,22,1,21,群益金鼎-桃園,2023-08-18,9189
2020,美亞,20,0,20,群益金鼎-桃園,2023-08-18,9189
01010T,京城樂富R1,20,0,20,群益金鼎-桃園,2023-08-18,9189
1524,耿鼎,20,0,20,群益金鼎-桃園,2023-08-18,9189
1101,台泥,21,2,19,群益金鼎-桃園,2023-08-18,9189
00713,元大台灣高息低波,19,0,19,群益金鼎-桃園,2023-08-18,9189
2338,光罩,18,0,18,群益金鼎-桃園,2023-08-18,9189
2891,中信金,19,1,18,群益金鼎-桃園,2023-08-18,9189
1471,首利,22,4,18,群益金鼎-桃園,2023-08-18,9189
2618,長榮航,28,12,16,群益金鼎-桃園,2023-08-18,9189
00900,富邦特選高股息30,16,0,16,群益金鼎-桃園,2023-08-18,9189
2388,威盛,33,17,16,群益金鼎-桃園,2023-08-18,9189
00913,兆豐台灣晶圓製造,16,0,16,群益金鼎-桃園,2023-08-18,9189
3013,晟銘電,22,6,16,群益金鼎-桃園,2023-08-18,9189
00720B,元大投資級公司債,15,0,15,群益金鼎-桃園,2023-08-18,9189
6116,彩晶,15,0,15,群益金鼎-桃園,2023-08-18,9189
1504,東元,45,31,14,群益金鼎-桃園,2023-08-18,9189
3035,智原,50,36,14,群益金鼎-桃園,2023-08-18,9189
00922,國泰台灣領袖50,13,0,13,群益金鼎-桃園,2023-08-18,9189
6282,康舒,17,5,12,群益金鼎-桃園,2023-08-18,9189
2421,建準,22,10,12,群益金鼎-桃園,2023-08-18,9189
2401,凌陽,17,5,12,群益金鼎-桃園,2023-08-18,9189
4746,台耀,14,2,12,群益金鼎-桃園,2023-08-18,9189
4768,晶呈科技,12,0,12,群益金鼎-桃園,2023-08-18,9189
6285,啟��,14,3,11,群益金鼎-桃園,2023-08-18,9189
2892,第一金,12,1,11,群益金鼎-桃園,2023-08-18,9189
3325,旭品,13,2,11,群益金鼎-桃園,2023-08-18,9189
00664R,國泰臺灣加權反1,10,0,10,群益金鼎-桃園,2023-08-18,9189
1103,嘉泥,10,0,10,群益金鼎-桃園,2023-08-18,9189
3037,欣興,11,1,10,群益金鼎-桃園,2023-08-18,9189
00877,復華中國5G,10,0,10,群益金鼎-桃園,2023-08-18,9189
3231,緯創,333,118,215,群益金鼎-桃園,2023-08-21,9189
00665L,富邦�琤肭磪囓�2,182,0,182,群益金鼎-桃園,2023-08-21,9189
2010,春源,50,0,50,群益金鼎-桃園,2023-08-21,9189
2301,光寶科,65,24,41,群益金鼎-桃園,2023-08-21,9189
00929,復華台灣科技優息,53,13,40,群益金鼎-桃園,2023-08-21,9189
1504,東元,55,17,38,群益金鼎-桃園,2023-08-21,9189
2332,友訊,42,7,35,群益金鼎-桃園,2023-08-21,9189
6125,廣運,43,12,31,群益金鼎-桃園,2023-08-21,9189
2014,中鴻,30,0,30,群益金鼎-桃園,2023-08-21,9189
2609,陽明,25,1,24,群益金鼎-桃園,2023-08-21,9189
8358,金居,32,11,21,群益金鼎-桃園,2023-08-21,9189
2317,鴻海,21,1,20,群益金鼎-桃園,2023-08-21,9189
2498,宏達電,20,0,20,群益金鼎-桃園,2023-08-21,9189
01009T,王道圓滿R1,20,0,20,群益金鼎-桃園,2023-08-21,9189
00712,復華富時不動產,19,0,19,群益金鼎-桃園,2023-08-21,9189
00882,中信中國高股息,18,0,18,群益金鼎-桃園,2023-08-21,9189
1210,大成,17,0,17,群益金鼎-桃園,2023-08-21,9189
2324,仁寶,24,8,16,群益金鼎-桃園,2023-08-21,9189
7402,邑錡,16,3,13,群益金鼎-桃園,2023-08-21,9189
1101,台泥,14,2,12,群益金鼎-桃園,2023-08-21,9189
2603,長榮,13,1,12,群益金鼎-桃園,2023-08-21,9189
00753L,中信中國50正2,12,0,12,群益金鼎-桃園,2023-08-21,9189
00919,群益台灣精選高息,12,0,12,群益金鼎-桃園,2023-08-21,9189
00650L,復華香港正2,12,0,12,群益金鼎-桃園,2023-08-21,9189
3044,健鼎,11,0,11,群益金鼎-桃園,2023-08-21,9189
00687B,國泰20年美債,11,0,11,群益金鼎-桃園,2023-08-21,9189
5608,四維航,12,1,11,群益金鼎-桃園,2023-08-21,9189
2344,華邦電,11,0,11,群益金鼎-桃園,2023-08-21,9189
00795B,中信美國公債20年,11,0,11,群益金鼎-桃園,2023-08-21,9189
00927,群益半導體收益,11,0,11,群益金鼎-桃園,2023-08-21,9189
00733,富邦臺灣中小,10,0,10,群益金鼎-桃園,2023-08-21,9189
6198,瑞築,10,0,10,群益金鼎-桃園,2023-08-21,9189
6005,群益證,10,0,10,群益金鼎-桃園,2023-08-21,9189
3005,神基,10,0,10,群益金鼎-桃園,2023-08-21,9189
00751B,元大AAA至A公司債,10,0,10,群益金鼎-桃園,2023-08-21,9189
1103,嘉泥,10,0,10,群益金鼎-桃園,2023-08-21,9189
00756B,群益投等新興公債,10,0,10,群益金鼎-桃園,2023-08-21,9189
1514,亞力,10,0,10,群益金鼎-桃園,2023-08-21,9189
2303,聯電,15,6,9,群益金鼎-桃園,2023-08-21,9189
2329,華泰,21,12,9,群益金鼎-桃園,2023-08-21,9189
2368,金像電,22,13,9,群益金鼎-桃園,2023-08-21,9189
4746,台耀,10,1,9,群益金鼎-桃園,2023-08-21,9189
3324,雙鴻,19,10,9,群益金鼎-桃園,2023-08-21,9189
2401,凌陽,12,3,9,群益金鼎-桃園,2023-08-21,9189
2883,凱基金,8,0,8,群益金鼎-桃園,2023-08-21,9189
2020,美亞,8,0,8,群益金鼎-桃園,2023-08-21,9189
6806,森崴能源,8,0,8,群益金鼎-桃園,2023-08-21,9189
2888,新光金,8,0,8,群益金鼎-桃園,2023-08-21,9189
2880,華南金,7,0,7,群益金鼎-桃園,2023-08-21,9189
6770,力積電,7,0,7,群益金鼎-桃園,2023-08-21,9189
2324,仁寶,382,65,317,群益金鼎-桃園,2023-08-22,9189
00673R,期元大S＆P原油反1,240,0,240,群益金鼎-桃園,2023-08-22,9189
00686R,群益臺灣加權反1,200,0,200,群益金鼎-桃園,2023-08-22,9189
00665L,富邦�琤肭磪囓�2,162,0,162,群益金鼎-桃園,2023-08-22,9189
2010,春源,60,0,60,群益金鼎-桃園,2023-08-22,9189
00929,復華台灣科技優息,62,11,51,群益金鼎-桃園,2023-08-22,9189
2399,映泰,30,0,30,群益金鼎-桃園,2023-08-22,9189
6114,久威,26,0,26,群益金鼎-桃園,2023-08-22,9189
6125,廣運,117,91,26,群益金鼎-桃園,2023-08-22,9189
2516,新建,25,0,25,群益金鼎-桃園,2023-08-22,9189
2606,裕民,38,14,24,群益金鼎-桃園,2023-08-22,9189
1326,台化,23,0,23,群益金鼎-桃園,2023-08-22,9189
00753L,中信中國50正2,50,27,23,群益金鼎-桃園,2023-08-22,9189
2352,佳世達,22,0,22,群益金鼎-桃園,2023-08-22,9189
1513,中興電,31,10,21,群益金鼎-桃園,2023-08-22,9189
00852L,國泰美國道瓊正2,21,0,21,群益金鼎-桃園,2023-08-22,9189
2323,中環,21,0,21,群益金鼎-桃園,2023-08-22,9189
1711,永光,20,0,20,群益金鼎-桃園,2023-08-22,9189
2014,中鴻,19,1,18,群益金鼎-桃園,2023-08-22,9189
00679B,元大美債20年,17,0,17,群益金鼎-桃園,2023-08-22,9189
6282,康舒,23,6,17,群益金鼎-桃園,2023-08-22,9189
2645,長榮航太,17,1,16,群益金鼎-桃園,2023-08-22,9189
2371,大同,20,4,16,群益金鼎-桃園,2023-08-22,9189
00637L,元大滬深300正2,15,0,15,群益金鼎-桃園,2023-08-22,9189
5469,瀚宇博,17,2,15,群益金鼎-桃園,2023-08-22,9189
8050,廣積,21,6,15,群益金鼎-桃園,2023-08-22,9189
3576,聯合再生,14,0,14,群益金鼎-桃園,2023-08-22,9189
3308,聯德,19,5,14,群益金鼎-桃園,2023-08-22,9189
00725B,國泰投資級公司債,17,3,14,群益金鼎-桃園,2023-08-22,9189
00795B,中信美國公債20年,13,0,13,群益金鼎-桃園,2023-08-22,9189
1471,首利,41,28,13,群益金鼎-桃園,2023-08-22,9189
1605,華新,16,4,12,群益金鼎-桃園,2023-08-22,9189
8210,勤誠,17,5,12,群益金鼎-桃園,2023-08-22,9189
2402,毅嘉,11,0,11,群益金鼎-桃園,2023-08-22,9189
1444,力麗,14,4,10,群益金鼎-桃園,2023-08-22,9189
3380,明泰,10,0,10,群益金鼎-桃園,2023-08-22,9189
4154,樂威科-KY,10,0,10,群益金鼎-桃園,2023-08-22,9189
1504,東元,22,12,10,群益金鼎-桃園,2023-08-22,9189
6179,亞通,10,0,10,群益金鼎-桃園,2023-08-22,9189
2605,新興,18,8,10,群益金鼎-桃園,2023-08-22,9189
2883,凱基金,20,10,10,群益金鼎-桃園,2023-08-22,9189
3306,鼎天,21,12,9,群益金鼎-桃園,2023-08-22,9189
3038,全台,9,0,9,群益金鼎-桃園,2023-08-22,9189
6285,啟��,27,18,9,群益金鼎-桃園,2023-08-22,9189
3051,力特,14,5,9,群益金鼎-桃園,2023-08-22,9189
2002,中鋼,9,0,9,群益金鼎-桃園,2023-08-22,9189
2363,矽統,132,124,8,群益金鼎-桃園,2023-08-22,9189
6770,力積電,12,4,8,群益金鼎-桃園,2023-08-22,9189
2891,中信金,10,2,8,群益金鼎-桃園,2023-08-22,9189
2460,建通,8,0,8,群益金鼎-桃園,2023-08-22,9189
2610,華航,109,8,101,群益金鼎-桃園,2023-08-23,9189
2618,長榮航,122,48,74,群益金鼎-桃園,2023-08-23,9189
2010,春源,60,0,60,群益金鼎-桃園,2023-08-23,9189
00632R,元大台灣50反1,49,10,39,群益金鼎-桃園,2023-08-23,9189
3163,波若威,40,5,35,群益金鼎-桃園,2023-08-23,9189
2883,凱基金,29,1,28,群益金鼎-桃園,2023-08-23,9189
3013,晟銘電,85,58,27,群益金鼎-桃園,2023-08-23,9189
2382,廣達,54,28,26,群益金鼎-桃園,2023-08-23,9189
00922,國泰台灣領袖50,20,0,20,群益金鼎-桃園,2023-08-23,9189
2538,基泰,20,0,20,群益金鼎-桃園,2023-08-23,9189
4906,正文,30,11,19,群益金鼎-桃園,2023-08-23,9189
2329,華泰,25,7,18,群益金鼎-桃園,2023-08-23,9189
2543,皇昌,20,2,18,群益金鼎-桃園,2023-08-23,9189
9919,康那香,18,0,18,群益金鼎-桃園,2023-08-23,9189
9945,潤泰新,17,0,17,群益金鼎-桃園,2023-08-23,9189
2337,旺宏,16,0,16,群益金鼎-桃園,2023-08-23,9189
6117,迎廣,155,139,16,群益金鼎-桃園,2023-08-23,9189
00712,復華富時不動產,20,4,16,群益金鼎-桃園,2023-08-23,9189
3576,聯合再生,15,0,15,群益金鼎-桃園,2023-08-23,9189
2511,太子,15,0,15,群益金鼎-桃園,2023-08-23,9189
8050,廣積,22,9,13,群益金鼎-桃園,2023-08-23,9189
2303,聯電,14,2,12,群益金鼎-桃園,2023-08-23,9189
2421,建準,16,4,12,群益金鼎-桃園,2023-08-23,9189
3324,雙鴻,13,1,12,群益金鼎-桃園,2023-08-23,9189
2637,慧洋-KY,32,20,12,群益金鼎-桃園,2023-08-23,9189
2606,裕民,11,0,11,群益金鼎-桃園,2023-08-23,9189
3228,金麗科,11,0,11,群益金鼎-桃園,2023-08-23,9189
3689,湧德,18,7,11,群益金鼎-桃園,2023-08-23,9189
2820,華票,10,0,10,群益金鼎-桃園,2023-08-23,9189
4977,眾達-KY,10,0,10,群益金鼎-桃園,2023-08-23,9189
4162,智擎,10,0,10,群益金鼎-桃園,2023-08-23,9189
6234,高僑,10,0,10,群益金鼎-桃園,2023-08-23,9189
3078,僑威,17,7,10,群益金鼎-桃園,2023-08-23,9189
6215,和椿,10,0,10,群益金鼎-桃園,2023-08-23,9189
6116,彩晶,10,0,10,群益金鼎-桃園,2023-08-23,9189
1444,力麗,10,0,10,群益金鼎-桃園,2023-08-23,9189
1529,樂事綠能,10,0,10,群益金鼎-桃園,2023-08-23,9189
1504,東元,11,2,9,群益金鼎-桃園,2023-08-23,9189
3664,安瑞-KY,11,2,9,群益金鼎-桃園,2023-08-23,9189
2440,太空梭,9,0,9,群益金鼎-桃園,2023-08-23,9189
2881,富邦金,9,1,8,群益金鼎-桃園,2023-08-23,9189
2367,燿華,15,8,7,群益金鼎-桃園,2023-08-23,9189
00885,富邦越南,7,0,7,群益金鼎-桃園,2023-08-23,9189
00720B,元大投資級公司債,7,0,7,群益金鼎-桃園,2023-08-23,9189
00637L,元大滬深300正2,7,0,7,群益金鼎-桃園,2023-08-23,9189
5880,合庫金,7,0,7,群益金鼎-桃園,2023-08-23,9189
00931B,統一美債20年,6,0,6,群益金鼎-桃園,2023-08-23,9189
3558,神準,11,5,6,群益金鼎-桃園,2023-08-23,9189
4746,台耀,7,1,6,群益金鼎-桃園,2023-08-23,9189
1802,台玻,6,0,6,群益金鼎-桃園,2023-08-23,9189
2010,春源,180,0,180,群益金鼎-桃園,2023-08-24,9189
2618,長榮航,181,38,143,群益金鼎-桃園,2023-08-24,9189
2363,矽統,196,112,84,群益金鼎-桃園,2023-08-24,9189
2883,凱基金,75,4,71,群益金鼎-桃園,2023-08-24,9189
3231,緯創,497,434,63,群益金鼎-桃園,2023-08-24,9189
2331,精英,125,63,62,群益金鼎-桃園,2023-08-24,9189
6191,精成科,95,40,55,群益金鼎-桃園,2023-08-24,9189
2485,兆赫,158,104,54,群益金鼎-桃園,2023-08-24,9189
2634,漢翔,109,56,53,群益金鼎-桃園,2023-08-24,9189
00772B,中信高評級公司債,40,1,39,群益金鼎-桃園,2023-08-24,9189
2605,新興,41,8,33,群益金鼎-桃園,2023-08-24,9189
6114,久威,26,1,25,群益金鼎-桃園,2023-08-24,9189
3308,聯德,35,11,24,群益金鼎-桃園,2023-08-24,9189
00852L,國泰美國道瓊正2,24,0,24,群益金鼎-桃園,2023-08-24,9189
2368,金像電,39,16,23,群益金鼎-桃園,2023-08-24,9189
1737,臺鹽,23,0,23,群益金鼎-桃園,2023-08-24,9189
3035,智原,39,16,23,群益金鼎-桃園,2023-08-24,9189
3576,聯合再生,22,1,21,群益金鼎-桃園,2023-08-24,9189
00919,群益台灣精選高息,23,3,20,群益金鼎-桃園,2023-08-24,9189
1721,三晃,20,0,20,群益金鼎-桃園,2023-08-24,9189
3581,博磊,20,0,20,群益金鼎-桃園,2023-08-24,9189
2449,京元電子,66,46,20,群益金鼎-桃園,2023-08-24,9189
8222,寶一,20,1,19,群益金鼎-桃園,2023-08-24,9189
00664R,國泰臺灣加權反1,18,0,18,群益金鼎-桃園,2023-08-24,9189
2610,華航,18,0,18,群益金鼎-桃園,2023-08-24,9189
6168,宏齊,17,0,17,群益金鼎-桃園,2023-08-24,9189
2356,英業達,45,29,16,群益金鼎-桃園,2023-08-24,9189
4931,新盛力,15,0,15,群益金鼎-桃園,2023-08-24,9189
2002,中鋼,17,3,14,群益金鼎-桃園,2023-08-24,9189
3078,僑威,26,13,13,群益金鼎-桃園,2023-08-24,9189
3483,力致,15,2,13,群益金鼎-桃園,2023-08-24,9189
2382,廣達,72,59,13,群益金鼎-桃園,2023-08-24,9189
1402,遠東新,12,0,12,群益金鼎-桃園,2023-08-24,9189
1709,和益,12,1,11,群益金鼎-桃園,2023-08-24,9189
3673,TPK-KY,11,0,11,群益金鼎-桃園,2023-08-24,9189
4543,萬在,14,3,11,群益金鼎-桃園,2023-08-24,9189
8234,新漢,19,8,11,群益金鼎-桃園,2023-08-24,9189
6285,啟��,22,11,11,群益金鼎-桃園,2023-08-24,9189
9945,潤泰新,10,0,10,群益金鼎-桃園,2023-08-24,9189
1455,集盛,10,0,10,群益金鼎-桃園,2023-08-24,9189
2344,華邦電,22,12,10,群益金鼎-桃園,2023-08-24,9189
2390,云辰,13,3,10,群益金鼎-桃園,2023-08-24,9189
3041,揚智,10,0,10,群益金鼎-桃園,2023-08-24,9189
2913,農林,10,0,10,群益金鼎-桃園,2023-08-24,9189
2014,中鴻,10,0,10,群益金鼎-桃園,2023-08-24,9189
2887,台新金,9,0,9,群益金鼎-桃園,2023-08-24,9189
2484,希華,9,0,9,群益金鼎-桃園,2023-08-24,9189
00715L,期街口布蘭特正2,9,0,9,群益金鼎-桃園,2023-08-24,9189
3265,台星科,13,5,8,群益金鼎-桃園,2023-08-24,9189
2405,輔信,8,0,8,群益金鼎-桃園,2023-08-24,9189
2010,春源,200,0,200,群益金鼎-桃園,2023-08-25,9189
00878,國泰永續高股息,160,2,158,群益金鼎-桃園,2023-08-25,9189
00929,復華台灣科技優息,154,5,149,群益金鼎-桃園,2023-08-25,9189
3231,緯創,272,141,131,群益金鼎-桃園,2023-08-25,9189
00919,群益台灣精選高息,91,0,91,群益金鼎-桃園,2023-08-25,9189
2303,聯電,62,1,61,群益金鼎-桃園,2023-08-25,9189
2382,廣達,80,22,58,群益金鼎-桃園,2023-08-25,9189
2705,六福,58,1,57,群益金鼎-桃園,2023-08-25,9189
00632R,元大台灣50反1,81,28,53,群益金鼎-桃園,2023-08-25,9189
8930,青鋼,50,0,50,群益金鼎-桃園,2023-08-25,9189
3037,欣興,59,16,43,群益金鼎-桃園,2023-08-25,9189
2883,凱基金,55,14,41,群益金鼎-桃園,2023-08-25,9189
2208,台船,40,1,39,群益金鼎-桃園,2023-08-25,9189
1524,耿鼎,35,0,35,群益金鼎-桃園,2023-08-25,9189
8112,至上,34,4,30,群益金鼎-桃園,2023-08-25,9189
00895,富邦未來車,30,0,30,群益金鼎-桃園,2023-08-25,9189
00900,富邦特選高股息30,35,8,27,群益金鼎-桃園,2023-08-25,9189
00719B,元大美債1-3,26,0,26,群益金鼎-桃園,2023-08-25,9189
0056,元大高股息,23,1,22,群益金鼎-桃園,2023-08-25,9189
6168,宏齊,27,7,20,群益金鼎-桃園,2023-08-25,9189
8076,伍豐,20,0,20,群益金鼎-桃園,2023-08-25,9189
2330,台積電,21,2,19,群益金鼎-桃園,2023-08-25,9189
1815,富喬,20,1,19,群益金鼎-桃園,2023-08-25,9189
5381,合正,28,11,17,群益金鼎-桃園,2023-08-25,9189
2332,友訊,31,15,16,群益金鼎-桃園,2023-08-25,9189
2368,金像電,18,2,16,群益金鼎-桃園,2023-08-25,9189
1536,和大,14,0,14,群益金鼎-桃園,2023-08-25,9189
2468,華經,12,0,12,群益金鼎-桃園,2023-08-25,9189
1734,杏輝,13,1,12,群益金鼎-桃園,2023-08-25,9189
8069,元太,11,0,11,群益金鼎-桃園,2023-08-25,9189
2630,亞航,16,5,11,群益金鼎-桃園,2023-08-25,9189
2369,菱生,18,7,11,群益金鼎-桃園,2023-08-25,9189
2301,光寶科,15,4,11,群益金鼎-桃園,2023-08-25,9189
2363,矽統,106,95,11,群益金鼎-桃園,2023-08-25,9189
2324,仁寶,20,10,10,群益金鼎-桃園,2023-08-25,9189
2329,華泰,13,3,10,群益金鼎-桃園,2023-08-25,9189
00909,國泰數位支付服務,10,0,10,群益金鼎-桃園,2023-08-25,9189
3062,建漢,11,1,10,群益金鼎-桃園,2023-08-25,9189
2605,新興,14,4,10,群益金鼎-桃園,2023-08-25,9189
4130,健亞,10,0,10,群益金鼎-桃園,2023-08-25,9189
8103,瀚荃,10,0,10,群益金鼎-桃園,2023-08-25,9189
2886,兆豐金,10,0,10,群益金鼎-桃園,2023-08-25,9189
6603,富強鑫,10,0,10,群益金鼎-桃園,2023-08-25,9189
5876,上海商銀,10,0,10,群益金鼎-桃園,2023-08-25,9189
9950,萬國通,10,0,10,群益金鼎-桃園,2023-08-25,9189
2002,中鋼,16,7,9,群益金鼎-桃園,2023-08-25,9189
6770,力積電,10,1,9,群益金鼎-桃園,2023-08-25,9189
2412,中華電,10,1,9,群益金鼎-桃園,2023-08-25,9189
6284,佳邦,12,3,9,群益金鼎-桃園,2023-08-25,9189
2888,新光金,12,3,9,群益金鼎-桃園,2023-08-25,9189
2010,春源,200,0,200,群益金鼎-桃園,2023-08-28,9189
00929,復華台灣科技優息,147,13,134,群益金鼎-桃園,2023-08-28,9189
00878,國泰永續高股息,69,5,64,群益金鼎-桃園,2023-08-28,9189
8930,青鋼,50,0,50,群益金鼎-桃園,2023-08-28,9189
5469,瀚宇博,60,12,48,群益金鼎-桃園,2023-08-28,9189
2888,新光金,103,57,46,群益金鼎-桃園,2023-08-28,9189
2618,長榮航,70,29,41,群益金鼎-桃園,2023-08-28,9189
2388,威盛,53,15,38,群益金鼎-桃園,2023-08-28,9189
2323,中環,23,0,23,群益金鼎-桃園,2023-08-28,9189
6191,精成科,20,0,20,群益金鼎-桃園,2023-08-28,9189
4906,正文,22,4,18,群益金鼎-桃園,2023-08-28,9189
00931B,統一美債20年,17,1,16,群益金鼎-桃園,2023-08-28,9189
2331,精英,48,32,16,群益金鼎-桃園,2023-08-28,9189
3051,力特,16,1,15,群益金鼎-桃園,2023-08-28,9189
2313,華通,15,1,14,群益金鼎-桃園,2023-08-28,9189
1802,台玻,23,10,13,群益金鼎-桃園,2023-08-28,9189
1605,華新,12,0,12,群益金鼎-桃園,2023-08-28,9189
4960,誠美材,12,0,12,群益金鼎-桃園,2023-08-28,9189
3346,麗清,12,0,12,群益金鼎-桃園,2023-08-28,9189
2352,佳世達,12,0,12,群益金鼎-桃園,2023-08-28,9189
3715,定穎投控,84,73,11,群益金鼎-桃園,2023-08-28,9189
1504,東元,11,0,11,群益金鼎-桃園,2023-08-28,9189
3078,僑威,11,0,11,群益金鼎-桃園,2023-08-28,9189
4916,事欣科,14,3,11,群益金鼎-桃園,2023-08-28,9189
1445,大宇,10,0,10,群益金鼎-桃園,2023-08-28,9189
9950,萬國通,10,0,10,群益金鼎-桃園,2023-08-28,9189
1734,杏輝,10,0,10,群益金鼎-桃園,2023-08-28,9189
2353,宏��,11,1,10,群益金鼎-桃園,2023-08-28,9189
00919,群益台灣精選高息,11,1,10,群益金鼎-桃園,2023-08-28,9189
2516,新建,10,0,10,群益金鼎-桃園,2023-08-28,9189
3047,訊舟,10,0,10,群益金鼎-桃園,2023-08-28,9189
3044,健鼎,12,2,10,群益金鼎-桃園,2023-08-28,9189
3026,禾伸堂,10,0,10,群益金鼎-桃園,2023-08-28,9189
2886,兆豐金,10,0,10,群益金鼎-桃園,2023-08-28,9189
1101,台泥,9,0,9,群益金鼎-桃園,2023-08-28,9189
6203,海韻電,10,1,9,群益金鼎-桃園,2023-08-28,9189
3558,神準,12,4,8,群益金鼎-桃園,2023-08-28,9189
00713,元大台灣高息低波,8,0,8,群益金鼎-桃園,2023-08-28,9189
3021,鴻名,8,0,8,群益金鼎-桃園,2023-08-28,9189
6288,聯嘉,9,1,8,群益金鼎-桃園,2023-08-28,9189
1519,華城,18,10,8,群益金鼎-桃園,2023-08-28,9189
3305,昇貿,8,1,7,群益金鼎-桃園,2023-08-28,9189
6538,倉和,9,2,7,群益金鼎-桃園,2023-08-28,9189
3576,聯合再生,15,8,7,群益金鼎-桃園,2023-08-28,9189
8112,至上,6,0,6,群益金鼎-桃園,2023-08-28,9189
3013,晟銘電,42,36,6,群益金鼎-桃園,2023-08-28,9189
2421,建準,14,8,6,群益金鼎-桃園,2023-08-28,9189
2903,遠百,6,0,6,群益金鼎-桃園,2023-08-28,9189
4138,曜亞,10,4,6,群益金鼎-桃園,2023-08-28,9189
8155,博智,6,0,6,群益金鼎-桃園,2023-08-28,9189
2010,春源,220,0,220,群益金鼎-桃園,2023-08-29,9189
00878,國泰永續高股息,59,2,57,群益金鼎-桃園,2023-08-29,9189
00900,富邦特選高股息30,56,0,56,群益金鼎-桃園,2023-08-29,9189
00929,復華台灣科技優息,75,29,46,群益金鼎-桃園,2023-08-29,9189
2303,聯電,38,4,34,群益金鼎-桃園,2023-08-29,9189
2363,矽統,132,101,31,群益金鼎-桃園,2023-08-29,9189
00931B,統一美債20年,30,0,30,群益金鼎-桃園,2023-08-29,9189
2402,毅嘉,50,20,30,群益金鼎-桃園,2023-08-29,9189
5381,合正,21,0,21,群益金鼎-桃園,2023-08-29,9189
5222,全訊,29,9,20,群益金鼎-桃園,2023-08-29,9189
2634,漢翔,46,26,20,群益金鼎-桃園,2023-08-29,9189
2328,廣宇,19,1,18,群益金鼎-桃園,2023-08-29,9189
2421,建準,25,7,18,群益金鼎-桃園,2023-08-29,9189
3706,神達,20,3,17,群益金鼎-桃園,2023-08-29,9189
2812,台中銀,17,0,17,群益金鼎-桃園,2023-08-29,9189
8222,寶一,29,12,17,群益金鼎-桃園,2023-08-29,9189
2329,華泰,21,5,16,群益金鼎-桃園,2023-08-29,9189
2002,中鋼,15,0,15,群益金鼎-桃園,2023-08-29,9189
6282,康舒,15,0,15,群益金鼎-桃園,2023-08-29,9189
3011,今皓,16,1,15,群益金鼎-桃園,2023-08-29,9189
00923,群益台ESG低碳50,15,0,15,群益金鼎-桃園,2023-08-29,9189
2419,仲琦,14,0,14,群益金鼎-桃園,2023-08-29,9189
2368,金像電,13,0,13,群益金鼎-桃園,2023-08-29,9189
1721,三晃,13,0,13,群益金鼎-桃園,2023-08-29,9189
1513,中興電,12,0,12,群益金鼎-桃園,2023-08-29,9189
6191,精成科,13,2,11,群益金鼎-桃園,2023-08-29,9189
00679B,元大美債20年,11,1,10,群益金鼎-桃園,2023-08-29,9189
00692,富邦公司治理,10,0,10,群益金鼎-桃園,2023-08-29,9189
1907,永豐餘,10,0,10,群益金鼎-桃園,2023-08-29,9189
1217,愛之味,10,0,10,群益金鼎-桃園,2023-08-29,9189
00673R,期元大S＆P原油反1,10,0,10,群益金鼎-桃園,2023-08-29,9189
5301,寶得利,10,0,10,群益金鼎-桃園,2023-08-29,9189
00665L,富邦�琤肭磪囓�2,10,0,10,群益金鼎-桃園,2023-08-29,9189
00903,富邦元宇宙,9,0,9,群益金鼎-桃園,2023-08-29,9189
8033,雷虎,20,11,9,群益金鼎-桃園,2023-08-29,9189
6213,聯茂,16,8,8,群益金鼎-桃園,2023-08-29,9189
1612,宏泰,8,0,8,群益金鼎-桃園,2023-08-29,9189
00885,富邦越南,11,3,8,群益金鼎-桃園,2023-08-29,9189
5880,合庫金,7,0,7,群益金鼎-桃園,2023-08-29,9189
4968,立積,7,0,7,群益金鼎-桃園,2023-08-29,9189
1471,首利,29,22,7,群益金鼎-桃園,2023-08-29,9189
4961,天鈺,7,1,6,群益金鼎-桃園,2023-08-29,9189
8936,國統,6,0,6,群益金鼎-桃園,2023-08-29,9189
9136,巨騰-DR,6,0,6,群益金鼎-桃園,2023-08-29,9189
4155,訊映,6,0,6,群益金鼎-桃園,2023-08-29,9189
4934,太極,6,0,6,群益金鼎-桃園,2023-08-29,9189
2441,超豐,6,0,6,群益金鼎-桃園,2023-08-29,9189
2324,仁寶,26,20,6,群益金鼎-桃園,2023-08-29,9189
00919,群益台灣精選高息,10,4,6,群益金鼎-桃園,2023-08-29,9189
2888,新光金,9,3,6,群益金鼎-桃園,2023-08-29,9189
3481,群創,1550,36,1514,群益金鼎-桃園,2023-08-30,9189
2409,友達,1007,0,1007,群益金鼎-桃園,2023-08-30,9189
2436,偉詮電,462,67,395,群益金鼎-桃園,2023-08-30,9189
00632R,元大台灣50反1,49,0,49,群益金鼎-桃園,2023-08-30,9189
2605,新興,36,0,36,群益金鼎-桃園,2023-08-30,9189
6185,幃翔,36,0,36,群益金鼎-桃園,2023-08-30,9189
00715L,期街口布蘭特正2,35,2,33,群益金鼎-桃園,2023-08-30,9189
6806,森崴能源,37,5,32,群益金鼎-桃園,2023-08-30,9189
5381,合正,31,0,31,群益金鼎-桃園,2023-08-30,9189
1815,富喬,22,0,22,群益金鼎-桃園,2023-08-30,9189
5880,合庫金,21,0,21,群益金鼎-桃園,2023-08-30,9189
1326,台化,20,0,20,群益金鼎-桃園,2023-08-30,9189
5314,世紀,20,0,20,群益金鼎-桃園,2023-08-30,9189
2880,華南金,20,0,20,群益金鼎-桃園,2023-08-30,9189
8222,寶一,30,13,17,群益金鼎-桃園,2023-08-30,9189
2344,華邦電,16,0,16,群益金鼎-桃園,2023-08-30,9189
00888,永豐台灣ESG,16,0,16,群益金鼎-桃園,2023-08-30,9189
1524,耿鼎,20,4,16,群益金鼎-桃園,2023-08-30,9189
00753L,中信中國50正2,15,0,15,群益金鼎-桃園,2023-08-30,9189
2834,臺企銀,20,6,14,群益金鼎-桃園,2023-08-30,9189
00637L,元大滬深300正2,23,10,13,群益金鼎-桃園,2023-08-30,9189
4746,台耀,15,3,12,群益金鼎-桃園,2023-08-30,9189
1471,首利,24,13,11,群益金鼎-桃園,2023-08-30,9189
2610,華航,12,1,11,群益金鼎-桃園,2023-08-30,9189
9945,潤泰新,11,1,10,群益金鼎-桃園,2023-08-30,9189
2812,台中銀,10,0,10,群益金鼎-桃園,2023-08-30,9189
1445,大宇,20,10,10,群益金鼎-桃園,2023-08-30,9189
00922,國泰台灣領袖50,10,0,10,群益金鼎-桃園,2023-08-30,9189
9906,欣巴巴,10,0,10,群益金鼎-桃園,2023-08-30,9189
00929,復華台灣科技優息,22,12,10,群益金鼎-桃園,2023-08-30,9189
1609,大亞,15,6,9,群益金鼎-桃園,2023-08-30,9189
00931B,統一美債20年,9,0,9,群益金鼎-桃園,2023-08-30,9189
6257,矽格,15,6,9,群益金鼎-桃園,2023-08-30,9189
6285,啟��,16,8,8,群益金鼎-桃園,2023-08-30,9189
3706,神達,9,1,8,群益金鼎-桃園,2023-08-30,9189
2421,建準,16,8,8,群益金鼎-桃園,2023-08-30,9189
00900,富邦特選高股息30,10,2,8,群益金鼎-桃園,2023-08-30,9189
6188,廣明,10,3,7,群益金鼎-桃園,2023-08-30,9189
2301,光寶科,14,7,7,群益金鼎-桃園,2023-08-30,9189
6104,創惟,7,1,6,群益金鼎-桃園,2023-08-30,9189
2441,超豐,6,0,6,群益金鼎-桃園,2023-08-30,9189
2637,慧洋-KY,6,0,6,群益金鼎-桃園,2023-08-30,9189
3596,智易,6,0,6,群益金鼎-桃園,2023-08-30,9189
3715,定穎投控,115,109,6,群益金鼎-桃園,2023-08-30,9189
00795B,中信美國公債20年,6,0,6,群益金鼎-桃園,2023-08-30,9189
8081,致新,6,0,6,群益金鼎-桃園,2023-08-30,9189
00919,群益台灣精選高息,13,8,5,群益金鼎-桃園,2023-08-30,9189
2618,長榮航,37,32,5,群益金鼎-桃園,2023-08-30,9189
1434,福懋,5,0,5,群益金鼎-桃園,2023-08-30,9189
3430,奇鈦科,5,0,5,群益金鼎-桃園,2023-08-30,9189
3481,群創,212,0,212,群益金鼎-桃園,2023-08-31,9189
9904,寶成,100,0,100,群益金鼎-桃園,2023-08-31,9189
5381,合正,102,11,91,群益金鼎-桃園,2023-08-31,9189
2317,鴻海,75,5,70,群益金鼎-桃園,2023-08-31,9189
2324,仁寶,70,14,56,群益金鼎-桃園,2023-08-31,9189
2436,偉詮電,126,73,53,群益金鼎-桃園,2023-08-31,9189
00878,國泰永續高股息,58,6,52,群益金鼎-桃園,2023-08-31,9189
2485,兆赫,71,21,50,群益金鼎-桃園,2023-08-31,9189
2530,華建,30,0,30,群益金鼎-桃園,2023-08-31,9189
2323,中環,30,0,30,群益金鼎-桃園,2023-08-31,9189
2610,華航,33,3,30,群益金鼎-桃園,2023-08-31,9189
8048,德勝,30,1,29,群益金鼎-桃園,2023-08-31,9189
2618,長榮航,38,12,26,群益金鼎-桃園,2023-08-31,9189
2886,兆豐金,26,1,25,群益金鼎-桃園,2023-08-31,9189
2412,中華電,25,0,25,群益金鼎-桃園,2023-08-31,9189
3715,定穎投控,109,85,24,群益金鼎-桃園,2023-08-31,9189
2440,太空梭,24,0,24,群益金鼎-桃園,2023-08-31,9189
2337,旺宏,53,31,22,群益金鼎-桃園,2023-08-31,9189
2388,威盛,28,7,21,群益金鼎-桃園,2023-08-31,9189
2511,太子,20,0,20,群益金鼎-桃園,2023-08-31,9189
2402,毅嘉,115,95,20,群益金鼎-桃園,2023-08-31,9189
1101,台泥,21,3,18,群益金鼎-桃園,2023-08-31,9189
1802,台玻,36,18,18,群益金鼎-桃園,2023-08-31,9189
00882,中信中國高股息,18,0,18,群益金鼎-桃園,2023-08-31,9189
2303,聯電,22,5,17,群益金鼎-桃園,2023-08-31,9189
2801,彰銀,17,0,17,群益金鼎-桃園,2023-08-31,9189
9906,欣巴巴,17,0,17,群益金鼎-桃園,2023-08-31,9189
2630,亞航,17,1,16,群益金鼎-桃園,2023-08-31,9189
6282,康舒,32,18,14,群益金鼎-桃園,2023-08-31,9189
6147,頎邦,18,5,13,群益金鼎-桃園,2023-08-31,9189
2392,正崴,19,6,13,群益金鼎-桃園,2023-08-31,9189
3051,力特,13,1,12,群益金鼎-桃園,2023-08-31,9189
1313,聯成,12,0,12,群益金鼎-桃園,2023-08-31,9189
00929,復華台灣科技優息,24,13,11,群益金鼎-桃園,2023-08-31,9189
5236,凌陽創新,11,0,11,群益金鼎-桃園,2023-08-31,9189
3308,聯德,13,2,11,群益金鼎-桃園,2023-08-31,9189
2367,燿華,20,9,11,群益金鼎-桃園,2023-08-31,9189
2887,台新金,11,0,11,群益金鼎-桃園,2023-08-31,9189
2834,臺企銀,10,0,10,群益金鼎-桃園,2023-08-31,9189
2014,中鴻,15,5,10,群益金鼎-桃園,2023-08-31,9189
3138,耀登,10,0,10,群益金鼎-桃園,2023-08-31,9189
2880,華南金,10,0,10,群益金鼎-桃園,2023-08-31,9189
00637L,元大滬深300正2,10,0,10,群益金鼎-桃園,2023-08-31,9189
2405,輔信,10,0,10,群益金鼎-桃園,2023-08-31,9189
9136,巨騰-DR,10,0,10,群益金鼎-桃園,2023-08-31,9189
2329,華泰,23,13,10,群益金鼎-桃園,2023-08-31,9189
2312,金寶,10,0,10,群益金鼎-桃園,2023-08-31,9189
2002,中鋼,9,0,9,群益金鼎-桃園,2023-08-31,9189
4933,友輝,14,5,9,群益金鼎-桃園,2023-08-31,9189
6274,台燿,17,8,9,群益金鼎-桃園,2023-08-31,9189
2010,春源,180,1,179,群益金鼎-桃園,2023-09-01,9189
00929,復華台灣科技優息,88,1,87,群益金鼎-桃園,2023-09-01,9189
00673R,期元大S＆P原油反1,70,0,70,群益金鼎-桃園,2023-09-01,9189
2485,兆赫,144,80,64,群益金鼎-桃園,2023-09-01,9189
00919,群益台灣精選高息,62,0,62,群益金鼎-桃園,2023-09-01,9189
5381,合正,67,6,61,群益金鼎-桃園,2023-09-01,9189
3011,今皓,61,3,58,群益金鼎-桃園,2023-09-01,9189
3481,群創,89,33,56,群益金鼎-桃園,2023-09-01,9189
2312,金寶,65,12,53,群益金鼎-桃園,2023-09-01,9189
3231,緯創,97,54,43,群益金鼎-桃園,2023-09-01,9189
2382,廣達,48,14,34,群益金鼎-桃園,2023-09-01,9189
00632R,元大台灣50反1,28,0,28,群益金鼎-桃園,2023-09-01,9189
2393,億光,27,0,27,群益金鼎-桃園,2023-09-01,9189
6285,啟��,26,1,25,群益金鼎-桃園,2023-09-01,9189
2369,菱生,31,7,24,群益金鼎-桃園,2023-09-01,9189
1101,台泥,21,0,21,群益金鼎-桃園,2023-09-01,9189
2530,華建,20,0,20,群益金鼎-桃園,2023-09-01,9189
3260,威剛,22,3,19,群益金鼎-桃園,2023-09-01,9189
2356,英業達,32,13,19,群益金鼎-桃園,2023-09-01,9189
2812,台中銀,20,2,18,群益金鼎-桃園,2023-09-01,9189
6274,台燿,42,24,18,群益金鼎-桃園,2023-09-01,9189
2645,長榮航太,19,2,17,群益金鼎-桃園,2023-09-01,9189
3037,欣興,19,2,17,群益金鼎-桃園,2023-09-01,9189
2401,凌陽,21,4,17,群益金鼎-桃園,2023-09-01,9189
6547,高端疫苗,19,2,17,群益金鼎-桃園,2023-09-01,9189
1605,華新,22,5,17,群益金鼎-桃園,2023-09-01,9189
4909,新復興,36,20,16,群益金鼎-桃園,2023-09-01,9189
2301,光寶科,25,9,16,群益金鼎-桃園,2023-09-01,9189
3013,晟銘電,16,1,15,群益金鼎-桃園,2023-09-01,9189
00923,群益台ESG低碳50,14,0,14,群益金鼎-桃園,2023-09-01,9189
3044,健鼎,18,4,14,群益金鼎-桃園,2023-09-01,9189
2331,精英,24,10,14,群益金鼎-桃園,2023-09-01,9189
2392,正崴,13,1,12,群益金鼎-桃園,2023-09-01,9189
2457,飛宏,15,3,12,群益金鼎-桃園,2023-09-01,9189
2368,金像電,17,6,11,群益金鼎-桃園,2023-09-01,9189
1528,恩德,13,2,11,群益金鼎-桃園,2023-09-01,9189
2329,華泰,42,31,11,群益金鼎-桃園,2023-09-01,9189
5512,力麒,10,0,10,群益金鼎-桃園,2023-09-01,9189
00903,富邦元宇宙,10,0,10,群益金鼎-桃園,2023-09-01,9189
8403,盛弘,10,0,10,群益金鼎-桃園,2023-09-01,9189
1614,三洋電,10,0,10,群益金鼎-桃園,2023-09-01,9189
8183,精星,10,0,10,群益金鼎-桃園,2023-09-01,9189
3325,旭品,13,4,9,群益金鼎-桃園,2023-09-01,9189
2352,佳世達,11,2,9,群益金鼎-桃園,2023-09-01,9189
3265,台星科,19,10,9,群益金鼎-桃園,2023-09-01,9189
2355,敬鵬,9,0,9,群益金鼎-桃園,2023-09-01,9189
9927,泰銘,10,1,9,群益金鼎-桃園,2023-09-01,9189
00932,兆豐永續高息等權,8,0,8,群益金鼎-桃園,2023-09-01,9189
8210,勤誠,17,9,8,群益金鼎-桃園,2023-09-01,9189
6770,力積電,8,0,8,群益金鼎-桃園,2023-09-01,9189
5381,合正,182,39,143,群益金鼎-桃園,2023-09-04,9189
00919,群益台灣精選高息,97,5,92,群益金鼎-桃園,2023-09-04,9189
2618,長榮航,71,6,65,群益金鼎-桃園,2023-09-04,9189
1584,精剛,38,6,32,群益金鼎-桃園,2023-09-04,9189
2023,燁輝,25,0,25,群益金鼎-桃園,2023-09-04,9189
2323,中環,30,6,24,群益金鼎-桃園,2023-09-04,9189
6288,聯嘉,32,8,24,群益金鼎-桃園,2023-09-04,9189
3011,今皓,34,11,23,群益金鼎-桃園,2023-09-04,9189
2812,台中銀,22,0,22,群益金鼎-桃園,2023-09-04,9189
2363,矽統,104,83,21,群益金鼎-桃園,2023-09-04,9189
3078,僑威,23,2,21,群益金鼎-桃園,2023-09-04,9189
00673R,期元大S＆P原油反1,24,4,20,群益金鼎-桃園,2023-09-04,9189
4938,和碩,19,0,19,群益金鼎-桃園,2023-09-04,9189
00931B,統一美債20年,19,0,19,群益金鼎-桃園,2023-09-04,9189
2409,友達,32,13,19,群益金鼎-桃園,2023-09-04,9189
1802,台玻,42,24,18,群益金鼎-桃園,2023-09-04,9189
2543,皇昌,22,4,18,群益金鼎-桃園,2023-09-04,9189
2002,中鋼,17,0,17,群益金鼎-桃園,2023-09-04,9189
0050,元大台灣50,20,3,17,群益金鼎-桃園,2023-09-04,9189
4542,科嶠,16,0,16,群益金鼎-桃園,2023-09-04,9189
1402,遠東新,16,0,16,群益金鼎-桃園,2023-09-04,9189
3257,虹冠電,63,47,16,群益金鼎-桃園,2023-09-04,9189
3071,協禧,15,0,15,群益金鼎-桃園,2023-09-04,9189
3051,力特,32,18,14,群益金鼎-桃園,2023-09-04,9189
9945,潤泰新,14,0,14,群益金鼎-桃園,2023-09-04,9189
3588,通嘉,39,25,14,群益金鼎-桃園,2023-09-04,9189
1471,首利,14,1,13,群益金鼎-桃園,2023-09-04,9189
3228,金麗科,13,0,13,群益金鼎-桃園,2023-09-04,9189
6625,必應,14,1,13,群益金鼎-桃園,2023-09-04,9189
8996,高力,14,1,13,群益金鼎-桃園,2023-09-04,9189
00885,富邦越南,15,3,12,群益金鼎-桃園,2023-09-04,9189
8222,寶一,22,10,12,群益金鼎-桃園,2023-09-04,9189
1101,台泥,14,2,12,群益金鼎-桃園,2023-09-04,9189
2748,雲品,11,0,11,群益金鼎-桃園,2023-09-04,9189
3290,東浦,16,5,11,群益金鼎-桃園,2023-09-04,9189
00679B,元大美債20年,10,0,10,群益金鼎-桃園,2023-09-04,9189
2371,大同,28,18,10,群益金鼎-桃園,2023-09-04,9189
2010,春源,10,0,10,群益金鼎-桃園,2023-09-04,9189
1806,冠軍,10,0,10,群益金鼎-桃園,2023-09-04,9189
3311,閎暉,10,0,10,群益金鼎-桃園,2023-09-04,9189
6160,欣技,10,0,10,群益金鼎-桃園,2023-09-04,9189
6285,啟��,11,1,10,群益金鼎-桃園,2023-09-04,9189
6461,益得,10,0,10,群益金鼎-桃園,2023-09-04,9189
8110,華東,14,4,10,群益金鼎-桃園,2023-09-04,9189
2317,鴻海,9,0,9,群益金鼎-桃園,2023-09-04,9189
2201,裕隆,19,10,9,群益金鼎-桃園,2023-09-04,9189
3481,群創,8,0,8,群益金鼎-桃園,2023-09-04,9189
2405,輔信,8,0,8,群益金鼎-桃園,2023-09-04,9189
2421,建準,11,3,8,群益金鼎-桃園,2023-09-04,9189
2488,漢平,14,6,8,群益金鼎-桃園,2023-09-04,9189
00919,群益台灣精選高息,326,3,323,群益金鼎-桃園,2023-09-05,9189
2363,矽統,98,35,63,群益金鼎-桃園,2023-09-05,9189
00929,復華台灣科技優息,113,54,59,群益金鼎-桃園,2023-09-05,9189
1616,億泰,40,0,40,群益金鼎-桃園,2023-09-05,9189
2312,金寶,38,2,36,群益金鼎-桃園,2023-09-05,9189
3715,定穎投控,90,58,32,群益金鼎-桃園,2023-09-05,9189
5314,世紀,30,0,30,群益金鼎-桃園,2023-09-05,9189
3163,波若威,39,11,28,群益金鼎-桃園,2023-09-05,9189
2436,偉詮電,141,117,24,群益金鼎-桃園,2023-09-05,9189
0050,元大台灣50,23,0,23,群益金鼎-桃園,2023-09-05,9189
2618,長榮航,54,31,23,群益金鼎-桃園,2023-09-05,9189
1303,南亞,20,0,20,群益金鼎-桃園,2023-09-05,9189
00922,國泰台灣領袖50,20,0,20,群益金鼎-桃園,2023-09-05,9189
00915,凱基優選高股息30,18,0,18,群益金鼎-桃園,2023-09-05,9189
2344,華邦電,23,6,17,群益金鼎-桃園,2023-09-05,9189
2332,友訊,19,2,17,群益金鼎-桃園,2023-09-05,9189
2392,正崴,18,3,15,群益金鼎-桃園,2023-09-05,9189
6173,信昌電,18,4,14,群益金鼎-桃園,2023-09-05,9189
00753L,中信中國50正2,13,0,13,群益金鼎-桃園,2023-09-05,9189
2609,陽明,14,1,13,群益金鼎-桃園,2023-09-05,9189
8261,富鼎,13,1,12,群益金鼎-桃園,2023-09-05,9189
6288,聯嘉,12,0,12,群益金鼎-桃園,2023-09-05,9189
2880,華南金,12,0,12,群益金鼎-桃園,2023-09-05,9189
2881,富邦金,11,0,11,群益金鼎-桃園,2023-09-05,9189
3014,聯陽,17,6,11,群益金鼎-桃園,2023-09-05,9189
2610,華航,19,8,11,群益金鼎-桃園,2023-09-05,9189
5258,虹堡,13,2,11,群益金鼎-桃園,2023-09-05,9189
2375,凱美,12,1,11,群益金鼎-桃園,2023-09-05,9189
00900,富邦特選高股息30,11,0,11,群益金鼎-桃園,2023-09-05,9189
2801,彰銀,10,0,10,群益金鼎-桃園,2023-09-05,9189
1568,倉佑,10,0,10,群益金鼎-桃園,2023-09-05,9189
2903,遠百,10,0,10,群益金鼎-桃園,2023-09-05,9189
2449,京元電子,10,0,10,群益金鼎-桃園,2023-09-05,9189
00680L,元大美債20正2,10,0,10,群益金鼎-桃園,2023-09-05,9189
00720B,元大投資級公司債,10,0,10,群益金鼎-桃園,2023-09-05,9189
2376,技嘉,16,7,9,群益金鼎-桃園,2023-09-05,9189
2887,台新金,12,3,9,群益金鼎-桃園,2023-09-05,9189
00773B,中信優先金融債,9,0,9,群益金鼎-桃園,2023-09-05,9189
1101,台泥,12,3,9,群益金鼎-桃園,2023-09-05,9189
1513,中興電,9,1,8,群益金鼎-桃園,2023-09-05,9189
5347,世界,10,2,8,群益金鼎-桃園,2023-09-05,9189
3051,力特,51,43,8,群益金鼎-桃園,2023-09-05,9189
3481,群創,7,0,7,群益金鼎-桃園,2023-09-05,9189
2367,燿華,7,0,7,群益金鼎-桃園,2023-09-05,9189
00931B,統一美債20年,7,0,7,群益金鼎-桃園,2023-09-05,9189
2458,義隆,19,12,7,群益金鼎-桃園,2023-09-05,9189
5488,松普,7,0,7,群益金鼎-桃園,2023-09-05,9189
3311,閎暉,7,0,7,群益金鼎-桃園,2023-09-05,9189
1605,華新,12,5,7,群益金鼎-桃園,2023-09-05,9189
00679B,元大美債20年,6,0,6,群益金鼎-桃園,2023-09-05,9189
00915,凱基優選高股息30,342,0,342,群益金鼎-桃園,2023-09-06,9189
3481,群創,161,12,149,群益金鼎-桃園,2023-09-06,9189
5381,合正,165,63,102,群益金鼎-桃園,2023-09-06,9189
00931B,統一美債20年,95,0,95,群益金鼎-桃園,2023-09-06,9189
00919,群益台灣精選高息,105,22,83,群益金鼎-桃園,2023-09-06,9189
00929,復華台灣科技優息,133,56,77,群益金鼎-桃園,2023-09-06,9189
2409,友達,78,4,74,群益金鼎-桃園,2023-09-06,9189
00878,國泰永續高股息,77,6,71,群益金鼎-桃園,2023-09-06,9189
2892,第一金,53,0,53,群益金鼎-桃園,2023-09-06,9189
8930,青鋼,52,0,52,群益金鼎-桃園,2023-09-06,9189
1101,台泥,72,23,49,群益金鼎-桃園,2023-09-06,9189
00891,中信關鍵半導體,48,0,48,群益金鼎-桃園,2023-09-06,9189
3034,聯詠,53,6,47,群益金鼎-桃園,2023-09-06,9189
2884,玉山金,43,0,43,群益金鼎-桃園,2023-09-06,9189
2881,富邦金,39,0,39,群益金鼎-桃園,2023-09-06,9189
2883,凱基金,36,0,36,群益金鼎-桃園,2023-09-06,9189
1471,首利,26,0,26,群益金鼎-桃園,2023-09-06,9189
0050,元大台灣50,25,3,22,群益金鼎-桃園,2023-09-06,9189
2401,凌陽,42,21,21,群益金鼎-桃園,2023-09-06,9189
2329,華泰,36,16,20,群益金鼎-桃園,2023-09-06,9189
2886,兆豐金,20,0,20,群益金鼎-桃園,2023-09-06,9189
1802,台玻,33,13,20,群益金鼎-桃園,2023-09-06,9189
1603,華電,18,0,18,群益金鼎-桃園,2023-09-06,9189
2485,兆赫,46,29,17,群益金鼎-桃園,2023-09-06,9189
4533,協易機,21,4,17,群益金鼎-桃園,2023-09-06,9189
6173,信昌電,18,2,16,群益金鼎-桃園,2023-09-06,9189
2323,中環,15,0,15,群益金鼎-桃園,2023-09-06,9189
2801,彰銀,14,0,14,群益金鼎-桃園,2023-09-06,9189
2337,旺宏,18,4,14,群益金鼎-桃園,2023-09-06,9189
00679B,元大美債20年,13,0,13,群益金鼎-桃園,2023-09-06,9189
3046,建��,18,5,13,群益金鼎-桃園,2023-09-06,9189
3011,今皓,14,1,13,群益金鼎-桃園,2023-09-06,9189
2834,臺企銀,13,0,13,群益金鼎-桃園,2023-09-06,9189
1314,中石化,12,0,12,群益金鼎-桃園,2023-09-06,9189
9950,萬國通,12,0,12,群益金鼎-桃園,2023-09-06,9189
6188,廣明,14,3,11,群益金鼎-桃園,2023-09-06,9189
6282,康舒,13,2,11,群益金鼎-桃園,2023-09-06,9189
00900,富邦特選高股息30,11,0,11,群益金鼎-桃園,2023-09-06,9189
2454,聯發科,12,2,10,群益金鼎-桃園,2023-09-06,9189
1108,幸福,10,0,10,群益金鼎-桃園,2023-09-06,9189
2887,台新金,12,2,10,群益金鼎-桃園,2023-09-06,9189
6142,友勁,10,0,10,群益金鼎-桃園,2023-09-06,9189
2022,聚亨,10,0,10,群益金鼎-桃園,2023-09-06,9189
2419,仲琦,10,0,10,群益金鼎-桃園,2023-09-06,9189
6116,彩晶,10,0,10,群益金鼎-桃園,2023-09-06,9189
00673R,期元大S＆P原油反1,10,0,10,群益金鼎-桃園,2023-09-06,9189
4563,百德,10,0,10,群益金鼎-桃園,2023-09-06,9189
6419,京晨科,10,0,10,群益金鼎-桃園,2023-09-06,9189
3715,定穎投控,64,54,10,群益金鼎-桃園,2023-09-06,9189
3325,旭品,10,1,9,群益金鼎-桃園,2023-09-06,9189
00918,大華優利高填息30,397,0,397,群益金鼎-桃園,2023-09-07,9189
00929,復華台灣科技優息,313,26,287,群益金鼎-桃園,2023-09-07,9189
2010,春源,130,0,130,群益金鼎-桃園,2023-09-07,9189
2313,華通,185,62,123,群益金鼎-桃園,2023-09-07,9189
2618,長榮航,133,23,110,群益金鼎-桃園,2023-09-07,9189
4909,新復興,69,4,65,群益金鼎-桃園,2023-09-07,9189
8930,青鋼,50,2,48,群益金鼎-桃園,2023-09-07,9189
1504,東元,50,4,46,群益金鼎-桃園,2023-09-07,9189
2409,友達,41,1,40,群益金鼎-桃園,2023-09-07,9189
4533,協易機,105,66,39,群益金鼎-桃園,2023-09-07,9189
3715,定穎投控,87,49,38,群益金鼎-桃園,2023-09-07,9189
3481,群創,30,0,30,群益金鼎-桃園,2023-09-07,9189
1802,台玻,42,13,29,群益金鼎-桃園,2023-09-07,9189
6414,樺漢,25,1,24,群益金鼎-桃園,2023-09-07,9189
2344,華邦電,28,4,24,群益金鼎-桃園,2023-09-07,9189
2002,中鋼,22,0,22,群益金鼎-桃園,2023-09-07,9189
6104,創惟,20,0,20,群益金鼎-桃園,2023-09-07,9189
00637L,元大滬深300正2,50,30,20,群益金鼎-桃園,2023-09-07,9189
00905,FT臺灣Smart,20,0,20,群益金鼎-桃園,2023-09-07,9189
1522,堤維西,20,1,19,群益金鼎-桃園,2023-09-07,9189
3231,緯創,21,3,18,群益金鼎-桃園,2023-09-07,9189
00919,群益台灣精選高息,69,52,17,群益金鼎-桃園,2023-09-07,9189
1611,中電,20,3,17,群益金鼎-桃園,2023-09-07,9189
3704,合勤控,36,21,15,群益金鼎-桃園,2023-09-07,9189
1616,億泰,15,0,15,群益金鼎-桃園,2023-09-07,9189
1513,中興電,15,1,14,群益金鼎-桃園,2023-09-07,9189
1314,中石化,14,0,14,群益金鼎-桃園,2023-09-07,9189
3037,欣興,16,2,14,群益金鼎-桃園,2023-09-07,9189
2880,華南金,14,0,14,群益金鼎-桃園,2023-09-07,9189
0056,元大高股息,52,39,13,群益金鼎-桃園,2023-09-07,9189
2610,華航,13,0,13,群益金鼎-桃園,2023-09-07,9189
1618,合機,15,3,12,群益金鼎-桃園,2023-09-07,9189
2609,陽明,13,1,12,群益金鼎-桃園,2023-09-07,9189
2883,凱基金,11,0,11,群益金鼎-桃園,2023-09-07,9189
3035,智原,49,39,10,群益金鼎-桃園,2023-09-07,9189
2308,台達電,10,0,10,群益金鼎-桃園,2023-09-07,9189
2801,彰銀,10,0,10,群益金鼎-桃園,2023-09-07,9189
2399,映泰,10,0,10,群益金鼎-桃園,2023-09-07,9189
2440,太空梭,10,0,10,群益金鼎-桃園,2023-09-07,9189
5302,太欣,10,0,10,群益金鼎-桃園,2023-09-07,9189
2204,中華,11,1,10,群益金鼎-桃園,2023-09-07,9189
3323,加百裕,12,2,10,群益金鼎-桃園,2023-09-07,9189
00931B,統一美債20年,9,0,9,群益金鼎-桃園,2023-09-07,9189
2492,華新科,9,0,9,群益金鼎-桃園,2023-09-07,9189
2486,一詮,26,17,9,群益金鼎-桃園,2023-09-07,9189
6138,茂達,24,15,9,群益金鼎-桃園,2023-09-07,9189
2614,東森,10,2,8,群益金鼎-桃園,2023-09-07,9189
4906,正文,8,0,8,群益金鼎-桃園,2023-09-07,9189
4147,中裕,11,3,8,群益金鼎-桃園,2023-09-07,9189
00923,群益台ESG低碳50,7,0,7,群益金鼎-桃園,2023-09-07,9189
2025,千興,270,0,270,群益金鼎-桃園,2023-09-08,9189
2010,春源,118,0,118,群益金鼎-桃園,2023-09-08,9189
00919,群益台灣精選高息,107,1,106,群益金鼎-桃園,2023-09-08,9189
4561,健椿,67,0,67,群益金鼎-桃園,2023-09-08,9189
00929,復華台灣科技優息,80,21,59,群益金鼎-桃園,2023-09-08,9189
1102,亞泥,34,0,34,群益金鼎-桃園,2023-09-08,9189
00673R,期元大S＆P原油反1,31,0,31,群益金鼎-桃園,2023-09-08,9189
4909,新復興,39,12,27,群益金鼎-桃園,2023-09-08,9189
1471,首利,54,27,27,群益金鼎-桃園,2023-09-08,9189
6114,久威,22,0,22,群益金鼎-桃園,2023-09-08,9189
2409,友達,24,3,21,群益金鼎-桃園,2023-09-08,9189
00692,富邦公司治理,20,0,20,群益金鼎-桃園,2023-09-08,9189
00752,中信中國50,20,0,20,群益金鼎-桃園,2023-09-08,9189
6173,信昌電,19,0,19,群益金鼎-桃園,2023-09-08,9189
3264,欣銓,23,4,19,群益金鼎-桃園,2023-09-08,9189
00932,兆豐永續高息等權,20,2,18,群益金鼎-桃園,2023-09-08,9189
6274,台燿,20,3,17,群益金鼎-桃園,2023-09-08,9189
2891,中信金,28,11,17,群益金鼎-桃園,2023-09-08,9189
2376,技嘉,34,18,16,群益金鼎-桃園,2023-09-08,9189
2330,台積電,16,0,16,群益金鼎-桃園,2023-09-08,9189
1603,華電,15,0,15,群益金鼎-桃園,2023-09-08,9189
3715,定穎投控,66,51,15,群益金鼎-桃園,2023-09-08,9189
3034,聯詠,21,7,14,群益金鼎-桃園,2023-09-08,9189
3686,達能,13,0,13,群益金鼎-桃園,2023-09-08,9189
2356,英業達,13,0,13,群益金鼎-桃園,2023-09-08,9189
6485,點序,12,0,12,群益金鼎-桃園,2023-09-08,9189
3711,日月光投控,12,0,12,群益金鼎-桃園,2023-09-08,9189
00687B,國泰20年美債,11,0,11,群益金鼎-桃園,2023-09-08,9189
00915,凱基優選高股息30,11,0,11,群益金鼎-桃園,2023-09-08,9189
8099,大世科,11,0,11,群益金鼎-桃園,2023-09-08,9189
00878,國泰永續高股息,13,3,10,群益金鼎-桃園,2023-09-08,9189
2630,亞航,31,21,10,群益金鼎-桃園,2023-09-08,9189
2014,中鴻,10,0,10,群益金鼎-桃園,2023-09-08,9189
3325,旭品,12,2,10,群益金鼎-桃園,2023-09-08,9189
2022,聚亨,10,0,10,群益金鼎-桃園,2023-09-08,9189
1402,遠東新,10,0,10,群益金鼎-桃園,2023-09-08,9189
2530,華建,10,0,10,群益金鼎-桃園,2023-09-08,9189
3702,大聯大,10,0,10,群益金鼎-桃園,2023-09-08,9189
6807,峰源-KY,9,0,9,群益金鼎-桃園,2023-09-08,9189
2313,華通,21,12,9,群益金鼎-桃園,2023-09-08,9189
2308,台達電,9,1,8,群益金鼎-桃園,2023-09-08,9189
3037,欣興,10,2,8,群益金鼎-桃園,2023-09-08,9189
4934,太極,10,2,8,群益金鼎-桃園,2023-09-08,9189
6165,浪凡,41,33,8,群益金鼎-桃園,2023-09-08,9189
3483,力致,14,6,8,群益金鼎-桃園,2023-09-08,9189
1101,台泥,8,0,8,群益金鼎-桃園,2023-09-08,9189
2355,敬鵬,13,6,7,群益金鼎-桃園,2023-09-08,9189
8112,至上,9,2,7,群益金鼎-桃園,2023-09-08,9189
2884,玉山金,7,0,7,群益金鼎-桃園,2023-09-08,9189
5880,合庫金,7,0,7,群益金鼎-桃園,2023-09-08,9189
00878,國泰永續高股息,322,20,302,群益金鼎-桃園,2023-09-11,9189
00919,群益台灣精選高息,119,4,115,群益金鼎-桃園,2023-09-11,9189
2010,春源,100,0,100,群益金鼎-桃園,2023-09-11,9189
0056,元大高股息,71,11,60,群益金鼎-桃園,2023-09-11,9189
2701,萬企,55,0,55,群益金鼎-桃園,2023-09-11,9189
6191,精成科,31,1,30,群益金鼎-桃園,2023-09-11,9189
00923,群益台ESG低碳50,30,0,30,群益金鼎-桃園,2023-09-11,9189
4909,新復興,30,0,30,群益金鼎-桃園,2023-09-11,9189
2201,裕隆,27,0,27,群益金鼎-桃園,2023-09-11,9189
2324,仁寶,30,4,26,群益金鼎-桃園,2023-09-11,9189
3025,星通,37,11,26,群益金鼎-桃園,2023-09-11,9189
3163,波若威,36,10,26,群益金鼎-桃園,2023-09-11,9189
1522,堤維西,40,14,26,群益金鼎-桃園,2023-09-11,9189
2368,金像電,28,3,25,群益金鼎-桃園,2023-09-11,9189
2888,新光金,32,8,24,群益金鼎-桃園,2023-09-11,9189
6104,創惟,23,0,23,群益金鼎-桃園,2023-09-11,9189
2405,輔信,114,91,23,群益金鼎-桃園,2023-09-11,9189
00915,凱基優選高股息30,22,0,22,群益金鼎-桃園,2023-09-11,9189
2312,金寶,22,1,21,群益金鼎-桃園,2023-09-11,9189
8033,雷虎,26,5,21,群益金鼎-桃園,2023-09-11,9189
2376,技嘉,36,15,21,群益金鼎-桃園,2023-09-11,9189
6288,聯嘉,20,0,20,群益金鼎-桃園,2023-09-11,9189
00918,大華優利高填息30,20,1,19,群益金鼎-桃園,2023-09-11,9189
2211,長榮鋼,16,0,16,群益金鼎-桃園,2023-09-11,9189
3362,先進光,17,1,16,群益金鼎-桃園,2023-09-11,9189
3231,緯創,73,57,16,群益金鼎-桃園,2023-09-11,9189
4938,和碩,16,1,15,群益金鼎-桃園,2023-09-11,9189
2358,廷鑫,19,4,15,群益金鼎-桃園,2023-09-11,9189
3078,僑威,31,16,15,群益金鼎-桃園,2023-09-11,9189
3265,台星科,15,1,14,群益金鼎-桃園,2023-09-11,9189
1605,華新,14,0,14,群益金鼎-桃園,2023-09-11,9189
2317,鴻海,14,1,13,群益金鼎-桃園,2023-09-11,9189
2486,一詮,13,0,13,群益金鼎-桃園,2023-09-11,9189
00679B,元大美債20年,13,0,13,群益金鼎-桃園,2023-09-11,9189
2610,華航,14,1,13,群益金鼎-桃園,2023-09-11,9189
2352,佳世達,17,5,12,群益金鼎-桃園,2023-09-11,9189
3038,全台,11,0,11,群益金鼎-桃園,2023-09-11,9189
00673R,期元大S＆P原油反1,11,0,11,群益金鼎-桃園,2023-09-11,9189
6125,廣運,12,1,11,群益金鼎-桃園,2023-09-11,9189
3035,智原,23,12,11,群益金鼎-桃園,2023-09-11,9189
00932,兆豐永續高息等權,11,1,10,群益金鼎-桃園,2023-09-11,9189
9938,百和,25,15,10,群益金鼎-桃園,2023-09-11,9189
4542,科嶠,10,0,10,群益金鼎-桃園,2023-09-11,9189
8076,伍豐,10,0,10,群益金鼎-桃園,2023-09-11,9189
8358,金居,11,1,10,群益金鼎-桃園,2023-09-11,9189
2891,中信金,16,7,9,群益金鼎-桃園,2023-09-11,9189
2887,台新金,9,0,9,群益金鼎-桃園,2023-09-11,9189
8048,德勝,10,1,9,群益金鼎-桃園,2023-09-11,9189
00753L,中信中國50正2,14,5,9,群益金鼎-桃園,2023-09-11,9189
2308,台達電,9,0,9,群益金鼎-桃園,2023-09-11,9189
00929,復華台灣科技優息,247,3,244,群益金鼎-桃園,2023-09-12,9189
2010,春源,100,0,100,群益金鼎-桃園,2023-09-12,9189
5483,中美晶,95,0,95,群益金鼎-桃園,2023-09-12,9189
00918,大華優利高填息30,53,0,53,群益金鼎-桃園,2023-09-12,9189
00673R,期元大S＆P原油反1,57,6,51,群益金鼎-桃園,2023-09-12,9189
3645,達邁,51,11,40,群益金鼎-桃園,2023-09-12,9189
4909,新復興,33,2,31,群益金鼎-桃園,2023-09-12,9189
2884,玉山金,36,5,31,群益金鼎-桃園,2023-09-12,9189
1471,首利,42,13,29,群益金鼎-桃園,2023-09-12,9189
2530,華建,28,0,28,群益金鼎-桃園,2023-09-12,9189
00919,群益台灣精選高息,30,3,27,群益金鼎-桃園,2023-09-12,9189
6282,康舒,36,13,23,群益金鼎-桃園,2023-09-12,9189
00915,凱基優選高股息30,20,0,20,群益金鼎-桃園,2023-09-12,9189
2002,中鋼,19,0,19,群益金鼎-桃園,2023-09-12,9189
3715,定穎投控,21,2,19,群益金鼎-桃園,2023-09-12,9189
2645,長榮航太,21,3,18,群益金鼎-桃園,2023-09-12,9189
6120,達運,21,3,18,群益金鼎-桃園,2023-09-12,9189
1584,精剛,26,10,16,群益金鼎-桃園,2023-09-12,9189
00881,國泰台灣5G+,24,8,16,群益金鼎-桃園,2023-09-12,9189
6841,長佳智能,15,0,15,群益金鼎-桃園,2023-09-12,9189
8069,元太,14,0,14,群益金鼎-桃園,2023-09-12,9189
00751B,元大AAA至A公司債,14,0,14,群益金鼎-桃園,2023-09-12,9189
2618,長榮航,46,33,13,群益金鼎-桃園,2023-09-12,9189
2390,云辰,13,0,13,群益金鼎-桃園,2023-09-12,9189
00900,富邦特選高股息30,13,0,13,群益金鼎-桃園,2023-09-12,9189
2538,基泰,18,6,12,群益金鼎-桃園,2023-09-12,9189
1319,東陽,35,23,12,群益金鼎-桃園,2023-09-12,9189
4908,前鼎,18,6,12,群益金鼎-桃園,2023-09-12,9189
8215,明基材,12,0,12,群益金鼎-桃園,2023-09-12,9189
00632R,元大台灣50反1,18,8,10,群益金鼎-桃園,2023-09-12,9189
00720B,元大投資級公司債,10,0,10,群益金鼎-桃園,2023-09-12,9189
00882,中信中國高股息,10,0,10,群益金鼎-桃園,2023-09-12,9189
1905,華紙,10,0,10,群益金鼎-桃園,2023-09-12,9189
2903,遠百,10,0,10,群益金鼎-桃園,2023-09-12,9189
3617,碩天,10,0,10,群益金鼎-桃園,2023-09-12,9189
1309,台達化,10,0,10,群益金鼎-桃園,2023-09-12,9189
9934,成霖,10,0,10,群益金鼎-桃園,2023-09-12,9189
4744,皇將,10,0,10,群益金鼎-桃園,2023-09-12,9189
3078,僑威,31,22,9,群益金鼎-桃園,2023-09-12,9189
00664R,國泰臺灣加權反1,8,0,8,群益金鼎-桃園,2023-09-12,9189
2331,精英,9,1,8,群益金鼎-桃園,2023-09-12,9189
6116,彩晶,8,0,8,群益金鼎-桃園,2023-09-12,9189
2436,偉詮電,16,8,8,群益金鼎-桃園,2023-09-12,9189
6605,帝寶,13,5,8,群益金鼎-桃園,2023-09-12,9189
6139,亞翔,8,0,8,群益金鼎-桃園,2023-09-12,9189
8996,高力,9,1,8,群益金鼎-桃園,2023-09-12,9189
6125,廣運,22,15,7,群益金鼎-桃園,2023-09-12,9189
00679B,元大美債20年,7,0,7,群益金鼎-桃園,2023-09-12,9189
2402,毅嘉,22,16,6,群益金鼎-桃園,2023-09-12,9189
4977,眾達-KY,8,2,6,群益金鼎-桃園,2023-09-12,9189
2010,春源,90,0,90,群益金鼎-桃園,2023-09-13,9189
00919,群益台灣精選高息,69,0,69,群益金鼎-桃園,2023-09-13,9189
2399,映泰,61,1,60,群益金鼎-桃園,2023-09-13,9189
00752,中信中國50,50,0,50,群益金鼎-桃園,2023-09-13,9189
00929,復華台灣科技優息,43,11,32,群益金鼎-桃園,2023-09-13,9189
5009,榮剛,46,18,28,群益金鼎-桃園,2023-09-13,9189
1471,首利,41,13,28,群益金鼎-桃園,2023-09-13,9189
2025,千興,43,15,28,群益金鼎-桃園,2023-09-13,9189
2355,敬鵬,50,23,27,群益金鼎-桃園,2023-09-13,9189
2425,承啟,24,0,24,群益金鼎-桃園,2023-09-13,9189
00878,國泰永續高股息,33,9,24,群益金鼎-桃園,2023-09-13,9189
2301,光寶科,35,12,23,群益金鼎-桃園,2023-09-13,9189
1324,地球,25,2,23,群益金鼎-桃園,2023-09-13,9189
2374,佳能,25,3,22,群益金鼎-桃園,2023-09-13,9189
00918,大華優利高填息30,20,0,20,群益金鼎-桃園,2023-09-13,9189
2332,友訊,20,0,20,群益金鼎-桃園,2023-09-13,9189
00864B,中信美國公債0-1,20,0,20,群益金鼎-桃園,2023-09-13,9189
3450,聯鈞,20,1,19,群益金鼎-桃園,2023-09-13,9189
2371,大同,35,18,17,群益金鼎-桃園,2023-09-13,9189
3711,日月光投控,17,0,17,群益金鼎-桃園,2023-09-13,9189
3346,麗清,34,17,17,群益金鼎-桃園,2023-09-13,9189
00632R,元大台灣50反1,33,19,14,群益金鼎-桃園,2023-09-13,9189
2020,美亞,18,4,14,群益金鼎-桃園,2023-09-13,9189
3264,欣銓,14,2,12,群益金鼎-桃園,2023-09-13,9189
2634,漢翔,12,0,12,群益金鼎-桃園,2023-09-13,9189
1314,中石化,12,0,12,群益金鼎-桃園,2023-09-13,9189
1319,東陽,83,71,12,群益金鼎-桃園,2023-09-13,9189
4721,美琪瑪,12,1,11,群益金鼎-桃園,2023-09-13,9189
00922,國泰台灣領袖50,11,0,11,群益金鼎-桃園,2023-09-13,9189
2731,雄獅,11,0,11,群益金鼎-桃園,2023-09-13,9189
6125,廣運,22,11,11,群益金鼎-桃園,2023-09-13,9189
6547,高端疫苗,13,3,10,群益金鼎-桃園,2023-09-13,9189
9927,泰銘,10,0,10,群益金鼎-桃園,2023-09-13,9189
4934,太極,10,0,10,群益金鼎-桃園,2023-09-13,9189
2615,萬海,10,0,10,群益金鼎-桃園,2023-09-13,9189
3006,晶豪科,11,1,10,群益金鼎-桃園,2023-09-13,9189
00900,富邦特選高股息30,10,0,10,群益金鼎-桃園,2023-09-13,9189
00932,兆豐永續高息等權,10,1,9,群益金鼎-桃園,2023-09-13,9189
2409,友達,9,0,9,群益金鼎-桃園,2023-09-13,9189
00673R,期元大S＆P原油反1,13,5,8,群益金鼎-桃園,2023-09-13,9189
2201,裕隆,11,3,8,群益金鼎-桃園,2023-09-13,9189
1809,中釉,10,2,8,群益金鼎-桃園,2023-09-13,9189
2427,三商電,11,3,8,群益金鼎-桃園,2023-09-13,9189
0056,元大高股息,7,0,7,群益金鼎-桃園,2023-09-13,9189
4561,健椿,7,0,7,群益金鼎-桃園,2023-09-13,9189
00902,中信電池及儲能,7,0,7,群益金鼎-桃園,2023-09-13,9189
4114,健喬,7,0,7,群益金鼎-桃園,2023-09-13,9189
2368,金像電,6,0,6,群益金鼎-桃園,2023-09-13,9189
2618,長榮航,8,2,6,群益金鼎-桃園,2023-09-13,9189
2352,佳世達,13,7,6,群益金鼎-桃園,2023-09-13,9189
00929,復華台灣科技優息,157,6,151,群益金鼎-桃園,2023-09-14,9189
2010,春源,120,0,120,群益金鼎-桃園,2023-09-14,9189
2637,慧洋-KY,104,29,75,群益金鼎-桃園,2023-09-14,9189
2312,金寶,61,0,61,群益金鼎-桃園,2023-09-14,9189
00632R,元大台灣50反1,55,0,55,群益金鼎-桃園,2023-09-14,9189
00919,群益台灣精選高息,65,32,33,群益金鼎-桃園,2023-09-14,9189
1101,台泥,36,11,25,群益金鼎-桃園,2023-09-14,9189
00915,凱基優選高股息30,24,0,24,群益金鼎-桃園,2023-09-14,9189
2371,大同,25,2,23,群益金鼎-桃園,2023-09-14,9189
6288,聯嘉,25,3,22,群益金鼎-桃園,2023-09-14,9189
3078,僑威,26,4,22,群益金鼎-桃園,2023-09-14,9189
3005,神基,25,3,22,群益金鼎-桃園,2023-09-14,9189
5426,振發,22,0,22,群益金鼎-桃園,2023-09-14,9189
3025,星通,52,31,21,群益金鼎-桃園,2023-09-14,9189
6122,擎邦,20,1,19,群益金鼎-桃園,2023-09-14,9189
2402,毅嘉,17,0,17,群益金鼎-桃園,2023-09-14,9189
8048,德勝,43,27,16,群益金鼎-桃園,2023-09-14,9189
00878,國泰永續高股息,45,30,15,群益金鼎-桃園,2023-09-14,9189
3014,聯陽,20,6,14,群益金鼎-桃園,2023-09-14,9189
00885,富邦越南,15,1,14,群益金鼎-桃園,2023-09-14,9189
4977,眾達-KY,21,8,13,群益金鼎-桃園,2023-09-14,9189
2392,正崴,13,0,13,群益金鼎-桃園,2023-09-14,9189
2515,中工,12,0,12,群益金鼎-桃園,2023-09-14,9189
00673R,期元大S＆P原油反1,12,0,12,群益金鼎-桃園,2023-09-14,9189
3094,聯傑,13,1,12,群益金鼎-桃園,2023-09-14,9189
2313,華通,38,26,12,群益金鼎-桃園,2023-09-14,9189
2731,雄獅,11,0,11,群益金鼎-桃園,2023-09-14,9189
2913,農林,11,0,11,群益金鼎-桃園,2023-09-14,9189
6426,統新,20,9,11,群益金鼎-桃園,2023-09-14,9189
2485,兆赫,12,1,11,群益金鼎-桃園,2023-09-14,9189
2634,漢翔,18,8,10,群益金鼎-桃園,2023-09-14,9189
2022,聚亨,10,0,10,群益金鼎-桃園,2023-09-14,9189
5328,華容,10,0,10,群益金鼎-桃園,2023-09-14,9189
00928,中信上櫃ESG30,10,0,10,群益金鼎-桃園,2023-09-14,9189
2881,富邦金,10,0,10,群益金鼎-桃園,2023-09-14,9189
2332,友訊,20,10,10,群益金鼎-桃園,2023-09-14,9189
2025,千興,10,0,10,群益金鼎-桃園,2023-09-14,9189
8936,國統,10,0,10,群益金鼎-桃園,2023-09-14,9189
4967,十銓,16,7,9,群益金鼎-桃園,2023-09-14,9189
2374,佳能,11,2,9,群益金鼎-桃園,2023-09-14,9189
5469,瀚宇博,12,3,9,群益金鼎-桃園,2023-09-14,9189
2228,劍麟,10,1,9,群益金鼎-桃園,2023-09-14,9189
00664R,國泰臺灣加權反1,8,0,8,群益金鼎-桃園,2023-09-14,9189
2301,光寶科,17,9,8,群益金鼎-桃園,2023-09-14,9189
5450,南良,10,2,8,群益金鼎-桃園,2023-09-14,9189
3591,艾笛森,7,0,7,群益金鼎-桃園,2023-09-14,9189
00637L,元大滬深300正2,7,0,7,群益金鼎-桃園,2023-09-14,9189
00917,中信特選金融,7,0,7,群益金鼎-桃園,2023-09-14,9189
3704,合勤控,17,11,6,群益金鼎-桃園,2023-09-14,9189
1471,首利,8,2,6,群益金鼎-桃園,2023-09-14,9189
2610,華航,200,3,197,群益金鼎-桃園,2023-09-15,9189
00929,復華台灣科技優息,159,8,151,群益金鼎-桃園,2023-09-15,9189
2605,新興,172,30,142,群益金鼎-桃園,2023-09-15,9189
2891,中信金,124,12,112,群益金鼎-桃園,2023-09-15,9189
2010,春源,100,0,100,群益金鼎-桃園,2023-09-15,9189
1815,富喬,47,0,47,群益金鼎-桃園,2023-09-15,9189
2637,慧洋-KY,110,68,42,群益金鼎-桃園,2023-09-15,9189
2606,裕民,45,8,37,群益金鼎-桃園,2023-09-15,9189
2880,華南金,35,1,34,群益金鼎-桃園,2023-09-15,9189
1611,中電,29,0,29,群益金鼎-桃園,2023-09-15,9189
4909,新復興,30,2,28,群益金鼎-桃園,2023-09-15,9189
2316,楠梓電,27,0,27,群益金鼎-桃園,2023-09-15,9189
2331,精英,30,3,27,群益金鼎-桃園,2023-09-15,9189
2402,毅嘉,35,10,25,群益金鼎-桃園,2023-09-15,9189
00679B,元大美債20年,23,0,23,群益金鼎-桃園,2023-09-15,9189
3042,晶技,22,0,22,群益金鼎-桃園,2023-09-15,9189
2002,中鋼,30,9,21,群益金鼎-桃園,2023-09-15,9189
2312,金寶,21,0,21,群益金鼎-桃園,2023-09-15,9189
3163,波若威,64,43,21,群益金鼎-桃園,2023-09-15,9189
2486,一詮,80,60,20,群益金鼎-桃園,2023-09-15,9189
5469,瀚宇博,20,0,20,群益金鼎-桃園,2023-09-15,9189
2352,佳世達,22,3,19,群益金鼎-桃園,2023-09-15,9189
00919,群益台灣精選高息,96,77,19,群益金鼎-桃園,2023-09-15,9189
1339,昭輝,18,0,18,群益金鼎-桃園,2023-09-15,9189
00673R,期元大S＆P原油反1,63,45,18,群益金鼎-桃園,2023-09-15,9189
00931B,統一美債20年,18,0,18,群益金鼎-桃園,2023-09-15,9189
2027,大成鋼,23,5,18,群益金鼎-桃園,2023-09-15,9189
6257,矽格,19,4,15,群益金鼎-桃園,2023-09-15,9189
2337,旺宏,22,7,15,群益金鼎-桃園,2023-09-15,9189
3022,威強電,15,1,14,群益金鼎-桃園,2023-09-15,9189
2618,長榮航,15,3,12,群益金鼎-桃園,2023-09-15,9189
3380,明泰,13,1,12,群益金鼎-桃園,2023-09-15,9189
00885,富邦越南,11,0,11,群益金鼎-桃園,2023-09-15,9189
1802,台玻,11,0,11,群益金鼎-桃園,2023-09-15,9189
5340,建榮,11,0,11,群益金鼎-桃園,2023-09-15,9189
2329,華泰,14,3,11,群益金鼎-桃園,2023-09-15,9189
2328,廣宇,11,0,11,群益金鼎-桃園,2023-09-15,9189
3481,群創,10,0,10,群益金鼎-桃園,2023-09-15,9189
1447,力鵬,10,0,10,群益金鼎-桃園,2023-09-15,9189
4402,郡都開發,10,0,10,群益金鼎-桃園,2023-09-15,9189
2615,萬海,11,1,10,群益金鼎-桃園,2023-09-15,9189
6770,力積電,10,0,10,群益金鼎-桃園,2023-09-15,9189
3231,緯創,25,16,9,群益金鼎-桃園,2023-09-15,9189
1536,和大,10,1,9,群益金鼎-桃園,2023-09-15,9189
1710,東聯,10,1,9,群益金鼎-桃園,2023-09-15,9189
6125,廣運,17,8,9,群益金鼎-桃園,2023-09-15,9189
2641,正德,50,41,9,群益金鼎-桃園,2023-09-15,9189
3035,智原,27,18,9,群益金鼎-桃園,2023-09-15,9189
2014,中鴻,13,5,8,群益金鼎-桃園,2023-09-15,9189
3363,上詮,23,15,8,群益金鼎-桃園,2023-09-15,9189
1815,富喬,318,4,314,群益金鼎-桃園,2023-09-18,9189
2025,千興,315,26,289,群益金鼎-桃園,2023-09-18,9189
2363,矽統,291,55,236,群益金鼎-桃園,2023-09-18,9189
00919,群益台灣精選高息,249,19,230,群益金鼎-桃園,2023-09-18,9189
00929,復華台灣科技優息,155,41,114,群益金鼎-桃園,2023-09-18,9189
2606,裕民,93,7,86,群益金鼎-桃園,2023-09-18,9189
2440,太空梭,60,0,60,群益金鼎-桃園,2023-09-18,9189
3276,宇環,109,54,55,群益金鼎-桃園,2023-09-18,9189
00878,國泰永續高股息,66,12,54,群益金鼎-桃園,2023-09-18,9189
3037,欣興,55,15,40,群益金鼎-桃園,2023-09-18,9189
3231,緯創,45,5,40,群益金鼎-桃園,2023-09-18,9189
00752,中信中國50,30,0,30,群益金鼎-桃園,2023-09-18,9189
2883,凱基金,32,3,29,群益金鼎-桃園,2023-09-18,9189
00772B,中信高評級公司債,26,0,26,群益金鼎-桃園,2023-09-18,9189
00679B,元大美債20年,23,0,23,群益金鼎-桃園,2023-09-18,9189
2330,台積電,23,0,23,群益金鼎-桃園,2023-09-18,9189
8112,至上,22,0,22,群益金鼎-桃園,2023-09-18,9189
2332,友訊,22,0,22,群益金鼎-桃園,2023-09-18,9189
00915,凱基優選高股息30,20,0,20,群益金鼎-桃園,2023-09-18,9189
3715,定穎投控,64,44,20,群益金鼎-桃園,2023-09-18,9189
2368,金像電,20,0,20,群益金鼎-桃園,2023-09-18,9189
2425,承啟,20,2,18,群益金鼎-桃園,2023-09-18,9189
00931B,統一美債20年,16,0,16,群益金鼎-桃園,2023-09-18,9189
6282,康舒,18,2,16,群益金鼎-桃園,2023-09-18,9189
0056,元大高股息,16,2,14,群益金鼎-桃園,2023-09-18,9189
00687B,國泰20年美債,14,0,14,群益金鼎-桃園,2023-09-18,9189
00893,國泰智能電動車,14,0,14,群益金鼎-桃園,2023-09-18,9189
00918,大華優利高填息30,13,0,13,群益金鼎-桃園,2023-09-18,9189
8088,品安,16,3,13,群益金鼎-桃園,2023-09-18,9189
1522,堤維西,18,6,12,群益金鼎-桃園,2023-09-18,9189
2382,廣達,17,5,12,群益金鼎-桃園,2023-09-18,9189
3163,波若威,17,6,11,群益金鼎-桃園,2023-09-18,9189
8040,九暘,12,1,11,群益金鼎-桃園,2023-09-18,9189
00885,富邦越南,11,0,11,群益金鼎-桃園,2023-09-18,9189
3694,海華,12,1,11,群益金鼎-桃園,2023-09-18,9189
8171,天宇,11,0,11,群益金鼎-桃園,2023-09-18,9189
2356,英業達,12,1,11,群益金鼎-桃園,2023-09-18,9189
3044,健鼎,13,2,11,群益金鼎-桃園,2023-09-18,9189
2388,威盛,25,15,10,群益金鼎-桃園,2023-09-18,9189
00653L,富邦印度正2,10,0,10,群益金鼎-桃園,2023-09-18,9189
1108,幸福,10,0,10,群益金鼎-桃園,2023-09-18,9189
00637L,元大滬深300正2,10,0,10,群益金鼎-桃園,2023-09-18,9189
2610,華航,10,0,10,群益金鼎-桃園,2023-09-18,9189
6233,旺玖,11,1,10,群益金鼎-桃園,2023-09-18,9189
1402,遠東新,10,0,10,群益金鼎-桃園,2023-09-18,9189
4114,健喬,9,0,9,群益金鼎-桃園,2023-09-18,9189
6189,豐藝,14,5,9,群益金鼎-桃園,2023-09-18,9189
2317,鴻海,8,0,8,群益金鼎-桃園,2023-09-18,9189
3058,立德,12,4,8,群益金鼎-桃園,2023-09-18,9189
1471,首利,11,3,8,群益金鼎-桃園,2023-09-18,9189
00907,永豐優息存股,120,0,120,群益金鼎-桃園,2023-09-19,9189
1504,東元,115,3,112,群益金鼎-桃園,2023-09-19,9189
2641,正德,100,2,98,群益金鼎-桃園,2023-09-19,9189
00919,群益台灣精選高息,61,0,61,群益金鼎-桃園,2023-09-19,9189
4909,新復興,43,0,43,群益金鼎-桃園,2023-09-19,9189
5381,合正,56,14,42,群益金鼎-桃園,2023-09-19,9189
4714,永捷,43,1,42,群益金鼎-桃園,2023-09-19,9189
2409,友達,33,2,31,群益金鼎-桃園,2023-09-19,9189
00887,永豐中國科技50大,30,0,30,群益金鼎-桃園,2023-09-19,9189
00632R,元大台灣50反1,64,35,29,群益金鼎-桃園,2023-09-19,9189
00881,國泰台灣5G+,29,0,29,群益金鼎-桃園,2023-09-19,9189
1319,東陽,40,13,27,群益金鼎-桃園,2023-09-19,9189
2610,華航,26,1,25,群益金鼎-桃園,2023-09-19,9189
8112,至上,26,4,22,群益金鼎-桃園,2023-09-19,9189
4979,華星光,21,1,20,群益金鼎-桃園,2023-09-19,9189
3163,波若威,67,48,19,群益金鼎-桃園,2023-09-19,9189
2312,金寶,22,3,19,群益金鼎-桃園,2023-09-19,9189
00900,富邦特選高股息30,17,0,17,群益金鼎-桃園,2023-09-19,9189
00679B,元大美債20年,15,0,15,群益金鼎-桃園,2023-09-19,9189
00921,兆豐龍頭等權重,14,0,14,群益金鼎-桃園,2023-09-19,9189
8086,宏捷科,13,0,13,群益金鼎-桃園,2023-09-19,9189
00932,兆豐永續高息等權,13,0,13,群益金鼎-桃園,2023-09-19,9189
2425,承啟,33,21,12,群益金鼎-桃園,2023-09-19,9189
2436,偉詮電,27,15,12,群益金鼎-桃園,2023-09-19,9189
2344,華邦電,20,9,11,群益金鼎-桃園,2023-09-19,9189
6770,力積電,10,0,10,群益金鼎-桃園,2023-09-19,9189
2330,台積電,10,0,10,群益金鼎-桃園,2023-09-19,9189
00877,復華中國5G,10,0,10,群益金鼎-桃園,2023-09-19,9189
1589,永冠-KY,10,0,10,群益金鼎-桃園,2023-09-19,9189
2356,英業達,12,2,10,群益金鼎-桃園,2023-09-19,9189
3022,威強電,17,7,10,群益金鼎-桃園,2023-09-19,9189
2883,凱基金,11,1,10,群益金鼎-桃園,2023-09-19,9189
3325,旭品,10,1,9,群益金鼎-桃園,2023-09-19,9189
2392,正崴,17,8,9,群益金鼎-桃園,2023-09-19,9189
1515,力山,10,1,9,群益金鼎-桃園,2023-09-19,9189
6288,聯嘉,9,0,9,群益金鼎-桃園,2023-09-19,9189
6756,威鋒電子,9,0,9,群益金鼎-桃園,2023-09-19,9189
2401,凌陽,12,3,9,群益金鼎-桃園,2023-09-19,9189
3231,緯創,38,30,8,群益金鼎-桃園,2023-09-19,9189
2618,長榮航,18,10,8,群益金鼎-桃園,2023-09-19,9189
00885,富邦越南,13,5,8,群益金鼎-桃園,2023-09-19,9189
1605,華新,10,2,8,群益金鼎-桃園,2023-09-19,9189
8016,矽創,14,6,8,群益金鼎-桃園,2023-09-19,9189
0056,元大高股息,10,2,8,群益金鼎-桃園,2023-09-19,9189
00673R,期元大S＆P原油反1,7,0,7,群益金鼎-桃園,2023-09-19,9189
3081,聯亞,14,7,7,群益金鼎-桃園,2023-09-19,9189
6577,勁豐,7,0,7,群益金鼎-桃園,2023-09-19,9189
3058,立德,7,0,7,群益金鼎-桃園,2023-09-19,9189
3576,聯合再生,6,0,6,群益金鼎-桃園,2023-09-19,9189
6189,豐藝,6,0,6,群益金鼎-桃園,2023-09-19,9189
00929,復華台灣科技優息,195,54,141,群益金鼎-桃園,2023-09-20,9189
2367,燿華,387,337,50,群益金鼎-桃園,2023-09-20,9189
00919,群益台灣精選高息,43,8,35,群益金鼎-桃園,2023-09-20,9189
1611,中電,35,0,35,群益金鼎-桃園,2023-09-20,9189
3163,波若威,61,30,31,群益金鼎-桃園,2023-09-20,9189
2449,京元電子,45,14,31,群益金鼎-桃園,2023-09-20,9189
6841,長佳智能,31,1,30,群益金鼎-桃園,2023-09-20,9189
4552,力達-KY,30,0,30,群益金鼎-桃園,2023-09-20,9189
00673R,期元大S＆P原油反1,38,8,30,群益金鼎-桃園,2023-09-20,9189
00679B,元大美債20年,29,0,29,群益金鼎-桃園,2023-09-20,9189
3265,台星科,51,24,27,群益金鼎-桃園,2023-09-20,9189
4739,康普,24,0,24,群益金鼎-桃園,2023-09-20,9189
0050,元大台灣50,24,2,22,群益金鼎-桃園,2023-09-20,9189
2883,凱基金,22,0,22,群益金鼎-桃園,2023-09-20,9189
2316,楠梓電,21,0,21,群益金鼎-桃園,2023-09-20,9189
3706,神達,29,9,20,群益金鼎-桃園,2023-09-20,9189
2890,永豐金,20,0,20,群益金鼎-桃園,2023-09-20,9189
4123,晟德,20,0,20,群益金鼎-桃園,2023-09-20,9189
3037,欣興,25,6,19,群益金鼎-桃園,2023-09-20,9189
6191,精成科,20,1,19,群益金鼎-桃園,2023-09-20,9189
1815,富喬,19,0,19,群益金鼎-桃園,2023-09-20,9189
2324,仁寶,24,5,19,群益金鼎-桃園,2023-09-20,9189
3036,文曄,43,25,18,群益金鼎-桃園,2023-09-20,9189
3060,銘異,20,2,18,群益金鼎-桃園,2023-09-20,9189
3260,威剛,25,7,18,群益金鼎-桃園,2023-09-20,9189
00881,國泰台灣5G+,21,3,18,群益金鼎-桃園,2023-09-20,9189
8046,南電,23,5,18,群益金鼎-桃園,2023-09-20,9189
4909,新復興,30,13,17,群益金鼎-桃園,2023-09-20,9189
3024,憶聲,14,0,14,群益金鼎-桃園,2023-09-20,9189
3034,聯詠,13,0,13,群益金鼎-桃園,2023-09-20,9189
2388,威盛,14,1,13,群益金鼎-桃園,2023-09-20,9189
8064,東捷,20,7,13,群益金鼎-桃園,2023-09-20,9189
1808,潤隆,13,0,13,群益金鼎-桃園,2023-09-20,9189
6122,擎邦,13,0,13,群益金鼎-桃園,2023-09-20,9189
2330,台積電,13,1,12,群益金鼎-桃園,2023-09-20,9189
00922,國泰台灣領袖50,12,0,12,群益金鼎-桃園,2023-09-20,9189
2023,燁輝,12,0,12,群益金鼎-桃園,2023-09-20,9189
2610,華航,12,0,12,群益金鼎-桃園,2023-09-20,9189
2609,陽明,27,16,11,群益金鼎-桃園,2023-09-20,9189
6770,力積電,10,0,10,群益金鼎-桃園,2023-09-20,9189
9105,泰金寶-DR,10,0,10,群益金鼎-桃園,2023-09-20,9189
00907,永豐優息存股,11,1,10,群益金鼎-桃園,2023-09-20,9189
1605,華新,12,2,10,群益金鼎-桃園,2023-09-20,9189
2505,國揚,10,0,10,群益金鼎-桃園,2023-09-20,9189
2465,麗臺,10,0,10,群益金鼎-桃園,2023-09-20,9189
3264,欣銓,12,2,10,群益金鼎-桃園,2023-09-20,9189
1101,台泥,9,0,9,群益金鼎-桃園,2023-09-20,9189
2929,淘帝-KY,9,0,9,群益金鼎-桃園,2023-09-20,9189
6235,華孚,13,4,9,群益金鼎-桃園,2023-09-20,9189
6223,旺矽,12,3,9,群益金鼎-桃園,2023-09-20,9189
00665L,富邦�琤肭磪囓�2,300,0,300,群益金鼎-桃園,2023-09-21,9189
2641,正德,203,5,198,群益金鼎-桃園,2023-09-21,9189
2891,中信金,139,0,139,群益金鼎-桃園,2023-09-21,9189
00679B,元大美債20年,126,1,125,群益金鼎-桃園,2023-09-21,9189
1815,富喬,114,4,110,群益金鼎-桃園,2023-09-21,9189
00929,復華台灣科技優息,251,152,99,群益金鼎-桃園,2023-09-21,9189
00878,國泰永續高股息,95,28,67,群益金鼎-桃園,2023-09-21,9189
00673R,期元大S＆P原油反1,54,3,51,群益金鼎-桃園,2023-09-21,9189
2102,泰豐,50,0,50,群益金鼎-桃園,2023-09-21,9189
3545,敦泰,53,3,50,群益金鼎-桃園,2023-09-21,9189
00931B,統一美債20年,43,0,43,群益金鼎-桃園,2023-09-21,9189
00919,群益台灣精選高息,37,2,35,群益金鼎-桃園,2023-09-21,9189
0056,元大高股息,36,4,32,群益金鼎-桃園,2023-09-21,9189
2888,新光金,32,0,32,群益金鼎-桃園,2023-09-21,9189
3450,聯鈞,73,41,32,群益金鼎-桃園,2023-09-21,9189
0050,元大台灣50,32,2,30,群益金鼎-桃園,2023-09-21,9189
2884,玉山金,30,0,30,群益金鼎-桃園,2023-09-21,9189
6191,精成科,22,0,22,群益金鼎-桃園,2023-09-21,9189
2317,鴻海,23,1,22,群益金鼎-桃園,2023-09-21,9189
2816,旺旺保,21,0,21,群益金鼎-桃園,2023-09-21,9189
5880,合庫金,21,0,21,群益金鼎-桃園,2023-09-21,9189
00692,富邦公司治理,20,0,20,群益金鼎-桃園,2023-09-21,9189
1611,中電,20,0,20,群益金鼎-桃園,2023-09-21,9189
2820,華票,20,0,20,群益金鼎-桃園,2023-09-21,9189
2330,台積電,25,5,20,群益金鼎-桃園,2023-09-21,9189
00923,群益台ESG低碳50,17,0,17,群益金鼎-桃園,2023-09-21,9189
2459,敦吉,16,0,16,群益金鼎-桃園,2023-09-21,9189
2002,中鋼,15,0,15,群益金鼎-桃園,2023-09-21,9189
2014,中鴻,15,0,15,群益金鼎-桃園,2023-09-21,9189
1101,台泥,14,0,14,群益金鼎-桃園,2023-09-21,9189
2892,第一金,13,0,13,群益金鼎-桃園,2023-09-21,9189
006208,富邦台50,13,0,13,群益金鼎-桃園,2023-09-21,9189
3035,智原,31,19,12,群益金鼎-桃園,2023-09-21,9189
2903,遠百,12,0,12,群益金鼎-桃園,2023-09-21,9189
5328,華容,12,0,12,群益金鼎-桃園,2023-09-21,9189
00671R,富邦NASDAQ反1,12,0,12,群益金鼎-桃園,2023-09-21,9189
3025,星通,12,0,12,群益金鼎-桃園,2023-09-21,9189
8034,榮群,13,1,12,群益金鼎-桃園,2023-09-21,9189
2880,華南金,12,0,12,群益金鼎-桃園,2023-09-21,9189
3706,神達,16,4,12,群益金鼎-桃園,2023-09-21,9189
3005,神基,16,4,12,群益金鼎-桃園,2023-09-21,9189
2801,彰銀,11,0,11,群益金鼎-桃園,2023-09-21,9189
00795B,中信美國公債20年,11,0,11,群益金鼎-桃園,2023-09-21,9189
1609,大亞,11,0,11,群益金鼎-桃園,2023-09-21,9189
00881,國泰台灣5G+,14,3,11,群益金鼎-桃園,2023-09-21,9189
00932,兆豐永續高息等權,12,1,11,群益金鼎-桃園,2023-09-21,9189
6120,達運,11,0,11,群益金鼎-桃園,2023-09-21,9189
8358,金居,11,0,11,群益金鼎-桃園,2023-09-21,9189
00713,元大台灣高息低波,11,0,11,群益金鼎-桃園,2023-09-21,9189
00753L,中信中國50正2,11,1,10,群益金鼎-桃園,2023-09-21,9189
00679B,元大美債20年,186,1,185,群益金鼎-桃園,2023-09-22,9189
2610,華航,102,0,102,群益金鼎-桃園,2023-09-22,9189
2618,長榮航,81,6,75,群益金鼎-桃園,2023-09-22,9189
2845,遠東銀,60,0,60,群益金鼎-桃園,2023-09-22,9189
2323,中環,50,0,50,群益金鼎-桃園,2023-09-22,9189
2324,仁寶,52,3,49,群益金鼎-桃園,2023-09-22,9189
3265,台星科,45,5,40,群益金鼎-桃園,2023-09-22,9189
00929,復華台灣科技優息,108,69,39,群益金鼎-桃園,2023-09-22,9189
1319,東陽,38,0,38,群益金鼎-桃園,2023-09-22,9189
00680L,元大美債20正2,35,0,35,群益金鼎-桃園,2023-09-22,9189
2887,台新金,30,0,30,群益金鼎-桃園,2023-09-22,9189
00687B,國泰20年美債,29,0,29,群益金鼎-桃園,2023-09-22,9189
00885,富邦越南,29,1,28,群益金鼎-桃園,2023-09-22,9189
5469,瀚宇博,27,0,27,群益金鼎-桃園,2023-09-22,9189
00919,群益台灣精選高息,36,10,26,群益金鼎-桃園,2023-09-22,9189
4908,前鼎,68,42,26,群益金鼎-桃園,2023-09-22,9189
00673R,期元大S＆P原油反1,26,0,26,群益金鼎-桃園,2023-09-22,9189
6153,嘉聯益,25,1,24,群益金鼎-桃園,2023-09-22,9189
00772B,中信高評級公司債,24,1,23,群益金鼎-桃園,2023-09-22,9189
1101,台泥,23,0,23,群益金鼎-桃園,2023-09-22,9189
6142,友勁,23,0,23,群益金鼎-桃園,2023-09-22,9189
3450,聯鈞,98,75,23,群益金鼎-桃園,2023-09-22,9189
2605,新興,23,1,22,群益金鼎-桃園,2023-09-22,9189
6139,亞翔,21,1,20,群益金鼎-桃園,2023-09-22,9189
2102,泰豐,20,0,20,群益金鼎-桃園,2023-09-22,9189
00795B,中信美國公債20年,19,0,19,群益金鼎-桃園,2023-09-22,9189
1802,台玻,19,0,19,群益金鼎-桃園,2023-09-22,9189
2606,裕民,16,0,16,群益金鼎-桃園,2023-09-22,9189
2880,華南金,16,0,16,群益金鼎-桃園,2023-09-22,9189
6901,鑽石投資,21,6,15,群益金鼎-桃園,2023-09-22,9189
6141,柏承,14,0,14,群益金鼎-桃園,2023-09-22,9189
1444,力麗,18,5,13,群益金鼎-桃園,2023-09-22,9189
2401,凌陽,12,0,12,群益金鼎-桃園,2023-09-22,9189
2883,凱基金,12,0,12,群益金鼎-桃園,2023-09-22,9189
00751B,元大AAA至A公司債,12,0,12,群益金鼎-桃園,2023-09-22,9189
8034,榮群,14,3,11,群益金鼎-桃園,2023-09-22,9189
00878,國泰永續高股息,10,0,10,群益金鼎-桃園,2023-09-22,9189
2834,臺企銀,10,0,10,群益金鼎-桃園,2023-09-22,9189
2891,中信金,11,1,10,群益金鼎-桃園,2023-09-22,9189
2816,旺旺保,12,2,10,群益金鼎-桃園,2023-09-22,9189
1701,中化,10,0,10,群益金鼎-桃園,2023-09-22,9189
2801,彰銀,10,0,10,群益金鼎-桃園,2023-09-22,9189
1102,亞泥,10,0,10,群益金鼎-桃園,2023-09-22,9189
1815,富喬,22,12,10,群益金鼎-桃園,2023-09-22,9189
2530,華建,10,2,8,群益金鼎-桃園,2023-09-22,9189
2330,台積電,9,1,8,群益金鼎-桃園,2023-09-22,9189
2002,中鋼,10,2,8,群益金鼎-桃園,2023-09-22,9189
1513,中興電,23,15,8,群益金鼎-桃園,2023-09-22,9189
00664R,國泰臺灣加權反1,7,0,7,群益金鼎-桃園,2023-09-22,9189
2515,中工,7,0,7,群益金鼎-桃園,2023-09-22,9189
00919,群益台灣精選高息,85,1,84,群益金鼎-桃園,2023-09-25,9189
00632R,元大台灣50反1,84,4,80,群益金鼎-桃園,2023-09-25,9189
2538,基泰,80,1,79,群益金鼎-桃園,2023-09-25,9189
00907,永豐優息存股,51,0,51,群益金鼎-桃園,2023-09-25,9189
3706,神達,35,4,31,群益金鼎-桃園,2023-09-25,9189
3163,波若威,72,43,29,群益金鼎-桃園,2023-09-25,9189
2459,敦吉,27,0,27,群益金鼎-桃園,2023-09-25,9189
00679B,元大美債20年,26,0,26,群益金鼎-桃園,2023-09-25,9189
2618,長榮航,34,10,24,群益金鼎-桃園,2023-09-25,9189
1101,台泥,25,1,24,群益金鼎-桃園,2023-09-25,9189
2617,台航,20,0,20,群益金鼎-桃園,2023-09-25,9189
3037,欣興,30,12,18,群益金鼎-桃園,2023-09-25,9189
3188,鑫龍騰,37,19,18,群益金鼎-桃園,2023-09-25,9189
2313,華通,17,1,16,群益金鼎-桃園,2023-09-25,9189
00888,永豐台灣ESG,16,0,16,群益金鼎-桃園,2023-09-25,9189
2303,聯電,20,5,15,群益金鼎-桃園,2023-09-25,9189
2610,華航,22,7,15,群益金鼎-桃園,2023-09-25,9189
9958,世紀鋼,15,1,14,群益金鼎-桃園,2023-09-25,9189
00881,國泰台灣5G+,11,0,11,群益金鼎-桃園,2023-09-25,9189
00772B,中信高評級公司債,11,0,11,群益金鼎-桃園,2023-09-25,9189
5469,瀚宇博,11,0,11,群益金鼎-桃園,2023-09-25,9189
2025,千興,10,0,10,群益金鼎-桃園,2023-09-25,9189
8155,博智,13,3,10,群益金鼎-桃園,2023-09-25,9189
2332,友訊,10,0,10,群益金鼎-桃園,2023-09-25,9189
00733,富邦臺灣中小,10,0,10,群益金鼎-桃園,2023-09-25,9189
4402,郡都開發,10,0,10,群益金鼎-桃園,2023-09-25,9189
1402,遠東新,10,0,10,群益金鼎-桃園,2023-09-25,9189
6197,佳必琪,11,1,10,群益金鼎-桃園,2023-09-25,9189
6213,聯茂,14,5,9,群益金鼎-桃園,2023-09-25,9189
2542,興富發,9,0,9,群益金鼎-桃園,2023-09-25,9189
2891,中信金,8,0,8,群益金鼎-桃園,2023-09-25,9189
1522,堤維西,10,3,7,群益金鼎-桃園,2023-09-25,9189
3014,聯陽,7,0,7,群益金鼎-桃園,2023-09-25,9189
8358,金居,8,1,7,群益金鼎-桃園,2023-09-25,9189
2417,圓剛,8,1,7,群益金鼎-桃園,2023-09-25,9189
2344,華邦電,7,0,7,群益金鼎-桃園,2023-09-25,9189
3615,安可,8,1,7,群益金鼎-桃園,2023-09-25,9189
2363,矽統,33,26,7,群益金鼎-桃園,2023-09-25,9189
2317,鴻海,7,1,6,群益金鼎-桃園,2023-09-25,9189
6901,鑽石投資,6,0,6,群益金鼎-桃園,2023-09-25,9189
5009,榮剛,18,12,6,群益金鼎-桃園,2023-09-25,9189
2812,台中銀,6,0,6,群益金鼎-桃園,2023-09-25,9189
2457,飛宏,6,0,6,群益金鼎-桃園,2023-09-25,9189
3576,聯合再生,6,0,6,群益金鼎-桃園,2023-09-25,9189
2402,毅嘉,5,0,5,群益金鼎-桃園,2023-09-25,9189
8050,廣積,6,1,5,群益金鼎-桃園,2023-09-25,9189
2358,廷鑫,9,4,5,群益金鼎-桃園,2023-09-25,9189
2498,宏達電,5,0,5,群益金鼎-桃園,2023-09-25,9189
5299,杰力,5,0,5,群益金鼎-桃園,2023-09-25,9189
3308,聯德,5,0,5,群益金鼎-桃園,2023-09-25,9189
1815,富喬,183,27,156,群益金鼎-桃園,2023-09-26,9189
00679B,元大美債20年,83,2,81,群益金鼎-桃園,2023-09-26,9189
00931B,統一美債20年,69,0,69,群益金鼎-桃園,2023-09-26,9189
2313,華通,59,5,54,群益金鼎-桃園,2023-09-26,9189
00929,復華台灣科技優息,43,5,38,群益金鼎-桃園,2023-09-26,9189
00919,群益台灣精選高息,38,2,36,群益金鼎-桃園,2023-09-26,9189
3051,力特,34,1,33,群益金鼎-桃園,2023-09-26,9189
2303,聯電,37,5,32,群益金鼎-桃園,2023-09-26,9189
1524,耿鼎,91,60,31,群益金鼎-桃園,2023-09-26,9189
2025,千興,46,15,31,群益金鼎-桃園,2023-09-26,9189
2363,矽統,49,20,29,群益金鼎-桃園,2023-09-26,9189
2880,華南金,26,0,26,群益金鼎-桃園,2023-09-26,9189
2834,臺企銀,26,1,25,群益金鼎-桃園,2023-09-26,9189
2888,新光金,23,0,23,群益金鼎-桃園,2023-09-26,9189
00878,國泰永續高股息,24,2,22,群益金鼎-桃園,2023-09-26,9189
3025,星通,27,6,21,群益金鼎-桃園,2023-09-26,9189
00885,富邦越南,21,0,21,群益金鼎-桃園,2023-09-26,9189
1101,台泥,21,1,20,群益金鼎-桃園,2023-09-26,9189
2543,皇昌,25,5,20,群益金鼎-桃園,2023-09-26,9189
3715,定穎投控,70,51,19,群益金鼎-桃園,2023-09-26,9189
6770,力積電,18,0,18,群益金鼎-桃園,2023-09-26,9189
3711,日月光投控,17,0,17,群益金鼎-桃園,2023-09-26,9189
00687B,國泰20年美債,20,3,17,群益金鼎-桃園,2023-09-26,9189
00632R,元大台灣50反1,125,108,17,群益金鼎-桃園,2023-09-26,9189
1522,堤維西,33,17,16,群益金鼎-桃園,2023-09-26,9189
3322,建舜電,21,6,15,群益金鼎-桃園,2023-09-26,9189
2301,光寶科,15,0,15,群益金鼎-桃園,2023-09-26,9189
2449,京元電子,15,0,15,群益金鼎-桃園,2023-09-26,9189
1612,宏泰,18,5,13,群益金鼎-桃園,2023-09-26,9189
2455,全新,13,0,13,群益金鼎-桃園,2023-09-26,9189
0050,元大台灣50,16,3,13,群益金鼎-桃園,2023-09-26,9189
2308,台達電,14,2,12,群益金鼎-桃園,2023-09-26,9189
2882,國泰金,12,0,12,群益金鼎-桃園,2023-09-26,9189
2324,仁寶,15,3,12,群益金鼎-桃園,2023-09-26,9189
2883,凱基金,11,0,11,群益金鼎-桃園,2023-09-26,9189
2884,玉山金,11,0,11,群益金鼎-桃園,2023-09-26,9189
00795B,中信美國公債20年,11,0,11,群益金鼎-桃園,2023-09-26,9189
6807,峰源-KY,11,0,11,群益金鼎-桃園,2023-09-26,9189
00881,國泰台灣5G+,10,0,10,群益金鼎-桃園,2023-09-26,9189
6122,擎邦,10,0,10,群益金鼎-桃園,2023-09-26,9189
3034,聯詠,10,0,10,群益金鼎-桃園,2023-09-26,9189
00637L,元大滬深300正2,10,0,10,群益金鼎-桃園,2023-09-26,9189
00932,兆豐永續高息等權,10,0,10,群益金鼎-桃園,2023-09-26,9189
8076,伍豐,10,0,10,群益金鼎-桃園,2023-09-26,9189
00680L,元大美債20正2,10,0,10,群益金鼎-桃園,2023-09-26,9189
4977,眾達-KY,13,3,10,群益金鼎-桃園,2023-09-26,9189
1618,合機,29,19,10,群益金鼎-桃園,2023-09-26,9189
2801,彰銀,10,0,10,群益金鼎-桃園,2023-09-26,9189
3481,群創,11,2,9,群益金鼎-桃園,2023-09-26,9189
2317,鴻海,10,1,9,群益金鼎-桃園,2023-09-26,9189
2010,春源,180,0,180,群益金鼎-桃園,2023-09-27,9189
2888,新光金,69,0,69,群益金鼎-桃園,2023-09-27,9189
00686R,群益臺灣加權反1,60,0,60,群益金鼎-桃園,2023-09-27,9189
00878,國泰永續高股息,53,2,51,群益金鼎-桃園,2023-09-27,9189
2303,聯電,45,0,45,群益金鼎-桃園,2023-09-27,9189
8420,明揚,57,14,43,群益金鼎-桃園,2023-09-27,9189
00679B,元大美債20年,35,0,35,群益金鼎-桃園,2023-09-27,9189
0056,元大高股息,35,1,34,群益金鼎-桃園,2023-09-27,9189
1802,台玻,36,2,34,群益金鼎-桃園,2023-09-27,9189
00688L,國泰20年美債正2,30,0,30,群益金鼎-桃園,2023-09-27,9189
1618,合機,61,36,25,群益金鼎-桃園,2023-09-27,9189
9919,康那香,26,2,24,群益金鼎-桃園,2023-09-27,9189
00713,元大台灣高息低波,23,0,23,群益金鼎-桃園,2023-09-27,9189
2891,中信金,20,0,20,群益金鼎-桃園,2023-09-27,9189
2606,裕民,21,1,20,群益金鼎-桃園,2023-09-27,9189
1524,耿鼎,26,7,19,群益金鼎-桃園,2023-09-27,9189
00919,群益台灣精選高息,22,4,18,群益金鼎-桃園,2023-09-27,9189
2002,中鋼,24,7,17,群益金鼎-桃園,2023-09-27,9189
2344,華邦電,18,2,16,群益金鼎-桃園,2023-09-27,9189
2886,兆豐金,16,1,15,群益金鼎-桃園,2023-09-27,9189
1815,富喬,54,39,15,群益金鼎-桃園,2023-09-27,9189
1504,東元,18,3,15,群益金鼎-桃園,2023-09-27,9189
1609,大亞,19,4,15,群益金鼎-桃園,2023-09-27,9189
1584,精剛,24,10,14,群益金鼎-桃園,2023-09-27,9189
1608,華榮,13,0,13,群益金鼎-桃園,2023-09-27,9189
3265,台星科,14,1,13,群益金鼎-桃園,2023-09-27,9189
00923,群益台ESG低碳50,12,0,12,群益金鼎-桃園,2023-09-27,9189
2880,華南金,12,0,12,群益金鼎-桃園,2023-09-27,9189
3037,欣興,13,2,11,群益金鼎-桃園,2023-09-27,9189
2801,彰銀,11,0,11,群益金鼎-桃園,2023-09-27,9189
00927,群益半導體收益,10,0,10,群益金鼎-桃園,2023-09-27,9189
1471,首利,20,10,10,群益金鼎-桃園,2023-09-27,9189
2634,漢翔,10,0,10,群益金鼎-桃園,2023-09-27,9189
1522,堤維西,11,2,9,群益金鼎-桃園,2023-09-27,9189
2892,第一金,13,4,9,群益金鼎-桃園,2023-09-27,9189
2884,玉山金,8,0,8,群益金鼎-桃園,2023-09-27,9189
2883,凱基金,8,0,8,群益金鼎-桃園,2023-09-27,9189
1101,台泥,9,1,8,群益金鼎-桃園,2023-09-27,9189
4542,科嶠,32,24,8,群益金鼎-桃園,2023-09-27,9189
00712,復華富時不動產,7,0,7,群益金鼎-桃園,2023-09-27,9189
3122,笙泉,17,10,7,群益金鼎-桃園,2023-09-27,9189
3105,穩懋,10,3,7,群益金鼎-桃園,2023-09-27,9189
3322,建舜電,8,1,7,群益金鼎-桃園,2023-09-27,9189
3231,緯創,18,11,7,群益金鼎-桃園,2023-09-27,9189
2317,鴻海,7,1,6,群益金鼎-桃園,2023-09-27,9189
2328,廣宇,6,0,6,群益金鼎-桃園,2023-09-27,9189
2816,旺旺保,7,1,6,群益金鼎-桃園,2023-09-27,9189
4123,晟德,6,0,6,群益金鼎-桃園,2023-09-27,9189
1519,華城,10,5,5,群益金鼎-桃園,2023-09-27,9189
00720B,元大投資級公司債,5,0,5,群益金鼎-桃園,2023-09-27,9189
1815,富喬,136,27,109,群益金鼎-桃園,2023-09-28,9189
00715L,期街口布蘭特正2,65,1,64,群益金鼎-桃園,2023-09-28,9189
00679B,元大美債20年,45,1,44,群益金鼎-桃園,2023-09-28,9189
5225,東科-KY,47,7,40,群益金鼎-桃園,2023-09-28,9189
1471,首利,45,5,40,群益金鼎-桃園,2023-09-28,9189
2610,華航,40,4,36,群益金鼎-桃園,2023-09-28,9189
00929,復華台灣科技優息,35,1,34,群益金鼎-桃園,2023-09-28,9189
3231,緯創,47,16,31,群益金鼎-桃園,2023-09-28,9189
3006,晶豪科,24,1,23,群益金鼎-桃園,2023-09-28,9189
00673R,期元大S＆P原油反1,32,9,23,群益金鼎-桃園,2023-09-28,9189
2402,毅嘉,22,0,22,群益金鼎-桃園,2023-09-28,9189
00919,群益台灣精選高息,28,7,21,群益金鼎-桃園,2023-09-28,9189
1802,台玻,22,1,21,群益金鼎-桃園,2023-09-28,9189
2609,陽明,23,2,21,群益金鼎-桃園,2023-09-28,9189
00773B,中信優先金融債,21,0,21,群益金鼎-桃園,2023-09-28,9189
00752,中信中國50,20,0,20,群益金鼎-桃園,2023-09-28,9189
2002,中鋼,28,12,16,群益金鼎-桃園,2023-09-28,9189
2337,旺宏,14,0,14,群益金鼎-桃園,2023-09-28,9189
2329,華泰,25,11,14,群益金鼎-桃園,2023-09-28,9189
00772B,中信高評級公司債,13,0,13,群益金鼎-桃園,2023-09-28,9189
3105,穩懋,12,0,12,群益金鼎-桃園,2023-09-28,9189
2312,金寶,12,0,12,群益金鼎-桃園,2023-09-28,9189
5469,瀚宇博,12,0,12,群益金鼎-桃園,2023-09-28,9189
2208,台船,13,1,12,群益金鼎-桃園,2023-09-28,9189
1301,台塑,12,0,12,群益金鼎-桃園,2023-09-28,9189
00878,國泰永續高股息,17,6,11,群益金鼎-桃園,2023-09-28,9189
2324,仁寶,12,1,11,群益金鼎-桃園,2023-09-28,9189
00712,復華富時不動產,11,0,11,群益金鼎-桃園,2023-09-28,9189
2408,南亞科,12,1,11,群益金鼎-桃園,2023-09-28,9189
00720B,元大投資級公司債,10,0,10,群益金鼎-桃園,2023-09-28,9189
4577,達航科技,10,0,10,群益金鼎-桃園,2023-09-28,9189
00688L,國泰20年美債正2,10,0,10,群益金鼎-桃園,2023-09-28,9189
6288,聯嘉,10,0,10,群益金鼎-桃園,2023-09-28,9189
00722B,群益投資級電信債,10,0,10,群益金鼎-桃園,2023-09-28,9189
3363,上詮,29,19,10,群益金鼎-桃園,2023-09-28,9189
6122,擎邦,12,2,10,群益金鼎-桃園,2023-09-28,9189
2025,千興,21,12,9,群益金鼎-桃園,2023-09-28,9189
2891,中信金,8,0,8,群益金鼎-桃園,2023-09-28,9189
2405,輔信,8,0,8,群益金鼎-桃園,2023-09-28,9189
6485,點序,8,0,8,群益金鼎-桃園,2023-09-28,9189
00931B,統一美債20年,8,0,8,群益金鼎-桃園,2023-09-28,9189
9904,寶成,7,0,7,群益金鼎-桃園,2023-09-28,9189
2618,長榮航,17,11,6,群益金鼎-桃園,2023-09-28,9189
3521,鴻翊,7,1,6,群益金鼎-桃園,2023-09-28,9189
00795B,中信美國公債20年,6,0,6,群益金鼎-桃園,2023-09-28,9189
2438,翔耀,6,0,6,群益金鼎-桃園,2023-09-28,9189
4129,聯合,6,0,6,群益金鼎-桃園,2023-09-28,9189
3081,聯亞,6,0,6,群益金鼎-桃園,2023-09-28,9189
5452,佶優,10,4,6,群益金鼎-桃園,2023-09-28,9189
2388,威盛,8,2,6,群益金鼎-桃園,2023-09-28,9189
2618,長榮航,136,37,99,群益金鼎-桃園,2023-10-02,9189
2010,春源,73,0,73,群益金鼎-桃園,2023-10-02,9189
2605,新興,75,3,72,群益金鼎-桃園,2023-10-02,9189
00679B,元大美債20年,72,0,72,群益金鼎-桃園,2023-10-02,9189
00687B,國泰20年美債,52,1,51,群益金鼎-桃園,2023-10-02,9189
8358,金居,68,18,50,群益金鼎-桃園,2023-10-02,9189
00915,凱基優選高股息30,48,0,48,群益金鼎-桃園,2023-10-02,9189
2301,光寶科,50,9,41,群益金鼎-桃園,2023-10-02,9189
1522,堤維西,34,4,30,群益金鼎-桃園,2023-10-02,9189
3481,群創,34,8,26,群益金鼎-桃園,2023-10-02,9189
3325,旭品,63,37,26,群益金鼎-桃園,2023-10-02,9189
2409,友達,23,1,22,群益金鼎-桃園,2023-10-02,9189
00919,群益台灣精選高息,25,5,20,群益金鼎-桃園,2023-10-02,9189
1402,遠東新,20,0,20,群益金鼎-桃園,2023-10-02,9189
2609,陽明,28,8,20,群益金鼎-桃園,2023-10-02,9189
1905,華紙,20,0,20,群益金鼎-桃園,2023-10-02,9189
00900,富邦特選高股息30,20,0,20,群益金鼎-桃園,2023-10-02,9189
1802,台玻,22,3,19,群益金鼎-桃園,2023-10-02,9189
00931B,統一美債20年,20,1,19,群益金鼎-桃園,2023-10-02,9189
2888,新光金,17,1,16,群益金鼎-桃園,2023-10-02,9189
6117,迎廣,27,12,15,群益金鼎-桃園,2023-10-02,9189
2363,矽統,41,27,14,群益金鼎-桃園,2023-10-02,9189
2367,燿華,19,5,14,群益金鼎-桃園,2023-10-02,9189
6182,合晶,13,0,13,群益金鼎-桃園,2023-10-02,9189
6139,亞翔,33,20,13,群益金鼎-桃園,2023-10-02,9189
00738U,期元大道瓊白銀,13,0,13,群益金鼎-桃園,2023-10-02,9189
00680L,元大美債20正2,13,0,13,群益金鼎-桃園,2023-10-02,9189
6188,廣明,27,15,12,群益金鼎-桃園,2023-10-02,9189
1102,亞泥,11,0,11,群益金鼎-桃園,2023-10-02,9189
5340,建榮,13,2,11,群益金鼎-桃園,2023-10-02,9189
2816,旺旺保,12,1,11,群益金鼎-桃園,2023-10-02,9189
3580,友威科,11,1,10,群益金鼎-桃園,2023-10-02,9189
1471,首利,31,21,10,群益金鼎-桃園,2023-10-02,9189
6223,旺矽,10,0,10,群益金鼎-桃園,2023-10-02,9189
6282,康舒,15,5,10,群益金鼎-桃園,2023-10-02,9189
6271,同欣電,18,8,10,群益金鼎-桃園,2023-10-02,9189
6806,森崴能源,9,0,9,群益金鼎-桃園,2023-10-02,9189
4746,台耀,9,0,9,群益金鼎-桃園,2023-10-02,9189
6218,豪勉,9,0,9,群益金鼎-桃園,2023-10-02,9189
5381,合正,23,14,9,群益金鼎-桃園,2023-10-02,9189
4979,華星光,12,3,9,群益金鼎-桃園,2023-10-02,9189
1519,華城,10,2,8,群益金鼎-桃園,2023-10-02,9189
3521,鴻翊,8,0,8,群益金鼎-桃園,2023-10-02,9189
4944,兆遠,8,0,8,群益金鼎-桃園,2023-10-02,9189
3094,聯傑,8,0,8,群益金鼎-桃園,2023-10-02,9189
2615,萬海,16,9,7,群益金鼎-桃園,2023-10-02,9189
00751B,元大AAA至A公司債,7,0,7,群益金鼎-桃園,2023-10-02,9189
1319,東陽,7,0,7,群益金鼎-桃園,2023-10-02,9189
4106,雃博,7,0,7,群益金鼎-桃園,2023-10-02,9189
2324,仁寶,9,2,7,群益金鼎-桃園,2023-10-02,9189
00929,復華台灣科技優息,163,31,132,群益金鼎-桃園,2023-10-03,9189
3043,科風,61,0,61,群益金鼎-桃園,2023-10-03,9189
2409,友達,151,103,48,群益金鼎-桃園,2023-10-03,9189
00753L,中信中國50正2,46,0,46,群益金鼎-桃園,2023-10-03,9189
2313,華通,60,15,45,群益金鼎-桃園,2023-10-03,9189
00919,群益台灣精選高息,45,1,44,群益金鼎-桃園,2023-10-03,9189
2538,基泰,86,45,41,群益金鼎-桃園,2023-10-03,9189
2610,華航,39,6,33,群益金鼎-桃園,2023-10-03,9189
1101,台泥,30,0,30,群益金鼎-桃園,2023-10-03,9189
00908,富邦入息REITs+,30,0,30,群益金鼎-桃園,2023-10-03,9189
0056,元大高股息,31,2,29,群益金鼎-桃園,2023-10-03,9189
00931B,統一美債20年,30,2,28,群益金鼎-桃園,2023-10-03,9189
3231,緯創,67,39,28,群益金鼎-桃園,2023-10-03,9189
2888,新光金,28,1,27,群益金鼎-桃園,2023-10-03,9189
2884,玉山金,26,0,26,群益金鼎-桃園,2023-10-03,9189
00922,國泰台灣領袖50,25,0,25,群益金鼎-桃園,2023-10-03,9189
3521,鴻翊,25,2,23,群益金鼎-桃園,2023-10-03,9189
2402,毅嘉,36,15,21,群益金鼎-桃園,2023-10-03,9189
3706,神達,20,0,20,群益金鼎-桃園,2023-10-03,9189
00637L,元大滬深300正2,19,0,19,群益金鼎-桃園,2023-10-03,9189
00720B,元大投資級公司債,18,0,18,群益金鼎-桃園,2023-10-03,9189
00722B,群益投資級電信債,17,0,17,群益金鼎-桃園,2023-10-03,9189
1609,大亞,24,8,16,群益金鼎-桃園,2023-10-03,9189
2355,敬鵬,15,0,15,群益金鼎-桃園,2023-10-03,9189
00882,中信中國高股息,14,0,14,群益金鼎-桃園,2023-10-03,9189
6126,信音,14,0,14,群益金鼎-桃園,2023-10-03,9189
2618,長榮航,39,25,14,群益金鼎-桃園,2023-10-03,9189
3162,精確,14,0,14,群益金鼎-桃園,2023-10-03,9189
4129,聯合,14,0,14,群益金鼎-桃園,2023-10-03,9189
2324,仁寶,14,1,13,群益金鼎-桃園,2023-10-03,9189
2002,中鋼,18,5,13,群益金鼎-桃園,2023-10-03,9189
00738U,期元大道瓊白銀,13,0,13,群益金鼎-桃園,2023-10-03,9189
6187,萬潤,23,10,13,群益金鼎-桃園,2023-10-03,9189
1504,東元,23,10,13,群益金鼎-桃園,2023-10-03,9189
6182,合晶,12,0,12,群益金鼎-桃園,2023-10-03,9189
3163,波若威,26,14,12,群益金鼎-桃園,2023-10-03,9189
3450,聯鈞,33,21,12,群益金鼎-桃園,2023-10-03,9189
2891,中信金,12,0,12,群益金鼎-桃園,2023-10-03,9189
00712,復華富時不動產,12,0,12,群益金鼎-桃園,2023-10-03,9189
1210,大成,12,0,12,群益金鼎-桃園,2023-10-03,9189
3481,群創,44,33,11,群益金鼎-桃園,2023-10-03,9189
6120,達運,10,0,10,群益金鼎-桃園,2023-10-03,9189
3032,偉訓,20,10,10,群益金鼎-桃園,2023-10-03,9189
2609,陽明,10,0,10,群益金鼎-桃園,2023-10-03,9189
00655L,國泰中國A50正2,10,0,10,群益金鼎-桃園,2023-10-03,9189
1605,華新,17,7,10,群益金鼎-桃園,2023-10-03,9189
2645,長榮航太,10,0,10,群益金鼎-桃園,2023-10-03,9189
6168,宏齊,10,0,10,群益金鼎-桃園,2023-10-03,9189
1514,亞力,20,10,10,群益金鼎-桃園,2023-10-03,9189
2356,英業達,19,10,9,群益金鼎-桃園,2023-10-03,9189
2890,永豐金,432,1,431,群益金鼎-桃園,2023-10-04,9189
00929,復華台灣科技優息,94,2,92,群益金鼎-桃園,2023-10-04,9189
2303,聯電,80,2,78,群益金鼎-桃園,2023-10-04,9189
2618,長榮航,129,58,71,群益金鼎-桃園,2023-10-04,9189
2538,基泰,62,5,57,群益金鼎-桃園,2023-10-04,9189
00679B,元大美債20年,61,15,46,群益金鼎-桃園,2023-10-04,9189
00632R,元大台灣50反1,95,53,42,群益金鼎-桃園,2023-10-04,9189
2891,中信金,39,1,38,群益金鼎-桃園,2023-10-04,9189
3231,緯創,50,13,37,群益金鼎-桃園,2023-10-04,9189
2884,玉山金,45,10,35,群益金鼎-桃園,2023-10-04,9189
2010,春源,34,0,34,群益金鼎-桃園,2023-10-04,9189
00931B,統一美債20年,49,18,31,群益金鼎-桃園,2023-10-04,9189
2419,仲琦,30,0,30,群益金鼎-桃園,2023-10-04,9189
0056,元大高股息,30,0,30,群益金鼎-桃園,2023-10-04,9189
00680L,元大美債20正2,29,0,29,群益金鼎-桃園,2023-10-04,9189
5258,虹堡,32,3,29,群益金鼎-桃園,2023-10-04,9189
2610,華航,29,1,28,群益金鼎-桃園,2023-10-04,9189
2888,新光金,27,0,27,群益金鼎-桃園,2023-10-04,9189
00922,國泰台灣領袖50,27,0,27,群益金鼎-桃園,2023-10-04,9189
2409,友達,29,3,26,群益金鼎-桃園,2023-10-04,9189
2845,遠東銀,25,0,25,群益金鼎-桃園,2023-10-04,9189
00919,群益台灣精選高息,26,3,23,群益金鼎-桃園,2023-10-04,9189
00720B,元大投資級公司債,24,3,21,群益金鼎-桃園,2023-10-04,9189
2883,凱基金,20,0,20,群益金鼎-桃園,2023-10-04,9189
00712,復華富時不動產,26,6,20,群益金鼎-桃園,2023-10-04,9189
8358,金居,29,9,20,群益金鼎-桃園,2023-10-04,9189
00878,國泰永續高股息,20,0,20,群益金鼎-桃園,2023-10-04,9189
2885,元大金,21,1,20,群益金鼎-桃園,2023-10-04,9189
1216,統一,19,0,19,群益金鼎-桃園,2023-10-04,9189
2892,第一金,19,0,19,群益金鼎-桃園,2023-10-04,9189
3013,晟銘電,31,12,19,群益金鼎-桃園,2023-10-04,9189
8086,宏捷科,38,19,19,群益金鼎-桃園,2023-10-04,9189
4933,友輝,63,46,17,群益金鼎-桃園,2023-10-04,9189
1605,華新,21,5,16,群益金鼎-桃園,2023-10-04,9189
4129,聯合,15,0,15,群益金鼎-桃園,2023-10-04,9189
2344,華邦電,15,0,15,群益金鼎-桃園,2023-10-04,9189
00688L,國泰20年美債正2,15,0,15,群益金鼎-桃園,2023-10-04,9189
1303,南亞,14,0,14,群益金鼎-桃園,2023-10-04,9189
1504,東元,18,4,14,群益金鼎-桃園,2023-10-04,9189
2449,京元電子,34,20,14,群益金鼎-桃園,2023-10-04,9189
3044,健鼎,15,1,14,群益金鼎-桃園,2023-10-04,9189
1584,精剛,15,1,14,群益金鼎-桃園,2023-10-04,9189
00751B,元大AAA至A公司債,13,0,13,群益金鼎-桃園,2023-10-04,9189
2881,富邦金,13,0,13,群益金鼎-桃園,2023-10-04,9189
2002,中鋼,49,36,13,群益金鼎-桃園,2023-10-04,9189
1102,亞泥,13,0,13,群益金鼎-桃園,2023-10-04,9189
00795B,中信美國公債20年,17,4,13,群益金鼎-桃園,2023-10-04,9189
6279,胡連,13,0,13,群益金鼎-桃園,2023-10-04,9189
3122,笙泉,66,53,13,群益金鼎-桃園,2023-10-04,9189
6770,力積電,13,0,13,群益金鼎-桃園,2023-10-04,9189
2010,春源,106,10,96,群益金鼎-桃園,2023-10-05,9189
1324,地球,85,19,66,群益金鼎-桃園,2023-10-05,9189
6288,聯嘉,63,1,62,群益金鼎-桃園,2023-10-05,9189
3481,群創,46,0,46,群益金鼎-桃園,2023-10-05,9189
00929,復華台灣科技優息,43,2,41,群益金鼎-桃園,2023-10-05,9189
00712,復華富時不動產,39,1,38,群益金鼎-桃園,2023-10-05,9189
3715,定穎投控,111,74,37,群益金鼎-桃園,2023-10-05,9189
00632R,元大台灣50反1,45,15,30,群益金鼎-桃園,2023-10-05,9189
4129,聯合,30,0,30,群益金鼎-桃園,2023-10-05,9189
00922,國泰台灣領袖50,30,0,30,群益金鼎-桃園,2023-10-05,9189
3234,光環,31,1,30,群益金鼎-桃園,2023-10-05,9189
3014,聯陽,25,0,25,群益金鼎-桃園,2023-10-05,9189
1524,耿鼎,24,0,24,群益金鼎-桃園,2023-10-05,9189
00931B,統一美債20年,43,20,23,群益金鼎-桃園,2023-10-05,9189
3032,偉訓,35,13,22,群益金鼎-桃園,2023-10-05,9189
8358,金居,33,11,22,群益金鼎-桃園,2023-10-05,9189
5272,笙科,32,11,21,群益金鼎-桃園,2023-10-05,9189
6684,安格,20,0,20,群益金鼎-桃園,2023-10-05,9189
1815,富喬,86,67,19,群益金鼎-桃園,2023-10-05,9189
3006,晶豪科,21,2,19,群益金鼎-桃園,2023-10-05,9189
2606,裕民,16,0,16,群益金鼎-桃園,2023-10-05,9189
00730,富邦臺灣優質高息,15,0,15,群益金鼎-桃園,2023-10-05,9189
4933,友輝,21,8,13,群益金鼎-桃園,2023-10-05,9189
2883,凱基金,14,2,12,群益金鼎-桃園,2023-10-05,9189
1527,鑽全,12,0,12,群益金鼎-桃園,2023-10-05,9189
1515,力山,12,0,12,群益金鼎-桃園,2023-10-05,9189
00642U,期元大S＆P石油,12,0,12,群益金鼎-桃園,2023-10-05,9189
00919,群益台灣精選高息,16,4,12,群益金鼎-桃園,2023-10-05,9189
2888,新光金,12,1,11,群益金鼎-桃園,2023-10-05,9189
9958,世紀鋼,12,1,11,群益金鼎-桃園,2023-10-05,9189
2834,臺企銀,11,0,11,群益金鼎-桃園,2023-10-05,9189
2884,玉山金,10,0,10,群益金鼎-桃園,2023-10-05,9189
00633L,富邦上証正2,10,0,10,群益金鼎-桃園,2023-10-05,9189
1802,台玻,10,0,10,群益金鼎-桃園,2023-10-05,9189
3325,旭品,14,4,10,群益金鼎-桃園,2023-10-05,9189
0056,元大高股息,11,2,9,群益金鼎-桃園,2023-10-05,9189
3037,欣興,11,2,9,群益金鼎-桃園,2023-10-05,9189
2429,銘旺科,9,0,9,群益金鼎-桃園,2023-10-05,9189
00715L,期街口布蘭特正2,8,0,8,群益金鼎-桃園,2023-10-05,9189
1319,東陽,20,12,8,群益金鼎-桃園,2023-10-05,9189
2637,慧洋-KY,8,0,8,群益金鼎-桃園,2023-10-05,9189
8277,商丞,7,0,7,群益金鼎-桃園,2023-10-05,9189
3044,健鼎,17,10,7,群益金鼎-桃園,2023-10-05,9189
00753L,中信中國50正2,7,0,7,群益金鼎-桃園,2023-10-05,9189
2405,輔信,9,2,7,群益金鼎-桃園,2023-10-05,9189
5426,振發,9,2,7,群益金鼎-桃園,2023-10-05,9189
2748,雲品,6,0,6,群益金鼎-桃園,2023-10-05,9189
00888,永豐台灣ESG,6,0,6,群益金鼎-桃園,2023-10-05,9189
5469,瀚宇博,5,0,5,群益金鼎-桃園,2023-10-05,9189
1216,統一,5,0,5,群益金鼎-桃園,2023-10-05,9189
2010,春源,105,0,105,群益金鼎-桃園,2023-10-06,9189
00929,復華台灣科技優息,99,0,99,群益金鼎-桃園,2023-10-06,9189
2618,長榮航,64,2,62,群益金鼎-桃園,2023-10-06,9189
2323,中環,60,1,59,群益金鼎-桃園,2023-10-06,9189
00751B,元大AAA至A公司債,38,0,38,群益金鼎-桃園,2023-10-06,9189
1324,地球,45,10,35,群益金鼎-桃園,2023-10-06,9189
00919,群益台灣精選高息,33,0,33,群益金鼎-桃園,2023-10-06,9189
6191,精成科,40,7,33,群益金鼎-桃園,2023-10-06,9189
2486,一詮,49,18,31,群益金鼎-桃園,2023-10-06,9189
6530,創威,30,2,28,群益金鼎-桃園,2023-10-06,9189
5258,虹堡,33,9,24,群益金鼎-桃園,2023-10-06,9189
2449,京元電子,37,14,23,群益金鼎-桃園,2023-10-06,9189
00712,復華富時不動產,23,0,23,群益金鼎-桃園,2023-10-06,9189
8271,宇瞻,23,1,22,群益金鼎-桃園,2023-10-06,9189
6188,廣明,21,0,21,群益金鼎-桃園,2023-10-06,9189
4927,泰鼎-KY,21,1,20,群益金鼎-桃園,2023-10-06,9189
2313,華通,26,7,19,群益金鼎-桃園,2023-10-06,9189
2002,中鋼,19,2,17,群益金鼎-桃園,2023-10-06,9189
9105,泰金寶-DR,16,0,16,群益金鼎-桃園,2023-10-06,9189
2337,旺宏,21,5,16,群益金鼎-桃園,2023-10-06,9189
6139,亞翔,28,12,16,群益金鼎-桃園,2023-10-06,9189
2371,大同,15,0,15,群益金鼎-桃園,2023-10-06,9189
00632R,元大台灣50反1,25,10,15,群益金鼎-桃園,2023-10-06,9189
1815,富喬,23,8,15,群益金鼎-桃園,2023-10-06,9189
1310,台苯,14,0,14,群益金鼎-桃園,2023-10-06,9189
1101,台泥,14,0,14,群益金鼎-桃園,2023-10-06,9189
00922,國泰台灣領袖50,13,0,13,群益金鼎-桃園,2023-10-06,9189
2610,華航,14,2,12,群益金鼎-桃園,2023-10-06,9189
6770,力積電,12,0,12,群益金鼎-桃園,2023-10-06,9189
1514,亞力,14,2,12,群益金鼎-桃園,2023-10-06,9189
8086,宏捷科,11,0,11,群益金鼎-桃園,2023-10-06,9189
9950,萬國通,42,31,11,群益金鼎-桃園,2023-10-06,9189
3479,安勤,11,0,11,群益金鼎-桃園,2023-10-06,9189
2368,金像電,17,7,10,群益金鼎-桃園,2023-10-06,9189
2472,立隆電,10,0,10,群益金鼎-桃園,2023-10-06,9189
00853B,統一美債10年Aa-,10,0,10,群益金鼎-桃園,2023-10-06,9189
4543,萬在,11,1,10,群益金鼎-桃園,2023-10-06,9189
00902,中信電池及儲能,10,0,10,群益金鼎-桃園,2023-10-06,9189
6282,康舒,9,0,9,群益金鼎-桃園,2023-10-06,9189
2329,華泰,26,17,9,群益金鼎-桃園,2023-10-06,9189
3380,明泰,8,0,8,群益金鼎-桃園,2023-10-06,9189
00720B,元大投資級公司債,7,0,7,群益金鼎-桃園,2023-10-06,9189
2442,新美齊,12,5,7,群益金鼎-桃園,2023-10-06,9189
2344,華邦電,24,17,7,群益金鼎-桃園,2023-10-06,9189
2303,聯電,8,2,6,群益金鼎-桃園,2023-10-06,9189
00772B,中信高評級公司債,6,0,6,群益金鼎-桃園,2023-10-06,9189
3231,緯創,47,41,6,群益金鼎-桃園,2023-10-06,9189
4953,緯軟,10,4,6,群益金鼎-桃園,2023-10-06,9189
2882,國泰金,6,0,6,群益金鼎-桃園,2023-10-06,9189
2468,華經,32,26,6,群益金鼎-桃園,2023-10-06,9189
2010,春源,110,0,110,群益金鼎-桃園,2023-10-11,9189
3231,緯創,127,40,87,群益金鼎-桃園,2023-10-11,9189
00632R,元大台灣50反1,104,38,66,群益金鼎-桃園,2023-10-11,9189
2382,廣達,57,15,42,群益金鼎-桃園,2023-10-11,9189
2609,陽明,66,25,41,群益金鼎-桃園,2023-10-11,9189
00679B,元大美債20年,34,0,34,群益金鼎-桃園,2023-10-11,9189
5258,虹堡,35,5,30,群益金鼎-桃園,2023-10-11,9189
2405,輔信,30,0,30,群益金鼎-桃園,2023-10-11,9189
00919,群益台灣精選高息,39,10,29,群益金鼎-桃園,2023-10-11,9189
5340,建榮,34,6,28,群益金鼎-桃園,2023-10-11,9189
1609,大亞,26,0,26,群益金鼎-桃園,2023-10-11,9189
3715,定穎投控,55,32,23,群益金鼎-桃園,2023-10-11,9189
6189,豐藝,37,20,17,群益金鼎-桃園,2023-10-11,9189
6122,擎邦,25,8,17,群益金鼎-桃園,2023-10-11,9189
2603,長榮,20,3,17,群益金鼎-桃園,2023-10-11,9189
00712,復華富時不動產,21,5,16,群益金鼎-桃園,2023-10-11,9189
00931B,統一美債20年,15,0,15,群益金鼎-桃園,2023-10-11,9189
2453,凌群,19,5,14,群益金鼎-桃園,2023-10-11,9189
1504,東元,15,2,13,群益金鼎-桃園,2023-10-11,9189
5469,瀚宇博,17,5,12,群益金鼎-桃園,2023-10-11,9189
4714,永捷,16,4,12,群益金鼎-桃園,2023-10-11,9189
9933,中鼎,12,0,12,群益金鼎-桃園,2023-10-11,9189
00764B,群益25年美債,12,0,12,群益金鼎-桃園,2023-10-11,9189
00722B,群益投資級電信債,12,0,12,群益金鼎-桃園,2023-10-11,9189
1513,中興電,11,0,11,群益金鼎-桃園,2023-10-11,9189
1612,宏泰,11,0,11,群益金鼎-桃園,2023-10-11,9189
2816,旺旺保,18,7,11,群益金鼎-桃園,2023-10-11,9189
2014,中鴻,10,0,10,群益金鼎-桃園,2023-10-11,9189
2637,慧洋-KY,10,0,10,群益金鼎-桃園,2023-10-11,9189
2312,金寶,10,0,10,群益金鼎-桃園,2023-10-11,9189
6117,迎廣,10,0,10,群益金鼎-桃園,2023-10-11,9189
2465,麗臺,12,2,10,群益金鼎-桃園,2023-10-11,9189
6187,萬潤,10,0,10,群益金鼎-桃園,2023-10-11,9189
2892,第一金,10,0,10,群益金鼎-桃園,2023-10-11,9189
3047,訊舟,10,0,10,群益金鼎-桃園,2023-10-11,9189
3006,晶豪科,120,110,10,群益金鼎-桃園,2023-10-11,9189
00882,中信中國高股息,10,0,10,群益金鼎-桃園,2023-10-11,9189
2883,凱基金,13,3,10,群益金鼎-桃園,2023-10-11,9189
3036,文曄,11,2,9,群益金鼎-桃園,2023-10-11,9189
3545,敦泰,10,1,9,群益金鼎-桃園,2023-10-11,9189
8033,雷虎,10,1,9,群益金鼎-桃園,2023-10-11,9189
2368,金像電,17,8,9,群益金鼎-桃園,2023-10-11,9189
00730,富邦臺灣優質高息,8,0,8,群益金鼎-桃園,2023-10-11,9189
4533,協易機,9,1,8,群益金鼎-桃園,2023-10-11,9189
3709,鑫聯大投控,8,0,8,群益金鼎-桃園,2023-10-11,9189
1605,華新,21,13,8,群益金鼎-桃園,2023-10-11,9189
6118,建達,8,0,8,群益金鼎-桃園,2023-10-11,9189
1783,和康生,7,0,7,群益金鼎-桃園,2023-10-11,9189
5243,乙盛-KY,7,0,7,群益金鼎-桃園,2023-10-11,9189
4503,金雨,9,2,7,群益金鼎-桃園,2023-10-11,9189
2618,長榮航,146,5,141,群益金鼎-桃園,2023-10-12,9189
2010,春源,100,0,100,群益金鼎-桃園,2023-10-12,9189
00632R,元大台灣50反1,43,0,43,群益金鼎-桃園,2023-10-12,9189
6117,迎廣,36,0,36,群益金鼎-桃園,2023-10-12,9189
2329,華泰,38,3,35,群益金鼎-桃園,2023-10-12,9189
00753L,中信中國50正2,30,3,27,群益金鼎-桃園,2023-10-12,9189
2312,金寶,25,0,25,群益金鼎-桃園,2023-10-12,9189
2303,聯電,29,9,20,群益金鼎-桃園,2023-10-12,9189
1909,榮成,20,0,20,群益金鼎-桃園,2023-10-12,9189
2352,佳世達,21,1,20,群益金鼎-桃園,2023-10-12,9189
2356,英業達,33,16,17,群益金鼎-桃園,2023-10-12,9189
00919,群益台灣精選高息,28,14,14,群益金鼎-桃園,2023-10-12,9189
2444,兆勁,14,0,14,群益金鼎-桃園,2023-10-12,9189
3013,晟銘電,14,1,13,群益金鼎-桃園,2023-10-12,9189
5272,笙科,13,1,12,群益金鼎-桃園,2023-10-12,9189
2538,基泰,13,2,11,群益金鼎-桃園,2023-10-12,9189
6129,普誠,12,1,11,群益金鼎-桃園,2023-10-12,9189
2382,廣達,26,16,10,群益金鼎-桃園,2023-10-12,9189
00673R,期元大S＆P原油反1,20,10,10,群益金鼎-桃園,2023-10-12,9189
00642U,期元大S＆P石油,10,0,10,群益金鼎-桃園,2023-10-12,9189
6168,宏齊,16,6,10,群益金鼎-桃園,2023-10-12,9189
6625,必應,11,1,10,群益金鼎-桃園,2023-10-12,9189
6509,聚和,10,0,10,群益金鼎-桃園,2023-10-12,9189
3014,聯陽,20,11,9,群益金鼎-桃園,2023-10-12,9189
3276,宇環,9,1,8,群益金鼎-桃園,2023-10-12,9189
2436,偉詮電,14,6,8,群益金鼎-桃園,2023-10-12,9189
2886,兆豐金,11,3,8,群益金鼎-桃園,2023-10-12,9189
1815,富喬,42,35,7,群益金鼎-桃園,2023-10-12,9189
2377,微星,7,0,7,群益金鼎-桃園,2023-10-12,9189
00931B,統一美債20年,7,0,7,群益金鼎-桃園,2023-10-12,9189
3163,波若威,41,35,6,群益金鼎-桃園,2023-10-12,9189
1802,台玻,6,0,6,群益金鼎-桃園,2023-10-12,9189
1584,精剛,6,0,6,群益金鼎-桃園,2023-10-12,9189
6451,訊芯-KY,13,7,6,群益金鼎-桃園,2023-10-12,9189
3036,文曄,19,13,6,群益金鼎-桃園,2023-10-12,9189
6158,禾昌,7,1,6,群益金鼎-桃園,2023-10-12,9189
2355,敬鵬,8,2,6,群益金鼎-桃園,2023-10-12,9189
2516,新建,6,0,6,群益金鼎-桃園,2023-10-12,9189
00680L,元大美債20正2,6,0,6,群益金鼎-桃園,2023-10-12,9189
3706,神達,13,7,6,群益金鼎-桃園,2023-10-12,9189
3037,欣興,11,5,6,群益金鼎-桃園,2023-10-12,9189
00712,復華富時不動產,11,5,6,群益金鼎-桃園,2023-10-12,9189
00679B,元大美債20年,7,2,5,群益金鼎-桃園,2023-10-12,9189
2453,凌群,11,6,5,群益金鼎-桃園,2023-10-12,9189
4563,百德,10,5,5,群益金鼎-桃園,2023-10-12,9189
6257,矽格,5,0,5,群益金鼎-桃園,2023-10-12,9189
2851,中再保,5,0,5,群益金鼎-桃園,2023-10-12,9189
2413,環科,5,0,5,群益金鼎-桃園,2023-10-12,9189
3587,閎康,5,0,5,群益金鼎-桃園,2023-10-12,9189
4564,元翎,10,5,5,群益金鼎-桃園,2023-10-12,9189
2010,春源,88,5,83,群益金鼎-桃園,2023-10-13,9189
00878,國泰永續高股息,55,0,55,群益金鼎-桃園,2023-10-13,9189
2382,廣達,69,15,54,群益金鼎-桃園,2023-10-13,9189
2891,中信金,58,5,53,群益金鼎-桃園,2023-10-13,9189
1303,南亞,50,0,50,群益金鼎-桃園,2023-10-13,9189
0056,元大高股息,41,3,38,群益金鼎-桃園,2023-10-13,9189
1760,寶齡富錦,37,1,36,群益金鼎-桃園,2023-10-13,9189
00637L,元大滬深300正2,39,4,35,群益金鼎-桃園,2023-10-13,9189
00753L,中信中國50正2,34,0,34,群益金鼎-桃園,2023-10-13,9189
2440,太空梭,29,0,29,群益金鼎-桃園,2023-10-13,9189
3260,威剛,57,28,29,群益金鼎-桃園,2023-10-13,9189
2607,榮運,32,8,24,群益金鼎-桃園,2023-10-13,9189
4533,協易機,23,0,23,群益金鼎-桃園,2023-10-13,9189
8930,青鋼,22,0,22,群益金鼎-桃園,2023-10-13,9189
2888,新光金,22,0,22,群益金鼎-桃園,2023-10-13,9189
6116,彩晶,20,0,20,群益金鼎-桃園,2023-10-13,9189
2363,矽統,183,164,19,群益金鼎-桃園,2023-10-13,9189
8358,金居,21,2,19,群益金鼎-桃園,2023-10-13,9189
3078,僑威,36,19,17,群益金鼎-桃園,2023-10-13,9189
6187,萬潤,29,13,16,群益金鼎-桃園,2023-10-13,9189
2356,英業達,18,3,15,群益金鼎-桃園,2023-10-13,9189
00919,群益台灣精選高息,15,0,15,群益金鼎-桃園,2023-10-13,9189
2324,仁寶,14,0,14,群益金鼎-桃園,2023-10-13,9189
00885,富邦越南,14,0,14,群益金鼎-桃園,2023-10-13,9189
2301,光寶科,19,6,13,群益金鼎-桃園,2023-10-13,9189
00931B,統一美債20年,13,0,13,群益金鼎-桃園,2023-10-13,9189
8996,高力,14,1,13,群益金鼎-桃園,2023-10-13,9189
3313,斐成,12,0,12,群益金鼎-桃園,2023-10-13,9189
2609,陽明,36,25,11,群益金鼎-桃園,2023-10-13,9189
9933,中鼎,10,0,10,群益金鼎-桃園,2023-10-13,9189
1101,台泥,10,0,10,群益金鼎-桃園,2023-10-13,9189
00720B,元大投資級公司債,10,0,10,群益金鼎-桃園,2023-10-13,9189
6005,群益證,10,0,10,群益金鼎-桃園,2023-10-13,9189
2812,台中銀,10,0,10,群益金鼎-桃園,2023-10-13,9189
00752,中信中國50,10,0,10,群益金鼎-桃園,2023-10-13,9189
2855,統一證,10,0,10,群益金鼎-桃園,2023-10-13,9189
2903,遠百,10,0,10,群益金鼎-桃園,2023-10-13,9189
00633L,富邦上証正2,10,0,10,群益金鼎-桃園,2023-10-13,9189
00680L,元大美債20正2,10,0,10,群益金鼎-桃園,2023-10-13,9189
1531,高林股,10,0,10,群益金鼎-桃園,2023-10-13,9189
2444,兆勁,10,0,10,群益金鼎-桃園,2023-10-13,9189
1326,台化,10,0,10,群益金鼎-桃園,2023-10-13,9189
6189,豐藝,10,0,10,群益金鼎-桃園,2023-10-13,9189
2486,一詮,26,17,9,群益金鼎-桃園,2023-10-13,9189
00679B,元大美債20年,9,0,9,群益金鼎-桃園,2023-10-13,9189
00687B,國泰20年美債,9,0,9,群益金鼎-桃園,2023-10-13,9189
4979,華星光,35,26,9,群益金鼎-桃園,2023-10-13,9189
1504,東元,10,2,8,群益金鼎-桃園,2023-10-13,9189
2610,華航,7,0,7,群益金鼎-桃園,2023-10-13,9189
6284,佳邦,19,12,7,群益金鼎-桃園,2023-10-13,9189
00929,復華台灣科技優息,156,1,155,群益金鼎-桃園,2023-10-16,9189
00878,國泰永續高股息,129,0,129,群益金鼎-桃園,2023-10-16,9189
2010,春源,105,5,100,群益金鼎-桃園,2023-10-16,9189
1314,中石化,92,22,70,群益金鼎-桃園,2023-10-16,9189
00919,群益台灣精選高息,69,3,66,群益金鼎-桃園,2023-10-16,9189
2618,長榮航,70,21,49,群益金鼎-桃園,2023-10-16,9189
3231,緯創,61,15,46,群益金鼎-桃園,2023-10-16,9189
2515,中工,154,116,38,群益金鼎-桃園,2023-10-16,9189
2371,大同,40,4,36,群益金鼎-桃園,2023-10-16,9189
00632R,元大台灣50反1,48,13,35,群益金鼎-桃園,2023-10-16,9189
0056,元大高股息,35,1,34,群益金鼎-桃園,2023-10-16,9189
2369,菱生,33,3,30,群益金鼎-桃園,2023-10-16,9189
00722B,群益投資級電信債,25,0,25,群益金鼎-桃園,2023-10-16,9189
2201,裕隆,28,7,21,群益金鼎-桃園,2023-10-16,9189
2748,雲品,20,0,20,群益金鼎-桃園,2023-10-16,9189
8996,高力,22,4,18,群益金鼎-桃園,2023-10-16,9189
2610,華航,23,6,17,群益金鼎-桃園,2023-10-16,9189
6274,台燿,20,3,17,群益金鼎-桃園,2023-10-16,9189
9950,萬國通,19,2,17,群益金鼎-桃園,2023-10-16,9189
00922,國泰台灣領袖50,21,4,17,群益金鼎-桃園,2023-10-16,9189
3706,神達,21,4,17,群益金鼎-桃園,2023-10-16,9189
2382,廣達,30,13,17,群益金鼎-桃園,2023-10-16,9189
2344,華邦電,29,14,15,群益金鼎-桃園,2023-10-16,9189
00753L,中信中國50正2,20,5,15,群益金鼎-桃園,2023-10-16,9189
1605,華新,19,5,14,群益金鼎-桃園,2023-10-16,9189
4908,前鼎,45,31,14,群益金鼎-桃園,2023-10-16,9189
6244,茂迪,16,3,13,群益金鼎-桃園,2023-10-16,9189
1101,台泥,12,0,12,群益金鼎-桃園,2023-10-16,9189
9933,中鼎,12,0,12,群益金鼎-桃園,2023-10-16,9189
6531,愛普*,15,4,11,群益金鼎-桃園,2023-10-16,9189
2498,宏達電,11,0,11,群益金鼎-桃園,2023-10-16,9189
1525,江申,12,1,11,群益金鼎-桃園,2023-10-16,9189
1301,台塑,10,0,10,群益金鼎-桃園,2023-10-16,9189
2368,金像電,19,9,10,群益金鼎-桃園,2023-10-16,9189
8150,南茂,10,0,10,群益金鼎-桃園,2023-10-16,9189
4402,郡都開發,10,0,10,群益金鼎-桃園,2023-10-16,9189
3032,偉訓,10,0,10,群益金鼎-桃園,2023-10-16,9189
2855,統一證,10,0,10,群益金鼎-桃園,2023-10-16,9189
2462,良得電,10,0,10,群益金鼎-桃園,2023-10-16,9189
3521,鴻翊,10,0,10,群益金鼎-桃園,2023-10-16,9189
3481,群創,9,0,9,群益金鼎-桃園,2023-10-16,9189
8076,伍豐,9,0,9,群益金鼎-桃園,2023-10-16,9189
2025,千興,10,2,8,群益金鼎-桃園,2023-10-16,9189
3006,晶豪科,10,2,8,群益金鼎-桃園,2023-10-16,9189
8034,榮群,8,0,8,群益金鼎-桃園,2023-10-16,9189
8358,金居,10,2,8,群益金鼎-桃園,2023-10-16,9189
2457,飛宏,8,0,8,群益金鼎-桃園,2023-10-16,9189
3715,定穎投控,46,39,7,群益金鼎-桃園,2023-10-16,9189
2303,聯電,12,5,7,群益金鼎-桃園,2023-10-16,9189
2388,威盛,15,8,7,群益金鼎-桃園,2023-10-16,9189
00878,國泰永續高股息,239,2,237,群益金鼎-桃園,2023-10-17,9189
2010,春源,100,0,100,群益金鼎-桃園,2023-10-17,9189
0056,元大高股息,86,4,82,群益金鼎-桃園,2023-10-17,9189
00687B,國泰20年美債,38,0,38,群益金鼎-桃園,2023-10-17,9189
2610,華航,39,2,37,群益金鼎-桃園,2023-10-17,9189
2303,聯電,106,69,37,群益金鼎-桃園,2023-10-17,9189
3715,定穎投控,73,37,36,群益金鼎-桃園,2023-10-17,9189
6770,力積電,37,3,34,群益金鼎-桃園,2023-10-17,9189
00919,群益台灣精選高息,53,20,33,群益金鼎-桃園,2023-10-17,9189
2891,中信金,37,5,32,群益金鼎-桃園,2023-10-17,9189
00673R,期元大S＆P原油反1,30,0,30,群益金鼎-桃園,2023-10-17,9189
9945,潤泰新,29,0,29,群益金鼎-桃園,2023-10-17,9189
00929,復華台灣科技優息,50,21,29,群益金鼎-桃園,2023-10-17,9189
8048,德勝,33,9,24,群益金鼎-桃園,2023-10-17,9189
2618,長榮航,223,202,21,群益金鼎-桃園,2023-10-17,9189
00905,FT臺灣Smart,20,0,20,群益金鼎-桃園,2023-10-17,9189
1815,富喬,50,30,20,群益金鼎-桃園,2023-10-17,9189
2382,廣達,41,21,20,群益金鼎-桃園,2023-10-17,9189
1909,榮成,20,1,19,群益金鼎-桃園,2023-10-17,9189
8222,寶一,16,0,16,群益金鼎-桃園,2023-10-17,9189
6509,聚和,15,0,15,群益金鼎-桃園,2023-10-17,9189
1504,東元,14,0,14,群益金鼎-桃園,2023-10-17,9189
00931B,統一美債20年,16,3,13,群益金鼎-桃園,2023-10-17,9189
6117,迎廣,14,2,12,群益金鼎-桃園,2023-10-17,9189
00751B,元大AAA至A公司債,13,1,12,群益金鼎-桃園,2023-10-17,9189
5009,榮剛,42,30,12,群益金鼎-桃園,2023-10-17,9189
1603,華電,12,0,12,群益金鼎-桃園,2023-10-17,9189
00753L,中信中國50正2,12,0,12,群益金鼎-桃園,2023-10-17,9189
6530,創威,25,14,11,群益金鼎-桃園,2023-10-17,9189
8358,金居,13,2,11,群益金鼎-桃園,2023-10-17,9189
8044,網家,11,0,11,群益金鼎-桃園,2023-10-17,9189
9105,泰金寶-DR,11,0,11,群益金鼎-桃園,2023-10-17,9189
2425,承啟,14,4,10,群益金鼎-桃園,2023-10-17,9189
00690,兆豐藍籌30,10,0,10,群益金鼎-桃園,2023-10-17,9189
4550,長佳,10,0,10,群益金鼎-桃園,2023-10-17,9189
00881,國泰台灣5G+,10,0,10,群益金鼎-桃園,2023-10-17,9189
3479,安勤,10,0,10,群益金鼎-桃園,2023-10-17,9189
3006,晶豪科,22,12,10,群益金鼎-桃園,2023-10-17,9189
00631L,元大台灣50正2,11,1,10,群益金鼎-桃園,2023-10-17,9189
2459,敦吉,10,0,10,群益金鼎-桃園,2023-10-17,9189
2637,慧洋-KY,9,0,9,群益金鼎-桃園,2023-10-17,9189
00720B,元大投資級公司債,9,0,9,群益金鼎-桃園,2023-10-17,9189
1527,鑽全,9,0,9,群益金鼎-桃園,2023-10-17,9189
2634,漢翔,9,0,9,群益金鼎-桃園,2023-10-17,9189
2201,裕隆,8,0,8,群益金鼎-桃園,2023-10-17,9189
2352,佳世達,8,0,8,群益金鼎-桃園,2023-10-17,9189
6104,創惟,9,1,8,群益金鼎-桃園,2023-10-17,9189
2412,中華電,8,0,8,群益金鼎-桃園,2023-10-17,9189
2887,台新金,8,0,8,群益金鼎-桃園,2023-10-17,9189
3062,建漢,9,1,8,群益金鼎-桃園,2023-10-17,9189
00929,復華台灣科技優息,179,0,179,群益金鼎-桃園,2023-10-18,9189
0056,元大高股息,106,4,102,群益金鼎-桃園,2023-10-18,9189
2010,春源,92,0,92,群益金鼎-桃園,2023-10-18,9189
00919,群益台灣精選高息,82,0,82,群益金鼎-桃園,2023-10-18,9189
00878,國泰永續高股息,131,77,54,群益金鼎-桃園,2023-10-18,9189
2618,長榮航,137,92,45,群益金鼎-桃園,2023-10-18,9189
6168,宏齊,63,18,45,群益金鼎-桃園,2023-10-18,9189
3260,威剛,55,27,28,群益金鼎-桃園,2023-10-18,9189
00687B,國泰20年美債,28,0,28,群益金鼎-桃園,2023-10-18,9189
8076,伍豐,26,0,26,群益金鼎-桃園,2023-10-18,9189
2382,廣達,61,35,26,群益金鼎-桃園,2023-10-18,9189
2498,宏達電,24,0,24,群益金鼎-桃園,2023-10-18,9189
2324,仁寶,42,19,23,群益金鼎-桃園,2023-10-18,9189
2344,華邦電,23,0,23,群益金鼎-桃園,2023-10-18,9189
6117,迎廣,21,0,21,群益金鼎-桃園,2023-10-18,9189
2486,一詮,23,2,21,群益金鼎-桃園,2023-10-18,9189
2399,映泰,20,0,20,群益金鼎-桃園,2023-10-18,9189
00922,國泰台灣領袖50,18,0,18,群益金鼎-桃園,2023-10-18,9189
3706,神達,26,8,18,群益金鼎-桃園,2023-10-18,9189
1815,富喬,35,18,17,群益金鼎-桃園,2023-10-18,9189
2449,京元電子,17,1,16,群益金鼎-桃園,2023-10-18,9189
2352,佳世達,24,9,15,群益金鼎-桃園,2023-10-18,9189
2402,毅嘉,17,3,14,群益金鼎-桃園,2023-10-18,9189
5243,乙盛-KY,14,0,14,群益金鼎-桃園,2023-10-18,9189
2313,華通,30,16,14,群益金鼎-桃園,2023-10-18,9189
4908,前鼎,41,28,13,群益金鼎-桃園,2023-10-18,9189
1101,台泥,18,5,13,群益金鼎-桃園,2023-10-18,9189
4402,郡都開發,12,0,12,群益金鼎-桃園,2023-10-18,9189
2002,中鋼,12,0,12,群益金鼎-桃園,2023-10-18,9189
00881,國泰台灣5G+,11,0,11,群益金鼎-桃園,2023-10-18,9189
1909,榮成,11,0,11,群益金鼎-桃園,2023-10-18,9189
2534,宏盛,21,10,11,群益金鼎-桃園,2023-10-18,9189
5009,榮剛,31,20,11,群益金鼎-桃園,2023-10-18,9189
00722B,群益投資級電信債,11,0,11,群益金鼎-桃園,2023-10-18,9189
00679B,元大美債20年,11,0,11,群益金鼎-桃園,2023-10-18,9189
1513,中興電,10,0,10,群益金鼎-桃園,2023-10-18,9189
3558,神準,11,1,10,群益金鼎-桃園,2023-10-18,9189
3583,辛耘,10,0,10,群益金鼎-桃園,2023-10-18,9189
1217,愛之味,10,0,10,群益金鼎-桃園,2023-10-18,9189
00673R,期元大S＆P原油反1,10,0,10,群益金鼎-桃園,2023-10-18,9189
00795B,中信美國公債20年,10,0,10,群益金鼎-桃園,2023-10-18,9189
00877,復華中國5G,10,0,10,群益金鼎-桃園,2023-10-18,9189
00905,FT臺灣Smart,10,0,10,群益金鼎-桃園,2023-10-18,9189
3701,大眾控,14,4,10,群益金鼎-桃園,2023-10-18,9189
2201,裕隆,22,13,9,群益金鼎-桃園,2023-10-18,9189
00751B,元大AAA至A公司債,9,0,9,群益金鼎-桃園,2023-10-18,9189
2376,技嘉,24,15,9,群益金鼎-桃園,2023-10-18,9189
2851,中再保,8,0,8,群益金鼎-桃園,2023-10-18,9189
4720,德淵,8,0,8,群益金鼎-桃園,2023-10-18,9189
6138,茂達,8,0,8,群益金鼎-桃園,2023-10-18,9189
0056,元大高股息,109,3,106,群益金鼎-桃園,2023-10-19,9189
2010,春源,80,0,80,群益金鼎-桃園,2023-10-19,9189
2323,中環,80,0,80,群益金鼎-桃園,2023-10-19,9189
00878,國泰永續高股息,78,12,66,群益金鼎-桃園,2023-10-19,9189
2801,彰銀,50,0,50,群益金鼎-桃園,2023-10-19,9189
00679B,元大美債20年,43,5,38,群益金鼎-桃園,2023-10-19,9189
8054,安國,36,6,30,群益金鼎-桃園,2023-10-19,9189
1101,台泥,28,1,27,群益金鼎-桃園,2023-10-19,9189
2885,元大金,24,0,24,群益金鼎-桃園,2023-10-19,9189
00753L,中信中國50正2,25,2,23,群益金鼎-桃園,2023-10-19,9189
2888,新光金,22,0,22,群益金鼎-桃園,2023-10-19,9189
3231,緯創,64,43,21,群益金鼎-桃園,2023-10-19,9189
00655L,國泰中國A50正2,21,0,21,群益金鼎-桃園,2023-10-19,9189
3325,旭品,22,1,21,群益金鼎-桃園,2023-10-19,9189
00687B,國泰20年美債,25,5,20,群益金鼎-桃園,2023-10-19,9189
2543,皇昌,20,1,19,群益金鼎-桃園,2023-10-19,9189
00680L,元大美債20正2,21,2,19,群益金鼎-桃園,2023-10-19,9189
6139,亞翔,29,10,19,群益金鼎-桃園,2023-10-19,9189
00720B,元大投資級公司債,19,2,17,群益金鼎-桃園,2023-10-19,9189
1471,首利,18,1,17,群益金鼎-桃園,2023-10-19,9189
2002,中鋼,17,0,17,群益金鼎-桃園,2023-10-19,9189
00772B,中信高評級公司債,17,0,17,群益金鼎-桃園,2023-10-19,9189
00931B,統一美債20年,15,0,15,群益金鼎-桃園,2023-10-19,9189
1301,台塑,15,0,15,群益金鼎-桃園,2023-10-19,9189
00929,復華台灣科技優息,28,14,14,群益金鼎-桃園,2023-10-19,9189
6530,創威,53,39,14,群益金鼎-桃園,2023-10-19,9189
3035,智原,46,33,13,群益金鼎-桃園,2023-10-19,9189
3032,偉訓,13,1,12,群益金鼎-桃園,2023-10-19,9189
2328,廣宇,12,0,12,群益金鼎-桃園,2023-10-19,9189
00893,國泰智能電動車,11,0,11,群益金鼎-桃園,2023-10-19,9189
2355,敬鵬,14,3,11,群益金鼎-桃園,2023-10-19,9189
2388,威盛,38,27,11,群益金鼎-桃園,2023-10-19,9189
2457,飛宏,12,1,11,群益金鼎-桃園,2023-10-19,9189
3450,聯鈞,13,2,11,群益金鼎-桃園,2023-10-19,9189
1809,中釉,11,0,11,群益金鼎-桃園,2023-10-19,9189
5880,合庫金,10,0,10,群益金鼎-桃園,2023-10-19,9189
00688L,國泰20年美債正2,10,0,10,群益金鼎-桃園,2023-10-19,9189
2369,菱生,25,15,10,群益金鼎-桃園,2023-10-19,9189
6167,久正,10,0,10,群益金鼎-桃園,2023-10-19,9189
1609,大亞,10,0,10,群益金鼎-桃園,2023-10-19,9189
2903,遠百,10,0,10,群益金鼎-桃園,2023-10-19,9189
4503,金雨,12,2,10,群益金鼎-桃園,2023-10-19,9189
6768,志強-KY,9,0,9,群益金鼎-桃園,2023-10-19,9189
6231,系微,11,2,9,群益金鼎-桃園,2023-10-19,9189
8076,伍豐,9,0,9,群益金鼎-桃園,2023-10-19,9189
1513,中興電,10,2,8,群益金鼎-桃園,2023-10-19,9189
00885,富邦越南,9,1,8,群益金鼎-桃園,2023-10-19,9189
00922,國泰台灣領袖50,8,0,8,群益金鼎-桃園,2023-10-19,9189
1303,南亞,8,0,8,群益金鼎-桃園,2023-10-19,9189
3138,耀登,8,0,8,群益金鼎-桃園,2023-10-19,9189
2888,新光金,103,3,100,群益金鼎-桃園,2023-10-20,9189
00878,國泰永續高股息,88,5,83,群益金鼎-桃園,2023-10-20,9189
2891,中信金,79,4,75,群益金鼎-桃園,2023-10-20,9189
8176,智捷,66,0,66,群益金鼎-桃園,2023-10-20,9189
0056,元大高股息,51,1,50,群益金鼎-桃園,2023-10-20,9189
2436,偉詮電,55,6,49,群益金鼎-桃園,2023-10-20,9189
00712,復華富時不動產,36,0,36,群益金鼎-桃園,2023-10-20,9189
6770,力積電,37,4,33,群益金鼎-桃園,2023-10-20,9189
00929,復華台灣科技優息,43,11,32,群益金鼎-桃園,2023-10-20,9189
2010,春源,30,0,30,群益金鼎-桃園,2023-10-20,9189
1815,富喬,26,0,26,群益金鼎-桃園,2023-10-20,9189
00687B,國泰20年美債,22,0,22,群益金鼎-桃園,2023-10-20,9189
00882,中信中國高股息,22,0,22,群益金鼎-桃園,2023-10-20,9189
8040,九暘,25,4,21,群益金鼎-桃園,2023-10-20,9189
3450,聯鈞,24,3,21,群益金鼎-桃園,2023-10-20,9189
00877,復華中國5G,20,0,20,群益金鼎-桃園,2023-10-20,9189
3325,旭品,20,0,20,群益金鼎-桃園,2023-10-20,9189
2618,長榮航,30,11,19,群益金鼎-桃園,2023-10-20,9189
4129,聯合,20,1,19,群益金鼎-桃園,2023-10-20,9189
1303,南亞,19,0,19,群益金鼎-桃園,2023-10-20,9189
2883,凱基金,18,1,17,群益金鼎-桃園,2023-10-20,9189
1785,光洋科,27,10,17,群益金鼎-桃園,2023-10-20,9189
2834,臺企銀,17,0,17,群益金鼎-桃園,2023-10-20,9189
1471,首利,18,2,16,群益金鼎-桃園,2023-10-20,9189
00753L,中信中國50正2,17,1,16,群益金鼎-桃園,2023-10-20,9189
2317,鴻海,15,0,15,群益金鼎-桃園,2023-10-20,9189
2449,京元電子,43,28,15,群益金鼎-桃園,2023-10-20,9189
1101,台泥,14,0,14,群益金鼎-桃園,2023-10-20,9189
00720B,元大投資級公司債,14,0,14,群益金鼎-桃園,2023-10-20,9189
1324,地球,95,82,13,群益金鼎-桃園,2023-10-20,9189
00679B,元大美債20年,12,0,12,群益金鼎-桃園,2023-10-20,9189
9945,潤泰新,12,0,12,群益金鼎-桃園,2023-10-20,9189
2382,廣達,37,25,12,群益金鼎-桃園,2023-10-20,9189
3376,新日興,11,0,11,群益金鼎-桃園,2023-10-20,9189
1310,台苯,10,0,10,群益金鼎-桃園,2023-10-20,9189
9955,佳龍,51,41,10,群益金鼎-桃園,2023-10-20,9189
2637,慧洋-KY,10,0,10,群益金鼎-桃園,2023-10-20,9189
1909,榮成,10,0,10,群益金鼎-桃園,2023-10-20,9189
00922,國泰台灣領袖50,10,0,10,群益金鼎-桃園,2023-10-20,9189
9105,泰金寶-DR,10,0,10,群益金鼎-桃園,2023-10-20,9189
1605,華新,10,0,10,群益金鼎-桃園,2023-10-20,9189
2903,遠百,10,0,10,群益金鼎-桃園,2023-10-20,9189
3380,明泰,12,2,10,群益金鼎-桃園,2023-10-20,9189
2801,彰銀,13,3,10,群益金鼎-桃園,2023-10-20,9189
00772B,中信高評級公司債,9,0,9,群益金鼎-桃園,2023-10-20,9189
2885,元大金,9,0,9,群益金鼎-桃園,2023-10-20,9189
8033,雷虎,10,1,9,群益金鼎-桃園,2023-10-20,9189
1527,鑽全,9,0,9,群益金鼎-桃園,2023-10-20,9189
3709,鑫聯大投控,16,7,9,群益金鼎-桃園,2023-10-20,9189
1710,東聯,9,0,9,群益金鼎-桃園,2023-10-20,9189
00929,復華台灣科技優息,289,0,289,群益金鼎-桃園,2023-10-23,9189
00632R,元大台灣50反1,242,52,190,群益金鼎-桃園,2023-10-23,9189
00919,群益台灣精選高息,135,0,135,群益金鼎-桃園,2023-10-23,9189
2010,春源,100,0,100,群益金鼎-桃園,2023-10-23,9189
00712,復華富時不動產,73,0,73,群益金鼎-桃園,2023-10-23,9189
5355,佳總,43,3,40,群益金鼎-桃園,2023-10-23,9189
00751B,元大AAA至A公司債,32,0,32,群益金鼎-桃園,2023-10-23,9189
00642U,期元大S＆P石油,31,0,31,群益金鼎-桃園,2023-10-23,9189
2323,中環,30,1,29,群益金鼎-桃園,2023-10-23,9189
2883,凱基金,28,0,28,群益金鼎-桃園,2023-10-23,9189
00931B,統一美債20年,27,0,27,群益金鼎-桃園,2023-10-23,9189
2903,遠百,24,0,24,群益金鼎-桃園,2023-10-23,9189
1324,地球,43,22,21,群益金鼎-桃園,2023-10-23,9189
5348,正能量智能,20,0,20,群益金鼎-桃園,2023-10-23,9189
00887,永豐中國科技50大,20,0,20,群益金鼎-桃園,2023-10-23,9189
8105,凌巨,20,0,20,群益金鼎-桃園,2023-10-23,9189
8150,南茂,28,8,20,群益金鼎-桃園,2023-10-23,9189
2317,鴻海,40,22,18,群益金鼎-桃園,2023-10-23,9189
8040,九暘,22,4,18,群益金鼎-桃園,2023-10-23,9189
8110,華東,20,5,15,群益金鼎-桃園,2023-10-23,9189
1101,台泥,14,0,14,群益金鼎-桃園,2023-10-23,9189
1711,永光,20,6,14,群益金鼎-桃園,2023-10-23,9189
00922,國泰台灣領袖50,14,0,14,群益金鼎-桃園,2023-10-23,9189
6770,力積電,17,5,12,群益金鼎-桃園,2023-10-23,9189
2882,國泰金,11,0,11,群益金鼎-桃園,2023-10-23,9189
00637L,元大滬深300正2,16,5,11,群益金鼎-桃園,2023-10-23,9189
0056,元大高股息,17,7,10,群益金鼎-桃園,2023-10-23,9189
00687B,國泰20年美債,10,0,10,群益金鼎-桃園,2023-10-23,9189
2371,大同,10,0,10,群益金鼎-桃園,2023-10-23,9189
2449,京元電子,34,24,10,群益金鼎-桃園,2023-10-23,9189
9938,百和,10,0,10,群益金鼎-桃園,2023-10-23,9189
2801,彰銀,10,0,10,群益金鼎-桃園,2023-10-23,9189
2204,中華,10,0,10,群益金鼎-桃園,2023-10-23,9189
1303,南亞,10,0,10,群益金鼎-桃園,2023-10-23,9189
3094,聯傑,10,0,10,群益金鼎-桃園,2023-10-23,9189
5215,科嘉-KY,15,6,9,群益金鼎-桃園,2023-10-23,9189
6243,迅杰,12,4,8,群益金鼎-桃園,2023-10-23,9189
2419,仲琦,8,0,8,群益金鼎-桃園,2023-10-23,9189
2368,金像電,9,2,7,群益金鼎-桃園,2023-10-23,9189
1815,富喬,20,13,7,群益金鼎-桃園,2023-10-23,9189
2891,中信金,8,1,7,群益金鼎-桃園,2023-10-23,9189
5880,合庫金,7,0,7,群益金鼎-桃園,2023-10-23,9189
1301,台塑,6,0,6,群益金鼎-桃園,2023-10-23,9189
2892,第一金,6,0,6,群益金鼎-桃園,2023-10-23,9189
3715,定穎投控,60,54,6,群益金鼎-桃園,2023-10-23,9189
9945,潤泰新,6,0,6,群益金鼎-桃園,2023-10-23,9189
1402,遠東新,6,0,6,群益金鼎-桃園,2023-10-23,9189
0050,元大台灣50,6,0,6,群益金鼎-桃園,2023-10-23,9189
00679B,元大美債20年,5,0,5,群益金鼎-桃園,2023-10-23,9189
00720B,元大投資級公司債,6,1,5,群益金鼎-桃園,2023-10-23,9189
3260,威剛,95,8,87,群益金鼎-桃園,2023-10-24,9189
1611,中電,70,0,70,群益金鼎-桃園,2023-10-24,9189
2002,中鋼,52,2,50,群益金鼎-桃園,2023-10-24,9189
2369,菱生,172,141,31,群益金鼎-桃園,2023-10-24,9189
3339,泰谷,30,0,30,群益金鼎-桃園,2023-10-24,9189
00929,復華台灣科技優息,35,11,24,群益金鼎-桃園,2023-10-24,9189
6117,迎廣,21,0,21,群益金鼎-桃園,2023-10-24,9189
2313,華通,27,7,20,群益金鼎-桃園,2023-10-24,9189
1101,台泥,19,0,19,群益金鼎-桃園,2023-10-24,9189
00687B,國泰20年美債,19,0,19,群益金鼎-桃園,2023-10-24,9189
00878,國泰永續高股息,19,2,17,群益金鼎-桃園,2023-10-24,9189
2367,燿華,28,11,17,群益金鼎-桃園,2023-10-24,9189
1815,富喬,32,18,14,群益金鼎-桃園,2023-10-24,9189
2401,凌陽,25,12,13,群益金鼎-桃園,2023-10-24,9189
1909,榮成,13,0,13,群益金鼎-桃園,2023-10-24,9189
3706,神達,14,1,13,群益金鼎-桃園,2023-10-24,9189
2883,凱基金,14,1,13,群益金鼎-桃園,2023-10-24,9189
00712,復華富時不動產,13,0,13,群益金鼎-桃園,2023-10-24,9189
3576,聯合再生,12,0,12,群益金鼎-桃園,2023-10-24,9189
3715,定穎投控,48,37,11,群益金鼎-桃園,2023-10-24,9189
2887,台新金,12,1,11,群益金鼎-桃園,2023-10-24,9189
2880,華南金,11,0,11,群益金鼎-桃園,2023-10-24,9189
2303,聯電,19,9,10,群益金鼎-桃園,2023-10-24,9189
2834,臺企銀,10,0,10,群益金鼎-桃園,2023-10-24,9189
3022,威強電,10,0,10,群益金鼎-桃園,2023-10-24,9189
6188,廣明,11,1,10,群益金鼎-桃園,2023-10-24,9189
2409,友達,16,6,10,群益金鼎-桃園,2023-10-24,9189
3372,典範,10,0,10,群益金鼎-桃園,2023-10-24,9189
8438,昶昕,10,0,10,群益金鼎-桃園,2023-10-24,9189
4532,瑞智,10,0,10,群益金鼎-桃園,2023-10-24,9189
2449,京元電子,16,7,9,群益金鼎-桃園,2023-10-24,9189
00680L,元大美債20正2,8,0,8,群益金鼎-桃園,2023-10-24,9189
00900,富邦特選高股息30,9,1,8,群益金鼎-桃園,2023-10-24,9189
3363,上詮,10,2,8,群益金鼎-桃園,2023-10-24,9189
2891,中信金,8,1,7,群益金鼎-桃園,2023-10-24,9189
0050,元大台灣50,7,0,7,群益金鼎-桃園,2023-10-24,9189
2406,國碩,7,0,7,群益金鼎-桃園,2023-10-24,9189
6194,育富,8,1,7,群益金鼎-桃園,2023-10-24,9189
8069,元太,8,1,7,群益金鼎-桃園,2023-10-24,9189
00881,國泰台灣5G+,10,4,6,群益金鼎-桃園,2023-10-24,9189
2352,佳世達,8,2,6,群益金鼎-桃園,2023-10-24,9189
2723,美食-KY,6,0,6,群益金鼎-桃園,2023-10-24,9189
6530,創威,6,0,6,群益金鼎-桃園,2023-10-24,9189
2405,輔信,52,46,6,群益金鼎-桃園,2023-10-24,9189
00632R,元大台灣50反1,50,44,6,群益金鼎-桃園,2023-10-24,9189
6104,創惟,6,0,6,群益金鼎-桃園,2023-10-24,9189
9933,中鼎,6,0,6,群益金鼎-桃園,2023-10-24,9189
6901,鑽石投資,6,0,6,群益金鼎-桃園,2023-10-24,9189
2408,南亞科,20,14,6,群益金鼎-桃園,2023-10-24,9189
4960,誠美材,6,0,6,群益金鼎-桃園,2023-10-24,9189
00632R,元大台灣50反1,170,3,167,群益金鼎-桃園,2023-10-25,9189
2323,中環,50,4,46,群益金鼎-桃園,2023-10-25,9189
2010,春源,44,0,44,群益金鼎-桃園,2023-10-25,9189
3231,緯創,67,32,35,群益金鼎-桃園,2023-10-25,9189
00929,復華台灣科技優息,55,23,32,群益金鼎-桃園,2023-10-25,9189
3006,晶豪科,31,0,31,群益金鼎-桃園,2023-10-25,9189
2883,凱基金,28,5,23,群益金鼎-桃園,2023-10-25,9189
1721,三晃,54,31,23,群益金鼎-桃園,2023-10-25,9189
2316,楠梓電,22,0,22,群益金鼎-桃園,2023-10-25,9189
2516,新建,27,7,20,群益金鼎-桃園,2023-10-25,9189
8930,青鋼,20,0,20,群益金鼎-桃園,2023-10-25,9189
1524,耿鼎,171,153,18,群益金鼎-桃園,2023-10-25,9189
00931B,統一美債20年,18,0,18,群益金鼎-桃園,2023-10-25,9189
2543,皇昌,53,36,17,群益金鼎-桃園,2023-10-25,9189
3035,智原,30,14,16,群益金鼎-桃園,2023-10-25,9189
00753L,中信中國50正2,20,4,16,群益金鼎-桃園,2023-10-25,9189
3041,揚智,34,19,15,群益金鼎-桃園,2023-10-25,9189
00878,國泰永續高股息,15,0,15,群益金鼎-桃園,2023-10-25,9189
6274,台燿,31,16,15,群益金鼎-桃園,2023-10-25,9189
2731,雄獅,15,0,15,群益金鼎-桃園,2023-10-25,9189
00687B,國泰20年美債,15,0,15,群益金鼎-桃園,2023-10-25,9189
5381,合正,17,3,14,群益金鼎-桃園,2023-10-25,9189
5351,鈺創,23,9,14,群益金鼎-桃園,2023-10-25,9189
1514,亞力,15,2,13,群益金鼎-桃園,2023-10-25,9189
8110,華東,41,28,13,群益金鼎-桃園,2023-10-25,9189
2834,臺企銀,12,0,12,群益金鼎-桃園,2023-10-25,9189
3535,晶彩科,12,1,11,群益金鼎-桃園,2023-10-25,9189
1314,中石化,14,3,11,群益金鼎-桃園,2023-10-25,9189
9105,泰金寶-DR,11,0,11,群益金鼎-桃園,2023-10-25,9189
00706L,期元大S＆P日圓正2,10,0,10,群益金鼎-桃園,2023-10-25,9189
1471,首利,10,0,10,群益金鼎-桃園,2023-10-25,9189
5348,正能量智能,10,0,10,群益金鼎-桃園,2023-10-25,9189
2739,寒舍,10,0,10,群益金鼎-桃園,2023-10-25,9189
5704,老爺知,10,0,10,群益金鼎-桃園,2023-10-25,9189
2409,友達,30,20,10,群益金鼎-桃園,2023-10-25,9189
1477,聚陽,10,0,10,群益金鼎-桃園,2023-10-25,9189
00680L,元大美債20正2,15,5,10,群益金鼎-桃園,2023-10-25,9189
00933B,國泰10Y+金融債,12,3,9,群益金鼎-桃園,2023-10-25,9189
6593,台灣銘板,9,0,9,群益金鼎-桃園,2023-10-25,9189
00712,復華富時不動產,8,0,8,群益金鼎-桃園,2023-10-25,9189
2427,三商電,8,0,8,群益金鼎-桃園,2023-10-25,9189
8081,致新,8,0,8,群益金鼎-桃園,2023-10-25,9189
1303,南亞,8,0,8,群益金鼎-桃園,2023-10-25,9189
8040,九暘,14,7,7,群益金鼎-桃園,2023-10-25,9189
3313,斐成,7,0,7,群益金鼎-桃園,2023-10-25,9189
2002,中鋼,19,12,7,群益金鼎-桃園,2023-10-25,9189
2324,仁寶,11,5,6,群益金鼎-桃園,2023-10-25,9189
3374,精材,6,0,6,群益金鼎-桃園,2023-10-25,9189
1795,美時,10,4,6,群益金鼎-桃園,2023-10-25,9189
3078,僑威,17,11,6,群益金鼎-桃園,2023-10-25,9189
00919,群益台灣精選高息,90,11,79,群益金鼎-桃園,2023-10-26,9189
00929,復華台灣科技優息,78,7,71,群益金鼎-桃園,2023-10-26,9189
00706L,期元大S＆P日圓正2,65,0,65,群益金鼎-桃園,2023-10-26,9189
2303,聯電,87,25,62,群益金鼎-桃園,2023-10-26,9189
00878,國泰永續高股息,56,4,52,群益金鼎-桃園,2023-10-26,9189
4960,誠美材,50,1,49,群益金鼎-桃園,2023-10-26,9189
8110,華東,45,7,38,群益金鼎-桃園,2023-10-26,9189
00715L,期街口布蘭特正2,35,1,34,群益金鼎-桃園,2023-10-26,9189
2884,玉山金,31,0,31,群益金鼎-桃園,2023-10-26,9189
4552,力達-KY,33,2,31,群益金鼎-桃園,2023-10-26,9189
9950,萬國通,30,0,30,群益金鼎-桃園,2023-10-26,9189
00712,復華富時不動產,28,0,28,群益金鼎-桃園,2023-10-26,9189
0056,元大高股息,37,9,28,群益金鼎-桃園,2023-10-26,9189
2313,華通,29,2,27,群益金鼎-桃園,2023-10-26,9189
1605,華新,20,0,20,群益金鼎-桃園,2023-10-26,9189
1101,台泥,20,0,20,群益金鼎-桃園,2023-10-26,9189
00637L,元大滬深300正2,17,0,17,群益金鼎-桃園,2023-10-26,9189
2543,皇昌,20,3,17,群益金鼎-桃園,2023-10-26,9189
2890,永豐金,25,8,17,群益金鼎-桃園,2023-10-26,9189
3006,晶豪科,31,14,17,群益金鼎-桃園,2023-10-26,9189
00885,富邦越南,16,0,16,群益金鼎-桃園,2023-10-26,9189
3037,欣興,41,26,15,群益金鼎-桃園,2023-10-26,9189
00687B,國泰20年美債,14,0,14,群益金鼎-桃園,2023-10-26,9189
00922,國泰台灣領袖50,14,0,14,群益金鼎-桃園,2023-10-26,9189
0050,元大台灣50,17,4,13,群益金鼎-桃園,2023-10-26,9189
3055,蔚華科,22,9,13,群益金鼎-桃園,2023-10-26,9189
2883,凱基金,15,3,12,群益金鼎-桃園,2023-10-26,9189
2515,中工,22,10,12,群益金鼎-桃園,2023-10-26,9189
2388,威盛,26,14,12,群益金鼎-桃園,2023-10-26,9189
2888,新光金,12,0,12,群益金鼎-桃園,2023-10-26,9189
2344,華邦電,17,6,11,群益金鼎-桃園,2023-10-26,9189
6117,迎廣,27,16,11,群益金鼎-桃園,2023-10-26,9189
2317,鴻海,13,3,10,群益金鼎-桃園,2023-10-26,9189
00679B,元大美債20年,10,0,10,群益金鼎-桃園,2023-10-26,9189
2368,金像電,17,7,10,群益金鼎-桃園,2023-10-26,9189
00900,富邦特選高股息30,12,2,10,群益金鼎-桃園,2023-10-26,9189
2409,友達,10,0,10,群益金鼎-桃園,2023-10-26,9189
00772B,中信高評級公司債,10,0,10,群益金鼎-桃園,2023-10-26,9189
00633L,富邦上証正2,10,0,10,群益金鼎-桃園,2023-10-26,9189
2887,台新金,10,0,10,群益金鼎-桃園,2023-10-26,9189
1909,榮成,10,0,10,群益金鼎-桃園,2023-10-26,9189
2468,華經,11,1,10,群益金鼎-桃園,2023-10-26,9189
3380,明泰,10,0,10,群益金鼎-桃園,2023-10-26,9189
2330,台積電,11,1,10,群益金鼎-桃園,2023-10-26,9189
1524,耿鼎,53,44,9,群益金鼎-桃園,2023-10-26,9189
3122,笙泉,9,0,9,群益金鼎-桃園,2023-10-26,9189
2637,慧洋-KY,9,0,9,群益金鼎-桃園,2023-10-26,9189
1504,東元,10,1,9,群益金鼎-桃園,2023-10-26,9189
3715,定穎投控,31,22,9,群益金鼎-桃園,2023-10-26,9189
2308,台達電,9,0,9,群益金鼎-桃園,2023-10-26,9189
00929,復華台灣科技優息,160,0,160,群益金鼎-桃園,2023-10-27,9189
00632R,元大台灣50反1,77,0,77,群益金鼎-桃園,2023-10-27,9189
2618,長榮航,67,12,55,群益金鼎-桃園,2023-10-27,9189
2010,春源,50,0,50,群益金鼎-桃園,2023-10-27,9189
2425,承啟,34,0,34,群益金鼎-桃園,2023-10-27,9189
5381,合正,33,0,33,群益金鼎-桃園,2023-10-27,9189
2323,中環,31,0,31,群益金鼎-桃園,2023-10-27,9189
6216,居易,30,6,24,群益金鼎-桃園,2023-10-27,9189
3704,合勤控,40,16,24,群益金鼎-桃園,2023-10-27,9189
2201,裕隆,26,3,23,群益金鼎-桃園,2023-10-27,9189
00885,富邦越南,23,0,23,群益金鼎-桃園,2023-10-27,9189
8044,網家,19,1,18,群益金鼎-桃園,2023-10-27,9189
3078,僑威,22,4,18,群益金鼎-桃園,2023-10-27,9189
1609,大亞,15,0,15,群益金鼎-桃園,2023-10-27,9189
2388,威盛,21,6,15,群益金鼎-桃園,2023-10-27,9189
1603,華電,15,0,15,群益金鼎-桃園,2023-10-27,9189
2883,凱基金,14,0,14,群益金鼎-桃園,2023-10-27,9189
2486,一詮,12,0,12,群益金鼎-桃園,2023-10-27,9189
2485,兆赫,14,2,12,群益金鼎-桃園,2023-10-27,9189
00712,復華富時不動產,11,0,11,群益金鼎-桃園,2023-10-27,9189
2882,國泰金,11,0,11,群益金鼎-桃園,2023-10-27,9189
6188,廣明,11,0,11,群益金鼎-桃園,2023-10-27,9189
2498,宏達電,11,1,10,群益金鼎-桃園,2023-10-27,9189
00881,國泰台灣5G+,10,0,10,群益金鼎-桃園,2023-10-27,9189
4909,新復興,10,0,10,群益金鼎-桃園,2023-10-27,9189
8215,明基材,10,0,10,群益金鼎-桃園,2023-10-27,9189
8936,國統,10,0,10,群益金鼎-桃園,2023-10-27,9189
3062,建漢,8,0,8,群益金鼎-桃園,2023-10-27,9189
6168,宏齊,8,0,8,群益金鼎-桃園,2023-10-27,9189
2329,華泰,13,5,8,群益金鼎-桃園,2023-10-27,9189
2376,技嘉,22,14,8,群益金鼎-桃園,2023-10-27,9189
1101,台泥,8,1,7,群益金鼎-桃園,2023-10-27,9189
3088,艾訊,7,0,7,群益金鼎-桃園,2023-10-27,9189
00919,群益台灣精選高息,7,0,7,群益金鼎-桃園,2023-10-27,9189
6114,久威,8,1,7,群益金鼎-桃園,2023-10-27,9189
0056,元大高股息,12,5,7,群益金鼎-桃園,2023-10-27,9189
2481,強茂,6,0,6,群益金鼎-桃園,2023-10-27,9189
2352,佳世達,6,0,6,群益金鼎-桃園,2023-10-27,9189
3260,威剛,18,12,6,群益金鼎-桃園,2023-10-27,9189
3346,麗清,7,1,6,群益金鼎-桃園,2023-10-27,9189
00631L,元大台灣50正2,5,0,5,群益金鼎-桃園,2023-10-27,9189
3339,泰谷,5,0,5,群益金鼎-桃園,2023-10-27,9189
3317,尼克森,6,1,5,群益金鼎-桃園,2023-10-27,9189
5314,世紀,5,0,5,群益金鼎-桃園,2023-10-27,9189
2015,豐興,5,0,5,群益金鼎-桃園,2023-10-27,9189
00674R,期元大S＆P黃金反1,5,0,5,群益金鼎-桃園,2023-10-27,9189
3432,台端,5,0,5,群益金鼎-桃園,2023-10-27,9189
1324,地球,7,2,5,群益金鼎-桃園,2023-10-27,9189
3035,智原,9,4,5,群益金鼎-桃園,2023-10-27,9189
2887,台新金,5,0,5,群益金鼎-桃園,2023-10-27,9189
2317,鴻海,109,16,93,群益金鼎-桃園,2023-10-30,9189
8110,華東,90,0,90,群益金鼎-桃園,2023-10-30,9189
00680L,元大美債20正2,61,3,58,群益金鼎-桃園,2023-10-30,9189
2891,中信金,46,0,46,群益金鼎-桃園,2023-10-30,9189
2010,春源,41,0,41,群益金鼎-桃園,2023-10-30,9189
00712,復華富時不動產,41,1,40,群益金鼎-桃園,2023-10-30,9189
2344,華邦電,50,11,39,群益金鼎-桃園,2023-10-30,9189
3715,定穎投控,68,33,35,群益金鼎-桃園,2023-10-30,9189
2390,云辰,34,0,34,群益金鼎-桃園,2023-10-30,9189
3576,聯合再生,47,14,33,群益金鼎-桃園,2023-10-30,9189
5880,合庫金,41,8,33,群益金鼎-桃園,2023-10-30,9189
2880,華南金,30,0,30,群益金鼎-桃園,2023-10-30,9189
3481,群創,101,75,26,群益金鼎-桃園,2023-10-30,9189
3290,東浦,22,0,22,群益金鼎-桃園,2023-10-30,9189
2867,三商壽,20,0,20,群益金鼎-桃園,2023-10-30,9189
00878,國泰永續高股息,35,16,19,群益金鼎-桃園,2023-10-30,9189
1524,耿鼎,22,5,17,群益金鼎-桃園,2023-10-30,9189
3231,緯創,50,33,17,群益金鼎-桃園,2023-10-30,9189
5351,鈺創,21,6,15,群益金鼎-桃園,2023-10-30,9189
1303,南亞,14,0,14,群益金鼎-桃園,2023-10-30,9189
2610,華航,14,0,14,群益金鼎-桃園,2023-10-30,9189
2369,菱生,30,16,14,群益金鼎-桃園,2023-10-30,9189
3260,威剛,19,6,13,群益金鼎-桃園,2023-10-30,9189
00912,中信臺灣智慧50,12,0,12,群益金鼎-桃園,2023-10-30,9189
2324,仁寶,11,0,11,群益金鼎-桃園,2023-10-30,9189
00881,國泰台灣5G+,11,0,11,群益金鼎-桃園,2023-10-30,9189
00679B,元大美債20年,10,0,10,群益金鼎-桃園,2023-10-30,9189
2801,彰銀,10,0,10,群益金鼎-桃園,2023-10-30,9189
00753L,中信中國50正2,10,0,10,群益金鼎-桃園,2023-10-30,9189
3669,圓展,13,4,9,群益金鼎-桃園,2023-10-30,9189
2337,旺宏,9,0,9,群益金鼎-桃園,2023-10-30,9189
4162,智擎,8,0,8,群益金鼎-桃園,2023-10-30,9189
2618,長榮航,12,4,8,群益金鼎-桃園,2023-10-30,9189
8358,金居,8,0,8,群益金鼎-桃園,2023-10-30,9189
2887,台新金,7,0,7,群益金鼎-桃園,2023-10-30,9189
0050,元大台灣50,8,2,6,群益金鼎-桃園,2023-10-30,9189
6168,宏齊,18,12,6,群益金鼎-桃園,2023-10-30,9189
2002,中鋼,7,1,6,群益金鼎-桃園,2023-10-30,9189
6443,元晶,24,18,6,群益金鼎-桃園,2023-10-30,9189
2884,玉山金,7,1,6,群益金鼎-桃園,2023-10-30,9189
2330,台積電,6,1,5,群益金鼎-桃園,2023-10-30,9189
0056,元大高股息,5,0,5,群益金鼎-桃園,2023-10-30,9189
5347,世界,5,0,5,群益金鼎-桃園,2023-10-30,9189
1319,東陽,6,1,5,群益金鼎-桃園,2023-10-30,9189
2515,中工,5,0,5,群益金鼎-桃園,2023-10-30,9189
8996,高力,5,0,5,群益金鼎-桃園,2023-10-30,9189
2305,全友,5,0,5,群益金鼎-桃園,2023-10-30,9189
00907,永豐優息存股,5,0,5,群益金鼎-桃園,2023-10-30,9189
6114,久威,5,0,5,群益金鼎-桃園,2023-10-30,9189
3010,華立,5,0,5,群益金鼎-桃園,2023-10-30,9189
4188,安克,47,0,47,群益金鼎-桃園,2023-10-31,9189
2382,廣達,59,20,39,群益金鼎-桃園,2023-10-31,9189
0056,元大高股息,33,0,33,群益金鼎-桃園,2023-10-31,9189
2449,京元電子,34,3,31,群益金鼎-桃園,2023-10-31,9189
2323,中環,30,0,30,群益金鼎-桃園,2023-10-31,9189
6271,同欣電,31,1,30,群益金鼎-桃園,2023-10-31,9189
00753L,中信中國50正2,30,0,30,群益金鼎-桃園,2023-10-31,9189
3138,耀登,30,1,29,群益金鼎-桃園,2023-10-31,9189
00931B,統一美債20年,28,0,28,群益金鼎-桃園,2023-10-31,9189
6153,嘉聯益,27,0,27,群益金鼎-桃園,2023-10-31,9189
2344,華邦電,46,22,24,群益金鼎-桃園,2023-10-31,9189
1909,榮成,20,0,20,群益金鼎-桃園,2023-10-31,9189
2887,台新金,20,0,20,群益金鼎-桃園,2023-10-31,9189
3704,合勤控,37,18,19,群益金鼎-桃園,2023-10-31,9189
3548,兆利,29,10,19,群益金鼎-桃園,2023-10-31,9189
3380,明泰,19,1,18,群益金鼎-桃園,2023-10-31,9189
5907,大洋-KY,18,0,18,群益金鼎-桃園,2023-10-31,9189
2417,圓剛,20,3,17,群益金鼎-桃園,2023-10-31,9189
00637L,元大滬深300正2,16,0,16,群益金鼎-桃園,2023-10-31,9189
1522,堤維西,16,1,15,群益金鼎-桃園,2023-10-31,9189
2402,毅嘉,15,1,14,群益金鼎-桃園,2023-10-31,9189
3032,偉訓,17,3,14,群益金鼎-桃園,2023-10-31,9189
2492,華新科,14,0,14,群益金鼎-桃園,2023-10-31,9189
00713,元大台灣高息低波,14,1,13,群益金鼎-桃園,2023-10-31,9189
3035,智原,34,22,12,群益金鼎-桃園,2023-10-31,9189
2637,慧洋-KY,12,0,12,群益金鼎-桃園,2023-10-31,9189
8222,寶一,12,0,12,群益金鼎-桃園,2023-10-31,9189
2356,英業達,11,0,11,群益金鼎-桃園,2023-10-31,9189
3094,聯傑,23,12,11,群益金鼎-桃園,2023-10-31,9189
00922,國泰台灣領袖50,11,0,11,群益金鼎-桃園,2023-10-31,9189
00712,復華富時不動產,12,1,11,群益金鼎-桃園,2023-10-31,9189
00650L,復華香港正2,11,0,11,群益金鼎-桃園,2023-10-31,9189
2303,聯電,15,5,10,群益金鼎-桃園,2023-10-31,9189
9905,大華,10,0,10,群益金鼎-桃園,2023-10-31,9189
00877,復華中國5G,10,0,10,群益金鼎-桃園,2023-10-31,9189
1584,精剛,10,0,10,群益金鼎-桃園,2023-10-31,9189
6117,迎廣,20,10,10,群益金鼎-桃園,2023-10-31,9189
2312,金寶,10,0,10,群益金鼎-桃園,2023-10-31,9189
00893,國泰智能電動車,10,0,10,群益金鼎-桃園,2023-10-31,9189
2010,春源,10,0,10,群益金鼎-桃園,2023-10-31,9189
2376,技嘉,24,15,9,群益金鼎-桃園,2023-10-31,9189
1504,東元,21,12,9,群益金鼎-桃園,2023-10-31,9189
4979,華星光,13,4,9,群益金鼎-桃園,2023-10-31,9189
3583,辛耘,11,2,9,群益金鼎-桃園,2023-10-31,9189
2352,佳世達,8,0,8,群益金鼎-桃園,2023-10-31,9189
2883,凱基金,21,13,8,群益金鼎-桃園,2023-10-31,9189
2301,光寶科,12,4,8,群益金鼎-桃園,2023-10-31,9189
2329,華泰,12,4,8,群益金鼎-桃園,2023-10-31,9189
2317,鴻海,24,17,7,群益金鼎-桃園,2023-10-31,9189
2884,玉山金,7,0,7,群益金鼎-桃園,2023-10-31,9189
00934,中信成長高股息,220,6,214,群益金鼎-桃園,2023-11-01,9189
00878,國泰永續高股息,136,0,136,群益金鼎-桃園,2023-11-01,9189
2618,長榮航,237,200,37,群益金鼎-桃園,2023-11-01,9189
6418,詠昇,35,2,33,群益金鼎-桃園,2023-11-01,9189
3105,穩懋,35,3,32,群益金鼎-桃園,2023-11-01,9189
1504,東元,34,3,31,群益金鼎-桃園,2023-11-01,9189
00919,群益台灣精選高息,29,0,29,群益金鼎-桃園,2023-11-01,9189
2401,凌陽,20,0,20,群益金鼎-桃園,2023-11-01,9189
2344,華邦電,23,4,19,群益金鼎-桃園,2023-11-01,9189
2382,廣達,21,6,15,群益金鼎-桃園,2023-11-01,9189
2748,雲品,18,3,15,群益金鼎-桃園,2023-11-01,9189
6117,迎廣,24,9,15,群益金鼎-桃園,2023-11-01,9189
00687B,國泰20年美債,13,1,12,群益金鼎-桃園,2023-11-01,9189
2002,中鋼,15,3,12,群益金鼎-桃園,2023-11-01,9189
00885,富邦越南,12,0,12,群益金鼎-桃園,2023-11-01,9189
4915,致伸,23,11,12,群益金鼎-桃園,2023-11-01,9189
4114,健喬,11,0,11,群益金鼎-桃園,2023-11-01,9189
4102,永日,11,0,11,群益金鼎-桃園,2023-11-01,9189
00680L,元大美債20正2,10,0,10,群益金鼎-桃園,2023-11-01,9189
2338,光罩,10,0,10,群益金鼎-桃園,2023-11-01,9189
5347,世界,10,0,10,群益金鼎-桃園,2023-11-01,9189
00706L,期元大S＆P日圓正2,10,0,10,群益金鼎-桃園,2023-11-01,9189
6143,振曜,10,0,10,群益金鼎-桃園,2023-11-01,9189
2887,台新金,10,0,10,群益金鼎-桃園,2023-11-01,9189
00753L,中信中國50正2,10,0,10,群益金鼎-桃園,2023-11-01,9189
6282,康舒,10,1,9,群益金鼎-桃園,2023-11-01,9189
4909,新復興,9,0,9,群益金鼎-桃園,2023-11-01,9189
4743,合一,26,17,9,群益金鼎-桃園,2023-11-01,9189
2369,菱生,15,6,9,群益金鼎-桃園,2023-11-01,9189
2317,鴻海,11,2,9,群益金鼎-桃園,2023-11-01,9189
00679B,元大美債20年,9,1,8,群益金鼎-桃園,2023-11-01,9189
00935,野村臺灣新科技50,8,0,8,群益金鼎-桃園,2023-11-01,9189
3290,東浦,8,0,8,群益金鼎-桃園,2023-11-01,9189
2739,寒舍,8,0,8,群益金鼎-桃園,2023-11-01,9189
2883,凱基金,8,0,8,群益金鼎-桃園,2023-11-01,9189
3374,精材,7,0,7,群益金鼎-桃園,2023-11-01,9189
2332,友訊,7,0,7,群益金鼎-桃園,2023-11-01,9189
3094,聯傑,21,14,7,群益金鼎-桃園,2023-11-01,9189
3346,麗清,7,0,7,群益金鼎-桃園,2023-11-01,9189
2409,友達,7,0,7,群益金鼎-桃園,2023-11-01,9189
00631L,元大台灣50正2,6,0,6,群益金鼎-桃園,2023-11-01,9189
3704,合勤控,15,9,6,群益金鼎-桃園,2023-11-01,9189
00715L,期街口布蘭特正2,6,0,6,群益金鼎-桃園,2023-11-01,9189
5704,老爺知,9,3,6,群益金鼎-桃園,2023-11-01,9189
1603,華電,6,0,6,群益金鼎-桃園,2023-11-01,9189
1519,華城,8,3,5,群益金鼎-桃園,2023-11-01,9189
2353,宏��,5,0,5,群益金鼎-桃園,2023-11-01,9189
00641R,富邦日本反1,5,0,5,群益金鼎-桃園,2023-11-01,9189
3535,晶彩科,5,0,5,群益金鼎-桃園,2023-11-01,9189
3289,宜特,5,0,5,群益金鼎-桃園,2023-11-01,9189
1815,富喬,256,95,161,群益金鼎-桃園,2023-11-02,9189
2618,長榮航,128,39,89,群益金鼎-桃園,2023-11-02,9189
2010,春源,42,0,42,群益金鼎-桃園,2023-11-02,9189
00632R,元大台灣50反1,29,2,27,群益金鼎-桃園,2023-11-02,9189
6113,亞矽,28,4,24,群益金鼎-桃園,2023-11-02,9189
00642U,期元大S＆P石油,20,0,20,群益金鼎-桃園,2023-11-02,9189
3041,揚智,16,0,16,群益金鼎-桃園,2023-11-02,9189
5301,寶得利,16,0,16,群益金鼎-桃園,2023-11-02,9189
3715,定穎投控,118,102,16,群益金鼎-桃園,2023-11-02,9189
4908,前鼎,20,5,15,群益金鼎-桃園,2023-11-02,9189
3548,兆利,30,15,15,群益金鼎-桃園,2023-11-02,9189
6173,信昌電,14,2,12,群益金鼎-桃園,2023-11-02,9189
00931B,統一美債20年,12,0,12,群益金鼎-桃園,2023-11-02,9189
2417,圓剛,17,6,11,群益金鼎-桃園,2023-11-02,9189
8255,朋程,15,5,10,群益金鼎-桃園,2023-11-02,9189
6117,迎廣,20,10,10,群益金鼎-桃園,2023-11-02,9189
9958,世紀鋼,13,4,9,群益金鼎-桃園,2023-11-02,9189
8210,勤誠,13,4,9,群益金鼎-桃園,2023-11-02,9189
3036,文曄,12,4,8,群益金鼎-桃園,2023-11-02,9189
3002,歐格,17,9,8,群益金鼎-桃園,2023-11-02,9189
4967,十銓,23,15,8,群益金鼎-桃園,2023-11-02,9189
1795,美時,9,2,7,群益金鼎-桃園,2023-11-02,9189
1721,三晃,14,7,7,群益金鼎-桃園,2023-11-02,9189
00753L,中信中國50正2,7,0,7,群益金鼎-桃園,2023-11-02,9189
3005,神基,7,0,7,群益金鼎-桃園,2023-11-02,9189
2454,聯發科,13,6,7,群益金鼎-桃園,2023-11-02,9189
4402,郡都開發,6,0,6,群益金鼎-桃園,2023-11-02,9189
2457,飛宏,8,2,6,群益金鼎-桃園,2023-11-02,9189
00671R,富邦NASDAQ反1,6,0,6,群益金鼎-桃園,2023-11-02,9189
8299,群聯,6,0,6,群益金鼎-桃園,2023-11-02,9189
2356,英業達,8,3,5,群益金鼎-桃園,2023-11-02,9189
2241,艾姆勒,6,1,5,群益金鼎-桃園,2023-11-02,9189
6116,彩晶,5,0,5,群益金鼎-桃園,2023-11-02,9189
6168,宏齊,15,10,5,群益金鼎-桃園,2023-11-02,9189
5381,合正,5,0,5,群益金鼎-桃園,2023-11-02,9189
1907,永豐餘,5,0,5,群益金鼎-桃園,2023-11-02,9189
3025,星通,6,1,5,群益金鼎-桃園,2023-11-02,9189
3189,景碩,5,0,5,群益金鼎-桃園,2023-11-02,9189
3083,網龍,5,0,5,群益金鼎-桃園,2023-11-02,9189
00715L,期街口布蘭特正2,8,4,4,群益金鼎-桃園,2023-11-02,9189
3043,科風,12,8,4,群益金鼎-桃園,2023-11-02,9189
00664R,國泰臺灣加權反1,4,0,4,群益金鼎-桃園,2023-11-02,9189
4533,協易機,5,1,4,群益金鼎-桃園,2023-11-02,9189
3708,上緯投控,4,0,4,群益金鼎-桃園,2023-11-02,9189
1313,聯成,4,0,4,群益金鼎-桃園,2023-11-02,9189
2338,光罩,5,1,4,群益金鼎-桃園,2023-11-02,9189
2233,宇隆,4,0,4,群益金鼎-桃園,2023-11-02,9189
2337,旺宏,5,1,4,群益金鼎-桃園,2023-11-02,9189
4961,天鈺,3,0,3,群益金鼎-桃園,2023-11-02,9189
6443,元晶,3,0,3,群益金鼎-桃園,2023-11-02,9189
00929,復華台灣科技優息,78,3,75,群益金鼎-桃園,2023-11-03,9189
00632R,元大台灣50反1,68,0,68,群益金鼎-桃園,2023-11-03,9189
00931B,統一美債20年,67,0,67,群益金鼎-桃園,2023-11-03,9189
2363,矽統,168,112,56,群益金鼎-桃園,2023-11-03,9189
2618,長榮航,129,79,50,群益金鼎-桃園,2023-11-03,9189
8150,南茂,50,1,49,群益金鼎-桃園,2023-11-03,9189
00687B,國泰20年美債,49,1,48,群益金鼎-桃園,2023-11-03,9189
00878,國泰永續高股息,50,2,48,群益金鼎-桃園,2023-11-03,9189
3491,昇達科,48,2,46,群益金鼎-桃園,2023-11-03,9189
2010,春源,46,0,46,群益金鼎-桃園,2023-11-03,9189
5215,科嘉-KY,31,1,30,群益金鼎-桃園,2023-11-03,9189
2329,華泰,50,23,27,群益金鼎-桃園,2023-11-03,9189
1609,大亞,26,0,26,群益金鼎-桃園,2023-11-03,9189
2498,宏達電,50,24,26,群益金鼎-桃園,2023-11-03,9189
1101,台泥,23,0,23,群益金鼎-桃園,2023-11-03,9189
6120,達運,20,0,20,群益金鼎-桃園,2023-11-03,9189
2313,華通,41,21,20,群益金鼎-桃園,2023-11-03,9189
3704,合勤控,20,1,19,群益金鼎-桃園,2023-11-03,9189
00715L,期街口布蘭特正2,23,5,18,群益金鼎-桃園,2023-11-03,9189
00679B,元大美債20年,19,2,17,群益金鼎-桃園,2023-11-03,9189
1477,聚陽,16,1,15,群益金鼎-桃園,2023-11-03,9189
00720B,元大投資級公司債,14,0,14,群益金鼎-桃園,2023-11-03,9189
2468,華經,14,1,13,群益金鼎-桃園,2023-11-03,9189
5521,工信,13,0,13,群益金鼎-桃園,2023-11-03,9189
2317,鴻海,45,32,13,群益金鼎-桃園,2023-11-03,9189
2458,義隆,31,19,12,群益金鼎-桃園,2023-11-03,9189
00919,群益台灣精選高息,14,2,12,群益金鼎-桃園,2023-11-03,9189
2382,廣達,22,11,11,群益金鼎-桃園,2023-11-03,9189
2301,光寶科,15,4,11,群益金鼎-桃園,2023-11-03,9189
9955,佳龍,11,0,11,群益金鼎-桃園,2023-11-03,9189
00905,FT臺灣Smart,10,0,10,群益金鼎-桃園,2023-11-03,9189
00753L,中信中國50正2,20,10,10,群益金鼎-桃園,2023-11-03,9189
1314,中石化,10,0,10,群益金鼎-桃園,2023-11-03,9189
2838,聯邦銀,10,0,10,群益金鼎-桃園,2023-11-03,9189
9919,康那香,10,0,10,群益金鼎-桃園,2023-11-03,9189
2014,中鴻,11,1,10,群益金鼎-桃園,2023-11-03,9189
00935,野村臺灣新科技50,9,0,9,群益金鼎-桃園,2023-11-03,9189
1471,首利,13,4,9,群益金鼎-桃園,2023-11-03,9189
3545,敦泰,22,14,8,群益金鼎-桃園,2023-11-03,9189
00671R,富邦NASDAQ反1,8,0,8,群益金鼎-桃園,2023-11-03,9189
2465,麗臺,9,1,8,群益金鼎-桃園,2023-11-03,9189
2406,國碩,10,2,8,群益金鼎-桃園,2023-11-03,9189
6874,倍力,8,0,8,群益金鼎-桃園,2023-11-03,9189
6509,聚和,8,0,8,群益金鼎-桃園,2023-11-03,9189
4961,天鈺,8,0,8,群益金鼎-桃園,2023-11-03,9189
1524,耿鼎,32,25,7,群益金鼎-桃園,2023-11-03,9189
00900,富邦特選高股息30,7,0,7,群益金鼎-桃園,2023-11-03,9189
3037,欣興,15,9,6,群益金鼎-桃園,2023-11-03,9189
2855,統一證,6,0,6,群益金鼎-桃園,2023-11-03,9189
3576,聯合再生,8,2,6,群益金鼎-桃園,2023-11-03,9189
00632R,元大台灣50反1,108,0,108,群益金鼎-桃園,2023-11-06,9189
2618,長榮航,98,26,72,群益金鼎-桃園,2023-11-06,9189
6153,嘉聯益,50,0,50,群益金鼎-桃園,2023-11-06,9189
1314,中石化,50,5,45,群益金鼎-桃園,2023-11-06,9189
2369,菱生,35,1,34,群益金鼎-桃園,2023-11-06,9189
6156,松上,47,16,31,群益金鼎-桃園,2023-11-06,9189
00687B,國泰20年美債,35,7,28,群益金鼎-桃園,2023-11-06,9189
2363,矽統,61,33,28,群益金鼎-桃園,2023-11-06,9189
6603,富強鑫,31,4,27,群益金鼎-桃園,2023-11-06,9189
00679B,元大美債20年,27,1,26,群益金鼎-桃園,2023-11-06,9189
00905,FT臺灣Smart,25,0,25,群益金鼎-桃園,2023-11-06,9189
2406,國碩,29,4,25,群益金鼎-桃園,2023-11-06,9189
3706,神達,25,1,24,群益金鼎-桃園,2023-11-06,9189
3306,鼎天,24,4,20,群益金鼎-桃園,2023-11-06,9189
5348,正能量智能,20,0,20,群益金鼎-桃園,2023-11-06,9189
00664R,國泰臺灣加權反1,20,0,20,群益金鼎-桃園,2023-11-06,9189
00696B,富邦美債20年,20,0,20,群益金鼎-桃園,2023-11-06,9189
1721,三晃,38,19,19,群益金鼎-桃園,2023-11-06,9189
6770,力積電,30,12,18,群益金鼎-桃園,2023-11-06,9189
3491,昇達科,18,0,18,群益金鼎-桃園,2023-11-06,9189
2390,云辰,21,3,18,群益金鼎-桃園,2023-11-06,9189
00919,群益台灣精選高息,18,2,16,群益金鼎-桃園,2023-11-06,9189
2405,輔信,15,0,15,群益金鼎-桃園,2023-11-06,9189
2393,億光,15,0,15,群益金鼎-桃園,2023-11-06,9189
5880,合庫金,17,2,15,群益金鼎-桃園,2023-11-06,9189
6117,迎廣,28,14,14,群益金鼎-桃園,2023-11-06,9189
00715L,期街口布蘭特正2,14,0,14,群益金鼎-桃園,2023-11-06,9189
2485,兆赫,27,14,13,群益金鼎-桃園,2023-11-06,9189
2313,華通,44,31,13,群益金鼎-桃園,2023-11-06,9189
8110,華東,12,0,12,群益金鼎-桃園,2023-11-06,9189
2610,華航,20,8,12,群益金鼎-桃園,2023-11-06,9189
2388,威盛,83,72,11,群益金鼎-桃園,2023-11-06,9189
3078,僑威,11,0,11,群益金鼎-桃園,2023-11-06,9189
8358,金居,11,0,11,群益金鼎-桃園,2023-11-06,9189
1809,中釉,14,3,11,群益金鼎-桃園,2023-11-06,9189
2417,圓剛,21,10,11,群益金鼎-桃園,2023-11-06,9189
00934,中信成長高股息,10,0,10,群益金鼎-桃園,2023-11-06,9189
3450,聯鈞,17,8,9,群益金鼎-桃園,2023-11-06,9189
4147,中裕,9,0,9,群益金鼎-桃園,2023-11-06,9189
2439,美律,17,8,9,群益金鼎-桃園,2023-11-06,9189
8163,達方,13,5,8,群益金鼎-桃園,2023-11-06,9189
4743,合一,10,2,8,群益金鼎-桃園,2023-11-06,9189
3094,聯傑,16,8,8,群益金鼎-桃園,2023-11-06,9189
00795B,中信美國公債20年,8,0,8,群益金鼎-桃園,2023-11-06,9189
1722,台肥,10,2,8,群益金鼎-桃園,2023-11-06,9189
00671R,富邦NASDAQ反1,8,0,8,群益金鼎-桃園,2023-11-06,9189
4979,華星光,11,3,8,群益金鼎-桃園,2023-11-06,9189
3041,揚智,7,0,7,群益金鼎-桃園,2023-11-06,9189
1514,亞力,8,1,7,群益金鼎-桃園,2023-11-06,9189
00722B,群益投資級電信債,7,0,7,群益金鼎-桃園,2023-11-06,9189
00671R,富邦NASDAQ反1,80,0,80,群益金鼎-桃園,2023-11-07,9189
2363,矽統,98,41,57,群益金鼎-桃園,2023-11-07,9189
2816,旺旺保,51,1,50,群益金鼎-桃園,2023-11-07,9189
3545,敦泰,45,3,42,群益金鼎-桃園,2023-11-07,9189
2498,宏達電,36,1,35,群益金鼎-桃園,2023-11-07,9189
2739,寒舍,40,5,35,群益金鼎-桃園,2023-11-07,9189
2344,華邦電,32,1,31,群益金鼎-桃園,2023-11-07,9189
2458,義隆,31,2,29,群益金鼎-桃園,2023-11-07,9189
2388,威盛,50,28,22,群益金鼎-桃園,2023-11-07,9189
2618,長榮航,32,11,21,群益金鼎-桃園,2023-11-07,9189
8176,智捷,20,0,20,群益金鼎-桃園,2023-11-07,9189
3024,憶聲,20,0,20,群益金鼎-桃園,2023-11-07,9189
8432,東生華,21,1,20,群益金鼎-桃園,2023-11-07,9189
1609,大亞,19,0,19,群益金鼎-桃園,2023-11-07,9189
6461,益得,19,0,19,群益金鼎-桃園,2023-11-07,9189
6603,富強鑫,23,5,18,群益金鼎-桃園,2023-11-07,9189
2453,凌群,51,33,18,群益金鼎-桃園,2023-11-07,9189
2486,一詮,17,0,17,群益金鼎-桃園,2023-11-07,9189
00687B,國泰20年美債,26,10,16,群益金鼎-桃園,2023-11-07,9189
00795B,中信美國公債20年,14,0,14,群益金鼎-桃園,2023-11-07,9189
1504,東元,44,30,14,群益金鼎-桃園,2023-11-07,9189
2002,中鋼,14,0,14,群益金鼎-桃園,2023-11-07,9189
00878,國泰永續高股息,14,1,13,群益金鼎-桃園,2023-11-07,9189
5439,高技,12,0,12,群益金鼎-桃園,2023-11-07,9189
2201,裕隆,12,0,12,群益金鼎-桃園,2023-11-07,9189
9958,世紀鋼,11,0,11,群益金鼎-桃園,2023-11-07,9189
00642U,期元大S＆P石油,11,0,11,群益金鼎-桃園,2023-11-07,9189
8215,明基材,10,0,10,群益金鼎-桃園,2023-11-07,9189
2601,益航,10,0,10,群益金鼎-桃園,2023-11-07,9189
3290,東浦,10,0,10,群益金鼎-桃園,2023-11-07,9189
2610,華航,22,12,10,群益金鼎-桃園,2023-11-07,9189
00679B,元大美債20年,14,5,9,群益金鼎-桃園,2023-11-07,9189
6237,驊訊,9,1,8,群益金鼎-桃園,2023-11-07,9189
8930,青鋼,8,0,8,群益金鼎-桃園,2023-11-07,9189
00934,中信成長高股息,16,8,8,群益金鼎-桃園,2023-11-07,9189
1721,三晃,28,20,8,群益金鼎-桃園,2023-11-07,9189
2883,凱基金,7,0,7,群益金鼎-桃園,2023-11-07,9189
00715L,期街口布蘭特正2,8,1,7,群益金鼎-桃園,2023-11-07,9189
2634,漢翔,8,1,7,群益金鼎-桃園,2023-11-07,9189
1316,上曜,7,0,7,群益金鼎-桃園,2023-11-07,9189
00919,群益台灣精選高息,7,0,7,群益金鼎-桃園,2023-11-07,9189
2358,廷鑫,7,0,7,群益金鼎-桃園,2023-11-07,9189
3105,穩懋,7,0,7,群益金鼎-桃園,2023-11-07,9189
2317,鴻海,7,1,6,群益金鼎-桃園,2023-11-07,9189
2421,建準,8,2,6,群益金鼎-桃園,2023-11-07,9189
6189,豐藝,26,20,6,群益金鼎-桃園,2023-11-07,9189
00935,野村臺灣新科技50,6,0,6,群益金鼎-桃園,2023-11-07,9189
2408,南亞科,9,3,6,群益金鼎-桃園,2023-11-07,9189
2364,倫飛,6,0,6,群益金鼎-桃園,2023-11-07,9189
2337,旺宏,6,1,5,群益金鼎-桃園,2023-11-07,9189
2412,中華電,161,12,149,群益金鼎-桃園,2023-11-08,9189
00936,台新永續高息中小,72,2,70,群益金鼎-桃園,2023-11-08,9189
00632R,元大台灣50反1,56,5,51,群益金鼎-桃園,2023-11-08,9189
2010,春源,50,0,50,群益金鼎-桃園,2023-11-08,9189
2618,長榮航,99,52,47,群益金鼎-桃園,2023-11-08,9189
6117,迎廣,125,84,41,群益金鼎-桃園,2023-11-08,9189
2609,陽明,41,0,41,群益金鼎-桃園,2023-11-08,9189
2363,矽統,112,72,40,群益金鼎-桃園,2023-11-08,9189
1815,富喬,70,35,35,群益金鼎-桃園,2023-11-08,9189
00715L,期街口布蘭特正2,40,10,30,群益金鼎-桃園,2023-11-08,9189
2388,威盛,54,30,24,群益金鼎-桃園,2023-11-08,9189
4533,協易機,22,0,22,群益金鼎-桃園,2023-11-08,9189
00642U,期元大S＆P石油,22,0,22,群益金鼎-桃園,2023-11-08,9189
4908,前鼎,22,3,19,群益金鼎-桃園,2023-11-08,9189
1301,台塑,16,0,16,群益金鼎-桃園,2023-11-08,9189
2367,燿華,17,1,16,群益金鼎-桃園,2023-11-08,9189
3260,威剛,17,1,16,群益金鼎-桃園,2023-11-08,9189
5347,世界,15,1,14,群益金鼎-桃園,2023-11-08,9189
2002,中鋼,15,2,13,群益金鼎-桃園,2023-11-08,9189
3376,新日興,14,1,13,群益金鼎-桃園,2023-11-08,9189
2344,華邦電,12,0,12,群益金鼎-桃園,2023-11-08,9189
6139,亞翔,17,5,12,群益金鼎-桃園,2023-11-08,9189
3228,金麗科,13,2,11,群益金鼎-桃園,2023-11-08,9189
2014,中鴻,14,3,11,群益金鼎-桃園,2023-11-08,9189
4967,十銓,17,6,11,群益金鼎-桃園,2023-11-08,9189
6538,倉和,12,1,11,群益金鼎-桃園,2023-11-08,9189
00680L,元大美債20正2,11,0,11,群益金鼎-桃園,2023-11-08,9189
3481,群創,10,0,10,群益金鼎-桃園,2023-11-08,9189
2816,旺旺保,19,9,10,群益金鼎-桃園,2023-11-08,9189
3162,精確,13,3,10,群益金鼎-桃園,2023-11-08,9189
1467,南緯,10,0,10,群益金鼎-桃園,2023-11-08,9189
1477,聚陽,10,0,10,群益金鼎-桃園,2023-11-08,9189
8150,南茂,11,1,10,群益金鼎-桃園,2023-11-08,9189
3374,精材,9,0,9,群益金鼎-桃園,2023-11-08,9189
00935,野村臺灣新科技50,9,0,9,群益金鼎-桃園,2023-11-08,9189
3014,聯陽,10,2,8,群益金鼎-桃園,2023-11-08,9189
2402,毅嘉,8,0,8,群益金鼎-桃園,2023-11-08,9189
4188,安克,8,0,8,群益金鼎-桃園,2023-11-08,9189
2308,台達電,7,0,7,群益金鼎-桃園,2023-11-08,9189
3051,力特,9,2,7,群益金鼎-桃園,2023-11-08,9189
9919,康那香,7,0,7,群益金鼎-桃園,2023-11-08,9189
6182,合晶,7,0,7,群益金鼎-桃園,2023-11-08,9189
2408,南亞科,7,0,7,群益金鼎-桃園,2023-11-08,9189
6770,力積電,14,7,7,群益金鼎-桃園,2023-11-08,9189
3036,文曄,21,15,6,群益金鼎-桃園,2023-11-08,9189
4915,致伸,6,0,6,群益金鼎-桃園,2023-11-08,9189
4736,泰博,6,0,6,群益金鼎-桃園,2023-11-08,9189
3006,晶豪科,11,5,6,群益金鼎-桃園,2023-11-08,9189
1605,華新,10,4,6,群益金鼎-桃園,2023-11-08,9189
1795,美時,15,9,6,群益金鼎-桃園,2023-11-08,9189
00929,復華台灣科技優息,85,2,83,群益金鼎-桃園,2023-11-09,9189
2329,華泰,128,59,69,群益金鼎-桃園,2023-11-09,9189
00936,台新永續高息中小,68,11,57,群益金鼎-桃園,2023-11-09,9189
00933B,國泰10Y+金融債,55,14,41,群益金鼎-桃園,2023-11-09,9189
00679B,元大美債20年,42,7,35,群益金鼎-桃園,2023-11-09,9189
2610,華航,55,21,34,群益金鼎-桃園,2023-11-09,9189
2363,矽統,121,87,34,群益金鼎-桃園,2023-11-09,9189
00934,中信成長高股息,35,2,33,群益金鼎-桃園,2023-11-09,9189
00935,野村臺灣新科技50,30,0,30,群益金鼎-桃園,2023-11-09,9189
00688L,國泰20年美債正2,23,0,23,群益金鼎-桃園,2023-11-09,9189
5347,世界,21,0,21,群益金鼎-桃園,2023-11-09,9189
3715,定穎投控,20,0,20,群益金鼎-桃園,2023-11-09,9189
3481,群創,22,3,19,群益金鼎-桃園,2023-11-09,9189
6189,豐藝,19,2,17,群益金鼎-桃園,2023-11-09,9189
3372,典範,14,0,14,群益金鼎-桃園,2023-11-09,9189
00715L,期街口布蘭特正2,25,12,13,群益金鼎-桃園,2023-11-09,9189
2486,一詮,20,8,12,群益金鼎-桃園,2023-11-09,9189
1582,信錦,16,4,12,群益金鼎-桃園,2023-11-09,9189
2498,宏達電,52,41,11,群益金鼎-桃園,2023-11-09,9189
2344,華邦電,14,3,11,群益金鼎-桃園,2023-11-09,9189
4510,高鋒,10,0,10,群益金鼎-桃園,2023-11-09,9189
2465,麗臺,11,1,10,群益金鼎-桃園,2023-11-09,9189
00637L,元大滬深300正2,10,0,10,群益金鼎-桃園,2023-11-09,9189
00882,中信中國高股息,10,0,10,群益金鼎-桃園,2023-11-09,9189
6841,長佳智能,10,0,10,群益金鼎-桃園,2023-11-09,9189
3122,笙泉,58,48,10,群益金鼎-桃園,2023-11-09,9189
2388,威盛,18,8,10,群益金鼎-桃園,2023-11-09,9189
6244,茂迪,13,3,10,群益金鼎-桃園,2023-11-09,9189
00918,大華優利高填息30,10,0,10,群益金鼎-桃園,2023-11-09,9189
6799,來頡,12,2,10,群益金鼎-桃園,2023-11-09,9189
6901,鑽石投資,14,4,10,群益金鼎-桃園,2023-11-09,9189
4743,合一,28,19,9,群益金鼎-桃園,2023-11-09,9189
3227,原相,11,2,9,群益金鼎-桃園,2023-11-09,9189
2393,億光,9,0,9,群益金鼎-桃園,2023-11-09,9189
6415,矽力*-KY,11,2,9,群益金鼎-桃園,2023-11-09,9189
3006,晶豪科,11,2,9,群益金鼎-桃園,2023-11-09,9189
2605,新興,10,1,9,群益金鼎-桃園,2023-11-09,9189
00878,國泰永續高股息,12,4,8,群益金鼎-桃園,2023-11-09,9189
1301,台塑,8,0,8,群益金鼎-桃園,2023-11-09,9189
1522,堤維西,28,20,8,群益金鼎-桃園,2023-11-09,9189
4908,前鼎,19,11,8,群益金鼎-桃園,2023-11-09,9189
2903,遠百,8,0,8,群益金鼎-桃園,2023-11-09,9189
8043,蜜望實,11,3,8,群益金鼎-桃園,2023-11-09,9189
3014,聯陽,9,2,7,群益金鼎-桃園,2023-11-09,9189
2481,強茂,7,0,7,群益金鼎-桃園,2023-11-09,9189
4557,永新-KY,7,0,7,群益金鼎-桃園,2023-11-09,9189
3380,明泰,8,1,7,群益金鼎-桃園,2023-11-09,9189
2353,宏��,9,3,6,群益金鼎-桃園,2023-11-09,9189
2331,精英,11,5,6,群益金鼎-桃園,2023-11-09,9189
3617,碩天,11,5,6,群益金鼎-桃園,2023-11-09,9189
00882,中信中國高股息,50,0,50,群益金鼎-桃園,2023-11-10,9189
00878,國泰永續高股息,53,4,49,群益金鼎-桃園,2023-11-10,9189
6117,迎廣,51,6,45,群益金鼎-桃園,2023-11-10,9189
00679B,元大美債20年,45,3,42,群益金鼎-桃園,2023-11-10,9189
4128,中天,92,52,40,群益金鼎-桃園,2023-11-10,9189
00929,復華台灣科技優息,40,1,39,群益金鼎-桃園,2023-11-10,9189
1815,富喬,111,73,38,群益金鼎-桃園,2023-11-10,9189
2401,凌陽,37,1,36,群益金鼎-桃園,2023-11-10,9189
00936,台新永續高息中小,26,0,26,群益金鼎-桃園,2023-11-10,9189
00687B,國泰20年美債,25,0,25,群益金鼎-桃園,2023-11-10,9189
4744,皇將,29,5,24,群益金鼎-桃園,2023-11-10,9189
2316,楠梓電,26,5,21,群益金鼎-桃園,2023-11-10,9189
2816,旺旺保,21,0,21,群益金鼎-桃園,2023-11-10,9189
4743,合一,49,29,20,群益金鼎-桃園,2023-11-10,9189
2352,佳世達,28,8,20,群益金鼎-桃園,2023-11-10,9189
3231,緯創,193,175,18,群益金鼎-桃園,2023-11-10,9189
00715L,期街口布蘭特正2,18,0,18,群益金鼎-桃園,2023-11-10,9189
6271,同欣電,36,20,16,群益金鼎-桃園,2023-11-10,9189
3325,旭品,15,0,15,群益金鼎-桃園,2023-11-10,9189
1101,台泥,14,0,14,群益金鼎-桃園,2023-11-10,9189
2883,凱基金,14,0,14,群益金鼎-桃園,2023-11-10,9189
1504,東元,12,0,12,群益金鼎-桃園,2023-11-10,9189
2903,遠百,12,0,12,群益金鼎-桃園,2023-11-10,9189
2201,裕隆,11,0,11,群益金鼎-桃園,2023-11-10,9189
3715,定穎投控,15,4,11,群益金鼎-桃園,2023-11-10,9189
2382,廣達,38,27,11,群益金鼎-桃園,2023-11-10,9189
1524,耿鼎,15,4,11,群益金鼎-桃園,2023-11-10,9189
00650L,復華香港正2,10,0,10,群益金鼎-桃園,2023-11-10,9189
2376,技嘉,22,12,10,群益金鼎-桃園,2023-11-10,9189
3689,湧德,10,0,10,群益金鼎-桃園,2023-11-10,9189
00637L,元大滬深300正2,15,5,10,群益金鼎-桃園,2023-11-10,9189
2349,錸德,10,0,10,群益金鼎-桃園,2023-11-10,9189
00753L,中信中國50正2,10,0,10,群益金鼎-桃園,2023-11-10,9189
5871,中租-KY,9,0,9,群益金鼎-桃園,2023-11-10,9189
4550,長佳,8,0,8,群益金鼎-桃園,2023-11-10,9189
4908,前鼎,10,2,8,群益金鼎-桃園,2023-11-10,9189
00696B,富邦美債20年,8,0,8,群益金鼎-桃園,2023-11-10,9189
2408,南亞科,7,0,7,群益金鼎-桃園,2023-11-10,9189
1522,堤維西,22,15,7,群益金鼎-桃園,2023-11-10,9189
8358,金居,7,0,7,群益金鼎-桃園,2023-11-10,9189
1582,信錦,8,1,7,群益金鼎-桃園,2023-11-10,9189
3346,麗清,7,0,7,群益金鼎-桃園,2023-11-10,9189
2329,華泰,25,19,6,群益金鼎-桃園,2023-11-10,9189
2486,一詮,14,8,6,群益金鼎-桃園,2023-11-10,9189
2615,萬海,6,0,6,群益金鼎-桃園,2023-11-10,9189
00712,復華富時不動產,6,0,6,群益金鼎-桃園,2023-11-10,9189
2610,華航,6,0,6,群益金鼎-桃園,2023-11-10,9189
6113,亞矽,6,0,6,群益金鼎-桃園,2023-11-10,9189
6245,立端,7,1,6,群益金鼎-桃園,2023-11-10,9189
00751B,元大AAA至A公司債,6,0,6,群益金鼎-桃園,2023-11-10,9189
00632R,元大台灣50反1,141,2,139,群益金鼎-桃園,2023-11-13,9189
00929,復華台灣科技優息,89,5,84,群益金鼎-桃園,2023-11-13,9189
00900,富邦特選高股息30,70,1,69,群益金鼎-桃園,2023-11-13,9189
3450,聯鈞,49,1,48,群益金鼎-桃園,2023-11-13,9189
6550,北極星藥業-KY,33,0,33,群益金鼎-桃園,2023-11-13,9189
5388,中磊,31,0,31,群益金鼎-桃園,2023-11-13,9189
00878,國泰永續高股息,31,1,30,群益金鼎-桃園,2023-11-13,9189
2369,菱生,67,37,30,群益金鼎-桃園,2023-11-13,9189
2816,旺旺保,42,13,29,群益金鼎-桃園,2023-11-13,9189
00687B,國泰20年美債,27,0,27,群益金鼎-桃園,2023-11-13,9189
00679B,元大美債20年,25,0,25,群益金鼎-桃園,2023-11-13,9189
3015,全漢,25,0,25,群益金鼎-桃園,2023-11-13,9189
2891,中信金,32,8,24,群益金鼎-桃園,2023-11-13,9189
5381,合正,25,2,23,群益金鼎-桃園,2023-11-13,9189
00637L,元大滬深300正2,20,0,20,群益金鼎-桃園,2023-11-13,9189
2031,新光鋼,20,0,20,群益金鼎-桃園,2023-11-13,9189
2382,廣達,54,35,19,群益金鼎-桃園,2023-11-13,9189
2323,中環,21,2,19,群益金鼎-桃園,2023-11-13,9189
00696B,富邦美債20年,17,0,17,群益金鼎-桃園,2023-11-13,9189
2387,精元,88,71,17,群益金鼎-桃園,2023-11-13,9189
3105,穩懋,18,2,16,群益金鼎-桃園,2023-11-13,9189
6139,亞翔,19,3,16,群益金鼎-桃園,2023-11-13,9189
1314,中石化,15,0,15,群益金鼎-桃園,2023-11-13,9189
3022,威強電,15,0,15,群益金鼎-桃園,2023-11-13,9189
6141,柏承,15,0,15,群益金鼎-桃園,2023-11-13,9189
2610,華航,19,5,14,群益金鼎-桃園,2023-11-13,9189
5512,力麒,14,0,14,群益金鼎-桃園,2023-11-13,9189
3044,健鼎,18,5,13,群益金鼎-桃園,2023-11-13,9189
2462,良得電,13,0,13,群益金鼎-桃園,2023-11-13,9189
2485,兆赫,25,12,13,群益金鼎-桃園,2023-11-13,9189
3078,僑威,15,2,13,群益金鼎-桃園,2023-11-13,9189
2243,宏旭-KY,12,0,12,群益金鼎-桃園,2023-11-13,9189
9934,成霖,15,3,12,群益金鼎-桃園,2023-11-13,9189
8936,國統,11,0,11,群益金鼎-桃園,2023-11-13,9189
3163,波若威,12,1,11,群益金鼎-桃園,2023-11-13,9189
9958,世紀鋼,51,40,11,群益金鼎-桃園,2023-11-13,9189
2377,微星,11,1,10,群益金鼎-桃園,2023-11-13,9189
00933B,國泰10Y+金融債,10,0,10,群益金鼎-桃園,2023-11-13,9189
1301,台塑,10,0,10,群益金鼎-桃園,2023-11-13,9189
1515,力山,32,22,10,群益金鼎-桃園,2023-11-13,9189
8215,明基材,10,0,10,群益金鼎-桃園,2023-11-13,9189
3706,神達,10,1,9,群益金鼎-桃園,2023-11-13,9189
5348,正能量智能,9,0,9,群益金鼎-桃園,2023-11-13,9189
2439,美律,11,2,9,群益金鼎-桃園,2023-11-13,9189
4967,十銓,34,26,8,群益金鼎-桃園,2023-11-13,9189
00715L,期街口布蘭特正2,8,0,8,群益金鼎-桃園,2023-11-13,9189
6188,廣明,8,0,8,群益金鼎-桃園,2023-11-13,9189
2486,一詮,9,2,7,群益金鼎-桃園,2023-11-13,9189
3043,科風,12,5,7,群益金鼎-桃園,2023-11-13,9189
6288,聯嘉,7,0,7,群益金鼎-桃園,2023-11-13,9189
00687B,國泰20年美債,81,1,80,群益金鼎-桃園,2023-11-14,9189
00929,復華台灣科技優息,65,13,52,群益金鼎-桃園,2023-11-14,9189
3231,緯創,145,98,47,群益金鼎-桃園,2023-11-14,9189
1504,東元,45,0,45,群益金鼎-桃園,2023-11-14,9189
00632R,元大台灣50反1,43,0,43,群益金鼎-桃園,2023-11-14,9189
2609,陽明,47,16,31,群益金鼎-桃園,2023-11-14,9189
2618,長榮航,29,2,27,群益金鼎-桃園,2023-11-14,9189
3450,聯鈞,29,3,26,群益金鼎-桃園,2023-11-14,9189
6603,富強鑫,30,5,25,群益金鼎-桃園,2023-11-14,9189
00679B,元大美債20年,25,1,24,群益金鼎-桃園,2023-11-14,9189
2516,新建,24,0,24,群益金鼎-桃園,2023-11-14,9189
3689,湧德,25,2,23,群益金鼎-桃園,2023-11-14,9189
1515,力山,77,56,21,群益金鼎-桃園,2023-11-14,9189
2498,宏達電,43,22,21,群益金鼎-桃園,2023-11-14,9189
00931B,統一美債20年,20,0,20,群益金鼎-桃園,2023-11-14,9189
6282,康舒,19,3,16,群益金鼎-桃園,2023-11-14,9189
1568,倉佑,22,7,15,群益金鼎-桃園,2023-11-14,9189
2363,矽統,26,11,15,群益金鼎-桃園,2023-11-14,9189
6274,台燿,17,2,15,群益金鼎-桃園,2023-11-14,9189
2317,鴻海,20,6,14,群益金鼎-桃園,2023-11-14,9189
4128,中天,33,20,13,群益金鼎-桃園,2023-11-14,9189
3406,玉晶光,15,2,13,群益金鼎-桃園,2023-11-14,9189
2374,佳能,14,2,12,群益金鼎-桃園,2023-11-14,9189
00902,中信電池及儲能,12,0,12,群益金鼎-桃園,2023-11-14,9189
9945,潤泰新,20,9,11,群益金鼎-桃園,2023-11-14,9189
00696B,富邦美債20年,11,0,11,群益金鼎-桃園,2023-11-14,9189
3209,全科,11,0,11,群益金鼎-桃園,2023-11-14,9189
1309,台達化,10,0,10,群益金鼎-桃園,2023-11-14,9189
1605,華新,10,0,10,群益金鼎-桃園,2023-11-14,9189
3704,合勤控,12,2,10,群益金鼎-桃園,2023-11-14,9189
6472,保瑞,10,0,10,群益金鼎-桃園,2023-11-14,9189
00637L,元大滬深300正2,10,0,10,群益金鼎-桃園,2023-11-14,9189
00688L,國泰20年美債正2,10,0,10,群益金鼎-桃園,2023-11-14,9189
5348,正能量智能,10,0,10,群益金鼎-桃園,2023-11-14,9189
2610,華航,11,1,10,群益金鼎-桃園,2023-11-14,9189
00671R,富邦NASDAQ反1,8,0,8,群益金鼎-桃園,2023-11-14,9189
2402,毅嘉,37,29,8,群益金鼎-桃園,2023-11-14,9189
3014,聯陽,8,0,8,群益金鼎-桃園,2023-11-14,9189
8936,國統,8,0,8,群益金鼎-桃園,2023-11-14,9189
9927,泰銘,12,4,8,群益金鼎-桃園,2023-11-14,9189
2206,三陽工業,11,3,8,群益金鼎-桃園,2023-11-14,9189
6026,福邦證,7,0,7,群益金鼎-桃園,2023-11-14,9189
6278,台表科,8,1,7,群益金鼎-桃園,2023-11-14,9189
2606,裕民,8,1,7,群益金鼎-桃園,2023-11-14,9189
2387,精元,8,1,7,群益金鼎-桃園,2023-11-14,9189
00692,富邦公司治理,7,0,7,群益金鼎-桃園,2023-11-14,9189
2882,國泰金,7,0,7,群益金鼎-桃園,2023-11-14,9189
4105,東洋,8,2,6,群益金鼎-桃園,2023-11-14,9189
2453,凌群,6,0,6,群益金鼎-桃園,2023-11-14,9189
3189,景碩,6,0,6,群益金鼎-桃園,2023-11-14,9189
00680L,元大美債20正2,253,0,253,群益金鼎-桃園,2023-11-15,9189
2618,長榮航,127,55,72,群益金鼎-桃園,2023-11-15,9189
6139,亞翔,58,4,54,群益金鼎-桃園,2023-11-15,9189
2313,華通,58,7,51,群益金鼎-桃園,2023-11-15,9189
00687B,國泰20年美債,45,5,40,群益金鼎-桃園,2023-11-15,9189
3034,聯詠,30,0,30,群益金鼎-桃園,2023-11-15,9189
3260,威剛,29,1,28,群益金鼎-桃園,2023-11-15,9189
6026,福邦證,30,2,28,群益金鼎-桃園,2023-11-15,9189
00671R,富邦NASDAQ反1,27,0,27,群益金鼎-桃園,2023-11-15,9189
00679B,元大美債20年,29,2,27,群益金鼎-桃園,2023-11-15,9189
2312,金寶,24,1,23,群益金鼎-桃園,2023-11-15,9189
3706,神達,31,8,23,群益金鼎-桃園,2023-11-15,9189
3276,宇環,31,10,21,群益金鼎-桃園,2023-11-15,9189
2485,兆赫,20,0,20,群益金鼎-桃園,2023-11-15,9189
2425,承啟,20,1,19,群益金鼎-桃園,2023-11-15,9189
8110,華東,18,1,17,群益金鼎-桃園,2023-11-15,9189
2748,雲品,17,0,17,群益金鼎-桃園,2023-11-15,9189
2356,英業達,18,3,15,群益金鼎-桃園,2023-11-15,9189
3576,聯合再生,14,0,14,群益金鼎-桃園,2023-11-15,9189
2328,廣宇,14,1,13,群益金鼎-桃園,2023-11-15,9189
2014,中鴻,23,12,11,群益金鼎-桃園,2023-11-15,9189
00935,野村臺灣新科技50,11,0,11,群益金鼎-桃園,2023-11-15,9189
6285,啟��,11,0,11,群益金鼎-桃園,2023-11-15,9189
2338,光罩,10,0,10,群益金鼎-桃園,2023-11-15,9189
00676R,富邦臺灣加權反1,10,0,10,群益金鼎-桃園,2023-11-15,9189
5439,高技,11,2,9,群益金鼎-桃園,2023-11-15,9189
4533,協易機,10,1,9,群益金鼎-桃園,2023-11-15,9189
1795,美時,24,15,9,群益金鼎-桃園,2023-11-15,9189
2402,毅嘉,32,24,8,群益金鼎-桃園,2023-11-15,9189
2317,鴻海,20,12,8,群益金鼎-桃園,2023-11-15,9189
8222,寶一,8,0,8,群益金鼎-桃園,2023-11-15,9189
3176,基亞,10,2,8,群益金鼎-桃園,2023-11-15,9189
00675L,富邦臺灣加權正2,7,0,7,群益金鼎-桃園,2023-11-15,9189
3017,奇鋐,9,2,7,群益金鼎-桃園,2023-11-15,9189
3596,智易,7,0,7,群益金鼎-桃園,2023-11-15,9189
3022,威強電,7,0,7,群益金鼎-桃園,2023-11-15,9189
2610,華航,7,0,7,群益金鼎-桃園,2023-11-15,9189
6770,力積電,21,15,6,群益金鼎-桃園,2023-11-15,9189
2357,華碩,8,2,6,群益金鼎-桃園,2023-11-15,9189
1314,中石化,6,0,6,群益金鼎-桃園,2023-11-15,9189
5347,世界,10,4,6,群益金鼎-桃園,2023-11-15,9189
1514,亞力,9,3,6,群益金鼎-桃園,2023-11-15,9189
3078,僑威,6,0,6,群益金鼎-桃園,2023-11-15,9189
2449,京元電子,18,12,6,群益金鼎-桃園,2023-11-15,9189
3231,緯創,118,112,6,群益金鼎-桃園,2023-11-15,9189
0050,元大台灣50,26,20,6,群益金鼎-桃園,2023-11-15,9189
3558,神準,5,0,5,群益金鼎-桃園,2023-11-15,9189
5871,中租-KY,5,0,5,群益金鼎-桃園,2023-11-15,9189
1604,聲寶,5,0,5,群益金鼎-桃園,2023-11-15,9189
2106,建大,6,1,5,群益金鼎-桃園,2023-11-15,9189
00878,國泰永續高股息,117,4,113,群益金鼎-桃園,2023-11-16,9189
1815,富喬,102,17,85,群益金鼎-桃園,2023-11-16,9189
00632R,元大台灣50反1,55,0,55,群益金鼎-桃園,2023-11-16,9189
4720,德淵,50,0,50,群益金鼎-桃園,2023-11-16,9189
5512,力麒,42,0,42,群益金鼎-桃園,2023-11-16,9189
1504,東元,31,7,24,群益金鼎-桃園,2023-11-16,9189
9945,潤泰新,22,0,22,群益金鼎-桃園,2023-11-16,9189
6667,信紘科,38,17,21,群益金鼎-桃園,2023-11-16,9189
2393,億光,20,0,20,群益金鼎-桃園,2023-11-16,9189
2417,圓剛,66,47,19,群益金鼎-桃園,2023-11-16,9189
2731,雄獅,21,2,19,群益金鼎-桃園,2023-11-16,9189
2607,榮運,16,1,15,群益金鼎-桃園,2023-11-16,9189
1101,台泥,16,2,14,群益金鼎-桃園,2023-11-16,9189
4543,萬在,15,1,14,群益金鼎-桃園,2023-11-16,9189
00679B,元大美債20年,13,0,13,群益金鼎-桃園,2023-11-16,9189
2734,易飛網,14,1,13,群益金鼎-桃園,2023-11-16,9189
6901,鑽石投資,13,0,13,群益金鼎-桃園,2023-11-16,9189
2344,華邦電,40,28,12,群益金鼎-桃園,2023-11-16,9189
2543,皇昌,14,2,12,群益金鼎-桃園,2023-11-16,9189
3548,兆利,42,30,12,群益金鼎-桃園,2023-11-16,9189
9919,康那香,12,0,12,群益金鼎-桃園,2023-11-16,9189
00688L,國泰20年美債正2,12,0,12,群益金鼎-桃園,2023-11-16,9189
3260,威剛,15,4,11,群益金鼎-桃園,2023-11-16,9189
00934,中信成長高股息,11,0,11,群益金鼎-桃園,2023-11-16,9189
00637L,元大滬深300正2,10,0,10,群益金鼎-桃園,2023-11-16,9189
3034,聯詠,10,0,10,群益金鼎-桃園,2023-11-16,9189
00936,台新永續高息中小,11,1,10,群益金鼎-桃園,2023-11-16,9189
3325,旭品,11,1,10,群益金鼎-桃園,2023-11-16,9189
3147,大綜,12,2,10,群益金鼎-桃園,2023-11-16,9189
00642U,期元大S＆P石油,10,0,10,群益金鼎-桃園,2023-11-16,9189
00891,中信關鍵半導體,10,0,10,群益金鼎-桃園,2023-11-16,9189
4128,中天,13,3,10,群益金鼎-桃園,2023-11-16,9189
2390,云辰,10,0,10,群益金鼎-桃園,2023-11-16,9189
4510,高鋒,10,0,10,群益金鼎-桃園,2023-11-16,9189
00715L,期街口布蘭特正2,14,4,10,群益金鼎-桃園,2023-11-16,9189
5309,系統電,10,0,10,群益金鼎-桃園,2023-11-16,9189
2371,大同,16,7,9,群益金鼎-桃園,2023-11-16,9189
4916,事欣科,12,3,9,群益金鼎-桃園,2023-11-16,9189
6416,瑞祺電通,9,0,9,群益金鼎-桃園,2023-11-16,9189
1582,信錦,9,1,8,群益金鼎-桃園,2023-11-16,9189
00931B,統一美債20年,8,0,8,群益金鼎-桃園,2023-11-16,9189
3217,優群,9,1,8,群益金鼎-桃園,2023-11-16,9189
00690,兆豐藍籌30,8,0,8,群益金鼎-桃園,2023-11-16,9189
6016,康和證,10,2,8,群益金鼎-桃園,2023-11-16,9189
4746,台耀,8,1,7,群益金鼎-桃園,2023-11-16,9189
2352,佳世達,7,0,7,群益金鼎-桃園,2023-11-16,9189
8234,新漢,7,0,7,群益金鼎-桃園,2023-11-16,9189
2462,良得電,8,1,7,群益金鼎-桃園,2023-11-16,9189
00900,富邦特選高股息30,7,0,7,群益金鼎-桃園,2023-11-16,9189
6290,良維,13,6,7,群益金鼎-桃園,2023-11-16,9189
2618,長榮航,170,59,111,群益金鼎-桃園,2023-11-17,9189
1568,倉佑,81,2,79,群益金鼎-桃園,2023-11-17,9189
3481,群創,172,100,72,群益金鼎-桃園,2023-11-17,9189
00752,中信中國50,52,0,52,群益金鼎-桃園,2023-11-17,9189
00632R,元大台灣50反1,37,0,37,群益金鼎-桃園,2023-11-17,9189
2516,新建,35,0,35,群益金鼎-桃園,2023-11-17,9189
1815,富喬,54,23,31,群益金鼎-桃園,2023-11-17,9189
1515,力山,28,7,21,群益金鼎-桃園,2023-11-17,9189
1618,合機,21,0,21,群益金鼎-桃園,2023-11-17,9189
6770,力積電,23,3,20,群益金鼎-桃園,2023-11-17,9189
2301,光寶科,18,0,18,群益金鼎-桃園,2023-11-17,9189
3094,聯傑,50,32,18,群益金鼎-桃園,2023-11-17,9189
00751B,元大AAA至A公司債,20,2,18,群益金鼎-桃園,2023-11-17,9189
2607,榮運,18,1,17,群益金鼎-桃園,2023-11-17,9189
2605,新興,17,0,17,群益金鼎-桃園,2023-11-17,9189
3260,威剛,15,0,15,群益金鼎-桃園,2023-11-17,9189
3041,揚智,100,85,15,群益金鼎-桃園,2023-11-17,9189
5512,力麒,15,0,15,群益金鼎-桃園,2023-11-17,9189
2547,日勝生,15,0,15,群益金鼎-桃園,2023-11-17,9189
8110,華東,15,0,15,群益金鼎-桃園,2023-11-17,9189
3169,亞信,14,0,14,群益金鼎-桃園,2023-11-17,9189
4109,加捷生醫,14,0,14,群益金鼎-桃園,2023-11-17,9189
2707,晶華,15,1,14,群益金鼎-桃園,2023-11-17,9189
2329,華泰,16,2,14,群益金鼎-桃園,2023-11-17,9189
2634,漢翔,15,2,13,群益金鼎-桃園,2023-11-17,9189
2371,大同,22,9,13,群益金鼎-桃園,2023-11-17,9189
2014,中鴻,12,0,12,群益金鼎-桃園,2023-11-17,9189
6129,普誠,13,1,12,群益金鼎-桃園,2023-11-17,9189
1795,美時,12,1,11,群益金鼎-桃園,2023-11-17,9189
00642U,期元大S＆P石油,11,0,11,群益金鼎-桃園,2023-11-17,9189
9958,世紀鋼,20,9,11,群益金鼎-桃園,2023-11-17,9189
2393,億光,10,0,10,群益金鼎-桃園,2023-11-17,9189
3289,宜特,10,0,10,群益金鼎-桃園,2023-11-17,9189
6163,華電網,10,0,10,群益金鼎-桃園,2023-11-17,9189
00929,復華台灣科技優息,10,1,9,群益金鼎-桃園,2023-11-17,9189
3322,建舜電,9,0,9,群益金鼎-桃園,2023-11-17,9189
5351,鈺創,10,2,8,群益金鼎-桃園,2023-11-17,9189
1609,大亞,9,1,8,群益金鼎-桃園,2023-11-17,9189
00919,群益台灣精選高息,13,5,8,群益金鼎-桃園,2023-11-17,9189
6416,瑞祺電通,10,3,7,群益金鼎-桃園,2023-11-17,9189
6143,振曜,7,0,7,群益金鼎-桃園,2023-11-17,9189
00931B,統一美債20年,7,0,7,群益金鼎-桃園,2023-11-17,9189
00637L,元大滬深300正2,23,17,6,群益金鼎-桃園,2023-11-17,9189
2603,長榮,6,0,6,群益金鼎-桃園,2023-11-17,9189
3032,偉訓,8,2,6,群益金鼎-桃園,2023-11-17,9189
3623,富晶通,10,4,6,群益金鼎-桃園,2023-11-17,9189
6530,創威,6,0,6,群益金鼎-桃園,2023-11-17,9189
2353,宏��,9,3,6,群益金鼎-桃園,2023-11-17,9189
3043,科風,16,10,6,群益金鼎-桃園,2023-11-17,9189
6158,禾昌,11,5,6,群益金鼎-桃園,2023-11-17,9189
00929,復華台灣科技優息,180,13,167,群益金鼎-桃園,2023-11-20,9189
6456,GIS-KY,55,1,54,群益金鼎-桃園,2023-11-20,9189
2618,長榮航,88,34,54,群益金鼎-桃園,2023-11-20,9189
2363,矽統,102,52,50,群益金鼎-桃園,2023-11-20,9189
00931B,統一美債20年,34,0,34,群益金鼎-桃園,2023-11-20,9189
00936,台新永續高息中小,32,0,32,群益金鼎-桃園,2023-11-20,9189
5531,鄉林,30,0,30,群益金鼎-桃園,2023-11-20,9189
2891,中信金,29,0,29,群益金鼎-桃園,2023-11-20,9189
3701,大眾控,36,8,28,群益金鼎-桃園,2023-11-20,9189
00751B,元大AAA至A公司債,28,0,28,群益金鼎-桃園,2023-11-20,9189
2329,華泰,45,21,24,群益金鼎-桃園,2023-11-20,9189
00687B,國泰20年美債,23,0,23,群益金鼎-桃園,2023-11-20,9189
4931,新盛力,26,3,23,群益金鼎-桃園,2023-11-20,9189
2425,承啟,22,0,22,群益金鼎-桃園,2023-11-20,9189
1460,宏遠,20,0,20,群益金鼎-桃園,2023-11-20,9189
00934,中信成長高股息,30,10,20,群益金鼎-桃園,2023-11-20,9189
3038,全台,20,0,20,群益金鼎-桃園,2023-11-20,9189
3037,欣興,25,5,20,群益金鼎-桃園,2023-11-20,9189
00878,國泰永續高股息,20,4,16,群益金鼎-桃園,2023-11-20,9189
2812,台中銀,15,0,15,群益金鼎-桃園,2023-11-20,9189
5340,建榮,15,0,15,群益金鼎-桃園,2023-11-20,9189
3231,緯創,80,66,14,群益金鼎-桃園,2023-11-20,9189
5706,鳳凰,27,13,14,群益金鼎-桃園,2023-11-20,9189
2610,華航,23,9,14,群益金鼎-桃園,2023-11-20,9189
00679B,元大美債20年,13,0,13,群益金鼎-桃園,2023-11-20,9189
1319,東陽,11,0,11,群益金鼎-桃園,2023-11-20,9189
2344,華邦電,15,5,10,群益金鼎-桃園,2023-11-20,9189
00918,大華優利高填息30,10,0,10,群益金鼎-桃園,2023-11-20,9189
1584,精剛,12,2,10,群益金鼎-桃園,2023-11-20,9189
1806,冠軍,10,0,10,群益金鼎-桃園,2023-11-20,9189
4147,中裕,10,0,10,群益金鼎-桃園,2023-11-20,9189
2390,云辰,10,0,10,群益金鼎-桃園,2023-11-20,9189
00753L,中信中國50正2,10,0,10,群益金鼎-桃園,2023-11-20,9189
00696B,富邦美債20年,10,0,10,群益金鼎-桃園,2023-11-20,9189
6117,迎廣,18,8,10,群益金鼎-桃園,2023-11-20,9189
1301,台塑,10,0,10,群益金鼎-桃園,2023-11-20,9189
2014,中鴻,10,0,10,群益金鼎-桃園,2023-11-20,9189
2105,正新,10,1,9,群益金鼎-桃園,2023-11-20,9189
2401,凌陽,27,18,9,群益金鼎-桃園,2023-11-20,9189
3162,精確,9,0,9,群益金鼎-桃園,2023-11-20,9189
3035,智原,34,25,9,群益金鼎-桃園,2023-11-20,9189
8210,勤誠,8,0,8,群益金鼎-桃園,2023-11-20,9189
2485,兆赫,10,2,8,群益金鼎-桃園,2023-11-20,9189
6418,詠昇,8,0,8,群益金鼎-桃園,2023-11-20,9189
8930,青鋼,8,0,8,群益金鼎-桃園,2023-11-20,9189
4952,凌通,8,0,8,群益金鼎-桃園,2023-11-20,9189
3376,新日興,11,4,7,群益金鼎-桃園,2023-11-20,9189
3363,上詮,7,0,7,群益金鼎-桃園,2023-11-20,9189
2486,一詮,7,0,7,群益金鼎-桃園,2023-11-20,9189
3006,晶豪科,16,9,7,群益金鼎-桃園,2023-11-20,9189
6284,佳邦,252,3,249,群益金鼎-桃園,2023-11-21,9189
00632R,元大台灣50反1,205,0,205,群益金鼎-桃園,2023-11-21,9189
6233,旺玖,159,3,156,群益金鼎-桃園,2023-11-21,9189
2066,世德,151,0,151,群益金鼎-桃園,2023-11-21,9189
5351,鈺創,96,30,66,群益金鼎-桃園,2023-11-21,9189
00679B,元大美債20年,52,0,52,群益金鼎-桃園,2023-11-21,9189
5533,皇鼎,48,0,48,群益金鼎-桃園,2023-11-21,9189
1504,東元,43,0,43,群益金鼎-桃園,2023-11-21,9189
6158,禾昌,41,1,40,群益金鼎-桃園,2023-11-21,9189
00687B,國泰20年美債,40,0,40,群益金鼎-桃園,2023-11-21,9189
00933B,國泰10Y+金融債,37,0,37,群益金鼎-桃園,2023-11-21,9189
3625,西勝,35,0,35,群益金鼎-桃園,2023-11-21,9189
2618,長榮航,55,22,33,群益金鼎-桃園,2023-11-21,9189
2516,新建,51,20,31,群益金鼎-桃園,2023-11-21,9189
5014,建錩,30,0,30,群益金鼎-桃園,2023-11-21,9189
1314,中石化,30,1,29,群益金鼎-桃園,2023-11-21,9189
2355,敬鵬,75,49,26,群益金鼎-桃園,2023-11-21,9189
00696B,富邦美債20年,25,0,25,群益金鼎-桃園,2023-11-21,9189
6187,萬潤,179,158,21,群益金鼎-桃園,2023-11-21,9189
00753L,中信中國50正2,20,0,20,群益金鼎-桃園,2023-11-21,9189
00931B,統一美債20年,20,0,20,群益金鼎-桃園,2023-11-21,9189
6122,擎邦,20,0,20,群益金鼎-桃園,2023-11-21,9189
3715,定穎投控,39,19,20,群益金鼎-桃園,2023-11-21,9189
6125,廣運,70,52,18,群益金鼎-桃園,2023-11-21,9189
00664R,國泰臺灣加權反1,14,0,14,群益金鼎-桃園,2023-11-21,9189
6237,驊訊,23,10,13,群益金鼎-桃園,2023-11-21,9189
2913,農林,13,0,13,群益金鼎-桃園,2023-11-21,9189
2337,旺宏,12,0,12,群益金鼎-桃園,2023-11-21,9189
8936,國統,14,3,11,群益金鼎-桃園,2023-11-21,9189
4968,立積,11,0,11,群益金鼎-桃園,2023-11-21,9189
3276,宇環,13,2,11,群益金鼎-桃園,2023-11-21,9189
6282,康舒,18,8,10,群益金鼎-桃園,2023-11-21,9189
2241,艾姆勒,10,0,10,群益金鼎-桃園,2023-11-21,9189
2393,億光,10,0,10,群益金鼎-桃園,2023-11-21,9189
2611,志信,10,0,10,群益金鼎-桃園,2023-11-21,9189
00688L,國泰20年美債正2,10,0,10,群益金鼎-桃園,2023-11-21,9189
2486,一詮,10,0,10,群益金鼎-桃園,2023-11-21,9189
3576,聯合再生,13,4,9,群益金鼎-桃園,2023-11-21,9189
00936,台新永續高息中小,12,3,9,群益金鼎-桃園,2023-11-21,9189
6278,台表科,8,0,8,群益金鼎-桃園,2023-11-21,9189
2449,京元電子,7,0,7,群益金鼎-桃園,2023-11-21,9189
5703,亞都,8,1,7,群益金鼎-桃園,2023-11-21,9189
3006,晶豪科,13,6,7,群益金鼎-桃園,2023-11-21,9189
2634,漢翔,7,0,7,群益金鼎-桃園,2023-11-21,9189
6161,捷波,6,0,6,群益金鼎-桃園,2023-11-21,9189
8081,致新,6,0,6,群益金鼎-桃園,2023-11-21,9189
3515,華擎,7,1,6,群益金鼎-桃園,2023-11-21,9189
4543,萬在,20,14,6,群益金鼎-桃園,2023-11-21,9189
6585,鼎基,7,1,6,群益金鼎-桃園,2023-11-21,9189
3059,華晶科,16,10,6,群益金鼎-桃園,2023-11-21,9189
3231,緯創,166,43,123,群益金鼎-桃園,2023-11-22,9189
3019,亞光,61,1,60,群益金鼎-桃園,2023-11-22,9189
00929,復華台灣科技優息,48,2,46,群益金鼎-桃園,2023-11-22,9189
1605,華新,53,10,43,群益金鼎-桃園,2023-11-22,9189
2382,廣達,43,6,37,群益金鼎-桃園,2023-11-22,9189
2356,英業達,35,4,31,群益金鼎-桃園,2023-11-22,9189
3024,憶聲,30,3,27,群益金鼎-桃園,2023-11-22,9189
9919,康那香,25,0,25,群益金鼎-桃園,2023-11-22,9189
2614,東森,27,3,24,群益金鼎-桃園,2023-11-22,9189
8011,台通,25,1,24,群益金鼎-桃園,2023-11-22,9189
2610,華航,25,1,24,群益金鼎-桃園,2023-11-22,9189
3078,僑威,31,10,21,群益金鼎-桃園,2023-11-22,9189
00687B,國泰20年美債,19,0,19,群益金鼎-桃園,2023-11-22,9189
8176,智捷,16,0,16,群益金鼎-桃園,2023-11-22,9189
5471,松翰,30,14,16,群益金鼎-桃園,2023-11-22,9189
3694,海華,25,10,15,群益金鼎-桃園,2023-11-22,9189
3257,虹冠電,22,8,14,群益金鼎-桃園,2023-11-22,9189
2317,鴻海,17,3,14,群益金鼎-桃園,2023-11-22,9189
00902,中信電池及儲能,35,22,13,群益金鼎-桃園,2023-11-22,9189
2014,中鴻,13,0,13,群益金鼎-桃園,2023-11-22,9189
2330,台積電,14,2,12,群益金鼎-桃園,2023-11-22,9189
3706,神達,19,7,12,群益金鼎-桃園,2023-11-22,9189
6494,九齊,22,10,12,群益金鼎-桃園,2023-11-22,9189
3047,訊舟,17,5,12,群益金鼎-桃園,2023-11-22,9189
5225,東科-KY,11,0,11,群益金鼎-桃園,2023-11-22,9189
2376,技嘉,22,12,10,群益金鼎-桃園,2023-11-22,9189
2301,光寶科,11,1,10,群益金鼎-桃園,2023-11-22,9189
5324,士開,10,0,10,群益金鼎-桃園,2023-11-22,9189
6449,鈺邦,10,0,10,群益金鼎-桃園,2023-11-22,9189
4915,致伸,10,0,10,群益金鼎-桃園,2023-11-22,9189
00637L,元大滬深300正2,10,0,10,群益金鼎-桃園,2023-11-22,9189
00877,復華中國5G,10,0,10,群益金鼎-桃園,2023-11-22,9189
2401,凌陽,21,11,10,群益金鼎-桃園,2023-11-22,9189
2501,國建,10,0,10,群益金鼎-桃園,2023-11-22,9189
2002,中鋼,11,1,10,群益金鼎-桃園,2023-11-22,9189
1303,南亞,10,0,10,群益金鼎-桃園,2023-11-22,9189
3325,旭品,71,62,9,群益金鼎-桃園,2023-11-22,9189
2353,宏��,9,0,9,群益金鼎-桃園,2023-11-22,9189
00936,台新永續高息中小,10,2,8,群益金鼎-桃園,2023-11-22,9189
00706L,期元大S＆P日圓正2,8,0,8,群益金鼎-桃園,2023-11-22,9189
00905,FT臺灣Smart,8,0,8,群益金鼎-桃園,2023-11-22,9189
2371,大同,8,0,8,群益金鼎-桃園,2023-11-22,9189
2328,廣宇,8,0,8,群益金鼎-桃園,2023-11-22,9189
4938,和碩,8,0,8,群益金鼎-桃園,2023-11-22,9189
3580,友威科,9,2,7,群益金鼎-桃園,2023-11-22,9189
5443,均豪,8,1,7,群益金鼎-桃園,2023-11-22,9189
2201,裕隆,8,1,7,群益金鼎-桃園,2023-11-22,9189
00935,野村臺灣新科技50,7,0,7,群益金鼎-桃園,2023-11-22,9189
2618,長榮航,61,54,7,群益金鼎-桃園,2023-11-22,9189
6111,大宇資,7,1,6,群益金鼎-桃園,2023-11-22,9189
3450,聯鈞,246,20,226,群益金鼎-桃園,2023-11-23,9189
00680L,元大美債20正2,100,0,100,群益金鼎-桃園,2023-11-23,9189
00632R,元大台灣50反1,93,4,89,群益金鼎-桃園,2023-11-23,9189
2363,矽統,100,34,66,群益金鼎-桃園,2023-11-23,9189
2891,中信金,65,18,47,群益金鼎-桃園,2023-11-23,9189
2329,華泰,44,2,42,群益金鼎-桃園,2023-11-23,9189
3715,定穎投控,46,11,35,群益金鼎-桃園,2023-11-23,9189
6477,安集,27,0,27,群益金鼎-桃園,2023-11-23,9189
1815,富喬,59,34,25,群益金鼎-桃園,2023-11-23,9189
2367,燿華,27,4,23,群益金鼎-桃園,2023-11-23,9189
2405,輔信,23,1,22,群益金鼎-桃園,2023-11-23,9189
3035,智原,41,19,22,群益金鼎-桃園,2023-11-23,9189
00900,富邦特選高股息30,22,0,22,群益金鼎-桃園,2023-11-23,9189
00919,群益台灣精選高息,21,0,21,群益金鼎-桃園,2023-11-23,9189
2303,聯電,33,12,21,群益金鼎-桃園,2023-11-23,9189
00936,台新永續高息中小,21,0,21,群益金鼎-桃園,2023-11-23,9189
5521,工信,52,33,19,群益金鼎-桃園,2023-11-23,9189
6282,康舒,58,40,18,群益金鼎-桃園,2023-11-23,9189
1605,華新,23,5,18,群益金鼎-桃園,2023-11-23,9189
3437,榮創,21,3,18,群益金鼎-桃園,2023-11-23,9189
2516,新建,24,6,18,群益金鼎-桃園,2023-11-23,9189
2344,華邦電,18,1,17,群益金鼎-桃園,2023-11-23,9189
00772B,中信高評級公司債,18,1,17,群益金鼎-桃園,2023-11-23,9189
9105,泰金寶-DR,15,0,15,群益金鼎-桃園,2023-11-23,9189
6125,廣運,45,30,15,群益金鼎-桃園,2023-11-23,9189
4720,德淵,20,6,14,群益金鼎-桃園,2023-11-23,9189
4931,新盛力,14,0,14,群益金鼎-桃園,2023-11-23,9189
6770,力積電,14,1,13,群益金鼎-桃園,2023-11-23,9189
3094,聯傑,13,0,13,群益金鼎-桃園,2023-11-23,9189
00637L,元大滬深300正2,15,3,12,群益金鼎-桃園,2023-11-23,9189
2801,彰銀,12,0,12,群益金鼎-桃園,2023-11-23,9189
5381,合正,17,5,12,群益金鼎-桃園,2023-11-23,9189
5471,松翰,16,4,12,群益金鼎-桃園,2023-11-23,9189
6122,擎邦,13,1,12,群益金鼎-桃園,2023-11-23,9189
6411,晶焱,19,9,10,群益金鼎-桃園,2023-11-23,9189
2484,希華,10,0,10,群益金鼎-桃園,2023-11-23,9189
6139,亞翔,25,15,10,群益金鼎-桃園,2023-11-23,9189
00931B,統一美債20年,13,3,10,群益金鼎-桃園,2023-11-23,9189
6213,聯茂,10,0,10,群益金鼎-桃園,2023-11-23,9189
2731,雄獅,10,0,10,群益金鼎-桃園,2023-11-23,9189
2449,京元電子,10,0,10,群益金鼎-桃園,2023-11-23,9189
00642U,期元大S＆P石油,9,0,9,群益金鼎-桃園,2023-11-23,9189
3013,晟銘電,19,10,9,群益金鼎-桃園,2023-11-23,9189
3006,晶豪科,41,32,9,群益金鼎-桃園,2023-11-23,9189
00715L,期街口布蘭特正2,9,0,9,群益金鼎-桃園,2023-11-23,9189
2439,美律,9,0,9,群益金鼎-桃園,2023-11-23,9189
00679B,元大美債20年,9,1,8,群益金鼎-桃園,2023-11-23,9189
2634,漢翔,8,0,8,群益金鼎-桃園,2023-11-23,9189
2748,雲品,16,8,8,群益金鼎-桃園,2023-11-23,9189
3047,訊舟,18,10,8,群益金鼎-桃園,2023-11-23,9189
2025,千興,120,0,120,群益金鼎-桃園,2023-11-24,9189
2618,長榮航,71,13,58,群益金鼎-桃園,2023-11-24,9189
2313,華通,125,71,54,群益金鼎-桃園,2023-11-24,9189
2610,華航,39,1,38,群益金鼎-桃園,2023-11-24,9189
2516,新建,41,4,37,群益金鼎-桃園,2023-11-24,9189
4720,德淵,30,0,30,群益金鼎-桃園,2023-11-24,9189
5351,鈺創,40,12,28,群益金鼎-桃園,2023-11-24,9189
2303,聯電,38,11,27,群益金鼎-桃園,2023-11-24,9189
00929,復華台灣科技優息,30,4,26,群益金鼎-桃園,2023-11-24,9189
00720B,元大投資級公司債,26,0,26,群益金鼎-桃園,2023-11-24,9189
6168,宏齊,32,7,25,群益金鼎-桃園,2023-11-24,9189
1471,首利,24,0,24,群益金鼎-桃園,2023-11-24,9189
00933B,國泰10Y+金融債,23,0,23,群益金鼎-桃園,2023-11-24,9189
3257,虹冠電,21,0,21,群益金鼎-桃園,2023-11-24,9189
00687B,國泰20年美債,21,0,21,群益金鼎-桃園,2023-11-24,9189
3006,晶豪科,34,14,20,群益金鼎-桃園,2023-11-24,9189
00878,國泰永續高股息,22,2,20,群益金鼎-桃園,2023-11-24,9189
5706,鳳凰,24,4,20,群益金鼎-桃園,2023-11-24,9189
1102,亞泥,20,0,20,群益金鼎-桃園,2023-11-24,9189
2382,廣達,20,2,18,群益金鼎-桃園,2023-11-24,9189
2344,華邦電,17,0,17,群益金鼎-桃園,2023-11-24,9189
2630,亞航,16,1,15,群益金鼎-桃園,2023-11-24,9189
2317,鴻海,14,0,14,群益金鼎-桃園,2023-11-24,9189
00679B,元大美債20年,13,0,13,群益金鼎-桃園,2023-11-24,9189
1514,亞力,30,17,13,群益金鼎-桃園,2023-11-24,9189
5381,合正,12,0,12,群益金鼎-桃園,2023-11-24,9189
8089,康全電訊,19,7,12,群益金鼎-桃園,2023-11-24,9189
3376,新日興,11,0,11,群益金鼎-桃園,2023-11-24,9189
4956,光鋐,26,15,11,群益金鼎-桃園,2023-11-24,9189
3014,聯陽,11,0,11,群益金鼎-桃園,2023-11-24,9189
3701,大眾控,27,16,11,群益金鼎-桃園,2023-11-24,9189
6129,普誠,11,0,11,群益金鼎-桃園,2023-11-24,9189
2329,華泰,12,1,11,群益金鼎-桃園,2023-11-24,9189
2727,王品,11,1,10,群益金鼎-桃園,2023-11-24,9189
6456,GIS-KY,16,6,10,群益金鼎-桃園,2023-11-24,9189
00751B,元大AAA至A公司債,10,0,10,群益金鼎-桃園,2023-11-24,9189
00900,富邦特選高股息30,10,0,10,群益金鼎-桃園,2023-11-24,9189
2605,新興,10,0,10,群益金鼎-桃園,2023-11-24,9189
2867,三商壽,11,2,9,群益金鼎-桃園,2023-11-24,9189
2457,飛宏,40,32,8,群益金鼎-桃園,2023-11-24,9189
1338,廣華-KY,8,0,8,群益金鼎-桃園,2023-11-24,9189
5425,台半,10,2,8,群益金鼎-桃園,2023-11-24,9189
2388,威盛,12,4,8,群益金鼎-桃園,2023-11-24,9189
2357,華碩,9,1,8,群益金鼎-桃園,2023-11-24,9189
5521,工信,10,2,8,群益金鼎-桃園,2023-11-24,9189
6104,創惟,27,20,7,群益金鼎-桃園,2023-11-24,9189
1504,東元,28,21,7,群益金鼎-桃園,2023-11-24,9189
3372,典範,7,0,7,群益金鼎-桃園,2023-11-24,9189
3022,威強電,7,0,7,群益金鼎-桃園,2023-11-24,9189
2734,易飛網,7,0,7,群益金鼎-桃園,2023-11-24,9189
2457,飛宏,75,14,61,群益金鼎-桃園,2023-11-27,9189
5425,台半,46,2,44,群益金鼎-桃園,2023-11-27,9189
2382,廣達,51,14,37,群益金鼎-桃園,2023-11-27,9189
2816,旺旺保,84,48,36,群益金鼎-桃園,2023-11-27,9189
00637L,元大滬深300正2,36,0,36,群益金鼎-桃園,2023-11-27,9189
00885,富邦越南,35,0,35,群益金鼎-桃園,2023-11-27,9189
00720B,元大投資級公司債,30,0,30,群益金鼎-桃園,2023-11-27,9189
6127,九豪,82,53,29,群益金鼎-桃園,2023-11-27,9189
2888,新光金,40,13,27,群益金鼎-桃園,2023-11-27,9189
00687B,國泰20年美債,25,1,24,群益金鼎-桃園,2023-11-27,9189
2352,佳世達,34,11,23,群益金鼎-桃園,2023-11-27,9189
5351,鈺創,23,2,21,群益金鼎-桃園,2023-11-27,9189
2375,凱美,22,1,21,群益金鼎-桃園,2023-11-27,9189
00692,富邦公司治理,20,0,20,群益金鼎-桃園,2023-11-27,9189
4720,德淵,20,0,20,群益金鼎-桃園,2023-11-27,9189
6117,迎廣,28,9,19,群益金鼎-桃園,2023-11-27,9189
2303,聯電,24,6,18,群益金鼎-桃園,2023-11-27,9189
5381,合正,24,6,18,群益金鼎-桃園,2023-11-27,9189
6901,鑽石投資,20,2,18,群益金鼎-桃園,2023-11-27,9189
2633,台灣高鐵,17,0,17,群益金鼎-桃園,2023-11-27,9189
8222,寶一,18,1,17,群益金鼎-桃園,2023-11-27,9189
5347,世界,19,2,17,群益金鼎-桃園,2023-11-27,9189
0056,元大高股息,17,1,16,群益金鼎-桃園,2023-11-27,9189
1471,首利,23,7,16,群益金鼎-桃園,2023-11-27,9189
00665L,富邦�琤肭磪囓�2,15,0,15,群益金鼎-桃園,2023-11-27,9189
00931B,統一美債20年,14,0,14,群益金鼎-桃園,2023-11-27,9189
00918,大華優利高填息30,14,0,14,群益金鼎-桃園,2023-11-27,9189
2913,農林,18,4,14,群益金鼎-桃園,2023-11-27,9189
3006,晶豪科,19,5,14,群益金鼎-桃園,2023-11-27,9189
3035,智原,21,8,13,群益金鼎-桃園,2023-11-27,9189
1809,中釉,16,3,13,群益金鼎-桃園,2023-11-27,9189
3017,奇鋐,15,2,13,群益金鼎-桃園,2023-11-27,9189
00919,群益台灣精選高息,23,11,12,群益金鼎-桃園,2023-11-27,9189
2317,鴻海,22,10,12,群益金鼎-桃園,2023-11-27,9189
00642U,期元大S＆P石油,12,0,12,群益金鼎-桃園,2023-11-27,9189
1532,勤美,13,1,12,群益金鼎-桃園,2023-11-27,9189
00934,中信成長高股息,12,0,12,群益金鼎-桃園,2023-11-27,9189
2356,英業達,11,0,11,群益金鼎-桃園,2023-11-27,9189
3019,亞光,11,0,11,群益金鼎-桃園,2023-11-27,9189
6446,藥華藥,13,2,11,群益金鼎-桃園,2023-11-27,9189
3706,神達,13,2,11,群益金鼎-桃園,2023-11-27,9189
1314,中石化,10,0,10,群益金鼎-桃園,2023-11-27,9189
2344,華邦電,10,0,10,群益金鼎-桃園,2023-11-27,9189
00877,復華中國5G,10,0,10,群益金鼎-桃園,2023-11-27,9189
1324,地球,10,0,10,群益金鼎-桃園,2023-11-27,9189
6757,台灣虎航,10,0,10,群益金鼎-桃園,2023-11-27,9189
00753L,中信中國50正2,10,0,10,群益金鼎-桃園,2023-11-27,9189
2399,映泰,10,0,10,群益金鼎-桃園,2023-11-27,9189
1513,中興電,53,44,9,群益金鼎-桃園,2023-11-27,9189
00878,國泰永續高股息,10,0,10,群益金鼎-桃園,2023-11-27,9189
2313,華通,192,100,92,群益金鼎-桃園,2023-11-28,9189
4114,健喬,129,60,69,群益金鼎-桃園,2023-11-28,9189
00632R,元大台灣50反1,69,10,59,群益金鼎-桃園,2023-11-28,9189
1101,台泥,76,22,54,群益金鼎-桃園,2023-11-28,9189
00720B,元大投資級公司債,41,0,41,群益金鼎-桃園,2023-11-28,9189
5351,鈺創,99,58,41,群益金鼎-桃園,2023-11-28,9189
2472,立隆電,40,1,39,群益金鼎-桃園,2023-11-28,9189
1701,中化,45,12,33,群益金鼎-桃園,2023-11-28,9189
2010,春源,30,0,30,群益金鼎-桃園,2023-11-28,9189
2883,凱基金,70,47,23,群益金鼎-桃園,2023-11-28,9189
1514,亞力,35,13,22,群益金鼎-桃園,2023-11-28,9189
2867,三商壽,20,0,20,群益金鼎-桃園,2023-11-28,9189
9907,統一實,20,0,20,群益金鼎-桃園,2023-11-28,9189
2641,正德,25,6,19,群益金鼎-桃園,2023-11-28,9189
6276,安鈦克,21,5,16,群益金鼎-桃園,2023-11-28,9189
2367,燿華,32,18,14,群益金鼎-桃園,2023-11-28,9189
2607,榮運,24,11,13,群益金鼎-桃園,2023-11-28,9189
2603,長榮,25,12,13,群益金鼎-桃園,2023-11-28,9189
2399,映泰,16,3,13,群益金鼎-桃園,2023-11-28,9189
00919,群益台灣精選高息,13,1,12,群益金鼎-桃園,2023-11-28,9189
8210,勤誠,11,0,11,群益金鼎-桃園,2023-11-28,9189
2882,國泰金,11,0,11,群益金鼎-桃園,2023-11-28,9189
2731,雄獅,10,0,10,群益金鼎-桃園,2023-11-28,9189
1301,台塑,10,0,10,群益金鼎-桃園,2023-11-28,9189
2816,旺旺保,16,6,10,群益金鼎-桃園,2023-11-28,9189
6233,旺玖,10,0,10,群益金鼎-桃園,2023-11-28,9189
5347,世界,13,3,10,群益金鼎-桃園,2023-11-28,9189
3512,皇龍,10,0,10,群益金鼎-桃園,2023-11-28,9189
8926,台汽電,10,0,10,群益金鼎-桃園,2023-11-28,9189
00878,國泰永續高股息,11,1,10,群益金鼎-桃園,2023-11-28,9189
00637L,元大滬深300正2,10,1,9,群益金鼎-桃園,2023-11-28,9189
4121,優盛,11,2,9,群益金鼎-桃園,2023-11-28,9189
6243,迅杰,14,5,9,群益金鼎-桃園,2023-11-28,9189
0056,元大高股息,8,0,8,群益金鼎-桃園,2023-11-28,9189
00712,復華富時不動產,8,0,8,群益金鼎-桃園,2023-11-28,9189
00935,野村臺灣新科技50,8,0,8,群益金鼎-桃園,2023-11-28,9189
6684,安格,13,5,8,群益金鼎-桃園,2023-11-28,9189
1616,億泰,10,2,8,群益金鼎-桃園,2023-11-28,9189
2528,皇普,7,0,7,群益金鼎-桃園,2023-11-28,9189
6863,永道-KY,7,0,7,群益金鼎-桃園,2023-11-28,9189
2383,台光電,10,4,6,群益金鼎-桃園,2023-11-28,9189
00922,國泰台灣領袖50,6,0,6,群益金鼎-桃園,2023-11-28,9189
3260,威剛,6,0,6,群益金鼎-桃園,2023-11-28,9189
6274,台燿,10,4,6,群益金鼎-桃園,2023-11-28,9189
8936,國統,15,9,6,群益金鼎-桃園,2023-11-28,9189
1752,南光,6,0,6,群益金鼎-桃園,2023-11-28,9189
5272,笙科,7,1,6,群益金鼎-桃園,2023-11-28,9189
6282,康舒,8,2,6,群益金鼎-桃園,2023-11-28,9189
1309,台達化,5,0,5,群益金鼎-桃園,2023-11-28,9189
00669R,國泰美國道瓊反1,5,0,5,群益金鼎-桃園,2023-11-28,9189
9919,康那香,212,56,156,群益金鼎-桃園,2023-11-29,9189
00632R,元大台灣50反1,100,40,60,群益金鼎-桃園,2023-11-29,9189
4720,德淵,60,0,60,群益金鼎-桃園,2023-11-29,9189
2891,中信金,45,1,44,群益金鼎-桃園,2023-11-29,9189
1449,佳和,44,0,44,群益金鼎-桃園,2023-11-29,9189
5347,世界,40,3,37,群益金鼎-桃園,2023-11-29,9189
00882,中信中國高股息,35,0,35,群益金鼎-桃園,2023-11-29,9189
00720B,元大投資級公司債,35,2,33,群益金鼎-桃園,2023-11-29,9189
00650L,復華香港正2,33,0,33,群益金鼎-桃園,2023-11-29,9189
9934,成霖,30,0,30,群益金鼎-桃園,2023-11-29,9189
3026,禾伸堂,28,0,28,群益金鼎-桃園,2023-11-29,9189
00687B,國泰20年美債,26,0,26,群益金鼎-桃園,2023-11-29,9189
00919,群益台灣精選高息,23,0,23,群益金鼎-桃園,2023-11-29,9189
00931B,統一美債20年,23,2,21,群益金鼎-桃園,2023-11-29,9189
00655L,國泰中國A50正2,21,0,21,群益金鼎-桃園,2023-11-29,9189
2610,華航,26,5,21,群益金鼎-桃園,2023-11-29,9189
2425,承啟,22,2,20,群益金鼎-桃園,2023-11-29,9189
3545,敦泰,44,24,20,群益金鼎-桃園,2023-11-29,9189
4114,健喬,29,10,19,群益金鼎-桃園,2023-11-29,9189
1701,中化,18,1,17,群益金鼎-桃園,2023-11-29,9189
3450,聯鈞,22,5,17,群益金鼎-桃園,2023-11-29,9189
3373,熱映,23,6,17,群益金鼎-桃園,2023-11-29,9189
6284,佳邦,20,6,14,群益金鼎-桃園,2023-11-29,9189
6282,康舒,14,0,14,群益金鼎-桃園,2023-11-29,9189
3515,華擎,12,1,11,群益金鼎-桃園,2023-11-29,9189
6173,信昌電,24,13,11,群益金鼎-桃園,2023-11-29,9189
1504,東元,11,0,11,群益金鼎-桃園,2023-11-29,9189
6517,保勝光學,11,0,11,群益金鼎-桃園,2023-11-29,9189
3055,蔚華科,13,2,11,群益金鼎-桃園,2023-11-29,9189
2383,台光電,10,0,10,群益金鼎-桃園,2023-11-29,9189
2882,國泰金,10,0,10,群益金鼎-桃園,2023-11-29,9189
2401,凌陽,17,7,10,群益金鼎-桃園,2023-11-29,9189
9950,萬國通,10,0,10,群益金鼎-桃園,2023-11-29,9189
2468,華經,10,0,10,群益金鼎-桃園,2023-11-29,9189
2867,三商壽,10,0,10,群益金鼎-桃園,2023-11-29,9189
00753L,中信中國50正2,10,0,10,群益金鼎-桃園,2023-11-29,9189
00665L,富邦�琤肭磪囓�2,10,0,10,群益金鼎-桃園,2023-11-29,9189
3501,維熹,10,0,10,群益金鼎-桃園,2023-11-29,9189
3715,定穎投控,16,7,9,群益金鼎-桃園,2023-11-29,9189
3481,群創,9,0,9,群益金鼎-桃園,2023-11-29,9189
1909,榮成,8,0,8,群益金鼎-桃園,2023-11-29,9189
3583,辛耘,8,0,8,群益金鼎-桃園,2023-11-29,9189
2883,凱基金,103,95,8,群益金鼎-桃園,2023-11-29,9189
2367,燿華,10,3,7,群益金鼎-桃園,2023-11-29,9189
3530,晶相光,13,6,7,群益金鼎-桃園,2023-11-29,9189
2369,菱生,14,7,7,群益金鼎-桃園,2023-11-29,9189
8222,寶一,7,0,7,群益金鼎-桃園,2023-11-29,9189
3305,昇貿,7,0,7,群益金鼎-桃園,2023-11-29,9189
3037,欣興,15,9,6,群益金鼎-桃園,2023-11-29,9189
3308,聯德,6,0,6,群益金鼎-桃園,2023-11-29,9189
00680L,元大美債20正2,604,375,229,群益金鼎-桃園,2023-11-30,9189
3481,群創,77,0,77,群益金鼎-桃園,2023-11-30,9189
6456,GIS-KY,55,2,53,群益金鼎-桃園,2023-11-30,9189
9919,康那香,130,83,47,群益金鼎-桃園,2023-11-30,9189
5351,鈺創,58,13,45,群益金鼎-桃園,2023-11-30,9189
5328,華容,66,22,44,群益金鼎-桃園,2023-11-30,9189
2313,華通,76,34,42,群益金鼎-桃園,2023-11-30,9189
3231,緯創,58,18,40,群益金鼎-桃園,2023-11-30,9189
00687B,國泰20年美債,39,3,36,群益金鼎-桃園,2023-11-30,9189
2888,新光金,30,0,30,群益金鼎-桃園,2023-11-30,9189
2369,菱生,98,68,30,群益金鼎-桃園,2023-11-30,9189
00934,中信成長高股息,32,2,30,群益金鼎-桃園,2023-11-30,9189
5903,全家,30,0,30,群益金鼎-桃園,2023-11-30,9189
2912,統一超,30,0,30,群益金鼎-桃園,2023-11-30,9189
1732,毛寶,28,1,27,群益金鼎-桃園,2023-11-30,9189
3623,富晶通,27,0,27,群益金鼎-桃園,2023-11-30,9189
4739,康普,25,0,25,群益金鼎-桃園,2023-11-30,9189
2492,華新科,33,10,23,群益金鼎-桃園,2023-11-30,9189
6257,矽格,48,25,23,群益金鼎-桃園,2023-11-30,9189
2332,友訊,26,3,23,群益金鼎-桃園,2023-11-30,9189
2363,矽統,27,4,23,群益金鼎-桃園,2023-11-30,9189
3260,威剛,43,22,21,群益金鼎-桃園,2023-11-30,9189
1582,信錦,26,7,19,群益金鼎-桃園,2023-11-30,9189
3026,禾伸堂,16,0,16,群益金鼎-桃園,2023-11-30,9189
00720B,元大投資級公司債,15,0,15,群益金鼎-桃園,2023-11-30,9189
3013,晟銘電,28,13,15,群益金鼎-桃園,2023-11-30,9189
5452,佶優,19,4,15,群益金鼎-桃園,2023-11-30,9189
1504,東元,16,1,15,群益金鼎-桃園,2023-11-30,9189
3047,訊舟,20,6,14,群益金鼎-桃園,2023-11-30,9189
00919,群益台灣精選高息,14,1,13,群益金鼎-桃園,2023-11-30,9189
2377,微星,21,9,12,群益金鼎-桃園,2023-11-30,9189
2457,飛宏,13,2,11,群益金鼎-桃園,2023-11-30,9189
1616,億泰,12,1,11,群益金鼎-桃園,2023-11-30,9189
00673R,期元大S＆P原油反1,11,0,11,群益金鼎-桃園,2023-11-30,9189
2610,華航,11,0,11,群益金鼎-桃園,2023-11-30,9189
3059,華晶科,12,1,11,群益金鼎-桃園,2023-11-30,9189
1326,台化,11,0,11,群益金鼎-桃園,2023-11-30,9189
00679B,元大美債20年,12,1,11,群益金鼎-桃園,2023-11-30,9189
2367,燿華,16,5,11,群益金鼎-桃園,2023-11-30,9189
2618,長榮航,32,22,10,群益金鼎-桃園,2023-11-30,9189
1301,台塑,10,0,10,群益金鼎-桃園,2023-11-30,9189
8111,立��,10,0,10,群益金鼎-桃園,2023-11-30,9189
4114,健喬,11,1,10,群益金鼎-桃園,2023-11-30,9189
2038,海光,10,0,10,群益金鼎-桃園,2023-11-30,9189
00688L,國泰20年美債正2,10,0,10,群益金鼎-桃園,2023-11-30,9189
00882,中信中國高股息,10,0,10,群益金鼎-桃園,2023-11-30,9189
6175,立敦,10,0,10,群益金鼎-桃園,2023-11-30,9189
00930,永豐ESG低碳高息,10,0,10,群益金鼎-桃園,2023-11-30,9189
2609,陽明,10,0,10,群益金鼎-桃園,2023-11-30,9189
2605,新興,42,32,10,群益金鼎-桃園,2023-11-30,9189
00919,群益台灣精選高息,380,15,365,群益金鼎-桃園,2023-12-01,9189
9919,康那香,169,65,104,群益金鼎-桃園,2023-12-01,9189
2605,新興,110,21,89,群益金鼎-桃園,2023-12-01,9189
2888,新光金,83,0,83,群益金鼎-桃園,2023-12-01,9189
4720,德淵,69,0,69,群益金鼎-桃園,2023-12-01,9189
1514,亞力,68,4,64,群益金鼎-桃園,2023-12-01,9189
2344,華邦電,55,1,54,群益金鼎-桃園,2023-12-01,9189
4909,新復興,54,7,47,群益金鼎-桃園,2023-12-01,9189
00915,凱基優選高股息30,40,0,40,群益金鼎-桃園,2023-12-01,9189
2886,兆豐金,33,0,33,群益金鼎-桃園,2023-12-01,9189
3483,力致,36,4,32,群益金鼎-桃園,2023-12-01,9189
00687B,國泰20年美債,31,1,30,群益金鼎-桃園,2023-12-01,9189
4721,美琪瑪,30,2,28,群益金鼎-桃園,2023-12-01,9189
3041,揚智,49,22,27,群益金鼎-桃園,2023-12-01,9189
1503,士電,26,0,26,群益金鼎-桃園,2023-12-01,9189
00929,復華台灣科技優息,27,2,25,群益金鼎-桃園,2023-12-01,9189
2355,敬鵬,32,7,25,群益金鼎-桃園,2023-12-01,9189
00637L,元大滬深300正2,25,0,25,群益金鼎-桃園,2023-12-01,9189
5347,世界,25,2,23,群益金鼎-桃園,2023-12-01,9189
1760,寶齡富錦,24,3,21,群益金鼎-桃園,2023-12-01,9189
2409,友達,21,1,20,群益金鼎-桃園,2023-12-01,9189
2211,長榮鋼,20,0,20,群益金鼎-桃園,2023-12-01,9189
00878,國泰永續高股息,20,1,19,群益金鼎-桃園,2023-12-01,9189
00900,富邦特選高股息30,20,1,19,群益金鼎-桃園,2023-12-01,9189
3043,科風,39,20,19,群益金鼎-桃園,2023-12-01,9189
00642U,期元大S＆P石油,18,0,18,群益金鼎-桃園,2023-12-01,9189
1513,中興電,25,8,17,群益金鼎-桃園,2023-12-01,9189
4763,材料-KY,18,1,17,群益金鼎-桃園,2023-12-01,9189
2371,大同,17,1,16,群益金鼎-桃園,2023-12-01,9189
3260,威剛,18,3,15,群益金鼎-桃園,2023-12-01,9189
1605,華新,19,4,15,群益金鼎-桃園,2023-12-01,9189
2363,矽統,34,19,15,群益金鼎-桃園,2023-12-01,9189
00720B,元大投資級公司債,14,0,14,群益金鼎-桃園,2023-12-01,9189
6213,聯茂,14,0,14,群益金鼎-桃園,2023-12-01,9189
6104,創惟,16,2,14,群益金鼎-桃園,2023-12-01,9189
2884,玉山金,14,0,14,群益金鼎-桃園,2023-12-01,9189
6117,迎廣,40,28,12,群益金鼎-桃園,2023-12-01,9189
4564,元翎,11,0,11,群益金鼎-桃園,2023-12-01,9189
6276,安鈦克,17,6,11,群益金鼎-桃園,2023-12-01,9189
0056,元大高股息,11,0,11,群益金鼎-桃園,2023-12-01,9189
00715L,期街口布蘭特正2,11,1,10,群益金鼎-桃園,2023-12-01,9189
00655L,國泰中國A50正2,10,0,10,群益金鼎-桃園,2023-12-01,9189
00726B,國泰新興投等債,10,0,10,群益金鼎-桃園,2023-12-01,9189
2105,正新,10,0,10,群益金鼎-桃園,2023-12-01,9189
3105,穩懋,14,4,10,群益金鼎-桃園,2023-12-01,9189
6470,宇智,10,0,10,群益金鼎-桃園,2023-12-01,9189
6122,擎邦,10,0,10,群益金鼎-桃園,2023-12-01,9189
2495,普安,10,0,10,群益金鼎-桃園,2023-12-01,9189
1314,中石化,10,0,10,群益金鼎-桃園,2023-12-01,9189
6163,華電網,10,0,10,群益金鼎-桃園,2023-12-01,9189
3481,群創,1233,137,1096,群益金鼎-桃園,2023-12-04,9189
00919,群益台灣精選高息,213,26,187,群益金鼎-桃園,2023-12-04,9189
2883,凱基金,121,8,113,群益金鼎-桃園,2023-12-04,9189
00665L,富邦�琤肭磪囓�2,105,0,105,群益金鼎-桃園,2023-12-04,9189
9919,康那香,165,66,99,群益金鼎-桃園,2023-12-04,9189
00918,大華優利高填息30,66,0,66,群益金鼎-桃園,2023-12-04,9189
00929,復華台灣科技優息,66,7,59,群益金鼎-桃園,2023-12-04,9189
4188,安克,50,0,50,群益金鼎-桃園,2023-12-04,9189
4720,德淵,50,2,48,群益金鼎-桃園,2023-12-04,9189
3715,定穎投控,68,23,45,群益金鼎-桃園,2023-12-04,9189
00720B,元大投資級公司債,44,1,43,群益金鼎-桃園,2023-12-04,9189
00715L,期街口布蘭特正2,41,2,39,群益金鼎-桃園,2023-12-04,9189
2329,華泰,96,60,36,群益金鼎-桃園,2023-12-04,9189
3013,晟銘電,105,70,35,群益金鼎-桃園,2023-12-04,9189
00722B,群益投資級電信債,35,2,33,群益金鼎-桃園,2023-12-04,9189
2457,飛宏,33,1,32,群益金鼎-桃園,2023-12-04,9189
1504,東元,41,13,28,群益金鼎-桃園,2023-12-04,9189
6125,廣運,46,19,27,群益金鼎-桃園,2023-12-04,9189
00882,中信中國高股息,25,0,25,群益金鼎-桃園,2023-12-04,9189
3706,神達,55,31,24,群益金鼎-桃園,2023-12-04,9189
1312,國喬,23,0,23,群益金鼎-桃園,2023-12-04,9189
6194,育富,26,4,22,群益金鼎-桃園,2023-12-04,9189
2816,旺旺保,26,5,21,群益金鼎-桃園,2023-12-04,9189
4934,太極,20,0,20,群益金鼎-桃園,2023-12-04,9189
2515,中工,20,0,20,群益金鼎-桃園,2023-12-04,9189
4526,東台,19,0,19,群益金鼎-桃園,2023-12-04,9189
00764B,群益25年美債,20,1,19,群益金鼎-桃園,2023-12-04,9189
1605,華新,58,39,19,群益金鼎-桃園,2023-12-04,9189
00934,中信成長高股息,20,2,18,群益金鼎-桃園,2023-12-04,9189
1325,恆大,28,10,18,群益金鼎-桃園,2023-12-04,9189
8996,高力,18,1,17,群益金鼎-桃園,2023-12-04,9189
8034,榮群,17,0,17,群益金鼎-桃園,2023-12-04,9189
6117,迎廣,69,52,17,群益金鼎-桃園,2023-12-04,9189
2009,第一銅,21,5,16,群益金鼎-桃園,2023-12-04,9189
3624,光頡,16,0,16,群益金鼎-桃園,2023-12-04,9189
5425,台半,17,1,16,群益金鼎-桃園,2023-12-04,9189
00680L,元大美債20正2,121,105,16,群益金鼎-桃園,2023-12-04,9189
3623,富晶通,15,0,15,群益金鼎-桃園,2023-12-04,9189
1305,華夏,15,0,15,群益金鼎-桃園,2023-12-04,9189
1708,東鹼,15,0,15,群益金鼎-桃園,2023-12-04,9189
2338,光罩,15,1,14,群益金鼎-桃園,2023-12-04,9189
2376,技嘉,14,1,13,群益金鼎-桃園,2023-12-04,9189
3094,聯傑,13,0,13,群益金鼎-桃園,2023-12-04,9189
1568,倉佑,14,2,12,群益金鼎-桃園,2023-12-04,9189
00642U,期元大S＆P石油,12,0,12,群益金鼎-桃園,2023-12-04,9189
4915,致伸,12,0,12,群益金鼎-桃園,2023-12-04,9189
00935,野村臺灣新科技50,21,9,12,群益金鼎-桃園,2023-12-04,9189
3011,今皓,12,1,11,群益金鼎-桃園,2023-12-04,9189
00650L,復華香港正2,10,0,10,群益金鼎-桃園,2023-12-04,9189
2363,矽統,18,8,10,群益金鼎-桃園,2023-12-04,9189
00937B,群益ESG投等債20,766,501,265,群益金鼎-桃園,2023-12-05,9189
00919,群益台灣精選高息,169,21,148,群益金鼎-桃園,2023-12-05,9189
00680L,元大美債20正2,105,0,105,群益金鼎-桃園,2023-12-05,9189
9958,世紀鋼,111,15,96,群益金鼎-桃園,2023-12-05,9189
00637L,元大滬深300正2,97,13,84,群益金鼎-桃園,2023-12-05,9189
00722B,群益投資級電信債,72,0,72,群益金鼎-桃園,2023-12-05,9189
1316,上曜,70,5,65,群益金鼎-桃園,2023-12-05,9189
3481,群創,174,118,56,群益金鼎-桃園,2023-12-05,9189
5608,四維航,64,10,54,群益金鼎-桃園,2023-12-05,9189
6233,旺玖,96,45,51,群益金鼎-桃園,2023-12-05,9189
3051,力特,52,5,47,群益金鼎-桃園,2023-12-05,9189
4561,健椿,43,1,42,群益金鼎-桃園,2023-12-05,9189
2883,凱基金,45,5,40,群益金鼎-桃園,2023-12-05,9189
3231,緯創,38,9,29,群益金鼎-桃園,2023-12-05,9189
00929,復華台灣科技優息,77,48,29,群益金鼎-桃園,2023-12-05,9189
1605,華新,68,40,28,群益金鼎-桃園,2023-12-05,9189
2601,益航,29,1,28,群益金鼎-桃園,2023-12-05,9189
5347,世界,27,0,27,群益金鼎-桃園,2023-12-05,9189
2465,麗臺,28,1,27,群益金鼎-桃園,2023-12-05,9189
2489,瑞軒,29,3,26,群益金鼎-桃園,2023-12-05,9189
1513,中興電,70,47,23,群益金鼎-桃園,2023-12-05,9189
00650L,復華香港正2,23,0,23,群益金鼎-桃園,2023-12-05,9189
1795,美時,33,11,22,群益金鼎-桃園,2023-12-05,9189
2888,新光金,21,0,21,群益金鼎-桃園,2023-12-05,9189
2641,正德,84,63,21,群益金鼎-桃園,2023-12-05,9189
2515,中工,20,0,20,群益金鼎-桃園,2023-12-05,9189
1504,東元,26,6,20,群益金鼎-桃園,2023-12-05,9189
6112,邁達特,24,5,19,群益金鼎-桃園,2023-12-05,9189
00687B,國泰20年美債,24,5,19,群益金鼎-桃園,2023-12-05,9189
1325,恆大,25,6,19,群益金鼎-桃園,2023-12-05,9189
3035,智原,35,18,17,群益金鼎-桃園,2023-12-05,9189
2308,台達電,17,0,17,群益金鼎-桃園,2023-12-05,9189
4167,松瑞藥,42,26,16,群益金鼎-桃園,2023-12-05,9189
3380,明泰,21,5,16,群益金鼎-桃園,2023-12-05,9189
00882,中信中國高股息,16,0,16,群益金鼎-桃園,2023-12-05,9189
1701,中化,16,1,15,群益金鼎-桃園,2023-12-05,9189
2330,台積電,14,0,14,群益金鼎-桃園,2023-12-05,9189
3715,定穎投控,24,11,13,群益金鼎-桃園,2023-12-05,9189
8089,康全電訊,25,12,13,群益金鼎-桃園,2023-12-05,9189
2313,華通,19,6,13,群益金鼎-桃園,2023-12-05,9189
00935,野村臺灣新科技50,12,0,12,群益金鼎-桃園,2023-12-05,9189
3325,旭品,16,4,12,群益金鼎-桃園,2023-12-05,9189
6016,康和證,12,0,12,群益金鼎-桃園,2023-12-05,9189
5381,合正,12,0,12,群益金鼎-桃園,2023-12-05,9189
2303,聯電,13,2,11,群益金鼎-桃園,2023-12-05,9189
6288,聯嘉,11,0,11,群益金鼎-桃園,2023-12-05,9189
00923,群益台ESG低碳50,11,0,11,群益金鼎-桃園,2023-12-05,9189
00918,大華優利高填息30,11,0,11,群益金鼎-桃園,2023-12-05,9189
00931B,統一美債20年,11,0,11,群益金鼎-桃園,2023-12-05,9189
8171,天宇,11,0,11,群益金鼎-桃園,2023-12-05,9189
1522,堤維西,89,18,71,群益金鼎-桃園,2023-12-06,9189
5426,振發,77,19,58,群益金鼎-桃園,2023-12-06,9189
6733,博晟生醫,50,0,50,群益金鼎-桃園,2023-12-06,9189
00720B,元大投資級公司債,50,8,42,群益金鼎-桃園,2023-12-06,9189
00918,大華優利高填息30,41,0,41,群益金鼎-桃園,2023-12-06,9189
00637L,元大滬深300正2,44,4,40,群益金鼎-桃園,2023-12-06,9189
3013,晟銘電,115,75,40,群益金鼎-桃園,2023-12-06,9189
00632R,元大台灣50反1,43,3,40,群益金鼎-桃園,2023-12-06,9189
2419,仲琦,71,37,34,群益金鼎-桃園,2023-12-06,9189
00919,群益台灣精選高息,54,24,30,群益金鼎-桃園,2023-12-06,9189
2031,新光鋼,30,0,30,群益金鼎-桃園,2023-12-06,9189
2303,聯電,32,4,28,群益金鼎-桃園,2023-12-06,9189
1514,亞力,60,34,26,群益金鼎-桃園,2023-12-06,9189
2606,裕民,51,25,26,群益金鼎-桃園,2023-12-06,9189
5258,虹堡,27,4,23,群益金鼎-桃園,2023-12-06,9189
1591,駿吉-KY,27,4,23,群益金鼎-桃園,2023-12-06,9189
1529,樂事綠能,28,6,22,群益金鼎-桃園,2023-12-06,9189
1605,華新,21,1,20,群益金鼎-桃園,2023-12-06,9189
2618,長榮航,25,5,20,群益金鼎-桃園,2023-12-06,9189
2516,新建,20,0,20,群益金鼎-桃園,2023-12-06,9189
2816,旺旺保,20,1,19,群益金鼎-桃園,2023-12-06,9189
5452,佶優,18,0,18,群益金鼎-桃園,2023-12-06,9189
1316,上曜,20,2,18,群益金鼎-桃園,2023-12-06,9189
00679B,元大美債20年,20,2,18,群益金鼎-桃園,2023-12-06,9189
1513,中興電,28,12,16,群益金鼎-桃園,2023-12-06,9189
3701,大眾控,15,0,15,群益金鼎-桃園,2023-12-06,9189
8215,明基材,15,0,15,群益金鼎-桃園,2023-12-06,9189
1319,東陽,30,17,13,群益金鼎-桃園,2023-12-06,9189
1325,恆大,25,12,13,群益金鼎-桃園,2023-12-06,9189
2323,中環,13,0,13,群益金鼎-桃園,2023-12-06,9189
1568,倉佑,17,5,12,群益金鼎-桃園,2023-12-06,9189
2603,長榮,13,1,12,群益金鼎-桃園,2023-12-06,9189
2883,凱基金,32,20,12,群益金鼎-桃園,2023-12-06,9189
00857B,永豐20年美公債,11,0,11,群益金鼎-桃園,2023-12-06,9189
3481,群創,93,82,11,群益金鼎-桃園,2023-12-06,9189
1324,地球,11,0,11,群益金鼎-桃園,2023-12-06,9189
3231,緯創,21,10,11,群益金鼎-桃園,2023-12-06,9189
00751B,元大AAA至A公司債,13,3,10,群益金鼎-桃園,2023-12-06,9189
1701,中化,10,0,10,群益金鼎-桃園,2023-12-06,9189
3047,訊舟,10,0,10,群益金鼎-桃園,2023-12-06,9189
2354,鴻準,10,0,10,群益金鼎-桃園,2023-12-06,9189
5607,遠雄港,10,0,10,群益金鼎-桃園,2023-12-06,9189
1305,華夏,10,0,10,群益金鼎-桃園,2023-12-06,9189
6213,聯茂,12,2,10,群益金鼎-桃園,2023-12-06,9189
8028,昇陽半導體,10,0,10,群益金鼎-桃園,2023-12-06,9189
6271,同欣電,10,1,9,群益金鼎-桃園,2023-12-06,9189
4116,明基醫,9,0,9,群益金鼎-桃園,2023-12-06,9189
00706L,期元大S＆P日圓正2,9,0,9,群益金鼎-桃園,2023-12-06,9189
2605,新興,91,83,8,群益金鼎-桃園,2023-12-06,9189
5347,世界,9,1,8,群益金鼎-桃園,2023-12-06,9189
00919,群益台灣精選高息,255,37,218,群益金鼎-桃園,2023-12-07,9189
2883B,凱基金乙特,160,0,160,群益金鼎-桃園,2023-12-07,9189
00680L,元大美債20正2,148,5,143,群益金鼎-桃園,2023-12-07,9189
00937B,群益ESG投等債20,268,160,108,群益金鼎-桃園,2023-12-07,9189
00933B,國泰10Y+金融債,103,17,86,群益金鼎-桃園,2023-12-07,9189
00687B,國泰20年美債,77,16,61,群益金鼎-桃園,2023-12-07,9189
3013,晟銘電,112,52,60,群益金鼎-桃園,2023-12-07,9189
00929,復華台灣科技優息,44,0,44,群益金鼎-桃園,2023-12-07,9189
00931B,統一美債20年,62,20,42,群益金鼎-桃園,2023-12-07,9189
2605,新興,49,7,42,群益金鼎-桃園,2023-12-07,9189
00712,復華富時不動產,39,0,39,群益金鼎-桃園,2023-12-07,9189
2367,燿華,79,41,38,群益金鼎-桃園,2023-12-07,9189
6233,旺玖,61,24,37,群益金鼎-桃園,2023-12-07,9189
00637L,元大滬深300正2,35,0,35,群益金鼎-桃園,2023-12-07,9189
00918,大華優利高填息30,29,0,29,群益金鼎-桃園,2023-12-07,9189
2313,華通,65,39,26,群益金鼎-桃園,2023-12-07,9189
2329,華泰,46,20,26,群益金鼎-桃園,2023-12-07,9189
3041,揚智,110,84,26,群益金鼎-桃園,2023-12-07,9189
2204,中華,22,0,22,群益金鼎-桃園,2023-12-07,9189
1219,福壽,20,0,20,群益金鼎-桃園,2023-12-07,9189
2489,瑞軒,20,0,20,群益金鼎-桃園,2023-12-07,9189
2102,泰豐,22,2,20,群益金鼎-桃園,2023-12-07,9189
2891,中信金,20,1,19,群益金鼎-桃園,2023-12-07,9189
3162,精確,19,0,19,群益金鼎-桃園,2023-12-07,9189
4561,健椿,23,4,19,群益金鼎-桃園,2023-12-07,9189
2618,長榮航,63,45,18,群益金鼎-桃園,2023-12-07,9189
6282,康舒,17,2,15,群益金鼎-桃園,2023-12-07,9189
1612,宏泰,19,5,14,群益金鼎-桃園,2023-12-07,9189
2637,慧洋-KY,16,2,14,群益金鼎-桃園,2023-12-07,9189
00882,中信中國高股息,14,0,14,群益金鼎-桃園,2023-12-07,9189
8210,勤誠,17,3,14,群益金鼎-桃園,2023-12-07,9189
3715,定穎投控,17,4,13,群益金鼎-桃園,2023-12-07,9189
2399,映泰,17,4,13,群益金鼎-桃園,2023-12-07,9189
00720B,元大投資級公司債,13,0,13,群益金鼎-桃園,2023-12-07,9189
1529,樂事綠能,49,36,13,群益金鼎-桃園,2023-12-07,9189
2474,可成,12,0,12,群益金鼎-桃園,2023-12-07,9189
2881,富邦金,13,1,12,群益金鼎-桃園,2023-12-07,9189
2816,旺旺保,20,8,12,群益金鼎-桃園,2023-12-07,9189
00642U,期元大S＆P石油,12,0,12,群益金鼎-桃園,2023-12-07,9189
00751B,元大AAA至A公司債,13,2,11,群益金鼎-桃園,2023-12-07,9189
3234,光環,12,1,11,群益金鼎-桃園,2023-12-07,9189
6712,長聖,11,0,11,群益金鼎-桃園,2023-12-07,9189
2641,正德,14,3,11,群益金鼎-桃園,2023-12-07,9189
8932,智通*,16,5,11,群益金鼎-桃園,2023-12-07,9189
6129,普誠,11,0,11,群益金鼎-桃園,2023-12-07,9189
00923,群益台ESG低碳50,10,0,10,群益金鼎-桃園,2023-12-07,9189
3036,文曄,10,0,10,群益金鼎-桃園,2023-12-07,9189
00753L,中信中國50正2,10,0,10,群益金鼎-桃園,2023-12-07,9189
2354,鴻準,11,1,10,群益金鼎-桃園,2023-12-07,9189
3501,維熹,10,0,10,群益金鼎-桃園,2023-12-07,9189
00919,群益台灣精選高息,204,14,190,群益金鼎-桃園,2023-12-08,9189
00680L,元大美債20正2,100,2,98,群益金鼎-桃園,2023-12-08,9189
2329,華泰,92,25,67,群益金鼎-桃園,2023-12-08,9189
00753L,中信中國50正2,55,11,44,群益金鼎-桃園,2023-12-08,9189
00929,復華台灣科技優息,52,15,37,群益金鼎-桃園,2023-12-08,9189
00752,中信中國50,36,0,36,群益金鼎-桃園,2023-12-08,9189
00937B,群益ESG投等債20,87,51,36,群益金鼎-桃園,2023-12-08,9189
00632R,元大台灣50反1,35,12,23,群益金鼎-桃園,2023-12-08,9189
2883B,凱基金乙特,23,0,23,群益金鼎-桃園,2023-12-08,9189
3051,力特,42,19,23,群益金鼎-桃園,2023-12-08,9189
00720B,元大投資級公司債,27,5,22,群益金鼎-桃園,2023-12-08,9189
2882,國泰金,21,0,21,群益金鼎-桃園,2023-12-08,9189
00712,復華富時不動產,22,2,20,群益金鼎-桃園,2023-12-08,9189
6799,來頡,22,2,20,群益金鼎-桃園,2023-12-08,9189
00715L,期街口布蘭特正2,24,5,19,群益金鼎-桃園,2023-12-08,9189
8034,榮群,19,0,19,群益金鼎-桃園,2023-12-08,9189
3481,群創,124,106,18,群益金鼎-桃園,2023-12-08,9189
3265,台星科,20,2,18,群益金鼎-桃園,2023-12-08,9189
00687B,國泰20年美債,26,8,18,群益金鼎-桃園,2023-12-08,9189
1524,耿鼎,274,256,18,群益金鼎-桃園,2023-12-08,9189
00882,中信中國高股息,17,0,17,群益金鼎-桃園,2023-12-08,9189
1514,亞力,54,37,17,群益金鼎-桃園,2023-12-08,9189
1522,堤維西,57,41,16,群益金鼎-桃園,2023-12-08,9189
8354,冠好,16,0,16,群益金鼎-桃園,2023-12-08,9189
2031,新光鋼,15,0,15,群益金鼎-桃園,2023-12-08,9189
5536,聖暉*,15,0,15,群益金鼎-桃園,2023-12-08,9189
8271,宇瞻,14,0,14,群益金鼎-桃園,2023-12-08,9189
2606,裕民,15,1,14,群益金鼎-桃園,2023-12-08,9189
1529,樂事綠能,14,0,14,群益金鼎-桃園,2023-12-08,9189
00679B,元大美債20年,14,0,14,群益金鼎-桃園,2023-12-08,9189
1513,中興電,15,3,12,群益金鼎-桃園,2023-12-08,9189
8996,高力,14,2,12,群益金鼎-桃園,2023-12-08,9189
4123,晟德,11,0,11,群益金鼎-桃園,2023-12-08,9189
3041,揚智,12,1,11,群益金鼎-桃園,2023-12-08,9189
00751B,元大AAA至A公司債,10,0,10,群益金鼎-桃園,2023-12-08,9189
2015,豐興,10,0,10,群益金鼎-桃園,2023-12-08,9189
2314,台揚,10,0,10,群益金鼎-桃園,2023-12-08,9189
2605,新興,134,124,10,群益金鼎-桃園,2023-12-08,9189
3545,敦泰,11,1,10,群益金鼎-桃園,2023-12-08,9189
2449,京元電子,18,9,9,群益金鼎-桃園,2023-12-08,9189
6531,愛普*,13,4,9,群益金鼎-桃園,2023-12-08,9189
3380,明泰,11,2,9,群益金鼎-桃園,2023-12-08,9189
00706L,期元大S＆P日圓正2,19,10,9,群益金鼎-桃園,2023-12-08,9189
00915,凱基優選高股息30,8,0,8,群益金鼎-桃園,2023-12-08,9189
1605,華新,14,6,8,群益金鼎-桃園,2023-12-08,9189
3390,旭軟,11,3,8,群益金鼎-桃園,2023-12-08,9189
6239,力成,11,3,8,群益金鼎-桃園,2023-12-08,9189
2405,輔信,20,12,8,群益金鼎-桃園,2023-12-08,9189
4906,正文,8,0,8,群益金鼎-桃園,2023-12-08,9189
9933,中鼎,8,0,8,群益金鼎-桃園,2023-12-08,9189
00919,群益台灣精選高息,138,7,131,群益金鼎-桃園,2023-12-11,9189
00937B,群益ESG投等債20,122,15,107,群益金鼎-桃園,2023-12-11,9189
1815,富喬,100,2,98,群益金鼎-桃園,2023-12-11,9189
2888,新光金,79,0,79,群益金鼎-桃園,2023-12-11,9189
3607,谷崧,65,24,41,群益金鼎-桃園,2023-12-11,9189
1524,耿鼎,146,108,38,群益金鼎-桃園,2023-12-11,9189
2323,中環,38,1,37,群益金鼎-桃園,2023-12-11,9189
3078,僑威,36,0,36,群益金鼎-桃園,2023-12-11,9189
5324,士開,33,1,32,群益金鼎-桃園,2023-12-11,9189
1618,合機,113,82,31,群益金鼎-桃園,2023-12-11,9189
00918,大華優利高填息30,32,2,30,群益金鼎-桃園,2023-12-11,9189
2884,玉山金,30,0,30,群益金鼎-桃園,2023-12-11,9189
2883B,凱基金乙特,30,0,30,群益金鼎-桃園,2023-12-11,9189
5607,遠雄港,25,0,25,群益金鼎-桃園,2023-12-11,9189
2618,長榮航,44,20,24,群益金鼎-桃園,2023-12-11,9189
1612,宏泰,40,17,23,群益金鼎-桃園,2023-12-11,9189
2457,飛宏,22,0,22,群益金鼎-桃園,2023-12-11,9189
6233,旺玖,34,12,22,群益金鼎-桃園,2023-12-11,9189
00680L,元大美債20正2,21,0,21,群益金鼎-桃園,2023-12-11,9189
00882,中信中國高股息,25,4,21,群益金鼎-桃園,2023-12-11,9189
5381,合正,20,0,20,群益金鼎-桃園,2023-12-11,9189
6016,康和證,20,0,20,群益金鼎-桃園,2023-12-11,9189
2365,昆盈,25,6,19,群益金鼎-桃園,2023-12-11,9189
5521,工信,19,0,19,群益金鼎-桃園,2023-12-11,9189
3545,敦泰,22,4,18,群益金鼎-桃園,2023-12-11,9189
00650L,復華香港正2,16,0,16,群益金鼎-桃園,2023-12-11,9189
6290,良維,17,1,16,群益金鼎-桃園,2023-12-11,9189
00637L,元大滬深300正2,15,0,15,群益金鼎-桃園,2023-12-11,9189
8112,至上,63,48,15,群益金鼎-桃園,2023-12-11,9189
6470,宇智,14,0,14,群益金鼎-桃園,2023-12-11,9189
4916,事欣科,13,0,13,群益金鼎-桃園,2023-12-11,9189
00751B,元大AAA至A公司債,13,0,13,群益金鼎-桃園,2023-12-11,9189
3231,緯創,23,10,13,群益金鼎-桃園,2023-12-11,9189
2002,中鋼,36,24,12,群益金鼎-桃園,2023-12-11,9189
2388,威盛,20,8,12,群益金鼎-桃園,2023-12-11,9189
5353,台林,12,0,12,群益金鼎-桃園,2023-12-11,9189
6770,力積電,13,2,11,群益金鼎-桃園,2023-12-11,9189
4906,正文,11,0,11,群益金鼎-桃園,2023-12-11,9189
6684,安格,11,0,11,群益金鼎-桃園,2023-12-11,9189
3141,晶宏,11,0,11,群益金鼎-桃園,2023-12-11,9189
00878,國泰永續高股息,12,1,11,群益金鼎-桃園,2023-12-11,9189
2543,皇昌,12,2,10,群益金鼎-桃園,2023-12-11,9189
00753L,中信中國50正2,10,0,10,群益金鼎-桃園,2023-12-11,9189
3257,虹冠電,10,0,10,群益金鼎-桃園,2023-12-11,9189
3479,安勤,16,6,10,群益金鼎-桃園,2023-12-11,9189
3038,全台,11,1,10,群益金鼎-桃園,2023-12-11,9189
2701,萬企,10,0,10,群益金鼎-桃園,2023-12-11,9189
6235,華孚,10,0,10,群益金鼎-桃園,2023-12-11,9189
1701,中化,11,1,10,群益金鼎-桃園,2023-12-11,9189
1529,樂事綠能,11,1,10,群益金鼎-桃園,2023-12-11,9189
00918,大華優利高填息30,206,0,206,群益金鼎-桃園,2023-12-12,9189
00929,復華台灣科技優息,194,13,181,群益金鼎-桃園,2023-12-12,9189
00919,群益台灣精選高息,131,23,108,群益金鼎-桃園,2023-12-12,9189
00937B,群益ESG投等債20,113,12,101,群益金鼎-桃園,2023-12-12,9189
1618,合機,212,122,90,群益金鼎-桃園,2023-12-12,9189
2618,長榮航,87,3,84,群益金鼎-桃園,2023-12-12,9189
4720,德淵,58,0,58,群益金鼎-桃園,2023-12-12,9189
2313,華通,83,25,58,群益金鼎-桃園,2023-12-12,9189
3694,海華,54,4,50,群益金鼎-桃園,2023-12-12,9189
1108,幸福,40,0,40,群益金鼎-桃園,2023-12-12,9189
5355,佳總,40,0,40,群益金鼎-桃園,2023-12-12,9189
5483,中美晶,38,1,37,群益金鼎-桃園,2023-12-12,9189
8034,榮群,82,51,31,群益金鼎-桃園,2023-12-12,9189
3450,聯鈞,33,4,29,群益金鼎-桃園,2023-12-12,9189
2402,毅嘉,43,15,28,群益金鼎-桃園,2023-12-12,9189
2363,矽統,34,7,27,群益金鼎-桃園,2023-12-12,9189
4908,前鼎,31,6,25,群益金鼎-桃園,2023-12-12,9189
3706,神達,24,0,24,群益金鼎-桃園,2023-12-12,9189
1615,大山,24,0,24,群益金鼎-桃園,2023-12-12,9189
00687B,國泰20年美債,38,14,24,群益金鼎-桃園,2023-12-12,9189
4967,十銓,31,8,23,群益金鼎-桃園,2023-12-12,9189
6684,安格,22,1,21,群益金鼎-桃園,2023-12-12,9189
5381,合正,27,7,20,群益金鼎-桃園,2023-12-12,9189
6113,亞矽,28,10,18,群益金鼎-桃園,2023-12-12,9189
2607,榮運,18,2,16,群益金鼎-桃園,2023-12-12,9189
00900,富邦特選高股息30,16,1,15,群益金鼎-桃園,2023-12-12,9189
00753L,中信中國50正2,15,0,15,群益金鼎-桃園,2023-12-12,9189
2002,中鋼,23,8,15,群益金鼎-桃園,2023-12-12,9189
8086,宏捷科,31,17,14,群益金鼎-桃園,2023-12-12,9189
1909,榮成,14,0,14,群益金鼎-桃園,2023-12-12,9189
6282,康舒,14,1,13,群益金鼎-桃園,2023-12-12,9189
1471,首利,13,0,13,群益金鼎-桃園,2023-12-12,9189
3712,永崴投控,25,12,13,群益金鼎-桃園,2023-12-12,9189
6743,安普新,14,2,12,群益金鼎-桃園,2023-12-12,9189
1609,大亞,29,17,12,群益金鼎-桃園,2023-12-12,9189
8222,寶一,12,0,12,群益金鼎-桃園,2023-12-12,9189
2308,台達電,18,7,11,群益金鼎-桃園,2023-12-12,9189
3037,欣興,12,1,11,群益金鼎-桃園,2023-12-12,9189
3058,立德,10,0,10,群益金鼎-桃園,2023-12-12,9189
5328,華容,10,0,10,群益金鼎-桃園,2023-12-12,9189
00756B,群益投等新興公債,10,0,10,群益金鼎-桃園,2023-12-12,9189
2867,三商壽,10,0,10,群益金鼎-桃園,2023-12-12,9189
1781,合世,10,0,10,群益金鼎-桃園,2023-12-12,9189
2913,農林,10,0,10,群益金鼎-桃園,2023-12-12,9189
3338,泰碩,10,1,9,群益金鼎-桃園,2023-12-12,9189
6770,力積電,11,2,9,群益金鼎-桃園,2023-12-12,9189
3209,全科,10,1,9,群益金鼎-桃園,2023-12-12,9189
5258,虹堡,9,0,9,群益金鼎-桃園,2023-12-12,9189
2465,麗臺,9,0,9,群益金鼎-桃園,2023-12-12,9189
2007,燁興,8,0,8,群益金鼎-桃園,2023-12-12,9189
00937B,群益ESG投等債20,365,33,332,群益金鼎-桃園,2023-12-13,9189
3481,群創,105,4,101,群益金鼎-桃園,2023-12-13,9189
2883B,凱基金乙特,87,0,87,群益金鼎-桃園,2023-12-13,9189
00919,群益台灣精選高息,107,39,68,群益金鼎-桃園,2023-12-13,9189
1524,耿鼎,99,34,65,群益金鼎-桃園,2023-12-13,9189
0056,元大高股息,82,27,55,群益金鼎-桃園,2023-12-13,9189
00687B,國泰20年美債,41,0,41,群益金鼎-桃園,2023-12-13,9189
1101,台泥,54,18,36,群益金鼎-桃園,2023-12-13,9189
4933,友輝,37,2,35,群益金鼎-桃園,2023-12-13,9189
2002,中鋼,31,0,31,群益金鼎-桃園,2023-12-13,9189
00933B,國泰10Y+金融債,31,0,31,群益金鼎-桃園,2023-12-13,9189
6122,擎邦,32,2,30,群益金鼎-桃園,2023-12-13,9189
00715L,期街口布蘭特正2,29,0,29,群益金鼎-桃園,2023-12-13,9189
00918,大華優利高填息30,29,0,29,群益金鼎-桃園,2023-12-13,9189
2883,凱基金,29,1,28,群益金鼎-桃園,2023-12-13,9189
2609,陽明,36,8,28,群益金鼎-桃園,2023-12-13,9189
00637L,元大滬深300正2,42,15,27,群益金鼎-桃園,2023-12-13,9189
00632R,元大台灣50反1,27,0,27,群益金鼎-桃園,2023-12-13,9189
00882,中信中國高股息,26,0,26,群益金鼎-桃園,2023-12-13,9189
00680L,元大美債20正2,24,0,24,群益金鼎-桃園,2023-12-13,9189
2376,技嘉,31,9,22,群益金鼎-桃園,2023-12-13,9189
2888,新光金,21,0,21,群益金鼎-桃園,2023-12-13,9189
2323,中環,21,0,21,群益金鼎-桃園,2023-12-13,9189
3287,廣寰科,27,8,19,群益金鼎-桃園,2023-12-13,9189
1618,合機,52,34,18,群益金鼎-桃園,2023-12-13,9189
6265,方土昶,21,4,17,群益金鼎-桃園,2023-12-13,9189
00713,元大台灣高息低波,16,0,16,群益金鼎-桃園,2023-12-13,9189
00642U,期元大S＆P石油,15,0,15,群益金鼎-桃園,2023-12-13,9189
9105,泰金寶-DR,23,8,15,群益金鼎-桃園,2023-12-13,9189
8034,榮群,28,13,15,群益金鼎-桃園,2023-12-13,9189
9919,康那香,19,6,13,群益金鼎-桃園,2023-12-13,9189
00753L,中信中國50正2,16,3,13,群益金鼎-桃園,2023-12-13,9189
1307,三芳,12,0,12,群益金鼎-桃園,2023-12-13,9189
6170,統振,12,0,12,群益金鼎-桃園,2023-12-13,9189
1513,中興電,14,3,11,群益金鼎-桃園,2023-12-13,9189
2459,敦吉,12,1,11,群益金鼎-桃園,2023-12-13,9189
1582,信錦,12,1,11,群益金鼎-桃園,2023-12-13,9189
2387,精元,14,3,11,群益金鼎-桃園,2023-12-13,9189
2605,新興,23,12,11,群益金鼎-桃園,2023-12-13,9189
3712,永崴投控,23,12,11,群益金鼎-桃園,2023-12-13,9189
1609,大亞,32,21,11,群益金鼎-桃園,2023-12-13,9189
2472,立隆電,10,0,10,群益金鼎-桃園,2023-12-13,9189
00936,台新永續高息中小,11,1,10,群益金鼎-桃園,2023-12-13,9189
2371,大同,16,6,10,群益金鼎-桃園,2023-12-13,9189
3043,科風,25,15,10,群益金鼎-桃園,2023-12-13,9189
3081,聯亞,18,8,10,群益金鼎-桃園,2023-12-13,9189
2701,萬企,10,0,10,群益金鼎-桃園,2023-12-13,9189
1616,億泰,10,0,10,群益金鼎-桃園,2023-12-13,9189
2495,普安,10,0,10,群益金鼎-桃園,2023-12-13,9189
6104,創惟,11,1,10,群益金鼎-桃園,2023-12-13,9189
00919,群益台灣精選高息,325,126,199,群益金鼎-桃園,2023-12-14,9189
00679B,元大美債20年,178,6,172,群益金鼎-桃園,2023-12-14,9189
00687B,國泰20年美債,112,5,107,群益金鼎-桃園,2023-12-14,9189
00632R,元大台灣50反1,97,9,88,群益金鼎-桃園,2023-12-14,9189
2888,新光金,109,45,64,群益金鼎-桃園,2023-12-14,9189
00931B,統一美債20年,76,12,64,群益金鼎-桃園,2023-12-14,9189
2313,華通,137,78,59,群益金鼎-桃園,2023-12-14,9189
4720,德淵,45,0,45,群益金鼎-桃園,2023-12-14,9189
2303,聯電,55,10,45,群益金鼎-桃園,2023-12-14,9189
2399,映泰,41,0,41,群益金鼎-桃園,2023-12-14,9189
1618,合機,122,87,35,群益金鼎-桃園,2023-12-14,9189
8096,擎亞,41,6,35,群益金鼎-桃園,2023-12-14,9189
2465,麗臺,37,2,35,群益金鼎-桃園,2023-12-14,9189
1513,中興電,76,41,35,群益金鼎-桃園,2023-12-14,9189
00882,中信中國高股息,30,0,30,群益金鼎-桃園,2023-12-14,9189
2609,陽明,28,2,26,群益金鼎-桃園,2023-12-14,9189
00934,中信成長高股息,26,0,26,群益金鼎-桃園,2023-12-14,9189
5426,振發,215,191,24,群益金鼎-桃園,2023-12-14,9189
2615,萬海,21,0,21,群益金鼎-桃園,2023-12-14,9189
2419,仲琦,29,8,21,群益金鼎-桃園,2023-12-14,9189
3055,蔚華科,20,0,20,群益金鼎-桃園,2023-12-14,9189
1524,耿鼎,26,8,18,群益金鼎-桃園,2023-12-14,9189
8011,台通,49,31,18,群益金鼎-桃園,2023-12-14,9189
5512,力麒,21,3,18,群益金鼎-桃園,2023-12-14,9189
00688L,國泰20年美債正2,25,8,17,群益金鼎-桃園,2023-12-14,9189
8234,新漢,16,0,16,群益金鼎-桃園,2023-12-14,9189
3231,緯創,67,52,15,群益金鼎-桃園,2023-12-14,9189
00933B,國泰10Y+金融債,24,10,14,群益金鼎-桃園,2023-12-14,9189
2329,華泰,37,23,14,群益金鼎-桃園,2023-12-14,9189
8112,至上,41,28,13,群益金鼎-桃園,2023-12-14,9189
00637L,元大滬深300正2,232,220,12,群益金鼎-桃園,2023-12-14,9189
00664R,國泰臺灣加權反1,12,0,12,群益金鼎-桃園,2023-12-14,9189
2610,華航,13,1,12,群益金鼎-桃園,2023-12-14,9189
3015,全漢,12,0,12,群益金鼎-桃園,2023-12-14,9189
8936,國統,16,4,12,群益金鼎-桃園,2023-12-14,9189
00900,富邦特選高股息30,21,9,12,群益金鼎-桃園,2023-12-14,9189
00885,富邦越南,13,2,11,群益金鼎-桃園,2023-12-14,9189
1503,士電,13,2,11,群益金鼎-桃園,2023-12-14,9189
3715,定穎投控,16,5,11,群益金鼎-桃園,2023-12-14,9189
2882,國泰金,18,8,10,群益金鼎-桃園,2023-12-14,9189
3479,安勤,10,0,10,群益金鼎-桃園,2023-12-14,9189
3499,環天科,10,0,10,群益金鼎-桃園,2023-12-14,9189
6139,亞翔,16,6,10,群益金鼎-桃園,2023-12-14,9189
1307,三芳,10,0,10,群益金鼎-桃園,2023-12-14,9189
3188,鑫龍騰,10,0,10,群益金鼎-桃園,2023-12-14,9189
1512,瑞利,10,0,10,群益金鼎-桃園,2023-12-14,9189
3576,聯合再生,10,0,10,群益金鼎-桃園,2023-12-14,9189
6285,啟��,28,18,10,群益金鼎-桃園,2023-12-14,9189
1815,富喬,11,1,10,群益金鼎-桃園,2023-12-14,9189
4746,台耀,11,2,9,群益金鼎-桃園,2023-12-14,9189
00937B,群益ESG投等債20,794,70,724,群益金鼎-桃園,2023-12-15,9189
00919,群益台灣精選高息,293,82,211,群益金鼎-桃園,2023-12-15,9189
00632R,元大台灣50反1,173,0,173,群益金鼎-桃園,2023-12-15,9189
00933B,國泰10Y+金融債,139,1,138,群益金鼎-桃園,2023-12-15,9189
00929,復華台灣科技優息,129,4,125,群益金鼎-桃園,2023-12-15,9189
2356,英業達,220,104,116,群益金鼎-桃園,2023-12-15,9189
00687B,國泰20年美債,110,2,108,群益金鼎-桃園,2023-12-15,9189
3481,群創,100,14,86,群益金鼎-桃園,2023-12-15,9189
00679B,元大美債20年,45,3,42,群益金鼎-桃園,2023-12-15,9189
00637L,元大滬深300正2,245,205,40,群益金鼎-桃園,2023-12-15,9189
1584,精剛,73,33,40,群益金鼎-桃園,2023-12-15,9189
2883B,凱基金乙特,40,0,40,群益金鼎-桃園,2023-12-15,9189
00673R,期元大S＆P原油反1,38,0,38,群益金鼎-桃園,2023-12-15,9189
2363,矽統,176,145,31,群益金鼎-桃園,2023-12-15,9189
0056,元大高股息,32,2,30,群益金鼎-桃園,2023-12-15,9189
1524,耿鼎,27,0,27,群益金鼎-桃園,2023-12-15,9189
9958,世紀鋼,55,29,26,群益金鼎-桃園,2023-12-15,9189
2388,威盛,51,26,25,群益金鼎-桃園,2023-12-15,9189
2367,燿華,28,4,24,群益金鼎-桃園,2023-12-15,9189
1319,東陽,24,0,24,群益金鼎-桃園,2023-12-15,9189
3622,洋華,25,2,23,群益金鼎-桃園,2023-12-15,9189
2365,昆盈,32,11,21,群益金鼎-桃園,2023-12-15,9189
00751B,元大AAA至A公司債,24,7,17,群益金鼎-桃園,2023-12-15,9189
6257,矽格,23,7,16,群益金鼎-桃園,2023-12-15,9189
3715,定穎投控,17,1,16,群益金鼎-桃園,2023-12-15,9189
4533,協易機,15,0,15,群益金鼎-桃園,2023-12-15,9189
6284,佳邦,25,10,15,群益金鼎-桃園,2023-12-15,9189
2801,彰銀,21,7,14,群益金鼎-桃園,2023-12-15,9189
2890,永豐金,13,0,13,群益金鼎-桃園,2023-12-15,9189
6274,台燿,13,0,13,群益金鼎-桃園,2023-12-15,9189
2457,飛宏,18,6,12,群益金鼎-桃園,2023-12-15,9189
2402,毅嘉,34,22,12,群益金鼎-桃園,2023-12-15,9189
3260,威剛,17,5,12,群益金鼎-桃園,2023-12-15,9189
4130,健亞,12,0,12,群益金鼎-桃園,2023-12-15,9189
2892,第一金,20,8,12,群益金鼎-桃園,2023-12-15,9189
00795B,中信美國公債20年,14,3,11,群益金鼎-桃園,2023-12-15,9189
2468,華經,11,0,11,群益金鼎-桃園,2023-12-15,9189
3587,閎康,11,0,11,群益金鼎-桃園,2023-12-15,9189
2486,一詮,11,0,11,群益金鼎-桃園,2023-12-15,9189
2359,所羅門,11,0,11,群益金鼎-桃園,2023-12-15,9189
00935,野村臺灣新科技50,10,0,10,群益金鼎-桃園,2023-12-15,9189
00664R,國泰臺灣加權反1,10,0,10,群益金鼎-桃園,2023-12-15,9189
3047,訊舟,20,10,10,群益金鼎-桃園,2023-12-15,9189
5381,合正,10,0,10,群益金鼎-桃園,2023-12-15,9189
1785,光洋科,10,0,10,群益金鼎-桃園,2023-12-15,9189
1616,億泰,20,10,10,群益金鼎-桃園,2023-12-15,9189
00882,中信中國高股息,20,10,10,群益金鼎-桃園,2023-12-15,9189
9962,有益,10,0,10,群益金鼎-桃園,2023-12-15,9189
2328,廣宇,10,0,10,群益金鼎-桃園,2023-12-15,9189
2492,華新科,13,3,10,群益金鼎-桃園,2023-12-15,9189
00687B,國泰20年美債,126,53,73,群益金鼎-桃園,2023-12-18,9189
2002,中鋼,81,12,69,群益金鼎-桃園,2023-12-18,9189
2888,新光金,53,0,53,群益金鼎-桃園,2023-12-18,9189
00751B,元大AAA至A公司債,47,0,47,群益金鼎-桃園,2023-12-18,9189
00919,群益台灣精選高息,95,54,41,群益金鼎-桃園,2023-12-18,9189
2371,大同,42,1,41,群益金鼎-桃園,2023-12-18,9189
3043,科風,40,0,40,群益金鼎-桃園,2023-12-18,9189
2356,英業達,120,80,40,群益金鼎-桃園,2023-12-18,9189
2618,長榮航,65,29,36,群益金鼎-桃園,2023-12-18,9189
2313,華通,43,8,35,群益金鼎-桃園,2023-12-18,9189
2812,台中銀,30,1,29,群益金鼎-桃園,2023-12-18,9189
2401,凌陽,30,3,27,群益金鼎-桃園,2023-12-18,9189
1905,華紙,28,2,26,群益金鼎-桃園,2023-12-18,9189
00637L,元大滬深300正2,24,0,24,群益金鼎-桃園,2023-12-18,9189
00753L,中信中國50正2,24,0,24,群益金鼎-桃園,2023-12-18,9189
9933,中鼎,28,5,23,群益金鼎-桃園,2023-12-18,9189
2610,華航,43,21,22,群益金鼎-桃園,2023-12-18,9189
00679B,元大美債20年,41,19,22,群益金鼎-桃園,2023-12-18,9189
5381,合正,20,0,20,群益金鼎-桃園,2023-12-18,9189
6202,盛群,20,0,20,群益金鼎-桃園,2023-12-18,9189
2883B,凱基金乙特,20,0,20,群益金鼎-桃園,2023-12-18,9189
1504,東元,21,1,20,群益金鼎-桃園,2023-12-18,9189
2867,三商壽,20,1,19,群益金鼎-桃園,2023-12-18,9189
2890,永豐金,19,0,19,群益金鼎-桃園,2023-12-18,9189
0056,元大高股息,20,2,18,群益金鼎-桃園,2023-12-18,9189
00933B,國泰10Y+金融債,29,11,18,群益金鼎-桃園,2023-12-18,9189
2388,威盛,22,5,17,群益金鼎-桃園,2023-12-18,9189
6668,中揚光,16,0,16,群益金鼎-桃園,2023-12-18,9189
2436,偉詮電,17,2,15,群益金鼎-桃園,2023-12-18,9189
2913,農林,24,9,15,群益金鼎-桃園,2023-12-18,9189
5324,士開,15,0,15,群益金鼎-桃園,2023-12-18,9189
00688L,國泰20年美債正2,15,0,15,群益金鼎-桃園,2023-12-18,9189
2915,潤泰全,15,0,15,群益金鼎-桃園,2023-12-18,9189
2032,新鋼,24,10,14,群益金鼎-桃園,2023-12-18,9189
8930,青鋼,16,2,14,群益金鼎-桃園,2023-12-18,9189
2014,中鴻,125,111,14,群益金鼎-桃園,2023-12-18,9189
00795B,中信美國公債20年,15,1,14,群益金鼎-桃園,2023-12-18,9189
00931B,統一美債20年,19,6,13,群益金鼎-桃園,2023-12-18,9189
6138,茂達,12,0,12,群益金鼎-桃園,2023-12-18,9189
1802,台玻,12,0,12,群益金鼎-桃園,2023-12-18,9189
6117,迎廣,13,1,12,群益金鼎-桃園,2023-12-18,9189
00680L,元大美債20正2,15,3,12,群益金鼎-桃園,2023-12-18,9189
2883,凱基金,36,25,11,群益金鼎-桃園,2023-12-18,9189
3288,點晶,11,0,11,群益金鼎-桃園,2023-12-18,9189
9919,康那香,11,0,11,群益金鼎-桃園,2023-12-18,9189
6282,康舒,11,0,11,群益金鼎-桃園,2023-12-18,9189
5608,四維航,10,0,10,群益金鼎-桃園,2023-12-18,9189
5521,工信,15,5,10,群益金鼎-桃園,2023-12-18,9189
6129,普誠,10,0,10,群益金鼎-桃園,2023-12-18,9189
5536,聖暉*,9,0,9,群益金鼎-桃園,2023-12-18,9189
2323,中環,104,0,104,群益金鼎-桃園,2023-12-19,9189
9904,寶成,100,0,100,群益金鼎-桃園,2023-12-19,9189
2888,新光金,95,1,94,群益金鼎-桃園,2023-12-19,9189
00919,群益台灣精選高息,101,8,93,群益金鼎-桃園,2023-12-19,9189
2618,長榮航,120,27,93,群益金鼎-桃園,2023-12-19,9189
2801,彰銀,36,0,36,群益金鼎-桃園,2023-12-19,9189
00934,中信成長高股息,43,10,33,群益金鼎-桃園,2023-12-19,9189
6275,元山,32,0,32,群益金鼎-桃園,2023-12-19,9189
0050,元大台灣50,34,2,32,群益金鼎-桃園,2023-12-19,9189
2356,英業達,92,62,30,群益金鼎-桃園,2023-12-19,9189
8150,南茂,30,0,30,群益金鼎-桃園,2023-12-19,9189
00753L,中信中國50正2,25,0,25,群益金鼎-桃園,2023-12-19,9189
6202,盛群,23,0,23,群益金鼎-桃園,2023-12-19,9189
2313,華通,46,23,23,群益金鼎-桃園,2023-12-19,9189
3231,緯創,56,34,22,群益金鼎-桃園,2023-12-19,9189
1101,台泥,23,1,22,群益金鼎-桃園,2023-12-19,9189
2399,映泰,21,0,21,群益金鼎-桃園,2023-12-19,9189
1802,台玻,21,1,20,群益金鼎-桃園,2023-12-19,9189
2308,台達電,18,0,18,群益金鼎-桃園,2023-12-19,9189
00713,元大台灣高息低波,19,2,17,群益金鼎-桃園,2023-12-19,9189
3706,神達,16,0,16,群益金鼎-桃園,2023-12-19,9189
00679B,元大美債20年,28,12,16,群益金鼎-桃園,2023-12-19,9189
6191,精成科,15,0,15,群益金鼎-桃園,2023-12-19,9189
5351,鈺創,15,0,15,群益金鼎-桃園,2023-12-19,9189
2038,海光,37,22,15,群益金鼎-桃園,2023-12-19,9189
6470,宇智,15,0,15,群益金鼎-桃園,2023-12-19,9189
00637L,元大滬深300正2,233,218,15,群益金鼎-桃園,2023-12-19,9189
2515,中工,45,30,15,群益金鼎-桃園,2023-12-19,9189
00712,復華富時不動產,18,4,14,群益金鼎-桃園,2023-12-19,9189
8086,宏捷科,17,3,14,群益金鼎-桃園,2023-12-19,9189
9962,有益,14,0,14,群益金鼎-桃園,2023-12-19,9189
4976,佳凌,14,0,14,群益金鼎-桃園,2023-12-19,9189
2344,華邦電,16,2,14,群益金鼎-桃園,2023-12-19,9189
00687B,國泰20年美債,19,5,14,群益金鼎-桃園,2023-12-19,9189
2023,燁輝,23,10,13,群益金鼎-桃園,2023-12-19,9189
2425,承啟,13,0,13,群益金鼎-桃園,2023-12-19,9189
2328,廣宇,13,0,13,群益金鼎-桃園,2023-12-19,9189
3105,穩懋,17,5,12,群益金鼎-桃園,2023-12-19,9189
00933B,國泰10Y+金融債,29,17,12,群益金鼎-桃園,2023-12-19,9189
6205,詮欣,12,0,12,群益金鼎-桃園,2023-12-19,9189
1513,中興電,14,3,11,群益金鼎-桃園,2023-12-19,9189
2007,燁興,49,38,11,群益金鼎-桃園,2023-12-19,9189
9933,中鼎,11,0,11,群益金鼎-桃園,2023-12-19,9189
6114,久威,14,3,11,群益金鼎-桃園,2023-12-19,9189
2303,聯電,15,4,11,群益金鼎-桃園,2023-12-19,9189
1504,東元,10,0,10,群益金鼎-桃園,2023-12-19,9189
6182,合晶,11,1,10,群益金鼎-桃園,2023-12-19,9189
00688L,國泰20年美債正2,10,0,10,群益金鼎-桃園,2023-12-19,9189
9802,鈺齊-KY,10,0,10,群益金鼎-桃園,2023-12-19,9189
1584,精剛,10,0,10,群益金鼎-桃園,2023-12-19,9189
00919,群益台灣精選高息,173,8,165,群益金鼎-桃園,2023-12-20,9189
6282,康舒,190,79,111,群益金鼎-桃園,2023-12-20,9189
2610,華航,102,3,99,群益金鼎-桃園,2023-12-20,9189
1815,富喬,107,17,90,群益金鼎-桃園,2023-12-20,9189
00878,國泰永續高股息,89,19,70,群益金鼎-桃園,2023-12-20,9189
1905,華紙,74,21,53,群益金鼎-桃園,2023-12-20,9189
9904,寶成,51,0,51,群益金鼎-桃園,2023-12-20,9189
2888,新光金,52,10,42,群益金鼎-桃園,2023-12-20,9189
00679B,元大美債20年,34,0,34,群益金鼎-桃園,2023-12-20,9189
4420,光明,39,8,31,群益金鼎-桃園,2023-12-20,9189
00712,復華富時不動產,30,0,30,群益金鼎-桃園,2023-12-20,9189
00918,大華優利高填息30,29,0,29,群益金鼎-桃園,2023-12-20,9189
2353,宏��,114,86,28,群益金鼎-桃園,2023-12-20,9189
2884,玉山金,26,1,25,群益金鼎-桃園,2023-12-20,9189
00687B,國泰20年美債,26,0,26,群益金鼎-桃園,2023-12-20,9189
2356,英業達,149,125,24,群益金鼎-桃園,2023-12-20,9189
00795B,中信美國公債20年,25,2,23,群益金鼎-桃園,2023-12-20,9189
00637L,元大滬深300正2,234,211,23,群益金鼎-桃園,2023-12-20,9189
2912,統一超,21,0,21,群益金鼎-桃園,2023-12-20,9189
3006,晶豪科,22,2,20,群益金鼎-桃園,2023-12-20,9189
5258,虹堡,22,2,20,群益金鼎-桃園,2023-12-20,9189
2450,神腦,20,0,20,群益金鼎-桃園,2023-12-20,9189
00900,富邦特選高股息30,17,0,17,群益金鼎-桃園,2023-12-20,9189
9933,中鼎,17,0,17,群益金鼎-桃園,2023-12-20,9189
1701,中化,15,0,15,群益金鼎-桃園,2023-12-20,9189
2201,裕隆,15,0,15,群益金鼎-桃園,2023-12-20,9189
3288,點晶,15,0,15,群益金鼎-桃園,2023-12-20,9189
2891,中信金,15,3,12,群益金鼎-桃園,2023-12-20,9189
3548,兆利,28,17,11,群益金鼎-桃園,2023-12-20,9189
2459,敦吉,10,0,10,群益金鼎-桃園,2023-12-20,9189
2102,泰豐,10,0,10,群益金鼎-桃園,2023-12-20,9189
00664R,國泰臺灣加權反1,10,0,10,群益金鼎-桃園,2023-12-20,9189
1213,大飲,10,0,10,群益金鼎-桃園,2023-12-20,9189
3689,湧德,10,0,10,群益金鼎-桃園,2023-12-20,9189
00641R,富邦日本反1,10,0,10,群益金鼎-桃園,2023-12-20,9189
1101,台泥,11,1,10,群益金鼎-桃園,2023-12-20,9189
2317,鴻海,19,10,9,群益金鼎-桃園,2023-12-20,9189
3228,金麗科,13,4,9,群益金鼎-桃園,2023-12-20,9189
2438,翔耀,9,0,9,群益金鼎-桃園,2023-12-20,9189
3622,洋華,11,2,9,群益金鼎-桃園,2023-12-20,9189
8028,昇陽半導體,9,0,9,群益金鼎-桃園,2023-12-20,9189
2408,南亞科,10,1,9,群益金鼎-桃園,2023-12-20,9189
2801,彰銀,10,2,8,群益金鼎-桃園,2023-12-20,9189
00934,中信成長高股息,8,0,8,群益金鼎-桃園,2023-12-20,9189
6156,松上,11,3,8,群益金鼎-桃園,2023-12-20,9189
6117,迎廣,8,1,7,群益金鼎-桃園,2023-12-20,9189
2312,金寶,33,26,7,群益金鼎-桃園,2023-12-20,9189
00688L,國泰20年美債正2,7,0,7,群益金鼎-桃園,2023-12-20,9189
6125,廣運,10,3,7,群益金鼎-桃園,2023-12-20,9189
6182,合晶,7,0,7,群益金鼎-桃園,2023-12-20,9189
00919,群益台灣精選高息,137,0,137,群益金鼎-桃園,2023-12-21,9189
00929,復華台灣科技優息,131,2,129,群益金鼎-桃園,2023-12-21,9189
3548,兆利,128,22,106,群益金鼎-桃園,2023-12-21,9189
4720,德淵,94,0,94,群益金鼎-桃園,2023-12-21,9189
00900,富邦特選高股息30,87,0,87,群益金鼎-桃園,2023-12-21,9189
1325,恆大,99,13,86,群益金鼎-桃園,2023-12-21,9189
00885,富邦越南,65,8,57,群益金鼎-桃園,2023-12-21,9189
1732,毛寶,97,58,39,群益金鼎-桃園,2023-12-21,9189
9945,潤泰新,38,0,38,群益金鼎-桃園,2023-12-21,9189
2038,海光,43,6,37,群益金鼎-桃園,2023-12-21,9189
2323,中環,35,0,35,群益金鼎-桃園,2023-12-21,9189
2515,中工,105,71,34,群益金鼎-桃園,2023-12-21,9189
2331,精英,64,33,31,群益金鼎-桃園,2023-12-21,9189
00673R,期元大S＆P原油反1,31,0,31,群益金鼎-桃園,2023-12-21,9189
0050,元大台灣50,31,1,30,群益金鼎-桃園,2023-12-21,9189
2303,聯電,28,2,26,群益金鼎-桃園,2023-12-21,9189
2607,榮運,42,17,25,群益金鼎-桃園,2023-12-21,9189
00878,國泰永續高股息,33,11,22,群益金鼎-桃園,2023-12-21,9189
2344,華邦電,24,5,19,群益金鼎-桃園,2023-12-21,9189
6742,澤米,20,1,19,群益金鼎-桃園,2023-12-21,9189
9919,康那香,69,51,18,群益金鼎-桃園,2023-12-21,9189
2882,國泰金,23,5,18,群益金鼎-桃園,2023-12-21,9189
9958,世紀鋼,29,12,17,群益金鼎-桃園,2023-12-21,9189
1504,東元,19,3,16,群益金鼎-桃園,2023-12-21,9189
3450,聯鈞,15,0,15,群益金鼎-桃園,2023-12-21,9189
3162,精確,15,0,15,群益金鼎-桃園,2023-12-21,9189
00670L,富邦NASDAQ正2,14,0,14,群益金鼎-桃園,2023-12-21,9189
3228,金麗科,14,0,14,群益金鼎-桃園,2023-12-21,9189
6534,正瀚-創,14,0,14,群益金鼎-桃園,2023-12-21,9189
2365,昆盈,16,2,14,群益金鼎-桃園,2023-12-21,9189
2105,正新,14,1,13,群益金鼎-桃園,2023-12-21,9189
2641,正德,22,9,13,群益金鼎-桃園,2023-12-21,9189
00753L,中信中國50正2,22,10,12,群益金鼎-桃園,2023-12-21,9189
00923,群益台ESG低碳50,12,0,12,群益金鼎-桃園,2023-12-21,9189
2605,新興,12,1,11,群益金鼎-桃園,2023-12-21,9189
3622,洋華,13,2,11,群益金鼎-桃園,2023-12-21,9189
6477,安集,11,0,11,群益金鼎-桃園,2023-12-21,9189
3587,閎康,10,0,10,群益金鼎-桃園,2023-12-21,9189
9935,慶豐富,10,0,10,群益金鼎-桃園,2023-12-21,9189
2884,玉山金,10,0,10,群益金鼎-桃園,2023-12-21,9189
2031,新光鋼,11,1,10,群益金鼎-桃園,2023-12-21,9189
00933B,國泰10Y+金融債,13,3,10,群益金鼎-桃園,2023-12-21,9189
00903,富邦元宇宙,10,0,10,群益金鼎-桃園,2023-12-21,9189
2388,威盛,11,1,10,群益金鼎-桃園,2023-12-21,9189
2201,裕隆,14,5,9,群益金鼎-桃園,2023-12-21,9189
6138,茂達,14,5,9,群益金鼎-桃園,2023-12-21,9189
6182,合晶,8,0,8,群益金鼎-桃園,2023-12-21,9189
3264,欣銓,11,3,8,群益金鼎-桃園,2023-12-21,9189
2390,云辰,8,0,8,群益金鼎-桃園,2023-12-21,9189
6443,元晶,8,0,8,群益金鼎-桃園,2023-12-21,9189
2609,陽明,225,131,94,群益金鼎-桃園,2023-12-22,9189
00937B,群益ESG投等債20,92,7,85,群益金鼎-桃園,2023-12-22,9189
00933B,國泰10Y+金融債,71,5,66,群益金鼎-桃園,2023-12-22,9189
9105,泰金寶-DR,68,5,63,群益金鼎-桃園,2023-12-22,9189
2356,英業達,111,62,49,群益金鼎-桃園,2023-12-22,9189
2615,萬海,115,73,42,群益金鼎-桃園,2023-12-22,9189
2324,仁寶,67,31,36,群益金鼎-桃園,2023-12-22,9189
00753L,中信中國50正2,49,15,34,群益金鼎-桃園,2023-12-22,9189
1326,台化,30,0,30,群益金鼎-桃園,2023-12-22,9189
00637L,元大滬深300正2,30,1,29,群益金鼎-桃園,2023-12-22,9189
00929,復華台灣科技優息,37,9,28,群益金鼎-桃園,2023-12-22,9189
2891,中信金,23,0,23,群益金鼎-桃園,2023-12-22,9189
3231,緯創,66,46,20,群益金鼎-桃園,2023-12-22,9189
2450,神腦,20,0,20,群益金鼎-桃園,2023-12-22,9189
00772B,中信高評級公司債,25,6,19,群益金鼎-桃園,2023-12-22,9189
2867,三商壽,22,3,19,群益金鼎-桃園,2023-12-22,9189
00900,富邦特選高股息30,137,119,18,群益金鼎-桃園,2023-12-22,9189
1531,高林股,18,0,18,群益金鼎-桃園,2023-12-22,9189
2888,新光金,21,3,18,群益金鼎-桃園,2023-12-22,9189
00936,台新永續高息中小,17,0,17,群益金鼎-桃園,2023-12-22,9189
00919,群益台灣精選高息,26,10,16,群益金鼎-桃園,2023-12-22,9189
6116,彩晶,16,0,16,群益金鼎-桃園,2023-12-22,9189
00720B,元大投資級公司債,16,0,16,群益金鼎-桃園,2023-12-22,9189
00878,國泰永續高股息,18,3,15,群益金鼎-桃園,2023-12-22,9189
00687B,國泰20年美債,16,1,15,群益金鼎-桃園,2023-12-22,9189
00669R,國泰美國道瓊反1,15,0,15,群益金鼎-桃園,2023-12-22,9189
2002,中鋼,18,4,14,群益金鼎-桃園,2023-12-22,9189
6742,澤米,15,1,14,群益金鼎-桃園,2023-12-22,9189
00632R,元大台灣50反1,18,5,13,群益金鼎-桃園,2023-12-22,9189
00688L,國泰20年美債正2,13,0,13,群益金鼎-桃園,2023-12-22,9189
2388,威盛,20,8,12,群益金鼎-桃園,2023-12-22,9189
9945,潤泰新,12,0,12,群益金鼎-桃園,2023-12-22,9189
4720,德淵,11,0,11,群益金鼎-桃園,2023-12-22,9189
2367,燿華,15,4,11,群益金鼎-桃園,2023-12-22,9189
6188,廣明,13,2,11,群益金鼎-桃園,2023-12-22,9189
00888,永豐台灣ESG,10,0,10,群益金鼎-桃園,2023-12-22,9189
00751B,元大AAA至A公司債,10,0,10,群益金鼎-桃園,2023-12-22,9189
2028,威致,10,0,10,群益金鼎-桃園,2023-12-22,9189
5340,建榮,10,0,10,群益金鼎-桃園,2023-12-22,9189
2617,台航,10,0,10,群益金鼎-桃園,2023-12-22,9189
4402,郡都開發,10,0,10,群益金鼎-桃園,2023-12-22,9189
2399,映泰,10,0,10,群益金鼎-桃園,2023-12-22,9189
6916,華凌,10,0,10,群益金鼎-桃園,2023-12-22,9189
3499,環天科,9,0,9,群益金鼎-桃園,2023-12-22,9189
2543,皇昌,13,4,9,群益金鼎-桃園,2023-12-22,9189
2208,台船,7,0,7,群益金鼎-桃園,2023-12-22,9189
6477,安集,7,0,7,群益金鼎-桃園,2023-12-22,9189
4543,萬在,7,0,7,群益金鼎-桃園,2023-12-22,9189
2408,南亞科,10,3,7,群益金鼎-桃園,2023-12-22,9189
5009,榮剛,27,21,6,群益金鼎-桃園,2023-12-22,9189
00919,群益台灣精選高息,212,20,192,群益金鼎-桃園,2023-12-25,9189
00929,復華台灣科技優息,93,1,92,群益金鼎-桃園,2023-12-25,9189
00885,富邦越南,95,22,73,群益金鼎-桃園,2023-12-25,9189
2609,陽明,143,79,64,群益金鼎-桃園,2023-12-25,9189
2324,仁寶,118,55,63,群益金鼎-桃園,2023-12-25,9189
2515,中工,78,25,53,群益金鼎-桃園,2023-12-25,9189
2442,新美齊,50,0,50,群益金鼎-桃園,2023-12-25,9189
2313,華通,62,16,46,群益金鼎-桃園,2023-12-25,9189
00937B,群益ESG投等債20,38,0,38,群益金鼎-桃園,2023-12-25,9189
00918,大華優利高填息30,32,0,32,群益金鼎-桃園,2023-12-25,9189
2637,慧洋-KY,33,1,32,群益金鼎-桃園,2023-12-25,9189
5258,虹堡,26,0,26,群益金鼎-桃園,2023-12-25,9189
1612,宏泰,27,4,23,群益金鼎-桃園,2023-12-25,9189
2603,長榮,45,23,22,群益金鼎-桃園,2023-12-25,9189
00687B,國泰20年美債,24,3,21,群益金鼎-桃園,2023-12-25,9189
1582,信錦,21,0,21,群益金鼎-桃園,2023-12-25,9189
5608,四維航,25,4,21,群益金鼎-桃園,2023-12-25,9189
5381,合正,20,1,19,群益金鼎-桃園,2023-12-25,9189
4939,亞電,14,0,14,群益金鼎-桃園,2023-12-25,9189
00688L,國泰20年美債正2,13,0,13,群益金鼎-桃園,2023-12-25,9189
00679B,元大美債20年,13,0,13,群益金鼎-桃園,2023-12-25,9189
3508,位速,13,0,13,群益金鼎-桃園,2023-12-25,9189
00934,中信成長高股息,12,0,12,群益金鼎-桃園,2023-12-25,9189
00921,兆豐龍頭等權重,11,0,11,群益金鼎-桃園,2023-12-25,9189
3260,威剛,13,2,11,群益金鼎-桃園,2023-12-25,9189
2904,匯僑,11,0,11,群益金鼎-桃園,2023-12-25,9189
4973,廣穎,12,1,11,群益金鼎-桃園,2023-12-25,9189
2701,萬企,10,0,10,群益金鼎-桃園,2023-12-25,9189
3051,力特,10,0,10,群益金鼎-桃園,2023-12-25,9189
1589,永冠-KY,10,0,10,群益金鼎-桃園,2023-12-25,9189
4909,新復興,13,3,10,群益金鼎-桃園,2023-12-25,9189
3305,昇貿,10,0,10,群益金鼎-桃園,2023-12-25,9189
4174,浩鼎,10,0,10,群益金鼎-桃園,2023-12-25,9189
8936,國統,11,1,10,群益金鼎-桃園,2023-12-25,9189
9958,世紀鋼,10,0,10,群益金鼎-桃園,2023-12-25,9189
3211,順達,11,2,9,群益金鼎-桃園,2023-12-25,9189
1522,堤維西,10,1,9,群益金鼎-桃園,2023-12-25,9189
3450,聯鈞,9,0,9,群益金鼎-桃園,2023-12-25,9189
9105,泰金寶-DR,10,1,9,群益金鼎-桃園,2023-12-25,9189
6117,迎廣,51,42,9,群益金鼎-桃園,2023-12-25,9189
3041,揚智,23,14,9,群益金鼎-桃園,2023-12-25,9189
4979,華星光,16,7,9,群益金鼎-桃園,2023-12-25,9189
2014,中鴻,20,12,8,群益金鼎-桃園,2023-12-25,9189
00720B,元大投資級公司債,8,0,8,群益金鼎-桃園,2023-12-25,9189
00673R,期元大S＆P原油反1,8,0,8,群益金鼎-桃園,2023-12-25,9189
2405,輔信,11,3,8,群益金鼎-桃園,2023-12-25,9189
00772B,中信高評級公司債,8,0,8,群益金鼎-桃園,2023-12-25,9189
8088,品安,56,48,8,群益金鼎-桃園,2023-12-25,9189
2344,華邦電,12,5,7,群益金鼎-桃園,2023-12-25,9189
3515,華擎,8,1,7,群益金鼎-桃園,2023-12-25,9189
00632R,元大台灣50反1,467,0,467,群益金鼎-桃園,2023-12-26,9189
8096,擎亞,91,9,82,群益金鼎-桃園,2023-12-26,9189
00937B,群益ESG投等債20,55,0,55,群益金鼎-桃園,2023-12-26,9189
00933B,國泰10Y+金融債,57,15,42,群益金鼎-桃園,2023-12-26,9189
1513,中興電,36,1,35,群益金鼎-桃園,2023-12-26,9189
2312,金寶,33,0,33,群益金鼎-桃園,2023-12-26,9189
2369,菱生,30,0,30,群益金鼎-桃園,2023-12-26,9189
2377,微星,41,20,21,群益金鼎-桃園,2023-12-26,9189
00687B,國泰20年美債,20,0,20,群益金鼎-桃園,2023-12-26,9189
2615,萬海,21,1,20,群益金鼎-桃園,2023-12-26,9189
00878,國泰永續高股息,23,5,18,群益金鼎-桃園,2023-12-26,9189
00753L,中信中國50正2,17,0,17,群益金鼎-桃園,2023-12-26,9189
00919,群益台灣精選高息,26,10,16,群益金鼎-桃園,2023-12-26,9189
2801,彰銀,15,0,15,群益金鼎-桃園,2023-12-26,9189
3623,富晶通,13,0,13,群益金鼎-桃園,2023-12-26,9189
6116,彩晶,28,15,13,群益金鼎-桃園,2023-12-26,9189
2634,漢翔,13,1,12,群益金鼎-桃園,2023-12-26,9189
6485,點序,11,0,11,群益金鼎-桃園,2023-12-26,9189
2402,毅嘉,22,11,11,群益金鼎-桃園,2023-12-26,9189
2468,華經,10,0,10,群益金鼎-桃園,2023-12-26,9189
1785,光洋科,10,0,10,群益金鼎-桃園,2023-12-26,9189
2607,榮運,10,1,9,群益金鼎-桃園,2023-12-26,9189
3017,奇鋐,10,1,9,群益金鼎-桃園,2023-12-26,9189
9919,康那香,11,2,9,群益金鼎-桃園,2023-12-26,9189
00713,元大台灣高息低波,9,0,9,群益金鼎-桃園,2023-12-26,9189
2618,長榮航,32,24,8,群益金鼎-桃園,2023-12-26,9189
2352,佳世達,22,14,8,群益金鼎-桃園,2023-12-26,9189
00637L,元大滬深300正2,35,27,8,群益金鼎-桃園,2023-12-26,9189
3704,合勤控,7,0,7,群益金鼎-桃園,2023-12-26,9189
2382,廣達,12,5,7,群益金鼎-桃園,2023-12-26,9189
1522,堤維西,7,0,7,群益金鼎-桃園,2023-12-26,9189
00902,中信電池及儲能,7,0,7,群益金鼎-桃園,2023-12-26,9189
8039,台虹,16,9,7,群益金鼎-桃園,2023-12-26,9189
4968,立積,7,0,7,群益金鼎-桃園,2023-12-26,9189
9933,中鼎,7,0,7,群益金鼎-桃園,2023-12-26,9189
9904,寶成,7,0,7,群益金鼎-桃園,2023-12-26,9189
6182,合晶,13,6,7,群益金鼎-桃園,2023-12-26,9189
1609,大亞,10,3,7,群益金鼎-桃園,2023-12-26,9189
3006,晶豪科,14,7,7,群益金鼎-桃園,2023-12-26,9189
3231,緯創,53,47,6,群益金鼎-桃園,2023-12-26,9189
9907,統一實,6,0,6,群益金鼎-桃園,2023-12-26,9189
1524,耿鼎,7,1,6,群益金鼎-桃園,2023-12-26,9189
00680L,元大美債20正2,6,0,6,群益金鼎-桃園,2023-12-26,9189
8222,寶一,6,0,6,群益金鼎-桃園,2023-12-26,9189
3376,新日興,7,1,6,群益金鼎-桃園,2023-12-26,9189
6916,華凌,6,0,6,群益金鼎-桃園,2023-12-26,9189
2014,中鴻,6,0,6,群益金鼎-桃園,2023-12-26,9189
2356,英業達,63,58,5,群益金鼎-桃園,2023-12-26,9189
5871,中租-KY,5,0,5,群益金鼎-桃園,2023-12-26,9189
3563,牧德,5,0,5,群益金鼎-桃園,2023-12-26,9189
00632R,元大台灣50反1,821,330,491,群益金鼎-桃園,2023-12-27,9189
00929,復華台灣科技優息,382,3,379,群益金鼎-桃園,2023-12-27,9189
00878,國泰永續高股息,351,17,334,群益金鼎-桃園,2023-12-27,9189
00937B,群益ESG投等債20,289,7,282,群益金鼎-桃園,2023-12-27,9189
4720,德淵,100,2,98,群益金鼎-桃園,2023-12-27,9189
2618,長榮航,78,5,73,群益金鼎-桃園,2023-12-27,9189
1101,台泥,53,1,52,群益金鼎-桃園,2023-12-27,9189
2353,宏��,127,75,52,群益金鼎-桃園,2023-12-27,9189
9950,萬國通,33,0,33,群益金鼎-桃園,2023-12-27,9189
8930,青鋼,32,1,31,群益金鼎-桃園,2023-12-27,9189
3188,鑫龍騰,30,0,30,群益金鼎-桃園,2023-12-27,9189
9105,泰金寶-DR,28,0,28,群益金鼎-桃園,2023-12-27,9189
6179,亞通,43,19,24,群益金鼎-桃園,2023-12-27,9189
3264,欣銓,28,4,24,群益金鼎-桃園,2023-12-27,9189
2337,旺宏,39,16,23,群益金鼎-桃園,2023-12-27,9189
8936,國統,28,6,22,群益金鼎-桃園,2023-12-27,9189
2365,昆盈,22,0,22,群益金鼎-桃園,2023-12-27,9189
00753L,中信中國50正2,21,0,21,群益金鼎-桃園,2023-12-27,9189
2450,神腦,20,0,20,群益金鼎-桃園,2023-12-27,9189
6265,方土昶,18,0,18,群益金鼎-桃園,2023-12-27,9189
1605,華新,39,23,16,群益金鼎-桃園,2023-12-27,9189
00673R,期元大S＆P原油反1,16,0,16,群益金鼎-桃園,2023-12-27,9189
6257,矽格,15,0,15,群益金鼎-桃園,2023-12-27,9189
2014,中鴻,19,4,15,群益金鼎-桃園,2023-12-27,9189
3622,洋華,16,1,15,群益金鼎-桃園,2023-12-27,9189
00891,中信關鍵半導體,20,5,15,群益金鼎-桃園,2023-12-27,9189
4967,十銓,13,0,13,群益金鼎-桃園,2023-12-27,9189
6288,聯嘉,13,0,13,群益金鼎-桃園,2023-12-27,9189
00688L,國泰20年美債正2,13,0,13,群益金鼎-桃園,2023-12-27,9189
2358,廷鑫,12,0,12,群益金鼎-桃園,2023-12-27,9189
3234,光環,12,0,12,群益金鼎-桃園,2023-12-27,9189
2812,台中銀,10,0,10,群益金鼎-桃園,2023-12-27,9189
00935,野村臺灣新科技50,12,2,10,群益金鼎-桃園,2023-12-27,9189
3317,尼克森,10,0,10,群益金鼎-桃園,2023-12-27,9189
2809,京城銀,10,0,10,群益金鼎-桃園,2023-12-27,9189
6120,達運,10,0,10,群益金鼎-桃園,2023-12-27,9189
1438,三地開發,53,43,10,群益金鼎-桃園,2023-12-27,9189
2383,台光電,10,0,10,群益金鼎-桃園,2023-12-27,9189
2369,菱生,11,1,10,群益金鼎-桃園,2023-12-27,9189
6182,合晶,15,6,9,群益金鼎-桃園,2023-12-27,9189
2498,宏達電,11,2,9,群益金鼎-桃園,2023-12-27,9189
00664R,國泰臺灣加權反1,9,0,9,群益金鼎-桃園,2023-12-27,9189
3540,曜越,10,1,9,群益金鼎-桃園,2023-12-27,9189
00712,復華富時不動產,10,2,8,群益金鼎-桃園,2023-12-27,9189
2208,台船,8,0,8,群益金鼎-桃園,2023-12-27,9189
3081,聯亞,8,0,8,群益金鼎-桃園,2023-12-27,9189
00882,中信中國高股息,8,0,8,群益金鼎-桃園,2023-12-27,9189
5439,高技,8,0,8,群益金鼎-桃園,2023-12-27,9189
00713,元大台灣高息低波,7,0,7,群益金鼎-桃園,2023-12-27,9189
3049,精金,7,0,7,群益金鼎-桃園,2023-12-27,9189
00937B,群益ESG投等債20,592,0,592,群益金鼎-桃園,2023-12-28,9189
00919,群益台灣精選高息,178,6,172,群益金鼎-桃園,2023-12-28,9189
2603,長榮,186,39,147,群益金鼎-桃園,2023-12-28,9189
00929,復華台灣科技優息,112,15,97,群益金鼎-桃園,2023-12-28,9189
00687B,國泰20年美債,74,0,74,群益金鼎-桃園,2023-12-28,9189
2365,昆盈,122,55,67,群益金鼎-桃園,2023-12-28,9189
00933B,國泰10Y+金融債,63,1,62,群益金鼎-桃園,2023-12-28,9189
2313,華通,57,1,56,群益金鼎-桃園,2023-12-28,9189
2820,華票,37,0,37,群益金鼎-桃園,2023-12-28,9189
2337,旺宏,55,23,32,群益金鼎-桃園,2023-12-28,9189
1618,合機,43,12,31,群益金鼎-桃園,2023-12-28,9189
00900,富邦特選高股息30,27,3,24,群益金鼎-桃園,2023-12-28,9189
1471,首利,23,0,23,群益金鼎-桃園,2023-12-28,9189
1514,亞力,46,27,19,群益金鼎-桃園,2023-12-28,9189
3257,虹冠電,19,1,18,群益金鼎-桃園,2023-12-28,9189
2353,宏��,100,82,18,群益金鼎-桃園,2023-12-28,9189
6188,廣明,41,25,16,群益金鼎-桃園,2023-12-28,9189
8011,台通,16,0,16,群益金鼎-桃園,2023-12-28,9189
00927,群益半導體收益,15,0,15,群益金鼎-桃園,2023-12-28,9189
6462,神盾,21,7,14,群益金鼎-桃園,2023-12-28,9189
2618,長榮航,22,8,14,群益金鼎-桃園,2023-12-28,9189
00936,台新永續高息中小,14,0,14,群益金鼎-桃園,2023-12-28,9189
3305,昇貿,14,1,13,群益金鼎-桃園,2023-12-28,9189
00885,富邦越南,23,10,13,群益金鼎-桃園,2023-12-28,9189
2208,台船,13,0,13,群益金鼎-桃園,2023-12-28,9189
3481,群創,13,1,12,群益金鼎-桃園,2023-12-28,9189
2405,輔信,13,1,12,群益金鼎-桃園,2023-12-28,9189
00918,大華優利高填息30,12,0,12,群益金鼎-桃園,2023-12-28,9189
00712,復華富時不動產,12,1,11,群益金鼎-桃園,2023-12-28,9189
00905,FT臺灣Smart,12,1,11,群益金鼎-桃園,2023-12-28,9189
6276,安鈦克,12,1,11,群益金鼎-桃園,2023-12-28,9189
8021,尖點,10,0,10,群益金鼎-桃園,2023-12-28,9189
00722B,群益投資級電信債,10,0,10,群益金鼎-桃園,2023-12-28,9189
3673,TPK-KY,10,0,10,群益金鼎-桃園,2023-12-28,9189
2031,新光鋼,11,1,10,群益金鼎-桃園,2023-12-28,9189
2543,皇昌,10,0,10,群益金鼎-桃園,2023-12-28,9189
2538,基泰,10,0,10,群益金鼎-桃園,2023-12-28,9189
6550,北極星藥業-KY,12,2,10,群益金鼎-桃園,2023-12-28,9189
8059,凱碩,10,0,10,群益金鼎-桃園,2023-12-28,9189
6257,矽格,10,1,9,群益金鼎-桃園,2023-12-28,9189
8936,國統,12,3,9,群益金鼎-桃園,2023-12-28,9189
2637,慧洋-KY,12,3,9,群益金鼎-桃園,2023-12-28,9189
3035,智原,15,7,8,群益金鼎-桃園,2023-12-28,9189
3712,永崴投控,7,0,7,群益金鼎-桃園,2023-12-28,9189
00930,永豐ESG低碳高息,7,0,7,群益金鼎-桃園,2023-12-28,9189
6546,正基,7,0,7,群益金鼎-桃園,2023-12-28,9189
3015,全漢,6,0,6,群益金鼎-桃園,2023-12-28,9189
3264,欣銓,7,1,6,群益金鼎-桃園,2023-12-28,9189
00664R,國泰臺灣加權反1,6,0,6,群益金鼎-桃園,2023-12-28,9189
2357,華碩,14,8,6,群益金鼎-桃園,2023-12-28,9189
2618,長榮航,591,20,571,群益金鼎-桃園,2023-12-29,9189
00937B,群益ESG投等債20,170,3,167,群益金鼎-桃園,2023-12-29,9189
2867,三商壽,100,0,100,群益金鼎-桃園,2023-12-29,9189
00929,復華台灣科技優息,47,1,46,群益金鼎-桃園,2023-12-29,9189
4967,十銓,39,0,39,群益金鼎-桃園,2023-12-29,9189
00919,群益台灣精選高息,40,3,37,群益金鼎-桃園,2023-12-29,9189
3006,晶豪科,47,16,31,群益金鼎-桃園,2023-12-29,9189
00679B,元大美債20年,30,1,29,群益金鼎-桃園,2023-12-29,9189
5347,世界,32,5,27,群益金鼎-桃園,2023-12-29,9189
1471,首利,30,3,27,群益金鼎-桃園,2023-12-29,9189
6282,康舒,27,1,26,群益金鼎-桃園,2023-12-29,9189
2888,新光金,35,10,25,群益金鼎-桃園,2023-12-29,9189
2609,陽明,30,6,24,群益金鼎-桃園,2023-12-29,9189
3450,聯鈞,24,2,22,群益金鼎-桃園,2023-12-29,9189
5009,榮剛,28,7,21,群益金鼎-桃園,2023-12-29,9189
2313,華通,34,13,21,群益金鼎-桃園,2023-12-29,9189
2801,彰銀,21,0,21,群益金鼎-桃園,2023-12-29,9189
2399,映泰,20,0,20,群益金鼎-桃園,2023-12-29,9189
4915,致伸,24,4,20,群益金鼎-桃園,2023-12-29,9189
00931B,統一美債20年,20,0,20,群益金鼎-桃園,2023-12-29,9189
5351,鈺創,26,9,17,群益金鼎-桃園,2023-12-29,9189
2324,仁寶,50,34,16,群益金鼎-桃園,2023-12-29,9189
5340,建榮,16,0,16,群益金鼎-桃園,2023-12-29,9189
5272,笙科,16,0,16,群益金鼎-桃園,2023-12-29,9189
00933B,國泰10Y+金融債,15,0,15,群益金鼎-桃園,2023-12-29,9189
2303,聯電,20,5,15,群益金鼎-桃園,2023-12-29,9189
2014,中鴻,15,0,15,群益金鼎-桃園,2023-12-29,9189
4979,華星光,17,4,13,群益金鼎-桃園,2023-12-29,9189
6188,廣明,14,1,13,群益金鼎-桃園,2023-12-29,9189
00712,復華富時不動產,23,11,12,群益金鼎-桃園,2023-12-29,9189
3024,憶聲,13,1,12,群益金鼎-桃園,2023-12-29,9189
2603,長榮,16,4,12,群益金鼎-桃園,2023-12-29,9189
3260,威剛,24,13,11,群益金鼎-桃園,2023-12-29,9189
00687B,國泰20年美債,11,0,11,群益金鼎-桃園,2023-12-29,9189
6770,力積電,11,0,11,群益金鼎-桃園,2023-12-29,9189
3622,洋華,11,0,11,群益金鼎-桃園,2023-12-29,9189
3188,鑫龍騰,10,0,10,群益金鼎-桃園,2023-12-29,9189
6550,北極星藥業-KY,10,0,10,群益金鼎-桃園,2023-12-29,9189
2809,京城銀,10,0,10,群益金鼎-桃園,2023-12-29,9189
1342,八貫,10,0,10,群益金鼎-桃園,2023-12-29,9189
6117,迎廣,18,8,10,群益金鼎-桃園,2023-12-29,9189
1101,台泥,20,10,10,群益金鼎-桃園,2023-12-29,9189
2615,萬海,10,0,10,群益金鼎-桃園,2023-12-29,9189
6005,群益證,10,0,10,群益金鼎-桃園,2023-12-29,9189
6443,元晶,10,1,9,群益金鼎-桃園,2023-12-29,9189
3264,欣銓,11,2,9,群益金鼎-桃園,2023-12-29,9189
5521,工信,43,34,9,群益金鼎-桃園,2023-12-29,9189
1503,士電,14,6,8,群益金鼎-桃園,2023-12-29,9189
6125,廣運,101,93,8,群益金鼎-桃園,2023-12-29,9189
2736,富野,8,0,8,群益金鼎-桃園,2023-12-29,9189
00937B,群益ESG投等債20,345,0,345,群益金鼎-桃園,2024-01-02,9189
00929,復華台灣科技優息,232,0,232,群益金鼎-桃園,2024-01-02,9189
5355,佳總,121,0,121,群益金鼎-桃園,2024-01-02,9189
00680L,元大美債20正2,113,1,112,群益金鼎-桃園,2024-01-02,9189
1815,富喬,107,11,96,群益金鼎-桃園,2024-01-02,9189
00919,群益台灣精選高息,86,6,80,群益金鼎-桃園,2024-01-02,9189
00637L,元大滬深300正2,554,479,75,群益金鼎-桃園,2024-01-02,9189
2457,飛宏,61,1,60,群益金鼎-桃園,2024-01-02,9189
5398,慕康生醫,50,0,50,群益金鼎-桃園,2024-01-02,9189
00679B,元大美債20年,48,0,48,群益金鼎-桃園,2024-01-02,9189
2352,佳世達,87,46,41,群益金鼎-桃園,2024-01-02,9189
3481,群創,76,37,39,群益金鼎-桃園,2024-01-02,9189
00933B,國泰10Y+金融債,52,14,38,群益金鼎-桃園,2024-01-02,9189
00753L,中信中國50正2,48,11,37,群益金鼎-桃園,2024-01-02,9189
3548,兆利,40,8,32,群益金鼎-桃園,2024-01-02,9189
00687B,國泰20年美債,29,0,29,群益金鼎-桃園,2024-01-02,9189
2313,華通,30,3,27,群益金鼎-桃園,2024-01-02,9189
00688L,國泰20年美債正2,27,0,27,群益金鼎-桃園,2024-01-02,9189
2382,廣達,51,27,24,群益金鼎-桃園,2024-01-02,9189
00882,中信中國高股息,23,0,23,群益金鼎-桃園,2024-01-02,9189
8046,南電,24,1,23,群益金鼎-桃園,2024-01-02,9189
00642U,期元大S＆P石油,21,0,21,群益金鼎-桃園,2024-01-02,9189
2303,聯電,29,9,20,群益金鼎-桃園,2024-01-02,9189
8429,金麗-KY,20,0,20,群益金鼎-桃園,2024-01-02,9189
00931B,統一美債20年,19,0,19,群益金鼎-桃園,2024-01-02,9189
2609,陽明,43,25,18,群益金鼎-桃園,2024-01-02,9189
5426,振發,20,2,18,群益金鼎-桃園,2024-01-02,9189
2641,正德,33,16,17,群益金鼎-桃園,2024-01-02,9189
2890,永豐金,16,0,16,群益金鼎-桃園,2024-01-02,9189
3231,緯創,97,82,15,群益金鼎-桃園,2024-01-02,9189
1506,正道,15,0,15,群益金鼎-桃園,2024-01-02,9189
2362,藍天,79,64,15,群益金鼎-桃園,2024-01-02,9189
1309,台達化,15,0,15,群益金鼎-桃園,2024-01-02,9189
2405,輔信,15,0,15,群益金鼎-桃園,2024-01-02,9189
00934,中信成長高股息,15,0,15,群益金鼎-桃園,2024-01-02,9189
5521,工信,71,57,14,群益金鼎-桃園,2024-01-02,9189
2363,矽統,21,8,13,群益金鼎-桃園,2024-01-02,9189
2324,仁寶,28,15,13,群益金鼎-桃園,2024-01-02,9189
00918,大華優利高填息30,12,0,12,群益金鼎-桃園,2024-01-02,9189
2425,承啟,12,0,12,群益金鼎-桃園,2024-01-02,9189
00878,國泰永續高股息,33,22,11,群益金鼎-桃園,2024-01-02,9189
00712,復華富時不動產,11,0,11,群益金鼎-桃園,2024-01-02,9189
2454,聯發科,11,0,11,群益金鼎-桃園,2024-01-02,9189
00751B,元大AAA至A公司債,11,0,11,群益金鼎-桃園,2024-01-02,9189
2867,三商壽,10,0,10,群益金鼎-桃園,2024-01-02,9189
3264,欣銓,15,5,10,群益金鼎-桃園,2024-01-02,9189
4568,科際精密,10,0,10,群益金鼎-桃園,2024-01-02,9189
2913,農林,10,0,10,群益金鼎-桃園,2024-01-02,9189
4532,瑞智,10,0,10,群益金鼎-桃園,2024-01-02,9189
3288,點晶,9,0,9,群益金鼎-桃園,2024-01-02,9189
00929,復華台灣科技優息,286,141,145,群益金鼎-桃園,2024-01-03,9189
00919,群益台灣精選高息,126,11,115,群益金鼎-桃園,2024-01-03,9189
00632R,元大台灣50反1,103,37,66,群益金鼎-桃園,2024-01-03,9189
2888,新光金,59,0,59,群益金鼎-桃園,2024-01-03,9189
00937B,群益ESG投等債20,64,6,58,群益金鼎-桃園,2024-01-03,9189
0056,元大高股息,61,9,52,群益金鼎-桃園,2024-01-03,9189
2603,長榮,180,129,51,群益金鼎-桃園,2024-01-03,9189
2303,聯電,50,8,42,群益金鼎-桃園,2024-01-03,9189
00753L,中信中國50正2,40,0,40,群益金鼎-桃園,2024-01-03,9189
00642U,期元大S＆P石油,37,0,37,群益金鼎-桃園,2024-01-03,9189
9945,潤泰新,37,4,33,群益金鼎-桃園,2024-01-03,9189
00933B,國泰10Y+金融債,35,4,31,群益金鼎-桃園,2024-01-03,9189
2353,宏��,50,20,30,群益金鼎-桃園,2024-01-03,9189
2618,長榮航,71,43,28,群益金鼎-桃園,2024-01-03,9189
00918,大華優利高填息30,26,0,26,群益金鼎-桃園,2024-01-03,9189
2362,藍天,49,23,26,群益金鼎-桃園,2024-01-03,9189
00881,國泰台灣5G+,25,0,25,群益金鼎-桃園,2024-01-03,9189
00900,富邦特選高股息30,23,0,23,群益金鼎-桃園,2024-01-03,9189
2883,凱基金,23,0,23,群益金鼎-桃園,2024-01-03,9189
2308,台達電,22,0,22,群益金鼎-桃園,2024-01-03,9189
2330,台積電,25,3,22,群益金鼎-桃園,2024-01-03,9189
2892,第一金,22,0,22,群益金鼎-桃園,2024-01-03,9189
2313,華通,28,7,21,群益金鼎-桃園,2024-01-03,9189
00934,中信成長高股息,21,0,21,群益金鼎-桃園,2024-01-03,9189
2610,華航,22,2,20,群益金鼎-桃園,2024-01-03,9189
8477,創業家,20,0,20,群益金鼎-桃園,2024-01-03,9189
1582,信錦,20,0,20,群益金鼎-桃園,2024-01-03,9189
00713,元大台灣高息低波,20,0,20,群益金鼎-桃園,2024-01-03,9189
00720B,元大投資級公司債,19,0,19,群益金鼎-桃園,2024-01-03,9189
00885,富邦越南,18,0,18,群益金鼎-桃園,2024-01-03,9189
4129,聯合,18,0,18,群益金鼎-桃園,2024-01-03,9189
9934,成霖,34,17,17,群益金鼎-桃園,2024-01-03,9189
3221,台嘉碩,17,0,17,群益金鼎-桃園,2024-01-03,9189
2324,仁寶,53,37,16,群益金鼎-桃園,2024-01-03,9189
00665L,富邦�琤肭磪囓�2,15,0,15,群益金鼎-桃園,2024-01-03,9189
4967,十銓,22,7,15,群益金鼎-桃園,2024-01-03,9189
2885,元大金,23,10,13,群益金鼎-桃園,2024-01-03,9189
5426,振發,16,3,13,群益金鼎-桃園,2024-01-03,9189
00891,中信關鍵半導體,15,3,12,群益金鼎-桃園,2024-01-03,9189
2641,正德,57,45,12,群益金鼎-桃園,2024-01-03,9189
2801,彰銀,12,0,12,群益金鼎-桃園,2024-01-03,9189
3481,群創,17,5,12,群益金鼎-桃園,2024-01-03,9189
3706,神達,19,7,12,群益金鼎-桃園,2024-01-03,9189
1524,耿鼎,12,0,12,群益金鼎-桃園,2024-01-03,9189
2352,佳世達,18,7,11,群益金鼎-桃園,2024-01-03,9189
2882,國泰金,11,0,11,群益金鼎-桃園,2024-01-03,9189
1504,東元,12,1,11,群益金鼎-桃園,2024-01-03,9189
2323,中環,11,0,11,群益金鼎-桃園,2024-01-03,9189
2459,敦吉,11,0,11,群益金鼎-桃園,2024-01-03,9189
2377,微星,11,0,11,群益金鼎-桃園,2024-01-03,9189
00937B,群益ESG投等債20,183,2,181,群益金鼎-桃園,2024-01-04,9189
00929,復華台灣科技優息,157,3,154,群益金鼎-桃園,2024-01-04,9189
8096,擎亞,97,31,66,群益金鼎-桃園,2024-01-04,9189
8059,凱碩,54,0,54,群益金鼎-桃園,2024-01-04,9189
9945,潤泰新,57,4,53,群益金鼎-桃園,2024-01-04,9189
3706,神達,46,0,46,群益金鼎-桃園,2024-01-04,9189
1101,台泥,40,0,40,群益金鼎-桃園,2024-01-04,9189
9919,康那香,82,44,38,群益金鼎-桃園,2024-01-04,9189
00885,富邦越南,55,18,37,群益金鼎-桃園,2024-01-04,9189
2324,仁寶,44,8,36,群益金鼎-桃園,2024-01-04,9189
1513,中興電,36,2,34,群益金鼎-桃園,2024-01-04,9189
00753L,中信中國50正2,33,0,33,群益金鼎-桃園,2024-01-04,9189
5439,高技,32,2,30,群益金鼎-桃園,2024-01-04,9189
4106,雃博,30,0,30,群益金鼎-桃園,2024-01-04,9189
00927,群益半導體收益,30,0,30,群益金鼎-桃園,2024-01-04,9189
6282,康舒,32,3,29,群益金鼎-桃園,2024-01-04,9189
0056,元大高股息,27,2,25,群益金鼎-桃園,2024-01-04,9189
2313,華通,31,6,25,群益金鼎-桃園,2024-01-04,9189
1569,濱川,25,0,25,群益金鼎-桃園,2024-01-04,9189
3260,威剛,25,2,23,群益金鼎-桃園,2024-01-04,9189
1301,台塑,23,0,23,群益金鼎-桃園,2024-01-04,9189
2610,華航,31,8,23,群益金鼎-桃園,2024-01-04,9189
8034,榮群,21,0,21,群益金鼎-桃園,2024-01-04,9189
00712,復華富時不動產,20,0,20,群益金鼎-桃園,2024-01-04,9189
00673R,期元大S＆P原油反1,20,0,20,群益金鼎-桃園,2024-01-04,9189
2748,雲品,20,0,20,群益金鼎-桃園,2024-01-04,9189
2486,一詮,33,13,20,群益金鼎-桃園,2024-01-04,9189
2356,英業達,26,8,18,群益金鼎-桃園,2024-01-04,9189
2367,燿華,19,1,18,群益金鼎-桃園,2024-01-04,9189
00878,國泰永續高股息,26,13,13,群益金鼎-桃園,2024-01-04,9189
3038,全台,13,0,13,群益金鼎-桃園,2024-01-04,9189
3033,威健,16,3,13,群益金鼎-桃園,2024-01-04,9189
00637L,元大滬深300正2,575,563,12,群益金鼎-桃園,2024-01-04,9189
00720B,元大投資級公司債,12,0,12,群益金鼎-桃園,2024-01-04,9189
2465,麗臺,12,0,12,群益金鼎-桃園,2024-01-04,9189
2888,新光金,45,33,12,群益金鼎-桃園,2024-01-04,9189
3211,順達,12,0,12,群益金鼎-桃園,2024-01-04,9189
3231,緯創,43,31,12,群益金鼎-桃園,2024-01-04,9189
4956,光鋐,11,0,11,群益金鼎-桃園,2024-01-04,9189
2303,聯電,13,2,11,群益金鼎-桃園,2024-01-04,9189
6005,群益證,10,0,10,群益金鼎-桃園,2024-01-04,9189
3051,力特,10,0,10,群益金鼎-桃園,2024-01-04,9189
5009,榮剛,22,12,10,群益金鼎-桃園,2024-01-04,9189
2419,仲琦,13,3,10,群益金鼎-桃園,2024-01-04,9189
00935,野村臺灣新科技50,10,0,10,群益金鼎-桃園,2024-01-04,9189
00877,復華中國5G,10,0,10,群益金鼎-桃園,2024-01-04,9189
2331,精英,13,3,10,群益金鼎-桃園,2024-01-04,9189
5355,佳總,10,0,10,群益金鼎-桃園,2024-01-04,9189
8215,明基材,10,0,10,群益金鼎-桃園,2024-01-04,9189
6625,必應,18,9,9,群益金鼎-桃園,2024-01-04,9189
00929,復華台灣科技優息,115,10,105,群益金鼎-桃園,2024-01-05,9189
2603,長榮,136,34,102,群益金鼎-桃園,2024-01-05,9189
2618,長榮航,109,41,68,群益金鼎-桃園,2024-01-05,9189
2609,陽明,110,48,62,群益金鼎-桃園,2024-01-05,9189
4956,光鋐,60,2,58,群益金鼎-桃園,2024-01-05,9189
2610,華航,61,7,54,群益金鼎-桃園,2024-01-05,9189
8096,擎亞,112,61,51,群益金鼎-桃園,2024-01-05,9189
2615,萬海,67,16,51,群益金鼎-桃園,2024-01-05,9189
2888,新光金,50,0,50,群益金鼎-桃園,2024-01-05,9189
2303,聯電,72,22,50,群益金鼎-桃園,2024-01-05,9189
2641,正德,64,21,43,群益金鼎-桃園,2024-01-05,9189
00770,國泰北美科技,40,0,40,群益金鼎-桃園,2024-01-05,9189
00885,富邦越南,33,0,33,群益金鼎-桃園,2024-01-05,9189
00673R,期元大S＆P原油反1,30,0,30,群益金鼎-桃園,2024-01-05,9189
00919,群益台灣精選高息,35,7,28,群益金鼎-桃園,2024-01-05,9189
00753L,中信中國50正2,27,0,27,群益金鼎-桃園,2024-01-05,9189
2489,瑞軒,24,0,24,群益金鼎-桃園,2024-01-05,9189
00912,中信臺灣智慧50,20,0,20,群益金鼎-桃園,2024-01-05,9189
00679B,元大美債20年,19,0,19,群益金鼎-桃園,2024-01-05,9189
8059,凱碩,17,0,17,群益金鼎-桃園,2024-01-05,9189
00878,國泰永續高股息,22,6,16,群益金鼎-桃園,2024-01-05,9189
00712,復華富時不動產,16,0,16,群益金鼎-桃園,2024-01-05,9189
3373,熱映,19,4,15,群益金鼎-桃園,2024-01-05,9189
1514,亞力,21,6,15,群益金鼎-桃園,2024-01-05,9189
6113,亞矽,204,191,13,群益金鼎-桃園,2024-01-05,9189
2330,台積電,13,0,13,群益金鼎-桃園,2024-01-05,9189
00751B,元大AAA至A公司債,12,0,12,群益金鼎-桃園,2024-01-05,9189
00706L,期元大S＆P日圓正2,12,0,12,群益金鼎-桃園,2024-01-05,9189
00881,國泰台灣5G+,12,1,11,群益金鼎-桃園,2024-01-05,9189
1504,東元,11,0,11,群益金鼎-桃園,2024-01-05,9189
00687B,國泰20年美債,10,0,10,群益金鼎-桃園,2024-01-05,9189
1524,耿鼎,12,2,10,群益金鼎-桃園,2024-01-05,9189
6163,華電網,14,4,10,群益金鼎-桃園,2024-01-05,9189
2543,皇昌,10,0,10,群益金鼎-桃園,2024-01-05,9189
9103,美德醫療-DR,10,0,10,群益金鼎-桃園,2024-01-05,9189
3390,旭軟,12,3,9,群益金鼎-桃園,2024-01-05,9189
2344,華邦電,9,0,9,群益金鼎-桃園,2024-01-05,9189
8089,康全電訊,10,1,9,群益金鼎-桃園,2024-01-05,9189
00720B,元大投資級公司債,8,0,8,群益金鼎-桃園,2024-01-05,9189
00632R,元大台灣50反1,13,5,8,群益金鼎-桃園,2024-01-05,9189
6117,迎廣,26,18,8,群益金鼎-桃園,2024-01-05,9189
6161,捷波,8,0,8,群益金鼎-桃園,2024-01-05,9189
0056,元大高股息,12,5,7,群益金鼎-桃園,2024-01-05,9189
2376,技嘉,18,11,7,群益金鼎-桃園,2024-01-05,9189
2421,建準,7,0,7,群益金鼎-桃園,2024-01-05,9189
1781,合世,7,0,7,群益金鼎-桃園,2024-01-05,9189
2601,益航,7,0,7,群益金鼎-桃園,2024-01-05,9189
00933B,國泰10Y+金融債,7,0,7,群益金鼎-桃園,2024-01-05,9189
00680L,元大美債20正2,8,2,6,群益金鼎-桃園,2024-01-05,9189
1515,力山,6,0,6,群益金鼎-桃園,2024-01-05,9189
00632R,元大台灣50反1,203,4,199,群益金鼎-桃園,2024-01-08,9189
00919,群益台灣精選高息,110,1,109,群益金鼎-桃園,2024-01-08,9189
2603,長榮,110,11,99,群益金鼎-桃園,2024-01-08,9189
00900,富邦特選高股息30,101,11,90,群益金鼎-桃園,2024-01-08,9189
00929,復華台灣科技優息,85,0,85,群益金鼎-桃園,2024-01-08,9189
00753L,中信中國50正2,57,0,57,群益金鼎-桃園,2024-01-08,9189
00679B,元大美債20年,55,0,55,群益金鼎-桃園,2024-01-08,9189
2353,宏��,75,21,54,群益金鼎-桃園,2024-01-08,9189
2838,聯邦銀,50,0,50,群益金鼎-桃園,2024-01-08,9189
1721,三晃,57,9,48,群益金鼎-桃園,2024-01-08,9189
00673R,期元大S＆P原油反1,48,0,48,群益金鼎-桃園,2024-01-08,9189
00937B,群益ESG投等債20,47,12,35,群益金鼎-桃園,2024-01-08,9189
1513,中興電,37,3,34,群益金鼎-桃園,2024-01-08,9189
2362,藍天,118,85,33,群益金鼎-桃園,2024-01-08,9189
2303,聯電,31,0,31,群益金鼎-桃園,2024-01-08,9189
2387,精元,32,1,31,群益金鼎-桃園,2024-01-08,9189
1722,台肥,25,0,25,群益金鼎-桃園,2024-01-08,9189
3450,聯鈞,22,1,21,群益金鼎-桃園,2024-01-08,9189
4532,瑞智,21,0,21,群益金鼎-桃園,2024-01-08,9189
7402,邑錡,21,0,21,群益金鼎-桃園,2024-01-08,9189
2382,廣達,22,2,20,群益金鼎-桃園,2024-01-08,9189
3234,光環,20,0,20,群益金鼎-桃園,2024-01-08,9189
6129,普誠,20,0,20,群益金鼎-桃園,2024-01-08,9189
2489,瑞軒,20,1,19,群益金鼎-桃園,2024-01-08,9189
6446,藥華藥,18,0,18,群益金鼎-桃園,2024-01-08,9189
8034,榮群,20,2,18,群益金鼎-桃園,2024-01-08,9189
6153,嘉聯益,17,0,17,群益金鼎-桃園,2024-01-08,9189
8085,福華,32,16,16,群益金鼎-桃園,2024-01-08,9189
3622,洋華,16,1,15,群益金鼎-桃園,2024-01-08,9189
00934,中信成長高股息,14,0,14,群益金鼎-桃園,2024-01-08,9189
00882,中信中國高股息,15,1,14,群益金鼎-桃園,2024-01-08,9189
2615,萬海,24,10,14,群益金鼎-桃園,2024-01-08,9189
00688L,國泰20年美債正2,34,21,13,群益金鼎-桃園,2024-01-08,9189
9945,潤泰新,12,0,12,群益金鼎-桃園,2024-01-08,9189
2501,國建,12,0,12,群益金鼎-桃園,2024-01-08,9189
6770,力積電,132,120,12,群益金鼎-桃園,2024-01-08,9189
2317,鴻海,16,5,11,群益金鼎-桃園,2024-01-08,9189
2421,建準,13,2,11,群益金鼎-桃園,2024-01-08,9189
6695,芯鼎,17,6,11,群益金鼎-桃園,2024-01-08,9189
2388,威盛,34,23,11,群益金鼎-桃園,2024-01-08,9189
1524,耿鼎,10,0,10,群益金鼎-桃園,2024-01-08,9189
6462,神盾,28,18,10,群益金鼎-桃園,2024-01-08,9189
2323,中環,10,0,10,群益金鼎-桃園,2024-01-08,9189
3047,訊舟,10,0,10,群益金鼎-桃園,2024-01-08,9189
4420,光明,15,5,10,群益金鼎-桃園,2024-01-08,9189
3217,優群,15,5,10,群益金鼎-桃園,2024-01-08,9189
2402,毅嘉,22,12,10,群益金鼎-桃園,2024-01-08,9189
00936,台新永續高息中小,10,0,10,群益金鼎-桃園,2024-01-08,9189
00720B,元大投資級公司債,22,12,10,群益金鼎-桃園,2024-01-08,9189
6465,威潤,15,6,9,群益金鼎-桃園,2024-01-08,9189
00919,群益台灣精選高息,112,13,99,群益金鼎-桃園,2024-01-09,9189
00927,群益半導體收益,82,0,82,群益金鼎-桃園,2024-01-09,9189
00687B,國泰20年美債,62,0,62,群益金鼎-桃園,2024-01-09,9189
2356,英業達,76,41,35,群益金鼎-桃園,2024-01-09,9189
00885,富邦越南,35,0,35,群益金鼎-桃園,2024-01-09,9189
00937B,群益ESG投等債20,36,2,34,群益金鼎-桃園,2024-01-09,9189
00753L,中信中國50正2,44,10,34,群益金鼎-桃園,2024-01-09,9189
8150,南茂,30,0,30,群益金鼎-桃園,2024-01-09,9189
00642U,期元大S＆P石油,27,0,27,群益金鼎-桃園,2024-01-09,9189
5309,系統電,47,24,23,群益金鼎-桃園,2024-01-09,9189
2610,華航,29,6,23,群益金鼎-桃園,2024-01-09,9189
2457,飛宏,22,0,22,群益金鼎-桃園,2024-01-09,9189
3188,鑫龍騰,20,0,20,群益金鼎-桃園,2024-01-09,9189
2748,雲品,23,3,20,群益金鼎-桃園,2024-01-09,9189
1314,中石化,20,0,20,群益金鼎-桃園,2024-01-09,9189
2637,慧洋-KY,19,0,19,群益金鼎-桃園,2024-01-09,9189
2002,中鋼,18,0,18,群益金鼎-桃園,2024-01-09,9189
9933,中鼎,18,0,18,群益金鼎-桃園,2024-01-09,9189
2634,漢翔,18,1,17,群益金鼎-桃園,2024-01-09,9189
4198,欣大健康,17,0,17,群益金鼎-桃園,2024-01-09,9189
2641,正德,21,4,17,群益金鼎-桃園,2024-01-09,9189
2645,長榮航太,15,0,15,群益金鼎-桃園,2024-01-09,9189
1310,台苯,15,0,15,群益金鼎-桃園,2024-01-09,9189
2353,宏��,36,23,13,群益金鼎-桃園,2024-01-09,9189
2368,金像電,20,7,13,群益金鼎-桃園,2024-01-09,9189
00918,大華優利高填息30,13,0,13,群益金鼎-桃園,2024-01-09,9189
00935,野村臺灣新科技50,12,0,12,群益金鼎-桃園,2024-01-09,9189
6140,訊達,50,38,12,群益金鼎-桃園,2024-01-09,9189
00688L,國泰20年美債正2,12,0,12,群益金鼎-桃園,2024-01-09,9189
8054,安國,12,0,12,群益金鼎-桃園,2024-01-09,9189
6770,力積電,16,5,11,群益金鼎-桃園,2024-01-09,9189
00715L,期街口布蘭特正2,11,0,11,群益金鼎-桃園,2024-01-09,9189
2609,陽明,106,96,10,群益金鼎-桃園,2024-01-09,9189
2316,楠梓電,10,0,10,群益金鼎-桃園,2024-01-09,9189
00671R,富邦NASDAQ反1,10,0,10,群益金鼎-桃園,2024-01-09,9189
4420,光明,27,17,10,群益金鼎-桃園,2024-01-09,9189
1603,華電,10,0,10,群益金鼎-桃園,2024-01-09,9189
00675L,富邦臺灣加權正2,10,0,10,群益金鼎-桃園,2024-01-09,9189
9935,慶豐富,10,0,10,群益金鼎-桃園,2024-01-09,9189
3390,旭軟,11,1,10,群益金鼎-桃園,2024-01-09,9189
2887,台新金,10,1,9,群益金鼎-桃園,2024-01-09,9189
0056,元大高股息,10,0,10,群益金鼎-桃園,2024-01-09,9189
2486,一詮,14,5,9,群益金鼎-桃園,2024-01-09,9189
3078,僑威,17,8,9,群益金鼎-桃園,2024-01-09,9189
6282,康舒,9,0,9,群益金鼎-桃園,2024-01-09,9189
5351,鈺創,16,7,9,群益金鼎-桃園,2024-01-09,9189
1504,東元,9,1,8,群益金鼎-桃園,2024-01-09,9189
2324,仁寶,25,17,8,群益金鼎-桃園,2024-01-09,9189
00679B,元大美債20年,8,0,8,群益金鼎-桃園,2024-01-09,9189
8011,台通,8,0,8,群益金鼎-桃園,2024-01-09,9189
6026,福邦證,551,6,545,群益金鼎-桃園,2024-01-10,9189
1216,統一,220,0,220,群益金鼎-桃園,2024-01-10,9189
00929,復華台灣科技優息,108,0,108,群益金鼎-桃園,2024-01-10,9189
2890,永豐金,100,0,100,群益金鼎-桃園,2024-01-10,9189
00937B,群益ESG投等債20,81,1,80,群益金鼎-桃園,2024-01-10,9189
00919,群益台灣精選高息,81,17,64,群益金鼎-桃園,2024-01-10,9189
2609,陽明,125,65,60,群益金鼎-桃園,2024-01-10,9189
2834,臺企銀,50,1,49,群益金鼎-桃園,2024-01-10,9189
3499,環天科,45,0,45,群益金鼎-桃園,2024-01-10,9189
6164,華興,57,14,43,群益金鼎-桃園,2024-01-10,9189
00753L,中信中國50正2,46,10,36,群益金鼎-桃園,2024-01-10,9189
00632R,元大台灣50反1,35,0,35,群益金鼎-桃園,2024-01-10,9189
2880,華南金,32,1,31,群益金鼎-桃園,2024-01-10,9189
00687B,國泰20年美債,30,0,30,群益金鼎-桃園,2024-01-10,9189
3231,緯創,51,23,28,群益金鼎-桃園,2024-01-10,9189
2515,中工,26,0,26,群益金鼎-桃園,2024-01-10,9189
5425,台半,25,0,25,群益金鼎-桃園,2024-01-10,9189
00720B,元大投資級公司債,24,0,24,群益金鼎-桃園,2024-01-10,9189
2329,華泰,33,11,22,群益金鼎-桃園,2024-01-10,9189
1531,高林股,22,0,22,群益金鼎-桃園,2024-01-10,9189
2303,聯電,24,2,22,群益金鼎-桃園,2024-01-10,9189
2891,中信金,23,2,21,群益金鼎-桃園,2024-01-10,9189
5490,同亨,21,0,21,群益金鼎-桃園,2024-01-10,9189
8477,創業家,20,0,20,群益金鼎-桃園,2024-01-10,9189
2637,慧洋-KY,16,0,16,群益金鼎-桃園,2024-01-10,9189
00933B,國泰10Y+金融債,16,1,15,群益金鼎-桃園,2024-01-10,9189
00904,新光臺灣半導體30,15,0,15,群益金鼎-桃園,2024-01-10,9189
9945,潤泰新,15,0,15,群益金鼎-桃園,2024-01-10,9189
00679B,元大美債20年,14,0,14,群益金鼎-桃園,2024-01-10,9189
2388,威盛,24,12,12,群益金鼎-桃園,2024-01-10,9189
8222,寶一,21,9,12,群益金鼎-桃園,2024-01-10,9189
3706,神達,64,53,11,群益金鼎-桃園,2024-01-10,9189
00878,國泰永續高股息,10,0,10,群益金鼎-桃園,2024-01-10,9189
2913,農林,10,0,10,群益金鼎-桃園,2024-01-10,9189
2301,光寶科,16,6,10,群益金鼎-桃園,2024-01-10,9189
2812,台中銀,10,0,10,群益金鼎-桃園,2024-01-10,9189
6244,茂迪,10,0,10,群益金鼎-桃園,2024-01-10,9189
4916,事欣科,10,0,10,群益金鼎-桃園,2024-01-10,9189
2543,皇昌,10,0,10,群益金鼎-桃園,2024-01-10,9189
2387,精元,11,1,10,群益金鼎-桃園,2024-01-10,9189
2472,立隆電,10,0,10,群益金鼎-桃園,2024-01-10,9189
2887,台新金,12,2,10,群益金鼎-桃園,2024-01-10,9189
00770,國泰北美科技,8,0,8,群益金鼎-桃園,2024-01-10,9189
3264,欣銓,9,1,8,群益金鼎-桃園,2024-01-10,9189
00692,富邦公司治理,9,1,8,群益金鼎-桃園,2024-01-10,9189
00882,中信中國高股息,8,0,8,群益金鼎-桃園,2024-01-10,9189
2356,英業達,28,20,8,群益金鼎-桃園,2024-01-10,9189
8936,國統,8,0,8,群益金鼎-桃園,2024-01-10,9189
3349,寶德,8,0,8,群益金鼎-桃園,2024-01-10,9189
00713,元大台灣高息低波,8,0,8,群益金鼎-桃園,2024-01-10,9189
00927,群益半導體收益,82,0,82,群益金鼎-桃園,2024-01-11,9189
2002,中鋼,70,0,70,群益金鼎-桃園,2024-01-11,9189
00919,群益台灣精選高息,95,29,66,群益金鼎-桃園,2024-01-11,9189
1514,亞力,88,23,65,群益金鼎-桃園,2024-01-11,9189
2610,華航,58,1,57,群益金鼎-桃園,2024-01-11,9189
00929,復華台灣科技優息,47,0,47,群益金鼎-桃園,2024-01-11,9189
6164,華興,47,0,47,群益金鼎-桃園,2024-01-11,9189
4746,台耀,46,1,45,群益金鼎-桃園,2024-01-11,9189
5351,鈺創,51,7,44,群益金鼎-桃園,2024-01-11,9189
00885,富邦越南,41,0,41,群益金鼎-桃園,2024-01-11,9189
2208,台船,33,0,33,群益金鼎-桃園,2024-01-11,9189
2883,凱基金,30,3,27,群益金鼎-桃園,2024-01-11,9189
2618,長榮航,43,17,26,群益金鼎-桃園,2024-01-11,9189
00642U,期元大S＆P石油,26,0,26,群益金鼎-桃園,2024-01-11,9189
5521,工信,40,14,26,群益金鼎-桃園,2024-01-11,9189
2408,南亞科,28,4,24,群益金鼎-桃園,2024-01-11,9189
00632R,元大台灣50反1,33,11,22,群益金鼎-桃園,2024-01-11,9189
2423,固緯,50,28,22,群益金鼎-桃園,2024-01-11,9189
2449,京元電子,21,0,21,群益金鼎-桃園,2024-01-11,9189
3025,星通,42,21,21,群益金鼎-桃園,2024-01-11,9189
00770,國泰北美科技,21,0,21,群益金鼎-桃園,2024-01-11,9189
6153,嘉聯益,20,0,20,群益金鼎-桃園,2024-01-11,9189
6695,芯鼎,33,13,20,群益金鼎-桃園,2024-01-11,9189
2442,新美齊,20,0,20,群益金鼎-桃園,2024-01-11,9189
1303,南亞,20,0,20,群益金鼎-桃園,2024-01-11,9189
2409,友達,27,9,18,群益金鼎-桃園,2024-01-11,9189
6140,訊達,74,57,17,群益金鼎-桃園,2024-01-11,9189
6026,福邦證,17,0,17,群益金鼎-桃園,2024-01-11,9189
00753L,中信中國50正2,24,8,16,群益金鼎-桃園,2024-01-11,9189
0056,元大高股息,31,15,16,群益金鼎-桃園,2024-01-11,9189
00900,富邦特選高股息30,30,15,15,群益金鼎-桃園,2024-01-11,9189
00933B,國泰10Y+金融債,15,0,15,群益金鼎-桃園,2024-01-11,9189
00937B,群益ESG投等債20,14,0,14,群益金鼎-桃園,2024-01-11,9189
2317,鴻海,16,2,14,群益金鼎-桃園,2024-01-11,9189
6684,安格,15,2,13,群益金鼎-桃園,2024-01-11,9189
2454,聯發科,12,0,12,群益金鼎-桃園,2024-01-11,9189
00830,國泰費城半導體,12,0,12,群益金鼎-桃園,2024-01-11,9189
4956,光鋐,62,50,12,群益金鼎-桃園,2024-01-11,9189
00688L,國泰20年美債正2,12,0,12,群益金鼎-桃園,2024-01-11,9189
00687B,國泰20年美債,14,2,12,群益金鼎-桃園,2024-01-11,9189
3211,順達,11,0,11,群益金鼎-桃園,2024-01-11,9189
3706,神達,23,12,11,群益金鼎-桃園,2024-01-11,9189
2303,聯電,11,1,10,群益金鼎-桃園,2024-01-11,9189
1449,佳和,12,2,10,群益金鼎-桃園,2024-01-11,9189
7402,邑錡,10,0,10,群益金鼎-桃園,2024-01-11,9189
1612,宏泰,10,0,10,群益金鼎-桃園,2024-01-11,9189
9934,成霖,11,1,10,群益金鼎-桃園,2024-01-11,9189
2867,三商壽,10,0,10,群益金鼎-桃園,2024-01-11,9189
6116,彩晶,10,0,10,群益金鼎-桃園,2024-01-11,9189
6129,普誠,10,0,10,群益金鼎-桃園,2024-01-11,9189
00929,復華台灣科技優息,164,10,154,群益金鼎-桃園,2024-01-12,9189
00885,富邦越南,116,0,116,群益金鼎-桃園,2024-01-12,9189
00900,富邦特選高股息30,100,9,91,群益金鼎-桃園,2024-01-12,9189
7402,邑錡,74,7,67,群益金鼎-桃園,2024-01-12,9189
00937B,群益ESG投等債20,32,0,32,群益金鼎-桃園,2024-01-12,9189
6120,達運,62,31,31,群益金鼎-桃園,2024-01-12,9189
00923,群益台ESG低碳50,30,0,30,群益金鼎-桃園,2024-01-12,9189
2353,宏��,29,5,24,群益金鼎-桃園,2024-01-12,9189
3036,文曄,27,4,23,群益金鼎-桃園,2024-01-12,9189
6164,華興,31,8,23,群益金鼎-桃園,2024-01-12,9189
0056,元大高股息,27,5,22,群益金鼎-桃園,2024-01-12,9189
2324,仁寶,21,1,20,群益金鼎-桃園,2024-01-12,9189
2880,華南金,20,1,19,群益金鼎-桃園,2024-01-12,9189
00919,群益台灣精選高息,27,11,16,群益金鼎-桃園,2024-01-12,9189
00720B,元大投資級公司債,16,0,16,群益金鼎-桃園,2024-01-12,9189
00688L,國泰20年美債正2,15,0,15,群益金鼎-桃園,2024-01-12,9189
2303,聯電,14,0,14,群益金鼎-桃園,2024-01-12,9189
6695,芯鼎,70,56,14,群益金鼎-桃園,2024-01-12,9189
4420,光明,35,21,14,群益金鼎-桃園,2024-01-12,9189
00878,國泰永續高股息,13,0,13,群益金鼎-桃園,2024-01-12,9189
2891,中信金,13,0,13,群益金鼎-桃園,2024-01-12,9189
1325,恆大,17,4,13,群益金鼎-桃園,2024-01-12,9189
00673R,期元大S＆P原油反1,13,0,13,群益金鼎-桃園,2024-01-12,9189
9945,潤泰新,13,0,13,群益金鼎-桃園,2024-01-12,9189
1314,中石化,13,0,13,群益金鼎-桃園,2024-01-12,9189
2801,彰銀,12,0,12,群益金鼎-桃園,2024-01-12,9189
2498,宏達電,14,2,12,群益金鼎-桃園,2024-01-12,9189
4104,佳醫,13,1,12,群益金鼎-桃園,2024-01-12,9189
5347,世界,14,3,11,群益金鼎-桃園,2024-01-12,9189
2367,燿華,16,5,11,群益金鼎-桃園,2024-01-12,9189
6191,精成科,10,0,10,群益金鼎-桃園,2024-01-12,9189
6425,易發,10,0,10,群益金鼎-桃園,2024-01-12,9189
6233,旺玖,10,0,10,群益金鼎-桃園,2024-01-12,9189
5340,建榮,10,0,10,群益金鼎-桃園,2024-01-12,9189
00881,國泰台灣5G+,10,0,10,群益金鼎-桃園,2024-01-12,9189
2354,鴻準,10,0,10,群益金鼎-桃園,2024-01-12,9189
6016,康和證,10,0,10,群益金鼎-桃園,2024-01-12,9189
2468,華經,10,0,10,群益金鼎-桃園,2024-01-12,9189
2449,京元電子,12,2,10,群益金鼎-桃園,2024-01-12,9189
00753L,中信中國50正2,10,0,10,群益金鼎-桃園,2024-01-12,9189
3686,達能,10,0,10,群益金鼎-桃園,2024-01-12,9189
00725B,國泰投資級公司債,13,4,9,群益金鼎-桃園,2024-01-12,9189
8227,巨有科技,15,6,9,群益金鼎-桃園,2024-01-12,9189
5425,台半,9,0,9,群益金鼎-桃園,2024-01-12,9189
3066,李洲,11,2,9,群益金鼎-桃園,2024-01-12,9189
2605,新興,12,3,9,群益金鼎-桃園,2024-01-12,9189
00679B,元大美債20年,9,0,9,群益金鼎-桃園,2024-01-12,9189
2890,永豐金,8,0,8,群益金鼎-桃園,2024-01-12,9189
2401,凌陽,19,11,8,群益金鼎-桃園,2024-01-12,9189
2903,遠百,8,0,8,群益金鼎-桃園,2024-01-12,9189
2884,玉山金,207,0,207,群益金鼎-桃園,2024-01-15,9189
00929,復華台灣科技優息,139,8,131,群益金鼎-桃園,2024-01-15,9189
3231,緯創,163,53,110,群益金鼎-桃園,2024-01-15,9189
6120,達運,96,28,68,群益金鼎-桃園,2024-01-15,9189
00680L,元大美債20正2,72,10,62,群益金鼎-桃園,2024-01-15,9189
2356,英業達,59,3,56,群益金鼎-桃園,2024-01-15,9189
2618,長榮航,49,5,44,群益金鼎-桃園,2024-01-15,9189
0056,元大高股息,33,0,33,群益金鼎-桃園,2024-01-15,9189
00632R,元大台灣50反1,32,0,32,群益金鼎-桃園,2024-01-15,9189
2481,強茂,30,0,30,群益金鼎-桃園,2024-01-15,9189
5443,均豪,31,2,29,群益金鼎-桃園,2024-01-15,9189
00900,富邦特選高股息30,27,0,27,群益金鼎-桃園,2024-01-15,9189
00937B,群益ESG投等債20,28,1,27,群益金鼎-桃園,2024-01-15,9189
7402,邑錡,35,9,26,群益金鼎-桃園,2024-01-15,9189
2634,漢翔,36,10,26,群益金鼎-桃園,2024-01-15,9189
00687B,國泰20年美債,28,3,25,群益金鼎-桃園,2024-01-15,9189
2516,新建,24,0,24,群益金鼎-桃園,2024-01-15,9189
2317,鴻海,25,2,23,群益金鼎-桃園,2024-01-15,9189
00927,群益半導體收益,23,0,23,群益金鼎-桃園,2024-01-15,9189
00753L,中信中國50正2,21,0,21,群益金鼎-桃園,2024-01-15,9189
2887,台新金,20,1,19,群益金鼎-桃園,2024-01-15,9189
2449,京元電子,18,2,16,群益金鼎-桃園,2024-01-15,9189
3499,環天科,16,1,15,群益金鼎-桃園,2024-01-15,9189
2748,雲品,16,1,15,群益金鼎-桃園,2024-01-15,9189
9945,潤泰新,14,0,14,群益金鼎-桃園,2024-01-15,9189
2344,華邦電,21,7,14,群益金鼎-桃園,2024-01-15,9189
2603,長榮,17,4,13,群益金鼎-桃園,2024-01-15,9189
4113,聯上,12,0,12,群益金鼎-桃園,2024-01-15,9189
3712,永崴投控,15,4,11,群益金鼎-桃園,2024-01-15,9189
2515,中工,23,12,11,群益金鼎-桃園,2024-01-15,9189
8222,寶一,22,11,11,群益金鼎-桃園,2024-01-15,9189
2886,兆豐金,11,0,11,群益金鼎-桃園,2024-01-15,9189
00770,國泰北美科技,11,0,11,群益金鼎-桃園,2024-01-15,9189
2883,凱基金,11,0,11,群益金鼎-桃園,2024-01-15,9189
2739,寒舍,10,0,10,群益金鼎-桃園,2024-01-15,9189
3390,旭軟,10,0,10,群益金鼎-桃園,2024-01-15,9189
6202,盛群,10,0,10,群益金鼎-桃園,2024-01-15,9189
2429,銘旺科,10,0,10,群益金鼎-桃園,2024-01-15,9189
8033,雷虎,10,0,10,群益金鼎-桃園,2024-01-15,9189
00637L,元大滬深300正2,10,0,10,群益金鼎-桃園,2024-01-15,9189
1101,台泥,9,0,9,群益金鼎-桃園,2024-01-15,9189
2382,廣達,36,27,9,群益金鼎-桃園,2024-01-15,9189
2454,聯發科,9,1,8,群益金鼎-桃園,2024-01-15,9189
4979,華星光,11,3,8,群益金鼎-桃園,2024-01-15,9189
00933B,國泰10Y+金融債,11,3,8,群益金鼎-桃園,2024-01-15,9189
5521,工信,10,2,8,群益金鼎-桃園,2024-01-15,9189
3715,定穎投控,7,0,7,群益金鼎-桃園,2024-01-15,9189
5258,虹堡,14,7,7,群益金鼎-桃園,2024-01-15,9189
3264,欣銓,10,4,6,群益金鼎-桃園,2024-01-15,9189
4956,光鋐,7,1,6,群益金鼎-桃園,2024-01-15,9189
00919,群益台灣精選高息,256,3,253,群益金鼎-桃園,2024-01-16,9189
00929,復華台灣科技優息,104,5,99,群益金鼎-桃園,2024-01-16,9189
2883,凱基金,80,0,80,群益金鼎-桃園,2024-01-16,9189
2888,新光金,70,0,70,群益金鼎-桃園,2024-01-16,9189
9945,潤泰新,69,0,69,群益金鼎-桃園,2024-01-16,9189
00680L,元大美債20正2,52,0,52,群益金鼎-桃園,2024-01-16,9189
7402,邑錡,48,1,47,群益金鼎-桃園,2024-01-16,9189
2449,京元電子,62,16,46,群益金鼎-桃園,2024-01-16,9189
2002,中鋼,46,0,46,群益金鼎-桃園,2024-01-16,9189
2408,南亞科,45,0,45,群益金鼎-桃園,2024-01-16,9189
1514,亞力,51,7,44,群益金鼎-桃園,2024-01-16,9189
00904,新光臺灣半導體30,41,0,41,群益金鼎-桃園,2024-01-16,9189
2887,台新金,40,0,40,群益金鼎-桃園,2024-01-16,9189
2891,中信金,41,3,38,群益金鼎-桃園,2024-01-16,9189
2882,國泰金,37,0,37,群益金鼎-桃園,2024-01-16,9189
2618,長榮航,51,14,37,群益金鼎-桃園,2024-01-16,9189
8436,大江,39,2,37,群益金鼎-桃園,2024-01-16,9189
3588,通嘉,40,6,34,群益金鼎-桃園,2024-01-16,9189
2344,華邦電,50,16,34,群益金鼎-桃園,2024-01-16,9189
2308,台達電,29,0,29,群益金鼎-桃園,2024-01-16,9189
5347,世界,28,0,28,群益金鼎-桃園,2024-01-16,9189
2486,一詮,69,42,27,群益金鼎-桃園,2024-01-16,9189
2317,鴻海,30,4,26,群益金鼎-桃園,2024-01-16,9189
2515,中工,39,14,25,群益金鼎-桃園,2024-01-16,9189
8096,擎亞,54,32,22,群益金鼎-桃園,2024-01-16,9189
2801,彰銀,22,0,22,群益金鼎-桃園,2024-01-16,9189
6116,彩晶,30,10,20,群益金鼎-桃園,2024-01-16,9189
1301,台塑,22,3,19,群益金鼎-桃園,2024-01-16,9189
1303,南亞,18,0,18,群益金鼎-桃園,2024-01-16,9189
00918,大華優利高填息30,18,0,18,群益金鼎-桃園,2024-01-16,9189
1612,宏泰,17,0,17,群益金鼎-桃園,2024-01-16,9189
2885,元大金,21,5,16,群益金鼎-桃園,2024-01-16,9189
5426,振發,30,14,16,群益金鼎-桃園,2024-01-16,9189
00687B,國泰20年美債,15,1,14,群益金鼎-桃園,2024-01-16,9189
2881,富邦金,14,1,13,群益金鼎-桃園,2024-01-16,9189
4967,十銓,16,3,13,群益金鼎-桃園,2024-01-16,9189
2748,雲品,13,1,12,群益金鼎-桃園,2024-01-16,9189
6139,亞翔,13,1,12,群益金鼎-桃園,2024-01-16,9189
2610,華航,14,2,12,群益金鼎-桃園,2024-01-16,9189
6152,百一,13,1,12,群益金鼎-桃園,2024-01-16,9189
1101,台泥,11,0,11,群益金鼎-桃園,2024-01-16,9189
1310,台苯,11,0,11,群益金鼎-桃園,2024-01-16,9189
2443,昶虹,11,0,11,群益金鼎-桃園,2024-01-16,9189
6695,芯鼎,78,67,11,群益金鼎-桃園,2024-01-16,9189
2465,麗臺,12,1,11,群益金鼎-桃園,2024-01-16,9189
2329,華泰,49,38,11,群益金鼎-桃園,2024-01-16,9189
2884,玉山金,10,0,10,群益金鼎-桃園,2024-01-16,9189
2913,農林,10,0,10,群益金鼎-桃園,2024-01-16,9189
00911,兆豐洲際半導體,10,0,10,群益金鼎-桃園,2024-01-16,9189
2637,慧洋-KY,12,2,10,群益金鼎-桃園,2024-01-16,9189
00929,復華台灣科技優息,401,8,393,群益金鼎-桃園,2024-01-17,9189
00919,群益台灣精選高息,236,12,224,群益金鼎-桃園,2024-01-17,9189
2891,中信金,163,14,149,群益金鼎-桃園,2024-01-17,9189
2303,聯電,101,11,90,群益金鼎-桃園,2024-01-17,9189
0056,元大高股息,89,6,83,群益金鼎-桃園,2024-01-17,9189
00632R,元大台灣50反1,101,20,81,群益金鼎-桃園,2024-01-17,9189
00882,中信中國高股息,64,0,64,群益金鼎-桃園,2024-01-17,9189
00937B,群益ESG投等債20,72,8,64,群益金鼎-桃園,2024-01-17,9189
2308,台達電,57,2,55,群益金鼎-桃園,2024-01-17,9189
1101,台泥,56,3,53,群益金鼎-桃園,2024-01-17,9189
2801,彰銀,49,0,49,群益金鼎-桃園,2024-01-17,9189
2618,長榮航,44,3,41,群益金鼎-桃園,2024-01-17,9189
1513,中興電,41,2,39,群益金鼎-桃園,2024-01-17,9189
2317,鴻海,43,5,38,群益金鼎-桃園,2024-01-17,9189
2883,凱基金,42,5,37,群益金鼎-桃園,2024-01-17,9189
2457,飛宏,32,0,32,群益金鼎-桃園,2024-01-17,9189
00687B,國泰20年美債,31,0,31,群益金鼎-桃園,2024-01-17,9189
00688L,國泰20年美債正2,26,0,26,群益金鼎-桃園,2024-01-17,9189
00753L,中信中國50正2,35,9,26,群益金鼎-桃園,2024-01-17,9189
2888,新光金,25,0,25,群益金鼎-桃園,2024-01-17,9189
2399,映泰,23,0,23,群益金鼎-桃園,2024-01-17,9189
00881,國泰台灣5G+,24,1,23,群益金鼎-桃園,2024-01-17,9189
2881,富邦金,23,0,23,群益金鼎-桃園,2024-01-17,9189
2887,台新金,22,0,22,群益金鼎-桃園,2024-01-17,9189
00878,國泰永續高股息,45,23,22,群益金鼎-桃園,2024-01-17,9189
2344,華邦電,29,8,21,群益金鼎-桃園,2024-01-17,9189
2481,強茂,22,1,21,群益金鼎-桃園,2024-01-17,9189
2356,英業達,50,29,21,群益金鼎-桃園,2024-01-17,9189
4938,和碩,20,0,20,群益金鼎-桃園,2024-01-17,9189
2886,兆豐金,20,0,20,群益金鼎-桃園,2024-01-17,9189
00888,永豐台灣ESG,20,0,20,群益金鼎-桃園,2024-01-17,9189
5009,榮剛,32,12,20,群益金鼎-桃園,2024-01-17,9189
2472,立隆電,20,0,20,群益金鼎-桃園,2024-01-17,9189
00706L,期元大S＆P日圓正2,20,0,20,群益金鼎-桃園,2024-01-17,9189
8059,凱碩,19,0,19,群益金鼎-桃園,2024-01-17,9189
2002,中鋼,18,0,18,群益金鼎-桃園,2024-01-17,9189
00927,群益半導體收益,18,0,18,群益金鼎-桃園,2024-01-17,9189
1301,台塑,16,0,16,群益金鼎-桃園,2024-01-17,9189
2449,京元電子,16,0,16,群益金鼎-桃園,2024-01-17,9189
2371,大同,17,1,16,群益金鼎-桃園,2024-01-17,9189
2486,一詮,41,25,16,群益金鼎-桃園,2024-01-17,9189
2405,輔信,16,0,16,群益金鼎-桃園,2024-01-17,9189
00918,大華優利高填息30,16,0,16,群益金鼎-桃園,2024-01-17,9189
0050,元大台灣50,19,4,15,群益金鼎-桃園,2024-01-17,9189
2882,國泰金,15,0,15,群益金鼎-桃園,2024-01-17,9189
6425,易發,28,14,14,群益金鼎-桃園,2024-01-17,9189
6213,聯茂,14,0,14,群益金鼎-桃園,2024-01-17,9189
00679B,元大美債20年,14,1,13,群益金鼎-桃園,2024-01-17,9189
9945,潤泰新,18,5,13,群益金鼎-桃園,2024-01-17,9189
2884,玉山金,14,1,13,群益金鼎-桃園,2024-01-17,9189
00929,復華台灣科技優息,122,0,122,群益金鼎-桃園,2024-01-18,9189
00882,中信中國高股息,62,0,62,群益金鼎-桃園,2024-01-18,9189
2888,新光金,59,0,59,群益金鼎-桃園,2024-01-18,9189
00919,群益台灣精選高息,64,8,56,群益金鼎-桃園,2024-01-18,9189
2303,聯電,48,2,46,群益金鼎-桃園,2024-01-18,9189
00637L,元大滬深300正2,51,5,46,群益金鼎-桃園,2024-01-18,9189
2371,大同,46,2,44,群益金鼎-桃園,2024-01-18,9189
6770,力積電,38,1,37,群益金鼎-桃園,2024-01-18,9189
2324,仁寶,41,6,35,群益金鼎-桃園,2024-01-18,9189
00632R,元大台灣50反1,62,30,32,群益金鼎-桃園,2024-01-18,9189
8422,可寧衛,30,0,30,群益金鼎-桃園,2024-01-18,9189
6120,達運,57,33,24,群益金鼎-桃園,2024-01-18,9189
2543,皇昌,23,0,23,群益金鼎-桃園,2024-01-18,9189
00720B,元大投資級公司債,22,0,22,群益金鼎-桃園,2024-01-18,9189
2308,台達電,23,1,22,群益金鼎-桃園,2024-01-18,9189
2634,漢翔,21,0,21,群益金鼎-桃園,2024-01-18,9189
8096,擎亞,28,7,21,群益金鼎-桃園,2024-01-18,9189
3057,喬鼎,20,0,20,群益金鼎-桃園,2024-01-18,9189
6173,信昌電,20,0,20,群益金鼎-桃園,2024-01-18,9189
2408,南亞科,20,0,20,群益金鼎-桃園,2024-01-18,9189
00881,國泰台灣5G+,17,0,17,群益金鼎-桃園,2024-01-18,9189
9945,潤泰新,16,0,16,群益金鼎-桃園,2024-01-18,9189
3715,定穎投控,16,0,16,群益金鼎-桃園,2024-01-18,9189
00706L,期元大S＆P日圓正2,15,0,15,群益金鼎-桃園,2024-01-18,9189
4114,健喬,15,0,15,群益金鼎-桃園,2024-01-18,9189
4979,華星光,19,6,13,群益金鼎-桃園,2024-01-18,9189
2353,宏��,28,15,13,群益金鼎-桃園,2024-01-18,9189
2884,玉山金,13,0,13,群益金鼎-桃園,2024-01-18,9189
2887,台新金,17,4,13,群益金鼎-桃園,2024-01-18,9189
00878,國泰永續高股息,18,6,12,群益金鼎-桃園,2024-01-18,9189
2421,建準,13,1,12,群益金鼎-桃園,2024-01-18,9189
2382,廣達,34,22,12,群益金鼎-桃園,2024-01-18,9189
00713,元大台灣高息低波,11,0,11,群益金鼎-桃園,2024-01-18,9189
1513,中興電,11,0,11,群益金鼎-桃園,2024-01-18,9189
5426,振發,220,209,11,群益金鼎-桃園,2024-01-18,9189
2363,矽統,15,4,11,群益金鼎-桃園,2024-01-18,9189
00900,富邦特選高股息30,11,0,11,群益金鼎-桃園,2024-01-18,9189
2332,友訊,11,0,11,群益金鼎-桃園,2024-01-18,9189
1326,台化,11,0,11,群益金鼎-桃園,2024-01-18,9189
2882,國泰金,10,0,10,群益金鼎-桃園,2024-01-18,9189
4958,臻鼎-KY,10,0,10,群益金鼎-桃園,2024-01-18,9189
1711,永光,10,0,10,群益金鼎-桃園,2024-01-18,9189
1785,光洋科,10,0,10,群益金鼎-桃園,2024-01-18,9189
3046,建��,10,0,10,群益金鼎-桃園,2024-01-18,9189
3149,正達,10,0,10,群益金鼎-桃園,2024-01-18,9189
4960,誠美材,10,0,10,群益金鼎-桃園,2024-01-18,9189
0056,元大高股息,21,11,10,群益金鼎-桃園,2024-01-18,9189
00751B,元大AAA至A公司債,9,0,9,群益金鼎-桃園,2024-01-18,9189
1605,華新,10,1,9,群益金鼎-桃園,2024-01-18,9189
2356,英業達,17,9,8,群益金鼎-桃園,2024-01-18,9189
2891,中信金,149,1,148,群益金鼎-桃園,2024-01-19,9189
00632R,元大台灣50反1,157,43,114,群益金鼎-桃園,2024-01-19,9189
00931B,統一美債20年,88,0,88,群益金鼎-桃園,2024-01-19,9189
2324,仁寶,94,11,83,群益金鼎-桃園,2024-01-19,9189
00687B,國泰20年美債,62,0,62,群益金鼎-桃園,2024-01-19,9189
00929,復華台灣科技優息,62,11,51,群益金鼎-桃園,2024-01-19,9189
8422,可寧衛,50,0,50,群益金鼎-桃園,2024-01-19,9189
00937B,群益ESG投等債20,51,4,47,群益金鼎-桃園,2024-01-19,9189
00919,群益台灣精選高息,49,2,47,群益金鼎-桃園,2024-01-19,9189
00751B,元大AAA至A公司債,41,0,41,群益金鼎-桃園,2024-01-19,9189
7402,邑錡,34,0,34,群益金鼎-桃園,2024-01-19,9189
00720B,元大投資級公司債,32,0,32,群益金鼎-桃園,2024-01-19,9189
2371,大同,33,1,32,群益金鼎-桃園,2024-01-19,9189
00679B,元大美債20年,36,5,31,群益金鼎-桃園,2024-01-19,9189
1101,台泥,30,0,30,群益金鼎-桃園,2024-01-19,9189
2618,長榮航,37,7,30,群益金鼎-桃園,2024-01-19,9189
6140,訊達,35,7,28,群益金鼎-桃園,2024-01-19,9189
00900,富邦特選高股息30,29,2,27,群益金鼎-桃園,2024-01-19,9189
4956,光鋐,140,114,26,群益金鼎-桃園,2024-01-19,9189
2312,金寶,28,3,25,群益金鼎-桃園,2024-01-19,9189
00680L,元大美債20正2,23,0,23,群益金鼎-桃園,2024-01-19,9189
00688L,國泰20年美債正2,22,0,22,群益金鼎-桃園,2024-01-19,9189
1711,永光,20,0,20,群益金鼎-桃園,2024-01-19,9189
00933B,國泰10Y+金融債,17,0,17,群益金鼎-桃園,2024-01-19,9189
8436,大江,17,2,15,群益金鼎-桃園,2024-01-19,9189
5488,松普,14,0,14,群益金鼎-桃園,2024-01-19,9189
2356,英業達,78,66,12,群益金鼎-桃園,2024-01-19,9189
00725B,國泰投資級公司債,11,0,11,群益金鼎-桃園,2024-01-19,9189
3490,單井,13,2,11,群益金鼎-桃園,2024-01-19,9189
2887,台新金,11,0,11,群益金鼎-桃園,2024-01-19,9189
2884,玉山金,11,0,11,群益金鼎-桃園,2024-01-19,9189
6191,精成科,10,0,10,群益金鼎-桃園,2024-01-19,9189
3013,晟銘電,18,8,10,群益金鼎-桃園,2024-01-19,9189
5355,佳總,10,0,10,群益金鼎-桃園,2024-01-19,9189
00650L,復華香港正2,10,0,10,群益金鼎-桃園,2024-01-19,9189
2404,漢唐,10,0,10,群益金鼎-桃園,2024-01-19,9189
1589,永冠-KY,10,0,10,群益金鼎-桃園,2024-01-19,9189
6901,鑽石投資,10,0,10,群益金鼎-桃園,2024-01-19,9189
4529,淳紳,10,0,10,群益金鼎-桃園,2024-01-19,9189
2303,聯電,27,17,10,群益金鼎-桃園,2024-01-19,9189
2609,陽明,12,3,9,群益金鼎-桃園,2024-01-19,9189
00795B,中信美國公債20年,9,0,9,群益金鼎-桃園,2024-01-19,9189
6271,同欣電,14,5,9,群益金鼎-桃園,2024-01-19,9189
6462,神盾,19,10,9,群益金鼎-桃園,2024-01-19,9189
5521,工信,8,0,8,群益金鼎-桃園,2024-01-19,9189
9928,中視,9,1,8,群益金鼎-桃園,2024-01-19,9189
6134,萬旭,8,0,8,群益金鼎-桃園,2024-01-19,9189
3025,星通,8,0,8,群益金鼎-桃園,2024-01-19,9189
2637,慧洋-KY,8,0,8,群益金鼎-桃園,2024-01-19,9189
00904,新光臺灣半導體30,8,0,8,群益金鼎-桃園,2024-01-19,9189
7402,邑錡,137,0,137,群益金鼎-桃園,2024-01-22,9189
00688L,國泰20年美債正2,94,0,94,群益金鼎-桃園,2024-01-22,9189
4167,松瑞藥,50,0,50,群益金鼎-桃園,2024-01-22,9189
2610,華航,51,5,46,群益金鼎-桃園,2024-01-22,9189
00882,中信中國高股息,42,0,42,群益金鼎-桃園,2024-01-22,9189
00665L,富邦�琤肭磪囓�2,42,0,42,群益金鼎-桃園,2024-01-22,9189
3354,律勝,43,2,41,群益金鼎-桃園,2024-01-22,9189
00933B,國泰10Y+金融債,37,0,37,群益金鼎-桃園,2024-01-22,9189
2301,光寶科,41,7,34,群益金鼎-桃園,2024-01-22,9189
2329,華泰,62,30,32,群益金鼎-桃園,2024-01-22,9189
2618,長榮航,62,31,31,群益金鼎-桃園,2024-01-22,9189
6712,長聖,31,1,30,群益金鼎-桃園,2024-01-22,9189
2353,宏��,51,22,29,群益金鼎-桃園,2024-01-22,9189
2316,楠梓電,26,1,25,群益金鼎-桃園,2024-01-22,9189
00632R,元大台灣50反1,52,28,24,群益金鼎-桃園,2024-01-22,9189
5880,合庫金,23,0,23,群益金鼎-桃園,2024-01-22,9189
6153,嘉聯益,20,0,20,群益金鼎-桃園,2024-01-22,9189
2516,新建,20,0,20,群益金鼎-桃園,2024-01-22,9189
4743,合一,19,2,17,群益金鼎-桃園,2024-01-22,9189
0050,元大台灣50,19,2,17,群益金鼎-桃園,2024-01-22,9189
1515,力山,21,5,16,群益金鼎-桃園,2024-01-22,9189
3437,榮創,20,4,16,群益金鼎-桃園,2024-01-22,9189
5211,蒙恬,16,1,15,群益金鼎-桃園,2024-01-22,9189
2408,南亞科,15,0,15,群益金鼎-桃園,2024-01-22,9189
3231,緯創,146,132,14,群益金鼎-桃園,2024-01-22,9189
6124,業強,15,3,12,群益金鼎-桃園,2024-01-22,9189
5426,振發,43,31,12,群益金鼎-桃園,2024-01-22,9189
6770,力積電,13,2,11,群益金鼎-桃園,2024-01-22,9189
8111,立��,12,1,11,群益金鼎-桃園,2024-01-22,9189
3055,蔚華科,12,1,11,群益金鼎-桃園,2024-01-22,9189
1326,台化,10,0,10,群益金鼎-桃園,2024-01-22,9189
2468,華經,10,0,10,群益金鼎-桃園,2024-01-22,9189
6461,益得,10,0,10,群益金鼎-桃園,2024-01-22,9189
3025,星通,33,23,10,群益金鼎-桃園,2024-01-22,9189
6550,北極星藥業-KY,10,0,10,群益金鼎-桃園,2024-01-22,9189
2834,臺企銀,10,0,10,群益金鼎-桃園,2024-01-22,9189
2884,玉山金,10,0,10,群益金鼎-桃園,2024-01-22,9189
2809,京城銀,10,0,10,群益金鼎-桃園,2024-01-22,9189
00671R,富邦NASDAQ反1,10,0,10,群益金鼎-桃園,2024-01-22,9189
00891,中信關鍵半導體,20,11,9,群益金鼎-桃園,2024-01-22,9189
8034,榮群,11,2,9,群益金鼎-桃園,2024-01-22,9189
5871,中租-KY,9,0,9,群益金鼎-桃園,2024-01-22,9189
3712,永崴投控,10,1,9,群益金鼎-桃園,2024-01-22,9189
1722,台肥,8,0,8,群益金鼎-桃園,2024-01-22,9189
4967,十銓,10,2,8,群益金鼎-桃園,2024-01-22,9189
6695,芯鼎,15,7,8,群益金鼎-桃園,2024-01-22,9189
4960,誠美材,11,3,8,群益金鼎-桃園,2024-01-22,9189
6139,亞翔,9,1,8,群益金鼎-桃園,2024-01-22,9189
4906,正文,14,6,8,群益金鼎-桃園,2024-01-22,9189
2887,台新金,10,2,8,群益金鼎-桃園,2024-01-22,9189
2880,華南金,61,1,60,群益金鼎-桃園,2024-01-23,9189
2344,華邦電,69,17,52,群益金鼎-桃園,2024-01-23,9189
6153,嘉聯益,50,0,50,群益金鼎-桃園,2024-01-23,9189
2912,統一超,50,0,50,群益金鼎-桃園,2024-01-23,9189
2801,彰銀,50,0,50,群益金鼎-桃園,2024-01-23,9189
00632R,元大台灣50反1,49,0,49,群益金鼎-桃園,2024-01-23,9189
3481,群創,150,107,43,群益金鼎-桃園,2024-01-23,9189
00673R,期元大S＆P原油反1,38,0,38,群益金鼎-桃園,2024-01-23,9189
2618,長榮航,49,13,36,群益金鼎-桃園,2024-01-23,9189
2324,仁寶,37,5,32,群益金鼎-桃園,2024-01-23,9189
6237,驊訊,58,29,29,群益金鼎-桃園,2024-01-23,9189
00919,群益台灣精選高息,27,0,27,群益金鼎-桃園,2024-01-23,9189
2408,南亞科,29,2,27,群益金鼎-桃園,2024-01-23,9189
00882,中信中國高股息,27,0,27,群益金鼎-桃園,2024-01-23,9189
2352,佳世達,34,8,26,群益金鼎-桃園,2024-01-23,9189
00637L,元大滬深300正2,40,14,26,群益金鼎-桃園,2024-01-23,9189
2329,華泰,35,15,20,群益金鼎-桃園,2024-01-23,9189
2883,凱基金,20,1,19,群益金鼎-桃園,2024-01-23,9189
6243,迅杰,24,7,17,群益金鼎-桃園,2024-01-23,9189
6140,訊達,77,60,17,群益金鼎-桃園,2024-01-23,9189
6120,達運,31,15,16,群益金鼎-桃園,2024-01-23,9189
2362,藍天,18,2,16,群益金鼎-桃園,2024-01-23,9189
2609,陽明,34,18,16,群益金鼎-桃園,2024-01-23,9189
3059,華晶科,34,19,15,群益金鼎-桃園,2024-01-23,9189
3217,優群,14,0,14,群益金鼎-桃園,2024-01-23,9189
2332,友訊,14,0,14,群益金鼎-桃園,2024-01-23,9189
2886,兆豐金,13,0,13,群益金鼎-桃園,2024-01-23,9189
6163,華電網,12,0,12,群益金鼎-桃園,2024-01-23,9189
1301,台塑,12,0,12,群益金鼎-桃園,2024-01-23,9189
3596,智易,12,0,12,群益金鼎-桃園,2024-01-23,9189
2887,台新金,11,0,11,群益金鼎-桃園,2024-01-23,9189
2882,國泰金,11,0,11,群益金鼎-桃園,2024-01-23,9189
4729,熒茂,13,2,11,群益金鼎-桃園,2024-01-23,9189
2316,楠梓電,17,6,11,群益金鼎-桃園,2024-01-23,9189
2417,圓剛,11,0,11,群益金鼎-桃園,2024-01-23,9189
1471,首利,13,2,11,群益金鼎-桃園,2024-01-23,9189
3284,太普高,10,0,10,群益金鼎-桃園,2024-01-23,9189
5222,全訊,10,0,10,群益金鼎-桃園,2024-01-23,9189
2603,長榮,15,5,10,群益金鼎-桃園,2024-01-23,9189
1616,億泰,10,0,10,群益金鼎-桃園,2024-01-23,9189
1303,南亞,9,0,9,群益金鼎-桃園,2024-01-23,9189
8110,華東,9,0,9,群益金鼎-桃園,2024-01-23,9189
00679B,元大美債20年,9,0,9,群益金鼎-桃園,2024-01-23,9189
6218,豪勉,15,6,9,群益金鼎-桃園,2024-01-23,9189
1795,美時,11,3,8,群益金鼎-桃園,2024-01-23,9189
3622,洋華,10,2,8,群益金鼎-桃園,2024-01-23,9189
4938,和碩,9,1,8,群益金鼎-桃園,2024-01-23,9189
6901,鑽石投資,8,0,8,群益金鼎-桃園,2024-01-23,9189
6113,亞矽,10,2,8,群益金鼎-桃園,2024-01-23,9189
6124,業強,14,7,7,群益金鼎-桃園,2024-01-23,9189
5439,高技,106,7,99,群益金鼎-桃園,2024-01-24,9189
8089,康全電訊,84,4,80,群益金鼎-桃園,2024-01-24,9189
00937B,群益ESG投等債20,94,26,68,群益金鼎-桃園,2024-01-24,9189
00919,群益台灣精選高息,83,17,66,群益金鼎-桃園,2024-01-24,9189
00665L,富邦�琤肭磪囓�2,73,20,53,群益金鼎-桃園,2024-01-24,9189
3615,安可,60,14,46,群益金鼎-桃園,2024-01-24,9189
00882,中信中國高股息,47,5,42,群益金鼎-桃園,2024-01-24,9189
00679B,元大美債20年,40,0,40,群益金鼎-桃園,2024-01-24,9189
1514,亞力,43,4,39,群益金鼎-桃園,2024-01-24,9189
2308,台達電,34,1,33,群益金鼎-桃園,2024-01-24,9189
8088,品安,30,0,30,群益金鼎-桃園,2024-01-24,9189
00934,中信成長高股息,30,1,29,群益金鼎-桃園,2024-01-24,9189
3055,蔚華科,57,31,26,群益金鼎-桃園,2024-01-24,9189
3437,榮創,25,0,25,群益金鼎-桃園,2024-01-24,9189
00687B,國泰20年美債,24,0,24,群益金鼎-桃園,2024-01-24,9189
6180,橘子,24,1,23,群益金鼎-桃園,2024-01-24,9189
00632R,元大台灣50反1,22,0,22,群益金鼎-桃園,2024-01-24,9189
2882,國泰金,22,0,22,群益金鼎-桃園,2024-01-24,9189
00899,FT潔淨能源,20,0,20,群益金鼎-桃園,2024-01-24,9189
00637L,元大滬深300正2,20,0,20,群益金鼎-桃園,2024-01-24,9189
6239,力成,20,1,19,群益金鼎-桃園,2024-01-24,9189
2485,兆赫,17,0,17,群益金鼎-桃園,2024-01-24,9189
3374,精材,17,0,17,群益金鼎-桃園,2024-01-24,9189
2618,長榮航,28,11,17,群益金鼎-桃園,2024-01-24,9189
3354,律勝,16,1,15,群益金鼎-桃園,2024-01-24,9189
6548,長科*,15,0,15,群益金鼎-桃園,2024-01-24,9189
8034,榮群,27,13,14,群益金鼎-桃園,2024-01-24,9189
4420,光明,29,15,14,群益金鼎-桃園,2024-01-24,9189
8059,凱碩,46,32,14,群益金鼎-桃園,2024-01-24,9189
00720B,元大投資級公司債,14,1,13,群益金鼎-桃園,2024-01-24,9189
00929,復華台灣科技優息,23,11,12,群益金鼎-桃園,2024-01-24,9189
00877,復華中國5G,12,0,12,群益金鼎-桃園,2024-01-24,9189
8110,華東,20,8,12,群益金鼎-桃園,2024-01-24,9189
1301,台塑,10,0,10,群益金鼎-桃園,2024-01-24,9189
00680L,元大美債20正2,12,2,10,群益金鼎-桃園,2024-01-24,9189
9938,百和,10,0,10,群益金鼎-桃園,2024-01-24,9189
6603,富強鑫,10,0,10,群益金鼎-桃園,2024-01-24,9189
4529,淳紳,14,4,10,群益金鼎-桃園,2024-01-24,9189
2369,菱生,133,124,9,群益金鼎-桃園,2024-01-24,9189
3490,單井,11,2,9,群益金鼎-桃園,2024-01-24,9189
1449,佳和,9,0,9,群益金鼎-桃園,2024-01-24,9189
8936,國統,12,3,9,群益金鼎-桃園,2024-01-24,9189
2515,中工,8,0,8,群益金鼎-桃園,2024-01-24,9189
6120,達運,18,10,8,群益金鼎-桃園,2024-01-24,9189
2465,麗臺,11,3,8,群益金鼎-桃園,2024-01-24,9189
1303,南亞,8,0,8,群益金鼎-桃園,2024-01-24,9189
3006,晶豪科,12,5,7,群益金鼎-桃園,2024-01-24,9189
2409,友達,9,2,7,群益金鼎-桃園,2024-01-24,9189
3605,宏致,8,1,7,群益金鼎-桃園,2024-01-24,9189
6179,亞通,12,5,7,群益金鼎-桃園,2024-01-24,9189
2888,新光金,551,45,506,群益金鼎-桃園,2024-01-25,9189
8096,擎亞,333,225,108,群益金鼎-桃園,2024-01-25,9189
5439,高技,101,2,99,群益金鼎-桃園,2024-01-25,9189
00919,群益台灣精選高息,93,2,91,群益金鼎-桃園,2024-01-25,9189
2882,國泰金,100,10,90,群益金鼎-桃園,2024-01-25,9189
6113,亞矽,103,23,80,群益金鼎-桃園,2024-01-25,9189
00632R,元大台灣50反1,77,0,77,群益金鼎-桃園,2024-01-25,9189
00937B,群益ESG投等債20,59,0,59,群益金鼎-桃園,2024-01-25,9189
00687B,國泰20年美債,47,0,47,群益金鼎-桃園,2024-01-25,9189
6120,達運,49,5,44,群益金鼎-桃園,2024-01-25,9189
00852L,國泰美國道瓊正2,43,0,43,群益金鼎-桃園,2024-01-25,9189
3354,律勝,60,24,36,群益金鼎-桃園,2024-01-25,9189
00671R,富邦NASDAQ反1,32,0,32,群益金鼎-桃園,2024-01-25,9189
6140,訊達,53,22,31,群益金鼎-桃園,2024-01-25,9189
00637L,元大滬深300正2,114,84,30,群益金鼎-桃園,2024-01-25,9189
6167,久正,25,0,25,群益金鼎-桃園,2024-01-25,9189
6233,旺玖,24,0,24,群益金鼎-桃園,2024-01-25,9189
00720B,元大投資級公司債,23,0,23,群益金鼎-桃園,2024-01-25,9189
8059,凱碩,26,5,21,群益金鼎-桃園,2024-01-25,9189
3622,洋華,21,0,21,群益金鼎-桃園,2024-01-25,9189
4938,和碩,22,2,20,群益金鼎-桃園,2024-01-25,9189
2356,英業達,50,34,16,群益金鼎-桃園,2024-01-25,9189
00680L,元大美債20正2,17,2,15,群益金鼎-桃園,2024-01-25,9189
4956,光鋐,20,5,15,群益金鼎-桃園,2024-01-25,9189
00679B,元大美債20年,18,3,15,群益金鼎-桃園,2024-01-25,9189
6916,華凌,13,0,13,群益金鼎-桃園,2024-01-25,9189
1522,堤維西,15,2,13,群益金鼎-桃園,2024-01-25,9189
3047,訊舟,20,7,13,群益金鼎-桃園,2024-01-25,9189
6668,中揚光,12,0,12,群益金鼎-桃園,2024-01-25,9189
3032,偉訓,13,1,12,群益金鼎-桃園,2024-01-25,9189
00712,復華富時不動產,12,0,12,群益金鼎-桃園,2024-01-25,9189
2498,宏達電,17,5,12,群益金鼎-桃園,2024-01-25,9189
3033,威健,15,4,11,群益金鼎-桃園,2024-01-25,9189
6244,茂迪,11,0,11,群益金鼎-桃園,2024-01-25,9189
2401,凌陽,12,1,11,群益金鼎-桃園,2024-01-25,9189
5426,振發,38,28,10,群益金鼎-桃園,2024-01-25,9189
6218,豪勉,10,0,10,群益金鼎-桃園,2024-01-25,9189
9919,康那香,10,0,10,群益金鼎-桃園,2024-01-25,9189
2809,京城銀,10,0,10,群益金鼎-桃園,2024-01-25,9189
3051,力特,12,2,10,群益金鼎-桃園,2024-01-25,9189
3548,兆利,19,9,10,群益金鼎-桃園,2024-01-25,9189
2834,臺企銀,10,0,10,群益金鼎-桃園,2024-01-25,9189
00752,中信中國50,10,0,10,群益金鼎-桃園,2024-01-25,9189
3308,聯德,10,0,10,群益金鼎-桃園,2024-01-25,9189
2357,華碩,10,0,10,群益金鼎-桃園,2024-01-25,9189
6237,驊訊,36,26,10,群益金鼎-桃園,2024-01-25,9189
8021,尖點,11,1,10,群益金鼎-桃園,2024-01-25,9189
8064,東捷,11,1,10,群益金鼎-桃園,2024-01-25,9189
006208,富邦台50,10,0,10,群益金鼎-桃園,2024-01-25,9189
00933B,國泰10Y+金融債,9,0,9,群益金鼎-桃園,2024-01-25,9189
2888,新光金,451,0,451,群益金鼎-桃園,2024-01-26,9189
2882,國泰金,392,17,375,群益金鼎-桃園,2024-01-26,9189
2303,聯電,116,11,105,群益金鼎-桃園,2024-01-26,9189
00919,群益台灣精選高息,78,7,71,群益金鼎-桃園,2024-01-26,9189
00673R,期元大S＆P原油反1,52,0,52,群益金鼎-桃園,2024-01-26,9189
2889,國票金,50,0,50,群益金鼎-桃園,2024-01-26,9189
00665L,富邦�琤肭磪囓�2,50,0,50,群益金鼎-桃園,2024-01-26,9189
2353,宏��,76,33,43,群益金鼎-桃園,2024-01-26,9189
3231,緯創,42,13,29,群益金鼎-桃園,2024-01-26,9189
00937B,群益ESG投等債20,30,6,24,群益金鼎-桃園,2024-01-26,9189
00687B,國泰20年美債,23,0,23,群益金鼎-桃園,2024-01-26,9189
00929,復華台灣科技優息,28,6,22,群益金鼎-桃園,2024-01-26,9189
4938,和碩,23,1,22,群益金鼎-桃園,2024-01-26,9189
00918,大華優利高填息30,20,0,20,群益金鼎-桃園,2024-01-26,9189
1528,恩德,20,0,20,群益金鼎-桃園,2024-01-26,9189
2609,陽明,30,10,20,群益金鼎-桃園,2024-01-26,9189
3623,富晶通,72,55,17,群益金鼎-桃園,2024-01-26,9189
00679B,元大美債20年,18,1,17,群益金鼎-桃園,2024-01-26,9189
1301,台塑,18,1,17,群益金鼎-桃園,2024-01-26,9189
1514,亞力,24,7,17,群益金鼎-桃園,2024-01-26,9189
8111,立��,17,2,15,群益金鼎-桃園,2024-01-26,9189
5258,虹堡,15,0,15,群益金鼎-桃園,2024-01-26,9189
4909,新復興,22,8,14,群益金鼎-桃園,2024-01-26,9189
3038,全台,14,0,14,群益金鼎-桃園,2024-01-26,9189
2363,矽統,16,2,14,群益金鼎-桃園,2024-01-26,9189
2324,仁寶,42,28,14,群益金鼎-桃園,2024-01-26,9189
6213,聯茂,14,1,13,群益金鼎-桃園,2024-01-26,9189
4162,智擎,15,2,13,群益金鼎-桃園,2024-01-26,9189
2618,長榮航,18,6,12,群益金鼎-桃園,2024-01-26,9189
6274,台燿,12,0,12,群益金鼎-桃園,2024-01-26,9189
3191,雲嘉南,12,0,12,群益金鼎-桃園,2024-01-26,9189
00636,國泰中國A50,12,0,12,群益金鼎-桃園,2024-01-26,9189
6167,久正,16,4,12,群益金鼎-桃園,2024-01-26,9189
9105,泰金寶-DR,60,50,10,群益金鼎-桃園,2024-01-26,9189
006205,富邦上証,10,0,10,群益金鼎-桃園,2024-01-26,9189
6239,力成,12,2,10,群益金鼎-桃園,2024-01-26,9189
6215,和椿,10,0,10,群益金鼎-桃園,2024-01-26,9189
2603,長榮,16,6,10,群益金鼎-桃園,2024-01-26,9189
6235,華孚,14,4,10,群益金鼎-桃園,2024-01-26,9189
3706,神達,13,4,9,群益金鼎-桃園,2024-01-26,9189
4147,中裕,11,2,9,群益金鼎-桃園,2024-01-26,9189
0061,元大寶滬深,9,0,9,群益金鼎-桃園,2024-01-26,9189
3047,訊舟,10,1,9,群益金鼎-桃園,2024-01-26,9189
3265,台星科,19,10,9,群益金鼎-桃園,2024-01-26,9189
2637,慧洋-KY,8,0,8,群益金鼎-桃園,2024-01-26,9189
2458,義隆,9,1,8,群益金鼎-桃園,2024-01-26,9189
4956,光鋐,22,14,8,群益金鼎-桃園,2024-01-26,9189
6259,百徽,8,0,8,群益金鼎-桃園,2024-01-26,9189
3035,智原,16,8,8,群益金鼎-桃園,2024-01-26,9189
00664R,國泰臺灣加權反1,7,0,7,群益金鼎-桃園,2024-01-26,9189
2882,國泰金,412,10,402,群益金鼎-桃園,2024-01-29,9189
00753L,中信中國50正2,93,25,68,群益金鼎-桃園,2024-01-29,9189
00937B,群益ESG投等債20,65,0,65,群益金鼎-桃園,2024-01-29,9189
00632R,元大台灣50反1,64,0,64,群益金鼎-桃園,2024-01-29,9189
2409,友達,55,2,53,群益金鼎-桃園,2024-01-29,9189
00637L,元大滬深300正2,160,113,47,群益金鼎-桃園,2024-01-29,9189
2344,華邦電,56,12,44,群益金鼎-桃園,2024-01-29,9189
2303,聯電,41,2,39,群益金鼎-桃園,2024-01-29,9189
2356,英業達,50,13,37,群益金鼎-桃園,2024-01-29,9189
2610,華航,53,17,36,群益金鼎-桃園,2024-01-29,9189
00673R,期元大S＆P原油反1,36,0,36,群益金鼎-桃園,2024-01-29,9189
1815,富喬,32,1,31,群益金鼎-桃園,2024-01-29,9189
00687B,國泰20年美債,34,3,31,群益金鼎-桃園,2024-01-29,9189
8064,東捷,28,1,27,群益金鼎-桃園,2024-01-29,9189
3535,晶彩科,31,8,23,群益金鼎-桃園,2024-01-29,9189
2881,富邦金,23,1,22,群益金鼎-桃園,2024-01-29,9189
3481,群創,131,110,21,群益金鼎-桃園,2024-01-29,9189
8150,南茂,20,0,20,群益金鼎-桃園,2024-01-29,9189
3360,尚立,165,145,20,群益金鼎-桃園,2024-01-29,9189
4729,熒茂,20,2,18,群益金鼎-桃園,2024-01-29,9189
3356,奇偶,19,2,17,群益金鼎-桃園,2024-01-29,9189
6770,力積電,16,0,16,群益金鼎-桃園,2024-01-29,9189
00720B,元大投資級公司債,15,0,15,群益金鼎-桃園,2024-01-29,9189
3694,海華,16,1,15,群益金鼎-桃園,2024-01-29,9189
00933B,國泰10Y+金融債,14,0,14,群益金鼎-桃園,2024-01-29,9189
6535,順藥,12,0,12,群益金鼎-桃園,2024-01-29,9189
5905,南仁湖,12,0,12,群益金鼎-桃園,2024-01-29,9189
00877,復華中國5G,12,0,12,群益金鼎-桃園,2024-01-29,9189
4420,光明,19,7,12,群益金鼎-桃園,2024-01-29,9189
00878,國泰永續高股息,24,14,10,群益金鼎-桃園,2024-01-29,9189
00706L,期元大S＆P日圓正2,10,0,10,群益金鼎-桃園,2024-01-29,9189
6163,華電網,10,0,10,群益金鼎-桃園,2024-01-29,9189
00895,富邦未來車,10,0,10,群益金鼎-桃園,2024-01-29,9189
8936,國統,18,8,10,群益金鼎-桃園,2024-01-29,9189
6763,綠界科技*,9,0,9,群益金鼎-桃園,2024-01-29,9189
1309,台達化,9,0,9,群益金鼎-桃園,2024-01-29,9189
4968,立積,12,4,8,群益金鼎-桃園,2024-01-29,9189
6113,亞矽,20,12,8,群益金鼎-桃園,2024-01-29,9189
2337,旺宏,7,0,7,群益金鼎-桃園,2024-01-29,9189
2317,鴻海,10,3,7,群益金鼎-桃園,2024-01-29,9189
2401,凌陽,7,0,7,群益金鼎-桃園,2024-01-29,9189
8927,北基,7,0,7,群益金鼎-桃園,2024-01-29,9189
00795B,中信美國公債20年,6,0,6,群益金鼎-桃園,2024-01-29,9189
8937,合騏,6,0,6,群益金鼎-桃園,2024-01-29,9189
2867,三商壽,6,0,6,群益金鼎-桃園,2024-01-29,9189
2365,昆盈,14,8,6,群益金鼎-桃園,2024-01-29,9189
00688L,國泰20年美債正2,5,0,5,群益金鼎-桃園,2024-01-29,9189
1536,和大,5,0,5,群益金鼎-桃園,2024-01-29,9189
1569,濱川,5,0,5,群益金鼎-桃園,2024-01-29,9189
8021,尖點,5,0,5,群益金鼎-桃園,2024-01-29,9189
2882,國泰金,202,17,185,群益金鼎-桃園,2024-01-30,9189
00665L,富邦�琤肭磪囓�2,135,0,135,群益金鼎-桃園,2024-01-30,9189
00751B,元大AAA至A公司債,121,0,121,群益金鼎-桃園,2024-01-30,9189
00637L,元大滬深300正2,82,3,79,群益金鼎-桃園,2024-01-30,9189
00650L,復華香港正2,50,0,50,群益金鼎-桃園,2024-01-30,9189
00937B,群益ESG投等債20,53,10,43,群益金鼎-桃園,2024-01-30,9189
7402,邑錡,35,0,35,群益金鼎-桃園,2024-01-30,9189
2104,國際中橡,30,0,30,群益金鼎-桃園,2024-01-30,9189
9105,泰金寶-DR,30,1,29,群益金鼎-桃園,2024-01-30,9189
6165,浪凡,42,16,26,群益金鼎-桃園,2024-01-30,9189
5426,振發,35,11,24,群益金鼎-桃園,2024-01-30,9189
00882,中信中國高股息,23,0,23,群益金鼎-桃園,2024-01-30,9189
4543,萬在,32,9,23,群益金鼎-桃園,2024-01-30,9189
00706L,期元大S＆P日圓正2,23,0,23,群益金鼎-桃園,2024-01-30,9189
1409,新纖,20,0,20,群益金鼎-桃園,2024-01-30,9189
2731,雄獅,20,0,20,群益金鼎-桃園,2024-01-30,9189
00753L,中信中國50正2,25,5,20,群益金鼎-桃園,2024-01-30,9189
1708,東鹼,17,0,17,群益金鼎-桃園,2024-01-30,9189
8489,三貝德,16,1,15,群益金鼎-桃園,2024-01-30,9189
3058,立德,15,0,15,群益金鼎-桃園,2024-01-30,9189
6465,威潤,15,0,15,群益金鼎-桃園,2024-01-30,9189
2618,長榮航,18,4,14,群益金鼎-桃園,2024-01-30,9189
00898,國泰基因免疫革命,14,0,14,群益金鼎-桃園,2024-01-30,9189
5871,中租-KY,13,0,13,群益金鼎-桃園,2024-01-30,9189
8110,華東,13,0,13,群益金鼎-桃園,2024-01-30,9189
4729,熒茂,15,2,13,群益金鼎-桃園,2024-01-30,9189
2887,台新金,13,0,13,群益金鼎-桃園,2024-01-30,9189
2421,建準,45,32,13,群益金鼎-桃園,2024-01-30,9189
00680L,元大美債20正2,12,0,12,群益金鼎-桃園,2024-01-30,9189
2316,楠梓電,14,2,12,群益金鼎-桃園,2024-01-30,9189
2884,玉山金,11,0,11,群益金鼎-桃園,2024-01-30,9189
00632R,元大台灣50反1,11,0,11,群益金鼎-桃園,2024-01-30,9189
3376,新日興,31,21,10,群益金鼎-桃園,2024-01-30,9189
9934,成霖,10,0,10,群益金鼎-桃園,2024-01-30,9189
1795,美時,10,0,10,群益金鼎-桃園,2024-01-30,9189
5469,瀚宇博,10,0,10,群益金鼎-桃園,2024-01-30,9189
00909,國泰數位支付服務,10,0,10,群益金鼎-桃園,2024-01-30,9189
6550,北極星藥業-KY,10,0,10,群益金鼎-桃園,2024-01-30,9189
1605,華新,10,0,10,群益金鼎-桃園,2024-01-30,9189
00933B,國泰10Y+金融債,10,1,9,群益金鼎-桃園,2024-01-30,9189
2353,宏��,23,14,9,群益金鼎-桃園,2024-01-30,9189
3297,杭特,13,4,9,群益金鼎-桃園,2024-01-30,9189
8033,雷虎,9,0,9,群益金鼎-桃園,2024-01-30,9189
2748,雲品,21,12,9,群益金鼎-桃園,2024-01-30,9189
2605,新興,10,1,9,群益金鼎-桃園,2024-01-30,9189
4909,新復興,25,16,9,群益金鼎-桃園,2024-01-30,9189
6770,力積電,8,0,8,群益金鼎-桃園,2024-01-30,9189
2363,矽統,10,2,8,群益金鼎-桃園,2024-01-30,9189
5243,乙盛-KY,8,0,8,群益金鼎-桃園,2024-01-30,9189
6202,盛群,8,0,8,群益金鼎-桃園,2024-01-30,9189
3114,好德,142,1,141,群益金鼎-桃園,2024-01-31,9189
1806,冠軍,100,1,99,群益金鼎-桃園,2024-01-31,9189
00937B,群益ESG投等債20,73,14,59,群益金鼎-桃園,2024-01-31,9189
00665L,富邦�琤肭磪囓�2,50,0,50,群益金鼎-桃園,2024-01-31,9189
2308,台達電,37,0,37,群益金鼎-桃園,2024-01-31,9189
00878,國泰永續高股息,25,0,25,群益金鼎-桃園,2024-01-31,9189
3231,緯創,35,10,25,群益金鼎-桃園,2024-01-31,9189
00687B,國泰20年美債,25,1,24,群益金鼎-桃園,2024-01-31,9189
3694,海華,58,36,22,群益金鼎-桃園,2024-01-31,9189
2313,華通,25,4,21,群益金鼎-桃園,2024-01-31,9189
2329,華泰,22,1,21,群益金鼎-桃園,2024-01-31,9189
2356,英業達,35,15,20,群益金鼎-桃園,2024-01-31,9189
2409,友達,20,0,20,群益金鼎-桃園,2024-01-31,9189
3055,蔚華科,72,52,20,群益金鼎-桃園,2024-01-31,9189
2330,台積電,18,0,18,群益金鼎-桃園,2024-01-31,9189
8489,三貝德,19,2,17,群益金鼎-桃園,2024-01-31,9189
2002,中鋼,22,6,16,群益金鼎-桃園,2024-01-31,9189
2303,聯電,26,11,15,群益金鼎-桃園,2024-01-31,9189
3308,聯德,14,0,14,群益金鼎-桃園,2024-01-31,9189
2353,宏��,26,12,14,群益金鼎-桃園,2024-01-31,9189
2369,菱生,17,4,13,群益金鼎-桃園,2024-01-31,9189
00637L,元大滬深300正2,32,20,12,群益金鼎-桃園,2024-01-31,9189
6695,芯鼎,35,23,12,群益金鼎-桃園,2024-01-31,9189
4529,淳紳,13,1,12,群益金鼎-桃園,2024-01-31,9189
4167,松瑞藥,13,1,12,群益金鼎-桃園,2024-01-31,9189
2634,漢翔,11,0,11,群益金鼎-桃園,2024-01-31,9189
4729,熒茂,11,0,11,群益金鼎-桃園,2024-01-31,9189
6768,志強-KY,16,5,11,群益金鼎-桃園,2024-01-31,9189
3354,律勝,11,0,11,群益金鼎-桃園,2024-01-31,9189
2204,中華,11,0,11,群益金鼎-桃園,2024-01-31,9189
2605,新興,11,0,11,群益金鼎-桃園,2024-01-31,9189
3325,旭品,10,0,10,群益金鼎-桃園,2024-01-31,9189
00670L,富邦NASDAQ正2,10,0,10,群益金鼎-桃園,2024-01-31,9189
2459,敦吉,10,0,10,群益金鼎-桃園,2024-01-31,9189
3217,優群,10,0,10,群益金鼎-桃園,2024-01-31,9189
6118,建達,9,0,9,群益金鼎-桃園,2024-01-31,9189
3535,晶彩科,13,4,9,群益金鼎-桃園,2024-01-31,9189
00919,群益台灣精選高息,11,2,9,群益金鼎-桃園,2024-01-31,9189
2363,矽統,15,7,8,群益金鼎-桃園,2024-01-31,9189
2449,京元電子,8,0,8,群益金鼎-桃園,2024-01-31,9189
1582,信錦,8,0,8,群益金鼎-桃園,2024-01-31,9189
2355,敬鵬,8,0,8,群益金鼎-桃園,2024-01-31,9189
00753L,中信中國50正2,10,2,8,群益金鼎-桃園,2024-01-31,9189
00650L,復華香港正2,10,2,8,群益金鼎-桃園,2024-01-31,9189
2382,廣達,15,7,8,群益金鼎-桃園,2024-01-31,9189
00679B,元大美債20年,8,1,7,群益金鼎-桃園,2024-01-31,9189
2365,昆盈,13,6,7,群益金鼎-桃園,2024-01-31,9189
3691,碩禾,7,0,7,群益金鼎-桃園,2024-01-31,9189
6140,訊達,11,4,7,群益金鼎-桃園,2024-01-31,9189
6451,訊芯-KY,24,17,7,群益金鼎-桃園,2024-01-31,9189
00878,國泰永續高股息,53,1,52,群益金鼎-桃園,2024-02-01,9189
3481,群創,57,12,45,群益金鼎-桃園,2024-02-01,9189
00885,富邦越南,50,5,45,群益金鼎-桃園,2024-02-01,9189
2303,聯電,44,1,43,群益金鼎-桃園,2024-02-01,9189
3114,好德,40,2,38,群益金鼎-桃園,2024-02-01,9189
3033,威健,63,29,34,群益金鼎-桃園,2024-02-01,9189
2409,友達,59,27,32,群益金鼎-桃園,2024-02-01,9189
8936,國統,78,48,30,群益金鼎-桃園,2024-02-01,9189
4729,熒茂,23,2,21,群益金鼎-桃園,2024-02-01,9189
2382,廣達,21,1,20,群益金鼎-桃園,2024-02-01,9189
2401,凌陽,18,0,18,群益金鼎-桃園,2024-02-01,9189
1612,宏泰,16,0,16,群益金鼎-桃園,2024-02-01,9189
8039,台虹,16,0,16,群益金鼎-桃園,2024-02-01,9189
8150,南茂,15,0,15,群益金鼎-桃園,2024-02-01,9189
3354,律勝,117,102,15,群益金鼎-桃園,2024-02-01,9189
1515,力山,20,6,14,群益金鼎-桃園,2024-02-01,9189
00919,群益台灣精選高息,32,20,12,群益金鼎-桃園,2024-02-01,9189
2376,技嘉,14,2,12,群益金鼎-桃園,2024-02-01,9189
6603,富強鑫,12,0,12,群益金鼎-桃園,2024-02-01,9189
2739,寒舍,12,1,11,群益金鼎-桃園,2024-02-01,9189
00900,富邦特選高股息30,11,0,11,群益金鼎-桃園,2024-02-01,9189
3376,新日興,50,39,11,群益金鼎-桃園,2024-02-01,9189
8234,新漢,15,5,10,群益金鼎-桃園,2024-02-01,9189
8021,尖點,10,0,10,群益金鼎-桃園,2024-02-01,9189
2405,輔信,10,0,10,群益金鼎-桃園,2024-02-01,9189
1504,東元,10,0,10,群益金鼎-桃園,2024-02-01,9189
2340,台亞,10,0,10,群益金鼎-桃園,2024-02-01,9189
5487,通泰,11,1,10,群益金鼎-桃園,2024-02-01,9189
00655L,國泰中國A50正2,11,1,10,群益金鼎-桃園,2024-02-01,9189
00679B,元大美債20年,10,0,10,群益金鼎-桃園,2024-02-01,9189
00929,復華台灣科技優息,29,20,9,群益金鼎-桃園,2024-02-01,9189
1618,合機,15,6,9,群益金鼎-桃園,2024-02-01,9189
6116,彩晶,10,1,9,群益金鼎-桃園,2024-02-01,9189
6120,達運,15,6,9,群益金鼎-桃園,2024-02-01,9189
00645,富邦日本,8,0,8,群益金鼎-桃園,2024-02-01,9189
6118,建達,9,1,8,群益金鼎-桃園,2024-02-01,9189
2885,元大金,10,2,8,群益金鼎-桃園,2024-02-01,9189
3313,斐成,8,0,8,群益金鼎-桃園,2024-02-01,9189
6233,旺玖,7,0,7,群益金鼎-桃園,2024-02-01,9189
6139,亞翔,12,5,7,群益金鼎-桃園,2024-02-01,9189
5203,訊連,7,0,7,群益金鼎-桃園,2024-02-01,9189
1789,神隆,7,0,7,群益金鼎-桃園,2024-02-01,9189
9919,康那香,25,18,7,群益金鼎-桃園,2024-02-01,9189
00753L,中信中國50正2,32,25,7,群益金鼎-桃園,2024-02-01,9189
4303,信立,12,5,7,群益金鼎-桃園,2024-02-01,9189
00931B,統一美債20年,10,3,7,群益金鼎-桃園,2024-02-01,9189
00712,復華富時不動產,7,0,7,群益金鼎-桃園,2024-02-01,9189
00933B,國泰10Y+金融債,8,2,6,群益金鼎-桃園,2024-02-01,9189
2365,昆盈,7,1,6,群益金鼎-桃園,2024-02-01,9189
2342,茂矽,6,0,6,群益金鼎-桃園,2024-02-01,9189
2409,友達,200,10,190,群益金鼎-桃園,2024-02-02,9189
1806,冠軍,80,0,80,群益金鼎-桃園,2024-02-02,9189
00919,群益台灣精選高息,68,0,68,群益金鼎-桃園,2024-02-02,9189
1514,亞力,80,15,65,群益金鼎-桃園,2024-02-02,9189
2303,聯電,60,0,60,群益金鼎-桃園,2024-02-02,9189
00680L,元大美債20正2,51,0,51,群益金鼎-桃園,2024-02-02,9189
00665L,富邦�琤肭磪囓�2,60,10,50,群益金鼎-桃園,2024-02-02,9189
2609,陽明,51,2,49,群益金鼎-桃園,2024-02-02,9189
00929,復華台灣科技優息,58,10,48,群益金鼎-桃園,2024-02-02,9189
2891,中信金,45,0,45,群益金鼎-桃園,2024-02-02,9189
1528,恩德,69,33,36,群益金鼎-桃園,2024-02-02,9189
00933B,國泰10Y+金融債,35,0,35,群益金鼎-桃園,2024-02-02,9189
2812,台中銀,33,0,33,群益金鼎-桃園,2024-02-02,9189
2449,京元電子,47,15,32,群益金鼎-桃園,2024-02-02,9189
3081,聯亞,48,23,25,群益金鼎-桃園,2024-02-02,9189
2353,宏��,39,15,24,群益金鼎-桃園,2024-02-02,9189
2603,長榮,26,2,24,群益金鼎-桃園,2024-02-02,9189
00642U,期元大S＆P石油,22,0,22,群益金鼎-桃園,2024-02-02,9189
2520,冠德,21,0,21,群益金鼎-桃園,2024-02-02,9189
00664R,國泰臺灣加權反1,20,0,20,群益金鼎-桃園,2024-02-02,9189
1536,和大,19,0,19,群益金鼎-桃園,2024-02-02,9189
00733,富邦臺灣中小,18,0,18,群益金鼎-桃園,2024-02-02,9189
8085,福華,22,5,17,群益金鼎-桃園,2024-02-02,9189
00632R,元大台灣50反1,31,14,17,群益金鼎-桃園,2024-02-02,9189
6695,芯鼎,41,24,17,群益金鼎-桃園,2024-02-02,9189
8936,國統,26,10,16,群益金鼎-桃園,2024-02-02,9189
2356,英業達,34,18,16,群益金鼎-桃園,2024-02-02,9189
3094,聯傑,15,0,15,群益金鼎-桃園,2024-02-02,9189
2637,慧洋-KY,15,0,15,群益金鼎-桃園,2024-02-02,9189
8039,台虹,14,0,14,群益金鼎-桃園,2024-02-02,9189
2634,漢翔,14,1,13,群益金鼎-桃園,2024-02-02,9189
2014,中鴻,13,0,13,群益金鼎-桃園,2024-02-02,9189
1605,華新,13,0,13,群益金鼎-桃園,2024-02-02,9189
2882,國泰金,12,0,12,群益金鼎-桃園,2024-02-02,9189
00679B,元大美債20年,14,2,12,群益金鼎-桃園,2024-02-02,9189
8064,東捷,12,0,12,群益金鼎-桃園,2024-02-02,9189
2390,云辰,21,10,11,群益金鼎-桃園,2024-02-02,9189
3038,全台,11,0,11,群益金鼎-桃園,2024-02-02,9189
3017,奇鋐,16,6,10,群益金鼎-桃園,2024-02-02,9189
8096,擎亞,14,4,10,群益金鼎-桃園,2024-02-02,9189
2605,新興,10,0,10,群益金鼎-桃園,2024-02-02,9189
00720B,元大投資級公司債,15,5,10,群益金鼎-桃園,2024-02-02,9189
00882,中信中國高股息,10,0,10,群益金鼎-桃園,2024-02-02,9189
3044,健鼎,11,1,10,群益金鼎-桃園,2024-02-02,9189
8150,南茂,10,0,10,群益金鼎-桃園,2024-02-02,9189
2031,新光鋼,10,0,10,群益金鼎-桃園,2024-02-02,9189
2340,台亞,10,0,10,群益金鼎-桃園,2024-02-02,9189
6026,福邦證,10,0,10,群益金鼎-桃園,2024-02-02,9189
00637L,元大滬深300正2,69,59,10,群益金鼎-桃園,2024-02-02,9189
6530,創威,15,6,9,群益金鼎-桃園,2024-02-02,9189
00937B,群益ESG投等債20,138,30,108,群益金鼎-桃園,2024-02-05,9189
8210,勤誠,115,11,104,群益金鼎-桃園,2024-02-05,9189
2888,新光金,100,0,100,群益金鼎-桃園,2024-02-05,9189
00919,群益台灣精選高息,60,0,60,群益金鼎-桃園,2024-02-05,9189
8064,東捷,53,5,48,群益金鼎-桃園,2024-02-05,9189
2423,固緯,39,0,39,群益金鼎-桃園,2024-02-05,9189
2887,台新金,53,15,38,群益金鼎-桃園,2024-02-05,9189
00929,復華台灣科技優息,40,5,35,群益金鼎-桃園,2024-02-05,9189
00690,兆豐藍籌30,34,0,34,群益金鼎-桃園,2024-02-05,9189
00637L,元大滬深300正2,178,145,33,群益金鼎-桃園,2024-02-05,9189
00687B,國泰20年美債,33,0,33,群益金鼎-桃園,2024-02-05,9189
00665L,富邦�琤肭磪囓�2,30,2,28,群益金鼎-桃園,2024-02-05,9189
2331,精英,28,0,28,群益金鼎-桃園,2024-02-05,9189
00652,富邦印度,27,0,27,群益金鼎-桃園,2024-02-05,9189
2421,建準,62,37,25,群益金鼎-桃園,2024-02-05,9189
2476,鉅祥,25,0,25,群益金鼎-桃園,2024-02-05,9189
2303,聯電,28,4,24,群益金鼎-桃園,2024-02-05,9189
00679B,元大美債20年,23,2,21,群益金鼎-桃園,2024-02-05,9189
00878,國泰永續高股息,25,4,21,群益金鼎-桃園,2024-02-05,9189
6194,育富,21,0,21,群益金鼎-桃園,2024-02-05,9189
2356,英業達,56,36,20,群益金鼎-桃園,2024-02-05,9189
00706L,期元大S＆P日圓正2,20,1,19,群益金鼎-桃園,2024-02-05,9189
2363,矽統,23,4,19,群益金鼎-桃園,2024-02-05,9189
00753L,中信中國50正2,22,3,19,群益金鼎-桃園,2024-02-05,9189
2324,仁寶,28,10,18,群益金鼎-桃園,2024-02-05,9189
00680L,元大美債20正2,17,0,17,群益金鼎-桃園,2024-02-05,9189
2002,中鋼,17,0,17,群益金鼎-桃園,2024-02-05,9189
3530,晶相光,19,2,17,群益金鼎-桃園,2024-02-05,9189
2883,凱基金,16,0,16,群益金鼎-桃園,2024-02-05,9189
2401,凌陽,15,0,15,群益金鼎-桃園,2024-02-05,9189
00688L,國泰20年美債正2,15,0,15,群益金鼎-桃園,2024-02-05,9189
6113,亞矽,16,1,15,群益金鼎-桃園,2024-02-05,9189
1605,華新,15,0,15,群益金鼎-桃園,2024-02-05,9189
2408,南亞科,15,1,14,群益金鼎-桃園,2024-02-05,9189
00900,富邦特選高股息30,13,0,13,群益金鼎-桃園,2024-02-05,9189
2606,裕民,12,0,12,群益金鼎-桃園,2024-02-05,9189
6684,安格,14,2,12,群益金鼎-桃園,2024-02-05,9189
6695,芯鼎,36,24,12,群益金鼎-桃園,2024-02-05,9189
00642U,期元大S＆P石油,12,0,12,群益金鼎-桃園,2024-02-05,9189
00715L,期街口布蘭特正2,12,0,12,群益金鼎-桃園,2024-02-05,9189
6213,聯茂,19,8,11,群益金鼎-桃園,2024-02-05,9189
4401,東隆興,11,0,11,群益金鼎-桃園,2024-02-05,9189
2891,中信金,12,1,11,群益金鼎-桃園,2024-02-05,9189
2301,光寶科,16,5,11,群益金鼎-桃園,2024-02-05,9189
2915,潤泰全,10,0,10,群益金鼎-桃園,2024-02-05,9189
6530,創威,11,1,10,群益金鼎-桃園,2024-02-05,9189
3711,日月光投控,10,0,10,群益金鼎-桃園,2024-02-05,9189
3260,威剛,10,0,10,群益金鼎-桃園,2024-02-05,9189
3588,通嘉,10,0,10,群益金鼎-桃園,2024-02-05,9189
1612,宏泰,10,0,10,群益金鼎-桃園,2024-02-05,9189
2891,中信金,513,13,500,群益金鼎-桃園,2024-02-15,9189
00706L,期元大S＆P日圓正2,270,0,270,群益金鼎-桃園,2024-02-15,9189
00937B,群益ESG投等債20,247,0,247,群益金鼎-桃園,2024-02-15,9189
00632R,元大台灣50反1,193,0,193,群益金鼎-桃園,2024-02-15,9189
00680L,元大美債20正2,171,3,168,群益金鼎-桃園,2024-02-15,9189
00720B,元大投資級公司債,144,0,144,群益金鼎-桃園,2024-02-15,9189
00751B,元大AAA至A公司債,121,0,121,群益金鼎-桃園,2024-02-15,9189
00933B,國泰10Y+金融債,110,1,109,群益金鼎-桃園,2024-02-15,9189
2515,中工,102,1,101,群益金鼎-桃園,2024-02-15,9189
00919,群益台灣精選高息,133,36,97,群益金鼎-桃園,2024-02-15,9189
00929,復華台灣科技優息,119,31,88,群益金鼎-桃園,2024-02-15,9189
00679B,元大美債20年,73,5,68,群益金鼎-桃園,2024-02-15,9189
00687B,國泰20年美債,67,10,57,群益金鼎-桃園,2024-02-15,9189
3481,群創,56,13,43,群益金鼎-桃園,2024-02-15,9189
2344,華邦電,43,1,42,群益金鼎-桃園,2024-02-15,9189
5381,合正,40,1,39,群益金鼎-桃園,2024-02-15,9189
00712,復華富時不動產,41,10,31,群益金鼎-桃園,2024-02-15,9189
00878,國泰永續高股息,46,15,31,群益金鼎-桃園,2024-02-15,9189
00931B,統一美債20年,30,0,30,群益金鼎-桃園,2024-02-15,9189
00885,富邦越南,30,0,30,群益金鼎-桃園,2024-02-15,9189
1711,永光,30,0,30,群益金鼎-桃園,2024-02-15,9189
2408,南亞科,27,2,25,群益金鼎-桃園,2024-02-15,9189
00900,富邦特選高股息30,32,8,24,群益金鼎-桃園,2024-02-15,9189
00688L,國泰20年美債正2,24,0,24,群益金鼎-桃園,2024-02-15,9189
2356,英業達,98,75,23,群益金鼎-桃園,2024-02-15,9189
3288,點晶,20,0,20,群益金鼎-桃園,2024-02-15,9189
00852L,國泰美國道瓊正2,20,0,20,群益金鼎-桃園,2024-02-15,9189
2313,華通,30,10,20,群益金鼎-桃園,2024-02-15,9189
2610,華航,18,0,18,群益金鼎-桃園,2024-02-15,9189
1513,中興電,20,3,17,群益金鼎-桃園,2024-02-15,9189
00664R,國泰臺灣加權反1,17,0,17,群益金鼎-桃園,2024-02-15,9189
00795B,中信美國公債20年,19,2,17,群益金鼎-桃園,2024-02-15,9189
2365,昆盈,157,141,16,群益金鼎-桃園,2024-02-15,9189
3105,穩懋,16,1,15,群益金鼎-桃園,2024-02-15,9189
2748,雲品,16,2,14,群益金鼎-桃園,2024-02-15,9189
2405,輔信,24,10,14,群益金鼎-桃園,2024-02-15,9189
2739,寒舍,13,0,13,群益金鼎-桃園,2024-02-15,9189
9919,康那香,15,2,13,群益金鼎-桃園,2024-02-15,9189
00676R,富邦臺灣加權反1,13,0,13,群益金鼎-桃園,2024-02-15,9189
2618,長榮航,35,22,13,群益金鼎-桃園,2024-02-15,9189
00673R,期元大S＆P原油反1,12,0,12,群益金鼎-桃園,2024-02-15,9189
6584,南俊國際,12,0,12,群益金鼎-桃園,2024-02-15,9189
4747,強生,12,0,12,群益金鼎-桃園,2024-02-15,9189
3360,尚立,14,3,11,群益金鼎-桃園,2024-02-15,9189
2002,中鋼,16,6,10,群益金鼎-桃園,2024-02-15,9189
1789,神隆,10,0,10,群益金鼎-桃園,2024-02-15,9189
1301,台塑,12,2,10,群益金鼎-桃園,2024-02-15,9189
00665L,富邦�琤肭磪囓�2,20,10,10,群益金鼎-桃園,2024-02-15,9189
6129,普誠,10,0,10,群益金鼎-桃園,2024-02-15,9189
2317,鴻海,11,2,9,群益金鼎-桃園,2024-02-15,9189
2888,新光金,170,10,160,群益金鼎-桃園,2024-02-16,9189
2324,仁寶,124,14,110,群益金鼎-桃園,2024-02-16,9189
8926,台汽電,107,1,106,群益金鼎-桃園,2024-02-16,9189
00933B,國泰10Y+金融債,89,0,89,群益金鼎-桃園,2024-02-16,9189
2365,昆盈,160,79,81,群益金鼎-桃園,2024-02-16,9189
00937B,群益ESG投等債20,158,87,71,群益金鼎-桃園,2024-02-16,9189
00706L,期元大S＆P日圓正2,61,0,61,群益金鼎-桃園,2024-02-16,9189
2303,聯電,70,12,58,群益金鼎-桃園,2024-02-16,9189
00632R,元大台灣50反1,51,0,51,群益金鼎-桃園,2024-02-16,9189
2882,國泰金,50,5,45,群益金鼎-桃園,2024-02-16,9189
00795B,中信美國公債20年,44,0,44,群益金鼎-桃園,2024-02-16,9189
00688L,國泰20年美債正2,35,0,35,群益金鼎-桃園,2024-02-16,9189
00931B,統一美債20年,35,0,35,群益金鼎-桃園,2024-02-16,9189
00687B,國泰20年美債,36,5,31,群益金鼎-桃園,2024-02-16,9189
2329,華泰,77,50,27,群益金鼎-桃園,2024-02-16,9189
00679B,元大美債20年,33,7,26,群益金鼎-桃園,2024-02-16,9189
1514,亞力,43,17,26,群益金鼎-桃園,2024-02-16,9189
2515,中工,35,10,25,群益金鼎-桃園,2024-02-16,9189
2371,大同,24,0,24,群益金鼎-桃園,2024-02-16,9189
4420,光明,22,0,22,群益金鼎-桃園,2024-02-16,9189
2382,廣達,46,26,20,群益金鼎-桃園,2024-02-16,9189
6667,信紘科,25,5,20,群益金鼎-桃園,2024-02-16,9189
6538,倉和,20,0,20,群益金鼎-桃園,2024-02-16,9189
8064,東捷,20,1,19,群益金鼎-桃園,2024-02-16,9189
4109,加捷生醫,19,0,19,群益金鼎-桃園,2024-02-16,9189
2425,承啟,29,10,19,群益金鼎-桃園,2024-02-16,9189
00929,復華台灣科技優息,65,48,17,群益金鼎-桃園,2024-02-16,9189
3704,合勤控,16,0,16,群益金鼎-桃園,2024-02-16,9189
8089,康全電訊,21,5,16,群益金鼎-桃園,2024-02-16,9189
3017,奇鋐,20,6,14,群益金鼎-桃園,2024-02-16,9189
00680L,元大美債20正2,14,0,14,群益金鼎-桃園,2024-02-16,9189
3264,欣銓,15,1,14,群益金鼎-桃園,2024-02-16,9189
8054,安國,19,5,14,群益金鼎-桃園,2024-02-16,9189
00751B,元大AAA至A公司債,13,0,13,群益金鼎-桃園,2024-02-16,9189
2390,云辰,13,0,13,群益金鼎-桃園,2024-02-16,9189
2748,雲品,13,0,13,群益金鼎-桃園,2024-02-16,9189
2887,台新金,13,0,13,群益金鼎-桃園,2024-02-16,9189
2423,固緯,40,28,12,群益金鼎-桃園,2024-02-16,9189
6139,亞翔,15,3,12,群益金鼎-桃園,2024-02-16,9189
3211,順達,12,0,12,群益金鼎-桃園,2024-02-16,9189
3622,洋華,13,1,12,群益金鼎-桃園,2024-02-16,9189
4908,前鼎,28,17,11,群益金鼎-桃園,2024-02-16,9189
6140,訊達,19,8,11,群益金鼎-桃園,2024-02-16,9189
4729,熒茂,11,0,11,群益金鼎-桃園,2024-02-16,9189
2419,仲琦,11,0,11,群益金鼎-桃園,2024-02-16,9189
3217,優群,11,0,11,群益金鼎-桃園,2024-02-16,9189
3036,文曄,12,1,11,群益金鼎-桃園,2024-02-16,9189
1522,堤維西,27,16,11,群益金鼎-桃園,2024-02-16,9189
5871,中租-KY,12,1,11,群益金鼎-桃園,2024-02-16,9189
2492,華新科,12,2,10,群益金鼎-桃園,2024-02-16,9189
00919,群益台灣精選高息,474,6,468,群益金鼎-桃園,2024-02-19,9189
2025,千興,214,1,213,群益金鼎-桃園,2024-02-19,9189
00937B,群益ESG投等債20,246,35,211,群益金鼎-桃園,2024-02-19,9189
00665L,富邦�琤肭磪囓�2,70,0,70,群益金鼎-桃園,2024-02-19,9189
2888,新光金,80,11,69,群益金鼎-桃園,2024-02-19,9189
2329,華泰,131,75,56,群益金鼎-桃園,2024-02-19,9189
4714,永捷,77,24,53,群益金鼎-桃園,2024-02-19,9189
1806,冠軍,50,2,48,群益金鼎-桃園,2024-02-19,9189
00679B,元大美債20年,47,0,47,群益金鼎-桃園,2024-02-19,9189
7402,邑錡,50,3,47,群益金鼎-桃園,2024-02-19,9189
2356,英業達,55,9,46,群益金鼎-桃園,2024-02-19,9189
3231,緯創,56,24,32,群益金鼎-桃園,2024-02-19,9189
1314,中石化,32,0,32,群益金鼎-桃園,2024-02-19,9189
2353,宏��,39,8,31,群益金鼎-桃園,2024-02-19,9189
2102,泰豐,30,0,30,群益金鼎-桃園,2024-02-19,9189
3356,奇偶,31,1,30,群益金鼎-桃園,2024-02-19,9189
2201,裕隆,33,6,27,群益金鼎-桃園,2024-02-19,9189
2701,萬企,30,4,26,群益金鼎-桃園,2024-02-19,9189
1514,亞力,120,95,25,群益金鼎-桃園,2024-02-19,9189
6742,澤米,25,0,25,群益金鼎-桃園,2024-02-19,9189
00878,國泰永續高股息,37,13,24,群益金鼎-桃園,2024-02-19,9189
5443,均豪,31,8,23,群益金鼎-桃園,2024-02-19,9189
6770,力積電,31,8,23,群益金鼎-桃園,2024-02-19,9189
2890,永豐金,25,2,23,群益金鼎-桃園,2024-02-19,9189
00687B,國泰20年美債,21,0,21,群益金鼎-桃園,2024-02-19,9189
2408,南亞科,21,0,21,群益金鼎-桃園,2024-02-19,9189
1504,東元,21,0,21,群益金鼎-桃園,2024-02-19,9189
3715,定穎投控,22,2,20,群益金鼎-桃園,2024-02-19,9189
3035,智原,24,4,20,群益金鼎-桃園,2024-02-19,9189
5347,世界,20,1,19,群益金鼎-桃園,2024-02-19,9189
8096,擎亞,37,19,18,群益金鼎-桃園,2024-02-19,9189
6179,亞通,23,5,18,群益金鼎-桃園,2024-02-19,9189
2324,仁寶,17,0,17,群益金鼎-桃園,2024-02-19,9189
4908,前鼎,21,5,16,群益金鼎-桃園,2024-02-19,9189
00772B,中信高評級公司債,16,0,16,群益金鼎-桃園,2024-02-19,9189
2609,陽明,20,5,15,群益金鼎-桃園,2024-02-19,9189
4960,誠美材,31,17,14,群益金鼎-桃園,2024-02-19,9189
2515,中工,27,14,13,群益金鼎-桃園,2024-02-19,9189
00712,復華富時不動產,13,0,13,群益金鼎-桃園,2024-02-19,9189
2303,聯電,21,8,13,群益金鼎-桃園,2024-02-19,9189
2421,建準,19,6,13,群益金鼎-桃園,2024-02-19,9189
00637L,元大滬深300正2,35,22,13,群益金鼎-桃園,2024-02-19,9189
2388,威盛,15,3,12,群益金鼎-桃園,2024-02-19,9189
4979,華星光,16,4,12,群益金鼎-桃園,2024-02-19,9189
8926,台汽電,12,1,11,群益金鼎-桃園,2024-02-19,9189
00688L,國泰20年美債正2,11,0,11,群益金鼎-桃園,2024-02-19,9189
2481,強茂,11,0,11,群益金鼎-桃園,2024-02-19,9189
2402,毅嘉,12,1,11,群益金鼎-桃園,2024-02-19,9189
6138,茂達,12,1,11,群益金鼎-桃園,2024-02-19,9189
1316,上曜,12,2,10,群益金鼎-桃園,2024-02-19,9189
00937B,群益ESG投等債20,449,22,427,群益金鼎-桃園,2024-02-20,9189
00665L,富邦�琤肭磪囓�2,110,0,110,群益金鼎-桃園,2024-02-20,9189
2353,宏��,125,16,109,群益金鼎-桃園,2024-02-20,9189
2440,太空梭,100,0,100,群益金鼎-桃園,2024-02-20,9189
00933B,國泰10Y+金融債,80,0,80,群益金鼎-桃園,2024-02-20,9189
1815,富喬,87,28,59,群益金鼎-桃園,2024-02-20,9189
6153,嘉聯益,50,0,50,群益金鼎-桃園,2024-02-20,9189
00712,復華富時不動產,46,0,46,群益金鼎-桃園,2024-02-20,9189
2371,大同,45,0,45,群益金鼎-桃園,2024-02-20,9189
8926,台汽電,46,1,45,群益金鼎-桃園,2024-02-20,9189
2601,益航,38,0,38,群益金鼎-桃園,2024-02-20,9189
00687B,國泰20年美債,37,0,37,群益金鼎-桃園,2024-02-20,9189
2618,長榮航,42,6,36,群益金鼎-桃園,2024-02-20,9189
4729,熒茂,35,0,35,群益金鼎-桃園,2024-02-20,9189
1809,中釉,54,20,34,群益金鼎-桃園,2024-02-20,9189
6282,康舒,43,9,34,群益金鼎-桃園,2024-02-20,9189
3712,永崴投控,38,9,29,群益金鼎-桃園,2024-02-20,9189
00706L,期元大S＆P日圓正2,30,1,29,群益金鼎-桃園,2024-02-20,9189
3035,智原,39,10,29,群益金鼎-桃園,2024-02-20,9189
3622,洋華,28,2,26,群益金鼎-桃園,2024-02-20,9189
3081,聯亞,29,3,26,群益金鼎-桃園,2024-02-20,9189
4714,永捷,76,50,26,群益金鼎-桃園,2024-02-20,9189
00878,國泰永續高股息,49,24,25,群益金鼎-桃園,2024-02-20,9189
3312,弘憶股,38,13,25,群益金鼎-桃園,2024-02-20,9189
00795B,中信美國公債20年,24,0,24,群益金鼎-桃園,2024-02-20,9189
1513,中興電,29,8,21,群益金鼎-桃園,2024-02-20,9189
1316,上曜,22,2,20,群益金鼎-桃園,2024-02-20,9189
1528,恩德,21,1,20,群益金鼎-桃園,2024-02-20,9189
5426,振發,23,4,19,群益金鼎-桃園,2024-02-20,9189
2368,金像電,18,1,17,群益金鼎-桃園,2024-02-20,9189
6684,安格,52,36,16,群益金鼎-桃園,2024-02-20,9189
2337,旺宏,16,0,16,群益金鼎-桃園,2024-02-20,9189
00929,復華台灣科技優息,108,93,15,群益金鼎-桃園,2024-02-20,9189
00720B,元大投資級公司債,15,0,15,群益金鼎-桃園,2024-02-20,9189
8070,長華*,15,0,15,群益金鼎-桃園,2024-02-20,9189
6120,達運,15,0,15,群益金鼎-桃園,2024-02-20,9189
2489,瑞軒,21,7,14,群益金鼎-桃園,2024-02-20,9189
8096,擎亞,16,2,14,群益金鼎-桃園,2024-02-20,9189
6116,彩晶,15,1,14,群益金鼎-桃園,2024-02-20,9189
2376,技嘉,27,13,14,群益金鼎-桃園,2024-02-20,9189
00679B,元大美債20年,13,0,13,群益金鼎-桃園,2024-02-20,9189
2302,麗正,19,6,13,群益金鼎-桃園,2024-02-20,9189
3260,威剛,17,4,13,群益金鼎-桃園,2024-02-20,9189
8064,東捷,47,34,13,群益金鼎-桃園,2024-02-20,9189
00733,富邦臺灣中小,13,1,12,群益金鼎-桃園,2024-02-20,9189
5258,虹堡,52,41,11,群益金鼎-桃園,2024-02-20,9189
4540,全球傳動,12,1,11,群益金鼎-桃園,2024-02-20,9189
00891,中信關鍵半導體,10,0,10,群益金鼎-桃園,2024-02-20,9189
2516,新建,10,0,10,群益金鼎-桃園,2024-02-20,9189
00688L,國泰20年美債正2,10,0,10,群益金鼎-桃園,2024-02-20,9189
00751B,元大AAA至A公司債,462,0,462,群益金鼎-桃園,2024-02-21,9189
00933B,國泰10Y+金融債,369,0,369,群益金鼎-桃園,2024-02-21,9189
00937B,群益ESG投等債20,195,0,195,群益金鼎-桃園,2024-02-21,9189
00679B,元大美債20年,50,0,50,群益金鼎-桃園,2024-02-21,9189
3057,喬鼎,50,0,50,群益金鼎-桃園,2024-02-21,9189
8039,台虹,41,0,41,群益金鼎-桃園,2024-02-21,9189
5381,合正,80,43,37,群益金鼎-桃園,2024-02-21,9189
00878,國泰永續高股息,47,12,35,群益金鼎-桃園,2024-02-21,9189
2606,裕民,40,5,35,群益金鼎-桃園,2024-02-21,9189
00712,復華富時不動產,33,0,33,群益金鼎-桃園,2024-02-21,9189
2609,陽明,84,52,32,群益金鼎-桃園,2024-02-21,9189
2885,元大金,30,0,30,群益金鼎-桃園,2024-02-21,9189
2618,長榮航,31,2,29,群益金鼎-桃園,2024-02-21,9189
3047,訊舟,40,12,28,群益金鼎-桃園,2024-02-21,9189
2883,凱基金,25,0,25,群益金鼎-桃園,2024-02-21,9189
2303,聯電,28,4,24,群益金鼎-桃園,2024-02-21,9189
1528,恩德,24,1,23,群益金鼎-桃園,2024-02-21,9189
6189,豐藝,24,2,22,群益金鼎-桃園,2024-02-21,9189
5515,建國,20,0,20,群益金鼎-桃園,2024-02-21,9189
2530,華建,20,0,20,群益金鼎-桃園,2024-02-21,9189
00687B,國泰20年美債,19,0,19,群益金鼎-桃園,2024-02-21,9189
3583,辛耘,22,3,19,群益金鼎-桃園,2024-02-21,9189
00919,群益台灣精選高息,39,21,18,群益金鼎-桃園,2024-02-21,9189
3231,緯創,47,29,18,群益金鼎-桃園,2024-02-21,9189
3081,聯亞,30,13,17,群益金鼎-桃園,2024-02-21,9189
2371,大同,20,3,17,群益金鼎-桃園,2024-02-21,9189
3234,光環,24,7,17,群益金鼎-桃園,2024-02-21,9189
3437,榮創,19,3,16,群益金鼎-桃園,2024-02-21,9189
3035,智原,25,9,16,群益金鼎-桃園,2024-02-21,9189
2367,燿華,17,2,15,群益金鼎-桃園,2024-02-21,9189
5443,均豪,74,59,15,群益金鼎-桃園,2024-02-21,9189
2356,英業達,30,15,15,群益金鼎-桃園,2024-02-21,9189
1316,上曜,32,17,15,群益金鼎-桃園,2024-02-21,9189
3339,泰谷,17,3,14,群益金鼎-桃園,2024-02-21,9189
2476,鉅祥,19,5,14,群益金鼎-桃園,2024-02-21,9189
3372,典範,14,1,13,群益金鼎-桃園,2024-02-21,9189
9933,中鼎,12,0,12,群益金鼎-桃園,2024-02-21,9189
2025,千興,12,0,12,群益金鼎-桃園,2024-02-21,9189
2313,華通,16,4,12,群益金鼎-桃園,2024-02-21,9189
6290,良維,34,22,12,群益金鼎-桃園,2024-02-21,9189
4561,健椿,11,0,11,群益金鼎-桃園,2024-02-21,9189
1506,正道,11,0,11,群益金鼎-桃園,2024-02-21,9189
2543,皇昌,54,43,11,群益金鼎-桃園,2024-02-21,9189
4960,誠美材,14,3,11,群益金鼎-桃園,2024-02-21,9189
00858,永豐美國500大,10,0,10,群益金鼎-桃園,2024-02-21,9189
5521,工信,15,5,10,群益金鼎-桃園,2024-02-21,9189
5355,佳總,10,0,10,群益金鼎-桃園,2024-02-21,9189
1326,台化,10,0,10,群益金鼎-桃園,2024-02-21,9189
9912,偉聯,10,0,10,群益金鼎-桃園,2024-02-21,9189
6188,廣明,10,0,10,群益金鼎-桃園,2024-02-21,9189
00795B,中信美國公債20年,204,0,204,群益金鼎-桃園,2024-02-22,9189
00937B,群益ESG投等債20,200,22,178,群益金鼎-桃園,2024-02-22,9189
1815,富喬,110,22,88,群益金鼎-桃園,2024-02-22,9189
3231,緯創,116,42,74,群益金鼎-桃園,2024-02-22,9189
2489,瑞軒,74,4,70,群益金鼎-桃園,2024-02-22,9189
3312,弘憶股,64,2,62,群益金鼎-桃園,2024-02-22,9189
2329,華泰,123,63,60,群益金鼎-桃園,2024-02-22,9189
2882,國泰金,50,0,50,群益金鼎-桃園,2024-02-22,9189
2324,仁寶,53,5,48,群益金鼎-桃園,2024-02-22,9189
5443,均豪,73,28,45,群益金鼎-桃園,2024-02-22,9189
00679B,元大美債20年,36,0,36,群益金鼎-桃園,2024-02-22,9189
4908,前鼎,39,4,35,群益金鼎-桃園,2024-02-22,9189
8021,尖點,30,0,30,群益金鼎-桃園,2024-02-22,9189
6667,信紘科,32,2,30,群益金鼎-桃園,2024-02-22,9189
00687B,國泰20年美債,27,1,26,群益金鼎-桃園,2024-02-22,9189
1524,耿鼎,29,4,25,群益金鼎-桃園,2024-02-22,9189
1337,再生-KY,25,0,25,群益金鼎-桃園,2024-02-22,9189
00688L,國泰20年美債正2,23,0,23,群益金鼎-桃園,2024-02-22,9189
1503,士電,61,41,20,群益金鼎-桃園,2024-02-22,9189
1513,中興電,55,36,19,群益金鼎-桃園,2024-02-22,9189
6213,聯茂,19,0,19,群益金鼎-桃園,2024-02-22,9189
6126,信音,37,18,19,群益金鼎-桃園,2024-02-22,9189
1702,南僑,19,0,19,群益金鼎-桃園,2024-02-22,9189
00680L,元大美債20正2,21,3,18,群益金鼎-桃園,2024-02-22,9189
6139,亞翔,21,4,17,群益金鼎-桃園,2024-02-22,9189
1314,中石化,17,0,17,群益金鼎-桃園,2024-02-22,9189
3689,湧德,24,8,16,群益金鼎-桃園,2024-02-22,9189
5381,合正,45,29,16,群益金鼎-桃園,2024-02-22,9189
1409,新纖,16,0,16,群益金鼎-桃園,2024-02-22,9189
2388,威盛,18,3,15,群益金鼎-桃園,2024-02-22,9189
00665L,富邦�琤肭磪囓�2,15,0,15,群益金鼎-桃園,2024-02-22,9189
3706,神達,23,8,15,群益金鼎-桃園,2024-02-22,9189
2515,中工,15,0,15,群益金鼎-桃園,2024-02-22,9189
1528,恩德,25,11,14,群益金鼎-桃園,2024-02-22,9189
2371,大同,68,54,14,群益金鼎-桃園,2024-02-22,9189
00751B,元大AAA至A公司債,14,0,14,群益金鼎-桃園,2024-02-22,9189
2618,長榮航,14,0,14,群益金鼎-桃園,2024-02-22,9189
3265,台星科,29,15,14,群益金鼎-桃園,2024-02-22,9189
4109,加捷生醫,14,0,14,群益金鼎-桃園,2024-02-22,9189
2887,台新金,14,0,14,群益金鼎-桃園,2024-02-22,9189
2476,鉅祥,14,1,13,群益金鼎-桃園,2024-02-22,9189
6703,軒郁,13,0,13,群益金鼎-桃園,2024-02-22,9189
5439,高技,28,15,13,群益金鼎-桃園,2024-02-22,9189
3437,榮創,14,1,13,群益金鼎-桃園,2024-02-22,9189
2883,凱基金,15,3,12,群益金鼎-桃園,2024-02-22,9189
2748,雲品,11,0,11,群益金鼎-桃園,2024-02-22,9189
5351,鈺創,12,1,11,群益金鼎-桃園,2024-02-22,9189
5425,台半,11,0,11,群益金鼎-桃園,2024-02-22,9189
5426,振發,11,0,11,群益金鼎-桃園,2024-02-22,9189
00927,群益半導體收益,14,3,11,群益金鼎-桃園,2024-02-22,9189
8064,東捷,241,103,138,群益金鼎-桃園,2024-02-23,9189
2313,華通,241,106,135,群益金鼎-桃園,2024-02-23,9189
00937B,群益ESG投等債20,136,5,131,群益金鼎-桃園,2024-02-23,9189
8021,尖點,114,4,110,群益金鼎-桃園,2024-02-23,9189
1536,和大,76,10,66,群益金鼎-桃園,2024-02-23,9189
00919,群益台灣精選高息,116,53,63,群益金鼎-桃園,2024-02-23,9189
00632R,元大台灣50反1,54,0,54,群益金鼎-桃園,2024-02-23,9189
6189,豐藝,49,1,48,群益金鼎-桃園,2024-02-23,9189
6257,矽格,55,13,42,群益金鼎-桃園,2024-02-23,9189
6125,廣運,51,11,40,群益金鼎-桃園,2024-02-23,9189
2356,英業達,54,18,36,群益金鼎-桃園,2024-02-23,9189
2884,玉山金,38,3,35,群益金鼎-桃園,2024-02-23,9189
1515,力山,31,1,30,群益金鼎-桃園,2024-02-23,9189
2618,長榮航,45,16,29,群益金鼎-桃園,2024-02-23,9189
00687B,國泰20年美債,29,1,28,群益金鼎-桃園,2024-02-23,9189
2520,冠德,24,0,24,群益金鼎-桃園,2024-02-23,9189
6218,豪勉,27,3,24,群益金鼎-桃園,2024-02-23,9189
00679B,元大美債20年,23,0,23,群益金鼎-桃園,2024-02-23,9189
6164,華興,22,0,22,群益金鼎-桃園,2024-02-23,9189
6530,創威,24,3,21,群益金鼎-桃園,2024-02-23,9189
00706L,期元大S＆P日圓正2,20,0,20,群益金鼎-桃園,2024-02-23,9189
8489,三貝德,20,0,20,群益金鼎-桃園,2024-02-23,9189
00918,大華優利高填息30,20,0,20,群益金鼎-桃園,2024-02-23,9189
00764B,群益25年美債,20,0,20,群益金鼎-桃園,2024-02-23,9189
00795B,中信美國公債20年,19,0,19,群益金鼎-桃園,2024-02-23,9189
2367,燿華,19,0,19,群益金鼎-桃園,2024-02-23,9189
2489,瑞軒,29,11,18,群益金鼎-桃園,2024-02-23,9189
2417,圓剛,20,2,18,群益金鼎-桃園,2024-02-23,9189
00641R,富邦日本反1,17,0,17,群益金鼎-桃園,2024-02-23,9189
4743,合一,37,21,16,群益金鼎-桃園,2024-02-23,9189
2408,南亞科,16,0,16,群益金鼎-桃園,2024-02-23,9189
1314,中石化,16,0,16,群益金鼎-桃園,2024-02-23,9189
2888,新光金,16,0,16,群益金鼎-桃園,2024-02-23,9189
6684,安格,19,3,16,群益金鼎-桃園,2024-02-23,9189
2498,宏達電,15,0,15,群益金鼎-桃園,2024-02-23,9189
5347,世界,22,8,14,群益金鼎-桃園,2024-02-23,9189
6782,視陽,14,0,14,群益金鼎-桃園,2024-02-23,9189
00757,統一FANG+,13,0,13,群益金鼎-桃園,2024-02-23,9189
8093,保銳,13,0,13,群益金鼎-桃園,2024-02-23,9189
2460,建通,13,1,12,群益金鼎-桃園,2024-02-23,9189
6695,芯鼎,16,4,12,群益金鼎-桃園,2024-02-23,9189
2474,可成,11,0,11,群益金鼎-桃園,2024-02-23,9189
4526,東台,11,0,11,群益金鼎-桃園,2024-02-23,9189
3380,明泰,13,2,11,群益金鼎-桃園,2024-02-23,9189
3374,精材,11,0,11,群益金鼎-桃園,2024-02-23,9189
2603,長榮,19,8,11,群益金鼎-桃園,2024-02-23,9189
4961,天鈺,12,2,10,群益金鼎-桃園,2024-02-23,9189
2885,元大金,12,2,10,群益金鼎-桃園,2024-02-23,9189
2314,台揚,10,0,10,群益金鼎-桃園,2024-02-23,9189
00858,永豐美國500大,10,0,10,群益金鼎-桃園,2024-02-23,9189
00929,復華台灣科技優息,343,31,312,群益金鼎-桃園,2024-02-26,9189
00937B,群益ESG投等債20,256,67,189,群益金鼎-桃園,2024-02-26,9189
2888,新光金,120,10,110,群益金鼎-桃園,2024-02-26,9189
8047,星雲,83,0,83,群益金鼎-桃園,2024-02-26,9189
8064,東捷,91,12,79,群益金鼎-桃園,2024-02-26,9189
2405,輔信,103,27,76,群益金鼎-桃園,2024-02-26,9189
2371,大同,107,31,76,群益金鼎-桃園,2024-02-26,9189
1101,台泥,52,1,51,群益金鼎-桃園,2024-02-26,9189
8040,九暘,75,25,50,群益金鼎-桃園,2024-02-26,9189
00687B,國泰20年美債,43,0,43,群益金鼎-桃園,2024-02-26,9189
1504,東元,46,12,34,群益金鼎-桃園,2024-02-26,9189
00642U,期元大S＆P石油,31,0,31,群益金鼎-桃園,2024-02-26,9189
00720B,元大投資級公司債,40,10,30,群益金鼎-桃園,2024-02-26,9189
00753L,中信中國50正2,30,0,30,群益金鼎-桃園,2024-02-26,9189
2427,三商電,27,0,27,群益金鼎-桃園,2024-02-26,9189
2313,華通,31,6,25,群益金鼎-桃園,2024-02-26,9189
00665L,富邦�琤肭磪囓�2,30,5,25,群益金鼎-桃園,2024-02-26,9189
3047,訊舟,30,5,25,群益金鼎-桃園,2024-02-26,9189
3312,弘憶股,28,5,23,群益金鼎-桃園,2024-02-26,9189
1514,亞力,92,70,22,群益金鼎-桃園,2024-02-26,9189
00900,富邦特選高股息30,50,28,22,群益金鼎-桃園,2024-02-26,9189
2352,佳世達,21,0,21,群益金鼎-桃園,2024-02-26,9189
2363,矽統,94,74,20,群益金鼎-桃園,2024-02-26,9189
00692,富邦公司治理,20,0,20,群益金鼎-桃園,2024-02-26,9189
6179,亞通,20,0,20,群益金鼎-桃園,2024-02-26,9189
00933B,國泰10Y+金融債,79,60,19,群益金鼎-桃園,2024-02-26,9189
2356,英業達,24,6,18,群益金鼎-桃園,2024-02-26,9189
3706,神達,25,8,17,群益金鼎-桃園,2024-02-26,9189
2892,第一金,16,0,16,群益金鼎-桃園,2024-02-26,9189
2449,京元電子,17,1,16,群益金鼎-桃園,2024-02-26,9189
6120,達運,16,0,16,群益金鼎-桃園,2024-02-26,9189
1414,東和,15,0,15,群益金鼎-桃園,2024-02-26,9189
3231,緯創,37,23,14,群益金鼎-桃園,2024-02-26,9189
3260,威剛,14,0,14,群益金鼎-桃園,2024-02-26,9189
6197,佳必琪,14,0,14,群益金鼎-桃園,2024-02-26,9189
2412,中華電,15,1,14,群益金鼎-桃園,2024-02-26,9189
1503,士電,54,40,14,群益金鼎-桃園,2024-02-26,9189
6288,聯嘉,21,8,13,群益金鼎-桃園,2024-02-26,9189
00664R,國泰臺灣加權反1,12,0,12,群益金鼎-桃園,2024-02-26,9189
2880,華南金,11,0,11,群益金鼎-桃園,2024-02-26,9189
00637L,元大滬深300正2,10,0,10,群益金鼎-桃園,2024-02-26,9189
3466,德晉,10,0,10,群益金鼎-桃園,2024-02-26,9189
00892,富邦台灣半導體,10,0,10,群益金鼎-桃園,2024-02-26,9189
8182,加高,10,0,10,群益金鼎-桃園,2024-02-26,9189
00852L,國泰美國道瓊正2,10,0,10,群益金鼎-桃園,2024-02-26,9189
6142,友勁,10,0,10,群益金鼎-桃園,2024-02-26,9189
6274,台燿,24,14,10,群益金鼎-桃園,2024-02-26,9189
2845,遠東銀,10,0,10,群益金鼎-桃園,2024-02-26,9189
6505,台塑化,10,0,10,群益金鼎-桃園,2024-02-26,9189
00931B,統一美債20年,12,3,9,群益金鼎-桃園,2024-02-26,9189
00937B,群益ESG投等債20,226,55,171,群益金鼎-桃園,2024-02-27,9189
2313,華通,160,31,129,群益金鼎-桃園,2024-02-27,9189
2888,新光金,132,8,124,群益金鼎-桃園,2024-02-27,9189
00878,國泰永續高股息,141,29,112,群益金鼎-桃園,2024-02-27,9189
00929,復華台灣科技優息,130,31,99,群益金鼎-桃園,2024-02-27,9189
8064,東捷,95,33,62,群益金鼎-桃園,2024-02-27,9189
3037,欣興,58,7,51,群益金鼎-桃園,2024-02-27,9189
7402,邑錡,55,5,50,群益金鼎-桃園,2024-02-27,9189
2405,輔信,51,4,47,群益金鼎-桃園,2024-02-27,9189
00919,群益台灣精選高息,155,111,44,群益金鼎-桃園,2024-02-27,9189
00665L,富邦�琤肭磪囓�2,40,0,40,群益金鼎-桃園,2024-02-27,9189
4714,永捷,39,0,39,群益金鼎-桃園,2024-02-27,9189
00679B,元大美債20年,45,12,33,群益金鼎-桃園,2024-02-27,9189
6160,欣技,33,0,33,群益金鼎-桃園,2024-02-27,9189
3455,由田,32,2,30,群益金鼎-桃園,2024-02-27,9189
2885,元大金,30,0,30,群益金鼎-桃園,2024-02-27,9189
2329,華泰,47,18,29,群益金鼎-桃園,2024-02-27,9189
00933B,國泰10Y+金融債,34,7,27,群益金鼎-桃園,2024-02-27,9189
6139,亞翔,39,12,27,群益金鼎-桃園,2024-02-27,9189
4938,和碩,27,1,26,群益金鼎-桃園,2024-02-27,9189
8926,台汽電,36,10,26,群益金鼎-桃園,2024-02-27,9189
00720B,元大投資級公司債,23,0,23,群益金鼎-桃園,2024-02-27,9189
3231,緯創,37,14,23,群益金鼎-桃園,2024-02-27,9189
3354,律勝,22,0,22,群益金鼎-桃園,2024-02-27,9189
00687B,國泰20年美債,22,0,22,群益金鼎-桃園,2024-02-27,9189
1528,恩德,22,1,21,群益金鼎-桃園,2024-02-27,9189
2417,圓剛,21,0,21,群益金鼎-桃園,2024-02-27,9189
6125,廣運,32,12,20,群益金鼎-桃園,2024-02-27,9189
2618,長榮航,25,5,20,群益金鼎-桃園,2024-02-27,9189
1701,中化,20,0,20,群益金鼎-桃園,2024-02-27,9189
2382,廣達,26,6,20,群益金鼎-桃園,2024-02-27,9189
2609,陽明,22,3,19,群益金鼎-桃園,2024-02-27,9189
2543,皇昌,21,3,18,群益金鼎-桃園,2024-02-27,9189
2301,光寶科,30,12,18,群益金鼎-桃園,2024-02-27,9189
1711,永光,116,98,18,群益金鼎-桃園,2024-02-27,9189
6218,豪勉,25,8,17,群益金鼎-桃園,2024-02-27,9189
8096,擎亞,24,7,17,群益金鼎-桃園,2024-02-27,9189
5426,振發,19,2,17,群益金鼎-桃園,2024-02-27,9189
8047,星雲,28,12,16,群益金鼎-桃園,2024-02-27,9189
2408,南亞科,32,16,16,群益金鼎-桃園,2024-02-27,9189
8086,宏捷科,21,6,15,群益金鼎-桃園,2024-02-27,9189
5438,東友,15,0,15,群益金鼎-桃園,2024-02-27,9189
2025,千興,15,0,15,群益金鼎-桃園,2024-02-27,9189
5381,合正,17,2,15,群益金鼎-桃園,2024-02-27,9189
2353,宏��,20,5,15,群益金鼎-桃園,2024-02-27,9189
2002,中鋼,15,1,14,群益金鼎-桃園,2024-02-27,9189
9945,潤泰新,13,0,13,群益金鼎-桃園,2024-02-27,9189
6126,信音,26,13,13,群益金鼎-桃園,2024-02-27,9189
4979,華星光,29,16,13,群益金鼎-桃園,2024-02-27,9189
1536,和大,20,8,12,群益金鼎-桃園,2024-02-27,9189
00937B,群益ESG投等債20,144,0,144,群益金鼎-桃園,2024-02-29,9189
00878,國泰永續高股息,135,17,118,群益金鼎-桃園,2024-02-29,9189
2491,吉祥全,100,0,100,群益金鼎-桃園,2024-02-29,9189
2405,輔信,87,5,82,群益金鼎-桃園,2024-02-29,9189
00665L,富邦�琤肭磪囓�2,80,0,80,群益金鼎-桃園,2024-02-29,9189
2353,宏��,49,0,49,群益金鼎-桃園,2024-02-29,9189
3231,緯創,47,12,35,群益金鼎-桃園,2024-02-29,9189
6901,鑽石投資,31,0,31,群益金鼎-桃園,2024-02-29,9189
4977,眾達-KY,31,1,30,群益金鼎-桃園,2024-02-29,9189
1569,濱川,30,1,29,群益金鼎-桃園,2024-02-29,9189
00919,群益台灣精選高息,67,38,29,群益金鼎-桃園,2024-02-29,9189
00632R,元大台灣50反1,85,59,26,群益金鼎-桃園,2024-02-29,9189
6160,欣技,26,0,26,群益金鼎-桃園,2024-02-29,9189
1528,恩德,21,0,21,群益金鼎-桃園,2024-02-29,9189
8936,國統,62,41,21,群益金鼎-桃園,2024-02-29,9189
3055,蔚華科,21,1,20,群益金鼎-桃園,2024-02-29,9189
4543,萬在,27,8,19,群益金鼎-桃園,2024-02-29,9189
8040,九暘,24,5,19,群益金鼎-桃園,2024-02-29,9189
00929,復華台灣科技優息,44,26,18,群益金鼎-桃園,2024-02-29,9189
2329,華泰,47,31,16,群益金鼎-桃園,2024-02-29,9189
2023,燁輝,16,0,16,群益金鼎-桃園,2024-02-29,9189
3390,旭軟,19,3,16,群益金鼎-桃園,2024-02-29,9189
2303,聯電,16,1,15,群益金鼎-桃園,2024-02-29,9189
6125,廣運,39,24,15,群益金鼎-桃園,2024-02-29,9189
1101,台泥,17,2,15,群益金鼎-桃園,2024-02-29,9189
00720B,元大投資級公司債,14,0,14,群益金鼎-桃園,2024-02-29,9189
1522,堤維西,90,76,14,群益金鼎-桃園,2024-02-29,9189
00933B,國泰10Y+金融債,27,13,14,群益金鼎-桃園,2024-02-29,9189
3481,群創,38,25,13,群益金鼎-桃園,2024-02-29,9189
3035,智原,15,2,13,群益金鼎-桃園,2024-02-29,9189
1524,耿鼎,15,2,13,群益金鼎-桃園,2024-02-29,9189
5452,佶優,20,7,13,群益金鼎-桃園,2024-02-29,9189
6683,雍智科技,13,0,13,群益金鼎-桃園,2024-02-29,9189
00712,復華富時不動產,14,2,12,群益金鼎-桃園,2024-02-29,9189
5388,中磊,12,0,12,群益金鼎-桃園,2024-02-29,9189
6122,擎邦,17,5,12,群益金鼎-桃園,2024-02-29,9189
1721,三晃,12,0,12,群益金鼎-桃園,2024-02-29,9189
00673R,期元大S＆P原油反1,11,0,11,群益金鼎-桃園,2024-02-29,9189
3044,健鼎,11,0,11,群益金鼎-桃園,2024-02-29,9189
2530,華建,11,0,11,群益金鼎-桃園,2024-02-29,9189
2049,上銀,12,1,11,群益金鼎-桃園,2024-02-29,9189
6113,亞矽,19,8,11,群益金鼎-桃園,2024-02-29,9189
3715,定穎投控,10,0,10,群益金鼎-桃園,2024-02-29,9189
8091,翔名,10,0,10,群益金鼎-桃園,2024-02-29,9189
4420,光明,10,0,10,群益金鼎-桃園,2024-02-29,9189
00687B,國泰20年美債,10,0,10,群益金鼎-桃園,2024-02-29,9189
8942,森鉅,10,0,10,群益金鼎-桃園,2024-02-29,9189
2352,佳世達,10,0,10,群益金鼎-桃園,2024-02-29,9189
3234,光環,10,0,10,群益金鼎-桃園,2024-02-29,9189
2312,金寶,10,0,10,群益金鼎-桃園,2024-02-29,9189
00919,群益台灣精選高息,212,19,193,群益金鼎-桃園,2024-03-01,9189
00918,大華優利高填息30,132,4,128,群益金鼎-桃園,2024-03-01,9189
00665L,富邦�琤肭磪囓�2,80,0,80,群益金鼎-桃園,2024-03-01,9189
2313,華通,89,9,80,群益金鼎-桃園,2024-03-01,9189
6160,欣技,52,0,52,群益金鼎-桃園,2024-03-01,9189
1316,上曜,114,74,40,群益金鼎-桃園,2024-03-01,9189
2891,中信金,39,0,39,群益金鼎-桃園,2024-03-01,9189
00632R,元大台灣50反1,38,0,38,群益金鼎-桃園,2024-03-01,9189
1342,八貫,36,0,36,群益金鼎-桃園,2024-03-01,9189
1618,合機,57,21,36,群益金鼎-桃園,2024-03-01,9189
1603,華電,37,2,35,群益金鼎-桃園,2024-03-01,9189
6127,九豪,32,2,30,群益金鼎-桃園,2024-03-01,9189
9945,潤泰新,33,3,30,群益金鼎-桃園,2024-03-01,9189
1609,大亞,57,29,28,群益金鼎-桃園,2024-03-01,9189
3038,全台,27,0,27,群益金鼎-桃園,2024-03-01,9189
2002,中鋼,26,0,26,群益金鼎-桃園,2024-03-01,9189
9105,泰金寶-DR,25,1,24,群益金鼎-桃園,2024-03-01,9189
00720B,元大投資級公司債,24,0,24,群益金鼎-桃園,2024-03-01,9189
00687B,國泰20年美債,23,0,23,群益金鼎-桃園,2024-03-01,9189
3188,鑫龍騰,20,0,20,群益金鼎-桃園,2024-03-01,9189
2530,華建,20,0,20,群益金鼎-桃園,2024-03-01,9189
00641R,富邦日本反1,20,0,20,群益金鼎-桃園,2024-03-01,9189
3390,旭軟,19,0,19,群益金鼎-桃園,2024-03-01,9189
2356,英業達,21,4,17,群益金鼎-桃園,2024-03-01,9189
1589,永冠-KY,23,6,17,群益金鼎-桃園,2024-03-01,9189
2303,聯電,24,8,16,群益金鼎-桃園,2024-03-01,9189
1522,堤維西,27,11,16,群益金鼎-桃園,2024-03-01,9189
2882,國泰金,15,0,15,群益金鼎-桃園,2024-03-01,9189
1102,亞泥,15,0,15,群益金鼎-桃園,2024-03-01,9189
00882,中信中國高股息,15,0,15,群益金鼎-桃園,2024-03-01,9189
1711,永光,22,8,14,群益金鼎-桃園,2024-03-01,9189
1314,中石化,14,0,14,群益金鼎-桃園,2024-03-01,9189
1809,中釉,12,0,12,群益金鼎-桃園,2024-03-01,9189
3294,英濟,12,0,12,群益金鼎-桃園,2024-03-01,9189
3071,協禧,13,1,12,群益金鼎-桃園,2024-03-01,9189
2610,華航,12,0,12,群益金鼎-桃園,2024-03-01,9189
00751B,元大AAA至A公司債,12,0,12,群益金鼎-桃園,2024-03-01,9189
00931B,統一美債20年,12,0,12,群益金鼎-桃園,2024-03-01,9189
6438,迅得,16,4,12,群益金鼎-桃園,2024-03-01,9189
5880,合庫金,11,0,11,群益金鼎-桃園,2024-03-01,9189
1101,台泥,16,5,11,群益金鼎-桃園,2024-03-01,9189
6732,昇佳電子,11,0,11,群益金鼎-桃園,2024-03-01,9189
2491,吉祥全,11,0,11,群益金鼎-桃園,2024-03-01,9189
4979,華星光,13,2,11,群益金鼎-桃園,2024-03-01,9189
6257,矽格,13,2,11,群益金鼎-桃園,2024-03-01,9189
2504,國產,10,0,10,群益金鼎-桃園,2024-03-01,9189
4433,興采,10,0,10,群益金鼎-桃園,2024-03-01,9189
2542,興富發,10,0,10,群益金鼎-桃園,2024-03-01,9189
3520,華盈,10,0,10,群益金鼎-桃園,2024-03-01,9189
2385,群光,10,0,10,群益金鼎-桃園,2024-03-01,9189
00687B,國泰20年美債,436,20,416,群益金鼎-桃園,2024-03-04,9189
00632R,元大台灣50反1,238,0,238,群益金鼎-桃園,2024-03-04,9189
00937B,群益ESG投等債20,199,0,199,群益金鼎-桃園,2024-03-04,9189
00673R,期元大S＆P原油反1,153,0,153,群益金鼎-桃園,2024-03-04,9189
00665L,富邦�琤肭磪囓�2,90,0,90,群益金鼎-桃園,2024-03-04,9189
00918,大華優利高填息30,80,5,75,群益金鼎-桃園,2024-03-04,9189
00688L,國泰20年美債正2,100,30,70,群益金鼎-桃園,2024-03-04,9189
2371,大同,91,34,57,群益金鼎-桃園,2024-03-04,9189
7402,邑錡,53,6,47,群益金鼎-桃園,2024-03-04,9189
2002,中鋼,43,0,43,群益金鼎-桃園,2024-03-04,9189
00915,凱基優選高股息30,46,4,42,群益金鼎-桃園,2024-03-04,9189
2206,三陽工業,46,8,38,群益金鼎-桃園,2024-03-04,9189
2066,世德,42,4,38,群益金鼎-桃園,2024-03-04,9189
1569,濱川,36,0,36,群益金鼎-桃園,2024-03-04,9189
3363,上詮,47,12,35,群益金鼎-桃園,2024-03-04,9189
4543,萬在,44,9,35,群益金鼎-桃園,2024-03-04,9189
00664R,國泰臺灣加權反1,31,0,31,群益金鼎-桃園,2024-03-04,9189
00679B,元大美債20年,30,0,30,群益金鼎-桃園,2024-03-04,9189
00919,群益台灣精選高息,115,85,30,群益金鼎-桃園,2024-03-04,9189
00637L,元大滬深300正2,25,0,25,群益金鼎-桃園,2024-03-04,9189
2312,金寶,25,0,25,群益金鼎-桃園,2024-03-04,9189
6806,森崴能源,42,18,24,群益金鼎-桃園,2024-03-04,9189
2903,遠百,21,0,21,群益金鼎-桃園,2024-03-04,9189
3005,神基,30,10,20,群益金鼎-桃園,2024-03-04,9189
1514,亞力,52,32,20,群益金鼎-桃園,2024-03-04,9189
1527,鑽全,22,2,20,群益金鼎-桃園,2024-03-04,9189
3356,奇偶,33,13,20,群益金鼎-桃園,2024-03-04,9189
8059,凱碩,20,1,19,群益金鼎-桃園,2024-03-04,9189
9933,中鼎,20,1,19,群益金鼎-桃園,2024-03-04,9189
2888,新光金,19,0,19,群益金鼎-桃園,2024-03-04,9189
5272,笙科,20,1,19,群益金鼎-桃園,2024-03-04,9189
1522,堤維西,28,10,18,群益金鼎-桃園,2024-03-04,9189
1609,大亞,18,0,18,群益金鼎-桃園,2024-03-04,9189
2014,中鴻,23,6,17,群益金鼎-桃園,2024-03-04,9189
6292,迅德,17,0,17,群益金鼎-桃園,2024-03-04,9189
3346,麗清,17,0,17,群益金鼎-桃園,2024-03-04,9189
2609,陽明,23,7,16,群益金鼎-桃園,2024-03-04,9189
1618,合機,17,1,16,群益金鼎-桃園,2024-03-04,9189
1809,中釉,17,1,16,群益金鼎-桃園,2024-03-04,9189
6695,芯鼎,16,1,15,群益金鼎-桃園,2024-03-04,9189
4968,立積,15,0,15,群益金鼎-桃園,2024-03-04,9189
5009,榮剛,14,0,14,群益金鼎-桃園,2024-03-04,9189
00720B,元大投資級公司債,14,0,14,群益金鼎-桃園,2024-03-04,9189
00934,中信成長高股息,14,0,14,群益金鼎-桃園,2024-03-04,9189
6282,康舒,20,7,13,群益金鼎-桃園,2024-03-04,9189
5381,合正,12,0,12,群益金鼎-桃園,2024-03-04,9189
00641R,富邦日本反1,12,0,12,群益金鼎-桃園,2024-03-04,9189
5328,華容,14,3,11,群益金鼎-桃園,2024-03-04,9189
6139,亞翔,24,13,11,群益金鼎-桃園,2024-03-04,9189
6113,亞矽,11,0,11,群益金鼎-桃園,2024-03-04,9189
00687B,國泰20年美債,421,23,398,群益金鼎-桃園,2024-03-05,9189
00706L,期元大S＆P日圓正2,180,0,180,群益金鼎-桃園,2024-03-05,9189
00919,群益台灣精選高息,184,40,144,群益金鼎-桃園,2024-03-05,9189
2371,大同,137,22,115,群益金鼎-桃園,2024-03-05,9189
2891,中信金,105,4,101,群益金鼎-桃園,2024-03-05,9189
8926,台汽電,102,1,101,群益金鼎-桃園,2024-03-05,9189
00664R,國泰臺灣加權反1,92,0,92,群益金鼎-桃園,2024-03-05,9189
00632R,元大台灣50反1,70,0,70,群益金鼎-桃園,2024-03-05,9189
00937B,群益ESG投等債20,64,0,64,群益金鼎-桃園,2024-03-05,9189
00665L,富邦�琤肭磪囓�2,60,0,60,群益金鼎-桃園,2024-03-05,9189
2367,燿華,170,117,53,群益金鼎-桃園,2024-03-05,9189
4906,正文,86,36,50,群益金鼎-桃園,2024-03-05,9189
2888,新光金,44,3,41,群益金鼎-桃園,2024-03-05,9189
3372,典範,63,26,37,群益金鼎-桃園,2024-03-05,9189
5880,合庫金,33,0,33,群益金鼎-桃園,2024-03-05,9189
8064,東捷,41,9,32,群益金鼎-桃園,2024-03-05,9189
2408,南亞科,31,1,30,群益金鼎-桃園,2024-03-05,9189
1905,華紙,37,9,28,群益金鼎-桃園,2024-03-05,9189
1524,耿鼎,29,2,27,群益金鼎-桃園,2024-03-05,9189
4420,光明,25,0,25,群益金鼎-桃園,2024-03-05,9189
00915,凱基優選高股息30,32,8,24,群益金鼎-桃園,2024-03-05,9189
00918,大華優利高填息30,30,6,24,群益金鼎-桃園,2024-03-05,9189
2303,聯電,23,0,23,群益金鼎-桃園,2024-03-05,9189
2892,第一金,23,0,23,群益金鼎-桃園,2024-03-05,9189
00642U,期元大S＆P石油,23,0,23,群益金鼎-桃園,2024-03-05,9189
3060,銘異,23,0,23,群益金鼎-桃園,2024-03-05,9189
6271,同欣電,22,0,22,群益金鼎-桃園,2024-03-05,9189
00712,復華富時不動產,22,1,21,群益金鼎-桃園,2024-03-05,9189
6770,力積電,37,16,21,群益金鼎-桃園,2024-03-05,9189
00753L,中信中國50正2,20,0,20,群益金鼎-桃園,2024-03-05,9189
6275,元山,74,54,20,群益金鼎-桃園,2024-03-05,9189
6241,易通展,20,0,20,群益金鼎-桃園,2024-03-05,9189
1303,南亞,19,0,19,群益金鼎-桃園,2024-03-05,9189
00679B,元大美債20年,28,10,18,群益金鼎-桃園,2024-03-05,9189
3711,日月光投控,25,8,17,群益金鼎-桃園,2024-03-05,9189
3543,州巧,17,0,17,群益金鼎-桃園,2024-03-05,9189
2405,輔信,27,11,16,群益金鼎-桃園,2024-03-05,9189
6125,廣運,20,4,16,群益金鼎-桃園,2024-03-05,9189
1326,台化,15,0,15,群益金鼎-桃園,2024-03-05,9189
2887,台新金,14,0,14,群益金鼎-桃園,2024-03-05,9189
3006,晶豪科,19,6,13,群益金鼎-桃園,2024-03-05,9189
1504,東元,16,3,13,群益金鼎-桃園,2024-03-05,9189
2002,中鋼,26,14,12,群益金鼎-桃園,2024-03-05,9189
3217,優群,13,1,12,群益金鼎-桃園,2024-03-05,9189
00934,中信成長高股息,13,1,12,群益金鼎-桃園,2024-03-05,9189
2419,仲琦,24,13,11,群益金鼎-桃園,2024-03-05,9189
2355,敬鵬,12,1,11,群益金鼎-桃園,2024-03-05,9189
6111,大宇資,11,0,11,群益金鼎-桃園,2024-03-05,9189
6806,森崴能源,33,22,11,群益金鼎-桃園,2024-03-05,9189
2104,國際中橡,10,0,10,群益金鼎-桃園,2024-03-05,9189
00918,大華優利高填息30,149,0,149,群益金鼎-桃園,2024-03-06,9189
00937B,群益ESG投等債20,178,35,143,群益金鼎-桃園,2024-03-06,9189
00915,凱基優選高股息30,76,0,76,群益金鼎-桃園,2024-03-06,9189
1609,大亞,150,76,74,群益金鼎-桃園,2024-03-06,9189
2515,中工,66,6,60,群益金鼎-桃園,2024-03-06,9189
3481,群創,73,16,57,群益金鼎-桃園,2024-03-06,9189
6152,百一,55,0,55,群益金鼎-桃園,2024-03-06,9189
6163,華電網,59,8,51,群益金鼎-桃園,2024-03-06,9189
3325,旭品,93,43,50,群益金鼎-桃園,2024-03-06,9189
2634,漢翔,49,4,45,群益金鼎-桃園,2024-03-06,9189
00706L,期元大S＆P日圓正2,45,0,45,群益金鼎-桃園,2024-03-06,9189
6275,元山,65,34,31,群益金鼎-桃園,2024-03-06,9189
4938,和碩,28,0,28,群益金鼎-桃園,2024-03-06,9189
3339,泰谷,29,2,27,群益金鼎-桃園,2024-03-06,9189
5388,中磊,27,1,26,群益金鼎-桃園,2024-03-06,9189
3540,曜越,30,4,26,群益金鼎-桃園,2024-03-06,9189
3050,鈺德,25,0,25,群益金鼎-桃園,2024-03-06,9189
8011,台通,37,12,25,群益金鼎-桃園,2024-03-06,9189
2329,華泰,32,9,23,群益金鼎-桃園,2024-03-06,9189
2610,華航,33,10,23,群益金鼎-桃園,2024-03-06,9189
2365,昆盈,24,2,22,群益金鼎-桃園,2024-03-06,9189
2618,長榮航,22,1,21,群益金鼎-桃園,2024-03-06,9189
3356,奇偶,24,3,21,群益金鼎-桃園,2024-03-06,9189
6233,旺玖,24,4,20,群益金鼎-桃園,2024-03-06,9189
1471,首利,38,18,20,群益金鼎-桃園,2024-03-06,9189
2377,微星,19,0,19,群益金鼎-桃園,2024-03-06,9189
6113,亞矽,20,1,19,群益金鼎-桃園,2024-03-06,9189
2409,友達,22,5,17,群益金鼎-桃園,2024-03-06,9189
5381,合正,17,1,16,群益金鼎-桃園,2024-03-06,9189
1314,中石化,16,0,16,群益金鼎-桃園,2024-03-06,9189
2352,佳世達,25,9,16,群益金鼎-桃園,2024-03-06,9189
2498,宏達電,15,0,15,群益金鼎-桃園,2024-03-06,9189
3231,緯創,37,23,14,群益金鼎-桃園,2024-03-06,9189
9105,泰金寶-DR,20,6,14,群益金鼎-桃園,2024-03-06,9189
6282,康舒,20,6,14,群益金鼎-桃園,2024-03-06,9189
6189,豐藝,16,2,14,群益金鼎-桃園,2024-03-06,9189
4906,正文,24,10,14,群益金鼎-桃園,2024-03-06,9189
4433,興采,13,0,13,群益金鼎-桃園,2024-03-06,9189
8039,台虹,13,0,13,群益金鼎-桃園,2024-03-06,9189
00923,群益台ESG低碳50,13,0,13,群益金鼎-桃園,2024-03-06,9189
1514,亞力,31,18,13,群益金鼎-桃園,2024-03-06,9189
2605,新興,13,1,12,群益金鼎-桃園,2024-03-06,9189
2324,仁寶,22,10,12,群益金鼎-桃園,2024-03-06,9189
8358,金居,12,0,12,群益金鼎-桃園,2024-03-06,9189
00687B,國泰20年美債,43,31,12,群益金鼎-桃園,2024-03-06,9189
2408,南亞科,13,2,11,群益金鼎-桃園,2024-03-06,9189
2809,京城銀,11,0,11,群益金鼎-桃園,2024-03-06,9189
1731,美吾華,13,2,11,群益金鼎-桃園,2024-03-06,9189
6284,佳邦,13,2,11,群益金鼎-桃園,2024-03-06,9189
00696B,富邦美債20年,21,10,11,群益金鼎-桃園,2024-03-06,9189
00937B,群益ESG投等債20,539,33,506,群益金鼎-桃園,2024-03-07,9189
3481,群創,463,6,457,群益金鼎-桃園,2024-03-07,9189
00632R,元大台灣50反1,201,21,180,群益金鼎-桃園,2024-03-07,9189
2801,彰銀,157,0,157,群益金鼎-桃園,2024-03-07,9189
2834,臺企銀,126,21,105,群益金鼎-桃園,2024-03-07,9189
2882,國泰金,101,12,89,群益金鼎-桃園,2024-03-07,9189
00664R,國泰臺灣加權反1,83,0,83,群益金鼎-桃園,2024-03-07,9189
7402,邑錡,69,10,59,群益金鼎-桃園,2024-03-07,9189
6217,中探針,54,4,50,群益金鼎-桃園,2024-03-07,9189
2542,興富發,50,1,49,群益金鼎-桃園,2024-03-07,9189
3540,曜越,60,11,49,群益金鼎-桃園,2024-03-07,9189
2324,仁寶,45,5,40,群益金鼎-桃園,2024-03-07,9189
00706L,期元大S＆P日圓正2,40,0,40,群益金鼎-桃園,2024-03-07,9189
8092,建暐,40,2,38,群益金鼎-桃園,2024-03-07,9189
6116,彩晶,35,0,35,群益金鼎-桃園,2024-03-07,9189
9945,潤泰新,31,0,31,群益金鼎-桃園,2024-03-07,9189
5907,大洋-KY,30,0,30,群益金鼎-桃園,2024-03-07,9189
8112,至上,54,26,28,群益金鼎-桃園,2024-03-07,9189
2367,燿華,136,108,28,群益金鼎-桃園,2024-03-07,9189
6239,力成,31,3,28,群益金鼎-桃園,2024-03-07,9189
5452,佶優,33,7,26,群益金鼎-桃園,2024-03-07,9189
6275,元山,85,59,26,群益金鼎-桃園,2024-03-07,9189
6274,台燿,41,15,26,群益金鼎-桃園,2024-03-07,9189
2368,金像電,34,9,25,群益金鼎-桃園,2024-03-07,9189
6125,廣運,45,21,24,群益金鼎-桃園,2024-03-07,9189
1513,中興電,27,3,24,群益金鼎-桃園,2024-03-07,9189
6591,動力-KY,31,7,24,群益金鼎-桃園,2024-03-07,9189
2603,長榮,43,20,23,群益金鼎-桃園,2024-03-07,9189
2002,中鋼,22,0,22,群益金鼎-桃園,2024-03-07,9189
6139,亞翔,30,8,22,群益金鼎-桃園,2024-03-07,9189
8110,華東,38,16,22,群益金鼎-桃園,2024-03-07,9189
00687B,國泰20年美債,49,28,21,群益金鼎-桃園,2024-03-07,9189
2409,友達,25,5,20,群益金鼎-桃園,2024-03-07,9189
5521,工信,40,20,20,群益金鼎-桃園,2024-03-07,9189
8131,福懋科,20,0,20,群益金鼎-桃園,2024-03-07,9189
4420,光明,20,0,20,群益金鼎-桃園,2024-03-07,9189
00665L,富邦�琤肭磪囓�2,70,50,20,群益金鼎-桃園,2024-03-07,9189
5469,瀚宇博,20,0,20,群益金鼎-桃園,2024-03-07,9189
2352,佳世達,29,9,20,群益金鼎-桃園,2024-03-07,9189
3264,欣銓,25,5,20,群益金鼎-桃園,2024-03-07,9189
1527,鑽全,22,3,19,群益金鼎-桃園,2024-03-07,9189
6156,松上,18,0,18,群益金鼎-桃園,2024-03-07,9189
2405,輔信,18,0,18,群益金鼎-桃園,2024-03-07,9189
1802,台玻,17,0,17,群益金鼎-桃園,2024-03-07,9189
8034,榮群,21,5,16,群益金鼎-桃園,2024-03-07,9189
6584,南俊國際,17,1,16,群益金鼎-桃園,2024-03-07,9189
2401,凌陽,18,2,16,群益金鼎-桃園,2024-03-07,9189
3051,力特,17,2,15,群益金鼎-桃園,2024-03-07,9189
2355,敬鵬,21,6,15,群益金鼎-桃園,2024-03-07,9189
6213,聯茂,24,10,14,群益金鼎-桃園,2024-03-07,9189
00937B,群益ESG投等債20,214,39,175,群益金鼎-桃園,2024-03-08,9189
1722,台肥,100,0,100,群益金鼎-桃園,2024-03-08,9189
2324,仁寶,93,4,89,群益金鼎-桃園,2024-03-08,9189
6282,康舒,87,5,82,群益金鼎-桃園,2024-03-08,9189
00664R,國泰臺灣加權反1,77,0,77,群益金鼎-桃園,2024-03-08,9189
00632R,元大台灣50反1,490,414,76,群益金鼎-桃園,2024-03-08,9189
2367,燿華,94,20,74,群益金鼎-桃園,2024-03-08,9189
2352,佳世達,77,4,73,群益金鼎-桃園,2024-03-08,9189
5469,瀚宇博,65,1,64,群益金鼎-桃園,2024-03-08,9189
00919,群益台灣精選高息,190,132,58,群益金鼎-桃園,2024-03-08,9189
7402,邑錡,66,8,58,群益金鼎-桃園,2024-03-08,9189
2031,新光鋼,57,0,57,群益金鼎-桃園,2024-03-08,9189
6217,中探針,60,4,56,群益金鼎-桃園,2024-03-08,9189
00680L,元大美債20正2,52,0,52,群益金鼎-桃園,2024-03-08,9189
3532,台勝科,51,1,50,群益金鼎-桃園,2024-03-08,9189
00915,凱基優選高股息30,83,38,45,群益金鼎-桃園,2024-03-08,9189
8069,元太,47,3,44,群益金鼎-桃園,2024-03-08,9189
2883,凱基金,65,22,43,群益金鼎-桃園,2024-03-08,9189
6005,群益證,50,8,42,群益金鼎-桃園,2024-03-08,9189
2371,大同,54,12,42,群益金鼎-桃園,2024-03-08,9189
9105,泰金寶-DR,40,0,40,群益金鼎-桃園,2024-03-08,9189
3711,日月光投控,76,38,38,群益金鼎-桃園,2024-03-08,9189
2358,廷鑫,43,5,38,群益金鼎-桃園,2024-03-08,9189
2809,京城銀,32,2,30,群益金鼎-桃園,2024-03-08,9189
6016,康和證,40,10,30,群益金鼎-桃園,2024-03-08,9189
00918,大華優利高填息30,59,31,28,群益金鼎-桃園,2024-03-08,9189
2888,新光金,30,2,28,群益金鼎-桃園,2024-03-08,9189
2313,華通,37,12,25,群益金鼎-桃園,2024-03-08,9189
00706L,期元大S＆P日圓正2,25,0,25,群益金鼎-桃園,2024-03-08,9189
6770,力積電,28,4,24,群益金鼎-桃園,2024-03-08,9189
1409,新纖,25,2,23,群益金鼎-桃園,2024-03-08,9189
00679B,元大美債20年,24,2,22,群益金鼎-桃園,2024-03-08,9189
2365,昆盈,43,21,22,群益金鼎-桃園,2024-03-08,9189
8092,建暐,22,0,22,群益金鼎-桃園,2024-03-08,9189
9925,新保,21,0,21,群益金鼎-桃園,2024-03-08,9189
5521,工信,23,2,21,群益金鼎-桃園,2024-03-08,9189
2376,技嘉,32,12,20,群益金鼎-桃園,2024-03-08,9189
8215,明基材,20,0,20,群益金鼎-桃園,2024-03-08,9189
00927,群益半導體收益,23,4,19,群益金鼎-桃園,2024-03-08,9189
3051,力特,20,1,19,群益金鼎-桃園,2024-03-08,9189
1301,台塑,26,7,19,群益金鼎-桃園,2024-03-08,9189
3543,州巧,18,0,18,群益金鼎-桃園,2024-03-08,9189
6538,倉和,18,0,18,群益金鼎-桃園,2024-03-08,9189
2845,遠東銀,18,0,18,群益金鼎-桃園,2024-03-08,9189
4927,泰鼎-KY,17,0,17,群益金鼎-桃園,2024-03-08,9189
5328,華容,17,0,17,群益金鼎-桃園,2024-03-08,9189
3564,其陽,18,1,17,群益金鼎-桃園,2024-03-08,9189
6122,擎邦,21,5,16,群益金鼎-桃園,2024-03-08,9189
2634,漢翔,17,1,16,群益金鼎-桃園,2024-03-08,9189
1455,集盛,22,6,16,群益金鼎-桃園,2024-03-08,9189
00937B,群益ESG投等債20,215,57,158,群益金鼎-桃園,2024-03-11,9189
00929,復華台灣科技優息,68,10,58,群益金鼎-桃園,2024-03-11,9189
00915,凱基優選高股息30,56,1,55,群益金鼎-桃園,2024-03-11,9189
2312,金寶,55,0,55,群益金鼎-桃園,2024-03-11,9189
5469,瀚宇博,46,0,46,群益金鼎-桃園,2024-03-11,9189
8096,擎亞,57,13,44,群益金鼎-桃園,2024-03-11,9189
6197,佳必琪,53,12,41,群益金鼎-桃園,2024-03-11,9189
5386,青雲,43,3,40,群益金鼎-桃園,2024-03-11,9189
0056,元大高股息,52,13,39,群益金鼎-桃園,2024-03-11,9189
00687B,國泰20年美債,39,0,39,群益金鼎-桃園,2024-03-11,9189
2329,華泰,54,19,35,群益金鼎-桃園,2024-03-11,9189
2610,華航,34,0,34,群益金鼎-桃園,2024-03-11,9189
00715L,期街口布蘭特正2,32,0,32,群益金鼎-桃園,2024-03-11,9189
2340,台亞,31,0,31,群益金鼎-桃園,2024-03-11,9189
5880,合庫金,31,0,31,群益金鼎-桃園,2024-03-11,9189
2882,國泰金,57,27,30,群益金鼎-桃園,2024-03-11,9189
00878,國泰永續高股息,53,25,28,群益金鼎-桃園,2024-03-11,9189
2330,台積電,31,4,27,群益金鼎-桃園,2024-03-11,9189
1815,富喬,40,14,26,群益金鼎-桃園,2024-03-11,9189
2371,大同,27,2,25,群益金鼎-桃園,2024-03-11,9189
00706L,期元大S＆P日圓正2,23,0,23,群益金鼎-桃園,2024-03-11,9189
2801,彰銀,23,0,23,群益金鼎-桃園,2024-03-11,9189
8092,建暐,22,0,22,群益金鼎-桃園,2024-03-11,9189
3050,鈺德,30,8,22,群益金鼎-桃園,2024-03-11,9189
4906,正文,21,0,21,群益金鼎-桃園,2024-03-11,9189
6126,信音,22,1,21,群益金鼎-桃園,2024-03-11,9189
8936,國統,30,10,20,群益金鼎-桃園,2024-03-11,9189
5907,大洋-KY,20,0,20,群益金鼎-桃園,2024-03-11,9189
2367,燿華,32,13,19,群益金鼎-桃園,2024-03-11,9189
3622,洋華,19,1,18,群益金鼎-桃園,2024-03-11,9189
00918,大華優利高填息30,18,1,17,群益金鼎-桃園,2024-03-11,9189
1316,上曜,149,132,17,群益金鼎-桃園,2024-03-11,9189
2812,台中銀,17,0,17,群益金鼎-桃園,2024-03-11,9189
2809,京城銀,17,0,17,群益金鼎-桃園,2024-03-11,9189
00933B,國泰10Y+金融債,17,0,17,群益金鼎-桃園,2024-03-11,9189
00934,中信成長高股息,16,0,16,群益金鼎-桃園,2024-03-11,9189
3044,健鼎,18,3,15,群益金鼎-桃園,2024-03-11,9189
5347,世界,14,0,14,群益金鼎-桃園,2024-03-11,9189
3707,漢磊,90,76,14,群益金鼎-桃園,2024-03-11,9189
2308,台達電,26,12,14,群益金鼎-桃園,2024-03-11,9189
2356,英業達,29,15,14,群益金鼎-桃園,2024-03-11,9189
2352,佳世達,20,7,13,群益金鼎-桃園,2024-03-11,9189
00892,富邦台灣半導體,12,0,12,群益金鼎-桃園,2024-03-11,9189
2417,圓剛,20,9,11,群益金鼎-桃園,2024-03-11,9189
2836,高雄銀,21,10,11,群益金鼎-桃園,2024-03-11,9189
5536,聖暉*,11,0,11,群益金鼎-桃園,2024-03-11,9189
5443,均豪,11,0,11,群益金鼎-桃園,2024-03-11,9189
00882,中信中國高股息,11,0,11,群益金鼎-桃園,2024-03-11,9189
1101,台泥,13,3,10,群益金鼎-桃園,2024-03-11,9189
6742,澤米,10,0,10,群益金鼎-桃園,2024-03-11,9189
2371,大同,138,11,127,群益金鼎-桃園,2024-03-12,9189
2888,新光金,103,0,103,群益金鼎-桃園,2024-03-12,9189
00706L,期元大S＆P日圓正2,75,3,72,群益金鼎-桃園,2024-03-12,9189
00937B,群益ESG投等債20,89,18,71,群益金鼎-桃園,2024-03-12,9189
00687B,國泰20年美債,61,1,60,群益金鼎-桃園,2024-03-12,9189
2801,彰銀,62,10,52,群益金鼎-桃園,2024-03-12,9189
2352,佳世達,54,5,49,群益金鼎-桃園,2024-03-12,9189
2367,燿華,144,100,44,群益金鼎-桃園,2024-03-12,9189
00881,國泰台灣5G+,61,17,44,群益金鼎-桃園,2024-03-12,9189
7402,邑錡,43,1,42,群益金鼎-桃園,2024-03-12,9189
8112,至上,35,5,30,群益金鼎-桃園,2024-03-12,9189
00918,大華優利高填息30,33,4,29,群益金鼎-桃園,2024-03-12,9189
00929,復華台灣科技優息,59,31,28,群益金鼎-桃園,2024-03-12,9189
6282,康舒,28,1,27,群益金鼎-桃園,2024-03-12,9189
6213,聯茂,23,0,23,群益金鼎-桃園,2024-03-12,9189
00632R,元大台灣50反1,160,138,22,群益金鼎-桃園,2024-03-12,9189
5483,中美晶,22,0,22,群益金鼎-桃園,2024-03-12,9189
2383,台光電,31,11,20,群益金鼎-桃園,2024-03-12,9189
1540,喬福,20,0,20,群益金鼎-桃園,2024-03-12,9189
2340,台亞,20,0,20,群益金鼎-桃園,2024-03-12,9189
00753L,中信中國50正2,30,10,20,群益金鼎-桃園,2024-03-12,9189
2543,皇昌,53,34,19,群益金鼎-桃園,2024-03-12,9189
3325,旭品,23,5,18,群益金鼎-桃園,2024-03-12,9189
1618,合機,23,6,17,群益金鼎-桃園,2024-03-12,9189
4906,正文,21,4,17,群益金鼎-桃園,2024-03-12,9189
8926,台汽電,18,1,17,群益金鼎-桃園,2024-03-12,9189
5351,鈺創,17,1,16,群益金鼎-桃園,2024-03-12,9189
00857B,永豐20年美公債,17,2,15,群益金鼎-桃園,2024-03-12,9189
1514,亞力,67,52,15,群益金鼎-桃園,2024-03-12,9189
1582,信錦,35,20,15,群益金鼎-桃園,2024-03-12,9189
2204,中華,16,1,15,群益金鼎-桃園,2024-03-12,9189
2344,華邦電,15,0,15,群益金鼎-桃園,2024-03-12,9189
2301,光寶科,14,1,13,群益金鼎-桃園,2024-03-12,9189
1528,恩德,13,0,13,群益金鼎-桃園,2024-03-12,9189
4714,永捷,22,9,13,群益金鼎-桃園,2024-03-12,9189
9945,潤泰新,12,0,12,群益金鼎-桃園,2024-03-12,9189
6616,特昇-KY,11,0,11,群益金鼎-桃園,2024-03-12,9189
5272,笙科,19,8,11,群益金鼎-桃園,2024-03-12,9189
2605,新興,11,0,11,群益金鼎-桃園,2024-03-12,9189
5880,合庫金,11,0,11,群益金鼎-桃園,2024-03-12,9189
2376,技嘉,15,5,10,群益金鼎-桃園,2024-03-12,9189
1904,正隆,10,0,10,群益金鼎-桃園,2024-03-12,9189
00636,國泰中國A50,10,0,10,群益金鼎-桃園,2024-03-12,9189
6683,雍智科技,10,0,10,群益金鼎-桃園,2024-03-12,9189
4129,聯合,11,1,10,群益金鼎-桃園,2024-03-12,9189
911868,同方友友-DR,10,0,10,群益金鼎-桃園,2024-03-12,9189
00645,富邦日本,10,0,10,群益金鼎-桃園,2024-03-12,9189
8261,富鼎,10,0,10,群益金鼎-桃園,2024-03-12,9189
2368,金像電,18,9,9,群益金鼎-桃園,2024-03-12,9189
3081,聯亞,10,1,9,群益金鼎-桃園,2024-03-12,9189
00937B,群益ESG投等債20,212,13,199,群益金鼎-桃園,2024-03-13,9189
00687B,國泰20年美債,204,28,176,群益金鼎-桃園,2024-03-13,9189
2409,友達,120,9,111,群益金鼎-桃園,2024-03-13,9189
00918,大華優利高填息30,109,16,93,群益金鼎-桃園,2024-03-13,9189
2882,國泰金,100,7,93,群益金鼎-桃園,2024-03-13,9189
3231,緯創,110,24,86,群益金鼎-桃園,2024-03-13,9189
2610,華航,82,7,75,群益金鼎-桃園,2024-03-13,9189
1608,華榮,88,13,75,群益金鼎-桃園,2024-03-13,9189
9902,台火,188,119,69,群益金鼎-桃園,2024-03-13,9189
8064,東捷,64,0,64,群益金鼎-桃園,2024-03-13,9189
00665L,富邦�琤肭磪囓�2,60,0,60,群益金鼎-桃園,2024-03-13,9189
00915,凱基優選高股息30,78,19,59,群益金鼎-桃園,2024-03-13,9189
00878,國泰永續高股息,62,20,42,群益金鼎-桃園,2024-03-13,9189
8926,台汽電,70,29,41,群益金鼎-桃園,2024-03-13,9189
00881,國泰台灣5G+,41,1,40,群益金鼎-桃園,2024-03-13,9189
0056,元大高股息,50,11,39,群益金鼎-桃園,2024-03-13,9189
1589,永冠-KY,38,0,38,群益金鼎-桃園,2024-03-13,9189
00679B,元大美債20年,36,1,35,群益金鼎-桃園,2024-03-13,9189
2845,遠東銀,31,0,31,群益金鼎-桃園,2024-03-13,9189
00673R,期元大S＆P原油反1,30,0,30,群益金鼎-桃園,2024-03-13,9189
2408,南亞科,29,0,29,群益金鼎-桃園,2024-03-13,9189
1316,上曜,42,14,28,群益金鼎-桃園,2024-03-13,9189
1582,信錦,33,5,28,群益金鼎-桃園,2024-03-13,9189
3715,定穎投控,28,1,27,群益金鼎-桃園,2024-03-13,9189
00933B,國泰10Y+金融債,36,10,26,群益金鼎-桃園,2024-03-13,9189
4543,萬在,27,1,26,群益金鼎-桃園,2024-03-13,9189
6116,彩晶,25,0,25,群益金鼎-桃園,2024-03-13,9189
2376,技嘉,31,6,25,群益金鼎-桃園,2024-03-13,9189
5490,同亨,25,1,24,群益金鼎-桃園,2024-03-13,9189
4420,光明,57,36,21,群益金鼎-桃園,2024-03-13,9189
6206,飛捷,21,0,21,群益金鼎-桃園,2024-03-13,9189
3013,晟銘電,23,2,21,群益金鼎-桃園,2024-03-13,9189
2002,中鋼,29,9,20,群益金鼎-桃園,2024-03-13,9189
1101,台泥,28,8,20,群益金鼎-桃園,2024-03-13,9189
1540,喬福,20,0,20,群益金鼎-桃園,2024-03-13,9189
1809,中釉,22,3,19,群益金鼎-桃園,2024-03-13,9189
9945,潤泰新,20,1,19,群益金鼎-桃園,2024-03-13,9189
2324,仁寶,21,3,18,群益金鼎-桃園,2024-03-13,9189
3105,穩懋,20,2,18,群益金鼎-桃園,2024-03-13,9189
2421,建準,21,3,18,群益金鼎-桃園,2024-03-13,9189
00680L,元大美債20正2,18,0,18,群益金鼎-桃園,2024-03-13,9189
2809,京城銀,25,7,18,群益金鼎-桃園,2024-03-13,9189
00720B,元大投資級公司債,17,0,17,群益金鼎-桃園,2024-03-13,9189
3707,漢磊,20,3,17,群益金鼎-桃園,2024-03-13,9189
00713,元大台灣高息低波,21,4,17,群益金鼎-桃園,2024-03-13,9189
6125,廣運,25,9,16,群益金鼎-桃園,2024-03-13,9189
3234,光環,17,2,15,群益金鼎-桃園,2024-03-13,9189
3706,神達,18,4,14,群益金鼎-桃園,2024-03-13,9189
5243,乙盛-KY,21,7,14,群益金鼎-桃園,2024-03-13,9189
3540,曜越,20,6,14,群益金鼎-桃園,2024-03-13,9189
2887,台新金,535,60,475,群益金鼎-桃園,2024-03-14,9189
00919,群益台灣精選高息,425,189,236,群益金鼎-桃園,2024-03-14,9189
2897,王道銀行,200,0,200,群益金鼎-桃園,2024-03-14,9189
2618,長榮航,178,26,152,群益金鼎-桃園,2024-03-14,9189
00929,復華台灣科技優息,245,130,115,群益金鼎-桃園,2024-03-14,9189
00937B,群益ESG投等債20,101,7,94,群益金鼎-桃園,2024-03-14,9189
00687B,國泰20年美債,91,0,91,群益金鼎-桃園,2024-03-14,9189
00680L,元大美債20正2,105,15,90,群益金鼎-桃園,2024-03-14,9189
00679B,元大美債20年,83,1,82,群益金鼎-桃園,2024-03-14,9189
2009,第一銅,66,5,61,群益金鼎-桃園,2024-03-14,9189
2313,華通,56,3,53,群益金鼎-桃園,2024-03-14,9189
00665L,富邦�琤肭磪囓�2,70,20,50,群益金鼎-桃園,2024-03-14,9189
6005,群益證,45,2,43,群益金鼎-桃園,2024-03-14,9189
2884,玉山金,51,9,42,群益金鼎-桃園,2024-03-14,9189
3163,波若威,49,7,42,群益金鼎-桃園,2024-03-14,9189
2883,凱基金,69,28,41,群益金鼎-桃園,2024-03-14,9189
6160,欣技,37,0,37,群益金鼎-桃園,2024-03-14,9189
00918,大華優利高填息30,63,26,37,群益金鼎-桃園,2024-03-14,9189
2809,京城銀,35,0,35,群益金鼎-桃園,2024-03-14,9189
9945,潤泰新,46,16,30,群益金鼎-桃園,2024-03-14,9189
3051,力特,30,0,30,群益金鼎-桃園,2024-03-14,9189
8926,台汽電,28,1,27,群益金鼎-桃園,2024-03-14,9189
5381,合正,26,0,26,群益金鼎-桃園,2024-03-14,9189
2603,長榮,34,8,26,群益金鼎-桃園,2024-03-14,9189
6026,福邦證,38,13,25,群益金鼎-桃園,2024-03-14,9189
3231,緯創,36,11,25,群益金鼎-桃園,2024-03-14,9189
2025,千興,23,0,23,群益金鼎-桃園,2024-03-14,9189
1616,億泰,81,58,23,群益金鼎-桃園,2024-03-14,9189
00673R,期元大S＆P原油反1,22,0,22,群益金鼎-桃園,2024-03-14,9189
2915,潤泰全,26,6,20,群益金鼎-桃園,2024-03-14,9189
2352,佳世達,23,3,20,群益金鼎-桃園,2024-03-14,9189
2838,聯邦銀,20,0,20,群益金鼎-桃園,2024-03-14,9189
5907,大洋-KY,20,0,20,群益金鼎-桃園,2024-03-14,9189
00896,中信綠能及電動車,20,0,20,群益金鼎-桃園,2024-03-14,9189
2308,台達電,21,3,18,群益金鼎-桃園,2024-03-14,9189
6194,育富,18,0,18,群益金鼎-桃園,2024-03-14,9189
00720B,元大投資級公司債,17,0,17,群益金鼎-桃園,2024-03-14,9189
3622,洋華,17,0,17,群益金鼎-桃園,2024-03-14,9189
2354,鴻準,21,4,17,群益金鼎-桃園,2024-03-14,9189
4938,和碩,16,1,15,群益金鼎-桃園,2024-03-14,9189
3402,漢科,15,0,15,群益金鼎-桃園,2024-03-14,9189
2382,廣達,24,9,15,群益金鼎-桃園,2024-03-14,9189
00931B,統一美債20年,14,0,14,群益金鼎-桃園,2024-03-14,9189
4714,永捷,46,32,14,群益金鼎-桃園,2024-03-14,9189
2329,華泰,19,6,13,群益金鼎-桃園,2024-03-14,9189
6274,台燿,19,6,13,群益金鼎-桃園,2024-03-14,9189
5243,乙盛-KY,14,2,12,群益金鼎-桃園,2024-03-14,9189
2834,臺企銀,33,21,12,群益金鼎-桃園,2024-03-14,9189
3105,穩懋,13,1,12,群益金鼎-桃園,2024-03-14,9189
1513,中興電,48,37,11,群益金鼎-桃園,2024-03-14,9189
00937B,群益ESG投等債20,239,13,226,群益金鼎-桃園,2024-03-15,9189
00665L,富邦�琤肭磪囓�2,170,0,170,群益金鼎-桃園,2024-03-15,9189
00919,群益台灣精選高息,284,145,139,群益金鼎-桃園,2024-03-15,9189
00941,中信上游半導體,152,20,132,群益金鼎-桃園,2024-03-15,9189
2834,臺企銀,246,131,115,群益金鼎-桃園,2024-03-15,9189
00679B,元大美債20年,81,0,81,群益金鼎-桃園,2024-03-15,9189
2603,長榮,88,17,71,群益金鼎-桃園,2024-03-15,9189
00918,大華優利高填息30,69,7,62,群益金鼎-桃園,2024-03-15,9189
2356,英業達,59,5,54,群益金鼎-桃園,2024-03-15,9189
2610,華航,61,12,49,群益金鼎-桃園,2024-03-15,9189
00688L,國泰20年美債正2,45,0,45,群益金鼎-桃園,2024-03-15,9189
2609,陽明,40,3,37,群益金鼎-桃園,2024-03-15,9189
1513,中興電,69,35,34,群益金鼎-桃園,2024-03-15,9189
00687B,國泰20年美債,61,27,34,群益金鼎-桃園,2024-03-15,9189
00706L,期元大S＆P日圓正2,30,0,30,群益金鼎-桃園,2024-03-15,9189
2313,華通,33,3,30,群益金鼎-桃園,2024-03-15,9189
00632R,元大台灣50反1,94,66,28,群益金鼎-桃園,2024-03-15,9189
4714,永捷,138,115,23,群益金鼎-桃園,2024-03-15,9189
2891,中信金,27,5,22,群益金鼎-桃園,2024-03-15,9189
2897,王道銀行,21,0,21,群益金鼎-桃園,2024-03-15,9189
2330,台積電,21,1,20,群益金鼎-桃園,2024-03-15,9189
2337,旺宏,20,0,20,群益金鼎-桃園,2024-03-15,9189
00673R,期元大S＆P原油反1,20,0,20,群益金鼎-桃園,2024-03-15,9189
00902,中信電池及儲能,20,0,20,群益金鼎-桃園,2024-03-15,9189
3437,榮創,20,0,20,群益金鼎-桃園,2024-03-15,9189
1616,億泰,21,2,19,群益金鼎-桃園,2024-03-15,9189
6026,福邦證,30,11,19,群益金鼎-桃園,2024-03-15,9189
2615,萬海,21,4,17,群益金鼎-桃園,2024-03-15,9189
5210,寶碩,17,0,17,群益金鼎-桃園,2024-03-15,9189
00795B,中信美國公債20年,17,0,17,群益金鼎-桃園,2024-03-15,9189
2308,台達電,16,0,16,群益金鼎-桃園,2024-03-15,9189
9945,潤泰新,26,10,16,群益金鼎-桃園,2024-03-15,9189
00712,復華富時不動產,19,3,16,群益金鼎-桃園,2024-03-15,9189
3005,神基,18,3,15,群益金鼎-桃園,2024-03-15,9189
5347,世界,19,4,15,群益金鼎-桃園,2024-03-15,9189
00931B,統一美債20年,15,0,15,群益金鼎-桃園,2024-03-15,9189
1210,大成,14,0,14,群益金鼎-桃園,2024-03-15,9189
3715,定穎投控,16,3,13,群益金鼎-桃園,2024-03-15,9189
1608,華榮,51,38,13,群益金鼎-桃園,2024-03-15,9189
3672,康聯訊,13,0,13,群益金鼎-桃園,2024-03-15,9189
6194,育富,13,0,13,群益金鼎-桃園,2024-03-15,9189
6546,正基,14,1,13,群益金鼎-桃園,2024-03-15,9189
2352,佳世達,13,1,12,群益金鼎-桃園,2024-03-15,9189
3051,力特,12,0,12,群益金鼎-桃園,2024-03-15,9189
3548,兆利,26,14,12,群益金鼎-桃園,2024-03-15,9189
1455,集盛,12,0,12,群益金鼎-桃園,2024-03-15,9189
2812,台中銀,13,1,12,群益金鼎-桃園,2024-03-15,9189
00915,凱基優選高股息30,11,1,10,群益金鼎-桃園,2024-03-15,9189
00929,復華台灣科技優息,134,124,10,群益金鼎-桃園,2024-03-15,9189
00909,國泰數位支付服務,10,0,10,群益金鼎-桃園,2024-03-15,9189
2836,高雄銀,100,0,100,群益金鼎-桃園,2024-03-18,9189
00937B,群益ESG投等債20,220,127,93,群益金鼎-桃園,2024-03-18,9189
00706L,期元大S＆P日圓正2,75,0,75,群益金鼎-桃園,2024-03-18,9189
00919,群益台灣精選高息,104,37,67,群益金鼎-桃園,2024-03-18,9189
3312,弘憶股,66,2,64,群益金鼎-桃園,2024-03-18,9189
00941,中信上游半導體,55,1,54,群益金鼎-桃園,2024-03-18,9189
00680L,元大美債20正2,70,17,53,群益金鼎-桃園,2024-03-18,9189
00830,國泰費城半導體,52,0,52,群益金鼎-桃園,2024-03-18,9189
2834,臺企銀,68,22,46,群益金鼎-桃園,2024-03-18,9189
2329,華泰,80,34,46,群益金鼎-桃園,2024-03-18,9189
2352,佳世達,57,13,44,群益金鼎-桃園,2024-03-18,9189
00687B,國泰20年美債,75,38,37,群益金鼎-桃園,2024-03-18,9189
7402,邑錡,35,3,32,群益金鼎-桃園,2024-03-18,9189
00918,大華優利高填息30,36,6,30,群益金鼎-桃園,2024-03-18,9189
2406,國碩,28,0,28,群益金鼎-桃園,2024-03-18,9189
2002,中鋼,25,0,25,群益金鼎-桃園,2024-03-18,9189
00915,凱基優選高股息30,26,1,25,群益金鼎-桃園,2024-03-18,9189
4714,永捷,84,60,24,群益金鼎-桃園,2024-03-18,9189
2885,元大金,32,9,23,群益金鼎-桃園,2024-03-18,9189
00933B,國泰10Y+金融債,22,0,22,群益金鼎-桃園,2024-03-18,9189
2367,燿華,63,41,22,群益金鼎-桃園,2024-03-18,9189
1736,喬山,22,0,22,群益金鼎-桃園,2024-03-18,9189
2382,廣達,28,7,21,群益金鼎-桃園,2024-03-18,9189
9945,潤泰新,20,0,20,群益金鼎-桃園,2024-03-18,9189
2618,長榮航,22,2,20,群益金鼎-桃園,2024-03-18,9189
00650L,復華香港正2,20,0,20,群益金鼎-桃園,2024-03-18,9189
1618,合機,22,3,19,群益金鼎-桃園,2024-03-18,9189
6126,信音,20,1,19,群益金鼎-桃園,2024-03-18,9189
2610,華航,20,2,18,群益金鼎-桃園,2024-03-18,9189
2609,陽明,29,11,18,群益金鼎-桃園,2024-03-18,9189
00751B,元大AAA至A公司債,17,0,17,群益金鼎-桃園,2024-03-18,9189
00712,復華富時不動產,17,0,17,群益金鼎-桃園,2024-03-18,9189
2611,志信,28,11,17,群益金鼎-桃園,2024-03-18,9189
3622,洋華,32,16,16,群益金鼎-桃園,2024-03-18,9189
1514,亞力,26,13,13,群益金鼎-桃園,2024-03-18,9189
1609,大亞,27,14,13,群益金鼎-桃園,2024-03-18,9189
6770,力積電,13,0,13,群益金鼎-桃園,2024-03-18,9189
4961,天鈺,18,6,12,群益金鼎-桃園,2024-03-18,9189
1608,華榮,22,10,12,群益金鼎-桃園,2024-03-18,9189
6799,來頡,12,0,12,群益金鼎-桃園,2024-03-18,9189
1301,台塑,11,0,11,群益金鼎-桃園,2024-03-18,9189
2889,國票金,11,0,11,群益金鼎-桃園,2024-03-18,9189
00891,中信關鍵半導體,15,5,10,群益金鼎-桃園,2024-03-18,9189
2887,台新金,10,0,10,群益金鼎-桃園,2024-03-18,9189
3617,碩天,11,1,10,群益金鼎-桃園,2024-03-18,9189
2605,新興,10,0,10,群益金鼎-桃園,2024-03-18,9189
3051,力特,10,0,10,群益金鼎-桃園,2024-03-18,9189
2010,春源,10,0,10,群益金鼎-桃園,2024-03-18,9189
3715,定穎投控,10,0,10,群益金鼎-桃園,2024-03-18,9189
8093,保銳,10,0,10,群益金鼎-桃園,2024-03-18,9189
00937B,群益ESG投等債20,234,23,211,群益金鼎-桃園,2024-03-19,9189
1727,中華化,89,2,87,群益金鼎-桃園,2024-03-19,9189
00665L,富邦�琤肭磪囓�2,80,0,80,群益金鼎-桃園,2024-03-19,9189
8926,台汽電,60,1,59,群益金鼎-桃園,2024-03-19,9189
00679B,元大美債20年,53,0,53,群益金鼎-桃園,2024-03-19,9189
00687B,國泰20年美債,44,0,44,群益金鼎-桃園,2024-03-19,9189
6005,群益證,41,1,40,群益金鼎-桃園,2024-03-19,9189
3481,群創,45,6,39,群益金鼎-桃園,2024-03-19,9189
6125,廣運,37,1,36,群益金鼎-桃園,2024-03-19,9189
1612,宏泰,39,3,36,群益金鼎-桃園,2024-03-19,9189
2317,鴻海,117,82,35,群益金鼎-桃園,2024-03-19,9189
2618,長榮航,45,10,35,群益金鼎-桃園,2024-03-19,9189
8011,台通,37,4,33,群益金鼎-桃園,2024-03-19,9189
2834,臺企銀,37,6,31,群益金鼎-桃園,2024-03-19,9189
2353,宏��,37,8,29,群益金鼎-桃園,2024-03-19,9189
00706L,期元大S＆P日圓正2,40,15,25,群益金鼎-桃園,2024-03-19,9189
00923,群益台ESG低碳50,23,0,23,群益金鼎-桃園,2024-03-19,9189
2022,聚亨,20,0,20,群益金鼎-桃園,2024-03-19,9189
3545,敦泰,18,0,18,群益金鼎-桃園,2024-03-19,9189
2610,華航,18,0,18,群益金鼎-桃園,2024-03-19,9189
00902,中信電池及儲能,20,2,18,群益金鼎-桃園,2024-03-19,9189
00764B,群益25年美債,18,0,18,群益金鼎-桃園,2024-03-19,9189
00715L,期街口布蘭特正2,17,0,17,群益金鼎-桃園,2024-03-19,9189
1514,亞力,42,26,16,群益金鼎-桃園,2024-03-19,9189
9945,潤泰新,16,0,16,群益金鼎-桃園,2024-03-19,9189
2408,南亞科,19,3,16,群益金鼎-桃園,2024-03-19,9189
5347,世界,36,20,16,群益金鼎-桃園,2024-03-19,9189
1608,華榮,15,0,15,群益金鼎-桃園,2024-03-19,9189
8930,青鋼,15,0,15,群益金鼎-桃園,2024-03-19,9189
4994,傳奇,14,0,14,群益金鼎-桃園,2024-03-19,9189
2615,萬海,16,2,14,群益金鼎-桃園,2024-03-19,9189
3312,弘憶股,42,30,12,群益金鼎-桃園,2024-03-19,9189
2362,藍天,12,0,12,群益金鼎-桃園,2024-03-19,9189
00941,中信上游半導體,13,1,12,群益金鼎-桃園,2024-03-19,9189
00857B,永豐20年美公債,12,0,12,群益金鼎-桃園,2024-03-19,9189
6550,北極星藥業-KY,12,0,12,群益金鼎-桃園,2024-03-19,9189
2344,華邦電,10,0,10,群益金鼎-桃園,2024-03-19,9189
1536,和大,10,0,10,群益金鼎-桃園,2024-03-19,9189
00680L,元大美債20正2,10,0,10,群益金鼎-桃園,2024-03-19,9189
2357,華碩,11,1,10,群益金鼎-桃園,2024-03-19,9189
2915,潤泰全,10,0,10,群益金鼎-桃園,2024-03-19,9189
2538,基泰,10,0,10,群益金鼎-桃園,2024-03-19,9189
00756B,群益投等新興公債,10,0,10,群益金鼎-桃園,2024-03-19,9189
1101,台泥,17,7,10,群益金鼎-桃園,2024-03-19,9189
2368,金像電,19,10,9,群益金鼎-桃園,2024-03-19,9189
1303,南亞,10,1,9,群益金鼎-桃園,2024-03-19,9189
2641,正德,10,1,9,群益金鼎-桃園,2024-03-19,9189
3059,華晶科,13,4,9,群益金鼎-桃園,2024-03-19,9189
1316,上曜,16,7,9,群益金鼎-桃園,2024-03-19,9189
2605,新興,12,3,9,群益金鼎-桃園,2024-03-19,9189
00919,群益台灣精選高息,367,156,211,群益金鼎-桃園,2024-03-20,9189
00939,統一台灣高息動能,812,642,170,群益金鼎-桃園,2024-03-20,9189
00937B,群益ESG投等債20,136,10,126,群益金鼎-桃園,2024-03-20,9189
1434,福懋,123,0,123,群益金鼎-桃園,2024-03-20,9189
2303,聯電,198,79,119,群益金鼎-桃園,2024-03-20,9189
00929,復華台灣科技優息,184,99,85,群益金鼎-桃園,2024-03-20,9189
2344,華邦電,66,1,65,群益金鼎-桃園,2024-03-20,9189
00706L,期元大S＆P日圓正2,51,0,51,群益金鼎-桃園,2024-03-20,9189
00687B,國泰20年美債,43,0,43,群益金鼎-桃園,2024-03-20,9189
2618,長榮航,43,2,41,群益金鼎-桃園,2024-03-20,9189
00680L,元大美債20正2,37,0,37,群益金鼎-桃園,2024-03-20,9189
1609,大亞,37,3,34,群益金鼎-桃園,2024-03-20,9189
0056,元大高股息,33,1,32,群益金鼎-桃園,2024-03-20,9189
2888,新光金,55,25,30,群益金鼎-桃園,2024-03-20,9189
2610,華航,31,1,30,群益金鼎-桃園,2024-03-20,9189
4942,嘉彰,30,0,30,群益金鼎-桃園,2024-03-20,9189
2006,東和鋼鐵,30,2,28,群益金鼎-桃園,2024-03-20,9189
5011,久陽,29,1,28,群益金鼎-桃園,2024-03-20,9189
00900,富邦特選高股息30,56,29,27,群益金鼎-桃園,2024-03-20,9189
00941,中信上游半導體,27,0,27,群益金鼎-桃園,2024-03-20,9189
2323,中環,46,20,26,群益金鼎-桃園,2024-03-20,9189
2356,英業達,31,7,24,群益金鼎-桃園,2024-03-20,9189
00632R,元大台灣50反1,100,77,23,群益金鼎-桃園,2024-03-20,9189
00688L,國泰20年美債正2,20,0,20,群益金鼎-桃園,2024-03-20,9189
00887,永豐中國科技50大,20,0,20,群益金鼎-桃園,2024-03-20,9189
5258,虹堡,32,12,20,群益金鼎-桃園,2024-03-20,9189
2449,京元電子,37,17,20,群益金鼎-桃園,2024-03-20,9189
1513,中興電,26,8,18,群益金鼎-桃園,2024-03-20,9189
1527,鑽全,18,0,18,群益金鼎-桃園,2024-03-20,9189
1611,中電,18,0,18,群益金鼎-桃園,2024-03-20,9189
4938,和碩,71,54,17,群益金鼎-桃園,2024-03-20,9189
5880,合庫金,17,0,17,群益金鼎-桃園,2024-03-20,9189
00679B,元大美債20年,19,2,17,群益金鼎-桃園,2024-03-20,9189
3617,碩天,16,0,16,群益金鼎-桃園,2024-03-20,9189
4543,萬在,16,0,16,群益金鼎-桃園,2024-03-20,9189
2376,技嘉,19,4,15,群益金鼎-桃園,2024-03-20,9189
00764B,群益25年美債,15,0,15,群益金鼎-桃園,2024-03-20,9189
2354,鴻準,72,58,14,群益金鼎-桃園,2024-03-20,9189
3207,耀勝,48,35,13,群益金鼎-桃園,2024-03-20,9189
2501,國建,13,0,13,群益金鼎-桃園,2024-03-20,9189
2408,南亞科,19,7,12,群益金鼎-桃園,2024-03-20,9189
7402,邑錡,13,1,12,群益金鼎-桃園,2024-03-20,9189
1785,光洋科,28,16,12,群益金鼎-桃園,2024-03-20,9189
3019,亞光,11,0,11,群益金鼎-桃園,2024-03-20,9189
2371,大同,13,2,11,群益金鼎-桃園,2024-03-20,9189
6577,勁豐,12,1,11,群益金鼎-桃園,2024-03-20,9189
2882,國泰金,11,0,11,群益金鼎-桃園,2024-03-20,9189
3325,旭品,11,0,11,群益金鼎-桃園,2024-03-20,9189
2834,臺企銀,11,0,11,群益金鼎-桃園,2024-03-20,9189
6139,亞翔,20,9,11,群益金鼎-桃園,2024-03-20,9189
00751B,元大AAA至A公司債,474,3,471,群益金鼎-桃園,2024-03-21,9189
00632R,元大台灣50反1,283,0,283,群益金鼎-桃園,2024-03-21,9189
00664R,國泰臺灣加權反1,209,0,209,群益金鼎-桃園,2024-03-21,9189
00939,統一台灣高息動能,271,74,197,群益金鼎-桃園,2024-03-21,9189
00919,群益台灣精選高息,232,56,176,群益金鼎-桃園,2024-03-21,9189
2885,元大金,102,1,101,群益金鼎-桃園,2024-03-21,9189
2371,大同,66,1,65,群益金鼎-桃園,2024-03-21,9189
00830,國泰費城半導體,62,3,59,群益金鼎-桃園,2024-03-21,9189
3037,欣興,52,5,47,群益金鼎-桃園,2024-03-21,9189
00937B,群益ESG投等債20,63,20,43,群益金鼎-桃園,2024-03-21,9189
00679B,元大美債20年,41,1,40,群益金鼎-桃園,2024-03-21,9189
2888,新光金,39,0,39,群益金鼎-桃園,2024-03-21,9189
2354,鴻準,62,24,38,群益金鼎-桃園,2024-03-21,9189
00887,永豐中國科技50大,32,0,32,群益金鼎-桃園,2024-03-21,9189
5299,杰力,32,0,32,群益金鼎-桃園,2024-03-21,9189
2618,長榮航,25,0,25,群益金鼎-桃園,2024-03-21,9189
3706,神達,185,162,23,群益金鼎-桃園,2024-03-21,9189
4129,聯合,22,0,22,群益金鼎-桃園,2024-03-21,9189
3163,波若威,23,1,22,群益金鼎-桃園,2024-03-21,9189
2376,技嘉,24,3,21,群益金鼎-桃園,2024-03-21,9189
5201,凱衛,21,0,21,群益金鼎-桃園,2024-03-21,9189
00706L,期元大S＆P日圓正2,20,0,20,群益金鼎-桃園,2024-03-21,9189
6176,瑞儀,19,0,19,群益金鼎-桃園,2024-03-21,9189
6160,欣技,19,0,19,群益金鼎-桃園,2024-03-21,9189
00687B,國泰20年美債,16,0,16,群益金鼎-桃園,2024-03-21,9189
2834,臺企銀,16,0,16,群益金鼎-桃園,2024-03-21,9189
3322,建舜電,19,3,16,群益金鼎-桃園,2024-03-21,9189
2458,義隆,16,1,15,群益金鼎-桃園,2024-03-21,9189
2395,研華,15,0,15,群益金鼎-桃園,2024-03-21,9189
00933B,國泰10Y+金融債,22,8,14,群益金鼎-桃園,2024-03-21,9189
00882,中信中國高股息,31,17,14,群益金鼎-桃園,2024-03-21,9189
6443,元晶,15,1,14,群益金鼎-桃園,2024-03-21,9189
1789,神隆,12,0,12,群益金鼎-桃園,2024-03-21,9189
1522,堤維西,12,0,12,群益金鼎-桃園,2024-03-21,9189
3567,逸昌,11,0,11,群益金鼎-桃園,2024-03-21,9189
2605,新興,11,0,11,群益金鼎-桃園,2024-03-21,9189
2465,麗臺,11,0,11,群益金鼎-桃園,2024-03-21,9189
3325,旭品,10,0,10,群益金鼎-桃園,2024-03-21,9189
1527,鑽全,10,0,10,群益金鼎-桃園,2024-03-21,9189
1569,濱川,10,0,10,群益金鼎-桃園,2024-03-21,9189
2701,萬企,10,0,10,群益金鼎-桃園,2024-03-21,9189
3520,華盈,10,0,10,群益金鼎-桃園,2024-03-21,9189
6239,力成,16,6,10,群益金鼎-桃園,2024-03-21,9189
4956,光鋐,10,0,10,群益金鼎-桃園,2024-03-21,9189
6194,育富,10,0,10,群益金鼎-桃園,2024-03-21,9189
4927,泰鼎-KY,10,0,10,群益金鼎-桃園,2024-03-21,9189
4142,國光生,10,0,10,群益金鼎-桃園,2024-03-21,9189
4743,合一,15,6,9,群益金鼎-桃園,2024-03-21,9189
3033,威健,10,1,9,群益金鼎-桃園,2024-03-21,9189
00930,永豐ESG低碳高息,9,0,9,群益金鼎-桃園,2024-03-21,9189
00665L,富邦�琤肭磪囓�2,180,0,180,群益金鼎-桃園,2024-03-22,9189
00937B,群益ESG投等債20,270,142,128,群益金鼎-桃園,2024-03-22,9189
00919,群益台灣精選高息,208,102,106,群益金鼎-桃園,2024-03-22,9189
9904,寶成,100,11,89,群益金鼎-桃園,2024-03-22,9189
2888,新光金,92,4,88,群益金鼎-桃園,2024-03-22,9189
8936,國統,77,14,63,群益金鼎-桃園,2024-03-22,9189
00927,群益半導體收益,57,0,57,群益金鼎-桃園,2024-03-22,9189
9105,泰金寶-DR,50,1,49,群益金鼎-桃園,2024-03-22,9189
2317,鴻海,116,70,46,群益金鼎-桃園,2024-03-22,9189
2885,元大金,57,15,42,群益金鼎-桃園,2024-03-22,9189
2353,宏��,110,74,36,群益金鼎-桃園,2024-03-22,9189
6176,瑞儀,37,2,35,群益金鼎-桃園,2024-03-22,9189
6443,元晶,55,21,34,群益金鼎-桃園,2024-03-22,9189
2883,凱基金,35,5,30,群益金鼎-桃園,2024-03-22,9189
00752,中信中國50,27,0,27,群益金鼎-桃園,2024-03-22,9189
2303,聯電,38,12,26,群益金鼎-桃園,2024-03-22,9189
3033,威健,26,1,25,群益金鼎-桃園,2024-03-22,9189
8234,新漢,25,0,25,群益金鼎-桃園,2024-03-22,9189
00637L,元大滬深300正2,55,30,25,群益金鼎-桃園,2024-03-22,9189
5347,世界,29,7,22,群益金鼎-桃園,2024-03-22,9189
1504,東元,62,40,22,群益金鼎-桃園,2024-03-22,9189
2313,華通,23,4,19,群益金鼎-桃園,2024-03-22,9189
5871,中租-KY,18,0,18,群益金鼎-桃園,2024-03-22,9189
00941,中信上游半導體,20,3,17,群益金鼎-桃園,2024-03-22,9189
1513,中興電,32,15,17,群益金鼎-桃園,2024-03-22,9189
00764B,群益25年美債,22,5,17,群益金鼎-桃園,2024-03-22,9189
6163,華電網,18,1,17,群益金鼎-桃園,2024-03-22,9189
00679B,元大美債20年,16,0,16,群益金鼎-桃園,2024-03-22,9189
0050,元大台灣50,17,2,15,群益金鼎-桃園,2024-03-22,9189
3704,合勤控,26,11,15,群益金鼎-桃園,2024-03-22,9189
1101,台泥,15,0,15,群益金鼎-桃園,2024-03-22,9189
2301,光寶科,37,22,15,群益金鼎-桃園,2024-03-22,9189
00706L,期元大S＆P日圓正2,15,0,15,群益金鼎-桃園,2024-03-22,9189
9907,統一實,15,0,15,群益金鼎-桃園,2024-03-22,9189
2486,一詮,41,26,15,群益金鼎-桃園,2024-03-22,9189
3712,永崴投控,25,11,14,群益金鼎-桃園,2024-03-22,9189
2618,長榮航,17,3,14,群益金鼎-桃園,2024-03-22,9189
2377,微星,16,2,14,群益金鼎-桃園,2024-03-22,9189
1455,集盛,15,1,14,群益金鼎-桃園,2024-03-22,9189
5483,中美晶,14,0,14,群益金鼎-桃園,2024-03-22,9189
8021,尖點,13,0,13,群益金鼎-桃園,2024-03-22,9189
3715,定穎投控,13,1,12,群益金鼎-桃園,2024-03-22,9189
6146,耕興,12,0,12,群益金鼎-桃園,2024-03-22,9189
00915,凱基優選高股息30,12,0,12,群益金鼎-桃園,2024-03-22,9189
2376,技嘉,24,13,11,群益金鼎-桃園,2024-03-22,9189
1907,永豐餘,11,0,11,群益金鼎-桃園,2024-03-22,9189
6147,頎邦,15,4,11,群益金鼎-桃園,2024-03-22,9189
3083,網龍,11,0,11,群益金鼎-桃園,2024-03-22,9189
8070,長華*,11,0,11,群益金鼎-桃園,2024-03-22,9189
5443,均豪,22,12,10,群益金鼎-桃園,2024-03-22,9189
00937B,群益ESG投等債20,407,17,390,群益金鼎-桃園,2024-03-25,9189
1101,台泥,121,0,121,群益金鼎-桃園,2024-03-25,9189
4938,和碩,113,11,102,群益金鼎-桃園,2024-03-25,9189
00941,中信上游半導體,113,22,91,群益金鼎-桃園,2024-03-25,9189
2888,新光金,86,0,86,群益金鼎-桃園,2024-03-25,9189
1609,大亞,184,100,84,群益金鼎-桃園,2024-03-25,9189
6147,頎邦,79,0,79,群益金鼎-桃園,2024-03-25,9189
2367,燿華,184,113,71,群益金鼎-桃園,2024-03-25,9189
2881,富邦金,66,1,65,群益金鼎-桃園,2024-03-25,9189
2356,英業達,81,30,51,群益金鼎-桃園,2024-03-25,9189
912000,晨訊科-DR,50,0,50,群益金鼎-桃園,2024-03-25,9189
2006,東和鋼鐵,50,0,50,群益金鼎-桃園,2024-03-25,9189
00664R,國泰臺灣加權反1,50,0,50,群益金鼎-桃園,2024-03-25,9189
2324,仁寶,49,2,47,群益金鼎-桃園,2024-03-25,9189
1815,富喬,70,23,47,群益金鼎-桃園,2024-03-25,9189
1612,宏泰,74,29,45,群益金鼎-桃園,2024-03-25,9189
911608,明輝-DR,35,0,35,群益金鼎-桃園,2024-03-25,9189
1605,華新,39,5,34,群益金鼎-桃園,2024-03-25,9189
00919,群益台灣精選高息,108,74,34,群益金鼎-桃園,2024-03-25,9189
00687B,國泰20年美債,39,5,34,群益金鼎-桃園,2024-03-25,9189
00679B,元大美債20年,32,0,32,群益金鼎-桃園,2024-03-25,9189
1314,中石化,30,0,30,群益金鼎-桃園,2024-03-25,9189
2897,王道銀行,24,0,24,群益金鼎-桃園,2024-03-25,9189
5483,中美晶,23,0,23,群益金鼎-桃園,2024-03-25,9189
4943,康控-KY,23,0,23,群益金鼎-桃園,2024-03-25,9189
00929,復華台灣科技優息,33,12,21,群益金鼎-桃園,2024-03-25,9189
2301,光寶科,25,5,20,群益金鼎-桃園,2024-03-25,9189
00939,統一台灣高息動能,75,55,20,群益金鼎-桃園,2024-03-25,9189
6443,元晶,31,12,19,群益金鼎-桃園,2024-03-25,9189
2809,京城銀,21,2,19,群益金鼎-桃園,2024-03-25,9189
2882,國泰金,19,0,19,群益金鼎-桃園,2024-03-25,9189
6768,志強-KY,18,0,18,群益金鼎-桃園,2024-03-25,9189
2889,國票金,16,0,16,群益金鼎-桃園,2024-03-25,9189
2449,京元電子,20,4,16,群益金鼎-桃園,2024-03-25,9189
6139,亞翔,45,30,15,群益金鼎-桃園,2024-03-25,9189
3325,旭品,15,0,15,群益金鼎-桃園,2024-03-25,9189
1503,士電,30,15,15,群益金鼎-桃園,2024-03-25,9189
2303,聯電,24,11,13,群益金鼎-桃園,2024-03-25,9189
5381,合正,14,1,13,群益金鼎-桃園,2024-03-25,9189
2883,凱基金,17,4,13,群益金鼎-桃園,2024-03-25,9189
6415,矽力*-KY,13,0,13,群益金鼎-桃園,2024-03-25,9189
6290,良維,21,8,13,群益金鼎-桃園,2024-03-25,9189
2886,兆豐金,12,0,12,群益金鼎-桃園,2024-03-25,9189
2352,佳世達,24,13,11,群益金鼎-桃園,2024-03-25,9189
0056,元大高股息,12,1,11,群益金鼎-桃園,2024-03-25,9189
3406,玉晶光,14,3,11,群益金鼎-桃園,2024-03-25,9189
00720B,元大投資級公司債,31,20,11,群益金鼎-桃園,2024-03-25,9189
1529,樂事綠能,17,6,11,群益金鼎-桃園,2024-03-25,9189
3188,鑫龍騰,15,4,11,群益金鼎-桃園,2024-03-25,9189
8085,福華,11,0,11,群益金鼎-桃園,2024-03-25,9189
00937B,群益ESG投等債20,292,22,270,群益金鼎-桃園,2024-03-26,9189
00665L,富邦�琤肭磪囓�2,222,0,222,群益金鼎-桃園,2024-03-26,9189
00919,群益台灣精選高息,241,66,175,群益金鼎-桃園,2024-03-26,9189
00939,統一台灣高息動能,236,108,128,群益金鼎-桃園,2024-03-26,9189
00929,復華台灣科技優息,111,27,84,群益金鼎-桃園,2024-03-26,9189
2356,英業達,115,41,74,群益金鼎-桃園,2024-03-26,9189
2618,長榮航,59,3,56,群益金鼎-桃園,2024-03-26,9189
1504,東元,74,21,53,群益金鼎-桃園,2024-03-26,9189
4938,和碩,76,24,52,群益金鼎-桃園,2024-03-26,9189
00909,國泰數位支付服務,51,0,51,群益金鼎-桃園,2024-03-26,9189
00686R,群益臺灣加權反1,50,0,50,群益金鼎-桃園,2024-03-26,9189
1609,大亞,146,97,49,群益金鼎-桃園,2024-03-26,9189
9933,中鼎,63,19,44,群益金鼎-桃園,2024-03-26,9189
6125,廣運,71,28,43,群益金鼎-桃園,2024-03-26,9189
2609,陽明,41,2,39,群益金鼎-桃園,2024-03-26,9189
00941,中信上游半導體,50,13,37,群益金鼎-桃園,2024-03-26,9189
2367,燿華,67,31,36,群益金鼎-桃園,2024-03-26,9189
2417,圓剛,37,1,36,群益金鼎-桃園,2024-03-26,9189
00632R,元大台灣50反1,149,115,34,群益金鼎-桃園,2024-03-26,9189
2883,凱基金,38,6,32,群益金鼎-桃園,2024-03-26,9189
2834,臺企銀,31,0,31,群益金鼎-桃園,2024-03-26,9189
2603,長榮,35,5,30,群益金鼎-桃園,2024-03-26,9189
2405,輔信,30,0,30,群益金鼎-桃園,2024-03-26,9189
8271,宇瞻,33,3,30,群益金鼎-桃園,2024-03-26,9189
3231,緯創,56,26,30,群益金鼎-桃園,2024-03-26,9189
2634,漢翔,28,0,28,群益金鼎-桃園,2024-03-26,9189
3312,弘憶股,39,14,25,群益金鼎-桃園,2024-03-26,9189
2388,威盛,38,14,24,群益金鼎-桃園,2024-03-26,9189
8926,台汽電,30,7,23,群益金鼎-桃園,2024-03-26,9189
00933B,國泰10Y+金融債,22,0,22,群益金鼎-桃園,2024-03-26,9189
4931,新盛力,21,0,21,群益金鼎-桃園,2024-03-26,9189
6284,佳邦,20,0,20,群益金鼎-桃園,2024-03-26,9189
1905,華紙,20,0,20,群益金鼎-桃園,2024-03-26,9189
6016,康和證,20,2,18,群益金鼎-桃園,2024-03-26,9189
4979,華星光,29,12,17,群益金鼎-桃園,2024-03-26,9189
6122,擎邦,18,1,17,群益金鼎-桃園,2024-03-26,9189
00764B,群益25年美債,22,5,17,群益金鼎-桃園,2024-03-26,9189
2402,毅嘉,30,14,16,群益金鼎-桃園,2024-03-26,9189
00687B,國泰20年美債,24,9,15,群益金鼎-桃園,2024-03-26,9189
8046,南電,15,0,15,群益金鼎-桃園,2024-03-26,9189
2353,宏��,19,4,15,群益金鼎-桃園,2024-03-26,9189
911608,明輝-DR,15,0,15,群益金鼎-桃園,2024-03-26,9189
00706L,期元大S＆P日圓正2,15,0,15,群益金鼎-桃園,2024-03-26,9189
1529,樂事綠能,30,15,15,群益金鼎-桃園,2024-03-26,9189
8996,高力,23,8,15,群益金鼎-桃園,2024-03-26,9189
6274,台燿,39,25,14,群益金鼎-桃園,2024-03-26,9189
3322,建舜電,14,0,14,群益金鼎-桃園,2024-03-26,9189
2070,精湛,14,0,14,群益金鼎-桃園,2024-03-26,9189
2889,國票金,17,4,13,群益金鼎-桃園,2024-03-26,9189
3038,全台,13,0,13,群益金鼎-桃園,2024-03-26,9189
00937B,群益ESG投等債20,256,0,256,群益金鼎-桃園,2024-03-27,9189
00939,統一台灣高息動能,285,82,203,群益金鼎-桃園,2024-03-27,9189
5481,新華,200,0,200,群益金鼎-桃園,2024-03-27,9189
00665L,富邦�琤肭磪囓�2,128,0,128,群益金鼎-桃園,2024-03-27,9189
2323,中環,90,0,90,群益金鼎-桃園,2024-03-27,9189
2630,亞航,71,7,64,群益金鼎-桃園,2024-03-27,9189
1905,華紙,48,1,47,群益金鼎-桃園,2024-03-27,9189
3296,勝德,45,5,40,群益金鼎-桃園,2024-03-27,9189
3013,晟銘電,60,21,39,群益金鼎-桃園,2024-03-27,9189
1618,合機,48,10,38,群益金鼎-桃園,2024-03-27,9189
2913,農林,40,4,36,群益金鼎-桃園,2024-03-27,9189
00706L,期元大S＆P日圓正2,30,0,30,群益金鼎-桃園,2024-03-27,9189
3231,緯創,25,2,23,群益金鼎-桃園,2024-03-27,9189
2464,盟立,54,32,22,群益金鼎-桃園,2024-03-27,9189
1513,中興電,45,24,21,群益金鼎-桃園,2024-03-27,9189
2888,新光金,30,10,20,群益金鼎-桃園,2024-03-27,9189
6275,元山,20,0,20,群益金鼎-桃園,2024-03-27,9189
3025,星通,21,1,20,群益金鼎-桃園,2024-03-27,9189
2371,大同,46,26,20,群益金鼎-桃園,2024-03-27,9189
3617,碩天,19,0,19,群益金鼎-桃園,2024-03-27,9189
2354,鴻準,68,50,18,群益金鼎-桃園,2024-03-27,9189
2417,圓剛,19,1,18,群益金鼎-桃園,2024-03-27,9189
1603,華電,29,12,17,群益金鼎-桃園,2024-03-27,9189
3312,弘憶股,32,15,17,群益金鼎-桃園,2024-03-27,9189
00941,中信上游半導體,16,0,16,群益金鼎-桃園,2024-03-27,9189
1808,潤隆,21,5,16,群益金鼎-桃園,2024-03-27,9189
2498,宏達電,17,1,16,群益金鼎-桃園,2024-03-27,9189
4513,福裕,23,8,15,群益金鼎-桃園,2024-03-27,9189
1605,華新,22,7,15,群益金鼎-桃園,2024-03-27,9189
1503,士電,28,13,15,群益金鼎-桃園,2024-03-27,9189
00679B,元大美債20年,13,0,13,群益金鼎-桃園,2024-03-27,9189
2312,金寶,15,2,13,群益金鼎-桃園,2024-03-27,9189
2313,華通,27,15,12,群益金鼎-桃園,2024-03-27,9189
2615,萬海,12,0,12,群益金鼎-桃園,2024-03-27,9189
4576,大銀微系統,30,18,12,群益金鼎-桃園,2024-03-27,9189
5351,鈺創,12,0,12,群益金鼎-桃園,2024-03-27,9189
2355,敬鵬,12,1,11,群益金鼎-桃園,2024-03-27,9189
2301,光寶科,13,3,10,群益金鼎-桃園,2024-03-27,9189
1314,中石化,10,0,10,群益金鼎-桃園,2024-03-27,9189
1608,華榮,183,173,10,群益金鼎-桃園,2024-03-27,9189
3051,力特,10,0,10,群益金鼎-桃園,2024-03-27,9189
2034,允強,10,0,10,群益金鼎-桃園,2024-03-27,9189
3703,欣陸,30,20,10,群益金鼎-桃園,2024-03-27,9189
00753L,中信中國50正2,10,0,10,群益金鼎-桃園,2024-03-27,9189
4162,智擎,12,2,10,群益金鼎-桃園,2024-03-27,9189
00641R,富邦日本反1,10,0,10,群益金鼎-桃園,2024-03-27,9189
6215,和椿,43,33,10,群益金鼎-桃園,2024-03-27,9189
6125,廣運,21,12,9,群益金鼎-桃園,2024-03-27,9189
1514,亞力,19,10,9,群益金鼎-桃園,2024-03-27,9189
9904,寶成,12,3,9,群益金鼎-桃園,2024-03-27,9189
00632R,元大台灣50反1,306,70,236,群益金鼎-桃園,2024-03-28,9189
2888,新光金,162,0,162,群益金鼎-桃園,2024-03-28,9189
2405,輔信,130,0,130,群益金鼎-桃園,2024-03-28,9189
00929,復華台灣科技優息,123,17,106,群益金鼎-桃園,2024-03-28,9189
9904,寶成,101,7,94,群益金鼎-桃園,2024-03-28,9189
2883,凱基金,85,0,85,群益金鼎-桃園,2024-03-28,9189
00679B,元大美債20年,75,5,70,群益金鼎-桃園,2024-03-28,9189
1609,大亞,102,48,54,群益金鼎-桃園,2024-03-28,9189
1584,精剛,54,0,54,群益金鼎-桃園,2024-03-28,9189
00937B,群益ESG投等債20,84,31,53,群益金鼎-桃園,2024-03-28,9189
2515,中工,88,44,44,群益金鼎-桃園,2024-03-28,9189
8033,雷虎,46,3,43,群益金鼎-桃園,2024-03-28,9189
3706,神達,64,23,41,群益金鼎-桃園,2024-03-28,9189
2002,中鋼,42,2,40,群益金鼎-桃園,2024-03-28,9189
00919,群益台灣精選高息,151,114,37,群益金鼎-桃園,2024-03-28,9189
00882,中信中國高股息,41,10,31,群益金鼎-桃園,2024-03-28,9189
2356,英業達,55,29,26,群益金鼎-桃園,2024-03-28,9189
00764B,群益25年美債,32,6,26,群益金鼎-桃園,2024-03-28,9189
00915,凱基優選高股息30,30,5,25,群益金鼎-桃園,2024-03-28,9189
3710,連展投控,25,0,25,群益金鼎-桃園,2024-03-28,9189
2114,鑫永銓,25,0,25,群益金鼎-桃園,2024-03-28,9189
6770,力積電,33,8,25,群益金鼎-桃園,2024-03-28,9189
5515,建國,33,9,24,群益金鼎-桃園,2024-03-28,9189
00720B,元大投資級公司債,27,3,24,群益金鼎-桃園,2024-03-28,9189
3540,曜越,22,0,22,群益金鼎-桃園,2024-03-28,9189
3005,神基,29,7,22,群益金鼎-桃園,2024-03-28,9189
4526,東台,24,3,21,群益金鼎-桃園,2024-03-28,9189
00941,中信上游半導體,18,0,18,群益金鼎-桃園,2024-03-28,9189
2615,萬海,20,2,18,群益金鼎-桃園,2024-03-28,9189
6244,茂迪,31,13,18,群益金鼎-桃園,2024-03-28,9189
2409,友達,20,2,18,群益金鼎-桃園,2024-03-28,9189
5009,榮剛,17,0,17,群益金鼎-桃園,2024-03-28,9189
6743,安普新,16,0,16,群益金鼎-桃園,2024-03-28,9189
3171,炎洲流通,18,2,16,群益金鼎-桃園,2024-03-28,9189
8222,寶一,25,10,15,群益金鼎-桃園,2024-03-28,9189
4513,福裕,18,3,15,群益金鼎-桃園,2024-03-28,9189
2543,皇昌,15,0,15,群益金鼎-桃園,2024-03-28,9189
00687B,國泰20年美債,15,1,14,群益金鼎-桃園,2024-03-28,9189
2367,燿華,36,22,14,群益金鼎-桃園,2024-03-28,9189
3062,建漢,24,10,14,群益金鼎-桃園,2024-03-28,9189
00719B,元大美債1-3,13,0,13,群益金鼎-桃園,2024-03-28,9189
2882,國泰金,13,0,13,群益金鼎-桃園,2024-03-28,9189
3322,建舜電,12,0,12,群益金鼎-桃園,2024-03-28,9189
5351,鈺創,13,1,12,群益金鼎-桃園,2024-03-28,9189
3437,榮創,12,0,12,群益金鼎-桃園,2024-03-28,9189
00740B,富邦全球投等債,12,0,12,群益金鼎-桃園,2024-03-28,9189
6443,元晶,43,31,12,群益金鼎-桃園,2024-03-28,9189
2301,光寶科,15,4,11,群益金鼎-桃園,2024-03-28,9189
3390,旭軟,11,0,11,群益金鼎-桃園,2024-03-28,9189
3260,威剛,19,8,11,群益金鼎-桃園,2024-03-28,9189
8085,福華,296,0,296,群益金鼎-桃園,2024-03-29,9189
00632R,元大台灣50反1,135,0,135,群益金鼎-桃園,2024-03-29,9189
00937B,群益ESG投等債20,117,42,75,群益金鼎-桃園,2024-03-29,9189
2324,仁寶,305,247,58,群益金鼎-桃園,2024-03-29,9189
2888,新光金,55,3,52,群益金鼎-桃園,2024-03-29,9189
2303,聯電,90,52,38,群益金鼎-桃園,2024-03-29,9189
00764B,群益25年美債,37,0,37,群益金鼎-桃園,2024-03-29,9189
00939,統一台灣高息動能,94,58,36,群益金鼎-桃園,2024-03-29,9189
00941,中信上游半導體,35,0,35,群益金鼎-桃園,2024-03-29,9189
2344,華邦電,31,1,30,群益金鼎-桃園,2024-03-29,9189
1434,福懋,30,0,30,群益金鼎-桃園,2024-03-29,9189
2317,鴻海,54,24,30,群益金鼎-桃園,2024-03-29,9189
5309,系統電,26,2,24,群益金鼎-桃園,2024-03-29,9189
2611,志信,23,1,22,群益金鼎-桃園,2024-03-29,9189
2883,凱基金,30,8,22,群益金鼎-桃園,2024-03-29,9189
1316,上曜,30,9,21,群益金鼎-桃園,2024-03-29,9189
8110,華東,23,2,21,群益金鼎-桃園,2024-03-29,9189
3013,晟銘電,89,68,21,群益金鼎-桃園,2024-03-29,9189
00637L,元大滬深300正2,20,0,20,群益金鼎-桃園,2024-03-29,9189
8150,南茂,23,4,19,群益金鼎-桃園,2024-03-29,9189
5515,建國,29,12,17,群益金鼎-桃園,2024-03-29,9189
2371,大同,33,16,17,群益金鼎-桃園,2024-03-29,9189
2301,光寶科,21,5,16,群益金鼎-桃園,2024-03-29,9189
00919,群益台灣精選高息,68,52,16,群益金鼎-桃園,2024-03-29,9189
6789,采鈺,16,1,15,群益金鼎-桃園,2024-03-29,9189
6443,元晶,21,7,14,群益金鼎-桃園,2024-03-29,9189
2377,微星,14,0,14,群益金鼎-桃園,2024-03-29,9189
6126,信音,30,16,14,群益金鼎-桃園,2024-03-29,9189
00722B,群益投資級電信債,14,0,14,群益金鼎-桃園,2024-03-29,9189
3715,定穎投控,13,0,13,群益金鼎-桃園,2024-03-29,9189
4127,天良,14,3,11,群益金鼎-桃園,2024-03-29,9189
6176,瑞儀,31,21,10,群益金鼎-桃園,2024-03-29,9189
00664R,國泰臺灣加權反1,10,0,10,群益金鼎-桃園,2024-03-29,9189
2838,聯邦銀,10,0,10,群益金鼎-桃園,2024-03-29,9189
00720B,元大投資級公司債,10,0,10,群益金鼎-桃園,2024-03-29,9189
3188,鑫龍騰,17,7,10,群益金鼎-桃園,2024-03-29,9189
6127,九豪,10,0,10,群益金鼎-桃園,2024-03-29,9189
8215,明基材,10,0,10,群益金鼎-桃園,2024-03-29,9189
6274,台燿,23,13,10,群益金鼎-桃園,2024-03-29,9189
4576,大銀微系統,12,3,9,群益金鼎-桃園,2024-03-29,9189
3017,奇鋐,12,3,9,群益金鼎-桃園,2024-03-29,9189
1618,合機,15,6,9,群益金鼎-桃園,2024-03-29,9189
00885,富邦越南,10,1,9,群益金鼎-桃園,2024-03-29,9189
1608,華榮,15,6,9,群益金鼎-桃園,2024-03-29,9189
2617,台航,8,0,8,群益金鼎-桃園,2024-03-29,9189
2409,友達,10,2,8,群益金鼎-桃園,2024-03-29,9189
2610,華航,7,0,7,群益金鼎-桃園,2024-03-29,9189
3706,神達,23,16,7,群益金鼎-桃園,2024-03-29,9189
1455,集盛,7,0,7,群益金鼎-桃園,2024-03-29,9189
6179,亞通,10,3,7,群益金鼎-桃園,2024-03-29,9189
00940,元大台灣價值高息,756,167,589,群益金鼎-桃園,2024-04-01,9189
00720B,元大投資級公司債,473,0,473,群益金鼎-桃園,2024-04-01,9189
00927,群益半導體收益,246,0,246,群益金鼎-桃園,2024-04-01,9189
2515,中工,94,46,48,群益金鼎-桃園,2024-04-01,9189
1527,鑽全,44,2,42,群益金鼎-桃園,2024-04-01,9189
2367,燿華,61,25,36,群益金鼎-桃園,2024-04-01,9189
00919,群益台灣精選高息,52,16,36,群益金鼎-桃園,2024-04-01,9189
00679B,元大美債20年,36,2,34,群益金鼎-桃園,2024-04-01,9189
00632R,元大台灣50反1,35,3,32,群益金鼎-桃園,2024-04-01,9189
1504,東元,55,24,31,群益金鼎-桃園,2024-04-01,9189
5324,士開,30,0,30,群益金鼎-桃園,2024-04-01,9189
2352,佳世達,27,0,27,群益金鼎-桃園,2024-04-01,9189
2891,中信金,36,13,23,群益金鼎-桃園,2024-04-01,9189
2308,台達電,27,5,22,群益金鼎-桃園,2024-04-01,9189
00918,大華優利高填息30,23,1,22,群益金鼎-桃園,2024-04-01,9189
2353,宏��,25,6,19,群益金鼎-桃園,2024-04-01,9189
3376,新日興,23,6,17,群益金鼎-桃園,2024-04-01,9189
4958,臻鼎-KY,24,7,17,群益金鼎-桃園,2024-04-01,9189
9105,泰金寶-DR,20,3,17,群益金鼎-桃園,2024-04-01,9189
1201,味全,16,0,16,群益金鼎-桃園,2024-04-01,9189
6443,元晶,30,14,16,群益金鼎-桃園,2024-04-01,9189
00937B,群益ESG投等債20,86,71,15,群益金鼎-桃園,2024-04-01,9189
6695,芯鼎,17,2,15,群益金鼎-桃園,2024-04-01,9189
2610,華航,15,0,15,群益金鼎-桃園,2024-04-01,9189
8054,安國,23,8,15,群益金鼎-桃園,2024-04-01,9189
4576,大銀微系統,30,15,15,群益金鼎-桃園,2024-04-01,9189
3231,緯創,35,22,13,群益金鼎-桃園,2024-04-01,9189
1815,富喬,18,5,13,群益金鼎-桃園,2024-04-01,9189
2630,亞航,16,3,13,群益金鼎-桃園,2024-04-01,9189
6125,廣運,23,10,13,群益金鼎-桃園,2024-04-01,9189
00941,中信上游半導體,12,0,12,群益金鼎-桃園,2024-04-01,9189
5439,高技,14,2,12,群益金鼎-桃園,2024-04-01,9189
4938,和碩,29,18,11,群益金鼎-桃園,2024-04-01,9189
2611,志信,12,1,11,群益金鼎-桃園,2024-04-01,9189
2884,玉山金,11,1,10,群益金鼎-桃園,2024-04-01,9189
2388,威盛,12,2,10,群益金鼎-桃園,2024-04-01,9189
00680L,元大美債20正2,10,0,10,群益金鼎-桃園,2024-04-01,9189
00664R,國泰臺灣加權反1,10,0,10,群益金鼎-桃園,2024-04-01,9189
2538,基泰,10,0,10,群益金鼎-桃園,2024-04-01,9189
2382,廣達,27,18,9,群益金鼎-桃園,2024-04-01,9189
3021,鴻名,8,0,8,群益金鼎-桃園,2024-04-01,9189
3005,神基,14,7,7,群益金鼎-桃園,2024-04-01,9189
3171,炎洲流通,10,3,7,群益金鼎-桃園,2024-04-01,9189
2313,華通,23,16,7,群益金鼎-桃園,2024-04-01,9189
1514,亞力,11,4,7,群益金鼎-桃園,2024-04-01,9189
2330,台積電,7,0,7,群益金鼎-桃園,2024-04-01,9189
3706,神達,12,5,7,群益金鼎-桃園,2024-04-01,9189
4994,傳奇,6,0,6,群益金鼎-桃園,2024-04-01,9189
6219,富旺,7,1,6,群益金鼎-桃園,2024-04-01,9189
3014,聯陽,6,0,6,群益金鼎-桃園,2024-04-01,9189
00929,復華台灣科技優息,331,12,319,群益金鼎-桃園,2024-04-02,9189
2440,太空梭,241,0,241,群益金鼎-桃園,2024-04-02,9189
00664R,國泰臺灣加權反1,234,0,234,群益金鼎-桃園,2024-04-02,9189
00940,元大台灣價值高息,306,116,190,群益金鼎-桃園,2024-04-02,9189
00927,群益半導體收益,170,6,164,群益金鼎-桃園,2024-04-02,9189
2371,大同,174,27,147,群益金鼎-桃園,2024-04-02,9189
0056,元大高股息,125,9,116,群益金鼎-桃園,2024-04-02,9189
00679B,元大美債20年,105,0,105,群益金鼎-桃園,2024-04-02,9189
00937B,群益ESG投等債20,331,227,104,群益金鼎-桃園,2024-04-02,9189
2618,長榮航,106,10,96,群益金鼎-桃園,2024-04-02,9189
2324,仁寶,63,3,60,群益金鼎-桃園,2024-04-02,9189
00637L,元大滬深300正2,50,0,50,群益金鼎-桃園,2024-04-02,9189
2367,燿華,57,8,49,群益金鼎-桃園,2024-04-02,9189
00687B,國泰20年美債,44,0,44,群益金鼎-桃園,2024-04-02,9189
00933B,國泰10Y+金融債,38,0,38,群益金鼎-桃園,2024-04-02,9189
00688L,國泰20年美債正2,34,0,34,群益金鼎-桃園,2024-04-02,9189
5386,青雲,36,2,34,群益金鼎-桃園,2024-04-02,9189
2331,精英,34,0,34,群益金鼎-桃園,2024-04-02,9189
3357,臺慶科,31,0,31,群益金鼎-桃園,2024-04-02,9189
00680L,元大美債20正2,30,0,30,群益金鼎-桃園,2024-04-02,9189
6288,聯嘉,27,0,27,群益金鼎-桃園,2024-04-02,9189
00665L,富邦�琤肭磪囓�2,40,15,25,群益金鼎-桃園,2024-04-02,9189
00877,復華中國5G,24,0,24,群益金鼎-桃園,2024-04-02,9189
3706,神達,24,2,22,群益金鼎-桃園,2024-04-02,9189
2344,華邦電,21,0,21,群益金鼎-桃園,2024-04-02,9189
00941,中信上游半導體,20,0,20,群益金鼎-桃園,2024-04-02,9189
6026,福邦證,20,0,20,群益金鼎-桃園,2024-04-02,9189
2020,美亞,20,0,20,群益金鼎-桃園,2024-04-02,9189
00751B,元大AAA至A公司債,18,0,18,群益金鼎-桃園,2024-04-02,9189
1785,光洋科,21,3,18,群益金鼎-桃園,2024-04-02,9189
2834,臺企銀,15,0,15,群益金鼎-桃園,2024-04-02,9189
3312,弘憶股,15,0,15,群益金鼎-桃園,2024-04-02,9189
2528,皇普,14,0,14,群益金鼎-桃園,2024-04-02,9189
2417,圓剛,23,9,14,群益金鼎-桃園,2024-04-02,9189
1455,集盛,20,7,13,群益金鼎-桃園,2024-04-02,9189
2458,義隆,13,0,13,群益金鼎-桃園,2024-04-02,9189
2610,華航,15,2,13,群益金鼎-桃園,2024-04-02,9189
00939,統一台灣高息動能,16,3,13,群益金鼎-桃園,2024-04-02,9189
1905,華紙,12,0,12,群益金鼎-桃園,2024-04-02,9189
00740B,富邦全球投等債,12,0,12,群益金鼎-桃園,2024-04-02,9189
3004,豐達科,12,0,12,群益金鼎-桃園,2024-04-02,9189
2352,佳世達,20,8,12,群益金鼎-桃園,2024-04-02,9189
4576,大銀微系統,23,12,11,群益金鼎-桃園,2024-04-02,9189
9105,泰金寶-DR,11,0,11,群益金鼎-桃園,2024-04-02,9189
1305,華夏,11,0,11,群益金鼎-桃園,2024-04-02,9189
2887,台新金,11,1,10,群益金鼎-桃園,2024-04-02,9189
4513,福裕,10,0,10,群益金鼎-桃園,2024-04-02,9189
3057,喬鼎,10,0,10,群益金鼎-桃園,2024-04-02,9189
2888,新光金,10,0,10,群益金鼎-桃園,2024-04-02,9189
2471,資通,10,0,10,群益金鼎-桃園,2024-04-02,9189
00937B,群益ESG投等債20,286,100,186,群益金鼎-桃園,2024-04-03,9189
2440,太空梭,174,0,174,群益金鼎-桃園,2024-04-03,9189
00940,元大台灣價值高息,244,78,166,群益金鼎-桃園,2024-04-03,9189
00665L,富邦�琤肭磪囓�2,145,0,145,群益金鼎-桃園,2024-04-03,9189
2066,世德,145,18,127,群益金鼎-桃園,2024-04-03,9189
8085,福華,120,5,115,群益金鼎-桃園,2024-04-03,9189
2890,永豐金,106,0,106,群益金鼎-桃園,2024-04-03,9189
00679B,元大美債20年,100,0,100,群益金鼎-桃園,2024-04-03,9189
6016,康和證,100,0,100,群益金鼎-桃園,2024-04-03,9189
00927,群益半導體收益,96,10,86,群益金鼎-桃園,2024-04-03,9189
00929,復華台灣科技優息,65,0,65,群益金鼎-桃園,2024-04-03,9189
2618,長榮航,65,0,65,群益金鼎-桃園,2024-04-03,9189
2371,大同,62,4,58,群益金鼎-桃園,2024-04-03,9189
00680L,元大美債20正2,55,0,55,群益金鼎-桃園,2024-04-03,9189
2881,富邦金,54,0,54,群益金鼎-桃園,2024-04-03,9189
2313,華通,53,12,41,群益金鼎-桃園,2024-04-03,9189
2845,遠東銀,40,0,40,群益金鼎-桃園,2024-04-03,9189
1722,台肥,40,0,40,群益金鼎-桃園,2024-04-03,9189
00941,中信上游半導體,38,0,38,群益金鼎-桃園,2024-04-03,9189
1609,大亞,39,3,36,群益金鼎-桃園,2024-04-03,9189
2834,臺企銀,32,0,32,群益金鼎-桃園,2024-04-03,9189
2352,佳世達,40,11,29,群益金鼎-桃園,2024-04-03,9189
3481,群創,39,10,29,群益金鼎-桃園,2024-04-03,9189
2374,佳能,29,1,28,群益金鼎-桃園,2024-04-03,9189
1815,富喬,24,0,24,群益金鼎-桃園,2024-04-03,9189
6122,擎邦,23,0,23,群益金鼎-桃園,2024-04-03,9189
00687B,國泰20年美債,22,0,22,群益金鼎-桃園,2024-04-03,9189
5309,系統電,22,1,21,群益金鼎-桃園,2024-04-03,9189
2515,中工,40,19,21,群益金鼎-桃園,2024-04-03,9189
00720B,元大投資級公司債,20,0,20,群益金鼎-桃園,2024-04-03,9189
4938,和碩,21,1,20,群益金鼎-桃園,2024-04-03,9189
6213,聯茂,35,15,20,群益金鼎-桃園,2024-04-03,9189
00637L,元大滬深300正2,25,5,20,群益金鼎-桃園,2024-04-03,9189
2353,宏��,18,0,18,群益金鼎-桃園,2024-04-03,9189
00753L,中信中國50正2,22,4,18,群益金鼎-桃園,2024-04-03,9189
2324,仁寶,20,3,17,群益金鼎-桃園,2024-04-03,9189
2528,皇普,17,0,17,群益金鼎-桃園,2024-04-03,9189
2392,正崴,21,5,16,群益金鼎-桃園,2024-04-03,9189
8088,品安,16,0,16,群益金鼎-桃園,2024-04-03,9189
00751B,元大AAA至A公司債,16,0,16,群益金鼎-桃園,2024-04-03,9189
2301,光寶科,20,4,16,群益金鼎-桃園,2024-04-03,9189
2331,精英,15,0,15,群益金鼎-桃園,2024-04-03,9189
2727,王品,15,0,15,群益金鼎-桃園,2024-04-03,9189
3188,鑫龍騰,14,0,14,群益金鼎-桃園,2024-04-03,9189
6292,迅德,14,1,13,群益金鼎-桃園,2024-04-03,9189
8054,安國,53,40,13,群益金鼎-桃園,2024-04-03,9189
2486,一詮,66,54,12,群益金鼎-桃園,2024-04-03,9189
9945,潤泰新,42,30,12,群益金鼎-桃園,2024-04-03,9189
2449,京元電子,20,8,12,群益金鼎-桃園,2024-04-03,9189
0056,元大高股息,15,3,12,群益金鼎-桃園,2024-04-03,9189
00940,元大台灣價值高息,245,23,222,群益金鼎-桃園,2024-04-08,9189
00665L,富邦�琤肭磪囓�2,185,0,185,群益金鼎-桃園,2024-04-08,9189
00929,復華台灣科技優息,161,0,161,群益金鼎-桃園,2024-04-08,9189
00632R,元大台灣50反1,145,0,145,群益金鼎-桃園,2024-04-08,9189
00679B,元大美債20年,149,9,140,群益金鼎-桃園,2024-04-08,9189
2371,大同,129,5,124,群益金鼎-桃園,2024-04-08,9189
00919,群益台灣精選高息,104,12,92,群益金鼎-桃園,2024-04-08,9189
00927,群益半導體收益,63,0,63,群益金鼎-桃園,2024-04-08,9189
2362,藍天,57,0,57,群益金鼎-桃園,2024-04-08,9189
2356,英業達,79,24,55,群益金鼎-桃園,2024-04-08,9189
6164,華興,53,0,53,群益金鼎-桃園,2024-04-08,9189
2392,正崴,51,0,51,群益金鼎-桃園,2024-04-08,9189
00664R,國泰臺灣加權反1,50,0,50,群益金鼎-桃園,2024-04-08,9189
00680L,元大美債20正2,68,19,49,群益金鼎-桃園,2024-04-08,9189
6016,康和證,55,10,45,群益金鼎-桃園,2024-04-08,9189
00687B,國泰20年美債,50,6,44,群益金鼎-桃園,2024-04-08,9189
2891,中信金,50,6,44,群益金鼎-桃園,2024-04-08,9189
2809,京城銀,41,0,41,群益金鼎-桃園,2024-04-08,9189
2888,新光金,38,0,38,群益金鼎-桃園,2024-04-08,9189
00720B,元大投資級公司債,40,7,33,群益金鼎-桃園,2024-04-08,9189
00933B,國泰10Y+金融債,26,0,26,群益金鼎-桃園,2024-04-08,9189
00931B,統一美債20年,26,0,26,群益金鼎-桃園,2024-04-08,9189
3059,華晶科,34,10,24,群益金鼎-桃園,2024-04-08,9189
8111,立��,24,1,23,群益金鼎-桃園,2024-04-08,9189
5443,均豪,40,17,23,群益金鼎-桃園,2024-04-08,9189
00688L,國泰20年美債正2,22,0,22,群益金鼎-桃園,2024-04-08,9189
4510,高鋒,21,0,21,群益金鼎-桃園,2024-04-08,9189
5324,士開,21,0,21,群益金鼎-桃園,2024-04-08,9189
8064,東捷,25,4,21,群益金鼎-桃園,2024-04-08,9189
2547,日勝生,20,0,20,群益金鼎-桃園,2024-04-08,9189
4714,永捷,38,19,19,群益金鼎-桃園,2024-04-08,9189
6122,擎邦,19,0,19,群益金鼎-桃園,2024-04-08,9189
6237,驊訊,19,0,19,群益金鼎-桃園,2024-04-08,9189
2303,聯電,24,7,17,群益金鼎-桃園,2024-04-08,9189
4958,臻鼎-KY,21,6,15,群益金鼎-桃園,2024-04-08,9189
3032,偉訓,24,9,15,群益金鼎-桃園,2024-04-08,9189
8996,高力,22,7,15,群益金鼎-桃園,2024-04-08,9189
6288,聯嘉,27,13,14,群益金鼎-桃園,2024-04-08,9189
00733,富邦臺灣中小,16,2,14,群益金鼎-桃園,2024-04-08,9189
00937B,群益ESG投等債20,114,100,14,群益金鼎-桃園,2024-04-08,9189
1609,大亞,26,13,13,群益金鼎-桃園,2024-04-08,9189
1513,中興電,43,31,12,群益金鼎-桃園,2024-04-08,9189
2515,中工,12,0,12,群益金鼎-桃園,2024-04-08,9189
2355,敬鵬,11,0,11,群益金鼎-桃園,2024-04-08,9189
1785,光洋科,11,0,11,群益金鼎-桃園,2024-04-08,9189
2884,玉山金,12,1,11,群益金鼎-桃園,2024-04-08,9189
2611,志信,12,1,11,群益金鼎-桃園,2024-04-08,9189
00751B,元大AAA至A公司債,11,0,11,群益金鼎-桃園,2024-04-08,9189
6179,亞通,18,8,10,群益金鼎-桃園,2024-04-08,9189
00637L,元大滬深300正2,10,0,10,群益金鼎-桃園,2024-04-08,9189
00632R,元大台灣50反1,448,13,435,群益金鼎-桃園,2024-04-09,9189
00664R,國泰臺灣加權反1,279,0,279,群益金鼎-桃園,2024-04-09,9189
2440,太空梭,148,0,148,群益金鼎-桃園,2024-04-09,9189
00929,復華台灣科技優息,105,9,96,群益金鼎-桃園,2024-04-09,9189
00940,元大台灣價值高息,108,35,73,群益金鼎-桃園,2024-04-09,9189
1524,耿鼎,74,6,68,群益金鼎-桃園,2024-04-09,9189
2888,新光金,60,1,59,群益金鼎-桃園,2024-04-09,9189
00937B,群益ESG投等債20,59,1,58,群益金鼎-桃園,2024-04-09,9189
6005,群益證,66,10,56,群益金鼎-桃園,2024-04-09,9189
3052,夆典,50,0,50,群益金鼎-桃園,2024-04-09,9189
2371,大同,84,37,47,群益金鼎-桃園,2024-04-09,9189
00679B,元大美債20年,47,5,42,群益金鼎-桃園,2024-04-09,9189
2317,鴻海,64,28,36,群益金鼎-桃園,2024-04-09,9189
3042,晶技,35,0,35,群益金鼎-桃園,2024-04-09,9189
00687B,國泰20年美債,33,0,33,群益金鼎-桃園,2024-04-09,9189
2537,聯上發,35,3,32,群益金鼎-桃園,2024-04-09,9189
4909,新復興,35,3,32,群益金鼎-桃園,2024-04-09,9189
2367,燿華,59,29,30,群益金鼎-桃園,2024-04-09,9189
1104,環泥,30,0,30,群益金鼎-桃園,2024-04-09,9189
8034,榮群,30,4,26,群益金鼎-桃園,2024-04-09,9189
2354,鴻準,50,29,21,群益金鼎-桃園,2024-04-09,9189
2313,華通,23,5,18,群益金鼎-桃園,2024-04-09,9189
6189,豐藝,30,12,18,群益金鼎-桃園,2024-04-09,9189
3062,建漢,15,0,15,群益金鼎-桃園,2024-04-09,9189
5443,均豪,46,31,15,群益金鼎-桃園,2024-04-09,9189
2382,廣達,18,5,13,群益金鼎-桃園,2024-04-09,9189
6188,廣明,37,23,14,群益金鼎-桃園,2024-04-09,9189
3363,上詮,31,18,13,群益金鼎-桃園,2024-04-09,9189
2356,英業達,21,8,13,群益金鼎-桃園,2024-04-09,9189
3312,弘憶股,13,0,13,群益金鼎-桃園,2024-04-09,9189
2453,凌群,14,1,13,群益金鼎-桃園,2024-04-09,9189
4576,大銀微系統,13,0,13,群益金鼎-桃園,2024-04-09,9189
6257,矽格,22,9,13,群益金鼎-桃園,2024-04-09,9189
6284,佳邦,12,0,12,群益金鼎-桃園,2024-04-09,9189
1409,新纖,12,0,12,群益金鼎-桃園,2024-04-09,9189
00939,統一台灣高息動能,40,28,12,群益金鼎-桃園,2024-04-09,9189
3036,文曄,13,2,11,群益金鼎-桃園,2024-04-09,9189
5347,世界,12,1,11,群益金鼎-桃園,2024-04-09,9189
2387,精元,11,0,11,群益金鼎-桃園,2024-04-09,9189
2344,華邦電,21,10,11,群益金鼎-桃園,2024-04-09,9189
8234,新漢,11,0,11,群益金鼎-桃園,2024-04-09,9189
4306,炎洲,16,5,11,群益金鼎-桃園,2024-04-09,9189
2069,運錩,11,0,11,群益金鼎-桃園,2024-04-09,9189
00885,富邦越南,10,0,10,群益金鼎-桃園,2024-04-09,9189
6207,雷科,45,35,10,群益金鼎-桃園,2024-04-09,9189
1529,樂事綠能,11,1,10,群益金鼎-桃園,2024-04-09,9189
1536,和大,10,0,10,群益金鼎-桃園,2024-04-09,9189
4967,十銓,17,7,10,群益金鼎-桃園,2024-04-09,9189
1453,大將,10,0,10,群益金鼎-桃園,2024-04-09,9189
2025,千興,10,0,10,群益金鼎-桃園,2024-04-09,9189
6016,康和證,422,52,370,群益金鼎-桃園,2024-04-10,9189
00937B,群益ESG投等債20,218,40,178,群益金鼎-桃園,2024-04-10,9189
2440,太空梭,115,0,115,群益金鼎-桃園,2024-04-10,9189
2501,國建,111,11,100,群益金鼎-桃園,2024-04-10,9189
3481,群創,106,31,75,群益金鼎-桃園,2024-04-10,9189
00940,元大台灣價值高息,111,43,68,群益金鼎-桃園,2024-04-10,9189
2515,中工,79,19,60,群益金鼎-桃園,2024-04-10,9189
1609,大亞,91,31,60,群益金鼎-桃園,2024-04-10,9189
00720B,元大投資級公司債,56,0,56,群益金鼎-桃園,2024-04-10,9189
2323,中環,50,0,50,群益金鼎-桃園,2024-04-10,9189
8096,擎亞,157,118,39,群益金鼎-桃園,2024-04-10,9189
00679B,元大美債20年,40,2,38,群益金鼎-桃園,2024-04-10,9189
3703,欣陸,36,0,36,群益金鼎-桃園,2024-04-10,9189
3231,緯創,41,10,31,群益金鼎-桃園,2024-04-10,9189
6753,龍德造船,30,1,29,群益金鼎-桃園,2024-04-10,9189
3312,弘憶股,30,5,25,群益金鼎-桃園,2024-04-10,9189
00740B,富邦全球投等債,31,7,24,群益金鼎-桃園,2024-04-10,9189
2634,漢翔,48,25,23,群益金鼎-桃園,2024-04-10,9189
8064,東捷,32,10,22,群益金鼎-桃園,2024-04-10,9189
00687B,國泰20年美債,21,0,21,群益金鼎-桃園,2024-04-10,9189
2609,陽明,25,4,21,群益金鼎-桃園,2024-04-10,9189
2459,敦吉,20,0,20,群益金鼎-桃園,2024-04-10,9189
00706L,期元大S＆P日圓正2,20,0,20,群益金鼎-桃園,2024-04-10,9189
1736,喬山,26,6,20,群益金鼎-桃園,2024-04-10,9189
2601,益航,20,1,19,群益金鼎-桃園,2024-04-10,9189
2408,南亞科,30,12,18,群益金鼎-桃園,2024-04-10,9189
2382,廣達,19,2,17,群益金鼎-桃園,2024-04-10,9189
2367,燿華,21,4,17,群益金鼎-桃園,2024-04-10,9189
1503,士電,41,24,17,群益金鼎-桃園,2024-04-10,9189
00878,國泰永續高股息,28,12,16,群益金鼎-桃園,2024-04-10,9189
2014,中鴻,74,58,16,群益金鼎-桃園,2024-04-10,9189
5488,松普,21,5,16,群益金鼎-桃園,2024-04-10,9189
2330,台積電,19,3,16,群益金鼎-桃園,2024-04-10,9189
1514,亞力,57,42,15,群益金鼎-桃園,2024-04-10,9189
1608,華榮,20,5,15,群益金鼎-桃園,2024-04-10,9189
2007,燁興,15,1,14,群益金鼎-桃園,2024-04-10,9189
2885,元大金,13,0,13,群益金鼎-桃園,2024-04-10,9189
2390,云辰,10,0,10,群益金鼎-桃園,2024-04-10,9189
8034,榮群,10,0,10,群益金鼎-桃園,2024-04-10,9189
3450,聯鈞,35,25,10,群益金鼎-桃園,2024-04-10,9189
8210,勤誠,11,1,10,群益金鼎-桃園,2024-04-10,9189
00692,富邦公司治理,10,0,10,群益金鼎-桃園,2024-04-10,9189
8092,建暐,10,0,10,群益金鼎-桃園,2024-04-10,9189
00902,中信電池及儲能,10,0,10,群益金鼎-桃園,2024-04-10,9189
4513,福裕,11,1,10,群益金鼎-桃園,2024-04-10,9189
5443,均豪,29,19,10,群益金鼎-桃園,2024-04-10,9189
6477,安集,10,0,10,群益金鼎-桃園,2024-04-10,9189
6274,台燿,20,11,9,群益金鼎-桃園,2024-04-10,9189
1504,東元,16,7,9,群益金鼎-桃園,2024-04-10,9189
2374,佳能,13,4,9,群益金鼎-桃園,2024-04-10,9189
2440,太空梭,254,0,254,群益金鼎-桃園,2024-04-11,9189
00937B,群益ESG投等債20,169,11,158,群益金鼎-桃園,2024-04-11,9189
00665L,富邦�琤肭磪囓�2,250,100,150,群益金鼎-桃園,2024-04-11,9189
2501,國建,158,15,143,群益金鼎-桃園,2024-04-11,9189
3481,群創,170,29,141,群益金鼎-桃園,2024-04-11,9189
2409,友達,110,5,105,群益金鼎-桃園,2024-04-11,9189
2313,華通,87,3,84,群益金鼎-桃園,2024-04-11,9189
00679B,元大美債20年,79,1,78,群益金鼎-桃園,2024-04-11,9189
00680L,元大美債20正2,75,1,74,群益金鼎-桃園,2024-04-11,9189
2888,新光金,69,0,69,群益金鼎-桃園,2024-04-11,9189
00940,元大台灣價值高息,68,3,65,群益金鼎-桃園,2024-04-11,9189
2344,華邦電,60,1,59,群益金鼎-桃園,2024-04-11,9189
8096,擎亞,65,12,53,群益金鼎-桃園,2024-04-11,9189
2355,敬鵬,49,0,49,群益金鼎-桃園,2024-04-11,9189
2002,中鋼,50,3,47,群益金鼎-桃園,2024-04-11,9189
00687B,國泰20年美債,56,9,47,群益金鼎-桃園,2024-04-11,9189
00929,復華台灣科技優息,61,16,45,群益金鼎-桃園,2024-04-11,9189
00720B,元大投資級公司債,45,4,41,群益金鼎-桃園,2024-04-11,9189
00919,群益台灣精選高息,41,1,40,群益金鼎-桃園,2024-04-11,9189
1605,華新,67,30,37,群益金鼎-桃園,2024-04-11,9189
00688L,國泰20年美債正2,35,0,35,群益金鼎-桃園,2024-04-11,9189
3231,緯創,44,11,33,群益金鼎-桃園,2024-04-11,9189
8011,台通,45,13,32,群益金鼎-桃園,2024-04-11,9189
2882,國泰金,42,11,31,群益金鼎-桃園,2024-04-11,9189
2312,金寶,30,0,30,群益金鼎-桃園,2024-04-11,9189
6215,和椿,32,3,29,群益金鼎-桃園,2024-04-11,9189
00795B,中信美國公債20年,23,0,23,群益金鼎-桃園,2024-04-11,9189
6770,力積電,26,6,20,群益金鼎-桃園,2024-04-11,9189
1611,中電,20,0,20,群益金鼎-桃園,2024-04-11,9189
1514,亞力,39,20,19,群益金鼎-桃園,2024-04-11,9189
2303,聯電,30,13,17,群益金鼎-桃園,2024-04-11,9189
1609,大亞,42,25,17,群益金鼎-桃園,2024-04-11,9189
00712,復華富時不動產,17,1,16,群益金鼎-桃園,2024-04-11,9189
00719B,元大美債1-3,16,0,16,群益金鼎-桃園,2024-04-11,9189
3372,典範,15,0,15,群益金鼎-桃園,2024-04-11,9189
4513,福裕,20,5,15,群益金鼎-桃園,2024-04-11,9189
2464,盟立,18,3,15,群益金鼎-桃園,2024-04-11,9189
00939,統一台灣高息動能,14,0,14,群益金鼎-桃園,2024-04-11,9189
2371,大同,49,35,14,群益金鼎-桃園,2024-04-11,9189
3545,敦泰,14,0,14,群益金鼎-桃園,2024-04-11,9189
00931B,統一美債20年,14,0,14,群益金鼎-桃園,2024-04-11,9189
2883,凱基金,13,0,13,群益金鼎-桃園,2024-04-11,9189
5864,致和證,13,0,13,群益金鼎-桃園,2024-04-11,9189
3234,光環,13,0,13,群益金鼎-桃園,2024-04-11,9189
2393,億光,13,0,13,群益金鼎-桃園,2024-04-11,9189
00722B,群益投資級電信債,12,0,12,群益金鼎-桃園,2024-04-11,9189
2852,第一保,20,8,12,群益金鼎-桃園,2024-04-11,9189
3035,智原,12,1,11,群益金鼎-桃園,2024-04-11,9189
3060,銘異,50,39,11,群益金鼎-桃園,2024-04-11,9189
1527,鑽全,13,2,11,群益金鼎-桃園,2024-04-11,9189
2440,太空梭,224,0,224,群益金鼎-桃園,2024-04-12,9189
00929,復華台灣科技優息,227,41,186,群益金鼎-桃園,2024-04-12,9189
2618,長榮航,172,13,159,群益金鼎-桃園,2024-04-12,9189
00665L,富邦�琤肭磪囓�2,110,0,110,群益金鼎-桃園,2024-04-12,9189
912000,晨訊科-DR,100,0,100,群益金鼎-桃園,2024-04-12,9189
1605,華新,152,68,84,群益金鼎-桃園,2024-04-12,9189
9958,世紀鋼,81,4,77,群益金鼎-桃園,2024-04-12,9189
3481,群創,93,33,60,群益金鼎-桃園,2024-04-12,9189
00937B,群益ESG投等債20,75,16,59,群益金鼎-桃園,2024-04-12,9189
2867,三商壽,62,5,57,群益金鼎-桃園,2024-04-12,9189
2542,興富發,50,0,50,群益金鼎-桃園,2024-04-12,9189
2382,廣達,48,2,46,群益金鼎-桃園,2024-04-12,9189
2406,國碩,51,7,44,群益金鼎-桃園,2024-04-12,9189
2344,華邦電,42,0,42,群益金鼎-桃園,2024-04-12,9189
00687B,國泰20年美債,40,0,40,群益金鼎-桃園,2024-04-12,9189
2883,凱基金,39,4,35,群益金鼎-桃園,2024-04-12,9189
8047,星雲,35,0,35,群益金鼎-桃園,2024-04-12,9189
00720B,元大投資級公司債,64,30,34,群益金鼎-桃園,2024-04-12,9189
00940,元大台灣價值高息,99,65,34,群益金鼎-桃園,2024-04-12,9189
00933B,國泰10Y+金融債,30,2,28,群益金鼎-桃園,2024-04-12,9189
00679B,元大美債20年,28,0,28,群益金鼎-桃園,2024-04-12,9189
00795B,中信美國公債20年,27,0,27,群益金鼎-桃園,2024-04-12,9189
6244,茂迪,25,0,25,群益金鼎-桃園,2024-04-12,9189
1515,力山,23,0,23,群益金鼎-桃園,2024-04-12,9189
3260,威剛,73,50,23,群益金鼎-桃園,2024-04-12,9189
2353,宏��,55,35,20,群益金鼎-桃園,2024-04-12,9189
2547,日勝生,19,0,19,群益金鼎-桃園,2024-04-12,9189
2515,中工,30,12,18,群益金鼎-桃園,2024-04-12,9189
2374,佳能,55,39,16,群益金鼎-桃園,2024-04-12,9189
3284,太普高,15,0,15,群益金鼎-桃園,2024-04-12,9189
2888,新光金,15,0,15,群益金鼎-桃園,2024-04-12,9189
3231,緯創,30,15,15,群益金鼎-桃園,2024-04-12,9189
2303,聯電,23,10,13,群益金鼎-桃園,2024-04-12,9189
2049,上銀,13,0,13,群益金鼎-桃園,2024-04-12,9189
8096,擎亞,29,16,13,群益金鼎-桃園,2024-04-12,9189
2483,百容,13,0,13,群益金鼎-桃園,2024-04-12,9189
2031,新光鋼,13,0,13,群益金鼎-桃園,2024-04-12,9189
00919,群益台灣精選高息,15,3,12,群益金鼎-桃園,2024-04-12,9189
8926,台汽電,13,1,12,群益金鼎-桃園,2024-04-12,9189
2409,友達,34,22,12,群益金鼎-桃園,2024-04-12,9189
3013,晟銘電,52,40,12,群益金鼎-桃園,2024-04-12,9189
5425,台半,12,0,12,群益金鼎-桃園,2024-04-12,9189
6425,易發,13,1,12,群益金鼎-桃園,2024-04-12,9189
4303,信立,11,0,11,群益金鼎-桃園,2024-04-12,9189
00941,中信上游半導體,17,6,11,群益金鼎-桃園,2024-04-12,9189
00751B,元大AAA至A公司債,11,0,11,群益金鼎-桃園,2024-04-12,9189
00909,國泰數位支付服務,11,0,11,群益金鼎-桃園,2024-04-12,9189
00857B,永豐20年美公債,11,0,11,群益金鼎-桃園,2024-04-12,9189
8112,至上,28,18,10,群益金鼎-桃園,2024-04-12,9189
4938,和碩,12,2,10,群益金鼎-桃園,2024-04-12,9189
2440,太空梭,212,0,212,群益金鼎-桃園,2024-04-15,9189
00929,復華台灣科技優息,215,22,193,群益金鼎-桃園,2024-04-15,9189
00927,群益半導體收益,167,5,162,群益金鼎-桃園,2024-04-15,9189
2367,燿華,174,23,151,群益金鼎-桃園,2024-04-15,9189
00706L,期元大S＆P日圓正2,105,0,105,群益金鼎-桃園,2024-04-15,9189
8064,東捷,81,0,81,群益金鼎-桃園,2024-04-15,9189
2313,華通,70,3,67,群益金鼎-桃園,2024-04-15,9189
1513,中興電,136,80,56,群益金鼎-桃園,2024-04-15,9189
5381,合正,85,31,54,群益金鼎-桃園,2024-04-15,9189
1608,華榮,92,41,51,群益金鼎-桃園,2024-04-15,9189
00940,元大台灣價值高息,68,18,50,群益金鼎-桃園,2024-04-15,9189
2002,中鋼,49,0,49,群益金鼎-桃園,2024-04-15,9189
2883,凱基金,49,2,47,群益金鼎-桃園,2024-04-15,9189
3060,銘異,63,16,47,群益金鼎-桃園,2024-04-15,9189
00919,群益台灣精選高息,96,52,44,群益金鼎-桃園,2024-04-15,9189
2344,華邦電,43,12,31,群益金鼎-桃園,2024-04-15,9189
0056,元大高股息,29,1,28,群益金鼎-桃園,2024-04-15,9189
2317,鴻海,50,22,28,群益金鼎-桃園,2024-04-15,9189
2355,敬鵬,28,1,27,群益金鼎-桃園,2024-04-15,9189
2371,大同,219,192,27,群益金鼎-桃園,2024-04-15,9189
3015,全漢,30,4,26,群益金鼎-桃園,2024-04-15,9189
2515,中工,64,39,25,群益金鼎-桃園,2024-04-15,9189
2618,長榮航,51,27,24,群益金鼎-桃園,2024-04-15,9189
9933,中鼎,24,0,24,群益金鼎-桃園,2024-04-15,9189
5324,士開,24,0,24,群益金鼎-桃園,2024-04-15,9189
8234,新漢,23,0,23,群益金鼎-桃園,2024-04-15,9189
00720B,元大投資級公司債,22,0,22,群益金鼎-桃園,2024-04-15,9189
00909,國泰數位支付服務,22,0,22,群益金鼎-桃園,2024-04-15,9189
1605,華新,172,150,22,群益金鼎-桃園,2024-04-15,9189
9105,泰金寶-DR,23,2,21,群益金鼎-桃園,2024-04-15,9189
2537,聯上發,20,0,20,群益金鼎-桃園,2024-04-15,9189
1785,光洋科,43,25,18,群益金鼎-桃園,2024-04-15,9189
1717,長興,21,4,17,群益金鼎-桃園,2024-04-15,9189
8112,至上,19,3,16,群益金鼎-桃園,2024-04-15,9189
00679B,元大美債20年,16,0,16,群益金鼎-桃園,2024-04-15,9189
6248,沛波,17,1,16,群益金鼎-桃園,2024-04-15,9189
1504,東元,117,102,15,群益金鼎-桃園,2024-04-15,9189
00891,中信關鍵半導體,15,0,15,群益金鼎-桃園,2024-04-15,9189
5880,合庫金,20,5,15,群益金鼎-桃園,2024-04-15,9189
3231,緯創,25,11,14,群益金鼎-桃園,2024-04-15,9189
3037,欣興,15,1,14,群益金鼎-桃園,2024-04-15,9189
3013,晟銘電,17,3,14,群益金鼎-桃園,2024-04-15,9189
5213,亞昕,14,0,14,群益金鼎-桃園,2024-04-15,9189
1453,大將,13,0,13,群益金鼎-桃園,2024-04-15,9189
00878,國泰永續高股息,13,0,13,群益金鼎-桃園,2024-04-15,9189
2356,英業達,29,17,12,群益金鼎-桃園,2024-04-15,9189
4541,晟田,12,0,12,群益金鼎-桃園,2024-04-15,9189
1455,集盛,13,1,12,群益金鼎-桃園,2024-04-15,9189
2836,高雄銀,12,0,12,群益金鼎-桃園,2024-04-15,9189
00733,富邦臺灣中小,17,6,11,群益金鼎-桃園,2024-04-15,9189
00940,元大台灣價值高息,619,66,553,群益金鼎-桃園,2024-04-16,9189
00937B,群益ESG投等債20,400,100,300,群益金鼎-桃園,2024-04-16,9189
00919,群益台灣精選高息,310,24,286,群益金鼎-桃園,2024-04-16,9189
00929,復華台灣科技優息,208,58,150,群益金鼎-桃園,2024-04-16,9189
00939,統一台灣高息動能,145,0,145,群益金鼎-桃園,2024-04-16,9189
00706L,期元大S＆P日圓正2,90,0,90,群益金鼎-桃園,2024-04-16,9189
2618,長榮航,99,9,90,群益金鼎-桃園,2024-04-16,9189
2888,新光金,89,2,87,群益金鼎-桃園,2024-04-16,9189
1605,華新,105,20,85,群益金鼎-桃園,2024-04-16,9189
2440,太空梭,80,0,80,群益金鼎-桃園,2024-04-16,9189
1609,大亞,187,125,62,群益金鼎-桃園,2024-04-16,9189
3231,緯創,75,14,61,群益金鼎-桃園,2024-04-16,9189
8064,東捷,50,0,50,群益金鼎-桃園,2024-04-16,9189
2303,聯電,53,5,48,群益金鼎-桃園,2024-04-16,9189
2356,英業達,48,2,46,群益金鼎-桃園,2024-04-16,9189
5324,士開,45,1,44,群益金鼎-桃園,2024-04-16,9189
00720B,元大投資級公司債,73,30,43,群益金鼎-桃園,2024-04-16,9189
1504,東元,67,29,38,群益金鼎-桃園,2024-04-16,9189
2885,元大金,41,5,36,群益金鼎-桃園,2024-04-16,9189
00933B,國泰10Y+金融債,40,6,34,群益金鼎-桃園,2024-04-16,9189
3260,威剛,50,17,33,群益金鼎-桃園,2024-04-16,9189
3481,群創,71,39,32,群益金鼎-桃園,2024-04-16,9189
6016,康和證,32,0,32,群益金鼎-桃園,2024-04-16,9189
6153,嘉聯益,30,0,30,群益金鼎-桃園,2024-04-16,9189
5299,杰力,30,1,29,群益金鼎-桃園,2024-04-16,9189
8105,凌巨,30,2,28,群益金鼎-桃園,2024-04-16,9189
2313,華通,29,2,27,群益金鼎-桃園,2024-04-16,9189
3706,神達,30,3,27,群益金鼎-桃園,2024-04-16,9189
00927,群益半導體收益,30,3,27,群益金鼎-桃園,2024-04-16,9189
1810,和成,27,0,27,群益金鼎-桃園,2024-04-16,9189
00918,大華優利高填息30,27,1,26,群益金鼎-桃園,2024-04-16,9189
2408,南亞科,52,26,26,群益金鼎-桃園,2024-04-16,9189
00712,復華富時不動產,26,0,26,群益金鼎-桃園,2024-04-16,9189
5381,合正,26,0,26,群益金鼎-桃園,2024-04-16,9189
00905,FT臺灣Smart,25,0,25,群益金鼎-桃園,2024-04-16,9189
1513,中興電,50,25,25,群益金鼎-桃園,2024-04-16,9189
2884,玉山金,32,8,24,群益金鼎-桃園,2024-04-16,9189
00878,國泰永續高股息,45,22,23,群益金鼎-桃園,2024-04-16,9189
00936,台新永續高息中小,22,0,22,群益金鼎-桃園,2024-04-16,9189
1101,台泥,21,0,21,群益金鼎-桃園,2024-04-16,9189
2007,燁興,23,2,21,群益金鼎-桃園,2024-04-16,9189
2308,台達電,20,0,20,群益金鼎-桃園,2024-04-16,9189
2330,台積電,27,7,20,群益金鼎-桃園,2024-04-16,9189
9945,潤泰新,22,2,20,群益金鼎-桃園,2024-04-16,9189
5871,中租-KY,21,1,20,群益金鼎-桃園,2024-04-16,9189
6120,達運,20,0,20,群益金鼎-桃園,2024-04-16,9189
2801,彰銀,40,20,20,群益金鼎-桃園,2024-04-16,9189
6282,康舒,19,0,19,群益金鼎-桃園,2024-04-16,9189
2609,陽明,19,0,19,群益金鼎-桃園,2024-04-16,9189
2515,中工,27,8,19,群益金鼎-桃園,2024-04-16,9189
00940,元大台灣價值高息,158,11,147,群益金鼎-桃園,2024-04-17,9189
2440,太空梭,90,0,90,群益金鼎-桃園,2024-04-17,9189
00632R,元大台灣50反1,171,103,68,群益金鼎-桃園,2024-04-17,9189
2618,長榮航,78,11,67,群益金鼎-桃園,2024-04-17,9189
00929,復華台灣科技優息,93,27,66,群益金鼎-桃園,2024-04-17,9189
0056,元大高股息,60,1,59,群益金鼎-桃園,2024-04-17,9189
00665L,富邦�琤肭磪囓�2,180,130,50,群益金鼎-桃園,2024-04-17,9189
00680L,元大美債20正2,50,0,50,群益金鼎-桃園,2024-04-17,9189
1616,億泰,51,7,44,群益金鼎-桃園,2024-04-17,9189
00919,群益台灣精選高息,61,21,40,群益金鼎-桃園,2024-04-17,9189
2303,聯電,43,7,36,群益金鼎-桃園,2024-04-17,9189
00720B,元大投資級公司債,62,30,32,群益金鼎-桃園,2024-04-17,9189
00687B,國泰20年美債,41,10,31,群益金鼎-桃園,2024-04-17,9189
2353,宏��,34,3,31,群益金鼎-桃園,2024-04-17,9189
00679B,元大美債20年,40,12,28,群益金鼎-桃園,2024-04-17,9189
2501,國建,95,68,27,群益金鼎-桃園,2024-04-17,9189
6743,安普新,27,0,27,群益金鼎-桃園,2024-04-17,9189
00712,復華富時不動產,27,0,27,群益金鼎-桃園,2024-04-17,9189
4513,福裕,24,1,23,群益金鼎-桃園,2024-04-17,9189
00905,FT臺灣Smart,21,0,21,群益金鼎-桃園,2024-04-17,9189
2363,矽統,38,17,21,群益金鼎-桃園,2024-04-17,9189
00937B,群益ESG投等債20,162,141,21,群益金鼎-桃園,2024-04-17,9189
3490,單井,80,60,20,群益金鼎-桃園,2024-04-17,9189
2884,玉山金,30,10,20,群益金鼎-桃園,2024-04-17,9189
2020,美亞,20,0,20,群益金鼎-桃園,2024-04-17,9189
6443,元晶,21,1,20,群益金鼎-桃園,2024-04-17,9189
3231,緯創,39,19,20,群益金鼎-桃園,2024-04-17,9189
6770,力積電,21,2,19,群益金鼎-桃園,2024-04-17,9189
3481,群創,19,0,19,群益金鼎-桃園,2024-04-17,9189
3494,誠研,19,0,19,群益金鼎-桃園,2024-04-17,9189
00931B,統一美債20年,19,0,19,群益金鼎-桃園,2024-04-17,9189
00933B,國泰10Y+金融債,18,0,18,群益金鼎-桃園,2024-04-17,9189
00733,富邦臺灣中小,18,0,18,群益金鼎-桃園,2024-04-17,9189
2409,友達,18,0,18,群益金鼎-桃園,2024-04-17,9189
1101,台泥,19,2,17,群益金鼎-桃園,2024-04-17,9189
2537,聯上發,15,0,15,群益金鼎-桃園,2024-04-17,9189
2101,南港,35,20,15,群益金鼎-桃園,2024-04-17,9189
2883,凱基金,14,0,14,群益金鼎-桃園,2024-04-17,9189
6548,長科*,14,0,14,群益金鼎-桃園,2024-04-17,9189
2344,華邦電,19,6,13,群益金鼎-桃園,2024-04-17,9189
00927,群益半導體收益,13,0,13,群益金鼎-桃園,2024-04-17,9189
4726,永昕,13,0,13,群益金鼎-桃園,2024-04-17,9189
2615,萬海,13,0,13,群益金鼎-桃園,2024-04-17,9189
2368,金像電,17,5,12,群益金鼎-桃園,2024-04-17,9189
2610,華航,14,2,12,群益金鼎-桃園,2024-04-17,9189
3013,晟銘電,28,16,12,群益金鼎-桃園,2024-04-17,9189
2515,中工,18,6,12,群益金鼎-桃園,2024-04-17,9189
1808,潤隆,14,3,11,群益金鼎-桃園,2024-04-17,9189
2606,裕民,11,0,11,群益金鼎-桃園,2024-04-17,9189
00675L,富邦臺灣加權正2,11,0,11,群益金鼎-桃園,2024-04-17,9189
00929,復華台灣科技優息,434,7,427,群益金鼎-桃園,2024-04-18,9189
3481,群創,463,311,152,群益金鼎-桃園,2024-04-18,9189
00937B,群益ESG投等債20,126,0,126,群益金鼎-桃園,2024-04-18,9189
00664R,國泰臺灣加權反1,120,0,120,群益金鼎-桃園,2024-04-18,9189
00940,元大台灣價值高息,72,5,67,群益金鼎-桃園,2024-04-18,9189
1504,東元,238,186,52,群益金鼎-桃園,2024-04-18,9189
00668,國泰美國道瓊,45,0,45,群益金鼎-桃園,2024-04-18,9189
6015,宏遠證,44,0,44,群益金鼎-桃園,2024-04-18,9189
1611,中電,40,1,39,群益金鼎-桃園,2024-04-18,9189
2303,聯電,34,1,33,群益金鼎-桃園,2024-04-18,9189
5512,力麒,66,34,32,群益金鼎-桃園,2024-04-18,9189
00919,群益台灣精選高息,31,0,31,群益金鼎-桃園,2024-04-18,9189
00632R,元大台灣50反1,138,107,31,群益金鼎-桃園,2024-04-18,9189
6190,萬泰科,30,0,30,群益金鼎-桃園,2024-04-18,9189
00753L,中信中國50正2,30,0,30,群益金鼎-桃園,2024-04-18,9189
6282,康舒,39,13,26,群益金鼎-桃園,2024-04-18,9189
1608,華榮,93,69,24,群益金鼎-桃園,2024-04-18,9189
1722,台肥,23,0,23,群益金鼎-桃園,2024-04-18,9189
1609,大亞,130,109,21,群益金鼎-桃園,2024-04-18,9189
0056,元大高股息,22,1,21,群益金鼎-桃園,2024-04-18,9189
00687B,國泰20年美債,25,5,20,群益金鼎-桃園,2024-04-18,9189
8927,北基,20,0,20,群益金鼎-桃園,2024-04-18,9189
00941,中信上游半導體,19,0,19,群益金鼎-桃園,2024-04-18,9189
3296,勝德,22,3,19,群益金鼎-桃園,2024-04-18,9189
00733,富邦臺灣中小,18,0,18,群益金鼎-桃園,2024-04-18,9189
1531,高林股,17,0,17,群益金鼎-桃園,2024-04-18,9189
00679B,元大美債20年,17,0,17,群益金鼎-桃園,2024-04-18,9189
6016,康和證,17,0,17,群益金鼎-桃園,2024-04-18,9189
2353,宏��,28,11,17,群益金鼎-桃園,2024-04-18,9189
1785,光洋科,17,1,16,群益金鼎-桃園,2024-04-18,9189
2371,大同,178,162,16,群益金鼎-桃園,2024-04-18,9189
5515,建國,20,6,14,群益金鼎-桃園,2024-04-18,9189
00712,復華富時不動產,14,0,14,群益金鼎-桃園,2024-04-18,9189
6223,旺矽,17,3,14,群益金鼎-桃園,2024-04-18,9189
9933,中鼎,17,3,14,群益金鼎-桃園,2024-04-18,9189
2406,國碩,16,3,13,群益金鼎-桃園,2024-04-18,9189
2440,太空梭,13,0,13,群益金鼎-桃園,2024-04-18,9189
2501,國建,71,59,12,群益金鼎-桃園,2024-04-18,9189
9962,有益,12,0,12,群益金鼎-桃園,2024-04-18,9189
2352,佳世達,17,6,11,群益金鼎-桃園,2024-04-18,9189
00927,群益半導體收益,11,0,11,群益金鼎-桃園,2024-04-18,9189
1101,台泥,21,10,11,群益金鼎-桃園,2024-04-18,9189
3715,定穎投控,11,0,11,群益金鼎-桃園,2024-04-18,9189
2301,光寶科,14,4,10,群益金鼎-桃園,2024-04-18,9189
2408,南亞科,11,1,10,群益金鼎-桃園,2024-04-18,9189
2809,京城銀,16,6,10,群益金鼎-桃園,2024-04-18,9189
8033,雷虎,11,1,10,群益金鼎-桃園,2024-04-18,9189
2417,圓剛,10,0,10,群益金鼎-桃園,2024-04-18,9189
00909,國泰數位支付服務,10,0,10,群益金鼎-桃園,2024-04-18,9189
2409,友達,10,0,10,群益金鼎-桃園,2024-04-18,9189
00929,復華台灣科技優息,557,87,470,群益金鼎-桃園,2024-04-19,9189
00919,群益台灣精選高息,306,30,276,群益金鼎-桃園,2024-04-19,9189
00940,元大台灣價值高息,376,171,205,群益金鼎-桃園,2024-04-19,9189
3576,聯合再生,109,0,109,群益金鼎-桃園,2024-04-19,9189
2888,新光金,100,0,100,群益金鼎-桃園,2024-04-19,9189
2374,佳能,125,28,97,群益金鼎-桃園,2024-04-19,9189
2330,台積電,94,5,89,群益金鼎-桃園,2024-04-19,9189
00939,統一台灣高息動能,103,15,88,群益金鼎-桃園,2024-04-19,9189
2515,中工,289,203,86,群益金鼎-桃園,2024-04-19,9189
5521,工信,107,22,85,群益金鼎-桃園,2024-04-19,9189
5381,合正,83,0,83,群益金鼎-桃園,2024-04-19,9189
0056,元大高股息,123,43,80,群益金鼎-桃園,2024-04-19,9189
2371,大同,407,327,80,群益金鼎-桃園,2024-04-19,9189
5512,力麒,163,96,67,群益金鼎-桃園,2024-04-19,9189
2303,聯電,77,13,64,群益金鼎-桃園,2024-04-19,9189
00878,國泰永續高股息,71,7,64,群益金鼎-桃園,2024-04-19,9189
00941,中信上游半導體,56,5,51,群益金鼎-桃園,2024-04-19,9189
2009,第一銅,64,14,50,群益金鼎-桃園,2024-04-19,9189
2317,鴻海,68,25,43,群益金鼎-桃園,2024-04-19,9189
1603,華電,69,26,43,群益金鼎-桃園,2024-04-19,9189
2459,敦吉,40,0,40,群益金鼎-桃園,2024-04-19,9189
5324,士開,50,14,36,群益金鼎-桃園,2024-04-19,9189
00927,群益半導體收益,35,1,34,群益金鼎-桃園,2024-04-19,9189
2382,廣達,37,3,34,群益金鼎-桃園,2024-04-19,9189
3481,群創,32,0,32,群益金鼎-桃園,2024-04-19,9189
5299,杰力,30,0,30,群益金鼎-桃園,2024-04-19,9189
2313,華通,40,10,30,群益金鼎-桃園,2024-04-19,9189
00891,中信關鍵半導體,50,20,30,群益金鼎-桃園,2024-04-19,9189
4956,光鋐,34,4,30,群益金鼎-桃園,2024-04-19,9189
2409,友達,34,4,30,群益金鼎-桃園,2024-04-19,9189
9919,康那香,48,18,30,群益金鼎-桃園,2024-04-19,9189
2101,南港,39,10,29,群益金鼎-桃園,2024-04-19,9189
2520,冠德,34,6,28,群益金鼎-桃園,2024-04-19,9189
0050,元大台灣50,27,0,27,群益金鼎-桃園,2024-04-19,9189
8033,雷虎,44,17,27,群益金鼎-桃園,2024-04-19,9189
00715L,期街口布蘭特正2,27,1,26,群益金鼎-桃園,2024-04-19,9189
00671R,富邦NASDAQ反1,25,0,25,群益金鼎-桃園,2024-04-19,9189
2353,宏��,27,4,23,群益金鼎-桃園,2024-04-19,9189
2427,三商電,26,3,23,群益金鼎-桃園,2024-04-19,9189
2355,敬鵬,33,10,23,群益金鼎-桃園,2024-04-19,9189
2376,技嘉,25,2,23,群益金鼎-桃園,2024-04-19,9189
5009,榮剛,43,21,22,群益金鼎-桃園,2024-04-19,9189
2367,燿華,83,61,22,群益金鼎-桃園,2024-04-19,9189
8064,東捷,24,2,22,群益金鼎-桃園,2024-04-19,9189
6770,力積電,21,0,21,群益金鼎-桃園,2024-04-19,9189
2369,菱生,20,0,20,群益金鼎-桃園,2024-04-19,9189
2442,新美齊,21,1,20,群益金鼎-桃園,2024-04-19,9189
6265,方土昶,20,0,20,群益金鼎-桃園,2024-04-19,9189
3231,緯創,36,17,19,群益金鼎-桃園,2024-04-19,9189
2880,華南金,20,1,19,群益金鼎-桃園,2024-04-19,9189
00929,復華台灣科技優息,768,76,692,群益金鼎-桃園,2024-04-22,9189
00937B,群益ESG投等債20,154,7,147,群益金鼎-桃園,2024-04-22,9189
00919,群益台灣精選高息,131,13,118,群益金鼎-桃園,2024-04-22,9189
00940,元大台灣價值高息,136,51,85,群益金鼎-桃園,2024-04-22,9189
2303,聯電,84,10,74,群益金鼎-桃園,2024-04-22,9189
00680L,元大美債20正2,70,0,70,群益金鼎-桃園,2024-04-22,9189
2101,南港,78,24,54,群益金鼎-桃園,2024-04-22,9189
5324,士開,50,0,50,群益金鼎-桃園,2024-04-22,9189
2867,三商壽,56,6,50,群益金鼎-桃園,2024-04-22,9189
5512,力麒,76,27,49,群益金鼎-桃園,2024-04-22,9189
9933,中鼎,54,10,44,群益金鼎-桃園,2024-04-22,9189
3481,群創,42,4,38,群益金鼎-桃園,2024-04-22,9189
1618,合機,45,7,38,群益金鼎-桃園,2024-04-22,9189
5521,工信,40,5,35,群益金鼎-桃園,2024-04-22,9189
3027,盛達,40,6,34,群益金鼎-桃園,2024-04-22,9189
00939,統一台灣高息動能,114,80,34,群益金鼎-桃園,2024-04-22,9189
1442,名軒,33,0,33,群益金鼎-桃園,2024-04-22,9189
2537,聯上發,52,22,30,群益金鼎-桃園,2024-04-22,9189
1608,華榮,57,27,30,群益金鼎-桃園,2024-04-22,9189
2371,大同,230,203,27,群益金鼎-桃園,2024-04-22,9189
5230,雷笛克光學,26,0,26,群益金鼎-桃園,2024-04-22,9189
00878,國泰永續高股息,32,6,26,群益金鼎-桃園,2024-04-22,9189
1616,億泰,25,0,25,群益金鼎-桃園,2024-04-22,9189
2528,皇普,24,0,24,群益金鼎-桃園,2024-04-22,9189
2534,宏盛,25,2,23,群益金鼎-桃園,2024-04-22,9189
2885,元大金,23,0,23,群益金鼎-桃園,2024-04-22,9189
1455,集盛,23,1,22,群益金鼎-桃園,2024-04-22,9189
5009,榮剛,35,14,21,群益金鼎-桃園,2024-04-22,9189
2442,新美齊,20,0,20,群益金鼎-桃園,2024-04-22,9189
3576,聯合再生,45,25,20,群益金鼎-桃園,2024-04-22,9189
00885,富邦越南,20,0,20,群益金鼎-桃園,2024-04-22,9189
6264,富裔,23,3,20,群益金鼎-桃園,2024-04-22,9189
3706,神達,25,6,19,群益金鼎-桃園,2024-04-22,9189
2409,友達,25,8,17,群益金鼎-桃園,2024-04-22,9189
2009,第一銅,39,22,17,群益金鼎-桃園,2024-04-22,9189
2367,燿華,44,28,16,群益金鼎-桃園,2024-04-22,9189
2727,王品,17,1,16,群益金鼎-桃園,2024-04-22,9189
4973,廣穎,15,0,15,群益金鼎-桃園,2024-04-22,9189
5515,建國,17,2,15,群益金鼎-桃園,2024-04-22,9189
3034,聯詠,14,0,14,群益金鼎-桃園,2024-04-22,9189
1605,華新,36,22,14,群益金鼎-桃園,2024-04-22,9189
6125,廣運,36,23,13,群益金鼎-桃園,2024-04-22,9189
1504,東元,92,79,13,群益金鼎-桃園,2024-04-22,9189
2377,微星,12,0,12,群益金鼎-桃園,2024-04-22,9189
6283,淳安,12,1,11,群益金鼎-桃園,2024-04-22,9189
3051,力特,11,0,11,群益金鼎-桃園,2024-04-22,9189
6443,元晶,11,0,11,群益金鼎-桃園,2024-04-22,9189
8076,伍豐,11,0,11,群益金鼎-桃園,2024-04-22,9189
1903,士紙,11,0,11,群益金鼎-桃園,2024-04-22,9189
3703,欣陸,47,36,11,群益金鼎-桃園,2024-04-22,9189
2440,太空梭,118,0,118,群益金鼎-桃園,2024-04-23,9189
2515,中工,118,51,67,群益金鼎-桃園,2024-04-23,9189
00929,復華台灣科技優息,66,2,64,群益金鼎-桃園,2024-04-23,9189
1808,潤隆,44,4,40,群益金鼎-桃園,2024-04-23,9189
2352,佳世達,40,1,39,群益金鼎-桃園,2024-04-23,9189
3494,誠研,29,0,29,群益金鼎-桃園,2024-04-23,9189
6282,康舒,27,0,27,群益金鼎-桃園,2024-04-23,9189
00919,群益台灣精選高息,57,35,22,群益金鼎-桃園,2024-04-23,9189
00937B,群益ESG投等債20,22,0,22,群益金鼎-桃園,2024-04-23,9189
2409,友達,24,2,22,群益金鼎-桃園,2024-04-23,9189
1603,華電,26,4,22,群益金鼎-桃園,2024-04-23,9189
2371,大同,184,164,20,群益金鼎-桃園,2024-04-23,9189
00936,台新永續高息中小,20,0,20,群益金鼎-桃園,2024-04-23,9189
2020,美亞,20,0,20,群益金鼎-桃園,2024-04-23,9189
2374,佳能,37,19,18,群益金鼎-桃園,2024-04-23,9189
00878,國泰永續高股息,21,5,16,群益金鼎-桃園,2024-04-23,9189
3708,上緯投控,23,7,16,群益金鼎-桃園,2024-04-23,9189
6486,互動,15,1,14,群益金鼎-桃園,2024-04-23,9189
1316,上曜,165,153,12,群益金鼎-桃園,2024-04-23,9189
3231,緯創,22,10,12,群益金鼎-桃園,2024-04-23,9189
1504,東元,64,52,12,群益金鼎-桃園,2024-04-23,9189
1785,光洋科,12,0,12,群益金鼎-桃園,2024-04-23,9189
2612,中航,11,0,11,群益金鼎-桃園,2024-04-23,9189
2903,遠百,11,0,11,群益金鼎-桃園,2024-04-23,9189
8222,寶一,11,0,11,群益金鼎-桃園,2024-04-23,9189
2337,旺宏,11,0,11,群益金鼎-桃園,2024-04-23,9189
1503,士電,19,8,11,群益金鼎-桃園,2024-04-23,9189
1609,大亞,41,31,10,群益金鼎-桃園,2024-04-23,9189
00896,中信綠能及電動車,10,0,10,群益金鼎-桃園,2024-04-23,9189
1907,永豐餘,10,0,10,群益金鼎-桃園,2024-04-23,9189
2606,裕民,14,4,10,群益金鼎-桃園,2024-04-23,9189
3715,定穎投控,19,10,9,群益金鼎-桃園,2024-04-23,9189
2344,華邦電,9,0,9,群益金鼎-桃園,2024-04-23,9189
2511,太子,9,0,9,群益金鼎-桃園,2024-04-23,9189
1440,南紡,25,16,9,群益金鼎-桃園,2024-04-23,9189
4716,大立,12,3,9,群益金鼎-桃園,2024-04-23,9189
2547,日勝生,13,5,8,群益金鼎-桃園,2024-04-23,9189
6578,達邦蛋白,14,6,8,群益金鼎-桃園,2024-04-23,9189
1903,士紙,8,0,8,群益金鼎-桃園,2024-04-23,9189
3576,聯合再生,10,2,8,群益金鼎-桃園,2024-04-23,9189
1513,中興電,22,15,7,群益金鼎-桃園,2024-04-23,9189
1618,合機,17,10,7,群益金鼎-桃園,2024-04-23,9189
3015,全漢,7,0,7,群益金鼎-桃園,2024-04-23,9189
8011,台通,11,4,7,群益金鼎-桃園,2024-04-23,9189
4576,大銀微系統,9,2,7,群益金鼎-桃園,2024-04-23,9189
5515,建國,11,4,7,群益金鼎-桃園,2024-04-23,9189
2610,華航,19,13,6,群益金鼎-桃園,2024-04-23,9189
2408,南亞科,7,1,6,群益金鼎-桃園,2024-04-23,9189
1611,中電,6,0,6,群益金鼎-桃園,2024-04-23,9189
3081,聯亞,6,0,6,群益金鼎-桃園,2024-04-23,9189
00632R,元大台灣50反1,144,22,122,群益金鼎-桃園,2024-04-24,9189
2440,太空梭,108,0,108,群益金鼎-桃園,2024-04-24,9189
8086,宏捷科,64,1,63,群益金鼎-桃園,2024-04-24,9189
00937B,群益ESG投等債20,61,1,60,群益金鼎-桃園,2024-04-24,9189
2886,兆豐金,57,0,57,群益金鼎-桃園,2024-04-24,9189
5324,士開,50,0,50,群益金鼎-桃園,2024-04-24,9189
2903,遠百,61,14,47,群益金鼎-桃園,2024-04-24,9189
8110,華東,30,0,30,群益金鼎-桃園,2024-04-24,9189
00679B,元大美債20年,27,0,27,群益金鼎-桃園,2024-04-24,9189
2504,國產,26,2,24,群益金鼎-桃園,2024-04-24,9189
2363,矽統,38,15,23,群益金鼎-桃園,2024-04-24,9189
2464,盟立,25,4,21,群益金鼎-桃園,2024-04-24,9189
6227,茂綸,21,0,21,群益金鼎-桃園,2024-04-24,9189
00929,復華台灣科技優息,74,54,20,群益金鼎-桃園,2024-04-24,9189
2020,美亞,20,0,20,群益金鼎-桃園,2024-04-24,9189
2002,中鋼,19,0,19,群益金鼎-桃園,2024-04-24,9189
1536,和大,20,1,19,群益金鼎-桃園,2024-04-24,9189
1618,合機,47,29,18,群益金鼎-桃園,2024-04-24,9189
2313,華通,17,0,17,群益金鼎-桃園,2024-04-24,9189
1409,新纖,15,0,15,群益金鼎-桃園,2024-04-24,9189
1605,華新,30,15,15,群益金鼎-桃園,2024-04-24,9189
4532,瑞智,24,10,14,群益金鼎-桃園,2024-04-24,9189
5512,力麒,18,4,14,群益金鼎-桃園,2024-04-24,9189
00645,富邦日本,14,0,14,群益金鼎-桃園,2024-04-24,9189
2528,皇普,14,0,14,群益金鼎-桃園,2024-04-24,9189
2606,裕民,15,2,13,群益金鼎-桃園,2024-04-24,9189
3027,盛達,19,6,13,群益金鼎-桃園,2024-04-24,9189
2409,友達,15,2,13,群益金鼎-桃園,2024-04-24,9189
00909,國泰數位支付服務,15,2,13,群益金鼎-桃園,2024-04-24,9189
1717,長興,12,0,12,群益金鼎-桃園,2024-04-24,9189
3013,晟銘電,69,57,12,群益金鼎-桃園,2024-04-24,9189
3481,群創,42,31,11,群益金鼎-桃園,2024-04-24,9189
00757,統一FANG+,11,0,11,群益金鼎-桃園,2024-04-24,9189
00900,富邦特選高股息30,10,0,10,群益金鼎-桃園,2024-04-24,9189
2208,台船,10,0,10,群益金鼎-桃園,2024-04-24,9189
2867,三商壽,10,0,10,群益金鼎-桃園,2024-04-24,9189
2105,正新,10,0,10,群益金鼎-桃園,2024-04-24,9189
4157,太景*-KY,10,0,10,群益金鼎-桃園,2024-04-24,9189
2066,世德,10,0,10,群益金鼎-桃園,2024-04-24,9189
00664R,國泰臺灣加權反1,10,0,10,群益金鼎-桃園,2024-04-24,9189
2634,漢翔,22,12,10,群益金鼎-桃園,2024-04-24,9189
2352,佳世達,11,2,9,群益金鼎-桃園,2024-04-24,9189
00720B,元大投資級公司債,8,0,8,群益金鼎-桃園,2024-04-24,9189
3024,憶聲,10,2,8,群益金鼎-桃園,2024-04-24,9189
3044,健鼎,8,0,8,群益金鼎-桃園,2024-04-24,9189
5230,雷笛克光學,21,13,8,群益金鼎-桃園,2024-04-24,9189
8069,元太,8,0,8,群益金鼎-桃園,2024-04-24,9189
3036,文曄,9,1,8,群益金鼎-桃園,2024-04-24,9189
2206,三陽工業,33,26,7,群益金鼎-桃園,2024-04-24,9189
1316,上曜,18,11,7,群益金鼎-桃園,2024-04-24,9189
00937B,群益ESG投等債20,600,2,598,群益金鼎-桃園,2024-04-25,9189
00929,復華台灣科技優息,236,1,235,群益金鼎-桃園,2024-04-25,9189
2501,國建,172,40,132,群益金鼎-桃園,2024-04-25,9189
1440,南紡,112,4,108,群益金鼎-桃園,2024-04-25,9189
2515,中工,144,44,100,群益金鼎-桃園,2024-04-25,9189
2440,太空梭,100,0,100,群益金鼎-桃園,2024-04-25,9189
2618,長榮航,162,110,52,群益金鼎-桃園,2024-04-25,9189
2888,新光金,40,0,40,群益金鼎-桃園,2024-04-25,9189
2208,台船,40,1,39,群益金鼎-桃園,2024-04-25,9189
3013,晟銘電,100,63,37,群益金鼎-桃園,2024-04-25,9189
5531,鄉林,35,0,35,群益金鼎-桃園,2024-04-25,9189
3481,群創,38,3,35,群益金鼎-桃園,2024-04-25,9189
2885,元大金,33,0,33,群益金鼎-桃園,2024-04-25,9189
3035,智原,32,0,32,群益金鼎-桃園,2024-04-25,9189
00665L,富邦�琤肭磪囓�2,45,15,30,群益金鼎-桃園,2024-04-25,9189
2317,鴻海,45,16,29,群益金鼎-桃園,2024-04-25,9189
1504,東元,51,23,28,群益金鼎-桃園,2024-04-25,9189
00919,群益台灣精選高息,30,2,28,群益金鼎-桃園,2024-04-25,9189
1101,台泥,27,0,27,群益金鼎-桃園,2024-04-25,9189
2867,三商壽,25,0,25,群益金鼎-桃園,2024-04-25,9189
00720B,元大投資級公司債,24,0,24,群益金鼎-桃園,2024-04-25,9189
00751B,元大AAA至A公司債,23,0,23,群益金鼎-桃園,2024-04-25,9189
6116,彩晶,21,0,21,群益金鼎-桃園,2024-04-25,9189
2461,光群雷,21,1,20,群益金鼎-桃園,2024-04-25,9189
2886,兆豐金,20,0,20,群益金鼎-桃園,2024-04-25,9189
1605,華新,24,5,19,群益金鼎-桃園,2024-04-25,9189
2409,友達,120,101,19,群益金鼎-桃園,2024-04-25,9189
2371,大同,66,49,17,群益金鼎-桃園,2024-04-25,9189
00632R,元大台灣50反1,50,33,17,群益金鼎-桃園,2024-04-25,9189
00878,國泰永續高股息,16,0,16,群益金鼎-桃園,2024-04-25,9189
2002,中鋼,15,0,15,群益金鼎-桃園,2024-04-25,9189
2892,第一金,15,0,15,群益金鼎-桃園,2024-04-25,9189
5381,合正,15,0,15,群益金鼎-桃園,2024-04-25,9189
00680L,元大美債20正2,15,0,15,群益金鼎-桃園,2024-04-25,9189
4716,大立,42,27,15,群益金鼎-桃園,2024-04-25,9189
00645,富邦日本,15,0,15,群益金鼎-桃園,2024-04-25,9189
2489,瑞軒,19,5,14,群益金鼎-桃園,2024-04-25,9189
2855,統一證,12,0,12,群益金鼎-桃園,2024-04-25,9189
6125,廣運,54,42,12,群益金鼎-桃園,2024-04-25,9189
1522,堤維西,12,0,12,群益金鼎-桃園,2024-04-25,9189
00679B,元大美債20年,11,0,11,群益金鼎-桃園,2024-04-25,9189
3703,欣陸,28,17,11,群益金鼎-桃園,2024-04-25,9189
2303,聯電,20,9,11,群益金鼎-桃園,2024-04-25,9189
3231,緯創,19,9,10,群益金鼎-桃園,2024-04-25,9189
0056,元大高股息,13,3,10,群益金鼎-桃園,2024-04-25,9189
2801,彰銀,10,0,10,群益金鼎-桃園,2024-04-25,9189
5515,建國,16,6,10,群益金鼎-桃園,2024-04-25,9189
3094,聯傑,9,0,9,群益金鼎-桃園,2024-04-25,9189
2486,一詮,14,5,9,群益金鼎-桃園,2024-04-25,9189
1609,大亞,43,34,9,群益金鼎-桃園,2024-04-25,9189
00632R,元大台灣50反1,215,0,215,群益金鼎-桃園,2024-04-26,9189
00937B,群益ESG投等債20,148,0,148,群益金鼎-桃園,2024-04-26,9189
3481,群創,143,22,121,群益金鼎-桃園,2024-04-26,9189
2324,仁寶,100,5,95,群益金鼎-桃園,2024-04-26,9189
00679B,元大美債20年,68,0,68,群益金鼎-桃園,2024-04-26,9189
2312,金寶,62,0,62,群益金鼎-桃園,2024-04-26,9189
00878,國泰永續高股息,61,0,61,群益金鼎-桃園,2024-04-26,9189
2903,遠百,60,3,57,群益金鼎-桃園,2024-04-26,9189
00680L,元大美債20正2,50,0,50,群益金鼎-桃園,2024-04-26,9189
3312,弘憶股,49,1,48,群益金鼎-桃園,2024-04-26,9189
0056,元大高股息,55,13,42,群益金鼎-桃園,2024-04-26,9189
00720B,元大投資級公司債,40,0,40,群益金鼎-桃園,2024-04-26,9189
00942B,台新美A公司債20+,36,0,36,群益金鼎-桃園,2024-04-26,9189
1536,和大,40,11,29,群益金鼎-桃園,2024-04-26,9189
6015,宏遠證,29,0,29,群益金鼎-桃園,2024-04-26,9189
2834,臺企銀,29,1,28,群益金鼎-桃園,2024-04-26,9189
5381,合正,28,0,28,群益金鼎-桃園,2024-04-26,9189
2241,艾姆勒,32,4,28,群益金鼎-桃園,2024-04-26,9189
6016,康和證,25,1,24,群益金鼎-桃園,2024-04-26,9189
00706L,期元大S＆P日圓正2,22,0,22,群益金鼎-桃園,2024-04-26,9189
2353,宏��,21,0,21,群益金鼎-桃園,2024-04-26,9189
2408,南亞科,26,5,21,群益金鼎-桃園,2024-04-26,9189
2855,統一證,20,0,20,群益金鼎-桃園,2024-04-26,9189
2883,凱基金,21,1,20,群益金鼎-桃園,2024-04-26,9189
6282,康舒,19,0,19,群益金鼎-桃園,2024-04-26,9189
2002,中鋼,22,4,18,群益金鼎-桃園,2024-04-26,9189
5525,順天,17,0,17,群益金鼎-桃園,2024-04-26,9189
2356,英業達,19,2,17,群益金鼎-桃園,2024-04-26,9189
3231,緯創,22,5,17,群益金鼎-桃園,2024-04-26,9189
1618,合機,30,14,16,群益金鼎-桃園,2024-04-26,9189
3363,上詮,43,28,15,群益金鼎-桃園,2024-04-26,9189
6116,彩晶,20,6,14,群益金鼎-桃園,2024-04-26,9189
3037,欣興,24,11,13,群益金鼎-桃園,2024-04-26,9189
00857B,永豐20年美公債,12,0,12,群益金鼎-桃園,2024-04-26,9189
6431,光麗-KY,12,0,12,群益金鼎-桃園,2024-04-26,9189
1903,士紙,14,2,12,群益金鼎-桃園,2024-04-26,9189
3030,德律,23,11,12,群益金鼎-桃園,2024-04-26,9189
00751B,元大AAA至A公司債,11,0,11,群益金鼎-桃園,2024-04-26,9189
1101,台泥,10,0,10,群益金鼎-桃園,2024-04-26,9189
2880,華南金,10,0,10,群益金鼎-桃園,2024-04-26,9189
8929,富堡,10,0,10,群益金鼎-桃園,2024-04-26,9189
2801,彰銀,10,0,10,群益金鼎-桃園,2024-04-26,9189
5469,瀚宇博,10,0,10,群益金鼎-桃園,2024-04-26,9189
2889,國票金,11,1,10,群益金鼎-桃園,2024-04-26,9189
1617,榮星,10,0,10,群益金鼎-桃園,2024-04-26,9189
2809,京城銀,10,0,10,群益金鼎-桃園,2024-04-26,9189
9105,泰金寶-DR,10,0,10,群益金鼎-桃園,2024-04-26,9189
6283,淳安,10,0,10,群益金鼎-桃園,2024-04-26,9189
8926,台汽電,10,0,10,群益金鼎-桃園,2024-04-26,9189
00687B,國泰20年美債,12,3,9,群益金鼎-桃園,2024-04-26,9189
00937B,群益ESG投等債20,504,6,498,群益金鼎-桃園,2024-04-29,9189
2610,華航,344,8,336,群益金鼎-桃園,2024-04-29,9189
00632R,元大台灣50反1,109,0,109,群益金鼎-桃園,2024-04-29,9189
2618,長榮航,220,121,99,群益金鼎-桃園,2024-04-29,9189
2367,燿華,107,23,84,群益金鼎-桃園,2024-04-29,9189
1444,力麗,60,0,60,群益金鼎-桃園,2024-04-29,9189
2834,臺企銀,62,6,56,群益金鼎-桃園,2024-04-29,9189
00706L,期元大S＆P日圓正2,58,4,54,群益金鼎-桃園,2024-04-29,9189
1905,華紙,55,13,42,群益金鼎-桃園,2024-04-29,9189
1103,嘉泥,45,5,40,群益金鼎-桃園,2024-04-29,9189
1531,高林股,37,0,37,群益金鼎-桃園,2024-04-29,9189
3703,欣陸,37,1,36,群益金鼎-桃園,2024-04-29,9189
2489,瑞軒,38,3,35,群益金鼎-桃園,2024-04-29,9189
2101,南港,55,20,35,群益金鼎-桃園,2024-04-29,9189
5521,工信,34,0,34,群益金鼎-桃園,2024-04-29,9189
2371,大同,79,46,33,群益金鼎-桃園,2024-04-29,9189
2449,京元電子,36,6,30,群益金鼎-桃園,2024-04-29,9189
2323,中環,180,152,28,群益金鼎-桃園,2024-04-29,9189
00645,富邦日本,25,0,25,群益金鼎-桃園,2024-04-29,9189
3312,弘憶股,29,6,23,群益金鼎-桃園,2024-04-29,9189
1503,士電,26,6,20,群益金鼎-桃園,2024-04-29,9189
2066,世德,24,4,20,群益金鼎-桃園,2024-04-29,9189
2883,凱基金,62,42,20,群益金鼎-桃園,2024-04-29,9189
00878,國泰永續高股息,20,0,20,群益金鼎-桃園,2024-04-29,9189
2359,所羅門,25,6,19,群益金鼎-桃園,2024-04-29,9189
2809,京城銀,20,1,19,群益金鼎-桃園,2024-04-29,9189
2511,太子,20,1,19,群益金鼎-桃園,2024-04-29,9189
3494,誠研,19,0,19,群益金鼎-桃園,2024-04-29,9189
0056,元大高股息,20,1,19,群益金鼎-桃園,2024-04-29,9189
6125,廣運,79,61,18,群益金鼎-桃園,2024-04-29,9189
1504,東元,19,6,13,群益金鼎-桃園,2024-04-29,9189
1513,中興電,17,5,12,群益金鼎-桃園,2024-04-29,9189
4513,福裕,18,6,12,群益金鼎-桃園,2024-04-29,9189
7402,邑錡,14,2,12,群益金鼎-桃園,2024-04-29,9189
00753L,中信中國50正2,11,0,11,群益金鼎-桃園,2024-04-29,9189
2363,矽統,90,79,11,群益金鼎-桃園,2024-04-29,9189
9907,統一實,10,0,10,群益金鼎-桃園,2024-04-29,9189
2609,陽明,59,49,10,群益金鼎-桃園,2024-04-29,9189
1609,大亞,22,12,10,群益金鼎-桃園,2024-04-29,9189
4919,新唐,12,2,10,群益金鼎-桃園,2024-04-29,9189
6841,長佳智能,10,0,10,群益金鼎-桃園,2024-04-29,9189
6290,良維,12,2,10,群益金鼎-桃園,2024-04-29,9189
8071,能率網通,10,0,10,群益金鼎-桃園,2024-04-29,9189
6016,康和證,12,2,10,群益金鼎-桃園,2024-04-29,9189
2887,台新金,9,0,9,群益金鼎-桃園,2024-04-29,9189
8210,勤誠,12,3,9,群益金鼎-桃園,2024-04-29,9189
2611,志信,9,0,9,群益金鼎-桃園,2024-04-29,9189
6770,力積電,35,26,9,群益金鼎-桃園,2024-04-29,9189
3715,定穎投控,25,17,8,群益金鼎-桃園,2024-04-29,9189
2486,一詮,35,28,7,群益金鼎-桃園,2024-04-29,9189
2440,太空梭,355,0,355,群益金鼎-桃園,2024-04-30,9189
00664R,國泰臺灣加權反1,100,0,100,群益金鼎-桃園,2024-04-30,9189
2515,中工,129,50,79,群益金鼎-桃園,2024-04-30,9189
3481,群創,169,105,64,群益金鼎-桃園,2024-04-30,9189
00706L,期元大S＆P日圓正2,65,3,62,群益金鼎-桃園,2024-04-30,9189
00919,群益台灣精選高息,56,2,54,群益金鼎-桃園,2024-04-30,9189
1314,中石化,71,18,53,群益金鼎-桃園,2024-04-30,9189
7402,邑錡,54,1,53,群益金鼎-桃園,2024-04-30,9189
1609,大亞,58,12,46,群益金鼎-桃園,2024-04-30,9189
5009,榮剛,51,8,43,群益金鼎-桃園,2024-04-30,9189
2317,鴻海,54,12,42,群益金鼎-桃園,2024-04-30,9189
00915,凱基優選高股息30,51,9,42,群益金鼎-桃園,2024-04-30,9189
2610,華航,42,6,36,群益金鼎-桃園,2024-04-30,9189
5439,高技,33,1,32,群益金鼎-桃園,2024-04-30,9189
00929,復華台灣科技優息,41,9,32,群益金鼎-桃園,2024-04-30,9189
2880,華南金,55,25,30,群益金鼎-桃園,2024-04-30,9189
2913,農林,34,8,26,群益金鼎-桃園,2024-04-30,9189
5469,瀚宇博,23,0,23,群益金鼎-桃園,2024-04-30,9189
1618,合機,26,4,22,群益金鼎-桃園,2024-04-30,9189
6770,力積電,20,0,20,群益金鼎-桃園,2024-04-30,9189
1504,東元,21,3,18,群益金鼎-桃園,2024-04-30,9189
00632R,元大台灣50反1,17,0,17,群益金鼎-桃園,2024-04-30,9189
2611,志信,28,11,17,群益金鼎-桃園,2024-04-30,9189
2609,陽明,31,14,17,群益金鼎-桃園,2024-04-30,9189
00923,群益台ESG低碳50,16,0,16,群益金鼎-桃園,2024-04-30,9189
6290,良維,16,1,15,群益金鼎-桃園,2024-04-30,9189
6213,聯茂,14,0,14,群益金鼎-桃園,2024-04-30,9189
3163,波若威,31,17,14,群益金鼎-桃園,2024-04-30,9189
2363,矽統,80,66,14,群益金鼎-桃園,2024-04-30,9189
1605,華新,13,0,13,群益金鼎-桃園,2024-04-30,9189
4533,協易機,14,1,13,群益金鼎-桃園,2024-04-30,9189
2606,裕民,12,0,12,群益金鼎-桃園,2024-04-30,9189
1513,中興電,15,3,12,群益金鼎-桃園,2024-04-30,9189
6275,元山,14,3,11,群益金鼎-桃園,2024-04-30,9189
6283,淳安,13,2,11,群益金鼎-桃園,2024-04-30,9189
3376,新日興,14,3,11,群益金鼎-桃園,2024-04-30,9189
6274,台燿,20,9,11,群益金鼎-桃園,2024-04-30,9189
2501,國建,60,49,11,群益金鼎-桃園,2024-04-30,9189
2101,南港,19,8,11,群益金鼎-桃園,2024-04-30,9189
4912,聯德控股-KY,10,0,10,群益金鼎-桃園,2024-04-30,9189
5302,太欣,10,0,10,群益金鼎-桃園,2024-04-30,9189
5324,士開,10,0,10,群益金鼎-桃園,2024-04-30,9189
6244,茂迪,10,0,10,群益金鼎-桃園,2024-04-30,9189
5531,鄉林,13,3,10,群益金鼎-桃園,2024-04-30,9189
5443,均豪,9,0,9,群益金鼎-桃園,2024-04-30,9189
2367,燿華,15,6,9,群益金鼎-桃園,2024-04-30,9189
2002,中鋼,14,6,8,群益金鼎-桃園,2024-04-30,9189
5230,雷笛克光學,8,0,8,群益金鼎-桃園,2024-04-30,9189
5234,達興材料,9,1,8,群益金鼎-桃園,2024-04-30,9189
2605,新興,10,2,8,群益金鼎-桃園,2024-04-30,9189
3481,群創,139,5,134,群益金鼎-桃園,2024-05-02,9189
2440,太空梭,103,0,103,群益金鼎-桃園,2024-05-02,9189
00878,國泰永續高股息,66,3,63,群益金鼎-桃園,2024-05-02,9189
2405,輔信,50,0,50,群益金鼎-桃園,2024-05-02,9189
00929,復華台灣科技優息,46,0,46,群益金鼎-桃園,2024-05-02,9189
8064,東捷,58,13,45,群益金鼎-桃園,2024-05-02,9189
2371,大同,73,32,41,群益金鼎-桃園,2024-05-02,9189
00932,兆豐永續高息等權,40,0,40,群益金鼎-桃園,2024-05-02,9189
2514,龍邦,40,0,40,群益金鼎-桃園,2024-05-02,9189
1605,華新,40,0,40,群益金鼎-桃園,2024-05-02,9189
8086,宏捷科,39,0,39,群益金鼎-桃園,2024-05-02,9189
00690,兆豐藍籌30,38,0,38,群益金鼎-桃園,2024-05-02,9189
3049,精金,31,0,31,群益金鼎-桃園,2024-05-02,9189
1808,潤隆,29,1,28,群益金鼎-桃園,2024-05-02,9189
00857B,永豐20年美公債,25,0,25,群益金鼎-桃園,2024-05-02,9189
2401,凌陽,35,10,25,群益金鼎-桃園,2024-05-02,9189
2886,兆豐金,20,2,18,群益金鼎-桃園,2024-05-02,9189
1609,大亞,23,5,18,群益金鼎-桃園,2024-05-02,9189
00712,復華富時不動產,18,0,18,群益金鼎-桃園,2024-05-02,9189
00679B,元大美債20年,17,0,17,群益金鼎-桃園,2024-05-02,9189
1440,南紡,20,4,16,群益金鼎-桃園,2024-05-02,9189
8089,康全電訊,17,2,15,群益金鼎-桃園,2024-05-02,9189
1445,大宇,14,0,14,群益金鼎-桃園,2024-05-02,9189
1455,集盛,17,4,13,群益金鼎-桃園,2024-05-02,9189
2409,友達,125,112,13,群益金鼎-桃園,2024-05-02,9189
2329,華泰,13,1,12,群益金鼎-桃園,2024-05-02,9189
2611,志信,27,15,12,群益金鼎-桃園,2024-05-02,9189
6015,宏遠證,12,0,12,群益金鼎-桃園,2024-05-02,9189
5371,中光電,18,6,12,群益金鼎-桃園,2024-05-02,9189
2354,鴻準,13,1,12,群益金鼎-桃園,2024-05-02,9189
2609,陽明,54,43,11,群益金鼎-桃園,2024-05-02,9189
6125,廣運,20,9,11,群益金鼎-桃園,2024-05-02,9189
00915,凱基優選高股息30,12,1,11,群益金鼎-桃園,2024-05-02,9189
5439,高技,11,0,11,群益金鼎-桃園,2024-05-02,9189
9105,泰金寶-DR,10,0,10,群益金鼎-桃園,2024-05-02,9189
6139,亞翔,11,1,10,群益金鼎-桃園,2024-05-02,9189
00918,大華優利高填息30,10,0,10,群益金鼎-桃園,2024-05-02,9189
4526,東台,11,1,10,群益金鼎-桃園,2024-05-02,9189
4938,和碩,12,2,10,群益金鼎-桃園,2024-05-02,9189
6016,康和證,15,5,10,群益金鼎-桃園,2024-05-02,9189
1531,高林股,10,0,10,群益金鼎-桃園,2024-05-02,9189
6230,尼得科超眾,19,9,10,群益金鼎-桃園,2024-05-02,9189
2317,鴻海,25,15,10,群益金鼎-桃園,2024-05-02,9189
2359,所羅門,11,2,9,群益金鼎-桃園,2024-05-02,9189
3338,泰碩,10,1,9,群益金鼎-桃園,2024-05-02,9189
2323,中環,45,36,9,群益金鼎-桃園,2024-05-02,9189
2504,國產,17,8,9,群益金鼎-桃園,2024-05-02,9189
2101,南港,36,28,8,群益金鼎-桃園,2024-05-02,9189
00720B,元大投資級公司債,8,0,8,群益金鼎-桃園,2024-05-02,9189
00909,國泰數位支付服務,8,0,8,群益金鼎-桃園,2024-05-02,9189
00937B,群益ESG投等債20,431,2,429,群益金鼎-桃園,2024-05-03,9189
9945,潤泰新,546,424,122,群益金鼎-桃園,2024-05-03,9189
2392,正崴,54,3,51,群益金鼎-桃園,2024-05-03,9189
6770,力積電,91,47,44,群益金鼎-桃園,2024-05-03,9189
00933B,國泰10Y+金融債,44,0,44,群益金鼎-桃園,2024-05-03,9189
4109,加捷生醫,41,2,39,群益金鼎-桃園,2024-05-03,9189
00795B,中信美國公債20年,38,0,38,群益金鼎-桃園,2024-05-03,9189
00878,國泰永續高股息,48,11,37,群益金鼎-桃園,2024-05-03,9189
1442,名軒,35,0,35,群益金鼎-桃園,2024-05-03,9189
6244,茂迪,31,0,31,群益金鼎-桃園,2024-05-03,9189
00665L,富邦�琤肭磪囓�2,30,0,30,群益金鼎-桃園,2024-05-03,9189
6016,康和證,29,0,29,群益金鼎-桃園,2024-05-03,9189
2515,中工,75,48,27,群益金鼎-桃園,2024-05-03,9189
2913,農林,33,8,25,群益金鼎-桃園,2024-05-03,9189
8926,台汽電,23,0,23,群益金鼎-桃園,2024-05-03,9189
5512,力麒,117,94,23,群益金鼎-桃園,2024-05-03,9189
00934,中信成長高股息,30,7,23,群益金鼎-桃園,2024-05-03,9189
3013,晟銘電,25,4,21,群益金鼎-桃園,2024-05-03,9189
00688L,國泰20年美債正2,20,0,20,群益金鼎-桃園,2024-05-03,9189
4714,永捷,60,40,20,群益金鼎-桃園,2024-05-03,9189
8930,青鋼,20,0,20,群益金鼎-桃園,2024-05-03,9189
3710,連展投控,20,0,20,群益金鼎-桃園,2024-05-03,9189
2371,大同,47,27,20,群益金鼎-桃園,2024-05-03,9189
8096,擎亞,73,53,20,群益金鼎-桃園,2024-05-03,9189
6120,達運,31,12,19,群益金鼎-桃園,2024-05-03,9189
1316,上曜,90,71,19,群益金鼎-桃園,2024-05-03,9189
4558,寶緯,20,1,19,群益金鼎-桃園,2024-05-03,9189
3481,群創,23,5,18,群益金鼎-桃園,2024-05-03,9189
00929,復華台灣科技優息,31,13,18,群益金鼎-桃園,2024-05-03,9189
2609,陽明,50,32,18,群益金鼎-桃園,2024-05-03,9189
2530,華建,17,0,17,群益金鼎-桃園,2024-05-03,9189
2032,新鋼,16,0,16,群益金鼎-桃園,2024-05-03,9189
1589,永冠-KY,16,0,16,群益金鼎-桃園,2024-05-03,9189
6282,康舒,15,0,15,群益金鼎-桃園,2024-05-03,9189
3313,斐成,18,3,15,群益金鼎-桃園,2024-05-03,9189
00679B,元大美債20年,14,0,14,群益金鼎-桃園,2024-05-03,9189
2505,國揚,14,0,14,群益金鼎-桃園,2024-05-03,9189
00919,群益台灣精選高息,28,14,14,群益金鼎-桃園,2024-05-03,9189
2489,瑞軒,15,1,14,群益金鼎-桃園,2024-05-03,9189
1514,亞力,34,20,14,群益金鼎-桃園,2024-05-03,9189
1459,聯發,13,0,13,群益金鼎-桃園,2024-05-03,9189
1531,高林股,13,0,13,群益金鼎-桃園,2024-05-03,9189
8064,東捷,14,1,13,群益金鼎-桃園,2024-05-03,9189
6026,福邦證,13,0,13,群益金鼎-桃園,2024-05-03,9189
1608,華榮,20,8,12,群益金鼎-桃園,2024-05-03,9189
2641,正德,11,0,11,群益金鼎-桃園,2024-05-03,9189
00926,凱基全球菁英55,10,0,10,群益金鼎-桃園,2024-05-03,9189
00900,富邦特選高股息30,10,0,10,群益金鼎-桃園,2024-05-03,9189
1618,合機,12,2,10,群益金鼎-桃園,2024-05-03,9189
00645,富邦日本,11,1,10,群益金鼎-桃園,2024-05-03,9189
00632R,元大台灣50反1,230,0,230,群益金鼎-桃園,2024-05-06,9189
2440,太空梭,157,6,151,群益金鼎-桃園,2024-05-06,9189
00937B,群益ESG投等債20,128,1,127,群益金鼎-桃園,2024-05-06,9189
9933,中鼎,134,22,112,群益金鼎-桃園,2024-05-06,9189
00878,國泰永續高股息,123,22,101,群益金鼎-桃園,2024-05-06,9189
2881,富邦金,100,8,92,群益金鼎-桃園,2024-05-06,9189
1217,愛之味,80,0,80,群益金鼎-桃園,2024-05-06,9189
4303,信立,66,14,52,群益金鼎-桃園,2024-05-06,9189
5512,力麒,57,9,48,群益金鼎-桃園,2024-05-06,9189
2834,臺企銀,49,4,45,群益金鼎-桃園,2024-05-06,9189
00929,復華台灣科技優息,49,9,40,群益金鼎-桃園,2024-05-06,9189
2618,長榮航,97,65,32,群益金鼎-桃園,2024-05-06,9189
2515,中工,32,6,26,群益金鼎-桃園,2024-05-06,9189
4714,永捷,24,1,23,群益金鼎-桃園,2024-05-06,9189
2323,中環,23,0,23,群益金鼎-桃園,2024-05-06,9189
2449,京元電子,36,13,23,群益金鼎-桃園,2024-05-06,9189
2007,燁興,22,0,22,群益金鼎-桃園,2024-05-06,9189
6283,淳安,23,2,21,群益金鼎-桃園,2024-05-06,9189
00642U,期元大S＆P石油,21,0,21,群益金鼎-桃園,2024-05-06,9189
1532,勤美,22,1,21,群益金鼎-桃園,2024-05-06,9189
4558,寶緯,20,0,20,群益金鼎-桃園,2024-05-06,9189
3624,光頡,16,1,15,群益金鼎-桃園,2024-05-06,9189
2913,農林,32,17,15,群益金鼎-桃園,2024-05-06,9189
2547,日勝生,15,0,15,群益金鼎-桃園,2024-05-06,9189
2313,華通,17,2,15,群益金鼎-桃園,2024-05-06,9189
00919,群益台灣精選高息,21,8,13,群益金鼎-桃園,2024-05-06,9189
4967,十銓,29,16,13,群益金鼎-桃園,2024-05-06,9189
00645,富邦日本,26,13,13,群益金鼎-桃園,2024-05-06,9189
2542,興富發,36,24,12,群益金鼎-桃園,2024-05-06,9189
4956,光鋐,13,1,12,群益金鼎-桃園,2024-05-06,9189
6207,雷科,29,17,12,群益金鼎-桃園,2024-05-06,9189
8234,新漢,13,1,12,群益金鼎-桃園,2024-05-06,9189
6274,台燿,16,4,12,群益金鼎-桃園,2024-05-06,9189
9945,潤泰新,248,236,12,群益金鼎-桃園,2024-05-06,9189
2025,千興,12,1,11,群益金鼎-桃園,2024-05-06,9189
2014,中鴻,12,1,11,群益金鼎-桃園,2024-05-06,9189
2464,盟立,14,3,11,群益金鼎-桃園,2024-05-06,9189
2538,基泰,14,3,11,群益金鼎-桃園,2024-05-06,9189
1314,中石化,18,7,11,群益金鼎-桃園,2024-05-06,9189
6113,亞矽,10,0,10,群益金鼎-桃園,2024-05-06,9189
6668,中揚光,15,5,10,群益金鼎-桃園,2024-05-06,9189
1504,東元,13,3,10,群益金鼎-桃園,2024-05-06,9189
00899,FT潔淨能源,10,0,10,群益金鼎-桃園,2024-05-06,9189
3557,嘉威,11,1,10,群益金鼎-桃園,2024-05-06,9189
8215,明基材,10,0,10,群益金鼎-桃園,2024-05-06,9189
8064,東捷,13,3,10,群益金鼎-桃園,2024-05-06,9189
2328,廣宇,12,3,9,群益金鼎-桃園,2024-05-06,9189
00650L,復華香港正2,10,1,9,群益金鼎-桃園,2024-05-06,9189
2611,志信,14,5,9,群益金鼎-桃園,2024-05-06,9189
4533,協易機,15,6,9,群益金鼎-桃園,2024-05-06,9189
00937B,群益ESG投等債20,861,29,832,群益金鼎-桃園,2024-05-07,9189
00664R,國泰臺灣加權反1,305,3,302,群益金鼎-桃園,2024-05-07,9189
3481,群創,119,0,119,群益金鼎-桃園,2024-05-07,9189
2409,友達,105,3,102,群益金鼎-桃園,2024-05-07,9189
00665L,富邦�琤肭磪囓�2,83,15,68,群益金鼎-桃園,2024-05-07,9189
00679B,元大美債20年,60,0,60,群益金鼎-桃園,2024-05-07,9189
00878,國泰永續高股息,55,3,52,群益金鼎-桃園,2024-05-07,9189
2006,東和鋼鐵,50,0,50,群益金鼎-桃園,2024-05-07,9189
2603,長榮,49,2,47,群益金鼎-桃園,2024-05-07,9189
1609,大亞,50,11,39,群益金鼎-桃園,2024-05-07,9189
2887,台新金,47,14,33,群益金鼎-桃園,2024-05-07,9189
00632R,元大台灣50反1,37,4,33,群益金鼎-桃園,2024-05-07,9189
2101,南港,40,8,32,群益金鼎-桃園,2024-05-07,9189
3013,晟銘電,105,73,32,群益金鼎-桃園,2024-05-07,9189
6841,長佳智能,31,0,31,群益金鼎-桃園,2024-05-07,9189
9919,康那香,25,0,25,群益金鼎-桃園,2024-05-07,9189
3704,合勤控,25,0,25,群益金鼎-桃園,2024-05-07,9189
2486,一詮,117,92,25,群益金鼎-桃園,2024-05-07,9189
2317,鴻海,65,42,23,群益金鼎-桃園,2024-05-07,9189
4303,信立,43,21,22,群益金鼎-桃園,2024-05-07,9189
2354,鴻準,23,1,22,群益金鼎-桃園,2024-05-07,9189
3033,威健,26,4,22,群益金鼎-桃園,2024-05-07,9189
2014,中鴻,23,1,22,群益金鼎-桃園,2024-05-07,9189
1608,華榮,29,7,22,群益金鼎-桃園,2024-05-07,9189
4938,和碩,25,3,22,群益金鼎-桃園,2024-05-07,9189
8086,宏捷科,21,0,21,群益金鼎-桃園,2024-05-07,9189
00918,大華優利高填息30,22,1,21,群益金鼎-桃園,2024-05-07,9189
00929,復華台灣科技優息,20,0,20,群益金鼎-桃園,2024-05-07,9189
2511,太子,20,0,20,群益金鼎-桃園,2024-05-07,9189
0056,元大高股息,21,1,20,群益金鼎-桃園,2024-05-07,9189
1514,亞力,25,6,19,群益金鼎-桃園,2024-05-07,9189
2408,南亞科,20,1,19,群益金鼎-桃園,2024-05-07,9189
5871,中租-KY,18,0,18,群益金鼎-桃園,2024-05-07,9189
00891,中信關鍵半導體,18,0,18,群益金鼎-桃園,2024-05-07,9189
1808,潤隆,19,2,17,群益金鼎-桃園,2024-05-07,9189
2501,國建,25,8,17,群益金鼎-桃園,2024-05-07,9189
2344,華邦電,18,2,16,群益金鼎-桃園,2024-05-07,9189
2323,中環,16,0,16,群益金鼎-桃園,2024-05-07,9189
2880,華南金,22,6,16,群益金鼎-桃園,2024-05-07,9189
1531,高林股,18,2,16,群益金鼎-桃園,2024-05-07,9189
4533,協易機,20,4,16,群益金鼎-桃園,2024-05-07,9189
2739,寒舍,18,3,15,群益金鼎-桃園,2024-05-07,9189
3024,憶聲,15,0,15,群益金鼎-桃園,2024-05-07,9189
3363,上詮,42,28,14,群益金鼎-桃園,2024-05-07,9189
1532,勤美,30,16,14,群益金鼎-桃園,2024-05-07,9189
6546,正基,18,5,13,群益金鼎-桃園,2024-05-07,9189
00933B,國泰10Y+金融債,13,0,13,群益金鼎-桃園,2024-05-07,9189
2618,長榮航,52,39,13,群益金鼎-桃園,2024-05-07,9189
3162,精確,13,0,13,群益金鼎-桃園,2024-05-07,9189
6671,三能-KY,12,0,12,群益金鼎-桃園,2024-05-07,9189
00937B,群益ESG投等債20,143,0,143,群益金鼎-桃園,2024-05-08,9189
2371,大同,163,54,109,群益金鼎-桃園,2024-05-08,9189
9945,潤泰新,108,1,107,群益金鼎-桃園,2024-05-08,9189
2888,新光金,90,13,77,群益金鼎-桃園,2024-05-08,9189
5871,中租-KY,70,12,58,群益金鼎-桃園,2024-05-08,9189
00919,群益台灣精選高息,65,10,55,群益金鼎-桃園,2024-05-08,9189
1808,潤隆,50,0,50,群益金鼎-桃園,2024-05-08,9189
00637L,元大滬深300正2,45,0,45,群益金鼎-桃園,2024-05-08,9189
1217,愛之味,44,0,44,群益金鼎-桃園,2024-05-08,9189
2440,太空梭,42,0,42,群益金鼎-桃園,2024-05-08,9189
1618,合機,64,22,42,群益金鼎-桃園,2024-05-08,9189
2338,光罩,42,1,41,群益金鼎-桃園,2024-05-08,9189
00878,國泰永續高股息,48,9,39,群益金鼎-桃園,2024-05-08,9189
2603,長榮,37,4,33,群益金鼎-桃園,2024-05-08,9189
2363,矽統,65,32,33,群益金鼎-桃園,2024-05-08,9189
2601,益航,32,0,32,群益金鼎-桃園,2024-05-08,9189
00929,復華台灣科技優息,33,1,32,群益金鼎-桃園,2024-05-08,9189
5302,太欣,31,0,31,群益金鼎-桃園,2024-05-08,9189
2883B,凱基金乙特,30,0,30,群益金鼎-桃園,2024-05-08,9189
00795B,中信美國公債20年,25,0,25,群益金鼎-桃園,2024-05-08,9189
2002,中鋼,25,2,23,群益金鼎-桃園,2024-05-08,9189
2515,中工,39,18,21,群益金鼎-桃園,2024-05-08,9189
6188,廣明,93,72,21,群益金鼎-桃園,2024-05-08,9189
3312,弘憶股,24,3,21,群益金鼎-桃園,2024-05-08,9189
1531,高林股,22,1,21,群益金鼎-桃園,2024-05-08,9189
3481,群創,21,1,20,群益金鼎-桃園,2024-05-08,9189
5324,士開,20,0,20,群益金鼎-桃園,2024-05-08,9189
2884,玉山金,20,0,20,群益金鼎-桃園,2024-05-08,9189
2618,長榮航,62,42,20,群益金鼎-桃園,2024-05-08,9189
4303,信立,38,19,19,群益金鼎-桃園,2024-05-08,9189
00857B,永豐20年美公債,17,0,17,群益金鼎-桃園,2024-05-08,9189
2374,佳能,24,7,17,群益金鼎-桃園,2024-05-08,9189
00932,兆豐永續高息等權,17,0,17,群益金鼎-桃園,2024-05-08,9189
2611,志信,18,2,16,群益金鼎-桃園,2024-05-08,9189
9105,泰金寶-DR,15,0,15,群益金鼎-桃園,2024-05-08,9189
5608,四維航,33,18,15,群益金鼎-桃園,2024-05-08,9189
2506,太設,14,0,14,群益金鼎-桃園,2024-05-08,9189
6217,中探針,17,3,14,群益金鼎-桃園,2024-05-08,9189
00632R,元大台灣50反1,14,0,14,群益金鼎-桃園,2024-05-08,9189
6230,尼得科超眾,13,0,13,群益金鼎-桃園,2024-05-08,9189
6113,亞矽,13,0,13,群益金鼎-桃園,2024-05-08,9189
2915,潤泰全,15,3,12,群益金鼎-桃園,2024-05-08,9189
6712,長聖,12,0,12,群益金鼎-桃園,2024-05-08,9189
2913,農林,12,0,12,群益金鼎-桃園,2024-05-08,9189
3034,聯詠,15,4,11,群益金鼎-桃園,2024-05-08,9189
6005,群益證,23,12,11,群益金鼎-桃園,2024-05-08,9189
1314,中石化,10,0,10,群益金鼎-桃園,2024-05-08,9189
2201,裕隆,12,2,10,群益金鼎-桃園,2024-05-08,9189
1308,亞聚,10,0,10,群益金鼎-桃園,2024-05-08,9189
1504,東元,26,16,10,群益金鼎-桃園,2024-05-08,9189
00937B,群益ESG投等債20,446,18,428,群益金鼎-桃園,2024-05-09,9189
00946,群益科技高息成長,175,12,163,群益金鼎-桃園,2024-05-09,9189
1310,台苯,100,0,100,群益金鼎-桃園,2024-05-09,9189
2515,中工,100,2,98,群益金鼎-桃園,2024-05-09,9189
1524,耿鼎,78,3,75,群益金鼎-桃園,2024-05-09,9189
2888,新光金,73,2,71,群益金鼎-桃園,2024-05-09,9189
00915,凱基優選高股息30,67,2,65,群益金鼎-桃園,2024-05-09,9189
1312,國喬,60,0,60,群益金鼎-桃園,2024-05-09,9189
2883B,凱基金乙特,50,0,50,群益金鼎-桃園,2024-05-09,9189
2363,矽統,80,35,45,群益金鼎-桃園,2024-05-09,9189
2317,鴻海,69,34,35,群益金鼎-桃園,2024-05-09,9189
5324,士開,35,0,35,群益金鼎-桃園,2024-05-09,9189
00919,群益台灣精選高息,40,7,33,群益金鼎-桃園,2024-05-09,9189
3339,泰谷,37,4,33,群益金鼎-桃園,2024-05-09,9189
2618,長榮航,91,58,33,群益金鼎-桃園,2024-05-09,9189
00679B,元大美債20年,38,5,33,群益金鼎-桃園,2024-05-09,9189
6005,群益證,34,2,32,群益金鼎-桃園,2024-05-09,9189
2834,臺企銀,31,0,31,群益金鼎-桃園,2024-05-09,9189
2884,玉山金,30,1,29,群益金鼎-桃園,2024-05-09,9189
00878,國泰永續高股息,35,6,29,群益金鼎-桃園,2024-05-09,9189
1605,華新,28,1,27,群益金鼎-桃園,2024-05-09,9189
2610,華航,32,5,27,群益金鼎-桃園,2024-05-09,9189
2486,一詮,54,28,26,群益金鼎-桃園,2024-05-09,9189
3231,緯創,36,10,26,群益金鼎-桃園,2024-05-09,9189
1531,高林股,26,1,25,群益金鼎-桃園,2024-05-09,9189
3041,揚智,29,5,24,群益金鼎-桃園,2024-05-09,9189
3494,誠研,23,0,23,群益金鼎-桃園,2024-05-09,9189
5871,中租-KY,25,4,21,群益金鼎-桃園,2024-05-09,9189
2344,華邦電,19,0,19,群益金鼎-桃園,2024-05-09,9189
1616,億泰,19,1,18,群益金鼎-桃園,2024-05-09,9189
6217,中探針,16,0,16,群益金鼎-桃園,2024-05-09,9189
00933B,國泰10Y+金融債,16,0,16,群益金鼎-桃園,2024-05-09,9189
6548,長科*,13,0,13,群益金鼎-桃園,2024-05-09,9189
1609,大亞,17,4,13,群益金鼎-桃園,2024-05-09,9189
00720B,元大投資級公司債,12,0,12,群益金鼎-桃園,2024-05-09,9189
6116,彩晶,12,0,12,群益金鼎-桃園,2024-05-09,9189
2889,國票金,13,1,12,群益金鼎-桃園,2024-05-09,9189
8121,越峰,12,0,12,群益金鼎-桃園,2024-05-09,9189
1303,南亞,11,0,11,群益金鼎-桃園,2024-05-09,9189
3260,威剛,13,2,11,群益金鼎-桃園,2024-05-09,9189
1440,南紡,11,0,11,群益金鼎-桃園,2024-05-09,9189
3024,憶聲,11,0,11,群益金鼎-桃園,2024-05-09,9189
2204,中華,11,0,11,群益金鼎-桃園,2024-05-09,9189
00944,野村趨勢動能高息,10,0,10,群益金鼎-桃園,2024-05-09,9189
8112,至上,25,15,10,群益金鼎-桃園,2024-05-09,9189
2405,輔信,10,0,10,群益金鼎-桃園,2024-05-09,9189
00941,中信上游半導體,10,0,10,群益金鼎-桃園,2024-05-09,9189
2329,華泰,10,0,10,群益金鼎-桃園,2024-05-09,9189
4303,信立,16,6,10,群益金鼎-桃園,2024-05-09,9189
6213,聯茂,15,5,10,群益金鼎-桃園,2024-05-09,9189
2313,華通,232,39,193,群益金鼎-桃園,2024-05-10,9189
00929,復華台灣科技優息,128,0,128,群益金鼎-桃園,2024-05-10,9189
00946,群益科技高息成長,121,0,121,群益金鼎-桃園,2024-05-10,9189
2883B,凱基金乙特,70,0,70,群益金鼎-桃園,2024-05-10,9189
2020,美亞,60,0,60,群益金鼎-桃園,2024-05-10,9189
2323,中環,60,0,60,群益金鼎-桃園,2024-05-10,9189
8112,至上,57,5,52,群益金鼎-桃園,2024-05-10,9189
8436,大江,48,1,47,群益金鼎-桃園,2024-05-10,9189
4904,遠傳,40,0,40,群益金鼎-桃園,2024-05-10,9189
8234,新漢,36,1,35,群益金鼎-桃園,2024-05-10,9189
6005,群益證,57,23,34,群益金鼎-桃園,2024-05-10,9189
1589,永冠-KY,32,0,32,群益金鼎-桃園,2024-05-10,9189
2887,台新金,33,5,28,群益金鼎-桃園,2024-05-10,9189
3706,神達,31,4,27,群益金鼎-桃園,2024-05-10,9189
2355,敬鵬,25,0,25,群益金鼎-桃園,2024-05-10,9189
5324,士開,25,0,25,群益金鼎-桃園,2024-05-10,9189
00940,元大台灣價值高息,62,40,22,群益金鼎-桃園,2024-05-10,9189
5512,力麒,24,2,22,群益金鼎-桃園,2024-05-10,9189
3013,晟銘電,141,120,21,群益金鼎-桃園,2024-05-10,9189
5439,高技,21,0,21,群益金鼎-桃園,2024-05-10,9189
2889,國票金,21,1,20,群益金鼎-桃園,2024-05-10,9189
2369,菱生,21,1,20,群益金鼎-桃園,2024-05-10,9189
5340,建榮,21,1,20,群益金鼎-桃園,2024-05-10,9189
2359,所羅門,22,3,19,群益金鼎-桃園,2024-05-10,9189
2486,一詮,45,26,19,群益金鼎-桃園,2024-05-10,9189
1531,高林股,19,0,19,群益金鼎-桃園,2024-05-10,9189
5608,四維航,30,12,18,群益金鼎-桃園,2024-05-10,9189
3231,緯創,35,17,18,群益金鼎-桃園,2024-05-10,9189
2204,中華,18,1,17,群益金鼎-桃園,2024-05-10,9189
3703,欣陸,16,0,16,群益金鼎-桃園,2024-05-10,9189
4746,台耀,16,1,15,群益金鼎-桃園,2024-05-10,9189
00733,富邦臺灣中小,14,0,14,群益金鼎-桃園,2024-05-10,9189
7402,邑錡,15,1,14,群益金鼎-桃園,2024-05-10,9189
00932,兆豐永續高息等權,13,0,13,群益金鼎-桃園,2024-05-10,9189
1440,南紡,13,0,13,群益金鼎-桃園,2024-05-10,9189
2882,國泰金,55,42,13,群益金鼎-桃園,2024-05-10,9189
2501,國建,22,10,12,群益金鼎-桃園,2024-05-10,9189
2317,鴻海,17,6,11,群益金鼎-桃園,2024-05-10,9189
4576,大銀微系統,17,6,11,群益金鼎-桃園,2024-05-10,9189
2606,裕民,42,31,11,群益金鼎-桃園,2024-05-10,9189
4306,炎洲,11,0,11,群益金鼎-桃園,2024-05-10,9189
6024,群益期,11,0,11,群益金鼎-桃園,2024-05-10,9189
2515,中工,14,3,11,群益金鼎-桃園,2024-05-10,9189
4960,誠美材,20,10,10,群益金鼎-桃園,2024-05-10,9189
00645,富邦日本,16,6,10,群益金鼎-桃園,2024-05-10,9189
1442,名軒,10,0,10,群益金鼎-桃園,2024-05-10,9189
00764B,群益25年美債,14,4,10,群益金鼎-桃園,2024-05-10,9189
2029,盛餘,10,0,10,群益金鼎-桃園,2024-05-10,9189
6525,捷敏-KY,10,0,10,群益金鼎-桃園,2024-05-10,9189
3164,景岳,10,0,10,群益金鼎-桃園,2024-05-10,9189
00919,群益台灣精選高息,568,16,552,群益金鼎-桃園,2024-05-13,9189
2615,萬海,158,38,120,群益金鼎-桃園,2024-05-13,9189
2883,凱基金,143,25,118,群益金鼎-桃園,2024-05-13,9189
2344,華邦電,110,0,110,群益金鼎-桃園,2024-05-13,9189
00706L,期元大S＆P日圓正2,90,0,90,群益金鼎-桃園,2024-05-13,9189
2501,國建,84,10,74,群益金鼎-桃園,2024-05-13,9189
2610,華航,129,69,60,群益金鼎-桃園,2024-05-13,9189
00751B,元大AAA至A公司債,53,0,53,群益金鼎-桃園,2024-05-13,9189
2641,正德,71,18,53,群益金鼎-桃園,2024-05-13,9189
3481,群創,55,3,52,群益金鼎-桃園,2024-05-13,9189
2883B,凱基金乙特,52,0,52,群益金鼎-桃園,2024-05-13,9189
2618,長榮航,191,139,52,群益金鼎-桃園,2024-05-13,9189
2867,三商壽,52,2,50,群益金鼎-桃園,2024-05-13,9189
2834,臺企銀,50,0,50,群益金鼎-桃園,2024-05-13,9189
00946,群益科技高息成長,80,30,50,群益金鼎-桃園,2024-05-13,9189
00937B,群益ESG投等債20,57,10,47,群益金鼎-桃園,2024-05-13,9189
00929,復華台灣科技優息,48,4,44,群益金鼎-桃園,2024-05-13,9189
2317,鴻海,48,7,41,群益金鼎-桃園,2024-05-13,9189
1310,台苯,40,0,40,群益金鼎-桃園,2024-05-13,9189
4904,遠傳,40,3,37,群益金鼎-桃園,2024-05-13,9189
00878,國泰永續高股息,69,34,35,群益金鼎-桃園,2024-05-13,9189
2363,矽統,33,5,28,群益金鼎-桃園,2024-05-13,9189
6265,方土昶,22,0,22,群益金鼎-桃園,2024-05-13,9189
2449,京元電子,21,0,21,群益金鼎-桃園,2024-05-13,9189
2313,華通,26,5,21,群益金鼎-桃園,2024-05-13,9189
2355,敬鵬,20,0,20,群益金鼎-桃園,2024-05-13,9189
00642U,期元大S＆P石油,20,0,20,群益金鼎-桃園,2024-05-13,9189
6283,淳安,19,0,19,群益金鼎-桃園,2024-05-13,9189
8096,擎亞,21,2,19,群益金鼎-桃園,2024-05-13,9189
2605,新興,114,95,19,群益金鼎-桃園,2024-05-13,9189
2891,中信金,30,11,19,群益金鼎-桃園,2024-05-13,9189
0056,元大高股息,21,2,19,群益金鼎-桃園,2024-05-13,9189
00632R,元大台灣50反1,28,10,18,群益金鼎-桃園,2024-05-13,9189
1531,高林股,18,0,18,群益金鼎-桃園,2024-05-13,9189
5512,力麒,16,0,16,群益金鼎-桃園,2024-05-13,9189
3231,緯創,22,6,16,群益金鼎-桃園,2024-05-13,9189
2882,國泰金,28,13,15,群益金鼎-桃園,2024-05-13,9189
1616,億泰,29,14,15,群益金鼎-桃園,2024-05-13,9189
2367,燿華,105,91,14,群益金鼎-桃園,2024-05-13,9189
00795B,中信美國公債20年,14,0,14,群益金鼎-桃園,2024-05-13,9189
3013,晟銘電,33,20,13,群益金鼎-桃園,2024-05-13,9189
1513,中興電,21,8,13,群益金鼎-桃園,2024-05-13,9189
3188,鑫龍騰,16,3,13,群益金鼎-桃園,2024-05-13,9189
6743,安普新,16,3,13,群益金鼎-桃園,2024-05-13,9189
6140,訊達,12,0,12,群益金鼎-桃園,2024-05-13,9189
2637,慧洋-KY,27,15,12,群益金鼎-桃園,2024-05-13,9189
4303,信立,12,1,11,群益金鼎-桃園,2024-05-13,9189
3260,威剛,14,3,11,群益金鼎-桃園,2024-05-13,9189
00679B,元大美債20年,10,0,10,群益金鼎-桃園,2024-05-13,9189
2359,所羅門,12,2,10,群益金鼎-桃園,2024-05-13,9189
00937B,群益ESG投等債20,508,4,504,群益金鼎-桃園,2024-05-14,9189
2845,遠東銀,100,0,100,群益金鼎-桃園,2024-05-14,9189
2615,萬海,230,147,83,群益金鼎-桃園,2024-05-14,9189
9945,潤泰新,117,34,83,群益金鼎-桃園,2024-05-14,9189
6005,群益證,83,3,80,群益金鼎-桃園,2024-05-14,9189
1310,台苯,50,0,50,群益金鼎-桃園,2024-05-14,9189
1531,高林股,44,0,44,群益金鼎-桃園,2024-05-14,9189
00909,國泰數位支付服務,43,0,43,群益金鼎-桃園,2024-05-14,9189
00946,群益科技高息成長,50,12,38,群益金鼎-桃園,2024-05-14,9189
1474,弘裕,30,0,30,群益金鼎-桃園,2024-05-14,9189
00637L,元大滬深300正2,30,1,29,群益金鼎-桃園,2024-05-14,9189
00679B,元大美債20年,27,0,27,群益金鼎-桃園,2024-05-14,9189
00751B,元大AAA至A公司債,26,0,26,群益金鼎-桃園,2024-05-14,9189
00878,國泰永續高股息,43,18,25,群益金鼎-桃園,2024-05-14,9189
5508,永信建,25,1,24,群益金鼎-桃園,2024-05-14,9189
2882,國泰金,26,2,24,群益金鼎-桃園,2024-05-14,9189
00882,中信中國高股息,24,0,24,群益金鼎-桃園,2024-05-14,9189
3481,群創,21,0,21,群益金鼎-桃園,2024-05-14,9189
00936,台新永續高息中小,22,1,21,群益金鼎-桃園,2024-05-14,9189
2317,鴻海,35,15,20,群益金鼎-桃園,2024-05-14,9189
1714,和桐,20,0,20,群益金鼎-桃園,2024-05-14,9189
1304,台聚,20,0,20,群益金鼎-桃園,2024-05-14,9189
5371,中光電,22,2,20,群益金鼎-桃園,2024-05-14,9189
9904,寶成,31,11,20,群益金鼎-桃園,2024-05-14,9189
00655L,國泰中國A50正2,20,0,20,群益金鼎-桃園,2024-05-14,9189
1524,耿鼎,20,2,18,群益金鼎-桃園,2024-05-14,9189
2049,上銀,17,0,17,群益金鼎-桃園,2024-05-14,9189
2609,陽明,255,238,17,群益金鼎-桃園,2024-05-14,9189
0056,元大高股息,25,9,16,群益金鼎-桃園,2024-05-14,9189
6283,淳安,15,0,15,群益金鼎-桃園,2024-05-14,9189
1455,集盛,15,0,15,群益金鼎-桃園,2024-05-14,9189
00942B,台新美A公司債20+,14,0,14,群益金鼎-桃園,2024-05-14,9189
3231,緯創,21,7,14,群益金鼎-桃園,2024-05-14,9189
2520,冠德,16,3,13,群益金鼎-桃園,2024-05-14,9189
5871,中租-KY,16,3,13,群益金鼎-桃園,2024-05-14,9189
2101,南港,33,20,13,群益金鼎-桃園,2024-05-14,9189
2889,國票金,14,1,13,群益金鼎-桃園,2024-05-14,9189
00929,復華台灣科技優息,16,3,13,群益金鼎-桃園,2024-05-14,9189
1609,大亞,12,1,11,群益金鼎-桃園,2024-05-14,9189
2617,台航,16,5,11,群益金鼎-桃園,2024-05-14,9189
00933B,國泰10Y+金融債,11,0,11,群益金鼎-桃園,2024-05-14,9189
1308,亞聚,11,0,11,群益金鼎-桃園,2024-05-14,9189
2884,玉山金,11,0,11,群益金鼎-桃園,2024-05-14,9189
2013,中鋼構,10,0,10,群益金鼎-桃園,2024-05-14,9189
6264,富裔,10,0,10,群益金鼎-桃園,2024-05-14,9189
3346,麗清,10,0,10,群益金鼎-桃園,2024-05-14,9189
1313,聯成,10,0,10,群益金鼎-桃園,2024-05-14,9189
2312,金寶,10,0,10,群益金鼎-桃園,2024-05-14,9189
8111,立��,10,0,10,群益金鼎-桃園,2024-05-14,9189
4967,十銓,11,2,9,群益金鼎-桃園,2024-05-14,9189
00679B,元大美債20年,205,0,205,群益金鼎-桃園,2024-05-15,9189
2609,陽明,324,171,153,群益金鼎-桃園,2024-05-15,9189
00919,群益台灣精選高息,165,32,133,群益金鼎-桃園,2024-05-15,9189
00937B,群益ESG投等債20,135,5,130,群益金鼎-桃園,2024-05-15,9189
2344,華邦電,95,5,90,群益金鼎-桃園,2024-05-15,9189
1304,台聚,88,0,88,群益金鼎-桃園,2024-05-15,9189
1308,亞聚,68,4,64,群益金鼎-桃園,2024-05-15,9189
2618,長榮航,98,44,54,群益金鼎-桃園,2024-05-15,9189
00946,群益科技高息成長,77,40,37,群益金鼎-桃園,2024-05-15,9189
2323,中環,33,3,30,群益金鼎-桃園,2024-05-15,9189
1305,華夏,30,0,30,群益金鼎-桃園,2024-05-15,9189
00930,永豐ESG低碳高息,30,0,30,群益金鼎-桃園,2024-05-15,9189
6116,彩晶,30,0,30,群益金鼎-桃園,2024-05-15,9189
00690,兆豐藍籌30,30,1,29,群益金鼎-桃園,2024-05-15,9189
00932,兆豐永續高息等權,52,24,28,群益金鼎-桃園,2024-05-15,9189
3268,海德威,22,0,22,群益金鼎-桃園,2024-05-15,9189
2605,新興,27,5,22,群益金鼎-桃園,2024-05-15,9189
00936,台新永續高息中小,22,0,22,群益金鼎-桃園,2024-05-15,9189
00795B,中信美國公債20年,22,0,22,群益金鼎-桃園,2024-05-15,9189
3051,力特,21,0,21,群益金鼎-桃園,2024-05-15,9189
2603,長榮,45,24,21,群益金鼎-桃園,2024-05-15,9189
1776,展宇,20,0,20,群益金鼎-桃園,2024-05-15,9189
1474,弘裕,20,0,20,群益金鼎-桃園,2024-05-15,9189
4720,德淵,18,0,18,群益金鼎-桃園,2024-05-15,9189
1531,高林股,16,0,16,群益金鼎-桃園,2024-05-15,9189
1459,聯發,16,0,16,群益金鼎-桃園,2024-05-15,9189
2537,聯上發,15,0,15,群益金鼎-桃園,2024-05-15,9189
5512,力麒,14,1,13,群益金鼎-桃園,2024-05-15,9189
3042,晶技,12,0,12,群益金鼎-桃園,2024-05-15,9189
00664R,國泰臺灣加權反1,12,0,12,群益金鼎-桃園,2024-05-15,9189
2331,精英,23,12,11,群益金鼎-桃園,2024-05-15,9189
2355,敬鵬,23,12,11,群益金鼎-桃園,2024-05-15,9189
5213,亞昕,11,0,11,群益金鼎-桃園,2024-05-15,9189
2009,第一銅,40,29,11,群益金鼎-桃園,2024-05-15,9189
2356,英業達,60,49,11,群益金鼎-桃園,2024-05-15,9189
3013,晟銘電,55,45,10,群益金鼎-桃園,2024-05-15,9189
6443,元晶,13,3,10,群益金鼎-桃園,2024-05-15,9189
2509,全坤建,10,0,10,群益金鼎-桃園,2024-05-15,9189
3701,大眾控,10,0,10,群益金鼎-桃園,2024-05-15,9189
8054,安國,25,15,10,群益金鼎-桃園,2024-05-15,9189
2528,皇普,10,0,10,群益金鼎-桃園,2024-05-15,9189
00881,國泰台灣5G+,11,1,10,群益金鼎-桃園,2024-05-15,9189
6127,九豪,10,0,10,群益金鼎-桃園,2024-05-15,9189
5498,凱崴,10,0,10,群益金鼎-桃園,2024-05-15,9189
2885,元大金,15,6,9,群益金鼎-桃園,2024-05-15,9189
4726,永昕,10,1,9,群益金鼎-桃園,2024-05-15,9189
2376,技嘉,15,7,8,群益金鼎-桃園,2024-05-15,9189
4576,大銀微系統,8,0,8,群益金鼎-桃園,2024-05-15,9189
4904,遠傳,20,12,8,群益金鼎-桃園,2024-05-15,9189
2845,遠東銀,8,0,8,群益金鼎-桃園,2024-05-15,9189
00632R,元大台灣50反1,795,55,740,群益金鼎-桃園,2024-05-16,9189
3450,聯鈞,110,22,88,群益金鼎-桃園,2024-05-16,9189
2382,廣達,70,16,54,群益金鼎-桃園,2024-05-16,9189
1447,力鵬,60,16,44,群益金鼎-桃園,2024-05-16,9189
3231,緯創,80,36,44,群益金鼎-桃園,2024-05-16,9189
1304,台聚,42,2,40,群益金鼎-桃園,2024-05-16,9189
2610,華航,112,78,34,群益金鼎-桃園,2024-05-16,9189
2515,中工,41,10,31,群益金鼎-桃園,2024-05-16,9189
00864B,中信美國公債0-1,31,0,31,群益金鼎-桃園,2024-05-16,9189
4164,承業醫,30,0,30,群益金鼎-桃園,2024-05-16,9189
00878,國泰永續高股息,68,39,29,群益金鼎-桃園,2024-05-16,9189
00929,復華台灣科技優息,53,30,23,群益金鼎-桃園,2024-05-16,9189
00933B,國泰10Y+金融債,29,6,23,群益金鼎-桃園,2024-05-16,9189
2317,鴻海,104,80,24,群益金鼎-桃園,2024-05-16,9189
6592,和潤企業,23,0,23,群益金鼎-桃園,2024-05-16,9189
2408,南亞科,23,0,23,群益金鼎-桃園,2024-05-16,9189
8069,元太,20,0,20,群益金鼎-桃園,2024-05-16,9189
1308,亞聚,20,0,20,群益金鼎-桃園,2024-05-16,9189
2886,兆豐金,20,0,20,群益金鼎-桃園,2024-05-16,9189
1563,巧新,20,0,20,群益金鼎-桃園,2024-05-16,9189
2365,昆盈,48,29,19,群益金鼎-桃園,2024-05-16,9189
00690,兆豐藍籌30,20,1,19,群益金鼎-桃園,2024-05-16,9189
2889,國票金,23,6,17,群益金鼎-桃園,2024-05-16,9189
6438,迅得,16,0,16,群益金鼎-桃園,2024-05-16,9189
1711,永光,15,1,14,群益金鼎-桃園,2024-05-16,9189
4956,光鋐,14,0,14,群益金鼎-桃園,2024-05-16,9189
00946,群益科技高息成長,96,82,14,群益金鼎-桃園,2024-05-16,9189
00733,富邦臺灣中小,14,1,13,群益金鼎-桃園,2024-05-16,9189
1722,台肥,13,0,13,群益金鼎-桃園,2024-05-16,9189
2009,第一銅,34,21,13,群益金鼎-桃園,2024-05-16,9189
2352,佳世達,30,18,12,群益金鼎-桃園,2024-05-16,9189
8147,正淩,12,0,12,群益金鼎-桃園,2024-05-16,9189
3312,弘憶股,20,8,12,群益金鼎-桃園,2024-05-16,9189
1453,大將,13,2,11,群益金鼎-桃園,2024-05-16,9189
2883,凱基金,23,13,10,群益金鼎-桃園,2024-05-16,9189
6425,易發,12,2,10,群益金鼎-桃園,2024-05-16,9189
1584,精剛,10,0,10,群益金鼎-桃園,2024-05-16,9189
5515,建國,10,0,10,群益金鼎-桃園,2024-05-16,9189
3227,原相,13,3,10,群益金鼎-桃園,2024-05-16,9189
2351,順德,10,0,10,群益金鼎-桃園,2024-05-16,9189
2546,根基,10,0,10,群益金鼎-桃園,2024-05-16,9189
2356,英業達,48,38,10,群益金鼎-桃園,2024-05-16,9189
3492,長盛,10,1,9,群益金鼎-桃園,2024-05-16,9189
2362,藍天,96,87,9,群益金鼎-桃園,2024-05-16,9189
4545,銘鈺,17,8,9,群益金鼎-桃園,2024-05-16,9189
4908,前鼎,12,3,9,群益金鼎-桃園,2024-05-16,9189
3481,群創,21,13,8,群益金鼎-桃園,2024-05-16,9189
3030,德律,10,2,8,群益金鼎-桃園,2024-05-16,9189
8070,長華*,8,0,8,群益金鼎-桃園,2024-05-16,9189
1440,南紡,11,3,8,群益金鼎-桃園,2024-05-16,9189
00937B,群益ESG投等債20,1020,60,960,群益金鼎-桃園,2024-05-17,9189
00946,群益科技高息成長,265,41,224,群益金鼎-桃園,2024-05-17,9189
2618,長榮航,330,163,167,群益金鼎-桃園,2024-05-17,9189
9945,潤泰新,310,171,139,群益金鼎-桃園,2024-05-17,9189
2489,瑞軒,153,26,127,群益金鼎-桃園,2024-05-17,9189
2845,遠東銀,103,0,103,群益金鼎-桃園,2024-05-17,9189
3033,威健,108,6,102,群益金鼎-桃園,2024-05-17,9189
1440,南紡,100,0,100,群益金鼎-桃園,2024-05-17,9189
3450,聯鈞,110,19,91,群益金鼎-桃園,2024-05-17,9189
3047,訊舟,77,5,72,群益金鼎-桃園,2024-05-17,9189
00942B,台新美A公司債20+,71,0,71,群益金鼎-桃園,2024-05-17,9189
2020,美亞,71,0,71,群益金鼎-桃園,2024-05-17,9189
00878,國泰永續高股息,75,9,66,群益金鼎-桃園,2024-05-17,9189
3494,誠研,60,0,60,群益金鼎-桃園,2024-05-17,9189
3481,群創,75,19,56,群益金鼎-桃園,2024-05-17,9189
1313,聯成,55,5,50,群益金鼎-桃園,2024-05-17,9189
1513,中興電,51,4,47,群益金鼎-桃園,2024-05-17,9189
2611,志信,46,3,43,群益金鼎-桃園,2024-05-17,9189
2609,陽明,58,16,42,群益金鼎-桃園,2024-05-17,9189
00795B,中信美國公債20年,42,0,42,群益金鼎-桃園,2024-05-17,9189
6005,群益證,54,13,41,群益金鼎-桃園,2024-05-17,9189
3356,奇偶,40,0,40,群益金鼎-桃園,2024-05-17,9189
00929,復華台灣科技優息,42,3,39,群益金鼎-桃園,2024-05-17,9189
9904,寶成,40,1,39,群益金鼎-桃園,2024-05-17,9189
2406,國碩,52,15,37,群益金鼎-桃園,2024-05-17,9189
912000,晨訊科-DR,35,0,35,群益金鼎-桃園,2024-05-17,9189
3059,華晶科,44,14,30,群益金鼎-桃園,2024-05-17,9189
2834,臺企銀,40,11,29,群益金鼎-桃園,2024-05-17,9189
5392,能率,35,7,28,群益金鼎-桃園,2024-05-17,9189
2349,錸德,27,0,27,群益金鼎-桃園,2024-05-17,9189
3363,上詮,32,10,22,群益金鼎-桃園,2024-05-17,9189
00733,富邦臺灣中小,22,0,22,群益金鼎-桃園,2024-05-17,9189
2323,中環,37,15,22,群益金鼎-桃園,2024-05-17,9189
2637,慧洋-KY,23,1,22,群益金鼎-桃園,2024-05-17,9189
2606,裕民,21,1,20,群益金鼎-桃園,2024-05-17,9189
2509,全坤建,20,0,20,群益金鼎-桃園,2024-05-17,9189
00919,群益台灣精選高息,22,3,19,群益金鼎-桃園,2024-05-17,9189
8271,宇瞻,21,2,19,群益金鼎-桃園,2024-05-17,9189
6177,達麗,20,2,18,群益金鼎-桃園,2024-05-17,9189
2408,南亞科,18,0,18,群益金鼎-桃園,2024-05-17,9189
3024,憶聲,17,0,17,群益金鼎-桃園,2024-05-17,9189
3051,力特,20,5,15,群益金鼎-桃園,2024-05-17,9189
1718,中纖,15,0,15,群益金鼎-桃園,2024-05-17,9189
1301,台塑,15,0,15,群益金鼎-桃園,2024-05-17,9189
1218,泰山,15,0,15,群益金鼎-桃園,2024-05-17,9189
2356,英業達,19,5,14,群益金鼎-桃園,2024-05-17,9189
2317,鴻海,39,26,13,群益金鼎-桃園,2024-05-17,9189
1609,大亞,16,3,13,群益金鼎-桃園,2024-05-17,9189
2514,龍邦,18,5,13,群益金鼎-桃園,2024-05-17,9189
3060,銘異,49,36,13,群益金鼎-桃園,2024-05-17,9189
2618,長榮航,284,96,188,群益金鼎-桃園,2024-05-20,9189
00632R,元大台灣50反1,200,32,168,群益金鼎-桃園,2024-05-20,9189
00937B,群益ESG投等債20,94,0,94,群益金鼎-桃園,2024-05-20,9189
2867,三商壽,78,2,76,群益金鼎-桃園,2024-05-20,9189
2610,華航,102,33,69,群益金鼎-桃園,2024-05-20,9189
2501,國建,71,3,68,群益金鼎-桃園,2024-05-20,9189
00929,復華台灣科技優息,106,41,65,群益金鼎-桃園,2024-05-20,9189
2392,正崴,83,20,63,群益金鼎-桃園,2024-05-20,9189
9945,潤泰新,61,4,57,群益金鼎-桃園,2024-05-20,9189
2344,華邦電,52,0,52,群益金鼎-桃園,2024-05-20,9189
00878,國泰永續高股息,72,23,49,群益金鼎-桃園,2024-05-20,9189
00919,群益台灣精選高息,99,50,49,群益金鼎-桃園,2024-05-20,9189
00946,群益科技高息成長,278,232,46,群益金鼎-桃園,2024-05-20,9189
2367,燿華,108,64,44,群益金鼎-桃園,2024-05-20,9189
1442,名軒,41,0,41,群益金鼎-桃園,2024-05-20,9189
2329,華泰,45,6,39,群益金鼎-桃園,2024-05-20,9189
1313,聯成,38,0,38,群益金鼎-桃園,2024-05-20,9189
9904,寶成,39,3,36,群益金鼎-桃園,2024-05-20,9189
2382,廣達,40,6,34,群益金鼎-桃園,2024-05-20,9189
2014,中鴻,65,31,34,群益金鼎-桃園,2024-05-20,9189
00795B,中信美國公債20年,27,0,27,群益金鼎-桃園,2024-05-20,9189
6005,群益證,27,1,26,群益金鼎-桃園,2024-05-20,9189
00665L,富邦�琤肭磪囓�2,26,0,26,群益金鼎-桃園,2024-05-20,9189
2104,國際中橡,27,1,26,群益金鼎-桃園,2024-05-20,9189
5009,榮剛,26,1,25,群益金鼎-桃園,2024-05-20,9189
6265,方土昶,28,5,23,群益金鼎-桃園,2024-05-20,9189
2317,鴻海,31,8,23,群益金鼎-桃園,2024-05-20,9189
4533,協易機,100,78,22,群益金鼎-桃園,2024-05-20,9189
3576,聯合再生,42,20,22,群益金鼎-桃園,2024-05-20,9189
2547,日勝生,21,0,21,群益金鼎-桃園,2024-05-20,9189
3188,鑫龍騰,20,0,20,群益金鼎-桃園,2024-05-20,9189
6117,迎廣,20,1,19,群益金鼎-桃園,2024-05-20,9189
6770,力積電,25,7,18,群益金鼎-桃園,2024-05-20,9189
5508,永信建,19,1,18,群益金鼎-桃園,2024-05-20,9189
6443,元晶,21,3,18,群益金鼎-桃園,2024-05-20,9189
3231,緯創,28,11,17,群益金鼎-桃園,2024-05-20,9189
1589,永冠-KY,15,0,15,群益金鼎-桃園,2024-05-20,9189
912000,晨訊科-DR,15,0,15,群益金鼎-桃園,2024-05-20,9189
6177,達麗,31,16,15,群益金鼎-桃園,2024-05-20,9189
2887,台新金,35,20,15,群益金鼎-桃園,2024-05-20,9189
1504,東元,41,27,14,群益金鼎-桃園,2024-05-20,9189
2739,寒舍,23,10,13,群益金鼎-桃園,2024-05-20,9189
2007,燁興,19,6,13,群益金鼎-桃園,2024-05-20,9189
2359,所羅門,59,47,12,群益金鼎-桃園,2024-05-20,9189
00933B,國泰10Y+金融債,12,0,12,群益金鼎-桃園,2024-05-20,9189
1101,台泥,16,4,12,群益金鼎-桃園,2024-05-20,9189
00650L,復華香港正2,12,0,12,群益金鼎-桃園,2024-05-20,9189
4532,瑞智,15,3,12,群益金鼎-桃園,2024-05-20,9189
2371,大同,14,3,11,群益金鼎-桃園,2024-05-20,9189
1618,合機,13,2,11,群益金鼎-桃園,2024-05-20,9189
00937B,群益ESG投等債20,566,4,562,群益金鼎-桃園,2024-05-21,9189
1304,台聚,84,10,74,群益金鼎-桃園,2024-05-21,9189
00929,復華台灣科技優息,73,4,69,群益金鼎-桃園,2024-05-21,9189
9904,寶成,71,3,68,群益金鼎-桃園,2024-05-21,9189
1313,聯成,87,30,57,群益金鼎-桃園,2024-05-21,9189
2884,玉山金,54,1,53,群益金鼎-桃園,2024-05-21,9189
00680L,元大美債20正2,50,0,50,群益金鼎-桃園,2024-05-21,9189
00900,富邦特選高股息30,47,0,47,群益金鼎-桃園,2024-05-21,9189
2609,陽明,52,12,40,群益金鼎-桃園,2024-05-21,9189
911868,同方友友-DR,40,0,40,群益金鼎-桃園,2024-05-21,9189
5302,太欣,32,0,32,群益金鼎-桃園,2024-05-21,9189
2208,台船,26,0,26,群益金鼎-桃園,2024-05-21,9189
2489,瑞軒,55,29,26,群益金鼎-桃園,2024-05-21,9189
3024,憶聲,26,0,26,群益金鼎-桃園,2024-05-21,9189
00665L,富邦�琤肭磪囓�2,26,0,26,群益金鼎-桃園,2024-05-21,9189
2002,中鋼,27,1,26,群益金鼎-桃園,2024-05-21,9189
2104,國際中橡,24,0,24,群益金鼎-桃園,2024-05-21,9189
2349,錸德,23,0,23,群益金鼎-桃園,2024-05-21,9189
2382,廣達,23,1,22,群益金鼎-桃園,2024-05-21,9189
00764B,群益25年美債,20,0,20,群益金鼎-桃園,2024-05-21,9189
1718,中纖,19,0,19,群益金鼎-桃園,2024-05-21,9189
1453,大將,26,7,19,群益金鼎-桃園,2024-05-21,9189
1442,名軒,18,0,18,群益金鼎-桃園,2024-05-21,9189
00751B,元大AAA至A公司債,16,0,16,群益金鼎-桃園,2024-05-21,9189
5009,榮剛,16,0,16,群益金鼎-桃園,2024-05-21,9189
2317,鴻海,27,12,15,群益金鼎-桃園,2024-05-21,9189
3576,聯合再生,15,0,15,群益金鼎-桃園,2024-05-21,9189
2312,金寶,25,10,15,群益金鼎-桃園,2024-05-21,9189
2520,冠德,17,2,15,群益金鼎-桃園,2024-05-21,9189
00919,群益台灣精選高息,30,16,14,群益金鼎-桃園,2024-05-21,9189
00878,國泰永續高股息,17,3,14,群益金鼎-桃園,2024-05-21,9189
2367,燿華,148,134,14,群益金鼎-桃園,2024-05-21,9189
00632R,元大台灣50反1,36,22,14,群益金鼎-桃園,2024-05-21,9189
2303,聯電,61,47,14,群益金鼎-桃園,2024-05-21,9189
5371,中光電,31,18,13,群益金鼎-桃園,2024-05-21,9189
2352,佳世達,20,7,13,群益金鼎-桃園,2024-05-21,9189
00909,國泰數位支付服務,15,2,13,群益金鼎-桃園,2024-05-21,9189
2883,凱基金,12,0,12,群益金鼎-桃園,2024-05-21,9189
6274,台燿,13,1,12,群益金鼎-桃園,2024-05-21,9189
1504,東元,12,0,12,群益金鼎-桃園,2024-05-21,9189
5521,工信,12,0,12,群益金鼎-桃園,2024-05-21,9189
2903,遠百,12,0,12,群益金鼎-桃園,2024-05-21,9189
3689,湧德,12,0,12,群益金鼎-桃園,2024-05-21,9189
00944,野村趨勢動能高息,11,0,11,群益金鼎-桃園,2024-05-21,9189
8071,能率網通,23,12,11,群益金鼎-桃園,2024-05-21,9189
2915,潤泰全,11,0,11,群益金鼎-桃園,2024-05-21,9189
00940,元大台灣價值高息,21,10,11,群益金鼎-桃園,2024-05-21,9189
2610,華航,30,20,10,群益金鼎-桃園,2024-05-21,9189
2509,全坤建,10,0,10,群益金鼎-桃園,2024-05-21,9189
1612,宏泰,12,2,10,群益金鼎-桃園,2024-05-21,9189
3481,群創,3111,100,3011,群益金鼎-桃園,2024-05-22,9189
2409,友達,516,21,495,群益金鼎-桃園,2024-05-22,9189
00937B,群益ESG投等債20,181,0,181,群益金鼎-桃園,2024-05-22,9189
2867,三商壽,165,11,154,群益金鼎-桃園,2024-05-22,9189
00632R,元大台灣50反1,140,7,133,群益金鼎-桃園,2024-05-22,9189
2881,富邦金,100,0,100,群益金鼎-桃園,2024-05-22,9189
00680L,元大美債20正2,69,0,69,群益金鼎-桃園,2024-05-22,9189
2618,長榮航,77,16,61,群益金鼎-桃園,2024-05-22,9189
9945,潤泰新,53,2,51,群益金鼎-桃園,2024-05-22,9189
2002,中鋼,75,30,45,群益金鼎-桃園,2024-05-22,9189
2489,瑞軒,48,13,35,群益金鼎-桃園,2024-05-22,9189
2884,玉山金,38,5,33,群益金鼎-桃園,2024-05-22,9189
2892,第一金,27,0,27,群益金鼎-桃園,2024-05-22,9189
3013,晟銘電,88,62,26,群益金鼎-桃園,2024-05-22,9189
5230,雷笛克光學,36,11,25,群益金鼎-桃園,2024-05-22,9189
00642U,期元大S＆P石油,25,0,25,群益金鼎-桃園,2024-05-22,9189
1608,華榮,27,3,24,群益金鼎-桃園,2024-05-22,9189
5324,士開,24,0,24,群益金鼎-桃園,2024-05-22,9189
2392,正崴,43,20,23,群益金鼎-桃園,2024-05-22,9189
5512,力麒,22,0,22,群益金鼎-桃園,2024-05-22,9189
5864,致和證,20,0,20,群益金鼎-桃園,2024-05-22,9189
2369,菱生,20,0,20,群益金鼎-桃園,2024-05-22,9189
2610,華航,34,14,20,群益金鼎-桃園,2024-05-22,9189
2801,彰銀,20,0,20,群益金鼎-桃園,2024-05-22,9189
3033,威健,20,4,16,群益金鼎-桃園,2024-05-22,9189
00733,富邦臺灣中小,27,11,16,群益金鼎-桃園,2024-05-22,9189
3188,鑫龍騰,15,0,15,群益金鼎-桃園,2024-05-22,9189
2406,國碩,23,9,14,群益金鼎-桃園,2024-05-22,9189
1587,吉茂,14,0,14,群益金鼎-桃園,2024-05-22,9189
2104,國際中橡,14,0,14,群益金鼎-桃園,2024-05-22,9189
2634,漢翔,14,0,14,群益金鼎-桃園,2024-05-22,9189
3030,德律,16,2,14,群益金鼎-桃園,2024-05-22,9189
1303,南亞,13,0,13,群益金鼎-桃園,2024-05-22,9189
1453,大將,14,1,13,群益金鼎-桃園,2024-05-22,9189
2630,亞航,12,0,12,群益金鼎-桃園,2024-05-22,9189
00665L,富邦�琤肭磪囓�2,12,0,12,群益金鼎-桃園,2024-05-22,9189
2537,聯上發,19,7,12,群益金鼎-桃園,2024-05-22,9189
2476,鉅祥,11,0,11,群益金鼎-桃園,2024-05-22,9189
9904,寶成,12,1,11,群益金鼎-桃園,2024-05-22,9189
3005,神基,16,5,11,群益金鼎-桃園,2024-05-22,9189
3231,緯創,18,8,10,群益金鼎-桃園,2024-05-22,9189
5521,工信,10,0,10,群益金鼎-桃園,2024-05-22,9189
1605,華新,22,12,10,群益金鼎-桃園,2024-05-22,9189
2607,榮運,10,0,10,群益金鼎-桃園,2024-05-22,9189
1434,福懋,10,0,10,群益金鼎-桃園,2024-05-22,9189
9960,邁達康,10,0,10,群益金鼎-桃園,2024-05-22,9189
1591,駿吉-KY,10,0,10,群益金鼎-桃園,2024-05-22,9189
00715L,期街口布蘭特正2,10,0,10,群益金鼎-桃園,2024-05-22,9189
00645,富邦日本,10,0,10,群益金鼎-桃園,2024-05-22,9189
00942B,台新美A公司債20+,10,0,10,群益金鼎-桃園,2024-05-22,9189
00937B,群益ESG投等債20,483,0,483,群益金鼎-桃園,2024-05-23,9189
3481,群創,646,293,353,群益金鼎-桃園,2024-05-23,9189
2867,三商壽,315,30,285,群益金鼎-桃園,2024-05-23,9189
00632R,元大台灣50反1,228,64,164,群益金鼎-桃園,2024-05-23,9189
3013,晟銘電,222,62,160,群益金鼎-桃園,2024-05-23,9189
5324,士開,130,0,130,群益金鼎-桃園,2024-05-23,9189
2002,中鋼,92,0,92,群益金鼎-桃園,2024-05-23,9189
6147,頎邦,77,0,77,群益金鼎-桃園,2024-05-23,9189
1815,富喬,180,117,63,群益金鼎-桃園,2024-05-23,9189
2101,南港,61,11,50,群益金鼎-桃園,2024-05-23,9189
3450,聯鈞,73,27,46,群益金鼎-桃園,2024-05-23,9189
2440,太空梭,60,17,43,群益金鼎-桃園,2024-05-23,9189
2883,凱基金,42,1,41,群益金鼎-桃園,2024-05-23,9189
1608,華榮,40,2,38,群益金鼎-桃園,2024-05-23,9189
2367,燿華,52,17,35,群益金鼎-桃園,2024-05-23,9189
2020,美亞,31,0,31,群益金鼎-桃園,2024-05-23,9189
2104,國際中橡,30,0,30,群益金鼎-桃園,2024-05-23,9189
2464,盟立,72,43,29,群益金鼎-桃園,2024-05-23,9189
6275,元山,36,8,28,群益金鼎-桃園,2024-05-23,9189
2891,中信金,33,5,28,群益金鼎-桃園,2024-05-23,9189
2609,陽明,36,9,27,群益金鼎-桃園,2024-05-23,9189
00642U,期元大S＆P石油,26,0,26,群益金鼎-桃園,2024-05-23,9189
8104,錸寶,25,0,25,群益金鼎-桃園,2024-05-23,9189
2359,所羅門,70,47,23,群益金鼎-桃園,2024-05-23,9189
00936,台新永續高息中小,24,1,23,群益金鼎-桃園,2024-05-23,9189
3231,緯創,55,33,22,群益金鼎-桃園,2024-05-23,9189
2834,臺企銀,22,0,22,群益金鼎-桃園,2024-05-23,9189
3030,德律,26,4,22,群益金鼎-桃園,2024-05-23,9189
1303,南亞,22,0,22,群益金鼎-桃園,2024-05-23,9189
2882,國泰金,22,0,22,群益金鼎-桃園,2024-05-23,9189
2371,大同,67,46,21,群益金鼎-桃園,2024-05-23,9189
6425,易發,24,3,21,群益金鼎-桃園,2024-05-23,9189
2880,華南金,20,0,20,群益金鼎-桃園,2024-05-23,9189
5426,振發,20,0,20,群益金鼎-桃園,2024-05-23,9189
1304,台聚,20,0,20,群益金鼎-桃園,2024-05-23,9189
2537,聯上發,30,10,20,群益金鼎-桃園,2024-05-23,9189
00665L,富邦�琤肭磪囓�2,30,10,20,群益金鼎-桃園,2024-05-23,9189
9105,泰金寶-DR,20,0,20,群益金鼎-桃園,2024-05-23,9189
2331,精英,20,1,19,群益金鼎-桃園,2024-05-23,9189
2009,第一銅,33,14,19,群益金鼎-桃園,2024-05-23,9189
8050,廣積,20,1,19,群益金鼎-桃園,2024-05-23,9189
2392,正崴,85,67,18,群益金鼎-桃園,2024-05-23,9189
5508,永信建,20,2,18,群益金鼎-桃園,2024-05-23,9189
2324,仁寶,61,44,17,群益金鼎-桃園,2024-05-23,9189
2363,矽統,22,5,17,群益金鼎-桃園,2024-05-23,9189
3049,精金,16,0,16,群益金鼎-桃園,2024-05-23,9189
6005,群益證,16,0,16,群益金鼎-桃園,2024-05-23,9189
2615,萬海,16,0,16,群益金鼎-桃園,2024-05-23,9189
3188,鑫龍騰,15,0,15,群益金鼎-桃園,2024-05-23,9189
00712,復華富時不動產,15,0,15,群益金鼎-桃園,2024-05-23,9189
00937B,群益ESG投等債20,644,3,641,群益金鼎-桃園,2024-05-24,9189
00632R,元大台灣50反1,326,15,311,群益金鼎-桃園,2024-05-24,9189
2867,三商壽,211,5,206,群益金鼎-桃園,2024-05-24,9189
00929,復華台灣科技優息,127,12,115,群益金鼎-桃園,2024-05-24,9189
2881,富邦金,101,1,100,群益金鼎-桃園,2024-05-24,9189
2618,長榮航,85,21,64,群益金鼎-桃園,2024-05-24,9189
3033,威健,67,7,60,群益金鼎-桃園,2024-05-24,9189
2002,中鋼,62,2,60,群益金鼎-桃園,2024-05-24,9189
00940,元大台灣價值高息,53,0,53,群益金鼎-桃園,2024-05-24,9189
1609,大亞,44,1,43,群益金鼎-桃園,2024-05-24,9189
2312,金寶,42,1,41,群益金鼎-桃園,2024-05-24,9189
2891,中信金,41,0,41,群益金鼎-桃園,2024-05-24,9189
00712,復華富時不動產,37,2,35,群益金鼎-桃園,2024-05-24,9189
00943,兆豐電子高息等權,30,0,30,群益金鼎-桃園,2024-05-24,9189
2104,國際中橡,28,0,28,群益金鼎-桃園,2024-05-24,9189
2303,聯電,34,8,26,群益金鼎-桃園,2024-05-24,9189
4960,誠美材,26,0,26,群益金鼎-桃園,2024-05-24,9189
2027,大成鋼,25,0,25,群益金鼎-桃園,2024-05-24,9189
3706,神達,33,8,25,群益金鼎-桃園,2024-05-24,9189
2365,昆盈,70,46,24,群益金鼎-桃園,2024-05-24,9189
2884,玉山金,23,0,23,群益金鼎-桃園,2024-05-24,9189
00665L,富邦�琤肭磪囓�2,21,0,21,群益金鼎-桃園,2024-05-24,9189
00942B,台新美A公司債20+,20,0,20,群益金鼎-桃園,2024-05-24,9189
00687B,國泰20年美債,20,0,20,群益金鼎-桃園,2024-05-24,9189
3013,晟銘電,58,38,20,群益金鼎-桃園,2024-05-24,9189
1440,南紡,17,0,17,群益金鼎-桃園,2024-05-24,9189
00751B,元大AAA至A公司債,15,0,15,群益金鼎-桃園,2024-05-24,9189
5508,永信建,15,0,15,群益金鼎-桃園,2024-05-24,9189
2324,仁寶,26,12,14,群益金鼎-桃園,2024-05-24,9189
2227,裕日車,13,0,13,群益金鼎-桃園,2024-05-24,9189
2354,鴻準,27,15,12,群益金鼎-桃園,2024-05-24,9189
006208,富邦台50,15,3,12,群益金鼎-桃園,2024-05-24,9189
3071,協禧,16,4,12,群益金鼎-桃園,2024-05-24,9189
00915,凱基優選高股息30,11,0,11,群益金鼎-桃園,2024-05-24,9189
1809,中釉,11,0,11,群益金鼎-桃園,2024-05-24,9189
6147,頎邦,19,8,11,群益金鼎-桃園,2024-05-24,9189
1810,和成,12,2,10,群益金鼎-桃園,2024-05-24,9189
6177,達麗,10,0,10,群益金鼎-桃園,2024-05-24,9189
2371,大同,28,18,10,群益金鼎-桃園,2024-05-24,9189
2509,全坤建,10,0,10,群益金鼎-桃園,2024-05-24,9189
3594,磐儀,10,0,10,群益金鼎-桃園,2024-05-24,9189
6125,廣運,37,27,10,群益金鼎-桃園,2024-05-24,9189
2887,台新金,10,0,10,群益金鼎-桃園,2024-05-24,9189
6209,今國光,19,9,10,群益金鼎-桃園,2024-05-24,9189
6274,台燿,10,1,9,群益金鼎-桃園,2024-05-24,9189
4545,銘鈺,10,1,9,群益金鼎-桃園,2024-05-24,9189
3163,波若威,47,38,9,群益金鼎-桃園,2024-05-24,9189
00679B,元大美債20年,10,2,8,群益金鼎-桃園,2024-05-24,9189
3010,華立,8,0,8,群益金鼎-桃園,2024-05-24,9189
4720,德淵,8,0,8,群益金鼎-桃園,2024-05-24,9189
00937B,群益ESG投等債20,212,19,193,群益金鼎-桃園,2024-05-27,9189
2353,宏��,193,55,138,群益金鼎-桃園,2024-05-27,9189
9105,泰金寶-DR,153,35,118,群益金鼎-桃園,2024-05-27,9189
00679B,元大美債20年,116,5,111,群益金鼎-桃園,2024-05-27,9189
6770,力積電,101,6,95,群益金鼎-桃園,2024-05-27,9189
00632R,元大台灣50反1,132,40,92,群益金鼎-桃園,2024-05-27,9189
1304,台聚,60,0,60,群益金鼎-桃園,2024-05-27,9189
3615,安可,60,0,60,群益金鼎-桃園,2024-05-27,9189
1815,富喬,97,42,55,群益金鼎-桃園,2024-05-27,9189
2002,中鋼,63,8,55,群益金鼎-桃園,2024-05-27,9189
00712,復華富時不動產,47,0,47,群益金鼎-桃園,2024-05-27,9189
9904,寶成,36,0,36,群益金鼎-桃園,2024-05-27,9189
2609,陽明,79,45,34,群益金鼎-桃園,2024-05-27,9189
5324,士開,30,0,30,群益金鼎-桃園,2024-05-27,9189
1101,台泥,30,1,29,群益金鼎-桃園,2024-05-27,9189
3013,晟銘電,76,49,27,群益金鼎-桃園,2024-05-27,9189
2618,長榮航,42,17,25,群益金鼎-桃園,2024-05-27,9189
2515,中工,33,9,24,群益金鼎-桃園,2024-05-27,9189
2867,三商壽,34,10,24,群益金鼎-桃園,2024-05-27,9189
9945,潤泰新,23,0,23,群益金鼎-桃園,2024-05-27,9189
00664R,國泰臺灣加權反1,21,0,21,群益金鼎-桃園,2024-05-27,9189
4909,新復興,22,1,21,群益金鼎-桃園,2024-05-27,9189
1310,台苯,21,0,21,群益金鼎-桃園,2024-05-27,9189
2104,國際中橡,21,0,21,群益金鼎-桃園,2024-05-27,9189
5426,振發,41,21,20,群益金鼎-桃園,2024-05-27,9189
5531,鄉林,20,0,20,群益金鼎-桃園,2024-05-27,9189
5302,太欣,20,0,20,群益金鼎-桃園,2024-05-27,9189
5328,華容,20,0,20,群益金鼎-桃園,2024-05-27,9189
2324,仁寶,34,14,20,群益金鼎-桃園,2024-05-27,9189
2610,華航,19,0,19,群益金鼎-桃園,2024-05-27,9189
6005,群益證,18,0,18,群益金鼎-桃園,2024-05-27,9189
00687B,國泰20年美債,17,0,17,群益金鼎-桃園,2024-05-27,9189
6257,矽格,21,5,16,群益金鼎-桃園,2024-05-27,9189
1589,永冠-KY,16,0,16,群益金鼎-桃園,2024-05-27,9189
00942B,台新美A公司債20+,16,0,16,群益金鼎-桃園,2024-05-27,9189
2611,志信,21,5,16,群益金鼎-桃園,2024-05-27,9189
1514,亞力,23,8,15,群益金鼎-桃園,2024-05-27,9189
6125,廣運,65,50,15,群益金鼎-桃園,2024-05-27,9189
1608,華榮,33,18,15,群益金鼎-桃園,2024-05-27,9189
2801,彰銀,15,0,15,群益金鼎-桃園,2024-05-27,9189
2489,瑞軒,35,20,15,群益金鼎-桃園,2024-05-27,9189
2363,矽統,106,93,13,群益金鼎-桃園,2024-05-27,9189
2886,兆豐金,13,0,13,群益金鼎-桃園,2024-05-27,9189
00915,凱基優選高股息30,20,7,13,群益金鼎-桃園,2024-05-27,9189
2355,敬鵬,13,0,13,群益金鼎-桃園,2024-05-27,9189
1609,大亞,22,10,12,群益金鼎-桃園,2024-05-27,9189
9958,世紀鋼,17,5,12,群益金鼎-桃園,2024-05-27,9189
3363,上詮,21,9,12,群益金鼎-桃園,2024-05-27,9189
2884,玉山金,13,1,12,群益金鼎-桃園,2024-05-27,9189
2888,新光金,12,0,12,群益金鼎-桃園,2024-05-27,9189
00937B,群益ESG投等債20,425,3,422,群益金鼎-桃園,2024-05-28,9189
00919,群益台灣精選高息,147,13,134,群益金鼎-桃園,2024-05-28,9189
00929,復華台灣科技優息,132,26,106,群益金鼎-桃園,2024-05-28,9189
2801,彰銀,101,0,101,群益金鼎-桃園,2024-05-28,9189
2820,華票,100,0,100,群益金鼎-桃園,2024-05-28,9189
6770,力積電,100,13,87,群益金鼎-桃園,2024-05-28,9189
6244,茂迪,84,1,83,群益金鼎-桃園,2024-05-28,9189
2317,鴻海,89,26,63,群益金鼎-桃園,2024-05-28,9189
6215,和椿,102,42,60,群益金鼎-桃園,2024-05-28,9189
2354,鴻準,103,47,56,群益金鼎-桃園,2024-05-28,9189
2344,華邦電,46,4,42,群益金鼎-桃園,2024-05-28,9189
5302,太欣,40,1,39,群益金鼎-桃園,2024-05-28,9189
2363,矽統,107,70,37,群益金鼎-桃園,2024-05-28,9189
1524,耿鼎,40,3,37,群益金鼎-桃園,2024-05-28,9189
2408,南亞科,32,1,31,群益金鼎-桃園,2024-05-28,9189
2349,錸德,35,4,31,群益金鼎-桃園,2024-05-28,9189
2409,友達,35,6,29,群益金鼎-桃園,2024-05-28,9189
3450,聯鈞,53,24,29,群益金鼎-桃園,2024-05-28,9189
2369,菱生,40,11,29,群益金鼎-桃園,2024-05-28,9189
3535,晶彩科,37,9,28,群益金鼎-桃園,2024-05-28,9189
2104,國際中橡,26,0,26,群益金鼎-桃園,2024-05-28,9189
2886,兆豐金,26,0,26,群益金鼎-桃園,2024-05-28,9189
2601,益航,24,0,24,群益金鼎-桃園,2024-05-28,9189
3466,德晉,24,0,24,群益金鼎-桃園,2024-05-28,9189
1304,台聚,25,2,23,群益金鼎-桃園,2024-05-28,9189
8096,擎亞,26,3,23,群益金鼎-桃園,2024-05-28,9189
8936,國統,26,3,23,群益金鼎-桃園,2024-05-28,9189
2324,仁寶,30,8,22,群益金鼎-桃園,2024-05-28,9189
3005,神基,22,0,22,群益金鼎-桃園,2024-05-28,9189
2520,冠德,25,3,22,群益金鼎-桃園,2024-05-28,9189
5706,鳳凰,38,17,21,群益金鼎-桃園,2024-05-28,9189
2891,中信金,22,2,20,群益金鼎-桃園,2024-05-28,9189
6116,彩晶,20,0,20,群益金鼎-桃園,2024-05-28,9189
1718,中纖,20,0,20,群益金鼎-桃園,2024-05-28,9189
2537,聯上發,20,0,20,群益金鼎-桃園,2024-05-28,9189
4960,誠美材,20,0,20,群益金鼎-桃園,2024-05-28,9189
3702,大聯大,21,2,19,群益金鼎-桃園,2024-05-28,9189
2049,上銀,18,0,18,群益金鼎-桃園,2024-05-28,9189
2618,長榮航,83,65,18,群益金鼎-桃園,2024-05-28,9189
2241,艾姆勒,19,3,16,群益金鼎-桃園,2024-05-28,9189
2464,盟立,30,14,16,群益金鼎-桃園,2024-05-28,9189
8054,安國,25,9,16,群益金鼎-桃園,2024-05-28,9189
3372,典範,25,10,15,群益金鼎-桃園,2024-05-28,9189
1809,中釉,15,0,15,群益金鼎-桃園,2024-05-28,9189
3605,宏致,19,4,15,群益金鼎-桃園,2024-05-28,9189
4545,銘鈺,15,0,15,群益金鼎-桃園,2024-05-28,9189
2603,長榮,38,23,15,群益金鼎-桃園,2024-05-28,9189
1609,大亞,16,2,14,群益金鼎-桃園,2024-05-28,9189
3202,樺晟,17,3,14,群益金鼎-桃園,2024-05-28,9189
00942B,台新美A公司債20+,13,0,13,群益金鼎-桃園,2024-05-28,9189
00937B,群益ESG投等債20,761,6,755,群益金鼎-桃園,2024-05-29,9189
3481,群創,337,10,327,群益金鼎-桃園,2024-05-29,9189
00679B,元大美債20年,190,1,189,群益金鼎-桃園,2024-05-29,9189
2002,中鋼,139,11,128,群益金鼎-桃園,2024-05-29,9189
2888,新光金,157,31,126,群益金鼎-桃園,2024-05-29,9189
1304,台聚,92,0,92,群益金鼎-桃園,2024-05-29,9189
2889,國票金,106,16,90,群益金鼎-桃園,2024-05-29,9189
2353,宏��,98,29,69,群益金鼎-桃園,2024-05-29,9189
00751B,元大AAA至A公司債,62,0,62,群益金鼎-桃園,2024-05-29,9189
2883,凱基金,59,0,59,群益金鼎-桃園,2024-05-29,9189
2344,華邦電,62,4,58,群益金鼎-桃園,2024-05-29,9189
6215,和椿,65,11,54,群益金鼎-桃園,2024-05-29,9189
2886,兆豐金,50,0,50,群益金鼎-桃園,2024-05-29,9189
5324,士開,40,0,40,群益金鼎-桃園,2024-05-29,9189
1308,亞聚,40,0,40,群益金鼎-桃園,2024-05-29,9189
2603,長榮,75,38,37,群益金鼎-桃園,2024-05-29,9189
00687B,國泰20年美債,36,0,36,群益金鼎-桃園,2024-05-29,9189
9945,潤泰新,104,70,34,群益金鼎-桃園,2024-05-29,9189
4714,永捷,51,18,33,群益金鼎-桃園,2024-05-29,9189
2884,玉山金,32,0,32,群益金鼎-桃園,2024-05-29,9189
2301,光寶科,45,14,31,群益金鼎-桃園,2024-05-29,9189
00933B,國泰10Y+金融債,29,0,29,群益金鼎-桃園,2024-05-29,9189
6120,達運,34,5,29,群益金鼎-桃園,2024-05-29,9189
2606,裕民,65,36,29,群益金鼎-桃園,2024-05-29,9189
2641,正德,39,10,29,群益金鼎-桃園,2024-05-29,9189
2867,三商壽,38,10,28,群益金鼎-桃園,2024-05-29,9189
2363,矽統,36,9,27,群益金鼎-桃園,2024-05-29,9189
00942B,台新美A公司債20+,27,0,27,群益金鼎-桃園,2024-05-29,9189
3047,訊舟,89,62,27,群益金鼎-桃園,2024-05-29,9189
2801,彰銀,26,0,26,群益金鼎-桃園,2024-05-29,9189
1815,富喬,56,30,26,群益金鼎-桃園,2024-05-29,9189
8096,擎亞,64,39,25,群益金鼎-桃園,2024-05-29,9189
00940,元大台灣價值高息,78,54,24,群益金鼎-桃園,2024-05-29,9189
5608,四維航,44,20,24,群益金鼎-桃園,2024-05-29,9189
2354,鴻準,89,66,23,群益金鼎-桃園,2024-05-29,9189
2739,寒舍,26,3,23,群益金鼎-桃園,2024-05-29,9189
2609,陽明,56,33,23,群益金鼎-桃園,2024-05-29,9189
00712,復華富時不動產,22,0,22,群益金鼎-桃園,2024-05-29,9189
2312,金寶,21,0,21,群益金鼎-桃園,2024-05-29,9189
00720B,元大投資級公司債,21,0,21,群益金鼎-桃園,2024-05-29,9189
2303,聯電,89,69,20,群益金鼎-桃園,2024-05-29,9189
00665L,富邦�琤肭磪囓�2,20,0,20,群益金鼎-桃園,2024-05-29,9189
4720,德淵,20,0,20,群益金鼎-桃園,2024-05-29,9189
3541,西柏,20,0,20,群益金鼎-桃園,2024-05-29,9189
2618,長榮航,73,54,19,群益金鼎-桃園,2024-05-29,9189
2201,裕隆,20,1,19,群益金鼎-桃園,2024-05-29,9189
1101,台泥,19,0,19,群益金鼎-桃園,2024-05-29,9189
1608,華榮,22,4,18,群益金鼎-桃園,2024-05-29,9189
2317,鴻海,34,16,18,群益金鼎-桃園,2024-05-29,9189
6616,特昇-KY,35,17,18,群益金鼎-桃園,2024-05-29,9189
00937B,群益ESG投等債20,480,9,471,群益金鼎-桃園,2024-05-30,9189
00665L,富邦�琤肭磪囓�2,130,10,120,群益金鼎-桃園,2024-05-30,9189
6770,力積電,112,1,111,群益金鼎-桃園,2024-05-30,9189
8936,國統,103,0,103,群益金鼎-桃園,2024-05-30,9189
3494,誠研,76,0,76,群益金鼎-桃園,2024-05-30,9189
2353,宏��,90,16,74,群益金鼎-桃園,2024-05-30,9189
8105,凌巨,116,42,74,群益金鼎-桃園,2024-05-30,9189
1815,富喬,235,169,66,群益金鼎-桃園,2024-05-30,9189
9902,台火,55,0,55,群益金鼎-桃園,2024-05-30,9189
00679B,元大美債20年,58,5,53,群益金鼎-桃園,2024-05-30,9189
5498,凱崴,52,1,51,群益金鼎-桃園,2024-05-30,9189
2009,第一銅,52,2,50,群益金鼎-桃園,2024-05-30,9189
3048,益登,53,4,49,群益金鼎-桃園,2024-05-30,9189
2884,玉山金,46,2,44,群益金鼎-桃園,2024-05-30,9189
2891,中信金,44,5,39,群益金鼎-桃園,2024-05-30,9189
3231,緯創,62,26,36,群益金鼎-桃園,2024-05-30,9189
2354,鴻準,51,16,35,群益金鼎-桃園,2024-05-30,9189
00939,統一台灣高息動能,33,0,33,群益金鼎-桃園,2024-05-30,9189
5880,合庫金,32,0,32,群益金鼎-桃園,2024-05-30,9189
2002,中鋼,31,0,31,群益金鼎-桃園,2024-05-30,9189
2501,國建,34,3,31,群益金鼎-桃園,2024-05-30,9189
1101,台泥,37,7,30,群益金鼎-桃園,2024-05-30,9189
00900,富邦特選高股息30,30,0,30,群益金鼎-桃園,2024-05-30,9189
1303,南亞,36,8,28,群益金鼎-桃園,2024-05-30,9189
00919,群益台灣精選高息,57,29,28,群益金鼎-桃園,2024-05-30,9189
2324,仁寶,34,6,28,群益金鼎-桃園,2024-05-30,9189
2886,兆豐金,28,0,28,群益金鼎-桃園,2024-05-30,9189
00941,中信上游半導體,28,1,27,群益金鼎-桃園,2024-05-30,9189
00764B,群益25年美債,66,40,26,群益金鼎-桃園,2024-05-30,9189
2330,台積電,27,2,25,群益金鼎-桃園,2024-05-30,9189
1304,台聚,25,0,25,群益金鼎-桃園,2024-05-30,9189
6269,台郡,24,1,23,群益金鼎-桃園,2024-05-30,9189
00720B,元大投資級公司債,23,0,23,群益金鼎-桃園,2024-05-30,9189
3481,群創,24,1,23,群益金鼎-桃園,2024-05-30,9189
2451,創見,22,1,21,群益金鼎-桃園,2024-05-30,9189
2458,義隆,21,0,21,群益金鼎-桃園,2024-05-30,9189
2317,鴻海,34,13,21,群益金鼎-桃園,2024-05-30,9189
00940,元大台灣價值高息,96,76,20,群益金鼎-桃園,2024-05-30,9189
00942B,台新美A公司債20+,20,0,20,群益金鼎-桃園,2024-05-30,9189
1532,勤美,19,0,19,群益金鼎-桃園,2024-05-30,9189
00712,復華富時不動產,19,0,19,群益金鼎-桃園,2024-05-30,9189
2367,燿華,29,10,19,群益金鼎-桃園,2024-05-30,9189
00929,復華台灣科技優息,67,48,19,群益金鼎-桃園,2024-05-30,9189
3321,同泰,17,0,17,群益金鼎-桃園,2024-05-30,9189
2313,華通,27,11,16,群益金鼎-桃園,2024-05-30,9189
2887,台新金,16,0,16,群益金鼎-桃園,2024-05-30,9189
2312,金寶,15,0,15,群益金鼎-桃園,2024-05-30,9189
2486,一詮,17,2,15,群益金鼎-桃園,2024-05-30,9189
3013,晟銘電,47,33,14,群益金鼎-桃園,2024-05-30,9189
1795,美時,13,0,13,群益金鼎-桃園,2024-05-30,9189
2324,仁寶,250,3,247,群益金鼎-桃園,2024-05-31,9189
2609,陽明,300,157,143,群益金鼎-桃園,2024-05-31,9189
6770,力積電,128,12,116,群益金鼎-桃園,2024-05-31,9189
00632R,元大台灣50反1,171,69,102,群益金鼎-桃園,2024-05-31,9189
00946,群益科技高息成長,60,0,60,群益金鼎-桃園,2024-05-31,9189
1218,泰山,54,0,54,群益金鼎-桃園,2024-05-31,9189
1802,台玻,75,24,51,群益金鼎-桃園,2024-05-31,9189
5498,凱崴,50,0,50,群益金鼎-桃園,2024-05-31,9189
2449,京元電子,51,5,46,群益金鼎-桃園,2024-05-31,9189
2317,鴻海,68,27,41,群益金鼎-桃園,2024-05-31,9189
3231,緯創,58,19,39,群益金鼎-桃園,2024-05-31,9189
3312,弘憶股,77,40,37,群益金鼎-桃園,2024-05-31,9189
2002,中鋼,37,0,37,群益金鼎-桃園,2024-05-31,9189
1709,和益,36,0,36,群益金鼎-桃園,2024-05-31,9189
5426,振發,66,34,32,群益金鼎-桃園,2024-05-31,9189
00900,富邦特選高股息30,30,0,30,群益金鼎-桃園,2024-05-31,9189
2363,矽統,50,21,29,群益金鼎-桃園,2024-05-31,9189
2382,廣達,30,4,26,群益金鼎-桃園,2024-05-31,9189
2303,聯電,71,47,24,群益金鼎-桃園,2024-05-31,9189
4960,誠美材,27,3,24,群益金鼎-桃園,2024-05-31,9189
6152,百一,24,0,24,群益金鼎-桃園,2024-05-31,9189
00939,統一台灣高息動能,30,7,23,群益金鼎-桃園,2024-05-31,9189
3122,笙泉,33,11,22,群益金鼎-桃園,2024-05-31,9189
2464,盟立,74,52,22,群益金鼎-桃園,2024-05-31,9189
00931B,統一美債20年,20,0,20,群益金鼎-桃園,2024-05-31,9189
1815,富喬,116,96,20,群益金鼎-桃園,2024-05-31,9189
6270,倍微,20,0,20,群益金鼎-桃園,2024-05-31,9189
00715L,期街口布蘭特正2,19,0,19,群益金鼎-桃園,2024-05-31,9189
2399,映泰,23,4,19,群益金鼎-桃園,2024-05-31,9189
3390,旭軟,24,5,19,群益金鼎-桃園,2024-05-31,9189
5880,合庫金,18,0,18,群益金鼎-桃園,2024-05-31,9189
2405,輔信,24,6,18,群益金鼎-桃園,2024-05-31,9189
2610,華航,19,2,17,群益金鼎-桃園,2024-05-31,9189
1453,大將,32,15,17,群益金鼎-桃園,2024-05-31,9189
6271,同欣電,18,1,17,群益金鼎-桃園,2024-05-31,9189
6005,群益證,17,1,16,群益金鼎-桃園,2024-05-31,9189
2634,漢翔,17,2,15,群益金鼎-桃園,2024-05-31,9189
00751B,元大AAA至A公司債,15,0,15,群益金鼎-桃園,2024-05-31,9189
2301,光寶科,17,3,14,群益金鼎-桃園,2024-05-31,9189
8096,擎亞,15,1,14,群益金鼎-桃園,2024-05-31,9189
8358,金居,14,0,14,群益金鼎-桃園,2024-05-31,9189
2330,台積電,15,1,14,群益金鼎-桃園,2024-05-31,9189
00692,富邦公司治理,13,0,13,群益金鼎-桃園,2024-05-31,9189
6609,瀧澤科,14,1,13,群益金鼎-桃園,2024-05-31,9189
2328,廣宇,27,15,12,群益金鼎-桃園,2024-05-31,9189
00878,國泰永續高股息,11,0,11,群益金鼎-桃園,2024-05-31,9189
8076,伍豐,11,0,11,群益金鼎-桃園,2024-05-31,9189
4909,新復興,11,0,11,群益金鼎-桃園,2024-05-31,9189
8070,長華*,11,0,11,群益金鼎-桃園,2024-05-31,9189
3234,光環,10,0,10,群益金鼎-桃園,2024-05-31,9189
00664R,國泰臺灣加權反1,962,0,962,群益金鼎-桃園,2024-06-03,9189
00632R,元大台灣50反1,329,45,284,群益金鼎-桃園,2024-06-03,9189
00676R,富邦臺灣加權反1,270,0,270,群益金鼎-桃園,2024-06-03,9189
00919,群益台灣精選高息,221,10,211,群益金鼎-桃園,2024-06-03,9189
6215,和椿,205,50,155,群益金鼎-桃園,2024-06-03,9189
00937B,群益ESG投等債20,156,20,136,群益金鼎-桃園,2024-06-03,9189
2867,三商壽,64,0,64,群益金鼎-桃園,2024-06-03,9189
1447,力鵬,60,0,60,群益金鼎-桃園,2024-06-03,9189
00918,大華優利高填息30,63,4,59,群益金鼎-桃園,2024-06-03,9189
6005,群益證,69,11,58,群益金鼎-桃園,2024-06-03,9189
00946,群益科技高息成長,58,0,58,群益金鼎-桃園,2024-06-03,9189
3703,欣陸,58,1,57,群益金鼎-桃園,2024-06-03,9189
9945,潤泰新,55,1,54,群益金鼎-桃園,2024-06-03,9189
2353,宏��,74,22,52,群益金鼎-桃園,2024-06-03,9189
2344,華邦電,51,1,50,群益金鼎-桃園,2024-06-03,9189
6166,凌華,53,6,47,群益金鼎-桃園,2024-06-03,9189
6016,康和證,46,0,46,群益金鼎-桃園,2024-06-03,9189
2313,華通,47,1,46,群益金鼎-桃園,2024-06-03,9189
4533,協易機,90,49,41,群益金鼎-桃園,2024-06-03,9189
3450,聯鈞,38,1,37,群益金鼎-桃園,2024-06-03,9189
00764B,群益25年美債,67,34,33,群益金鼎-桃園,2024-06-03,9189
00929,復華台灣科技優息,54,21,33,群益金鼎-桃園,2024-06-03,9189
1314,中石化,41,8,33,群益金鼎-桃園,2024-06-03,9189
00686R,群益臺灣加權反1,30,0,30,群益金鼎-桃園,2024-06-03,9189
3044,健鼎,28,3,25,群益金鼎-桃園,2024-06-03,9189
5302,太欣,25,0,25,群益金鼎-桃園,2024-06-03,9189
2367,燿華,48,24,24,群益金鼎-桃園,2024-06-03,9189
4720,德淵,22,0,22,群益金鼎-桃園,2024-06-03,9189
6177,達麗,23,2,21,群益金鼎-桃園,2024-06-03,9189
2303,聯電,85,65,20,群益金鼎-桃園,2024-06-03,9189
6182,合晶,20,0,20,群益金鼎-桃園,2024-06-03,9189
2834,臺企銀,20,0,20,群益金鼎-桃園,2024-06-03,9189
1504,東元,43,24,19,群益金鼎-桃園,2024-06-03,9189
1514,亞力,20,1,19,群益金鼎-桃園,2024-06-03,9189
1536,和大,22,3,19,群益金鼎-桃園,2024-06-03,9189
3059,華晶科,22,4,18,群益金鼎-桃園,2024-06-03,9189
2641,正德,19,2,17,群益金鼎-桃園,2024-06-03,9189
2356,英業達,39,23,16,群益金鼎-桃園,2024-06-03,9189
5512,力麒,20,4,16,群益金鼎-桃園,2024-06-03,9189
2618,長榮航,28,13,15,群益金鼎-桃園,2024-06-03,9189
8105,凌巨,20,5,15,群益金鼎-桃園,2024-06-03,9189
1326,台化,14,0,14,群益金鼎-桃園,2024-06-03,9189
00715L,期街口布蘭特正2,15,1,14,群益金鼎-桃園,2024-06-03,9189
6552,易華電,15,2,13,群益金鼎-桃園,2024-06-03,9189
6282,康舒,13,0,13,群益金鼎-桃園,2024-06-03,9189
3481,群創,24,11,13,群益金鼎-桃園,2024-06-03,9189
1301,台塑,23,10,13,群益金鼎-桃園,2024-06-03,9189
2401,凌陽,14,2,12,群益金鼎-桃園,2024-06-03,9189
1310,台苯,12,0,12,群益金鼎-桃園,2024-06-03,9189
6188,廣明,31,19,12,群益金鼎-桃園,2024-06-03,9189
2888,新光金,406,215,191,群益金鼎-桃園,2024-06-04,9189
2887,台新金,135,0,135,群益金鼎-桃園,2024-06-04,9189
00937B,群益ESG投等債20,113,7,106,群益金鼎-桃園,2024-06-04,9189
00919,群益台灣精選高息,102,0,102,群益金鼎-桃園,2024-06-04,9189
00929,復華台灣科技優息,111,10,101,群益金鼎-桃園,2024-06-04,9189
00936,台新永續高息中小,85,3,82,群益金鼎-桃園,2024-06-04,9189
00676R,富邦臺灣加權反1,80,0,80,群益金鼎-桃園,2024-06-04,9189
6125,廣運,138,66,72,群益金鼎-桃園,2024-06-04,9189
2867,三商壽,74,8,66,群益金鼎-桃園,2024-06-04,9189
1605,華新,75,13,62,群益金鼎-桃園,2024-06-04,9189
00918,大華優利高填息30,56,0,56,群益金鼎-桃園,2024-06-04,9189
2009,第一銅,80,29,51,群益金鼎-桃園,2024-06-04,9189
2883B,凱基金乙特,50,0,50,群益金鼎-桃園,2024-06-04,9189
3615,安可,50,0,50,群益金鼎-桃園,2024-06-04,9189
2328,廣宇,60,12,48,群益金鼎-桃園,2024-06-04,9189
6270,倍微,45,4,41,群益金鼎-桃園,2024-06-04,9189
9945,潤泰新,133,93,40,群益金鼎-桃園,2024-06-04,9189
2002,中鋼,39,1,38,群益金鼎-桃園,2024-06-04,9189
2367,燿華,60,22,38,群益金鼎-桃園,2024-06-04,9189
2353,宏��,49,11,38,群益金鼎-桃園,2024-06-04,9189
2324,仁寶,47,11,36,群益金鼎-桃園,2024-06-04,9189
1312,國喬,36,0,36,群益金鼎-桃園,2024-06-04,9189
1101,台泥,34,0,34,群益金鼎-桃園,2024-06-04,9189
2356,英業達,42,9,33,群益金鼎-桃園,2024-06-04,9189
1802,台玻,40,12,28,群益金鼎-桃園,2024-06-04,9189
2303,聯電,29,3,26,群益金鼎-桃園,2024-06-04,9189
5371,中光電,26,1,25,群益金鼎-桃園,2024-06-04,9189
2344,華邦電,25,0,25,群益金鼎-桃園,2024-06-04,9189
2313,華通,26,2,24,群益金鼎-桃園,2024-06-04,9189
1453,大將,40,16,24,群益金鼎-桃園,2024-06-04,9189
3231,緯創,39,16,23,群益金鼎-桃園,2024-06-04,9189
2312,金寶,36,13,23,群益金鼎-桃園,2024-06-04,9189
6015,宏遠證,30,8,22,群益金鼎-桃園,2024-06-04,9189
2801,彰銀,22,1,21,群益金鼎-桃園,2024-06-04,9189
4939,亞電,21,0,21,群益金鼎-桃園,2024-06-04,9189
3260,威剛,21,0,21,群益金鼎-桃園,2024-06-04,9189
1301,台塑,23,2,21,群益金鼎-桃園,2024-06-04,9189
1313,聯成,20,0,20,群益金鼎-桃園,2024-06-04,9189
6016,康和證,20,0,20,群益金鼎-桃園,2024-06-04,9189
2618,長榮航,23,3,20,群益金鼎-桃園,2024-06-04,9189
2331,精英,74,55,19,群益金鼎-桃園,2024-06-04,9189
4114,健喬,18,0,18,群益金鼎-桃園,2024-06-04,9189
00675L,富邦臺灣加權正2,18,0,18,群益金鼎-桃園,2024-06-04,9189
2883,凱基金,21,4,17,群益金鼎-桃園,2024-06-04,9189
2317,鴻海,40,24,16,群益金鼎-桃園,2024-06-04,9189
4967,十銓,43,27,16,群益金鼎-桃園,2024-06-04,9189
8374,羅昇,16,0,16,群益金鼎-桃園,2024-06-04,9189
3202,樺晟,29,13,16,群益金鼎-桃園,2024-06-04,9189
2501,國建,54,38,16,群益金鼎-桃園,2024-06-04,9189
6412,群電,15,0,15,群益金鼎-桃園,2024-06-04,9189
00712,復華富時不動產,201,0,201,群益金鼎-桃園,2024-06-05,9189
00632R,元大台灣50反1,127,0,127,群益金鼎-桃園,2024-06-05,9189
00929,復華台灣科技優息,98,2,96,群益金鼎-桃園,2024-06-05,9189
00937B,群益ESG投等債20,236,152,84,群益金鼎-桃園,2024-06-05,9189
2867,三商壽,73,0,73,群益金鼎-桃園,2024-06-05,9189
00936,台新永續高息中小,77,21,56,群益金鼎-桃園,2024-06-05,9189
6770,力積電,56,1,55,群益金鼎-桃園,2024-06-05,9189
2324,仁寶,52,0,52,群益金鼎-桃園,2024-06-05,9189
6163,華電網,73,24,49,群益金鼎-桃園,2024-06-05,9189
2344,華邦電,46,0,46,群益金鼎-桃園,2024-06-05,9189
2104,國際中橡,28,0,28,群益金鼎-桃園,2024-06-05,9189
5302,太欣,26,0,26,群益金鼎-桃園,2024-06-05,9189
3083,網龍,25,0,25,群益金鼎-桃園,2024-06-05,9189
4532,瑞智,30,6,24,群益金鼎-桃園,2024-06-05,9189
00878,國泰永續高股息,25,1,24,群益金鼎-桃園,2024-06-05,9189
2002,中鋼,24,0,24,群益金鼎-桃園,2024-06-05,9189
2331,精英,41,19,22,群益金鼎-桃園,2024-06-05,9189
2495,普安,31,10,21,群益金鼎-桃園,2024-06-05,9189
6177,達麗,23,2,21,群益金鼎-桃園,2024-06-05,9189
3088,艾訊,39,19,20,群益金鼎-桃園,2024-06-05,9189
3494,誠研,17,0,17,群益金鼎-桃園,2024-06-05,9189
8086,宏捷科,18,1,17,群益金鼎-桃園,2024-06-05,9189
3231,緯創,45,29,16,群益金鼎-桃園,2024-06-05,9189
1722,台肥,30,14,16,群益金鼎-桃園,2024-06-05,9189
2354,鴻準,35,20,15,群益金鼎-桃園,2024-06-05,9189
2405,輔信,14,0,14,群益金鼎-桃園,2024-06-05,9189
1536,和大,35,21,14,群益金鼎-桃園,2024-06-05,9189
3048,益登,29,16,13,群益金鼎-桃園,2024-06-05,9189
6531,愛普*,13,1,12,群益金鼎-桃園,2024-06-05,9189
5880,合庫金,12,0,12,群益金鼎-桃園,2024-06-05,9189
2409,友達,12,0,12,群益金鼎-桃園,2024-06-05,9189
6591,動力-KY,12,0,12,群益金鼎-桃園,2024-06-05,9189
2880,華南金,13,1,12,群益金鼎-桃園,2024-06-05,9189
6125,廣運,64,53,11,群益金鼎-桃園,2024-06-05,9189
3481,群創,14,3,11,群益金鼎-桃園,2024-06-05,9189
3029,零壹,11,0,11,群益金鼎-桃園,2024-06-05,9189
4939,亞電,11,0,11,群益金鼎-桃園,2024-06-05,9189
8093,保銳,10,0,10,群益金鼎-桃園,2024-06-05,9189
2250,IKKA-KY,10,0,10,群益金鼎-桃園,2024-06-05,9189
1201,味全,10,0,10,群益金鼎-桃園,2024-06-05,9189
00637L,元大滬深300正2,10,0,10,群益金鼎-桃園,2024-06-05,9189
1701,中化,10,0,10,群益金鼎-桃園,2024-06-05,9189
3062,建漢,15,5,10,群益金鼎-桃園,2024-06-05,9189
2449,京元電子,20,11,9,群益金鼎-桃園,2024-06-05,9189
2009,第一銅,11,2,9,群益金鼎-桃園,2024-06-05,9189
2482,連宇,37,28,9,群益金鼎-桃園,2024-06-05,9189
6552,易華電,14,5,9,群益金鼎-桃園,2024-06-05,9189
3312,弘憶股,10,1,9,群益金鼎-桃園,2024-06-05,9189
5009,榮剛,10,1,9,群益金鼎-桃園,2024-06-05,9189
6215,和椿,17,8,9,群益金鼎-桃園,2024-06-05,9189
00632R,元大台灣50反1,464,30,434,群益金鼎-桃園,2024-06-06,9189
00688L,國泰20年美債正2,270,0,270,群益金鼎-桃園,2024-06-06,9189
00946,群益科技高息成長,133,26,107,群益金鼎-桃園,2024-06-06,9189
2344,華邦電,108,8,100,群益金鼎-桃園,2024-06-06,9189
00680L,元大美債20正2,96,0,96,群益金鼎-桃園,2024-06-06,9189
9945,潤泰新,112,26,86,群益金鼎-桃園,2024-06-06,9189
2409,友達,50,0,50,群益金鼎-桃園,2024-06-06,9189
00929,復華台灣科技優息,52,5,47,群益金鼎-桃園,2024-06-06,9189
2367,燿華,74,36,38,群益金鼎-桃園,2024-06-06,9189
2101,南港,66,30,36,群益金鼎-桃園,2024-06-06,9189
6163,華電網,45,10,35,群益金鼎-桃園,2024-06-06,9189
00936,台新永續高息中小,36,3,33,群益金鼎-桃園,2024-06-06,9189
3481,群創,33,1,32,群益金鼎-桃園,2024-06-06,9189
2888,新光金,136,106,30,群益金鼎-桃園,2024-06-06,9189
2324,仁寶,32,4,28,群益金鼎-桃園,2024-06-06,9189
00918,大華優利高填息30,28,0,28,群益金鼎-桃園,2024-06-06,9189
2104,國際中橡,28,2,26,群益金鼎-桃園,2024-06-06,9189
1815,富喬,83,57,26,群益金鼎-桃園,2024-06-06,9189
1455,集盛,25,0,25,群益金鼎-桃園,2024-06-06,9189
2882,國泰金,43,18,25,群益金鼎-桃園,2024-06-06,9189
5340,建榮,37,13,24,群益金鼎-桃園,2024-06-06,9189
2331,精英,61,37,24,群益金鼎-桃園,2024-06-06,9189
6257,矽格,25,3,22,群益金鼎-桃園,2024-06-06,9189
1532,勤美,21,0,21,群益金鼎-桃園,2024-06-06,9189
3162,精確,24,3,21,群益金鼎-桃園,2024-06-06,9189
2801,彰銀,21,0,21,群益金鼎-桃園,2024-06-06,9189
00919,群益台灣精選高息,28,8,20,群益金鼎-桃園,2024-06-06,9189
2489,瑞軒,20,0,20,群益金鼎-桃園,2024-06-06,9189
3048,益登,27,7,20,群益金鼎-桃園,2024-06-06,9189
00882,中信中國高股息,20,1,19,群益金鼎-桃園,2024-06-06,9189
6546,正基,21,3,18,群益金鼎-桃園,2024-06-06,9189
4167,松瑞藥,20,2,18,群益金鼎-桃園,2024-06-06,9189
8076,伍豐,16,0,16,群益金鼎-桃園,2024-06-06,9189
2427,三商電,30,15,15,群益金鼎-桃園,2024-06-06,9189
6418,詠昇,15,0,15,群益金鼎-桃園,2024-06-06,9189
00687B,國泰20年美債,18,3,15,群益金鼎-桃園,2024-06-06,9189
4927,泰鼎-KY,16,2,14,群益金鼎-桃園,2024-06-06,9189
2303,聯電,18,5,13,群益金鼎-桃園,2024-06-06,9189
3297,杭特,13,0,13,群益金鼎-桃園,2024-06-06,9189
6446,藥華藥,21,8,13,群益金鼎-桃園,2024-06-06,9189
5880,合庫金,12,0,12,群益金鼎-桃園,2024-06-06,9189
3715,定穎投控,12,0,12,群益金鼎-桃園,2024-06-06,9189
5009,榮剛,12,0,12,群益金鼎-桃園,2024-06-06,9189
9933,中鼎,12,0,12,群益金鼎-桃園,2024-06-06,9189
00675L,富邦臺灣加權正2,12,0,12,群益金鼎-桃園,2024-06-06,9189
00753L,中信中國50正2,11,0,11,群益金鼎-桃園,2024-06-06,9189
3372,典範,17,7,10,群益金鼎-桃園,2024-06-06,9189
2458,義隆,11,1,10,群益金鼎-桃園,2024-06-06,9189
6153,嘉聯益,10,0,10,群益金鼎-桃園,2024-06-06,9189
1536,和大,26,16,10,群益金鼎-桃園,2024-06-06,9189
1312,國喬,191,0,191,群益金鼎-桃園,2024-06-07,9189
00679B,元大美債20年,173,21,152,群益金鼎-桃園,2024-06-07,9189
2836,高雄銀,140,0,140,群益金鼎-桃園,2024-06-07,9189
00937B,群益ESG投等債20,147,24,123,群益金鼎-桃園,2024-06-07,9189
00715L,期街口布蘭特正2,107,5,102,群益金鼎-桃園,2024-06-07,9189
00712,復華富時不動產,100,0,100,群益金鼎-桃園,2024-06-07,9189
00929,復華台灣科技優息,117,42,75,群益金鼎-桃園,2024-06-07,9189
00680L,元大美債20正2,77,10,67,群益金鼎-桃園,2024-06-07,9189
1714,和桐,57,0,57,群益金鼎-桃園,2024-06-07,9189
00936,台新永續高息中小,47,0,47,群益金鼎-桃園,2024-06-07,9189
3231,緯創,57,10,47,群益金鼎-桃園,2024-06-07,9189
2367,燿華,74,28,46,群益金鼎-桃園,2024-06-07,9189
2353,宏��,45,1,44,群益金鼎-桃園,2024-06-07,9189
4909,新復興,54,13,41,群益金鼎-桃園,2024-06-07,9189
6265,方土昶,41,1,40,群益金鼎-桃園,2024-06-07,9189
00664R,國泰臺灣加權反1,38,0,38,群益金鼎-桃園,2024-06-07,9189
2834,臺企銀,41,4,37,群益金鼎-桃園,2024-06-07,9189
00919,群益台灣精選高息,37,2,35,群益金鼎-桃園,2024-06-07,9189
2356,英業達,35,2,33,群益金鼎-桃園,2024-06-07,9189
2104,國際中橡,28,0,28,群益金鼎-桃園,2024-06-07,9189
2324,仁寶,27,0,27,群益金鼎-桃園,2024-06-07,9189
2317,鴻海,46,22,24,群益金鼎-桃園,2024-06-07,9189
2002,中鋼,25,1,24,群益金鼎-桃園,2024-06-07,9189
1609,大亞,29,7,22,群益金鼎-桃園,2024-06-07,9189
2607,榮運,20,0,20,群益金鼎-桃園,2024-06-07,9189
2312,金寶,57,37,20,群益金鼎-桃園,2024-06-07,9189
2882,國泰金,36,16,20,群益金鼎-桃園,2024-06-07,9189
2330,台積電,19,1,18,群益金鼎-桃園,2024-06-07,9189
00632R,元大台灣50反1,22,4,18,群益金鼎-桃園,2024-06-07,9189
6418,詠昇,17,0,17,群益金鼎-桃園,2024-06-07,9189
3041,揚智,17,0,17,群益金鼎-桃園,2024-06-07,9189
2486,一詮,34,18,16,群益金鼎-桃園,2024-06-07,9189
1326,台化,20,4,16,群益金鼎-桃園,2024-06-07,9189
8096,擎亞,16,0,16,群益金鼎-桃園,2024-06-07,9189
2615,萬海,83,67,16,群益金鼎-桃園,2024-06-07,9189
3706,神達,16,1,15,群益金鼎-桃園,2024-06-07,9189
2382,廣達,17,2,15,群益金鼎-桃園,2024-06-07,9189
2801,彰銀,25,11,14,群益金鼎-桃園,2024-06-07,9189
2489,瑞軒,15,1,14,群益金鼎-桃園,2024-06-07,9189
6190,萬泰科,14,1,13,群益金鼎-桃園,2024-06-07,9189
2520,冠德,20,8,12,群益金鼎-桃園,2024-06-07,9189
4906,正文,15,3,12,群益金鼎-桃園,2024-06-07,9189
00918,大華優利高填息30,13,2,11,群益金鼎-桃園,2024-06-07,9189
2401,凌陽,13,2,11,群益金鼎-桃園,2024-06-07,9189
6143,振曜,11,0,11,群益金鼎-桃園,2024-06-07,9189
2331,精英,12,1,11,群益金鼎-桃園,2024-06-07,9189
2603,長榮,35,24,11,群益金鼎-桃園,2024-06-07,9189
00753L,中信中國50正2,10,0,10,群益金鼎-桃園,2024-06-07,9189
4562,穎漢,11,1,10,群益金鼎-桃園,2024-06-07,9189
2352,佳世達,10,0,10,群益金鼎-桃園,2024-06-07,9189
00937B,群益ESG投等債20,435,130,305,群益金鼎-桃園,2024-06-11,9189
00680L,元大美債20正2,131,0,131,群益金鼎-桃園,2024-06-11,9189
00918,大華優利高填息30,96,0,96,群益金鼎-桃園,2024-06-11,9189
00687B,國泰20年美債,96,0,96,群益金鼎-桃園,2024-06-11,9189
00919,群益台灣精選高息,90,0,90,群益金鼎-桃園,2024-06-11,9189
2609,陽明,217,137,80,群益金鼎-桃園,2024-06-11,9189
2903,遠百,85,7,78,群益金鼎-桃園,2024-06-11,9189
00679B,元大美債20年,77,0,77,群益金鼎-桃園,2024-06-11,9189
00929,復華台灣科技優息,69,3,66,群益金鼎-桃園,2024-06-11,9189
00940,元大台灣價值高息,66,15,51,群益金鼎-桃園,2024-06-11,9189
1815,富喬,101,52,49,群益金鼎-桃園,2024-06-11,9189
2603,長榮,54,5,49,群益金鼎-桃園,2024-06-11,9189
2002,中鋼,49,0,49,群益金鼎-桃園,2024-06-11,9189
2313,華通,47,4,43,群益金鼎-桃園,2024-06-11,9189
2501,國建,61,19,42,群益金鼎-桃園,2024-06-11,9189
00882,中信中國高股息,46,6,40,群益金鼎-桃園,2024-06-11,9189
2615,萬海,68,31,37,群益金鼎-桃園,2024-06-11,9189
3715,定穎投控,37,2,35,群益金鼎-桃園,2024-06-11,9189
2356,英業達,45,13,32,群益金鼎-桃園,2024-06-11,9189
00712,復華富時不動產,31,0,31,群益金鼎-桃園,2024-06-11,9189
00688L,國泰20年美債正2,30,0,30,群益金鼎-桃園,2024-06-11,9189
2515,中工,26,0,26,群益金鼎-桃園,2024-06-11,9189
2888,新光金,34,8,26,群益金鼎-桃園,2024-06-11,9189
6122,擎邦,26,0,26,群益金鼎-桃園,2024-06-11,9189
2009,第一銅,27,2,25,群益金鼎-桃園,2024-06-11,9189
00936,台新永續高息中小,25,0,25,群益金鼎-桃園,2024-06-11,9189
2610,華航,42,20,22,群益金鼎-桃園,2024-06-11,9189
1582,信錦,25,5,20,群益金鼎-桃園,2024-06-11,9189
00946,群益科技高息成長,20,0,20,群益金鼎-桃園,2024-06-11,9189
00753L,中信中國50正2,20,0,20,群益金鼎-桃園,2024-06-11,9189
1617,榮星,20,0,20,群益金鼎-桃園,2024-06-11,9189
6264,富裔,19,0,19,群益金鼎-桃園,2024-06-11,9189
2637,慧洋-KY,20,1,19,群益金鼎-桃園,2024-06-11,9189
6120,達運,21,3,18,群益金鼎-桃園,2024-06-11,9189
00933B,國泰10Y+金融債,17,0,17,群益金鼎-桃園,2024-06-11,9189
00939,統一台灣高息動能,17,0,17,群益金鼎-桃園,2024-06-11,9189
3390,旭軟,25,8,17,群益金鼎-桃園,2024-06-11,9189
9907,統一實,20,3,17,群益金鼎-桃園,2024-06-11,9189
2882,國泰金,34,17,17,群益金鼎-桃園,2024-06-11,9189
1301,台塑,19,2,17,群益金鼎-桃園,2024-06-11,9189
3481,群創,16,0,16,群益金鼎-桃園,2024-06-11,9189
00637L,元大滬深300正2,31,15,16,群益金鼎-桃園,2024-06-11,9189
2449,京元電子,19,4,15,群益金鼎-桃園,2024-06-11,9189
2643,捷迅,15,0,15,群益金鼎-桃園,2024-06-11,9189
00665L,富邦�琤肭磪囓�2,15,0,15,群益金鼎-桃園,2024-06-11,9189
6616,特昇-KY,15,0,15,群益金鼎-桃園,2024-06-11,9189
2323,中環,20,6,14,群益金鼎-桃園,2024-06-11,9189
9958,世紀鋼,19,5,14,群益金鼎-桃園,2024-06-11,9189
2834,臺企銀,14,0,14,群益金鼎-桃園,2024-06-11,9189
1532,勤美,24,11,13,群益金鼎-桃園,2024-06-11,9189
00680L,元大美債20正2,423,0,423,群益金鼎-桃園,2024-06-12,9189
00632R,元大台灣50反1,287,5,282,群益金鼎-桃園,2024-06-12,9189
9945,潤泰新,268,70,198,群益金鼎-桃園,2024-06-12,9189
2820,華票,100,0,100,群益金鼎-桃園,2024-06-12,9189
2881,富邦金,100,0,100,群益金鼎-桃園,2024-06-12,9189
00933B,國泰10Y+金融債,90,3,87,群益金鼎-桃園,2024-06-12,9189
00937B,群益ESG投等債20,93,13,80,群益金鼎-桃園,2024-06-12,9189
00929,復華台灣科技優息,114,36,78,群益金鼎-桃園,2024-06-12,9189
00679B,元大美債20年,80,5,75,群益金鼎-桃園,2024-06-12,9189
2801,彰銀,71,0,71,群益金鼎-桃園,2024-06-12,9189
2883,凱基金,140,72,68,群益金鼎-桃園,2024-06-12,9189
00665L,富邦�琤肭磪囓�2,67,0,67,群益金鼎-桃園,2024-06-12,9189
3540,曜越,63,2,61,群益金鼎-桃園,2024-06-12,9189
00915,凱基優選高股息30,61,1,60,群益金鼎-桃園,2024-06-12,9189
2867,三商壽,58,5,53,群益金鼎-桃園,2024-06-12,9189
2882,國泰金,52,1,51,群益金鼎-桃園,2024-06-12,9189
2836,高雄銀,45,2,43,群益金鼎-桃園,2024-06-12,9189
3481,群創,46,5,41,群益金鼎-桃園,2024-06-12,9189
00664R,國泰臺灣加權反1,40,0,40,群益金鼎-桃園,2024-06-12,9189
1455,集盛,32,1,31,群益金鼎-桃園,2024-06-12,9189
1303,南亞,31,0,31,群益金鼎-桃園,2024-06-12,9189
3162,精確,31,3,28,群益金鼎-桃園,2024-06-12,9189
3231,緯創,66,40,26,群益金鼎-桃園,2024-06-12,9189
3047,訊舟,30,4,26,群益金鼎-桃園,2024-06-12,9189
2501,國建,27,1,26,群益金鼎-桃園,2024-06-12,9189
00674R,期元大S＆P黃金反1,25,0,25,群益金鼎-桃園,2024-06-12,9189
1714,和桐,24,0,24,群益金鼎-桃園,2024-06-12,9189
00919,群益台灣精選高息,24,1,23,群益金鼎-桃園,2024-06-12,9189
2002,中鋼,22,0,22,群益金鼎-桃園,2024-06-12,9189
6177,達麗,21,0,21,群益金鼎-桃園,2024-06-12,9189
2609,陽明,162,142,20,群益金鼎-桃園,2024-06-12,9189
3141,晶宏,20,0,20,群益金鼎-桃園,2024-06-12,9189
1301,台塑,21,2,19,群益金鼎-桃園,2024-06-12,9189
2104,國際中橡,19,0,19,群益金鼎-桃園,2024-06-12,9189
2605,新興,26,8,18,群益金鼎-桃園,2024-06-12,9189
5392,能率,21,3,18,群益金鼎-桃園,2024-06-12,9189
4726,永昕,25,8,17,群益金鼎-桃園,2024-06-12,9189
00687B,國泰20年美債,23,6,17,群益金鼎-桃園,2024-06-12,9189
1514,亞力,36,20,16,群益金鼎-桃園,2024-06-12,9189
2323,中環,17,1,16,群益金鼎-桃園,2024-06-12,9189
2603,長榮,37,21,16,群益金鼎-桃園,2024-06-12,9189
00712,復華富時不動產,15,0,15,群益金鼎-桃園,2024-06-12,9189
1609,大亞,18,3,15,群益金鼎-桃園,2024-06-12,9189
00942B,台新美A公司債20+,15,0,15,群益金鼎-桃園,2024-06-12,9189
4714,永捷,20,6,14,群益金鼎-桃園,2024-06-12,9189
00918,大華優利高填息30,17,3,14,群益金鼎-桃園,2024-06-12,9189
2915,潤泰全,14,0,14,群益金鼎-桃園,2024-06-12,9189
1504,東元,13,0,13,群益金鼎-桃園,2024-06-12,9189
2637,慧洋-KY,19,6,13,群益金鼎-桃園,2024-06-12,9189
6122,擎邦,13,0,13,群益金鼎-桃園,2024-06-12,9189
00942B,台新美A公司債20+,490,0,490,群益金鼎-桃園,2024-06-13,9189
00632R,元大台灣50反1,243,86,157,群益金鼎-桃園,2024-06-13,9189
2889,國票金,102,0,102,群益金鼎-桃園,2024-06-13,9189
2881,富邦金,100,2,98,群益金鼎-桃園,2024-06-13,9189
2609,陽明,150,54,96,群益金鼎-桃園,2024-06-13,9189
00637L,元大滬深300正2,105,10,95,群益金鼎-桃園,2024-06-13,9189
00679B,元大美債20年,88,11,77,群益金鼎-桃園,2024-06-13,9189
2888,新光金,63,1,62,群益金鼎-桃園,2024-06-13,9189
2618,長榮航,76,21,55,群益金鼎-桃園,2024-06-13,9189
00712,復華富時不動產,41,0,41,群益金鼎-桃園,2024-06-13,9189
5534,長虹,40,0,40,群益金鼎-桃園,2024-06-13,9189
00929,復華台灣科技優息,82,45,37,群益金鼎-桃園,2024-06-13,9189
2002,中鋼,37,1,36,群益金鼎-桃園,2024-06-13,9189
2801,彰銀,36,0,36,群益金鼎-桃園,2024-06-13,9189
2882,國泰金,39,5,34,群益金鼎-桃園,2024-06-13,9189
3593,力銘,34,0,34,群益金鼎-桃園,2024-06-13,9189
3450,聯鈞,48,17,31,群益金鼎-桃園,2024-06-13,9189
00753L,中信中國50正2,31,0,31,群益金鼎-桃園,2024-06-13,9189
00918,大華優利高填息30,32,1,31,群益金鼎-桃園,2024-06-13,9189
2748,雲品,30,0,30,群益金鼎-桃園,2024-06-13,9189
1815,富喬,55,26,29,群益金鼎-桃園,2024-06-13,9189
00674R,期元大S＆P黃金反1,25,0,25,群益金鼎-桃園,2024-06-13,9189
00915,凱基優選高股息30,25,0,25,群益金鼎-桃園,2024-06-13,9189
2867,三商壽,23,0,23,群益金鼎-桃園,2024-06-13,9189
8085,福華,20,0,20,群益金鼎-桃園,2024-06-13,9189
00673R,期元大S＆P原油反1,20,0,20,群益金鼎-桃園,2024-06-13,9189
00645,富邦日本,20,0,20,群益金鼎-桃園,2024-06-13,9189
00936,台新永續高息中小,27,8,19,群益金鼎-桃園,2024-06-13,9189
2371,大同,32,14,18,群益金鼎-桃園,2024-06-13,9189
8112,至上,21,3,18,群益金鼎-桃園,2024-06-13,9189
2368,金像電,31,13,18,群益金鼎-桃園,2024-06-13,9189
00948B,中信優息投資級債,17,0,17,群益金鼎-桃園,2024-06-13,9189
3390,旭軟,21,6,15,群益金鼎-桃園,2024-06-13,9189
5324,士開,15,0,15,群益金鼎-桃園,2024-06-13,9189
00671R,富邦NASDAQ反1,15,0,15,群益金鼎-桃園,2024-06-13,9189
3379,彬台,14,0,14,群益金鼎-桃園,2024-06-13,9189
2027,大成鋼,13,0,13,群益金鼎-桃園,2024-06-13,9189
6161,捷波,13,0,13,群益金鼎-桃園,2024-06-13,9189
9935,慶豐富,12,0,12,群益金鼎-桃園,2024-06-13,9189
00751B,元大AAA至A公司債,13,1,12,群益金鼎-桃園,2024-06-13,9189
3071,協禧,12,0,12,群益金鼎-桃園,2024-06-13,9189
1504,東元,13,1,12,群益金鼎-桃園,2024-06-13,9189
6125,廣運,17,6,11,群益金鼎-桃園,2024-06-13,9189
5512,力麒,11,0,11,群益金鼎-桃園,2024-06-13,9189
2359,所羅門,58,48,10,群益金鼎-桃園,2024-06-13,9189
2520,冠德,10,0,10,群益金鼎-桃園,2024-06-13,9189
3162,精確,17,7,10,群益金鼎-桃園,2024-06-13,9189
00641R,富邦日本反1,10,0,10,群益金鼎-桃園,2024-06-13,9189
2303,聯電,39,29,10,群益金鼎-桃園,2024-06-13,9189
2104,國際中橡,10,0,10,群益金鼎-桃園,2024-06-13,9189
8085,福華,155,26,129,群益金鼎-桃園,2024-06-14,9189
00941,中信上游半導體,112,7,105,群益金鼎-桃園,2024-06-14,9189
00946,群益科技高息成長,95,5,90,群益金鼎-桃園,2024-06-14,9189
00632R,元大台灣50反1,63,0,63,群益金鼎-桃園,2024-06-14,9189
2313,華通,61,0,61,群益金鼎-桃園,2024-06-14,9189
6805,富世達,62,1,61,群益金鼎-桃園,2024-06-14,9189
00936,台新永續高息中小,63,6,57,群益金鼎-桃園,2024-06-14,9189
2349,錸德,50,0,50,群益金鼎-桃園,2024-06-14,9189
00919,群益台灣精選高息,56,12,44,群益金鼎-桃園,2024-06-14,9189
4927,泰鼎-KY,36,0,36,群益金鼎-桃園,2024-06-14,9189
00679B,元大美債20年,73,39,34,群益金鼎-桃園,2024-06-14,9189
1815,富喬,38,4,34,群益金鼎-桃園,2024-06-14,9189
2002,中鋼,33,1,32,群益金鼎-桃園,2024-06-14,9189
00751B,元大AAA至A公司債,30,0,30,群益金鼎-桃園,2024-06-14,9189
00664R,國泰臺灣加權反1,30,0,30,群益金鼎-桃園,2024-06-14,9189
2367,燿華,44,16,28,群益金鼎-桃園,2024-06-14,9189
2399,映泰,27,0,27,群益金鼎-桃園,2024-06-14,9189
2609,陽明,105,79,26,群益金鼎-桃園,2024-06-14,9189
2405,輔信,38,16,22,群益金鼎-桃園,2024-06-14,9189
00637L,元大滬深300正2,122,101,21,群益金鼎-桃園,2024-06-14,9189
00712,復華富時不動產,22,1,21,群益金鼎-桃園,2024-06-14,9189
2882,國泰金,27,7,20,群益金鼎-桃園,2024-06-14,9189
2353,宏��,24,5,19,群益金鼎-桃園,2024-06-14,9189
2027,大成鋼,18,0,18,群益金鼎-桃園,2024-06-14,9189
2537,聯上發,58,40,18,群益金鼎-桃園,2024-06-14,9189
2613,中櫃,25,7,18,群益金鼎-桃園,2024-06-14,9189
1802,台玻,20,5,15,群益金鼎-桃園,2024-06-14,9189
3576,聯合再生,15,1,14,群益金鼎-桃園,2024-06-14,9189
2101,南港,14,0,14,群益金鼎-桃園,2024-06-14,9189
2801,彰銀,20,6,14,群益金鼎-桃園,2024-06-14,9189
1301,台塑,16,3,13,群益金鼎-桃園,2024-06-14,9189
2351,順德,13,0,13,群益金鼎-桃園,2024-06-14,9189
2324,仁寶,13,0,13,群益金鼎-桃園,2024-06-14,9189
3013,晟銘電,48,35,13,群益金鼎-桃園,2024-06-14,9189
00929,復華台灣科技優息,29,16,13,群益金鼎-桃園,2024-06-14,9189
3162,精確,16,4,12,群益金鼎-桃園,2024-06-14,9189
2607,榮運,12,0,12,群益金鼎-桃園,2024-06-14,9189
1905,華紙,12,0,12,群益金鼎-桃園,2024-06-14,9189
2427,三商電,16,5,11,群益金鼎-桃園,2024-06-14,9189
5426,振發,11,0,11,群益金鼎-桃園,2024-06-14,9189
2486,一詮,42,31,11,群益金鼎-桃園,2024-06-14,9189
2344,華邦電,11,0,11,群益金鼎-桃園,2024-06-14,9189
1528,恩德,10,0,10,群益金鼎-桃園,2024-06-14,9189
8255,朋程,15,5,10,群益金鼎-桃園,2024-06-14,9189
2630,亞航,10,0,10,群益金鼎-桃園,2024-06-14,9189
00655L,國泰中國A50正2,10,0,10,群益金鼎-桃園,2024-06-14,9189
00686R,群益臺灣加權反1,10,0,10,群益金鼎-桃園,2024-06-14,9189
2701,萬企,10,0,10,群益金鼎-桃園,2024-06-14,9189
2426,鼎元,10,0,10,群益金鼎-桃園,2024-06-14,9189
3036,文曄,11,1,10,群益金鼎-桃園,2024-06-14,9189
00942B,台新美A公司債20+,1866,0,1866,群益金鼎-桃園,2024-06-17,9189
00929,復華台灣科技優息,685,78,607,群益金鼎-桃園,2024-06-17,9189
00680L,元大美債20正2,103,0,103,群益金鼎-桃園,2024-06-17,9189
00937B,群益ESG投等債20,116,16,100,群益金鼎-桃園,2024-06-17,9189
2615,萬海,123,29,94,群益金鼎-桃園,2024-06-17,9189
9945,潤泰新,104,12,92,群益金鼎-桃園,2024-06-17,9189
00918,大華優利高填息30,60,0,60,群益金鼎-桃園,2024-06-17,9189
00687B,國泰20年美債,46,0,46,群益金鼎-桃園,2024-06-17,9189
2399,映泰,45,0,45,群益金鼎-桃園,2024-06-17,9189
2538,基泰,40,0,40,群益金鼎-桃園,2024-06-17,9189
2609,陽明,123,85,38,群益金鼎-桃園,2024-06-17,9189
00946,群益科技高息成長,39,1,38,群益金鼎-桃園,2024-06-17,9189
3450,聯鈞,38,4,34,群益金鼎-桃園,2024-06-17,9189
9105,泰金寶-DR,30,5,25,群益金鼎-桃園,2024-06-17,9189
3481,群創,126,101,25,群益金鼎-桃園,2024-06-17,9189
2610,華航,25,0,25,群益金鼎-桃園,2024-06-17,9189
2367,燿華,35,11,24,群益金鼎-桃園,2024-06-17,9189
8105,凌巨,23,1,22,群益金鼎-桃園,2024-06-17,9189
00645,富邦日本,20,0,20,群益金鼎-桃園,2024-06-17,9189
2439,美律,20,0,20,群益金鼎-桃園,2024-06-17,9189
3024,憶聲,23,3,20,群益金鼎-桃園,2024-06-17,9189
2501,國建,20,0,20,群益金鼎-桃園,2024-06-17,9189
2208,台船,20,0,20,群益金鼎-桃園,2024-06-17,9189
2025,千興,22,2,20,群益金鼎-桃園,2024-06-17,9189
00932,兆豐永續高息等權,19,0,19,群益金鼎-桃園,2024-06-17,9189
2363,矽統,38,20,18,群益金鼎-桃園,2024-06-17,9189
5443,均豪,26,9,17,群益金鼎-桃園,2024-06-17,9189
2618,長榮航,25,8,17,群益金鼎-桃園,2024-06-17,9189
00679B,元大美債20年,29,12,17,群益金鼎-桃園,2024-06-17,9189
2464,盟立,23,7,16,群益金鼎-桃園,2024-06-17,9189
1513,中興電,21,6,15,群益金鼎-桃園,2024-06-17,9189
00712,復華富時不動產,15,0,15,群益金鼎-桃園,2024-06-17,9189
00948B,中信優息投資級債,15,0,15,群益金鼎-桃園,2024-06-17,9189
00637L,元大滬深300正2,15,0,15,群益金鼎-桃園,2024-06-17,9189
3466,德晉,24,9,15,群益金鼎-桃園,2024-06-17,9189
8028,昇陽半導體,76,61,15,群益金鼎-桃園,2024-06-17,9189
2317,鴻海,50,36,14,群益金鼎-桃園,2024-06-17,9189
00882,中信中國高股息,13,0,13,群益金鼎-桃園,2024-06-17,9189
3219,倚強科,13,0,13,群益金鼎-桃園,2024-06-17,9189
8112,至上,15,2,13,群益金鼎-桃園,2024-06-17,9189
2354,鴻準,19,6,13,群益金鼎-桃園,2024-06-17,9189
8039,台虹,12,0,12,群益金鼎-桃園,2024-06-17,9189
1326,台化,12,0,12,群益金鼎-桃園,2024-06-17,9189
2515,中工,12,0,12,群益金鼎-桃園,2024-06-17,9189
00795B,中信美國公債20年,12,0,12,群益金鼎-桃園,2024-06-17,9189
5490,同亨,12,0,12,群益金鼎-桃園,2024-06-17,9189
1442,名軒,11,0,11,群益金鼎-桃園,2024-06-17,9189
2101,南港,11,0,11,群益金鼎-桃園,2024-06-17,9189
1514,亞力,45,34,11,群益金鼎-桃園,2024-06-17,9189
1301,台塑,14,4,10,群益金鼎-桃園,2024-06-17,9189
00929,復華台灣科技優息,474,55,419,群益金鼎-桃園,2024-06-18,9189
00632R,元大台灣50反1,273,22,251,群益金鼎-桃園,2024-06-18,9189
00919,群益台灣精選高息,138,16,122,群益金鼎-桃園,2024-06-18,9189
00936,台新永續高息中小,101,9,92,群益金鼎-桃園,2024-06-18,9189
00946,群益科技高息成長,144,56,88,群益金鼎-桃園,2024-06-18,9189
00942B,台新美A公司債20+,73,0,73,群益金鼎-桃園,2024-06-18,9189
00664R,國泰臺灣加權反1,65,0,65,群益金鼎-桃園,2024-06-18,9189
1504,東元,66,4,62,群益金鼎-桃園,2024-06-18,9189
00637L,元大滬深300正2,105,50,55,群益金鼎-桃園,2024-06-18,9189
00899,FT潔淨能源,50,0,50,群益金鼎-桃園,2024-06-18,9189
6538,倉和,43,0,43,群益金鼎-桃園,2024-06-18,9189
2371,大同,67,30,37,群益金鼎-桃園,2024-06-18,9189
00713,元大台灣高息低波,36,0,36,群益金鼎-桃園,2024-06-18,9189
1102,亞泥,35,0,35,群益金鼎-桃園,2024-06-18,9189
5443,均豪,63,30,33,群益金鼎-桃園,2024-06-18,9189
8936,國統,33,0,33,群益金鼎-桃園,2024-06-18,9189
1802,台玻,32,2,30,群益金鼎-桃園,2024-06-18,9189
2515,中工,32,5,27,群益金鼎-桃園,2024-06-18,9189
2890,永豐金,30,4,26,群益金鼎-桃園,2024-06-18,9189
00712,復華富時不動產,36,10,26,群益金鼎-桃園,2024-06-18,9189
2104,國際中橡,25,0,25,群益金鼎-桃園,2024-06-18,9189
00679B,元大美債20年,34,11,23,群益金鼎-桃園,2024-06-18,9189
2363,矽統,39,16,23,群益金鼎-桃園,2024-06-18,9189
00673R,期元大S＆P原油反1,23,0,23,群益金鼎-桃園,2024-06-18,9189
2903,遠百,22,0,22,群益金鼎-桃園,2024-06-18,9189
2609,陽明,54,33,21,群益金鼎-桃園,2024-06-18,9189
00751B,元大AAA至A公司債,22,1,21,群益金鼎-桃園,2024-06-18,9189
3706,神達,24,3,21,群益金鼎-桃園,2024-06-18,9189
2392,正崴,57,37,20,群益金鼎-桃園,2024-06-18,9189
9904,寶成,20,0,20,群益金鼎-桃園,2024-06-18,9189
00688L,國泰20年美債正2,20,0,20,群益金鼎-桃園,2024-06-18,9189
2399,映泰,20,0,20,群益金鼎-桃園,2024-06-18,9189
8096,擎亞,53,33,20,群益金鼎-桃園,2024-06-18,9189
3466,德晉,28,10,18,群益金鼎-桃園,2024-06-18,9189
4938,和碩,18,0,18,群益金鼎-桃園,2024-06-18,9189
1513,中興電,22,5,17,群益金鼎-桃園,2024-06-18,9189
2031,新光鋼,17,0,17,群益金鼎-桃園,2024-06-18,9189
9958,世紀鋼,19,3,16,群益金鼎-桃園,2024-06-18,9189
1325,恆大,17,1,16,群益金鼎-桃園,2024-06-18,9189
2025,千興,14,1,13,群益金鼎-桃園,2024-06-18,9189
8028,昇陽半導體,64,51,13,群益金鼎-桃園,2024-06-18,9189
6770,力積電,41,29,12,群益金鼎-桃園,2024-06-18,9189
2489,瑞軒,15,3,12,群益金鼎-桃園,2024-06-18,9189
2438,翔耀,12,0,12,群益金鼎-桃園,2024-06-18,9189
2476,鉅祥,22,10,12,群益金鼎-桃園,2024-06-18,9189
2002,中鋼,12,0,12,群益金鼎-桃園,2024-06-18,9189
00948B,中信優息投資級債,13,2,11,群益金鼎-桃園,2024-06-18,9189
8358,金居,11,0,11,群益金鼎-桃園,2024-06-18,9189
3567,逸昌,11,0,11,群益金鼎-桃園,2024-06-18,9189
5521,工信,11,0,11,群益金鼎-桃園,2024-06-18,9189
00680L,元大美債20正2,479,0,479,群益金鼎-桃園,2024-06-19,9189
00942B,台新美A公司債20+,460,0,460,群益金鼎-桃園,2024-06-19,9189
00632R,元大台灣50反1,245,65,180,群益金鼎-桃園,2024-06-19,9189
00946,群益科技高息成長,197,35,162,群益金鼎-桃園,2024-06-19,9189
00686R,群益臺灣加權反1,130,0,130,群益金鼎-桃園,2024-06-19,9189
3450,聯鈞,133,41,92,群益金鼎-桃園,2024-06-19,9189
00679B,元大美債20年,82,6,76,群益金鼎-桃園,2024-06-19,9189
9945,潤泰新,62,8,54,群益金鼎-桃園,2024-06-19,9189
2371,大同,67,17,50,群益金鼎-桃園,2024-06-19,9189
00664R,國泰臺灣加權反1,49,0,49,群益金鼎-桃園,2024-06-19,9189
3048,益登,104,63,41,群益金鼎-桃園,2024-06-19,9189
00947,台新臺灣IC設計,40,0,40,群益金鼎-桃園,2024-06-19,9189
2903,遠百,127,88,39,群益金鼎-桃園,2024-06-19,9189
8064,東捷,88,50,38,群益金鼎-桃園,2024-06-19,9189
00712,復華富時不動產,34,0,34,群益金鼎-桃園,2024-06-19,9189
2323,中環,33,0,33,群益金鼎-桃園,2024-06-19,9189
5512,力麒,40,8,32,群益金鼎-桃園,2024-06-19,9189
2801,彰銀,32,0,32,群益金鼎-桃園,2024-06-19,9189
2365,昆盈,78,47,31,群益金鼎-桃園,2024-06-19,9189
6547,高端疫苗,30,0,30,群益金鼎-桃園,2024-06-19,9189
2104,國際中橡,28,1,27,群益金鼎-桃園,2024-06-19,9189
3287,廣寰科,63,36,27,群益金鼎-桃園,2024-06-19,9189
1504,東元,33,7,26,群益金鼎-桃園,2024-06-19,9189
5608,四維航,25,0,25,群益金鼎-桃園,2024-06-19,9189
6125,廣運,23,0,23,群益金鼎-桃園,2024-06-19,9189
1301,台塑,24,1,23,群益金鼎-桃園,2024-06-19,9189
3006,晶豪科,27,5,22,群益金鼎-桃園,2024-06-19,9189
2465,麗臺,19,0,19,群益金鼎-桃園,2024-06-19,9189
00936,台新永續高息中小,65,47,18,群益金鼎-桃園,2024-06-19,9189
2301,光寶科,22,4,18,群益金鼎-桃園,2024-06-19,9189
3033,威健,26,9,17,群益金鼎-桃園,2024-06-19,9189
3013,晟銘電,42,25,17,群益金鼎-桃園,2024-06-19,9189
3231,緯創,42,26,16,群益金鼎-桃園,2024-06-19,9189
3062,建漢,33,17,16,群益金鼎-桃園,2024-06-19,9189
5457,宣德,25,9,16,群益金鼎-桃園,2024-06-19,9189
4967,十銓,27,11,16,群益金鼎-桃園,2024-06-19,9189
5871,中租-KY,16,0,16,群益金鼎-桃園,2024-06-19,9189
00895,富邦未來車,15,0,15,群益金鼎-桃園,2024-06-19,9189
00915,凱基優選高股息30,14,0,14,群益金鼎-桃園,2024-06-19,9189
00673R,期元大S＆P原油反1,13,0,13,群益金鼎-桃園,2024-06-19,9189
2337,旺宏,15,2,13,群益金鼎-桃園,2024-06-19,9189
4532,瑞智,16,4,12,群益金鼎-桃園,2024-06-19,9189
9105,泰金寶-DR,14,2,12,群益金鼎-桃園,2024-06-19,9189
5484,慧友,12,0,12,群益金鼎-桃園,2024-06-19,9189
3576,聯合再生,12,0,12,群益金鼎-桃園,2024-06-19,9189
6264,富裔,12,0,12,群益金鼎-桃園,2024-06-19,9189
3665,貿聯-KY,23,11,12,群益金鼎-桃園,2024-06-19,9189
1303,南亞,12,0,12,群益金鼎-桃園,2024-06-19,9189
3481,群創,28,16,12,群益金鼎-桃園,2024-06-19,9189
6290,良維,13,2,11,群益金鼎-桃園,2024-06-19,9189
00637L,元大滬深300正2,170,0,170,群益金鼎-桃園,2024-06-20,9189
2889,國票金,100,3,97,群益金鼎-桃園,2024-06-20,9189
2323,中環,96,5,91,群益金鼎-桃園,2024-06-20,9189
00679B,元大美債20年,84,13,71,群益金鼎-桃園,2024-06-20,9189
00942B,台新美A公司債20+,60,0,60,群益金鼎-桃園,2024-06-20,9189
00687B,國泰20年美債,59,6,53,群益金鼎-桃園,2024-06-20,9189
00948B,中信優息投資級債,71,20,51,群益金鼎-桃園,2024-06-20,9189
4562,穎漢,55,13,42,群益金鼎-桃園,2024-06-20,9189
2618,長榮航,64,23,41,群益金鼎-桃園,2024-06-20,9189
6770,力積電,57,17,40,群益金鼎-桃園,2024-06-20,9189
2353,宏��,46,6,40,群益金鼎-桃園,2024-06-20,9189
9105,泰金寶-DR,44,5,39,群益金鼎-桃園,2024-06-20,9189
00936,台新永續高息中小,39,0,39,群益金鼎-桃園,2024-06-20,9189
2027,大成鋼,30,0,30,群益金鼎-桃園,2024-06-20,9189
2399,映泰,32,2,30,群益金鼎-桃園,2024-06-20,9189
2883,凱基金,30,2,28,群益金鼎-桃園,2024-06-20,9189
8110,華東,30,5,25,群益金鼎-桃園,2024-06-20,9189
2498,宏達電,48,25,23,群益金鼎-桃園,2024-06-20,9189
2330,台積電,24,1,23,群益金鼎-桃園,2024-06-20,9189
4915,致伸,21,0,21,群益金鼎-桃園,2024-06-20,9189
00662,富邦NASDAQ,21,0,21,群益金鼎-桃園,2024-06-20,9189
00645,富邦日本,20,0,20,群益金鼎-桃園,2024-06-20,9189
00688L,國泰20年美債正2,20,0,20,群益金鼎-桃園,2024-06-20,9189
2537,聯上發,21,1,20,群益金鼎-桃園,2024-06-20,9189
00761B,國泰A級公司債,20,0,20,群益金鼎-桃園,2024-06-20,9189
00720B,元大投資級公司債,25,5,20,群益金鼎-桃園,2024-06-20,9189
2316,楠梓電,41,21,20,群益金鼎-桃園,2024-06-20,9189
8050,廣積,41,24,17,群益金鼎-桃園,2024-06-20,9189
1605,華新,17,0,17,群益金鼎-桃園,2024-06-20,9189
00712,復華富時不動產,17,0,17,群益金鼎-桃園,2024-06-20,9189
6005,群益證,17,0,17,群益金鼎-桃園,2024-06-20,9189
3706,神達,34,17,17,群益金鼎-桃園,2024-06-20,9189
00664R,國泰臺灣加權反1,15,0,15,群益金鼎-桃園,2024-06-20,9189
1303,南亞,12,1,11,群益金鼎-桃園,2024-06-20,9189
00881,國泰台灣5G+,13,2,11,群益金鼎-桃園,2024-06-20,9189
00751B,元大AAA至A公司債,11,0,11,群益金鼎-桃園,2024-06-20,9189
3033,威健,11,0,11,群益金鼎-桃園,2024-06-20,9189
2002,中鋼,14,3,11,群益金鼎-桃園,2024-06-20,9189
2354,鴻準,80,70,10,群益金鼎-桃園,2024-06-20,9189
3036,文曄,11,1,10,群益金鼎-桃園,2024-06-20,9189
5203,訊連,10,0,10,群益金鼎-桃園,2024-06-20,9189
2374,佳能,10,0,10,群益金鼎-桃園,2024-06-20,9189
2371,大同,44,34,10,群益金鼎-桃園,2024-06-20,9189
3287,廣寰科,16,6,10,群益金鼎-桃園,2024-06-20,9189
5521,工信,10,0,10,群益金鼎-桃園,2024-06-20,9189
3276,宇環,13,3,10,群益金鼎-桃園,2024-06-20,9189
2101,南港,10,0,10,群益金鼎-桃園,2024-06-20,9189
00671R,富邦NASDAQ反1,10,0,10,群益金鼎-桃園,2024-06-20,9189
8039,台虹,10,0,10,群益金鼎-桃園,2024-06-20,9189
00713,元大台灣高息低波,10,0,10,群益金鼎-桃園,2024-06-20,9189
00946,群益科技高息成長,1192,6,1186,群益金鼎-桃園,2024-06-21,9189
00937B,群益ESG投等債20,334,39,295,群益金鼎-桃園,2024-06-21,9189
2883,凱基金,150,13,137,群益金鼎-桃園,2024-06-21,9189
5512,力麒,80,0,80,群益金鼎-桃園,2024-06-21,9189
9945,潤泰新,74,11,63,群益金鼎-桃園,2024-06-21,9189
3042,晶技,52,0,52,群益金鼎-桃園,2024-06-21,9189
00679B,元大美債20年,58,15,43,群益金鼎-桃園,2024-06-21,9189
00753L,中信中國50正2,40,0,40,群益金鼎-桃園,2024-06-21,9189
2317,鴻海,82,44,38,群益金鼎-桃園,2024-06-21,9189
1301,台塑,37,1,36,群益金鼎-桃園,2024-06-21,9189
3227,原相,32,0,32,群益金鼎-桃園,2024-06-21,9189
3379,彬台,32,0,32,群益金鼎-桃園,2024-06-21,9189
00948B,中信優息投資級債,32,0,32,群益金鼎-桃園,2024-06-21,9189
2801,彰銀,32,0,32,群益金鼎-桃園,2024-06-21,9189
00637L,元大滬深300正2,119,93,26,群益金鼎-桃園,2024-06-21,9189
00936,台新永續高息中小,25,1,24,群益金鼎-桃園,2024-06-21,9189
5443,均豪,35,11,24,群益金鼎-桃園,2024-06-21,9189
2615,萬海,100,77,23,群益金鼎-桃園,2024-06-21,9189
00947,台新臺灣IC設計,26,3,23,群益金鼎-桃園,2024-06-21,9189
2104,國際中橡,23,0,23,群益金鼎-桃園,2024-06-21,9189
00712,復華富時不動產,24,3,21,群益金鼎-桃園,2024-06-21,9189
1605,華新,22,1,21,群益金鼎-桃園,2024-06-21,9189
2891,中信金,24,4,20,群益金鼎-桃園,2024-06-21,9189
00882,中信中國高股息,51,31,20,群益金鼎-桃園,2024-06-21,9189
6117,迎廣,23,4,19,群益金鼎-桃園,2024-06-21,9189
2356,英業達,22,5,17,群益金鼎-桃園,2024-06-21,9189
2330,台積電,17,1,16,群益金鼎-桃園,2024-06-21,9189
00720B,元大投資級公司債,16,0,16,群益金鼎-桃園,2024-06-21,9189
5521,工信,20,4,16,群益金鼎-桃園,2024-06-21,9189
8096,擎亞,26,10,16,群益金鼎-桃園,2024-06-21,9189
6282,康舒,18,2,16,群益金鼎-桃園,2024-06-21,9189
4909,新復興,29,14,15,群益金鼎-桃園,2024-06-21,9189
6233,旺玖,16,1,15,群益金鼎-桃園,2024-06-21,9189
00887,永豐中國科技50大,15,0,15,群益金鼎-桃園,2024-06-21,9189
2303,聯電,45,31,14,群益金鼎-桃園,2024-06-21,9189
00665L,富邦�琤肭磪囓�2,14,0,14,群益金鼎-桃園,2024-06-21,9189
1609,大亞,13,0,13,群益金鼎-桃園,2024-06-21,9189
2489,瑞軒,44,31,13,群益金鼎-桃園,2024-06-21,9189
2367,燿華,15,3,12,群益金鼎-桃園,2024-06-21,9189
2329,華泰,28,17,11,群益金鼎-桃園,2024-06-21,9189
2881,富邦金,12,1,11,群益金鼎-桃園,2024-06-21,9189
2603,長榮,18,7,11,群益金鼎-桃園,2024-06-21,9189
1503,士電,21,10,11,群益金鼎-桃園,2024-06-21,9189
00929,復華台灣科技優息,57,47,10,群益金鼎-桃園,2024-06-21,9189
6425,易發,12,2,10,群益金鼎-桃園,2024-06-21,9189
00639,富邦深100,10,0,10,群益金鼎-桃園,2024-06-21,9189
2537,聯上發,20,10,10,群益金鼎-桃園,2024-06-21,9189
1714,和桐,10,0,10,群益金鼎-桃園,2024-06-21,9189
6153,嘉聯益,10,0,10,群益金鼎-桃園,2024-06-21,9189
3380,明泰,10,0,10,群益金鼎-桃園,2024-06-21,9189
3481,群創,430,291,139,群益金鼎-桃園,2024-06-24,9189
00936,台新永續高息中小,107,6,101,群益金鼎-桃園,2024-06-24,9189
00919,群益台灣精選高息,146,46,100,群益金鼎-桃園,2024-06-24,9189
00948B,中信優息投資級債,98,0,98,群益金鼎-桃園,2024-06-24,9189
00937B,群益ESG投等債20,97,0,97,群益金鼎-桃園,2024-06-24,9189
3062,建漢,162,81,81,群益金鼎-桃園,2024-06-24,9189
8096,擎亞,86,7,79,群益金鼎-桃園,2024-06-24,9189
2867,三商壽,58,0,58,群益金鼎-桃園,2024-06-24,9189
5443,均豪,104,50,54,群益金鼎-桃園,2024-06-24,9189
00686R,群益臺灣加權反1,50,0,50,群益金鼎-桃園,2024-06-24,9189
00940,元大台灣價值高息,77,29,48,群益金鼎-桃園,2024-06-24,9189
00946,群益科技高息成長,47,4,43,群益金鼎-桃園,2024-06-24,9189
2104,國際中橡,43,0,43,群益金鼎-桃園,2024-06-24,9189
00679B,元大美債20年,43,0,43,群益金鼎-桃園,2024-06-24,9189
00947,台新臺灣IC設計,36,0,36,群益金鼎-桃園,2024-06-24,9189
2406,國碩,35,0,35,群益金鼎-桃園,2024-06-24,9189
2615,萬海,40,6,34,群益金鼎-桃園,2024-06-24,9189
2489,瑞軒,38,4,34,群益金鼎-桃園,2024-06-24,9189
6806,森崴能源,38,4,34,群益金鼎-桃園,2024-06-24,9189
2303,聯電,46,15,31,群益金鼎-桃園,2024-06-24,9189
6116,彩晶,31,1,30,群益金鼎-桃園,2024-06-24,9189
1516,川飛,30,0,30,群益金鼎-桃園,2024-06-24,9189
00929,復華台灣科技優息,133,105,28,群益金鼎-桃園,2024-06-24,9189
2330,台積電,32,5,27,群益金鼎-桃園,2024-06-24,9189
5328,華容,36,11,25,群益金鼎-桃園,2024-06-24,9189
8076,伍豐,25,1,24,群益金鼎-桃園,2024-06-24,9189
00918,大華優利高填息30,33,10,23,群益金鼎-桃園,2024-06-24,9189
2002,中鋼,23,1,22,群益金鼎-桃園,2024-06-24,9189
9105,泰金寶-DR,61,40,21,群益金鼎-桃園,2024-06-24,9189
6139,亞翔,21,1,20,群益金鼎-桃園,2024-06-24,9189
2464,盟立,40,20,20,群益金鼎-桃園,2024-06-24,9189
6207,雷科,23,4,19,群益金鼎-桃園,2024-06-24,9189
2344,華邦電,19,0,19,群益金鼎-桃園,2024-06-24,9189
2367,燿華,30,12,18,群益金鼎-桃園,2024-06-24,9189
3287,廣寰科,18,0,18,群益金鼎-桃園,2024-06-24,9189
2409,友達,43,25,18,群益金鼎-桃園,2024-06-24,9189
3231,緯創,20,3,17,群益金鼎-桃園,2024-06-24,9189
3706,神達,24,7,17,群益金鼎-桃園,2024-06-24,9189
5434,崇越,17,0,17,群益金鼎-桃園,2024-06-24,9189
6176,瑞儀,17,0,17,群益金鼎-桃園,2024-06-24,9189
2324,仁寶,35,18,17,群益金鼎-桃園,2024-06-24,9189
4720,德淵,16,0,16,群益金鼎-桃園,2024-06-24,9189
1608,華榮,15,0,15,群益金鼎-桃園,2024-06-24,9189
6284,佳邦,16,1,15,群益金鼎-桃園,2024-06-24,9189
6538,倉和,15,0,15,群益金鼎-桃園,2024-06-24,9189
2603,長榮,16,1,15,群益金鼎-桃園,2024-06-24,9189
1503,士電,16,2,14,群益金鼎-桃園,2024-06-24,9189
3576,聯合再生,14,0,14,群益金鼎-桃園,2024-06-24,9189
4561,健椿,14,0,14,群益金鼎-桃園,2024-06-24,9189
1319,東陽,14,1,13,群益金鼎-桃園,2024-06-24,9189
2409,友達,648,4,644,群益金鼎-桃園,2024-06-25,9189
3481,群創,247,75,172,群益金鼎-桃園,2024-06-25,9189
5530,龍巖,170,2,168,群益金鼎-桃園,2024-06-25,9189
5452,佶優,167,68,99,群益金鼎-桃園,2024-06-25,9189
00679B,元大美債20年,82,3,79,群益金鼎-桃園,2024-06-25,9189
00919,群益台灣精選高息,102,32,70,群益金鼎-桃園,2024-06-25,9189
00929,復華台灣科技優息,76,10,66,群益金鼎-桃園,2024-06-25,9189
9945,潤泰新,83,20,63,群益金鼎-桃園,2024-06-25,9189
00936,台新永續高息中小,50,0,50,群益金鼎-桃園,2024-06-25,9189
2324,仁寶,49,2,47,群益金鼎-桃園,2024-06-25,9189
2374,佳能,50,6,44,群益金鼎-桃園,2024-06-25,9189
2615,萬海,58,15,43,群益金鼎-桃園,2024-06-25,9189
2303,聯電,56,13,43,群益金鼎-桃園,2024-06-25,9189
1815,富喬,51,16,35,群益金鼎-桃園,2024-06-25,9189
00946,群益科技高息成長,76,45,31,群益金鼎-桃園,2024-06-25,9189
8110,華東,36,10,26,群益金鼎-桃園,2024-06-25,9189
00937B,群益ESG投等債20,30,9,21,群益金鼎-桃園,2024-06-25,9189
3287,廣寰科,22,2,20,群益金鼎-桃園,2024-06-25,9189
2406,國碩,33,14,19,群益金鼎-桃園,2024-06-25,9189
2356,英業達,36,18,18,群益金鼎-桃園,2024-06-25,9189
6770,力積電,28,10,18,群益金鼎-桃園,2024-06-25,9189
1701,中化,18,0,18,群益金鼎-桃園,2024-06-25,9189
00918,大華優利高填息30,18,0,18,群益金鼎-桃園,2024-06-25,9189
3037,欣興,17,0,17,群益金鼎-桃園,2024-06-25,9189
2489,瑞軒,17,0,17,群益金鼎-桃園,2024-06-25,9189
00939,統一台灣高息動能,17,2,15,群益金鼎-桃園,2024-06-25,9189
3059,華晶科,16,1,15,群益金鼎-桃園,2024-06-25,9189
1219,福壽,15,0,15,群益金鼎-桃園,2024-06-25,9189
2002,中鋼,16,1,15,群益金鼎-桃園,2024-06-25,9189
2367,燿華,30,16,14,群益金鼎-桃園,2024-06-25,9189
4971,IET-KY,14,0,14,群益金鼎-桃園,2024-06-25,9189
1611,中電,13,0,13,群益金鼎-桃園,2024-06-25,9189
2472,立隆電,13,0,13,群益金鼎-桃園,2024-06-25,9189
1785,光洋科,111,99,12,群益金鼎-桃園,2024-06-25,9189
00933B,國泰10Y+金融債,13,1,12,群益金鼎-桃園,2024-06-25,9189
2464,盟立,45,33,12,群益金鼎-桃園,2024-06-25,9189
8046,南電,13,1,12,群益金鼎-桃園,2024-06-25,9189
3498,陽程,14,3,11,群益金鼎-桃園,2024-06-25,9189
6538,倉和,26,16,10,群益金鼎-桃園,2024-06-25,9189
3105,穩懋,11,1,10,群益金鼎-桃園,2024-06-25,9189
1524,耿鼎,10,0,10,群益金鼎-桃園,2024-06-25,9189
2891,中信金,24,14,10,群益金鼎-桃園,2024-06-25,9189
5328,華容,12,2,10,群益金鼎-桃園,2024-06-25,9189
5009,榮剛,12,2,10,群益金鼎-桃園,2024-06-25,9189
4908,前鼎,10,0,10,群益金鼎-桃園,2024-06-25,9189
4513,福裕,10,0,10,群益金鼎-桃園,2024-06-25,9189
00947,台新臺灣IC設計,10,1,9,群益金鼎-桃園,2024-06-25,9189
8064,東捷,32,23,9,群益金鼎-桃園,2024-06-25,9189
6271,同欣電,9,0,9,群益金鼎-桃園,2024-06-25,9189
2104,國際中橡,9,0,9,群益金鼎-桃園,2024-06-25,9189
00686R,群益臺灣加權反1,201,0,201,群益金鼎-桃園,2024-06-26,9189
00946,群益科技高息成長,223,62,161,群益金鼎-桃園,2024-06-26,9189
00878,國泰永續高股息,129,17,112,群益金鼎-桃園,2024-06-26,9189
2002,中鋼,92,12,80,群益金鼎-桃園,2024-06-26,9189
00632R,元大台灣50反1,177,100,77,群益金鼎-桃園,2024-06-26,9189
2883B,凱基金乙特,70,0,70,群益金鼎-桃園,2024-06-26,9189
2883,凱基金,59,6,53,群益金鼎-桃園,2024-06-26,9189
3494,誠研,50,0,50,群益金鼎-桃園,2024-06-26,9189
2323,中環,50,0,50,群益金鼎-桃園,2024-06-26,9189
00680L,元大美債20正2,70,23,47,群益金鼎-桃園,2024-06-26,9189
5530,龍巖,45,0,45,群益金鼎-桃園,2024-06-26,9189
9105,泰金寶-DR,46,10,36,群益金鼎-桃園,2024-06-26,9189
6213,聯茂,36,3,33,群益金鼎-桃園,2024-06-26,9189
00637L,元大滬深300正2,32,0,32,群益金鼎-桃園,2024-06-26,9189
00936,台新永續高息中小,32,0,32,群益金鼎-桃園,2024-06-26,9189
2392,正崴,45,14,31,群益金鼎-桃園,2024-06-26,9189
9904,寶成,33,2,31,群益金鼎-桃園,2024-06-26,9189
00679B,元大美債20年,31,0,31,群益金鼎-桃園,2024-06-26,9189
00664R,國泰臺灣加權反1,30,0,30,群益金鼎-桃園,2024-06-26,9189
2888,新光金,34,5,29,群益金鼎-桃園,2024-06-26,9189
1605,華新,28,0,28,群益金鼎-桃園,2024-06-26,9189
00937B,群益ESG投等債20,43,16,27,群益金鼎-桃園,2024-06-26,9189
2020,美亞,25,0,25,群益金鼎-桃園,2024-06-26,9189
6695,芯鼎,32,7,25,群益金鼎-桃園,2024-06-26,9189
8112,至上,27,3,24,群益金鼎-桃園,2024-06-26,9189
2367,燿華,39,16,23,群益金鼎-桃園,2024-06-26,9189
1455,集盛,22,0,22,群益金鼎-桃園,2024-06-26,9189
2344,華邦電,23,1,22,群益金鼎-桃園,2024-06-26,9189
5452,佶優,31,9,22,群益金鼎-桃園,2024-06-26,9189
00933B,國泰10Y+金融債,21,0,21,群益金鼎-桃園,2024-06-26,9189
00764B,群益25年美債,126,105,21,群益金鼎-桃園,2024-06-26,9189
2409,友達,21,0,21,群益金鼎-桃園,2024-06-26,9189
4114,健喬,24,4,20,群益金鼎-桃園,2024-06-26,9189
2374,佳能,28,8,20,群益金鼎-桃園,2024-06-26,9189
2347,聯強,20,0,20,群益金鼎-桃園,2024-06-26,9189
00882,中信中國高股息,25,5,20,群益金鼎-桃園,2024-06-26,9189
5534,長虹,19,0,19,群益金鼎-桃園,2024-06-26,9189
1802,台玻,19,0,19,群益金鼎-桃園,2024-06-26,9189
4526,東台,75,56,19,群益金鼎-桃園,2024-06-26,9189
3535,晶彩科,58,39,19,群益金鼎-桃園,2024-06-26,9189
2406,國碩,31,12,19,群益金鼎-桃園,2024-06-26,9189
00720B,元大投資級公司債,19,1,18,群益金鼎-桃園,2024-06-26,9189
2104,國際中橡,18,0,18,群益金鼎-桃園,2024-06-26,9189
2609,陽明,20,3,17,群益金鼎-桃園,2024-06-26,9189
00948B,中信優息投資級債,17,0,17,群益金鼎-桃園,2024-06-26,9189
00830,國泰費城半導體,16,1,15,群益金鼎-桃園,2024-06-26,9189
4908,前鼎,14,0,14,群益金鼎-桃園,2024-06-26,9189
4566,時碩工業,23,10,13,群益金鼎-桃園,2024-06-26,9189
2438,翔耀,14,1,13,群益金鼎-桃園,2024-06-26,9189
4157,太景*-KY,13,0,13,群益金鼎-桃園,2024-06-26,9189
3481,群創,411,97,314,群益金鼎-桃園,2024-06-27,9189
00937B,群益ESG投等債20,145,2,143,群益金鼎-桃園,2024-06-27,9189
9105,泰金寶-DR,97,0,97,群益金鼎-桃園,2024-06-27,9189
2002,中鋼,73,1,72,群益金鼎-桃園,2024-06-27,9189
00680L,元大美債20正2,71,0,71,群益金鼎-桃園,2024-06-27,9189
2885,元大金,65,11,54,群益金鼎-桃園,2024-06-27,9189
00948B,中信優息投資級債,50,0,50,群益金鼎-桃園,2024-06-27,9189
2324,仁寶,48,0,48,群益金鼎-桃園,2024-06-27,9189
4938,和碩,49,2,47,群益金鼎-桃園,2024-06-27,9189
2104,國際中橡,42,0,42,群益金鼎-桃園,2024-06-27,9189
3297,杭特,46,5,41,群益金鼎-桃園,2024-06-27,9189
00687B,國泰20年美債,38,0,38,群益金鼎-桃園,2024-06-27,9189
00919,群益台灣精選高息,36,3,33,群益金鼎-桃園,2024-06-27,9189
3712,永崴投控,91,58,33,群益金鼎-桃園,2024-06-27,9189
2353,宏��,39,7,32,群益金鼎-桃園,2024-06-27,9189
4167,松瑞藥,63,31,32,群益金鼎-桃園,2024-06-27,9189
2303,聯電,39,8,31,群益金鼎-桃園,2024-06-27,9189
8150,南茂,31,0,31,群益金鼎-桃園,2024-06-27,9189
5905,南仁湖,43,13,30,群益金鼎-桃園,2024-06-27,9189
3047,訊舟,134,104,30,群益金鼎-桃園,2024-06-27,9189
00940,元大台灣價值高息,81,52,29,群益金鼎-桃園,2024-06-27,9189
5443,均豪,70,43,27,群益金鼎-桃園,2024-06-27,9189
2317,鴻海,49,22,27,群益金鼎-桃園,2024-06-27,9189
2515,中工,27,1,26,群益金鼎-桃園,2024-06-27,9189
2344,華邦電,26,0,26,群益金鼎-桃園,2024-06-27,9189
2332,友訊,25,0,25,群益金鼎-桃園,2024-06-27,9189
1609,大亞,55,30,25,群益金鼎-桃園,2024-06-27,9189
00936,台新永續高息中小,25,0,25,群益金鼎-桃園,2024-06-27,9189
1781,合世,24,2,22,群益金鼎-桃園,2024-06-27,9189
6957,裕慶-KY,23,2,21,群益金鼎-桃園,2024-06-27,9189
1785,光洋科,29,8,21,群益金鼎-桃園,2024-06-27,9189
00720B,元大投資級公司債,20,0,20,群益金鼎-桃園,2024-06-27,9189
1504,東元,20,0,20,群益金鼎-桃園,2024-06-27,9189
4906,正文,22,2,20,群益金鼎-桃園,2024-06-27,9189
5521,工信,20,1,19,群益金鼎-桃園,2024-06-27,9189
00713,元大台灣高息低波,20,1,19,群益金鼎-桃園,2024-06-27,9189
2855,統一證,18,0,18,群益金鼎-桃園,2024-06-27,9189
00939,統一台灣高息動能,20,3,17,群益金鼎-桃園,2024-06-27,9189
6770,力積電,17,1,16,群益金鼎-桃園,2024-06-27,9189
1612,宏泰,16,1,15,群益金鼎-桃園,2024-06-27,9189
2329,華泰,15,0,15,群益金鼎-桃園,2024-06-27,9189
2406,國碩,14,1,13,群益金鼎-桃園,2024-06-27,9189
00688L,國泰20年美債正2,13,0,13,群益金鼎-桃園,2024-06-27,9189
2337,旺宏,13,0,13,群益金鼎-桃園,2024-06-27,9189
6282,康舒,14,2,12,群益金鼎-桃園,2024-06-27,9189
3122,笙泉,12,0,12,群益金鼎-桃園,2024-06-27,9189
3622,洋華,14,2,12,群益金鼎-桃園,2024-06-27,9189
3260,威剛,16,4,12,群益金鼎-桃園,2024-06-27,9189
3666,光耀,18,6,12,群益金鼎-桃園,2024-06-27,9189
5478,智冠,16,4,12,群益金鼎-桃園,2024-06-27,9189
00686R,群益臺灣加權反1,201,0,201,群益金鼎-桃園,2024-06-28,9189
00942B,台新美A公司債20+,100,0,100,群益金鼎-桃園,2024-06-28,9189
2323,中環,88,19,69,群益金鼎-桃園,2024-06-28,9189
2618,長榮航,151,88,63,群益金鼎-桃園,2024-06-28,9189
5452,佶優,68,8,60,群益金鼎-桃園,2024-06-28,9189
2002,中鋼,57,0,57,群益金鼎-桃園,2024-06-28,9189
3494,誠研,45,0,45,群益金鼎-桃園,2024-06-28,9189
9105,泰金寶-DR,56,11,45,群益金鼎-桃園,2024-06-28,9189
00632R,元大台灣50反1,42,2,40,群益金鼎-桃園,2024-06-28,9189
6005,群益證,40,0,40,群益金鼎-桃園,2024-06-28,9189
9945,潤泰新,40,2,38,群益金鼎-桃園,2024-06-28,9189
1301,台塑,38,2,36,群益金鼎-桃園,2024-06-28,9189
2349,錸德,42,9,33,群益金鼎-桃園,2024-06-28,9189
00712,復華富時不動產,42,10,32,群益金鼎-桃園,2024-06-28,9189
3580,友威科,37,6,31,群益金鼎-桃園,2024-06-28,9189
6116,彩晶,31,0,31,群益金鼎-桃園,2024-06-28,9189
00936,台新永續高息中小,33,3,30,群益金鼎-桃園,2024-06-28,9189
00927,群益半導體收益,36,7,29,群益金鼎-桃園,2024-06-28,9189
6244,茂迪,64,36,28,群益金鼎-桃園,2024-06-28,9189
2409,友達,50,22,28,群益金鼎-桃園,2024-06-28,9189
3576,聯合再生,93,65,28,群益金鼎-桃園,2024-06-28,9189
8064,東捷,35,8,27,群益金鼎-桃園,2024-06-28,9189
3481,群創,67,43,24,群益金鼎-桃園,2024-06-28,9189
2476,鉅祥,24,0,24,群益金鼎-桃園,2024-06-28,9189
00919,群益台灣精選高息,25,2,23,群益金鼎-桃園,2024-06-28,9189
5371,中光電,34,11,23,群益金鼎-桃園,2024-06-28,9189
2543,皇昌,23,2,21,群益金鼎-桃園,2024-06-28,9189
00687B,國泰20年美債,22,1,21,群益金鼎-桃園,2024-06-28,9189
4909,新復興,23,5,18,群益金鼎-桃園,2024-06-28,9189
00937B,群益ESG投等債20,43,25,18,群益金鼎-桃園,2024-06-28,9189
3693,營邦,22,5,17,群益金鼎-桃園,2024-06-28,9189
00679B,元大美債20年,15,0,15,群益金鼎-桃園,2024-06-28,9189
2337,旺宏,16,1,15,群益金鼎-桃園,2024-06-28,9189
2438,翔耀,15,0,15,群益金鼎-桃園,2024-06-28,9189
2607,榮運,15,0,15,群益金鼎-桃園,2024-06-28,9189
1471,首利,14,0,14,群益金鼎-桃園,2024-06-28,9189
6477,安集,58,44,14,群益金鼎-桃園,2024-06-28,9189
00948B,中信優息投資級債,14,0,14,群益金鼎-桃園,2024-06-28,9189
2104,國際中橡,16,2,14,群益金鼎-桃園,2024-06-28,9189
4919,新唐,14,0,14,群益金鼎-桃園,2024-06-28,9189
2610,華航,28,15,13,群益金鼎-桃園,2024-06-28,9189
3149,正達,13,0,13,群益金鼎-桃園,2024-06-28,9189
1310,台苯,13,0,13,群益金鼎-桃園,2024-06-28,9189
2303,聯電,13,1,12,群益金鼎-桃園,2024-06-28,9189
9958,世紀鋼,23,11,12,群益金鼎-桃園,2024-06-28,9189
2392,正崴,25,13,12,群益金鼎-桃園,2024-06-28,9189
2312,金寶,12,0,12,群益金鼎-桃園,2024-06-28,9189
3013,晟銘電,33,21,12,群益金鼎-桃園,2024-06-28,9189
2486,一詮,13,1,12,群益金鼎-桃園,2024-06-28,9189
0056,元大高股息,12,0,12,群益金鼎-桃園,2024-06-28,9189
00937B,群益ESG投等債20,441,23,418,群益金鼎-桃園,2024-07-01,9189
00680L,元大美債20正2,378,0,378,群益金鼎-桃園,2024-07-01,9189
1109,信大,140,0,140,群益金鼎-桃園,2024-07-01,9189
00679B,元大美債20年,109,1,108,群益金鼎-桃園,2024-07-01,9189
00686R,群益臺灣加權反1,100,0,100,群益金鼎-桃園,2024-07-01,9189
2820,華票,100,0,100,群益金鼎-桃園,2024-07-01,9189
6770,力積電,105,8,97,群益金鼎-桃園,2024-07-01,9189
00942B,台新美A公司債20+,89,0,89,群益金鼎-桃園,2024-07-01,9189
00687B,國泰20年美債,90,10,80,群益金鼎-桃園,2024-07-01,9189
8096,擎亞,61,4,57,群益金鼎-桃園,2024-07-01,9189
00725B,國泰投資級公司債,52,0,52,群益金鼎-桃園,2024-07-01,9189
1101,台泥,56,7,49,群益金鼎-桃園,2024-07-01,9189
2317,鴻海,62,14,48,群益金鼎-桃園,2024-07-01,9189
0056,元大高股息,48,3,45,群益金鼎-桃園,2024-07-01,9189
00949,復華日本龍頭,69,25,44,群益金鼎-桃園,2024-07-01,9189
2303,聯電,44,6,38,群益金鼎-桃園,2024-07-01,9189
2515,中工,46,8,38,群益金鼎-桃園,2024-07-01,9189
00948B,中信優息投資級債,36,0,36,群益金鼎-桃園,2024-07-01,9189
2313,華通,43,7,36,群益金鼎-桃園,2024-07-01,9189
3312,弘憶股,82,48,34,群益金鼎-桃園,2024-07-01,9189
2615,萬海,54,22,32,群益金鼎-桃園,2024-07-01,9189
4532,瑞智,31,0,31,群益金鼎-桃園,2024-07-01,9189
2883B,凱基金乙特,30,0,30,群益金鼎-桃園,2024-07-01,9189
00664R,國泰臺灣加權反1,30,0,30,群益金鼎-桃園,2024-07-01,9189
9105,泰金寶-DR,27,2,25,群益金鼎-桃園,2024-07-01,9189
00751B,元大AAA至A公司債,28,4,24,群益金鼎-桃園,2024-07-01,9189
3402,漢科,27,3,24,群益金鼎-桃園,2024-07-01,9189
2324,仁寶,23,0,23,群益金鼎-桃園,2024-07-01,9189
3580,友威科,40,18,22,群益金鼎-桃園,2024-07-01,9189
6282,康舒,31,11,20,群益金鼎-桃園,2024-07-01,9189
8930,青鋼,20,0,20,群益金鼎-桃園,2024-07-01,9189
3576,聯合再生,32,13,19,群益金鼎-桃園,2024-07-01,9189
2367,燿華,25,7,18,群益金鼎-桃園,2024-07-01,9189
1514,亞力,25,8,17,群益金鼎-桃園,2024-07-01,9189
5483,中美晶,20,3,17,群益金鼎-桃園,2024-07-01,9189
1785,光洋科,27,10,17,群益金鼎-桃園,2024-07-01,9189
00918,大華優利高填息30,22,5,17,群益金鼎-桃園,2024-07-01,9189
2883,凱基金,18,1,17,群益金鼎-桃園,2024-07-01,9189
2409,友達,16,0,16,群益金鼎-桃園,2024-07-01,9189
00946,群益科技高息成長,18,2,16,群益金鼎-桃園,2024-07-01,9189
5230,雷笛克光學,40,25,15,群益金鼎-桃園,2024-07-01,9189
8390,金益鼎,15,0,15,群益金鼎-桃園,2024-07-01,9189
2891,中信金,15,0,15,群益金鼎-桃園,2024-07-01,9189
8996,高力,16,2,14,群益金鼎-桃園,2024-07-01,9189
6435,大中,14,0,14,群益金鼎-桃園,2024-07-01,9189
1612,宏泰,16,2,14,群益金鼎-桃園,2024-07-01,9189
2605,新興,14,1,13,群益金鼎-桃園,2024-07-01,9189
00637L,元大滬深300正2,117,104,13,群益金鼎-桃園,2024-07-01,9189
1815,富喬,32,20,12,群益金鼎-桃園,2024-07-01,9189
00795B,中信美國公債20年,14,2,12,群益金鼎-桃園,2024-07-01,9189
00680L,元大美債20正2,310,5,305,群益金鼎-桃園,2024-07-02,9189
00934,中信成長高股息,238,0,238,群益金鼎-桃園,2024-07-02,9189
2303,聯電,225,33,192,群益金鼎-桃園,2024-07-02,9189
00927,群益半導體收益,114,4,110,群益金鼎-桃園,2024-07-02,9189
00933B,國泰10Y+金融債,98,1,97,群益金鼎-桃園,2024-07-02,9189
2610,華航,140,58,82,群益金鼎-桃園,2024-07-02,9189
00946,群益科技高息成長,84,6,78,群益金鼎-桃園,2024-07-02,9189
00919,群益台灣精選高息,64,2,62,群益金鼎-桃園,2024-07-02,9189
9105,泰金寶-DR,91,33,58,群益金鼎-桃園,2024-07-02,9189
00936,台新永續高息中小,55,3,52,群益金鼎-桃園,2024-07-02,9189
00687B,國泰20年美債,52,1,51,群益金鼎-桃園,2024-07-02,9189
3047,訊舟,67,18,49,群益金鼎-桃園,2024-07-02,9189
2317,鴻海,65,18,47,群益金鼎-桃園,2024-07-02,9189
00679B,元大美債20年,43,0,43,群益金鼎-桃園,2024-07-02,9189
1303,南亞,43,0,43,群益金鼎-桃園,2024-07-02,9189
00942B,台新美A公司債20+,42,0,42,群益金鼎-桃園,2024-07-02,9189
2002,中鋼,44,5,39,群益金鼎-桃園,2024-07-02,9189
2323,中環,42,5,37,群益金鼎-桃園,2024-07-02,9189
0056,元大高股息,36,1,35,群益金鼎-桃園,2024-07-02,9189
2406,國碩,74,39,35,群益金鼎-桃園,2024-07-02,9189
3703,欣陸,32,0,32,群益金鼎-桃園,2024-07-02,9189
2606,裕民,57,27,30,群益金鼎-桃園,2024-07-02,9189
1301,台塑,30,0,30,群益金鼎-桃園,2024-07-02,9189
2405,輔信,30,4,26,群益金鼎-桃園,2024-07-02,9189
8112,至上,26,1,25,群益金鼎-桃園,2024-07-02,9189
2344,華邦電,25,0,25,群益金鼎-桃園,2024-07-02,9189
2464,盟立,48,27,21,群益金鼎-桃園,2024-07-02,9189
2476,鉅祥,22,1,21,群益金鼎-桃園,2024-07-02,9189
3380,明泰,21,0,21,群益金鼎-桃園,2024-07-02,9189
1513,中興電,23,2,21,群益金鼎-桃園,2024-07-02,9189
00706L,期元大S＆P日圓正2,20,0,20,群益金鼎-桃園,2024-07-02,9189
1785,光洋科,40,20,20,群益金鼎-桃園,2024-07-02,9189
3006,晶豪科,20,0,20,群益金鼎-桃園,2024-07-02,9189
00751B,元大AAA至A公司債,19,0,19,群益金鼎-桃園,2024-07-02,9189
2324,仁寶,20,1,19,群益金鼎-桃園,2024-07-02,9189
00948B,中信優息投資級債,18,0,18,群益金鼎-桃園,2024-07-02,9189
1783,和康生,17,0,17,群益金鼎-桃園,2024-07-02,9189
6114,久威,18,2,16,群益金鼎-桃園,2024-07-02,9189
8436,大江,16,0,16,群益金鼎-桃園,2024-07-02,9189
00688L,國泰20年美債正2,15,0,15,群益金鼎-桃園,2024-07-02,9189
1802,台玻,18,3,15,群益金鼎-桃園,2024-07-02,9189
6285,啟��,14,0,14,群益金鼎-桃園,2024-07-02,9189
1905,華紙,14,0,14,群益金鼎-桃園,2024-07-02,9189
2104,國際中橡,14,0,14,群益金鼎-桃園,2024-07-02,9189
2615,萬海,25,11,14,群益金鼎-桃園,2024-07-02,9189
2412,中華電,18,5,13,群益金鼎-桃園,2024-07-02,9189
3167,大量,13,0,13,群益金鼎-桃園,2024-07-02,9189
00712,復華富時不動產,13,0,13,群益金鼎-桃園,2024-07-02,9189
4534,慶騰,20,7,13,群益金鼎-桃園,2024-07-02,9189
6239,力成,12,0,12,群益金鼎-桃園,2024-07-02,9189
00680L,元大美債20正2,168,0,168,群益金鼎-桃園,2024-07-03,9189
00934,中信成長高股息,137,0,137,群益金鼎-桃園,2024-07-03,9189
00937B,群益ESG投等債20,80,0,80,群益金鼎-桃園,2024-07-03,9189
00933B,國泰10Y+金融債,80,18,62,群益金鼎-桃園,2024-07-03,9189
3321,同泰,57,0,57,群益金鼎-桃園,2024-07-03,9189
3576,聯合再生,150,95,55,群益金鼎-桃園,2024-07-03,9189
2405,輔信,54,6,48,群益金鼎-桃園,2024-07-03,9189
00936,台新永續高息中小,46,0,46,群益金鼎-桃園,2024-07-03,9189
2303,聯電,45,8,37,群益金鼎-桃園,2024-07-03,9189
00909,國泰數位支付服務,37,0,37,群益金鼎-桃園,2024-07-03,9189
5452,佶優,62,25,37,群益金鼎-桃園,2024-07-03,9189
00664R,國泰臺灣加權反1,35,0,35,群益金鼎-桃園,2024-07-03,9189
2002,中鋼,33,0,33,群益金鼎-桃園,2024-07-03,9189
2356,英業達,41,10,31,群益金鼎-桃園,2024-07-03,9189
5490,同亨,35,6,29,群益金鼎-桃園,2024-07-03,9189
3005,神基,31,2,29,群益金鼎-桃園,2024-07-03,9189
4906,正文,43,14,29,群益金鼎-桃園,2024-07-03,9189
2104,國際中橡,29,0,29,群益金鼎-桃園,2024-07-03,9189
6152,百一,22,0,22,群益金鼎-桃園,2024-07-03,9189
4960,誠美材,22,0,22,群益金鼎-桃園,2024-07-03,9189
3663,鑫科,34,14,20,群益金鼎-桃園,2024-07-03,9189
8033,雷虎,20,0,20,群益金鼎-桃園,2024-07-03,9189
00632R,元大台灣50反1,20,0,20,群益金鼎-桃園,2024-07-03,9189
1217,愛之味,20,0,20,群益金鼎-桃園,2024-07-03,9189
2890,永豐金,16,0,16,群益金鼎-桃園,2024-07-03,9189
4561,健椿,16,0,16,群益金鼎-桃園,2024-07-03,9189
00764B,群益25年美債,15,0,15,群益金鼎-桃園,2024-07-03,9189
00686R,群益臺灣加權反1,15,0,15,群益金鼎-桃園,2024-07-03,9189
3402,漢科,19,4,15,群益金鼎-桃園,2024-07-03,9189
6443,元晶,104,90,14,群益金鼎-桃園,2024-07-03,9189
00687B,國泰20年美債,14,0,14,群益金鼎-桃園,2024-07-03,9189
2324,仁寶,20,6,14,群益金鼎-桃園,2024-07-03,9189
2344,華邦電,34,20,14,群益金鼎-桃園,2024-07-03,9189
2402,毅嘉,92,79,13,群益金鼎-桃園,2024-07-03,9189
2301,光寶科,15,2,13,群益金鼎-桃園,2024-07-03,9189
4433,興采,13,0,13,群益金鼎-桃園,2024-07-03,9189
00679B,元大美債20年,13,0,13,群益金鼎-桃園,2024-07-03,9189
2409,友達,13,0,13,群益金鼎-桃園,2024-07-03,9189
00946,群益科技高息成長,33,21,12,群益金鼎-桃園,2024-07-03,9189
2462,良得電,12,0,12,群益金鼎-桃園,2024-07-03,9189
2444,兆勁,16,4,12,群益金鼎-桃園,2024-07-03,9189
2614,東森,13,1,12,群益金鼎-桃園,2024-07-03,9189
3535,晶彩科,44,32,12,群益金鼎-桃園,2024-07-03,9189
4534,慶騰,15,3,12,群益金鼎-桃園,2024-07-03,9189
2317,鴻海,45,34,11,群益金鼎-桃園,2024-07-03,9189
2615,萬海,17,6,11,群益金鼎-桃園,2024-07-03,9189
2603,長榮,15,4,11,群益金鼎-桃園,2024-07-03,9189
2515,中工,11,0,11,群益金鼎-桃園,2024-07-03,9189
1734,杏輝,10,0,10,群益金鼎-桃園,2024-07-03,9189
5443,均豪,45,35,10,群益金鼎-桃園,2024-07-03,9189
00686R,群益臺灣加權反1,484,0,484,群益金鼎-桃園,2024-07-04,9189
00934,中信成長高股息,274,0,274,群益金鼎-桃園,2024-07-04,9189
00937B,群益ESG投等債20,168,41,127,群益金鼎-桃園,2024-07-04,9189
00933B,國泰10Y+金融債,70,2,68,群益金鼎-桃園,2024-07-04,9189
00632R,元大台灣50反1,60,0,60,群益金鼎-桃園,2024-07-04,9189
2412,中華電,61,12,49,群益金鼎-桃園,2024-07-04,9189
3047,訊舟,102,54,48,群益金鼎-桃園,2024-07-04,9189
8110,華東,45,0,45,群益金鼎-桃園,2024-07-04,9189
00664R,國泰臺灣加權反1,41,0,41,群益金鼎-桃園,2024-07-04,9189
6116,彩晶,52,15,37,群益金鼎-桃園,2024-07-04,9189
3615,安可,72,37,35,群益金鼎-桃園,2024-07-04,9189
2371,大同,56,24,32,群益金鼎-桃園,2024-07-04,9189
3450,聯鈞,70,41,29,群益金鼎-桃園,2024-07-04,9189
2324,仁寶,29,1,28,群益金鼎-桃園,2024-07-04,9189
2323,中環,114,86,28,群益金鼎-桃園,2024-07-04,9189
2367,燿華,91,64,27,群益金鼎-桃園,2024-07-04,9189
2886,兆豐金,25,0,25,群益金鼎-桃園,2024-07-04,9189
2618,長榮航,33,8,25,群益金鼎-桃園,2024-07-04,9189
3535,晶彩科,93,70,23,群益金鼎-桃園,2024-07-04,9189
1785,光洋科,101,79,22,群益金鼎-桃園,2024-07-04,9189
3669,圓展,24,2,22,群益金鼎-桃園,2024-07-04,9189
00946,群益科技高息成長,22,0,22,群益金鼎-桃園,2024-07-04,9189
2609,陽明,36,15,21,群益金鼎-桃園,2024-07-04,9189
2603,長榮,21,0,21,群益金鼎-桃園,2024-07-04,9189
2344,華邦電,48,29,19,群益金鼎-桃園,2024-07-04,9189
3231,緯創,30,11,19,群益金鼎-桃園,2024-07-04,9189
8064,東捷,65,46,19,群益金鼎-桃園,2024-07-04,9189
00679B,元大美債20年,19,0,19,群益金鼎-桃園,2024-07-04,9189
1447,力鵬,22,4,18,群益金鼎-桃園,2024-07-04,9189
6005,群益證,58,40,18,群益金鼎-桃園,2024-07-04,9189
9105,泰金寶-DR,72,54,18,群益金鼎-桃園,2024-07-04,9189
2883,凱基金,226,208,18,群益金鼎-桃園,2024-07-04,9189
2104,國際中橡,18,0,18,群益金鼎-桃園,2024-07-04,9189
2017,官田鋼,17,0,17,群益金鼎-桃園,2024-07-04,9189
8071,能率網通,18,3,15,群益金鼎-桃園,2024-07-04,9189
6285,啟��,15,0,15,群益金鼎-桃園,2024-07-04,9189
00947,台新臺灣IC設計,15,1,14,群益金鼎-桃園,2024-07-04,9189
9945,潤泰新,45,31,14,群益金鼎-桃園,2024-07-04,9189
1597,直得,16,2,14,群益金鼎-桃園,2024-07-04,9189
3260,威剛,13,0,13,群益金鼎-桃園,2024-07-04,9189
3372,典範,13,0,13,群益金鼎-桃園,2024-07-04,9189
6127,九豪,16,3,13,群益金鼎-桃園,2024-07-04,9189
2382,廣達,17,4,13,群益金鼎-桃園,2024-07-04,9189
2363,矽統,23,10,13,群益金鼎-桃園,2024-07-04,9189
00919,群益台灣精選高息,24,12,12,群益金鼎-桃園,2024-07-04,9189
3066,李洲,13,1,12,群益金鼎-桃園,2024-07-04,9189
6271,同欣電,20,8,12,群益金鼎-桃園,2024-07-04,9189
8059,凱碩,14,2,12,群益金鼎-桃園,2024-07-04,9189
2374,佳能,15,3,12,群益金鼎-桃園,2024-07-04,9189
6415,矽力*-KY,12,0,12,群益金鼎-桃園,2024-07-04,9189
1714,和桐,100,0,100,群益金鼎-桃園,2024-07-05,9189
6116,彩晶,106,6,100,群益金鼎-桃園,2024-07-05,9189
6120,達運,100,3,97,群益金鼎-桃園,2024-07-05,9189
2427,三商電,85,9,76,群益金鼎-桃園,2024-07-05,9189
2610,華航,66,8,58,群益金鼎-桃園,2024-07-05,9189
00934,中信成長高股息,52,0,52,群益金鼎-桃園,2024-07-05,9189
00929,復華台灣科技優息,51,3,48,群益金鼎-桃園,2024-07-05,9189
2618,長榮航,88,47,41,群益金鼎-桃園,2024-07-05,9189
00706L,期元大S＆P日圓正2,40,0,40,群益金鼎-桃園,2024-07-05,9189
6160,欣技,37,1,36,群益金鼎-桃園,2024-07-05,9189
1301,台塑,33,0,33,群益金鼎-桃園,2024-07-05,9189
00632R,元大台灣50反1,42,10,32,群益金鼎-桃園,2024-07-05,9189
3231,緯創,33,2,31,群益金鼎-桃園,2024-07-05,9189
3580,友威科,54,25,29,群益金鼎-桃園,2024-07-05,9189
2603,長榮,34,5,29,群益金鼎-桃園,2024-07-05,9189
00948B,中信優息投資級債,40,12,28,群益金鼎-桃園,2024-07-05,9189
00679B,元大美債20年,37,9,28,群益金鼎-桃園,2024-07-05,9189
00882,中信中國高股息,36,10,26,群益金鼎-桃園,2024-07-05,9189
1711,永光,41,17,24,群益金鼎-桃園,2024-07-05,9189
2409,友達,52,30,22,群益金鼎-桃園,2024-07-05,9189
6169,昱泉,22,0,22,群益金鼎-桃園,2024-07-05,9189
3494,誠研,22,0,22,群益金鼎-桃園,2024-07-05,9189
2615,萬海,26,4,22,群益金鼎-桃園,2024-07-05,9189
2392,正崴,25,3,22,群益金鼎-桃園,2024-07-05,9189
2882,國泰金,22,1,21,群益金鼎-桃園,2024-07-05,9189
2889,國票金,21,0,21,群益金鼎-桃園,2024-07-05,9189
3219,倚強科,21,0,21,群益金鼎-桃園,2024-07-05,9189
2352,佳世達,20,0,20,群益金鼎-桃園,2024-07-05,9189
4976,佳凌,40,20,20,群益金鼎-桃園,2024-07-05,9189
2614,東森,20,1,19,群益金鼎-桃園,2024-07-05,9189
6957,裕慶-KY,20,2,18,群益金鼎-桃園,2024-07-05,9189
8107,大億金茂,20,2,18,群益金鼎-桃園,2024-07-05,9189
3663,鑫科,30,12,18,群益金鼎-桃園,2024-07-05,9189
2104,國際中橡,17,0,17,群益金鼎-桃園,2024-07-05,9189
2481,強茂,23,7,16,群益金鼎-桃園,2024-07-05,9189
00937B,群益ESG投等債20,56,40,16,群益金鼎-桃園,2024-07-05,9189
3005,神基,27,12,15,群益金鼎-桃園,2024-07-05,9189
1464,得力,15,0,15,群益金鼎-桃園,2024-07-05,9189
8440,綠電,15,0,15,群益金鼎-桃園,2024-07-05,9189
4540,全球傳動,16,1,15,群益金鼎-桃園,2024-07-05,9189
00752,中信中國50,15,0,15,群益金鼎-桃園,2024-07-05,9189
2301,光寶科,17,3,14,群益金鼎-桃園,2024-07-05,9189
2303,聯電,16,2,14,群益金鼎-桃園,2024-07-05,9189
00935,野村臺灣新科技50,14,0,14,群益金鼎-桃園,2024-07-05,9189
2405,輔信,35,21,14,群益金鼎-桃園,2024-07-05,9189
6127,九豪,27,13,14,群益金鼎-桃園,2024-07-05,9189
0056,元大高股息,42,28,14,群益金鼎-桃園,2024-07-05,9189
3105,穩懋,15,2,13,群益金鼎-桃園,2024-07-05,9189
1532,勤美,13,0,13,群益金鼎-桃園,2024-07-05,9189
1314,中石化,40,27,13,群益金鼎-桃園,2024-07-05,9189
00686R,群益臺灣加權反1,201,0,201,群益金鼎-桃園,2024-07-08,9189
00934,中信成長高股息,127,6,121,群益金鼎-桃園,2024-07-08,9189
00929,復華台灣科技優息,139,35,104,群益金鼎-桃園,2024-07-08,9189
3231,緯創,96,34,62,群益金鼎-桃園,2024-07-08,9189
2618,長榮航,55,4,51,群益金鼎-桃園,2024-07-08,9189
00753L,中信中國50正2,50,2,48,群益金鼎-桃園,2024-07-08,9189
8076,伍豐,39,0,39,群益金鼎-桃園,2024-07-08,9189
6153,嘉聯益,72,38,34,群益金鼎-桃園,2024-07-08,9189
8429,金麗-KY,33,0,33,群益金鼎-桃園,2024-07-08,9189
2464,盟立,94,64,30,群益金鼎-桃園,2024-07-08,9189
3576,聯合再生,30,1,29,群益金鼎-桃園,2024-07-08,9189
6126,信音,39,11,28,群益金鼎-桃園,2024-07-08,9189
3498,陽程,33,5,28,群益金鼎-桃園,2024-07-08,9189
00632R,元大台灣50反1,96,70,26,群益金鼎-桃園,2024-07-08,9189
2104,國際中橡,25,0,25,群益金鼎-桃園,2024-07-08,9189
1536,和大,62,37,25,群益金鼎-桃園,2024-07-08,9189
1409,新纖,30,5,25,群益金鼎-桃園,2024-07-08,9189
2637,慧洋-KY,23,0,23,群益金鼎-桃園,2024-07-08,9189
00757,統一FANG+,22,0,22,群益金鼎-桃園,2024-07-08,9189
1513,中興電,34,12,22,群益金鼎-桃園,2024-07-08,9189
00915,凱基優選高股息30,22,0,22,群益金鼎-桃園,2024-07-08,9189
6269,台郡,27,5,22,群益金鼎-桃園,2024-07-08,9189
1504,東元,21,0,21,群益金鼎-桃園,2024-07-08,9189
1605,華新,22,1,21,群益金鼎-桃園,2024-07-08,9189
00679B,元大美債20年,23,2,21,群益金鼎-桃園,2024-07-08,9189
3481,群創,92,72,20,群益金鼎-桃園,2024-07-08,9189
1785,光洋科,82,62,20,群益金鼎-桃園,2024-07-08,9189
6213,聯茂,21,1,20,群益金鼎-桃園,2024-07-08,9189
5530,龍巖,20,0,20,群益金鼎-桃園,2024-07-08,9189
00933B,國泰10Y+金融債,23,3,20,群益金鼎-桃園,2024-07-08,9189
2609,陽明,62,43,19,群益金鼎-桃園,2024-07-08,9189
1304,台聚,20,1,19,群益金鼎-桃園,2024-07-08,9189
3045,台灣大,18,0,18,群益金鼎-桃園,2024-07-08,9189
8071,能率網通,20,2,18,群益金鼎-桃園,2024-07-08,9189
2344,華邦電,20,2,18,群益金鼎-桃園,2024-07-08,9189
2371,大同,47,29,18,群益金鼎-桃園,2024-07-08,9189
00939,統一台灣高息動能,22,5,17,群益金鼎-桃園,2024-07-08,9189
2377,微星,20,3,17,群益金鼎-桃園,2024-07-08,9189
1528,恩德,18,1,17,群益金鼎-桃園,2024-07-08,9189
4543,萬在,23,6,17,群益金鼎-桃園,2024-07-08,9189
1815,富喬,17,1,16,群益金鼎-桃園,2024-07-08,9189
5328,華容,28,12,16,群益金鼎-桃園,2024-07-08,9189
6446,藥華藥,18,3,15,群益金鼎-桃園,2024-07-08,9189
5460,同協,15,0,15,群益金鼎-桃園,2024-07-08,9189
6538,倉和,15,0,15,群益金鼎-桃園,2024-07-08,9189
6160,欣技,16,1,15,群益金鼎-桃園,2024-07-08,9189
8064,東捷,53,38,15,群益金鼎-桃園,2024-07-08,9189
6217,中探針,25,10,15,群益金鼎-桃園,2024-07-08,9189
2882,國泰金,40,26,14,群益金鼎-桃園,2024-07-08,9189
6133,金橋,14,0,14,群益金鼎-桃園,2024-07-08,9189
3229,晟鈦,112,4,108,群益金鼎-桃園,2024-07-09,9189
3062,建漢,133,25,108,群益金鼎-桃園,2024-07-09,9189
4510,高鋒,133,31,102,群益金鼎-桃園,2024-07-09,9189
9105,泰金寶-DR,138,37,101,群益金鼎-桃園,2024-07-09,9189
2312,金寶,511,424,87,群益金鼎-桃園,2024-07-09,9189
3494,誠研,85,0,85,群益金鼎-桃園,2024-07-09,9189
2801,彰銀,80,0,80,群益金鼎-桃園,2024-07-09,9189
3231,緯創,83,14,69,群益金鼎-桃園,2024-07-09,9189
2353,宏��,55,2,53,群益金鼎-桃園,2024-07-09,9189
6005,群益證,53,0,53,群益金鼎-桃園,2024-07-09,9189
1314,中石化,51,1,50,群益金鼎-桃園,2024-07-09,9189
2609,陽明,79,29,50,群益金鼎-桃園,2024-07-09,9189
5324,士開,50,0,50,群益金鼎-桃園,2024-07-09,9189
2834,臺企銀,59,11,48,群益金鼎-桃園,2024-07-09,9189
00944,野村趨勢動能高息,46,0,46,群益金鼎-桃園,2024-07-09,9189
00878,國泰永續高股息,50,8,42,群益金鼎-桃園,2024-07-09,9189
2323,中環,38,0,38,群益金鼎-桃園,2024-07-09,9189
2882,國泰金,37,1,36,群益金鼎-桃園,2024-07-09,9189
2349,錸德,53,18,35,群益金鼎-桃園,2024-07-09,9189
2543,皇昌,36,2,34,群益金鼎-桃園,2024-07-09,9189
2354,鴻準,48,16,32,群益金鼎-桃園,2024-07-09,9189
5452,佶優,35,3,32,群益金鼎-桃園,2024-07-09,9189
2883,凱基金,51,20,31,群益金鼎-桃園,2024-07-09,9189
5309,系統電,59,28,31,群益金鼎-桃園,2024-07-09,9189
3005,神基,32,1,31,群益金鼎-桃園,2024-07-09,9189
2618,長榮航,51,22,29,群益金鼎-桃園,2024-07-09,9189
00947,台新臺灣IC設計,30,3,27,群益金鼎-桃園,2024-07-09,9189
6217,中探針,29,2,27,群益金鼎-桃園,2024-07-09,9189
6016,康和證,28,2,26,群益金鼎-桃園,2024-07-09,9189
4545,銘鈺,26,0,26,群益金鼎-桃園,2024-07-09,9189
00927,群益半導體收益,24,0,24,群益金鼎-桃園,2024-07-09,9189
3450,聯鈞,32,9,23,群益金鼎-桃園,2024-07-09,9189
00937B,群益ESG投等債20,88,65,23,群益金鼎-桃園,2024-07-09,9189
2402,毅嘉,31,9,22,群益金鼎-桃園,2024-07-09,9189
3706,神達,26,4,22,群益金鼎-桃園,2024-07-09,9189
00936,台新永續高息中小,32,11,21,群益金鼎-桃園,2024-07-09,9189
2338,光罩,22,1,21,群益金鼎-桃園,2024-07-09,9189
4114,健喬,20,0,20,群益金鼎-桃園,2024-07-09,9189
1471,首利,20,0,20,群益金鼎-桃園,2024-07-09,9189
1528,恩德,28,8,20,群益金鼎-桃園,2024-07-09,9189
00934,中信成長高股息,33,14,19,群益金鼎-桃園,2024-07-09,9189
00751B,元大AAA至A公司債,20,1,19,群益金鼎-桃園,2024-07-09,9189
00905,FT臺灣Smart,21,2,19,群益金鼎-桃園,2024-07-09,9189
8429,金麗-KY,18,0,18,群益金鼎-桃園,2024-07-09,9189
2474,可成,18,0,18,群益金鼎-桃園,2024-07-09,9189
1618,合機,41,24,17,群益金鼎-桃園,2024-07-09,9189
00946,群益科技高息成長,16,0,16,群益金鼎-桃園,2024-07-09,9189
9958,世紀鋼,31,15,16,群益金鼎-桃園,2024-07-09,9189
9945,潤泰新,16,0,16,群益金鼎-桃園,2024-07-09,9189
6169,昱泉,16,0,16,群益金鼎-桃園,2024-07-09,9189
00937B,群益ESG投等債20,176,5,171,群益金鼎-桃園,2024-07-10,9189
6116,彩晶,158,5,153,群益金鼎-桃園,2024-07-10,9189
1312,國喬,116,0,116,群益金鼎-桃園,2024-07-10,9189
2406,國碩,107,10,97,群益金鼎-桃園,2024-07-10,9189
2610,華航,102,16,86,群益金鼎-桃園,2024-07-10,9189
2002,中鋼,62,0,62,群益金鼎-桃園,2024-07-10,9189
3265,台星科,57,1,56,群益金鼎-桃園,2024-07-10,9189
1809,中釉,84,30,54,群益金鼎-桃園,2024-07-10,9189
00680L,元大美債20正2,53,0,53,群益金鼎-桃園,2024-07-10,9189
00934,中信成長高股息,54,4,50,群益金鼎-桃園,2024-07-10,9189
1337,再生-KY,50,0,50,群益金鼎-桃園,2024-07-10,9189
1529,樂事綠能,40,0,40,群益金鼎-桃園,2024-07-10,9189
2485,兆赫,37,0,37,群益金鼎-桃園,2024-07-10,9189
00679B,元大美債20年,37,0,37,群益金鼎-桃園,2024-07-10,9189
00929,復華台灣科技優息,51,16,35,群益金鼎-桃園,2024-07-10,9189
2367,燿華,62,30,32,群益金鼎-桃園,2024-07-10,9189
2317,鴻海,46,17,29,群益金鼎-桃園,2024-07-10,9189
2374,佳能,30,1,29,群益金鼎-桃園,2024-07-10,9189
3229,晟鈦,27,0,27,群益金鼎-桃園,2024-07-10,9189
9933,中鼎,27,0,27,群益金鼎-桃園,2024-07-10,9189
3162,精確,42,17,25,群益金鼎-桃園,2024-07-10,9189
3706,神達,35,11,24,群益金鼎-桃園,2024-07-10,9189
2886,兆豐金,24,0,24,群益金鼎-桃園,2024-07-10,9189
5880,合庫金,22,0,22,群益金鼎-桃園,2024-07-10,9189
1303,南亞,22,0,22,群益金鼎-桃園,2024-07-10,9189
5426,振發,23,1,22,群益金鼎-桃園,2024-07-10,9189
6217,中探針,22,0,22,群益金鼎-桃園,2024-07-10,9189
3580,友威科,23,1,22,群益金鼎-桃園,2024-07-10,9189
2427,三商電,26,4,22,群益金鼎-桃園,2024-07-10,9189
6584,南俊國際,21,0,21,群益金鼎-桃園,2024-07-10,9189
8071,能率網通,30,9,21,群益金鼎-桃園,2024-07-10,9189
3060,銘異,21,0,21,群益金鼎-桃園,2024-07-10,9189
2801,彰銀,20,0,20,群益金鼎-桃園,2024-07-10,9189
5512,力麒,22,2,20,群益金鼎-桃園,2024-07-10,9189
2834,臺企銀,23,3,20,群益金鼎-桃園,2024-07-10,9189
2392,正崴,105,85,20,群益金鼎-桃園,2024-07-10,9189
3481,群創,46,27,19,群益金鼎-桃園,2024-07-10,9189
6118,建達,20,1,19,群益金鼎-桃園,2024-07-10,9189
00949,復華日本龍頭,19,1,18,群益金鼎-桃園,2024-07-10,9189
2303,聯電,33,15,18,群益金鼎-桃園,2024-07-10,9189
3047,訊舟,129,111,18,群益金鼎-桃園,2024-07-10,9189
00945B,凱基美國非投等債,17,0,17,群益金鼎-桃園,2024-07-10,9189
00878,國泰永續高股息,29,12,17,群益金鼎-桃園,2024-07-10,9189
3498,陽程,22,6,16,群益金鼎-桃園,2024-07-10,9189
00632R,元大台灣50反1,24,8,16,群益金鼎-桃園,2024-07-10,9189
00936,台新永續高息中小,15,0,15,群益金鼎-桃園,2024-07-10,9189
5309,系統電,40,25,15,群益金鼎-桃園,2024-07-10,9189
00687B,國泰20年美債,18,3,15,群益金鼎-桃園,2024-07-10,9189
2344,華邦電,16,1,15,群益金鼎-桃園,2024-07-10,9189
3508,位速,15,0,15,群益金鼎-桃園,2024-07-10,9189
00632R,元大台灣50反1,1214,30,1184,群益金鼎-桃園,2024-07-11,9189
00680L,元大美債20正2,243,1,242,群益金鼎-桃園,2024-07-11,9189
1714,和桐,112,5,107,群益金鼎-桃園,2024-07-11,9189
6116,彩晶,106,13,93,群益金鼎-桃園,2024-07-11,9189
00934,中信成長高股息,110,34,76,群益金鼎-桃園,2024-07-11,9189
2891,中信金,90,16,74,群益金鼎-桃園,2024-07-11,9189
3576,聯合再生,61,5,56,群益金鼎-桃園,2024-07-11,9189
00945B,凱基美國非投等債,55,0,55,群益金鼎-桃園,2024-07-11,9189
2888,新光金,166,114,52,群益金鼎-桃園,2024-07-11,9189
2349,錸德,88,45,43,群益金鼎-桃園,2024-07-11,9189
5202,力新,38,1,37,群益金鼎-桃園,2024-07-11,9189
2353,宏��,73,39,34,群益金鼎-桃園,2024-07-11,9189
00687B,國泰20年美債,33,3,30,群益金鼎-桃園,2024-07-11,9189
6118,建達,27,1,26,群益金鼎-桃園,2024-07-11,9189
5426,振發,30,5,25,群益金鼎-桃園,2024-07-11,9189
4545,銘鈺,23,0,23,群益金鼎-桃園,2024-07-11,9189
00927,群益半導體收益,24,1,23,群益金鼎-桃園,2024-07-11,9189
6239,力成,23,0,23,群益金鼎-桃園,2024-07-11,9189
1785,光洋科,47,24,23,群益金鼎-桃園,2024-07-11,9189
2453,凌群,27,5,22,群益金鼎-桃園,2024-07-11,9189
2449,京元電子,27,5,22,群益金鼎-桃園,2024-07-11,9189
3229,晟鈦,33,11,22,群益金鼎-桃園,2024-07-11,9189
00946,群益科技高息成長,21,0,21,群益金鼎-桃園,2024-07-11,9189
00932,兆豐永續高息等權,20,0,20,群益金鼎-桃園,2024-07-11,9189
4306,炎洲,24,5,19,群益金鼎-桃園,2024-07-11,9189
6127,九豪,36,17,19,群益金鼎-桃園,2024-07-11,9189
2374,佳能,23,4,19,群益金鼎-桃園,2024-07-11,9189
6005,群益證,18,0,18,群益金鼎-桃園,2024-07-11,9189
2464,盟立,39,22,17,群益金鼎-桃園,2024-07-11,9189
00882,中信中國高股息,17,0,17,群益金鼎-桃園,2024-07-11,9189
1609,大亞,21,4,17,群益金鼎-桃園,2024-07-11,9189
2376,技嘉,21,5,16,群益金鼎-桃園,2024-07-11,9189
1582,信錦,16,0,16,群益金鼎-桃園,2024-07-11,9189
00725B,國泰投資級公司債,16,0,16,群益金鼎-桃園,2024-07-11,9189
2371,大同,48,32,16,群益金鼎-桃園,2024-07-11,9189
2382,廣達,21,5,16,群益金鼎-桃園,2024-07-11,9189
1303,南亞,15,0,15,群益金鼎-桃園,2024-07-11,9189
4414,如興,15,0,15,群益金鼎-桃園,2024-07-11,9189
1809,中釉,22,7,15,群益金鼎-桃園,2024-07-11,9189
6461,益得,15,0,15,群益金鼎-桃園,2024-07-11,9189
00936,台新永續高息中小,16,2,14,群益金鼎-桃園,2024-07-11,9189
5484,慧友,18,4,14,群益金鼎-桃園,2024-07-11,9189
4113,聯上,15,1,14,群益金鼎-桃園,2024-07-11,9189
2328,廣宇,13,0,13,群益金鼎-桃園,2024-07-11,9189
2367,燿華,30,17,13,群益金鼎-桃園,2024-07-11,9189
0056,元大高股息,14,1,13,群益金鼎-桃園,2024-07-11,9189
2365,昆盈,75,62,13,群益金鼎-桃園,2024-07-11,9189
1514,亞力,34,22,12,群益金鼎-桃園,2024-07-11,9189
2002,中鋼,13,1,12,群益金鼎-桃園,2024-07-11,9189
1503,士電,12,0,12,群益金鼎-桃園,2024-07-11,9189
00929,復華台灣科技優息,218,54,164,群益金鼎-桃園,2024-07-12,9189
2801,彰銀,160,6,154,群益金鼎-桃園,2024-07-12,9189
2303,聯電,122,15,107,群益金鼎-桃園,2024-07-12,9189
2317,鴻海,126,31,95,群益金鼎-桃園,2024-07-12,9189
00919,群益台灣精選高息,119,35,84,群益金鼎-桃園,2024-07-12,9189
2365,昆盈,124,55,69,群益金鼎-桃園,2024-07-12,9189
00934,中信成長高股息,122,61,61,群益金鼎-桃園,2024-07-12,9189
1815,富喬,66,13,53,群益金鼎-桃園,2024-07-12,9189
2889,國票金,64,11,53,群益金鼎-桃園,2024-07-12,9189
00946,群益科技高息成長,52,1,51,群益金鼎-桃園,2024-07-12,9189
00940,元大台灣價值高息,93,43,50,群益金鼎-桃園,2024-07-12,9189
00927,群益半導體收益,48,2,46,群益金鼎-桃園,2024-07-12,9189
2338,光罩,42,1,41,群益金鼎-桃園,2024-07-12,9189
6603,富強鑫,43,2,41,群益金鼎-桃園,2024-07-12,9189
00878,國泰永續高股息,40,2,38,群益金鼎-桃園,2024-07-12,9189
3047,訊舟,81,46,35,群益金鼎-桃園,2024-07-12,9189
2609,陽明,36,1,35,群益金鼎-桃園,2024-07-12,9189
2312,金寶,177,145,32,群益金鼎-桃園,2024-07-12,9189
00680L,元大美債20正2,91,60,31,群益金鼎-桃園,2024-07-12,9189
00948B,中信優息投資級債,31,0,31,群益金鼎-桃園,2024-07-12,9189
2330,台積電,35,5,30,群益金鼎-桃園,2024-07-12,9189
4534,慶騰,29,0,29,群益金鼎-桃園,2024-07-12,9189
3712,永崴投控,41,12,29,群益金鼎-桃園,2024-07-12,9189
1536,和大,48,20,28,群益金鼎-桃園,2024-07-12,9189
1569,濱川,35,8,27,群益金鼎-桃園,2024-07-12,9189
9105,泰金寶-DR,50,23,27,群益金鼎-桃園,2024-07-12,9189
5328,華容,35,8,27,群益金鼎-桃園,2024-07-12,9189
1785,光洋科,41,16,25,群益金鼎-桃園,2024-07-12,9189
00923,群益台ESG低碳50,24,0,24,群益金鼎-桃園,2024-07-12,9189
1532,勤美,22,0,22,群益金鼎-桃園,2024-07-12,9189
6005,群益證,22,0,22,群益金鼎-桃園,2024-07-12,9189
8064,東捷,126,105,21,群益金鼎-桃園,2024-07-12,9189
2367,燿華,27,7,20,群益金鼎-桃園,2024-07-12,9189
1110,東泥,20,0,20,群益金鼎-桃園,2024-07-12,9189
3376,新日興,23,3,20,群益金鼎-桃園,2024-07-12,9189
00751B,元大AAA至A公司債,20,0,20,群益金鼎-桃園,2024-07-12,9189
2610,華航,27,8,19,群益金鼎-桃園,2024-07-12,9189
2476,鉅祥,21,3,18,群益金鼎-桃園,2024-07-12,9189
00920,富邦ESG綠色電力,17,0,17,群益金鼎-桃園,2024-07-12,9189
9933,中鼎,18,1,17,群益金鼎-桃園,2024-07-12,9189
2867,三商壽,29,13,16,群益金鼎-桃園,2024-07-12,9189
3710,連展投控,15,0,15,群益金鼎-桃園,2024-07-12,9189
3294,英濟,15,0,15,群益金鼎-桃園,2024-07-12,9189
2353,宏��,18,4,14,群益金鼎-桃園,2024-07-12,9189
2618,長榮航,15,1,14,群益金鼎-桃園,2024-07-12,9189
1312,國喬,14,0,14,群益金鼎-桃園,2024-07-12,9189
3019,亞光,23,10,13,群益金鼎-桃園,2024-07-12,9189
5443,均豪,18,5,13,群益金鼎-桃園,2024-07-12,9189
2882,國泰金,16,3,13,群益金鼎-桃園,2024-07-12,9189
00905,FT臺灣Smart,16,3,13,群益金鼎-桃園,2024-07-12,9189
00632R,元大台灣50反1,640,23,617,群益金鼎-桃園,2024-07-15,9189
00664R,國泰臺灣加權反1,300,0,300,群益金鼎-桃園,2024-07-15,9189
3630,新鉅科,180,0,180,群益金鼎-桃園,2024-07-15,9189
00934,中信成長高股息,149,5,144,群益金鼎-桃園,2024-07-15,9189
00680L,元大美債20正2,115,0,115,群益金鼎-桃園,2024-07-15,9189
00945B,凱基美國非投等債,108,0,108,群益金鼎-桃園,2024-07-15,9189
00665L,富邦�琤肭磪囓�2,100,1,99,群益金鼎-桃園,2024-07-15,9189
00937B,群益ESG投等債20,278,195,83,群益金鼎-桃園,2024-07-15,9189
2891,中信金,107,28,79,群益金鼎-桃園,2024-07-15,9189
2312,金寶,318,242,76,群益金鼎-桃園,2024-07-15,9189
1591,駿吉-KY,75,0,75,群益金鼎-桃園,2024-07-15,9189
2618,長榮航,85,30,55,群益金鼎-桃園,2024-07-15,9189
2610,華航,56,2,54,群益金鼎-桃園,2024-07-15,9189
2801,彰銀,50,0,50,群益金鼎-桃園,2024-07-15,9189
2323,中環,47,0,47,群益金鼎-桃園,2024-07-15,9189
2883,凱基金,61,14,47,群益金鼎-桃園,2024-07-15,9189
3481,群創,99,63,36,群益金鼎-桃園,2024-07-15,9189
2915,潤泰全,34,0,34,群益金鼎-桃園,2024-07-15,9189
2409,友達,246,212,34,群益金鼎-桃園,2024-07-15,9189
5381,合正,34,1,33,群益金鼎-桃園,2024-07-15,9189
2317,鴻海,44,11,33,群益金鼎-桃園,2024-07-15,9189
00919,群益台灣精選高息,33,1,32,群益金鼎-桃園,2024-07-15,9189
6142,友勁,30,0,30,群益金鼎-桃園,2024-07-15,9189
2367,燿華,36,7,29,群益金鼎-桃園,2024-07-15,9189
2313,華通,30,1,29,群益金鼎-桃園,2024-07-15,9189
1304,台聚,28,0,28,群益金鼎-桃園,2024-07-15,9189
0056,元大高股息,29,3,26,群益金鼎-桃園,2024-07-15,9189
2356,英業達,47,21,26,群益金鼎-桃園,2024-07-15,9189
6005,群益證,24,0,24,群益金鼎-桃園,2024-07-15,9189
1785,光洋科,48,25,23,群益金鼎-桃園,2024-07-15,9189
5328,華容,22,0,22,群益金鼎-桃園,2024-07-15,9189
1101,台泥,21,0,21,群益金鼎-桃園,2024-07-15,9189
4545,銘鈺,21,0,21,群益金鼎-桃園,2024-07-15,9189
00679B,元大美債20年,21,1,20,群益金鼎-桃園,2024-07-15,9189
5519,隆大,20,0,20,群益金鼎-桃園,2024-07-15,9189
2913,農林,20,0,20,群益金鼎-桃園,2024-07-15,9189
4532,瑞智,21,2,19,群益金鼎-桃園,2024-07-15,9189
2498,宏達電,19,0,19,群益金鼎-桃園,2024-07-15,9189
00687B,國泰20年美債,20,1,19,群益金鼎-桃園,2024-07-15,9189
1809,中釉,21,3,18,群益金鼎-桃園,2024-07-15,9189
3128,昇銳,18,0,18,群益金鼎-桃園,2024-07-15,9189
4513,福裕,19,1,18,群益金鼎-桃園,2024-07-15,9189
3715,定穎投控,19,2,17,群益金鼎-桃園,2024-07-15,9189
1608,華榮,41,24,17,群益金鼎-桃園,2024-07-15,9189
8210,勤誠,21,6,15,群益金鼎-桃園,2024-07-15,9189
2344,華邦電,16,1,15,群益金鼎-桃園,2024-07-15,9189
2884,玉山金,18,3,15,群益金鼎-桃園,2024-07-15,9189
2405,輔信,28,13,15,群益金鼎-桃園,2024-07-15,9189
1536,和大,58,44,14,群益金鼎-桃園,2024-07-15,9189
1609,大亞,53,39,14,群益金鼎-桃園,2024-07-15,9189
00933B,國泰10Y+金融債,196,0,196,群益金鼎-桃園,2024-07-16,9189
00664R,國泰臺灣加權反1,175,0,175,群益金鼎-桃園,2024-07-16,9189
2801,彰銀,131,21,110,群益金鼎-桃園,2024-07-16,9189
0056,元大高股息,101,9,92,群益金鼎-桃園,2024-07-16,9189
00929,復華台灣科技優息,71,4,67,群益金鼎-桃園,2024-07-16,9189
1540,喬福,72,14,58,群益金鼎-桃園,2024-07-16,9189
3071,協禧,50,0,50,群益金鼎-桃園,2024-07-16,9189
6127,九豪,49,1,48,群益金鼎-桃園,2024-07-16,9189
2891,中信金,53,6,47,群益金鼎-桃園,2024-07-16,9189
00665L,富邦�琤肭磪囓�2,55,10,45,群益金鼎-桃園,2024-07-16,9189
6005,群益證,37,0,37,群益金鼎-桃園,2024-07-16,9189
6592,和潤企業,40,3,37,群益金鼎-桃園,2024-07-16,9189
00632R,元大台灣50反1,36,0,36,群益金鼎-桃園,2024-07-16,9189
2312,金寶,58,22,36,群益金鼎-桃園,2024-07-16,9189
00905,FT臺灣Smart,34,0,34,群益金鼎-桃園,2024-07-16,9189
00945B,凱基美國非投等債,31,0,31,群益金鼎-桃園,2024-07-16,9189
00882,中信中國高股息,30,0,30,群益金鼎-桃園,2024-07-16,9189
00937B,群益ESG投等債20,56,26,30,群益金鼎-桃園,2024-07-16,9189
1513,中興電,39,13,26,群益金鼎-桃園,2024-07-16,9189
1609,大亞,54,28,26,群益金鼎-桃園,2024-07-16,9189
4109,加捷生醫,33,8,25,群益金鼎-桃園,2024-07-16,9189
00795B,中信美國公債20年,24,0,24,群益金鼎-桃園,2024-07-16,9189
6684,安格,50,26,24,群益金鼎-桃園,2024-07-16,9189
00751B,元大AAA至A公司債,23,0,23,群益金鼎-桃園,2024-07-16,9189
1471,首利,23,0,23,群益金鼎-桃園,2024-07-16,9189
3290,東浦,24,2,22,群益金鼎-桃園,2024-07-16,9189
5443,均豪,40,19,21,群益金鼎-桃園,2024-07-16,9189
9105,泰金寶-DR,36,16,20,群益金鼎-桃園,2024-07-16,9189
1714,和桐,20,0,20,群益金鼎-桃園,2024-07-16,9189
00753L,中信中國50正2,20,0,20,群益金鼎-桃園,2024-07-16,9189
00934,中信成長高股息,20,1,19,群益金鼎-桃園,2024-07-16,9189
2392,正崴,22,3,19,群益金鼎-桃園,2024-07-16,9189
00948B,中信優息投資級債,19,0,19,群益金鼎-桃園,2024-07-16,9189
4510,高鋒,18,0,18,群益金鼎-桃園,2024-07-16,9189
2317,鴻海,31,14,17,群益金鼎-桃園,2024-07-16,9189
3189,景碩,33,18,15,群益金鼎-桃園,2024-07-16,9189
00927,群益半導體收益,16,2,14,群益金鼎-桃園,2024-07-16,9189
2338,光罩,18,4,14,群益金鼎-桃園,2024-07-16,9189
2353,宏��,15,1,14,群益金鼎-桃園,2024-07-16,9189
1316,上曜,34,21,13,群益金鼎-桃園,2024-07-16,9189
5426,振發,53,40,13,群益金鼎-桃園,2024-07-16,9189
2609,陽明,18,6,12,群益金鼎-桃園,2024-07-16,9189
2501,國建,12,0,12,群益金鼎-桃園,2024-07-16,9189
2367,燿華,16,5,11,群益金鼎-桃園,2024-07-16,9189
3715,定穎投控,11,0,11,群益金鼎-桃園,2024-07-16,9189
2303,聯電,21,10,11,群益金鼎-桃園,2024-07-16,9189
5876,上海商銀,11,0,11,群益金鼎-桃園,2024-07-16,9189
2363,矽統,19,9,10,群益金鼎-桃園,2024-07-16,9189
6129,普誠,10,0,10,群益金鼎-桃園,2024-07-16,9189
00733,富邦臺灣中小,10,0,10,群益金鼎-桃園,2024-07-16,9189
00720B,元大投資級公司債,475,1,474,群益金鼎-桃園,2024-07-17,9189
00680L,元大美債20正2,208,68,140,群益金鼎-桃園,2024-07-17,9189
00919,群益台灣精選高息,135,24,111,群益金鼎-桃園,2024-07-17,9189
2881,富邦金,82,1,81,群益金鼎-桃園,2024-07-17,9189
00937B,群益ESG投等債20,91,11,80,群益金鼎-桃園,2024-07-17,9189
00946,群益科技高息成長,99,20,79,群益金鼎-桃園,2024-07-17,9189
00929,復華台灣科技優息,104,27,77,群益金鼎-桃園,2024-07-17,9189
6116,彩晶,59,0,59,群益金鼎-桃園,2024-07-17,9189
2891,中信金,56,0,56,群益金鼎-桃園,2024-07-17,9189
2867,三商壽,51,5,46,群益金鼎-桃園,2024-07-17,9189
8096,擎亞,61,18,43,群益金鼎-桃園,2024-07-17,9189
2367,燿華,72,30,42,群益金鼎-桃園,2024-07-17,9189
00641R,富邦日本反1,40,0,40,群益金鼎-桃園,2024-07-17,9189
1409,新纖,49,12,37,群益金鼎-桃園,2024-07-17,9189
2323,中環,54,19,35,群益金鼎-桃園,2024-07-17,9189
2330,台積電,36,1,35,群益金鼎-桃園,2024-07-17,9189
2845,遠東銀,32,0,32,群益金鼎-桃園,2024-07-17,9189
6244,茂迪,33,2,31,群益金鼎-桃園,2024-07-17,9189
00679B,元大美債20年,41,11,30,群益金鼎-桃園,2024-07-17,9189
00923,群益台ESG低碳50,40,10,30,群益金鼎-桃園,2024-07-17,9189
0056,元大高股息,28,0,28,群益金鼎-桃園,2024-07-17,9189
4906,正文,27,3,24,群益金鼎-桃園,2024-07-17,9189
5328,華容,26,2,24,群益金鼎-桃園,2024-07-17,9189
6173,信昌電,28,4,24,群益金鼎-桃園,2024-07-17,9189
2609,陽明,40,17,23,群益金鼎-桃園,2024-07-17,9189
1536,和大,38,15,23,群益金鼎-桃園,2024-07-17,9189
6770,力積電,48,25,23,群益金鼎-桃園,2024-07-17,9189
2023,燁輝,30,8,22,群益金鼎-桃園,2024-07-17,9189
1524,耿鼎,22,0,22,群益金鼎-桃園,2024-07-17,9189
2408,南亞科,22,1,21,群益金鼎-桃園,2024-07-17,9189
3042,晶技,22,1,21,群益金鼎-桃園,2024-07-17,9189
2884,玉山金,25,4,21,群益金鼎-桃園,2024-07-17,9189
1513,中興電,39,19,20,群益金鼎-桃園,2024-07-17,9189
00918,大華優利高填息30,20,0,20,群益金鼎-桃園,2024-07-17,9189
6265,方土昶,20,0,20,群益金鼎-桃園,2024-07-17,9189
2603,長榮,24,4,20,群益金鼎-桃園,2024-07-17,9189
8044,網家,20,0,20,群益金鼎-桃園,2024-07-17,9189
2801,彰銀,20,0,20,群益金鼎-桃園,2024-07-17,9189
3231,緯創,33,14,19,群益金鼎-桃園,2024-07-17,9189
00948B,中信優息投資級債,19,0,19,群益金鼎-桃園,2024-07-17,9189
2474,可成,19,0,19,群益金鼎-桃園,2024-07-17,9189
2301,光寶科,23,6,17,群益金鼎-桃園,2024-07-17,9189
3019,亞光,34,17,17,群益金鼎-桃園,2024-07-17,9189
1584,精剛,17,0,17,群益金鼎-桃園,2024-07-17,9189
2359,所羅門,50,33,17,群益金鼎-桃園,2024-07-17,9189
3094,聯傑,18,2,16,群益金鼎-桃園,2024-07-17,9189
00688L,國泰20年美債正2,16,0,16,群益金鼎-桃園,2024-07-17,9189
2915,潤泰全,24,9,15,群益金鼎-桃園,2024-07-17,9189
6179,亞通,15,0,15,群益金鼎-桃園,2024-07-17,9189
2353,宏��,16,1,15,群益金鼎-桃園,2024-07-17,9189
00632R,元大台灣50反1,473,194,279,群益金鼎-桃園,2024-07-18,9189
00934,中信成長高股息,141,0,141,群益金鼎-桃園,2024-07-18,9189
00919,群益台灣精選高息,141,14,127,群益金鼎-桃園,2024-07-18,9189
1611,中電,79,6,73,群益金鼎-桃園,2024-07-18,9189
2367,燿華,75,9,66,群益金鼎-桃園,2024-07-18,9189
00929,復華台灣科技優息,170,106,64,群益金鼎-桃園,2024-07-18,9189
2330,台積電,63,5,58,群益金鼎-桃園,2024-07-18,9189
00933B,國泰10Y+金融債,65,12,53,群益金鼎-桃園,2024-07-18,9189
6443,元晶,51,0,51,群益金鼎-桃園,2024-07-18,9189
2867,三商壽,50,0,50,群益金鼎-桃園,2024-07-18,9189
2356,英業達,49,3,46,群益金鼎-桃園,2024-07-18,9189
1540,喬福,53,8,45,群益金鼎-桃園,2024-07-18,9189
2610,華航,42,0,42,群益金鼎-桃園,2024-07-18,9189
00878,國泰永續高股息,36,0,36,群益金鼎-桃園,2024-07-18,9189
2881,富邦金,41,6,35,群益金鼎-桃園,2024-07-18,9189
00687B,國泰20年美債,34,0,34,群益金鼎-桃園,2024-07-18,9189
2382,廣達,38,4,34,群益金鼎-桃園,2024-07-18,9189
2365,昆盈,143,111,32,群益金鼎-桃園,2024-07-18,9189
0056,元大高股息,37,6,31,群益金鼎-桃園,2024-07-18,9189
00679B,元大美債20年,67,37,30,群益金鼎-桃園,2024-07-18,9189
1455,集盛,30,0,30,群益金鼎-桃園,2024-07-18,9189
4909,新復興,38,9,29,群益金鼎-桃園,2024-07-18,9189
6125,廣運,39,13,26,群益金鼎-桃園,2024-07-18,9189
1714,和桐,25,0,25,群益金鼎-桃園,2024-07-18,9189
3094,聯傑,25,0,25,群益金鼎-桃園,2024-07-18,9189
3189,景碩,36,12,24,群益金鼎-桃園,2024-07-18,9189
2489,瑞軒,42,18,24,群益金鼎-桃園,2024-07-18,9189
00715L,期街口布蘭特正2,30,6,24,群益金鼎-桃園,2024-07-18,9189
8105,凌巨,289,265,24,群益金鼎-桃園,2024-07-18,9189
00936,台新永續高息中小,23,0,23,群益金鼎-桃園,2024-07-18,9189
3019,亞光,25,3,22,群益金鼎-桃園,2024-07-18,9189
3163,波若威,89,68,21,群益金鼎-桃園,2024-07-18,9189
2405,輔信,21,0,21,群益金鼎-桃園,2024-07-18,9189
1809,中釉,20,0,20,群益金鼎-桃園,2024-07-18,9189
3615,安可,20,0,20,群益金鼎-桃園,2024-07-18,9189
00935,野村臺灣新科技50,20,0,20,群益金鼎-桃園,2024-07-18,9189
2352,佳世達,37,18,19,群益金鼎-桃園,2024-07-18,9189
8390,金益鼎,23,4,19,群益金鼎-桃園,2024-07-18,9189
1815,富喬,21,2,19,群益金鼎-桃園,2024-07-18,9189
3630,新鉅科,19,0,19,群益金鼎-桃園,2024-07-18,9189
2345,智邦,18,0,18,群益金鼎-桃園,2024-07-18,9189
2303,聯電,32,14,18,群益金鼎-桃園,2024-07-18,9189
00937B,群益ESG投等債20,99,82,17,群益金鼎-桃園,2024-07-18,9189
00891,中信關鍵半導體,17,0,17,群益金鼎-桃園,2024-07-18,9189
1513,中興電,32,15,17,群益金鼎-桃園,2024-07-18,9189
00918,大華優利高填息30,16,0,16,群益金鼎-桃園,2024-07-18,9189
2323,中環,16,0,16,群益金鼎-桃園,2024-07-18,9189
2353,宏��,23,7,16,群益金鼎-桃園,2024-07-18,9189
2317,鴻海,58,43,15,群益金鼎-桃園,2024-07-18,9189
6770,力積電,17,2,15,群益金鼎-桃園,2024-07-18,9189
00632R,元大台灣50反1,1456,90,1366,群益金鼎-桃園,2024-07-19,9189
3481,群創,991,109,882,群益金鼎-桃園,2024-07-19,9189
2002,中鋼,309,90,219,群益金鼎-桃園,2024-07-19,9189
00946,群益科技高息成長,114,0,114,群益金鼎-桃園,2024-07-19,9189
9945,潤泰新,178,75,103,群益金鼎-桃園,2024-07-19,9189
1444,力麗,94,1,93,群益金鼎-桃園,2024-07-19,9189
2883,凱基金,95,6,89,群益金鼎-桃園,2024-07-19,9189
2330,台積電,80,11,69,群益金鼎-桃園,2024-07-19,9189
2609,陽明,68,3,65,群益金鼎-桃園,2024-07-19,9189
2313,華通,63,0,63,群益金鼎-桃園,2024-07-19,9189
2312,金寶,115,54,61,群益金鼎-桃園,2024-07-19,9189
2867,三商壽,61,5,56,群益金鼎-桃園,2024-07-19,9189
2419,仲琦,89,33,56,群益金鼎-桃園,2024-07-19,9189
6770,力積電,47,5,42,群益金鼎-桃園,2024-07-19,9189
00878,國泰永續高股息,44,5,39,群益金鼎-桃園,2024-07-19,9189
00725B,國泰投資級公司債,39,0,39,群益金鼎-桃園,2024-07-19,9189
00929,復華台灣科技優息,153,115,38,群益金鼎-桃園,2024-07-19,9189
2547,日勝生,36,0,36,群益金鼎-桃園,2024-07-19,9189
00918,大華優利高填息30,36,1,35,群益金鼎-桃園,2024-07-19,9189
1785,光洋科,49,14,35,群益金鼎-桃園,2024-07-19,9189
2344,華邦電,35,0,35,群益金鼎-桃園,2024-07-19,9189
3006,晶豪科,37,2,35,群益金鼎-桃園,2024-07-19,9189
2408,南亞科,36,2,34,群益金鼎-桃園,2024-07-19,9189
2891,中信金,78,45,33,群益金鼎-桃園,2024-07-19,9189
2356,英業達,56,23,33,群益金鼎-桃園,2024-07-19,9189
8096,擎亞,40,10,30,群益金鼎-桃園,2024-07-19,9189
00927,群益半導體收益,29,1,28,群益金鼎-桃園,2024-07-19,9189
2323,中環,29,3,26,群益金鼎-桃園,2024-07-19,9189
00891,中信關鍵半導體,24,0,24,群益金鼎-桃園,2024-07-19,9189
2801,彰銀,30,7,23,群益金鼎-桃園,2024-07-19,9189
3576,聯合再生,27,4,23,群益金鼎-桃園,2024-07-19,9189
2023,燁輝,23,0,23,群益金鼎-桃園,2024-07-19,9189
1455,集盛,22,0,22,群益金鼎-桃園,2024-07-19,9189
1617,榮星,21,0,21,群益金鼎-桃園,2024-07-19,9189
2388,威盛,23,2,21,群益金鼎-桃園,2024-07-19,9189
6592,和潤企業,20,0,20,群益金鼎-桃園,2024-07-19,9189
00934,中信成長高股息,25,5,20,群益金鼎-桃園,2024-07-19,9189
2906,高林,23,3,20,群益金鼎-桃園,2024-07-19,9189
8050,廣積,20,0,20,群益金鼎-桃園,2024-07-19,9189
4303,信立,39,21,18,群益金鼎-桃園,2024-07-19,9189
00935,野村臺灣新科技50,18,0,18,群益金鼎-桃園,2024-07-19,9189
3580,友威科,31,13,18,群益金鼎-桃園,2024-07-19,9189
3231,緯創,23,6,17,群益金鼎-桃園,2024-07-19,9189
3706,神達,21,4,17,群益金鼎-桃園,2024-07-19,9189
2352,佳世達,36,19,17,群益金鼎-桃園,2024-07-19,9189
8046,南電,16,0,16,群益金鼎-桃園,2024-07-19,9189
2104,國際中橡,17,1,16,群益金鼎-桃園,2024-07-19,9189
8105,凌巨,70,54,16,群益金鼎-桃園,2024-07-19,9189
5309,系統電,19,4,15,群益金鼎-桃園,2024-07-19,9189
00936,台新永續高息中小,15,0,15,群益金鼎-桃園,2024-07-19,9189
3481,群創,420,26,394,群益金鼎-桃園,2024-07-22,9189
2344,華邦電,241,0,241,群益金鼎-桃園,2024-07-22,9189
6217,中探針,180,1,179,群益金鼎-桃園,2024-07-22,9189
00940,元大台灣價值高息,159,6,153,群益金鼎-桃園,2024-07-22,9189
00919,群益台灣精選高息,185,49,136,群益金鼎-桃園,2024-07-22,9189
2887,台新金,114,5,109,群益金鼎-桃園,2024-07-22,9189
00929,復華台灣科技優息,206,119,87,群益金鼎-桃園,2024-07-22,9189
5324,士開,70,0,70,群益金鼎-桃園,2024-07-22,9189
9945,潤泰新,70,4,66,群益金鼎-桃園,2024-07-22,9189
2303,聯電,66,7,59,群益金鼎-桃園,2024-07-22,9189
2489,瑞軒,68,13,55,群益金鼎-桃園,2024-07-22,9189
00934,中信成長高股息,61,20,41,群益金鼎-桃園,2024-07-22,9189
2324,仁寶,40,3,37,群益金鼎-桃園,2024-07-22,9189
2323,中環,32,0,32,群益金鼎-桃園,2024-07-22,9189
2317,鴻海,78,47,31,群益金鼎-桃園,2024-07-22,9189
00891,中信關鍵半導體,30,0,30,群益金鼎-桃園,2024-07-22,9189
00878,國泰永續高股息,94,64,30,群益金鼎-桃園,2024-07-22,9189
1609,大亞,39,11,28,群益金鼎-桃園,2024-07-22,9189
2313,華通,31,3,28,群益金鼎-桃園,2024-07-22,9189
2312,金寶,39,12,27,群益金鼎-桃園,2024-07-22,9189
1608,華榮,27,1,26,群益金鼎-桃園,2024-07-22,9189
2486,一詮,27,1,26,群益金鼎-桃園,2024-07-22,9189
00680L,元大美債20正2,51,25,26,群益金鼎-桃園,2024-07-22,9189
2537,聯上發,25,0,25,群益金鼎-桃園,2024-07-22,9189
5483,中美晶,25,0,25,群益金鼎-桃園,2024-07-22,9189
00918,大華優利高填息30,24,0,24,群益金鼎-桃園,2024-07-22,9189
8105,凌巨,45,21,24,群益金鼎-桃園,2024-07-22,9189
3231,緯創,37,14,23,群益金鼎-桃園,2024-07-22,9189
6142,友勁,23,0,23,群益金鼎-桃園,2024-07-22,9189
4916,事欣科,37,14,23,群益金鼎-桃園,2024-07-22,9189
1504,東元,31,10,21,群益金鼎-桃園,2024-07-22,9189
00948B,中信優息投資級債,20,0,20,群益金鼎-桃園,2024-07-22,9189
00927,群益半導體收益,19,0,19,群益金鼎-桃園,2024-07-22,9189
1709,和益,32,13,19,群益金鼎-桃園,2024-07-22,9189
00936,台新永續高息中小,18,0,18,群益金鼎-桃園,2024-07-22,9189
00939,統一台灣高息動能,17,0,17,群益金鼎-桃園,2024-07-22,9189
2603,長榮,24,6,18,群益金鼎-桃園,2024-07-22,9189
2337,旺宏,18,1,17,群益金鼎-桃園,2024-07-22,9189
2610,華航,16,0,16,群益金鼎-桃園,2024-07-22,9189
2637,慧洋-KY,16,0,16,群益金鼎-桃園,2024-07-22,9189
4303,信立,19,3,16,群益金鼎-桃園,2024-07-22,9189
4938,和碩,32,17,15,群益金鼎-桃園,2024-07-22,9189
3046,建��,15,0,15,群益金鼎-桃園,2024-07-22,9189
6125,廣運,43,28,15,群益金鼎-桃園,2024-07-22,9189
6116,彩晶,15,0,15,群益金鼎-桃園,2024-07-22,9189
2882,國泰金,18,4,14,群益金鼎-桃園,2024-07-22,9189
1802,台玻,15,1,14,群益金鼎-桃園,2024-07-22,9189
00935,野村臺灣新科技50,14,0,14,群益金鼎-桃園,2024-07-22,9189
3035,智原,13,0,13,群益金鼎-桃園,2024-07-22,9189
1213,大飲,13,0,13,群益金鼎-桃園,2024-07-22,9189
2344,華邦電,304,4,300,群益金鼎-桃園,2024-07-23,9189
00946,群益科技高息成長,211,5,206,群益金鼎-桃園,2024-07-23,9189
00937B,群益ESG投等債20,157,3,154,群益金鼎-桃園,2024-07-23,9189
2888,新光金,153,23,130,群益金鼎-桃園,2024-07-23,9189
00929,復華台灣科技優息,87,8,79,群益金鼎-桃園,2024-07-23,9189
3481,群創,99,44,55,群益金鼎-桃園,2024-07-23,9189
00632R,元大台灣50反1,114,66,48,群益金鼎-桃園,2024-07-23,9189
2891,中信金,63,20,43,群益金鼎-桃園,2024-07-23,9189
00679B,元大美債20年,64,22,42,群益金鼎-桃園,2024-07-23,9189
00919,群益台灣精選高息,49,15,34,群益金鼎-桃園,2024-07-23,9189
6217,中探針,38,6,32,群益金鼎-桃園,2024-07-23,9189
00933B,國泰10Y+金融債,28,0,28,群益金鼎-桃園,2024-07-23,9189
3494,誠研,40,15,25,群益金鼎-桃園,2024-07-23,9189
3663,鑫科,45,21,24,群益金鼎-桃園,2024-07-23,9189
4303,信立,35,12,23,群益金鼎-桃園,2024-07-23,9189
2867,三商壽,106,83,23,群益金鼎-桃園,2024-07-23,9189
1102,亞泥,23,1,22,群益金鼎-桃園,2024-07-23,9189
8440,綠電,44,22,22,群益金鼎-桃園,2024-07-23,9189
2408,南亞科,25,3,22,群益金鼎-桃園,2024-07-23,9189
6239,力成,20,0,20,群益金鼎-桃園,2024-07-23,9189
00878,國泰永續高股息,34,15,19,群益金鼎-桃園,2024-07-23,9189
00687B,國泰20年美債,19,0,19,群益金鼎-桃園,2024-07-23,9189
2371,大同,17,1,16,群益金鼎-桃園,2024-07-23,9189
8039,台虹,16,0,16,群益金鼎-桃園,2024-07-23,9189
4916,事欣科,16,1,15,群益金鼎-桃園,2024-07-23,9189
3122,笙泉,15,0,15,群益金鼎-桃園,2024-07-23,9189
2464,盟立,70,56,14,群益金鼎-桃園,2024-07-23,9189
2312,金寶,67,53,14,群益金鼎-桃園,2024-07-23,9189
5309,系統電,17,3,14,群益金鼎-桃園,2024-07-23,9189
1201,味全,13,0,13,群益金鼎-桃園,2024-07-23,9189
1314,中石化,13,0,13,群益金鼎-桃園,2024-07-23,9189
00918,大華優利高填息30,13,0,13,群益金鼎-桃園,2024-07-23,9189
1609,大亞,14,2,12,群益金鼎-桃園,2024-07-23,9189
00942B,台新美A公司債20+,11,0,11,群益金鼎-桃園,2024-07-23,9189
00751B,元大AAA至A公司債,11,0,11,群益金鼎-桃園,2024-07-23,9189
3673,TPK-KY,11,0,11,群益金鼎-桃園,2024-07-23,9189
00680L,元大美債20正2,42,31,11,群益金鼎-桃園,2024-07-23,9189
2409,友達,11,0,11,群益金鼎-桃園,2024-07-23,9189
5213,亞昕,14,4,10,群益金鼎-桃園,2024-07-23,9189
2356,英業達,19,9,10,群益金鼎-桃園,2024-07-23,9189
4113,聯上,10,0,10,群益金鼎-桃園,2024-07-23,9189
3622,洋華,10,0,10,群益金鼎-桃園,2024-07-23,9189
8249,菱光,10,0,10,群益金鼎-桃園,2024-07-23,9189
00664R,國泰臺灣加權反1,10,0,10,群益金鼎-桃園,2024-07-23,9189
2520,冠德,11,1,10,群益金鼎-桃園,2024-07-23,9189
6120,達運,10,0,10,群益金鼎-桃園,2024-07-23,9189
6126,信音,11,1,10,群益金鼎-桃園,2024-07-23,9189
8096,擎亞,12,2,10,群益金鼎-桃園,2024-07-23,9189
2313,華通,15,5,10,群益金鼎-桃園,2024-07-23,9189
0056,元大高股息,15,5,10,群益金鼎-桃園,2024-07-23,9189
00919,群益台灣精選高息,593,0,593,群益金鼎-桃園,2024-07-26,9189
00940,元大台灣價值高息,199,10,189,群益金鼎-桃園,2024-07-26,9189
00680L,元大美債20正2,178,10,168,群益金鼎-桃園,2024-07-26,9189
00939,統一台灣高息動能,162,9,153,群益金鼎-桃園,2024-07-26,9189
00929,復華台灣科技優息,155,5,150,群益金鼎-桃園,2024-07-26,9189
6217,中探針,130,2,128,群益金鼎-桃園,2024-07-26,9189
0050,元大台灣50,123,4,119,群益金鼎-桃園,2024-07-26,9189
2371,大同,105,0,105,群益金鼎-桃園,2024-07-26,9189
00665L,富邦�琤肭磪囓�2,95,0,95,群益金鼎-桃園,2024-07-26,9189
2382,廣達,95,2,93,群益金鼎-桃園,2024-07-26,9189
2884,玉山金,81,0,81,群益金鼎-桃園,2024-07-26,9189
0056,元大高股息,85,6,79,群益金鼎-桃園,2024-07-26,9189
2317,鴻海,80,18,62,群益金鼎-桃園,2024-07-26,9189
00878,國泰永續高股息,77,18,59,群益金鼎-桃園,2024-07-26,9189
2867,三商壽,61,3,58,群益金鼎-桃園,2024-07-26,9189
2330,台積電,64,7,57,群益金鼎-桃園,2024-07-26,9189
2885,元大金,53,0,53,群益金鼎-桃園,2024-07-26,9189
2880,華南金,50,0,50,群益金鼎-桃園,2024-07-26,9189
2352,佳世達,46,0,46,群益金鼎-桃園,2024-07-26,9189
00937B,群益ESG投等債20,95,55,40,群益金鼎-桃園,2024-07-26,9189
2312,金寶,42,5,37,群益金鼎-桃園,2024-07-26,9189
3711,日月光投控,37,0,37,群益金鼎-桃園,2024-07-26,9189
00687B,國泰20年美債,37,0,37,群益金鼎-桃園,2024-07-26,9189
2365,昆盈,87,53,34,群益金鼎-桃園,2024-07-26,9189
2887,台新金,41,8,33,群益金鼎-桃園,2024-07-26,9189
3312,弘憶股,34,2,32,群益金鼎-桃園,2024-07-26,9189
00715L,期街口布蘭特正2,32,0,32,群益金鼎-桃園,2024-07-26,9189
00946,群益科技高息成長,57,26,31,群益金鼎-桃園,2024-07-26,9189
2356,英業達,37,9,28,群益金鼎-桃園,2024-07-26,9189
6005,群益證,28,0,28,群益金鼎-桃園,2024-07-26,9189
3706,神達,32,5,27,群益金鼎-桃園,2024-07-26,9189
6142,友勁,27,0,27,群益金鼎-桃園,2024-07-26,9189
00692,富邦公司治理,27,0,27,群益金鼎-桃園,2024-07-26,9189
00918,大華優利高填息30,26,0,26,群益金鼎-桃園,2024-07-26,9189
2537,聯上發,36,10,26,群益金鼎-桃園,2024-07-26,9189
2408,南亞科,27,2,25,群益金鼎-桃園,2024-07-26,9189
00941,中信上游半導體,24,0,24,群益金鼎-桃園,2024-07-26,9189
00882,中信中國高股息,25,2,23,群益金鼎-桃園,2024-07-26,9189
2303,聯電,28,7,21,群益金鼎-桃園,2024-07-26,9189
1473,台南,22,1,21,群益金鼎-桃園,2024-07-26,9189
1708,東鹼,20,0,20,群益金鼎-桃園,2024-07-26,9189
1570,力肯,19,0,19,群益金鼎-桃園,2024-07-26,9189
00927,群益半導體收益,19,0,19,群益金鼎-桃園,2024-07-26,9189
00949,復華日本龍頭,19,0,19,群益金鼎-桃園,2024-07-26,9189
2033,佳大,19,0,19,群益金鼎-桃園,2024-07-26,9189
00720B,元大投資級公司債,20,3,17,群益金鼎-桃園,2024-07-26,9189
8926,台汽電,35,19,16,群益金鼎-桃園,2024-07-26,9189
00712,復華富時不動產,16,0,16,群益金鼎-桃園,2024-07-26,9189
2002,中鋼,17,1,16,群益金鼎-桃園,2024-07-26,9189
5483,中美晶,16,0,16,群益金鼎-桃園,2024-07-26,9189
6116,彩晶,200,2,198,群益金鼎-桃園,2024-07-29,9189
00680L,元大美債20正2,115,0,115,群益金鼎-桃園,2024-07-29,9189
00929,復華台灣科技優息,120,12,108,群益金鼎-桃園,2024-07-29,9189
2887,台新金,132,26,106,群益金鼎-桃園,2024-07-29,9189
2882,國泰金,83,4,79,群益金鼎-桃園,2024-07-29,9189
00937B,群益ESG投等債20,80,3,77,群益金鼎-桃園,2024-07-29,9189
00632R,元大台灣50反1,86,11,75,群益金鼎-桃園,2024-07-29,9189
2423,固緯,64,0,64,群益金鼎-桃園,2024-07-29,9189
2353,宏��,72,10,62,群益金鼎-桃園,2024-07-29,9189
2409,友達,61,10,51,群益金鼎-桃園,2024-07-29,9189
0056,元大高股息,61,15,46,群益金鼎-桃園,2024-07-29,9189
00946,群益科技高息成長,53,11,42,群益金鼎-桃園,2024-07-29,9189
1513,中興電,38,4,34,群益金鼎-桃園,2024-07-29,9189
2486,一詮,59,29,30,群益金鼎-桃園,2024-07-29,9189
2344,華邦電,31,2,29,群益金鼎-桃園,2024-07-29,9189
2324,仁寶,33,6,27,群益金鼎-桃園,2024-07-29,9189
00945B,凱基美國非投等債,27,0,27,群益金鼎-桃園,2024-07-29,9189
2367,燿華,95,70,25,群益金鼎-桃園,2024-07-29,9189
3013,晟銘電,38,13,25,群益金鼎-桃園,2024-07-29,9189
3035,智原,33,9,24,群益金鼎-桃園,2024-07-29,9189
2884,玉山金,24,0,24,群益金鼎-桃園,2024-07-29,9189
3706,神達,30,7,23,群益金鼎-桃園,2024-07-29,9189
00878,國泰永續高股息,37,15,22,群益金鼎-桃園,2024-07-29,9189
00715L,期街口布蘭特正2,22,0,22,群益金鼎-桃園,2024-07-29,9189
9945,潤泰新,36,14,22,群益金鼎-桃園,2024-07-29,9189
2382,廣達,23,2,21,群益金鼎-桃園,2024-07-29,9189
2356,英業達,33,12,21,群益金鼎-桃園,2024-07-29,9189
1316,上曜,32,12,20,群益金鼎-桃園,2024-07-29,9189
8234,新漢,19,0,19,群益金鼎-桃園,2024-07-29,9189
2317,鴻海,25,6,19,群益金鼎-桃園,2024-07-29,9189
6269,台郡,18,0,18,群益金鼎-桃園,2024-07-29,9189
00923,群益台ESG低碳50,17,0,17,群益金鼎-桃園,2024-07-29,9189
9933,中鼎,16,0,16,群益金鼎-桃園,2024-07-29,9189
2323,中環,21,5,16,群益金鼎-桃園,2024-07-29,9189
1514,亞力,24,9,15,群益金鼎-桃園,2024-07-29,9189
00919,群益台灣精選高息,25,10,15,群益金鼎-桃園,2024-07-29,9189
4564,元翎,16,2,14,群益金鼎-桃園,2024-07-29,9189
6126,信音,17,3,14,群益金鼎-桃園,2024-07-29,9189
8086,宏捷科,18,5,13,群益金鼎-桃園,2024-07-29,9189
5340,建榮,13,0,13,群益金鼎-桃園,2024-07-29,9189
00936,台新永續高息中小,13,0,13,群益金鼎-桃園,2024-07-29,9189
00891,中信關鍵半導體,13,0,13,群益金鼎-桃園,2024-07-29,9189
3037,欣興,15,3,12,群益金鼎-桃園,2024-07-29,9189
1785,光洋科,15,3,12,群益金鼎-桃園,2024-07-29,9189
6591,動力-KY,12,0,12,群益金鼎-桃園,2024-07-29,9189
3163,波若威,31,19,12,群益金鼎-桃園,2024-07-29,9189
00881,國泰台灣5G+,11,0,11,群益金鼎-桃園,2024-07-29,9189
5009,榮剛,12,1,11,群益金鼎-桃園,2024-07-29,9189
3708,上緯投控,11,0,11,群益金鼎-桃園,2024-07-29,9189
1456,怡華,11,0,11,群益金鼎-桃園,2024-07-29,9189
00940,元大台灣價值高息,162,13,149,群益金鼎-桃園,2024-07-30,9189
00664R,國泰臺灣加權反1,155,15,140,群益金鼎-桃園,2024-07-30,9189
00919,群益台灣精選高息,137,3,134,群益金鼎-桃園,2024-07-30,9189
1569,濱川,130,3,127,群益金鼎-桃園,2024-07-30,9189
00679B,元大美債20年,126,0,126,群益金鼎-桃園,2024-07-30,9189
00929,復華台灣科技優息,155,34,121,群益金鼎-桃園,2024-07-30,9189
2349,錸德,239,139,100,群益金鼎-桃園,2024-07-30,9189
0056,元大高股息,84,6,78,群益金鼎-桃園,2024-07-30,9189
00665L,富邦�琤肭磪囓�2,72,0,72,群益金鼎-桃園,2024-07-30,9189
2303,聯電,75,16,59,群益金鼎-桃園,2024-07-30,9189
2887,台新金,71,15,56,群益金鼎-桃園,2024-07-30,9189
2423,固緯,118,63,55,群益金鼎-桃園,2024-07-30,9189
5469,瀚宇博,53,1,52,群益金鼎-桃園,2024-07-30,9189
2891,中信金,62,22,40,群益金鼎-桃園,2024-07-30,9189
00891,中信關鍵半導體,42,3,39,群益金鼎-桃園,2024-07-30,9189
2801,彰銀,35,0,35,群益金鼎-桃園,2024-07-30,9189
00945B,凱基美國非投等債,32,0,32,群益金鼎-桃園,2024-07-30,9189
2344,華邦電,34,2,32,群益金鼎-桃園,2024-07-30,9189
3706,神達,35,4,31,群益金鼎-桃園,2024-07-30,9189
4720,德淵,30,0,30,群益金鼎-桃園,2024-07-30,9189
00931B,統一美債20年,30,0,30,群益金鼎-桃園,2024-07-30,9189
2515,中工,30,2,28,群益金鼎-桃園,2024-07-30,9189
2023,燁輝,29,3,26,群益金鼎-桃園,2024-07-30,9189
3188,鑫龍騰,34,9,25,群益金鼎-桃園,2024-07-30,9189
00680L,元大美債20正2,145,120,25,群益金鼎-桃園,2024-07-30,9189
00946,群益科技高息成長,42,17,25,群益金鼎-桃園,2024-07-30,9189
00937B,群益ESG投等債20,43,20,23,群益金鼎-桃園,2024-07-30,9189
2324,仁寶,27,4,23,群益金鼎-桃園,2024-07-30,9189
4510,高鋒,24,1,23,群益金鼎-桃園,2024-07-30,9189
00687B,國泰20年美債,24,2,22,群益金鼎-桃園,2024-07-30,9189
00637L,元大滬深300正2,28,6,22,群益金鼎-桃園,2024-07-30,9189
00909,國泰數位支付服務,22,0,22,群益金鼎-桃園,2024-07-30,9189
2352,佳世達,23,2,21,群益金鼎-桃園,2024-07-30,9189
3518,柏騰,30,10,20,群益金鼎-桃園,2024-07-30,9189
1785,光洋科,55,35,20,群益金鼎-桃園,2024-07-30,9189
1617,榮星,20,1,19,群益金鼎-桃園,2024-07-30,9189
2367,燿華,34,16,18,群益金鼎-桃園,2024-07-30,9189
00934,中信成長高股息,27,10,17,群益金鼎-桃園,2024-07-30,9189
2464,盟立,19,4,15,群益金鼎-桃園,2024-07-30,9189
1303,南亞,15,1,14,群益金鼎-桃園,2024-07-30,9189
2356,英業達,17,3,14,群益金鼎-桃園,2024-07-30,9189
00936,台新永續高息中小,23,10,13,群益金鼎-桃園,2024-07-30,9189
2353,宏��,20,7,13,群益金鼎-桃園,2024-07-30,9189
5309,系統電,19,6,13,群益金鼎-桃園,2024-07-30,9189
3379,彬台,14,1,13,群益金鼎-桃園,2024-07-30,9189
3231,緯創,42,30,12,群益金鼎-桃園,2024-07-30,9189
00725B,國泰投資級公司債,12,0,12,群益金鼎-桃園,2024-07-30,9189
2812,台中銀,11,0,11,群益金鼎-桃園,2024-07-30,9189
00922,國泰台灣領袖50,11,0,11,群益金鼎-桃園,2024-07-30,9189
1213,大飲,11,0,11,群益金鼎-桃園,2024-07-30,9189
1806,冠軍,305,4,301,群益金鼎-桃園,2024-07-31,9189
00946,群益科技高息成長,134,3,131,群益金鼎-桃園,2024-07-31,9189
00753L,中信中國50正2,100,0,100,群益金鼎-桃園,2024-07-31,9189
00650L,復華香港正2,100,0,100,群益金鼎-桃園,2024-07-31,9189
5512,力麒,107,12,95,群益金鼎-桃園,2024-07-31,9189
2062,橋椿,68,4,64,群益金鼎-桃園,2024-07-31,9189
3167,大量,53,10,43,群益金鼎-桃園,2024-07-31,9189
00919,群益台灣精選高息,65,23,42,群益金鼎-桃園,2024-07-31,9189
3630,新鉅科,40,0,40,群益金鼎-桃園,2024-07-31,9189
00929,復華台灣科技優息,41,3,38,群益金鼎-桃園,2024-07-31,9189
3047,訊舟,132,96,36,群益金鼎-桃園,2024-07-31,9189
9105,泰金寶-DR,30,0,30,群益金鼎-桃園,2024-07-31,9189
3044,健鼎,26,0,26,群益金鼎-桃園,2024-07-31,9189
0056,元大高股息,25,0,25,群益金鼎-桃園,2024-07-31,9189
8039,台虹,24,0,24,群益金鼎-桃園,2024-07-31,9189
6116,彩晶,65,42,23,群益金鼎-桃園,2024-07-31,9189
00679B,元大美債20年,25,2,23,群益金鼎-桃園,2024-07-31,9189
00687B,國泰20年美債,25,2,23,群益金鼎-桃園,2024-07-31,9189
00878,國泰永續高股息,22,1,21,群益金鼎-桃園,2024-07-31,9189
3055,蔚華科,29,9,20,群益金鼎-桃園,2024-07-31,9189
1611,中電,20,0,20,群益金鼎-桃園,2024-07-31,9189
00680L,元大美債20正2,70,50,20,群益金鼎-桃園,2024-07-31,9189
3037,欣興,25,7,18,群益金鼎-桃園,2024-07-31,9189
3105,穩懋,18,1,17,群益金鼎-桃園,2024-07-31,9189
4513,福裕,25,8,17,群益金鼎-桃園,2024-07-31,9189
2409,友達,17,0,17,群益金鼎-桃園,2024-07-31,9189
2349,錸德,36,20,16,群益金鼎-桃園,2024-07-31,9189
1213,大飲,38,23,15,群益金鼎-桃園,2024-07-31,9189
2485,兆赫,13,0,13,群益金鼎-桃園,2024-07-31,9189
00751B,元大AAA至A公司債,13,0,13,群益金鼎-桃園,2024-07-31,9189
4562,穎漢,13,0,13,群益金鼎-桃園,2024-07-31,9189
1608,華榮,12,0,12,群益金鼎-桃園,2024-07-31,9189
1455,集盛,12,0,12,群益金鼎-桃園,2024-07-31,9189
1795,美時,12,0,12,群益金鼎-桃園,2024-07-31,9189
6152,百一,12,0,12,群益金鼎-桃園,2024-07-31,9189
5508,永信建,15,4,11,群益金鼎-桃園,2024-07-31,9189
00715L,期街口布蘭特正2,12,1,11,群益金鼎-桃園,2024-07-31,9189
00719B,元大美債1-3,10,0,10,群益金鼎-桃園,2024-07-31,9189
2316,楠梓電,11,1,10,群益金鼎-桃園,2024-07-31,9189
4566,時碩工業,11,1,10,群益金鼎-桃園,2024-07-31,9189
6727,亞泰金屬,10,0,10,群益金鼎-桃園,2024-07-31,9189
3035,智原,21,11,10,群益金鼎-桃園,2024-07-31,9189
5328,華容,12,3,9,群益金鼎-桃園,2024-07-31,9189
3019,亞光,11,2,9,群益金鼎-桃園,2024-07-31,9189
1454,台富,9,0,9,群益金鼎-桃園,2024-07-31,9189
2317,鴻海,45,36,9,群益金鼎-桃園,2024-07-31,9189
2363,矽統,17,9,8,群益金鼎-桃園,2024-07-31,9189
6271,同欣電,8,0,8,群益金鼎-桃園,2024-07-31,9189
00720B,元大投資級公司債,8,0,8,群益金鼎-桃園,2024-07-31,9189
1513,中興電,11,3,8,群益金鼎-桃園,2024-07-31,9189
00664R,國泰臺灣加權反1,175,0,175,群益金鼎-桃園,2024-08-01,9189
00637L,元大滬深300正2,200,32,168,群益金鼎-桃園,2024-08-01,9189
00878,國泰永續高股息,167,16,151,群益金鼎-桃園,2024-08-01,9189
00715L,期街口布蘭特正2,100,19,81,群益金鼎-桃園,2024-08-01,9189
2337,旺宏,183,126,57,群益金鼎-桃園,2024-08-01,9189
00687B,國泰20年美債,70,15,55,群益金鼎-桃園,2024-08-01,9189
2610,華航,47,0,47,群益金鼎-桃園,2024-08-01,9189
3024,憶聲,42,2,40,群益金鼎-桃園,2024-08-01,9189
2405,輔信,39,2,37,群益金鼎-桃園,2024-08-01,9189
3481,群創,41,6,35,群益金鼎-桃園,2024-08-01,9189
9902,台火,35,2,33,群益金鼎-桃園,2024-08-01,9189
8064,東捷,121,90,31,群益金鼎-桃園,2024-08-01,9189
00712,復華富時不動產,25,2,23,群益金鼎-桃園,2024-08-01,9189
00881,國泰台灣5G+,20,0,20,群益金鼎-桃園,2024-08-01,9189
5009,榮剛,20,1,19,群益金鼎-桃園,2024-08-01,9189
00706L,期元大S＆P日圓正2,20,2,18,群益金鼎-桃園,2024-08-01,9189
2104,國際中橡,19,1,18,群益金鼎-桃園,2024-08-01,9189
2489,瑞軒,22,4,18,群益金鼎-桃園,2024-08-01,9189
2515,中工,63,45,18,群益金鼎-桃園,2024-08-01,9189
00932,兆豐永續高息等權,17,0,17,群益金鼎-桃園,2024-08-01,9189
9933,中鼎,16,0,16,群益金鼎-桃園,2024-08-01,9189
3535,晶彩科,31,16,15,群益金鼎-桃園,2024-08-01,9189
5392,能率,21,6,15,群益金鼎-桃園,2024-08-01,9189
2356,英業達,24,10,14,群益金鼎-桃園,2024-08-01,9189
1785,光洋科,25,11,14,群益金鼎-桃園,2024-08-01,9189
1447,力鵬,107,94,13,群益金鼎-桃園,2024-08-01,9189
00665L,富邦�琤肭磪囓�2,15,2,13,群益金鼎-桃園,2024-08-01,9189
6804,明係,13,0,13,群益金鼎-桃園,2024-08-01,9189
6016,康和證,12,0,12,群益金鼎-桃園,2024-08-01,9189
1569,濱川,24,13,11,群益金鼎-桃園,2024-08-01,9189
1101,台泥,11,0,11,群益金鼎-桃園,2024-08-01,9189
8438,昶昕,15,5,10,群益金鼎-桃園,2024-08-01,9189
4513,福裕,68,58,10,群益金鼎-桃園,2024-08-01,9189
1560,中砂,14,4,10,群益金鼎-桃園,2024-08-01,9189
2033,佳大,10,0,10,群益金鼎-桃園,2024-08-01,9189
9105,泰金寶-DR,11,1,10,群益金鼎-桃園,2024-08-01,9189
6727,亞泰金屬,10,0,10,群益金鼎-桃園,2024-08-01,9189
3576,聯合再生,17,7,10,群益金鼎-桃園,2024-08-01,9189
8011,台通,14,4,10,群益金鼎-桃園,2024-08-01,9189
00895,富邦未來車,10,0,10,群益金鼎-桃園,2024-08-01,9189
2486,一詮,33,24,9,群益金鼎-桃園,2024-08-01,9189
1711,永光,20,11,9,群益金鼎-桃園,2024-08-01,9189
9945,潤泰新,27,18,9,群益金鼎-桃園,2024-08-01,9189
5443,均豪,82,74,8,群益金鼎-桃園,2024-08-01,9189
00923,群益台ESG低碳50,8,0,8,群益金鼎-桃園,2024-08-01,9189
6239,力成,8,0,8,群益金鼎-桃園,2024-08-01,9189
2363,矽統,38,31,7,群益金鼎-桃園,2024-08-01,9189
3363,上詮,31,24,7,群益金鼎-桃園,2024-08-01,9189
1216,統一,8,1,7,群益金鼎-桃園,2024-08-01,9189
6166,凌華,7,0,7,群益金鼎-桃園,2024-08-01,9189
00878,國泰永續高股息,317,1,316,群益金鼎-桃園,2024-08-02,9189
1806,冠軍,307,0,307,群益金鼎-桃園,2024-08-02,9189
00919,群益台灣精選高息,224,4,220,群益金鼎-桃園,2024-08-02,9189
00940,元大台灣價值高息,179,16,163,群益金鼎-桃園,2024-08-02,9189
00946,群益科技高息成長,252,95,157,群益金鼎-桃園,2024-08-02,9189
9945,潤泰新,184,29,155,群益金鼎-桃園,2024-08-02,9189
00929,復華台灣科技優息,165,16,149,群益金鼎-桃園,2024-08-02,9189
2317,鴻海,157,14,143,群益金鼎-桃園,2024-08-02,9189
00688L,國泰20年美債正2,110,5,105,群益金鼎-桃園,2024-08-02,9189
3062,建漢,104,0,104,群益金鼎-桃園,2024-08-02,9189
5512,力麒,150,54,96,群益金鼎-桃園,2024-08-02,9189
00679B,元大美債20年,112,23,89,群益金鼎-桃園,2024-08-02,9189
2891,中信金,71,0,71,群益金鼎-桃園,2024-08-02,9189
2313,華通,71,0,71,群益金鼎-桃園,2024-08-02,9189
2801,彰銀,70,0,70,群益金鼎-桃園,2024-08-02,9189
2515,中工,71,5,66,群益金鼎-桃園,2024-08-02,9189
00665L,富邦�琤肭磪囓�2,65,0,65,群益金鼎-桃園,2024-08-02,9189
0056,元大高股息,58,0,58,群益金鼎-桃園,2024-08-02,9189
00881,國泰台灣5G+,50,0,50,群益金鼎-桃園,2024-08-02,9189
6005,群益證,48,0,48,群益金鼎-桃園,2024-08-02,9189
6727,亞泰金屬,45,0,45,群益金鼎-桃園,2024-08-02,9189
3037,欣興,44,3,41,群益金鼎-桃園,2024-08-02,9189
2330,台積電,54,14,40,群益金鼎-桃園,2024-08-02,9189
1540,喬福,72,32,40,群益金鼎-桃園,2024-08-02,9189
1213,大飲,55,15,40,群益金鼎-桃園,2024-08-02,9189
2382,廣達,45,6,39,群益金鼎-桃園,2024-08-02,9189
00923,群益台ESG低碳50,35,0,35,群益金鼎-桃園,2024-08-02,9189
3048,益登,38,6,32,群益金鼎-桃園,2024-08-02,9189
1536,和大,34,3,31,群益金鼎-桃園,2024-08-02,9189
00936,台新永續高息中小,31,1,30,群益金鼎-桃園,2024-08-02,9189
2303,聯電,54,24,30,群益金鼎-桃園,2024-08-02,9189
1569,濱川,53,23,30,群益金鼎-桃園,2024-08-02,9189
3024,憶聲,31,2,29,群益金鼎-桃園,2024-08-02,9189
1447,力鵬,28,0,28,群益金鼎-桃園,2024-08-02,9189
3580,友威科,31,3,28,群益金鼎-桃園,2024-08-02,9189
2337,旺宏,39,11,28,群益金鼎-桃園,2024-08-02,9189
2308,台達電,29,1,28,群益金鼎-桃園,2024-08-02,9189
00905,FT臺灣Smart,27,0,27,群益金鼎-桃園,2024-08-02,9189
2538,基泰,27,0,27,群益金鼎-桃園,2024-08-02,9189
00927,群益半導體收益,30,4,26,群益金鼎-桃園,2024-08-02,9189
2402,毅嘉,26,2,24,群益金鼎-桃園,2024-08-02,9189
2408,南亞科,27,3,24,群益金鼎-桃園,2024-08-02,9189
3189,景碩,28,5,23,群益金鼎-桃園,2024-08-02,9189
00637L,元大滬深300正2,223,200,23,群益金鼎-桃園,2024-08-02,9189
2834,臺企銀,23,0,23,群益金鼎-桃園,2024-08-02,9189
00932,兆豐永續高息等權,22,0,22,群益金鼎-桃園,2024-08-02,9189
5519,隆大,21,0,21,群益金鼎-桃園,2024-08-02,9189
2355,敬鵬,20,0,20,群益金鼎-桃園,2024-08-02,9189
5324,士開,20,0,20,群益金鼎-桃園,2024-08-02,9189
2890,永豐金,19,0,19,群益金鼎-桃園,2024-08-02,9189
00929,復華台灣科技優息,458,59,399,群益金鼎-桃園,2024-08-05,9189
00940,元大台灣價值高息,456,63,393,群益金鼎-桃園,2024-08-05,9189
00919,群益台灣精選高息,507,119,388,群益金鼎-桃園,2024-08-05,9189
00937B,群益ESG投等債20,474,125,349,群益金鼎-桃園,2024-08-05,9189
9945,潤泰新,423,203,220,群益金鼎-桃園,2024-08-05,9189
00878,國泰永續高股息,315,118,197,群益金鼎-桃園,2024-08-05,9189
2352,佳世達,185,6,179,群益金鼎-桃園,2024-08-05,9189
2409,友達,191,12,179,群益金鼎-桃園,2024-08-05,9189
2883,凱基金,142,4,138,群益金鼎-桃園,2024-08-05,9189
00932,兆豐永續高息等權,110,0,110,群益金鼎-桃園,2024-08-05,9189
2344,華邦電,115,11,104,群益金鼎-桃園,2024-08-05,9189
00948B,中信優息投資級債,100,0,100,群益金鼎-桃園,2024-08-05,9189
2890,永豐金,101,3,98,群益金鼎-桃園,2024-08-05,9189
2610,華航,92,2,90,群益金鼎-桃園,2024-08-05,9189
00679B,元大美債20年,152,64,88,群益金鼎-桃園,2024-08-05,9189
2313,華通,89,2,87,群益金鼎-桃園,2024-08-05,9189
2891,中信金,99,15,84,群益金鼎-桃園,2024-08-05,9189
00688L,國泰20年美債正2,107,27,80,群益金鼎-桃園,2024-08-05,9189
0056,元大高股息,135,56,79,群益金鼎-桃園,2024-08-05,9189
2886,兆豐金,81,2,79,群益金鼎-桃園,2024-08-05,9189
3481,群創,133,64,69,群益金鼎-桃園,2024-08-05,9189
2834,臺企銀,86,29,57,群益金鼎-桃園,2024-08-05,9189
2323,中環,52,0,52,群益金鼎-桃園,2024-08-05,9189
2488,漢平,52,0,52,群益金鼎-桃園,2024-08-05,9189
6015,宏遠證,50,0,50,群益金鼎-桃園,2024-08-05,9189
2330,台積電,84,35,49,群益金鼎-桃園,2024-08-05,9189
1540,喬福,360,312,48,群益金鼎-桃園,2024-08-05,9189
1310,台苯,45,0,45,群益金鼎-桃園,2024-08-05,9189
00933B,國泰10Y+金融債,48,3,45,群益金鼎-桃園,2024-08-05,9189
2303,聯電,49,9,40,群益金鼎-桃園,2024-08-05,9189
5490,同亨,36,0,36,群益金鼎-桃園,2024-08-05,9189
3706,神達,38,3,35,群益金鼎-桃園,2024-08-05,9189
00715L,期街口布蘭特正2,35,0,35,群益金鼎-桃園,2024-08-05,9189
00881,國泰台灣5G+,40,6,34,群益金鼎-桃園,2024-08-05,9189
6116,彩晶,37,4,33,群益金鼎-桃園,2024-08-05,9189
9105,泰金寶-DR,33,0,33,群益金鼎-桃園,2024-08-05,9189
8050,廣積,32,0,32,群益金鼎-桃園,2024-08-05,9189
2528,皇普,32,0,32,群益金鼎-桃園,2024-08-05,9189
2609,陽明,47,17,30,群益金鼎-桃園,2024-08-05,9189
2002,中鋼,60,30,30,群益金鼎-桃園,2024-08-05,9189
6770,力積電,31,3,28,群益金鼎-桃園,2024-08-05,9189
2408,南亞科,30,2,28,群益金鼎-桃園,2024-08-05,9189
1802,台玻,27,1,26,群益金鼎-桃園,2024-08-05,9189
2308,台達電,31,5,26,群益金鼎-桃園,2024-08-05,9189
00927,群益半導體收益,45,20,25,群益金鼎-桃園,2024-08-05,9189
2637,慧洋-KY,28,3,25,群益金鼎-桃園,2024-08-05,9189
2449,京元電子,25,1,24,群益金鼎-桃園,2024-08-05,9189
2023,燁輝,28,4,24,群益金鼎-桃園,2024-08-05,9189
5880,合庫金,24,2,22,群益金鼎-桃園,2024-08-05,9189
00675L,富邦臺灣加權正2,23,1,22,群益金鼎-桃園,2024-08-05,9189
00680L,元大美債20正2,718,142,576,群益金鼎-桃園,2024-08-06,9189
00664R,國泰臺灣加權反1,557,1,556,群益金鼎-桃園,2024-08-06,9189
00937B,群益ESG投等債20,481,58,423,群益金鼎-桃園,2024-08-06,9189
2887,台新金,175,10,165,群益金鼎-桃園,2024-08-06,9189
0056,元大高股息,109,15,94,群益金鼎-桃園,2024-08-06,9189
2317,鴻海,166,74,92,群益金鼎-桃園,2024-08-06,9189
00720B,元大投資級公司債,94,7,87,群益金鼎-桃園,2024-08-06,9189
4113,聯上,80,6,74,群益金鼎-桃園,2024-08-06,9189
00885,富邦越南,74,3,71,群益金鼎-桃園,2024-08-06,9189
00632R,元大台灣50反1,149,80,69,群益金鼎-桃園,2024-08-06,9189
00679B,元大美債20年,108,42,66,群益金鼎-桃園,2024-08-06,9189
00929,復華台灣科技優息,211,148,63,群益金鼎-桃園,2024-08-06,9189
00878,國泰永續高股息,114,51,63,群益金鼎-桃園,2024-08-06,9189
00932,兆豐永續高息等權,60,0,60,群益金鼎-桃園,2024-08-06,9189
5488,松普,52,0,52,群益金鼎-桃園,2024-08-06,9189
00751B,元大AAA至A公司債,90,38,52,群益金鼎-桃園,2024-08-06,9189
00900,富邦特選高股息30,104,53,51,群益金鼎-桃園,2024-08-06,9189
9933,中鼎,68,18,50,群益金鼎-桃園,2024-08-06,9189
2834,臺企銀,49,2,47,群益金鼎-桃園,2024-08-06,9189
00919,群益台灣精選高息,83,38,45,群益金鼎-桃園,2024-08-06,9189
2528,皇普,44,0,44,群益金鼎-桃園,2024-08-06,9189
00795B,中信美國公債20年,45,2,43,群益金鼎-桃園,2024-08-06,9189
2352,佳世達,41,1,40,群益金鼎-桃園,2024-08-06,9189
2883,凱基金,49,12,37,群益金鼎-桃園,2024-08-06,9189
2409,友達,36,1,35,群益金鼎-桃園,2024-08-06,9189
00637L,元大滬深300正2,33,1,32,群益金鼎-桃園,2024-08-06,9189
3481,群創,69,38,31,群益金鼎-桃園,2024-08-06,9189
2402,毅嘉,36,5,31,群益金鼎-桃園,2024-08-06,9189
2537,聯上發,29,3,26,群益金鼎-桃園,2024-08-06,9189
4526,東台,29,3,26,群益金鼎-桃園,2024-08-06,9189
3013,晟銘電,36,11,25,群益金鼎-桃園,2024-08-06,9189
00881,國泰台灣5G+,32,9,23,群益金鼎-桃園,2024-08-06,9189
4510,高鋒,65,42,23,群益金鼎-桃園,2024-08-06,9189
6770,力積電,22,0,22,群益金鼎-桃園,2024-08-06,9189
2497,怡利電,20,0,20,群益金鼎-桃園,2024-08-06,9189
3047,訊舟,28,8,20,群益金鼎-桃園,2024-08-06,9189
1815,富喬,20,1,19,群益金鼎-桃園,2024-08-06,9189
3663,鑫科,62,43,19,群益金鼎-桃園,2024-08-06,9189
3037,欣興,34,16,18,群益金鼎-桃園,2024-08-06,9189
00936,台新永續高息中小,20,2,18,群益金鼎-桃園,2024-08-06,9189
5392,能率,18,0,18,群益金鼎-桃園,2024-08-06,9189
2495,普安,18,0,18,群益金鼎-桃園,2024-08-06,9189
2615,萬海,37,20,17,群益金鼎-桃園,2024-08-06,9189
3024,憶聲,20,4,16,群益金鼎-桃園,2024-08-06,9189
00715L,期街口布蘭特正2,16,0,16,群益金鼎-桃園,2024-08-06,9189
8105,凌巨,15,0,15,群益金鼎-桃園,2024-08-06,9189
2356,英業達,19,4,15,群益金鼎-桃園,2024-08-06,9189
1213,大飲,15,0,15,群益金鼎-桃園,2024-08-06,9189
2609,陽明,68,53,15,群益金鼎-桃園,2024-08-06,9189
1531,高林股,14,0,14,群益金鼎-桃園,2024-08-06,9189
00664R,國泰臺灣加權反1,547,0,547,群益金鼎-桃園,2024-08-07,9189
00929,復華台灣科技優息,409,60,349,群益金鼎-桃園,2024-08-07,9189
00680L,元大美債20正2,291,14,277,群益金鼎-桃園,2024-08-07,9189
00632R,元大台灣50反1,247,14,233,群益金鼎-桃園,2024-08-07,9189
00878,國泰永續高股息,114,10,104,群益金鼎-桃園,2024-08-07,9189
00919,群益台灣精選高息,191,110,81,群益金鼎-桃園,2024-08-07,9189
2367,燿華,67,11,56,群益金鼎-桃園,2024-08-07,9189
3481,群創,91,38,53,群益金鼎-桃園,2024-08-07,9189
00715L,期街口布蘭特正2,51,2,49,群益金鼎-桃園,2024-08-07,9189
5531,鄉林,44,4,40,群益金鼎-桃園,2024-08-07,9189
00720B,元大投資級公司債,40,0,40,群益金鼎-桃園,2024-08-07,9189
2867,三商壽,41,2,39,群益金鼎-桃園,2024-08-07,9189
00940,元大台灣價值高息,61,22,39,群益金鼎-桃園,2024-08-07,9189
2409,友達,63,29,34,群益金鼎-桃園,2024-08-07,9189
00900,富邦特選高股息30,94,61,33,群益金鼎-桃園,2024-08-07,9189
00642U,期元大S＆P石油,30,0,30,群益金鼎-桃園,2024-08-07,9189
2344,華邦電,29,4,25,群益金鼎-桃園,2024-08-07,9189
2887,台新金,24,0,24,群益金鼎-桃園,2024-08-07,9189
2834,臺企銀,26,5,21,群益金鼎-桃園,2024-08-07,9189
00751B,元大AAA至A公司債,40,20,20,群益金鼎-桃園,2024-08-07,9189
2524,京城,60,40,20,群益金鼎-桃園,2024-08-07,9189
8354,冠好,20,0,20,群益金鼎-桃園,2024-08-07,9189
1531,高林股,20,0,20,群益金鼎-桃園,2024-08-07,9189
00687B,國泰20年美債,64,46,18,群益金鼎-桃園,2024-08-07,9189
3576,聯合再生,23,5,18,群益金鼎-桃園,2024-08-07,9189
00881,國泰台灣5G+,16,0,16,群益金鼎-桃園,2024-08-07,9189
3607,谷崧,16,0,16,群益金鼎-桃園,2024-08-07,9189
6189,豐藝,20,4,16,群益金鼎-桃園,2024-08-07,9189
6015,宏遠證,15,0,15,群益金鼎-桃園,2024-08-07,9189
6191,精成科,15,0,15,群益金鼎-桃園,2024-08-07,9189
00679B,元大美債20年,25,11,14,群益金鼎-桃園,2024-08-07,9189
4510,高鋒,43,29,14,群益金鼎-桃園,2024-08-07,9189
1514,亞力,18,5,13,群益金鼎-桃園,2024-08-07,9189
3037,欣興,33,20,13,群益金鼎-桃園,2024-08-07,9189
3711,日月光投控,18,5,13,群益金鼎-桃園,2024-08-07,9189
6692,進能服,12,0,12,群益金鼎-桃園,2024-08-07,9189
2615,萬海,58,46,12,群益金鼎-桃園,2024-08-07,9189
00934,中信成長高股息,142,131,11,群益金鼎-桃園,2024-08-07,9189
8076,伍豐,10,0,10,群益金鼎-桃園,2024-08-07,9189
00942B,台新美A公司債20+,10,0,10,群益金鼎-桃園,2024-08-07,9189
2382,廣達,34,25,9,群益金鼎-桃園,2024-08-07,9189
00641R,富邦日本反1,9,0,9,群益金鼎-桃園,2024-08-07,9189
6683,雍智科技,9,0,9,群益金鼎-桃園,2024-08-07,9189
3672,康聯訊,9,0,9,群益金鼎-桃園,2024-08-07,9189
6488,環球晶,10,2,8,群益金鼎-桃園,2024-08-07,9189
6213,聯茂,15,7,8,群益金鼎-桃園,2024-08-07,9189
6264,富裔,10,2,8,群益金鼎-桃園,2024-08-07,9189
00933B,國泰10Y+金融債,8,0,8,群益金鼎-桃園,2024-08-07,9189
1513,中興電,10,3,7,群益金鼎-桃園,2024-08-07,9189
3105,穩懋,8,1,7,群益金鼎-桃園,2024-08-07,9189
00937B,群益ESG投等債20,250,3,247,群益金鼎-桃園,2024-08-08,9189
00680L,元大美債20正2,192,6,186,群益金鼎-桃園,2024-08-08,9189
00929,復華台灣科技優息,182,8,174,群益金鼎-桃園,2024-08-08,9189
00919,群益台灣精選高息,143,12,131,群益金鼎-桃園,2024-08-08,9189
6153,嘉聯益,106,0,106,群益金鼎-桃園,2024-08-08,9189
2317,鴻海,130,42,88,群益金鼎-桃園,2024-08-08,9189
00720B,元大投資級公司債,88,3,85,群益金鼎-桃園,2024-08-08,9189
00751B,元大AAA至A公司債,85,0,85,群益金鼎-桃園,2024-08-08,9189
00940,元大台灣價值高息,97,26,71,群益金鼎-桃園,2024-08-08,9189
00664R,國泰臺灣加權反1,56,0,56,群益金鼎-桃園,2024-08-08,9189
8043,蜜望實,73,18,55,群益金鼎-桃園,2024-08-08,9189
2888,新光金,50,3,47,群益金鼎-桃園,2024-08-08,9189
2891,中信金,63,21,42,群益金鼎-桃園,2024-08-08,9189
00715L,期街口布蘭特正2,60,18,42,群益金鼎-桃園,2024-08-08,9189
2886,兆豐金,39,0,39,群益金鼎-桃園,2024-08-08,9189
3231,緯創,41,3,38,群益金鼎-桃園,2024-08-08,9189
2609,陽明,42,11,31,群益金鼎-桃園,2024-08-08,9189
00878,國泰永續高股息,34,3,31,群益金鼎-桃園,2024-08-08,9189
00942B,台新美A公司債20+,30,0,30,群益金鼎-桃園,2024-08-08,9189
8299,群聯,31,1,30,群益金鼎-桃園,2024-08-08,9189
2883,凱基金,52,23,29,群益金鼎-桃園,2024-08-08,9189
00688L,國泰20年美債正2,37,10,27,群益金鼎-桃園,2024-08-08,9189
2330,台積電,47,23,24,群益金鼎-桃園,2024-08-08,9189
00933B,國泰10Y+金融債,24,1,23,群益金鼎-桃園,2024-08-08,9189
3535,晶彩科,23,0,23,群益金鼎-桃園,2024-08-08,9189
6005,群益證,20,0,20,群益金鼎-桃園,2024-08-08,9189
5530,龍巖,20,0,20,群益金鼎-桃園,2024-08-08,9189
00915,凱基優選高股息30,17,0,17,群益金鼎-桃園,2024-08-08,9189
00687B,國泰20年美債,20,3,17,群益金鼎-桃園,2024-08-08,9189
2528,皇普,16,0,16,群益金鼎-桃園,2024-08-08,9189
2537,聯上發,27,12,15,群益金鼎-桃園,2024-08-08,9189
1301,台塑,15,1,14,群益金鼎-桃園,2024-08-08,9189
2382,廣達,27,14,13,群益金鼎-桃園,2024-08-08,9189
2892,第一金,13,0,13,群益金鼎-桃園,2024-08-08,9189
4716,大立,13,0,13,群益金鼎-桃園,2024-08-08,9189
00948B,中信優息投資級債,13,0,13,群益金鼎-桃園,2024-08-08,9189
6603,富強鑫,21,8,13,群益金鼎-桃園,2024-08-08,9189
00881,國泰台灣5G+,12,0,12,群益金鼎-桃園,2024-08-08,9189
2227,裕日車,12,0,12,群益金鼎-桃園,2024-08-08,9189
2618,長榮航,11,0,11,群益金鼎-桃園,2024-08-08,9189
2353,宏��,11,0,11,群益金鼎-桃園,2024-08-08,9189
3339,泰谷,11,0,11,群益金鼎-桃園,2024-08-08,9189
2915,潤泰全,11,0,11,群益金鼎-桃園,2024-08-08,9189
8926,台汽電,11,0,11,群益金鼎-桃園,2024-08-08,9189
2362,藍天,14,3,11,群益金鼎-桃園,2024-08-08,9189
6016,康和證,11,0,11,群益金鼎-桃園,2024-08-08,9189
3048,益登,16,5,11,群益金鼎-桃園,2024-08-08,9189
2464,盟立,46,35,11,群益金鼎-桃園,2024-08-08,9189
00665L,富邦�琤肭磪囓�2,10,0,10,群益金鼎-桃園,2024-08-08,9189
9906,欣巴巴,30,20,10,群益金鼎-桃園,2024-08-08,9189
00632R,元大台灣50反1,2377,89,2288,群益金鼎-桃園,2024-08-09,9189
00929,復華台灣科技優息,966,205,761,群益金鼎-桃園,2024-08-09,9189
00680L,元大美債20正2,741,40,701,群益金鼎-桃園,2024-08-09,9189
00937B,群益ESG投等債20,157,7,150,群益金鼎-桃園,2024-08-09,9189
00664R,國泰臺灣加權反1,147,0,147,群益金鼎-桃園,2024-08-09,9189
00942B,台新美A公司債20+,80,0,80,群益金鼎-桃園,2024-08-09,9189
2886,兆豐金,87,20,67,群益金鼎-桃園,2024-08-09,9189
00665L,富邦�琤肭磪囓�2,73,13,60,群益金鼎-桃園,2024-08-09,9189
00686R,群益臺灣加權反1,60,0,60,群益金鼎-桃園,2024-08-09,9189
00919,群益台灣精選高息,81,23,58,群益金鼎-桃園,2024-08-09,9189
00918,大華優利高填息30,39,1,38,群益金鼎-桃園,2024-08-09,9189
00720B,元大投資級公司債,43,5,38,群益金鼎-桃園,2024-08-09,9189
4510,高鋒,37,2,35,群益金鼎-桃園,2024-08-09,9189
00948B,中信優息投資級債,32,0,32,群益金鼎-桃園,2024-08-09,9189
00715L,期街口布蘭特正2,64,33,31,群益金鼎-桃園,2024-08-09,9189
2883B,凱基金乙特,30,0,30,群益金鼎-桃園,2024-08-09,9189
4401,東隆興,30,0,30,群益金鼎-桃園,2024-08-09,9189
00936,台新永續高息中小,29,0,29,群益金鼎-桃園,2024-08-09,9189
3024,憶聲,27,0,27,群益金鼎-桃園,2024-08-09,9189
5880,合庫金,26,0,26,群益金鼎-桃園,2024-08-09,9189
00878,國泰永續高股息,43,17,26,群益金鼎-桃園,2024-08-09,9189
3260,威剛,42,17,25,群益金鼎-桃園,2024-08-09,9189
3231,緯創,65,42,23,群益金鼎-桃園,2024-08-09,9189
00940,元大台灣價值高息,66,45,21,群益金鼎-桃園,2024-08-09,9189
00679B,元大美債20年,37,17,20,群益金鼎-桃園,2024-08-09,9189
2392,正崴,67,47,20,群益金鼎-桃園,2024-08-09,9189
1536,和大,24,5,19,群益金鼎-桃園,2024-08-09,9189
00830,國泰費城半導體,19,0,19,群益金鼎-桃園,2024-08-09,9189
5484,慧友,17,0,17,群益金鼎-桃園,2024-08-09,9189
2349,錸德,37,21,16,群益金鼎-桃園,2024-08-09,9189
8089,康全電訊,15,0,15,群益金鼎-桃園,2024-08-09,9189
4555,氣立,15,0,15,群益金鼎-桃園,2024-08-09,9189
4916,事欣科,15,0,15,群益金鼎-桃園,2024-08-09,9189
3234,光環,14,0,14,群益金鼎-桃園,2024-08-09,9189
00946,群益科技高息成長,18,4,14,群益金鼎-桃園,2024-08-09,9189
8096,擎亞,21,7,14,群益金鼎-桃園,2024-08-09,9189
2636,台驊控股,14,0,14,群益金鼎-桃園,2024-08-09,9189
8021,尖點,16,3,13,群益金鼎-桃園,2024-08-09,9189
6152,百一,13,0,13,群益金鼎-桃園,2024-08-09,9189
6213,聯茂,26,13,13,群益金鼎-桃園,2024-08-09,9189
00725B,國泰投資級公司債,12,0,12,群益金鼎-桃園,2024-08-09,9189
3019,亞光,60,48,12,群益金鼎-桃園,2024-08-09,9189
2359,所羅門,21,9,12,群益金鼎-桃園,2024-08-09,9189
6285,啟��,12,1,11,群益金鼎-桃園,2024-08-09,9189
2313,華通,25,14,11,群益金鼎-桃園,2024-08-09,9189
00751B,元大AAA至A公司債,11,0,11,群益金鼎-桃園,2024-08-09,9189
1785,光洋科,18,7,11,群益金鼎-桃園,2024-08-09,9189
0052,富邦科技,10,0,10,群益金鼎-桃園,2024-08-09,9189
4956,光鋐,11,1,10,群益金鼎-桃園,2024-08-09,9189
00655L,國泰中國A50正2,10,0,10,群益金鼎-桃園,2024-08-09,9189
00632R,元大台灣50反1,534,121,413,群益金鼎-桃園,2024-08-12,9189
2883,凱基金,304,21,283,群益金鼎-桃園,2024-08-12,9189
00948B,中信優息投資級債,268,0,268,群益金鼎-桃園,2024-08-12,9189
00673R,期元大S＆P原油反1,199,0,199,群益金鼎-桃園,2024-08-12,9189
9934,成霖,155,0,155,群益金鼎-桃園,2024-08-12,9189
2317,鴻海,153,44,109,群益金鼎-桃園,2024-08-12,9189
00679B,元大美債20年,86,0,86,群益金鼎-桃園,2024-08-12,9189
2062,橋椿,84,0,84,群益金鼎-桃園,2024-08-12,9189
00680L,元大美債20正2,113,55,58,群益金鼎-桃園,2024-08-12,9189
1527,鑽全,62,5,57,群益金鼎-桃園,2024-08-12,9189
2002,中鋼,41,0,41,群益金鼎-桃園,2024-08-12,9189
8390,金益鼎,38,0,38,群益金鼎-桃園,2024-08-12,9189
4562,穎漢,48,10,38,群益金鼎-桃園,2024-08-12,9189
2312,金寶,72,36,36,群益金鼎-桃園,2024-08-12,9189
00687B,國泰20年美債,31,0,31,群益金鼎-桃園,2024-08-12,9189
00688L,國泰20年美債正2,29,0,29,群益金鼎-桃園,2024-08-12,9189
00664R,國泰臺灣加權反1,25,0,25,群益金鼎-桃園,2024-08-12,9189
00929,復華台灣科技優息,96,75,21,群益金鼎-桃園,2024-08-12,9189
2883B,凱基金乙特,20,0,20,群益金鼎-桃園,2024-08-12,9189
3535,晶彩科,23,4,19,群益金鼎-桃園,2024-08-12,9189
3518,柏騰,23,4,19,群益金鼎-桃園,2024-08-12,9189
8105,凌巨,21,3,18,群益金鼎-桃園,2024-08-12,9189
00946,群益科技高息成長,22,5,17,群益金鼎-桃園,2024-08-12,9189
00900,富邦特選高股息30,16,0,16,群益金鼎-桃園,2024-08-12,9189
6179,亞通,15,0,15,群益金鼎-桃園,2024-08-12,9189
2891,中信金,13,0,13,群益金鼎-桃園,2024-08-12,9189
2880,華南金,14,1,13,群益金鼎-桃園,2024-08-12,9189
2464,盟立,67,55,12,群益金鼎-桃園,2024-08-12,9189
3581,博磊,14,2,12,群益金鼎-桃園,2024-08-12,9189
1301,台塑,12,0,12,群益金鼎-桃園,2024-08-12,9189
2495,普安,13,1,12,群益金鼎-桃園,2024-08-12,9189
4513,福裕,46,34,12,群益金鼎-桃園,2024-08-12,9189
2409,友達,33,21,12,群益金鼎-桃園,2024-08-12,9189
2497,怡利電,13,1,12,群益金鼎-桃園,2024-08-12,9189
1309,台達化,12,0,12,群益金鼎-桃園,2024-08-12,9189
2801,彰銀,11,0,11,群益金鼎-桃園,2024-08-12,9189
4510,高鋒,13,2,11,群益金鼎-桃園,2024-08-12,9189
6116,彩晶,11,0,11,群益金鼎-桃園,2024-08-12,9189
4114,健喬,10,0,10,群益金鼎-桃園,2024-08-12,9189
8374,羅昇,47,37,10,群益金鼎-桃園,2024-08-12,9189
00931B,統一美債20年,10,0,10,群益金鼎-桃園,2024-08-12,9189
2359,所羅門,34,24,10,群益金鼎-桃園,2024-08-12,9189
5443,均豪,14,4,10,群益金鼎-桃園,2024-08-12,9189
1513,中興電,24,14,10,群益金鼎-桃園,2024-08-12,9189
00690,兆豐藍籌30,10,0,10,群益金鼎-桃園,2024-08-12,9189
1528,恩德,9,0,9,群益金鼎-桃園,2024-08-12,9189
3024,憶聲,12,3,9,群益金鼎-桃園,2024-08-12,9189
3708,上緯投控,10,1,9,群益金鼎-桃園,2024-08-12,9189
8299,群聯,10,1,9,群益金鼎-桃園,2024-08-12,9189
2489,瑞軒,51,42,9,群益金鼎-桃園,2024-08-12,9189
2883,凱基金,228,4,224,群益金鼎-桃園,2024-08-13,9189
00632R,元大台灣50反1,209,0,209,群益金鼎-桃園,2024-08-13,9189
1806,冠軍,80,0,80,群益金鼎-桃園,2024-08-13,9189
2880,華南金,78,0,78,群益金鼎-桃園,2024-08-13,9189
3576,聯合再生,77,0,77,群益金鼎-桃園,2024-08-13,9189
00948B,中信優息投資級債,71,0,71,群益金鼎-桃園,2024-08-13,9189
00712,復華富時不動產,64,0,64,群益金鼎-桃園,2024-08-13,9189
00679B,元大美債20年,64,1,63,群益金鼎-桃園,2024-08-13,9189
3303,岱稜,58,8,50,群益金鼎-桃園,2024-08-13,9189
00919,群益台灣精選高息,46,4,42,群益金鼎-桃園,2024-08-13,9189
00688L,國泰20年美債正2,51,10,41,群益金鼎-桃園,2024-08-13,9189
2610,華航,45,5,40,群益金鼎-桃園,2024-08-13,9189
6215,和椿,75,37,38,群益金鼎-桃園,2024-08-13,9189
00937B,群益ESG投等債20,36,3,33,群益金鼎-桃園,2024-08-13,9189
00881,國泰台灣5G+,33,1,32,群益金鼎-桃園,2024-08-13,9189
00878,國泰永續高股息,44,18,26,群益金鼎-桃園,2024-08-13,9189
2489,瑞軒,30,4,26,群益金鼎-桃園,2024-08-13,9189
2002,中鋼,33,10,23,群益金鼎-桃園,2024-08-13,9189
5880,合庫金,22,0,22,群益金鼎-桃園,2024-08-13,9189
2886,兆豐金,21,0,21,群益金鼎-桃園,2024-08-13,9189
8105,凌巨,21,0,21,群益金鼎-桃園,2024-08-13,9189
00929,復華台灣科技優息,73,53,20,群益金鼎-桃園,2024-08-13,9189
2208,台船,20,1,19,群益金鼎-桃園,2024-08-13,9189
1513,中興電,37,19,18,群益金鼎-桃園,2024-08-13,9189
1314,中石化,18,0,18,群益金鼎-桃園,2024-08-13,9189
2609,陽明,65,49,16,群益金鼎-桃園,2024-08-13,9189
2883B,凱基金乙特,16,0,16,群益金鼎-桃園,2024-08-13,9189
6838,台新藥,16,0,16,群益金鼎-桃園,2024-08-13,9189
00936,台新永續高息中小,15,0,15,群益金鼎-桃園,2024-08-13,9189
6180,橘子,15,0,15,群益金鼎-桃園,2024-08-13,9189
2069,運錩,15,0,15,群益金鼎-桃園,2024-08-13,9189
2801,彰銀,14,0,14,群益金鼎-桃園,2024-08-13,9189
3691,碩禾,14,0,14,群益金鼎-桃園,2024-08-13,9189
1304,台聚,14,0,14,群益金鼎-桃園,2024-08-13,9189
9934,成霖,13,1,12,群益金鼎-桃園,2024-08-13,9189
00687B,國泰20年美債,12,0,12,群益金鼎-桃園,2024-08-13,9189
2537,聯上發,12,0,12,群益金鼎-桃園,2024-08-13,9189
3062,建漢,77,65,12,群益金鼎-桃園,2024-08-13,9189
2891,中信金,11,0,11,群益金鼎-桃園,2024-08-13,9189
00680L,元大美債20正2,24,13,11,群益金鼎-桃園,2024-08-13,9189
3048,益登,30,19,11,群益金鼎-桃園,2024-08-13,9189
2892,第一金,12,1,11,群益金鼎-桃園,2024-08-13,9189
00907,永豐優息存股,11,0,11,群益金鼎-桃園,2024-08-13,9189
3593,力銘,11,0,11,群益金鼎-桃園,2024-08-13,9189
2834,臺企銀,11,0,11,群益金鼎-桃園,2024-08-13,9189
4716,大立,20,9,11,群益金鼎-桃園,2024-08-13,9189
3037,欣興,37,27,10,群益金鼎-桃園,2024-08-13,9189
2359,所羅門,97,87,10,群益金鼎-桃園,2024-08-13,9189
2009,第一銅,10,0,10,群益金鼎-桃園,2024-08-13,9189
00931B,統一美債20年,10,0,10,群益金鼎-桃園,2024-08-13,9189
00664R,國泰臺灣加權反1,220,0,220,群益金鼎-桃園,2024-08-14,9189
2324,仁寶,107,3,104,群益金鼎-桃園,2024-08-14,9189
00940,元大台灣價值高息,79,27,52,群益金鼎-桃園,2024-08-14,9189
00688L,國泰20年美債正2,50,0,50,群益金鼎-桃園,2024-08-14,9189
8105,凌巨,42,1,41,群益金鼎-桃園,2024-08-14,9189
00900,富邦特選高股息30,37,0,37,群益金鼎-桃園,2024-08-14,9189
00948B,中信優息投資級債,41,5,36,群益金鼎-桃園,2024-08-14,9189
00929,復華台灣科技優息,41,7,34,群益金鼎-桃園,2024-08-14,9189
4562,穎漢,84,52,32,群益金鼎-桃園,2024-08-14,9189
00679B,元大美債20年,50,20,30,群益金鼎-桃園,2024-08-14,9189
6152,百一,30,1,29,群益金鼎-桃園,2024-08-14,9189
2891,中信金,33,5,28,群益金鼎-桃園,2024-08-14,9189
00946,群益科技高息成長,27,1,26,群益金鼎-桃園,2024-08-14,9189
2801,彰銀,24,0,24,群益金鼎-桃園,2024-08-14,9189
3481,群創,33,12,21,群益金鼎-桃園,2024-08-14,9189
2506,太設,20,0,20,群益金鼎-桃園,2024-08-14,9189
00931B,統一美債20年,20,0,20,群益金鼎-桃園,2024-08-14,9189
3706,神達,20,0,20,群益金鼎-桃園,2024-08-14,9189
2365,昆盈,136,117,19,群益金鼎-桃園,2024-08-14,9189
2739,寒舍,18,0,18,群益金鼎-桃園,2024-08-14,9189
2312,金寶,22,4,18,群益金鼎-桃園,2024-08-14,9189
3006,晶豪科,20,2,18,群益金鼎-桃園,2024-08-14,9189
00881,國泰台灣5G+,17,0,17,群益金鼎-桃園,2024-08-14,9189
00932,兆豐永續高息等權,15,0,15,群益金鼎-桃園,2024-08-14,9189
2867,三商壽,16,1,15,群益金鼎-桃園,2024-08-14,9189
1708,東鹼,34,19,15,群益金鼎-桃園,2024-08-14,9189
1213,大飲,14,0,14,群益金鼎-桃園,2024-08-14,9189
2610,華航,18,4,14,群益金鼎-桃園,2024-08-14,9189
3580,友威科,28,14,14,群益金鼎-桃園,2024-08-14,9189
3062,建漢,27,14,13,群益金鼎-桃園,2024-08-14,9189
1101,台泥,14,2,12,群益金鼎-桃園,2024-08-14,9189
00891,中信關鍵半導體,16,4,12,群益金鼎-桃園,2024-08-14,9189
1569,濱川,12,0,12,群益金鼎-桃園,2024-08-14,9189
00687B,國泰20年美債,13,1,12,群益金鼎-桃園,2024-08-14,9189
2356,英業達,45,33,12,群益金鼎-桃園,2024-08-14,9189
4534,慶騰,14,2,12,群益金鼎-桃園,2024-08-14,9189
00936,台新永續高息中小,11,0,11,群益金鼎-桃園,2024-08-14,9189
4513,福裕,27,16,11,群益金鼎-桃園,2024-08-14,9189
00712,復華富時不動產,11,0,11,群益金鼎-桃園,2024-08-14,9189
00671R,富邦NASDAQ反1,10,0,10,群益金鼎-桃園,2024-08-14,9189
4916,事欣科,10,0,10,群益金鼎-桃園,2024-08-14,9189
3576,聯合再生,20,10,10,群益金鼎-桃園,2024-08-14,9189
2337,旺宏,12,2,10,群益金鼎-桃園,2024-08-14,9189
5512,力麒,10,0,10,群益金鼎-桃園,2024-08-14,9189
1442,名軒,10,0,10,群益金鼎-桃園,2024-08-14,9189
00945B,凱基美國非投等債,10,0,10,群益金鼎-桃園,2024-08-14,9189
6664,群翊,10,0,10,群益金鼎-桃園,2024-08-14,9189
2401,凌陽,22,12,10,群益金鼎-桃園,2024-08-14,9189
4561,健椿,14,4,10,群益金鼎-桃園,2024-08-14,9189
6695,芯鼎,14,4,10,群益金鼎-桃園,2024-08-14,9189
2888,新光金,1000,55,945,群益金鼎-桃園,2024-08-15,9189
00664R,國泰臺灣加權反1,251,0,251,群益金鼎-桃園,2024-08-15,9189
00632R,元大台灣50反1,171,39,132,群益金鼎-桃園,2024-08-15,9189
00878,國泰永續高股息,113,16,97,群益金鼎-桃園,2024-08-15,9189
00687B,國泰20年美債,87,0,87,群益金鼎-桃園,2024-08-15,9189
00900,富邦特選高股息30,80,0,80,群益金鼎-桃園,2024-08-15,9189
2489,瑞軒,136,65,71,群益金鼎-桃園,2024-08-15,9189
00688L,國泰20年美債正2,63,0,63,群益金鼎-桃園,2024-08-15,9189
9945,潤泰新,66,8,58,群益金鼎-桃園,2024-08-15,9189
00945B,凱基美國非投等債,50,0,50,群益金鼎-桃園,2024-08-15,9189
00929,復華台灣科技優息,40,3,37,群益金鼎-桃園,2024-08-15,9189
2886,兆豐金,36,0,36,群益金鼎-桃園,2024-08-15,9189
00679B,元大美債20年,43,12,31,群益金鼎-桃園,2024-08-15,9189
00936,台新永續高息中小,28,0,28,群益金鼎-桃園,2024-08-15,9189
1101,台泥,33,6,27,群益金鼎-桃園,2024-08-15,9189
2352,佳世達,29,2,27,群益金鼎-桃園,2024-08-15,9189
9105,泰金寶-DR,27,2,25,群益金鼎-桃園,2024-08-15,9189
1513,中興電,39,15,24,群益金鼎-桃園,2024-08-15,9189
1802,台玻,25,2,23,群益金鼎-桃園,2024-08-15,9189
00923,群益台ESG低碳50,34,12,22,群益金鼎-桃園,2024-08-15,9189
1514,亞力,23,1,22,群益金鼎-桃園,2024-08-15,9189
2002,中鋼,24,2,22,群益金鼎-桃園,2024-08-15,9189
5512,力麒,20,0,20,群益金鼎-桃園,2024-08-15,9189
2820,華票,20,0,20,群益金鼎-桃園,2024-08-15,9189
2520,冠德,28,8,20,群益金鼎-桃園,2024-08-15,9189
6152,百一,20,0,20,群益金鼎-桃園,2024-08-15,9189
4561,健椿,52,35,17,群益金鼎-桃園,2024-08-15,9189
2884,玉山金,23,6,17,群益金鼎-桃園,2024-08-15,9189
00655L,國泰中國A50正2,15,0,15,群益金鼎-桃園,2024-08-15,9189
2062,橋椿,26,11,15,群益金鼎-桃園,2024-08-15,9189
2801,彰銀,14,1,13,群益金鼎-桃園,2024-08-15,9189
00881,國泰台灣5G+,22,9,13,群益金鼎-桃園,2024-08-15,9189
00933B,國泰10Y+金融債,13,0,13,群益金鼎-桃園,2024-08-15,9189
3374,精材,18,5,13,群益金鼎-桃園,2024-08-15,9189
2834,臺企銀,13,0,13,群益金鼎-桃園,2024-08-15,9189
4566,時碩工業,37,24,13,群益金鼎-桃園,2024-08-15,9189
2014,中鴻,16,4,12,群益金鼎-桃園,2024-08-15,9189
8374,羅昇,31,19,12,群益金鼎-桃園,2024-08-15,9189
2543,皇昌,11,0,11,群益金鼎-桃園,2024-08-15,9189
6461,益得,11,0,11,群益金鼎-桃園,2024-08-15,9189
3580,友威科,31,20,11,群益金鼎-桃園,2024-08-15,9189
2903,遠百,11,0,11,群益金鼎-桃園,2024-08-15,9189
00915,凱基優選高股息30,11,0,11,群益金鼎-桃園,2024-08-15,9189
3047,訊舟,30,19,11,群益金鼎-桃園,2024-08-15,9189
2464,盟立,13,3,10,群益金鼎-桃園,2024-08-15,9189
6139,亞翔,15,5,10,群益金鼎-桃園,2024-08-15,9189
00712,復華富時不動產,10,0,10,群益金鼎-桃園,2024-08-15,9189
1477,聚陽,10,0,10,群益金鼎-桃園,2024-08-15,9189
6116,彩晶,10,0,10,群益金鼎-桃園,2024-08-15,9189
2539,櫻花建,10,0,10,群益金鼎-桃園,2024-08-15,9189
2888,新光金,1251,15,1236,群益金鼎-桃園,2024-08-16,9189
00632R,元大台灣50反1,815,216,599,群益金鼎-桃園,2024-08-16,9189
00680L,元大美債20正2,473,55,418,群益金鼎-桃園,2024-08-16,9189
00664R,國泰臺灣加權反1,130,0,130,群益金鼎-桃園,2024-08-16,9189
2317,鴻海,147,23,124,群益金鼎-桃園,2024-08-16,9189
00936,台新永續高息中小,100,0,100,群益金鼎-桃園,2024-08-16,9189
00712,復華富時不動產,96,0,96,群益金鼎-桃園,2024-08-16,9189
00687B,國泰20年美債,84,0,84,群益金鼎-桃園,2024-08-16,9189
2887,台新金,50,0,50,群益金鼎-桃園,2024-08-16,9189
2365,昆盈,225,182,43,群益金鼎-桃園,2024-08-16,9189
2323,中環,80,44,36,群益金鼎-桃園,2024-08-16,9189
2062,橋椿,75,42,33,群益金鼎-桃園,2024-08-16,9189
3105,穩懋,34,1,33,群益金鼎-桃園,2024-08-16,9189
00945B,凱基美國非投等債,60,30,30,群益金鼎-桃園,2024-08-16,9189
00878,國泰永續高股息,46,16,30,群益金鼎-桃園,2024-08-16,9189
1326,台化,30,1,29,群益金鼎-桃園,2024-08-16,9189
1101,台泥,27,0,27,群益金鼎-桃園,2024-08-16,9189
8110,華東,25,0,25,群益金鼎-桃園,2024-08-16,9189
2609,陽明,32,7,25,群益金鼎-桃園,2024-08-16,9189
3284,太普高,24,0,24,群益金鼎-桃園,2024-08-16,9189
8096,擎亞,162,139,23,群益金鼎-桃園,2024-08-16,9189
3062,建漢,47,26,21,群益金鼎-桃園,2024-08-16,9189
4562,穎漢,91,72,19,群益金鼎-桃園,2024-08-16,9189
3712,永崴投控,21,4,17,群益金鼎-桃園,2024-08-16,9189
00795B,中信美國公債20年,16,0,16,群益金鼎-桃園,2024-08-16,9189
2401,凌陽,22,7,15,群益金鼎-桃園,2024-08-16,9189
2882,國泰金,25,10,15,群益金鼎-桃園,2024-08-16,9189
9934,成霖,16,1,15,群益金鼎-桃園,2024-08-16,9189
2367,燿華,27,13,14,群益金鼎-桃園,2024-08-16,9189
2610,華航,20,6,14,群益金鼎-桃園,2024-08-16,9189
00923,群益台ESG低碳50,12,0,12,群益金鼎-桃園,2024-08-16,9189
00933B,國泰10Y+金融債,12,0,12,群益金鼎-桃園,2024-08-16,9189
2002,中鋼,21,9,12,群益金鼎-桃園,2024-08-16,9189
2312,金寶,21,9,12,群益金鼎-桃園,2024-08-16,9189
00882,中信中國高股息,12,0,12,群益金鼎-桃園,2024-08-16,9189
3019,亞光,30,19,11,群益金鼎-桃園,2024-08-16,9189
2913,農林,12,1,11,群益金鼎-桃園,2024-08-16,9189
00948B,中信優息投資級債,10,0,10,群益金鼎-桃園,2024-08-16,9189
3207,耀勝,10,0,10,群益金鼎-桃園,2024-08-16,9189
6592,和潤企業,10,0,10,群益金鼎-桃園,2024-08-16,9189
6116,彩晶,50,40,10,群益金鼎-桃園,2024-08-16,9189
1609,大亞,16,6,10,群益金鼎-桃園,2024-08-16,9189
3312,弘憶股,13,5,8,群益金鼎-桃園,2024-08-16,9189
00688L,國泰20年美債正2,8,0,8,群益金鼎-桃園,2024-08-16,9189
5474,聰泰,12,4,8,群益金鼎-桃園,2024-08-16,9189
3535,晶彩科,16,8,8,群益金鼎-桃園,2024-08-16,9189
3038,全台,8,0,8,群益金鼎-桃園,2024-08-16,9189
00919,群益台灣精選高息,13,5,8,群益金鼎-桃園,2024-08-16,9189
3663,鑫科,47,40,7,群益金鼎-桃園,2024-08-16,9189
8054,安國,36,29,7,群益金鼎-桃園,2024-08-16,9189
2888,新光金,581,47,534,群益金鼎-桃園,2024-08-19,9189
00937B,群益ESG投等債20,606,400,206,群益金鼎-桃園,2024-08-19,9189
00680L,元大美債20正2,656,552,104,群益金鼎-桃園,2024-08-19,9189
00687B,國泰20年美債,98,15,83,群益金鼎-桃園,2024-08-19,9189
2365,昆盈,136,61,75,群益金鼎-桃園,2024-08-19,9189
00929,復華台灣科技優息,132,65,67,群益金鼎-桃園,2024-08-19,9189
00933B,國泰10Y+金融債,69,20,49,群益金鼎-桃園,2024-08-19,9189
2002,中鋼,39,0,39,群益金鼎-桃園,2024-08-19,9189
8028,昇陽半導體,51,17,34,群益金鼎-桃園,2024-08-19,9189
1785,光洋科,45,14,31,群益金鼎-桃園,2024-08-19,9189
3058,立德,30,0,30,群益金鼎-桃園,2024-08-19,9189
00948B,中信優息投資級債,27,0,27,群益金鼎-桃園,2024-08-19,9189
1449,佳和,49,24,25,群益金鼎-桃園,2024-08-19,9189
1802,台玻,21,0,21,群益金鼎-桃園,2024-08-19,9189
2359,所羅門,63,44,19,群益金鼎-桃園,2024-08-19,9189
2354,鴻準,20,2,18,群益金鼎-桃園,2024-08-19,9189
3047,訊舟,92,74,18,群益金鼎-桃園,2024-08-19,9189
6658,聯策,23,5,18,群益金鼎-桃園,2024-08-19,9189
6806,森崴能源,20,2,18,群益金鼎-桃園,2024-08-19,9189
3231,緯創,18,0,18,群益金鼎-桃園,2024-08-19,9189
2882,國泰金,17,1,16,群益金鼎-桃園,2024-08-19,9189
2891,中信金,30,15,15,群益金鼎-桃園,2024-08-19,9189
2615,萬海,15,0,15,群益金鼎-桃園,2024-08-19,9189
5371,中光電,23,8,15,群益金鼎-桃園,2024-08-19,9189
2405,輔信,14,0,14,群益金鼎-桃園,2024-08-19,9189
3062,建漢,36,22,14,群益金鼎-桃園,2024-08-19,9189
4576,大銀微系統,16,2,14,群益金鼎-桃園,2024-08-19,9189
1513,中興電,19,5,14,群益金鼎-桃園,2024-08-19,9189
6609,瀧澤科,25,12,13,群益金鼎-桃園,2024-08-19,9189
6133,金橋,15,2,13,群益金鼎-桃園,2024-08-19,9189
00945B,凱基美國非投等債,13,0,13,群益金鼎-桃園,2024-08-19,9189
1101,台泥,13,1,12,群益金鼎-桃園,2024-08-19,9189
2881,富邦金,16,4,12,群益金鼎-桃園,2024-08-19,9189
2610,華航,17,5,12,群益金鼎-桃園,2024-08-19,9189
2303,聯電,30,18,12,群益金鼎-桃園,2024-08-19,9189
4906,正文,18,7,11,群益金鼎-桃園,2024-08-19,9189
2323,中環,51,40,11,群益金鼎-桃園,2024-08-19,9189
2453,凌群,11,0,11,群益金鼎-桃園,2024-08-19,9189
00946,群益科技高息成長,10,0,10,群益金鼎-桃園,2024-08-19,9189
6770,力積電,10,0,10,群益金鼎-桃園,2024-08-19,9189
2344,華邦電,21,11,10,群益金鼎-桃園,2024-08-19,9189
3207,耀勝,10,0,10,群益金鼎-桃園,2024-08-19,9189
2704,國賓,10,0,10,群益金鼎-桃園,2024-08-19,9189
3188,鑫龍騰,10,0,10,群益金鼎-桃園,2024-08-19,9189
6015,宏遠證,10,0,10,群益金鼎-桃園,2024-08-19,9189
3528,安馳,10,0,10,群益金鼎-桃園,2024-08-19,9189
8076,伍豐,10,0,10,群益金鼎-桃園,2024-08-19,9189
2537,聯上發,32,23,9,群益金鼎-桃園,2024-08-19,9189
00795B,中信美國公債20年,10,1,9,群益金鼎-桃園,2024-08-19,9189
2883,凱基金,36,27,9,群益金鼎-桃園,2024-08-19,9189
00937B,群益ESG投等債20,1010,0,1010,群益金鼎-桃園,2024-08-20,9189
00680L,元大美債20正2,600,60,540,群益金鼎-桃園,2024-08-20,9189
2352,佳世達,207,0,207,群益金鼎-桃園,2024-08-20,9189
00936,台新永續高息中小,168,0,168,群益金鼎-桃園,2024-08-20,9189
00929,復華台灣科技優息,110,7,103,群益金鼎-桃園,2024-08-20,9189
00687B,國泰20年美債,89,1,88,群益金鼎-桃園,2024-08-20,9189
00679B,元大美債20年,76,3,73,群益金鼎-桃園,2024-08-20,9189
2356,英業達,85,15,70,群益金鼎-桃園,2024-08-20,9189
00900,富邦特選高股息30,60,1,59,群益金鼎-桃園,2024-08-20,9189
00919,群益台灣精選高息,79,21,58,群益金鼎-桃園,2024-08-20,9189
00940,元大台灣價值高息,88,33,55,群益金鼎-桃園,2024-08-20,9189
00878,國泰永續高股息,59,5,54,群益金鼎-桃園,2024-08-20,9189
00934,中信成長高股息,51,0,51,群益金鼎-桃園,2024-08-20,9189
00927,群益半導體收益,50,3,47,群益金鼎-桃園,2024-08-20,9189
1301,台塑,44,2,42,群益金鼎-桃園,2024-08-20,9189
2883,凱基金,69,33,36,群益金鼎-桃園,2024-08-20,9189
4534,慶騰,35,3,32,群益金鼎-桃園,2024-08-20,9189
00712,復華富時不動產,30,1,29,群益金鼎-桃園,2024-08-20,9189
2362,藍天,33,6,27,群益金鼎-桃園,2024-08-20,9189
00706L,期元大S＆P日圓正2,27,0,27,群益金鼎-桃園,2024-08-20,9189
00945B,凱基美國非投等債,25,0,25,群益金鼎-桃園,2024-08-20,9189
8070,長華*,25,2,23,群益金鼎-桃園,2024-08-20,9189
6265,方土昶,22,0,22,群益金鼎-桃園,2024-08-20,9189
2348,海悅,28,8,20,群益金鼎-桃園,2024-08-20,9189
5531,鄉林,18,0,18,群益金鼎-桃園,2024-08-20,9189
8064,東捷,112,94,18,群益金鼎-桃園,2024-08-20,9189
3047,訊舟,24,7,17,群益金鼎-桃園,2024-08-20,9189
3339,泰谷,18,1,17,群益金鼎-桃園,2024-08-20,9189
2516,新建,15,0,15,群益金鼎-桃園,2024-08-20,9189
2368,金像電,16,1,15,群益金鼎-桃園,2024-08-20,9189
2442,新美齊,15,0,15,群益金鼎-桃園,2024-08-20,9189
2891,中信金,15,1,14,群益金鼎-桃園,2024-08-20,9189
9907,統一實,14,0,14,群益金鼎-桃園,2024-08-20,9189
2002,中鋼,24,11,13,群益金鼎-桃園,2024-08-20,9189
4526,東台,18,5,13,群益金鼎-桃園,2024-08-20,9189
3188,鑫龍騰,14,1,13,群益金鼎-桃園,2024-08-20,9189
2312,金寶,29,16,13,群益金鼎-桃園,2024-08-20,9189
2323,中環,49,37,12,群益金鼎-桃園,2024-08-20,9189
2062,橋椿,23,11,12,群益金鼎-桃園,2024-08-20,9189
00933B,國泰10Y+金融債,11,0,11,群益金鼎-桃園,2024-08-20,9189
2459,敦吉,11,0,11,群益金鼎-桃園,2024-08-20,9189
2392,正崴,30,19,11,群益金鼎-桃園,2024-08-20,9189
6531,愛普*,12,1,11,群益金鼎-桃園,2024-08-20,9189
1314,中石化,11,0,11,群益金鼎-桃園,2024-08-20,9189
9904,寶成,11,0,11,群益金鼎-桃園,2024-08-20,9189
3019,亞光,39,29,10,群益金鼎-桃園,2024-08-20,9189
2101,南港,10,0,10,群益金鼎-桃園,2024-08-20,9189
2351,順德,16,7,9,群益金鼎-桃園,2024-08-20,9189
2405,輔信,19,10,9,群益金鼎-桃園,2024-08-20,9189
9945,潤泰新,40,31,9,群益金鼎-桃園,2024-08-20,9189
2888,新光金,838,325,513,群益金鼎-桃園,2024-08-21,9189
00953B,群益優選非投等債,264,20,244,群益金鼎-桃園,2024-08-21,9189
2891,中信金,150,17,133,群益金鼎-桃園,2024-08-21,9189
00937B,群益ESG投等債20,100,10,90,群益金鼎-桃園,2024-08-21,9189
2352,佳世達,91,2,89,群益金鼎-桃園,2024-08-21,9189
2371,大同,74,6,68,群益金鼎-桃園,2024-08-21,9189
00637L,元大滬深300正2,60,0,60,群益金鼎-桃園,2024-08-21,9189
2880,華南金,50,0,50,群益金鼎-桃園,2024-08-21,9189
2892,第一金,50,1,49,群益金鼎-桃園,2024-08-21,9189
8054,安國,41,3,38,群益金鼎-桃園,2024-08-21,9189
00632R,元大台灣50反1,82,44,38,群益金鼎-桃園,2024-08-21,9189
00679B,元大美債20年,37,0,37,群益金鼎-桃園,2024-08-21,9189
5905,南仁湖,94,59,35,群益金鼎-桃園,2024-08-21,9189
4960,誠美材,32,0,32,群益金鼎-桃園,2024-08-21,9189
8104,錸寶,34,6,28,群益金鼎-桃園,2024-08-21,9189
00900,富邦特選高股息30,24,0,24,群益金鼎-桃園,2024-08-21,9189
00878,國泰永續高股息,22,1,21,群益金鼎-桃園,2024-08-21,9189
3535,晶彩科,78,57,21,群益金鼎-桃園,2024-08-21,9189
00936,台新永續高息中小,21,0,21,群益金鼎-桃園,2024-08-21,9189
3581,博磊,19,0,19,群益金鼎-桃園,2024-08-21,9189
3580,友威科,42,24,18,群益金鼎-桃園,2024-08-21,9189
00687B,國泰20年美債,18,0,18,群益金鼎-桃園,2024-08-21,9189
00923,群益台ESG低碳50,16,0,16,群益金鼎-桃園,2024-08-21,9189
1301,台塑,16,0,16,群益金鼎-桃園,2024-08-21,9189
4563,百德,15,2,13,群益金鼎-桃園,2024-08-21,9189
2002,中鋼,22,9,13,群益金鼎-桃園,2024-08-21,9189
1711,永光,22,9,13,群益金鼎-桃園,2024-08-21,9189
8064,東捷,45,33,12,群益金鼎-桃園,2024-08-21,9189
6692,進能服,11,0,11,群益金鼎-桃園,2024-08-21,9189
2308,台達電,14,3,11,群益金鼎-桃園,2024-08-21,9189
1795,美時,11,1,10,群益金鼎-桃園,2024-08-21,9189
4903,聯光通,10,0,10,群益金鼎-桃園,2024-08-21,9189
00945B,凱基美國非投等債,10,0,10,群益金鼎-桃園,2024-08-21,9189
6757,台灣虎航,10,0,10,群益金鼎-桃園,2024-08-21,9189
00948B,中信優息投資級債,10,0,10,群益金鼎-桃園,2024-08-21,9189
5521,工信,20,10,10,群益金鼎-桃園,2024-08-21,9189
1409,新纖,11,1,10,群益金鼎-桃園,2024-08-21,9189
2365,昆盈,18,8,10,群益金鼎-桃園,2024-08-21,9189
6213,聯茂,11,1,10,群益金鼎-桃園,2024-08-21,9189
8076,伍豐,10,0,10,群益金鼎-桃園,2024-08-21,9189
6431,光麗-KY,10,0,10,群益金鼎-桃園,2024-08-21,9189
2610,華航,14,4,10,群益金鼎-桃園,2024-08-21,9189
6153,嘉聯益,10,0,10,群益金鼎-桃園,2024-08-21,9189
00720B,元大投資級公司債,10,0,10,群益金鼎-桃園,2024-08-21,9189
3372,典範,10,0,10,群益金鼎-桃園,2024-08-21,9189
3048,益登,11,2,9,群益金鼎-桃園,2024-08-21,9189
4979,華星光,36,27,9,群益金鼎-桃園,2024-08-21,9189
4510,高鋒,9,0,9,群益金鼎-桃園,2024-08-21,9189
2528,皇普,9,0,9,群益金鼎-桃園,2024-08-21,9189
2401,凌陽,10,1,9,群益金鼎-桃園,2024-08-21,9189
00929,復華台灣科技優息,173,1,172,群益金鼎-桃園,2024-08-22,9189
00680L,元大美債20正2,127,0,127,群益金鼎-桃園,2024-08-22,9189
00937B,群益ESG投等債20,135,16,119,群益金鼎-桃園,2024-08-22,9189
00919,群益台灣精選高息,120,12,108,群益金鼎-桃園,2024-08-22,9189
1514,亞力,117,19,98,群益金鼎-桃園,2024-08-22,9189
00725B,國泰投資級公司債,58,0,58,群益金鼎-桃園,2024-08-22,9189
00720B,元大投資級公司債,50,0,50,群益金鼎-桃園,2024-08-22,9189
00953B,群益優選非投等債,44,0,44,群益金鼎-桃園,2024-08-22,9189
2317,鴻海,50,7,43,群益金鼎-桃園,2024-08-22,9189
2349,錸德,502,470,32,群益金鼎-桃園,2024-08-22,9189
2610,華航,26,0,26,群益金鼎-桃園,2024-08-22,9189
6461,益得,25,0,25,群益金鼎-桃園,2024-08-22,9189
00715L,期街口布蘭特正2,24,0,24,群益金鼎-桃園,2024-08-22,9189
2528,皇普,24,0,24,群益金鼎-桃園,2024-08-22,9189
2891,中信金,54,31,23,群益金鼎-桃園,2024-08-22,9189
5521,工信,20,0,20,群益金鼎-桃園,2024-08-22,9189
1570,力肯,20,0,20,群益金鼎-桃園,2024-08-22,9189
00939,統一台灣高息動能,20,0,20,群益金鼎-桃園,2024-08-22,9189
1584,精剛,60,40,20,群益金鼎-桃園,2024-08-22,9189
2348,海悅,39,20,19,群益金鼎-桃園,2024-08-22,9189
6139,亞翔,17,1,16,群益金鼎-桃園,2024-08-22,9189
1442,名軒,15,0,15,群益金鼎-桃園,2024-08-22,9189
2344,華邦電,20,6,14,群益金鼎-桃園,2024-08-22,9189
00940,元大台灣價值高息,29,15,14,群益金鼎-桃園,2024-08-22,9189
8064,東捷,25,11,14,群益金鼎-桃園,2024-08-22,9189
2890,永豐金,32,19,13,群益金鼎-桃園,2024-08-22,9189
6156,松上,19,7,12,群益金鼎-桃園,2024-08-22,9189
3048,益登,12,0,12,群益金鼎-桃園,2024-08-22,9189
00923,群益台ESG低碳50,11,0,11,群益金鼎-桃園,2024-08-22,9189
6125,廣運,27,16,11,群益金鼎-桃園,2024-08-22,9189
00907,永豐優息存股,11,0,11,群益金鼎-桃園,2024-08-22,9189
2371,大同,15,4,11,群益金鼎-桃園,2024-08-22,9189
8054,安國,11,1,10,群益金鼎-桃園,2024-08-22,9189
3078,僑威,10,0,10,群益金鼎-桃園,2024-08-22,9189
1101,台泥,11,1,10,群益金鼎-桃園,2024-08-22,9189
3374,精材,22,12,10,群益金鼎-桃園,2024-08-22,9189
8358,金居,11,2,9,群益金鼎-桃園,2024-08-22,9189
00679B,元大美債20年,12,3,9,群益金鼎-桃園,2024-08-22,9189
3673,TPK-KY,9,0,9,群益金鼎-桃園,2024-08-22,9189
4562,穎漢,19,11,8,群益金鼎-桃園,2024-08-22,9189
2489,瑞軒,8,0,8,群益金鼎-桃園,2024-08-22,9189
4564,元翎,9,1,8,群益金鼎-桃園,2024-08-22,9189
2330,台積電,14,6,8,群益金鼎-桃園,2024-08-22,9189
1717,長興,8,1,7,群益金鼎-桃園,2024-08-22,9189
00900,富邦特選高股息30,7,0,7,群益金鼎-桃園,2024-08-22,9189
3013,晟銘電,13,6,7,群益金鼎-桃園,2024-08-22,9189
2208,台船,8,1,7,群益金鼎-桃園,2024-08-22,9189
2382,廣達,6,0,6,群益金鼎-桃園,2024-08-22,9189
2465,麗臺,6,0,6,群益金鼎-桃園,2024-08-22,9189
6770,力積電,6,0,6,群益金鼎-桃園,2024-08-22,9189
2867,三商壽,411,22,389,群益金鼎-桃園,2024-08-23,9189
2409,友達,217,15,202,群益金鼎-桃園,2024-08-23,9189
2913,農林,176,0,176,群益金鼎-桃園,2024-08-23,9189
00948B,中信優息投資級債,90,0,90,群益金鼎-桃園,2024-08-23,9189
1314,中石化,58,16,42,群益金鼎-桃園,2024-08-23,9189
5443,均豪,103,64,39,群益金鼎-桃園,2024-08-23,9189
00679B,元大美債20年,40,3,37,群益金鼎-桃園,2024-08-23,9189
00919,群益台灣精選高息,35,1,34,群益金鼎-桃園,2024-08-23,9189
00632R,元大台灣50反1,94,62,32,群益金鼎-桃園,2024-08-23,9189
00878,國泰永續高股息,31,0,31,群益金鼎-桃園,2024-08-23,9189
4729,熒茂,38,7,31,群益金鼎-桃園,2024-08-23,9189
1785,光洋科,51,21,30,群益金鼎-桃園,2024-08-23,9189
00687B,國泰20年美債,29,0,29,群益金鼎-桃園,2024-08-23,9189
2609,陽明,33,5,28,群益金鼎-桃園,2024-08-23,9189
00929,復華台灣科技優息,34,9,25,群益金鼎-桃園,2024-08-23,9189
00940,元大台灣價值高息,49,25,24,群益金鼎-桃園,2024-08-23,9189
3535,晶彩科,32,11,21,群益金鼎-桃園,2024-08-23,9189
3576,聯合再生,20,0,20,群益金鼎-桃園,2024-08-23,9189
5521,工信,20,0,20,群益金鼎-桃園,2024-08-23,9189
1721,三晃,149,129,20,群益金鼎-桃園,2024-08-23,9189
6692,進能服,22,2,20,群益金鼎-桃園,2024-08-23,9189
1708,東鹼,26,7,19,群益金鼎-桃園,2024-08-23,9189
2891,中信金,51,33,18,群益金鼎-桃園,2024-08-23,9189
00881,國泰台灣5G+,17,0,17,群益金鼎-桃園,2024-08-23,9189
00937B,群益ESG投等債20,15,0,15,群益金鼎-桃園,2024-08-23,9189
00680L,元大美債20正2,15,0,15,群益金鼎-桃園,2024-08-23,9189
5452,佶優,14,0,14,群益金鼎-桃園,2024-08-23,9189
2528,皇普,14,0,14,群益金鼎-桃園,2024-08-23,9189
6191,精成科,13,0,13,群益金鼎-桃園,2024-08-23,9189
6156,松上,31,18,13,群益金鼎-桃園,2024-08-23,9189
2367,燿華,13,0,13,群益金鼎-桃園,2024-08-23,9189
2884,玉山金,13,0,13,群益金鼎-桃園,2024-08-23,9189
2880,華南金,12,0,12,群益金鼎-桃園,2024-08-23,9189
00923,群益台ESG低碳50,11,0,11,群益金鼎-桃園,2024-08-23,9189
4540,全球傳動,20,9,11,群益金鼎-桃園,2024-08-23,9189
2323,中環,11,0,11,群益金鼎-桃園,2024-08-23,9189
6470,宇智,11,0,11,群益金鼎-桃園,2024-08-23,9189
2547,日勝生,10,0,10,群益金鼎-桃園,2024-08-23,9189
2009,第一銅,10,0,10,群益金鼎-桃園,2024-08-23,9189
6235,華孚,10,0,10,群益金鼎-桃園,2024-08-23,9189
1303,南亞,10,0,10,群益金鼎-桃園,2024-08-23,9189
00706L,期元大S＆P日圓正2,10,0,10,群益金鼎-桃園,2024-08-23,9189
5345,天揚,10,0,10,群益金鼎-桃園,2024-08-23,9189
2101,南港,10,0,10,群益金鼎-桃園,2024-08-23,9189
6207,雷科,10,0,10,群益金鼎-桃園,2024-08-23,9189
1326,台化,9,0,9,群益金鼎-桃園,2024-08-23,9189
8085,福華,9,0,9,群益金鼎-桃園,2024-08-23,9189
6770,力積電,9,0,9,群益金鼎-桃園,2024-08-23,9189
00755B,群益投資級公用債,8,0,8,群益金鼎-桃園,2024-08-23,9189
8076,伍豐,10,2,8,群益金鼎-桃園,2024-08-23,9189
00632R,元大台灣50反1,372,17,355,群益金鼎-桃園,2024-08-26,9189
2888,新光金,682,352,330,群益金鼎-桃園,2024-08-26,9189
00937B,群益ESG投等債20,209,3,206,群益金鼎-桃園,2024-08-26,9189
00680L,元大美債20正2,153,10,143,群益金鼎-桃園,2024-08-26,9189
00948B,中信優息投資級債,100,0,100,群益金鼎-桃園,2024-08-26,9189
2352,佳世達,100,20,80,群益金鼎-桃園,2024-08-26,9189
00687B,國泰20年美債,76,2,74,群益金鼎-桃園,2024-08-26,9189
00931B,統一美債20年,66,1,65,群益金鼎-桃園,2024-08-26,9189
2891,中信金,77,13,64,群益金鼎-桃園,2024-08-26,9189
3171,炎洲流通,57,0,57,群益金鼎-桃園,2024-08-26,9189
00953B,群益優選非投等債,81,42,39,群益金鼎-桃園,2024-08-26,9189
2489,瑞軒,43,7,36,群益金鼎-桃園,2024-08-26,9189
00919,群益台灣精選高息,34,0,34,群益金鼎-桃園,2024-08-26,9189
1785,光洋科,36,7,29,群益金鼎-桃園,2024-08-26,9189
3450,聯鈞,24,1,23,群益金鼎-桃園,2024-08-26,9189
5452,佶優,23,1,22,群益金鼎-桃園,2024-08-26,9189
00720B,元大投資級公司債,22,0,22,群益金鼎-桃園,2024-08-26,9189
1711,永光,46,25,21,群益金鼎-桃園,2024-08-26,9189
2368,金像電,21,1,20,群益金鼎-桃園,2024-08-26,9189
00795B,中信美國公債20年,20,0,20,群益金鼎-桃園,2024-08-26,9189
3580,友威科,28,9,19,群益金鼎-桃園,2024-08-26,9189
5880,合庫金,19,0,19,群益金鼎-桃園,2024-08-26,9189
4526,東台,24,7,17,群益金鼎-桃園,2024-08-26,9189
00923,群益台ESG低碳50,17,0,17,群益金鼎-桃園,2024-08-26,9189
4564,元翎,20,4,16,群益金鼎-桃園,2024-08-26,9189
2313,華通,22,6,16,群益金鼎-桃園,2024-08-26,9189
00679B,元大美債20年,15,0,15,群益金鼎-桃園,2024-08-26,9189
8299,群聯,13,0,13,群益金鼎-桃園,2024-08-26,9189
8028,昇陽半導體,90,77,13,群益金鼎-桃園,2024-08-26,9189
3711,日月光投控,15,4,11,群益金鼎-桃園,2024-08-26,9189
2495,普安,11,0,11,群益金鼎-桃園,2024-08-26,9189
2402,毅嘉,129,118,11,群益金鼎-桃園,2024-08-26,9189
3231,緯創,13,2,11,群益金鼎-桃園,2024-08-26,9189
00878,國泰永續高股息,12,2,10,群益金鼎-桃園,2024-08-26,9189
2331,精英,26,16,10,群益金鼎-桃園,2024-08-26,9189
3058,立德,10,0,10,群益金鼎-桃園,2024-08-26,9189
00688L,國泰20年美債正2,10,0,10,群益金鼎-桃園,2024-08-26,9189
1591,駿吉-KY,10,0,10,群益金鼎-桃園,2024-08-26,9189
1459,聯發,10,0,10,群益金鼎-桃園,2024-08-26,9189
2890,永豐金,10,0,10,群益金鼎-桃園,2024-08-26,9189
00706L,期元大S＆P日圓正2,10,0,10,群益金鼎-桃園,2024-08-26,9189
00944,野村趨勢動能高息,10,0,10,群益金鼎-桃園,2024-08-26,9189
00882,中信中國高股息,10,0,10,群益金鼎-桃園,2024-08-26,9189
00897,富邦基因免疫生技,10,0,10,群益金鼎-桃園,2024-08-26,9189
9945,潤泰新,57,48,9,群益金鼎-桃園,2024-08-26,9189
2354,鴻準,14,5,9,群益金鼎-桃園,2024-08-26,9189
3707,漢磊,12,3,9,群益金鼎-桃園,2024-08-26,9189
4979,華星光,37,28,9,群益金鼎-桃園,2024-08-26,9189
3062,建漢,18,9,9,群益金鼎-桃園,2024-08-26,9189
1532,勤美,9,0,9,群益金鼎-桃園,2024-08-26,9189
2913,農林,184,0,184,群益金鼎-桃園,2024-08-27,9189
9934,成霖,181,0,181,群益金鼎-桃園,2024-08-27,9189
00715L,期街口布蘭特正2,200,21,179,群益金鼎-桃園,2024-08-27,9189
00673R,期元大S＆P原油反1,157,0,157,群益金鼎-桃園,2024-08-27,9189
2317,鴻海,133,5,128,群益金鼎-桃園,2024-08-27,9189
00680L,元大美債20正2,135,18,117,群益金鼎-桃園,2024-08-27,9189
2062,橋椿,109,20,89,群益金鼎-桃園,2024-08-27,9189
00687B,國泰20年美債,81,0,81,群益金鼎-桃園,2024-08-27,9189
2891,中信金,101,23,78,群益金鼎-桃園,2024-08-27,9189
1527,鑽全,80,2,78,群益金鼎-桃園,2024-08-27,9189
00929,復華台灣科技優息,132,60,72,群益金鼎-桃園,2024-08-27,9189
3481,群創,102,31,71,群益金鼎-桃園,2024-08-27,9189
1316,上曜,76,11,65,群益金鼎-桃園,2024-08-27,9189
00937B,群益ESG投等債20,58,1,57,群益金鼎-桃園,2024-08-27,9189
00948B,中信優息投資級債,57,0,57,群益金鼎-桃園,2024-08-27,9189
2399,映泰,208,154,54,群益金鼎-桃園,2024-08-27,9189
00919,群益台灣精選高息,56,3,53,群益金鼎-桃園,2024-08-27,9189
2610,華航,50,0,50,群益金鼎-桃園,2024-08-27,9189
00688L,國泰20年美債正2,50,1,49,群益金鼎-桃園,2024-08-27,9189
2882,國泰金,45,0,45,群益金鼎-桃園,2024-08-27,9189
8096,擎亞,50,6,44,群益金鼎-桃園,2024-08-27,9189
00706L,期元大S＆P日圓正2,40,0,40,群益金鼎-桃園,2024-08-27,9189
6179,亞通,41,3,38,群益金鼎-桃園,2024-08-27,9189
6129,普誠,30,0,30,群益金鼎-桃園,2024-08-27,9189
3047,訊舟,30,3,27,群益金鼎-桃園,2024-08-27,9189
3260,威剛,27,8,19,群益金鼎-桃園,2024-08-27,9189
2359,所羅門,66,47,19,群益金鼎-桃園,2024-08-27,9189
00679B,元大美債20年,18,0,18,群益金鼎-桃園,2024-08-27,9189
2383,台光電,18,1,17,群益金鼎-桃園,2024-08-27,9189
00940,元大台灣價值高息,24,8,16,群益金鼎-桃園,2024-08-27,9189
1409,新纖,23,7,16,群益金鼎-桃園,2024-08-27,9189
2637,慧洋-KY,15,0,15,群益金鼎-桃園,2024-08-27,9189
2883,凱基金,16,3,13,群益金鼎-桃園,2024-08-27,9189
00927,群益半導體收益,12,0,12,群益金鼎-桃園,2024-08-27,9189
6177,達麗,21,10,11,群益金鼎-桃園,2024-08-27,9189
3062,建漢,34,23,11,群益金鼎-桃園,2024-08-27,9189
1732,毛寶,11,0,11,群益金鼎-桃園,2024-08-27,9189
00909,國泰數位支付服務,10,0,10,群益金鼎-桃園,2024-08-27,9189
5469,瀚宇博,14,4,10,群益金鼎-桃園,2024-08-27,9189
2397,友通,10,0,10,群益金鼎-桃園,2024-08-27,9189
6789,采鈺,10,0,10,群益金鼎-桃園,2024-08-27,9189
6244,茂迪,11,1,10,群益金鼎-桃園,2024-08-27,9189
2915,潤泰全,10,0,10,群益金鼎-桃園,2024-08-27,9189
1201,味全,10,0,10,群益金鼎-桃園,2024-08-27,9189
00918,大華優利高填息30,10,0,10,群益金鼎-桃園,2024-08-27,9189
2883B,凱基金乙特,10,0,10,群益金鼎-桃園,2024-08-27,9189
6451,訊芯-KY,20,10,10,群益金鼎-桃園,2024-08-27,9189
4555,氣立,10,0,10,群益金鼎-桃園,2024-08-27,9189
2364,倫飛,9,0,9,群益金鼎-桃園,2024-08-27,9189
3211,順達,9,0,9,群益金鼎-桃園,2024-08-27,9189
2409,友達,121,21,100,群益金鼎-桃園,2024-08-28,9189
00637L,元大滬深300正2,74,4,70,群益金鼎-桃園,2024-08-28,9189
3605,宏致,65,1,64,群益金鼎-桃園,2024-08-28,9189
3576,聯合再生,51,0,51,群益金鼎-桃園,2024-08-28,9189
2891,中信金,67,20,47,群益金鼎-桃園,2024-08-28,9189
3481,群創,133,91,42,群益金鼎-桃園,2024-08-28,9189
2618,長榮航,40,2,38,群益金鼎-桃園,2024-08-28,9189
2062,橋椿,37,8,29,群益金鼎-桃園,2024-08-28,9189
4510,高鋒,41,13,28,群益金鼎-桃園,2024-08-28,9189
2867,三商壽,30,2,28,群益金鼎-桃園,2024-08-28,9189
00937B,群益ESG投等債20,64,40,24,群益金鼎-桃園,2024-08-28,9189
4566,時碩工業,40,17,23,群益金鼎-桃園,2024-08-28,9189
3498,陽程,23,2,21,群益金鼎-桃園,2024-08-28,9189
2537,聯上發,20,0,20,群益金鼎-桃園,2024-08-28,9189
6215,和椿,26,6,20,群益金鼎-桃園,2024-08-28,9189
6431,光麗-KY,20,0,20,群益金鼎-桃園,2024-08-28,9189
6244,茂迪,20,0,20,群益金鼎-桃園,2024-08-28,9189
9934,成霖,19,0,19,群益金鼎-桃園,2024-08-28,9189
2356,英業達,22,4,18,群益金鼎-桃園,2024-08-28,9189
00664R,國泰臺灣加權反1,15,0,15,群益金鼎-桃園,2024-08-28,9189
00919,群益台灣精選高息,14,0,14,群益金鼎-桃園,2024-08-28,9189
2637,慧洋-KY,17,3,14,群益金鼎-桃園,2024-08-28,9189
8039,台虹,19,5,14,群益金鼎-桃園,2024-08-28,9189
3581,博磊,16,3,13,群益金鼎-桃園,2024-08-28,9189
2354,鴻準,14,2,12,群益金鼎-桃園,2024-08-28,9189
2388,威盛,17,5,12,群益金鼎-桃園,2024-08-28,9189
6177,達麗,12,0,12,群益金鼎-桃園,2024-08-28,9189
00632R,元大台灣50反1,73,61,12,群益金鼎-桃園,2024-08-28,9189
1409,新纖,14,2,12,群益金鼎-桃園,2024-08-28,9189
2887,台新金,13,2,11,群益金鼎-桃園,2024-08-28,9189
8096,擎亞,44,33,11,群益金鼎-桃園,2024-08-28,9189
6152,百一,12,1,11,群益金鼎-桃園,2024-08-28,9189
00680L,元大美債20正2,10,0,10,群益金鼎-桃園,2024-08-28,9189
3078,僑威,10,0,10,群益金鼎-桃園,2024-08-28,9189
00948B,中信優息投資級債,10,0,10,群益金鼎-桃園,2024-08-28,9189
2387,精元,10,0,10,群益金鼎-桃園,2024-08-28,9189
00953B,群益優選非投等債,10,0,10,群益金鼎-桃園,2024-08-28,9189
00720B,元大投資級公司債,10,0,10,群益金鼎-桃園,2024-08-28,9189
2489,瑞軒,11,2,9,群益金鼎-桃園,2024-08-28,9189
00688L,國泰20年美債正2,9,0,9,群益金鼎-桃園,2024-08-28,9189
2801,彰銀,10,1,9,群益金鼎-桃園,2024-08-28,9189
00918,大華優利高填息30,10,2,8,群益金鼎-桃園,2024-08-28,9189
2528,皇普,8,0,8,群益金鼎-桃園,2024-08-28,9189
00959B,大華投等美債15Y+,8,0,8,群益金鼎-桃園,2024-08-28,9189
2330,台積電,21,13,8,群益金鼎-桃園,2024-08-28,9189
4513,福裕,29,22,7,群益金鼎-桃園,2024-08-28,9189
8064,東捷,33,26,7,群益金鼎-桃園,2024-08-28,9189
2883,凱基金,10,4,6,群益金鼎-桃園,2024-08-28,9189
4526,東台,14,8,6,群益金鼎-桃園,2024-08-28,9189
00795B,中信美國公債20年,6,0,6,群益金鼎-桃園,2024-08-28,9189
00688L,國泰20年美債正2,425,0,425,群益金鼎-桃園,2024-08-29,9189
00679B,元大美債20年,169,0,169,群益金鼎-桃園,2024-08-29,9189
00637L,元大滬深300正2,330,220,110,群益金鼎-桃園,2024-08-29,9189
4526,東台,143,82,61,群益金鼎-桃園,2024-08-29,9189
00937B,群益ESG投等債20,81,21,60,群益金鼎-桃園,2024-08-29,9189
3017,奇鋐,51,1,50,群益金鼎-桃園,2024-08-29,9189
6603,富強鑫,69,26,43,群益金鼎-桃園,2024-08-29,9189
4303,信立,50,8,42,群益金鼎-桃園,2024-08-29,9189
6179,亞通,36,0,36,群益金鼎-桃園,2024-08-29,9189
00687B,國泰20年美債,32,0,32,群益金鼎-桃園,2024-08-29,9189
2891,中信金,86,55,31,群益金鼎-桃園,2024-08-29,9189
0056,元大高股息,32,1,31,群益金鼎-桃園,2024-08-29,9189
4720,德淵,30,0,30,群益金鼎-桃園,2024-08-29,9189
4563,百德,57,28,29,群益金鼎-桃園,2024-08-29,9189
00959B,大華投等美債15Y+,26,0,26,群益金鼎-桃園,2024-08-29,9189
2610,華航,28,2,26,群益金鼎-桃園,2024-08-29,9189
2331,精英,50,25,25,群益金鼎-桃園,2024-08-29,9189
00882,中信中國高股息,24,0,24,群益金鼎-桃園,2024-08-29,9189
2371,大同,24,1,23,群益金鼎-桃園,2024-08-29,9189
2547,日勝生,21,0,21,群益金鼎-桃園,2024-08-29,9189
00945B,凱基美國非投等債,20,0,20,群益金鼎-桃園,2024-08-29,9189
2324,仁寶,20,0,20,群益金鼎-桃園,2024-08-29,9189
00948B,中信優息投資級債,20,0,20,群益金鼎-桃園,2024-08-29,9189
3498,陽程,20,1,19,群益金鼎-桃園,2024-08-29,9189
6016,康和證,19,0,19,群益金鼎-桃園,2024-08-29,9189
2383,台光電,18,0,18,群益金鼎-桃園,2024-08-29,9189
2330,台積電,22,4,18,群益金鼎-桃園,2024-08-29,9189
2402,毅嘉,26,9,17,群益金鼎-桃園,2024-08-29,9189
2312,金寶,26,10,16,群益金鼎-桃園,2024-08-29,9189
1314,中石化,37,22,15,群益金鼎-桃園,2024-08-29,9189
1201,味全,15,0,15,群益金鼎-桃園,2024-08-29,9189
2426,鼎元,32,17,15,群益金鼎-桃園,2024-08-29,9189
6446,藥華藥,18,3,15,群益金鼎-桃園,2024-08-29,9189
1609,大亞,16,2,14,群益金鼎-桃園,2024-08-29,9189
2537,聯上發,13,0,13,群益金鼎-桃園,2024-08-29,9189
6153,嘉聯益,12,0,12,群益金鼎-桃園,2024-08-29,9189
00881,國泰台灣5G+,11,0,11,群益金鼎-桃園,2024-08-29,9189
00933B,國泰10Y+金融債,11,0,11,群益金鼎-桃園,2024-08-29,9189
00720B,元大投資級公司債,12,1,11,群益金鼎-桃園,2024-08-29,9189
6668,中揚光,11,0,11,群益金鼎-桃園,2024-08-29,9189
6431,光麗-KY,10,0,10,群益金鼎-桃園,2024-08-29,9189
2387,精元,10,0,10,群益金鼎-桃園,2024-08-29,9189
2401,凌陽,11,1,10,群益金鼎-桃園,2024-08-29,9189
5521,工信,10,0,10,群益金鼎-桃園,2024-08-29,9189
6194,育富,10,0,10,群益金鼎-桃園,2024-08-29,9189
2867,三商壽,40,30,10,群益金鼎-桃園,2024-08-29,9189
2883B,凱基金乙特,10,0,10,群益金鼎-桃園,2024-08-29,9189
6916,華凌,10,0,10,群益金鼎-桃園,2024-08-29,9189
00919,群益台灣精選高息,20,11,9,群益金鼎-桃園,2024-08-29,9189
1727,中華化,22,13,9,群益金鼎-桃園,2024-08-29,9189
00919,群益台灣精選高息,313,9,304,群益金鼎-桃園,2024-08-30,9189
00680L,元大美債20正2,179,0,179,群益金鼎-桃園,2024-08-30,9189
00940,元大台灣價值高息,90,21,69,群益金鼎-桃園,2024-08-30,9189
00687B,國泰20年美債,65,1,64,群益金鼎-桃園,2024-08-30,9189
00937B,群益ESG投等債20,71,10,61,群益金鼎-桃園,2024-08-30,9189
00929,復華台灣科技優息,53,3,50,群益金鼎-桃園,2024-08-30,9189
3481,群創,135,86,49,群益金鼎-桃園,2024-08-30,9189
2801,彰銀,42,0,42,群益金鼎-桃園,2024-08-30,9189
1326,台化,40,0,40,群益金鼎-桃園,2024-08-30,9189
2891,中信金,47,8,39,群益金鼎-桃園,2024-08-30,9189
2882,國泰金,49,11,38,群益金鼎-桃園,2024-08-30,9189
00679B,元大美債20年,43,5,38,群益金鼎-桃園,2024-08-30,9189
3645,達邁,25,1,24,群益金鼎-桃園,2024-08-30,9189
6213,聯茂,30,6,24,群益金鼎-桃園,2024-08-30,9189
8086,宏捷科,33,9,24,群益金鼎-桃園,2024-08-30,9189
2426,鼎元,37,14,23,群益金鼎-桃園,2024-08-30,9189
2382,廣達,22,0,22,群益金鼎-桃園,2024-08-30,9189
00688L,國泰20年美債正2,22,0,22,群益金鼎-桃園,2024-08-30,9189
2323,中環,31,10,21,群益金鼎-桃園,2024-08-30,9189
2033,佳大,21,0,21,群益金鼎-桃園,2024-08-30,9189
2618,長榮航,33,12,21,群益金鼎-桃園,2024-08-30,9189
2367,燿華,70,50,20,群益金鼎-桃園,2024-08-30,9189
2538,基泰,28,8,20,群益金鼎-桃園,2024-08-30,9189
8076,伍豐,20,0,20,群益金鼎-桃園,2024-08-30,9189
2887,台新金,19,0,19,群益金鼎-桃園,2024-08-30,9189
2545,皇翔,20,1,19,群益金鼎-桃園,2024-08-30,9189
8064,東捷,25,7,18,群益金鼎-桃園,2024-08-30,9189
3024,憶聲,17,0,17,群益金鼎-桃園,2024-08-30,9189
3013,晟銘電,23,7,16,群益金鼎-桃園,2024-08-30,9189
00632R,元大台灣50反1,16,0,16,群益金鼎-桃園,2024-08-30,9189
4561,健椿,24,9,15,群益金鼎-桃園,2024-08-30,9189
2534,宏盛,15,0,15,群益金鼎-桃園,2024-08-30,9189
1513,中興電,14,0,14,群益金鼎-桃園,2024-08-30,9189
8150,南茂,14,1,13,群益金鼎-桃園,2024-08-30,9189
3025,星通,13,0,13,群益金鼎-桃園,2024-08-30,9189
2317,鴻海,17,4,13,群益金鼎-桃園,2024-08-30,9189
3312,弘憶股,15,3,12,群益金鼎-桃園,2024-08-30,9189
3715,定穎投控,13,1,12,群益金鼎-桃園,2024-08-30,9189
2886,兆豐金,12,0,12,群益金鼎-桃園,2024-08-30,9189
9907,統一實,12,0,12,群益金鼎-桃園,2024-08-30,9189
2388,威盛,13,1,12,群益金鼎-桃園,2024-08-30,9189
2387,精元,12,0,12,群益金鼎-桃園,2024-08-30,9189
8096,擎亞,26,15,11,群益金鼎-桃園,2024-08-30,9189
2489,瑞軒,15,4,11,群益金鼎-桃園,2024-08-30,9189
2609,陽明,17,6,11,群益金鼎-桃園,2024-08-30,9189
1569,濱川,10,0,10,群益金鼎-桃園,2024-08-30,9189
8234,新漢,10,0,10,群益金鼎-桃園,2024-08-30,9189
1802,台玻,11,1,10,群益金鼎-桃園,2024-08-30,9189
8089,康全電訊,15,5,10,群益金鼎-桃園,2024-08-30,9189
3062,建漢,35,25,10,群益金鼎-桃園,2024-08-30,9189
00680L,元大美債20正2,451,0,451,群益金鼎-桃園,2024-09-02,9189
2317,鴻海,129,10,119,群益金鼎-桃園,2024-09-02,9189
00687B,國泰20年美債,124,8,116,群益金鼎-桃園,2024-09-02,9189
00679B,元大美債20年,66,0,66,群益金鼎-桃園,2024-09-02,9189
8105,凌巨,157,93,64,群益金鼎-桃園,2024-09-02,9189
00945B,凱基美國非投等債,56,0,56,群益金鼎-桃園,2024-09-02,9189
00948B,中信優息投資級債,43,0,43,群益金鼎-桃園,2024-09-02,9189
00919,群益台灣精選高息,41,0,41,群益金鼎-桃園,2024-09-02,9189
4526,東台,56,16,40,群益金鼎-桃園,2024-09-02,9189
00665L,富邦�琤肭磪囓�2,33,0,33,群益金鼎-桃園,2024-09-02,9189
2313,華通,42,11,31,群益金鼎-桃園,2024-09-02,9189
2323,中環,73,42,31,群益金鼎-桃園,2024-09-02,9189
6179,亞通,30,0,30,群益金鼎-桃園,2024-09-02,9189
2913,農林,30,0,30,群益金鼎-桃園,2024-09-02,9189
00937B,群益ESG投等債20,30,6,24,群益金鼎-桃園,2024-09-02,9189
2497,怡利電,23,1,22,群益金鼎-桃園,2024-09-02,9189
2883,凱基金,22,1,21,群益金鼎-桃園,2024-09-02,9189
00959B,大華投等美債15Y+,19,0,19,群益金鼎-桃園,2024-09-02,9189
4714,永捷,24,6,18,群益金鼎-桃園,2024-09-02,9189
1301,台塑,17,0,17,群益金鼎-桃園,2024-09-02,9189
2609,陽明,17,0,17,群益金鼎-桃園,2024-09-02,9189
00795B,中信美國公債20年,17,0,17,群益金鼎-桃園,2024-09-02,9189
8070,長華*,41,25,16,群益金鼎-桃園,2024-09-02,9189
00715L,期街口布蘭特正2,19,3,16,群益金鼎-桃園,2024-09-02,9189
1721,三晃,15,0,15,群益金鼎-桃園,2024-09-02,9189
9958,世紀鋼,14,1,13,群益金鼎-桃園,2024-09-02,9189
2537,聯上發,30,17,13,群益金鼎-桃園,2024-09-02,9189
9945,潤泰新,36,23,13,群益金鼎-桃園,2024-09-02,9189
00642U,期元大S＆P石油,12,0,12,群益金鼎-桃園,2024-09-02,9189
3390,旭軟,12,0,12,群益金鼎-桃園,2024-09-02,9189
3047,訊舟,31,19,12,群益金鼎-桃園,2024-09-02,9189
1303,南亞,11,0,11,群益金鼎-桃園,2024-09-02,9189
2603,長榮,11,0,11,群益金鼎-桃園,2024-09-02,9189
3686,達能,11,0,11,群益金鼎-桃園,2024-09-02,9189
2387,精元,14,3,11,群益金鼎-桃園,2024-09-02,9189
8089,康全電訊,16,5,11,群益金鼎-桃園,2024-09-02,9189
1326,台化,20,10,10,群益金鼎-桃園,2024-09-02,9189
00933B,國泰10Y+金融債,10,0,10,群益金鼎-桃園,2024-09-02,9189
5388,中磊,10,0,10,群益金鼎-桃園,2024-09-02,9189
3711,日月光投控,11,1,10,群益金鼎-桃園,2024-09-02,9189
6005,群益證,10,0,10,群益金鼎-桃園,2024-09-02,9189
5521,工信,10,0,10,群益金鼎-桃園,2024-09-02,9189
2349,錸德,18,8,10,群益金鼎-桃園,2024-09-02,9189
2101,南港,10,0,10,群益金鼎-桃園,2024-09-02,9189
2312,金寶,14,4,10,群益金鼎-桃園,2024-09-02,9189
4510,高鋒,27,17,10,群益金鼎-桃園,2024-09-02,9189
5512,力麒,50,40,10,群益金鼎-桃園,2024-09-02,9189
4720,德淵,10,0,10,群益金鼎-桃園,2024-09-02,9189
8039,台虹,10,0,10,群益金鼎-桃園,2024-09-02,9189
6274,台燿,14,5,9,群益金鼎-桃園,2024-09-02,9189
3149,正達,90,13,77,群益金鼎-桃園,2024-09-03,9189
00915,凱基優選高股息30,74,0,74,群益金鼎-桃園,2024-09-03,9189
2891,中信金,83,15,68,群益金鼎-桃園,2024-09-03,9189
00937B,群益ESG投等債20,68,1,67,群益金鼎-桃園,2024-09-03,9189
00919,群益台灣精選高息,73,11,62,群益金鼎-桃園,2024-09-03,9189
2002,中鋼,56,1,55,群益金鼎-桃園,2024-09-03,9189
4533,協易機,53,9,44,群益金鼎-桃園,2024-09-03,9189
5443,均豪,121,80,41,群益金鼎-桃園,2024-09-03,9189
00679B,元大美債20年,40,0,40,群益金鼎-桃園,2024-09-03,9189
00948B,中信優息投資級債,40,0,40,群益金鼎-桃園,2024-09-03,9189
00918,大華優利高填息30,39,1,38,群益金鼎-桃園,2024-09-03,9189
8027,鈦昇,59,24,35,群益金鼎-桃園,2024-09-03,9189
00715L,期街口布蘭特正2,43,9,34,群益金鼎-桃園,2024-09-03,9189
00687B,國泰20年美債,62,31,31,群益金鼎-桃園,2024-09-03,9189
00637L,元大滬深300正2,41,12,29,群益金鼎-桃園,2024-09-03,9189
3062,建漢,43,14,29,群益金鼎-桃園,2024-09-03,9189
00940,元大台灣價值高息,35,7,28,群益金鼎-桃園,2024-09-03,9189
1711,永光,42,15,27,群益金鼎-桃園,2024-09-03,9189
6215,和椿,36,11,25,群益金鼎-桃園,2024-09-03,9189
8096,擎亞,56,33,23,群益金鼎-桃園,2024-09-03,9189
2834,臺企銀,22,0,22,群益金鼎-桃園,2024-09-03,9189
3051,力特,22,1,21,群益金鼎-桃園,2024-09-03,9189
2241,艾姆勒,23,3,20,群益金鼎-桃園,2024-09-03,9189
2547,日勝生,20,0,20,群益金鼎-桃園,2024-09-03,9189
1213,大飲,20,0,20,群益金鼎-桃園,2024-09-03,9189
00713,元大台灣高息低波,21,2,19,群益金鼎-桃園,2024-09-03,9189
2313,華通,31,15,16,群益金鼎-桃園,2024-09-03,9189
00878,國泰永續高股息,15,0,15,群益金鼎-桃園,2024-09-03,9189
2515,中工,15,0,15,群益金鼎-桃園,2024-09-03,9189
2419,仲琦,20,6,14,群益金鼎-桃園,2024-09-03,9189
5388,中磊,14,0,14,群益金鼎-桃園,2024-09-03,9189
00882,中信中國高股息,14,0,14,群益金鼎-桃園,2024-09-03,9189
2365,昆盈,42,29,13,群益金鼎-桃園,2024-09-03,9189
8071,能率網通,13,0,13,群益金鼎-桃園,2024-09-03,9189
2101,南港,12,0,12,群益金鼎-桃園,2024-09-03,9189
4906,正文,13,2,11,群益金鼎-桃園,2024-09-03,9189
1314,中石化,11,0,11,群益金鼎-桃園,2024-09-03,9189
00959B,大華投等美債15Y+,11,0,11,群益金鼎-桃園,2024-09-03,9189
3576,聯合再生,10,0,10,群益金鼎-桃園,2024-09-03,9189
00951,台新日本半導體,10,0,10,群益金鼎-桃園,2024-09-03,9189
1455,集盛,10,0,10,群益金鼎-桃園,2024-09-03,9189
6194,育富,10,0,10,群益金鼎-桃園,2024-09-03,9189
8112,至上,10,0,10,群益金鼎-桃園,2024-09-03,9189
5521,工信,10,0,10,群益金鼎-桃園,2024-09-03,9189
2387,精元,10,0,10,群益金鼎-桃園,2024-09-03,9189
6177,達麗,19,9,10,群益金鼎-桃園,2024-09-03,9189
3037,欣興,12,3,9,群益金鼎-桃園,2024-09-03,9189
3013,晟銘電,14,5,9,群益金鼎-桃園,2024-09-03,9189
3105,穩懋,12,3,9,群益金鼎-桃園,2024-09-03,9189
3374,精材,9,0,9,群益金鼎-桃園,2024-09-03,9189
00940,元大台灣價值高息,323,44,279,群益金鼎-桃園,2024-09-04,9189
00919,群益台灣精選高息,218,34,184,群益金鼎-桃園,2024-09-04,9189
2891,中信金,145,3,142,群益金鼎-桃園,2024-09-04,9189
00687B,國泰20年美債,178,42,136,群益金鼎-桃園,2024-09-04,9189
00915,凱基優選高股息30,111,5,106,群益金鼎-桃園,2024-09-04,9189
00878,國泰永續高股息,106,6,100,群益金鼎-桃園,2024-09-04,9189
00918,大華優利高填息30,101,10,91,群益金鼎-桃園,2024-09-04,9189
2382,廣達,77,8,69,群益金鼎-桃園,2024-09-04,9189
0056,元大高股息,71,3,68,群益金鼎-桃園,2024-09-04,9189
00929,復華台灣科技優息,300,243,57,群益金鼎-桃園,2024-09-04,9189
00937B,群益ESG投等債20,85,29,56,群益金鼎-桃園,2024-09-04,9189
2002,中鋼,68,16,52,群益金鼎-桃園,2024-09-04,9189
00953B,群益優選非投等債,52,3,49,群益金鼎-桃園,2024-09-04,9189
2405,輔信,52,3,49,群益金鼎-桃園,2024-09-04,9189
1310,台苯,45,0,45,群益金鼎-桃園,2024-09-04,9189
2883,凱基金,66,21,45,群益金鼎-桃園,2024-09-04,9189
00881,國泰台灣5G+,43,0,43,群益金鼎-桃園,2024-09-04,9189
00715L,期街口布蘭特正2,43,0,43,群益金鼎-桃園,2024-09-04,9189
00713,元大台灣高息低波,44,1,43,群益金鼎-桃園,2024-09-04,9189
2344,華邦電,42,4,38,群益金鼎-桃園,2024-09-04,9189
1815,富喬,33,0,33,群益金鼎-桃園,2024-09-04,9189
0050,元大台灣50,32,5,27,群益金鼎-桃園,2024-09-04,9189
2801,彰銀,34,10,24,群益金鼎-桃園,2024-09-04,9189
1609,大亞,24,0,24,群益金鼎-桃園,2024-09-04,9189
3673,TPK-KY,25,1,24,群益金鼎-桃園,2024-09-04,9189
4303,信立,30,7,23,群益金鼎-桃園,2024-09-04,9189
3037,欣興,28,6,22,群益金鼎-桃園,2024-09-04,9189
2834,臺企銀,23,2,21,群益金鼎-桃園,2024-09-04,9189
2330,台積電,58,38,20,群益金鼎-桃園,2024-09-04,9189
006208,富邦台50,25,5,20,群益金鼎-桃園,2024-09-04,9189
2547,日勝生,20,0,20,群益金鼎-桃園,2024-09-04,9189
3035,智原,22,2,20,群益金鼎-桃園,2024-09-04,9189
1409,新纖,20,0,20,群益金鼎-桃園,2024-09-04,9189
2387,精元,20,0,20,群益金鼎-桃園,2024-09-04,9189
3576,聯合再生,20,0,20,群益金鼎-桃園,2024-09-04,9189
2637,慧洋-KY,20,0,20,群益金鼎-桃園,2024-09-04,9189
2317,鴻海,79,59,20,群益金鼎-桃園,2024-09-04,9189
4510,高鋒,88,70,18,群益金鼎-桃園,2024-09-04,9189
2610,華航,20,2,18,群益金鼎-桃園,2024-09-04,9189
2303,聯電,17,0,17,群益金鼎-桃園,2024-09-04,9189
00637L,元大滬深300正2,57,40,17,群益金鼎-桃園,2024-09-04,9189
1326,台化,32,15,17,群益金鼎-桃園,2024-09-04,9189
1785,光洋科,42,26,16,群益金鼎-桃園,2024-09-04,9189
8936,國統,15,0,15,群益金鼎-桃園,2024-09-04,9189
2913,農林,15,0,15,群益金鼎-桃園,2024-09-04,9189
6215,和椿,19,4,15,群益金鼎-桃園,2024-09-04,9189
6152,百一,17,2,15,群益金鼎-桃園,2024-09-04,9189
00951,台新日本半導體,15,1,14,群益金鼎-桃園,2024-09-04,9189
2915,潤泰全,16,2,14,群益金鼎-桃園,2024-09-04,9189
00935,野村臺灣新科技50,13,0,13,群益金鼎-桃園,2024-09-04,9189
00919,群益台灣精選高息,162,10,152,群益金鼎-桃園,2024-09-05,9189
00632R,元大台灣50反1,218,94,124,群益金鼎-桃園,2024-09-05,9189
4534,慶騰,103,10,93,群益金鼎-桃園,2024-09-05,9189
00929,復華台灣科技優息,166,84,82,群益金鼎-桃園,2024-09-05,9189
00715L,期街口布蘭特正2,77,0,77,群益金鼎-桃園,2024-09-05,9189
00937B,群益ESG投等債20,64,2,62,群益金鼎-桃園,2024-09-05,9189
00952,凱基台灣AI50,57,0,57,群益金鼎-桃園,2024-09-05,9189
2405,輔信,52,0,52,群益金鼎-桃園,2024-09-05,9189
2542,興富發,50,0,50,群益金鼎-桃園,2024-09-05,9189
00679B,元大美債20年,77,31,46,群益金鼎-桃園,2024-09-05,9189
00915,凱基優選高股息30,43,5,38,群益金鼎-桃園,2024-09-05,9189
00713,元大台灣高息低波,47,10,37,群益金鼎-桃園,2024-09-05,9189
4510,高鋒,80,45,35,群益金鼎-桃園,2024-09-05,9189
3481,群創,58,26,32,群益金鼎-桃園,2024-09-05,9189
2344,華邦電,31,1,30,群益金鼎-桃園,2024-09-05,9189
00918,大華優利高填息30,28,1,27,群益金鼎-桃園,2024-09-05,9189
2891,中信金,46,19,27,群益金鼎-桃園,2024-09-05,9189
2486,一詮,31,7,24,群益金鼎-桃園,2024-09-05,9189
2367,燿華,38,15,23,群益金鼎-桃園,2024-09-05,9189
00891,中信關鍵半導體,22,0,22,群益金鼎-桃園,2024-09-05,9189
2402,毅嘉,33,12,21,群益金鼎-桃園,2024-09-05,9189
3149,正達,21,0,21,群益金鼎-桃園,2024-09-05,9189
00951,台新日本半導體,20,0,20,群益金鼎-桃園,2024-09-05,9189
00894,中信小資高價30,20,0,20,群益金鼎-桃園,2024-09-05,9189
9925,新保,20,0,20,群益金鼎-桃園,2024-09-05,9189
00946,群益科技高息成長,21,1,20,群益金鼎-桃園,2024-09-05,9189
1326,台化,37,17,20,群益金鼎-桃園,2024-09-05,9189
00665L,富邦�琤肭磪囓�2,18,0,18,群益金鼎-桃園,2024-09-05,9189
00878,國泰永續高股息,22,5,17,群益金鼎-桃園,2024-09-05,9189
00943,兆豐電子高息等權,16,0,16,群益金鼎-桃園,2024-09-05,9189
00940,元大台灣價值高息,62,47,15,群益金鼎-桃園,2024-09-05,9189
2317,鴻海,49,34,15,群益金鼎-桃園,2024-09-05,9189
1513,中興電,15,1,14,群益金鼎-桃園,2024-09-05,9189
3019,亞光,27,13,14,群益金鼎-桃園,2024-09-05,9189
6223,旺矽,21,8,13,群益金鼎-桃園,2024-09-05,9189
1314,中石化,13,0,13,群益金鼎-桃園,2024-09-05,9189
1795,美時,13,0,13,群益金鼎-桃園,2024-09-05,9189
6768,志強-KY,13,0,13,群益金鼎-桃園,2024-09-05,9189
6026,福邦證,13,0,13,群益金鼎-桃園,2024-09-05,9189
6770,力積電,22,9,13,群益金鼎-桃園,2024-09-05,9189
2885,元大金,12,0,12,群益金鼎-桃園,2024-09-05,9189
6916,華凌,12,0,12,群益金鼎-桃園,2024-09-05,9189
2354,鴻準,11,0,11,群益金鼎-桃園,2024-09-05,9189
3715,定穎投控,12,1,11,群益金鼎-桃園,2024-09-05,9189
00857B,永豐20年美公債,10,0,10,群益金鼎-桃園,2024-09-05,9189
00664R,國泰臺灣加權反1,10,0,10,群益金鼎-桃園,2024-09-05,9189
2845,遠東銀,12,2,10,群益金鼎-桃園,2024-09-05,9189
00637L,元大滬深300正2,10,0,10,群益金鼎-桃園,2024-09-05,9189
00764B,群益25年美債,10,0,10,群益金鼎-桃園,2024-09-05,9189
2547,日勝生,10,0,10,群益金鼎-桃園,2024-09-05,9189
00680L,元大美債20正2,723,303,420,群益金鼎-桃園,2024-09-06,9189
00632R,元大台灣50反1,202,61,141,群益金鼎-桃園,2024-09-06,9189
2002,中鋼,54,0,54,群益金鼎-桃園,2024-09-06,9189
2542,興富發,50,0,50,群益金鼎-桃園,2024-09-06,9189
2618,長榮航,34,5,29,群益金鼎-桃園,2024-09-06,9189
00919,群益台灣精選高息,29,0,29,群益金鼎-桃園,2024-09-06,9189
3019,亞光,33,8,25,群益金鼎-桃園,2024-09-06,9189
2367,燿華,27,5,22,群益金鼎-桃園,2024-09-06,9189
2014,中鴻,27,7,20,群益金鼎-桃園,2024-09-06,9189
2867,三商壽,21,2,19,群益金鼎-桃園,2024-09-06,9189
00929,復華台灣科技優息,19,3,16,群益金鼎-桃園,2024-09-06,9189
00918,大華優利高填息30,21,5,16,群益金鼎-桃園,2024-09-06,9189
4510,高鋒,33,18,15,群益金鼎-桃園,2024-09-06,9189
00715L,期街口布蘭特正2,17,2,15,群益金鼎-桃園,2024-09-06,9189
6156,松上,16,2,14,群益金鼎-桃園,2024-09-06,9189
6449,鈺邦,16,2,14,群益金鼎-桃園,2024-09-06,9189
2610,華航,43,29,14,群益金鼎-桃園,2024-09-06,9189
2344,華邦電,13,0,13,群益金鼎-桃園,2024-09-06,9189
00706L,期元大S＆P日圓正2,13,0,13,群益金鼎-桃園,2024-09-06,9189
2317,鴻海,25,13,12,群益金鼎-桃園,2024-09-06,9189
5481,新華,13,1,12,群益金鼎-桃園,2024-09-06,9189
00946,群益科技高息成長,11,0,11,群益金鼎-桃園,2024-09-06,9189
6005,群益證,11,0,11,群益金鼎-桃園,2024-09-06,9189
4562,穎漢,13,2,11,群益金鼎-桃園,2024-09-06,9189
00642U,期元大S＆P石油,11,0,11,群益金鼎-桃園,2024-09-06,9189
4956,光鋐,17,6,11,群益金鼎-桃園,2024-09-06,9189
3437,榮創,13,3,10,群益金鼎-桃園,2024-09-06,9189
1711,永光,55,45,10,群益金鼎-桃園,2024-09-06,9189
4563,百德,21,11,10,群益金鼎-桃園,2024-09-06,9189
4133,亞諾法,10,0,10,群益金鼎-桃園,2024-09-06,9189
2401,凌陽,10,0,10,群益金鼎-桃園,2024-09-06,9189
2101,南港,10,0,10,群益金鼎-桃園,2024-09-06,9189
6869,雲豹能源,10,0,10,群益金鼎-桃園,2024-09-06,9189
2547,日勝生,10,0,10,群益金鼎-桃園,2024-09-06,9189
2883,凱基金,27,17,10,群益金鼎-桃園,2024-09-06,9189
3037,欣興,11,1,10,群益金鼎-桃園,2024-09-06,9189
3339,泰谷,13,4,9,群益金鼎-桃園,2024-09-06,9189
8034,榮群,9,0,9,群益金鼎-桃園,2024-09-06,9189
00940,元大台灣價值高息,24,16,8,群益金鼎-桃園,2024-09-06,9189
3481,群創,14,6,8,群益金鼎-桃園,2024-09-06,9189
9945,潤泰新,10,2,8,群益金鼎-桃園,2024-09-06,9189
00687B,國泰20年美債,53,45,8,群益金鼎-桃園,2024-09-06,9189
00713,元大台灣高息低波,7,0,7,群益金鼎-桃園,2024-09-06,9189
00951,台新日本半導體,7,0,7,群益金鼎-桃園,2024-09-06,9189
3211,順達,8,1,7,群益金鼎-桃園,2024-09-06,9189
1608,華榮,10,3,7,群益金鼎-桃園,2024-09-06,9189
2464,盟立,15,8,7,群益金鼎-桃園,2024-09-06,9189
6114,久威,7,0,7,群益金鼎-桃園,2024-09-06,9189
6163,華電網,12,5,7,群益金鼎-桃園,2024-09-06,9189
1519,華城,8,2,6,群益金鼎-桃園,2024-09-06,9189
00680L,元大美債20正2,369,1,368,群益金鼎-桃園,2024-09-09,9189
00937B,群益ESG投等債20,117,0,117,群益金鼎-桃園,2024-09-09,9189
00929,復華台灣科技優息,116,5,111,群益金鼎-桃園,2024-09-09,9189
00919,群益台灣精選高息,105,8,97,群益金鼎-桃園,2024-09-09,9189
2542,興富發,102,9,93,群益金鼎-桃園,2024-09-09,9189
00687B,國泰20年美債,84,1,83,群益金鼎-桃園,2024-09-09,9189
6217,中探針,85,2,83,群益金鼎-桃園,2024-09-09,9189
00679B,元大美債20年,80,1,79,群益金鼎-桃園,2024-09-09,9189
3042,晶技,95,27,68,群益金鼎-桃園,2024-09-09,9189
2885,元大金,56,0,56,群益金鼎-桃園,2024-09-09,9189
2801,彰銀,37,0,37,群益金鼎-桃園,2024-09-09,9189
2497,怡利電,69,33,36,群益金鼎-桃園,2024-09-09,9189
00940,元大台灣價值高息,39,5,34,群益金鼎-桃園,2024-09-09,9189
00665L,富邦�琤肭磪囓�2,32,0,32,群益金鼎-桃園,2024-09-09,9189
3303,岱稜,37,6,31,群益金鼎-桃園,2024-09-09,9189
00878,國泰永續高股息,31,4,27,群益金鼎-桃園,2024-09-09,9189
00918,大華優利高填息30,25,0,25,群益金鼎-桃園,2024-09-09,9189
9945,潤泰新,26,2,24,群益金鼎-桃園,2024-09-09,9189
2002,中鋼,22,0,22,群益金鼎-桃園,2024-09-09,9189
2489,瑞軒,21,0,21,群益金鼎-桃園,2024-09-09,9189
2618,長榮航,21,0,21,群益金鼎-桃園,2024-09-09,9189
00715L,期街口布蘭特正2,22,2,20,群益金鼎-桃園,2024-09-09,9189
00894,中信小資高價30,20,0,20,群益金鼎-桃園,2024-09-09,9189
6116,彩晶,20,0,20,群益金鼎-桃園,2024-09-09,9189
2881,富邦金,20,1,19,群益金鼎-桃園,2024-09-09,9189
1442,名軒,18,0,18,群益金鼎-桃園,2024-09-09,9189
2891,中信金,35,17,18,群益金鼎-桃園,2024-09-09,9189
1326,台化,35,18,17,群益金鼎-桃園,2024-09-09,9189
00927,群益半導體收益,17,0,17,群益金鼎-桃園,2024-09-09,9189
2317,鴻海,35,18,17,群益金鼎-桃園,2024-09-09,9189
1527,鑽全,15,0,15,群益金鼎-桃園,2024-09-09,9189
00688L,國泰20年美債正2,14,0,14,群益金鼎-桃園,2024-09-09,9189
5356,協益,14,0,14,群益金鼎-桃園,2024-09-09,9189
2330,台積電,16,2,14,群益金鼎-桃園,2024-09-09,9189
0056,元大高股息,13,0,13,群益金鼎-桃園,2024-09-09,9189
3003,健和興,16,3,13,群益金鼎-桃園,2024-09-09,9189
3715,定穎投控,17,4,13,群益金鼎-桃園,2024-09-09,9189
3013,晟銘電,20,9,11,群益金鼎-桃園,2024-09-09,9189
00953B,群益優選非投等債,11,0,11,群益金鼎-桃園,2024-09-09,9189
2063,世鎧,11,0,11,群益金鼎-桃園,2024-09-09,9189
3622,洋華,11,0,11,群益金鼎-桃園,2024-09-09,9189
00932,兆豐永續高息等權,12,1,11,群益金鼎-桃園,2024-09-09,9189
5460,同協,23,12,11,群益金鼎-桃園,2024-09-09,9189
2363,矽統,13,2,11,群益金鼎-桃園,2024-09-09,9189
4956,光鋐,38,28,10,群益金鼎-桃園,2024-09-09,9189
5508,永信建,13,3,10,群益金鼎-桃園,2024-09-09,9189
1531,高林股,10,0,10,群益金鼎-桃園,2024-09-09,9189
00952,凱基台灣AI50,10,0,10,群益金鼎-桃園,2024-09-09,9189
00943,兆豐電子高息等權,11,1,10,群益金鼎-桃園,2024-09-09,9189
6592,和潤企業,10,0,10,群益金鼎-桃園,2024-09-09,9189
2313,華通,138,43,95,群益金鼎-桃園,2024-09-10,9189
00919,群益台灣精選高息,89,0,89,群益金鼎-桃園,2024-09-10,9189
6217,中探針,61,1,60,群益金鼎-桃園,2024-09-10,9189
00918,大華優利高填息30,36,0,36,群益金鼎-桃園,2024-09-10,9189
0056,元大高股息,34,0,34,群益金鼎-桃園,2024-09-10,9189
2344,華邦電,35,2,33,群益金鼎-桃園,2024-09-10,9189
2382,廣達,37,6,31,群益金鼎-桃園,2024-09-10,9189
00915,凱基優選高股息30,33,4,29,群益金鼎-桃園,2024-09-10,9189
9945,潤泰新,57,29,28,群益金鼎-桃園,2024-09-10,9189
2317,鴻海,42,14,28,群益金鼎-桃園,2024-09-10,9189
00940,元大台灣價值高息,47,23,24,群益金鼎-桃園,2024-09-10,9189
1718,中纖,22,0,22,群益金鼎-桃園,2024-09-10,9189
2356,英業達,21,0,21,群益金鼎-桃園,2024-09-10,9189
2408,南亞科,52,31,21,群益金鼎-桃園,2024-09-10,9189
00637L,元大滬深300正2,20,0,20,群益金鼎-桃園,2024-09-10,9189
00946,群益科技高息成長,19,0,19,群益金鼎-桃園,2024-09-10,9189
4958,臻鼎-KY,22,4,18,群益金鼎-桃園,2024-09-10,9189
8374,羅昇,25,7,18,群益金鼎-桃園,2024-09-10,9189
00933B,國泰10Y+金融債,18,0,18,群益金鼎-桃園,2024-09-10,9189
2330,台積電,20,2,18,群益金鼎-桃園,2024-09-10,9189
2497,怡利電,51,34,17,群益金鼎-桃園,2024-09-10,9189
1711,永光,19,2,17,群益金鼎-桃園,2024-09-10,9189
1514,亞力,16,0,16,群益金鼎-桃園,2024-09-10,9189
2002,中鋼,16,1,15,群益金鼎-桃園,2024-09-10,9189
00881,國泰台灣5G+,15,0,15,群益金鼎-桃園,2024-09-10,9189
1464,得力,15,0,15,群益金鼎-桃園,2024-09-10,9189
6153,嘉聯益,15,0,15,群益金鼎-桃園,2024-09-10,9189
3673,TPK-KY,16,2,14,群益金鼎-桃園,2024-09-10,9189
00878,國泰永續高股息,15,2,13,群益金鼎-桃園,2024-09-10,9189
8112,至上,13,0,13,群益金鼎-桃園,2024-09-10,9189
2881,富邦金,13,1,12,群益金鼎-桃園,2024-09-10,9189
6213,聯茂,12,0,12,群益金鼎-桃園,2024-09-10,9189
1326,台化,12,0,12,群益金鼎-桃園,2024-09-10,9189
2498,宏達電,16,4,12,群益金鼎-桃園,2024-09-10,9189
2387,精元,12,0,12,群益金鼎-桃園,2024-09-10,9189
6592,和潤企業,12,0,12,群益金鼎-桃園,2024-09-10,9189
6532,瑞耘,12,0,12,群益金鼎-桃園,2024-09-10,9189
2609,陽明,18,7,11,群益金鼎-桃園,2024-09-10,9189
2603,長榮,12,1,11,群益金鼎-桃園,2024-09-10,9189
2014,中鴻,11,0,11,群益金鼎-桃園,2024-09-10,9189
6114,久威,14,3,11,群益金鼎-桃園,2024-09-10,9189
5347,世界,13,2,11,群益金鼎-桃園,2024-09-10,9189
1808,潤隆,11,0,11,群益金鼎-桃園,2024-09-10,9189
00713,元大台灣高息低波,10,0,10,群益金鼎-桃園,2024-09-10,9189
2367,燿華,21,11,10,群益金鼎-桃園,2024-09-10,9189
2363,矽統,10,0,10,群益金鼎-桃園,2024-09-10,9189
1409,新纖,10,0,10,群益金鼎-桃園,2024-09-10,9189
6215,和椿,27,17,10,群益金鼎-桃園,2024-09-10,9189
2528,皇普,10,0,10,群益金鼎-桃園,2024-09-10,9189
8279,生展,10,0,10,群益金鼎-桃園,2024-09-10,9189
00937B,群益ESG投等債20,108,48,60,群益金鼎-桃園,2024-09-11,9189
00919,群益台灣精選高息,70,18,52,群益金鼎-桃園,2024-09-11,9189
2002,中鋼,48,0,48,群益金鼎-桃園,2024-09-11,9189
2891,中信金,48,0,48,群益金鼎-桃園,2024-09-11,9189
00918,大華優利高填息30,46,2,44,群益金鼎-桃園,2024-09-11,9189
00687B,國泰20年美債,133,90,43,群益金鼎-桃園,2024-09-11,9189
00929,復華台灣科技優息,55,15,40,群益金鼎-桃園,2024-09-11,9189
00632R,元大台灣50反1,50,10,40,群益金鼎-桃園,2024-09-11,9189
00948B,中信優息投資級債,35,1,34,群益金鼎-桃園,2024-09-11,9189
00940,元大台灣價值高息,43,10,33,群益金鼎-桃園,2024-09-11,9189
3550,聯穎,34,4,30,群益金鼎-桃園,2024-09-11,9189
3360,尚立,40,10,30,群益金鼎-桃園,2024-09-11,9189
2402,毅嘉,30,1,29,群益金鼎-桃園,2024-09-11,9189
2344,華邦電,22,0,22,群益金鼎-桃園,2024-09-11,9189
00712,復華富時不動產,22,0,22,群益金鼎-桃園,2024-09-11,9189
00715L,期街口布蘭特正2,29,8,21,群益金鼎-桃園,2024-09-11,9189
3057,喬鼎,20,0,20,群益金鼎-桃園,2024-09-11,9189
4510,高鋒,27,7,20,群益金鼎-桃園,2024-09-11,9189
5534,長虹,20,0,20,群益金鼎-桃園,2024-09-11,9189
6757,台灣虎航,20,0,20,群益金鼎-桃園,2024-09-11,9189
00915,凱基優選高股息30,20,0,20,群益金鼎-桃園,2024-09-11,9189
6122,擎邦,19,0,19,群益金鼎-桃園,2024-09-11,9189
8076,伍豐,20,2,18,群益金鼎-桃園,2024-09-11,9189
00878,國泰永續高股息,18,0,18,群益金鼎-桃園,2024-09-11,9189
3715,定穎投控,21,4,17,群益金鼎-桃園,2024-09-11,9189
0056,元大高股息,16,0,16,群益金鼎-桃園,2024-09-11,9189
00751B,元大AAA至A公司債,15,0,15,群益金鼎-桃園,2024-09-11,9189
00642U,期元大S＆P石油,15,0,15,群益金鼎-桃園,2024-09-11,9189
2387,精元,14,0,14,群益金鼎-桃園,2024-09-11,9189
2367,燿華,15,2,13,群益金鼎-桃園,2024-09-11,9189
00953B,群益優選非投等債,13,0,13,群益金鼎-桃園,2024-09-11,9189
00664R,國泰臺灣加權反1,12,0,12,群益金鼎-桃園,2024-09-11,9189
1815,富喬,12,0,12,群益金鼎-桃園,2024-09-11,9189
2308,台達電,11,0,11,群益金鼎-桃園,2024-09-11,9189
2464,盟立,13,3,10,群益金鼎-桃園,2024-09-11,9189
00946,群益科技高息成長,10,0,10,群益金鼎-桃園,2024-09-11,9189
6257,矽格,10,0,10,群益金鼎-桃園,2024-09-11,9189
4562,穎漢,11,1,10,群益金鼎-桃園,2024-09-11,9189
1513,中興電,11,2,9,群益金鼎-桃園,2024-09-11,9189
2883,凱基金,17,9,8,群益金鼎-桃園,2024-09-11,9189
6216,居易,14,6,8,群益金鼎-桃園,2024-09-11,9189
4979,華星光,16,9,7,群益金鼎-桃園,2024-09-11,9189
3037,欣興,9,2,7,群益金鼎-桃園,2024-09-11,9189
00934,中信成長高股息,7,0,7,群益金鼎-桃園,2024-09-11,9189
00911,兆豐洲際半導體,6,0,6,群益金鼎-桃園,2024-09-11,9189
00935,野村臺灣新科技50,6,0,6,群益金鼎-桃園,2024-09-11,9189
1540,喬福,52,46,6,群益金鼎-桃園,2024-09-11,9189
00945B,凱基美國非投等債,6,0,6,群益金鼎-桃園,2024-09-11,9189
3624,光頡,6,0,6,群益金鼎-桃園,2024-09-11,9189
3189,景碩,8,2,6,群益金鼎-桃園,2024-09-11,9189
00919,群益台灣精選高息,160,6,154,群益金鼎-桃園,2024-09-12,9189
00632R,元大台灣50反1,145,0,145,群益金鼎-桃園,2024-09-12,9189
00948B,中信優息投資級債,115,0,115,群益金鼎-桃園,2024-09-12,9189
00929,復華台灣科技優息,116,3,113,群益金鼎-桃園,2024-09-12,9189
2891,中信金,129,51,78,群益金鼎-桃園,2024-09-12,9189
6217,中探針,65,1,64,群益金鼎-桃園,2024-09-12,9189
00664R,國泰臺灣加權反1,50,0,50,群益金鼎-桃園,2024-09-12,9189
2883,凱基金,50,1,49,群益金鼎-桃園,2024-09-12,9189
00679B,元大美債20年,49,5,44,群益金鼎-桃園,2024-09-12,9189
00687B,國泰20年美債,125,87,38,群益金鼎-桃園,2024-09-12,9189
3360,尚立,32,1,31,群益金鼎-桃園,2024-09-12,9189
5905,南仁湖,35,4,31,群益金鼎-桃園,2024-09-12,9189
00706L,期元大S＆P日圓正2,25,0,25,群益金鼎-桃園,2024-09-12,9189
2887,台新金,22,0,22,群益金鼎-桃園,2024-09-12,9189
3031,佰鴻,20,0,20,群益金鼎-桃園,2024-09-12,9189
4510,高鋒,52,32,20,群益金鼎-桃園,2024-09-12,9189
00715L,期街口布蘭特正2,21,2,19,群益金鼎-桃園,2024-09-12,9189
3481,群創,19,0,19,群益金鼎-桃園,2024-09-12,9189
2371,大同,22,7,15,群益金鼎-桃園,2024-09-12,9189
8107,大億金茂,13,0,13,群益金鼎-桃園,2024-09-12,9189
1101,台泥,12,0,12,群益金鼎-桃園,2024-09-12,9189
6134,萬旭,13,2,11,群益金鼎-桃園,2024-09-12,9189
2609,陽明,25,14,11,群益金鼎-桃園,2024-09-12,9189
2603,長榮,17,6,11,群益金鼎-桃園,2024-09-12,9189
5443,均豪,52,42,10,群益金鼎-桃園,2024-09-12,9189
2888,新光金,70,60,10,群益金鼎-桃園,2024-09-12,9189
00757,統一FANG+,10,0,10,群益金鼎-桃園,2024-09-12,9189
00957B,兆豐US優選投等債,10,0,10,群益金鼎-桃園,2024-09-12,9189
6125,廣運,17,7,10,群益金鼎-桃園,2024-09-12,9189
2399,映泰,26,16,10,群益金鼎-桃園,2024-09-12,9189
3312,弘憶股,13,3,10,群益金鼎-桃園,2024-09-12,9189
4161,聿新科,9,0,9,群益金鼎-桃園,2024-09-12,9189
00713,元大台灣高息低波,10,1,9,群益金鼎-桃園,2024-09-12,9189
3019,亞光,10,1,9,群益金鼎-桃園,2024-09-12,9189
6530,創威,106,99,7,群益金鼎-桃園,2024-09-12,9189
5381,合正,7,0,7,群益金鼎-桃園,2024-09-12,9189
6505,台塑化,10,3,7,群益金鼎-桃園,2024-09-12,9189
00933B,國泰10Y+金融債,6,0,6,群益金鼎-桃園,2024-09-12,9189
6182,合晶,6,0,6,群益金鼎-桃園,2024-09-12,9189
8034,榮群,6,0,6,群益金鼎-桃園,2024-09-12,9189
5871,中租-KY,5,0,5,群益金鼎-桃園,2024-09-12,9189
4763,材料-KY,6,1,5,群益金鼎-桃園,2024-09-12,9189
1522,堤維西,5,0,5,群益金鼎-桃園,2024-09-12,9189
00915,凱基優選高股息30,7,2,5,群益金鼎-桃園,2024-09-12,9189
1589,永冠-KY,5,0,5,群益金鼎-桃園,2024-09-12,9189
2886,兆豐金,5,0,5,群益金鼎-桃園,2024-09-12,9189
2401,凌陽,5,0,5,群益金鼎-桃園,2024-09-12,9189
1616,億泰,5,0,5,群益金鼎-桃園,2024-09-12,9189
6133,金橋,7,2,5,群益金鼎-桃園,2024-09-12,9189
5469,瀚宇博,5,0,5,群益金鼎-桃園,2024-09-12,9189
2883,凱基金,222,0,222,群益金鼎-桃園,2024-09-13,9189
00680L,元大美債20正2,94,2,92,群益金鼎-桃園,2024-09-13,9189
00929,復華台灣科技優息,95,9,86,群益金鼎-桃園,2024-09-13,9189
00937B,群益ESG投等債20,79,2,77,群益金鼎-桃園,2024-09-13,9189
00919,群益台灣精選高息,69,19,50,群益金鼎-桃園,2024-09-13,9189
00948B,中信優息投資級債,38,0,38,群益金鼎-桃園,2024-09-13,9189
00715L,期街口布蘭特正2,45,10,35,群益金鼎-桃園,2024-09-13,9189
1539,巨庭,31,0,31,群益金鼎-桃園,2024-09-13,9189
1316,上曜,31,0,31,群益金鼎-桃園,2024-09-13,9189
3360,尚立,61,31,30,群益金鼎-桃園,2024-09-13,9189
8070,長華*,43,14,29,群益金鼎-桃園,2024-09-13,9189
6215,和椿,35,10,25,群益金鼎-桃園,2024-09-13,9189
2886,兆豐金,20,0,20,群益金鼎-桃園,2024-09-13,9189
00918,大華優利高填息30,37,18,19,群益金鼎-桃園,2024-09-13,9189
00878,國泰永續高股息,20,2,18,群益金鼎-桃園,2024-09-13,9189
6530,創威,33,15,18,群益金鼎-桃園,2024-09-13,9189
3481,群創,27,10,17,群益金鼎-桃園,2024-09-13,9189
6152,百一,16,0,16,群益金鼎-桃園,2024-09-13,9189
006208,富邦台50,17,1,16,群益金鼎-桃園,2024-09-13,9189
4979,華星光,41,27,14,群益金鼎-桃園,2024-09-13,9189
5481,新華,14,0,14,群益金鼎-桃園,2024-09-13,9189
8039,台虹,59,45,14,群益金鼎-桃園,2024-09-13,9189
1795,美時,15,1,14,群益金鼎-桃園,2024-09-13,9189
2365,昆盈,13,1,12,群益金鼎-桃園,2024-09-13,9189
1540,喬福,88,76,12,群益金鼎-桃園,2024-09-13,9189
3663,鑫科,15,4,11,群益金鼎-桃園,2024-09-13,9189
0056,元大高股息,11,0,11,群益金鼎-桃園,2024-09-13,9189
00772B,中信高評級公司債,10,0,10,群益金鼎-桃園,2024-09-13,9189
00953B,群益優選非投等債,10,0,10,群益金鼎-桃園,2024-09-13,9189
9105,泰金寶-DR,10,0,10,群益金鼎-桃園,2024-09-13,9189
4562,穎漢,11,1,10,群益金鼎-桃園,2024-09-13,9189
1522,堤維西,12,2,10,群益金鼎-桃園,2024-09-13,9189
3379,彬台,10,0,10,群益金鼎-桃園,2024-09-13,9189
6216,居易,13,3,10,群益金鼎-桃園,2024-09-13,9189
00957B,兆豐US優選投等債,10,0,10,群益金鼎-桃園,2024-09-13,9189
4716,大立,10,0,10,群益金鼎-桃園,2024-09-13,9189
1802,台玻,9,0,9,群益金鼎-桃園,2024-09-13,9189
2891,中信金,21,13,8,群益金鼎-桃園,2024-09-13,9189
8011,台通,14,6,8,群益金鼎-桃園,2024-09-13,9189
3296,勝德,8,0,8,群益金鼎-桃園,2024-09-13,9189
00713,元大台灣高息低波,13,6,7,群益金鼎-桃園,2024-09-13,9189
00674R,期元大S＆P黃金反1,7,0,7,群益金鼎-桃園,2024-09-13,9189
3013,晟銘電,9,2,7,群益金鼎-桃園,2024-09-13,9189
9958,世紀鋼,17,10,7,群益金鼎-桃園,2024-09-13,9189
00927,群益半導體收益,6,0,6,群益金鼎-桃園,2024-09-13,9189
8064,東捷,75,69,6,群益金鼎-桃園,2024-09-13,9189
5309,系統電,10,4,6,群益金鼎-桃園,2024-09-13,9189
00933B,國泰10Y+金融債,6,0,6,群益金鼎-桃園,2024-09-13,9189
1201,味全,6,0,6,群益金鼎-桃園,2024-09-13,9189
00795B,中信美國公債20年,5,0,5,群益金鼎-桃園,2024-09-13,9189
00687B,國泰20年美債,570,0,570,群益金鼎-桃園,2024-09-16,9189
00929,復華台灣科技優息,246,1,245,群益金鼎-桃園,2024-09-16,9189
00933B,國泰10Y+金融債,112,0,112,群益金鼎-桃園,2024-09-16,9189
00919,群益台灣精選高息,62,1,61,群益金鼎-桃園,2024-09-16,9189
2349,錸德,77,31,46,群益金鼎-桃園,2024-09-16,9189
00937B,群益ESG投等債20,113,70,43,群益金鼎-桃園,2024-09-16,9189
00751B,元大AAA至A公司債,40,0,40,群益金鼎-桃園,2024-09-16,9189
6117,迎廣,30,0,30,群益金鼎-桃園,2024-09-16,9189
9925,新保,30,0,30,群益金鼎-桃園,2024-09-16,9189
8249,菱光,61,31,30,群益金鼎-桃園,2024-09-16,9189
2104,國際中橡,27,0,27,群益金鼎-桃園,2024-09-16,9189
1301,台塑,35,10,25,群益金鼎-桃園,2024-09-16,9189
6005,群益證,23,0,23,群益金鼎-桃園,2024-09-16,9189
00959B,大華投等美債15Y+,20,0,20,群益金鼎-桃園,2024-09-16,9189
9105,泰金寶-DR,20,0,20,群益金鼎-桃園,2024-09-16,9189
00957B,兆豐US優選投等債,20,0,20,群益金鼎-桃園,2024-09-16,9189
1310,台苯,20,1,19,群益金鼎-桃園,2024-09-16,9189
6151,晉倫,19,0,19,群益金鼎-桃園,2024-09-16,9189
00679B,元大美債20年,37,19,18,群益金鼎-桃園,2024-09-16,9189
00918,大華優利高填息30,17,0,17,群益金鼎-桃園,2024-09-16,9189
3363,上詮,17,0,17,群益金鼎-桃園,2024-09-16,9189
3019,亞光,20,3,17,群益金鼎-桃園,2024-09-16,9189
00921,兆豐龍頭等權重,16,0,16,群益金鼎-桃園,2024-09-16,9189
00930,永豐ESG低碳高息,16,0,16,群益金鼎-桃園,2024-09-16,9189
4755,三福化,19,3,16,群益金鼎-桃園,2024-09-16,9189
3360,尚立,91,76,15,群益金鼎-桃園,2024-09-16,9189
3031,佰鴻,15,0,15,群益金鼎-桃園,2024-09-16,9189
6152,百一,15,1,14,群益金鼎-桃園,2024-09-16,9189
2313,華通,17,3,14,群益金鼎-桃園,2024-09-16,9189
1303,南亞,31,18,13,群益金鼎-桃園,2024-09-16,9189
00740B,富邦全球投等債,13,0,13,群益金鼎-桃園,2024-09-16,9189
00878,國泰永續高股息,13,1,12,群益金鼎-桃園,2024-09-16,9189
2204,中華,11,0,11,群益金鼎-桃園,2024-09-16,9189
00795B,中信美國公債20年,11,0,11,群益金鼎-桃園,2024-09-16,9189
3290,東浦,14,3,11,群益金鼎-桃園,2024-09-16,9189
9945,潤泰新,30,20,10,群益金鼎-桃園,2024-09-16,9189
5443,均豪,17,7,10,群益金鼎-桃園,2024-09-16,9189
3052,夆典,10,0,10,群益金鼎-桃園,2024-09-16,9189
3234,光環,10,0,10,群益金鼎-桃園,2024-09-16,9189
4577,達航科技,10,0,10,群益金鼎-桃園,2024-09-16,9189
1583,程泰,10,0,10,群益金鼎-桃園,2024-09-16,9189
2634,漢翔,10,0,10,群益金鼎-桃園,2024-09-16,9189
2882,國泰金,12,2,10,群益金鼎-桃園,2024-09-16,9189
3049,精金,17,7,10,群益金鼎-桃園,2024-09-16,9189
5452,佶優,14,4,10,群益金鼎-桃園,2024-09-16,9189
0056,元大高股息,11,1,10,群益金鼎-桃園,2024-09-16,9189
2891,中信金,14,5,9,群益金鼎-桃園,2024-09-16,9189
4716,大立,10,1,9,群益金鼎-桃園,2024-09-16,9189
3592,瑞鼎,9,0,9,群益金鼎-桃園,2024-09-16,9189
3002,歐格,10,1,9,群益金鼎-桃園,2024-09-16,9189
00680L,元大美債20正2,211,0,211,群益金鼎-桃園,2024-09-18,9189
00929,復華台灣科技優息,231,135,96,群益金鼎-桃園,2024-09-18,9189
00918,大華優利高填息30,105,16,89,群益金鼎-桃園,2024-09-18,9189
00679B,元大美債20年,68,1,67,群益金鼎-桃園,2024-09-18,9189
6438,迅得,60,1,59,群益金鼎-桃園,2024-09-18,9189
1711,永光,166,109,57,群益金鼎-桃園,2024-09-18,9189
00706L,期元大S＆P日圓正2,50,0,50,群益金鼎-桃園,2024-09-18,9189
00937B,群益ESG投等債20,60,12,48,群益金鼎-桃園,2024-09-18,9189
2317,鴻海,52,4,48,群益金鼎-桃園,2024-09-18,9189
2354,鴻準,44,4,40,群益金鼎-桃園,2024-09-18,9189
00948B,中信優息投資級債,35,0,35,群益金鼎-桃園,2024-09-18,9189
3715,定穎投控,36,5,31,群益金鼎-桃園,2024-09-18,9189
2885,元大金,30,0,30,群益金鼎-桃園,2024-09-18,9189
00957B,兆豐US優選投等債,30,0,30,群益金鼎-桃園,2024-09-18,9189
2349,錸德,53,26,27,群益金鼎-桃園,2024-09-18,9189
2313,華通,29,4,25,群益金鼎-桃園,2024-09-18,9189
00713,元大台灣高息低波,24,0,24,群益金鼎-桃園,2024-09-18,9189
00715L,期街口布蘭特正2,26,4,22,群益金鼎-桃園,2024-09-18,9189
00687B,國泰20年美債,26,5,21,群益金鼎-桃園,2024-09-18,9189
00688L,國泰20年美債正2,21,0,21,群益金鼎-桃園,2024-09-18,9189
00907,永豐優息存股,20,0,20,群益金鼎-桃園,2024-09-18,9189
6104,創惟,26,7,19,群益金鼎-桃園,2024-09-18,9189
3550,聯穎,94,75,19,群益金鼎-桃園,2024-09-18,9189
00915,凱基優選高股息30,18,0,18,群益金鼎-桃園,2024-09-18,9189
4542,科嶠,25,8,17,群益金鼎-桃園,2024-09-18,9189
6215,和椿,21,5,16,群益金鼎-桃園,2024-09-18,9189
2345,智邦,16,0,16,群益金鼎-桃園,2024-09-18,9189
2524,京城,24,8,16,群益金鼎-桃園,2024-09-18,9189
00891,中信關鍵半導體,15,0,15,群益金鼎-桃園,2024-09-18,9189
5443,均豪,23,9,14,群益金鼎-桃園,2024-09-18,9189
2887,台新金,15,1,14,群益金鼎-桃園,2024-09-18,9189
00951,台新日本半導體,13,0,13,群益金鼎-桃園,2024-09-18,9189
2497,怡利電,33,20,13,群益金鼎-桃園,2024-09-18,9189
2303,聯電,14,1,13,群益金鼎-桃園,2024-09-18,9189
00795B,中信美國公債20年,13,0,13,群益金鼎-桃園,2024-09-18,9189
2891,中信金,123,110,13,群益金鼎-桃園,2024-09-18,9189
3062,建漢,26,13,13,群益金鼎-桃園,2024-09-18,9189
0056,元大高股息,12,0,12,群益金鼎-桃園,2024-09-18,9189
4909,新復興,14,3,11,群益金鼎-桃園,2024-09-18,9189
00934,中信成長高股息,11,0,11,群益金鼎-桃園,2024-09-18,9189
00751B,元大AAA至A公司債,10,0,10,群益金鼎-桃園,2024-09-18,9189
9105,泰金寶-DR,10,0,10,群益金鼎-桃園,2024-09-18,9189
00921,兆豐龍頭等權重,10,0,10,群益金鼎-桃園,2024-09-18,9189
4977,眾達-KY,25,15,10,群益金鼎-桃園,2024-09-18,9189
8076,伍豐,9,0,9,群益金鼎-桃園,2024-09-18,9189
6153,嘉聯益,9,0,9,群益金鼎-桃園,2024-09-18,9189
2028,威致,11,2,9,群益金鼎-桃園,2024-09-18,9189
6120,達運,9,0,9,群益金鼎-桃園,2024-09-18,9189
2426,鼎元,17,8,9,群益金鼎-桃園,2024-09-18,9189
2382,廣達,9,0,9,群益金鼎-桃園,2024-09-18,9189
00680L,元大美債20正2,838,241,597,群益金鼎-桃園,2024-09-19,9189
00688L,國泰20年美債正2,514,29,485,群益金鼎-桃園,2024-09-19,9189
00632R,元大台灣50反1,143,1,142,群益金鼎-桃園,2024-09-19,9189
2344,華邦電,130,2,128,群益金鼎-桃園,2024-09-19,9189
00687B,國泰20年美債,117,0,117,群益金鼎-桃園,2024-09-19,9189
00948B,中信優息投資級債,69,0,69,群益金鼎-桃園,2024-09-19,9189
00957B,兆豐US優選投等債,60,0,60,群益金鼎-桃園,2024-09-19,9189
2515,中工,52,1,51,群益金鼎-桃園,2024-09-19,9189
00907,永豐優息存股,50,0,50,群益金鼎-桃園,2024-09-19,9189
5483,中美晶,30,0,30,群益金鼎-桃園,2024-09-19,9189
00637L,元大滬深300正2,30,0,30,群益金鼎-桃園,2024-09-19,9189
00918,大華優利高填息30,24,0,24,群益金鼎-桃園,2024-09-19,9189
2609,陽明,22,0,22,群益金鼎-桃園,2024-09-19,9189
4513,福裕,27,5,22,群益金鼎-桃園,2024-09-19,9189
1514,亞力,27,6,21,群益金鼎-桃園,2024-09-19,9189
6698,旭暉應材,23,2,21,群益金鼎-桃園,2024-09-19,9189
00929,復華台灣科技優息,72,52,20,群益金鼎-桃園,2024-09-19,9189
00932,兆豐永續高息等權,20,0,20,群益金鼎-桃園,2024-09-19,9189
2883B,凱基金乙特,20,0,20,群益金鼎-桃園,2024-09-19,9189
1605,華新,21,1,20,群益金鼎-桃園,2024-09-19,9189
2323,中環,25,5,20,群益金鼎-桃園,2024-09-19,9189
2349,錸德,27,8,19,群益金鼎-桃園,2024-09-19,9189
3581,博磊,30,12,18,群益金鼎-桃園,2024-09-19,9189
3049,精金,61,44,17,群益金鼎-桃園,2024-09-19,9189
1503,士電,15,0,15,群益金鼎-桃園,2024-09-19,9189
6609,瀧澤科,25,10,15,群益金鼎-桃園,2024-09-19,9189
00795B,中信美國公債20年,15,0,15,群益金鼎-桃園,2024-09-19,9189
3362,先進光,14,0,14,群益金鼎-桃園,2024-09-19,9189
00958B,永豐ESG銀行債15,12,0,12,群益金鼎-桃園,2024-09-19,9189
00915,凱基優選高股息30,12,0,12,群益金鼎-桃園,2024-09-19,9189
3711,日月光投控,12,1,11,群益金鼎-桃園,2024-09-19,9189
00725B,國泰投資級公司債,11,0,11,群益金鼎-桃園,2024-09-19,9189
00933B,國泰10Y+金融債,11,0,11,群益金鼎-桃園,2024-09-19,9189
2303,聯電,11,0,11,群益金鼎-桃園,2024-09-19,9189
2313,華通,18,8,10,群益金鼎-桃園,2024-09-19,9189
3354,律勝,11,1,10,群益金鼎-桃園,2024-09-19,9189
2387,精元,10,0,10,群益金鼎-桃園,2024-09-19,9189
4977,眾達-KY,20,10,10,群益金鼎-桃園,2024-09-19,9189
8110,華東,10,0,10,群益金鼎-桃園,2024-09-19,9189
4562,穎漢,11,1,10,群益金鼎-桃園,2024-09-19,9189
9955,佳龍,10,1,9,群益金鼎-桃園,2024-09-19,9189
6757,台灣虎航,9,0,9,群益金鼎-桃園,2024-09-19,9189
2486,一詮,11,2,9,群益金鼎-桃園,2024-09-19,9189
00919,群益台灣精選高息,64,56,8,群益金鼎-桃園,2024-09-19,9189
3062,建漢,40,32,8,群益金鼎-桃園,2024-09-19,9189
3707,漢磊,8,0,8,群益金鼎-桃園,2024-09-19,9189
2033,佳大,14,7,7,群益金鼎-桃園,2024-09-19,9189
00635U,期元大S＆P黃金,7,0,7,群益金鼎-桃園,2024-09-19,9189
2501,國建,7,0,7,群益金鼎-桃園,2024-09-19,9189
00946,群益科技高息成長,11,5,6,群益金鼎-桃園,2024-09-19,9189
00680L,元大美債20正2,329,80,249,群益金鼎-桃園,2024-09-20,9189
00687B,國泰20年美債,201,30,171,群益金鼎-桃園,2024-09-20,9189
00937B,群益ESG投等債20,175,10,165,群益金鼎-桃園,2024-09-20,9189
5347,世界,101,5,96,群益金鼎-桃園,2024-09-20,9189
2542,興富發,76,2,74,群益金鼎-桃園,2024-09-20,9189
00671R,富邦NASDAQ反1,60,0,60,群益金鼎-桃園,2024-09-20,9189
2867,三商壽,61,11,50,群益金鼎-桃園,2024-09-20,9189
4534,慶騰,50,0,50,群益金鼎-桃園,2024-09-20,9189
00679B,元大美債20年,60,20,40,群益金鼎-桃園,2024-09-20,9189
2885,元大金,41,1,40,群益金鼎-桃園,2024-09-20,9189
00918,大華優利高填息30,38,0,38,群益金鼎-桃園,2024-09-20,9189
4729,熒茂,41,3,38,群益金鼎-桃園,2024-09-20,9189
00919,群益台灣精選高息,154,118,36,群益金鼎-桃園,2024-09-20,9189
3062,建漢,104,70,34,群益金鼎-桃園,2024-09-20,9189
00958B,永豐ESG銀行債15,30,0,30,群益金鼎-桃園,2024-09-20,9189
2528,皇普,28,0,28,群益金鼎-桃園,2024-09-20,9189
00688L,國泰20年美債正2,26,0,26,群益金鼎-桃園,2024-09-20,9189
4939,亞電,29,3,26,群益金鼎-桃園,2024-09-20,9189
2538,基泰,25,0,25,群益金鼎-桃園,2024-09-20,9189
3390,旭軟,26,1,25,群益金鼎-桃園,2024-09-20,9189
2464,盟立,74,50,24,群益金鼎-桃園,2024-09-20,9189
00915,凱基優選高股息30,27,6,21,群益金鼎-桃園,2024-09-20,9189
00764B,群益25年美債,21,0,21,群益金鼎-桃園,2024-09-20,9189
1808,潤隆,44,24,20,群益金鼎-桃園,2024-09-20,9189
00948B,中信優息投資級債,20,0,20,群益金鼎-桃園,2024-09-20,9189
1714,和桐,20,0,20,群益金鼎-桃園,2024-09-20,9189
1312,國喬,20,0,20,群益金鼎-桃園,2024-09-20,9189
3581,博磊,17,1,16,群益金鼎-桃園,2024-09-20,9189
2891,中信金,76,60,16,群益金鼎-桃園,2024-09-20,9189
2303,聯電,15,0,15,群益金鼎-桃園,2024-09-20,9189
3689,湧德,26,11,15,群益金鼎-桃園,2024-09-20,9189
8070,長華*,26,12,14,群益金鼎-桃園,2024-09-20,9189
3354,律勝,38,24,14,群益金鼎-桃園,2024-09-20,9189
00637L,元大滬深300正2,13,0,13,群益金鼎-桃園,2024-09-20,9189
2101,南港,23,10,13,群益金鼎-桃園,2024-09-20,9189
8076,伍豐,14,1,13,群益金鼎-桃園,2024-09-20,9189
6216,居易,13,1,12,群益金鼎-桃園,2024-09-20,9189
00907,永豐優息存股,12,0,12,群益金鼎-桃園,2024-09-20,9189
5508,永信建,13,1,12,群益金鼎-桃園,2024-09-20,9189
1310,台苯,20,8,12,群益金鼎-桃園,2024-09-20,9189
5425,台半,11,0,11,群益金鼎-桃園,2024-09-20,9189
3673,TPK-KY,14,3,11,群益金鼎-桃園,2024-09-20,9189
3035,智原,14,3,11,群益金鼎-桃園,2024-09-20,9189
5258,虹堡,11,0,11,群益金鼎-桃園,2024-09-20,9189
6104,創惟,41,31,10,群益金鼎-桃園,2024-09-20,9189
8929,富堡,10,0,10,群益金鼎-桃園,2024-09-20,9189
6570,維田,14,4,10,群益金鼎-桃園,2024-09-20,9189
1539,巨庭,12,3,9,群益金鼎-桃園,2024-09-20,9189
00931B,統一美債20年,10,1,9,群益金鼎-桃園,2024-09-20,9189
1326,台化,41,32,9,群益金鼎-桃園,2024-09-20,9189
00680L,元大美債20正2,985,156,829,群益金鼎-桃園,2024-09-23,9189
2344,華邦電,180,0,180,群益金鼎-桃園,2024-09-23,9189
1524,耿鼎,149,16,133,群益金鼎-桃園,2024-09-23,9189
3481,群創,130,1,129,群益金鼎-桃園,2024-09-23,9189
00919,群益台灣精選高息,111,7,104,群益金鼎-桃園,2024-09-23,9189
00937B,群益ESG投等債20,170,80,90,群益金鼎-桃園,2024-09-23,9189
2867,三商壽,52,0,52,群益金鼎-桃園,2024-09-23,9189
00632R,元大台灣50反1,46,0,46,群益金鼎-桃園,2024-09-23,9189
1711,永光,61,16,45,群益金鼎-桃園,2024-09-23,9189
00688L,國泰20年美債正2,41,0,41,群益金鼎-桃園,2024-09-23,9189
00706L,期元大S＆P日圓正2,35,0,35,群益金鼎-桃園,2024-09-23,9189
5469,瀚宇博,31,0,31,群益金鼎-桃園,2024-09-23,9189
2464,盟立,33,6,27,群益金鼎-桃園,2024-09-23,9189
9945,潤泰新,101,75,26,群益金鼎-桃園,2024-09-23,9189
2062,橋椿,36,10,26,群益金鼎-桃園,2024-09-23,9189
2338,光罩,25,0,25,群益金鼎-桃園,2024-09-23,9189
2538,基泰,25,0,25,群益金鼎-桃園,2024-09-23,9189
00960,野村全球航運龍頭,18,0,18,群益金鼎-桃園,2024-09-23,9189
00679B,元大美債20年,23,6,17,群益金鼎-桃園,2024-09-23,9189
1536,和大,15,0,15,群益金鼎-桃園,2024-09-23,9189
4563,百德,17,2,15,群益金鼎-桃園,2024-09-23,9189
2399,映泰,64,50,14,群益金鼎-桃園,2024-09-23,9189
2528,皇普,14,0,14,群益金鼎-桃園,2024-09-23,9189
2883,凱基金,21,7,14,群益金鼎-桃園,2024-09-23,9189
2408,南亞科,16,2,14,群益金鼎-桃園,2024-09-23,9189
9958,世紀鋼,17,4,13,群益金鼎-桃園,2024-09-23,9189
2495,普安,16,3,13,群益金鼎-桃園,2024-09-23,9189
00687B,國泰20年美債,22,10,12,群益金鼎-桃園,2024-09-23,9189
6152,百一,11,0,11,群益金鼎-桃園,2024-09-23,9189
00948B,中信優息投資級債,11,0,11,群益金鼎-桃園,2024-09-23,9189
5481,新華,11,0,11,群益金鼎-桃園,2024-09-23,9189
4714,永捷,20,9,11,群益金鼎-桃園,2024-09-23,9189
2409,友達,10,0,10,群益金鼎-桃園,2024-09-23,9189
6005,群益證,10,0,10,群益金鼎-桃園,2024-09-23,9189
2049,上銀,10,0,10,群益金鼎-桃園,2024-09-23,9189
00927,群益半導體收益,10,0,10,群益金鼎-桃園,2024-09-23,9189
6532,瑞耘,9,0,9,群益金鼎-桃園,2024-09-23,9189
00959B,大華投等美債15Y+,9,0,9,群益金鼎-桃園,2024-09-23,9189
00940,元大台灣價值高息,11,2,9,群益金鼎-桃園,2024-09-23,9189
1314,中石化,10,2,8,群益金鼎-桃園,2024-09-23,9189
4711,永純,8,0,8,群益金鼎-桃園,2024-09-23,9189
2537,聯上發,7,0,7,群益金鼎-桃園,2024-09-23,9189
1587,吉茂,7,0,7,群益金鼎-桃園,2024-09-23,9189
4510,高鋒,10,3,7,群益金鼎-桃園,2024-09-23,9189
6134,萬旭,7,0,7,群益金鼎-桃園,2024-09-23,9189
6589,台康生技,7,0,7,群益金鼎-桃園,2024-09-23,9189
4919,新唐,6,0,6,群益金鼎-桃園,2024-09-23,9189
4527,方土霖,6,0,6,群益金鼎-桃園,2024-09-23,9189
4526,東台,7,1,6,群益金鼎-桃園,2024-09-23,9189
2393,億光,6,0,6,群益金鼎-桃園,2024-09-23,9189
00687B,國泰20年美債,225,10,215,群益金鼎-桃園,2024-09-24,9189
00680L,元大美債20正2,224,10,214,群益金鼎-桃園,2024-09-24,9189
00960,野村全球航運龍頭,162,0,162,群益金鼎-桃園,2024-09-24,9189
2888,新光金,127,23,104,群益金鼎-桃園,2024-09-24,9189
00927,群益半導體收益,61,0,61,群益金鼎-桃園,2024-09-24,9189
00946,群益科技高息成長,57,0,57,群益金鼎-桃園,2024-09-24,9189
8111,立��,68,18,50,群益金鼎-桃園,2024-09-24,9189
3576,聯合再生,47,0,47,群益金鼎-桃園,2024-09-24,9189
2497,怡利電,59,23,36,群益金鼎-桃園,2024-09-24,9189
00632R,元大台灣50反1,80,47,33,群益金鼎-桃園,2024-09-24,9189
2002,中鋼,41,10,31,群益金鼎-桃園,2024-09-24,9189
00929,復華台灣科技優息,25,0,25,群益金鼎-桃園,2024-09-24,9189
00948B,中信優息投資級債,25,0,25,群益金鼎-桃園,2024-09-24,9189
00919,群益台灣精選高息,24,0,24,群益金鼎-桃園,2024-09-24,9189
2867,三商壽,23,0,23,群益金鼎-桃園,2024-09-24,9189
4716,大立,26,4,22,群益金鼎-桃園,2024-09-24,9189
8033,雷虎,21,0,21,群益金鼎-桃園,2024-09-24,9189
00915,凱基優選高股息30,23,5,18,群益金鼎-桃園,2024-09-24,9189
00937B,群益ESG投等債20,21,5,16,群益金鼎-桃園,2024-09-24,9189
2458,義隆,19,3,16,群益金鼎-桃園,2024-09-24,9189
2425,承啟,25,9,16,群益金鼎-桃園,2024-09-24,9189
00953B,群益優選非投等債,16,0,16,群益金鼎-桃園,2024-09-24,9189
6244,茂迪,20,4,16,群益金鼎-桃園,2024-09-24,9189
1519,華城,15,0,15,群益金鼎-桃園,2024-09-24,9189
6548,長科*,17,2,15,群益金鼎-桃園,2024-09-24,9189
2610,華航,23,8,15,群益金鼎-桃園,2024-09-24,9189
4510,高鋒,17,3,14,群益金鼎-桃園,2024-09-24,9189
8086,宏捷科,16,3,13,群益金鼎-桃園,2024-09-24,9189
3149,正達,135,122,13,群益金鼎-桃園,2024-09-24,9189
0056,元大高股息,12,0,12,群益金鼎-桃園,2024-09-24,9189
4729,熒茂,24,12,12,群益金鼎-桃園,2024-09-24,9189
2330,台積電,41,30,11,群益金鼎-桃園,2024-09-24,9189
00857B,永豐20年美公債,11,0,11,群益金鼎-桃園,2024-09-24,9189
3317,尼克森,11,0,11,群益金鼎-桃園,2024-09-24,9189
1201,味全,10,0,10,群益金鼎-桃園,2024-09-24,9189
1455,集盛,10,0,10,群益金鼎-桃園,2024-09-24,9189
00891,中信關鍵半導體,10,0,10,群益金鼎-桃園,2024-09-24,9189
00957B,兆豐US優選投等債,10,0,10,群益金鼎-桃園,2024-09-24,9189
4526,東台,17,7,10,群益金鼎-桃園,2024-09-24,9189
6175,立敦,10,0,10,群益金鼎-桃園,2024-09-24,9189
6005,群益證,10,0,10,群益金鼎-桃園,2024-09-24,9189
00740B,富邦全球投等債,10,0,10,群益金鼎-桃園,2024-09-24,9189
3580,友威科,10,0,10,群益金鼎-桃園,2024-09-24,9189
3622,洋華,11,1,10,群益金鼎-桃園,2024-09-24,9189
2388,威盛,15,5,10,群益金鼎-桃園,2024-09-24,9189
6223,旺矽,13,4,9,群益金鼎-桃園,2024-09-24,9189
3714,富采,10,1,9,群益金鼎-桃園,2024-09-24,9189
6405,悅城,14,5,9,群益金鼎-桃園,2024-09-24,9189
6530,創威,21,12,9,群益金鼎-桃園,2024-09-24,9189
00918,大華優利高填息30,8,0,8,群益金鼎-桃園,2024-09-24,9189
00686R,群益臺灣加權反1,701,0,701,群益金鼎-桃園,2024-09-25,9189
00680L,元大美債20正2,371,93,278,群益金鼎-桃園,2024-09-25,9189
00937B,群益ESG投等債20,229,63,166,群益金鼎-桃園,2024-09-25,9189
00960,野村全球航運龍頭,110,1,109,群益金鼎-桃園,2024-09-25,9189
1711,永光,90,17,73,群益金鼎-桃園,2024-09-25,9189
1815,富喬,63,0,63,群益金鼎-桃園,2024-09-25,9189
3209,全科,36,0,36,群益金鼎-桃園,2024-09-25,9189
2477,美隆電,34,0,34,群益金鼎-桃園,2024-09-25,9189
00687B,國泰20年美債,34,2,32,群益金鼎-桃園,2024-09-25,9189
2867,三商壽,31,0,31,群益金鼎-桃園,2024-09-25,9189
00712,復華富時不動產,30,0,30,群益金鼎-桃園,2024-09-25,9189
2023,燁輝,30,0,30,群益金鼎-桃園,2024-09-25,9189
3163,波若威,41,12,29,群益金鼎-桃園,2024-09-25,9189
2415,錩新,26,0,26,群益金鼎-桃園,2024-09-25,9189
2351,順德,25,1,24,群益金鼎-桃園,2024-09-25,9189
2392,正崴,23,1,22,群益金鼎-桃園,2024-09-25,9189
00688L,國泰20年美債正2,21,0,21,群益金鼎-桃園,2024-09-25,9189
2201,裕隆,21,0,21,群益金鼎-桃園,2024-09-25,9189
2027,大成鋼,20,0,20,群益金鼎-桃園,2024-09-25,9189
2401,凌陽,26,6,20,群益金鼎-桃園,2024-09-25,9189
00945B,凱基美國非投等債,19,0,19,群益金鼎-桃園,2024-09-25,9189
2355,敬鵬,20,1,19,群益金鼎-桃園,2024-09-25,9189
3715,定穎投控,28,10,18,群益金鼎-桃園,2024-09-25,9189
4563,百德,21,3,18,群益金鼎-桃園,2024-09-25,9189
5243,乙盛-KY,18,0,18,群益金鼎-桃園,2024-09-25,9189
4979,華星光,37,20,17,群益金鼎-桃園,2024-09-25,9189
4303,信立,18,1,17,群益金鼎-桃園,2024-09-25,9189
6264,富裔,16,0,16,群益金鼎-桃園,2024-09-25,9189
8070,長華*,34,19,15,群益金鼎-桃園,2024-09-25,9189
2845,遠東銀,15,0,15,群益金鼎-桃園,2024-09-25,9189
00931B,統一美債20年,16,1,15,群益金鼎-桃園,2024-09-25,9189
6438,迅得,18,3,15,群益金鼎-桃園,2024-09-25,9189
4510,高鋒,45,30,15,群益金鼎-桃園,2024-09-25,9189
6194,育富,16,2,14,群益金鼎-桃園,2024-09-25,9189
3550,聯穎,132,118,14,群益金鼎-桃園,2024-09-25,9189
2520,冠德,15,1,14,群益金鼎-桃園,2024-09-25,9189
00878,國泰永續高股息,22,8,14,群益金鼎-桃園,2024-09-25,9189
2881,富邦金,15,2,13,群益金鼎-桃園,2024-09-25,9189
3714,富采,26,13,13,群益金鼎-桃園,2024-09-25,9189
3047,訊舟,17,5,12,群益金鼎-桃園,2024-09-25,9189
4716,大立,16,4,12,群益金鼎-桃園,2024-09-25,9189
1314,中石化,12,0,12,群益金鼎-桃園,2024-09-25,9189
3481,群創,18,7,11,群益金鼎-桃園,2024-09-25,9189
6530,創威,12,1,11,群益金鼎-桃園,2024-09-25,9189
1722,台肥,11,0,11,群益金鼎-桃園,2024-09-25,9189
5488,松普,11,0,11,群益金鼎-桃園,2024-09-25,9189
1727,中華化,13,3,10,群益金鼎-桃園,2024-09-25,9189
2345,智邦,13,3,10,群益金鼎-桃園,2024-09-25,9189
6116,彩晶,10,0,10,群益金鼎-桃園,2024-09-25,9189
8182,加高,10,0,10,群益金鼎-桃園,2024-09-25,9189
00937B,群益ESG投等債20,605,45,560,群益金鼎-桃園,2024-09-26,9189
00680L,元大美債20正2,469,5,464,群益金鼎-桃園,2024-09-26,9189
00686R,群益臺灣加權反1,300,1,299,群益金鼎-桃園,2024-09-26,9189
00679B,元大美債20年,144,0,144,群益金鼎-桃園,2024-09-26,9189
00946,群益科技高息成長,104,0,104,群益金鼎-桃園,2024-09-26,9189
4716,大立,104,29,75,群益金鼎-桃園,2024-09-26,9189
00919,群益台灣精選高息,93,28,65,群益金鼎-桃園,2024-09-26,9189
00688L,國泰20年美債正2,59,0,59,群益金鼎-桃園,2024-09-26,9189
1808,潤隆,64,7,57,群益金鼎-桃園,2024-09-26,9189
2887,台新金,56,0,56,群益金鼎-桃園,2024-09-26,9189
2530,華建,50,0,50,群益金鼎-桃園,2024-09-26,9189
00947,台新臺灣IC設計,40,0,40,群益金鼎-桃園,2024-09-26,9189
2528,皇普,40,0,40,群益金鼎-桃園,2024-09-26,9189
00712,復華富時不動產,37,0,37,群益金鼎-桃園,2024-09-26,9189
2845,遠東銀,36,0,36,群益金鼎-桃園,2024-09-26,9189
2002,中鋼,23,0,23,群益金鼎-桃園,2024-09-26,9189
2748,雲品,23,1,22,群益金鼎-桃園,2024-09-26,9189
00957B,兆豐US優選投等債,20,0,20,群益金鼎-桃園,2024-09-26,9189
2885,元大金,20,0,20,群益金鼎-桃園,2024-09-26,9189
2426,鼎元,21,1,20,群益金鼎-桃園,2024-09-26,9189
00948B,中信優息投資級債,22,2,20,群益金鼎-桃園,2024-09-26,9189
00632R,元大台灣50反1,375,356,19,群益金鼎-桃園,2024-09-26,9189
3006,晶豪科,50,32,18,群益金鼎-桃園,2024-09-26,9189
2542,興富發,17,0,17,群益金鼎-桃園,2024-09-26,9189
00960,野村全球航運龍頭,38,22,16,群益金鼎-桃園,2024-09-26,9189
3013,晟銘電,27,11,16,群益金鼎-桃園,2024-09-26,9189
2929,淘帝-KY,15,0,15,群益金鼎-桃園,2024-09-26,9189
6239,力成,15,2,13,群益金鼎-桃園,2024-09-26,9189
2409,友達,13,0,13,群益金鼎-桃園,2024-09-26,9189
00933B,國泰10Y+金融債,12,0,12,群益金鼎-桃園,2024-09-26,9189
2356,英業達,13,1,12,群益金鼎-桃園,2024-09-26,9189
00651R,復華香港反1,12,0,12,群益金鼎-桃園,2024-09-26,9189
3483,力致,12,0,12,群益金鼎-桃園,2024-09-26,9189
00725B,國泰投資級公司債,11,0,11,群益金鼎-桃園,2024-09-26,9189
1584,精剛,12,2,10,群益金鼎-桃園,2024-09-26,9189
6770,力積電,10,0,10,群益金鼎-桃園,2024-09-26,9189
2345,智邦,10,0,10,群益金鼎-桃園,2024-09-26,9189
5288,豐祥-KY,10,0,10,群益金鼎-桃園,2024-09-26,9189
2903,遠百,10,0,10,群益金鼎-桃園,2024-09-26,9189
1455,集盛,10,0,10,群益金鼎-桃園,2024-09-26,9189
4563,百德,10,0,10,群益金鼎-桃園,2024-09-26,9189
2428,興勤,10,0,10,群益金鼎-桃園,2024-09-26,9189
6438,迅得,10,0,10,群益金鼎-桃園,2024-09-26,9189
6116,彩晶,10,0,10,群益金鼎-桃園,2024-09-26,9189
6290,良維,9,0,9,群益金鼎-桃園,2024-09-26,9189
2323,中環,12,3,9,群益金鼎-桃園,2024-09-26,9189
3209,全科,13,4,9,群益金鼎-桃園,2024-09-26,9189
6152,百一,10,1,9,群益金鼎-桃園,2024-09-26,9189
3149,正達,48,40,8,群益金鼎-桃園,2024-09-26,9189
3673,TPK-KY,17,9,8,群益金鼎-桃園,2024-09-26,9189
00937B,群益ESG投等債20,343,5,338,群益金鼎-桃園,2024-09-27,9189
00687B,國泰20年美債,264,18,246,群益金鼎-桃園,2024-09-27,9189
00948B,中信優息投資級債,126,0,126,群益金鼎-桃園,2024-09-27,9189
00632R,元大台灣50反1,119,54,65,群益金鼎-桃園,2024-09-27,9189
00940,元大台灣價值高息,76,12,64,群益金鼎-桃園,2024-09-27,9189
2530,華建,52,0,52,群益金鼎-桃園,2024-09-27,9189
3483,力致,53,2,51,群益金鼎-桃園,2024-09-27,9189
00960,野村全球航運龍頭,49,0,49,群益金鼎-桃園,2024-09-27,9189
2528,皇普,49,0,49,群益金鼎-桃園,2024-09-27,9189
2201,裕隆,50,5,45,群益金鼎-桃園,2024-09-27,9189
00712,復華富時不動產,45,0,45,群益金鼎-桃園,2024-09-27,9189
00680L,元大美債20正2,35,0,35,群益金鼎-桃園,2024-09-27,9189
8043,蜜望實,36,2,34,群益金鼎-桃園,2024-09-27,9189
00679B,元大美債20年,43,14,29,群益金鼎-桃園,2024-09-27,9189
00953B,群益優選非投等債,32,4,28,群益金鼎-桃園,2024-09-27,9189
2891,中信金,31,4,27,群益金鼎-桃園,2024-09-27,9189
2303,聯電,51,24,27,群益金鼎-桃園,2024-09-27,9189
2388,威盛,29,3,26,群益金鼎-桃園,2024-09-27,9189
4903,聯光通,60,37,23,群益金鼎-桃園,2024-09-27,9189
2363,矽統,80,59,21,群益金鼎-桃園,2024-09-27,9189
00715L,期街口布蘭特正2,24,3,21,群益金鼎-桃園,2024-09-27,9189
2885,元大金,20,0,20,群益金鼎-桃園,2024-09-27,9189
6151,晉倫,22,2,20,群益金鼎-桃園,2024-09-27,9189
6188,廣明,23,3,20,群益金鼎-桃園,2024-09-27,9189
2344,華邦電,22,2,20,群益金鼎-桃園,2024-09-27,9189
1301,台塑,145,127,18,群益金鼎-桃園,2024-09-27,9189
4563,百德,29,11,18,群益金鼎-桃園,2024-09-27,9189
6104,創惟,54,37,17,群益金鼎-桃園,2024-09-27,9189
8150,南茂,16,0,16,群益金鼎-桃園,2024-09-27,9189
8076,伍豐,20,4,16,群益金鼎-桃園,2024-09-27,9189
1609,大亞,22,6,16,群益金鼎-桃園,2024-09-27,9189
3019,亞光,20,5,15,群益金鼎-桃園,2024-09-27,9189
3376,新日興,15,0,15,群益金鼎-桃園,2024-09-27,9189
3710,連展投控,16,2,14,群益金鼎-桃園,2024-09-27,9189
6005,群益證,20,6,14,群益金鼎-桃園,2024-09-27,9189
2313,華通,21,7,14,群益金鼎-桃園,2024-09-27,9189
1605,華新,22,9,13,群益金鼎-桃園,2024-09-27,9189
3041,揚智,17,4,13,群益金鼎-桃園,2024-09-27,9189
6116,彩晶,13,1,12,群益金鼎-桃園,2024-09-27,9189
00725B,國泰投資級公司債,12,0,12,群益金鼎-桃園,2024-09-27,9189
1815,富喬,12,0,12,群益金鼎-桃園,2024-09-27,9189
00753L,中信中國50正2,43,31,12,群益金鼎-桃園,2024-09-27,9189
3038,全台,12,0,12,群益金鼎-桃園,2024-09-27,9189
00946,群益科技高息成長,13,1,12,群益金鼎-桃園,2024-09-27,9189
00751B,元大AAA至A公司債,11,0,11,群益金鼎-桃園,2024-09-27,9189
2408,南亞科,11,0,11,群益金鼎-桃園,2024-09-27,9189
4906,正文,13,2,11,群益金鼎-桃園,2024-09-27,9189
6438,迅得,13,2,11,群益金鼎-桃園,2024-09-27,9189
00945B,凱基美國非投等債,11,0,11,群益金鼎-桃園,2024-09-27,9189
1785,光洋科,24,13,11,群益金鼎-桃園,2024-09-27,9189
00679B,元大美債20年,108,0,108,群益金鼎-桃園,2024-09-30,9189
00929,復華台灣科技優息,68,0,68,群益金鼎-桃園,2024-09-30,9189
1301,台塑,61,1,60,群益金鼎-桃園,2024-09-30,9189
00919,群益台灣精選高息,66,10,56,群益金鼎-桃園,2024-09-30,9189
00940,元大台灣價值高息,105,50,55,群益金鼎-桃園,2024-09-30,9189
2530,華建,53,0,53,群益金鼎-桃園,2024-09-30,9189
00951,台新日本半導體,50,0,50,群益金鼎-桃園,2024-09-30,9189
00687B,國泰20年美債,50,2,48,群益金鼎-桃園,2024-09-30,9189
00937B,群益ESG投等債20,47,0,47,群益金鼎-桃園,2024-09-30,9189
2888,新光金,58,13,45,群益金鼎-桃園,2024-09-30,9189
2891,中信金,57,17,40,群益金鼎-桃園,2024-09-30,9189
2897B,王道銀乙特,40,0,40,群益金鼎-桃園,2024-09-30,9189
2313,華通,42,5,37,群益金鼎-桃園,2024-09-30,9189
00680L,元大美債20正2,31,0,31,群益金鼎-桃園,2024-09-30,9189
00922,國泰台灣領袖50,30,0,30,群益金鼎-桃園,2024-09-30,9189
2204,中華,30,0,30,群益金鼎-桃園,2024-09-30,9189
00927,群益半導體收益,26,0,26,群益金鼎-桃園,2024-09-30,9189
00688L,國泰20年美債正2,25,0,25,群益金鼎-桃園,2024-09-30,9189
2528,皇普,44,21,23,群益金鼎-桃園,2024-09-30,9189
2436,偉詮電,23,0,23,群益金鼎-桃園,2024-09-30,9189
00953B,群益優選非投等債,42,20,22,群益金鼎-桃園,2024-09-30,9189
1540,喬福,23,1,22,群益金鼎-桃園,2024-09-30,9189
00946,群益科技高息成長,21,0,21,群益金鼎-桃園,2024-09-30,9189
2615,萬海,34,13,21,群益金鼎-桃園,2024-09-30,9189
00708L,期元大S＆P黃金正2,20,0,20,群益金鼎-桃園,2024-09-30,9189
2069,運錩,20,0,20,群益金鼎-桃園,2024-09-30,9189
00894,中信小資高價30,20,0,20,群益金鼎-桃園,2024-09-30,9189
5009,榮剛,22,2,20,群益金鼎-桃園,2024-09-30,9189
2330,台積電,55,36,19,群益金鼎-桃園,2024-09-30,9189
00918,大華優利高填息30,20,1,19,群益金鼎-桃園,2024-09-30,9189
6005,群益證,19,0,19,群益金鼎-桃園,2024-09-30,9189
00891,中信關鍵半導體,18,0,18,群益金鼎-桃園,2024-09-30,9189
3037,欣興,17,0,17,群益金鼎-桃園,2024-09-30,9189
2382,廣達,18,1,17,群益金鼎-桃園,2024-09-30,9189
6530,創威,64,48,16,群益金鼎-桃園,2024-09-30,9189
2609,陽明,56,40,16,群益金鼎-桃園,2024-09-30,9189
00959B,大華投等美債15Y+,15,0,15,群益金鼎-桃園,2024-09-30,9189
6217,中探針,15,0,15,群益金鼎-桃園,2024-09-30,9189
5243,乙盛-KY,16,1,15,群益金鼎-桃園,2024-09-30,9189
2401,凌陽,18,3,15,群益金鼎-桃園,2024-09-30,9189
00952,凱基台灣AI50,14,0,14,群益金鼎-桃園,2024-09-30,9189
0056,元大高股息,14,0,14,群益金鼎-桃園,2024-09-30,9189
4919,新唐,16,3,13,群益金鼎-桃園,2024-09-30,9189
2610,華航,15,2,13,群益金鼎-桃園,2024-09-30,9189
2344,華邦電,13,0,13,群益金鼎-桃園,2024-09-30,9189
1309,台達化,20,7,13,群益金鼎-桃園,2024-09-30,9189
00905,FT臺灣Smart,18,5,13,群益金鼎-桃園,2024-09-30,9189
3305,昇貿,20,8,12,群益金鼎-桃園,2024-09-30,9189
1595,川寶,36,24,12,群益金鼎-桃園,2024-09-30,9189
2022,聚亨,31,19,12,群益金鼎-桃園,2024-09-30,9189
00688L,國泰20年美債正2,105,0,105,群益金鼎-桃園,2024-10-01,9189
00929,復華台灣科技優息,92,2,90,群益金鼎-桃園,2024-10-01,9189
00945B,凱基美國非投等債,66,0,66,群益金鼎-桃園,2024-10-01,9189
2528,皇普,57,3,54,群益金鼎-桃園,2024-10-01,9189
00937B,群益ESG投等債20,54,2,52,群益金鼎-桃園,2024-10-01,9189
2530,華建,50,0,50,群益金鼎-桃園,2024-10-01,9189
9945,潤泰新,50,10,40,群益金鼎-桃園,2024-10-01,9189
1802,台玻,49,10,39,群益金鼎-桃園,2024-10-01,9189
2317,鴻海,44,10,34,群益金鼎-桃園,2024-10-01,9189
3715,定穎投控,49,16,33,群益金鼎-桃園,2024-10-01,9189
2885,元大金,30,0,30,群益金鼎-桃園,2024-10-01,9189
8032,光菱,27,0,27,群益金鼎-桃園,2024-10-01,9189
00878,國泰永續高股息,34,10,24,群益金鼎-桃園,2024-10-01,9189
3576,聯合再生,26,2,24,群益金鼎-桃園,2024-10-01,9189
00679B,元大美債20年,25,2,23,群益金鼎-桃園,2024-10-01,9189
3360,尚立,23,0,23,群益金鼎-桃園,2024-10-01,9189
1605,華新,24,2,22,群益金鼎-桃園,2024-10-01,9189
2313,華通,22,0,22,群益金鼎-桃園,2024-10-01,9189
2376,技嘉,22,1,21,群益金鼎-桃園,2024-10-01,9189
6217,中探針,20,0,20,群益金鼎-桃園,2024-10-01,9189
8076,伍豐,20,0,20,群益金鼎-桃園,2024-10-01,9189
00891,中信關鍵半導體,18,0,18,群益金鼎-桃園,2024-10-01,9189
2329,華泰,22,4,18,群益金鼎-桃園,2024-10-01,9189
0056,元大高股息,44,28,16,群益金鼎-桃園,2024-10-01,9189
2347,聯強,15,0,15,群益金鼎-桃園,2024-10-01,9189
2002,中鋼,22,8,14,群益金鼎-桃園,2024-10-01,9189
2344,華邦電,14,0,14,群益金鼎-桃園,2024-10-01,9189
2543,皇昌,41,27,14,群益金鼎-桃園,2024-10-01,9189
2023,燁輝,28,14,14,群益金鼎-桃園,2024-10-01,9189
3430,奇鈦科,50,36,14,群益金鼎-桃園,2024-10-01,9189
00946,群益科技高息成長,13,0,13,群益金鼎-桃園,2024-10-01,9189
6104,創惟,27,14,13,群益金鼎-桃園,2024-10-01,9189
2363,矽統,29,16,13,群益金鼎-桃園,2024-10-01,9189
4157,太景*-KY,12,0,12,群益金鼎-桃園,2024-10-01,9189
2345,智邦,11,0,11,群益金鼎-桃園,2024-10-01,9189
00752,中信中國50,11,0,11,群益金鼎-桃園,2024-10-01,9189
2356,英業達,11,1,10,群益金鼎-桃園,2024-10-01,9189
00948B,中信優息投資級債,10,0,10,群益金鼎-桃園,2024-10-01,9189
6863,永道-KY,10,0,10,群益金鼎-桃園,2024-10-01,9189
1569,濱川,25,15,10,群益金鼎-桃園,2024-10-01,9189
2480,敦陽科,10,0,10,群益金鼎-桃園,2024-10-01,9189
6186,新潤,11,2,9,群益金鼎-桃園,2024-10-01,9189
1785,光洋科,17,8,9,群益金鼎-桃園,2024-10-01,9189
9935,慶豐富,10,1,9,群益金鼎-桃園,2024-10-01,9189
0061,元大寶滬深,9,0,9,群益金鼎-桃園,2024-10-01,9189
6449,鈺邦,10,1,9,群益金鼎-桃園,2024-10-01,9189
2605,新興,22,13,9,群益金鼎-桃園,2024-10-01,9189
6125,廣運,8,0,8,群益金鼎-桃園,2024-10-01,9189
00922,國泰台灣領袖50,8,0,8,群益金鼎-桃園,2024-10-01,9189
2351,順德,9,1,8,群益金鼎-桃園,2024-10-01,9189
00680L,元大美債20正2,218,2,216,群益金鼎-桃園,2024-10-04,9189
00688L,國泰20年美債正2,172,0,172,群益金鼎-桃園,2024-10-04,9189
2891,中信金,125,5,120,群益金鼎-桃園,2024-10-04,9189
00940,元大台灣價值高息,148,30,118,群益金鼎-桃園,2024-10-04,9189
00919,群益台灣精選高息,123,19,104,群益金鼎-桃園,2024-10-04,9189
00946,群益科技高息成長,83,0,83,群益金鼎-桃園,2024-10-04,9189
2609,陽明,97,20,77,群益金鼎-桃園,2024-10-04,9189
00878,國泰永續高股息,73,0,73,群益金鼎-桃園,2024-10-04,9189
00687B,國泰20年美債,72,0,72,群益金鼎-桃園,2024-10-04,9189
0056,元大高股息,62,0,62,群益金鼎-桃園,2024-10-04,9189
00960,野村全球航運龍頭,61,0,61,群益金鼎-桃園,2024-10-04,9189
2530,華建,60,0,60,群益金鼎-桃園,2024-10-04,9189
4534,慶騰,56,0,56,群益金鼎-桃園,2024-10-04,9189
2603,長榮,56,7,49,群益金鼎-桃園,2024-10-04,9189
2618,長榮航,84,35,49,群益金鼎-桃園,2024-10-04,9189
2303,聯電,55,8,47,群益金鼎-桃園,2024-10-04,9189
00673R,期元大S＆P原油反1,38,0,38,群益金鼎-桃園,2024-10-04,9189
2637,慧洋-KY,39,4,35,群益金鼎-桃園,2024-10-04,9189
2615,萬海,40,6,34,群益金鼎-桃園,2024-10-04,9189
00948B,中信優息投資級債,30,0,30,群益金鼎-桃園,2024-10-04,9189
2897B,王道銀乙特,25,0,25,群益金鼎-桃園,2024-10-04,9189
5230,雷笛克光學,26,2,24,群益金鼎-桃園,2024-10-04,9189
1531,高林股,23,0,23,群益金鼎-桃園,2024-10-04,9189
2323,中環,21,0,21,群益金鼎-桃園,2024-10-04,9189
2610,華航,25,5,20,群益金鼎-桃園,2024-10-04,9189
00918,大華優利高填息30,19,0,19,群益金鼎-桃園,2024-10-04,9189
4909,新復興,27,8,19,群益金鼎-桃園,2024-10-04,9189
2330,台積電,25,6,19,群益金鼎-桃園,2024-10-04,9189
1605,華新,21,3,18,群益金鼎-桃園,2024-10-04,9189
6770,力積電,16,0,16,群益金鼎-桃園,2024-10-04,9189
3037,欣興,16,0,16,群益金鼎-桃園,2024-10-04,9189
3062,建漢,17,1,16,群益金鼎-桃園,2024-10-04,9189
3047,訊舟,17,1,16,群益金鼎-桃園,2024-10-04,9189
2425,承啟,35,19,16,群益金鼎-桃園,2024-10-04,9189
00907,永豐優息存股,16,0,16,群益金鼎-桃園,2024-10-04,9189
00720B,元大投資級公司債,16,0,16,群益金鼎-桃園,2024-10-04,9189
1301,台塑,32,17,15,群益金鼎-桃園,2024-10-04,9189
00753L,中信中國50正2,56,41,15,群益金鼎-桃園,2024-10-04,9189
6186,新潤,14,0,14,群益金鼎-桃園,2024-10-04,9189
8936,國統,14,0,14,群益金鼎-桃園,2024-10-04,9189
2371,大同,17,3,14,群益金鼎-桃園,2024-10-04,9189
2313,華通,16,2,14,群益金鼎-桃園,2024-10-04,9189
2929,淘帝-KY,15,2,13,群益金鼎-桃園,2024-10-04,9189
5309,系統電,13,0,13,群益金鼎-桃園,2024-10-04,9189
4303,信立,13,0,13,群益金鼎-桃園,2024-10-04,9189
00679B,元大美債20年,18,5,13,群益金鼎-桃園,2024-10-04,9189
4979,華星光,42,30,12,群益金鼎-桃園,2024-10-04,9189
00937B,群益ESG投等債20,12,0,12,群益金鼎-桃園,2024-10-04,9189
00927,群益半導體收益,62,50,12,群益金鼎-桃園,2024-10-04,9189
2007,燁興,16,4,12,群益金鼎-桃園,2024-10-04,9189
00680L,元大美債20正2,622,14,608,群益金鼎-桃園,2024-10-07,9189
00632R,元大台灣50反1,319,10,309,群益金鼎-桃園,2024-10-07,9189
00919,群益台灣精選高息,215,0,215,群益金鼎-桃園,2024-10-07,9189
00688L,國泰20年美債正2,130,3,127,群益金鼎-桃園,2024-10-07,9189
00753L,中信中國50正2,145,83,62,群益金鼎-桃園,2024-10-07,9189
00679B,元大美債20年,59,4,55,群益金鼎-桃園,2024-10-07,9189
2528,皇普,60,8,52,群益金鼎-桃園,2024-10-07,9189
2882,國泰金,50,3,47,群益金鼎-桃園,2024-10-07,9189
00937B,群益ESG投等債20,54,8,46,群益金鼎-桃園,2024-10-07,9189
00673R,期元大S＆P原油反1,42,0,42,群益金鼎-桃園,2024-10-07,9189
2017,官田鋼,42,0,42,群益金鼎-桃園,2024-10-07,9189
2317,鴻海,48,9,39,群益金鼎-桃園,2024-10-07,9189
6425,易發,62,25,37,群益金鼎-桃園,2024-10-07,9189
00918,大華優利高填息30,40,4,36,群益金鼎-桃園,2024-10-07,9189
3591,艾笛森,42,8,34,群益金鼎-桃園,2024-10-07,9189
2313,華通,33,9,24,群益金鼎-桃園,2024-10-07,9189
00948B,中信優息投資級債,24,0,24,群益金鼎-桃園,2024-10-07,9189
5443,均豪,31,8,23,群益金鼎-桃園,2024-10-07,9189
00960,野村全球航運龍頭,24,1,23,群益金鼎-桃園,2024-10-07,9189
2530,華建,23,0,23,群益金鼎-桃園,2024-10-07,9189
6194,育富,22,1,21,群益金鼎-桃園,2024-10-07,9189
4526,東台,20,0,20,群益金鼎-桃園,2024-10-07,9189
5452,佶優,19,0,19,群益金鼎-桃園,2024-10-07,9189
6438,迅得,21,2,19,群益金鼎-桃園,2024-10-07,9189
2353,宏��,19,0,19,群益金鼎-桃園,2024-10-07,9189
0056,元大高股息,28,10,18,群益金鼎-桃園,2024-10-07,9189
1337,再生-KY,17,0,17,群益金鼎-桃園,2024-10-07,9189
2615,萬海,24,8,16,群益金鼎-桃園,2024-10-07,9189
9105,泰金寶-DR,21,5,16,群益金鼎-桃園,2024-10-07,9189
00725B,國泰投資級公司債,15,0,15,群益金鼎-桃園,2024-10-07,9189
2402,毅嘉,19,5,14,群益金鼎-桃園,2024-10-07,9189
00933B,國泰10Y+金融債,14,0,14,群益金鼎-桃園,2024-10-07,9189
3374,精材,18,4,14,群益金鼎-桃園,2024-10-07,9189
8070,長華*,14,1,13,群益金鼎-桃園,2024-10-07,9189
2436,偉詮電,13,0,13,群益金鼎-桃園,2024-10-07,9189
2486,一詮,25,13,12,群益金鼎-桃園,2024-10-07,9189
00885,富邦越南,12,0,12,群益金鼎-桃園,2024-10-07,9189
6156,松上,12,1,11,群益金鼎-桃園,2024-10-07,9189
00642U,期元大S＆P石油,15,4,11,群益金鼎-桃園,2024-10-07,9189
3706,神達,11,0,11,群益金鼎-桃園,2024-10-07,9189
00795B,中信美國公債20年,11,0,11,群益金鼎-桃園,2024-10-07,9189
00878,國泰永續高股息,11,0,11,群益金鼎-桃園,2024-10-07,9189
4510,高鋒,22,12,10,群益金鼎-桃園,2024-10-07,9189
00665L,富邦�琤肭磪囓�2,16,6,10,群益金鼎-桃園,2024-10-07,9189
00636,國泰中國A50,11,1,10,群益金鼎-桃園,2024-10-07,9189
8111,立��,68,58,10,群益金鼎-桃園,2024-10-07,9189
1717,長興,10,0,10,群益金鼎-桃園,2024-10-07,9189
2104,國際中橡,10,0,10,群益金鼎-桃園,2024-10-07,9189
6241,易通展,10,0,10,群益金鼎-桃園,2024-10-07,9189
3511,矽瑪,11,1,10,群益金鼎-桃園,2024-10-07,9189
00632R,元大台灣50反1,1528,56,1472,群益金鼎-桃園,2024-10-08,9189
2888,新光金,998,19,979,群益金鼎-桃園,2024-10-08,9189
00680L,元大美債20正2,157,2,155,群益金鼎-桃園,2024-10-08,9189
00753L,中信中國50正2,338,226,112,群益金鼎-桃園,2024-10-08,9189
00688L,國泰20年美債正2,97,0,97,群益金鼎-桃園,2024-10-08,9189
00929,復華台灣科技優息,70,1,69,群益金鼎-桃園,2024-10-08,9189
00655L,國泰中國A50正2,71,10,61,群益金鼎-桃園,2024-10-08,9189
00712,復華富時不動產,61,0,61,群益金鼎-桃園,2024-10-08,9189
2801,彰銀,61,0,61,群益金鼎-桃園,2024-10-08,9189
2352,佳世達,60,0,60,群益金鼎-桃園,2024-10-08,9189
2883,凱基金,61,10,51,群益金鼎-桃園,2024-10-08,9189
00937B,群益ESG投等債20,73,23,50,群益金鼎-桃園,2024-10-08,9189
3049,精金,69,20,49,群益金鼎-桃園,2024-10-08,9189
2891,中信金,53,8,45,群益金鼎-桃園,2024-10-08,9189
4534,慶騰,43,0,43,群益金鼎-桃園,2024-10-08,9189
2344,華邦電,61,20,41,群益金鼎-桃園,2024-10-08,9189
2399,映泰,131,91,40,群益金鼎-桃園,2024-10-08,9189
00637L,元大滬深300正2,61,26,35,群益金鼎-桃園,2024-10-08,9189
00687B,國泰20年美債,54,25,29,群益金鼎-桃園,2024-10-08,9189
6005,群益證,28,0,28,群益金鼎-桃園,2024-10-08,9189
2353,宏��,27,0,27,群益金鼎-桃園,2024-10-08,9189
00940,元大台灣價值高息,31,4,27,群益金鼎-桃園,2024-10-08,9189
00919,群益台灣精選高息,31,5,26,群益金鼎-桃園,2024-10-08,9189
00636,國泰中國A50,26,3,23,群益金鼎-桃園,2024-10-08,9189
3498,陽程,23,0,23,群益金鼎-桃園,2024-10-08,9189
2362,藍天,43,21,22,群益金鼎-桃園,2024-10-08,9189
00673R,期元大S＆P原油反1,21,0,21,群益金鼎-桃園,2024-10-08,9189
3483,力致,21,0,21,群益金鼎-桃園,2024-10-08,9189
3037,欣興,23,2,21,群益金鼎-桃園,2024-10-08,9189
6218,豪勉,21,1,20,群益金鼎-桃園,2024-10-08,9189
6194,育富,20,0,20,群益金鼎-桃園,2024-10-08,9189
00948B,中信優息投資級債,20,0,20,群益金鼎-桃園,2024-10-08,9189
5512,力麒,20,0,20,群益金鼎-桃園,2024-10-08,9189
1815,富喬,19,0,19,群益金鼎-桃園,2024-10-08,9189
2436,偉詮電,27,8,19,群益金鼎-桃園,2024-10-08,9189
2355,敬鵬,19,1,18,群益金鼎-桃園,2024-10-08,9189
00882,中信中國高股息,101,83,18,群益金鼎-桃園,2024-10-08,9189
00945B,凱基美國非投等債,17,0,17,群益金鼎-桃園,2024-10-08,9189
2356,英業達,17,0,17,群益金鼎-桃園,2024-10-08,9189
00922,國泰台灣領袖50,16,0,16,群益金鼎-桃園,2024-10-08,9189
00887,永豐中國科技50大,109,93,16,群益金鼎-桃園,2024-10-08,9189
2929,淘帝-KY,20,4,16,群益金鼎-桃園,2024-10-08,9189
8085,福華,15,0,15,群益金鼎-桃園,2024-10-08,9189
00905,FT臺灣Smart,14,0,14,群益金鼎-桃園,2024-10-08,9189
2609,陽明,18,4,14,群益金鼎-桃園,2024-10-08,9189
1213,大飲,14,0,14,群益金鼎-桃園,2024-10-08,9189
00751B,元大AAA至A公司債,14,0,14,群益金鼎-桃園,2024-10-08,9189
2317,鴻海,40,26,14,群益金鼎-桃園,2024-10-08,9189
2498,宏達電,36,23,13,群益金鼎-桃園,2024-10-08,9189
2316,楠梓電,15,2,13,群益金鼎-桃園,2024-10-08,9189
00686R,群益臺灣加權反1,999,0,999,群益金鼎-桃園,2024-10-09,9189
00688L,國泰20年美債正2,235,15,220,群益金鼎-桃園,2024-10-09,9189
00680L,元大美債20正2,225,30,195,群益金鼎-桃園,2024-10-09,9189
2891,中信金,123,1,122,群益金鼎-桃園,2024-10-09,9189
00665L,富邦�琤肭磪囓�2,122,2,120,群益金鼎-桃園,2024-10-09,9189
00882,中信中國高股息,119,6,113,群益金鼎-桃園,2024-10-09,9189
3481,群創,87,0,87,群益金鼎-桃園,2024-10-09,9189
2356,英業達,92,29,63,群益金鼎-桃園,2024-10-09,9189
2303,聯電,60,2,58,群益金鼎-桃園,2024-10-09,9189
3284,太普高,57,2,55,群益金鼎-桃園,2024-10-09,9189
1616,億泰,50,0,50,群益金鼎-桃園,2024-10-09,9189
00937B,群益ESG投等債20,49,1,48,群益金鼎-桃園,2024-10-09,9189
00940,元大台灣價值高息,47,0,47,群益金鼎-桃園,2024-10-09,9189
2528,皇普,47,0,47,群益金鼎-桃園,2024-10-09,9189
00679B,元大美債20年,44,0,44,群益金鼎-桃園,2024-10-09,9189
3483,力致,40,0,40,群益金鼎-桃園,2024-10-09,9189
00881,國泰台灣5G+,45,8,37,群益金鼎-桃園,2024-10-09,9189
2363,矽統,165,133,32,群益金鼎-桃園,2024-10-09,9189
2313,華通,31,1,30,群益金鼎-桃園,2024-10-09,9189
00687B,國泰20年美債,32,2,30,群益金鼎-桃園,2024-10-09,9189
4303,信立,31,1,30,群益金鼎-桃園,2024-10-09,9189
1711,永光,29,0,29,群益金鼎-桃園,2024-10-09,9189
4306,炎洲,28,0,28,群益金鼎-桃園,2024-10-09,9189
00946,群益科技高息成長,28,0,28,群益金鼎-桃園,2024-10-09,9189
2030,彰源,25,0,25,群益金鼎-桃園,2024-10-09,9189
1301,台塑,25,0,25,群益金鼎-桃園,2024-10-09,9189
2603,長榮,26,2,24,群益金鼎-桃園,2024-10-09,9189
4551,智伸科,24,0,24,群益金鼎-桃園,2024-10-09,9189
1314,中石化,24,1,23,群益金鼎-桃園,2024-10-09,9189
00655L,國泰中國A50正2,24,2,22,群益金鼎-桃園,2024-10-09,9189
6530,創威,53,32,21,群益金鼎-桃園,2024-10-09,9189
1785,光洋科,21,0,21,群益金鼎-桃園,2024-10-09,9189
00929,復華台灣科技優息,24,4,20,群益金鼎-桃園,2024-10-09,9189
2530,華建,20,0,20,群益金鼎-桃園,2024-10-09,9189
2886,兆豐金,20,0,20,群益金鼎-桃園,2024-10-09,9189
2436,偉詮電,24,5,19,群益金鼎-桃園,2024-10-09,9189
2423,固緯,78,59,19,群益金鼎-桃園,2024-10-09,9189
5512,力麒,18,0,18,群益金鼎-桃園,2024-10-09,9189
00878,國泰永續高股息,18,1,17,群益金鼎-桃園,2024-10-09,9189
6770,力積電,17,0,17,群益金鼎-桃園,2024-10-09,9189
2323,中環,16,0,16,群益金鼎-桃園,2024-10-09,9189
00753L,中信中國50正2,25,10,15,群益金鼎-桃園,2024-10-09,9189
00642U,期元大S＆P石油,25,10,15,群益金鼎-桃園,2024-10-09,9189
9938,百和,15,0,15,群益金鼎-桃園,2024-10-09,9189
2618,長榮航,19,5,14,群益金鼎-桃園,2024-10-09,9189
2913,農林,14,0,14,群益金鼎-桃園,2024-10-09,9189
3711,日月光投控,13,0,13,群益金鼎-桃園,2024-10-09,9189
00643,群益深証中小,13,0,13,群益金鼎-桃園,2024-10-09,9189
2033,佳大,13,0,13,群益金鼎-桃園,2024-10-09,9189
3025,星通,45,32,13,群益金鼎-桃園,2024-10-09,9189
00753L,中信中國50正2,388,8,380,群益金鼎-桃園,2024-10-11,9189
2903,遠百,162,1,161,群益金鼎-桃園,2024-10-11,9189
00688L,國泰20年美債正2,123,0,123,群益金鼎-桃園,2024-10-11,9189
00686R,群益臺灣加權反1,100,0,100,群益金鼎-桃園,2024-10-11,9189
00680L,元大美債20正2,127,40,87,群益金鼎-桃園,2024-10-11,9189
00632R,元大台灣50反1,88,10,78,群益金鼎-桃園,2024-10-11,9189
00673R,期元大S＆P原油反1,77,0,77,群益金鼎-桃園,2024-10-11,9189
2528,皇普,62,0,62,群益金鼎-桃園,2024-10-11,9189
00637L,元大滬深300正2,127,69,58,群益金鼎-桃園,2024-10-11,9189
00687B,國泰20年美債,126,72,54,群益金鼎-桃園,2024-10-11,9189
2488,漢平,53,0,53,群益金鼎-桃園,2024-10-11,9189
4534,慶騰,50,1,49,群益金鼎-桃園,2024-10-11,9189
2486,一詮,66,23,43,群益金鼎-桃園,2024-10-11,9189
00665L,富邦�琤肭磪囓�2,43,5,38,群益金鼎-桃園,2024-10-11,9189
00679B,元大美債20年,40,3,37,群益金鼎-桃園,2024-10-11,9189
4956,光鋐,68,31,37,群益金鼎-桃園,2024-10-11,9189
8111,立��,86,50,36,群益金鼎-桃園,2024-10-11,9189
2388,威盛,36,8,28,群益金鼎-桃園,2024-10-11,9189
00937B,群益ESG投等債20,47,20,27,群益金鼎-桃園,2024-10-11,9189
00633L,富邦上証正2,25,0,25,群益金鼎-桃園,2024-10-11,9189
3576,聯合再生,23,0,23,群益金鼎-桃園,2024-10-11,9189
2449,京元電子,38,15,23,群益金鼎-桃園,2024-10-11,9189
2363,矽統,30,9,21,群益金鼎-桃園,2024-10-11,9189
00712,復華富時不動產,21,0,21,群益金鼎-桃園,2024-10-11,9189
0056,元大高股息,20,0,20,群益金鼎-桃園,2024-10-11,9189
2355,敬鵬,20,0,20,群益金鼎-桃園,2024-10-11,9189
2530,華建,20,0,20,群益金鼎-桃園,2024-10-11,9189
6108,競國,20,0,20,群益金鼎-桃園,2024-10-11,9189
6438,迅得,34,14,20,群益金鼎-桃園,2024-10-11,9189
4903,聯光通,51,33,18,群益金鼎-桃園,2024-10-11,9189
2344,華邦電,18,0,18,群益金鼎-桃園,2024-10-11,9189
2834,臺企銀,18,0,18,群益金鼎-桃園,2024-10-11,9189
6768,志強-KY,18,0,18,群益金鼎-桃園,2024-10-11,9189
3149,正達,133,116,17,群益金鼎-桃園,2024-10-11,9189
8028,昇陽半導體,20,4,16,群益金鼎-桃園,2024-10-11,9189
3710,連展投控,20,4,16,群益金鼎-桃園,2024-10-11,9189
3303,岱稜,26,11,15,群益金鼎-桃園,2024-10-11,9189
00940,元大台灣價值高息,24,10,14,群益金鼎-桃園,2024-10-11,9189
2887,台新金,14,0,14,群益金鼎-桃園,2024-10-11,9189
00795B,中信美國公債20年,13,0,13,群益金鼎-桃園,2024-10-11,9189
4927,泰鼎-KY,12,0,12,群益金鼎-桃園,2024-10-11,9189
2313,華通,16,4,12,群益金鼎-桃園,2024-10-11,9189
00655L,國泰中國A50正2,12,0,12,群益金鼎-桃園,2024-10-11,9189
2867,三商壽,12,0,12,群益金鼎-桃園,2024-10-11,9189
5309,系統電,12,0,12,群益金鼎-桃園,2024-10-11,9189
00922,國泰台灣領袖50,19,8,11,群益金鼎-桃園,2024-10-11,9189
00915,凱基優選高股息30,11,0,11,群益金鼎-桃園,2024-10-11,9189
2354,鴻準,12,1,11,群益金鼎-桃園,2024-10-11,9189
2605,新興,12,1,11,群益金鼎-桃園,2024-10-11,9189
6116,彩晶,11,0,11,群益金鼎-桃園,2024-10-11,9189
00632R,元大台灣50反1,312,67,245,群益金鼎-桃園,2024-10-14,9189
00688L,國泰20年美債正2,127,0,127,群益金鼎-桃園,2024-10-14,9189
00887,永豐中國科技50大,121,7,114,群益金鼎-桃園,2024-10-14,9189
2312,金寶,116,27,89,群益金鼎-桃園,2024-10-14,9189
0056,元大高股息,41,0,41,群益金鼎-桃園,2024-10-14,9189
2436,偉詮電,40,0,40,群益金鼎-桃園,2024-10-14,9189
00679B,元大美債20年,152,112,40,群益金鼎-桃園,2024-10-14,9189
00929,復華台灣科技優息,46,7,39,群益金鼎-桃園,2024-10-14,9189
2882,國泰金,38,0,38,群益金鼎-桃園,2024-10-14,9189
2883,凱基金,55,20,35,群益金鼎-桃園,2024-10-14,9189
2002,中鋼,36,1,35,群益金鼎-桃園,2024-10-14,9189
2887,台新金,35,0,35,群益金鼎-桃園,2024-10-14,9189
4563,百德,37,2,35,群益金鼎-桃園,2024-10-14,9189
00912,中信臺灣智慧50,30,0,30,群益金鼎-桃園,2024-10-14,9189
2885,元大金,30,0,30,群益金鼎-桃園,2024-10-14,9189
3049,精金,38,10,28,群益金鼎-桃園,2024-10-14,9189
2891,中信金,101,75,26,群益金鼎-桃園,2024-10-14,9189
5452,佶優,35,9,26,群益金鼎-桃園,2024-10-14,9189
00725B,國泰投資級公司債,25,0,25,群益金鼎-桃園,2024-10-14,9189
2007,燁興,23,0,23,群益金鼎-桃園,2024-10-14,9189
3499,環天科,24,2,22,群益金鼎-桃園,2024-10-14,9189
3663,鑫科,21,0,21,群益金鼎-桃園,2024-10-14,9189
2324,仁寶,22,1,21,群益金鼎-桃園,2024-10-14,9189
00932,兆豐永續高息等權,20,0,20,群益金鼎-桃園,2024-10-14,9189
4526,東台,20,0,20,群益金鼎-桃園,2024-10-14,9189
8011,台通,27,8,19,群益金鼎-桃園,2024-10-14,9189
3163,波若威,54,35,19,群益金鼎-桃園,2024-10-14,9189
00752,中信中國50,25,6,19,群益金鼎-桃園,2024-10-14,9189
2421,建準,32,14,18,群益金鼎-桃園,2024-10-14,9189
2845,遠東銀,18,0,18,群益金鼎-桃園,2024-10-14,9189
2601,益航,16,0,16,群益金鼎-桃園,2024-10-14,9189
8059,凱碩,16,0,16,群益金鼎-桃園,2024-10-14,9189
6202,盛群,21,5,16,群益金鼎-桃園,2024-10-14,9189
00878,國泰永續高股息,17,1,16,群益金鼎-桃園,2024-10-14,9189
6104,創惟,27,12,15,群益金鼎-桃園,2024-10-14,9189
3149,正達,27,12,15,群益金鼎-桃園,2024-10-14,9189
2618,長榮航,15,0,15,群益金鼎-桃園,2024-10-14,9189
4903,聯光通,23,10,13,群益金鼎-桃園,2024-10-14,9189
6451,訊芯-KY,15,2,13,群益金鼎-桃園,2024-10-14,9189
00795B,中信美國公債20年,12,0,12,群益金鼎-桃園,2024-10-14,9189
2528,皇普,29,17,12,群益金鼎-桃園,2024-10-14,9189
4303,信立,18,6,12,群益金鼎-桃園,2024-10-14,9189
00891,中信關鍵半導體,11,0,11,群益金鼎-桃園,2024-10-14,9189
2426,鼎元,50,39,11,群益金鼎-桃園,2024-10-14,9189
00751B,元大AAA至A公司債,11,0,11,群益金鼎-桃園,2024-10-14,9189
00959B,大華投等美債15Y+,11,0,11,群益金鼎-桃園,2024-10-14,9189
5905,南仁湖,11,0,11,群益金鼎-桃園,2024-10-14,9189
6142,友勁,11,0,11,群益金鼎-桃園,2024-10-14,9189
2609,陽明,13,2,11,群益金鼎-桃園,2024-10-14,9189
2101,南港,10,0,10,群益金鼎-桃園,2024-10-14,9189
00753L,中信中國50正2,193,2,191,群益金鼎-桃園,2024-10-15,9189
2888,新光金,163,17,146,群益金鼎-桃園,2024-10-15,9189
00688L,國泰20年美債正2,130,0,130,群益金鼎-桃園,2024-10-15,9189
00632R,元大台灣50反1,129,19,110,群益金鼎-桃園,2024-10-15,9189
00687B,國泰20年美債,70,0,70,群益金鼎-桃園,2024-10-15,9189
00937B,群益ESG投等債20,51,5,46,群益金鼎-桃園,2024-10-15,9189
2241,艾姆勒,65,20,45,群益金鼎-桃園,2024-10-15,9189
00680L,元大美債20正2,45,5,40,群益金鼎-桃園,2024-10-15,9189
00740B,富邦全球投等債,35,0,35,群益金鼎-桃園,2024-10-15,9189
1213,大飲,24,1,23,群益金鼎-桃園,2024-10-15,9189
00932,兆豐永續高息等權,22,0,22,群益金鼎-桃園,2024-10-15,9189
1301,台塑,21,0,21,群益金鼎-桃園,2024-10-15,9189
00637L,元大滬深300正2,47,27,20,群益金鼎-桃園,2024-10-15,9189
4927,泰鼎-KY,20,0,20,群益金鼎-桃園,2024-10-15,9189
8215,明基材,20,0,20,群益金鼎-桃園,2024-10-15,9189
6425,易發,20,0,20,群益金鼎-桃園,2024-10-15,9189
3303,岱稜,20,0,20,群益金鼎-桃園,2024-10-15,9189
4739,康普,20,0,20,群益金鼎-桃園,2024-10-15,9189
2887,台新金,25,6,19,群益金鼎-桃園,2024-10-15,9189
00919,群益台灣精選高息,19,1,18,群益金鼎-桃園,2024-10-15,9189
3499,環天科,17,0,17,群益金鼎-桃園,2024-10-15,9189
00948B,中信優息投資級債,16,0,16,群益金鼎-桃園,2024-10-15,9189
3390,旭軟,17,1,16,群益金鼎-桃園,2024-10-15,9189
3710,連展投控,25,9,16,群益金鼎-桃園,2024-10-15,9189
9958,世紀鋼,36,20,16,群益金鼎-桃園,2024-10-15,9189
3058,立德,15,0,15,群益金鼎-桃園,2024-10-15,9189
8028,昇陽半導體,28,14,14,群益金鼎-桃園,2024-10-15,9189
4956,光鋐,135,121,14,群益金鼎-桃園,2024-10-15,9189
1524,耿鼎,14,0,14,群益金鼎-桃園,2024-10-15,9189
6768,志強-KY,14,0,14,群益金鼎-桃園,2024-10-15,9189
3031,佰鴻,13,0,13,群益金鼎-桃園,2024-10-15,9189
6257,矽格,13,2,11,群益金鼎-桃園,2024-10-15,9189
2344,華邦電,15,4,11,群益金鼎-桃園,2024-10-15,9189
1714,和桐,11,0,11,群益金鼎-桃園,2024-10-15,9189
3576,聯合再生,11,0,11,群益金鼎-桃園,2024-10-15,9189
6168,宏齊,11,0,11,群益金鼎-桃園,2024-10-15,9189
2449,京元電子,16,5,11,群益金鼎-桃園,2024-10-15,9189
1611,中電,10,0,10,群益金鼎-桃園,2024-10-15,9189
3047,訊舟,11,1,10,群益金鼎-桃園,2024-10-15,9189
1569,濱川,10,0,10,群益金鼎-桃園,2024-10-15,9189
1455,集盛,10,0,10,群益金鼎-桃園,2024-10-15,9189
006206,元大上證50,10,0,10,群益金鼎-桃園,2024-10-15,9189
4555,氣立,12,4,8,群益金鼎-桃園,2024-10-15,9189
3673,TPK-KY,8,0,8,群益金鼎-桃園,2024-10-15,9189
1513,中興電,9,1,8,群益金鼎-桃園,2024-10-15,9189
4707,磐亞,9,1,8,群益金鼎-桃園,2024-10-15,9189
00881,國泰台灣5G+,24,16,8,群益金鼎-桃園,2024-10-15,9189
00882,中信中國高股息,15,7,8,群益金鼎-桃園,2024-10-15,9189
4979,華星光,40,33,7,群益金鼎-桃園,2024-10-15,9189
6156,松上,18,11,7,群益金鼎-桃園,2024-10-15,9189
00929,復華台灣科技優息,161,21,140,群益金鼎-桃園,2024-10-16,9189
00922,國泰台灣領袖50,175,44,131,群益金鼎-桃園,2024-10-16,9189
00688L,國泰20年美債正2,109,0,109,群益金鼎-桃園,2024-10-16,9189
0056,元大高股息,107,0,107,群益金鼎-桃園,2024-10-16,9189
2883,凱基金,84,5,79,群益金鼎-桃園,2024-10-16,9189
1722,台肥,71,1,70,群益金鼎-桃園,2024-10-16,9189
00894,中信小資高價30,58,0,58,群益金鼎-桃園,2024-10-16,9189
00679B,元大美債20年,57,3,54,群益金鼎-桃園,2024-10-16,9189
00753L,中信中國50正2,71,19,52,群益金鼎-桃園,2024-10-16,9189
00687B,國泰20年美債,49,4,45,群益金鼎-桃園,2024-10-16,9189
2330,台積電,50,5,45,群益金鼎-桃園,2024-10-16,9189
2888,新光金,43,2,41,群益金鼎-桃園,2024-10-16,9189
00919,群益台灣精選高息,56,15,41,群益金鼎-桃園,2024-10-16,9189
2344,華邦電,40,0,40,群益金鼎-桃園,2024-10-16,9189
2528,皇普,40,3,37,群益金鼎-桃園,2024-10-16,9189
2887,台新金,36,3,33,群益金鼎-桃園,2024-10-16,9189
00951,台新日本半導體,30,0,30,群益金鼎-桃園,2024-10-16,9189
6215,和椿,37,10,27,群益金鼎-桃園,2024-10-16,9189
2303,聯電,26,0,26,群益金鼎-桃園,2024-10-16,9189
00887,永豐中國科技50大,27,1,26,群益金鼎-桃園,2024-10-16,9189
2408,南亞科,25,0,25,群益金鼎-桃園,2024-10-16,9189
1802,台玻,25,2,23,群益金鼎-桃園,2024-10-16,9189
4533,協易機,24,3,21,群益金鼎-桃園,2024-10-16,9189
3303,岱稜,20,0,20,群益金鼎-桃園,2024-10-16,9189
3029,零壹,21,2,19,群益金鼎-桃園,2024-10-16,9189
6274,台燿,20,1,19,群益金鼎-桃園,2024-10-16,9189
8404,百和興業-KY,17,0,17,群益金鼎-桃園,2024-10-16,9189
9105,泰金寶-DR,48,32,16,群益金鼎-桃園,2024-10-16,9189
3257,虹冠電,16,0,16,群益金鼎-桃園,2024-10-16,9189
3499,環天科,16,0,16,群益金鼎-桃園,2024-10-16,9189
00937B,群益ESG投等債20,18,2,16,群益金鼎-桃園,2024-10-16,9189
3149,正達,107,92,15,群益金鼎-桃園,2024-10-16,9189
4908,前鼎,16,1,15,群益金鼎-桃園,2024-10-16,9189
4729,熒茂,18,3,15,群益金鼎-桃園,2024-10-16,9189
00905,FT臺灣Smart,14,0,14,群益金鼎-桃園,2024-10-16,9189
6546,正基,13,0,13,群益金鼎-桃園,2024-10-16,9189
8086,宏捷科,14,1,13,群益金鼎-桃園,2024-10-16,9189
2371,大同,12,0,12,群益金鼎-桃園,2024-10-16,9189
3591,艾笛森,12,0,12,群益金鼎-桃園,2024-10-16,9189
5443,均豪,13,1,12,群益金鼎-桃園,2024-10-16,9189
5880,合庫金,12,0,12,群益金鼎-桃園,2024-10-16,9189
2363,矽統,18,6,12,群益金鼎-桃園,2024-10-16,9189
00912,中信臺灣智慧50,13,2,11,群益金鼎-桃園,2024-10-16,9189
9933,中鼎,11,0,11,群益金鼎-桃園,2024-10-16,9189
5498,凱崴,11,0,11,群益金鼎-桃園,2024-10-16,9189
2028,威致,11,0,11,群益金鼎-桃園,2024-10-16,9189
6425,易發,23,13,10,群益金鼎-桃園,2024-10-16,9189
00881,國泰台灣5G+,11,1,10,群益金鼎-桃園,2024-10-16,9189
9945,潤泰新,21,11,10,群益金鼎-桃園,2024-10-16,9189
00916,國泰全球品牌50,10,0,10,群益金鼎-桃園,2024-10-16,9189
1528,恩德,206,51,155,群益金鼎-桃園,2024-10-17,9189
00922,國泰台灣領袖50,133,2,131,群益金鼎-桃園,2024-10-17,9189
00753L,中信中國50正2,121,0,121,群益金鼎-桃園,2024-10-17,9189
00688L,國泰20年美債正2,104,0,104,群益金鼎-桃園,2024-10-17,9189
2486,一詮,82,13,69,群益金鼎-桃園,2024-10-17,9189
00959B,大華投等美債15Y+,55,0,55,群益金鼎-桃園,2024-10-17,9189
3303,岱稜,45,1,44,群益金鼎-桃園,2024-10-17,9189
2399,映泰,69,33,36,群益金鼎-桃園,2024-10-17,9189
00951,台新日本半導體,30,0,30,群益金鼎-桃園,2024-10-17,9189
00720B,元大投資級公司債,33,4,29,群益金鼎-桃園,2024-10-17,9189
00706L,期元大S＆P日圓正2,20,0,20,群益金鼎-桃園,2024-10-17,9189
0056,元大高股息,30,10,20,群益金鼎-桃園,2024-10-17,9189
6530,創威,27,12,15,群益金鼎-桃園,2024-10-17,9189
4903,聯光通,27,12,15,群益金鼎-桃園,2024-10-17,9189
1213,大飲,25,10,15,群益金鼎-桃園,2024-10-17,9189
4915,致伸,14,0,14,群益金鼎-桃園,2024-10-17,9189
2903,遠百,13,0,13,群益金鼎-桃園,2024-10-17,9189
00905,FT臺灣Smart,13,0,13,群益金鼎-桃園,2024-10-17,9189
6125,廣運,13,1,12,群益金鼎-桃園,2024-10-17,9189
3062,建漢,21,9,12,群益金鼎-桃園,2024-10-17,9189
2515,中工,15,4,11,群益金鼎-桃園,2024-10-17,9189
2388,威盛,14,3,11,群益金鼎-桃園,2024-10-17,9189
1536,和大,21,10,11,群益金鼎-桃園,2024-10-17,9189
1314,中石化,11,0,11,群益金鼎-桃園,2024-10-17,9189
2431,聯昌,10,0,10,群益金鼎-桃園,2024-10-17,9189
2323,中環,10,0,10,群益金鼎-桃園,2024-10-17,9189
2426,鼎元,11,1,10,群益金鼎-桃園,2024-10-17,9189
2482,連宇,10,0,10,群益金鼎-桃園,2024-10-17,9189
3545,敦泰,10,0,10,群益金鼎-桃園,2024-10-17,9189
2330,台積電,12,2,10,群益金鼎-桃園,2024-10-17,9189
6449,鈺邦,11,2,9,群益金鼎-桃園,2024-10-17,9189
00948B,中信優息投資級債,20,11,9,群益金鼎-桃園,2024-10-17,9189
6763,綠界科技*,12,3,9,群益金鼎-桃園,2024-10-17,9189
8032,光菱,21,12,9,群益金鼎-桃園,2024-10-17,9189
3711,日月光投控,9,1,8,群益金鼎-桃園,2024-10-17,9189
3312,弘憶股,10,2,8,群益金鼎-桃園,2024-10-17,9189
00882,中信中國高股息,9,1,8,群益金鼎-桃園,2024-10-17,9189
8111,立��,22,15,7,群益金鼎-桃園,2024-10-17,9189
00912,中信臺灣智慧50,7,0,7,群益金鼎-桃園,2024-10-17,9189
5907,大洋-KY,7,0,7,群益金鼎-桃園,2024-10-17,9189
2377,微星,7,0,7,群益金鼎-桃園,2024-10-17,9189
00637L,元大滬深300正2,84,77,7,群益金鼎-桃園,2024-10-17,9189
3413,京鼎,8,1,7,群益金鼎-桃園,2024-10-17,9189
006208,富邦台50,7,1,6,群益金鼎-桃園,2024-10-17,9189
2449,京元電子,18,12,6,群益金鼎-桃園,2024-10-17,9189
00733,富邦臺灣中小,6,0,6,群益金鼎-桃園,2024-10-17,9189
4938,和碩,6,0,6,群益金鼎-桃園,2024-10-17,9189
8936,國統,6,0,6,群益金鼎-桃園,2024-10-17,9189
4513,福裕,6,0,6,群益金鼎-桃園,2024-10-17,9189
2845,遠東銀,6,0,6,群益金鼎-桃園,2024-10-17,9189
00937B,群益ESG投等債20,495,0,495,群益金鼎-桃園,2024-10-18,9189
00753L,中信中國50正2,471,0,471,群益金鼎-桃園,2024-10-18,9189
00632R,元大台灣50反1,339,12,327,群益金鼎-桃園,2024-10-18,9189
00932,兆豐永續高息等權,270,0,270,群益金鼎-桃園,2024-10-18,9189
2352,佳世達,156,0,156,群益金鼎-桃園,2024-10-18,9189
00688L,國泰20年美債正2,118,0,118,群益金鼎-桃園,2024-10-18,9189
00686R,群益臺灣加權反1,100,0,100,群益金鼎-桃園,2024-10-18,9189
00687B,國泰20年美債,99,1,98,群益金鼎-桃園,2024-10-18,9189
2303,聯電,82,3,79,群益金鼎-桃園,2024-10-18,9189
00679B,元大美債20年,70,2,68,群益金鼎-桃園,2024-10-18,9189
2313,華通,75,15,60,群益金鼎-桃園,2024-10-18,9189
00680L,元大美債20正2,54,0,54,群益金鼎-桃園,2024-10-18,9189
00664R,國泰臺灣加權反1,52,0,52,群益金鼎-桃園,2024-10-18,9189
00959B,大華投等美債15Y+,46,0,46,群益金鼎-桃園,2024-10-18,9189
2374,佳能,40,3,37,群益金鼎-桃園,2024-10-18,9189
00948B,中信優息投資級債,33,0,33,群益金鼎-桃園,2024-10-18,9189
00715L,期街口布蘭特正2,31,0,31,群益金鼎-桃園,2024-10-18,9189
0056,元大高股息,33,2,31,群益金鼎-桃園,2024-10-18,9189
2355,敬鵬,26,0,26,群益金鼎-桃園,2024-10-18,9189
3162,精確,30,4,26,群益金鼎-桃園,2024-10-18,9189
00706L,期元大S＆P日圓正2,25,0,25,群益金鼎-桃園,2024-10-18,9189
00751B,元大AAA至A公司債,24,0,24,群益金鼎-桃園,2024-10-18,9189
6165,浪凡,28,6,22,群益金鼎-桃園,2024-10-18,9189
9925,新保,21,0,21,群益金鼎-桃園,2024-10-18,9189
00951,台新日本半導體,20,0,20,群益金鼎-桃園,2024-10-18,9189
6005,群益證,20,0,20,群益金鼎-桃園,2024-10-18,9189
6505,台塑化,20,0,20,群益金鼎-桃園,2024-10-18,9189
8043,蜜望實,19,0,19,群益金鼎-桃園,2024-10-18,9189
2886,兆豐金,20,1,19,群益金鼎-桃園,2024-10-18,9189
2421,建準,35,17,18,群益金鼎-桃園,2024-10-18,9189
4109,加捷生醫,17,0,17,群益金鼎-桃園,2024-10-18,9189
2449,京元電子,39,22,17,群益金鼎-桃園,2024-10-18,9189
4903,聯光通,26,10,16,群益金鼎-桃園,2024-10-18,9189
5880,合庫金,20,4,16,群益金鼎-桃園,2024-10-18,9189
8028,昇陽半導體,98,83,15,群益金鼎-桃園,2024-10-18,9189
00931B,統一美債20年,14,0,14,群益金鼎-桃園,2024-10-18,9189
3031,佰鴻,18,4,14,群益金鼎-桃園,2024-10-18,9189
3025,星通,28,14,14,群益金鼎-桃園,2024-10-18,9189
2637,慧洋-KY,15,1,14,群益金鼎-桃園,2024-10-18,9189
00795B,中信美國公債20年,13,0,13,群益金鼎-桃園,2024-10-18,9189
00942B,台新美A公司債20+,13,0,13,群益金鼎-桃園,2024-10-18,9189
2431,聯昌,13,0,13,群益金鼎-桃園,2024-10-18,9189
5347,世界,18,5,13,群益金鼎-桃園,2024-10-18,9189
1605,華新,13,0,13,群益金鼎-桃園,2024-10-18,9189
3105,穩懋,13,1,12,群益金鼎-桃園,2024-10-18,9189
0061,元大寶滬深,12,0,12,群益金鼎-桃園,2024-10-18,9189
2323,中環,12,0,12,群益金鼎-桃園,2024-10-18,9189
00633L,富邦上証正2,12,0,12,群益金鼎-桃園,2024-10-18,9189
00891,中信關鍵半導體,11,0,11,群益金鼎-桃園,2024-10-18,9189
00740B,富邦全球投等債,11,0,11,群益金鼎-桃園,2024-10-18,9189
00937B,群益ESG投等債20,186,0,186,群益金鼎-桃園,2024-10-21,9189
00679B,元大美債20年,181,0,181,群益金鼎-桃園,2024-10-21,9189
00929,復華台灣科技優息,164,18,146,群益金鼎-桃園,2024-10-21,9189
00953B,群益優選非投等債,143,0,143,群益金鼎-桃園,2024-10-21,9189
00687B,國泰20年美債,112,0,112,群益金鼎-桃園,2024-10-21,9189
00637L,元大滬深300正2,121,41,80,群益金鼎-桃園,2024-10-21,9189
2883,凱基金,62,3,59,群益金鼎-桃園,2024-10-21,9189
00632R,元大台灣50反1,53,0,53,群益金鼎-桃園,2024-10-21,9189
00688L,國泰20年美債正2,44,5,39,群益金鼎-桃園,2024-10-21,9189
5880,合庫金,35,1,34,群益金鼎-桃園,2024-10-21,9189
00933B,國泰10Y+金融債,32,0,32,群益金鼎-桃園,2024-10-21,9189
2618,長榮航,39,9,30,群益金鼎-桃園,2024-10-21,9189
2002,中鋼,27,0,27,群益金鼎-桃園,2024-10-21,9189
6156,松上,39,12,27,群益金鼎-桃園,2024-10-21,9189
00959B,大華投等美債15Y+,26,0,26,群益金鼎-桃園,2024-10-21,9189
00900,富邦特選高股息30,28,4,24,群益金鼎-桃園,2024-10-21,9189
00715L,期街口布蘭特正2,25,1,24,群益金鼎-桃園,2024-10-21,9189
2884,玉山金,20,0,20,群益金鼎-桃園,2024-10-21,9189
2881,富邦金,19,1,18,群益金鼎-桃園,2024-10-21,9189
3450,聯鈞,45,27,18,群益金鼎-桃園,2024-10-21,9189
2359,所羅門,20,2,18,群益金鼎-桃園,2024-10-21,9189
5443,均豪,18,0,18,群益金鼎-桃園,2024-10-21,9189
2845,遠東銀,17,0,17,群益金鼎-桃園,2024-10-21,9189
4561,健椿,21,4,17,群益金鼎-桃園,2024-10-21,9189
2486,一詮,26,10,16,群益金鼎-桃園,2024-10-21,9189
2886,兆豐金,17,1,16,群益金鼎-桃園,2024-10-21,9189
2102,泰豐,15,0,15,群益金鼎-桃園,2024-10-21,9189
6505,台塑化,14,0,14,群益金鼎-桃園,2024-10-21,9189
1326,台化,14,0,14,群益金鼎-桃園,2024-10-21,9189
00907,永豐優息存股,14,0,14,群益金鼎-桃園,2024-10-21,9189
5452,佶優,22,8,14,群益金鼎-桃園,2024-10-21,9189
00950B,凱基A級公司債,13,0,13,群益金鼎-桃園,2024-10-21,9189
2344,華邦電,28,15,13,群益金鼎-桃園,2024-10-21,9189
00927,群益半導體收益,12,0,12,群益金鼎-桃園,2024-10-21,9189
3060,銘異,13,1,12,群益金鼎-桃園,2024-10-21,9189
2356,英業達,22,10,12,群益金鼎-桃園,2024-10-21,9189
3209,全科,13,2,11,群益金鼎-桃園,2024-10-21,9189
2498,宏達電,20,9,11,群益金鼎-桃園,2024-10-21,9189
2399,映泰,30,19,11,群益金鼎-桃園,2024-10-21,9189
00922,國泰台灣領袖50,11,0,11,群益金鼎-桃園,2024-10-21,9189
5347,世界,12,1,11,群益金鼎-桃園,2024-10-21,9189
2891,中信金,31,21,10,群益金鼎-桃園,2024-10-21,9189
00706L,期元大S＆P日圓正2,10,0,10,群益金鼎-桃園,2024-10-21,9189
9105,泰金寶-DR,23,13,10,群益金鼎-桃園,2024-10-21,9189
2538,基泰,10,0,10,群益金鼎-桃園,2024-10-21,9189
1213,大飲,11,1,10,群益金鼎-桃園,2024-10-21,9189
1455,集盛,10,0,10,群益金鼎-桃園,2024-10-21,9189
6770,力積電,11,1,10,群益金鼎-桃園,2024-10-21,9189
0056,元大高股息,11,1,10,群益金鼎-桃園,2024-10-21,9189
00915,凱基優選高股息30,9,0,9,群益金鼎-桃園,2024-10-21,9189
00680L,元大美債20正2,296,74,222,群益金鼎-桃園,2024-10-22,9189
00937B,群益ESG投等債20,229,15,214,群益金鼎-桃園,2024-10-22,9189
00688L,國泰20年美債正2,155,6,149,群益金鼎-桃園,2024-10-22,9189
00679B,元大美債20年,265,151,114,群益金鼎-桃園,2024-10-22,9189
4960,誠美材,73,0,73,群益金鼎-桃園,2024-10-22,9189
00948B,中信優息投資級債,54,0,54,群益金鼎-桃園,2024-10-22,9189
3303,岱稜,54,0,54,群益金鼎-桃園,2024-10-22,9189
2201,裕隆,50,0,50,群益金鼎-桃園,2024-10-22,9189
00637L,元大滬深300正2,71,30,41,群益金鼎-桃園,2024-10-22,9189
5452,佶優,55,18,37,群益金鼎-桃園,2024-10-22,9189
00931B,統一美債20年,47,15,32,群益金鼎-桃園,2024-10-22,9189
2367,燿華,42,10,32,群益金鼎-桃園,2024-10-22,9189
00959B,大華投等美債15Y+,32,0,32,群益金鼎-桃園,2024-10-22,9189
2359,所羅門,30,0,30,群益金鼎-桃園,2024-10-22,9189
2344,華邦電,27,0,27,群益金鼎-桃園,2024-10-22,9189
00720B,元大投資級公司債,22,0,22,群益金鼎-桃園,2024-10-22,9189
2528,皇普,22,0,22,群益金鼎-桃園,2024-10-22,9189
3285,微端,20,0,20,群益金鼎-桃園,2024-10-22,9189
4540,全球傳動,24,4,20,群益金鼎-桃園,2024-10-22,9189
2303,聯電,20,0,20,群益金鼎-桃園,2024-10-22,9189
2613,中櫃,20,0,20,群益金鼎-桃園,2024-10-22,9189
00907,永豐優息存股,18,0,18,群益金鼎-桃園,2024-10-22,9189
2489,瑞軒,17,0,17,群益金鼎-桃園,2024-10-22,9189
00953B,群益優選非投等債,16,0,16,群益金鼎-桃園,2024-10-22,9189
00950B,凱基A級公司債,16,0,16,群益金鼎-桃園,2024-10-22,9189
00712,復華富時不動產,16,0,16,群益金鼎-桃園,2024-10-22,9189
3710,連展投控,17,2,15,群益金鼎-桃園,2024-10-22,9189
3060,銘異,15,0,15,群益金鼎-桃園,2024-10-22,9189
00751B,元大AAA至A公司債,14,0,14,群益金鼎-桃園,2024-10-22,9189
00941,中信上游半導體,11,0,11,群益金鼎-桃園,2024-10-22,9189
2911,麗嬰房,11,0,11,群益金鼎-桃園,2024-10-22,9189
00692,富邦公司治理,11,0,11,群益金鼎-桃園,2024-10-22,9189
9958,世紀鋼,11,0,11,群益金鼎-桃園,2024-10-22,9189
2492,華新科,10,0,10,群益金鼎-桃園,2024-10-22,9189
2399,映泰,32,22,10,群益金鼎-桃園,2024-10-22,9189
00675L,富邦臺灣加權正2,10,0,10,群益金鼎-桃園,2024-10-22,9189
00945B,凱基美國非投等債,10,0,10,群益金鼎-桃園,2024-10-22,9189
2538,基泰,10,0,10,群益金鼎-桃園,2024-10-22,9189
2105,正新,10,0,10,群益金鼎-桃園,2024-10-22,9189
2101,南港,10,0,10,群益金鼎-桃園,2024-10-22,9189
6237,驊訊,11,1,10,群益金鼎-桃園,2024-10-22,9189
2033,佳大,11,1,10,群益金鼎-桃園,2024-10-22,9189
2493,揚博,18,8,10,群益金鼎-桃園,2024-10-22,9189
00713,元大台灣高息低波,10,0,10,群益金鼎-桃園,2024-10-22,9189
2301,光寶科,10,0,10,群益金鼎-桃園,2024-10-22,9189
00687B,國泰20年美債,167,158,9,群益金鼎-桃園,2024-10-22,9189
2883,凱基金,16,7,9,群益金鼎-桃園,2024-10-22,9189
00795B,中信美國公債20年,15,6,9,群益金鼎-桃園,2024-10-22,9189
00725B,國泰投資級公司債,9,0,9,群益金鼎-桃園,2024-10-22,9189
6261,久元,9,0,9,群益金鼎-桃園,2024-10-22,9189
00937B,群益ESG投等債20,236,4,232,群益金鼎-桃園,2024-10-23,9189
9105,泰金寶-DR,130,0,130,群益金鼎-桃園,2024-10-23,9189
2528,皇普,120,0,120,群益金鼎-桃園,2024-10-23,9189
00688L,國泰20年美債正2,134,31,103,群益金鼎-桃園,2024-10-23,9189
00932,兆豐永續高息等權,76,5,71,群益金鼎-桃園,2024-10-23,9189
00679B,元大美債20年,61,3,58,群益金鼎-桃園,2024-10-23,9189
00687B,國泰20年美債,60,2,58,群益金鼎-桃園,2024-10-23,9189
00940,元大台灣價值高息,55,4,51,群益金鼎-桃園,2024-10-23,9189
2317,鴻海,87,37,50,群益金鼎-桃園,2024-10-23,9189
1522,堤維西,50,0,50,群益金鼎-桃園,2024-10-23,9189
3303,岱稜,52,2,50,群益金鼎-桃園,2024-10-23,9189
2464,盟立,44,2,42,群益金鼎-桃園,2024-10-23,9189
2845,遠東銀,42,0,42,群益金鼎-桃園,2024-10-23,9189
00929,復華台灣科技優息,42,0,42,群益金鼎-桃園,2024-10-23,9189
00951,台新日本半導體,40,0,40,群益金鼎-桃園,2024-10-23,9189
00959B,大華投等美債15Y+,35,0,35,群益金鼎-桃園,2024-10-23,9189
00907,永豐優息存股,30,0,30,群益金鼎-桃園,2024-10-23,9189
2884,玉山金,28,0,28,群益金鼎-桃園,2024-10-23,9189
8404,百和興業-KY,27,0,27,群益金鼎-桃園,2024-10-23,9189
6005,群益證,26,0,26,群益金鼎-桃園,2024-10-23,9189
8064,東捷,116,91,25,群益金鼎-桃園,2024-10-23,9189
00911,兆豐洲際半導體,20,0,20,群益金鼎-桃園,2024-10-23,9189
2329,華泰,68,48,20,群益金鼎-桃園,2024-10-23,9189
00919,群益台灣精選高息,20,1,19,群益金鼎-桃園,2024-10-23,9189
2887,台新金,19,0,19,群益金鼎-桃園,2024-10-23,9189
00953B,群益優選非投等債,18,0,18,群益金鼎-桃園,2024-10-23,9189
2312,金寶,27,10,17,群益金鼎-桃園,2024-10-23,9189
8076,伍豐,17,0,17,群益金鼎-桃園,2024-10-23,9189
00772B,中信高評級公司債,20,3,17,群益金鼎-桃園,2024-10-23,9189
6770,力積電,22,6,16,群益金鼎-桃園,2024-10-23,9189
00891,中信關鍵半導體,16,0,16,群益金鼎-桃園,2024-10-23,9189
4526,東台,23,7,16,群益金鼎-桃園,2024-10-23,9189
1213,大飲,20,4,16,群益金鼎-桃園,2024-10-23,9189
2303,聯電,26,10,16,群益金鼎-桃園,2024-10-23,9189
2408,南亞科,15,0,15,群益金鼎-桃園,2024-10-23,9189
00948B,中信優息投資級債,18,4,14,群益金鼎-桃園,2024-10-23,9189
1326,台化,13,0,13,群益金鼎-桃園,2024-10-23,9189
2890,永豐金,14,1,13,群益金鼎-桃園,2024-10-23,9189
6165,浪凡,13,0,13,群益金鼎-桃園,2024-10-23,9189
00712,復華富時不動產,13,0,13,群益金鼎-桃園,2024-10-23,9189
00887,永豐中國科技50大,40,28,12,群益金鼎-桃園,2024-10-23,9189
2362,藍天,14,2,12,群益金鼎-桃園,2024-10-23,9189
2367,燿華,17,5,12,群益金鼎-桃園,2024-10-23,9189
6120,達運,12,0,12,群益金鼎-桃園,2024-10-23,9189
00878,國泰永續高股息,30,18,12,群益金鼎-桃園,2024-10-23,9189
00713,元大台灣高息低波,11,0,11,群益金鼎-桃園,2024-10-23,9189
6133,金橋,11,0,11,群益金鼎-桃園,2024-10-23,9189
3710,連展投控,11,0,11,群益金鼎-桃園,2024-10-23,9189
2883,凱基金,12,2,10,群益金鼎-桃園,2024-10-23,9189
1605,華新,10,0,10,群益金鼎-桃園,2024-10-23,9189
00706L,期元大S＆P日圓正2,639,0,639,群益金鼎-桃園,2024-10-24,9189
00680L,元大美債20正2,270,0,270,群益金鼎-桃園,2024-10-24,9189
1595,川寶,108,2,106,群益金鼎-桃園,2024-10-24,9189
00688L,國泰20年美債正2,100,0,100,群益金鼎-桃園,2024-10-24,9189
00929,復華台灣科技優息,79,10,69,群益金鼎-桃園,2024-10-24,9189
2528,皇普,60,0,60,群益金鼎-桃園,2024-10-24,9189
00894,中信小資高價30,50,0,50,群益金鼎-桃園,2024-10-24,9189
1522,堤維西,50,1,49,群益金鼎-桃園,2024-10-24,9189
2382,廣達,46,0,46,群益金鼎-桃園,2024-10-24,9189
2891,中信金,55,10,45,群益金鼎-桃園,2024-10-24,9189
00940,元大台灣價值高息,54,9,45,群益金鼎-桃園,2024-10-24,9189
3710,連展投控,42,0,42,群益金鼎-桃園,2024-10-24,9189
2388,威盛,41,1,40,群益金鼎-桃園,2024-10-24,9189
00953B,群益優選非投等債,35,0,35,群益金鼎-桃園,2024-10-24,9189
0056,元大高股息,34,0,34,群益金鼎-桃園,2024-10-24,9189
4716,大立,97,64,33,群益金鼎-桃園,2024-10-24,9189
00948B,中信優息投資級債,33,0,33,群益金鼎-桃園,2024-10-24,9189
2313,華通,34,3,31,群益金鼎-桃園,2024-10-24,9189
00950B,凱基A級公司債,30,0,30,群益金鼎-桃園,2024-10-24,9189
4114,健喬,30,0,30,群益金鼎-桃園,2024-10-24,9189
2431,聯昌,54,26,28,群益金鼎-桃園,2024-10-24,9189
3450,聯鈞,40,12,28,群益金鼎-桃園,2024-10-24,9189
00887,永豐中國科技50大,27,0,27,群益金鼎-桃園,2024-10-24,9189
00932,兆豐永續高息等權,25,0,25,群益金鼎-桃園,2024-10-24,9189
8404,百和興業-KY,24,0,24,群益金鼎-桃園,2024-10-24,9189
00637L,元大滬深300正2,53,30,23,群益金鼎-桃園,2024-10-24,9189
1815,富喬,41,18,23,群益金鼎-桃園,2024-10-24,9189
3615,安可,68,45,23,群益金鼎-桃園,2024-10-24,9189
1301,台塑,22,0,22,群益金鼎-桃園,2024-10-24,9189
2332,友訊,21,0,21,群益金鼎-桃園,2024-10-24,9189
2405,輔信,74,53,21,群益金鼎-桃園,2024-10-24,9189
6770,力積電,25,5,20,群益金鼎-桃園,2024-10-24,9189
3167,大量,25,5,20,群益金鼎-桃園,2024-10-24,9189
2374,佳能,27,9,18,群益金鼎-桃園,2024-10-24,9189
2911,麗嬰房,17,0,17,群益金鼎-桃園,2024-10-24,9189
2367,燿華,17,0,17,群益金鼎-桃園,2024-10-24,9189
5315,光聯,17,0,17,群益金鼎-桃園,2024-10-24,9189
5907,大洋-KY,20,4,16,群益金鼎-桃園,2024-10-24,9189
2609,陽明,21,5,16,群益金鼎-桃園,2024-10-24,9189
2887,台新金,16,0,16,群益金鼎-桃園,2024-10-24,9189
4729,熒茂,30,14,16,群益金鼎-桃園,2024-10-24,9189
3715,定穎投控,19,3,16,群益金鼎-桃園,2024-10-24,9189
00878,國泰永續高股息,19,4,15,群益金鼎-桃園,2024-10-24,9189
2489,瑞軒,33,18,15,群益金鼎-桃園,2024-10-24,9189
912000,晨訊科-DR,15,0,15,群益金鼎-桃園,2024-10-24,9189
8431,匯鑽科,15,0,15,群益金鼎-桃園,2024-10-24,9189
6763,綠界科技*,21,7,14,群益金鼎-桃園,2024-10-24,9189
3481,群創,24,10,14,群益金鼎-桃園,2024-10-24,9189
3037,欣興,23,9,14,群益金鼎-桃園,2024-10-24,9189
2545,皇翔,13,0,13,群益金鼎-桃園,2024-10-24,9189
00632R,元大台灣50反1,326,3,323,群益金鼎-桃園,2024-10-25,9189
00929,復華台灣科技優息,310,2,308,群益金鼎-桃園,2024-10-25,9189
00753L,中信中國50正2,821,529,292,群益金鼎-桃園,2024-10-25,9189
00887,永豐中國科技50大,159,1,158,群益金鼎-桃園,2024-10-25,9189
00679B,元大美債20年,143,3,140,群益金鼎-桃園,2024-10-25,9189
00937B,群益ESG投等債20,87,1,86,群益金鼎-桃園,2024-10-25,9189
00688L,國泰20年美債正2,86,2,84,群益金鼎-桃園,2024-10-25,9189
2344,華邦電,69,2,67,群益金鼎-桃園,2024-10-25,9189
4903,聯光通,62,2,60,群益金鼎-桃園,2024-10-25,9189
8043,蜜望實,80,24,56,群益金鼎-桃園,2024-10-25,9189
3576,聯合再生,93,45,48,群益金鼎-桃園,2024-10-25,9189
00959B,大華投等美債15Y+,46,0,46,群益金鼎-桃園,2024-10-25,9189
00687B,國泰20年美債,45,4,41,群益金鼎-桃園,2024-10-25,9189
8249,菱光,71,33,38,群益金鼎-桃園,2024-10-25,9189
1301,台塑,36,0,36,群益金鼎-桃園,2024-10-25,9189
2889,國票金,31,0,31,群益金鼎-桃園,2024-10-25,9189
9935,慶豐富,30,0,30,群益金鼎-桃園,2024-10-25,9189
00950B,凱基A級公司債,30,0,30,群益金鼎-桃園,2024-10-25,9189
1524,耿鼎,28,0,28,群益金鼎-桃園,2024-10-25,9189
6005,群益證,27,0,27,群益金鼎-桃園,2024-10-25,9189
2303,聯電,36,10,26,群益金鼎-桃園,2024-10-25,9189
00932,兆豐永續高息等權,26,0,26,群益金鼎-桃園,2024-10-25,9189
3663,鑫科,33,7,26,群益金鼎-桃園,2024-10-25,9189
2332,友訊,25,1,24,群益金鼎-桃園,2024-10-25,9189
2489,瑞軒,34,11,23,群益金鼎-桃園,2024-10-25,9189
6207,雷科,24,3,21,群益金鼎-桃園,2024-10-25,9189
2528,皇普,21,0,21,群益金鼎-桃園,2024-10-25,9189
2313,華通,20,0,20,群益金鼎-桃園,2024-10-25,9189
00945B,凱基美國非投等債,20,0,20,群益金鼎-桃園,2024-10-25,9189
00795B,中信美國公債20年,19,0,19,群益金鼎-桃園,2024-10-25,9189
2618,長榮航,28,11,17,群益金鼎-桃園,2024-10-25,9189
0056,元大高股息,21,4,17,群益金鼎-桃園,2024-10-25,9189
6223,旺矽,18,2,16,群益金鼎-桃園,2024-10-25,9189
3060,銘異,16,0,16,群益金鼎-桃園,2024-10-25,9189
2392,正崴,16,0,16,群益金鼎-桃園,2024-10-25,9189
1101,台泥,15,0,15,群益金鼎-桃園,2024-10-25,9189
3290,東浦,18,4,14,群益金鼎-桃園,2024-10-25,9189
1809,中釉,13,0,13,群益金鼎-桃園,2024-10-25,9189
00960,野村全球航運龍頭,13,0,13,群益金鼎-桃園,2024-10-25,9189
6156,松上,17,4,13,群益金鼎-桃園,2024-10-25,9189
2369,菱生,17,5,12,群益金鼎-桃園,2024-10-25,9189
4563,百德,12,0,12,群益金鼎-桃園,2024-10-25,9189
2646,星宇航空,293,281,12,群益金鼎-桃園,2024-10-25,9189
9945,潤泰新,11,0,11,群益金鼎-桃園,2024-10-25,9189
2020,美亞,11,0,11,群益金鼎-桃園,2024-10-25,9189
2349,錸德,11,0,11,群益金鼎-桃園,2024-10-25,9189
2883,凱基金,10,0,10,群益金鼎-桃園,2024-10-25,9189
6202,盛群,10,0,10,群益金鼎-桃園,2024-10-25,9189
6751,智聯服務,10,0,10,群益金鼎-桃園,2024-10-25,9189
6016,康和證,10,0,10,群益金鼎-桃園,2024-10-25,9189
00948B,中信優息投資級債,301,0,301,群益金鼎-桃園,2024-10-28,9189
00937B,群益ESG投等債20,307,20,287,群益金鼎-桃園,2024-10-28,9189
00680L,元大美債20正2,178,1,177,群益金鼎-桃園,2024-10-28,9189
00795B,中信美國公債20年,91,0,91,群益金鼎-桃園,2024-10-28,9189
1416,廣豐,91,0,91,群益金鼎-桃園,2024-10-28,9189
00679B,元大美債20年,112,25,87,群益金鼎-桃園,2024-10-28,9189
2886,兆豐金,60,0,60,群益金鼎-桃園,2024-10-28,9189
00950B,凱基A級公司債,60,0,60,群益金鼎-桃園,2024-10-28,9189
00959B,大華投等美債15Y+,48,0,48,群益金鼎-桃園,2024-10-28,9189
00687B,國泰20年美債,98,50,48,群益金鼎-桃園,2024-10-28,9189
00688L,國泰20年美債正2,104,60,44,群益金鼎-桃園,2024-10-28,9189
8234,新漢,42,0,42,群益金鼎-桃園,2024-10-28,9189
2646,星宇航空,95,57,38,群益金鼎-桃園,2024-10-28,9189
00905,FT臺灣Smart,30,0,30,群益金鼎-桃園,2024-10-28,9189
2002,中鋼,32,3,29,群益金鼎-桃園,2024-10-28,9189
2303,聯電,29,2,27,群益金鼎-桃園,2024-10-28,9189
2399,映泰,139,112,27,群益金鼎-桃園,2024-10-28,9189
00715L,期街口布蘭特正2,41,15,26,群益金鼎-桃園,2024-10-28,9189
6142,友勁,33,7,26,群益金鼎-桃園,2024-10-28,9189
6438,迅得,31,5,26,群益金鼎-桃園,2024-10-28,9189
2330,台積電,32,8,24,群益金鼎-桃園,2024-10-28,9189
1595,川寶,45,24,21,群益金鼎-桃園,2024-10-28,9189
4545,銘鈺,25,4,21,群益金鼎-桃園,2024-10-28,9189
6763,綠界科技*,21,0,21,群益金鼎-桃園,2024-10-28,9189
2929,淘帝-KY,20,0,20,群益金鼎-桃園,2024-10-28,9189
00706L,期元大S＆P日圓正2,20,0,20,群益金鼎-桃園,2024-10-28,9189
3149,正達,24,6,18,群益金鼎-桃園,2024-10-28,9189
1528,恩德,29,11,18,群益金鼎-桃園,2024-10-28,9189
4746,台耀,18,0,18,群益金鼎-桃園,2024-10-28,9189
00751B,元大AAA至A公司債,16,0,16,群益金鼎-桃園,2024-10-28,9189
3060,銘異,16,0,16,群益金鼎-桃園,2024-10-28,9189
6288,聯嘉,127,112,15,群益金鼎-桃園,2024-10-28,9189
00642U,期元大S＆P石油,15,0,15,群益金鼎-桃園,2024-10-28,9189
3234,光環,15,1,14,群益金鼎-桃園,2024-10-28,9189
00918,大華優利高填息30,14,0,14,群益金鼎-桃園,2024-10-28,9189
9958,世紀鋼,18,5,13,群益金鼎-桃園,2024-10-28,9189
6530,創威,24,12,12,群益金鼎-桃園,2024-10-28,9189
3715,定穎投控,14,3,11,群益金鼎-桃園,2024-10-28,9189
2352,佳世達,11,0,11,群益金鼎-桃園,2024-10-28,9189
8064,東捷,14,3,11,群益金鼎-桃園,2024-10-28,9189
2010,春源,11,0,11,群益金鼎-桃園,2024-10-28,9189
3363,上詮,12,2,10,群益金鼎-桃園,2024-10-28,9189
2367,燿華,11,1,10,群益金鼎-桃園,2024-10-28,9189
2408,南亞科,10,0,10,群益金鼎-桃園,2024-10-28,9189
8085,福華,12,2,10,群益金鼎-桃園,2024-10-28,9189
2637,慧洋-KY,10,0,10,群益金鼎-桃園,2024-10-28,9189
00891,中信關鍵半導體,10,0,10,群益金鼎-桃園,2024-10-28,9189
2323,中環,10,0,10,群益金鼎-桃園,2024-10-28,9189
2489,瑞軒,17,8,9,群益金鼎-桃園,2024-10-28,9189
00946,群益科技高息成長,9,0,9,群益金鼎-桃園,2024-10-28,9189
00959B,大華投等美債15Y+,501,0,501,群益金鼎-桃園,2024-10-29,9189
2618,長榮航,358,2,356,群益金鼎-桃園,2024-10-29,9189
00948B,中信優息投資級債,121,0,121,群益金鼎-桃園,2024-10-29,9189
00687B,國泰20年美債,114,6,108,群益金鼎-桃園,2024-10-29,9189
3710,連展投控,107,4,103,群益金鼎-桃園,2024-10-29,9189
0056,元大高股息,94,4,90,群益金鼎-桃園,2024-10-29,9189
00919,群益台灣精選高息,89,3,86,群益金鼎-桃園,2024-10-29,9189
2883,凱基金,83,1,82,群益金鼎-桃園,2024-10-29,9189
2317,鴻海,95,18,77,群益金鼎-桃園,2024-10-29,9189
2880,華南金,65,0,65,群益金鼎-桃園,2024-10-29,9189
00929,復華台灣科技優息,126,62,64,群益金鼎-桃園,2024-10-29,9189
3303,岱稜,52,1,51,群益金鼎-桃園,2024-10-29,9189
00632R,元大台灣50反1,72,23,49,群益金鼎-桃園,2024-10-29,9189
2344,華邦電,48,0,48,群益金鼎-桃園,2024-10-29,9189
2528,皇普,50,2,48,群益金鼎-桃園,2024-10-29,9189
00940,元大台灣價值高息,49,2,47,群益金鼎-桃園,2024-10-29,9189
8044,網家,49,4,45,群益金鼎-桃園,2024-10-29,9189
00688L,國泰20年美債正2,100,60,40,群益金鼎-桃園,2024-10-29,9189
2303,聯電,39,3,36,群益金鼎-桃園,2024-10-29,9189
5880,合庫金,33,1,32,群益金鼎-桃園,2024-10-29,9189
00936,台新永續高息中小,32,0,32,群益金鼎-桃園,2024-10-29,9189
00894,中信小資高價30,30,0,30,群益金鼎-桃園,2024-10-29,9189
00950B,凱基A級公司債,30,1,29,群益金鼎-桃園,2024-10-29,9189
1802,台玻,37,11,26,群益金鼎-桃園,2024-10-29,9189
00918,大華優利高填息30,26,0,26,群益金鼎-桃園,2024-10-29,9189
00715L,期街口布蘭特正2,26,1,25,群益金鼎-桃園,2024-10-29,9189
00934,中信成長高股息,25,0,25,群益金鼎-桃園,2024-10-29,9189
1524,耿鼎,25,1,24,群益金鼎-桃園,2024-10-29,9189
3715,定穎投控,23,0,23,群益金鼎-桃園,2024-10-29,9189
00637L,元大滬深300正2,53,30,23,群益金鼎-桃園,2024-10-29,9189
2330,台積電,33,10,23,群益金鼎-桃園,2024-10-29,9189
00946,群益科技高息成長,22,0,22,群益金鼎-桃園,2024-10-29,9189
00671R,富邦NASDAQ反1,20,0,20,群益金鼎-桃園,2024-10-29,9189
8107,大億金茂,47,27,20,群益金鼎-桃園,2024-10-29,9189
00680L,元大美債20正2,20,0,20,群益金鼎-桃園,2024-10-29,9189
6770,力積電,22,5,17,群益金鼎-桃園,2024-10-29,9189
8064,東捷,21,4,17,群益金鼎-桃園,2024-10-29,9189
00878,國泰永續高股息,27,10,17,群益金鼎-桃園,2024-10-29,9189
00905,FT臺灣Smart,16,0,16,群益金鼎-桃園,2024-10-29,9189
1442,名軒,15,0,15,群益金鼎-桃園,2024-10-29,9189
6438,迅得,21,7,14,群益金鼎-桃園,2024-10-29,9189
00881,國泰台灣5G+,13,1,12,群益金鼎-桃園,2024-10-29,9189
3189,景碩,13,1,12,群益金鼎-桃園,2024-10-29,9189
00712,復華富時不動產,12,0,12,群益金鼎-桃園,2024-10-29,9189
8074,鉅橡,12,0,12,群益金鼎-桃園,2024-10-29,9189
2323,中環,12,0,12,群益金鼎-桃園,2024-10-29,9189
00675L,富邦臺灣加權正2,11,0,11,群益金鼎-桃園,2024-10-29,9189
4938,和碩,12,1,11,群益金鼎-桃園,2024-10-29,9189
2495,普安,80,69,11,群益金鼎-桃園,2024-10-29,9189
2637,慧洋-KY,11,0,11,群益金鼎-桃園,2024-10-29,9189
1402,遠東新,129,0,129,群益金鼎-桃園,2024-10-30,9189
6217,中探針,120,0,120,群益金鼎-桃園,2024-10-30,9189
00948B,中信優息投資級債,104,0,104,群益金鼎-桃園,2024-10-30,9189
00637L,元大滬深300正2,169,71,98,群益金鼎-桃園,2024-10-30,9189
00688L,國泰20年美債正2,60,0,60,群益金鼎-桃園,2024-10-30,9189
00929,復華台灣科技優息,55,0,55,群益金鼎-桃園,2024-10-30,9189
00937B,群益ESG投等債20,50,0,50,群益金鼎-桃園,2024-10-30,9189
6153,嘉聯益,40,0,40,群益金鼎-桃園,2024-10-30,9189
00931B,統一美債20年,34,1,33,群益金鼎-桃園,2024-10-30,9189
00878,國泰永續高股息,37,5,32,群益金鼎-桃園,2024-10-30,9189
6438,迅得,31,0,31,群益金鼎-桃園,2024-10-30,9189
00950B,凱基A級公司債,30,0,30,群益金鼎-桃園,2024-10-30,9189
00919,群益台灣精選高息,32,4,28,群益金鼎-桃園,2024-10-30,9189
2303,聯電,28,0,28,群益金鼎-桃園,2024-10-30,9189
2337,旺宏,29,2,27,群益金鼎-桃園,2024-10-30,9189
2431,聯昌,38,14,24,群益金鼎-桃園,2024-10-30,9189
3481,群創,24,0,24,群益金鼎-桃園,2024-10-30,9189
8183,精星,22,0,22,群益金鼎-桃園,2024-10-30,9189
2327,國巨,25,3,22,群益金鼎-桃園,2024-10-30,9189
00715L,期街口布蘭特正2,20,0,20,群益金鼎-桃園,2024-10-30,9189
00706L,期元大S＆P日圓正2,20,0,20,群益金鼎-桃園,2024-10-30,9189
1416,廣豐,20,0,20,群益金鼎-桃園,2024-10-30,9189
1326,台化,20,1,19,群益金鼎-桃園,2024-10-30,9189
6770,力積電,31,15,16,群益金鼎-桃園,2024-10-30,9189
00943,兆豐電子高息等權,16,0,16,群益金鼎-桃園,2024-10-30,9189
3551,世禾,16,0,16,群益金鼎-桃園,2024-10-30,9189
6443,元晶,16,0,16,群益金鼎-桃園,2024-10-30,9189
00712,復華富時不動產,15,0,15,群益金鼎-桃園,2024-10-30,9189
3031,佰鴻,15,0,15,群益金鼎-桃園,2024-10-30,9189
2313,華通,15,0,15,群益金鼎-桃園,2024-10-30,9189
0056,元大高股息,14,0,14,群益金鼎-桃園,2024-10-30,9189
9933,中鼎,14,0,14,群益金鼎-桃園,2024-10-30,9189
4915,致伸,14,0,14,群益金鼎-桃園,2024-10-30,9189
2344,華邦電,13,0,13,群益金鼎-桃園,2024-10-30,9189
2605,新興,12,0,12,群益金鼎-桃園,2024-10-30,9189
00887,永豐中國科技50大,62,50,12,群益金鼎-桃園,2024-10-30,9189
2365,昆盈,12,1,11,群益金鼎-桃園,2024-10-30,9189
2528,皇普,11,0,11,群益金鼎-桃園,2024-10-30,9189
00922,國泰台灣領袖50,14,3,11,群益金鼎-桃園,2024-10-30,9189
4919,新唐,37,26,11,群益金鼎-桃園,2024-10-30,9189
2891,中信金,12,2,10,群益金鼎-桃園,2024-10-30,9189
00720B,元大投資級公司債,10,0,10,群益金鼎-桃園,2024-10-30,9189
00932,兆豐永續高息等權,10,0,10,群益金鼎-桃園,2024-10-30,9189
4109,加捷生醫,10,0,10,群益金鼎-桃園,2024-10-30,9189
2425,承啟,13,3,10,群益金鼎-桃園,2024-10-30,9189
2402,毅嘉,10,0,10,群益金鼎-桃園,2024-10-30,9189
2492,華新科,10,0,10,群益金鼎-桃園,2024-10-30,9189
2356,英業達,10,0,10,群益金鼎-桃園,2024-10-30,9189
2646,星宇航空,12,2,10,群益金鼎-桃園,2024-10-30,9189
6188,廣明,10,0,10,群益金鼎-桃園,2024-10-30,9189
00959B,大華投等美債15Y+,811,0,811,群益金鼎-桃園,2024-11-01,9189
00940,元大台灣價值高息,221,105,116,群益金鼎-桃園,2024-11-01,9189
2886,兆豐金,111,0,111,群益金鼎-桃園,2024-11-01,9189
00948B,中信優息投資級債,100,0,100,群益金鼎-桃園,2024-11-01,9189
00878,國泰永續高股息,98,6,92,群益金鼎-桃園,2024-11-01,9189
2303,聯電,105,17,88,群益金鼎-桃園,2024-11-01,9189
2328,廣宇,87,15,72,群益金鼎-桃園,2024-11-01,9189
00929,復華台灣科技優息,73,2,71,群益金鼎-桃園,2024-11-01,9189
00679B,元大美債20年,71,2,69,群益金鼎-桃園,2024-11-01,9189
3615,安可,72,7,65,群益金鼎-桃園,2024-11-01,9189
00937B,群益ESG投等債20,60,5,55,群益金鼎-桃園,2024-11-01,9189
00706L,期元大S＆P日圓正2,50,0,50,群益金鼎-桃園,2024-11-01,9189
0056,元大高股息,50,1,49,群益金鼎-桃園,2024-11-01,9189
00919,群益台灣精選高息,51,6,45,群益金鼎-桃園,2024-11-01,9189
00950B,凱基A級公司債,35,0,35,群益金鼎-桃園,2024-11-01,9189
3303,岱稜,42,10,32,群益金鼎-桃園,2024-11-01,9189
5880,合庫金,30,0,30,群益金鼎-桃園,2024-11-01,9189
00953B,群益優選非投等債,28,0,28,群益金鼎-桃園,2024-11-01,9189
00687B,國泰20年美債,27,0,27,群益金鼎-桃園,2024-11-01,9189
00688L,國泰20年美債正2,24,1,23,群益金鼎-桃園,2024-11-01,9189
9933,中鼎,23,0,23,群益金鼎-桃園,2024-11-01,9189
2423,固緯,31,8,23,群益金鼎-桃園,2024-11-01,9189
4927,泰鼎-KY,21,0,21,群益金鼎-桃園,2024-11-01,9189
6217,中探針,21,0,21,群益金鼎-桃園,2024-11-01,9189
2317,鴻海,31,12,19,群益金鼎-桃園,2024-11-01,9189
4956,光鋐,21,2,19,群益金鼎-桃園,2024-11-01,9189
2495,普安,112,94,18,群益金鼎-桃園,2024-11-01,9189
00951,台新日本半導體,16,0,16,群益金鼎-桃園,2024-11-01,9189
2353,宏��,15,0,15,群益金鼎-桃園,2024-11-01,9189
6016,康和證,15,0,15,群益金鼎-桃園,2024-11-01,9189
2344,華邦電,18,4,14,群益金鼎-桃園,2024-11-01,9189
4108,懷特,14,0,14,群益金鼎-桃園,2024-11-01,9189
2884,玉山金,15,1,14,群益金鼎-桃園,2024-11-01,9189
2605,新興,26,13,13,群益金鼎-桃園,2024-11-01,9189
00918,大華優利高填息30,13,1,12,群益金鼎-桃園,2024-11-01,9189
6770,力積電,12,1,11,群益金鼎-桃園,2024-11-01,9189
00912,中信臺灣智慧50,11,0,11,群益金鼎-桃園,2024-11-01,9189
4958,臻鼎-KY,12,1,11,群益金鼎-桃園,2024-11-01,9189
3481,群創,11,0,11,群益金鼎-桃園,2024-11-01,9189
2323,中環,10,0,10,群益金鼎-桃園,2024-11-01,9189
00720B,元大投資級公司債,10,0,10,群益金鼎-桃園,2024-11-01,9189
3035,智原,12,2,10,群益金鼎-桃園,2024-11-01,9189
00933B,國泰10Y+金融債,10,0,10,群益金鼎-桃園,2024-11-01,9189
1569,濱川,10,0,10,群益金鼎-桃園,2024-11-01,9189
00632R,元大台灣50反1,53,43,10,群益金鼎-桃園,2024-11-01,9189
2025,千興,10,0,10,群益金鼎-桃園,2024-11-01,9189
00949,復華日本龍頭,10,0,10,群益金鼎-桃園,2024-11-01,9189
1416,廣豐,10,0,10,群益金鼎-桃園,2024-11-01,9189
2392,正崴,14,4,10,群益金鼎-桃園,2024-11-01,9189
4532,瑞智,10,0,10,群益金鼎-桃園,2024-11-01,9189
2609,陽明,247,3,244,群益金鼎-桃園,2024-11-04,9189
00937B,群益ESG投等債20,146,10,136,群益金鼎-桃園,2024-11-04,9189
00680L,元大美債20正2,101,0,101,群益金鼎-桃園,2024-11-04,9189
00878,國泰永續高股息,93,0,93,群益金鼎-桃園,2024-11-04,9189
00919,群益台灣精選高息,79,2,77,群益金鼎-桃園,2024-11-04,9189
2399,映泰,83,11,72,群益金鼎-桃園,2024-11-04,9189
00687B,國泰20年美債,59,0,59,群益金鼎-桃園,2024-11-04,9189
00632R,元大台灣50反1,60,3,57,群益金鼎-桃園,2024-11-04,9189
00948B,中信優息投資級債,54,0,54,群益金鼎-桃園,2024-11-04,9189
00688L,國泰20年美債正2,62,14,48,群益金鼎-桃園,2024-11-04,9189
2303,聯電,55,11,44,群益金鼎-桃園,2024-11-04,9189
6005,群益證,45,1,44,群益金鼎-桃園,2024-11-04,9189
5438,東友,59,16,43,群益金鼎-桃園,2024-11-04,9189
3303,岱稜,41,4,37,群益金鼎-桃園,2024-11-04,9189
6509,聚和,30,0,30,群益金鼎-桃園,2024-11-04,9189
00679B,元大美債20年,36,8,28,群益金鼎-桃園,2024-11-04,9189
1595,川寶,45,19,26,群益金鼎-桃園,2024-11-04,9189
00950B,凱基A級公司債,25,0,25,群益金鼎-桃園,2024-11-04,9189
00953B,群益優選非投等債,25,0,25,群益金鼎-桃園,2024-11-04,9189
00712,復華富時不動產,22,0,22,群益金鼎-桃園,2024-11-04,9189
4956,光鋐,21,0,21,群益金鼎-桃園,2024-11-04,9189
1617,榮星,21,0,21,群益金鼎-桃園,2024-11-04,9189
00706L,期元大S＆P日圓正2,21,0,21,群益金鼎-桃園,2024-11-04,9189
00943,兆豐電子高息等權,21,0,21,群益金鼎-桃園,2024-11-04,9189
2408,南亞科,27,7,20,群益金鼎-桃園,2024-11-04,9189
5534,長虹,20,0,20,群益金鼎-桃園,2024-11-04,9189
5905,南仁湖,25,5,20,群益金鼎-桃園,2024-11-04,9189
4991,環宇-KY,50,31,19,群益金鼎-桃園,2024-11-04,9189
6216,居易,22,3,19,群益金鼎-桃園,2024-11-04,9189
00751B,元大AAA至A公司債,18,0,18,群益金鼎-桃園,2024-11-04,9189
2367,燿華,17,0,17,群益金鼎-桃園,2024-11-04,9189
00720B,元大投資級公司債,17,0,17,群益金鼎-桃園,2024-11-04,9189
00946,群益科技高息成長,17,0,17,群益金鼎-桃園,2024-11-04,9189
6285,啟��,16,0,16,群益金鼎-桃園,2024-11-04,9189
00932,兆豐永續高息等權,15,0,15,群益金鼎-桃園,2024-11-04,9189
00713,元大台灣高息低波,15,0,15,群益金鼎-桃園,2024-11-04,9189
2431,聯昌,72,59,13,群益金鼎-桃園,2024-11-04,9189
2337,旺宏,13,0,13,群益金鼎-桃園,2024-11-04,9189
1442,名軒,13,0,13,群益金鼎-桃園,2024-11-04,9189
5443,均豪,21,8,13,群益金鼎-桃園,2024-11-04,9189
00900,富邦特選高股息30,12,0,12,群益金鼎-桃園,2024-11-04,9189
00939,統一台灣高息動能,12,0,12,群益金鼎-桃園,2024-11-04,9189
6438,迅得,12,1,11,群益金鼎-桃園,2024-11-04,9189
9935,慶豐富,11,0,11,群益金鼎-桃園,2024-11-04,9189
00830,國泰費城半導體,10,0,10,群益金鼎-桃園,2024-11-04,9189
0056,元大高股息,11,1,10,群益金鼎-桃園,2024-11-04,9189
6168,宏齊,10,0,10,群益金鼎-桃園,2024-11-04,9189
1714,和桐,10,0,10,群益金鼎-桃園,2024-11-04,9189
1517,利奇,10,0,10,群益金鼎-桃園,2024-11-04,9189
00959B,大華投等美債15Y+,10,0,10,群益金鼎-桃園,2024-11-04,9189
00918,大華優利高填息30,413,44,369,群益金鼎-桃園,2024-11-05,9189
00953B,群益優選非投等債,345,0,345,群益金鼎-桃園,2024-11-05,9189
00919,群益台灣精選高息,134,1,133,群益金鼎-桃園,2024-11-05,9189
00688L,國泰20年美債正2,80,0,80,群益金鼎-桃園,2024-11-05,9189
3494,誠研,50,0,50,群益金鼎-桃園,2024-11-05,9189
00706L,期元大S＆P日圓正2,50,0,50,群益金鼎-桃園,2024-11-05,9189
00948B,中信優息投資級債,51,2,49,群益金鼎-桃園,2024-11-05,9189
3049,精金,153,107,46,群益金鼎-桃園,2024-11-05,9189
2603,長榮,64,18,46,群益金鼎-桃園,2024-11-05,9189
5258,虹堡,39,1,38,群益金鼎-桃園,2024-11-05,9189
2303,聯電,63,25,38,群益金鼎-桃園,2024-11-05,9189
00950B,凱基A級公司債,67,29,38,群益金鼎-桃園,2024-11-05,9189
00937B,群益ESG投等債20,33,0,33,群益金鼎-桃園,2024-11-05,9189
4956,光鋐,38,6,32,群益金鼎-桃園,2024-11-05,9189
8404,百和興業-KY,31,0,31,群益金鼎-桃園,2024-11-05,9189
00680L,元大美債20正2,30,0,30,群益金鼎-桃園,2024-11-05,9189
2646,星宇航空,41,14,27,群益金鼎-桃園,2024-11-05,9189
4526,東台,37,10,27,群益金鼎-桃園,2024-11-05,9189
1201,味全,26,0,26,群益金鼎-桃園,2024-11-05,9189
3303,岱稜,38,15,23,群益金鼎-桃園,2024-11-05,9189
00885,富邦越南,22,0,22,群益金鼎-桃園,2024-11-05,9189
00830,國泰費城半導體,20,0,20,群益金鼎-桃園,2024-11-05,9189
00756B,群益投等新興公債,20,0,20,群益金鼎-桃園,2024-11-05,9189
00650L,復華香港正2,40,20,20,群益金鼎-桃園,2024-11-05,9189
8249,菱光,29,11,18,群益金鼎-桃園,2024-11-05,9189
6216,居易,18,1,17,群益金鼎-桃園,2024-11-05,9189
3615,安可,20,3,17,群益金鼎-桃園,2024-11-05,9189
00932,兆豐永續高息等權,16,0,16,群益金鼎-桃園,2024-11-05,9189
2365,昆盈,21,5,16,群益金鼎-桃園,2024-11-05,9189
6438,迅得,13,0,13,群益金鼎-桃園,2024-11-05,9189
00679B,元大美債20年,23,11,12,群益金鼎-桃園,2024-11-05,9189
00795B,中信美國公債20年,12,0,12,群益金鼎-桃園,2024-11-05,9189
3227,原相,12,0,12,群益金鼎-桃園,2024-11-05,9189
1104,環泥,11,0,11,群益金鼎-桃園,2024-11-05,9189
3321,同泰,12,1,11,群益金鼎-桃園,2024-11-05,9189
00923,群益台ESG低碳50,11,0,11,群益金鼎-桃園,2024-11-05,9189
2458,義隆,11,0,11,群益金鼎-桃園,2024-11-05,9189
6196,帆宣,11,0,11,群益金鼎-桃園,2024-11-05,9189
3149,正達,17,6,11,群益金鼎-桃園,2024-11-05,9189
00878,國泰永續高股息,11,0,11,群益金鼎-桃園,2024-11-05,9189
00946,群益科技高息成長,10,0,10,群益金鼎-桃園,2024-11-05,9189
6153,嘉聯益,10,0,10,群益金鼎-桃園,2024-11-05,9189
00952,凱基台灣AI50,10,0,10,群益金鼎-桃園,2024-11-05,9189
6143,振曜,10,0,10,群益金鼎-桃園,2024-11-05,9189
00915,凱基優選高股息30,10,0,10,群益金鼎-桃園,2024-11-05,9189
2605,新興,10,0,10,群益金鼎-桃園,2024-11-05,9189
00943,兆豐電子高息等權,10,0,10,群益金鼎-桃園,2024-11-05,9189
4729,熒茂,13,4,9,群益金鼎-桃園,2024-11-05,9189
00887,永豐中國科技50大,54,45,9,群益金鼎-桃園,2024-11-05,9189
8183,精星,9,0,9,群益金鼎-桃園,2024-11-05,9189
00679B,元大美債20年,556,318,238,群益金鼎-桃園,2024-11-06,9189
2609,陽明,113,3,110,群益金鼎-桃園,2024-11-06,9189
2303,聯電,100,18,82,群益金鼎-桃園,2024-11-06,9189
00688L,國泰20年美債正2,59,0,59,群益金鼎-桃園,2024-11-06,9189
2431,聯昌,212,166,46,群益金鼎-桃園,2024-11-06,9189
00948B,中信優息投資級債,50,5,45,群益金鼎-桃園,2024-11-06,9189
00680L,元大美債20正2,596,555,41,群益金鼎-桃園,2024-11-06,9189
2399,映泰,64,24,40,群益金鼎-桃園,2024-11-06,9189
2444,兆勁,38,0,38,群益金鼎-桃園,2024-11-06,9189
2419,仲琦,53,17,36,群益金鼎-桃園,2024-11-06,9189
00878,國泰永續高股息,50,17,33,群益金鼎-桃園,2024-11-06,9189
9933,中鼎,30,0,30,群益金鼎-桃園,2024-11-06,9189
1711,永光,29,0,29,群益金鼎-桃園,2024-11-06,9189
00959B,大華投等美債15Y+,34,5,29,群益金鼎-桃園,2024-11-06,9189
2356,英業達,87,63,24,群益金鼎-桃園,2024-11-06,9189
00932,兆豐永續高息等權,22,0,22,群益金鼎-桃園,2024-11-06,9189
2618,長榮航,21,0,21,群益金鼎-桃園,2024-11-06,9189
00946,群益科技高息成長,27,7,20,群益金鼎-桃園,2024-11-06,9189
00673R,期元大S＆P原油反1,20,0,20,群益金鼎-桃園,2024-11-06,9189
00756B,群益投等新興公債,20,0,20,群益金鼎-桃園,2024-11-06,9189
2929,淘帝-KY,20,0,20,群益金鼎-桃園,2024-11-06,9189
00957B,兆豐US優選投等債,20,0,20,群益金鼎-桃園,2024-11-06,9189
00950B,凱基A級公司債,20,0,20,群益金鼎-桃園,2024-11-06,9189
2101,南港,20,0,20,群益金鼎-桃園,2024-11-06,9189
2739,寒舍,20,1,19,群益金鼎-桃園,2024-11-06,9189
2393,億光,20,3,17,群益金鼎-桃園,2024-11-06,9189
4729,熒茂,15,0,15,群益金鼎-桃園,2024-11-06,9189
4956,光鋐,20,5,15,群益金鼎-桃園,2024-11-06,9189
2615,萬海,30,16,14,群益金鼎-桃園,2024-11-06,9189
00795B,中信美國公債20年,14,0,14,群益金鼎-桃園,2024-11-06,9189
00916,國泰全球品牌50,13,0,13,群益金鼎-桃園,2024-11-06,9189
2382,廣達,20,7,13,群益金鼎-桃園,2024-11-06,9189
6405,悅城,52,40,12,群益金鼎-桃園,2024-11-06,9189
4919,新唐,12,1,11,群益金鼎-桃園,2024-11-06,9189
2542,興富發,11,0,11,群益金鼎-桃園,2024-11-06,9189
3501,維熹,11,0,11,群益金鼎-桃園,2024-11-06,9189
6153,嘉聯益,10,0,10,群益金鼎-桃園,2024-11-06,9189
1201,味全,10,0,10,群益金鼎-桃園,2024-11-06,9189
2337,旺宏,10,0,10,群益金鼎-桃園,2024-11-06,9189
00943,兆豐電子高息等權,10,0,10,群益金鼎-桃園,2024-11-06,9189
00706L,期元大S＆P日圓正2,10,0,10,群益金鼎-桃園,2024-11-06,9189
4510,高鋒,14,4,10,群益金鼎-桃園,2024-11-06,9189
8261,富鼎,25,15,10,群益金鼎-桃園,2024-11-06,9189
1449,佳和,58,49,9,群益金鼎-桃園,2024-11-06,9189
3441,聯一光,9,0,9,群益金鼎-桃園,2024-11-06,9189
00881,國泰台灣5G+,12,3,9,群益金鼎-桃園,2024-11-06,9189
3163,波若威,8,0,8,群益金鼎-桃園,2024-11-06,9189
4938,和碩,8,0,8,群益金鼎-桃園,2024-11-06,9189
0050,元大台灣50,11,3,8,群益金鼎-桃園,2024-11-06,9189
00915,凱基優選高股息30,7,0,7,群益金鼎-桃園,2024-11-06,9189
00686R,群益臺灣加權反1,200,0,200,群益金鼎-桃園,2024-11-07,9189
00687B,國泰20年美債,164,16,148,群益金鼎-桃園,2024-11-07,9189
00680L,元大美債20正2,127,2,125,群益金鼎-桃園,2024-11-07,9189
00878,國泰永續高股息,136,13,123,群益金鼎-桃園,2024-11-07,9189
00937B,群益ESG投等債20,72,6,66,群益金鼎-桃園,2024-11-07,9189
00665L,富邦�琤肭磪囓�2,65,0,65,群益金鼎-桃園,2024-11-07,9189
00679B,元大美債20年,63,0,63,群益金鼎-桃園,2024-11-07,9189
00900,富邦特選高股息30,51,0,51,群益金鼎-桃園,2024-11-07,9189
2609,陽明,72,30,42,群益金鼎-桃園,2024-11-07,9189
00688L,國泰20年美債正2,42,0,42,群益金鼎-桃園,2024-11-07,9189
00706L,期元大S＆P日圓正2,30,0,30,群益金鼎-桃園,2024-11-07,9189
2014,中鴻,31,3,28,群益金鼎-桃園,2024-11-07,9189
00673R,期元大S＆P原油反1,26,0,26,群益金鼎-桃園,2024-11-07,9189
8421,旭源,25,0,25,群益金鼎-桃園,2024-11-07,9189
6288,聯嘉,66,42,24,群益金鼎-桃園,2024-11-07,9189
6282,康舒,24,0,24,群益金鼎-桃園,2024-11-07,9189
5410,國眾,23,0,23,群益金鼎-桃園,2024-11-07,9189
2634,漢翔,21,0,21,群益金鼎-桃園,2024-11-07,9189
8044,網家,25,4,21,群益金鼎-桃園,2024-11-07,9189
2497,怡利電,22,2,20,群益金鼎-桃園,2024-11-07,9189
00756B,群益投等新興公債,20,0,20,群益金鼎-桃園,2024-11-07,9189
2006,東和鋼鐵,20,0,20,群益金鼎-桃園,2024-11-07,9189
6151,晉倫,20,0,20,群益金鼎-桃園,2024-11-07,9189
1711,永光,26,8,18,群益金鼎-桃園,2024-11-07,9189
1201,味全,17,0,17,群益金鼎-桃園,2024-11-07,9189
2603,長榮,16,1,15,群益金鼎-桃園,2024-11-07,9189
2489,瑞軒,22,8,14,群益金鼎-桃園,2024-11-07,9189
4510,高鋒,18,5,13,群益金鼎-桃園,2024-11-07,9189
3013,晟銘電,27,14,13,群益金鼎-桃園,2024-11-07,9189
00930,永豐ESG低碳高息,13,0,13,群益金鼎-桃園,2024-11-07,9189
2027,大成鋼,49,36,13,群益金鼎-桃園,2024-11-07,9189
2344,華邦電,44,31,13,群益金鼎-桃園,2024-11-07,9189
2327,國巨,13,1,12,群益金鼎-桃園,2024-11-07,9189
00712,復華富時不動產,12,0,12,群益金鼎-桃園,2024-11-07,9189
2892,第一金,11,0,11,群益金鼎-桃園,2024-11-07,9189
6197,佳必琪,12,1,11,群益金鼎-桃園,2024-11-07,9189
2492,華新科,11,0,11,群益金鼎-桃園,2024-11-07,9189
8070,長華*,12,2,10,群益金鼎-桃園,2024-11-07,9189
2903,遠百,10,0,10,群益金鼎-桃園,2024-11-07,9189
00696B,富邦美債20年,10,0,10,群益金鼎-桃園,2024-11-07,9189
4526,東台,29,19,10,群益金鼎-桃園,2024-11-07,9189
6658,聯策,10,0,10,群益金鼎-桃園,2024-11-07,9189
00646,元大S＆P500,10,0,10,群益金鼎-桃園,2024-11-07,9189
4942,嘉彰,10,0,10,群益金鼎-桃園,2024-11-07,9189
2834,臺企銀,11,1,10,群益金鼎-桃園,2024-11-07,9189
2615,萬海,11,2,9,群益金鼎-桃園,2024-11-07,9189
6114,久威,9,0,9,群益金鼎-桃園,2024-11-07,9189
3167,大量,28,19,9,群益金鼎-桃園,2024-11-07,9189
006208,富邦台50,14,6,8,群益金鼎-桃園,2024-11-07,9189
00919,群益台灣精選高息,10,2,8,群益金鼎-桃園,2024-11-07,9189
00932,兆豐永續高息等權,183,0,183,群益金鼎-桃園,2024-11-08,9189
00632R,元大台灣50反1,276,145,131,群益金鼎-桃園,2024-11-08,9189
2367,燿華,100,0,100,群益金鼎-桃園,2024-11-08,9189
2891,中信金,84,11,73,群益金鼎-桃園,2024-11-08,9189
2883,凱基金,103,37,66,群益金鼎-桃園,2024-11-08,9189
00950B,凱基A級公司債,65,0,65,群益金鼎-桃園,2024-11-08,9189
00946,群益科技高息成長,62,0,62,群益金鼎-桃園,2024-11-08,9189
2353,宏��,59,0,59,群益金鼎-桃園,2024-11-08,9189
2615,萬海,129,72,57,群益金鼎-桃園,2024-11-08,9189
8215,明基材,47,0,47,群益金鼎-桃園,2024-11-08,9189
2929,淘帝-KY,46,1,45,群益金鼎-桃園,2024-11-08,9189
6153,嘉聯益,40,3,37,群益金鼎-桃園,2024-11-08,9189
2408,南亞科,43,6,37,群益金鼎-桃園,2024-11-08,9189
00633L,富邦上証正2,39,3,36,群益金鼎-桃園,2024-11-08,9189
00679B,元大美債20年,51,20,31,群益金鼎-桃園,2024-11-08,9189
00959B,大華投等美債15Y+,30,0,30,群益金鼎-桃園,2024-11-08,9189
3062,建漢,66,37,29,群益金鼎-桃園,2024-11-08,9189
1201,味全,27,0,27,群益金鼎-桃園,2024-11-08,9189
2313,華通,30,4,26,群益金鼎-桃園,2024-11-08,9189
00878,國泰永續高股息,27,3,24,群益金鼎-桃園,2024-11-08,9189
8096,擎亞,52,29,23,群益金鼎-桃園,2024-11-08,9189
9933,中鼎,23,0,23,群益金鼎-桃園,2024-11-08,9189
00953B,群益優選非投等債,27,5,22,群益金鼎-桃園,2024-11-08,9189
2344,華邦電,21,0,21,群益金鼎-桃園,2024-11-08,9189
2388,威盛,31,10,21,群益金鼎-桃園,2024-11-08,9189
2892,第一金,20,0,20,群益金鼎-桃園,2024-11-08,9189
2231,為升,20,0,20,群益金鼎-桃園,2024-11-08,9189
3494,誠研,20,0,20,群益金鼎-桃園,2024-11-08,9189
2332,友訊,25,5,20,群益金鼎-桃園,2024-11-08,9189
5309,系統電,19,1,18,群益金鼎-桃園,2024-11-08,9189
00680L,元大美債20正2,25,8,17,群益金鼎-桃園,2024-11-08,9189
9958,世紀鋼,21,5,16,群益金鼎-桃園,2024-11-08,9189
3048,益登,15,0,15,群益金鼎-桃園,2024-11-08,9189
1789,神隆,15,0,15,群益金鼎-桃園,2024-11-08,9189
00706L,期元大S＆P日圓正2,15,0,15,群益金鼎-桃園,2024-11-08,9189
4956,光鋐,19,6,13,群益金鼎-桃園,2024-11-08,9189
2354,鴻準,74,60,14,群益金鼎-桃園,2024-11-08,9189
3710,連展投控,14,1,13,群益金鼎-桃園,2024-11-08,9189
8183,精星,13,0,13,群益金鼎-桃園,2024-11-08,9189
2392,正崴,78,66,12,群益金鼎-桃園,2024-11-08,9189
4938,和碩,12,1,11,群益金鼎-桃園,2024-11-08,9189
2352,佳世達,11,0,11,群益金鼎-桃園,2024-11-08,9189
5225,東科-KY,12,1,11,群益金鼎-桃園,2024-11-08,9189
2431,聯昌,23,12,11,群益金鼎-桃園,2024-11-08,9189
6217,中探針,11,0,11,群益金鼎-桃園,2024-11-08,9189
2368,金像電,19,8,11,群益金鼎-桃園,2024-11-08,9189
2444,兆勁,10,0,10,群益金鼎-桃園,2024-11-08,9189
00951,台新日本半導體,10,0,10,群益金鼎-桃園,2024-11-08,9189
2031,新光鋼,10,0,10,群益金鼎-桃園,2024-11-08,9189
00948B,中信優息投資級債,10,0,10,群益金鼎-桃園,2024-11-08,9189
2609,陽明,175,8,167,群益金鼎-桃園,2024-11-11,9189
00753L,中信中國50正2,81,0,81,群益金鼎-桃園,2024-11-11,9189
3162,精確,62,3,59,群益金鼎-桃園,2024-11-11,9189
2312,金寶,63,5,58,群益金鼎-桃園,2024-11-11,9189
2002,中鋼,55,3,52,群益金鼎-桃園,2024-11-11,9189
6134,萬旭,51,0,51,群益金鼎-桃園,2024-11-11,9189
00665L,富邦�琤肭磪囓�2,45,0,45,群益金鼎-桃園,2024-11-11,9189
1326,台化,36,0,36,群益金鼎-桃園,2024-11-11,9189
3149,正達,33,1,32,群益金鼎-桃園,2024-11-11,9189
2506,太設,30,2,28,群益金鼎-桃園,2024-11-11,9189
00881,國泰台灣5G+,31,4,27,群益金鼎-桃園,2024-11-11,9189
00751B,元大AAA至A公司債,25,0,25,群益金鼎-桃園,2024-11-11,9189
9933,中鼎,25,0,25,群益金鼎-桃園,2024-11-11,9189
00919,群益台灣精選高息,25,0,25,群益金鼎-桃園,2024-11-11,9189
5426,振發,51,27,24,群益金鼎-桃園,2024-11-11,9189
2929,淘帝-KY,24,1,23,群益金鼎-桃園,2024-11-11,9189
1605,華新,23,0,23,群益金鼎-桃園,2024-11-11,9189
2891,中信金,28,6,22,群益金鼎-桃園,2024-11-11,9189
3303,岱稜,33,11,22,群益金鼎-桃園,2024-11-11,9189
3060,銘異,21,0,21,群益金鼎-桃園,2024-11-11,9189
6438,迅得,22,1,21,群益金鼎-桃園,2024-11-11,9189
00706L,期元大S＆P日圓正2,20,0,20,群益金鼎-桃園,2024-11-11,9189
6220,岳豐,20,0,20,群益金鼎-桃園,2024-11-11,9189
1595,川寶,20,0,20,群益金鼎-桃園,2024-11-11,9189
00949,復華日本龍頭,20,0,20,群益金鼎-桃園,2024-11-11,9189
00673R,期元大S＆P原油反1,20,0,20,群益金鼎-桃園,2024-11-11,9189
00679B,元大美債20年,20,0,20,群益金鼎-桃園,2024-11-11,9189
2615,萬海,60,41,19,群益金鼎-桃園,2024-11-11,9189
1522,堤維西,21,2,19,群益金鼎-桃園,2024-11-11,9189
6224,聚鼎,18,0,18,群益金鼎-桃園,2024-11-11,9189
2353,宏��,16,0,16,群益金鼎-桃園,2024-11-11,9189
1449,佳和,143,127,16,群益金鼎-桃園,2024-11-11,9189
3231,緯創,22,6,16,群益金鼎-桃園,2024-11-11,9189
1532,勤美,15,0,15,群益金鼎-桃園,2024-11-11,9189
00941,中信上游半導體,15,0,15,群益金鼎-桃園,2024-11-11,9189
2610,華航,42,29,13,群益金鼎-桃園,2024-11-11,9189
1477,聚陽,13,0,13,群益金鼎-桃園,2024-11-11,9189
2376,技嘉,16,3,13,群益金鼎-桃園,2024-11-11,9189
00650L,復華香港正2,40,27,13,群益金鼎-桃園,2024-11-11,9189
2882,國泰金,13,0,13,群益金鼎-桃園,2024-11-11,9189
8936,國統,12,0,12,群益金鼎-桃園,2024-11-11,9189
2368,金像電,15,3,12,群益金鼎-桃園,2024-11-11,9189
1708,東鹼,12,0,12,群益金鼎-桃園,2024-11-11,9189
5457,宣德,26,14,12,群益金鼎-桃園,2024-11-11,9189
1446,宏和,11,0,11,群益金鼎-桃園,2024-11-11,9189
1201,味全,11,0,11,群益金鼎-桃園,2024-11-11,9189
2342,茂矽,11,0,11,群益金鼎-桃園,2024-11-11,9189
6182,合晶,11,0,11,群益金鼎-桃園,2024-11-11,9189
00878,國泰永續高股息,15,4,11,群益金鼎-桃園,2024-11-11,9189
00637L,元大滬深300正2,49,39,10,群益金鼎-桃園,2024-11-11,9189
00878,國泰永續高股息,154,1,153,群益金鼎-桃園,2024-11-12,9189
00894,中信小資高價30,100,0,100,群益金鼎-桃園,2024-11-12,9189
0056,元大高股息,61,0,61,群益金鼎-桃園,2024-11-12,9189
00665L,富邦�琤肭磪囓�2,60,0,60,群益金鼎-桃園,2024-11-12,9189
00715L,期街口布蘭特正2,59,0,59,群益金鼎-桃園,2024-11-12,9189
00953B,群益優選非投等債,66,8,58,群益金鼎-桃園,2024-11-12,9189
2002,中鋼,61,14,47,群益金鼎-桃園,2024-11-12,9189
2609,陽明,89,44,45,群益金鼎-桃園,2024-11-12,9189
006208,富邦台50,50,7,43,群益金鼎-桃園,2024-11-12,9189
00932,兆豐永續高息等權,46,3,43,群益金鼎-桃園,2024-11-12,9189
00881,國泰台灣5G+,42,0,42,群益金鼎-桃園,2024-11-12,9189
00930,永豐ESG低碳高息,42,0,42,群益金鼎-桃園,2024-11-12,9189
00929,復華台灣科技優息,39,5,34,群益金鼎-桃園,2024-11-12,9189
00900,富邦特選高股息30,33,0,33,群益金鼎-桃園,2024-11-12,9189
2892,第一金,31,0,31,群益金鼎-桃園,2024-11-12,9189
00919,群益台灣精選高息,28,0,28,群益金鼎-桃園,2024-11-12,9189
9933,中鼎,27,1,26,群益金鼎-桃園,2024-11-12,9189
2353,宏��,24,0,24,群益金鼎-桃園,2024-11-12,9189
2615,萬海,48,24,24,群益金鼎-桃園,2024-11-12,9189
2313,華通,24,1,23,群益金鼎-桃園,2024-11-12,9189
1595,川寶,33,10,23,群益金鼎-桃園,2024-11-12,9189
9105,泰金寶-DR,22,0,22,群益金鼎-桃園,2024-11-12,9189
5871,中租-KY,22,0,22,群益金鼎-桃園,2024-11-12,9189
00922,國泰台灣領袖50,21,0,21,群益金鼎-桃園,2024-11-12,9189
1326,台化,21,0,21,群益金鼎-桃園,2024-11-12,9189
2330,台積電,24,4,20,群益金鼎-桃園,2024-11-12,9189
00650L,復華香港正2,30,10,20,群益金鼎-桃園,2024-11-12,9189
9945,潤泰新,20,0,20,群益金鼎-桃園,2024-11-12,9189
1524,耿鼎,40,21,19,群益金鼎-桃園,2024-11-12,9189
00680L,元大美債20正2,20,1,19,群益金鼎-桃園,2024-11-12,9189
4303,信立,49,30,19,群益金鼎-桃園,2024-11-12,9189
2368,金像電,19,0,19,群益金鼎-桃園,2024-11-12,9189
8028,昇陽半導體,20,2,18,群益金鼎-桃園,2024-11-12,9189
5426,振發,22,4,18,群益金鼎-桃園,2024-11-12,9189
9958,世紀鋼,18,0,18,群益金鼎-桃園,2024-11-12,9189
00713,元大台灣高息低波,17,0,17,群益金鼎-桃園,2024-11-12,9189
2834,臺企銀,17,0,17,群益金鼎-桃園,2024-11-12,9189
6770,力積電,30,14,16,群益金鼎-桃園,2024-11-12,9189
1217,愛之味,16,0,16,群益金鼎-桃園,2024-11-12,9189
6005,群益證,15,0,15,群益金鼎-桃園,2024-11-12,9189
00706L,期元大S＆P日圓正2,15,0,15,群益金鼎-桃園,2024-11-12,9189
6438,迅得,18,3,15,群益金鼎-桃園,2024-11-12,9189
2382,廣達,15,1,14,群益金鼎-桃園,2024-11-12,9189
1531,高林股,14,0,14,群益金鼎-桃園,2024-11-12,9189
00753L,中信中國50正2,13,0,13,群益金鼎-桃園,2024-11-12,9189
2883,凱基金,13,0,13,群益金鼎-桃園,2024-11-12,9189
3013,晟銘電,33,20,13,群益金鼎-桃園,2024-11-12,9189
2063,世鎧,13,0,13,群益金鼎-桃園,2024-11-12,9189
2882,國泰金,12,0,12,群益金鼎-桃園,2024-11-12,9189
6223,旺矽,23,11,12,群益金鼎-桃園,2024-11-12,9189
00680L,元大美債20正2,112,0,112,群益金鼎-桃園,2024-11-13,9189
00943,兆豐電子高息等權,100,0,100,群益金鼎-桃園,2024-11-13,9189
2618,長榮航,113,14,99,群益金鼎-桃園,2024-11-13,9189
2834,臺企銀,73,1,72,群益金鼎-桃園,2024-11-13,9189
3706,神達,215,144,71,群益金鼎-桃園,2024-11-13,9189
1301,台塑,69,1,68,群益金鼎-桃園,2024-11-13,9189
2890,永豐金,102,36,66,群益金鼎-桃園,2024-11-13,9189
00878,國泰永續高股息,69,4,65,群益金鼎-桃園,2024-11-13,9189
00919,群益台灣精選高息,65,2,63,群益金鼎-桃園,2024-11-13,9189
2891,中信金,60,1,59,群益金鼎-桃園,2024-11-13,9189
2354,鴻準,61,20,41,群益金鼎-桃園,2024-11-13,9189
00953B,群益優選非投等債,42,2,40,群益金鼎-桃園,2024-11-13,9189
1522,堤維西,39,0,39,群益金鼎-桃園,2024-11-13,9189
00706L,期元大S＆P日圓正2,35,0,35,群益金鼎-桃園,2024-11-13,9189
2317,鴻海,34,1,33,群益金鼎-桃園,2024-11-13,9189
5521,工信,30,0,30,群益金鼎-桃園,2024-11-13,9189
3372,典範,30,1,29,群益金鼎-桃園,2024-11-13,9189
00687B,國泰20年美債,37,11,26,群益金鼎-桃園,2024-11-13,9189
2303,聯電,26,1,25,群益金鼎-桃園,2024-11-13,9189
00891,中信關鍵半導體,27,3,24,群益金鼎-桃園,2024-11-13,9189
2449,京元電子,26,3,23,群益金鼎-桃園,2024-11-13,9189
2801,彰銀,23,0,23,群益金鼎-桃園,2024-11-13,9189
3498,陽程,23,0,23,群益金鼎-桃園,2024-11-13,9189
2349,錸德,29,6,23,群益金鼎-桃園,2024-11-13,9189
2330,台積電,25,2,23,群益金鼎-桃園,2024-11-13,9189
00915,凱基優選高股息30,22,0,22,群益金鼎-桃園,2024-11-13,9189
6284,佳邦,20,0,20,群益金鼎-桃園,2024-11-13,9189
2027,大成鋼,27,7,20,群益金鼎-桃園,2024-11-13,9189
00951,台新日本半導體,20,0,20,群益金鼎-桃園,2024-11-13,9189
6153,嘉聯益,17,0,17,群益金鼎-桃園,2024-11-13,9189
1605,華新,17,0,17,群益金鼎-桃園,2024-11-13,9189
00715L,期街口布蘭特正2,24,8,16,群益金鼎-桃園,2024-11-13,9189
2323,中環,16,0,16,群益金鼎-桃園,2024-11-13,9189
6703,軒郁,16,0,16,群益金鼎-桃園,2024-11-13,9189
00940,元大台灣價值高息,15,0,15,群益金鼎-桃園,2024-11-13,9189
0056,元大高股息,16,1,15,群益金鼎-桃園,2024-11-13,9189
00713,元大台灣高息低波,14,0,14,群益金鼎-桃園,2024-11-13,9189
2486,一詮,16,2,14,群益金鼎-桃園,2024-11-13,9189
2356,英業達,24,11,13,群益金鼎-桃園,2024-11-13,9189
00679B,元大美債20年,39,26,13,群益金鼎-桃園,2024-11-13,9189
3013,晟銘電,46,33,13,群益金鼎-桃園,2024-11-13,9189
2312,金寶,43,30,13,群益金鼎-桃園,2024-11-13,9189
2882,國泰金,22,10,12,群益金鼎-桃園,2024-11-13,9189
3707,漢磊,12,0,12,群益金鼎-桃園,2024-11-13,9189
4576,大銀微系統,12,0,12,群益金鼎-桃園,2024-11-13,9189
5225,東科-KY,12,0,12,群益金鼎-桃園,2024-11-13,9189
2002,中鋼,11,0,11,群益金鼎-桃園,2024-11-13,9189
2431,聯昌,12,1,11,群益金鼎-桃園,2024-11-13,9189
00881,國泰台灣5G+,11,0,11,群益金鼎-桃園,2024-11-13,9189
4563,百德,12,1,11,群益金鼎-桃園,2024-11-13,9189
00878,國泰永續高股息,475,12,463,群益金鼎-桃園,2024-11-14,9189
00937B,群益ESG投等債20,272,24,248,群益金鼎-桃園,2024-11-14,9189
00932,兆豐永續高息等權,253,10,243,群益金鼎-桃園,2024-11-14,9189
2352,佳世達,212,0,212,群益金鼎-桃園,2024-11-14,9189
00753L,中信中國50正2,100,20,80,群益金鼎-桃園,2024-11-14,9189
00929,復華台灣科技優息,64,0,64,群益金鼎-桃園,2024-11-14,9189
00680L,元大美債20正2,105,43,62,群益金鼎-桃園,2024-11-14,9189
00919,群益台灣精選高息,58,5,53,群益金鼎-桃園,2024-11-14,9189
6153,嘉聯益,50,0,50,群益金鼎-桃園,2024-11-14,9189
2002,中鋼,47,0,47,群益金鼎-桃園,2024-11-14,9189
00687B,國泰20年美債,45,2,43,群益金鼎-桃園,2024-11-14,9189
3481,群創,40,4,36,群益金鼎-桃園,2024-11-14,9189
8249,菱光,37,2,35,群益金鼎-桃園,2024-11-14,9189
2883,凱基金,37,6,31,群益金鼎-桃園,2024-11-14,9189
2367,燿華,31,0,31,群益金鼎-桃園,2024-11-14,9189
2444,兆勁,32,1,31,群益金鼎-桃園,2024-11-14,9189
8011,台通,45,15,30,群益金鼎-桃園,2024-11-14,9189
3062,建漢,36,6,30,群益金鼎-桃園,2024-11-14,9189
2303,聯電,55,26,29,群益金鼎-桃園,2024-11-14,9189
1201,味全,27,0,27,群益金鼎-桃園,2024-11-14,9189
00900,富邦特選高股息30,26,0,26,群益金鼎-桃園,2024-11-14,9189
2344,華邦電,56,30,26,群益金鼎-桃園,2024-11-14,9189
00943,兆豐電子高息等權,25,0,25,群益金鼎-桃園,2024-11-14,9189
2317,鴻海,29,4,25,群益金鼎-桃園,2024-11-14,9189
0056,元大高股息,54,30,24,群益金鼎-桃園,2024-11-14,9189
00881,國泰台灣5G+,24,1,23,群益金鼎-桃園,2024-11-14,9189
6005,群益證,22,0,22,群益金鼎-桃園,2024-11-14,9189
2101,南港,21,0,21,群益金鼎-桃園,2024-11-14,9189
1301,台塑,22,2,20,群益金鼎-桃園,2024-11-14,9189
2312,金寶,28,8,20,群益金鼎-桃園,2024-11-14,9189
8089,康全電訊,22,2,20,群益金鼎-桃園,2024-11-14,9189
00891,中信關鍵半導體,19,0,19,群益金鼎-桃園,2024-11-14,9189
2353,宏��,19,0,19,群益金鼎-桃園,2024-11-14,9189
00706L,期元大S＆P日圓正2,19,0,19,群益金鼎-桃園,2024-11-14,9189
00915,凱基優選高股息30,18,0,18,群益金鼎-桃園,2024-11-14,9189
5398,慕康生醫,41,23,18,群益金鼎-桃園,2024-11-14,9189
4938,和碩,19,3,16,群益金鼎-桃園,2024-11-14,9189
2603,長榮,21,6,15,群益金鼎-桃園,2024-11-14,9189
00927,群益半導體收益,15,0,15,群益金鼎-桃園,2024-11-14,9189
00922,國泰台灣領袖50,15,0,15,群益金鼎-桃園,2024-11-14,9189
00930,永豐ESG低碳高息,15,0,15,群益金鼎-桃園,2024-11-14,9189
00642U,期元大S＆P石油,15,0,15,群益金鼎-桃園,2024-11-14,9189
00679B,元大美債20年,17,2,15,群益金鼎-桃園,2024-11-14,9189
00946,群益科技高息成長,13,0,13,群益金鼎-桃園,2024-11-14,9189
4927,泰鼎-KY,13,0,13,群益金鼎-桃園,2024-11-14,9189
2231,為升,13,0,13,群益金鼎-桃園,2024-11-14,9189
2884,玉山金,13,0,13,群益金鼎-桃園,2024-11-14,9189
1314,中石化,14,2,12,群益金鼎-桃園,2024-11-14,9189
1303,南亞,12,0,12,群益金鼎-桃園,2024-11-14,9189
2408,南亞科,16,4,12,群益金鼎-桃園,2024-11-14,9189
00637L,元大滬深300正2,236,39,197,群益金鼎-桃園,2024-11-15,9189
3625,西勝,146,0,146,群益金鼎-桃園,2024-11-15,9189
2382,廣達,144,4,140,群益金鼎-桃園,2024-11-15,9189
00878,國泰永續高股息,131,9,122,群益金鼎-桃園,2024-11-15,9189
00688L,國泰20年美債正2,120,0,120,群益金鼎-桃園,2024-11-15,9189
1815,富喬,91,3,88,群益金鼎-桃園,2024-11-15,9189
00929,復華台灣科技優息,82,1,81,群益金鼎-桃園,2024-11-15,9189
00937B,群益ESG投等債20,88,16,72,群益金鼎-桃園,2024-11-15,9189
2317,鴻海,57,10,47,群益金鼎-桃園,2024-11-15,9189
00945B,凱基美國非投等債,42,0,42,群益金鼎-桃園,2024-11-15,9189
00679B,元大美債20年,40,0,40,群益金鼎-桃園,2024-11-15,9189
00919,群益台灣精選高息,30,3,27,群益金鼎-桃園,2024-11-15,9189
2303,聯電,31,5,26,群益金鼎-桃園,2024-11-15,9189
2748,雲品,45,20,25,群益金鼎-桃園,2024-11-15,9189
1213,大飲,24,0,24,群益金鼎-桃園,2024-11-15,9189
2353,宏��,22,0,22,群益金鼎-桃園,2024-11-15,9189
2891,中信金,22,0,22,群益金鼎-桃園,2024-11-15,9189
6284,佳邦,21,0,21,群益金鼎-桃園,2024-11-15,9189
2474,可成,21,0,21,群益金鼎-桃園,2024-11-15,9189
2495,普安,20,0,20,群益金鼎-桃園,2024-11-15,9189
00706L,期元大S＆P日圓正2,20,0,20,群益金鼎-桃園,2024-11-15,9189
5309,系統電,26,6,20,群益金鼎-桃園,2024-11-15,9189
1611,中電,22,6,16,群益金鼎-桃園,2024-11-15,9189
2392,正崴,24,9,15,群益金鼎-桃園,2024-11-15,9189
00959B,大華投等美債15Y+,15,0,15,群益金鼎-桃園,2024-11-15,9189
6438,迅得,15,0,15,群益金鼎-桃園,2024-11-15,9189
2885,元大金,20,5,15,群益金鼎-桃園,2024-11-15,9189
00946,群益科技高息成長,13,0,13,群益金鼎-桃園,2024-11-15,9189
9904,寶成,13,0,13,群益金鼎-桃園,2024-11-15,9189
00713,元大台灣高息低波,12,0,12,群益金鼎-桃園,2024-11-15,9189
5871,中租-KY,13,1,12,群益金鼎-桃園,2024-11-15,9189
2615,萬海,22,11,11,群益金鼎-桃園,2024-11-15,9189
5876,上海商銀,11,0,11,群益金鼎-桃園,2024-11-15,9189
8150,南茂,10,0,10,群益金鼎-桃園,2024-11-15,9189
912000,晨訊科-DR,10,0,10,群益金鼎-桃園,2024-11-15,9189
00932,兆豐永續高息等權,10,0,10,群益金鼎-桃園,2024-11-15,9189
2314,台揚,10,0,10,群益金鼎-桃園,2024-11-15,9189
5227,立凱-KY,10,0,10,群益金鼎-桃園,2024-11-15,9189
6530,創威,20,10,10,群益金鼎-桃園,2024-11-15,9189
006208,富邦台50,12,2,10,群益金鼎-桃園,2024-11-15,9189
0056,元大高股息,9,0,9,群益金鼎-桃園,2024-11-15,9189
1201,味全,9,0,9,群益金鼎-桃園,2024-11-15,9189
00891,中信關鍵半導體,10,1,9,群益金鼎-桃園,2024-11-15,9189
8085,福華,9,0,9,群益金鼎-桃園,2024-11-15,9189
6405,悅城,9,0,9,群益金鼎-桃園,2024-11-15,9189
2002,中鋼,9,0,9,群益金鼎-桃園,2024-11-15,9189
6757,台灣虎航,8,0,8,群益金鼎-桃園,2024-11-15,9189
8240,華宏,14,6,8,群益金鼎-桃園,2024-11-15,9189
1560,中砂,8,1,7,群益金鼎-桃園,2024-11-15,9189
1531,高林股,11,4,7,群益金鼎-桃園,2024-11-15,9189
00878,國泰永續高股息,147,0,147,群益金鼎-桃園,2024-11-18,9189
00919,群益台灣精選高息,78,0,78,群益金鼎-桃園,2024-11-18,9189
00943,兆豐電子高息等權,55,0,55,群益金鼎-桃園,2024-11-18,9189
00945B,凱基美國非投等債,50,0,50,群益金鼎-桃園,2024-11-18,9189
3702,大聯大,50,3,47,群益金鼎-桃園,2024-11-18,9189
6005,群益證,43,0,43,群益金鼎-桃園,2024-11-18,9189
2312,金寶,85,45,40,群益金鼎-桃園,2024-11-18,9189
2883,凱基金,51,17,34,群益金鼎-桃園,2024-11-18,9189
2354,鴻準,103,72,31,群益金鼎-桃園,2024-11-18,9189
2349,錸德,68,37,31,群益金鼎-桃園,2024-11-18,9189
1326,台化,30,1,29,群益金鼎-桃園,2024-11-18,9189
2317,鴻海,41,12,29,群益金鼎-桃園,2024-11-18,9189
00715L,期街口布蘭特正2,31,3,28,群益金鼎-桃園,2024-11-18,9189
00891,中信關鍵半導體,38,10,28,群益金鼎-桃園,2024-11-18,9189
00953B,群益優選非投等債,27,0,27,群益金鼎-桃園,2024-11-18,9189
8929,富堡,28,2,26,群益金鼎-桃園,2024-11-18,9189
0056,元大高股息,24,0,24,群益金鼎-桃園,2024-11-18,9189
00915,凱基優選高股息30,23,0,23,群益金鼎-桃園,2024-11-18,9189
6438,迅得,21,0,21,群益金鼎-桃園,2024-11-18,9189
2303,聯電,23,3,20,群益金鼎-桃園,2024-11-18,9189
1595,川寶,20,0,20,群益金鼎-桃園,2024-11-18,9189
00918,大華優利高填息30,24,5,19,群益金鼎-桃園,2024-11-18,9189
3013,晟銘電,29,13,16,群益金鼎-桃園,2024-11-18,9189
00930,永豐ESG低碳高息,15,0,15,群益金鼎-桃園,2024-11-18,9189
00751B,元大AAA至A公司債,15,0,15,群益金鼎-桃園,2024-11-18,9189
2610,華航,46,32,14,群益金鼎-桃園,2024-11-18,9189
1815,富喬,15,1,14,群益金鼎-桃園,2024-11-18,9189
2204,中華,15,2,13,群益金鼎-桃園,2024-11-18,9189
4956,光鋐,16,3,13,群益金鼎-桃園,2024-11-18,9189
2646,星宇航空,17,4,13,群益金鼎-桃園,2024-11-18,9189
9933,中鼎,13,0,13,群益金鼎-桃園,2024-11-18,9189
2382,廣達,14,1,13,群益金鼎-桃園,2024-11-18,9189
006208,富邦台50,15,2,13,群益金鼎-桃園,2024-11-18,9189
00922,國泰台灣領袖50,12,0,12,群益金鼎-桃園,2024-11-18,9189
3062,建漢,16,6,10,群益金鼎-桃園,2024-11-18,9189
00881,國泰台灣5G+,12,2,10,群益金鼎-桃園,2024-11-18,9189
4974,亞泰,10,0,10,群益金鼎-桃園,2024-11-18,9189
00752,中信中國50,10,0,10,群益金鼎-桃園,2024-11-18,9189
6271,同欣電,10,0,10,群益金鼎-桃園,2024-11-18,9189
2002,中鋼,12,3,9,群益金鼎-桃園,2024-11-18,9189
5009,榮剛,9,0,9,群益金鼎-桃園,2024-11-18,9189
6147,頎邦,10,1,9,群益金鼎-桃園,2024-11-18,9189
2881,富邦金,9,0,9,群益金鼎-桃園,2024-11-18,9189
2492,華新科,9,0,9,群益金鼎-桃園,2024-11-18,9189
1560,中砂,9,1,8,群益金鼎-桃園,2024-11-18,9189
2423,固緯,48,40,8,群益金鼎-桃園,2024-11-18,9189
2929,淘帝-KY,22,14,8,群益金鼎-桃園,2024-11-18,9189
2409,友達,8,0,8,群益金鼎-桃園,2024-11-18,9189
3593,力銘,8,0,8,群益金鼎-桃園,2024-11-18,9189
8121,越峰,8,0,8,群益金鼎-桃園,2024-11-18,9189
00919,群益台灣精選高息,95,9,86,群益金鼎-桃園,2024-11-19,9189
4577,達航科技,76,0,76,群益金鼎-桃園,2024-11-19,9189
00637L,元大滬深300正2,81,40,41,群益金鼎-桃園,2024-11-19,9189
2317,鴻海,49,16,33,群益金鼎-桃園,2024-11-19,9189
2382,廣達,36,4,32,群益金鼎-桃園,2024-11-19,9189
6005,群益證,30,0,30,群益金鼎-桃園,2024-11-19,9189
6153,嘉聯益,30,0,30,群益金鼎-桃園,2024-11-19,9189
5309,系統電,41,17,24,群益金鼎-桃園,2024-11-19,9189
0056,元大高股息,23,1,22,群益金鼎-桃園,2024-11-19,9189
1301,台塑,21,1,20,群益金鼎-桃園,2024-11-19,9189
8150,南茂,20,0,20,群益金鼎-桃園,2024-11-19,9189
8249,菱光,26,6,20,群益金鼎-桃園,2024-11-19,9189
00945B,凱基美國非投等債,20,2,18,群益金鼎-桃園,2024-11-19,9189
00877,復華中國5G,15,0,15,群益金鼎-桃園,2024-11-19,9189
6215,和椿,15,0,15,群益金鼎-桃園,2024-11-19,9189
00960,野村全球航運龍頭,14,0,14,群益金鼎-桃園,2024-11-19,9189
006208,富邦台50,13,1,12,群益金鼎-桃園,2024-11-19,9189
1618,合機,11,0,11,群益金鼎-桃園,2024-11-19,9189
3481,群創,27,16,11,群益金鼎-桃園,2024-11-19,9189
3576,聯合再生,12,1,11,群益金鼎-桃園,2024-11-19,9189
9933,中鼎,11,0,11,群益金鼎-桃園,2024-11-19,9189
1522,堤維西,11,0,11,群益金鼎-桃園,2024-11-19,9189
00878,國泰永續高股息,13,3,10,群益金鼎-桃園,2024-11-19,9189
6558,興能高,18,8,10,群益金鼎-桃園,2024-11-19,9189
00894,中信小資高價30,10,0,10,群益金鼎-桃園,2024-11-19,9189
2357,華碩,10,1,9,群益金鼎-桃園,2024-11-19,9189
3006,晶豪科,12,3,9,群益金鼎-桃園,2024-11-19,9189
2314,台揚,10,1,9,群益金鼎-桃園,2024-11-19,9189
2489,瑞軒,10,1,9,群益金鼎-桃園,2024-11-19,9189
8104,錸寶,14,5,9,群益金鼎-桃園,2024-11-19,9189
2356,英業達,10,2,8,群益金鼎-桃園,2024-11-19,9189
4927,泰鼎-KY,9,1,8,群益金鼎-桃園,2024-11-19,9189
00946,群益科技高息成長,11,3,8,群益金鼎-桃園,2024-11-19,9189
00953B,群益優選非投等債,7,0,7,群益金鼎-桃園,2024-11-19,9189
2303,聯電,20,13,7,群益金鼎-桃園,2024-11-19,9189
00713,元大台灣高息低波,6,0,6,群益金鼎-桃園,2024-11-19,9189
2308,台達電,7,1,6,群益金鼎-桃園,2024-11-19,9189
9921,巨大,6,0,6,群益金鼎-桃園,2024-11-19,9189
00905,FT臺灣Smart,6,0,6,群益金鼎-桃園,2024-11-19,9189
5871,中租-KY,7,1,6,群益金鼎-桃園,2024-11-19,9189
3450,聯鈞,27,21,6,群益金鼎-桃園,2024-11-19,9189
2009,第一銅,6,0,6,群益金鼎-桃園,2024-11-19,9189
2421,建準,6,0,6,群益金鼎-桃園,2024-11-19,9189
2537,聯上發,6,0,6,群益金鼎-桃園,2024-11-19,9189
2353,宏��,11,5,6,群益金鼎-桃園,2024-11-19,9189
6139,亞翔,6,0,6,群益金鼎-桃園,2024-11-19,9189
00915,凱基優選高股息30,5,0,5,群益金鼎-桃園,2024-11-19,9189
9955,佳龍,6,1,5,群益金鼎-桃園,2024-11-19,9189
6120,達運,5,0,5,群益金鼎-桃園,2024-11-19,9189
00909,國泰數位支付服務,5,0,5,群益金鼎-桃園,2024-11-19,9189
00878,國泰永續高股息,141,21,120,群益金鼎-桃園,2024-11-20,9189
00918,大華優利高填息30,105,2,103,群益金鼎-桃園,2024-11-20,9189
2367,燿華,100,3,97,群益金鼎-桃園,2024-11-20,9189
2354,鴻準,116,34,82,群益金鼎-桃園,2024-11-20,9189
2603,長榮,89,13,76,群益金鼎-桃園,2024-11-20,9189
00943,兆豐電子高息等權,57,1,56,群益金鼎-桃園,2024-11-20,9189
00680L,元大美債20正2,51,0,51,群益金鼎-桃園,2024-11-20,9189
1595,川寶,47,0,47,群益金鼎-桃園,2024-11-20,9189
00937B,群益ESG投等債20,42,3,39,群益金鼎-桃園,2024-11-20,9189
4956,光鋐,35,8,27,群益金鼎-桃園,2024-11-20,9189
3481,群創,28,5,23,群益金鼎-桃園,2024-11-20,9189
2356,英業達,47,24,23,群益金鼎-桃園,2024-11-20,9189
8047,星雲,21,0,21,群益金鼎-桃園,2024-11-20,9189
1301,台塑,20,0,20,群益金鼎-桃園,2024-11-20,9189
3511,矽瑪,80,61,19,群益金鼎-桃園,2024-11-20,9189
00922,國泰台灣領袖50,17,0,17,群益金鼎-桃園,2024-11-20,9189
3323,加百裕,20,5,15,群益金鼎-桃園,2024-11-20,9189
2929,淘帝-KY,20,5,15,群益金鼎-桃園,2024-11-20,9189
8261,富鼎,17,3,14,群益金鼎-桃園,2024-11-20,9189
3447,展達,32,19,13,群益金鼎-桃園,2024-11-20,9189
2605,新興,35,23,12,群益金鼎-桃園,2024-11-20,9189
4927,泰鼎-KY,14,2,12,群益金鼎-桃園,2024-11-20,9189
2332,友訊,21,9,12,群益金鼎-桃園,2024-11-20,9189
00631L,元大台灣50正2,14,3,11,群益金鼎-桃園,2024-11-20,9189
2903,遠百,11,0,11,群益金鼎-桃園,2024-11-20,9189
2641,正德,13,2,11,群益金鼎-桃園,2024-11-20,9189
2441,超豐,11,0,11,群益金鼎-桃園,2024-11-20,9189
6456,GIS-KY,11,0,11,群益金鼎-桃園,2024-11-20,9189
8112,至上,10,0,10,群益金鼎-桃園,2024-11-20,9189
2457,飛宏,10,0,10,群益金鼎-桃園,2024-11-20,9189
912000,晨訊科-DR,10,0,10,群益金鼎-桃園,2024-11-20,9189
2401,凌陽,10,0,10,群益金鼎-桃園,2024-11-20,9189
3615,安可,22,12,10,群益金鼎-桃園,2024-11-20,9189
1785,光洋科,10,0,10,群益金鼎-桃園,2024-11-20,9189
3062,建漢,14,4,10,群益金鼎-桃園,2024-11-20,9189
00891,中信關鍵半導體,10,0,10,群益金鼎-桃園,2024-11-20,9189
6194,育富,10,0,10,群益金鼎-桃園,2024-11-20,9189
5438,東友,18,9,9,群益金鼎-桃園,2024-11-20,9189
2423,固緯,88,79,9,群益金鼎-桃園,2024-11-20,9189
3006,晶豪科,9,0,9,群益金鼎-桃園,2024-11-20,9189
2337,旺宏,11,2,9,群益金鼎-桃園,2024-11-20,9189
00946,群益科技高息成長,8,0,8,群益金鼎-桃園,2024-11-20,9189
006208,富邦台50,11,3,8,群益金鼎-桃園,2024-11-20,9189
8403,盛弘,8,0,8,群益金鼎-桃園,2024-11-20,9189
5426,振發,10,2,8,群益金鼎-桃園,2024-11-20,9189
1449,佳和,8,0,8,群益金鼎-桃園,2024-11-20,9189
3625,西勝,9,1,8,群益金鼎-桃園,2024-11-20,9189
6761,穩得,8,0,8,群益金鼎-桃園,2024-11-20,9189
1513,中興電,8,1,7,群益金鼎-桃園,2024-11-20,9189
00892,富邦台灣半導體,7,0,7,群益金鼎-桃園,2024-11-20,9189
2890,永豐金,104,0,104,群益金鼎-桃園,2024-11-21,9189
00680L,元大美債20正2,90,0,90,群益金鼎-桃園,2024-11-21,9189
3013,晟銘電,91,10,81,群益金鼎-桃園,2024-11-21,9189
6492,生華科,68,0,68,群益金鼎-桃園,2024-11-21,9189
3323,加百裕,68,16,52,群益金鼎-桃園,2024-11-21,9189
00945B,凱基美國非投等債,40,0,40,群益金鼎-桃園,2024-11-21,9189
2303,聯電,42,3,39,群益金鼎-桃園,2024-11-21,9189
1301,台塑,37,0,37,群益金鼎-桃園,2024-11-21,9189
00878,國泰永續高股息,35,0,35,群益金鼎-桃園,2024-11-21,9189
2317,鴻海,39,4,35,群益金鼎-桃園,2024-11-21,9189
3236,千如,32,0,32,群益金鼎-桃園,2024-11-21,9189
6153,嘉聯益,30,0,30,群益金鼎-桃園,2024-11-21,9189
5531,鄉林,30,0,30,群益金鼎-桃園,2024-11-21,9189
2883,凱基金,30,0,30,群益金鼎-桃園,2024-11-21,9189
1616,億泰,30,0,30,群益金鼎-桃園,2024-11-21,9189
2354,鴻準,77,47,30,群益金鼎-桃園,2024-11-21,9189
00688L,國泰20年美債正2,25,0,25,群益金鼎-桃園,2024-11-21,9189
3576,聯合再生,22,0,22,群益金鼎-桃園,2024-11-21,9189
3031,佰鴻,22,0,22,群益金鼎-桃園,2024-11-21,9189
00940,元大台灣價值高息,23,1,22,群益金鼎-桃園,2024-11-21,9189
4102,永日,20,0,20,群益金鼎-桃園,2024-11-21,9189
2834,臺企銀,21,2,19,群益金鼎-桃園,2024-11-21,9189
4956,光鋐,29,14,15,群益金鼎-桃園,2024-11-21,9189
3290,東浦,15,0,15,群益金鼎-桃園,2024-11-21,9189
00930,永豐ESG低碳高息,14,0,14,群益金鼎-桃園,2024-11-21,9189
5443,均豪,13,0,13,群益金鼎-桃園,2024-11-21,9189
2884,玉山金,13,0,13,群益金鼎-桃園,2024-11-21,9189
1446,宏和,12,0,12,群益金鼎-桃園,2024-11-21,9189
00919,群益台灣精選高息,15,3,12,群益金鼎-桃園,2024-11-21,9189
006208,富邦台50,14,3,11,群益金鼎-桃園,2024-11-21,9189
4958,臻鼎-KY,12,1,11,群益金鼎-桃園,2024-11-21,9189
2474,可成,11,0,11,群益金鼎-桃園,2024-11-21,9189
00939,統一台灣高息動能,11,0,11,群益金鼎-桃園,2024-11-21,9189
00655L,國泰中國A50正2,10,0,10,群益金鼎-桃園,2024-11-21,9189
00642U,期元大S＆P石油,10,0,10,群益金鼎-桃園,2024-11-21,9189
2323,中環,10,0,10,群益金鼎-桃園,2024-11-21,9189
8929,富堡,10,0,10,群益金鼎-桃園,2024-11-21,9189
2882,國泰金,19,10,9,群益金鼎-桃園,2024-11-21,9189
2881,富邦金,19,10,9,群益金鼎-桃園,2024-11-21,9189
2545,皇翔,9,0,9,群益金鼎-桃園,2024-11-21,9189
2371,大同,11,2,9,群益金鼎-桃園,2024-11-21,9189
2204,中華,38,30,8,群益金鼎-桃園,2024-11-21,9189
5876,上海商銀,8,0,8,群益金鼎-桃園,2024-11-21,9189
2363,矽統,8,0,8,群益金鼎-桃園,2024-11-21,9189
2646,星宇航空,9,1,8,群益金鼎-桃園,2024-11-21,9189
3617,碩天,9,1,8,群益金鼎-桃園,2024-11-21,9189
00922,國泰台灣領袖50,8,1,7,群益金鼎-桃園,2024-11-21,9189
2344,華邦電,7,0,7,群益金鼎-桃園,2024-11-21,9189
0050,元大台灣50,9,2,7,群益金鼎-桃園,2024-11-21,9189
2401,凌陽,7,0,7,群益金鼎-桃園,2024-11-21,9189
00953B,群益優選非投等債,272,5,267,群益金鼎-桃園,2024-11-22,9189
2444,兆勁,151,17,134,群益金鼎-桃園,2024-11-22,9189
2409,友達,100,0,100,群益金鼎-桃園,2024-11-22,9189
9105,泰金寶-DR,202,107,95,群益金鼎-桃園,2024-11-22,9189
00637L,元大滬深300正2,128,33,95,群益金鼎-桃園,2024-11-22,9189
2883,凱基金,100,8,92,群益金鼎-桃園,2024-11-22,9189
00673R,期元大S＆P原油反1,49,0,49,群益金鼎-桃園,2024-11-22,9189
2891,中信金,35,1,34,群益金鼎-桃園,2024-11-22,9189
3706,神達,196,162,34,群益金鼎-桃園,2024-11-22,9189
2324,仁寶,40,7,33,群益金鼎-桃園,2024-11-22,9189
6153,嘉聯益,31,0,31,群益金鼎-桃園,2024-11-22,9189
00924,復華S＆P500成長,30,0,30,群益金鼎-桃園,2024-11-22,9189
00916,國泰全球品牌50,30,0,30,群益金鼎-桃園,2024-11-22,9189
6492,生華科,30,0,30,群益金鼎-桃園,2024-11-22,9189
2609,陽明,53,28,25,群益金鼎-桃園,2024-11-22,9189
2486,一詮,32,9,23,群益金鼎-桃園,2024-11-22,9189
00878,國泰永續高股息,21,0,21,群益金鼎-桃園,2024-11-22,9189
2539,櫻花建,31,10,21,群益金鼎-桃園,2024-11-22,9189
1460,宏遠,20,0,20,群益金鼎-桃園,2024-11-22,9189
00930,永豐ESG低碳高息,20,0,20,群益金鼎-桃園,2024-11-22,9189
00712,復華富時不動產,20,0,20,群益金鼎-桃園,2024-11-22,9189
00882,中信中國高股息,19,0,19,群益金鼎-桃園,2024-11-22,9189
6274,台燿,20,4,16,群益金鼎-桃園,2024-11-22,9189
9933,中鼎,15,0,15,群益金鼎-桃園,2024-11-22,9189
6558,興能高,122,108,14,群益金鼎-桃園,2024-11-22,9189
1522,堤維西,16,2,14,群益金鼎-桃園,2024-11-22,9189
00909,國泰數位支付服務,15,1,14,群益金鼎-桃園,2024-11-22,9189
0056,元大高股息,16,2,14,群益金鼎-桃園,2024-11-22,9189
6282,康舒,29,16,13,群益金鼎-桃園,2024-11-22,9189
6179,亞通,12,0,12,群益金鼎-桃園,2024-11-22,9189
2353,宏��,12,0,12,群益金鼎-桃園,2024-11-22,9189
1609,大亞,13,2,11,群益金鼎-桃園,2024-11-22,9189
2303,聯電,23,12,11,群益金鼎-桃園,2024-11-22,9189
2929,淘帝-KY,11,0,11,群益金鼎-桃園,2024-11-22,9189
3322,建舜電,11,0,11,群益金鼎-桃園,2024-11-22,9189
8374,羅昇,11,0,11,群益金鼎-桃園,2024-11-22,9189
00915,凱基優選高股息30,10,0,10,群益金鼎-桃園,2024-11-22,9189
2374,佳能,10,0,10,群益金鼎-桃園,2024-11-22,9189
3290,東浦,11,1,10,群益金鼎-桃園,2024-11-22,9189
1742,台蠟,10,0,10,群益金鼎-桃園,2024-11-22,9189
3149,正達,9,0,9,群益金鼎-桃園,2024-11-22,9189
1301,台塑,8,0,8,群益金鼎-桃園,2024-11-22,9189
6156,松上,13,5,8,群益金鼎-桃園,2024-11-22,9189
5426,振發,24,16,8,群益金鼎-桃園,2024-11-22,9189
2002,中鋼,7,0,7,群益金鼎-桃園,2024-11-22,9189
3189,景碩,8,1,7,群益金鼎-桃園,2024-11-22,9189
6191,精成科,7,0,7,群益金鼎-桃園,2024-11-22,9189
00632R,元大台灣50反1,76,69,7,群益金鼎-桃園,2024-11-22,9189
2615,萬海,14,8,6,群益金鼎-桃園,2024-11-22,9189
5876,上海商銀,6,0,6,群益金鼎-桃園,2024-11-22,9189
2891,中信金,305,1,304,群益金鼎-桃園,2024-11-25,9189
00953B,群益優選非投等債,289,0,289,群益金鼎-桃園,2024-11-25,9189
5880,合庫金,102,1,101,群益金鼎-桃園,2024-11-25,9189
9105,泰金寶-DR,110,17,93,群益金鼎-桃園,2024-11-25,9189
2371,大同,76,3,73,群益金鼎-桃園,2024-11-25,9189
4102,永日,70,0,70,群益金鼎-桃園,2024-11-25,9189
00950B,凱基A級公司債,65,0,65,群益金鼎-桃園,2024-11-25,9189
2603,長榮,47,4,43,群益金鼎-桃園,2024-11-25,9189
6282,康舒,45,3,42,群益金鼎-桃園,2024-11-25,9189
1711,永光,41,1,40,群益金鼎-桃園,2024-11-25,9189
2633,台灣高鐵,37,0,37,群益金鼎-桃園,2024-11-25,9189
2312,金寶,293,258,35,群益金鼎-桃園,2024-11-25,9189
00877,復華中國5G,30,1,29,群益金鼎-桃園,2024-11-25,9189
00929,復華台灣科技優息,36,11,25,群益金鼎-桃園,2024-11-25,9189
8096,擎亞,24,0,24,群益金鼎-桃園,2024-11-25,9189
3706,神達,131,108,23,群益金鼎-桃園,2024-11-25,9189
6005,群益證,31,8,23,群益金鼎-桃園,2024-11-25,9189
00930,永豐ESG低碳高息,23,0,23,群益金鼎-桃園,2024-11-25,9189
00639,富邦深100,23,2,21,群益金鼎-桃園,2024-11-25,9189
00632R,元大台灣50反1,38,18,20,群益金鼎-桃園,2024-11-25,9189
00959B,大華投等美債15Y+,20,0,20,群益金鼎-桃園,2024-11-25,9189
00919,群益台灣精選高息,22,5,17,群益金鼎-桃園,2024-11-25,9189
2330,台積電,21,5,16,群益金鼎-桃園,2024-11-25,9189
00885,富邦越南,16,0,16,群益金鼎-桃園,2024-11-25,9189
1524,耿鼎,19,4,15,群益金鼎-桃園,2024-11-25,9189
00655L,國泰中國A50正2,15,0,15,群益金鼎-桃園,2024-11-25,9189
2498,宏達電,16,1,15,群益金鼎-桃園,2024-11-25,9189
2615,萬海,15,1,14,群益金鼎-桃園,2024-11-25,9189
2618,長榮航,22,10,12,群益金鼎-桃園,2024-11-25,9189
3114,好德,13,1,12,群益金鼎-桃園,2024-11-25,9189
3290,東浦,14,2,12,群益金鼎-桃園,2024-11-25,9189
00940,元大台灣價值高息,11,0,11,群益金鼎-桃園,2024-11-25,9189
5876,上海商銀,11,0,11,群益金鼎-桃園,2024-11-25,9189
9945,潤泰新,10,0,10,群益金鼎-桃園,2024-11-25,9189
1326,台化,10,0,10,群益金鼎-桃園,2024-11-25,9189
5871,中租-KY,10,0,10,群益金鼎-桃園,2024-11-25,9189
3055,蔚華科,10,0,10,群益金鼎-桃園,2024-11-25,9189
6284,佳邦,10,0,10,群益金鼎-桃園,2024-11-25,9189
2892,第一金,10,0,10,群益金鼎-桃園,2024-11-25,9189
2449,京元電子,11,2,9,群益金鼎-桃園,2024-11-25,9189
3031,佰鴻,14,5,9,群益金鼎-桃園,2024-11-25,9189
5398,慕康生醫,10,1,9,群益金鼎-桃園,2024-11-25,9189
4931,新盛力,12,3,9,群益金鼎-桃園,2024-11-25,9189
4729,熒茂,27,18,9,群益金鼎-桃園,2024-11-25,9189
1101,台泥,111,102,9,群益金鼎-桃園,2024-11-25,9189
1809,中釉,24,16,8,群益金鼎-桃園,2024-11-25,9189
4956,光鋐,40,32,8,群益金鼎-桃園,2024-11-25,9189
5452,佶優,8,0,8,群益金鼎-桃園,2024-11-25,9189
1563,巧新,8,0,8,群益金鼎-桃園,2024-11-25,9189
2034,允強,9,1,8,群益金鼎-桃園,2024-11-25,9189
9105,泰金寶-DR,250,12,238,群益金鼎-桃園,2024-11-26,9189
3706,神達,193,76,117,群益金鼎-桃園,2024-11-26,9189
5880,合庫金,101,1,100,群益金鼎-桃園,2024-11-26,9189
2317,鴻海,92,11,81,群益金鼎-桃園,2024-11-26,9189
3024,憶聲,52,0,52,群益金鼎-桃園,2024-11-26,9189
00930,永豐ESG低碳高息,36,0,36,群益金鼎-桃園,2024-11-26,9189
1504,東元,41,10,31,群益金鼎-桃園,2024-11-26,9189
6133,金橋,31,0,31,群益金鼎-桃園,2024-11-26,9189
00885,富邦越南,30,0,30,群益金鼎-桃園,2024-11-26,9189
2312,金寶,119,91,28,群益金鼎-桃園,2024-11-26,9189
3231,緯創,32,5,27,群益金鼎-桃園,2024-11-26,9189
2609,陽明,27,1,26,群益金鼎-桃園,2024-11-26,9189
2349,錸德,28,2,26,群益金鼎-桃園,2024-11-26,9189
00919,群益台灣精選高息,31,6,25,群益金鼎-桃園,2024-11-26,9189
00673R,期元大S＆P原油反1,23,0,23,群益金鼎-桃園,2024-11-26,9189
00878,國泰永續高股息,22,0,22,群益金鼎-桃園,2024-11-26,9189
2371,大同,22,1,21,群益金鼎-桃園,2024-11-26,9189
2356,英業達,27,8,19,群益金鼎-桃園,2024-11-26,9189
2883,凱基金,18,0,18,群益金鼎-桃園,2024-11-26,9189
00953B,群益優選非投等債,30,13,17,群益金鼎-桃園,2024-11-26,9189
5426,振發,16,0,16,群益金鼎-桃園,2024-11-26,9189
2444,兆勁,18,2,16,群益金鼎-桃園,2024-11-26,9189
5009,榮剛,15,0,15,群益金鼎-桃園,2024-11-26,9189
1524,耿鼎,20,6,14,群益金鼎-桃園,2024-11-26,9189
3363,上詮,25,12,13,群益金鼎-桃園,2024-11-26,9189
2449,京元電子,13,0,13,群益金鼎-桃園,2024-11-26,9189
6962,ITH-KY,14,1,13,群益金鼎-桃園,2024-11-26,9189
8028,昇陽半導體,18,5,13,群益金鼎-桃園,2024-11-26,9189
00946,群益科技高息成長,22,9,13,群益金鼎-桃園,2024-11-26,9189
5309,系統電,96,84,12,群益金鼎-桃園,2024-11-26,9189
006208,富邦台50,16,4,12,群益金鼎-桃園,2024-11-26,9189
8042,金山電,23,12,11,群益金鼎-桃園,2024-11-26,9189
1563,巧新,10,0,10,群益金鼎-桃園,2024-11-26,9189
3055,蔚華科,10,0,10,群益金鼎-桃園,2024-11-26,9189
2880,華南金,10,0,10,群益金鼎-桃園,2024-11-26,9189
00881,國泰台灣5G+,9,0,9,群益金鼎-桃園,2024-11-26,9189
2419,仲琦,38,29,9,群益金鼎-桃園,2024-11-26,9189
2330,台積電,8,0,8,群益金鼎-桃園,2024-11-26,9189
6164,華興,8,0,8,群益金鼎-桃園,2024-11-26,9189
2748,雲品,8,0,8,群益金鼎-桃園,2024-11-26,9189
6438,迅得,13,5,8,群益金鼎-桃園,2024-11-26,9189
2890,永豐金,7,0,7,群益金鼎-桃園,2024-11-26,9189
3227,原相,7,0,7,群益金鼎-桃園,2024-11-26,9189
2388,威盛,7,0,7,群益金鼎-桃園,2024-11-26,9189
8121,越峰,7,0,7,群益金鼎-桃園,2024-11-26,9189
6605,帝寶,10,3,7,群益金鼎-桃園,2024-11-26,9189
8044,網家,23,16,7,群益金鼎-桃園,2024-11-26,9189
3090,日電貿,9,3,6,群益金鼎-桃園,2024-11-26,9189
2408,南亞科,6,0,6,群益金鼎-桃園,2024-11-26,9189
6288,聯嘉,7,1,6,群益金鼎-桃園,2024-11-26,9189
2409,友達,141,0,141,群益金鼎-桃園,2024-11-27,9189
00878,國泰永續高股息,148,12,136,群益金鼎-桃園,2024-11-27,9189
00929,復華台灣科技優息,180,64,116,群益金鼎-桃園,2024-11-27,9189
2883,凱基金,116,0,116,群益金鼎-桃園,2024-11-27,9189
2303,聯電,88,8,80,群益金鼎-桃園,2024-11-27,9189
2317,鴻海,81,11,70,群益金鼎-桃園,2024-11-27,9189
00918,大華優利高填息30,68,0,68,群益金鼎-桃園,2024-11-27,9189
00687B,國泰20年美債,102,41,61,群益金鼎-桃園,2024-11-27,9189
00891,中信關鍵半導體,56,0,56,群益金鼎-桃園,2024-11-27,9189
00937B,群益ESG投等債20,63,8,55,群益金鼎-桃園,2024-11-27,9189
0056,元大高股息,51,0,51,群益金鼎-桃園,2024-11-27,9189
00919,群益台灣精選高息,50,0,50,群益金鼎-桃園,2024-11-27,9189
2344,華邦電,66,17,49,群益金鼎-桃園,2024-11-27,9189
00922,國泰台灣領袖50,47,0,47,群益金鼎-桃園,2024-11-27,9189
3303,岱稜,42,0,42,群益金鼎-桃園,2024-11-27,9189
2323,中環,41,0,41,群益金鼎-桃園,2024-11-27,9189
00932,兆豐永續高息等權,40,0,40,群益金鼎-桃園,2024-11-27,9189
00940,元大台灣價值高息,36,0,36,群益金鼎-桃園,2024-11-27,9189
2603,長榮,39,8,31,群益金鼎-桃園,2024-11-27,9189
00632R,元大台灣50反1,71,40,31,群益金鼎-桃園,2024-11-27,9189
8096,擎亞,30,0,30,群益金鼎-桃園,2024-11-27,9189
2104,國際中橡,29,0,29,群益金鼎-桃園,2024-11-27,9189
2392,正崴,58,30,28,群益金鼎-桃園,2024-11-27,9189
3231,緯創,35,7,28,群益金鼎-桃園,2024-11-27,9189
9945,潤泰新,35,8,27,群益金鼎-桃園,2024-11-27,9189
8028,昇陽半導體,26,1,25,群益金鼎-桃園,2024-11-27,9189
2891,中信金,24,0,24,群益金鼎-桃園,2024-11-27,9189
2382,廣達,26,4,22,群益金鼎-桃園,2024-11-27,9189
00905,FT臺灣Smart,22,0,22,群益金鼎-桃園,2024-11-27,9189
5521,工信,20,0,20,群益金鼎-桃園,2024-11-27,9189
2330,台積電,19,0,19,群益金鼎-桃園,2024-11-27,9189
2609,陽明,72,57,15,群益金鼎-桃園,2024-11-27,9189
2881,富邦金,15,0,15,群益金鼎-桃園,2024-11-27,9189
3047,訊舟,15,0,15,群益金鼎-桃園,2024-11-27,9189
1301,台塑,15,0,15,群益金鼎-桃園,2024-11-27,9189
2359,所羅門,16,2,14,群益金鼎-桃園,2024-11-27,9189
2882,國泰金,15,1,14,群益金鼎-桃園,2024-11-27,9189
3149,正達,14,0,14,群益金鼎-桃園,2024-11-27,9189
1326,台化,14,0,14,群益金鼎-桃園,2024-11-27,9189
02001R,富邦蘋果反一N,14,0,14,群益金鼎-桃園,2024-11-27,9189
2002,中鋼,16,3,13,群益金鼎-桃園,2024-11-27,9189
4157,太景*-KY,13,0,13,群益金鼎-桃園,2024-11-27,9189
2356,英業達,16,3,13,群益金鼎-桃園,2024-11-27,9189
3622,洋華,13,0,13,群益金鼎-桃園,2024-11-27,9189
3290,東浦,13,0,13,群益金鼎-桃園,2024-11-27,9189
2887,台新金,13,0,13,群益金鼎-桃園,2024-11-27,9189
2388,威盛,13,0,13,群益金鼎-桃園,2024-11-27,9189
9933,中鼎,12,0,12,群益金鼎-桃園,2024-11-27,9189
00887,永豐中國科技50大,12,0,12,群益金鼎-桃園,2024-11-27,9189
4540,全球傳動,13,1,12,群益金鼎-桃園,2024-11-27,9189
2888,新光金,100,1,99,群益金鼎-桃園,2024-11-28,9189
00919,群益台灣精選高息,88,6,82,群益金鼎-桃園,2024-11-28,9189
2303,聯電,102,29,73,群益金鼎-桃園,2024-11-28,9189
00878,國泰永續高股息,81,9,72,群益金鼎-桃園,2024-11-28,9189
5410,國眾,70,0,70,群益金鼎-桃園,2024-11-28,9189
3483,力致,60,0,60,群益金鼎-桃園,2024-11-28,9189
2312,金寶,95,39,56,群益金鼎-桃園,2024-11-28,9189
9105,泰金寶-DR,53,2,51,群益金鼎-桃園,2024-11-28,9189
0056,元大高股息,50,1,49,群益金鼎-桃園,2024-11-28,9189
6153,嘉聯益,43,0,43,群益金鼎-桃園,2024-11-28,9189
2332,友訊,73,35,38,群益金鼎-桃園,2024-11-28,9189
00946,群益科技高息成長,33,0,33,群益金鼎-桃園,2024-11-28,9189
1815,富喬,144,111,33,群益金鼎-桃園,2024-11-28,9189
2317,鴻海,31,4,27,群益金鼎-桃園,2024-11-28,9189
00940,元大台灣價值高息,30,5,25,群益金鼎-桃園,2024-11-28,9189
3591,艾笛森,27,5,22,群益金鼎-桃園,2024-11-28,9189
1326,台化,20,0,20,群益金鼎-桃園,2024-11-28,9189
00637L,元大滬深300正2,62,42,20,群益金鼎-桃園,2024-11-28,9189
00915,凱基優選高股息30,19,2,17,群益金鼎-桃園,2024-11-28,9189
00918,大華優利高填息30,57,40,17,群益金鼎-桃園,2024-11-28,9189
2423,固緯,49,32,17,群益金鼎-桃園,2024-11-28,9189
2070,精湛,97,80,17,群益金鼎-桃園,2024-11-28,9189
2344,華邦電,15,0,15,群益金鼎-桃園,2024-11-28,9189
3231,緯創,17,3,14,群益金鼎-桃園,2024-11-28,9189
8046,南電,14,0,14,群益金鼎-桃園,2024-11-28,9189
1909,榮成,13,0,13,群益金鼎-桃園,2024-11-28,9189
2102,泰豐,13,0,13,群益金鼎-桃園,2024-11-28,9189
3521,鴻翊,13,0,13,群益金鼎-桃園,2024-11-28,9189
2327,國巨,14,2,12,群益金鼎-桃園,2024-11-28,9189
2615,萬海,12,0,12,群益金鼎-桃園,2024-11-28,9189
4971,IET-KY,15,3,12,群益金鼎-桃園,2024-11-28,9189
2881,富邦金,12,1,11,群益金鼎-桃園,2024-11-28,9189
6438,迅得,11,0,11,群益金鼎-桃園,2024-11-28,9189
2104,國際中橡,11,0,11,群益金鼎-桃園,2024-11-28,9189
3221,台嘉碩,10,0,10,群益金鼎-桃園,2024-11-28,9189
1201,味全,10,0,10,群益金鼎-桃園,2024-11-28,9189
1711,永光,10,0,10,群益金鼎-桃園,2024-11-28,9189
6016,康和證,10,0,10,群益金鼎-桃園,2024-11-28,9189
5521,工信,10,0,10,群益金鼎-桃園,2024-11-28,9189
00932,兆豐永續高息等權,10,0,10,群益金鼎-桃園,2024-11-28,9189
2515,中工,10,0,10,群益金鼎-桃園,2024-11-28,9189
6142,友勁,10,0,10,群益金鼎-桃園,2024-11-28,9189
00665L,富邦�琤肭磪囓�2,10,0,10,群益金鼎-桃園,2024-11-28,9189
8043,蜜望實,10,0,10,群益金鼎-桃園,2024-11-28,9189
5299,杰力,9,0,9,群益金鼎-桃園,2024-11-28,9189
2929,淘帝-KY,10,1,9,群益金鼎-桃園,2024-11-28,9189
1305,華夏,10,2,8,群益金鼎-桃園,2024-11-28,9189
6683,雍智科技,8,0,8,群益金鼎-桃園,2024-11-28,9189
2355,敬鵬,8,0,8,群益金鼎-桃園,2024-11-28,9189
2402,毅嘉,9,1,8,群益金鼎-桃園,2024-11-28,9189
00637L,元大滬深300正2,105,45,60,群益金鼎-桃園,2024-11-29,9189
00919,群益台灣精選高息,109,69,40,群益金鼎-桃園,2024-11-29,9189
2002,中鋼,34,0,34,群益金鼎-桃園,2024-11-29,9189
00878,國泰永續高股息,33,1,32,群益金鼎-桃園,2024-11-29,9189
2891,中信金,31,0,31,群益金鼎-桃園,2024-11-29,9189
2303,聯電,32,8,24,群益金鼎-桃園,2024-11-29,9189
8043,蜜望實,22,0,22,群益金鼎-桃園,2024-11-29,9189
2329,華泰,20,0,20,群益金鼎-桃園,2024-11-29,9189
00960,野村全球航運龍頭,20,0,20,群益金鼎-桃園,2024-11-29,9189
2515,中工,20,0,20,群益金鼎-桃園,2024-11-29,9189
6176,瑞儀,20,1,19,群益金鼎-桃園,2024-11-29,9189
9105,泰金寶-DR,19,3,16,群益金鼎-桃園,2024-11-29,9189
2317,鴻海,22,6,16,群益金鼎-桃園,2024-11-29,9189
00687B,國泰20年美債,20,5,15,群益金鼎-桃園,2024-11-29,9189
8163,達方,20,6,14,群益金鼎-桃園,2024-11-29,9189
3114,好德,13,0,13,群益金鼎-桃園,2024-11-29,9189
4510,高鋒,51,39,12,群益金鼎-桃園,2024-11-29,9189
2449,京元電子,11,0,11,群益金鼎-桃園,2024-11-29,9189
6235,華孚,12,1,11,群益金鼎-桃園,2024-11-29,9189
1605,華新,16,5,11,群益金鼎-桃園,2024-11-29,9189
2354,鴻準,38,27,11,群益金鼎-桃園,2024-11-29,9189
3483,力致,10,0,10,群益金鼎-桃園,2024-11-29,9189
2401,凌陽,10,0,10,群益金鼎-桃園,2024-11-29,9189
3413,京鼎,10,0,10,群益金鼎-桃園,2024-11-29,9189
3303,岱稜,13,3,10,群益金鼎-桃園,2024-11-29,9189
00953B,群益優選非投等債,10,0,10,群益金鼎-桃園,2024-11-29,9189
3712,永崴投控,11,1,10,群益金鼎-桃園,2024-11-29,9189
3055,蔚華科,10,0,10,群益金鼎-桃園,2024-11-29,9189
2882,國泰金,9,0,9,群益金鼎-桃園,2024-11-29,9189
2344,華邦電,10,1,9,群益金鼎-桃園,2024-11-29,9189
2883,凱基金,17,8,9,群益金鼎-桃園,2024-11-29,9189
2324,仁寶,11,2,9,群益金鼎-桃園,2024-11-29,9189
1595,川寶,10,1,9,群益金鼎-桃園,2024-11-29,9189
6603,富強鑫,9,0,9,群益金鼎-桃園,2024-11-29,9189
00929,復華台灣科技優息,8,0,8,群益金鼎-桃園,2024-11-29,9189
00930,永豐ESG低碳高息,8,0,8,群益金鼎-桃園,2024-11-29,9189
5213,亞昕,8,0,8,群益金鼎-桃園,2024-11-29,9189
00900,富邦特選高股息30,8,0,8,群益金鼎-桃園,2024-11-29,9189
2881,富邦金,8,1,7,群益金鼎-桃園,2024-11-29,9189
4729,熒茂,12,5,7,群益金鼎-桃園,2024-11-29,9189
2070,精湛,11,4,7,群益金鼎-桃園,2024-11-29,9189
2887,台新金,7,0,7,群益金鼎-桃園,2024-11-29,9189
2801,彰銀,10,3,7,群益金鼎-桃園,2024-11-29,9189
5880,合庫金,7,1,6,群益金鼎-桃園,2024-11-29,9189
2615,萬海,6,0,6,群益金鼎-桃園,2024-11-29,9189
00632R,元大台灣50反1,123,117,6,群益金鼎-桃園,2024-11-29,9189
3031,佰鴻,13,7,6,群益金鼎-桃園,2024-11-29,9189
2609,陽明,32,26,6,群益金鼎-桃園,2024-11-29,9189
0056,元大高股息,14,8,6,群益金鼎-桃園,2024-11-29,9189
006208,富邦台50,13,7,6,群益金鼎-桃園,2024-11-29,9189
00665L,富邦�琤肭磪囓�2,110,0,110,群益金鼎-桃園,2024-12-02,9189
1815,富喬,84,22,62,群益金鼎-桃園,2024-12-02,9189
2888,新光金,100,40,60,群益金鼎-桃園,2024-12-02,9189
8171,天宇,58,2,56,群益金鼎-桃園,2024-12-02,9189
3024,憶聲,49,5,44,群益金鼎-桃園,2024-12-02,9189
2886,兆豐金,42,0,42,群益金鼎-桃園,2024-12-02,9189
00632R,元大台灣50反1,95,66,29,群益金鼎-桃園,2024-12-02,9189
2312,金寶,76,49,27,群益金鼎-桃園,2024-12-02,9189
2498,宏達電,26,0,26,群益金鼎-桃園,2024-12-02,9189
5469,瀚宇博,25,0,25,群益金鼎-桃園,2024-12-02,9189
4956,光鋐,25,0,25,群益金鼎-桃園,2024-12-02,9189
00715L,期街口布蘭特正2,30,7,23,群益金鼎-桃園,2024-12-02,9189
00953B,群益優選非投等債,20,0,20,群益金鼎-桃園,2024-12-02,9189
2344,華邦電,18,1,17,群益金鼎-桃園,2024-12-02,9189
1326,台化,16,0,16,群益金鼎-桃園,2024-12-02,9189
2495,普安,17,1,16,群益金鼎-桃園,2024-12-02,9189
2543,皇昌,16,1,15,群益金鼎-桃園,2024-12-02,9189
2352,佳世達,14,0,14,群益金鼎-桃園,2024-12-02,9189
00637L,元大滬深300正2,105,91,14,群益金鼎-桃園,2024-12-02,9189
6117,迎廣,16,3,13,群益金鼎-桃園,2024-12-02,9189
5371,中光電,43,31,12,群益金鼎-桃園,2024-12-02,9189
00770,國泰北美科技,12,0,12,群益金鼎-桃園,2024-12-02,9189
2027,大成鋼,12,0,12,群益金鼎-桃園,2024-12-02,9189
2348,海悅,12,0,12,群益金鼎-桃園,2024-12-02,9189
2337,旺宏,11,0,11,群益金鼎-桃園,2024-12-02,9189
2359,所羅門,12,1,11,群益金鼎-桃園,2024-12-02,9189
1102,亞泥,10,0,10,群益金鼎-桃園,2024-12-02,9189
8938,明安,10,0,10,群益金鼎-桃園,2024-12-02,9189
3163,波若威,20,10,10,群益金鼎-桃園,2024-12-02,9189
00650L,復華香港正2,40,30,10,群益金鼎-桃園,2024-12-02,9189
1611,中電,10,0,10,群益金鼎-桃園,2024-12-02,9189
1605,華新,15,6,9,群益金鼎-桃園,2024-12-02,9189
2108,南帝,9,0,9,群益金鼎-桃園,2024-12-02,9189
9933,中鼎,9,0,9,群益金鼎-桃園,2024-12-02,9189
6153,嘉聯益,8,0,8,群益金鼎-桃園,2024-12-02,9189
2345,智邦,15,7,8,群益金鼎-桃園,2024-12-02,9189
1504,東元,9,1,8,群益金鼎-桃園,2024-12-02,9189
2809,京城銀,8,0,8,群益金鼎-桃園,2024-12-02,9189
2317,鴻海,19,12,7,群益金鼎-桃園,2024-12-02,9189
2615,萬海,8,1,7,群益金鼎-桃園,2024-12-02,9189
1536,和大,35,28,7,群益金鼎-桃園,2024-12-02,9189
2408,南亞科,7,0,7,群益金鼎-桃園,2024-12-02,9189
4123,晟德,8,1,7,群益金鼎-桃園,2024-12-02,9189
3211,順達,33,26,7,群益金鼎-桃園,2024-12-02,9189
3363,上詮,7,0,7,群益金鼎-桃園,2024-12-02,9189
8163,達方,9,2,7,群益金鼎-桃園,2024-12-02,9189
5244,弘凱,19,13,6,群益金鼎-桃園,2024-12-02,9189
4714,永捷,63,57,6,群益金鼎-桃園,2024-12-02,9189
2637,慧洋-KY,6,0,6,群益金鼎-桃園,2024-12-02,9189
3580,友威科,6,0,6,群益金鼎-桃園,2024-12-02,9189
00686R,群益臺灣加權反1,998,0,998,群益金鼎-桃園,2024-12-03,9189
00946,群益科技高息成長,157,0,157,群益金鼎-桃園,2024-12-03,9189
00919,群益台灣精選高息,147,35,112,群益金鼎-桃園,2024-12-03,9189
8112,至上,101,3,98,群益金鼎-桃園,2024-12-03,9189
00953B,群益優選非投等債,64,0,64,群益金鼎-桃園,2024-12-03,9189
3499,環天科,50,1,49,群益金鼎-桃園,2024-12-03,9189
0056,元大高股息,44,4,40,群益金鼎-桃園,2024-12-03,9189
2618,長榮航,110,78,32,群益金鼎-桃園,2024-12-03,9189
2312,金寶,40,9,31,群益金鼎-桃園,2024-12-03,9189
3231,緯創,35,5,30,群益金鼎-桃園,2024-12-03,9189
3090,日電貿,37,9,28,群益金鼎-桃園,2024-12-03,9189
1815,富喬,39,11,28,群益金鼎-桃園,2024-12-03,9189
00715L,期街口布蘭特正2,27,0,27,群益金鼎-桃園,2024-12-03,9189
2444,兆勁,33,10,23,群益金鼎-桃園,2024-12-03,9189
00632R,元大台灣50反1,64,42,22,群益金鼎-桃園,2024-12-03,9189
4303,信立,36,18,18,群益金鼎-桃園,2024-12-03,9189
1449,佳和,22,7,15,群益金鼎-桃園,2024-12-03,9189
4430,耀億,15,0,15,群益金鼎-桃園,2024-12-03,9189
3265,台星科,13,0,13,群益金鼎-桃園,2024-12-03,9189
8097,常珵,13,0,13,群益金鼎-桃園,2024-12-03,9189
3338,泰碩,25,13,12,群益金鼎-桃園,2024-12-03,9189
4927,泰鼎-KY,12,0,12,群益金鼎-桃園,2024-12-03,9189
3037,欣興,14,3,11,群益金鼎-桃園,2024-12-03,9189
5328,華容,11,0,11,群益金鼎-桃園,2024-12-03,9189
00646,元大S＆P500,11,0,11,群益金鼎-桃園,2024-12-03,9189
00712,復華富時不動產,11,0,11,群益金鼎-桃園,2024-12-03,9189
1605,華新,11,0,11,群益金鼎-桃園,2024-12-03,9189
3234,光環,21,10,11,群益金鼎-桃園,2024-12-03,9189
2303,聯電,25,15,10,群益金鼎-桃園,2024-12-03,9189
2354,鴻準,21,11,10,群益金鼎-桃園,2024-12-03,9189
8358,金居,10,0,10,群益金鼎-桃園,2024-12-03,9189
8028,昇陽半導體,12,2,10,群益金鼎-桃園,2024-12-03,9189
3483,力致,10,0,10,群益金鼎-桃園,2024-12-03,9189
3260,威剛,10,0,10,群益金鼎-桃園,2024-12-03,9189
00688L,國泰20年美債正2,10,0,10,群益金鼎-桃園,2024-12-03,9189
6271,同欣電,10,0,10,群益金鼎-桃園,2024-12-03,9189
6548,長科*,11,1,10,群益金鼎-桃園,2024-12-03,9189
2646,星宇航空,16,7,9,群益金鼎-桃園,2024-12-03,9189
6274,台燿,10,2,8,群益金鼎-桃園,2024-12-03,9189
4938,和碩,8,0,8,群益金鼎-桃園,2024-12-03,9189
6770,力積電,9,2,7,群益金鼎-桃園,2024-12-03,9189
2887,台新金,7,0,7,群益金鼎-桃園,2024-12-03,9189
4915,致伸,7,0,7,群益金鼎-桃園,2024-12-03,9189
4991,環宇-KY,20,13,7,群益金鼎-桃園,2024-12-03,9189
00915,凱基優選高股息30,7,0,7,群益金鼎-桃園,2024-12-03,9189
2486,一詮,10,3,7,群益金鼎-桃園,2024-12-03,9189
3419,譁裕,7,0,7,群益金鼎-桃園,2024-12-03,9189
2338,光罩,7,0,7,群益金鼎-桃園,2024-12-03,9189
4931,新盛力,13,6,7,群益金鼎-桃園,2024-12-03,9189
2317,鴻海,11,5,6,群益金鼎-桃園,2024-12-03,9189
00953B,群益優選非投等債,318,0,318,群益金鼎-桃園,2024-12-04,9189
3706,神達,243,149,94,群益金鼎-桃園,2024-12-04,9189
2883,凱基金,83,12,71,群益金鼎-桃園,2024-12-04,9189
00680L,元大美債20正2,60,8,52,群益金鼎-桃園,2024-12-04,9189
00753L,中信中國50正2,49,0,49,群益金鼎-桃園,2024-12-04,9189
3483,力致,46,0,46,群益金鼎-桃園,2024-12-04,9189
00687B,國泰20年美債,53,8,45,群益金鼎-桃園,2024-12-04,9189
00712,復華富時不動產,41,0,41,群益金鼎-桃園,2024-12-04,9189
4960,誠美材,31,0,31,群益金鼎-桃園,2024-12-04,9189
00751B,元大AAA至A公司債,30,0,30,群益金鼎-桃園,2024-12-04,9189
00946,群益科技高息成長,28,2,26,群益金鼎-桃園,2024-12-04,9189
2834,臺企銀,26,0,26,群益金鼎-桃園,2024-12-04,9189
2891,中信金,24,2,22,群益金鼎-桃園,2024-12-04,9189
00919,群益台灣精選高息,38,17,21,群益金鼎-桃園,2024-12-04,9189
00918,大華優利高填息30,21,0,21,群益金鼎-桃園,2024-12-04,9189
00926,凱基全球菁英55,21,0,21,群益金鼎-桃園,2024-12-04,9189
5309,系統電,26,5,21,群益金鼎-桃園,2024-12-04,9189
4157,太景*-KY,20,0,20,群益金鼎-桃園,2024-12-04,9189
2610,華航,51,32,19,群益金鼎-桃園,2024-12-04,9189
0056,元大高股息,32,16,16,群益金鼎-桃園,2024-12-04,9189
1449,佳和,15,0,15,群益金鼎-桃園,2024-12-04,9189
00959B,大華投等美債15Y+,17,2,15,群益金鼎-桃園,2024-12-04,9189
2303,聯電,18,4,14,群益金鼎-桃園,2024-12-04,9189
3088,艾訊,14,0,14,群益金鼎-桃園,2024-12-04,9189
6791,虎門科技,14,0,14,群益金鼎-桃園,2024-12-04,9189
00679B,元大美債20年,314,300,14,群益金鼎-桃園,2024-12-04,9189
006208,富邦台50,18,6,12,群益金鼎-桃園,2024-12-04,9189
3466,德晉,18,6,12,群益金鼎-桃園,2024-12-04,9189
1504,東元,12,1,11,群益金鼎-桃園,2024-12-04,9189
6005,群益證,12,1,11,群益金鼎-桃園,2024-12-04,9189
2449,京元電子,21,11,10,群益金鼎-桃園,2024-12-04,9189
3623,富晶通,10,0,10,群益金鼎-桃園,2024-12-04,9189
8111,立��,14,4,10,群益金鼎-桃園,2024-12-04,9189
00957B,兆豐US優選投等債,10,0,10,群益金鼎-桃園,2024-12-04,9189
2027,大成鋼,10,0,10,群益金鼎-桃園,2024-12-04,9189
2002,中鋼,9,0,9,群益金鼎-桃園,2024-12-04,9189
1595,川寶,12,3,9,群益金鼎-桃園,2024-12-04,9189
3163,波若威,29,21,8,群益金鼎-桃園,2024-12-04,9189
6173,信昌電,10,2,8,群益金鼎-桃園,2024-12-04,9189
3380,明泰,14,6,8,群益金鼎-桃園,2024-12-04,9189
3712,永崴投控,10,2,8,群益金鼎-桃園,2024-12-04,9189
00915,凱基優選高股息30,9,2,7,群益金鼎-桃園,2024-12-04,9189
00950B,凱基A級公司債,13,6,7,群益金鼎-桃園,2024-12-04,9189
4956,光鋐,12,5,7,群益金鼎-桃園,2024-12-04,9189
4927,泰鼎-KY,9,2,7,群益金鼎-桃園,2024-12-04,9189
2402,毅嘉,7,0,7,群益金鼎-桃園,2024-12-04,9189
2637,慧洋-KY,14,7,7,群益金鼎-桃園,2024-12-04,9189
6117,迎廣,7,1,6,群益金鼎-桃園,2024-12-04,9189
2486,一詮,10,4,6,群益金鼎-桃園,2024-12-04,9189
2474,可成,11,5,6,群益金鼎-桃園,2024-12-04,9189
00953B,群益優選非投等債,651,0,651,群益金鼎-桃園,2024-12-05,9189
00959B,大華投等美債15Y+,186,0,186,群益金鼎-桃園,2024-12-05,9189
00878,國泰永續高股息,112,5,107,群益金鼎-桃園,2024-12-05,9189
1815,富喬,218,119,99,群益金鼎-桃園,2024-12-05,9189
2891,中信金,104,16,88,群益金鼎-桃園,2024-12-05,9189
00637L,元大滬深300正2,72,16,56,群益金鼎-桃園,2024-12-05,9189
2444,兆勁,47,0,47,群益金鼎-桃園,2024-12-05,9189
2603,長榮,42,0,42,群益金鼎-桃園,2024-12-05,9189
3090,日電貿,90,51,39,群益金鼎-桃園,2024-12-05,9189
3483,力致,24,0,24,群益金鼎-桃園,2024-12-05,9189
2392,正崴,72,48,24,群益金鼎-桃園,2024-12-05,9189
4576,大銀微系統,24,2,22,群益金鼎-桃園,2024-12-05,9189
2929,淘帝-KY,21,0,21,群益金鼎-桃園,2024-12-05,9189
2375,凱美,114,94,20,群益金鼎-桃園,2024-12-05,9189
00919,群益台灣精選高息,26,6,20,群益金鼎-桃園,2024-12-05,9189
3015,全漢,24,6,18,群益金鼎-桃園,2024-12-05,9189
00715L,期街口布蘭特正2,36,20,16,群益金鼎-桃園,2024-12-05,9189
5328,華容,57,41,16,群益金鼎-桃園,2024-12-05,9189
2337,旺宏,15,0,15,群益金鼎-桃園,2024-12-05,9189
2472,立隆電,24,9,15,群益金鼎-桃園,2024-12-05,9189
00918,大華優利高填息30,28,13,15,群益金鼎-桃園,2024-12-05,9189
4510,高鋒,16,2,14,群益金鼎-桃園,2024-12-05,9189
3540,曜越,14,0,14,群益金鼎-桃園,2024-12-05,9189
1326,台化,13,0,13,群益金鼎-桃園,2024-12-05,9189
3625,西勝,17,4,13,群益金鼎-桃園,2024-12-05,9189
2317,鴻海,18,6,12,群益金鼎-桃園,2024-12-05,9189
5469,瀚宇博,12,0,12,群益金鼎-桃園,2024-12-05,9189
5371,中光電,17,6,11,群益金鼎-桃園,2024-12-05,9189
00713,元大台灣高息低波,10,0,10,群益金鼎-桃園,2024-12-05,9189
00907,永豐優息存股,10,0,10,群益金鼎-桃園,2024-12-05,9189
00930,永豐ESG低碳高息,10,0,10,群益金鼎-桃園,2024-12-05,9189
2344,華邦電,10,0,10,群益金鼎-桃園,2024-12-05,9189
00650L,復華香港正2,45,35,10,群益金鼎-桃園,2024-12-05,9189
3047,訊舟,10,0,10,群益金鼎-桃園,2024-12-05,9189
3003,健和興,10,1,9,群益金鼎-桃園,2024-12-05,9189
00770,國泰北美科技,9,0,9,群益金鼎-桃園,2024-12-05,9189
2102,泰豐,9,0,9,群益金鼎-桃園,2024-12-05,9189
5315,光聯,10,1,9,群益金鼎-桃園,2024-12-05,9189
00926,凱基全球菁英55,9,0,9,群益金鼎-桃園,2024-12-05,9189
9105,泰金寶-DR,21,13,8,群益金鼎-桃園,2024-12-05,9189
2204,中華,12,4,8,群益金鼎-桃園,2024-12-05,9189
1402,遠東新,8,0,8,群益金鼎-桃園,2024-12-05,9189
2399,映泰,18,10,8,群益金鼎-桃園,2024-12-05,9189
1303,南亞,7,0,7,群益金鼎-桃園,2024-12-05,9189
1316,上曜,7,0,7,群益金鼎-桃園,2024-12-05,9189
0056,元大高股息,14,7,7,群益金鼎-桃園,2024-12-05,9189
1504,東元,7,0,7,群益金鼎-桃園,2024-12-05,9189
8261,富鼎,9,2,7,群益金鼎-桃園,2024-12-05,9189
1597,直得,8,1,7,群益金鼎-桃園,2024-12-05,9189
3290,東浦,7,0,7,群益金鼎-桃園,2024-12-05,9189
00953B,群益優選非投等債,1018,0,1018,群益金鼎-桃園,2024-12-06,9189
3706,神達,405,290,115,群益金鼎-桃園,2024-12-06,9189
2002,中鋼,109,0,109,群益金鼎-桃園,2024-12-06,9189
00915,凱基優選高股息30,66,0,66,群益金鼎-桃園,2024-12-06,9189
2891,中信金,62,4,58,群益金鼎-桃園,2024-12-06,9189
3303,岱稜,47,0,47,群益金鼎-桃園,2024-12-06,9189
00918,大華優利高填息30,48,2,46,群益金鼎-桃園,2024-12-06,9189
00919,群益台灣精選高息,54,9,45,群益金鼎-桃園,2024-12-06,9189
6223,旺矽,50,6,44,群益金鼎-桃園,2024-12-06,9189
00715L,期街口布蘭特正2,31,0,31,群益金鼎-桃園,2024-12-06,9189
8070,長華*,31,1,30,群益金鼎-桃園,2024-12-06,9189
1504,東元,32,2,30,群益金鼎-桃園,2024-12-06,9189
2486,一詮,27,0,27,群益金鼎-桃園,2024-12-06,9189
3323,加百裕,69,44,25,群益金鼎-桃園,2024-12-06,9189
00951,台新日本半導體,20,0,20,群益金鼎-桃園,2024-12-06,9189
2809,京城銀,20,0,20,群益金鼎-桃園,2024-12-06,9189
1605,華新,41,21,20,群益金鼎-桃園,2024-12-06,9189
2102,泰豐,21,2,19,群益金鼎-桃園,2024-12-06,9189
0056,元大高股息,22,4,18,群益金鼎-桃園,2024-12-06,9189
1815,富喬,36,18,18,群益金鼎-桃園,2024-12-06,9189
2337,旺宏,21,3,18,群益金鼎-桃園,2024-12-06,9189
2354,鴻準,100,84,16,群益金鼎-桃園,2024-12-06,9189
00937B,群益ESG投等債20,20,5,15,群益金鼎-桃園,2024-12-06,9189
6116,彩晶,15,0,15,群益金鼎-桃園,2024-12-06,9189
00926,凱基全球菁英55,15,0,15,群益金鼎-桃園,2024-12-06,9189
6163,華電網,14,0,14,群益金鼎-桃園,2024-12-06,9189
4755,三福化,14,0,14,群益金鼎-桃園,2024-12-06,9189
00922,國泰台灣領袖50,13,1,12,群益金鼎-桃園,2024-12-06,9189
00712,復華富時不動產,11,0,11,群益金鼎-桃園,2024-12-06,9189
00959B,大華投等美債15Y+,11,0,11,群益金鼎-桃園,2024-12-06,9189
6530,創威,10,0,10,群益金鼎-桃園,2024-12-06,9189
2429,銘旺科,10,0,10,群益金鼎-桃園,2024-12-06,9189
00957B,兆豐US優選投等債,10,0,10,群益金鼎-桃園,2024-12-06,9189
1402,遠東新,10,0,10,群益金鼎-桃園,2024-12-06,9189
00905,FT臺灣Smart,10,0,10,群益金鼎-桃園,2024-12-06,9189
6546,正基,11,1,10,群益金鼎-桃園,2024-12-06,9189
8044,網家,10,0,10,群益金鼎-桃園,2024-12-06,9189
2365,昆盈,13,3,10,群益金鼎-桃園,2024-12-06,9189
00770,國泰北美科技,9,0,9,群益金鼎-桃園,2024-12-06,9189
00909,國泰數位支付服務,9,0,9,群益金鼎-桃園,2024-12-06,9189
6757,台灣虎航,28,19,9,群益金鼎-桃園,2024-12-06,9189
2303,聯電,10,1,9,群益金鼎-桃園,2024-12-06,9189
1455,集盛,8,0,8,群益金鼎-桃園,2024-12-06,9189
6257,矽格,11,3,8,群益金鼎-桃園,2024-12-06,9189
5439,高技,12,4,8,群益金鼎-桃園,2024-12-06,9189
2449,京元電子,9,1,8,群益金鼎-桃園,2024-12-06,9189
2344,華邦電,14,6,8,群益金鼎-桃園,2024-12-06,9189
00907,永豐優息存股,7,0,7,群益金鼎-桃園,2024-12-06,9189
00887,永豐中國科技50大,20,13,7,群益金鼎-桃園,2024-12-06,9189
2356,英業達,7,0,7,群益金鼎-桃園,2024-12-06,9189
00953B,群益優選非投等債,589,0,589,群益金鼎-桃園,2024-12-09,9189
00715L,期街口布蘭特正2,111,23,88,群益金鼎-桃園,2024-12-09,9189
3625,西勝,90,3,87,群益金鼎-桃園,2024-12-09,9189
00945B,凱基美國非投等債,82,0,82,群益金鼎-桃園,2024-12-09,9189
6505,台塑化,60,0,60,群益金鼎-桃園,2024-12-09,9189
2891,中信金,60,2,58,群益金鼎-桃園,2024-12-09,9189
00878,國泰永續高股息,58,1,57,群益金鼎-桃園,2024-12-09,9189
6962,ITH-KY,48,3,45,群益金鼎-桃園,2024-12-09,9189
1449,佳和,55,12,43,群益金鼎-桃園,2024-12-09,9189
5243,乙盛-KY,40,0,40,群益金鼎-桃園,2024-12-09,9189
00951,台新日本半導體,40,0,40,群益金鼎-桃園,2024-12-09,9189
00900,富邦特選高股息30,39,4,35,群益金鼎-桃園,2024-12-09,9189
2495,普安,35,0,35,群益金鼎-桃園,2024-12-09,9189
2317,鴻海,30,4,26,群益金鼎-桃園,2024-12-09,9189
2883,凱基金,30,6,24,群益金鼎-桃園,2024-12-09,9189
2471,資通,73,49,24,群益金鼎-桃園,2024-12-09,9189
00918,大華優利高填息30,25,1,24,群益金鼎-桃園,2024-12-09,9189
6153,嘉聯益,23,0,23,群益金鼎-桃園,2024-12-09,9189
1595,川寶,27,4,23,群益金鼎-桃園,2024-12-09,9189
1711,永光,23,0,23,群益金鼎-桃園,2024-12-09,9189
6757,台灣虎航,42,20,22,群益金鼎-桃園,2024-12-09,9189
3047,訊舟,20,0,20,群益金鼎-桃園,2024-12-09,9189
4401,東隆興,20,0,20,群益金鼎-桃園,2024-12-09,9189
2385,群光,19,0,19,群益金鼎-桃園,2024-12-09,9189
1326,台化,19,1,18,群益金鼎-桃園,2024-12-09,9189
8121,越峰,18,0,18,群益金鼎-桃園,2024-12-09,9189
2408,南亞科,20,3,17,群益金鼎-桃園,2024-12-09,9189
9105,泰金寶-DR,28,11,17,群益金鼎-桃園,2024-12-09,9189
2002,中鋼,21,4,17,群益金鼎-桃園,2024-12-09,9189
3211,順達,20,4,16,群益金鼎-桃園,2024-12-09,9189
2312,金寶,26,10,16,群益金鼎-桃園,2024-12-09,9189
2449,京元電子,18,3,15,群益金鼎-桃園,2024-12-09,9189
2102,泰豐,15,0,15,群益金鼎-桃園,2024-12-09,9189
1708,東鹼,16,2,14,群益金鼎-桃園,2024-12-09,9189
3090,日電貿,36,22,14,群益金鼎-桃園,2024-12-09,9189
2436,偉詮電,22,9,13,群益金鼎-桃園,2024-12-09,9189
3062,建漢,13,1,12,群益金鼎-桃園,2024-12-09,9189
1584,精剛,11,0,11,群益金鼎-桃園,2024-12-09,9189
2387,精元,11,0,11,群益金鼎-桃園,2024-12-09,9189
3622,洋華,12,1,11,群益金鼎-桃園,2024-12-09,9189
1402,遠東新,11,0,11,群益金鼎-桃園,2024-12-09,9189
6278,台表科,12,1,11,群益金鼎-桃園,2024-12-09,9189
1815,富喬,32,21,11,群益金鼎-桃園,2024-12-09,9189
8028,昇陽半導體,16,5,11,群益金鼎-桃園,2024-12-09,9189
1308,亞聚,10,0,10,群益金鼎-桃園,2024-12-09,9189
1101,台泥,10,0,10,群益金鼎-桃園,2024-12-09,9189
00960,野村全球航運龍頭,10,0,10,群益金鼎-桃園,2024-12-09,9189
3055,蔚華科,10,0,10,群益金鼎-桃園,2024-12-09,9189
8942,森鉅,10,0,10,群益金鼎-桃園,2024-12-09,9189
6770,力積電,17,7,10,群益金鼎-桃園,2024-12-09,9189
2883,凱基金,60,0,60,群益金鼎-桃園,2024-12-10,9189
00909,國泰數位支付服務,58,0,58,群益金鼎-桃園,2024-12-10,9189
00878,國泰永續高股息,61,6,55,群益金鼎-桃園,2024-12-10,9189
00953B,群益優選非投等債,38,0,38,群益金鼎-桃園,2024-12-10,9189
1605,華新,60,23,37,群益金鼎-桃園,2024-12-10,9189
3664,安瑞-KY,33,0,33,群益金鼎-桃園,2024-12-10,9189
3625,西勝,32,0,32,群益金鼎-桃園,2024-12-10,9189
3706,神達,129,99,30,群益金鼎-桃園,2024-12-10,9189
00715L,期街口布蘭特正2,30,0,30,群益金鼎-桃園,2024-12-10,9189
8163,達方,30,0,30,群益金鼎-桃園,2024-12-10,9189
00939,統一台灣高息動能,27,0,27,群益金鼎-桃園,2024-12-10,9189
2354,鴻準,32,6,26,群益金鼎-桃園,2024-12-10,9189
2317,鴻海,27,3,24,群益金鼎-桃園,2024-12-10,9189
00918,大華優利高填息30,23,0,23,群益金鼎-桃園,2024-12-10,9189
2353,宏��,21,0,21,群益金鼎-桃園,2024-12-10,9189
4933,友輝,22,1,21,群益金鼎-桃園,2024-12-10,9189
00915,凱基優選高股息30,20,0,20,群益金鼎-桃園,2024-12-10,9189
1449,佳和,49,29,20,群益金鼎-桃園,2024-12-10,9189
3303,岱稜,20,0,20,群益金鼎-桃園,2024-12-10,9189
6752,叡揚,27,12,15,群益金鼎-桃園,2024-12-10,9189
2330,台積電,14,0,14,群益金鼎-桃園,2024-12-10,9189
5439,高技,20,7,13,群益金鼎-桃園,2024-12-10,9189
2374,佳能,16,3,13,群益金鼎-桃園,2024-12-10,9189
2363,矽統,33,20,13,群益金鼎-桃園,2024-12-10,9189
2382,廣達,17,5,12,群益金鼎-桃園,2024-12-10,9189
3037,欣興,12,0,12,群益金鼎-桃園,2024-12-10,9189
1504,東元,14,2,12,群益金鼎-桃園,2024-12-10,9189
2303,聯電,12,0,12,群益金鼎-桃園,2024-12-10,9189
2646,星宇航空,15,3,12,群益金鼎-桃園,2024-12-10,9189
1309,台達化,12,0,12,群益金鼎-桃園,2024-12-10,9189
1584,精剛,12,0,12,群益金鼎-桃園,2024-12-10,9189
1710,東聯,12,0,12,群益金鼎-桃園,2024-12-10,9189
2618,長榮航,16,4,12,群益金鼎-桃園,2024-12-10,9189
00943,兆豐電子高息等權,11,0,11,群益金鼎-桃園,2024-12-10,9189
6223,旺矽,12,1,11,群益金鼎-桃園,2024-12-10,9189
6127,九豪,19,9,10,群益金鼎-桃園,2024-12-10,9189
5388,中磊,10,0,10,群益金鼎-桃園,2024-12-10,9189
2323,中環,10,0,10,群益金鼎-桃園,2024-12-10,9189
2801,彰銀,10,0,10,群益金鼎-桃園,2024-12-10,9189
2538,基泰,10,0,10,群益金鼎-桃園,2024-12-10,9189
6016,康和證,10,0,10,群益金鼎-桃園,2024-12-10,9189
8234,新漢,12,2,10,群益金鼎-桃園,2024-12-10,9189
2328,廣宇,10,0,10,群益金鼎-桃園,2024-12-10,9189
1457,宜進,10,0,10,群益金鼎-桃園,2024-12-10,9189
9105,泰金寶-DR,21,11,10,群益金鼎-桃園,2024-12-10,9189
6669,緯穎,10,0,10,群益金鼎-桃園,2024-12-10,9189
2301,光寶科,12,3,9,群益金鼎-桃園,2024-12-10,9189
6180,橘子,12,3,9,群益金鼎-桃園,2024-12-10,9189
2515,中工,10,1,9,群益金鼎-桃園,2024-12-10,9189
6664,群翊,9,0,9,群益金鼎-桃園,2024-12-10,9189
00937B,群益ESG投等債20,216,0,216,群益金鼎-桃園,2024-12-11,9189
00919,群益台灣精選高息,78,0,78,群益金鼎-桃園,2024-12-11,9189
00637L,元大滬深300正2,97,25,72,群益金鼎-桃園,2024-12-11,9189
00918,大華優利高填息30,67,0,67,群益金鼎-桃園,2024-12-11,9189
2317,鴻海,60,5,55,群益金鼎-桃園,2024-12-11,9189
2801,彰銀,50,0,50,群益金鼎-桃園,2024-12-11,9189
2609,陽明,57,20,37,群益金鼎-桃園,2024-12-11,9189
2303,聯電,37,0,37,群益金鼎-桃園,2024-12-11,9189
2408,南亞科,44,9,35,群益金鼎-桃園,2024-12-11,9189
1449,佳和,32,1,31,群益金鼎-桃園,2024-12-11,9189
2382,廣達,31,2,29,群益金鼎-桃園,2024-12-11,9189
2388,威盛,29,3,26,群益金鼎-桃園,2024-12-11,9189
1802,台玻,31,6,25,群益金鼎-桃園,2024-12-11,9189
8926,台汽電,20,0,20,群益金鼎-桃園,2024-12-11,9189
1595,川寶,23,3,20,群益金鼎-桃園,2024-12-11,9189
6695,芯鼎,53,33,20,群益金鼎-桃園,2024-12-11,9189
9934,成霖,20,0,20,群益金鼎-桃園,2024-12-11,9189
2031,新光鋼,20,0,20,群益金鼎-桃園,2024-12-11,9189
00932,兆豐永續高息等權,19,0,19,群益金鼎-桃園,2024-12-11,9189
2646,星宇航空,20,1,19,群益金鼎-桃園,2024-12-11,9189
00878,國泰永續高股息,20,2,18,群益金鼎-桃園,2024-12-11,9189
1540,喬福,23,5,18,群益金鼎-桃園,2024-12-11,9189
6770,力積電,28,12,16,群益金鼎-桃園,2024-12-11,9189
3664,安瑞-KY,16,0,16,群益金鼎-桃園,2024-12-11,9189
2066,世德,15,0,15,群益金鼎-桃園,2024-12-11,9189
1312,國喬,15,0,15,群益金鼎-桃園,2024-12-11,9189
2603,長榮,16,2,14,群益金鼎-桃園,2024-12-11,9189
2423,固緯,53,39,14,群益金鼎-桃園,2024-12-11,9189
6517,保勝光學,13,0,13,群益金鼎-桃園,2024-12-11,9189
2886,兆豐金,13,0,13,群益金鼎-桃園,2024-12-11,9189
2412,中華電,13,0,13,群益金鼎-桃園,2024-12-11,9189
00940,元大台灣價值高息,12,0,12,群益金鼎-桃園,2024-12-11,9189
0056,元大高股息,11,0,11,群益金鼎-桃園,2024-12-11,9189
00881,國泰台灣5G+,11,0,11,群益金鼎-桃園,2024-12-11,9189
00650L,復華香港正2,10,0,10,群益金鼎-桃園,2024-12-11,9189
3211,順達,18,8,10,群益金鼎-桃園,2024-12-11,9189
00951,台新日本半導體,10,0,10,群益金鼎-桃園,2024-12-11,9189
3231,緯創,11,1,10,群益金鼎-桃園,2024-12-11,9189
2891,中信金,12,2,10,群益金鼎-桃園,2024-12-11,9189
3483,力致,10,0,10,群益金鼎-桃園,2024-12-11,9189
00655L,國泰中國A50正2,10,0,10,群益金鼎-桃園,2024-12-11,9189
2618,長榮航,19,9,10,群益金鼎-桃園,2024-12-11,9189
2106,建大,10,0,10,群益金鼎-桃園,2024-12-11,9189
00676R,富邦臺灣加權反1,10,0,10,群益金鼎-桃園,2024-12-11,9189
6752,叡揚,31,21,10,群益金鼎-桃園,2024-12-11,9189
6139,亞翔,11,1,10,群益金鼎-桃園,2024-12-11,9189
1727,中華化,14,5,9,群益金鼎-桃園,2024-12-11,9189
1413,宏洲,9,0,9,群益金鼎-桃園,2024-12-11,9189
4931,新盛力,43,34,9,群益金鼎-桃園,2024-12-11,9189
2344,華邦電,14,5,9,群益金鼎-桃園,2024-12-11,9189
00959B,大華投等美債15Y+,321,0,321,群益金鼎-桃園,2024-12-12,9189
00680L,元大美債20正2,186,2,184,群益金鼎-桃園,2024-12-12,9189
00937B,群益ESG投等債20,188,6,182,群益金鼎-桃園,2024-12-12,9189
2883,凱基金,103,27,76,群益金鼎-桃園,2024-12-12,9189
2303,聯電,61,3,58,群益金鼎-桃園,2024-12-12,9189
00918,大華優利高填息30,58,1,57,群益金鼎-桃園,2024-12-12,9189
1101,台泥,50,0,50,群益金鼎-桃園,2024-12-12,9189
00687B,國泰20年美債,49,3,46,群益金鼎-桃園,2024-12-12,9189
2002,中鋼,43,1,42,群益金鼎-桃園,2024-12-12,9189
00919,群益台灣精選高息,43,2,41,群益金鼎-桃園,2024-12-12,9189
00915,凱基優選高股息30,42,2,40,群益金鼎-桃園,2024-12-12,9189
2317,鴻海,44,8,36,群益金鼎-桃園,2024-12-12,9189
00673R,期元大S＆P原油反1,35,0,35,群益金鼎-桃園,2024-12-12,9189
00713,元大台灣高息低波,30,0,30,群益金鼎-桃園,2024-12-12,9189
3706,神達,133,104,29,群益金鼎-桃園,2024-12-12,9189
6213,聯茂,25,0,25,群益金鼎-桃園,2024-12-12,9189
3338,泰碩,21,0,21,群益金鼎-桃園,2024-12-12,9189
2312,金寶,28,7,21,群益金鼎-桃園,2024-12-12,9189
00942B,台新美A公司債20+,20,0,20,群益金鼎-桃園,2024-12-12,9189
3710,連展投控,20,0,20,群益金鼎-桃園,2024-12-12,9189
3055,蔚華科,20,0,20,群益金鼎-桃園,2024-12-12,9189
00887,永豐中國科技50大,20,0,20,群益金鼎-桃園,2024-12-12,9189
2609,陽明,34,15,19,群益金鼎-桃園,2024-12-12,9189
1326,台化,33,16,17,群益金鼎-桃園,2024-12-12,9189
6142,友勁,15,0,15,群益金鼎-桃園,2024-12-12,9189
00953B,群益優選非投等債,15,0,15,群益金鼎-桃園,2024-12-12,9189
00945B,凱基美國非投等債,15,0,15,群益金鼎-桃園,2024-12-12,9189
2324,仁寶,14,1,13,群益金鼎-桃園,2024-12-12,9189
1413,宏洲,13,0,13,群益金鼎-桃園,2024-12-12,9189
1504,東元,13,0,13,群益金鼎-桃園,2024-12-12,9189
00948B,中信優息投資級債,11,0,11,群益金鼎-桃園,2024-12-12,9189
3032,偉訓,24,13,11,群益金鼎-桃園,2024-12-12,9189
3231,緯創,10,0,10,群益金鼎-桃園,2024-12-12,9189
00679B,元大美債20年,121,111,10,群益金鼎-桃園,2024-12-12,9189
4956,光鋐,10,0,10,群益金鼎-桃園,2024-12-12,9189
2352,佳世達,10,0,10,群益金鼎-桃園,2024-12-12,9189
4510,高鋒,18,8,10,群益金鼎-桃園,2024-12-12,9189
0061,元大寶滬深,10,0,10,群益金鼎-桃園,2024-12-12,9189
8933,愛地雅,9,0,9,群益金鼎-桃園,2024-12-12,9189
6005,群益證,10,1,9,群益金鼎-桃園,2024-12-12,9189
2637,慧洋-KY,10,1,9,群益金鼎-桃園,2024-12-12,9189
1785,光洋科,12,3,9,群益金鼎-桃園,2024-12-12,9189
1711,永光,9,0,9,群益金鼎-桃園,2024-12-12,9189
9105,泰金寶-DR,15,6,9,群益金鼎-桃園,2024-12-12,9189
2382,廣達,9,0,9,群益金鼎-桃園,2024-12-12,9189
2520,冠德,8,0,8,群益金鼎-桃園,2024-12-12,9189
2388,威盛,12,4,8,群益金鼎-桃園,2024-12-12,9189
6585,鼎基,8,0,8,群益金鼎-桃園,2024-12-12,9189
00830,國泰費城半導體,9,1,8,群益金鼎-桃園,2024-12-12,9189
3037,欣興,14,6,8,群益金鼎-桃園,2024-12-12,9189
00937B,群益ESG投等債20,236,10,226,群益金鼎-桃園,2024-12-13,9189
00959B,大華投等美債15Y+,224,0,224,群益金鼎-桃園,2024-12-13,9189
00680L,元大美債20正2,130,0,130,群益金鼎-桃園,2024-12-13,9189
00637L,元大滬深300正2,153,25,128,群益金鼎-桃園,2024-12-13,9189
2324,仁寶,108,0,108,群益金鼎-桃園,2024-12-13,9189
2883,凱基金,104,0,104,群益金鼎-桃園,2024-12-13,9189
00922,國泰台灣領袖50,71,0,71,群益金鼎-桃園,2024-12-13,9189
00919,群益台灣精選高息,67,0,67,群益金鼎-桃園,2024-12-13,9189
1589,永冠-KY,57,0,57,群益金鼎-桃園,2024-12-13,9189
2303,聯電,73,23,50,群益金鼎-桃園,2024-12-13,9189
2317,鴻海,58,11,47,群益金鼎-桃園,2024-12-13,9189
00918,大華優利高填息30,75,32,43,群益金鼎-桃園,2024-12-13,9189
00909,國泰數位支付服務,41,3,38,群益金鼎-桃園,2024-12-13,9189
00687B,國泰20年美債,35,0,35,群益金鼎-桃園,2024-12-13,9189
3694,海華,37,5,32,群益金鼎-桃園,2024-12-13,9189
00878,國泰永續高股息,30,0,30,群益金鼎-桃園,2024-12-13,9189
8121,越峰,28,0,28,群益金鼎-桃園,2024-12-13,9189
8111,立��,38,14,24,群益金鼎-桃園,2024-12-13,9189
3037,欣興,24,1,23,群益金鼎-桃園,2024-12-13,9189
3706,神達,80,58,22,群益金鼎-桃園,2024-12-13,9189
6153,嘉聯益,22,0,22,群益金鼎-桃園,2024-12-13,9189
0056,元大高股息,22,0,22,群益金鼎-桃園,2024-12-13,9189
1326,台化,22,0,22,群益金鼎-桃園,2024-12-13,9189
2002,中鋼,21,0,21,群益金鼎-桃園,2024-12-13,9189
00713,元大台灣高息低波,21,0,21,群益金鼎-桃園,2024-12-13,9189
00679B,元大美債20年,20,0,20,群益金鼎-桃園,2024-12-13,9189
6142,友勁,20,0,20,群益金鼎-桃園,2024-12-13,9189
1584,精剛,20,0,20,群益金鼎-桃園,2024-12-13,9189
8249,菱光,20,0,20,群益金鼎-桃園,2024-12-13,9189
00673R,期元大S＆P原油反1,19,0,19,群益金鼎-桃園,2024-12-13,9189
2423,固緯,118,100,18,群益金鼎-桃園,2024-12-13,9189
3032,偉訓,19,1,18,群益金鼎-桃園,2024-12-13,9189
2382,廣達,17,0,17,群益金鼎-桃園,2024-12-13,9189
1220,台榮,16,0,16,群益金鼎-桃園,2024-12-13,9189
2313,華通,19,4,15,群益金鼎-桃園,2024-12-13,9189
00930,永豐ESG低碳高息,15,0,15,群益金鼎-桃園,2024-12-13,9189
6005,群益證,25,10,15,群益金鼎-桃園,2024-12-13,9189
1609,大亞,15,0,15,群益金鼎-桃園,2024-12-13,9189
5309,系統電,55,41,14,群益金鼎-桃園,2024-12-13,9189
00952,凱基台灣AI50,15,1,14,群益金鼎-桃園,2024-12-13,9189
5483,中美晶,16,3,13,群益金鼎-桃園,2024-12-13,9189
8255,朋程,12,0,12,群益金鼎-桃園,2024-12-13,9189
2886,兆豐金,12,0,12,群益金鼎-桃園,2024-12-13,9189
2515,中工,12,0,12,群益金鼎-桃園,2024-12-13,9189
2338,光罩,12,0,12,群益金鼎-桃園,2024-12-13,9189
2610,華航,33,21,12,群益金鼎-桃園,2024-12-13,9189
2352,佳世達,11,0,11,群益金鼎-桃園,2024-12-13,9189
00931B,統一美債20年,11,0,11,群益金鼎-桃園,2024-12-13,9189
1522,堤維西,12,1,11,群益金鼎-桃園,2024-12-13,9189
2301,光寶科,11,1,10,群益金鼎-桃園,2024-12-13,9189
00959B,大華投等美債15Y+,502,0,502,群益金鼎-桃園,2024-12-16,9189
00937B,群益ESG投等債20,267,48,219,群益金鼎-桃園,2024-12-16,9189
9105,泰金寶-DR,260,100,160,群益金鼎-桃園,2024-12-16,9189
6505,台塑化,60,1,59,群益金鼎-桃園,2024-12-16,9189
2609,陽明,163,110,53,群益金鼎-桃園,2024-12-16,9189
6005,群益證,75,25,50,群益金鼎-桃園,2024-12-16,9189
00918,大華優利高填息30,43,0,43,群益金鼎-桃園,2024-12-16,9189
00915,凱基優選高股息30,47,4,43,群益金鼎-桃園,2024-12-16,9189
00878,國泰永續高股息,55,13,42,群益金鼎-桃園,2024-12-16,9189
00679B,元大美債20年,39,0,39,群益金鼎-桃園,2024-12-16,9189
00673R,期元大S＆P原油反1,38,0,38,群益金鼎-桃園,2024-12-16,9189
00680L,元大美債20正2,36,0,36,群益金鼎-桃園,2024-12-16,9189
00919,群益台灣精選高息,38,8,30,群益金鼎-桃園,2024-12-16,9189
00687B,國泰20年美債,29,1,28,群益金鼎-桃園,2024-12-16,9189
00751B,元大AAA至A公司債,27,0,27,群益金鼎-桃園,2024-12-16,9189
3706,神達,71,48,23,群益金鼎-桃園,2024-12-16,9189
2002,中鋼,22,1,21,群益金鼎-桃園,2024-12-16,9189
2356,英業達,21,0,21,群益金鼎-桃園,2024-12-16,9189
0056,元大高股息,20,0,20,群益金鼎-桃園,2024-12-16,9189
00945B,凱基美國非投等債,20,0,20,群益金鼎-桃園,2024-12-16,9189
8234,新漢,20,0,20,群益金鼎-桃園,2024-12-16,9189
5880,合庫金,20,0,20,群益金鼎-桃園,2024-12-16,9189
2637,慧洋-KY,19,0,19,群益金鼎-桃園,2024-12-16,9189
00933B,國泰10Y+金融債,19,0,19,群益金鼎-桃園,2024-12-16,9189
2423,固緯,110,92,18,群益金鼎-桃園,2024-12-16,9189
00940,元大台灣價值高息,89,71,18,群益金鼎-桃園,2024-12-16,9189
00946,群益科技高息成長,24,10,14,群益金鼎-桃園,2024-12-16,9189
3260,威剛,20,6,14,群益金鼎-桃園,2024-12-16,9189
3363,上詮,27,13,14,群益金鼎-桃園,2024-12-16,9189
6414,樺漢,15,1,14,群益金鼎-桃園,2024-12-16,9189
00637L,元大滬深300正2,39,26,13,群益金鼎-桃園,2024-12-16,9189
00909,國泰數位支付服務,15,2,13,群益金鼎-桃園,2024-12-16,9189
1326,台化,12,0,12,群益金鼎-桃園,2024-12-16,9189
2344,華邦電,16,4,12,群益金鼎-桃園,2024-12-16,9189
2615,萬海,11,0,11,群益金鼎-桃園,2024-12-16,9189
911608,明輝-DR,11,0,11,群益金鼎-桃園,2024-12-16,9189
6530,創威,11,0,11,群益金鼎-桃園,2024-12-16,9189
2359,所羅門,13,2,11,群益金鼎-桃園,2024-12-16,9189
1815,富喬,13,3,10,群益金鼎-桃園,2024-12-16,9189
6116,彩晶,10,0,10,群益金鼎-桃園,2024-12-16,9189
00882,中信中國高股息,10,0,10,群益金鼎-桃園,2024-12-16,9189
6122,擎邦,10,0,10,群益金鼎-桃園,2024-12-16,9189
1409,新纖,10,0,10,群益金鼎-桃園,2024-12-16,9189
8163,達方,10,0,10,群益金鼎-桃園,2024-12-16,9189
6285,啟��,11,1,10,群益金鼎-桃園,2024-12-16,9189
2337,旺宏,20,10,10,群益金鼎-桃園,2024-12-16,9189
2323,中環,10,0,10,群益金鼎-桃園,2024-12-16,9189
3450,聯鈞,37,28,9,群益金鼎-桃園,2024-12-16,9189
00632R,元大台灣50反1,22,13,9,群益金鼎-桃園,2024-12-16,9189
2354,鴻準,23,14,9,群益金鼎-桃園,2024-12-16,9189
00940,元大台灣價值高息,201,6,195,群益金鼎-桃園,2024-12-17,9189
00915,凱基優選高股息30,167,0,167,群益金鼎-桃園,2024-12-17,9189
00937B,群益ESG投等債20,137,0,137,群益金鼎-桃園,2024-12-17,9189
00637L,元大滬深300正2,215,88,127,群益金鼎-桃園,2024-12-17,9189
2883,凱基金,123,0,123,群益金鼎-桃園,2024-12-17,9189
3499,環天科,57,0,57,群益金鼎-桃園,2024-12-17,9189
00918,大華優利高填息30,56,0,56,群益金鼎-桃園,2024-12-17,9189
3706,神達,49,13,36,群益金鼎-桃園,2024-12-17,9189
00948B,中信優息投資級債,35,0,35,群益金鼎-桃園,2024-12-17,9189
00687B,國泰20年美債,28,0,28,群益金鼎-桃園,2024-12-17,9189
00713,元大台灣高息低波,28,0,28,群益金鼎-桃園,2024-12-17,9189
00933B,國泰10Y+金融債,27,0,27,群益金鼎-桃園,2024-12-17,9189
2002,中鋼,22,0,22,群益金鼎-桃園,2024-12-17,9189
00757,統一FANG+,20,0,20,群益金鼎-桃園,2024-12-17,9189
3481,群創,24,4,20,群益金鼎-桃園,2024-12-17,9189
00673R,期元大S＆P原油反1,20,0,20,群益金鼎-桃園,2024-12-17,9189
6244,茂迪,20,0,20,群益金鼎-桃園,2024-12-17,9189
2353,宏��,19,0,19,群益金鼎-桃園,2024-12-17,9189
3041,揚智,111,94,17,群益金鼎-桃園,2024-12-17,9189
2891,中信金,17,0,17,群益金鼎-桃園,2024-12-17,9189
2317,鴻海,20,3,17,群益金鼎-桃園,2024-12-17,9189
2881,富邦金,17,2,15,群益金鼎-桃園,2024-12-17,9189
2014,中鴻,15,0,15,群益金鼎-桃園,2024-12-17,9189
2882,國泰金,13,0,13,群益金鼎-桃園,2024-12-17,9189
1459,聯發,13,0,13,群益金鼎-桃園,2024-12-17,9189
2250,IKKA-KY,13,0,13,群益金鼎-桃園,2024-12-17,9189
2886,兆豐金,13,0,13,群益金鼎-桃園,2024-12-17,9189
4938,和碩,12,0,12,群益金鼎-桃園,2024-12-17,9189
0056,元大高股息,12,0,12,群益金鼎-桃園,2024-12-17,9189
00963,中信全球高股息,11,0,11,群益金鼎-桃園,2024-12-17,9189
1785,光洋科,15,4,11,群益金鼎-桃園,2024-12-17,9189
2545,皇翔,11,0,11,群益金鼎-桃園,2024-12-17,9189
6213,聯茂,13,2,11,群益金鼎-桃園,2024-12-17,9189
2423,固緯,16,6,10,群益金鼎-桃園,2024-12-17,9189
1409,新纖,10,0,10,群益金鼎-桃園,2024-12-17,9189
6152,百一,10,0,10,群益金鼎-桃園,2024-12-17,9189
4931,新盛力,20,10,10,群益金鼎-桃園,2024-12-17,9189
912000,晨訊科-DR,10,0,10,群益金鼎-桃園,2024-12-17,9189
6274,台燿,25,15,10,群益金鼎-桃園,2024-12-17,9189
6770,力積電,19,9,10,群益金鼎-桃園,2024-12-17,9189
00679B,元大美債20年,8,0,8,群益金鼎-桃園,2024-12-17,9189
2368,金像電,34,26,8,群益金鼎-桃園,2024-12-17,9189
00959B,大華投等美債15Y+,8,0,8,群益金鼎-桃園,2024-12-17,9189
2834,臺企銀,8,1,7,群益金鼎-桃園,2024-12-17,9189
8112,至上,7,0,7,群益金鼎-桃園,2024-12-17,9189
2801,彰銀,10,3,7,群益金鼎-桃園,2024-12-17,9189
3702,大聯大,7,0,7,群益金鼎-桃園,2024-12-17,9189
2845,遠東銀,8,1,7,群益金鼎-桃園,2024-12-17,9189
6127,九豪,7,0,7,群益金鼎-桃園,2024-12-17,9189
1504,東元,10,3,7,群益金鼎-桃園,2024-12-17,9189
00937B,群益ESG投等債20,231,6,225,群益金鼎-桃園,2024-12-18,9189
2903,遠百,158,0,158,群益金鼎-桃園,2024-12-18,9189
2886,兆豐金,104,6,98,群益金鼎-桃園,2024-12-18,9189
1815,富喬,90,22,68,群益金鼎-桃園,2024-12-18,9189
00918,大華優利高填息30,59,0,59,群益金鼎-桃園,2024-12-18,9189
00725B,國泰投資級公司債,55,0,55,群益金鼎-桃園,2024-12-18,9189
2891,中信金,59,4,55,群益金鼎-桃園,2024-12-18,9189
00680L,元大美債20正2,52,0,52,群益金鼎-桃園,2024-12-18,9189
2615,萬海,52,0,52,群益金鼎-桃園,2024-12-18,9189
00953B,群益優選非投等債,42,0,42,群益金鼎-桃園,2024-12-18,9189
9928,中視,40,0,40,群益金鼎-桃園,2024-12-18,9189
8111,立��,56,18,38,群益金鼎-桃園,2024-12-18,9189
3545,敦泰,40,11,29,群益金鼎-桃園,2024-12-18,9189
4562,穎漢,55,29,26,群益金鼎-桃園,2024-12-18,9189
00933B,國泰10Y+金融債,21,0,21,群益金鼎-桃園,2024-12-18,9189
6962,ITH-KY,32,12,20,群益金鼎-桃園,2024-12-18,9189
00909,國泰數位支付服務,21,2,19,群益金鼎-桃園,2024-12-18,9189
2618,長榮航,36,18,18,群益金鼎-桃園,2024-12-18,9189
2609,陽明,30,12,18,群益金鼎-桃園,2024-12-18,9189
2912,統一超,17,0,17,群益金鼎-桃園,2024-12-18,9189
00712,復華富時不動產,17,0,17,群益金鼎-桃園,2024-12-18,9189
1722,台肥,16,0,16,群益金鼎-桃園,2024-12-18,9189
8249,菱光,75,59,16,群益金鼎-桃園,2024-12-18,9189
2382,廣達,15,0,15,群益金鼎-桃園,2024-12-18,9189
3041,揚智,174,160,14,群益金鼎-桃園,2024-12-18,9189
2002,中鋼,13,0,13,群益金鼎-桃園,2024-12-18,9189
2637,慧洋-KY,13,0,13,群益金鼎-桃園,2024-12-18,9189
00713,元大台灣高息低波,13,0,13,群益金鼎-桃園,2024-12-18,9189
00915,凱基優選高股息30,13,0,13,群益金鼎-桃園,2024-12-18,9189
4927,泰鼎-KY,13,1,12,群益金鼎-桃園,2024-12-18,9189
00720B,元大投資級公司債,11,0,11,群益金鼎-桃園,2024-12-18,9189
3037,欣興,11,0,11,群益金鼎-桃園,2024-12-18,9189
2883,凱基金,15,5,10,群益金鼎-桃園,2024-12-18,9189
8403,盛弘,10,0,10,群益金鼎-桃園,2024-12-18,9189
00715L,期街口布蘭特正2,10,0,10,群益金鼎-桃園,2024-12-18,9189
2801,彰銀,10,0,10,群益金鼎-桃園,2024-12-18,9189
00688L,國泰20年美債正2,10,0,10,群益金鼎-桃園,2024-12-18,9189
2102,泰豐,10,0,10,群益金鼎-桃園,2024-12-18,9189
912000,晨訊科-DR,10,0,10,群益金鼎-桃園,2024-12-18,9189
2208,台船,10,0,10,群益金鼎-桃園,2024-12-18,9189
3055,蔚華科,10,0,10,群益金鼎-桃園,2024-12-18,9189
00878,國泰永續高股息,10,1,9,群益金鼎-桃園,2024-12-18,9189
2882,國泰金,10,0,10,群益金鼎-桃園,2024-12-18,9189
2881,富邦金,10,1,9,群益金鼎-桃園,2024-12-18,9189
5371,中光電,37,28,9,群益金鼎-桃園,2024-12-18,9189
2486,一詮,12,3,9,群益金鼎-桃園,2024-12-18,9189
8016,矽創,10,1,9,群益金鼎-桃園,2024-12-18,9189
3059,華晶科,17,9,8,群益金鼎-桃園,2024-12-18,9189
3152,璟德,8,0,8,群益金鼎-桃園,2024-12-18,9189
2634,漢翔,8,0,8,群益金鼎-桃園,2024-12-18,9189
00959B,大華投等美債15Y+,505,13,492,群益金鼎-桃園,2024-12-19,9189
00937B,群益ESG投等債20,196,1,195,群益金鼎-桃園,2024-12-19,9189
00919,群益台灣精選高息,193,60,133,群益金鼎-桃園,2024-12-19,9189
2892,第一金,112,0,112,群益金鼎-桃園,2024-12-19,9189
2365,昆盈,128,19,109,群益金鼎-桃園,2024-12-19,9189
2883,凱基金,113,4,109,群益金鼎-桃園,2024-12-19,9189
00680L,元大美債20正2,106,0,106,群益金鼎-桃園,2024-12-19,9189
00918,大華優利高填息30,74,0,74,群益金鼎-桃園,2024-12-19,9189
00753L,中信中國50正2,61,0,61,群益金鼎-桃園,2024-12-19,9189
00878,國泰永續高股息,64,4,60,群益金鼎-桃園,2024-12-19,9189
00646,元大S＆P500,54,0,54,群益金鼎-桃園,2024-12-19,9189
2603,長榮,57,4,53,群益金鼎-桃園,2024-12-19,9189
00687B,國泰20年美債,87,36,51,群益金鼎-桃園,2024-12-19,9189
00665L,富邦�琤肭磪囓�2,60,10,50,群益金鼎-桃園,2024-12-19,9189
911608,明輝-DR,49,0,49,群益金鼎-桃園,2024-12-19,9189
2355,敬鵬,45,0,45,群益金鼎-桃園,2024-12-19,9189
2845,遠東銀,43,1,42,群益金鼎-桃園,2024-12-19,9189
2344,華邦電,54,13,41,群益金鼎-桃園,2024-12-19,9189
2609,陽明,50,9,41,群益金鼎-桃園,2024-12-19,9189
2423,固緯,94,56,38,群益金鼎-桃園,2024-12-19,9189
3481,群創,36,0,36,群益金鼎-桃園,2024-12-19,9189
00712,復華富時不動產,35,0,35,群益金鼎-桃園,2024-12-19,9189
6770,力積電,35,0,35,群益金鼎-桃園,2024-12-19,9189
2886,兆豐金,58,25,33,群益金鼎-桃園,2024-12-19,9189
2912,統一超,33,0,33,群益金鼎-桃園,2024-12-19,9189
2801,彰銀,32,0,32,群益金鼎-桃園,2024-12-19,9189
2317,鴻海,35,6,29,群益金鼎-桃園,2024-12-19,9189
2891,中信金,29,2,27,群益金鼎-桃園,2024-12-19,9189
0056,元大高股息,21,0,21,群益金鼎-桃園,2024-12-19,9189
00942B,台新美A公司債20+,20,0,20,群益金鼎-桃園,2024-12-19,9189
912000,晨訊科-DR,20,0,20,群益金鼎-桃園,2024-12-19,9189
2002,中鋼,28,9,19,群益金鼎-桃園,2024-12-19,9189
3706,神達,43,24,19,群益金鼎-桃園,2024-12-19,9189
2618,長榮航,18,0,18,群益金鼎-桃園,2024-12-19,9189
2330,台積電,18,1,17,群益金鼎-桃園,2024-12-19,9189
2880,華南金,15,0,15,群益金鼎-桃園,2024-12-19,9189
2882,國泰金,15,0,15,群益金鼎-桃園,2024-12-19,9189
00951,台新日本半導體,15,0,15,群益金鼎-桃園,2024-12-19,9189
00650L,復華香港正2,15,0,15,群益金鼎-桃園,2024-12-19,9189
2367,燿華,19,4,15,群益金鼎-桃園,2024-12-19,9189
1504,東元,16,1,15,群益金鼎-桃園,2024-12-19,9189
00933B,國泰10Y+金融債,14,0,14,群益金鼎-桃園,2024-12-19,9189
1513,中興電,13,0,13,群益金鼎-桃園,2024-12-19,9189
2637,慧洋-KY,13,0,13,群益金鼎-桃園,2024-12-19,9189
00963,中信全球高股息,13,0,13,群益金鼎-桃園,2024-12-19,9189
00922,國泰台灣領袖50,13,0,13,群益金鼎-桃園,2024-12-19,9189
2409,友達,12,0,12,群益金鼎-桃園,2024-12-19,9189
8044,網家,14,2,12,群益金鼎-桃園,2024-12-19,9189
2371,大同,11,0,11,群益金鼎-桃園,2024-12-19,9189
2354,鴻準,23,12,11,群益金鼎-桃園,2024-12-19,9189
