Ticker,Name,buy,sell,diff,Branch,Date,Branch_Code
6472,保瑞,101,1,100,凱基-永和,2023-01-03,9207
3661,世芯-KY,53,1,52,凱基-永和,2023-01-03,9207
2867,三商壽,24,0,24,凱基-永和,2023-01-03,9207
2609,陽明,35,12,23,凱基-永和,2023-01-03,9207
3680,家登,20,0,20,凱基-永和,2023-01-03,9207
5457,宣德,20,0,20,凱基-永和,2023-01-03,9207
00885,富邦越南,18,0,18,凱基-永和,2023-01-03,9207
00915,凱基優選高股息30,10,0,10,凱基-永和,2023-01-03,9207
4111,濟生,10,0,10,凱基-永和,2023-01-03,9207
4133,亞諾法,11,1,10,凱基-永和,2023-01-03,9207
8415,大國鋼,10,0,10,凱基-永和,2023-01-03,9207
00878,國泰永續高股息,21,12,9,凱基-永和,2023-01-03,9207
2882,國泰金,9,0,9,凱基-永和,2023-01-03,9207
4121,優盛,11,3,8,凱基-永和,2023-01-03,9207
00637L,元大滬深300正2,9,2,7,凱基-永和,2023-01-03,9207
00632R,元大台灣50反1,20,13,7,凱基-永和,2023-01-03,9207
2888,新光金,7,1,6,凱基-永和,2023-01-03,9207
1101,台泥,6,0,6,凱基-永和,2023-01-03,9207
1605,華新,83,77,6,凱基-永和,2023-01-03,9207
2618,長榮航,6,0,6,凱基-永和,2023-01-03,9207
2723,美食-KY,7,1,6,凱基-永和,2023-01-03,9207
4102,永日,6,0,6,凱基-永和,2023-01-03,9207
6111,大宇資,11,5,6,凱基-永和,2023-01-03,9207
2317,鴻海,11,6,5,凱基-永和,2023-01-03,9207
2028,威致,5,0,5,凱基-永和,2023-01-03,9207
2332,友訊,5,0,5,凱基-永和,2023-01-03,9207
2881,富邦金,5,0,5,凱基-永和,2023-01-03,9207
5531,鄉林,5,0,5,凱基-永和,2023-01-03,9207
00679B,元大美債20年,4,0,4,凱基-永和,2023-01-03,9207
2371,大同,4,0,4,凱基-永和,2023-01-03,9207
2612,中航,4,0,4,凱基-永和,2023-01-03,9207
2614,東森,5,1,4,凱基-永和,2023-01-03,9207
4563,百德,6,2,4,凱基-永和,2023-01-03,9207
6477,安集,6,2,4,凱基-永和,2023-01-03,9207
0050,元大台灣50,3,0,3,凱基-永和,2023-01-03,9207
6180,橘子,5,2,3,凱基-永和,2023-01-03,9207
6568,宏觀,3,0,3,凱基-永和,2023-01-03,9207
00720B,元大投資級公司債,3,0,3,凱基-永和,2023-01-03,9207
1102,亞泥,3,0,3,凱基-永和,2023-01-03,9207
2201,裕隆,3,0,3,凱基-永和,2023-01-03,9207
3023,信邦,5,2,3,凱基-永和,2023-01-03,9207
8112,至上,3,0,3,凱基-永和,2023-01-03,9207
8938,明安,3,0,3,凱基-永和,2023-01-03,9207
9904,寶成,3,0,3,凱基-永和,2023-01-03,9207
2603,長榮,3,1,2,凱基-永和,2023-01-03,9207
1720,生達,2,0,2,凱基-永和,2023-01-03,9207
1783,和康生,2,0,2,凱基-永和,2023-01-03,9207
00895,富邦未來車,2,0,2,凱基-永和,2023-01-03,9207
00893,國泰智能電動車,2,0,2,凱基-永和,2023-01-03,9207
00772B,中信高評級公司債,2,0,2,凱基-永和,2023-01-03,9207
4162,智擎,100,2,98,凱基-永和,2023-01-04,9207
3037,欣興,48,12,36,凱基-永和,2023-01-04,9207
2867,三商壽,30,0,30,凱基-永和,2023-01-04,9207
6197,佳必琪,20,1,19,凱基-永和,2023-01-04,9207
2405,輔信,15,0,15,凱基-永和,2023-01-04,9207
00885,富邦越南,14,0,14,凱基-永和,2023-01-04,9207
3284,太普高,19,5,14,凱基-永和,2023-01-04,9207
2317,鴻海,18,7,11,凱基-永和,2023-01-04,9207
6235,華孚,11,0,11,凱基-永和,2023-01-04,9207
2007,燁興,10,0,10,凱基-永和,2023-01-04,9207
2425,承啟,10,0,10,凱基-永和,2023-01-04,9207
3661,世芯-KY,10,0,10,凱基-永和,2023-01-04,9207
8171,天宇,14,4,10,凱基-永和,2023-01-04,9207
8069,元太,13,4,9,凱基-永和,2023-01-04,9207
1701,中化,10,2,8,凱基-永和,2023-01-04,9207
2014,中鴻,9,1,8,凱基-永和,2023-01-04,9207
2329,華泰,8,0,8,凱基-永和,2023-01-04,9207
6541,泰福-KY,8,0,8,凱基-永和,2023-01-04,9207
8046,南電,8,1,7,凱基-永和,2023-01-04,9207
2609,陽明,8,1,7,凱基-永和,2023-01-04,9207
00637L,元大滬深300正2,16,10,6,凱基-永和,2023-01-04,9207
2028,威致,6,0,6,凱基-永和,2023-01-04,9207
6282,康舒,6,0,6,凱基-永和,2023-01-04,9207
3443,創意,6,0,6,凱基-永和,2023-01-04,9207
1513,中興電,23,18,5,凱基-永和,2023-01-04,9207
1717,長興,5,0,5,凱基-永和,2023-01-04,9207
3022,威強電,5,0,5,凱基-永和,2023-01-04,9207
3576,聯合再生,5,0,5,凱基-永和,2023-01-04,9207
4919,新唐,6,1,5,凱基-永和,2023-01-04,9207
6492,生華科,5,0,5,凱基-永和,2023-01-04,9207
9103,美德醫療-DR,5,0,5,凱基-永和,2023-01-04,9207
9904,寶成,5,0,5,凱基-永和,2023-01-04,9207
1618,合機,4,0,4,凱基-永和,2023-01-04,9207
2331,精英,4,0,4,凱基-永和,2023-01-04,9207
2498,宏達電,5,1,4,凱基-永和,2023-01-04,9207
2915,潤泰全,4,0,4,凱基-永和,2023-01-04,9207
3707,漢磊,4,0,4,凱基-永和,2023-01-04,9207
6462,神盾,4,0,4,凱基-永和,2023-01-04,9207
2615,萬海,4,0,4,凱基-永和,2023-01-04,9207
0056,元大高股息,4,0,4,凱基-永和,2023-01-04,9207
00683L,期元大美元指正2,3,0,3,凱基-永和,2023-01-04,9207
00720B,元大投資級公司債,3,0,3,凱基-永和,2023-01-04,9207
00772B,中信高評級公司債,3,0,3,凱基-永和,2023-01-04,9207
00915,凱基優選高股息30,3,0,3,凱基-永和,2023-01-04,9207
2465,麗臺,23,20,3,凱基-永和,2023-01-04,9207
3545,敦泰,3,0,3,凱基-永和,2023-01-04,9207
4114,健喬,5,2,3,凱基-永和,2023-01-04,9207
4155,訊映,3,0,3,凱基-永和,2023-01-04,9207
4566,時碩工業,3,0,3,凱基-永和,2023-01-04,9207
5907,大洋-KY,4,1,3,凱基-永和,2023-01-04,9207
2867,三商壽,80,0,80,凱基-永和,2023-01-05,9207
00632R,元大台灣50反1,30,0,30,凱基-永和,2023-01-05,9207
00633L,富邦上証正2,25,0,25,凱基-永和,2023-01-05,9207
3022,威強電,25,0,25,凱基-永和,2023-01-05,9207
4566,時碩工業,20,0,20,凱基-永和,2023-01-05,9207
8033,雷虎,22,6,16,凱基-永和,2023-01-05,9207
8996,高力,14,0,14,凱基-永和,2023-01-05,9207
00893,國泰智能電動車,10,0,10,凱基-永和,2023-01-05,9207
4960,誠美材,10,0,10,凱基-永和,2023-01-05,9207
6443,元晶,10,0,10,凱基-永和,2023-01-05,9207
4919,新唐,12,2,10,凱基-永和,2023-01-05,9207
3037,欣興,43,35,8,凱基-永和,2023-01-05,9207
2615,萬海,10,2,8,凱基-永和,2023-01-05,9207
00753L,中信中國50正2,11,4,7,凱基-永和,2023-01-05,9207
00683L,期元大美元指正2,7,0,7,凱基-永和,2023-01-05,9207
1417,嘉裕,6,0,6,凱基-永和,2023-01-05,9207
2617,台航,6,0,6,凱基-永和,2023-01-05,9207
2317,鴻海,15,9,6,凱基-永和,2023-01-05,9207
2454,聯發科,5,0,5,凱基-永和,2023-01-05,9207
1609,大亞,5,0,5,凱基-永和,2023-01-05,9207
3059,華晶科,5,0,5,凱基-永和,2023-01-05,9207
3189,景碩,6,1,5,凱基-永和,2023-01-05,9207
5009,榮剛,5,0,5,凱基-永和,2023-01-05,9207
00725B,國泰投資級公司債,4,0,4,凱基-永和,2023-01-05,9207
00715L,期街口布蘭特正2,4,0,4,凱基-永和,2023-01-05,9207
1810,和成,4,0,4,凱基-永和,2023-01-05,9207
2354,鴻準,4,0,4,凱基-永和,2023-01-05,9207
2609,陽明,8,4,4,凱基-永和,2023-01-05,9207
2888,新光金,19,15,4,凱基-永和,2023-01-05,9207
3284,太普高,4,0,4,凱基-永和,2023-01-05,9207
5425,台半,4,0,4,凱基-永和,2023-01-05,9207
6531,愛普*,6,2,4,凱基-永和,2023-01-05,9207
9958,世紀鋼,4,0,4,凱基-永和,2023-01-05,9207
00885,富邦越南,3,0,3,凱基-永和,2023-01-05,9207
00896,中信綠能及電動車,3,0,3,凱基-永和,2023-01-05,9207
1342,八貫,33,30,3,凱基-永和,2023-01-05,9207
2421,建準,3,0,3,凱基-永和,2023-01-05,9207
2465,麗臺,3,0,3,凱基-永和,2023-01-05,9207
6533,晶心科,6,3,3,凱基-永和,2023-01-05,9207
6589,台康生技,5,2,3,凱基-永和,2023-01-05,9207
6643,M31,12,9,3,凱基-永和,2023-01-05,9207
8086,宏捷科,3,0,3,凱基-永和,2023-01-05,9207
6446,藥華藥,3,0,3,凱基-永和,2023-01-05,9207
1909,榮成,2,0,2,凱基-永和,2023-01-05,9207
2368,金像電,2,0,2,凱基-永和,2023-01-05,9207
00676R,富邦臺灣加權反1,2,0,2,凱基-永和,2023-01-05,9207
00830,國泰費城半導體,2,0,2,凱基-永和,2023-01-05,9207
0056,元大高股息,2,0,2,凱基-永和,2023-01-05,9207
1229,聯華,2,0,2,凱基-永和,2023-01-05,9207
00897,富邦基因免疫生技,2,0,2,凱基-永和,2023-01-05,9207
8069,元太,251,5,246,凱基-永和,2023-01-06,9207
2014,中鴻,100,5,95,凱基-永和,2023-01-06,9207
00633L,富邦上証正2,43,26,17,凱基-永和,2023-01-06,9207
8996,高力,18,5,13,凱基-永和,2023-01-06,9207
00665L,富邦�琤肭磪囓�2,14,2,12,凱基-永和,2023-01-06,9207
2419,仲琦,12,0,12,凱基-永和,2023-01-06,9207
00885,富邦越南,11,0,11,凱基-永和,2023-01-06,9207
3704,合勤控,23,12,11,凱基-永和,2023-01-06,9207
00632R,元大台灣50反1,10,0,10,凱基-永和,2023-01-06,9207
2641,正德,10,0,10,凱基-永和,2023-01-06,9207
3576,聯合再生,10,0,10,凱基-永和,2023-01-06,9207
6533,晶心科,10,0,10,凱基-永和,2023-01-06,9207
2880,華南金,11,1,10,凱基-永和,2023-01-06,9207
2454,聯發科,10,1,9,凱基-永和,2023-01-06,9207
1519,華城,22,13,9,凱基-永和,2023-01-06,9207
0056,元大高股息,10,1,9,凱基-永和,2023-01-06,9207
8033,雷虎,11,2,9,凱基-永和,2023-01-06,9207
00720B,元大投資級公司債,7,0,7,凱基-永和,2023-01-06,9207
2606,裕民,9,2,7,凱基-永和,2023-01-06,9207
4102,永日,6,0,6,凱基-永和,2023-01-06,9207
00891,中信關鍵半導體,5,0,5,凱基-永和,2023-01-06,9207
2329,華泰,6,1,5,凱基-永和,2023-01-06,9207
3284,太普高,6,1,5,凱基-永和,2023-01-06,9207
6492,生華科,5,0,5,凱基-永和,2023-01-06,9207
3260,威剛,6,2,4,凱基-永和,2023-01-06,9207
2317,鴻海,4,0,4,凱基-永和,2023-01-06,9207
1533,車王電,5,1,4,凱基-永和,2023-01-06,9207
1795,美時,4,0,4,凱基-永和,2023-01-06,9207
2412,中華電,5,1,4,凱基-永和,2023-01-06,9207
2886,兆豐金,4,0,4,凱基-永和,2023-01-06,9207
4160,訊聯基因,4,0,4,凱基-永和,2023-01-06,9207
9904,寶成,4,0,4,凱基-永和,2023-01-06,9207
1584,精剛,13,10,3,凱基-永和,2023-01-06,9207
1609,大亞,3,0,3,凱基-永和,2023-01-06,9207
00773B,中信優先金融債,3,0,3,凱基-永和,2023-01-06,9207
00772B,中信高評級公司債,3,0,3,凱基-永和,2023-01-06,9207
2327,國巨,5,2,3,凱基-永和,2023-01-06,9207
2387,精元,3,0,3,凱基-永和,2023-01-06,9207
2609,陽明,5,2,3,凱基-永和,2023-01-06,9207
2634,漢翔,13,10,3,凱基-永和,2023-01-06,9207
2888,新光金,3,0,3,凱基-永和,2023-01-06,9207
3545,敦泰,3,0,3,凱基-永和,2023-01-06,9207
3708,上緯投控,8,5,3,凱基-永和,2023-01-06,9207
4114,健喬,9,6,3,凱基-永和,2023-01-06,9207
6589,台康生技,6,3,3,凱基-永和,2023-01-06,9207
00676R,富邦臺灣加權反1,2,0,2,凱基-永和,2023-01-06,9207
00878,國泰永續高股息,2,0,2,凱基-永和,2023-01-06,9207
00725B,國泰投資級公司債,2,0,2,凱基-永和,2023-01-06,9207
1101,台泥,2,0,2,凱基-永和,2023-01-06,9207
1413,宏洲,2,0,2,凱基-永和,2023-01-06,9207
4979,華星光,250,0,250,凱基-永和,2023-01-09,9207
00632R,元大台灣50反1,97,0,97,凱基-永和,2023-01-09,9207
00633L,富邦上証正2,72,0,72,凱基-永和,2023-01-09,9207
3443,創意,65,0,65,凱基-永和,2023-01-09,9207
2867,三商壽,60,0,60,凱基-永和,2023-01-09,9207
00772B,中信高評級公司債,30,0,30,凱基-永和,2023-01-09,9207
8996,高力,30,5,25,凱基-永和,2023-01-09,9207
6443,元晶,32,10,22,凱基-永和,2023-01-09,9207
2101,南港,20,0,20,凱基-永和,2023-01-09,9207
00676R,富邦臺灣加權反1,17,0,17,凱基-永和,2023-01-09,9207
5388,中磊,15,0,15,凱基-永和,2023-01-09,9207
2609,陽明,32,18,14,凱基-永和,2023-01-09,9207
6261,久元,11,0,11,凱基-永和,2023-01-09,9207
1447,力鵬,10,0,10,凱基-永和,2023-01-09,9207
00671R,富邦NASDAQ反1,10,0,10,凱基-永和,2023-01-09,9207
2601,益航,10,0,10,凱基-永和,2023-01-09,9207
4763,材料-KY,10,0,10,凱基-永和,2023-01-09,9207
4960,誠美材,10,0,10,凱基-永和,2023-01-09,9207
1533,車王電,9,0,9,凱基-永和,2023-01-09,9207
2034,允強,9,0,9,凱基-永和,2023-01-09,9207
2359,所羅門,10,1,9,凱基-永和,2023-01-09,9207
2027,大成鋼,8,1,7,凱基-永和,2023-01-09,9207
8084,巨虹,7,0,7,凱基-永和,2023-01-09,9207
3231,緯創,6,0,6,凱基-永和,2023-01-09,9207
00720B,元大投資級公司債,6,0,6,凱基-永和,2023-01-09,9207
00885,富邦越南,6,0,6,凱基-永和,2023-01-09,9207
1609,大亞,5,0,5,凱基-永和,2023-01-09,9207
2482,連宇,5,0,5,凱基-永和,2023-01-09,9207
2851,中再保,5,0,5,凱基-永和,2023-01-09,9207
4563,百德,7,2,5,凱基-永和,2023-01-09,9207
4977,眾達-KY,5,0,5,凱基-永和,2023-01-09,9207
6118,建達,10,5,5,凱基-永和,2023-01-09,9207
6548,長科*,5,0,5,凱基-永和,2023-01-09,9207
8478,東哥遊艇,6,1,5,凱基-永和,2023-01-09,9207
2603,長榮,7,3,4,凱基-永和,2023-01-09,9207
00830,國泰費城半導體,4,0,4,凱基-永和,2023-01-09,9207
2489,瑞軒,4,0,4,凱基-永和,2023-01-09,9207
6752,叡揚,4,0,4,凱基-永和,2023-01-09,9207
1708,東鹼,3,0,3,凱基-永和,2023-01-09,9207
00665L,富邦�琤肭磪囓�2,15,12,3,凱基-永和,2023-01-09,9207
00878,國泰永續高股息,4,1,3,凱基-永和,2023-01-09,9207
1605,華新,15,12,3,凱基-永和,2023-01-09,9207
1734,杏輝,3,0,3,凱基-永和,2023-01-09,9207
3265,台星科,3,0,3,凱基-永和,2023-01-09,9207
4576,大銀微系統,3,0,3,凱基-永和,2023-01-09,9207
5203,訊連,3,0,3,凱基-永和,2023-01-09,9207
5351,鈺創,3,0,3,凱基-永和,2023-01-09,9207
6279,胡連,5,2,3,凱基-永和,2023-01-09,9207
1536,和大,3,1,2,凱基-永和,2023-01-09,9207
1417,嘉裕,2,0,2,凱基-永和,2023-01-09,9207
3481,群創,100,0,100,凱基-永和,2023-01-10,9207
4979,華星光,75,0,75,凱基-永和,2023-01-10,9207
6643,M31,75,2,73,凱基-永和,2023-01-10,9207
00632R,元大台灣50反1,37,0,37,凱基-永和,2023-01-10,9207
5251,天鉞電,25,0,25,凱基-永和,2023-01-10,9207
2618,長榮航,20,0,20,凱基-永和,2023-01-10,9207
4908,前鼎,20,0,20,凱基-永和,2023-01-10,9207
00633L,富邦上証正2,18,0,18,凱基-永和,2023-01-10,9207
1752,南光,15,0,15,凱基-永和,2023-01-10,9207
00685L,群益臺灣加權正2,12,0,12,凱基-永和,2023-01-10,9207
4919,新唐,11,1,10,凱基-永和,2023-01-10,9207
2007,燁興,10,0,10,凱基-永和,2023-01-10,9207
2425,承啟,10,0,10,凱基-永和,2023-01-10,9207
2495,普安,10,0,10,凱基-永和,2023-01-10,9207
2614,東森,10,0,10,凱基-永和,2023-01-10,9207
2851,中再保,10,0,10,凱基-永和,2023-01-10,9207
8064,東捷,10,0,10,凱基-永和,2023-01-10,9207
00878,國泰永續高股息,21,13,8,凱基-永和,2023-01-10,9207
1736,喬山,9,1,8,凱基-永和,2023-01-10,9207
00897,富邦基因免疫生技,7,0,7,凱基-永和,2023-01-10,9207
1609,大亞,6,0,6,凱基-永和,2023-01-10,9207
1560,中砂,15,9,6,凱基-永和,2023-01-10,9207
2455,全新,6,1,5,凱基-永和,2023-01-10,9207
1514,亞力,5,0,5,凱基-永和,2023-01-10,9207
1536,和大,10,5,5,凱基-永和,2023-01-10,9207
2014,中鴻,5,0,5,凱基-永和,2023-01-10,9207
2312,金寶,5,0,5,凱基-永和,2023-01-10,9207
2358,廷鑫,5,0,5,凱基-永和,2023-01-10,9207
2371,大同,5,0,5,凱基-永和,2023-01-10,9207
2812,台中銀,5,0,5,凱基-永和,2023-01-10,9207
6124,業強,5,0,5,凱基-永和,2023-01-10,9207
2367,燿華,4,0,4,凱基-永和,2023-01-10,9207
2610,華航,4,0,4,凱基-永和,2023-01-10,9207
1605,華新,14,11,3,凱基-永和,2023-01-10,9207
2444,兆勁,3,0,3,凱基-永和,2023-01-10,9207
6443,元晶,45,42,3,凱基-永和,2023-01-10,9207
6492,生華科,3,0,3,凱基-永和,2023-01-10,9207
5347,世界,9,7,2,凱基-永和,2023-01-10,9207
00830,國泰費城半導體,2,0,2,凱基-永和,2023-01-10,9207
1513,中興電,4,2,2,凱基-永和,2023-01-10,9207
1413,宏洲,2,0,2,凱基-永和,2023-01-10,9207
1409,新纖,2,0,2,凱基-永和,2023-01-10,9207
006208,富邦台50,3,1,2,凱基-永和,2023-01-10,9207
00713,元大台灣高息低波,2,0,2,凱基-永和,2023-01-10,9207
1708,東鹼,2,0,2,凱基-永和,2023-01-10,9207
1810,和成,2,0,2,凱基-永和,2023-01-10,9207
2313,華通,2,0,2,凱基-永和,2023-01-10,9207
2324,仁寶,2,0,2,凱基-永和,2023-01-10,9207
2465,麗臺,2,0,2,凱基-永和,2023-01-10,9207
2882,國泰金,2,0,2,凱基-永和,2023-01-10,9207
6770,力積電,94,1,93,凱基-永和,2023-01-11,9207
2468,華經,37,6,31,凱基-永和,2023-01-11,9207
00680L,元大美債20正2,30,0,30,凱基-永和,2023-01-11,9207
3037,欣興,30,2,28,凱基-永和,2023-01-11,9207
00907,永豐優息存股,20,0,20,凱基-永和,2023-01-11,9207
00882,中信中國高股息,19,0,19,凱基-永和,2023-01-11,9207
00633L,富邦上証正2,18,0,18,凱基-永和,2023-01-11,9207
00650L,復華香港正2,15,0,15,凱基-永和,2023-01-11,9207
2404,漢唐,12,0,12,凱基-永和,2023-01-11,9207
2609,陽明,63,51,12,凱基-永和,2023-01-11,9207
1268,漢來美食,11,0,11,凱基-永和,2023-01-11,9207
00878,國泰永續高股息,13,2,11,凱基-永和,2023-01-11,9207
2610,華航,12,1,11,凱基-永和,2023-01-11,9207
2617,台航,10,0,10,凱基-永和,2023-01-11,9207
5321,美而快,26,16,10,凱基-永和,2023-01-11,9207
3034,聯詠,11,1,10,凱基-永和,2023-01-11,9207
1104,環泥,11,2,9,凱基-永和,2023-01-11,9207
00637L,元大滬深300正2,11,2,9,凱基-永和,2023-01-11,9207
2465,麗臺,10,2,8,凱基-永和,2023-01-11,9207
2886,兆豐金,7,0,7,凱基-永和,2023-01-11,9207
3265,台星科,7,0,7,凱基-永和,2023-01-11,9207
4160,訊聯基因,7,0,7,凱基-永和,2023-01-11,9207
00632R,元大台灣50反1,6,0,6,凱基-永和,2023-01-11,9207
00665L,富邦�琤肭磪囓�2,6,0,6,凱基-永和,2023-01-11,9207
5483,中美晶,6,0,6,凱基-永和,2023-01-11,9207
6443,元晶,11,5,6,凱基-永和,2023-01-11,9207
8069,元太,8,3,5,凱基-永和,2023-01-11,9207
2892,第一金,5,0,5,凱基-永和,2023-01-11,9207
1734,杏輝,5,0,5,凱基-永和,2023-01-11,9207
3056,富華新,5,0,5,凱基-永和,2023-01-11,9207
3059,華晶科,5,0,5,凱基-永和,2023-01-11,9207
5258,虹堡,11,6,5,凱基-永和,2023-01-11,9207
8046,南電,5,1,4,凱基-永和,2023-01-11,9207
2884,玉山金,4,0,4,凱基-永和,2023-01-11,9207
4726,永昕,4,0,4,凱基-永和,2023-01-11,9207
6533,晶心科,5,1,4,凱基-永和,2023-01-11,9207
2882,國泰金,4,1,3,凱基-永和,2023-01-11,9207
00679B,元大美債20年,3,0,3,凱基-永和,2023-01-11,9207
1301,台塑,3,0,3,凱基-永和,2023-01-11,9207
1522,堤維西,3,0,3,凱基-永和,2023-01-11,9207
1795,美時,9,6,3,凱基-永和,2023-01-11,9207
2457,飛宏,3,0,3,凱基-永和,2023-01-11,9207
3705,永信,3,0,3,凱基-永和,2023-01-11,9207
5324,士開,3,0,3,凱基-永和,2023-01-11,9207
6143,振曜,3,0,3,凱基-永和,2023-01-11,9207
2888,新光金,6,4,2,凱基-永和,2023-01-11,9207
2368,金像電,2,0,2,凱基-永和,2023-01-11,9207
1517,利奇,2,0,2,凱基-永和,2023-01-11,9207
00773B,中信優先金融債,2,0,2,凱基-永和,2023-01-11,9207
00753L,中信中國50正2,5,3,2,凱基-永和,2023-01-11,9207
2609,陽明,42,14,28,凱基-永和,2023-01-12,9207
00680L,元大美債20正2,25,0,25,凱基-永和,2023-01-12,9207
00878,國泰永續高股息,25,3,22,凱基-永和,2023-01-12,9207
3481,群創,16,0,16,凱基-永和,2023-01-12,9207
2610,華航,16,2,14,凱基-永和,2023-01-12,9207
00753L,中信中國50正2,14,2,12,凱基-永和,2023-01-12,9207
1442,名軒,11,0,11,凱基-永和,2023-01-12,9207
00650L,復華香港正2,10,0,10,凱基-永和,2023-01-12,9207
2888,新光金,10,0,10,凱基-永和,2023-01-12,9207
00882,中信中國高股息,9,0,9,凱基-永和,2023-01-12,9207
4743,合一,10,2,8,凱基-永和,2023-01-12,9207
2014,中鴻,10,2,8,凱基-永和,2023-01-12,9207
2017,官田鋼,7,0,7,凱基-永和,2023-01-12,9207
2892,第一金,7,0,7,凱基-永和,2023-01-12,9207
4746,台耀,7,0,7,凱基-永和,2023-01-12,9207
4919,新唐,10,3,7,凱基-永和,2023-01-12,9207
2404,漢唐,6,0,6,凱基-永和,2023-01-12,9207
3532,台勝科,6,0,6,凱基-永和,2023-01-12,9207
00725B,國泰投資級公司債,6,0,6,凱基-永和,2023-01-12,9207
00720B,元大投資級公司債,6,0,6,凱基-永和,2023-01-12,9207
00632R,元大台灣50反1,5,0,5,凱基-永和,2023-01-12,9207
1701,中化,5,0,5,凱基-永和,2023-01-12,9207
2880,華南金,6,1,5,凱基-永和,2023-01-12,9207
3059,華晶科,5,0,5,凱基-永和,2023-01-12,9207
1560,中砂,5,1,4,凱基-永和,2023-01-12,9207
0056,元大高股息,6,2,4,凱基-永和,2023-01-12,9207
2009,第一銅,176,172,4,凱基-永和,2023-01-12,9207
2105,正新,4,0,4,凱基-永和,2023-01-12,9207
2359,所羅門,4,0,4,凱基-永和,2023-01-12,9207
5243,乙盛-KY,5,1,4,凱基-永和,2023-01-12,9207
00713,元大台灣高息低波,3,0,3,凱基-永和,2023-01-12,9207
1413,宏洲,3,0,3,凱基-永和,2023-01-12,9207
1815,富喬,3,0,3,凱基-永和,2023-01-12,9207
2354,鴻準,3,0,3,凱基-永和,2023-01-12,9207
3128,昇銳,3,0,3,凱基-永和,2023-01-12,9207
3707,漢磊,3,0,3,凱基-永和,2023-01-12,9207
6104,創惟,3,0,3,凱基-永和,2023-01-12,9207
2327,國巨,2,0,2,凱基-永和,2023-01-12,9207
5347,世界,18,16,2,凱基-永和,2023-01-12,9207
2603,長榮,2,0,2,凱基-永和,2023-01-12,9207
1310,台苯,2,0,2,凱基-永和,2023-01-12,9207
00830,國泰費城半導體,3,1,2,凱基-永和,2023-01-12,9207
00770,國泰北美科技,2,0,2,凱基-永和,2023-01-12,9207
1519,華城,2,0,2,凱基-永和,2023-01-12,9207
2352,佳世達,2,0,2,凱基-永和,2023-01-12,9207
2358,廷鑫,2,0,2,凱基-永和,2023-01-12,9207
2382,廣達,2,0,2,凱基-永和,2023-01-12,9207
2441,超豐,2,0,2,凱基-永和,2023-01-12,9207
2611,志信,2,0,2,凱基-永和,2023-01-12,9207
2887,台新金,2,0,2,凱基-永和,2023-01-12,9207
6282,康舒,33,0,33,凱基-永和,2023-01-13,9207
00632R,元大台灣50反1,32,2,30,凱基-永和,2023-01-13,9207
00680L,元大美債20正2,30,8,22,凱基-永和,2023-01-13,9207
00633L,富邦上証正2,19,1,18,凱基-永和,2023-01-13,9207
5258,虹堡,15,0,15,凱基-永和,2023-01-13,9207
0056,元大高股息,16,2,14,凱基-永和,2023-01-13,9207
1609,大亞,12,0,12,凱基-永和,2023-01-13,9207
2881,富邦金,10,0,10,凱基-永和,2023-01-13,9207
5871,中租-KY,10,0,10,凱基-永和,2023-01-13,9207
2603,長榮,11,2,9,凱基-永和,2023-01-13,9207
2105,正新,9,1,8,凱基-永和,2023-01-13,9207
3036,文曄,12,4,8,凱基-永和,2023-01-13,9207
00679B,元大美債20年,7,0,7,凱基-永和,2023-01-13,9207
00893,國泰智能電動車,6,0,6,凱基-永和,2023-01-13,9207
2457,飛宏,6,0,6,凱基-永和,2023-01-13,9207
3704,合勤控,6,0,6,凱基-永和,2023-01-13,9207
00751B,元大AAA至A公司債,5,0,5,凱基-永和,2023-01-13,9207
2888,新光金,5,0,5,凱基-永和,2023-01-13,9207
3481,群創,5,0,5,凱基-永和,2023-01-13,9207
4128,中天,5,0,5,凱基-永和,2023-01-13,9207
00647L,元大S＆P500正2,4,0,4,凱基-永和,2023-01-13,9207
2312,金寶,4,0,4,凱基-永和,2023-01-13,9207
2359,所羅門,4,0,4,凱基-永和,2023-01-13,9207
2380,虹光,4,0,4,凱基-永和,2023-01-13,9207
3665,貿聯-KY,6,2,4,凱基-永和,2023-01-13,9207
5531,鄉林,4,0,4,凱基-永和,2023-01-13,9207
5347,世界,6,3,3,凱基-永和,2023-01-13,9207
6245,立端,6,3,3,凱基-永和,2023-01-13,9207
3128,昇銳,5,2,3,凱基-永和,2023-01-13,9207
3682,亞太電,3,0,3,凱基-永和,2023-01-13,9207
6443,元晶,14,11,3,凱基-永和,2023-01-13,9207
8050,廣積,4,1,3,凱基-永和,2023-01-13,9207
8478,東哥遊艇,3,0,3,凱基-永和,2023-01-13,9207
3035,智原,3,1,2,凱基-永和,2023-01-13,9207
1308,亞聚,5,3,2,凱基-永和,2023-01-13,9207
4961,天鈺,2,0,2,凱基-永和,2023-01-13,9207
1104,環泥,2,0,2,凱基-永和,2023-01-13,9207
00770,國泰北美科技,2,0,2,凱基-永和,2023-01-13,9207
1319,東陽,2,0,2,凱基-永和,2023-01-13,9207
1413,宏洲,2,0,2,凱基-永和,2023-01-13,9207
1522,堤維西,2,0,2,凱基-永和,2023-01-13,9207
2349,錸德,2,0,2,凱基-永和,2023-01-13,9207
2409,友達,2,0,2,凱基-永和,2023-01-13,9207
2547,日勝生,2,0,2,凱基-永和,2023-01-13,9207
2608,嘉里大榮,2,0,2,凱基-永和,2023-01-13,9207
2615,萬海,2,0,2,凱基-永和,2023-01-13,9207
3265,台星科,6,4,2,凱基-永和,2023-01-13,9207
3625,西勝,2,0,2,凱基-永和,2023-01-13,9207
5607,遠雄港,2,0,2,凱基-永和,2023-01-13,9207
5608,四維航,2,0,2,凱基-永和,2023-01-13,9207
00673R,期元大S＆P原油反1,17,0,17,凱基-永和,2023-01-16,9207
00650L,復華香港正2,14,0,14,凱基-永和,2023-01-16,9207
2929,淘帝-KY,14,0,14,凱基-永和,2023-01-16,9207
2609,陽明,12,0,12,凱基-永和,2023-01-16,9207
2317,鴻海,10,0,10,凱基-永和,2023-01-16,9207
00720B,元大投資級公司債,10,0,10,凱基-永和,2023-01-16,9207
2323,中環,10,0,10,凱基-永和,2023-01-16,9207
00633L,富邦上証正2,9,0,9,凱基-永和,2023-01-16,9207
00679B,元大美債20年,8,0,8,凱基-永和,2023-01-16,9207
00725B,國泰投資級公司債,8,0,8,凱基-永和,2023-01-16,9207
4128,中天,8,1,7,凱基-永和,2023-01-16,9207
1314,中石化,6,0,6,凱基-永和,2023-01-16,9207
00878,國泰永續高股息,7,1,6,凱基-永和,2023-01-16,9207
2489,瑞軒,6,0,6,凱基-永和,2023-01-16,9207
8112,至上,6,0,6,凱基-永和,2023-01-16,9207
8046,南電,6,0,6,凱基-永和,2023-01-16,9207
2618,長榮航,17,12,5,凱基-永和,2023-01-16,9207
3023,信邦,9,4,5,凱基-永和,2023-01-16,9207
3450,聯鈞,5,0,5,凱基-永和,2023-01-16,9207
5452,佶優,5,0,5,凱基-永和,2023-01-16,9207
8086,宏捷科,5,0,5,凱基-永和,2023-01-16,9207
00893,國泰智能電動車,6,2,4,凱基-永和,2023-01-16,9207
00830,國泰費城半導體,4,0,4,凱基-永和,2023-01-16,9207
2468,華經,4,0,4,凱基-永和,2023-01-16,9207
2723,美食-KY,17,13,4,凱基-永和,2023-01-16,9207
4960,誠美材,4,0,4,凱基-永和,2023-01-16,9207
5531,鄉林,4,0,4,凱基-永和,2023-01-16,9207
00680L,元大美債20正2,3,0,3,凱基-永和,2023-01-16,9207
1584,精剛,3,0,3,凱基-永和,2023-01-16,9207
3290,東浦,3,0,3,凱基-永和,2023-01-16,9207
6609,瀧澤科,3,0,3,凱基-永和,2023-01-16,9207
9945,潤泰新,4,1,3,凱基-永和,2023-01-16,9207
6214,精誠,2,0,2,凱基-永和,2023-01-16,9207
3034,聯詠,2,0,2,凱基-永和,2023-01-16,9207
2404,漢唐,2,0,2,凱基-永和,2023-01-16,9207
00897,富邦基因免疫生技,2,0,2,凱基-永和,2023-01-16,9207
00676R,富邦臺灣加權反1,2,0,2,凱基-永和,2023-01-16,9207
1308,亞聚,2,0,2,凱基-永和,2023-01-16,9207
1522,堤維西,2,0,2,凱基-永和,2023-01-16,9207
2002,中鋼,2,0,2,凱基-永和,2023-01-16,9207
2010,春源,2,0,2,凱基-永和,2023-01-16,9207
2313,華通,2,0,2,凱基-永和,2023-01-16,9207
2634,漢翔,3,1,2,凱基-永和,2023-01-16,9207
2736,富野,2,0,2,凱基-永和,2023-01-16,9207
3481,群創,2,0,2,凱基-永和,2023-01-16,9207
3588,通嘉,2,0,2,凱基-永和,2023-01-16,9207
2603,長榮,2,0,2,凱基-永和,2023-01-16,9207
1795,美時,9,7,2,凱基-永和,2023-01-16,9207
6104,創惟,1,0,1,凱基-永和,2023-01-16,9207
1519,華城,1,0,1,凱基-永和,2023-01-16,9207
2540,愛山林,110,55,55,凱基-永和,2023-01-17,9207
0050,元大台灣50,58,3,55,凱基-永和,2023-01-17,9207
2317,鴻海,18,0,18,凱基-永和,2023-01-17,9207
00637L,元大滬深300正2,18,1,17,凱基-永和,2023-01-17,9207
3481,群創,16,0,16,凱基-永和,2023-01-17,9207
6259,百徽,15,0,15,凱基-永和,2023-01-17,9207
2736,富野,13,0,13,凱基-永和,2023-01-17,9207
2230,泰茂,11,0,11,凱基-永和,2023-01-17,9207
00878,國泰永續高股息,12,1,11,凱基-永和,2023-01-17,9207
6180,橘子,14,4,10,凱基-永和,2023-01-17,9207
3037,欣興,11,1,10,凱基-永和,2023-01-17,9207
1717,長興,10,0,10,凱基-永和,2023-01-17,9207
3576,聯合再生,10,0,10,凱基-永和,2023-01-17,9207
2204,中華,8,0,8,凱基-永和,2023-01-17,9207
2368,金像電,8,0,8,凱基-永和,2023-01-17,9207
3284,太普高,8,0,8,凱基-永和,2023-01-17,9207
4729,熒茂,8,0,8,凱基-永和,2023-01-17,9207
1101,台泥,9,3,6,凱基-永和,2023-01-17,9207
2436,偉詮電,6,0,6,凱基-永和,2023-01-17,9207
00881,國泰台灣5G+,6,0,6,凱基-永和,2023-01-17,9207
00673R,期元大S＆P原油反1,5,0,5,凱基-永和,2023-01-17,9207
00632R,元大台灣50反1,6,1,5,凱基-永和,2023-01-17,9207
00882,中信中國高股息,5,0,5,凱基-永和,2023-01-17,9207
2884,玉山金,5,0,5,凱基-永和,2023-01-17,9207
3033,威健,5,0,5,凱基-永和,2023-01-17,9207
8171,天宇,6,1,5,凱基-永和,2023-01-17,9207
8996,高力,75,70,5,凱基-永和,2023-01-17,9207
1442,名軒,4,0,4,凱基-永和,2023-01-17,9207
2338,光罩,4,0,4,凱基-永和,2023-01-17,9207
2458,義隆,5,1,4,凱基-永和,2023-01-17,9207
2609,陽明,7,3,4,凱基-永和,2023-01-17,9207
3413,京鼎,4,0,4,凱基-永和,2023-01-17,9207
4540,全球傳動,4,0,4,凱基-永和,2023-01-17,9207
4906,正文,4,0,4,凱基-永和,2023-01-17,9207
8916,光隆,4,0,4,凱基-永和,2023-01-17,9207
1514,亞力,5,2,3,凱基-永和,2023-01-17,9207
1560,中砂,4,1,3,凱基-永和,2023-01-17,9207
1524,耿鼎,3,0,3,凱基-永和,2023-01-17,9207
2034,允強,3,0,3,凱基-永和,2023-01-17,9207
2365,昆盈,5,2,3,凱基-永和,2023-01-17,9207
5251,天鉞電,3,0,3,凱基-永和,2023-01-17,9207
2618,長榮航,7,5,2,凱基-永和,2023-01-17,9207
2634,漢翔,2,0,2,凱基-永和,2023-01-17,9207
2637,慧洋-KY,2,0,2,凱基-永和,2023-01-17,9207
3219,倚強科,2,0,2,凱基-永和,2023-01-17,9207
3265,台星科,3,1,2,凱基-永和,2023-01-17,9207
3332,幸康,2,0,2,凱基-永和,2023-01-17,9207
4160,訊聯基因,2,0,2,凱基-永和,2023-01-17,9207
4927,泰鼎-KY,2,0,2,凱基-永和,2023-01-17,9207
6589,台康生技,2,0,2,凱基-永和,2023-01-17,9207
4979,華星光,741,0,741,凱基-永和,2023-01-30,9207
3289,宜特,498,10,488,凱基-永和,2023-01-30,9207
6282,康舒,240,73,167,凱基-永和,2023-01-30,9207
00633L,富邦上証正2,115,1,114,凱基-永和,2023-01-30,9207
2323,中環,100,10,90,凱基-永和,2023-01-30,9207
2349,錸德,88,0,88,凱基-永和,2023-01-30,9207
00632R,元大台灣50反1,85,0,85,凱基-永和,2023-01-30,9207
3231,緯創,100,24,76,凱基-永和,2023-01-30,9207
2201,裕隆,59,2,57,凱基-永和,2023-01-30,9207
2030,彰源,50,0,50,凱基-永和,2023-01-30,9207
2014,中鴻,54,9,45,凱基-永和,2023-01-30,9207
2610,華航,73,30,43,凱基-永和,2023-01-30,9207
6244,茂迪,40,1,39,凱基-永和,2023-01-30,9207
3661,世芯-KY,38,0,38,凱基-永和,2023-01-30,9207
2230,泰茂,25,0,25,凱基-永和,2023-01-30,9207
9941,裕融,25,0,25,凱基-永和,2023-01-30,9207
2609,陽明,21,0,21,凱基-永和,2023-01-30,9207
3062,建漢,20,0,20,凱基-永和,2023-01-30,9207
2892,第一金,18,0,18,凱基-永和,2023-01-30,9207
6415,矽力*-KY,18,0,18,凱基-永和,2023-01-30,9207
2317,鴻海,31,14,17,凱基-永和,2023-01-30,9207
1605,華新,389,374,15,凱基-永和,2023-01-30,9207
2009,第一銅,15,4,11,凱基-永和,2023-01-30,9207
1312,國喬,10,0,10,凱基-永和,2023-01-30,9207
4564,元翎,10,0,10,凱基-永和,2023-01-30,9207
6279,胡連,11,1,10,凱基-永和,2023-01-30,9207
8038,長園科,10,0,10,凱基-永和,2023-01-30,9207
2328,廣宇,16,7,9,凱基-永和,2023-01-30,9207
8069,元太,9,0,9,凱基-永和,2023-01-30,9207
1517,利奇,8,0,8,凱基-永和,2023-01-30,9207
00770,國泰北美科技,7,0,7,凱基-永和,2023-01-30,9207
00636,國泰中國A50,7,0,7,凱基-永和,2023-01-30,9207
2614,東森,7,0,7,凱基-永和,2023-01-30,9207
00673R,期元大S＆P原油反1,6,0,6,凱基-永和,2023-01-30,9207
2913,農林,6,0,6,凱基-永和,2023-01-30,9207
1560,中砂,7,2,5,凱基-永和,2023-01-30,9207
00671R,富邦NASDAQ反1,5,0,5,凱基-永和,2023-01-30,9207
00650L,復華香港正2,5,0,5,凱基-永和,2023-01-30,9207
00648R,元大S＆P500反1,5,0,5,凱基-永和,2023-01-30,9207
00892,富邦台灣半導體,5,0,5,凱基-永和,2023-01-30,9207
2313,華通,5,0,5,凱基-永和,2023-01-30,9207
3437,榮創,5,0,5,凱基-永和,2023-01-30,9207
6806,森崴能源,10,5,5,凱基-永和,2023-01-30,9207
3443,創意,5,0,5,凱基-永和,2023-01-30,9207
2603,長榮,5,0,5,凱基-永和,2023-01-30,9207
6509,聚和,4,0,4,凱基-永和,2023-01-30,9207
9802,鈺齊-KY,4,0,4,凱基-永和,2023-01-30,9207
3036,文曄,5,2,3,凱基-永和,2023-01-30,9207
1104,環泥,3,0,3,凱基-永和,2023-01-30,9207
1319,東陽,4,1,3,凱基-永和,2023-01-30,9207
3289,宜特,145,0,145,凱基-永和,2023-01-31,9207
1336,台翰,100,0,100,凱基-永和,2023-01-31,9207
2867,三商壽,100,0,100,凱基-永和,2023-01-31,9207
2929,淘帝-KY,100,0,100,凱基-永和,2023-01-31,9207
00905,FT臺灣Smart,75,0,75,凱基-永和,2023-01-31,9207
00893,國泰智能電動車,89,25,64,凱基-永和,2023-01-31,9207
1101,台泥,55,0,55,凱基-永和,2023-01-31,9207
2884,玉山金,41,0,41,凱基-永和,2023-01-31,9207
2002,中鋼,44,4,40,凱基-永和,2023-01-31,9207
6139,亞翔,38,0,38,凱基-永和,2023-01-31,9207
00878,國泰永續高股息,37,2,35,凱基-永和,2023-01-31,9207
00632R,元大台灣50反1,64,30,34,凱基-永和,2023-01-31,9207
3587,閎康,39,5,34,凱基-永和,2023-01-31,9207
2330,台積電,30,2,28,凱基-永和,2023-01-31,9207
6649,台生材,25,0,25,凱基-永和,2023-01-31,9207
2887,台新金,25,1,24,凱基-永和,2023-01-31,9207
0056,元大高股息,30,7,23,凱基-永和,2023-01-31,9207
2892,第一金,28,11,17,凱基-永和,2023-01-31,9207
3178,公準,15,0,15,凱基-永和,2023-01-31,9207
5009,榮剛,15,1,14,凱基-永和,2023-01-31,9207
1560,中砂,18,5,13,凱基-永和,2023-01-31,9207
00753L,中信中國50正2,13,0,13,凱基-永和,2023-01-31,9207
3711,日月光投控,13,0,13,凱基-永和,2023-01-31,9207
00636,國泰中國A50,12,0,12,凱基-永和,2023-01-31,9207
00673R,期元大S＆P原油反1,12,0,12,凱基-永和,2023-01-31,9207
4961,天鈺,13,1,12,凱基-永和,2023-01-31,9207
00720B,元大投資級公司債,11,0,11,凱基-永和,2023-01-31,9207
2354,鴻準,12,1,11,凱基-永和,2023-01-31,9207
2367,燿華,11,0,11,凱基-永和,2023-01-31,9207
2890,永豐金,11,0,11,凱基-永和,2023-01-31,9207
00679B,元大美債20年,10,0,10,凱基-永和,2023-01-31,9207
1611,中電,10,0,10,凱基-永和,2023-01-31,9207
2449,京元電子,10,0,10,凱基-永和,2023-01-31,9207
4564,元翎,10,0,10,凱基-永和,2023-01-31,9207
2412,中華電,9,0,9,凱基-永和,2023-01-31,9207
3665,貿聯-KY,8,0,8,凱基-永和,2023-01-31,9207
6180,橘子,15,7,8,凱基-永和,2023-01-31,9207
0050,元大台灣50,12,5,7,凱基-永和,2023-01-31,9207
3702,大聯大,8,1,7,凱基-永和,2023-01-31,9207
00637L,元大滬深300正2,6,0,6,凱基-永和,2023-01-31,9207
2886,兆豐金,6,0,6,凱基-永和,2023-01-31,9207
2603,長榮,5,0,5,凱基-永和,2023-01-31,9207
00650L,復華香港正2,5,0,5,凱基-永和,2023-01-31,9207
00728,第一金工業30,5,0,5,凱基-永和,2023-01-31,9207
00665L,富邦�琤肭磪囓�2,5,0,5,凱基-永和,2023-01-31,9207
1104,環泥,5,0,5,凱基-永和,2023-01-31,9207
1513,中興電,11,6,5,凱基-永和,2023-01-31,9207
2618,長榮航,8,3,5,凱基-永和,2023-01-31,9207
4123,晟德,5,0,5,凱基-永和,2023-01-31,9207
4566,時碩工業,5,0,5,凱基-永和,2023-01-31,9207
6143,振曜,163,0,163,凱基-永和,2023-02-01,9207
2618,長榮航,109,9,100,凱基-永和,2023-02-01,9207
3062,建漢,80,0,80,凱基-永和,2023-02-01,9207
2030,彰源,70,0,70,凱基-永和,2023-02-01,9207
5321,美而快,90,20,70,凱基-永和,2023-02-01,9207
4919,新唐,75,9,66,凱基-永和,2023-02-01,9207
6494,九齊,64,14,50,凱基-永和,2023-02-01,9207
2882A,國泰特,49,0,49,凱基-永和,2023-02-01,9207
1810,和成,35,0,35,凱基-永和,2023-02-01,9207
2009,第一銅,83,52,31,凱基-永和,2023-02-01,9207
1609,大亞,41,15,26,凱基-永和,2023-02-01,9207
00878,國泰永續高股息,25,3,22,凱基-永和,2023-02-01,9207
2884,玉山金,22,0,22,凱基-永和,2023-02-01,9207
00671R,富邦NASDAQ反1,20,0,20,凱基-永和,2023-02-01,9207
6695,芯鼎,20,0,20,凱基-永和,2023-02-01,9207
2465,麗臺,16,0,16,凱基-永和,2023-02-01,9207
3675,德微,32,16,16,凱基-永和,2023-02-01,9207
0056,元大高股息,16,1,15,凱基-永和,2023-02-01,9207
00632R,元大台灣50反1,14,0,14,凱基-永和,2023-02-01,9207
2492,華新科,20,7,13,凱基-永和,2023-02-01,9207
00673R,期元大S＆P原油反1,12,0,12,凱基-永和,2023-02-01,9207
2609,陽明,12,1,11,凱基-永和,2023-02-01,9207
1612,宏泰,10,0,10,凱基-永和,2023-02-01,9207
1809,中釉,20,10,10,凱基-永和,2023-02-01,9207
2006,東和鋼鐵,10,0,10,凱基-永和,2023-02-01,9207
2356,英業達,10,0,10,凱基-永和,2023-02-01,9207
2913,農林,10,0,10,凱基-永和,2023-02-01,9207
6133,金橋,10,0,10,凱基-永和,2023-02-01,9207
2412,中華電,9,0,9,凱基-永和,2023-02-01,9207
4960,誠美材,10,1,9,凱基-永和,2023-02-01,9207
6669,緯穎,9,0,9,凱基-永和,2023-02-01,9207
00679B,元大美債20年,8,0,8,凱基-永和,2023-02-01,9207
2458,義隆,8,0,8,凱基-永和,2023-02-01,9207
1526,日馳,7,0,7,凱基-永和,2023-02-01,9207
2887,台新金,6,0,6,凱基-永和,2023-02-01,9207
6548,長科*,6,0,6,凱基-永和,2023-02-01,9207
9945,潤泰新,8,2,6,凱基-永和,2023-02-01,9207
3026,禾伸堂,5,0,5,凱基-永和,2023-02-01,9207
1529,樂事綠能,5,0,5,凱基-永和,2023-02-01,9207
2101,南港,5,0,5,凱基-永和,2023-02-01,9207
2401,凌陽,5,0,5,凱基-永和,2023-02-01,9207
3207,耀勝,7,2,5,凱基-永和,2023-02-01,9207
4102,永日,5,0,5,凱基-永和,2023-02-01,9207
4566,時碩工業,5,0,5,凱基-永和,2023-02-01,9207
5876,上海商銀,5,0,5,凱基-永和,2023-02-01,9207
6161,捷波,5,0,5,凱基-永和,2023-02-01,9207
8084,巨虹,5,0,5,凱基-永和,2023-02-01,9207
2883,凱基金,5,0,5,凱基-永和,2023-02-01,9207
2317,鴻海,7,3,4,凱基-永和,2023-02-01,9207
2230,泰茂,4,0,4,凱基-永和,2023-02-01,9207
2344,華邦電,908,128,780,凱基-永和,2023-02-02,9207
2388,威盛,515,319,196,凱基-永和,2023-02-02,9207
6282,康舒,207,14,193,凱基-永和,2023-02-02,9207
3661,世芯-KY,68,1,67,凱基-永和,2023-02-02,9207
6118,建達,50,0,50,凱基-永和,2023-02-02,9207
3289,宜特,35,0,35,凱基-永和,2023-02-02,9207
6143,振曜,41,6,35,凱基-永和,2023-02-02,9207
2498,宏達電,41,9,32,凱基-永和,2023-02-02,9207
00878,國泰永續高股息,30,0,30,凱基-永和,2023-02-02,9207
00679B,元大美債20年,30,0,30,凱基-永和,2023-02-02,9207
6548,長科*,30,0,30,凱基-永和,2023-02-02,9207
6180,橘子,30,0,30,凱基-永和,2023-02-02,9207
8261,富鼎,23,0,23,凱基-永和,2023-02-02,9207
00687B,國泰20年美債,21,0,21,凱基-永和,2023-02-02,9207
3141,晶宏,23,2,21,凱基-永和,2023-02-02,9207
3264,欣銓,20,0,20,凱基-永和,2023-02-02,9207
3704,合勤控,20,1,19,凱基-永和,2023-02-02,9207
2201,裕隆,18,1,17,凱基-永和,2023-02-02,9207
2884,玉山金,16,0,16,凱基-永和,2023-02-02,9207
1795,美時,27,11,16,凱基-永和,2023-02-02,9207
5285,界霖,16,1,15,凱基-永和,2023-02-02,9207
4160,訊聯基因,14,0,14,凱基-永和,2023-02-02,9207
6546,正基,15,1,14,凱基-永和,2023-02-02,9207
2002,中鋼,13,0,13,凱基-永和,2023-02-02,9207
5425,台半,17,4,13,凱基-永和,2023-02-02,9207
3443,創意,26,13,13,凱基-永和,2023-02-02,9207
1524,耿鼎,12,0,12,凱基-永和,2023-02-02,9207
2009,第一銅,12,0,12,凱基-永和,2023-02-02,9207
6411,晶焱,12,0,12,凱基-永和,2023-02-02,9207
00696B,富邦美債20年,12,0,12,凱基-永和,2023-02-02,9207
00637L,元大滬深300正2,12,1,11,凱基-永和,2023-02-02,9207
1560,中砂,13,2,11,凱基-永和,2023-02-02,9207
2401,凌陽,11,1,10,凱基-永和,2023-02-02,9207
8070,長華*,10,0,10,凱基-永和,2023-02-02,9207
8996,高力,11,1,10,凱基-永和,2023-02-02,9207
2618,長榮航,18,9,9,凱基-永和,2023-02-02,9207
1609,大亞,20,12,8,凱基-永和,2023-02-02,9207
2633,台灣高鐵,8,0,8,凱基-永和,2023-02-02,9207
3189,景碩,16,8,8,凱基-永和,2023-02-02,9207
0056,元大高股息,11,4,7,凱基-永和,2023-02-02,9207
00715L,期街口布蘭特正2,6,0,6,凱基-永和,2023-02-02,9207
2367,燿華,12,6,6,凱基-永和,2023-02-02,9207
3324,雙鴻,6,0,6,凱基-永和,2023-02-02,9207
4566,時碩工業,6,0,6,凱基-永和,2023-02-02,9207
2609,陽明,16,10,6,凱基-永和,2023-02-02,9207
2014,中鴻,5,0,5,凱基-永和,2023-02-02,9207
00900,富邦特選高股息30,5,0,5,凱基-永和,2023-02-02,9207
1526,日馳,5,0,5,凱基-永和,2023-02-02,9207
3023,信邦,8,3,5,凱基-永和,2023-02-02,9207
3207,耀勝,5,0,5,凱基-永和,2023-02-02,9207
3682,亞太電,831,29,802,凱基-永和,2023-02-03,9207
1760,寶齡富錦,140,1,139,凱基-永和,2023-02-03,9207
6548,長科*,165,36,129,凱基-永和,2023-02-03,9207
6643,M31,60,0,60,凱基-永和,2023-02-03,9207
1218,泰山,50,0,50,凱基-永和,2023-02-03,9207
6245,立端,51,3,48,凱基-永和,2023-02-03,9207
6104,創惟,47,4,43,凱基-永和,2023-02-03,9207
6531,愛普*,41,0,41,凱基-永和,2023-02-03,9207
00632R,元大台灣50反1,40,0,40,凱基-永和,2023-02-03,9207
1101,台泥,39,0,39,凱基-永和,2023-02-03,9207
3498,陽程,37,0,37,凱基-永和,2023-02-03,9207
1809,中釉,46,12,34,凱基-永和,2023-02-03,9207
3289,宜特,32,0,32,凱基-永和,2023-02-03,9207
2641,正德,27,0,27,凱基-永和,2023-02-03,9207
1513,中興電,25,0,25,凱基-永和,2023-02-03,9207
1219,福壽,20,0,20,凱基-永和,2023-02-03,9207
00687B,國泰20年美債,20,0,20,凱基-永和,2023-02-03,9207
00637L,元大滬深300正2,18,0,18,凱基-永和,2023-02-03,9207
2610,華航,19,1,18,凱基-永和,2023-02-03,9207
2618,長榮航,19,2,17,凱基-永和,2023-02-03,9207
2344,華邦電,22,7,15,凱基-永和,2023-02-03,9207
4564,元翎,20,5,15,凱基-永和,2023-02-03,9207
2891,中信金,15,0,15,凱基-永和,2023-02-03,9207
5258,虹堡,19,5,14,凱基-永和,2023-02-03,9207
00893,國泰智能電動車,14,0,14,凱基-永和,2023-02-03,9207
1103,嘉泥,13,0,13,凱基-永和,2023-02-03,9207
1560,中砂,13,1,12,凱基-永和,2023-02-03,9207
5324,士開,12,0,12,凱基-永和,2023-02-03,9207
2882,國泰金,12,0,12,凱基-永和,2023-02-03,9207
00878,國泰永續高股息,16,6,10,凱基-永和,2023-02-03,9207
2104,國際中橡,12,2,10,凱基-永和,2023-02-03,9207
2401,凌陽,20,10,10,凱基-永和,2023-02-03,9207
2851,中再保,10,0,10,凱基-永和,2023-02-03,9207
2303,聯電,12,3,9,凱基-永和,2023-02-03,9207
5222,全訊,8,0,8,凱基-永和,2023-02-03,9207
5351,鈺創,19,11,8,凱基-永和,2023-02-03,9207
00882,中信中國高股息,7,0,7,凱基-永和,2023-02-03,9207
2376,技嘉,7,0,7,凱基-永和,2023-02-03,9207
3037,欣興,38,31,7,凱基-永和,2023-02-03,9207
00665L,富邦�琤肭磪囓�2,6,0,6,凱基-永和,2023-02-03,9207
2329,華泰,6,0,6,凱基-永和,2023-02-03,9207
3047,訊舟,6,0,6,凱基-永和,2023-02-03,9207
2317,鴻海,7,2,5,凱基-永和,2023-02-03,9207
00885,富邦越南,5,0,5,凱基-永和,2023-02-03,9207
2034,允強,5,0,5,凱基-永和,2023-02-03,9207
2464,盟立,5,0,5,凱基-永和,2023-02-03,9207
3346,麗清,5,0,5,凱基-永和,2023-02-03,9207
3624,光頡,5,0,5,凱基-永和,2023-02-03,9207
3706,神達,5,0,5,凱基-永和,2023-02-03,9207
3715,定穎投控,5,0,5,凱基-永和,2023-02-03,9207
6282,康舒,351,1,350,凱基-永和,2023-02-06,9207
1760,寶齡富錦,94,0,94,凱基-永和,2023-02-06,9207
6235,華孚,115,26,89,凱基-永和,2023-02-06,9207
00878,國泰永續高股息,43,0,43,凱基-永和,2023-02-06,9207
3037,欣興,27,1,26,凱基-永和,2023-02-06,9207
2609,陽明,40,15,25,凱基-永和,2023-02-06,9207
00900,富邦特選高股息30,22,0,22,凱基-永和,2023-02-06,9207
00893,國泰智能電動車,22,0,22,凱基-永和,2023-02-06,9207
2484,希華,20,0,20,凱基-永和,2023-02-06,9207
0056,元大高股息,29,11,18,凱基-永和,2023-02-06,9207
00715L,期街口布蘭特正2,15,0,15,凱基-永和,2023-02-06,9207
1219,福壽,14,0,14,凱基-永和,2023-02-06,9207
4726,永昕,12,0,12,凱基-永和,2023-02-06,9207
1304,台聚,10,0,10,凱基-永和,2023-02-06,9207
00753L,中信中國50正2,10,0,10,凱基-永和,2023-02-06,9207
2634,漢翔,10,0,10,凱基-永和,2023-02-06,9207
4129,聯合,10,0,10,凱基-永和,2023-02-06,9207
9904,寶成,10,0,10,凱基-永和,2023-02-06,9207
3189,景碩,10,1,9,凱基-永和,2023-02-06,9207
00679B,元大美債20年,9,0,9,凱基-永和,2023-02-06,9207
00637L,元大滬深300正2,12,3,9,凱基-永和,2023-02-06,9207
00642U,期元大S＆P石油,8,0,8,凱基-永和,2023-02-06,9207
2367,燿華,10,2,8,凱基-永和,2023-02-06,9207
8215,明基材,9,1,8,凱基-永和,2023-02-06,9207
2603,長榮,9,1,8,凱基-永和,2023-02-06,9207
00632R,元大台灣50反1,7,0,7,凱基-永和,2023-02-06,9207
2014,中鴻,6,0,6,凱基-永和,2023-02-06,9207
2886,兆豐金,6,0,6,凱基-永和,2023-02-06,9207
3036,文曄,7,2,5,凱基-永和,2023-02-06,9207
1522,堤維西,5,0,5,凱基-永和,2023-02-06,9207
00772B,中信高評級公司債,5,0,5,凱基-永和,2023-02-06,9207
2027,大成鋼,5,0,5,凱基-永和,2023-02-06,9207
2464,盟立,5,0,5,凱基-永和,2023-02-06,9207
5009,榮剛,5,0,5,凱基-永和,2023-02-06,9207
6182,合晶,5,0,5,凱基-永和,2023-02-06,9207
6231,系微,5,0,5,凱基-永和,2023-02-06,9207
00882,中信中國高股息,15,10,5,凱基-永和,2023-02-06,9207
1101,台泥,22,18,4,凱基-永和,2023-02-06,9207
5347,世界,4,0,4,凱基-永和,2023-02-06,9207
1560,中砂,10,6,4,凱基-永和,2023-02-06,9207
1609,大亞,4,0,4,凱基-永和,2023-02-06,9207
2368,金像電,4,0,4,凱基-永和,2023-02-06,9207
2497,怡利電,4,0,4,凱基-永和,2023-02-06,9207
2498,宏達電,28,24,4,凱基-永和,2023-02-06,9207
4566,時碩工業,4,0,4,凱基-永和,2023-02-06,9207
6180,橘子,6,2,4,凱基-永和,2023-02-06,9207
2330,台積電,4,0,4,凱基-永和,2023-02-06,9207
8046,南電,3,0,3,凱基-永和,2023-02-06,9207
00881,國泰台灣5G+,3,0,3,凱基-永和,2023-02-06,9207
1909,榮成,3,0,3,凱基-永和,2023-02-06,9207
2867,三商壽,100,0,100,凱基-永和,2023-02-07,9207
6472,保瑞,94,4,90,凱基-永和,2023-02-07,9207
2340,台亞,50,0,50,凱基-永和,2023-02-07,9207
1506,正道,44,0,44,凱基-永和,2023-02-07,9207
1584,精剛,40,1,39,凱基-永和,2023-02-07,9207
00878,國泰永續高股息,34,0,34,凱基-永和,2023-02-07,9207
6245,立端,32,0,32,凱基-永和,2023-02-07,9207
00893,國泰智能電動車,29,0,29,凱基-永和,2023-02-07,9207
2009,第一銅,28,0,28,凱基-永和,2023-02-07,9207
2801,彰銀,21,1,20,凱基-永和,2023-02-07,9207
8916,光隆,20,1,19,凱基-永和,2023-02-07,9207
00676R,富邦臺灣加權反1,14,0,14,凱基-永和,2023-02-07,9207
3219,倚強科,14,0,14,凱基-永和,2023-02-07,9207
2201,裕隆,15,2,13,凱基-永和,2023-02-07,9207
00795B,中信美國公債20年,10,0,10,凱基-永和,2023-02-07,9207
1219,福壽,10,0,10,凱基-永和,2023-02-07,9207
4160,訊聯基因,10,0,10,凱基-永和,2023-02-07,9207
6441,廣錠,65,55,10,凱基-永和,2023-02-07,9207
8070,長華*,10,0,10,凱基-永和,2023-02-07,9207
1342,八貫,13,4,9,凱基-永和,2023-02-07,9207
00715L,期街口布蘭特正2,10,1,9,凱基-永和,2023-02-07,9207
1560,中砂,9,1,8,凱基-永和,2023-02-07,9207
2368,金像電,8,0,8,凱基-永和,2023-02-07,9207
3481,群創,11,3,8,凱基-永和,2023-02-07,9207
1605,華新,20,13,7,凱基-永和,2023-02-07,9207
2891,中信金,7,0,7,凱基-永和,2023-02-07,9207
00679B,元大美債20年,6,0,6,凱基-永和,2023-02-07,9207
2367,燿華,6,0,6,凱基-永和,2023-02-07,9207
2458,義隆,6,0,6,凱基-永和,2023-02-07,9207
2887,台新金,18,12,6,凱基-永和,2023-02-07,9207
00753L,中信中國50正2,5,0,5,凱基-永和,2023-02-07,9207
1734,杏輝,10,5,5,凱基-永和,2023-02-07,9207
2474,可成,5,0,5,凱基-永和,2023-02-07,9207
3413,京鼎,5,0,5,凱基-永和,2023-02-07,9207
4123,晟德,5,0,5,凱基-永和,2023-02-07,9207
4564,元翎,5,0,5,凱基-永和,2023-02-07,9207
6509,聚和,5,0,5,凱基-永和,2023-02-07,9207
8171,天宇,5,0,5,凱基-永和,2023-02-07,9207
0056,元大高股息,6,1,5,凱基-永和,2023-02-07,9207
0050,元大台灣50,4,0,4,凱基-永和,2023-02-07,9207
2303,聯電,12,8,4,凱基-永和,2023-02-07,9207
1104,環泥,4,0,4,凱基-永和,2023-02-07,9207
00637L,元大滬深300正2,9,5,4,凱基-永和,2023-02-07,9207
1731,美吾華,4,0,4,凱基-永和,2023-02-07,9207
2328,廣宇,4,0,4,凱基-永和,2023-02-07,9207
5353,台林,4,0,4,凱基-永和,2023-02-07,9207
6532,瑞耘,4,0,4,凱基-永和,2023-02-07,9207
6589,台康生技,7,3,4,凱基-永和,2023-02-07,9207
00642U,期元大S＆P石油,3,0,3,凱基-永和,2023-02-07,9207
1701,中化,3,0,3,凱基-永和,2023-02-07,9207
5483,中美晶,170,0,170,凱基-永和,2023-02-08,9207
3661,世芯-KY,65,1,64,凱基-永和,2023-02-08,9207
2340,台亞,50,0,50,凱基-永和,2023-02-08,9207
6244,茂迪,40,0,40,凱基-永和,2023-02-08,9207
3035,智原,44,22,22,凱基-永和,2023-02-08,9207
4128,中天,27,6,21,凱基-永和,2023-02-08,9207
2007,燁興,19,0,19,凱基-永和,2023-02-08,9207
00878,國泰永續高股息,24,6,18,凱基-永和,2023-02-08,9207
8171,天宇,98,82,16,凱基-永和,2023-02-08,9207
8476,台境*,14,0,14,凱基-永和,2023-02-08,9207
2834,臺企銀,13,1,12,凱基-永和,2023-02-08,9207
2888,新光金,12,0,12,凱基-永和,2023-02-08,9207
6781,AES-KY,12,0,12,凱基-永和,2023-02-08,9207
2313,華通,16,5,11,凱基-永和,2023-02-08,9207
2453,凌群,11,0,11,凱基-永和,2023-02-08,9207
1444,力麗,10,0,10,凱基-永和,2023-02-08,9207
00687B,國泰20年美債,10,0,10,凱基-永和,2023-02-08,9207
00670L,富邦NASDAQ正2,10,0,10,凱基-永和,2023-02-08,9207
1219,福壽,10,0,10,凱基-永和,2023-02-08,9207
4958,臻鼎-KY,10,0,10,凱基-永和,2023-02-08,9207
5258,虹堡,12,2,10,凱基-永和,2023-02-08,9207
6235,華孚,42,32,10,凱基-永和,2023-02-08,9207
8033,雷虎,10,0,10,凱基-永和,2023-02-08,9207
8289,泰藝,10,0,10,凱基-永和,2023-02-08,9207
2618,長榮航,11,2,9,凱基-永和,2023-02-08,9207
00882,中信中國高股息,9,0,9,凱基-永和,2023-02-08,9207
3189,景碩,12,4,8,凱基-永和,2023-02-08,9207
2460,建通,8,0,8,凱基-永和,2023-02-08,9207
3706,神達,8,0,8,凱基-永和,2023-02-08,9207
5234,達興材料,8,0,8,凱基-永和,2023-02-08,9207
00679B,元大美債20年,7,0,7,凱基-永和,2023-02-08,9207
2029,盛餘,6,0,6,凱基-永和,2023-02-08,9207
2455,全新,6,0,6,凱基-永和,2023-02-08,9207
3615,安可,6,0,6,凱基-永和,2023-02-08,9207
6223,旺矽,26,20,6,凱基-永和,2023-02-08,9207
6695,芯鼎,6,0,6,凱基-永和,2023-02-08,9207
1453,大將,115,110,5,凱基-永和,2023-02-08,9207
1513,中興電,5,0,5,凱基-永和,2023-02-08,9207
00885,富邦越南,5,0,5,凱基-永和,2023-02-08,9207
00795B,中信美國公債20年,5,0,5,凱基-永和,2023-02-08,9207
2329,華泰,5,0,5,凱基-永和,2023-02-08,9207
2404,漢唐,5,0,5,凱基-永和,2023-02-08,9207
4979,華星光,11,6,5,凱基-永和,2023-02-08,9207
6415,矽力*-KY,5,0,5,凱基-永和,2023-02-08,9207
8046,南電,13,8,5,凱基-永和,2023-02-08,9207
2609,陽明,5,1,4,凱基-永和,2023-02-08,9207
00772B,中信高評級公司債,4,0,4,凱基-永和,2023-02-08,9207
2367,燿華,6,2,4,凱基-永和,2023-02-08,9207
2412,中華電,5,1,4,凱基-永和,2023-02-08,9207
3163,波若威,4,0,4,凱基-永和,2023-02-08,9207
00878,國泰永續高股息,90,2,88,凱基-永和,2023-02-09,9207
2340,台亞,75,0,75,凱基-永和,2023-02-09,9207
2498,宏達電,62,3,59,凱基-永和,2023-02-09,9207
2401,凌陽,50,0,50,凱基-永和,2023-02-09,9207
3037,欣興,35,6,29,凱基-永和,2023-02-09,9207
00679B,元大美債20年,23,0,23,凱基-永和,2023-02-09,9207
5340,建榮,23,0,23,凱基-永和,2023-02-09,9207
6118,建達,42,22,20,凱基-永和,2023-02-09,9207
2201,裕隆,18,1,17,凱基-永和,2023-02-09,9207
00772B,中信高評級公司債,16,0,16,凱基-永和,2023-02-09,9207
1219,福壽,15,0,15,凱基-永和,2023-02-09,9207
2465,麗臺,15,0,15,凱基-永和,2023-02-09,9207
6509,聚和,20,5,15,凱基-永和,2023-02-09,9207
2618,長榮航,42,28,14,凱基-永和,2023-02-09,9207
1101,台泥,19,7,12,凱基-永和,2023-02-09,9207
00882,中信中國高股息,11,0,11,凱基-永和,2023-02-09,9207
00713,元大台灣高息低波,11,0,11,凱基-永和,2023-02-09,9207
4128,中天,13,2,11,凱基-永和,2023-02-09,9207
3680,家登,60,50,10,凱基-永和,2023-02-09,9207
00751B,元大AAA至A公司債,10,0,10,凱基-永和,2023-02-09,9207
2028,威致,10,0,10,凱基-永和,2023-02-09,9207
2867,三商壽,10,0,10,凱基-永和,2023-02-09,9207
6217,中探針,10,0,10,凱基-永和,2023-02-09,9207
6282,康舒,17,7,10,凱基-永和,2023-02-09,9207
6517,保勝光學,10,0,10,凱基-永和,2023-02-09,9207
6552,易華電,10,0,10,凱基-永和,2023-02-09,9207
4566,時碩工業,9,0,9,凱基-永和,2023-02-09,9207
2603,長榮,9,0,9,凱基-永和,2023-02-09,9207
1515,力山,9,0,9,凱基-永和,2023-02-09,9207
3706,神達,9,0,9,凱基-永和,2023-02-09,9207
6180,橘子,12,3,9,凱基-永和,2023-02-09,9207
1584,精剛,12,4,8,凱基-永和,2023-02-09,9207
2368,金像電,8,0,8,凱基-永和,2023-02-09,9207
2303,聯電,8,1,7,凱基-永和,2023-02-09,9207
3088,艾訊,7,0,7,凱基-永和,2023-02-09,9207
00670L,富邦NASDAQ正2,7,0,7,凱基-永和,2023-02-09,9207
6770,力積電,8,1,7,凱基-永和,2023-02-09,9207
00893,國泰智能電動車,6,0,6,凱基-永和,2023-02-09,9207
2329,華泰,6,0,6,凱基-永和,2023-02-09,9207
3264,欣銓,6,0,6,凱基-永和,2023-02-09,9207
6443,元晶,6,0,6,凱基-永和,2023-02-09,9207
2404,漢唐,5,0,5,凱基-永和,2023-02-09,9207
4564,元翎,5,0,5,凱基-永和,2023-02-09,9207
4960,誠美材,5,0,5,凱基-永和,2023-02-09,9207
5880,合庫金,5,0,5,凱基-永和,2023-02-09,9207
6505,台塑化,5,0,5,凱基-永和,2023-02-09,9207
6706,惠特,5,0,5,凱基-永和,2023-02-09,9207
6763,綠界科技*,5,0,5,凱基-永和,2023-02-09,9207
8049,晶采,5,0,5,凱基-永和,2023-02-09,9207
9904,寶成,5,0,5,凱基-永和,2023-02-09,9207
6282,康舒,314,10,304,凱基-永和,2023-02-10,9207
2340,台亞,75,0,75,凱基-永和,2023-02-10,9207
00878,國泰永續高股息,75,2,73,凱基-永和,2023-02-10,9207
2634,漢翔,127,54,73,凱基-永和,2023-02-10,9207
6116,彩晶,43,0,43,凱基-永和,2023-02-10,9207
6472,保瑞,55,18,37,凱基-永和,2023-02-10,9207
2609,陽明,24,0,24,凱基-永和,2023-02-10,9207
6517,保勝光學,20,0,20,凱基-永和,2023-02-10,9207
1701,中化,21,2,19,凱基-永和,2023-02-10,9207
4979,華星光,28,10,18,凱基-永和,2023-02-10,9207
3037,欣興,18,1,17,凱基-永和,2023-02-10,9207
2317,鴻海,21,5,16,凱基-永和,2023-02-10,9207
6509,聚和,20,7,13,凱基-永和,2023-02-10,9207
00751B,元大AAA至A公司債,11,0,11,凱基-永和,2023-02-10,9207
1742,台蠟,10,0,10,凱基-永和,2023-02-10,9207
1810,和成,12,2,10,凱基-永和,2023-02-10,9207
2006,東和鋼鐵,10,0,10,凱基-永和,2023-02-10,9207
2027,大成鋼,10,0,10,凱基-永和,2023-02-10,9207
2883,凱基金,10,0,10,凱基-永和,2023-02-10,9207
3576,聯合再生,10,0,10,凱基-永和,2023-02-10,9207
5410,國眾,10,0,10,凱基-永和,2023-02-10,9207
3498,陽程,9,0,9,凱基-永和,2023-02-10,9207
0056,元大高股息,7,0,7,凱基-永和,2023-02-10,9207
4729,熒茂,7,0,7,凱基-永和,2023-02-10,9207
2603,長榮,8,2,6,凱基-永和,2023-02-10,9207
1605,華新,11,5,6,凱基-永和,2023-02-10,9207
00720B,元大投資級公司債,6,0,6,凱基-永和,2023-02-10,9207
2409,友達,7,1,6,凱基-永和,2023-02-10,9207
2929,淘帝-KY,6,0,6,凱基-永和,2023-02-10,9207
6269,台郡,6,0,6,凱基-永和,2023-02-10,9207
6531,愛普*,6,0,6,凱基-永和,2023-02-10,9207
8358,金居,6,0,6,凱基-永和,2023-02-10,9207
0050,元大台灣50,6,0,6,凱基-永和,2023-02-10,9207
8069,元太,10,5,5,凱基-永和,2023-02-10,9207
2915,潤泰全,5,0,5,凱基-永和,2023-02-10,9207
3033,威健,5,0,5,凱基-永和,2023-02-10,9207
2404,漢唐,5,0,5,凱基-永和,2023-02-10,9207
1584,精剛,36,31,5,凱基-永和,2023-02-10,9207
1219,福壽,5,0,5,凱基-永和,2023-02-10,9207
2313,華通,5,0,5,凱基-永和,2023-02-10,9207
2465,麗臺,5,0,5,凱基-永和,2023-02-10,9207
2607,榮運,5,0,5,凱基-永和,2023-02-10,9207
3013,晟銘電,5,0,5,凱基-永和,2023-02-10,9207
3615,安可,5,0,5,凱基-永和,2023-02-10,9207
4968,立積,5,0,5,凱基-永和,2023-02-10,9207
5351,鈺創,7,2,5,凱基-永和,2023-02-10,9207
6109,亞元,5,0,5,凱基-永和,2023-02-10,9207
6188,廣明,5,0,5,凱基-永和,2023-02-10,9207
8070,長華*,5,0,5,凱基-永和,2023-02-10,9207
2101,南港,20,15,5,凱基-永和,2023-02-10,9207
00878,國泰永續高股息,76,12,64,凱基-永和,2023-02-13,9207
2340,台亞,50,0,50,凱基-永和,2023-02-13,9207
2634,漢翔,46,2,44,凱基-永和,2023-02-13,9207
00679B,元大美債20年,35,0,35,凱基-永和,2023-02-13,9207
3494,誠研,30,0,30,凱基-永和,2023-02-13,9207
2409,友達,29,0,29,凱基-永和,2023-02-13,9207
00751B,元大AAA至A公司債,26,0,26,凱基-永和,2023-02-13,9207
2314,台揚,24,4,20,凱基-永和,2023-02-13,9207
5340,建榮,20,0,20,凱基-永和,2023-02-13,9207
2404,漢唐,20,0,20,凱基-永和,2023-02-13,9207
2332,友訊,16,0,16,凱基-永和,2023-02-13,9207
6770,力積電,15,0,15,凱基-永和,2023-02-13,9207
2303,聯電,15,2,13,凱基-永和,2023-02-13,9207
2101,南港,13,0,13,凱基-永和,2023-02-13,9207
1519,華城,11,0,11,凱基-永和,2023-02-13,9207
6116,彩晶,11,0,11,凱基-永和,2023-02-13,9207
00670L,富邦NASDAQ正2,10,0,10,凱基-永和,2023-02-13,9207
1717,長興,10,0,10,凱基-永和,2023-02-13,9207
2610,華航,11,1,10,凱基-永和,2023-02-13,9207
3162,精確,10,0,10,凱基-永和,2023-02-13,9207
4114,健喬,12,2,10,凱基-永和,2023-02-13,9207
6191,精成科,10,0,10,凱基-永和,2023-02-13,9207
2453,凌群,8,0,8,凱基-永和,2023-02-13,9207
2834,臺企銀,11,3,8,凱基-永和,2023-02-13,9207
4160,訊聯基因,9,2,7,凱基-永和,2023-02-13,9207
6235,華孚,8,1,7,凱基-永和,2023-02-13,9207
00720B,元大投資級公司債,6,0,6,凱基-永和,2023-02-13,9207
00673R,期元大S＆P原油反1,6,0,6,凱基-永和,2023-02-13,9207
00773B,中信優先金融債,5,0,5,凱基-永和,2023-02-13,9207
00900,富邦特選高股息30,5,0,5,凱基-永和,2023-02-13,9207
00671R,富邦NASDAQ反1,5,0,5,凱基-永和,2023-02-13,9207
1605,華新,6,1,5,凱基-永和,2023-02-13,9207
1701,中化,7,2,5,凱基-永和,2023-02-13,9207
1795,美時,13,8,5,凱基-永和,2023-02-13,9207
2027,大成鋼,5,0,5,凱基-永和,2023-02-13,9207
3207,耀勝,15,10,5,凱基-永和,2023-02-13,9207
3498,陽程,5,0,5,凱基-永和,2023-02-13,9207
4564,元翎,5,0,5,凱基-永和,2023-02-13,9207
5410,國眾,5,0,5,凱基-永和,2023-02-13,9207
6180,橘子,6,1,5,凱基-永和,2023-02-13,9207
6806,森崴能源,42,37,5,凱基-永和,2023-02-13,9207
00687B,國泰20年美債,4,0,4,凱基-永和,2023-02-13,9207
1104,環泥,4,0,4,凱基-永和,2023-02-13,9207
00795B,中信美國公債20年,4,0,4,凱基-永和,2023-02-13,9207
2897,王道銀行,4,0,4,凱基-永和,2023-02-13,9207
4979,華星光,7,3,4,凱基-永和,2023-02-13,9207
8033,雷虎,4,0,4,凱基-永和,2023-02-13,9207
8046,南電,3,0,3,凱基-永和,2023-02-13,9207
2603,長榮,7,4,3,凱基-永和,2023-02-13,9207
2891,中信金,5,2,3,凱基-永和,2023-02-13,9207
3438,類比科,60,0,60,凱基-永和,2023-02-14,9207
00878,國泰永續高股息,47,0,47,凱基-永和,2023-02-14,9207
1734,杏輝,30,0,30,凱基-永和,2023-02-14,9207
8478,東哥遊艇,31,1,30,凱基-永和,2023-02-14,9207
1605,華新,25,3,22,凱基-永和,2023-02-14,9207
2641,正德,21,0,21,凱基-永和,2023-02-14,9207
5410,國眾,17,0,17,凱基-永和,2023-02-14,9207
00882,中信中國高股息,16,0,16,凱基-永和,2023-02-14,9207
6180,橘子,46,32,14,凱基-永和,2023-02-14,9207
1503,士電,12,0,12,凱基-永和,2023-02-14,9207
4979,華星光,12,0,12,凱基-永和,2023-02-14,9207
2404,漢唐,11,0,11,凱基-永和,2023-02-14,9207
00670L,富邦NASDAQ正2,10,0,10,凱基-永和,2023-02-14,9207
2367,燿華,10,0,10,凱基-永和,2023-02-14,9207
6806,森崴能源,19,10,9,凱基-永和,2023-02-14,9207
2351,順德,10,3,7,凱基-永和,2023-02-14,9207
1701,中化,9,2,7,凱基-永和,2023-02-14,9207
00752,中信中國50,7,0,7,凱基-永和,2023-02-14,9207
5904,寶雅,7,0,7,凱基-永和,2023-02-14,9207
6005,群益證,7,0,7,凱基-永和,2023-02-14,9207
3265,台星科,6,0,6,凱基-永和,2023-02-14,9207
6509,聚和,7,1,6,凱基-永和,2023-02-14,9207
8069,元太,13,8,5,凱基-永和,2023-02-14,9207
00671R,富邦NASDAQ反1,5,0,5,凱基-永和,2023-02-14,9207
2017,官田鋼,5,0,5,凱基-永和,2023-02-14,9207
2027,大成鋼,5,0,5,凱基-永和,2023-02-14,9207
2201,裕隆,6,1,5,凱基-永和,2023-02-14,9207
2371,大同,5,0,5,凱基-永和,2023-02-14,9207
2834,臺企銀,5,0,5,凱基-永和,2023-02-14,9207
2929,淘帝-KY,5,0,5,凱基-永和,2023-02-14,9207
5531,鄉林,5,0,5,凱基-永和,2023-02-14,9207
00673R,期元大S＆P原油反1,4,0,4,凱基-永和,2023-02-14,9207
00720B,元大投資級公司債,4,0,4,凱基-永和,2023-02-14,9207
2486,一詮,4,0,4,凱基-永和,2023-02-14,9207
2734,易飛網,4,0,4,凱基-永和,2023-02-14,9207
3006,晶豪科,4,0,4,凱基-永和,2023-02-14,9207
3704,合勤控,7,3,4,凱基-永和,2023-02-14,9207
1584,精剛,7,4,3,凱基-永和,2023-02-14,9207
00830,國泰費城半導體,3,0,3,凱基-永和,2023-02-14,9207
2023,燁輝,3,0,3,凱基-永和,2023-02-14,9207
2338,光罩,3,0,3,凱基-永和,2023-02-14,9207
3701,大眾控,3,0,3,凱基-永和,2023-02-14,9207
4160,訊聯基因,3,0,3,凱基-永和,2023-02-14,9207
4729,熒茂,3,0,3,凱基-永和,2023-02-14,9207
4977,眾達-KY,4,1,3,凱基-永和,2023-02-14,9207
5351,鈺創,3,0,3,凱基-永和,2023-02-14,9207
9942,茂順,3,0,3,凱基-永和,2023-02-14,9207
00679B,元大美債20年,3,0,3,凱基-永和,2023-02-14,9207
1795,美時,5,3,2,凱基-永和,2023-02-14,9207
6104,創惟,124,122,2,凱基-永和,2023-02-14,9207
00878,國泰永續高股息,195,14,181,凱基-永和,2023-02-15,9207
2892,第一金,93,0,93,凱基-永和,2023-02-15,9207
2886,兆豐金,67,0,67,凱基-永和,2023-02-15,9207
2340,台亞,50,0,50,凱基-永和,2023-02-15,9207
6523,達爾膚,40,0,40,凱基-永和,2023-02-15,9207
2618,長榮航,31,0,31,凱基-永和,2023-02-15,9207
2027,大成鋼,24,1,23,凱基-永和,2023-02-15,9207
0050,元大台灣50,19,1,18,凱基-永和,2023-02-15,9207
2888,新光金,18,3,15,凱基-永和,2023-02-15,9207
5706,鳳凰,21,7,14,凱基-永和,2023-02-15,9207
8097,常珵,13,0,13,凱基-永和,2023-02-15,9207
2882,國泰金,15,3,12,凱基-永和,2023-02-15,9207
3406,玉晶光,10,0,10,凱基-永和,2023-02-15,9207
2014,中鴻,10,0,10,凱基-永和,2023-02-15,9207
2371,大同,10,0,10,凱基-永和,2023-02-15,9207
3508,位速,10,0,10,凱基-永和,2023-02-15,9207
6441,廣錠,10,0,10,凱基-永和,2023-02-15,9207
1536,和大,9,1,8,凱基-永和,2023-02-15,9207
2329,華泰,8,0,8,凱基-永和,2023-02-15,9207
4160,訊聯基因,8,0,8,凱基-永和,2023-02-15,9207
6477,安集,8,0,8,凱基-永和,2023-02-15,9207
00679B,元大美債20年,11,3,8,凱基-永和,2023-02-15,9207
2891,中信金,7,0,7,凱基-永和,2023-02-15,9207
2344,華邦電,10,3,7,凱基-永和,2023-02-15,9207
3265,台星科,6,0,6,凱基-永和,2023-02-15,9207
4564,元翎,6,0,6,凱基-永和,2023-02-15,9207
00671R,富邦NASDAQ反1,5,0,5,凱基-永和,2023-02-15,9207
2201,裕隆,10,5,5,凱基-永和,2023-02-15,9207
2929,淘帝-KY,5,0,5,凱基-永和,2023-02-15,9207
2330,台積電,16,12,4,凱基-永和,2023-02-15,9207
00673R,期元大S＆P原油反1,4,0,4,凱基-永和,2023-02-15,9207
2486,一詮,4,0,4,凱基-永和,2023-02-15,9207
2889,國票金,4,0,4,凱基-永和,2023-02-15,9207
3128,昇銳,4,0,4,凱基-永和,2023-02-15,9207
3498,陽程,4,0,4,凱基-永和,2023-02-15,9207
3701,大眾控,4,0,4,凱基-永和,2023-02-15,9207
4533,協易機,4,0,4,凱基-永和,2023-02-15,9207
5704,老爺知,4,0,4,凱基-永和,2023-02-15,9207
8931,大汽電,9,5,4,凱基-永和,2023-02-15,9207
006208,富邦台50,3,0,3,凱基-永和,2023-02-15,9207
1512,瑞利,3,0,3,凱基-永和,2023-02-15,9207
1514,亞力,3,0,3,凱基-永和,2023-02-15,9207
0056,元大高股息,3,0,3,凱基-永和,2023-02-15,9207
00916,國泰全球品牌50,3,0,3,凱基-永和,2023-02-15,9207
1734,杏輝,3,0,3,凱基-永和,2023-02-15,9207
2515,中工,3,0,3,凱基-永和,2023-02-15,9207
2609,陽明,5,2,3,凱基-永和,2023-02-15,9207
2880,華南金,3,0,3,凱基-永和,2023-02-15,9207
3209,全科,3,0,3,凱基-永和,2023-02-15,9207
4128,中天,3,0,3,凱基-永和,2023-02-15,9207
5425,台半,332,6,326,凱基-永和,2023-02-16,9207
00878,國泰永續高股息,116,35,81,凱基-永和,2023-02-16,9207
8996,高力,61,0,61,凱基-永和,2023-02-16,9207
3289,宜特,121,70,51,凱基-永和,2023-02-16,9207
00632R,元大台灣50反1,45,0,45,凱基-永和,2023-02-16,9207
1714,和桐,30,0,30,凱基-永和,2023-02-16,9207
2886,兆豐金,40,11,29,凱基-永和,2023-02-16,9207
1101,台泥,25,0,25,凱基-永和,2023-02-16,9207
2340,台亞,25,0,25,凱基-永和,2023-02-16,9207
6224,聚鼎,20,0,20,凱基-永和,2023-02-16,9207
6581,鋼聯,20,0,20,凱基-永和,2023-02-16,9207
00679B,元大美債20年,18,0,18,凱基-永和,2023-02-16,9207
6282,康舒,18,0,18,凱基-永和,2023-02-16,9207
1513,中興電,14,0,14,凱基-永和,2023-02-16,9207
4160,訊聯基因,12,0,12,凱基-永和,2023-02-16,9207
2883,凱基金,12,0,12,凱基-永和,2023-02-16,9207
2484,希華,13,2,11,凱基-永和,2023-02-16,9207
6603,富強鑫,12,1,11,凱基-永和,2023-02-16,9207
00671R,富邦NASDAQ反1,10,0,10,凱基-永和,2023-02-16,9207
2367,燿華,10,0,10,凱基-永和,2023-02-16,9207
2634,漢翔,10,0,10,凱基-永和,2023-02-16,9207
6411,晶焱,10,1,9,凱基-永和,2023-02-16,9207
4533,協易機,9,0,9,凱基-永和,2023-02-16,9207
1609,大亞,8,1,7,凱基-永和,2023-02-16,9207
2028,威致,7,0,7,凱基-永和,2023-02-16,9207
6643,M31,7,0,7,凱基-永和,2023-02-16,9207
2409,友達,18,11,7,凱基-永和,2023-02-16,9207
00687B,國泰20年美債,6,0,6,凱基-永和,2023-02-16,9207
2007,燁興,6,0,6,凱基-永和,2023-02-16,9207
2029,盛餘,6,0,6,凱基-永和,2023-02-16,9207
3264,欣銓,6,0,6,凱基-永和,2023-02-16,9207
3624,光頡,17,11,6,凱基-永和,2023-02-16,9207
8215,明基材,6,0,6,凱基-永和,2023-02-16,9207
1336,台翰,5,0,5,凱基-永和,2023-02-16,9207
4564,元翎,5,0,5,凱基-永和,2023-02-16,9207
6179,亞通,5,0,5,凱基-永和,2023-02-16,9207
6477,安集,5,0,5,凱基-永和,2023-02-16,9207
2369,菱生,5,0,5,凱基-永和,2023-02-16,9207
00720B,元大投資級公司債,5,0,5,凱基-永和,2023-02-16,9207
00751B,元大AAA至A公司債,4,0,4,凱基-永和,2023-02-16,9207
2063,世鎧,4,0,4,凱基-永和,2023-02-16,9207
2472,立隆電,6,2,4,凱基-永和,2023-02-16,9207
6278,台表科,4,0,4,凱基-永和,2023-02-16,9207
2889,國票金,4,0,4,凱基-永和,2023-02-16,9207
00681R,元大美債20反1,3,0,3,凱基-永和,2023-02-16,9207
1102,亞泥,4,1,3,凱基-永和,2023-02-16,9207
1727,中華化,3,0,3,凱基-永和,2023-02-16,9207
2812,台中銀,3,0,3,凱基-永和,2023-02-16,9207
3013,晟銘電,3,0,3,凱基-永和,2023-02-16,9207
3023,信邦,4,1,3,凱基-永和,2023-02-16,9207
5340,建榮,161,43,118,凱基-永和,2023-02-17,9207
3062,建漢,70,0,70,凱基-永和,2023-02-17,9207
2515,中工,50,0,50,凱基-永和,2023-02-17,9207
2867,三商壽,50,0,50,凱基-永和,2023-02-17,9207
6237,驊訊,39,0,39,凱基-永和,2023-02-17,9207
1442,名軒,30,0,30,凱基-永和,2023-02-17,9207
2314,台揚,30,0,30,凱基-永和,2023-02-17,9207
2888,新光金,30,2,28,凱基-永和,2023-02-17,9207
00679B,元大美債20年,22,0,22,凱基-永和,2023-02-17,9207
00680L,元大美債20正2,20,0,20,凱基-永和,2023-02-17,9207
00878,國泰永續高股息,21,4,17,凱基-永和,2023-02-17,9207
3704,合勤控,28,11,17,凱基-永和,2023-02-17,9207
6689,伊雲谷,17,0,17,凱基-永和,2023-02-17,9207
00751B,元大AAA至A公司債,15,0,15,凱基-永和,2023-02-17,9207
2489,瑞軒,25,10,15,凱基-永和,2023-02-17,9207
2546,根基,13,0,13,凱基-永和,2023-02-17,9207
3037,欣興,15,2,13,凱基-永和,2023-02-17,9207
00893,國泰智能電動車,12,0,12,凱基-永和,2023-02-17,9207
6523,達爾膚,15,4,11,凱基-永和,2023-02-17,9207
4160,訊聯基因,11,0,11,凱基-永和,2023-02-17,9207
2618,長榮航,24,13,11,凱基-永和,2023-02-17,9207
1514,亞力,10,0,10,凱基-永和,2023-02-17,9207
1611,中電,10,0,10,凱基-永和,2023-02-17,9207
1760,寶齡富錦,10,0,10,凱基-永和,2023-02-17,9207
2104,國際中橡,10,0,10,凱基-永和,2023-02-17,9207
2329,華泰,10,0,10,凱基-永和,2023-02-17,9207
3027,盛達,10,0,10,凱基-永和,2023-02-17,9207
3083,網龍,10,0,10,凱基-永和,2023-02-17,9207
4979,華星光,20,10,10,凱基-永和,2023-02-17,9207
6509,聚和,10,0,10,凱基-永和,2023-02-17,9207
8222,寶一,16,6,10,凱基-永和,2023-02-17,9207
1714,和桐,10,1,9,凱基-永和,2023-02-17,9207
00772B,中信高評級公司債,8,0,8,凱基-永和,2023-02-17,9207
2704,國賓,8,0,8,凱基-永和,2023-02-17,9207
6603,富強鑫,8,0,8,凱基-永和,2023-02-17,9207
5706,鳳凰,12,4,8,凱基-永和,2023-02-17,9207
00795B,中信美國公債20年,7,0,7,凱基-永和,2023-02-17,9207
4961,天鈺,16,9,7,凱基-永和,2023-02-17,9207
4105,東洋,6,0,6,凱基-永和,2023-02-17,9207
6271,同欣電,6,0,6,凱基-永和,2023-02-17,9207
2330,台積電,6,0,6,凱基-永和,2023-02-17,9207
3209,全科,9,4,5,凱基-永和,2023-02-17,9207
00639,富邦深100,5,0,5,凱基-永和,2023-02-17,9207
0056,元大高股息,7,2,5,凱基-永和,2023-02-17,9207
00900,富邦特選高股息30,5,0,5,凱基-永和,2023-02-17,9207
1784,訊聯,5,0,5,凱基-永和,2023-02-17,9207
2201,裕隆,6,1,5,凱基-永和,2023-02-17,9207
2929,淘帝-KY,5,0,5,凱基-永和,2023-02-17,9207
00892,富邦台灣半導體,4,0,4,凱基-永和,2023-02-17,9207
00687B,國泰20年美債,4,0,4,凱基-永和,2023-02-17,9207
3289,宜特,70,0,70,凱基-永和,2023-02-20,9207
2515,中工,50,6,44,凱基-永和,2023-02-20,9207
4503,金雨,31,0,31,凱基-永和,2023-02-20,9207
2888,新光金,20,0,20,凱基-永和,2023-02-20,9207
2030,彰源,20,0,20,凱基-永和,2023-02-20,9207
6118,建達,45,25,20,凱基-永和,2023-02-20,9207
00676R,富邦臺灣加權反1,15,0,15,凱基-永和,2023-02-20,9207
2891,中信金,13,0,13,凱基-永和,2023-02-20,9207
3356,奇偶,12,0,12,凱基-永和,2023-02-20,9207
6104,創惟,12,0,12,凱基-永和,2023-02-20,9207
8215,明基材,13,1,12,凱基-永和,2023-02-20,9207
4968,立積,12,0,12,凱基-永和,2023-02-20,9207
1104,環泥,10,0,10,凱基-永和,2023-02-20,9207
1760,寶齡富錦,10,0,10,凱基-永和,2023-02-20,9207
2104,國際中橡,10,0,10,凱基-永和,2023-02-20,9207
2329,華泰,10,0,10,凱基-永和,2023-02-20,9207
2340,台亞,15,5,10,凱基-永和,2023-02-20,9207
2484,希華,10,0,10,凱基-永和,2023-02-20,9207
2885,元大金,10,0,10,凱基-永和,2023-02-20,9207
6140,訊達,10,0,10,凱基-永和,2023-02-20,9207
8358,金居,13,3,10,凱基-永和,2023-02-20,9207
8996,高力,13,3,10,凱基-永和,2023-02-20,9207
1108,幸福,10,1,9,凱基-永和,2023-02-20,9207
3624,光頡,10,1,9,凱基-永和,2023-02-20,9207
5880,合庫金,11,2,9,凱基-永和,2023-02-20,9207
0056,元大高股息,8,0,8,凱基-永和,2023-02-20,9207
2009,第一銅,8,0,8,凱基-永和,2023-02-20,9207
2376,技嘉,8,0,8,凱基-永和,2023-02-20,9207
5512,力麒,10,3,7,凱基-永和,2023-02-20,9207
1708,東鹼,6,0,6,凱基-永和,2023-02-20,9207
1560,中砂,6,0,6,凱基-永和,2023-02-20,9207
2034,允強,6,0,6,凱基-永和,2023-02-20,9207
2206,三陽工業,6,0,6,凱基-永和,2023-02-20,9207
2313,華通,6,0,6,凱基-永和,2023-02-20,9207
2349,錸德,8,2,6,凱基-永和,2023-02-20,9207
2358,廷鑫,6,0,6,凱基-永和,2023-02-20,9207
3138,耀登,6,0,6,凱基-永和,2023-02-20,9207
8097,常珵,6,0,6,凱基-永和,2023-02-20,9207
1101,台泥,6,0,6,凱基-永和,2023-02-20,9207
8478,東哥遊艇,6,1,5,凱基-永和,2023-02-20,9207
1314,中石化,5,0,5,凱基-永和,2023-02-20,9207
00770,國泰北美科技,5,0,5,凱基-永和,2023-02-20,9207
00632R,元大台灣50反1,5,0,5,凱基-永和,2023-02-20,9207
1536,和大,5,0,5,凱基-永和,2023-02-20,9207
2017,官田鋼,5,0,5,凱基-永和,2023-02-20,9207
2371,大同,5,0,5,凱基-永和,2023-02-20,9207
4162,智擎,5,0,5,凱基-永和,2023-02-20,9207
5285,界霖,7,2,5,凱基-永和,2023-02-20,9207
8105,凌巨,5,0,5,凱基-永和,2023-02-20,9207
2061,風青,4,0,4,凱基-永和,2023-02-20,9207
8050,廣積,205,0,205,凱基-永和,2023-02-21,9207
2340,台亞,112,0,112,凱基-永和,2023-02-21,9207
2867,三商壽,88,10,78,凱基-永和,2023-02-21,9207
5425,台半,153,112,41,凱基-永和,2023-02-21,9207
8996,高力,40,0,40,凱基-永和,2023-02-21,9207
6515,穎崴,38,0,38,凱基-永和,2023-02-21,9207
2883,凱基金,32,0,32,凱基-永和,2023-02-21,9207
2312,金寶,22,0,22,凱基-永和,2023-02-21,9207
6282,康舒,501,481,20,凱基-永和,2023-02-21,9207
9945,潤泰新,20,0,20,凱基-永和,2023-02-21,9207
2618,長榮航,20,1,19,凱基-永和,2023-02-21,9207
2367,燿華,17,0,17,凱基-永和,2023-02-21,9207
2634,漢翔,32,15,17,凱基-永和,2023-02-21,9207
6257,矽格,14,0,14,凱基-永和,2023-02-21,9207
2401,凌陽,13,0,13,凱基-永和,2023-02-21,9207
2610,華航,168,157,11,凱基-永和,2023-02-21,9207
9907,統一實,11,0,11,凱基-永和,2023-02-21,9207
1210,大成,10,0,10,凱基-永和,2023-02-21,9207
1219,福壽,10,0,10,凱基-永和,2023-02-21,9207
1304,台聚,10,0,10,凱基-永和,2023-02-21,9207
1815,富喬,10,0,10,凱基-永和,2023-02-21,9207
6278,台表科,10,0,10,凱基-永和,2023-02-21,9207
1513,中興電,13,3,10,凱基-永和,2023-02-21,9207
3027,盛達,11,2,9,凱基-永和,2023-02-21,9207
5512,力麒,7,0,7,凱基-永和,2023-02-21,9207
4979,華星光,12,5,7,凱基-永和,2023-02-21,9207
00878,國泰永續高股息,6,0,6,凱基-永和,2023-02-21,9207
1609,大亞,7,1,6,凱基-永和,2023-02-21,9207
2352,佳世達,6,0,6,凱基-永和,2023-02-21,9207
2371,大同,8,2,6,凱基-永和,2023-02-21,9207
4550,長佳,6,0,6,凱基-永和,2023-02-21,9207
6165,浪凡,7,1,6,凱基-永和,2023-02-21,9207
1605,華新,17,11,6,凱基-永和,2023-02-21,9207
00882,中信中國高股息,5,0,5,凱基-永和,2023-02-21,9207
2014,中鴻,10,5,5,凱基-永和,2023-02-21,9207
2882,國泰金,5,0,5,凱基-永和,2023-02-21,9207
3346,麗清,5,0,5,凱基-永和,2023-02-21,9207
3715,定穎投控,5,0,5,凱基-永和,2023-02-21,9207
6140,訊達,5,0,5,凱基-永和,2023-02-21,9207
6531,愛普*,5,0,5,凱基-永和,2023-02-21,9207
8358,金居,8,3,5,凱基-永和,2023-02-21,9207
8933,愛地雅,5,0,5,凱基-永和,2023-02-21,9207
4961,天鈺,10,5,5,凱基-永和,2023-02-21,9207
1519,華城,6,2,4,凱基-永和,2023-02-21,9207
1227,佳格,4,0,4,凱基-永和,2023-02-21,9207
1437,勤益控,8,4,4,凱基-永和,2023-02-21,9207
00713,元大台灣高息低波,4,0,4,凱基-永和,2023-02-21,9207
2317,鴻海,4,0,4,凱基-永和,2023-02-21,9207
8261,富鼎,5,1,4,凱基-永和,2023-02-21,9207
0050,元大台灣50,3,0,3,凱基-永和,2023-02-21,9207
2340,台亞,151,0,151,凱基-永和,2023-02-22,9207
8996,高力,71,1,70,凱基-永和,2023-02-22,9207
00878,國泰永續高股息,66,13,53,凱基-永和,2023-02-22,9207
6116,彩晶,50,0,50,凱基-永和,2023-02-22,9207
8940,新天地,49,0,49,凱基-永和,2023-02-22,9207
2208,台船,23,0,23,凱基-永和,2023-02-22,9207
2201,裕隆,20,0,20,凱基-永和,2023-02-22,9207
2701,萬企,20,0,20,凱基-永和,2023-02-22,9207
3576,聯合再生,20,0,20,凱基-永和,2023-02-22,9207
2884,玉山金,26,7,19,凱基-永和,2023-02-22,9207
3037,欣興,21,2,19,凱基-永和,2023-02-22,9207
5904,寶雅,19,0,19,凱基-永和,2023-02-22,9207
2344,華邦電,21,4,17,凱基-永和,2023-02-22,9207
6791,虎門科技,15,0,15,凱基-永和,2023-02-22,9207
00715L,期街口布蘭特正2,12,0,12,凱基-永和,2023-02-22,9207
2537,聯上發,12,0,12,凱基-永和,2023-02-22,9207
2906,高林,12,0,12,凱基-永和,2023-02-22,9207
2308,台達電,11,0,11,凱基-永和,2023-02-22,9207
2897,王道銀行,11,0,11,凱基-永和,2023-02-22,9207
4142,國光生,11,0,11,凱基-永和,2023-02-22,9207
2886,兆豐金,12,2,10,凱基-永和,2023-02-22,9207
3652,精聯,10,0,10,凱基-永和,2023-02-22,9207
4114,健喬,11,1,10,凱基-永和,2023-02-22,9207
8070,長華*,10,0,10,凱基-永和,2023-02-22,9207
2618,長榮航,11,2,9,凱基-永和,2023-02-22,9207
3362,先進光,9,0,9,凱基-永和,2023-02-22,9207
3545,敦泰,10,2,8,凱基-永和,2023-02-22,9207
1503,士電,8,1,7,凱基-永和,2023-02-22,9207
4550,長佳,7,0,7,凱基-永和,2023-02-22,9207
2882,國泰金,9,2,7,凱基-永和,2023-02-22,9207
00679B,元大美債20年,6,0,6,凱基-永和,2023-02-22,9207
1515,力山,6,0,6,凱基-永和,2023-02-22,9207
1605,華新,21,15,6,凱基-永和,2023-02-22,9207
6288,聯嘉,6,0,6,凱基-永和,2023-02-22,9207
6443,元晶,8,2,6,凱基-永和,2023-02-22,9207
00713,元大台灣高息低波,5,0,5,凱基-永和,2023-02-22,9207
4743,合一,5,0,5,凱基-永和,2023-02-22,9207
1529,樂事綠能,5,0,5,凱基-永和,2023-02-22,9207
2375,凱美,5,0,5,凱基-永和,2023-02-22,9207
2845,遠東銀,5,0,5,凱基-永和,2023-02-22,9207
3265,台星科,5,0,5,凱基-永和,2023-02-22,9207
3715,定穎投控,5,0,5,凱基-永和,2023-02-22,9207
4160,訊聯基因,5,0,5,凱基-永和,2023-02-22,9207
6140,訊達,5,0,5,凱基-永和,2023-02-22,9207
8111,立��,5,0,5,凱基-永和,2023-02-22,9207
8289,泰藝,5,0,5,凱基-永和,2023-02-22,9207
00772B,中信高評級公司債,5,0,5,凱基-永和,2023-02-22,9207
0056,元大高股息,9,5,4,凱基-永和,2023-02-22,9207
1102,亞泥,4,0,4,凱基-永和,2023-02-22,9207
00773B,中信優先金融債,4,0,4,凱基-永和,2023-02-22,9207
2388,威盛,882,158,724,凱基-永和,2023-02-23,9207
5512,力麒,803,308,495,凱基-永和,2023-02-23,9207
1108,幸福,307,110,197,凱基-永和,2023-02-23,9207
5425,台半,121,0,121,凱基-永和,2023-02-23,9207
2605,新興,209,103,106,凱基-永和,2023-02-23,9207
00632R,元大台灣50反1,78,0,78,凱基-永和,2023-02-23,9207
3661,世芯-KY,61,1,60,凱基-永和,2023-02-23,9207
2611,志信,53,0,53,凱基-永和,2023-02-23,9207
6101,寬魚國際,41,0,41,凱基-永和,2023-02-23,9207
00679B,元大美債20年,34,0,34,凱基-永和,2023-02-23,9207
2340,台亞,35,2,33,凱基-永和,2023-02-23,9207
00680L,元大美債20正2,30,0,30,凱基-永和,2023-02-23,9207
3406,玉晶光,28,0,28,凱基-永和,2023-02-23,9207
2736,富野,37,11,26,凱基-永和,2023-02-23,9207
3515,華擎,27,1,26,凱基-永和,2023-02-23,9207
2477,美隆電,25,0,25,凱基-永和,2023-02-23,9207
3447,展達,23,0,23,凱基-永和,2023-02-23,9207
5905,南仁湖,40,18,22,凱基-永和,2023-02-23,9207
2303,聯電,23,3,20,凱基-永和,2023-02-23,9207
6751,智聯服務,20,0,20,凱基-永和,2023-02-23,9207
6843,進典,20,0,20,凱基-永和,2023-02-23,9207
2409,友達,17,0,17,凱基-永和,2023-02-23,9207
00715L,期街口布蘭特正2,18,1,17,凱基-永和,2023-02-23,9207
1453,大將,15,0,15,凱基-永和,2023-02-23,9207
2101,南港,15,0,15,凱基-永和,2023-02-23,9207
2618,長榮航,15,0,15,凱基-永和,2023-02-23,9207
6732,昇佳電子,24,10,14,凱基-永和,2023-02-23,9207
00893,國泰智能電動車,20,7,13,凱基-永和,2023-02-23,9207
4729,熒茂,12,0,12,凱基-永和,2023-02-23,9207
020032,元大綠能N,10,0,10,凱基-永和,2023-02-23,9207
00773B,中信優先金融債,10,0,10,凱基-永和,2023-02-23,9207
00692,富邦公司治理,10,0,10,凱基-永和,2023-02-23,9207
2345,智邦,10,0,10,凱基-永和,2023-02-23,9207
2427,三商電,10,0,10,凱基-永和,2023-02-23,9207
2903,遠百,10,0,10,凱基-永和,2023-02-23,9207
3290,東浦,14,4,10,凱基-永和,2023-02-23,9207
6005,群益證,10,0,10,凱基-永和,2023-02-23,9207
2330,台積電,11,2,9,凱基-永和,2023-02-23,9207
1522,堤維西,9,0,9,凱基-永和,2023-02-23,9207
3443,創意,8,0,8,凱基-永和,2023-02-23,9207
5706,鳳凰,8,0,8,凱基-永和,2023-02-23,9207
00712,復華富時不動產,7,0,7,凱基-永和,2023-02-23,9207
2882,國泰金,7,1,6,凱基-永和,2023-02-23,9207
2702,華園,6,0,6,凱基-永和,2023-02-23,9207
8171,天宇,6,0,6,凱基-永和,2023-02-23,9207
2812,台中銀,5,0,5,凱基-永和,2023-02-23,9207
2892,第一金,5,0,5,凱基-永和,2023-02-23,9207
5210,寶碩,5,0,5,凱基-永和,2023-02-23,9207
2027,大成鋼,5,0,5,凱基-永和,2023-02-23,9207
4919,新唐,14,9,5,凱基-永和,2023-02-23,9207
5608,四維航,305,146,159,凱基-永和,2023-02-24,9207
2340,台亞,116,0,116,凱基-永和,2023-02-24,9207
2504,國產,100,0,100,凱基-永和,2023-02-24,9207
2739,寒舍,100,0,100,凱基-永和,2023-02-24,9207
8289,泰藝,308,242,66,凱基-永和,2023-02-24,9207
00632R,元大台灣50反1,50,0,50,凱基-永和,2023-02-24,9207
6527,明達醫,46,0,46,凱基-永和,2023-02-24,9207
6244,茂迪,35,0,35,凱基-永和,2023-02-24,9207
6266,泰詠,34,1,33,凱基-永和,2023-02-24,9207
3684,榮昌,30,0,30,凱基-永和,2023-02-24,9207
00713,元大台灣高息低波,29,0,29,凱基-永和,2023-02-24,9207
6689,伊雲谷,28,0,28,凱基-永和,2023-02-24,9207
6697,東捷資訊,28,0,28,凱基-永和,2023-02-24,9207
3037,欣興,28,3,25,凱基-永和,2023-02-24,9207
6116,彩晶,25,0,25,凱基-永和,2023-02-24,9207
00893,國泰智能電動車,20,0,20,凱基-永和,2023-02-24,9207
2889,國票金,15,0,15,凱基-永和,2023-02-24,9207
6109,亞元,15,0,15,凱基-永和,2023-02-24,9207
2354,鴻準,14,0,14,凱基-永和,2023-02-24,9207
1760,寶齡富錦,15,2,13,凱基-永和,2023-02-24,9207
3264,欣銓,13,0,13,凱基-永和,2023-02-24,9207
3094,聯傑,12,0,12,凱基-永和,2023-02-24,9207
8069,元太,16,5,11,凱基-永和,2023-02-24,9207
2317,鴻海,11,0,11,凱基-永和,2023-02-24,9207
1560,中砂,11,1,10,凱基-永和,2023-02-24,9207
3447,展達,10,0,10,凱基-永和,2023-02-24,9207
3552,同致,10,0,10,凱基-永和,2023-02-24,9207
2330,台積電,14,4,10,凱基-永和,2023-02-24,9207
3036,文曄,14,5,9,凱基-永和,2023-02-24,9207
2891,中信金,11,2,9,凱基-永和,2023-02-24,9207
2356,英業達,10,1,9,凱基-永和,2023-02-24,9207
4967,十銓,22,13,9,凱基-永和,2023-02-24,9207
8033,雷虎,11,2,9,凱基-永和,2023-02-24,9207
2637,慧洋-KY,11,3,8,凱基-永和,2023-02-24,9207
2014,中鴻,9,2,7,凱基-永和,2023-02-24,9207
00882,中信中國高股息,6,0,6,凱基-永和,2023-02-24,9207
00679B,元大美債20年,6,0,6,凱基-永和,2023-02-24,9207
2101,南港,6,0,6,凱基-永和,2023-02-24,9207
1326,台化,5,0,5,凱基-永和,2023-02-24,9207
00671R,富邦NASDAQ反1,5,0,5,凱基-永和,2023-02-24,9207
00669R,國泰美國道瓊反1,5,0,5,凱基-永和,2023-02-24,9207
00665L,富邦�琤肭磪囓�2,5,0,5,凱基-永和,2023-02-24,9207
00692,富邦公司治理,5,0,5,凱基-永和,2023-02-24,9207
00725B,國泰投資級公司債,5,0,5,凱基-永和,2023-02-24,9207
00753L,中信中國50正2,5,0,5,凱基-永和,2023-02-24,9207
3014,聯陽,6,1,5,凱基-永和,2023-02-24,9207
3520,華盈,7,2,5,凱基-永和,2023-02-24,9207
6235,華孚,15,10,5,凱基-永和,2023-02-24,9207
2308,台達電,4,0,4,凱基-永和,2023-02-24,9207
00902,中信電池及儲能,4,0,4,凱基-永和,2023-02-24,9207
6282,康舒,1001,9,992,凱基-永和,2023-03-01,9207
2388,威盛,307,1,306,凱基-永和,2023-03-01,9207
2340,台亞,222,0,222,凱基-永和,2023-03-01,9207
6578,達邦蛋白,66,0,66,凱基-永和,2023-03-01,9207
1605,華新,57,3,54,凱基-永和,2023-03-01,9207
3207,耀勝,39,0,39,凱基-永和,2023-03-01,9207
00632R,元大台灣50反1,30,0,30,凱基-永和,2023-03-01,9207
3661,世芯-KY,30,1,29,凱基-永和,2023-03-01,9207
6116,彩晶,28,0,28,凱基-永和,2023-03-01,9207
2344,華邦電,26,0,26,凱基-永和,2023-03-01,9207
4739,康普,20,0,20,凱基-永和,2023-03-01,9207
1101,台泥,23,3,20,凱基-永和,2023-03-01,9207
2641,正德,15,0,15,凱基-永和,2023-03-01,9207
8249,菱光,15,0,15,凱基-永和,2023-03-01,9207
3231,緯創,15,0,15,凱基-永和,2023-03-01,9207
2891,中信金,13,0,13,凱基-永和,2023-03-01,9207
00772B,中信高評級公司債,11,0,11,凱基-永和,2023-03-01,9207
2867,三商壽,11,0,11,凱基-永和,2023-03-01,9207
1314,中石化,10,0,10,凱基-永和,2023-03-01,9207
2017,官田鋼,10,0,10,凱基-永和,2023-03-01,9207
2471,資通,10,0,10,凱基-永和,2023-03-01,9207
2615,萬海,10,0,10,凱基-永和,2023-03-01,9207
2885,元大金,9,0,9,凱基-永和,2023-03-01,9207
2888,新光金,9,0,9,凱基-永和,2023-03-01,9207
2014,中鴻,10,2,8,凱基-永和,2023-03-01,9207
3702,大聯大,8,0,8,凱基-永和,2023-03-01,9207
3706,神達,7,0,7,凱基-永和,2023-03-01,9207
2345,智邦,7,0,7,凱基-永和,2023-03-01,9207
5464,霖宏,7,0,7,凱基-永和,2023-03-01,9207
2454,聯發科,7,0,7,凱基-永和,2023-03-01,9207
2609,陽明,6,0,6,凱基-永和,2023-03-01,9207
2328,廣宇,7,1,6,凱基-永和,2023-03-01,9207
6806,森崴能源,6,0,6,凱基-永和,2023-03-01,9207
00713,元大台灣高息低波,5,0,5,凱基-永和,2023-03-01,9207
00692,富邦公司治理,5,0,5,凱基-永和,2023-03-01,9207
006208,富邦台50,5,0,5,凱基-永和,2023-03-01,9207
2887,台新金,5,0,5,凱基-永和,2023-03-01,9207
3011,今皓,5,0,5,凱基-永和,2023-03-01,9207
3624,光頡,5,0,5,凱基-永和,2023-03-01,9207
2884,玉山金,7,2,5,凱基-永和,2023-03-01,9207
1102,亞泥,4,0,4,凱基-永和,2023-03-01,9207
2606,裕民,5,1,4,凱基-永和,2023-03-01,9207
2105,正新,4,0,4,凱基-永和,2023-03-01,9207
2605,新興,7,3,4,凱基-永和,2023-03-01,9207
2881,富邦金,4,0,4,凱基-永和,2023-03-01,9207
3035,智原,6,2,4,凱基-永和,2023-03-01,9207
8016,矽創,4,0,4,凱基-永和,2023-03-01,9207
2610,華航,5,1,4,凱基-永和,2023-03-01,9207
00679B,元大美債20年,3,0,3,凱基-永和,2023-03-01,9207
1319,東陽,3,0,3,凱基-永和,2023-03-01,9207
6509,聚和,233,5,228,凱基-永和,2023-03-02,9207
2352,佳世達,55,6,49,凱基-永和,2023-03-02,9207
6752,叡揚,37,0,37,凱基-永和,2023-03-02,9207
6207,雷科,33,0,33,凱基-永和,2023-03-02,9207
6116,彩晶,30,0,30,凱基-永和,2023-03-02,9207
1605,華新,130,108,22,凱基-永和,2023-03-02,9207
1409,新纖,20,0,20,凱基-永和,2023-03-02,9207
00878,國泰永續高股息,25,7,18,凱基-永和,2023-03-02,9207
00751B,元大AAA至A公司債,12,0,12,凱基-永和,2023-03-02,9207
1101,台泥,13,1,12,凱基-永和,2023-03-02,9207
1444,力麗,10,0,10,凱基-永和,2023-03-02,9207
1609,大亞,10,0,10,凱基-永和,2023-03-02,9207
2101,南港,10,0,10,凱基-永和,2023-03-02,9207
2337,旺宏,10,0,10,凱基-永和,2023-03-02,9207
4113,聯上,10,0,10,凱基-永和,2023-03-02,9207
3027,盛達,9,0,9,凱基-永和,2023-03-02,9207
3481,群創,9,0,9,凱基-永和,2023-03-02,9207
2201,裕隆,18,10,8,凱基-永和,2023-03-02,9207
2303,聯電,11,3,8,凱基-永和,2023-03-02,9207
2345,智邦,9,1,8,凱基-永和,2023-03-02,9207
2484,希華,8,0,8,凱基-永和,2023-03-02,9207
3088,艾訊,8,0,8,凱基-永和,2023-03-02,9207
2891,中信金,8,0,8,凱基-永和,2023-03-02,9207
2886,兆豐金,7,0,7,凱基-永和,2023-03-02,9207
2892,第一金,7,0,7,凱基-永和,2023-03-02,9207
4960,誠美材,7,0,7,凱基-永和,2023-03-02,9207
0056,元大高股息,18,12,6,凱基-永和,2023-03-02,9207
00679B,元大美債20年,6,0,6,凱基-永和,2023-03-02,9207
2883,凱基金,6,0,6,凱基-永和,2023-03-02,9207
00712,復華富時不動產,5,0,5,凱基-永和,2023-03-02,9207
00669R,國泰美國道瓊反1,5,0,5,凱基-永和,2023-03-02,9207
00648R,元大S＆P500反1,5,0,5,凱基-永和,2023-03-02,9207
2002,中鋼,5,0,5,凱基-永和,2023-03-02,9207
3162,精確,5,0,5,凱基-永和,2023-03-02,9207
4533,協易機,5,0,5,凱基-永和,2023-03-02,9207
4919,新唐,7,2,5,凱基-永和,2023-03-02,9207
8088,品安,5,0,5,凱基-永和,2023-03-02,9207
8936,國統,5,0,5,凱基-永和,2023-03-02,9207
00897,富邦基因免疫生技,4,0,4,凱基-永和,2023-03-02,9207
00637L,元大滬深300正2,6,2,4,凱基-永和,2023-03-02,9207
1727,中華化,4,0,4,凱基-永和,2023-03-02,9207
2208,台船,4,0,4,凱基-永和,2023-03-02,9207
2421,建準,4,0,4,凱基-永和,2023-03-02,9207
2634,漢翔,4,0,4,凱基-永和,2023-03-02,9207
2884,玉山金,4,0,4,凱基-永和,2023-03-02,9207
4576,大銀微系統,4,0,4,凱基-永和,2023-03-02,9207
4729,熒茂,4,0,4,凱基-永和,2023-03-02,9207
3545,敦泰,4,0,4,凱基-永和,2023-03-02,9207
6841,長佳智能,4,0,4,凱基-永和,2023-03-02,9207
2637,慧洋-KY,12,9,3,凱基-永和,2023-03-02,9207
00637L,元大滬深300正2,202,2,200,凱基-永和,2023-03-03,9207
2890,永豐金,50,1,49,凱基-永和,2023-03-03,9207
9907,統一實,50,1,49,凱基-永和,2023-03-03,9207
00725B,國泰投資級公司債,40,0,40,凱基-永和,2023-03-03,9207
2609,陽明,49,17,32,凱基-永和,2023-03-03,9207
3093,港建*,31,0,31,凱基-永和,2023-03-03,9207
5315,光聯,31,0,31,凱基-永和,2023-03-03,9207
00893,國泰智能電動車,30,0,30,凱基-永和,2023-03-03,9207
3707,漢磊,30,0,30,凱基-永和,2023-03-03,9207
6228,全譜,30,0,30,凱基-永和,2023-03-03,9207
4729,熒茂,21,0,21,凱基-永和,2023-03-03,9207
6697,東捷資訊,21,0,21,凱基-永和,2023-03-03,9207
3024,憶聲,20,0,20,凱基-永和,2023-03-03,9207
3402,漢科,20,0,20,凱基-永和,2023-03-03,9207
3479,安勤,15,0,15,凱基-永和,2023-03-03,9207
3006,晶豪科,15,1,14,凱基-永和,2023-03-03,9207
6282,康舒,13,2,11,凱基-永和,2023-03-03,9207
2891,中信金,10,0,10,凱基-永和,2023-03-03,9207
00673R,期元大S＆P原油反1,10,0,10,凱基-永和,2023-03-03,9207
2352,佳世達,10,0,10,凱基-永和,2023-03-03,9207
3508,位速,10,0,10,凱基-永和,2023-03-03,9207
6288,聯嘉,10,0,10,凱基-永和,2023-03-03,9207
6589,台康生技,10,0,10,凱基-永和,2023-03-03,9207
6672,騰輝電子-KY,10,0,10,凱基-永和,2023-03-03,9207
8043,蜜望實,10,0,10,凱基-永和,2023-03-03,9207
00878,國泰永續高股息,12,3,9,凱基-永和,2023-03-03,9207
00720B,元大投資級公司債,10,1,9,凱基-永和,2023-03-03,9207
3058,立德,9,0,9,凱基-永和,2023-03-03,9207
3564,其陽,9,0,9,凱基-永和,2023-03-03,9207
8028,昇陽半導體,9,0,9,凱基-永和,2023-03-03,9207
3209,全科,8,0,8,凱基-永和,2023-03-03,9207
2812,台中銀,7,0,7,凱基-永和,2023-03-03,9207
00751B,元大AAA至A公司債,7,0,7,凱基-永和,2023-03-03,9207
5351,鈺創,8,1,7,凱基-永和,2023-03-03,9207
3362,先進光,8,1,7,凱基-永和,2023-03-03,9207
2340,台亞,6,0,6,凱基-永和,2023-03-03,9207
2915,潤泰全,6,0,6,凱基-永和,2023-03-03,9207
8105,凌巨,6,0,6,凱基-永和,2023-03-03,9207
8928,鉅明,6,0,6,凱基-永和,2023-03-03,9207
00902,中信電池及儲能,5,0,5,凱基-永和,2023-03-03,9207
00713,元大台灣高息低波,5,0,5,凱基-永和,2023-03-03,9207
2101,南港,5,0,5,凱基-永和,2023-03-03,9207
3035,智原,16,11,5,凱基-永和,2023-03-03,9207
3714,富采,5,0,5,凱基-永和,2023-03-03,9207
6263,普萊德,5,0,5,凱基-永和,2023-03-03,9207
6613,朋億*,5,0,5,凱基-永和,2023-03-03,9207
8171,天宇,5,0,5,凱基-永和,2023-03-03,9207
2883,凱基金,4,0,4,凱基-永和,2023-03-03,9207
2014,中鴻,8,4,4,凱基-永和,2023-03-03,9207
2601,益航,5,1,4,凱基-永和,2023-03-03,9207
6282,康舒,364,162,202,凱基-永和,2023-03-06,9207
3013,晟銘電,109,3,106,凱基-永和,2023-03-06,9207
2486,一詮,100,1,99,凱基-永和,2023-03-06,9207
6234,高僑,75,1,74,凱基-永和,2023-03-06,9207
5608,四維航,66,5,61,凱基-永和,2023-03-06,9207
1708,東鹼,57,3,54,凱基-永和,2023-03-06,9207
00893,國泰智能電動車,50,0,50,凱基-永和,2023-03-06,9207
5315,光聯,49,0,49,凱基-永和,2023-03-06,9207
4729,熒茂,39,0,39,凱基-永和,2023-03-06,9207
6548,長科*,45,8,37,凱基-永和,2023-03-06,9207
00673R,期元大S＆P原油反1,33,0,33,凱基-永和,2023-03-06,9207
3008,大立光,27,0,27,凱基-永和,2023-03-06,9207
6419,京晨科,25,0,25,凱基-永和,2023-03-06,9207
3499,環天科,20,0,20,凱基-永和,2023-03-06,9207
6257,矽格,50,30,20,凱基-永和,2023-03-06,9207
2610,華航,19,2,17,凱基-永和,2023-03-06,9207
6104,創惟,21,4,17,凱基-永和,2023-03-06,9207
3047,訊舟,16,1,15,凱基-永和,2023-03-06,9207
2882,國泰金,15,1,14,凱基-永和,2023-03-06,9207
00632R,元大台灣50反1,12,0,12,凱基-永和,2023-03-06,9207
2314,台揚,12,0,12,凱基-永和,2023-03-06,9207
1336,台翰,10,0,10,凱基-永和,2023-03-06,9207
00725B,國泰投資級公司債,10,0,10,凱基-永和,2023-03-06,9207
2834,臺企銀,10,0,10,凱基-永和,2023-03-06,9207
3062,建漢,10,0,10,凱基-永和,2023-03-06,9207
6477,安集,10,0,10,凱基-永和,2023-03-06,9207
1584,精剛,9,0,9,凱基-永和,2023-03-06,9207
2201,裕隆,10,1,9,凱基-永和,2023-03-06,9207
6288,聯嘉,12,3,9,凱基-永和,2023-03-06,9207
1605,華新,28,20,8,凱基-永和,2023-03-06,9207
3058,立德,8,0,8,凱基-永和,2023-03-06,9207
4931,新盛力,10,2,8,凱基-永和,2023-03-06,9207
00780B,國泰A級金融債,7,0,7,凱基-永和,2023-03-06,9207
1533,車王電,8,1,7,凱基-永和,2023-03-06,9207
2345,智邦,7,0,7,凱基-永和,2023-03-06,9207
3441,聯一光,17,10,7,凱基-永和,2023-03-06,9207
4915,致伸,9,2,7,凱基-永和,2023-03-06,9207
2884,玉山金,8,1,7,凱基-永和,2023-03-06,9207
2449,京元電子,6,0,6,凱基-永和,2023-03-06,9207
3432,台端,6,0,6,凱基-永和,2023-03-06,9207
6668,中揚光,6,0,6,凱基-永和,2023-03-06,9207
8033,雷虎,8,2,6,凱基-永和,2023-03-06,9207
8289,泰藝,11,5,6,凱基-永和,2023-03-06,9207
6245,立端,11,6,5,凱基-永和,2023-03-06,9207
2421,建準,5,0,5,凱基-永和,2023-03-06,9207
3105,穩懋,5,0,5,凱基-永和,2023-03-06,9207
00888,永豐台灣ESG,5,0,5,凱基-永和,2023-03-06,9207
00648R,元大S＆P500反1,5,0,5,凱基-永和,2023-03-06,9207
00671R,富邦NASDAQ反1,5,0,5,凱基-永和,2023-03-06,9207
00669R,國泰美國道瓊反1,5,0,5,凱基-永和,2023-03-06,9207
1432,大魯閣,163,0,163,凱基-永和,2023-03-07,9207
6226,光鼎,100,0,100,凱基-永和,2023-03-07,9207
6290,良維,37,0,37,凱基-永和,2023-03-07,9207
2618,長榮航,35,2,33,凱基-永和,2023-03-07,9207
5607,遠雄港,30,0,30,凱基-永和,2023-03-07,9207
5608,四維航,62,36,26,凱基-永和,2023-03-07,9207
00632R,元大台灣50反1,24,0,24,凱基-永和,2023-03-07,9207
00673R,期元大S＆P原油反1,21,0,21,凱基-永和,2023-03-07,9207
8924,大田,21,0,21,凱基-永和,2023-03-07,9207
00893,國泰智能電動車,30,10,20,凱基-永和,2023-03-07,9207
3046,建��,20,0,20,凱基-永和,2023-03-07,9207
3207,耀勝,15,0,15,凱基-永和,2023-03-07,9207
5536,聖暉*,15,0,15,凱基-永和,2023-03-07,9207
3308,聯德,13,0,13,凱基-永和,2023-03-07,9207
6205,詮欣,13,0,13,凱基-永和,2023-03-07,9207
8028,昇陽半導體,13,0,13,凱基-永和,2023-03-07,9207
1795,美時,11,0,11,凱基-永和,2023-03-07,9207
2891,中信金,22,11,11,凱基-永和,2023-03-07,9207
3093,港建*,10,0,10,凱基-永和,2023-03-07,9207
1504,東元,10,0,10,凱基-永和,2023-03-07,9207
00671R,富邦NASDAQ反1,10,0,10,凱基-永和,2023-03-07,9207
2313,華通,10,0,10,凱基-永和,2023-03-07,9207
3189,景碩,10,0,10,凱基-永和,2023-03-07,9207
3704,合勤控,20,10,10,凱基-永和,2023-03-07,9207
5011,久陽,10,0,10,凱基-永和,2023-03-07,9207
3481,群創,15,6,9,凱基-永和,2023-03-07,9207
4729,熒茂,9,0,9,凱基-永和,2023-03-07,9207
8070,長華*,9,0,9,凱基-永和,2023-03-07,9207
2484,希華,10,2,8,凱基-永和,2023-03-07,9207
4906,正文,10,2,8,凱基-永和,2023-03-07,9207
6129,普誠,11,3,8,凱基-永和,2023-03-07,9207
6770,力積電,9,1,8,凱基-永和,2023-03-07,9207
00713,元大台灣高息低波,7,0,7,凱基-永和,2023-03-07,9207
5483,中美晶,7,0,7,凱基-永和,2023-03-07,9207
1525,江申,6,0,6,凱基-永和,2023-03-07,9207
1533,車王電,6,0,6,凱基-永和,2023-03-07,9207
2929,淘帝-KY,6,0,6,凱基-永和,2023-03-07,9207
1708,東鹼,6,1,5,凱基-永和,2023-03-07,9207
1752,南光,10,5,5,凱基-永和,2023-03-07,9207
2345,智邦,5,0,5,凱基-永和,2023-03-07,9207
3624,光頡,5,0,5,凱基-永和,2023-03-07,9207
6285,啟��,6,1,5,凱基-永和,2023-03-07,9207
6414,樺漢,5,0,5,凱基-永和,2023-03-07,9207
6517,保勝光學,5,0,5,凱基-永和,2023-03-07,9207
6683,雍智科技,5,0,5,凱基-永和,2023-03-07,9207
2603,長榮,9,4,5,凱基-永和,2023-03-07,9207
6147,頎邦,5,1,4,凱基-永和,2023-03-07,9207
2471,資通,8,4,4,凱基-永和,2023-03-07,9207
2344,華邦電,4,0,4,凱基-永和,2023-03-07,9207
3029,零壹,9,5,4,凱基-永和,2023-03-07,9207
2471,資通,192,6,186,凱基-永和,2023-03-08,9207
1432,大魯閣,219,105,114,凱基-永和,2023-03-08,9207
6443,元晶,108,2,106,凱基-永和,2023-03-08,9207
8227,巨有科技,95,0,95,凱基-永和,2023-03-08,9207
00878,國泰永續高股息,76,2,74,凱基-永和,2023-03-08,9207
4433,興采,65,0,65,凱基-永和,2023-03-08,9207
3652,精聯,60,1,59,凱基-永和,2023-03-08,9207
5608,四維航,67,10,57,凱基-永和,2023-03-08,9207
4543,萬在,100,50,50,凱基-永和,2023-03-08,9207
5340,建榮,41,0,41,凱基-永和,2023-03-08,9207
3021,鴻名,39,0,39,凱基-永和,2023-03-08,9207
2457,飛宏,340,304,36,凱基-永和,2023-03-08,9207
00893,國泰智能電動車,30,0,30,凱基-永和,2023-03-08,9207
3046,建��,53,23,30,凱基-永和,2023-03-08,9207
3712,永崴投控,28,1,27,凱基-永和,2023-03-08,9207
3289,宜特,250,224,26,凱基-永和,2023-03-08,9207
6240,松崗,25,0,25,凱基-永和,2023-03-08,9207
9907,統一實,23,1,22,凱基-永和,2023-03-08,9207
00882,中信中國高股息,21,0,21,凱基-永和,2023-03-08,9207
00915,凱基優選高股息30,22,1,21,凱基-永和,2023-03-08,9207
0056,元大高股息,19,0,19,凱基-永和,2023-03-08,9207
2609,陽明,26,7,19,凱基-永和,2023-03-08,9207
00637L,元大滬深300正2,17,1,16,凱基-永和,2023-03-08,9207
2891,中信金,16,0,16,凱基-永和,2023-03-08,9207
1536,和大,14,0,14,凱基-永和,2023-03-08,9207
2419,仲琦,15,1,14,凱基-永和,2023-03-08,9207
3093,港建*,20,7,13,凱基-永和,2023-03-08,9207
1102,亞泥,13,1,12,凱基-永和,2023-03-08,9207
4729,熒茂,12,0,12,凱基-永和,2023-03-08,9207
8215,明基材,12,0,12,凱基-永和,2023-03-08,9207
6548,長科*,11,0,11,凱基-永和,2023-03-08,9207
8222,寶一,339,329,10,凱基-永和,2023-03-08,9207
2603,長榮,11,1,10,凱基-永和,2023-03-08,9207
5607,遠雄港,10,0,10,凱基-永和,2023-03-08,9207
1722,台肥,10,0,10,凱基-永和,2023-03-08,9207
2337,旺宏,10,0,10,凱基-永和,2023-03-08,9207
2344,華邦電,10,0,10,凱基-永和,2023-03-08,9207
5351,鈺創,10,0,10,凱基-永和,2023-03-08,9207
6414,樺漢,10,0,10,凱基-永和,2023-03-08,9207
1504,東元,9,0,9,凱基-永和,2023-03-08,9207
2347,聯強,10,1,9,凱基-永和,2023-03-08,9207
3265,台星科,20,11,9,凱基-永和,2023-03-08,9207
4114,健喬,9,0,9,凱基-永和,2023-03-08,9207
8473,山林水,9,0,9,凱基-永和,2023-03-08,9207
1524,耿鼎,7,0,7,凱基-永和,2023-03-08,9207
4564,元翎,7,0,7,凱基-永和,2023-03-08,9207
6188,廣明,10,3,7,凱基-永和,2023-03-08,9207
6235,華孚,227,220,7,凱基-永和,2023-03-08,9207
6282,康舒,11,4,7,凱基-永和,2023-03-08,9207
2882,國泰金,9,3,6,凱基-永和,2023-03-08,9207
2388,威盛,335,40,295,凱基-永和,2023-03-09,9207
1616,億泰,188,0,188,凱基-永和,2023-03-09,9207
6274,台燿,142,5,137,凱基-永和,2023-03-09,9207
3289,宜特,160,30,130,凱基-永和,2023-03-09,9207
4903,聯光通,79,0,79,凱基-永和,2023-03-09,9207
2610,華航,58,7,51,凱基-永和,2023-03-09,9207
5272,笙科,51,1,50,凱基-永和,2023-03-09,9207
5309,系統電,48,1,47,凱基-永和,2023-03-09,9207
4130,健亞,45,0,45,凱基-永和,2023-03-09,9207
2486,一詮,39,9,30,凱基-永和,2023-03-09,9207
1714,和桐,23,0,23,凱基-永和,2023-03-09,9207
6129,普誠,23,0,23,凱基-永和,2023-03-09,9207
2888,新光金,21,0,21,凱基-永和,2023-03-09,9207
4960,誠美材,20,0,20,凱基-永和,2023-03-09,9207
5340,建榮,60,40,20,凱基-永和,2023-03-09,9207
6140,訊達,20,0,20,凱基-永和,2023-03-09,9207
00713,元大台灣高息低波,17,0,17,凱基-永和,2023-03-09,9207
2359,所羅門,26,9,17,凱基-永和,2023-03-09,9207
2880,華南金,16,0,16,凱基-永和,2023-03-09,9207
3047,訊舟,17,1,16,凱基-永和,2023-03-09,9207
5206,坤悅,16,0,16,凱基-永和,2023-03-09,9207
6770,力積電,16,1,15,凱基-永和,2023-03-09,9207
2429,銘旺科,15,0,15,凱基-永和,2023-03-09,9207
5321,美而快,13,0,13,凱基-永和,2023-03-09,9207
2884,玉山金,14,1,13,凱基-永和,2023-03-09,9207
2889,國票金,12,0,12,凱基-永和,2023-03-09,9207
00878,國泰永續高股息,11,0,11,凱基-永和,2023-03-09,9207
1718,中纖,11,0,11,凱基-永和,2023-03-09,9207
6806,森崴能源,13,2,11,凱基-永和,2023-03-09,9207
8114,振樺電,11,0,11,凱基-永和,2023-03-09,9207
2409,友達,11,0,11,凱基-永和,2023-03-09,9207
1336,台翰,10,0,10,凱基-永和,2023-03-09,9207
00882,中信中國高股息,10,0,10,凱基-永和,2023-03-09,9207
1722,台肥,10,0,10,凱基-永和,2023-03-09,9207
2731,雄獅,10,0,10,凱基-永和,2023-03-09,9207
3481,群創,13,3,10,凱基-永和,2023-03-09,9207
3591,艾笛森,10,0,10,凱基-永和,2023-03-09,9207
3704,合勤控,10,0,10,凱基-永和,2023-03-09,9207
4121,優盛,10,0,10,凱基-永和,2023-03-09,9207
6112,邁達特,10,0,10,凱基-永和,2023-03-09,9207
6209,今國光,10,0,10,凱基-永和,2023-03-09,9207
6532,瑞耘,10,0,10,凱基-永和,2023-03-09,9207
8933,愛地雅,10,0,10,凱基-永和,2023-03-09,9207
1513,中興電,11,2,9,凱基-永和,2023-03-09,9207
5469,瀚宇博,9,0,9,凱基-永和,2023-03-09,9207
00885,富邦越南,8,0,8,凱基-永和,2023-03-09,9207
2641,正德,11,4,7,凱基-永和,2023-03-09,9207
5351,鈺創,12,5,7,凱基-永和,2023-03-09,9207
5388,中磊,7,0,7,凱基-永和,2023-03-09,9207
5706,鳳凰,10,3,7,凱基-永和,2023-03-09,9207
2388,威盛,252,52,200,凱基-永和,2023-03-10,9207
4130,健亞,200,0,200,凱基-永和,2023-03-10,9207
2610,華航,113,36,77,凱基-永和,2023-03-10,9207
00878,國泰永續高股息,77,3,74,凱基-永和,2023-03-10,9207
6257,矽格,45,1,44,凱基-永和,2023-03-10,9207
2882,國泰金,38,1,37,凱基-永和,2023-03-10,9207
2884,玉山金,37,0,37,凱基-永和,2023-03-10,9207
5608,四維航,80,44,36,凱基-永和,2023-03-10,9207
2344,華邦電,33,0,33,凱基-永和,2023-03-10,9207
00900,富邦特選高股息30,25,0,25,凱基-永和,2023-03-10,9207
8069,元太,31,8,23,凱基-永和,2023-03-10,9207
1524,耿鼎,33,11,22,凱基-永和,2023-03-10,9207
0056,元大高股息,25,4,21,凱基-永和,2023-03-10,9207
4960,誠美材,20,0,20,凱基-永和,2023-03-10,9207
6109,亞元,20,0,20,凱基-永和,2023-03-10,9207
6180,橘子,21,1,20,凱基-永和,2023-03-10,9207
2409,友達,18,2,16,凱基-永和,2023-03-10,9207
4533,協易機,16,0,16,凱基-永和,2023-03-10,9207
2891,中信金,16,0,16,凱基-永和,2023-03-10,9207
5351,鈺創,16,1,15,凱基-永和,2023-03-10,9207
1605,華新,20,7,13,凱基-永和,2023-03-10,9207
3583,辛耘,17,4,13,凱基-永和,2023-03-10,9207
00642U,期元大S＆P石油,12,0,12,凱基-永和,2023-03-10,9207
6205,詮欣,12,0,12,凱基-永和,2023-03-10,9207
9945,潤泰新,11,0,11,凱基-永和,2023-03-10,9207
2330,台積電,11,0,11,凱基-永和,2023-03-10,9207
2609,陽明,275,264,11,凱基-永和,2023-03-10,9207
5425,台半,11,1,10,凱基-永和,2023-03-10,9207
2883,凱基金,10,0,10,凱基-永和,2023-03-10,9207
00636,國泰中國A50,10,0,10,凱基-永和,2023-03-10,9207
2331,精英,11,1,10,凱基-永和,2023-03-10,9207
4746,台耀,10,0,10,凱基-永和,2023-03-10,9207
5452,佶優,10,0,10,凱基-永和,2023-03-10,9207
6209,今國光,10,0,10,凱基-永和,2023-03-10,9207
8936,國統,10,0,10,凱基-永和,2023-03-10,9207
3019,亞光,10,0,10,凱基-永和,2023-03-10,9207
9940,信義,10,1,9,凱基-永和,2023-03-10,9207
00713,元大台灣高息低波,9,0,9,凱基-永和,2023-03-10,9207
2801,彰銀,10,1,9,凱基-永和,2023-03-10,9207
1513,中興電,12,4,8,凱基-永和,2023-03-10,9207
2368,金像電,8,0,8,凱基-永和,2023-03-10,9207
6517,保勝光學,8,0,8,凱基-永和,2023-03-10,9207
0050,元大台灣50,12,5,7,凱基-永和,2023-03-10,9207
2851,中再保,8,1,7,凱基-永和,2023-03-10,9207
00715L,期街口布蘭特正2,7,0,7,凱基-永和,2023-03-10,9207
2359,所羅門,13,6,7,凱基-永和,2023-03-10,9207
2915,潤泰全,7,0,7,凱基-永和,2023-03-10,9207
6643,M31,7,0,7,凱基-永和,2023-03-10,9207
8171,天宇,7,0,7,凱基-永和,2023-03-10,9207
4743,合一,8,2,6,凱基-永和,2023-03-10,9207
00878,國泰永續高股息,91,28,63,凱基-永和,2023-03-13,9207
00900,富邦特選高股息30,47,0,47,凱基-永和,2023-03-13,9207
00637L,元大滬深300正2,37,2,35,凱基-永和,2023-03-13,9207
6109,亞元,40,10,30,凱基-永和,2023-03-13,9207
00715L,期街口布蘭特正2,32,8,24,凱基-永和,2023-03-13,9207
2548,華固,24,0,24,凱基-永和,2023-03-13,9207
00680L,元大美債20正2,20,0,20,凱基-永和,2023-03-13,9207
4960,誠美材,20,0,20,凱基-永和,2023-03-13,9207
2609,陽明,115,96,19,凱基-永和,2023-03-13,9207
1104,環泥,16,1,15,凱基-永和,2023-03-13,9207
00669R,國泰美國道瓊反1,15,0,15,凱基-永和,2023-03-13,9207
6609,瀧澤科,14,1,13,凱基-永和,2023-03-13,9207
00751B,元大AAA至A公司債,13,0,13,凱基-永和,2023-03-13,9207
00679B,元大美債20年,12,0,12,凱基-永和,2023-03-13,9207
1524,耿鼎,10,0,10,凱基-永和,2023-03-13,9207
2884,玉山金,10,0,10,凱基-永和,2023-03-13,9207
3624,光頡,20,10,10,凱基-永和,2023-03-13,9207
5452,佶優,10,0,10,凱基-永和,2023-03-13,9207
6140,訊達,10,0,10,凱基-永和,2023-03-13,9207
6205,詮欣,10,0,10,凱基-永和,2023-03-13,9207
6438,迅得,10,0,10,凱基-永和,2023-03-13,9207
8227,巨有科技,10,0,10,凱基-永和,2023-03-13,9207
2634,漢翔,9,0,9,凱基-永和,2023-03-13,9207
2312,金寶,8,0,8,凱基-永和,2023-03-13,9207
4105,東洋,10,2,8,凱基-永和,2023-03-13,9207
4533,協易機,8,0,8,凱基-永和,2023-03-13,9207
5880,合庫金,7,0,7,凱基-永和,2023-03-13,9207
0056,元大高股息,21,14,7,凱基-永和,2023-03-13,9207
1301,台塑,6,0,6,凱基-永和,2023-03-13,9207
2427,三商電,7,1,6,凱基-永和,2023-03-13,9207
5206,坤悅,6,0,6,凱基-永和,2023-03-13,9207
5230,雷笛克光學,6,0,6,凱基-永和,2023-03-13,9207
2834,臺企銀,6,1,5,凱基-永和,2023-03-13,9207
8112,至上,6,1,5,凱基-永和,2023-03-13,9207
1438,三地開發,5,0,5,凱基-永和,2023-03-13,9207
00902,中信電池及儲能,5,0,5,凱基-永和,2023-03-13,9207
1522,堤維西,5,0,5,凱基-永和,2023-03-13,9207
2359,所羅門,10,5,5,凱基-永和,2023-03-13,9207
5351,鈺創,5,0,5,凱基-永和,2023-03-13,9207
6770,力積電,5,0,5,凱基-永和,2023-03-13,9207
9945,潤泰新,5,0,5,凱基-永和,2023-03-13,9207
1605,華新,16,12,4,凱基-永和,2023-03-13,9207
2453,凌群,4,0,4,凱基-永和,2023-03-13,9207
2906,高林,4,0,4,凱基-永和,2023-03-13,9207
9907,統一實,4,0,4,凱基-永和,2023-03-13,9207
00713,元大台灣高息低波,3,0,3,凱基-永和,2023-03-13,9207
2615,萬海,4,1,3,凱基-永和,2023-03-13,9207
1101,台泥,4,1,3,凱基-永和,2023-03-13,9207
00915,凱基優選高股息30,3,0,3,凱基-永和,2023-03-13,9207
2482,連宇,3,0,3,凱基-永和,2023-03-13,9207
00878,國泰永續高股息,87,3,84,凱基-永和,2023-03-14,9207
2882,國泰金,58,0,58,凱基-永和,2023-03-14,9207
3661,世芯-KY,46,0,46,凱基-永和,2023-03-14,9207
0056,元大高股息,30,0,30,凱基-永和,2023-03-14,9207
00751B,元大AAA至A公司債,30,0,30,凱基-永和,2023-03-14,9207
6109,亞元,25,0,25,凱基-永和,2023-03-14,9207
2344,華邦電,24,0,24,凱基-永和,2023-03-14,9207
5258,虹堡,21,0,21,凱基-永和,2023-03-14,9207
3260,威剛,20,0,20,凱基-永和,2023-03-14,9207
2610,華航,23,4,19,凱基-永和,2023-03-14,9207
2303,聯電,20,2,18,凱基-永和,2023-03-14,9207
00715L,期街口布蘭特正2,18,0,18,凱基-永和,2023-03-14,9207
2883,凱基金,24,6,18,凱基-永和,2023-03-14,9207
2891,中信金,17,0,17,凱基-永和,2023-03-14,9207
4960,誠美材,17,0,17,凱基-永和,2023-03-14,9207
2409,友達,21,5,16,凱基-永和,2023-03-14,9207
0050,元大台灣50,15,0,15,凱基-永和,2023-03-14,9207
2034,允強,15,0,15,凱基-永和,2023-03-14,9207
8222,寶一,20,6,14,凱基-永和,2023-03-14,9207
2211,長榮鋼,13,0,13,凱基-永和,2023-03-14,9207
2312,金寶,13,0,13,凱基-永和,2023-03-14,9207
1432,大魯閣,12,0,12,凱基-永和,2023-03-14,9207
00720B,元大投資級公司債,12,0,12,凱基-永和,2023-03-14,9207
2885,元大金,11,0,11,凱基-永和,2023-03-14,9207
5272,笙科,10,0,10,凱基-永和,2023-03-14,9207
6191,精成科,10,0,10,凱基-永和,2023-03-14,9207
9940,信義,10,0,10,凱基-永和,2023-03-14,9207
2886,兆豐金,9,0,9,凱基-永和,2023-03-14,9207
3037,欣興,10,1,9,凱基-永和,2023-03-14,9207
00882,中信中國高股息,9,0,9,凱基-永和,2023-03-14,9207
00679B,元大美債20年,10,2,8,凱基-永和,2023-03-14,9207
2330,台積電,7,0,7,凱基-永和,2023-03-14,9207
1504,東元,7,0,7,凱基-永和,2023-03-14,9207
2014,中鴻,9,2,7,凱基-永和,2023-03-14,9207
9958,世紀鋼,7,0,7,凱基-永和,2023-03-14,9207
2884,玉山金,7,1,6,凱基-永和,2023-03-14,9207
2007,燁興,6,0,6,凱基-永和,2023-03-14,9207
3704,合勤控,6,0,6,凱基-永和,2023-03-14,9207
2027,大成鋼,20,15,5,凱基-永和,2023-03-14,9207
1473,台南,5,0,5,凱基-永和,2023-03-14,9207
1513,中興電,6,1,5,凱基-永和,2023-03-14,9207
00633L,富邦上証正2,5,0,5,凱基-永和,2023-03-14,9207
3481,群創,5,0,5,凱基-永和,2023-03-14,9207
6485,點序,5,0,5,凱基-永和,2023-03-14,9207
2308,台達電,4,0,4,凱基-永和,2023-03-14,9207
2881,富邦金,5,1,4,凱基-永和,2023-03-14,9207
1101,台泥,4,0,4,凱基-永和,2023-03-14,9207
2408,南亞科,4,0,4,凱基-永和,2023-03-14,9207
2548,華固,4,0,4,凱基-永和,2023-03-14,9207
4533,協易機,4,0,4,凱基-永和,2023-03-14,9207
00715L,期街口布蘭特正2,72,0,72,凱基-永和,2023-03-15,9207
2359,所羅門,67,0,67,凱基-永和,2023-03-15,9207
3443,創意,53,0,53,凱基-永和,2023-03-15,9207
2887,台新金,51,0,51,凱基-永和,2023-03-15,9207
2421,建準,45,1,44,凱基-永和,2023-03-15,9207
2603,長榮,74,42,32,凱基-永和,2023-03-15,9207
2609,陽明,138,112,26,凱基-永和,2023-03-15,9207
2891,中信金,34,9,25,凱基-永和,2023-03-15,9207
4960,誠美材,20,0,20,凱基-永和,2023-03-15,9207
00713,元大台灣高息低波,21,1,20,凱基-永和,2023-03-15,9207
2409,友達,21,2,19,凱基-永和,2023-03-15,9207
2618,長榮航,39,21,18,凱基-永和,2023-03-15,9207
2515,中工,20,3,17,凱基-永和,2023-03-15,9207
3645,達邁,15,0,15,凱基-永和,2023-03-15,9207
5230,雷笛克光學,15,0,15,凱基-永和,2023-03-15,9207
6109,亞元,16,1,15,凱基-永和,2023-03-15,9207
2402,毅嘉,15,1,14,凱基-永和,2023-03-15,9207
2906,高林,14,0,14,凱基-永和,2023-03-15,9207
2883,凱基金,20,7,13,凱基-永和,2023-03-15,9207
00642U,期元大S＆P石油,13,0,13,凱基-永和,2023-03-15,9207
2834,臺企銀,13,0,13,凱基-永和,2023-03-15,9207
2457,飛宏,32,21,11,凱基-永和,2023-03-15,9207
2338,光罩,10,0,10,凱基-永和,2023-03-15,9207
3520,華盈,10,0,10,凱基-永和,2023-03-15,9207
4967,十銓,10,0,10,凱基-永和,2023-03-15,9207
6244,茂迪,10,0,10,凱基-永和,2023-03-15,9207
8938,明安,10,0,10,凱基-永和,2023-03-15,9207
9945,潤泰新,9,0,9,凱基-永和,2023-03-15,9207
00882,中信中國高股息,8,0,8,凱基-永和,2023-03-15,9207
2497,怡利電,9,1,8,凱基-永和,2023-03-15,9207
3231,緯創,7,0,7,凱基-永和,2023-03-15,9207
00679B,元大美債20年,7,0,7,凱基-永和,2023-03-15,9207
2915,潤泰全,8,1,7,凱基-永和,2023-03-15,9207
3027,盛達,23,16,7,凱基-永和,2023-03-15,9207
4564,元翎,7,0,7,凱基-永和,2023-03-15,9207
5206,坤悅,7,0,7,凱基-永和,2023-03-15,9207
2317,鴻海,6,0,6,凱基-永和,2023-03-15,9207
4583,台灣精銳,6,0,6,凱基-永和,2023-03-15,9207
5234,達興材料,6,0,6,凱基-永和,2023-03-15,9207
1722,台肥,5,0,5,凱基-永和,2023-03-15,9207
00671R,富邦NASDAQ反1,5,0,5,凱基-永和,2023-03-15,9207
3093,港建*,6,1,5,凱基-永和,2023-03-15,9207
8069,元太,5,0,5,凱基-永和,2023-03-15,9207
00885,富邦越南,5,1,4,凱基-永和,2023-03-15,9207
0056,元大高股息,30,26,4,凱基-永和,2023-03-15,9207
00772B,中信高評級公司債,4,0,4,凱基-永和,2023-03-15,9207
2009,第一銅,4,0,4,凱基-永和,2023-03-15,9207
5608,四維航,11,7,4,凱基-永和,2023-03-15,9207
6613,朋億*,4,0,4,凱基-永和,2023-03-15,9207
2881,富邦金,5,1,4,凱基-永和,2023-03-15,9207
00878,國泰永續高股息,85,3,82,凱基-永和,2023-03-16,9207
3661,世芯-KY,58,3,55,凱基-永和,2023-03-16,9207
6109,亞元,45,0,45,凱基-永和,2023-03-16,9207
00713,元大台灣高息低波,42,0,42,凱基-永和,2023-03-16,9207
1312,國喬,41,2,39,凱基-永和,2023-03-16,9207
2312,金寶,32,0,32,凱基-永和,2023-03-16,9207
2618,長榮航,68,36,32,凱基-永和,2023-03-16,9207
2882,國泰金,34,2,32,凱基-永和,2023-03-16,9207
0056,元大高股息,27,0,27,凱基-永和,2023-03-16,9207
2834,臺企銀,56,30,26,凱基-永和,2023-03-16,9207
2891,中信金,36,12,24,凱基-永和,2023-03-16,9207
4119,旭富,21,0,21,凱基-永和,2023-03-16,9207
1473,台南,20,0,20,凱基-永和,2023-03-16,9207
2542,興富發,20,0,20,凱基-永和,2023-03-16,9207
6244,茂迪,37,17,20,凱基-永和,2023-03-16,9207
1722,台肥,24,5,19,凱基-永和,2023-03-16,9207
2603,長榮,38,20,18,凱基-永和,2023-03-16,9207
3056,富華新,44,26,18,凱基-永和,2023-03-16,9207
2888,新光金,18,0,18,凱基-永和,2023-03-16,9207
00642U,期元大S＆P石油,26,10,16,凱基-永和,2023-03-16,9207
3011,今皓,13,0,13,凱基-永和,2023-03-16,9207
5425,台半,16,3,13,凱基-永和,2023-03-16,9207
2884,玉山金,13,0,13,凱基-永和,2023-03-16,9207
0050,元大台灣50,12,0,12,凱基-永和,2023-03-16,9207
00881,國泰台灣5G+,11,0,11,凱基-永和,2023-03-16,9207
5011,久陽,11,0,11,凱基-永和,2023-03-16,9207
00679B,元大美債20年,11,1,10,凱基-永和,2023-03-16,9207
4168,醣聯,10,0,10,凱基-永和,2023-03-16,9207
5206,坤悅,10,0,10,凱基-永和,2023-03-16,9207
8289,泰藝,10,0,10,凱基-永和,2023-03-16,9207
2892,第一金,10,0,10,凱基-永和,2023-03-16,9207
2548,華固,9,0,9,凱基-永和,2023-03-16,9207
6605,帝寶,9,0,9,凱基-永和,2023-03-16,9207
4533,協易機,8,0,8,凱基-永和,2023-03-16,9207
2881,富邦金,8,1,7,凱基-永和,2023-03-16,9207
1522,堤維西,7,0,7,凱基-永和,2023-03-16,9207
1536,和大,7,0,7,凱基-永和,2023-03-16,9207
2457,飛宏,69,62,7,凱基-永和,2023-03-16,9207
5483,中美晶,6,0,6,凱基-永和,2023-03-16,9207
2365,昆盈,10,4,6,凱基-永和,2023-03-16,9207
2375,凱美,7,1,6,凱基-永和,2023-03-16,9207
3037,欣興,9,3,6,凱基-永和,2023-03-16,9207
6202,盛群,6,0,6,凱基-永和,2023-03-16,9207
2886,兆豐金,6,0,6,凱基-永和,2023-03-16,9207
2330,台積電,6,0,6,凱基-永和,2023-03-16,9207
2880,華南金,6,0,6,凱基-永和,2023-03-16,9207
00671R,富邦NASDAQ反1,5,0,5,凱基-永和,2023-03-16,9207
2022,聚亨,5,0,5,凱基-永和,2023-03-16,9207
2302,麗正,5,0,5,凱基-永和,2023-03-16,9207
2344,華邦電,5,0,5,凱基-永和,2023-03-16,9207
2471,資通,139,63,76,凱基-永和,2023-03-17,9207
00893,國泰智能電動車,80,5,75,凱基-永和,2023-03-17,9207
2891,中信金,56,0,56,凱基-永和,2023-03-17,9207
2887,台新金,56,0,56,凱基-永和,2023-03-17,9207
1432,大魯閣,50,0,50,凱基-永和,2023-03-17,9207
00632R,元大台灣50反1,30,0,30,凱基-永和,2023-03-17,9207
6788,華景電,63,33,30,凱基-永和,2023-03-17,9207
6874,倍力,22,1,21,凱基-永和,2023-03-17,9207
00795B,中信美國公債20年,20,0,20,凱基-永和,2023-03-17,9207
2481,強茂,20,0,20,凱基-永和,2023-03-17,9207
6109,亞元,20,0,20,凱基-永和,2023-03-17,9207
2548,華固,18,0,18,凱基-永和,2023-03-17,9207
00878,國泰永續高股息,19,2,17,凱基-永和,2023-03-17,9207
2002,中鋼,20,4,16,凱基-永和,2023-03-17,9207
3707,漢磊,16,2,14,凱基-永和,2023-03-17,9207
00713,元大台灣高息低波,11,0,11,凱基-永和,2023-03-17,9207
2834,臺企銀,12,1,11,凱基-永和,2023-03-17,9207
9904,寶成,11,0,11,凱基-永和,2023-03-17,9207
2017,官田鋼,10,0,10,凱基-永和,2023-03-17,9207
2756,聯發國際,10,0,10,凱基-永和,2023-03-17,9207
2342,茂矽,10,0,10,凱基-永和,2023-03-17,9207
3029,零壹,11,1,10,凱基-永和,2023-03-17,9207
2610,華航,12,3,9,凱基-永和,2023-03-17,9207
2888,新光金,8,0,8,凱基-永和,2023-03-17,9207
6743,安普新,8,0,8,凱基-永和,2023-03-17,9207
1504,東元,8,1,7,凱基-永和,2023-03-17,9207
3105,穩懋,7,0,7,凱基-永和,2023-03-17,9207
6182,合晶,6,0,6,凱基-永和,2023-03-17,9207
6271,同欣電,6,0,6,凱基-永和,2023-03-17,9207
1526,日馳,6,0,6,凱基-永和,2023-03-17,9207
2915,潤泰全,6,0,6,凱基-永和,2023-03-17,9207
00642U,期元大S＆P石油,5,0,5,凱基-永和,2023-03-17,9207
2014,中鴻,12,7,5,凱基-永和,2023-03-17,9207
3033,威健,5,0,5,凱基-永和,2023-03-17,9207
3712,永崴投控,5,0,5,凱基-永和,2023-03-17,9207
9945,潤泰新,5,0,5,凱基-永和,2023-03-17,9207
3035,智原,25,21,4,凱基-永和,2023-03-17,9207
3594,磐儀,5,1,4,凱基-永和,2023-03-17,9207
6531,愛普*,6,2,4,凱基-永和,2023-03-17,9207
6589,台康生技,4,0,4,凱基-永和,2023-03-17,9207
2609,陽明,5,1,4,凱基-永和,2023-03-17,9207
9921,巨大,4,0,4,凱基-永和,2023-03-17,9207
1316,上曜,3,0,3,凱基-永和,2023-03-17,9207
1308,亞聚,4,1,3,凱基-永和,2023-03-17,9207
1708,東鹼,3,0,3,凱基-永和,2023-03-17,9207
2105,正新,3,0,3,凱基-永和,2023-03-17,9207
2867,三商壽,3,0,3,凱基-永和,2023-03-17,9207
3042,晶技,3,0,3,凱基-永和,2023-03-17,9207
4979,華星光,5,2,3,凱基-永和,2023-03-17,9207
8033,雷虎,4,1,3,凱基-永和,2023-03-17,9207
3017,奇鋐,125,1,124,凱基-永和,2023-03-20,9207
6274,台燿,100,2,98,凱基-永和,2023-03-20,9207
00893,國泰智能電動車,80,0,80,凱基-永和,2023-03-20,9207
1603,華電,50,0,50,凱基-永和,2023-03-20,9207
8033,雷虎,34,0,34,凱基-永和,2023-03-20,9207
4967,十銓,72,38,34,凱基-永和,2023-03-20,9207
2371,大同,30,0,30,凱基-永和,2023-03-20,9207
00878,國泰永續高股息,30,3,27,凱基-永和,2023-03-20,9207
2453,凌群,27,1,26,凱基-永和,2023-03-20,9207
00715L,期街口布蘭特正2,25,0,25,凱基-永和,2023-03-20,9207
2317,鴻海,21,0,21,凱基-永和,2023-03-20,9207
1722,台肥,20,0,20,凱基-永和,2023-03-20,9207
2891,中信金,20,1,19,凱基-永和,2023-03-20,9207
2739,寒舍,17,0,17,凱基-永和,2023-03-20,9207
2609,陽明,16,3,13,凱基-永和,2023-03-20,9207
2834,臺企銀,13,0,13,凱基-永和,2023-03-20,9207
00642U,期元大S＆P石油,11,0,11,凱基-永和,2023-03-20,9207
00900,富邦特選高股息30,11,0,11,凱基-永和,2023-03-20,9207
2359,所羅門,13,2,11,凱基-永和,2023-03-20,9207
6509,聚和,11,0,11,凱基-永和,2023-03-20,9207
2352,佳世達,10,0,10,凱基-永和,2023-03-20,9207
1309,台達化,10,0,10,凱基-永和,2023-03-20,9207
00897,富邦基因免疫生技,10,0,10,凱基-永和,2023-03-20,9207
2617,台航,10,0,10,凱基-永和,2023-03-20,9207
6187,萬潤,10,0,10,凱基-永和,2023-03-20,9207
2883,凱基金,8,0,8,凱基-永和,2023-03-20,9207
00720B,元大投資級公司債,8,0,8,凱基-永和,2023-03-20,9207
2423,固緯,8,0,8,凱基-永和,2023-03-20,9207
4729,熒茂,8,0,8,凱基-永和,2023-03-20,9207
2882,國泰金,11,3,8,凱基-永和,2023-03-20,9207
4550,長佳,7,0,7,凱基-永和,2023-03-20,9207
2353,宏��,7,0,7,凱基-永和,2023-03-20,9207
2449,京元電子,10,4,6,凱基-永和,2023-03-20,9207
3005,神基,7,1,6,凱基-永和,2023-03-20,9207
4114,健喬,6,0,6,凱基-永和,2023-03-20,9207
4160,訊聯基因,6,0,6,凱基-永和,2023-03-20,9207
2881,富邦金,6,0,6,凱基-永和,2023-03-20,9207
2022,聚亨,5,0,5,凱基-永和,2023-03-20,9207
3290,東浦,5,0,5,凱基-永和,2023-03-20,9207
6197,佳必琪,5,0,5,凱基-永和,2023-03-20,9207
8046,南電,5,0,5,凱基-永和,2023-03-20,9207
1605,華新,4,0,4,凱基-永和,2023-03-20,9207
1519,華城,4,0,4,凱基-永和,2023-03-20,9207
00902,中信電池及儲能,4,0,4,凱基-永和,2023-03-20,9207
00885,富邦越南,5,1,4,凱基-永和,2023-03-20,9207
00637L,元大滬深300正2,9,5,4,凱基-永和,2023-03-20,9207
2618,長榮航,6,2,4,凱基-永和,2023-03-20,9207
2884,玉山金,4,0,4,凱基-永和,2023-03-20,9207
3027,盛達,14,10,4,凱基-永和,2023-03-20,9207
3264,欣銓,4,0,4,凱基-永和,2023-03-20,9207
2402,毅嘉,316,127,189,凱基-永和,2023-03-21,9207
3533,嘉澤,60,0,60,凱基-永和,2023-03-21,9207
6156,松上,60,0,60,凱基-永和,2023-03-21,9207
4729,熒茂,45,0,45,凱基-永和,2023-03-21,9207
6122,擎邦,40,0,40,凱基-永和,2023-03-21,9207
2888,新光金,40,10,30,凱基-永和,2023-03-21,9207
3002,歐格,30,0,30,凱基-永和,2023-03-21,9207
2891,中信金,25,2,23,凱基-永和,2023-03-21,9207
7402,邑錡,24,1,23,凱基-永和,2023-03-21,9207
2890,永豐金,22,0,22,凱基-永和,2023-03-21,9207
3481,群創,30,8,22,凱基-永和,2023-03-21,9207
3056,富華新,23,2,21,凱基-永和,2023-03-21,9207
2897,王道銀行,20,0,20,凱基-永和,2023-03-21,9207
2409,友達,21,4,17,凱基-永和,2023-03-21,9207
1504,東元,18,3,15,凱基-永和,2023-03-21,9207
00669R,國泰美國道瓊反1,15,0,15,凱基-永和,2023-03-21,9207
00632R,元大台灣50反1,15,0,15,凱基-永和,2023-03-21,9207
6245,立端,14,0,14,凱基-永和,2023-03-21,9207
6811,宏�硌穈T,13,0,13,凱基-永和,2023-03-21,9207
2481,強茂,12,0,12,凱基-永和,2023-03-21,9207
00830,國泰費城半導體,14,3,11,凱基-永和,2023-03-21,9207
1603,華電,61,50,11,凱基-永和,2023-03-21,9207
5371,中光電,10,0,10,凱基-永和,2023-03-21,9207
1314,中石化,10,0,10,凱基-永和,2023-03-21,9207
00648R,元大S＆P500反1,10,0,10,凱基-永和,2023-03-21,9207
2460,建通,10,0,10,凱基-永和,2023-03-21,9207
2537,聯上發,10,0,10,凱基-永和,2023-03-21,9207
5607,遠雄港,10,0,10,凱基-永和,2023-03-21,9207
8064,東捷,10,0,10,凱基-永和,2023-03-21,9207
3346,麗清,10,1,9,凱基-永和,2023-03-21,9207
00720B,元大投資級公司債,8,0,8,凱基-永和,2023-03-21,9207
2610,華航,8,0,8,凱基-永和,2023-03-21,9207
2429,銘旺科,8,0,8,凱基-永和,2023-03-21,9207
3094,聯傑,24,16,8,凱基-永和,2023-03-21,9207
3508,位速,8,0,8,凱基-永和,2023-03-21,9207
2881,富邦金,7,0,7,凱基-永和,2023-03-21,9207
4976,佳凌,6,0,6,凱基-永和,2023-03-21,9207
5425,台半,27,21,6,凱基-永和,2023-03-21,9207
6531,愛普*,17,11,6,凱基-永和,2023-03-21,9207
2845,遠東銀,6,0,6,凱基-永和,2023-03-21,9207
1526,日馳,5,0,5,凱基-永和,2023-03-21,9207
00885,富邦越南,5,0,5,凱基-永和,2023-03-21,9207
00634R,富邦上証反1,5,0,5,凱基-永和,2023-03-21,9207
1503,士電,5,0,5,凱基-永和,2023-03-21,9207
2206,三陽工業,5,0,5,凱基-永和,2023-03-21,9207
2345,智邦,15,10,5,凱基-永和,2023-03-21,9207
2609,陽明,6,1,5,凱基-永和,2023-03-21,9207
3041,揚智,5,0,5,凱基-永和,2023-03-21,9207
3454,晶睿,5,0,5,凱基-永和,2023-03-21,9207
3498,陽程,5,0,5,凱基-永和,2023-03-21,9207
3017,奇鋐,497,4,493,凱基-永和,2023-03-22,9207
5425,台半,295,148,147,凱基-永和,2023-03-22,9207
3499,環天科,300,156,144,凱基-永和,2023-03-22,9207
6266,泰詠,111,0,111,凱基-永和,2023-03-22,9207
3710,連展投控,100,0,100,凱基-永和,2023-03-22,9207
3322,建舜電,166,85,81,凱基-永和,2023-03-22,9207
2888,新光金,82,7,75,凱基-永和,2023-03-22,9207
2515,中工,60,0,60,凱基-永和,2023-03-22,9207
3479,安勤,56,2,54,凱基-永和,2023-03-22,9207
2812,台中銀,48,0,48,凱基-永和,2023-03-22,9207
00679B,元大美債20年,40,0,40,凱基-永和,2023-03-22,9207
6811,宏�硌穈T,36,0,36,凱基-永和,2023-03-22,9207
00632R,元大台灣50反1,35,0,35,凱基-永和,2023-03-22,9207
2201,裕隆,32,0,32,凱基-永和,2023-03-22,9207
2887,台新金,42,10,32,凱基-永和,2023-03-22,9207
2303,聯電,43,12,31,凱基-永和,2023-03-22,9207
2359,所羅門,75,47,28,凱基-永和,2023-03-22,9207
00885,富邦越南,24,0,24,凱基-永和,2023-03-22,9207
00795B,中信美國公債20年,21,0,21,凱基-永和,2023-03-22,9207
3056,富華新,24,3,21,凱基-永和,2023-03-22,9207
6472,保瑞,20,0,20,凱基-永和,2023-03-22,9207
1605,華新,20,1,19,凱基-永和,2023-03-22,9207
3189,景碩,20,1,19,凱基-永和,2023-03-22,9207
6669,緯穎,20,1,19,凱基-永和,2023-03-22,9207
6715,嘉基,19,0,19,凱基-永和,2023-03-22,9207
1603,華電,18,0,18,凱基-永和,2023-03-22,9207
4967,十銓,15,0,15,凱基-永和,2023-03-22,9207
6129,普誠,17,2,15,凱基-永和,2023-03-22,9207
2610,華航,16,1,15,凱基-永和,2023-03-22,9207
2618,長榮航,12,0,12,凱基-永和,2023-03-22,9207
3260,威剛,12,0,12,凱基-永和,2023-03-22,9207
6874,倍力,13,2,11,凱基-永和,2023-03-22,9207
00650L,復華香港正2,10,0,10,凱基-永和,2023-03-22,9207
00648R,元大S＆P500反1,10,0,10,凱基-永和,2023-03-22,9207
00669R,國泰美國道瓊反1,10,0,10,凱基-永和,2023-03-22,9207
3515,華擎,10,0,10,凱基-永和,2023-03-22,9207
4746,台耀,10,0,10,凱基-永和,2023-03-22,9207
8046,南電,13,3,10,凱基-永和,2023-03-22,9207
1513,中興電,7,0,7,凱基-永和,2023-03-22,9207
00720B,元大投資級公司債,7,0,7,凱基-永和,2023-03-22,9207
2409,友達,9,2,7,凱基-永和,2023-03-22,9207
2387,精元,6,0,6,凱基-永和,2023-03-22,9207
6488,環球晶,6,0,6,凱基-永和,2023-03-22,9207
00635U,期元大S＆P黃金,5,0,5,凱基-永和,2023-03-22,9207
1722,台肥,5,0,5,凱基-永和,2023-03-22,9207
2344,華邦電,5,0,5,凱基-永和,2023-03-22,9207
2352,佳世達,16,11,5,凱基-永和,2023-03-22,9207
2845,遠東銀,5,0,5,凱基-永和,2023-03-22,9207
3290,東浦,20,15,5,凱基-永和,2023-03-22,9207
3346,麗清,5,0,5,凱基-永和,2023-03-22,9207
2610,華航,350,2,348,凱基-永和,2023-03-23,9207
3017,奇鋐,287,14,273,凱基-永和,2023-03-23,9207
6122,擎邦,226,50,176,凱基-永和,2023-03-23,9207
2303,聯電,137,7,130,凱基-永和,2023-03-23,9207
8234,新漢,105,30,75,凱基-永和,2023-03-23,9207
8069,元太,58,0,58,凱基-永和,2023-03-23,9207
1524,耿鼎,70,15,55,凱基-永和,2023-03-23,9207
8478,東哥遊艇,63,22,41,凱基-永和,2023-03-23,9207
3363,上詮,33,0,33,凱基-永和,2023-03-23,9207
2888,新光金,30,3,27,凱基-永和,2023-03-23,9207
00772B,中信高評級公司債,21,1,20,凱基-永和,2023-03-23,9207
6138,茂達,15,0,15,凱基-永和,2023-03-23,9207
6156,松上,15,0,15,凱基-永和,2023-03-23,9207
4147,中裕,15,2,13,凱基-永和,2023-03-23,9207
3094,聯傑,45,33,12,凱基-永和,2023-03-23,9207
00679B,元大美債20年,11,0,11,凱基-永和,2023-03-23,9207
00712,復華富時不動產,11,0,11,凱基-永和,2023-03-23,9207
00795B,中信美國公債20年,10,0,10,凱基-永和,2023-03-23,9207
1783,和康生,10,0,10,凱基-永和,2023-03-23,9207
2376,技嘉,16,6,10,凱基-永和,2023-03-23,9207
2834,臺企銀,10,0,10,凱基-永和,2023-03-23,9207
4538,大詠城,10,0,10,凱基-永和,2023-03-23,9207
5015,華祺,10,0,10,凱基-永和,2023-03-23,9207
6101,寬魚國際,10,0,10,凱基-永和,2023-03-23,9207
6196,帆宣,10,0,10,凱基-永和,2023-03-23,9207
6754,匯僑設計,10,0,10,凱基-永和,2023-03-23,9207
8358,金居,10,0,10,凱基-永和,2023-03-23,9207
2605,新興,8,0,8,凱基-永和,2023-03-23,9207
3162,精確,10,3,7,凱基-永和,2023-03-23,9207
2402,毅嘉,39,32,7,凱基-永和,2023-03-23,9207
2609,陽明,21,15,6,凱基-永和,2023-03-23,9207
2345,智邦,7,1,6,凱基-永和,2023-03-23,9207
2882,國泰金,6,0,6,凱基-永和,2023-03-23,9207
6767,台微醫,6,0,6,凱基-永和,2023-03-23,9207
1451,年興,5,0,5,凱基-永和,2023-03-23,9207
00885,富邦越南,5,0,5,凱基-永和,2023-03-23,9207
2204,中華,7,2,5,凱基-永和,2023-03-23,9207
3591,艾笛森,5,0,5,凱基-永和,2023-03-23,9207
3653,健策,6,1,5,凱基-永和,2023-03-23,9207
4566,時碩工業,5,0,5,凱基-永和,2023-03-23,9207
4763,材料-KY,7,2,5,凱基-永和,2023-03-23,9207
6509,聚和,6,1,5,凱基-永和,2023-03-23,9207
6605,帝寶,5,0,5,凱基-永和,2023-03-23,9207
2891,中信金,7,2,5,凱基-永和,2023-03-23,9207
4564,元翎,4,0,4,凱基-永和,2023-03-23,9207
00720B,元大投資級公司債,4,0,4,凱基-永和,2023-03-23,9207
3530,晶相光,4,0,4,凱基-永和,2023-03-23,9207
4160,訊聯基因,4,0,4,凱基-永和,2023-03-23,9207
4729,熒茂,4,0,4,凱基-永和,2023-03-23,9207
6129,普誠,4,0,4,凱基-永和,2023-03-23,9207
3714,富采,147,29,118,凱基-永和,2023-03-24,9207
1504,東元,104,5,99,凱基-永和,2023-03-24,9207
3035,智原,283,188,95,凱基-永和,2023-03-24,9207
6244,茂迪,70,1,69,凱基-永和,2023-03-24,9207
4402,郡都開發,66,0,66,凱基-永和,2023-03-24,9207
6733,博晟生醫,49,0,49,凱基-永和,2023-03-24,9207
2303,聯電,45,5,40,凱基-永和,2023-03-24,9207
5534,長虹,38,0,38,凱基-永和,2023-03-24,9207
2515,中工,30,0,30,凱基-永和,2023-03-24,9207
2331,精英,26,0,26,凱基-永和,2023-03-24,9207
3491,昇達科,25,3,22,凱基-永和,2023-03-24,9207
2888,新光金,20,0,20,凱基-永和,2023-03-24,9207
2402,毅嘉,22,3,19,凱基-永和,2023-03-24,9207
2328,廣宇,19,1,18,凱基-永和,2023-03-24,9207
3013,晟銘電,16,0,16,凱基-永和,2023-03-24,9207
3022,威強電,16,1,15,凱基-永和,2023-03-24,9207
00679B,元大美債20年,15,0,15,凱基-永和,2023-03-24,9207
1104,環泥,12,0,12,凱基-永和,2023-03-24,9207
2332,友訊,11,0,11,凱基-永和,2023-03-24,9207
2349,錸德,10,0,10,凱基-永和,2023-03-24,9207
5243,乙盛-KY,10,0,10,凱基-永和,2023-03-24,9207
8121,越峰,10,0,10,凱基-永和,2023-03-24,9207
8936,國統,10,0,10,凱基-永和,2023-03-24,9207
3036,文曄,9,1,8,凱基-永和,2023-03-24,9207
6116,彩晶,7,0,7,凱基-永和,2023-03-24,9207
5009,榮剛,9,2,7,凱基-永和,2023-03-24,9207
00751B,元大AAA至A公司債,6,0,6,凱基-永和,2023-03-24,9207
2101,南港,6,0,6,凱基-永和,2023-03-24,9207
3545,敦泰,6,0,6,凱基-永和,2023-03-24,9207
4164,承業醫,6,0,6,凱基-永和,2023-03-24,9207
6472,保瑞,9,3,6,凱基-永和,2023-03-24,9207
8996,高力,7,2,5,凱基-永和,2023-03-24,9207
1513,中興電,5,0,5,凱基-永和,2023-03-24,9207
00683L,期元大美元指正2,5,0,5,凱基-永和,2023-03-24,9207
00720B,元大投資級公司債,5,0,5,凱基-永和,2023-03-24,9207
1752,南光,5,0,5,凱基-永和,2023-03-24,9207
2345,智邦,5,0,5,凱基-永和,2023-03-24,9207
2376,技嘉,6,1,5,凱基-永和,2023-03-24,9207
2610,華航,5,0,5,凱基-永和,2023-03-24,9207
2641,正德,5,0,5,凱基-永和,2023-03-24,9207
3062,建漢,5,0,5,凱基-永和,2023-03-24,9207
4566,時碩工業,5,0,5,凱基-永和,2023-03-24,9207
4967,十銓,6,1,5,凱基-永和,2023-03-24,9207
6290,良維,5,0,5,凱基-永和,2023-03-24,9207
6840,東研信超,5,0,5,凱基-永和,2023-03-24,9207
9904,寶成,5,0,5,凱基-永和,2023-03-24,9207
3592,瑞鼎,4,0,4,凱基-永和,2023-03-24,9207
4564,元翎,4,0,4,凱基-永和,2023-03-24,9207
4763,材料-KY,4,0,4,凱基-永和,2023-03-24,9207
5258,虹堡,4,0,4,凱基-永和,2023-03-24,9207
1524,耿鼎,100,1,99,凱基-永和,2023-03-27,9207
8033,雷虎,104,6,98,凱基-永和,2023-03-27,9207
2201,裕隆,73,0,73,凱基-永和,2023-03-27,9207
6152,百一,63,1,62,凱基-永和,2023-03-27,9207
6753,龍德造船,60,0,60,凱基-永和,2023-03-27,9207
1605,華新,63,11,52,凱基-永和,2023-03-27,9207
2331,精英,50,0,50,凱基-永和,2023-03-27,9207
6122,擎邦,46,0,46,凱基-永和,2023-03-27,9207
1101,台泥,26,0,26,凱基-永和,2023-03-27,9207
2344,華邦電,29,4,25,凱基-永和,2023-03-27,9207
2002,中鋼,34,10,24,凱基-永和,2023-03-27,9207
6116,彩晶,25,2,23,凱基-永和,2023-03-27,9207
5222,全訊,44,23,21,凱基-永和,2023-03-27,9207
00878,國泰永續高股息,24,4,20,凱基-永和,2023-03-27,9207
2342,茂矽,20,0,20,凱基-永和,2023-03-27,9207
3520,華盈,20,0,20,凱基-永和,2023-03-27,9207
5225,東科-KY,20,0,20,凱基-永和,2023-03-27,9207
6517,保勝光學,20,0,20,凱基-永和,2023-03-27,9207
00882,中信中國高股息,18,0,18,凱基-永和,2023-03-27,9207
6288,聯嘉,20,3,17,凱基-永和,2023-03-27,9207
2412,中華電,16,0,16,凱基-永和,2023-03-27,9207
3056,富華新,13,0,13,凱基-永和,2023-03-27,9207
1455,集盛,10,0,10,凱基-永和,2023-03-27,9207
2371,大同,10,0,10,凱基-永和,2023-03-27,9207
2548,華固,10,0,10,凱基-永和,2023-03-27,9207
2888,新光金,10,0,10,凱基-永和,2023-03-27,9207
3045,台灣大,10,0,10,凱基-永和,2023-03-27,9207
5512,力麒,10,0,10,凱基-永和,2023-03-27,9207
5522,遠雄,10,0,10,凱基-永和,2023-03-27,9207
6806,森崴能源,13,3,10,凱基-永和,2023-03-27,9207
8088,品安,11,1,10,凱基-永和,2023-03-27,9207
3338,泰碩,10,1,9,凱基-永和,2023-03-27,9207
5386,青雲,8,0,8,凱基-永和,2023-03-27,9207
3005,神基,8,0,8,凱基-永和,2023-03-27,9207
3037,欣興,7,0,7,凱基-永和,2023-03-27,9207
0050,元大台灣50,27,20,7,凱基-永和,2023-03-27,9207
1522,堤維西,6,0,6,凱基-永和,2023-03-27,9207
3047,訊舟,13,7,6,凱基-永和,2023-03-27,9207
6205,詮欣,6,0,6,凱基-永和,2023-03-27,9207
3189,景碩,5,0,5,凱基-永和,2023-03-27,9207
3260,威剛,5,0,5,凱基-永和,2023-03-27,9207
4306,炎洲,5,0,5,凱基-永和,2023-03-27,9207
5425,台半,6,1,5,凱基-永和,2023-03-27,9207
6109,亞元,5,0,5,凱基-永和,2023-03-27,9207
6156,松上,5,0,5,凱基-永和,2023-03-27,9207
6840,東研信超,5,0,5,凱基-永和,2023-03-27,9207
9907,統一實,5,0,5,凱基-永和,2023-03-27,9207
2404,漢唐,5,1,4,凱基-永和,2023-03-27,9207
1519,華城,4,0,4,凱基-永和,2023-03-27,9207
1227,佳格,4,0,4,凱基-永和,2023-03-27,9207
2428,興勤,225,1,224,凱基-永和,2023-03-28,9207
6182,合晶,94,0,94,凱基-永和,2023-03-28,9207
00632R,元大台灣50反1,100,10,90,凱基-永和,2023-03-28,9207
2303,聯電,82,12,70,凱基-永和,2023-03-28,9207
00679B,元大美債20年,47,0,47,凱基-永和,2023-03-28,9207
4919,新唐,37,1,36,凱基-永和,2023-03-28,9207
6245,立端,33,2,31,凱基-永和,2023-03-28,9207
6517,保勝光學,50,20,30,凱基-永和,2023-03-28,9207
6129,普誠,27,0,27,凱基-永和,2023-03-28,9207
2342,茂矽,87,63,24,凱基-永和,2023-03-28,9207
6111,大宇資,22,1,21,凱基-永和,2023-03-28,9207
3002,歐格,20,0,20,凱基-永和,2023-03-28,9207
00922,國泰台灣領袖50,18,0,18,凱基-永和,2023-03-28,9207
2882,國泰金,15,0,15,凱基-永和,2023-03-28,9207
2461,光群雷,13,0,13,凱基-永和,2023-03-28,9207
6443,元晶,15,3,12,凱基-永和,2023-03-28,9207
00772B,中信高評級公司債,11,0,11,凱基-永和,2023-03-28,9207
2201,裕隆,19,8,11,凱基-永和,2023-03-28,9207
1455,集盛,10,0,10,凱基-永和,2023-03-28,9207
00878,國泰永續高股息,11,1,10,凱基-永和,2023-03-28,9207
6109,亞元,10,0,10,凱基-永和,2023-03-28,9207
6197,佳必琪,10,0,10,凱基-永和,2023-03-28,9207
8171,天宇,10,0,10,凱基-永和,2023-03-28,9207
2610,華航,11,2,9,凱基-永和,2023-03-28,9207
00720B,元大投資級公司債,9,0,9,凱基-永和,2023-03-28,9207
2409,友達,9,0,9,凱基-永和,2023-03-28,9207
3664,安瑞-KY,9,0,9,凱基-永和,2023-03-28,9207
1609,大亞,8,0,8,凱基-永和,2023-03-28,9207
2462,良得電,8,0,8,凱基-永和,2023-03-28,9207
3701,大眾控,8,0,8,凱基-永和,2023-03-28,9207
6168,宏齊,9,1,8,凱基-永和,2023-03-28,9207
8255,朋程,16,8,8,凱基-永和,2023-03-28,9207
8358,金居,9,1,8,凱基-永和,2023-03-28,9207
3037,欣興,16,9,7,凱基-永和,2023-03-28,9207
0050,元大台灣50,7,0,7,凱基-永和,2023-03-28,9207
1539,巨庭,7,0,7,凱基-永和,2023-03-28,9207
1605,華新,8,1,7,凱基-永和,2023-03-28,9207
6462,神盾,7,0,7,凱基-永和,2023-03-28,9207
4564,元翎,6,0,6,凱基-永和,2023-03-28,9207
3447,展達,6,0,6,凱基-永和,2023-03-28,9207
4160,訊聯基因,6,0,6,凱基-永和,2023-03-28,9207
00639,富邦深100,5,0,5,凱基-永和,2023-03-28,9207
2457,飛宏,7,2,5,凱基-永和,2023-03-28,9207
2481,強茂,24,19,5,凱基-永和,2023-03-28,9207
2883B,凱基金乙特,5,0,5,凱基-永和,2023-03-28,9207
3224,三顧,5,0,5,凱基-永和,2023-03-28,9207
4967,十銓,12,7,5,凱基-永和,2023-03-28,9207
5534,長虹,5,0,5,凱基-永和,2023-03-28,9207
00882,中信中國高股息,4,0,4,凱基-永和,2023-03-28,9207
2331,精英,4,0,4,凱基-永和,2023-03-28,9207
2428,興勤,240,0,240,凱基-永和,2023-03-29,9207
3324,雙鴻,169,0,169,凱基-永和,2023-03-29,9207
5475,德宏,132,10,122,凱基-永和,2023-03-29,9207
6443,元晶,113,0,113,凱基-永和,2023-03-29,9207
1618,合機,110,0,110,凱基-永和,2023-03-29,9207
1524,耿鼎,93,0,93,凱基-永和,2023-03-29,9207
2812,台中銀,38,0,38,凱基-永和,2023-03-29,9207
6122,擎邦,66,33,33,凱基-永和,2023-03-29,9207
5258,虹堡,26,1,25,凱基-永和,2023-03-29,9207
2303,聯電,32,9,23,凱基-永和,2023-03-29,9207
2461,光群雷,22,1,21,凱基-永和,2023-03-29,9207
2515,中工,20,0,20,凱基-永和,2023-03-29,9207
3338,泰碩,20,0,20,凱基-永和,2023-03-29,9207
8931,大汽電,20,0,20,凱基-永和,2023-03-29,9207
6171,大城地產,20,1,19,凱基-永和,2023-03-29,9207
2359,所羅門,30,11,19,凱基-永和,2023-03-29,9207
6282,康舒,15,0,15,凱基-永和,2023-03-29,9207
6244,茂迪,19,5,14,凱基-永和,2023-03-29,9207
3035,智原,28,15,13,凱基-永和,2023-03-29,9207
1101,台泥,12,0,12,凱基-永和,2023-03-29,9207
2459,敦吉,12,0,12,凱基-永和,2023-03-29,9207
8916,光隆,12,0,12,凱基-永和,2023-03-29,9207
00922,國泰台灣領袖50,11,0,11,凱基-永和,2023-03-29,9207
00878,國泰永續高股息,38,27,11,凱基-永和,2023-03-29,9207
1442,名軒,10,0,10,凱基-永和,2023-03-29,9207
00715L,期街口布蘭特正2,10,0,10,凱基-永和,2023-03-29,9207
1605,華新,12,2,10,凱基-永和,2023-03-29,9207
3019,亞光,10,0,10,凱基-永和,2023-03-29,9207
3432,台端,10,0,10,凱基-永和,2023-03-29,9207
7402,邑錡,10,0,10,凱基-永和,2023-03-29,9207
8024,佑華,10,0,10,凱基-永和,2023-03-29,9207
2314,台揚,8,0,8,凱基-永和,2023-03-29,9207
5285,界霖,8,0,8,凱基-永和,2023-03-29,9207
5309,系統電,8,0,8,凱基-永和,2023-03-29,9207
2206,三陽工業,10,3,7,凱基-永和,2023-03-29,9207
2357,華碩,7,0,7,凱基-永和,2023-03-29,9207
5206,坤悅,7,0,7,凱基-永和,2023-03-29,9207
6220,岳豐,7,0,7,凱基-永和,2023-03-29,9207
4763,材料-KY,6,0,6,凱基-永和,2023-03-29,9207
1536,和大,6,0,6,凱基-永和,2023-03-29,9207
2344,華邦電,7,1,6,凱基-永和,2023-03-29,9207
2371,大同,6,0,6,凱基-永和,2023-03-29,9207
2745,五福,6,0,6,凱基-永和,2023-03-29,9207
3322,建舜電,10,4,6,凱基-永和,2023-03-29,9207
5388,中磊,6,0,6,凱基-永和,2023-03-29,9207
1519,華城,5,0,5,凱基-永和,2023-03-29,9207
1784,訊聯,5,0,5,凱基-永和,2023-03-29,9207
2634,漢翔,6,1,5,凱基-永和,2023-03-29,9207
3694,海華,5,0,5,凱基-永和,2023-03-29,9207
3703,欣陸,5,0,5,凱基-永和,2023-03-29,9207
3664,安瑞-KY,69,10,59,凱基-永和,2023-03-30,9207
2426,鼎元,50,0,50,凱基-永和,2023-03-30,9207
3324,雙鴻,50,1,49,凱基-永和,2023-03-30,9207
6125,廣運,34,2,32,凱基-永和,2023-03-30,9207
1517,利奇,30,0,30,凱基-永和,2023-03-30,9207
6517,保勝光學,32,4,28,凱基-永和,2023-03-30,9207
1605,華新,26,1,25,凱基-永和,2023-03-30,9207
2515,中工,20,0,20,凱基-永和,2023-03-30,9207
3711,日月光投控,20,0,20,凱基-永和,2023-03-30,9207
3481,群創,17,0,17,凱基-永和,2023-03-30,9207
5425,台半,16,0,16,凱基-永和,2023-03-30,9207
6282,康舒,18,2,16,凱基-永和,2023-03-30,9207
00679B,元大美債20年,15,0,15,凱基-永和,2023-03-30,9207
1101,台泥,22,9,13,凱基-永和,2023-03-30,9207
00713,元大台灣高息低波,11,0,11,凱基-永和,2023-03-30,9207
00878,國泰永續高股息,12,1,11,凱基-永和,2023-03-30,9207
1314,中石化,10,0,10,凱基-永和,2023-03-30,9207
2329,華泰,10,0,10,凱基-永和,2023-03-30,9207
3483,力致,11,1,10,凱基-永和,2023-03-30,9207
5015,華祺,10,0,10,凱基-永和,2023-03-30,9207
6244,茂迪,10,0,10,凱基-永和,2023-03-30,9207
00882,中信中國高股息,10,0,10,凱基-永和,2023-03-30,9207
8086,宏捷科,14,5,9,凱基-永和,2023-03-30,9207
6239,力成,11,2,9,凱基-永和,2023-03-30,9207
2548,華固,9,0,9,凱基-永和,2023-03-30,9207
2330,台積電,8,0,8,凱基-永和,2023-03-30,9207
3704,合勤控,7,0,7,凱基-永和,2023-03-30,9207
3484,崧騰,7,0,7,凱基-永和,2023-03-30,9207
3706,神達,7,0,7,凱基-永和,2023-03-30,9207
2731,雄獅,8,1,7,凱基-永和,2023-03-30,9207
1560,中砂,7,1,6,凱基-永和,2023-03-30,9207
4729,熒茂,6,0,6,凱基-永和,2023-03-30,9207
00715L,期街口布蘭特正2,5,0,5,凱基-永和,2023-03-30,9207
1584,精剛,5,0,5,凱基-永和,2023-03-30,9207
2392,正崴,5,0,5,凱基-永和,2023-03-30,9207
2610,華航,5,0,5,凱基-永和,2023-03-30,9207
2739,寒舍,5,0,5,凱基-永和,2023-03-30,9207
2867,三商壽,5,0,5,凱基-永和,2023-03-30,9207
4528,江興鍛,5,0,5,凱基-永和,2023-03-30,9207
5439,高技,5,0,5,凱基-永和,2023-03-30,9207
8112,至上,5,0,5,凱基-永和,2023-03-30,9207
3218,大學光,5,0,5,凱基-永和,2023-03-30,9207
2882,國泰金,5,1,4,凱基-永和,2023-03-30,9207
2609,陽明,5,1,4,凱基-永和,2023-03-30,9207
1524,耿鼎,4,0,4,凱基-永和,2023-03-30,9207
1795,美時,4,1,3,凱基-永和,2023-03-30,9207
2484,希華,3,0,3,凱基-永和,2023-03-30,9207
2753,八方雲集,4,1,3,凱基-永和,2023-03-30,9207
2883,凱基金,4,1,3,凱基-永和,2023-03-30,9207
3083,網龍,3,0,3,凱基-永和,2023-03-30,9207
1722,台肥,118,0,118,凱基-永和,2023-03-31,9207
5512,力麒,100,0,100,凱基-永和,2023-03-31,9207
1560,中砂,36,3,33,凱基-永和,2023-03-31,9207
3447,展達,27,3,24,凱基-永和,2023-03-31,9207
00897,富邦基因免疫生技,20,0,20,凱基-永和,2023-03-31,9207
1605,華新,21,6,15,凱基-永和,2023-03-31,9207
2201,裕隆,15,0,15,凱基-永和,2023-03-31,9207
2312,金寶,15,0,15,凱基-永和,2023-03-31,9207
2408,南亞科,38,23,15,凱基-永和,2023-03-31,9207
6282,康舒,16,1,15,凱基-永和,2023-03-31,9207
8171,天宇,15,0,15,凱基-永和,2023-03-31,9207
2413,環科,14,0,14,凱基-永和,2023-03-31,9207
00922,國泰台灣領袖50,12,0,12,凱基-永和,2023-03-31,9207
3540,曜越,17,6,11,凱基-永和,2023-03-31,9207
6171,大城地產,11,0,11,凱基-永和,2023-03-31,9207
1806,冠軍,10,0,10,凱基-永和,2023-03-31,9207
6168,宏齊,10,0,10,凱基-永和,2023-03-31,9207
6233,旺玖,10,0,10,凱基-永和,2023-03-31,9207
6290,良維,12,2,10,凱基-永和,2023-03-31,9207
8028,昇陽半導體,12,2,10,凱基-永和,2023-03-31,9207
6163,華電網,11,2,9,凱基-永和,2023-03-31,9207
3290,東浦,8,0,8,凱基-永和,2023-03-31,9207
8110,華東,10,2,8,凱基-永和,2023-03-31,9207
00679B,元大美債20年,6,0,6,凱基-永和,2023-03-31,9207
2548,華固,6,0,6,凱基-永和,2023-03-31,9207
2618,長榮航,6,0,6,凱基-永和,2023-03-31,9207
6187,萬潤,6,0,6,凱基-永和,2023-03-31,9207
8086,宏捷科,9,3,6,凱基-永和,2023-03-31,9207
00632R,元大台灣50反1,5,0,5,凱基-永和,2023-03-31,9207
1513,中興電,6,1,5,凱基-永和,2023-03-31,9207
2359,所羅門,5,0,5,凱基-永和,2023-03-31,9207
2425,承啟,5,0,5,凱基-永和,2023-03-31,9207
3264,欣銓,5,0,5,凱基-永和,2023-03-31,9207
4967,十銓,25,20,5,凱基-永和,2023-03-31,9207
5011,久陽,5,0,5,凱基-永和,2023-03-31,9207
6830,汎銓,5,0,5,凱基-永和,2023-03-31,9207
3037,欣興,6,2,4,凱基-永和,2023-03-31,9207
1752,南光,8,4,4,凱基-永和,2023-03-31,9207
1795,美時,7,3,4,凱基-永和,2023-03-31,9207
6235,華孚,14,10,4,凱基-永和,2023-03-31,9207
9105,泰金寶-DR,4,0,4,凱基-永和,2023-03-31,9207
4746,台耀,3,0,3,凱基-永和,2023-03-31,9207
2454,聯發科,4,1,3,凱基-永和,2023-03-31,9207
3032,偉訓,3,0,3,凱基-永和,2023-03-31,9207
3706,神達,3,0,3,凱基-永和,2023-03-31,9207
3715,定穎投控,3,0,3,凱基-永和,2023-03-31,9207
6462,神盾,3,0,3,凱基-永和,2023-03-31,9207
6643,M31,5,2,3,凱基-永和,2023-03-31,9207
8210,勤誠,3,0,3,凱基-永和,2023-03-31,9207
2603,長榮,2,0,2,凱基-永和,2023-03-31,9207
2344,華邦電,50,10,40,凱基-永和,2023-04-06,9207
6244,茂迪,37,0,37,凱基-永和,2023-04-06,9207
6266,泰詠,33,0,33,凱基-永和,2023-04-06,9207
2486,一詮,30,0,30,凱基-永和,2023-04-06,9207
00673R,期元大S＆P原油反1,29,0,29,凱基-永和,2023-04-06,9207
2457,飛宏,39,11,28,凱基-永和,2023-04-06,9207
3324,雙鴻,27,0,27,凱基-永和,2023-04-06,9207
2201,裕隆,34,14,20,凱基-永和,2023-04-06,9207
3046,建��,15,0,15,凱基-永和,2023-04-06,9207
1218,泰山,15,2,13,凱基-永和,2023-04-06,9207
6589,台康生技,18,5,13,凱基-永和,2023-04-06,9207
1539,巨庭,12,0,12,凱基-永和,2023-04-06,9207
1104,環泥,12,0,12,凱基-永和,2023-04-06,9207
2017,官田鋼,12,0,12,凱基-永和,2023-04-06,9207
00679B,元大美債20年,13,1,12,凱基-永和,2023-04-06,9207
2317,鴻海,11,0,11,凱基-永和,2023-04-06,9207
3056,富華新,17,6,11,凱基-永和,2023-04-06,9207
1712,興農,10,0,10,凱基-永和,2023-04-06,9207
1519,華城,10,0,10,凱基-永和,2023-04-06,9207
1517,利奇,10,0,10,凱基-永和,2023-04-06,9207
00772B,中信高評級公司債,10,0,10,凱基-永和,2023-04-06,9207
5015,華祺,10,0,10,凱基-永和,2023-04-06,9207
6190,萬泰科,10,0,10,凱基-永和,2023-04-06,9207
00713,元大台灣高息低波,10,1,9,凱基-永和,2023-04-06,9207
00885,富邦越南,18,10,8,凱基-永和,2023-04-06,9207
2618,長榮航,8,0,8,凱基-永和,2023-04-06,9207
3025,星通,8,0,8,凱基-永和,2023-04-06,9207
2535,達欣工,7,0,7,凱基-永和,2023-04-06,9207
2548,華固,7,0,7,凱基-永和,2023-04-06,9207
3703,欣陸,7,0,7,凱基-永和,2023-04-06,9207
6472,保瑞,7,0,7,凱基-永和,2023-04-06,9207
1752,南光,16,10,6,凱基-永和,2023-04-06,9207
2345,智邦,6,0,6,凱基-永和,2023-04-06,9207
2883,凱基金,6,0,6,凱基-永和,2023-04-06,9207
4744,皇將,6,0,6,凱基-永和,2023-04-06,9207
6576,逸達,6,0,6,凱基-永和,2023-04-06,9207
1524,耿鼎,5,0,5,凱基-永和,2023-04-06,9207
1784,訊聯,5,0,5,凱基-永和,2023-04-06,9207
2328,廣宇,5,0,5,凱基-永和,2023-04-06,9207
2610,華航,6,1,5,凱基-永和,2023-04-06,9207
3023,信邦,5,0,5,凱基-永和,2023-04-06,9207
3466,德晉,5,0,5,凱基-永和,2023-04-06,9207
3552,同致,5,0,5,凱基-永和,2023-04-06,9207
5531,鄉林,5,0,5,凱基-永和,2023-04-06,9207
6538,倉和,5,0,5,凱基-永和,2023-04-06,9207
2834,臺企銀,10,5,5,凱基-永和,2023-04-06,9207
006208,富邦台50,5,0,5,凱基-永和,2023-04-06,9207
3036,文曄,17,13,4,凱基-永和,2023-04-06,9207
4564,元翎,4,0,4,凱基-永和,2023-04-06,9207
2402,毅嘉,7,3,4,凱基-永和,2023-04-06,9207
2606,裕民,168,1,167,凱基-永和,2023-04-07,9207
3447,展達,74,0,74,凱基-永和,2023-04-07,9207
4114,健喬,50,0,50,凱基-永和,2023-04-07,9207
6196,帆宣,30,0,30,凱基-永和,2023-04-07,9207
2303,聯電,38,10,28,凱基-永和,2023-04-07,9207
00679B,元大美債20年,37,13,24,凱基-永和,2023-04-07,9207
4564,元翎,23,2,21,凱基-永和,2023-04-07,9207
00671R,富邦NASDAQ反1,20,0,20,凱基-永和,2023-04-07,9207
8069,元太,19,1,18,凱基-永和,2023-04-07,9207
00680L,元大美債20正2,17,0,17,凱基-永和,2023-04-07,9207
8150,南茂,15,0,15,凱基-永和,2023-04-07,9207
2610,華航,12,0,12,凱基-永和,2023-04-07,9207
6753,龍德造船,12,0,12,凱基-永和,2023-04-07,9207
8028,昇陽半導體,16,4,12,凱基-永和,2023-04-07,9207
8289,泰藝,11,0,11,凱基-永和,2023-04-07,9207
1714,和桐,10,0,10,凱基-永和,2023-04-07,9207
1722,台肥,10,0,10,凱基-永和,2023-04-07,9207
4979,華星光,10,0,10,凱基-永和,2023-04-07,9207
5009,榮剛,10,0,10,凱基-永和,2023-04-07,9207
5258,虹堡,10,0,10,凱基-永和,2023-04-07,9207
8403,盛弘,10,0,10,凱基-永和,2023-04-07,9207
2208,台船,9,1,8,凱基-永和,2023-04-07,9207
2436,偉詮電,8,0,8,凱基-永和,2023-04-07,9207
2801,彰銀,8,0,8,凱基-永和,2023-04-07,9207
6104,創惟,8,0,8,凱基-永和,2023-04-07,9207
3017,奇鋐,7,0,7,凱基-永和,2023-04-07,9207
2101,南港,7,0,7,凱基-永和,2023-04-07,9207
3056,富華新,8,2,6,凱基-永和,2023-04-07,9207
3162,精確,6,0,6,凱基-永和,2023-04-07,9207
1218,泰山,5,0,5,凱基-永和,2023-04-07,9207
0056,元大高股息,5,0,5,凱基-永和,2023-04-07,9207
00653L,富邦印度正2,5,0,5,凱基-永和,2023-04-07,9207
1514,亞力,6,1,5,凱基-永和,2023-04-07,9207
2425,承啟,5,0,5,凱基-永和,2023-04-07,9207
2867,三商壽,10,5,5,凱基-永和,2023-04-07,9207
3209,全科,5,0,5,凱基-永和,2023-04-07,9207
6290,良維,8,3,5,凱基-永和,2023-04-07,9207
3481,群創,5,0,5,凱基-永和,2023-04-07,9207
1605,華新,4,0,4,凱基-永和,2023-04-07,9207
6125,廣運,13,9,4,凱基-永和,2023-04-07,9207
6244,茂迪,5,1,4,凱基-永和,2023-04-07,9207
6576,逸達,6,2,4,凱基-永和,2023-04-07,9207
1609,大亞,10,7,3,凱基-永和,2023-04-07,9207
1708,東鹼,3,0,3,凱基-永和,2023-04-07,9207
2736,富野,3,0,3,凱基-永和,2023-04-07,9207
2897,王道銀行,3,0,3,凱基-永和,2023-04-07,9207
3188,鑫龍騰,3,0,3,凱基-永和,2023-04-07,9207
3338,泰碩,3,0,3,凱基-永和,2023-04-07,9207
3665,貿聯-KY,3,0,3,凱基-永和,2023-04-07,9207
4967,十銓,56,53,3,凱基-永和,2023-04-07,9207
1513,中興電,381,18,363,凱基-永和,2023-04-10,9207
6733,博晟生醫,166,0,166,凱基-永和,2023-04-10,9207
3324,雙鴻,128,2,126,凱基-永和,2023-04-10,9207
8069,元太,113,7,106,凱基-永和,2023-04-10,9207
2443,昶虹,100,0,100,凱基-永和,2023-04-10,9207
1722,台肥,75,0,75,凱基-永和,2023-04-10,9207
00679B,元大美債20年,46,0,46,凱基-永和,2023-04-10,9207
2606,裕民,41,1,40,凱基-永和,2023-04-10,9207
3046,建��,175,142,33,凱基-永和,2023-04-10,9207
00673R,期元大S＆P原油反1,31,0,31,凱基-永和,2023-04-10,9207
6443,元晶,30,0,30,凱基-永和,2023-04-10,9207
6538,倉和,29,1,28,凱基-永和,2023-04-10,9207
8261,富鼎,30,3,27,凱基-永和,2023-04-10,9207
6698,旭暉應材,25,0,25,凱基-永和,2023-04-10,9207
4961,天鈺,22,0,22,凱基-永和,2023-04-10,9207
00897,富邦基因免疫生技,20,0,20,凱基-永和,2023-04-10,9207
3290,東浦,20,3,17,凱基-永和,2023-04-10,9207
3624,光頡,37,23,14,凱基-永和,2023-04-10,9207
8936,國統,18,5,13,凱基-永和,2023-04-10,9207
2427,三商電,12,0,12,凱基-永和,2023-04-10,9207
4541,晟田,12,0,12,凱基-永和,2023-04-10,9207
1784,訊聯,11,0,11,凱基-永和,2023-04-10,9207
6148,驊宏資,11,0,11,凱基-永和,2023-04-10,9207
6168,宏齊,11,0,11,凱基-永和,2023-04-10,9207
6752,叡揚,11,0,11,凱基-永和,2023-04-10,9207
1314,中石化,10,0,10,凱基-永和,2023-04-10,9207
2231,為升,10,0,10,凱基-永和,2023-04-10,9207
6245,立端,10,0,10,凱基-永和,2023-04-10,9207
6477,安集,10,0,10,凱基-永和,2023-04-10,9207
2439,美律,9,0,9,凱基-永和,2023-04-10,9207
2482,連宇,11,2,9,凱基-永和,2023-04-10,9207
6237,驊訊,10,1,9,凱基-永和,2023-04-10,9207
00720B,元大投資級公司債,7,0,7,凱基-永和,2023-04-10,9207
1313,聯成,6,0,6,凱基-永和,2023-04-10,9207
1752,南光,6,0,6,凱基-永和,2023-04-10,9207
6285,啟��,14,8,6,凱基-永和,2023-04-10,9207
3019,亞光,5,0,5,凱基-永和,2023-04-10,9207
1101,台泥,5,0,5,凱基-永和,2023-04-10,9207
2344,華邦電,8,3,5,凱基-永和,2023-04-10,9207
3015,全漢,5,0,5,凱基-永和,2023-04-10,9207
4971,IET-KY,5,0,5,凱基-永和,2023-04-10,9207
5309,系統電,5,0,5,凱基-永和,2023-04-10,9207
8112,至上,5,0,5,凱基-永和,2023-04-10,9207
2603,長榮,4,0,4,凱基-永和,2023-04-10,9207
1605,華新,11,7,4,凱基-永和,2023-04-10,9207
2408,南亞科,4,0,4,凱基-永和,2023-04-10,9207
6220,岳豐,4,0,4,凱基-永和,2023-04-10,9207
9962,有益,5,1,4,凱基-永和,2023-04-10,9207
3376,新日興,3,0,3,凱基-永和,2023-04-10,9207
6605,帝寶,3,0,3,凱基-永和,2023-04-10,9207
3324,雙鴻,70,3,67,凱基-永和,2023-04-11,9207
3661,世芯-KY,48,1,47,凱基-永和,2023-04-11,9207
8088,品安,44,4,40,凱基-永和,2023-04-11,9207
8210,勤誠,29,0,29,凱基-永和,2023-04-11,9207
6245,立端,24,0,24,凱基-永和,2023-04-11,9207
6532,瑞耘,25,1,24,凱基-永和,2023-04-11,9207
5353,台林,23,1,22,凱基-永和,2023-04-11,9207
00679B,元大美債20年,19,0,19,凱基-永和,2023-04-11,9207
2206,三陽工業,17,1,16,凱基-永和,2023-04-11,9207
2892,第一金,20,5,15,凱基-永和,2023-04-11,9207
6285,啟��,15,1,14,凱基-永和,2023-04-11,9207
6116,彩晶,15,1,14,凱基-永和,2023-04-11,9207
6203,海韻電,16,3,13,凱基-永和,2023-04-11,9207
4968,立積,21,9,12,凱基-永和,2023-04-11,9207
2313,華通,11,0,11,凱基-永和,2023-04-11,9207
2436,偉詮電,11,0,11,凱基-永和,2023-04-11,9207
00719B,元大美債1-3,10,0,10,凱基-永和,2023-04-11,9207
2371,大同,10,0,10,凱基-永和,2023-04-11,9207
5309,系統電,10,0,10,凱基-永和,2023-04-11,9207
6160,欣技,10,0,10,凱基-永和,2023-04-11,9207
6220,岳豐,10,0,10,凱基-永和,2023-04-11,9207
8150,南茂,10,0,10,凱基-永和,2023-04-11,9207
8926,台汽電,10,0,10,凱基-永和,2023-04-11,9207
9941,裕融,10,0,10,凱基-永和,2023-04-11,9207
2303,聯電,16,7,9,凱基-永和,2023-04-11,9207
3035,智原,17,9,8,凱基-永和,2023-04-11,9207
6234,高僑,7,0,7,凱基-永和,2023-04-11,9207
1514,亞力,21,14,7,凱基-永和,2023-04-11,9207
2610,華航,10,3,7,凱基-永和,2023-04-11,9207
2344,華邦電,27,21,6,凱基-永和,2023-04-11,9207
3704,合勤控,6,0,6,凱基-永和,2023-04-11,9207
6244,茂迪,6,0,6,凱基-永和,2023-04-11,9207
6538,倉和,7,1,6,凱基-永和,2023-04-11,9207
1437,勤益控,5,0,5,凱基-永和,2023-04-11,9207
2736,富野,5,0,5,凱基-永和,2023-04-11,9207
3338,泰碩,5,0,5,凱基-永和,2023-04-11,9207
3388,崇越電,5,0,5,凱基-永和,2023-04-11,9207
4532,瑞智,5,0,5,凱基-永和,2023-04-11,9207
5483,中美晶,5,0,5,凱基-永和,2023-04-11,9207
6456,GIS-KY,5,0,5,凱基-永和,2023-04-11,9207
6111,大宇資,5,0,5,凱基-永和,2023-04-11,9207
2101,南港,4,0,4,凱基-永和,2023-04-11,9207
2603,長榮,7,3,4,凱基-永和,2023-04-11,9207
1515,力山,4,0,4,凱基-永和,2023-04-11,9207
3545,敦泰,5,1,4,凱基-永和,2023-04-11,9207
6125,廣運,4,0,4,凱基-永和,2023-04-11,9207
8183,精星,7,3,4,凱基-永和,2023-04-11,9207
9945,潤泰新,5,1,4,凱基-永和,2023-04-11,9207
2408,南亞科,5,1,4,凱基-永和,2023-04-11,9207
2634,漢翔,6,3,3,凱基-永和,2023-04-11,9207
3017,奇鋐,300,0,300,凱基-永和,2023-04-12,9207
2634,漢翔,317,94,223,凱基-永和,2023-04-12,9207
6122,擎邦,152,2,150,凱基-永和,2023-04-12,9207
5009,榮剛,154,5,149,凱基-永和,2023-04-12,9207
1514,亞力,314,169,145,凱基-永和,2023-04-12,9207
6244,茂迪,166,30,136,凱基-永和,2023-04-12,9207
2515,中工,74,5,69,凱基-永和,2023-04-12,9207
5351,鈺創,63,5,58,凱基-永和,2023-04-12,9207
5353,台林,108,54,54,凱基-永和,2023-04-12,9207
4147,中裕,53,0,53,凱基-永和,2023-04-12,9207
1529,樂事綠能,44,2,42,凱基-永和,2023-04-12,9207
6538,倉和,43,6,37,凱基-永和,2023-04-12,9207
3231,緯創,39,6,33,凱基-永和,2023-04-12,9207
2344,華邦電,31,0,31,凱基-永和,2023-04-12,9207
00637L,元大滬深300正2,30,0,30,凱基-永和,2023-04-12,9207
2426,鼎元,30,0,30,凱基-永和,2023-04-12,9207
8097,常珵,26,0,26,凱基-永和,2023-04-12,9207
2497,怡利電,23,0,23,凱基-永和,2023-04-12,9207
3169,亞信,142,120,22,凱基-永和,2023-04-12,9207
2880,華南金,20,0,20,凱基-永和,2023-04-12,9207
1609,大亞,25,10,15,凱基-永和,2023-04-12,9207
3591,艾笛森,15,0,15,凱基-永和,2023-04-12,9207
3624,光頡,24,9,15,凱基-永和,2023-04-12,9207
2206,三陽工業,37,23,14,凱基-永和,2023-04-12,9207
4129,聯合,20,6,14,凱基-永和,2023-04-12,9207
2208,台船,14,1,13,凱基-永和,2023-04-12,9207
9907,統一實,13,0,13,凱基-永和,2023-04-12,9207
4979,華星光,15,3,12,凱基-永和,2023-04-12,9207
1584,精剛,34,23,11,凱基-永和,2023-04-12,9207
6205,詮欣,11,0,11,凱基-永和,2023-04-12,9207
00772B,中信高評級公司債,11,0,11,凱基-永和,2023-04-12,9207
00878,國泰永續高股息,16,6,10,凱基-永和,2023-04-12,9207
1455,集盛,10,0,10,凱基-永和,2023-04-12,9207
2329,華泰,20,10,10,凱基-永和,2023-04-12,9207
2867,三商壽,10,0,10,凱基-永和,2023-04-12,9207
3704,合勤控,10,0,10,凱基-永和,2023-04-12,9207
8107,大億金茂,10,0,10,凱基-永和,2023-04-12,9207
1504,東元,12,2,10,凱基-永和,2023-04-12,9207
1784,訊聯,11,2,9,凱基-永和,2023-04-12,9207
6101,寬魚國際,9,0,9,凱基-永和,2023-04-12,9207
1513,中興電,50,42,8,凱基-永和,2023-04-12,9207
2101,南港,8,0,8,凱基-永和,2023-04-12,9207
3189,景碩,8,0,8,凱基-永和,2023-04-12,9207
3015,全漢,7,0,7,凱基-永和,2023-04-12,9207
6770,力積電,7,0,7,凱基-永和,2023-04-12,9207
2330,台積電,7,0,7,凱基-永和,2023-04-12,9207
5483,中美晶,6,0,6,凱基-永和,2023-04-12,9207
00673R,期元大S＆P原油反1,6,0,6,凱基-永和,2023-04-12,9207
2483,百容,8,2,6,凱基-永和,2023-04-12,9207
3491,昇達科,8,2,6,凱基-永和,2023-04-12,9207
1584,精剛,333,92,241,凱基-永和,2023-04-13,9207
3011,今皓,140,0,140,凱基-永和,2023-04-13,9207
2208,台船,101,17,84,凱基-永和,2023-04-13,9207
2645,長榮航太,51,1,50,凱基-永和,2023-04-13,9207
3019,亞光,50,0,50,凱基-永和,2023-04-13,9207
2457,飛宏,125,81,44,凱基-永和,2023-04-13,9207
2515,中工,2089,2047,42,凱基-永和,2023-04-13,9207
6465,威潤,40,0,40,凱基-永和,2023-04-13,9207
1524,耿鼎,30,0,30,凱基-永和,2023-04-13,9207
2413,環科,33,4,29,凱基-永和,2023-04-13,9207
00720B,元大投資級公司債,25,0,25,凱基-永和,2023-04-13,9207
2884,玉山金,25,0,25,凱基-永和,2023-04-13,9207
3576,聯合再生,34,11,23,凱基-永和,2023-04-13,9207
6163,華電網,32,9,23,凱基-永和,2023-04-13,9207
2889,國票金,20,0,20,凱基-永和,2023-04-13,9207
4503,金雨,20,0,20,凱基-永和,2023-04-13,9207
6179,亞通,20,0,20,凱基-永和,2023-04-13,9207
5309,系統電,21,2,19,凱基-永和,2023-04-13,9207
8097,常珵,19,0,19,凱基-永和,2023-04-13,9207
6443,元晶,16,0,16,凱基-永和,2023-04-13,9207
2731,雄獅,20,5,15,凱基-永和,2023-04-13,9207
3711,日月光投控,15,0,15,凱基-永和,2023-04-13,9207
0056,元大高股息,14,0,14,凱基-永和,2023-04-13,9207
2382,廣達,18,4,14,凱基-永和,2023-04-13,9207
00712,復華富時不動產,12,0,12,凱基-永和,2023-04-13,9207
2303,聯電,12,1,11,凱基-永和,2023-04-13,9207
5258,虹堡,22,11,11,凱基-永和,2023-04-13,9207
00642U,期元大S＆P石油,10,0,10,凱基-永和,2023-04-13,9207
6461,益得,10,0,10,凱基-永和,2023-04-13,9207
1504,東元,14,4,10,凱基-永和,2023-04-13,9207
1605,華新,11,2,9,凱基-永和,2023-04-13,9207
2439,美律,9,0,9,凱基-永和,2023-04-13,9207
6244,茂迪,9,0,9,凱基-永和,2023-04-13,9207
0050,元大台灣50,9,0,9,凱基-永和,2023-04-13,9207
00673R,期元大S＆P原油反1,8,0,8,凱基-永和,2023-04-13,9207
1609,大亞,9,1,8,凱基-永和,2023-04-13,9207
3265,台星科,8,0,8,凱基-永和,2023-04-13,9207
3704,合勤控,10,2,8,凱基-永和,2023-04-13,9207
2888,新光金,10,3,7,凱基-永和,2023-04-13,9207
2317,鴻海,6,0,6,凱基-永和,2023-04-13,9207
2338,光罩,6,0,6,凱基-永和,2023-04-13,9207
2375,凱美,6,0,6,凱基-永和,2023-04-13,9207
3025,星通,6,0,6,凱基-永和,2023-04-13,9207
3231,緯創,9,3,6,凱基-永和,2023-04-13,9207
6182,合晶,6,0,6,凱基-永和,2023-04-13,9207
6223,旺矽,6,0,6,凱基-永和,2023-04-13,9207
6282,康舒,6,0,6,凱基-永和,2023-04-13,9207
6789,采鈺,7,1,6,凱基-永和,2023-04-13,9207
00679B,元大美債20年,5,0,5,凱基-永和,2023-04-13,9207
00671R,富邦NASDAQ反1,5,0,5,凱基-永和,2023-04-13,9207
3032,偉訓,670,157,513,凱基-永和,2023-04-14,9207
8033,雷虎,214,3,211,凱基-永和,2023-04-14,9207
2630,亞航,200,11,189,凱基-永和,2023-04-14,9207
2739,寒舍,100,0,100,凱基-永和,2023-04-14,9207
4433,興采,80,1,79,凱基-永和,2023-04-14,9207
6791,虎門科技,68,0,68,凱基-永和,2023-04-14,9207
5371,中光電,53,3,50,凱基-永和,2023-04-14,9207
2880,華南金,40,0,40,凱基-永和,2023-04-14,9207
6148,驊宏資,40,1,39,凱基-永和,2023-04-14,9207
00772B,中信高評級公司債,34,0,34,凱基-永和,2023-04-14,9207
4721,美琪瑪,30,0,30,凱基-永和,2023-04-14,9207
2359,所羅門,93,65,28,凱基-永和,2023-04-14,9207
2382,廣達,40,12,28,凱基-永和,2023-04-14,9207
00632R,元大台灣50反1,27,0,27,凱基-永和,2023-04-14,9207
00720B,元大投資級公司債,26,0,26,凱基-永和,2023-04-14,9207
4129A,聯合甲特,25,0,25,凱基-永和,2023-04-14,9207
4566,時碩工業,20,0,20,凱基-永和,2023-04-14,9207
4739,康普,20,0,20,凱基-永和,2023-04-14,9207
2355,敬鵬,18,0,18,凱基-永和,2023-04-14,9207
3037,欣興,17,0,17,凱基-永和,2023-04-14,9207
3714,富采,18,1,17,凱基-永和,2023-04-14,9207
00679B,元大美債20年,20,3,17,凱基-永和,2023-04-14,9207
3481,群創,20,4,16,凱基-永和,2023-04-14,9207
2105,正新,15,0,15,凱基-永和,2023-04-14,9207
3322,建舜電,15,0,15,凱基-永和,2023-04-14,9207
6244,茂迪,19,4,15,凱基-永和,2023-04-14,9207
2303,聯電,15,1,14,凱基-永和,2023-04-14,9207
2409,友達,14,0,14,凱基-永和,2023-04-14,9207
2883,凱基金,17,5,12,凱基-永和,2023-04-14,9207
2867,三商壽,10,0,10,凱基-永和,2023-04-14,9207
3004,豐達科,10,0,10,凱基-永和,2023-04-14,9207
3062,建漢,10,0,10,凱基-永和,2023-04-14,9207
3704,合勤控,10,0,10,凱基-永和,2023-04-14,9207
6101,寬魚國際,10,0,10,凱基-永和,2023-04-14,9207
6109,亞元,10,0,10,凱基-永和,2023-04-14,9207
6125,廣運,10,0,10,凱基-永和,2023-04-14,9207
8171,天宇,10,0,10,凱基-永和,2023-04-14,9207
2706,第一店,8,0,8,凱基-永和,2023-04-14,9207
6282,康舒,8,0,8,凱基-永和,2023-04-14,9207
8289,泰藝,8,0,8,凱基-永和,2023-04-14,9207
00888,永豐台灣ESG,7,0,7,凱基-永和,2023-04-14,9207
2439,美律,7,0,7,凱基-永和,2023-04-14,9207
3025,星通,9,2,7,凱基-永和,2023-04-14,9207
4153,鈺緯,7,0,7,凱基-永和,2023-04-14,9207
0056,元大高股息,7,1,6,凱基-永和,2023-04-14,9207
2603,長榮,33,27,6,凱基-永和,2023-04-14,9207
00687B,國泰20年美債,6,0,6,凱基-永和,2023-04-14,9207
2467,志聖,5,0,5,凱基-永和,2023-04-14,9207
3021,鴻名,5,0,5,凱基-永和,2023-04-14,9207
4916,事欣科,26,21,5,凱基-永和,2023-04-14,9207
2312,金寶,843,30,813,凱基-永和,2023-04-17,9207
6234,高僑,484,1,483,凱基-永和,2023-04-17,9207
2634,漢翔,1538,1083,455,凱基-永和,2023-04-17,9207
2609,陽明,162,2,160,凱基-永和,2023-04-17,9207
3046,建��,104,2,102,凱基-永和,2023-04-17,9207
1809,中釉,300,205,95,凱基-永和,2023-04-17,9207
2457,飛宏,303,208,95,凱基-永和,2023-04-17,9207
5211,蒙恬,61,0,61,凱基-永和,2023-04-17,9207
3058,立德,35,2,33,凱基-永和,2023-04-17,9207
2429,銘旺科,30,0,30,凱基-永和,2023-04-17,9207
6245,立端,30,1,29,凱基-永和,2023-04-17,9207
2382,廣達,28,0,28,凱基-永和,2023-04-17,9207
3712,永崴投控,28,3,25,凱基-永和,2023-04-17,9207
1514,亞力,26,3,23,凱基-永和,2023-04-17,9207
2427,三商電,23,0,23,凱基-永和,2023-04-17,9207
5534,長虹,23,0,23,凱基-永和,2023-04-17,9207
2314,台揚,21,0,21,凱基-永和,2023-04-17,9207
5015,華祺,20,0,20,凱基-永和,2023-04-17,9207
6465,威潤,20,0,20,凱基-永和,2023-04-17,9207
3021,鴻名,19,0,19,凱基-永和,2023-04-17,9207
2439,美律,18,0,18,凱基-永和,2023-04-17,9207
5488,松普,20,3,17,凱基-永和,2023-04-17,9207
00720B,元大投資級公司債,16,0,16,凱基-永和,2023-04-17,9207
6116,彩晶,15,0,15,凱基-永和,2023-04-17,9207
6190,萬泰科,130,115,15,凱基-永和,2023-04-17,9207
2610,華航,14,0,14,凱基-永和,2023-04-17,9207
3231,緯創,17,4,13,凱基-永和,2023-04-17,9207
00679B,元大美債20年,12,0,12,凱基-永和,2023-04-17,9207
2886,兆豐金,12,1,11,凱基-永和,2023-04-17,9207
2332,友訊,10,0,10,凱基-永和,2023-04-17,9207
2867,三商壽,10,0,10,凱基-永和,2023-04-17,9207
3056,富華新,10,0,10,凱基-永和,2023-04-17,9207
5011,久陽,10,0,10,凱基-永和,2023-04-17,9207
5309,系統電,10,0,10,凱基-永和,2023-04-17,9207
5353,台林,10,0,10,凱基-永和,2023-04-17,9207
6117,迎廣,10,0,10,凱基-永和,2023-04-17,9207
6129,普誠,10,0,10,凱基-永和,2023-04-17,9207
6590,普鴻,10,0,10,凱基-永和,2023-04-17,9207
2105,正新,9,0,9,凱基-永和,2023-04-17,9207
2409,友達,9,0,9,凱基-永和,2023-04-17,9207
2618,長榮航,10,1,9,凱基-永和,2023-04-17,9207
00878,國泰永續高股息,12,3,9,凱基-永和,2023-04-17,9207
6282,康舒,14,6,8,凱基-永和,2023-04-17,9207
6782,視陽,8,0,8,凱基-永和,2023-04-17,9207
8222,寶一,15,8,7,凱基-永和,2023-04-17,9207
4968,立積,8,2,6,凱基-永和,2023-04-17,9207
1609,大亞,6,0,6,凱基-永和,2023-04-17,9207
1101,台泥,5,0,5,凱基-永和,2023-04-17,9207
4104,佳醫,5,0,5,凱基-永和,2023-04-17,9207
2002,中鋼,5,0,5,凱基-永和,2023-04-17,9207
3004,豐達科,178,30,148,凱基-永和,2023-04-18,9207
2314,台揚,123,24,99,凱基-永和,2023-04-18,9207
2495,普安,102,20,82,凱基-永和,2023-04-18,9207
3057,喬鼎,80,0,80,凱基-永和,2023-04-18,9207
0056,元大高股息,79,0,79,凱基-永和,2023-04-18,9207
00912,中信臺灣智慧50,43,0,43,凱基-永和,2023-04-18,9207
1533,車王電,51,11,40,凱基-永和,2023-04-18,9207
2359,所羅門,40,1,39,凱基-永和,2023-04-18,9207
6804,明係,38,0,38,凱基-永和,2023-04-18,9207
1609,大亞,38,1,37,凱基-永和,2023-04-18,9207
6606,建德工業,35,0,35,凱基-永和,2023-04-18,9207
00772B,中信高評級公司債,29,0,29,凱基-永和,2023-04-18,9207
6244,茂迪,72,44,28,凱基-永和,2023-04-18,9207
00878,國泰永續高股息,32,5,27,凱基-永和,2023-04-18,9207
2609,陽明,37,10,27,凱基-永和,2023-04-18,9207
1605,華新,35,12,23,凱基-永和,2023-04-18,9207
2409,友達,23,2,21,凱基-永和,2023-04-18,9207
6443,元晶,34,13,21,凱基-永和,2023-04-18,9207
6743,安普新,41,20,21,凱基-永和,2023-04-18,9207
1503,士電,21,1,20,凱基-永和,2023-04-18,9207
5512,力麒,20,0,20,凱基-永和,2023-04-18,9207
6863,永道-KY,20,0,20,凱基-永和,2023-04-18,9207
3037,欣興,19,1,18,凱基-永和,2023-04-18,9207
00679B,元大美債20年,15,0,15,凱基-永和,2023-04-18,9207
6806,森崴能源,41,26,15,凱基-永和,2023-04-18,9207
00885,富邦越南,13,0,13,凱基-永和,2023-04-18,9207
2439,美律,13,0,13,凱基-永和,2023-04-18,9207
2754,亞洲藏壽司,32,20,12,凱基-永和,2023-04-18,9207
3231,緯創,13,1,12,凱基-永和,2023-04-18,9207
00713,元大台灣高息低波,10,0,10,凱基-永和,2023-04-18,9207
2607,榮運,10,0,10,凱基-永和,2023-04-18,9207
3013,晟銘電,15,5,10,凱基-永和,2023-04-18,9207
3518,柏騰,10,0,10,凱基-永和,2023-04-18,9207
4129A,聯合甲特,10,0,10,凱基-永和,2023-04-18,9207
4728,雙美,13,3,10,凱基-永和,2023-04-18,9207
8289,泰藝,11,1,10,凱基-永和,2023-04-18,9207
6133,金橋,9,0,9,凱基-永和,2023-04-18,9207
00720B,元大投資級公司債,24,16,8,凱基-永和,2023-04-18,9207
2344,華邦電,12,4,8,凱基-永和,2023-04-18,9207
2481,強茂,8,0,8,凱基-永和,2023-04-18,9207
3011,今皓,8,0,8,凱基-永和,2023-04-18,9207
3289,宜特,8,0,8,凱基-永和,2023-04-18,9207
2603,長榮,11,4,7,凱基-永和,2023-04-18,9207
1529,樂事綠能,19,12,7,凱基-永和,2023-04-18,9207
2882,國泰金,6,0,6,凱基-永和,2023-04-18,9207
0050,元大台灣50,6,0,6,凱基-永和,2023-04-18,9207
1584,精剛,20,14,6,凱基-永和,2023-04-18,9207
2471,資通,8,2,6,凱基-永和,2023-04-18,9207
2617,台航,6,0,6,凱基-永和,2023-04-18,9207
3015,全漢,6,0,6,凱基-永和,2023-04-18,9207
3058,立德,201,0,201,凱基-永和,2023-04-19,9207
6282,康舒,657,536,121,凱基-永和,2023-04-19,9207
3004,豐達科,110,0,110,凱基-永和,2023-04-19,9207
3652,精聯,258,159,99,凱基-永和,2023-04-19,9207
3207,耀勝,90,0,90,凱基-永和,2023-04-19,9207
1722,台肥,80,0,80,凱基-永和,2023-04-19,9207
6590,普鴻,80,0,80,凱基-永和,2023-04-19,9207
3522,御嵿,70,0,70,凱基-永和,2023-04-19,9207
5210,寶碩,60,0,60,凱基-永和,2023-04-19,9207
2618,長榮航,55,0,55,凱基-永和,2023-04-19,9207
3576,聯合再生,107,52,55,凱基-永和,2023-04-19,9207
2867,三商壽,40,0,40,凱基-永和,2023-04-19,9207
0050,元大台灣50,36,0,36,凱基-永和,2023-04-19,9207
5531,鄉林,35,0,35,凱基-永和,2023-04-19,9207
3481,群創,46,12,34,凱基-永和,2023-04-19,9207
2739,寒舍,28,0,28,凱基-永和,2023-04-19,9207
0056,元大高股息,29,1,28,凱基-永和,2023-04-19,9207
2303,聯電,24,1,23,凱基-永和,2023-04-19,9207
8105,凌巨,23,0,23,凱基-永和,2023-04-19,9207
6752,叡揚,24,3,21,凱基-永和,2023-04-19,9207
2330,台積電,20,0,20,凱基-永和,2023-04-19,9207
6116,彩晶,20,0,20,凱基-永和,2023-04-19,9207
4147,中裕,105,86,19,凱基-永和,2023-04-19,9207
2515,中工,21,3,18,凱基-永和,2023-04-19,9207
4979,華星光,22,4,18,凱基-永和,2023-04-19,9207
6865,偉康科技,18,0,18,凱基-永和,2023-04-19,9207
00882,中信中國高股息,17,0,17,凱基-永和,2023-04-19,9207
1810,和成,20,3,17,凱基-永和,2023-04-19,9207
4729,熒茂,17,0,17,凱基-永和,2023-04-19,9207
2548,華固,16,0,16,凱基-永和,2023-04-19,9207
1314,中石化,13,0,13,凱基-永和,2023-04-19,9207
3037,欣興,13,1,12,凱基-永和,2023-04-19,9207
6209,今國光,13,1,12,凱基-永和,2023-04-19,9207
1444,力麗,11,0,11,凱基-永和,2023-04-19,9207
3032,偉訓,11,0,11,凱基-永和,2023-04-19,9207
5512,力麒,16,5,11,凱基-永和,2023-04-19,9207
2317,鴻海,10,0,10,凱基-永和,2023-04-19,9207
00857B,永豐20年美公債,10,0,10,凱基-永和,2023-04-19,9207
2481,強茂,10,0,10,凱基-永和,2023-04-19,9207
2880,華南金,10,0,10,凱基-永和,2023-04-19,9207
3325,旭品,60,50,10,凱基-永和,2023-04-19,9207
3508,位速,10,0,10,凱基-永和,2023-04-19,9207
6456,GIS-KY,10,0,10,凱基-永和,2023-04-19,9207
00720B,元大投資級公司債,10,0,10,凱基-永和,2023-04-19,9207
6770,力積電,10,1,9,凱基-永和,2023-04-19,9207
2009,第一銅,48,40,8,凱基-永和,2023-04-19,9207
2329,華泰,8,0,8,凱基-永和,2023-04-19,9207
3413,京鼎,8,0,8,凱基-永和,2023-04-19,9207
5011,久陽,10,2,8,凱基-永和,2023-04-19,9207
2206,三陽工業,11,3,8,凱基-永和,2023-04-19,9207
6163,華電網,3633,10,3623,凱基-永和,2023-04-20,9207
1616,億泰,300,1,299,凱基-永和,2023-04-20,9207
2324,仁寶,83,0,83,凱基-永和,2023-04-20,9207
6109,亞元,70,0,70,凱基-永和,2023-04-20,9207
3058,立德,235,181,54,凱基-永和,2023-04-20,9207
8038,長園科,40,0,40,凱基-永和,2023-04-20,9207
5880,合庫金,38,0,38,凱基-永和,2023-04-20,9207
6874,倍力,29,1,28,凱基-永和,2023-04-20,9207
2303,聯電,28,0,28,凱基-永和,2023-04-20,9207
5512,力麒,27,0,27,凱基-永和,2023-04-20,9207
00720B,元大投資級公司債,23,0,23,凱基-永和,2023-04-20,9207
2457,飛宏,41,20,21,凱基-永和,2023-04-20,9207
6443,元晶,24,4,20,凱基-永和,2023-04-20,9207
3078,僑威,22,5,17,凱基-永和,2023-04-20,9207
00878,國泰永續高股息,17,0,17,凱基-永和,2023-04-20,9207
6288,聯嘉,43,30,13,凱基-永和,2023-04-20,9207
0056,元大高股息,12,0,12,凱基-永和,2023-04-20,9207
00893,國泰智能電動車,12,0,12,凱基-永和,2023-04-20,9207
1904,正隆,18,7,11,凱基-永和,2023-04-20,9207
3576,聯合再生,13,2,11,凱基-永和,2023-04-20,9207
4123,晟德,15,4,11,凱基-永和,2023-04-20,9207
2371,大同,10,0,10,凱基-永和,2023-04-20,9207
1101,台泥,10,0,10,凱基-永和,2023-04-20,9207
3029,零壹,30,20,10,凱基-永和,2023-04-20,9207
3704,合勤控,10,0,10,凱基-永和,2023-04-20,9207
5531,鄉林,10,0,10,凱基-永和,2023-04-20,9207
6101,寬魚國際,10,0,10,凱基-永和,2023-04-20,9207
6285,啟��,13,3,10,凱基-永和,2023-04-20,9207
8107,大億金茂,10,0,10,凱基-永和,2023-04-20,9207
2402,毅嘉,10,1,9,凱基-永和,2023-04-20,9207
1514,亞力,9,0,9,凱基-永和,2023-04-20,9207
2906,高林,9,0,9,凱基-永和,2023-04-20,9207
5534,長虹,9,0,9,凱基-永和,2023-04-20,9207
8936,國統,9,0,9,凱基-永和,2023-04-20,9207
2867,三商壽,9,0,9,凱基-永和,2023-04-20,9207
4114,健喬,10,2,8,凱基-永和,2023-04-20,9207
4155,訊映,8,0,8,凱基-永和,2023-04-20,9207
8171,天宇,8,0,8,凱基-永和,2023-04-20,9207
1536,和大,7,0,7,凱基-永和,2023-04-20,9207
1810,和成,41,34,7,凱基-永和,2023-04-20,9207
2453,凌群,8,1,7,凱基-永和,2023-04-20,9207
4729,熒茂,7,0,7,凱基-永和,2023-04-20,9207
6477,安集,10,3,7,凱基-永和,2023-04-20,9207
6712,長聖,14,7,7,凱基-永和,2023-04-20,9207
1522,堤維西,6,0,6,凱基-永和,2023-04-20,9207
1504,東元,6,0,6,凱基-永和,2023-04-20,9207
00680L,元大美債20正2,6,0,6,凱基-永和,2023-04-20,9207
00679B,元大美債20年,6,0,6,凱基-永和,2023-04-20,9207
00885,富邦越南,6,0,6,凱基-永和,2023-04-20,9207
3624,光頡,6,0,6,凱基-永和,2023-04-20,9207
1560,中砂,107,2,105,凱基-永和,2023-04-21,9207
6244,茂迪,106,52,54,凱基-永和,2023-04-21,9207
2312,金寶,34,0,34,凱基-永和,2023-04-21,9207
3078,僑威,35,3,32,凱基-永和,2023-04-21,9207
2609,陽明,22,0,22,凱基-永和,2023-04-21,9207
6109,亞元,20,0,20,凱基-永和,2023-04-21,9207
4160,訊聯基因,19,0,19,凱基-永和,2023-04-21,9207
0056,元大高股息,18,0,18,凱基-永和,2023-04-21,9207
2344,華邦電,14,0,14,凱基-永和,2023-04-21,9207
00772B,中信高評級公司債,14,0,14,凱基-永和,2023-04-21,9207
2610,華航,15,2,13,凱基-永和,2023-04-21,9207
5534,長虹,12,0,12,凱基-永和,2023-04-21,9207
00751B,元大AAA至A公司債,11,0,11,凱基-永和,2023-04-21,9207
1611,中電,22,11,11,凱基-永和,2023-04-21,9207
2618,長榮航,15,4,11,凱基-永和,2023-04-21,9207
3552,同致,11,0,11,凱基-永和,2023-04-21,9207
00878,國泰永續高股息,14,4,10,凱基-永和,2023-04-21,9207
1442,名軒,10,0,10,凱基-永和,2023-04-21,9207
1218,泰山,10,0,10,凱基-永和,2023-04-21,9207
1210,大成,10,0,10,凱基-永和,2023-04-21,9207
2231,為升,10,0,10,凱基-永和,2023-04-21,9207
2504,國產,10,0,10,凱基-永和,2023-04-21,9207
6116,彩晶,10,0,10,凱基-永和,2023-04-21,9207
1711,永光,10,1,9,凱基-永和,2023-04-21,9207
4915,致伸,15,6,9,凱基-永和,2023-04-21,9207
2915,潤泰全,8,0,8,凱基-永和,2023-04-21,9207
6118,建達,8,0,8,凱基-永和,2023-04-21,9207
4906,正文,7,0,7,凱基-永和,2023-04-21,9207
6461,益得,8,1,7,凱基-永和,2023-04-21,9207
2603,長榮,8,1,7,凱基-永和,2023-04-21,9207
6271,同欣電,6,0,6,凱基-永和,2023-04-21,9207
1605,華新,9,3,6,凱基-永和,2023-04-21,9207
1708,東鹼,7,1,6,凱基-永和,2023-04-21,9207
6104,創惟,6,0,6,凱基-永和,2023-04-21,9207
6465,威潤,7,1,6,凱基-永和,2023-04-21,9207
8183,精星,6,0,6,凱基-永和,2023-04-21,9207
6290,良維,8,2,6,凱基-永和,2023-04-21,9207
2375,凱美,5,0,5,凱基-永和,2023-04-21,9207
2461,光群雷,5,0,5,凱基-永和,2023-04-21,9207
3580,友威科,5,0,5,凱基-永和,2023-04-21,9207
00893,國泰智能電動車,5,1,4,凱基-永和,2023-04-21,9207
2615,萬海,4,0,4,凱基-永和,2023-04-21,9207
00715L,期街口布蘭特正2,4,0,4,凱基-永和,2023-04-21,9207
00680L,元大美債20正2,4,0,4,凱基-永和,2023-04-21,9207
00900,富邦特選高股息30,4,0,4,凱基-永和,2023-04-21,9207
1785,光洋科,4,0,4,凱基-永和,2023-04-21,9207
2482,連宇,4,0,4,凱基-永和,2023-04-21,9207
6719,力智,4,0,4,凱基-永和,2023-04-21,9207
2308,台達電,4,0,4,凱基-永和,2023-04-21,9207
4128,中天,3,0,3,凱基-永和,2023-04-21,9207
1310,台苯,200,0,200,凱基-永和,2023-04-24,9207
1721,三晃,90,0,90,凱基-永和,2023-04-24,9207
2634,漢翔,43,7,36,凱基-永和,2023-04-24,9207
6799,來頡,30,0,30,凱基-永和,2023-04-24,9207
9933,中鼎,30,0,30,凱基-永和,2023-04-24,9207
2471,資通,40,26,14,凱基-永和,2023-04-24,9207
4127,天良,14,0,14,凱基-永和,2023-04-24,9207
00772B,中信高評級公司債,13,0,13,凱基-永和,2023-04-24,9207
2324,仁寶,12,0,12,凱基-永和,2023-04-24,9207
00720B,元大投資級公司債,11,0,11,凱基-永和,2023-04-24,9207
1907,永豐餘,11,1,10,凱基-永和,2023-04-24,9207
1605,華新,13,3,10,凱基-永和,2023-04-24,9207
2353,宏��,10,0,10,凱基-永和,2023-04-24,9207
2409,友達,10,0,10,凱基-永和,2023-04-24,9207
2495,普安,10,0,10,凱基-永和,2023-04-24,9207
2504,國產,10,0,10,凱基-永和,2023-04-24,9207
2882,國泰金,10,0,10,凱基-永和,2023-04-24,9207
8183,精星,10,0,10,凱基-永和,2023-04-24,9207
3707,漢磊,10,1,9,凱基-永和,2023-04-24,9207
3308,聯德,9,0,9,凱基-永和,2023-04-24,9207
6282,康舒,17,9,8,凱基-永和,2023-04-24,9207
3071,協禧,11,3,8,凱基-永和,2023-04-24,9207
4104,佳醫,8,0,8,凱基-永和,2023-04-24,9207
2603,長榮,11,3,8,凱基-永和,2023-04-24,9207
4155,訊映,7,0,7,凱基-永和,2023-04-24,9207
006208,富邦台50,6,0,6,凱基-永和,2023-04-24,9207
00637L,元大滬深300正2,7,1,6,凱基-永和,2023-04-24,9207
2313,華通,6,0,6,凱基-永和,2023-04-24,9207
2453,凌群,20,14,6,凱基-永和,2023-04-24,9207
4915,致伸,6,0,6,凱基-永和,2023-04-24,9207
6803,崑鼎,6,0,6,凱基-永和,2023-04-24,9207
3035,智原,5,0,5,凱基-永和,2023-04-24,9207
1108,幸福,5,0,5,凱基-永和,2023-04-24,9207
00679B,元大美債20年,5,0,5,凱基-永和,2023-04-24,9207
00671R,富邦NASDAQ反1,5,0,5,凱基-永和,2023-04-24,9207
00712,復華富時不動產,5,0,5,凱基-永和,2023-04-24,9207
3189,景碩,5,0,5,凱基-永和,2023-04-24,9207
5243,乙盛-KY,5,0,5,凱基-永和,2023-04-24,9207
6271,同欣電,5,0,5,凱基-永和,2023-04-24,9207
6770,力積電,10,5,5,凱基-永和,2023-04-24,9207
00751B,元大AAA至A公司債,4,0,4,凱基-永和,2023-04-24,9207
00682U,期元大美元指數,4,0,4,凱基-永和,2023-04-24,9207
1514,亞力,5,1,4,凱基-永和,2023-04-24,9207
1752,南光,15,11,4,凱基-永和,2023-04-24,9207
2881,富邦金,5,1,4,凱基-永和,2023-04-24,9207
5425,台半,4,0,4,凱基-永和,2023-04-24,9207
6446,藥華藥,4,1,3,凱基-永和,2023-04-24,9207
1513,中興電,6,3,3,凱基-永和,2023-04-24,9207
1522,堤維西,3,0,3,凱基-永和,2023-04-24,9207
00900,富邦特選高股息30,3,0,3,凱基-永和,2023-04-24,9207
6282,康舒,121,18,103,凱基-永和,2023-04-25,9207
00878,國泰永續高股息,75,22,53,凱基-永和,2023-04-25,9207
2867,三商壽,52,0,52,凱基-永和,2023-04-25,9207
6517,保勝光學,49,0,49,凱基-永和,2023-04-25,9207
00923,群益台ESG低碳50,44,0,44,凱基-永和,2023-04-25,9207
6109,亞元,40,0,40,凱基-永和,2023-04-25,9207
2634,漢翔,52,16,36,凱基-永和,2023-04-25,9207
2337,旺宏,32,0,32,凱基-永和,2023-04-25,9207
00902,中信電池及儲能,31,0,31,凱基-永和,2023-04-25,9207
1101,台泥,28,1,27,凱基-永和,2023-04-25,9207
3308,聯德,26,0,26,凱基-永和,2023-04-25,9207
0056,元大高股息,26,0,26,凱基-永和,2023-04-25,9207
4127,天良,24,0,24,凱基-永和,2023-04-25,9207
2206,三陽工業,214,192,22,凱基-永和,2023-04-25,9207
2303,聯電,19,0,19,凱基-永和,2023-04-25,9207
4915,致伸,19,0,19,凱基-永和,2023-04-25,9207
1711,永光,23,6,17,凱基-永和,2023-04-25,9207
4541,晟田,17,0,17,凱基-永和,2023-04-25,9207
2317,鴻海,19,2,17,凱基-永和,2023-04-25,9207
1503,士電,66,51,15,凱基-永和,2023-04-25,9207
1905,華紙,217,202,15,凱基-永和,2023-04-25,9207
1904,正隆,16,2,14,凱基-永和,2023-04-25,9207
2603,長榮,13,1,12,凱基-永和,2023-04-25,9207
00881,國泰台灣5G+,12,0,12,凱基-永和,2023-04-25,9207
2204,中華,12,0,12,凱基-永和,2023-04-25,9207
2610,華航,12,0,12,凱基-永和,2023-04-25,9207
3419,譁裕,12,0,12,凱基-永和,2023-04-25,9207
9958,世紀鋼,16,4,12,凱基-永和,2023-04-25,9207
1504,東元,25,13,12,凱基-永和,2023-04-25,9207
00900,富邦特選高股息30,11,0,11,凱基-永和,2023-04-25,9207
00751B,元大AAA至A公司債,11,0,11,凱基-永和,2023-04-25,9207
2515,中工,10,0,10,凱基-永和,2023-04-25,9207
0050,元大台灣50,11,1,10,凱基-永和,2023-04-25,9207
3013,晟銘電,12,2,10,凱基-永和,2023-04-25,9207
3231,緯創,15,5,10,凱基-永和,2023-04-25,9207
3664,安瑞-KY,10,0,10,凱基-永和,2023-04-25,9207
4746,台耀,10,0,10,凱基-永和,2023-04-25,9207
5457,宣德,10,0,10,凱基-永和,2023-04-25,9207
6279,胡連,10,0,10,凱基-永和,2023-04-25,9207
3071,協禧,23,14,9,凱基-永和,2023-04-25,9207
3712,永崴投控,9,0,9,凱基-永和,2023-04-25,9207
2002,中鋼,10,2,8,凱基-永和,2023-04-25,9207
3016,嘉晶,8,0,8,凱基-永和,2023-04-25,9207
3189,景碩,9,1,8,凱基-永和,2023-04-25,9207
5351,鈺創,8,0,8,凱基-永和,2023-04-25,9207
00891,中信關鍵半導體,7,0,7,凱基-永和,2023-04-25,9207
1714,和桐,7,0,7,凱基-永和,2023-04-25,9207
2402,毅嘉,7,0,7,凱基-永和,2023-04-25,9207
4104,佳醫,7,0,7,凱基-永和,2023-04-25,9207
1513,中興電,9,3,6,凱基-永和,2023-04-25,9207
3207,耀勝,100,0,100,凱基-永和,2023-04-26,9207
3265,台星科,56,2,54,凱基-永和,2023-04-26,9207
2607,榮運,40,0,40,凱基-永和,2023-04-26,9207
6799,來頡,51,11,40,凱基-永和,2023-04-26,9207
1471,首利,37,0,37,凱基-永和,2023-04-26,9207
8227,巨有科技,122,87,35,凱基-永和,2023-04-26,9207
6109,亞元,25,0,25,凱基-永和,2023-04-26,9207
5425,台半,22,0,22,凱基-永和,2023-04-26,9207
2303,聯電,18,2,16,凱基-永和,2023-04-26,9207
2609,陽明,15,0,15,凱基-永和,2023-04-26,9207
006208,富邦台50,13,0,13,凱基-永和,2023-04-26,9207
00900,富邦特選高股息30,13,0,13,凱基-永和,2023-04-26,9207
2002,中鋼,13,0,13,凱基-永和,2023-04-26,9207
2634,漢翔,20,7,13,凱基-永和,2023-04-26,9207
3037,欣興,20,7,13,凱基-永和,2023-04-26,9207
1904,正隆,22,10,12,凱基-永和,2023-04-26,9207
1611,中電,11,0,11,凱基-永和,2023-04-26,9207
2453,凌群,73,62,11,凱基-永和,2023-04-26,9207
4915,致伸,10,0,10,凱基-永和,2023-04-26,9207
00878,國泰永續高股息,11,1,10,凱基-永和,2023-04-26,9207
3014,聯陽,10,0,10,凱基-永和,2023-04-26,9207
3029,零壹,10,0,10,凱基-永和,2023-04-26,9207
4746,台耀,10,0,10,凱基-永和,2023-04-26,9207
8086,宏捷科,10,0,10,凱基-永和,2023-04-26,9207
2515,中工,10,0,10,凱基-永和,2023-04-26,9207
2610,華航,8,0,8,凱基-永和,2023-04-26,9207
0056,元大高股息,7,0,7,凱基-永和,2023-04-26,9207
8908,欣雄,7,0,7,凱基-永和,2023-04-26,9207
00772B,中信高評級公司債,7,0,7,凱基-永和,2023-04-26,9207
5351,鈺創,6,0,6,凱基-永和,2023-04-26,9207
00891,中信關鍵半導體,6,1,5,凱基-永和,2023-04-26,9207
1734,杏輝,5,0,5,凱基-永和,2023-04-26,9207
3260,威剛,5,0,5,凱基-永和,2023-04-26,9207
6167,久正,5,0,5,凱基-永和,2023-04-26,9207
00671R,富邦NASDAQ反1,4,0,4,凱基-永和,2023-04-26,9207
00680L,元大美債20正2,4,0,4,凱基-永和,2023-04-26,9207
00885,富邦越南,4,0,4,凱基-永和,2023-04-26,9207
1725,元禎,4,0,4,凱基-永和,2023-04-26,9207
1905,華紙,15,11,4,凱基-永和,2023-04-26,9207
2314,台揚,5,1,4,凱基-永和,2023-04-26,9207
2331,精英,4,0,4,凱基-永和,2023-04-26,9207
2404,漢唐,4,0,4,凱基-永和,2023-04-26,9207
3592,瑞鼎,5,1,4,凱基-永和,2023-04-26,9207
4966,譜瑞-KY,6,2,4,凱基-永和,2023-04-26,9207
6163,華電網,5,1,4,凱基-永和,2023-04-26,9207
1504,東元,3,0,3,凱基-永和,2023-04-26,9207
3035,智原,4,1,3,凱基-永和,2023-04-26,9207
2603,長榮,4,1,3,凱基-永和,2023-04-26,9207
4743,合一,5,2,3,凱基-永和,2023-04-26,9207
00751B,元大AAA至A公司債,3,0,3,凱基-永和,2023-04-26,9207
2409,友達,90,0,90,凱基-永和,2023-04-27,9207
6548,長科*,58,0,58,凱基-永和,2023-04-27,9207
6282,康舒,274,219,55,凱基-永和,2023-04-27,9207
5309,系統電,29,1,28,凱基-永和,2023-04-27,9207
1710,東聯,32,6,26,凱基-永和,2023-04-27,9207
00715L,期街口布蘭特正2,24,0,24,凱基-永和,2023-04-27,9207
00878,國泰永續高股息,23,0,23,凱基-永和,2023-04-27,9207
6517,保勝光學,25,4,21,凱基-永和,2023-04-27,9207
3481,群創,20,1,19,凱基-永和,2023-04-27,9207
00900,富邦特選高股息30,17,0,17,凱基-永和,2023-04-27,9207
2603,長榮,16,0,16,凱基-永和,2023-04-27,9207
00712,復華富時不動產,16,0,16,凱基-永和,2023-04-27,9207
00632R,元大台灣50反1,16,0,16,凱基-永和,2023-04-27,9207
1905,華紙,174,163,11,凱基-永和,2023-04-27,9207
00922,國泰台灣領袖50,10,0,10,凱基-永和,2023-04-27,9207
00642U,期元大S＆P石油,10,0,10,凱基-永和,2023-04-27,9207
1717,長興,10,0,10,凱基-永和,2023-04-27,9207
2352,佳世達,12,4,8,凱基-永和,2023-04-27,9207
2609,陽明,7,0,7,凱基-永和,2023-04-27,9207
6160,欣技,7,0,7,凱基-永和,2023-04-27,9207
4121,優盛,6,0,6,凱基-永和,2023-04-27,9207
6125,廣運,6,0,6,凱基-永和,2023-04-27,9207
00680L,元大美債20正2,5,0,5,凱基-永和,2023-04-27,9207
2353,宏��,5,0,5,凱基-永和,2023-04-27,9207
2515,中工,5,0,5,凱基-永和,2023-04-27,9207
2618,長榮航,6,1,5,凱基-永和,2023-04-27,9207
2849,安泰銀,5,0,5,凱基-永和,2023-04-27,9207
3035,智原,5,0,5,凱基-永和,2023-04-27,9207
3305,昇貿,6,1,5,凱基-永和,2023-04-27,9207
3701,大眾控,5,0,5,凱基-永和,2023-04-27,9207
5351,鈺創,6,1,5,凱基-永和,2023-04-27,9207
3037,欣興,6,1,5,凱基-永和,2023-04-27,9207
0050,元大台灣50,5,0,5,凱基-永和,2023-04-27,9207
2610,華航,5,1,4,凱基-永和,2023-04-27,9207
1513,中興電,4,0,4,凱基-永和,2023-04-27,9207
00683L,期元大美元指正2,4,0,4,凱基-永和,2023-04-27,9207
3338,泰碩,5,1,4,凱基-永和,2023-04-27,9207
4306,炎洲,4,0,4,凱基-永和,2023-04-27,9207
8222,寶一,97,93,4,凱基-永和,2023-04-27,9207
8927,北基,4,0,4,凱基-永和,2023-04-27,9207
00687B,國泰20年美債,4,0,4,凱基-永和,2023-04-27,9207
006208,富邦台50,3,0,3,凱基-永和,2023-04-27,9207
2328,廣宇,3,0,3,凱基-永和,2023-04-27,9207
8046,南電,3,0,3,凱基-永和,2023-04-27,9207
1709,和益,13,10,3,凱基-永和,2023-04-27,9207
1605,華新,3,0,3,凱基-永和,2023-04-27,9207
0056,元大高股息,3,0,3,凱基-永和,2023-04-27,9207
00633L,富邦上証正2,3,0,3,凱基-永和,2023-04-27,9207
1444,力麗,3,0,3,凱基-永和,2023-04-27,9207
2206,三陽工業,7,4,3,凱基-永和,2023-04-27,9207
8121,越峰,597,171,426,凱基-永和,2023-04-28,9207
2022,聚亨,304,0,304,凱基-永和,2023-04-28,9207
1809,中釉,561,360,201,凱基-永和,2023-04-28,9207
2344,華邦電,179,3,176,凱基-永和,2023-04-28,9207
3363,上詮,143,1,142,凱基-永和,2023-04-28,9207
8069,元太,90,4,86,凱基-永和,2023-04-28,9207
2471,資通,289,217,72,凱基-永和,2023-04-28,9207
2331,精英,47,0,47,凱基-永和,2023-04-28,9207
8093,保銳,41,0,41,凱基-永和,2023-04-28,9207
6751,智聯服務,21,0,21,凱基-永和,2023-04-28,9207
3714,富采,20,0,20,凱基-永和,2023-04-28,9207
6753,龍德造船,20,0,20,凱基-永和,2023-04-28,9207
2364,倫飛,20,2,18,凱基-永和,2023-04-28,9207
2610,華航,17,1,16,凱基-永和,2023-04-28,9207
6291,沛亨,14,0,14,凱基-永和,2023-04-28,9207
6461,益得,13,0,13,凱基-永和,2023-04-28,9207
00772B,中信高評級公司債,13,0,13,凱基-永和,2023-04-28,9207
2208,台船,13,2,11,凱基-永和,2023-04-28,9207
3481,群創,10,0,10,凱基-永和,2023-04-28,9207
1777,生泰,11,1,10,凱基-永和,2023-04-28,9207
6209,今國光,10,0,10,凱基-永和,2023-04-28,9207
3479,安勤,18,9,9,凱基-永和,2023-04-28,9207
00632R,元大台灣50反1,8,0,8,凱基-永和,2023-04-28,9207
4979,華星光,10,2,8,凱基-永和,2023-04-28,9207
6752,叡揚,32,25,7,凱基-永和,2023-04-28,9207
6811,宏�硌穈T,27,20,7,凱基-永和,2023-04-28,9207
00878,國泰永續高股息,11,5,6,凱基-永和,2023-04-28,9207
00720B,元大投資級公司債,6,0,6,凱基-永和,2023-04-28,9207
2515,中工,10,4,6,凱基-永和,2023-04-28,9207
2888,新光金,6,0,6,凱基-永和,2023-04-28,9207
3570,大塚,6,0,6,凱基-永和,2023-04-28,9207
6266,泰詠,7,1,6,凱基-永和,2023-04-28,9207
1584,精剛,5,0,5,凱基-永和,2023-04-28,9207
00671R,富邦NASDAQ反1,5,0,5,凱基-永和,2023-04-28,9207
00740B,富邦全球投等債,5,0,5,凱基-永和,2023-04-28,9207
2105,正新,5,0,5,凱基-永和,2023-04-28,9207
2849,安泰銀,5,0,5,凱基-永和,2023-04-28,9207
3058,立德,5,0,5,凱基-永和,2023-04-28,9207
3260,威剛,5,0,5,凱基-永和,2023-04-28,9207
3624,光頡,5,0,5,凱基-永和,2023-04-28,9207
4923,力士,5,0,5,凱基-永和,2023-04-28,9207
6863,永道-KY,5,0,5,凱基-永和,2023-04-28,9207
8150,南茂,5,0,5,凱基-永和,2023-04-28,9207
1308,亞聚,4,0,4,凱基-永和,2023-04-28,9207
00751B,元大AAA至A公司債,4,0,4,凱基-永和,2023-04-28,9207
00893,國泰智能電動車,4,0,4,凱基-永和,2023-04-28,9207
00680L,元大美債20正2,4,0,4,凱基-永和,2023-04-28,9207
2419,仲琦,4,0,4,凱基-永和,2023-04-28,9207
2734,易飛網,4,0,4,凱基-永和,2023-04-28,9207
3380,明泰,4,0,4,凱基-永和,2023-04-28,9207
3017,奇鋐,300,2,298,凱基-永和,2023-05-02,9207
1905,華紙,493,290,203,凱基-永和,2023-05-02,9207
2913,農林,320,157,163,凱基-永和,2023-05-02,9207
6282,康舒,150,6,144,凱基-永和,2023-05-02,9207
6806,森崴能源,103,4,99,凱基-永和,2023-05-02,9207
3522,御嵿,96,0,96,凱基-永和,2023-05-02,9207
1776,展宇,88,0,88,凱基-永和,2023-05-02,9207
3013,晟銘電,88,5,83,凱基-永和,2023-05-02,9207
1514,亞力,117,39,78,凱基-永和,2023-05-02,9207
3682,亞太電,60,0,60,凱基-永和,2023-05-02,9207
3147,大綜,84,27,57,凱基-永和,2023-05-02,9207
2206,三陽工業,83,27,56,凱基-永和,2023-05-02,9207
1519,華城,43,6,37,凱基-永和,2023-05-02,9207
2834,臺企銀,29,2,27,凱基-永和,2023-05-02,9207
2603,長榮,37,11,26,凱基-永和,2023-05-02,9207
6535,順藥,24,0,24,凱基-永和,2023-05-02,9207
1314,中石化,39,17,22,凱基-永和,2023-05-02,9207
3715,定穎投控,20,0,20,凱基-永和,2023-05-02,9207
6770,力積電,20,0,20,凱基-永和,2023-05-02,9207
00720B,元大投資級公司債,16,0,16,凱基-永和,2023-05-02,9207
1503,士電,35,20,15,凱基-永和,2023-05-02,9207
4127,天良,14,0,14,凱基-永和,2023-05-02,9207
6689,伊雲谷,14,0,14,凱基-永和,2023-05-02,9207
2352,佳世達,36,24,12,凱基-永和,2023-05-02,9207
2457,飛宏,18,7,11,凱基-永和,2023-05-02,9207
4979,華星光,10,0,10,凱基-永和,2023-05-02,9207
8403,盛弘,28,18,10,凱基-永和,2023-05-02,9207
9958,世紀鋼,10,0,10,凱基-永和,2023-05-02,9207
3029,零壹,52,43,9,凱基-永和,2023-05-02,9207
6217,中探針,10,1,9,凱基-永和,2023-05-02,9207
8222,寶一,11,2,9,凱基-永和,2023-05-02,9207
3443,創意,10,2,8,凱基-永和,2023-05-02,9207
00772B,中信高評級公司債,8,0,8,凱基-永和,2023-05-02,9207
2801,彰銀,7,0,7,凱基-永和,2023-05-02,9207
4130,健亞,7,0,7,凱基-永和,2023-05-02,9207
00679B,元大美債20年,7,0,7,凱基-永和,2023-05-02,9207
00632R,元大台灣50反1,6,0,6,凱基-永和,2023-05-02,9207
2890,永豐金,7,1,6,凱基-永和,2023-05-02,9207
2812,台中銀,6,0,6,凱基-永和,2023-05-02,9207
1104,環泥,6,1,5,凱基-永和,2023-05-02,9207
00918,大華優利高填息30,5,0,5,凱基-永和,2023-05-02,9207
00912,中信臺灣智慧50,5,0,5,凱基-永和,2023-05-02,9207
2009,第一銅,5,0,5,凱基-永和,2023-05-02,9207
3231,緯創,27,22,5,凱基-永和,2023-05-02,9207
3322,建舜電,5,0,5,凱基-永和,2023-05-02,9207
3712,永崴投控,6,1,5,凱基-永和,2023-05-02,9207
4564,元翎,5,0,5,凱基-永和,2023-05-02,9207
6168,宏齊,5,0,5,凱基-永和,2023-05-02,9207
6190,萬泰科,5,0,5,凱基-永和,2023-05-02,9207
00713,元大台灣高息低波,4,0,4,凱基-永和,2023-05-02,9207
2428,興勤,300,1,299,凱基-永和,2023-05-03,9207
2498,宏達電,60,0,60,凱基-永和,2023-05-03,9207
6111,大宇資,41,1,40,凱基-永和,2023-05-03,9207
2634,漢翔,83,47,36,凱基-永和,2023-05-03,9207
1710,東聯,31,1,30,凱基-永和,2023-05-03,9207
00712,復華富時不動產,27,0,27,凱基-永和,2023-05-03,9207
2609,陽明,30,4,26,凱基-永和,2023-05-03,9207
00878,國泰永續高股息,29,4,25,凱基-永和,2023-05-03,9207
5478,智冠,25,1,24,凱基-永和,2023-05-03,9207
3712,永崴投控,28,4,24,凱基-永和,2023-05-03,9207
00680L,元大美債20正2,23,0,23,凱基-永和,2023-05-03,9207
1101,台泥,24,1,23,凱基-永和,2023-05-03,9207
00882,中信中國高股息,20,0,20,凱基-永和,2023-05-03,9207
4763,材料-KY,20,0,20,凱基-永和,2023-05-03,9207
2002,中鋼,17,0,17,凱基-永和,2023-05-03,9207
2603,長榮,22,6,16,凱基-永和,2023-05-03,9207
3046,建��,15,0,15,凱基-永和,2023-05-03,9207
3454,晶睿,15,0,15,凱基-永和,2023-05-03,9207
4108,懷特,14,0,14,凱基-永和,2023-05-03,9207
6231,系微,11,0,11,凱基-永和,2023-05-03,9207
00720B,元大投資級公司債,10,0,10,凱基-永和,2023-05-03,9207
3322,建舜電,10,0,10,凱基-永和,2023-05-03,9207
4916,事欣科,10,0,10,凱基-永和,2023-05-03,9207
5381,合正,10,0,10,凱基-永和,2023-05-03,9207
3576,聯合再生,10,1,9,凱基-永和,2023-05-03,9207
9925,新保,9,0,9,凱基-永和,2023-05-03,9207
00679B,元大美債20年,9,0,9,凱基-永和,2023-05-03,9207
6550,北極星藥業-KY,10,2,8,凱基-永和,2023-05-03,9207
2617,台航,8,1,7,凱基-永和,2023-05-03,9207
9933,中鼎,7,0,7,凱基-永和,2023-05-03,9207
0056,元大高股息,12,6,6,凱基-永和,2023-05-03,9207
1536,和大,5,0,5,凱基-永和,2023-05-03,9207
00757,統一FANG+,5,0,5,凱基-永和,2023-05-03,9207
00891,中信關鍵半導體,5,0,5,凱基-永和,2023-05-03,9207
00653L,富邦印度正2,5,0,5,凱基-永和,2023-05-03,9207
00642U,期元大S＆P石油,5,0,5,凱基-永和,2023-05-03,9207
1907,永豐餘,9,4,5,凱基-永和,2023-05-03,9207
3675,德微,5,0,5,凱基-永和,2023-05-03,9207
6168,宏齊,5,0,5,凱基-永和,2023-05-03,9207
8478,東哥遊艇,46,41,5,凱基-永和,2023-05-03,9207
0050,元大台灣50,4,0,4,凱基-永和,2023-05-03,9207
1529,樂事綠能,4,0,4,凱基-永和,2023-05-03,9207
1711,永光,4,0,4,凱基-永和,2023-05-03,9207
1905,華紙,14,10,4,凱基-永和,2023-05-03,9207
2497,怡利電,4,0,4,凱基-永和,2023-05-03,9207
3033,威健,4,0,4,凱基-永和,2023-05-03,9207
3703,欣陸,4,0,4,凱基-永和,2023-05-03,9207
4977,眾達-KY,4,0,4,凱基-永和,2023-05-03,9207
8289,泰藝,4,0,4,凱基-永和,2023-05-03,9207
6180,橘子,7,3,4,凱基-永和,2023-05-03,9207
3017,奇鋐,132,63,69,凱基-永和,2023-05-04,9207
6244,茂迪,78,26,52,凱基-永和,2023-05-04,9207
3576,聯合再生,50,0,50,凱基-永和,2023-05-04,9207
1609,大亞,192,151,41,凱基-永和,2023-05-04,9207
00715L,期街口布蘭特正2,33,1,32,凱基-永和,2023-05-04,9207
3363,上詮,93,65,28,凱基-永和,2023-05-04,9207
00642U,期元大S＆P石油,26,0,26,凱基-永和,2023-05-04,9207
3356,奇偶,28,3,25,凱基-永和,2023-05-04,9207
4111,濟生,21,0,21,凱基-永和,2023-05-04,9207
6234,高僑,61,41,20,凱基-永和,2023-05-04,9207
6612,奈米醫材,20,0,20,凱基-永和,2023-05-04,9207
8076,伍豐,20,0,20,凱基-永和,2023-05-04,9207
2359,所羅門,15,0,15,凱基-永和,2023-05-04,9207
6472,保瑞,52,37,15,凱基-永和,2023-05-04,9207
2204,中華,14,0,14,凱基-永和,2023-05-04,9207
3481,群創,10,0,10,凱基-永和,2023-05-04,9207
2022,聚亨,10,0,10,凱基-永和,2023-05-04,9207
3712,永崴投控,10,0,10,凱基-永和,2023-05-04,9207
6517,保勝光學,30,20,10,凱基-永和,2023-05-04,9207
6443,元晶,10,0,10,凱基-永和,2023-05-04,9207
00712,復華富時不動產,9,0,9,凱基-永和,2023-05-04,9207
4915,致伸,10,1,9,凱基-永和,2023-05-04,9207
6282,康舒,12,3,9,凱基-永和,2023-05-04,9207
1312,國喬,8,0,8,凱基-永和,2023-05-04,9207
2206,三陽工業,39,31,8,凱基-永和,2023-05-04,9207
1504,東元,7,0,7,凱基-永和,2023-05-04,9207
2317,鴻海,7,0,7,凱基-永和,2023-05-04,9207
2834,臺企銀,6,0,6,凱基-永和,2023-05-04,9207
4104,佳醫,9,3,6,凱基-永和,2023-05-04,9207
4968,立積,6,0,6,凱基-永和,2023-05-04,9207
2801,彰銀,6,0,6,凱基-永和,2023-05-04,9207
8403,盛弘,34,28,6,凱基-永和,2023-05-04,9207
4566,時碩工業,7,2,5,凱基-永和,2023-05-04,9207
1460,宏遠,5,0,5,凱基-永和,2023-05-04,9207
2208,台船,5,0,5,凱基-永和,2023-05-04,9207
2838A,聯邦銀甲特,5,0,5,凱基-永和,2023-05-04,9207
2849,安泰銀,5,0,5,凱基-永和,2023-05-04,9207
3021,鴻名,5,0,5,凱基-永和,2023-05-04,9207
3324,雙鴻,8,3,5,凱基-永和,2023-05-04,9207
3701,大眾控,5,0,5,凱基-永和,2023-05-04,9207
2617,台航,5,1,4,凱基-永和,2023-05-04,9207
2906,高林,4,0,4,凱基-永和,2023-05-04,9207
2609,陽明,4,1,3,凱基-永和,2023-05-04,9207
00885,富邦越南,3,0,3,凱基-永和,2023-05-04,9207
1308,亞聚,3,0,3,凱基-永和,2023-05-04,9207
3704,合勤控,4,1,3,凱基-永和,2023-05-04,9207
4527,方土霖,3,0,3,凱基-永和,2023-05-04,9207
5351,鈺創,5,2,3,凱基-永和,2023-05-04,9207
6112,邁達特,3,0,3,凱基-永和,2023-05-04,9207
6163,華電網,3,0,3,凱基-永和,2023-05-04,9207
00878,國泰永續高股息,108,4,104,凱基-永和,2023-05-05,9207
3714,富采,35,0,35,凱基-永和,2023-05-05,9207
6770,力積電,31,0,31,凱基-永和,2023-05-05,9207
00713,元大台灣高息低波,29,3,26,凱基-永和,2023-05-05,9207
2006,東和鋼鐵,25,0,25,凱基-永和,2023-05-05,9207
3017,奇鋐,31,7,24,凱基-永和,2023-05-05,9207
00885,富邦越南,21,0,21,凱基-永和,2023-05-05,9207
2436,偉詮電,20,0,20,凱基-永和,2023-05-05,9207
3036,文曄,22,5,17,凱基-永和,2023-05-05,9207
4979,華星光,18,1,17,凱基-永和,2023-05-05,9207
2368,金像電,17,2,15,凱基-永和,2023-05-05,9207
8215,明基材,17,2,15,凱基-永和,2023-05-05,9207
2301,光寶科,14,0,14,凱基-永和,2023-05-05,9207
00902,中信電池及儲能,13,0,13,凱基-永和,2023-05-05,9207
2603,長榮,12,0,12,凱基-永和,2023-05-05,9207
00715L,期街口布蘭特正2,11,0,11,凱基-永和,2023-05-05,9207
2359,所羅門,38,27,11,凱基-永和,2023-05-05,9207
8429,金麗-KY,11,0,11,凱基-永和,2023-05-05,9207
5425,台半,11,1,10,凱基-永和,2023-05-05,9207
00648R,元大S＆P500反1,10,0,10,凱基-永和,2023-05-05,9207
2610,華航,10,0,10,凱基-永和,2023-05-05,9207
3484,崧騰,10,0,10,凱基-永和,2023-05-05,9207
3545,敦泰,10,0,10,凱基-永和,2023-05-05,9207
4111,濟生,11,1,10,凱基-永和,2023-05-05,9207
4562,穎漢,10,0,10,凱基-永和,2023-05-05,9207
6125,廣運,10,0,10,凱基-永和,2023-05-05,9207
6191,精成科,12,2,10,凱基-永和,2023-05-05,9207
00772B,中信高評級公司債,9,0,9,凱基-永和,2023-05-05,9207
00679B,元大美債20年,9,0,9,凱基-永和,2023-05-05,9207
00642U,期元大S＆P石油,8,0,8,凱基-永和,2023-05-05,9207
00720B,元大投資級公司債,8,0,8,凱基-永和,2023-05-05,9207
3005,神基,15,7,8,凱基-永和,2023-05-05,9207
4931,新盛力,8,0,8,凱基-永和,2023-05-05,9207
1605,華新,11,3,8,凱基-永和,2023-05-05,9207
1310,台苯,8,1,7,凱基-永和,2023-05-05,9207
1905,華紙,16,9,7,凱基-永和,2023-05-05,9207
2634,漢翔,23,16,7,凱基-永和,2023-05-05,9207
4763,材料-KY,7,1,6,凱基-永和,2023-05-05,9207
6282,康舒,10,4,6,凱基-永和,2023-05-05,9207
2344,華邦電,9,3,6,凱基-永和,2023-05-05,9207
2495,普安,6,0,6,凱基-永和,2023-05-05,9207
4104,佳醫,7,1,6,凱基-永和,2023-05-05,9207
6756,威鋒電子,6,0,6,凱基-永和,2023-05-05,9207
00751B,元大AAA至A公司債,5,0,5,凱基-永和,2023-05-05,9207
00773B,中信優先金融債,5,0,5,凱基-永和,2023-05-05,9207
2458,義隆,5,0,5,凱基-永和,2023-05-05,9207
2497,怡利電,5,0,5,凱基-永和,2023-05-05,9207
5309,系統電,5,0,5,凱基-永和,2023-05-05,9207
5321,美而快,87,82,5,凱基-永和,2023-05-05,9207
2480,敦陽科,5,1,4,凱基-永和,2023-05-05,9207
3231,緯創,898,9,889,凱基-永和,2023-05-08,9207
2883,凱基金,159,12,147,凱基-永和,2023-05-08,9207
6282,康舒,108,7,101,凱基-永和,2023-05-08,9207
5211,蒙恬,92,2,90,凱基-永和,2023-05-08,9207
3011,今皓,88,1,87,凱基-永和,2023-05-08,9207
1504,東元,121,72,49,凱基-永和,2023-05-08,9207
1519,華城,105,58,47,凱基-永和,2023-05-08,9207
2812,台中銀,45,5,40,凱基-永和,2023-05-08,9207
1905,華紙,53,13,40,凱基-永和,2023-05-08,9207
1218,泰山,38,4,34,凱基-永和,2023-05-08,9207
00720B,元大投資級公司債,25,0,25,凱基-永和,2023-05-08,9207
3046,建��,69,44,25,凱基-永和,2023-05-08,9207
1612,宏泰,25,2,23,凱基-永和,2023-05-08,9207
6509,聚和,21,0,21,凱基-永和,2023-05-08,9207
2515,中工,20,0,20,凱基-永和,2023-05-08,9207
3693,營邦,50,30,20,凱基-永和,2023-05-08,9207
2471,資通,20,1,19,凱基-永和,2023-05-08,9207
6443,元晶,16,1,15,凱基-永和,2023-05-08,9207
00878,國泰永續高股息,24,10,14,凱基-永和,2023-05-08,9207
2371,大同,29,15,14,凱基-永和,2023-05-08,9207
2609,陽明,13,0,13,凱基-永和,2023-05-08,9207
00679B,元大美債20年,12,0,12,凱基-永和,2023-05-08,9207
00901,永豐智能車供應鏈,10,0,10,凱基-永和,2023-05-08,9207
2884,玉山金,10,0,10,凱基-永和,2023-05-08,9207
4133,亞諾法,10,0,10,凱基-永和,2023-05-08,9207
4541,晟田,51,41,10,凱基-永和,2023-05-08,9207
8171,天宇,10,0,10,凱基-永和,2023-05-08,9207
2913,農林,10,1,9,凱基-永和,2023-05-08,9207
1605,華新,13,5,8,凱基-永和,2023-05-08,9207
3714,富采,8,0,8,凱基-永和,2023-05-08,9207
00751B,元大AAA至A公司債,7,0,7,凱基-永和,2023-05-08,9207
2634,漢翔,17,10,7,凱基-永和,2023-05-08,9207
4915,致伸,7,0,7,凱基-永和,2023-05-08,9207
6840,東研信超,7,0,7,凱基-永和,2023-05-08,9207
8478,東哥遊艇,15,8,7,凱基-永和,2023-05-08,9207
1319,東陽,6,0,6,凱基-永和,2023-05-08,9207
1584,精剛,6,0,6,凱基-永和,2023-05-08,9207
2618,長榮航,31,25,6,凱基-永和,2023-05-08,9207
3454,晶睿,6,0,6,凱基-永和,2023-05-08,9207
8049,晶采,6,0,6,凱基-永和,2023-05-08,9207
9105,泰金寶-DR,6,0,6,凱基-永和,2023-05-08,9207
1514,亞力,13,8,5,凱基-永和,2023-05-08,9207
00671R,富邦NASDAQ反1,5,0,5,凱基-永和,2023-05-08,9207
00632R,元大台灣50反1,5,0,5,凱基-永和,2023-05-08,9207
00701,國泰股利精選30,5,0,5,凱基-永和,2023-05-08,9207
2337,旺宏,5,0,5,凱基-永和,2023-05-08,9207
2883B,凱基金乙特,5,0,5,凱基-永和,2023-05-08,9207
3443,創意,5,0,5,凱基-永和,2023-05-08,9207
3450,聯鈞,5,0,5,凱基-永和,2023-05-08,9207
4111,濟生,5,0,5,凱基-永和,2023-05-08,9207
3017,奇鋐,111,0,111,凱基-永和,2023-05-09,9207
1609,大亞,48,1,47,凱基-永和,2023-05-09,9207
2883,凱基金,53,18,35,凱基-永和,2023-05-09,9207
6443,元晶,51,30,21,凱基-永和,2023-05-09,9207
4564,元翎,20,0,20,凱基-永和,2023-05-09,9207
3322,建舜電,20,0,20,凱基-永和,2023-05-09,9207
0056,元大高股息,21,3,18,凱基-永和,2023-05-09,9207
1616,億泰,18,0,18,凱基-永和,2023-05-09,9207
00720B,元大投資級公司債,17,0,17,凱基-永和,2023-05-09,9207
2618,長榮航,16,0,16,凱基-永和,2023-05-09,9207
00679B,元大美債20年,14,0,14,凱基-永和,2023-05-09,9207
3704,合勤控,13,0,13,凱基-永和,2023-05-09,9207
00902,中信電池及儲能,12,0,12,凱基-永和,2023-05-09,9207
4129,聯合,12,0,12,凱基-永和,2023-05-09,9207
1101,台泥,12,1,11,凱基-永和,2023-05-09,9207
3576,聯合再生,11,0,11,凱基-永和,2023-05-09,9207
1513,中興電,11,1,10,凱基-永和,2023-05-09,9207
2359,所羅門,12,2,10,凱基-永和,2023-05-09,9207
2515,中工,10,0,10,凱基-永和,2023-05-09,9207
3346,麗清,10,0,10,凱基-永和,2023-05-09,9207
4111,濟生,10,0,10,凱基-永和,2023-05-09,9207
6109,亞元,10,0,10,凱基-永和,2023-05-09,9207
6672,騰輝電子-KY,10,0,10,凱基-永和,2023-05-09,9207
6770,力積電,10,0,10,凱基-永和,2023-05-09,9207
8171,天宇,10,0,10,凱基-永和,2023-05-09,9207
00878,國泰永續高股息,9,0,9,凱基-永和,2023-05-09,9207
6741,91APP*-KY,10,1,9,凱基-永和,2023-05-09,9207
00712,復華富時不動產,10,2,8,凱基-永和,2023-05-09,9207
3484,崧騰,8,0,8,凱基-永和,2023-05-09,9207
4967,十銓,8,0,8,凱基-永和,2023-05-09,9207
3034,聯詠,7,0,7,凱基-永和,2023-05-09,9207
00751B,元大AAA至A公司債,7,0,7,凱基-永和,2023-05-09,9207
2104,國際中橡,7,0,7,凱基-永和,2023-05-09,9207
6275,元山,8,1,7,凱基-永和,2023-05-09,9207
2353,宏��,6,0,6,凱基-永和,2023-05-09,9207
3051,力特,6,0,6,凱基-永和,2023-05-09,9207
3504,揚明光,6,0,6,凱基-永和,2023-05-09,9207
3706,神達,6,0,6,凱基-永和,2023-05-09,9207
3715,定穎投控,7,1,6,凱基-永和,2023-05-09,9207
4104,佳醫,11,5,6,凱基-永和,2023-05-09,9207
5227,立凱-KY,8,2,6,凱基-永和,2023-05-09,9207
6290,良維,6,0,6,凱基-永和,2023-05-09,9207
2609,陽明,7,2,5,凱基-永和,2023-05-09,9207
00687B,國泰20年美債,5,0,5,凱基-永和,2023-05-09,9207
1711,永光,5,0,5,凱基-永和,2023-05-09,9207
2023,燁輝,5,0,5,凱基-永和,2023-05-09,9207
2849,安泰銀,5,0,5,凱基-永和,2023-05-09,9207
3521,鴻翊,5,0,5,凱基-永和,2023-05-09,9207
5483,中美晶,6,1,5,凱基-永和,2023-05-09,9207
6116,彩晶,5,0,5,凱基-永和,2023-05-09,9207
2022,聚亨,145,9,136,凱基-永和,2023-05-10,9207
6234,高僑,140,54,86,凱基-永和,2023-05-10,9207
2356,英業達,70,0,70,凱基-永和,2023-05-10,9207
6139,亞翔,51,1,50,凱基-永和,2023-05-10,9207
2886,兆豐金,26,0,26,凱基-永和,2023-05-10,9207
6109,亞元,25,0,25,凱基-永和,2023-05-10,9207
0056,元大高股息,25,1,24,凱基-永和,2023-05-10,9207
4564,元翎,24,0,24,凱基-永和,2023-05-10,9207
00878,國泰永續高股息,23,1,22,凱基-永和,2023-05-10,9207
2801,彰銀,13,0,13,凱基-永和,2023-05-10,9207
5301,寶得利,12,0,12,凱基-永和,2023-05-10,9207
00679B,元大美債20年,11,0,11,凱基-永和,2023-05-10,9207
2002,中鋼,10,0,10,凱基-永和,2023-05-10,9207
2834,臺企銀,10,0,10,凱基-永和,2023-05-10,9207
3576,聯合再生,10,0,10,凱基-永和,2023-05-10,9207
00713,元大台灣高息低波,9,0,9,凱基-永和,2023-05-10,9207
00772B,中信高評級公司債,9,0,9,凱基-永和,2023-05-10,9207
4138,曜亞,10,1,9,凱基-永和,2023-05-10,9207
1762,中化生,10,2,8,凱基-永和,2023-05-10,9207
3231,緯創,12,4,8,凱基-永和,2023-05-10,9207
4906,正文,10,2,8,凱基-永和,2023-05-10,9207
3338,泰碩,15,8,7,凱基-永和,2023-05-10,9207
9939,宏全,6,0,6,凱基-永和,2023-05-10,9207
3211,順達,6,0,6,凱基-永和,2023-05-10,9207
4155,訊映,6,0,6,凱基-永和,2023-05-10,9207
6118,建達,6,0,6,凱基-永和,2023-05-10,9207
2330,台積電,5,0,5,凱基-永和,2023-05-10,9207
8210,勤誠,5,0,5,凱基-永和,2023-05-10,9207
00918,大華優利高填息30,5,0,5,凱基-永和,2023-05-10,9207
00720B,元大投資級公司債,5,0,5,凱基-永和,2023-05-10,9207
2542,興富發,5,0,5,凱基-永和,2023-05-10,9207
3037,欣興,16,11,5,凱基-永和,2023-05-10,9207
4133,亞諾法,5,0,5,凱基-永和,2023-05-10,9207
6213,聯茂,5,0,5,凱基-永和,2023-05-10,9207
6223,旺矽,5,0,5,凱基-永和,2023-05-10,9207
6456,GIS-KY,5,0,5,凱基-永和,2023-05-10,9207
9905,大華,5,0,5,凱基-永和,2023-05-10,9207
9907,統一實,5,0,5,凱基-永和,2023-05-10,9207
6244,茂迪,7,2,5,凱基-永和,2023-05-10,9207
1605,華新,4,0,4,凱基-永和,2023-05-10,9207
2344,華邦電,5,1,4,凱基-永和,2023-05-10,9207
2457,飛宏,32,28,4,凱基-永和,2023-05-10,9207
2881,富邦金,4,0,4,凱基-永和,2023-05-10,9207
3013,晟銘電,7,3,4,凱基-永和,2023-05-10,9207
3546,宇峻,4,0,4,凱基-永和,2023-05-10,9207
4979,華星光,20,16,4,凱基-永和,2023-05-10,9207
6770,力積電,4,0,4,凱基-永和,2023-05-10,9207
9945,潤泰新,4,0,4,凱基-永和,2023-05-10,9207
3479,安勤,8,4,4,凱基-永和,2023-05-10,9207
0050,元大台灣50,3,0,3,凱基-永和,2023-05-10,9207
6109,亞元,75,0,75,凱基-永和,2023-05-11,9207
2880,華南金,71,0,71,凱基-永和,2023-05-11,9207
4729,熒茂,50,0,50,凱基-永和,2023-05-11,9207
5531,鄉林,40,0,40,凱基-永和,2023-05-11,9207
2201,裕隆,36,1,35,凱基-永和,2023-05-11,9207
6285,啟��,37,2,35,凱基-永和,2023-05-11,9207
2883,凱基金,27,0,27,凱基-永和,2023-05-11,9207
00679B,元大美債20年,21,0,21,凱基-永和,2023-05-11,9207
2312,金寶,21,0,21,凱基-永和,2023-05-11,9207
3138,耀登,20,0,20,凱基-永和,2023-05-11,9207
8038,長園科,18,0,18,凱基-永和,2023-05-11,9207
4564,元翎,17,0,17,凱基-永和,2023-05-11,9207
2002,中鋼,19,2,17,凱基-永和,2023-05-11,9207
3322,建舜電,16,0,16,凱基-永和,2023-05-11,9207
4766,南寶,16,0,16,凱基-永和,2023-05-11,9207
00664R,國泰臺灣加權反1,15,0,15,凱基-永和,2023-05-11,9207
2515,中工,15,0,15,凱基-永和,2023-05-11,9207
2885,元大金,15,0,15,凱基-永和,2023-05-11,9207
1514,亞力,13,0,13,凱基-永和,2023-05-11,9207
00878,國泰永續高股息,24,12,12,凱基-永和,2023-05-11,9207
3704,合勤控,22,10,12,凱基-永和,2023-05-11,9207
6122,擎邦,22,11,11,凱基-永和,2023-05-11,9207
2603,長榮,10,0,10,凱基-永和,2023-05-11,9207
00720B,元大投資級公司債,10,0,10,凱基-永和,2023-05-11,9207
00632R,元大台灣50反1,15,5,10,凱基-永和,2023-05-11,9207
1314,中石化,10,0,10,凱基-永和,2023-05-11,9207
2605,新興,10,0,10,凱基-永和,2023-05-11,9207
6461,益得,10,0,10,凱基-永和,2023-05-11,9207
1513,中興電,9,0,9,凱基-永和,2023-05-11,9207
2402,毅嘉,9,0,9,凱基-永和,2023-05-11,9207
3017,奇鋐,11,2,9,凱基-永和,2023-05-11,9207
3284,太普高,9,0,9,凱基-永和,2023-05-11,9207
4746,台耀,10,1,9,凱基-永和,2023-05-11,9207
4915,致伸,9,0,9,凱基-永和,2023-05-11,9207
6282,康舒,9,0,9,凱基-永和,2023-05-11,9207
3037,欣興,26,18,8,凱基-永和,2023-05-11,9207
1802,台玻,7,0,7,凱基-永和,2023-05-11,9207
1609,大亞,10,3,7,凱基-永和,2023-05-11,9207
4104,佳醫,15,8,7,凱基-永和,2023-05-11,9207
2745,五福,7,1,6,凱基-永和,2023-05-11,9207
5353,台林,6,0,6,凱基-永和,2023-05-11,9207
6806,森崴能源,5,0,5,凱基-永和,2023-05-11,9207
4967,十銓,15,10,5,凱基-永和,2023-05-11,9207
1529,樂事綠能,5,0,5,凱基-永和,2023-05-11,9207
1598,岱宇,5,0,5,凱基-永和,2023-05-11,9207
2867,三商壽,5,0,5,凱基-永和,2023-05-11,9207
3024,憶聲,5,0,5,凱基-永和,2023-05-11,9207
4106,雃博,5,0,5,凱基-永和,2023-05-11,9207
5227,立凱-KY,6,1,5,凱基-永和,2023-05-11,9207
6443,元晶,5,0,5,凱基-永和,2023-05-11,9207
3363,上詮,101,0,101,凱基-永和,2023-05-12,9207
8097,常珵,84,1,83,凱基-永和,2023-05-12,9207
3661,世芯-KY,65,0,65,凱基-永和,2023-05-12,9207
3058,立德,51,10,41,凱基-永和,2023-05-12,9207
00882,中信中國高股息,29,0,29,凱基-永和,2023-05-12,9207
2382,廣達,151,124,27,凱基-永和,2023-05-12,9207
3484,崧騰,21,0,21,凱基-永和,2023-05-12,9207
2002,中鋼,20,0,20,凱基-永和,2023-05-12,9207
2031,新光鋼,20,0,20,凱基-永和,2023-05-12,9207
2331,精英,20,0,20,凱基-永和,2023-05-12,9207
2317,鴻海,22,3,19,凱基-永和,2023-05-12,9207
3046,建��,20,5,15,凱基-永和,2023-05-12,9207
1504,東元,18,4,14,凱基-永和,2023-05-12,9207
2883,凱基金,17,3,14,凱基-永和,2023-05-12,9207
4744,皇將,13,0,13,凱基-永和,2023-05-12,9207
1101,台泥,15,4,11,凱基-永和,2023-05-12,9207
1514,亞力,10,0,10,凱基-永和,2023-05-12,9207
00632R,元大台灣50反1,10,0,10,凱基-永和,2023-05-12,9207
2504,國產,10,0,10,凱基-永和,2023-05-12,9207
2605,新興,10,0,10,凱基-永和,2023-05-12,9207
2801,彰銀,10,0,10,凱基-永和,2023-05-12,9207
3284,太普高,10,1,9,凱基-永和,2023-05-12,9207
00878,國泰永續高股息,10,2,8,凱基-永和,2023-05-12,9207
4133,亞諾法,8,0,8,凱基-永和,2023-05-12,9207
1529,樂事綠能,8,2,6,凱基-永和,2023-05-12,9207
00715L,期街口布蘭特正2,6,0,6,凱基-永和,2023-05-12,9207
2338,光罩,8,2,6,凱基-永和,2023-05-12,9207
2610,華航,6,0,6,凱基-永和,2023-05-12,9207
2887,台新金,6,0,6,凱基-永和,2023-05-12,9207
4564,元翎,5,0,5,凱基-永和,2023-05-12,9207
2303,聯電,6,1,5,凱基-永和,2023-05-12,9207
2462,良得電,5,0,5,凱基-永和,2023-05-12,9207
2882,國泰金,5,0,5,凱基-永和,2023-05-12,9207
3324,雙鴻,5,0,5,凱基-永和,2023-05-12,9207
3592,瑞鼎,5,0,5,凱基-永和,2023-05-12,9207
4763,材料-KY,11,6,5,凱基-永和,2023-05-12,9207
2888,新光金,4,0,4,凱基-永和,2023-05-12,9207
9945,潤泰新,4,0,4,凱基-永和,2023-05-12,9207
2731,雄獅,4,0,4,凱基-永和,2023-05-12,9207
3032,偉訓,4,0,4,凱基-永和,2023-05-12,9207
6605,帝寶,4,0,4,凱基-永和,2023-05-12,9207
9921,巨大,4,0,4,凱基-永和,2023-05-12,9207
2393,億光,3,0,3,凱基-永和,2023-05-12,9207
00680L,元大美債20正2,3,0,3,凱基-永和,2023-05-12,9207
00679B,元大美債20年,8,5,3,凱基-永和,2023-05-12,9207
00888,永豐台灣ESG,3,0,3,凱基-永和,2023-05-12,9207
1616,億泰,3,0,3,凱基-永和,2023-05-12,9207
2371,大同,17,14,3,凱基-永和,2023-05-12,9207
2542,興富發,3,0,3,凱基-永和,2023-05-12,9207
2915,潤泰全,3,0,3,凱基-永和,2023-05-12,9207
2303,聯電,57,0,57,凱基-永和,2023-05-15,9207
5227,立凱-KY,42,0,42,凱基-永和,2023-05-15,9207
1905,華紙,140,100,40,凱基-永和,2023-05-15,9207
2743,山富,68,35,33,凱基-永和,2023-05-15,9207
8046,南電,32,0,32,凱基-永和,2023-05-15,9207
2388,威盛,22,0,22,凱基-永和,2023-05-15,9207
3058,立德,20,0,20,凱基-永和,2023-05-15,9207
3224,三顧,20,0,20,凱基-永和,2023-05-15,9207
8222,寶一,20,2,18,凱基-永和,2023-05-15,9207
3037,欣興,18,1,17,凱基-永和,2023-05-15,9207
3481,群創,17,0,17,凱基-永和,2023-05-15,9207
1727,中華化,17,1,16,凱基-永和,2023-05-15,9207
00878,國泰永續高股息,16,0,16,凱基-永和,2023-05-15,9207
2482,連宇,12,0,12,凱基-永和,2023-05-15,9207
1104,環泥,10,0,10,凱基-永和,2023-05-15,9207
2457,飛宏,17,7,10,凱基-永和,2023-05-15,9207
4104,佳醫,10,0,10,凱基-永和,2023-05-15,9207
8011,台通,10,0,10,凱基-永和,2023-05-15,9207
5258,虹堡,14,5,9,凱基-永和,2023-05-15,9207
6214,精誠,11,2,9,凱基-永和,2023-05-15,9207
6585,鼎基,9,0,9,凱基-永和,2023-05-15,9207
3202,樺晟,14,6,8,凱基-永和,2023-05-15,9207
3231,緯創,17,9,8,凱基-永和,2023-05-15,9207
3413,京鼎,8,0,8,凱基-永和,2023-05-15,9207
6288,聯嘉,8,0,8,凱基-永和,2023-05-15,9207
00882,中信中國高股息,7,0,7,凱基-永和,2023-05-15,9207
4743,合一,8,1,7,凱基-永和,2023-05-15,9207
00637L,元大滬深300正2,7,0,7,凱基-永和,2023-05-15,9207
2393,億光,7,0,7,凱基-永和,2023-05-15,9207
2915,潤泰全,8,1,7,凱基-永和,2023-05-15,9207
00715L,期街口布蘭特正2,6,0,6,凱基-永和,2023-05-15,9207
5871,中租-KY,6,0,6,凱基-永和,2023-05-15,9207
5009,榮剛,8,2,6,凱基-永和,2023-05-15,9207
00905,FT臺灣Smart,5,0,5,凱基-永和,2023-05-15,9207
00885,富邦越南,9,4,5,凱基-永和,2023-05-15,9207
2317,鴻海,6,1,5,凱基-永和,2023-05-15,9207
2867,三商壽,5,0,5,凱基-永和,2023-05-15,9207
2883,凱基金,8,3,5,凱基-永和,2023-05-15,9207
3479,安勤,9,4,5,凱基-永和,2023-05-15,9207
4303,信立,5,0,5,凱基-永和,2023-05-15,9207
4533,協易機,5,0,5,凱基-永和,2023-05-15,9207
4729,熒茂,5,0,5,凱基-永和,2023-05-15,9207
00680L,元大美債20正2,4,0,4,凱基-永和,2023-05-15,9207
2489,瑞軒,6,2,4,凱基-永和,2023-05-15,9207
2618,長榮航,10,6,4,凱基-永和,2023-05-15,9207
3011,今皓,4,0,4,凱基-永和,2023-05-15,9207
3284,太普高,4,0,4,凱基-永和,2023-05-15,9207
3576,聯合再生,4,0,4,凱基-永和,2023-05-15,9207
3715,定穎投控,4,0,4,凱基-永和,2023-05-15,9207
6111,大宇資,4,0,4,凱基-永和,2023-05-15,9207
2371,大同,118,27,91,凱基-永和,2023-05-16,9207
3617,碩天,91,0,91,凱基-永和,2023-05-16,9207
2880,華南金,70,0,70,凱基-永和,2023-05-16,9207
00751B,元大AAA至A公司債,55,0,55,凱基-永和,2023-05-16,9207
3661,世芯-KY,40,7,33,凱基-永和,2023-05-16,9207
1727,中華化,30,0,30,凱基-永和,2023-05-16,9207
00680L,元大美債20正2,27,0,27,凱基-永和,2023-05-16,9207
5351,鈺創,25,2,23,凱基-永和,2023-05-16,9207
3058,立德,20,0,20,凱基-永和,2023-05-16,9207
00772B,中信高評級公司債,18,0,18,凱基-永和,2023-05-16,9207
2618,長榮航,35,18,17,凱基-永和,2023-05-16,9207
3703,欣陸,15,0,15,凱基-永和,2023-05-16,9207
00720B,元大投資級公司債,14,0,14,凱基-永和,2023-05-16,9207
3704,合勤控,12,0,12,凱基-永和,2023-05-16,9207
6160,欣技,124,112,12,凱基-永和,2023-05-16,9207
00687B,國泰20年美債,10,0,10,凱基-永和,2023-05-16,9207
2609,陽明,10,0,10,凱基-永和,2023-05-16,9207
4729,熒茂,10,0,10,凱基-永和,2023-05-16,9207
2323,中環,9,0,9,凱基-永和,2023-05-16,9207
6282,康舒,10,1,9,凱基-永和,2023-05-16,9207
3308,聯德,7,0,7,凱基-永和,2023-05-16,9207
3231,緯創,34,28,6,凱基-永和,2023-05-16,9207
4919,新唐,6,0,6,凱基-永和,2023-05-16,9207
6139,亞翔,8,2,6,凱基-永和,2023-05-16,9207
9905,大華,6,0,6,凱基-永和,2023-05-16,9207
00882,中信中國高股息,5,0,5,凱基-永和,2023-05-16,9207
2002,中鋼,5,0,5,凱基-永和,2023-05-16,9207
2206,三陽工業,16,11,5,凱基-永和,2023-05-16,9207
2889,國票金,5,0,5,凱基-永和,2023-05-16,9207
3003,健和興,5,0,5,凱基-永和,2023-05-16,9207
4111,濟生,5,0,5,凱基-永和,2023-05-16,9207
4564,元翎,5,0,5,凱基-永和,2023-05-16,9207
6109,亞元,5,0,5,凱基-永和,2023-05-16,9207
4967,十銓,35,31,4,凱基-永和,2023-05-16,9207
1721,三晃,4,0,4,凱基-永和,2023-05-16,9207
3035,智原,4,0,4,凱基-永和,2023-05-16,9207
4155,訊映,4,0,4,凱基-永和,2023-05-16,9207
5209,新鼎,4,0,4,凱基-永和,2023-05-16,9207
8069,元太,6,2,4,凱基-永和,2023-05-16,9207
2888,新光金,12,8,4,凱基-永和,2023-05-16,9207
2368,金像電,4,1,3,凱基-永和,2023-05-16,9207
2603,長榮,4,1,3,凱基-永和,2023-05-16,9207
00679B,元大美債20年,5,2,3,凱基-永和,2023-05-16,9207
00690,兆豐藍籌30,3,0,3,凱基-永和,2023-05-16,9207
2453,凌群,3,0,3,凱基-永和,2023-05-16,9207
3284,太普高,3,0,3,凱基-永和,2023-05-16,9207
6535,順藥,3,0,3,凱基-永和,2023-05-16,9207
8436,大江,3,0,3,凱基-永和,2023-05-16,9207
3491,昇達科,2,0,2,凱基-永和,2023-05-16,9207
1413,宏洲,2,0,2,凱基-永和,2023-05-16,9207
3037,欣興,388,25,363,凱基-永和,2023-05-17,9207
2880,華南金,70,2,68,凱基-永和,2023-05-17,9207
00632R,元大台灣50反1,60,0,60,凱基-永和,2023-05-17,9207
5258,虹堡,64,4,60,凱基-永和,2023-05-17,9207
6112,邁達特,140,80,60,凱基-永和,2023-05-17,9207
2453,凌群,50,1,49,凱基-永和,2023-05-17,9207
6243,迅杰,39,7,32,凱基-永和,2023-05-17,9207
5312,寶島科,30,0,30,凱基-永和,2023-05-17,9207
2607,榮運,25,0,25,凱基-永和,2023-05-17,9207
00878,國泰永續高股息,27,3,24,凱基-永和,2023-05-17,9207
4967,十銓,23,2,21,凱基-永和,2023-05-17,9207
6791,虎門科技,20,0,20,凱基-永和,2023-05-17,9207
6139,亞翔,12,1,11,凱基-永和,2023-05-17,9207
2603,長榮,10,0,10,凱基-永和,2023-05-17,9207
3260,威剛,10,0,10,凱基-永和,2023-05-17,9207
4163,鐿鈦,10,0,10,凱基-永和,2023-05-17,9207
6751,智聯服務,10,0,10,凱基-永和,2023-05-17,9207
6517,保勝光學,40,30,10,凱基-永和,2023-05-17,9207
00772B,中信高評級公司債,10,0,10,凱基-永和,2023-05-17,9207
2706,第一店,10,1,9,凱基-永和,2023-05-17,9207
00751B,元大AAA至A公司債,8,0,8,凱基-永和,2023-05-17,9207
2888,新光金,10,2,8,凱基-永和,2023-05-17,9207
4564,元翎,8,0,8,凱基-永和,2023-05-17,9207
00687B,國泰20年美債,8,0,8,凱基-永和,2023-05-17,9207
00671R,富邦NASDAQ反1,5,0,5,凱基-永和,2023-05-17,9207
1608,華榮,5,0,5,凱基-永和,2023-05-17,9207
2515,中工,5,0,5,凱基-永和,2023-05-17,9207
2618,長榮航,9,4,5,凱基-永和,2023-05-17,9207
3006,晶豪科,6,1,5,凱基-永和,2023-05-17,9207
3707,漢磊,5,0,5,凱基-永和,2023-05-17,9207
6109,亞元,5,0,5,凱基-永和,2023-05-17,9207
00720B,元大投資級公司債,4,0,4,凱基-永和,2023-05-17,9207
1611,中電,4,0,4,凱基-永和,2023-05-17,9207
2610,華航,5,1,4,凱基-永和,2023-05-17,9207
3454,晶睿,4,0,4,凱基-永和,2023-05-17,9207
3715,定穎投控,9,5,4,凱基-永和,2023-05-17,9207
4744,皇將,4,0,4,凱基-永和,2023-05-17,9207
2883,凱基金,4,0,4,凱基-永和,2023-05-17,9207
00725B,國泰投資級公司債,3,0,3,凱基-永和,2023-05-17,9207
00680L,元大美債20正2,3,0,3,凱基-永和,2023-05-17,9207
2356,英業達,4,1,3,凱基-永和,2023-05-17,9207
5508,永信建,3,0,3,凱基-永和,2023-05-17,9207
6160,欣技,6,3,3,凱基-永和,2023-05-17,9207
6443,元晶,3,0,3,凱基-永和,2023-05-17,9207
8940,新天地,3,0,3,凱基-永和,2023-05-17,9207
1101,台泥,4,1,3,凱基-永和,2023-05-17,9207
4121,優盛,2,0,2,凱基-永和,2023-05-17,9207
8403,盛弘,2,0,2,凱基-永和,2023-05-17,9207
2731,雄獅,4,2,2,凱基-永和,2023-05-17,9207
00857B,永豐20年美公債,2,0,2,凱基-永和,2023-05-17,9207
2888,新光金,1112,21,1091,凱基-永和,2023-05-18,9207
8996,高力,251,2,249,凱基-永和,2023-05-18,9207
9945,潤泰新,153,0,153,凱基-永和,2023-05-18,9207
2453,凌群,160,28,132,凱基-永和,2023-05-18,9207
6116,彩晶,100,0,100,凱基-永和,2023-05-18,9207
2880,華南金,70,1,69,凱基-永和,2023-05-18,9207
1609,大亞,56,12,44,凱基-永和,2023-05-18,9207
3045,台灣大,43,0,43,凱基-永和,2023-05-18,9207
2412,中華電,36,0,36,凱基-永和,2023-05-18,9207
1101,台泥,31,0,31,凱基-永和,2023-05-18,9207
2006,東和鋼鐵,28,0,28,凱基-永和,2023-05-18,9207
2457,飛宏,43,17,26,凱基-永和,2023-05-18,9207
6266,泰詠,23,0,23,凱基-永和,2023-05-18,9207
2471,資通,20,5,15,凱基-永和,2023-05-18,9207
6235,華孚,26,11,15,凱基-永和,2023-05-18,9207
4906,正文,15,2,13,凱基-永和,2023-05-18,9207
2303,聯電,20,7,13,凱基-永和,2023-05-18,9207
4916,事欣科,15,3,12,凱基-永和,2023-05-18,9207
5206,坤悅,12,0,12,凱基-永和,2023-05-18,9207
2633,台灣高鐵,11,0,11,凱基-永和,2023-05-18,9207
8261,富鼎,12,1,11,凱基-永和,2023-05-18,9207
00640L,富邦日本正2,10,0,10,凱基-永和,2023-05-18,9207
1722,台肥,10,0,10,凱基-永和,2023-05-18,9207
4123,晟德,10,0,10,凱基-永和,2023-05-18,9207
4168,醣聯,10,0,10,凱基-永和,2023-05-18,9207
6109,亞元,10,0,10,凱基-永和,2023-05-18,9207
8086,宏捷科,10,0,10,凱基-永和,2023-05-18,9207
2706,第一店,9,0,9,凱基-永和,2023-05-18,9207
3032,偉訓,10,1,9,凱基-永和,2023-05-18,9207
4919,新唐,11,2,9,凱基-永和,2023-05-18,9207
00878,國泰永續高股息,24,16,8,凱基-永和,2023-05-18,9207
00632R,元大台灣50反1,10,2,8,凱基-永和,2023-05-18,9207
2480,敦陽科,48,40,8,凱基-永和,2023-05-18,9207
2701,萬企,7,0,7,凱基-永和,2023-05-18,9207
4729,熒茂,7,0,7,凱基-永和,2023-05-18,9207
00687B,國泰20年美債,7,0,7,凱基-永和,2023-05-18,9207
1519,華城,210,204,6,凱基-永和,2023-05-18,9207
1905,華紙,8,2,6,凱基-永和,2023-05-18,9207
2371,大同,20,14,6,凱基-永和,2023-05-18,9207
2542,興富發,6,0,6,凱基-永和,2023-05-18,9207
3078,僑威,12,6,6,凱基-永和,2023-05-18,9207
3338,泰碩,6,0,6,凱基-永和,2023-05-18,9207
5425,台半,13,7,6,凱基-永和,2023-05-18,9207
00679B,元大美債20年,6,0,6,凱基-永和,2023-05-18,9207
00751B,元大AAA至A公司債,6,0,6,凱基-永和,2023-05-18,9207
00882,中信中國高股息,5,0,5,凱基-永和,2023-05-18,9207
1316,上曜,5,0,5,凱基-永和,2023-05-18,9207
1536,和大,5,0,5,凱基-永和,2023-05-18,9207
2206,三陽工業,32,27,5,凱基-永和,2023-05-18,9207
2393,億光,7,2,5,凱基-永和,2023-05-18,9207
2618,長榮航,1505,65,1440,凱基-永和,2023-05-19,9207
2888,新光金,1243,15,1228,凱基-永和,2023-05-19,9207
3163,波若威,430,6,424,凱基-永和,2023-05-19,9207
6282,康舒,384,9,375,凱基-永和,2023-05-19,9207
9945,潤泰新,123,0,123,凱基-永和,2023-05-19,9207
2739,寒舍,81,2,79,凱基-永和,2023-05-19,9207
2006,東和鋼鐵,58,0,58,凱基-永和,2023-05-19,9207
2442,新美齊,36,0,36,凱基-永和,2023-05-19,9207
00772B,中信高評級公司債,29,0,29,凱基-永和,2023-05-19,9207
00751B,元大AAA至A公司債,28,0,28,凱基-永和,2023-05-19,9207
00715L,期街口布蘭特正2,21,0,21,凱基-永和,2023-05-19,9207
2014,中鴻,20,0,20,凱基-永和,2023-05-19,9207
6182,合晶,20,3,17,凱基-永和,2023-05-19,9207
2609,陽明,20,4,16,凱基-永和,2023-05-19,9207
00679B,元大美債20年,16,0,16,凱基-永和,2023-05-19,9207
2610,華航,58,43,15,凱基-永和,2023-05-19,9207
2206,三陽工業,48,34,14,凱基-永和,2023-05-19,9207
2482,連宇,23,10,13,凱基-永和,2023-05-19,9207
00882,中信中國高股息,11,0,11,凱基-永和,2023-05-19,9207
00687B,國泰20年美債,11,0,11,凱基-永和,2023-05-19,9207
5009,榮剛,12,1,11,凱基-永和,2023-05-19,9207
6288,聯嘉,11,0,11,凱基-永和,2023-05-19,9207
3029,零壹,44,33,11,凱基-永和,2023-05-19,9207
00720B,元大投資級公司債,10,0,10,凱基-永和,2023-05-19,9207
1783,和康生,10,0,10,凱基-永和,2023-05-19,9207
2371,大同,16,6,10,凱基-永和,2023-05-19,9207
3308,聯德,10,0,10,凱基-永和,2023-05-19,9207
6109,亞元,10,0,10,凱基-永和,2023-05-19,9207
6243,迅杰,10,0,10,凱基-永和,2023-05-19,9207
8038,長園科,10,0,10,凱基-永和,2023-05-19,9207
6509,聚和,15,6,9,凱基-永和,2023-05-19,9207
6770,力積電,10,2,8,凱基-永和,2023-05-19,9207
00881,國泰台灣5G+,8,0,8,凱基-永和,2023-05-19,9207
3615,安可,8,0,8,凱基-永和,2023-05-19,9207
3715,定穎投控,9,1,8,凱基-永和,2023-05-19,9207
6443,元晶,8,0,8,凱基-永和,2023-05-19,9207
3038,全台,10,3,7,凱基-永和,2023-05-19,9207
00637L,元大滬深300正2,7,1,6,凱基-永和,2023-05-19,9207
1609,大亞,7,1,6,凱基-永和,2023-05-19,9207
1616,億泰,6,0,6,凱基-永和,2023-05-19,9207
3450,聯鈞,6,0,6,凱基-永和,2023-05-19,9207
1504,東元,21,16,5,凱基-永和,2023-05-19,9207
00682U,期元大美元指數,5,0,5,凱基-永和,2023-05-19,9207
2393,億光,5,0,5,凱基-永和,2023-05-19,9207
3224,三顧,5,0,5,凱基-永和,2023-05-19,9207
4728,雙美,5,0,5,凱基-永和,2023-05-19,9207
4744,皇將,5,0,5,凱基-永和,2023-05-19,9207
5309,系統電,5,0,5,凱基-永和,2023-05-19,9207
5371,中光電,5,0,5,凱基-永和,2023-05-19,9207
5521,工信,5,0,5,凱基-永和,2023-05-19,9207
2201,裕隆,928,13,915,凱基-永和,2023-05-22,9207
1608,華榮,133,6,127,凱基-永和,2023-05-22,9207
2303,聯電,101,6,95,凱基-永和,2023-05-22,9207
1905,華紙,100,8,92,凱基-永和,2023-05-22,9207
2915,潤泰全,80,1,79,凱基-永和,2023-05-22,9207
2442,新美齊,305,237,68,凱基-永和,2023-05-22,9207
6535,順藥,62,0,62,凱基-永和,2023-05-22,9207
3178,公準,33,1,32,凱基-永和,2023-05-22,9207
00751B,元大AAA至A公司債,24,0,24,凱基-永和,2023-05-22,9207
3037,欣興,36,15,21,凱基-永和,2023-05-22,9207
6282,康舒,125,106,19,凱基-永和,2023-05-22,9207
6138,茂達,15,0,15,凱基-永和,2023-05-22,9207
1314,中石化,12,0,12,凱基-永和,2023-05-22,9207
00687B,國泰20年美債,12,0,12,凱基-永和,2023-05-22,9207
6288,聯嘉,11,0,11,凱基-永和,2023-05-22,9207
00706L,期元大S＆P日圓正2,10,0,10,凱基-永和,2023-05-22,9207
2323,中環,12,2,10,凱基-永和,2023-05-22,9207
2406,國碩,10,0,10,凱基-永和,2023-05-22,9207
2427,三商電,11,1,10,凱基-永和,2023-05-22,9207
2515,中工,20,10,10,凱基-永和,2023-05-22,9207
2913,農林,10,0,10,凱基-永和,2023-05-22,9207
3038,全台,10,0,10,凱基-永和,2023-05-22,9207
6509,聚和,9,0,9,凱基-永和,2023-05-22,9207
4137,麗豐-KY,8,0,8,凱基-永和,2023-05-22,9207
6770,力積電,8,0,8,凱基-永和,2023-05-22,9207
8097,常珵,7,0,7,凱基-永和,2023-05-22,9207
2301,光寶科,7,1,6,凱基-永和,2023-05-22,9207
6139,亞翔,6,0,6,凱基-永和,2023-05-22,9207
3189,景碩,10,4,6,凱基-永和,2023-05-22,9207
3479,安勤,5,0,5,凱基-永和,2023-05-22,9207
1444,力麗,5,0,5,凱基-永和,2023-05-22,9207
2542,興富發,5,0,5,凱基-永和,2023-05-22,9207
3706,神達,6,1,5,凱基-永和,2023-05-22,9207
5905,南仁湖,5,0,5,凱基-永和,2023-05-22,9207
6160,欣技,5,0,5,凱基-永和,2023-05-22,9207
6271,同欣電,5,0,5,凱基-永和,2023-05-22,9207
6548,長科*,5,0,5,凱基-永和,2023-05-22,9207
8086,宏捷科,5,0,5,凱基-永和,2023-05-22,9207
00715L,期街口布蘭特正2,4,0,4,凱基-永和,2023-05-22,9207
2609,陽明,5,1,4,凱基-永和,2023-05-22,9207
6023,元大期,4,0,4,凱基-永和,2023-05-22,9207
6112,邁達特,6,2,4,凱基-永和,2023-05-22,9207
6235,華孚,4,0,4,凱基-永和,2023-05-22,9207
8222,寶一,8,4,4,凱基-永和,2023-05-22,9207
1432,大魯閣,3,0,3,凱基-永和,2023-05-22,9207
00679B,元大美債20年,3,0,3,凱基-永和,2023-05-22,9207
2313,華通,3,0,3,凱基-永和,2023-05-22,9207
2337,旺宏,3,0,3,凱基-永和,2023-05-22,9207
2356,英業達,3,0,3,凱基-永和,2023-05-22,9207
2457,飛宏,7,4,3,凱基-永和,2023-05-22,9207
8996,高力,211,1,210,凱基-永和,2023-05-23,9207
3163,波若威,193,74,119,凱基-永和,2023-05-23,9207
3205,佰研,111,1,110,凱基-永和,2023-05-23,9207
2344,華邦電,87,0,87,凱基-永和,2023-05-23,9207
2611,志信,60,0,60,凱基-永和,2023-05-23,9207
3661,世芯-KY,57,0,57,凱基-永和,2023-05-23,9207
8940,新天地,50,0,50,凱基-永和,2023-05-23,9207
6288,聯嘉,47,3,44,凱基-永和,2023-05-23,9207
2913,農林,50,10,40,凱基-永和,2023-05-23,9207
00720B,元大投資級公司債,34,0,34,凱基-永和,2023-05-23,9207
5703,亞都,30,3,27,凱基-永和,2023-05-23,9207
3029,零壹,27,1,26,凱基-永和,2023-05-23,9207
00772B,中信高評級公司債,26,0,26,凱基-永和,2023-05-23,9207
2915,潤泰全,28,5,23,凱基-永和,2023-05-23,9207
1304,台聚,20,0,20,凱基-永和,2023-05-23,9207
2014,中鴻,20,0,20,凱基-永和,2023-05-23,9207
5284,jpp-KY,97,77,20,凱基-永和,2023-05-23,9207
6109,亞元,19,0,19,凱基-永和,2023-05-23,9207
2482,連宇,18,0,18,凱基-永和,2023-05-23,9207
00878,國泰永續高股息,16,0,16,凱基-永和,2023-05-23,9207
2706,第一店,15,0,15,凱基-永和,2023-05-23,9207
6160,欣技,22,7,15,凱基-永和,2023-05-23,9207
00687B,國泰20年美債,13,0,13,凱基-永和,2023-05-23,9207
5531,鄉林,14,1,13,凱基-永和,2023-05-23,9207
1460,宏遠,12,0,12,凱基-永和,2023-05-23,9207
3479,安勤,11,0,11,凱基-永和,2023-05-23,9207
1528,恩德,10,0,10,凱基-永和,2023-05-23,9207
2314,台揚,10,0,10,凱基-永和,2023-05-23,9207
3260,威剛,10,0,10,凱基-永和,2023-05-23,9207
4973,廣穎,10,0,10,凱基-永和,2023-05-23,9207
6138,茂達,10,0,10,凱基-永和,2023-05-23,9207
6205,詮欣,10,1,9,凱基-永和,2023-05-23,9207
2897,王道銀行,9,0,9,凱基-永和,2023-05-23,9207
2330,台積電,10,2,8,凱基-永和,2023-05-23,9207
2449,京元電子,7,0,7,凱基-永和,2023-05-23,9207
9105,泰金寶-DR,7,0,7,凱基-永和,2023-05-23,9207
00882,中信中國高股息,6,0,6,凱基-永和,2023-05-23,9207
1101,台泥,8,2,6,凱基-永和,2023-05-23,9207
2399,映泰,7,1,6,凱基-永和,2023-05-23,9207
2903,遠百,6,0,6,凱基-永和,2023-05-23,9207
00679B,元大美債20年,12,7,5,凱基-永和,2023-05-23,9207
00632R,元大台灣50反1,5,0,5,凱基-永和,2023-05-23,9207
00706L,期元大S＆P日圓正2,5,0,5,凱基-永和,2023-05-23,9207
2027,大成鋼,5,0,5,凱基-永和,2023-05-23,9207
2421,建準,5,0,5,凱基-永和,2023-05-23,9207
2809,京城銀,5,0,5,凱基-永和,2023-05-23,9207
3481,群創,5,0,5,凱基-永和,2023-05-23,9207
4543,萬在,5,0,5,凱基-永和,2023-05-23,9207
5469,瀚宇博,5,0,5,凱基-永和,2023-05-23,9207
6164,華興,5,0,5,凱基-永和,2023-05-23,9207
6282,康舒,202,13,189,凱基-永和,2023-05-24,9207
8996,高力,161,1,160,凱基-永和,2023-05-24,9207
2344,華邦電,100,26,74,凱基-永和,2023-05-24,9207
2618,長榮航,129,67,62,凱基-永和,2023-05-24,9207
2442,新美齊,84,33,51,凱基-永和,2023-05-24,9207
2722,夏都,51,0,51,凱基-永和,2023-05-24,9207
1727,中華化,51,1,50,凱基-永和,2023-05-24,9207
2882,國泰金,29,2,27,凱基-永和,2023-05-24,9207
2712,遠雄來,50,25,25,凱基-永和,2023-05-24,9207
3105,穩懋,24,0,24,凱基-永和,2023-05-24,9207
00882,中信中國高股息,20,0,20,凱基-永和,2023-05-24,9207
2204,中華,20,0,20,凱基-永和,2023-05-24,9207
3163,波若威,20,0,20,凱基-永和,2023-05-24,9207
5258,虹堡,20,5,15,凱基-永和,2023-05-24,9207
1513,中興電,19,5,14,凱基-永和,2023-05-24,9207
00632R,元大台灣50反1,12,0,12,凱基-永和,2023-05-24,9207
00712,復華富時不動產,12,0,12,凱基-永和,2023-05-24,9207
2338,光罩,11,0,11,凱基-永和,2023-05-24,9207
3034,聯詠,10,0,10,凱基-永和,2023-05-24,9207
00795B,中信美國公債20年,10,0,10,凱基-永和,2023-05-24,9207
1514,亞力,11,1,10,凱基-永和,2023-05-24,9207
4566,時碩工業,10,0,10,凱基-永和,2023-05-24,9207
5351,鈺創,10,0,10,凱基-永和,2023-05-24,9207
6125,廣運,10,0,10,凱基-永和,2023-05-24,9207
1905,華紙,9,0,9,凱基-永和,2023-05-24,9207
2913,農林,10,1,9,凱基-永和,2023-05-24,9207
2017,官田鋼,8,0,8,凱基-永和,2023-05-24,9207
2706,第一店,15,7,8,凱基-永和,2023-05-24,9207
00893,國泰智能電動車,7,0,7,凱基-永和,2023-05-24,9207
2886,兆豐金,6,0,6,凱基-永和,2023-05-24,9207
2634,漢翔,12,6,6,凱基-永和,2023-05-24,9207
3003,健和興,7,1,6,凱基-永和,2023-05-24,9207
2328,廣宇,10,5,5,凱基-永和,2023-05-24,9207
00706L,期元大S＆P日圓正2,5,0,5,凱基-永和,2023-05-24,9207
2421,建準,8,3,5,凱基-永和,2023-05-24,9207
2427,三商電,5,0,5,凱基-永和,2023-05-24,9207
3021,鴻名,5,0,5,凱基-永和,2023-05-24,9207
4129,聯合,5,0,5,凱基-永和,2023-05-24,9207
4746,台耀,7,2,5,凱基-永和,2023-05-24,9207
4919,新唐,5,0,5,凱基-永和,2023-05-24,9207
6168,宏齊,5,0,5,凱基-永和,2023-05-24,9207
8011,台通,5,0,5,凱基-永和,2023-05-24,9207
2881,富邦金,4,0,4,凱基-永和,2023-05-24,9207
4527,方土霖,4,0,4,凱基-永和,2023-05-24,9207
1101,台泥,3,0,3,凱基-永和,2023-05-24,9207
00637L,元大滬深300正2,3,0,3,凱基-永和,2023-05-24,9207
00772B,中信高評級公司債,3,0,3,凱基-永和,2023-05-24,9207
1709,和益,3,0,3,凱基-永和,2023-05-24,9207
2719,燦星旅,3,0,3,凱基-永和,2023-05-24,9207
2845,遠東銀,3,0,3,凱基-永和,2023-05-24,9207
3231,緯創,1321,328,993,凱基-永和,2023-05-25,9207
3017,奇鋐,361,42,319,凱基-永和,2023-05-25,9207
1608,華榮,412,201,211,凱基-永和,2023-05-25,9207
2915,潤泰全,190,1,189,凱基-永和,2023-05-25,9207
2323,中環,150,7,143,凱基-永和,2023-05-25,9207
1795,美時,86,2,84,凱基-永和,2023-05-25,9207
00882,中信中國高股息,54,1,53,凱基-永和,2023-05-25,9207
5512,力麒,50,0,50,凱基-永和,2023-05-25,9207
2421,建準,47,3,44,凱基-永和,2023-05-25,9207
3025,星通,42,1,41,凱基-永和,2023-05-25,9207
3308,聯德,33,0,33,凱基-永和,2023-05-25,9207
6727,亞泰金屬,30,0,30,凱基-永和,2023-05-25,9207
3264,欣銓,29,0,29,凱基-永和,2023-05-25,9207
8155,博智,42,21,21,凱基-永和,2023-05-25,9207
00637L,元大滬深300正2,18,0,18,凱基-永和,2023-05-25,9207
5258,虹堡,18,0,18,凱基-永和,2023-05-25,9207
2881,富邦金,18,1,17,凱基-永和,2023-05-25,9207
8069,元太,23,6,17,凱基-永和,2023-05-25,9207
1442,名軒,17,0,17,凱基-永和,2023-05-25,9207
2006,東和鋼鐵,16,0,16,凱基-永和,2023-05-25,9207
2388,威盛,15,0,15,凱基-永和,2023-05-25,9207
00752,中信中國50,15,0,15,凱基-永和,2023-05-25,9207
3693,營邦,14,0,14,凱基-永和,2023-05-25,9207
2882,國泰金,14,0,14,凱基-永和,2023-05-25,9207
6245,立端,13,0,13,凱基-永和,2023-05-25,9207
5905,南仁湖,12,0,12,凱基-永和,2023-05-25,9207
3037,欣興,20,8,12,凱基-永和,2023-05-25,9207
2603,長榮,12,1,11,凱基-永和,2023-05-25,9207
00632R,元大台灣50反1,10,0,10,凱基-永和,2023-05-25,9207
00712,復華富時不動產,10,0,10,凱基-永和,2023-05-25,9207
1905,華紙,10,0,10,凱基-永和,2023-05-25,9207
3032,偉訓,10,0,10,凱基-永和,2023-05-25,9207
4543,萬在,10,0,10,凱基-永和,2023-05-25,9207
6188,廣明,10,0,10,凱基-永和,2023-05-25,9207
2034,允強,10,0,10,凱基-永和,2023-05-25,9207
1513,中興電,13,3,10,凱基-永和,2023-05-25,9207
00878,國泰永續高股息,10,1,9,凱基-永和,2023-05-25,9207
00751B,元大AAA至A公司債,9,0,9,凱基-永和,2023-05-25,9207
3006,晶豪科,15,6,9,凱基-永和,2023-05-25,9207
1589,永冠-KY,8,0,8,凱基-永和,2023-05-25,9207
2371,大同,8,0,8,凱基-永和,2023-05-25,9207
2883,凱基金,8,0,8,凱基-永和,2023-05-25,9207
00679B,元大美債20年,9,2,7,凱基-永和,2023-05-25,9207
3284,太普高,7,0,7,凱基-永和,2023-05-25,9207
2630,亞航,13,7,6,凱基-永和,2023-05-25,9207
2888,新光金,6,0,6,凱基-永和,2023-05-25,9207
4729,熒茂,6,0,6,凱基-永和,2023-05-25,9207
6643,M31,6,0,6,凱基-永和,2023-05-25,9207
2457,飛宏,8,3,5,凱基-永和,2023-05-25,9207
2886,兆豐金,5,0,5,凱基-永和,2023-05-25,9207
3037,欣興,222,41,181,凱基-永和,2023-05-26,9207
4979,華星光,153,13,140,凱基-永和,2023-05-26,9207
2610,華航,119,18,101,凱基-永和,2023-05-26,9207
3443,創意,51,1,50,凱基-永和,2023-05-26,9207
3540,曜越,50,0,50,凱基-永和,2023-05-26,9207
00712,復華富時不動產,44,0,44,凱基-永和,2023-05-26,9207
2915,潤泰全,42,0,42,凱基-永和,2023-05-26,9207
3093,港建*,40,0,40,凱基-永和,2023-05-26,9207
3363,上詮,59,30,29,凱基-永和,2023-05-26,9207
3481,群創,28,0,28,凱基-永和,2023-05-26,9207
2103,台橡,25,0,25,凱基-永和,2023-05-26,9207
2515,中工,25,0,25,凱基-永和,2023-05-26,9207
2471,資通,74,50,24,凱基-永和,2023-05-26,9207
2425,承啟,39,18,21,凱基-永和,2023-05-26,9207
6191,精成科,20,0,20,凱基-永和,2023-05-26,9207
2492,華新科,20,0,20,凱基-永和,2023-05-26,9207
2883,凱基金,19,0,19,凱基-永和,2023-05-26,9207
00632R,元大台灣50反1,18,0,18,凱基-永和,2023-05-26,9207
3006,晶豪科,18,0,18,凱基-永和,2023-05-26,9207
2881,富邦金,19,2,17,凱基-永和,2023-05-26,9207
4729,熒茂,15,0,15,凱基-永和,2023-05-26,9207
2376,技嘉,69,55,14,凱基-永和,2023-05-26,9207
00882,中信中國高股息,12,0,12,凱基-永和,2023-05-26,9207
00679B,元大美債20年,14,2,12,凱基-永和,2023-05-26,9207
2736,富野,20,8,12,凱基-永和,2023-05-26,9207
4746,台耀,12,0,12,凱基-永和,2023-05-26,9207
2617,台航,11,0,11,凱基-永和,2023-05-26,9207
3715,定穎投控,11,0,11,凱基-永和,2023-05-26,9207
1907,永豐餘,10,0,10,凱基-永和,2023-05-26,9207
2105,正新,10,0,10,凱基-永和,2023-05-26,9207
2706,第一店,10,0,10,凱基-永和,2023-05-26,9207
4432,銘旺實,10,0,10,凱基-永和,2023-05-26,9207
5206,坤悅,10,0,10,凱基-永和,2023-05-26,9207
6415,矽力*-KY,10,0,10,凱基-永和,2023-05-26,9207
5258,虹堡,9,0,9,凱基-永和,2023-05-26,9207
2606,裕民,9,0,9,凱基-永和,2023-05-26,9207
00725B,國泰投資級公司債,8,0,8,凱基-永和,2023-05-26,9207
1316,上曜,8,0,8,凱基-永和,2023-05-26,9207
1513,中興電,9,1,8,凱基-永和,2023-05-26,9207
2548,華固,8,0,8,凱基-永和,2023-05-26,9207
2614,東森,8,1,7,凱基-永和,2023-05-26,9207
2023,燁輝,7,0,7,凱基-永和,2023-05-26,9207
3036,文曄,7,1,6,凱基-永和,2023-05-26,9207
3035,智原,6,0,6,凱基-永和,2023-05-26,9207
2382,廣達,9,4,5,凱基-永和,2023-05-26,9207
2317,鴻海,5,0,5,凱基-永和,2023-05-26,9207
00795B,中信美國公債20年,5,0,5,凱基-永和,2023-05-26,9207
00857B,永豐20年美公債,5,0,5,凱基-永和,2023-05-26,9207
00671R,富邦NASDAQ反1,5,0,5,凱基-永和,2023-05-26,9207
2453,凌群,32,27,5,凱基-永和,2023-05-26,9207
2888,新光金,924,6,918,凱基-永和,2023-05-29,9207
6282,康舒,1279,497,782,凱基-永和,2023-05-29,9207
3032,偉訓,634,132,502,凱基-永和,2023-05-29,9207
1905,華紙,150,7,143,凱基-永和,2023-05-29,9207
2388,威盛,154,20,134,凱基-永和,2023-05-29,9207
6125,廣運,100,2,98,凱基-永和,2023-05-29,9207
00650L,復華香港正2,47,0,47,凱基-永和,2023-05-29,9207
3443,創意,35,0,35,凱基-永和,2023-05-29,9207
00687B,國泰20年美債,33,0,33,凱基-永和,2023-05-29,9207
00882,中信中國高股息,43,10,33,凱基-永和,2023-05-29,9207
8054,安國,33,0,33,凱基-永和,2023-05-29,9207
9945,潤泰新,30,0,30,凱基-永和,2023-05-29,9207
6244,茂迪,31,1,30,凱基-永和,2023-05-29,9207
6443,元晶,31,8,23,凱基-永和,2023-05-29,9207
1460,宏遠,22,0,22,凱基-永和,2023-05-29,9207
4432,銘旺實,20,0,20,凱基-永和,2023-05-29,9207
2345,智邦,20,1,19,凱基-永和,2023-05-29,9207
00715L,期街口布蘭特正2,20,3,17,凱基-永和,2023-05-29,9207
1589,永冠-KY,15,0,15,凱基-永和,2023-05-29,9207
2548,華固,15,0,15,凱基-永和,2023-05-29,9207
2495,普安,19,6,13,凱基-永和,2023-05-29,9207
1314,中石化,13,0,13,凱基-永和,2023-05-29,9207
5706,鳳凰,14,1,13,凱基-永和,2023-05-29,9207
2103,台橡,12,0,12,凱基-永和,2023-05-29,9207
3206,志豐,12,0,12,凱基-永和,2023-05-29,9207
3363,上詮,12,0,12,凱基-永和,2023-05-29,9207
0056,元大高股息,16,5,11,凱基-永和,2023-05-29,9207
3105,穩懋,11,0,11,凱基-永和,2023-05-29,9207
4147,中裕,11,0,11,凱基-永和,2023-05-29,9207
8069,元太,13,3,10,凱基-永和,2023-05-29,9207
00640L,富邦日本正2,10,0,10,凱基-永和,2023-05-29,9207
00706L,期元大S＆P日圓正2,10,0,10,凱基-永和,2023-05-29,9207
9904,寶成,10,0,10,凱基-永和,2023-05-29,9207
1442,名軒,10,0,10,凱基-永和,2023-05-29,9207
6138,茂達,10,1,9,凱基-永和,2023-05-29,9207
3704,合勤控,10,1,9,凱基-永和,2023-05-29,9207
4729,熒茂,9,0,9,凱基-永和,2023-05-29,9207
4744,皇將,13,4,9,凱基-永和,2023-05-29,9207
3661,世芯-KY,50,42,8,凱基-永和,2023-05-29,9207
2323,中環,13,6,7,凱基-永和,2023-05-29,9207
2303,聯電,23,16,7,凱基-永和,2023-05-29,9207
5206,坤悅,7,0,7,凱基-永和,2023-05-29,9207
00751B,元大AAA至A公司債,6,0,6,凱基-永和,2023-05-29,9207
00772B,中信高評級公司債,6,0,6,凱基-永和,2023-05-29,9207
2006,東和鋼鐵,6,0,6,凱基-永和,2023-05-29,9207
2353,宏��,5,0,5,凱基-永和,2023-05-29,9207
00878,國泰永續高股息,6,1,5,凱基-永和,2023-05-29,9207
2392,正崴,5,0,5,凱基-永和,2023-05-29,9207
2412,中華電,5,0,5,凱基-永和,2023-05-29,9207
2453,凌群,5,0,5,凱基-永和,2023-05-29,9207
2618,長榮航,142,35,107,凱基-永和,2023-05-30,9207
9945,潤泰新,82,3,79,凱基-永和,2023-05-30,9207
2344,華邦電,59,7,52,凱基-永和,2023-05-30,9207
3661,世芯-KY,53,11,42,凱基-永和,2023-05-30,9207
00882,中信中國高股息,41,0,41,凱基-永和,2023-05-30,9207
6160,欣技,90,51,39,凱基-永和,2023-05-30,9207
00679B,元大美債20年,28,0,28,凱基-永和,2023-05-30,9207
2356,英業達,71,45,26,凱基-永和,2023-05-30,9207
3037,欣興,32,6,26,凱基-永和,2023-05-30,9207
2204,中華,24,2,22,凱基-永和,2023-05-30,9207
4729,熒茂,20,0,20,凱基-永和,2023-05-30,9207
6770,力積電,26,7,19,凱基-永和,2023-05-30,9207
2548,華固,19,0,19,凱基-永和,2023-05-30,9207
2474,可成,16,0,16,凱基-永和,2023-05-30,9207
5328,華容,15,1,14,凱基-永和,2023-05-30,9207
2801,彰銀,12,0,12,凱基-永和,2023-05-30,9207
2103,台橡,10,0,10,凱基-永和,2023-05-30,9207
1316,上曜,10,0,10,凱基-永和,2023-05-30,9207
00632R,元大台灣50反1,25,15,10,凱基-永和,2023-05-30,9207
2323,中環,17,7,10,凱基-永和,2023-05-30,9207
5465,富驊,10,0,10,凱基-永和,2023-05-30,9207
6248,沛波,10,0,10,凱基-永和,2023-05-30,9207
00878,國泰永續高股息,50,41,9,凱基-永和,2023-05-30,9207
2206,三陽工業,13,4,9,凱基-永和,2023-05-30,9207
2329,華泰,8,0,8,凱基-永和,2023-05-30,9207
3706,神達,9,2,7,凱基-永和,2023-05-30,9207
2371,大同,24,18,6,凱基-永和,2023-05-30,9207
6516,勤崴國際,6,0,6,凱基-永和,2023-05-30,9207
1460,宏遠,5,0,5,凱基-永和,2023-05-30,9207
3022,威強電,5,0,5,凱基-永和,2023-05-30,9207
3205,佰研,5,0,5,凱基-永和,2023-05-30,9207
3231,緯創,34,29,5,凱基-永和,2023-05-30,9207
3346,麗清,5,0,5,凱基-永和,2023-05-30,9207
4915,致伸,5,0,5,凱基-永和,2023-05-30,9207
1589,永冠-KY,5,0,5,凱基-永和,2023-05-30,9207
6285,啟��,4,0,4,凱基-永和,2023-05-30,9207
6509,聚和,4,0,4,凱基-永和,2023-05-30,9207
8076,伍豐,6,2,4,凱基-永和,2023-05-30,9207
8155,博智,4,0,4,凱基-永和,2023-05-30,9207
8478,東哥遊艇,4,0,4,凱基-永和,2023-05-30,9207
2382,廣達,50,46,4,凱基-永和,2023-05-30,9207
2637,慧洋-KY,4,0,4,凱基-永和,2023-05-30,9207
2327,國巨,4,1,3,凱基-永和,2023-05-30,9207
00680L,元大美債20正2,3,0,3,凱基-永和,2023-05-30,9207
00665L,富邦�琤肭磪囓�2,3,0,3,凱基-永和,2023-05-30,9207
00687B,國泰20年美債,3,0,3,凱基-永和,2023-05-30,9207
1605,華新,3,0,3,凱基-永和,2023-05-30,9207
2006,東和鋼鐵,3,0,3,凱基-永和,2023-05-30,9207
2031,新光鋼,3,0,3,凱基-永和,2023-05-30,9207
2324,仁寶,4,1,3,凱基-永和,2023-05-30,9207
2888,新光金,946,0,946,凱基-永和,2023-05-31,9207
2515,中工,1010,110,900,凱基-永和,2023-05-31,9207
2323,中環,499,19,480,凱基-永和,2023-05-31,9207
8088,品安,204,5,199,凱基-永和,2023-05-31,9207
3260,威剛,226,79,147,凱基-永和,2023-05-31,9207
4129,聯合,199,76,123,凱基-永和,2023-05-31,9207
2734,易飛網,102,0,102,凱基-永和,2023-05-31,9207
3252,海灣,100,0,100,凱基-永和,2023-05-31,9207
8277,商丞,100,0,100,凱基-永和,2023-05-31,9207
5706,鳳凰,101,4,97,凱基-永和,2023-05-31,9207
2722,夏都,71,2,69,凱基-永和,2023-05-31,9207
6770,力積電,60,0,60,凱基-永和,2023-05-31,9207
5243,乙盛-KY,36,4,32,凱基-永和,2023-05-31,9207
8271,宇瞻,30,0,30,凱基-永和,2023-05-31,9207
2356,英業達,33,11,22,凱基-永和,2023-05-31,9207
1519,華城,26,5,21,凱基-永和,2023-05-31,9207
6140,訊達,20,0,20,凱基-永和,2023-05-31,9207
00642U,期元大S＆P石油,18,0,18,凱基-永和,2023-05-31,9207
3058,立德,18,0,18,凱基-永和,2023-05-31,9207
8059,凱碩,17,0,17,凱基-永和,2023-05-31,9207
00878,國泰永續高股息,17,1,16,凱基-永和,2023-05-31,9207
00715L,期街口布蘭特正2,16,0,16,凱基-永和,2023-05-31,9207
4729,熒茂,16,0,16,凱基-永和,2023-05-31,9207
00680L,元大美債20正2,13,0,13,凱基-永和,2023-05-31,9207
5534,長虹,12,0,12,凱基-永和,2023-05-31,9207
2401,凌陽,11,0,11,凱基-永和,2023-05-31,9207
00882,中信中國高股息,10,0,10,凱基-永和,2023-05-31,9207
1528,恩德,10,0,10,凱基-永和,2023-05-31,9207
2706,第一店,10,0,10,凱基-永和,2023-05-31,9207
3029,零壹,10,0,10,凱基-永和,2023-05-31,9207
3583,辛耘,10,0,10,凱基-永和,2023-05-31,9207
4755,三福化,10,0,10,凱基-永和,2023-05-31,9207
5876,上海商銀,10,0,10,凱基-永和,2023-05-31,9207
3704,合勤控,9,0,9,凱基-永和,2023-05-31,9207
6516,勤崴國際,8,0,8,凱基-永和,2023-05-31,9207
00679B,元大美債20年,8,0,8,凱基-永和,2023-05-31,9207
2006,東和鋼鐵,8,0,8,凱基-永和,2023-05-31,9207
4916,事欣科,9,1,8,凱基-永和,2023-05-31,9207
00687B,國泰20年美債,7,0,7,凱基-永和,2023-05-31,9207
1608,華榮,7,0,7,凱基-永和,2023-05-31,9207
2382,廣達,16,9,7,凱基-永和,2023-05-31,9207
2421,建準,18,11,7,凱基-永和,2023-05-31,9207
3711,日月光投控,7,0,7,凱基-永和,2023-05-31,9207
2739,寒舍,6,0,6,凱基-永和,2023-05-31,9207
8210,勤誠,7,1,6,凱基-永和,2023-05-31,9207
3037,欣興,8,3,5,凱基-永和,2023-05-31,9207
1609,大亞,13,8,5,凱基-永和,2023-05-31,9207
4123,晟德,5,0,5,凱基-永和,2023-05-31,9207
4533,協易機,5,0,5,凱基-永和,2023-05-31,9207
4566,時碩工業,5,0,5,凱基-永和,2023-05-31,9207
2888,新光金,460,0,460,凱基-永和,2023-06-01,9207
1905,華紙,303,18,285,凱基-永和,2023-06-01,9207
4979,華星光,195,64,131,凱基-永和,2023-06-01,9207
1727,中華化,312,208,104,凱基-永和,2023-06-01,9207
2486,一詮,100,0,100,凱基-永和,2023-06-01,9207
3363,上詮,100,1,99,凱基-永和,2023-06-01,9207
2344,華邦電,44,1,43,凱基-永和,2023-06-01,9207
2892,第一金,24,0,24,凱基-永和,2023-06-01,9207
2303,聯電,40,17,23,凱基-永和,2023-06-01,9207
00878,國泰永續高股息,23,1,22,凱基-永和,2023-06-01,9207
2882,國泰金,22,0,22,凱基-永和,2023-06-01,9207
00680L,元大美債20正2,20,0,20,凱基-永和,2023-06-01,9207
2489,瑞軒,422,402,20,凱基-永和,2023-06-01,9207
3029,零壹,22,2,20,凱基-永和,2023-06-01,9207
4128,中天,20,0,20,凱基-永和,2023-06-01,9207
3481,群創,20,2,18,凱基-永和,2023-06-01,9207
6288,聯嘉,16,0,16,凱基-永和,2023-06-01,9207
3094,聯傑,15,0,15,凱基-永和,2023-06-01,9207
00882,中信中國高股息,14,0,14,凱基-永和,2023-06-01,9207
00715L,期街口布蘭特正2,14,0,14,凱基-永和,2023-06-01,9207
00642U,期元大S＆P石油,13,0,13,凱基-永和,2023-06-01,9207
2883,凱基金,13,0,13,凱基-永和,2023-06-01,9207
2371,大同,20,7,13,凱基-永和,2023-06-01,9207
3661,世芯-KY,12,0,12,凱基-永和,2023-06-01,9207
6190,萬泰科,14,3,11,凱基-永和,2023-06-01,9207
2485,兆赫,10,0,10,凱基-永和,2023-06-01,9207
3025,星通,10,0,10,凱基-永和,2023-06-01,9207
4123,晟德,15,5,10,凱基-永和,2023-06-01,9207
4729,熒茂,10,0,10,凱基-永和,2023-06-01,9207
6111,大宇資,30,20,10,凱基-永和,2023-06-01,9207
6456,GIS-KY,10,0,10,凱基-永和,2023-06-01,9207
3038,全台,10,1,9,凱基-永和,2023-06-01,9207
3051,力特,10,1,9,凱基-永和,2023-06-01,9207
00679B,元大美債20年,7,0,7,凱基-永和,2023-06-01,9207
5478,智冠,27,20,7,凱基-永和,2023-06-01,9207
8021,尖點,7,0,7,凱基-永和,2023-06-01,9207
00772B,中信高評級公司債,6,0,6,凱基-永和,2023-06-01,9207
2412,中華電,6,0,6,凱基-永和,2023-06-01,9207
2460,建通,6,0,6,凱基-永和,2023-06-01,9207
00643,群益深証中小,5,0,5,凱基-永和,2023-06-01,9207
00902,中信電池及儲能,5,0,5,凱基-永和,2023-06-01,9207
2538,基泰,5,0,5,凱基-永和,2023-06-01,9207
3380,明泰,5,0,5,凱基-永和,2023-06-01,9207
3454,晶睿,5,0,5,凱基-永和,2023-06-01,9207
6269,台郡,5,0,5,凱基-永和,2023-06-01,9207
9933,中鼎,5,0,5,凱基-永和,2023-06-01,9207
2881,富邦金,5,1,4,凱基-永和,2023-06-01,9207
3013,晟銘電,15,11,4,凱基-永和,2023-06-01,9207
00795B,中信美國公債20年,4,0,4,凱基-永和,2023-06-01,9207
1218,泰山,4,0,4,凱基-永和,2023-06-01,9207
2353,宏��,608,210,398,凱基-永和,2023-06-02,9207
6167,久正,399,7,392,凱基-永和,2023-06-02,9207
8996,高力,295,0,295,凱基-永和,2023-06-02,9207
2425,承啟,267,155,112,凱基-永和,2023-06-02,9207
2402,毅嘉,111,4,107,凱基-永和,2023-06-02,9207
3324,雙鴻,124,19,105,凱基-永和,2023-06-02,9207
6125,廣運,102,1,101,凱基-永和,2023-06-02,9207
2610,華航,119,23,96,凱基-永和,2023-06-02,9207
2436,偉詮電,58,0,58,凱基-永和,2023-06-02,9207
5386,青雲,50,0,50,凱基-永和,2023-06-02,9207
1721,三晃,30,0,30,凱基-永和,2023-06-02,9207
00885,富邦越南,22,0,22,凱基-永和,2023-06-02,9207
00919,群益台灣精選高息,31,10,21,凱基-永和,2023-06-02,9207
3094,聯傑,25,4,21,凱基-永和,2023-06-02,9207
2031,新光鋼,20,0,20,凱基-永和,2023-06-02,9207
2323,中環,26,6,20,凱基-永和,2023-06-02,9207
6138,茂達,16,0,16,凱基-永和,2023-06-02,9207
3231,緯創,125,110,15,凱基-永和,2023-06-02,9207
2104,國際中橡,15,0,15,凱基-永和,2023-06-02,9207
2515,中工,21,7,14,凱基-永和,2023-06-02,9207
1529,樂事綠能,13,0,13,凱基-永和,2023-06-02,9207
1734,杏輝,14,1,13,凱基-永和,2023-06-02,9207
6770,力積電,12,0,12,凱基-永和,2023-06-02,9207
0056,元大高股息,19,8,11,凱基-永和,2023-06-02,9207
1560,中砂,11,0,11,凱基-永和,2023-06-02,9207
2376,技嘉,418,407,11,凱基-永和,2023-06-02,9207
00632R,元大台灣50反1,15,5,10,凱基-永和,2023-06-02,9207
00679B,元大美債20年,10,0,10,凱基-永和,2023-06-02,9207
1717,長興,10,0,10,凱基-永和,2023-06-02,9207
3038,全台,16,6,10,凱基-永和,2023-06-02,9207
3346,麗清,10,0,10,凱基-永和,2023-06-02,9207
2603,長榮,10,0,10,凱基-永和,2023-06-02,9207
5706,鳳凰,12,2,10,凱基-永和,2023-06-02,9207
2634,漢翔,17,8,9,凱基-永和,2023-06-02,9207
3260,威剛,9,0,9,凱基-永和,2023-06-02,9207
3017,奇鋐,9,1,8,凱基-永和,2023-06-02,9207
00701,國泰股利精選30,8,0,8,凱基-永和,2023-06-02,9207
2444,兆勁,8,0,8,凱基-永和,2023-06-02,9207
2460,建通,8,0,8,凱基-永和,2023-06-02,9207
3013,晟銘電,21,13,8,凱基-永和,2023-06-02,9207
3338,泰碩,10,2,8,凱基-永和,2023-06-02,9207
6188,廣明,11,3,8,凱基-永和,2023-06-02,9207
3019,亞光,7,0,7,凱基-永和,2023-06-02,9207
1609,大亞,18,11,7,凱基-永和,2023-06-02,9207
2886,兆豐金,10,3,7,凱基-永和,2023-06-02,9207
2882,國泰金,6,0,6,凱基-永和,2023-06-02,9207
6112,邁達特,6,0,6,凱基-永和,2023-06-02,9207
00706L,期元大S＆P日圓正2,5,0,5,凱基-永和,2023-06-02,9207
1504,東元,13,8,5,凱基-永和,2023-06-02,9207
2337,旺宏,6,1,5,凱基-永和,2023-06-02,9207
2376,技嘉,310,2,308,凱基-永和,2023-06-05,9207
4979,華星光,301,10,291,凱基-永和,2023-06-05,9207
3715,定穎投控,254,29,225,凱基-永和,2023-06-05,9207
1810,和成,700,500,200,凱基-永和,2023-06-05,9207
2409,友達,200,13,187,凱基-永和,2023-06-05,9207
1609,大亞,203,21,182,凱基-永和,2023-06-05,9207
8277,商丞,120,0,120,凱基-永和,2023-06-05,9207
00919,群益台灣精選高息,104,0,104,凱基-永和,2023-06-05,9207
8426,紅木-KY,100,0,100,凱基-永和,2023-06-05,9207
3630,新鉅科,100,2,98,凱基-永和,2023-06-05,9207
2634,漢翔,54,2,52,凱基-永和,2023-06-05,9207
3058,立德,50,2,48,凱基-永和,2023-06-05,9207
6776,展�眥篕�,42,0,42,凱基-永和,2023-06-05,9207
4946,辣椒,39,0,39,凱基-永和,2023-06-05,9207
4916,事欣科,35,2,33,凱基-永和,2023-06-05,9207
00720B,元大投資級公司債,22,0,22,凱基-永和,2023-06-05,9207
3711,日月光投控,20,0,20,凱基-永和,2023-06-05,9207
00679B,元大美債20年,19,0,19,凱基-永和,2023-06-05,9207
2838A,聯邦銀甲特,19,0,19,凱基-永和,2023-06-05,9207
1460,宏遠,20,2,18,凱基-永和,2023-06-05,9207
00882,中信中國高股息,17,1,16,凱基-永和,2023-06-05,9207
2887E,台新戊特,15,0,15,凱基-永和,2023-06-05,9207
3029,零壹,15,0,15,凱基-永和,2023-06-05,9207
6111,大宇資,15,0,15,凱基-永和,2023-06-05,9207
00893,國泰智能電動車,20,6,14,凱基-永和,2023-06-05,9207
00751B,元大AAA至A公司債,14,0,14,凱基-永和,2023-06-05,9207
2388,威盛,26,12,14,凱基-永和,2023-06-05,9207
8011,台通,18,4,14,凱基-永和,2023-06-05,9207
2359,所羅門,13,0,13,凱基-永和,2023-06-05,9207
4729,熒茂,13,0,13,凱基-永和,2023-06-05,9207
1717,長興,12,0,12,凱基-永和,2023-06-05,9207
3706,神達,13,1,12,凱基-永和,2023-06-05,9207
3576,聯合再生,12,1,11,凱基-永和,2023-06-05,9207
1714,和桐,21,10,11,凱基-永和,2023-06-05,9207
2331,精英,12,1,11,凱基-永和,2023-06-05,9207
00773B,中信優先金融債,10,0,10,凱基-永和,2023-06-05,9207
00772B,中信高評級公司債,10,0,10,凱基-永和,2023-06-05,9207
1233,天仁,10,0,10,凱基-永和,2023-06-05,9207
1533,車王電,10,0,10,凱基-永和,2023-06-05,9207
2314,台揚,10,0,10,凱基-永和,2023-06-05,9207
5519,隆大,10,0,10,凱基-永和,2023-06-05,9207
6603,富強鑫,10,0,10,凱基-永和,2023-06-05,9207
00713,元大台灣高息低波,9,0,9,凱基-永和,2023-06-05,9207
00680L,元大美債20正2,8,0,8,凱基-永和,2023-06-05,9207
6112,邁達特,9,1,8,凱基-永和,2023-06-05,9207
3406,玉晶光,14,6,8,凱基-永和,2023-06-05,9207
1605,華新,12,5,7,凱基-永和,2023-06-05,9207
2027,大成鋼,10,3,7,凱基-永和,2023-06-05,9207
2883,凱基金,20,13,7,凱基-永和,2023-06-05,9207
3704,合勤控,7,0,7,凱基-永和,2023-06-05,9207
2618,長榮航,130,8,122,凱基-永和,2023-06-06,9207
2610,華航,124,19,105,凱基-永和,2023-06-06,9207
2734,易飛網,100,1,99,凱基-永和,2023-06-06,9207
2883,凱基金,100,10,90,凱基-永和,2023-06-06,9207
2888,新光金,84,30,54,凱基-永和,2023-06-06,9207
8076,伍豐,35,2,33,凱基-永和,2023-06-06,9207
00761B,國泰A級公司債,30,0,30,凱基-永和,2023-06-06,9207
2495,普安,31,2,29,凱基-永和,2023-06-06,9207
00795B,中信美國公債20年,26,0,26,凱基-永和,2023-06-06,9207
2887E,台新戊特,25,0,25,凱基-永和,2023-06-06,9207
4729,熒茂,25,0,25,凱基-永和,2023-06-06,9207
6109,亞元,25,0,25,凱基-永和,2023-06-06,9207
2482,連宇,22,0,22,凱基-永和,2023-06-06,9207
6290,良維,22,0,22,凱基-永和,2023-06-06,9207
3037,欣興,26,4,22,凱基-永和,2023-06-06,9207
4979,華星光,171,151,20,凱基-永和,2023-06-06,9207
2344,華邦電,28,11,17,凱基-永和,2023-06-06,9207
4735,豪展,17,0,17,凱基-永和,2023-06-06,9207
6245,立端,18,1,17,凱基-永和,2023-06-06,9207
00927,群益半導體收益,16,0,16,凱基-永和,2023-06-06,9207
00679B,元大美債20年,15,0,15,凱基-永和,2023-06-06,9207
2838A,聯邦銀甲特,15,0,15,凱基-永和,2023-06-06,9207
1905,華紙,28,14,14,凱基-永和,2023-06-06,9207
2206,三陽工業,28,14,14,凱基-永和,2023-06-06,9207
00720B,元大投資級公司債,12,0,12,凱基-永和,2023-06-06,9207
8261,富鼎,12,0,12,凱基-永和,2023-06-06,9207
2354,鴻準,11,0,11,凱基-永和,2023-06-06,9207
2455,全新,12,1,11,凱基-永和,2023-06-06,9207
3013,晟銘電,11,0,11,凱基-永和,2023-06-06,9207
3025,星通,11,0,11,凱基-永和,2023-06-06,9207
4906,正文,13,2,11,凱基-永和,2023-06-06,9207
00712,復華富時不動產,10,0,10,凱基-永和,2023-06-06,9207
00773B,中信優先金融債,10,0,10,凱基-永和,2023-06-06,9207
1714,和桐,10,0,10,凱基-永和,2023-06-06,9207
2913,農林,10,0,10,凱基-永和,2023-06-06,9207
4953,緯軟,10,0,10,凱基-永和,2023-06-06,9207
6116,彩晶,15,5,10,凱基-永和,2023-06-06,9207
00881,國泰台灣5G+,10,0,10,凱基-永和,2023-06-06,9207
1815,富喬,12,4,8,凱基-永和,2023-06-06,9207
2617,台航,8,0,8,凱基-永和,2023-06-06,9207
3078,僑威,26,18,8,凱基-永和,2023-06-06,9207
1442,名軒,7,0,7,凱基-永和,2023-06-06,9207
00751B,元大AAA至A公司債,7,0,7,凱基-永和,2023-06-06,9207
6112,邁達特,9,2,7,凱基-永和,2023-06-06,9207
1313,聯成,5,0,5,凱基-永和,2023-06-06,9207
1227,佳格,5,0,5,凱基-永和,2023-06-06,9207
00673R,期元大S＆P原油反1,5,0,5,凱基-永和,2023-06-06,9207
1711,永光,5,0,5,凱基-永和,2023-06-06,9207
2427,三商電,8,3,5,凱基-永和,2023-06-06,9207
3236,千如,5,0,5,凱基-永和,2023-06-06,9207
4533,協易機,340,0,340,凱基-永和,2023-06-07,9207
00712,復華富時不動產,130,0,130,凱基-永和,2023-06-07,9207
4979,華星光,130,0,130,凱基-永和,2023-06-07,9207
2376,技嘉,270,146,124,凱基-永和,2023-06-07,9207
5703,亞都,100,0,100,凱基-永和,2023-06-07,9207
1449,佳和,88,0,88,凱基-永和,2023-06-07,9207
1609,大亞,155,77,78,凱基-永和,2023-06-07,9207
2383,台光電,76,4,72,凱基-永和,2023-06-07,9207
8996,高力,163,98,65,凱基-永和,2023-06-07,9207
6187,萬潤,62,4,58,凱基-永和,2023-06-07,9207
4138,曜亞,42,0,42,凱基-永和,2023-06-07,9207
8033,雷虎,40,0,40,凱基-永和,2023-06-07,9207
2888,新光金,50,12,38,凱基-永和,2023-06-07,9207
6728,上洋,33,0,33,凱基-永和,2023-06-07,9207
00632R,元大台灣50反1,30,0,30,凱基-永和,2023-06-07,9207
3105,穩懋,113,83,30,凱基-永和,2023-06-07,9207
0056,元大高股息,29,0,29,凱基-永和,2023-06-07,9207
2337,旺宏,29,0,29,凱基-永和,2023-06-07,9207
2610,華航,46,17,29,凱基-永和,2023-06-07,9207
8097,常珵,43,14,29,凱基-永和,2023-06-07,9207
3046,建��,28,0,28,凱基-永和,2023-06-07,9207
2838A,聯邦銀甲特,26,0,26,凱基-永和,2023-06-07,9207
1720,生達,33,9,24,凱基-永和,2023-06-07,9207
3563,牧德,34,11,23,凱基-永和,2023-06-07,9207
2482,連宇,20,0,20,凱基-永和,2023-06-07,9207
2887E,台新戊特,20,0,20,凱基-永和,2023-06-07,9207
3030,德律,20,0,20,凱基-永和,2023-06-07,9207
6753,龍德造船,20,0,20,凱基-永和,2023-06-07,9207
2515,中工,20,1,19,凱基-永和,2023-06-07,9207
2882,國泰金,19,0,19,凱基-永和,2023-06-07,9207
1802,台玻,18,0,18,凱基-永和,2023-06-07,9207
4915,致伸,18,3,15,凱基-永和,2023-06-07,9207
3029,零壹,15,1,14,凱基-永和,2023-06-07,9207
00679B,元大美債20年,13,0,13,凱基-永和,2023-06-07,9207
1603,華電,13,0,13,凱基-永和,2023-06-07,9207
2344,華邦電,14,1,13,凱基-永和,2023-06-07,9207
5871A,中租-KY甲特,13,0,13,凱基-永和,2023-06-07,9207
2347,聯強,12,0,12,凱基-永和,2023-06-07,9207
6125,廣運,23,11,12,凱基-永和,2023-06-07,9207
00882,中信中國高股息,10,0,10,凱基-永和,2023-06-07,9207
00772B,中信高評級公司債,10,0,10,凱基-永和,2023-06-07,9207
1528,恩德,17,7,10,凱基-永和,2023-06-07,9207
1611,中電,10,0,10,凱基-永和,2023-06-07,9207
2618,長榮航,114,104,10,凱基-永和,2023-06-07,9207
2883,凱基金,13,3,10,凱基-永和,2023-06-07,9207
4129,聯合,13,3,10,凱基-永和,2023-06-07,9207
4729,熒茂,10,0,10,凱基-永和,2023-06-07,9207
5324,士開,10,0,10,凱基-永和,2023-06-07,9207
6167,久正,10,0,10,凱基-永和,2023-06-07,9207
6285,啟��,12,2,10,凱基-永和,2023-06-07,9207
00919,群益台灣精選高息,237,2,235,凱基-永和,2023-06-08,9207
00878,國泰永續高股息,160,3,157,凱基-永和,2023-06-08,9207
6122,擎邦,131,0,131,凱基-永和,2023-06-08,9207
2482,連宇,307,196,111,凱基-永和,2023-06-08,9207
0056,元大高股息,111,2,109,凱基-永和,2023-06-08,9207
6517,保勝光學,102,0,102,凱基-永和,2023-06-08,9207
1432,大魯閣,102,2,100,凱基-永和,2023-06-08,9207
1533,車王電,101,6,95,凱基-永和,2023-06-08,9207
2328,廣宇,80,0,80,凱基-永和,2023-06-08,9207
6441,廣錠,102,61,41,凱基-永和,2023-06-08,9207
6577,勁豐,101,60,41,凱基-永和,2023-06-08,9207
3054,立萬利,40,0,40,凱基-永和,2023-06-08,9207
1605,華新,45,5,40,凱基-永和,2023-06-08,9207
6532,瑞耘,60,21,39,凱基-永和,2023-06-08,9207
7402,邑錡,65,26,39,凱基-永和,2023-06-08,9207
6198,瑞築,35,0,35,凱基-永和,2023-06-08,9207
3037,欣興,33,0,33,凱基-永和,2023-06-08,9207
3030,德律,31,0,31,凱基-永和,2023-06-08,9207
6245,立端,29,0,29,凱基-永和,2023-06-08,9207
2882,國泰金,29,1,28,凱基-永和,2023-06-08,9207
3308,聯德,27,2,25,凱基-永和,2023-06-08,9207
3498,陽程,30,5,25,凱基-永和,2023-06-08,9207
6101,寬魚國際,25,0,25,凱基-永和,2023-06-08,9207
2495,普安,21,0,21,凱基-永和,2023-06-08,9207
5880,合庫金,20,0,20,凱基-永和,2023-06-08,9207
00712,復華富時不動產,20,0,20,凱基-永和,2023-06-08,9207
2706,第一店,19,1,18,凱基-永和,2023-06-08,9207
00679B,元大美債20年,17,0,17,凱基-永和,2023-06-08,9207
00720B,元大投資級公司債,14,0,14,凱基-永和,2023-06-08,9207
3029,零壹,15,1,14,凱基-永和,2023-06-08,9207
6016,康和證,21,7,14,凱基-永和,2023-06-08,9207
3141,晶宏,13,0,13,凱基-永和,2023-06-08,9207
6625,必應,13,0,13,凱基-永和,2023-06-08,9207
2460,建通,12,0,12,凱基-永和,2023-06-08,9207
2359,所羅門,23,11,12,凱基-永和,2023-06-08,9207
8940,新天地,17,6,11,凱基-永和,2023-06-08,9207
1905,華紙,13,2,11,凱基-永和,2023-06-08,9207
2736,富野,11,0,11,凱基-永和,2023-06-08,9207
4729,熒茂,11,0,11,凱基-永和,2023-06-08,9207
8028,昇陽半導體,11,0,11,凱基-永和,2023-06-08,9207
0050,元大台灣50,10,0,10,凱基-永和,2023-06-08,9207
6732,昇佳電子,10,0,10,凱基-永和,2023-06-08,9207
00893,國泰智能電動車,10,0,10,凱基-永和,2023-06-08,9207
2515,中工,50,40,10,凱基-永和,2023-06-08,9207
4960,誠美材,10,0,10,凱基-永和,2023-06-08,9207
6116,彩晶,10,0,10,凱基-永和,2023-06-08,9207
6282,康舒,17,7,10,凱基-永和,2023-06-08,9207
6294,智基,10,0,10,凱基-永和,2023-06-08,9207
1514,亞力,13,3,10,凱基-永和,2023-06-08,9207
1904,正隆,10,1,9,凱基-永和,2023-06-08,9207
6148,驊宏資,350,0,350,凱基-永和,2023-06-09,9207
3481,群創,182,1,181,凱基-永和,2023-06-09,9207
4979,華星光,122,2,120,凱基-永和,2023-06-09,9207
3231,緯創,114,24,90,凱基-永和,2023-06-09,9207
3058,立德,68,0,68,凱基-永和,2023-06-09,9207
2399,映泰,116,56,60,凱基-永和,2023-06-09,9207
8210,勤誠,123,66,57,凱基-永和,2023-06-09,9207
8234,新漢,61,5,56,凱基-永和,2023-06-09,9207
3032,偉訓,101,52,49,凱基-永和,2023-06-09,9207
00929,復華台灣科技優息,47,0,47,凱基-永和,2023-06-09,9207
2383,台光電,49,2,47,凱基-永和,2023-06-09,9207
3054,立萬利,84,45,39,凱基-永和,2023-06-09,9207
00720B,元大投資級公司債,35,0,35,凱基-永和,2023-06-09,9207
00919,群益台灣精選高息,38,5,33,凱基-永和,2023-06-09,9207
6122,擎邦,244,213,31,凱基-永和,2023-06-09,9207
2618,長榮航,36,9,27,凱基-永和,2023-06-09,9207
4543,萬在,30,3,27,凱基-永和,2023-06-09,9207
00915,凱基優選高股息30,25,1,24,凱基-永和,2023-06-09,9207
2603,長榮,23,1,22,凱基-永和,2023-06-09,9207
6770,力積電,21,0,21,凱基-永和,2023-06-09,9207
3306,鼎天,20,0,20,凱基-永和,2023-06-09,9207
8358,金居,23,3,20,凱基-永和,2023-06-09,9207
5512,力麒,20,1,19,凱基-永和,2023-06-09,9207
3515,華擎,20,1,19,凱基-永和,2023-06-09,9207
1710,東聯,18,0,18,凱基-永和,2023-06-09,9207
2611,志信,19,1,18,凱基-永和,2023-06-09,9207
3374,精材,99,81,18,凱基-永和,2023-06-09,9207
6789,采鈺,20,2,18,凱基-永和,2023-06-09,9207
1609,大亞,31,16,15,凱基-永和,2023-06-09,9207
3013,晟銘電,21,6,15,凱基-永和,2023-06-09,9207
2801,彰銀,14,0,14,凱基-永和,2023-06-09,9207
8033,雷虎,13,0,13,凱基-永和,2023-06-09,9207
00751B,元大AAA至A公司債,10,0,10,凱基-永和,2023-06-09,9207
1903,士紙,10,0,10,凱基-永和,2023-06-09,9207
4566,時碩工業,10,0,10,凱基-永和,2023-06-09,9207
6109,亞元,10,0,10,凱基-永和,2023-06-09,9207
6141,柏承,10,0,10,凱基-永和,2023-06-09,9207
6603,富強鑫,10,0,10,凱基-永和,2023-06-09,9207
9943,好樂迪,10,0,10,凱基-永和,2023-06-09,9207
2882,國泰金,9,1,8,凱基-永和,2023-06-09,9207
6625,必應,16,8,8,凱基-永和,2023-06-09,9207
2359,所羅門,7,0,7,凱基-永和,2023-06-09,9207
2609,陽明,12,5,7,凱基-永和,2023-06-09,9207
2458,義隆,9,2,7,凱基-永和,2023-06-09,9207
6285,啟��,10,4,6,凱基-永和,2023-06-09,9207
3037,欣興,11,6,5,凱基-永和,2023-06-09,9207
1513,中興電,5,0,5,凱基-永和,2023-06-09,9207
2607,榮運,6,1,5,凱基-永和,2023-06-09,9207
4129,聯合,5,0,5,凱基-永和,2023-06-09,9207
5009,榮剛,7,2,5,凱基-永和,2023-06-09,9207
2888,新光金,3005,201,2804,凱基-永和,2023-06-12,9207
1742,台蠟,138,0,138,凱基-永和,2023-06-12,9207
9945,潤泰新,101,0,101,凱基-永和,2023-06-12,9207
8112,至上,68,0,68,凱基-永和,2023-06-12,9207
00929,復華台灣科技優息,62,0,62,凱基-永和,2023-06-12,9207
00881,國泰台灣5G+,57,6,51,凱基-永和,2023-06-12,9207
2014,中鴻,51,0,51,凱基-永和,2023-06-12,9207
2634,漢翔,51,0,51,凱基-永和,2023-06-12,9207
2305,全友,50,0,50,凱基-永和,2023-06-12,9207
3178,公準,105,55,50,凱基-永和,2023-06-12,9207
4129,聯合,50,0,50,凱基-永和,2023-06-12,9207
2383,台光電,67,19,48,凱基-永和,2023-06-12,9207
6109,亞元,40,0,40,凱基-永和,2023-06-12,9207
00919,群益台灣精選高息,30,0,30,凱基-永和,2023-06-12,9207
2515,中工,40,11,29,凱基-永和,2023-06-12,9207
2206,三陽工業,27,2,25,凱基-永和,2023-06-12,9207
4432,銘旺實,24,0,24,凱基-永和,2023-06-12,9207
1101,台泥,33,10,23,凱基-永和,2023-06-12,9207
2812,台中銀,23,0,23,凱基-永和,2023-06-12,9207
6271,同欣電,23,0,23,凱基-永和,2023-06-12,9207
2204,中華,20,0,20,凱基-永和,2023-06-12,9207
3454,晶睿,95,75,20,凱基-永和,2023-06-12,9207
2610,華航,35,17,18,凱基-永和,2023-06-12,9207
2356,英業達,15,0,15,凱基-永和,2023-06-12,9207
8097,常珵,15,2,13,凱基-永和,2023-06-12,9207
6461,益得,12,0,12,凱基-永和,2023-06-12,9207
1513,中興電,12,1,11,凱基-永和,2023-06-12,9207
2323,中環,11,0,11,凱基-永和,2023-06-12,9207
2352,佳世達,11,0,11,凱基-永和,2023-06-12,9207
6770,力積電,10,0,10,凱基-永和,2023-06-12,9207
1802,台玻,10,0,10,凱基-永和,2023-06-12,9207
4138,曜亞,16,6,10,凱基-永和,2023-06-12,9207
8034,榮群,10,0,10,凱基-永和,2023-06-12,9207
1536,和大,10,1,9,凱基-永和,2023-06-12,9207
1609,大亞,21,12,9,凱基-永和,2023-06-12,9207
6509,聚和,9,0,9,凱基-永和,2023-06-12,9207
00878,國泰永續高股息,9,1,8,凱基-永和,2023-06-12,9207
00642U,期元大S＆P石油,8,0,8,凱基-永和,2023-06-12,9207
4104,佳醫,10,2,8,凱基-永和,2023-06-12,9207
8446,華研,12,4,8,凱基-永和,2023-06-12,9207
2382,廣達,15,7,8,凱基-永和,2023-06-12,9207
3037,欣興,8,1,7,凱基-永和,2023-06-12,9207
8028,昇陽半導體,7,0,7,凱基-永和,2023-06-12,9207
2388,威盛,11,5,6,凱基-永和,2023-06-12,9207
2882,國泰金,6,0,6,凱基-永和,2023-06-12,9207
6244,茂迪,6,0,6,凱基-永和,2023-06-12,9207
00713,元大台灣高息低波,5,0,5,凱基-永和,2023-06-12,9207
00679B,元大美債20年,5,0,5,凱基-永和,2023-06-12,9207
1603,華電,5,0,5,凱基-永和,2023-06-12,9207
2337,旺宏,5,0,5,凱基-永和,2023-06-12,9207
2888,新光金,953,0,953,凱基-永和,2023-06-13,9207
2356,英業達,792,342,450,凱基-永和,2023-06-13,9207
3308,聯德,121,0,121,凱基-永和,2023-06-13,9207
2867,三商壽,105,0,105,凱基-永和,2023-06-13,9207
6235,華孚,432,332,100,凱基-永和,2023-06-13,9207
6245,立端,71,22,49,凱基-永和,2023-06-13,9207
2453,凌群,51,2,49,凱基-永和,2023-06-13,9207
00715L,期街口布蘭特正2,42,0,42,凱基-永和,2023-06-13,9207
8299,群聯,40,0,40,凱基-永和,2023-06-13,9207
3617,碩天,40,1,39,凱基-永和,2023-06-13,9207
00881,國泰台灣5G+,57,19,38,凱基-永和,2023-06-13,9207
3443,創意,36,1,35,凱基-永和,2023-06-13,9207
00642U,期元大S＆P石油,28,0,28,凱基-永和,2023-06-13,9207
2006,東和鋼鐵,26,0,26,凱基-永和,2023-06-13,9207
00878,國泰永續高股息,30,5,25,凱基-永和,2023-06-13,9207
2515,中工,45,20,25,凱基-永和,2023-06-13,9207
8050,廣積,34,11,23,凱基-永和,2023-06-13,9207
6770,力積電,22,0,22,凱基-永和,2023-06-13,9207
2882,國泰金,21,0,21,凱基-永和,2023-06-13,9207
3231,緯創,31,11,20,凱基-永和,2023-06-13,9207
2719,燦星旅,23,3,20,凱基-永和,2023-06-13,9207
8076,伍豐,20,0,20,凱基-永和,2023-06-13,9207
2603,長榮,22,3,19,凱基-永和,2023-06-13,9207
2428,興勤,20,1,19,凱基-永和,2023-06-13,9207
6116,彩晶,19,0,19,凱基-永和,2023-06-13,9207
1605,華新,30,13,17,凱基-永和,2023-06-13,9207
9945,潤泰新,23,6,17,凱基-永和,2023-06-13,9207
1734,杏輝,16,0,16,凱基-永和,2023-06-13,9207
8446,華研,16,0,16,凱基-永和,2023-06-13,9207
5439,高技,19,5,14,凱基-永和,2023-06-13,9207
00632R,元大台灣50反1,12,0,12,凱基-永和,2023-06-13,9207
1314,中石化,11,0,11,凱基-永和,2023-06-13,9207
1785,光洋科,11,0,11,凱基-永和,2023-06-13,9207
2105,正新,11,0,11,凱基-永和,2023-06-13,9207
00720B,元大投資級公司債,10,0,10,凱基-永和,2023-06-13,9207
2402,毅嘉,10,0,10,凱基-永和,2023-06-13,9207
2913,農林,10,0,10,凱基-永和,2023-06-13,9207
5302,太欣,10,0,10,凱基-永和,2023-06-13,9207
8070,長華*,10,0,10,凱基-永和,2023-06-13,9207
2886,兆豐金,10,1,9,凱基-永和,2023-06-13,9207
2412,中華電,8,0,8,凱基-永和,2023-06-13,9207
2883,凱基金,8,0,8,凱基-永和,2023-06-13,9207
2301,光寶科,8,1,7,凱基-永和,2023-06-13,9207
6643,M31,6,0,6,凱基-永和,2023-06-13,9207
1517,利奇,6,0,6,凱基-永和,2023-06-13,9207
00882,中信中國高股息,6,0,6,凱基-永和,2023-06-13,9207
2323,中環,8,2,6,凱基-永和,2023-06-13,9207
2337,旺宏,6,0,6,凱基-永和,2023-06-13,9207
2885,元大金,6,0,6,凱基-永和,2023-06-13,9207
3011,今皓,6,0,6,凱基-永和,2023-06-13,9207
2888,新光金,1503,55,1448,凱基-永和,2023-06-14,9207
3058,立德,250,71,179,凱基-永和,2023-06-14,9207
2867,三商壽,115,20,95,凱基-永和,2023-06-14,9207
9945,潤泰新,61,1,60,凱基-永和,2023-06-14,9207
2401,凌陽,51,1,50,凱基-永和,2023-06-14,9207
8210,勤誠,50,5,45,凱基-永和,2023-06-14,9207
2701,萬企,35,0,35,凱基-永和,2023-06-14,9207
3707,漢磊,37,3,34,凱基-永和,2023-06-14,9207
2611,志信,23,1,22,凱基-永和,2023-06-14,9207
8097,常珵,23,1,22,凱基-永和,2023-06-14,9207
00882,中信中國高股息,20,0,20,凱基-永和,2023-06-14,9207
3141,晶宏,18,0,18,凱基-永和,2023-06-14,9207
4729,熒茂,17,0,17,凱基-永和,2023-06-14,9207
2453,凌群,15,0,15,凱基-永和,2023-06-14,9207
2457,飛宏,22,9,13,凱基-永和,2023-06-14,9207
2399,映泰,12,0,12,凱基-永和,2023-06-14,9207
3481,群創,12,0,12,凱基-永和,2023-06-14,9207
8996,高力,12,0,12,凱基-永和,2023-06-14,9207
1904,正隆,12,0,12,凱基-永和,2023-06-14,9207
00772B,中信高評級公司債,11,0,11,凱基-永和,2023-06-14,9207
00919,群益台灣精選高息,10,0,10,凱基-永和,2023-06-14,9207
1314,中石化,10,0,10,凱基-永和,2023-06-14,9207
1806,冠軍,20,10,10,凱基-永和,2023-06-14,9207
2515,中工,20,10,10,凱基-永和,2023-06-14,9207
3545,敦泰,10,0,10,凱基-永和,2023-06-14,9207
8927,北基,15,5,10,凱基-永和,2023-06-14,9207
2206,三陽工業,31,22,9,凱基-永和,2023-06-14,9207
2330,台積電,11,2,9,凱基-永和,2023-06-14,9207
00679B,元大美債20年,9,0,9,凱基-永和,2023-06-14,9207
00633L,富邦上証正2,10,1,9,凱基-永和,2023-06-14,9207
2606,裕民,10,1,9,凱基-永和,2023-06-14,9207
6282,康舒,9,0,9,凱基-永和,2023-06-14,9207
2603,長榮,22,13,9,凱基-永和,2023-06-14,9207
00878,國泰永續高股息,39,31,8,凱基-永和,2023-06-14,9207
3013,晟銘電,10,2,8,凱基-永和,2023-06-14,9207
00637L,元大滬深300正2,11,3,8,凱基-永和,2023-06-14,9207
1517,利奇,8,0,8,凱基-永和,2023-06-14,9207
2388,威盛,14,6,8,凱基-永和,2023-06-14,9207
2801,彰銀,8,0,8,凱基-永和,2023-06-14,9207
2014,中鴻,9,2,7,凱基-永和,2023-06-14,9207
2421,建準,14,7,7,凱基-永和,2023-06-14,9207
5351,鈺創,14,7,7,凱基-永和,2023-06-14,9207
3030,德律,7,0,7,凱基-永和,2023-06-14,9207
2883,凱基金,6,0,6,凱基-永和,2023-06-14,9207
1504,東元,7,1,6,凱基-永和,2023-06-14,9207
2436,偉詮電,7,1,6,凱基-永和,2023-06-14,9207
3046,建��,6,0,6,凱基-永和,2023-06-14,9207
3576,聯合再生,6,0,6,凱基-永和,2023-06-14,9207
8050,廣積,20,14,6,凱基-永和,2023-06-14,9207
00751B,元大AAA至A公司債,5,0,5,凱基-永和,2023-06-14,9207
2888,新光金,1442,0,1442,凱基-永和,2023-06-15,9207
3706,神達,812,239,573,凱基-永和,2023-06-15,9207
2371,大同,382,224,158,凱基-永和,2023-06-15,9207
3481,群創,105,1,104,凱基-永和,2023-06-15,9207
1795,美時,88,6,82,凱基-永和,2023-06-15,9207
1815,富喬,265,188,77,凱基-永和,2023-06-15,9207
2867,三商壽,70,0,70,凱基-永和,2023-06-15,9207
2356,英業達,173,104,69,凱基-永和,2023-06-15,9207
2359,所羅門,52,9,43,凱基-永和,2023-06-15,9207
6743,安普新,40,0,40,凱基-永和,2023-06-15,9207
3231,緯創,57,28,29,凱基-永和,2023-06-15,9207
1477,聚陽,80,53,27,凱基-永和,2023-06-15,9207
2353,宏��,25,0,25,凱基-永和,2023-06-15,9207
00919,群益台灣精選高息,26,2,24,凱基-永和,2023-06-15,9207
2312,金寶,23,0,23,凱基-永和,2023-06-15,9207
6218,豪勉,20,0,20,凱基-永和,2023-06-15,9207
2405,輔信,20,5,15,凱基-永和,2023-06-15,9207
4951,精拓科,15,0,15,凱基-永和,2023-06-15,9207
3443,創意,16,1,15,凱基-永和,2023-06-15,9207
00715L,期街口布蘭特正2,14,0,14,凱基-永和,2023-06-15,9207
4739,康普,14,0,14,凱基-永和,2023-06-15,9207
2337,旺宏,15,1,14,凱基-永和,2023-06-15,9207
3264,欣銓,16,5,11,凱基-永和,2023-06-15,9207
2883,凱基金,11,1,10,凱基-永和,2023-06-15,9207
00882,中信中國高股息,10,0,10,凱基-永和,2023-06-15,9207
2492,華新科,10,0,10,凱基-永和,2023-06-15,9207
2515,中工,10,0,10,凱基-永和,2023-06-15,9207
3105,穩懋,11,1,10,凱基-永和,2023-06-15,9207
8171,天宇,10,0,10,凱基-永和,2023-06-15,9207
9945,潤泰新,10,0,10,凱基-永和,2023-06-15,9207
2453,凌群,98,89,9,凱基-永和,2023-06-15,9207
6672,騰輝電子-KY,10,1,9,凱基-永和,2023-06-15,9207
6770,力積電,27,19,8,凱基-永和,2023-06-15,9207
1752,南光,8,0,8,凱基-永和,2023-06-15,9207
6213,聯茂,8,0,8,凱基-永和,2023-06-15,9207
00878,國泰永續高股息,23,16,7,凱基-永和,2023-06-15,9207
2454,聯發科,7,0,7,凱基-永和,2023-06-15,9207
2002,中鋼,7,0,7,凱基-永和,2023-06-15,9207
2891,中信金,7,0,7,凱基-永和,2023-06-15,9207
6223,旺矽,10,3,7,凱基-永和,2023-06-15,9207
8043,蜜望實,7,0,7,凱基-永和,2023-06-15,9207
2609,陽明,6,0,6,凱基-永和,2023-06-15,9207
1215,卜蜂,7,1,6,凱基-永和,2023-06-15,9207
1720,生達,6,0,6,凱基-永和,2023-06-15,9207
2399,映泰,10,4,6,凱基-永和,2023-06-15,9207
5465,富驊,10,4,6,凱基-永和,2023-06-15,9207
6143,振曜,6,0,6,凱基-永和,2023-06-15,9207
00898,國泰基因免疫革命,5,0,5,凱基-永和,2023-06-15,9207
00885,富邦越南,5,0,5,凱基-永和,2023-06-15,9207
1806,冠軍,5,0,5,凱基-永和,2023-06-15,9207
2312,金寶,891,711,180,凱基-永和,2023-06-16,9207
1513,中興電,165,13,152,凱基-永和,2023-06-16,9207
9945,潤泰新,109,1,108,凱基-永和,2023-06-16,9207
2618,長榮航,100,24,76,凱基-永和,2023-06-16,9207
00712,復華富時不動產,53,0,53,凱基-永和,2023-06-16,9207
00881,國泰台灣5G+,57,4,53,凱基-永和,2023-06-16,9207
1525,江申,50,1,49,凱基-永和,2023-06-16,9207
00893,國泰智能電動車,40,0,40,凱基-永和,2023-06-16,9207
2332,友訊,40,0,40,凱基-永和,2023-06-16,9207
8071,能率網通,25,0,25,凱基-永和,2023-06-16,9207
6016,康和證,20,0,20,凱基-永和,2023-06-16,9207
6603,富強鑫,20,0,20,凱基-永和,2023-06-16,9207
2344,華邦電,27,9,18,凱基-永和,2023-06-16,9207
00679B,元大美債20年,16,0,16,凱基-永和,2023-06-16,9207
2388,威盛,51,36,15,凱基-永和,2023-06-16,9207
2429,銘旺科,15,0,15,凱基-永和,2023-06-16,9207
2886,兆豐金,14,0,14,凱基-永和,2023-06-16,9207
00637L,元大滬深300正2,16,2,14,凱基-永和,2023-06-16,9207
3324,雙鴻,14,0,14,凱基-永和,2023-06-16,9207
2610,華航,118,107,11,凱基-永和,2023-06-16,9207
2303,聯電,16,5,11,凱基-永和,2023-06-16,9207
00885,富邦越南,11,0,11,凱基-永和,2023-06-16,9207
6245,立端,12,1,11,凱基-永和,2023-06-16,9207
2812,台中銀,10,0,10,凱基-永和,2023-06-16,9207
2204,中華,10,0,10,凱基-永和,2023-06-16,9207
2882,國泰金,12,2,10,凱基-永和,2023-06-16,9207
2897,王道銀行,10,0,10,凱基-永和,2023-06-16,9207
3025,星通,12,2,10,凱基-永和,2023-06-16,9207
3027,盛達,10,0,10,凱基-永和,2023-06-16,9207
6218,豪勉,10,0,10,凱基-永和,2023-06-16,9207
8076,伍豐,20,10,10,凱基-永和,2023-06-16,9207
8927,北基,10,0,10,凱基-永和,2023-06-16,9207
00919,群益台灣精選高息,9,0,9,凱基-永和,2023-06-16,9207
2515,中工,20,11,9,凱基-永和,2023-06-16,9207
1515,力山,8,0,8,凱基-永和,2023-06-16,9207
3006,晶豪科,10,2,8,凱基-永和,2023-06-16,9207
00680L,元大美債20正2,10,3,7,凱基-永和,2023-06-16,9207
1522,堤維西,11,4,7,凱基-永和,2023-06-16,9207
2454,聯發科,7,0,7,凱基-永和,2023-06-16,9207
6533,晶心科,6,0,6,凱基-永和,2023-06-16,9207
2834,臺企銀,6,0,6,凱基-永和,2023-06-16,9207
1609,大亞,17,11,6,凱基-永和,2023-06-16,9207
2009,第一銅,6,0,6,凱基-永和,2023-06-16,9207
4953,緯軟,6,0,6,凱基-永和,2023-06-16,9207
5009,榮剛,7,1,6,凱基-永和,2023-06-16,9207
6531,愛普*,6,0,6,凱基-永和,2023-06-16,9207
1227,佳格,5,0,5,凱基-永和,2023-06-16,9207
2883,凱基金,8,3,5,凱基-永和,2023-06-16,9207
1307,三芳,10,5,5,凱基-永和,2023-06-16,9207
2739,寒舍,5,0,5,凱基-永和,2023-06-16,9207
2427,三商電,941,448,493,凱基-永和,2023-06-19,9207
7402,邑錡,250,2,248,凱基-永和,2023-06-19,9207
2739,寒舍,215,2,213,凱基-永和,2023-06-19,9207
5443,均豪,108,0,108,凱基-永和,2023-06-19,9207
2867,三商壽,65,0,65,凱基-永和,2023-06-19,9207
8222,寶一,104,52,52,凱基-永和,2023-06-19,9207
2719,燦星旅,39,0,39,凱基-永和,2023-06-19,9207
2453,凌群,30,1,29,凱基-永和,2023-06-19,9207
6217,中探針,31,3,28,凱基-永和,2023-06-19,9207
2812,台中銀,24,0,24,凱基-永和,2023-06-19,9207
2324,仁寶,23,2,21,凱基-永和,2023-06-19,9207
6415,矽力*-KY,22,1,21,凱基-永和,2023-06-19,9207
00753L,中信中國50正2,20,0,20,凱基-永和,2023-06-19,9207
6697,東捷資訊,20,0,20,凱基-永和,2023-06-19,9207
2332,友訊,21,1,20,凱基-永和,2023-06-19,9207
2201,裕隆,17,1,16,凱基-永和,2023-06-19,9207
6266,泰詠,16,0,16,凱基-永和,2023-06-19,9207
2609,陽明,17,3,14,凱基-永和,2023-06-19,9207
2014,中鴻,19,6,13,凱基-永和,2023-06-19,9207
2617,台航,12,0,12,凱基-永和,2023-06-19,9207
3552,同致,14,2,12,凱基-永和,2023-06-19,9207
3260,威剛,13,2,11,凱基-永和,2023-06-19,9207
6285,啟��,11,0,11,凱基-永和,2023-06-19,9207
2888,新光金,10,0,10,凱基-永和,2023-06-19,9207
2915,潤泰全,10,0,10,凱基-永和,2023-06-19,9207
5534,長虹,10,0,10,凱基-永和,2023-06-19,9207
8038,長園科,10,0,10,凱基-永和,2023-06-19,9207
1528,恩德,9,0,9,凱基-永和,2023-06-19,9207
2421,建準,26,17,9,凱基-永和,2023-06-19,9207
6811,宏�硌穈T,10,1,9,凱基-永和,2023-06-19,9207
8358,金居,9,0,9,凱基-永和,2023-06-19,9207
1504,東元,8,0,8,凱基-永和,2023-06-19,9207
2371,大同,8,0,8,凱基-永和,2023-06-19,9207
5351,鈺創,8,0,8,凱基-永和,2023-06-19,9207
2409,友達,35,27,8,凱基-永和,2023-06-19,9207
2603,長榮,12,5,7,凱基-永和,2023-06-19,9207
2027,大成鋼,7,0,7,凱基-永和,2023-06-19,9207
2450,神腦,6,0,6,凱基-永和,2023-06-19,9207
2885,元大金,6,0,6,凱基-永和,2023-06-19,9207
3092,鴻碩,6,0,6,凱基-永和,2023-06-19,9207
4729,熒茂,6,0,6,凱基-永和,2023-06-19,9207
6477,安集,6,0,6,凱基-永和,2023-06-19,9207
5706,鳳凰,7,1,6,凱基-永和,2023-06-19,9207
2382,廣達,16,11,5,凱基-永和,2023-06-19,9207
2610,華航,69,64,5,凱基-永和,2023-06-19,9207
00929,復華台灣科技優息,5,0,5,凱基-永和,2023-06-19,9207
00712,復華富時不動產,5,0,5,凱基-永和,2023-06-19,9207
00706L,期元大S＆P日圓正2,5,0,5,凱基-永和,2023-06-19,9207
00679B,元大美債20年,5,0,5,凱基-永和,2023-06-19,9207
00882,中信中國高股息,7,2,5,凱基-永和,2023-06-19,9207
00878,國泰永續高股息,162,64,98,凱基-永和,2023-06-20,9207
1514,亞力,90,2,88,凱基-永和,2023-06-20,9207
2610,華航,123,42,81,凱基-永和,2023-06-20,9207
1513,中興電,83,16,67,凱基-永和,2023-06-20,9207
2915,潤泰全,55,2,53,凱基-永和,2023-06-20,9207
2705,六福,51,1,50,凱基-永和,2023-06-20,9207
2748,雲品,50,8,42,凱基-永和,2023-06-20,9207
2634,漢翔,525,489,36,凱基-永和,2023-06-20,9207
6120,達運,33,0,33,凱基-永和,2023-06-20,9207
00915,凱基優選高股息30,31,0,31,凱基-永和,2023-06-20,9207
00712,復華富時不動產,30,0,30,凱基-永和,2023-06-20,9207
2888,新光金,30,5,25,凱基-永和,2023-06-20,9207
2618,長榮航,34,12,22,凱基-永和,2023-06-20,9207
3552,同致,23,2,21,凱基-永和,2023-06-20,9207
2611,志信,20,0,20,凱基-永和,2023-06-20,9207
3308,聯德,17,0,17,凱基-永和,2023-06-20,9207
6140,訊達,15,0,15,凱基-永和,2023-06-20,9207
6550,北極星藥業-KY,15,0,15,凱基-永和,2023-06-20,9207
8277,商丞,15,0,15,凱基-永和,2023-06-20,9207
5706,鳳凰,14,0,14,凱基-永和,2023-06-20,9207
0056,元大高股息,17,4,13,凱基-永和,2023-06-20,9207
2104,國際中橡,12,0,12,凱基-永和,2023-06-20,9207
2340,台亞,16,4,12,凱基-永和,2023-06-20,9207
3264,欣銓,12,0,12,凱基-永和,2023-06-20,9207
2486,一詮,13,2,11,凱基-永和,2023-06-20,9207
00893,國泰智能電動車,10,0,10,凱基-永和,2023-06-20,9207
00679B,元大美債20年,10,0,10,凱基-永和,2023-06-20,9207
5009,榮剛,12,2,10,凱基-永和,2023-06-20,9207
2457,飛宏,9,0,9,凱基-永和,2023-06-20,9207
2883,凱基金,11,2,9,凱基-永和,2023-06-20,9207
6282,康舒,11,2,9,凱基-永和,2023-06-20,9207
1319,東陽,8,0,8,凱基-永和,2023-06-20,9207
00929,復華台灣科技優息,9,1,8,凱基-永和,2023-06-20,9207
00919,群益台灣精選高息,6,0,6,凱基-永和,2023-06-20,9207
3576,聯合再生,6,0,6,凱基-永和,2023-06-20,9207
8076,伍豐,6,0,6,凱基-永和,2023-06-20,9207
2454,聯發科,10,5,5,凱基-永和,2023-06-20,9207
1101,台泥,12,7,5,凱基-永和,2023-06-20,9207
00882,中信中國高股息,5,0,5,凱基-永和,2023-06-20,9207
2607,榮運,5,0,5,凱基-永和,2023-06-20,9207
2913,農林,5,0,5,凱基-永和,2023-06-20,9207
5351,鈺創,5,0,5,凱基-永和,2023-06-20,9207
6672,騰輝電子-KY,5,0,5,凱基-永和,2023-06-20,9207
6806,森崴能源,5,0,5,凱基-永和,2023-06-20,9207
1440,南紡,4,0,4,凱基-永和,2023-06-20,9207
1718,中纖,4,0,4,凱基-永和,2023-06-20,9207
2356,英業達,11,7,4,凱基-永和,2023-06-20,9207
2504,國產,4,0,4,凱基-永和,2023-06-20,9207
3652,精聯,4,0,4,凱基-永和,2023-06-20,9207
5512,力麒,5,1,4,凱基-永和,2023-06-20,9207
1471,首利,305,0,305,凱基-永和,2023-06-21,9207
2427,三商電,708,516,192,凱基-永和,2023-06-21,9207
2376,技嘉,85,0,85,凱基-永和,2023-06-21,9207
4979,華星光,76,1,75,凱基-永和,2023-06-21,9207
6217,中探針,71,0,71,凱基-永和,2023-06-21,9207
6276,安鈦克,149,90,59,凱基-永和,2023-06-21,9207
6203,海韻電,74,26,48,凱基-永和,2023-06-21,9207
5534,長虹,36,0,36,凱基-永和,2023-06-21,9207
2915,潤泰全,35,0,35,凱基-永和,2023-06-21,9207
1522,堤維西,36,3,33,凱基-永和,2023-06-21,9207
2337,旺宏,31,0,31,凱基-永和,2023-06-21,9207
3003,健和興,31,2,29,凱基-永和,2023-06-21,9207
2609,陽明,27,0,27,凱基-永和,2023-06-21,9207
2409,友達,58,31,27,凱基-永和,2023-06-21,9207
2618,長榮航,27,5,22,凱基-永和,2023-06-21,9207
6142,友勁,20,0,20,凱基-永和,2023-06-21,9207
2634,漢翔,26,11,15,凱基-永和,2023-06-21,9207
2603,長榮,18,4,14,凱基-永和,2023-06-21,9207
00752,中信中國50,15,1,14,凱基-永和,2023-06-21,9207
3049,精金,15,1,14,凱基-永和,2023-06-21,9207
5871,中租-KY,11,0,11,凱基-永和,2023-06-21,9207
2888,新光金,13,2,11,凱基-永和,2023-06-21,9207
5351,鈺創,11,0,11,凱基-永和,2023-06-21,9207
6290,良維,11,0,11,凱基-永和,2023-06-21,9207
2308,台達電,11,1,10,凱基-永和,2023-06-21,9207
3308,聯德,10,0,10,凱基-永和,2023-06-21,9207
4566,時碩工業,10,0,10,凱基-永和,2023-06-21,9207
5475,德宏,10,0,10,凱基-永和,2023-06-21,9207
2201,裕隆,9,0,9,凱基-永和,2023-06-21,9207
00713,元大台灣高息低波,9,0,9,凱基-永和,2023-06-21,9207
00720B,元大投資級公司債,10,1,9,凱基-永和,2023-06-21,9207
2408,南亞科,9,0,9,凱基-永和,2023-06-21,9207
1904,正隆,19,11,8,凱基-永和,2023-06-21,9207
9933,中鼎,8,0,8,凱基-永和,2023-06-21,9207
1533,車王電,9,1,8,凱基-永和,2023-06-21,9207
3264,欣銓,9,1,8,凱基-永和,2023-06-21,9207
6150,撼訊,8,0,8,凱基-永和,2023-06-21,9207
00673R,期元大S＆P原油反1,7,0,7,凱基-永和,2023-06-21,9207
2867,三商壽,20,13,7,凱基-永和,2023-06-21,9207
2356,英業達,16,10,6,凱基-永和,2023-06-21,9207
2707,晶華,6,0,6,凱基-永和,2023-06-21,9207
3027,盛達,9,3,6,凱基-永和,2023-06-21,9207
3324,雙鴻,8,2,6,凱基-永和,2023-06-21,9207
5905,南仁湖,6,0,6,凱基-永和,2023-06-21,9207
00722B,群益投資級電信債,5,0,5,凱基-永和,2023-06-21,9207
1528,恩德,6,1,5,凱基-永和,2023-06-21,9207
2614,東森,5,0,5,凱基-永和,2023-06-21,9207
2883,凱基金,5,0,5,凱基-永和,2023-06-21,9207
3013,晟銘電,8,3,5,凱基-永和,2023-06-21,9207
00919,群益台灣精選高息,4,0,4,凱基-永和,2023-06-21,9207
1471,首利,1003,305,698,凱基-永和,2023-06-26,9207
2888,新光金,550,0,550,凱基-永和,2023-06-26,9207
3306,鼎天,106,6,100,凱基-永和,2023-06-26,9207
1513,中興電,81,8,73,凱基-永和,2023-06-26,9207
6169,昱泉,65,1,64,凱基-永和,2023-06-26,9207
4503,金雨,60,0,60,凱基-永和,2023-06-26,9207
00882,中信中國高股息,57,0,57,凱基-永和,2023-06-26,9207
3664,安瑞-KY,36,0,36,凱基-永和,2023-06-26,9207
00633L,富邦上証正2,30,0,30,凱基-永和,2023-06-26,9207
2432,倚天酷��-創,29,0,29,凱基-永和,2023-06-26,9207
2481,強茂,28,0,28,凱基-永和,2023-06-26,9207
6788,華景電,27,0,27,凱基-永和,2023-06-26,9207
2412,中華電,26,0,26,凱基-永和,2023-06-26,9207
6120,達運,26,0,26,凱基-永和,2023-06-26,9207
2382,廣達,30,5,25,凱基-永和,2023-06-26,9207
2610,華航,34,10,24,凱基-永和,2023-06-26,9207
2812,台中銀,24,0,24,凱基-永和,2023-06-26,9207
1905,華紙,27,7,20,凱基-永和,2023-06-26,9207
3689,湧德,20,0,20,凱基-永和,2023-06-26,9207
3257,虹冠電,18,0,18,凱基-永和,2023-06-26,9207
00680L,元大美債20正2,15,0,15,凱基-永和,2023-06-26,9207
1522,堤維西,16,1,15,凱基-永和,2023-06-26,9207
5351,鈺創,15,0,15,凱基-永和,2023-06-26,9207
2618,長榮航,24,11,13,凱基-永和,2023-06-26,9207
6282,康舒,24,11,13,凱基-永和,2023-06-26,9207
6770,力積電,13,0,13,凱基-永和,2023-06-26,9207
3706,神達,27,15,12,凱基-永和,2023-06-26,9207
00878,國泰永續高股息,68,57,11,凱基-永和,2023-06-26,9207
2356,英業達,21,10,11,凱基-永和,2023-06-26,9207
6220,岳豐,11,0,11,凱基-永和,2023-06-26,9207
1616,億泰,10,0,10,凱基-永和,2023-06-26,9207
2409,友達,16,7,9,凱基-永和,2023-06-26,9207
1504,東元,10,1,9,凱基-永和,2023-06-26,9207
1528,恩德,11,2,9,凱基-永和,2023-06-26,9207
6188,廣明,12,3,9,凱基-永和,2023-06-26,9207
2498,宏達電,9,1,8,凱基-永和,2023-06-26,9207
3037,欣興,9,1,8,凱基-永和,2023-06-26,9207
8069,元太,22,15,7,凱基-永和,2023-06-26,9207
2891,中信金,8,1,7,凱基-永和,2023-06-26,9207
2707,晶華,7,1,6,凱基-永和,2023-06-26,9207
2883,凱基金,8,2,6,凱基-永和,2023-06-26,9207
6213,聯茂,6,0,6,凱基-永和,2023-06-26,9207
8358,金居,6,0,6,凱基-永和,2023-06-26,9207
3481,群創,11,6,5,凱基-永和,2023-06-26,9207
00632R,元大台灣50反1,5,0,5,凱基-永和,2023-06-26,9207
00642U,期元大S＆P石油,5,0,5,凱基-永和,2023-06-26,9207
2515,中工,5,0,5,凱基-永和,2023-06-26,9207
2630,亞航,5,0,5,凱基-永和,2023-06-26,9207
3078,僑威,10,5,5,凱基-永和,2023-06-26,9207
4102,永日,5,0,5,凱基-永和,2023-06-26,9207
2888,新光金,301,9,292,凱基-永和,2023-06-27,9207
00878,國泰永續高股息,160,11,149,凱基-永和,2023-06-27,9207
2382,廣達,160,13,147,凱基-永和,2023-06-27,9207
1477,聚陽,100,0,100,凱基-永和,2023-06-27,9207
2610,華航,134,38,96,凱基-永和,2023-06-27,9207
2303,聯電,41,2,39,凱基-永和,2023-06-27,9207
2376,技嘉,52,13,39,凱基-永和,2023-06-27,9207
6770,力積電,32,0,32,凱基-永和,2023-06-27,9207
2317,鴻海,34,9,25,凱基-永和,2023-06-27,9207
1907,永豐餘,21,0,21,凱基-永和,2023-06-27,9207
6556,勝品,35,15,20,凱基-永和,2023-06-27,9207
3596,智易,17,0,17,凱基-永和,2023-06-27,9207
2603,長榮,22,5,17,凱基-永和,2023-06-27,9207
00885,富邦越南,18,3,15,凱基-永和,2023-06-27,9207
3481,群創,20,5,15,凱基-永和,2023-06-27,9207
6188,廣明,25,11,14,凱基-永和,2023-06-27,9207
2104,國際中橡,14,0,14,凱基-永和,2023-06-27,9207
2412,中華電,14,1,13,凱基-永和,2023-06-27,9207
3038,全台,13,1,12,凱基-永和,2023-06-27,9207
8097,常珵,12,0,12,凱基-永和,2023-06-27,9207
1301,台塑,11,0,11,凱基-永和,2023-06-27,9207
2344,華邦電,14,3,11,凱基-永和,2023-06-27,9207
4106,雃博,24,13,11,凱基-永和,2023-06-27,9207
5876,上海商銀,11,0,11,凱基-永和,2023-06-27,9207
2515,中工,10,0,10,凱基-永和,2023-06-27,9207
00671R,富邦NASDAQ反1,10,0,10,凱基-永和,2023-06-27,9207
3508,位速,10,0,10,凱基-永和,2023-06-27,9207
4951,精拓科,10,0,10,凱基-永和,2023-06-27,9207
5351,鈺創,10,0,10,凱基-永和,2023-06-27,9207
6470,宇智,13,3,10,凱基-永和,2023-06-27,9207
2883,凱基金,14,4,10,凱基-永和,2023-06-27,9207
00772B,中信高評級公司債,9,0,9,凱基-永和,2023-06-27,9207
6451,訊芯-KY,9,0,9,凱基-永和,2023-06-27,9207
00795B,中信美國公債20年,8,0,8,凱基-永和,2023-06-27,9207
6116,彩晶,8,0,8,凱基-永和,2023-06-27,9207
2618,長榮航,36,29,7,凱基-永和,2023-06-27,9207
00919,群益台灣精選高息,7,0,7,凱基-永和,2023-06-27,9207
2312,金寶,7,0,7,凱基-永和,2023-06-27,9207
3706,神達,8,1,7,凱基-永和,2023-06-27,9207
1529,樂事綠能,6,0,6,凱基-永和,2023-06-27,9207
2634,漢翔,6,0,6,凱基-永和,2023-06-27,9207
8358,金居,10,4,6,凱基-永和,2023-06-27,9207
2332,友訊,9,3,6,凱基-永和,2023-06-27,9207
006208,富邦台50,5,0,5,凱基-永和,2023-06-27,9207
2353,宏��,5,0,5,凱基-永和,2023-06-27,9207
1605,華新,7,2,5,凱基-永和,2023-06-27,9207
1710,東聯,5,0,5,凱基-永和,2023-06-27,9207
2347,聯強,5,0,5,凱基-永和,2023-06-27,9207
2383,台光電,5,0,5,凱基-永和,2023-06-27,9207
3491,昇達科,5,0,5,凱基-永和,2023-06-27,9207
2610,華航,1008,19,989,凱基-永和,2023-06-28,9207
2618,長榮航,615,31,584,凱基-永和,2023-06-28,9207
2888,新光金,249,0,249,凱基-永和,2023-06-28,9207
4979,華星光,201,0,201,凱基-永和,2023-06-28,9207
8210,勤誠,101,1,100,凱基-永和,2023-06-28,9207
1477,聚陽,200,101,99,凱基-永和,2023-06-28,9207
6584,南俊國際,80,0,80,凱基-永和,2023-06-28,9207
3356,奇偶,218,160,58,凱基-永和,2023-06-28,9207
3308,聯德,31,0,31,凱基-永和,2023-06-28,9207
2337,旺宏,28,0,28,凱基-永和,2023-06-28,9207
1605,華新,37,12,25,凱基-永和,2023-06-28,9207
3294,英濟,25,0,25,凱基-永和,2023-06-28,9207
00642U,期元大S＆P石油,20,0,20,凱基-永和,2023-06-28,9207
2388,威盛,20,0,20,凱基-永和,2023-06-28,9207
9933,中鼎,20,0,20,凱基-永和,2023-06-28,9207
4906,正文,28,12,16,凱基-永和,2023-06-28,9207
00679B,元大美債20年,14,0,14,凱基-永和,2023-06-28,9207
00715L,期街口布蘭特正2,14,0,14,凱基-永和,2023-06-28,9207
4106,雃博,31,17,14,凱基-永和,2023-06-28,9207
1471,首利,12,0,12,凱基-永和,2023-06-28,9207
2906,高林,26,14,12,凱基-永和,2023-06-28,9207
1514,亞力,11,0,11,凱基-永和,2023-06-28,9207
1611,中電,10,0,10,凱基-永和,2023-06-28,9207
2201,裕隆,10,0,10,凱基-永和,2023-06-28,9207
3025,星通,10,0,10,凱基-永和,2023-06-28,9207
4960,誠美材,10,0,10,凱基-永和,2023-06-28,9207
6109,亞元,10,0,10,凱基-永和,2023-06-28,9207
6142,友勁,10,0,10,凱基-永和,2023-06-28,9207
1907,永豐餘,9,0,9,凱基-永和,2023-06-28,9207
3055,蔚華科,9,0,9,凱基-永和,2023-06-28,9207
1301,台塑,8,0,8,凱基-永和,2023-06-28,9207
2303,聯電,10,2,8,凱基-永和,2023-06-28,9207
5009,榮剛,13,5,8,凱基-永和,2023-06-28,9207
6169,昱泉,8,0,8,凱基-永和,2023-06-28,9207
2412,中華電,9,2,7,凱基-永和,2023-06-28,9207
00706L,期元大S＆P日圓正2,7,0,7,凱基-永和,2023-06-28,9207
2371,大同,26,19,7,凱基-永和,2023-06-28,9207
00919,群益台灣精選高息,6,0,6,凱基-永和,2023-06-28,9207
2453,凌群,6,0,6,凱基-永和,2023-06-28,9207
2883,凱基金,7,1,6,凱基-永和,2023-06-28,9207
4157,太景*-KY,8,2,6,凱基-永和,2023-06-28,9207
00927,群益半導體收益,5,0,5,凱基-永和,2023-06-28,9207
00885,富邦越南,5,0,5,凱基-永和,2023-06-28,9207
2247,汎德永業,7,2,5,凱基-永和,2023-06-28,9207
2323,中環,5,0,5,凱基-永和,2023-06-28,9207
2748,雲品,5,0,5,凱基-永和,2023-06-28,9207
2897,王道銀行,5,0,5,凱基-永和,2023-06-28,9207
3017,奇鋐,5,0,5,凱基-永和,2023-06-28,9207
3037,欣興,5,0,5,凱基-永和,2023-06-28,9207
3592,瑞鼎,5,0,5,凱基-永和,2023-06-28,9207
4414,如興,441,0,441,凱基-永和,2023-06-29,9207
3207,耀勝,282,2,280,凱基-永和,2023-06-29,9207
3665,貿聯-KY,112,0,112,凱基-永和,2023-06-29,9207
2888,新光金,103,2,101,凱基-永和,2023-06-29,9207
4979,華星光,182,82,100,凱基-永和,2023-06-29,9207
2303,聯電,71,6,65,凱基-永和,2023-06-29,9207
2867,三商壽,60,0,60,凱基-永和,2023-06-29,9207
00712,復華富時不動產,50,0,50,凱基-永和,2023-06-29,9207
1905,華紙,35,1,34,凱基-永和,2023-06-29,9207
6669,緯穎,30,1,29,凱基-永和,2023-06-29,9207
2002,中鋼,24,0,24,凱基-永和,2023-06-29,9207
2332,友訊,20,0,20,凱基-永和,2023-06-29,9207
2409,友達,15,0,15,凱基-永和,2023-06-29,9207
5285,界霖,15,0,15,凱基-永和,2023-06-29,9207
8069,元太,20,5,15,凱基-永和,2023-06-29,9207
2457,飛宏,24,11,13,凱基-永和,2023-06-29,9207
1605,華新,25,13,12,凱基-永和,2023-06-29,9207
2313,華通,12,0,12,凱基-永和,2023-06-29,9207
1528,恩德,12,1,11,凱基-永和,2023-06-29,9207
5531,鄉林,11,0,11,凱基-永和,2023-06-29,9207
2883,凱基金,12,1,11,凱基-永和,2023-06-29,9207
00896,中信綠能及電動車,10,0,10,凱基-永和,2023-06-29,9207
2329,華泰,10,0,10,凱基-永和,2023-06-29,9207
2412,中華電,10,0,10,凱基-永和,2023-06-29,9207
3294,英濟,10,0,10,凱基-永和,2023-06-29,9207
4138,曜亞,10,0,10,凱基-永和,2023-06-29,9207
5534,長虹,10,0,10,凱基-永和,2023-06-29,9207
6613,朋億*,10,0,10,凱基-永和,2023-06-29,9207
8112,至上,10,0,10,凱基-永和,2023-06-29,9207
0056,元大高股息,11,2,9,凱基-永和,2023-06-29,9207
2317,鴻海,29,20,9,凱基-永和,2023-06-29,9207
3005,神基,8,0,8,凱基-永和,2023-06-29,9207
3481,群創,10,2,8,凱基-永和,2023-06-29,9207
2344,華邦電,40,33,7,凱基-永和,2023-06-29,9207
00706L,期元大S＆P日圓正2,7,0,7,凱基-永和,2023-06-29,9207
00919,群益台灣精選高息,6,0,6,凱基-永和,2023-06-29,9207
1584,精剛,6,0,6,凱基-永和,2023-06-29,9207
4106,雃博,8,2,6,凱基-永和,2023-06-29,9207
8028,昇陽半導體,6,0,6,凱基-永和,2023-06-29,9207
1727,中華化,5,0,5,凱基-永和,2023-06-29,9207
2408,南亞科,8,3,5,凱基-永和,2023-06-29,9207
3227,原相,5,0,5,凱基-永和,2023-06-29,9207
3346,麗清,5,0,5,凱基-永和,2023-06-29,9207
3372,典範,5,0,5,凱基-永和,2023-06-29,9207
4129,聯合,5,0,5,凱基-永和,2023-06-29,9207
6142,友勁,5,0,5,凱基-永和,2023-06-29,9207
6191,精成科,5,0,5,凱基-永和,2023-06-29,9207
8097,常珵,5,0,5,凱基-永和,2023-06-29,9207
1815,富喬,4,0,4,凱基-永和,2023-06-29,9207
2753,八方雲集,5,1,4,凱基-永和,2023-06-29,9207
2888,新光金,2072,1,2071,凱基-永和,2023-06-30,9207
3231,緯創,467,77,390,凱基-永和,2023-06-30,9207
1217,愛之味,340,9,331,凱基-永和,2023-06-30,9207
2368,金像電,313,7,306,凱基-永和,2023-06-30,9207
3481,群創,200,0,200,凱基-永和,2023-06-30,9207
2609,陽明,416,228,188,凱基-永和,2023-06-30,9207
3025,星通,62,2,60,凱基-永和,2023-06-30,9207
00712,復華富時不動產,54,0,54,凱基-永和,2023-06-30,9207
2317,鴻海,47,5,42,凱基-永和,2023-06-30,9207
2618,長榮航,54,16,38,凱基-永和,2023-06-30,9207
00680L,元大美債20正2,36,0,36,凱基-永和,2023-06-30,9207
4979,華星光,42,7,35,凱基-永和,2023-06-30,9207
6669,緯穎,31,0,31,凱基-永和,2023-06-30,9207
3017,奇鋐,29,5,24,凱基-永和,2023-06-30,9207
6155,鈞寶,20,0,20,凱基-永和,2023-06-30,9207
4121,優盛,21,5,16,凱基-永和,2023-06-30,9207
2409,友達,16,0,16,凱基-永和,2023-06-30,9207
2610,華航,16,1,15,凱基-永和,2023-06-30,9207
2206,三陽工業,17,2,15,凱基-永和,2023-06-30,9207
00679B,元大美債20年,14,0,14,凱基-永和,2023-06-30,9207
1528,恩德,14,0,14,凱基-永和,2023-06-30,9207
00772B,中信高評級公司債,13,0,13,凱基-永和,2023-06-30,9207
4532,瑞智,36,23,13,凱基-永和,2023-06-30,9207
00731,復華富時高息低波,11,0,11,凱基-永和,2023-06-30,9207
4155,訊映,12,1,11,凱基-永和,2023-06-30,9207
00687B,國泰20年美債,11,0,11,凱基-永和,2023-06-30,9207
2883,凱基金,14,4,10,凱基-永和,2023-06-30,9207
00671R,富邦NASDAQ反1,10,0,10,凱基-永和,2023-06-30,9207
00891,中信關鍵半導體,10,0,10,凱基-永和,2023-06-30,9207
1905,華紙,10,0,10,凱基-永和,2023-06-30,9207
2328,廣宇,10,0,10,凱基-永和,2023-06-30,9207
2601,益航,10,0,10,凱基-永和,2023-06-30,9207
00795B,中信美國公債20年,9,0,9,凱基-永和,2023-06-30,9207
2412,中華電,9,0,9,凱基-永和,2023-06-30,9207
6104,創惟,14,5,9,凱基-永和,2023-06-30,9207
2323,中環,7,0,7,凱基-永和,2023-06-30,9207
2324,仁寶,7,0,7,凱基-永和,2023-06-30,9207
8936,國統,10,3,7,凱基-永和,2023-06-30,9207
8210,勤誠,90,84,6,凱基-永和,2023-06-30,9207
00916,國泰全球品牌50,6,0,6,凱基-永和,2023-06-30,9207
1907,永豐餘,11,5,6,凱基-永和,2023-06-30,9207
5351,鈺創,6,0,6,凱基-永和,2023-06-30,9207
6166,凌華,6,0,6,凱基-永和,2023-06-30,9207
4960,誠美材,5,0,5,凱基-永和,2023-06-30,9207
2376,技嘉,5,0,5,凱基-永和,2023-06-30,9207
2419,仲琦,8,3,5,凱基-永和,2023-06-30,9207
4105,東洋,5,0,5,凱基-永和,2023-06-30,9207
6233,旺玖,5,0,5,凱基-永和,2023-06-30,9207
2104,國際中橡,10,6,4,凱基-永和,2023-06-30,9207
2606,裕民,4,0,4,凱基-永和,2023-06-30,9207
2888,新光金,1270,0,1270,凱基-永和,2023-07-03,9207
2427,三商電,402,3,399,凱基-永和,2023-07-03,9207
3231,緯創,767,389,378,凱基-永和,2023-07-03,9207
1603,華電,401,200,201,凱基-永和,2023-07-03,9207
8996,高力,166,2,164,凱基-永和,2023-07-03,9207
3013,晟銘電,115,10,105,凱基-永和,2023-07-03,9207
3308,聯德,102,0,102,凱基-永和,2023-07-03,9207
6451,訊芯-KY,200,100,100,凱基-永和,2023-07-03,9207
2421,建準,152,56,96,凱基-永和,2023-07-03,9207
2419,仲琦,275,183,92,凱基-永和,2023-07-03,9207
3025,星通,63,4,59,凱基-永和,2023-07-03,9207
00712,復華富時不動產,59,0,59,凱基-永和,2023-07-03,9207
4979,華星光,52,1,51,凱基-永和,2023-07-03,9207
5285,界霖,43,0,43,凱基-永和,2023-07-03,9207
3207,耀勝,40,8,32,凱基-永和,2023-07-03,9207
00679B,元大美債20年,30,0,30,凱基-永和,2023-07-03,9207
2636,台驊控股,59,30,29,凱基-永和,2023-07-03,9207
1460,宏遠,24,0,24,凱基-永和,2023-07-03,9207
6491,晶碩,22,0,22,凱基-永和,2023-07-03,9207
1528,恩德,34,13,21,凱基-永和,2023-07-03,9207
1101,台泥,19,1,18,凱基-永和,2023-07-03,9207
6770,力積電,17,0,17,凱基-永和,2023-07-03,9207
1795,美時,27,10,17,凱基-永和,2023-07-03,9207
3324,雙鴻,18,1,17,凱基-永和,2023-07-03,9207
2303,聯電,53,40,13,凱基-永和,2023-07-03,9207
2317,鴻海,28,15,13,凱基-永和,2023-07-03,9207
2105,正新,13,0,13,凱基-永和,2023-07-03,9207
1103,嘉泥,10,0,10,凱基-永和,2023-07-03,9207
1802,台玻,10,0,10,凱基-永和,2023-07-03,9207
2009,第一銅,10,0,10,凱基-永和,2023-07-03,9207
3615,安可,10,0,10,凱基-永和,2023-07-03,9207
6547,高端疫苗,10,0,10,凱基-永和,2023-07-03,9207
6743,安普新,10,0,10,凱基-永和,2023-07-03,9207
8071,能率網通,10,0,10,凱基-永和,2023-07-03,9207
8171,天宇,10,0,10,凱基-永和,2023-07-03,9207
2382,廣達,13,4,9,凱基-永和,2023-07-03,9207
00888,永豐台灣ESG,10,1,9,凱基-永和,2023-07-03,9207
2312,金寶,12,3,9,凱基-永和,2023-07-03,9207
5534,長虹,8,0,8,凱基-永和,2023-07-03,9207
8255,朋程,8,0,8,凱基-永和,2023-07-03,9207
6568,宏觀,7,0,7,凱基-永和,2023-07-03,9207
00671R,富邦NASDAQ反1,10,3,7,凱基-永和,2023-07-03,9207
1301,台塑,8,1,7,凱基-永和,2023-07-03,9207
1514,亞力,15,8,7,凱基-永和,2023-07-03,9207
3706,神達,17,10,7,凱基-永和,2023-07-03,9207
2412,中華電,7,1,6,凱基-永和,2023-07-03,9207
00713,元大台灣高息低波,6,0,6,凱基-永和,2023-07-03,9207
3045,台灣大,6,0,6,凱基-永和,2023-07-03,9207
1536,和大,6,0,6,凱基-永和,2023-07-03,9207
3058,立德,6,0,6,凱基-永和,2023-07-03,9207
2427,三商電,6389,0,6389,凱基-永和,2023-07-04,9207
2888,新光金,1415,5,1410,凱基-永和,2023-07-04,9207
2609,陽明,1328,1018,310,凱基-永和,2023-07-04,9207
3231,緯創,336,29,307,凱基-永和,2023-07-04,9207
3374,精材,297,118,179,凱基-永和,2023-07-04,9207
0056,元大高股息,120,11,109,凱基-永和,2023-07-04,9207
6806,森崴能源,105,4,101,凱基-永和,2023-07-04,9207
2332,友訊,38,0,38,凱基-永和,2023-07-04,9207
2337,旺宏,29,0,29,凱基-永和,2023-07-04,9207
1460,宏遠,21,0,21,凱基-永和,2023-07-04,9207
00679B,元大美債20年,21,0,21,凱基-永和,2023-07-04,9207
1477,聚陽,18,0,18,凱基-永和,2023-07-04,9207
2882,國泰金,16,0,16,凱基-永和,2023-07-04,9207
00632R,元大台灣50反1,15,0,15,凱基-永和,2023-07-04,9207
2515,中工,15,0,15,凱基-永和,2023-07-04,9207
4538,大詠城,15,0,15,凱基-永和,2023-07-04,9207
1904,正隆,20,5,15,凱基-永和,2023-07-04,9207
2618,長榮航,14,2,12,凱基-永和,2023-07-04,9207
2603,長榮,653,641,12,凱基-永和,2023-07-04,9207
2303,聯電,11,0,11,凱基-永和,2023-07-04,9207
3362,先進光,12,1,11,凱基-永和,2023-07-04,9207
6223,旺矽,13,2,11,凱基-永和,2023-07-04,9207
00753L,中信中國50正2,10,0,10,凱基-永和,2023-07-04,9207
1714,和桐,10,0,10,凱基-永和,2023-07-04,9207
2328,廣宇,10,0,10,凱基-永和,2023-07-04,9207
2360,致茂,10,0,10,凱基-永和,2023-07-04,9207
2362,藍天,10,0,10,凱基-永和,2023-07-04,9207
2460,建通,10,0,10,凱基-永和,2023-07-04,9207
6265,方土昶,10,0,10,凱基-永和,2023-07-04,9207
2317,鴻海,21,11,10,凱基-永和,2023-07-04,9207
6190,萬泰科,10,1,9,凱基-永和,2023-07-04,9207
2883,凱基金,19,11,8,凱基-永和,2023-07-04,9207
2331,精英,7,0,7,凱基-永和,2023-07-04,9207
3058,立德,7,0,7,凱基-永和,2023-07-04,9207
4129,聯合,12,5,7,凱基-永和,2023-07-04,9207
8358,金居,10,3,7,凱基-永和,2023-07-04,9207
3481,群創,11,5,6,凱基-永和,2023-07-04,9207
1309,台達化,6,0,6,凱基-永和,2023-07-04,9207
00751B,元大AAA至A公司債,7,1,6,凱基-永和,2023-07-04,9207
1522,堤維西,7,1,6,凱基-永和,2023-07-04,9207
2615,萬海,16,10,6,凱基-永和,2023-07-04,9207
6191,精成科,9,3,6,凱基-永和,2023-07-04,9207
00687B,國泰20年美債,6,0,6,凱基-永和,2023-07-04,9207
1532,勤美,5,0,5,凱基-永和,2023-07-04,9207
2412,中華電,8,3,5,凱基-永和,2023-07-04,9207
2413,環科,5,0,5,凱基-永和,2023-07-04,9207
2457,飛宏,17,12,5,凱基-永和,2023-07-04,9207
2748,雲品,5,0,5,凱基-永和,2023-07-04,9207
2755,揚秦,5,0,5,凱基-永和,2023-07-04,9207
3689,湧德,5,0,5,凱基-永和,2023-07-04,9207
2888,新光金,1000,10,990,凱基-永和,2023-07-05,9207
4979,華星光,142,22,120,凱基-永和,2023-07-05,9207
3481,群創,106,0,106,凱基-永和,2023-07-05,9207
00772B,中信高評級公司債,101,0,101,凱基-永和,2023-07-05,9207
2409,友達,100,0,100,凱基-永和,2023-07-05,9207
4414,如興,52,2,50,凱基-永和,2023-07-05,9207
00712,復華富時不動產,46,0,46,凱基-永和,2023-07-05,9207
00878,國泰永續高股息,30,4,26,凱基-永和,2023-07-05,9207
2332,友訊,24,1,23,凱基-永和,2023-07-05,9207
1611,中電,22,0,22,凱基-永和,2023-07-05,9207
2303,聯電,67,46,21,凱基-永和,2023-07-05,9207
8071,能率網通,20,0,20,凱基-永和,2023-07-05,9207
3362,先進光,23,4,19,凱基-永和,2023-07-05,9207
00929,復華台灣科技優息,17,0,17,凱基-永和,2023-07-05,9207
2618,長榮航,62,45,17,凱基-永和,2023-07-05,9207
2312,金寶,20,6,14,凱基-永和,2023-07-05,9207
2324,仁寶,58,44,14,凱基-永和,2023-07-05,9207
1101,台泥,13,0,13,凱基-永和,2023-07-05,9207
1314,中石化,12,0,12,凱基-永和,2023-07-05,9207
2419,仲琦,28,17,11,凱基-永和,2023-07-05,9207
8028,昇陽半導體,10,0,10,凱基-永和,2023-07-05,9207
00893,國泰智能電動車,22,12,10,凱基-永和,2023-07-05,9207
1514,亞力,10,0,10,凱基-永和,2023-07-05,9207
1609,大亞,28,18,10,凱基-永和,2023-07-05,9207
2809,京城銀,10,0,10,凱基-永和,2023-07-05,9207
3703,欣陸,10,0,10,凱基-永和,2023-07-05,9207
6269,台郡,10,0,10,凱基-永和,2023-07-05,9207
8034,榮群,11,1,10,凱基-永和,2023-07-05,9207
8097,常珵,10,0,10,凱基-永和,2023-07-05,9207
2884,玉山金,10,1,9,凱基-永和,2023-07-05,9207
3105,穩懋,9,0,9,凱基-永和,2023-07-05,9207
00673R,期元大S＆P原油反1,8,0,8,凱基-永和,2023-07-05,9207
1528,恩德,16,8,8,凱基-永和,2023-07-05,9207
2401,凌陽,9,1,8,凱基-永和,2023-07-05,9207
1605,華新,9,2,7,凱基-永和,2023-07-05,9207
3501,維熹,7,0,7,凱基-永和,2023-07-05,9207
1905,華紙,7,0,7,凱基-永和,2023-07-05,9207
2883,凱基金,8,1,7,凱基-永和,2023-07-05,9207
1460,宏遠,6,0,6,凱基-永和,2023-07-05,9207
1522,堤維西,6,0,6,凱基-永和,2023-07-05,9207
1783,和康生,6,0,6,凱基-永和,2023-07-05,9207
1809,中釉,9,3,6,凱基-永和,2023-07-05,9207
2301,光寶科,6,0,6,凱基-永和,2023-07-05,9207
2359,所羅門,6,0,6,凱基-永和,2023-07-05,9207
2402,毅嘉,31,25,6,凱基-永和,2023-07-05,9207
6158,禾昌,6,0,6,凱基-永和,2023-07-05,9207
6741,91APP*-KY,6,0,6,凱基-永和,2023-07-05,9207
0056,元大高股息,22,17,5,凱基-永和,2023-07-05,9207
1471,首利,5,0,5,凱基-永和,2023-07-05,9207
00632R,元大台灣50反1,5,0,5,凱基-永和,2023-07-05,9207
2888,新光金,1323,4,1319,凱基-永和,2023-07-06,9207
2380,虹光,200,0,200,凱基-永和,2023-07-06,9207
3131,弘塑,100,0,100,凱基-永和,2023-07-06,9207
00753L,中信中國50正2,102,10,92,凱基-永和,2023-07-06,9207
3037,欣興,62,0,62,凱基-永和,2023-07-06,9207
2401,凌陽,69,21,48,凱基-永和,2023-07-06,9207
00650L,復華香港正2,47,0,47,凱基-永和,2023-07-06,9207
3019,亞光,55,10,45,凱基-永和,2023-07-06,9207
00712,復華富時不動產,37,0,37,凱基-永和,2023-07-06,9207
3701,大眾控,54,17,37,凱基-永和,2023-07-06,9207
6538,倉和,80,44,36,凱基-永和,2023-07-06,9207
2883,凱基金,29,0,29,凱基-永和,2023-07-06,9207
00929,復華台灣科技優息,29,0,29,凱基-永和,2023-07-06,9207
1611,中電,31,2,29,凱基-永和,2023-07-06,9207
00882,中信中國高股息,28,0,28,凱基-永和,2023-07-06,9207
2337,旺宏,28,1,27,凱基-永和,2023-07-06,9207
2301,光寶科,26,3,23,凱基-永和,2023-07-06,9207
0056,元大高股息,29,7,22,凱基-永和,2023-07-06,9207
2356,英業達,24,2,22,凱基-永和,2023-07-06,9207
00720B,元大投資級公司債,21,0,21,凱基-永和,2023-07-06,9207
2888B,新光金乙特,20,0,20,凱基-永和,2023-07-06,9207
6531,愛普*,20,0,20,凱基-永和,2023-07-06,9207
00878,國泰永續高股息,20,1,19,凱基-永和,2023-07-06,9207
4108,懷特,16,0,16,凱基-永和,2023-07-06,9207
00881,國泰台灣5G+,15,2,13,凱基-永和,2023-07-06,9207
2204,中華,12,0,12,凱基-永和,2023-07-06,9207
6217,中探針,12,0,12,凱基-永和,2023-07-06,9207
1101,台泥,12,1,11,凱基-永和,2023-07-06,9207
2330,台積電,11,0,11,凱基-永和,2023-07-06,9207
1301,台塑,10,0,10,凱基-永和,2023-07-06,9207
2014,中鴻,10,0,10,凱基-永和,2023-07-06,9207
2460,建通,10,0,10,凱基-永和,2023-07-06,9207
3338,泰碩,10,0,10,凱基-永和,2023-07-06,9207
5009,榮剛,10,0,10,凱基-永和,2023-07-06,9207
6168,宏齊,10,0,10,凱基-永和,2023-07-06,9207
6417,韋僑,10,0,10,凱基-永和,2023-07-06,9207
00919,群益台灣精選高息,10,1,9,凱基-永和,2023-07-06,9207
1907,永豐餘,9,0,9,凱基-永和,2023-07-06,9207
3550,聯穎,9,0,9,凱基-永和,2023-07-06,9207
00751B,元大AAA至A公司債,8,0,8,凱基-永和,2023-07-06,9207
2006,東和鋼鐵,8,0,8,凱基-永和,2023-07-06,9207
3580,友威科,8,0,8,凱基-永和,2023-07-06,9207
4744,皇將,10,2,8,凱基-永和,2023-07-06,9207
8215,明基材,20,12,8,凱基-永和,2023-07-06,9207
8358,金居,8,0,8,凱基-永和,2023-07-06,9207
4958,臻鼎-KY,8,0,8,凱基-永和,2023-07-06,9207
2882,國泰金,9,2,7,凱基-永和,2023-07-06,9207
2329,華泰,11,4,7,凱基-永和,2023-07-06,9207
3071,協禧,7,0,7,凱基-永和,2023-07-06,9207
3362,先進光,8,1,7,凱基-永和,2023-07-06,9207
2888,新光金,1296,0,1296,凱基-永和,2023-07-07,9207
4532,瑞智,2727,1658,1069,凱基-永和,2023-07-07,9207
3231,緯創,439,22,417,凱基-永和,2023-07-07,9207
4533,協易機,600,300,300,凱基-永和,2023-07-07,9207
2618,長榮航,86,3,83,凱基-永和,2023-07-07,9207
3362,先進光,158,88,70,凱基-永和,2023-07-07,9207
9958,世紀鋼,50,1,49,凱基-永和,2023-07-07,9207
3380,明泰,44,6,38,凱基-永和,2023-07-07,9207
00632R,元大台灣50反1,40,5,35,凱基-永和,2023-07-07,9207
00680L,元大美債20正2,35,0,35,凱基-永和,2023-07-07,9207
6109,亞元,35,0,35,凱基-永和,2023-07-07,9207
2344,華邦電,31,0,31,凱基-永和,2023-07-07,9207
2332,友訊,30,0,30,凱基-永和,2023-07-07,9207
2312,金寶,29,0,29,凱基-永和,2023-07-07,9207
6846,綠茵,28,0,28,凱基-永和,2023-07-07,9207
00679B,元大美債20年,27,0,27,凱基-永和,2023-07-07,9207
5521,工信,22,0,22,凱基-永和,2023-07-07,9207
00882,中信中國高股息,21,0,21,凱基-永和,2023-07-07,9207
1104,環泥,21,0,21,凱基-永和,2023-07-07,9207
2328,廣宇,20,0,20,凱基-永和,2023-07-07,9207
6142,友勁,20,0,20,凱基-永和,2023-07-07,9207
00712,復華富時不動產,17,0,17,凱基-永和,2023-07-07,9207
5531,鄉林,17,0,17,凱基-永和,2023-07-07,9207
6770,力積電,15,0,15,凱基-永和,2023-07-07,9207
2607,榮運,15,0,15,凱基-永和,2023-07-07,9207
1301,台塑,14,0,14,凱基-永和,2023-07-07,9207
00720B,元大投資級公司債,14,0,14,凱基-永和,2023-07-07,9207
3481,群創,13,0,13,凱基-永和,2023-07-07,9207
2317,鴻海,14,1,13,凱基-永和,2023-07-07,9207
2886,兆豐金,12,0,12,凱基-永和,2023-07-07,9207
1710,東聯,12,0,12,凱基-永和,2023-07-07,9207
8358,金居,12,0,12,凱基-永和,2023-07-07,9207
2883,凱基金,11,0,11,凱基-永和,2023-07-07,9207
2356,英業達,25,14,11,凱基-永和,2023-07-07,9207
2603,長榮,14,3,11,凱基-永和,2023-07-07,9207
6719,力智,10,0,10,凱基-永和,2023-07-07,9207
00921,兆豐龍頭等權重,10,0,10,凱基-永和,2023-07-07,9207
1604,聲寶,10,0,10,凱基-永和,2023-07-07,9207
3138,耀登,10,0,10,凱基-永和,2023-07-07,9207
8097,常珵,10,0,10,凱基-永和,2023-07-07,9207
9802,鈺齊-KY,10,0,10,凱基-永和,2023-07-07,9207
00878,國泰永續高股息,9,0,9,凱基-永和,2023-07-07,9207
2301,光寶科,11,2,9,凱基-永和,2023-07-07,9207
2340,台亞,14,6,8,凱基-永和,2023-07-07,9207
6491,晶碩,7,0,7,凱基-永和,2023-07-07,9207
2887,台新金,8,1,7,凱基-永和,2023-07-07,9207
2367,燿華,7,0,7,凱基-永和,2023-07-07,9207
00929,復華台灣科技優息,8,1,7,凱基-永和,2023-07-07,9207
1471,首利,9,2,7,凱基-永和,2023-07-07,9207
4729,熒茂,7,0,7,凱基-永和,2023-07-07,9207
2888,新光金,2100,0,2100,凱基-永和,2023-07-10,9207
1604,聲寶,700,2,698,凱基-永和,2023-07-10,9207
9945,潤泰新,230,0,230,凱基-永和,2023-07-10,9207
2382,廣達,218,12,206,凱基-永和,2023-07-10,9207
2368,金像電,202,5,197,凱基-永和,2023-07-10,9207
3231,緯創,118,3,115,凱基-永和,2023-07-10,9207
2303,聯電,106,2,104,凱基-永和,2023-07-10,9207
2867,三商壽,74,0,74,凱基-永和,2023-07-10,9207
00882,中信中國高股息,76,5,71,凱基-永和,2023-07-10,9207
00679B,元大美債20年,57,0,57,凱基-永和,2023-07-10,9207
8092,建暐,50,0,50,凱基-永和,2023-07-10,9207
2883,凱基金,47,0,47,凱基-永和,2023-07-10,9207
4979,華星光,36,3,33,凱基-永和,2023-07-10,9207
5283,禾聯碩,55,24,31,凱基-永和,2023-07-10,9207
3289,宜特,30,0,30,凱基-永和,2023-07-10,9207
2880,華南金,24,0,24,凱基-永和,2023-07-10,9207
4967,十銓,23,1,22,凱基-永和,2023-07-10,9207
6811,宏�硌穈T,20,0,20,凱基-永和,2023-07-10,9207
6120,達運,28,9,19,凱基-永和,2023-07-10,9207
00673R,期元大S＆P原油反1,15,0,15,凱基-永和,2023-07-10,9207
1711,永光,15,0,15,凱基-永和,2023-07-10,9207
8034,榮群,15,0,15,凱基-永和,2023-07-10,9207
1504,東元,17,3,14,凱基-永和,2023-07-10,9207
00715L,期街口布蘭特正2,15,1,14,凱基-永和,2023-07-10,9207
2356,英業達,16,2,14,凱基-永和,2023-07-10,9207
4527,方土霖,25,12,13,凱基-永和,2023-07-10,9207
1513,中興電,14,3,11,凱基-永和,2023-07-10,9207
1802,台玻,11,0,11,凱基-永和,2023-07-10,9207
3025,星通,14,3,11,凱基-永和,2023-07-10,9207
5439,高技,11,0,11,凱基-永和,2023-07-10,9207
3707,漢磊,22,12,10,凱基-永和,2023-07-10,9207
1463,強盛新,10,0,10,凱基-永和,2023-07-10,9207
2460,建通,10,0,10,凱基-永和,2023-07-10,9207
3019,亞光,11,1,10,凱基-永和,2023-07-10,9207
8171,天宇,10,0,10,凱基-永和,2023-07-10,9207
2886,兆豐金,10,1,9,凱基-永和,2023-07-10,9207
6531,愛普*,9,0,9,凱基-永和,2023-07-10,9207
3481,群創,12,4,8,凱基-永和,2023-07-10,9207
00751B,元大AAA至A公司債,8,0,8,凱基-永和,2023-07-10,9207
3036,文曄,8,0,8,凱基-永和,2023-07-10,9207
4744,皇將,8,0,8,凱基-永和,2023-07-10,9207
8086,宏捷科,10,2,8,凱基-永和,2023-07-10,9207
1605,華新,7,0,7,凱基-永和,2023-07-10,9207
3078,僑威,8,1,7,凱基-永和,2023-07-10,9207
4129,聯合,7,0,7,凱基-永和,2023-07-10,9207
2317,鴻海,6,0,6,凱基-永和,2023-07-10,9207
2615,萬海,6,0,6,凱基-永和,2023-07-10,9207
2313,華通,6,0,6,凱基-永和,2023-07-10,9207
6126,信音,6,0,6,凱基-永和,2023-07-10,9207
6840,東研信超,6,0,6,凱基-永和,2023-07-10,9207
2301,光寶科,682,6,676,凱基-永和,2023-07-11,9207
3231,緯創,482,305,177,凱基-永和,2023-07-11,9207
9929,秋雨,100,0,100,凱基-永和,2023-07-11,9207
2332,友訊,76,0,76,凱基-永和,2023-07-11,9207
2371,大同,81,29,52,凱基-永和,2023-07-11,9207
2889,國票金,50,0,50,凱基-永和,2023-07-11,9207
5512,力麒,50,0,50,凱基-永和,2023-07-11,9207
4538,大詠城,40,1,39,凱基-永和,2023-07-11,9207
00680L,元大美債20正2,30,0,30,凱基-永和,2023-07-11,9207
2618,長榮航,41,14,27,凱基-永和,2023-07-11,9207
5392,能率,25,0,25,凱基-永和,2023-07-11,9207
3105,穩懋,24,0,24,凱基-永和,2023-07-11,9207
2882,國泰金,31,8,23,凱基-永和,2023-07-11,9207
2359,所羅門,20,0,20,凱基-永和,2023-07-11,9207
3707,漢磊,20,0,20,凱基-永和,2023-07-11,9207
5371,中光電,25,5,20,凱基-永和,2023-07-11,9207
00712,復華富時不動產,18,0,18,凱基-永和,2023-07-11,9207
4532,瑞智,68,52,16,凱基-永和,2023-07-11,9207
00687B,國泰20年美債,14,0,14,凱基-永和,2023-07-11,9207
2303,聯電,14,0,14,凱基-永和,2023-07-11,9207
3712,永崴投控,15,1,14,凱基-永和,2023-07-11,9207
3025,星通,13,1,12,凱基-永和,2023-07-11,9207
3037,欣興,12,0,12,凱基-永和,2023-07-11,9207
4106,雃博,11,0,11,凱基-永和,2023-07-11,9207
3055,蔚華科,10,0,10,凱基-永和,2023-07-11,9207
3234,光環,11,1,10,凱基-永和,2023-07-11,9207
6023,元大期,10,0,10,凱基-永和,2023-07-11,9207
6168,宏齊,10,0,10,凱基-永和,2023-07-11,9207
2881,富邦金,12,3,9,凱基-永和,2023-07-11,9207
2913,農林,9,0,9,凱基-永和,2023-07-11,9207
1442,名軒,8,0,8,凱基-永和,2023-07-11,9207
9919,康那香,8,0,8,凱基-永和,2023-07-11,9207
6288,聯嘉,8,1,7,凱基-永和,2023-07-11,9207
1101,台泥,6,0,6,凱基-永和,2023-07-11,9207
6024,群益期,6,0,6,凱基-永和,2023-07-11,9207
1463,強盛新,5,0,5,凱基-永和,2023-07-11,9207
1522,堤維西,5,0,5,凱基-永和,2023-07-11,9207
2462,良得電,5,0,5,凱基-永和,2023-07-11,9207
2546,根基,5,0,5,凱基-永和,2023-07-11,9207
2801,彰銀,5,0,5,凱基-永和,2023-07-11,9207
2883,凱基金,8,3,5,凱基-永和,2023-07-11,9207
3338,泰碩,10,5,5,凱基-永和,2023-07-11,9207
3580,友威科,5,0,5,凱基-永和,2023-07-11,9207
3666,光耀,6,1,5,凱基-永和,2023-07-11,9207
4104,佳醫,7,2,5,凱基-永和,2023-07-11,9207
5483,中美晶,5,0,5,凱基-永和,2023-07-11,9207
6142,友勁,25,20,5,凱基-永和,2023-07-11,9207
6271,同欣電,6,1,5,凱基-永和,2023-07-11,9207
2312,金寶,6,1,5,凱基-永和,2023-07-11,9207
1513,中興電,4,0,4,凱基-永和,2023-07-11,9207
2888,新光金,2401,0,2401,凱基-永和,2023-07-12,9207
9945,潤泰新,181,0,181,凱基-永和,2023-07-12,9207
2382,廣達,162,28,134,凱基-永和,2023-07-12,9207
2376,技嘉,246,144,102,凱基-永和,2023-07-12,9207
3706,神達,821,757,64,凱基-永和,2023-07-12,9207
00712,復華富時不動產,52,0,52,凱基-永和,2023-07-12,9207
00687B,國泰20年美債,45,0,45,凱基-永和,2023-07-12,9207
6109,亞元,40,0,40,凱基-永和,2023-07-12,9207
1453,大將,130,100,30,凱基-永和,2023-07-12,9207
00673R,期元大S＆P原油反1,28,0,28,凱基-永和,2023-07-12,9207
8215,明基材,34,6,28,凱基-永和,2023-07-12,9207
2812,台中銀,20,0,20,凱基-永和,2023-07-12,9207
6142,友勁,20,0,20,凱基-永和,2023-07-12,9207
4763,材料-KY,20,1,19,凱基-永和,2023-07-12,9207
3704,合勤控,20,3,17,凱基-永和,2023-07-12,9207
1609,大亞,22,9,13,凱基-永和,2023-07-12,9207
2449,京元電子,11,0,11,凱基-永和,2023-07-12,9207
00905,FT臺灣Smart,11,0,11,凱基-永和,2023-07-12,9207
6182,合晶,12,1,11,凱基-永和,2023-07-12,9207
00918,大華優利高填息30,10,0,10,凱基-永和,2023-07-12,9207
6290,良維,12,2,10,凱基-永和,2023-07-12,9207
2356,英業達,30,21,9,凱基-永和,2023-07-12,9207
2303,聯電,24,15,9,凱基-永和,2023-07-12,9207
2460,建通,9,0,9,凱基-永和,2023-07-12,9207
00640L,富邦日本正2,8,0,8,凱基-永和,2023-07-12,9207
8069,元太,10,2,8,凱基-永和,2023-07-12,9207
5258,虹堡,15,8,7,凱基-永和,2023-07-12,9207
6104,創惟,7,0,7,凱基-永和,2023-07-12,9207
3037,欣興,7,1,6,凱基-永和,2023-07-12,9207
00679B,元大美債20年,6,0,6,凱基-永和,2023-07-12,9207
1584,精剛,6,0,6,凱基-永和,2023-07-12,9207
2038,海光,6,0,6,凱基-永和,2023-07-12,9207
3265,台星科,6,0,6,凱基-永和,2023-07-12,9207
00675L,富邦臺灣加權正2,5,0,5,凱基-永和,2023-07-12,9207
1720,生達,5,0,5,凱基-永和,2023-07-12,9207
1809,中釉,5,0,5,凱基-永和,2023-07-12,9207
2022,聚亨,5,0,5,凱基-永和,2023-07-12,9207
2633,台灣高鐵,5,0,5,凱基-永和,2023-07-12,9207
2889,國票金,5,0,5,凱基-永和,2023-07-12,9207
3481,群創,29,24,5,凱基-永和,2023-07-12,9207
6112,邁達特,5,0,5,凱基-永和,2023-07-12,9207
6153,嘉聯益,5,0,5,凱基-永和,2023-07-12,9207
6477,安集,5,0,5,凱基-永和,2023-07-12,9207
6582,申豐,5,0,5,凱基-永和,2023-07-12,9207
2481,強茂,30,25,5,凱基-永和,2023-07-12,9207
2603,長榮,10,6,4,凱基-永和,2023-07-12,9207
2365,昆盈,4,0,4,凱基-永和,2023-07-12,9207
2388,威盛,545,541,4,凱基-永和,2023-07-12,9207
2614,東森,5,1,4,凱基-永和,2023-07-12,9207
3558,神準,4,0,4,凱基-永和,2023-07-12,9207
2888,新光金,1200,10,1190,凱基-永和,2023-07-13,9207
3231,緯創,1970,1568,402,凱基-永和,2023-07-13,9207
3706,神達,600,311,289,凱基-永和,2023-07-13,9207
3013,晟銘電,200,5,195,凱基-永和,2023-07-13,9207
2368,金像電,186,3,183,凱基-永和,2023-07-13,9207
2887,台新金,100,0,100,凱基-永和,2023-07-13,9207
5457,宣德,104,6,98,凱基-永和,2023-07-13,9207
9945,潤泰新,89,0,89,凱基-永和,2023-07-13,9207
2610,華航,94,28,66,凱基-永和,2023-07-13,9207
00720B,元大投資級公司債,42,1,41,凱基-永和,2023-07-13,9207
2436,偉詮電,35,0,35,凱基-永和,2023-07-13,9207
8938,明安,33,0,33,凱基-永和,2023-07-13,9207
6109,亞元,30,0,30,凱基-永和,2023-07-13,9207
2883,凱基金,18,0,18,凱基-永和,2023-07-13,9207
8028,昇陽半導體,26,10,16,凱基-永和,2023-07-13,9207
2059,川湖,15,0,15,凱基-永和,2023-07-13,9207
3711,日月光投控,15,0,15,凱基-永和,2023-07-13,9207
00679B,元大美債20年,12,0,12,凱基-永和,2023-07-13,9207
1795,美時,11,0,11,凱基-永和,2023-07-13,9207
2457,飛宏,11,0,11,凱基-永和,2023-07-13,9207
2891,中信金,12,1,11,凱基-永和,2023-07-13,9207
6282,康舒,36,26,10,凱基-永和,2023-07-13,9207
1514,亞力,10,0,10,凱基-永和,2023-07-13,9207
2362,藍天,10,0,10,凱基-永和,2023-07-13,9207
2367,燿華,14,4,10,凱基-永和,2023-07-13,9207
2504,國產,10,0,10,凱基-永和,2023-07-13,9207
2701,萬企,10,0,10,凱基-永和,2023-07-13,9207
4953,緯軟,15,5,10,凱基-永和,2023-07-13,9207
6235,華孚,12,2,10,凱基-永和,2023-07-13,9207
2515,中工,10,0,10,凱基-永和,2023-07-13,9207
00930,永豐ESG低碳高息,9,0,9,凱基-永和,2023-07-13,9207
2634,漢翔,13,4,9,凱基-永和,2023-07-13,9207
00673R,期元大S＆P原油反1,8,0,8,凱基-永和,2023-07-13,9207
1218,泰山,7,0,7,凱基-永和,2023-07-13,9207
1609,大亞,7,0,7,凱基-永和,2023-07-13,9207
5230,雷笛克光學,7,0,7,凱基-永和,2023-07-13,9207
2324,仁寶,29,23,6,凱基-永和,2023-07-13,9207
5443,均豪,6,0,6,凱基-永和,2023-07-13,9207
8478,東哥遊艇,6,0,6,凱基-永和,2023-07-13,9207
6271,同欣電,5,0,5,凱基-永和,2023-07-13,9207
00632R,元大台灣50反1,25,20,5,凱基-永和,2023-07-13,9207
00675L,富邦臺灣加權正2,5,0,5,凱基-永和,2023-07-13,9207
00885,富邦越南,5,0,5,凱基-永和,2023-07-13,9207
00882,中信中國高股息,5,0,5,凱基-永和,2023-07-13,9207
00795B,中信美國公債20年,5,0,5,凱基-永和,2023-07-13,9207
6790,永豐實,5,0,5,凱基-永和,2023-07-13,9207
8358,金居,13,8,5,凱基-永和,2023-07-13,9207
2345,智邦,8,3,5,凱基-永和,2023-07-13,9207
6188,廣明,10,6,4,凱基-永和,2023-07-13,9207
2412,中華電,4,0,4,凱基-永和,2023-07-13,9207
2301,光寶科,987,385,602,凱基-永和,2023-07-14,9207
2356,英業達,2063,1547,516,凱基-永和,2023-07-14,9207
3037,欣興,512,34,478,凱基-永和,2023-07-14,9207
6841,長佳智能,101,0,101,凱基-永和,2023-07-14,9207
1519,華城,100,1,99,凱基-永和,2023-07-14,9207
4533,協易機,302,203,99,凱基-永和,2023-07-14,9207
3706,神達,503,406,97,凱基-永和,2023-07-14,9207
3035,智原,130,37,93,凱基-永和,2023-07-14,9207
2610,華航,119,27,92,凱基-永和,2023-07-14,9207
6187,萬潤,202,118,84,凱基-永和,2023-07-14,9207
2355,敬鵬,70,0,70,凱基-永和,2023-07-14,9207
00929,復華台灣科技優息,70,0,70,凱基-永和,2023-07-14,9207
2388,威盛,355,303,52,凱基-永和,2023-07-14,9207
2380,虹光,47,0,47,凱基-永和,2023-07-14,9207
4106,雃博,28,0,28,凱基-永和,2023-07-14,9207
00673R,期元大S＆P原油反1,27,0,27,凱基-永和,2023-07-14,9207
8092,建暐,24,0,24,凱基-永和,2023-07-14,9207
6124,業強,23,0,23,凱基-永和,2023-07-14,9207
2317,鴻海,34,12,22,凱基-永和,2023-07-14,9207
00633L,富邦上証正2,20,0,20,凱基-永和,2023-07-14,9207
2382,廣達,245,225,20,凱基-永和,2023-07-14,9207
2323,中環,14,0,14,凱基-永和,2023-07-14,9207
2344,華邦電,15,1,14,凱基-永和,2023-07-14,9207
3454,晶睿,13,0,13,凱基-永和,2023-07-14,9207
2482,連宇,12,0,12,凱基-永和,2023-07-14,9207
00708L,期元大S＆P黃金正2,11,0,11,凱基-永和,2023-07-14,9207
2607,榮運,11,0,11,凱基-永和,2023-07-14,9207
6120,達運,11,0,11,凱基-永和,2023-07-14,9207
1102,亞泥,10,0,10,凱基-永和,2023-07-14,9207
00634R,富邦上証反1,10,0,10,凱基-永和,2023-07-14,9207
4503,金雨,10,0,10,凱基-永和,2023-07-14,9207
5230,雷笛克光學,10,0,10,凱基-永和,2023-07-14,9207
2345,智邦,11,2,9,凱基-永和,2023-07-14,9207
00882,中信中國高股息,8,0,8,凱基-永和,2023-07-14,9207
3013,晟銘電,10,2,8,凱基-永和,2023-07-14,9207
6472,保瑞,8,0,8,凱基-永和,2023-07-14,9207
5465,富驊,7,0,7,凱基-永和,2023-07-14,9207
00632R,元大台灣50反1,11,4,7,凱基-永和,2023-07-14,9207
6188,廣明,13,6,7,凱基-永和,2023-07-14,9207
3036,文曄,7,1,6,凱基-永和,2023-07-14,9207
2633,台灣高鐵,6,0,6,凱基-永和,2023-07-14,9207
2340,台亞,12,6,6,凱基-永和,2023-07-14,9207
2915,潤泰全,6,0,6,凱基-永和,2023-07-14,9207
6190,萬泰科,10,4,6,凱基-永和,2023-07-14,9207
8021,尖點,15,10,5,凱基-永和,2023-07-14,9207
5483,中美晶,6,1,5,凱基-永和,2023-07-14,9207
00636,國泰中國A50,5,0,5,凱基-永和,2023-07-14,9207
00893,國泰智能電動車,17,12,5,凱基-永和,2023-07-14,9207
1417,嘉裕,5,0,5,凱基-永和,2023-07-14,9207
1514,亞力,5,0,5,凱基-永和,2023-07-14,9207
4938,和碩,1007,2,1005,凱基-永和,2023-07-17,9207
2356,英業達,1507,509,998,凱基-永和,2023-07-17,9207
6282,康舒,540,26,514,凱基-永和,2023-07-17,9207
2885,元大金,150,1,149,凱基-永和,2023-07-17,9207
2481,強茂,112,2,110,凱基-永和,2023-07-17,9207
00882,中信中國高股息,85,0,85,凱基-永和,2023-07-17,9207
2915,潤泰全,50,0,50,凱基-永和,2023-07-17,9207
2371,大同,2486,2448,38,凱基-永和,2023-07-17,9207
2355,敬鵬,40,3,37,凱基-永和,2023-07-17,9207
1560,中砂,33,0,33,凱基-永和,2023-07-17,9207
3022,威強電,37,4,33,凱基-永和,2023-07-17,9207
4532,瑞智,25,2,23,凱基-永和,2023-07-17,9207
00633L,富邦上証正2,20,0,20,凱基-永和,2023-07-17,9207
00929,復華台灣科技優息,52,33,19,凱基-永和,2023-07-17,9207
2610,華航,34,20,14,凱基-永和,2023-07-17,9207
1711,永光,43,30,13,凱基-永和,2023-07-17,9207
5351,鈺創,13,0,13,凱基-永和,2023-07-17,9207
2352,佳世達,17,5,12,凱基-永和,2023-07-17,9207
2892,第一金,12,0,12,凱基-永和,2023-07-17,9207
2421,建準,14,2,12,凱基-永和,2023-07-17,9207
2428,興勤,12,0,12,凱基-永和,2023-07-17,9207
3189,景碩,12,0,12,凱基-永和,2023-07-17,9207
1402,遠東新,11,0,11,凱基-永和,2023-07-17,9207
4533,協易機,34,23,11,凱基-永和,2023-07-17,9207
6235,華孚,12,2,10,凱基-永和,2023-07-17,9207
00673R,期元大S＆P原油反1,10,0,10,凱基-永和,2023-07-17,9207
1219,福壽,10,0,10,凱基-永和,2023-07-17,9207
1611,中電,10,0,10,凱基-永和,2023-07-17,9207
2009,第一銅,10,0,10,凱基-永和,2023-07-17,9207
2324,仁寶,33,23,10,凱基-永和,2023-07-17,9207
2362,藍天,10,0,10,凱基-永和,2023-07-17,9207
2482,連宇,10,0,10,凱基-永和,2023-07-17,9207
3081,聯亞,10,0,10,凱基-永和,2023-07-17,9207
3508,位速,10,0,10,凱基-永和,2023-07-17,9207
5876,上海商銀,10,0,10,凱基-永和,2023-07-17,9207
8040,九暘,10,0,10,凱基-永和,2023-07-17,9207
8210,勤誠,11,1,10,凱基-永和,2023-07-17,9207
9941,裕融,10,0,10,凱基-永和,2023-07-17,9207
2618,長榮航,16,7,9,凱基-永和,2023-07-17,9207
6129,普誠,12,4,8,凱基-永和,2023-07-17,9207
2353,宏��,14,6,8,凱基-永和,2023-07-17,9207
1301,台塑,7,0,7,凱基-永和,2023-07-17,9207
00642U,期元大S＆P石油,7,0,7,凱基-永和,2023-07-17,9207
00679B,元大美債20年,7,0,7,凱基-永和,2023-07-17,9207
2204,中華,7,0,7,凱基-永和,2023-07-17,9207
4106,雃博,7,0,7,凱基-永和,2023-07-17,9207
6218,豪勉,7,0,7,凱基-永和,2023-07-17,9207
00753L,中信中國50正2,6,0,6,凱基-永和,2023-07-17,9207
1582,信錦,6,0,6,凱基-永和,2023-07-17,9207
6767,台微醫,6,0,6,凱基-永和,2023-07-17,9207
2888,新光金,1500,3,1497,凱基-永和,2023-07-18,9207
2329,華泰,944,327,617,凱基-永和,2023-07-18,9207
2421,建準,222,115,107,凱基-永和,2023-07-18,9207
8201,無敵,100,0,100,凱基-永和,2023-07-18,9207
3022,威強電,41,0,41,凱基-永和,2023-07-18,9207
6142,友勁,40,0,40,凱基-永和,2023-07-18,9207
3231,緯創,40,3,37,凱基-永和,2023-07-18,9207
3443,創意,37,0,37,凱基-永和,2023-07-18,9207
2359,所羅門,34,0,34,凱基-永和,2023-07-18,9207
0056,元大高股息,44,14,30,凱基-永和,2023-07-18,9207
2915,潤泰全,30,0,30,凱基-永和,2023-07-18,9207
4979,華星光,29,0,29,凱基-永和,2023-07-18,9207
8936,國統,26,0,26,凱基-永和,2023-07-18,9207
3706,神達,478,454,24,凱基-永和,2023-07-18,9207
00878,國泰永續高股息,25,4,21,凱基-永和,2023-07-18,9207
00632R,元大台灣50反1,20,0,20,凱基-永和,2023-07-18,9207
2883,凱基金,16,0,16,凱基-永和,2023-07-18,9207
1514,亞力,16,1,15,凱基-永和,2023-07-18,9207
00715L,期街口布蘭特正2,15,0,15,凱基-永和,2023-07-18,9207
2340,台亞,17,2,15,凱基-永和,2023-07-18,9207
2344,華邦電,15,0,15,凱基-永和,2023-07-18,9207
6488,環球晶,15,0,15,凱基-永和,2023-07-18,9207
3481,群創,31,16,15,凱基-永和,2023-07-18,9207
00679B,元大美債20年,20,6,14,凱基-永和,2023-07-18,9207
5469,瀚宇博,17,3,14,凱基-永和,2023-07-18,9207
9937,全國,13,0,13,凱基-永和,2023-07-18,9207
1218,泰山,12,0,12,凱基-永和,2023-07-18,9207
00720B,元大投資級公司債,12,0,12,凱基-永和,2023-07-18,9207
5230,雷笛克光學,12,0,12,凱基-永和,2023-07-18,9207
5531,鄉林,12,0,12,凱基-永和,2023-07-18,9207
8358,金居,14,2,12,凱基-永和,2023-07-18,9207
1605,華新,13,3,10,凱基-永和,2023-07-18,9207
00772B,中信高評級公司債,10,0,10,凱基-永和,2023-07-18,9207
1312,國喬,10,0,10,凱基-永和,2023-07-18,9207
2323,中環,12,2,10,凱基-永和,2023-07-18,9207
2504,國產,10,0,10,凱基-永和,2023-07-18,9207
2618,長榮航,20,10,10,凱基-永和,2023-07-18,9207
2886,兆豐金,11,1,10,凱基-永和,2023-07-18,9207
3046,建��,12,2,10,凱基-永和,2023-07-18,9207
6806,森崴能源,17,7,10,凱基-永和,2023-07-18,9207
8092,建暐,10,0,10,凱基-永和,2023-07-18,9207
2331,精英,10,1,9,凱基-永和,2023-07-18,9207
6150,撼訊,9,0,9,凱基-永和,2023-07-18,9207
00687B,國泰20年美債,8,0,8,凱基-永和,2023-07-18,9207
3227,原相,10,2,8,凱基-永和,2023-07-18,9207
2353,宏��,750,742,8,凱基-永和,2023-07-18,9207
2002,中鋼,7,0,7,凱基-永和,2023-07-18,9207
2748,雲品,7,0,7,凱基-永和,2023-07-18,9207
3357,臺慶科,7,0,7,凱基-永和,2023-07-18,9207
6191,精成科,7,0,7,凱基-永和,2023-07-18,9207
2317,鴻海,321,2,319,凱基-永和,2023-07-19,9207
00772B,中信高評級公司債,100,2,98,凱基-永和,2023-07-19,9207
9945,潤泰新,81,0,81,凱基-永和,2023-07-19,9207
3231,緯創,113,32,81,凱基-永和,2023-07-19,9207
00929,復華台灣科技優息,57,0,57,凱基-永和,2023-07-19,9207
2324,仁寶,95,45,50,凱基-永和,2023-07-19,9207
2610,華航,49,1,48,凱基-永和,2023-07-19,9207
00753L,中信中國50正2,30,0,30,凱基-永和,2023-07-19,9207
2303,聯電,26,3,23,凱基-永和,2023-07-19,9207
2002,中鋼,22,0,22,凱基-永和,2023-07-19,9207
2881,富邦金,24,3,21,凱基-永和,2023-07-19,9207
2405,輔信,27,7,20,凱基-永和,2023-07-19,9207
3022,威強電,18,0,18,凱基-永和,2023-07-19,9207
2331,精英,16,1,15,凱基-永和,2023-07-19,9207
2353,宏��,32,17,15,凱基-永和,2023-07-19,9207
1101,台泥,18,4,14,凱基-永和,2023-07-19,9207
2351,順德,14,0,14,凱基-永和,2023-07-19,9207
2419,仲琦,14,2,12,凱基-永和,2023-07-19,9207
2486,一詮,13,1,12,凱基-永和,2023-07-19,9207
2618,長榮航,19,7,12,凱基-永和,2023-07-19,9207
4938,和碩,17,5,12,凱基-永和,2023-07-19,9207
00882,中信中國高股息,11,0,11,凱基-永和,2023-07-19,9207
1301,台塑,11,0,11,凱基-永和,2023-07-19,9207
2059,川湖,11,0,11,凱基-永和,2023-07-19,9207
2458,義隆,21,10,11,凱基-永和,2023-07-19,9207
3138,耀登,10,0,10,凱基-永和,2023-07-19,9207
3693,營邦,10,0,10,凱基-永和,2023-07-19,9207
4142,國光生,10,0,10,凱基-永和,2023-07-19,9207
6150,撼訊,10,0,10,凱基-永和,2023-07-19,9207
6547,高端疫苗,10,0,10,凱基-永和,2023-07-19,9207
3661,世芯-KY,55,45,10,凱基-永和,2023-07-19,9207
1402,遠東新,11,1,10,凱基-永和,2023-07-19,9207
2609,陽明,17,7,10,凱基-永和,2023-07-19,9207
2887,台新金,10,1,9,凱基-永和,2023-07-19,9207
3450,聯鈞,9,0,9,凱基-永和,2023-07-19,9207
5469,瀚宇博,10,1,9,凱基-永和,2023-07-19,9207
6657,華安,14,5,9,凱基-永和,2023-07-19,9207
2812,台中銀,9,0,9,凱基-永和,2023-07-19,9207
2634,漢翔,9,1,8,凱基-永和,2023-07-19,9207
4979,華星光,9,1,8,凱基-永和,2023-07-19,9207
2412,中華電,7,0,7,凱基-永和,2023-07-19,9207
6104,創惟,10,3,7,凱基-永和,2023-07-19,9207
8046,南電,7,0,7,凱基-永和,2023-07-19,9207
2352,佳世達,6,0,6,凱基-永和,2023-07-19,9207
3003,健和興,6,0,6,凱基-永和,2023-07-19,9207
6188,廣明,6,0,6,凱基-永和,2023-07-19,9207
3105,穩懋,7,1,6,凱基-永和,2023-07-19,9207
00851,台新全球AI,5,0,5,凱基-永和,2023-07-19,9207
1313,聯成,5,0,5,凱基-永和,2023-07-19,9207
1905,華紙,5,0,5,凱基-永和,2023-07-19,9207
2888,新光金,1100,15,1085,凱基-永和,2023-07-20,9207
2324,仁寶,324,24,300,凱基-永和,2023-07-20,9207
2421,建準,151,6,145,凱基-永和,2023-07-20,9207
4938,和碩,150,14,136,凱基-永和,2023-07-20,9207
3013,晟銘電,100,4,96,凱基-永和,2023-07-20,9207
8033,雷虎,87,0,87,凱基-永和,2023-07-20,9207
2303,聯電,112,49,63,凱基-永和,2023-07-20,9207
1815,富喬,55,5,50,凱基-永和,2023-07-20,9207
2301,光寶科,53,3,50,凱基-永和,2023-07-20,9207
00720B,元大投資級公司債,41,0,41,凱基-永和,2023-07-20,9207
00680L,元大美債20正2,38,0,38,凱基-永和,2023-07-20,9207
4979,華星光,38,0,38,凱基-永和,2023-07-20,9207
5475,德宏,36,0,36,凱基-永和,2023-07-20,9207
00881,國泰台灣5G+,38,3,35,凱基-永和,2023-07-20,9207
1529,樂事綠能,26,0,26,凱基-永和,2023-07-20,9207
2317,鴻海,23,2,21,凱基-永和,2023-07-20,9207
2504,國產,20,0,20,凱基-永和,2023-07-20,9207
9945,潤泰新,20,0,20,凱基-永和,2023-07-20,9207
2405,輔信,21,4,17,凱基-永和,2023-07-20,9207
2461,光群雷,21,4,17,凱基-永和,2023-07-20,9207
00893,國泰智能電動車,15,0,15,凱基-永和,2023-07-20,9207
8403,盛弘,15,0,15,凱基-永和,2023-07-20,9207
3191,雲嘉南,14,0,14,凱基-永和,2023-07-20,9207
2206,三陽工業,59,47,12,凱基-永和,2023-07-20,9207
2313,華通,12,1,11,凱基-永和,2023-07-20,9207
1513,中興電,11,0,11,凱基-永和,2023-07-20,9207
2030,彰源,10,0,10,凱基-永和,2023-07-20,9207
2915,潤泰全,10,0,10,凱基-永和,2023-07-20,9207
8092,建暐,10,0,10,凱基-永和,2023-07-20,9207
1522,堤維西,13,4,9,凱基-永和,2023-07-20,9207
1795,美時,17,8,9,凱基-永和,2023-07-20,9207
2436,偉詮電,35,26,9,凱基-永和,2023-07-20,9207
5243,乙盛-KY,10,1,9,凱基-永和,2023-07-20,9207
2314,台揚,8,0,8,凱基-永和,2023-07-20,9207
5388,中磊,10,2,8,凱基-永和,2023-07-20,9207
6187,萬潤,10,2,8,凱基-永和,2023-07-20,9207
3289,宜特,10,3,7,凱基-永和,2023-07-20,9207
2329,華泰,23,16,7,凱基-永和,2023-07-20,9207
2453,凌群,8,1,7,凱基-永和,2023-07-20,9207
2618,長榮航,14,7,7,凱基-永和,2023-07-20,9207
4123,晟德,10,3,7,凱基-永和,2023-07-20,9207
8358,金居,12,5,7,凱基-永和,2023-07-20,9207
1102,亞泥,6,0,6,凱基-永和,2023-07-20,9207
1789,神隆,6,0,6,凱基-永和,2023-07-20,9207
8071,能率網通,7,1,6,凱基-永和,2023-07-20,9207
2834,臺企銀,5,0,5,凱基-永和,2023-07-20,9207
00753L,中信中國50正2,5,0,5,凱基-永和,2023-07-20,9207
00752,中信中國50,5,0,5,凱基-永和,2023-07-20,9207
00882,中信中國高股息,5,0,5,凱基-永和,2023-07-20,9207
1536,和大,5,0,5,凱基-永和,2023-07-20,9207
2888,新光金,1250,0,1250,凱基-永和,2023-07-21,9207
2301,光寶科,652,252,400,凱基-永和,2023-07-21,9207
2382,廣達,860,561,299,凱基-永和,2023-07-21,9207
9945,潤泰新,169,0,169,凱基-永和,2023-07-21,9207
2457,飛宏,99,0,99,凱基-永和,2023-07-21,9207
3035,智原,104,14,90,凱基-永和,2023-07-21,9207
1513,中興電,503,421,82,凱基-永和,2023-07-21,9207
1903,士紙,62,2,60,凱基-永和,2023-07-21,9207
2425,承啟,61,1,60,凱基-永和,2023-07-21,9207
5512,力麒,50,0,50,凱基-永和,2023-07-21,9207
2388,威盛,101,60,41,凱基-永和,2023-07-21,9207
00633L,富邦上証正2,40,0,40,凱基-永和,2023-07-21,9207
2883,凱基金,32,0,32,凱基-永和,2023-07-21,9207
2344,華邦電,64,34,30,凱基-永和,2023-07-21,9207
00680L,元大美債20正2,30,0,30,凱基-永和,2023-07-21,9207
2915,潤泰全,30,0,30,凱基-永和,2023-07-21,9207
3017,奇鋐,32,6,26,凱基-永和,2023-07-21,9207
00881,國泰台灣5G+,21,0,21,凱基-永和,2023-07-21,9207
1529,樂事綠能,18,3,15,凱基-永和,2023-07-21,9207
2419,仲琦,21,6,15,凱基-永和,2023-07-21,9207
00922,國泰台灣領袖50,14,0,14,凱基-永和,2023-07-21,9207
2303,聯電,15,2,13,凱基-永和,2023-07-21,9207
3071,協禧,13,0,13,凱基-永和,2023-07-21,9207
2206,三陽工業,26,14,12,凱基-永和,2023-07-21,9207
2412,中華電,12,0,12,凱基-永和,2023-07-21,9207
0056,元大高股息,21,10,11,凱基-永和,2023-07-21,9207
2351,順德,11,0,11,凱基-永和,2023-07-21,9207
2881,富邦金,11,1,10,凱基-永和,2023-07-21,9207
1218,泰山,10,0,10,凱基-永和,2023-07-21,9207
00688L,國泰20年美債正2,10,0,10,凱基-永和,2023-07-21,9207
2504,國產,10,0,10,凱基-永和,2023-07-21,9207
5475,德宏,10,0,10,凱基-永和,2023-07-21,9207
5607,遠雄港,11,1,10,凱基-永和,2023-07-21,9207
8403,盛弘,10,1,9,凱基-永和,2023-07-21,9207
2405,輔信,9,0,9,凱基-永和,2023-07-21,9207
4123,晟德,10,1,9,凱基-永和,2023-07-21,9207
6282,康舒,14,5,9,凱基-永和,2023-07-21,9207
9937,全國,9,0,9,凱基-永和,2023-07-21,9207
2436,偉詮電,14,6,8,凱基-永和,2023-07-21,9207
4755,三福化,8,0,8,凱基-永和,2023-07-21,9207
6266,泰詠,8,0,8,凱基-永和,2023-07-21,9207
2482,連宇,7,0,7,凱基-永和,2023-07-21,9207
3305,昇貿,7,0,7,凱基-永和,2023-07-21,9207
6530,創威,7,0,7,凱基-永和,2023-07-21,9207
2609,陽明,15,8,7,凱基-永和,2023-07-21,9207
3324,雙鴻,9,2,7,凱基-永和,2023-07-21,9207
00893,國泰智能電動車,11,5,6,凱基-永和,2023-07-21,9207
1309,台達化,6,0,6,凱基-永和,2023-07-21,9207
2377,微星,6,0,6,凱基-永和,2023-07-21,9207
8215,明基材,6,0,6,凱基-永和,2023-07-21,9207
2888,新光金,1625,0,1625,凱基-永和,2023-07-24,9207
1905,華紙,304,33,271,凱基-永和,2023-07-24,9207
5452,佶優,112,0,112,凱基-永和,2023-07-24,9207
2382,廣達,151,48,103,凱基-永和,2023-07-24,9207
3564,其陽,66,0,66,凱基-永和,2023-07-24,9207
2357,華碩,211,150,61,凱基-永和,2023-07-24,9207
6443,元晶,52,1,51,凱基-永和,2023-07-24,9207
2887,台新金,34,0,34,凱基-永和,2023-07-24,9207
00680L,元大美債20正2,30,0,30,凱基-永和,2023-07-24,9207
1504,東元,26,1,25,凱基-永和,2023-07-24,9207
6196,帆宣,23,0,23,凱基-永和,2023-07-24,9207
6109,亞元,22,0,22,凱基-永和,2023-07-24,9207
2886,兆豐金,21,0,21,凱基-永和,2023-07-24,9207
5243,乙盛-KY,21,0,21,凱基-永和,2023-07-24,9207
00885,富邦越南,20,0,20,凱基-永和,2023-07-24,9207
3324,雙鴻,21,2,19,凱基-永和,2023-07-24,9207
3013,晟銘電,40,22,18,凱基-永和,2023-07-24,9207
00900,富邦特選高股息30,16,0,16,凱基-永和,2023-07-24,9207
3306,鼎天,16,0,16,凱基-永和,2023-07-24,9207
2323,中環,15,0,15,凱基-永和,2023-07-24,9207
6282,康舒,35,21,14,凱基-永和,2023-07-24,9207
3706,神達,17,4,13,凱基-永和,2023-07-24,9207
4729,熒茂,13,0,13,凱基-永和,2023-07-24,9207
1402,遠東新,12,0,12,凱基-永和,2023-07-24,9207
2317,鴻海,12,1,11,凱基-永和,2023-07-24,9207
3046,建��,13,2,11,凱基-永和,2023-07-24,9207
1785,光洋科,15,5,10,凱基-永和,2023-07-24,9207
00919,群益台灣精選高息,11,1,10,凱基-永和,2023-07-24,9207
00633L,富邦上証正2,10,0,10,凱基-永和,2023-07-24,9207
00764B,群益25年美債,10,0,10,凱基-永和,2023-07-24,9207
1734,杏輝,10,0,10,凱基-永和,2023-07-24,9207
2331,精英,10,0,10,凱基-永和,2023-07-24,9207
5531,鄉林,12,2,10,凱基-永和,2023-07-24,9207
6121,新普,10,0,10,凱基-永和,2023-07-24,9207
6288,聯嘉,26,16,10,凱基-永和,2023-07-24,9207
6582,申豐,10,0,10,凱基-永和,2023-07-24,9207
00722B,群益投資級電信債,9,0,9,凱基-永和,2023-07-24,9207
00929,復華台灣科技優息,10,1,9,凱基-永和,2023-07-24,9207
3308,聯德,9,0,9,凱基-永和,2023-07-24,9207
3704,合勤控,10,1,9,凱基-永和,2023-07-24,9207
4533,協易機,9,0,9,凱基-永和,2023-07-24,9207
6219,富旺,9,0,9,凱基-永和,2023-07-24,9207
6874,倍力,9,0,9,凱基-永和,2023-07-24,9207
3481,群創,15,7,8,凱基-永和,2023-07-24,9207
2891,中信金,10,3,7,凱基-永和,2023-07-24,9207
3508,位速,7,0,7,凱基-永和,2023-07-24,9207
2603,長榮,7,1,6,凱基-永和,2023-07-24,9207
2338,光罩,6,0,6,凱基-永和,2023-07-24,9207
2610,華航,14,8,6,凱基-永和,2023-07-24,9207
2356,英業達,13,7,6,凱基-永和,2023-07-24,9207
2888,新光金,1300,1,1299,凱基-永和,2023-07-25,9207
6188,廣明,221,20,201,凱基-永和,2023-07-25,9207
6274,台燿,346,211,135,凱基-永和,2023-07-25,9207
1513,中興電,110,6,104,凱基-永和,2023-07-25,9207
5258,虹堡,125,32,93,凱基-永和,2023-07-25,9207
8358,金居,305,227,78,凱基-永和,2023-07-25,9207
2382,廣達,508,432,76,凱基-永和,2023-07-25,9207
3583,辛耘,100,50,50,凱基-永和,2023-07-25,9207
2887,台新金,50,0,50,凱基-永和,2023-07-25,9207
2344,華邦電,40,0,40,凱基-永和,2023-07-25,9207
00633L,富邦上証正2,39,0,39,凱基-永和,2023-07-25,9207
00713,元大台灣高息低波,32,0,32,凱基-永和,2023-07-25,9207
3443,創意,30,0,30,凱基-永和,2023-07-25,9207
00680L,元大美債20正2,30,0,30,凱基-永和,2023-07-25,9207
8028,昇陽半導體,30,1,29,凱基-永和,2023-07-25,9207
4106,雃博,25,0,25,凱基-永和,2023-07-25,9207
5392,能率,22,0,22,凱基-永和,2023-07-25,9207
1101,台泥,21,2,19,凱基-永和,2023-07-25,9207
3231,緯創,16,1,15,凱基-永和,2023-07-25,9207
6290,良維,13,0,13,凱基-永和,2023-07-25,9207
2404,漢唐,12,0,12,凱基-永和,2023-07-25,9207
1905,華紙,28,17,11,凱基-永和,2023-07-25,9207
2457,飛宏,11,0,11,凱基-永和,2023-07-25,9207
00893,國泰智能電動車,20,10,10,凱基-永和,2023-07-25,9207
4543,萬在,11,1,10,凱基-永和,2023-07-25,9207
6182,合晶,10,0,10,凱基-永和,2023-07-25,9207
6214,精誠,9,0,9,凱基-永和,2023-07-25,9207
2609,陽明,9,1,8,凱基-永和,2023-07-25,9207
3706,神達,11,3,8,凱基-永和,2023-07-25,9207
2449,京元電子,7,0,7,凱基-永和,2023-07-25,9207
3481,群創,7,0,7,凱基-永和,2023-07-25,9207
3036,文曄,11,4,7,凱基-永和,2023-07-25,9207
00679B,元大美債20年,7,0,7,凱基-永和,2023-07-25,9207
00712,復華富時不動產,6,0,6,凱基-永和,2023-07-25,9207
4729,熒茂,6,0,6,凱基-永和,2023-07-25,9207
6138,茂達,7,1,6,凱基-永和,2023-07-25,9207
6257,矽格,7,1,6,凱基-永和,2023-07-25,9207
2603,長榮,6,0,6,凱基-永和,2023-07-25,9207
1229,聯華,5,0,5,凱基-永和,2023-07-25,9207
1417,嘉裕,5,0,5,凱基-永和,2023-07-25,9207
3059,華晶科,5,0,5,凱基-永和,2023-07-25,9207
3541,西柏,5,0,5,凱基-永和,2023-07-25,9207
4129,聯合,13,8,5,凱基-永和,2023-07-25,9207
4714,永捷,5,0,5,凱基-永和,2023-07-25,9207
3702,大聯大,4,0,4,凱基-永和,2023-07-25,9207
2303,聯電,6,2,4,凱基-永和,2023-07-25,9207
2323,中環,6,2,4,凱基-永和,2023-07-25,9207
2327,國巨,4,0,4,凱基-永和,2023-07-25,9207
2461,光群雷,10,6,4,凱基-永和,2023-07-25,9207
2913,農林,4,0,4,凱基-永和,2023-07-25,9207
2888,新光金,1499,104,1395,凱基-永和,2023-07-26,9207
4979,華星光,57,0,57,凱基-永和,2023-07-26,9207
2382,廣達,68,22,46,凱基-永和,2023-07-26,9207
2453,凌群,112,68,44,凱基-永和,2023-07-26,9207
3131,弘塑,44,0,44,凱基-永和,2023-07-26,9207
6791,虎門科技,42,0,42,凱基-永和,2023-07-26,9207
00680L,元大美債20正2,30,0,30,凱基-永和,2023-07-26,9207
8478,東哥遊艇,30,1,29,凱基-永和,2023-07-26,9207
2303,聯電,30,3,27,凱基-永和,2023-07-26,9207
3450,聯鈞,21,1,20,凱基-永和,2023-07-26,9207
8028,昇陽半導體,20,0,20,凱基-永和,2023-07-26,9207
6117,迎廣,21,4,17,凱基-永和,2023-07-26,9207
00633L,富邦上証正2,17,0,17,凱基-永和,2023-07-26,9207
6124,業強,16,0,16,凱基-永和,2023-07-26,9207
4726,永昕,15,0,15,凱基-永和,2023-07-26,9207
00878,國泰永續高股息,22,7,15,凱基-永和,2023-07-26,9207
2887,台新金,12,0,12,凱基-永和,2023-07-26,9207
1618,合機,242,230,12,凱基-永和,2023-07-26,9207
2027,大成鋼,12,0,12,凱基-永和,2023-07-26,9207
4533,協易機,30,18,12,凱基-永和,2023-07-26,9207
2344,華邦電,11,0,11,凱基-永和,2023-07-26,9207
6187,萬潤,11,0,11,凱基-永和,2023-07-26,9207
2301,光寶科,22,12,10,凱基-永和,2023-07-26,9207
1319,東陽,11,1,10,凱基-永和,2023-07-26,9207
1313,聯成,10,0,10,凱基-永和,2023-07-26,9207
3441,聯一光,10,0,10,凱基-永和,2023-07-26,9207
6219,富旺,10,0,10,凱基-永和,2023-07-26,9207
6806,森崴能源,10,0,10,凱基-永和,2023-07-26,9207
2353,宏��,12,3,9,凱基-永和,2023-07-26,9207
00924,復華S＆P500成長,9,0,9,凱基-永和,2023-07-26,9207
2883,凱基金,12,3,9,凱基-永和,2023-07-26,9207
1513,中興電,8,0,8,凱基-永和,2023-07-26,9207
2618,長榮航,10,2,8,凱基-永和,2023-07-26,9207
1504,東元,31,24,7,凱基-永和,2023-07-26,9207
2356,英業達,8,1,7,凱基-永和,2023-07-26,9207
00919,群益台灣精選高息,7,0,7,凱基-永和,2023-07-26,9207
2891,中信金,13,6,7,凱基-永和,2023-07-26,9207
9940,信義,7,0,7,凱基-永和,2023-07-26,9207
3055,蔚華科,7,0,7,凱基-永和,2023-07-26,9207
3702,大聯大,6,0,6,凱基-永和,2023-07-26,9207
3105,穩懋,6,0,6,凱基-永和,2023-07-26,9207
2329,華泰,272,266,6,凱基-永和,2023-07-26,9207
3189,景碩,6,0,6,凱基-永和,2023-07-26,9207
5386,青雲,10,4,6,凱基-永和,2023-07-26,9207
5483,中美晶,7,1,6,凱基-永和,2023-07-26,9207
6841,長佳智能,6,0,6,凱基-永和,2023-07-26,9207
1795,美時,10,5,5,凱基-永和,2023-07-26,9207
2014,中鴻,5,0,5,凱基-永和,2023-07-26,9207
3044,健鼎,18,13,5,凱基-永和,2023-07-26,9207
3338,泰碩,17,12,5,凱基-永和,2023-07-26,9207
2913,農林,607,12,595,凱基-永和,2023-07-27,9207
2888,新光金,499,27,472,凱基-永和,2023-07-27,9207
1905,華紙,302,28,274,凱基-永和,2023-07-27,9207
2329,華泰,831,623,208,凱基-永和,2023-07-27,9207
5452,佶優,182,8,174,凱基-永和,2023-07-27,9207
3231,緯創,129,1,128,凱基-永和,2023-07-27,9207
3029,零壹,111,2,109,凱基-永和,2023-07-27,9207
00772B,中信高評級公司債,102,0,102,凱基-永和,2023-07-27,9207
1513,中興電,103,2,101,凱基-永和,2023-07-27,9207
1453,大將,100,0,100,凱基-永和,2023-07-27,9207
3035,智原,101,1,100,凱基-永和,2023-07-27,9207
3289,宜特,71,1,70,凱基-永和,2023-07-27,9207
6133,金橋,66,0,66,凱基-永和,2023-07-27,9207
8110,華東,60,0,60,凱基-永和,2023-07-27,9207
3014,聯陽,58,7,51,凱基-永和,2023-07-27,9207
6161,捷波,51,0,51,凱基-永和,2023-07-27,9207
2324,仁寶,35,0,35,凱基-永和,2023-07-27,9207
00680L,元大美債20正2,30,0,30,凱基-永和,2023-07-27,9207
4533,協易機,53,23,30,凱基-永和,2023-07-27,9207
8358,金居,109,83,26,凱基-永和,2023-07-27,9207
3205,佰研,23,0,23,凱基-永和,2023-07-27,9207
6491,晶碩,21,0,21,凱基-永和,2023-07-27,9207
3017,奇鋐,19,0,19,凱基-永和,2023-07-27,9207
3284,太普高,17,0,17,凱基-永和,2023-07-27,9207
3191,雲嘉南,20,4,16,凱基-永和,2023-07-27,9207
5425,台半,15,0,15,凱基-永和,2023-07-27,9207
3037,欣興,23,9,14,凱基-永和,2023-07-27,9207
6188,廣明,76,63,13,凱基-永和,2023-07-27,9207
1313,聯成,21,10,11,凱基-永和,2023-07-27,9207
2535,達欣工,11,0,11,凱基-永和,2023-07-27,9207
6190,萬泰科,11,0,11,凱基-永和,2023-07-27,9207
2352,佳世達,11,0,11,凱基-永和,2023-07-27,9207
2027,大成鋼,10,0,10,凱基-永和,2023-07-27,9207
3265,台星科,15,5,10,凱基-永和,2023-07-27,9207
5905,南仁湖,10,0,10,凱基-永和,2023-07-27,9207
6834,天二科技,10,0,10,凱基-永和,2023-07-27,9207
00633L,富邦上証正2,9,0,9,凱基-永和,2023-07-27,9207
2419,仲琦,14,5,9,凱基-永和,2023-07-27,9207
3363,上詮,10,1,9,凱基-永和,2023-07-27,9207
2884,玉山金,9,0,9,凱基-永和,2023-07-27,9207
2471,資通,21,13,8,凱基-永和,2023-07-27,9207
3693,營邦,8,0,8,凱基-永和,2023-07-27,9207
00655L,國泰中國A50正2,9,2,7,凱基-永和,2023-07-27,9207
1504,東元,10,3,7,凱基-永和,2023-07-27,9207
2382,廣達,15,8,7,凱基-永和,2023-07-27,9207
2609,陽明,9,2,7,凱基-永和,2023-07-27,9207
3264,欣銓,7,0,7,凱基-永和,2023-07-27,9207
00687B,國泰20年美債,6,0,6,凱基-永和,2023-07-27,9207
00900,富邦特選高股息30,9,3,6,凱基-永和,2023-07-27,9207
2014,中鴻,6,0,6,凱基-永和,2023-07-27,9207
2888,新光金,1123,6,1117,凱基-永和,2023-07-28,9207
2618,長榮航,251,1,250,凱基-永和,2023-07-28,9207
3587,閎康,150,25,125,凱基-永和,2023-07-28,9207
6231,系微,102,0,102,凱基-永和,2023-07-28,9207
00680L,元大美債20正2,80,0,80,凱基-永和,2023-07-28,9207
1802,台玻,58,2,56,凱基-永和,2023-07-28,9207
6217,中探針,51,3,48,凱基-永和,2023-07-28,9207
00679B,元大美債20年,47,0,47,凱基-永和,2023-07-28,9207
2357,華碩,71,25,46,凱基-永和,2023-07-28,9207
2369,菱生,41,1,40,凱基-永和,2023-07-28,9207
00633L,富邦上証正2,36,0,36,凱基-永和,2023-07-28,9207
1907,永豐餘,34,3,31,凱基-永和,2023-07-28,9207
3083,網龍,41,10,31,凱基-永和,2023-07-28,9207
6491,晶碩,31,0,31,凱基-永和,2023-07-28,9207
00752,中信中國50,30,0,30,凱基-永和,2023-07-28,9207
2891,中信金,40,10,30,凱基-永和,2023-07-28,9207
2885,元大金,30,1,29,凱基-永和,2023-07-28,9207
3163,波若威,68,47,21,凱基-永和,2023-07-28,9207
2356,英業達,31,10,21,凱基-永和,2023-07-28,9207
2412,中華電,20,0,20,凱基-永和,2023-07-28,9207
3191,雲嘉南,20,0,20,凱基-永和,2023-07-28,9207
2419,仲琦,19,1,18,凱基-永和,2023-07-28,9207
00687B,國泰20年美債,16,0,16,凱基-永和,2023-07-28,9207
5285,界霖,18,3,15,凱基-永和,2023-07-28,9207
5475,德宏,16,1,15,凱基-永和,2023-07-28,9207
00772B,中信高評級公司債,13,0,13,凱基-永和,2023-07-28,9207
2014,中鴻,13,0,13,凱基-永和,2023-07-28,9207
5388,中磊,13,1,12,凱基-永和,2023-07-28,9207
00674R,期元大S＆P黃金反1,10,0,10,凱基-永和,2023-07-28,9207
2535,達欣工,10,0,10,凱基-永和,2023-07-28,9207
3346,麗清,10,0,10,凱基-永和,2023-07-28,9207
3576,聯合再生,10,0,10,凱基-永和,2023-07-28,9207
2337,旺宏,12,3,9,凱基-永和,2023-07-28,9207
2408,南亞科,12,4,8,凱基-永和,2023-07-28,9207
2610,華航,11,3,8,凱基-永和,2023-07-28,9207
2838,聯邦銀,8,0,8,凱基-永和,2023-07-28,9207
6443,元晶,8,0,8,凱基-永和,2023-07-28,9207
6533,晶心科,11,3,8,凱基-永和,2023-07-28,9207
6535,順藥,10,2,8,凱基-永和,2023-07-28,9207
1319,東陽,14,7,7,凱基-永和,2023-07-28,9207
2617,台航,9,2,7,凱基-永和,2023-07-28,9207
8234,新漢,7,0,7,凱基-永和,2023-07-28,9207
2027,大成鋼,12,5,7,凱基-永和,2023-07-28,9207
00632R,元大台灣50反1,6,0,6,凱基-永和,2023-07-28,9207
3704,合勤控,7,1,6,凱基-永和,2023-07-28,9207
00795B,中信美國公債20年,5,0,5,凱基-永和,2023-07-28,9207
00923,群益台ESG低碳50,5,0,5,凱基-永和,2023-07-28,9207
00671R,富邦NASDAQ反1,5,0,5,凱基-永和,2023-07-28,9207
2401,凌陽,5,0,5,凱基-永和,2023-07-28,9207
2441,超豐,5,0,5,凱基-永和,2023-07-28,9207
2885,元大金,300,1,299,凱基-永和,2023-07-31,9207
2308,台達電,92,3,89,凱基-永和,2023-07-31,9207
3596,智易,70,0,70,凱基-永和,2023-07-31,9207
4919,新唐,60,3,57,凱基-永和,2023-07-31,9207
2607,榮運,50,0,50,凱基-永和,2023-07-31,9207
00929,復華台灣科技優息,44,0,44,凱基-永和,2023-07-31,9207
00725B,國泰投資級公司債,43,0,43,凱基-永和,2023-07-31,9207
2324,仁寶,86,43,43,凱基-永和,2023-07-31,9207
3231,緯創,1064,1023,41,凱基-永和,2023-07-31,9207
2883,凱基金,42,1,41,凱基-永和,2023-07-31,9207
1477,聚陽,42,1,41,凱基-永和,2023-07-31,9207
6161,捷波,35,0,35,凱基-永和,2023-07-31,9207
2382,廣達,412,377,35,凱基-永和,2023-07-31,9207
2610,華航,34,4,30,凱基-永和,2023-07-31,9207
2303,聯電,27,2,25,凱基-永和,2023-07-31,9207
00633L,富邦上証正2,28,3,25,凱基-永和,2023-07-31,9207
00795B,中信美國公債20年,24,0,24,凱基-永和,2023-07-31,9207
6202,盛群,21,0,21,凱基-永和,2023-07-31,9207
2412,中華電,20,0,20,凱基-永和,2023-07-31,9207
2891,中信金,24,5,19,凱基-永和,2023-07-31,9207
6116,彩晶,18,0,18,凱基-永和,2023-07-31,9207
00752,中信中國50,15,0,15,凱基-永和,2023-07-31,9207
00923,群益台ESG低碳50,14,0,14,凱基-永和,2023-07-31,9207
1612,宏泰,13,0,13,凱基-永和,2023-07-31,9207
00930,永豐ESG低碳高息,12,0,12,凱基-永和,2023-07-31,9207
1319,東陽,14,2,12,凱基-永和,2023-07-31,9207
2369,菱生,12,0,12,凱基-永和,2023-07-31,9207
1611,中電,11,0,11,凱基-永和,2023-07-31,9207
8028,昇陽半導體,11,0,11,凱基-永和,2023-07-31,9207
00878,國泰永續高股息,61,51,10,凱基-永和,2023-07-31,9207
2329,華泰,42,32,10,凱基-永和,2023-07-31,9207
00671R,富邦NASDAQ反1,10,0,10,凱基-永和,2023-07-31,9207
00634R,富邦上証反1,10,0,10,凱基-永和,2023-07-31,9207
1218,泰山,10,0,10,凱基-永和,2023-07-31,9207
2618,長榮航,10,0,10,凱基-永和,2023-07-31,9207
2867,三商壽,10,0,10,凱基-永和,2023-07-31,9207
2890,永豐金,12,2,10,凱基-永和,2023-07-31,9207
3005,神基,10,0,10,凱基-永和,2023-07-31,9207
3019,亞光,10,0,10,凱基-永和,2023-07-31,9207
4541,晟田,10,0,10,凱基-永和,2023-07-31,9207
2402,毅嘉,10,0,10,凱基-永和,2023-07-31,9207
2419,仲琦,10,1,9,凱基-永和,2023-07-31,9207
3041,揚智,10,1,9,凱基-永和,2023-07-31,9207
2603,長榮,25,17,8,凱基-永和,2023-07-31,9207
1312,國喬,10,2,8,凱基-永和,2023-07-31,9207
1752,南光,8,0,8,凱基-永和,2023-07-31,9207
1905,華紙,30,22,8,凱基-永和,2023-07-31,9207
2066,世德,8,0,8,凱基-永和,2023-07-31,9207
2338,光罩,8,0,8,凱基-永和,2023-07-31,9207
3013,晟銘電,13,5,8,凱基-永和,2023-07-31,9207
2888,新光金,918,634,284,凱基-永和,2023-08-01,9207
3231,緯創,249,61,188,凱基-永和,2023-08-01,9207
2356,英業達,204,23,181,凱基-永和,2023-08-01,9207
3596,智易,74,5,69,凱基-永和,2023-08-01,9207
2428,興勤,167,104,63,凱基-永和,2023-08-01,9207
2388,威盛,61,0,61,凱基-永和,2023-08-01,9207
2449,京元電子,58,1,57,凱基-永和,2023-08-01,9207
2883,凱基金,65,10,55,凱基-永和,2023-08-01,9207
1477,聚陽,55,1,54,凱基-永和,2023-08-01,9207
2401,凌陽,51,0,51,凱基-永和,2023-08-01,9207
2885,元大金,50,0,50,凱基-永和,2023-08-01,9207
4746,台耀,70,26,44,凱基-永和,2023-08-01,9207
9927,泰銘,60,16,44,凱基-永和,2023-08-01,9207
9937,全國,36,0,36,凱基-永和,2023-08-01,9207
2312,金寶,29,0,29,凱基-永和,2023-08-01,9207
3289,宜特,28,0,28,凱基-永和,2023-08-01,9207
6282,康舒,32,7,25,凱基-永和,2023-08-01,9207
1806,冠軍,20,0,20,凱基-永和,2023-08-01,9207
3191,雲嘉南,20,0,20,凱基-永和,2023-08-01,9207
3264,欣銓,20,0,20,凱基-永和,2023-08-01,9207
00878,國泰永續高股息,44,25,19,凱基-永和,2023-08-01,9207
3062,建漢,18,0,18,凱基-永和,2023-08-01,9207
2412,中華電,16,0,16,凱基-永和,2023-08-01,9207
00923,群益台ESG低碳50,16,0,16,凱基-永和,2023-08-01,9207
4938,和碩,16,0,16,凱基-永和,2023-08-01,9207
2409,友達,20,5,15,凱基-永和,2023-08-01,9207
2603,長榮,26,12,14,凱基-永和,2023-08-01,9207
4979,華星光,118,105,13,凱基-永和,2023-08-01,9207
3714,富采,13,0,13,凱基-永和,2023-08-01,9207
3088,艾訊,13,0,13,凱基-永和,2023-08-01,9207
5285,界霖,12,0,12,凱基-永和,2023-08-01,9207
2419,仲琦,11,0,11,凱基-永和,2023-08-01,9207
2890,永豐金,11,0,11,凱基-永和,2023-08-01,9207
3163,波若威,216,205,11,凱基-永和,2023-08-01,9207
2801,彰銀,10,0,10,凱基-永和,2023-08-01,9207
6841,長佳智能,14,4,10,凱基-永和,2023-08-01,9207
1442,名軒,9,0,9,凱基-永和,2023-08-01,9207
1504,東元,19,10,9,凱基-永和,2023-08-01,9207
2329,華泰,10,1,9,凱基-永和,2023-08-01,9207
2458,義隆,8,0,8,凱基-永和,2023-08-01,9207
1609,大亞,7,0,7,凱基-永和,2023-08-01,9207
3037,欣興,8,1,7,凱基-永和,2023-08-01,9207
00929,復華台灣科技優息,11,5,6,凱基-永和,2023-08-01,9207
4961,天鈺,8,2,6,凱基-永和,2023-08-01,9207
6806,森崴能源,6,0,6,凱基-永和,2023-08-01,9207
2887,台新金,6,0,6,凱基-永和,2023-08-01,9207
00919,群益台灣精選高息,5,0,5,凱基-永和,2023-08-01,9207
00752,中信中國50,5,0,5,凱基-永和,2023-08-01,9207
1802,台玻,8,3,5,凱基-永和,2023-08-01,9207
2331,精英,5,0,5,凱基-永和,2023-08-01,9207
3231,緯創,1306,777,529,凱基-永和,2023-08-02,9207
2888,新光金,205,31,174,凱基-永和,2023-08-02,9207
1727,中華化,160,10,150,凱基-永和,2023-08-02,9207
9927,泰銘,121,1,120,凱基-永和,2023-08-02,9207
2883,凱基金,87,0,87,凱基-永和,2023-08-02,9207
3481,群創,84,13,71,凱基-永和,2023-08-02,9207
00878,國泰永續高股息,118,61,57,凱基-永和,2023-08-02,9207
2887E,台新戊特,50,0,50,凱基-永和,2023-08-02,9207
6443,元晶,47,0,47,凱基-永和,2023-08-02,9207
2439,美律,45,0,45,凱基-永和,2023-08-02,9207
0056,元大高股息,39,6,33,凱基-永和,2023-08-02,9207
00929,復華台灣科技優息,52,20,32,凱基-永和,2023-08-02,9207
2303,聯電,34,4,30,凱基-永和,2023-08-02,9207
2344,華邦電,44,14,30,凱基-永和,2023-08-02,9207
2359,所羅門,30,0,30,凱基-永和,2023-08-02,9207
00725B,國泰投資級公司債,30,1,29,凱基-永和,2023-08-02,9207
2610,華航,39,11,28,凱基-永和,2023-08-02,9207
6874,倍力,50,27,23,凱基-永和,2023-08-02,9207
00751B,元大AAA至A公司債,22,0,22,凱基-永和,2023-08-02,9207
00923,群益台ESG低碳50,25,4,21,凱基-永和,2023-08-02,9207
2607,榮運,20,0,20,凱基-永和,2023-08-02,9207
2867,三商壽,20,0,20,凱基-永和,2023-08-02,9207
2308,台達電,28,9,19,凱基-永和,2023-08-02,9207
6285,啟��,16,0,16,凱基-永和,2023-08-02,9207
00712,復華富時不動產,16,0,16,凱基-永和,2023-08-02,9207
00679B,元大美債20年,16,0,16,凱基-永和,2023-08-02,9207
00676R,富邦臺灣加權反1,15,0,15,凱基-永和,2023-08-02,9207
3163,波若威,18,3,15,凱基-永和,2023-08-02,9207
00900,富邦特選高股息30,13,0,13,凱基-永和,2023-08-02,9207
00687B,國泰20年美債,13,0,13,凱基-永和,2023-08-02,9207
00680L,元大美債20正2,13,0,13,凱基-永和,2023-08-02,9207
2383,台光電,16,3,13,凱基-永和,2023-08-02,9207
2882,國泰金,15,2,13,凱基-永和,2023-08-02,9207
1504,東元,55,42,13,凱基-永和,2023-08-02,9207
1560,中砂,12,0,12,凱基-永和,2023-08-02,9207
2301,光寶科,710,699,11,凱基-永和,2023-08-02,9207
2351,順德,12,1,11,凱基-永和,2023-08-02,9207
1514,亞力,10,0,10,凱基-永和,2023-08-02,9207
2462,良得電,10,0,10,凱基-永和,2023-08-02,9207
3005,神基,10,0,10,凱基-永和,2023-08-02,9207
00881,國泰台灣5G+,24,15,9,凱基-永和,2023-08-02,9207
2412,中華電,10,1,9,凱基-永和,2023-08-02,9207
3037,欣興,10,2,8,凱基-永和,2023-08-02,9207
2906,高林,8,0,8,凱基-永和,2023-08-02,9207
2913,農林,35,27,8,凱基-永和,2023-08-02,9207
1513,中興電,11,4,7,凱基-永和,2023-08-02,9207
6282,康舒,13,6,7,凱基-永和,2023-08-02,9207
006208,富邦台50,6,0,6,凱基-永和,2023-08-02,9207
00928,中信上櫃ESG30,6,0,6,凱基-永和,2023-08-02,9207
00930,永豐ESG低碳高息,6,0,6,凱基-永和,2023-08-02,9207
2888,新光金,2479,0,2479,凱基-永和,2023-08-04,9207
3032,偉訓,891,2,889,凱基-永和,2023-08-04,9207
00633L,富邦上証正2,99,0,99,凱基-永和,2023-08-04,9207
2618,長榮航,66,0,66,凱基-永和,2023-08-04,9207
2891,中信金,57,0,57,凱基-永和,2023-08-04,9207
3308,聯德,54,1,53,凱基-永和,2023-08-04,9207
2388,威盛,50,0,50,凱基-永和,2023-08-04,9207
3004,豐達科,57,9,48,凱基-永和,2023-08-04,9207
00929,復華台灣科技優息,36,0,36,凱基-永和,2023-08-04,9207
00679B,元大美債20年,32,0,32,凱基-永和,2023-08-04,9207
9937,全國,32,0,32,凱基-永和,2023-08-04,9207
1785,光洋科,37,6,31,凱基-永和,2023-08-04,9207
00687B,國泰20年美債,27,0,27,凱基-永和,2023-08-04,9207
2356,英業達,42,16,26,凱基-永和,2023-08-04,9207
00772B,中信高評級公司債,24,0,24,凱基-永和,2023-08-04,9207
2886,兆豐金,22,0,22,凱基-永和,2023-08-04,9207
3037,欣興,20,0,20,凱基-永和,2023-08-04,9207
00795B,中信美國公債20年,19,0,19,凱基-永和,2023-08-04,9207
2376,技嘉,40,21,19,凱基-永和,2023-08-04,9207
1605,華新,24,6,18,凱基-永和,2023-08-04,9207
00881,國泰台灣5G+,17,0,17,凱基-永和,2023-08-04,9207
4746,台耀,18,2,16,凱基-永和,2023-08-04,9207
2206,三陽工業,32,16,16,凱基-永和,2023-08-04,9207
00751B,元大AAA至A公司債,15,0,15,凱基-永和,2023-08-04,9207
2301,光寶科,24,9,15,凱基-永和,2023-08-04,9207
1612,宏泰,17,3,14,凱基-永和,2023-08-04,9207
2009,第一銅,14,0,14,凱基-永和,2023-08-04,9207
2607,榮運,15,1,14,凱基-永和,2023-08-04,9207
5880,合庫金,14,0,14,凱基-永和,2023-08-04,9207
00878,國泰永續高股息,49,37,12,凱基-永和,2023-08-04,9207
2913,農林,16,4,12,凱基-永和,2023-08-04,9207
00757,統一FANG+,14,3,11,凱基-永和,2023-08-04,9207
00680L,元大美債20正2,22,11,11,凱基-永和,2023-08-04,9207
1615,大山,11,0,11,凱基-永和,2023-08-04,9207
2352,佳世達,14,3,11,凱基-永和,2023-08-04,9207
4961,天鈺,11,0,11,凱基-永和,2023-08-04,9207
00632R,元大台灣50反1,10,0,10,凱基-永和,2023-08-04,9207
00907,永豐優息存股,10,0,10,凱基-永和,2023-08-04,9207
1611,中電,10,0,10,凱基-永和,2023-08-04,9207
1721,三晃,10,0,10,凱基-永和,2023-08-04,9207
2369,菱生,10,0,10,凱基-永和,2023-08-04,9207
2385,群光,10,0,10,凱基-永和,2023-08-04,9207
2464,盟立,10,0,10,凱基-永和,2023-08-04,9207
5871,中租-KY,10,0,10,凱基-永和,2023-08-04,9207
2211,長榮鋼,9,0,9,凱基-永和,2023-08-04,9207
4106,雃博,9,0,9,凱基-永和,2023-08-04,9207
00930,永豐ESG低碳高息,7,0,7,凱基-永和,2023-08-04,9207
6125,廣運,10,3,7,凱基-永和,2023-08-04,9207
00725B,國泰投資級公司債,6,0,6,凱基-永和,2023-08-04,9207
2801,彰銀,6,0,6,凱基-永和,2023-08-04,9207
2888,新光金,2131,3,2128,凱基-永和,2023-08-07,9207
2382,廣達,215,20,195,凱基-永和,2023-08-07,9207
3481,群創,170,5,165,凱基-永和,2023-08-07,9207
2301,光寶科,120,12,108,凱基-永和,2023-08-07,9207
2409,友達,114,7,107,凱基-永和,2023-08-07,9207
2618,長榮航,98,4,94,凱基-永和,2023-08-07,9207
2412,中華電,51,0,51,凱基-永和,2023-08-07,9207
2610,華航,44,15,29,凱基-永和,2023-08-07,9207
1905,華紙,28,0,28,凱基-永和,2023-08-07,9207
6148,驊宏資,28,0,28,凱基-永和,2023-08-07,9207
00885,富邦越南,24,0,24,凱基-永和,2023-08-07,9207
5880,合庫金,28,5,23,凱基-永和,2023-08-07,9207
8358,金居,20,0,20,凱基-永和,2023-08-07,9207
1314,中石化,20,0,20,凱基-永和,2023-08-07,9207
8930,青鋼,18,2,16,凱基-永和,2023-08-07,9207
2603,長榮,20,5,15,凱基-永和,2023-08-07,9207
2607,榮運,16,1,15,凱基-永和,2023-08-07,9207
8049,晶采,15,0,15,凱基-永和,2023-08-07,9207
2913,農林,15,3,12,凱基-永和,2023-08-07,9207
4938,和碩,13,1,12,凱基-永和,2023-08-07,9207
2606,裕民,11,0,11,凱基-永和,2023-08-07,9207
00795B,中信美國公債20年,10,0,10,凱基-永和,2023-08-07,9207
1218,泰山,10,0,10,凱基-永和,2023-08-07,9207
00931B,統一美債20年,10,0,10,凱基-永和,2023-08-07,9207
2405,輔信,10,0,10,凱基-永和,2023-08-07,9207
2484,希華,10,0,10,凱基-永和,2023-08-07,9207
6109,亞元,10,0,10,凱基-永和,2023-08-07,9207
9937,全國,10,0,10,凱基-永和,2023-08-07,9207
00929,復華台灣科技優息,8,0,8,凱基-永和,2023-08-07,9207
2009,第一銅,11,3,8,凱基-永和,2023-08-07,9207
2440,太空梭,10,2,8,凱基-永和,2023-08-07,9207
2464,盟立,12,4,8,凱基-永和,2023-08-07,9207
6533,晶心科,9,1,8,凱基-永和,2023-08-07,9207
6625,必應,8,0,8,凱基-永和,2023-08-07,9207
2211,長榮鋼,7,0,7,凱基-永和,2023-08-07,9207
00893,國泰智能電動車,11,5,6,凱基-永和,2023-08-07,9207
00923,群益台ESG低碳50,6,0,6,凱基-永和,2023-08-07,9207
2630,亞航,8,2,6,凱基-永和,2023-08-07,9207
3322,建舜電,6,0,6,凱基-永和,2023-08-07,9207
00924,復華S＆P500成長,5,0,5,凱基-永和,2023-08-07,9207
00632R,元大台灣50反1,6,1,5,凱基-永和,2023-08-07,9207
1536,和大,5,0,5,凱基-永和,2023-08-07,9207
2317,鴻海,26,21,5,凱基-永和,2023-08-07,9207
2801,彰銀,5,0,5,凱基-永和,2023-08-07,9207
2867,三商壽,5,0,5,凱基-永和,2023-08-07,9207
2883,凱基金,10,5,5,凱基-永和,2023-08-07,9207
2883B,凱基金乙特,5,0,5,凱基-永和,2023-08-07,9207
3454,晶睿,5,0,5,凱基-永和,2023-08-07,9207
3689,湧德,7,2,5,凱基-永和,2023-08-07,9207
4167,松瑞藥,5,0,5,凱基-永和,2023-08-07,9207
2888,新光金,1620,3,1617,凱基-永和,2023-08-08,9207
2363,矽統,151,10,141,凱基-永和,2023-08-08,9207
6235,華孚,103,0,103,凱基-永和,2023-08-08,9207
00878,國泰永續高股息,65,14,51,凱基-永和,2023-08-08,9207
00900,富邦特選高股息30,47,0,47,凱基-永和,2023-08-08,9207
00882,中信中國高股息,55,15,40,凱基-永和,2023-08-08,9207
2891,中信金,39,1,38,凱基-永和,2023-08-08,9207
00931B,統一美債20年,34,0,34,凱基-永和,2023-08-08,9207
00929,復華台灣科技優息,29,2,27,凱基-永和,2023-08-08,9207
2356,英業達,48,25,23,凱基-永和,2023-08-08,9207
1101,台泥,22,0,22,凱基-永和,2023-08-08,9207
6143,振曜,22,1,21,凱基-永和,2023-08-08,9207
2634,漢翔,114,94,20,凱基-永和,2023-08-08,9207
2357,華碩,18,0,18,凱基-永和,2023-08-08,9207
00753L,中信中國50正2,15,0,15,凱基-永和,2023-08-08,9207
4906,正文,12,0,12,凱基-永和,2023-08-08,9207
00687B,國泰20年美債,11,0,11,凱基-永和,2023-08-08,9207
8936,國統,11,0,11,凱基-永和,2023-08-08,9207
00679B,元大美債20年,10,0,10,凱基-永和,2023-08-08,9207
00857B,永豐20年美公債,10,0,10,凱基-永和,2023-08-08,9207
2009,第一銅,14,4,10,凱基-永和,2023-08-08,9207
5880,合庫金,10,0,10,凱基-永和,2023-08-08,9207
6116,彩晶,10,0,10,凱基-永和,2023-08-08,9207
2412,中華電,10,1,9,凱基-永和,2023-08-08,9207
3715,定穎投控,9,0,9,凱基-永和,2023-08-08,9207
3056,富華新,8,0,8,凱基-永和,2023-08-08,9207
6142,友勁,8,0,8,凱基-永和,2023-08-08,9207
1609,大亞,18,10,8,凱基-永和,2023-08-08,9207
2887,台新金,7,0,7,凱基-永和,2023-08-08,9207
2313,華通,8,1,7,凱基-永和,2023-08-08,9207
3706,神達,11,4,7,凱基-永和,2023-08-08,9207
00907,永豐優息存股,7,0,7,凱基-永和,2023-08-08,9207
00891,中信關鍵半導體,6,0,6,凱基-永和,2023-08-08,9207
1905,華紙,8,2,6,凱基-永和,2023-08-08,9207
2388,威盛,8,2,6,凱基-永和,2023-08-08,9207
3702,大聯大,6,0,6,凱基-永和,2023-08-08,9207
2371,大同,6,0,6,凱基-永和,2023-08-08,9207
3231,緯創,25,20,5,凱基-永和,2023-08-08,9207
00752,中信中國50,5,0,5,凱基-永和,2023-08-08,9207
1718,中纖,5,0,5,凱基-永和,2023-08-08,9207
2337,旺宏,5,0,5,凱基-永和,2023-08-08,9207
4167,松瑞藥,5,0,5,凱基-永和,2023-08-08,9207
6153,嘉聯益,5,0,5,凱基-永和,2023-08-08,9207
6188,廣明,6,1,5,凱基-永和,2023-08-08,9207
6269,台郡,5,0,5,凱基-永和,2023-08-08,9207
3587,閎康,5,0,5,凱基-永和,2023-08-08,9207
00720B,元大投資級公司債,4,0,4,凱基-永和,2023-08-08,9207
2913,農林,16,12,4,凱基-永和,2023-08-08,9207
00795B,中信美國公債20年,4,0,4,凱基-永和,2023-08-08,9207
00751B,元大AAA至A公司債,4,0,4,凱基-永和,2023-08-08,9207
2376,技嘉,222,5,217,凱基-永和,2023-08-09,9207
2888,新光金,90,0,90,凱基-永和,2023-08-09,9207
2611,志信,40,0,40,凱基-永和,2023-08-09,9207
6223,旺矽,32,3,29,凱基-永和,2023-08-09,9207
2002,中鋼,27,0,27,凱基-永和,2023-08-09,9207
2351,順德,25,0,25,凱基-永和,2023-08-09,9207
1513,中興電,25,3,22,凱基-永和,2023-08-09,9207
2009,第一銅,22,1,21,凱基-永和,2023-08-09,9207
2022,聚亨,20,0,20,凱基-永和,2023-08-09,9207
2344,華邦電,16,0,16,凱基-永和,2023-08-09,9207
6116,彩晶,16,0,16,凱基-永和,2023-08-09,9207
3231,緯創,22,7,15,凱基-永和,2023-08-09,9207
4729,熒茂,14,0,14,凱基-永和,2023-08-09,9207
8936,國統,13,0,13,凱基-永和,2023-08-09,9207
2882,國泰金,11,0,11,凱基-永和,2023-08-09,9207
2388,威盛,17,7,10,凱基-永和,2023-08-09,9207
3323,加百裕,10,0,10,凱基-永和,2023-08-09,9207
8210,勤誠,11,1,10,凱基-永和,2023-08-09,9207
3051,力特,9,0,9,凱基-永和,2023-08-09,9207
4977,眾達-KY,10,1,9,凱基-永和,2023-08-09,9207
3702,大聯大,14,6,8,凱基-永和,2023-08-09,9207
00679B,元大美債20年,8,0,8,凱基-永和,2023-08-09,9207
2891,中信金,7,0,7,凱基-永和,2023-08-09,9207
2382,廣達,31,25,6,凱基-永和,2023-08-09,9207
00923,群益台ESG低碳50,7,0,7,凱基-永和,2023-08-09,9207
1560,中砂,6,0,6,凱基-永和,2023-08-09,9207
00893,國泰智能電動車,6,0,6,凱基-永和,2023-08-09,9207
1785,光洋科,6,0,6,凱基-永和,2023-08-09,9207
2890,永豐金,16,10,6,凱基-永和,2023-08-09,9207
3163,波若威,21,15,6,凱基-永和,2023-08-09,9207
3260,威剛,7,2,5,凱基-永和,2023-08-09,9207
00929,復華台灣科技優息,9,4,5,凱基-永和,2023-08-09,9207
1905,華紙,5,0,5,凱基-永和,2023-08-09,9207
2883B,凱基金乙特,5,0,5,凱基-永和,2023-08-09,9207
2897,王道銀行,5,0,5,凱基-永和,2023-08-09,9207
6288,聯嘉,5,0,5,凱基-永和,2023-08-09,9207
6548,長科*,5,0,5,凱基-永和,2023-08-09,9207
8930,青鋼,7,2,5,凱基-永和,2023-08-09,9207
1210,大成,5,0,5,凱基-永和,2023-08-09,9207
00878,國泰永續高股息,6,2,4,凱基-永和,2023-08-09,9207
2458,義隆,5,1,4,凱基-永和,2023-08-09,9207
4190,佐登-KY,4,0,4,凱基-永和,2023-08-09,9207
6756,威鋒電子,4,0,4,凱基-永和,2023-08-09,9207
9907,統一實,4,0,4,凱基-永和,2023-08-09,9207
2603,長榮,3,0,3,凱基-永和,2023-08-09,9207
5871,中租-KY,3,0,3,凱基-永和,2023-08-09,9207
1102,亞泥,3,0,3,凱基-永和,2023-08-09,9207
1605,華新,3,0,3,凱基-永和,2023-08-09,9207
1231,聯華食,3,0,3,凱基-永和,2023-08-09,9207
1219,福壽,3,0,3,凱基-永和,2023-08-09,9207
2883,凱基金,91,1,90,凱基-永和,2023-08-10,9207
2303,聯電,85,0,85,凱基-永和,2023-08-10,9207
00878,國泰永續高股息,48,0,48,凱基-永和,2023-08-10,9207
2357,華碩,45,0,45,凱基-永和,2023-08-10,9207
2618,長榮航,40,2,38,凱基-永和,2023-08-10,9207
00900,富邦特選高股息30,34,0,34,凱基-永和,2023-08-10,9207
00929,復華台灣科技優息,32,0,32,凱基-永和,2023-08-10,9207
2324,仁寶,32,1,31,凱基-永和,2023-08-10,9207
2882,國泰金,24,0,24,凱基-永和,2023-08-10,9207
0056,元大高股息,29,5,24,凱基-永和,2023-08-10,9207
2409,友達,23,0,23,凱基-永和,2023-08-10,9207
2886,兆豐金,20,0,20,凱基-永和,2023-08-10,9207
6142,友勁,20,0,20,凱基-永和,2023-08-10,9207
6223,旺矽,22,3,19,凱基-永和,2023-08-10,9207
2382,廣達,28,10,18,凱基-永和,2023-08-10,9207
6109,亞元,16,0,16,凱基-永和,2023-08-10,9207
00882,中信中國高股息,15,0,15,凱基-永和,2023-08-10,9207
2610,華航,21,6,15,凱基-永和,2023-08-10,9207
3481,群創,13,0,13,凱基-永和,2023-08-10,9207
2317,鴻海,15,2,13,凱基-永和,2023-08-10,9207
2002,中鋼,12,0,12,凱基-永和,2023-08-10,9207
00923,群益台ESG低碳50,11,0,11,凱基-永和,2023-08-10,9207
2388,威盛,12,1,11,凱基-永和,2023-08-10,9207
5388,中磊,11,0,11,凱基-永和,2023-08-10,9207
6271,同欣電,11,0,11,凱基-永和,2023-08-10,9207
00720B,元大投資級公司債,10,0,10,凱基-永和,2023-08-10,9207
5258,虹堡,14,4,10,凱基-永和,2023-08-10,9207
8215,明基材,10,0,10,凱基-永和,2023-08-10,9207
1514,亞力,11,2,9,凱基-永和,2023-08-10,9207
3032,偉訓,9,0,9,凱基-永和,2023-08-10,9207
00706L,期元大S＆P日圓正2,8,0,8,凱基-永和,2023-08-10,9207
6282,康舒,37,29,8,凱基-永和,2023-08-10,9207
6672,騰輝電子-KY,20,12,8,凱基-永和,2023-08-10,9207
00931B,統一美債20年,7,0,7,凱基-永和,2023-08-10,9207
2337,旺宏,7,0,7,凱基-永和,2023-08-10,9207
3264,欣銓,7,0,7,凱基-永和,2023-08-10,9207
2059,川湖,7,0,7,凱基-永和,2023-08-10,9207
3231,緯創,19,12,7,凱基-永和,2023-08-10,9207
1503,士電,7,1,6,凱基-永和,2023-08-10,9207
2891,中信金,11,5,6,凱基-永和,2023-08-10,9207
9945,潤泰新,6,0,6,凱基-永和,2023-08-10,9207
3213,茂訊,6,0,6,凱基-永和,2023-08-10,9207
6104,創惟,6,0,6,凱基-永和,2023-08-10,9207
00850,元大臺灣ESG永續,5,0,5,凱基-永和,2023-08-10,9207
2108,南帝,5,0,5,凱基-永和,2023-08-10,9207
2464,盟立,6,1,5,凱基-永和,2023-08-10,9207
2614,東森,5,0,5,凱基-永和,2023-08-10,9207
3078,僑威,5,0,5,凱基-永和,2023-08-10,9207
3707,漢磊,5,0,5,凱基-永和,2023-08-10,9207
4977,眾達-KY,5,0,5,凱基-永和,2023-08-10,9207
2888,新光金,1101,9,1092,凱基-永和,2023-08-11,9207
3231,緯創,1072,920,152,凱基-永和,2023-08-11,9207
4979,華星光,129,0,129,凱基-永和,2023-08-11,9207
2376,技嘉,119,7,112,凱基-永和,2023-08-11,9207
2883,凱基金,72,0,72,凱基-永和,2023-08-11,9207
6116,彩晶,66,2,64,凱基-永和,2023-08-11,9207
00931B,統一美債20年,54,0,54,凱基-永和,2023-08-11,9207
8426,紅木-KY,40,0,40,凱基-永和,2023-08-11,9207
6625,必應,30,0,30,凱基-永和,2023-08-11,9207
2892,第一金,25,0,25,凱基-永和,2023-08-11,9207
2009,第一銅,26,1,25,凱基-永和,2023-08-11,9207
00878,國泰永續高股息,23,0,23,凱基-永和,2023-08-11,9207
1514,亞力,20,0,20,凱基-永和,2023-08-11,9207
3062,建漢,15,0,15,凱基-永和,2023-08-11,9207
6109,亞元,15,0,15,凱基-永和,2023-08-11,9207
3058,立德,12,0,12,凱基-永和,2023-08-11,9207
00679B,元大美債20年,11,0,11,凱基-永和,2023-08-11,9207
2317,鴻海,11,0,11,凱基-永和,2023-08-11,9207
3483,力致,11,0,11,凱基-永和,2023-08-11,9207
2383,台光電,10,0,10,凱基-永和,2023-08-11,9207
8038,長園科,11,1,10,凱基-永和,2023-08-11,9207
8092,建暐,10,0,10,凱基-永和,2023-08-11,9207
2002,中鋼,9,0,9,凱基-永和,2023-08-11,9207
00655L,國泰中國A50正2,10,1,9,凱基-永和,2023-08-11,9207
2356,英業達,33,24,9,凱基-永和,2023-08-11,9207
6472,保瑞,10,2,8,凱基-永和,2023-08-11,9207
00795B,中信美國公債20年,8,0,8,凱基-永和,2023-08-11,9207
2388,威盛,9,2,7,凱基-永和,2023-08-11,9207
2027,大成鋼,7,0,7,凱基-永和,2023-08-11,9207
5351,鈺創,7,0,7,凱基-永和,2023-08-11,9207
0056,元大高股息,7,0,7,凱基-永和,2023-08-11,9207
00772B,中信高評級公司債,6,0,6,凱基-永和,2023-08-11,9207
2316,楠梓電,6,0,6,凱基-永和,2023-08-11,9207
2731,雄獅,7,1,6,凱基-永和,2023-08-11,9207
2897,王道銀行,6,0,6,凱基-永和,2023-08-11,9207
1108,幸福,5,0,5,凱基-永和,2023-08-11,9207
00882,中信中國高股息,5,0,5,凱基-永和,2023-08-11,9207
2630,亞航,7,2,5,凱基-永和,2023-08-11,9207
3035,智原,5,0,5,凱基-永和,2023-08-11,9207
3051,力特,5,0,5,凱基-永和,2023-08-11,9207
3260,威剛,15,10,5,凱基-永和,2023-08-11,9207
4746,台耀,5,0,5,凱基-永和,2023-08-11,9207
8069,元太,5,0,5,凱基-永和,2023-08-11,9207
9937,全國,5,0,5,凱基-永和,2023-08-11,9207
1795,美時,6,2,4,凱基-永和,2023-08-11,9207
00706L,期元大S＆P日圓正2,4,0,4,凱基-永和,2023-08-11,9207
00751B,元大AAA至A公司債,4,0,4,凱基-永和,2023-08-11,9207
1442,名軒,4,0,4,凱基-永和,2023-08-11,9207
1504,東元,14,10,4,凱基-永和,2023-08-11,9207
2314,台揚,4,0,4,凱基-永和,2023-08-11,9207
3058,立德,165,0,165,凱基-永和,2023-08-14,9207
00929,復華台灣科技優息,96,0,96,凱基-永和,2023-08-14,9207
00878,國泰永續高股息,74,3,71,凱基-永和,2023-08-14,9207
2618,長榮航,69,0,69,凱基-永和,2023-08-14,9207
2610,華航,57,1,56,凱基-永和,2023-08-14,9207
2891,中信金,49,0,49,凱基-永和,2023-08-14,9207
6109,亞元,67,20,47,凱基-永和,2023-08-14,9207
00900,富邦特選高股息30,46,0,46,凱基-永和,2023-08-14,9207
2344,華邦電,41,0,41,凱基-永和,2023-08-14,9207
2883,凱基金,32,0,32,凱基-永和,2023-08-14,9207
00888,永豐台灣ESG,38,9,29,凱基-永和,2023-08-14,9207
3325,旭品,25,0,25,凱基-永和,2023-08-14,9207
00931B,統一美債20年,23,0,23,凱基-永和,2023-08-14,9207
00706L,期元大S＆P日圓正2,20,0,20,凱基-永和,2023-08-14,9207
8092,建暐,20,0,20,凱基-永和,2023-08-14,9207
2356,英業達,29,13,16,凱基-永和,2023-08-14,9207
0050,元大台灣50,18,2,16,凱基-永和,2023-08-14,9207
00650L,復華香港正2,14,0,14,凱基-永和,2023-08-14,9207
5258,虹堡,16,3,13,凱基-永和,2023-08-14,9207
2002,中鋼,12,0,12,凱基-永和,2023-08-14,9207
1905,華紙,12,1,11,凱基-永和,2023-08-14,9207
5871,中租-KY,10,0,10,凱基-永和,2023-08-14,9207
2385,群光,10,0,10,凱基-永和,2023-08-14,9207
2460,建通,10,0,10,凱基-永和,2023-08-14,9207
2882,國泰金,10,0,10,凱基-永和,2023-08-14,9207
5388,中磊,11,1,10,凱基-永和,2023-08-14,9207
6669,緯穎,10,0,10,凱基-永和,2023-08-14,9207
2886,兆豐金,9,0,9,凱基-永和,2023-08-14,9207
2439,美律,9,0,9,凱基-永和,2023-08-14,9207
2883B,凱基金乙特,9,0,9,凱基-永和,2023-08-14,9207
6282,康舒,21,12,9,凱基-永和,2023-08-14,9207
00923,群益台ESG低碳50,8,0,8,凱基-永和,2023-08-14,9207
2371,大同,8,0,8,凱基-永和,2023-08-14,9207
5608,四維航,10,2,8,凱基-永和,2023-08-14,9207
1513,中興電,12,4,8,凱基-永和,2023-08-14,9207
2317,鴻海,24,17,7,凱基-永和,2023-08-14,9207
1605,華新,11,4,7,凱基-永和,2023-08-14,9207
2388,威盛,9,2,7,凱基-永和,2023-08-14,9207
4977,眾達-KY,7,0,7,凱基-永和,2023-08-14,9207
2606,裕民,6,0,6,凱基-永和,2023-08-14,9207
2867,三商壽,6,0,6,凱基-永和,2023-08-14,9207
3346,麗清,6,0,6,凱基-永和,2023-08-14,9207
6488,環球晶,6,0,6,凱基-永和,2023-08-14,9207
6770,力積電,5,0,5,凱基-永和,2023-08-14,9207
006208,富邦台50,7,2,5,凱基-永和,2023-08-14,9207
00637L,元大滬深300正2,7,2,5,凱基-永和,2023-08-14,9207
00930,永豐ESG低碳高息,5,0,5,凱基-永和,2023-08-14,9207
1218,泰山,5,0,5,凱基-永和,2023-08-14,9207
2353,宏��,16,11,5,凱基-永和,2023-08-14,9207
2890,永豐金,5,0,5,凱基-永和,2023-08-14,9207
4979,華星光,106,0,106,凱基-永和,2023-08-15,9207
00923,群益台ESG低碳50,65,0,65,凱基-永和,2023-08-15,9207
2340,台亞,48,0,48,凱基-永和,2023-08-15,9207
00878,國泰永續高股息,49,11,38,凱基-永和,2023-08-15,9207
2883,凱基金,34,0,34,凱基-永和,2023-08-15,9207
00931B,統一美債20年,24,0,24,凱基-永和,2023-08-15,9207
00900,富邦特選高股息30,21,0,21,凱基-永和,2023-08-15,9207
1504,東元,15,1,14,凱基-永和,2023-08-15,9207
00795B,中信美國公債20年,14,0,14,凱基-永和,2023-08-15,9207
2363,矽統,19,7,12,凱基-永和,2023-08-15,9207
00679B,元大美債20年,11,0,11,凱基-永和,2023-08-15,9207
3231,緯創,218,207,11,凱基-永和,2023-08-15,9207
2882,國泰金,11,0,11,凱基-永和,2023-08-15,9207
2888,新光金,11,0,11,凱基-永和,2023-08-15,9207
2312,金寶,11,1,10,凱基-永和,2023-08-15,9207
2014,中鴻,10,0,10,凱基-永和,2023-08-15,9207
8092,建暐,10,0,10,凱基-永和,2023-08-15,9207
8069,元太,9,0,9,凱基-永和,2023-08-15,9207
2002,中鋼,8,0,8,凱基-永和,2023-08-15,9207
4533,協易機,12,4,8,凱基-永和,2023-08-15,9207
00772B,中信高評級公司債,7,0,7,凱基-永和,2023-08-15,9207
00830,國泰費城半導體,7,0,7,凱基-永和,2023-08-15,9207
6770,力積電,7,1,6,凱基-永和,2023-08-15,9207
2603,長榮,6,0,6,凱基-永和,2023-08-15,9207
2913,農林,6,0,6,凱基-永和,2023-08-15,9207
3687,歐買尬,6,0,6,凱基-永和,2023-08-15,9207
2303,聯電,6,0,6,凱基-永和,2023-08-15,9207
00757,統一FANG+,7,2,5,凱基-永和,2023-08-15,9207
2834,臺企銀,5,0,5,凱基-永和,2023-08-15,9207
00687B,國泰20年美債,5,0,5,凱基-永和,2023-08-15,9207
2887,台新金,5,0,5,凱基-永和,2023-08-15,9207
00706L,期元大S＆P日圓正2,5,0,5,凱基-永和,2023-08-15,9207
2409,友達,5,0,5,凱基-永和,2023-08-15,9207
2888B,新光金乙特,5,0,5,凱基-永和,2023-08-15,9207
6274,台燿,6,1,5,凱基-永和,2023-08-15,9207
1229,聯華,5,0,5,凱基-永和,2023-08-15,9207
1513,中興電,5,1,4,凱基-永和,2023-08-15,9207
2440,太空梭,4,0,4,凱基-永和,2023-08-15,9207
2903,遠百,4,0,4,凱基-永和,2023-08-15,9207
5880,合庫金,4,0,4,凱基-永和,2023-08-15,9207
2884,玉山金,4,1,3,凱基-永和,2023-08-15,9207
2891,中信金,8,5,3,凱基-永和,2023-08-15,9207
00751B,元大AAA至A公司債,3,0,3,凱基-永和,2023-08-15,9207
00885,富邦越南,3,0,3,凱基-永和,2023-08-15,9207
2419,仲琦,3,0,3,凱基-永和,2023-08-15,9207
2421,建準,9,6,3,凱基-永和,2023-08-15,9207
6109,亞元,3,0,3,凱基-永和,2023-08-15,9207
8446,華研,3,0,3,凱基-永和,2023-08-15,9207
1907,永豐餘,3,0,3,凱基-永和,2023-08-15,9207
2388,威盛,3,0,3,凱基-永和,2023-08-15,9207
2382,廣達,314,33,281,凱基-永和,2023-08-16,9207
3231,緯創,283,44,239,凱基-永和,2023-08-16,9207
2356,英業達,235,57,178,凱基-永和,2023-08-16,9207
2401,凌陽,101,3,98,凱基-永和,2023-08-16,9207
00923,群益台ESG低碳50,64,0,64,凱基-永和,2023-08-16,9207
2421,建準,121,61,60,凱基-永和,2023-08-16,9207
2891,中信金,58,4,54,凱基-永和,2023-08-16,9207
2610,華航,45,1,44,凱基-永和,2023-08-16,9207
2303,聯電,51,11,40,凱基-永和,2023-08-16,9207
00878,國泰永續高股息,30,0,30,凱基-永和,2023-08-16,9207
2890,永豐金,25,0,25,凱基-永和,2023-08-16,9207
3693,營邦,26,3,23,凱基-永和,2023-08-16,9207
6569,醫揚,20,0,20,凱基-永和,2023-08-16,9207
00882,中信中國高股息,18,0,18,凱基-永和,2023-08-16,9207
00772B,中信高評級公司債,18,0,18,凱基-永和,2023-08-16,9207
2239,英利-KY,18,0,18,凱基-永和,2023-08-16,9207
5523,豐謙,18,0,18,凱基-永和,2023-08-16,9207
2317,鴻海,20,3,17,凱基-永和,2023-08-16,9207
6109,亞元,15,0,15,凱基-永和,2023-08-16,9207
2332,友訊,44,29,15,凱基-永和,2023-08-16,9207
2501,國建,14,0,14,凱基-永和,2023-08-16,9207
3078,僑威,17,3,14,凱基-永和,2023-08-16,9207
00720B,元大投資級公司債,12,0,12,凱基-永和,2023-08-16,9207
2312,金寶,10,0,10,凱基-永和,2023-08-16,9207
3034,聯詠,10,0,10,凱基-永和,2023-08-16,9207
2867,三商壽,10,0,10,凱基-永和,2023-08-16,9207
0050,元大台灣50,10,0,10,凱基-永和,2023-08-16,9207
2002,中鋼,9,0,9,凱基-永和,2023-08-16,9207
00712,復華富時不動產,13,4,9,凱基-永和,2023-08-16,9207
3481,群創,12,4,8,凱基-永和,2023-08-16,9207
2645,長榮航太,8,0,8,凱基-永和,2023-08-16,9207
8097,常珵,8,0,8,凱基-永和,2023-08-16,9207
00795B,中信美國公債20年,8,0,8,凱基-永和,2023-08-16,9207
1402,遠東新,7,0,7,凱基-永和,2023-08-16,9207
2609,陽明,7,0,7,凱基-永和,2023-08-16,9207
2834,臺企銀,7,1,6,凱基-永和,2023-08-16,9207
00725B,國泰投資級公司債,6,0,6,凱基-永和,2023-08-16,9207
2886,兆豐金,8,2,6,凱基-永和,2023-08-16,9207
2915,潤泰全,6,0,6,凱基-永和,2023-08-16,9207
1101,台泥,6,0,6,凱基-永和,2023-08-16,9207
2637,慧洋-KY,5,0,5,凱基-永和,2023-08-16,9207
2812,台中銀,5,0,5,凱基-永和,2023-08-16,9207
00753L,中信中國50正2,5,0,5,凱基-永和,2023-08-16,9207
1605,華新,5,0,5,凱基-永和,2023-08-16,9207
2801,彰銀,5,0,5,凱基-永和,2023-08-16,9207
2880,華南金,5,0,5,凱基-永和,2023-08-16,9207
3706,神達,8,3,5,凱基-永和,2023-08-16,9207
6414,樺漢,5,0,5,凱基-永和,2023-08-16,9207
00679B,元大美債20年,5,0,5,凱基-永和,2023-08-16,9207
8069,元太,5,1,4,凱基-永和,2023-08-16,9207
5340,建榮,296,3,293,凱基-永和,2023-08-17,9207
00687B,國泰20年美債,104,0,104,凱基-永和,2023-08-17,9207
3051,力特,74,1,73,凱基-永和,2023-08-17,9207
2301,光寶科,71,0,71,凱基-永和,2023-08-17,9207
2415,錩新,60,0,60,凱基-永和,2023-08-17,9207
2014,中鴻,53,0,53,凱基-永和,2023-08-17,9207
2317,鴻海,50,1,49,凱基-永和,2023-08-17,9207
4944,兆遠,40,0,40,凱基-永和,2023-08-17,9207
6257,矽格,40,0,40,凱基-永和,2023-08-17,9207
2356,英業達,438,403,35,凱基-永和,2023-08-17,9207
2408,南亞科,31,0,31,凱基-永和,2023-08-17,9207
9950,萬國通,31,0,31,凱基-永和,2023-08-17,9207
2239,英利-KY,25,0,25,凱基-永和,2023-08-17,9207
2206,三陽工業,25,0,25,凱基-永和,2023-08-17,9207
00882,中信中國高股息,25,0,25,凱基-永和,2023-08-17,9207
6139,亞翔,46,22,24,凱基-永和,2023-08-17,9207
6168,宏齊,22,0,22,凱基-永和,2023-08-17,9207
4938,和碩,21,1,20,凱基-永和,2023-08-17,9207
3265,台星科,20,3,17,凱基-永和,2023-08-17,9207
2618,長榮航,18,1,17,凱基-永和,2023-08-17,9207
2367,燿華,15,0,15,凱基-永和,2023-08-17,9207
00931B,統一美債20年,15,0,15,凱基-永和,2023-08-17,9207
00751B,元大AAA至A公司債,13,0,13,凱基-永和,2023-08-17,9207
2610,華航,15,2,13,凱基-永和,2023-08-17,9207
3035,智原,15,2,13,凱基-永和,2023-08-17,9207
00753L,中信中國50正2,12,0,12,凱基-永和,2023-08-17,9207
2344,華邦電,13,1,12,凱基-永和,2023-08-17,9207
00772B,中信高評級公司債,11,0,11,凱基-永和,2023-08-17,9207
2885,元大金,11,0,11,凱基-永和,2023-08-17,9207
5381,合正,11,0,11,凱基-永和,2023-08-17,9207
00923,群益台ESG低碳50,10,0,10,凱基-永和,2023-08-17,9207
2867,三商壽,10,0,10,凱基-永和,2023-08-17,9207
3264,欣銓,10,0,10,凱基-永和,2023-08-17,9207
2891,中信金,14,5,9,凱基-永和,2023-08-17,9207
2883,凱基金,9,0,9,凱基-永和,2023-08-17,9207
6109,亞元,9,0,9,凱基-永和,2023-08-17,9207
2002,中鋼,8,0,8,凱基-永和,2023-08-17,9207
00679B,元大美債20年,8,0,8,凱基-永和,2023-08-17,9207
00662,富邦NASDAQ,8,0,8,凱基-永和,2023-08-17,9207
4933,友輝,8,0,8,凱基-永和,2023-08-17,9207
2881,富邦金,9,1,8,凱基-永和,2023-08-17,9207
00795B,中信美國公債20年,7,0,7,凱基-永和,2023-08-17,9207
1442,名軒,7,0,7,凱基-永和,2023-08-17,9207
2329,華泰,17,10,7,凱基-永和,2023-08-17,9207
3706,神達,19,12,7,凱基-永和,2023-08-17,9207
1101,台泥,6,0,6,凱基-永和,2023-08-17,9207
1532,勤美,6,0,6,凱基-永和,2023-08-17,9207
2915,潤泰全,8,2,6,凱基-永和,2023-08-17,9207
2609,陽明,5,0,5,凱基-永和,2023-08-17,9207
00642U,期元大S＆P石油,5,0,5,凱基-永和,2023-08-17,9207
1471,首利,609,2,607,凱基-永和,2023-08-18,9207
2605,新興,305,2,303,凱基-永和,2023-08-18,9207
00680L,元大美債20正2,80,0,80,凱基-永和,2023-08-18,9207
2641,正德,64,1,63,凱基-永和,2023-08-18,9207
4960,誠美材,50,0,50,凱基-永和,2023-08-18,9207
2353,宏��,51,2,49,凱基-永和,2023-08-18,9207
2239,英利-KY,38,0,38,凱基-永和,2023-08-18,9207
00929,復華台灣科技優息,24,1,23,凱基-永和,2023-08-18,9207
2409,友達,21,0,21,凱基-永和,2023-08-18,9207
00753L,中信中國50正2,20,0,20,凱基-永和,2023-08-18,9207
1609,大亞,25,7,18,凱基-永和,2023-08-18,9207
1101,台泥,17,1,16,凱基-永和,2023-08-18,9207
2330,台積電,15,0,15,凱基-永和,2023-08-18,9207
2610,華航,17,2,15,凱基-永和,2023-08-18,9207
3376,新日興,15,0,15,凱基-永和,2023-08-18,9207
6125,廣運,18,4,14,凱基-永和,2023-08-18,9207
2324,仁寶,25,13,12,凱基-永和,2023-08-18,9207
2388,威盛,18,6,12,凱基-永和,2023-08-18,9207
00923,群益台ESG低碳50,12,0,12,凱基-永和,2023-08-18,9207
5258,虹堡,15,4,11,凱基-永和,2023-08-18,9207
6672,騰輝電子-KY,14,3,11,凱基-永和,2023-08-18,9207
3035,智原,12,1,11,凱基-永和,2023-08-18,9207
5009,榮剛,10,0,10,凱基-永和,2023-08-18,9207
00881,國泰台灣5G+,10,0,10,凱基-永和,2023-08-18,9207
00919,群益台灣精選高息,10,0,10,凱基-永和,2023-08-18,9207
8034,榮群,10,0,10,凱基-永和,2023-08-18,9207
3622,洋華,9,0,9,凱基-永和,2023-08-18,9207
00882,中信中國高股息,11,2,9,凱基-永和,2023-08-18,9207
3056,富華新,7,0,7,凱基-永和,2023-08-18,9207
8210,勤誠,33,26,7,凱基-永和,2023-08-18,9207
2002,中鋼,10,3,7,凱基-永和,2023-08-18,9207
2206,三陽工業,8,1,7,凱基-永和,2023-08-18,9207
3704,合勤控,12,6,6,凱基-永和,2023-08-18,9207
2317,鴻海,6,0,6,凱基-永和,2023-08-18,9207
0050,元大台灣50,6,0,6,凱基-永和,2023-08-18,9207
2329,華泰,108,102,6,凱基-永和,2023-08-18,9207
2883,凱基金,7,1,6,凱基-永和,2023-08-18,9207
2363,矽統,12,6,6,凱基-永和,2023-08-18,9207
2421,建準,11,6,5,凱基-永和,2023-08-18,9207
00720B,元大投資級公司債,7,2,5,凱基-永和,2023-08-18,9207
3338,泰碩,5,0,5,凱基-永和,2023-08-18,9207
1795,美時,7,2,5,凱基-永和,2023-08-18,9207
3567,逸昌,5,0,5,凱基-永和,2023-08-18,9207
8358,金居,7,2,5,凱基-永和,2023-08-18,9207
8936,國統,5,0,5,凱基-永和,2023-08-18,9207
1504,東元,6,1,5,凱基-永和,2023-08-18,9207
00878,國泰永續高股息,13,9,4,凱基-永和,2023-08-18,9207
00751B,元大AAA至A公司債,4,0,4,凱基-永和,2023-08-18,9207
3013,晟銘電,6,2,4,凱基-永和,2023-08-18,9207
3042,晶技,4,0,4,凱基-永和,2023-08-18,9207
1444,力麗,180,0,180,凱基-永和,2023-08-21,9207
2409,友達,100,0,100,凱基-永和,2023-08-21,9207
6116,彩晶,100,0,100,凱基-永和,2023-08-21,9207
5340,建榮,152,57,95,凱基-永和,2023-08-21,9207
00650L,復華香港正2,58,0,58,凱基-永和,2023-08-21,9207
2516,新建,50,0,50,凱基-永和,2023-08-21,9207
6125,廣運,136,105,31,凱基-永和,2023-08-21,9207
2421,建準,38,9,29,凱基-永和,2023-08-21,9207
2885,元大金,21,0,21,凱基-永和,2023-08-21,9207
3622,洋華,21,0,21,凱基-永和,2023-08-21,9207
2890,永豐金,20,0,20,凱基-永和,2023-08-21,9207
2887,台新金,20,1,19,凱基-永和,2023-08-21,9207
2303,聯電,20,2,18,凱基-永和,2023-08-21,9207
3024,憶聲,16,0,16,凱基-永和,2023-08-21,9207
2382,廣達,22,8,14,凱基-永和,2023-08-21,9207
2610,華航,13,0,13,凱基-永和,2023-08-21,9207
00929,復華台灣科技優息,11,0,11,凱基-永和,2023-08-21,9207
00931B,統一美債20年,11,0,11,凱基-永和,2023-08-21,9207
00919,群益台灣精選高息,11,0,11,凱基-永和,2023-08-21,9207
2603,長榮,11,0,11,凱基-永和,2023-08-21,9207
006208,富邦台50,10,0,10,凱基-永和,2023-08-21,9207
2324,仁寶,24,14,10,凱基-永和,2023-08-21,9207
2618,長榮航,19,10,9,凱基-永和,2023-08-21,9207
3163,波若威,46,38,8,凱基-永和,2023-08-21,9207
6531,愛普*,11,3,8,凱基-永和,2023-08-21,9207
00687B,國泰20年美債,9,1,8,凱基-永和,2023-08-21,9207
00795B,中信美國公債20年,7,0,7,凱基-永和,2023-08-21,9207
00878,國泰永續高股息,6,0,6,凱基-永和,2023-08-21,9207
00885,富邦越南,9,3,6,凱基-永和,2023-08-21,9207
3042,晶技,6,0,6,凱基-永和,2023-08-21,9207
6147,頎邦,6,0,6,凱基-永和,2023-08-21,9207
2606,裕民,6,0,6,凱基-永和,2023-08-21,9207
1218,泰山,5,0,5,凱基-永和,2023-08-21,9207
1904,正隆,5,0,5,凱基-永和,2023-08-21,9207
2630,亞航,5,0,5,凱基-永和,2023-08-21,9207
3715,定穎投控,7,2,5,凱基-永和,2023-08-21,9207
6109,亞元,5,0,5,凱基-永和,2023-08-21,9207
9945,潤泰新,5,0,5,凱基-永和,2023-08-21,9207
3048,益登,4,0,4,凱基-永和,2023-08-21,9207
1815,富喬,4,0,4,凱基-永和,2023-08-21,9207
1905,華紙,4,0,4,凱基-永和,2023-08-21,9207
2359,所羅門,5,1,4,凱基-永和,2023-08-21,9207
4933,友輝,4,0,4,凱基-永和,2023-08-21,9207
1504,東元,11,7,4,凱基-永和,2023-08-21,9207
6770,力積電,4,0,4,凱基-永和,2023-08-21,9207
0050,元大台灣50,4,0,4,凱基-永和,2023-08-21,9207
00772B,中信高評級公司債,3,0,3,凱基-永和,2023-08-21,9207
00923,群益台ESG低碳50,3,0,3,凱基-永和,2023-08-21,9207
1513,中興電,4,1,3,凱基-永和,2023-08-21,9207
2376,技嘉,3,0,3,凱基-永和,2023-08-21,9207
2382,廣達,269,29,240,凱基-永和,2023-08-22,9207
1471,首利,219,5,214,凱基-永和,2023-08-22,9207
2376,技嘉,336,152,184,凱基-永和,2023-08-22,9207
6282,康舒,52,0,52,凱基-永和,2023-08-22,9207
2329,華泰,107,56,51,凱基-永和,2023-08-22,9207
2516,新建,48,0,48,凱基-永和,2023-08-22,9207
3037,欣興,42,4,38,凱基-永和,2023-08-22,9207
00712,復華富時不動產,25,0,25,凱基-永和,2023-08-22,9207
4129,聯合,25,0,25,凱基-永和,2023-08-22,9207
6109,亞元,22,0,22,凱基-永和,2023-08-22,9207
2892,第一金,21,0,21,凱基-永和,2023-08-22,9207
00929,復華台灣科技優息,21,0,21,凱基-永和,2023-08-22,9207
3024,憶聲,21,0,21,凱基-永和,2023-08-22,9207
2891,中信金,15,0,15,凱基-永和,2023-08-22,9207
2344,華邦電,14,0,14,凱基-永和,2023-08-22,9207
00882,中信中國高股息,13,0,13,凱基-永和,2023-08-22,9207
00772B,中信高評級公司債,12,0,12,凱基-永和,2023-08-22,9207
2356,英業達,42,30,12,凱基-永和,2023-08-22,9207
2402,毅嘉,22,10,12,凱基-永和,2023-08-22,9207
2606,裕民,14,4,10,凱基-永和,2023-08-22,9207
2886,兆豐金,10,0,10,凱基-永和,2023-08-22,9207
2211,長榮鋼,10,0,10,凱基-永和,2023-08-22,9207
2303,聯電,10,0,10,凱基-永和,2023-08-22,9207
3058,立德,10,0,10,凱基-永和,2023-08-22,9207
3380,明泰,10,0,10,凱基-永和,2023-08-22,9207
5258,虹堡,18,8,10,凱基-永和,2023-08-22,9207
3661,世芯-KY,10,0,10,凱基-永和,2023-08-22,9207
2883,凱基金,8,0,8,凱基-永和,2023-08-22,9207
1795,美時,7,0,7,凱基-永和,2023-08-22,9207
2436,偉詮電,7,0,7,凱基-永和,2023-08-22,9207
3689,湧德,7,0,7,凱基-永和,2023-08-22,9207
3706,神達,7,0,7,凱基-永和,2023-08-22,9207
2605,新興,8,1,7,凱基-永和,2023-08-22,9207
4933,友輝,6,0,6,凱基-永和,2023-08-22,9207
8034,榮群,6,0,6,凱基-永和,2023-08-22,9207
2206,三陽工業,5,0,5,凱基-永和,2023-08-22,9207
4979,華星光,9,4,5,凱基-永和,2023-08-22,9207
3693,營邦,4,0,4,凱基-永和,2023-08-22,9207
00795B,中信美國公債20年,4,0,4,凱基-永和,2023-08-22,9207
2603,長榮,4,0,4,凱基-永和,2023-08-22,9207
2645,長榮航太,8,4,4,凱基-永和,2023-08-22,9207
2882,國泰金,4,0,4,凱基-永和,2023-08-22,9207
3088,艾訊,4,0,4,凱基-永和,2023-08-22,9207
00878,國泰永續高股息,5,1,4,凱基-永和,2023-08-22,9207
6139,亞翔,3,0,3,凱基-永和,2023-08-22,9207
2059,川湖,4,1,3,凱基-永和,2023-08-22,9207
00931B,統一美債20年,3,0,3,凱基-永和,2023-08-22,9207
00751B,元大AAA至A公司債,3,0,3,凱基-永和,2023-08-22,9207
00730,富邦臺灣優質高息,3,0,3,凱基-永和,2023-08-22,9207
00665L,富邦�琤肭磪囓�2,3,0,3,凱基-永和,2023-08-22,9207
2363,矽統,275,174,101,凱基-永和,2023-08-23,9207
3653,健策,70,0,70,凱基-永和,2023-08-23,9207
3665,貿聯-KY,65,0,65,凱基-永和,2023-08-23,9207
6170,統振,121,63,58,凱基-永和,2023-08-23,9207
2887,台新金,43,0,43,凱基-永和,2023-08-23,9207
2605,新興,42,8,34,凱基-永和,2023-08-23,9207
3583,辛耘,28,4,24,凱基-永和,2023-08-23,9207
2618,長榮航,53,31,22,凱基-永和,2023-08-23,9207
2883,凱基金,21,0,21,凱基-永和,2023-08-23,9207
2890,永豐金,20,0,20,凱基-永和,2023-08-23,9207
2610,華航,18,1,17,凱基-永和,2023-08-23,9207
2539,櫻花建,15,0,15,凱基-永和,2023-08-23,9207
2332,友訊,32,22,10,凱基-永和,2023-08-23,9207
2852,第一保,9,0,9,凱基-永和,2023-08-23,9207
2884,玉山金,9,0,9,凱基-永和,2023-08-23,9207
2303,聯電,9,1,8,凱基-永和,2023-08-23,9207
2882,國泰金,9,1,8,凱基-永和,2023-08-23,9207
3689,湧德,8,0,8,凱基-永和,2023-08-23,9207
00712,復華富時不動產,7,0,7,凱基-永和,2023-08-23,9207
2383,台光電,7,0,7,凱基-永和,2023-08-23,9207
3693,營邦,8,1,7,凱基-永和,2023-08-23,9207
2615,萬海,8,2,6,凱基-永和,2023-08-23,9207
1722,台肥,6,0,6,凱基-永和,2023-08-23,9207
1217,愛之味,10,4,6,凱基-永和,2023-08-23,9207
8027,鈦昇,12,6,6,凱基-永和,2023-08-23,9207
2328,廣宇,5,0,5,凱基-永和,2023-08-23,9207
2867,三商壽,5,0,5,凱基-永和,2023-08-23,9207
3058,立德,5,0,5,凱基-永和,2023-08-23,9207
2002,中鋼,4,0,4,凱基-永和,2023-08-23,9207
2355,敬鵬,4,0,4,凱基-永和,2023-08-23,9207
6191,精成科,3,0,3,凱基-永和,2023-08-23,9207
2634,漢翔,114,111,3,凱基-永和,2023-08-23,9207
00671R,富邦NASDAQ反1,3,0,3,凱基-永和,2023-08-23,9207
2606,裕民,3,0,3,凱基-永和,2023-08-23,9207
3217,優群,3,0,3,凱基-永和,2023-08-23,9207
3704,合勤控,4,1,3,凱基-永和,2023-08-23,9207
6231,系微,8,5,3,凱基-永和,2023-08-23,9207
9929,秋雨,3,0,3,凱基-永和,2023-08-23,9207
6235,華孚,8,5,3,凱基-永和,2023-08-23,9207
1101,台泥,2,0,2,凱基-永和,2023-08-23,9207
00910,第一金太空衛星,2,0,2,凱基-永和,2023-08-23,9207
00895,富邦未來車,2,0,2,凱基-永和,2023-08-23,9207
2301,光寶科,9,7,2,凱基-永和,2023-08-23,9207
2421,建準,5,3,2,凱基-永和,2023-08-23,9207
2428,興勤,2,0,2,凱基-永和,2023-08-23,9207
2637,慧洋-KY,11,9,2,凱基-永和,2023-08-23,9207
2705,六福,2,0,2,凱基-永和,2023-08-23,9207
2885,元大金,4,2,2,凱基-永和,2023-08-23,9207
3042,晶技,2,0,2,凱基-永和,2023-08-23,9207
3078,僑威,5,3,2,凱基-永和,2023-08-23,9207
2382,廣達,269,97,172,凱基-永和,2023-08-24,9207
6109,亞元,57,0,57,凱基-永和,2023-08-24,9207
2401,凌陽,52,0,52,凱基-永和,2023-08-24,9207
3231,緯創,339,292,47,凱基-永和,2023-08-24,9207
2887,台新金,30,0,30,凱基-永和,2023-08-24,9207
2331,精英,38,9,29,凱基-永和,2023-08-24,9207
6167,久正,25,0,25,凱基-永和,2023-08-24,9207
3711,日月光投控,23,0,23,凱基-永和,2023-08-24,9207
3665,貿聯-KY,21,0,21,凱基-永和,2023-08-24,9207
2886,兆豐金,23,3,20,凱基-永和,2023-08-24,9207
6257,矽格,22,2,20,凱基-永和,2023-08-24,9207
2317,鴻海,36,18,18,凱基-永和,2023-08-24,9207
00929,復華台灣科技優息,19,2,17,凱基-永和,2023-08-24,9207
00632R,元大台灣50反1,15,0,15,凱基-永和,2023-08-24,9207
3388,崇越電,15,0,15,凱基-永和,2023-08-24,9207
3706,神達,24,9,15,凱基-永和,2023-08-24,9207
2883,凱基金,13,0,13,凱基-永和,2023-08-24,9207
3702,大聯大,15,2,13,凱基-永和,2023-08-24,9207
2006,東和鋼鐵,12,0,12,凱基-永和,2023-08-24,9207
1402,遠東新,12,0,12,凱基-永和,2023-08-24,9207
2882,國泰金,12,0,12,凱基-永和,2023-08-24,9207
2424,隴華,10,0,10,凱基-永和,2023-08-24,9207
2504,國產,10,0,10,凱基-永和,2023-08-24,9207
2867,三商壽,10,0,10,凱基-永和,2023-08-24,9207
3024,憶聲,11,1,10,凱基-永和,2023-08-24,9207
2884,玉山金,9,0,9,凱基-永和,2023-08-24,9207
2002,中鋼,9,0,9,凱基-永和,2023-08-24,9207
5457,宣德,9,0,9,凱基-永和,2023-08-24,9207
2419,仲琦,14,6,8,凱基-永和,2023-08-24,9207
2431,聯昌,8,0,8,凱基-永和,2023-08-24,9207
3265,台星科,9,1,8,凱基-永和,2023-08-24,9207
3380,明泰,12,4,8,凱基-永和,2023-08-24,9207
8930,青鋼,8,0,8,凱基-永和,2023-08-24,9207
3138,耀登,7,0,7,凱基-永和,2023-08-24,9207
5381,合正,7,0,7,凱基-永和,2023-08-24,9207
9937,全國,7,0,7,凱基-永和,2023-08-24,9207
2332,友訊,52,45,7,凱基-永和,2023-08-24,9207
8048,德勝,6,0,6,凱基-永和,2023-08-24,9207
8299,群聯,6,0,6,凱基-永和,2023-08-24,9207
2883B,凱基金乙特,5,0,5,凱基-永和,2023-08-24,9207
3032,偉訓,7,2,5,凱基-永和,2023-08-24,9207
3363,上詮,5,0,5,凱基-永和,2023-08-24,9207
3454,晶睿,5,0,5,凱基-永和,2023-08-24,9207
3622,洋華,5,0,5,凱基-永和,2023-08-24,9207
5371,中光電,6,1,5,凱基-永和,2023-08-24,9207
6589,台康生技,5,0,5,凱基-永和,2023-08-24,9207
2323,中環,4,0,4,凱基-永和,2023-08-24,9207
2449,京元電子,8,4,4,凱基-永和,2023-08-24,9207
3042,晶技,4,0,4,凱基-永和,2023-08-24,9207
4906,正文,6,2,4,凱基-永和,2023-08-24,9207
5703,亞都,60,0,60,凱基-永和,2023-08-25,9207
2706,第一店,58,0,58,凱基-永和,2023-08-25,9207
2739,寒舍,62,4,58,凱基-永和,2023-08-25,9207
2883,凱基金,48,0,48,凱基-永和,2023-08-25,9207
2359,所羅門,45,1,44,凱基-永和,2023-08-25,9207
00878,國泰永續高股息,48,4,44,凱基-永和,2023-08-25,9207
3231,緯創,294,252,42,凱基-永和,2023-08-25,9207
2344,華邦電,24,0,24,凱基-永和,2023-08-25,9207
2353,宏��,22,0,22,凱基-永和,2023-08-25,9207
00893,國泰智能電動車,19,1,18,凱基-永和,2023-08-25,9207
00708L,期元大S＆P黃金正2,18,0,18,凱基-永和,2023-08-25,9207
3706,神達,19,1,18,凱基-永和,2023-08-25,9207
00929,復華台灣科技優息,17,0,17,凱基-永和,2023-08-25,9207
2301,光寶科,29,15,14,凱基-永和,2023-08-25,9207
0056,元大高股息,13,0,13,凱基-永和,2023-08-25,9207
2332,友訊,13,1,12,凱基-永和,2023-08-25,9207
2409,友達,12,0,12,凱基-永和,2023-08-25,9207
6109,亞元,11,0,11,凱基-永和,2023-08-25,9207
2891,中信金,11,0,11,凱基-永和,2023-08-25,9207
2356,英業達,25,15,10,凱基-永和,2023-08-25,9207
00851,台新全球AI,10,0,10,凱基-永和,2023-08-25,9207
1802,台玻,10,0,10,凱基-永和,2023-08-25,9207
2303,聯電,11,2,9,凱基-永和,2023-08-25,9207
00919,群益台灣精選高息,9,0,9,凱基-永和,2023-08-25,9207
2401,凌陽,12,3,9,凱基-永和,2023-08-25,9207
5525,順天,9,0,9,凱基-永和,2023-08-25,9207
0050,元大台灣50,8,0,8,凱基-永和,2023-08-25,9207
2312,金寶,7,0,7,凱基-永和,2023-08-25,9207
2903,遠百,7,0,7,凱基-永和,2023-08-25,9207
3715,定穎投控,7,0,7,凱基-永和,2023-08-25,9207
4906,正文,11,4,7,凱基-永和,2023-08-25,9207
2882,國泰金,8,2,6,凱基-永和,2023-08-25,9207
3042,晶技,6,0,6,凱基-永和,2023-08-25,9207
3665,貿聯-KY,6,0,6,凱基-永和,2023-08-25,9207
2330,台積電,6,0,6,凱基-永和,2023-08-25,9207
00757,統一FANG+,66,61,5,凱基-永和,2023-08-25,9207
00922,國泰台灣領袖50,5,0,5,凱基-永和,2023-08-25,9207
00633L,富邦上証正2,5,0,5,凱基-永和,2023-08-25,9207
00647L,元大S＆P500正2,5,0,5,凱基-永和,2023-08-25,9207
00712,復華富時不動產,10,5,5,凱基-永和,2023-08-25,9207
8048,德勝,5,0,5,凱基-永和,2023-08-25,9207
8916,光隆,5,0,5,凱基-永和,2023-08-25,9207
6285,啟��,5,1,4,凱基-永和,2023-08-25,9207
3017,奇鋐,18,14,4,凱基-永和,2023-08-25,9207
1513,中興電,7,3,4,凱基-永和,2023-08-25,9207
2002,中鋼,4,0,4,凱基-永和,2023-08-25,9207
2603,長榮,6,2,4,凱基-永和,2023-08-25,9207
2328,廣宇,4,0,4,凱基-永和,2023-08-25,9207
3035,智原,9,5,4,凱基-永和,2023-08-25,9207
5269,祥碩,4,0,4,凱基-永和,2023-08-25,9207
2618,長榮航,162,24,138,凱基-永和,2023-08-28,9207
00929,復華台灣科技優息,84,0,84,凱基-永和,2023-08-28,9207
6443,元晶,60,0,60,凱基-永和,2023-08-28,9207
2485,兆赫,53,0,53,凱基-永和,2023-08-28,9207
6109,亞元,48,0,48,凱基-永和,2023-08-28,9207
5443,均豪,47,2,45,凱基-永和,2023-08-28,9207
00878,國泰永續高股息,35,8,27,凱基-永和,2023-08-28,9207
2610,華航,24,0,24,凱基-永和,2023-08-28,9207
2344,華邦電,21,0,21,凱基-永和,2023-08-28,9207
3062,建漢,21,0,21,凱基-永和,2023-08-28,9207
5381,合正,16,0,16,凱基-永和,2023-08-28,9207
2301,光寶科,22,8,14,凱基-永和,2023-08-28,9207
2331,精英,16,2,14,凱基-永和,2023-08-28,9207
1513,中興電,15,2,13,凱基-永和,2023-08-28,9207
3008,大立光,12,0,12,凱基-永和,2023-08-28,9207
3702,大聯大,10,0,10,凱基-永和,2023-08-28,9207
4906,正文,23,13,10,凱基-永和,2023-08-28,9207
00919,群益台灣精選高息,9,0,9,凱基-永和,2023-08-28,9207
2409,友達,8,0,8,凱基-永和,2023-08-28,9207
8034,榮群,13,5,8,凱基-永和,2023-08-28,9207
8916,光隆,8,0,8,凱基-永和,2023-08-28,9207
2369,菱生,31,24,7,凱基-永和,2023-08-28,9207
4763,材料-KY,7,0,7,凱基-永和,2023-08-28,9207
00637L,元大滬深300正2,13,7,6,凱基-永和,2023-08-28,9207
2388,威盛,9,3,6,凱基-永和,2023-08-28,9207
3029,零壹,6,0,6,凱基-永和,2023-08-28,9207
3078,僑威,6,0,6,凱基-永和,2023-08-28,9207
1402,遠東新,6,0,6,凱基-永和,2023-08-28,9207
2449,京元電子,15,10,5,凱基-永和,2023-08-28,9207
1737,臺鹽,17,12,5,凱基-永和,2023-08-28,9207
1909,榮成,5,0,5,凱基-永和,2023-08-28,9207
3088,艾訊,5,0,5,凱基-永和,2023-08-28,9207
4746,台耀,5,0,5,凱基-永和,2023-08-28,9207
4755,三福化,5,0,5,凱基-永和,2023-08-28,9207
6168,宏齊,6,1,5,凱基-永和,2023-08-28,9207
1709,和益,5,1,4,凱基-永和,2023-08-28,9207
2323,中環,4,0,4,凱基-永和,2023-08-28,9207
2884,玉山金,4,0,4,凱基-永和,2023-08-28,9207
2887,台新金,4,0,4,凱基-永和,2023-08-28,9207
3032,偉訓,4,0,4,凱基-永和,2023-08-28,9207
6125,廣運,5,1,4,凱基-永和,2023-08-28,9207
6147,頎邦,5,1,4,凱基-永和,2023-08-28,9207
6203,海韻電,4,0,4,凱基-永和,2023-08-28,9207
00850,元大臺灣ESG永續,3,0,3,凱基-永和,2023-08-28,9207
00706L,期元大S＆P日圓正2,3,0,3,凱基-永和,2023-08-28,9207
2353,宏��,3,0,3,凱基-永和,2023-08-28,9207
2468,華經,3,0,3,凱基-永和,2023-08-28,9207
2630,亞航,3,0,3,凱基-永和,2023-08-28,9207
2834,臺企銀,3,0,3,凱基-永和,2023-08-28,9207
2903,遠百,3,0,3,凱基-永和,2023-08-28,9207
2337,旺宏,188,2,186,凱基-永和,2023-08-29,9207
2344,華邦電,50,8,42,凱基-永和,2023-08-29,9207
3231,緯創,28,5,23,凱基-永和,2023-08-29,9207
2867,三商壽,23,0,23,凱基-永和,2023-08-29,9207
2516,新建,27,5,22,凱基-永和,2023-08-29,9207
6109,亞元,19,0,19,凱基-永和,2023-08-29,9207
2317,鴻海,18,0,18,凱基-永和,2023-08-29,9207
0056,元大高股息,17,1,16,凱基-永和,2023-08-29,9207
00929,復華台灣科技優息,15,0,15,凱基-永和,2023-08-29,9207
5314,世紀,13,0,13,凱基-永和,2023-08-29,9207
6116,彩晶,10,0,10,凱基-永和,2023-08-29,9207
1217,愛之味,10,0,10,凱基-永和,2023-08-29,9207
00633L,富邦上証正2,10,0,10,凱基-永和,2023-08-29,9207
1471,首利,10,1,9,凱基-永和,2023-08-29,9207
2392,正崴,10,1,9,凱基-永和,2023-08-29,9207
2903,遠百,10,1,9,凱基-永和,2023-08-29,9207
6531,愛普*,9,0,9,凱基-永和,2023-08-29,9207
5009,榮剛,7,1,6,凱基-永和,2023-08-29,9207
1532,勤美,6,0,6,凱基-永和,2023-08-29,9207
2886,兆豐金,6,0,6,凱基-永和,2023-08-29,9207
3042,晶技,5,0,5,凱基-永和,2023-08-29,9207
00881,國泰台灣5G+,5,0,5,凱基-永和,2023-08-29,9207
2915,潤泰全,5,0,5,凱基-永和,2023-08-29,9207
5351,鈺創,5,0,5,凱基-永和,2023-08-29,9207
5880,合庫金,5,0,5,凱基-永和,2023-08-29,9207
8222,寶一,12,7,5,凱基-永和,2023-08-29,9207
2002,中鋼,4,0,4,凱基-永和,2023-08-29,9207
1612,宏泰,4,0,4,凱基-永和,2023-08-29,9207
1904,正隆,4,0,4,凱基-永和,2023-08-29,9207
2891,中信金,5,1,4,凱基-永和,2023-08-29,9207
3388,崇越電,6,2,4,凱基-永和,2023-08-29,9207
6182,合晶,5,1,4,凱基-永和,2023-08-29,9207
2303,聯電,11,7,4,凱基-永和,2023-08-29,9207
00919,群益台灣精選高息,3,0,3,凱基-永和,2023-08-29,9207
00671R,富邦NASDAQ反1,3,0,3,凱基-永和,2023-08-29,9207
2353,宏��,3,0,3,凱基-永和,2023-08-29,9207
2354,鴻準,3,0,3,凱基-永和,2023-08-29,9207
2425,承啟,3,0,3,凱基-永和,2023-08-29,9207
2484,希華,3,0,3,凱基-永和,2023-08-29,9207
2630,亞航,6,3,3,凱基-永和,2023-08-29,9207
3013,晟銘電,3,0,3,凱基-永和,2023-08-29,9207
3289,宜特,4,1,3,凱基-永和,2023-08-29,9207
6216,居易,3,0,3,凱基-永和,2023-08-29,9207
6488,環球晶,3,0,3,凱基-永和,2023-08-29,9207
2363,矽統,573,571,2,凱基-永和,2023-08-29,9207
2603,長榮,2,0,2,凱基-永和,2023-08-29,9207
4108,懷特,2,0,2,凱基-永和,2023-08-29,9207
4906,正文,5,3,2,凱基-永和,2023-08-29,9207
00637L,元大滬深300正2,2,0,2,凱基-永和,2023-08-29,9207
00679B,元大美債20年,2,0,2,凱基-永和,2023-08-29,9207
2376,技嘉,172,3,169,凱基-永和,2023-08-30,9207
2382,廣達,156,7,149,凱基-永和,2023-08-30,9207
2303,聯電,121,11,110,凱基-永和,2023-08-30,9207
2485,兆赫,109,12,97,凱基-永和,2023-08-30,9207
2363,矽統,219,129,90,凱基-永和,2023-08-30,9207
00919,群益台灣精選高息,82,0,82,凱基-永和,2023-08-30,9207
3706,神達,40,0,40,凱基-永和,2023-08-30,9207
2317,鴻海,40,2,38,凱基-永和,2023-08-30,9207
4906,正文,45,8,37,凱基-永和,2023-08-30,9207
2455,全新,198,166,32,凱基-永和,2023-08-30,9207
00885,富邦越南,26,0,26,凱基-永和,2023-08-30,9207
3711,日月光投控,23,1,22,凱基-永和,2023-08-30,9207
6109,亞元,17,0,17,凱基-永和,2023-08-30,9207
8210,勤誠,19,3,16,凱基-永和,2023-08-30,9207
3481,群創,13,0,13,凱基-永和,2023-08-30,9207
2324,仁寶,12,1,11,凱基-永和,2023-08-30,9207
2408,南亞科,11,0,11,凱基-永和,2023-08-30,9207
1101,台泥,10,0,10,凱基-永和,2023-08-30,9207
2368,金像電,10,0,10,凱基-永和,2023-08-30,9207
3163,波若威,10,0,10,凱基-永和,2023-08-30,9207
3231,緯創,21,11,10,凱基-永和,2023-08-30,9207
3703,欣陸,10,0,10,凱基-永和,2023-08-30,9207
6547,高端疫苗,10,0,10,凱基-永和,2023-08-30,9207
8021,尖點,10,0,10,凱基-永和,2023-08-30,9207
2201,裕隆,12,3,9,凱基-永和,2023-08-30,9207
1524,耿鼎,7,0,7,凱基-永和,2023-08-30,9207
2301,光寶科,12,5,7,凱基-永和,2023-08-30,9207
3308,聯德,34,27,7,凱基-永和,2023-08-30,9207
00891,中信關鍵半導體,6,0,6,凱基-永和,2023-08-30,9207
3094,聯傑,10,4,6,凱基-永和,2023-08-30,9207
5483,中美晶,6,0,6,凱基-永和,2023-08-30,9207
6111,大宇資,8,2,6,凱基-永和,2023-08-30,9207
1319,東陽,8,3,5,凱基-永和,2023-08-30,9207
1815,富喬,6,1,5,凱基-永和,2023-08-30,9207
3013,晟銘電,5,0,5,凱基-永和,2023-08-30,9207
2101,南港,4,0,4,凱基-永和,2023-08-30,9207
2352,佳世達,5,1,4,凱基-永和,2023-08-30,9207
2516,新建,4,0,4,凱基-永和,2023-08-30,9207
3032,偉訓,5,1,4,凱基-永和,2023-08-30,9207
3338,泰碩,4,0,4,凱基-永和,2023-08-30,9207
6274,台燿,4,0,4,凱基-永和,2023-08-30,9207
6285,啟��,5,1,4,凱基-永和,2023-08-30,9207
1504,東元,4,0,4,凱基-永和,2023-08-30,9207
2884,玉山金,3,0,3,凱基-永和,2023-08-30,9207
2891,中信金,4,1,3,凱基-永和,2023-08-30,9207
1513,中興電,3,0,3,凱基-永和,2023-08-30,9207
2528,皇普,3,0,3,凱基-永和,2023-08-30,9207
2630,亞航,9,6,3,凱基-永和,2023-08-30,9207
2897,王道銀行,3,0,3,凱基-永和,2023-08-30,9207
2903,遠百,3,0,3,凱基-永和,2023-08-30,9207
2329,華泰,102,4,98,凱基-永和,2023-08-31,9207
00929,復華台灣科技優息,60,0,60,凱基-永和,2023-08-31,9207
2363,矽統,178,140,38,凱基-永和,2023-08-31,9207
4510,高鋒,29,0,29,凱基-永和,2023-08-31,9207
3481,群創,20,1,19,凱基-永和,2023-08-31,9207
5014,建錩,18,0,18,凱基-永和,2023-08-31,9207
1101,台泥,15,0,15,凱基-永和,2023-08-31,9207
6109,亞元,15,0,15,凱基-永和,2023-08-31,9207
00878,國泰永續高股息,14,0,14,凱基-永和,2023-08-31,9207
3035,智原,13,1,12,凱基-永和,2023-08-31,9207
4564,元翎,12,0,12,凱基-永和,2023-08-31,9207
00888,永豐台灣ESG,10,0,10,凱基-永和,2023-08-31,9207
2367,燿華,10,0,10,凱基-永和,2023-08-31,9207
2867,三商壽,10,0,10,凱基-永和,2023-08-31,9207
4129,聯合,10,0,10,凱基-永和,2023-08-31,9207
5425,台半,10,0,10,凱基-永和,2023-08-31,9207
6438,迅得,10,0,10,凱基-永和,2023-08-31,9207
00662,富邦NASDAQ,8,0,8,凱基-永和,2023-08-31,9207
2884,玉山金,7,0,7,凱基-永和,2023-08-31,9207
1471,首利,7,0,7,凱基-永和,2023-08-31,9207
1802,台玻,11,4,7,凱基-永和,2023-08-31,9207
3693,營邦,7,0,7,凱基-永和,2023-08-31,9207
2886,兆豐金,6,0,6,凱基-永和,2023-08-31,9207
00647L,元大S＆P500正2,6,0,6,凱基-永和,2023-08-31,9207
1519,華城,6,0,6,凱基-永和,2023-08-31,9207
2704,國賓,6,0,6,凱基-永和,2023-08-31,9207
3308,聯德,9,3,6,凱基-永和,2023-08-31,9207
9904,寶成,6,0,6,凱基-永和,2023-08-31,9207
2301,光寶科,12,6,6,凱基-永和,2023-08-31,9207
2883,凱基金,5,0,5,凱基-永和,2023-08-31,9207
1409,新纖,5,0,5,凱基-永和,2023-08-31,9207
2027,大成鋼,5,0,5,凱基-永和,2023-08-31,9207
2436,偉詮電,11,6,5,凱基-永和,2023-08-31,9207
3325,旭品,5,0,5,凱基-永和,2023-08-31,9207
4123,晟德,5,0,5,凱基-永和,2023-08-31,9207
4953,緯軟,5,0,5,凱基-永和,2023-08-31,9207
6114,久威,5,0,5,凱基-永和,2023-08-31,9207
6116,彩晶,5,0,5,凱基-永和,2023-08-31,9207
6168,宏齊,5,0,5,凱基-永和,2023-08-31,9207
8033,雷虎,5,0,5,凱基-永和,2023-08-31,9207
2324,仁寶,5,1,4,凱基-永和,2023-08-31,9207
2892,第一金,4,0,4,凱基-永和,2023-08-31,9207
2492,華新科,4,0,4,凱基-永和,2023-08-31,9207
1605,華新,4,0,4,凱基-永和,2023-08-31,9207
1301,台塑,4,0,4,凱基-永和,2023-08-31,9207
2610,華航,4,0,4,凱基-永和,2023-08-31,9207
2882,國泰金,4,0,4,凱基-永和,2023-08-31,9207
3014,聯陽,5,1,4,凱基-永和,2023-08-31,9207
3149,正達,4,0,4,凱基-永和,2023-08-31,9207
3714,富采,4,0,4,凱基-永和,2023-08-31,9207
1802,台玻,450,326,124,凱基-永和,2023-09-01,9207
5381,合正,100,0,100,凱基-永和,2023-09-01,9207
00919,群益台灣精選高息,65,0,65,凱基-永和,2023-09-01,9207
2492,華新科,138,83,55,凱基-永和,2023-09-01,9207
5443,均豪,48,0,48,凱基-永和,2023-09-01,9207
00929,復華台灣科技優息,37,0,37,凱基-永和,2023-09-01,9207
00878,國泰永續高股息,30,4,26,凱基-永和,2023-09-01,9207
2884,玉山金,29,3,26,凱基-永和,2023-09-01,9207
5215,科嘉-KY,25,0,25,凱基-永和,2023-09-01,9207
6285,啟��,24,1,23,凱基-永和,2023-09-01,9207
2337,旺宏,34,12,22,凱基-永和,2023-09-01,9207
2356,英業達,27,5,22,凱基-永和,2023-09-01,9207
1101,台泥,18,1,17,凱基-永和,2023-09-01,9207
8358,金居,19,3,16,凱基-永和,2023-09-01,9207
00671R,富邦NASDAQ反1,15,0,15,凱基-永和,2023-09-01,9207
1722,台肥,15,0,15,凱基-永和,2023-09-01,9207
2887,台新金,14,0,14,凱基-永和,2023-09-01,9207
00932,兆豐永續高息等權,14,0,14,凱基-永和,2023-09-01,9207
2308,台達電,14,0,14,凱基-永和,2023-09-01,9207
2312,金寶,21,8,13,凱基-永和,2023-09-01,9207
1522,堤維西,34,23,11,凱基-永和,2023-09-01,9207
00669R,國泰美國道瓊反1,10,0,10,凱基-永和,2023-09-01,9207
00648R,元大S＆P500反1,10,0,10,凱基-永和,2023-09-01,9207
00632R,元大台灣50反1,10,0,10,凱基-永和,2023-09-01,9207
1338,廣華-KY,10,0,10,凱基-永和,2023-09-01,9207
8097,常珵,10,0,10,凱基-永和,2023-09-01,9207
2892,第一金,10,0,10,凱基-永和,2023-09-01,9207
5009,榮剛,10,0,10,凱基-永和,2023-09-01,9207
1513,中興電,10,1,9,凱基-永和,2023-09-01,9207
5388,中磊,11,3,8,凱基-永和,2023-09-01,9207
6834,天二科技,7,0,7,凱基-永和,2023-09-01,9207
1471,首利,6,0,6,凱基-永和,2023-09-01,9207
3702,大聯大,6,0,6,凱基-永和,2023-09-01,9207
00679B,元大美債20年,5,0,5,凱基-永和,2023-09-01,9207
2206,三陽工業,12,7,5,凱基-永和,2023-09-01,9207
1314,中石化,5,0,5,凱基-永和,2023-09-01,9207
00893,國泰智能電動車,5,0,5,凱基-永和,2023-09-01,9207
3078,僑威,6,1,5,凱基-永和,2023-09-01,9207
3380,明泰,5,0,5,凱基-永和,2023-09-01,9207
3450,聯鈞,5,0,5,凱基-永和,2023-09-01,9207
6505,台塑化,5,0,5,凱基-永和,2023-09-01,9207
6672,騰輝電子-KY,5,0,5,凱基-永和,2023-09-01,9207
2382,廣達,14,9,5,凱基-永和,2023-09-01,9207
1210,大成,4,0,4,凱基-永和,2023-09-01,9207
1560,中砂,4,0,4,凱基-永和,2023-09-01,9207
2367,燿華,6,2,4,凱基-永和,2023-09-01,9207
2897,王道銀行,5,1,4,凱基-永和,2023-09-01,9207
3051,力特,16,12,4,凱基-永和,2023-09-01,9207
6109,亞元,4,0,4,凱基-永和,2023-09-01,9207
00885,富邦越南,3,0,3,凱基-永和,2023-09-01,9207
2888,新光金,422,10,412,凱基-永和,2023-09-04,9207
3231,緯創,101,2,99,凱基-永和,2023-09-04,9207
2436,偉詮電,142,44,98,凱基-永和,2023-09-04,9207
3105,穩懋,91,4,87,凱基-永和,2023-09-04,9207
00919,群益台灣精選高息,61,0,61,凱基-永和,2023-09-04,9207
2610,華航,51,0,51,凱基-永和,2023-09-04,9207
3051,力特,60,10,50,凱基-永和,2023-09-04,9207
4542,科嶠,50,0,50,凱基-永和,2023-09-04,9207
00931B,統一美債20年,32,2,30,凱基-永和,2023-09-04,9207
2328,廣宇,30,0,30,凱基-永和,2023-09-04,9207
3163,波若威,31,2,29,凱基-永和,2023-09-04,9207
2618,長榮航,23,2,21,凱基-永和,2023-09-04,9207
5314,世紀,20,0,20,凱基-永和,2023-09-04,9207
00918,大華優利高填息30,17,0,17,凱基-永和,2023-09-04,9207
00715L,期街口布蘭特正2,17,1,16,凱基-永和,2023-09-04,9207
6223,旺矽,18,2,16,凱基-永和,2023-09-04,9207
00633L,富邦上証正2,15,0,15,凱基-永和,2023-09-04,9207
8034,榮群,14,0,14,凱基-永和,2023-09-04,9207
6173,信昌電,16,4,12,凱基-永和,2023-09-04,9207
00673R,期元大S＆P原油反1,12,0,12,凱基-永和,2023-09-04,9207
1605,華新,17,5,12,凱基-永和,2023-09-04,9207
1444,力麗,10,0,10,凱基-永和,2023-09-04,9207
2323,中環,10,0,10,凱基-永和,2023-09-04,9207
5243,乙盛-KY,10,0,10,凱基-永和,2023-09-04,9207
8076,伍豐,7,0,7,凱基-永和,2023-09-04,9207
8069,元太,6,0,6,凱基-永和,2023-09-04,9207
3035,智原,8,2,6,凱基-永和,2023-09-04,9207
2206,三陽工業,6,0,6,凱基-永和,2023-09-04,9207
00725B,國泰投資級公司債,5,0,5,凱基-永和,2023-09-04,9207
1584,精剛,15,10,5,凱基-永和,2023-09-04,9207
2329,華泰,10,5,5,凱基-永和,2023-09-04,9207
2543,皇昌,5,0,5,凱基-永和,2023-09-04,9207
3017,奇鋐,5,0,5,凱基-永和,2023-09-04,9207
3027,盛達,5,0,5,凱基-永和,2023-09-04,9207
6515,穎崴,5,0,5,凱基-永和,2023-09-04,9207
2881,富邦金,4,0,4,凱基-永和,2023-09-04,9207
00687B,國泰20年美債,4,0,4,凱基-永和,2023-09-04,9207
1522,堤維西,8,4,4,凱基-永和,2023-09-04,9207
1616,億泰,4,0,4,凱基-永和,2023-09-04,9207
2516,新建,4,0,4,凱基-永和,2023-09-04,9207
8446,華研,3,0,3,凱基-永和,2023-09-04,9207
2464,盟立,4,1,3,凱基-永和,2023-09-04,9207
00751B,元大AAA至A公司債,3,0,3,凱基-永和,2023-09-04,9207
00915,凱基優選高股息30,3,0,3,凱基-永和,2023-09-04,9207
00679B,元大美債20年,3,0,3,凱基-永和,2023-09-04,9207
1503,士電,3,0,3,凱基-永和,2023-09-04,9207
2337,旺宏,14,11,3,凱基-永和,2023-09-04,9207
3042,晶技,5,2,3,凱基-永和,2023-09-04,9207
3290,東浦,3,0,3,凱基-永和,2023-09-04,9207
3663,鑫科,3,0,3,凱基-永和,2023-09-04,9207
2331,精英,109,14,95,凱基-永和,2023-09-05,9207
2401,凌陽,407,318,89,凱基-永和,2023-09-05,9207
5443,均豪,50,0,50,凱基-永和,2023-09-05,9207
6770,力積電,50,0,50,凱基-永和,2023-09-05,9207
6274,台燿,185,138,47,凱基-永和,2023-09-05,9207
00633L,富邦上証正2,45,0,45,凱基-永和,2023-09-05,9207
00919,群益台灣精選高息,73,29,44,凱基-永和,2023-09-05,9207
00679B,元大美債20年,43,0,43,凱基-永和,2023-09-05,9207
2482,連宇,32,1,31,凱基-永和,2023-09-05,9207
3363,上詮,50,25,25,凱基-永和,2023-09-05,9207
2344,華邦電,24,1,23,凱基-永和,2023-09-05,9207
6173,信昌電,25,4,21,凱基-永和,2023-09-05,9207
3051,力特,40,19,21,凱基-永和,2023-09-05,9207
4961,天鈺,21,1,20,凱基-永和,2023-09-05,9207
3706,神達,22,2,20,凱基-永和,2023-09-05,9207
5328,華容,20,0,20,凱基-永和,2023-09-05,9207
8016,矽創,20,1,19,凱基-永和,2023-09-05,9207
2881,富邦金,17,0,17,凱基-永和,2023-09-05,9207
2388,威盛,14,0,14,凱基-永和,2023-09-05,9207
2618,長榮航,12,1,11,凱基-永和,2023-09-05,9207
5243,乙盛-KY,11,0,11,凱基-永和,2023-09-05,9207
8390,金益鼎,10,0,10,凱基-永和,2023-09-05,9207
2376,技嘉,11,1,10,凱基-永和,2023-09-05,9207
2834,臺企銀,10,0,10,凱基-永和,2023-09-05,9207
2317,鴻海,10,0,10,凱基-永和,2023-09-05,9207
2485,兆赫,11,1,10,凱基-永和,2023-09-05,9207
3260,威剛,15,5,10,凱基-永和,2023-09-05,9207
4747,強生,10,0,10,凱基-永和,2023-09-05,9207
9937,全國,10,0,10,凱基-永和,2023-09-05,9207
5439,高技,10,1,9,凱基-永和,2023-09-05,9207
00932,兆豐永續高息等權,9,0,9,凱基-永和,2023-09-05,9207
00915,凱基優選高股息30,10,1,9,凱基-永和,2023-09-05,9207
2371,大同,10,1,9,凱基-永和,2023-09-05,9207
00751B,元大AAA至A公司債,8,0,8,凱基-永和,2023-09-05,9207
5347,世界,7,0,7,凱基-永和,2023-09-05,9207
00687B,國泰20年美債,6,0,6,凱基-永和,2023-09-05,9207
2354,鴻準,6,0,6,凱基-永和,2023-09-05,9207
2409,友達,6,0,6,凱基-永和,2023-09-05,9207
8299,群聯,6,0,6,凱基-永和,2023-09-05,9207
2363,矽統,231,225,6,凱基-永和,2023-09-05,9207
3231,緯創,58,53,5,凱基-永和,2023-09-05,9207
00891,中信關鍵半導體,5,0,5,凱基-永和,2023-09-05,9207
00888,永豐台灣ESG,5,0,5,凱基-永和,2023-09-05,9207
00725B,國泰投資級公司債,5,0,5,凱基-永和,2023-09-05,9207
2634,漢翔,6,1,5,凱基-永和,2023-09-05,9207
6757,台灣虎航,5,0,5,凱基-永和,2023-09-05,9207
2301,光寶科,8,4,4,凱基-永和,2023-09-05,9207
1210,大成,4,0,4,凱基-永和,2023-09-05,9207
1101,台泥,4,0,4,凱基-永和,2023-09-05,9207
00753L,中信中國50正2,4,0,4,凱基-永和,2023-09-05,9207
00929,復華台灣科技優息,180,17,163,凱基-永和,2023-09-06,9207
5302,太欣,100,0,100,凱基-永和,2023-09-06,9207
2368,金像電,91,1,90,凱基-永和,2023-09-06,9207
00919,群益台灣精選高息,68,10,58,凱基-永和,2023-09-06,9207
6109,亞元,39,0,39,凱基-永和,2023-09-06,9207
2618,長榮航,25,1,24,凱基-永和,2023-09-06,9207
3481,群創,24,0,24,凱基-永和,2023-09-06,9207
00772B,中信高評級公司債,23,0,23,凱基-永和,2023-09-06,9207
2344,華邦電,22,0,22,凱基-永和,2023-09-06,9207
9928,中視,20,0,20,凱基-永和,2023-09-06,9207
00915,凱基優選高股息30,21,2,19,凱基-永和,2023-09-06,9207
5880,合庫金,18,0,18,凱基-永和,2023-09-06,9207
2884,玉山金,14,0,14,凱基-永和,2023-09-06,9207
2002,中鋼,12,0,12,凱基-永和,2023-09-06,9207
2891,中信金,12,0,12,凱基-永和,2023-09-06,9207
00931B,統一美債20年,11,0,11,凱基-永和,2023-09-06,9207
00713,元大台灣高息低波,10,0,10,凱基-永和,2023-09-06,9207
00882,中信中國高股息,10,0,10,凱基-永和,2023-09-06,9207
00679B,元大美債20年,10,0,10,凱基-永和,2023-09-06,9207
1709,和益,10,0,10,凱基-永和,2023-09-06,9207
3024,憶聲,10,0,10,凱基-永和,2023-09-06,9207
00692,富邦公司治理,10,0,10,凱基-永和,2023-09-06,9207
00720B,元大投資級公司債,9,0,9,凱基-永和,2023-09-06,9207
8426,紅木-KY,9,0,9,凱基-永和,2023-09-06,9207
2324,仁寶,8,0,8,凱基-永和,2023-09-06,9207
3264,欣銓,8,0,8,凱基-永和,2023-09-06,9207
2436,偉詮電,7,0,7,凱基-永和,2023-09-06,9207
2605,新興,7,0,7,凱基-永和,2023-09-06,9207
2376,技嘉,10,4,6,凱基-永和,2023-09-06,9207
2887,台新金,6,0,6,凱基-永和,2023-09-06,9207
00918,大華優利高填息30,6,0,6,凱基-永和,2023-09-06,9207
1616,億泰,6,0,6,凱基-永和,2023-09-06,9207
2331,精英,6,0,6,凱基-永和,2023-09-06,9207
4128,中天,6,0,6,凱基-永和,2023-09-06,9207
2027,大成鋼,5,0,5,凱基-永和,2023-09-06,9207
2457,飛宏,12,7,5,凱基-永和,2023-09-06,9207
5347,世界,5,0,5,凱基-永和,2023-09-06,9207
1722,台肥,5,0,5,凱基-永和,2023-09-06,9207
2425,承啟,6,1,5,凱基-永和,2023-09-06,9207
2543,皇昌,5,0,5,凱基-永和,2023-09-06,9207
2801,彰銀,5,0,5,凱基-永和,2023-09-06,9207
4533,協易機,6,1,5,凱基-永和,2023-09-06,9207
00923,群益台ESG低碳50,5,1,4,凱基-永和,2023-09-06,9207
2886,兆豐金,4,0,4,凱基-永和,2023-09-06,9207
4743,合一,4,0,4,凱基-永和,2023-09-06,9207
1802,台玻,4,0,4,凱基-永和,2023-09-06,9207
2421,建準,6,2,4,凱基-永和,2023-09-06,9207
2482,連宇,4,0,4,凱基-永和,2023-09-06,9207
2485,兆赫,35,31,4,凱基-永和,2023-09-06,9207
2838,聯邦銀,4,0,4,凱基-永和,2023-09-06,9207
00919,群益台灣精選高息,62,1,61,凱基-永和,2023-09-07,9207
2409,友達,66,6,60,凱基-永和,2023-09-07,9207
6148,驊宏資,60,0,60,凱基-永和,2023-09-07,9207
00632R,元大台灣50反1,50,0,50,凱基-永和,2023-09-07,9207
00915,凱基優選高股息30,39,0,39,凱基-永和,2023-09-07,9207
1722,台肥,35,0,35,凱基-永和,2023-09-07,9207
2884,玉山金,34,0,34,凱基-永和,2023-09-07,9207
00929,復華台灣科技優息,38,8,30,凱基-永和,2023-09-07,9207
2328,廣宇,30,0,30,凱基-永和,2023-09-07,9207
6116,彩晶,30,0,30,凱基-永和,2023-09-07,9207
8358,金居,29,0,29,凱基-永和,2023-09-07,9207
5351,鈺創,36,10,26,凱基-永和,2023-09-07,9207
2329,華泰,24,2,22,凱基-永和,2023-09-07,9207
2838,聯邦銀,22,0,22,凱基-永和,2023-09-07,9207
5388,中磊,23,1,22,凱基-永和,2023-09-07,9207
4533,協易機,58,38,20,凱基-永和,2023-09-07,9207
3260,威剛,21,2,19,凱基-永和,2023-09-07,9207
2330,台積電,18,0,18,凱基-永和,2023-09-07,9207
1101,台泥,17,0,17,凱基-永和,2023-09-07,9207
2618,長榮航,18,1,17,凱基-永和,2023-09-07,9207
2486,一詮,30,14,16,凱基-永和,2023-09-07,9207
2485,兆赫,261,248,13,凱基-永和,2023-09-07,9207
2408,南亞科,13,1,12,凱基-永和,2023-09-07,9207
00679B,元大美債20年,11,0,11,凱基-永和,2023-09-07,9207
2543,皇昌,11,0,11,凱基-永和,2023-09-07,9207
1319,東陽,14,4,10,凱基-永和,2023-09-07,9207
2412,中華電,10,0,10,凱基-永和,2023-09-07,9207
2906,高林,10,0,10,凱基-永和,2023-09-07,9207
3055,蔚華科,10,0,10,凱基-永和,2023-09-07,9207
3062,建漢,10,0,10,凱基-永和,2023-09-07,9207
2324,仁寶,9,0,9,凱基-永和,2023-09-07,9207
2610,華航,9,0,9,凱基-永和,2023-09-07,9207
3323,加百裕,9,0,9,凱基-永和,2023-09-07,9207
0050,元大台灣50,9,0,9,凱基-永和,2023-09-07,9207
1616,億泰,8,0,8,凱基-永和,2023-09-07,9207
6139,亞翔,8,0,8,凱基-永和,2023-09-07,9207
1513,中興電,7,0,7,凱基-永和,2023-09-07,9207
1612,宏泰,8,1,7,凱基-永和,2023-09-07,9207
00851,台新全球AI,6,0,6,凱基-永和,2023-09-07,9207
00891,中信關鍵半導體,6,0,6,凱基-永和,2023-09-07,9207
00932,兆豐永續高息等權,6,0,6,凱基-永和,2023-09-07,9207
2421,建準,7,1,6,凱基-永和,2023-09-07,9207
3013,晟銘電,7,1,6,凱基-永和,2023-09-07,9207
3051,力特,7,1,6,凱基-永和,2023-09-07,9207
8299,群聯,6,0,6,凱基-永和,2023-09-07,9207
00923,群益台ESG低碳50,6,0,6,凱基-永和,2023-09-07,9207
00893,國泰智能電動車,5,0,5,凱基-永和,2023-09-07,9207
2101,南港,5,0,5,凱基-永和,2023-09-07,9207
3615,安可,5,0,5,凱基-永和,2023-09-07,9207
3704,合勤控,63,58,5,凱基-永和,2023-09-07,9207
2405,輔信,101,2,99,凱基-永和,2023-09-08,9207
00919,群益台灣精選高息,94,1,93,凱基-永和,2023-09-08,9207
00918,大華優利高填息30,36,2,34,凱基-永和,2023-09-08,9207
8034,榮群,39,5,34,凱基-永和,2023-09-08,9207
1722,台肥,30,0,30,凱基-永和,2023-09-08,9207
2328,廣宇,30,1,29,凱基-永和,2023-09-08,9207
2618,長榮航,26,0,26,凱基-永和,2023-09-08,9207
00915,凱基優選高股息30,16,0,16,凱基-永和,2023-09-08,9207
2486,一詮,16,3,13,凱基-永和,2023-09-08,9207
2412,中華電,12,0,12,凱基-永和,2023-09-08,9207
2421,建準,12,1,11,凱基-永和,2023-09-08,9207
2801,彰銀,11,0,11,凱基-永和,2023-09-08,9207
2897,王道銀行,11,0,11,凱基-永和,2023-09-08,9207
4958,臻鼎-KY,10,0,10,凱基-永和,2023-09-08,9207
2504,國產,10,0,10,凱基-永和,2023-09-08,9207
3615,安可,10,0,10,凱基-永和,2023-09-08,9207
4944,兆遠,10,0,10,凱基-永和,2023-09-08,9207
6223,旺矽,20,10,10,凱基-永和,2023-09-08,9207
6274,台燿,10,1,9,凱基-永和,2023-09-08,9207
2884,玉山金,10,2,8,凱基-永和,2023-09-08,9207
00878,國泰永續高股息,8,0,8,凱基-永和,2023-09-08,9207
3013,晟銘電,8,1,7,凱基-永和,2023-09-08,9207
8050,廣積,84,77,7,凱基-永和,2023-09-08,9207
3043,科風,7,1,6,凱基-永和,2023-09-08,9207
3715,定穎投控,18,12,6,凱基-永和,2023-09-08,9207
2303,聯電,6,0,6,凱基-永和,2023-09-08,9207
3693,營邦,6,0,6,凱基-永和,2023-09-08,9207
3035,智原,13,7,6,凱基-永和,2023-09-08,9207
1101,台泥,5,0,5,凱基-永和,2023-09-08,9207
00757,統一FANG+,8,3,5,凱基-永和,2023-09-08,9207
1471,首利,6,1,5,凱基-永和,2023-09-08,9207
2027,大成鋼,5,0,5,凱基-永和,2023-09-08,9207
3078,僑威,5,0,5,凱基-永和,2023-09-08,9207
3217,優群,5,0,5,凱基-永和,2023-09-08,9207
4916,事欣科,5,0,5,凱基-永和,2023-09-08,9207
6109,亞元,5,0,5,凱基-永和,2023-09-08,9207
2330,台積電,6,1,5,凱基-永和,2023-09-08,9207
0050,元大台灣50,4,0,4,凱基-永和,2023-09-08,9207
3522,御嵿,4,0,4,凱基-永和,2023-09-08,9207
00882,中信中國高股息,4,0,4,凱基-永和,2023-09-08,9207
2402,毅嘉,6,2,4,凱基-永和,2023-09-08,9207
8271,宇瞻,4,0,4,凱基-永和,2023-09-08,9207
00931B,統一美債20年,3,0,3,凱基-永和,2023-09-08,9207
00637L,元大滬深300正2,3,0,3,凱基-永和,2023-09-08,9207
1442,名軒,3,0,3,凱基-永和,2023-09-08,9207
2002,中鋼,3,0,3,凱基-永和,2023-09-08,9207
2630,亞航,152,149,3,凱基-永和,2023-09-08,9207
2834,臺企銀,3,0,3,凱基-永和,2023-09-08,9207
3617,碩天,6,3,3,凱基-永和,2023-09-08,9207
4147,中裕,10,7,3,凱基-永和,2023-09-08,9207
00919,群益台灣精選高息,105,0,105,凱基-永和,2023-09-11,9207
00878,國泰永續高股息,77,21,56,凱基-永和,2023-09-11,9207
3024,憶聲,30,0,30,凱基-永和,2023-09-11,9207
2353,宏��,30,0,30,凱基-永和,2023-09-11,9207
2457,飛宏,39,10,29,凱基-永和,2023-09-11,9207
8358,金居,28,0,28,凱基-永和,2023-09-11,9207
2610,華航,27,1,26,凱基-永和,2023-09-11,9207
6116,彩晶,25,0,25,凱基-永和,2023-09-11,9207
3231,緯創,31,8,23,凱基-永和,2023-09-11,9207
6109,亞元,23,0,23,凱基-永和,2023-09-11,9207
2618,長榮航,34,12,22,凱基-永和,2023-09-11,9207
6672,騰輝電子-KY,20,0,20,凱基-永和,2023-09-11,9207
2867,三商壽,17,0,17,凱基-永和,2023-09-11,9207
2363,矽統,27,10,17,凱基-永和,2023-09-11,9207
2359,所羅門,15,0,15,凱基-永和,2023-09-11,9207
2382,廣達,50,36,14,凱基-永和,2023-09-11,9207
00751B,元大AAA至A公司債,14,0,14,凱基-永和,2023-09-11,9207
8069,元太,14,1,13,凱基-永和,2023-09-11,9207
2317,鴻海,12,0,12,凱基-永和,2023-09-11,9207
00932,兆豐永續高息等權,12,0,12,凱基-永和,2023-09-11,9207
2313,華通,16,5,11,凱基-永和,2023-09-11,9207
2436,偉詮電,11,0,11,凱基-永和,2023-09-11,9207
00929,復華台灣科技優息,32,21,11,凱基-永和,2023-09-11,9207
00706L,期元大S＆P日圓正2,10,0,10,凱基-永和,2023-09-11,9207
2204,中華,10,0,10,凱基-永和,2023-09-11,9207
2603,長榮,10,0,10,凱基-永和,2023-09-11,9207
2855,統一證,10,0,10,凱基-永和,2023-09-11,9207
3481,群創,12,2,10,凱基-永和,2023-09-11,9207
5388,中磊,10,0,10,凱基-永和,2023-09-11,9207
8034,榮群,11,1,10,凱基-永和,2023-09-11,9207
2614,東森,10,1,9,凱基-永和,2023-09-11,9207
6531,愛普*,10,2,8,凱基-永和,2023-09-11,9207
4919,新唐,9,1,8,凱基-永和,2023-09-11,9207
8033,雷虎,8,0,8,凱基-永和,2023-09-11,9207
00918,大華優利高填息30,7,0,7,凱基-永和,2023-09-11,9207
1513,中興電,7,0,7,凱基-永和,2023-09-11,9207
2745,五福,16,9,7,凱基-永和,2023-09-11,9207
6830,汎銓,7,0,7,凱基-永和,2023-09-11,9207
2458,義隆,6,0,6,凱基-永和,2023-09-11,9207
00891,中信關鍵半導體,6,0,6,凱基-永和,2023-09-11,9207
3163,波若威,7,1,6,凱基-永和,2023-09-11,9207
00923,群益台ESG低碳50,5,0,5,凱基-永和,2023-09-11,9207
00931B,統一美債20年,5,0,5,凱基-永和,2023-09-11,9207
00753L,中信中國50正2,5,0,5,凱基-永和,2023-09-11,9207
1319,東陽,7,2,5,凱基-永和,2023-09-11,9207
2409,友達,5,0,5,凱基-永和,2023-09-11,9207
2462,良得電,5,0,5,凱基-永和,2023-09-11,9207
2486,一詮,5,0,5,凱基-永和,2023-09-11,9207
2630,亞航,15,10,5,凱基-永和,2023-09-11,9207
2890,永豐金,5,0,5,凱基-永和,2023-09-11,9207
6116,彩晶,50,3,47,凱基-永和,2023-09-12,9207
00919,群益台灣精選高息,46,0,46,凱基-永和,2023-09-12,9207
00929,復華台灣科技優息,34,6,28,凱基-永和,2023-09-12,9207
4120,友華,25,0,25,凱基-永和,2023-09-12,9207
00753L,中信中國50正2,20,0,20,凱基-永和,2023-09-12,9207
2436,偉詮電,19,0,19,凱基-永和,2023-09-12,9207
2427,三商電,19,3,16,凱基-永和,2023-09-12,9207
6125,廣運,18,2,16,凱基-永和,2023-09-12,9207
00931B,統一美債20年,12,0,12,凱基-永和,2023-09-12,9207
2313,華通,17,7,10,凱基-永和,2023-09-12,9207
2388,威盛,10,0,10,凱基-永和,2023-09-12,9207
2401,凌陽,12,2,10,凱基-永和,2023-09-12,9207
6104,創惟,10,0,10,凱基-永和,2023-09-12,9207
6573,虹揚-KY,10,0,10,凱基-永和,2023-09-12,9207
8097,常珵,10,0,10,凱基-永和,2023-09-12,9207
2645,長榮航太,11,2,9,凱基-永和,2023-09-12,9207
1524,耿鼎,41,33,8,凱基-永和,2023-09-12,9207
2421,建準,9,1,8,凱基-永和,2023-09-12,9207
8069,元太,9,1,8,凱基-永和,2023-09-12,9207
00751B,元大AAA至A公司債,7,0,7,凱基-永和,2023-09-12,9207
2618,長榮航,7,0,7,凱基-永和,2023-09-12,9207
2881,富邦金,7,1,6,凱基-永和,2023-09-12,9207
00720B,元大投資級公司債,6,0,6,凱基-永和,2023-09-12,9207
3078,僑威,7,1,6,凱基-永和,2023-09-12,9207
6109,亞元,6,0,6,凱基-永和,2023-09-12,9207
6756,威鋒電子,6,0,6,凱基-永和,2023-09-12,9207
3035,智原,13,8,5,凱基-永和,2023-09-12,9207
2382,廣達,8,3,5,凱基-永和,2023-09-12,9207
00907,永豐優息存股,5,0,5,凱基-永和,2023-09-12,9207
00888,永豐台灣ESG,5,0,5,凱基-永和,2023-09-12,9207
2376,技嘉,10,5,5,凱基-永和,2023-09-12,9207
3149,正達,5,0,5,凱基-永和,2023-09-12,9207
3454,晶睿,5,0,5,凱基-永和,2023-09-12,9207
6120,達運,5,0,5,凱基-永和,2023-09-12,9207
2409,友達,5,0,5,凱基-永和,2023-09-12,9207
1471,首利,5,1,4,凱基-永和,2023-09-12,9207
6770,力積電,4,0,4,凱基-永和,2023-09-12,9207
0056,元大高股息,5,1,4,凱基-永和,2023-09-12,9207
2303,聯電,5,1,4,凱基-永和,2023-09-12,9207
8112,至上,4,0,4,凱基-永和,2023-09-12,9207
00923,群益台ESG低碳50,3,0,3,凱基-永和,2023-09-12,9207
00679B,元大美債20年,3,0,3,凱基-永和,2023-09-12,9207
00665L,富邦�琤肭磪囓�2,3,0,3,凱基-永和,2023-09-12,9207
00662,富邦NASDAQ,3,0,3,凱基-永和,2023-09-12,9207
4763,材料-KY,3,0,3,凱基-永和,2023-09-12,9207
6203,海韻電,3,0,3,凱基-永和,2023-09-12,9207
8446,華研,3,0,3,凱基-永和,2023-09-12,9207
2630,亞航,20,17,3,凱基-永和,2023-09-12,9207
1319,東陽,7,5,2,凱基-永和,2023-09-12,9207
1101,台泥,2,0,2,凱基-永和,2023-09-12,9207
3044,健鼎,305,5,300,凱基-永和,2023-09-13,9207
5258,虹堡,262,2,260,凱基-永和,2023-09-13,9207
00753L,中信中國50正2,90,0,90,凱基-永和,2023-09-13,9207
4908,前鼎,176,91,85,凱基-永和,2023-09-13,9207
2371,大同,60,0,60,凱基-永和,2023-09-13,9207
00929,復華台灣科技優息,52,0,52,凱基-永和,2023-09-13,9207
00919,群益台灣精選高息,49,1,48,凱基-永和,2023-09-13,9207
1101,台泥,25,3,22,凱基-永和,2023-09-13,9207
8155,博智,42,21,21,凱基-永和,2023-09-13,9207
2363,矽統,23,3,20,凱基-永和,2023-09-13,9207
00715L,期街口布蘭特正2,17,0,17,凱基-永和,2023-09-13,9207
2485,兆赫,20,3,17,凱基-永和,2023-09-13,9207
00915,凱基優選高股息30,16,1,15,凱基-永和,2023-09-13,9207
6109,亞元,12,0,12,凱基-永和,2023-09-13,9207
00893,國泰智能電動車,11,0,11,凱基-永和,2023-09-13,9207
2312,金寶,11,0,11,凱基-永和,2023-09-13,9207
2352,佳世達,11,0,11,凱基-永和,2023-09-13,9207
2457,飛宏,11,0,11,凱基-永和,2023-09-13,9207
3037,欣興,11,0,11,凱基-永和,2023-09-13,9207
3090,日電貿,12,1,11,凱基-永和,2023-09-13,9207
00772B,中信高評級公司債,10,0,10,凱基-永和,2023-09-13,9207
2330,台積電,10,0,10,凱基-永和,2023-09-13,9207
2486,一詮,10,0,10,凱基-永和,2023-09-13,9207
2497,怡利電,10,0,10,凱基-永和,2023-09-13,9207
2634,漢翔,10,0,10,凱基-永和,2023-09-13,9207
00679B,元大美債20年,9,0,9,凱基-永和,2023-09-13,9207
6788,華景電,8,0,8,凱基-永和,2023-09-13,9207
0056,元大高股息,7,0,7,凱基-永和,2023-09-13,9207
2301,光寶科,9,2,7,凱基-永和,2023-09-13,9207
2883,凱基金,8,2,6,凱基-永和,2023-09-13,9207
6173,信昌電,6,0,6,凱基-永和,2023-09-13,9207
00923,群益台ESG低碳50,6,0,6,凱基-永和,2023-09-13,9207
6182,合晶,5,0,5,凱基-永和,2023-09-13,9207
2887,台新金,5,0,5,凱基-永和,2023-09-13,9207
1339,昭輝,5,0,5,凱基-永和,2023-09-13,9207
2009,第一銅,5,0,5,凱基-永和,2023-09-13,9207
3530,晶相光,5,0,5,凱基-永和,2023-09-13,9207
3711,日月光投控,5,0,5,凱基-永和,2023-09-13,9207
8358,金居,6,1,5,凱基-永和,2023-09-13,9207
1513,中興電,4,0,4,凱基-永和,2023-09-13,9207
2504,國產,4,0,4,凱基-永和,2023-09-13,9207
2630,亞航,15,11,4,凱基-永和,2023-09-13,9207
8930,青鋼,4,0,4,凱基-永和,2023-09-13,9207
2313,華通,3,0,3,凱基-永和,2023-09-13,9207
6139,亞翔,3,0,3,凱基-永和,2023-09-13,9207
00673R,期元大S＆P原油反1,3,0,3,凱基-永和,2023-09-13,9207
2417,圓剛,4,1,3,凱基-永和,2023-09-13,9207
2881,富邦金,3,0,3,凱基-永和,2023-09-13,9207
3011,今皓,3,0,3,凱基-永和,2023-09-13,9207
3587,閎康,3,0,3,凱基-永和,2023-09-13,9207
6531,愛普*,135,10,125,凱基-永和,2023-09-14,9207
3013,晟銘電,293,202,91,凱基-永和,2023-09-14,9207
4979,華星光,62,5,57,凱基-永和,2023-09-14,9207
5474,聰泰,41,2,39,凱基-永和,2023-09-14,9207
3363,上詮,86,49,37,凱基-永和,2023-09-14,9207
00929,復華台灣科技優息,59,24,35,凱基-永和,2023-09-14,9207
3481,群創,30,0,30,凱基-永和,2023-09-14,9207
00878,國泰永續高股息,27,5,22,凱基-永和,2023-09-14,9207
00632R,元大台灣50反1,20,0,20,凱基-永和,2023-09-14,9207
2376,技嘉,24,5,19,凱基-永和,2023-09-14,9207
00919,群益台灣精選高息,21,5,16,凱基-永和,2023-09-14,9207
2605,新興,22,6,16,凱基-永和,2023-09-14,9207
2316,楠梓電,15,0,15,凱基-永和,2023-09-14,9207
2401,凌陽,11,0,11,凱基-永和,2023-09-14,9207
2421,建準,12,1,11,凱基-永和,2023-09-14,9207
2641,正德,10,0,10,凱基-永和,2023-09-14,9207
3006,晶豪科,12,2,10,凱基-永和,2023-09-14,9207
2323,中環,10,1,9,凱基-永和,2023-09-14,9207
2402,毅嘉,11,2,9,凱基-永和,2023-09-14,9207
2329,華泰,12,4,8,凱基-永和,2023-09-14,9207
2356,英業達,33,25,8,凱基-永和,2023-09-14,9207
2515,中工,8,0,8,凱基-永和,2023-09-14,9207
3715,定穎投控,15,7,8,凱基-永和,2023-09-14,9207
1519,華城,7,0,7,凱基-永和,2023-09-14,9207
00885,富邦越南,7,0,7,凱基-永和,2023-09-14,9207
00635U,期元大S＆P黃金,7,0,7,凱基-永和,2023-09-14,9207
2485,兆赫,10,3,7,凱基-永和,2023-09-14,9207
3587,閎康,7,0,7,凱基-永和,2023-09-14,9207
00679B,元大美債20年,6,0,6,凱基-永和,2023-09-14,9207
2101,南港,6,0,6,凱基-永和,2023-09-14,9207
2634,漢翔,6,0,6,凱基-永和,2023-09-14,9207
2838,聯邦銀,6,0,6,凱基-永和,2023-09-14,9207
4933,友輝,6,0,6,凱基-永和,2023-09-14,9207
1218,泰山,5,0,5,凱基-永和,2023-09-14,9207
6158,禾昌,5,0,5,凱基-永和,2023-09-14,9207
8028,昇陽半導體,5,0,5,凱基-永和,2023-09-14,9207
1515,力山,4,0,4,凱基-永和,2023-09-14,9207
1568,倉佑,51,47,4,凱基-永和,2023-09-14,9207
2504,國產,4,0,4,凱基-永和,2023-09-14,9207
2645,長榮航太,5,1,4,凱基-永和,2023-09-14,9207
3257,虹冠電,4,0,4,凱基-永和,2023-09-14,9207
6125,廣運,6,2,4,凱基-永和,2023-09-14,9207
3702,大聯大,11,8,3,凱基-永和,2023-09-14,9207
9927,泰銘,4,1,3,凱基-永和,2023-09-14,9207
1314,中石化,5,2,3,凱基-永和,2023-09-14,9207
00850,元大臺灣ESG永續,3,0,3,凱基-永和,2023-09-14,9207
00665L,富邦�琤肭磪囓�2,3,0,3,凱基-永和,2023-09-14,9207
2206,三陽工業,3,0,3,凱基-永和,2023-09-14,9207
2425,承啟,3,0,3,凱基-永和,2023-09-14,9207
2889,國票金,3,0,3,凱基-永和,2023-09-14,9207
2838,聯邦銀,800,20,780,凱基-永和,2023-09-15,9207
6531,愛普*,172,3,169,凱基-永和,2023-09-15,9207
2363,矽統,164,25,139,凱基-永和,2023-09-15,9207
2354,鴻準,53,3,50,凱基-永和,2023-09-15,9207
00929,復華台灣科技優息,54,9,45,凱基-永和,2023-09-15,9207
2890,永豐金,36,0,36,凱基-永和,2023-09-15,9207
2337,旺宏,31,3,28,凱基-永和,2023-09-15,9207
00679B,元大美債20年,25,0,25,凱基-永和,2023-09-15,9207
2486,一詮,26,2,24,凱基-永和,2023-09-15,9207
2888,新光金,24,0,24,凱基-永和,2023-09-15,9207
00920,富邦ESG綠色電力,20,0,20,凱基-永和,2023-09-15,9207
2637,慧洋-KY,40,23,17,凱基-永和,2023-09-15,9207
3231,緯創,23,7,16,凱基-永和,2023-09-15,9207
00919,群益台灣精選高息,30,14,16,凱基-永和,2023-09-15,9207
3035,智原,20,5,15,凱基-永和,2023-09-15,9207
3380,明泰,15,0,15,凱基-永和,2023-09-15,9207
6109,亞元,15,0,15,凱基-永和,2023-09-15,9207
6120,達運,15,0,15,凱基-永和,2023-09-15,9207
2891,中信金,12,0,12,凱基-永和,2023-09-15,9207
2610,華航,12,0,12,凱基-永和,2023-09-15,9207
2409,友達,12,0,12,凱基-永和,2023-09-15,9207
3706,神達,12,0,12,凱基-永和,2023-09-15,9207
3094,聯傑,11,0,11,凱基-永和,2023-09-15,9207
6231,系微,11,0,11,凱基-永和,2023-09-15,9207
8054,安國,19,8,11,凱基-永和,2023-09-15,9207
2313,華通,46,35,11,凱基-永和,2023-09-15,9207
2884,玉山金,11,0,11,凱基-永和,2023-09-15,9207
00893,國泰智能電動車,12,2,10,凱基-永和,2023-09-15,9207
00632R,元大台灣50反1,10,0,10,凱基-永和,2023-09-15,9207
1584,精剛,10,0,10,凱基-永和,2023-09-15,9207
1785,光洋科,10,0,10,凱基-永和,2023-09-15,9207
2401,凌陽,22,12,10,凱基-永和,2023-09-15,9207
2630,亞航,11,1,10,凱基-永和,2023-09-15,9207
3615,安可,10,0,10,凱基-永和,2023-09-15,9207
8034,榮群,13,6,7,凱基-永和,2023-09-15,9207
3481,群創,21,14,7,凱基-永和,2023-09-15,9207
00857B,永豐20年美公債,6,0,6,凱基-永和,2023-09-15,9207
1503,士電,8,2,6,凱基-永和,2023-09-15,9207
3264,欣銓,7,1,6,凱基-永和,2023-09-15,9207
6830,汎銓,6,0,6,凱基-永和,2023-09-15,9207
1402,遠東新,5,0,5,凱基-永和,2023-09-15,9207
2316,楠梓電,20,15,5,凱基-永和,2023-09-15,9207
3003,健和興,6,1,5,凱基-永和,2023-09-15,9207
3042,晶技,5,0,5,凱基-永和,2023-09-15,9207
5324,士開,5,0,5,凱基-永和,2023-09-15,9207
6741,91APP*-KY,5,0,5,凱基-永和,2023-09-15,9207
8277,商丞,5,0,5,凱基-永和,2023-09-15,9207
2002,中鋼,4,0,4,凱基-永和,2023-09-15,9207
00918,大華優利高填息30,10,6,4,凱基-永和,2023-09-15,9207
1471,首利,4,0,4,凱基-永和,2023-09-15,9207
3481,群創,205,9,196,凱基-永和,2023-09-18,9207
00929,復華台灣科技優息,150,4,146,凱基-永和,2023-09-18,9207
6531,愛普*,137,10,127,凱基-永和,2023-09-18,9207
00919,群益台灣精選高息,102,10,92,凱基-永和,2023-09-18,9207
2002,中鋼,51,0,51,凱基-永和,2023-09-18,9207
2316,楠梓電,33,0,33,凱基-永和,2023-09-18,9207
00679B,元大美債20年,32,2,30,凱基-永和,2023-09-18,9207
2605,新興,29,3,26,凱基-永和,2023-09-18,9207
3231,緯創,20,0,20,凱基-永和,2023-09-18,9207
2204,中華,19,0,19,凱基-永和,2023-09-18,9207
3037,欣興,18,0,18,凱基-永和,2023-09-18,9207
4739,康普,18,0,18,凱基-永和,2023-09-18,9207
00930,永豐ESG低碳高息,16,0,16,凱基-永和,2023-09-18,9207
00633L,富邦上証正2,16,0,16,凱基-永和,2023-09-18,9207
00687B,國泰20年美債,16,0,16,凱基-永和,2023-09-18,9207
00915,凱基優選高股息30,15,0,15,凱基-永和,2023-09-18,9207
00772B,中信高評級公司債,14,0,14,凱基-永和,2023-09-18,9207
3008,大立光,14,0,14,凱基-永和,2023-09-18,9207
2634,漢翔,12,0,12,凱基-永和,2023-09-18,9207
00931B,統一美債20年,11,0,11,凱基-永和,2023-09-18,9207
00881,國泰台灣5G+,11,0,11,凱基-永和,2023-09-18,9207
3058,立德,11,0,11,凱基-永和,2023-09-18,9207
3702,大聯大,16,6,10,凱基-永和,2023-09-18,9207
2538,基泰,10,0,10,凱基-永和,2023-09-18,9207
2855,統一證,10,0,10,凱基-永和,2023-09-18,9207
2382,廣達,32,23,9,凱基-永和,2023-09-18,9207
2301,光寶科,13,4,9,凱基-永和,2023-09-18,9207
2355,敬鵬,10,1,9,凱基-永和,2023-09-18,9207
2027,大成鋼,8,0,8,凱基-永和,2023-09-18,9207
00878,國泰永續高股息,8,1,7,凱基-永和,2023-09-18,9207
00751B,元大AAA至A公司債,7,0,7,凱基-永和,2023-09-18,9207
1605,華新,6,0,6,凱基-永和,2023-09-18,9207
2344,華邦電,6,0,6,凱基-永和,2023-09-18,9207
00918,大華優利高填息30,5,0,5,凱基-永和,2023-09-18,9207
1101,台泥,5,0,5,凱基-永和,2023-09-18,9207
2449,京元電子,8,3,5,凱基-永和,2023-09-18,9207
4909,新復興,5,0,5,凱基-永和,2023-09-18,9207
8088,品安,5,0,5,凱基-永和,2023-09-18,9207
8930,青鋼,5,0,5,凱基-永和,2023-09-18,9207
2368,金像電,4,0,4,凱基-永和,2023-09-18,9207
2330,台積電,4,0,4,凱基-永和,2023-09-18,9207
1308,亞聚,4,0,4,凱基-永和,2023-09-18,9207
00795B,中信美國公債20年,4,0,4,凱基-永和,2023-09-18,9207
00900,富邦特選高股息30,4,0,4,凱基-永和,2023-09-18,9207
1907,永豐餘,4,0,4,凱基-永和,2023-09-18,9207
2317,鴻海,6,2,4,凱基-永和,2023-09-18,9207
2324,仁寶,4,0,4,凱基-永和,2023-09-18,9207
2883B,凱基金乙特,4,0,4,凱基-永和,2023-09-18,9207
5607,遠雄港,4,0,4,凱基-永和,2023-09-18,9207
2303,聯電,6,3,3,凱基-永和,2023-09-18,9207
2367,燿華,113,14,99,凱基-永和,2023-09-19,9207
00929,復華台灣科技優息,90,0,90,凱基-永和,2023-09-19,9207
00919,群益台灣精選高息,55,0,55,凱基-永和,2023-09-19,9207
00930,永豐ESG低碳高息,22,0,22,凱基-永和,2023-09-19,9207
2369,菱生,20,0,20,凱基-永和,2023-09-19,9207
4944,兆遠,20,0,20,凱基-永和,2023-09-19,9207
00878,國泰永續高股息,19,3,16,凱基-永和,2023-09-19,9207
2618,長榮航,16,0,16,凱基-永和,2023-09-19,9207
6531,愛普*,15,2,13,凱基-永和,2023-09-19,9207
2605,新興,11,0,11,凱基-永和,2023-09-19,9207
2886,兆豐金,11,0,11,凱基-永和,2023-09-19,9207
1714,和桐,10,0,10,凱基-永和,2023-09-19,9207
2331,精英,10,0,10,凱基-永和,2023-09-19,9207
2412,中華電,10,0,10,凱基-永和,2023-09-19,9207
6274,台燿,10,0,10,凱基-永和,2023-09-19,9207
8054,安國,20,10,10,凱基-永和,2023-09-19,9207
2892,第一金,12,3,9,凱基-永和,2023-09-19,9207
1808,潤隆,8,0,8,凱基-永和,2023-09-19,9207
3689,湧德,8,0,8,凱基-永和,2023-09-19,9207
2645,長榮航太,8,0,8,凱基-永和,2023-09-19,9207
2330,台積電,8,0,8,凱基-永和,2023-09-19,9207
2706,第一店,7,0,7,凱基-永和,2023-09-19,9207
3030,德律,9,2,7,凱基-永和,2023-09-19,9207
1503,士電,9,3,6,凱基-永和,2023-09-19,9207
2425,承啟,12,6,6,凱基-永和,2023-09-19,9207
5225,東科-KY,6,0,6,凱基-永和,2023-09-19,9207
1101,台泥,6,0,6,凱基-永和,2023-09-19,9207
1815,富喬,17,12,5,凱基-永和,2023-09-19,9207
00857B,永豐20年美公債,5,0,5,凱基-永和,2023-09-19,9207
00757,統一FANG+,10,5,5,凱基-永和,2023-09-19,9207
2634,漢翔,8,3,5,凱基-永和,2023-09-19,9207
3706,神達,5,0,5,凱基-永和,2023-09-19,9207
4550,長佳,5,0,5,凱基-永和,2023-09-19,9207
6109,亞元,5,0,5,凱基-永和,2023-09-19,9207
6213,聯茂,5,0,5,凱基-永和,2023-09-19,9207
8277,商丞,5,0,5,凱基-永和,2023-09-19,9207
3231,緯創,20,16,4,凱基-永和,2023-09-19,9207
1442,名軒,4,0,4,凱基-永和,2023-09-19,9207
1522,堤維西,6,2,4,凱基-永和,2023-09-19,9207
1319,東陽,8,4,4,凱基-永和,2023-09-19,9207
3022,威強電,4,0,4,凱基-永和,2023-09-19,9207
5210,寶碩,4,0,4,凱基-永和,2023-09-19,9207
6901,鑽石投資,16,12,4,凱基-永和,2023-09-19,9207
00673R,期元大S＆P原油反1,3,0,3,凱基-永和,2023-09-19,9207
00665L,富邦�琤肭磪囓�2,3,0,3,凱基-永和,2023-09-19,9207
2340,台亞,3,0,3,凱基-永和,2023-09-19,9207
2464,盟立,3,0,3,凱基-永和,2023-09-19,9207
2606,裕民,5,2,3,凱基-永和,2023-09-19,9207
2641,正德,3,0,3,凱基-永和,2023-09-19,9207
2883,凱基金,3,0,3,凱基-永和,2023-09-19,9207
00929,復華台灣科技優息,139,10,129,凱基-永和,2023-09-20,9207
1444,力麗,100,5,95,凱基-永和,2023-09-20,9207
8905,裕國,72,0,72,凱基-永和,2023-09-20,9207
00930,永豐ESG低碳高息,39,0,39,凱基-永和,2023-09-20,9207
00919,群益台灣精選高息,39,3,36,凱基-永和,2023-09-20,9207
2457,飛宏,35,0,35,凱基-永和,2023-09-20,9207
6282,康舒,33,0,33,凱基-永和,2023-09-20,9207
6109,亞元,30,0,30,凱基-永和,2023-09-20,9207
2354,鴻準,26,3,23,凱基-永和,2023-09-20,9207
2883,凱基金,17,0,17,凱基-永和,2023-09-20,9207
2344,華邦電,27,11,16,凱基-永和,2023-09-20,9207
6274,台燿,15,0,15,凱基-永和,2023-09-20,9207
3362,先進光,14,0,14,凱基-永和,2023-09-20,9207
3481,群創,14,1,13,凱基-永和,2023-09-20,9207
1319,東陽,34,21,13,凱基-永和,2023-09-20,9207
3707,漢磊,13,0,13,凱基-永和,2023-09-20,9207
2882,國泰金,14,2,12,凱基-永和,2023-09-20,9207
00878,國泰永續高股息,12,0,12,凱基-永和,2023-09-20,9207
00751B,元大AAA至A公司債,12,0,12,凱基-永和,2023-09-20,9207
6285,啟��,12,0,12,凱基-永和,2023-09-20,9207
3715,定穎投控,341,330,11,凱基-永和,2023-09-20,9207
3265,台星科,17,7,10,凱基-永和,2023-09-20,9207
00696B,富邦美債20年,10,0,10,凱基-永和,2023-09-20,9207
1731,美吾華,10,0,10,凱基-永和,2023-09-20,9207
3163,波若威,11,1,10,凱基-永和,2023-09-20,9207
2330,台積電,10,0,10,凱基-永和,2023-09-20,9207
2618,長榮航,12,3,9,凱基-永和,2023-09-20,9207
2449,京元電子,8,0,8,凱基-永和,2023-09-20,9207
00915,凱基優選高股息30,8,0,8,凱基-永和,2023-09-20,9207
00921,兆豐龍頭等權重,8,0,8,凱基-永和,2023-09-20,9207
3546,宇峻,8,0,8,凱基-永和,2023-09-20,9207
01009T,王道圓滿R1,6,0,6,凱基-永和,2023-09-20,9207
2317,鴻海,5,0,5,凱基-永和,2023-09-20,9207
3711,日月光投控,5,0,5,凱基-永和,2023-09-20,9207
4909,新復興,5,0,5,凱基-永和,2023-09-20,9207
6443,元晶,5,0,5,凱基-永和,2023-09-20,9207
8046,南電,5,0,5,凱基-永和,2023-09-20,9207
4944,兆遠,5,0,5,凱基-永和,2023-09-20,9207
2388,威盛,7,2,5,凱基-永和,2023-09-20,9207
3016,嘉晶,5,0,5,凱基-永和,2023-09-20,9207
0050,元大台灣50,4,0,4,凱基-永和,2023-09-20,9207
2002,中鋼,4,0,4,凱基-永和,2023-09-20,9207
00881,國泰台灣5G+,4,0,4,凱基-永和,2023-09-20,9207
00773B,中信優先金融債,4,0,4,凱基-永和,2023-09-20,9207
2313,華通,19,15,4,凱基-永和,2023-09-20,9207
2352,佳世達,4,0,4,凱基-永和,2023-09-20,9207
6168,宏齊,4,0,4,凱基-永和,2023-09-20,9207
00713,元大台灣高息低波,3,0,3,凱基-永和,2023-09-20,9207
3231,緯創,55,52,3,凱基-永和,2023-09-20,9207
2603,長榮,7,4,3,凱基-永和,2023-09-20,9207
1722,台肥,315,0,315,凱基-永和,2023-09-21,9207
00919,群益台灣精選高息,57,0,57,凱基-永和,2023-09-21,9207
00929,復華台灣科技優息,80,28,52,凱基-永和,2023-09-21,9207
6109,亞元,50,0,50,凱基-永和,2023-09-21,9207
2883,凱基金,48,5,43,凱基-永和,2023-09-21,9207
00878,國泰永續高股息,43,6,37,凱基-永和,2023-09-21,9207
00930,永豐ESG低碳高息,30,0,30,凱基-永和,2023-09-21,9207
2002,中鋼,26,0,26,凱基-永和,2023-09-21,9207
0050,元大台灣50,22,0,22,凱基-永和,2023-09-21,9207
2618,長榮航,30,11,19,凱基-永和,2023-09-21,9207
2603,長榮,48,30,18,凱基-永和,2023-09-21,9207
5203,訊連,16,0,16,凱基-永和,2023-09-21,9207
8034,榮群,16,0,16,凱基-永和,2023-09-21,9207
1584,精剛,38,22,16,凱基-永和,2023-09-21,9207
2891,中信金,15,1,14,凱基-永和,2023-09-21,9207
6285,啟��,21,9,12,凱基-永和,2023-09-21,9207
2610,華航,22,10,12,凱基-永和,2023-09-21,9207
3707,漢磊,11,0,11,凱基-永和,2023-09-21,9207
2383,台光電,10,0,10,凱基-永和,2023-09-21,9207
2906,高林,10,0,10,凱基-永和,2023-09-21,9207
1513,中興電,19,10,9,凱基-永和,2023-09-21,9207
5880,合庫金,8,0,8,凱基-永和,2023-09-21,9207
2645,長榮航太,8,0,8,凱基-永和,2023-09-21,9207
3032,偉訓,8,0,8,凱基-永和,2023-09-21,9207
8227,巨有科技,11,3,8,凱基-永和,2023-09-21,9207
1504,東元,8,0,8,凱基-永和,2023-09-21,9207
00923,群益台ESG低碳50,8,0,8,凱基-永和,2023-09-21,9207
3231,緯創,19,12,7,凱基-永和,2023-09-21,9207
2330,台積電,9,2,7,凱基-永和,2023-09-21,9207
2303,聯電,10,3,7,凱基-永和,2023-09-21,9207
6770,力積電,7,0,7,凱基-永和,2023-09-21,9207
00932,兆豐永續高息等權,7,0,7,凱基-永和,2023-09-21,9207
00665L,富邦�琤肭磪囓�2,7,0,7,凱基-永和,2023-09-21,9207
1809,中釉,8,1,7,凱基-永和,2023-09-21,9207
2317,鴻海,6,0,6,凱基-永和,2023-09-21,9207
2882,國泰金,6,0,6,凱基-永和,2023-09-21,9207
2363,矽統,8,2,6,凱基-永和,2023-09-21,9207
4550,長佳,6,0,6,凱基-永和,2023-09-21,9207
4909,新復興,6,0,6,凱基-永和,2023-09-21,9207
00915,凱基優選高股息30,10,4,6,凱基-永和,2023-09-21,9207
2376,技嘉,12,6,6,凱基-永和,2023-09-21,9207
006208,富邦台50,5,0,5,凱基-永和,2023-09-21,9207
1731,美吾華,5,0,5,凱基-永和,2023-09-21,9207
2313,華通,16,11,5,凱基-永和,2023-09-21,9207
00882,中信中國高股息,5,0,5,凱基-永和,2023-09-21,9207
1560,中砂,5,0,5,凱基-永和,2023-09-21,9207
3617,碩天,6,1,5,凱基-永和,2023-09-21,9207
3711,日月光投控,5,0,5,凱基-永和,2023-09-21,9207
4906,正文,5,0,5,凱基-永和,2023-09-21,9207
5381,合正,10,5,5,凱基-永和,2023-09-21,9207
6187,萬潤,510,1,509,凱基-永和,2023-09-22,9207
2363,矽統,163,6,157,凱基-永和,2023-09-22,9207
00679B,元大美債20年,38,0,38,凱基-永和,2023-09-22,9207
6109,亞元,36,0,36,凱基-永和,2023-09-22,9207
3715,定穎投控,42,10,32,凱基-永和,2023-09-22,9207
00919,群益台灣精選高息,24,2,22,凱基-永和,2023-09-22,9207
6531,愛普*,28,6,22,凱基-永和,2023-09-22,9207
2374,佳能,20,0,20,凱基-永和,2023-09-22,9207
3583,辛耘,16,0,16,凱基-永和,2023-09-22,9207
2460,建通,13,0,13,凱基-永和,2023-09-22,9207
00772B,中信高評級公司債,11,0,11,凱基-永和,2023-09-22,9207
2101,南港,10,0,10,凱基-永和,2023-09-22,9207
2883,凱基金,10,0,10,凱基-永和,2023-09-22,9207
3062,建漢,10,0,10,凱基-永和,2023-09-22,9207
6585,鼎基,10,0,10,凱基-永和,2023-09-22,9207
00720B,元大投資級公司債,9,0,9,凱基-永和,2023-09-22,9207
00633L,富邦上証正2,9,0,9,凱基-永和,2023-09-22,9207
1442,名軒,9,0,9,凱基-永和,2023-09-22,9207
2459,敦吉,9,0,9,凱基-永和,2023-09-22,9207
8027,鈦昇,8,0,8,凱基-永和,2023-09-22,9207
00795B,中信美國公債20年,7,0,7,凱基-永和,2023-09-22,9207
2201,裕隆,10,3,7,凱基-永和,2023-09-22,9207
2801,彰銀,7,0,7,凱基-永和,2023-09-22,9207
2618,長榮航,10,4,6,凱基-永和,2023-09-22,9207
3037,欣興,6,0,6,凱基-永和,2023-09-22,9207
00751B,元大AAA至A公司債,6,0,6,凱基-永和,2023-09-22,9207
2891,中信金,6,0,6,凱基-永和,2023-09-22,9207
2538,基泰,6,0,6,凱基-永和,2023-09-22,9207
2330,台積電,6,0,6,凱基-永和,2023-09-22,9207
00773B,中信優先金融債,5,0,5,凱基-永和,2023-09-22,9207
00753L,中信中國50正2,5,0,5,凱基-永和,2023-09-22,9207
2323,中環,5,0,5,凱基-永和,2023-09-22,9207
2883B,凱基金乙特,5,0,5,凱基-永和,2023-09-22,9207
4944,兆遠,5,0,5,凱基-永和,2023-09-22,9207
4960,誠美材,5,0,5,凱基-永和,2023-09-22,9207
6757,台灣虎航,5,0,5,凱基-永和,2023-09-22,9207
6533,晶心科,4,0,4,凱基-永和,2023-09-22,9207
00712,復華富時不動產,4,0,4,凱基-永和,2023-09-22,9207
2881,富邦金,4,0,4,凱基-永和,2023-09-22,9207
2603,長榮,6,2,4,凱基-永和,2023-09-22,9207
00680L,元大美債20正2,4,0,4,凱基-永和,2023-09-22,9207
3264,欣銓,4,0,4,凱基-永和,2023-09-22,9207
00931B,統一美債20年,4,0,4,凱基-永和,2023-09-22,9207
1101,台泥,3,0,3,凱基-永和,2023-09-22,9207
0050,元大台灣50,3,0,3,凱基-永和,2023-09-22,9207
00687B,國泰20年美債,3,0,3,凱基-永和,2023-09-22,9207
2905,三商,3,0,3,凱基-永和,2023-09-22,9207
6446,藥華藥,3,0,3,凱基-永和,2023-09-22,9207
00757,統一FANG+,19,16,3,凱基-永和,2023-09-22,9207
00900,富邦特選高股息30,3,0,3,凱基-永和,2023-09-22,9207
6531,愛普*,128,2,126,凱基-永和,2023-09-25,9207
2457,飛宏,25,1,24,凱基-永和,2023-09-25,9207
4979,華星光,24,4,20,凱基-永和,2023-09-25,9207
2618,長榮航,17,0,17,凱基-永和,2023-09-25,9207
8034,榮群,31,15,16,凱基-永和,2023-09-25,9207
00679B,元大美債20年,15,0,15,凱基-永和,2023-09-25,9207
2376,技嘉,19,6,13,凱基-永和,2023-09-25,9207
2634,漢翔,13,1,12,凱基-永和,2023-09-25,9207
00878,國泰永續高股息,14,3,11,凱基-永和,2023-09-25,9207
00931B,統一美債20年,10,0,10,凱基-永和,2023-09-25,9207
2316,楠梓電,10,0,10,凱基-永和,2023-09-25,9207
3444,利機,8,0,8,凱基-永和,2023-09-25,9207
2313,華通,8,0,8,凱基-永和,2023-09-25,9207
1504,東元,8,0,8,凱基-永和,2023-09-25,9207
3615,安可,47,40,7,凱基-永和,2023-09-25,9207
5227,立凱-KY,7,0,7,凱基-永和,2023-09-25,9207
00712,復華富時不動產,6,0,6,凱基-永和,2023-09-25,9207
00893,國泰智能電動車,6,0,6,凱基-永和,2023-09-25,9207
2027,大成鋼,6,1,5,凱基-永和,2023-09-25,9207
00670L,富邦NASDAQ正2,5,0,5,凱基-永和,2023-09-25,9207
5452,佶優,5,0,5,凱基-永和,2023-09-25,9207
1101,台泥,6,2,4,凱基-永和,2023-09-25,9207
00795B,中信美國公債20年,4,0,4,凱基-永和,2023-09-25,9207
2324,仁寶,4,0,4,凱基-永和,2023-09-25,9207
3265,台星科,4,0,4,凱基-永和,2023-09-25,9207
8097,常珵,7,3,4,凱基-永和,2023-09-25,9207
2882,國泰金,3,0,3,凱基-永和,2023-09-25,9207
00902,中信電池及儲能,3,0,3,凱基-永和,2023-09-25,9207
00924,復華S＆P500成長,3,0,3,凱基-永和,2023-09-25,9207
2317,鴻海,3,0,3,凱基-永和,2023-09-25,9207
00662,富邦NASDAQ,3,0,3,凱基-永和,2023-09-25,9207
00650L,復華香港正2,3,0,3,凱基-永和,2023-09-25,9207
00640L,富邦日本正2,3,0,3,凱基-永和,2023-09-25,9207
1519,華城,3,0,3,凱基-永和,2023-09-25,9207
1503,士電,3,0,3,凱基-永和,2023-09-25,9207
1727,中華化,3,0,3,凱基-永和,2023-09-25,9207
2002,中鋼,3,0,3,凱基-永和,2023-09-25,9207
2208,台船,3,0,3,凱基-永和,2023-09-25,9207
2888,新光金,3,0,3,凱基-永和,2023-09-25,9207
3035,智原,3,0,3,凱基-永和,2023-09-25,9207
6485,點序,3,0,3,凱基-永和,2023-09-25,9207
9951,皇田,2,0,2,凱基-永和,2023-09-25,9207
1319,東陽,9,7,2,凱基-永和,2023-09-25,9207
1316,上曜,2,0,2,凱基-永和,2023-09-25,9207
00751B,元大AAA至A公司債,2,0,2,凱基-永和,2023-09-25,9207
1718,中纖,2,0,2,凱基-永和,2023-09-25,9207
2201,裕隆,2,0,2,凱基-永和,2023-09-25,9207
2305,全友,2,0,2,凱基-永和,2023-09-25,9207
2327,國巨,2,0,2,凱基-永和,2023-09-25,9207
2329,華泰,2,0,2,凱基-永和,2023-09-25,9207
00929,復華台灣科技優息,129,0,129,凱基-永和,2023-09-26,9207
9945,潤泰新,52,4,48,凱基-永和,2023-09-26,9207
6116,彩晶,40,0,40,凱基-永和,2023-09-26,9207
00919,群益台灣精選高息,29,1,28,凱基-永和,2023-09-26,9207
00679B,元大美債20年,22,0,22,凱基-永和,2023-09-26,9207
00931B,統一美債20年,21,0,21,凱基-永和,2023-09-26,9207
2401,凌陽,23,3,20,凱基-永和,2023-09-26,9207
2303,聯電,15,0,15,凱基-永和,2023-09-26,9207
3615,安可,12,0,12,凱基-永和,2023-09-26,9207
3379,彬台,10,0,10,凱基-永和,2023-09-26,9207
3548,兆利,12,2,10,凱基-永和,2023-09-26,9207
5009,榮剛,10,0,10,凱基-永和,2023-09-26,9207
3011,今皓,9,0,9,凱基-永和,2023-09-26,9207
6109,亞元,9,0,9,凱基-永和,2023-09-26,9207
0050,元大台灣50,8,0,8,凱基-永和,2023-09-26,9207
4533,協易機,15,7,8,凱基-永和,2023-09-26,9207
2330,台積電,8,0,8,凱基-永和,2023-09-26,9207
0056,元大高股息,7,0,7,凱基-永和,2023-09-26,9207
00795B,中信美國公債20年,7,0,7,凱基-永和,2023-09-26,9207
1808,潤隆,7,0,7,凱基-永和,2023-09-26,9207
5347,世界,9,2,7,凱基-永和,2023-09-26,9207
00720B,元大投資級公司債,6,0,6,凱基-永和,2023-09-26,9207
00923,群益台ESG低碳50,6,0,6,凱基-永和,2023-09-26,9207
3035,智原,7,1,6,凱基-永和,2023-09-26,9207
00885,富邦越南,10,4,6,凱基-永和,2023-09-26,9207
00712,復華富時不動產,6,0,6,凱基-永和,2023-09-26,9207
00687B,國泰20年美債,6,0,6,凱基-永和,2023-09-26,9207
2634,漢翔,7,1,6,凱基-永和,2023-09-26,9207
4566,時碩工業,6,0,6,凱基-永和,2023-09-26,9207
6443,元晶,6,0,6,凱基-永和,2023-09-26,9207
8034,榮群,6,0,6,凱基-永和,2023-09-26,9207
8048,德勝,6,0,6,凱基-永和,2023-09-26,9207
2882,國泰金,5,0,5,凱基-永和,2023-09-26,9207
2880,華南金,5,0,5,凱基-永和,2023-09-26,9207
2317,鴻海,5,0,5,凱基-永和,2023-09-26,9207
00753L,中信中國50正2,5,0,5,凱基-永和,2023-09-26,9207
00751B,元大AAA至A公司債,5,0,5,凱基-永和,2023-09-26,9207
00730,富邦臺灣優質高息,5,0,5,凱基-永和,2023-09-26,9207
1802,台玻,5,0,5,凱基-永和,2023-09-26,9207
2314,台揚,5,0,5,凱基-永和,2023-09-26,9207
2889,國票金,5,0,5,凱基-永和,2023-09-26,9207
3388,崇越電,5,0,5,凱基-永和,2023-09-26,9207
4933,友輝,6,1,5,凱基-永和,2023-09-26,9207
4944,兆遠,5,0,5,凱基-永和,2023-09-26,9207
6257,矽格,5,0,5,凱基-永和,2023-09-26,9207
00725B,國泰投資級公司債,4,0,4,凱基-永和,2023-09-26,9207
3231,緯創,5,1,4,凱基-永和,2023-09-26,9207
2891,中信金,4,0,4,凱基-永和,2023-09-26,9207
00900,富邦特選高股息30,4,0,4,凱基-永和,2023-09-26,9207
2313,華通,5,1,4,凱基-永和,2023-09-26,9207
2363,矽統,154,4,150,凱基-永和,2023-09-27,9207
2337,旺宏,65,0,65,凱基-永和,2023-09-27,9207
00929,復華台灣科技優息,69,13,56,凱基-永和,2023-09-27,9207
3325,旭品,51,0,51,凱基-永和,2023-09-27,9207
00919,群益台灣精選高息,29,1,28,凱基-永和,2023-09-27,9207
1101,台泥,22,0,22,凱基-永和,2023-09-27,9207
8420,明揚,154,132,22,凱基-永和,2023-09-27,9207
6182,合晶,21,0,21,凱基-永和,2023-09-27,9207
2867,三商壽,19,0,19,凱基-永和,2023-09-27,9207
2401,凌陽,20,2,18,凱基-永和,2023-09-27,9207
6757,台灣虎航,16,0,16,凱基-永和,2023-09-27,9207
3037,欣興,15,0,15,凱基-永和,2023-09-27,9207
3504,揚明光,13,0,13,凱基-永和,2023-09-27,9207
5465,富驊,12,0,12,凱基-永和,2023-09-27,9207
2303,聯電,14,4,10,凱基-永和,2023-09-27,9207
00772B,中信高評級公司債,10,0,10,凱基-永和,2023-09-27,9207
2006,東和鋼鐵,10,0,10,凱基-永和,2023-09-27,9207
6585,鼎基,10,0,10,凱基-永和,2023-09-27,9207
8936,國統,14,5,9,凱基-永和,2023-09-27,9207
2801,彰銀,8,0,8,凱基-永和,2023-09-27,9207
2460,建通,7,0,7,凱基-永和,2023-09-27,9207
6109,亞元,7,0,7,凱基-永和,2023-09-27,9207
6288,聯嘉,7,0,7,凱基-永和,2023-09-27,9207
8930,青鋼,9,2,7,凱基-永和,2023-09-27,9207
2313,華通,7,0,7,凱基-永和,2023-09-27,9207
00679B,元大美債20年,6,0,6,凱基-永和,2023-09-27,9207
00712,復華富時不動產,6,0,6,凱基-永和,2023-09-27,9207
1608,華榮,6,0,6,凱基-永和,2023-09-27,9207
3013,晟銘電,7,1,6,凱基-永和,2023-09-27,9207
8048,德勝,6,0,6,凱基-永和,2023-09-27,9207
1442,名軒,5,0,5,凱基-永和,2023-09-27,9207
2441,超豐,5,0,5,凱基-永和,2023-09-27,9207
2605,新興,7,2,5,凱基-永和,2023-09-27,9207
4944,兆遠,5,0,5,凱基-永和,2023-09-27,9207
00757,統一FANG+,20,16,4,凱基-永和,2023-09-27,9207
6770,力積電,4,0,4,凱基-永和,2023-09-27,9207
00895,富邦未來車,4,0,4,凱基-永和,2023-09-27,9207
00878,國泰永續高股息,4,0,4,凱基-永和,2023-09-27,9207
00738U,期元大道瓊白銀,4,0,4,凱基-永和,2023-09-27,9207
2618,長榮航,5,1,4,凱基-永和,2023-09-27,9207
2820,華票,4,0,4,凱基-永和,2023-09-27,9207
2888,新光金,6,2,4,凱基-永和,2023-09-27,9207
3293,鈊象,4,0,4,凱基-永和,2023-09-27,9207
3481,群創,4,0,4,凱基-永和,2023-09-27,9207
5347,世界,4,0,4,凱基-永和,2023-09-27,9207
2542,興富發,4,0,4,凱基-永和,2023-09-27,9207
2382,廣達,24,21,3,凱基-永和,2023-09-27,9207
1303,南亞,3,0,3,凱基-永和,2023-09-27,9207
1503,士電,3,0,3,凱基-永和,2023-09-27,9207
3264,欣銓,3,0,3,凱基-永和,2023-09-27,9207
6117,迎廣,68,2,66,凱基-永和,2023-09-28,9207
2353,宏��,50,0,50,凱基-永和,2023-09-28,9207
00751B,元大AAA至A公司債,50,8,42,凱基-永和,2023-09-28,9207
00929,復華台灣科技優息,73,34,39,凱基-永和,2023-09-28,9207
3715,定穎投控,152,125,27,凱基-永和,2023-09-28,9207
2881,富邦金,21,1,20,凱基-永和,2023-09-28,9207
00679B,元大美債20年,18,0,18,凱基-永和,2023-09-28,9207
00720B,元大投資級公司債,16,0,16,凱基-永和,2023-09-28,9207
2317,鴻海,15,0,15,凱基-永和,2023-09-28,9207
2610,華航,13,0,13,凱基-永和,2023-09-28,9207
3325,旭品,97,84,13,凱基-永和,2023-09-28,9207
0055,元大MSCI金融,10,0,10,凱基-永和,2023-09-28,9207
3693,營邦,10,0,10,凱基-永和,2023-09-28,9207
2376,技嘉,15,6,9,凱基-永和,2023-09-28,9207
00919,群益台灣精選高息,8,0,8,凱基-永和,2023-09-28,9207
1402,遠東新,8,0,8,凱基-永和,2023-09-28,9207
00885,富邦越南,7,0,7,凱基-永和,2023-09-28,9207
2449,京元電子,7,0,7,凱基-永和,2023-09-28,9207
6023,元大期,7,0,7,凱基-永和,2023-09-28,9207
8034,榮群,7,0,7,凱基-永和,2023-09-28,9207
3231,緯創,14,7,7,凱基-永和,2023-09-28,9207
2801,彰銀,6,0,6,凱基-永和,2023-09-28,9207
2356,英業達,16,10,6,凱基-永和,2023-09-28,9207
1326,台化,6,0,6,凱基-永和,2023-09-28,9207
00712,復華富時不動產,6,0,6,凱基-永和,2023-09-28,9207
2354,鴻準,7,1,6,凱基-永和,2023-09-28,9207
2377,微星,6,0,6,凱基-永和,2023-09-28,9207
3122,笙泉,7,1,6,凱基-永和,2023-09-28,9207
2344,華邦電,5,0,5,凱基-永和,2023-09-28,9207
00772B,中信高評級公司債,5,0,5,凱基-永和,2023-09-28,9207
00635U,期元大S＆P黃金,5,0,5,凱基-永和,2023-09-28,9207
1584,精剛,5,0,5,凱基-永和,2023-09-28,9207
2105,正新,5,0,5,凱基-永和,2023-09-28,9207
2241,艾姆勒,5,0,5,凱基-永和,2023-09-28,9207
2888B,新光金乙特,5,0,5,凱基-永和,2023-09-28,9207
3035,智原,5,0,5,凱基-永和,2023-09-28,9207
3379,彬台,5,0,5,凱基-永和,2023-09-28,9207
6188,廣明,6,1,5,凱基-永和,2023-09-28,9207
6275,元山,5,0,5,凱基-永和,2023-09-28,9207
8358,金居,5,0,5,凱基-永和,2023-09-28,9207
8942,森鉅,5,0,5,凱基-永和,2023-09-28,9207
9958,世紀鋼,5,0,5,凱基-永和,2023-09-28,9207
2002,中鋼,9,4,5,凱基-永和,2023-09-28,9207
2883,凱基金,4,0,4,凱基-永和,2023-09-28,9207
1524,耿鼎,4,0,4,凱基-永和,2023-09-28,9207
1710,東聯,4,0,4,凱基-永和,2023-09-28,9207
2464,盟立,4,0,4,凱基-永和,2023-09-28,9207
3006,晶豪科,5,1,4,凱基-永和,2023-09-28,9207
3081,聯亞,4,0,4,凱基-永和,2023-09-28,9207
2891,中信金,3,0,3,凱基-永和,2023-09-28,9207
3044,健鼎,310,2,308,凱基-永和,2023-10-02,9207
6187,萬潤,257,1,256,凱基-永和,2023-10-02,9207
6274,台燿,257,37,220,凱基-永和,2023-10-02,9207
3276,宇環,166,100,66,凱基-永和,2023-10-02,9207
3231,緯創,306,240,66,凱基-永和,2023-10-02,9207
2356,英業達,43,5,38,凱基-永和,2023-10-02,9207
2363,矽統,59,24,35,凱基-永和,2023-10-02,9207
5014,建錩,24,0,24,凱基-永和,2023-10-02,9207
1229,聯華,21,0,21,凱基-永和,2023-10-02,9207
00632R,元大台灣50反1,20,0,20,凱基-永和,2023-10-02,9207
2358,廷鑫,20,0,20,凱基-永和,2023-10-02,9207
00720B,元大投資級公司債,17,0,17,凱基-永和,2023-10-02,9207
00751B,元大AAA至A公司債,16,0,16,凱基-永和,2023-10-02,9207
2367,燿華,22,7,15,凱基-永和,2023-10-02,9207
2745,五福,15,0,15,凱基-永和,2023-10-02,9207
2603,長榮,14,0,14,凱基-永和,2023-10-02,9207
00919,群益台灣精選高息,12,0,12,凱基-永和,2023-10-02,9207
00915,凱基優選高股息30,12,0,12,凱基-永和,2023-10-02,9207
2888,新光金,12,0,12,凱基-永和,2023-10-02,9207
3260,威剛,20,9,11,凱基-永和,2023-10-02,9207
00679B,元大美債20年,11,0,11,凱基-永和,2023-10-02,9207
00772B,中信高評級公司債,10,0,10,凱基-永和,2023-10-02,9207
5347,世界,10,0,10,凱基-永和,2023-10-02,9207
00929,復華台灣科技優息,58,48,10,凱基-永和,2023-10-02,9207
00921,兆豐龍頭等權重,10,0,10,凱基-永和,2023-10-02,9207
1305,華夏,10,0,10,凱基-永和,2023-10-02,9207
3038,全台,10,0,10,凱基-永和,2023-10-02,9207
3056,富華新,10,0,10,凱基-永和,2023-10-02,9207
4123,晟德,10,0,10,凱基-永和,2023-10-02,9207
6016,康和證,10,0,10,凱基-永和,2023-10-02,9207
6182,合晶,10,0,10,凱基-永和,2023-10-02,9207
6125,廣運,10,1,9,凱基-永和,2023-10-02,9207
2405,輔信,39,31,8,凱基-永和,2023-10-02,9207
2002,中鋼,9,1,8,凱基-永和,2023-10-02,9207
8930,青鋼,8,1,7,凱基-永和,2023-10-02,9207
3363,上詮,28,22,6,凱基-永和,2023-10-02,9207
6285,啟��,6,0,6,凱基-永和,2023-10-02,9207
1608,華榮,10,5,5,凱基-永和,2023-10-02,9207
2427,三商電,10,5,5,凱基-永和,2023-10-02,9207
2812,台中銀,5,0,5,凱基-永和,2023-10-02,9207
4147,中裕,5,0,5,凱基-永和,2023-10-02,9207
6143,振曜,5,0,5,凱基-永和,2023-10-02,9207
6901,鑽石投資,5,0,5,凱基-永和,2023-10-02,9207
2329,華泰,14,9,5,凱基-永和,2023-10-02,9207
2882,國泰金,5,0,5,凱基-永和,2023-10-02,9207
3037,欣興,7,2,5,凱基-永和,2023-10-02,9207
2886,兆豐金,5,1,4,凱基-永和,2023-10-02,9207
00725B,國泰投資級公司債,4,0,4,凱基-永和,2023-10-02,9207
2731,雄獅,4,0,4,凱基-永和,2023-10-02,9207
00706L,期元大S＆P日圓正2,4,0,4,凱基-永和,2023-10-02,9207
3234,光環,393,2,391,凱基-永和,2023-10-03,9207
2382,廣達,226,22,204,凱基-永和,2023-10-03,9207
00892,富邦台灣半導體,98,0,98,凱基-永和,2023-10-03,9207
00922,國泰台灣領袖50,62,0,62,凱基-永和,2023-10-03,9207
00881,國泰台灣5G+,54,2,52,凱基-永和,2023-10-03,9207
3122,笙泉,56,5,51,凱基-永和,2023-10-03,9207
1201,味全,30,0,30,凱基-永和,2023-10-03,9207
00712,復華富時不動產,24,0,24,凱基-永和,2023-10-03,9207
2855,統一證,20,0,20,凱基-永和,2023-10-03,9207
00929,復華台灣科技優息,19,0,19,凱基-永和,2023-10-03,9207
2882,國泰金,16,0,16,凱基-永和,2023-10-03,9207
3529,力旺,15,0,15,凱基-永和,2023-10-03,9207
3338,泰碩,17,2,15,凱基-永和,2023-10-03,9207
00919,群益台灣精選高息,15,1,14,凱基-永和,2023-10-03,9207
2329,華泰,25,12,13,凱基-永和,2023-10-03,9207
2409,友達,31,19,12,凱基-永和,2023-10-03,9207
3481,群創,13,1,12,凱基-永和,2023-10-03,9207
2317,鴻海,11,0,11,凱基-永和,2023-10-03,9207
8011,台通,11,0,11,凱基-永和,2023-10-03,9207
6285,啟��,11,0,11,凱基-永和,2023-10-03,9207
00772B,中信高評級公司債,9,0,9,凱基-永和,2023-10-03,9207
1442,名軒,9,0,9,凱基-永和,2023-10-03,9207
2356,英業達,15,6,9,凱基-永和,2023-10-03,9207
6757,台灣虎航,9,0,9,凱基-永和,2023-10-03,9207
2618,長榮航,14,6,8,凱基-永和,2023-10-03,9207
00915,凱基優選高股息30,7,0,7,凱基-永和,2023-10-03,9207
2002,中鋼,7,0,7,凱基-永和,2023-10-03,9207
2417,圓剛,73,66,7,凱基-永和,2023-10-03,9207
6182,合晶,7,0,7,凱基-永和,2023-10-03,9207
8034,榮群,7,0,7,凱基-永和,2023-10-03,9207
00795B,中信美國公債20年,6,0,6,凱基-永和,2023-10-03,9207
00738U,期元大道瓊白銀,6,0,6,凱基-永和,2023-10-03,9207
1524,耿鼎,26,20,6,凱基-永和,2023-10-03,9207
2634,漢翔,6,0,6,凱基-永和,2023-10-03,9207
8916,光隆,6,0,6,凱基-永和,2023-10-03,9207
0056,元大高股息,9,3,6,凱基-永和,2023-10-03,9207
2884,玉山金,5,0,5,凱基-永和,2023-10-03,9207
2891,中信金,9,4,5,凱基-永和,2023-10-03,9207
2603,長榮,7,2,5,凱基-永和,2023-10-03,9207
00650L,復華香港正2,5,0,5,凱基-永和,2023-10-03,9207
00753L,中信中國50正2,5,0,5,凱基-永和,2023-10-03,9207
2633,台灣高鐵,5,0,5,凱基-永和,2023-10-03,9207
3264,欣銓,5,0,5,凱基-永和,2023-10-03,9207
4944,兆遠,5,0,5,凱基-永和,2023-10-03,9207
5465,富驊,7,2,5,凱基-永和,2023-10-03,9207
6005,群益證,5,0,5,凱基-永和,2023-10-03,9207
6841,長佳智能,5,0,5,凱基-永和,2023-10-03,9207
8277,商丞,15,10,5,凱基-永和,2023-10-03,9207
8930,青鋼,5,0,5,凱基-永和,2023-10-03,9207
2520,冠德,4,0,4,凱基-永和,2023-10-03,9207
00720B,元大投資級公司債,215,0,215,凱基-永和,2023-10-04,9207
2363,矽統,153,20,133,凱基-永和,2023-10-04,9207
00650L,復華香港正2,63,0,63,凱基-永和,2023-10-04,9207
3715,定穎投控,85,26,59,凱基-永和,2023-10-04,9207
2891,中信金,43,0,43,凱基-永和,2023-10-04,9207
00687B,國泰20年美債,40,0,40,凱基-永和,2023-10-04,9207
00679B,元大美債20年,34,0,34,凱基-永和,2023-10-04,9207
3260,威剛,37,8,29,凱基-永和,2023-10-04,9207
2303,聯電,25,1,24,凱基-永和,2023-10-04,9207
2884,玉山金,22,1,21,凱基-永和,2023-10-04,9207
00929,復華台灣科技優息,20,0,20,凱基-永和,2023-10-04,9207
8277,商丞,15,0,15,凱基-永和,2023-10-04,9207
6117,迎廣,16,2,14,凱基-永和,2023-10-04,9207
00919,群益台灣精選高息,13,0,13,凱基-永和,2023-10-04,9207
4967,十銓,30,17,13,凱基-永和,2023-10-04,9207
00772B,中信高評級公司債,13,0,13,凱基-永和,2023-10-04,9207
1802,台玻,12,0,12,凱基-永和,2023-10-04,9207
2201,裕隆,12,0,12,凱基-永和,2023-10-04,9207
2634,漢翔,12,0,12,凱基-永和,2023-10-04,9207
2633,台灣高鐵,11,0,11,凱基-永和,2023-10-04,9207
8210,勤誠,11,0,11,凱基-永和,2023-10-04,9207
0050,元大台灣50,11,0,11,凱基-永和,2023-10-04,9207
1201,味全,10,0,10,凱基-永和,2023-10-04,9207
2436,偉詮電,10,0,10,凱基-永和,2023-10-04,9207
2606,裕民,10,0,10,凱基-永和,2023-10-04,9207
3338,泰碩,14,4,10,凱基-永和,2023-10-04,9207
8227,巨有科技,11,1,10,凱基-永和,2023-10-04,9207
0056,元大高股息,12,2,10,凱基-永和,2023-10-04,9207
00878,國泰永續高股息,22,13,9,凱基-永和,2023-10-04,9207
00922,國泰台灣領袖50,9,0,9,凱基-永和,2023-10-04,9207
00680L,元大美債20正2,9,0,9,凱基-永和,2023-10-04,9207
6285,啟��,11,2,9,凱基-永和,2023-10-04,9207
9930,中聯資源,9,0,9,凱基-永和,2023-10-04,9207
3231,緯創,15,7,8,凱基-永和,2023-10-04,9207
00795B,中信美國公債20年,10,2,8,凱基-永和,2023-10-04,9207
2002,中鋼,7,0,7,凱基-永和,2023-10-04,9207
00893,國泰智能電動車,7,0,7,凱基-永和,2023-10-04,9207
8034,榮群,7,0,7,凱基-永和,2023-10-04,9207
00751B,元大AAA至A公司債,6,0,6,凱基-永和,2023-10-04,9207
1442,名軒,6,0,6,凱基-永和,2023-10-04,9207
6143,振曜,5,0,5,凱基-永和,2023-10-04,9207
00671R,富邦NASDAQ反1,5,0,5,凱基-永和,2023-10-04,9207
2441,超豐,5,0,5,凱基-永和,2023-10-04,9207
2867,三商壽,5,0,5,凱基-永和,2023-10-04,9207
2883B,凱基金乙特,5,0,5,凱基-永和,2023-10-04,9207
2889,國票金,5,0,5,凱基-永和,2023-10-04,9207
3325,旭品,54,49,5,凱基-永和,2023-10-04,9207
6443,元晶,5,0,5,凱基-永和,2023-10-04,9207
6505,台塑化,5,0,5,凱基-永和,2023-10-04,9207
2330,台積電,4,0,4,凱基-永和,2023-10-04,9207
2486,一詮,601,39,562,凱基-永和,2023-10-05,9207
1722,台肥,205,0,205,凱基-永和,2023-10-05,9207
00720B,元大投資級公司債,66,0,66,凱基-永和,2023-10-05,9207
3664,安瑞-KY,50,0,50,凱基-永和,2023-10-05,9207
3035,智原,37,1,36,凱基-永和,2023-10-05,9207
6187,萬潤,172,137,35,凱基-永和,2023-10-05,9207
2618,長榮航,34,4,30,凱基-永和,2023-10-05,9207
00929,復華台灣科技優息,30,7,23,凱基-永和,2023-10-05,9207
2538,基泰,220,200,20,凱基-永和,2023-10-05,9207
2382,廣達,46,27,19,凱基-永和,2023-10-05,9207
6288,聯嘉,24,6,18,凱基-永和,2023-10-05,9207
2634,漢翔,16,0,16,凱基-永和,2023-10-05,9207
00632R,元大台灣50反1,15,0,15,凱基-永和,2023-10-05,9207
2542,興富發,13,0,13,凱基-永和,2023-10-05,9207
00757,統一FANG+,16,3,13,凱基-永和,2023-10-05,9207
4564,元翎,12,0,12,凱基-永和,2023-10-05,9207
00726B,國泰新興投等債,10,0,10,凱基-永和,2023-10-05,9207
2241,艾姆勒,10,0,10,凱基-永和,2023-10-05,9207
2355,敬鵬,12,2,10,凱基-永和,2023-10-05,9207
3032,偉訓,10,0,10,凱基-永和,2023-10-05,9207
4763,材料-KY,10,0,10,凱基-永和,2023-10-05,9207
2313,華通,10,1,9,凱基-永和,2023-10-05,9207
6531,愛普*,9,0,9,凱基-永和,2023-10-05,9207
2353,宏��,8,0,8,凱基-永和,2023-10-05,9207
2887E,台新戊特,8,0,8,凱基-永和,2023-10-05,9207
3380,明泰,8,0,8,凱基-永和,2023-10-05,9207
2610,華航,17,10,7,凱基-永和,2023-10-05,9207
1442,名軒,7,0,7,凱基-永和,2023-10-05,9207
00753L,中信中國50正2,7,0,7,凱基-永和,2023-10-05,9207
6244,茂迪,10,3,7,凱基-永和,2023-10-05,9207
00715L,期街口布蘭特正2,6,0,6,凱基-永和,2023-10-05,9207
1522,堤維西,15,10,5,凱基-永和,2023-10-05,9207
2376,技嘉,13,8,5,凱基-永和,2023-10-05,9207
3042,晶技,5,0,5,凱基-永和,2023-10-05,9207
4906,正文,5,0,5,凱基-永和,2023-10-05,9207
6109,亞元,5,0,5,凱基-永和,2023-10-05,9207
8930,青鋼,5,0,5,凱基-永和,2023-10-05,9207
9930,中聯資源,5,0,5,凱基-永和,2023-10-05,9207
00679B,元大美債20年,4,0,4,凱基-永和,2023-10-05,9207
0056,元大高股息,6,2,4,凱基-永和,2023-10-05,9207
2548,華固,4,0,4,凱基-永和,2023-10-05,9207
2460,建通,4,0,4,凱基-永和,2023-10-05,9207
2723,美食-KY,4,0,4,凱基-永和,2023-10-05,9207
3265,台星科,7,3,4,凱基-永和,2023-10-05,9207
6285,啟��,4,0,4,凱基-永和,2023-10-05,9207
3037,欣興,4,0,4,凱基-永和,2023-10-05,9207
2417,圓剛,16,13,3,凱基-永和,2023-10-05,9207
00642U,期元大S＆P石油,3,0,3,凱基-永和,2023-10-05,9207
1402,遠東新,3,0,3,凱基-永和,2023-10-05,9207
1785,光洋科,3,0,3,凱基-永和,2023-10-05,9207
2637,慧洋-KY,120,0,120,凱基-永和,2023-10-06,9207
3234,光環,100,5,95,凱基-永和,2023-10-06,9207
00929,復華台灣科技優息,59,0,59,凱基-永和,2023-10-06,9207
2465,麗臺,50,0,50,凱基-永和,2023-10-06,9207
00892,富邦台灣半導體,49,0,49,凱基-永和,2023-10-06,9207
2883,凱基金,41,1,40,凱基-永和,2023-10-06,9207
2816,旺旺保,36,0,36,凱基-永和,2023-10-06,9207
4968,立積,31,0,31,凱基-永和,2023-10-06,9207
2363,矽統,37,15,22,凱基-永和,2023-10-06,9207
00878,國泰永續高股息,18,0,18,凱基-永和,2023-10-06,9207
8086,宏捷科,18,0,18,凱基-永和,2023-10-06,9207
2353,宏��,18,0,18,凱基-永和,2023-10-06,9207
5439,高技,15,0,15,凱基-永和,2023-10-06,9207
2486,一詮,23,11,12,凱基-永和,2023-10-06,9207
2641,正德,11,0,11,凱基-永和,2023-10-06,9207
00720B,元大投資級公司債,10,0,10,凱基-永和,2023-10-06,9207
00715L,期街口布蘭特正2,10,0,10,凱基-永和,2023-10-06,9207
3081,聯亞,10,0,10,凱基-永和,2023-10-06,9207
0056,元大高股息,9,0,9,凱基-永和,2023-10-06,9207
4105,東洋,10,1,9,凱基-永和,2023-10-06,9207
6757,台灣虎航,9,0,9,凱基-永和,2023-10-06,9207
2634,漢翔,8,0,8,凱基-永和,2023-10-06,9207
00885,富邦越南,8,0,8,凱基-永和,2023-10-06,9207
2376,技嘉,14,7,7,凱基-永和,2023-10-06,9207
2356,英業達,7,0,7,凱基-永和,2023-10-06,9207
3013,晟銘電,231,224,7,凱基-永和,2023-10-06,9207
6191,精成科,10,3,7,凱基-永和,2023-10-06,9207
8034,榮群,8,1,7,凱基-永和,2023-10-06,9207
2603,長榮,7,0,7,凱基-永和,2023-10-06,9207
00679B,元大美債20年,6,0,6,凱基-永和,2023-10-06,9207
2354,鴻準,6,0,6,凱基-永和,2023-10-06,9207
2387,精元,6,0,6,凱基-永和,2023-10-06,9207
2645,長榮航太,6,0,6,凱基-永和,2023-10-06,9207
3042,晶技,6,0,6,凱基-永和,2023-10-06,9207
4564,元翎,6,0,6,凱基-永和,2023-10-06,9207
4967,十銓,6,0,6,凱基-永和,2023-10-06,9207
1710,東聯,5,0,5,凱基-永和,2023-10-06,9207
1802,台玻,5,0,5,凱基-永和,2023-10-06,9207
1808,潤隆,5,0,5,凱基-永和,2023-10-06,9207
2365,昆盈,35,30,5,凱基-永和,2023-10-06,9207
3693,營邦,6,1,5,凱基-永和,2023-10-06,9207
4944,兆遠,5,0,5,凱基-永和,2023-10-06,9207
5324,士開,5,0,5,凱基-永和,2023-10-06,9207
6109,亞元,5,0,5,凱基-永和,2023-10-06,9207
8222,寶一,5,0,5,凱基-永和,2023-10-06,9207
00919,群益台灣精選高息,4,0,4,凱基-永和,2023-10-06,9207
00642U,期元大S＆P石油,4,0,4,凱基-永和,2023-10-06,9207
2903,遠百,4,0,4,凱基-永和,2023-10-06,9207
4155,訊映,4,0,4,凱基-永和,2023-10-06,9207
5347,世界,7,3,4,凱基-永和,2023-10-06,9207
2363,矽統,206,27,179,凱基-永和,2023-10-11,9207
3231,緯創,153,112,41,凱基-永和,2023-10-11,9207
4966,譜瑞-KY,25,0,25,凱基-永和,2023-10-11,9207
6016,康和證,20,0,20,凱基-永和,2023-10-11,9207
2441,超豐,20,0,20,凱基-永和,2023-10-11,9207
6109,亞元,20,0,20,凱基-永和,2023-10-11,9207
8034,榮群,20,0,20,凱基-永和,2023-10-11,9207
8390,金益鼎,19,0,19,凱基-永和,2023-10-11,9207
2903,遠百,19,0,19,凱基-永和,2023-10-11,9207
00720B,元大投資級公司債,22,4,18,凱基-永和,2023-10-11,9207
2009,第一銅,15,0,15,凱基-永和,2023-10-11,9207
1442,名軒,14,0,14,凱基-永和,2023-10-11,9207
00679B,元大美債20年,13,0,13,凱基-永和,2023-10-11,9207
0056,元大高股息,16,6,10,凱基-永和,2023-10-11,9207
00632R,元大台灣50反1,10,0,10,凱基-永和,2023-10-11,9207
4543,萬在,10,0,10,凱基-永和,2023-10-11,9207
5388,中磊,11,1,10,凱基-永和,2023-10-11,9207
6288,聯嘉,10,0,10,凱基-永和,2023-10-11,9207
2353,宏��,11,3,8,凱基-永和,2023-10-11,9207
2618,長榮航,8,0,8,凱基-永和,2023-10-11,9207
3623,富晶通,8,0,8,凱基-永和,2023-10-11,9207
5426,振發,8,0,8,凱基-永和,2023-10-11,9207
2603,長榮,16,8,8,凱基-永和,2023-10-11,9207
2301,光寶科,11,4,7,凱基-永和,2023-10-11,9207
6282,康舒,7,0,7,凱基-永和,2023-10-11,9207
2206,三陽工業,5,0,5,凱基-永和,2023-10-11,9207
2356,英業達,6,1,5,凱基-永和,2023-10-11,9207
00681R,元大美債20反1,5,0,5,凱基-永和,2023-10-11,9207
1815,富喬,10,5,5,凱基-永和,2023-10-11,9207
2421,建準,6,1,5,凱基-永和,2023-10-11,9207
2464,盟立,5,0,5,凱基-永和,2023-10-11,9207
2515,中工,5,0,5,凱基-永和,2023-10-11,9207
3006,晶豪科,28,23,5,凱基-永和,2023-10-11,9207
3276,宇環,5,0,5,凱基-永和,2023-10-11,9207
4909,新復興,5,0,5,凱基-永和,2023-10-11,9207
5351,鈺創,7,2,5,凱基-永和,2023-10-11,9207
6741,91APP*-KY,5,0,5,凱基-永和,2023-10-11,9207
2405,輔信,4,0,4,凱基-永和,2023-10-11,9207
2609,陽明,4,0,4,凱基-永和,2023-10-11,9207
3005,神基,4,0,4,凱基-永和,2023-10-11,9207
3081,聯亞,4,0,4,凱基-永和,2023-10-11,9207
4933,友輝,11,7,4,凱基-永和,2023-10-11,9207
6806,森崴能源,4,0,4,凱基-永和,2023-10-11,9207
00878,國泰永續高股息,5,1,4,凱基-永和,2023-10-11,9207
00757,統一FANG+,11,8,3,凱基-永和,2023-10-11,9207
00697B,元大美債7-10,3,0,3,凱基-永和,2023-10-11,9207
2504,國產,3,0,3,凱基-永和,2023-10-11,9207
2605,新興,3,0,3,凱基-永和,2023-10-11,9207
3036,文曄,3,0,3,凱基-永和,2023-10-11,9207
3088,艾訊,3,0,3,凱基-永和,2023-10-11,9207
1471,首利,51,0,51,凱基-永和,2023-10-12,9207
3013,晟銘電,45,1,44,凱基-永和,2023-10-12,9207
00881,國泰台灣5G+,49,10,39,凱基-永和,2023-10-12,9207
4979,華星光,60,22,38,凱基-永和,2023-10-12,9207
8261,富鼎,29,0,29,凱基-永和,2023-10-12,9207
3035,智原,33,4,29,凱基-永和,2023-10-12,9207
5215,科嘉-KY,20,0,20,凱基-永和,2023-10-12,9207
3715,定穎投控,154,135,19,凱基-永和,2023-10-12,9207
00720B,元大投資級公司債,16,0,16,凱基-永和,2023-10-12,9207
00633L,富邦上証正2,15,0,15,凱基-永和,2023-10-12,9207
2801,彰銀,11,0,11,凱基-永和,2023-10-12,9207
8034,榮群,10,0,10,凱基-永和,2023-10-12,9207
8210,勤誠,13,3,10,凱基-永和,2023-10-12,9207
8420,明揚,10,0,10,凱基-永和,2023-10-12,9207
3443,創意,10,0,10,凱基-永和,2023-10-12,9207
2607,榮運,10,1,9,凱基-永和,2023-10-12,9207
2383,台光電,8,0,8,凱基-永和,2023-10-12,9207
00757,統一FANG+,13,6,7,凱基-永和,2023-10-12,9207
1580,新麥,7,1,6,凱基-永和,2023-10-12,9207
0056,元大高股息,9,4,5,凱基-永和,2023-10-12,9207
2701,萬企,5,0,5,凱基-永和,2023-10-12,9207
6288,聯嘉,5,0,5,凱基-永和,2023-10-12,9207
2233,宇隆,7,2,5,凱基-永和,2023-10-12,9207
2206,三陽工業,13,9,4,凱基-永和,2023-10-12,9207
3231,緯創,9,5,4,凱基-永和,2023-10-12,9207
00713,元大台灣高息低波,4,0,4,凱基-永和,2023-10-12,9207
9919,康那香,4,0,4,凱基-永和,2023-10-12,9207
00715L,期街口布蘭特正2,4,0,4,凱基-永和,2023-10-12,9207
3617,碩天,4,0,4,凱基-永和,2023-10-12,9207
4114,健喬,4,0,4,凱基-永和,2023-10-12,9207
6245,立端,5,1,4,凱基-永和,2023-10-12,9207
9925,新保,4,0,4,凱基-永和,2023-10-12,9207
1503,士電,4,1,3,凱基-永和,2023-10-12,9207
00726B,國泰新興投等債,3,0,3,凱基-永和,2023-10-12,9207
1802,台玻,3,0,3,凱基-永和,2023-10-12,9207
5534,長虹,3,0,3,凱基-永和,2023-10-12,9207
2816,旺旺保,3,0,3,凱基-永和,2023-10-12,9207
2851,中再保,2,0,2,凱基-永和,2023-10-12,9207
00929,復華台灣科技優息,5,3,2,凱基-永和,2023-10-12,9207
6285,啟��,2,0,2,凱基-永和,2023-10-12,9207
3227,原相,2,0,2,凱基-永和,2023-10-12,9207
1453,大將,2,0,2,凱基-永和,2023-10-12,9207
2360,致茂,7,5,2,凱基-永和,2023-10-12,9207
00885,富邦越南,2,0,2,凱基-永和,2023-10-12,9207
1603,華電,6,4,2,凱基-永和,2023-10-12,9207
1609,大亞,2,0,2,凱基-永和,2023-10-12,9207
2425,承啟,6,4,2,凱基-永和,2023-10-12,9207
2465,麗臺,2,0,2,凱基-永和,2023-10-12,9207
2617,台航,2,0,2,凱基-永和,2023-10-12,9207
2889,國票金,4,2,2,凱基-永和,2023-10-12,9207
2515,中工,200,32,168,凱基-永和,2023-10-13,9207
00669R,國泰美國道瓊反1,50,0,50,凱基-永和,2023-10-13,9207
1314,中石化,53,11,42,凱基-永和,2023-10-13,9207
4966,譜瑞-KY,43,5,38,凱基-永和,2023-10-13,9207
3231,緯創,35,4,31,凱基-永和,2023-10-13,9207
0056,元大高股息,35,5,30,凱基-永和,2023-10-13,9207
2353,宏��,30,0,30,凱基-永和,2023-10-13,9207
2401,凌陽,30,0,30,凱基-永和,2023-10-13,9207
00878,國泰永續高股息,28,0,28,凱基-永和,2023-10-13,9207
4919,新唐,20,1,19,凱基-永和,2023-10-13,9207
2301,光寶科,26,9,17,凱基-永和,2023-10-13,9207
00680L,元大美債20正2,17,0,17,凱基-永和,2023-10-13,9207
3325,旭品,15,0,15,凱基-永和,2023-10-13,9207
3380,明泰,15,0,15,凱基-永和,2023-10-13,9207
2382,廣達,41,28,13,凱基-永和,2023-10-13,9207
3078,僑威,24,12,12,凱基-永和,2023-10-13,9207
3189,景碩,10,0,10,凱基-永和,2023-10-13,9207
2906,高林,10,0,10,凱基-永和,2023-10-13,9207
3548,兆利,10,0,10,凱基-永和,2023-10-13,9207
6412,群電,10,0,10,凱基-永和,2023-10-13,9207
2881,富邦金,10,0,10,凱基-永和,2023-10-13,9207
00720B,元大投資級公司債,9,0,9,凱基-永和,2023-10-13,9207
2376,技嘉,14,5,9,凱基-永和,2023-10-13,9207
00679B,元大美債20年,8,0,8,凱基-永和,2023-10-13,9207
1608,華榮,8,0,8,凱基-永和,2023-10-13,9207
1785,光洋科,8,0,8,凱基-永和,2023-10-13,9207
6202,盛群,8,0,8,凱基-永和,2023-10-13,9207
8034,榮群,8,0,8,凱基-永和,2023-10-13,9207
8068,全達,11,3,8,凱基-永和,2023-10-13,9207
00726B,國泰新興投等債,7,0,7,凱基-永和,2023-10-13,9207
00885,富邦越南,7,0,7,凱基-永和,2023-10-13,9207
2002,中鋼,7,0,7,凱基-永和,2023-10-13,9207
3041,揚智,7,0,7,凱基-永和,2023-10-13,9207
6282,康舒,7,0,7,凱基-永和,2023-10-13,9207
5347,世界,18,12,6,凱基-永和,2023-10-13,9207
00922,國泰台灣領袖50,6,0,6,凱基-永和,2023-10-13,9207
00648R,元大S＆P500反1,6,0,6,凱基-永和,2023-10-13,9207
2427,三商電,9,3,6,凱基-永和,2023-10-13,9207
3265,台星科,8,2,6,凱基-永和,2023-10-13,9207
3048,益登,5,0,5,凱基-永和,2023-10-13,9207
00671R,富邦NASDAQ反1,5,0,5,凱基-永和,2023-10-13,9207
00708L,期元大S＆P黃金正2,5,0,5,凱基-永和,2023-10-13,9207
1584,精剛,5,0,5,凱基-永和,2023-10-13,9207
2377,微星,5,0,5,凱基-永和,2023-10-13,9207
3037,欣興,5,0,5,凱基-永和,2023-10-13,9207
3704,合勤控,6,1,5,凱基-永和,2023-10-13,9207
4128,中天,5,0,5,凱基-永和,2023-10-13,9207
6109,亞元,5,0,5,凱基-永和,2023-10-13,9207
6269,台郡,5,0,5,凱基-永和,2023-10-13,9207
6284,佳邦,14,9,5,凱基-永和,2023-10-13,9207
2618,長榮航,121,0,121,凱基-永和,2023-10-16,9207
2344,華邦電,66,1,65,凱基-永和,2023-10-16,9207
00922,國泰台灣領袖50,56,0,56,凱基-永和,2023-10-16,9207
6770,力積電,77,22,55,凱基-永和,2023-10-16,9207
3325,旭品,35,0,35,凱基-永和,2023-10-16,9207
4979,華星光,35,6,29,凱基-永和,2023-10-16,9207
0056,元大高股息,28,0,28,凱基-永和,2023-10-16,9207
2610,華航,26,0,26,凱基-永和,2023-10-16,9207
2401,凌陽,26,1,25,凱基-永和,2023-10-16,9207
6109,亞元,22,0,22,凱基-永和,2023-10-16,9207
00929,復華台灣科技優息,41,20,21,凱基-永和,2023-10-16,9207
6451,訊芯-KY,20,0,20,凱基-永和,2023-10-16,9207
00632R,元大台灣50反1,20,0,20,凱基-永和,2023-10-16,9207
1314,中石化,21,1,20,凱基-永和,2023-10-16,9207
00919,群益台灣精選高息,20,2,18,凱基-永和,2023-10-16,9207
6757,台灣虎航,18,0,18,凱基-永和,2023-10-16,9207
2323,中環,14,0,14,凱基-永和,2023-10-16,9207
3706,神達,12,0,12,凱基-永和,2023-10-16,9207
4906,正文,12,0,12,凱基-永和,2023-10-16,9207
00633L,富邦上証正2,10,0,10,凱基-永和,2023-10-16,9207
2025,千興,10,0,10,凱基-永和,2023-10-16,9207
3260,威剛,11,1,10,凱基-永和,2023-10-16,9207
3557,嘉威,10,0,10,凱基-永和,2023-10-16,9207
4923,力士,10,0,10,凱基-永和,2023-10-16,9207
1309,台達化,10,1,9,凱基-永和,2023-10-16,9207
00878,國泰永續高股息,14,6,8,凱基-永和,2023-10-16,9207
2201,裕隆,8,0,8,凱基-永和,2023-10-16,9207
2324,仁寶,7,0,7,凱基-永和,2023-10-16,9207
2516,新建,7,0,7,凱基-永和,2023-10-16,9207
3276,宇環,12,5,7,凱基-永和,2023-10-16,9207
6284,佳邦,18,11,7,凱基-永和,2023-10-16,9207
9950,萬國通,8,1,7,凱基-永和,2023-10-16,9207
2347,聯強,10,3,7,凱基-永和,2023-10-16,9207
3005,神基,6,0,6,凱基-永和,2023-10-16,9207
8034,榮群,10,4,6,凱基-永和,2023-10-16,9207
00680L,元大美債20正2,5,0,5,凱基-永和,2023-10-16,9207
00720B,元大投資級公司債,6,1,5,凱基-永和,2023-10-16,9207
00893,國泰智能電動車,5,0,5,凱基-永和,2023-10-16,9207
1524,耿鼎,11,6,5,凱基-永和,2023-10-16,9207
2208,台船,5,0,5,凱基-永和,2023-10-16,9207
2420,新巨,5,0,5,凱基-永和,2023-10-16,9207
3189,景碩,5,0,5,凱基-永和,2023-10-16,9207
6282,康舒,5,0,5,凱基-永和,2023-10-16,9207
2892,第一金,5,0,5,凱基-永和,2023-10-16,9207
2206,三陽工業,5,1,4,凱基-永和,2023-10-16,9207
3231,緯創,16,12,4,凱基-永和,2023-10-16,9207
2637,慧洋-KY,4,0,4,凱基-永和,2023-10-16,9207
00921,兆豐龍頭等權重,4,0,4,凱基-永和,2023-10-16,9207
00926,凱基全球菁英55,5,1,4,凱基-永和,2023-10-16,9207
0061,元大寶滬深,4,0,4,凱基-永和,2023-10-16,9207
0056,元大高股息,71,4,67,凱基-永和,2023-10-17,9207
00881,國泰台灣5G+,49,0,49,凱基-永和,2023-10-17,9207
1471,首利,102,57,45,凱基-永和,2023-10-17,9207
6113,亞矽,45,0,45,凱基-永和,2023-10-17,9207
00922,國泰台灣領袖50,41,0,41,凱基-永和,2023-10-17,9207
6109,亞元,24,0,24,凱基-永和,2023-10-17,9207
00929,復華台灣科技優息,22,0,22,凱基-永和,2023-10-17,9207
8088,品安,34,12,22,凱基-永和,2023-10-17,9207
2425,承啟,29,8,21,凱基-永和,2023-10-17,9207
2363,矽統,298,278,20,凱基-永和,2023-10-17,9207
3231,緯創,31,12,19,凱基-永和,2023-10-17,9207
00715L,期街口布蘭特正2,19,0,19,凱基-永和,2023-10-17,9207
5299,杰力,18,0,18,凱基-永和,2023-10-17,9207
2301,光寶科,16,2,14,凱基-永和,2023-10-17,9207
00720B,元大投資級公司債,14,0,14,凱基-永和,2023-10-17,9207
00878,國泰永續高股息,13,1,12,凱基-永和,2023-10-17,9207
2618,長榮航,21,10,11,凱基-永和,2023-10-17,9207
2892,第一金,10,0,10,凱基-永和,2023-10-17,9207
3379,彬台,10,0,10,凱基-永和,2023-10-17,9207
5347,世界,17,9,8,凱基-永和,2023-10-17,9207
00679B,元大美債20年,7,0,7,凱基-永和,2023-10-17,9207
00708L,期元大S＆P黃金正2,7,0,7,凱基-永和,2023-10-17,9207
00687B,國泰20年美債,7,0,7,凱基-永和,2023-10-17,9207
2316,楠梓電,10,3,7,凱基-永和,2023-10-17,9207
6170,統振,7,0,7,凱基-永和,2023-10-17,9207
1810,和成,6,0,6,凱基-永和,2023-10-17,9207
8034,榮群,6,0,6,凱基-永和,2023-10-17,9207
3702,大聯大,10,5,5,凱基-永和,2023-10-17,9207
2610,華航,5,0,5,凱基-永和,2023-10-17,9207
00751B,元大AAA至A公司債,5,0,5,凱基-永和,2023-10-17,9207
3317,尼克森,5,0,5,凱基-永和,2023-10-17,9207
4128,中天,5,0,5,凱基-永和,2023-10-17,9207
5309,系統電,5,0,5,凱基-永和,2023-10-17,9207
9933,中鼎,5,0,5,凱基-永和,2023-10-17,9207
2201,裕隆,4,0,4,凱基-永和,2023-10-17,9207
2888,新光金,4,0,4,凱基-永和,2023-10-17,9207
2637,慧洋-KY,4,0,4,凱基-永和,2023-10-17,9207
1580,新麥,4,0,4,凱基-永和,2023-10-17,9207
00772B,中信高評級公司債,4,0,4,凱基-永和,2023-10-17,9207
1616,億泰,4,0,4,凱基-永和,2023-10-17,9207
2344,華邦電,30,26,4,凱基-永和,2023-10-17,9207
2420,新巨,4,0,4,凱基-永和,2023-10-17,9207
3081,聯亞,6,2,4,凱基-永和,2023-10-17,9207
4908,前鼎,15,11,4,凱基-永和,2023-10-17,9207
4968,立積,4,0,4,凱基-永和,2023-10-17,9207
6203,海韻電,4,0,4,凱基-永和,2023-10-17,9207
6438,迅得,4,0,4,凱基-永和,2023-10-17,9207
8093,保銳,4,0,4,凱基-永和,2023-10-17,9207
2317,鴻海,4,0,4,凱基-永和,2023-10-17,9207
00680L,元大美債20正2,3,0,3,凱基-永和,2023-10-17,9207
00878,國泰永續高股息,120,33,87,凱基-永和,2023-10-18,9207
0056,元大高股息,90,13,77,凱基-永和,2023-10-18,9207
2816,旺旺保,60,0,60,凱基-永和,2023-10-18,9207
6443,元晶,50,0,50,凱基-永和,2023-10-18,9207
00929,復華台灣科技優息,36,0,36,凱基-永和,2023-10-18,9207
3037,欣興,35,0,35,凱基-永和,2023-10-18,9207
2344,華邦電,33,1,32,凱基-永和,2023-10-18,9207
2401,凌陽,38,9,29,凱基-永和,2023-10-18,9207
1815,富喬,28,0,28,凱基-永和,2023-10-18,9207
00919,群益台灣精選高息,26,0,26,凱基-永和,2023-10-18,9207
2515,中工,25,0,25,凱基-永和,2023-10-18,9207
2317,鴻海,23,0,23,凱基-永和,2023-10-18,9207
00922,國泰台灣領袖50,23,0,23,凱基-永和,2023-10-18,9207
00881,國泰台灣5G+,22,0,22,凱基-永和,2023-10-18,9207
6244,茂迪,21,0,21,凱基-永和,2023-10-18,9207
1504,東元,20,0,20,凱基-永和,2023-10-18,9207
1524,耿鼎,20,0,20,凱基-永和,2023-10-18,9207
4979,華星光,22,2,20,凱基-永和,2023-10-18,9207
6182,合晶,20,1,19,凱基-永和,2023-10-18,9207
2002,中鋼,18,0,18,凱基-永和,2023-10-18,9207
2481,強茂,18,0,18,凱基-永和,2023-10-18,9207
3032,偉訓,17,0,17,凱基-永和,2023-10-18,9207
2610,華航,16,0,16,凱基-永和,2023-10-18,9207
1101,台泥,15,0,15,凱基-永和,2023-10-18,9207
3325,旭品,20,6,14,凱基-永和,2023-10-18,9207
3706,神達,14,0,14,凱基-永和,2023-10-18,9207
00720B,元大投資級公司債,13,0,13,凱基-永和,2023-10-18,9207
3081,聯亞,16,4,12,凱基-永和,2023-10-18,9207
6109,亞元,12,0,12,凱基-永和,2023-10-18,9207
5534,長虹,11,0,11,凱基-永和,2023-10-18,9207
3231,緯創,98,88,10,凱基-永和,2023-10-18,9207
00893,國泰智能電動車,10,0,10,凱基-永和,2023-10-18,9207
2324,仁寶,10,0,10,凱基-永和,2023-10-18,9207
00679B,元大美債20年,10,0,10,凱基-永和,2023-10-18,9207
00907,永豐優息存股,10,0,10,凱基-永和,2023-10-18,9207
2645,長榮航太,10,0,10,凱基-永和,2023-10-18,9207
4744,皇將,10,0,10,凱基-永和,2023-10-18,9207
5876,上海商銀,10,0,10,凱基-永和,2023-10-18,9207
3484,崧騰,15,6,9,凱基-永和,2023-10-18,9207
2206,三陽工業,11,2,9,凱基-永和,2023-10-18,9207
2374,佳能,8,0,8,凱基-永和,2023-10-18,9207
8390,金益鼎,8,0,8,凱基-永和,2023-10-18,9207
6257,矽格,7,0,7,凱基-永和,2023-10-18,9207
6442,光聖,7,0,7,凱基-永和,2023-10-18,9207
1319,東陽,7,1,6,凱基-永和,2023-10-18,9207
6125,廣運,6,0,6,凱基-永和,2023-10-18,9207
8034,榮群,6,0,6,凱基-永和,2023-10-18,9207
2376,技嘉,12,6,6,凱基-永和,2023-10-18,9207
6531,愛普*,5,0,5,凱基-永和,2023-10-18,9207
1709,和益,5,0,5,凱基-永和,2023-10-18,9207
9950,萬國通,162,88,74,凱基-永和,2023-10-19,9207
00929,復華台灣科技優息,68,10,58,凱基-永和,2023-10-19,9207
00878,國泰永續高股息,56,4,52,凱基-永和,2023-10-19,9207
00753L,中信中國50正2,37,0,37,凱基-永和,2023-10-19,9207
6274,台燿,32,1,31,凱基-永和,2023-10-19,9207
3044,健鼎,30,0,30,凱基-永和,2023-10-19,9207
6187,萬潤,30,0,30,凱基-永和,2023-10-19,9207
00720B,元大投資級公司債,28,0,28,凱基-永和,2023-10-19,9207
0056,元大高股息,31,7,24,凱基-永和,2023-10-19,9207
2328,廣宇,20,0,20,凱基-永和,2023-10-19,9207
6451,訊芯-KY,21,1,20,凱基-永和,2023-10-19,9207
1101,台泥,19,0,19,凱基-永和,2023-10-19,9207
1442,名軒,15,0,15,凱基-永和,2023-10-19,9207
00679B,元大美債20年,13,0,13,凱基-永和,2023-10-19,9207
00751B,元大AAA至A公司債,13,0,13,凱基-永和,2023-10-19,9207
6568,宏觀,13,0,13,凱基-永和,2023-10-19,9207
00922,國泰台灣領袖50,11,0,11,凱基-永和,2023-10-19,9207
2002,中鋼,10,0,10,凱基-永和,2023-10-19,9207
1799,易威,10,0,10,凱基-永和,2023-10-19,9207
2009,第一銅,10,0,10,凱基-永和,2023-10-19,9207
2634,漢翔,10,0,10,凱基-永和,2023-10-19,9207
2897,王道銀行,10,0,10,凱基-永和,2023-10-19,9207
3379,彬台,10,0,10,凱基-永和,2023-10-19,9207
6220,岳豐,10,0,10,凱基-永和,2023-10-19,9207
00893,國泰智能電動車,9,0,9,凱基-永和,2023-10-19,9207
00933B,國泰10Y+金融債,19,10,9,凱基-永和,2023-10-19,9207
00885,富邦越南,9,0,9,凱基-永和,2023-10-19,9207
00665L,富邦�琤肭磪囓�2,8,0,8,凱基-永和,2023-10-19,9207
1618,合機,8,0,8,凱基-永和,2023-10-19,9207
00637L,元大滬深300正2,7,0,7,凱基-永和,2023-10-19,9207
6196,帆宣,7,0,7,凱基-永和,2023-10-19,9207
00795B,中信美國公債20年,7,0,7,凱基-永和,2023-10-19,9207
2618,長榮航,6,0,6,凱基-永和,2023-10-19,9207
2888,新光金,6,0,6,凱基-永和,2023-10-19,9207
6282,康舒,8,2,6,凱基-永和,2023-10-19,9207
2206,三陽工業,6,1,5,凱基-永和,2023-10-19,9207
3693,營邦,5,0,5,凱基-永和,2023-10-19,9207
00687B,國泰20年美債,5,0,5,凱基-永和,2023-10-19,9207
00724B,群益投資級金融債,5,0,5,凱基-永和,2023-10-19,9207
2891,中信金,6,1,5,凱基-永和,2023-10-19,9207
5230,雷笛克光學,5,0,5,凱基-永和,2023-10-19,9207
8215,明基材,5,0,5,凱基-永和,2023-10-19,9207
2454,聯發科,5,0,5,凱基-永和,2023-10-19,9207
00772B,中信高評級公司債,10,6,4,凱基-永和,2023-10-19,9207
00712,復華富時不動產,4,0,4,凱基-永和,2023-10-19,9207
1568,倉佑,35,31,4,凱基-永和,2023-10-19,9207
1608,華榮,4,0,4,凱基-永和,2023-10-19,9207
8277,商丞,5,1,4,凱基-永和,2023-10-19,9207
2915,潤泰全,4,0,4,凱基-永和,2023-10-19,9207
2347,聯強,4,1,3,凱基-永和,2023-10-19,9207
2382,廣達,86,28,58,凱基-永和,2023-10-20,9207
00878,國泰永續高股息,79,37,42,凱基-永和,2023-10-20,9207
00929,復華台灣科技優息,33,4,29,凱基-永和,2023-10-20,9207
6109,亞元,29,0,29,凱基-永和,2023-10-20,9207
6770,力積電,27,3,24,凱基-永和,2023-10-20,9207
2885,元大金,42,20,22,凱基-永和,2023-10-20,9207
2009,第一銅,17,0,17,凱基-永和,2023-10-20,9207
2449,京元電子,20,3,17,凱基-永和,2023-10-20,9207
2886,兆豐金,21,4,17,凱基-永和,2023-10-20,9207
00679B,元大美債20年,15,0,15,凱基-永和,2023-10-20,9207
00637L,元大滬深300正2,14,0,14,凱基-永和,2023-10-20,9207
1524,耿鼎,20,6,14,凱基-永和,2023-10-20,9207
2303,聯電,23,10,13,凱基-永和,2023-10-20,9207
2454,聯發科,13,0,13,凱基-永和,2023-10-20,9207
00712,復華富時不動產,12,0,12,凱基-永和,2023-10-20,9207
2347,聯強,12,1,11,凱基-永和,2023-10-20,9207
5880,合庫金,11,0,11,凱基-永和,2023-10-20,9207
8390,金益鼎,11,1,10,凱基-永和,2023-10-20,9207
00897,富邦基因免疫生技,10,0,10,凱基-永和,2023-10-20,9207
1616,億泰,10,0,10,凱基-永和,2023-10-20,9207
2618,長榮航,12,2,10,凱基-永和,2023-10-20,9207
8358,金居,12,2,10,凱基-永和,2023-10-20,9207
1532,勤美,7,0,7,凱基-永和,2023-10-20,9207
2888,新光金,7,0,7,凱基-永和,2023-10-20,9207
2884,玉山金,7,0,7,凱基-永和,2023-10-20,9207
0056,元大高股息,28,21,7,凱基-永和,2023-10-20,9207
00931B,統一美債20年,6,0,6,凱基-永和,2023-10-20,9207
4944,兆遠,6,0,6,凱基-永和,2023-10-20,9207
5516,雙喜,7,1,6,凱基-永和,2023-10-20,9207
6153,嘉聯益,6,0,6,凱基-永和,2023-10-20,9207
00757,統一FANG+,15,10,5,凱基-永和,2023-10-20,9207
2305,全友,6,1,5,凱基-永和,2023-10-20,9207
3189,景碩,5,0,5,凱基-永和,2023-10-20,9207
00648R,元大S＆P500反1,5,0,5,凱基-永和,2023-10-20,9207
00895,富邦未來車,5,0,5,凱基-永和,2023-10-20,9207
00885,富邦越南,5,0,5,凱基-永和,2023-10-20,9207
1101,台泥,5,0,5,凱基-永和,2023-10-20,9207
2605,新興,5,0,5,凱基-永和,2023-10-20,9207
2883,凱基金,5,0,5,凱基-永和,2023-10-20,9207
3035,智原,8,3,5,凱基-永和,2023-10-20,9207
6257,矽格,5,0,5,凱基-永和,2023-10-20,9207
8916,光隆,5,0,5,凱基-永和,2023-10-20,9207
9955,佳龍,10,5,5,凱基-永和,2023-10-20,9207
2206,三陽工業,5,1,4,凱基-永和,2023-10-20,9207
00919,群益台灣精選高息,4,0,4,凱基-永和,2023-10-20,9207
1303,南亞,4,0,4,凱基-永和,2023-10-20,9207
2201,裕隆,4,0,4,凱基-永和,2023-10-20,9207
9933,中鼎,4,0,4,凱基-永和,2023-10-20,9207
00922,國泰台灣領袖50,4,0,4,凱基-永和,2023-10-20,9207
2882,國泰金,4,0,4,凱基-永和,2023-10-20,9207
2884,玉山金,64,0,64,凱基-永和,2023-10-23,9207
4542,科嶠,50,0,50,凱基-永和,2023-10-23,9207
6233,旺玖,51,1,50,凱基-永和,2023-10-23,9207
00929,復華台灣科技優息,42,2,40,凱基-永和,2023-10-23,9207
0056,元大高股息,45,15,30,凱基-永和,2023-10-23,9207
00878,國泰永續高股息,50,21,29,凱基-永和,2023-10-23,9207
00919,群益台灣精選高息,28,0,28,凱基-永和,2023-10-23,9207
2317,鴻海,39,14,25,凱基-永和,2023-10-23,9207
00632R,元大台灣50反1,20,0,20,凱基-永和,2023-10-23,9207
2201,裕隆,20,0,20,凱基-永和,2023-10-23,9207
2610,華航,19,1,18,凱基-永和,2023-10-23,9207
00715L,期街口布蘭特正2,16,0,16,凱基-永和,2023-10-23,9207
00679B,元大美債20年,15,0,15,凱基-永和,2023-10-23,9207
00720B,元大投資級公司債,13,0,13,凱基-永和,2023-10-23,9207
2633,台灣高鐵,13,0,13,凱基-永和,2023-10-23,9207
0050,元大台灣50,12,0,12,凱基-永和,2023-10-23,9207
00712,復華富時不動產,10,0,10,凱基-永和,2023-10-23,9207
1514,亞力,10,0,10,凱基-永和,2023-10-23,9207
1717,長興,10,0,10,凱基-永和,2023-10-23,9207
2408,南亞科,10,0,10,凱基-永和,2023-10-23,9207
6274,台燿,10,1,9,凱基-永和,2023-10-23,9207
00922,國泰台灣領袖50,8,0,8,凱基-永和,2023-10-23,9207
2438,翔耀,8,0,8,凱基-永和,2023-10-23,9207
3481,群創,8,0,8,凱基-永和,2023-10-23,9207
00900,富邦特選高股息30,7,0,7,凱基-永和,2023-10-23,9207
6213,聯茂,7,0,7,凱基-永和,2023-10-23,9207
3260,威剛,8,1,7,凱基-永和,2023-10-23,9207
00687B,國泰20年美債,6,0,6,凱基-永和,2023-10-23,9207
3025,星通,16,10,6,凱基-永和,2023-10-23,9207
00751B,元大AAA至A公司債,5,0,5,凱基-永和,2023-10-23,9207
1101,台泥,5,0,5,凱基-永和,2023-10-23,9207
00916,國泰全球品牌50,5,0,5,凱基-永和,2023-10-23,9207
1905,華紙,5,0,5,凱基-永和,2023-10-23,9207
2427,三商電,10,5,5,凱基-永和,2023-10-23,9207
2516,新建,5,0,5,凱基-永和,2023-10-23,9207
3711,日月光投控,5,0,5,凱基-永和,2023-10-23,9207
6269,台郡,5,0,5,凱基-永和,2023-10-23,9207
00923,群益台ESG低碳50,4,0,4,凱基-永和,2023-10-23,9207
00881,國泰台灣5G+,4,0,4,凱基-永和,2023-10-23,9207
00671R,富邦NASDAQ反1,4,0,4,凱基-永和,2023-10-23,9207
1582,信錦,4,0,4,凱基-永和,2023-10-23,9207
2303,聯電,9,5,4,凱基-永和,2023-10-23,9207
2605,新興,4,0,4,凱基-永和,2023-10-23,9207
4968,立積,4,0,4,凱基-永和,2023-10-23,9207
5258,虹堡,15,11,4,凱基-永和,2023-10-23,9207
6104,創惟,4,0,4,凱基-永和,2023-10-23,9207
6118,建達,4,0,4,凱基-永和,2023-10-23,9207
2330,台積電,3,0,3,凱基-永和,2023-10-23,9207
1303,南亞,3,0,3,凱基-永和,2023-10-23,9207
00648R,元大S＆P500反1,3,0,3,凱基-永和,2023-10-23,9207
2405,輔信,153,5,148,凱基-永和,2023-10-24,9207
2382,廣達,292,197,95,凱基-永和,2023-10-24,9207
2317,鴻海,64,3,61,凱基-永和,2023-10-24,9207
2014,中鴻,57,0,57,凱基-永和,2023-10-24,9207
4908,前鼎,68,12,56,凱基-永和,2023-10-24,9207
3325,旭品,45,0,45,凱基-永和,2023-10-24,9207
6442,光聖,41,1,40,凱基-永和,2023-10-24,9207
6182,合晶,40,0,40,凱基-永和,2023-10-24,9207
00929,復華台灣科技優息,27,1,26,凱基-永和,2023-10-24,9207
6276,安鈦克,25,0,25,凱基-永和,2023-10-24,9207
8048,德勝,25,0,25,凱基-永和,2023-10-24,9207
2441,超豐,20,1,19,凱基-永和,2023-10-24,9207
4906,正文,15,1,14,凱基-永和,2023-10-24,9207
2887,台新金,12,0,12,凱基-永和,2023-10-24,9207
00712,復華富時不動產,11,0,11,凱基-永和,2023-10-24,9207
2369,菱生,154,143,11,凱基-永和,2023-10-24,9207
2399,映泰,10,0,10,凱基-永和,2023-10-24,9207
2303,聯電,12,3,9,凱基-永和,2023-10-24,9207
3704,合勤控,13,4,9,凱基-永和,2023-10-24,9207
2884,玉山金,7,0,7,凱基-永和,2023-10-24,9207
2002,中鋼,7,0,7,凱基-永和,2023-10-24,9207
2457,飛宏,9,2,7,凱基-永和,2023-10-24,9207
5381,合正,7,0,7,凱基-永和,2023-10-24,9207
3260,威剛,10,3,7,凱基-永和,2023-10-24,9207
1721,三晃,6,0,6,凱基-永和,2023-10-24,9207
3189,景碩,6,0,6,凱基-永和,2023-10-24,9207
3481,群創,5,0,5,凱基-永和,2023-10-24,9207
1301,台塑,5,0,5,凱基-永和,2023-10-24,9207
00720B,元大投資級公司債,5,0,5,凱基-永和,2023-10-24,9207
00637L,元大滬深300正2,5,0,5,凱基-永和,2023-10-24,9207
1905,華紙,5,0,5,凱基-永和,2023-10-24,9207
2897,王道銀行,5,0,5,凱基-永和,2023-10-24,9207
3548,兆利,5,0,5,凱基-永和,2023-10-24,9207
5289,宜鼎,5,0,5,凱基-永和,2023-10-24,9207
6874,倍力,5,0,5,凱基-永和,2023-10-24,9207
2883,凱基金,4,0,4,凱基-永和,2023-10-24,9207
0050,元大台灣50,4,0,4,凱基-永和,2023-10-24,9207
3037,欣興,5,1,4,凱基-永和,2023-10-24,9207
2637,慧洋-KY,4,0,4,凱基-永和,2023-10-24,9207
2834,臺企銀,4,0,4,凱基-永和,2023-10-24,9207
00850,元大臺灣ESG永續,4,0,4,凱基-永和,2023-10-24,9207
3017,奇鋐,6,2,4,凱基-永和,2023-10-24,9207
2426,鼎元,3,0,3,凱基-永和,2023-10-24,9207
2603,長榮,3,0,3,凱基-永和,2023-10-24,9207
3711,日月光投控,3,0,3,凱基-永和,2023-10-24,9207
4128,中天,3,0,3,凱基-永和,2023-10-24,9207
6284,佳邦,9,6,3,凱基-永和,2023-10-24,9207
6494,九齊,3,0,3,凱基-永和,2023-10-24,9207
6515,穎崴,3,0,3,凱基-永和,2023-10-24,9207
8110,華東,13,10,3,凱基-永和,2023-10-24,9207
2317,鴻海,569,4,565,凱基-永和,2023-10-25,9207
6117,迎廣,280,180,100,凱基-永和,2023-10-25,9207
2465,麗臺,100,3,97,凱基-永和,2023-10-25,9207
2816,旺旺保,82,1,81,凱基-永和,2023-10-25,9207
8054,安國,71,2,69,凱基-永和,2023-10-25,9207
3058,立德,50,0,50,凱基-永和,2023-10-25,9207
00881,國泰台灣5G+,45,0,45,凱基-永和,2023-10-25,9207
4966,譜瑞-KY,37,1,36,凱基-永和,2023-10-25,9207
1524,耿鼎,213,185,28,凱基-永和,2023-10-25,9207
2905,三商,27,0,27,凱基-永和,2023-10-25,9207
6182,合晶,21,0,21,凱基-永和,2023-10-25,9207
00632R,元大台灣50反1,30,10,20,凱基-永和,2023-10-25,9207
3481,群創,13,1,12,凱基-永和,2023-10-25,9207
2881,富邦金,12,2,10,凱基-永和,2023-10-25,9207
1608,華榮,10,0,10,凱基-永和,2023-10-25,9207
2204,中華,10,0,10,凱基-永和,2023-10-25,9207
2331,精英,10,0,10,凱基-永和,2023-10-25,9207
2338,光罩,10,0,10,凱基-永和,2023-10-25,9207
8044,網家,12,2,10,凱基-永和,2023-10-25,9207
1522,堤維西,15,6,9,凱基-永和,2023-10-25,9207
2462,良得電,20,11,9,凱基-永和,2023-10-25,9207
2337,旺宏,9,1,8,凱基-永和,2023-10-25,9207
1799,易威,7,0,7,凱基-永和,2023-10-25,9207
3006,晶豪科,6,0,6,凱基-永和,2023-10-25,9207
4933,友輝,6,0,6,凱基-永和,2023-10-25,9207
3231,緯創,63,58,5,凱基-永和,2023-10-25,9207
1101,台泥,5,0,5,凱基-永和,2023-10-25,9207
1536,和大,5,0,5,凱基-永和,2023-10-25,9207
2329,華泰,5,0,5,凱基-永和,2023-10-25,9207
2417,圓剛,5,0,5,凱基-永和,2023-10-25,9207
2441,超豐,5,0,5,凱基-永和,2023-10-25,9207
3051,力特,5,0,5,凱基-永和,2023-10-25,9207
3454,晶睿,5,0,5,凱基-永和,2023-10-25,9207
3576,聯合再生,5,0,5,凱基-永和,2023-10-25,9207
6288,聯嘉,5,0,5,凱基-永和,2023-10-25,9207
6741,91APP*-KY,5,0,5,凱基-永和,2023-10-25,9207
2884,玉山金,4,0,4,凱基-永和,2023-10-25,9207
2303,聯電,16,12,4,凱基-永和,2023-10-25,9207
00902,中信電池及儲能,4,0,4,凱基-永和,2023-10-25,9207
00712,復華富時不動產,4,0,4,凱基-永和,2023-10-25,9207
2388,威盛,241,237,4,凱基-永和,2023-10-25,9207
2485,兆赫,4,0,4,凱基-永和,2023-10-25,9207
3380,明泰,4,0,4,凱基-永和,2023-10-25,9207
4552,力達-KY,4,0,4,凱基-永和,2023-10-25,9207
3260,威剛,8,4,4,凱基-永和,2023-10-25,9207
2892,第一金,3,0,3,凱基-永和,2023-10-25,9207
8150,南茂,5,2,3,凱基-永和,2023-10-25,9207
00715L,期街口布蘭特正2,3,0,3,凱基-永和,2023-10-25,9207
00687B,國泰20年美債,3,0,3,凱基-永和,2023-10-25,9207
0061,元大寶滬深,3,0,3,凱基-永和,2023-10-25,9207
00795B,中信美國公債20年,277,0,277,凱基-永和,2023-10-26,9207
00752,中信中國50,97,0,97,凱基-永和,2023-10-26,9207
00885,富邦越南,81,0,81,凱基-永和,2023-10-26,9207
00687B,國泰20年美債,75,0,75,凱基-永和,2023-10-26,9207
2883,凱基金,73,0,73,凱基-永和,2023-10-26,9207
00772B,中信高評級公司債,70,0,70,凱基-永和,2023-10-26,9207
00761B,國泰A級公司債,61,0,61,凱基-永和,2023-10-26,9207
00929,復華台灣科技優息,64,5,59,凱基-永和,2023-10-26,9207
00740B,富邦全球投等債,56,0,56,凱基-永和,2023-10-26,9207
0056,元大高股息,62,14,48,凱基-永和,2023-10-26,9207
2337,旺宏,33,0,33,凱基-永和,2023-10-26,9207
2885,元大金,30,0,30,凱基-永和,2023-10-26,9207
2317,鴻海,35,5,30,凱基-永和,2023-10-26,9207
6442,光聖,142,114,28,凱基-永和,2023-10-26,9207
0050,元大台灣50,27,0,27,凱基-永和,2023-10-26,9207
00922,國泰台灣領袖50,26,0,26,凱基-永和,2023-10-26,9207
1568,倉佑,26,0,26,凱基-永和,2023-10-26,9207
2303,聯電,36,11,25,凱基-永和,2023-10-26,9207
00878,國泰永續高股息,28,3,25,凱基-永和,2023-10-26,9207
2884,玉山金,22,0,22,凱基-永和,2023-10-26,9207
2344,華邦電,19,0,19,凱基-永和,2023-10-26,9207
00931B,統一美債20年,15,0,15,凱基-永和,2023-10-26,9207
2377,微星,17,2,15,凱基-永和,2023-10-26,9207
00679B,元大美債20年,294,284,10,凱基-永和,2023-10-26,9207
00720B,元大投資級公司債,10,0,10,凱基-永和,2023-10-26,9207
2323,中環,10,0,10,凱基-永和,2023-10-26,9207
2458,義隆,10,0,10,凱基-永和,2023-10-26,9207
6179,亞通,10,0,10,凱基-永和,2023-10-26,9207
8210,勤誠,12,2,10,凱基-永和,2023-10-26,9207
1471,首利,11,2,9,凱基-永和,2023-10-26,9207
2905,三商,9,0,9,凱基-永和,2023-10-26,9207
2330,台積電,9,0,9,凱基-永和,2023-10-26,9207
00773B,中信優先金融債,8,0,8,凱基-永和,2023-10-26,9207
2449,京元電子,8,0,8,凱基-永和,2023-10-26,9207
2486,一詮,13,5,8,凱基-永和,2023-10-26,9207
3260,威剛,8,0,8,凱基-永和,2023-10-26,9207
1721,三晃,50,43,7,凱基-永和,2023-10-26,9207
5215,科嘉-KY,7,0,7,凱基-永和,2023-10-26,9207
6143,振曜,12,5,7,凱基-永和,2023-10-26,9207
3105,穩懋,7,0,7,凱基-永和,2023-10-26,9207
00919,群益台灣精選高息,8,2,6,凱基-永和,2023-10-26,9207
2485,兆赫,7,1,6,凱基-永和,2023-10-26,9207
4968,立積,6,0,6,凱基-永和,2023-10-26,9207
6216,居易,7,1,6,凱基-永和,2023-10-26,9207
2201,裕隆,5,0,5,凱基-永和,2023-10-26,9207
2002,中鋼,10,5,5,凱基-永和,2023-10-26,9207
1303,南亞,5,0,5,凱基-永和,2023-10-26,9207
00902,中信電池及儲能,5,0,5,凱基-永和,2023-10-26,9207
2351,順德,5,0,5,凱基-永和,2023-10-26,9207
2441,超豐,5,0,5,凱基-永和,2023-10-26,9207
6117,迎廣,75,2,73,凱基-永和,2023-10-27,9207
3715,定穎投控,54,4,50,凱基-永和,2023-10-27,9207
6443,元晶,50,3,47,凱基-永和,2023-10-27,9207
00933B,國泰10Y+金融債,60,20,40,凱基-永和,2023-10-27,9207
2706,第一店,25,0,25,凱基-永和,2023-10-27,9207
00757,統一FANG+,26,1,25,凱基-永和,2023-10-27,9207
2618,長榮航,21,0,21,凱基-永和,2023-10-27,9207
2515,中工,20,0,20,凱基-永和,2023-10-27,9207
00929,復華台灣科技優息,17,0,17,凱基-永和,2023-10-27,9207
00720B,元大投資級公司債,12,0,12,凱基-永和,2023-10-27,9207
00885,富邦越南,11,0,11,凱基-永和,2023-10-27,9207
2408,南亞科,11,0,11,凱基-永和,2023-10-27,9207
00712,復華富時不動產,10,0,10,凱基-永和,2023-10-27,9207
00683L,期元大美元指正2,10,0,10,凱基-永和,2023-10-27,9207
00882,中信中國高股息,10,0,10,凱基-永和,2023-10-27,9207
2344,華邦電,10,0,10,凱基-永和,2023-10-27,9207
2365,昆盈,10,0,10,凱基-永和,2023-10-27,9207
6472,保瑞,10,0,10,凱基-永和,2023-10-27,9207
00919,群益台灣精選高息,11,1,10,凱基-永和,2023-10-27,9207
2351,順德,8,0,8,凱基-永和,2023-10-27,9207
3037,欣興,8,0,8,凱基-永和,2023-10-27,9207
3264,欣銓,10,2,8,凱基-永和,2023-10-27,9207
2317,鴻海,9,2,7,凱基-永和,2023-10-27,9207
2303,聯電,7,0,7,凱基-永和,2023-10-27,9207
1762,中化生,7,0,7,凱基-永和,2023-10-27,9207
4911,德英,7,0,7,凱基-永和,2023-10-27,9207
2603,長榮,9,2,7,凱基-永和,2023-10-27,9207
00752,中信中國50,10,4,6,凱基-永和,2023-10-27,9207
8277,商丞,6,0,6,凱基-永和,2023-10-27,9207
0056,元大高股息,7,2,5,凱基-永和,2023-10-27,9207
4543,萬在,5,0,5,凱基-永和,2023-10-27,9207
4743,合一,6,1,5,凱基-永和,2023-10-27,9207
2002,中鋼,4,0,4,凱基-永和,2023-10-27,9207
00642U,期元大S＆P石油,4,0,4,凱基-永和,2023-10-27,9207
1721,三晃,4,0,4,凱基-永和,2023-10-27,9207
2324,仁寶,7,3,4,凱基-永和,2023-10-27,9207
2382,廣達,9,5,4,凱基-永和,2023-10-27,9207
2609,陽明,4,0,4,凱基-永和,2023-10-27,9207
3694,海華,4,0,4,凱基-永和,2023-10-27,9207
6158,禾昌,4,0,4,凱基-永和,2023-10-27,9207
6462,神盾,4,0,4,凱基-永和,2023-10-27,9207
00900,富邦特選高股息30,3,0,3,凱基-永和,2023-10-27,9207
1308,亞聚,3,0,3,凱基-永和,2023-10-27,9207
2356,英業達,3,0,3,凱基-永和,2023-10-27,9207
2436,偉詮電,3,0,3,凱基-永和,2023-10-27,9207
6139,亞翔,3,0,3,凱基-永和,2023-10-27,9207
6257,矽格,3,0,3,凱基-永和,2023-10-27,9207
6669,緯穎,3,0,3,凱基-永和,2023-10-27,9207
8240,華宏,4,1,3,凱基-永和,2023-10-27,9207
2454,聯發科,4,2,2,凱基-永和,2023-10-27,9207
2344,華邦電,100,0,100,凱基-永和,2023-10-30,9207
6235,華孚,100,1,99,凱基-永和,2023-10-30,9207
0050,元大台灣50,100,2,98,凱基-永和,2023-10-30,9207
4529,淳紳,66,0,66,凱基-永和,2023-10-30,9207
2883,凱基金,56,1,55,凱基-永和,2023-10-30,9207
2419,仲琦,50,0,50,凱基-永和,2023-10-30,9207
3176,基亞,50,0,50,凱基-永和,2023-10-30,9207
6531,愛普*,50,1,49,凱基-永和,2023-10-30,9207
00878,國泰永續高股息,49,1,48,凱基-永和,2023-10-30,9207
3105,穩懋,30,0,30,凱基-永和,2023-10-30,9207
5269,祥碩,30,0,30,凱基-永和,2023-10-30,9207
00687B,國泰20年美債,20,0,20,凱基-永和,2023-10-30,9207
6116,彩晶,20,0,20,凱基-永和,2023-10-30,9207
8040,九暘,26,7,19,凱基-永和,2023-10-30,9207
3171,炎洲流通,15,0,15,凱基-永和,2023-10-30,9207
2314,台揚,13,0,13,凱基-永和,2023-10-30,9207
00751B,元大AAA至A公司債,11,0,11,凱基-永和,2023-10-30,9207
5371,中光電,11,0,11,凱基-永和,2023-10-30,9207
1568,倉佑,10,0,10,凱基-永和,2023-10-30,9207
2603,長榮,10,0,10,凱基-永和,2023-10-30,9207
00929,復華台灣科技優息,10,1,9,凱基-永和,2023-10-30,9207
2303,聯電,8,0,8,凱基-永和,2023-10-30,9207
00922,國泰台灣領袖50,8,0,8,凱基-永和,2023-10-30,9207
00885,富邦越南,8,0,8,凱基-永和,2023-10-30,9207
2886,兆豐金,8,0,8,凱基-永和,2023-10-30,9207
4908,前鼎,27,21,6,凱基-永和,2023-10-30,9207
1513,中興電,8,3,5,凱基-永和,2023-10-30,9207
00933B,國泰10Y+金融債,5,0,5,凱基-永和,2023-10-30,9207
2645,長榮航太,5,0,5,凱基-永和,2023-10-30,9207
3454,晶睿,5,0,5,凱基-永和,2023-10-30,9207
00720B,元大投資級公司債,5,0,5,凱基-永和,2023-10-30,9207
2610,華航,4,0,4,凱基-永和,2023-10-30,9207
6279,胡連,4,0,4,凱基-永和,2023-10-30,9207
8054,安國,147,143,4,凱基-永和,2023-10-30,9207
006208,富邦台50,3,0,3,凱基-永和,2023-10-30,9207
1303,南亞,3,0,3,凱基-永和,2023-10-30,9207
5876,上海商銀,3,0,3,凱基-永和,2023-10-30,9207
2887,台新金,13,10,3,凱基-永和,2023-10-30,9207
2888,新光金,3,0,3,凱基-永和,2023-10-30,9207
00665L,富邦�琤肭磪囓�2,3,0,3,凱基-永和,2023-10-30,9207
00712,復華富時不動產,3,0,3,凱基-永和,2023-10-30,9207
00900,富邦特選高股息30,3,0,3,凱基-永和,2023-10-30,9207
2349,錸德,3,0,3,凱基-永和,2023-10-30,9207
2889,國票金,3,0,3,凱基-永和,2023-10-30,9207
2905,三商,3,0,3,凱基-永和,2023-10-30,9207
3217,優群,3,0,3,凱基-永和,2023-10-30,9207
3265,台星科,3,0,3,凱基-永和,2023-10-30,9207
5880,合庫金,3,0,3,凱基-永和,2023-10-30,9207
6188,廣明,3,0,3,凱基-永和,2023-10-30,9207
6290,良維,3,0,3,凱基-永和,2023-10-30,9207
0056,元大高股息,48,0,48,凱基-永和,2023-10-31,9207
6276,安鈦克,30,0,30,凱基-永和,2023-10-31,9207
00720B,元大投資級公司債,26,0,26,凱基-永和,2023-10-31,9207
00878,國泰永續高股息,67,42,25,凱基-永和,2023-10-31,9207
4906,正文,21,0,21,凱基-永和,2023-10-31,9207
2390,云辰,20,0,20,凱基-永和,2023-10-31,9207
00929,復華台灣科技優息,18,1,17,凱基-永和,2023-10-31,9207
00919,群益台灣精選高息,17,0,17,凱基-永和,2023-10-31,9207
006208,富邦台50,17,1,16,凱基-永和,2023-10-31,9207
2324,仁寶,13,0,13,凱基-永和,2023-10-31,9207
2369,菱生,10,0,10,凱基-永和,2023-10-31,9207
3051,力特,10,0,10,凱基-永和,2023-10-31,9207
3548,兆利,20,11,9,凱基-永和,2023-10-31,9207
3576,聯合再生,13,4,9,凱基-永和,2023-10-31,9207
2382,廣達,40,32,8,凱基-永和,2023-10-31,9207
00922,國泰台灣領袖50,8,0,8,凱基-永和,2023-10-31,9207
00885,富邦越南,8,0,8,凱基-永和,2023-10-31,9207
8930,青鋼,8,0,8,凱基-永和,2023-10-31,9207
2436,偉詮電,7,0,7,凱基-永和,2023-10-31,9207
3583,辛耘,6,0,6,凱基-永和,2023-10-31,9207
00679B,元大美債20年,6,0,6,凱基-永和,2023-10-31,9207
2313,華通,7,1,6,凱基-永和,2023-10-31,9207
9905,大華,6,0,6,凱基-永和,2023-10-31,9207
00687B,國泰20年美債,5,0,5,凱基-永和,2023-10-31,9207
00712,復華富時不動產,5,0,5,凱基-永和,2023-10-31,9207
00738U,期元大道瓊白銀,5,0,5,凱基-永和,2023-10-31,9207
2025,千興,5,0,5,凱基-永和,2023-10-31,9207
2329,華泰,7,2,5,凱基-永和,2023-10-31,9207
2354,鴻準,5,0,5,凱基-永和,2023-10-31,9207
2387,精元,5,0,5,凱基-永和,2023-10-31,9207
2618,長榮航,8,3,5,凱基-永和,2023-10-31,9207
2706,第一店,5,0,5,凱基-永和,2023-10-31,9207
2816,旺旺保,5,0,5,凱基-永和,2023-10-31,9207
2905,三商,6,1,5,凱基-永和,2023-10-31,9207
3013,晟銘電,6,1,5,凱基-永和,2023-10-31,9207
3078,僑威,5,0,5,凱基-永和,2023-10-31,9207
3379,彬台,5,0,5,凱基-永和,2023-10-31,9207
3715,定穎投控,65,60,5,凱基-永和,2023-10-31,9207
6109,亞元,5,0,5,凱基-永和,2023-10-31,9207
9938,百和,5,0,5,凱基-永和,2023-10-31,9207
0050,元大台灣50,5,0,5,凱基-永和,2023-10-31,9207
00713,元大台灣高息低波,4,0,4,凱基-永和,2023-10-31,9207
1522,堤維西,5,1,4,凱基-永和,2023-10-31,9207
3035,智原,15,11,4,凱基-永和,2023-10-31,9207
2603,長榮,6,2,4,凱基-永和,2023-10-31,9207
1609,大亞,5,1,4,凱基-永和,2023-10-31,9207
2337,旺宏,4,0,4,凱基-永和,2023-10-31,9207
2458,義隆,4,0,4,凱基-永和,2023-10-31,9207
2645,長榮航太,4,0,4,凱基-永和,2023-10-31,9207
2915,潤泰全,4,0,4,凱基-永和,2023-10-31,9207
3715,定穎投控,115,14,101,凱基-永和,2023-11-01,9207
8183,精星,77,0,77,凱基-永和,2023-11-01,9207
00934,中信成長高股息,67,1,66,凱基-永和,2023-11-01,9207
2543,皇昌,52,0,52,凱基-永和,2023-11-01,9207
8054,安國,52,0,52,凱基-永和,2023-11-01,9207
00929,復華台灣科技優息,37,1,36,凱基-永和,2023-11-01,9207
2883,凱基金,41,10,31,凱基-永和,2023-11-01,9207
6109,亞元,25,0,25,凱基-永和,2023-11-01,9207
3105,穩懋,23,1,22,凱基-永和,2023-11-01,9207
6274,台燿,20,0,20,凱基-永和,2023-11-01,9207
00878,國泰永續高股息,22,3,19,凱基-永和,2023-11-01,9207
8227,巨有科技,17,1,16,凱基-永和,2023-11-01,9207
3044,健鼎,15,0,15,凱基-永和,2023-11-01,9207
3260,威剛,16,1,15,凱基-永和,2023-11-01,9207
00679B,元大美債20年,14,0,14,凱基-永和,2023-11-01,9207
2002,中鋼,14,0,14,凱基-永和,2023-11-01,9207
2867,三商壽,14,0,14,凱基-永和,2023-11-01,9207
8210,勤誠,12,0,12,凱基-永和,2023-11-01,9207
00751B,元大AAA至A公司債,12,1,11,凱基-永和,2023-11-01,9207
2353,宏��,11,0,11,凱基-永和,2023-11-01,9207
2376,技嘉,11,0,11,凱基-永和,2023-11-01,9207
3706,神達,11,0,11,凱基-永和,2023-11-01,9207
5272,笙科,11,0,11,凱基-永和,2023-11-01,9207
00922,國泰台灣領袖50,11,0,11,凱基-永和,2023-11-01,9207
2382,廣達,15,5,10,凱基-永和,2023-11-01,9207
00664R,國泰臺灣加權反1,10,0,10,凱基-永和,2023-11-01,9207
2412,中華電,10,0,10,凱基-永和,2023-11-01,9207
2515,中工,10,0,10,凱基-永和,2023-11-01,9207
4129,聯合,10,0,10,凱基-永和,2023-11-01,9207
2610,華航,11,2,9,凱基-永和,2023-11-01,9207
2323,中環,8,0,8,凱基-永和,2023-11-01,9207
9919,康那香,8,0,8,凱基-永和,2023-11-01,9207
6284,佳邦,16,8,8,凱基-永和,2023-11-01,9207
2211,長榮鋼,9,3,6,凱基-永和,2023-11-01,9207
2884,玉山金,6,0,6,凱基-永和,2023-11-01,9207
4128,中天,6,0,6,凱基-永和,2023-11-01,9207
8110,華東,6,0,6,凱基-永和,2023-11-01,9207
8916,光隆,6,0,6,凱基-永和,2023-11-01,9207
2427,三商電,5,0,5,凱基-永和,2023-11-01,9207
2889,國票金,5,0,5,凱基-永和,2023-11-01,9207
3325,旭品,5,0,5,凱基-永和,2023-11-01,9207
3372,典範,5,0,5,凱基-永和,2023-11-01,9207
4306,炎洲,5,0,5,凱基-永和,2023-11-01,9207
5309,系統電,5,0,5,凱基-永和,2023-11-01,9207
6443,元晶,5,0,5,凱基-永和,2023-11-01,9207
00885,富邦越南,5,0,5,凱基-永和,2023-11-01,9207
00753L,中信中國50正2,4,0,4,凱基-永和,2023-11-01,9207
00642U,期元大S＆P石油,4,0,4,凱基-永和,2023-11-01,9207
2014,中鴻,4,0,4,凱基-永和,2023-11-01,9207
2356,英業達,5,1,4,凱基-永和,2023-11-01,9207
2883,凱基金,61,0,61,凱基-永和,2023-11-02,9207
00632R,元大台灣50反1,50,0,50,凱基-永和,2023-11-02,9207
1722,台肥,50,0,50,凱基-永和,2023-11-02,9207
00881,國泰台灣5G+,49,0,49,凱基-永和,2023-11-02,9207
2465,麗臺,50,2,48,凱基-永和,2023-11-02,9207
6285,啟��,51,3,48,凱基-永和,2023-11-02,9207
6139,亞翔,45,0,45,凱基-永和,2023-11-02,9207
3661,世芯-KY,30,0,30,凱基-永和,2023-11-02,9207
2610,華航,24,2,22,凱基-永和,2023-11-02,9207
9958,世紀鋼,20,0,20,凱基-永和,2023-11-02,9207
4923,力士,19,0,19,凱基-永和,2023-11-02,9207
2618,長榮航,26,8,18,凱基-永和,2023-11-02,9207
3035,智原,16,2,14,凱基-永和,2023-11-02,9207
2385,群光,10,0,10,凱基-永和,2023-11-02,9207
2390,云辰,10,0,10,凱基-永和,2023-11-02,9207
3481,群創,10,0,10,凱基-永和,2023-11-02,9207
2376,技嘉,10,2,8,凱基-永和,2023-11-02,9207
3702,大聯大,24,18,6,凱基-永和,2023-11-02,9207
8110,華東,6,0,6,凱基-永和,2023-11-02,9207
00905,FT臺灣Smart,5,0,5,凱基-永和,2023-11-02,9207
00671R,富邦NASDAQ反1,5,0,5,凱基-永和,2023-11-02,9207
2883B,凱基金乙特,5,0,5,凱基-永和,2023-11-02,9207
3163,波若威,6,1,5,凱基-永和,2023-11-02,9207
4129,聯合,5,0,5,凱基-永和,2023-11-02,9207
6189,豐藝,5,0,5,凱基-永和,2023-11-02,9207
3380,明泰,4,0,4,凱基-永和,2023-11-02,9207
3523,迎輝,4,0,4,凱基-永和,2023-11-02,9207
4532,瑞智,4,0,4,凱基-永和,2023-11-02,9207
00720B,元大投資級公司債,3,0,3,凱基-永和,2023-11-02,9207
2409,友達,3,0,3,凱基-永和,2023-11-02,9207
6668,中揚光,3,0,3,凱基-永和,2023-11-02,9207
2363,矽統,11,8,3,凱基-永和,2023-11-02,9207
00757,統一FANG+,4,1,3,凱基-永和,2023-11-02,9207
3704,合勤控,9,7,2,凱基-永和,2023-11-02,9207
2457,飛宏,2,0,2,凱基-永和,2023-11-02,9207
00642U,期元大S＆P石油,2,0,2,凱基-永和,2023-11-02,9207
2211,長榮鋼,2,0,2,凱基-永和,2023-11-02,9207
2425,承啟,2,0,2,凱基-永和,2023-11-02,9207
2486,一詮,3,1,2,凱基-永和,2023-11-02,9207
3044,健鼎,3,1,2,凱基-永和,2023-11-02,9207
3489,森寶,2,0,2,凱基-永和,2023-11-02,9207
3491,昇達科,2,0,2,凱基-永和,2023-11-02,9207
3714,富采,2,0,2,凱基-永和,2023-11-02,9207
4105,東洋,2,0,2,凱基-永和,2023-11-02,9207
4108,懷特,2,0,2,凱基-永和,2023-11-02,9207
4167,松瑞藥,2,0,2,凱基-永和,2023-11-02,9207
4426,利勤,2,0,2,凱基-永和,2023-11-02,9207
4739,康普,2,0,2,凱基-永和,2023-11-02,9207
4908,前鼎,5,3,2,凱基-永和,2023-11-02,9207
4915,致伸,2,0,2,凱基-永和,2023-11-02,9207
00929,復華台灣科技優息,127,6,121,凱基-永和,2023-11-03,9207
2303,聯電,87,23,64,凱基-永和,2023-11-03,9207
00881,國泰台灣5G+,41,0,41,凱基-永和,2023-11-03,9207
2363,矽統,1166,1130,36,凱基-永和,2023-11-03,9207
6112,邁達特,107,75,32,凱基-永和,2023-11-03,9207
2353,宏��,30,0,30,凱基-永和,2023-11-03,9207
2809,京城銀,30,0,30,凱基-永和,2023-11-03,9207
00934,中信成長高股息,29,0,29,凱基-永和,2023-11-03,9207
6243,迅杰,28,0,28,凱基-永和,2023-11-03,9207
2358,廷鑫,23,1,22,凱基-永和,2023-11-03,9207
2317,鴻海,18,1,17,凱基-永和,2023-11-03,9207
00919,群益台灣精選高息,16,0,16,凱基-永和,2023-11-03,9207
2382,廣達,28,16,12,凱基-永和,2023-11-03,9207
2834,臺企銀,20,8,12,凱基-永和,2023-11-03,9207
3702,大聯大,19,8,11,凱基-永和,2023-11-03,9207
2344,華邦電,11,0,11,凱基-永和,2023-11-03,9207
0056,元大高股息,13,3,10,凱基-永和,2023-11-03,9207
00712,復華富時不動產,10,0,10,凱基-永和,2023-11-03,9207
2316,楠梓電,10,0,10,凱基-永和,2023-11-03,9207
2601,益航,10,0,10,凱基-永和,2023-11-03,9207
3025,星通,10,0,10,凱基-永和,2023-11-03,9207
9904,寶成,10,0,10,凱基-永和,2023-11-03,9207
9958,世紀鋼,10,0,10,凱基-永和,2023-11-03,9207
3213,茂訊,11,1,10,凱基-永和,2023-11-03,9207
2376,技嘉,29,21,8,凱基-永和,2023-11-03,9207
2323,中環,10,2,8,凱基-永和,2023-11-03,9207
4105,東洋,7,0,7,凱基-永和,2023-11-03,9207
2458,義隆,8,2,6,凱基-永和,2023-11-03,9207
4128,中天,6,0,6,凱基-永和,2023-11-03,9207
2367,燿華,6,0,6,凱基-永和,2023-11-03,9207
1316,上曜,5,0,5,凱基-永和,2023-11-03,9207
00857B,永豐20年美公債,5,0,5,凱基-永和,2023-11-03,9207
2329,華泰,211,206,5,凱基-永和,2023-11-03,9207
2516,新建,5,0,5,凱基-永和,2023-11-03,9207
3078,僑威,6,1,5,凱基-永和,2023-11-03,9207
4129,聯合,5,0,5,凱基-永和,2023-11-03,9207
6288,聯嘉,5,0,5,凱基-永和,2023-11-03,9207
6432,今展科,5,0,5,凱基-永和,2023-11-03,9207
8277,商丞,5,0,5,凱基-永和,2023-11-03,9207
2610,華航,22,17,5,凱基-永和,2023-11-03,9207
3122,笙泉,5,1,4,凱基-永和,2023-11-03,9207
3617,碩天,4,0,4,凱基-永和,2023-11-03,9207
00640L,富邦日本正2,3,0,3,凱基-永和,2023-11-03,9207
00631L,元大台灣50正2,4,1,3,凱基-永和,2023-11-03,9207
00751B,元大AAA至A公司債,5,2,3,凱基-永和,2023-11-03,9207
3706,神達,3,0,3,凱基-永和,2023-11-03,9207
4766,南寶,3,0,3,凱基-永和,2023-11-03,9207
5340,建榮,4,1,3,凱基-永和,2023-11-03,9207
5386,青雲,3,0,3,凱基-永和,2023-11-03,9207
00893,國泰智能電動車,2,0,2,凱基-永和,2023-11-03,9207
3034,聯詠,151,0,151,凱基-永和,2023-11-06,9207
2344,華邦電,140,11,129,凱基-永和,2023-11-06,9207
2618,長榮航,122,1,121,凱基-永和,2023-11-06,9207
2453,凌群,123,3,120,凱基-永和,2023-11-06,9207
2363,矽統,169,74,95,凱基-永和,2023-11-06,9207
6117,迎廣,101,26,75,凱基-永和,2023-11-06,9207
2401,凌陽,143,77,66,凱基-永和,2023-11-06,9207
3036,文曄,185,133,52,凱基-永和,2023-11-06,9207
00680L,元大美債20正2,51,0,51,凱基-永和,2023-11-06,9207
00881,國泰台灣5G+,41,2,39,凱基-永和,2023-11-06,9207
2421,建準,46,7,39,凱基-永和,2023-11-06,9207
00878,國泰永續高股息,26,0,26,凱基-永和,2023-11-06,9207
3702,大聯大,35,13,22,凱基-永和,2023-11-06,9207
3548,兆利,21,1,20,凱基-永和,2023-11-06,9207
4162,智擎,20,0,20,凱基-永和,2023-11-06,9207
6770,力積電,203,186,17,凱基-永和,2023-11-06,9207
3508,位速,12,0,12,凱基-永和,2023-11-06,9207
3060,銘異,11,0,11,凱基-永和,2023-11-06,9207
2913,農林,10,0,10,凱基-永和,2023-11-06,9207
1611,中電,10,0,10,凱基-永和,2023-11-06,9207
1714,和桐,10,0,10,凱基-永和,2023-11-06,9207
1809,中釉,10,0,10,凱基-永和,2023-11-06,9207
4533,協易機,10,0,10,凱基-永和,2023-11-06,9207
5347,世界,10,0,10,凱基-永和,2023-11-06,9207
6213,聯茂,10,0,10,凱基-永和,2023-11-06,9207
1721,三晃,61,52,9,凱基-永和,2023-11-06,9207
2515,中工,9,0,9,凱基-永和,2023-11-06,9207
6732,昇佳電子,9,0,9,凱基-永和,2023-11-06,9207
00655L,國泰中國A50正2,8,0,8,凱基-永和,2023-11-06,9207
00919,群益台灣精選高息,7,0,7,凱基-永和,2023-11-06,9207
2891,中信金,7,1,6,凱基-永和,2023-11-06,9207
1785,光洋科,9,3,6,凱基-永和,2023-11-06,9207
4958,臻鼎-KY,6,0,6,凱基-永和,2023-11-06,9207
2367,燿華,7,2,5,凱基-永和,2023-11-06,9207
8016,矽創,5,0,5,凱基-永和,2023-11-06,9207
8034,榮群,5,0,5,凱基-永和,2023-11-06,9207
3231,緯創,5,0,5,凱基-永和,2023-11-06,9207
0056,元大高股息,15,11,4,凱基-永和,2023-11-06,9207
1301,台塑,4,0,4,凱基-永和,2023-11-06,9207
00923,群益台ESG低碳50,4,0,4,凱基-永和,2023-11-06,9207
2376,技嘉,6,2,4,凱基-永和,2023-11-06,9207
1101,台泥,3,0,3,凱基-永和,2023-11-06,9207
00885,富邦越南,3,0,3,凱基-永和,2023-11-06,9207
1905,華紙,3,0,3,凱基-永和,2023-11-06,9207
2365,昆盈,3,0,3,凱基-永和,2023-11-06,9207
2419,仲琦,3,0,3,凱基-永和,2023-11-06,9207
2634,漢翔,4,1,3,凱基-永和,2023-11-06,9207
2851,中再保,3,0,3,凱基-永和,2023-11-06,9207
3122,笙泉,3,0,3,凱基-永和,2023-11-06,9207
3489,森寶,3,0,3,凱基-永和,2023-11-06,9207
00687B,國泰20年美債,101,0,101,凱基-永和,2023-11-07,9207
1524,耿鼎,74,5,69,凱基-永和,2023-11-07,9207
4188,安克,66,1,65,凱基-永和,2023-11-07,9207
3006,晶豪科,54,0,54,凱基-永和,2023-11-07,9207
00929,復華台灣科技優息,43,0,43,凱基-永和,2023-11-07,9207
00680L,元大美債20正2,35,0,35,凱基-永和,2023-11-07,9207
5521,工信,30,0,30,凱基-永和,2023-11-07,9207
2618,長榮航,32,3,29,凱基-永和,2023-11-07,9207
2409,友達,23,0,23,凱基-永和,2023-11-07,9207
1472,三洋實業,20,0,20,凱基-永和,2023-11-07,9207
4439,冠星-KY,20,0,20,凱基-永和,2023-11-07,9207
3338,泰碩,20,1,19,凱基-永和,2023-11-07,9207
6625,必應,20,2,18,凱基-永和,2023-11-07,9207
2610,華航,18,0,18,凱基-永和,2023-11-07,9207
00878,國泰永續高股息,15,0,15,凱基-永和,2023-11-07,9207
3060,銘異,14,0,14,凱基-永和,2023-11-07,9207
00923,群益台ESG低碳50,12,0,12,凱基-永和,2023-11-07,9207
2891,中信金,12,0,12,凱基-永和,2023-11-07,9207
3704,合勤控,19,8,11,凱基-永和,2023-11-07,9207
2002,中鋼,11,0,11,凱基-永和,2023-11-07,9207
6509,聚和,11,0,11,凱基-永和,2023-11-07,9207
2634,漢翔,9,0,9,凱基-永和,2023-11-07,9207
00934,中信成長高股息,9,0,9,凱基-永和,2023-11-07,9207
8110,華東,10,1,9,凱基-永和,2023-11-07,9207
1608,華榮,8,0,8,凱基-永和,2023-11-07,9207
3022,威強電,8,1,7,凱基-永和,2023-11-07,9207
2454,聯發科,7,1,6,凱基-永和,2023-11-07,9207
2324,仁寶,6,0,6,凱基-永和,2023-11-07,9207
3105,穩懋,5,0,5,凱基-永和,2023-11-07,9207
3211,順達,5,0,5,凱基-永和,2023-11-07,9207
4167,松瑞藥,14,9,5,凱基-永和,2023-11-07,9207
4533,協易機,5,0,5,凱基-永和,2023-11-07,9207
6269,台郡,5,0,5,凱基-永和,2023-11-07,9207
6292,迅德,5,0,5,凱基-永和,2023-11-07,9207
8299,群聯,5,0,5,凱基-永和,2023-11-07,9207
2313,華通,5,1,4,凱基-永和,2023-11-07,9207
0056,元大高股息,8,4,4,凱基-永和,2023-11-07,9207
00712,復華富時不動產,4,0,4,凱基-永和,2023-11-07,9207
00631L,元大台灣50正2,4,0,4,凱基-永和,2023-11-07,9207
3058,立德,4,0,4,凱基-永和,2023-11-07,9207
3167,大量,4,0,4,凱基-永和,2023-11-07,9207
6005,群益證,4,0,4,凱基-永和,2023-11-07,9207
6182,合晶,4,0,4,凱基-永和,2023-11-07,9207
6285,啟��,4,1,3,凱基-永和,2023-11-07,9207
1760,寶齡富錦,3,0,3,凱基-永和,2023-11-07,9207
2408,南亞科,4,1,3,凱基-永和,2023-11-07,9207
2484,希華,3,0,3,凱基-永和,2023-11-07,9207
2851,中再保,3,0,3,凱基-永和,2023-11-07,9207
3623,富晶通,5,2,3,凱基-永和,2023-11-07,9207
6188,廣明,3,0,3,凱基-永和,2023-11-07,9207
3231,緯創,1430,412,1018,凱基-永和,2023-11-08,9207
2329,華泰,155,32,123,凱基-永和,2023-11-08,9207
3324,雙鴻,103,0,103,凱基-永和,2023-11-08,9207
1324,地球,200,100,100,凱基-永和,2023-11-08,9207
3227,原相,102,4,98,凱基-永和,2023-11-08,9207
3013,晟銘電,51,3,48,凱基-永和,2023-11-08,9207
2610,華航,73,33,40,凱基-永和,2023-11-08,9207
2401,凌陽,38,0,38,凱基-永和,2023-11-08,9207
00936,台新永續高息中小,39,2,37,凱基-永和,2023-11-08,9207
4979,華星光,37,0,37,凱基-永和,2023-11-08,9207
6274,台燿,30,0,30,凱基-永和,2023-11-08,9207
1515,力山,25,0,25,凱基-永和,2023-11-08,9207
3491,昇達科,22,0,22,凱基-永和,2023-11-08,9207
6244,茂迪,20,0,20,凱基-永和,2023-11-08,9207
2002,中鋼,15,0,15,凱基-永和,2023-11-08,9207
2233,宇隆,15,0,15,凱基-永和,2023-11-08,9207
5321,美而快,15,0,15,凱基-永和,2023-11-08,9207
1314,中石化,15,1,14,凱基-永和,2023-11-08,9207
00923,群益台ESG低碳50,12,1,11,凱基-永和,2023-11-08,9207
00720B,元大投資級公司債,10,0,10,凱基-永和,2023-11-08,9207
6585,鼎基,10,0,10,凱基-永和,2023-11-08,9207
00919,群益台灣精選高息,11,2,9,凱基-永和,2023-11-08,9207
3036,文曄,70,61,9,凱基-永和,2023-11-08,9207
4105,東洋,7,0,7,凱基-永和,2023-11-08,9207
5213,亞昕,7,0,7,凱基-永和,2023-11-08,9207
6869,雲豹能源,7,0,7,凱基-永和,2023-11-08,9207
8088,品安,7,0,7,凱基-永和,2023-11-08,9207
00715L,期街口布蘭特正2,6,0,6,凱基-永和,2023-11-08,9207
2337,旺宏,6,0,6,凱基-永和,2023-11-08,9207
6770,力積電,5,0,5,凱基-永和,2023-11-08,9207
1731,美吾華,5,0,5,凱基-永和,2023-11-08,9207
2855,統一證,5,0,5,凱基-永和,2023-11-08,9207
2454,聯發科,5,0,5,凱基-永和,2023-11-08,9207
2103,台橡,4,0,4,凱基-永和,2023-11-08,9207
2377,微星,4,0,4,凱基-永和,2023-11-08,9207
2484,希華,6,2,4,凱基-永和,2023-11-08,9207
3322,建舜電,5,1,4,凱基-永和,2023-11-08,9207
1609,大亞,3,0,3,凱基-永和,2023-11-08,9207
2382,廣達,20,17,3,凱基-永和,2023-11-08,9207
00885,富邦越南,3,0,3,凱基-永和,2023-11-08,9207
1605,華新,3,0,3,凱基-永和,2023-11-08,9207
2451,創見,3,0,3,凱基-永和,2023-11-08,9207
2739,寒舍,5,2,3,凱基-永和,2023-11-08,9207
2748,雲品,3,0,3,凱基-永和,2023-11-08,9207
3221,台嘉碩,6,3,3,凱基-永和,2023-11-08,9207
4167,松瑞藥,3,0,3,凱基-永和,2023-11-08,9207
4207,環泰,3,0,3,凱基-永和,2023-11-08,9207
4532,瑞智,3,0,3,凱基-永和,2023-11-08,9207
5347,世界,13,10,3,凱基-永和,2023-11-08,9207
8054,安國,3,0,3,凱基-永和,2023-11-08,9207
3227,原相,101,1,100,凱基-永和,2023-11-09,9207
2376,技嘉,109,15,94,凱基-永和,2023-11-09,9207
2352,佳世達,95,3,92,凱基-永和,2023-11-09,9207
5386,青雲,75,5,70,凱基-永和,2023-11-09,9207
2816,旺旺保,50,0,50,凱基-永和,2023-11-09,9207
6122,擎邦,50,0,50,凱基-永和,2023-11-09,9207
2610,華航,62,21,41,凱基-永和,2023-11-09,9207
2206,三陽工業,30,0,30,凱基-永和,2023-11-09,9207
3266,昇陽,30,0,30,凱基-永和,2023-11-09,9207
3231,緯創,40,14,26,凱基-永和,2023-11-09,9207
6223,旺矽,26,0,26,凱基-永和,2023-11-09,9207
3260,威剛,78,53,25,凱基-永和,2023-11-09,9207
00878,國泰永續高股息,21,0,21,凱基-永和,2023-11-09,9207
3390,旭軟,20,0,20,凱基-永和,2023-11-09,9207
4533,協易機,21,2,19,凱基-永和,2023-11-09,9207
00936,台新永續高息中小,15,0,15,凱基-永和,2023-11-09,9207
00632R,元大台灣50反1,15,0,15,凱基-永和,2023-11-09,9207
5347,世界,15,0,15,凱基-永和,2023-11-09,9207
0056,元大高股息,17,3,14,凱基-永和,2023-11-09,9207
00923,群益台ESG低碳50,14,0,14,凱基-永和,2023-11-09,9207
00934,中信成長高股息,12,0,12,凱基-永和,2023-11-09,9207
6869,雲豹能源,12,0,12,凱基-永和,2023-11-09,9207
8930,青鋼,12,0,12,凱基-永和,2023-11-09,9207
00919,群益台灣精選高息,15,4,11,凱基-永和,2023-11-09,9207
3702,大聯大,9,0,9,凱基-永和,2023-11-09,9207
3228,金麗科,11,2,9,凱基-永和,2023-11-09,9207
1522,堤維西,13,5,8,凱基-永和,2023-11-09,9207
3105,穩懋,10,2,8,凱基-永和,2023-11-09,9207
8016,矽創,7,0,7,凱基-永和,2023-11-09,9207
1795,美時,6,0,6,凱基-永和,2023-11-09,9207
2316,楠梓電,6,0,6,凱基-永和,2023-11-09,9207
2337,旺宏,6,0,6,凱基-永和,2023-11-09,9207
8048,德勝,6,0,6,凱基-永和,2023-11-09,9207
2382,廣達,14,8,6,凱基-永和,2023-11-09,9207
8046,南電,5,0,5,凱基-永和,2023-11-09,9207
2025,千興,5,0,5,凱基-永和,2023-11-09,9207
2104,國際中橡,5,0,5,凱基-永和,2023-11-09,9207
2484,希華,5,0,5,凱基-永和,2023-11-09,9207
3013,晟銘電,6,1,5,凱基-永和,2023-11-09,9207
3083,網龍,5,0,5,凱基-永和,2023-11-09,9207
3689,湧德,5,0,5,凱基-永和,2023-11-09,9207
4961,天鈺,5,0,5,凱基-永和,2023-11-09,9207
5009,榮剛,5,0,5,凱基-永和,2023-11-09,9207
1477,聚陽,5,0,5,凱基-永和,2023-11-09,9207
6188,廣明,5,0,5,凱基-永和,2023-11-09,9207
3008,大立光,5,1,4,凱基-永和,2023-11-09,9207
00715L,期街口布蘭特正2,4,0,4,凱基-永和,2023-11-09,9207
00642U,期元大S＆P石油,4,0,4,凱基-永和,2023-11-09,9207
1720,生達,4,0,4,凱基-永和,2023-11-09,9207
2002,中鋼,8,4,4,凱基-永和,2023-11-09,9207
00878,國泰永續高股息,59,0,59,凱基-永和,2023-11-10,9207
00692,富邦公司治理,40,0,40,凱基-永和,2023-11-10,9207
3032,偉訓,41,1,40,凱基-永和,2023-11-10,9207
00936,台新永續高息中小,38,1,37,凱基-永和,2023-11-10,9207
00929,復華台灣科技優息,34,0,34,凱基-永和,2023-11-10,9207
2353,宏��,32,0,32,凱基-永和,2023-11-10,9207
2401,凌陽,31,1,30,凱基-永和,2023-11-10,9207
00885,富邦越南,21,0,21,凱基-永和,2023-11-10,9207
00919,群益台灣精選高息,20,0,20,凱基-永和,2023-11-10,9207
00680L,元大美債20正2,15,0,15,凱基-永和,2023-11-10,9207
2618,長榮航,15,0,15,凱基-永和,2023-11-10,9207
8076,伍豐,15,0,15,凱基-永和,2023-11-10,9207
1101,台泥,12,0,12,凱基-永和,2023-11-10,9207
00679B,元大美債20年,11,0,11,凱基-永和,2023-11-10,9207
3617,碩天,11,0,11,凱基-永和,2023-11-10,9207
00642U,期元大S＆P石油,10,0,10,凱基-永和,2023-11-10,9207
00891,中信關鍵半導體,10,0,10,凱基-永和,2023-11-10,9207
1618,合機,10,0,10,凱基-永和,2023-11-10,9207
3390,旭軟,10,0,10,凱基-永和,2023-11-10,9207
6276,安鈦克,10,0,10,凱基-永和,2023-11-10,9207
1522,堤維西,9,0,9,凱基-永和,2023-11-10,9207
2317,鴻海,19,10,9,凱基-永和,2023-11-10,9207
5457,宣德,9,0,9,凱基-永和,2023-11-10,9207
6869,雲豹能源,9,0,9,凱基-永和,2023-11-10,9207
8034,榮群,9,0,9,凱基-永和,2023-11-10,9207
6547,高端疫苗,8,0,8,凱基-永和,2023-11-10,9207
6901,鑽石投資,8,0,8,凱基-永和,2023-11-10,9207
2929,淘帝-KY,6,0,6,凱基-永和,2023-11-10,9207
4129,聯合,15,9,6,凱基-永和,2023-11-10,9207
2363,矽統,154,149,5,凱基-永和,2023-11-10,9207
2201,裕隆,5,0,5,凱基-永和,2023-11-10,9207
4128,中天,510,505,5,凱基-永和,2023-11-10,9207
00905,FT臺灣Smart,5,0,5,凱基-永和,2023-11-10,9207
2427,三商電,5,0,5,凱基-永和,2023-11-10,9207
2610,華航,5,0,5,凱基-永和,2023-11-10,9207
3094,聯傑,5,0,5,凱基-永和,2023-11-10,9207
5009,榮剛,5,0,5,凱基-永和,2023-11-10,9207
8086,宏捷科,10,5,5,凱基-永和,2023-11-10,9207
0056,元大高股息,4,0,4,凱基-永和,2023-11-10,9207
2609,陽明,4,0,4,凱基-永和,2023-11-10,9207
00915,凱基優選高股息30,4,0,4,凱基-永和,2023-11-10,9207
2025,千興,4,0,4,凱基-永和,2023-11-10,9207
2344,華邦電,4,0,4,凱基-永和,2023-11-10,9207
2885,元大金,4,0,4,凱基-永和,2023-11-10,9207
6712,長聖,4,0,4,凱基-永和,2023-11-10,9207
8358,金居,3,0,3,凱基-永和,2023-11-10,9207
00712,復華富時不動產,3,0,3,凱基-永和,2023-11-10,9207
1720,生達,3,0,3,凱基-永和,2023-11-10,9207
2105,正新,3,0,3,凱基-永和,2023-11-10,9207
2637,慧洋-KY,3,0,3,凱基-永和,2023-11-10,9207
00679B,元大美債20年,156,5,151,凱基-永和,2023-11-13,9207
2388,威盛,80,6,74,凱基-永和,2023-11-13,9207
00632R,元大台灣50反1,70,0,70,凱基-永和,2023-11-13,9207
3041,揚智,89,33,56,凱基-永和,2023-11-13,9207
6186,新潤,50,0,50,凱基-永和,2023-11-13,9207
00715L,期街口布蘭特正2,40,0,40,凱基-永和,2023-11-13,9207
00878,國泰永續高股息,35,4,31,凱基-永和,2023-11-13,9207
3122,笙泉,28,1,27,凱基-永和,2023-11-13,9207
3306,鼎天,25,0,25,凱基-永和,2023-11-13,9207
4908,前鼎,23,0,23,凱基-永和,2023-11-13,9207
3308,聯德,25,3,22,凱基-永和,2023-11-13,9207
3036,文曄,31,10,21,凱基-永和,2023-11-13,9207
3062,建漢,20,0,20,凱基-永和,2023-11-13,9207
00881,國泰台灣5G+,30,12,18,凱基-永和,2023-11-13,9207
2883,凱基金,18,0,18,凱基-永和,2023-11-13,9207
2401,凌陽,17,1,16,凱基-永和,2023-11-13,9207
3032,偉訓,13,0,13,凱基-永和,2023-11-13,9207
2369,菱生,12,0,12,凱基-永和,2023-11-13,9207
8076,伍豐,12,0,12,凱基-永和,2023-11-13,9207
2301,光寶科,11,0,11,凱基-永和,2023-11-13,9207
3491,昇達科,11,0,11,凱基-永和,2023-11-13,9207
5347,世界,12,1,11,凱基-永和,2023-11-13,9207
2382,廣達,37,27,10,凱基-永和,2023-11-13,9207
1104,環泥,10,0,10,凱基-永和,2023-11-13,9207
2402,毅嘉,63,53,10,凱基-永和,2023-11-13,9207
6901,鑽石投資,11,1,10,凱基-永和,2023-11-13,9207
2618,長榮航,32,23,9,凱基-永和,2023-11-13,9207
6109,亞元,8,0,8,凱基-永和,2023-11-13,9207
8048,德勝,8,0,8,凱基-永和,2023-11-13,9207
2420,新巨,7,0,7,凱基-永和,2023-11-13,9207
3625,西勝,7,0,7,凱基-永和,2023-11-13,9207
6176,瑞儀,7,0,7,凱基-永和,2023-11-13,9207
00931B,統一美債20年,5,0,5,凱基-永和,2023-11-13,9207
00688L,國泰20年美債正2,5,0,5,凱基-永和,2023-11-13,9207
1721,三晃,5,0,5,凱基-永和,2023-11-13,9207
2614,東森,5,0,5,凱基-永和,2023-11-13,9207
6202,盛群,5,0,5,凱基-永和,2023-11-13,9207
8940,新天地,5,0,5,凱基-永和,2023-11-13,9207
4763,材料-KY,5,1,4,凱基-永和,2023-11-13,9207
00687B,國泰20年美債,4,0,4,凱基-永和,2023-11-13,9207
2002,中鋼,28,24,4,凱基-永和,2023-11-13,9207
2486,一詮,4,0,4,凱基-永和,2023-11-13,9207
3294,英濟,4,0,4,凱基-永和,2023-11-13,9207
4746,台耀,4,0,4,凱基-永和,2023-11-13,9207
4909,新復興,5,1,4,凱基-永和,2023-11-13,9207
6288,聯嘉,5,1,4,凱基-永和,2023-11-13,9207
6616,特昇-KY,5,1,4,凱基-永和,2023-11-13,9207
2204,中華,3,0,3,凱基-永和,2023-11-13,9207
1471,首利,3,0,3,凱基-永和,2023-11-13,9207
1795,美時,3,0,3,凱基-永和,2023-11-13,9207
00687B,國泰20年美債,500,20,480,凱基-永和,2023-11-14,9207
00679B,元大美債20年,80,2,78,凱基-永和,2023-11-14,9207
00929,復華台灣科技優息,75,7,68,凱基-永和,2023-11-14,9207
4979,華星光,63,0,63,凱基-永和,2023-11-14,9207
3041,揚智,110,55,55,凱基-永和,2023-11-14,9207
2881,富邦金,30,0,30,凱基-永和,2023-11-14,9207
6531,愛普*,51,23,28,凱基-永和,2023-11-14,9207
4908,前鼎,23,0,23,凱基-永和,2023-11-14,9207
3260,威剛,26,3,23,凱基-永和,2023-11-14,9207
00632R,元大台灣50反1,22,0,22,凱基-永和,2023-11-14,9207
6187,萬潤,22,0,22,凱基-永和,2023-11-14,9207
5009,榮剛,21,0,21,凱基-永和,2023-11-14,9207
3038,全台,20,1,19,凱基-永和,2023-11-14,9207
6585,鼎基,18,0,18,凱基-永和,2023-11-14,9207
3661,世芯-KY,16,0,16,凱基-永和,2023-11-14,9207
3014,聯陽,15,0,15,凱基-永和,2023-11-14,9207
2482,連宇,14,0,14,凱基-永和,2023-11-14,9207
3689,湧德,14,0,14,凱基-永和,2023-11-14,9207
6612,奈米醫材,13,0,13,凱基-永和,2023-11-14,9207
3231,緯創,19,7,12,凱基-永和,2023-11-14,9207
2609,陽明,18,6,12,凱基-永和,2023-11-14,9207
3036,文曄,13,2,11,凱基-永和,2023-11-14,9207
1442,名軒,10,0,10,凱基-永和,2023-11-14,9207
2488,漢平,10,0,10,凱基-永和,2023-11-14,9207
3006,晶豪科,14,4,10,凱基-永和,2023-11-14,9207
8930,青鋼,9,1,8,凱基-永和,2023-11-14,9207
00878,國泰永續高股息,31,24,7,凱基-永和,2023-11-14,9207
3380,明泰,7,0,7,凱基-永和,2023-11-14,9207
2402,毅嘉,7,1,6,凱基-永和,2023-11-14,9207
2883,凱基金,6,0,6,凱基-永和,2023-11-14,9207
8936,國統,8,2,6,凱基-永和,2023-11-14,9207
00900,富邦特選高股息30,6,0,6,凱基-永和,2023-11-14,9207
00692,富邦公司治理,5,0,5,凱基-永和,2023-11-14,9207
2353,宏��,5,0,5,凱基-永和,2023-11-14,9207
2382,廣達,51,46,5,凱基-永和,2023-11-14,9207
2427,三商電,5,0,5,凱基-永和,2023-11-14,9207
3693,營邦,6,1,5,凱基-永和,2023-11-14,9207
6288,聯嘉,5,0,5,凱基-永和,2023-11-14,9207
6869,雲豹能源,5,0,5,凱基-永和,2023-11-14,9207
9945,潤泰新,5,0,5,凱基-永和,2023-11-14,9207
2303,聯電,5,0,5,凱基-永和,2023-11-14,9207
2206,三陽工業,13,9,4,凱基-永和,2023-11-14,9207
2460,建通,4,0,4,凱基-永和,2023-11-14,9207
2486,一詮,4,0,4,凱基-永和,2023-11-14,9207
6188,廣明,4,0,4,凱基-永和,2023-11-14,9207
3702,大聯大,4,0,4,凱基-永和,2023-11-14,9207
00936,台新永續高息中小,3,0,3,凱基-永和,2023-11-14,9207
2355,敬鵬,3,0,3,凱基-永和,2023-11-14,9207
2359,所羅門,5,2,3,凱基-永和,2023-11-14,9207
3031,佰鴻,3,0,3,凱基-永和,2023-11-14,9207
00878,國泰永續高股息,232,12,220,凱基-永和,2023-11-15,9207
00679B,元大美債20年,86,20,66,凱基-永和,2023-11-15,9207
00929,復華台灣科技優息,68,15,53,凱基-永和,2023-11-15,9207
9924,福興,50,0,50,凱基-永和,2023-11-15,9207
00881,國泰台灣5G+,49,0,49,凱基-永和,2023-11-15,9207
3049,精金,48,0,48,凱基-永和,2023-11-15,9207
1314,中石化,40,0,40,凱基-永和,2023-11-15,9207
6603,富強鑫,40,0,40,凱基-永和,2023-11-15,9207
2883,凱基金,30,1,29,凱基-永和,2023-11-15,9207
4979,華星光,30,1,29,凱基-永和,2023-11-15,9207
3362,先進光,25,0,25,凱基-永和,2023-11-15,9207
00632R,元大台灣50反1,24,0,24,凱基-永和,2023-11-15,9207
1568,倉佑,21,1,20,凱基-永和,2023-11-15,9207
1201,味全,18,0,18,凱基-永和,2023-11-15,9207
2607,榮運,14,0,14,凱基-永和,2023-11-15,9207
2401,凌陽,13,1,12,凱基-永和,2023-11-15,9207
6139,亞翔,13,2,11,凱基-永和,2023-11-15,9207
00671R,富邦NASDAQ反1,10,0,10,凱基-永和,2023-11-15,9207
2605,新興,10,0,10,凱基-永和,2023-11-15,9207
2816,旺旺保,10,0,10,凱基-永和,2023-11-15,9207
6276,安鈦克,10,0,10,凱基-永和,2023-11-15,9207
6509,聚和,10,0,10,凱基-永和,2023-11-15,9207
2323,中環,9,0,9,凱基-永和,2023-11-15,9207
2337,旺宏,8,0,8,凱基-永和,2023-11-15,9207
2387,精元,8,0,8,凱基-永和,2023-11-15,9207
2405,輔信,8,0,8,凱基-永和,2023-11-15,9207
2449,京元電子,17,10,7,凱基-永和,2023-11-15,9207
3078,僑威,8,1,7,凱基-永和,2023-11-15,9207
2603,長榮,10,3,7,凱基-永和,2023-11-15,9207
2363,矽統,414,408,6,凱基-永和,2023-11-15,9207
00936,台新永續高息中小,6,0,6,凱基-永和,2023-11-15,9207
00934,中信成長高股息,6,0,6,凱基-永和,2023-11-15,9207
00885,富邦越南,6,0,6,凱基-永和,2023-11-15,9207
2369,菱生,8,2,6,凱基-永和,2023-11-15,9207
3227,原相,7,1,6,凱基-永和,2023-11-15,9207
5230,雷笛克光學,6,0,6,凱基-永和,2023-11-15,9207
00919,群益台灣精選高息,13,8,5,凱基-永和,2023-11-15,9207
00922,國泰台灣領袖50,6,1,5,凱基-永和,2023-11-15,9207
1442,名軒,5,0,5,凱基-永和,2023-11-15,9207
1721,三晃,5,0,5,凱基-永和,2023-11-15,9207
3363,上詮,7,2,5,凱基-永和,2023-11-15,9207
6266,泰詠,5,0,5,凱基-永和,2023-11-15,9207
6612,奈米醫材,5,0,5,凱基-永和,2023-11-15,9207
6741,91APP*-KY,5,0,5,凱基-永和,2023-11-15,9207
2376,技嘉,7,3,4,凱基-永和,2023-11-15,9207
5880,合庫金,5,1,4,凱基-永和,2023-11-15,9207
00857B,永豐20年美公債,4,0,4,凱基-永和,2023-11-15,9207
1717,長興,8,4,4,凱基-永和,2023-11-15,9207
3689,湧德,4,0,4,凱基-永和,2023-11-15,9207
6282,康舒,16,12,4,凱基-永和,2023-11-15,9207
3231,緯創,114,4,110,凱基-永和,2023-11-16,9207
9950,萬國通,112,2,110,凱基-永和,2023-11-16,9207
3041,揚智,100,10,90,凱基-永和,2023-11-16,9207
00878,國泰永續高股息,60,7,53,凱基-永和,2023-11-16,9207
4543,萬在,100,60,40,凱基-永和,2023-11-16,9207
00919,群益台灣精選高息,38,0,38,凱基-永和,2023-11-16,9207
00687B,國泰20年美債,33,0,33,凱基-永和,2023-11-16,9207
00929,復華台灣科技優息,39,7,32,凱基-永和,2023-11-16,9207
2337,旺宏,34,5,29,凱基-永和,2023-11-16,9207
2607,榮運,27,0,27,凱基-永和,2023-11-16,9207
2515,中工,25,0,25,凱基-永和,2023-11-16,9207
2329,華泰,339,317,22,凱基-永和,2023-11-16,9207
3078,僑威,21,1,20,凱基-永和,2023-11-16,9207
2027,大成鋼,16,0,16,凱基-永和,2023-11-16,9207
2303,聯電,16,0,16,凱基-永和,2023-11-16,9207
00632R,元大台灣50反1,15,0,15,凱基-永和,2023-11-16,9207
6438,迅得,15,0,15,凱基-永和,2023-11-16,9207
6109,亞元,12,0,12,凱基-永和,2023-11-16,9207
00933B,國泰10Y+金融債,11,0,11,凱基-永和,2023-11-16,9207
6901,鑽石投資,12,1,11,凱基-永和,2023-11-16,9207
1314,中石化,10,0,10,凱基-永和,2023-11-16,9207
2002,中鋼,10,0,10,凱基-永和,2023-11-16,9207
2369,菱生,10,0,10,凱基-永和,2023-11-16,9207
2402,毅嘉,13,3,10,凱基-永和,2023-11-16,9207
2504,國產,10,0,10,凱基-永和,2023-11-16,9207
2915,潤泰全,10,0,10,凱基-永和,2023-11-16,9207
5512,力麒,10,0,10,凱基-永和,2023-11-16,9207
6125,廣運,10,0,10,凱基-永和,2023-11-16,9207
6443,元晶,10,0,10,凱基-永和,2023-11-16,9207
8358,金居,10,0,10,凱基-永和,2023-11-16,9207
2412,中華電,10,0,10,凱基-永和,2023-11-16,9207
2356,英業達,15,6,9,凱基-永和,2023-11-16,9207
3265,台星科,9,0,9,凱基-永和,2023-11-16,9207
3450,聯鈞,10,1,9,凱基-永和,2023-11-16,9207
1101,台泥,10,1,9,凱基-永和,2023-11-16,9207
5880,合庫金,8,0,8,凱基-永和,2023-11-16,9207
00679B,元大美債20年,7,0,7,凱基-永和,2023-11-16,9207
2387,精元,7,0,7,凱基-永和,2023-11-16,9207
3149,正達,7,0,7,凱基-永和,2023-11-16,9207
4561,健椿,7,0,7,凱基-永和,2023-11-16,9207
00885,富邦越南,6,0,6,凱基-永和,2023-11-16,9207
6456,GIS-KY,6,0,6,凱基-永和,2023-11-16,9207
00713,元大台灣高息低波,5,0,5,凱基-永和,2023-11-16,9207
1504,東元,5,0,5,凱基-永和,2023-11-16,9207
00772B,中信高評級公司債,5,0,5,凱基-永和,2023-11-16,9207
2316,楠梓電,5,0,5,凱基-永和,2023-11-16,9207
2371,大同,8,3,5,凱基-永和,2023-11-16,9207
3023,信邦,5,0,5,凱基-永和,2023-11-16,9207
3032,偉訓,5,0,5,凱基-永和,2023-11-16,9207
3308,聯德,5,0,5,凱基-永和,2023-11-16,9207
6125,廣運,109,3,106,凱基-永和,2023-11-17,9207
3041,揚智,485,383,102,凱基-永和,2023-11-17,9207
2401,凌陽,203,107,96,凱基-永和,2023-11-17,9207
2883,凱基金,83,2,81,凱基-永和,2023-11-17,9207
2312,金寶,66,0,66,凱基-永和,2023-11-17,9207
6515,穎崴,61,0,61,凱基-永和,2023-11-17,9207
2515,中工,55,0,55,凱基-永和,2023-11-17,9207
6127,九豪,56,1,55,凱基-永和,2023-11-17,9207
6531,愛普*,53,5,48,凱基-永和,2023-11-17,9207
6187,萬潤,40,0,40,凱基-永和,2023-11-17,9207
3285,微端,60,25,35,凱基-永和,2023-11-17,9207
2353,宏��,33,0,33,凱基-永和,2023-11-17,9207
3005,神基,45,12,33,凱基-永和,2023-11-17,9207
00919,群益台灣精選高息,30,1,29,凱基-永和,2023-11-17,9207
6122,擎邦,29,0,29,凱基-永和,2023-11-17,9207
2329,華泰,40,12,28,凱基-永和,2023-11-17,9207
4908,前鼎,48,24,24,凱基-永和,2023-11-17,9207
2731,雄獅,35,11,24,凱基-永和,2023-11-17,9207
2492,華新科,22,0,22,凱基-永和,2023-11-17,9207
4967,十銓,22,2,20,凱基-永和,2023-11-17,9207
2610,華航,21,5,16,凱基-永和,2023-11-17,9207
2027,大成鋼,15,0,15,凱基-永和,2023-11-17,9207
00642U,期元大S＆P石油,14,0,14,凱基-永和,2023-11-17,9207
1301,台塑,12,0,12,凱基-永和,2023-11-17,9207
00751B,元大AAA至A公司債,11,0,11,凱基-永和,2023-11-17,9207
00936,台新永續高息中小,10,0,10,凱基-永和,2023-11-17,9207
00632R,元大台灣50反1,10,0,10,凱基-永和,2023-11-17,9207
1721,三晃,10,0,10,凱基-永和,2023-11-17,9207
2007,燁興,10,0,10,凱基-永和,2023-11-17,9207
2385,群光,10,0,10,凱基-永和,2023-11-17,9207
3038,全台,10,0,10,凱基-永和,2023-11-17,9207
3666,光耀,10,0,10,凱基-永和,2023-11-17,9207
00915,凱基優選高股息30,8,0,8,凱基-永和,2023-11-17,9207
00715L,期街口布蘭特正2,8,0,8,凱基-永和,2023-11-17,9207
8358,金居,8,0,8,凱基-永和,2023-11-17,9207
00720B,元大投資級公司債,7,0,7,凱基-永和,2023-11-17,9207
2748,雲品,8,1,7,凱基-永和,2023-11-17,9207
6271,同欣電,9,2,7,凱基-永和,2023-11-17,9207
00712,復華富時不動產,6,0,6,凱基-永和,2023-11-17,9207
00752,中信中國50,6,0,6,凱基-永和,2023-11-17,9207
2405,輔信,10,4,6,凱基-永和,2023-11-17,9207
2743,山富,12,6,6,凱基-永和,2023-11-17,9207
3339,泰谷,6,0,6,凱基-永和,2023-11-17,9207
3491,昇達科,6,0,6,凱基-永和,2023-11-17,9207
6584,南俊國際,6,0,6,凱基-永和,2023-11-17,9207
00885,富邦越南,5,0,5,凱基-永和,2023-11-17,9207
1409,新纖,5,0,5,凱基-永和,2023-11-17,9207
1515,力山,6,1,5,凱基-永和,2023-11-17,9207
1717,長興,5,0,5,凱基-永和,2023-11-17,9207
2402,毅嘉,7,2,5,凱基-永和,2023-11-17,9207
3041,揚智,303,37,266,凱基-永和,2023-11-20,9207
2313,華通,203,7,196,凱基-永和,2023-11-20,9207
3715,定穎投控,205,110,95,凱基-永和,2023-11-20,9207
3059,華晶科,101,9,92,凱基-永和,2023-11-20,9207
3013,晟銘電,92,2,90,凱基-永和,2023-11-20,9207
3017,奇鋐,68,3,65,凱基-永和,2023-11-20,9207
6274,台燿,80,21,59,凱基-永和,2023-11-20,9207
00919,群益台灣精選高息,54,0,54,凱基-永和,2023-11-20,9207
6158,禾昌,50,0,50,凱基-永和,2023-11-20,9207
8261,富鼎,50,0,50,凱基-永和,2023-11-20,9207
3035,智原,74,44,30,凱基-永和,2023-11-20,9207
3036,文曄,30,1,29,凱基-永和,2023-11-20,9207
1442,名軒,24,0,24,凱基-永和,2023-11-20,9207
00632R,元大台灣50反1,22,0,22,凱基-永和,2023-11-20,9207
2421,建準,20,0,20,凱基-永和,2023-11-20,9207
2382,廣達,15,2,13,凱基-永和,2023-11-20,9207
3454,晶睿,13,0,13,凱基-永和,2023-11-20,9207
00679B,元大美債20年,13,1,12,凱基-永和,2023-11-20,9207
00751B,元大AAA至A公司債,10,0,10,凱基-永和,2023-11-20,9207
2607,榮運,10,0,10,凱基-永和,2023-11-20,9207
5206,坤悅,10,0,10,凱基-永和,2023-11-20,9207
6182,合晶,10,0,10,凱基-永和,2023-11-20,9207
8044,網家,10,0,10,凱基-永和,2023-11-20,9207
3008,大立光,10,1,9,凱基-永和,2023-11-20,9207
2002,中鋼,8,0,8,凱基-永和,2023-11-20,9207
5465,富驊,8,0,8,凱基-永和,2023-11-20,9207
2317,鴻海,9,3,6,凱基-永和,2023-11-20,9207
00885,富邦越南,6,0,6,凱基-永和,2023-11-20,9207
6472,保瑞,6,0,6,凱基-永和,2023-11-20,9207
8930,青鋼,6,0,6,凱基-永和,2023-11-20,9207
2637,慧洋-KY,6,0,6,凱基-永和,2023-11-20,9207
00687B,國泰20年美債,5,0,5,凱基-永和,2023-11-20,9207
00713,元大台灣高息低波,5,0,5,凱基-永和,2023-11-20,9207
00891,中信關鍵半導體,5,0,5,凱基-永和,2023-11-20,9207
00722B,群益投資級電信債,5,0,5,凱基-永和,2023-11-20,9207
00772B,中信高評級公司債,5,0,5,凱基-永和,2023-11-20,9207
00762,元大全球AI,5,0,5,凱基-永和,2023-11-20,9207
2605,新興,5,0,5,凱基-永和,2023-11-20,9207
6288,聯嘉,5,0,5,凱基-永和,2023-11-20,9207
6139,亞翔,65,60,5,凱基-永和,2023-11-20,9207
2409,友達,4,0,4,凱基-永和,2023-11-20,9207
1301,台塑,5,1,4,凱基-永和,2023-11-20,9207
00936,台新永續高息中小,4,0,4,凱基-永和,2023-11-20,9207
2375,凱美,4,0,4,凱基-永和,2023-11-20,9207
3228,金麗科,4,0,4,凱基-永和,2023-11-20,9207
5706,鳳凰,5,1,4,凱基-永和,2023-11-20,9207
5864,致和證,5,1,4,凱基-永和,2023-11-20,9207
9945,潤泰新,4,0,4,凱基-永和,2023-11-20,9207
1303,南亞,3,0,3,凱基-永和,2023-11-20,9207
2449,京元電子,5,2,3,凱基-永和,2023-11-20,9207
2405,輔信,687,365,322,凱基-永和,2023-11-21,9207
4908,前鼎,191,87,104,凱基-永和,2023-11-21,9207
00662,富邦NASDAQ,75,0,75,凱基-永和,2023-11-21,9207
4979,華星光,132,61,71,凱基-永和,2023-11-21,9207
2618,長榮航,273,208,65,凱基-永和,2023-11-21,9207
2867,三商壽,60,0,60,凱基-永和,2023-11-21,9207
4542,科嶠,52,0,52,凱基-永和,2023-11-21,9207
00919,群益台灣精選高息,57,12,45,凱基-永和,2023-11-21,9207
1568,倉佑,31,1,30,凱基-永和,2023-11-21,9207
5443,均豪,30,0,30,凱基-永和,2023-11-21,9207
6585,鼎基,60,30,30,凱基-永和,2023-11-21,9207
00706L,期元大S＆P日圓正2,27,0,27,凱基-永和,2023-11-21,9207
3122,笙泉,25,0,25,凱基-永和,2023-11-21,9207
00929,復華台灣科技優息,25,3,22,凱基-永和,2023-11-21,9207
00632R,元大台灣50反1,32,10,22,凱基-永和,2023-11-21,9207
1524,耿鼎,21,0,21,凱基-永和,2023-11-21,9207
6579,研揚,20,0,20,凱基-永和,2023-11-21,9207
00751B,元大AAA至A公司債,19,0,19,凱基-永和,2023-11-21,9207
3702,大聯大,32,15,17,凱基-永和,2023-11-21,9207
3044,健鼎,14,0,14,凱基-永和,2023-11-21,9207
5347,世界,27,14,13,凱基-永和,2023-11-21,9207
5351,鈺創,306,295,11,凱基-永和,2023-11-21,9207
2385,群光,10,0,10,凱基-永和,2023-11-21,9207
2488,漢平,10,0,10,凱基-永和,2023-11-21,9207
3707,漢磊,10,0,10,凱基-永和,2023-11-21,9207
4931,新盛力,11,1,10,凱基-永和,2023-11-21,9207
6276,安鈦克,10,0,10,凱基-永和,2023-11-21,9207
3515,華擎,20,12,8,凱基-永和,2023-11-21,9207
2002,中鋼,20,12,8,凱基-永和,2023-11-21,9207
1101,台泥,8,0,8,凱基-永和,2023-11-21,9207
3035,智原,7,0,7,凱基-永和,2023-11-21,9207
9904,寶成,7,0,7,凱基-永和,2023-11-21,9207
00934,中信成長高股息,6,0,6,凱基-永和,2023-11-21,9207
3036A,文曄甲特,6,0,6,凱基-永和,2023-11-21,9207
3689,湧德,6,0,6,凱基-永和,2023-11-21,9207
2883,凱基金,12,6,6,凱基-永和,2023-11-21,9207
00725B,國泰投資級公司債,5,0,5,凱基-永和,2023-11-21,9207
1522,堤維西,5,0,5,凱基-永和,2023-11-21,9207
2314,台揚,5,0,5,凱基-永和,2023-11-21,9207
2462,良得電,5,0,5,凱基-永和,2023-11-21,9207
2542,興富發,5,0,5,凱基-永和,2023-11-21,9207
3504,揚明光,5,0,5,凱基-永和,2023-11-21,9207
3706,神達,12,7,5,凱基-永和,2023-11-21,9207
6202,盛群,5,0,5,凱基-永和,2023-11-21,9207
6456,GIS-KY,5,0,5,凱基-永和,2023-11-21,9207
6285,啟��,6,1,5,凱基-永和,2023-11-21,9207
2367,燿華,15,11,4,凱基-永和,2023-11-21,9207
3062,建漢,7,3,4,凱基-永和,2023-11-21,9207
3149,正達,4,0,4,凱基-永和,2023-11-21,9207
3489,森寶,4,0,4,凱基-永和,2023-11-21,9207
3227,原相,201,9,192,凱基-永和,2023-11-22,9207
5351,鈺創,224,32,192,凱基-永和,2023-11-22,9207
6237,驊訊,125,2,123,凱基-永和,2023-11-22,9207
8054,安國,77,2,75,凱基-永和,2023-11-22,9207
6243,迅杰,100,29,71,凱基-永和,2023-11-22,9207
2356,英業達,69,0,69,凱基-永和,2023-11-22,9207
4979,華星光,61,1,60,凱基-永和,2023-11-22,9207
2353,宏��,62,11,51,凱基-永和,2023-11-22,9207
6411,晶焱,51,4,47,凱基-永和,2023-11-22,9207
2401,凌陽,44,2,42,凱基-永和,2023-11-22,9207
3530,晶相光,42,1,41,凱基-永和,2023-11-22,9207
00878,國泰永續高股息,44,4,40,凱基-永和,2023-11-22,9207
3402,漢科,40,0,40,凱基-永和,2023-11-22,9207
00919,群益台灣精選高息,40,2,38,凱基-永和,2023-11-22,9207
3231,緯創,38,3,35,凱基-永和,2023-11-22,9207
2427,三商電,38,7,31,凱基-永和,2023-11-22,9207
2329,華泰,83,53,30,凱基-永和,2023-11-22,9207
6494,九齊,31,1,30,凱基-永和,2023-11-22,9207
6104,創惟,31,7,24,凱基-永和,2023-11-22,9207
2883,凱基金,22,0,22,凱基-永和,2023-11-22,9207
00933B,國泰10Y+金融債,20,0,20,凱基-永和,2023-11-22,9207
2492,華新科,20,0,20,凱基-永和,2023-11-22,9207
5478,智冠,20,0,20,凱基-永和,2023-11-22,9207
9958,世紀鋼,20,0,20,凱基-永和,2023-11-22,9207
00891,中信關鍵半導體,16,0,16,凱基-永和,2023-11-22,9207
5215,科嘉-KY,15,0,15,凱基-永和,2023-11-22,9207
5903,全家,15,0,15,凱基-永和,2023-11-22,9207
00929,復華台灣科技優息,43,29,14,凱基-永和,2023-11-22,9207
1101,台泥,14,0,14,凱基-永和,2023-11-22,9207
6716,應廣,12,0,12,凱基-永和,2023-11-22,9207
8044,網家,11,0,11,凱基-永和,2023-11-22,9207
1316,上曜,10,0,10,凱基-永和,2023-11-22,9207
1102,亞泥,10,0,10,凱基-永和,2023-11-22,9207
1802,台玻,10,0,10,凱基-永和,2023-11-22,9207
2313,華通,13,3,10,凱基-永和,2023-11-22,9207
2476,鉅祥,10,0,10,凱基-永和,2023-11-22,9207
3047,訊舟,30,20,10,凱基-永和,2023-11-22,9207
8121,越峰,10,0,10,凱基-永和,2023-11-22,9207
2344,華邦電,11,2,9,凱基-永和,2023-11-22,9207
2369,菱生,11,2,9,凱基-永和,2023-11-22,9207
4933,友輝,9,0,9,凱基-永和,2023-11-22,9207
0056,元大高股息,9,0,9,凱基-永和,2023-11-22,9207
2382,廣達,11,3,8,凱基-永和,2023-11-22,9207
00893,國泰智能電動車,8,0,8,凱基-永和,2023-11-22,9207
3325,旭品,11,3,8,凱基-永和,2023-11-22,9207
00708L,期元大S＆P黃金正2,7,0,7,凱基-永和,2023-11-22,9207
2498,宏達電,12,5,7,凱基-永和,2023-11-22,9207
3583,辛耘,10,3,7,凱基-永和,2023-11-22,9207
2454,聯發科,8,2,6,凱基-永和,2023-11-22,9207
2023,燁輝,6,0,6,凱基-永和,2023-11-22,9207
00878,國泰永續高股息,62,0,62,凱基-永和,2023-11-23,9207
3169,亞信,31,1,30,凱基-永和,2023-11-23,9207
3231,緯創,30,3,27,凱基-永和,2023-11-23,9207
1582,信錦,26,0,26,凱基-永和,2023-11-23,9207
6578,達邦蛋白,60,35,25,凱基-永和,2023-11-23,9207
2356,英業達,62,40,22,凱基-永和,2023-11-23,9207
2002,中鋼,21,0,21,凱基-永和,2023-11-23,9207
2455,全新,22,2,20,凱基-永和,2023-11-23,9207
6789,采鈺,40,20,20,凱基-永和,2023-11-23,9207
6282,康舒,143,125,18,凱基-永和,2023-11-23,9207
4188,安克,17,0,17,凱基-永和,2023-11-23,9207
1605,華新,17,1,16,凱基-永和,2023-11-23,9207
2891,中信金,18,2,16,凱基-永和,2023-11-23,9207
00919,群益台灣精選高息,16,1,15,凱基-永和,2023-11-23,9207
3483,力致,16,1,15,凱基-永和,2023-11-23,9207
2634,漢翔,15,1,14,凱基-永和,2023-11-23,9207
1101,台泥,13,0,13,凱基-永和,2023-11-23,9207
2363,矽統,56,44,12,凱基-永和,2023-11-23,9207
00929,復華台灣科技優息,12,0,12,凱基-永和,2023-11-23,9207
3694,海華,28,16,12,凱基-永和,2023-11-23,9207
3260,威剛,12,1,11,凱基-永和,2023-11-23,9207
8044,網家,11,0,11,凱基-永和,2023-11-23,9207
00933B,國泰10Y+金融債,10,0,10,凱基-永和,2023-11-23,9207
00632R,元大台灣50反1,10,0,10,凱基-永和,2023-11-23,9207
2314,台揚,10,0,10,凱基-永和,2023-11-23,9207
3257,虹冠電,10,0,10,凱基-永和,2023-11-23,9207
6216,居易,10,0,10,凱基-永和,2023-11-23,9207
6276,安鈦克,10,0,10,凱基-永和,2023-11-23,9207
8110,華東,10,0,10,凱基-永和,2023-11-23,9207
3037,欣興,16,8,8,凱基-永和,2023-11-23,9207
0056,元大高股息,7,0,7,凱基-永和,2023-11-23,9207
2482,連宇,11,4,7,凱基-永和,2023-11-23,9207
6275,元山,7,0,7,凱基-永和,2023-11-23,9207
3105,穩懋,10,4,6,凱基-永和,2023-11-23,9207
2316,楠梓電,8,2,6,凱基-永和,2023-11-23,9207
3006,晶豪科,13,7,6,凱基-永和,2023-11-23,9207
3047,訊舟,16,10,6,凱基-永和,2023-11-23,9207
6472,保瑞,6,0,6,凱基-永和,2023-11-23,9207
00881,國泰台灣5G+,5,0,5,凱基-永和,2023-11-23,9207
2408,南亞科,5,0,5,凱基-永和,2023-11-23,9207
2492,華新科,5,0,5,凱基-永和,2023-11-23,9207
2881,富邦金,5,0,5,凱基-永和,2023-11-23,9207
3049,精金,5,0,5,凱基-永和,2023-11-23,9207
3058,立德,5,0,5,凱基-永和,2023-11-23,9207
3701,大眾控,5,0,5,凱基-永和,2023-11-23,9207
6411,晶焱,5,0,5,凱基-永和,2023-11-23,9207
8930,青鋼,6,1,5,凱基-永和,2023-11-23,9207
2883,凱基金,12,7,5,凱基-永和,2023-11-23,9207
9945,潤泰新,4,0,4,凱基-永和,2023-11-23,9207
2313,華通,6,2,4,凱基-永和,2023-11-23,9207
2313,華通,213,11,202,凱基-永和,2023-11-24,9207
1514,亞力,155,2,153,凱基-永和,2023-11-24,9207
6127,九豪,101,1,100,凱基-永和,2023-11-24,9207
1529,樂事綠能,96,1,95,凱基-永和,2023-11-24,9207
2630,亞航,83,0,83,凱基-永和,2023-11-24,9207
8222,寶一,74,1,73,凱基-永和,2023-11-24,9207
2888,新光金,118,50,68,凱基-永和,2023-11-24,9207
2634,漢翔,51,5,46,凱基-永和,2023-11-24,9207
2610,華航,43,0,43,凱基-永和,2023-11-24,9207
00751B,元大AAA至A公司債,43,0,43,凱基-永和,2023-11-24,9207
2618,長榮航,54,14,40,凱基-永和,2023-11-24,9207
2355,敬鵬,42,4,38,凱基-永和,2023-11-24,9207
3702,大聯大,45,10,35,凱基-永和,2023-11-24,9207
2476,鉅祥,33,0,33,凱基-永和,2023-11-24,9207
00679B,元大美債20年,31,0,31,凱基-永和,2023-11-24,9207
2356,英業達,30,0,30,凱基-永和,2023-11-24,9207
3494,誠研,28,0,28,凱基-永和,2023-11-24,9207
8033,雷虎,26,0,26,凱基-永和,2023-11-24,9207
6223,旺矽,25,0,25,凱基-永和,2023-11-24,9207
1101,台泥,24,1,23,凱基-永和,2023-11-24,9207
6753,龍德造船,22,0,22,凱基-永和,2023-11-24,9207
2388,威盛,20,0,20,凱基-永和,2023-11-24,9207
9958,世紀鋼,70,50,20,凱基-永和,2023-11-24,9207
5258,虹堡,21,2,19,凱基-永和,2023-11-24,9207
3217,優群,20,2,18,凱基-永和,2023-11-24,9207
6829,千附精密,19,1,18,凱基-永和,2023-11-24,9207
1503,士電,21,5,16,凱基-永和,2023-11-24,9207
2887E,台新戊特,16,0,16,凱基-永和,2023-11-24,9207
3694,海華,30,15,15,凱基-永和,2023-11-24,9207
2363,矽統,31,18,13,凱基-永和,2023-11-24,9207
2515,中工,13,0,13,凱基-永和,2023-11-24,9207
3706,神達,11,0,11,凱基-永和,2023-11-24,9207
2641,正德,10,0,10,凱基-永和,2023-11-24,9207
6456,GIS-KY,10,0,10,凱基-永和,2023-11-24,9207
00893,國泰智能電動車,10,1,9,凱基-永和,2023-11-24,9207
1519,華城,15,6,9,凱基-永和,2023-11-24,9207
2367,燿華,15,6,9,凱基-永和,2023-11-24,9207
3041,揚智,9,1,8,凱基-永和,2023-11-24,9207
6271,同欣電,7,0,7,凱基-永和,2023-11-24,9207
5351,鈺創,12,6,6,凱基-永和,2023-11-24,9207
00720B,元大投資級公司債,6,0,6,凱基-永和,2023-11-24,9207
00885,富邦越南,6,0,6,凱基-永和,2023-11-24,9207
00931B,統一美債20年,6,0,6,凱基-永和,2023-11-24,9207
1713,國化,6,0,6,凱基-永和,2023-11-24,9207
2439,美律,6,0,6,凱基-永和,2023-11-24,9207
3032,偉訓,6,0,6,凱基-永和,2023-11-24,9207
6716,應廣,6,0,6,凱基-永和,2023-11-24,9207
3006,晶豪科,9,4,5,凱基-永和,2023-11-24,9207
1301,台塑,5,0,5,凱基-永和,2023-11-24,9207
00934,中信成長高股息,5,0,5,凱基-永和,2023-11-24,9207
2371,大同,50,3,47,凱基-永和,2023-11-27,9207
2618,長榮航,50,12,38,凱基-永和,2023-11-27,9207
1513,中興電,44,10,34,凱基-永和,2023-11-27,9207
2337,旺宏,28,0,28,凱基-永和,2023-11-27,9207
2356,英業達,26,0,26,凱基-永和,2023-11-27,9207
00919,群益台灣精選高息,20,0,20,凱基-永和,2023-11-27,9207
3231,緯創,21,2,19,凱基-永和,2023-11-27,9207
3694,海華,18,0,18,凱基-永和,2023-11-27,9207
2201,裕隆,17,0,17,凱基-永和,2023-11-27,9207
2340,台亞,16,0,16,凱基-永和,2023-11-27,9207
00931B,統一美債20年,15,0,15,凱基-永和,2023-11-27,9207
2344,華邦電,15,0,15,凱基-永和,2023-11-27,9207
2303,聯電,14,0,14,凱基-永和,2023-11-27,9207
2610,華航,21,8,13,凱基-永和,2023-11-27,9207
2641,正德,12,0,12,凱基-永和,2023-11-27,9207
00671R,富邦NASDAQ反1,10,0,10,凱基-永和,2023-11-27,9207
00648R,元大S＆P500反1,10,0,10,凱基-永和,2023-11-27,9207
00639,富邦深100,10,0,10,凱基-永和,2023-11-27,9207
2419,仲琦,10,0,10,凱基-永和,2023-11-27,9207
3218,大學光,10,0,10,凱基-永和,2023-11-27,9207
3362,先進光,10,0,10,凱基-永和,2023-11-27,9207
4744,皇將,10,0,10,凱基-永和,2023-11-27,9207
6412,群電,10,0,10,凱基-永和,2023-11-27,9207
2382,廣達,9,0,9,凱基-永和,2023-11-27,9207
00636,國泰中國A50,9,0,9,凱基-永和,2023-11-27,9207
2387,精元,12,3,9,凱基-永和,2023-11-27,9207
1734,杏輝,11,3,8,凱基-永和,2023-11-27,9207
2883,凱基金,8,0,8,凱基-永和,2023-11-27,9207
0056,元大高股息,7,0,7,凱基-永和,2023-11-27,9207
00637L,元大滬深300正2,7,0,7,凱基-永和,2023-11-27,9207
2891,中信金,8,1,7,凱基-永和,2023-11-27,9207
6122,擎邦,7,0,7,凱基-永和,2023-11-27,9207
5478,智冠,10,3,7,凱基-永和,2023-11-27,9207
3705,永信,6,0,6,凱基-永和,2023-11-27,9207
3037,欣興,11,5,6,凱基-永和,2023-11-27,9207
00679B,元大美債20年,16,10,6,凱基-永和,2023-11-27,9207
3588,通嘉,6,0,6,凱基-永和,2023-11-27,9207
6139,亞翔,6,0,6,凱基-永和,2023-11-27,9207
8215,明基材,6,0,6,凱基-永和,2023-11-27,9207
2515,中工,5,0,5,凱基-永和,2023-11-27,9207
00900,富邦特選高股息30,5,0,5,凱基-永和,2023-11-27,9207
00915,凱基優選高股息30,5,0,5,凱基-永和,2023-11-27,9207
2351,順德,5,0,5,凱基-永和,2023-11-27,9207
2367,燿華,7,2,5,凱基-永和,2023-11-27,9207
2903,遠百,5,0,5,凱基-永和,2023-11-27,9207
3017,奇鋐,5,0,5,凱基-永和,2023-11-27,9207
3122,笙泉,5,0,5,凱基-永和,2023-11-27,9207
3284,太普高,5,0,5,凱基-永和,2023-11-27,9207
4129,聯合,5,0,5,凱基-永和,2023-11-27,9207
5347,世界,6,1,5,凱基-永和,2023-11-27,9207
2329,華泰,1165,678,487,凱基-永和,2023-11-28,9207
3035,智原,154,6,148,凱基-永和,2023-11-28,9207
6245,立端,131,4,127,凱基-永和,2023-11-28,9207
2363,矽統,103,1,102,凱基-永和,2023-11-28,9207
4973,廣穎,100,0,100,凱基-永和,2023-11-28,9207
5381,合正,100,0,100,凱基-永和,2023-11-28,9207
6235,華孚,60,0,60,凱基-永和,2023-11-28,9207
3059,華晶科,55,0,55,凱基-永和,2023-11-28,9207
5351,鈺創,64,11,53,凱基-永和,2023-11-28,9207
2401,凌陽,150,106,44,凱基-永和,2023-11-28,9207
2355,敬鵬,44,1,43,凱基-永和,2023-11-28,9207
00637L,元大滬深300正2,40,0,40,凱基-永和,2023-11-28,9207
6117,迎廣,40,1,39,凱基-永和,2023-11-28,9207
1101,台泥,47,8,39,凱基-永和,2023-11-28,9207
2344,華邦電,71,37,34,凱基-永和,2023-11-28,9207
00632R,元大台灣50反1,31,0,31,凱基-永和,2023-11-28,9207
9103,美德醫療-DR,30,1,29,凱基-永和,2023-11-28,9207
3041,揚智,32,5,27,凱基-永和,2023-11-28,9207
3044,健鼎,27,1,26,凱基-永和,2023-11-28,9207
2801,彰銀,22,0,22,凱基-永和,2023-11-28,9207
3483,力致,22,0,22,凱基-永和,2023-11-28,9207
2388,威盛,23,1,22,凱基-永和,2023-11-28,9207
6585,鼎基,20,0,20,凱基-永和,2023-11-28,9207
6104,創惟,21,2,19,凱基-永和,2023-11-28,9207
3702,大聯大,20,3,17,凱基-永和,2023-11-28,9207
6139,亞翔,23,7,16,凱基-永和,2023-11-28,9207
5215,科嘉-KY,15,0,15,凱基-永和,2023-11-28,9207
6530,創威,15,0,15,凱基-永和,2023-11-28,9207
8210,勤誠,15,0,15,凱基-永和,2023-11-28,9207
2641,正德,30,16,14,凱基-永和,2023-11-28,9207
6443,元晶,15,2,13,凱基-永和,2023-11-28,9207
4923,力士,13,0,13,凱基-永和,2023-11-28,9207
6757,台灣虎航,13,0,13,凱基-永和,2023-11-28,9207
00772B,中信高評級公司債,12,0,12,凱基-永和,2023-11-28,9207
2455,全新,12,0,12,凱基-永和,2023-11-28,9207
2014,中鴻,10,0,10,凱基-永和,2023-11-28,9207
1789,神隆,10,0,10,凱基-永和,2023-11-28,9207
2367,燿華,13,3,10,凱基-永和,2023-11-28,9207
2867,三商壽,10,0,10,凱基-永和,2023-11-28,9207
5347,世界,18,8,10,凱基-永和,2023-11-28,9207
2371,大同,9,0,9,凱基-永和,2023-11-28,9207
5230,雷笛克光學,12,3,9,凱基-永和,2023-11-28,9207
00752,中信中國50,8,0,8,凱基-永和,2023-11-28,9207
6109,亞元,8,0,8,凱基-永和,2023-11-28,9207
2606,裕民,10,3,7,凱基-永和,2023-11-28,9207
3231,緯創,17,10,7,凱基-永和,2023-11-28,9207
2353,宏��,6,0,6,凱基-永和,2023-11-28,9207
2460,建通,6,0,6,凱基-永和,2023-11-28,9207
3362,先進光,6,0,6,凱基-永和,2023-11-28,9207
6488,環球晶,6,0,6,凱基-永和,2023-11-28,9207
6485,點序,153,3,150,凱基-永和,2023-11-29,9207
5328,華容,129,0,129,凱基-永和,2023-11-29,9207
00665L,富邦�琤肭磪囓�2,106,0,106,凱基-永和,2023-11-29,9207
6117,迎廣,84,6,78,凱基-永和,2023-11-29,9207
3227,原相,71,2,69,凱基-永和,2023-11-29,9207
8096,擎亞,50,0,50,凱基-永和,2023-11-29,9207
3013,晟銘電,41,1,40,凱基-永和,2023-11-29,9207
2492,華新科,103,64,39,凱基-永和,2023-11-29,9207
2369,菱生,304,265,39,凱基-永和,2023-11-29,9207
2618,長榮航,71,37,34,凱基-永和,2023-11-29,9207
2883,凱基金,47,16,31,凱基-永和,2023-11-29,9207
00919,群益台灣精選高息,31,0,31,凱基-永和,2023-11-29,9207
2356,英業達,139,110,29,凱基-永和,2023-11-29,9207
6757,台灣虎航,27,0,27,凱基-永和,2023-11-29,9207
3036,文曄,32,7,25,凱基-永和,2023-11-29,9207
2233,宇隆,25,0,25,凱基-永和,2023-11-29,9207
4979,華星光,27,2,25,凱基-永和,2023-11-29,9207
2891,中信金,23,0,23,凱基-永和,2023-11-29,9207
6593,台灣銘板,23,2,21,凱基-永和,2023-11-29,9207
3702,大聯大,20,4,16,凱基-永和,2023-11-29,9207
6239,力成,20,5,15,凱基-永和,2023-11-29,9207
00752,中信中國50,14,0,14,凱基-永和,2023-11-29,9207
6139,亞翔,15,3,12,凱基-永和,2023-11-29,9207
2449,京元電子,11,0,11,凱基-永和,2023-11-29,9207
2303,聯電,23,13,10,凱基-永和,2023-11-29,9207
2404,漢唐,10,0,10,凱基-永和,2023-11-29,9207
3014,聯陽,11,1,10,凱基-永和,2023-11-29,9207
3530,晶相光,10,0,10,凱基-永和,2023-11-29,9207
5351,鈺創,10,0,10,凱基-永和,2023-11-29,9207
6156,松上,10,0,10,凱基-永和,2023-11-29,9207
6411,晶焱,10,0,10,凱基-永和,2023-11-29,9207
2313,華通,20,10,10,凱基-永和,2023-11-29,9207
2444,兆勁,9,0,9,凱基-永和,2023-11-29,9207
3122,笙泉,9,0,9,凱基-永和,2023-11-29,9207
6122,擎邦,9,0,9,凱基-永和,2023-11-29,9207
6282,康舒,9,0,9,凱基-永和,2023-11-29,9207
3231,緯創,12,3,9,凱基-永和,2023-11-29,9207
2460,建通,8,0,8,凱基-永和,2023-11-29,9207
2498,宏達電,10,2,8,凱基-永和,2023-11-29,9207
2457,飛宏,11,3,8,凱基-永和,2023-11-29,9207
2340,台亞,7,0,7,凱基-永和,2023-11-29,9207
2610,華航,8,2,6,凱基-永和,2023-11-29,9207
1616,億泰,6,0,6,凱基-永和,2023-11-29,9207
2316,楠梓電,6,0,6,凱基-永和,2023-11-29,9207
2401,凌陽,58,52,6,凱基-永和,2023-11-29,9207
1444,力麗,5,0,5,凱基-永和,2023-11-29,9207
2392,正崴,5,0,5,凱基-永和,2023-11-29,9207
2425,承啟,5,0,5,凱基-永和,2023-11-29,9207
3317,尼克森,6,1,5,凱基-永和,2023-11-29,9207
6125,廣運,5,0,5,凱基-永和,2023-11-29,9207
3050,鈺德,105,1,104,凱基-永和,2023-11-30,9207
00665L,富邦�琤肭磪囓�2,94,0,94,凱基-永和,2023-11-30,9207
1514,亞力,309,227,82,凱基-永和,2023-11-30,9207
00650L,復華香港正2,60,0,60,凱基-永和,2023-11-30,9207
4909,新復興,200,150,50,凱基-永和,2023-11-30,9207
2359,所羅門,62,17,45,凱基-永和,2023-11-30,9207
2482,連宇,37,0,37,凱基-永和,2023-11-30,9207
00933B,國泰10Y+金融債,23,0,23,凱基-永和,2023-11-30,9207
00882,中信中國高股息,21,0,21,凱基-永和,2023-11-30,9207
2363,矽統,23,2,21,凱基-永和,2023-11-30,9207
2465,麗臺,25,4,21,凱基-永和,2023-11-30,9207
8932,智通*,41,20,21,凱基-永和,2023-11-30,9207
2504,國產,20,0,20,凱基-永和,2023-11-30,9207
3043,科風,46,26,20,凱基-永和,2023-11-30,9207
2834,臺企銀,20,1,19,凱基-永和,2023-11-30,9207
00919,群益台灣精選高息,22,3,19,凱基-永和,2023-11-30,9207
3231,緯創,19,1,18,凱基-永和,2023-11-30,9207
5351,鈺創,13,0,13,凱基-永和,2023-11-30,9207
3694,海華,12,1,11,凱基-永和,2023-11-30,9207
8210,勤誠,11,0,11,凱基-永和,2023-11-30,9207
1402,遠東新,10,0,10,凱基-永和,2023-11-30,9207
0056,元大高股息,10,0,10,凱基-永和,2023-11-30,9207
1442,名軒,10,0,10,凱基-永和,2023-11-30,9207
2337,旺宏,10,0,10,凱基-永和,2023-11-30,9207
2458,義隆,10,0,10,凱基-永和,2023-11-30,9207
2867,三商壽,10,0,10,凱基-永和,2023-11-30,9207
3059,華晶科,10,0,10,凱基-永和,2023-11-30,9207
3163,波若威,11,1,10,凱基-永和,2023-11-30,9207
4905,台聯電,10,0,10,凱基-永和,2023-11-30,9207
6143,振曜,10,0,10,凱基-永和,2023-11-30,9207
00720B,元大投資級公司債,9,0,9,凱基-永和,2023-11-30,9207
2312,金寶,10,1,9,凱基-永和,2023-11-30,9207
2344,華邦電,21,12,9,凱基-永和,2023-11-30,9207
3702,大聯大,21,12,9,凱基-永和,2023-11-30,9207
1605,華新,8,0,8,凱基-永和,2023-11-30,9207
3548,兆利,8,0,8,凱基-永和,2023-11-30,9207
4123,晟德,7,0,7,凱基-永和,2023-11-30,9207
1321,大洋,6,0,6,凱基-永和,2023-11-30,9207
00897,富邦基因免疫生技,6,0,6,凱基-永和,2023-11-30,9207
4401,東隆興,6,0,6,凱基-永和,2023-11-30,9207
2515,中工,5,0,5,凱基-永和,2023-11-30,9207
4105,東洋,5,0,5,凱基-永和,2023-11-30,9207
00752,中信中國50,5,0,5,凱基-永和,2023-11-30,9207
2615,萬海,7,2,5,凱基-永和,2023-11-30,9207
2845,遠東銀,5,0,5,凱基-永和,2023-11-30,9207
00934,中信成長高股息,5,1,4,凱基-永和,2023-11-30,9207
00921,兆豐龍頭等權重,4,0,4,凱基-永和,2023-11-30,9207
00881,國泰台灣5G+,4,0,4,凱基-永和,2023-11-30,9207
2340,台亞,4,0,4,凱基-永和,2023-11-30,9207
2855,統一證,4,0,4,凱基-永和,2023-11-30,9207
2618,長榮航,204,31,173,凱基-永和,2023-12-01,9207
3715,定穎投控,425,276,149,凱基-永和,2023-12-01,9207
00679B,元大美債20年,124,0,124,凱基-永和,2023-12-01,9207
2388,威盛,123,4,119,凱基-永和,2023-12-01,9207
3481,群創,100,0,100,凱基-永和,2023-12-01,9207
2409,友達,106,9,97,凱基-永和,2023-12-01,9207
5426,振發,88,0,88,凱基-永和,2023-12-01,9207
4167,松瑞藥,605,519,86,凱基-永和,2023-12-01,9207
1789,神隆,83,8,75,凱基-永和,2023-12-01,9207
6245,立端,72,2,70,凱基-永和,2023-12-01,9207
1101,台泥,62,0,62,凱基-永和,2023-12-01,9207
2365,昆盈,60,6,54,凱基-永和,2023-12-01,9207
5469,瀚宇博,51,0,51,凱基-永和,2023-12-01,9207
2355,敬鵬,52,4,48,凱基-永和,2023-12-01,9207
6233,旺玖,185,139,46,凱基-永和,2023-12-01,9207
3050,鈺德,158,120,38,凱基-永和,2023-12-01,9207
1781,合世,36,0,36,凱基-永和,2023-12-01,9207
00919,群益台灣精選高息,43,10,33,凱基-永和,2023-12-01,9207
8038,長園科,33,0,33,凱基-永和,2023-12-01,9207
1339,昭輝,30,0,30,凱基-永和,2023-12-01,9207
6124,業強,30,0,30,凱基-永和,2023-12-01,9207
1442,名軒,25,0,25,凱基-永和,2023-12-01,9207
2359,所羅門,25,0,25,凱基-永和,2023-12-01,9207
3048,益登,25,0,25,凱基-永和,2023-12-01,9207
00637L,元大滬深300正2,21,0,21,凱基-永和,2023-12-01,9207
6579,研揚,20,0,20,凱基-永和,2023-12-01,9207
00751B,元大AAA至A公司債,20,0,20,凱基-永和,2023-12-01,9207
2504,國產,20,0,20,凱基-永和,2023-12-01,9207
6239,力成,20,0,20,凱基-永和,2023-12-01,9207
6274,台燿,22,2,20,凱基-永和,2023-12-01,9207
3483,力致,22,3,19,凱基-永和,2023-12-01,9207
2886,兆豐金,18,1,17,凱基-永和,2023-12-01,9207
00915,凱基優選高股息30,16,0,16,凱基-永和,2023-12-01,9207
1582,信錦,44,30,14,凱基-永和,2023-12-01,9207
2324,仁寶,14,0,14,凱基-永和,2023-12-01,9207
00878,國泰永續高股息,14,0,14,凱基-永和,2023-12-01,9207
2641,正德,43,30,13,凱基-永和,2023-12-01,9207
1608,華榮,12,0,12,凱基-永和,2023-12-01,9207
3260,威剛,13,1,12,凱基-永和,2023-12-01,9207
2460,建通,11,0,11,凱基-永和,2023-12-01,9207
5236,凌陽創新,11,0,11,凱基-永和,2023-12-01,9207
00882,中信中國高股息,10,0,10,凱基-永和,2023-12-01,9207
3706,神達,10,0,10,凱基-永和,2023-12-01,9207
5351,鈺創,11,1,10,凱基-永和,2023-12-01,9207
5521,工信,10,0,10,凱基-永和,2023-12-01,9207
2834,臺企銀,10,0,10,凱基-永和,2023-12-01,9207
00885,富邦越南,9,0,9,凱基-永和,2023-12-01,9207
00893,國泰智能電動車,10,1,9,凱基-永和,2023-12-01,9207
00720B,元大投資級公司債,9,0,9,凱基-永和,2023-12-01,9207
3567,逸昌,8,0,8,凱基-永和,2023-12-01,9207
5608,四維航,207,15,192,凱基-永和,2023-12-04,9207
4979,華星光,91,0,91,凱基-永和,2023-12-04,9207
2355,敬鵬,118,61,57,凱基-永和,2023-12-04,9207
4167,松瑞藥,174,117,57,凱基-永和,2023-12-04,9207
5469,瀚宇博,56,2,54,凱基-永和,2023-12-04,9207
00919,群益台灣精選高息,93,41,52,凱基-永和,2023-12-04,9207
00918,大華優利高填息30,42,0,42,凱基-永和,2023-12-04,9207
8110,華東,40,3,37,凱基-永和,2023-12-04,9207
2609,陽明,43,9,34,凱基-永和,2023-12-04,9207
1504,東元,34,1,33,凱基-永和,2023-12-04,9207
5210,寶碩,31,0,31,凱基-永和,2023-12-04,9207
00719B,元大美債1-3,30,0,30,凱基-永和,2023-12-04,9207
9958,世紀鋼,30,0,30,凱基-永和,2023-12-04,9207
3702,大聯大,37,12,25,凱基-永和,2023-12-04,9207
00680L,元大美債20正2,24,0,24,凱基-永和,2023-12-04,9207
2323,中環,15,0,15,凱基-永和,2023-12-04,9207
5328,華容,16,1,15,凱基-永和,2023-12-04,9207
2504,國產,20,6,14,凱基-永和,2023-12-04,9207
3041,揚智,15,1,14,凱基-永和,2023-12-04,9207
8088,品安,23,9,14,凱基-永和,2023-12-04,9207
1568,倉佑,64,51,13,凱基-永和,2023-12-04,9207
1101,台泥,14,2,12,凱基-永和,2023-12-04,9207
3706,神達,12,0,12,凱基-永和,2023-12-04,9207
9919,康那香,15,3,12,凱基-永和,2023-12-04,9207
3231,緯創,18,6,12,凱基-永和,2023-12-04,9207
00882,中信中國高股息,11,0,11,凱基-永和,2023-12-04,9207
2891,中信金,13,3,10,凱基-永和,2023-12-04,9207
00752,中信中國50,10,0,10,凱基-永和,2023-12-04,9207
1611,中電,10,0,10,凱基-永和,2023-12-04,9207
2356,英業達,11,1,10,凱基-永和,2023-12-04,9207
2537,聯上發,10,0,10,凱基-永和,2023-12-04,9207
2542,興富發,10,0,10,凱基-永和,2023-12-04,9207
3008,大立光,10,0,10,凱基-永和,2023-12-04,9207
6412,群電,10,0,10,凱基-永和,2023-12-04,9207
9103,美德醫療-DR,20,10,10,凱基-永和,2023-12-04,9207
4763,材料-KY,10,1,9,凱基-永和,2023-12-04,9207
6122,擎邦,9,0,9,凱基-永和,2023-12-04,9207
5871,中租-KY,8,0,8,凱基-永和,2023-12-04,9207
5381,合正,18,10,8,凱基-永和,2023-12-04,9207
2347,聯強,8,0,8,凱基-永和,2023-12-04,9207
2250,IKKA-KY,7,0,7,凱基-永和,2023-12-04,9207
2344,華邦電,8,1,7,凱基-永和,2023-12-04,9207
6282,康舒,7,0,7,凱基-永和,2023-12-04,9207
00715L,期街口布蘭特正2,6,0,6,凱基-永和,2023-12-04,9207
2352,佳世達,6,0,6,凱基-永和,2023-12-04,9207
5483,中美晶,6,0,6,凱基-永和,2023-12-04,9207
3380,明泰,11,6,5,凱基-永和,2023-12-04,9207
00642U,期元大S＆P石油,5,0,5,凱基-永和,2023-12-04,9207
1605,華新,7,2,5,凱基-永和,2023-12-04,9207
2331,精英,5,0,5,凱基-永和,2023-12-04,9207
6117,迎廣,250,90,160,凱基-永和,2023-12-05,9207
2329,華泰,168,22,146,凱基-永和,2023-12-05,9207
2332,友訊,138,0,138,凱基-永和,2023-12-05,9207
00937B,群益ESG投等債20,118,54,64,凱基-永和,2023-12-05,9207
6235,華孚,65,1,64,凱基-永和,2023-12-05,9207
2606,裕民,90,32,58,凱基-永和,2023-12-05,9207
00919,群益台灣精選高息,73,21,52,凱基-永和,2023-12-05,9207
2401,凌陽,50,0,50,凱基-永和,2023-12-05,9207
6148,驊宏資,51,1,50,凱基-永和,2023-12-05,9207
1503,士電,54,7,47,凱基-永和,2023-12-05,9207
00878,國泰永續高股息,46,1,45,凱基-永和,2023-12-05,9207
2618,長榮航,40,0,40,凱基-永和,2023-12-05,9207
2489,瑞軒,36,1,35,凱基-永和,2023-12-05,9207
3483,力致,32,0,32,凱基-永和,2023-12-05,9207
3363,上詮,30,0,30,凱基-永和,2023-12-05,9207
3041,揚智,34,4,30,凱基-永和,2023-12-05,9207
6274,台燿,30,0,30,凱基-永和,2023-12-05,9207
2601,益航,29,2,27,凱基-永和,2023-12-05,9207
6282,康舒,26,0,26,凱基-永和,2023-12-05,9207
3231,緯創,29,3,26,凱基-永和,2023-12-05,9207
2303,聯電,40,15,25,凱基-永和,2023-12-05,9207
1513,中興電,40,16,24,凱基-永和,2023-12-05,9207
00882,中信中國高股息,24,0,24,凱基-永和,2023-12-05,9207
3702,大聯大,43,21,22,凱基-永和,2023-12-05,9207
2867,三商壽,20,0,20,凱基-永和,2023-12-05,9207
3036,文曄,20,0,20,凱基-永和,2023-12-05,9207
3147,大綜,20,0,20,凱基-永和,2023-12-05,9207
8044,網家,20,0,20,凱基-永和,2023-12-05,9207
2609,陽明,24,5,19,凱基-永和,2023-12-05,9207
2516,新建,18,0,18,凱基-永和,2023-12-05,9207
4979,華星光,15,0,15,凱基-永和,2023-12-05,9207
6901,鑽石投資,15,0,15,凱基-永和,2023-12-05,9207
8215,明基材,14,0,14,凱基-永和,2023-12-05,9207
3588,通嘉,21,8,13,凱基-永和,2023-12-05,9207
1605,華新,12,0,12,凱基-永和,2023-12-05,9207
1608,華榮,12,0,12,凱基-永和,2023-12-05,9207
2313,華通,13,2,11,凱基-永和,2023-12-05,9207
2481,強茂,11,0,11,凱基-永和,2023-12-05,9207
8086,宏捷科,12,1,11,凱基-永和,2023-12-05,9207
00679B,元大美債20年,13,3,10,凱基-永和,2023-12-05,9207
9945,潤泰新,10,0,10,凱基-永和,2023-12-05,9207
00722B,群益投資級電信債,10,0,10,凱基-永和,2023-12-05,9207
00922,國泰台灣領袖50,10,0,10,凱基-永和,2023-12-05,9207
1314,中石化,10,0,10,凱基-永和,2023-12-05,9207
1522,堤維西,13,3,10,凱基-永和,2023-12-05,9207
2363,矽統,15,5,10,凱基-永和,2023-12-05,9207
00934,中信成長高股息,9,0,9,凱基-永和,2023-12-05,9207
1760,寶齡富錦,9,0,9,凱基-永和,2023-12-05,9207
5328,華容,10,1,9,凱基-永和,2023-12-05,9207
5347,世界,9,0,9,凱基-永和,2023-12-05,9207
8054,安國,320,197,123,凱基-永和,2023-12-06,9207
3450,聯鈞,103,0,103,凱基-永和,2023-12-06,9207
2399,映泰,202,101,101,凱基-永和,2023-12-06,9207
2425,承啟,106,5,101,凱基-永和,2023-12-06,9207
00665L,富邦�琤肭磪囓�2,106,6,100,凱基-永和,2023-12-06,9207
2465,麗臺,100,0,100,凱基-永和,2023-12-06,9207
3444,利機,100,0,100,凱基-永和,2023-12-06,9207
6243,迅杰,81,1,80,凱基-永和,2023-12-06,9207
6237,驊訊,79,0,79,凱基-永和,2023-12-06,9207
8936,國統,81,3,78,凱基-永和,2023-12-06,9207
2388,威盛,64,4,60,凱基-永和,2023-12-06,9207
2401,凌陽,51,3,48,凱基-永和,2023-12-06,9207
2867,三商壽,40,0,40,凱基-永和,2023-12-06,9207
3481,群創,40,0,40,凱基-永和,2023-12-06,9207
5351,鈺創,41,1,40,凱基-永和,2023-12-06,9207
3059,華晶科,36,0,36,凱基-永和,2023-12-06,9207
2303,聯電,34,2,32,凱基-永和,2023-12-06,9207
6695,芯鼎,25,0,25,凱基-永和,2023-12-06,9207
3715,定穎投控,43,21,22,凱基-永和,2023-12-06,9207
4967,十銓,23,2,21,凱基-永和,2023-12-06,9207
5432,新門,20,0,20,凱基-永和,2023-12-06,9207
6104,創惟,20,0,20,凱基-永和,2023-12-06,9207
6733,博晟生醫,20,0,20,凱基-永和,2023-12-06,9207
00918,大華優利高填息30,19,0,19,凱基-永和,2023-12-06,9207
3306,鼎天,21,2,19,凱基-永和,2023-12-06,9207
2611,志信,21,3,18,凱基-永和,2023-12-06,9207
1339,昭輝,15,0,15,凱基-永和,2023-12-06,9207
5516,雙喜,15,0,15,凱基-永和,2023-12-06,9207
9103,美德醫療-DR,15,0,15,凱基-永和,2023-12-06,9207
00919,群益台灣精選高息,39,26,13,凱基-永和,2023-12-06,9207
00680L,元大美債20正2,14,1,13,凱基-永和,2023-12-06,9207
00878,國泰永續高股息,12,0,12,凱基-永和,2023-12-06,9207
1101,台泥,11,0,11,凱基-永和,2023-12-06,9207
00882,中信中國高股息,11,0,11,凱基-永和,2023-12-06,9207
2408,南亞科,14,3,11,凱基-永和,2023-12-06,9207
00929,復華台灣科技優息,11,1,10,凱基-永和,2023-12-06,9207
00632R,元大台灣50反1,10,0,10,凱基-永和,2023-12-06,9207
1442,名軒,10,0,10,凱基-永和,2023-12-06,9207
3147,大綜,10,0,10,凱基-永和,2023-12-06,9207
4934,太極,10,0,10,凱基-永和,2023-12-06,9207
5230,雷笛克光學,10,0,10,凱基-永和,2023-12-06,9207
5426,振發,10,0,10,凱基-永和,2023-12-06,9207
6213,聯茂,10,0,10,凱基-永和,2023-12-06,9207
6215,和椿,10,0,10,凱基-永和,2023-12-06,9207
8358,金居,10,0,10,凱基-永和,2023-12-06,9207
1529,樂事綠能,17,8,9,凱基-永和,2023-12-06,9207
2883,凱基金,10,1,9,凱基-永和,2023-12-06,9207
6122,擎邦,10,1,9,凱基-永和,2023-12-06,9207
6139,亞翔,10,1,9,凱基-永和,2023-12-06,9207
1513,中興電,33,25,8,凱基-永和,2023-12-06,9207
2380,虹光,145,0,145,凱基-永和,2023-12-07,9207
00919,群益台灣精選高息,101,22,79,凱基-永和,2023-12-07,9207
2303,聯電,54,10,44,凱基-永和,2023-12-07,9207
00918,大華優利高填息30,22,0,22,凱基-永和,2023-12-07,9207
00687B,國泰20年美債,21,0,21,凱基-永和,2023-12-07,9207
2530,華建,20,0,20,凱基-永和,2023-12-07,9207
2886,兆豐金,25,5,20,凱基-永和,2023-12-07,9207
2344,華邦電,24,7,17,凱基-永和,2023-12-07,9207
00680L,元大美債20正2,25,9,16,凱基-永和,2023-12-07,9207
1504,東元,31,15,16,凱基-永和,2023-12-07,9207
3515,華擎,30,15,15,凱基-永和,2023-12-07,9207
2891,中信金,15,0,15,凱基-永和,2023-12-07,9207
00882,中信中國高股息,15,0,15,凱基-永和,2023-12-07,9207
3059,華晶科,14,0,14,凱基-永和,2023-12-07,9207
3661,世芯-KY,14,0,14,凱基-永和,2023-12-07,9207
2355,敬鵬,27,15,12,凱基-永和,2023-12-07,9207
2610,華航,14,2,12,凱基-永和,2023-12-07,9207
2881,富邦金,11,0,11,凱基-永和,2023-12-07,9207
2314,台揚,14,3,11,凱基-永和,2023-12-07,9207
8088,品安,11,0,11,凱基-永和,2023-12-07,9207
00933B,國泰10Y+金融債,22,12,10,凱基-永和,2023-12-07,9207
1314,中石化,10,0,10,凱基-永和,2023-12-07,9207
2349,錸德,10,0,10,凱基-永和,2023-12-07,9207
4533,協易機,29,19,10,凱基-永和,2023-12-07,9207
6412,群電,10,0,10,凱基-永和,2023-12-07,9207
8358,金居,10,0,10,凱基-永和,2023-12-07,9207
00937B,群益ESG投等債20,40,31,9,凱基-永和,2023-12-07,9207
1789,神隆,9,0,9,凱基-永和,2023-12-07,9207
2101,南港,9,0,9,凱基-永和,2023-12-07,9207
2331,精英,9,0,9,凱基-永和,2023-12-07,9207
00931B,統一美債20年,8,0,8,凱基-永和,2023-12-07,9207
00752,中信中國50,8,0,8,凱基-永和,2023-12-07,9207
2464,盟立,8,0,8,凱基-永和,2023-12-07,9207
2882,國泰金,8,0,8,凱基-永和,2023-12-07,9207
00679B,元大美債20年,12,5,7,凱基-永和,2023-12-07,9207
00715L,期街口布蘭特正2,7,0,7,凱基-永和,2023-12-07,9207
2340,台亞,7,0,7,凱基-永和,2023-12-07,9207
3122,笙泉,7,0,7,凱基-永和,2023-12-07,9207
00720B,元大投資級公司債,6,0,6,凱基-永和,2023-12-07,9207
00929,復華台灣科技優息,6,0,6,凱基-永和,2023-12-07,9207
00642U,期元大S＆P石油,6,0,6,凱基-永和,2023-12-07,9207
00688L,國泰20年美債正2,6,0,6,凱基-永和,2023-12-07,9207
9945,潤泰新,6,0,6,凱基-永和,2023-12-07,9207
00753L,中信中國50正2,5,0,5,凱基-永和,2023-12-07,9207
1717,長興,5,0,5,凱基-永和,2023-12-07,9207
1905,華紙,5,0,5,凱基-永和,2023-12-07,9207
2515,中工,5,0,5,凱基-永和,2023-12-07,9207
2845,遠東銀,5,0,5,凱基-永和,2023-12-07,9207
3257,虹冠電,5,0,5,凱基-永和,2023-12-07,9207
3689,湧德,5,0,5,凱基-永和,2023-12-07,9207
5351,鈺創,222,19,203,凱基-永和,2023-12-08,9207
00919,群益台灣精選高息,163,16,147,凱基-永和,2023-12-08,9207
3035,智原,64,6,58,凱基-永和,2023-12-08,9207
00719B,元大美債1-3,50,0,50,凱基-永和,2023-12-08,9207
3499,環天科,50,0,50,凱基-永和,2023-12-08,9207
3191,雲嘉南,42,0,42,凱基-永和,2023-12-08,9207
6239,力成,80,40,40,凱基-永和,2023-12-08,9207
00929,復華台灣科技優息,53,16,37,凱基-永和,2023-12-08,9207
2605,新興,165,130,35,凱基-永和,2023-12-08,9207
2809,京城銀,30,0,30,凱基-永和,2023-12-08,9207
6205,詮欣,130,101,29,凱基-永和,2023-12-08,9207
8210,勤誠,30,3,27,凱基-永和,2023-12-08,9207
4908,前鼎,28,2,26,凱基-永和,2023-12-08,9207
00706L,期元大S＆P日圓正2,25,0,25,凱基-永和,2023-12-08,9207
00679B,元大美債20年,22,0,22,凱基-永和,2023-12-08,9207
2388,威盛,23,3,20,凱基-永和,2023-12-08,9207
00687B,國泰20年美債,19,0,19,凱基-永和,2023-12-08,9207
8034,榮群,16,0,16,凱基-永和,2023-12-08,9207
3483,力致,15,0,15,凱基-永和,2023-12-08,9207
2606,裕民,14,0,14,凱基-永和,2023-12-08,9207
2314,台揚,14,1,13,凱基-永和,2023-12-08,9207
3443,創意,12,0,12,凱基-永和,2023-12-08,9207
00918,大華優利高填息30,12,0,12,凱基-永和,2023-12-08,9207
4979,華星光,23,11,12,凱基-永和,2023-12-08,9207
2402,毅嘉,12,0,12,凱基-永和,2023-12-08,9207
3231,緯創,14,2,12,凱基-永和,2023-12-08,9207
00937B,群益ESG投等債20,26,15,11,凱基-永和,2023-12-08,9207
6271,同欣電,10,0,10,凱基-永和,2023-12-08,9207
5328,華容,10,0,10,凱基-永和,2023-12-08,9207
2882,國泰金,9,0,9,凱基-永和,2023-12-08,9207
00772B,中信高評級公司債,9,0,9,凱基-永和,2023-12-08,9207
2363,矽統,10,1,9,凱基-永和,2023-12-08,9207
6282,康舒,7,0,7,凱基-永和,2023-12-08,9207
00662,富邦NASDAQ,7,0,7,凱基-永和,2023-12-08,9207
2618,長榮航,17,10,7,凱基-永和,2023-12-08,9207
3041,揚智,9,2,7,凱基-永和,2023-12-08,9207
00720B,元大投資級公司債,6,0,6,凱基-永和,2023-12-08,9207
1514,亞力,36,30,6,凱基-永和,2023-12-08,9207
1504,東元,7,1,6,凱基-永和,2023-12-08,9207
1608,華榮,47,41,6,凱基-永和,2023-12-08,9207
3213,茂訊,7,1,6,凱基-永和,2023-12-08,9207
4306,炎洲,6,0,6,凱基-永和,2023-12-08,9207
8930,青鋼,8,2,6,凱基-永和,2023-12-08,9207
2637,慧洋-KY,6,1,5,凱基-永和,2023-12-08,9207
00882,中信中國高股息,5,0,5,凱基-永和,2023-12-08,9207
00642U,期元大S＆P石油,5,0,5,凱基-永和,2023-12-08,9207
00724B,群益投資級金融債,5,0,5,凱基-永和,2023-12-08,9207
2312,金寶,15,10,5,凱基-永和,2023-12-08,9207
2462,良得電,5,0,5,凱基-永和,2023-12-08,9207
2486,一詮,5,0,5,凱基-永和,2023-12-08,9207
2516,新建,532,5,527,凱基-永和,2023-12-11,9207
5521,工信,196,20,176,凱基-永和,2023-12-11,9207
6285,啟��,177,2,175,凱基-永和,2023-12-11,9207
00919,群益台灣精選高息,146,5,141,凱基-永和,2023-12-11,9207
4908,前鼎,126,3,123,凱基-永和,2023-12-11,9207
2363,矽統,104,5,99,凱基-永和,2023-12-11,9207
2376,技嘉,81,2,79,凱基-永和,2023-12-11,9207
3191,雲嘉南,78,0,78,凱基-永和,2023-12-11,9207
2329,華泰,98,27,71,凱基-永和,2023-12-11,9207
4979,華星光,100,32,68,凱基-永和,2023-12-11,9207
3694,海華,71,11,60,凱基-永和,2023-12-11,9207
2543,皇昌,51,0,51,凱基-永和,2023-12-11,9207
3545,敦泰,50,0,50,凱基-永和,2023-12-11,9207
8201,無敵,50,0,50,凱基-永和,2023-12-11,9207
2002,中鋼,48,0,48,凱基-永和,2023-12-11,9207
00720B,元大投資級公司債,47,0,47,凱基-永和,2023-12-11,9207
2888,新光金,70,25,45,凱基-永和,2023-12-11,9207
00929,復華台灣科技優息,42,3,39,凱基-永和,2023-12-11,9207
00882,中信中國高股息,36,1,35,凱基-永和,2023-12-11,9207
3005,神基,30,0,30,凱基-永和,2023-12-11,9207
3036,文曄,30,0,30,凱基-永和,2023-12-11,9207
3363,上詮,30,0,30,凱基-永和,2023-12-11,9207
6588,東典光電,30,0,30,凱基-永和,2023-12-11,9207
3231,緯創,28,1,27,凱基-永和,2023-12-11,9207
00933B,國泰10Y+金融債,20,0,20,凱基-永和,2023-12-11,9207
1568,倉佑,20,2,18,凱基-永和,2023-12-11,9207
00918,大華優利高填息30,17,0,17,凱基-永和,2023-12-11,9207
5871,中租-KY,16,0,16,凱基-永和,2023-12-11,9207
2892,第一金,15,0,15,凱基-永和,2023-12-11,9207
2891,中信金,13,0,13,凱基-永和,2023-12-11,9207
6282,康舒,14,1,13,凱基-永和,2023-12-11,9207
00878,國泰永續高股息,12,0,12,凱基-永和,2023-12-11,9207
5355,佳總,13,1,12,凱基-永和,2023-12-11,9207
1101,台泥,11,0,11,凱基-永和,2023-12-11,9207
6593,台灣銘板,11,0,11,凱基-永和,2023-12-11,9207
00772B,中信高評級公司債,10,0,10,凱基-永和,2023-12-11,9207
3712,永崴投控,10,0,10,凱基-永和,2023-12-11,9207
6901,鑽石投資,10,0,10,凱基-永和,2023-12-11,9207
2867,三商壽,9,0,9,凱基-永和,2023-12-11,9207
00679B,元大美債20年,8,0,8,凱基-永和,2023-12-11,9207
00937B,群益ESG投等債20,22,14,8,凱基-永和,2023-12-11,9207
6643,M31,18,10,8,凱基-永和,2023-12-11,9207
00687B,國泰20年美債,7,0,7,凱基-永和,2023-12-11,9207
2458,義隆,7,0,7,凱基-永和,2023-12-11,9207
3041,揚智,7,0,7,凱基-永和,2023-12-11,9207
2454,聯發科,7,0,7,凱基-永和,2023-12-11,9207
00752,中信中國50,6,0,6,凱基-永和,2023-12-11,9207
2618,長榮航,14,8,6,凱基-永和,2023-12-11,9207
3508,位速,6,0,6,凱基-永和,2023-12-11,9207
6122,擎邦,6,0,6,凱基-永和,2023-12-11,9207
00919,群益台灣精選高息,213,9,204,凱基-永和,2023-12-12,9207
3702,大聯大,161,7,154,凱基-永和,2023-12-12,9207
6546,正基,125,5,120,凱基-永和,2023-12-12,9207
8068,全達,71,1,70,凱基-永和,2023-12-12,9207
6531,愛普*,54,5,49,凱基-永和,2023-12-12,9207
2543,皇昌,50,8,42,凱基-永和,2023-12-12,9207
2002,中鋼,38,0,38,凱基-永和,2023-12-12,9207
2427,三商電,36,1,35,凱基-永和,2023-12-12,9207
2618,長榮航,35,3,32,凱基-永和,2023-12-12,9207
3227,原相,30,1,29,凱基-永和,2023-12-12,9207
00687B,國泰20年美債,28,0,28,凱基-永和,2023-12-12,9207
00878,國泰永續高股息,25,0,25,凱基-永和,2023-12-12,9207
2344,華邦電,24,0,24,凱基-永和,2023-12-12,9207
3231,緯創,25,2,23,凱基-永和,2023-12-12,9207
2506,太設,20,0,20,凱基-永和,2023-12-12,9207
5880,合庫金,21,1,20,凱基-永和,2023-12-12,9207
6593,台灣銘板,30,11,19,凱基-永和,2023-12-12,9207
1101,台泥,22,4,18,凱基-永和,2023-12-12,9207
2888,新光金,15,0,15,凱基-永和,2023-12-12,9207
2356,英業達,25,13,12,凱基-永和,2023-12-12,9207
2903,遠百,12,0,12,凱基-永和,2023-12-12,9207
00632R,元大台灣50反1,10,0,10,凱基-永和,2023-12-12,9207
2481,強茂,10,0,10,凱基-永和,2023-12-12,9207
2537,聯上發,10,0,10,凱基-永和,2023-12-12,9207
2801,彰銀,10,0,10,凱基-永和,2023-12-12,9207
2845,遠東銀,10,0,10,凱基-永和,2023-12-12,9207
00713,元大台灣高息低波,8,0,8,凱基-永和,2023-12-12,9207
2316,楠梓電,8,0,8,凱基-永和,2023-12-12,9207
6282,康舒,7,0,7,凱基-永和,2023-12-12,9207
00931B,統一美債20年,7,0,7,凱基-永和,2023-12-12,9207
6488,環球晶,7,0,7,凱基-永和,2023-12-12,9207
9945,潤泰新,6,0,6,凱基-永和,2023-12-12,9207
1314,中石化,6,0,6,凱基-永和,2023-12-12,9207
00900,富邦特選高股息30,5,0,5,凱基-永和,2023-12-12,9207
3661,世芯-KY,5,0,5,凱基-永和,2023-12-12,9207
00882,中信中國高股息,5,0,5,凱基-永和,2023-12-12,9207
00905,FT臺灣Smart,5,0,5,凱基-永和,2023-12-12,9207
2101,南港,5,0,5,凱基-永和,2023-12-12,9207
2367,燿華,5,0,5,凱基-永和,2023-12-12,9207
3037,欣興,7,2,5,凱基-永和,2023-12-12,9207
3706,神達,5,0,5,凱基-永和,2023-12-12,9207
4105,東洋,5,0,5,凱基-永和,2023-12-12,9207
6235,華孚,5,0,5,凱基-永和,2023-12-12,9207
6275,元山,5,0,5,凱基-永和,2023-12-12,9207
6411,晶焱,5,0,5,凱基-永和,2023-12-12,9207
6643,M31,6,1,5,凱基-永和,2023-12-12,9207
8076,伍豐,5,0,5,凱基-永和,2023-12-12,9207
2347,聯強,7,2,5,凱基-永和,2023-12-12,9207
2887,台新金,5,0,5,凱基-永和,2023-12-12,9207
00637L,元大滬深300正2,5,1,4,凱基-永和,2023-12-12,9207
00632R,元大台灣50反1,421,0,421,凱基-永和,2023-12-13,9207
5521,工信,300,0,300,凱基-永和,2023-12-13,9207
2313,華通,283,16,267,凱基-永和,2023-12-13,9207
2363,矽統,140,7,133,凱基-永和,2023-12-13,9207
6546,正基,150,20,130,凱基-永和,2023-12-13,9207
2892,第一金,88,0,88,凱基-永和,2023-12-13,9207
2801,彰銀,88,2,86,凱基-永和,2023-12-13,9207
2329,華泰,73,3,70,凱基-永和,2023-12-13,9207
00918,大華優利高填息30,84,18,66,凱基-永和,2023-12-13,9207
00929,復華台灣科技優息,66,3,63,凱基-永和,2023-12-13,9207
2465,麗臺,60,0,60,凱基-永和,2023-12-13,9207
00919,群益台灣精選高息,60,1,59,凱基-永和,2023-12-13,9207
3390,旭軟,53,3,50,凱基-永和,2023-12-13,9207
00687B,國泰20年美債,46,1,45,凱基-永和,2023-12-13,9207
00878,國泰永續高股息,39,0,39,凱基-永和,2023-12-13,9207
2002,中鋼,33,0,33,凱基-永和,2023-12-13,9207
4770,上品,30,0,30,凱基-永和,2023-12-13,9207
5880,合庫金,30,0,30,凱基-永和,2023-12-13,9207
2618,長榮航,43,14,29,凱基-永和,2023-12-13,9207
3596,智易,60,31,29,凱基-永和,2023-12-13,9207
3715,定穎投控,31,9,22,凱基-永和,2023-12-13,9207
00937B,群益ESG投等債20,21,0,21,凱基-永和,2023-12-13,9207
1568,倉佑,20,0,20,凱基-永和,2023-12-13,9207
2506,太設,20,0,20,凱基-永和,2023-12-13,9207
6901,鑽石投資,20,0,20,凱基-永和,2023-12-13,9207
3035,智原,20,2,18,凱基-永和,2023-12-13,9207
6182,合晶,21,3,18,凱基-永和,2023-12-13,9207
3024,憶聲,17,0,17,凱基-永和,2023-12-13,9207
2201,裕隆,16,0,16,凱基-永和,2023-12-13,9207
2355,敬鵬,15,0,15,凱基-永和,2023-12-13,9207
00715L,期街口布蘭特正2,14,0,14,凱基-永和,2023-12-13,9207
2324,仁寶,21,7,14,凱基-永和,2023-12-13,9207
5871,中租-KY,13,0,13,凱基-永和,2023-12-13,9207
00915,凱基優選高股息30,12,1,11,凱基-永和,2023-12-13,9207
2516,新建,12,1,11,凱基-永和,2023-12-13,9207
2883,凱基金,15,4,11,凱基-永和,2023-12-13,9207
3548,兆利,11,0,11,凱基-永和,2023-12-13,9207
3712,永崴投控,11,0,11,凱基-永和,2023-12-13,9207
2359,所羅門,10,0,10,凱基-永和,2023-12-13,9207
2402,毅嘉,10,0,10,凱基-永和,2023-12-13,9207
3081,聯亞,11,1,10,凱基-永和,2023-12-13,9207
4979,華星光,11,1,10,凱基-永和,2023-12-13,9207
6443,元晶,10,0,10,凱基-永和,2023-12-13,9207
8034,榮群,16,6,10,凱基-永和,2023-12-13,9207
8046,南電,11,1,10,凱基-永和,2023-12-13,9207
9919,康那香,10,0,10,凱基-永和,2023-12-13,9207
2105,正新,9,0,9,凱基-永和,2023-12-13,9207
2486,一詮,13,4,9,凱基-永和,2023-12-13,9207
2347,聯強,11,2,9,凱基-永和,2023-12-13,9207
00642U,期元大S＆P石油,8,0,8,凱基-永和,2023-12-13,9207
2356,英業達,270,1,269,凱基-永和,2023-12-14,9207
2363,矽統,872,662,210,凱基-永和,2023-12-14,9207
00919,群益台灣精選高息,162,37,125,凱基-永和,2023-12-14,9207
6127,九豪,130,5,125,凱基-永和,2023-12-14,9207
00929,復華台灣科技優息,105,5,100,凱基-永和,2023-12-14,9207
5469,瀚宇博,80,0,80,凱基-永和,2023-12-14,9207
00687B,國泰20年美債,50,0,50,凱基-永和,2023-12-14,9207
6235,華孚,54,7,47,凱基-永和,2023-12-14,9207
3011,今皓,40,0,40,凱基-永和,2023-12-14,9207
6182,合晶,60,30,30,凱基-永和,2023-12-14,9207
8011,台通,33,3,30,凱基-永和,2023-12-14,9207
2498,宏達電,31,3,28,凱基-永和,2023-12-14,9207
6239,力成,29,2,27,凱基-永和,2023-12-14,9207
00679B,元大美債20年,29,3,26,凱基-永和,2023-12-14,9207
3596,智易,55,32,23,凱基-永和,2023-12-14,9207
00934,中信成長高股息,27,5,22,凱基-永和,2023-12-14,9207
3094,聯傑,23,2,21,凱基-永和,2023-12-14,9207
3325,旭品,20,0,20,凱基-永和,2023-12-14,9207
00680L,元大美債20正2,19,0,19,凱基-永和,2023-12-14,9207
2516,新建,20,1,19,凱基-永和,2023-12-14,9207
5230,雷笛克光學,19,0,19,凱基-永和,2023-12-14,9207
1503,士電,25,7,18,凱基-永和,2023-12-14,9207
6139,亞翔,31,14,17,凱基-永和,2023-12-14,9207
2359,所羅門,16,0,16,凱基-永和,2023-12-14,9207
3712,永崴投控,27,12,15,凱基-永和,2023-12-14,9207
5009,榮剛,20,5,15,凱基-永和,2023-12-14,9207
00850,元大臺灣ESG永續,15,0,15,凱基-永和,2023-12-14,9207
3231,緯創,68,53,15,凱基-永和,2023-12-14,9207
1477,聚陽,13,1,12,凱基-永和,2023-12-14,9207
3005,神基,31,19,12,凱基-永和,2023-12-14,9207
00662,富邦NASDAQ,11,0,11,凱基-永和,2023-12-14,9207
00632R,元大台灣50反1,21,10,11,凱基-永和,2023-12-14,9207
3483,力致,12,1,11,凱基-永和,2023-12-14,9207
2002,中鋼,11,0,11,凱基-永和,2023-12-14,9207
2388,威盛,11,1,10,凱基-永和,2023-12-14,9207
3380,明泰,10,0,10,凱基-永和,2023-12-14,9207
3694,海華,11,1,10,凱基-永和,2023-12-14,9207
6111,大宇資,10,0,10,凱基-永和,2023-12-14,9207
6770,力積電,10,0,10,凱基-永和,2023-12-14,9207
9945,潤泰新,10,0,10,凱基-永和,2023-12-14,9207
1324,地球,10,1,9,凱基-永和,2023-12-14,9207
6285,啟��,15,7,8,凱基-永和,2023-12-14,9207
2425,承啟,20,12,8,凱基-永和,2023-12-14,9207
4770,上品,8,0,8,凱基-永和,2023-12-14,9207
2353,宏��,14,7,7,凱基-永和,2023-12-14,9207
2419,仲琦,8,1,7,凱基-永和,2023-12-14,9207
3051,力特,7,0,7,凱基-永和,2023-12-14,9207
8110,華東,10,3,7,凱基-永和,2023-12-14,9207
2408,南亞科,9,3,6,凱基-永和,2023-12-14,9207
00904,新光臺灣半導體30,6,0,6,凱基-永和,2023-12-14,9207
2356,英業達,1395,1299,96,凱基-永和,2023-12-15,9207
2031,新光鋼,81,4,77,凱基-永和,2023-12-15,9207
00918,大華優利高填息30,41,0,41,凱基-永和,2023-12-15,9207
00679B,元大美債20年,52,13,39,凱基-永和,2023-12-15,9207
00929,復華台灣科技優息,56,21,35,凱基-永和,2023-12-15,9207
00934,中信成長高股息,31,1,30,凱基-永和,2023-12-15,9207
4564,元翎,30,0,30,凱基-永和,2023-12-15,9207
5351,鈺創,30,0,30,凱基-永和,2023-12-15,9207
6222,上揚,29,0,29,凱基-永和,2023-12-15,9207
3006,晶豪科,36,8,28,凱基-永和,2023-12-15,9207
00915,凱基優選高股息30,27,2,25,凱基-永和,2023-12-15,9207
2618,長榮航,26,1,25,凱基-永和,2023-12-15,9207
3702,大聯大,28,6,22,凱基-永和,2023-12-15,9207
00680L,元大美債20正2,22,0,22,凱基-永和,2023-12-15,9207
1584,精剛,25,3,22,凱基-永和,2023-12-15,9207
2201,裕隆,52,30,22,凱基-永和,2023-12-15,9207
3042,晶技,22,0,22,凱基-永和,2023-12-15,9207
3094,聯傑,20,0,20,凱基-永和,2023-12-15,9207
3390,旭軟,20,0,20,凱基-永和,2023-12-15,9207
3694,海華,26,10,16,凱基-永和,2023-12-15,9207
2530,華建,15,0,15,凱基-永和,2023-12-15,9207
5230,雷笛克光學,17,4,13,凱基-永和,2023-12-15,9207
3715,定穎投控,13,1,12,凱基-永和,2023-12-15,9207
2376,技嘉,13,1,12,凱基-永和,2023-12-15,9207
1802,台玻,12,0,12,凱基-永和,2023-12-15,9207
3264,欣銓,14,2,12,凱基-永和,2023-12-15,9207
3515,華擎,15,4,11,凱基-永和,2023-12-15,9207
2436,偉詮電,11,0,11,凱基-永和,2023-12-15,9207
6285,啟��,12,1,11,凱基-永和,2023-12-15,9207
9941,裕融,11,0,11,凱基-永和,2023-12-15,9207
00882,中信中國高股息,10,0,10,凱基-永和,2023-12-15,9207
00937B,群益ESG投等債20,10,0,10,凱基-永和,2023-12-15,9207
2367,燿華,19,9,10,凱基-永和,2023-12-15,9207
2472,立隆電,10,0,10,凱基-永和,2023-12-15,9207
2641,正德,10,0,10,凱基-永和,2023-12-15,9207
3011,今皓,10,0,10,凱基-永和,2023-12-15,9207
4939,亞電,10,0,10,凱基-永和,2023-12-15,9207
6412,群電,10,0,10,凱基-永和,2023-12-15,9207
6683,雍智科技,15,5,10,凱基-永和,2023-12-15,9207
2417,圓剛,10,2,8,凱基-永和,2023-12-15,9207
00930,永豐ESG低碳高息,7,0,7,凱基-永和,2023-12-15,9207
6509,聚和,9,2,7,凱基-永和,2023-12-15,9207
00751B,元大AAA至A公司債,6,0,6,凱基-永和,2023-12-15,9207
1513,中興電,6,0,6,凱基-永和,2023-12-15,9207
1582,信錦,6,0,6,凱基-永和,2023-12-15,9207
2371,大同,6,0,6,凱基-永和,2023-12-15,9207
2516,新建,6,0,6,凱基-永和,2023-12-15,9207
6469,大樹,6,0,6,凱基-永和,2023-12-15,9207
4763,材料-KY,12,6,6,凱基-永和,2023-12-15,9207
2303,聯電,23,18,5,凱基-永和,2023-12-15,9207
6285,啟��,153,2,151,凱基-永和,2023-12-18,9207
2505,國揚,251,101,150,凱基-永和,2023-12-18,9207
2324,仁寶,137,8,129,凱基-永和,2023-12-18,9207
2618,長榮航,111,13,98,凱基-永和,2023-12-18,9207
00929,復華台灣科技優息,80,15,65,凱基-永和,2023-12-18,9207
2030,彰源,80,21,59,凱基-永和,2023-12-18,9207
2002,中鋼,56,7,49,凱基-永和,2023-12-18,9207
00930,永豐ESG低碳高息,38,2,36,凱基-永和,2023-12-18,9207
2353,宏��,62,27,35,凱基-永和,2023-12-18,9207
3702,大聯大,75,44,31,凱基-永和,2023-12-18,9207
00756B,群益投等新興公債,29,0,29,凱基-永和,2023-12-18,9207
2645,長榮航太,28,2,26,凱基-永和,2023-12-18,9207
8068,全達,25,0,25,凱基-永和,2023-12-18,9207
3481,群創,21,1,20,凱基-永和,2023-12-18,9207
00933B,國泰10Y+金融債,20,0,20,凱基-永和,2023-12-18,9207
2867,三商壽,20,0,20,凱基-永和,2023-12-18,9207
00918,大華優利高填息30,18,0,18,凱基-永和,2023-12-18,9207
3041,揚智,18,0,18,凱基-永和,2023-12-18,9207
2610,華航,17,0,17,凱基-永和,2023-12-18,9207
00680L,元大美債20正2,17,1,16,凱基-永和,2023-12-18,9207
6556,勝品,11,0,11,凱基-永和,2023-12-18,9207
1608,華榮,11,0,11,凱基-永和,2023-12-18,9207
2606,裕民,11,0,11,凱基-永和,2023-12-18,9207
3034,聯詠,11,0,11,凱基-永和,2023-12-18,9207
00882,中信中國高股息,10,0,10,凱基-永和,2023-12-18,9207
1584,精剛,10,0,10,凱基-永和,2023-12-18,9207
2641,正德,11,1,10,凱基-永和,2023-12-18,9207
3532,台勝科,10,0,10,凱基-永和,2023-12-18,9207
5465,富驊,10,0,10,凱基-永和,2023-12-18,9207
9958,世紀鋼,12,3,9,凱基-永和,2023-12-18,9207
2313,華通,8,0,8,凱基-永和,2023-12-18,9207
2412,中華電,7,0,7,凱基-永和,2023-12-18,9207
00885,富邦越南,7,0,7,凱基-永和,2023-12-18,9207
2201,裕隆,8,1,7,凱基-永和,2023-12-18,9207
2367,燿華,7,0,7,凱基-永和,2023-12-18,9207
3047,訊舟,7,0,7,凱基-永和,2023-12-18,9207
00937B,群益ESG投等債20,17,11,6,凱基-永和,2023-12-18,9207
00915,凱基優選高股息30,6,0,6,凱基-永和,2023-12-18,9207
00936,台新永續高息中小,10,4,6,凱基-永和,2023-12-18,9207
2368,金像電,12,6,6,凱基-永和,2023-12-18,9207
3356,奇偶,7,1,6,凱基-永和,2023-12-18,9207
3715,定穎投控,7,2,5,凱基-永和,2023-12-18,9207
2454,聯發科,6,1,5,凱基-永和,2023-12-18,9207
1101,台泥,5,0,5,凱基-永和,2023-12-18,9207
1227,佳格,5,0,5,凱基-永和,2023-12-18,9207
2023,燁輝,9,4,5,凱基-永和,2023-12-18,9207
2345,智邦,5,0,5,凱基-永和,2023-12-18,9207
2363,矽統,15,10,5,凱基-永和,2023-12-18,9207
2812,台中銀,5,0,5,凱基-永和,2023-12-18,9207
3712,永崴投控,5,0,5,凱基-永和,2023-12-18,9207
00919,群益台灣精選高息,89,12,77,凱基-永和,2023-12-19,9207
2355,敬鵬,66,0,66,凱基-永和,2023-12-19,9207
00929,復華台灣科技優息,100,44,56,凱基-永和,2023-12-19,9207
8054,安國,52,3,49,凱基-永和,2023-12-19,9207
2101,南港,35,0,35,凱基-永和,2023-12-19,9207
3483,力致,38,3,35,凱基-永和,2023-12-19,9207
2812,台中銀,27,1,26,凱基-永和,2023-12-19,9207
3532,台勝科,27,1,26,凱基-永和,2023-12-19,9207
6901,鑽石投資,24,0,24,凱基-永和,2023-12-19,9207
00713,元大台灣高息低波,21,0,21,凱基-永和,2023-12-19,9207
2610,華航,20,0,20,凱基-永和,2023-12-19,9207
4979,華星光,20,1,19,凱基-永和,2023-12-19,9207
1474,弘裕,17,0,17,凱基-永和,2023-12-19,9207
2002,中鋼,19,3,16,凱基-永和,2023-12-19,9207
00679B,元大美債20年,17,2,15,凱基-永和,2023-12-19,9207
2903,遠百,15,0,15,凱基-永和,2023-12-19,9207
5880,合庫金,15,0,15,凱基-永和,2023-12-19,9207
8011,台通,15,0,15,凱基-永和,2023-12-19,9207
2482,連宇,14,0,14,凱基-永和,2023-12-19,9207
3715,定穎投控,15,1,14,凱基-永和,2023-12-19,9207
2724,藝舍-KY,13,0,13,凱基-永和,2023-12-19,9207
3024,憶聲,12,0,12,凱基-永和,2023-12-19,9207
1101,台泥,11,0,11,凱基-永和,2023-12-19,9207
6667,信紘科,11,0,11,凱基-永和,2023-12-19,9207
2014,中鴻,15,4,11,凱基-永和,2023-12-19,9207
00772B,中信高評級公司債,10,0,10,凱基-永和,2023-12-19,9207
00687B,國泰20年美債,10,0,10,凱基-永和,2023-12-19,9207
5876,上海商銀,10,0,10,凱基-永和,2023-12-19,9207
6770,力積電,10,0,10,凱基-永和,2023-12-19,9207
2618,長榮航,55,46,9,凱基-永和,2023-12-19,9207
0056,元大高股息,8,0,8,凱基-永和,2023-12-19,9207
2324,仁寶,8,1,7,凱基-永和,2023-12-19,9207
00712,復華富時不動產,7,0,7,凱基-永和,2023-12-19,9207
00934,中信成長高股息,6,0,6,凱基-永和,2023-12-19,9207
00680L,元大美債20正2,6,0,6,凱基-永和,2023-12-19,9207
1477,聚陽,6,0,6,凱基-永和,2023-12-19,9207
1513,中興電,6,0,6,凱基-永和,2023-12-19,9207
1584,精剛,6,0,6,凱基-永和,2023-12-19,9207
2891,中信金,8,2,6,凱基-永和,2023-12-19,9207
3051,力特,6,0,6,凱基-永和,2023-12-19,9207
00885,富邦越南,5,0,5,凱基-永和,2023-12-19,9207
00915,凱基優選高股息30,5,0,5,凱基-永和,2023-12-19,9207
1710,東聯,5,0,5,凱基-永和,2023-12-19,9207
2344,華邦電,6,1,5,凱基-永和,2023-12-19,9207
2359,所羅門,5,0,5,凱基-永和,2023-12-19,9207
2606,裕民,5,0,5,凱基-永和,2023-12-19,9207
2845,遠東銀,5,0,5,凱基-永和,2023-12-19,9207
2882,國泰金,5,0,5,凱基-永和,2023-12-19,9207
2913,農林,5,0,5,凱基-永和,2023-12-19,9207
3227,原相,5,0,5,凱基-永和,2023-12-19,9207
2353,宏��,834,42,792,凱基-永和,2023-12-20,9207
2356,英業達,513,249,264,凱基-永和,2023-12-20,9207
2324,仁寶,2091,1927,164,凱基-永和,2023-12-20,9207
2352,佳世達,100,6,94,凱基-永和,2023-12-20,9207
2888,新光金,85,0,85,凱基-永和,2023-12-20,9207
3652,精聯,61,0,61,凱基-永和,2023-12-20,9207
2449,京元電子,52,0,52,凱基-永和,2023-12-20,9207
00720B,元大投資級公司債,50,0,50,凱基-永和,2023-12-20,9207
3013,晟銘電,50,0,50,凱基-永和,2023-12-20,9207
8054,安國,50,2,48,凱基-永和,2023-12-20,9207
4979,華星光,40,1,39,凱基-永和,2023-12-20,9207
2867,三商壽,25,0,25,凱基-永和,2023-12-20,9207
6282,康舒,24,0,24,凱基-永和,2023-12-20,9207
00679B,元大美債20年,23,0,23,凱基-永和,2023-12-20,9207
3260,威剛,23,1,22,凱基-永和,2023-12-20,9207
2206,三陽工業,21,0,21,凱基-永和,2023-12-20,9207
6116,彩晶,20,0,20,凱基-永和,2023-12-20,9207
00919,群益台灣精選高息,56,37,19,凱基-永和,2023-12-20,9207
2347,聯強,18,0,18,凱基-永和,2023-12-20,9207
5880,合庫金,16,1,15,凱基-永和,2023-12-20,9207
00929,復華台灣科技優息,19,4,15,凱基-永和,2023-12-20,9207
3702,大聯大,44,30,14,凱基-永和,2023-12-20,9207
2891,中信金,27,14,13,凱基-永和,2023-12-20,9207
00937B,群益ESG投等債20,13,0,13,凱基-永和,2023-12-20,9207
2883,凱基金,12,0,12,凱基-永和,2023-12-20,9207
1477,聚陽,12,0,12,凱基-永和,2023-12-20,9207
00900,富邦特選高股息30,10,0,10,凱基-永和,2023-12-20,9207
1303,南亞,10,0,10,凱基-永和,2023-12-20,9207
6187,萬潤,10,0,10,凱基-永和,2023-12-20,9207
1101,台泥,13,4,9,凱基-永和,2023-12-20,9207
1905,華紙,10,2,8,凱基-永和,2023-12-20,9207
2880,華南金,8,0,8,凱基-永和,2023-12-20,9207
2313,華通,8,0,8,凱基-永和,2023-12-20,9207
2892,第一金,7,0,7,凱基-永和,2023-12-20,9207
00631L,元大台灣50正2,7,0,7,凱基-永和,2023-12-20,9207
2329,華泰,11,4,7,凱基-永和,2023-12-20,9207
2465,麗臺,7,0,7,凱基-永和,2023-12-20,9207
00930,永豐ESG低碳高息,6,0,6,凱基-永和,2023-12-20,9207
00936,台新永續高息中小,9,3,6,凱基-永和,2023-12-20,9207
3035,智原,12,6,6,凱基-永和,2023-12-20,9207
1218,泰山,5,0,5,凱基-永和,2023-12-20,9207
2007,燁興,5,0,5,凱基-永和,2023-12-20,9207
2038,海光,106,101,5,凱基-永和,2023-12-20,9207
2724,藝舍-KY,5,0,5,凱基-永和,2023-12-20,9207
3105,穩懋,7,2,5,凱基-永和,2023-12-20,9207
6233,旺玖,5,0,5,凱基-永和,2023-12-20,9207
2014,中鴻,10,6,4,凱基-永和,2023-12-20,9207
6139,亞翔,6,2,4,凱基-永和,2023-12-20,9207
2882,國泰金,4,0,4,凱基-永和,2023-12-20,9207
00662,富邦NASDAQ,4,0,4,凱基-永和,2023-12-20,9207
2324,仁寶,764,558,206,凱基-永和,2023-12-21,9207
2515,中工,205,3,202,凱基-永和,2023-12-21,9207
00642U,期元大S＆P石油,181,2,179,凱基-永和,2023-12-21,9207
4979,華星光,43,0,43,凱基-永和,2023-12-21,9207
6485,點序,42,0,42,凱基-永和,2023-12-21,9207
2344,華邦電,33,1,32,凱基-永和,2023-12-21,9207
00688L,國泰20年美債正2,29,0,29,凱基-永和,2023-12-21,9207
2888,新光金,25,2,23,凱基-永和,2023-12-21,9207
00687B,國泰20年美債,27,4,23,凱基-永和,2023-12-21,9207
2641,正德,27,4,23,凱基-永和,2023-12-21,9207
2317,鴻海,42,20,22,凱基-永和,2023-12-21,9207
2886,兆豐金,22,0,22,凱基-永和,2023-12-21,9207
2337,旺宏,21,1,20,凱基-永和,2023-12-21,9207
2891,中信金,23,4,19,凱基-永和,2023-12-21,9207
2606,裕民,27,9,18,凱基-永和,2023-12-21,9207
8034,榮群,17,0,17,凱基-永和,2023-12-21,9207
00929,復華台灣科技優息,38,22,16,凱基-永和,2023-12-21,9207
2362,藍天,15,0,15,凱基-永和,2023-12-21,9207
6684,安格,13,0,13,凱基-永和,2023-12-21,9207
2038,海光,13,0,13,凱基-永和,2023-12-21,9207
2409,友達,13,0,13,凱基-永和,2023-12-21,9207
00893,國泰智能電動車,10,0,10,凱基-永和,2023-12-21,9207
2485,兆赫,10,0,10,凱基-永和,2023-12-21,9207
2506,太設,30,20,10,凱基-永和,2023-12-21,9207
5236,凌陽創新,10,0,10,凱基-永和,2023-12-21,9207
6182,合晶,10,0,10,凱基-永和,2023-12-21,9207
6214,精誠,10,0,10,凱基-永和,2023-12-21,9207
1504,東元,9,0,9,凱基-永和,2023-12-21,9207
2352,佳世達,10,1,9,凱基-永和,2023-12-21,9207
2002,中鋼,11,3,8,凱基-永和,2023-12-21,9207
00937B,群益ESG投等債20,18,10,8,凱基-永和,2023-12-21,9207
00720B,元大投資級公司債,7,0,7,凱基-永和,2023-12-21,9207
2331,精英,14,7,7,凱基-永和,2023-12-21,9207
8054,安國,9,2,7,凱基-永和,2023-12-21,9207
9919,康那香,18,11,7,凱基-永和,2023-12-21,9207
2603,長榮,12,6,6,凱基-永和,2023-12-21,9207
00713,元大台灣高息低波,6,0,6,凱基-永和,2023-12-21,9207
00795B,中信美國公債20年,6,0,6,凱基-永和,2023-12-21,9207
3715,定穎投控,10,4,6,凱基-永和,2023-12-21,9207
6288,聯嘉,6,0,6,凱基-永和,2023-12-21,9207
8011,台通,6,0,6,凱基-永和,2023-12-21,9207
2330,台積電,6,0,6,凱基-永和,2023-12-21,9207
2303,聯電,6,1,5,凱基-永和,2023-12-21,9207
00756B,群益投等新興公債,5,0,5,凱基-永和,2023-12-21,9207
00753L,中信中國50正2,5,0,5,凱基-永和,2023-12-21,9207
1702,南僑,5,0,5,凱基-永和,2023-12-21,9207
1752,南光,5,0,5,凱基-永和,2023-12-21,9207
2007,燁興,5,0,5,凱基-永和,2023-12-21,9207
2504,國產,5,0,5,凱基-永和,2023-12-21,9207
3583,辛耘,5,0,5,凱基-永和,2023-12-21,9207
8277,商丞,151,5,146,凱基-永和,2023-12-22,9207
8054,安國,104,4,100,凱基-永和,2023-12-22,9207
3041,揚智,94,2,92,凱基-永和,2023-12-22,9207
00919,群益台灣精選高息,70,1,69,凱基-永和,2023-12-22,9207
6117,迎廣,61,0,61,凱基-永和,2023-12-22,9207
6245,立端,60,0,60,凱基-永和,2023-12-22,9207
8034,榮群,76,25,51,凱基-永和,2023-12-22,9207
2421,建準,228,178,50,凱基-永和,2023-12-22,9207
3005,神基,50,1,49,凱基-永和,2023-12-22,9207
2356,英業達,186,152,34,凱基-永和,2023-12-22,9207
2313,華通,31,1,30,凱基-永和,2023-12-22,9207
3362,先進光,26,2,24,凱基-永和,2023-12-22,9207
2347,聯強,26,3,23,凱基-永和,2023-12-22,9207
2337,旺宏,21,0,21,凱基-永和,2023-12-22,9207
1314,中石化,20,0,20,凱基-永和,2023-12-22,9207
3034,聯詠,20,0,20,凱基-永和,2023-12-22,9207
2408,南亞科,34,15,19,凱基-永和,2023-12-22,9207
6138,茂達,22,3,19,凱基-永和,2023-12-22,9207
2002,中鋼,19,0,19,凱基-永和,2023-12-22,9207
3231,緯創,22,5,17,凱基-永和,2023-12-22,9207
3481,群創,31,14,17,凱基-永和,2023-12-22,9207
4906,正文,16,0,16,凱基-永和,2023-12-22,9207
1101,台泥,15,0,15,凱基-永和,2023-12-22,9207
2368,金像電,15,0,15,凱基-永和,2023-12-22,9207
2455,全新,14,0,14,凱基-永和,2023-12-22,9207
00720B,元大投資級公司債,13,0,13,凱基-永和,2023-12-22,9207
00915,凱基優選高股息30,15,2,13,凱基-永和,2023-12-22,9207
1605,華新,12,0,12,凱基-永和,2023-12-22,9207
2353,宏��,273,261,12,凱基-永和,2023-12-22,9207
00929,復華台灣科技優息,11,0,11,凱基-永和,2023-12-22,9207
00937B,群益ESG投等債20,12,1,11,凱基-永和,2023-12-22,9207
2883,凱基金,11,0,11,凱基-永和,2023-12-22,9207
00679B,元大美債20年,12,1,11,凱基-永和,2023-12-22,9207
2324,仁寶,11,1,10,凱基-永和,2023-12-22,9207
2801,彰銀,10,0,10,凱基-永和,2023-12-22,9207
4938,和碩,10,0,10,凱基-永和,2023-12-22,9207
6505,台塑化,10,0,10,凱基-永和,2023-12-22,9207
8068,全達,15,5,10,凱基-永和,2023-12-22,9207
9103,美德醫療-DR,10,0,10,凱基-永和,2023-12-22,9207
2458,義隆,11,2,9,凱基-永和,2023-12-22,9207
00752,中信中國50,8,0,8,凱基-永和,2023-12-22,9207
9904,寶成,8,0,8,凱基-永和,2023-12-22,9207
2382,廣達,12,4,8,凱基-永和,2023-12-22,9207
00936,台新永續高息中小,6,0,6,凱基-永和,2023-12-22,9207
3715,定穎投控,12,6,6,凱基-永和,2023-12-22,9207
5009,榮剛,6,0,6,凱基-永和,2023-12-22,9207
9933,中鼎,5,0,5,凱基-永和,2023-12-22,9207
00772B,中信高評級公司債,5,0,5,凱基-永和,2023-12-22,9207
00680L,元大美債20正2,5,0,5,凱基-永和,2023-12-22,9207
1560,中砂,5,0,5,凱基-永和,2023-12-22,9207
3481,群創,123,15,108,凱基-永和,2023-12-25,9207
00919,群益台灣精選高息,99,4,95,凱基-永和,2023-12-25,9207
2609,陽明,111,39,72,凱基-永和,2023-12-25,9207
00937B,群益ESG投等債20,78,8,70,凱基-永和,2023-12-25,9207
6770,力積電,50,0,50,凱基-永和,2023-12-25,9207
6245,立端,50,5,45,凱基-永和,2023-12-25,9207
8034,榮群,55,16,39,凱基-永和,2023-12-25,9207
3008,大立光,36,0,36,凱基-永和,2023-12-25,9207
3706,神達,25,0,25,凱基-永和,2023-12-25,9207
2362,藍天,24,2,22,凱基-永和,2023-12-25,9207
3325,旭品,21,2,19,凱基-永和,2023-12-25,9207
00679B,元大美債20年,19,2,17,凱基-永和,2023-12-25,9207
3702,大聯大,15,0,15,凱基-永和,2023-12-25,9207
2356,英業達,92,78,14,凱基-永和,2023-12-25,9207
00687B,國泰20年美債,15,2,13,凱基-永和,2023-12-25,9207
2498,宏達電,22,9,13,凱基-永和,2023-12-25,9207
2605,新興,14,2,12,凱基-永和,2023-12-25,9207
4755,三福化,12,0,12,凱基-永和,2023-12-25,9207
00900,富邦特選高股息30,11,0,11,凱基-永和,2023-12-25,9207
00720B,元大投資級公司債,12,1,11,凱基-永和,2023-12-25,9207
2102,泰豐,11,0,11,凱基-永和,2023-12-25,9207
2610,華航,26,15,11,凱基-永和,2023-12-25,9207
1325,恆大,12,2,10,凱基-永和,2023-12-25,9207
00688L,國泰20年美債正2,10,0,10,凱基-永和,2023-12-25,9207
2504,國產,10,0,10,凱基-永和,2023-12-25,9207
3489,森寶,10,0,10,凱基-永和,2023-12-25,9207
3712,永崴投控,10,0,10,凱基-永和,2023-12-25,9207
6288,聯嘉,10,1,9,凱基-永和,2023-12-25,9207
00893,國泰智能電動車,10,2,8,凱基-永和,2023-12-25,9207
1101,台泥,12,4,8,凱基-永和,2023-12-25,9207
2359,所羅門,8,0,8,凱基-永和,2023-12-25,9207
8011,台通,8,0,8,凱基-永和,2023-12-25,9207
00662,富邦NASDAQ,7,0,7,凱基-永和,2023-12-25,9207
1795,美時,6,0,6,凱基-永和,2023-12-25,9207
2388,威盛,8,2,6,凱基-永和,2023-12-25,9207
2439,美律,6,0,6,凱基-永和,2023-12-25,9207
3047,訊舟,10,4,6,凱基-永和,2023-12-25,9207
8358,金居,6,0,6,凱基-永和,2023-12-25,9207
00929,復華台灣科技優息,6,1,5,凱基-永和,2023-12-25,9207
00885,富邦越南,5,0,5,凱基-永和,2023-12-25,9207
1727,中華化,5,0,5,凱基-永和,2023-12-25,9207
6438,迅得,5,0,5,凱基-永和,2023-12-25,9207
2637,慧洋-KY,5,0,5,凱基-永和,2023-12-25,9207
1605,華新,4,0,4,凱基-永和,2023-12-25,9207
2884,玉山金,4,0,4,凱基-永和,2023-12-25,9207
3522,御嵿,4,0,4,凱基-永和,2023-12-25,9207
6122,擎邦,4,0,4,凱基-永和,2023-12-25,9207
8112,至上,5,1,4,凱基-永和,2023-12-25,9207
8916,光隆,5,1,4,凱基-永和,2023-12-25,9207
2357,華碩,4,0,4,凱基-永和,2023-12-25,9207
3231,緯創,236,10,226,凱基-永和,2023-12-26,9207
2324,仁寶,551,362,189,凱基-永和,2023-12-26,9207
2610,華航,140,9,131,凱基-永和,2023-12-26,9207
3437,榮創,90,0,90,凱基-永和,2023-12-26,9207
00919,群益台灣精選高息,80,13,67,凱基-永和,2023-12-26,9207
4979,華星光,47,6,41,凱基-永和,2023-12-26,9207
3029,零壹,40,0,40,凱基-永和,2023-12-26,9207
2313,華通,40,2,38,凱基-永和,2023-12-26,9207
00937B,群益ESG投等債20,27,0,27,凱基-永和,2023-12-26,9207
3443,創意,25,1,24,凱基-永和,2023-12-26,9207
2002,中鋼,20,0,20,凱基-永和,2023-12-26,9207
9958,世紀鋼,20,0,20,凱基-永和,2023-12-26,9207
2356,英業達,30,11,19,凱基-永和,2023-12-26,9207
1718,中纖,10,0,10,凱基-永和,2023-12-26,9207
2362,藍天,10,0,10,凱基-永和,2023-12-26,9207
3042,晶技,10,0,10,凱基-永和,2023-12-26,9207
00687B,國泰20年美債,15,6,9,凱基-永和,2023-12-26,9207
00662,富邦NASDAQ,9,0,9,凱基-永和,2023-12-26,9207
00720B,元大投資級公司債,9,0,9,凱基-永和,2023-12-26,9207
2032,新鋼,9,0,9,凱基-永和,2023-12-26,9207
6116,彩晶,10,1,9,凱基-永和,2023-12-26,9207
2515,中工,10,2,8,凱基-永和,2023-12-26,9207
6469,大樹,8,0,8,凱基-永和,2023-12-26,9207
8210,勤誠,8,0,8,凱基-永和,2023-12-26,9207
1477,聚陽,7,0,7,凱基-永和,2023-12-26,9207
00885,富邦越南,7,0,7,凱基-永和,2023-12-26,9207
1503,士電,9,2,7,凱基-永和,2023-12-26,9207
00751B,元大AAA至A公司債,6,0,6,凱基-永和,2023-12-26,9207
2607,榮運,6,0,6,凱基-永和,2023-12-26,9207
8034,榮群,10,4,6,凱基-永和,2023-12-26,9207
00632R,元大台灣50反1,5,0,5,凱基-永和,2023-12-26,9207
1513,中興電,5,0,5,凱基-永和,2023-12-26,9207
1905,華紙,5,0,5,凱基-永和,2023-12-26,9207
5351,鈺創,5,0,5,凱基-永和,2023-12-26,9207
1319,東陽,4,0,4,凱基-永和,2023-12-26,9207
00688L,國泰20年美債正2,4,0,4,凱基-永和,2023-12-26,9207
00936,台新永續高息中小,4,0,4,凱基-永和,2023-12-26,9207
1605,華新,4,0,4,凱基-永和,2023-12-26,9207
5871,中租-KY,4,0,4,凱基-永和,2023-12-26,9207
6477,安集,4,0,4,凱基-永和,2023-12-26,9207
2618,長榮航,4,1,3,凱基-永和,2023-12-26,9207
1727,中華化,3,0,3,凱基-永和,2023-12-26,9207
2476,鉅祥,3,0,3,凱基-永和,2023-12-26,9207
2509,全坤建,3,0,3,凱基-永和,2023-12-26,9207
2542,興富發,3,0,3,凱基-永和,2023-12-26,9207
3324,雙鴻,3,0,3,凱基-永和,2023-12-26,9207
4967,十銓,3,0,3,凱基-永和,2023-12-26,9207
6416,瑞祺電通,3,0,3,凱基-永和,2023-12-26,9207
8432,東生華,3,0,3,凱基-永和,2023-12-26,9207
00929,復華台灣科技優息,7,5,2,凱基-永和,2023-12-26,9207
3006,晶豪科,573,5,568,凱基-永和,2023-12-27,9207
8096,擎亞,727,200,527,凱基-永和,2023-12-27,9207
2449,京元電子,75,2,73,凱基-永和,2023-12-27,9207
3450,聯鈞,59,0,59,凱基-永和,2023-12-27,9207
2362,藍天,48,0,48,凱基-永和,2023-12-27,9207
2421,建準,50,2,48,凱基-永和,2023-12-27,9207
00937B,群益ESG投等債20,39,5,34,凱基-永和,2023-12-27,9207
6531,愛普*,53,19,34,凱基-永和,2023-12-27,9207
2610,華航,51,20,31,凱基-永和,2023-12-27,9207
00919,群益台灣精選高息,34,4,30,凱基-永和,2023-12-27,9207
2867,三商壽,25,0,25,凱基-永和,2023-12-27,9207
00632R,元大台灣50反1,21,0,21,凱基-永和,2023-12-27,9207
3481,群創,21,0,21,凱基-永和,2023-12-27,9207
2368,金像電,21,6,15,凱基-永和,2023-12-27,9207
2515,中工,15,0,15,凱基-永和,2023-12-27,9207
3325,旭品,21,6,15,凱基-永和,2023-12-27,9207
2002,中鋼,14,0,14,凱基-永和,2023-12-27,9207
2014,中鴻,15,1,14,凱基-永和,2023-12-27,9207
00936,台新永續高息中小,13,0,13,凱基-永和,2023-12-27,9207
6684,安格,13,0,13,凱基-永和,2023-12-27,9207
1101,台泥,12,0,12,凱基-永和,2023-12-27,9207
00688L,國泰20年美債正2,11,0,11,凱基-永和,2023-12-27,9207
00929,復華台灣科技優息,10,0,10,凱基-永和,2023-12-27,9207
00893,國泰智能電動車,10,0,10,凱基-永和,2023-12-27,9207
2402,毅嘉,10,0,10,凱基-永和,2023-12-27,9207
2890,永豐金,10,0,10,凱基-永和,2023-12-27,9207
3231,緯創,12,3,9,凱基-永和,2023-12-27,9207
1717,長興,10,1,9,凱基-永和,2023-12-27,9207
2618,長榮航,9,1,8,凱基-永和,2023-12-27,9207
3588,通嘉,9,2,7,凱基-永和,2023-12-27,9207
2340,台亞,7,0,7,凱基-永和,2023-12-27,9207
3380,明泰,7,0,7,凱基-永和,2023-12-27,9207
2465,麗臺,6,0,6,凱基-永和,2023-12-27,9207
00922,國泰台灣領袖50,10,4,6,凱基-永和,2023-12-27,9207
6415,矽力*-KY,6,0,6,凱基-永和,2023-12-27,9207
6419,京晨科,6,0,6,凱基-永和,2023-12-27,9207
8112,至上,9,3,6,凱基-永和,2023-12-27,9207
8114,振樺電,5,0,5,凱基-永和,2023-12-27,9207
1474,弘裕,5,0,5,凱基-永和,2023-12-27,9207
1905,華紙,5,0,5,凱基-永和,2023-12-27,9207
2457,飛宏,5,0,5,凱基-永和,2023-12-27,9207
5351,鈺創,5,0,5,凱基-永和,2023-12-27,9207
6191,精成科,8,3,5,凱基-永和,2023-12-27,9207
6245,立端,5,0,5,凱基-永和,2023-12-27,9207
1321,大洋,4,0,4,凱基-永和,2023-12-27,9207
2314,台揚,4,0,4,凱基-永和,2023-12-27,9207
2371,大同,4,0,4,凱基-永和,2023-12-27,9207
5230,雷笛克光學,4,0,4,凱基-永和,2023-12-27,9207
6109,亞元,4,0,4,凱基-永和,2023-12-27,9207
00931B,統一美債20年,3,0,3,凱基-永和,2023-12-27,9207
00632R,元大台灣50反1,505,0,505,凱基-永和,2023-12-28,9207
2101,南港,411,4,407,凱基-永和,2023-12-28,9207
2303,聯電,153,83,70,凱基-永和,2023-12-28,9207
1514,亞力,60,4,56,凱基-永和,2023-12-28,9207
3706,神達,81,34,47,凱基-永和,2023-12-28,9207
5516,雙喜,46,0,46,凱基-永和,2023-12-28,9207
00919,群益台灣精選高息,62,17,45,凱基-永和,2023-12-28,9207
3450,聯鈞,40,1,39,凱基-永和,2023-12-28,9207
6139,亞翔,38,3,35,凱基-永和,2023-12-28,9207
00937B,群益ESG投等債20,25,0,25,凱基-永和,2023-12-28,9207
3284,太普高,24,0,24,凱基-永和,2023-12-28,9207
2356,英業達,76,54,22,凱基-永和,2023-12-28,9207
00933B,國泰10Y+金融債,19,0,19,凱基-永和,2023-12-28,9207
00687B,國泰20年美債,19,0,19,凱基-永和,2023-12-28,9207
6187,萬潤,22,3,19,凱基-永和,2023-12-28,9207
2603,長榮,20,3,17,凱基-永和,2023-12-28,9207
00679B,元大美債20年,16,0,16,凱基-永和,2023-12-28,9207
2439,美律,15,0,15,凱基-永和,2023-12-28,9207
2515,中工,15,0,15,凱基-永和,2023-12-28,9207
2867,三商壽,15,0,15,凱基-永和,2023-12-28,9207
1522,堤維西,11,0,11,凱基-永和,2023-12-28,9207
6179,亞通,11,0,11,凱基-永和,2023-12-28,9207
6469,大樹,11,0,11,凱基-永和,2023-12-28,9207
2324,仁寶,19,9,10,凱基-永和,2023-12-28,9207
1460,宏遠,10,0,10,凱基-永和,2023-12-28,9207
3441,聯一光,10,0,10,凱基-永和,2023-12-28,9207
6667,信紘科,10,0,10,凱基-永和,2023-12-28,9207
6684,安格,10,0,10,凱基-永和,2023-12-28,9207
3413,京鼎,10,0,10,凱基-永和,2023-12-28,9207
3036,文曄,11,2,9,凱基-永和,2023-12-28,9207
00918,大華優利高填息30,8,0,8,凱基-永和,2023-12-28,9207
2405,輔信,8,0,8,凱基-永和,2023-12-28,9207
00662,富邦NASDAQ,7,0,7,凱基-永和,2023-12-28,9207
3035,智原,13,6,7,凱基-永和,2023-12-28,9207
3017,奇鋐,9,3,6,凱基-永和,2023-12-28,9207
00936,台新永續高息中小,6,0,6,凱基-永和,2023-12-28,9207
00934,中信成長高股息,6,0,6,凱基-永和,2023-12-28,9207
1568,倉佑,6,0,6,凱基-永和,2023-12-28,9207
2009,第一銅,6,0,6,凱基-永和,2023-12-28,9207
00882,中信中國高股息,5,0,5,凱基-永和,2023-12-28,9207
1313,聯成,5,0,5,凱基-永和,2023-12-28,9207
00772B,中信高評級公司債,5,0,5,凱基-永和,2023-12-28,9207
00720B,元大投資級公司債,5,0,5,凱基-永和,2023-12-28,9207
1582,信錦,5,0,5,凱基-永和,2023-12-28,9207
2332,友訊,5,0,5,凱基-永和,2023-12-28,9207
3024,憶聲,12,7,5,凱基-永和,2023-12-28,9207
3041,揚智,5,0,5,凱基-永和,2023-12-28,9207
3338,泰碩,7,2,5,凱基-永和,2023-12-28,9207
5471,松翰,5,0,5,凱基-永和,2023-12-28,9207
6245,立端,5,0,5,凱基-永和,2023-12-28,9207
2352,佳世達,606,19,587,凱基-永和,2023-12-29,9207
5521,工信,562,206,356,凱基-永和,2023-12-29,9207
2101,南港,196,4,192,凱基-永和,2023-12-29,9207
3005,神基,100,2,98,凱基-永和,2023-12-29,9207
3706,神達,112,17,95,凱基-永和,2023-12-29,9207
2353,宏��,135,53,82,凱基-永和,2023-12-29,9207
5469,瀚宇博,66,0,66,凱基-永和,2023-12-29,9207
3088,艾訊,43,0,43,凱基-永和,2023-12-29,9207
00937B,群益ESG投等債20,47,12,35,凱基-永和,2023-12-29,9207
00930,永豐ESG低碳高息,32,0,32,凱基-永和,2023-12-29,9207
2492,華新科,31,0,31,凱基-永和,2023-12-29,9207
2867,三商壽,30,0,30,凱基-永和,2023-12-29,9207
2706,第一店,28,1,27,凱基-永和,2023-12-29,9207
6684,安格,26,0,26,凱基-永和,2023-12-29,9207
2356,英業達,65,39,26,凱基-永和,2023-12-29,9207
1101,台泥,21,0,21,凱基-永和,2023-12-29,9207
1503,士電,52,31,21,凱基-永和,2023-12-29,9207
2449,京元電子,20,1,19,凱基-永和,2023-12-29,9207
00885,富邦越南,18,0,18,凱基-永和,2023-12-29,9207
3044,健鼎,20,2,18,凱基-永和,2023-12-29,9207
00923,群益台ESG低碳50,17,0,17,凱基-永和,2023-12-29,9207
1513,中興電,17,0,17,凱基-永和,2023-12-29,9207
00764B,群益25年美債,16,0,16,凱基-永和,2023-12-29,9207
3694,海華,25,9,16,凱基-永和,2023-12-29,9207
00919,群益台灣精選高息,42,26,16,凱基-永和,2023-12-29,9207
2303,聯電,22,7,15,凱基-永和,2023-12-29,9207
00934,中信成長高股息,15,0,15,凱基-永和,2023-12-29,9207
5439,高技,15,0,15,凱基-永和,2023-12-29,9207
2330,台積電,15,1,14,凱基-永和,2023-12-29,9207
2365,昆盈,13,1,12,凱基-永和,2023-12-29,9207
5516,雙喜,12,0,12,凱基-永和,2023-12-29,9207
00882,中信中國高股息,10,0,10,凱基-永和,2023-12-29,9207
1314,中石化,10,0,10,凱基-永和,2023-12-29,9207
1522,堤維西,11,1,10,凱基-永和,2023-12-29,9207
1810,和成,10,0,10,凱基-永和,2023-12-29,9207
2368,金像電,11,1,10,凱基-永和,2023-12-29,9207
3041,揚智,15,5,10,凱基-永和,2023-12-29,9207
6274,台燿,10,0,10,凱基-永和,2023-12-29,9207
5488,松普,8,0,8,凱基-永和,2023-12-29,9207
00935,野村臺灣新科技50,10,3,7,凱基-永和,2023-12-29,9207
2630,亞航,7,0,7,凱基-永和,2023-12-29,9207
1477,聚陽,7,1,6,凱基-永和,2023-12-29,9207
2472,立隆電,8,2,6,凱基-永和,2023-12-29,9207
6461,益得,6,0,6,凱基-永和,2023-12-29,9207
1218,泰山,5,0,5,凱基-永和,2023-12-29,9207
00720B,元大投資級公司債,5,0,5,凱基-永和,2023-12-29,9207
1504,東元,12,7,5,凱基-永和,2023-12-29,9207
1605,華新,5,0,5,凱基-永和,2023-12-29,9207
2064,晉椿,5,0,5,凱基-永和,2023-12-29,9207
2891B,中信金乙特,5,0,5,凱基-永和,2023-12-29,9207
2486,一詮,1012,21,991,凱基-永和,2024-01-02,9207
00937B,群益ESG投等債20,135,45,90,凱基-永和,2024-01-02,9207
00919,群益台灣精選高息,86,3,83,凱基-永和,2024-01-02,9207
6117,迎廣,66,0,66,凱基-永和,2024-01-02,9207
3231,緯創,75,13,62,凱基-永和,2024-01-02,9207
3390,旭軟,81,30,51,凱基-永和,2024-01-02,9207
00929,復華台灣科技優息,58,8,50,凱基-永和,2024-01-02,9207
6122,擎邦,50,2,48,凱基-永和,2024-01-02,9207
00878,國泰永續高股息,36,8,28,凱基-永和,2024-01-02,9207
00687B,國泰20年美債,28,0,28,凱基-永和,2024-01-02,9207
00931B,統一美債20年,26,0,26,凱基-永和,2024-01-02,9207
00679B,元大美債20年,24,0,24,凱基-永和,2024-01-02,9207
0056,元大高股息,25,2,23,凱基-永和,2024-01-02,9207
2609,陽明,67,45,22,凱基-永和,2024-01-02,9207
2356,英業達,31,11,20,凱基-永和,2024-01-02,9207
2002,中鋼,19,1,18,凱基-永和,2024-01-02,9207
2344,華邦電,20,2,18,凱基-永和,2024-01-02,9207
00688L,國泰20年美債正2,17,0,17,凱基-永和,2024-01-02,9207
2382,廣達,18,3,15,凱基-永和,2024-01-02,9207
2331,精英,20,5,15,凱基-永和,2024-01-02,9207
00921,兆豐龍頭等權重,12,0,12,凱基-永和,2024-01-02,9207
2376,技嘉,15,3,12,凱基-永和,2024-01-02,9207
2208,台船,11,0,11,凱基-永和,2024-01-02,9207
2352,佳世達,26,15,11,凱基-永和,2024-01-02,9207
4939,亞電,20,9,11,凱基-永和,2024-01-02,9207
00893,國泰智能電動車,10,0,10,凱基-永和,2024-01-02,9207
2314,台揚,10,0,10,凱基-永和,2024-01-02,9207
5607,遠雄港,10,0,10,凱基-永和,2024-01-02,9207
8110,華東,10,0,10,凱基-永和,2024-01-02,9207
00720B,元大投資級公司債,9,0,9,凱基-永和,2024-01-02,9207
6235,華孚,11,3,8,凱基-永和,2024-01-02,9207
00922,國泰台灣領袖50,6,0,6,凱基-永和,2024-01-02,9207
1416,廣豐,6,0,6,凱基-永和,2024-01-02,9207
2363,矽統,6,0,6,凱基-永和,2024-01-02,9207
3006,晶豪科,7,2,5,凱基-永和,2024-01-02,9207
00751B,元大AAA至A公司債,5,0,5,凱基-永和,2024-01-02,9207
00885,富邦越南,5,0,5,凱基-永和,2024-01-02,9207
00904,新光臺灣半導體30,5,0,5,凱基-永和,2024-01-02,9207
1618,合機,6,1,5,凱基-永和,2024-01-02,9207
2020,美亞,5,0,5,凱基-永和,2024-01-02,9207
2362,藍天,9,4,5,凱基-永和,2024-01-02,9207
2739,寒舍,7,2,5,凱基-永和,2024-01-02,9207
3062,建漢,5,0,5,凱基-永和,2024-01-02,9207
3205,佰研,5,0,5,凱基-永和,2024-01-02,9207
6168,宏齊,5,0,5,凱基-永和,2024-01-02,9207
6290,良維,5,0,5,凱基-永和,2024-01-02,9207
8092,建暐,5,0,5,凱基-永和,2024-01-02,9207
8277,商丞,5,0,5,凱基-永和,2024-01-02,9207
00900,富邦特選高股息30,4,0,4,凱基-永和,2024-01-02,9207
1737,臺鹽,4,0,4,凱基-永和,2024-01-02,9207
8096,擎亞,239,3,236,凱基-永和,2024-01-03,9207
9919,康那香,201,16,185,凱基-永和,2024-01-03,9207
8358,金居,93,0,93,凱基-永和,2024-01-03,9207
00929,復華台灣科技優息,92,0,92,凱基-永和,2024-01-03,9207
0056,元大高股息,64,2,62,凱基-永和,2024-01-03,9207
2331,精英,98,38,60,凱基-永和,2024-01-03,9207
3406,玉晶光,50,0,50,凱基-永和,2024-01-03,9207
00937B,群益ESG投等債20,47,0,47,凱基-永和,2024-01-03,9207
00919,群益台灣精選高息,51,5,46,凱基-永和,2024-01-03,9207
2885,元大金,36,0,36,凱基-永和,2024-01-03,9207
2101,南港,35,0,35,凱基-永和,2024-01-03,9207
2505,國揚,30,0,30,凱基-永和,2024-01-03,9207
6284,佳邦,33,3,30,凱基-永和,2024-01-03,9207
4768,晶呈科技,28,0,28,凱基-永和,2024-01-03,9207
2002,中鋼,27,1,26,凱基-永和,2024-01-03,9207
2467,志聖,25,0,25,凱基-永和,2024-01-03,9207
00720B,元大投資級公司債,24,0,24,凱基-永和,2024-01-03,9207
00679B,元大美債20年,26,2,24,凱基-永和,2024-01-03,9207
2408,南亞科,24,0,24,凱基-永和,2024-01-03,9207
2303,聯電,25,1,24,凱基-永和,2024-01-03,9207
00882,中信中國高股息,23,0,23,凱基-永和,2024-01-03,9207
3522,御嵿,22,1,21,凱基-永和,2024-01-03,9207
1314,中石化,20,0,20,凱基-永和,2024-01-03,9207
1714,和桐,20,0,20,凱基-永和,2024-01-03,9207
1907,永豐餘,20,0,20,凱基-永和,2024-01-03,9207
2323,中環,20,0,20,凱基-永和,2024-01-03,9207
2351,順德,19,0,19,凱基-永和,2024-01-03,9207
2618,長榮航,20,2,18,凱基-永和,2024-01-03,9207
2313,華通,16,0,16,凱基-永和,2024-01-03,9207
00642U,期元大S＆P石油,14,0,14,凱基-永和,2024-01-03,9207
2201,裕隆,15,1,14,凱基-永和,2024-01-03,9207
00881,國泰台灣5G+,14,0,14,凱基-永和,2024-01-03,9207
1101,台泥,12,0,12,凱基-永和,2024-01-03,9207
2330,台積電,12,0,12,凱基-永和,2024-01-03,9207
00934,中信成長高股息,11,0,11,凱基-永和,2024-01-03,9207
6901,鑽石投資,11,0,11,凱基-永和,2024-01-03,9207
2892,第一金,10,0,10,凱基-永和,2024-01-03,9207
00935,野村臺灣新科技50,10,0,10,凱基-永和,2024-01-03,9207
00931B,統一美債20年,10,0,10,凱基-永和,2024-01-03,9207
00885,富邦越南,10,0,10,凱基-永和,2024-01-03,9207
00751B,元大AAA至A公司債,10,0,10,凱基-永和,2024-01-03,9207
2883,凱基金,11,1,10,凱基-永和,2024-01-03,9207
6163,華電網,10,0,10,凱基-永和,2024-01-03,9207
6191,精成科,10,0,10,凱基-永和,2024-01-03,9207
1477,聚陽,9,0,9,凱基-永和,2024-01-03,9207
00688L,國泰20年美債正2,8,0,8,凱基-永和,2024-01-03,9207
3037,欣興,9,1,8,凱基-永和,2024-01-03,9207
3548,兆利,8,0,8,凱基-永和,2024-01-03,9207
4763,材料-KY,8,0,8,凱基-永和,2024-01-03,9207
00915,凱基優選高股息30,7,0,7,凱基-永和,2024-01-03,9207
8096,擎亞,150,0,150,凱基-永和,2024-01-04,9207
3088,艾訊,64,0,64,凱基-永和,2024-01-04,9207
2486,一詮,70,7,63,凱基-永和,2024-01-04,9207
00929,復華台灣科技優息,61,0,61,凱基-永和,2024-01-04,9207
2505,國揚,60,0,60,凱基-永和,2024-01-04,9207
00937B,群益ESG投等債20,52,0,52,凱基-永和,2024-01-04,9207
3005,神基,50,0,50,凱基-永和,2024-01-04,9207
6284,佳邦,35,2,33,凱基-永和,2024-01-04,9207
00927,群益半導體收益,31,0,31,凱基-永和,2024-01-04,9207
8089,康全電訊,30,0,30,凱基-永和,2024-01-04,9207
3623,富晶通,27,0,27,凱基-永和,2024-01-04,9207
3712,永崴投控,25,0,25,凱基-永和,2024-01-04,9207
3232,昱捷,24,0,24,凱基-永和,2024-01-04,9207
3522,御嵿,24,0,24,凱基-永和,2024-01-04,9207
2344,華邦電,22,0,22,凱基-永和,2024-01-04,9207
1907,永豐餘,20,0,20,凱基-永和,2024-01-04,9207
00720B,元大投資級公司債,20,5,15,凱基-永和,2024-01-04,9207
00687B,國泰20年美債,20,5,15,凱基-永和,2024-01-04,9207
6684,安格,13,0,13,凱基-永和,2024-01-04,9207
2610,華航,18,7,11,凱基-永和,2024-01-04,9207
3036,文曄,11,0,11,凱基-永和,2024-01-04,9207
6901,鑽石投資,11,0,11,凱基-永和,2024-01-04,9207
1438,三地開發,10,0,10,凱基-永和,2024-01-04,9207
1815,富喬,10,0,10,凱基-永和,2024-01-04,9207
2241,艾姆勒,9,0,9,凱基-永和,2024-01-04,9207
3037,欣興,9,0,9,凱基-永和,2024-01-04,9207
3231,緯創,15,6,9,凱基-永和,2024-01-04,9207
2303,聯電,19,11,8,凱基-永和,2024-01-04,9207
00751B,元大AAA至A公司債,12,5,7,凱基-永和,2024-01-04,9207
3078,僑威,7,0,7,凱基-永和,2024-01-04,9207
00882,中信中國高股息,6,0,6,凱基-永和,2024-01-04,9207
00933B,國泰10Y+金融債,6,0,6,凱基-永和,2024-01-04,9207
3006,晶豪科,6,0,6,凱基-永和,2024-01-04,9207
00936,台新永續高息中小,6,0,6,凱基-永和,2024-01-04,9207
2313,華通,9,3,6,凱基-永和,2024-01-04,9207
2405,輔信,8,2,6,凱基-永和,2024-01-04,9207
3010,華立,6,0,6,凱基-永和,2024-01-04,9207
3325,旭品,6,0,6,凱基-永和,2024-01-04,9207
3706,神達,6,0,6,凱基-永和,2024-01-04,9207
2356,英業達,23,17,6,凱基-永和,2024-01-04,9207
2201,裕隆,5,0,5,凱基-永和,2024-01-04,9207
00680L,元大美債20正2,5,0,5,凱基-永和,2024-01-04,9207
2615,萬海,5,0,5,凱基-永和,2024-01-04,9207
2867,三商壽,5,0,5,凱基-永和,2024-01-04,9207
3711,日月光投控,5,0,5,凱基-永和,2024-01-04,9207
5531,鄉林,5,0,5,凱基-永和,2024-01-04,9207
8277,商丞,5,0,5,凱基-永和,2024-01-04,9207
00679B,元大美債20年,5,0,5,凱基-永和,2024-01-04,9207
2617,台航,5,1,4,凱基-永和,2024-01-04,9207
3034,聯詠,4,0,4,凱基-永和,2024-01-04,9207
6770,力積電,605,259,346,凱基-永和,2024-01-05,9207
8027,鈦昇,223,2,221,凱基-永和,2024-01-05,9207
3588,通嘉,101,2,99,凱基-永和,2024-01-05,9207
2352,佳世達,81,7,74,凱基-永和,2024-01-05,9207
4956,光鋐,66,1,65,凱基-永和,2024-01-05,9207
8097,常珵,50,6,44,凱基-永和,2024-01-05,9207
3041,揚智,38,0,38,凱基-永和,2024-01-05,9207
8068,全達,41,4,37,凱基-永和,2024-01-05,9207
00929,復華台灣科技優息,37,2,35,凱基-永和,2024-01-05,9207
2505,國揚,33,0,33,凱基-永和,2024-01-05,9207
3035,智原,36,3,33,凱基-永和,2024-01-05,9207
2610,華航,33,1,32,凱基-永和,2024-01-05,9207
2101,南港,30,0,30,凱基-永和,2024-01-05,9207
4768,晶呈科技,24,0,24,凱基-永和,2024-01-05,9207
3029,零壹,20,0,20,凱基-永和,2024-01-05,9207
3325,旭品,20,0,20,凱基-永和,2024-01-05,9207
3532,台勝科,20,0,20,凱基-永和,2024-01-05,9207
5521,工信,20,0,20,凱基-永和,2024-01-05,9207
2618,長榮航,21,2,19,凱基-永和,2024-01-05,9207
00720B,元大投資級公司債,15,0,15,凱基-永和,2024-01-05,9207
0056,元大高股息,16,2,14,凱基-永和,2024-01-05,9207
00687B,國泰20年美債,15,1,14,凱基-永和,2024-01-05,9207
00927,群益半導體收益,14,0,14,凱基-永和,2024-01-05,9207
00937B,群益ESG投等債20,27,14,13,凱基-永和,2024-01-05,9207
1795,美時,14,1,13,凱基-永和,2024-01-05,9207
2362,藍天,65,52,13,凱基-永和,2024-01-05,9207
00882,中信中國高股息,14,2,12,凱基-永和,2024-01-05,9207
2609,陽明,114,102,12,凱基-永和,2024-01-05,9207
8054,安國,12,0,12,凱基-永和,2024-01-05,9207
2308,台達電,11,0,11,凱基-永和,2024-01-05,9207
8088,品安,21,10,11,凱基-永和,2024-01-05,9207
00932,兆豐永續高息等權,10,0,10,凱基-永和,2024-01-05,9207
3094,聯傑,10,0,10,凱基-永和,2024-01-05,9207
6122,擎邦,15,5,10,凱基-永和,2024-01-05,9207
6275,元山,10,0,10,凱基-永和,2024-01-05,9207
6443,元晶,10,0,10,凱基-永和,2024-01-05,9207
1735,日勝化,9,0,9,凱基-永和,2024-01-05,9207
9919,康那香,11,2,9,凱基-永和,2024-01-05,9207
6472,保瑞,8,0,8,凱基-永和,2024-01-05,9207
2357,華碩,8,0,8,凱基-永和,2024-01-05,9207
00878,國泰永續高股息,19,12,7,凱基-永和,2024-01-05,9207
1732,毛寶,10,3,7,凱基-永和,2024-01-05,9207
00930,永豐ESG低碳高息,6,0,6,凱基-永和,2024-01-05,9207
2520,冠德,7,1,6,凱基-永和,2024-01-05,9207
2611,志信,7,1,6,凱基-永和,2024-01-05,9207
2891,中信金,8,2,6,凱基-永和,2024-01-05,9207
2929,淘帝-KY,6,0,6,凱基-永和,2024-01-05,9207
3380,明泰,18,12,6,凱基-永和,2024-01-05,9207
3545,敦泰,6,0,6,凱基-永和,2024-01-05,9207
5258,虹堡,6,0,6,凱基-永和,2024-01-05,9207
3481,群創,87,41,46,凱基-永和,2024-01-08,9207
2101,南港,43,9,34,凱基-永和,2024-01-08,9207
00937B,群益ESG投等債20,33,1,32,凱基-永和,2024-01-08,9207
2353,宏��,547,516,31,凱基-永和,2024-01-08,9207
00931B,統一美債20年,31,0,31,凱基-永和,2024-01-08,9207
4735,豪展,30,0,30,凱基-永和,2024-01-08,9207
8097,常珵,29,0,29,凱基-永和,2024-01-08,9207
3325,旭品,28,0,28,凱基-永和,2024-01-08,9207
00929,復華台灣科技優息,31,5,26,凱基-永和,2024-01-08,9207
00752,中信中國50,23,0,23,凱基-永和,2024-01-08,9207
00679B,元大美債20年,29,9,20,凱基-永和,2024-01-08,9207
00687B,國泰20年美債,19,0,19,凱基-永和,2024-01-08,9207
00882,中信中國高股息,17,0,17,凱基-永和,2024-01-08,9207
2611,志信,17,0,17,凱基-永和,2024-01-08,9207
4746,台耀,17,0,17,凱基-永和,2024-01-08,9207
00919,群益台灣精選高息,21,5,16,凱基-永和,2024-01-08,9207
1718,中纖,16,0,16,凱基-永和,2024-01-08,9207
3390,旭軟,19,5,14,凱基-永和,2024-01-08,9207
00720B,元大投資級公司債,12,0,12,凱基-永和,2024-01-08,9207
8046,南電,12,1,11,凱基-永和,2024-01-08,9207
2537,聯上發,11,0,11,凱基-永和,2024-01-08,9207
6716,應廣,10,0,10,凱基-永和,2024-01-08,9207
00751B,元大AAA至A公司債,10,0,10,凱基-永和,2024-01-08,9207
3260,威剛,12,2,10,凱基-永和,2024-01-08,9207
3515,華擎,10,0,10,凱基-永和,2024-01-08,9207
6657,華安,10,0,10,凱基-永和,2024-01-08,9207
2345,智邦,11,2,9,凱基-永和,2024-01-08,9207
2890,永豐金,10,2,8,凱基-永和,2024-01-08,9207
0056,元大高股息,7,0,7,凱基-永和,2024-01-08,9207
00688L,國泰20年美債正2,7,0,7,凱基-永和,2024-01-08,9207
2344,華邦電,7,0,7,凱基-永和,2024-01-08,9207
2610,華航,7,0,7,凱基-永和,2024-01-08,9207
6282,康舒,7,0,7,凱基-永和,2024-01-08,9207
2609,陽明,46,40,6,凱基-永和,2024-01-08,9207
2347,聯強,6,0,6,凱基-永和,2024-01-08,9207
2388,威盛,11,5,6,凱基-永和,2024-01-08,9207
2489,瑞軒,10,4,6,凱基-永和,2024-01-08,9207
6170,統振,6,0,6,凱基-永和,2024-01-08,9207
8936,國統,6,0,6,凱基-永和,2024-01-08,9207
3017,奇鋐,5,0,5,凱基-永和,2024-01-08,9207
00772B,中信高評級公司債,5,0,5,凱基-永和,2024-01-08,9207
1522,堤維西,5,0,5,凱基-永和,2024-01-08,9207
1721,三晃,13,8,5,凱基-永和,2024-01-08,9207
2408,南亞科,5,0,5,凱基-永和,2024-01-08,9207
2439,美律,5,0,5,凱基-永和,2024-01-08,9207
2633,台灣高鐵,5,0,5,凱基-永和,2024-01-08,9207
3006,晶豪科,6,1,5,凱基-永和,2024-01-08,9207
6109,亞元,5,0,5,凱基-永和,2024-01-08,9207
2888,新光金,5,0,5,凱基-永和,2024-01-08,9207
00636,國泰中國A50,6,2,4,凱基-永和,2024-01-08,9207
00885,富邦越南,2527,0,2527,凱基-永和,2024-01-09,9207
8096,擎亞,300,10,290,凱基-永和,2024-01-09,9207
4909,新復興,150,0,150,凱基-永和,2024-01-09,9207
00919,群益台灣精選高息,85,7,78,凱基-永和,2024-01-09,9207
00892,富邦台灣半導體,72,0,72,凱基-永和,2024-01-09,9207
00937B,群益ESG投等債20,81,13,68,凱基-永和,2024-01-09,9207
2609,陽明,170,129,41,凱基-永和,2024-01-09,9207
8089,康全電訊,40,0,40,凱基-永和,2024-01-09,9207
00680L,元大美債20正2,40,1,39,凱基-永和,2024-01-09,9207
00933B,國泰10Y+金融債,31,0,31,凱基-永和,2024-01-09,9207
1519,華城,35,5,30,凱基-永和,2024-01-09,9207
6139,亞翔,27,0,27,凱基-永和,2024-01-09,9207
2324,仁寶,37,14,23,凱基-永和,2024-01-09,9207
6187,萬潤,25,3,22,凱基-永和,2024-01-09,9207
00929,復華台灣科技優息,22,0,22,凱基-永和,2024-01-09,9207
6901,鑽石投資,21,0,21,凱基-永和,2024-01-09,9207
6275,元山,21,2,19,凱基-永和,2024-01-09,9207
1314,中石化,16,0,16,凱基-永和,2024-01-09,9207
4716,大立,15,0,15,凱基-永和,2024-01-09,9207
6235,華孚,14,0,14,凱基-永和,2024-01-09,9207
00918,大華優利高填息30,13,0,13,凱基-永和,2024-01-09,9207
00770,國泰北美科技,13,1,12,凱基-永和,2024-01-09,9207
2409,友達,14,2,12,凱基-永和,2024-01-09,9207
6282,康舒,11,0,11,凱基-永和,2024-01-09,9207
1714,和桐,10,0,10,凱基-永和,2024-01-09,9207
1905,華紙,10,0,10,凱基-永和,2024-01-09,9207
2014,中鴻,10,0,10,凱基-永和,2024-01-09,9207
2603,長榮,9,0,9,凱基-永和,2024-01-09,9207
2888,新光金,9,0,9,凱基-永和,2024-01-09,9207
2347,聯強,8,0,8,凱基-永和,2024-01-09,9207
2891,中信金,8,0,8,凱基-永和,2024-01-09,9207
3325,旭品,8,0,8,凱基-永和,2024-01-09,9207
6684,安格,10,2,8,凱基-永和,2024-01-09,9207
00882,中信中國高股息,7,0,7,凱基-永和,2024-01-09,9207
2362,藍天,9,2,7,凱基-永和,2024-01-09,9207
3489,森寶,8,1,7,凱基-永和,2024-01-09,9207
2317,鴻海,6,0,6,凱基-永和,2024-01-09,9207
1810,和成,6,0,6,凱基-永和,2024-01-09,9207
2605,新興,8,2,6,凱基-永和,2024-01-09,9207
5426,振發,6,0,6,凱基-永和,2024-01-09,9207
9934,成霖,6,0,6,凱基-永和,2024-01-09,9207
3006,晶豪科,39,34,5,凱基-永和,2024-01-09,9207
2308,台達電,5,0,5,凱基-永和,2024-01-09,9207
00934,中信成長高股息,5,0,5,凱基-永和,2024-01-09,9207
3693,營邦,7,2,5,凱基-永和,2024-01-09,9207
00637L,元大滬深300正2,5,0,5,凱基-永和,2024-01-09,9207
00631L,元大台灣50正2,5,0,5,凱基-永和,2024-01-09,9207
2617,台航,6,1,5,凱基-永和,2024-01-09,9207
5347,世界,5,0,5,凱基-永和,2024-01-09,9207
6109,亞元,5,0,5,凱基-永和,2024-01-09,9207
6120,達運,307,0,307,凱基-永和,2024-01-10,9207
5426,振發,249,98,151,凱基-永和,2024-01-10,9207
8096,擎亞,323,201,122,凱基-永和,2024-01-10,9207
6164,華興,102,0,102,凱基-永和,2024-01-10,9207
8111,立��,66,0,66,凱基-永和,2024-01-10,9207
2421,建準,52,1,51,凱基-永和,2024-01-10,9207
3005,神基,50,0,50,凱基-永和,2024-01-10,9207
2101,南港,46,5,41,凱基-永和,2024-01-10,9207
8089,康全電訊,40,0,40,凱基-永和,2024-01-10,9207
3623,富晶通,33,0,33,凱基-永和,2024-01-10,9207
00919,群益台灣精選高息,48,16,32,凱基-永和,2024-01-10,9207
6462,神盾,136,107,29,凱基-永和,2024-01-10,9207
2609,陽明,49,25,24,凱基-永和,2024-01-10,9207
1444,力麗,22,0,22,凱基-永和,2024-01-10,9207
00679B,元大美債20年,35,16,19,凱基-永和,2024-01-10,9207
3714,富采,19,0,19,凱基-永和,2024-01-10,9207
00933B,國泰10Y+金融債,17,0,17,凱基-永和,2024-01-10,9207
2312,金寶,16,0,16,凱基-永和,2024-01-10,9207
2610,華航,16,0,16,凱基-永和,2024-01-10,9207
00900,富邦特選高股息30,16,0,16,凱基-永和,2024-01-10,9207
6271,同欣電,15,0,15,凱基-永和,2024-01-10,9207
6640,均華,15,0,15,凱基-永和,2024-01-10,9207
00929,復華台灣科技優息,16,2,14,凱基-永和,2024-01-10,9207
1101,台泥,13,0,13,凱基-永和,2024-01-10,9207
6109,亞元,15,2,13,凱基-永和,2024-01-10,9207
2324,仁寶,27,15,12,凱基-永和,2024-01-10,9207
2636,台驊控股,12,0,12,凱基-永和,2024-01-10,9207
1314,中石化,12,0,12,凱基-永和,2024-01-10,9207
2888,新光金,12,0,12,凱基-永和,2024-01-10,9207
3287,廣寰科,24,12,12,凱基-永和,2024-01-10,9207
4768,晶呈科技,12,0,12,凱基-永和,2024-01-10,9207
2002,中鋼,11,0,11,凱基-永和,2024-01-10,9207
2603,長榮,11,0,11,凱基-永和,2024-01-10,9207
5465,富驊,10,0,10,凱基-永和,2024-01-10,9207
6593,台灣銘板,11,1,10,凱基-永和,2024-01-10,9207
2356,英業達,38,29,9,凱基-永和,2024-01-10,9207
3013,晟銘電,10,1,9,凱基-永和,2024-01-10,9207
6239,力成,8,0,8,凱基-永和,2024-01-10,9207
00770,國泰北美科技,7,0,7,凱基-永和,2024-01-10,9207
2605,新興,7,0,7,凱基-永和,2024-01-10,9207
2634,漢翔,7,0,7,凱基-永和,2024-01-10,9207
8034,榮群,7,0,7,凱基-永和,2024-01-10,9207
0056,元大高股息,6,0,6,凱基-永和,2024-01-10,9207
2308,台達電,6,0,6,凱基-永和,2024-01-10,9207
2352,佳世達,16,10,6,凱基-永和,2024-01-10,9207
2449,京元電子,12,6,6,凱基-永和,2024-01-10,9207
2542,興富發,6,0,6,凱基-永和,2024-01-10,9207
6505,台塑化,6,0,6,凱基-永和,2024-01-10,9207
3317,尼克森,5,0,5,凱基-永和,2024-01-10,9207
1802,台玻,5,0,5,凱基-永和,2024-01-10,9207
3035,智原,319,33,286,凱基-永和,2024-01-11,9207
2353,宏��,104,0,104,凱基-永和,2024-01-11,9207
3622,洋華,100,0,100,凱基-永和,2024-01-11,9207
2486,一詮,168,83,85,凱基-永和,2024-01-11,9207
0056,元大高股息,88,15,73,凱基-永和,2024-01-11,9207
2101,南港,65,6,59,凱基-永和,2024-01-11,9207
3228,金麗科,41,0,41,凱基-永和,2024-01-11,9207
3105,穩懋,38,0,38,凱基-永和,2024-01-11,9207
6117,迎廣,35,2,33,凱基-永和,2024-01-11,9207
3362,先進光,29,1,28,凱基-永和,2024-01-11,9207
6282,康舒,27,1,26,凱基-永和,2024-01-11,9207
2883,凱基金,26,1,25,凱基-永和,2024-01-11,9207
8027,鈦昇,25,0,25,凱基-永和,2024-01-11,9207
2331,精英,26,4,22,凱基-永和,2024-01-11,9207
2348,海悅,22,0,22,凱基-永和,2024-01-11,9207
3390,旭軟,20,0,20,凱基-永和,2024-01-11,9207
00919,群益台灣精選高息,29,12,17,凱基-永和,2024-01-11,9207
00933B,國泰10Y+金融債,17,0,17,凱基-永和,2024-01-11,9207
8087,麗升能源,17,0,17,凱基-永和,2024-01-11,9207
1301,台塑,15,0,15,凱基-永和,2024-01-11,9207
2383,台光電,16,2,14,凱基-永和,2024-01-11,9207
00929,復華台灣科技優息,17,5,12,凱基-永和,2024-01-11,9207
00892,富邦台灣半導體,11,0,11,凱基-永和,2024-01-11,9207
1314,中石化,10,0,10,凱基-永和,2024-01-11,9207
2402,毅嘉,10,0,10,凱基-永和,2024-01-11,9207
2495,普安,10,0,10,凱基-永和,2024-01-11,9207
2834,臺企銀,10,0,10,凱基-永和,2024-01-11,9207
9933,中鼎,10,0,10,凱基-永和,2024-01-11,9207
3661,世芯-KY,10,0,10,凱基-永和,2024-01-11,9207
9103,美德醫療-DR,9,0,9,凱基-永和,2024-01-11,9207
2427,三商電,10,2,8,凱基-永和,2024-01-11,9207
2472,立隆電,8,0,8,凱基-永和,2024-01-11,9207
2515,中工,10,2,8,凱基-永和,2024-01-11,9207
6150,撼訊,8,0,8,凱基-永和,2024-01-11,9207
1101,台泥,7,0,7,凱基-永和,2024-01-11,9207
00679B,元大美債20年,7,0,7,凱基-永和,2024-01-11,9207
1536,和大,7,0,7,凱基-永和,2024-01-11,9207
2887,台新金,10,3,7,凱基-永和,2024-01-11,9207
1519,華城,10,4,6,凱基-永和,2024-01-11,9207
2897,王道銀行,5,0,5,凱基-永和,2024-01-11,9207
2606,裕民,5,0,5,凱基-永和,2024-01-11,9207
00770,國泰北美科技,6,1,5,凱基-永和,2024-01-11,9207
2329,華泰,19,14,5,凱基-永和,2024-01-11,9207
2344,華邦電,5,0,5,凱基-永和,2024-01-11,9207
3037,欣興,5,0,5,凱基-永和,2024-01-11,9207
3479,安勤,5,0,5,凱基-永和,2024-01-11,9207
4401,東隆興,5,0,5,凱基-永和,2024-01-11,9207
6275,元山,5,0,5,凱基-永和,2024-01-11,9207
9919,康那香,5,0,5,凱基-永和,2024-01-11,9207
2809,京城銀,5,0,5,凱基-永和,2024-01-11,9207
3025,星通,250,150,100,凱基-永和,2024-01-12,9207
00929,復華台灣科技優息,73,5,68,凱基-永和,2024-01-12,9207
6593,台灣銘板,43,0,43,凱基-永和,2024-01-12,9207
3706,神達,36,0,36,凱基-永和,2024-01-12,9207
00632R,元大台灣50反1,30,0,30,凱基-永和,2024-01-12,9207
2348,海悅,30,0,30,凱基-永和,2024-01-12,9207
00680L,元大美債20正2,27,0,27,凱基-永和,2024-01-12,9207
2101,南港,45,20,25,凱基-永和,2024-01-12,9207
2324,仁寶,18,2,16,凱基-永和,2024-01-12,9207
00881,國泰台灣5G+,20,4,16,凱基-永和,2024-01-12,9207
2891,中信金,16,2,14,凱基-永和,2024-01-12,9207
6217,中探針,12,0,12,凱基-永和,2024-01-12,9207
9103,美德醫療-DR,11,0,11,凱基-永和,2024-01-12,9207
6770,力積電,10,0,10,凱基-永和,2024-01-12,9207
00878,國泰永續高股息,10,0,10,凱基-永和,2024-01-12,9207
00885,富邦越南,10,0,10,凱基-永和,2024-01-12,9207
1314,中石化,10,0,10,凱基-永和,2024-01-12,9207
1584,精剛,10,0,10,凱基-永和,2024-01-12,9207
2836,高雄銀,10,0,10,凱基-永和,2024-01-12,9207
2845,遠東銀,10,0,10,凱基-永和,2024-01-12,9207
2897,王道銀行,10,0,10,凱基-永和,2024-01-12,9207
3008,大立光,10,0,10,凱基-永和,2024-01-12,9207
4909,新復興,27,17,10,凱基-永和,2024-01-12,9207
5398,慕康生醫,10,0,10,凱基-永和,2024-01-12,9207
2449,京元電子,21,12,9,凱基-永和,2024-01-12,9207
2607,榮運,14,5,9,凱基-永和,2024-01-12,9207
6139,亞翔,9,1,8,凱基-永和,2024-01-12,9207
00937B,群益ESG投等債20,7,0,7,凱基-永和,2024-01-12,9207
00936,台新永續高息中小,7,0,7,凱基-永和,2024-01-12,9207
2331,精英,9,2,7,凱基-永和,2024-01-12,9207
3260,威剛,11,4,7,凱基-永和,2024-01-12,9207
0050,元大台灣50,7,0,7,凱基-永和,2024-01-12,9207
2439,美律,6,0,6,凱基-永和,2024-01-12,9207
2618,長榮航,7,1,6,凱基-永和,2024-01-12,9207
2887,台新金,6,0,6,凱基-永和,2024-01-12,9207
2405,輔信,5,0,5,凱基-永和,2024-01-12,9207
5425,台半,5,0,5,凱基-永和,2024-01-12,9207
00636,國泰中國A50,5,0,5,凱基-永和,2024-01-12,9207
2007,燁興,5,0,5,凱基-永和,2024-01-12,9207
3576,聯合再生,5,0,5,凱基-永和,2024-01-12,9207
3702A,大聯大甲特,5,0,5,凱基-永和,2024-01-12,9207
6163,華電網,5,0,5,凱基-永和,2024-01-12,9207
6233,旺玖,5,0,5,凱基-永和,2024-01-12,9207
6443,元晶,10,5,5,凱基-永和,2024-01-12,9207
6472,保瑞,5,0,5,凱基-永和,2024-01-12,9207
2609,陽明,43,38,5,凱基-永和,2024-01-12,9207
006208,富邦台50,4,0,4,凱基-永和,2024-01-12,9207
00930,永豐ESG低碳高息,4,0,4,凱基-永和,2024-01-12,9207
2453,凌群,4,0,4,凱基-永和,2024-01-12,9207
3034,聯詠,5,1,4,凱基-永和,2024-01-12,9207
1609,大亞,300,9,291,凱基-永和,2024-01-15,9207
1795,美時,200,1,199,凱基-永和,2024-01-15,9207
5351,鈺創,205,18,187,凱基-永和,2024-01-15,9207
8027,鈦昇,284,148,136,凱基-永和,2024-01-15,9207
6140,訊達,176,74,102,凱基-永和,2024-01-15,9207
6233,旺玖,99,0,99,凱基-永和,2024-01-15,9207
3287,廣寰科,100,3,97,凱基-永和,2024-01-15,9207
2618,長榮航,73,0,73,凱基-永和,2024-01-15,9207
6276,安鈦克,70,0,70,凱基-永和,2024-01-15,9207
3437,榮創,66,0,66,凱基-永和,2024-01-15,9207
3149,正達,65,0,65,凱基-永和,2024-01-15,9207
2449,京元電子,73,9,64,凱基-永和,2024-01-15,9207
8034,榮群,56,0,56,凱基-永和,2024-01-15,9207
2505,國揚,50,0,50,凱基-永和,2024-01-15,9207
3005,神基,50,0,50,凱基-永和,2024-01-15,9207
6245,立端,50,0,50,凱基-永和,2024-01-15,9207
6117,迎廣,50,1,49,凱基-永和,2024-01-15,9207
6207,雷科,40,0,40,凱基-永和,2024-01-15,9207
6695,芯鼎,107,67,40,凱基-永和,2024-01-15,9207
0056,元大高股息,46,8,38,凱基-永和,2024-01-15,9207
6116,彩晶,28,0,28,凱基-永和,2024-01-15,9207
2101,南港,60,36,24,凱基-永和,2024-01-15,9207
00929,復華台灣科技優息,23,0,23,凱基-永和,2024-01-15,9207
6274,台燿,22,0,22,凱基-永和,2024-01-15,9207
1314,中石化,20,0,20,凱基-永和,2024-01-15,9207
6735,美達科技,20,0,20,凱基-永和,2024-01-15,9207
00919,群益台灣精選高息,21,2,19,凱基-永和,2024-01-15,9207
00881,國泰台灣5G+,18,0,18,凱基-永和,2024-01-15,9207
2610,華航,53,35,18,凱基-永和,2024-01-15,9207
2353,宏��,23,8,15,凱基-永和,2024-01-15,9207
8089,康全電訊,15,0,15,凱基-永和,2024-01-15,9207
3231,緯創,22,8,14,凱基-永和,2024-01-15,9207
2382,廣達,16,4,12,凱基-永和,2024-01-15,9207
2883,凱基金,13,1,12,凱基-永和,2024-01-15,9207
6472,保瑞,10,0,10,凱基-永和,2024-01-15,9207
2867,三商壽,10,0,10,凱基-永和,2024-01-15,9207
00770,國泰北美科技,8,0,8,凱基-永和,2024-01-15,9207
2890,永豐金,10,2,8,凱基-永和,2024-01-15,9207
00679B,元大美債20年,8,0,8,凱基-永和,2024-01-15,9207
2329,華泰,13,6,7,凱基-永和,2024-01-15,9207
2324,仁寶,27,20,7,凱基-永和,2024-01-15,9207
0050,元大台灣50,6,0,6,凱基-永和,2024-01-15,9207
1519,華城,15,9,6,凱基-永和,2024-01-15,9207
6122,擎邦,17,11,6,凱基-永和,2024-01-15,9207
2882,國泰金,6,0,6,凱基-永和,2024-01-15,9207
1799,易威,5,0,5,凱基-永和,2024-01-15,9207
2498,宏達電,5,0,5,凱基-永和,2024-01-15,9207
2884,玉山金,5,0,5,凱基-永和,2024-01-15,9207
3702A,大聯大甲特,5,0,5,凱基-永和,2024-01-15,9207
9103,美德醫療-DR,5,0,5,凱基-永和,2024-01-15,9207
5426,振發,141,0,141,凱基-永和,2024-01-16,9207
8027,鈦昇,187,50,137,凱基-永和,2024-01-16,9207
1795,美時,70,16,54,凱基-永和,2024-01-16,9207
00927,群益半導體收益,52,0,52,凱基-永和,2024-01-16,9207
8092,建暐,66,15,51,凱基-永和,2024-01-16,9207
4956,光鋐,51,1,50,凱基-永和,2024-01-16,9207
5314,世紀,43,0,43,凱基-永和,2024-01-16,9207
0056,元大高股息,43,2,41,凱基-永和,2024-01-16,9207
2002,中鋼,33,0,33,凱基-永和,2024-01-16,9207
2618,長榮航,33,0,33,凱基-永和,2024-01-16,9207
00725B,國泰投資級公司債,30,0,30,凱基-永和,2024-01-16,9207
00929,復華台灣科技優息,71,42,29,凱基-永和,2024-01-16,9207
2481,強茂,27,0,27,凱基-永和,2024-01-16,9207
00919,群益台灣精選高息,39,14,25,凱基-永和,2024-01-16,9207
2887,台新金,22,0,22,凱基-永和,2024-01-16,9207
2324,仁寶,21,0,21,凱基-永和,2024-01-16,9207
2885,元大金,21,0,21,凱基-永和,2024-01-16,9207
2348,海悅,20,0,20,凱基-永和,2024-01-16,9207
3257,虹冠電,20,0,20,凱基-永和,2024-01-16,9207
00878,國泰永續高股息,19,0,19,凱基-永和,2024-01-16,9207
6285,啟��,19,0,19,凱基-永和,2024-01-16,9207
3037,欣興,20,1,19,凱基-永和,2024-01-16,9207
00679B,元大美債20年,18,0,18,凱基-永和,2024-01-16,9207
00937B,群益ESG投等債20,18,0,18,凱基-永和,2024-01-16,9207
8034,榮群,110,92,18,凱基-永和,2024-01-16,9207
2609,陽明,35,18,17,凱基-永和,2024-01-16,9207
00918,大華優利高填息30,16,0,16,凱基-永和,2024-01-16,9207
2867,三商壽,21,5,16,凱基-永和,2024-01-16,9207
4123,晟德,17,1,16,凱基-永和,2024-01-16,9207
00881,國泰台灣5G+,15,0,15,凱基-永和,2024-01-16,9207
2383,台光電,15,0,15,凱基-永和,2024-01-16,9207
2515,中工,15,0,15,凱基-永和,2024-01-16,9207
2883,凱基金,14,0,14,凱基-永和,2024-01-16,9207
2888,新光金,14,0,14,凱基-永和,2024-01-16,9207
2892,第一金,13,0,13,凱基-永和,2024-01-16,9207
2890,永豐金,12,0,12,凱基-永和,2024-01-16,9207
3712,永崴投控,11,0,11,凱基-永和,2024-01-16,9207
00900,富邦特選高股息30,10,0,10,凱基-永和,2024-01-16,9207
2486,一詮,13,3,10,凱基-永和,2024-01-16,9207
00687B,國泰20年美債,10,2,8,凱基-永和,2024-01-16,9207
00751B,元大AAA至A公司債,8,0,8,凱基-永和,2024-01-16,9207
00770,國泰北美科技,8,0,8,凱基-永和,2024-01-16,9207
1721,三晃,11,3,8,凱基-永和,2024-01-16,9207
6505,台塑化,8,0,8,凱基-永和,2024-01-16,9207
2891,中信金,10,3,7,凱基-永和,2024-01-16,9207
5880,合庫金,7,0,7,凱基-永和,2024-01-16,9207
00720B,元大投資級公司債,7,0,7,凱基-永和,2024-01-16,9207
00936,台新永續高息中小,7,0,7,凱基-永和,2024-01-16,9207
1582,信錦,7,0,7,凱基-永和,2024-01-16,9207
2241,艾姆勒,7,0,7,凱基-永和,2024-01-16,9207
4956,光鋐,1114,785,329,凱基-永和,2024-01-17,9207
00929,復華台灣科技優息,127,7,120,凱基-永和,2024-01-17,9207
3694,海華,114,2,112,凱基-永和,2024-01-17,9207
0056,元大高股息,103,0,103,凱基-永和,2024-01-17,9207
2303,聯電,75,1,74,凱基-永和,2024-01-17,9207
00919,群益台灣精選高息,81,17,64,凱基-永和,2024-01-17,9207
6117,迎廣,56,2,54,凱基-永和,2024-01-17,9207
00888,永豐台灣ESG,44,0,44,凱基-永和,2024-01-17,9207
00882,中信中國高股息,34,0,34,凱基-永和,2024-01-17,9207
8034,榮群,78,45,33,凱基-永和,2024-01-17,9207
6233,旺玖,33,2,31,凱基-永和,2024-01-17,9207
00679B,元大美債20年,39,9,30,凱基-永和,2024-01-17,9207
2883,凱基金,27,0,27,凱基-永和,2024-01-17,9207
3025,星通,24,1,23,凱基-永和,2024-01-17,9207
00900,富邦特選高股息30,22,0,22,凱基-永和,2024-01-17,9207
3276,宇環,22,0,22,凱基-永和,2024-01-17,9207
2308,台達電,21,2,19,凱基-永和,2024-01-17,9207
1815,富喬,18,0,18,凱基-永和,2024-01-17,9207
6869,雲豹能源,21,3,18,凱基-永和,2024-01-17,9207
2882,國泰金,19,1,18,凱基-永和,2024-01-17,9207
2609,陽明,28,12,16,凱基-永和,2024-01-17,9207
2892,第一金,14,0,14,凱基-永和,2024-01-17,9207
2618,長榮航,15,1,14,凱基-永和,2024-01-17,9207
00878,國泰永續高股息,13,1,12,凱基-永和,2024-01-17,9207
2324,仁寶,12,0,12,凱基-永和,2024-01-17,9207
2891,中信金,14,2,12,凱基-永和,2024-01-17,9207
00850,元大臺灣ESG永續,12,0,12,凱基-永和,2024-01-17,9207
00713,元大台灣高息低波,11,0,11,凱基-永和,2024-01-17,9207
1605,華新,12,1,11,凱基-永和,2024-01-17,9207
00692,富邦公司治理,10,0,10,凱基-永和,2024-01-17,9207
3357,臺慶科,30,20,10,凱基-永和,2024-01-17,9207
3712,永崴投控,10,0,10,凱基-永和,2024-01-17,9207
4760,勤凱,10,0,10,凱基-永和,2024-01-17,9207
6806,森崴能源,10,0,10,凱基-永和,2024-01-17,9207
00915,凱基優選高股息30,10,0,10,凱基-永和,2024-01-17,9207
2845,遠東銀,10,1,9,凱基-永和,2024-01-17,9207
00881,國泰台灣5G+,9,0,9,凱基-永和,2024-01-17,9207
2353,宏��,14,5,9,凱基-永和,2024-01-17,9207
4123,晟德,9,0,9,凱基-永和,2024-01-17,9207
9945,潤泰新,9,0,9,凱基-永和,2024-01-17,9207
00927,群益半導體收益,8,0,8,凱基-永和,2024-01-17,9207
2884,玉山金,8,0,8,凱基-永和,2024-01-17,9207
00650L,復華香港正2,8,0,8,凱基-永和,2024-01-17,9207
00753L,中信中國50正2,8,0,8,凱基-永和,2024-01-17,9207
00720B,元大投資級公司債,8,0,8,凱基-永和,2024-01-17,9207
2312,金寶,8,0,8,凱基-永和,2024-01-17,9207
2329,華泰,19,11,8,凱基-永和,2024-01-17,9207
5488,松普,25,18,7,凱基-永和,2024-01-17,9207
2603,長榮,7,0,7,凱基-永和,2024-01-17,9207
3105,穩懋,7,0,7,凱基-永和,2024-01-17,9207
6120,達運,700,401,299,凱基-永和,2024-01-18,9207
8027,鈦昇,200,0,200,凱基-永和,2024-01-18,9207
6117,迎廣,75,0,75,凱基-永和,2024-01-18,9207
4960,誠美材,60,1,59,凱基-永和,2024-01-18,9207
3520,華盈,50,0,50,凱基-永和,2024-01-18,9207
8034,榮群,104,61,43,凱基-永和,2024-01-18,9207
00937B,群益ESG投等債20,33,0,33,凱基-永和,2024-01-18,9207
00882,中信中國高股息,30,0,30,凱基-永和,2024-01-18,9207
2887,台新金,30,0,30,凱基-永和,2024-01-18,9207
6140,訊達,30,0,30,凱基-永和,2024-01-18,9207
3530,晶相光,30,1,29,凱基-永和,2024-01-18,9207
5488,松普,24,0,24,凱基-永和,2024-01-18,9207
00919,群益台灣精選高息,40,18,22,凱基-永和,2024-01-18,9207
00636,國泰中國A50,22,2,20,凱基-永和,2024-01-18,9207
3025,星通,48,28,20,凱基-永和,2024-01-18,9207
00752,中信中國50,17,0,17,凱基-永和,2024-01-18,9207
2303,聯電,14,1,13,凱基-永和,2024-01-18,9207
6901,鑽石投資,12,0,12,凱基-永和,2024-01-18,9207
4729,熒茂,10,0,10,凱基-永和,2024-01-18,9207
6179,亞通,10,0,10,凱基-永和,2024-01-18,9207
6695,芯鼎,20,10,10,凱基-永和,2024-01-18,9207
00934,中信成長高股息,9,0,9,凱基-永和,2024-01-18,9207
00881,國泰台灣5G+,9,0,9,凱基-永和,2024-01-18,9207
8936,國統,9,0,9,凱基-永和,2024-01-18,9207
2313,華通,8,0,8,凱基-永和,2024-01-18,9207
2610,華航,10,2,8,凱基-永和,2024-01-18,9207
2882,國泰金,8,0,8,凱基-永和,2024-01-18,9207
3702A,大聯大甲特,8,0,8,凱基-永和,2024-01-18,9207
5426,振發,225,217,8,凱基-永和,2024-01-18,9207
2002,中鋼,7,0,7,凱基-永和,2024-01-18,9207
2329,華泰,19,12,7,凱基-永和,2024-01-18,9207
2504,國產,10,3,7,凱基-永和,2024-01-18,9207
2617,台航,7,0,7,凱基-永和,2024-01-18,9207
2888,新光金,7,0,7,凱基-永和,2024-01-18,9207
2382,廣達,11,4,7,凱基-永和,2024-01-18,9207
2347,聯強,6,0,6,凱基-永和,2024-01-18,9207
8488,吉源-KY,6,0,6,凱基-永和,2024-01-18,9207
00679B,元大美債20年,6,1,5,凱基-永和,2024-01-18,9207
00633L,富邦上証正2,5,0,5,凱基-永和,2024-01-18,9207
1324,地球,5,0,5,凱基-永和,2024-01-18,9207
1752,南光,5,0,5,凱基-永和,2024-01-18,9207
2405,輔信,6,1,5,凱基-永和,2024-01-18,9207
2455,全新,5,0,5,凱基-永和,2024-01-18,9207
2486,一詮,17,12,5,凱基-永和,2024-01-18,9207
2614,東森,5,0,5,凱基-永和,2024-01-18,9207
4105,東洋,10,5,5,凱基-永和,2024-01-18,9207
6432,今展科,5,0,5,凱基-永和,2024-01-18,9207
3231,緯創,12,8,4,凱基-永和,2024-01-18,9207
0056,元大高股息,5,1,4,凱基-永和,2024-01-18,9207
00650L,復華香港正2,4,0,4,凱基-永和,2024-01-18,9207
3231,緯創,414,117,297,凱基-永和,2024-01-19,9207
3035,智原,154,2,152,凱基-永和,2024-01-19,9207
3066,李洲,100,0,100,凱基-永和,2024-01-19,9207
6276,安鈦克,85,0,85,凱基-永和,2024-01-19,9207
2344,華邦電,73,0,73,凱基-永和,2024-01-19,9207
2316,楠梓電,150,95,55,凱基-永和,2024-01-19,9207
00882,中信中國高股息,46,0,46,凱基-永和,2024-01-19,9207
6140,訊達,230,184,46,凱基-永和,2024-01-19,9207
00632R,元大台灣50反1,42,0,42,凱基-永和,2024-01-19,9207
3481,群創,41,4,37,凱基-永和,2024-01-19,9207
00937B,群益ESG投等債20,37,0,37,凱基-永和,2024-01-19,9207
2486,一詮,32,0,32,凱基-永和,2024-01-19,9207
2889,國票金,30,0,30,凱基-永和,2024-01-19,9207
2618,長榮航,23,0,23,凱基-永和,2024-01-19,9207
00679B,元大美債20年,27,5,22,凱基-永和,2024-01-19,9207
2330,台積電,88,67,21,凱基-永和,2024-01-19,9207
5244,弘凱,20,0,20,凱基-永和,2024-01-19,9207
4746,台耀,23,5,18,凱基-永和,2024-01-19,9207
6269,台郡,18,0,18,凱基-永和,2024-01-19,9207
2303,聯電,32,14,18,凱基-永和,2024-01-19,9207
00929,復華台灣科技優息,17,0,17,凱基-永和,2024-01-19,9207
2353,宏��,39,22,17,凱基-永和,2024-01-19,9207
6173,信昌電,17,0,17,凱基-永和,2024-01-19,9207
2348,海悅,15,0,15,凱基-永和,2024-01-19,9207
3306,鼎天,15,0,15,凱基-永和,2024-01-19,9207
6134,萬旭,50,37,13,凱基-永和,2024-01-19,9207
2409,友達,13,0,13,凱基-永和,2024-01-19,9207
2362,藍天,20,8,12,凱基-永和,2024-01-19,9207
1584,精剛,10,0,10,凱基-永和,2024-01-19,9207
2385,群光,11,1,10,凱基-永和,2024-01-19,9207
2633,台灣高鐵,10,0,10,凱基-永和,2024-01-19,9207
6679,鈺太,10,0,10,凱基-永和,2024-01-19,9207
8071,能率網通,10,0,10,凱基-永和,2024-01-19,9207
8150,南茂,10,0,10,凱基-永和,2024-01-19,9207
00687B,國泰20年美債,9,0,9,凱基-永和,2024-01-19,9207
2369,菱生,10,2,8,凱基-永和,2024-01-19,9207
8210,勤誠,10,2,8,凱基-永和,2024-01-19,9207
00795B,中信美國公債20年,8,0,8,凱基-永和,2024-01-19,9207
2312,金寶,11,3,8,凱基-永和,2024-01-19,9207
2401,凌陽,7,0,7,凱基-永和,2024-01-19,9207
6230,尼得科超眾,7,0,7,凱基-永和,2024-01-19,9207
00720B,元大投資級公司債,6,0,6,凱基-永和,2024-01-19,9207
6770,力積電,6,0,6,凱基-永和,2024-01-19,9207
00633L,富邦上証正2,9,3,6,凱基-永和,2024-01-19,9207
1434,福懋,6,0,6,凱基-永和,2024-01-19,9207
2801,彰銀,6,0,6,凱基-永和,2024-01-19,9207
3036,文曄,6,0,6,凱基-永和,2024-01-19,9207
3290,東浦,6,0,6,凱基-永和,2024-01-19,9207
8068,全達,10,4,6,凱基-永和,2024-01-19,9207
8110,華東,6,0,6,凱基-永和,2024-01-19,9207
00687B,國泰20年美債,1003,0,1003,凱基-永和,2024-01-22,9207
2329,華泰,366,16,350,凱基-永和,2024-01-22,9207
3481,群創,172,35,137,凱基-永和,2024-01-22,9207
4967,十銓,50,0,50,凱基-永和,2024-01-22,9207
3005,神基,50,0,50,凱基-永和,2024-01-22,9207
5398,慕康生醫,50,0,50,凱基-永和,2024-01-22,9207
3058,立德,50,2,48,凱基-永和,2024-01-22,9207
8299,群聯,50,2,48,凱基-永和,2024-01-22,9207
00882,中信中國高股息,46,0,46,凱基-永和,2024-01-22,9207
00919,群益台灣精選高息,46,1,45,凱基-永和,2024-01-22,9207
2353,宏��,53,10,43,凱基-永和,2024-01-22,9207
5432,新門,40,5,35,凱基-永和,2024-01-22,9207
3483,力致,35,1,34,凱基-永和,2024-01-22,9207
6698,旭暉應材,30,0,30,凱基-永和,2024-01-22,9207
8040,九暘,30,1,29,凱基-永和,2024-01-22,9207
3050,鈺德,28,0,28,凱基-永和,2024-01-22,9207
4729,熒茂,27,5,22,凱基-永和,2024-01-22,9207
00720B,元大投資級公司債,21,0,21,凱基-永和,2024-01-22,9207
5009,榮剛,20,0,20,凱基-永和,2024-01-22,9207
8054,安國,28,8,20,凱基-永和,2024-01-22,9207
3006,晶豪科,17,4,13,凱基-永和,2024-01-22,9207
00679B,元大美債20年,15,3,12,凱基-永和,2024-01-22,9207
6668,中揚光,22,10,12,凱基-永和,2024-01-22,9207
3260,威剛,11,0,11,凱基-永和,2024-01-22,9207
00929,復華台灣科技優息,11,0,11,凱基-永和,2024-01-22,9207
1519,華城,17,7,10,凱基-永和,2024-01-22,9207
2331,精英,10,0,10,凱基-永和,2024-01-22,9207
2348,海悅,10,0,10,凱基-永和,2024-01-22,9207
3059,華晶科,10,0,10,凱基-永和,2024-01-22,9207
6443,元晶,10,0,10,凱基-永和,2024-01-22,9207
6615,慧智,10,0,10,凱基-永和,2024-01-22,9207
00632R,元大台灣50反1,9,0,9,凱基-永和,2024-01-22,9207
6515,穎崴,9,0,9,凱基-永和,2024-01-22,9207
00900,富邦特選高股息30,10,1,9,凱基-永和,2024-01-22,9207
3694,海華,14,6,8,凱基-永和,2024-01-22,9207
2887,台新金,7,0,7,凱基-永和,2024-01-22,9207
2454,聯發科,7,0,7,凱基-永和,2024-01-22,9207
3227,原相,6,0,6,凱基-永和,2024-01-22,9207
00753L,中信中國50正2,6,0,6,凱基-永和,2024-01-22,9207
1216,統一,6,0,6,凱基-永和,2024-01-22,9207
5443,均豪,6,0,6,凱基-永和,2024-01-22,9207
6462,神盾,8,2,6,凱基-永和,2024-01-22,9207
8096,擎亞,11,5,6,凱基-永和,2024-01-22,9207
00933B,國泰10Y+金融債,5,0,5,凱基-永和,2024-01-22,9207
2492,華新科,5,0,5,凱基-永和,2024-01-22,9207
2845,遠東銀,5,0,5,凱基-永和,2024-01-22,9207
3265,台星科,7,2,5,凱基-永和,2024-01-22,9207
3339,泰谷,5,0,5,凱基-永和,2024-01-22,9207
3666,光耀,5,0,5,凱基-永和,2024-01-22,9207
4956,光鋐,7,2,5,凱基-永和,2024-01-22,9207
2369,菱生,304,101,203,凱基-永和,2024-01-23,9207
2460,建通,198,101,97,凱基-永和,2024-01-23,9207
6140,訊達,95,4,91,凱基-永和,2024-01-23,9207
3149,正達,83,0,83,凱基-永和,2024-01-23,9207
8089,康全電訊,60,0,60,凱基-永和,2024-01-23,9207
6127,九豪,57,0,57,凱基-永和,2024-01-23,9207
2331,精英,50,0,50,凱基-永和,2024-01-23,9207
3490,單井,50,0,50,凱基-永和,2024-01-23,9207
3362,先進光,50,2,48,凱基-永和,2024-01-23,9207
5234,達興材料,82,41,41,凱基-永和,2024-01-23,9207
6593,台灣銘板,35,0,35,凱基-永和,2024-01-23,9207
3231,緯創,53,24,29,凱基-永和,2024-01-23,9207
4746,台耀,24,1,23,凱基-永和,2024-01-23,9207
9958,世紀鋼,27,6,21,凱基-永和,2024-01-23,9207
6462,神盾,22,1,21,凱基-永和,2024-01-23,9207
4938,和碩,20,0,20,凱基-永和,2024-01-23,9207
3008,大立光,17,0,17,凱基-永和,2024-01-23,9207
2609,陽明,31,15,16,凱基-永和,2024-01-23,9207
8040,九暘,15,0,15,凱基-永和,2024-01-23,9207
6515,穎崴,13,0,13,凱基-永和,2024-01-23,9207
2104,國際中橡,11,0,11,凱基-永和,2024-01-23,9207
6109,亞元,11,0,11,凱基-永和,2024-01-23,9207
00632R,元大台灣50反1,10,0,10,凱基-永和,2024-01-23,9207
2332,友訊,10,0,10,凱基-永和,2024-01-23,9207
2618,長榮航,16,6,10,凱基-永和,2024-01-23,9207
6168,宏齊,10,0,10,凱基-永和,2024-01-23,9207
3706,神達,9,0,9,凱基-永和,2024-01-23,9207
00688L,國泰20年美債正2,9,0,9,凱基-永和,2024-01-23,9207
00882,中信中國高股息,10,1,9,凱基-永和,2024-01-23,9207
00893,國泰智能電動車,10,1,9,凱基-永和,2024-01-23,9207
00878,國泰永續高股息,9,0,9,凱基-永和,2024-01-23,9207
2208,台船,8,0,8,凱基-永和,2024-01-23,9207
6139,亞翔,8,0,8,凱基-永和,2024-01-23,9207
00756B,群益投等新興公債,7,0,7,凱基-永和,2024-01-23,9207
2731,雄獅,7,0,7,凱基-永和,2024-01-23,9207
3607,谷崧,7,0,7,凱基-永和,2024-01-23,9207
6292,迅德,8,1,7,凱基-永和,2024-01-23,9207
1417,嘉裕,7,0,7,凱基-永和,2024-01-23,9207
2002,中鋼,6,0,6,凱基-永和,2024-01-23,9207
2059,川湖,6,0,6,凱基-永和,2024-01-23,9207
2368,金像電,11,5,6,凱基-永和,2024-01-23,9207
2888,新光金,6,0,6,凱基-永和,2024-01-23,9207
3264,欣銓,6,0,6,凱基-永和,2024-01-23,9207
8096,擎亞,6,1,5,凱基-永和,2024-01-23,9207
9925,新保,5,0,5,凱基-永和,2024-01-23,9207
2353,宏��,9,4,5,凱基-永和,2024-01-23,9207
00679B,元大美債20年,6,2,4,凱基-永和,2024-01-23,9207
1471,首利,5,1,4,凱基-永和,2024-01-23,9207
1736,喬山,4,0,4,凱基-永和,2024-01-23,9207
3293,鈊象,4,0,4,凱基-永和,2024-01-23,9207
8069,元太,181,1,180,凱基-永和,2024-01-24,9207
8096,擎亞,200,27,173,凱基-永和,2024-01-24,9207
4909,新復興,114,13,101,凱基-永和,2024-01-24,9207
6113,亞矽,112,11,101,凱基-永和,2024-01-24,9207
3535,晶彩科,82,0,82,凱基-永和,2024-01-24,9207
2467,志聖,82,2,80,凱基-永和,2024-01-24,9207
3622,洋華,90,30,60,凱基-永和,2024-01-24,9207
2324,仁寶,34,1,33,凱基-永和,2024-01-24,9207
6229,研通,33,0,33,凱基-永和,2024-01-24,9207
3687,歐買尬,33,1,32,凱基-永和,2024-01-24,9207
00665L,富邦�琤肭磪囓�2,30,0,30,凱基-永和,2024-01-24,9207
4188,安克,30,0,30,凱基-永和,2024-01-24,9207
00937B,群益ESG投等債20,28,0,28,凱基-永和,2024-01-24,9207
3694,海華,43,16,27,凱基-永和,2024-01-24,9207
2706,第一店,25,0,25,凱基-永和,2024-01-24,9207
5478,智冠,25,1,24,凱基-永和,2024-01-24,9207
8261,富鼎,18,0,18,凱基-永和,2024-01-24,9207
8040,九暘,17,0,17,凱基-永和,2024-01-24,9207
00720B,元大投資級公司債,13,0,13,凱基-永和,2024-01-24,9207
4956,光鋐,12,0,12,凱基-永和,2024-01-24,9207
3260,威剛,28,17,11,凱基-永和,2024-01-24,9207
00636,國泰中國A50,11,0,11,凱基-永和,2024-01-24,9207
1809,中釉,11,0,11,凱基-永和,2024-01-24,9207
2356,英業達,18,8,10,凱基-永和,2024-01-24,9207
00679B,元大美債20年,13,3,10,凱基-永和,2024-01-24,9207
1795,美時,10,0,10,凱基-永和,2024-01-24,9207
2610,華航,10,0,10,凱基-永和,2024-01-24,9207
2883,凱基金,10,0,10,凱基-永和,2024-01-24,9207
5488,松普,10,0,10,凱基-永和,2024-01-24,9207
6668,中揚光,10,0,10,凱基-永和,2024-01-24,9207
6695,芯鼎,11,1,10,凱基-永和,2024-01-24,9207
2376,技嘉,14,4,10,凱基-永和,2024-01-24,9207
6116,彩晶,20,11,9,凱基-永和,2024-01-24,9207
6111,大宇資,9,1,8,凱基-永和,2024-01-24,9207
00919,群益台灣精選高息,6,0,6,凱基-永和,2024-01-24,9207
0056,元大高股息,6,0,6,凱基-永和,2024-01-24,9207
5871,中租-KY,6,0,6,凱基-永和,2024-01-24,9207
6906,現觀科,6,0,6,凱基-永和,2024-01-24,9207
3293,鈊象,5,0,5,凱基-永和,2024-01-24,9207
00642U,期元大S＆P石油,5,0,5,凱基-永和,2024-01-24,9207
00637L,元大滬深300正2,5,0,5,凱基-永和,2024-01-24,9207
00881,國泰台灣5G+,5,0,5,凱基-永和,2024-01-24,9207
1402,遠東新,5,0,5,凱基-永和,2024-01-24,9207
2344,華邦電,11,6,5,凱基-永和,2024-01-24,9207
2355,敬鵬,5,0,5,凱基-永和,2024-01-24,9207
2486,一詮,14,9,5,凱基-永和,2024-01-24,9207
2882,國泰金,6,1,5,凱基-永和,2024-01-24,9207
3322,建舜電,5,0,5,凱基-永和,2024-01-24,9207
6191,精成科,5,0,5,凱基-永和,2024-01-24,9207
6245,立端,7,2,5,凱基-永和,2024-01-24,9207
2365,昆盈,201,2,199,凱基-永和,2024-01-25,9207
6679,鈺太,101,0,101,凱基-永和,2024-01-25,9207
3066,李洲,62,0,62,凱基-永和,2024-01-25,9207
3581,博磊,50,0,50,凱基-永和,2024-01-25,9207
3005,神基,52,4,48,凱基-永和,2024-01-25,9207
00687B,國泰20年美債,47,0,47,凱基-永和,2024-01-25,9207
6229,研通,134,99,35,凱基-永和,2024-01-25,9207
00720B,元大投資級公司債,27,0,27,凱基-永和,2024-01-25,9207
00882,中信中國高股息,26,0,26,凱基-永和,2024-01-25,9207
00931B,統一美債20年,20,0,20,凱基-永和,2024-01-25,9207
00679B,元大美債20年,16,0,16,凱基-永和,2024-01-25,9207
3047,訊舟,15,1,14,凱基-永和,2024-01-25,9207
00929,復華台灣科技優息,13,1,12,凱基-永和,2024-01-25,9207
00633L,富邦上証正2,11,0,11,凱基-永和,2024-01-25,9207
00657,國泰日經225,10,0,10,凱基-永和,2024-01-25,9207
2367,燿華,10,0,10,凱基-永和,2024-01-25,9207
2618,長榮航,10,0,10,凱基-永和,2024-01-25,9207
8071,能率網通,10,0,10,凱基-永和,2024-01-25,9207
5284,jpp-KY,12,3,9,凱基-永和,2024-01-25,9207
00937B,群益ESG投等債20,8,0,8,凱基-永和,2024-01-25,9207
2344,華邦電,23,15,8,凱基-永和,2024-01-25,9207
3260,威剛,8,0,8,凱基-永和,2024-01-25,9207
6109,亞元,8,0,8,凱基-永和,2024-01-25,9207
00632R,元大台灣50反1,7,0,7,凱基-永和,2024-01-25,9207
6138,茂達,8,1,7,凱基-永和,2024-01-25,9207
2363,矽統,7,0,7,凱基-永和,2024-01-25,9207
2388,威盛,7,1,6,凱基-永和,2024-01-25,9207
2486,一詮,14,8,6,凱基-永和,2024-01-25,9207
3025,星通,6,0,6,凱基-永和,2024-01-25,9207
8081,致新,6,0,6,凱基-永和,2024-01-25,9207
2382,廣達,9,3,6,凱基-永和,2024-01-25,9207
1721,三晃,5,0,5,凱基-永和,2024-01-25,9207
3322,建舜電,5,0,5,凱基-永和,2024-01-25,9207
006205,富邦上証,5,0,5,凱基-永和,2024-01-25,9207
2355,敬鵬,5,0,5,凱基-永和,2024-01-25,9207
2489,瑞軒,5,0,5,凱基-永和,2024-01-25,9207
3645,達邁,5,0,5,凱基-永和,2024-01-25,9207
4529,淳紳,5,0,5,凱基-永和,2024-01-25,9207
4743,合一,5,0,5,凱基-永和,2024-01-25,9207
5426,振發,449,444,5,凱基-永和,2024-01-25,9207
6515,穎崴,5,0,5,凱基-永和,2024-01-25,9207
00725B,國泰投資級公司債,4,0,4,凱基-永和,2024-01-25,9207
1605,華新,4,0,4,凱基-永和,2024-01-25,9207
2356,英業達,7,3,4,凱基-永和,2024-01-25,9207
3515,華擎,4,1,3,凱基-永和,2024-01-25,9207
3017,奇鋐,15,12,3,凱基-永和,2024-01-25,9207
2369,菱生,3,0,3,凱基-永和,2024-01-25,9207
2605,新興,3,0,3,凱基-永和,2024-01-25,9207
6271,同欣電,3,0,3,凱基-永和,2024-01-25,9207
00773B,中信優先金融債,3,0,3,凱基-永和,2024-01-25,9207
00687B,國泰20年美債,502,0,502,凱基-永和,2024-01-26,9207
3481,群創,470,7,463,凱基-永和,2024-01-26,9207
2440,太空梭,66,0,66,凱基-永和,2024-01-26,9207
2303,聯電,276,218,58,凱基-永和,2024-01-26,9207
3434,哲固,100,50,50,凱基-永和,2024-01-26,9207
00679B,元大美債20年,51,12,39,凱基-永和,2024-01-26,9207
4746,台耀,33,0,33,凱基-永和,2024-01-26,9207
5478,智冠,32,0,32,凱基-永和,2024-01-26,9207
1316,上曜,30,0,30,凱基-永和,2024-01-26,9207
6005,群益證,25,1,24,凱基-永和,2024-01-26,9207
5284,jpp-KY,36,13,23,凱基-永和,2024-01-26,9207
2329,華泰,24,4,20,凱基-永和,2024-01-26,9207
2409,友達,20,0,20,凱基-永和,2024-01-26,9207
00878,國泰永續高股息,25,6,19,凱基-永和,2024-01-26,9207
4939,亞電,18,0,18,凱基-永和,2024-01-26,9207
2324,仁寶,163,148,15,凱基-永和,2024-01-26,9207
3035,智原,19,4,15,凱基-永和,2024-01-26,9207
6129,普誠,10,0,10,凱基-永和,2024-01-26,9207
00665L,富邦�琤肭磪囓�2,10,0,10,凱基-永和,2024-01-26,9207
2351,順德,10,0,10,凱基-永和,2024-01-26,9207
3036,文曄,10,0,10,凱基-永和,2024-01-26,9207
9103,美德醫療-DR,10,0,10,凱基-永和,2024-01-26,9207
00929,復華台灣科技優息,9,0,9,凱基-永和,2024-01-26,9207
00893,國泰智能電動車,10,1,9,凱基-永和,2024-01-26,9207
2317,鴻海,9,1,8,凱基-永和,2024-01-26,9207
2109,華豐,8,0,8,凱基-永和,2024-01-26,9207
2382,廣達,10,2,8,凱基-永和,2024-01-26,9207
2356,英業達,6,0,6,凱基-永和,2024-01-26,9207
1312,國喬,6,0,6,凱基-永和,2024-01-26,9207
2344,華邦電,16,10,6,凱基-永和,2024-01-26,9207
2884,玉山金,5,0,5,凱基-永和,2024-01-26,9207
00930,永豐ESG低碳高息,5,0,5,凱基-永和,2024-01-26,9207
00885,富邦越南,5,0,5,凱基-永和,2024-01-26,9207
1416,廣豐,5,0,5,凱基-永和,2024-01-26,9207
1560,中砂,5,0,5,凱基-永和,2024-01-26,9207
3105,穩懋,5,0,5,凱基-永和,2024-01-26,9207
3265,台星科,13,8,5,凱基-永和,2024-01-26,9207
4729,熒茂,10,5,5,凱基-永和,2024-01-26,9207
0056,元大高股息,4,0,4,凱基-永和,2024-01-26,9207
3715,定穎投控,6,2,4,凱基-永和,2024-01-26,9207
00934,中信成長高股息,4,0,4,凱基-永和,2024-01-26,9207
1503,士電,5,1,4,凱基-永和,2024-01-26,9207
3037,欣興,6,2,4,凱基-永和,2024-01-26,9207
3694,海華,192,188,4,凱基-永和,2024-01-26,9207
4961,天鈺,4,0,4,凱基-永和,2024-01-26,9207
5871,中租-KY,4,0,4,凱基-永和,2024-01-26,9207
2357,華碩,4,0,4,凱基-永和,2024-01-26,9207
3592,瑞鼎,3,0,3,凱基-永和,2024-01-26,9207
1108,幸福,3,0,3,凱基-永和,2024-01-26,9207
00633L,富邦上証正2,6,3,3,凱基-永和,2024-01-26,9207
4908,前鼎,137,8,129,凱基-永和,2024-01-29,9207
6530,創威,75,0,75,凱基-永和,2024-01-29,9207
3437,榮創,66,0,66,凱基-永和,2024-01-29,9207
8040,九暘,62,0,62,凱基-永和,2024-01-29,9207
6823,濾能,49,0,49,凱基-永和,2024-01-29,9207
3025,星通,43,3,40,凱基-永和,2024-01-29,9207
3041,揚智,38,1,37,凱基-永和,2024-01-29,9207
6785,昱展新藥,36,1,35,凱基-永和,2024-01-29,9207
2888,新光金,30,0,30,凱基-永和,2024-01-29,9207
6198,瑞築,30,0,30,凱基-永和,2024-01-29,9207
00937B,群益ESG投等債20,29,1,28,凱基-永和,2024-01-29,9207
00633L,富邦上証正2,27,0,27,凱基-永和,2024-01-29,9207
4542,科嶠,25,0,25,凱基-永和,2024-01-29,9207
6531,愛普*,86,63,23,凱基-永和,2024-01-29,9207
3047,訊舟,22,0,22,凱基-永和,2024-01-29,9207
00927,群益半導體收益,20,0,20,凱基-永和,2024-01-29,9207
8084,巨虹,20,0,20,凱基-永和,2024-01-29,9207
3548,兆利,21,3,18,凱基-永和,2024-01-29,9207
00679B,元大美債20年,18,0,18,凱基-永和,2024-01-29,9207
00933B,國泰10Y+金融債,15,0,15,凱基-永和,2024-01-29,9207
6117,迎廣,15,0,15,凱基-永和,2024-01-29,9207
00632R,元大台灣50反1,15,2,13,凱基-永和,2024-01-29,9207
6695,芯鼎,19,6,13,凱基-永和,2024-01-29,9207
2443,昶虹,11,0,11,凱基-永和,2024-01-29,9207
6276,安鈦克,10,0,10,凱基-永和,2024-01-29,9207
6593,台灣銘板,10,0,10,凱基-永和,2024-01-29,9207
2356,英業達,12,3,9,凱基-永和,2024-01-29,9207
00751B,元大AAA至A公司債,9,0,9,凱基-永和,2024-01-29,9207
00720B,元大投資級公司債,9,0,9,凱基-永和,2024-01-29,9207
6109,亞元,8,0,8,凱基-永和,2024-01-29,9207
3094,聯傑,7,0,7,凱基-永和,2024-01-29,9207
4934,太極,7,0,7,凱基-永和,2024-01-29,9207
00673R,期元大S＆P原油反1,6,0,6,凱基-永和,2024-01-29,9207
2344,華邦電,6,0,6,凱基-永和,2024-01-29,9207
6515,穎崴,6,0,6,凱基-永和,2024-01-29,9207
6906,現觀科,5,0,5,凱基-永和,2024-01-29,9207
00688L,國泰20年美債正2,5,0,5,凱基-永和,2024-01-29,9207
2375,凱美,5,0,5,凱基-永和,2024-01-29,9207
2465,麗臺,5,0,5,凱基-永和,2024-01-29,9207
3322,建舜電,5,0,5,凱基-永和,2024-01-29,9207
3376,新日興,9,4,5,凱基-永和,2024-01-29,9207
3702A,大聯大甲特,5,0,5,凱基-永和,2024-01-29,9207
5009,榮剛,5,0,5,凱基-永和,2024-01-29,9207
5258,虹堡,5,0,5,凱基-永和,2024-01-29,9207
1445,大宇,4,0,4,凱基-永和,2024-01-29,9207
2369,菱生,4,0,4,凱基-永和,2024-01-29,9207
2929,淘帝-KY,4,0,4,凱基-永和,2024-01-29,9207
6244,茂迪,4,0,4,凱基-永和,2024-01-29,9207
8064,東捷,5,1,4,凱基-永和,2024-01-29,9207
3294,英濟,4,0,4,凱基-永和,2024-01-29,9207
2369,菱生,305,10,295,凱基-永和,2024-01-30,9207
8084,巨虹,226,0,226,凱基-永和,2024-01-30,9207
3289,宜特,180,3,177,凱基-永和,2024-01-30,9207
1560,中砂,156,10,146,凱基-永和,2024-01-30,9207
3308,聯德,72,0,72,凱基-永和,2024-01-30,9207
4908,前鼎,205,137,68,凱基-永和,2024-01-30,9207
5210,寶碩,46,0,46,凱基-永和,2024-01-30,9207
00665L,富邦�琤肭磪囓�2,42,10,32,凱基-永和,2024-01-30,9207
6116,彩晶,31,0,31,凱基-永和,2024-01-30,9207
6462,神盾,46,17,29,凱基-永和,2024-01-30,9207
6515,穎崴,29,0,29,凱基-永和,2024-01-30,9207
00680L,元大美債20正2,27,0,27,凱基-永和,2024-01-30,9207
6124,業強,25,0,25,凱基-永和,2024-01-30,9207
00937B,群益ESG投等債20,24,0,24,凱基-永和,2024-01-30,9207
3035,智原,24,0,24,凱基-永和,2024-01-30,9207
3548,兆利,27,4,23,凱基-永和,2024-01-30,9207
3047,訊舟,20,0,20,凱基-永和,2024-01-30,9207
3664,安瑞-KY,20,0,20,凱基-永和,2024-01-30,9207
8089,康全電訊,20,0,20,凱基-永和,2024-01-30,9207
00633L,富邦上証正2,18,0,18,凱基-永和,2024-01-30,9207
3481,群創,18,1,17,凱基-永和,2024-01-30,9207
6109,亞元,14,0,14,凱基-永和,2024-01-30,9207
3362,先進光,20,7,13,凱基-永和,2024-01-30,9207
00687B,國泰20年美債,12,0,12,凱基-永和,2024-01-30,9207
2883,凱基金,12,0,12,凱基-永和,2024-01-30,9207
2460,建通,11,0,11,凱基-永和,2024-01-30,9207
1316,上曜,10,0,10,凱基-永和,2024-01-30,9207
2880,華南金,10,0,10,凱基-永和,2024-01-30,9207
6593,台灣銘板,10,0,10,凱基-永和,2024-01-30,9207
6603,富強鑫,10,0,10,凱基-永和,2024-01-30,9207
8110,華東,10,0,10,凱基-永和,2024-01-30,9207
2882,國泰金,9,0,9,凱基-永和,2024-01-30,9207
5426,振發,10,1,9,凱基-永和,2024-01-30,9207
2610,華航,9,1,8,凱基-永和,2024-01-30,9207
1503,士電,8,0,8,凱基-永和,2024-01-30,9207
3231,緯創,17,10,7,凱基-永和,2024-01-30,9207
2467,志聖,13,6,7,凱基-永和,2024-01-30,9207
2492,華新科,7,0,7,凱基-永和,2024-01-30,9207
00919,群益台灣精選高息,10,4,6,凱基-永和,2024-01-30,9207
6191,精成科,6,0,6,凱基-永和,2024-01-30,9207
3041,揚智,6,0,6,凱基-永和,2024-01-30,9207
3390,旭軟,6,0,6,凱基-永和,2024-01-30,9207
00930,永豐ESG低碳高息,5,0,5,凱基-永和,2024-01-30,9207
00632R,元大台灣50反1,5,0,5,凱基-永和,2024-01-30,9207
1713,國化,5,0,5,凱基-永和,2024-01-30,9207
1785,光洋科,5,0,5,凱基-永和,2024-01-30,9207
1795,美時,6,1,5,凱基-永和,2024-01-30,9207
2241,艾姆勒,5,0,5,凱基-永和,2024-01-30,9207
2363,矽統,5,0,5,凱基-永和,2024-01-30,9207
2855,統一證,5,0,5,凱基-永和,2024-01-30,9207
2443,昶虹,214,0,214,凱基-永和,2024-01-31,9207
8936,國統,202,5,197,凱基-永和,2024-01-31,9207
3354,律勝,190,40,150,凱基-永和,2024-01-31,9207
6270,倍微,111,12,99,凱基-永和,2024-01-31,9207
6530,創威,101,6,95,凱基-永和,2024-01-31,9207
2409,友達,100,20,80,凱基-永和,2024-01-31,9207
8080,印鉐,70,0,70,凱基-永和,2024-01-31,9207
00753L,中信中國50正2,61,0,61,凱基-永和,2024-01-31,9207
6667,信紘科,51,0,51,凱基-永和,2024-01-31,9207
1560,中砂,51,3,48,凱基-永和,2024-01-31,9207
6695,芯鼎,108,69,39,凱基-永和,2024-01-31,9207
6465,威潤,38,0,38,凱基-永和,2024-01-31,9207
5211,蒙恬,36,0,36,凱基-永和,2024-01-31,9207
3437,榮創,33,0,33,凱基-永和,2024-01-31,9207
00679B,元大美債20年,36,5,31,凱基-永和,2024-01-31,9207
3481,群創,32,2,30,凱基-永和,2024-01-31,9207
2330,台積電,28,1,27,凱基-永和,2024-01-31,9207
00680L,元大美債20正2,25,1,24,凱基-永和,2024-01-31,9207
5314,世紀,23,0,23,凱基-永和,2024-01-31,9207
3548,兆利,41,20,21,凱基-永和,2024-01-31,9207
1799,易威,21,0,21,凱基-永和,2024-01-31,9207
006208,富邦台50,21,0,21,凱基-永和,2024-01-31,9207
1316,上曜,20,0,20,凱基-永和,2024-01-31,9207
2002,中鋼,20,0,20,凱基-永和,2024-01-31,9207
3025,星通,20,0,20,凱基-永和,2024-01-31,9207
6593,台灣銘板,20,0,20,凱基-永和,2024-01-31,9207
8089,康全電訊,20,0,20,凱基-永和,2024-01-31,9207
2867,三商壽,18,0,18,凱基-永和,2024-01-31,9207
2303,聯電,19,2,17,凱基-永和,2024-01-31,9207
3231,緯創,19,2,17,凱基-永和,2024-01-31,9207
00929,復華台灣科技優息,15,1,14,凱基-永和,2024-01-31,9207
6785,昱展新藥,13,0,13,凱基-永和,2024-01-31,9207
6462,神盾,24,11,13,凱基-永和,2024-01-31,9207
6698,旭暉應材,12,1,11,凱基-永和,2024-01-31,9207
2376,技嘉,11,1,10,凱基-永和,2024-01-31,9207
00687B,國泰20年美債,10,0,10,凱基-永和,2024-01-31,9207
00918,大華優利高填息30,10,0,10,凱基-永和,2024-01-31,9207
1528,恩德,10,0,10,凱基-永和,2024-01-31,9207
2313,華通,11,1,10,凱基-永和,2024-01-31,9207
8050,廣積,10,0,10,凱基-永和,2024-01-31,9207
00881,國泰台灣5G+,10,1,9,凱基-永和,2024-01-31,9207
00893,國泰智能電動車,10,1,9,凱基-永和,2024-01-31,9207
00882,中信中國高股息,9,0,9,凱基-永和,2024-01-31,9207
2365,昆盈,10,1,9,凱基-永和,2024-01-31,9207
3094,聯傑,9,0,9,凱基-永和,2024-01-31,9207
4909,新復興,10,1,9,凱基-永和,2024-01-31,9207
4994,傳奇,9,0,9,凱基-永和,2024-01-31,9207
2308,台達電,8,0,8,凱基-永和,2024-01-31,9207
3189,景碩,8,0,8,凱基-永和,2024-01-31,9207
00764B,群益25年美債,7,0,7,凱基-永和,2024-01-31,9207
3294,英濟,300,1,299,凱基-永和,2024-02-01,9207
6265,方土昶,393,100,293,凱基-永和,2024-02-01,9207
4147,中裕,260,0,260,凱基-永和,2024-02-01,9207
8111,立��,201,1,200,凱基-永和,2024-02-01,9207
3036,文曄,205,6,199,凱基-永和,2024-02-01,9207
1528,恩德,151,0,151,凱基-永和,2024-02-01,9207
3363,上詮,150,0,150,凱基-永和,2024-02-01,9207
3289,宜特,166,33,133,凱基-永和,2024-02-01,9207
8089,康全電訊,120,0,120,凱基-永和,2024-02-01,9207
3287,廣寰科,124,6,118,凱基-永和,2024-02-01,9207
3081,聯亞,100,0,100,凱基-永和,2024-02-01,9207
6116,彩晶,85,0,85,凱基-永和,2024-02-01,9207
3543,州巧,60,0,60,凱基-永和,2024-02-01,9207
8996,高力,53,0,53,凱基-永和,2024-02-01,9207
00878,國泰永續高股息,51,0,51,凱基-永和,2024-02-01,9207
00679B,元大美債20年,132,84,48,凱基-永和,2024-02-01,9207
6667,信紘科,50,2,48,凱基-永和,2024-02-01,9207
3530,晶相光,50,6,44,凱基-永和,2024-02-01,9207
2443,昶虹,42,0,42,凱基-永和,2024-02-01,9207
6679,鈺太,22,0,22,凱基-永和,2024-02-01,9207
1325,恆大,21,0,21,凱基-永和,2024-02-01,9207
2323,中環,20,0,20,凱基-永和,2024-02-01,9207
6593,台灣銘板,20,0,20,凱基-永和,2024-02-01,9207
00712,復華富時不動產,17,0,17,凱基-永和,2024-02-01,9207
2241,艾姆勒,17,1,16,凱基-永和,2024-02-01,9207
2303,聯電,16,1,15,凱基-永和,2024-02-01,9207
00687B,國泰20年美債,11,0,11,凱基-永和,2024-02-01,9207
2724,藝舍-KY,11,0,11,凱基-永和,2024-02-01,9207
8096,擎亞,11,0,11,凱基-永和,2024-02-01,9207
00929,復華台灣科技優息,13,3,10,凱基-永和,2024-02-01,9207
00650L,復華香港正2,10,0,10,凱基-永和,2024-02-01,9207
0056,元大高股息,10,0,10,凱基-永和,2024-02-01,9207
00671R,富邦NASDAQ反1,10,0,10,凱基-永和,2024-02-01,9207
6285,啟��,10,0,10,凱基-永和,2024-02-01,9207
00757,統一FANG+,52,44,8,凱基-永和,2024-02-01,9207
9904,寶成,8,0,8,凱基-永和,2024-02-01,9207
6113,亞矽,21,14,7,凱基-永和,2024-02-01,9207
3234,光環,6,0,6,凱基-永和,2024-02-01,9207
00891,中信關鍵半導體,6,0,6,凱基-永和,2024-02-01,9207
00919,群益台灣精選高息,8,2,6,凱基-永和,2024-02-01,9207
00720B,元大投資級公司債,6,0,6,凱基-永和,2024-02-01,9207
5351,鈺創,6,0,6,凱基-永和,2024-02-01,9207
3702A,大聯大甲特,5,0,5,凱基-永和,2024-02-01,9207
6741,91APP*-KY,5,0,5,凱基-永和,2024-02-01,9207
8059,凱碩,5,0,5,凱基-永和,2024-02-01,9207
00881,國泰台灣5G+,4,0,4,凱基-永和,2024-02-01,9207
2412,中華電,4,0,4,凱基-永和,2024-02-01,9207
2618,長榮航,10,6,4,凱基-永和,2024-02-01,9207
3032,偉訓,15,11,4,凱基-永和,2024-02-01,9207
4939,亞電,4,0,4,凱基-永和,2024-02-01,9207
00679B,元大美債20年,219,7,212,凱基-永和,2024-02-02,9207
3081,聯亞,213,23,190,凱基-永和,2024-02-02,9207
8996,高力,174,2,172,凱基-永和,2024-02-02,9207
00892,富邦台灣半導體,105,0,105,凱基-永和,2024-02-02,9207
3013,晟銘電,108,5,103,凱基-永和,2024-02-02,9207
00878,國泰永續高股息,91,17,74,凱基-永和,2024-02-02,9207
00753L,中信中國50正2,91,23,68,凱基-永和,2024-02-02,9207
1528,恩德,500,450,50,凱基-永和,2024-02-02,9207
3025,星通,43,0,43,凱基-永和,2024-02-02,9207
00675L,富邦臺灣加權正2,32,0,32,凱基-永和,2024-02-02,9207
3376,新日興,31,3,28,凱基-永和,2024-02-02,9207
3481,群創,30,4,26,凱基-永和,2024-02-02,9207
00687B,國泰20年美債,25,4,21,凱基-永和,2024-02-02,9207
00680L,元大美債20正2,20,0,20,凱基-永和,2024-02-02,9207
8110,華東,20,0,20,凱基-永和,2024-02-02,9207
00933B,國泰10Y+金融債,21,5,16,凱基-永和,2024-02-02,9207
2324,仁寶,27,12,15,凱基-永和,2024-02-02,9207
4729,熒茂,16,1,15,凱基-永和,2024-02-02,9207
00720B,元大投資級公司債,13,0,13,凱基-永和,2024-02-02,9207
1325,恆大,13,0,13,凱基-永和,2024-02-02,9207
3715,定穎投控,18,5,13,凱基-永和,2024-02-02,9207
6282,康舒,14,1,13,凱基-永和,2024-02-02,9207
2801,彰銀,13,1,12,凱基-永和,2024-02-02,9207
5381,合正,15,3,12,凱基-永和,2024-02-02,9207
00918,大華優利高填息30,11,0,11,凱基-永和,2024-02-02,9207
2891,中信金,12,1,11,凱基-永和,2024-02-02,9207
1503,士電,21,10,11,凱基-永和,2024-02-02,9207
00636,國泰中國A50,11,0,11,凱基-永和,2024-02-02,9207
4736,泰博,11,0,11,凱基-永和,2024-02-02,9207
2303,聯電,10,0,10,凱基-永和,2024-02-02,9207
00665L,富邦�琤肭磪囓�2,10,0,10,凱基-永和,2024-02-02,9207
00712,復華富時不動產,13,3,10,凱基-永和,2024-02-02,9207
3048,益登,10,0,10,凱基-永和,2024-02-02,9207
6109,亞元,10,0,10,凱基-永和,2024-02-02,9207
6533,晶心科,11,1,10,凱基-永和,2024-02-02,9207
00715L,期街口布蘭特正2,8,0,8,凱基-永和,2024-02-02,9207
6223,旺矽,8,0,8,凱基-永和,2024-02-02,9207
9904,寶成,8,0,8,凱基-永和,2024-02-02,9207
2724,藝舍-KY,7,0,7,凱基-永和,2024-02-02,9207
6139,亞翔,11,4,7,凱基-永和,2024-02-02,9207
2356,英業達,114,107,7,凱基-永和,2024-02-02,9207
00632R,元大台灣50反1,6,0,6,凱基-永和,2024-02-02,9207
00751B,元大AAA至A公司債,6,0,6,凱基-永和,2024-02-02,9207
2609,陽明,14,8,6,凱基-永和,2024-02-02,9207
2636,台驊控股,6,0,6,凱基-永和,2024-02-02,9207
3294,英濟,6,0,6,凱基-永和,2024-02-02,9207
8040,九暘,130,124,6,凱基-永和,2024-02-02,9207
2383,台光電,5,0,5,凱基-永和,2024-02-02,9207
2353,宏��,12,7,5,凱基-永和,2024-02-02,9207
2323,中環,5,0,5,凱基-永和,2024-02-02,9207
00892,富邦台灣半導體,140,0,140,凱基-永和,2024-02-05,9207
6805,富世達,106,0,106,凱基-永和,2024-02-05,9207
00933B,國泰10Y+金融債,72,0,72,凱基-永和,2024-02-05,9207
2365,昆盈,1304,1235,69,凱基-永和,2024-02-05,9207
00882,中信中國高股息,63,0,63,凱基-永和,2024-02-05,9207
8054,安國,63,5,58,凱基-永和,2024-02-05,9207
5490,同亨,130,80,50,凱基-永和,2024-02-05,9207
6625,必應,80,40,40,凱基-永和,2024-02-05,9207
00937B,群益ESG投等債20,60,21,39,凱基-永和,2024-02-05,9207
1799,易威,39,0,39,凱基-永和,2024-02-05,9207
00919,群益台灣精選高息,41,5,36,凱基-永和,2024-02-05,9207
6684,安格,138,103,35,凱基-永和,2024-02-05,9207
3548,兆利,31,0,31,凱基-永和,2024-02-05,9207
00878,國泰永續高股息,39,8,31,凱基-永和,2024-02-05,9207
8112,至上,28,0,28,凱基-永和,2024-02-05,9207
4729,熒茂,25,0,25,凱基-永和,2024-02-05,9207
6534,正瀚-創,25,0,25,凱基-永和,2024-02-05,9207
00720B,元大投資級公司債,22,0,22,凱基-永和,2024-02-05,9207
00680L,元大美債20正2,22,0,22,凱基-永和,2024-02-05,9207
3288,點晶,22,0,22,凱基-永和,2024-02-05,9207
5284,jpp-KY,20,0,20,凱基-永和,2024-02-05,9207
2882,國泰金,19,0,19,凱基-永和,2024-02-05,9207
00679B,元大美債20年,19,0,19,凱基-永和,2024-02-05,9207
6246,臺龍,30,11,19,凱基-永和,2024-02-05,9207
00687B,國泰20年美債,18,0,18,凱基-永和,2024-02-05,9207
00751B,元大AAA至A公司債,16,0,16,凱基-永和,2024-02-05,9207
2303,聯電,18,4,14,凱基-永和,2024-02-05,9207
00891,中信關鍵半導體,14,0,14,凱基-永和,2024-02-05,9207
2369,菱生,19,5,14,凱基-永和,2024-02-05,9207
2459,敦吉,13,0,13,凱基-永和,2024-02-05,9207
1503,士電,12,0,12,凱基-永和,2024-02-05,9207
3294,英濟,12,0,12,凱基-永和,2024-02-05,9207
1101,台泥,11,0,11,凱基-永和,2024-02-05,9207
2344,華邦電,11,0,11,凱基-永和,2024-02-05,9207
2724,藝舍-KY,11,0,11,凱基-永和,2024-02-05,9207
00927,群益半導體收益,10,0,10,凱基-永和,2024-02-05,9207
0061,元大寶滬深,10,0,10,凱基-永和,2024-02-05,9207
00671R,富邦NASDAQ反1,10,0,10,凱基-永和,2024-02-05,9207
1515,力山,10,0,10,凱基-永和,2024-02-05,9207
5381,合正,10,0,10,凱基-永和,2024-02-05,9207
6590,普鴻,10,0,10,凱基-永和,2024-02-05,9207
2301,光寶科,10,1,9,凱基-永和,2024-02-05,9207
00715L,期街口布蘭特正2,9,0,9,凱基-永和,2024-02-05,9207
2419,仲琦,9,0,9,凱基-永和,2024-02-05,9207
6785,昱展新藥,10,1,9,凱基-永和,2024-02-05,9207
6901,鑽石投資,9,0,9,凱基-永和,2024-02-05,9207
00929,復華台灣科技優息,21,12,9,凱基-永和,2024-02-05,9207
5880,合庫金,8,0,8,凱基-永和,2024-02-05,9207
6223,旺矽,13,5,8,凱基-永和,2024-02-05,9207
6265,方土昶,8,0,8,凱基-永和,2024-02-05,9207
2329,華泰,403,215,188,凱基-永和,2024-02-15,9207
2543,皇昌,150,0,150,凱基-永和,2024-02-15,9207
00937B,群益ESG投等債20,99,0,99,凱基-永和,2024-02-15,9207
3481,群創,120,23,97,凱基-永和,2024-02-15,9207
3372,典範,70,0,70,凱基-永和,2024-02-15,9207
6194,育富,66,0,66,凱基-永和,2024-02-15,9207
4908,前鼎,66,3,63,凱基-永和,2024-02-15,9207
00679B,元大美債20年,59,0,59,凱基-永和,2024-02-15,9207
00918,大華優利高填息30,56,0,56,凱基-永和,2024-02-15,9207
00720B,元大投資級公司債,54,0,54,凱基-永和,2024-02-15,9207
6442,光聖,50,0,50,凱基-永和,2024-02-15,9207
3583,辛耘,51,2,49,凱基-永和,2024-02-15,9207
3013,晟銘電,152,106,46,凱基-永和,2024-02-15,9207
8110,華東,45,0,45,凱基-永和,2024-02-15,9207
00687B,國泰20年美債,60,16,44,凱基-永和,2024-02-15,9207
00632R,元大台灣50反1,57,21,36,凱基-永和,2024-02-15,9207
6515,穎崴,36,0,36,凱基-永和,2024-02-15,9207
8089,康全電訊,185,149,36,凱基-永和,2024-02-15,9207
2408,南亞科,36,1,35,凱基-永和,2024-02-15,9207
00919,群益台灣精選高息,104,72,32,凱基-永和,2024-02-15,9207
5508,永信建,26,0,26,凱基-永和,2024-02-15,9207
2449,京元電子,26,1,25,凱基-永和,2024-02-15,9207
2330,台積電,134,109,25,凱基-永和,2024-02-15,9207
00712,復華富時不動產,24,0,24,凱基-永和,2024-02-15,9207
00655L,國泰中國A50正2,25,1,24,凱基-永和,2024-02-15,9207
2905,三商,20,0,20,凱基-永和,2024-02-15,9207
8467,波力-KY,20,0,20,凱基-永和,2024-02-15,9207
00751B,元大AAA至A公司債,20,0,20,凱基-永和,2024-02-15,9207
3289,宜特,21,2,19,凱基-永和,2024-02-15,9207
1325,恆大,17,0,17,凱基-永和,2024-02-15,9207
2344,華邦電,16,0,16,凱基-永和,2024-02-15,9207
3623,富晶通,18,2,16,凱基-永和,2024-02-15,9207
3002,歐格,15,0,15,凱基-永和,2024-02-15,9207
3715,定穎投控,21,7,14,凱基-永和,2024-02-15,9207
4763,材料-KY,15,1,14,凱基-永和,2024-02-15,9207
2353,宏��,16,3,13,凱基-永和,2024-02-15,9207
2313,華通,12,0,12,凱基-永和,2024-02-15,9207
6584,南俊國際,12,0,12,凱基-永和,2024-02-15,9207
9945,潤泰新,13,1,12,凱基-永和,2024-02-15,9207
00680L,元大美債20正2,13,2,11,凱基-永和,2024-02-15,9207
4142,國光生,11,0,11,凱基-永和,2024-02-15,9207
4561,健椿,11,0,11,凱基-永和,2024-02-15,9207
8096,擎亞,11,0,11,凱基-永和,2024-02-15,9207
3325,旭品,10,0,10,凱基-永和,2024-02-15,9207
5381,合正,10,0,10,凱基-永和,2024-02-15,9207
6207,雷科,10,0,10,凱基-永和,2024-02-15,9207
6698,旭暉應材,10,0,10,凱基-永和,2024-02-15,9207
00900,富邦特選高股息30,10,0,10,凱基-永和,2024-02-15,9207
3443,創意,10,0,10,凱基-永和,2024-02-15,9207
2360,致茂,9,0,9,凱基-永和,2024-02-15,9207
2369,菱生,309,13,296,凱基-永和,2024-02-16,9207
3363,上詮,157,1,156,凱基-永和,2024-02-16,9207
3450,聯鈞,240,101,139,凱基-永和,2024-02-16,9207
3481,群創,113,0,113,凱基-永和,2024-02-16,9207
3025,星通,100,0,100,凱基-永和,2024-02-16,9207
6197,佳必琪,103,3,100,凱基-永和,2024-02-16,9207
8064,東捷,206,109,97,凱基-永和,2024-02-16,9207
3234,光環,100,5,95,凱基-永和,2024-02-16,9207
00919,群益台灣精選高息,120,39,81,凱基-永和,2024-02-16,9207
00679B,元大美債20年,60,0,60,凱基-永和,2024-02-16,9207
3041,揚智,115,64,51,凱基-永和,2024-02-16,9207
00665L,富邦�琤肭磪囓�2,50,0,50,凱基-永和,2024-02-16,9207
00929,復華台灣科技優息,80,32,48,凱基-永和,2024-02-16,9207
4128,中天,36,0,36,凱基-永和,2024-02-16,9207
00795B,中信美國公債20年,31,0,31,凱基-永和,2024-02-16,9207
2905,三商,30,0,30,凱基-永和,2024-02-16,9207
00878,國泰永續高股息,38,8,30,凱基-永和,2024-02-16,9207
00937B,群益ESG投等債20,28,0,28,凱基-永和,2024-02-16,9207
00931B,統一美債20年,25,0,25,凱基-永和,2024-02-16,9207
6120,達運,25,2,23,凱基-永和,2024-02-16,9207
8059,凱碩,196,174,22,凱基-永和,2024-02-16,9207
3686,達能,21,0,21,凱基-永和,2024-02-16,9207
6117,迎廣,22,1,21,凱基-永和,2024-02-16,9207
6741,91APP*-KY,20,0,20,凱基-永和,2024-02-16,9207
8147,正淩,20,0,20,凱基-永和,2024-02-16,9207
00655L,國泰中國A50正2,18,0,18,凱基-永和,2024-02-16,9207
1101,台泥,19,2,17,凱基-永和,2024-02-16,9207
2483,百容,16,0,16,凱基-永和,2024-02-16,9207
1711,永光,15,0,15,凱基-永和,2024-02-16,9207
2511,太子,15,0,15,凱基-永和,2024-02-16,9207
00720B,元大投資級公司債,14,0,14,凱基-永和,2024-02-16,9207
0056,元大高股息,19,5,14,凱基-永和,2024-02-16,9207
3372,典範,42,30,12,凱基-永和,2024-02-16,9207
6269,台郡,14,3,11,凱基-永和,2024-02-16,9207
00857B,永豐20年美公債,10,0,10,凱基-永和,2024-02-16,9207
2359,所羅門,10,0,10,凱基-永和,2024-02-16,9207
6116,彩晶,10,0,10,凱基-永和,2024-02-16,9207
2376,技嘉,23,13,10,凱基-永和,2024-02-16,9207
1524,耿鼎,10,1,9,凱基-永和,2024-02-16,9207
2441,超豐,9,0,9,凱基-永和,2024-02-16,9207
3264,欣銓,10,1,9,凱基-永和,2024-02-16,9207
00891,中信關鍵半導體,8,1,7,凱基-永和,2024-02-16,9207
9945,潤泰新,7,1,6,凱基-永和,2024-02-16,9207
00687B,國泰20年美債,26,20,6,凱基-永和,2024-02-16,9207
1515,力山,6,0,6,凱基-永和,2024-02-16,9207
2337,旺宏,6,0,6,凱基-永和,2024-02-16,9207
3693,營邦,6,0,6,凱基-永和,2024-02-16,9207
6244,茂迪,6,0,6,凱基-永和,2024-02-16,9207
2382,廣達,25,19,6,凱基-永和,2024-02-16,9207
00701,國泰股利精選30,5,0,5,凱基-永和,2024-02-16,9207
2489,瑞軒,512,200,312,凱基-永和,2024-02-19,9207
3058,立德,300,0,300,凱基-永和,2024-02-19,9207
8110,華東,310,30,280,凱基-永和,2024-02-19,9207
8996,高力,254,1,253,凱基-永和,2024-02-19,9207
8059,凱碩,137,0,137,凱基-永和,2024-02-19,9207
2353,宏��,109,12,97,凱基-永和,2024-02-19,9207
2355,敬鵬,101,10,91,凱基-永和,2024-02-19,9207
4909,新復興,95,6,89,凱基-永和,2024-02-19,9207
3686,達能,84,0,84,凱基-永和,2024-02-19,9207
00687B,國泰20年美債,92,10,82,凱基-永和,2024-02-19,9207
00878,國泰永續高股息,89,7,82,凱基-永和,2024-02-19,9207
3034,聯詠,70,8,62,凱基-永和,2024-02-19,9207
00665L,富邦�琤肭磪囓�2,110,50,60,凱基-永和,2024-02-19,9207
00933B,國泰10Y+金融債,74,20,54,凱基-永和,2024-02-19,9207
3081,聯亞,51,1,50,凱基-永和,2024-02-19,9207
3234,光環,50,0,50,凱基-永和,2024-02-19,9207
3588,通嘉,100,54,46,凱基-永和,2024-02-19,9207
3715,定穎投控,51,8,43,凱基-永和,2024-02-19,9207
00919,群益台灣精選高息,66,28,38,凱基-永和,2024-02-19,9207
4303,信立,33,0,33,凱基-永和,2024-02-19,9207
4939,亞電,31,0,31,凱基-永和,2024-02-19,9207
2885,元大金,30,0,30,凱基-永和,2024-02-19,9207
00929,復華台灣科技優息,37,7,30,凱基-永和,2024-02-19,9207
2609,陽明,29,4,25,凱基-永和,2024-02-19,9207
00937B,群益ESG投等債20,25,0,25,凱基-永和,2024-02-19,9207
2886,兆豐金,24,1,23,凱基-永和,2024-02-19,9207
2892,第一金,25,2,23,凱基-永和,2024-02-19,9207
00679B,元大美債20年,22,0,22,凱基-永和,2024-02-19,9207
00772B,中信高評級公司債,21,0,21,凱基-永和,2024-02-19,9207
4912,聯德控股-KY,35,14,21,凱基-永和,2024-02-19,9207
4128,中天,20,0,20,凱基-永和,2024-02-19,9207
00857B,永豐20年美公債,20,0,20,凱基-永和,2024-02-19,9207
00753L,中信中國50正2,20,0,20,凱基-永和,2024-02-19,9207
2483,百容,20,0,20,凱基-永和,2024-02-19,9207
3576,聯合再生,20,0,20,凱基-永和,2024-02-19,9207
00882,中信中國高股息,15,0,15,凱基-永和,2024-02-19,9207
00706L,期元大S＆P日圓正2,15,0,15,凱基-永和,2024-02-19,9207
5508,永信建,15,0,15,凱基-永和,2024-02-19,9207
6109,亞元,15,0,15,凱基-永和,2024-02-19,9207
2515,中工,13,0,13,凱基-永和,2024-02-19,9207
6578,達邦蛋白,13,0,13,凱基-永和,2024-02-19,9207
3260,威剛,17,6,11,凱基-永和,2024-02-19,9207
00637L,元大滬深300正2,11,0,11,凱基-永和,2024-02-19,9207
2634,漢翔,11,0,11,凱基-永和,2024-02-19,9207
2376,技嘉,19,8,11,凱基-永和,2024-02-19,9207
00881,國泰台灣5G+,10,0,10,凱基-永和,2024-02-19,9207
1717,長興,10,0,10,凱基-永和,2024-02-19,9207
1810,和成,10,0,10,凱基-永和,2024-02-19,9207
2477,美隆電,10,0,10,凱基-永和,2024-02-19,9207
4538,大詠城,10,0,10,凱基-永和,2024-02-19,9207
3481,群創,645,2,643,凱基-永和,2024-02-20,9207
1316,上曜,404,52,352,凱基-永和,2024-02-20,9207
2330,台積電,144,33,111,凱基-永和,2024-02-20,9207
4147,中裕,96,0,96,凱基-永和,2024-02-20,9207
8089,康全電訊,95,0,95,凱基-永和,2024-02-20,9207
00929,復華台灣科技優息,96,16,80,凱基-永和,2024-02-20,9207
2369,菱生,54,0,54,凱基-永和,2024-02-20,9207
00919,群益台灣精選高息,75,22,53,凱基-永和,2024-02-20,9207
3025,星通,52,0,52,凱基-永和,2024-02-20,9207
6241,易通展,50,0,50,凱基-永和,2024-02-20,9207
3147,大綜,47,0,47,凱基-永和,2024-02-20,9207
00637L,元大滬深300正2,35,0,35,凱基-永和,2024-02-20,9207
2059,川湖,35,0,35,凱基-永和,2024-02-20,9207
00719B,元大美債1-3,33,0,33,凱基-永和,2024-02-20,9207
5355,佳總,33,0,33,凱基-永和,2024-02-20,9207
2888,新光金,31,0,31,凱基-永和,2024-02-20,9207
8086,宏捷科,36,5,31,凱基-永和,2024-02-20,9207
8071,能率網通,30,0,30,凱基-永和,2024-02-20,9207
00891,中信關鍵半導體,30,1,29,凱基-永和,2024-02-20,9207
00937B,群益ESG投等債20,29,0,29,凱基-永和,2024-02-20,9207
2332,友訊,28,0,28,凱基-永和,2024-02-20,9207
3321,同泰,28,0,28,凱基-永和,2024-02-20,9207
00751B,元大AAA至A公司債,25,0,25,凱基-永和,2024-02-20,9207
00933B,國泰10Y+金融債,22,0,22,凱基-永和,2024-02-20,9207
3545,敦泰,22,1,21,凱基-永和,2024-02-20,9207
2408,南亞科,22,2,20,凱基-永和,2024-02-20,9207
2464,盟立,20,0,20,凱基-永和,2024-02-20,9207
8442,威宏-KY,20,0,20,凱基-永和,2024-02-20,9207
2353,宏��,24,5,19,凱基-永和,2024-02-20,9207
5284,jpp-KY,19,0,19,凱基-永和,2024-02-20,9207
9945,潤泰新,16,0,16,凱基-永和,2024-02-20,9207
6109,亞元,16,0,16,凱基-永和,2024-02-20,9207
6237,驊訊,14,0,14,凱基-永和,2024-02-20,9207
00931B,統一美債20年,13,0,13,凱基-永和,2024-02-20,9207
2405,輔信,222,209,13,凱基-永和,2024-02-20,9207
3686,達能,13,0,13,凱基-永和,2024-02-20,9207
2363,矽統,21,9,12,凱基-永和,2024-02-20,9207
4720,德淵,12,0,12,凱基-永和,2024-02-20,9207
6223,旺矽,12,0,12,凱基-永和,2024-02-20,9207
2409,友達,15,4,11,凱基-永和,2024-02-20,9207
3535,晶彩科,13,2,11,凱基-永和,2024-02-20,9207
00679B,元大美債20年,10,0,10,凱基-永和,2024-02-20,9207
00877,復華中國5G,10,0,10,凱基-永和,2024-02-20,9207
00753L,中信中國50正2,10,0,10,凱基-永和,2024-02-20,9207
00657,國泰日經225,10,0,10,凱基-永和,2024-02-20,9207
00655L,國泰中國A50正2,10,0,10,凱基-永和,2024-02-20,9207
00632R,元大台灣50反1,10,0,10,凱基-永和,2024-02-20,9207
2812,台中銀,10,0,10,凱基-永和,2024-02-20,9207
2836,高雄銀,10,0,10,凱基-永和,2024-02-20,9207
3704,合勤控,10,0,10,凱基-永和,2024-02-20,9207
2489,瑞軒,905,565,340,凱基-永和,2024-02-21,9207
3289,宜特,250,0,250,凱基-永和,2024-02-21,9207
6126,信音,204,54,150,凱基-永和,2024-02-21,9207
3221,台嘉碩,150,2,148,凱基-永和,2024-02-21,9207
1560,中砂,141,5,136,凱基-永和,2024-02-21,9207
8930,青鋼,117,1,116,凱基-永和,2024-02-21,9207
1809,中釉,105,0,105,凱基-永和,2024-02-21,9207
3363,上詮,153,54,99,凱基-永和,2024-02-21,9207
6668,中揚光,188,89,99,凱基-永和,2024-02-21,9207
6530,創威,101,3,98,凱基-永和,2024-02-21,9207
00918,大華優利高填息30,101,6,95,凱基-永和,2024-02-21,9207
6122,擎邦,80,6,74,凱基-永和,2024-02-21,9207
5488,松普,264,196,68,凱基-永和,2024-02-21,9207
6117,迎廣,90,30,60,凱基-永和,2024-02-21,9207
00878,國泰永續高股息,59,1,58,凱基-永和,2024-02-21,9207
3481,群創,71,16,55,凱基-永和,2024-02-21,9207
00633L,富邦上証正2,54,0,54,凱基-永和,2024-02-21,9207
4909,新復興,53,1,52,凱基-永和,2024-02-21,9207
00929,復華台灣科技優息,63,11,52,凱基-永和,2024-02-21,9207
00687B,國泰20年美債,50,0,50,凱基-永和,2024-02-21,9207
00937B,群益ESG投等債20,47,0,47,凱基-永和,2024-02-21,9207
3588,通嘉,51,5,46,凱基-永和,2024-02-21,9207
6282,康舒,48,5,43,凱基-永和,2024-02-21,9207
8299,群聯,44,1,43,凱基-永和,2024-02-21,9207
8467,波力-KY,35,0,35,凱基-永和,2024-02-21,9207
9912,偉聯,35,0,35,凱基-永和,2024-02-21,9207
3047,訊舟,42,10,32,凱基-永和,2024-02-21,9207
2881,富邦金,31,1,30,凱基-永和,2024-02-21,9207
6684,安格,36,7,29,凱基-永和,2024-02-21,9207
2888,新光金,30,2,28,凱基-永和,2024-02-21,9207
00650L,復華香港正2,30,4,26,凱基-永和,2024-02-21,9207
00850,元大臺灣ESG永續,25,0,25,凱基-永和,2024-02-21,9207
2408,南亞科,24,0,24,凱基-永和,2024-02-21,9207
6451,訊芯-KY,27,3,24,凱基-永和,2024-02-21,9207
3231,緯創,58,36,22,凱基-永和,2024-02-21,9207
5521,工信,21,0,21,凱基-永和,2024-02-21,9207
3229,晟鈦,20,0,20,凱基-永和,2024-02-21,9207
6141,柏承,20,0,20,凱基-永和,2024-02-21,9207
6233,旺玖,23,4,19,凱基-永和,2024-02-21,9207
6109,亞元,16,0,16,凱基-永和,2024-02-21,9207
2353,宏��,28,13,15,凱基-永和,2024-02-21,9207
2369,菱生,15,0,15,凱基-永和,2024-02-21,9207
6292,迅德,16,2,14,凱基-永和,2024-02-21,9207
4128,中天,18,5,13,凱基-永和,2024-02-21,9207
9945,潤泰新,14,1,13,凱基-永和,2024-02-21,9207
2301,光寶科,16,4,12,凱基-永和,2024-02-21,9207
00712,復華富時不動產,11,0,11,凱基-永和,2024-02-21,9207
6244,茂迪,12,1,11,凱基-永和,2024-02-21,9207
2460,建通,24,14,10,凱基-永和,2024-02-21,9207
2464,盟立,10,0,10,凱基-永和,2024-02-21,9207
2313,華通,365,111,254,凱基-永和,2024-02-22,9207
00933B,國泰10Y+金融債,173,1,172,凱基-永和,2024-02-22,9207
6285,啟��,155,15,140,凱基-永和,2024-02-22,9207
00830,國泰費城半導體,119,0,119,凱基-永和,2024-02-22,9207
2379,瑞昱,113,2,111,凱基-永和,2024-02-22,9207
3081,聯亞,100,6,94,凱基-永和,2024-02-22,9207
8069,元太,91,0,91,凱基-永和,2024-02-22,9207
00679B,元大美債20年,78,0,78,凱基-永和,2024-02-22,9207
00929,復華台灣科技優息,137,65,72,凱基-永和,2024-02-22,9207
00892,富邦台灣半導體,70,0,70,凱基-永和,2024-02-22,9207
1560,中砂,72,4,68,凱基-永和,2024-02-22,9207
6140,訊達,57,0,57,凱基-永和,2024-02-22,9207
4526,東台,55,0,55,凱基-永和,2024-02-22,9207
00665L,富邦�琤肭磪囓�2,50,0,50,凱基-永和,2024-02-22,9207
6204,艾華,35,2,33,凱基-永和,2024-02-22,9207
2888,新光金,40,9,31,凱基-永和,2024-02-22,9207
6526,達發,30,1,29,凱基-永和,2024-02-22,9207
2464,盟立,29,0,29,凱基-永和,2024-02-22,9207
2371,大同,36,12,24,凱基-永和,2024-02-22,9207
00637L,元大滬深300正2,25,5,20,凱基-永和,2024-02-22,9207
1568,倉佑,20,0,20,凱基-永和,2024-02-22,9207
5381,合正,121,103,18,凱基-永和,2024-02-22,9207
00937B,群益ESG投等債20,17,0,17,凱基-永和,2024-02-22,9207
5508,永信建,17,0,17,凱基-永和,2024-02-22,9207
3231,緯創,33,18,15,凱基-永和,2024-02-22,9207
3689,湧德,16,1,15,凱基-永和,2024-02-22,9207
00687B,國泰20年美債,14,0,14,凱基-永和,2024-02-22,9207
9945,潤泰新,13,0,13,凱基-永和,2024-02-22,9207
6189,豐藝,17,5,12,凱基-永和,2024-02-22,9207
1815,富喬,12,1,11,凱基-永和,2024-02-22,9207
2543,皇昌,12,1,11,凱基-永和,2024-02-22,9207
5443,均豪,16,5,11,凱基-永和,2024-02-22,9207
2408,南亞科,10,0,10,凱基-永和,2024-02-22,9207
00862B,中信投資級公司債,10,0,10,凱基-永和,2024-02-22,9207
00632R,元大台灣50反1,10,0,10,凱基-永和,2024-02-22,9207
2020,美亞,10,0,10,凱基-永和,2024-02-22,9207
2401,凌陽,10,0,10,凱基-永和,2024-02-22,9207
6129,普誠,11,1,10,凱基-永和,2024-02-22,9207
6136,富爾特,10,0,10,凱基-永和,2024-02-22,9207
8011,台通,12,2,10,凱基-永和,2024-02-22,9207
8028,昇陽半導體,10,0,10,凱基-永和,2024-02-22,9207
00720B,元大投資級公司債,9,0,9,凱基-永和,2024-02-22,9207
2356,英業達,17,8,9,凱基-永和,2024-02-22,9207
8930,青鋼,12,3,9,凱基-永和,2024-02-22,9207
2317,鴻海,12,4,8,凱基-永和,2024-02-22,9207
2329,華泰,22,15,7,凱基-永和,2024-02-22,9207
2324,仁寶,15,8,7,凱基-永和,2024-02-22,9207
4746,台耀,8,1,7,凱基-永和,2024-02-22,9207
2409,友達,7,1,6,凱基-永和,2024-02-22,9207
00878,國泰永續高股息,6,0,6,凱基-永和,2024-02-22,9207
6167,久正,201,0,201,凱基-永和,2024-02-23,9207
1809,中釉,300,100,200,凱基-永和,2024-02-23,9207
00892,富邦台灣半導體,198,0,198,凱基-永和,2024-02-23,9207
4526,東台,201,10,191,凱基-永和,2024-02-23,9207
3221,台嘉碩,185,0,185,凱基-永和,2024-02-23,9207
3390,旭軟,152,0,152,凱基-永和,2024-02-23,9207
3363,上詮,119,7,112,凱基-永和,2024-02-23,9207
4542,科嶠,100,0,100,凱基-永和,2024-02-23,9207
1513,中興電,209,113,96,凱基-永和,2024-02-23,9207
2379,瑞昱,70,2,68,凱基-永和,2024-02-23,9207
00937B,群益ESG投等債20,60,0,60,凱基-永和,2024-02-23,9207
00679B,元大美債20年,51,0,51,凱基-永和,2024-02-23,9207
5381,合正,50,0,50,凱基-永和,2024-02-23,9207
6113,亞矽,51,2,49,凱基-永和,2024-02-23,9207
5432,新門,47,1,46,凱基-永和,2024-02-23,9207
00632R,元大台灣50反1,40,0,40,凱基-永和,2024-02-23,9207
4906,正文,40,0,40,凱基-永和,2024-02-23,9207
3231,緯創,46,11,35,凱基-永和,2024-02-23,9207
3047,訊舟,62,30,32,凱基-永和,2024-02-23,9207
6593,台灣銘板,30,0,30,凱基-永和,2024-02-23,9207
1528,恩德,30,0,30,凱基-永和,2024-02-23,9207
8114,振樺電,30,0,30,凱基-永和,2024-02-23,9207
2484,希華,30,2,28,凱基-永和,2024-02-23,9207
6579,研揚,25,0,25,凱基-永和,2024-02-23,9207
00850,元大臺灣ESG永續,25,1,24,凱基-永和,2024-02-23,9207
2337,旺宏,25,1,24,凱基-永和,2024-02-23,9207
6237,驊訊,22,0,22,凱基-永和,2024-02-23,9207
8087,麗升能源,20,0,20,凱基-永和,2024-02-23,9207
2405,輔信,433,414,19,凱基-永和,2024-02-23,9207
6679,鈺太,20,1,19,凱基-永和,2024-02-23,9207
4908,前鼎,25,7,18,凱基-永和,2024-02-23,9207
1519,華城,27,9,18,凱基-永和,2024-02-23,9207
3583,辛耘,20,4,16,凱基-永和,2024-02-23,9207
3712,永崴投控,19,3,16,凱基-永和,2024-02-23,9207
00929,復華台灣科技優息,61,46,15,凱基-永和,2024-02-23,9207
2609,陽明,19,4,15,凱基-永和,2024-02-23,9207
00893,國泰智能電動車,17,2,15,凱基-永和,2024-02-23,9207
3402,漢科,15,0,15,凱基-永和,2024-02-23,9207
3581,博磊,15,0,15,凱基-永和,2024-02-23,9207
6134,萬旭,15,0,15,凱基-永和,2024-02-23,9207
00900,富邦特選高股息30,21,7,14,凱基-永和,2024-02-23,9207
00918,大華優利高填息30,14,0,14,凱基-永和,2024-02-23,9207
00637L,元大滬深300正2,21,7,14,凱基-永和,2024-02-23,9207
2618,長榮航,23,10,13,凱基-永和,2024-02-23,9207
2363,矽統,14,1,13,凱基-永和,2024-02-23,9207
4951,精拓科,12,0,12,凱基-永和,2024-02-23,9207
1605,華新,15,4,11,凱基-永和,2024-02-23,9207
1611,中電,10,0,10,凱基-永和,2024-02-23,9207
2371,大同,17,7,10,凱基-永和,2024-02-23,9207
2617,台航,10,0,10,凱基-永和,2024-02-23,9207
00937B,群益ESG投等債20,435,11,424,凱基-永和,2024-02-26,9207
6668,中揚光,241,0,241,凱基-永和,2024-02-26,9207
1711,永光,227,4,223,凱基-永和,2024-02-26,9207
2489,瑞軒,201,10,191,凱基-永和,2024-02-26,9207
6125,廣運,123,1,122,凱基-永和,2024-02-26,9207
00679B,元大美債20年,115,0,115,凱基-永和,2024-02-26,9207
3163,波若威,119,14,105,凱基-永和,2024-02-26,9207
6558,興能高,105,5,100,凱基-永和,2024-02-26,9207
2363,矽統,220,128,92,凱基-永和,2024-02-26,9207
3227,原相,100,10,90,凱基-永和,2024-02-26,9207
00878,國泰永續高股息,90,6,84,凱基-永和,2024-02-26,9207
00892,富邦台灣半導體,70,0,70,凱基-永和,2024-02-26,9207
00929,復華台灣科技優息,57,3,54,凱基-永和,2024-02-26,9207
3481,群創,54,10,44,凱基-永和,2024-02-26,9207
1603,華電,37,0,37,凱基-永和,2024-02-26,9207
1795,美時,33,3,30,凱基-永和,2024-02-26,9207
3530,晶相光,36,6,30,凱基-永和,2024-02-26,9207
2882,國泰金,27,1,26,凱基-永和,2024-02-26,9207
2618,長榮航,22,0,22,凱基-永和,2024-02-26,9207
00895,富邦未來車,20,0,20,凱基-永和,2024-02-26,9207
2312,金寶,20,0,20,凱基-永和,2024-02-26,9207
2338,光罩,21,1,20,凱基-永和,2024-02-26,9207
4763,材料-KY,21,1,20,凱基-永和,2024-02-26,9207
00915,凱基優選高股息30,20,0,20,凱基-永和,2024-02-26,9207
2812,台中銀,30,12,18,凱基-永和,2024-02-26,9207
3260,威剛,19,3,16,凱基-永和,2024-02-26,9207
3535,晶彩科,20,4,16,凱基-永和,2024-02-26,9207
6165,浪凡,15,0,15,凱基-永和,2024-02-26,9207
00637L,元大滬深300正2,13,0,13,凱基-永和,2024-02-26,9207
3265,台星科,13,2,11,凱基-永和,2024-02-26,9207
1717,長興,22,11,11,凱基-永和,2024-02-26,9207
3025,星通,12,1,11,凱基-永和,2024-02-26,9207
2495,普安,11,1,10,凱基-永和,2024-02-26,9207
1303,南亞,10,0,10,凱基-永和,2024-02-26,9207
00753L,中信中國50正2,12,2,10,凱基-永和,2024-02-26,9207
1710,東聯,10,0,10,凱基-永和,2024-02-26,9207
9105,泰金寶-DR,10,0,10,凱基-永和,2024-02-26,9207
9945,潤泰新,10,0,10,凱基-永和,2024-02-26,9207
1101,台泥,10,1,9,凱基-永和,2024-02-26,9207
2204,中華,10,1,9,凱基-永和,2024-02-26,9207
2387,精元,9,0,9,凱基-永和,2024-02-26,9207
2883,凱基金,8,0,8,凱基-永和,2024-02-26,9207
2884,玉山金,18,11,7,凱基-永和,2024-02-26,9207
1514,亞力,236,229,7,凱基-永和,2024-02-26,9207
4951,精拓科,7,0,7,凱基-永和,2024-02-26,9207
1504,東元,7,0,7,凱基-永和,2024-02-26,9207
00632R,元大台灣50反1,6,0,6,凱基-永和,2024-02-26,9207
2329,華泰,10,4,6,凱基-永和,2024-02-26,9207
2820,華票,6,0,6,凱基-永和,2024-02-26,9207
2885,元大金,6,0,6,凱基-永和,2024-02-26,9207
6799,來頡,209,40,169,凱基-永和,2024-02-27,9207
00919,群益台灣精選高息,186,39,147,凱基-永和,2024-02-27,9207
4543,萬在,115,14,101,凱基-永和,2024-02-27,9207
00878,國泰永續高股息,98,6,92,凱基-永和,2024-02-27,9207
5225,東科-KY,120,60,60,凱基-永和,2024-02-27,9207
00937B,群益ESG投等債20,59,0,59,凱基-永和,2024-02-27,9207
6116,彩晶,50,0,50,凱基-永和,2024-02-27,9207
2887,台新金,50,11,39,凱基-永和,2024-02-27,9207
8064,東捷,109,76,33,凱基-永和,2024-02-27,9207
6288,聯嘉,43,11,32,凱基-永和,2024-02-27,9207
6770,力積電,31,0,31,凱基-永和,2024-02-27,9207
3689,湧德,41,10,31,凱基-永和,2024-02-27,9207
1710,東聯,30,0,30,凱基-永和,2024-02-27,9207
6933,AMAX-KY,30,0,30,凱基-永和,2024-02-27,9207
2618,長榮航,41,12,29,凱基-永和,2024-02-27,9207
5269,祥碩,25,0,25,凱基-永和,2024-02-27,9207
6237,驊訊,24,0,24,凱基-永和,2024-02-27,9207
2308,台達電,23,2,21,凱基-永和,2024-02-27,9207
1568,倉佑,20,0,20,凱基-永和,2024-02-27,9207
00632R,元大台灣50反1,20,1,19,凱基-永和,2024-02-27,9207
5508,永信建,19,0,19,凱基-永和,2024-02-27,9207
2331,精英,39,21,18,凱基-永和,2024-02-27,9207
2312,金寶,17,0,17,凱基-永和,2024-02-27,9207
3037,欣興,20,4,16,凱基-永和,2024-02-27,9207
2883B,凱基金乙特,15,0,15,凱基-永和,2024-02-27,9207
1101,台泥,13,0,13,凱基-永和,2024-02-27,9207
3047,訊舟,13,0,13,凱基-永和,2024-02-27,9207
9945,潤泰新,12,0,12,凱基-永和,2024-02-27,9207
2359,所羅門,12,0,12,凱基-永和,2024-02-27,9207
00933B,國泰10Y+金融債,12,1,11,凱基-永和,2024-02-27,9207
2356,英業達,18,7,11,凱基-永和,2024-02-27,9207
2382,廣達,10,0,10,凱基-永和,2024-02-27,9207
00922,國泰台灣領袖50,10,0,10,凱基-永和,2024-02-27,9207
3702A,大聯大甲特,10,0,10,凱基-永和,2024-02-27,9207
4542,科嶠,10,0,10,凱基-永和,2024-02-27,9207
6109,亞元,10,0,10,凱基-永和,2024-02-27,9207
6113,亞矽,13,3,10,凱基-永和,2024-02-27,9207
6532,瑞耘,10,0,10,凱基-永和,2024-02-27,9207
8027,鈦昇,15,6,9,凱基-永和,2024-02-27,9207
00690,兆豐藍籌30,9,0,9,凱基-永和,2024-02-27,9207
6005,群益證,8,0,8,凱基-永和,2024-02-27,9207
8096,擎亞,15,7,8,凱基-永和,2024-02-27,9207
1303,南亞,7,0,7,凱基-永和,2024-02-27,9207
2383,台光電,7,0,7,凱基-永和,2024-02-27,9207
2609,陽明,15,8,7,凱基-永和,2024-02-27,9207
2313,華通,9,2,7,凱基-永和,2024-02-27,9207
5531,鄉林,7,0,7,凱基-永和,2024-02-27,9207
8299,群聯,8,1,7,凱基-永和,2024-02-27,9207
00679B,元大美債20年,11,5,6,凱基-永和,2024-02-27,9207
00673R,期元大S＆P原油反1,6,0,6,凱基-永和,2024-02-27,9207
1316,上曜,302,67,235,凱基-永和,2024-02-29,9207
00919,群益台灣精選高息,227,7,220,凱基-永和,2024-02-29,9207
6125,廣運,232,18,214,凱基-永和,2024-02-29,9207
00679B,元大美債20年,160,5,155,凱基-永和,2024-02-29,9207
3029,零壹,155,0,155,凱基-永和,2024-02-29,9207
6127,九豪,150,5,145,凱基-永和,2024-02-29,9207
3324,雙鴻,139,5,134,凱基-永和,2024-02-29,9207
1513,中興電,410,311,99,凱基-永和,2024-02-29,9207
00937B,群益ESG投等債20,88,0,88,凱基-永和,2024-02-29,9207
3289,宜特,100,28,72,凱基-永和,2024-02-29,9207
3372,典範,121,50,71,凱基-永和,2024-02-29,9207
2809,京城銀,70,0,70,凱基-永和,2024-02-29,9207
6531,愛普*,81,13,68,凱基-永和,2024-02-29,9207
00665L,富邦�琤肭磪囓�2,161,111,50,凱基-永和,2024-02-29,9207
00918,大華優利高填息30,55,10,45,凱基-永和,2024-02-29,9207
6198,瑞築,45,0,45,凱基-永和,2024-02-29,9207
5432,新門,40,1,39,凱基-永和,2024-02-29,9207
1514,亞力,75,38,37,凱基-永和,2024-02-29,9207
6109,亞元,33,0,33,凱基-永和,2024-02-29,9207
2376,技嘉,31,2,29,凱基-永和,2024-02-29,9207
8071,能率網通,27,0,27,凱基-永和,2024-02-29,9207
00687B,國泰20年美債,25,0,25,凱基-永和,2024-02-29,9207
4906,正文,22,0,22,凱基-永和,2024-02-29,9207
5531,鄉林,22,0,22,凱基-永和,2024-02-29,9207
1815,富喬,30,10,20,凱基-永和,2024-02-29,9207
9912,偉聯,20,0,20,凱基-永和,2024-02-29,9207
3228,金麗科,20,0,20,凱基-永和,2024-02-29,9207
2002,中鋼,19,0,19,凱基-永和,2024-02-29,9207
6138,茂達,27,8,19,凱基-永和,2024-02-29,9207
3515,華擎,25,8,17,凱基-永和,2024-02-29,9207
1618,合機,19,3,16,凱基-永和,2024-02-29,9207
2324,仁寶,29,14,15,凱基-永和,2024-02-29,9207
3680,家登,15,0,15,凱基-永和,2024-02-29,9207
2204,中華,14,0,14,凱基-永和,2024-02-29,9207
4951,精拓科,13,0,13,凱基-永和,2024-02-29,9207
00753L,中信中國50正2,11,0,11,凱基-永和,2024-02-29,9207
2317,鴻海,11,0,11,凱基-永和,2024-02-29,9207
2363,矽統,12,1,11,凱基-永和,2024-02-29,9207
3037,欣興,15,5,10,凱基-永和,2024-02-29,9207
8110,華東,10,0,10,凱基-永和,2024-02-29,9207
2303,聯電,40,30,10,凱基-永和,2024-02-29,9207
00909,國泰數位支付服務,10,0,10,凱基-永和,2024-02-29,9207
00648R,元大S＆P500反1,10,0,10,凱基-永和,2024-02-29,9207
2031,新光鋼,10,0,10,凱基-永和,2024-02-29,9207
2615,萬海,10,0,10,凱基-永和,2024-02-29,9207
2880,華南金,10,0,10,凱基-永和,2024-02-29,9207
3013,晟銘電,10,0,10,凱基-永和,2024-02-29,9207
5508,永信建,13,3,10,凱基-永和,2024-02-29,9207
6129,普誠,10,0,10,凱基-永和,2024-02-29,9207
6191,精成科,10,0,10,凱基-永和,2024-02-29,9207
3013,晟銘電,370,23,347,凱基-永和,2024-03-01,9207
00918,大華優利高填息30,203,2,201,凱基-永和,2024-03-01,9207
4402,郡都開發,113,0,113,凱基-永和,2024-03-01,9207
00937B,群益ESG投等債20,107,0,107,凱基-永和,2024-03-01,9207
3376,新日興,101,3,98,凱基-永和,2024-03-01,9207
8080,印鉐,100,9,91,凱基-永和,2024-03-01,9207
3372,典範,215,138,77,凱基-永和,2024-03-01,9207
00679B,元大美債20年,74,0,74,凱基-永和,2024-03-01,9207
3324,雙鴻,71,1,70,凱基-永和,2024-03-01,9207
6531,愛普*,72,2,70,凱基-永和,2024-03-01,9207
2323,中環,50,0,50,凱基-永和,2024-03-01,9207
2609,陽明,61,15,46,凱基-永和,2024-03-01,9207
00687B,國泰20年美債,42,0,42,凱基-永和,2024-03-01,9207
8996,高力,42,2,40,凱基-永和,2024-03-01,9207
3017,奇鋐,42,2,40,凱基-永和,2024-03-01,9207
2204,中華,35,0,35,凱基-永和,2024-03-01,9207
6449,鈺邦,30,0,30,凱基-永和,2024-03-01,9207
00725B,國泰投資級公司債,30,0,30,凱基-永和,2024-03-01,9207
2002,中鋼,36,9,27,凱基-永和,2024-03-01,9207
6715,嘉基,20,0,20,凱基-永和,2024-03-01,9207
8467,波力-KY,20,0,20,凱基-永和,2024-03-01,9207
2369,菱生,19,0,19,凱基-永和,2024-03-01,9207
00929,復華台灣科技優息,28,9,19,凱基-永和,2024-03-01,9207
4526,東台,18,0,18,凱基-永和,2024-03-01,9207
00712,復華富時不動產,19,2,17,凱基-永和,2024-03-01,9207
00637L,元大滬深300正2,61,44,17,凱基-永和,2024-03-01,9207
2327,國巨,16,0,16,凱基-永和,2024-03-01,9207
2367,燿華,18,3,15,凱基-永和,2024-03-01,9207
2324,仁寶,23,8,15,凱基-永和,2024-03-01,9207
8044,網家,16,2,14,凱基-永和,2024-03-01,9207
2618,長榮航,13,0,13,凱基-永和,2024-03-01,9207
1529,樂事綠能,12,0,12,凱基-永和,2024-03-01,9207
2408,南亞科,13,1,12,凱基-永和,2024-03-01,9207
3689,湧德,15,3,12,凱基-永和,2024-03-01,9207
4951,精拓科,12,0,12,凱基-永和,2024-03-01,9207
3055,蔚華科,45,34,11,凱基-永和,2024-03-01,9207
3706,神達,11,0,11,凱基-永和,2024-03-01,9207
4958,臻鼎-KY,11,0,11,凱基-永和,2024-03-01,9207
6770,力積電,11,0,11,凱基-永和,2024-03-01,9207
6126,信音,14,4,10,凱基-永和,2024-03-01,9207
00921,兆豐龍頭等權重,10,0,10,凱基-永和,2024-03-01,9207
00900,富邦特選高股息30,10,0,10,凱基-永和,2024-03-01,9207
1603,華電,10,0,10,凱基-永和,2024-03-01,9207
2617,台航,15,5,10,凱基-永和,2024-03-01,9207
3380,明泰,10,0,10,凱基-永和,2024-03-01,9207
8277,商丞,10,0,10,凱基-永和,2024-03-01,9207
2421,建準,11,2,9,凱基-永和,2024-03-01,9207
2610,華航,9,0,9,凱基-永和,2024-03-01,9207
3708,上緯投控,12,3,9,凱基-永和,2024-03-01,9207
8064,東捷,15,6,9,凱基-永和,2024-03-01,9207
2367,燿華,546,308,238,凱基-永和,2024-03-04,9207
3163,波若威,220,1,219,凱基-永和,2024-03-04,9207
8011,台通,205,1,204,凱基-永和,2024-03-04,9207
00665L,富邦�琤肭磪囓�2,200,0,200,凱基-永和,2024-03-04,9207
00885,富邦越南,100,0,100,凱基-永和,2024-03-04,9207
2449,京元電子,102,3,99,凱基-永和,2024-03-04,9207
2409,友達,80,0,80,凱基-永和,2024-03-04,9207
00919,群益台灣精選高息,59,5,54,凱基-永和,2024-03-04,9207
00918,大華優利高填息30,51,0,51,凱基-永和,2024-03-04,9207
3324,雙鴻,51,1,50,凱基-永和,2024-03-04,9207
3230,錦明,49,0,49,凱基-永和,2024-03-04,9207
6227,茂綸,50,2,48,凱基-永和,2024-03-04,9207
00915,凱基優選高股息30,44,2,42,凱基-永和,2024-03-04,9207
3481,群創,40,2,38,凱基-永和,2024-03-04,9207
4545,銘鈺,37,0,37,凱基-永和,2024-03-04,9207
6770,力積電,36,2,34,凱基-永和,2024-03-04,9207
00632R,元大台灣50反1,32,0,32,凱基-永和,2024-03-04,9207
00878,國泰永續高股息,45,17,28,凱基-永和,2024-03-04,9207
1815,富喬,53,28,25,凱基-永和,2024-03-04,9207
5234,達興材料,25,0,25,凱基-永和,2024-03-04,9207
2408,南亞科,21,0,21,凱基-永和,2024-03-04,9207
2903,遠百,20,0,20,凱基-永和,2024-03-04,9207
5392,能率,20,0,20,凱基-永和,2024-03-04,9207
6735,美達科技,20,0,20,凱基-永和,2024-03-04,9207
3231,緯創,54,36,18,凱基-永和,2024-03-04,9207
2324,仁寶,182,166,16,凱基-永和,2024-03-04,9207
6757,台灣虎航,15,0,15,凱基-永和,2024-03-04,9207
4960,誠美材,14,0,14,凱基-永和,2024-03-04,9207
8936,國統,20,6,14,凱基-永和,2024-03-04,9207
5272,笙科,13,0,13,凱基-永和,2024-03-04,9207
2421,建準,16,5,11,凱基-永和,2024-03-04,9207
3437,榮創,11,0,11,凱基-永和,2024-03-04,9207
3701,大眾控,11,0,11,凱基-永和,2024-03-04,9207
00687B,國泰20年美債,10,0,10,凱基-永和,2024-03-04,9207
2618,長榮航,12,2,10,凱基-永和,2024-03-04,9207
8467,波力-KY,10,0,10,凱基-永和,2024-03-04,9207
006208,富邦台50,14,4,10,凱基-永和,2024-03-04,9207
1514,亞力,21,12,9,凱基-永和,2024-03-04,9207
3169,亞信,9,0,9,凱基-永和,2024-03-04,9207
2382,廣達,11,2,9,凱基-永和,2024-03-04,9207
6531,愛普*,12,4,8,凱基-永和,2024-03-04,9207
6109,亞元,8,0,8,凱基-永和,2024-03-04,9207
2880,華南金,10,2,8,凱基-永和,2024-03-04,9207
1513,中興電,8,1,7,凱基-永和,2024-03-04,9207
2347,聯強,7,0,7,凱基-永和,2024-03-04,9207
2610,華航,10,3,7,凱基-永和,2024-03-04,9207
00882,中信中國高股息,6,0,6,凱基-永和,2024-03-04,9207
00937B,群益ESG投等債20,11,5,6,凱基-永和,2024-03-04,9207
1618,合機,7,1,6,凱基-永和,2024-03-04,9207
2355,敬鵬,6,0,6,凱基-永和,2024-03-04,9207
2516,新建,300,0,300,凱基-永和,2024-03-05,9207
3325,旭品,500,203,297,凱基-永和,2024-03-05,9207
6143,振曜,221,1,220,凱基-永和,2024-03-05,9207
6117,迎廣,214,2,212,凱基-永和,2024-03-05,9207
00665L,富邦�琤肭磪囓�2,166,10,156,凱基-永和,2024-03-05,9207
1455,集盛,300,150,150,凱基-永和,2024-03-05,9207
5426,振發,152,7,145,凱基-永和,2024-03-05,9207
5465,富驊,120,0,120,凱基-永和,2024-03-05,9207
6276,安鈦克,111,1,110,凱基-永和,2024-03-05,9207
8163,達方,100,0,100,凱基-永和,2024-03-05,9207
2330,台積電,141,52,89,凱基-永和,2024-03-05,9207
00919,群益台灣精選高息,106,18,88,凱基-永和,2024-03-05,9207
8996,高力,88,1,87,凱基-永和,2024-03-05,9207
6161,捷波,80,1,79,凱基-永和,2024-03-05,9207
00857B,永豐20年美公債,102,30,72,凱基-永和,2024-03-05,9207
5439,高技,71,1,70,凱基-永和,2024-03-05,9207
00650L,復華香港正2,64,0,64,凱基-永和,2024-03-05,9207
3017,奇鋐,64,2,62,凱基-永和,2024-03-05,9207
3564,其陽,210,150,60,凱基-永和,2024-03-05,9207
2890,永豐金,50,0,50,凱基-永和,2024-03-05,9207
8210,勤誠,51,2,49,凱基-永和,2024-03-05,9207
2888,新光金,46,0,46,凱基-永和,2024-03-05,9207
6116,彩晶,40,0,40,凱基-永和,2024-03-05,9207
00937B,群益ESG投等債20,77,40,37,凱基-永和,2024-03-05,9207
00687B,國泰20年美債,38,1,37,凱基-永和,2024-03-05,9207
3481,群創,33,1,32,凱基-永和,2024-03-05,9207
00679B,元大美債20年,31,0,31,凱基-永和,2024-03-05,9207
3206,志豐,30,0,30,凱基-永和,2024-03-05,9207
2323,中環,30,0,30,凱基-永和,2024-03-05,9207
00929,復華台灣科技優息,34,7,27,凱基-永和,2024-03-05,9207
3287,廣寰科,25,0,25,凱基-永和,2024-03-05,9207
00632R,元大台灣50反1,34,10,24,凱基-永和,2024-03-05,9207
00933B,國泰10Y+金融債,23,0,23,凱基-永和,2024-03-05,9207
00752,中信中國50,23,0,23,凱基-永和,2024-03-05,9207
1528,恩德,20,0,20,凱基-永和,2024-03-05,9207
6127,九豪,22,2,20,凱基-永和,2024-03-05,9207
2376,技嘉,20,1,19,凱基-永和,2024-03-05,9207
6284,佳邦,15,0,15,凱基-永和,2024-03-05,9207
3260,威剛,16,4,12,凱基-永和,2024-03-05,9207
2324,仁寶,14,3,11,凱基-永和,2024-03-05,9207
1524,耿鼎,11,0,11,凱基-永和,2024-03-05,9207
3005,神基,18,7,11,凱基-永和,2024-03-05,9207
3234,光環,14,3,11,凱基-永和,2024-03-05,9207
6237,驊訊,21,10,11,凱基-永和,2024-03-05,9207
00893,國泰智能電動車,10,0,10,凱基-永和,2024-03-05,9207
1445,大宇,15,5,10,凱基-永和,2024-03-05,9207
1503,士電,18,8,10,凱基-永和,2024-03-05,9207
2353,宏��,22,12,10,凱基-永和,2024-03-05,9207
2355,敬鵬,10,0,10,凱基-永和,2024-03-05,9207
2483,百容,10,0,10,凱基-永和,2024-03-05,9207
2367,燿華,1177,555,622,凱基-永和,2024-03-06,9207
5521,工信,303,0,303,凱基-永和,2024-03-06,9207
5452,佶優,202,3,199,凱基-永和,2024-03-06,9207
8034,榮群,200,4,196,凱基-永和,2024-03-06,9207
3017,奇鋐,211,64,147,凱基-永和,2024-03-06,9207
00918,大華優利高填息30,136,0,136,凱基-永和,2024-03-06,9207
5488,松普,103,0,103,凱基-永和,2024-03-06,9207
3338,泰碩,90,3,87,凱基-永和,2024-03-06,9207
4542,科嶠,82,0,82,凱基-永和,2024-03-06,9207
6290,良維,81,0,81,凱基-永和,2024-03-06,9207
5234,達興材料,80,0,80,凱基-永和,2024-03-06,9207
00919,群益台灣精選高息,85,8,77,凱基-永和,2024-03-06,9207
3540,曜越,120,47,73,凱基-永和,2024-03-06,9207
6757,台灣虎航,55,0,55,凱基-永和,2024-03-06,9207
3231,緯創,55,3,52,凱基-永和,2024-03-06,9207
00679B,元大美債20年,52,1,51,凱基-永和,2024-03-06,9207
2371,大同,55,4,51,凱基-永和,2024-03-06,9207
6933,AMAX-KY,45,0,45,凱基-永和,2024-03-06,9207
3564,其陽,101,62,39,凱基-永和,2024-03-06,9207
3289,宜特,35,0,35,凱基-永和,2024-03-06,9207
00632R,元大台灣50反1,33,1,32,凱基-永和,2024-03-06,9207
8467,波力-KY,30,0,30,凱基-永和,2024-03-06,9207
00915,凱基優選高股息30,30,2,28,凱基-永和,2024-03-06,9207
2467,志聖,51,28,23,凱基-永和,2024-03-06,9207
2344,華邦電,21,0,21,凱基-永和,2024-03-06,9207
3533,嘉澤,23,2,21,凱基-永和,2024-03-06,9207
1217,愛之味,20,0,20,凱基-永和,2024-03-06,9207
2323,中環,20,0,20,凱基-永和,2024-03-06,9207
3563,牧德,20,0,20,凱基-永和,2024-03-06,9207
6894,衛司特,20,2,18,凱基-永和,2024-03-06,9207
4533,協易機,19,1,18,凱基-永和,2024-03-06,9207
2349,錸德,15,0,15,凱基-永和,2024-03-06,9207
3512,皇龍,13,0,13,凱基-永和,2024-03-06,9207
2888,新光金,30,18,12,凱基-永和,2024-03-06,9207
3228,金麗科,14,2,12,凱基-永和,2024-03-06,9207
2609,陽明,13,1,12,凱基-永和,2024-03-06,9207
2610,華航,11,0,11,凱基-永和,2024-03-06,9207
8071,能率網通,11,0,11,凱基-永和,2024-03-06,9207
2421,建準,13,2,11,凱基-永和,2024-03-06,9207
2020,美亞,10,0,10,凱基-永和,2024-03-06,9207
2485,兆赫,11,1,10,凱基-永和,2024-03-06,9207
2524,京城,10,0,10,凱基-永和,2024-03-06,9207
2543,皇昌,12,2,10,凱基-永和,2024-03-06,9207
5381,合正,10,0,10,凱基-永和,2024-03-06,9207
8080,印鉐,55,45,10,凱基-永和,2024-03-06,9207
1503,士電,9,0,9,凱基-永和,2024-03-06,9207
2408,南亞科,8,0,8,凱基-永和,2024-03-06,9207
2897A,王道銀甲特,8,0,8,凱基-永和,2024-03-06,9207
5213,亞昕,8,0,8,凱基-永和,2024-03-06,9207
1303,南亞,7,0,7,凱基-永和,2024-03-06,9207
8097,常珵,130,0,130,凱基-永和,2024-03-07,9207
00857B,永豐20年美公債,116,0,116,凱基-永和,2024-03-07,9207
8027,鈦昇,81,1,80,凱基-永和,2024-03-07,9207
3163,波若威,252,176,76,凱基-永和,2024-03-07,9207
8933,愛地雅,55,1,54,凱基-永和,2024-03-07,9207
1217,愛之味,53,0,53,凱基-永和,2024-03-07,9207
00919,群益台灣精選高息,85,33,52,凱基-永和,2024-03-07,9207
3481,群創,59,11,48,凱基-永和,2024-03-07,9207
4743,合一,49,1,48,凱基-永和,2024-03-07,9207
3702,大聯大,49,6,43,凱基-永和,2024-03-07,9207
3548,兆利,142,100,42,凱基-永和,2024-03-07,9207
2313,華通,39,1,38,凱基-永和,2024-03-07,9207
00929,復華台灣科技優息,39,4,35,凱基-永和,2024-03-07,9207
00680L,元大美債20正2,33,0,33,凱基-永和,2024-03-07,9207
00687B,國泰20年美債,33,2,31,凱基-永和,2024-03-07,9207
2337,旺宏,30,0,30,凱基-永和,2024-03-07,9207
2374,佳能,30,0,30,凱基-永和,2024-03-07,9207
1815,富喬,70,41,29,凱基-永和,2024-03-07,9207
2324,仁寶,28,1,27,凱基-永和,2024-03-07,9207
2609,陽明,26,0,26,凱基-永和,2024-03-07,9207
4906,正文,30,6,24,凱基-永和,2024-03-07,9207
6005,群益證,21,0,21,凱基-永和,2024-03-07,9207
6265,方土昶,21,0,21,凱基-永和,2024-03-07,9207
00632R,元大台灣50反1,30,10,20,凱基-永和,2024-03-07,9207
2342,茂矽,20,0,20,凱基-永和,2024-03-07,9207
3563,牧德,20,0,20,凱基-永和,2024-03-07,9207
3231,緯創,28,9,19,凱基-永和,2024-03-07,9207
00655L,國泰中國A50正2,20,1,19,凱基-永和,2024-03-07,9207
6168,宏齊,19,0,19,凱基-永和,2024-03-07,9207
1503,士電,19,1,18,凱基-永和,2024-03-07,9207
00881,國泰台灣5G+,21,4,17,凱基-永和,2024-03-07,9207
2486,一詮,22,6,16,凱基-永和,2024-03-07,9207
6125,廣運,25,9,16,凱基-永和,2024-03-07,9207
2002,中鋼,21,5,16,凱基-永和,2024-03-07,9207
1608,華榮,18,3,15,凱基-永和,2024-03-07,9207
2363,矽統,15,0,15,凱基-永和,2024-03-07,9207
3022,威強電,14,0,14,凱基-永和,2024-03-07,9207
3587,閎康,13,0,13,凱基-永和,2024-03-07,9207
4951,精拓科,14,2,12,凱基-永和,2024-03-07,9207
6223,旺矽,13,1,12,凱基-永和,2024-03-07,9207
6190,萬泰科,11,0,11,凱基-永和,2024-03-07,9207
8087,麗升能源,11,0,11,凱基-永和,2024-03-07,9207
6770,力積電,10,0,10,凱基-永和,2024-03-07,9207
4939,亞電,10,0,10,凱基-永和,2024-03-07,9207
00905,FT臺灣Smart,10,0,10,凱基-永和,2024-03-07,9207
2007,燁興,10,0,10,凱基-永和,2024-03-07,9207
2548,華固,10,0,10,凱基-永和,2024-03-07,9207
3702A,大聯大甲特,10,0,10,凱基-永和,2024-03-07,9207
5469,瀚宇博,15,5,10,凱基-永和,2024-03-07,9207
6584,南俊國際,81,71,10,凱基-永和,2024-03-07,9207
00919,群益台灣精選高息,230,78,152,凱基-永和,2024-03-08,9207
2465,麗臺,101,0,101,凱基-永和,2024-03-08,9207
3013,晟銘電,105,5,100,凱基-永和,2024-03-08,9207
00665L,富邦�琤肭磪囓�2,97,0,97,凱基-永和,2024-03-08,9207
00679B,元大美債20年,81,1,80,凱基-永和,2024-03-08,9207
2344,華邦電,60,2,58,凱基-永和,2024-03-08,9207
00632R,元大台灣50反1,52,0,52,凱基-永和,2024-03-08,9207
2501,國建,50,0,50,凱基-永和,2024-03-08,9207
4908,前鼎,45,1,44,凱基-永和,2024-03-08,9207
5347,世界,29,0,29,凱基-永和,2024-03-08,9207
00918,大華優利高填息30,48,21,27,凱基-永和,2024-03-08,9207
1217,愛之味,25,1,24,凱基-永和,2024-03-08,9207
2603,長榮,34,12,22,凱基-永和,2024-03-08,9207
8096,擎亞,21,0,21,凱基-永和,2024-03-08,9207
1611,中電,20,0,20,凱基-永和,2024-03-08,9207
2385,群光,21,2,19,凱基-永和,2024-03-08,9207
3022,威強電,20,1,19,凱基-永和,2024-03-08,9207
6265,方土昶,17,0,17,凱基-永和,2024-03-08,9207
6616,特昇-KY,22,5,17,凱基-永和,2024-03-08,9207
5483,中美晶,25,9,16,凱基-永和,2024-03-08,9207
2347,聯強,15,0,15,凱基-永和,2024-03-08,9207
5478,智冠,13,0,13,凱基-永和,2024-03-08,9207
3481,群創,13,1,12,凱基-永和,2024-03-08,9207
1752,南光,12,0,12,凱基-永和,2024-03-08,9207
3178,公準,12,0,12,凱基-永和,2024-03-08,9207
6245,立端,12,0,12,凱基-永和,2024-03-08,9207
8044,網家,27,15,12,凱基-永和,2024-03-08,9207
3032,偉訓,11,0,11,凱基-永和,2024-03-08,9207
2486,一詮,14,4,10,凱基-永和,2024-03-08,9207
00712,復華富時不動產,10,0,10,凱基-永和,2024-03-08,9207
2515,中工,10,0,10,凱基-永和,2024-03-08,9207
2867,三商壽,10,0,10,凱基-永和,2024-03-08,9207
3211,順達,10,0,10,凱基-永和,2024-03-08,9207
5381,合正,10,0,10,凱基-永和,2024-03-08,9207
8358,金居,10,0,10,凱基-永和,2024-03-08,9207
6109,亞元,44,35,9,凱基-永和,2024-03-08,9207
1312,國喬,8,0,8,凱基-永和,2024-03-08,9207
3138,耀登,8,0,8,凱基-永和,2024-03-08,9207
3380,明泰,10,2,8,凱基-永和,2024-03-08,9207
4147,中裕,8,0,8,凱基-永和,2024-03-08,9207
6274,台燿,10,2,8,凱基-永和,2024-03-08,9207
3413,京鼎,13,5,8,凱基-永和,2024-03-08,9207
3265,台星科,12,5,7,凱基-永和,2024-03-08,9207
1529,樂事綠能,7,0,7,凱基-永和,2024-03-08,9207
2887,台新金,7,0,7,凱基-永和,2024-03-08,9207
8069,元太,6,0,6,凱基-永和,2024-03-08,9207
00673R,期元大S＆P原油反1,6,0,6,凱基-永和,2024-03-08,9207
1503,士電,12,6,6,凱基-永和,2024-03-08,9207
2634,漢翔,6,0,6,凱基-永和,2024-03-08,9207
3081,聯亞,6,0,6,凱基-永和,2024-03-08,9207
6120,達運,200,0,200,凱基-永和,2024-03-11,9207
8059,凱碩,140,0,140,凱基-永和,2024-03-11,9207
00892,富邦台灣半導體,122,0,122,凱基-永和,2024-03-11,9207
8996,高力,120,1,119,凱基-永和,2024-03-11,9207
00632R,元大台灣50反1,112,1,111,凱基-永和,2024-03-11,9207
3324,雙鴻,130,31,99,凱基-永和,2024-03-11,9207
00919,群益台灣精選高息,117,35,82,凱基-永和,2024-03-11,9207
00937B,群益ESG投等債20,79,2,77,凱基-永和,2024-03-11,9207
8099,大世科,62,0,62,凱基-永和,2024-03-11,9207
2543,皇昌,201,150,51,凱基-永和,2024-03-11,9207
4979,華星光,49,1,48,凱基-永和,2024-03-11,9207
00706L,期元大S＆P日圓正2,44,0,44,凱基-永和,2024-03-11,9207
8467,波力-KY,30,0,30,凱基-永和,2024-03-11,9207
2323,中環,30,1,29,凱基-永和,2024-03-11,9207
2367,燿華,49,23,26,凱基-永和,2024-03-11,9207
2457,飛宏,25,0,25,凱基-永和,2024-03-11,9207
6531,愛普*,38,13,25,凱基-永和,2024-03-11,9207
00679B,元大美債20年,21,0,21,凱基-永和,2024-03-11,9207
5432,新門,20,0,20,凱基-永和,2024-03-11,9207
6244,茂迪,21,2,19,凱基-永和,2024-03-11,9207
3017,奇鋐,21,3,18,凱基-永和,2024-03-11,9207
2888,新光金,15,0,15,凱基-永和,2024-03-11,9207
8071,能率網通,15,0,15,凱基-永和,2024-03-11,9207
2308,台達電,12,0,12,凱基-永和,2024-03-11,9207
2610,華航,12,0,12,凱基-永和,2024-03-11,9207
8933,愛地雅,12,0,12,凱基-永和,2024-03-11,9207
00687B,國泰20年美債,12,0,12,凱基-永和,2024-03-11,9207
6182,合晶,19,8,11,凱基-永和,2024-03-11,9207
6259,百徽,11,0,11,凱基-永和,2024-03-11,9207
2330,台積電,15,4,11,凱基-永和,2024-03-11,9207
6547,高端疫苗,10,0,10,凱基-永和,2024-03-11,9207
1528,恩德,10,0,10,凱基-永和,2024-03-11,9207
2548,華固,10,0,10,凱基-永和,2024-03-11,9207
2614,東森,10,0,10,凱基-永和,2024-03-11,9207
3047,訊舟,10,0,10,凱基-永和,2024-03-11,9207
3545,敦泰,10,0,10,凱基-永和,2024-03-11,9207
3706,神達,10,0,10,凱基-永和,2024-03-11,9207
5508,永信建,10,0,10,凱基-永和,2024-03-11,9207
8011,台通,10,1,9,凱基-永和,2024-03-11,9207
1316,上曜,9,0,9,凱基-永和,2024-03-11,9207
3533,嘉澤,10,1,9,凱基-永和,2024-03-11,9207
8926,台汽電,11,2,9,凱基-永和,2024-03-11,9207
2347,聯強,9,0,9,凱基-永和,2024-03-11,9207
4908,前鼎,8,0,8,凱基-永和,2024-03-11,9207
4128,中天,7,0,7,凱基-永和,2024-03-11,9207
3707,漢磊,40,33,7,凱基-永和,2024-03-11,9207
2618,長榮航,7,0,7,凱基-永和,2024-03-11,9207
2883,凱基金,8,2,6,凱基-永和,2024-03-11,9207
00715L,期街口布蘭特正2,6,0,6,凱基-永和,2024-03-11,9207
2359,所羅門,6,0,6,凱基-永和,2024-03-11,9207
2354,鴻準,502,59,443,凱基-永和,2024-03-12,9207
2317,鴻海,393,92,301,凱基-永和,2024-03-12,9207
5347,世界,221,4,217,凱基-永和,2024-03-12,9207
3516,亞帝歐,208,0,208,凱基-永和,2024-03-12,9207
1524,耿鼎,200,1,199,凱基-永和,2024-03-12,9207
8064,東捷,200,3,197,凱基-永和,2024-03-12,9207
3325,旭品,221,33,188,凱基-永和,2024-03-12,9207
3050,鈺德,172,0,172,凱基-永和,2024-03-12,9207
00632R,元大台灣50反1,120,0,120,凱基-永和,2024-03-12,9207
3017,奇鋐,155,46,109,凱基-永和,2024-03-12,9207
6290,良維,69,0,69,凱基-永和,2024-03-12,9207
2465,麗臺,61,1,60,凱基-永和,2024-03-12,9207
6425,易發,61,1,60,凱基-永和,2024-03-12,9207
6161,捷波,51,0,51,凱基-永和,2024-03-12,9207
00857B,永豐20年美公債,50,0,50,凱基-永和,2024-03-12,9207
5244,弘凱,50,0,50,凱基-永和,2024-03-12,9207
00918,大華優利高填息30,55,6,49,凱基-永和,2024-03-12,9207
4909,新復興,51,2,49,凱基-永和,2024-03-12,9207
1808,潤隆,50,1,49,凱基-永和,2024-03-12,9207
6742,澤米,46,0,46,凱基-永和,2024-03-12,9207
2548,華固,35,0,35,凱基-永和,2024-03-12,9207
2323,中環,33,3,30,凱基-永和,2024-03-12,9207
6933,AMAX-KY,30,0,30,凱基-永和,2024-03-12,9207
2888,新光金,35,7,28,凱基-永和,2024-03-12,9207
3260,威剛,26,0,26,凱基-永和,2024-03-12,9207
2845,遠東銀,25,0,25,凱基-永和,2024-03-12,9207
3484,崧騰,25,0,25,凱基-永和,2024-03-12,9207
00751B,元大AAA至A公司債,21,0,21,凱基-永和,2024-03-12,9207
1217,愛之味,21,0,21,凱基-永和,2024-03-12,9207
00753L,中信中國50正2,20,0,20,凱基-永和,2024-03-12,9207
00706L,期元大S＆P日圓正2,20,0,20,凱基-永和,2024-03-12,9207
6416,瑞祺電通,21,2,19,凱基-永和,2024-03-12,9207
00937B,群益ESG投等債20,20,2,18,凱基-永和,2024-03-12,9207
3583,辛耘,24,7,17,凱基-永和,2024-03-12,9207
4934,太極,17,0,17,凱基-永和,2024-03-12,9207
00679B,元大美債20年,16,0,16,凱基-永和,2024-03-12,9207
2355,敬鵬,15,0,15,凱基-永和,2024-03-12,9207
2376,技嘉,18,3,15,凱基-永和,2024-03-12,9207
2408,南亞科,15,0,15,凱基-永和,2024-03-12,9207
2892,第一金,15,0,15,凱基-永和,2024-03-12,9207
2324,仁寶,17,3,14,凱基-永和,2024-03-12,9207
00687B,國泰20年美債,13,0,13,凱基-永和,2024-03-12,9207
1608,華榮,15,2,13,凱基-永和,2024-03-12,9207
1609,大亞,14,1,13,凱基-永和,2024-03-12,9207
00902,中信電池及儲能,12,0,12,凱基-永和,2024-03-12,9207
2834,臺企銀,11,0,11,凱基-永和,2024-03-12,9207
3313,斐成,11,0,11,凱基-永和,2024-03-12,9207
1589,永冠-KY,14,3,11,凱基-永和,2024-03-12,9207
2352,佳世達,10,0,10,凱基-永和,2024-03-12,9207
6217,中探針,10,0,10,凱基-永和,2024-03-12,9207
1616,億泰,202,1,201,凱基-永和,2024-03-13,9207
8011,台通,213,60,153,凱基-永和,2024-03-13,9207
3231,緯創,164,95,69,凱基-永和,2024-03-13,9207
6593,台灣銘板,65,0,65,凱基-永和,2024-03-13,9207
00919,群益台灣精選高息,74,11,63,凱基-永和,2024-03-13,9207
3324,雙鴻,38,6,32,凱基-永和,2024-03-13,9207
00857B,永豐20年美公債,80,50,30,凱基-永和,2024-03-13,9207
2548,華固,30,0,30,凱基-永和,2024-03-13,9207
3284,太普高,30,0,30,凱基-永和,2024-03-13,9207
5488,松普,30,0,30,凱基-永和,2024-03-13,9207
6596,寬宏藝術,60,30,30,凱基-永和,2024-03-13,9207
00706L,期元大S＆P日圓正2,25,0,25,凱基-永和,2024-03-13,9207
1217,愛之味,25,0,25,凱基-永和,2024-03-13,9207
1503,士電,113,89,24,凱基-永和,2024-03-13,9207
00937B,群益ESG投等債20,26,3,23,凱基-永和,2024-03-13,9207
2883,凱基金,66,44,22,凱基-永和,2024-03-13,9207
9902,台火,35,13,22,凱基-永和,2024-03-13,9207
00918,大華優利高填息30,31,9,22,凱基-永和,2024-03-13,9207
4729,熒茂,20,0,20,凱基-永和,2024-03-13,9207
2328,廣宇,20,0,20,凱基-永和,2024-03-13,9207
2301,光寶科,19,0,19,凱基-永和,2024-03-13,9207
8071,能率網通,19,0,19,凱基-永和,2024-03-13,9207
8926,台汽電,20,2,18,凱基-永和,2024-03-13,9207
1608,華榮,21,5,16,凱基-永和,2024-03-13,9207
2455,全新,16,0,16,凱基-永和,2024-03-13,9207
4933,友輝,15,0,15,凱基-永和,2024-03-13,9207
4960,誠美材,22,7,15,凱基-永和,2024-03-13,9207
2002,中鋼,14,0,14,凱基-永和,2024-03-13,9207
00878,國泰永續高股息,32,19,13,凱基-永和,2024-03-13,9207
2460,建通,13,0,13,凱基-永和,2024-03-13,9207
6024,群益期,11,0,11,凱基-永和,2024-03-13,9207
3163,波若威,189,178,11,凱基-永和,2024-03-13,9207
1471,首利,11,0,11,凱基-永和,2024-03-13,9207
2337,旺宏,11,0,11,凱基-永和,2024-03-13,9207
3005,神基,19,8,11,凱基-永和,2024-03-13,9207
1802,台玻,10,0,10,凱基-永和,2024-03-13,9207
00679B,元大美債20年,20,10,10,凱基-永和,2024-03-13,9207
00650L,復華香港正2,10,0,10,凱基-永和,2024-03-13,9207
1618,合機,11,1,10,凱基-永和,2024-03-13,9207
2374,佳能,10,0,10,凱基-永和,2024-03-13,9207
2607,榮運,10,0,10,凱基-永和,2024-03-13,9207
3029,零壹,12,2,10,凱基-永和,2024-03-13,9207
6129,普誠,10,0,10,凱基-永和,2024-03-13,9207
6274,台燿,10,0,10,凱基-永和,2024-03-13,9207
8097,常珵,12,2,10,凱基-永和,2024-03-13,9207
8171,天宇,10,0,10,凱基-永和,2024-03-13,9207
2464,盟立,10,1,9,凱基-永和,2024-03-13,9207
3705,永信,9,0,9,凱基-永和,2024-03-13,9207
4908,前鼎,11,2,9,凱基-永和,2024-03-13,9207
6412,群電,25,16,9,凱基-永和,2024-03-13,9207
00919,群益台灣精選高息,151,21,130,凱基-永和,2024-03-14,9207
2371,大同,102,0,102,凱基-永和,2024-03-14,9207
2383,台光電,145,87,58,凱基-永和,2024-03-14,9207
00687B,國泰20年美債,53,0,53,凱基-永和,2024-03-14,9207
6206,飛捷,50,0,50,凱基-永和,2024-03-14,9207
00753L,中信中國50正2,42,0,42,凱基-永和,2024-03-14,9207
2834,臺企銀,1144,1102,42,凱基-永和,2024-03-14,9207
2618,長榮航,49,11,38,凱基-永和,2024-03-14,9207
00915,凱基優選高股息30,58,21,37,凱基-永和,2024-03-14,9207
2330,台積電,193,158,35,凱基-永和,2024-03-14,9207
6531,愛普*,123,88,35,凱基-永和,2024-03-14,9207
6290,良維,31,0,31,凱基-永和,2024-03-14,9207
4967,十銓,30,0,30,凱基-永和,2024-03-14,9207
00637L,元大滬深300正2,28,0,28,凱基-永和,2024-03-14,9207
6109,亞元,27,0,27,凱基-永和,2024-03-14,9207
2603,長榮,46,19,27,凱基-永和,2024-03-14,9207
00937B,群益ESG投等債20,58,32,26,凱基-永和,2024-03-14,9207
2883,凱基金,38,12,26,凱基-永和,2024-03-14,9207
00857B,永豐20年美公債,25,0,25,凱基-永和,2024-03-14,9207
6829,千附精密,22,0,22,凱基-永和,2024-03-14,9207
00929,復華台灣科技優息,38,17,21,凱基-永和,2024-03-14,9207
2515,中工,20,0,20,凱基-永和,2024-03-14,9207
2836,高雄銀,20,0,20,凱基-永和,2024-03-14,9207
00918,大華優利高填息30,31,12,19,凱基-永和,2024-03-14,9207
00655L,國泰中國A50正2,19,1,18,凱基-永和,2024-03-14,9207
1789,神隆,18,0,18,凱基-永和,2024-03-14,9207
2897,王道銀行,20,3,17,凱基-永和,2024-03-14,9207
2376,技嘉,21,5,16,凱基-永和,2024-03-14,9207
2609,陽明,15,0,15,凱基-永和,2024-03-14,9207
2548,華固,15,0,15,凱基-永和,2024-03-14,9207
5347,世界,17,2,15,凱基-永和,2024-03-14,9207
3047,訊舟,13,0,13,凱基-永和,2024-03-14,9207
3059,華晶科,12,0,12,凱基-永和,2024-03-14,9207
2347,聯強,12,0,12,凱基-永和,2024-03-14,9207
00933B,國泰10Y+金融債,10,0,10,凱基-永和,2024-03-14,9207
1582,信錦,13,3,10,凱基-永和,2024-03-14,9207
2014,中鴻,12,2,10,凱基-永和,2024-03-14,9207
2365,昆盈,10,0,10,凱基-永和,2024-03-14,9207
2634,漢翔,10,0,10,凱基-永和,2024-03-14,9207
3533,嘉澤,10,0,10,凱基-永和,2024-03-14,9207
3705,永信,10,0,10,凱基-永和,2024-03-14,9207
5488,松普,10,0,10,凱基-永和,2024-03-14,9207
5508,永信建,10,0,10,凱基-永和,2024-03-14,9207
6147,頎邦,12,2,10,凱基-永和,2024-03-14,9207
00633L,富邦上証正2,9,0,9,凱基-永和,2024-03-14,9207
8044,網家,9,0,9,凱基-永和,2024-03-14,9207
00878,國泰永續高股息,20,12,8,凱基-永和,2024-03-14,9207
2356,英業達,13,5,8,凱基-永和,2024-03-14,9207
2460,建通,8,0,8,凱基-永和,2024-03-14,9207
00679B,元大美債20年,48,40,8,凱基-永和,2024-03-14,9207
2317,鴻海,1419,435,984,凱基-永和,2024-03-15,9207
00665L,富邦�琤肭磪囓�2,341,0,341,凱基-永和,2024-03-15,9207
00919,群益台灣精選高息,169,3,166,凱基-永和,2024-03-15,9207
5519,隆大,145,0,145,凱基-永和,2024-03-15,9207
3294,英濟,100,1,99,凱基-永和,2024-03-15,9207
2883,凱基金,86,7,79,凱基-永和,2024-03-15,9207
00933B,國泰10Y+金融債,77,0,77,凱基-永和,2024-03-15,9207
00937B,群益ESG投等債20,63,0,63,凱基-永和,2024-03-15,9207
6206,飛捷,60,0,60,凱基-永和,2024-03-15,9207
2383,台光電,112,55,57,凱基-永和,2024-03-15,9207
2888,新光金,53,1,52,凱基-永和,2024-03-15,9207
2025,千興,50,0,50,凱基-永和,2024-03-15,9207
2382,廣達,66,27,39,凱基-永和,2024-03-15,9207
2603,長榮,41,8,33,凱基-永和,2024-03-15,9207
6187,萬潤,32,0,32,凱基-永和,2024-03-15,9207
00679B,元大美債20年,32,0,32,凱基-永和,2024-03-15,9207
6933,AMAX-KY,30,0,30,凱基-永和,2024-03-15,9207
8097,常珵,27,0,27,凱基-永和,2024-03-15,9207
2308,台達電,24,0,24,凱基-永和,2024-03-15,9207
00751B,元大AAA至A公司債,23,0,23,凱基-永和,2024-03-15,9207
00885,富邦越南,21,0,21,凱基-永和,2024-03-15,9207
00918,大華優利高填息30,45,24,21,凱基-永和,2024-03-15,9207
2449,京元電子,21,1,20,凱基-永和,2024-03-15,9207
6190,萬泰科,20,0,20,凱基-永和,2024-03-15,9207
3702,大聯大,35,16,19,凱基-永和,2024-03-15,9207
2882,國泰金,19,0,19,凱基-永和,2024-03-15,9207
2313,華通,18,1,17,凱基-永和,2024-03-15,9207
6757,台灣虎航,15,0,15,凱基-永和,2024-03-15,9207
3041,揚智,14,0,14,凱基-永和,2024-03-15,9207
00830,國泰費城半導體,14,1,13,凱基-永和,2024-03-15,9207
00857B,永豐20年美公債,12,0,12,凱基-永和,2024-03-15,9207
2855,統一證,20,8,12,凱基-永和,2024-03-15,9207
6829,千附精密,12,0,12,凱基-永和,2024-03-15,9207
2611,志信,12,0,12,凱基-永和,2024-03-15,9207
2353,宏��,11,0,11,凱基-永和,2024-03-15,9207
2356,英業達,14,3,11,凱基-永和,2024-03-15,9207
00637L,元大滬深300正2,10,0,10,凱基-永和,2024-03-15,9207
00712,復華富時不動產,10,0,10,凱基-永和,2024-03-15,9207
3037,欣興,12,2,10,凱基-永和,2024-03-15,9207
3231,緯創,22,12,10,凱基-永和,2024-03-15,9207
2409,友達,10,1,9,凱基-永和,2024-03-15,9207
6261,久元,9,1,8,凱基-永和,2024-03-15,9207
2371,大同,10,2,8,凱基-永和,2024-03-15,9207
2615,萬海,8,0,8,凱基-永和,2024-03-15,9207
3715,定穎投控,8,0,8,凱基-永和,2024-03-15,9207
00680L,元大美債20正2,7,0,7,凱基-永和,2024-03-15,9207
1608,華榮,10,3,7,凱基-永和,2024-03-15,9207
2636,台驊控股,7,0,7,凱基-永和,2024-03-15,9207
1513,中興電,11,5,6,凱基-永和,2024-03-15,9207
3592,瑞鼎,10,4,6,凱基-永和,2024-03-15,9207
00687B,國泰20年美債,1025,12,1013,凱基-永和,2024-03-18,9207
2367,燿華,321,34,287,凱基-永和,2024-03-18,9207
8936,國統,150,0,150,凱基-永和,2024-03-18,9207
2330,台積電,120,5,115,凱基-永和,2024-03-18,9207
3034,聯詠,100,0,100,凱基-永和,2024-03-18,9207
1316,上曜,103,3,100,凱基-永和,2024-03-18,9207
2465,麗臺,80,0,80,凱基-永和,2024-03-18,9207
00892,富邦台灣半導體,65,0,65,凱基-永和,2024-03-18,9207
6290,良維,60,0,60,凱基-永和,2024-03-18,9207
8089,康全電訊,63,3,60,凱基-永和,2024-03-18,9207
8996,高力,59,2,57,凱基-永和,2024-03-18,9207
2363,矽統,56,0,56,凱基-永和,2024-03-18,9207
6462,神盾,74,20,54,凱基-永和,2024-03-18,9207
1503,士電,102,51,51,凱基-永和,2024-03-18,9207
2915,潤泰全,51,0,51,凱基-永和,2024-03-18,9207
00679B,元大美債20年,58,12,46,凱基-永和,2024-03-18,9207
00857B,永豐20年美公債,46,0,46,凱基-永和,2024-03-18,9207
1319,東陽,57,12,45,凱基-永和,2024-03-18,9207
00941,中信上游半導體,51,7,44,凱基-永和,2024-03-18,9207
2421,建準,43,0,43,凱基-永和,2024-03-18,9207
8147,正淩,40,0,40,凱基-永和,2024-03-18,9207
6757,台灣虎航,38,0,38,凱基-永和,2024-03-18,9207
8467,波力-KY,35,0,35,凱基-永和,2024-03-18,9207
00933B,國泰10Y+金融債,34,0,34,凱基-永和,2024-03-18,9207
8054,安國,35,1,34,凱基-永和,2024-03-18,9207
6584,南俊國際,31,0,31,凱基-永和,2024-03-18,9207
7402,邑錡,30,0,30,凱基-永和,2024-03-18,9207
3563,牧德,30,2,28,凱基-永和,2024-03-18,9207
3324,雙鴻,83,58,25,凱基-永和,2024-03-18,9207
2301,光寶科,24,0,24,凱基-永和,2024-03-18,9207
5519,隆大,25,1,24,凱基-永和,2024-03-18,9207
1519,華城,27,4,23,凱基-永和,2024-03-18,9207
5289,宜鼎,23,0,23,凱基-永和,2024-03-18,9207
00878,國泰永續高股息,23,7,16,凱基-永和,2024-03-18,9207
5432,新門,15,0,15,凱基-永和,2024-03-18,9207
6770,力積電,15,1,14,凱基-永和,2024-03-18,9207
3228,金麗科,15,1,14,凱基-永和,2024-03-18,9207
6244,茂迪,15,1,14,凱基-永和,2024-03-18,9207
3231,緯創,16,3,13,凱基-永和,2024-03-18,9207
2867,三商壽,11,0,11,凱基-永和,2024-03-18,9207
1513,中興電,166,155,11,凱基-永和,2024-03-18,9207
2801,彰銀,10,0,10,凱基-永和,2024-03-18,9207
3041,揚智,10,0,10,凱基-永和,2024-03-18,9207
3533,嘉澤,21,11,10,凱基-永和,2024-03-18,9207
3689,湧德,15,5,10,凱基-永和,2024-03-18,9207
5880,合庫金,10,0,10,凱基-永和,2024-03-18,9207
2548,華固,9,0,9,凱基-永和,2024-03-18,9207
6237,驊訊,9,0,9,凱基-永和,2024-03-18,9207
1101,台泥,10,1,9,凱基-永和,2024-03-18,9207
9945,潤泰新,8,0,8,凱基-永和,2024-03-18,9207
2354,鴻準,284,10,274,凱基-永和,2024-03-19,9207
00665L,富邦�琤肭磪囓�2,200,0,200,凱基-永和,2024-03-19,9207
2317,鴻海,160,15,145,凱基-永和,2024-03-19,9207
3207,耀勝,131,9,122,凱基-永和,2024-03-19,9207
6188,廣明,100,2,98,凱基-永和,2024-03-19,9207
6753,龍德造船,70,0,70,凱基-永和,2024-03-19,9207
5483,中美晶,201,155,46,凱基-永和,2024-03-19,9207
2888,新光金,35,0,35,凱基-永和,2024-03-19,9207
6530,創威,30,0,30,凱基-永和,2024-03-19,9207
2883,凱基金,28,2,26,凱基-永和,2024-03-19,9207
6257,矽格,27,1,26,凱基-永和,2024-03-19,9207
00857B,永豐20年美公債,21,0,21,凱基-永和,2024-03-19,9207
8171,天宇,21,0,21,凱基-永和,2024-03-19,9207
6190,萬泰科,20,0,20,凱基-永和,2024-03-19,9207
6735,美達科技,30,10,20,凱基-永和,2024-03-19,9207
2382,廣達,28,9,19,凱基-永和,2024-03-19,9207
2885,元大金,20,1,19,凱基-永和,2024-03-19,9207
4938,和碩,26,8,18,凱基-永和,2024-03-19,9207
00687B,國泰20年美債,15,0,15,凱基-永和,2024-03-19,9207
2388,威盛,15,0,15,凱基-永和,2024-03-19,9207
1101,台泥,15,1,14,凱基-永和,2024-03-19,9207
2897,王道銀行,14,0,14,凱基-永和,2024-03-19,9207
8097,常珵,12,0,12,凱基-永和,2024-03-19,9207
00941,中信上游半導體,11,0,11,凱基-永和,2024-03-19,9207
2337,旺宏,11,0,11,凱基-永和,2024-03-19,9207
2328,廣宇,10,0,10,凱基-永和,2024-03-19,9207
1312,國喬,10,0,10,凱基-永和,2024-03-19,9207
2332,友訊,10,0,10,凱基-永和,2024-03-19,9207
2492,華新科,10,0,10,凱基-永和,2024-03-19,9207
6284,佳邦,10,0,10,凱基-永和,2024-03-19,9207
2609,陽明,10,1,9,凱基-永和,2024-03-19,9207
8926,台汽電,10,1,9,凱基-永和,2024-03-19,9207
2323,中環,10,1,9,凱基-永和,2024-03-19,9207
6285,啟��,13,4,9,凱基-永和,2024-03-19,9207
2347,聯強,9,0,9,凱基-永和,2024-03-19,9207
8163,達方,9,1,8,凱基-永和,2024-03-19,9207
4207,環泰,8,0,8,凱基-永和,2024-03-19,9207
6166,凌華,8,0,8,凱基-永和,2024-03-19,9207
00830,國泰費城半導體,25,18,7,凱基-永和,2024-03-19,9207
00673R,期元大S＆P原油反1,7,0,7,凱基-永和,2024-03-19,9207
2486,一詮,10,3,7,凱基-永和,2024-03-19,9207
2834,臺企銀,8,1,7,凱基-永和,2024-03-19,9207
3356,奇偶,8,1,7,凱基-永和,2024-03-19,9207
6109,亞元,7,0,7,凱基-永和,2024-03-19,9207
00919,群益台灣精選高息,25,19,6,凱基-永和,2024-03-19,9207
00927,群益半導體收益,6,0,6,凱基-永和,2024-03-19,9207
3005,神基,165,159,6,凱基-永和,2024-03-19,9207
00902,中信電池及儲能,6,0,6,凱基-永和,2024-03-19,9207
1504,東元,13,7,6,凱基-永和,2024-03-19,9207
1522,堤維西,9,3,6,凱基-永和,2024-03-19,9207
00919,群益台灣精選高息,286,53,233,凱基-永和,2024-03-20,9207
00939,統一台灣高息動能,502,310,192,凱基-永和,2024-03-20,9207
3706,神達,211,38,173,凱基-永和,2024-03-20,9207
6191,精成科,153,5,148,凱基-永和,2024-03-20,9207
8996,高力,169,59,110,凱基-永和,2024-03-20,9207
6188,廣明,102,2,100,凱基-永和,2024-03-20,9207
2603,長榮,111,44,67,凱基-永和,2024-03-20,9207
1504,東元,72,13,59,凱基-永和,2024-03-20,9207
2356,英業達,62,7,55,凱基-永和,2024-03-20,9207
2883,凱基金,61,14,47,凱基-永和,2024-03-20,9207
2382,廣達,44,2,42,凱基-永和,2024-03-20,9207
2885,元大金,33,0,33,凱基-永和,2024-03-20,9207
2308,台達電,32,1,31,凱基-永和,2024-03-20,9207
3231,緯創,48,21,27,凱基-永和,2024-03-20,9207
2025,千興,22,0,22,凱基-永和,2024-03-20,9207
00933B,國泰10Y+金融債,21,0,21,凱基-永和,2024-03-20,9207
6147,頎邦,21,0,21,凱基-永和,2024-03-20,9207
00753L,中信中國50正2,20,0,20,凱基-永和,2024-03-20,9207
1108,幸福,30,10,20,凱基-永和,2024-03-20,9207
1528,恩德,20,0,20,凱基-永和,2024-03-20,9207
2348,海悅,20,0,20,凱基-永和,2024-03-20,9207
8044,網家,21,1,20,凱基-永和,2024-03-20,9207
3481,群創,21,1,20,凱基-永和,2024-03-20,9207
2313,華通,20,1,19,凱基-永和,2024-03-20,9207
4532,瑞智,20,1,19,凱基-永和,2024-03-20,9207
6237,驊訊,17,0,17,凱基-永和,2024-03-20,9207
00941,中信上游半導體,16,0,16,凱基-永和,2024-03-20,9207
1101,台泥,17,3,14,凱基-永和,2024-03-20,9207
3709,鑫聯大投控,13,0,13,凱基-永和,2024-03-20,9207
2347,聯強,17,4,13,凱基-永和,2024-03-20,9207
00679B,元大美債20年,13,1,12,凱基-永和,2024-03-20,9207
6207,雷科,12,0,12,凱基-永和,2024-03-20,9207
00881,國泰台灣5G+,12,0,12,凱基-永和,2024-03-20,9207
00857B,永豐20年美公債,11,0,11,凱基-永和,2024-03-20,9207
00830,國泰費城半導體,35,24,11,凱基-永和,2024-03-20,9207
2317,鴻海,37,27,10,凱基-永和,2024-03-20,9207
00683L,期元大美元指正2,10,0,10,凱基-永和,2024-03-20,9207
1217,愛之味,10,0,10,凱基-永和,2024-03-20,9207
2344,華邦電,10,0,10,凱基-永和,2024-03-20,9207
2548,華固,10,0,10,凱基-永和,2024-03-20,9207
2409,友達,9,0,9,凱基-永和,2024-03-20,9207
2897,王道銀行,9,0,9,凱基-永和,2024-03-20,9207
4938,和碩,16,7,9,凱基-永和,2024-03-20,9207
2618,長榮航,11,3,8,凱基-永和,2024-03-20,9207
3592,瑞鼎,8,0,8,凱基-永和,2024-03-20,9207
6526,達發,8,0,8,凱基-永和,2024-03-20,9207
00673R,期元大S＆P原油反1,7,0,7,凱基-永和,2024-03-20,9207
3325,旭品,7,0,7,凱基-永和,2024-03-20,9207
8059,凱碩,7,0,7,凱基-永和,2024-03-20,9207
00795B,中信美國公債20年,6,0,6,凱基-永和,2024-03-20,9207
2317,鴻海,419,188,231,凱基-永和,2024-03-21,9207
8112,至上,209,12,197,凱基-永和,2024-03-21,9207
2408,南亞科,171,16,155,凱基-永和,2024-03-21,9207
6753,龍德造船,105,0,105,凱基-永和,2024-03-21,9207
8271,宇瞻,100,2,98,凱基-永和,2024-03-21,9207
00939,統一台灣高息動能,96,4,92,凱基-永和,2024-03-21,9207
00892,富邦台灣半導體,80,0,80,凱基-永和,2024-03-21,9207
00919,群益台灣精選高息,69,8,61,凱基-永和,2024-03-21,9207
1504,東元,128,70,58,凱基-永和,2024-03-21,9207
00687B,國泰20年美債,51,0,51,凱基-永和,2024-03-21,9207
00937B,群益ESG投等債20,38,0,38,凱基-永和,2024-03-21,9207
3163,波若威,37,0,37,凱基-永和,2024-03-21,9207
6757,台灣虎航,33,0,33,凱基-永和,2024-03-21,9207
00933B,國泰10Y+金融債,37,5,32,凱基-永和,2024-03-21,9207
2886,兆豐金,31,1,30,凱基-永和,2024-03-21,9207
4945,陞達科技,30,0,30,凱基-永和,2024-03-21,9207
2834,臺企銀,32,2,30,凱基-永和,2024-03-21,9207
3227,原相,30,2,28,凱基-永和,2024-03-21,9207
00720B,元大投資級公司債,28,0,28,凱基-永和,2024-03-21,9207
00679B,元大美債20年,68,41,27,凱基-永和,2024-03-21,9207
6244,茂迪,21,0,21,凱基-永和,2024-03-21,9207
1108,幸福,20,0,20,凱基-永和,2024-03-21,9207
3709,鑫聯大投控,20,0,20,凱基-永和,2024-03-21,9207
6585,鼎基,20,0,20,凱基-永和,2024-03-21,9207
2548,華固,20,0,20,凱基-永和,2024-03-21,9207
00931B,統一美債20年,16,0,16,凱基-永和,2024-03-21,9207
3231,緯創,19,4,15,凱基-永和,2024-03-21,9207
2820,華票,15,0,15,凱基-永和,2024-03-21,9207
3563,牧德,15,0,15,凱基-永和,2024-03-21,9207
3005,神基,26,12,14,凱基-永和,2024-03-21,9207
00935,野村臺灣新科技50,15,1,14,凱基-永和,2024-03-21,9207
2327,國巨,15,1,14,凱基-永和,2024-03-21,9207
00751B,元大AAA至A公司債,13,0,13,凱基-永和,2024-03-21,9207
4714,永捷,12,0,12,凱基-永和,2024-03-21,9207
2105,正新,11,0,11,凱基-永和,2024-03-21,9207
3224,三顧,11,0,11,凱基-永和,2024-03-21,9207
4968,立積,16,5,11,凱基-永和,2024-03-21,9207
00941,中信上游半導體,10,0,10,凱基-永和,2024-03-21,9207
1785,光洋科,12,2,10,凱基-永和,2024-03-21,9207
6584,南俊國際,10,0,10,凱基-永和,2024-03-21,9207
8088,品安,12,2,10,凱基-永和,2024-03-21,9207
00633L,富邦上証正2,9,0,9,凱基-永和,2024-03-21,9207
3284,太普高,14,5,9,凱基-永和,2024-03-21,9207
4523,永彰,10,1,9,凱基-永和,2024-03-21,9207
2405,輔信,19,10,9,凱基-永和,2024-03-21,9207
2316,楠梓電,8,0,8,凱基-永和,2024-03-21,9207
3322,建舜電,8,0,8,凱基-永和,2024-03-21,9207
4105,東洋,8,0,8,凱基-永和,2024-03-21,9207
00795B,中信美國公債20年,7,0,7,凱基-永和,2024-03-21,9207
1101,台泥,7,0,7,凱基-永和,2024-03-21,9207
2356,英業達,1709,322,1387,凱基-永和,2024-03-22,9207
00665L,富邦�琤肭磪囓�2,554,0,554,凱基-永和,2024-03-22,9207
1609,大亞,212,11,201,凱基-永和,2024-03-22,9207
2109,華豐,150,0,150,凱基-永和,2024-03-22,9207
2308,台達電,164,29,135,凱基-永和,2024-03-22,9207
3059,華晶科,116,1,115,凱基-永和,2024-03-22,9207
3481,群創,128,22,106,凱基-永和,2024-03-22,9207
3058,立德,101,0,101,凱基-永和,2024-03-22,9207
6189,豐藝,80,1,79,凱基-永和,2024-03-22,9207
00650L,復華香港正2,66,0,66,凱基-永和,2024-03-22,9207
2301,光寶科,60,6,54,凱基-永和,2024-03-22,9207
00931B,統一美債20年,52,0,52,凱基-永和,2024-03-22,9207
2834,臺企銀,50,1,49,凱基-永和,2024-03-22,9207
5439,高技,51,8,43,凱基-永和,2024-03-22,9207
3563,牧德,43,1,42,凱基-永和,2024-03-22,9207
8059,凱碩,42,1,41,凱基-永和,2024-03-22,9207
00753L,中信中國50正2,40,0,40,凱基-永和,2024-03-22,9207
6005,群益證,42,5,37,凱基-永和,2024-03-22,9207
00939,統一台灣高息動能,29,0,29,凱基-永和,2024-03-22,9207
3622,洋華,22,0,22,凱基-永和,2024-03-22,9207
2457,飛宏,20,1,19,凱基-永和,2024-03-22,9207
4968,立積,53,34,19,凱基-永和,2024-03-22,9207
3207,耀勝,16,0,16,凱基-永和,2024-03-22,9207
3706,神達,26,11,15,凱基-永和,2024-03-22,9207
6719,力智,13,0,13,凱基-永和,2024-03-22,9207
1504,東元,18,6,12,凱基-永和,2024-03-22,9207
8131,福懋科,12,0,12,凱基-永和,2024-03-22,9207
00937B,群益ESG投等債20,11,0,11,凱基-永和,2024-03-22,9207
2344,華邦電,11,0,11,凱基-永和,2024-03-22,9207
1325,恆大,10,0,10,凱基-永和,2024-03-22,9207
3284,太普高,10,0,10,凱基-永和,2024-03-22,9207
3362,先進光,10,0,10,凱基-永和,2024-03-22,9207
5381,合正,10,0,10,凱基-永和,2024-03-22,9207
6834,天二科技,10,0,10,凱基-永和,2024-03-22,9207
00900,富邦特選高股息30,15,5,10,凱基-永和,2024-03-22,9207
2330,台積電,10,0,10,凱基-永和,2024-03-22,9207
2603,長榮,14,5,9,凱基-永和,2024-03-22,9207
2303,聯電,12,3,9,凱基-永和,2024-03-22,9207
2327,國巨,9,0,9,凱基-永和,2024-03-22,9207
6443,元晶,34,26,8,凱基-永和,2024-03-22,9207
2634,漢翔,15,7,8,凱基-永和,2024-03-22,9207
2354,鴻準,12,5,7,凱基-永和,2024-03-22,9207
3324,雙鴻,8,1,7,凱基-永和,2024-03-22,9207
3484,崧騰,9,2,7,凱基-永和,2024-03-22,9207
8044,網家,11,4,7,凱基-永和,2024-03-22,9207
2382,廣達,25,18,7,凱基-永和,2024-03-22,9207
00688L,國泰20年美債正2,6,0,6,凱基-永和,2024-03-22,9207
3044,健鼎,6,0,6,凱基-永和,2024-03-22,9207
3357,臺慶科,6,0,6,凱基-永和,2024-03-22,9207
3588,通嘉,7,1,6,凱基-永和,2024-03-22,9207
2317,鴻海,525,157,368,凱基-永和,2024-03-25,9207
6125,廣運,362,134,228,凱基-永和,2024-03-25,9207
2344,華邦電,200,10,190,凱基-永和,2024-03-25,9207
00941,中信上游半導體,142,18,124,凱基-永和,2024-03-25,9207
6290,良維,106,0,106,凱基-永和,2024-03-25,9207
5426,振發,302,203,99,凱基-永和,2024-03-25,9207
2388,威盛,100,2,98,凱基-永和,2024-03-25,9207
00929,復華台灣科技優息,103,22,81,凱基-永和,2024-03-25,9207
8059,凱碩,70,0,70,凱基-永和,2024-03-25,9207
00937B,群益ESG投等債20,67,0,67,凱基-永和,2024-03-25,9207
00933B,國泰10Y+金融債,53,0,53,凱基-永和,2024-03-25,9207
00665L,富邦�琤肭磪囓�2,50,0,50,凱基-永和,2024-03-25,9207
4576,大銀微系統,50,0,50,凱基-永和,2024-03-25,9207
6538,倉和,50,0,50,凱基-永和,2024-03-25,9207
5425,台半,48,0,48,凱基-永和,2024-03-25,9207
00939,統一台灣高息動能,52,6,46,凱基-永和,2024-03-25,9207
00687B,國泰20年美債,35,0,35,凱基-永和,2024-03-25,9207
1609,大亞,251,218,33,凱基-永和,2024-03-25,9207
4906,正文,30,0,30,凱基-永和,2024-03-25,9207
3689,湧德,21,0,21,凱基-永和,2024-03-25,9207
1217,愛之味,20,0,20,凱基-永和,2024-03-25,9207
2109,華豐,20,0,20,凱基-永和,2024-03-25,9207
6005,群益證,20,0,20,凱基-永和,2024-03-25,9207
8996,高力,26,6,20,凱基-永和,2024-03-25,9207
6139,亞翔,30,11,19,凱基-永和,2024-03-25,9207
00857B,永豐20年美公債,19,0,19,凱基-永和,2024-03-25,9207
5519,隆大,19,1,18,凱基-永和,2024-03-25,9207
2376,技嘉,26,9,17,凱基-永和,2024-03-25,9207
2352,佳世達,17,0,17,凱基-永和,2024-03-25,9207
2324,仁寶,23,6,17,凱基-永和,2024-03-25,9207
3294,英濟,15,0,15,凱基-永和,2024-03-25,9207
5508,永信建,15,0,15,凱基-永和,2024-03-25,9207
0056,元大高股息,17,2,15,凱基-永和,2024-03-25,9207
00679B,元大美債20年,34,22,12,凱基-永和,2024-03-25,9207
2464,盟立,14,2,12,凱基-永和,2024-03-25,9207
00720B,元大投資級公司債,11,0,11,凱基-永和,2024-03-25,9207
1514,亞力,13,2,11,凱基-永和,2024-03-25,9207
2330,台積電,10,0,10,凱基-永和,2024-03-25,9207
00632R,元大台灣50反1,10,0,10,凱基-永和,2024-03-25,9207
00712,復華富時不動產,10,0,10,凱基-永和,2024-03-25,9207
2406,國碩,12,2,10,凱基-永和,2024-03-25,9207
2515,中工,10,0,10,凱基-永和,2024-03-25,9207
3362,先進光,10,0,10,凱基-永和,2024-03-25,9207
3479,安勤,10,0,10,凱基-永和,2024-03-25,9207
6026,福邦證,10,0,10,凱基-永和,2024-03-25,9207
8033,雷虎,10,0,10,凱基-永和,2024-03-25,9207
00878,國泰永續高股息,20,10,10,凱基-永和,2024-03-25,9207
2329,華泰,12,3,9,凱基-永和,2024-03-25,9207
2303,聯電,18,10,8,凱基-永和,2024-03-25,9207
6285,啟��,8,0,8,凱基-永和,2024-03-25,9207
00939,統一台灣高息動能,3099,64,3035,凱基-永和,2024-03-26,9207
1608,華榮,615,314,301,凱基-永和,2024-03-26,9207
2317,鴻海,216,30,186,凱基-永和,2024-03-26,9207
6163,華電網,133,2,131,凱基-永和,2024-03-26,9207
6176,瑞儀,60,0,60,凱基-永和,2024-03-26,9207
00937B,群益ESG投等債20,52,1,51,凱基-永和,2024-03-26,9207
00679B,元大美債20年,50,0,50,凱基-永和,2024-03-26,9207
2385,群光,50,0,50,凱基-永和,2024-03-26,9207
00919,群益台灣精選高息,89,43,46,凱基-永和,2024-03-26,9207
00687B,國泰20年美債,42,0,42,凱基-永和,2024-03-26,9207
1795,美時,41,0,41,凱基-永和,2024-03-26,9207
00933B,國泰10Y+金融債,41,0,41,凱基-永和,2024-03-26,9207
3689,湧德,31,0,31,凱基-永和,2024-03-26,9207
00712,復華富時不動產,30,0,30,凱基-永和,2024-03-26,9207
2486,一詮,27,1,26,凱基-永和,2024-03-26,9207
8044,網家,32,6,26,凱基-永和,2024-03-26,9207
6116,彩晶,25,0,25,凱基-永和,2024-03-26,9207
2303,聯電,24,0,24,凱基-永和,2024-03-26,9207
6121,新普,23,0,23,凱基-永和,2024-03-26,9207
3231,緯創,32,12,20,凱基-永和,2024-03-26,9207
00929,復華台灣科技優息,36,16,20,凱基-永和,2024-03-26,9207
2417,圓剛,25,8,17,凱基-永和,2024-03-26,9207
1815,富喬,16,2,14,凱基-永和,2024-03-26,9207
3062,建漢,14,0,14,凱基-永和,2024-03-26,9207
3712,永崴投控,15,1,14,凱基-永和,2024-03-26,9207
2359,所羅門,259,245,14,凱基-永和,2024-03-26,9207
2367,燿華,16,4,12,凱基-永和,2024-03-26,9207
8028,昇陽半導體,12,0,12,凱基-永和,2024-03-26,9207
2313,華通,13,1,12,凱基-永和,2024-03-26,9207
00720B,元大投資級公司債,11,0,11,凱基-永和,2024-03-26,9207
9105,泰金寶-DR,11,0,11,凱基-永和,2024-03-26,9207
2354,鴻準,12,2,10,凱基-永和,2024-03-26,9207
2406,國碩,10,0,10,凱基-永和,2024-03-26,9207
2607,榮運,10,0,10,凱基-永和,2024-03-26,9207
2888,新光金,10,0,10,凱基-永和,2024-03-26,9207
3680,家登,10,0,10,凱基-永和,2024-03-26,9207
4526,東台,11,1,10,凱基-永和,2024-03-26,9207
4532,瑞智,20,10,10,凱基-永和,2024-03-26,9207
6005,群益證,20,10,10,凱基-永和,2024-03-26,9207
6285,啟��,11,1,10,凱基-永和,2024-03-26,9207
2421,建準,60,51,9,凱基-永和,2024-03-26,9207
6770,力積電,11,2,9,凱基-永和,2024-03-26,9207
3450,聯鈞,10,1,9,凱基-永和,2024-03-26,9207
3715,定穎投控,11,2,9,凱基-永和,2024-03-26,9207
2605,新興,8,0,8,凱基-永和,2024-03-26,9207
2371,大同,524,516,8,凱基-永和,2024-03-26,9207
6244,茂迪,6,0,6,凱基-永和,2024-03-26,9207
2329,華泰,11,5,6,凱基-永和,2024-03-26,9207
3207,耀勝,6,0,6,凱基-永和,2024-03-26,9207
4979,華星光,8,2,6,凱基-永和,2024-03-26,9207
1316,上曜,400,200,200,凱基-永和,2024-03-27,9207
3062,建漢,200,2,198,凱基-永和,2024-03-27,9207
8033,雷虎,202,6,196,凱基-永和,2024-03-27,9207
2356,英業達,227,32,195,凱基-永和,2024-03-27,9207
2049,上銀,75,2,73,凱基-永和,2024-03-27,9207
4768,晶呈科技,54,1,53,凱基-永和,2024-03-27,9207
00665L,富邦�琤肭磪囓�2,50,0,50,凱基-永和,2024-03-27,9207
8027,鈦昇,50,1,49,凱基-永和,2024-03-27,9207
2834,臺企銀,32,0,32,凱基-永和,2024-03-27,9207
3583,辛耘,38,7,31,凱基-永和,2024-03-27,9207
2886,兆豐金,22,0,22,凱基-永和,2024-03-27,9207
1603,華電,21,1,20,凱基-永和,2024-03-27,9207
8076,伍豐,20,0,20,凱基-永和,2024-03-27,9207
3481,群創,20,1,19,凱基-永和,2024-03-27,9207
5244,弘凱,18,0,18,凱基-永和,2024-03-27,9207
6290,良維,17,0,17,凱基-永和,2024-03-27,9207
6109,亞元,16,0,16,凱基-永和,2024-03-27,9207
2331,精英,15,0,15,凱基-永和,2024-03-27,9207
5519,隆大,14,0,14,凱基-永和,2024-03-27,9207
4961,天鈺,17,3,14,凱基-永和,2024-03-27,9207
00933B,國泰10Y+金融債,12,0,12,凱基-永和,2024-03-27,9207
00679B,元大美債20年,12,0,12,凱基-永和,2024-03-27,9207
2610,華航,11,0,11,凱基-永和,2024-03-27,9207
2303,聯電,10,0,10,凱基-永和,2024-03-27,9207
1313,聯成,10,0,10,凱基-永和,2024-03-27,9207
8255,朋程,10,0,10,凱基-永和,2024-03-27,9207
3231,緯創,13,3,10,凱基-永和,2024-03-27,9207
1795,美時,12,3,9,凱基-永和,2024-03-27,9207
2371,大同,210,202,8,凱基-永和,2024-03-27,9207
4526,東台,9,1,8,凱基-永和,2024-03-27,9207
6113,亞矽,8,0,8,凱基-永和,2024-03-27,9207
00687B,國泰20年美債,7,0,7,凱基-永和,2024-03-27,9207
2408,南亞科,7,0,7,凱基-永和,2024-03-27,9207
9958,世紀鋼,10,3,7,凱基-永和,2024-03-27,9207
2542,興富發,8,2,6,凱基-永和,2024-03-27,9207
3027,盛達,7,1,6,凱基-永和,2024-03-27,9207
00673R,期元大S＆P原油反1,6,0,6,凱基-永和,2024-03-27,9207
1504,東元,7,1,6,凱基-永和,2024-03-27,9207
2382,廣達,11,5,6,凱基-永和,2024-03-27,9207
2330,台積電,5,0,5,凱基-永和,2024-03-27,9207
00857B,永豐20年美公債,5,0,5,凱基-永和,2024-03-27,9207
1536,和大,5,0,5,凱基-永和,2024-03-27,9207
1727,中華化,5,0,5,凱基-永和,2024-03-27,9207
2344,華邦電,5,0,5,凱基-永和,2024-03-27,9207
2597,潤弘,5,0,5,凱基-永和,2024-03-27,9207
2882,國泰金,5,0,5,凱基-永和,2024-03-27,9207
3105,穩懋,5,0,5,凱基-永和,2024-03-27,9207
3272,東碩,5,0,5,凱基-永和,2024-03-27,9207
3706,神達,30,25,5,凱基-永和,2024-03-27,9207
5469,瀚宇博,6,1,5,凱基-永和,2024-03-27,9207
2317,鴻海,586,78,508,凱基-永和,2024-03-28,9207
3710,連展投控,300,0,300,凱基-永和,2024-03-28,9207
3013,晟銘電,529,401,128,凱基-永和,2024-03-28,9207
6443,元晶,130,45,85,凱基-永和,2024-03-28,9207
2382,廣達,327,243,84,凱基-永和,2024-03-28,9207
2883,凱基金,71,1,70,凱基-永和,2024-03-28,9207
6425,易發,71,2,69,凱基-永和,2024-03-28,9207
4768,晶呈科技,50,0,50,凱基-永和,2024-03-28,9207
3707,漢磊,36,0,36,凱基-永和,2024-03-28,9207
6213,聯茂,41,5,36,凱基-永和,2024-03-28,9207
1504,東元,44,9,35,凱基-永和,2024-03-28,9207
3706,神達,71,47,24,凱基-永和,2024-03-28,9207
5309,系統電,21,0,21,凱基-永和,2024-03-28,9207
6770,力積電,23,2,21,凱基-永和,2024-03-28,9207
5519,隆大,20,0,20,凱基-永和,2024-03-28,9207
3576,聯合再生,20,0,20,凱基-永和,2024-03-28,9207
00939,統一台灣高息動能,25,7,18,凱基-永和,2024-03-28,9207
5269,祥碩,18,0,18,凱基-永和,2024-03-28,9207
3481,群創,16,0,16,凱基-永和,2024-03-28,9207
00933B,國泰10Y+金融債,15,0,15,凱基-永和,2024-03-28,9207
4714,永捷,17,2,15,凱基-永和,2024-03-28,9207
8054,安國,30,16,14,凱基-永和,2024-03-28,9207
2367,燿華,13,0,13,凱基-永和,2024-03-28,9207
2834,臺企銀,12,0,12,凱基-永和,2024-03-28,9207
2344,華邦電,11,0,11,凱基-永和,2024-03-28,9207
6244,茂迪,11,0,11,凱基-永和,2024-03-28,9207
6538,倉和,14,3,11,凱基-永和,2024-03-28,9207
5243,乙盛-KY,20,10,10,凱基-永和,2024-03-28,9207
2303,聯電,21,11,10,凱基-永和,2024-03-28,9207
6462,神盾,12,2,10,凱基-永和,2024-03-28,9207
1909,榮成,10,0,10,凱基-永和,2024-03-28,9207
2801,彰銀,10,0,10,凱基-永和,2024-03-28,9207
4934,太極,10,0,10,凱基-永和,2024-03-28,9207
6186,新潤,10,0,10,凱基-永和,2024-03-28,9207
8349,�矬�,10,0,10,凱基-永和,2024-03-28,9207
9904,寶成,21,11,10,凱基-永和,2024-03-28,9207
6176,瑞儀,9,0,9,凱基-永和,2024-03-28,9207
2059,川湖,8,0,8,凱基-永和,2024-03-28,9207
2363,矽統,7,0,7,凱基-永和,2024-03-28,9207
1609,大亞,14,8,6,凱基-永和,2024-03-28,9207
4908,前鼎,6,0,6,凱基-永和,2024-03-28,9207
1513,中興電,9,3,6,凱基-永和,2024-03-28,9207
00922,國泰台灣領袖50,6,0,6,凱基-永和,2024-03-28,9207
1808,潤隆,7,1,6,凱基-永和,2024-03-28,9207
3284,太普高,6,0,6,凱基-永和,2024-03-28,9207
3583,辛耘,9,3,6,凱基-永和,2024-03-28,9207
5603,陸海,6,0,6,凱基-永和,2024-03-28,9207
2376,技嘉,7,1,6,凱基-永和,2024-03-28,9207
2002,中鋼,5,0,5,凱基-永和,2024-03-28,9207
6669,緯穎,5,0,5,凱基-永和,2024-03-28,9207
2303,聯電,262,16,246,凱基-永和,2024-03-29,9207
00937B,群益ESG投等債20,211,15,196,凱基-永和,2024-03-29,9207
2382,廣達,507,322,185,凱基-永和,2024-03-29,9207
2330,台積電,110,7,103,凱基-永和,2024-03-29,9207
6578,達邦蛋白,100,2,98,凱基-永和,2024-03-29,9207
3706,神達,95,0,95,凱基-永和,2024-03-29,9207
6213,聯茂,100,7,93,凱基-永和,2024-03-29,9207
6290,良維,70,0,70,凱基-永和,2024-03-29,9207
3548,兆利,97,28,69,凱基-永和,2024-03-29,9207
2354,鴻準,56,4,52,凱基-永和,2024-03-29,9207
2547,日勝生,50,0,50,凱基-永和,2024-03-29,9207
2025,千興,40,0,40,凱基-永和,2024-03-29,9207
8044,網家,37,0,37,凱基-永和,2024-03-29,9207
5269,祥碩,36,0,36,凱基-永和,2024-03-29,9207
2367,燿華,35,8,27,凱基-永和,2024-03-29,9207
2301,光寶科,59,33,26,凱基-永和,2024-03-29,9207
5488,松普,20,0,20,凱基-永和,2024-03-29,9207
6116,彩晶,20,0,20,凱基-永和,2024-03-29,9207
8201,無敵,20,0,20,凱基-永和,2024-03-29,9207
2324,仁寶,19,0,19,凱基-永和,2024-03-29,9207
3062,建漢,18,0,18,凱基-永和,2024-03-29,9207
2882,國泰金,25,9,16,凱基-永和,2024-03-29,9207
1604,聲寶,15,0,15,凱基-永和,2024-03-29,9207
6215,和椿,15,0,15,凱基-永和,2024-03-29,9207
5515,建國,12,0,12,凱基-永和,2024-03-29,9207
6245,立端,12,0,12,凱基-永和,2024-03-29,9207
00939,統一台灣高息動能,11,0,11,凱基-永和,2024-03-29,9207
1101,台泥,10,0,10,凱基-永和,2024-03-29,9207
8076,伍豐,10,0,10,凱基-永和,2024-03-29,9207
1217,愛之味,10,0,10,凱基-永和,2024-03-29,9207
2913,農林,10,0,10,凱基-永和,2024-03-29,9207
6126,信音,8,0,8,凱基-永和,2024-03-29,9207
2327,國巨,8,0,8,凱基-永和,2024-03-29,9207
6416,瑞祺電通,10,2,8,凱基-永和,2024-03-29,9207
6196,帆宣,8,0,8,凱基-永和,2024-03-29,9207
00936,台新永續高息中小,7,0,7,凱基-永和,2024-03-29,9207
2014,中鴻,7,0,7,凱基-永和,2024-03-29,9207
6643,M31,10,3,7,凱基-永和,2024-03-29,9207
6670,復盛應用,7,0,7,凱基-永和,2024-03-29,9207
2356,英業達,540,533,7,凱基-永和,2024-03-29,9207
5388,中磊,6,0,6,凱基-永和,2024-03-29,9207
6669,緯穎,6,0,6,凱基-永和,2024-03-29,9207
00941,中信上游半導體,6,0,6,凱基-永和,2024-03-29,9207
3284,太普高,6,0,6,凱基-永和,2024-03-29,9207
4714,永捷,6,0,6,凱基-永和,2024-03-29,9207
2376,技嘉,12,7,5,凱基-永和,2024-03-29,9207
5521,工信,5,0,5,凱基-永和,2024-03-29,9207
6282,康舒,5,0,5,凱基-永和,2024-03-29,9207
1524,耿鼎,5,0,5,凱基-永和,2024-03-29,9207
2059,川湖,5,0,5,凱基-永和,2024-03-29,9207
00940,元大台灣價值高息,460,63,397,凱基-永和,2024-04-01,9207
6187,萬潤,234,1,233,凱基-永和,2024-04-01,9207
2486,一詮,701,509,192,凱基-永和,2024-04-01,9207
2324,仁寶,102,1,101,凱基-永和,2024-04-01,9207
8033,雷虎,100,2,98,凱基-永和,2024-04-01,9207
3231,緯創,91,6,85,凱基-永和,2024-04-01,9207
5386,青雲,61,0,61,凱基-永和,2024-04-01,9207
6189,豐藝,75,20,55,凱基-永和,2024-04-01,9207
00655L,國泰中國A50正2,52,0,52,凱基-永和,2024-04-01,9207
3680,家登,50,0,50,凱基-永和,2024-04-01,9207
8092,建暐,50,0,50,凱基-永和,2024-04-01,9207
2331,精英,40,0,40,凱基-永和,2024-04-01,9207
2882,國泰金,44,6,38,凱基-永和,2024-04-01,9207
1504,東元,35,2,33,凱基-永和,2024-04-01,9207
6667,信紘科,34,2,32,凱基-永和,2024-04-01,9207
00927,群益半導體收益,30,0,30,凱基-永和,2024-04-01,9207
1786,科妍,30,2,28,凱基-永和,2024-04-01,9207
8054,安國,28,0,28,凱基-永和,2024-04-01,9207
2317,鴻海,33,7,26,凱基-永和,2024-04-01,9207
00919,群益台灣精選高息,41,15,26,凱基-永和,2024-04-01,9207
2457,飛宏,25,0,25,凱基-永和,2024-04-01,9207
3706,神達,26,1,25,凱基-永和,2024-04-01,9207
6186,新潤,25,0,25,凱基-永和,2024-04-01,9207
2392,正崴,22,0,22,凱基-永和,2024-04-01,9207
00733,富邦臺灣中小,23,1,22,凱基-永和,2024-04-01,9207
00918,大華優利高填息30,24,4,20,凱基-永和,2024-04-01,9207
2347,聯強,46,27,19,凱基-永和,2024-04-01,9207
00939,統一台灣高息動能,18,0,18,凱基-永和,2024-04-01,9207
2603,長榮,18,0,18,凱基-永和,2024-04-01,9207
6120,達運,20,2,18,凱基-永和,2024-04-01,9207
2342,茂矽,25,8,17,凱基-永和,2024-04-01,9207
2891,中信金,22,6,16,凱基-永和,2024-04-01,9207
2506,太設,15,0,15,凱基-永和,2024-04-01,9207
1513,中興電,17,3,14,凱基-永和,2024-04-01,9207
3178,公準,12,0,12,凱基-永和,2024-04-01,9207
1316,上曜,13,3,10,凱基-永和,2024-04-01,9207
3202,樺晟,10,0,10,凱基-永和,2024-04-01,9207
3714,富采,10,0,10,凱基-永和,2024-04-01,9207
6785,昱展新藥,10,0,10,凱基-永和,2024-04-01,9207
8201,無敵,10,0,10,凱基-永和,2024-04-01,9207
00941,中信上游半導體,8,0,8,凱基-永和,2024-04-01,9207
00915,凱基優選高股息30,8,0,8,凱基-永和,2024-04-01,9207
2049,上銀,8,1,7,凱基-永和,2024-04-01,9207
3167,大量,7,0,7,凱基-永和,2024-04-01,9207
3360,尚立,7,0,7,凱基-永和,2024-04-01,9207
5425,台半,7,0,7,凱基-永和,2024-04-01,9207
00764B,群益25年美債,6,0,6,凱基-永和,2024-04-01,9207
2352,佳世達,6,0,6,凱基-永和,2024-04-01,9207
8086,宏捷科,6,0,6,凱基-永和,2024-04-01,9207
3661,世芯-KY,6,0,6,凱基-永和,2024-04-01,9207
2515,中工,1409,509,900,凱基-永和,2024-04-02,9207
2382,廣達,389,73,316,凱基-永和,2024-04-02,9207
1560,中砂,173,7,166,凱基-永和,2024-04-02,9207
3289,宜特,135,0,135,凱基-永和,2024-04-02,9207
00933B,國泰10Y+金融債,90,0,90,凱基-永和,2024-04-02,9207
00679B,元大美債20年,80,0,80,凱基-永和,2024-04-02,9207
00940,元大台灣價值高息,164,94,70,凱基-永和,2024-04-02,9207
00632R,元大台灣50反1,53,0,53,凱基-永和,2024-04-02,9207
4909,新復興,50,0,50,凱基-永和,2024-04-02,9207
6532,瑞耘,51,1,50,凱基-永和,2024-04-02,9207
4542,科嶠,44,0,44,凱基-永和,2024-04-02,9207
2025,千興,60,20,40,凱基-永和,2024-04-02,9207
6548,長科*,35,0,35,凱基-永和,2024-04-02,9207
6531,愛普*,33,0,33,凱基-永和,2024-04-02,9207
2392,正崴,30,0,30,凱基-永和,2024-04-02,9207
00937B,群益ESG投等債20,31,1,30,凱基-永和,2024-04-02,9207
2308,台達電,31,2,29,凱基-永和,2024-04-02,9207
3583,辛耘,103,77,26,凱基-永和,2024-04-02,9207
3163,波若威,32,7,25,凱基-永和,2024-04-02,9207
8996,高力,78,57,21,凱基-永和,2024-04-02,9207
3234,光環,20,0,20,凱基-永和,2024-04-02,9207
00676R,富邦臺灣加權反1,20,0,20,凱基-永和,2024-04-02,9207
3363,上詮,21,1,20,凱基-永和,2024-04-02,9207
8358,金居,23,3,20,凱基-永和,2024-04-02,9207
6442,光聖,19,0,19,凱基-永和,2024-04-02,9207
2376,技嘉,18,1,17,凱基-永和,2024-04-02,9207
00633L,富邦上証正2,15,0,15,凱基-永和,2024-04-02,9207
2610,華航,14,0,14,凱基-永和,2024-04-02,9207
00857B,永豐20年美公債,13,0,13,凱基-永和,2024-04-02,9207
00772B,中信高評級公司債,13,0,13,凱基-永和,2024-04-02,9207
6288,聯嘉,12,0,12,凱基-永和,2024-04-02,9207
00720B,元大投資級公司債,12,0,12,凱基-永和,2024-04-02,9207
2417,圓剛,11,0,11,凱基-永和,2024-04-02,9207
2834,臺企銀,11,0,11,凱基-永和,2024-04-02,9207
2406,國碩,10,0,10,凱基-永和,2024-04-02,9207
00706L,期元大S＆P日圓正2,10,0,10,凱基-永和,2024-04-02,9207
00680L,元大美債20正2,12,2,10,凱基-永和,2024-04-02,9207
1810,和成,10,0,10,凱基-永和,2024-04-02,9207
2329,華泰,10,0,10,凱基-永和,2024-04-02,9207
2356,英業達,11,1,10,凱基-永和,2024-04-02,9207
2371,大同,13,3,10,凱基-永和,2024-04-02,9207
2801,彰銀,10,0,10,凱基-永和,2024-04-02,9207
2867,三商壽,10,0,10,凱基-永和,2024-04-02,9207
3591,艾笛森,10,0,10,凱基-永和,2024-04-02,9207
4973,廣穎,10,0,10,凱基-永和,2024-04-02,9207
6271,同欣電,10,0,10,凱基-永和,2024-04-02,9207
6457,紘康,10,0,10,凱基-永和,2024-04-02,9207
6261,久元,10,1,9,凱基-永和,2024-04-02,9207
00751B,元大AAA至A公司債,8,0,8,凱基-永和,2024-04-02,9207
1806,冠軍,10,2,8,凱基-永和,2024-04-02,9207
6120,達運,1187,299,888,凱基-永和,2024-04-03,9207
2363,矽統,317,2,315,凱基-永和,2024-04-03,9207
6117,迎廣,179,54,125,凱基-永和,2024-04-03,9207
2834,臺企銀,55,0,55,凱基-永和,2024-04-03,9207
3231,緯創,392,341,51,凱基-永和,2024-04-03,9207
8996,高力,41,0,41,凱基-永和,2024-04-03,9207
6227,茂綸,40,1,39,凱基-永和,2024-04-03,9207
00927,群益半導體收益,34,0,34,凱基-永和,2024-04-03,9207
5426,振發,33,0,33,凱基-永和,2024-04-03,9207
6472,保瑞,35,2,33,凱基-永和,2024-04-03,9207
3481,群創,29,1,28,凱基-永和,2024-04-03,9207
00679B,元大美債20年,31,3,28,凱基-永和,2024-04-03,9207
6187,萬潤,23,1,22,凱基-永和,2024-04-03,9207
00857B,永豐20年美公債,21,0,21,凱基-永和,2024-04-03,9207
8054,安國,85,64,21,凱基-永和,2024-04-03,9207
00688L,國泰20年美債正2,20,0,20,凱基-永和,2024-04-03,9207
00756B,群益投等新興公債,20,0,20,凱基-永和,2024-04-03,9207
00665L,富邦�琤肭磪囓�2,20,0,20,凱基-永和,2024-04-03,9207
2882,國泰金,20,0,20,凱基-永和,2024-04-03,9207
2317,鴻海,32,14,18,凱基-永和,2024-04-03,9207
00687B,國泰20年美債,18,0,18,凱基-永和,2024-04-03,9207
00941,中信上游半導體,18,0,18,凱基-永和,2024-04-03,9207
2359,所羅門,20,3,17,凱基-永和,2024-04-03,9207
2409,友達,31,15,16,凱基-永和,2024-04-03,9207
2301,光寶科,16,1,15,凱基-永和,2024-04-03,9207
3587,閎康,15,0,15,凱基-永和,2024-04-03,9207
6438,迅得,15,0,15,凱基-永和,2024-04-03,9207
3033,威健,15,1,14,凱基-永和,2024-04-03,9207
3450,聯鈞,17,3,14,凱基-永和,2024-04-03,9207
00929,復華台灣科技優息,14,1,13,凱基-永和,2024-04-03,9207
00940,元大台灣價值高息,42,29,13,凱基-永和,2024-04-03,9207
2610,華航,12,0,12,凱基-永和,2024-04-03,9207
3036,文曄,13,1,12,凱基-永和,2024-04-03,9207
2486,一詮,75,63,12,凱基-永和,2024-04-03,9207
2371,大同,11,0,11,凱基-永和,2024-04-03,9207
3714,富采,11,0,11,凱基-永和,2024-04-03,9207
00733,富邦臺灣中小,10,0,10,凱基-永和,2024-04-03,9207
2892,第一金,10,0,10,凱基-永和,2024-04-03,9207
2461,光群雷,10,0,10,凱基-永和,2024-04-03,9207
2634,漢翔,10,0,10,凱基-永和,2024-04-03,9207
2880,華南金,10,0,10,凱基-永和,2024-04-03,9207
5392,能率,10,0,10,凱基-永和,2024-04-03,9207
6109,亞元,10,0,10,凱基-永和,2024-04-03,9207
6116,彩晶,10,0,10,凱基-永和,2024-04-03,9207
8050,廣積,10,0,10,凱基-永和,2024-04-03,9207
8201,無敵,10,0,10,凱基-永和,2024-04-03,9207
2059,川湖,9,0,9,凱基-永和,2024-04-03,9207
1103,嘉泥,8,0,8,凱基-永和,2024-04-03,9207
2344,華邦電,8,0,8,凱基-永和,2024-04-03,9207
6285,啟��,10,2,8,凱基-永和,2024-04-03,9207
1608,華榮,366,6,360,凱基-永和,2024-04-08,9207
3481,群創,300,1,299,凱基-永和,2024-04-08,9207
2009,第一銅,603,306,297,凱基-永和,2024-04-08,9207
8096,擎亞,206,8,198,凱基-永和,2024-04-08,9207
3017,奇鋐,159,4,155,凱基-永和,2024-04-08,9207
2409,友達,150,1,149,凱基-永和,2024-04-08,9207
3576,聯合再生,128,0,128,凱基-永和,2024-04-08,9207
00665L,富邦�琤肭磪囓�2,130,30,100,凱基-永和,2024-04-08,9207
4543,萬在,100,0,100,凱基-永和,2024-04-08,9207
00940,元大台灣價值高息,120,27,93,凱基-永和,2024-04-08,9207
00687B,國泰20年美債,69,0,69,凱基-永和,2024-04-08,9207
6125,廣運,70,5,65,凱基-永和,2024-04-08,9207
6443,元晶,62,1,61,凱基-永和,2024-04-08,9207
6113,亞矽,50,0,50,凱基-永和,2024-04-08,9207
00679B,元大美債20年,69,20,49,凱基-永和,2024-04-08,9207
6227,茂綸,146,109,37,凱基-永和,2024-04-08,9207
2365,昆盈,40,4,36,凱基-永和,2024-04-08,9207
00929,復華台灣科技優息,27,0,27,凱基-永和,2024-04-08,9207
2308,台達電,30,5,25,凱基-永和,2024-04-08,9207
6015,宏遠證,25,0,25,凱基-永和,2024-04-08,9207
00751B,元大AAA至A公司債,21,0,21,凱基-永和,2024-04-08,9207
00927,群益半導體收益,20,0,20,凱基-永和,2024-04-08,9207
00720B,元大投資級公司債,20,0,20,凱基-永和,2024-04-08,9207
2359,所羅門,19,0,19,凱基-永和,2024-04-08,9207
2882,國泰金,24,5,19,凱基-永和,2024-04-08,9207
00937B,群益ESG投等債20,19,1,18,凱基-永和,2024-04-08,9207
3260,威剛,21,3,18,凱基-永和,2024-04-08,9207
00857B,永豐20年美公債,18,1,17,凱基-永和,2024-04-08,9207
1513,中興電,23,8,15,凱基-永和,2024-04-08,9207
00772B,中信高評級公司債,15,0,15,凱基-永和,2024-04-08,9207
3535,晶彩科,20,5,15,凱基-永和,2024-04-08,9207
00919,群益台灣精選高息,26,12,14,凱基-永和,2024-04-08,9207
00939,統一台灣高息動能,13,0,13,凱基-永和,2024-04-08,9207
8996,高力,34,21,13,凱基-永和,2024-04-08,9207
2464,盟立,18,6,12,凱基-永和,2024-04-08,9207
1103,嘉泥,12,0,12,凱基-永和,2024-04-08,9207
00632R,元大台灣50反1,12,0,12,凱基-永和,2024-04-08,9207
2324,仁寶,13,1,12,凱基-永和,2024-04-08,9207
1604,聲寶,11,0,11,凱基-永和,2024-04-08,9207
2371,大同,13,2,11,凱基-永和,2024-04-08,9207
8044,網家,11,0,11,凱基-永和,2024-04-08,9207
00706L,期元大S＆P日圓正2,10,0,10,凱基-永和,2024-04-08,9207
2355,敬鵬,10,0,10,凱基-永和,2024-04-08,9207
5388,中磊,10,0,10,凱基-永和,2024-04-08,9207
6109,亞元,10,0,10,凱基-永和,2024-04-08,9207
6116,彩晶,10,0,10,凱基-永和,2024-04-08,9207
6154,順發,10,0,10,凱基-永和,2024-04-08,9207
6179,亞通,10,0,10,凱基-永和,2024-04-08,9207
8050,廣積,11,1,10,凱基-永和,2024-04-08,9207
2618,長榮航,11,2,9,凱基-永和,2024-04-08,9207
2338,光罩,377,1,376,凱基-永和,2024-04-09,9207
2014,中鴻,345,7,338,凱基-永和,2024-04-09,9207
8096,擎亞,302,28,274,凱基-永和,2024-04-09,9207
4533,協易機,203,6,197,凱基-永和,2024-04-09,9207
2634,漢翔,235,47,188,凱基-永和,2024-04-09,9207
3306,鼎天,302,150,152,凱基-永和,2024-04-09,9207
2464,盟立,167,16,151,凱基-永和,2024-04-09,9207
8033,雷虎,101,5,96,凱基-永和,2024-04-09,9207
3231,緯創,94,12,82,凱基-永和,2024-04-09,9207
2449,京元電子,72,2,70,凱基-永和,2024-04-09,9207
00679B,元大美債20年,55,2,53,凱基-永和,2024-04-09,9207
2329,華泰,40,2,38,凱基-永和,2024-04-09,9207
00632R,元大台灣50反1,67,30,37,凱基-永和,2024-04-09,9207
00940,元大台灣價值高息,33,4,29,凱基-永和,2024-04-09,9207
6125,廣運,98,72,26,凱基-永和,2024-04-09,9207
2383,台光電,22,0,22,凱基-永和,2024-04-09,9207
2501,國建,32,11,21,凱基-永和,2024-04-09,9207
2030,彰源,20,0,20,凱基-永和,2024-04-09,9207
2492,華新科,20,0,20,凱基-永和,2024-04-09,9207
4973,廣穎,20,0,20,凱基-永和,2024-04-09,9207
8070,長華*,20,0,20,凱基-永和,2024-04-09,9207
00929,復華台灣科技優息,25,7,18,凱基-永和,2024-04-09,9207
00919,群益台灣精選高息,17,0,17,凱基-永和,2024-04-09,9207
2330,台積電,39,24,15,凱基-永和,2024-04-09,9207
4109,加捷生醫,15,0,15,凱基-永和,2024-04-09,9207
2486,一詮,14,0,14,凱基-永和,2024-04-09,9207
9933,中鼎,21,8,13,凱基-永和,2024-04-09,9207
3013,晟銘電,21,9,12,凱基-永和,2024-04-09,9207
2371,大同,22,11,11,凱基-永和,2024-04-09,9207
00939,統一台灣高息動能,10,0,10,凱基-永和,2024-04-09,9207
2614,東森,10,0,10,凱基-永和,2024-04-09,9207
4938,和碩,10,0,10,凱基-永和,2024-04-09,9207
5213,亞昕,10,0,10,凱基-永和,2024-04-09,9207
5324,士開,10,0,10,凱基-永和,2024-04-09,9207
6170,統振,10,0,10,凱基-永和,2024-04-09,9207
6616,特昇-KY,10,0,10,凱基-永和,2024-04-09,9207
8222,寶一,10,0,10,凱基-永和,2024-04-09,9207
8112,至上,17,8,9,凱基-永和,2024-04-09,9207
1789,神隆,9,0,9,凱基-永和,2024-04-09,9207
3617,碩天,9,0,9,凱基-永和,2024-04-09,9207
4147,中裕,10,1,9,凱基-永和,2024-04-09,9207
3715,定穎投控,13,5,8,凱基-永和,2024-04-09,9207
00931B,統一美債20年,8,0,8,凱基-永和,2024-04-09,9207
6245,立端,8,0,8,凱基-永和,2024-04-09,9207
9955,佳龍,11,3,8,凱基-永和,2024-04-09,9207
2354,鴻準,7,0,7,凱基-永和,2024-04-09,9207
6670,復盛應用,7,0,7,凱基-永和,2024-04-09,9207
6190,萬泰科,7,0,7,凱基-永和,2024-04-09,9207
2382,廣達,13,7,6,凱基-永和,2024-04-09,9207
2344,華邦電,15,9,6,凱基-永和,2024-04-09,9207
3363,上詮,433,2,431,凱基-永和,2024-04-10,9207
4967,十銓,364,10,354,凱基-永和,2024-04-10,9207
00937B,群益ESG投等債20,206,1,205,凱基-永和,2024-04-10,9207
00878,國泰永續高股息,210,6,204,凱基-永和,2024-04-10,9207
3036,文曄,155,0,155,凱基-永和,2024-04-10,9207
8299,群聯,108,3,105,凱基-永和,2024-04-10,9207
8059,凱碩,100,0,100,凱基-永和,2024-04-10,9207
3260,威剛,158,79,79,凱基-永和,2024-04-10,9207
3013,晟銘電,52,1,51,凱基-永和,2024-04-10,9207
1609,大亞,59,8,51,凱基-永和,2024-04-10,9207
5340,建榮,47,1,46,凱基-永和,2024-04-10,9207
2867,三商壽,45,0,45,凱基-永和,2024-04-10,9207
00919,群益台灣精選高息,36,1,35,凱基-永和,2024-04-10,9207
5009,榮剛,37,5,32,凱基-永和,2024-04-10,9207
00632R,元大台灣50反1,30,0,30,凱基-永和,2024-04-10,9207
1504,東元,28,5,23,凱基-永和,2024-04-10,9207
5508,永信建,22,0,22,凱基-永和,2024-04-10,9207
00637L,元大滬深300正2,21,0,21,凱基-永和,2024-04-10,9207
00933B,國泰10Y+金融債,20,0,20,凱基-永和,2024-04-10,9207
3015,全漢,20,0,20,凱基-永和,2024-04-10,9207
2376,技嘉,21,4,17,凱基-永和,2024-04-10,9207
2506,太設,17,0,17,凱基-永和,2024-04-10,9207
2603,長榮,17,1,16,凱基-永和,2024-04-10,9207
2845,遠東銀,16,0,16,凱基-永和,2024-04-10,9207
5469,瀚宇博,25,9,16,凱基-永和,2024-04-10,9207
2382,廣達,17,2,15,凱基-永和,2024-04-10,9207
00940,元大台灣價值高息,24,10,14,凱基-永和,2024-04-10,9207
2348,海悅,13,0,13,凱基-永和,2024-04-10,9207
2882,國泰金,14,1,13,凱基-永和,2024-04-10,9207
6117,迎廣,14,2,12,凱基-永和,2024-04-10,9207
2354,鴻準,23,11,12,凱基-永和,2024-04-10,9207
00941,中信上游半導體,11,0,11,凱基-永和,2024-04-10,9207
1101,台泥,11,0,11,凱基-永和,2024-04-10,9207
1584,精剛,11,0,11,凱基-永和,2024-04-10,9207
2371,大同,14,3,11,凱基-永和,2024-04-10,9207
4532,瑞智,11,0,11,凱基-永和,2024-04-10,9207
8071,能率網通,11,0,11,凱基-永和,2024-04-10,9207
3481,群創,12,1,11,凱基-永和,2024-04-10,9207
2383,台光電,12,2,10,凱基-永和,2024-04-10,9207
9940,信義,10,0,10,凱基-永和,2024-04-10,9207
2459,敦吉,10,0,10,凱基-永和,2024-04-10,9207
2505,國揚,10,0,10,凱基-永和,2024-04-10,9207
2888,新光金,13,3,10,凱基-永和,2024-04-10,9207
8201,無敵,10,0,10,凱基-永和,2024-04-10,9207
0056,元大高股息,24,14,10,凱基-永和,2024-04-10,9207
2427,三商電,30,21,9,凱基-永和,2024-04-10,9207
00923,群益台ESG低碳50,8,0,8,凱基-永和,2024-04-10,9207
1513,中興電,15,8,7,凱基-永和,2024-04-10,9207
1503,士電,9,2,7,凱基-永和,2024-04-10,9207
3141,晶宏,7,0,7,凱基-永和,2024-04-10,9207
2353,宏��,616,12,604,凱基-永和,2024-04-11,9207
8112,至上,500,2,498,凱基-永和,2024-04-11,9207
6290,良維,262,0,262,凱基-永和,2024-04-11,9207
2374,佳能,161,2,159,凱基-永和,2024-04-11,9207
00929,復華台灣科技優息,125,0,125,凱基-永和,2024-04-11,9207
4958,臻鼎-KY,101,0,101,凱基-永和,2024-04-11,9207
3354,律勝,100,0,100,凱基-永和,2024-04-11,9207
00665L,富邦�琤肭磪囓�2,112,40,72,凱基-永和,2024-04-11,9207
3615,安可,67,0,67,凱基-永和,2024-04-11,9207
6515,穎崴,58,0,58,凱基-永和,2024-04-11,9207
00878,國泰永續高股息,50,4,46,凱基-永和,2024-04-11,9207
3680,家登,43,1,42,凱基-永和,2024-04-11,9207
2867,三商壽,40,0,40,凱基-永和,2024-04-11,9207
3481,群創,60,21,39,凱基-永和,2024-04-11,9207
8210,勤誠,40,2,38,凱基-永和,2024-04-11,9207
00937B,群益ESG投等債20,69,35,34,凱基-永和,2024-04-11,9207
00751B,元大AAA至A公司債,30,0,30,凱基-永和,2024-04-11,9207
00679B,元大美債20年,33,4,29,凱基-永和,2024-04-11,9207
2743,山富,30,1,29,凱基-永和,2024-04-11,9207
2337,旺宏,28,0,28,凱基-永和,2024-04-11,9207
2886,兆豐金,27,0,27,凱基-永和,2024-04-11,9207
0056,元大高股息,24,0,24,凱基-永和,2024-04-11,9207
00940,元大台灣價值高息,29,5,24,凱基-永和,2024-04-11,9207
00720B,元大投資級公司債,27,5,22,凱基-永和,2024-04-11,9207
3231,緯創,30,9,21,凱基-永和,2024-04-11,9207
5009,榮剛,20,0,20,凱基-永和,2024-04-11,9207
00931B,統一美債20年,20,0,20,凱基-永和,2024-04-11,9207
00830,國泰費城半導體,30,10,20,凱基-永和,2024-04-11,9207
00753L,中信中國50正2,20,0,20,凱基-永和,2024-04-11,9207
6257,矽格,22,2,20,凱基-永和,2024-04-11,9207
00772B,中信高評級公司債,18,0,18,凱基-永和,2024-04-11,9207
3583,辛耘,17,2,15,凱基-永和,2024-04-11,9207
4714,永捷,15,0,15,凱基-永和,2024-04-11,9207
00687B,國泰20年美債,15,0,15,凱基-永和,2024-04-11,9207
00680L,元大美債20正2,14,0,14,凱基-永和,2024-04-11,9207
3372,典範,14,0,14,凱基-永和,2024-04-11,9207
3563,牧德,15,1,14,凱基-永和,2024-04-11,9207
2881,富邦金,12,0,12,凱基-永和,2024-04-11,9207
6743,安普新,20,8,12,凱基-永和,2024-04-11,9207
2610,華航,102,90,12,凱基-永和,2024-04-11,9207
00933B,國泰10Y+金融債,11,0,11,凱基-永和,2024-04-11,9207
2344,華邦電,11,0,11,凱基-永和,2024-04-11,9207
2498,宏達電,12,1,11,凱基-永和,2024-04-11,9207
00632R,元大台灣50反1,10,0,10,凱基-永和,2024-04-11,9207
2329,華泰,22,12,10,凱基-永和,2024-04-11,9207
2342,茂矽,11,1,10,凱基-永和,2024-04-11,9207
2461,光群雷,10,0,10,凱基-永和,2024-04-11,9207
2464,盟立,10,0,10,凱基-永和,2024-04-11,9207
3015,全漢,10,0,10,凱基-永和,2024-04-11,9207
2002,中鋼,10,1,9,凱基-永和,2024-04-11,9207
2367,燿華,824,120,704,凱基-永和,2024-04-12,9207
3481,群創,271,1,270,凱基-永和,2024-04-12,9207
1618,合機,253,2,251,凱基-永和,2024-04-12,9207
00937B,群益ESG投等債20,219,14,205,凱基-永和,2024-04-12,9207
1612,宏泰,203,2,201,凱基-永和,2024-04-12,9207
4533,協易機,418,231,187,凱基-永和,2024-04-12,9207
1795,美時,170,3,167,凱基-永和,2024-04-12,9207
00665L,富邦�琤肭磪囓�2,150,0,150,凱基-永和,2024-04-12,9207
1609,大亞,262,128,134,凱基-永和,2024-04-12,9207
2388,威盛,221,102,119,凱基-永和,2024-04-12,9207
3622,洋華,103,1,102,凱基-永和,2024-04-12,9207
00679B,元大美債20年,98,31,67,凱基-永和,2024-04-12,9207
4905,台聯電,44,0,44,凱基-永和,2024-04-12,9207
6727,亞泰金屬,40,0,40,凱基-永和,2024-04-12,9207
8299,群聯,40,0,40,凱基-永和,2024-04-12,9207
2337,旺宏,37,0,37,凱基-永和,2024-04-12,9207
00940,元大台灣價值高息,45,11,34,凱基-永和,2024-04-12,9207
4588,玖鼎電力,30,0,30,凱基-永和,2024-04-12,9207
2317,鴻海,39,12,27,凱基-永和,2024-04-12,9207
3006,晶豪科,25,0,25,凱基-永和,2024-04-12,9207
3284,太普高,22,0,22,凱基-永和,2024-04-12,9207
3587,閎康,21,0,21,凱基-永和,2024-04-12,9207
6239,力成,21,0,21,凱基-永和,2024-04-12,9207
2009,第一銅,42,22,20,凱基-永和,2024-04-12,9207
00881,國泰台灣5G+,15,0,15,凱基-永和,2024-04-12,9207
3563,牧德,15,0,15,凱基-永和,2024-04-12,9207
8071,能率網通,15,0,15,凱基-永和,2024-04-12,9207
00929,復華台灣科技優息,15,1,14,凱基-永和,2024-04-12,9207
2382,廣達,18,4,14,凱基-永和,2024-04-12,9207
2460,建通,13,0,13,凱基-永和,2024-04-12,9207
0056,元大高股息,12,0,12,凱基-永和,2024-04-12,9207
3231,緯創,18,6,12,凱基-永和,2024-04-12,9207
1589,永冠-KY,12,0,12,凱基-永和,2024-04-12,9207
2610,華航,24,12,12,凱基-永和,2024-04-12,9207
00632R,元大台灣50反1,11,0,11,凱基-永和,2024-04-12,9207
2409,友達,11,0,11,凱基-永和,2024-04-12,9207
3041,揚智,11,0,11,凱基-永和,2024-04-12,9207
2330,台積電,10,0,10,凱基-永和,2024-04-12,9207
00933B,國泰10Y+金融債,10,0,10,凱基-永和,2024-04-12,9207
2706,第一店,10,0,10,凱基-永和,2024-04-12,9207
3131,弘塑,10,0,10,凱基-永和,2024-04-12,9207
3645,達邁,10,0,10,凱基-永和,2024-04-12,9207
6179,亞通,10,0,10,凱基-永和,2024-04-12,9207
2630,亞航,10,1,9,凱基-永和,2024-04-12,9207
3025,星通,15,6,9,凱基-永和,2024-04-12,9207
6198,瑞築,9,0,9,凱基-永和,2024-04-12,9207
4147,中裕,8,0,8,凱基-永和,2024-04-12,9207
6282,康舒,31,23,8,凱基-永和,2024-04-12,9207
2881,富邦金,9,2,7,凱基-永和,2024-04-12,9207
00795B,中信美國公債20年,7,0,7,凱基-永和,2024-04-12,9207
2344,華邦電,310,0,310,凱基-永和,2024-04-15,9207
5371,中光電,257,14,243,凱基-永和,2024-04-15,9207
00929,復華台灣科技優息,210,1,209,凱基-永和,2024-04-15,9207
8033,雷虎,200,3,197,凱基-永和,2024-04-15,9207
3491,昇達科,105,0,105,凱基-永和,2024-04-15,9207
3490,單井,100,0,100,凱基-永和,2024-04-15,9207
2867,三商壽,91,4,87,凱基-永和,2024-04-15,9207
3645,達邁,50,0,50,凱基-永和,2024-04-15,9207
1504,東元,59,11,48,凱基-永和,2024-04-15,9207
0056,元大高股息,51,4,47,凱基-永和,2024-04-15,9207
00933B,國泰10Y+金融債,38,0,38,凱基-永和,2024-04-15,9207
1605,華新,54,30,24,凱基-永和,2024-04-15,9207
8112,至上,22,0,22,凱基-永和,2024-04-15,9207
00697B,元大美債7-10,20,0,20,凱基-永和,2024-04-15,9207
1314,中石化,30,10,20,凱基-永和,2024-04-15,9207
00720B,元大投資級公司債,20,1,19,凱基-永和,2024-04-15,9207
00940,元大台灣價值高息,34,15,19,凱基-永和,2024-04-15,9207
2603,長榮,22,4,18,凱基-永和,2024-04-15,9207
1303,南亞,16,0,16,凱基-永和,2024-04-15,9207
1785,光洋科,15,0,15,凱基-永和,2024-04-15,9207
2382,廣達,19,5,14,凱基-永和,2024-04-15,9207
00919,群益台灣精選高息,15,1,14,凱基-永和,2024-04-15,9207
2501,國建,14,0,14,凱基-永和,2024-04-15,9207
3013,晟銘電,15,1,14,凱基-永和,2024-04-15,9207
3260,威剛,15,2,13,凱基-永和,2024-04-15,9207
00680L,元大美債20正2,12,0,12,凱基-永和,2024-04-15,9207
2607,榮運,11,0,11,凱基-永和,2024-04-15,9207
2883,凱基金,11,0,11,凱基-永和,2024-04-15,9207
2492,華新科,10,0,10,凱基-永和,2024-04-15,9207
00918,大華優利高填息30,10,0,10,凱基-永和,2024-04-15,9207
00772B,中信高評級公司債,10,0,10,凱基-永和,2024-04-15,9207
2027,大成鋼,10,0,10,凱基-永和,2024-04-15,9207
6152,百一,10,0,10,凱基-永和,2024-04-15,9207
8070,長華*,10,0,10,凱基-永和,2024-04-15,9207
8076,伍豐,10,0,10,凱基-永和,2024-04-15,9207
4532,瑞智,9,0,9,凱基-永和,2024-04-15,9207
2303,聯電,10,2,8,凱基-永和,2024-04-15,9207
00708L,期元大S＆P黃金正2,8,0,8,凱基-永和,2024-04-15,9207
2356,英業達,22,14,8,凱基-永和,2024-04-15,9207
4979,華星光,7,0,7,凱基-永和,2024-04-15,9207
2889,國票金,7,0,7,凱基-永和,2024-04-15,9207
4927,泰鼎-KY,7,0,7,凱基-永和,2024-04-15,9207
2449,京元電子,6,0,6,凱基-永和,2024-04-15,9207
00878,國泰永續高股息,9,3,6,凱基-永和,2024-04-15,9207
2014,中鴻,6,0,6,凱基-永和,2024-04-15,9207
2610,華航,6,0,6,凱基-永和,2024-04-15,9207
3563,牧德,6,0,6,凱基-永和,2024-04-15,9207
00891,中信關鍵半導體,6,0,6,凱基-永和,2024-04-15,9207
2383,台光電,12,7,5,凱基-永和,2024-04-15,9207
2025,千興,5,0,5,凱基-永和,2024-04-15,9207
00940,元大台灣價值高息,249,37,212,凱基-永和,2024-04-16,9207
00919,群益台灣精選高息,144,8,136,凱基-永和,2024-04-16,9207
00929,復華台灣科技優息,163,39,124,凱基-永和,2024-04-16,9207
00939,統一台灣高息動能,74,1,73,凱基-永和,2024-04-16,9207
0056,元大高股息,62,1,61,凱基-永和,2024-04-16,9207
00650L,復華香港正2,65,10,55,凱基-永和,2024-04-16,9207
2331,精英,50,0,50,凱基-永和,2024-04-16,9207
00937B,群益ESG投等債20,63,15,48,凱基-永和,2024-04-16,9207
1609,大亞,109,70,39,凱基-永和,2024-04-16,9207
2312,金寶,36,0,36,凱基-永和,2024-04-16,9207
1504,東元,31,0,31,凱基-永和,2024-04-16,9207
3260,威剛,32,1,31,凱基-永和,2024-04-16,9207
2330,台積電,29,2,27,凱基-永和,2024-04-16,9207
00933B,國泰10Y+金融債,26,0,26,凱基-永和,2024-04-16,9207
2317,鴻海,36,11,25,凱基-永和,2024-04-16,9207
3576,聯合再生,25,0,25,凱基-永和,2024-04-16,9207
6109,亞元,25,0,25,凱基-永和,2024-04-16,9207
00751B,元大AAA至A公司債,22,0,22,凱基-永和,2024-04-16,9207
3027,盛達,29,7,22,凱基-永和,2024-04-16,9207
2353,宏��,44,23,21,凱基-永和,2024-04-16,9207
2618,長榮航,21,1,20,凱基-永和,2024-04-16,9207
00676R,富邦臺灣加權反1,20,0,20,凱基-永和,2024-04-16,9207
00931B,統一美債20年,20,0,20,凱基-永和,2024-04-16,9207
1416,廣豐,20,0,20,凱基-永和,2024-04-16,9207
3056,富華新,20,0,20,凱基-永和,2024-04-16,9207
2505,國揚,18,0,18,凱基-永和,2024-04-16,9207
00881,國泰台灣5G+,18,0,18,凱基-永和,2024-04-16,9207
00680L,元大美債20正2,17,0,17,凱基-永和,2024-04-16,9207
00918,大華優利高填息30,22,6,16,凱基-永和,2024-04-16,9207
2356,英業達,18,2,16,凱基-永和,2024-04-16,9207
2303,聯電,20,4,16,凱基-永和,2024-04-16,9207
2374,佳能,20,5,15,凱基-永和,2024-04-16,9207
2897,王道銀行,15,0,15,凱基-永和,2024-04-16,9207
6443,元晶,14,0,14,凱基-永和,2024-04-16,9207
3231,緯創,21,7,14,凱基-永和,2024-04-16,9207
00891,中信關鍵半導體,13,0,13,凱基-永和,2024-04-16,9207
2892,第一金,12,0,12,凱基-永和,2024-04-16,9207
1618,合機,32,20,12,凱基-永和,2024-04-16,9207
2888,新光金,11,0,11,凱基-永和,2024-04-16,9207
3032,偉訓,11,0,11,凱基-永和,2024-04-16,9207
2301,光寶科,14,4,10,凱基-永和,2024-04-16,9207
00915,凱基優選高股息30,19,9,10,凱基-永和,2024-04-16,9207
1529,樂事綠能,10,0,10,凱基-永和,2024-04-16,9207
3227,原相,10,0,10,凱基-永和,2024-04-16,9207
4720,德淵,10,0,10,凱基-永和,2024-04-16,9207
4960,誠美材,11,1,10,凱基-永和,2024-04-16,9207
4977,眾達-KY,10,0,10,凱基-永和,2024-04-16,9207
3481,群創,11,1,10,凱基-永和,2024-04-16,9207
00679B,元大美債20年,23,14,9,凱基-永和,2024-04-16,9207
2492,華新科,10,1,9,凱基-永和,2024-04-16,9207
2467,志聖,400,0,400,凱基-永和,2024-04-17,9207
1616,億泰,300,0,300,凱基-永和,2024-04-17,9207
3583,辛耘,338,52,286,凱基-永和,2024-04-17,9207
1513,中興電,248,14,234,凱基-永和,2024-04-17,9207
2371,大同,907,707,200,凱基-永和,2024-04-17,9207
3481,群創,201,2,199,凱基-永和,2024-04-17,9207
6125,廣運,207,10,197,凱基-永和,2024-04-17,9207
2329,華泰,205,9,196,凱基-永和,2024-04-17,9207
2845,遠東銀,176,0,176,凱基-永和,2024-04-17,9207
1503,士電,212,95,117,凱基-永和,2024-04-17,9207
3622,洋華,102,0,102,凱基-永和,2024-04-17,9207
5381,合正,100,0,100,凱基-永和,2024-04-17,9207
8121,越峰,100,0,100,凱基-永和,2024-04-17,9207
2409,友達,101,1,100,凱基-永和,2024-04-17,9207
00929,復華台灣科技優息,106,17,89,凱基-永和,2024-04-17,9207
00892,富邦台灣半導體,65,0,65,凱基-永和,2024-04-17,9207
4956,光鋐,64,1,63,凱基-永和,2024-04-17,9207
00933B,國泰10Y+金融債,56,0,56,凱基-永和,2024-04-17,9207
5515,建國,52,0,52,凱基-永和,2024-04-17,9207
00937B,群益ESG投等債20,44,5,39,凱基-永和,2024-04-17,9207
3003,健和興,35,0,35,凱基-永和,2024-04-17,9207
2301,光寶科,33,1,32,凱基-永和,2024-04-17,9207
00857B,永豐20年美公債,31,0,31,凱基-永和,2024-04-17,9207
3296,勝德,30,0,30,凱基-永和,2024-04-17,9207
00940,元大台灣價值高息,29,0,29,凱基-永和,2024-04-17,9207
3231,緯創,32,5,27,凱基-永和,2024-04-17,9207
2101,南港,37,10,27,凱基-永和,2024-04-17,9207
5512,力麒,28,1,27,凱基-永和,2024-04-17,9207
6223,旺矽,27,1,26,凱基-永和,2024-04-17,9207
6806,森崴能源,24,4,20,凱基-永和,2024-04-17,9207
00720B,元大投資級公司債,17,1,16,凱基-永和,2024-04-17,9207
1795,美時,17,1,16,凱基-永和,2024-04-17,9207
2303,聯電,14,0,14,凱基-永和,2024-04-17,9207
2342,茂矽,15,2,13,凱基-永和,2024-04-17,9207
00679B,元大美債20年,12,0,12,凱基-永和,2024-04-17,9207
2724,藝舍-KY,12,0,12,凱基-永和,2024-04-17,9207
00905,FT臺灣Smart,12,1,11,凱基-永和,2024-04-17,9207
00687B,國泰20年美債,15,4,11,凱基-永和,2024-04-17,9207
2382,廣達,16,6,10,凱基-永和,2024-04-17,9207
00712,復華富時不動產,10,0,10,凱基-永和,2024-04-17,9207
2505,國揚,10,0,10,凱基-永和,2024-04-17,9207
3131,弘塑,11,1,10,凱基-永和,2024-04-17,9207
3591,艾笛森,10,0,10,凱基-永和,2024-04-17,9207
3701,大眾控,10,0,10,凱基-永和,2024-04-17,9207
2363,矽統,10,1,9,凱基-永和,2024-04-17,9207
2353,宏��,9,1,8,凱基-永和,2024-04-17,9207
4532,瑞智,16,8,8,凱基-永和,2024-04-17,9207
4934,太極,8,0,8,凱基-永和,2024-04-17,9207
6109,亞元,8,0,8,凱基-永和,2024-04-17,9207
3037,欣興,17,10,7,凱基-永和,2024-04-17,9207
1608,華榮,323,12,311,凱基-永和,2024-04-18,9207
2465,麗臺,258,4,254,凱基-永和,2024-04-18,9207
3576,聯合再生,180,0,180,凱基-永和,2024-04-18,9207
2867,三商壽,222,47,175,凱基-永和,2024-04-18,9207
2427,三商電,151,3,148,凱基-永和,2024-04-18,9207
8996,高力,143,0,143,凱基-永和,2024-04-18,9207
8383,千附,111,0,111,凱基-永和,2024-04-18,9207
6233,旺玖,100,0,100,凱基-永和,2024-04-18,9207
6443,元晶,70,0,70,凱基-永和,2024-04-18,9207
3052,夆典,50,0,50,凱基-永和,2024-04-18,9207
3363,上詮,50,0,50,凱基-永和,2024-04-18,9207
6415,矽力*-KY,51,3,48,凱基-永和,2024-04-18,9207
00632R,元大台灣50反1,54,10,44,凱基-永和,2024-04-18,9207
2406,國碩,40,0,40,凱基-永和,2024-04-18,9207
6282,康舒,52,20,32,凱基-永和,2024-04-18,9207
1504,東元,41,17,24,凱基-永和,2024-04-18,9207
00929,復華台灣科技優息,25,2,23,凱基-永和,2024-04-18,9207
2634,漢翔,31,8,23,凱基-永和,2024-04-18,9207
3702,大聯大,23,1,22,凱基-永和,2024-04-18,9207
6176,瑞儀,21,0,21,凱基-永和,2024-04-18,9207
1217,愛之味,19,0,19,凱基-永和,2024-04-18,9207
1589,永冠-KY,19,0,19,凱基-永和,2024-04-18,9207
4934,太極,16,0,16,凱基-永和,2024-04-18,9207
3707,漢磊,26,11,15,凱基-永和,2024-04-18,9207
5488,松普,15,0,15,凱基-永和,2024-04-18,9207
00940,元大台灣價值高息,14,1,13,凱基-永和,2024-04-18,9207
3708,上緯投控,14,1,13,凱基-永和,2024-04-18,9207
2610,華航,16,5,11,凱基-永和,2024-04-18,9207
2501,國建,18,6,12,凱基-永和,2024-04-18,9207
2408,南亞科,14,3,11,凱基-永和,2024-04-18,9207
00680L,元大美債20正2,10,0,10,凱基-永和,2024-04-18,9207
2337,旺宏,10,0,10,凱基-永和,2024-04-18,9207
2603,長榮,10,0,10,凱基-永和,2024-04-18,9207
3044,健鼎,11,1,10,凱基-永和,2024-04-18,9207
6285,啟��,10,0,10,凱基-永和,2024-04-18,9207
2605,新興,10,1,9,凱基-永和,2024-04-18,9207
3714,富采,9,0,9,凱基-永和,2024-04-18,9207
6182,合晶,8,0,8,凱基-永和,2024-04-18,9207
0056,元大高股息,9,2,7,凱基-永和,2024-04-18,9207
00937B,群益ESG投等債20,7,0,7,凱基-永和,2024-04-18,9207
1785,光洋科,7,0,7,凱基-永和,2024-04-18,9207
2331,精英,7,0,7,凱基-永和,2024-04-18,9207
2367,燿華,36,29,7,凱基-永和,2024-04-18,9207
2892,第一金,7,0,7,凱基-永和,2024-04-18,9207
4927,泰鼎-KY,7,0,7,凱基-永和,2024-04-18,9207
00885,富邦越南,6,0,6,凱基-永和,2024-04-18,9207
2354,鴻準,6,0,6,凱基-永和,2024-04-18,9207
2537,聯上發,6,0,6,凱基-永和,2024-04-18,9207
2883,凱基金,6,0,6,凱基-永和,2024-04-18,9207
3078,僑威,8,2,6,凱基-永和,2024-04-18,9207
2371,大同,1031,761,270,凱基-永和,2024-04-19,9207
00919,群益台灣精選高息,266,2,264,凱基-永和,2024-04-19,9207
00929,復華台灣科技優息,275,20,255,凱基-永和,2024-04-19,9207
00632R,元大台灣50反1,260,42,218,凱基-永和,2024-04-19,9207
00940,元大台灣價值高息,228,10,218,凱基-永和,2024-04-19,9207
6143,振曜,200,2,198,凱基-永和,2024-04-19,9207
1616,億泰,305,127,178,凱基-永和,2024-04-19,9207
8033,雷虎,160,0,160,凱基-永和,2024-04-19,9207
2867,三商壽,142,20,122,凱基-永和,2024-04-19,9207
3052,夆典,105,0,105,凱基-永和,2024-04-19,9207
2353,宏��,114,11,103,凱基-永和,2024-04-19,9207
3287,廣寰科,100,3,97,凱基-永和,2024-04-19,9207
4513,福裕,83,4,79,凱基-永和,2024-04-19,9207
0056,元大高股息,62,1,61,凱基-永和,2024-04-19,9207
00878,國泰永續高股息,59,6,53,凱基-永和,2024-04-19,9207
00888,永豐台灣ESG,41,0,41,凱基-永和,2024-04-19,9207
2330,台積電,45,11,34,凱基-永和,2024-04-19,9207
3481,群創,38,8,30,凱基-永和,2024-04-19,9207
2882,國泰金,28,1,27,凱基-永和,2024-04-19,9207
00939,統一台灣高息動能,73,47,26,凱基-永和,2024-04-19,9207
1101,台泥,22,0,22,凱基-永和,2024-04-19,9207
2888,新光金,26,6,20,凱基-永和,2024-04-19,9207
9955,佳龍,27,8,19,凱基-永和,2024-04-19,9207
3312,弘憶股,16,0,16,凱基-永和,2024-04-19,9207
8044,網家,20,4,16,凱基-永和,2024-04-19,9207
006208,富邦台50,19,4,15,凱基-永和,2024-04-19,9207
2801,彰銀,13,0,13,凱基-永和,2024-04-19,9207
3049,精金,15,2,13,凱基-永和,2024-04-19,9207
6109,亞元,13,0,13,凱基-永和,2024-04-19,9207
2317,鴻海,33,20,13,凱基-永和,2024-04-19,9207
5880,合庫金,12,0,12,凱基-永和,2024-04-19,9207
00891,中信關鍵半導體,12,0,12,凱基-永和,2024-04-19,9207
0050,元大台灣50,13,1,12,凱基-永和,2024-04-19,9207
2515,中工,30,18,12,凱基-永和,2024-04-19,9207
3037,欣興,11,0,11,凱基-永和,2024-04-19,9207
00904,新光臺灣半導體30,11,0,11,凱基-永和,2024-04-19,9207
6770,力積電,15,4,11,凱基-永和,2024-04-19,9207
00933B,國泰10Y+金融債,11,1,10,凱基-永和,2024-04-19,9207
1737,臺鹽,10,0,10,凱基-永和,2024-04-19,9207
2356,英業達,11,1,10,凱基-永和,2024-04-19,9207
2408,南亞科,10,0,10,凱基-永和,2024-04-19,9207
2460,建通,10,0,10,凱基-永和,2024-04-19,9207
6129,普誠,10,0,10,凱基-永和,2024-04-19,9207
2891,中信金,10,0,10,凱基-永和,2024-04-19,9207
2374,佳能,10,1,9,凱基-永和,2024-04-19,9207
00936,台新永續高息中小,9,0,9,凱基-永和,2024-04-19,9207
6486,互動,9,0,9,凱基-永和,2024-04-19,9207
5434,崇越,9,0,9,凱基-永和,2024-04-19,9207
2520,冠德,9,0,9,凱基-永和,2024-04-19,9207
00937B,群益ESG投等債20,8,0,8,凱基-永和,2024-04-19,9207
2515,中工,2078,1650,428,凱基-永和,2024-04-22,9207
2303,聯電,156,0,156,凱基-永和,2024-04-22,9207
2101,南港,141,26,115,凱基-永和,2024-04-22,9207
8027,鈦昇,70,0,70,凱基-永和,2024-04-22,9207
00919,群益台灣精選高息,71,8,63,凱基-永和,2024-04-22,9207
00929,復華台灣科技優息,57,6,51,凱基-永和,2024-04-22,9207
00679B,元大美債20年,39,0,39,凱基-永和,2024-04-22,9207
3228,金麗科,32,1,31,凱基-永和,2024-04-22,9207
3703,欣陸,33,2,31,凱基-永和,2024-04-22,9207
00939,統一台灣高息動能,24,0,24,凱基-永和,2024-04-22,9207
00937B,群益ESG投等債20,24,0,24,凱基-永和,2024-04-22,9207
1528,恩德,20,0,20,凱基-永和,2024-04-22,9207
2354,鴻準,21,1,20,凱基-永和,2024-04-22,9207
8044,網家,25,5,20,凱基-永和,2024-04-22,9207
8046,南電,53,34,19,凱基-永和,2024-04-22,9207
2731,雄獅,21,3,18,凱基-永和,2024-04-22,9207
2501,國建,170,152,18,凱基-永和,2024-04-22,9207
3231,緯創,18,2,16,凱基-永和,2024-04-22,9207
1608,華榮,17,2,15,凱基-永和,2024-04-22,9207
00878,國泰永續高股息,25,10,15,凱基-永和,2024-04-22,9207
3702,大聯大,18,4,14,凱基-永和,2024-04-22,9207
00931B,統一美債20年,13,0,13,凱基-永和,2024-04-22,9207
3015,全漢,14,1,13,凱基-永和,2024-04-22,9207
9940,信義,13,1,12,凱基-永和,2024-04-22,9207
2610,華航,12,1,11,凱基-永和,2024-04-22,9207
1460,宏遠,11,0,11,凱基-永和,2024-04-22,9207
1463,強盛新,10,0,10,凱基-永和,2024-04-22,9207
3308,聯德,10,0,10,凱基-永和,2024-04-22,9207
6275,元山,10,0,10,凱基-永和,2024-04-22,9207
6443,元晶,10,0,10,凱基-永和,2024-04-22,9207
1513,中興電,19,10,9,凱基-永和,2024-04-22,9207
1618,合機,349,340,9,凱基-永和,2024-04-22,9207
2609,陽明,27,18,9,凱基-永和,2024-04-22,9207
00683L,期元大美元指正2,8,0,8,凱基-永和,2024-04-22,9207
6122,擎邦,8,0,8,凱基-永和,2024-04-22,9207
2317,鴻海,9,2,7,凱基-永和,2024-04-22,9207
2382,廣達,13,5,8,凱基-永和,2024-04-22,9207
0056,元大高股息,35,28,7,凱基-永和,2024-04-22,9207
006208,富邦台50,6,0,6,凱基-永和,2024-04-22,9207
00918,大華優利高填息30,10,4,6,凱基-永和,2024-04-22,9207
2607,榮運,7,1,6,凱基-永和,2024-04-22,9207
3036,文曄,6,0,6,凱基-永和,2024-04-22,9207
4533,協易機,6,0,6,凱基-永和,2024-04-22,9207
8438,昶昕,6,0,6,凱基-永和,2024-04-22,9207
00891,中信關鍵半導體,6,0,6,凱基-永和,2024-04-22,9207
6219,富旺,7,2,5,凱基-永和,2024-04-22,9207
6189,豐藝,5,0,5,凱基-永和,2024-04-22,9207
00936,台新永續高息中小,5,0,5,凱基-永和,2024-04-22,9207
00830,國泰費城半導體,24,19,5,凱基-永和,2024-04-22,9207
1503,士電,11,6,5,凱基-永和,2024-04-22,9207
2374,佳能,771,544,227,凱基-永和,2024-04-23,9207
6125,廣運,314,117,197,凱基-永和,2024-04-23,9207
2515,中工,165,14,151,凱基-永和,2024-04-23,9207
00940,元大台灣價值高息,54,2,52,凱基-永和,2024-04-23,9207
2344,華邦電,52,0,52,凱基-永和,2024-04-23,9207
6213,聯茂,53,1,52,凱基-永和,2024-04-23,9207
6596,寬宏藝術,50,0,50,凱基-永和,2024-04-23,9207
2537,聯上發,48,2,46,凱基-永和,2024-04-23,9207
3576,聯合再生,45,0,45,凱基-永和,2024-04-23,9207
6117,迎廣,42,0,42,凱基-永和,2024-04-23,9207
6290,良維,40,0,40,凱基-永和,2024-04-23,9207
5371,中光電,30,1,29,凱基-永和,2024-04-23,9207
2368,金像電,26,0,26,凱基-永和,2024-04-23,9207
00919,群益台灣精選高息,26,0,26,凱基-永和,2024-04-23,9207
2382,廣達,24,1,23,凱基-永和,2024-04-23,9207
8210,勤誠,23,0,23,凱基-永和,2024-04-23,9207
1529,樂事綠能,23,0,23,凱基-永和,2024-04-23,9207
2371,大同,55,34,21,凱基-永和,2024-04-23,9207
2603,長榮,26,5,21,凱基-永和,2024-04-23,9207
6443,元晶,21,0,21,凱基-永和,2024-04-23,9207
6244,茂迪,20,0,20,凱基-永和,2024-04-23,9207
3715,定穎投控,19,0,19,凱基-永和,2024-04-23,9207
0050,元大台灣50,18,0,18,凱基-永和,2024-04-23,9207
00688L,國泰20年美債正2,17,0,17,凱基-永和,2024-04-23,9207
2610,華航,20,3,17,凱基-永和,2024-04-23,9207
00927,群益半導體收益,15,0,15,凱基-永和,2024-04-23,9207
1617,榮星,20,5,15,凱基-永和,2024-04-23,9207
3296,勝德,15,0,15,凱基-永和,2024-04-23,9207
6223,旺矽,15,0,15,凱基-永和,2024-04-23,9207
2408,南亞科,15,0,15,凱基-永和,2024-04-23,9207
3703,欣陸,18,5,13,凱基-永和,2024-04-23,9207
2353,宏��,12,0,12,凱基-永和,2024-04-23,9207
1609,大亞,30,19,11,凱基-永和,2024-04-23,9207
00918,大華優利高填息30,10,0,10,凱基-永和,2024-04-23,9207
00676R,富邦臺灣加權反1,10,0,10,凱基-永和,2024-04-23,9207
1616,億泰,10,0,10,凱基-永和,2024-04-23,9207
2062,橋椿,10,0,10,凱基-永和,2024-04-23,9207
2536,宏普,10,0,10,凱基-永和,2024-04-23,9207
2867,三商壽,20,10,10,凱基-永和,2024-04-23,9207
3024,憶聲,10,0,10,凱基-永和,2024-04-23,9207
6163,華電網,10,0,10,凱基-永和,2024-04-23,9207
2331,精英,10,1,9,凱基-永和,2024-04-23,9207
3034,聯詠,8,0,8,凱基-永和,2024-04-23,9207
2460,建通,8,0,8,凱基-永和,2024-04-23,9207
3708,上緯投控,13,5,8,凱基-永和,2024-04-23,9207
3702,大聯大,13,5,8,凱基-永和,2024-04-23,9207
0056,元大高股息,7,0,7,凱基-永和,2024-04-23,9207
3284,太普高,9,2,7,凱基-永和,2024-04-23,9207
3714,富采,7,0,7,凱基-永和,2024-04-23,9207
00939,統一台灣高息動能,10,4,6,凱基-永和,2024-04-23,9207
6125,廣運,469,357,112,凱基-永和,2024-04-24,9207
2886,兆豐金,110,1,109,凱基-永和,2024-04-24,9207
2409,友達,105,0,105,凱基-永和,2024-04-24,9207
3294,英濟,100,0,100,凱基-永和,2024-04-24,9207
3297,杭特,100,0,100,凱基-永和,2024-04-24,9207
2515,中工,90,0,90,凱基-永和,2024-04-24,9207
3013,晟銘電,103,19,84,凱基-永和,2024-04-24,9207
2743,山富,68,3,65,凱基-永和,2024-04-24,9207
2025,千興,50,0,50,凱基-永和,2024-04-24,9207
8054,安國,46,7,39,凱基-永和,2024-04-24,9207
00720B,元大投資級公司債,30,0,30,凱基-永和,2024-04-24,9207
2101,南港,35,11,24,凱基-永和,2024-04-24,9207
6462,神盾,25,1,24,凱基-永和,2024-04-24,9207
00929,復華台灣科技優息,31,8,23,凱基-永和,2024-04-24,9207
00940,元大台灣價值高息,36,15,21,凱基-永和,2024-04-24,9207
2618,長榮航,184,166,18,凱基-永和,2024-04-24,9207
00937B,群益ESG投等債20,16,0,16,凱基-永和,2024-04-24,9207
3689,湧德,11,0,11,凱基-永和,2024-04-24,9207
00935,野村臺灣新科技50,10,0,10,凱基-永和,2024-04-24,9207
1584,精剛,10,0,10,凱基-永和,2024-04-24,9207
3296,勝德,10,0,10,凱基-永和,2024-04-24,9207
3715,定穎投控,18,8,10,凱基-永和,2024-04-24,9207
2354,鴻準,22,13,9,凱基-永和,2024-04-24,9207
9940,信義,9,0,9,凱基-永和,2024-04-24,9207
3035,智原,10,2,8,凱基-永和,2024-04-24,9207
2376,技嘉,14,6,8,凱基-永和,2024-04-24,9207
3703,欣陸,16,9,7,凱基-永和,2024-04-24,9207
00795B,中信美國公債20年,6,0,6,凱基-永和,2024-04-24,9207
1339,昭輝,5,0,5,凱基-永和,2024-04-24,9207
1529,樂事綠能,5,0,5,凱基-永和,2024-04-24,9207
1608,華榮,8,3,5,凱基-永和,2024-04-24,9207
1617,榮星,5,0,5,凱基-永和,2024-04-24,9207
2606,裕民,5,0,5,凱基-永和,2024-04-24,9207
2608,嘉里大榮,5,0,5,凱基-永和,2024-04-24,9207
2891,中信金,6,1,5,凱基-永和,2024-04-24,9207
3548,兆利,5,0,5,凱基-永和,2024-04-24,9207
6109,亞元,5,0,5,凱基-永和,2024-04-24,9207
0056,元大高股息,4,0,4,凱基-永和,2024-04-24,9207
1439,雋揚,4,0,4,凱基-永和,2024-04-24,9207
2105,正新,6,2,4,凱基-永和,2024-04-24,9207
2342,茂矽,4,0,4,凱基-永和,2024-04-24,9207
3504,揚明光,4,0,4,凱基-永和,2024-04-24,9207
4157,太景*-KY,4,0,4,凱基-永和,2024-04-24,9207
6180,橘子,4,0,4,凱基-永和,2024-04-24,9207
8215,明基材,4,0,4,凱基-永和,2024-04-24,9207
3374,精材,3,0,3,凱基-永和,2024-04-24,9207
3707,漢磊,4,1,3,凱基-永和,2024-04-24,9207
1815,富喬,3,0,3,凱基-永和,2024-04-24,9207
2002,中鋼,5,2,3,凱基-永和,2024-04-24,9207
2010,春源,3,0,3,凱基-永和,2024-04-24,9207
2504,國產,202,22,180,凱基-永和,2024-04-25,9207
6425,易發,103,4,99,凱基-永和,2024-04-25,9207
6176,瑞儀,100,8,92,凱基-永和,2024-04-25,9207
2515,中工,201,116,85,凱基-永和,2024-04-25,9207
2547,日勝生,50,0,50,凱基-永和,2024-04-25,9207
6207,雷科,41,1,40,凱基-永和,2024-04-25,9207
8089,康全電訊,34,2,32,凱基-永和,2024-04-25,9207
00679B,元大美債20年,25,0,25,凱基-永和,2024-04-25,9207
00919,群益台灣精選高息,21,0,21,凱基-永和,2024-04-25,9207
00937B,群益ESG投等債20,21,0,21,凱基-永和,2024-04-25,9207
1617,榮星,21,0,21,凱基-永和,2024-04-25,9207
2317,鴻海,25,4,21,凱基-永和,2024-04-25,9207
2888,新光金,20,0,20,凱基-永和,2024-04-25,9207
00940,元大台灣價值高息,16,0,16,凱基-永和,2024-04-25,9207
3296,勝德,20,5,15,凱基-永和,2024-04-25,9207
6451,訊芯-KY,15,0,15,凱基-永和,2024-04-25,9207
5230,雷笛克光學,18,5,13,凱基-永和,2024-04-25,9207
1440,南紡,312,300,12,凱基-永和,2024-04-25,9207
2371,大同,18,6,12,凱基-永和,2024-04-25,9207
3686,達能,12,0,12,凱基-永和,2024-04-25,9207
5511,德昌,11,0,11,凱基-永和,2024-04-25,9207
00878,國泰永續高股息,18,8,10,凱基-永和,2024-04-25,9207
3231,緯創,10,0,10,凱基-永和,2024-04-25,9207
00680L,元大美債20正2,10,0,10,凱基-永和,2024-04-25,9207
1722,台肥,10,0,10,凱基-永和,2024-04-25,9207
2101,南港,15,5,10,凱基-永和,2024-04-25,9207
2459,敦吉,10,0,10,凱基-永和,2024-04-25,9207
2801,彰銀,10,0,10,凱基-永和,2024-04-25,9207
6179,亞通,10,0,10,凱基-永和,2024-04-25,9207
6533,晶心科,11,1,10,凱基-永和,2024-04-25,9207
2881,富邦金,10,1,9,凱基-永和,2024-04-25,9207
3284,太普高,14,5,9,凱基-永和,2024-04-25,9207
8069,元太,10,2,8,凱基-永和,2024-04-25,9207
2342,茂矽,7,0,7,凱基-永和,2024-04-25,9207
2505,國揚,9,2,7,凱基-永和,2024-04-25,9207
4927,泰鼎-KY,7,0,7,凱基-永和,2024-04-25,9207
4739,康普,8,2,6,凱基-永和,2024-04-25,9207
6239,力成,6,0,6,凱基-永和,2024-04-25,9207
6139,亞翔,7,1,6,凱基-永和,2024-04-25,9207
00857B,永豐20年美公債,6,0,6,凱基-永和,2024-04-25,9207
6219,富旺,6,0,6,凱基-永和,2024-04-25,9207
4938,和碩,6,0,6,凱基-永和,2024-04-25,9207
00893,國泰智能電動車,5,0,5,凱基-永和,2024-04-25,9207
6125,廣運,6,1,5,凱基-永和,2024-04-25,9207
1618,合機,6,1,5,凱基-永和,2024-04-25,9207
2886,兆豐金,16,11,5,凱基-永和,2024-04-25,9207
3036,文曄,5,0,5,凱基-永和,2024-04-25,9207
2501,國建,113,108,5,凱基-永和,2024-04-25,9207
1608,華榮,6,2,4,凱基-永和,2024-04-25,9207
8097,常珵,4,0,4,凱基-永和,2024-04-25,9207
2609,陽明,501,51,450,凱基-永和,2024-04-26,9207
2323,中環,351,71,280,凱基-永和,2024-04-26,9207
00632R,元大台灣50反1,241,0,241,凱基-永和,2024-04-26,9207
2501,國建,213,6,207,凱基-永和,2024-04-26,9207
2603,長榮,204,20,184,凱基-永和,2024-04-26,9207
2330,台積電,223,42,181,凱基-永和,2024-04-26,9207
6125,廣運,232,54,178,凱基-永和,2024-04-26,9207
8996,高力,187,38,149,凱基-永和,2024-04-26,9207
2611,志信,100,2,98,凱基-永和,2024-04-26,9207
2371,大同,63,11,52,凱基-永和,2024-04-26,9207
6188,廣明,60,12,48,凱基-永和,2024-04-26,9207
00937B,群益ESG投等債20,50,4,46,凱基-永和,2024-04-26,9207
3706,神達,31,2,29,凱基-永和,2024-04-26,9207
1101,台泥,28,0,28,凱基-永和,2024-04-26,9207
3231,緯創,33,8,25,凱基-永和,2024-04-26,9207
3563,牧德,25,2,23,凱基-永和,2024-04-26,9207
8070,長華*,20,0,20,凱基-永和,2024-04-26,9207
3017,奇鋐,22,3,19,凱基-永和,2024-04-26,9207
1440,南紡,19,2,17,凱基-永和,2024-04-26,9207
2610,華航,54,37,17,凱基-永和,2024-04-26,9207
9945,潤泰新,18,2,16,凱基-永和,2024-04-26,9207
00655L,國泰中國A50正2,15,0,15,凱基-永和,2024-04-26,9207
3031,佰鴻,15,0,15,凱基-永和,2024-04-26,9207
00919,群益台灣精選高息,17,2,15,凱基-永和,2024-04-26,9207
00940,元大台灣價值高息,30,16,14,凱基-永和,2024-04-26,9207
3013,晟銘電,27,15,12,凱基-永和,2024-04-26,9207
00933B,國泰10Y+金融債,12,0,12,凱基-永和,2024-04-26,9207
2374,佳能,12,0,12,凱基-永和,2024-04-26,9207
00857B,永豐20年美公債,11,0,11,凱基-永和,2024-04-26,9207
6282,康舒,11,0,11,凱基-永和,2024-04-26,9207
6531,愛普*,11,0,11,凱基-永和,2024-04-26,9207
00679B,元大美債20年,12,2,10,凱基-永和,2024-04-26,9207
1463,強盛新,10,0,10,凱基-永和,2024-04-26,9207
1733,五鼎,10,0,10,凱基-永和,2024-04-26,9207
1805,寶徠,10,0,10,凱基-永和,2024-04-26,9207
2883,凱基金,10,0,10,凱基-永和,2024-04-26,9207
3296,勝德,15,5,10,凱基-永和,2024-04-26,9207
3715,定穎投控,12,2,10,凱基-永和,2024-04-26,9207
8064,東捷,10,0,10,凱基-永和,2024-04-26,9207
00687B,國泰20年美債,9,1,8,凱基-永和,2024-04-26,9207
2637,慧洋-KY,29,21,8,凱基-永和,2024-04-26,9207
6672,騰輝電子-KY,8,0,8,凱基-永和,2024-04-26,9207
2892,第一金,7,0,7,凱基-永和,2024-04-26,9207
6442,光聖,7,0,7,凱基-永和,2024-04-26,9207
6109,亞元,6,0,6,凱基-永和,2024-04-26,9207
4533,協易機,7,1,6,凱基-永和,2024-04-26,9207
5274,信驊,6,0,6,凱基-永和,2024-04-26,9207
8936,國統,8,3,5,凱基-永和,2024-04-26,9207
1301,台塑,5,0,5,凱基-永和,2024-04-26,9207
1503,士電,7,2,5,凱基-永和,2024-04-26,9207
2317,鴻海,463,16,447,凱基-永和,2024-04-29,9207
2537,聯上發,1001,556,445,凱基-永和,2024-04-29,9207
3289,宜特,230,1,229,凱基-永和,2024-04-29,9207
1316,上曜,212,12,200,凱基-永和,2024-04-29,9207
8096,擎亞,200,0,200,凱基-永和,2024-04-29,9207
6451,訊芯-KY,180,11,169,凱基-永和,2024-04-29,9207
8996,高力,85,3,82,凱基-永和,2024-04-29,9207
00892,富邦台灣半導體,65,0,65,凱基-永和,2024-04-29,9207
2363,矽統,986,945,41,凱基-永和,2024-04-29,9207
2610,華航,61,21,40,凱基-永和,2024-04-29,9207
8044,網家,38,0,38,凱基-永和,2024-04-29,9207
2618,長榮航,63,25,38,凱基-永和,2024-04-29,9207
1504,東元,33,0,33,凱基-永和,2024-04-29,9207
2834,臺企銀,31,0,31,凱基-永和,2024-04-29,9207
2352,佳世達,30,0,30,凱基-永和,2024-04-29,9207
2511,太子,30,0,30,凱基-永和,2024-04-29,9207
6109,亞元,29,0,29,凱基-永和,2024-04-29,9207
1560,中砂,28,2,26,凱基-永和,2024-04-29,9207
2547,日勝生,26,0,26,凱基-永和,2024-04-29,9207
6139,亞翔,25,1,24,凱基-永和,2024-04-29,9207
8110,華東,25,1,24,凱基-永和,2024-04-29,9207
2889,國票金,30,7,23,凱基-永和,2024-04-29,9207
1474,弘裕,20,0,20,凱基-永和,2024-04-29,9207
2331,精英,20,0,20,凱基-永和,2024-04-29,9207
3055,蔚華科,20,1,19,凱基-永和,2024-04-29,9207
6112,邁達特,14,0,14,凱基-永和,2024-04-29,9207
8097,常珵,14,0,14,凱基-永和,2024-04-29,9207
2421,建準,13,0,13,凱基-永和,2024-04-29,9207
2449,京元電子,25,12,13,凱基-永和,2024-04-29,9207
9904,寶成,15,2,13,凱基-永和,2024-04-29,9207
4714,永捷,13,2,11,凱基-永和,2024-04-29,9207
00671R,富邦NASDAQ反1,10,0,10,凱基-永和,2024-04-29,9207
1416,廣豐,10,0,10,凱基-永和,2024-04-29,9207
2409,友達,10,0,10,凱基-永和,2024-04-29,9207
6016,康和證,10,0,10,凱基-永和,2024-04-29,9207
2892,第一金,11,1,10,凱基-永和,2024-04-29,9207
00679B,元大美債20年,10,1,9,凱基-永和,2024-04-29,9207
1609,大亞,9,1,8,凱基-永和,2024-04-29,9207
2367,燿華,8,0,8,凱基-永和,2024-04-29,9207
6683,雍智科技,9,1,8,凱基-永和,2024-04-29,9207
2002,中鋼,10,3,7,凱基-永和,2024-04-29,9207
5511,德昌,7,0,7,凱基-永和,2024-04-29,9207
2706,第一店,6,0,6,凱基-永和,2024-04-29,9207
3217,優群,6,0,6,凱基-永和,2024-04-29,9207
6215,和椿,6,0,6,凱基-永和,2024-04-29,9207
6806,森崴能源,9,4,5,凱基-永和,2024-04-29,9207
9940,信義,5,0,5,凱基-永和,2024-04-29,9207
2505,國揚,15,10,5,凱基-永和,2024-04-29,9207
00637L,元大滬深300正2,8,3,5,凱基-永和,2024-04-29,9207
1587,吉茂,7,2,5,凱基-永和,2024-04-29,9207
5371,中光電,484,6,478,凱基-永和,2024-04-30,9207
6125,廣運,563,307,256,凱基-永和,2024-04-30,9207
2515,中工,213,16,197,凱基-永和,2024-04-30,9207
2363,矽統,146,43,103,凱基-永和,2024-04-30,9207
2401,凌陽,100,0,100,凱基-永和,2024-04-30,9207
8064,東捷,100,0,100,凱基-永和,2024-04-30,9207
8996,高力,104,6,98,凱基-永和,2024-04-30,9207
3147,大綜,96,5,91,凱基-永和,2024-04-30,9207
4526,東台,98,12,86,凱基-永和,2024-04-30,9207
6143,振曜,60,0,60,凱基-永和,2024-04-30,9207
1533,車王電,40,0,40,凱基-永和,2024-04-30,9207
6202,盛群,40,0,40,凱基-永和,2024-04-30,9207
2359,所羅門,57,18,39,凱基-永和,2024-04-30,9207
2505,國揚,43,5,38,凱基-永和,2024-04-30,9207
2609,陽明,41,16,25,凱基-永和,2024-04-30,9207
1301,台塑,20,0,20,凱基-永和,2024-04-30,9207
1457,宜進,20,0,20,凱基-永和,2024-04-30,9207
2882,國泰金,21,2,19,凱基-永和,2024-04-30,9207
2913,農林,19,0,19,凱基-永和,2024-04-30,9207
4127,天良,19,0,19,凱基-永和,2024-04-30,9207
2885,元大金,20,2,18,凱基-永和,2024-04-30,9207
2610,華航,19,3,16,凱基-永和,2024-04-30,9207
2501,國建,45,30,15,凱基-永和,2024-04-30,9207
1101,台泥,14,0,14,凱基-永和,2024-04-30,9207
00919,群益台灣精選高息,13,0,13,凱基-永和,2024-04-30,9207
3443,創意,13,0,13,凱基-永和,2024-04-30,9207
2303,聯電,12,0,12,凱基-永和,2024-04-30,9207
2457,飛宏,15,3,12,凱基-永和,2024-04-30,9207
00940,元大台灣價值高息,11,0,11,凱基-永和,2024-04-30,9207
5469,瀚宇博,11,0,11,凱基-永和,2024-04-30,9207
6443,元晶,11,0,11,凱基-永和,2024-04-30,9207
3265,台星科,10,0,10,凱基-永和,2024-04-30,9207
2362,藍天,11,1,10,凱基-永和,2024-04-30,9207
2897,王道銀行,10,0,10,凱基-永和,2024-04-30,9207
4927,泰鼎-KY,10,0,10,凱基-永和,2024-04-30,9207
6190,萬泰科,11,1,10,凱基-永和,2024-04-30,9207
00878,國泰永續高股息,9,0,9,凱基-永和,2024-04-30,9207
00679B,元大美債20年,11,2,9,凱基-永和,2024-04-30,9207
2317,鴻海,18,10,8,凱基-永和,2024-04-30,9207
2009,第一銅,11,3,8,凱基-永和,2024-04-30,9207
6492,生華科,8,0,8,凱基-永和,2024-04-30,9207
8069,元太,7,0,7,凱基-永和,2024-04-30,9207
1605,華新,7,0,7,凱基-永和,2024-04-30,9207
2880,華南金,11,4,7,凱基-永和,2024-04-30,9207
6191,精成科,7,0,7,凱基-永和,2024-04-30,9207
1402,遠東新,6,0,6,凱基-永和,2024-04-30,9207
00937B,群益ESG投等債20,6,0,6,凱基-永和,2024-04-30,9207
1445,大宇,6,0,6,凱基-永和,2024-04-30,9207
2606,裕民,6,0,6,凱基-永和,2024-04-30,9207
3706,神達,6,0,6,凱基-永和,2024-04-30,9207
9945,潤泰新,815,420,395,凱基-永和,2024-05-02,9207
8112,至上,384,17,367,凱基-永和,2024-05-02,9207
2537,聯上發,200,0,200,凱基-永和,2024-05-02,9207
2852,第一保,150,0,150,凱基-永和,2024-05-02,9207
2374,佳能,102,0,102,凱基-永和,2024-05-02,9207
00919,群益台灣精選高息,101,0,101,凱基-永和,2024-05-02,9207
1413,宏洲,100,0,100,凱基-永和,2024-05-02,9207
2543,皇昌,100,0,100,凱基-永和,2024-05-02,9207
6290,良維,100,0,100,凱基-永和,2024-05-02,9207
2816,旺旺保,96,0,96,凱基-永和,2024-05-02,9207
2061,風青,84,0,84,凱基-永和,2024-05-02,9207
2867,三商壽,118,35,83,凱基-永和,2024-05-02,9207
6143,振曜,83,0,83,凱基-永和,2024-05-02,9207
2739,寒舍,80,2,78,凱基-永和,2024-05-02,9207
6207,雷科,70,0,70,凱基-永和,2024-05-02,9207
00878,國泰永續高股息,71,1,70,凱基-永和,2024-05-02,9207
8299,群聯,65,0,65,凱基-永和,2024-05-02,9207
3049,精金,59,0,59,凱基-永和,2024-05-02,9207
00929,復華台灣科技優息,58,0,58,凱基-永和,2024-05-02,9207
8027,鈦昇,50,0,50,凱基-永和,2024-05-02,9207
1316,上曜,450,410,40,凱基-永和,2024-05-02,9207
00665L,富邦�琤肭磪囓�2,323,283,40,凱基-永和,2024-05-02,9207
2886,兆豐金,38,0,38,凱基-永和,2024-05-02,9207
6116,彩晶,35,0,35,凱基-永和,2024-05-02,9207
3481,群創,35,4,31,凱基-永和,2024-05-02,9207
2520,冠德,33,5,28,凱基-永和,2024-05-02,9207
5512,力麒,471,444,27,凱基-永和,2024-05-02,9207
2337,旺宏,22,0,22,凱基-永和,2024-05-02,9207
00676R,富邦臺灣加權反1,20,0,20,凱基-永和,2024-05-02,9207
2492,華新科,20,0,20,凱基-永和,2024-05-02,9207
1314,中石化,20,1,19,凱基-永和,2024-05-02,9207
6274,台燿,17,0,17,凱基-永和,2024-05-02,9207
2641,正德,20,6,14,凱基-永和,2024-05-02,9207
6125,廣運,16,4,12,凱基-永和,2024-05-02,9207
00720B,元大投資級公司債,11,0,11,凱基-永和,2024-05-02,9207
4540,全球傳動,11,0,11,凱基-永和,2024-05-02,9207
2891,中信金,16,5,11,凱基-永和,2024-05-02,9207
1608,華榮,13,3,10,凱基-永和,2024-05-02,9207
2605,新興,10,0,10,凱基-永和,2024-05-02,9207
2888,新光金,10,0,10,凱基-永和,2024-05-02,9207
2615,萬海,17,7,10,凱基-永和,2024-05-02,9207
2609,陽明,12,3,9,凱基-永和,2024-05-02,9207
5392,能率,13,4,9,凱基-永和,2024-05-02,9207
2486,一詮,9,1,8,凱基-永和,2024-05-02,9207
8358,金居,8,0,8,凱基-永和,2024-05-02,9207
1337,再生-KY,7,0,7,凱基-永和,2024-05-02,9207
2885,元大金,8,1,7,凱基-永和,2024-05-02,9207
6526,達發,7,0,7,凱基-永和,2024-05-02,9207
8044,網家,17,10,7,凱基-永和,2024-05-02,9207
2301,光寶科,7,1,6,凱基-永和,2024-05-02,9207
6451,訊芯-KY,100,0,100,凱基-永和,2024-05-03,9207
8121,越峰,100,0,100,凱基-永和,2024-05-03,9207
2409,友達,100,10,90,凱基-永和,2024-05-03,9207
6143,振曜,76,1,75,凱基-永和,2024-05-03,9207
6449,鈺邦,70,0,70,凱基-永和,2024-05-03,9207
00929,復華台灣科技優息,59,3,56,凱基-永和,2024-05-03,9207
2515,中工,72,20,52,凱基-永和,2024-05-03,9207
00679B,元大美債20年,46,0,46,凱基-永和,2024-05-03,9207
4967,十銓,48,6,42,凱基-永和,2024-05-03,9207
00932,兆豐永續高息等權,40,0,40,凱基-永和,2024-05-03,9207
2545,皇翔,38,0,38,凱基-永和,2024-05-03,9207
8299,群聯,36,0,36,凱基-永和,2024-05-03,9207
00633L,富邦上証正2,25,0,25,凱基-永和,2024-05-03,9207
1589,永冠-KY,24,0,24,凱基-永和,2024-05-03,9207
3147,大綜,24,0,24,凱基-永和,2024-05-03,9207
2014,中鴻,20,0,20,凱基-永和,2024-05-03,9207
2328,廣宇,20,0,20,凱基-永和,2024-05-03,9207
00937B,群益ESG投等債20,18,0,18,凱基-永和,2024-05-03,9207
00650L,復華香港正2,18,0,18,凱基-永和,2024-05-03,9207
2705,六福,18,1,17,凱基-永和,2024-05-03,9207
1815,富喬,20,4,16,凱基-永和,2024-05-03,9207
2505,國揚,56,41,15,凱基-永和,2024-05-03,9207
3481,群創,20,5,15,凱基-永和,2024-05-03,9207
6170,統振,15,0,15,凱基-永和,2024-05-03,9207
6770,力積電,18,3,15,凱基-永和,2024-05-03,9207
00753L,中信中國50正2,25,11,14,凱基-永和,2024-05-03,9207
00878,國泰永續高股息,13,0,13,凱基-永和,2024-05-03,9207
3055,蔚華科,13,0,13,凱基-永和,2024-05-03,9207
1514,亞力,15,3,12,凱基-永和,2024-05-03,9207
00887,永豐中國科技50大,12,0,12,凱基-永和,2024-05-03,9207
6109,亞元,12,0,12,凱基-永和,2024-05-03,9207
8096,擎亞,390,378,12,凱基-永和,2024-05-03,9207
6806,森崴能源,12,1,11,凱基-永和,2024-05-03,9207
2887,台新金,14,3,11,凱基-永和,2024-05-03,9207
3231,緯創,18,7,11,凱基-永和,2024-05-03,9207
00657,國泰日經225,10,0,10,凱基-永和,2024-05-03,9207
00655L,國泰中國A50正2,10,0,10,凱基-永和,2024-05-03,9207
2527,宏璟,13,3,10,凱基-永和,2024-05-03,9207
2610,華航,16,6,10,凱基-永和,2024-05-03,9207
2701,萬企,10,0,10,凱基-永和,2024-05-03,9207
6223,旺矽,11,1,10,凱基-永和,2024-05-03,9207
6442,光聖,14,4,10,凱基-永和,2024-05-03,9207
8076,伍豐,10,0,10,凱基-永和,2024-05-03,9207
8926,台汽電,8,0,8,凱基-永和,2024-05-03,9207
2101,南港,12,4,8,凱基-永和,2024-05-03,9207
2344,華邦電,13,5,8,凱基-永和,2024-05-03,9207
2371,大同,10,2,8,凱基-永和,2024-05-03,9207
2618,長榮航,28,20,8,凱基-永和,2024-05-03,9207
2883,凱基金,11,3,8,凱基-永和,2024-05-03,9207
6219,富旺,8,0,8,凱基-永和,2024-05-03,9207
2486,一詮,505,51,454,凱基-永和,2024-05-06,9207
1616,億泰,308,2,306,凱基-永和,2024-05-06,9207
1582,信錦,206,7,199,凱基-永和,2024-05-06,9207
2363,矽統,205,11,194,凱基-永和,2024-05-06,9207
3013,晟銘電,201,34,167,凱基-永和,2024-05-06,9207
4543,萬在,100,0,100,凱基-永和,2024-05-06,9207
2883,凱基金,100,17,83,凱基-永和,2024-05-06,9207
2545,皇翔,80,1,79,凱基-永和,2024-05-06,9207
2801,彰銀,81,2,79,凱基-永和,2024-05-06,9207
00929,復華台灣科技優息,62,3,59,凱基-永和,2024-05-06,9207
2618,長榮航,98,42,56,凱基-永和,2024-05-06,9207
00633L,富邦上証正2,45,0,45,凱基-永和,2024-05-06,9207
6207,雷科,40,0,40,凱基-永和,2024-05-06,9207
8358,金居,38,0,38,凱基-永和,2024-05-06,9207
3680,家登,33,0,33,凱基-永和,2024-05-06,9207
00706L,期元大S＆P日圓正2,32,0,32,凱基-永和,2024-05-06,9207
5483,中美晶,25,0,25,凱基-永和,2024-05-06,9207
6753,龍德造船,26,1,25,凱基-永和,2024-05-06,9207
00637L,元大滬深300正2,22,0,22,凱基-永和,2024-05-06,9207
1217,愛之味,20,0,20,凱基-永和,2024-05-06,9207
1402,遠東新,24,4,20,凱基-永和,2024-05-06,9207
6217,中探針,20,0,20,凱基-永和,2024-05-06,9207
3033,威健,33,14,19,凱基-永和,2024-05-06,9207
00937B,群益ESG投等債20,18,0,18,凱基-永和,2024-05-06,9207
00662,富邦NASDAQ,18,0,18,凱基-永和,2024-05-06,9207
2887,台新金,37,19,18,凱基-永和,2024-05-06,9207
3049,精金,15,0,15,凱基-永和,2024-05-06,9207
00632R,元大台灣50反1,23,10,13,凱基-永和,2024-05-06,9207
2609,陽明,13,1,12,凱基-永和,2024-05-06,9207
2913,農林,12,0,12,凱基-永和,2024-05-06,9207
2449,京元電子,22,11,11,凱基-永和,2024-05-06,9207
2538,基泰,12,1,11,凱基-永和,2024-05-06,9207
1615,大山,10,0,10,凱基-永和,2024-05-06,9207
2327,國巨,10,0,10,凱基-永和,2024-05-06,9207
2359,所羅門,11,1,10,凱基-永和,2024-05-06,9207
8076,伍豐,10,0,10,凱基-永和,2024-05-06,9207
4513,福裕,11,2,9,凱基-永和,2024-05-06,9207
2328,廣宇,8,0,8,凱基-永和,2024-05-06,9207
2025,千興,9,1,8,凱基-永和,2024-05-06,9207
00940,元大台灣價值高息,12,5,7,凱基-永和,2024-05-06,9207
2101,南港,7,0,7,凱基-永和,2024-05-06,9207
2301,光寶科,7,0,7,凱基-永和,2024-05-06,9207
2705,六福,7,0,7,凱基-永和,2024-05-06,9207
9933,中鼎,7,1,6,凱基-永和,2024-05-06,9207
1532,勤美,15,9,6,凱基-永和,2024-05-06,9207
1789,神隆,6,0,6,凱基-永和,2024-05-06,9207
4919,新唐,6,0,6,凱基-永和,2024-05-06,9207
6213,聯茂,6,0,6,凱基-永和,2024-05-06,9207
6284,佳邦,7,1,6,凱基-永和,2024-05-06,9207
1314,中石化,5,0,5,凱基-永和,2024-05-06,9207
8059,凱碩,430,1,429,凱基-永和,2024-05-07,9207
2317,鴻海,479,51,428,凱基-永和,2024-05-07,9207
1608,華榮,401,9,392,凱基-永和,2024-05-07,9207
1618,合機,452,202,250,凱基-永和,2024-05-07,9207
2374,佳能,307,58,249,凱基-永和,2024-05-07,9207
8277,商丞,220,2,218,凱基-永和,2024-05-07,9207
2618,長榮航,139,11,128,凱基-永和,2024-05-07,9207
00878,國泰永續高股息,119,0,119,凱基-永和,2024-05-07,9207
2371,大同,116,18,98,凱基-永和,2024-05-07,9207
2061,風青,88,0,88,凱基-永和,2024-05-07,9207
00929,復華台灣科技優息,73,1,72,凱基-永和,2024-05-07,9207
00940,元大台灣價值高息,64,2,62,凱基-永和,2024-05-07,9207
2465,麗臺,60,0,60,凱基-永和,2024-05-07,9207
00665L,富邦�琤肭磪囓�2,60,10,50,凱基-永和,2024-05-07,9207
3622,洋華,50,0,50,凱基-永和,2024-05-07,9207
3055,蔚華科,40,0,40,凱基-永和,2024-05-07,9207
3287,廣寰科,40,0,40,凱基-永和,2024-05-07,9207
4994,傳奇,35,0,35,凱基-永和,2024-05-07,9207
6535,順藥,35,0,35,凱基-永和,2024-05-07,9207
2392,正崴,34,2,32,凱基-永和,2024-05-07,9207
6150,撼訊,25,0,25,凱基-永和,2024-05-07,9207
2505,國揚,28,4,24,凱基-永和,2024-05-07,9207
00632R,元大台灣50反1,21,0,21,凱基-永和,2024-05-07,9207
6505,台塑化,20,0,20,凱基-永和,2024-05-07,9207
2376,技嘉,31,13,18,凱基-永和,2024-05-07,9207
2838,聯邦銀,18,0,18,凱基-永和,2024-05-07,9207
00936,台新永續高息中小,17,0,17,凱基-永和,2024-05-07,9207
2897,王道銀行,17,0,17,凱基-永和,2024-05-07,9207
2888,新光金,15,1,14,凱基-永和,2024-05-07,9207
2536,宏普,13,0,13,凱基-永和,2024-05-07,9207
5514,三豐,13,0,13,凱基-永和,2024-05-07,9207
2515,中工,18,6,12,凱基-永和,2024-05-07,9207
3324,雙鴻,12,1,11,凱基-永和,2024-05-07,9207
2610,華航,28,18,10,凱基-永和,2024-05-07,9207
0050,元大台灣50,10,0,10,凱基-永和,2024-05-07,9207
2538,基泰,10,1,9,凱基-永和,2024-05-07,9207
2337,旺宏,10,1,9,凱基-永和,2024-05-07,9207
3714,富采,9,0,9,凱基-永和,2024-05-07,9207
4513,福裕,8,0,8,凱基-永和,2024-05-07,9207
8096,擎亞,12,4,8,凱基-永和,2024-05-07,9207
6188,廣明,63,55,8,凱基-永和,2024-05-07,9207
5871,中租-KY,9,2,7,凱基-永和,2024-05-07,9207
2301,光寶科,7,0,7,凱基-永和,2024-05-07,9207
6213,聯茂,11,4,7,凱基-永和,2024-05-07,9207
2344,華邦電,12,6,6,凱基-永和,2024-05-07,9207
3363,上詮,11,5,6,凱基-永和,2024-05-07,9207
4956,光鋐,8,2,6,凱基-永和,2024-05-07,9207
2880,華南金,8,2,6,凱基-永和,2024-05-07,9207
2303,聯電,11,5,6,凱基-永和,2024-05-07,9207
1217,愛之味,5,0,5,凱基-永和,2024-05-07,9207
3032,偉訓,250,10,240,凱基-永和,2024-05-08,9207
5014,建錩,200,0,200,凱基-永和,2024-05-08,9207
8027,鈦昇,100,0,100,凱基-永和,2024-05-08,9207
6265,方土昶,62,0,62,凱基-永和,2024-05-08,9207
2618,長榮航,103,44,59,凱基-永和,2024-05-08,9207
6139,亞翔,50,1,49,凱基-永和,2024-05-08,9207
1475,業旺,42,0,42,凱基-永和,2024-05-08,9207
3231,緯創,41,2,39,凱基-永和,2024-05-08,9207
2324,仁寶,38,1,37,凱基-永和,2024-05-08,9207
6449,鈺邦,30,0,30,凱基-永和,2024-05-08,9207
8163,達方,30,0,30,凱基-永和,2024-05-08,9207
2527,宏璟,29,1,28,凱基-永和,2024-05-08,9207
6223,旺矽,33,5,28,凱基-永和,2024-05-08,9207
2603,長榮,29,3,26,凱基-永和,2024-05-08,9207
3481,群創,26,0,26,凱基-永和,2024-05-08,9207
2359,所羅門,130,109,21,凱基-永和,2024-05-08,9207
00665L,富邦�琤肭磪囓�2,20,0,20,凱基-永和,2024-05-08,9207
3260,威剛,33,14,19,凱基-永和,2024-05-08,9207
6515,穎崴,15,0,15,凱基-永和,2024-05-08,9207
5871,中租-KY,14,0,14,凱基-永和,2024-05-08,9207
00933B,國泰10Y+金融債,13,1,12,凱基-永和,2024-05-08,9207
00632R,元大台灣50反1,11,0,11,凱基-永和,2024-05-08,9207
3034,聯詠,11,1,10,凱基-永和,2024-05-08,9207
00937B,群益ESG投等債20,10,0,10,凱基-永和,2024-05-08,9207
00929,復華台灣科技優息,18,8,10,凱基-永和,2024-05-08,9207
4746,台耀,10,0,10,凱基-永和,2024-05-08,9207
2913,農林,10,0,10,凱基-永和,2024-05-08,9207
6741,91APP*-KY,10,0,10,凱基-永和,2024-05-08,9207
9928,中視,10,0,10,凱基-永和,2024-05-08,9207
1440,南紡,9,0,9,凱基-永和,2024-05-08,9207
006208,富邦台50,9,0,9,凱基-永和,2024-05-08,9207
2486,一詮,38,30,8,凱基-永和,2024-05-08,9207
4933,友輝,8,0,8,凱基-永和,2024-05-08,9207
2338,光罩,12,4,8,凱基-永和,2024-05-08,9207
00940,元大台灣價值高息,13,5,8,凱基-永和,2024-05-08,9207
1609,大亞,12,4,8,凱基-永和,2024-05-08,9207
6117,迎廣,7,0,7,凱基-永和,2024-05-08,9207
6215,和椿,7,0,7,凱基-永和,2024-05-08,9207
2612,中航,108,102,6,凱基-永和,2024-05-08,9207
2605,新興,11,5,6,凱基-永和,2024-05-08,9207
2607,榮運,6,0,6,凱基-永和,2024-05-08,9207
2634,漢翔,7,1,6,凱基-永和,2024-05-08,9207
4543,萬在,7,1,6,凱基-永和,2024-05-08,9207
4580,捷流閥業,6,0,6,凱基-永和,2024-05-08,9207
1589,永冠-KY,5,0,5,凱基-永和,2024-05-08,9207
1721,三晃,5,0,5,凱基-永和,2024-05-08,9207
1805,寶徠,5,0,5,凱基-永和,2024-05-08,9207
3002,歐格,5,0,5,凱基-永和,2024-05-08,9207
4743,合一,5,0,5,凱基-永和,2024-05-08,9207
4956,光鋐,9,4,5,凱基-永和,2024-05-08,9207
3376,新日興,220,0,220,凱基-永和,2024-05-09,9207
3356,奇偶,150,0,150,凱基-永和,2024-05-09,9207
1307,三芳,180,44,136,凱基-永和,2024-05-09,9207
3055,蔚華科,100,0,100,凱基-永和,2024-05-09,9207
00878,國泰永續高股息,64,1,63,凱基-永和,2024-05-09,9207
3564,其陽,52,2,50,凱基-永和,2024-05-09,9207
00946,群益科技高息成長,59,10,49,凱基-永和,2024-05-09,9207
2618,長榮航,61,31,30,凱基-永和,2024-05-09,9207
2834,臺企銀,31,1,30,凱基-永和,2024-05-09,9207
00715L,期街口布蘭特正2,30,1,29,凱基-永和,2024-05-09,9207
00944,野村趨勢動能高息,31,4,27,凱基-永和,2024-05-09,9207
00680L,元大美債20正2,25,0,25,凱基-永和,2024-05-09,9207
3036,文曄,24,1,23,凱基-永和,2024-05-09,9207
2363,矽統,29,9,20,凱基-永和,2024-05-09,9207
2303,聯電,20,0,20,凱基-永和,2024-05-09,9207
2477,美隆電,20,0,20,凱基-永和,2024-05-09,9207
2545,皇翔,20,0,20,凱基-永和,2024-05-09,9207
1402,遠東新,20,1,19,凱基-永和,2024-05-09,9207
2367,燿華,31,12,19,凱基-永和,2024-05-09,9207
2344,華邦電,18,0,18,凱基-永和,2024-05-09,9207
1608,華榮,18,2,16,凱基-永和,2024-05-09,9207
3006,晶豪科,18,2,16,凱基-永和,2024-05-09,9207
2891,中信金,21,6,15,凱基-永和,2024-05-09,9207
00937B,群益ESG投等債20,27,12,15,凱基-永和,2024-05-09,9207
3189,景碩,15,0,15,凱基-永和,2024-05-09,9207
8358,金居,15,0,15,凱基-永和,2024-05-09,9207
00679B,元大美債20年,15,0,15,凱基-永和,2024-05-09,9207
1314,中石化,15,1,14,凱基-永和,2024-05-09,9207
00929,復華台灣科技優息,15,1,14,凱基-永和,2024-05-09,9207
00919,群益台灣精選高息,14,1,13,凱基-永和,2024-05-09,9207
2405,輔信,13,0,13,凱基-永和,2024-05-09,9207
6265,方土昶,13,0,13,凱基-永和,2024-05-09,9207
1609,大亞,15,3,12,凱基-永和,2024-05-09,9207
6005,群益證,12,0,12,凱基-永和,2024-05-09,9207
4967,十銓,15,4,11,凱基-永和,2024-05-09,9207
5531,鄉林,13,2,11,凱基-永和,2024-05-09,9207
6125,廣運,11,0,11,凱基-永和,2024-05-09,9207
3702,大聯大,25,14,11,凱基-永和,2024-05-09,9207
2376,技嘉,10,0,10,凱基-永和,2024-05-09,9207
00940,元大台灣價值高息,10,0,10,凱基-永和,2024-05-09,9207
00941,中信上游半導體,10,0,10,凱基-永和,2024-05-09,9207
5871,中租-KY,10,0,10,凱基-永和,2024-05-09,9207
2352,佳世達,18,9,9,凱基-永和,2024-05-09,9207
2421,建準,10,1,9,凱基-永和,2024-05-09,9207
00720B,元大投資級公司債,8,0,8,凱基-永和,2024-05-09,9207
00936,台新永續高息中小,8,0,8,凱基-永和,2024-05-09,9207
2537,聯上發,12,4,8,凱基-永和,2024-05-09,9207
2605,新興,10,2,8,凱基-永和,2024-05-09,9207
2888,新光金,10,2,8,凱基-永和,2024-05-09,9207
4934,太極,9,1,8,凱基-永和,2024-05-09,9207
2609,陽明,1847,215,1632,凱基-永和,2024-05-10,9207
00929,復華台灣科技優息,121,2,119,凱基-永和,2024-05-10,9207
8358,金居,91,0,91,凱基-永和,2024-05-10,9207
8210,勤誠,71,0,71,凱基-永和,2024-05-10,9207
6290,良維,70,0,70,凱基-永和,2024-05-10,9207
00892,富邦台灣半導體,67,0,67,凱基-永和,2024-05-10,9207
6125,廣運,72,10,62,凱基-永和,2024-05-10,9207
4994,傳奇,50,0,50,凱基-永和,2024-05-10,9207
3006,晶豪科,51,1,50,凱基-永和,2024-05-10,9207
3231,緯創,38,1,37,凱基-永和,2024-05-10,9207
2486,一詮,36,4,32,凱基-永和,2024-05-10,9207
00946,群益科技高息成長,41,10,31,凱基-永和,2024-05-10,9207
2313,華通,30,0,30,凱基-永和,2024-05-10,9207
6265,方土昶,25,0,25,凱基-永和,2024-05-10,9207
2002,中鋼,21,0,21,凱基-永和,2024-05-10,9207
2312,金寶,20,0,20,凱基-永和,2024-05-10,9207
2328,廣宇,20,1,19,凱基-永和,2024-05-10,9207
1101,台泥,20,2,18,凱基-永和,2024-05-10,9207
3346,麗清,16,0,16,凱基-永和,2024-05-10,9207
2374,佳能,18,3,15,凱基-永和,2024-05-10,9207
00919,群益台灣精選高息,16,1,15,凱基-永和,2024-05-10,9207
2376,技嘉,14,2,12,凱基-永和,2024-05-10,9207
00753L,中信中國50正2,11,0,11,凱基-永和,2024-05-10,9207
00632R,元大台灣50反1,21,10,11,凱基-永和,2024-05-10,9207
2354,鴻準,12,1,11,凱基-永和,2024-05-10,9207
3707,漢磊,11,1,10,凱基-永和,2024-05-10,9207
00918,大華優利高填息30,10,0,10,凱基-永和,2024-05-10,9207
00665L,富邦�琤肭磪囓�2,10,0,10,凱基-永和,2024-05-10,9207
1440,南紡,10,0,10,凱基-永和,2024-05-10,9207
2323,中環,10,0,10,凱基-永和,2024-05-10,9207
2362,藍天,11,1,10,凱基-永和,2024-05-10,9207
2515,中工,9,0,9,凱基-永和,2024-05-10,9207
6443,元晶,20,11,9,凱基-永和,2024-05-10,9207
2317,鴻海,20,11,9,凱基-永和,2024-05-10,9207
0050,元大台灣50,10,2,8,凱基-永和,2024-05-10,9207
00933B,國泰10Y+金融債,10,2,8,凱基-永和,2024-05-10,9207
00679B,元大美債20年,11,3,8,凱基-永和,2024-05-10,9207
1504,東元,8,0,8,凱基-永和,2024-05-10,9207
2353,宏��,12,4,8,凱基-永和,2024-05-10,9207
3013,晟銘電,21,13,8,凱基-永和,2024-05-10,9207
8112,至上,9,1,8,凱基-永和,2024-05-10,9207
1718,中纖,7,0,7,凱基-永和,2024-05-10,9207
2409,友達,6,0,6,凱基-永和,2024-05-10,9207
3287,廣寰科,6,0,6,凱基-永和,2024-05-10,9207
3706,神達,7,1,6,凱基-永和,2024-05-10,9207
6215,和椿,14,8,6,凱基-永和,2024-05-10,9207
6283,淳安,6,0,6,凱基-永和,2024-05-10,9207
2363,矽統,15,9,6,凱基-永和,2024-05-10,9207
00671R,富邦NASDAQ反1,5,0,5,凱基-永和,2024-05-10,9207
2368,金像電,10,5,5,凱基-永和,2024-05-10,9207
2374,佳能,582,275,307,凱基-永和,2024-05-13,9207
2330,台積電,158,12,146,凱基-永和,2024-05-13,9207
2915,潤泰全,150,14,136,凱基-永和,2024-05-13,9207
2618,長榮航,157,28,129,凱基-永和,2024-05-13,9207
2731,雄獅,84,3,81,凱基-永和,2024-05-13,9207
00937B,群益ESG投等債20,74,0,74,凱基-永和,2024-05-13,9207
2891,中信金,47,5,42,凱基-永和,2024-05-13,9207
2606,裕民,45,11,34,凱基-永和,2024-05-13,9207
00665L,富邦�琤肭磪囓�2,32,0,32,凱基-永和,2024-05-13,9207
2867,三商壽,33,1,32,凱基-永和,2024-05-13,9207
8234,新漢,30,0,30,凱基-永和,2024-05-13,9207
00919,群益台灣精選高息,33,8,25,凱基-永和,2024-05-13,9207
8358,金居,25,0,25,凱基-永和,2024-05-13,9207
6486,互動,23,0,23,凱基-永和,2024-05-13,9207
8210,勤誠,130,107,23,凱基-永和,2024-05-13,9207
1312,國喬,22,0,22,凱基-永和,2024-05-13,9207
2545,皇翔,20,0,20,凱基-永和,2024-05-13,9207
2615,萬海,34,14,20,凱基-永和,2024-05-13,9207
1503,士電,20,0,20,凱基-永和,2024-05-13,9207
2612,中航,23,5,18,凱基-永和,2024-05-13,9207
2312,金寶,20,4,16,凱基-永和,2024-05-13,9207
2353,宏��,16,0,16,凱基-永和,2024-05-13,9207
6265,方土昶,15,0,15,凱基-永和,2024-05-13,9207
00929,復華台灣科技優息,15,2,13,凱基-永和,2024-05-13,9207
2313,華通,12,0,12,凱基-永和,2024-05-13,9207
5880,合庫金,12,0,12,凱基-永和,2024-05-13,9207
2882,國泰金,21,10,11,凱基-永和,2024-05-13,9207
3013,晟銘電,13,2,11,凱基-永和,2024-05-13,9207
00632R,元大台灣50反1,21,10,11,凱基-永和,2024-05-13,9207
00946,群益科技高息成長,10,0,10,凱基-永和,2024-05-13,9207
00688L,國泰20年美債正2,10,0,10,凱基-永和,2024-05-13,9207
00671R,富邦NASDAQ反1,10,0,10,凱基-永和,2024-05-13,9207
2527,宏璟,10,0,10,凱基-永和,2024-05-13,9207
4157,太景*-KY,10,0,10,凱基-永和,2024-05-13,9207
6799,來頡,10,0,10,凱基-永和,2024-05-13,9207
9902,台火,10,0,10,凱基-永和,2024-05-13,9207
00753L,中信中國50正2,11,2,9,凱基-永和,2024-05-13,9207
2009,第一銅,12,3,9,凱基-永和,2024-05-13,9207
2892,第一金,9,0,9,凱基-永和,2024-05-13,9207
00679B,元大美債20年,8,0,8,凱基-永和,2024-05-13,9207
3706,神達,9,1,8,凱基-永和,2024-05-13,9207
2329,華泰,8,1,7,凱基-永和,2024-05-13,9207
2354,鴻準,7,0,7,凱基-永和,2024-05-13,9207
2367,燿華,9,2,7,凱基-永和,2024-05-13,9207
2883,凱基金,14,7,7,凱基-永和,2024-05-13,9207
3306,鼎天,7,0,7,凱基-永和,2024-05-13,9207
4207,環泰,7,0,7,凱基-永和,2024-05-13,9207
3036,文曄,9,3,6,凱基-永和,2024-05-13,9207
1608,華榮,7,1,6,凱基-永和,2024-05-13,9207
2377,微星,7,1,6,凱基-永和,2024-05-13,9207
2382,廣達,258,8,250,凱基-永和,2024-05-14,9207
2337,旺宏,250,0,250,凱基-永和,2024-05-14,9207
2344,華邦電,250,0,250,凱基-永和,2024-05-14,9207
2362,藍天,201,2,199,凱基-永和,2024-05-14,9207
6125,廣運,194,5,189,凱基-永和,2024-05-14,9207
3230,錦明,103,0,103,凱基-永和,2024-05-14,9207
2615,萬海,545,453,92,凱基-永和,2024-05-14,9207
8054,安國,66,6,60,凱基-永和,2024-05-14,9207
2606,裕民,53,1,52,凱基-永和,2024-05-14,9207
00632R,元大台灣50反1,39,0,39,凱基-永和,2024-05-14,9207
00878,國泰永續高股息,40,5,35,凱基-永和,2024-05-14,9207
00937B,群益ESG投等債20,29,0,29,凱基-永和,2024-05-14,9207
3260,威剛,26,0,26,凱基-永和,2024-05-14,9207
9945,潤泰新,36,12,24,凱基-永和,2024-05-14,9207
2834,臺企銀,20,0,20,凱基-永和,2024-05-14,9207
6265,方土昶,17,0,17,凱基-永和,2024-05-14,9207
6179,亞通,16,0,16,凱基-永和,2024-05-14,9207
2892,第一金,14,0,14,凱基-永和,2024-05-14,9207
00919,群益台灣精選高息,30,16,14,凱基-永和,2024-05-14,9207
1102,亞泥,12,0,12,凱基-永和,2024-05-14,9207
3481,群創,16,5,11,凱基-永和,2024-05-14,9207
2891,中信金,17,6,11,凱基-永和,2024-05-14,9207
00712,復華富時不動產,10,0,10,凱基-永和,2024-05-14,9207
1522,堤維西,34,24,10,凱基-永和,2024-05-14,9207
2406,國碩,10,0,10,凱基-永和,2024-05-14,9207
3520,華盈,10,0,10,凱基-永和,2024-05-14,9207
6164,華興,10,0,10,凱基-永和,2024-05-14,9207
2317,鴻海,31,22,9,凱基-永和,2024-05-14,9207
1314,中石化,10,1,9,凱基-永和,2024-05-14,9207
5009,榮剛,8,0,8,凱基-永和,2024-05-14,9207
1714,和桐,10,2,8,凱基-永和,2024-05-14,9207
9904,寶成,8,1,7,凱基-永和,2024-05-14,9207
5534,長虹,24,18,6,凱基-永和,2024-05-14,9207
2605,新興,15,9,6,凱基-永和,2024-05-14,9207
6016,康和證,6,0,6,凱基-永和,2024-05-14,9207
6229,研通,6,0,6,凱基-永和,2024-05-14,9207
00932,兆豐永續高息等權,5,0,5,凱基-永和,2024-05-14,9207
00724B,群益投資級金融債,5,0,5,凱基-永和,2024-05-14,9207
1722,台肥,5,0,5,凱基-永和,2024-05-14,9207
2208,台船,5,0,5,凱基-永和,2024-05-14,9207
3287,廣寰科,5,0,5,凱基-永和,2024-05-14,9207
6120,達運,5,0,5,凱基-永和,2024-05-14,9207
6605,帝寶,5,0,5,凱基-永和,2024-05-14,9207
2884,玉山金,4,0,4,凱基-永和,2024-05-14,9207
00753L,中信中國50正2,4,0,4,凱基-永和,2024-05-14,9207
2890,永豐金,4,0,4,凱基-永和,2024-05-14,9207
3033,威健,4,0,4,凱基-永和,2024-05-14,9207
5392,能率,8,4,4,凱基-永和,2024-05-14,9207
6237,驊訊,4,0,4,凱基-永和,2024-05-14,9207
6435,大中,4,0,4,凱基-永和,2024-05-14,9207
3047,訊舟,503,13,490,凱基-永和,2024-05-15,9207
2374,佳能,606,312,294,凱基-永和,2024-05-15,9207
9945,潤泰新,458,233,225,凱基-永和,2024-05-15,9207
8096,擎亞,217,13,204,凱基-永和,2024-05-15,9207
2359,所羅門,202,17,185,凱基-永和,2024-05-15,9207
3689,湧德,190,41,149,凱基-永和,2024-05-15,9207
6215,和椿,244,127,117,凱基-永和,2024-05-15,9207
8210,勤誠,107,3,104,凱基-永和,2024-05-15,9207
6207,雷科,102,1,101,凱基-永和,2024-05-15,9207
2365,昆盈,101,6,95,凱基-永和,2024-05-15,9207
3055,蔚華科,68,0,68,凱基-永和,2024-05-15,9207
2367,燿華,134,70,64,凱基-永和,2024-05-15,9207
2348,海悅,59,0,59,凱基-永和,2024-05-15,9207
6265,方土昶,60,2,58,凱基-永和,2024-05-15,9207
2467,志聖,50,0,50,凱基-永和,2024-05-15,9207
00632R,元大台灣50反1,53,10,43,凱基-永和,2024-05-15,9207
00940,元大台灣價值高息,43,3,40,凱基-永和,2024-05-15,9207
2356,英業達,40,11,29,凱基-永和,2024-05-15,9207
8996,高力,29,0,29,凱基-永和,2024-05-15,9207
3008,大立光,23,0,23,凱基-永和,2024-05-15,9207
6271,同欣電,25,2,23,凱基-永和,2024-05-15,9207
00937B,群益ESG投等債20,24,2,22,凱基-永和,2024-05-15,9207
00665L,富邦�琤肭磪囓�2,20,0,20,凱基-永和,2024-05-15,9207
4532,瑞智,20,0,20,凱基-永和,2024-05-15,9207
1402,遠東新,20,1,19,凱基-永和,2024-05-15,9207
5351,鈺創,20,1,19,凱基-永和,2024-05-15,9207
2486,一詮,54,37,17,凱基-永和,2024-05-15,9207
6770,力積電,17,0,17,凱基-永和,2024-05-15,9207
00882,中信中國高股息,14,0,14,凱基-永和,2024-05-15,9207
3715,定穎投控,13,1,12,凱基-永和,2024-05-15,9207
6223,旺矽,15,3,12,凱基-永和,2024-05-15,9207
2603,長榮,22,11,11,凱基-永和,2024-05-15,9207
3013,晟銘電,12,1,11,凱基-永和,2024-05-15,9207
00919,群益台灣精選高息,18,8,10,凱基-永和,2024-05-15,9207
00932,兆豐永續高息等權,10,0,10,凱基-永和,2024-05-15,9207
1313,聯成,10,0,10,凱基-永和,2024-05-15,9207
2392,正崴,10,0,10,凱基-永和,2024-05-15,9207
3207,耀勝,10,0,10,凱基-永和,2024-05-15,9207
5009,榮剛,10,0,10,凱基-永和,2024-05-15,9207
5488,松普,10,0,10,凱基-永和,2024-05-15,9207
6176,瑞儀,11,1,10,凱基-永和,2024-05-15,9207
6206,飛捷,10,0,10,凱基-永和,2024-05-15,9207
6548,長科*,10,0,10,凱基-永和,2024-05-15,9207
2634,漢翔,11,1,10,凱基-永和,2024-05-15,9207
1101,台泥,13,4,9,凱基-永和,2024-05-15,9207
2855,統一證,9,0,9,凱基-永和,2024-05-15,9207
3202,樺晟,10,1,9,凱基-永和,2024-05-15,9207
5269,祥碩,9,0,9,凱基-永和,2024-05-15,9207
2641,正德,8,0,8,凱基-永和,2024-05-15,9207
2801,彰銀,8,0,8,凱基-永和,2024-05-15,9207
2002,中鋼,499,35,464,凱基-永和,2024-05-16,9207
1101,台泥,148,14,134,凱基-永和,2024-05-16,9207
6207,雷科,101,0,101,凱基-永和,2024-05-16,9207
00665L,富邦�琤肭磪囓�2,100,0,100,凱基-永和,2024-05-16,9207
9105,泰金寶-DR,100,0,100,凱基-永和,2024-05-16,9207
2374,佳能,752,657,95,凱基-永和,2024-05-16,9207
2382,廣達,90,5,85,凱基-永和,2024-05-16,9207
8358,金居,77,10,67,凱基-永和,2024-05-16,9207
2301,光寶科,68,4,64,凱基-永和,2024-05-16,9207
00892,富邦台灣半導體,62,0,62,凱基-永和,2024-05-16,9207
6727,亞泰金屬,60,0,60,凱基-永和,2024-05-16,9207
3006,晶豪科,51,1,50,凱基-永和,2024-05-16,9207
3362,先進光,50,1,49,凱基-永和,2024-05-16,9207
00632R,元大台灣50反1,63,20,43,凱基-永和,2024-05-16,9207
3055,蔚華科,62,20,42,凱基-永和,2024-05-16,9207
2460,建通,41,1,40,凱基-永和,2024-05-16,9207
3564,其陽,40,0,40,凱基-永和,2024-05-16,9207
00929,復華台灣科技優息,44,4,40,凱基-永和,2024-05-16,9207
3260,威剛,40,4,36,凱基-永和,2024-05-16,9207
2363,矽統,63,27,36,凱基-永和,2024-05-16,9207
8463,潤泰材,130,98,32,凱基-永和,2024-05-16,9207
2545,皇翔,30,0,30,凱基-永和,2024-05-16,9207
2467,志聖,317,290,27,凱基-永和,2024-05-16,9207
5488,松普,27,0,27,凱基-永和,2024-05-16,9207
3231,緯創,29,4,25,凱基-永和,2024-05-16,9207
2883,凱基金,34,9,25,凱基-永和,2024-05-16,9207
2641,正德,26,2,24,凱基-永和,2024-05-16,9207
5351,鈺創,29,5,24,凱基-永和,2024-05-16,9207
00850,元大臺灣ESG永續,23,0,23,凱基-永和,2024-05-16,9207
2812,台中銀,22,0,22,凱基-永和,2024-05-16,9207
8070,長華*,20,0,20,凱基-永和,2024-05-16,9207
2356,英業達,24,6,18,凱基-永和,2024-05-16,9207
00680L,元大美債20正2,55,40,15,凱基-永和,2024-05-16,9207
6265,方土昶,15,0,15,凱基-永和,2024-05-16,9207
3702,大聯大,15,0,15,凱基-永和,2024-05-16,9207
00878,國泰永續高股息,22,7,15,凱基-永和,2024-05-16,9207
2009,第一銅,16,2,14,凱基-永和,2024-05-16,9207
6415,矽力*-KY,17,3,14,凱基-永和,2024-05-16,9207
00679B,元大美債20年,12,0,12,凱基-永和,2024-05-16,9207
2501,國建,15,3,12,凱基-永和,2024-05-16,9207
3008,大立光,10,0,10,凱基-永和,2024-05-16,9207
00712,復華富時不動產,10,0,10,凱基-永和,2024-05-16,9207
1611,中電,10,0,10,凱基-永和,2024-05-16,9207
1709,和益,10,0,10,凱基-永和,2024-05-16,9207
2913,農林,10,0,10,凱基-永和,2024-05-16,9207
2101,南港,12,2,10,凱基-永和,2024-05-16,9207
00940,元大台灣價值高息,25,17,8,凱基-永和,2024-05-16,9207
2352,佳世達,8,0,8,凱基-永和,2024-05-16,9207
4562,穎漢,8,0,8,凱基-永和,2024-05-16,9207
6223,旺矽,8,0,8,凱基-永和,2024-05-16,9207
1725,元禎,151,0,151,凱基-永和,2024-05-17,9207
1101,台泥,121,2,119,凱基-永和,2024-05-17,9207
00929,復華台灣科技優息,118,2,116,凱基-永和,2024-05-17,9207
3686,達能,100,1,99,凱基-永和,2024-05-17,9207
00940,元大台灣價值高息,115,24,91,凱基-永和,2024-05-17,9207
6125,廣運,72,7,65,凱基-永和,2024-05-17,9207
8089,康全電訊,65,5,60,凱基-永和,2024-05-17,9207
3294,英濟,60,10,50,凱基-永和,2024-05-17,9207
00919,群益台灣精選高息,40,1,39,凱基-永和,2024-05-17,9207
3055,蔚華科,38,0,38,凱基-永和,2024-05-17,9207
5488,松普,35,0,35,凱基-永和,2024-05-17,9207
6230,尼得科超眾,75,45,30,凱基-永和,2024-05-17,9207
2882,國泰金,35,8,27,凱基-永和,2024-05-17,9207
3049,精金,27,0,27,凱基-永和,2024-05-17,9207
2312,金寶,26,0,26,凱基-永和,2024-05-17,9207
3024,憶聲,25,0,25,凱基-永和,2024-05-17,9207
3047,訊舟,32,9,23,凱基-永和,2024-05-17,9207
00878,國泰永續高股息,30,7,23,凱基-永和,2024-05-17,9207
1589,永冠-KY,21,0,21,凱基-永和,2024-05-17,9207
2025,千興,20,0,20,凱基-永和,2024-05-17,9207
2329,華泰,20,0,20,凱基-永和,2024-05-17,9207
2359,所羅門,46,26,20,凱基-永和,2024-05-17,9207
2492,華新科,20,0,20,凱基-永和,2024-05-17,9207
6179,亞通,20,0,20,凱基-永和,2024-05-17,9207
8210,勤誠,20,0,20,凱基-永和,2024-05-17,9207
3707,漢磊,20,1,19,凱基-永和,2024-05-17,9207
9928,中視,20,1,19,凱基-永和,2024-05-17,9207
00753L,中信中國50正2,17,0,17,凱基-永和,2024-05-17,9207
6117,迎廣,15,1,14,凱基-永和,2024-05-17,9207
00944,野村趨勢動能高息,13,0,13,凱基-永和,2024-05-17,9207
2317,鴻海,26,15,11,凱基-永和,2024-05-17,9207
3231,緯創,12,1,11,凱基-永和,2024-05-17,9207
8936,國統,13,2,11,凱基-永和,2024-05-17,9207
3706,神達,12,2,10,凱基-永和,2024-05-17,9207
2885,元大金,10,0,10,凱基-永和,2024-05-17,9207
00850,元大臺灣ESG永續,10,0,10,凱基-永和,2024-05-17,9207
2371,大同,10,0,10,凱基-永和,2024-05-17,9207
2465,麗臺,10,0,10,凱基-永和,2024-05-17,9207
2597,潤弘,10,0,10,凱基-永和,2024-05-17,9207
3630,新鉅科,10,0,10,凱基-永和,2024-05-17,9207
3694,海華,11,1,10,凱基-永和,2024-05-17,9207
6477,安集,10,0,10,凱基-永和,2024-05-17,9207
4927,泰鼎-KY,9,0,9,凱基-永和,2024-05-17,9207
8039,台虹,9,0,9,凱基-永和,2024-05-17,9207
00927,群益半導體收益,10,2,8,凱基-永和,2024-05-17,9207
2641,正德,8,0,8,凱基-永和,2024-05-17,9207
5469,瀚宇博,10,2,8,凱基-永和,2024-05-17,9207
2489,瑞軒,152,144,8,凱基-永和,2024-05-17,9207
2464,盟立,21,14,7,凱基-永和,2024-05-17,9207
2301,光寶科,8,1,7,凱基-永和,2024-05-17,9207
6125,廣運,569,395,174,凱基-永和,2024-05-20,9207
2610,華航,288,121,167,凱基-永和,2024-05-20,9207
2009,第一銅,152,9,143,凱基-永和,2024-05-20,9207
3535,晶彩科,101,8,93,凱基-永和,2024-05-20,9207
2618,長榮航,184,130,54,凱基-永和,2024-05-20,9207
4533,協易機,41,7,34,凱基-永和,2024-05-20,9207
5009,榮剛,44,12,32,凱基-永和,2024-05-20,9207
00929,復華台灣科技優息,32,1,31,凱基-永和,2024-05-20,9207
00882,中信中國高股息,32,2,30,凱基-永和,2024-05-20,9207
2897,王道銀行,30,0,30,凱基-永和,2024-05-20,9207
2887,台新金,30,0,30,凱基-永和,2024-05-20,9207
2317,鴻海,31,3,28,凱基-永和,2024-05-20,9207
00633L,富邦上証正2,27,1,26,凱基-永和,2024-05-20,9207
3231,緯創,33,12,21,凱基-永和,2024-05-20,9207
6139,亞翔,25,4,21,凱基-永和,2024-05-20,9207
00679B,元大美債20年,21,0,21,凱基-永和,2024-05-20,9207
1319,東陽,22,1,21,凱基-永和,2024-05-20,9207
2545,皇翔,20,0,20,凱基-永和,2024-05-20,9207
3645,達邁,20,0,20,凱基-永和,2024-05-20,9207
2383,台光電,21,5,16,凱基-永和,2024-05-20,9207
2486,一詮,17,1,16,凱基-永和,2024-05-20,9207
3013,晟銘電,18,2,16,凱基-永和,2024-05-20,9207
5488,松普,15,0,15,凱基-永和,2024-05-20,9207
2363,矽統,25,11,14,凱基-永和,2024-05-20,9207
3033,威健,16,3,13,凱基-永和,2024-05-20,9207
1789,神隆,12,0,12,凱基-永和,2024-05-20,9207
1905,華紙,12,0,12,凱基-永和,2024-05-20,9207
2641,正德,12,0,12,凱基-永和,2024-05-20,9207
5392,能率,12,0,12,凱基-永和,2024-05-20,9207
00919,群益台灣精選高息,12,1,11,凱基-永和,2024-05-20,9207
1442,名軒,12,1,11,凱基-永和,2024-05-20,9207
1609,大亞,17,6,11,凱基-永和,2024-05-20,9207
2356,英業達,32,21,11,凱基-永和,2024-05-20,9207
3260,威剛,15,5,10,凱基-永和,2024-05-20,9207
1742,台蠟,10,0,10,凱基-永和,2024-05-20,9207
2497,怡利電,10,0,10,凱基-永和,2024-05-20,9207
9902,台火,10,0,10,凱基-永和,2024-05-20,9207
00878,國泰永續高股息,21,12,9,凱基-永和,2024-05-20,9207
00937B,群益ESG投等債20,11,2,9,凱基-永和,2024-05-20,9207
2312,金寶,26,17,9,凱基-永和,2024-05-20,9207
2605,新興,15,6,9,凱基-永和,2024-05-20,9207
00676R,富邦臺灣加權反1,8,0,8,凱基-永和,2024-05-20,9207
2906,高林,8,0,8,凱基-永和,2024-05-20,9207
2464,盟立,10,2,8,凱基-永和,2024-05-20,9207
2884,玉山金,25,18,7,凱基-永和,2024-05-20,9207
1608,華榮,15,8,7,凱基-永和,2024-05-20,9207
2030,彰源,7,0,7,凱基-永和,2024-05-20,9207
6288,聯嘉,8,1,7,凱基-永和,2024-05-20,9207
2867,三商壽,16,9,7,凱基-永和,2024-05-20,9207
00751B,元大AAA至A公司債,6,0,6,凱基-永和,2024-05-20,9207
6125,廣運,561,307,254,凱基-永和,2024-05-21,9207
3013,晟銘電,728,537,191,凱基-永和,2024-05-21,9207
2464,盟立,210,26,184,凱基-永和,2024-05-21,9207
2812,台中銀,160,0,160,凱基-永和,2024-05-21,9207
6117,迎廣,111,1,110,凱基-永和,2024-05-21,9207
6207,雷科,209,103,106,凱基-永和,2024-05-21,9207
2354,鴻準,108,8,100,凱基-永和,2024-05-21,9207
3481,群創,100,2,98,凱基-永和,2024-05-21,9207
1752,南光,80,0,80,凱基-永和,2024-05-21,9207
00665L,富邦�琤肭磪囓�2,70,4,66,凱基-永和,2024-05-21,9207
2367,燿華,414,364,50,凱基-永和,2024-05-21,9207
2488,漢平,40,0,40,凱基-永和,2024-05-21,9207
6584,南俊國際,40,0,40,凱基-永和,2024-05-21,9207
00944,野村趨勢動能高息,33,0,33,凱基-永和,2024-05-21,9207
6579,研揚,33,1,32,凱基-永和,2024-05-21,9207
2331,精英,30,1,29,凱基-永和,2024-05-21,9207
8064,東捷,30,2,28,凱基-永和,2024-05-21,9207
00915,凱基優選高股息30,24,0,24,凱基-永和,2024-05-21,9207
2359,所羅門,41,17,24,凱基-永和,2024-05-21,9207
2363,矽統,36,13,23,凱基-永和,2024-05-21,9207
2883,凱基金,22,0,22,凱基-永和,2024-05-21,9207
6757,台灣虎航,19,0,19,凱基-永和,2024-05-21,9207
1603,華電,15,0,15,凱基-永和,2024-05-21,9207
00882,中信中國高股息,15,2,13,凱基-永和,2024-05-21,9207
2891,中信金,15,3,12,凱基-永和,2024-05-21,9207
6573,虹揚-KY,12,0,12,凱基-永和,2024-05-21,9207
00676R,富邦臺灣加權反1,10,0,10,凱基-永和,2024-05-21,9207
2030,彰源,10,0,10,凱基-永和,2024-05-21,9207
3037,欣興,10,0,10,凱基-永和,2024-05-21,9207
3062,建漢,10,0,10,凱基-永和,2024-05-21,9207
6122,擎邦,10,0,10,凱基-永和,2024-05-21,9207
6129,普誠,10,0,10,凱基-永和,2024-05-21,9207
2317,鴻海,11,2,9,凱基-永和,2024-05-21,9207
00919,群益台灣精選高息,8,0,8,凱基-永和,2024-05-21,9207
2851,中再保,8,0,8,凱基-永和,2024-05-21,9207
2888,新光金,11,3,8,凱基-永和,2024-05-21,9207
2890,永豐金,8,0,8,凱基-永和,2024-05-21,9207
6109,亞元,8,0,8,凱基-永和,2024-05-21,9207
6230,尼得科超眾,30,22,8,凱基-永和,2024-05-21,9207
1560,中砂,10,3,7,凱基-永和,2024-05-21,9207
1605,華新,24,17,7,凱基-永和,2024-05-21,9207
2515,中工,9,2,7,凱基-永和,2024-05-21,9207
3036,文曄,7,0,7,凱基-永和,2024-05-21,9207
3702,大聯大,7,0,7,凱基-永和,2024-05-21,9207
9940,信義,16,9,7,凱基-永和,2024-05-21,9207
00936,台新永續高息中小,6,0,6,凱基-永和,2024-05-21,9207
3264,欣銓,6,0,6,凱基-永和,2024-05-21,9207
00933B,國泰10Y+金融債,5,0,5,凱基-永和,2024-05-21,9207
00940,元大台灣價值高息,10,5,5,凱基-永和,2024-05-21,9207
00680L,元大美債20正2,5,0,5,凱基-永和,2024-05-21,9207
2353,宏��,1028,577,451,凱基-永和,2024-05-22,9207
2453,凌群,601,302,299,凱基-永和,2024-05-22,9207
2464,盟立,518,309,209,凱基-永和,2024-05-22,9207
5443,均豪,201,7,194,凱基-永和,2024-05-22,9207
2812,台中銀,140,0,140,凱基-永和,2024-05-22,9207
4111,濟生,145,10,135,凱基-永和,2024-05-22,9207
00937B,群益ESG投等債20,133,16,117,凱基-永和,2024-05-22,9207
3363,上詮,200,100,100,凱基-永和,2024-05-22,9207
8092,建暐,100,0,100,凱基-永和,2024-05-22,9207
5371,中光電,107,13,94,凱基-永和,2024-05-22,9207
00918,大華優利高填息30,90,1,89,凱基-永和,2024-05-22,9207
2330,台積電,86,6,80,凱基-永和,2024-05-22,9207
2618,長榮航,60,2,58,凱基-永和,2024-05-22,9207
2488,漢平,50,0,50,凱基-永和,2024-05-22,9207
5251,天鉞電,50,0,50,凱基-永和,2024-05-22,9207
00632R,元大台灣50反1,47,0,47,凱基-永和,2024-05-22,9207
5488,松普,45,0,45,凱基-永和,2024-05-22,9207
2883,凱基金,46,4,42,凱基-永和,2024-05-22,9207
4979,華星光,40,0,40,凱基-永和,2024-05-22,9207
2002,中鋼,34,0,34,凱基-永和,2024-05-22,9207
2347,聯強,32,0,32,凱基-永和,2024-05-22,9207
6526,達發,30,1,29,凱基-永和,2024-05-22,9207
2610,華航,30,2,28,凱基-永和,2024-05-22,9207
3036,文曄,29,2,27,凱基-永和,2024-05-22,9207
6265,方土昶,25,0,25,凱基-永和,2024-05-22,9207
2367,燿華,31,9,22,凱基-永和,2024-05-22,9207
2884,玉山金,20,0,20,凱基-永和,2024-05-22,9207
00920,富邦ESG綠色電力,20,0,20,凱基-永和,2024-05-22,9207
3663,鑫科,20,0,20,凱基-永和,2024-05-22,9207
4967,十銓,18,0,18,凱基-永和,2024-05-22,9207
00939,統一台灣高息動能,17,0,17,凱基-永和,2024-05-22,9207
5351,鈺創,20,3,17,凱基-永和,2024-05-22,9207
4526,東台,18,3,15,凱基-永和,2024-05-22,9207
00940,元大台灣價值高息,25,11,14,凱基-永和,2024-05-22,9207
2489,瑞軒,17,4,13,凱基-永和,2024-05-22,9207
8096,擎亞,13,0,13,凱基-永和,2024-05-22,9207
2887,台新金,12,0,12,凱基-永和,2024-05-22,9207
2891,中信金,12,0,12,凱基-永和,2024-05-22,9207
00885,富邦越南,11,0,11,凱基-永和,2024-05-22,9207
6231,系微,12,1,11,凱基-永和,2024-05-22,9207
2603,長榮,15,5,10,凱基-永和,2024-05-22,9207
00637L,元大滬深300正2,10,0,10,凱基-永和,2024-05-22,9207
2903,遠百,10,0,10,凱基-永和,2024-05-22,9207
3044,健鼎,10,0,10,凱基-永和,2024-05-22,9207
00944,野村趨勢動能高息,7,0,7,凱基-永和,2024-05-22,9207
1722,台肥,7,0,7,凱基-永和,2024-05-22,9207
2331,精英,18,11,7,凱基-永和,2024-05-22,9207
2429,銘旺科,7,0,7,凱基-永和,2024-05-22,9207
3060,銘異,13,6,7,凱基-永和,2024-05-22,9207
6139,亞翔,7,0,7,凱基-永和,2024-05-22,9207
00665L,富邦�琤肭磪囓�2,302,0,302,凱基-永和,2024-05-23,9207
2486,一詮,346,51,295,凱基-永和,2024-05-23,9207
2354,鴻準,519,237,282,凱基-永和,2024-05-23,9207
00632R,元大台灣50反1,170,10,160,凱基-永和,2024-05-23,9207
6770,力積電,100,0,100,凱基-永和,2024-05-23,9207
00937B,群益ESG投等債20,70,2,68,凱基-永和,2024-05-23,9207
2916,滿心,60,0,60,凱基-永和,2024-05-23,9207
2613,中櫃,60,3,57,凱基-永和,2024-05-23,9207
3055,蔚華科,78,22,56,凱基-永和,2024-05-23,9207
00857B,永豐20年美公債,50,0,50,凱基-永和,2024-05-23,9207
00918,大華優利高填息30,50,0,50,凱基-永和,2024-05-23,9207
6285,啟��,100,56,44,凱基-永和,2024-05-23,9207
2618,長榮航,68,32,36,凱基-永和,2024-05-23,9207
00662,富邦NASDAQ,35,0,35,凱基-永和,2024-05-23,9207
6188,廣明,57,24,33,凱基-永和,2024-05-23,9207
00940,元大台灣價值高息,38,8,30,凱基-永和,2024-05-23,9207
2897,王道銀行,30,0,30,凱基-永和,2024-05-23,9207
2337,旺宏,28,0,28,凱基-永和,2024-05-23,9207
2002,中鋼,21,0,21,凱基-永和,2024-05-23,9207
2324,仁寶,26,5,21,凱基-永和,2024-05-23,9207
2834,臺企銀,21,0,21,凱基-永和,2024-05-23,9207
1312,國喬,20,0,20,凱基-永和,2024-05-23,9207
6265,方土昶,20,0,20,凱基-永和,2024-05-23,9207
5469,瀚宇博,20,1,19,凱基-永和,2024-05-23,9207
00946,群益科技高息成長,24,6,18,凱基-永和,2024-05-23,9207
1536,和大,26,9,17,凱基-永和,2024-05-23,9207
2392,正崴,24,7,17,凱基-永和,2024-05-23,9207
00915,凱基優選高股息30,16,0,16,凱基-永和,2024-05-23,9207
5498,凱崴,16,0,16,凱基-永和,2024-05-23,9207
2376,技嘉,17,2,15,凱基-永和,2024-05-23,9207
2883,凱基金,37,22,15,凱基-永和,2024-05-23,9207
3047,訊舟,25,10,15,凱基-永和,2024-05-23,9207
00637L,元大滬深300正2,14,1,13,凱基-永和,2024-05-23,9207
00679B,元大美債20年,12,0,12,凱基-永和,2024-05-23,9207
2356,英業達,28,16,12,凱基-永和,2024-05-23,9207
6223,旺矽,12,1,11,凱基-永和,2024-05-23,9207
9940,信義,11,0,11,凱基-永和,2024-05-23,9207
0056,元大高股息,15,4,11,凱基-永和,2024-05-23,9207
5871,中租-KY,10,0,10,凱基-永和,2024-05-23,9207
2368,金像電,11,1,10,凱基-永和,2024-05-23,9207
1560,中砂,11,1,10,凱基-永和,2024-05-23,9207
2313,華通,11,1,10,凱基-永和,2024-05-23,9207
2867,三商壽,10,0,10,凱基-永和,2024-05-23,9207
2880,華南金,10,0,10,凱基-永和,2024-05-23,9207
2885,元大金,10,0,10,凱基-永和,2024-05-23,9207
6176,瑞儀,10,0,10,凱基-永和,2024-05-23,9207
6207,雷科,10,0,10,凱基-永和,2024-05-23,9207
3483,力致,9,0,9,凱基-永和,2024-05-23,9207
2014,中鴻,9,0,9,凱基-永和,2024-05-23,9207
3231,緯創,18,9,9,凱基-永和,2024-05-23,9207
2489,瑞軒,805,116,689,凱基-永和,2024-05-24,9207
3047,訊舟,623,322,301,凱基-永和,2024-05-24,9207
00937B,群益ESG投等債20,217,0,217,凱基-永和,2024-05-24,9207
2301,光寶科,208,16,192,凱基-永和,2024-05-24,9207
5234,達興材料,66,0,66,凱基-永和,2024-05-24,9207
2303,聯電,61,3,58,凱基-永和,2024-05-24,9207
3055,蔚華科,100,50,50,凱基-永和,2024-05-24,9207
8210,勤誠,50,1,49,凱基-永和,2024-05-24,9207
2891,中信金,46,0,46,凱基-永和,2024-05-24,9207
2867,三商壽,45,0,45,凱基-永和,2024-05-24,9207
9105,泰金寶-DR,50,13,37,凱基-永和,2024-05-24,9207
2609,陽明,37,3,34,凱基-永和,2024-05-24,9207
3563,牧德,30,0,30,凱基-永和,2024-05-24,9207
2354,鴻準,30,1,29,凱基-永和,2024-05-24,9207
00940,元大台灣價值高息,26,1,25,凱基-永和,2024-05-24,9207
2885,元大金,22,0,22,凱基-永和,2024-05-24,9207
6770,力積電,22,0,22,凱基-永和,2024-05-24,9207
2352,佳世達,20,0,20,凱基-永和,2024-05-24,9207
4967,十銓,20,2,18,凱基-永和,2024-05-24,9207
8996,高力,21,3,18,凱基-永和,2024-05-24,9207
4760,勤凱,16,0,16,凱基-永和,2024-05-24,9207
2313,華通,14,1,13,凱基-永和,2024-05-24,9207
2916,滿心,13,0,13,凱基-永和,2024-05-24,9207
2610,華航,15,3,12,凱基-永和,2024-05-24,9207
2323,中環,12,0,12,凱基-永和,2024-05-24,9207
8028,昇陽半導體,13,1,12,凱基-永和,2024-05-24,9207
9945,潤泰新,11,0,11,凱基-永和,2024-05-24,9207
2002,中鋼,11,0,11,凱基-永和,2024-05-24,9207
2605,新興,12,1,11,凱基-永和,2024-05-24,9207
00929,復華台灣科技優息,20,10,10,凱基-永和,2024-05-24,9207
5009,榮剛,10,0,10,凱基-永和,2024-05-24,9207
3002,歐格,10,0,10,凱基-永和,2024-05-24,9207
3311,閎暉,10,0,10,凱基-永和,2024-05-24,9207
00919,群益台灣精選高息,11,2,9,凱基-永和,2024-05-24,9207
2634,漢翔,18,9,9,凱基-永和,2024-05-24,9207
2892,第一金,10,1,9,凱基-永和,2024-05-24,9207
3202,樺晟,10,1,9,凱基-永和,2024-05-24,9207
3715,定穎投控,10,1,9,凱基-永和,2024-05-24,9207
6190,萬泰科,16,7,9,凱基-永和,2024-05-24,9207
00878,國泰永續高股息,8,0,8,凱基-永和,2024-05-24,9207
00679B,元大美債20年,8,0,8,凱基-永和,2024-05-24,9207
2409,友達,8,0,8,凱基-永和,2024-05-24,9207
2611,志信,9,1,8,凱基-永和,2024-05-24,9207
3694,海華,11,3,8,凱基-永和,2024-05-24,9207
1301,台塑,7,0,7,凱基-永和,2024-05-24,9207
2324,仁寶,7,0,7,凱基-永和,2024-05-24,9207
2337,旺宏,6,0,6,凱基-永和,2024-05-24,9207
00933B,國泰10Y+金融債,6,0,6,凱基-永和,2024-05-24,9207
1217,愛之味,6,0,6,凱基-永和,2024-05-24,9207
2367,燿華,9,3,6,凱基-永和,2024-05-24,9207
8064,東捷,505,2,503,凱基-永和,2024-05-27,9207
4979,華星光,311,3,308,凱基-永和,2024-05-27,9207
2464,盟立,932,668,264,凱基-永和,2024-05-27,9207
6207,雷科,120,0,120,凱基-永和,2024-05-27,9207
00937B,群益ESG投等債20,119,0,119,凱基-永和,2024-05-27,9207
00933B,國泰10Y+金融債,112,2,110,凱基-永和,2024-05-27,9207
8059,凱碩,100,0,100,凱基-永和,2024-05-27,9207
2465,麗臺,80,0,80,凱基-永和,2024-05-27,9207
2363,矽統,155,80,75,凱基-永和,2024-05-27,9207
2454,聯發科,75,2,73,凱基-永和,2024-05-27,9207
6531,愛普*,71,1,70,凱基-永和,2024-05-27,9207
2618,長榮航,65,0,65,凱基-永和,2024-05-27,9207
00770,國泰北美科技,60,2,58,凱基-永和,2024-05-27,9207
6449,鈺邦,56,1,55,凱基-永和,2024-05-27,9207
2353,宏��,63,20,43,凱基-永和,2024-05-27,9207
6197,佳必琪,42,2,40,凱基-永和,2024-05-27,9207
2338,光罩,38,0,38,凱基-永和,2024-05-27,9207
00632R,元大台灣50反1,54,18,36,凱基-永和,2024-05-27,9207
5234,達興材料,36,0,36,凱基-永和,2024-05-27,9207
00946,群益科技高息成長,35,2,33,凱基-永和,2024-05-27,9207
2401,凌陽,35,4,31,凱基-永和,2024-05-27,9207
2367,燿華,34,4,30,凱基-永和,2024-05-27,9207
5371,中光電,32,5,27,凱基-永和,2024-05-27,9207
2886,兆豐金,27,0,27,凱基-永和,2024-05-27,9207
5351,鈺創,31,4,27,凱基-永和,2024-05-27,9207
00720B,元大投資級公司債,26,0,26,凱基-永和,2024-05-27,9207
3033,威健,28,2,26,凱基-永和,2024-05-27,9207
3311,閎暉,24,0,24,凱基-永和,2024-05-27,9207
5498,凱崴,25,5,20,凱基-永和,2024-05-27,9207
2002,中鋼,25,5,20,凱基-永和,2024-05-27,9207
3419,譁裕,20,0,20,凱基-永和,2024-05-27,9207
6270,倍微,20,0,20,凱基-永和,2024-05-27,9207
2317,鴻海,42,25,17,凱基-永和,2024-05-27,9207
2883,凱基金,17,1,16,凱基-永和,2024-05-27,9207
1815,富喬,20,5,15,凱基-永和,2024-05-27,9207
2887,台新金,15,0,15,凱基-永和,2024-05-27,9207
2616,山隆,13,1,12,凱基-永和,2024-05-27,9207
6239,力成,14,2,12,凱基-永和,2024-05-27,9207
2609,陽明,32,20,12,凱基-永和,2024-05-27,9207
00665L,富邦�琤肭磪囓�2,10,0,10,凱基-永和,2024-05-27,9207
00753L,中信中國50正2,14,4,10,凱基-永和,2024-05-27,9207
2328,廣宇,10,0,10,凱基-永和,2024-05-27,9207
2369,菱生,13,3,10,凱基-永和,2024-05-27,9207
2501,國建,15,5,10,凱基-永和,2024-05-27,9207
3372,典範,10,0,10,凱基-永和,2024-05-27,9207
6170,統振,10,0,10,凱基-永和,2024-05-27,9207
8085,福華,10,0,10,凱基-永和,2024-05-27,9207
2884,玉山金,10,1,9,凱基-永和,2024-05-27,9207
3290,東浦,9,0,9,凱基-永和,2024-05-27,9207
6139,亞翔,9,0,9,凱基-永和,2024-05-27,9207
2489,瑞軒,902,13,889,凱基-永和,2024-05-28,9207
2401,凌陽,662,45,617,凱基-永和,2024-05-28,9207
3231,緯創,636,26,610,凱基-永和,2024-05-28,9207
2349,錸德,376,2,374,凱基-永和,2024-05-28,9207
1582,信錦,200,8,192,凱基-永和,2024-05-28,9207
1815,富喬,184,17,167,凱基-永和,2024-05-28,9207
4720,德淵,130,0,130,凱基-永和,2024-05-28,9207
6207,雷科,133,24,109,凱基-永和,2024-05-28,9207
3260,威剛,109,0,109,凱基-永和,2024-05-28,9207
2605,新興,108,5,103,凱基-永和,2024-05-28,9207
6117,迎廣,101,1,100,凱基-永和,2024-05-28,9207
00937B,群益ESG投等債20,83,0,83,凱基-永和,2024-05-28,9207
00753L,中信中國50正2,70,0,70,凱基-永和,2024-05-28,9207
2891,中信金,63,0,63,凱基-永和,2024-05-28,9207
4909,新復興,51,1,50,凱基-永和,2024-05-28,9207
6451,訊芯-KY,55,8,47,凱基-永和,2024-05-28,9207
3055,蔚華科,100,61,39,凱基-永和,2024-05-28,9207
2486,一詮,47,10,37,凱基-永和,2024-05-28,9207
5269,祥碩,32,0,32,凱基-永和,2024-05-28,9207
3311,閎暉,30,0,30,凱基-永和,2024-05-28,9207
3689,湧德,30,1,29,凱基-永和,2024-05-28,9207
2009,第一銅,24,0,24,凱基-永和,2024-05-28,9207
00679B,元大美債20年,24,0,24,凱基-永和,2024-05-28,9207
00632R,元大台灣50反1,23,0,23,凱基-永和,2024-05-28,9207
2340,台亞,22,0,22,凱基-永和,2024-05-28,9207
00882,中信中國高股息,25,5,20,凱基-永和,2024-05-28,9207
2488,漢平,17,0,17,凱基-永和,2024-05-28,9207
6168,宏齊,17,2,15,凱基-永和,2024-05-28,9207
2329,華泰,16,1,15,凱基-永和,2024-05-28,9207
8069,元太,15,0,15,凱基-永和,2024-05-28,9207
4961,天鈺,17,3,14,凱基-永和,2024-05-28,9207
00933B,國泰10Y+金融債,14,0,14,凱基-永和,2024-05-28,9207
0056,元大高股息,26,13,13,凱基-永和,2024-05-28,9207
2880,華南金,12,0,12,凱基-永和,2024-05-28,9207
2603,長榮,18,8,10,凱基-永和,2024-05-28,9207
00946,群益科技高息成長,14,4,10,凱基-永和,2024-05-28,9207
00857B,永豐20年美公債,10,0,10,凱基-永和,2024-05-28,9207
2367,燿華,11,1,10,凱基-永和,2024-05-28,9207
2884,玉山金,10,0,10,凱基-永和,2024-05-28,9207
3029,零壹,10,0,10,凱基-永和,2024-05-28,9207
4714,永捷,10,0,10,凱基-永和,2024-05-28,9207
6167,久正,10,0,10,凱基-永和,2024-05-28,9207
8299,群聯,10,0,10,凱基-永和,2024-05-28,9207
5426,振發,14,5,9,凱基-永和,2024-05-28,9207
2317,鴻海,25,16,9,凱基-永和,2024-05-28,9207
2376,技嘉,9,1,8,凱基-永和,2024-05-28,9207
2457,飛宏,9,1,8,凱基-永和,2024-05-28,9207
3483,力致,8,0,8,凱基-永和,2024-05-28,9207
3712,永崴投控,14,6,8,凱基-永和,2024-05-28,9207
3443,創意,9,1,8,凱基-永和,2024-05-28,9207
00665L,富邦�琤肭磪囓�2,405,5,400,凱基-永和,2024-05-29,9207
5230,雷笛克光學,200,0,200,凱基-永和,2024-05-29,9207
00937B,群益ESG投等債20,197,3,194,凱基-永和,2024-05-29,9207
2618,長榮航,217,23,194,凱基-永和,2024-05-29,9207
8064,東捷,406,253,153,凱基-永和,2024-05-29,9207
9105,泰金寶-DR,150,0,150,凱基-永和,2024-05-29,9207
3564,其陽,110,0,110,凱基-永和,2024-05-29,9207
4533,協易機,150,45,105,凱基-永和,2024-05-29,9207
00679B,元大美債20年,71,0,71,凱基-永和,2024-05-29,9207
6285,啟��,87,21,66,凱基-永和,2024-05-29,9207
00770,國泰北美科技,65,0,65,凱基-永和,2024-05-29,9207
1725,元禎,60,0,60,凱基-永和,2024-05-29,9207
3041,揚智,61,2,59,凱基-永和,2024-05-29,9207
2353,宏��,63,32,31,凱基-永和,2024-05-29,9207
2208,台船,30,0,30,凱基-永和,2024-05-29,9207
3702,大聯大,31,2,29,凱基-永和,2024-05-29,9207
6125,廣運,29,1,28,凱基-永和,2024-05-29,9207
2884,玉山金,28,0,28,凱基-永和,2024-05-29,9207
00933B,國泰10Y+金融債,27,0,27,凱基-永和,2024-05-29,9207
1785,光洋科,30,6,24,凱基-永和,2024-05-29,9207
2367,燿華,27,4,23,凱基-永和,2024-05-29,9207
2344,華邦電,25,3,22,凱基-永和,2024-05-29,9207
2891,中信金,22,1,21,凱基-永和,2024-05-29,9207
00946,群益科技高息成長,25,4,21,凱基-永和,2024-05-29,9207
2880,華南金,21,0,21,凱基-永和,2024-05-29,9207
2834,臺企銀,20,0,20,凱基-永和,2024-05-29,9207
3047,訊舟,25,5,20,凱基-永和,2024-05-29,9207
2888,新光金,24,4,20,凱基-永和,2024-05-29,9207
6142,友勁,20,0,20,凱基-永和,2024-05-29,9207
2890,永豐金,19,0,19,凱基-永和,2024-05-29,9207
3035,智原,22,4,18,凱基-永和,2024-05-29,9207
6449,鈺邦,30,13,17,凱基-永和,2024-05-29,9207
2363,矽統,41,25,16,凱基-永和,2024-05-29,9207
2731,雄獅,21,5,16,凱基-永和,2024-05-29,9207
2317,鴻海,21,6,15,凱基-永和,2024-05-29,9207
00680L,元大美債20正2,14,0,14,凱基-永和,2024-05-29,9207
5269,祥碩,14,0,14,凱基-永和,2024-05-29,9207
5512,力麒,20,6,14,凱基-永和,2024-05-29,9207
6168,宏齊,14,0,14,凱基-永和,2024-05-29,9207
00878,國泰永續高股息,14,1,13,凱基-永和,2024-05-29,9207
2354,鴻準,25,13,12,凱基-永和,2024-05-29,9207
2465,麗臺,12,0,12,凱基-永和,2024-05-29,9207
2002,中鋼,13,2,11,凱基-永和,2024-05-29,9207
3535,晶彩科,11,0,11,凱基-永和,2024-05-29,9207
8374,羅昇,11,0,11,凱基-永和,2024-05-29,9207
6189,豐藝,18,8,10,凱基-永和,2024-05-29,9207
3034,聯詠,10,0,10,凱基-永和,2024-05-29,9207
2408,南亞科,10,0,10,凱基-永和,2024-05-29,9207
2636,台驊控股,10,0,10,凱基-永和,2024-05-29,9207
2897,王道銀行,10,0,10,凱基-永和,2024-05-29,9207
00632R,元大台灣50反1,301,44,257,凱基-永和,2024-05-30,9207
8996,高力,164,1,163,凱基-永和,2024-05-30,9207
2399,映泰,101,3,98,凱基-永和,2024-05-30,9207
00937B,群益ESG投等債20,78,0,78,凱基-永和,2024-05-30,9207
00919,群益台灣精選高息,62,5,57,凱基-永和,2024-05-30,9207
00929,復華台灣科技優息,45,0,45,凱基-永和,2024-05-30,9207
2408,南亞科,53,11,42,凱基-永和,2024-05-30,9207
2409,友達,40,0,40,凱基-永和,2024-05-30,9207
2891,中信金,33,0,33,凱基-永和,2024-05-30,9207
4760,勤凱,30,0,30,凱基-永和,2024-05-30,9207
2363,矽統,42,13,29,凱基-永和,2024-05-30,9207
2405,輔信,34,5,29,凱基-永和,2024-05-30,9207
00679B,元大美債20年,25,0,25,凱基-永和,2024-05-30,9207
2356,英業達,30,5,25,凱基-永和,2024-05-30,9207
8358,金居,22,0,22,凱基-永和,2024-05-30,9207
6443,元晶,20,0,20,凱基-永和,2024-05-30,9207
8028,昇陽半導體,23,4,19,凱基-永和,2024-05-30,9207
00878,國泰永續高股息,20,1,19,凱基-永和,2024-05-30,9207
00687B,國泰20年美債,18,0,18,凱基-永和,2024-05-30,9207
6168,宏齊,18,0,18,凱基-永和,2024-05-30,9207
6290,良維,21,3,18,凱基-永和,2024-05-30,9207
6201,亞弘電,16,0,16,凱基-永和,2024-05-30,9207
5880,合庫金,16,0,16,凱基-永和,2024-05-30,9207
00712,復華富時不動產,15,0,15,凱基-永和,2024-05-30,9207
2367,燿華,16,1,15,凱基-永和,2024-05-30,9207
6188,廣明,25,10,15,凱基-永和,2024-05-30,9207
2354,鴻準,26,13,13,凱基-永和,2024-05-30,9207
1808,潤隆,13,0,13,凱基-永和,2024-05-30,9207
4562,穎漢,18,5,13,凱基-永和,2024-05-30,9207
2371,大同,13,0,13,凱基-永和,2024-05-30,9207
00751B,元大AAA至A公司債,13,0,13,凱基-永和,2024-05-30,9207
00715L,期街口布蘭特正2,12,0,12,凱基-永和,2024-05-30,9207
00882,中信中國高股息,13,1,12,凱基-永和,2024-05-30,9207
2353,宏��,39,27,12,凱基-永和,2024-05-30,9207
2618,長榮航,41,29,12,凱基-永和,2024-05-30,9207
2330,台積電,11,0,11,凱基-永和,2024-05-30,9207
2002,中鋼,12,1,11,凱基-永和,2024-05-30,9207
2610,華航,16,5,11,凱基-永和,2024-05-30,9207
5498,凱崴,11,0,11,凱基-永和,2024-05-30,9207
2834,臺企銀,10,0,10,凱基-永和,2024-05-30,9207
00857B,永豐20年美公債,10,0,10,凱基-永和,2024-05-30,9207
1338,廣華-KY,10,0,10,凱基-永和,2024-05-30,9207
1580,新麥,10,0,10,凱基-永和,2024-05-30,9207
2312,金寶,10,0,10,凱基-永和,2024-05-30,9207
2483,百容,10,0,10,凱基-永和,2024-05-30,9207
3450,聯鈞,10,0,10,凱基-永和,2024-05-30,9207
2382,廣達,11,1,10,凱基-永和,2024-05-30,9207
00915,凱基優選高股息30,9,0,9,凱基-永和,2024-05-30,9207
9945,潤泰新,10,1,9,凱基-永和,2024-05-30,9207
00946,群益科技高息成長,15,7,8,凱基-永和,2024-05-30,9207
2349,錸德,504,0,504,凱基-永和,2024-05-31,9207
2641,正德,200,11,189,凱基-永和,2024-05-31,9207
6770,力積電,145,3,142,凱基-永和,2024-05-31,9207
3437,榮創,102,0,102,凱基-永和,2024-05-31,9207
1582,信錦,260,161,99,凱基-永和,2024-05-31,9207
1453,大將,89,1,88,凱基-永和,2024-05-31,9207
6695,芯鼎,78,8,70,凱基-永和,2024-05-31,9207
3564,其陽,66,0,66,凱基-永和,2024-05-31,9207
00919,群益台灣精選高息,50,0,50,凱基-永和,2024-05-31,9207
3231,緯創,49,1,48,凱基-永和,2024-05-31,9207
2317,鴻海,63,15,48,凱基-永和,2024-05-31,9207
1532,勤美,45,0,45,凱基-永和,2024-05-31,9207
8086,宏捷科,36,0,36,凱基-永和,2024-05-31,9207
2885,元大金,31,0,31,凱基-永和,2024-05-31,9207
00933B,國泰10Y+金融債,30,0,30,凱基-永和,2024-05-31,9207
2609,陽明,57,29,28,凱基-永和,2024-05-31,9207
00937B,群益ESG投等債20,42,15,27,凱基-永和,2024-05-31,9207
2605,新興,50,25,25,凱基-永和,2024-05-31,9207
5351,鈺創,25,0,25,凱基-永和,2024-05-31,9207
4566,時碩工業,23,0,23,凱基-永和,2024-05-31,9207
00927,群益半導體收益,20,0,20,凱基-永和,2024-05-31,9207
0056,元大高股息,20,0,20,凱基-永和,2024-05-31,9207
2867,三商壽,27,8,19,凱基-永和,2024-05-31,9207
6170,統振,20,3,17,凱基-永和,2024-05-31,9207
2886,兆豐金,16,1,15,凱基-永和,2024-05-31,9207
6201,亞弘電,15,0,15,凱基-永和,2024-05-31,9207
9934,成霖,15,0,15,凱基-永和,2024-05-31,9207
2303,聯電,19,5,14,凱基-永和,2024-05-31,9207
5478,智冠,14,0,14,凱基-永和,2024-05-31,9207
2405,輔信,13,0,13,凱基-永和,2024-05-31,9207
00881,國泰台灣5G+,11,0,11,凱基-永和,2024-05-31,9207
4938,和碩,11,0,11,凱基-永和,2024-05-31,9207
6109,亞元,19,8,11,凱基-永和,2024-05-31,9207
2801,彰銀,11,0,11,凱基-永和,2024-05-31,9207
00688L,國泰20年美債正2,10,0,10,凱基-永和,2024-05-31,9207
00665L,富邦�琤肭磪囓�2,10,0,10,凱基-永和,2024-05-31,9207
00753L,中信中國50正2,14,4,10,凱基-永和,2024-05-31,9207
2427,三商電,10,0,10,凱基-永和,2024-05-31,9207
2542,興富發,10,0,10,凱基-永和,2024-05-31,9207
5230,雷笛克光學,10,0,10,凱基-永和,2024-05-31,9207
2633,台灣高鐵,10,0,10,凱基-永和,2024-05-31,9207
1580,新麥,9,0,9,凱基-永和,2024-05-31,9207
2483,百容,9,0,9,凱基-永和,2024-05-31,9207
2489,瑞軒,13,4,9,凱基-永和,2024-05-31,9207
2618,長榮航,10,1,9,凱基-永和,2024-05-31,9207
00893,國泰智能電動車,8,0,8,凱基-永和,2024-05-31,9207
00918,大華優利高填息30,8,0,8,凱基-永和,2024-05-31,9207
2486,一詮,8,0,8,凱基-永和,2024-05-31,9207
2330,台積電,8,0,8,凱基-永和,2024-05-31,9207
00922,國泰台灣領袖50,7,0,7,凱基-永和,2024-05-31,9207
00687B,國泰20年美債,433,0,433,凱基-永和,2024-06-03,9207
00725B,國泰投資級公司債,400,0,400,凱基-永和,2024-06-03,9207
3202,樺晟,259,17,242,凱基-永和,2024-06-03,9207
8234,新漢,170,4,166,凱基-永和,2024-06-03,9207
8064,東捷,160,3,157,凱基-永和,2024-06-03,9207
5443,均豪,156,11,145,凱基-永和,2024-06-03,9207
1110,東泥,130,17,113,凱基-永和,2024-06-03,9207
3576,聯合再生,100,0,100,凱基-永和,2024-06-03,9207
3285,微端,100,0,100,凱基-永和,2024-06-03,9207
6197,佳必琪,102,3,99,凱基-永和,2024-06-03,9207
3055,蔚華科,151,85,66,凱基-永和,2024-06-03,9207
2324,仁寶,56,4,52,凱基-永和,2024-06-03,9207
3006,晶豪科,51,1,50,凱基-永和,2024-06-03,9207
6244,茂迪,50,0,50,凱基-永和,2024-06-03,9207
6443,元晶,50,0,50,凱基-永和,2024-06-03,9207
00919,群益台灣精選高息,71,25,46,凱基-永和,2024-06-03,9207
00937B,群益ESG投等債20,53,10,43,凱基-永和,2024-06-03,9207
1513,中興電,39,0,39,凱基-永和,2024-06-03,9207
2618,長榮航,56,18,38,凱基-永和,2024-06-03,9207
6201,亞弘電,34,0,34,凱基-永和,2024-06-03,9207
1453,大將,33,0,33,凱基-永和,2024-06-03,9207
3086,華義,33,0,33,凱基-永和,2024-06-03,9207
2337,旺宏,29,0,29,凱基-永和,2024-06-03,9207
8069,元太,31,2,29,凱基-永和,2024-06-03,9207
2301,光寶科,31,4,27,凱基-永和,2024-06-03,9207
2367,燿華,34,10,24,凱基-永和,2024-06-03,9207
6591,動力-KY,23,0,23,凱基-永和,2024-06-03,9207
1314,中石化,23,0,23,凱基-永和,2024-06-03,9207
00929,復華台灣科技優息,26,3,23,凱基-永和,2024-06-03,9207
2409,友達,22,0,22,凱基-永和,2024-06-03,9207
6695,芯鼎,63,42,21,凱基-永和,2024-06-03,9207
8916,光隆,20,0,20,凱基-永和,2024-06-03,9207
2483,百容,20,0,20,凱基-永和,2024-06-03,9207
6116,彩晶,20,0,20,凱基-永和,2024-06-03,9207
6451,訊芯-KY,20,0,20,凱基-永和,2024-06-03,9207
0050,元大台灣50,18,0,18,凱基-永和,2024-06-03,9207
4994,傳奇,17,0,17,凱基-永和,2024-06-03,9207
6109,亞元,17,0,17,凱基-永和,2024-06-03,9207
5469,瀚宇博,20,5,15,凱基-永和,2024-06-03,9207
6237,驊訊,16,1,15,凱基-永和,2024-06-03,9207
2328,廣宇,20,6,14,凱基-永和,2024-06-03,9207
00665L,富邦�琤肭磪囓�2,13,0,13,凱基-永和,2024-06-03,9207
5371,中光電,13,1,12,凱基-永和,2024-06-03,9207
00637L,元大滬深300正2,11,0,11,凱基-永和,2024-06-03,9207
2354,鴻準,19,8,11,凱基-永和,2024-06-03,9207
2436,偉詮電,11,0,11,凱基-永和,2024-06-03,9207
6163,華電網,11,0,11,凱基-永和,2024-06-03,9207
00715L,期街口布蘭特正2,10,0,10,凱基-永和,2024-06-03,9207
00753L,中信中國50正2,10,0,10,凱基-永和,2024-06-03,9207
00942B,台新美A公司債20+,10,0,10,凱基-永和,2024-06-03,9207
3376,新日興,223,7,216,凱基-永和,2024-06-04,9207
8277,商丞,200,0,200,凱基-永和,2024-06-04,9207
6531,愛普*,169,0,169,凱基-永和,2024-06-04,9207
6125,廣運,73,10,63,凱基-永和,2024-06-04,9207
00918,大華優利高填息30,58,5,53,凱基-永和,2024-06-04,9207
00919,群益台灣精選高息,53,0,53,凱基-永和,2024-06-04,9207
4994,傳奇,50,0,50,凱基-永和,2024-06-04,9207
1616,億泰,48,0,48,凱基-永和,2024-06-04,9207
00715L,期街口布蘭特正2,59,12,47,凱基-永和,2024-06-04,9207
00881,國泰台灣5G+,42,0,42,凱基-永和,2024-06-04,9207
2328,廣宇,36,2,34,凱基-永和,2024-06-04,9207
00929,復華台灣科技優息,83,50,33,凱基-永和,2024-06-04,9207
2312,金寶,44,16,28,凱基-永和,2024-06-04,9207
2344,華邦電,30,2,28,凱基-永和,2024-06-04,9207
2486,一詮,59,31,28,凱基-永和,2024-06-04,9207
1802,台玻,28,2,26,凱基-永和,2024-06-04,9207
2331,精英,56,30,26,凱基-永和,2024-06-04,9207
6109,亞元,33,7,26,凱基-永和,2024-06-04,9207
0050,元大台灣50,22,0,22,凱基-永和,2024-06-04,9207
2483,百容,20,0,20,凱基-永和,2024-06-04,9207
1504,東元,20,3,17,凱基-永和,2024-06-04,9207
00642U,期元大S＆P石油,16,0,16,凱基-永和,2024-06-04,9207
4726,永昕,18,2,16,凱基-永和,2024-06-04,9207
3443,創意,15,0,15,凱基-永和,2024-06-04,9207
2353,宏��,20,5,15,凱基-永和,2024-06-04,9207
6201,亞弘電,14,0,14,凱基-永和,2024-06-04,9207
00680L,元大美債20正2,12,0,12,凱基-永和,2024-06-04,9207
2303,聯電,13,2,11,凱基-永和,2024-06-04,9207
2002,中鋼,11,0,11,凱基-永和,2024-06-04,9207
3260,威剛,11,0,11,凱基-永和,2024-06-04,9207
00946,群益科技高息成長,11,0,11,凱基-永和,2024-06-04,9207
2834,臺企銀,11,0,11,凱基-永和,2024-06-04,9207
1314,中石化,10,0,10,凱基-永和,2024-06-04,9207
2427,三商電,20,10,10,凱基-永和,2024-06-04,9207
2511,太子,10,0,10,凱基-永和,2024-06-04,9207
2889,國票金,10,0,10,凱基-永和,2024-06-04,9207
2354,鴻準,48,38,10,凱基-永和,2024-06-04,9207
2337,旺宏,22,13,9,凱基-永和,2024-06-04,9207
2009,第一銅,11,2,9,凱基-永和,2024-06-04,9207
2610,華航,14,5,9,凱基-永和,2024-06-04,9207
3231,緯創,9,0,9,凱基-永和,2024-06-04,9207
2371,大同,8,1,7,凱基-永和,2024-06-04,9207
2537,聯上發,23,16,7,凱基-永和,2024-06-04,9207
3013,晟銘電,48,41,7,凱基-永和,2024-06-04,9207
3024,憶聲,7,0,7,凱基-永和,2024-06-04,9207
5471,松翰,7,0,7,凱基-永和,2024-06-04,9207
6270,倍微,8,2,6,凱基-永和,2024-06-04,9207
2329,華泰,6,0,6,凱基-永和,2024-06-04,9207
5353,台林,6,0,6,凱基-永和,2024-06-04,9207
5426,振發,6,0,6,凱基-永和,2024-06-04,9207
2328,廣宇,406,46,360,凱基-永和,2024-06-05,9207
2615,萬海,216,16,200,凱基-永和,2024-06-05,9207
3576,聯合再生,166,0,166,凱基-永和,2024-06-05,9207
5302,太欣,100,0,100,凱基-永和,2024-06-05,9207
6443,元晶,88,1,87,凱基-永和,2024-06-05,9207
00770,國泰北美科技,65,0,65,凱基-永和,2024-06-05,9207
00878,國泰永續高股息,67,3,64,凱基-永和,2024-06-05,9207
3297,杭特,51,0,51,凱基-永和,2024-06-05,9207
6753,龍德造船,50,0,50,凱基-永和,2024-06-05,9207
2457,飛宏,50,4,46,凱基-永和,2024-06-05,9207
4746,台耀,55,9,46,凱基-永和,2024-06-05,9207
8996,高力,40,0,40,凱基-永和,2024-06-05,9207
6112,邁達特,36,0,36,凱基-永和,2024-06-05,9207
00929,復華台灣科技優息,36,0,36,凱基-永和,2024-06-05,9207
2303,聯電,34,1,33,凱基-永和,2024-06-05,9207
8099,大世科,33,0,33,凱基-永和,2024-06-05,9207
4533,協易機,31,0,31,凱基-永和,2024-06-05,9207
00942B,台新美A公司債20+,30,0,30,凱基-永和,2024-06-05,9207
00687B,國泰20年美債,33,3,30,凱基-永和,2024-06-05,9207
4973,廣穎,30,0,30,凱基-永和,2024-06-05,9207
3686,達能,29,0,29,凱基-永和,2024-06-05,9207
6477,安集,28,0,28,凱基-永和,2024-06-05,9207
2891,中信金,29,7,22,凱基-永和,2024-06-05,9207
6244,茂迪,20,0,20,凱基-永和,2024-06-05,9207
3630,新鉅科,20,0,20,凱基-永和,2024-06-05,9207
2105,正新,19,0,19,凱基-永和,2024-06-05,9207
2101,南港,18,0,18,凱基-永和,2024-06-05,9207
2486,一詮,30,12,18,凱基-永和,2024-06-05,9207
3306,鼎天,20,2,18,凱基-永和,2024-06-05,9207
00680L,元大美債20正2,24,10,14,凱基-永和,2024-06-05,9207
6188,廣明,22,8,14,凱基-永和,2024-06-05,9207
8916,光隆,13,0,13,凱基-永和,2024-06-05,9207
2313,華通,13,0,13,凱基-永和,2024-06-05,9207
00936,台新永續高息中小,12,0,12,凱基-永和,2024-06-05,9207
00632R,元大台灣50反1,12,0,12,凱基-永和,2024-06-05,9207
2483,百容,12,1,11,凱基-永和,2024-06-05,9207
3374,精材,21,10,11,凱基-永和,2024-06-05,9207
1713,國化,10,0,10,凱基-永和,2024-06-05,9207
9958,世紀鋼,10,0,10,凱基-永和,2024-06-05,9207
2449,京元電子,9,0,9,凱基-永和,2024-06-05,9207
1301,台塑,9,1,8,凱基-永和,2024-06-05,9207
2867,三商壽,10,2,8,凱基-永和,2024-06-05,9207
3663,鑫科,8,0,8,凱基-永和,2024-06-05,9207
2014,中鴻,7,0,7,凱基-永和,2024-06-05,9207
5469,瀚宇博,11,4,7,凱基-永和,2024-06-05,9207
5471,松翰,7,0,7,凱基-永和,2024-06-05,9207
8096,擎亞,18,11,7,凱基-永和,2024-06-05,9207
00715L,期街口布蘭特正2,6,0,6,凱基-永和,2024-06-05,9207
2353,宏��,20,14,6,凱基-永和,2024-06-05,9207
6109,亞元,6,0,6,凱基-永和,2024-06-05,9207
2330,台積電,514,25,489,凱基-永和,2024-06-06,9207
00892,富邦台灣半導體,180,3,177,凱基-永和,2024-06-06,9207
00632R,元大台灣50反1,116,0,116,凱基-永和,2024-06-06,9207
00919,群益台灣精選高息,100,3,97,凱基-永和,2024-06-06,9207
2605,新興,82,0,82,凱基-永和,2024-06-06,9207
8114,振樺電,52,1,51,凱基-永和,2024-06-06,9207
4909,新復興,50,0,50,凱基-永和,2024-06-06,9207
6451,訊芯-KY,41,1,40,凱基-永和,2024-06-06,9207
00929,復華台灣科技優息,41,3,38,凱基-永和,2024-06-06,9207
8099,大世科,33,0,33,凱基-永和,2024-06-06,9207
5269,祥碩,31,0,31,凱基-永和,2024-06-06,9207
00720B,元大投資級公司債,20,0,20,凱基-永和,2024-06-06,9207
00918,大華優利高填息30,20,1,19,凱基-永和,2024-06-06,9207
2409,友達,17,0,17,凱基-永和,2024-06-06,9207
1314,中石化,19,2,17,凱基-永和,2024-06-06,9207
2354,鴻準,26,9,17,凱基-永和,2024-06-06,9207
3078,僑威,15,1,14,凱基-永和,2024-06-06,9207
3047,訊舟,14,0,14,凱基-永和,2024-06-06,9207
2483,百容,12,0,12,凱基-永和,2024-06-06,9207
1102,亞泥,11,0,11,凱基-永和,2024-06-06,9207
1815,富喬,11,0,11,凱基-永和,2024-06-06,9207
2014,中鴻,11,0,11,凱基-永和,2024-06-06,9207
00662,富邦NASDAQ,10,0,10,凱基-永和,2024-06-06,9207
1110,東泥,50,40,10,凱基-永和,2024-06-06,9207
2365,昆盈,13,3,10,凱基-永和,2024-06-06,9207
2436,偉詮電,10,0,10,凱基-永和,2024-06-06,9207
3027,盛達,10,0,10,凱基-永和,2024-06-06,9207
4714,永捷,10,0,10,凱基-永和,2024-06-06,9207
4760,勤凱,10,0,10,凱基-永和,2024-06-06,9207
6109,亞元,10,0,10,凱基-永和,2024-06-06,9207
8028,昇陽半導體,11,1,10,凱基-永和,2024-06-06,9207
1303,南亞,12,3,9,凱基-永和,2024-06-06,9207
3564,其陽,19,10,9,凱基-永和,2024-06-06,9207
3663,鑫科,9,0,9,凱基-永和,2024-06-06,9207
5009,榮剛,11,2,9,凱基-永和,2024-06-06,9207
00936,台新永續高息中小,8,0,8,凱基-永和,2024-06-06,9207
1609,大亞,10,2,8,凱基-永和,2024-06-06,9207
2208,台船,10,3,7,凱基-永和,2024-06-06,9207
2331,精英,11,4,7,凱基-永和,2024-06-06,9207
6168,宏齊,7,0,7,凱基-永和,2024-06-06,9207
8096,擎亞,9,2,7,凱基-永和,2024-06-06,9207
2317,鴻海,50,43,7,凱基-永和,2024-06-06,9207
3312,弘憶股,6,0,6,凱基-永和,2024-06-06,9207
3338,泰碩,6,0,6,凱基-永和,2024-06-06,9207
2327,國巨,6,0,6,凱基-永和,2024-06-06,9207
00676R,富邦臺灣加權反1,5,0,5,凱基-永和,2024-06-06,9207
00688L,國泰20年美債正2,5,0,5,凱基-永和,2024-06-06,9207
1733,五鼎,5,0,5,凱基-永和,2024-06-06,9207
2457,飛宏,5,0,5,凱基-永和,2024-06-06,9207
2611,志信,5,0,5,凱基-永和,2024-06-06,9207
00878,國泰永續高股息,2305,3,2302,凱基-永和,2024-06-07,9207
3047,訊舟,702,20,682,凱基-永和,2024-06-07,9207
2330,台積電,419,2,417,凱基-永和,2024-06-07,9207
2501,國建,451,151,300,凱基-永和,2024-06-07,9207
1608,華榮,302,9,293,凱基-永和,2024-06-07,9207
2812,台中銀,268,0,268,凱基-永和,2024-06-07,9207
5515,建國,203,0,203,凱基-永和,2024-06-07,9207
2537,聯上發,215,17,198,凱基-永和,2024-06-07,9207
00918,大華優利高填息30,149,16,133,凱基-永和,2024-06-07,9207
00665L,富邦�琤肭磪囓�2,143,23,120,凱基-永和,2024-06-07,9207
2613,中櫃,111,10,101,凱基-永和,2024-06-07,9207
6140,訊達,100,0,100,凱基-永和,2024-06-07,9207
8064,東捷,301,201,100,凱基-永和,2024-06-07,9207
1815,富喬,115,18,97,凱基-永和,2024-06-07,9207
4967,十銓,102,5,97,凱基-永和,2024-06-07,9207
4562,穎漢,83,0,83,凱基-永和,2024-06-07,9207
1101,台泥,80,2,78,凱基-永和,2024-06-07,9207
00937B,群益ESG投等債20,68,13,55,凱基-永和,2024-06-07,9207
00712,復華富時不動產,52,0,52,凱基-永和,2024-06-07,9207
00881,國泰台灣5G+,41,0,41,凱基-永和,2024-06-07,9207
2353,宏��,38,1,37,凱基-永和,2024-06-07,9207
3231,緯創,39,2,37,凱基-永和,2024-06-07,9207
0050,元大台灣50,29,0,29,凱基-永和,2024-06-07,9207
00687B,國泰20年美債,38,11,27,凱基-永和,2024-06-07,9207
00655L,國泰中國A50正2,27,1,26,凱基-永和,2024-06-07,9207
2392,正崴,26,0,26,凱基-永和,2024-06-07,9207
00929,復華台灣科技優息,26,4,22,凱基-永和,2024-06-07,9207
00637L,元大滬深300正2,21,0,21,凱基-永和,2024-06-07,9207
1532,勤美,20,0,20,凱基-永和,2024-06-07,9207
2312,金寶,28,9,19,凱基-永和,2024-06-07,9207
3376,新日興,22,3,19,凱基-永和,2024-06-07,9207
3707,漢磊,20,2,18,凱基-永和,2024-06-07,9207
2002,中鋼,16,0,16,凱基-永和,2024-06-07,9207
6451,訊芯-KY,15,0,15,凱基-永和,2024-06-07,9207
00632R,元大台灣50反1,14,0,14,凱基-永和,2024-06-07,9207
2609,陽明,58,46,12,凱基-永和,2024-06-07,9207
6139,亞翔,23,11,12,凱基-永和,2024-06-07,9207
2367,燿華,12,0,12,凱基-永和,2024-06-07,9207
2483,百容,12,0,12,凱基-永和,2024-06-07,9207
00680L,元大美債20正2,11,0,11,凱基-永和,2024-06-07,9207
2356,英業達,11,1,10,凱基-永和,2024-06-07,9207
2897,王道銀行,10,0,10,凱基-永和,2024-06-07,9207
3024,憶聲,20,10,10,凱基-永和,2024-06-07,9207
5324,士開,10,0,10,凱基-永和,2024-06-07,9207
6109,亞元,10,0,10,凱基-永和,2024-06-07,9207
6264,富裔,10,0,10,凱基-永和,2024-06-07,9207
4958,臻鼎-KY,10,0,10,凱基-永和,2024-06-07,9207
2498,宏達電,11,2,9,凱基-永和,2024-06-07,9207
3665,貿聯-KY,8,0,8,凱基-永和,2024-06-07,9207
6170,統振,15,7,8,凱基-永和,2024-06-07,9207
00933B,國泰10Y+金融債,988,0,988,凱基-永和,2024-06-11,9207
00665L,富邦�琤肭磪囓�2,260,55,205,凱基-永和,2024-06-11,9207
00937B,群益ESG投等債20,180,0,180,凱基-永和,2024-06-11,9207
2609,陽明,229,66,163,凱基-永和,2024-06-11,9207
00857B,永豐20年美公債,118,0,118,凱基-永和,2024-06-11,9207
9105,泰金寶-DR,100,0,100,凱基-永和,2024-06-11,9207
00687B,國泰20年美債,56,4,52,凱基-永和,2024-06-11,9207
2409,友達,50,0,50,凱基-永和,2024-06-11,9207
4979,華星光,50,1,49,凱基-永和,2024-06-11,9207
4746,台耀,48,2,46,凱基-永和,2024-06-11,9207
00919,群益台灣精選高息,44,0,44,凱基-永和,2024-06-11,9207
6139,亞翔,68,26,42,凱基-永和,2024-06-11,9207
00929,復華台灣科技優息,31,2,29,凱基-永和,2024-06-11,9207
00679B,元大美債20年,29,1,28,凱基-永和,2024-06-11,9207
0056,元大高股息,26,1,25,凱基-永和,2024-06-11,9207
00918,大華優利高填息30,30,8,22,凱基-永和,2024-06-11,9207
2610,華航,28,7,21,凱基-永和,2024-06-11,9207
3306,鼎天,20,0,20,凱基-永和,2024-06-11,9207
6116,彩晶,20,0,20,凱基-永和,2024-06-11,9207
1102,亞泥,20,0,20,凱基-永和,2024-06-11,9207
3583,辛耘,20,1,19,凱基-永和,2024-06-11,9207
00878,國泰永續高股息,18,0,18,凱基-永和,2024-06-11,9207
1444,力麗,17,0,17,凱基-永和,2024-06-11,9207
2603,長榮,20,6,14,凱基-永和,2024-06-11,9207
2615,萬海,21,8,13,凱基-永和,2024-06-11,9207
3540,曜越,13,0,13,凱基-永和,2024-06-11,9207
2356,英業達,15,3,12,凱基-永和,2024-06-11,9207
00931B,統一美債20年,12,0,12,凱基-永和,2024-06-11,9207
00632R,元大台灣50反1,12,0,12,凱基-永和,2024-06-11,9207
2353,宏��,25,13,12,凱基-永和,2024-06-11,9207
00637L,元大滬深300正2,12,1,11,凱基-永和,2024-06-11,9207
2313,華通,11,0,11,凱基-永和,2024-06-11,9207
1453,大將,11,1,10,凱基-永和,2024-06-11,9207
9945,潤泰新,16,6,10,凱基-永和,2024-06-11,9207
00936,台新永續高息中小,10,0,10,凱基-永和,2024-06-11,9207
00720B,元大投資級公司債,10,0,10,凱基-永和,2024-06-11,9207
00882,中信中國高股息,10,0,10,凱基-永和,2024-06-11,9207
00696B,富邦美債20年,10,0,10,凱基-永和,2024-06-11,9207
1781,合世,10,0,10,凱基-永和,2024-06-11,9207
1808,潤隆,10,0,10,凱基-永和,2024-06-11,9207
2611,志信,9,0,9,凱基-永和,2024-06-11,9207
5864,致和證,9,0,9,凱基-永和,2024-06-11,9207
8147,正淩,9,0,9,凱基-永和,2024-06-11,9207
2374,佳能,13,4,9,凱基-永和,2024-06-11,9207
4958,臻鼎-KY,11,2,9,凱基-永和,2024-06-11,9207
00712,復華富時不動產,8,0,8,凱基-永和,2024-06-11,9207
2354,鴻準,9,1,8,凱基-永和,2024-06-11,9207
2483,百容,8,0,8,凱基-永和,2024-06-11,9207
2515,中工,8,0,8,凱基-永和,2024-06-11,9207
6152,百一,8,0,8,凱基-永和,2024-06-11,9207
00933B,國泰10Y+金融債,2190,0,2190,凱基-永和,2024-06-12,9207
00687B,國泰20年美債,406,0,406,凱基-永和,2024-06-12,9207
8096,擎亞,246,0,246,凱基-永和,2024-06-12,9207
4979,華星光,150,3,147,凱基-永和,2024-06-12,9207
2330,台積電,111,6,105,凱基-永和,2024-06-12,9207
4909,新復興,101,1,100,凱基-永和,2024-06-12,9207
5443,均豪,100,0,100,凱基-永和,2024-06-12,9207
8064,東捷,100,0,100,凱基-永和,2024-06-12,9207
00919,群益台灣精選高息,80,1,79,凱基-永和,2024-06-12,9207
00878,國泰永續高股息,71,9,62,凱基-永和,2024-06-12,9207
2883,凱基金,60,7,53,凱基-永和,2024-06-12,9207
9105,泰金寶-DR,50,0,50,凱基-永和,2024-06-12,9207
6451,訊芯-KY,257,212,45,凱基-永和,2024-06-12,9207
2476,鉅祥,90,46,44,凱基-永和,2024-06-12,9207
00632R,元大台灣50反1,44,0,44,凱基-永和,2024-06-12,9207
6125,廣運,42,3,39,凱基-永和,2024-06-12,9207
2609,陽明,93,54,39,凱基-永和,2024-06-12,9207
2467,志聖,37,0,37,凱基-永和,2024-06-12,9207
2486,一詮,36,3,33,凱基-永和,2024-06-12,9207
8054,安國,35,2,33,凱基-永和,2024-06-12,9207
2465,麗臺,30,0,30,凱基-永和,2024-06-12,9207
00948B,中信優息投資級債,30,2,28,凱基-永和,2024-06-12,9207
1514,亞力,27,5,22,凱基-永和,2024-06-12,9207
9945,潤泰新,22,1,21,凱基-永和,2024-06-12,9207
00665L,富邦�琤肭磪囓�2,120,100,20,凱基-永和,2024-06-12,9207
2401,凌陽,21,1,20,凱基-永和,2024-06-12,9207
5536,聖暉*,18,0,18,凱基-永和,2024-06-12,9207
00918,大華優利高填息30,17,0,17,凱基-永和,2024-06-12,9207
2515,中工,15,0,15,凱基-永和,2024-06-12,9207
3372,典範,15,0,15,凱基-永和,2024-06-12,9207
6112,邁達特,15,0,15,凱基-永和,2024-06-12,9207
00882,中信中國高股息,14,0,14,凱基-永和,2024-06-12,9207
8028,昇陽半導體,16,3,13,凱基-永和,2024-06-12,9207
3047,訊舟,38,26,12,凱基-永和,2024-06-12,9207
5608,四維航,12,0,12,凱基-永和,2024-06-12,9207
6770,力積電,303,291,12,凱基-永和,2024-06-12,9207
1303,南亞,11,0,11,凱基-永和,2024-06-12,9207
6170,統振,11,0,11,凱基-永和,2024-06-12,9207
2303,聯電,13,2,11,凱基-永和,2024-06-12,9207
2014,中鴻,10,0,10,凱基-永和,2024-06-12,9207
2331,精英,10,0,10,凱基-永和,2024-06-12,9207
2427,三商電,20,10,10,凱基-永和,2024-06-12,9207
2483,百容,10,0,10,凱基-永和,2024-06-12,9207
2641,正德,10,0,10,凱基-永和,2024-06-12,9207
3630,新鉅科,10,0,10,凱基-永和,2024-06-12,9207
4533,協易機,16,6,10,凱基-永和,2024-06-12,9207
5283,禾聯碩,10,0,10,凱基-永和,2024-06-12,9207
3706,神達,10,1,9,凱基-永和,2024-06-12,9207
8210,勤誠,9,0,9,凱基-永和,2024-06-12,9207
2374,佳能,11,3,8,凱基-永和,2024-06-12,9207
00937B,群益ESG投等債20,708,0,708,凱基-永和,2024-06-13,9207
00933B,國泰10Y+金融債,606,1,605,凱基-永和,2024-06-13,9207
00878,國泰永續高股息,615,10,605,凱基-永和,2024-06-13,9207
3450,聯鈞,210,64,146,凱基-永和,2024-06-13,9207
3006,晶豪科,152,13,139,凱基-永和,2024-06-13,9207
2392,正崴,200,64,136,凱基-永和,2024-06-13,9207
6274,台燿,134,2,132,凱基-永和,2024-06-13,9207
1785,光洋科,140,26,114,凱基-永和,2024-06-13,9207
2454,聯發科,72,3,69,凱基-永和,2024-06-13,9207
00942B,台新美A公司債20+,53,0,53,凱基-永和,2024-06-13,9207
5243,乙盛-KY,50,0,50,凱基-永和,2024-06-13,9207
6207,雷科,74,27,47,凱基-永和,2024-06-13,9207
8096,擎亞,153,107,46,凱基-永和,2024-06-13,9207
2344,華邦電,45,1,44,凱基-永和,2024-06-13,9207
6451,訊芯-KY,157,116,41,凱基-永和,2024-06-13,9207
3017,奇鋐,39,4,35,凱基-永和,2024-06-13,9207
2610,華航,30,0,30,凱基-永和,2024-06-13,9207
00713,元大台灣高息低波,27,1,26,凱基-永和,2024-06-13,9207
00679B,元大美債20年,25,1,24,凱基-永和,2024-06-13,9207
3372,典範,21,0,21,凱基-永和,2024-06-13,9207
6548,長科*,20,0,20,凱基-永和,2024-06-13,9207
6216,居易,20,0,20,凱基-永和,2024-06-13,9207
00751B,元大AAA至A公司債,20,0,20,凱基-永和,2024-06-13,9207
2618,長榮航,20,5,15,凱基-永和,2024-06-13,9207
00919,群益台灣精選高息,15,1,14,凱基-永和,2024-06-13,9207
2427,三商電,34,20,14,凱基-永和,2024-06-13,9207
4167,松瑞藥,17,4,13,凱基-永和,2024-06-13,9207
3231,緯創,26,14,12,凱基-永和,2024-06-13,9207
6188,廣明,11,0,11,凱基-永和,2024-06-13,9207
00948B,中信優息投資級債,10,0,10,凱基-永和,2024-06-13,9207
2313,華通,12,2,10,凱基-永和,2024-06-13,9207
2429,銘旺科,10,0,10,凱基-永和,2024-06-13,9207
4129,聯合,10,0,10,凱基-永和,2024-06-13,9207
00946,群益科技高息成長,15,6,9,凱基-永和,2024-06-13,9207
00637L,元大滬深300正2,14,5,9,凱基-永和,2024-06-13,9207
2314,台揚,9,0,9,凱基-永和,2024-06-13,9207
3481,群創,20,11,9,凱基-永和,2024-06-13,9207
4562,穎漢,12,3,9,凱基-永和,2024-06-13,9207
6770,力積電,9,0,9,凱基-永和,2024-06-13,9207
00687B,國泰20年美債,7,0,7,凱基-永和,2024-06-13,9207
00882,中信中國高股息,7,0,7,凱基-永和,2024-06-13,9207
1402,遠東新,7,0,7,凱基-永和,2024-06-13,9207
1587,吉茂,8,1,7,凱基-永和,2024-06-13,9207
2365,昆盈,24,17,7,凱基-永和,2024-06-13,9207
2408,南亞科,7,1,6,凱基-永和,2024-06-13,9207
6223,旺矽,9,3,6,凱基-永和,2024-06-13,9207
1795,美時,7,1,6,凱基-永和,2024-06-13,9207
2014,中鴻,6,0,6,凱基-永和,2024-06-13,9207
3715,定穎投控,6,0,6,凱基-永和,2024-06-13,9207
8147,正淩,6,0,6,凱基-永和,2024-06-13,9207
00937B,群益ESG投等債20,1013,0,1013,凱基-永和,2024-06-14,9207
3481,群創,600,32,568,凱基-永和,2024-06-14,9207
00878,國泰永續高股息,374,21,353,凱基-永和,2024-06-14,9207
1616,億泰,400,179,221,凱基-永和,2024-06-14,9207
4533,協易機,212,1,211,凱基-永和,2024-06-14,9207
8277,商丞,200,0,200,凱基-永和,2024-06-14,9207
6449,鈺邦,166,41,125,凱基-永和,2024-06-14,9207
2371,大同,110,42,68,凱基-永和,2024-06-14,9207
3362,先進光,50,0,50,凱基-永和,2024-06-14,9207
00632R,元大台灣50反1,43,0,43,凱基-永和,2024-06-14,9207
00933B,國泰10Y+金融債,40,0,40,凱基-永和,2024-06-14,9207
1609,大亞,47,12,35,凱基-永和,2024-06-14,9207
2363,矽統,36,1,35,凱基-永和,2024-06-14,9207
00915,凱基優選高股息30,32,1,31,凱基-永和,2024-06-14,9207
3202,樺晟,33,2,31,凱基-永和,2024-06-14,9207
8147,正淩,31,0,31,凱基-永和,2024-06-14,9207
5269,祥碩,30,0,30,凱基-永和,2024-06-14,9207
2330,台積電,26,0,26,凱基-永和,2024-06-14,9207
2486,一詮,29,5,24,凱基-永和,2024-06-14,9207
2303,聯電,29,5,24,凱基-永和,2024-06-14,9207
00751B,元大AAA至A公司債,20,0,20,凱基-永和,2024-06-14,9207
4142,國光生,20,0,20,凱基-永和,2024-06-14,9207
6592,和潤企業,20,0,20,凱基-永和,2024-06-14,9207
3707,漢磊,20,1,19,凱基-永和,2024-06-14,9207
2427,三商電,29,10,19,凱基-永和,2024-06-14,9207
00919,群益台灣精選高息,19,2,17,凱基-永和,2024-06-14,9207
6190,萬泰科,13,0,13,凱基-永和,2024-06-14,9207
2421,建準,12,0,12,凱基-永和,2024-06-14,9207
4739,康普,12,0,12,凱基-永和,2024-06-14,9207
2883,凱基金,15,3,12,凱基-永和,2024-06-14,9207
2436,偉詮電,11,0,11,凱基-永和,2024-06-14,9207
3379,彬台,11,0,11,凱基-永和,2024-06-14,9207
6139,亞翔,14,3,11,凱基-永和,2024-06-14,9207
2388,威盛,10,0,10,凱基-永和,2024-06-14,9207
00947,台新臺灣IC設計,10,0,10,凱基-永和,2024-06-14,9207
2455,全新,12,2,10,凱基-永和,2024-06-14,9207
2476,鉅祥,10,0,10,凱基-永和,2024-06-14,9207
2607,榮運,10,0,10,凱基-永和,2024-06-14,9207
3434,哲固,10,0,10,凱基-永和,2024-06-14,9207
6270,倍微,10,0,10,凱基-永和,2024-06-14,9207
9105,泰金寶-DR,10,0,10,凱基-永和,2024-06-14,9207
2340,台亞,10,1,9,凱基-永和,2024-06-14,9207
1301,台塑,11,2,9,凱基-永和,2024-06-14,9207
2618,長榮航,14,6,8,凱基-永和,2024-06-14,9207
00893,國泰智能電動車,10,2,8,凱基-永和,2024-06-14,9207
2101,南港,8,0,8,凱基-永和,2024-06-14,9207
6016,康和證,8,0,8,凱基-永和,2024-06-14,9207
2483,百容,7,0,7,凱基-永和,2024-06-14,9207
1802,台玻,6,0,6,凱基-永和,2024-06-14,9207
5351,鈺創,9,3,6,凱基-永和,2024-06-14,9207
2449,京元電子,954,6,948,凱基-永和,2024-06-17,9207
00933B,國泰10Y+金融債,707,0,707,凱基-永和,2024-06-17,9207
2888,新光金,493,2,491,凱基-永和,2024-06-17,9207
00918,大華優利高填息30,201,4,197,凱基-永和,2024-06-17,9207
4726,永昕,202,11,191,凱基-永和,2024-06-17,9207
3006,晶豪科,150,2,148,凱基-永和,2024-06-17,9207
5443,均豪,210,90,120,凱基-永和,2024-06-17,9207
3622,洋華,102,1,101,凱基-永和,2024-06-17,9207
8064,東捷,154,60,94,凱基-永和,2024-06-17,9207
8096,擎亞,200,120,80,凱基-永和,2024-06-17,9207
2330,台積電,71,1,70,凱基-永和,2024-06-17,9207
6451,訊芯-KY,130,61,69,凱基-永和,2024-06-17,9207
6592,和潤企業,60,0,60,凱基-永和,2024-06-17,9207
00929,復華台灣科技優息,55,3,52,凱基-永和,2024-06-17,9207
5439,高技,151,100,51,凱基-永和,2024-06-17,9207
8054,安國,100,50,50,凱基-永和,2024-06-17,9207
6290,良維,50,2,48,凱基-永和,2024-06-17,9207
3008,大立光,43,0,43,凱基-永和,2024-06-17,9207
2027,大成鋼,42,0,42,凱基-永和,2024-06-17,9207
6116,彩晶,42,0,42,凱基-永和,2024-06-17,9207
6535,順藥,40,0,40,凱基-永和,2024-06-17,9207
00937B,群益ESG投等債20,32,0,32,凱基-永和,2024-06-17,9207
00948B,中信優息投資級債,32,0,32,凱基-永和,2024-06-17,9207
00687B,國泰20年美債,31,0,31,凱基-永和,2024-06-17,9207
6684,安格,29,0,29,凱基-永和,2024-06-17,9207
3062,建漢,25,1,24,凱基-永和,2024-06-17,9207
2344,華邦電,22,0,22,凱基-永和,2024-06-17,9207
3231,緯創,21,0,21,凱基-永和,2024-06-17,9207
00632R,元大台灣50反1,20,0,20,凱基-永和,2024-06-17,9207
2258,鴻華先進-創,20,0,20,凱基-永和,2024-06-17,9207
5351,鈺創,19,1,18,凱基-永和,2024-06-17,9207
3563,牧德,18,0,18,凱基-永和,2024-06-17,9207
00679B,元大美債20年,18,1,17,凱基-永和,2024-06-17,9207
2610,華航,22,6,16,凱基-永和,2024-06-17,9207
2883,凱基金,15,1,14,凱基-永和,2024-06-17,9207
00947,台新臺灣IC設計,13,0,13,凱基-永和,2024-06-17,9207
2376,技嘉,14,1,13,凱基-永和,2024-06-17,9207
2467,志聖,13,0,13,凱基-永和,2024-06-17,9207
00713,元大台灣高息低波,13,1,12,凱基-永和,2024-06-17,9207
2354,鴻準,12,0,12,凱基-永和,2024-06-17,9207
00946,群益科技高息成長,11,0,11,凱基-永和,2024-06-17,9207
2834,臺企銀,12,1,11,凱基-永和,2024-06-17,9207
2383,台光電,12,2,10,凱基-永和,2024-06-17,9207
2515,中工,10,0,10,凱基-永和,2024-06-17,9207
3376,新日興,10,0,10,凱基-永和,2024-06-17,9207
5469,瀚宇博,10,0,10,凱基-永和,2024-06-17,9207
6695,芯鼎,9,0,9,凱基-永和,2024-06-17,9207
4532,瑞智,27,19,8,凱基-永和,2024-06-17,9207
2392,正崴,14,6,8,凱基-永和,2024-06-17,9207
2609,陽明,24,16,8,凱基-永和,2024-06-17,9207
8277,商丞,400,0,400,凱基-永和,2024-06-18,9207
00933B,國泰10Y+金融債,229,0,229,凱基-永和,2024-06-18,9207
5443,均豪,312,124,188,凱基-永和,2024-06-18,9207
3062,建漢,101,0,101,凱基-永和,2024-06-18,9207
00632R,元大台灣50反1,80,0,80,凱基-永和,2024-06-18,9207
00942B,台新美A公司債20+,61,0,61,凱基-永和,2024-06-18,9207
2027,大成鋼,43,0,43,凱基-永和,2024-06-18,9207
3362,先進光,40,0,40,凱基-永和,2024-06-18,9207
2915,潤泰全,30,0,30,凱基-永和,2024-06-18,9207
3008,大立光,32,2,30,凱基-永和,2024-06-18,9207
9945,潤泰新,31,2,29,凱基-永和,2024-06-18,9207
1785,光洋科,30,3,27,凱基-永和,2024-06-18,9207
00937B,群益ESG投等債20,26,0,26,凱基-永和,2024-06-18,9207
6116,彩晶,26,0,26,凱基-永和,2024-06-18,9207
2317,鴻海,35,11,24,凱基-永和,2024-06-18,9207
00936,台新永續高息中小,20,0,20,凱基-永和,2024-06-18,9207
4534,慶騰,20,0,20,凱基-永和,2024-06-18,9207
6592,和潤企業,20,0,20,凱基-永和,2024-06-18,9207
8064,東捷,510,490,20,凱基-永和,2024-06-18,9207
8147,正淩,20,0,20,凱基-永和,2024-06-18,9207
00918,大華優利高填息30,21,1,20,凱基-永和,2024-06-18,9207
2486,一詮,54,34,20,凱基-永和,2024-06-18,9207
1444,力麗,16,0,16,凱基-永和,2024-06-18,9207
1802,台玻,18,3,15,凱基-永和,2024-06-18,9207
3317,尼克森,14,0,14,凱基-永和,2024-06-18,9207
6182,合晶,13,0,13,凱基-永和,2024-06-18,9207
00687B,國泰20年美債,12,0,12,凱基-永和,2024-06-18,9207
00948B,中信優息投資級債,11,0,11,凱基-永和,2024-06-18,9207
2303,聯電,11,0,11,凱基-永和,2024-06-18,9207
2371,大同,22,11,11,凱基-永和,2024-06-18,9207
6261,久元,10,0,10,凱基-永和,2024-06-18,9207
6462,神盾,10,0,10,凱基-永和,2024-06-18,9207
00673R,期元大S＆P原油反1,10,0,10,凱基-永和,2024-06-18,9207
2367,燿華,10,0,10,凱基-永和,2024-06-18,9207
2483,百容,10,0,10,凱基-永和,2024-06-18,9207
3540,曜越,10,0,10,凱基-永和,2024-06-18,9207
3611,鼎翰,10,0,10,凱基-永和,2024-06-18,9207
3048,益登,10,0,10,凱基-永和,2024-06-18,9207
00878,國泰永續高股息,10,0,10,凱基-永和,2024-06-18,9207
2330,台積電,12,3,9,凱基-永和,2024-06-18,9207
8097,常珵,9,0,9,凱基-永和,2024-06-18,9207
2353,宏��,18,9,9,凱基-永和,2024-06-18,9207
6139,亞翔,19,10,9,凱基-永和,2024-06-18,9207
1504,東元,8,0,8,凱基-永和,2024-06-18,9207
2301,光寶科,8,0,8,凱基-永和,2024-06-18,9207
2515,中工,10,2,8,凱基-永和,2024-06-18,9207
2363,矽統,30,22,8,凱基-永和,2024-06-18,9207
1301,台塑,7,0,7,凱基-永和,2024-06-18,9207
9105,泰金寶-DR,7,0,7,凱基-永和,2024-06-18,9207
3450,聯鈞,308,301,7,凱基-永和,2024-06-18,9207
1785,光洋科,425,141,284,凱基-永和,2024-06-19,9207
2323,中環,250,0,250,凱基-永和,2024-06-19,9207
4909,新復興,201,3,198,凱基-永和,2024-06-19,9207
2330,台積電,167,7,160,凱基-永和,2024-06-19,9207
00632R,元大台灣50反1,129,10,119,凱基-永和,2024-06-19,9207
6770,力積電,116,3,113,凱基-永和,2024-06-19,9207
2316,楠梓電,100,0,100,凱基-永和,2024-06-19,9207
00933B,國泰10Y+金融債,92,16,76,凱基-永和,2024-06-19,9207
3055,蔚華科,70,0,70,凱基-永和,2024-06-19,9207
8277,商丞,767,702,65,凱基-永和,2024-06-19,9207
00937B,群益ESG投等債20,54,1,53,凱基-永和,2024-06-19,9207
6227,茂綸,50,0,50,凱基-永和,2024-06-19,9207
2449,京元電子,52,5,47,凱基-永和,2024-06-19,9207
1815,富喬,34,2,32,凱基-永和,2024-06-19,9207
4306,炎洲,30,0,30,凱基-永和,2024-06-19,9207
2504,國產,26,1,25,凱基-永和,2024-06-19,9207
2887,台新金,23,0,23,凱基-永和,2024-06-19,9207
1303,南亞,21,0,21,凱基-永和,2024-06-19,9207
00936,台新永續高息中小,27,7,20,凱基-永和,2024-06-19,9207
6016,康和證,20,0,20,凱基-永和,2024-06-19,9207
00679B,元大美債20年,27,7,20,凱基-永和,2024-06-19,9207
00680L,元大美債20正2,22,5,17,凱基-永和,2024-06-19,9207
4714,永捷,20,3,17,凱基-永和,2024-06-19,9207
2353,宏��,17,0,17,凱基-永和,2024-06-19,9207
5351,鈺創,15,0,15,凱基-永和,2024-06-19,9207
00940,元大台灣價值高息,19,6,13,凱基-永和,2024-06-19,9207
00713,元大台灣高息低波,13,0,13,凱基-永和,2024-06-19,9207
2027,大成鋼,11,0,11,凱基-永和,2024-06-19,9207
3419,譁裕,11,0,11,凱基-永和,2024-06-19,9207
00948B,中信優息投資級債,10,0,10,凱基-永和,2024-06-19,9207
1722,台肥,10,0,10,凱基-永和,2024-06-19,9207
2498,宏達電,10,0,10,凱基-永和,2024-06-19,9207
2641,正德,10,0,10,凱基-永和,2024-06-19,9207
2897,王道銀行,10,0,10,凱基-永和,2024-06-19,9207
3540,曜越,10,0,10,凱基-永和,2024-06-19,9207
5230,雷笛克光學,10,0,10,凱基-永和,2024-06-19,9207
6265,方土昶,17,7,10,凱基-永和,2024-06-19,9207
8097,常珵,10,0,10,凱基-永和,2024-06-19,9207
3013,晟銘電,11,2,9,凱基-永和,2024-06-19,9207
2883,凱基金,31,23,8,凱基-永和,2024-06-19,9207
2337,旺宏,20,12,8,凱基-永和,2024-06-19,9207
5871,中租-KY,7,0,7,凱基-永和,2024-06-19,9207
00687B,國泰20年美債,12,5,7,凱基-永和,2024-06-19,9207
00673R,期元大S＆P原油反1,7,0,7,凱基-永和,2024-06-19,9207
2476,鉅祥,8,1,7,凱基-永和,2024-06-19,9207
6202,盛群,7,0,7,凱基-永和,2024-06-19,9207
8438,昶昕,7,0,7,凱基-永和,2024-06-19,9207
2317,鴻海,41,34,7,凱基-永和,2024-06-19,9207
3005,神基,6,0,6,凱基-永和,2024-06-19,9207
3622,洋華,6,0,6,凱基-永和,2024-06-19,9207
5443,均豪,575,64,511,凱基-永和,2024-06-20,9207
8105,凌巨,500,6,494,凱基-永和,2024-06-20,9207
3062,建漢,928,703,225,凱基-永和,2024-06-20,9207
1785,光洋科,180,4,176,凱基-永和,2024-06-20,9207
2618,長榮航,120,1,119,凱基-永和,2024-06-20,9207
2467,志聖,114,4,110,凱基-永和,2024-06-20,9207
3006,晶豪科,100,7,93,凱基-永和,2024-06-20,9207
00665L,富邦�琤肭磪囓�2,180,88,92,凱基-永和,2024-06-20,9207
2338,光罩,71,4,67,凱基-永和,2024-06-20,9207
1605,華新,64,10,54,凱基-永和,2024-06-20,9207
00942B,台新美A公司債20+,53,0,53,凱基-永和,2024-06-20,9207
2388,威盛,53,2,51,凱基-永和,2024-06-20,9207
5864,致和證,50,0,50,凱基-永和,2024-06-20,9207
00929,復華台灣科技優息,41,2,39,凱基-永和,2024-06-20,9207
3583,辛耘,101,67,34,凱基-永和,2024-06-20,9207
00632R,元大台灣50反1,32,0,32,凱基-永和,2024-06-20,9207
1453,大將,30,0,30,凱基-永和,2024-06-20,9207
3055,蔚華科,51,21,30,凱基-永和,2024-06-20,9207
3362,先進光,30,0,30,凱基-永和,2024-06-20,9207
8054,安國,55,26,29,凱基-永和,2024-06-20,9207
6217,中探針,28,0,28,凱基-永和,2024-06-20,9207
00687B,國泰20年美債,39,12,27,凱基-永和,2024-06-20,9207
2353,宏��,26,0,26,凱基-永和,2024-06-20,9207
3711,日月光投控,26,1,25,凱基-永和,2024-06-20,9207
00933B,國泰10Y+金融債,25,0,25,凱基-永和,2024-06-20,9207
2610,華航,21,1,20,凱基-永和,2024-06-20,9207
4142,國光生,20,0,20,凱基-永和,2024-06-20,9207
2002,中鋼,20,0,20,凱基-永和,2024-06-20,9207
6531,愛普*,26,9,17,凱基-永和,2024-06-20,9207
2365,昆盈,49,32,17,凱基-永和,2024-06-20,9207
2330,台積電,18,2,16,凱基-永和,2024-06-20,9207
00936,台新永續高息中小,14,0,14,凱基-永和,2024-06-20,9207
4915,致伸,14,1,13,凱基-永和,2024-06-20,9207
00679B,元大美債20年,14,2,12,凱基-永和,2024-06-20,9207
2376,技嘉,15,3,12,凱基-永和,2024-06-20,9207
3035,智原,21,9,12,凱基-永和,2024-06-20,9207
00937B,群益ESG投等債20,12,1,11,凱基-永和,2024-06-20,9207
2324,仁寶,11,0,11,凱基-永和,2024-06-20,9207
00697B,元大美債7-10,10,0,10,凱基-永和,2024-06-20,9207
00637L,元大滬深300正2,10,0,10,凱基-永和,2024-06-20,9207
2515,中工,10,0,10,凱基-永和,2024-06-20,9207
3047,訊舟,14,4,10,凱基-永和,2024-06-20,9207
8085,福華,10,0,10,凱基-永和,2024-06-20,9207
2548,華固,10,0,10,凱基-永和,2024-06-20,9207
00891,中信關鍵半導體,9,0,9,凱基-永和,2024-06-20,9207
1402,遠東新,10,1,9,凱基-永和,2024-06-20,9207
2356,英業達,30,22,8,凱基-永和,2024-06-20,9207
1609,大亞,12,4,8,凱基-永和,2024-06-20,9207
2329,華泰,24,16,8,凱基-永和,2024-06-20,9207
2301,光寶科,8,1,7,凱基-永和,2024-06-20,9207
2317,鴻海,507,16,491,凱基-永和,2024-06-21,9207
00665L,富邦�琤肭磪囓�2,412,0,412,凱基-永和,2024-06-21,9207
3025,星通,203,3,200,凱基-永和,2024-06-21,9207
2489,瑞軒,701,507,194,凱基-永和,2024-06-21,9207
00919,群益台灣精選高息,203,14,189,凱基-永和,2024-06-21,9207
2308,台達電,166,3,163,凱基-永和,2024-06-21,9207
2609,陽明,196,76,120,凱基-永和,2024-06-21,9207
6443,元晶,120,3,117,凱基-永和,2024-06-21,9207
8064,東捷,646,554,92,凱基-永和,2024-06-21,9207
6449,鈺邦,249,195,54,凱基-永和,2024-06-21,9207
6290,良維,50,0,50,凱基-永和,2024-06-21,9207
00637L,元大滬深300正2,51,5,46,凱基-永和,2024-06-21,9207
1605,華新,53,7,46,凱基-永和,2024-06-21,9207
00937B,群益ESG投等債20,47,6,41,凱基-永和,2024-06-21,9207
5234,達興材料,90,50,40,凱基-永和,2024-06-21,9207
00933B,國泰10Y+金融債,38,0,38,凱基-永和,2024-06-21,9207
1785,光洋科,34,11,23,凱基-永和,2024-06-21,9207
2515,中工,22,2,20,凱基-永和,2024-06-21,9207
2882,國泰金,21,1,20,凱基-永和,2024-06-21,9207
3481,群創,162,143,19,凱基-永和,2024-06-21,9207
3711,日月光投控,20,3,17,凱基-永和,2024-06-21,9207
3702,大聯大,21,4,17,凱基-永和,2024-06-21,9207
2368,金像電,18,2,16,凱基-永和,2024-06-21,9207
00946,群益科技高息成長,13,0,13,凱基-永和,2024-06-21,9207
6117,迎廣,13,0,13,凱基-永和,2024-06-21,9207
2603,長榮,16,4,12,凱基-永和,2024-06-21,9207
3264,欣銓,12,0,12,凱基-永和,2024-06-21,9207
6667,信紘科,12,0,12,凱基-永和,2024-06-21,9207
2382,廣達,16,5,11,凱基-永和,2024-06-21,9207
2330,台積電,14,3,11,凱基-永和,2024-06-21,9207
6643,M31,11,0,11,凱基-永和,2024-06-21,9207
6176,瑞儀,15,4,11,凱基-永和,2024-06-21,9207
00929,復華台灣科技優息,40,30,10,凱基-永和,2024-06-21,9207
00936,台新永續高息中小,10,0,10,凱基-永和,2024-06-21,9207
1453,大將,10,0,10,凱基-永和,2024-06-21,9207
2483,百容,10,0,10,凱基-永和,2024-06-21,9207
2897,王道銀行,10,0,10,凱基-永和,2024-06-21,9207
6115,鎰勝,10,0,10,凱基-永和,2024-06-21,9207
8096,擎亞,10,0,10,凱基-永和,2024-06-21,9207
9919,康那香,10,0,10,凱基-永和,2024-06-21,9207
3005,神基,10,0,10,凱基-永和,2024-06-21,9207
3036,文曄,10,0,10,凱基-永和,2024-06-21,9207
006208,富邦台50,9,0,9,凱基-永和,2024-06-21,9207
3035,智原,19,10,9,凱基-永和,2024-06-21,9207
1514,亞力,9,0,9,凱基-永和,2024-06-21,9207
2101,南港,14,5,9,凱基-永和,2024-06-21,9207
2301,光寶科,9,0,9,凱基-永和,2024-06-21,9207
2303,聯電,20,11,9,凱基-永和,2024-06-21,9207
00948B,中信優息投資級債,8,0,8,凱基-永和,2024-06-21,9207
5607,遠雄港,8,0,8,凱基-永和,2024-06-21,9207
2449,京元電子,738,70,668,凱基-永和,2024-06-24,9207
3149,正達,200,0,200,凱基-永和,2024-06-24,9207
2317,鴻海,151,15,136,凱基-永和,2024-06-24,9207
00919,群益台灣精選高息,182,54,128,凱基-永和,2024-06-24,9207
00929,復華台灣科技優息,129,1,128,凱基-永和,2024-06-24,9207
3481,群創,177,82,95,凱基-永和,2024-06-24,9207
00892,富邦台灣半導體,57,3,54,凱基-永和,2024-06-24,9207
2467,志聖,160,109,51,凱基-永和,2024-06-24,9207
00947,台新臺灣IC設計,41,0,41,凱基-永和,2024-06-24,9207
4566,時碩工業,40,0,40,凱基-永和,2024-06-24,9207
00937B,群益ESG投等債20,35,0,35,凱基-永和,2024-06-24,9207
00687B,國泰20年美債,32,1,31,凱基-永和,2024-06-24,9207
2369,菱生,27,0,27,凱基-永和,2024-06-24,9207
00918,大華優利高填息30,23,0,23,凱基-永和,2024-06-24,9207
00770,國泰北美科技,21,0,21,凱基-永和,2024-06-24,9207
00720B,元大投資級公司債,20,0,20,凱基-永和,2024-06-24,9207
1605,華新,20,0,20,凱基-永和,2024-06-24,9207
1785,光洋科,31,11,20,凱基-永和,2024-06-24,9207
6116,彩晶,52,32,20,凱基-永和,2024-06-24,9207
8027,鈦昇,20,0,20,凱基-永和,2024-06-24,9207
2101,南港,24,5,19,凱基-永和,2024-06-24,9207
00936,台新永續高息中小,24,10,14,凱基-永和,2024-06-24,9207
00652,富邦印度,15,1,14,凱基-永和,2024-06-24,9207
00878,國泰永續高股息,16,3,13,凱基-永和,2024-06-24,9207
00712,復華富時不動產,12,0,12,凱基-永和,2024-06-24,9207
6026,福邦證,12,0,12,凱基-永和,2024-06-24,9207
00948B,中信優息投資級債,11,0,11,凱基-永和,2024-06-24,9207
2352,佳世達,11,0,11,凱基-永和,2024-06-24,9207
1560,中砂,10,0,10,凱基-永和,2024-06-24,9207
2354,鴻準,12,2,10,凱基-永和,2024-06-24,9207
2506,太設,10,0,10,凱基-永和,2024-06-24,9207
2515,中工,10,0,10,凱基-永和,2024-06-24,9207
2597,潤弘,10,0,10,凱基-永和,2024-06-24,9207
2634,漢翔,10,0,10,凱基-永和,2024-06-24,9207
3062,建漢,46,36,10,凱基-永和,2024-06-24,9207
6120,達運,10,0,10,凱基-永和,2024-06-24,9207
6176,瑞儀,11,1,10,凱基-永和,2024-06-24,9207
8085,福華,10,0,10,凱基-永和,2024-06-24,9207
8277,商丞,10,0,10,凱基-永和,2024-06-24,9207
2324,仁寶,13,4,9,凱基-永和,2024-06-24,9207
2609,陽明,14,5,9,凱基-永和,2024-06-24,9207
2464,盟立,24,15,9,凱基-永和,2024-06-24,9207
2337,旺宏,10,1,9,凱基-永和,2024-06-24,9207
4532,瑞智,10,1,9,凱基-永和,2024-06-24,9207
00891,中信關鍵半導體,10,2,8,凱基-永和,2024-06-24,9207
3218,大學光,7,0,7,凱基-永和,2024-06-24,9207
00683L,期元大美元指正2,7,0,7,凱基-永和,2024-06-24,9207
2301,光寶科,7,0,7,凱基-永和,2024-06-24,9207
3048,益登,9,2,7,凱基-永和,2024-06-24,9207
4108,懷特,8,1,7,凱基-永和,2024-06-24,9207
00878,國泰永續高股息,568,6,562,凱基-永和,2024-06-25,9207
3481,群創,123,28,95,凱基-永和,2024-06-25,9207
2449,京元電子,267,178,89,凱基-永和,2024-06-25,9207
2317,鴻海,98,10,88,凱基-永和,2024-06-25,9207
3163,波若威,81,1,80,凱基-永和,2024-06-25,9207
00929,復華台灣科技優息,80,7,73,凱基-永和,2024-06-25,9207
8054,安國,56,0,56,凱基-永和,2024-06-25,9207
2467,志聖,60,10,50,凱基-永和,2024-06-25,9207
2363,矽統,42,1,41,凱基-永和,2024-06-25,9207
2883,凱基金,43,4,39,凱基-永和,2024-06-25,9207
00687B,國泰20年美債,40,6,34,凱基-永和,2024-06-25,9207
00940,元大台灣價值高息,51,20,31,凱基-永和,2024-06-25,9207
3055,蔚華科,230,200,30,凱基-永和,2024-06-25,9207
4956,光鋐,33,4,29,凱基-永和,2024-06-25,9207
00919,群益台灣精選高息,48,26,22,凱基-永和,2024-06-25,9207
2327,國巨,21,0,21,凱基-永和,2024-06-25,9207
1303,南亞,20,0,20,凱基-永和,2024-06-25,9207
2465,麗臺,20,0,20,凱基-永和,2024-06-25,9207
2408,南亞科,17,0,17,凱基-永和,2024-06-25,9207
00936,台新永續高息中小,14,0,14,凱基-永和,2024-06-25,9207
2312,金寶,14,1,13,凱基-永和,2024-06-25,9207
3580,友威科,48,35,13,凱基-永和,2024-06-25,9207
00830,國泰費城半導體,54,42,12,凱基-永和,2024-06-25,9207
3035,智原,12,1,11,凱基-永和,2024-06-25,9207
5531,鄉林,11,0,11,凱基-永和,2024-06-25,9207
2897,王道銀行,11,0,11,凱基-永和,2024-06-25,9207
2483,百容,10,0,10,凱基-永和,2024-06-25,9207
3540,曜越,10,0,10,凱基-永和,2024-06-25,9207
4526,東台,10,0,10,凱基-永和,2024-06-25,9207
4532,瑞智,21,11,10,凱基-永和,2024-06-25,9207
5283,禾聯碩,10,0,10,凱基-永和,2024-06-25,9207
6109,亞元,10,0,10,凱基-永和,2024-06-25,9207
2392,正崴,12,3,9,凱基-永和,2024-06-25,9207
3037,欣興,7,0,7,凱基-永和,2024-06-25,9207
00946,群益科技高息成長,7,0,7,凱基-永和,2024-06-25,9207
2610,華航,23,16,7,凱基-永和,2024-06-25,9207
6509,聚和,7,0,7,凱基-永和,2024-06-25,9207
2303,聯電,8,1,7,凱基-永和,2024-06-25,9207
2542,興富發,8,1,7,凱基-永和,2024-06-25,9207
1102,亞泥,6,0,6,凱基-永和,2024-06-25,9207
8046,南電,7,1,6,凱基-永和,2024-06-25,9207
00947,台新臺灣IC設計,6,0,6,凱基-永和,2024-06-25,9207
1802,台玻,7,1,6,凱基-永和,2024-06-25,9207
2377,微星,6,0,6,凱基-永和,2024-06-25,9207
3576,聯合再生,6,0,6,凱基-永和,2024-06-25,9207
6170,統振,6,0,6,凱基-永和,2024-06-25,9207
8110,華東,9,3,6,凱基-永和,2024-06-25,9207
2489,瑞軒,5,0,5,凱基-永和,2024-06-25,9207
5351,鈺創,5,0,5,凱基-永和,2024-06-25,9207
3231,緯創,12,7,5,凱基-永和,2024-06-25,9207
8277,商丞,601,10,591,凱基-永和,2024-06-26,9207
5443,均豪,600,204,396,凱基-永和,2024-06-26,9207
3055,蔚華科,334,95,239,凱基-永和,2024-06-26,9207
4167,松瑞藥,212,14,198,凱基-永和,2024-06-26,9207
2317,鴻海,209,12,197,凱基-永和,2024-06-26,9207
6207,雷科,102,1,101,凱基-永和,2024-06-26,9207
8105,凌巨,52,0,52,凱基-永和,2024-06-26,9207
6139,亞翔,68,18,50,凱基-永和,2024-06-26,9207
2354,鴻準,47,1,46,凱基-永和,2024-06-26,9207
2409,友達,38,0,38,凱基-永和,2024-06-26,9207
00720B,元大投資級公司債,37,0,37,凱基-永和,2024-06-26,9207
00795B,中信美國公債20年,35,0,35,凱基-永和,2024-06-26,9207
4994,傳奇,30,0,30,凱基-永和,2024-06-26,9207
00915,凱基優選高股息30,25,0,25,凱基-永和,2024-06-26,9207
2406,國碩,25,1,24,凱基-永和,2024-06-26,9207
2855,統一證,22,0,22,凱基-永和,2024-06-26,9207
00679B,元大美債20年,21,0,21,凱基-永和,2024-06-26,9207
2467,志聖,120,100,20,凱基-永和,2024-06-26,9207
2002,中鋼,19,0,19,凱基-永和,2024-06-26,9207
6695,芯鼎,32,13,19,凱基-永和,2024-06-26,9207
00929,復華台灣科技優息,18,1,17,凱基-永和,2024-06-26,9207
2615,萬海,40,24,16,凱基-永和,2024-06-26,9207
2408,南亞科,15,0,15,凱基-永和,2024-06-26,9207
00936,台新永續高息中小,13,0,13,凱基-永和,2024-06-26,9207
2303,聯電,14,1,13,凱基-永和,2024-06-26,9207
5351,鈺創,26,13,13,凱基-永和,2024-06-26,9207
3702,大聯大,12,0,12,凱基-永和,2024-06-26,9207
4566,時碩工業,23,11,12,凱基-永和,2024-06-26,9207
3535,晶彩科,73,61,12,凱基-永和,2024-06-26,9207
3036,文曄,12,0,12,凱基-永和,2024-06-26,9207
3481,群創,43,32,11,凱基-永和,2024-06-26,9207
2427,三商電,10,0,10,凱基-永和,2024-06-26,9207
1785,光洋科,46,36,10,凱基-永和,2024-06-26,9207
00881,國泰台灣5G+,10,0,10,凱基-永和,2024-06-26,9207
1325,恆大,10,0,10,凱基-永和,2024-06-26,9207
1402,遠東新,10,0,10,凱基-永和,2024-06-26,9207
2834,臺企銀,10,0,10,凱基-永和,2024-06-26,9207
3520,華盈,10,0,10,凱基-永和,2024-06-26,9207
4105,東洋,10,0,10,凱基-永和,2024-06-26,9207
911868,同方友友-DR,10,0,10,凱基-永和,2024-06-26,9207
1101,台泥,10,0,10,凱基-永和,2024-06-26,9207
00878,國泰永續高股息,9,0,9,凱基-永和,2024-06-26,9207
1301,台塑,13,5,8,凱基-永和,2024-06-26,9207
3081,聯亞,15,7,8,凱基-永和,2024-06-26,9207
2609,陽明,22,15,7,凱基-永和,2024-06-26,9207
2412,中華電,7,0,7,凱基-永和,2024-06-26,9207
3548,兆利,7,0,7,凱基-永和,2024-06-26,9207
9945,潤泰新,7,0,7,凱基-永和,2024-06-26,9207
00937B,群益ESG投等債20,25,19,6,凱基-永和,2024-06-26,9207
00946,群益科技高息成長,6,0,6,凱基-永和,2024-06-26,9207
00878,國泰永續高股息,1822,0,1822,凱基-永和,2024-06-27,9207
2349,錸德,1157,216,941,凱基-永和,2024-06-27,9207
00937B,群益ESG投等債20,151,0,151,凱基-永和,2024-06-27,9207
2465,麗臺,150,0,150,凱基-永和,2024-06-27,9207
4549,桓達,98,0,98,凱基-永和,2024-06-27,9207
6189,豐藝,99,1,98,凱基-永和,2024-06-27,9207
00929,復華台灣科技優息,66,5,61,凱基-永和,2024-06-27,9207
4908,前鼎,374,319,55,凱基-永和,2024-06-27,9207
2002,中鋼,51,0,51,凱基-永和,2024-06-27,9207
6116,彩晶,50,0,50,凱基-永和,2024-06-27,9207
2885,元大金,45,0,45,凱基-永和,2024-06-27,9207
00795B,中信美國公債20年,39,0,39,凱基-永和,2024-06-27,9207
2337,旺宏,28,0,28,凱基-永和,2024-06-27,9207
2317,鴻海,50,23,27,凱基-永和,2024-06-27,9207
00679B,元大美債20年,23,1,22,凱基-永和,2024-06-27,9207
1314,中石化,22,0,22,凱基-永和,2024-06-27,9207
4938,和碩,23,1,22,凱基-永和,2024-06-27,9207
00687B,國泰20年美債,20,0,20,凱基-永和,2024-06-27,9207
00933B,國泰10Y+金融債,20,0,20,凱基-永和,2024-06-27,9207
2883B,凱基金乙特,20,0,20,凱基-永和,2024-06-27,9207
2883,凱基金,21,1,20,凱基-永和,2024-06-27,9207
1709,和益,21,2,19,凱基-永和,2024-06-27,9207
2515,中工,17,2,15,凱基-永和,2024-06-27,9207
3520,華盈,20,5,15,凱基-永和,2024-06-27,9207
2884,玉山金,14,0,14,凱基-永和,2024-06-27,9207
6414,樺漢,13,0,13,凱基-永和,2024-06-27,9207
2101,南港,13,0,13,凱基-永和,2024-06-27,9207
8064,東捷,18,5,13,凱基-永和,2024-06-27,9207
1802,台玻,12,0,12,凱基-永和,2024-06-27,9207
3037,欣興,11,0,11,凱基-永和,2024-06-27,9207
3047,訊舟,84,73,11,凱基-永和,2024-06-27,9207
2449,京元電子,12,2,10,凱基-永和,2024-06-27,9207
00893,國泰智能電動車,10,0,10,凱基-永和,2024-06-27,9207
00947,台新臺灣IC設計,10,0,10,凱基-永和,2024-06-27,9207
1325,恆大,10,0,10,凱基-永和,2024-06-27,9207
2359,所羅門,10,0,10,凱基-永和,2024-06-27,9207
2419,仲琦,10,0,10,凱基-永和,2024-06-27,9207
3027,盛達,10,0,10,凱基-永和,2024-06-27,9207
6129,普誠,10,0,10,凱基-永和,2024-06-27,9207
6235,華孚,17,7,10,凱基-永和,2024-06-27,9207
8038,長園科,10,0,10,凱基-永和,2024-06-27,9207
00946,群益科技高息成長,9,0,9,凱基-永和,2024-06-27,9207
1785,光洋科,16,7,9,凱基-永和,2024-06-27,9207
5371,中光電,9,0,9,凱基-永和,2024-06-27,9207
2303,聯電,10,1,9,凱基-永和,2024-06-27,9207
3481,群創,39,31,8,凱基-永和,2024-06-27,9207
6188,廣明,8,0,8,凱基-永和,2024-06-27,9207
1444,力麗,8,0,8,凱基-永和,2024-06-27,9207
6446,藥華藥,12,5,7,凱基-永和,2024-06-27,9207
1102,亞泥,7,0,7,凱基-永和,2024-06-27,9207
2618,長榮航,360,10,350,凱基-永和,2024-06-28,9207
2495,普安,200,0,200,凱基-永和,2024-06-28,9207
3105,穩懋,234,65,169,凱基-永和,2024-06-28,9207
2374,佳能,170,19,151,凱基-永和,2024-06-28,9207
3202,樺晟,118,1,117,凱基-永和,2024-06-28,9207
4562,穎漢,101,6,95,凱基-永和,2024-06-28,9207
3017,奇鋐,70,4,66,凱基-永和,2024-06-28,9207
00929,復華台灣科技優息,71,10,61,凱基-永和,2024-06-28,9207
2455,全新,50,0,50,凱基-永和,2024-06-28,9207
6215,和椿,100,50,50,凱基-永和,2024-06-28,9207
00679B,元大美債20年,49,0,49,凱基-永和,2024-06-28,9207
2323,中環,30,2,28,凱基-永和,2024-06-28,9207
6187,萬潤,27,0,27,凱基-永和,2024-06-28,9207
00680L,元大美債20正2,23,0,23,凱基-永和,2024-06-28,9207
2605,新興,22,0,22,凱基-永和,2024-06-28,9207
2337,旺宏,43,22,21,凱基-永和,2024-06-28,9207
6244,茂迪,40,19,21,凱基-永和,2024-06-28,9207
00937B,群益ESG投等債20,20,0,20,凱基-永和,2024-06-28,9207
3576,聯合再生,26,6,20,凱基-永和,2024-06-28,9207
6216,居易,20,0,20,凱基-永和,2024-06-28,9207
3362,先進光,19,0,19,凱基-永和,2024-06-28,9207
00936,台新永續高息中小,18,0,18,凱基-永和,2024-06-28,9207
1785,光洋科,26,10,16,凱基-永和,2024-06-28,9207
2882,國泰金,26,11,15,凱基-永和,2024-06-28,9207
4956,光鋐,20,6,14,凱基-永和,2024-06-28,9207
00632R,元大台灣50反1,23,10,13,凱基-永和,2024-06-28,9207
2406,國碩,22,9,13,凱基-永和,2024-06-28,9207
2027,大成鋼,12,0,12,凱基-永和,2024-06-28,9207
2610,華航,25,14,11,凱基-永和,2024-06-28,9207
4167,松瑞藥,11,0,11,凱基-永和,2024-06-28,9207
4526,東台,11,0,11,凱基-永和,2024-06-28,9207
4938,和碩,11,0,11,凱基-永和,2024-06-28,9207
00673R,期元大S＆P原油反1,10,0,10,凱基-永和,2024-06-28,9207
00697B,元大美債7-10,10,0,10,凱基-永和,2024-06-28,9207
3037,欣興,10,0,10,凱基-永和,2024-06-28,9207
6202,盛群,9,0,9,凱基-永和,2024-06-28,9207
0056,元大高股息,10,2,8,凱基-永和,2024-06-28,9207
8358,金居,10,2,8,凱基-永和,2024-06-28,9207
00712,復華富時不動產,7,0,7,凱基-永和,2024-06-28,9207
2352,佳世達,7,0,7,凱基-永和,2024-06-28,9207
1609,大亞,9,2,7,凱基-永和,2024-06-28,9207
6470,宇智,6,0,6,凱基-永和,2024-06-28,9207
2303,聯電,10,4,6,凱基-永和,2024-06-28,9207
00933B,國泰10Y+金融債,5,0,5,凱基-永和,2024-06-28,9207
00696B,富邦美債20年,5,0,5,凱基-永和,2024-06-28,9207
2884,玉山金,5,0,5,凱基-永和,2024-06-28,9207
3227,原相,5,0,5,凱基-永和,2024-06-28,9207
4903,聯光通,5,0,5,凱基-永和,2024-06-28,9207
8096,擎亞,8,3,5,凱基-永和,2024-06-28,9207
9958,世紀鋼,5,0,5,凱基-永和,2024-06-28,9207
8064,東捷,213,28,185,凱基-永和,2024-07-01,9207
6425,易發,155,10,145,凱基-永和,2024-07-01,9207
2495,普安,204,91,113,凱基-永和,2024-07-01,9207
2349,錸德,709,599,110,凱基-永和,2024-07-01,9207
6189,豐藝,152,50,102,凱基-永和,2024-07-01,9207
8374,羅昇,101,1,100,凱基-永和,2024-07-01,9207
3615,安可,204,105,99,凱基-永和,2024-07-01,9207
00751B,元大AAA至A公司債,81,0,81,凱基-永和,2024-07-01,9207
3017,奇鋐,61,2,59,凱基-永和,2024-07-01,9207
00674R,期元大S＆P黃金反1,58,0,58,凱基-永和,2024-07-01,9207
00720B,元大投資級公司債,51,0,51,凱基-永和,2024-07-01,9207
2371,大同,54,4,50,凱基-永和,2024-07-01,9207
2467,志聖,212,171,41,凱基-永和,2024-07-01,9207
6207,雷科,41,2,39,凱基-永和,2024-07-01,9207
00795B,中信美國公債20年,37,0,37,凱基-永和,2024-07-01,9207
2365,昆盈,45,16,29,凱基-永和,2024-07-01,9207
2615,萬海,42,15,27,凱基-永和,2024-07-01,9207
6187,萬潤,28,2,26,凱基-永和,2024-07-01,9207
00680L,元大美債20正2,25,0,25,凱基-永和,2024-07-01,9207
8086,宏捷科,25,0,25,凱基-永和,2024-07-01,9207
00937B,群益ESG投等債20,24,0,24,凱基-永和,2024-07-01,9207
2359,所羅門,37,15,22,凱基-永和,2024-07-01,9207
00687B,國泰20年美債,22,1,21,凱基-永和,2024-07-01,9207
00931B,統一美債20年,20,0,20,凱基-永和,2024-07-01,9207
00632R,元大台灣50反1,30,10,20,凱基-永和,2024-07-01,9207
00948B,中信優息投資級債,20,0,20,凱基-永和,2024-07-01,9207
2405,輔信,20,0,20,凱基-永和,2024-07-01,9207
6116,彩晶,20,0,20,凱基-永和,2024-07-01,9207
8070,長華*,25,5,20,凱基-永和,2024-07-01,9207
00679B,元大美債20年,19,0,19,凱基-永和,2024-07-01,9207
2618,長榮航,21,3,18,凱基-永和,2024-07-01,9207
1785,光洋科,18,1,17,凱基-永和,2024-07-01,9207
2303,聯電,27,12,15,凱基-永和,2024-07-01,9207
00933B,國泰10Y+金融債,15,0,15,凱基-永和,2024-07-01,9207
0056,元大高股息,15,0,15,凱基-永和,2024-07-01,9207
6133,金橋,14,0,14,凱基-永和,2024-07-01,9207
4167,松瑞藥,12,0,12,凱基-永和,2024-07-01,9207
2317,鴻海,23,12,11,凱基-永和,2024-07-01,9207
1514,亞力,12,1,11,凱基-永和,2024-07-01,9207
4562,穎漢,212,201,11,凱基-永和,2024-07-01,9207
2383,台光電,10,0,10,凱基-永和,2024-07-01,9207
00893,國泰智能電動車,10,0,10,凱基-永和,2024-07-01,9207
00753L,中信中國50正2,10,0,10,凱基-永和,2024-07-01,9207
2313,華通,21,11,10,凱基-永和,2024-07-01,9207
2324,仁寶,10,0,10,凱基-永和,2024-07-01,9207
3290,東浦,10,0,10,凱基-永和,2024-07-01,9207
5289,宜鼎,10,0,10,凱基-永和,2024-07-01,9207
8024,佑華,10,0,10,凱基-永和,2024-07-01,9207
1612,宏泰,9,0,9,凱基-永和,2024-07-01,9207
3205,佰研,10,1,9,凱基-永和,2024-07-01,9207
3163,波若威,271,0,271,凱基-永和,2024-07-02,9207
8069,元太,230,0,230,凱基-永和,2024-07-02,9207
4906,正文,504,315,189,凱基-永和,2024-07-02,9207
00934,中信成長高股息,142,6,136,凱基-永和,2024-07-02,9207
6189,豐藝,405,300,105,凱基-永和,2024-07-02,9207
6290,良維,103,0,103,凱基-永和,2024-07-02,9207
3622,洋華,100,0,100,凱基-永和,2024-07-02,9207
2303,聯電,220,122,98,凱基-永和,2024-07-02,9207
2344,華邦電,100,3,97,凱基-永和,2024-07-02,9207
0056,元大高股息,96,0,96,凱基-永和,2024-07-02,9207
00857B,永豐20年美公債,80,0,80,凱基-永和,2024-07-02,9207
2356,英業達,59,0,59,凱基-永和,2024-07-02,9207
6425,易發,192,139,53,凱基-永和,2024-07-02,9207
00918,大華優利高填息30,42,0,42,凱基-永和,2024-07-02,9207
6538,倉和,75,33,42,凱基-永和,2024-07-02,9207
00687B,國泰20年美債,40,0,40,凱基-永和,2024-07-02,9207
3702,大聯大,38,0,38,凱基-永和,2024-07-02,9207
2002,中鋼,42,4,38,凱基-永和,2024-07-02,9207
00795B,中信美國公債20年,37,0,37,凱基-永和,2024-07-02,9207
3563,牧德,60,25,35,凱基-永和,2024-07-02,9207
2405,輔信,34,0,34,凱基-永和,2024-07-02,9207
00679B,元大美債20年,32,0,32,凱基-永和,2024-07-02,9207
00936,台新永續高息中小,27,0,27,凱基-永和,2024-07-02,9207
3550,聯穎,25,0,25,凱基-永和,2024-07-02,9207
4968,立積,29,4,25,凱基-永和,2024-07-02,9207
3362,先進光,22,0,22,凱基-永和,2024-07-02,9207
2884,玉山金,21,1,20,凱基-永和,2024-07-02,9207
00674R,期元大S＆P黃金反1,20,0,20,凱基-永和,2024-07-02,9207
00940,元大台灣價值高息,20,0,20,凱基-永和,2024-07-02,9207
1810,和成,20,0,20,凱基-永和,2024-07-02,9207
6109,亞元,20,0,20,凱基-永和,2024-07-02,9207
6957,裕慶-KY,20,0,20,凱基-永和,2024-07-02,9207
5347,世界,41,23,18,凱基-永和,2024-07-02,9207
9105,泰金寶-DR,17,0,17,凱基-永和,2024-07-02,9207
2348,海悅,16,0,16,凱基-永和,2024-07-02,9207
4123,晟德,16,0,16,凱基-永和,2024-07-02,9207
2618,長榮航,35,19,16,凱基-永和,2024-07-02,9207
2317,鴻海,63,48,15,凱基-永和,2024-07-02,9207
00946,群益科技高息成長,15,0,15,凱基-永和,2024-07-02,9207
2357,華碩,14,0,14,凱基-永和,2024-07-02,9207
00933B,國泰10Y+金融債,13,0,13,凱基-永和,2024-07-02,9207
00937B,群益ESG投等債20,24,13,11,凱基-永和,2024-07-02,9207
2329,華泰,11,0,11,凱基-永和,2024-07-02,9207
00725B,國泰投資級公司債,10,0,10,凱基-永和,2024-07-02,9207
00948B,中信優息投資級債,10,0,10,凱基-永和,2024-07-02,9207
2101,南港,10,0,10,凱基-永和,2024-07-02,9207
2603,長榮,10,0,10,凱基-永和,2024-07-02,9207
3017,奇鋐,12,2,10,凱基-永和,2024-07-02,9207
3712,永崴投控,12,2,10,凱基-永和,2024-07-02,9207
8033,雷虎,10,0,10,凱基-永和,2024-07-02,9207
2449,京元電子,798,26,772,凱基-永和,2024-07-03,9207
6189,豐藝,503,111,392,凱基-永和,2024-07-03,9207
3163,波若威,200,1,199,凱基-永和,2024-07-03,9207
3050,鈺德,253,56,197,凱基-永和,2024-07-03,9207
3006,晶豪科,183,0,183,凱基-永和,2024-07-03,9207
2317,鴻海,167,9,158,凱基-永和,2024-07-03,9207
3450,聯鈞,125,8,117,凱基-永和,2024-07-03,9207
2455,全新,101,3,98,凱基-永和,2024-07-03,9207
8054,安國,88,1,87,凱基-永和,2024-07-03,9207
8996,高力,65,1,64,凱基-永和,2024-07-03,9207
2464,盟立,254,204,50,凱基-永和,2024-07-03,9207
8105,凌巨,50,0,50,凱基-永和,2024-07-03,9207
3680,家登,45,0,45,凱基-永和,2024-07-03,9207
00662,富邦NASDAQ,40,0,40,凱基-永和,2024-07-03,9207
2332,友訊,40,0,40,凱基-永和,2024-07-03,9207
4956,光鋐,34,0,34,凱基-永和,2024-07-03,9207
00674R,期元大S＆P黃金反1,30,0,30,凱基-永和,2024-07-03,9207
6770,力積電,30,0,30,凱基-永和,2024-07-03,9207
00936,台新永續高息中小,26,0,26,凱基-永和,2024-07-03,9207
6187,萬潤,28,3,25,凱基-永和,2024-07-03,9207
00934,中信成長高股息,26,2,24,凱基-永和,2024-07-03,9207
1536,和大,40,17,23,凱基-永和,2024-07-03,9207
2486,一詮,31,9,22,凱基-永和,2024-07-03,9207
00680L,元大美債20正2,21,0,21,凱基-永和,2024-07-03,9207
00946,群益科技高息成長,20,0,20,凱基-永和,2024-07-03,9207
2367,燿華,31,13,18,凱基-永和,2024-07-03,9207
00939,統一台灣高息動能,17,0,17,凱基-永和,2024-07-03,9207
2809,京城銀,20,3,17,凱基-永和,2024-07-03,9207
8916,光隆,17,0,17,凱基-永和,2024-07-03,9207
2886,兆豐金,21,5,16,凱基-永和,2024-07-03,9207
6182,合晶,71,55,16,凱基-永和,2024-07-03,9207
00929,復華台灣科技優息,25,10,15,凱基-永和,2024-07-03,9207
8076,伍豐,15,1,14,凱基-永和,2024-07-03,9207
00632R,元大台灣50反1,23,10,13,凱基-永和,2024-07-03,9207
3537,堡達,15,2,13,凱基-永和,2024-07-03,9207
00687B,國泰20年美債,12,0,12,凱基-永和,2024-07-03,9207
3376,新日興,12,0,12,凱基-永和,2024-07-03,9207
5347,世界,12,0,12,凱基-永和,2024-07-03,9207
6282,康舒,13,2,11,凱基-永和,2024-07-03,9207
6147,頎邦,11,0,11,凱基-永和,2024-07-03,9207
3645,達邁,14,4,10,凱基-永和,2024-07-03,9207
00937B,群益ESG投等債20,13,3,10,凱基-永和,2024-07-03,9207
3047,訊舟,128,118,10,凱基-永和,2024-07-03,9207
3550,聯穎,10,0,10,凱基-永和,2024-07-03,9207
4510,高鋒,10,0,10,凱基-永和,2024-07-03,9207
6957,裕慶-KY,10,0,10,凱基-永和,2024-07-03,9207
6741,91APP*-KY,10,0,10,凱基-永和,2024-07-03,9207
3231,緯創,14,5,9,凱基-永和,2024-07-03,9207
3018,隆銘綠能,9,0,9,凱基-永和,2024-07-03,9207
6477,安集,11,2,9,凱基-永和,2024-07-03,9207
6207,雷科,309,8,301,凱基-永和,2024-07-04,9207
3048,益登,251,0,251,凱基-永和,2024-07-04,9207
3492,長盛,200,0,200,凱基-永和,2024-07-04,9207
2363,矽統,206,8,198,凱基-永和,2024-07-04,9207
00632R,元大台灣50反1,135,5,130,凱基-永和,2024-07-04,9207
2330,台積電,95,21,74,凱基-永和,2024-07-04,9207
2323,中環,100,35,65,凱基-永和,2024-07-04,9207
4588,玖鼎電力,64,0,64,凱基-永和,2024-07-04,9207
8027,鈦昇,60,1,59,凱基-永和,2024-07-04,9207
2405,輔信,55,3,52,凱基-永和,2024-07-04,9207
6189,豐藝,301,252,49,凱基-永和,2024-07-04,9207
6257,矽格,36,0,36,凱基-永和,2024-07-04,9207
3086,華義,25,0,25,凱基-永和,2024-07-04,9207
6187,萬潤,27,2,25,凱基-永和,2024-07-04,9207
2618,長榮航,24,0,24,凱基-永和,2024-07-04,9207
2412,中華電,24,2,22,凱基-永和,2024-07-04,9207
00934,中信成長高股息,22,0,22,凱基-永和,2024-07-04,9207
3008,大立光,22,0,22,凱基-永和,2024-07-04,9207
4123,晟德,26,5,21,凱基-永和,2024-07-04,9207
00946,群益科技高息成長,20,0,20,凱基-永和,2024-07-04,9207
2032,新鋼,20,0,20,凱基-永和,2024-07-04,9207
6166,凌華,20,0,20,凱基-永和,2024-07-04,9207
3481,群創,35,16,19,凱基-永和,2024-07-04,9207
00919,群益台灣精選高息,22,6,16,凱基-永和,2024-07-04,9207
9105,泰金寶-DR,18,2,16,凱基-永和,2024-07-04,9207
5283,禾聯碩,15,0,15,凱基-永和,2024-07-04,9207
3550,聯穎,15,0,15,凱基-永和,2024-07-04,9207
3563,牧德,16,1,15,凱基-永和,2024-07-04,9207
3615,安可,13,0,13,凱基-永和,2024-07-04,9207
6698,旭暉應材,53,40,13,凱基-永和,2024-07-04,9207
6121,新普,12,0,12,凱基-永和,2024-07-04,9207
00687B,國泰20年美債,14,3,11,凱基-永和,2024-07-04,9207
2329,華泰,11,0,11,凱基-永和,2024-07-04,9207
00905,FT臺灣Smart,10,0,10,凱基-永和,2024-07-04,9207
2482,連宇,14,4,10,凱基-永和,2024-07-04,9207
2614,東森,10,0,10,凱基-永和,2024-07-04,9207
2641,正德,11,1,10,凱基-永和,2024-07-04,9207
3189,景碩,10,0,10,凱基-永和,2024-07-04,9207
3266,昇陽,10,0,10,凱基-永和,2024-07-04,9207
5488,松普,10,0,10,凱基-永和,2024-07-04,9207
00688L,國泰20年美債正2,9,0,9,凱基-永和,2024-07-04,9207
00675L,富邦臺灣加權正2,9,0,9,凱基-永和,2024-07-04,9207
6695,芯鼎,10,1,9,凱基-永和,2024-07-04,9207
2356,英業達,11,3,8,凱基-永和,2024-07-04,9207
2537,聯上發,8,0,8,凱基-永和,2024-07-04,9207
4109,加捷生醫,8,0,8,凱基-永和,2024-07-04,9207
6209,今國光,8,0,8,凱基-永和,2024-07-04,9207
8163,達方,8,0,8,凱基-永和,2024-07-04,9207
3581,博磊,8,1,7,凱基-永和,2024-07-04,9207
2606,裕民,7,0,7,凱基-永和,2024-07-04,9207
2405,輔信,703,9,694,凱基-永和,2024-07-05,9207
9105,泰金寶-DR,500,14,486,凱基-永和,2024-07-05,9207
3047,訊舟,401,3,398,凱基-永和,2024-07-05,9207
8092,建暐,200,0,200,凱基-永和,2024-07-05,9207
6217,中探針,203,5,198,凱基-永和,2024-07-05,9207
6207,雷科,202,8,194,凱基-永和,2024-07-05,9207
4909,新復興,100,0,100,凱基-永和,2024-07-05,9207
4960,誠美材,100,0,100,凱基-永和,2024-07-05,9207
3588,通嘉,50,0,50,凱基-永和,2024-07-05,9207
6244,茂迪,70,20,50,凱基-永和,2024-07-05,9207
00637L,元大滬深300正2,50,3,47,凱基-永和,2024-07-05,9207
3362,先進光,55,10,45,凱基-永和,2024-07-05,9207
00632R,元大台灣50反1,40,0,40,凱基-永和,2024-07-05,9207
2359,所羅門,40,2,38,凱基-永和,2024-07-05,9207
5234,達興材料,38,0,38,凱基-永和,2024-07-05,9207
2356,英業達,57,21,36,凱基-永和,2024-07-05,9207
3013,晟銘電,38,2,36,凱基-永和,2024-07-05,9207
3402,漢科,31,0,31,凱基-永和,2024-07-05,9207
6188,廣明,34,5,29,凱基-永和,2024-07-05,9207
2349,錸德,27,0,27,凱基-永和,2024-07-05,9207
2344,華邦電,23,0,23,凱基-永和,2024-07-05,9207
2301,光寶科,17,0,17,凱基-永和,2024-07-05,9207
00679B,元大美債20年,17,0,17,凱基-永和,2024-07-05,9207
2609,陽明,19,3,16,凱基-永和,2024-07-05,9207
6698,旭暉應材,16,0,16,凱基-永和,2024-07-05,9207
1560,中砂,18,2,16,凱基-永和,2024-07-05,9207
2618,長榮航,23,9,14,凱基-永和,2024-07-05,9207
6515,穎崴,14,0,14,凱基-永和,2024-07-05,9207
00937B,群益ESG投等債20,12,0,12,凱基-永和,2024-07-05,9207
1609,大亞,14,2,12,凱基-永和,2024-07-05,9207
2883,凱基金,12,0,12,凱基-永和,2024-07-05,9207
00934,中信成長高股息,11,0,11,凱基-永和,2024-07-05,9207
6451,訊芯-KY,11,0,11,凱基-永和,2024-07-05,9207
2392,正崴,11,0,11,凱基-永和,2024-07-05,9207
00720B,元大投資級公司債,10,0,10,凱基-永和,2024-07-05,9207
00927,群益半導體收益,10,0,10,凱基-永和,2024-07-05,9207
1110,東泥,10,0,10,凱基-永和,2024-07-05,9207
1402,遠東新,10,0,10,凱基-永和,2024-07-05,9207
1514,亞力,15,5,10,凱基-永和,2024-07-05,9207
2369,菱生,10,0,10,凱基-永和,2024-07-05,9207
5475,德宏,10,0,10,凱基-永和,2024-07-05,9207
6770,力積電,10,0,10,凱基-永和,2024-07-05,9207
5392,能率,15,6,9,凱基-永和,2024-07-05,9207
2603,長榮,9,1,8,凱基-永和,2024-07-05,9207
1102,亞泥,8,0,8,凱基-永和,2024-07-05,9207
00946,群益科技高息成長,11,3,8,凱基-永和,2024-07-05,9207
2498,宏達電,11,3,8,凱基-永和,2024-07-05,9207
00945B,凱基美國非投等債,7,0,7,凱基-永和,2024-07-05,9207
6257,矽格,7,0,7,凱基-永和,2024-07-05,9207
1513,中興電,18,12,6,凱基-永和,2024-07-05,9207
2405,輔信,1185,619,566,凱基-永和,2024-07-08,9207
2367,燿華,574,53,521,凱基-永和,2024-07-08,9207
9105,泰金寶-DR,301,42,259,凱基-永和,2024-07-08,9207
3006,晶豪科,201,0,201,凱基-永和,2024-07-08,9207
3163,波若威,200,0,200,凱基-永和,2024-07-08,9207
5328,華容,200,5,195,凱基-永和,2024-07-08,9207
3047,訊舟,502,321,181,凱基-永和,2024-07-08,9207
6584,南俊國際,80,1,79,凱基-永和,2024-07-08,9207
00937B,群益ESG投等債20,76,4,72,凱基-永和,2024-07-08,9207
1316,上曜,60,0,60,凱基-永和,2024-07-08,9207
2353,宏��,50,1,49,凱基-永和,2024-07-08,9207
00632R,元大台灣50反1,101,53,48,凱基-永和,2024-07-08,9207
2618,長榮航,56,10,46,凱基-永和,2024-07-08,9207
6182,合晶,162,122,40,凱基-永和,2024-07-08,9207
8064,東捷,32,1,31,凱基-永和,2024-07-08,9207
00934,中信成長高股息,32,1,31,凱基-永和,2024-07-08,9207
6116,彩晶,32,1,31,凱基-永和,2024-07-08,9207
00679B,元大美債20年,40,10,30,凱基-永和,2024-07-08,9207
6134,萬旭,30,0,30,凱基-永和,2024-07-08,9207
00929,復華台灣科技優息,33,8,25,凱基-永和,2024-07-08,9207
2852,第一保,25,0,25,凱基-永和,2024-07-08,9207
8249,菱光,20,0,20,凱基-永和,2024-07-08,9207
2603,長榮,23,3,20,凱基-永和,2024-07-08,9207
2324,仁寶,18,0,18,凱基-永和,2024-07-08,9207
3008,大立光,17,0,17,凱基-永和,2024-07-08,9207
00878,國泰永續高股息,17,1,16,凱基-永和,2024-07-08,9207
6223,旺矽,16,0,16,凱基-永和,2024-07-08,9207
00687B,國泰20年美債,15,0,15,凱基-永和,2024-07-08,9207
6153,嘉聯益,16,1,15,凱基-永和,2024-07-08,9207
6176,瑞儀,15,0,15,凱基-永和,2024-07-08,9207
6244,茂迪,16,1,15,凱基-永和,2024-07-08,9207
2486,一詮,27,13,14,凱基-永和,2024-07-08,9207
00675L,富邦臺灣加權正2,13,0,13,凱基-永和,2024-07-08,9207
2332,友訊,13,0,13,凱基-永和,2024-07-08,9207
2352,佳世達,13,0,13,凱基-永和,2024-07-08,9207
6126,信音,13,0,13,凱基-永和,2024-07-08,9207
6505,台塑化,13,0,13,凱基-永和,2024-07-08,9207
2427,三商電,13,0,13,凱基-永和,2024-07-08,9207
2464,盟立,19,8,11,凱基-永和,2024-07-08,9207
00720B,元大投資級公司債,11,0,11,凱基-永和,2024-07-08,9207
3149,正達,11,0,11,凱基-永和,2024-07-08,9207
6290,良維,10,0,10,凱基-永和,2024-07-08,9207
00949,復華日本龍頭,10,0,10,凱基-永和,2024-07-08,9207
3694,海華,10,0,10,凱基-永和,2024-07-08,9207
5608,四維航,10,0,10,凱基-永和,2024-07-08,9207
8076,伍豐,10,0,10,凱基-永和,2024-07-08,9207
2409,友達,10,0,10,凱基-永和,2024-07-08,9207
5443,均豪,16,6,10,凱基-永和,2024-07-08,9207
1454,台富,9,0,9,凱基-永和,2024-07-08,9207
911868,同方友友-DR,9,0,9,凱基-永和,2024-07-08,9207
1314,中石化,743,0,743,凱基-永和,2024-07-09,9207
2392,正崴,1461,1016,445,凱基-永和,2024-07-09,9207
3312,弘憶股,231,2,229,凱基-永和,2024-07-09,9207
1618,合機,204,4,200,凱基-永和,2024-07-09,9207
1617,榮星,200,3,197,凱基-永和,2024-07-09,9207
8105,凌巨,214,20,194,凱基-永和,2024-07-09,9207
3163,波若威,130,41,89,凱基-永和,2024-07-09,9207
00665L,富邦�琤肭磪囓�2,170,100,70,凱基-永和,2024-07-09,9207
00687B,國泰20年美債,76,10,66,凱基-永和,2024-07-09,9207
6770,力積電,65,3,62,凱基-永和,2024-07-09,9207
6134,萬旭,61,0,61,凱基-永和,2024-07-09,9207
6116,彩晶,60,2,58,凱基-永和,2024-07-09,9207
2317,鴻海,68,23,45,凱基-永和,2024-07-09,9207
1528,恩德,41,0,41,凱基-永和,2024-07-09,9207
00929,復華台灣科技優息,42,6,36,凱基-永和,2024-07-09,9207
00679B,元大美債20年,42,10,32,凱基-永和,2024-07-09,9207
1301,台塑,31,0,31,凱基-永和,2024-07-09,9207
3443,創意,30,0,30,凱基-永和,2024-07-09,9207
2312,金寶,69,40,29,凱基-永和,2024-07-09,9207
1217,愛之味,26,0,26,凱基-永和,2024-07-09,9207
4960,誠美材,27,2,25,凱基-永和,2024-07-09,9207
2884,玉山金,21,0,21,凱基-永和,2024-07-09,9207
2610,華航,22,1,21,凱基-永和,2024-07-09,9207
3094,聯傑,21,0,21,凱基-永和,2024-07-09,9207
1718,中纖,21,0,21,凱基-永和,2024-07-09,9207
00922,國泰台灣領袖50,20,0,20,凱基-永和,2024-07-09,9207
6265,方土昶,20,0,20,凱基-永和,2024-07-09,9207
00936,台新永續高息中小,19,2,17,凱基-永和,2024-07-09,9207
00946,群益科技高息成長,16,0,16,凱基-永和,2024-07-09,9207
4956,光鋐,17,1,16,凱基-永和,2024-07-09,9207
2489,瑞軒,20,5,15,凱基-永和,2024-07-09,9207
3363,上詮,16,1,15,凱基-永和,2024-07-09,9207
2609,陽明,15,1,14,凱基-永和,2024-07-09,9207
1605,華新,14,0,14,凱基-永和,2024-07-09,9207
6505,台塑化,16,2,14,凱基-永和,2024-07-09,9207
3033,威健,13,0,13,凱基-永和,2024-07-09,9207
2337,旺宏,16,4,12,凱基-永和,2024-07-09,9207
2641,正德,12,0,12,凱基-永和,2024-07-09,9207
0056,元大高股息,13,1,12,凱基-永和,2024-07-09,9207
2352,佳世達,11,0,11,凱基-永和,2024-07-09,9207
8064,東捷,21,10,11,凱基-永和,2024-07-09,9207
1444,力麗,16,5,11,凱基-永和,2024-07-09,9207
3581,博磊,17,6,11,凱基-永和,2024-07-09,9207
00688L,國泰20年美債正2,10,0,10,凱基-永和,2024-07-09,9207
00928,中信上櫃ESG30,10,0,10,凱基-永和,2024-07-09,9207
4164,承業醫,10,0,10,凱基-永和,2024-07-09,9207
6425,易發,11,1,10,凱基-永和,2024-07-09,9207
3231,緯創,25,15,10,凱基-永和,2024-07-09,9207
3234,光環,10,0,10,凱基-永和,2024-07-09,9207
00934,中信成長高股息,9,0,9,凱基-永和,2024-07-09,9207
2363,矽統,621,5,616,凱基-永和,2024-07-10,9207
8092,建暐,300,0,300,凱基-永和,2024-07-10,9207
2316,楠梓電,500,202,298,凱基-永和,2024-07-10,9207
3450,聯鈞,421,221,200,凱基-永和,2024-07-10,9207
1514,亞力,214,30,184,凱基-永和,2024-07-10,9207
2362,藍天,126,1,125,凱基-永和,2024-07-10,9207
2412,中華電,101,0,101,凱基-永和,2024-07-10,9207
2464,盟立,523,425,98,凱基-永和,2024-07-10,9207
2328,廣宇,88,1,87,凱基-永和,2024-07-10,9207
2408,南亞科,78,1,77,凱基-永和,2024-07-10,9207
00937B,群益ESG投等債20,69,6,63,凱基-永和,2024-07-10,9207
2442,新美齊,60,0,60,凱基-永和,2024-07-10,9207
1718,中纖,59,0,59,凱基-永和,2024-07-10,9207
4588,玖鼎電力,60,3,57,凱基-永和,2024-07-10,9207
1528,恩德,60,5,55,凱基-永和,2024-07-10,9207
2354,鴻準,55,1,54,凱基-永和,2024-07-10,9207
00687B,國泰20年美債,49,0,49,凱基-永和,2024-07-10,9207
00936,台新永續高息中小,47,0,47,凱基-永和,2024-07-10,9207
00919,群益台灣精選高息,42,1,41,凱基-永和,2024-07-10,9207
2367,燿華,57,21,36,凱基-永和,2024-07-10,9207
00679B,元大美債20年,36,0,36,凱基-永和,2024-07-10,9207
3313,斐成,30,0,30,凱基-永和,2024-07-10,9207
5426,振發,30,1,29,凱基-永和,2024-07-10,9207
00934,中信成長高股息,30,3,27,凱基-永和,2024-07-10,9207
2743,山富,20,1,19,凱基-永和,2024-07-10,9207
2303,聯電,19,1,18,凱基-永和,2024-07-10,9207
2317,鴻海,24,8,16,凱基-永和,2024-07-10,9207
00933B,國泰10Y+金融債,16,0,16,凱基-永和,2024-07-10,9207
4956,光鋐,26,11,15,凱基-永和,2024-07-10,9207
8478,東哥遊艇,20,5,15,凱基-永和,2024-07-10,9207
00929,復華台灣科技優息,14,0,14,凱基-永和,2024-07-10,9207
1608,華榮,14,0,14,凱基-永和,2024-07-10,9207
8071,能率網通,16,2,14,凱基-永和,2024-07-10,9207
8437,大地-KY,15,1,14,凱基-永和,2024-07-10,9207
9105,泰金寶-DR,11,0,11,凱基-永和,2024-07-10,9207
5876,上海商銀,10,0,10,凱基-永和,2024-07-10,9207
1451,年興,10,0,10,凱基-永和,2024-07-10,9207
1609,大亞,30,20,10,凱基-永和,2024-07-10,9207
2618,長榮航,15,5,10,凱基-永和,2024-07-10,9207
3580,友威科,10,0,10,凱基-永和,2024-07-10,9207
6443,元晶,10,0,10,凱基-永和,2024-07-10,9207
2489,瑞軒,310,300,10,凱基-永和,2024-07-10,9207
00895,富邦未來車,10,1,9,凱基-永和,2024-07-10,9207
3037,欣興,11,2,9,凱基-永和,2024-07-10,9207
2331,精英,10,1,9,凱基-永和,2024-07-10,9207
00940,元大台灣價值高息,35,27,8,凱基-永和,2024-07-10,9207
4904,遠傳,8,0,8,凱基-永和,2024-07-10,9207
6531,愛普*,15,7,8,凱基-永和,2024-07-10,9207
1301,台塑,10,3,7,凱基-永和,2024-07-10,9207
6526,達發,7,0,7,凱基-永和,2024-07-10,9207
2888,新光金,452,103,349,凱基-永和,2024-07-11,9207
2104,國際中橡,196,0,196,凱基-永和,2024-07-11,9207
6834,天二科技,100,0,100,凱基-永和,2024-07-11,9207
00632R,元大台灣50反1,83,0,83,凱基-永和,2024-07-11,9207
00770,國泰北美科技,60,0,60,凱基-永和,2024-07-11,9207
00937B,群益ESG投等債20,54,0,54,凱基-永和,2024-07-11,9207
2610,華航,50,0,50,凱基-永和,2024-07-11,9207
3706,神達,68,21,47,凱基-永和,2024-07-11,9207
00936,台新永續高息中小,40,0,40,凱基-永和,2024-07-11,9207
00795B,中信美國公債20年,38,0,38,凱基-永和,2024-07-11,9207
2889,國票金,30,0,30,凱基-永和,2024-07-11,9207
6603,富強鑫,30,1,29,凱基-永和,2024-07-11,9207
2897,王道銀行,34,10,24,凱基-永和,2024-07-11,9207
2891,中信金,31,8,23,凱基-永和,2024-07-11,9207
8446,華研,23,0,23,凱基-永和,2024-07-11,9207
3455,由田,24,2,22,凱基-永和,2024-07-11,9207
4123,晟德,24,2,22,凱基-永和,2024-07-11,9207
2412,中華電,21,0,21,凱基-永和,2024-07-11,9207
2867,三商壽,133,112,21,凱基-永和,2024-07-11,9207
6282,康舒,25,4,21,凱基-永和,2024-07-11,9207
6548,長科*,22,1,21,凱基-永和,2024-07-11,9207
8234,新漢,23,2,21,凱基-永和,2024-07-11,9207
00679B,元大美債20年,19,0,19,凱基-永和,2024-07-11,9207
00662,富邦NASDAQ,15,0,15,凱基-永和,2024-07-11,9207
3581,博磊,22,7,15,凱基-永和,2024-07-11,9207
8028,昇陽半導體,17,3,14,凱基-永和,2024-07-11,9207
2392,正崴,319,305,14,凱基-永和,2024-07-11,9207
00918,大華優利高填息30,15,1,14,凱基-永和,2024-07-11,9207
1447,力鵬,12,0,12,凱基-永和,2024-07-11,9207
2313,華通,15,3,12,凱基-永和,2024-07-11,9207
2885,元大金,10,0,10,凱基-永和,2024-07-11,9207
00895,富邦未來車,10,0,10,凱基-永和,2024-07-11,9207
00725B,國泰投資級公司債,10,0,10,凱基-永和,2024-07-11,9207
00688L,國泰20年美債正2,10,0,10,凱基-永和,2024-07-11,9207
2101,南港,25,15,10,凱基-永和,2024-07-11,9207
2371,大同,10,0,10,凱基-永和,2024-07-11,9207
2419,仲琦,10,0,10,凱基-永和,2024-07-11,9207
8054,安國,10,0,10,凱基-永和,2024-07-11,9207
1795,美時,14,4,10,凱基-永和,2024-07-11,9207
2886,兆豐金,10,1,9,凱基-永和,2024-07-11,9207
6532,瑞耘,9,0,9,凱基-永和,2024-07-11,9207
1532,勤美,9,1,8,凱基-永和,2024-07-11,9207
6789,采鈺,8,0,8,凱基-永和,2024-07-11,9207
2852,第一保,7,0,7,凱基-永和,2024-07-11,9207
3008,大立光,7,0,7,凱基-永和,2024-07-11,9207
6118,建達,6,0,6,凱基-永和,2024-07-11,9207
1504,東元,8,2,6,凱基-永和,2024-07-11,9207
2355,敬鵬,6,0,6,凱基-永和,2024-07-11,9207
2460,建通,6,0,6,凱基-永和,2024-07-11,9207
3105,穩懋,6,0,6,凱基-永和,2024-07-11,9207
00878,國泰永續高股息,1186,1,1185,凱基-永和,2024-07-12,9207
2489,瑞軒,1375,498,877,凱基-永和,2024-07-12,9207
00929,復華台灣科技優息,174,3,171,凱基-永和,2024-07-12,9207
3163,波若威,155,2,153,凱基-永和,2024-07-12,9207
6462,神盾,320,172,148,凱基-永和,2024-07-12,9207
00933B,國泰10Y+金融債,115,0,115,凱基-永和,2024-07-12,9207
00680L,元大美債20正2,70,5,65,凱基-永和,2024-07-12,9207
00919,群益台灣精選高息,64,0,64,凱基-永和,2024-07-12,9207
00632R,元大台灣50反1,101,40,61,凱基-永和,2024-07-12,9207
2408,南亞科,52,0,52,凱基-永和,2024-07-12,9207
5234,達興材料,82,30,52,凱基-永和,2024-07-12,9207
8054,安國,50,0,50,凱基-永和,2024-07-12,9207
00679B,元大美債20年,55,8,47,凱基-永和,2024-07-12,9207
2303,聯電,40,2,38,凱基-永和,2024-07-12,9207
2312,金寶,128,92,36,凱基-永和,2024-07-12,9207
00740B,富邦全球投等債,35,0,35,凱基-永和,2024-07-12,9207
8916,光隆,32,0,32,凱基-永和,2024-07-12,9207
2888,新光金,39,13,26,凱基-永和,2024-07-12,9207
6603,富強鑫,30,5,25,凱基-永和,2024-07-12,9207
00946,群益科技高息成長,24,0,24,凱基-永和,2024-07-12,9207
2852,第一保,20,0,20,凱基-永和,2024-07-12,9207
4123,晟德,20,0,20,凱基-永和,2024-07-12,9207
6244,茂迪,20,0,20,凱基-永和,2024-07-12,9207
00881,國泰台灣5G+,19,1,18,凱基-永和,2024-07-12,9207
00725B,國泰投資級公司債,19,2,17,凱基-永和,2024-07-12,9207
00934,中信成長高股息,17,1,16,凱基-永和,2024-07-12,9207
006208,富邦台50,15,0,15,凱基-永和,2024-07-12,9207
00891,中信關鍵半導體,14,0,14,凱基-永和,2024-07-12,9207
3231,緯創,16,2,14,凱基-永和,2024-07-12,9207
00757,統一FANG+,63,50,13,凱基-永和,2024-07-12,9207
2618,長榮航,13,0,13,凱基-永和,2024-07-12,9207
2884,玉山金,13,0,13,凱基-永和,2024-07-12,9207
4533,協易機,14,1,13,凱基-永和,2024-07-12,9207
6698,旭暉應材,13,0,13,凱基-永和,2024-07-12,9207
2449,京元電子,14,2,12,凱基-永和,2024-07-12,9207
2313,華通,13,2,11,凱基-永和,2024-07-12,9207
5202,力新,14,3,11,凱基-永和,2024-07-12,9207
911868,同方友友-DR,11,0,11,凱基-永和,2024-07-12,9207
00935,野村臺灣新科技50,10,0,10,凱基-永和,2024-07-12,9207
1714,和桐,10,0,10,凱基-永和,2024-07-12,9207
2597,潤弘,10,0,10,凱基-永和,2024-07-12,9207
4956,光鋐,11,1,10,凱基-永和,2024-07-12,9207
5328,華容,10,0,10,凱基-永和,2024-07-12,9207
6127,九豪,10,0,10,凱基-永和,2024-07-12,9207
9904,寶成,16,6,10,凱基-永和,2024-07-12,9207
2337,旺宏,20,11,9,凱基-永和,2024-07-12,9207
2367,燿華,9,0,9,凱基-永和,2024-07-12,9207
1528,恩德,10,1,9,凱基-永和,2024-07-12,9207
2897,王道銀行,9,0,9,凱基-永和,2024-07-12,9207
3607,谷崧,16,7,9,凱基-永和,2024-07-12,9207
00878,國泰永續高股息,1305,3,1302,凱基-永和,2024-07-15,9207
4956,光鋐,165,2,163,凱基-永和,2024-07-15,9207
4927,泰鼎-KY,152,1,151,凱基-永和,2024-07-15,9207
8054,安國,159,18,141,凱基-永和,2024-07-15,9207
00929,復華台灣科技優息,133,3,130,凱基-永和,2024-07-15,9207
2455,全新,123,0,123,凱基-永和,2024-07-15,9207
6189,豐藝,93,0,93,凱基-永和,2024-07-15,9207
2891,中信金,92,7,85,凱基-永和,2024-07-15,9207
6271,同欣電,141,71,70,凱基-永和,2024-07-15,9207
00770,國泰北美科技,60,0,60,凱基-永和,2024-07-15,9207
3147,大綜,57,0,57,凱基-永和,2024-07-15,9207
3715,定穎投控,50,0,50,凱基-永和,2024-07-15,9207
9105,泰金寶-DR,50,3,47,凱基-永和,2024-07-15,9207
2888,新光金,52,10,42,凱基-永和,2024-07-15,9207
6603,富強鑫,40,0,40,凱基-永和,2024-07-15,9207
00949,復華日本龍頭,50,13,37,凱基-永和,2024-07-15,9207
00680L,元大美債20正2,36,0,36,凱基-永和,2024-07-15,9207
00706L,期元大S＆P日圓正2,33,0,33,凱基-永和,2024-07-15,9207
6462,神盾,163,130,33,凱基-永和,2024-07-15,9207
2317,鴻海,52,20,32,凱基-永和,2024-07-15,9207
00940,元大台灣價值高息,31,0,31,凱基-永和,2024-07-15,9207
2883,凱基金,44,14,30,凱基-永和,2024-07-15,9207
00934,中信成長高股息,28,4,24,凱基-永和,2024-07-15,9207
2603,長榮,25,2,23,凱基-永和,2024-07-15,9207
3029,零壹,21,0,21,凱基-永和,2024-07-15,9207
00632R,元大台灣50反1,20,0,20,凱基-永和,2024-07-15,9207
3357,臺慶科,20,0,20,凱基-永和,2024-07-15,9207
6116,彩晶,20,0,20,凱基-永和,2024-07-15,9207
00936,台新永續高息中小,19,0,19,凱基-永和,2024-07-15,9207
00687B,國泰20年美債,19,0,19,凱基-永和,2024-07-15,9207
2312,金寶,68,50,18,凱基-永和,2024-07-15,9207
6284,佳邦,19,1,18,凱基-永和,2024-07-15,9207
1721,三晃,17,0,17,凱基-永和,2024-07-15,9207
5314,世紀,16,0,16,凱基-永和,2024-07-15,9207
0056,元大高股息,16,0,16,凱基-永和,2024-07-15,9207
00679B,元大美債20年,15,0,15,凱基-永和,2024-07-15,9207
3231,緯創,16,1,15,凱基-永和,2024-07-15,9207
00948B,中信優息投資級債,14,0,14,凱基-永和,2024-07-15,9207
6139,亞翔,14,0,14,凱基-永和,2024-07-15,9207
2393,億光,13,0,13,凱基-永和,2024-07-15,9207
1444,力麗,13,0,13,凱基-永和,2024-07-15,9207
2027,大成鋼,13,1,12,凱基-永和,2024-07-15,9207
1303,南亞,11,0,11,凱基-永和,2024-07-15,9207
00918,大華優利高填息30,11,0,11,凱基-永和,2024-07-15,9207
00720B,元大投資級公司債,11,0,11,凱基-永和,2024-07-15,9207
2408,南亞科,10,0,10,凱基-永和,2024-07-15,9207
00725B,國泰投資級公司債,10,0,10,凱基-永和,2024-07-15,9207
1506,正道,10,0,10,凱基-永和,2024-07-15,9207
1528,恩德,10,0,10,凱基-永和,2024-07-15,9207
2332,友訊,10,0,10,凱基-永和,2024-07-15,9207
00878,國泰永續高股息,632,3,629,凱基-永和,2024-07-16,9207
5328,華容,402,1,401,凱基-永和,2024-07-16,9207
2206,三陽工業,297,0,297,凱基-永和,2024-07-16,9207
2359,所羅門,200,1,199,凱基-永和,2024-07-16,9207
6834,天二科技,200,1,199,凱基-永和,2024-07-16,9207
00892,富邦台灣半導體,160,0,160,凱基-永和,2024-07-16,9207
4909,新復興,100,0,100,凱基-永和,2024-07-16,9207
8147,正淩,120,20,100,凱基-永和,2024-07-16,9207
1609,大亞,83,23,60,凱基-永和,2024-07-16,9207
00919,群益台灣精選高息,54,1,53,凱基-永和,2024-07-16,9207
2867,三商壽,50,0,50,凱基-永和,2024-07-16,9207
2520,冠德,153,104,49,凱基-永和,2024-07-16,9207
00929,復華台灣科技優息,82,34,48,凱基-永和,2024-07-16,9207
00949,復華日本龍頭,43,0,43,凱基-永和,2024-07-16,9207
8097,常珵,39,0,39,凱基-永和,2024-07-16,9207
0056,元大高股息,36,1,35,凱基-永和,2024-07-16,9207
00937B,群益ESG投等債20,38,3,35,凱基-永和,2024-07-16,9207
2610,華航,33,1,32,凱基-永和,2024-07-16,9207
2408,南亞科,32,0,32,凱基-永和,2024-07-16,9207
00933B,國泰10Y+金融債,31,0,31,凱基-永和,2024-07-16,9207
00882,中信中國高股息,30,0,30,凱基-永和,2024-07-16,9207
2603,長榮,25,0,25,凱基-永和,2024-07-16,9207
2327,國巨,30,5,25,凱基-永和,2024-07-16,9207
00632R,元大台灣50反1,25,0,25,凱基-永和,2024-07-16,9207
6695,芯鼎,31,6,25,凱基-永和,2024-07-16,9207
00905,FT臺灣Smart,22,1,21,凱基-永和,2024-07-16,9207
00655L,國泰中國A50正2,21,1,20,凱基-永和,2024-07-16,9207
00719B,元大美債1-3,17,0,17,凱基-永和,2024-07-16,9207
00945B,凱基美國非投等債,17,0,17,凱基-永和,2024-07-16,9207
6139,亞翔,19,2,17,凱基-永和,2024-07-16,9207
3581,博磊,16,0,16,凱基-永和,2024-07-16,9207
00927,群益半導體收益,14,0,14,凱基-永和,2024-07-16,9207
3481,群創,16,2,14,凱基-永和,2024-07-16,9207
2356,英業達,15,2,13,凱基-永和,2024-07-16,9207
00720B,元大投資級公司債,12,0,12,凱基-永和,2024-07-16,9207
2884,玉山金,12,0,12,凱基-永和,2024-07-16,9207
5439,高技,16,4,12,凱基-永和,2024-07-16,9207
6176,瑞儀,12,0,12,凱基-永和,2024-07-16,9207
00934,中信成長高股息,13,2,11,凱基-永和,2024-07-16,9207
2891,中信金,14,3,11,凱基-永和,2024-07-16,9207
2885,元大金,11,0,11,凱基-永和,2024-07-16,9207
2385,群光,11,0,11,凱基-永和,2024-07-16,9207
3013,晟銘電,17,6,11,凱基-永和,2024-07-16,9207
00713,元大台灣高息低波,10,0,10,凱基-永和,2024-07-16,9207
00751B,元大AAA至A公司債,10,0,10,凱基-永和,2024-07-16,9207
5488,松普,10,0,10,凱基-永和,2024-07-16,9207
6140,訊達,10,0,10,凱基-永和,2024-07-16,9207
6603,富強鑫,10,0,10,凱基-永和,2024-07-16,9207
00679B,元大美債20年,11,1,10,凱基-永和,2024-07-16,9207
2615,萬海,25,16,9,凱基-永和,2024-07-16,9207
00878,國泰永續高股息,1199,4,1195,凱基-永和,2024-07-17,9207
1409,新纖,1007,0,1007,凱基-永和,2024-07-17,9207
2515,中工,772,3,769,凱基-永和,2024-07-17,9207
2365,昆盈,324,34,290,凱基-永和,2024-07-17,9207
4909,新復興,150,0,150,凱基-永和,2024-07-17,9207
2362,藍天,300,151,149,凱基-永和,2024-07-17,9207
00937B,群益ESG投等債20,136,5,131,凱基-永和,2024-07-17,9207
00946,群益科技高息成長,127,0,127,凱基-永和,2024-07-17,9207
2419,仲琦,100,10,90,凱基-永和,2024-07-17,9207
5234,達興材料,85,0,85,凱基-永和,2024-07-17,9207
00929,復華台灣科技優息,84,1,83,凱基-永和,2024-07-17,9207
00933B,國泰10Y+金融債,77,0,77,凱基-永和,2024-07-17,9207
00919,群益台灣精選高息,79,10,69,凱基-永和,2024-07-17,9207
00770,國泰北美科技,60,0,60,凱基-永和,2024-07-17,9207
2603,長榮,59,2,57,凱基-永和,2024-07-17,9207
3706,神達,55,2,53,凱基-永和,2024-07-17,9207
6462,神盾,52,3,49,凱基-永和,2024-07-17,9207
00680L,元大美債20正2,50,5,45,凱基-永和,2024-07-17,9207
2408,南亞科,43,2,41,凱基-永和,2024-07-17,9207
4906,正文,32,0,32,凱基-永和,2024-07-17,9207
1718,中纖,30,0,30,凱基-永和,2024-07-17,9207
5314,世紀,29,0,29,凱基-永和,2024-07-17,9207
8096,擎亞,27,4,23,凱基-永和,2024-07-17,9207
3231,緯創,38,15,23,凱基-永和,2024-07-17,9207
00665L,富邦�琤肭磪囓�2,21,0,21,凱基-永和,2024-07-17,9207
1305,華夏,21,0,21,凱基-永和,2024-07-17,9207
1806,冠軍,20,0,20,凱基-永和,2024-07-17,9207
2897,王道銀行,20,0,20,凱基-永和,2024-07-17,9207
00918,大華優利高填息30,21,2,19,凱基-永和,2024-07-17,9207
00720B,元大投資級公司債,18,0,18,凱基-永和,2024-07-17,9207
3163,波若威,23,5,18,凱基-永和,2024-07-17,9207
00945B,凱基美國非投等債,17,0,17,凱基-永和,2024-07-17,9207
8054,安國,18,2,16,凱基-永和,2024-07-17,9207
2597,潤弘,15,0,15,凱基-永和,2024-07-17,9207
2317,鴻海,22,7,15,凱基-永和,2024-07-17,9207
5876,上海商銀,14,0,14,凱基-永和,2024-07-17,9207
1314,中石化,21,8,13,凱基-永和,2024-07-17,9207
00679B,元大美債20年,13,0,13,凱基-永和,2024-07-17,9207
00947,台新臺灣IC設計,12,0,12,凱基-永和,2024-07-17,9207
2401,凌陽,17,5,12,凱基-永和,2024-07-17,9207
2483,百容,12,0,12,凱基-永和,2024-07-17,9207
00936,台新永續高息中小,11,0,11,凱基-永和,2024-07-17,9207
2344,華邦電,11,0,11,凱基-永和,2024-07-17,9207
5230,雷笛克光學,11,0,11,凱基-永和,2024-07-17,9207
3673,TPK-KY,16,6,10,凱基-永和,2024-07-17,9207
6239,力成,10,0,10,凱基-永和,2024-07-17,9207
1313,聯成,10,0,10,凱基-永和,2024-07-17,9207
2367,燿華,11,2,9,凱基-永和,2024-07-17,9207
2385,群光,11,2,9,凱基-永和,2024-07-17,9207
2453,凌群,10,1,9,凱基-永和,2024-07-17,9207
3518,柏騰,300,0,300,凱基-永和,2024-07-18,9207
00937B,群益ESG投等債20,132,0,132,凱基-永和,2024-07-18,9207
2317,鴻海,149,37,112,凱基-永和,2024-07-18,9207
00946,群益科技高息成長,88,0,88,凱基-永和,2024-07-18,9207
00919,群益台灣精選高息,83,3,80,凱基-永和,2024-07-18,9207
9958,世紀鋼,136,78,58,凱基-永和,2024-07-18,9207
1402,遠東新,52,0,52,凱基-永和,2024-07-18,9207
00665L,富邦�琤肭磪囓�2,50,0,50,凱基-永和,2024-07-18,9207
2888,新光金,62,12,50,凱基-永和,2024-07-18,9207
2603,長榮,50,0,50,凱基-永和,2024-07-18,9207
6116,彩晶,45,0,45,凱基-永和,2024-07-18,9207
1609,大亞,38,4,34,凱基-永和,2024-07-18,9207
1102,亞泥,34,0,34,凱基-永和,2024-07-18,9207
00933B,國泰10Y+金融債,32,0,32,凱基-永和,2024-07-18,9207
00927,群益半導體收益,30,0,30,凱基-永和,2024-07-18,9207
00680L,元大美債20正2,30,0,30,凱基-永和,2024-07-18,9207
3062,建漢,30,2,28,凱基-永和,2024-07-18,9207
3680,家登,26,0,26,凱基-永和,2024-07-18,9207
00725B,國泰投資級公司債,25,0,25,凱基-永和,2024-07-18,9207
00929,復華台灣科技優息,127,104,23,凱基-永和,2024-07-18,9207
6770,力積電,21,0,21,凱基-永和,2024-07-18,9207
1453,大將,25,5,20,凱基-永和,2024-07-18,9207
2610,華航,20,1,19,凱基-永和,2024-07-18,9207
2356,英業達,21,3,18,凱基-永和,2024-07-18,9207
00936,台新永續高息中小,18,2,16,凱基-永和,2024-07-18,9207
2348,海悅,27,12,15,凱基-永和,2024-07-18,9207
2913,農林,40,25,15,凱基-永和,2024-07-18,9207
8473,山林水,20,5,15,凱基-永和,2024-07-18,9207
2303,聯電,16,2,14,凱基-永和,2024-07-18,9207
00878,國泰永續高股息,20,5,15,凱基-永和,2024-07-18,9207
2382,廣達,15,1,14,凱基-永和,2024-07-18,9207
2891,中信金,18,5,13,凱基-永和,2024-07-18,9207
3049,精金,13,0,13,凱基-永和,2024-07-18,9207
00905,FT臺灣Smart,13,0,13,凱基-永和,2024-07-18,9207
1611,中電,12,0,12,凱基-永和,2024-07-18,9207
0050,元大台灣50,12,1,11,凱基-永和,2024-07-18,9207
5512,力麒,11,0,11,凱基-永和,2024-07-18,9207
6548,長科*,10,0,10,凱基-永和,2024-07-18,9207
0056,元大高股息,12,2,10,凱基-永和,2024-07-18,9207
00915,凱基優選高股息30,10,0,10,凱基-永和,2024-07-18,9207
1304,台聚,10,0,10,凱基-永和,2024-07-18,9207
2032,新鋼,10,0,10,凱基-永和,2024-07-18,9207
3217,優群,10,0,10,凱基-永和,2024-07-18,9207
6156,松上,10,0,10,凱基-永和,2024-07-18,9207
00934,中信成長高股息,26,17,9,凱基-永和,2024-07-18,9207
3218,大學光,9,0,9,凱基-永和,2024-07-18,9207
2882,國泰金,9,0,9,凱基-永和,2024-07-18,9207
00918,大華優利高填息30,12,3,9,凱基-永和,2024-07-18,9207
00947,台新臺灣IC設計,8,0,8,凱基-永和,2024-07-18,9207
2353,宏��,9,1,8,凱基-永和,2024-07-18,9207
2330,台積電,488,4,484,凱基-永和,2024-07-19,9207
3481,群創,312,10,302,凱基-永和,2024-07-19,9207
2317,鴻海,187,9,178,凱基-永和,2024-07-19,9207
00878,國泰永續高股息,225,52,173,凱基-永和,2024-07-19,9207
2888,新光金,101,15,86,凱基-永和,2024-07-19,9207
6116,彩晶,71,1,70,凱基-永和,2024-07-19,9207
00946,群益科技高息成長,63,0,63,凱基-永和,2024-07-19,9207
8996,高力,57,0,57,凱基-永和,2024-07-19,9207
2891,中信金,55,1,54,凱基-永和,2024-07-19,9207
2603,長榮,54,0,54,凱基-永和,2024-07-19,9207
6869,雲豹能源,50,0,50,凱基-永和,2024-07-19,9207
00665L,富邦�琤肭磪囓�2,46,0,46,凱基-永和,2024-07-19,9207
2483,百容,50,4,46,凱基-永和,2024-07-19,9207
1785,光洋科,41,5,36,凱基-永和,2024-07-19,9207
00934,中信成長高股息,30,3,27,凱基-永和,2024-07-19,9207
1709,和益,49,22,27,凱基-永和,2024-07-19,9207
00929,復華台灣科技優息,57,30,27,凱基-永和,2024-07-19,9207
00927,群益半導體收益,25,0,25,凱基-永和,2024-07-19,9207
0056,元大高股息,23,0,23,凱基-永和,2024-07-19,9207
2867,三商壽,20,0,20,凱基-永和,2024-07-19,9207
00919,群益台灣精選高息,129,110,19,凱基-永和,2024-07-19,9207
3037,欣興,34,17,17,凱基-永和,2024-07-19,9207
00918,大華優利高填息30,17,0,17,凱基-永和,2024-07-19,9207
4956,光鋐,17,0,17,凱基-永和,2024-07-19,9207
4726,永昕,17,0,17,凱基-永和,2024-07-19,9207
8234,新漢,16,0,16,凱基-永和,2024-07-19,9207
3105,穩懋,15,1,14,凱基-永和,2024-07-19,9207
2337,旺宏,14,0,14,凱基-永和,2024-07-19,9207
6229,研通,14,0,14,凱基-永和,2024-07-19,9207
00936,台新永續高息中小,13,0,13,凱基-永和,2024-07-19,9207
5871,中租-KY,15,2,13,凱基-永和,2024-07-19,9207
00905,FT臺灣Smart,11,0,11,凱基-永和,2024-07-19,9207
00940,元大台灣價值高息,32,22,10,凱基-永和,2024-07-19,9207
00949,復華日本龍頭,10,0,10,凱基-永和,2024-07-19,9207
1326,台化,10,0,10,凱基-永和,2024-07-19,9207
2101,南港,10,0,10,凱基-永和,2024-07-19,9207
2880,華南金,11,1,10,凱基-永和,2024-07-19,9207
6603,富強鑫,10,0,10,凱基-永和,2024-07-19,9207
9950,萬國通,10,0,10,凱基-永和,2024-07-19,9207
1102,亞泥,9,0,9,凱基-永和,2024-07-19,9207
1733,五鼎,10,1,9,凱基-永和,2024-07-19,9207
2344,華邦電,9,0,9,凱基-永和,2024-07-19,9207
6477,安集,9,0,9,凱基-永和,2024-07-19,9207
2609,陽明,18,10,8,凱基-永和,2024-07-19,9207
2354,鴻準,8,0,8,凱基-永和,2024-07-19,9207
2883,凱基金,8,0,8,凱基-永和,2024-07-19,9207
2515,中工,8,0,8,凱基-永和,2024-07-19,9207
6139,亞翔,8,0,8,凱基-永和,2024-07-19,9207
0050,元大台灣50,9,1,8,凱基-永和,2024-07-19,9207
3231,緯創,7,0,7,凱基-永和,2024-07-19,9207
00919,群益台灣精選高息,147,16,131,凱基-永和,2024-07-22,9207
00929,復華台灣科技優息,153,25,128,凱基-永和,2024-07-22,9207
5512,力麒,137,34,103,凱基-永和,2024-07-22,9207
6462,神盾,90,4,86,凱基-永和,2024-07-22,9207
2359,所羅門,486,407,79,凱基-永和,2024-07-22,9207
00878,國泰永續高股息,94,19,75,凱基-永和,2024-07-22,9207
00934,中信成長高股息,64,4,60,凱基-永和,2024-07-22,9207
2888,新光金,74,14,60,凱基-永和,2024-07-22,9207
00946,群益科技高息成長,59,0,59,凱基-永和,2024-07-22,9207
3202,樺晟,59,0,59,凱基-永和,2024-07-22,9207
00940,元大台灣價值高息,109,62,47,凱基-永和,2024-07-22,9207
00679B,元大美債20年,55,14,41,凱基-永和,2024-07-22,9207
2317,鴻海,479,439,40,凱基-永和,2024-07-22,9207
2337,旺宏,31,0,31,凱基-永和,2024-07-22,9207
2483,百容,30,0,30,凱基-永和,2024-07-22,9207
2867,三商壽,30,0,30,凱基-永和,2024-07-22,9207
00676R,富邦臺灣加權反1,25,0,25,凱基-永和,2024-07-22,9207
2303,聯電,30,6,24,凱基-永和,2024-07-22,9207
2610,華航,29,5,24,凱基-永和,2024-07-22,9207
2332,友訊,22,0,22,凱基-永和,2024-07-22,9207
00665L,富邦�琤肭磪囓�2,21,0,21,凱基-永和,2024-07-22,9207
6284,佳邦,23,2,21,凱基-永和,2024-07-22,9207
3306,鼎天,20,0,20,凱基-永和,2024-07-22,9207
4729,熒茂,20,0,20,凱基-永和,2024-07-22,9207
2367,燿華,21,2,19,凱基-永和,2024-07-22,9207
2891,中信金,27,8,19,凱基-永和,2024-07-22,9207
2354,鴻準,18,0,18,凱基-永和,2024-07-22,9207
00936,台新永續高息中小,17,0,17,凱基-永和,2024-07-22,9207
00933B,國泰10Y+金融債,20,5,15,凱基-永和,2024-07-22,9207
3581,博磊,23,8,15,凱基-永和,2024-07-22,9207
8358,金居,14,0,14,凱基-永和,2024-07-22,9207
006208,富邦台50,17,4,13,凱基-永和,2024-07-22,9207
0056,元大高股息,13,0,13,凱基-永和,2024-07-22,9207
2427,三商電,13,0,13,凱基-永和,2024-07-22,9207
2536,宏普,13,0,13,凱基-永和,2024-07-22,9207
1314,中石化,13,0,13,凱基-永和,2024-07-22,9207
00687B,國泰20年美債,22,10,12,凱基-永和,2024-07-22,9207
6116,彩晶,12,0,12,凱基-永和,2024-07-22,9207
00927,群益半導體收益,11,0,11,凱基-永和,2024-07-22,9207
2489,瑞軒,23,13,10,凱基-永和,2024-07-22,9207
5009,榮剛,10,0,10,凱基-永和,2024-07-22,9207
00674R,期元大S＆P黃金反1,10,0,10,凱基-永和,2024-07-22,9207
1456,怡華,10,0,10,凱基-永和,2024-07-22,9207
1533,車王電,10,0,10,凱基-永和,2024-07-22,9207
2820,華票,10,0,10,凱基-永和,2024-07-22,9207
8096,擎亞,10,0,10,凱基-永和,2024-07-22,9207
3035,智原,19,10,9,凱基-永和,2024-07-22,9207
1326,台化,10,1,9,凱基-永和,2024-07-22,9207
2323,中環,9,0,9,凱基-永和,2024-07-22,9207
3037,欣興,10,1,9,凱基-永和,2024-07-22,9207
2888,新光金,169,1,168,凱基-永和,2024-07-23,9207
2408,南亞科,106,0,106,凱基-永和,2024-07-23,9207
5234,達興材料,100,0,100,凱基-永和,2024-07-23,9207
8054,安國,531,435,96,凱基-永和,2024-07-23,9207
00919,群益台灣精選高息,136,53,83,凱基-永和,2024-07-23,9207
6538,倉和,75,0,75,凱基-永和,2024-07-23,9207
00680L,元大美債20正2,60,0,60,凱基-永和,2024-07-23,9207
6116,彩晶,56,0,56,凱基-永和,2024-07-23,9207
2356,英業達,64,10,54,凱基-永和,2024-07-23,9207
00946,群益科技高息成長,45,0,45,凱基-永和,2024-07-23,9207
3481,群創,47,13,34,凱基-永和,2024-07-23,9207
3231,緯創,30,1,29,凱基-永和,2024-07-23,9207
00679B,元大美債20年,18,1,17,凱基-永和,2024-07-23,9207
2489,瑞軒,20,3,17,凱基-永和,2024-07-23,9207
00933B,國泰10Y+金融債,16,0,16,凱基-永和,2024-07-23,9207
4128,中天,28,13,15,凱基-永和,2024-07-23,9207
00687B,國泰20年美債,15,0,15,凱基-永和,2024-07-23,9207
3217,優群,15,0,15,凱基-永和,2024-07-23,9207
00720B,元大投資級公司債,12,0,12,凱基-永和,2024-07-23,9207
00945B,凱基美國非投等債,11,0,11,凱基-永和,2024-07-23,9207
2101,南港,10,0,10,凱基-永和,2024-07-23,9207
00725B,國泰投資級公司債,10,0,10,凱基-永和,2024-07-23,9207
00655L,國泰中國A50正2,10,0,10,凱基-永和,2024-07-23,9207
5876,上海商銀,10,0,10,凱基-永和,2024-07-23,9207
6120,達運,10,0,10,凱基-永和,2024-07-23,9207
6698,旭暉應材,20,10,10,凱基-永和,2024-07-23,9207
2603,長榮,10,0,10,凱基-永和,2024-07-23,9207
0056,元大高股息,12,3,9,凱基-永和,2024-07-23,9207
00878,國泰永續高股息,9,0,9,凱基-永和,2024-07-23,9207
2457,飛宏,9,0,9,凱基-永和,2024-07-23,9207
2609,陽明,17,8,9,凱基-永和,2024-07-23,9207
2354,鴻準,9,1,8,凱基-永和,2024-07-23,9207
6015,宏遠證,8,0,8,凱基-永和,2024-07-23,9207
2328,廣宇,7,0,7,凱基-永和,2024-07-23,9207
2483,百容,7,0,7,凱基-永和,2024-07-23,9207
2884,玉山金,7,0,7,凱基-永和,2024-07-23,9207
3580,友威科,57,50,7,凱基-永和,2024-07-23,9207
00642U,期元大S＆P石油,6,0,6,凱基-永和,2024-07-23,9207
2312,金寶,8,2,6,凱基-永和,2024-07-23,9207
2812,台中銀,6,0,6,凱基-永和,2024-07-23,9207
3042,晶技,6,0,6,凱基-永和,2024-07-23,9207
3581,博磊,12,6,6,凱基-永和,2024-07-23,9207
4956,光鋐,6,0,6,凱基-永和,2024-07-23,9207
6271,同欣電,6,0,6,凱基-永和,2024-07-23,9207
00949,復華日本龍頭,5,0,5,凱基-永和,2024-07-23,9207
00950B,凱基A級公司債,5,0,5,凱基-永和,2024-07-23,9207
4729,熒茂,5,0,5,凱基-永和,2024-07-23,9207
5243,乙盛-KY,5,0,5,凱基-永和,2024-07-23,9207
6176,瑞儀,5,0,5,凱基-永和,2024-07-23,9207
2301,光寶科,6,2,4,凱基-永和,2024-07-23,9207
8054,安國,502,3,499,凱基-永和,2024-07-26,9207
3163,波若威,309,1,308,凱基-永和,2024-07-26,9207
2367,燿華,409,150,259,凱基-永和,2024-07-26,9207
2897,王道銀行,140,0,140,凱基-永和,2024-07-26,9207
2801,彰銀,136,0,136,凱基-永和,2024-07-26,9207
2330,台積電,125,4,121,凱基-永和,2024-07-26,9207
8936,國統,100,2,98,凱基-永和,2024-07-26,9207
6462,神盾,104,7,97,凱基-永和,2024-07-26,9207
00878,國泰永續高股息,80,4,76,凱基-永和,2024-07-26,9207
00937B,群益ESG投等債20,87,15,72,凱基-永和,2024-07-26,9207
00929,復華台灣科技優息,69,0,69,凱基-永和,2024-07-26,9207
00905,FT臺灣Smart,49,0,49,凱基-永和,2024-07-26,9207
2897A,王道銀甲特,40,0,40,凱基-永和,2024-07-26,9207
4128,中天,36,2,34,凱基-永和,2024-07-26,9207
00933B,國泰10Y+金融債,33,0,33,凱基-永和,2024-07-26,9207
00919,群益台灣精選高息,101,70,31,凱基-永和,2024-07-26,9207
3680,家登,29,0,29,凱基-永和,2024-07-26,9207
00949,復華日本龍頭,25,0,25,凱基-永和,2024-07-26,9207
00936,台新永續高息中小,23,0,23,凱基-永和,2024-07-26,9207
1303,南亞,22,0,22,凱基-永和,2024-07-26,9207
2377,微星,21,0,21,凱基-永和,2024-07-26,9207
2483,百容,20,0,20,凱基-永和,2024-07-26,9207
00931B,統一美債20年,22,4,18,凱基-永和,2024-07-26,9207
3711,日月光投控,18,0,18,凱基-永和,2024-07-26,9207
00927,群益半導體收益,18,2,16,凱基-永和,2024-07-26,9207
00751B,元大AAA至A公司債,15,0,15,凱基-永和,2024-07-26,9207
0056,元大高股息,12,0,12,凱基-永和,2024-07-26,9207
00951,台新日本半導體,12,0,12,凱基-永和,2024-07-26,9207
6698,旭暉應材,12,0,12,凱基-永和,2024-07-26,9207
00637L,元大滬深300正2,11,0,11,凱基-永和,2024-07-26,9207
3264,欣銓,10,0,10,凱基-永和,2024-07-26,9207
00680L,元大美債20正2,10,0,10,凱基-永和,2024-07-26,9207
00922,國泰台灣領袖50,10,0,10,凱基-永和,2024-07-26,9207
2332,友訊,10,0,10,凱基-永和,2024-07-26,9207
2352,佳世達,9,0,9,凱基-永和,2024-07-26,9207
3105,穩懋,11,2,9,凱基-永和,2024-07-26,9207
00882,中信中國高股息,9,0,9,凱基-永和,2024-07-26,9207
2382,廣達,12,3,9,凱基-永和,2024-07-26,9207
2883,凱基金,11,2,9,凱基-永和,2024-07-26,9207
2348,海悅,8,0,8,凱基-永和,2024-07-26,9207
00738U,期元大道瓊白銀,8,0,8,凱基-永和,2024-07-26,9207
00645,富邦日本,8,0,8,凱基-永和,2024-07-26,9207
00948B,中信優息投資級債,10,2,8,凱基-永和,2024-07-26,9207
2489,瑞軒,8,0,8,凱基-永和,2024-07-26,9207
2408,南亞科,7,0,7,凱基-永和,2024-07-26,9207
00923,群益台ESG低碳50,7,0,7,凱基-永和,2024-07-26,9207
006208,富邦台50,9,2,7,凱基-永和,2024-07-26,9207
00934,中信成長高股息,7,0,7,凱基-永和,2024-07-26,9207
3037,欣興,7,0,7,凱基-永和,2024-07-26,9207
0050,元大台灣50,9,2,7,凱基-永和,2024-07-26,9207
3518,柏騰,200,0,200,凱基-永和,2024-07-29,9207
2337,旺宏,129,38,91,凱基-永和,2024-07-29,9207
0052,富邦科技,80,0,80,凱基-永和,2024-07-29,9207
00878,國泰永續高股息,64,0,64,凱基-永和,2024-07-29,9207
00929,復華台灣科技優息,77,24,53,凱基-永和,2024-07-29,9207
00940,元大台灣價值高息,55,3,52,凱基-永和,2024-07-29,9207
00919,群益台灣精選高息,62,14,48,凱基-永和,2024-07-29,9207
00706L,期元大S＆P日圓正2,33,0,33,凱基-永和,2024-07-29,9207
00637L,元大滬深300正2,31,0,31,凱基-永和,2024-07-29,9207
00937B,群益ESG投等債20,33,10,23,凱基-永和,2024-07-29,9207
1513,中興電,26,4,22,凱基-永和,2024-07-29,9207
00946,群益科技高息成長,19,0,19,凱基-永和,2024-07-29,9207
3481,群創,21,4,17,凱基-永和,2024-07-29,9207
1785,光洋科,28,12,16,凱基-永和,2024-07-29,9207
2356,英業達,19,3,16,凱基-永和,2024-07-29,9207
6139,亞翔,15,0,15,凱基-永和,2024-07-29,9207
2002,中鋼,15,0,15,凱基-永和,2024-07-29,9207
0056,元大高股息,14,0,14,凱基-永和,2024-07-29,9207
2537,聯上發,25,11,14,凱基-永和,2024-07-29,9207
00915,凱基優選高股息30,13,0,13,凱基-永和,2024-07-29,9207
1503,士電,13,1,12,凱基-永和,2024-07-29,9207
2408,南亞科,11,0,11,凱基-永和,2024-07-29,9207
2329,華泰,11,0,11,凱基-永和,2024-07-29,9207
2344,華邦電,12,1,11,凱基-永和,2024-07-29,9207
4956,光鋐,11,0,11,凱基-永和,2024-07-29,9207
1504,東元,10,0,10,凱基-永和,2024-07-29,9207
00687B,國泰20年美債,9,0,9,凱基-永和,2024-07-29,9207
2483,百容,9,0,9,凱基-永和,2024-07-29,9207
2618,長榮航,10,1,9,凱基-永和,2024-07-29,9207
2317,鴻海,9,1,8,凱基-永和,2024-07-29,9207
1609,大亞,9,1,8,凱基-永和,2024-07-29,9207
3231,緯創,13,5,8,凱基-永和,2024-07-29,9207
00936,台新永續高息中小,8,0,8,凱基-永和,2024-07-29,9207
2324,仁寶,10,2,8,凱基-永和,2024-07-29,9207
2515,中工,8,0,8,凱基-永和,2024-07-29,9207
6229,研通,8,0,8,凱基-永和,2024-07-29,9207
8028,昇陽半導體,35,27,8,凱基-永和,2024-07-29,9207
6290,良維,7,0,7,凱基-永和,2024-07-29,9207
00830,國泰費城半導體,20,14,6,凱基-永和,2024-07-29,9207
3217,優群,6,0,6,凱基-永和,2024-07-29,9207
9105,泰金寶-DR,6,0,6,凱基-永和,2024-07-29,9207
2382,廣達,8,3,5,凱基-永和,2024-07-29,9207
00941,中信上游半導體,5,0,5,凱基-永和,2024-07-29,9207
00725B,國泰投資級公司債,5,0,5,凱基-永和,2024-07-29,9207
00951,台新日本半導體,5,0,5,凱基-永和,2024-07-29,9207
1710,東聯,5,0,5,凱基-永和,2024-07-29,9207
1737,臺鹽,5,0,5,凱基-永和,2024-07-29,9207
2486,一詮,6,1,5,凱基-永和,2024-07-29,9207
2890,永豐金,5,0,5,凱基-永和,2024-07-29,9207
2897,王道銀行,5,0,5,凱基-永和,2024-07-29,9207
3163,波若威,502,101,401,凱基-永和,2024-07-30,9207
8028,昇陽半導體,500,205,295,凱基-永和,2024-07-30,9207
2362,藍天,202,2,200,凱基-永和,2024-07-30,9207
4956,光鋐,201,15,186,凱基-永和,2024-07-30,9207
3518,柏騰,105,0,105,凱基-永和,2024-07-30,9207
3189,景碩,107,2,105,凱基-永和,2024-07-30,9207
5234,達興材料,104,0,104,凱基-永和,2024-07-30,9207
00937B,群益ESG投等債20,74,7,67,凱基-永和,2024-07-30,9207
00940,元大台灣價值高息,67,8,59,凱基-永和,2024-07-30,9207
2801,彰銀,54,0,54,凱基-永和,2024-07-30,9207
2891,中信金,46,4,42,凱基-永和,2024-07-30,9207
3563,牧德,37,0,37,凱基-永和,2024-07-30,9207
2603,長榮,41,4,37,凱基-永和,2024-07-30,9207
00679B,元大美債20年,41,5,36,凱基-永和,2024-07-30,9207
2317,鴻海,46,13,33,凱基-永和,2024-07-30,9207
00933B,國泰10Y+金融債,33,1,32,凱基-永和,2024-07-30,9207
2356,英業達,34,9,25,凱基-永和,2024-07-30,9207
3008,大立光,24,0,24,凱基-永和,2024-07-30,9207
00637L,元大滬深300正2,22,0,22,凱基-永和,2024-07-30,9207
2880,華南金,20,0,20,凱基-永和,2024-07-30,9207
6603,富強鑫,20,0,20,凱基-永和,2024-07-30,9207
00946,群益科技高息成長,19,0,19,凱基-永和,2024-07-30,9207
2382,廣達,19,1,18,凱基-永和,2024-07-30,9207
00919,群益台灣精選高息,29,11,18,凱基-永和,2024-07-30,9207
00936,台新永續高息中小,17,0,17,凱基-永和,2024-07-30,9207
00934,中信成長高股息,35,18,17,凱基-永和,2024-07-30,9207
2349,錸德,32,15,17,凱基-永和,2024-07-30,9207
2449,京元電子,17,0,17,凱基-永和,2024-07-30,9207
2408,南亞科,16,3,13,凱基-永和,2024-07-30,9207
3680,家登,13,0,13,凱基-永和,2024-07-30,9207
1513,中興電,19,7,12,凱基-永和,2024-07-30,9207
2610,華航,12,0,12,凱基-永和,2024-07-30,9207
0056,元大高股息,14,2,12,凱基-永和,2024-07-30,9207
1605,華新,11,0,11,凱基-永和,2024-07-30,9207
2489,瑞軒,20,9,11,凱基-永和,2024-07-30,9207
8096,擎亞,11,0,11,凱基-永和,2024-07-30,9207
6239,力成,10,0,10,凱基-永和,2024-07-30,9207
00905,FT臺灣Smart,10,0,10,凱基-永和,2024-07-30,9207
00951,台新日本半導體,10,0,10,凱基-永和,2024-07-30,9207
8104,錸寶,10,0,10,凱基-永和,2024-07-30,9207
5009,榮剛,9,0,9,凱基-永和,2024-07-30,9207
00878,國泰永續高股息,21,12,9,凱基-永和,2024-07-30,9207
00923,群益台ESG低碳50,8,0,8,凱基-永和,2024-07-30,9207
2596,綠意,7,0,7,凱基-永和,2024-07-30,9207
2884,玉山金,8,2,6,凱基-永和,2024-07-30,9207
00715L,期街口布蘭特正2,6,0,6,凱基-永和,2024-07-30,9207
2419,仲琦,6,0,6,凱基-永和,2024-07-30,9207
00636,國泰中國A50,5,0,5,凱基-永和,2024-07-30,9207
00915,凱基優選高股息30,5,0,5,凱基-永和,2024-07-30,9207
00687B,國泰20年美債,5,0,5,凱基-永和,2024-07-30,9207
2363,矽統,442,172,270,凱基-永和,2024-07-31,9207
00937B,群益ESG投等債20,135,0,135,凱基-永和,2024-07-31,9207
3481,群創,104,28,76,凱基-永和,2024-07-31,9207
00878,國泰永續高股息,63,1,62,凱基-永和,2024-07-31,9207
2603,長榮,46,1,45,凱基-永和,2024-07-31,9207
00929,復華台灣科技優息,36,1,35,凱基-永和,2024-07-31,9207
00919,群益台灣精選高息,24,0,24,凱基-永和,2024-07-31,9207
2344,華邦電,22,0,22,凱基-永和,2024-07-31,9207
8112,至上,21,0,21,凱基-永和,2024-07-31,9207
00725B,國泰投資級公司債,20,0,20,凱基-永和,2024-07-31,9207
8096,擎亞,43,23,20,凱基-永和,2024-07-31,9207
00946,群益科技高息成長,19,0,19,凱基-永和,2024-07-31,9207
2498,宏達電,20,1,19,凱基-永和,2024-07-31,9207
00651R,復華香港反1,15,0,15,凱基-永和,2024-07-31,9207
4906,正文,20,5,15,凱基-永和,2024-07-31,9207
3715,定穎投控,15,4,11,凱基-永和,2024-07-31,9207
3105,穩懋,11,0,11,凱基-永和,2024-07-31,9207
00934,中信成長高股息,11,0,11,凱基-永和,2024-07-31,9207
2886,兆豐金,12,1,11,凱基-永和,2024-07-31,9207
00688L,國泰20年美債正2,10,0,10,凱基-永和,2024-07-31,9207
00680L,元大美債20正2,20,10,10,凱基-永和,2024-07-31,9207
2204,中華,11,1,10,凱基-永和,2024-07-31,9207
6271,同欣電,9,0,9,凱基-永和,2024-07-31,9207
00936,台新永續高息中小,13,5,8,凱基-永和,2024-07-31,9207
3376,新日興,11,3,8,凱基-永和,2024-07-31,9207
1605,華新,7,0,7,凱基-永和,2024-07-31,9207
2486,一詮,6,0,6,凱基-永和,2024-07-31,9207
00715L,期街口布蘭特正2,9,3,6,凱基-永和,2024-07-31,9207
2892,第一金,6,0,6,凱基-永和,2024-07-31,9207
3008,大立光,6,0,6,凱基-永和,2024-07-31,9207
6443,元晶,6,0,6,凱基-永和,2024-07-31,9207
00830,國泰費城半導體,16,11,5,凱基-永和,2024-07-31,9207
1608,華榮,5,0,5,凱基-永和,2024-07-31,9207
2617,台航,5,0,5,凱基-永和,2024-07-31,9207
3596,智易,5,0,5,凱基-永和,2024-07-31,9207
3711,日月光投控,5,0,5,凱基-永和,2024-07-31,9207
6209,今國光,5,0,5,凱基-永和,2024-07-31,9207
8054,安國,5,0,5,凱基-永和,2024-07-31,9207
2882,國泰金,5,0,5,凱基-永和,2024-07-31,9207
3050,鈺德,5,0,5,凱基-永和,2024-07-31,9207
00757,統一FANG+,54,49,5,凱基-永和,2024-07-31,9207
2812,台中銀,5,0,5,凱基-永和,2024-07-31,9207
2609,陽明,5,1,4,凱基-永和,2024-07-31,9207
00712,復華富時不動產,4,0,4,凱基-永和,2024-07-31,9207
1229,聯華,4,0,4,凱基-永和,2024-07-31,9207
1514,亞力,4,0,4,凱基-永和,2024-07-31,9207
2527,宏璟,5,1,4,凱基-永和,2024-07-31,9207
4526,東台,4,0,4,凱基-永和,2024-07-31,9207
4560,強信-KY,4,0,4,凱基-永和,2024-07-31,9207
6117,迎廣,4,0,4,凱基-永和,2024-07-31,9207
1316,上曜,400,103,297,凱基-永和,2024-08-01,9207
2527,宏璟,201,0,201,凱基-永和,2024-08-01,9207
2359,所羅門,201,2,199,凱基-永和,2024-08-01,9207
2362,藍天,382,225,157,凱基-永和,2024-08-01,9207
2301,光寶科,253,142,111,凱基-永和,2024-08-01,9207
00937B,群益ESG投等債20,104,0,104,凱基-永和,2024-08-01,9207
3163,波若威,257,156,101,凱基-永和,2024-08-01,9207
3048,益登,100,0,100,凱基-永和,2024-08-01,9207
4562,穎漢,100,3,97,凱基-永和,2024-08-01,9207
2365,昆盈,100,5,95,凱基-永和,2024-08-01,9207
6805,富世達,70,2,68,凱基-永和,2024-08-01,9207
00632R,元大台灣50反1,58,1,57,凱基-永和,2024-08-01,9207
00927,群益半導體收益,48,0,48,凱基-永和,2024-08-01,9207
00640L,富邦日本正2,37,0,37,凱基-永和,2024-08-01,9207
00878,國泰永續高股息,40,5,35,凱基-永和,2024-08-01,9207
00687B,國泰20年美債,29,0,29,凱基-永和,2024-08-01,9207
2337,旺宏,44,15,29,凱基-永和,2024-08-01,9207
00679B,元大美債20年,32,3,29,凱基-永和,2024-08-01,9207
2610,華航,30,2,28,凱基-永和,2024-08-01,9207
4956,光鋐,23,0,23,凱基-永和,2024-08-01,9207
2618,長榮航,22,0,22,凱基-永和,2024-08-01,9207
3013,晟銘電,23,2,21,凱基-永和,2024-08-01,9207
00706L,期元大S＆P日圓正2,19,0,19,凱基-永和,2024-08-01,9207
6213,聯茂,20,1,19,凱基-永和,2024-08-01,9207
00929,復華台灣科技優息,53,36,17,凱基-永和,2024-08-01,9207
2801,彰銀,22,7,15,凱基-永和,2024-08-01,9207
00881,國泰台灣5G+,14,0,14,凱基-永和,2024-08-01,9207
2344,華邦電,12,0,12,凱基-永和,2024-08-01,9207
3680,家登,11,0,11,凱基-永和,2024-08-01,9207
00671R,富邦NASDAQ反1,10,0,10,凱基-永和,2024-08-01,9207
1721,三晃,11,1,10,凱基-永和,2024-08-01,9207
9958,世紀鋼,10,0,10,凱基-永和,2024-08-01,9207
5880,合庫金,11,1,10,凱基-永和,2024-08-01,9207
2317,鴻海,18,8,10,凱基-永和,2024-08-01,9207
00915,凱基優選高股息30,9,0,9,凱基-永和,2024-08-01,9207
2356,英業達,12,3,9,凱基-永和,2024-08-01,9207
3450,聯鈞,10,1,9,凱基-永和,2024-08-01,9207
00850,元大臺灣ESG永續,8,0,8,凱基-永和,2024-08-01,9207
00725B,國泰投資級公司債,8,0,8,凱基-永和,2024-08-01,9207
00882,中信中國高股息,8,0,8,凱基-永和,2024-08-01,9207
2486,一詮,14,6,8,凱基-永和,2024-08-01,9207
0056,元大高股息,8,1,7,凱基-永和,2024-08-01,9207
2348,海悅,8,1,7,凱基-永和,2024-08-01,9207
3712,永崴投控,7,0,7,凱基-永和,2024-08-01,9207
3715,定穎投控,10,3,7,凱基-永和,2024-08-01,9207
6239,力成,7,0,7,凱基-永和,2024-08-01,9207
00934,中信成長高股息,7,1,6,凱基-永和,2024-08-01,9207
2243,宏旭-KY,6,0,6,凱基-永和,2024-08-01,9207
8085,福華,6,0,6,凱基-永和,2024-08-01,9207
00918,大華優利高填息30,6,0,6,凱基-永和,2024-08-01,9207
00632R,元大台灣50反1,999,82,917,凱基-永和,2024-08-02,9207
2408,南亞科,278,1,277,凱基-永和,2024-08-02,9207
00680L,元大美債20正2,194,5,189,凱基-永和,2024-08-02,9207
00878,國泰永續高股息,99,0,99,凱基-永和,2024-08-02,9207
00919,群益台灣精選高息,59,0,59,凱基-永和,2024-08-02,9207
00946,群益科技高息成長,57,0,57,凱基-永和,2024-08-02,9207
00948B,中信優息投資級債,56,0,56,凱基-永和,2024-08-02,9207
00940,元大台灣價值高息,48,0,48,凱基-永和,2024-08-02,9207
00713,元大台灣高息低波,46,0,46,凱基-永和,2024-08-02,9207
00929,復華台灣科技優息,51,6,45,凱基-永和,2024-08-02,9207
2317,鴻海,91,48,43,凱基-永和,2024-08-02,9207
2454,聯發科,43,3,40,凱基-永和,2024-08-02,9207
00937B,群益ESG投等債20,48,12,36,凱基-永和,2024-08-02,9207
5512,力麒,33,0,33,凱基-永和,2024-08-02,9207
00687B,國泰20年美債,32,2,30,凱基-永和,2024-08-02,9207
2353,宏��,25,1,24,凱基-永和,2024-08-02,9207
00947,台新臺灣IC設計,22,0,22,凱基-永和,2024-08-02,9207
00923,群益台ESG低碳50,32,10,22,凱基-永和,2024-08-02,9207
00931B,統一美債20年,21,0,21,凱基-永和,2024-08-02,9207
2449,京元電子,23,2,21,凱基-永和,2024-08-02,9207
00674R,期元大S＆P黃金反1,20,0,20,凱基-永和,2024-08-02,9207
2867,三商壽,20,0,20,凱基-永和,2024-08-02,9207
6770,力積電,20,0,20,凱基-永和,2024-08-02,9207
3019,亞光,20,0,20,凱基-永和,2024-08-02,9207
0056,元大高股息,19,0,19,凱基-永和,2024-08-02,9207
3260,威剛,18,0,18,凱基-永和,2024-08-02,9207
00918,大華優利高填息30,18,1,17,凱基-永和,2024-08-02,9207
00949,復華日本龍頭,17,0,17,凱基-永和,2024-08-02,9207
00951,台新日本半導體,16,0,16,凱基-永和,2024-08-02,9207
3037,欣興,15,0,15,凱基-永和,2024-08-02,9207
0050,元大台灣50,16,1,15,凱基-永和,2024-08-02,9207
00679B,元大美債20年,20,6,14,凱基-永和,2024-08-02,9207
3047,訊舟,15,1,14,凱基-永和,2024-08-02,9207
3024,憶聲,15,2,13,凱基-永和,2024-08-02,9207
2603,長榮,15,3,12,凱基-永和,2024-08-02,9207
00927,群益半導體收益,12,0,12,凱基-永和,2024-08-02,9207
6215,和椿,15,3,12,凱基-永和,2024-08-02,9207
6269,台郡,12,0,12,凱基-永和,2024-08-02,9207
2382,廣達,20,8,12,凱基-永和,2024-08-02,9207
2520,冠德,13,2,11,凱基-永和,2024-08-02,9207
006208,富邦台50,13,3,10,凱基-永和,2024-08-02,9207
00941,中信上游半導體,10,0,10,凱基-永和,2024-08-02,9207
8358,金居,10,0,10,凱基-永和,2024-08-02,9207
9945,潤泰新,20,11,9,凱基-永和,2024-08-02,9207
3481,群創,17,8,9,凱基-永和,2024-08-02,9207
00891,中信關鍵半導體,11,2,9,凱基-永和,2024-08-02,9207
2610,華航,10,1,9,凱基-永和,2024-08-02,9207
3706,神達,9,0,9,凱基-永和,2024-08-02,9207
2313,華通,12,4,8,凱基-永和,2024-08-02,9207
00720B,元大投資級公司債,8,0,8,凱基-永和,2024-08-02,9207
00680L,元大美債20正2,871,38,833,凱基-永和,2024-08-05,9207
00940,元大台灣價值高息,241,31,210,凱基-永和,2024-08-05,9207
3189,景碩,182,0,182,凱基-永和,2024-08-05,9207
00929,復華台灣科技優息,183,38,145,凱基-永和,2024-08-05,9207
00878,國泰永續高股息,168,55,113,凱基-永和,2024-08-05,9207
00679B,元大美債20年,128,24,104,凱基-永和,2024-08-05,9207
2317,鴻海,1114,1011,103,凱基-永和,2024-08-05,9207
00919,群益台灣精選高息,107,29,78,凱基-永和,2024-08-05,9207
2897,王道銀行,70,0,70,凱基-永和,2024-08-05,9207
3481,群創,121,71,50,凱基-永和,2024-08-05,9207
2483,百容,50,0,50,凱基-永和,2024-08-05,9207
00706L,期元大S＆P日圓正2,47,0,47,凱基-永和,2024-08-05,9207
2867,三商壽,40,0,40,凱基-永和,2024-08-05,9207
6770,力積電,37,0,37,凱基-永和,2024-08-05,9207
3231,緯創,39,3,36,凱基-永和,2024-08-05,9207
3037,欣興,30,0,30,凱基-永和,2024-08-05,9207
00688L,國泰20年美債正2,40,10,30,凱基-永和,2024-08-05,9207
00951,台新日本半導體,30,0,30,凱基-永和,2024-08-05,9207
2328,廣宇,30,0,30,凱基-永和,2024-08-05,9207
1217,愛之味,30,1,29,凱基-永和,2024-08-05,9207
2615,萬海,51,22,29,凱基-永和,2024-08-05,9207
00937B,群益ESG投等債20,59,31,28,凱基-永和,2024-08-05,9207
00946,群益科技高息成長,42,14,28,凱基-永和,2024-08-05,9207
2409,友達,27,0,27,凱基-永和,2024-08-05,9207
2891,中信金,49,23,26,凱基-永和,2024-08-05,9207
2486,一詮,29,3,26,凱基-永和,2024-08-05,9207
00631L,元大台灣50正2,27,3,24,凱基-永和,2024-08-05,9207
9955,佳龍,100,77,23,凱基-永和,2024-08-05,9207
0056,元大高股息,44,22,22,凱基-永和,2024-08-05,9207
00933B,國泰10Y+金融債,22,0,22,凱基-永和,2024-08-05,9207
5512,力麒,22,0,22,凱基-永和,2024-08-05,9207
006208,富邦台50,23,1,22,凱基-永和,2024-08-05,9207
00935,野村臺灣新科技50,21,0,21,凱基-永和,2024-08-05,9207
00881,國泰台灣5G+,22,2,20,凱基-永和,2024-08-05,9207
8091,翔名,20,0,20,凱基-永和,2024-08-05,9207
6015,宏遠證,20,1,19,凱基-永和,2024-08-05,9207
2489,瑞軒,20,3,17,凱基-永和,2024-08-05,9207
2801,彰銀,20,3,17,凱基-永和,2024-08-05,9207
3580,友威科,18,1,17,凱基-永和,2024-08-05,9207
00675L,富邦臺灣加權正2,18,2,16,凱基-永和,2024-08-05,9207
2014,中鴻,16,0,16,凱基-永和,2024-08-05,9207
00936,台新永續高息中小,15,0,15,凱基-永和,2024-08-05,9207
00795B,中信美國公債20年,15,0,15,凱基-永和,2024-08-05,9207
6667,信紘科,15,0,15,凱基-永和,2024-08-05,9207
2886,兆豐金,19,5,14,凱基-永和,2024-08-05,9207
0050,元大台灣50,16,2,14,凱基-永和,2024-08-05,9207
3689,湧德,13,0,13,凱基-永和,2024-08-05,9207
6284,佳邦,20,7,13,凱基-永和,2024-08-05,9207
00947,台新臺灣IC設計,16,4,12,凱基-永和,2024-08-05,9207
2354,鴻準,13,1,12,凱基-永和,2024-08-05,9207
2317,鴻海,1291,79,1212,凱基-永和,2024-08-06,9207
3189,景碩,363,128,235,凱基-永和,2024-08-06,9207
3163,波若威,410,191,219,凱基-永和,2024-08-06,9207
4909,新復興,102,1,101,凱基-永和,2024-08-06,9207
00940,元大台灣價值高息,77,21,56,凱基-永和,2024-08-06,9207
3680,家登,57,10,47,凱基-永和,2024-08-06,9207
2337,旺宏,56,11,45,凱基-永和,2024-08-06,9207
2887,台新金,44,1,43,凱基-永和,2024-08-06,9207
2483,百容,45,5,40,凱基-永和,2024-08-06,9207
6757,台灣虎航,40,0,40,凱基-永和,2024-08-06,9207
2002,中鋼,44,7,37,凱基-永和,2024-08-06,9207
00688L,國泰20年美債正2,65,30,35,凱基-永和,2024-08-06,9207
00830,國泰費城半導體,40,8,32,凱基-永和,2024-08-06,9207
2348,海悅,33,2,31,凱基-永和,2024-08-06,9207
6109,亞元,38,12,26,凱基-永和,2024-08-06,9207
2610,華航,25,1,24,凱基-永和,2024-08-06,9207
00713,元大台灣高息低波,22,0,22,凱基-永和,2024-08-06,9207
2888,新光金,27,7,20,凱基-永和,2024-08-06,9207
2897,王道銀行,20,0,20,凱基-永和,2024-08-06,9207
2349,錸德,28,8,20,凱基-永和,2024-08-06,9207
4746,台耀,20,0,20,凱基-永和,2024-08-06,9207
6187,萬潤,24,4,20,凱基-永和,2024-08-06,9207
2409,友達,20,0,20,凱基-永和,2024-08-06,9207
1316,上曜,17,0,17,凱基-永和,2024-08-06,9207
2834,臺企銀,16,0,16,凱基-永和,2024-08-06,9207
8234,新漢,15,0,15,凱基-永和,2024-08-06,9207
00934,中信成長高股息,21,7,14,凱基-永和,2024-08-06,9207
1609,大亞,20,6,14,凱基-永和,2024-08-06,9207
00918,大華優利高填息30,17,3,14,凱基-永和,2024-08-06,9207
2362,藍天,17,5,12,凱基-永和,2024-08-06,9207
3689,湧德,22,10,12,凱基-永和,2024-08-06,9207
2356,英業達,11,0,11,凱基-永和,2024-08-06,9207
00641R,富邦日本反1,11,0,11,凱基-永和,2024-08-06,9207
4958,臻鼎-KY,12,1,11,凱基-永和,2024-08-06,9207
0056,元大高股息,31,20,11,凱基-永和,2024-08-06,9207
2882,國泰金,14,3,11,凱基-永和,2024-08-06,9207
1313,聯成,10,0,10,凱基-永和,2024-08-06,9207
2820,華票,10,0,10,凱基-永和,2024-08-06,9207
6229,研通,22,12,10,凱基-永和,2024-08-06,9207
2886,兆豐金,26,18,8,凱基-永和,2024-08-06,9207
2460,建通,8,0,8,凱基-永和,2024-08-06,9207
3374,精材,18,10,8,凱基-永和,2024-08-06,9207
9945,潤泰新,12,5,7,凱基-永和,2024-08-06,9207
00891,中信關鍵半導體,8,1,7,凱基-永和,2024-08-06,9207
00933B,國泰10Y+金融債,7,0,7,凱基-永和,2024-08-06,9207
00712,復華富時不動產,7,0,7,凱基-永和,2024-08-06,9207
00738U,期元大道瓊白銀,7,0,7,凱基-永和,2024-08-06,9207
3581,博磊,15,8,7,凱基-永和,2024-08-06,9207
2867,三商壽,6,0,6,凱基-永和,2024-08-06,9207
1513,中興電,8,2,6,凱基-永和,2024-08-06,9207
00632R,元大台灣50反1,292,0,292,凱基-永和,2024-08-07,9207
00679B,元大美債20年,159,18,141,凱基-永和,2024-08-07,9207
00687B,國泰20年美債,155,26,129,凱基-永和,2024-08-07,9207
00878,國泰永續高股息,92,13,79,凱基-永和,2024-08-07,9207
2312,金寶,68,5,63,凱基-永和,2024-08-07,9207
2615,萬海,69,12,57,凱基-永和,2024-08-07,9207
3481,群創,57,0,57,凱基-永和,2024-08-07,9207
3680,家登,56,0,56,凱基-永和,2024-08-07,9207
1436,華友聯,24,0,24,凱基-永和,2024-08-07,9207
2892,第一金,24,0,24,凱基-永和,2024-08-07,9207
2356,英業達,24,3,21,凱基-永和,2024-08-07,9207
00935,野村臺灣新科技50,20,0,20,凱基-永和,2024-08-07,9207
2002,中鋼,20,0,20,凱基-永和,2024-08-07,9207
2801,彰銀,20,0,20,凱基-永和,2024-08-07,9207
8210,勤誠,20,0,20,凱基-永和,2024-08-07,9207
00937B,群益ESG投等債20,23,3,20,凱基-永和,2024-08-07,9207
00720B,元大投資級公司債,15,0,15,凱基-永和,2024-08-07,9207
3357,臺慶科,15,0,15,凱基-永和,2024-08-07,9207
9105,泰金寶-DR,33,20,13,凱基-永和,2024-08-07,9207
2618,長榮航,11,0,11,凱基-永和,2024-08-07,9207
00713,元大台灣高息低波,11,0,11,凱基-永和,2024-08-07,9207
00795B,中信美國公債20年,11,0,11,凱基-永和,2024-08-07,9207
9933,中鼎,11,0,11,凱基-永和,2024-08-07,9207
2891,中信金,11,1,10,凱基-永和,2024-08-07,9207
00764B,群益25年美債,10,0,10,凱基-永和,2024-08-07,9207
00945B,凱基美國非投等債,10,0,10,凱基-永和,2024-08-07,9207
00946,群益科技高息成長,9,0,9,凱基-永和,2024-08-07,9207
2382,廣達,14,5,9,凱基-永和,2024-08-07,9207
00929,復華台灣科技優息,18,11,7,凱基-永和,2024-08-07,9207
2887,台新金,6,0,6,凱基-永和,2024-08-07,9207
2886,兆豐金,6,0,6,凱基-永和,2024-08-07,9207
3450,聯鈞,6,0,6,凱基-永和,2024-08-07,9207
4540,全球傳動,5,0,5,凱基-永和,2024-08-07,9207
00725B,國泰投資級公司債,5,0,5,凱基-永和,2024-08-07,9207
00715L,期街口布蘭特正2,5,0,5,凱基-永和,2024-08-07,9207
00738U,期元大道瓊白銀,5,0,5,凱基-永和,2024-08-07,9207
2327,國巨,7,2,5,凱基-永和,2024-08-07,9207
6719,力智,5,0,5,凱基-永和,2024-08-07,9207
9904,寶成,5,0,5,凱基-永和,2024-08-07,9207
3037,欣興,9,5,4,凱基-永和,2024-08-07,9207
2809,京城銀,4,0,4,凱基-永和,2024-08-07,9207
2454,聯發科,4,0,4,凱基-永和,2024-08-07,9207
00712,復華富時不動產,7,3,4,凱基-永和,2024-08-07,9207
1301,台塑,4,0,4,凱基-永和,2024-08-07,9207
1316,上曜,6,2,4,凱基-永和,2024-08-07,9207
2524,京城,4,0,4,凱基-永和,2024-08-07,9207
2883,凱基金,5,1,4,凱基-永和,2024-08-07,9207
6139,亞翔,7,3,4,凱基-永和,2024-08-07,9207
6187,萬潤,4,0,4,凱基-永和,2024-08-07,9207
2330,台積電,10,7,3,凱基-永和,2024-08-07,9207
3189,景碩,357,11,346,凱基-永和,2024-08-08,9207
00680L,元大美債20正2,133,0,133,凱基-永和,2024-08-08,9207
00878,國泰永續高股息,105,2,103,凱基-永和,2024-08-08,9207
2464,盟立,108,7,101,凱基-永和,2024-08-08,9207
4562,穎漢,105,5,100,凱基-永和,2024-08-08,9207
6603,富強鑫,100,20,80,凱基-永和,2024-08-08,9207
2408,南亞科,79,0,79,凱基-永和,2024-08-08,9207
2317,鴻海,52,15,37,凱基-永和,2024-08-08,9207
00937B,群益ESG投等債20,35,0,35,凱基-永和,2024-08-08,9207
2382,廣達,33,1,32,凱基-永和,2024-08-08,9207
6125,廣運,36,4,32,凱基-永和,2024-08-08,9207
3481,群創,31,0,31,凱基-永和,2024-08-08,9207
00929,復華台灣科技優息,29,0,29,凱基-永和,2024-08-08,9207
00919,群益台灣精選高息,27,3,24,凱基-永和,2024-08-08,9207
00687B,國泰20年美債,24,0,24,凱基-永和,2024-08-08,9207
2486,一詮,26,2,24,凱基-永和,2024-08-08,9207
2886,兆豐金,20,0,20,凱基-永和,2024-08-08,9207
00688L,國泰20年美債正2,20,0,20,凱基-永和,2024-08-08,9207
6116,彩晶,20,0,20,凱基-永和,2024-08-08,9207
00679B,元大美債20年,20,1,19,凱基-永和,2024-08-08,9207
2376,技嘉,13,0,13,凱基-永和,2024-08-08,9207
00881,國泰台灣5G+,14,1,13,凱基-永和,2024-08-08,9207
00933B,國泰10Y+金融債,15,2,13,凱基-永和,2024-08-08,9207
2349,錸德,17,5,12,凱基-永和,2024-08-08,9207
2834,臺企銀,12,1,11,凱基-永和,2024-08-08,9207
3218,大學光,11,0,11,凱基-永和,2024-08-08,9207
3489,森寶,12,1,11,凱基-永和,2024-08-08,9207
00795B,中信美國公債20年,10,0,10,凱基-永和,2024-08-08,9207
1402,遠東新,12,2,10,凱基-永和,2024-08-08,9207
2615,萬海,21,11,10,凱基-永和,2024-08-08,9207
6026,福邦證,10,0,10,凱基-永和,2024-08-08,9207
6770,力積電,10,0,10,凱基-永和,2024-08-08,9207
2330,台積電,12,3,9,凱基-永和,2024-08-08,9207
3231,緯創,24,15,9,凱基-永和,2024-08-08,9207
00936,台新永續高息中小,9,0,9,凱基-永和,2024-08-08,9207
00946,群益科技高息成長,9,0,9,凱基-永和,2024-08-08,9207
2609,陽明,9,1,8,凱基-永和,2024-08-08,9207
2610,華航,17,10,7,凱基-永和,2024-08-08,9207
3032,偉訓,7,0,7,凱基-永和,2024-08-08,9207
2365,昆盈,39,32,7,凱基-永和,2024-08-08,9207
0056,元大高股息,8,1,7,凱基-永和,2024-08-08,9207
2489,瑞軒,14,7,7,凱基-永和,2024-08-08,9207
2348,海悅,8,2,6,凱基-永和,2024-08-08,9207
6158,禾昌,6,0,6,凱基-永和,2024-08-08,9207
6188,廣明,9,3,6,凱基-永和,2024-08-08,9207
006208,富邦台50,6,0,6,凱基-永和,2024-08-08,9207
6679,鈺太,5,0,5,凱基-永和,2024-08-08,9207
3673,TPK-KY,5,0,5,凱基-永和,2024-08-08,9207
4542,科嶠,5,0,5,凱基-永和,2024-08-08,9207
6182,合晶,5,0,5,凱基-永和,2024-08-08,9207
2449,京元電子,700,25,675,凱基-永和,2024-08-09,9207
2408,南亞科,404,2,402,凱基-永和,2024-08-09,9207
00632R,元大台灣50反1,296,10,286,凱基-永和,2024-08-09,9207
2618,長榮航,218,20,198,凱基-永和,2024-08-09,9207
2610,華航,161,62,99,凱基-永和,2024-08-09,9207
00937B,群益ESG投等債20,87,3,84,凱基-永和,2024-08-09,9207
3037,欣興,74,4,70,凱基-永和,2024-08-09,9207
8996,高力,60,0,60,凱基-永和,2024-08-09,9207
2882,國泰金,62,4,58,凱基-永和,2024-08-09,9207
00680L,元大美債20正2,80,30,50,凱基-永和,2024-08-09,9207
00679B,元大美債20年,45,0,45,凱基-永和,2024-08-09,9207
00929,復華台灣科技優息,42,0,42,凱基-永和,2024-08-09,9207
2886,兆豐金,35,0,35,凱基-永和,2024-08-09,9207
3047,訊舟,36,7,29,凱基-永和,2024-08-09,9207
3260,威剛,30,2,28,凱基-永和,2024-08-09,9207
00933B,國泰10Y+金融債,28,0,28,凱基-永和,2024-08-09,9207
2520,冠德,27,1,26,凱基-永和,2024-08-09,9207
3374,精材,23,1,22,凱基-永和,2024-08-09,9207
8446,華研,21,0,21,凱基-永和,2024-08-09,9207
2330,台積電,29,9,20,凱基-永和,2024-08-09,9207
3680,家登,20,0,20,凱基-永和,2024-08-09,9207
00687B,國泰20年美債,22,3,19,凱基-永和,2024-08-09,9207
2464,盟立,26,7,19,凱基-永和,2024-08-09,9207
1536,和大,23,6,17,凱基-永和,2024-08-09,9207
00751B,元大AAA至A公司債,15,1,14,凱基-永和,2024-08-09,9207
00919,群益台灣精選高息,16,2,14,凱基-永和,2024-08-09,9207
00936,台新永續高息中小,14,0,14,凱基-永和,2024-08-09,9207
2337,旺宏,13,0,13,凱基-永和,2024-08-09,9207
00688L,國泰20年美債正2,13,0,13,凱基-永和,2024-08-09,9207
00878,國泰永續高股息,36,24,12,凱基-永和,2024-08-09,9207
00951,台新日本半導體,12,0,12,凱基-永和,2024-08-09,9207
6177,達麗,12,0,12,凱基-永和,2024-08-09,9207
1446,宏和,15,4,11,凱基-永和,2024-08-09,9207
8040,九暘,11,0,11,凱基-永和,2024-08-09,9207
00795B,中信美國公債20年,10,0,10,凱基-永和,2024-08-09,9207
00881,國泰台灣5G+,12,2,10,凱基-永和,2024-08-09,9207
00671R,富邦NASDAQ反1,10,0,10,凱基-永和,2024-08-09,9207
00651R,復華香港反1,10,0,10,凱基-永和,2024-08-09,9207
1702,南僑,10,0,10,凱基-永和,2024-08-09,9207
4566,時碩工業,13,3,10,凱基-永和,2024-08-09,9207
6179,亞通,10,0,10,凱基-永和,2024-08-09,9207
9904,寶成,10,0,10,凱基-永和,2024-08-09,9207
3189,景碩,220,211,9,凱基-永和,2024-08-09,9207
9945,潤泰新,22,13,9,凱基-永和,2024-08-09,9207
2421,建準,11,3,8,凱基-永和,2024-08-09,9207
0056,元大高股息,9,1,8,凱基-永和,2024-08-09,9207
00950B,凱基A級公司債,8,0,8,凱基-永和,2024-08-09,9207
2405,輔信,8,0,8,凱基-永和,2024-08-09,9207
6757,台灣虎航,8,0,8,凱基-永和,2024-08-09,9207
3324,雙鴻,47,40,7,凱基-永和,2024-08-09,9207
00632R,元大台灣50反1,241,0,241,凱基-永和,2024-08-12,9207
3062,建漢,200,1,199,凱基-永和,2024-08-12,9207
2330,台積電,176,3,173,凱基-永和,2024-08-12,9207
00937B,群益ESG投等債20,59,0,59,凱基-永和,2024-08-12,9207
2408,南亞科,50,9,41,凱基-永和,2024-08-12,9207
00680L,元大美債20正2,54,15,39,凱基-永和,2024-08-12,9207
00679B,元大美債20年,36,0,36,凱基-永和,2024-08-12,9207
00918,大華優利高填息30,30,0,30,凱基-永和,2024-08-12,9207
1314,中石化,31,2,29,凱基-永和,2024-08-12,9207
1301,台塑,25,0,25,凱基-永和,2024-08-12,9207
1609,大亞,28,7,21,凱基-永和,2024-08-12,9207
00895,富邦未來車,20,0,20,凱基-永和,2024-08-12,9207
2440,太空梭,20,0,20,凱基-永和,2024-08-12,9207
6505,台塑化,20,0,20,凱基-永和,2024-08-12,9207
6754,匯僑設計,20,0,20,凱基-永和,2024-08-12,9207
2891,中信金,21,2,19,凱基-永和,2024-08-12,9207
2337,旺宏,20,2,18,凱基-永和,2024-08-12,9207
2886,兆豐金,16,0,16,凱基-永和,2024-08-12,9207
5534,長虹,13,0,13,凱基-永和,2024-08-12,9207
00929,復華台灣科技優息,45,34,11,凱基-永和,2024-08-12,9207
8096,擎亞,23,12,11,凱基-永和,2024-08-12,9207
00648R,元大S＆P500反1,10,0,10,凱基-永和,2024-08-12,9207
00795B,中信美國公債20年,10,0,10,凱基-永和,2024-08-12,9207
1402,遠東新,10,0,10,凱基-永和,2024-08-12,9207
2426,鼎元,10,0,10,凱基-永和,2024-08-12,9207
8234,新漢,10,0,10,凱基-永和,2024-08-12,9207
9105,泰金寶-DR,10,0,10,凱基-永和,2024-08-12,9207
2409,友達,10,0,10,凱基-永和,2024-08-12,9207
2882,國泰金,10,1,9,凱基-永和,2024-08-12,9207
9940,信義,9,0,9,凱基-永和,2024-08-12,9207
00934,中信成長高股息,17,8,9,凱基-永和,2024-08-12,9207
2405,輔信,8,0,8,凱基-永和,2024-08-12,9207
3218,大學光,8,0,8,凱基-永和,2024-08-12,9207
2368,金像電,9,1,8,凱基-永和,2024-08-12,9207
2542,興富發,8,0,8,凱基-永和,2024-08-12,9207
00946,群益科技高息成長,12,5,7,凱基-永和,2024-08-12,9207
1540,喬福,7,0,7,凱基-永和,2024-08-12,9207
2312,金寶,24,17,7,凱基-永和,2024-08-12,9207
3024,憶聲,7,0,7,凱基-永和,2024-08-12,9207
6743,安普新,7,0,7,凱基-永和,2024-08-12,9207
00941,中信上游半導體,7,0,7,凱基-永和,2024-08-12,9207
00878,國泰永續高股息,29,23,6,凱基-永和,2024-08-12,9207
1307,三芳,10,4,6,凱基-永和,2024-08-12,9207
2369,菱生,6,0,6,凱基-永和,2024-08-12,9207
2852,第一保,6,0,6,凱基-永和,2024-08-12,9207
2867,三商壽,6,0,6,凱基-永和,2024-08-12,9207
2892,第一金,6,0,6,凱基-永和,2024-08-12,9207
3081,聯亞,6,0,6,凱基-永和,2024-08-12,9207
4513,福裕,9,3,6,凱基-永和,2024-08-12,9207
00715L,期街口布蘭特正2,5,0,5,凱基-永和,2024-08-12,9207
2408,南亞科,148,0,148,凱基-永和,2024-08-13,9207
8096,擎亞,145,13,132,凱基-永和,2024-08-13,9207
4562,穎漢,125,7,118,凱基-永和,2024-08-13,9207
2344,華邦電,89,2,87,凱基-永和,2024-08-13,9207
2356,英業達,76,1,75,凱基-永和,2024-08-13,9207
00937B,群益ESG投等債20,63,0,63,凱基-永和,2024-08-13,9207
3680,家登,51,0,51,凱基-永和,2024-08-13,9207
6805,富世達,50,1,49,凱基-永和,2024-08-13,9207
2609,陽明,45,6,39,凱基-永和,2024-08-13,9207
4967,十銓,39,0,39,凱基-永和,2024-08-13,9207
3260,威剛,38,1,37,凱基-永和,2024-08-13,9207
00687B,國泰20年美債,33,0,33,凱基-永和,2024-08-13,9207
00679B,元大美債20年,32,0,32,凱基-永和,2024-08-13,9207
3037,欣興,32,1,31,凱基-永和,2024-08-13,9207
00680L,元大美債20正2,157,130,27,凱基-永和,2024-08-13,9207
6505,台塑化,24,0,24,凱基-永和,2024-08-13,9207
2327,國巨,28,8,20,凱基-永和,2024-08-13,9207
3231,緯創,31,14,17,凱基-永和,2024-08-13,9207
9904,寶成,15,0,15,凱基-永和,2024-08-13,9207
00940,元大台灣價值高息,16,4,12,凱基-永和,2024-08-13,9207
00946,群益科技高息成長,17,5,12,凱基-永和,2024-08-13,9207
2520,冠德,15,3,12,凱基-永和,2024-08-13,9207
2610,華航,21,10,11,凱基-永和,2024-08-13,9207
6180,橘子,11,0,11,凱基-永和,2024-08-13,9207
00929,復華台灣科技優息,24,14,10,凱基-永和,2024-08-13,9207
00674R,期元大S＆P黃金反1,10,0,10,凱基-永和,2024-08-13,9207
2892,第一金,10,0,10,凱基-永和,2024-08-13,9207
3005,神基,11,1,10,凱基-永和,2024-08-13,9207
6223,旺矽,11,1,10,凱基-永和,2024-08-13,9207
6754,匯僑設計,10,0,10,凱基-永和,2024-08-13,9207
8996,高力,11,1,10,凱基-永和,2024-08-13,9207
2891,中信金,10,1,9,凱基-永和,2024-08-13,9207
4906,正文,9,0,9,凱基-永和,2024-08-13,9207
00673R,期元大S＆P原油反1,8,0,8,凱基-永和,2024-08-13,9207
6213,聯茂,9,1,8,凱基-永和,2024-08-13,9207
2880,華南金,22,14,8,凱基-永和,2024-08-13,9207
2330,台積電,10,2,8,凱基-永和,2024-08-13,9207
00878,國泰永續高股息,21,15,6,凱基-永和,2024-08-13,9207
1808,潤隆,9,3,6,凱基-永和,2024-08-13,9207
2365,昆盈,27,21,6,凱基-永和,2024-08-13,9207
2374,佳能,13,7,6,凱基-永和,2024-08-13,9207
2383,台光電,6,0,6,凱基-永和,2024-08-13,9207
2886,兆豐金,9,3,6,凱基-永和,2024-08-13,9207
1519,華城,6,1,5,凱基-永和,2024-08-13,9207
00676R,富邦臺灣加權反1,5,0,5,凱基-永和,2024-08-13,9207
00712,復華富時不動產,5,0,5,凱基-永和,2024-08-13,9207
1540,喬福,6,1,5,凱基-永和,2024-08-13,9207
2368,金像電,5,0,5,凱基-永和,2024-08-13,9207
2614,東森,5,0,5,凱基-永和,2024-08-13,9207
4510,高鋒,5,0,5,凱基-永和,2024-08-13,9207
2449,京元電子,502,6,496,凱基-永和,2024-08-14,9207
8069,元太,245,2,243,凱基-永和,2024-08-14,9207
3289,宜特,182,5,177,凱基-永和,2024-08-14,9207
2801,彰銀,170,0,170,凱基-永和,2024-08-14,9207
2002,中鋼,107,6,101,凱基-永和,2024-08-14,9207
00632R,元大台灣50反1,107,10,97,凱基-永和,2024-08-14,9207
00687B,國泰20年美債,77,1,76,凱基-永和,2024-08-14,9207
1513,中興電,51,4,47,凱基-永和,2024-08-14,9207
00878,國泰永續高股息,54,16,38,凱基-永和,2024-08-14,9207
1514,亞力,47,9,38,凱基-永和,2024-08-14,9207
6116,彩晶,32,0,32,凱基-永和,2024-08-14,9207
1436,華友聯,31,0,31,凱基-永和,2024-08-14,9207
2408,南亞科,52,22,30,凱基-永和,2024-08-14,9207
2618,長榮航,32,3,29,凱基-永和,2024-08-14,9207
2888,新光金,28,1,27,凱基-永和,2024-08-14,9207
1609,大亞,26,2,24,凱基-永和,2024-08-14,9207
2892,第一金,20,0,20,凱基-永和,2024-08-14,9207
9945,潤泰新,26,6,20,凱基-永和,2024-08-14,9207
00936,台新永續高息中小,18,0,18,凱基-永和,2024-08-14,9207
00929,復華台灣科技優息,17,2,15,凱基-永和,2024-08-14,9207
00679B,元大美債20年,15,0,15,凱基-永和,2024-08-14,9207
1321,大洋,11,0,11,凱基-永和,2024-08-14,9207
6754,匯僑設計,11,0,11,凱基-永和,2024-08-14,9207
2615,萬海,22,12,10,凱基-永和,2024-08-14,9207
2331,精英,10,0,10,凱基-永和,2024-08-14,9207
3363,上詮,10,0,10,凱基-永和,2024-08-14,9207
0056,元大高股息,10,2,8,凱基-永和,2024-08-14,9207
2718,全心投控,8,0,8,凱基-永和,2024-08-14,9207
4155,訊映,8,0,8,凱基-永和,2024-08-14,9207
5512,力麒,8,0,8,凱基-永和,2024-08-14,9207
4513,福裕,13,5,8,凱基-永和,2024-08-14,9207
6806,森崴能源,7,0,7,凱基-永和,2024-08-14,9207
3450,聯鈞,8,1,7,凱基-永和,2024-08-14,9207
4549,桓達,7,0,7,凱基-永和,2024-08-14,9207
00919,群益台灣精選高息,7,1,6,凱基-永和,2024-08-14,9207
3715,定穎投控,7,1,6,凱基-永和,2024-08-14,9207
5206,坤悅,8,2,6,凱基-永和,2024-08-14,9207
8071,能率網通,10,4,6,凱基-永和,2024-08-14,9207
8222,寶一,6,0,6,凱基-永和,2024-08-14,9207
3017,奇鋐,7,2,5,凱基-永和,2024-08-14,9207
00932,兆豐永續高息等權,5,0,5,凱基-永和,2024-08-14,9207
00636,國泰中國A50,5,0,5,凱基-永和,2024-08-14,9207
00904,新光臺灣半導體30,5,0,5,凱基-永和,2024-08-14,9207
2401,凌陽,5,0,5,凱基-永和,2024-08-14,9207
2614,東森,5,0,5,凱基-永和,2024-08-14,9207
3006,晶豪科,5,0,5,凱基-永和,2024-08-14,9207
5443,均豪,9,4,5,凱基-永和,2024-08-14,9207
6209,今國光,5,0,5,凱基-永和,2024-08-14,9207
00881,國泰台灣5G+,4,0,4,凱基-永和,2024-08-14,9207
3013,晟銘電,9,5,4,凱基-永和,2024-08-14,9207
5371,中光電,202,1,201,凱基-永和,2024-08-15,9207
2401,凌陽,99,1,98,凱基-永和,2024-08-15,9207
2408,南亞科,75,1,74,凱基-永和,2024-08-15,9207
3374,精材,96,23,73,凱基-永和,2024-08-15,9207
00878,國泰永續高股息,94,28,66,凱基-永和,2024-08-15,9207
6805,富世達,90,36,54,凱基-永和,2024-08-15,9207
00687B,國泰20年美債,51,0,51,凱基-永和,2024-08-15,9207
3260,威剛,50,1,49,凱基-永和,2024-08-15,9207
2801,彰銀,42,0,42,凱基-永和,2024-08-15,9207
00680L,元大美債20正2,224,184,40,凱基-永和,2024-08-15,9207
00929,復華台灣科技優息,38,0,38,凱基-永和,2024-08-15,9207
3019,亞光,52,16,36,凱基-永和,2024-08-15,9207
00900,富邦特選高股息30,28,0,28,凱基-永和,2024-08-15,9207
2520,冠德,27,2,25,凱基-永和,2024-08-15,9207
00688L,國泰20年美債正2,20,0,20,凱基-永和,2024-08-15,9207
00632R,元大台灣50反1,19,0,19,凱基-永和,2024-08-15,9207
1609,大亞,19,0,19,凱基-永和,2024-08-15,9207
00937B,群益ESG投等債20,18,0,18,凱基-永和,2024-08-15,9207
00919,群益台灣精選高息,17,0,17,凱基-永和,2024-08-15,9207
4128,中天,15,0,15,凱基-永和,2024-08-15,9207
2376,技嘉,17,3,14,凱基-永和,2024-08-15,9207
3715,定穎投控,20,7,13,凱基-永和,2024-08-15,9207
2718,全心投控,12,0,12,凱基-永和,2024-08-15,9207
2891,中信金,14,2,12,凱基-永和,2024-08-15,9207
2886,兆豐金,15,3,12,凱基-永和,2024-08-15,9207
1714,和桐,11,0,11,凱基-永和,2024-08-15,9207
00636,國泰中國A50,10,0,10,凱基-永和,2024-08-15,9207
00715L,期街口布蘭特正2,10,0,10,凱基-永和,2024-08-15,9207
1504,東元,10,0,10,凱基-永和,2024-08-15,9207
3025,星通,10,0,10,凱基-永和,2024-08-15,9207
4561,健椿,19,9,10,凱基-永和,2024-08-15,9207
2330,台積電,9,0,9,凱基-永和,2024-08-15,9207
2365,昆盈,22,13,9,凱基-永和,2024-08-15,9207
2892,第一金,9,0,9,凱基-永和,2024-08-15,9207
00881,國泰台灣5G+,8,0,8,凱基-永和,2024-08-15,9207
1446,宏和,9,1,8,凱基-永和,2024-08-15,9207
2915,潤泰全,8,0,8,凱基-永和,2024-08-15,9207
3037,欣興,8,1,7,凱基-永和,2024-08-15,9207
00679B,元大美債20年,12,5,7,凱基-永和,2024-08-15,9207
2883B,凱基金乙特,6,0,6,凱基-永和,2024-08-15,9207
4402,郡都開發,6,0,6,凱基-永和,2024-08-15,9207
2062,橋椿,19,14,5,凱基-永和,2024-08-15,9207
1702,南僑,5,0,5,凱基-永和,2024-08-15,9207
2105,正新,5,0,5,凱基-永和,2024-08-15,9207
3217,優群,5,0,5,凱基-永和,2024-08-15,9207
4939,亞電,5,0,5,凱基-永和,2024-08-15,9207
5905,南仁湖,6,1,5,凱基-永和,2024-08-15,9207
6462,神盾,5,0,5,凱基-永和,2024-08-15,9207
2303,聯電,7,3,4,凱基-永和,2024-08-15,9207
00915,凱基優選高股息30,4,0,4,凱基-永和,2024-08-15,9207
3047,訊舟,423,132,291,凱基-永和,2024-08-16,9207
2449,京元電子,305,40,265,凱基-永和,2024-08-16,9207
5371,中光電,200,0,200,凱基-永和,2024-08-16,9207
8028,昇陽半導體,502,308,194,凱基-永和,2024-08-16,9207
2351,順德,104,0,104,凱基-永和,2024-08-16,9207
3580,友威科,103,1,102,凱基-永和,2024-08-16,9207
2354,鴻準,100,6,94,凱基-永和,2024-08-16,9207
6806,森崴能源,116,50,66,凱基-永和,2024-08-16,9207
3289,宜特,61,1,60,凱基-永和,2024-08-16,9207
00679B,元大美債20年,50,0,50,凱基-永和,2024-08-16,9207
3189,景碩,250,201,49,凱基-永和,2024-08-16,9207
00632R,元大台灣50反1,48,0,48,凱基-永和,2024-08-16,9207
6664,群翊,31,0,31,凱基-永和,2024-08-16,9207
2718,全心投控,26,0,26,凱基-永和,2024-08-16,9207
00643,群益深証中小,20,0,20,凱基-永和,2024-08-16,9207
3202,樺晟,20,0,20,凱基-永和,2024-08-16,9207
6016,康和證,20,0,20,凱基-永和,2024-08-16,9207
2367,燿華,23,5,18,凱基-永和,2024-08-16,9207
2324,仁寶,19,2,17,凱基-永和,2024-08-16,9207
1536,和大,18,2,16,凱基-永和,2024-08-16,9207
00680L,元大美債20正2,15,2,13,凱基-永和,2024-08-16,9207
2427,三商電,13,0,13,凱基-永和,2024-08-16,9207
1314,中石化,13,0,13,凱基-永和,2024-08-16,9207
00636,國泰中國A50,12,0,12,凱基-永和,2024-08-16,9207
2489,瑞軒,25,13,12,凱基-永和,2024-08-16,9207
3231,緯創,15,3,12,凱基-永和,2024-08-16,9207
3105,穩懋,12,0,12,凱基-永和,2024-08-16,9207
2486,一詮,12,0,12,凱基-永和,2024-08-16,9207
2337,旺宏,13,2,11,凱基-永和,2024-08-16,9207
00687B,國泰20年美債,10,0,10,凱基-永和,2024-08-16,9207
2356,英業達,11,1,10,凱基-永和,2024-08-16,9207
2397,友通,10,0,10,凱基-永和,2024-08-16,9207
3583,辛耘,11,1,10,凱基-永和,2024-08-16,9207
6160,欣技,10,0,10,凱基-永和,2024-08-16,9207
6667,信紘科,10,0,10,凱基-永和,2024-08-16,9207
8043,蜜望實,23,13,10,凱基-永和,2024-08-16,9207
2392,正崴,11,1,10,凱基-永和,2024-08-16,9207
2317,鴻海,72,62,10,凱基-永和,2024-08-16,9207
2801,彰銀,12,2,10,凱基-永和,2024-08-16,9207
00795B,中信美國公債20年,8,0,8,凱基-永和,2024-08-16,9207
2323,中環,10,2,8,凱基-永和,2024-08-16,9207
00715L,期街口布蘭特正2,8,1,7,凱基-永和,2024-08-16,9207
00881,國泰台灣5G+,9,2,7,凱基-永和,2024-08-16,9207
3284,太普高,22,15,7,凱基-永和,2024-08-16,9207
1785,光洋科,12,6,6,凱基-永和,2024-08-16,9207
6691,洋基工程,6,0,6,凱基-永和,2024-08-16,9207
2327,國巨,8,3,5,凱基-永和,2024-08-16,9207
00937B,群益ESG投等債20,5,0,5,凱基-永和,2024-08-16,9207
00951,台新日本半導體,5,0,5,凱基-永和,2024-08-16,9207
2431,聯昌,5,0,5,凱基-永和,2024-08-16,9207
5443,均豪,647,403,244,凱基-永和,2024-08-19,9207
00795B,中信美國公債20年,211,0,211,凱基-永和,2024-08-19,9207
2374,佳能,306,105,201,凱基-永和,2024-08-19,9207
00937B,群益ESG投等債20,181,0,181,凱基-永和,2024-08-19,9207
2351,順德,101,1,100,凱基-永和,2024-08-19,9207
2312,金寶,83,3,80,凱基-永和,2024-08-19,9207
00948B,中信優息投資級債,63,0,63,凱基-永和,2024-08-19,9207
6937,天虹,81,20,61,凱基-永和,2024-08-19,9207
2352,佳世達,60,3,57,凱基-永和,2024-08-19,9207
3680,家登,70,20,50,凱基-永和,2024-08-19,9207
00725B,國泰投資級公司債,42,0,42,凱基-永和,2024-08-19,9207
2449,京元電子,54,14,40,凱基-永和,2024-08-19,9207
00679B,元大美債20年,36,0,36,凱基-永和,2024-08-19,9207
3008,大立光,35,0,35,凱基-永和,2024-08-19,9207
6664,群翊,36,1,35,凱基-永和,2024-08-19,9207
00687B,國泰20年美債,34,0,34,凱基-永和,2024-08-19,9207
1710,東聯,30,0,30,凱基-永和,2024-08-19,9207
5371,中光電,32,3,29,凱基-永和,2024-08-19,9207
6125,廣運,32,3,29,凱基-永和,2024-08-19,9207
00632R,元大台灣50反1,25,0,25,凱基-永和,2024-08-19,9207
00933B,國泰10Y+金融債,25,0,25,凱基-永和,2024-08-19,9207
00929,復華台灣科技優息,58,34,24,凱基-永和,2024-08-19,9207
00712,復華富時不動產,21,0,21,凱基-永和,2024-08-19,9207
00949,復華日本龍頭,23,3,20,凱基-永和,2024-08-19,9207
3202,樺晟,20,0,20,凱基-永和,2024-08-19,9207
3380,明泰,18,0,18,凱基-永和,2024-08-19,9207
2204,中華,16,0,16,凱基-永和,2024-08-19,9207
00720B,元大投資級公司債,16,0,16,凱基-永和,2024-08-19,9207
8096,擎亞,20,4,16,凱基-永和,2024-08-19,9207
00688L,國泰20年美債正2,15,0,15,凱基-永和,2024-08-19,9207
2002,中鋼,14,0,14,凱基-永和,2024-08-19,9207
2419,仲琦,14,0,14,凱基-永和,2024-08-19,9207
2489,瑞軒,23,9,14,凱基-永和,2024-08-19,9207
2718,全心投控,13,0,13,凱基-永和,2024-08-19,9207
3056,富華新,13,0,13,凱基-永和,2024-08-19,9207
6188,廣明,14,1,13,凱基-永和,2024-08-19,9207
00900,富邦特選高股息30,12,0,12,凱基-永和,2024-08-19,9207
1611,中電,12,0,12,凱基-永和,2024-08-19,9207
4958,臻鼎-KY,11,0,11,凱基-永和,2024-08-19,9207
00882,中信中國高股息,14,4,10,凱基-永和,2024-08-19,9207
00674R,期元大S＆P黃金反1,10,0,10,凱基-永和,2024-08-19,9207
2359,所羅門,410,400,10,凱基-永和,2024-08-19,9207
00752,中信中國50,9,0,9,凱基-永和,2024-08-19,9207
00715L,期街口布蘭特正2,8,0,8,凱基-永和,2024-08-19,9207
2881,富邦金,9,1,8,凱基-永和,2024-08-19,9207
2609,陽明,8,1,7,凱基-永和,2024-08-19,9207
1785,光洋科,7,0,7,凱基-永和,2024-08-19,9207
5347,世界,9,2,7,凱基-永和,2024-08-19,9207
2382,廣達,16,10,6,凱基-永和,2024-08-19,9207
2014,中鴻,6,0,6,凱基-永和,2024-08-19,9207
2888,新光金,602,141,461,凱基-永和,2024-08-20,9207
6570,維田,237,0,237,凱基-永和,2024-08-20,9207
4958,臻鼎-KY,205,17,188,凱基-永和,2024-08-20,9207
6806,森崴能源,167,7,160,凱基-永和,2024-08-20,9207
2408,南亞科,150,0,150,凱基-永和,2024-08-20,9207
3037,欣興,101,0,101,凱基-永和,2024-08-20,9207
3167,大量,100,0,100,凱基-永和,2024-08-20,9207
1513,中興電,104,5,99,凱基-永和,2024-08-20,9207
6869,雲豹能源,100,1,99,凱基-永和,2024-08-20,9207
2330,台積電,87,1,86,凱基-永和,2024-08-20,9207
3289,宜特,60,0,60,凱基-永和,2024-08-20,9207
00931B,統一美債20年,50,0,50,凱基-永和,2024-08-20,9207
3073,天方能源,50,0,50,凱基-永和,2024-08-20,9207
3663,鑫科,64,21,43,凱基-永和,2024-08-20,9207
00687B,國泰20年美債,32,1,31,凱基-永和,2024-08-20,9207
00937B,群益ESG投等債20,31,0,31,凱基-永和,2024-08-20,9207
2520,冠德,44,14,30,凱基-永和,2024-08-20,9207
2365,昆盈,43,15,28,凱基-永和,2024-08-20,9207
00882,中信中國高股息,26,1,25,凱基-永和,2024-08-20,9207
00632R,元大台灣50反1,20,0,20,凱基-永和,2024-08-20,9207
3680,家登,105,85,20,凱基-永和,2024-08-20,9207
5488,松普,20,0,20,凱基-永和,2024-08-20,9207
6462,神盾,17,0,17,凱基-永和,2024-08-20,9207
00891,中信關鍵半導體,15,0,15,凱基-永和,2024-08-20,9207
2356,英業達,24,10,14,凱基-永和,2024-08-20,9207
3265,台星科,15,1,14,凱基-永和,2024-08-20,9207
3450,聯鈞,14,1,13,凱基-永和,2024-08-20,9207
00752,中信中國50,11,0,11,凱基-永和,2024-08-20,9207
00715L,期街口布蘭特正2,11,0,11,凱基-永和,2024-08-20,9207
00929,復華台灣科技優息,11,0,11,凱基-永和,2024-08-20,9207
1618,合機,12,1,11,凱基-永和,2024-08-20,9207
3202,樺晟,11,0,11,凱基-永和,2024-08-20,9207
3149,正達,10,0,10,凱基-永和,2024-08-20,9207
6109,亞元,10,0,10,凱基-永和,2024-08-20,9207
9955,佳龍,10,0,10,凱基-永和,2024-08-20,9207
00885,富邦越南,9,0,9,凱基-永和,2024-08-20,9207
2349,錸德,16,7,9,凱基-永和,2024-08-20,9207
00936,台新永續高息中小,8,0,8,凱基-永和,2024-08-20,9207
1785,光洋科,10,2,8,凱基-永和,2024-08-20,9207
4555,氣立,8,0,8,凱基-永和,2024-08-20,9207
5484,慧友,8,0,8,凱基-永和,2024-08-20,9207
6125,廣運,11,3,8,凱基-永和,2024-08-20,9207
00642U,期元大S＆P石油,8,1,7,凱基-永和,2024-08-20,9207
2401,凌陽,10,3,7,凱基-永和,2024-08-20,9207
2882,國泰金,8,2,6,凱基-永和,2024-08-20,9207
9945,潤泰新,9,3,6,凱基-永和,2024-08-20,9207
00945B,凱基美國非投等債,6,0,6,凱基-永和,2024-08-20,9207
2609,陽明,7,1,6,凱基-永和,2024-08-20,9207
6695,芯鼎,17,11,6,凱基-永和,2024-08-20,9207
8069,元太,6,0,6,凱基-永和,2024-08-20,9207
00688L,國泰20年美債正2,748,20,728,凱基-永和,2024-08-21,9207
00680L,元大美債20正2,440,68,372,凱基-永和,2024-08-21,9207
2408,南亞科,249,0,249,凱基-永和,2024-08-21,9207
2888,新光金,681,468,213,凱基-永和,2024-08-21,9207
2891,中信金,162,7,155,凱基-永和,2024-08-21,9207
1519,華城,51,1,50,凱基-永和,2024-08-21,9207
2002,中鋼,50,5,45,凱基-永和,2024-08-21,9207
00937B,群益ESG投等債20,40,0,40,凱基-永和,2024-08-21,9207
8054,安國,39,1,38,凱基-永和,2024-08-21,9207
2888B,新光金乙特,35,0,35,凱基-永和,2024-08-21,9207
00929,復華台灣科技優息,45,11,34,凱基-永和,2024-08-21,9207
2317,鴻海,34,6,28,凱基-永和,2024-08-21,9207
00882,中信中國高股息,25,0,25,凱基-永和,2024-08-21,9207
2867,三商壽,36,11,25,凱基-永和,2024-08-21,9207
1609,大亞,24,7,17,凱基-永和,2024-08-21,9207
9955,佳龍,21,5,16,凱基-永和,2024-08-21,9207
00878,國泰永續高股息,17,2,15,凱基-永和,2024-08-21,9207
9105,泰金寶-DR,28,15,13,凱基-永和,2024-08-21,9207
2330,台積電,16,4,12,凱基-永和,2024-08-21,9207
00948B,中信優息投資級債,12,0,12,凱基-永和,2024-08-21,9207
2886,兆豐金,11,0,11,凱基-永和,2024-08-21,9207
6869,雲豹能源,112,102,10,凱基-永和,2024-08-21,9207
00674R,期元大S＆P黃金反1,10,0,10,凱基-永和,2024-08-21,9207
1402,遠東新,10,0,10,凱基-永和,2024-08-21,9207
2007,燁興,10,0,10,凱基-永和,2024-08-21,9207
5230,雷笛克光學,10,0,10,凱基-永和,2024-08-21,9207
8996,高力,10,0,10,凱基-永和,2024-08-21,9207
6449,鈺邦,10,0,10,凱基-永和,2024-08-21,9207
00752,中信中國50,19,10,9,凱基-永和,2024-08-21,9207
3037,欣興,9,1,8,凱基-永和,2024-08-21,9207
9945,潤泰新,8,0,8,凱基-永和,2024-08-21,9207
00715L,期街口布蘭特正2,8,0,8,凱基-永和,2024-08-21,9207
6109,亞元,7,0,7,凱基-永和,2024-08-21,9207
00907,永豐優息存股,7,0,7,凱基-永和,2024-08-21,9207
00936,台新永續高息中小,6,0,6,凱基-永和,2024-08-21,9207
1785,光洋科,7,1,6,凱基-永和,2024-08-21,9207
3047,訊舟,588,582,6,凱基-永和,2024-08-21,9207
8215,明基材,6,0,6,凱基-永和,2024-08-21,9207
1702,南僑,5,0,5,凱基-永和,2024-08-21,9207
2524,京城,9,4,5,凱基-永和,2024-08-21,9207
3686,達能,6,1,5,凱基-永和,2024-08-21,9207
6191,精成科,5,0,5,凱基-永和,2024-08-21,9207
6229,研通,5,0,5,凱基-永和,2024-08-21,9207
8081,致新,5,0,5,凱基-永和,2024-08-21,9207
6188,廣明,6,1,5,凱基-永和,2024-08-21,9207
3218,大學光,4,0,4,凱基-永和,2024-08-21,9207
2376,技嘉,6,2,4,凱基-永和,2024-08-21,9207
1536,和大,4,0,4,凱基-永和,2024-08-21,9207
2417,圓剛,5,1,4,凱基-永和,2024-08-21,9207
2888A,新光金甲特,4,0,4,凱基-永和,2024-08-21,9207
3189,景碩,500,6,494,凱基-永和,2024-08-22,9207
4958,臻鼎-KY,518,100,418,凱基-永和,2024-08-22,9207
2891,中信金,303,2,301,凱基-永和,2024-08-22,9207
1711,永光,470,202,268,凱基-永和,2024-08-22,9207
1409,新纖,180,0,180,凱基-永和,2024-08-22,9207
00680L,元大美債20正2,143,33,110,凱基-永和,2024-08-22,9207
00951,台新日本半導體,70,0,70,凱基-永和,2024-08-22,9207
2867,三商壽,50,0,50,凱基-永和,2024-08-22,9207
00664R,國泰臺灣加權反1,40,0,40,凱基-永和,2024-08-22,9207
9906,欣巴巴,42,2,40,凱基-永和,2024-08-22,9207
2349,錸德,73,36,37,凱基-永和,2024-08-22,9207
1727,中華化,30,0,30,凱基-永和,2024-08-22,9207
5488,松普,30,0,30,凱基-永和,2024-08-22,9207
2317,鴻海,30,6,24,凱基-永和,2024-08-22,9207
8996,高力,24,1,23,凱基-永和,2024-08-22,9207
00878,國泰永續高股息,21,1,20,凱基-永和,2024-08-22,9207
6284,佳邦,20,0,20,凱基-永和,2024-08-22,9207
00642U,期元大S＆P石油,19,0,19,凱基-永和,2024-08-22,9207
00937B,群益ESG投等債20,17,0,17,凱基-永和,2024-08-22,9207
00687B,國泰20年美債,16,0,16,凱基-永和,2024-08-22,9207
00679B,元大美債20年,24,9,15,凱基-永和,2024-08-22,9207
00915,凱基優選高股息30,17,3,14,凱基-永和,2024-08-22,9207
00918,大華優利高填息30,12,0,12,凱基-永和,2024-08-22,9207
2851,中再保,12,0,12,凱基-永和,2024-08-22,9207
2354,鴻準,11,0,11,凱基-永和,2024-08-22,9207
1314,中石化,11,0,11,凱基-永和,2024-08-22,9207
2489,瑞軒,11,2,9,凱基-永和,2024-08-22,9207
1102,亞泥,8,0,8,凱基-永和,2024-08-22,9207
2607,榮運,9,1,8,凱基-永和,2024-08-22,9207
2890,永豐金,8,0,8,凱基-永和,2024-08-22,9207
00919,群益台灣精選高息,11,3,8,凱基-永和,2024-08-22,9207
0056,元大高股息,8,0,8,凱基-永和,2024-08-22,9207
3019,亞光,211,204,7,凱基-永和,2024-08-22,9207
3450,聯鈞,8,1,7,凱基-永和,2024-08-22,9207
3663,鑫科,10,3,7,凱基-永和,2024-08-22,9207
6125,廣運,12,5,7,凱基-永和,2024-08-22,9207
8096,擎亞,19,12,7,凱基-永和,2024-08-22,9207
00882,中信中國高股息,6,0,6,凱基-永和,2024-08-22,9207
2002,中鋼,10,4,6,凱基-永和,2024-08-22,9207
2809,京城銀,6,0,6,凱基-永和,2024-08-22,9207
5206,坤悅,6,0,6,凱基-永和,2024-08-22,9207
8104,錸寶,7,1,6,凱基-永和,2024-08-22,9207
8081,致新,5,0,5,凱基-永和,2024-08-22,9207
00905,FT臺灣Smart,5,0,5,凱基-永和,2024-08-22,9207
00725B,國泰投資級公司債,5,0,5,凱基-永和,2024-08-22,9207
00722B,群益投資級電信債,5,0,5,凱基-永和,2024-08-22,9207
00715L,期街口布蘭特正2,5,0,5,凱基-永和,2024-08-22,9207
4164,承業醫,5,0,5,凱基-永和,2024-08-22,9207
4760,勤凱,5,0,5,凱基-永和,2024-08-22,9207
6109,亞元,5,0,5,凱基-永和,2024-08-22,9207
2891,中信金,1775,3,1772,凱基-永和,2024-08-23,9207
2409,友達,350,0,350,凱基-永和,2024-08-23,9207
1711,永光,904,660,244,凱基-永和,2024-08-23,9207
00680L,元大美債20正2,218,4,214,凱基-永和,2024-08-23,9207
4540,全球傳動,197,3,194,凱基-永和,2024-08-23,9207
6806,森崴能源,165,1,164,凱基-永和,2024-08-23,9207
6805,富世達,100,2,98,凱基-永和,2024-08-23,9207
6937,天虹,82,0,82,凱基-永和,2024-08-23,9207
00937B,群益ESG投等債20,67,0,67,凱基-永和,2024-08-23,9207
2454,聯發科,49,0,49,凱基-永和,2024-08-23,9207
5234,達興材料,45,0,45,凱基-永和,2024-08-23,9207
00919,群益台灣精選高息,50,7,43,凱基-永和,2024-08-23,9207
00946,群益科技高息成長,43,3,40,凱基-永和,2024-08-23,9207
2408,南亞科,40,0,40,凱基-永和,2024-08-23,9207
3581,博磊,30,0,30,凱基-永和,2024-08-23,9207
4958,臻鼎-KY,247,220,27,凱基-永和,2024-08-23,9207
5488,松普,25,0,25,凱基-永和,2024-08-23,9207
1314,中石化,24,0,24,凱基-永和,2024-08-23,9207
00687B,國泰20年美債,22,1,21,凱基-永和,2024-08-23,9207
00882,中信中國高股息,20,0,20,凱基-永和,2024-08-23,9207
2618,長榮航,20,1,19,凱基-永和,2024-08-23,9207
2887,台新金,50,32,18,凱基-永和,2024-08-23,9207
6179,亞通,16,0,16,凱基-永和,2024-08-23,9207
00878,國泰永續高股息,20,5,15,凱基-永和,2024-08-23,9207
2337,旺宏,16,1,15,凱基-永和,2024-08-23,9207
5905,南仁湖,13,0,13,凱基-永和,2024-08-23,9207
00688L,國泰20年美債正2,12,0,12,凱基-永和,2024-08-23,9207
00679B,元大美債20年,14,2,12,凱基-永和,2024-08-23,9207
3652,精聯,12,0,12,凱基-永和,2024-08-23,9207
5432,新門,11,0,11,凱基-永和,2024-08-23,9207
8097,常珵,11,0,11,凱基-永和,2024-08-23,9207
00895,富邦未來車,10,0,10,凱基-永和,2024-08-23,9207
00720B,元大投資級公司債,10,0,10,凱基-永和,2024-08-23,9207
1402,遠東新,10,0,10,凱基-永和,2024-08-23,9207
1710,東聯,10,0,10,凱基-永和,2024-08-23,9207
6789,采鈺,10,0,10,凱基-永和,2024-08-23,9207
4707,磐亞,10,0,10,凱基-永和,2024-08-23,9207
3062,建漢,8,0,8,凱基-永和,2024-08-23,9207
8215,明基材,8,0,8,凱基-永和,2024-08-23,9207
1708,東鹼,9,2,7,凱基-永和,2024-08-23,9207
2886,兆豐金,7,0,7,凱基-永和,2024-08-23,9207
2890,永豐金,7,0,7,凱基-永和,2024-08-23,9207
2208,台船,6,0,6,凱基-永和,2024-08-23,9207
2498,宏達電,6,0,6,凱基-永和,2024-08-23,9207
2524,京城,10,4,6,凱基-永和,2024-08-23,9207
5206,坤悅,11,5,6,凱基-永和,2024-08-23,9207
00772B,中信高評級公司債,5,0,5,凱基-永和,2024-08-23,9207
00650L,復華香港正2,5,0,5,凱基-永和,2024-08-23,9207
00642U,期元大S＆P石油,8,3,5,凱基-永和,2024-08-23,9207
00918,大華優利高填息30,6,1,5,凱基-永和,2024-08-23,9207
3481,群創,3603,29,3574,凱基-永和,2024-08-26,9207
2891,中信金,527,0,527,凱基-永和,2024-08-26,9207
2408,南亞科,175,0,175,凱基-永和,2024-08-26,9207
2324,仁寶,186,12,174,凱基-永和,2024-08-26,9207
2465,麗臺,100,0,100,凱基-永和,2024-08-26,9207
00680L,元大美債20正2,90,3,87,凱基-永和,2024-08-26,9207
8996,高力,107,34,73,凱基-永和,2024-08-26,9207
5234,達興材料,67,0,67,凱基-永和,2024-08-26,9207
2002,中鋼,50,1,49,凱基-永和,2024-08-26,9207
00919,群益台灣精選高息,46,1,45,凱基-永和,2024-08-26,9207
00687B,國泰20年美債,42,0,42,凱基-永和,2024-08-26,9207
8028,昇陽半導體,628,588,40,凱基-永和,2024-08-26,9207
8215,明基材,34,0,34,凱基-永和,2024-08-26,9207
1536,和大,34,1,33,凱基-永和,2024-08-26,9207
6515,穎崴,30,0,30,凱基-永和,2024-08-26,9207
00752,中信中國50,21,0,21,凱基-永和,2024-08-26,9207
00882,中信中國高股息,20,0,20,凱基-永和,2024-08-26,9207
3581,博磊,41,25,16,凱基-永和,2024-08-26,9207
2317,鴻海,25,11,14,凱基-永和,2024-08-26,9207
8097,常珵,13,0,13,凱基-永和,2024-08-26,9207
1710,東聯,11,0,11,凱基-永和,2024-08-26,9207
4128,中天,16,5,11,凱基-永和,2024-08-26,9207
00632R,元大台灣50反1,10,0,10,凱基-永和,2024-08-26,9207
00671R,富邦NASDAQ反1,10,0,10,凱基-永和,2024-08-26,9207
00895,富邦未來車,10,0,10,凱基-永和,2024-08-26,9207
2208,台船,10,0,10,凱基-永和,2024-08-26,9207
2365,昆盈,13,3,10,凱基-永和,2024-08-26,9207
2601,益航,10,0,10,凱基-永和,2024-08-26,9207
2607,榮運,10,0,10,凱基-永和,2024-08-26,9207
2331,精英,11,2,9,凱基-永和,2024-08-26,9207
3450,聯鈞,11,2,9,凱基-永和,2024-08-26,9207
00949,復華日本龍頭,8,0,8,凱基-永和,2024-08-26,9207
3284,太普高,8,0,8,凱基-永和,2024-08-26,9207
5371,中光電,8,0,8,凱基-永和,2024-08-26,9207
6284,佳邦,10,2,8,凱基-永和,2024-08-26,9207
00795B,中信美國公債20年,7,0,7,凱基-永和,2024-08-26,9207
00713,元大台灣高息低波,6,0,6,凱基-永和,2024-08-26,9207
2915,潤泰全,6,0,6,凱基-永和,2024-08-26,9207
5905,南仁湖,9,3,6,凱基-永和,2024-08-26,9207
3583,辛耘,6,1,5,凱基-永和,2024-08-26,9207
3376,新日興,5,0,5,凱基-永和,2024-08-26,9207
00674R,期元大S＆P黃金反1,5,0,5,凱基-永和,2024-08-26,9207
1416,廣豐,5,0,5,凱基-永和,2024-08-26,9207
1528,恩德,6,1,5,凱基-永和,2024-08-26,9207
2354,鴻準,5,0,5,凱基-永和,2024-08-26,9207
2537,聯上發,10,5,5,凱基-永和,2024-08-26,9207
2736,富野,6,1,5,凱基-永和,2024-08-26,9207
2886,兆豐金,5,0,5,凱基-永和,2024-08-26,9207
3312,弘憶股,5,0,5,凱基-永和,2024-08-26,9207
3324,雙鴻,8,3,5,凱基-永和,2024-08-26,9207
3450,聯鈞,304,16,288,凱基-永和,2024-08-27,9207
3550,聯穎,200,0,200,凱基-永和,2024-08-27,9207
4540,全球傳動,159,0,159,凱基-永和,2024-08-27,9207
6806,森崴能源,151,0,151,凱基-永和,2024-08-27,9207
00680L,元大美債20正2,100,0,100,凱基-永和,2024-08-27,9207
3167,大量,100,0,100,凱基-永和,2024-08-27,9207
6937,天虹,100,0,100,凱基-永和,2024-08-27,9207
3580,友威科,100,1,99,凱基-永和,2024-08-27,9207
3576,聯合再生,80,4,76,凱基-永和,2024-08-27,9207
6443,元晶,65,6,59,凱基-永和,2024-08-27,9207
2891,中信金,61,5,56,凱基-永和,2024-08-27,9207
8996,高力,43,0,43,凱基-永和,2024-08-27,9207
6244,茂迪,31,1,30,凱基-永和,2024-08-27,9207
00878,國泰永續高股息,29,0,29,凱基-永和,2024-08-27,9207
00940,元大台灣價值高息,26,0,26,凱基-永和,2024-08-27,9207
2303,聯電,25,0,25,凱基-永和,2024-08-27,9207
00937B,群益ESG投等債20,21,0,21,凱基-永和,2024-08-27,9207
6160,欣技,20,0,20,凱基-永和,2024-08-27,9207
00919,群益台灣精選高息,28,10,18,凱基-永和,2024-08-27,9207
5469,瀚宇博,18,0,18,凱基-永和,2024-08-27,9207
2317,鴻海,22,5,17,凱基-永和,2024-08-27,9207
00679B,元大美債20年,17,1,16,凱基-永和,2024-08-27,9207
2887,台新金,17,2,15,凱基-永和,2024-08-27,9207
2441,超豐,14,0,14,凱基-永和,2024-08-27,9207
1785,光洋科,11,0,11,凱基-永和,2024-08-27,9207
2208,台船,12,1,11,凱基-永和,2024-08-27,9207
2312,金寶,12,1,11,凱基-永和,2024-08-27,9207
3673,TPK-KY,18,7,11,凱基-永和,2024-08-27,9207
00687B,國泰20年美債,10,0,10,凱基-永和,2024-08-27,9207
3537,堡達,10,0,10,凱基-永和,2024-08-27,9207
00948B,中信優息投資級債,10,0,10,凱基-永和,2024-08-27,9207
2515,中工,13,4,9,凱基-永和,2024-08-27,9207
5905,南仁湖,9,0,9,凱基-永和,2024-08-27,9207
6229,研通,8,0,8,凱基-永和,2024-08-27,9207
2374,佳能,10,3,7,凱基-永和,2024-08-27,9207
4763,材料-KY,7,0,7,凱基-永和,2024-08-27,9207
6117,迎廣,7,0,7,凱基-永和,2024-08-27,9207
00733,富邦臺灣中小,6,0,6,凱基-永和,2024-08-27,9207
00936,台新永續高息中小,6,0,6,凱基-永和,2024-08-27,9207
3284,太普高,6,0,6,凱基-永和,2024-08-27,9207
6109,亞元,6,0,6,凱基-永和,2024-08-27,9207
8027,鈦昇,9,3,6,凱基-永和,2024-08-27,9207
00720B,元大投資級公司債,6,0,6,凱基-永和,2024-08-27,9207
00772B,中信高評級公司債,5,0,5,凱基-永和,2024-08-27,9207
5488,松普,5,0,5,凱基-永和,2024-08-27,9207
1540,喬福,7,2,5,凱基-永和,2024-08-27,9207
2464,盟立,5,0,5,凱基-永和,2024-08-27,9207
2845,遠東銀,5,0,5,凱基-永和,2024-08-27,9207
2892,第一金,5,0,5,凱基-永和,2024-08-27,9207
3033,威健,5,0,5,凱基-永和,2024-08-27,9207
2891,中信金,3088,3,3085,凱基-永和,2024-08-28,9207
3189,景碩,300,1,299,凱基-永和,2024-08-28,9207
3149,正達,201,4,197,凱基-永和,2024-08-28,9207
2330,台積電,133,4,129,凱基-永和,2024-08-28,9207
1449,佳和,120,0,120,凱基-永和,2024-08-28,9207
3289,宜特,54,4,50,凱基-永和,2024-08-28,9207
00680L,元大美債20正2,40,0,40,凱基-永和,2024-08-28,9207
00632R,元大台灣50反1,42,5,37,凱基-永和,2024-08-28,9207
00795B,中信美國公債20年,33,0,33,凱基-永和,2024-08-28,9207
2520,冠德,32,0,32,凱基-永和,2024-08-28,9207
00665L,富邦�琤肭磪囓�2,30,0,30,凱基-永和,2024-08-28,9207
2409,友達,30,0,30,凱基-永和,2024-08-28,9207
2449,京元電子,30,1,29,凱基-永和,2024-08-28,9207
3581,博磊,36,9,27,凱基-永和,2024-08-28,9207
1711,永光,34,10,24,凱基-永和,2024-08-28,9207
00751B,元大AAA至A公司債,20,0,20,凱基-永和,2024-08-28,9207
6176,瑞儀,20,0,20,凱基-永和,2024-08-28,9207
6187,萬潤,19,0,19,凱基-永和,2024-08-28,9207
6830,汎銓,18,0,18,凱基-永和,2024-08-28,9207
3008,大立光,17,0,17,凱基-永和,2024-08-28,9207
00929,復華台灣科技優息,25,10,15,凱基-永和,2024-08-28,9207
1316,上曜,15,0,15,凱基-永和,2024-08-28,9207
3059,華晶科,13,0,13,凱基-永和,2024-08-28,9207
00679B,元大美債20年,13,0,13,凱基-永和,2024-08-28,9207
00687B,國泰20年美債,12,0,12,凱基-永和,2024-08-28,9207
2886,兆豐金,10,0,10,凱基-永和,2024-08-28,9207
00688L,國泰20年美債正2,10,0,10,凱基-永和,2024-08-28,9207
00772B,中信高評級公司債,10,0,10,凱基-永和,2024-08-28,9207
6179,亞通,10,0,10,凱基-永和,2024-08-28,9207
3202,樺晟,10,0,10,凱基-永和,2024-08-28,9207
00937B,群益ESG投等債20,8,0,8,凱基-永和,2024-08-28,9207
00752,中信中國50,7,0,7,凱基-永和,2024-08-28,9207
2364,倫飛,7,0,7,凱基-永和,2024-08-28,9207
3715,定穎投控,11,4,7,凱基-永和,2024-08-28,9207
4714,永捷,7,0,7,凱基-永和,2024-08-28,9207
5488,松普,7,0,7,凱基-永和,2024-08-28,9207
6109,亞元,7,0,7,凱基-永和,2024-08-28,9207
00936,台新永續高息中小,6,0,6,凱基-永和,2024-08-28,9207
2392,正崴,13,7,6,凱基-永和,2024-08-28,9207
2427,三商電,6,0,6,凱基-永和,2024-08-28,9207
6770,力積電,6,0,6,凱基-永和,2024-08-28,9207
00940,元大台灣價值高息,6,0,6,凱基-永和,2024-08-28,9207
1303,南亞,5,0,5,凱基-永和,2024-08-28,9207
00893,國泰智能電動車,5,0,5,凱基-永和,2024-08-28,9207
2354,鴻準,5,0,5,凱基-永和,2024-08-28,9207
2362,藍天,7,2,5,凱基-永和,2024-08-28,9207
2426,鼎元,5,0,5,凱基-永和,2024-08-28,9207
2483,百容,5,0,5,凱基-永和,2024-08-28,9207
2888A,新光金甲特,5,0,5,凱基-永和,2024-08-28,9207
6733,博晟生醫,5,0,5,凱基-永和,2024-08-28,9207
2367,燿華,908,24,884,凱基-永和,2024-08-29,9207
1711,永光,1375,814,561,凱基-永和,2024-08-29,9207
2313,華通,709,322,387,凱基-永和,2024-08-29,9207
4958,臻鼎-KY,551,261,290,凱基-永和,2024-08-29,9207
00946,群益科技高息成長,200,7,193,凱基-永和,2024-08-29,9207
3189,景碩,408,267,141,凱基-永和,2024-08-29,9207
2330,台積電,207,100,107,凱基-永和,2024-08-29,9207
3580,友威科,101,1,100,凱基-永和,2024-08-29,9207
00680L,元大美債20正2,71,0,71,凱基-永和,2024-08-29,9207
2887,台新金,67,2,65,凱基-永和,2024-08-29,9207
00931B,統一美債20年,50,0,50,凱基-永和,2024-08-29,9207
2351,順德,50,0,50,凱基-永和,2024-08-29,9207
6789,采鈺,39,10,29,凱基-永和,2024-08-29,9207
2610,華航,36,11,25,凱基-永和,2024-08-29,9207
00881,國泰台灣5G+,23,0,23,凱基-永和,2024-08-29,9207
00687B,國泰20年美債,20,0,20,凱基-永和,2024-08-29,9207
00679B,元大美債20年,18,0,18,凱基-永和,2024-08-29,9207
00945B,凱基美國非投等債,16,0,16,凱基-永和,2024-08-29,9207
00948B,中信優息投資級債,16,0,16,凱基-永和,2024-08-29,9207
6603,富強鑫,19,4,15,凱基-永和,2024-08-29,9207
00936,台新永續高息中小,15,0,15,凱基-永和,2024-08-29,9207
00795B,中信美國公債20年,14,0,14,凱基-永和,2024-08-29,9207
3550,聯穎,35,21,14,凱基-永和,2024-08-29,9207
2317,鴻海,23,10,13,凱基-永和,2024-08-29,9207
2504,國產,12,1,11,凱基-永和,2024-08-29,9207
3481,群創,13,3,10,凱基-永和,2024-08-29,9207
00751B,元大AAA至A公司債,10,0,10,凱基-永和,2024-08-29,9207
00688L,國泰20年美債正2,10,0,10,凱基-永和,2024-08-29,9207
3437,榮創,10,0,10,凱基-永和,2024-08-29,9207
3624,光頡,10,0,10,凱基-永和,2024-08-29,9207
3689,湧德,10,0,10,凱基-永和,2024-08-29,9207
4510,高鋒,21,11,10,凱基-永和,2024-08-29,9207
4956,光鋐,10,0,10,凱基-永和,2024-08-29,9207
8076,伍豐,10,0,10,凱基-永和,2024-08-29,9207
4967,十銓,10,1,9,凱基-永和,2024-08-29,9207
00933B,國泰10Y+金融債,9,0,9,凱基-永和,2024-08-29,9207
1314,中石化,10,2,8,凱基-永和,2024-08-29,9207
4555,氣立,8,0,8,凱基-永和,2024-08-29,9207
8070,長華*,13,5,8,凱基-永和,2024-08-29,9207
4714,永捷,8,1,7,凱基-永和,2024-08-29,9207
6754,匯僑設計,8,1,7,凱基-永和,2024-08-29,9207
2354,鴻準,7,0,7,凱基-永和,2024-08-29,9207
00878,國泰永續高股息,8,2,6,凱基-永和,2024-08-29,9207
2886,兆豐金,7,1,6,凱基-永和,2024-08-29,9207
3673,TPK-KY,13,7,6,凱基-永和,2024-08-29,9207
6531,愛普*,6,0,6,凱基-永和,2024-08-29,9207
00720B,元大投資級公司債,5,0,5,凱基-永和,2024-08-29,9207
00919,群益台灣精選高息,7,2,5,凱基-永和,2024-08-29,9207
00918,大華優利高填息30,8,3,5,凱基-永和,2024-08-29,9207
00939,統一台灣高息動能,5,0,5,凱基-永和,2024-08-29,9207
2891,中信金,429,2,427,凱基-永和,2024-08-30,9207
2408,南亞科,240,0,240,凱基-永和,2024-08-30,9207
6706,惠特,202,1,201,凱基-永和,2024-08-30,9207
2312,金寶,153,3,150,凱基-永和,2024-08-30,9207
2351,順德,187,50,137,凱基-永和,2024-08-30,9207
8043,蜜望實,133,0,133,凱基-永和,2024-08-30,9207
4956,光鋐,203,103,100,凱基-永和,2024-08-30,9207
00680L,元大美債20正2,72,2,70,凱基-永和,2024-08-30,9207
2610,華航,61,0,61,凱基-永和,2024-08-30,9207
3481,群創,45,0,45,凱基-永和,2024-08-30,9207
2426,鼎元,96,62,34,凱基-永和,2024-08-30,9207
00795B,中信美國公債20年,34,10,24,凱基-永和,2024-08-30,9207
3231,緯創,20,0,20,凱基-永和,2024-08-30,9207
6016,康和證,20,0,20,凱基-永和,2024-08-30,9207
00936,台新永續高息中小,14,0,14,凱基-永和,2024-08-30,9207
4746,台耀,14,0,14,凱基-永和,2024-08-30,9207
00919,群益台灣精選高息,15,2,13,凱基-永和,2024-08-30,9207
00679B,元大美債20年,12,0,12,凱基-永和,2024-08-30,9207
2834,臺企銀,13,1,12,凱基-永和,2024-08-30,9207
4526,東台,31,19,12,凱基-永和,2024-08-30,9207
2455,全新,11,0,11,凱基-永和,2024-08-30,9207
3163,波若威,14,3,11,凱基-永和,2024-08-30,9207
3363,上詮,12,1,11,凱基-永和,2024-08-30,9207
00688L,國泰20年美債正2,10,0,10,凱基-永和,2024-08-30,9207
1402,遠東新,10,0,10,凱基-永和,2024-08-30,9207
1710,東聯,10,0,10,凱基-永和,2024-08-30,9207
3686,達能,10,0,10,凱基-永和,2024-08-30,9207
4538,大詠城,10,0,10,凱基-永和,2024-08-30,9207
6733,博晟生醫,10,0,10,凱基-永和,2024-08-30,9207
8076,伍豐,10,0,10,凱基-永和,2024-08-30,9207
1785,光洋科,218,208,10,凱基-永和,2024-08-30,9207
1314,中石化,10,1,9,凱基-永和,2024-08-30,9207
4576,大銀微系統,9,0,9,凱基-永和,2024-08-30,9207
4714,永捷,11,2,9,凱基-永和,2024-08-30,9207
00895,富邦未來車,8,0,8,凱基-永和,2024-08-30,9207
2365,昆盈,9,1,8,凱基-永和,2024-08-30,9207
2888A,新光金甲特,8,0,8,凱基-永和,2024-08-30,9207
4906,正文,10,2,8,凱基-永和,2024-08-30,9207
2382,廣達,7,0,7,凱基-永和,2024-08-30,9207
6805,富世達,7,1,6,凱基-永和,2024-08-30,9207
2208,台船,6,0,6,凱基-永和,2024-08-30,9207
2425,承啟,6,0,6,凱基-永和,2024-08-30,9207
00674R,期元大S＆P黃金反1,5,0,5,凱基-永和,2024-08-30,9207
00933B,國泰10Y+金融債,5,0,5,凱基-永和,2024-08-30,9207
2340,台亞,15,10,5,凱基-永和,2024-08-30,9207
2354,鴻準,5,0,5,凱基-永和,2024-08-30,9207
2417,圓剛,5,0,5,凱基-永和,2024-08-30,9207
2537,聯上發,5,0,5,凱基-永和,2024-08-30,9207
2614,東森,5,0,5,凱基-永和,2024-08-30,9207
2886,兆豐金,5,0,5,凱基-永和,2024-08-30,9207
2891,中信金,3062,6,3056,凱基-永和,2024-09-02,9207
4566,時碩工業,105,5,100,凱基-永和,2024-09-02,9207
00680L,元大美債20正2,52,0,52,凱基-永和,2024-09-02,9207
6806,森崴能源,151,101,50,凱基-永和,2024-09-02,9207
00919,群益台灣精選高息,44,0,44,凱基-永和,2024-09-02,9207
1316,上曜,36,1,35,凱基-永和,2024-09-02,9207
00937B,群益ESG投等債20,34,0,34,凱基-永和,2024-09-02,9207
3008,大立光,32,0,32,凱基-永和,2024-09-02,9207
00679B,元大美債20年,31,0,31,凱基-永和,2024-09-02,9207
2867,三商壽,36,5,31,凱基-永和,2024-09-02,9207
00857B,永豐20年美公債,30,0,30,凱基-永和,2024-09-02,9207
8150,南茂,30,0,30,凱基-永和,2024-09-02,9207
00947,台新臺灣IC設計,22,0,22,凱基-永和,2024-09-02,9207
00933B,國泰10Y+金融債,22,0,22,凱基-永和,2024-09-02,9207
00687B,國泰20年美債,19,1,18,凱基-永和,2024-09-02,9207
6230,尼得科超眾,18,0,18,凱基-永和,2024-09-02,9207
4714,永捷,16,1,15,凱基-永和,2024-09-02,9207
00642U,期元大S＆P石油,14,0,14,凱基-永和,2024-09-02,9207
8039,台虹,14,0,14,凱基-永和,2024-09-02,9207
1503,士電,16,3,13,凱基-永和,2024-09-02,9207
3673,TPK-KY,14,2,12,凱基-永和,2024-09-02,9207
00878,國泰永續高股息,20,9,11,凱基-永和,2024-09-02,9207
00882,中信中國高股息,11,0,11,凱基-永和,2024-09-02,9207
2402,毅嘉,11,0,11,凱基-永和,2024-09-02,9207
6274,台燿,10,0,10,凱基-永和,2024-09-02,9207
00936,台新永續高息中小,10,0,10,凱基-永和,2024-09-02,9207
1710,東聯,10,0,10,凱基-永和,2024-09-02,9207
2344,華邦電,10,0,10,凱基-永和,2024-09-02,9207
2419,仲琦,10,0,10,凱基-永和,2024-09-02,9207
5469,瀚宇博,20,10,10,凱基-永和,2024-09-02,9207
6257,矽格,10,0,10,凱基-永和,2024-09-02,9207
1314,中石化,10,0,10,凱基-永和,2024-09-02,9207
1582,信錦,9,0,9,凱基-永和,2024-09-02,9207
2002,中鋼,10,1,9,凱基-永和,2024-09-02,9207
00795B,中信美國公債20年,8,0,8,凱基-永和,2024-09-02,9207
00725B,國泰投資級公司債,8,0,8,凱基-永和,2024-09-02,9207
00720B,元大投資級公司債,8,0,8,凱基-永和,2024-09-02,9207
6176,瑞儀,8,0,8,凱基-永和,2024-09-02,9207
8096,擎亞,11,3,8,凱基-永和,2024-09-02,9207
3581,博磊,21,13,8,凱基-永和,2024-09-02,9207
00715L,期街口布蘭特正2,7,0,7,凱基-永和,2024-09-02,9207
1301,台塑,8,1,7,凱基-永和,2024-09-02,9207
2376,技嘉,8,1,7,凱基-永和,2024-09-02,9207
3059,華晶科,7,0,7,凱基-永和,2024-09-02,9207
2426,鼎元,23,16,7,凱基-永和,2024-09-02,9207
3481,群創,12,5,7,凱基-永和,2024-09-02,9207
2881,富邦金,11,5,6,凱基-永和,2024-09-02,9207
2615,萬海,7,1,6,凱基-永和,2024-09-02,9207
00752,中信中國50,6,0,6,凱基-永和,2024-09-02,9207
2208,台船,7,1,6,凱基-永和,2024-09-02,9207
00930,永豐ESG低碳高息,221,0,221,凱基-永和,2024-09-03,9207
00919,群益台灣精選高息,186,100,86,凱基-永和,2024-09-03,9207
4956,光鋐,96,20,76,凱基-永和,2024-09-03,9207
2887,台新金,70,0,70,凱基-永和,2024-09-03,9207
2891,中信金,58,1,57,凱基-永和,2024-09-03,9207
2002,中鋼,53,0,53,凱基-永和,2024-09-03,9207
1722,台肥,45,0,45,凱基-永和,2024-09-03,9207
4576,大銀微系統,51,6,45,凱基-永和,2024-09-03,9207
00918,大華優利高填息30,43,0,43,凱基-永和,2024-09-03,9207
00937B,群益ESG投等債20,41,0,41,凱基-永和,2024-09-03,9207
00940,元大台灣價值高息,38,0,38,凱基-永和,2024-09-03,9207
2464,盟立,46,17,29,凱基-永和,2024-09-03,9207
00882,中信中國高股息,24,0,24,凱基-永和,2024-09-03,9207
3019,亞光,21,2,19,凱基-永和,2024-09-03,9207
00878,國泰永續高股息,19,1,18,凱基-永和,2024-09-03,9207
8096,擎亞,22,5,17,凱基-永和,2024-09-03,9207
4306,炎洲,19,4,15,凱基-永和,2024-09-03,9207
4746,台耀,13,0,13,凱基-永和,2024-09-03,9207
8027,鈦昇,24,12,12,凱基-永和,2024-09-03,9207
00679B,元大美債20年,12,0,12,凱基-永和,2024-09-03,9207
00915,凱基優選高股息30,11,0,11,凱基-永和,2024-09-03,9207
00687B,國泰20年美債,11,0,11,凱基-永和,2024-09-03,9207
2337,旺宏,11,0,11,凱基-永和,2024-09-03,9207
1314,中石化,10,0,10,凱基-永和,2024-09-03,9207
2426,鼎元,12,2,10,凱基-永和,2024-09-03,9207
3284,太普高,10,0,10,凱基-永和,2024-09-03,9207
6207,雷科,13,3,10,凱基-永和,2024-09-03,9207
9945,潤泰新,10,0,10,凱基-永和,2024-09-03,9207
3037,欣興,9,0,9,凱基-永和,2024-09-03,9207
1446,宏和,12,3,9,凱基-永和,2024-09-03,9207
2382,廣達,10,1,9,凱基-永和,2024-09-03,9207
00946,群益科技高息成長,8,0,8,凱基-永和,2024-09-03,9207
2597,潤弘,8,0,8,凱基-永和,2024-09-03,9207
6152,百一,8,0,8,凱基-永和,2024-09-03,9207
1301,台塑,7,0,7,凱基-永和,2024-09-03,9207
2405,輔信,7,0,7,凱基-永和,2024-09-03,9207
4526,東台,8,1,7,凱基-永和,2024-09-03,9207
8097,常珵,7,0,7,凱基-永和,2024-09-03,9207
2609,陽明,6,0,6,凱基-永和,2024-09-03,9207
1815,富喬,6,0,6,凱基-永和,2024-09-03,9207
2208,台船,6,0,6,凱基-永和,2024-09-03,9207
2324,仁寶,6,0,6,凱基-永和,2024-09-03,9207
2408,南亞科,6,0,6,凱基-永和,2024-09-03,9207
3715,定穎投控,9,3,6,凱基-永和,2024-09-03,9207
1101,台泥,5,0,5,凱基-永和,2024-09-03,9207
006208,富邦台50,5,0,5,凱基-永和,2024-09-03,9207
3481,群創,6,1,5,凱基-永和,2024-09-03,9207
2884,玉山金,5,0,5,凱基-永和,2024-09-03,9207
6197,佳必琪,6,1,5,凱基-永和,2024-09-03,9207
1536,和大,9,4,5,凱基-永和,2024-09-03,9207
2891,中信金,1047,0,1047,凱基-永和,2024-09-04,9207
00929,復華台灣科技優息,187,34,153,凱基-永和,2024-09-04,9207
00919,群益台灣精選高息,160,20,140,凱基-永和,2024-09-04,9207
00937B,群益ESG投等債20,120,0,120,凱基-永和,2024-09-04,9207
00948B,中信優息投資級債,102,2,100,凱基-永和,2024-09-04,9207
00687B,國泰20年美債,112,16,96,凱基-永和,2024-09-04,9207
1447,力鵬,85,0,85,凱基-永和,2024-09-04,9207
2887,台新金,82,3,79,凱基-永和,2024-09-04,9207
00918,大華優利高填息30,65,1,64,凱基-永和,2024-09-04,9207
2618,長榮航,52,1,51,凱基-永和,2024-09-04,9207
1301,台塑,50,0,50,凱基-永和,2024-09-04,9207
2897A,王道銀甲特,50,0,50,凱基-永和,2024-09-04,9207
00878,國泰永續高股息,66,17,49,凱基-永和,2024-09-04,9207
2408,南亞科,48,1,47,凱基-永和,2024-09-04,9207
8097,常珵,45,0,45,凱基-永和,2024-09-04,9207
2002,中鋼,35,0,35,凱基-永和,2024-09-04,9207
2330,台積電,34,2,32,凱基-永和,2024-09-04,9207
2382,廣達,31,2,29,凱基-永和,2024-09-04,9207
00715L,期街口布蘭特正2,28,0,28,凱基-永和,2024-09-04,9207
1536,和大,31,5,26,凱基-永和,2024-09-04,9207
2882,國泰金,24,1,23,凱基-永和,2024-09-04,9207
4746,台耀,20,0,20,凱基-永和,2024-09-04,9207
00915,凱基優選高股息30,26,7,19,凱基-永和,2024-09-04,9207
8027,鈦昇,33,15,18,凱基-永和,2024-09-04,9207
00946,群益科技高息成長,17,0,17,凱基-永和,2024-09-04,9207
00642U,期元大S＆P石油,21,6,15,凱基-永和,2024-09-04,9207
5488,松普,15,0,15,凱基-永和,2024-09-04,9207
0050,元大台灣50,17,3,14,凱基-永和,2024-09-04,9207
8096,擎亞,17,4,13,凱基-永和,2024-09-04,9207
3037,欣興,12,0,12,凱基-永和,2024-09-04,9207
00882,中信中國高股息,12,0,12,凱基-永和,2024-09-04,9207
00947,台新臺灣IC設計,12,0,12,凱基-永和,2024-09-04,9207
2610,華航,12,0,12,凱基-永和,2024-09-04,9207
5876,上海商銀,12,0,12,凱基-永和,2024-09-04,9207
2834,臺企銀,11,0,11,凱基-永和,2024-09-04,9207
5460,同協,60,50,10,凱基-永和,2024-09-04,9207
00891,中信關鍵半導體,10,0,10,凱基-永和,2024-09-04,9207
2367,燿華,15,5,10,凱基-永和,2024-09-04,9207
2385,群光,10,0,10,凱基-永和,2024-09-04,9207
006208,富邦台50,10,0,10,凱基-永和,2024-09-04,9207
3189,景碩,15,6,9,凱基-永和,2024-09-04,9207
00923,群益台ESG低碳50,9,0,9,凱基-永和,2024-09-04,9207
2376,技嘉,8,0,8,凱基-永和,2024-09-04,9207
00930,永豐ESG低碳高息,8,0,8,凱基-永和,2024-09-04,9207
2455,全新,8,0,8,凱基-永和,2024-09-04,9207
1436,華友聯,8,0,8,凱基-永和,2024-09-04,9207
2615,萬海,9,1,8,凱基-永和,2024-09-04,9207
3047,訊舟,8,0,8,凱基-永和,2024-09-04,9207
5206,坤悅,8,0,8,凱基-永和,2024-09-04,9207
00713,元大台灣高息低波,7,0,7,凱基-永和,2024-09-04,9207
4956,光鋐,216,46,170,凱基-永和,2024-09-05,9207
2330,台積電,132,5,127,凱基-永和,2024-09-05,9207
3374,精材,133,9,124,凱基-永和,2024-09-05,9207
2002,中鋼,75,0,75,凱基-永和,2024-09-05,9207
2426,鼎元,51,0,51,凱基-永和,2024-09-05,9207
00937B,群益ESG投等債20,46,0,46,凱基-永和,2024-09-05,9207
00929,復華台灣科技優息,47,2,45,凱基-永和,2024-09-05,9207
2454,聯發科,44,2,42,凱基-永和,2024-09-05,9207
2317,鴻海,41,10,31,凱基-永和,2024-09-05,9207
00687B,國泰20年美債,30,0,30,凱基-永和,2024-09-05,9207
4538,大詠城,27,0,27,凱基-永和,2024-09-05,9207
2408,南亞科,22,0,22,凱基-永和,2024-09-05,9207
00918,大華優利高填息30,21,0,21,凱基-永和,2024-09-05,9207
8054,安國,14,1,13,凱基-永和,2024-09-05,9207
00951,台新日本半導體,12,0,12,凱基-永和,2024-09-05,9207
2812,台中銀,12,0,12,凱基-永和,2024-09-05,9207
00878,國泰永續高股息,13,2,11,凱基-永和,2024-09-05,9207
2537,聯上發,12,1,11,凱基-永和,2024-09-05,9207
00919,群益台灣精選高息,12,1,11,凱基-永和,2024-09-05,9207
1540,喬福,52,42,10,凱基-永和,2024-09-05,9207
2609,陽明,15,5,10,凱基-永和,2024-09-05,9207
3024,憶聲,11,1,10,凱基-永和,2024-09-05,9207
4123,晟德,10,0,10,凱基-永和,2024-09-05,9207
5484,慧友,10,0,10,凱基-永和,2024-09-05,9207
6538,倉和,10,0,10,凱基-永和,2024-09-05,9207
9105,泰金寶-DR,10,0,10,凱基-永和,2024-09-05,9207
00882,中信中國高股息,9,0,9,凱基-永和,2024-09-05,9207
00715L,期街口布蘭特正2,9,0,9,凱基-永和,2024-09-05,9207
1301,台塑,8,0,8,凱基-永和,2024-09-05,9207
2851,中再保,8,0,8,凱基-永和,2024-09-05,9207
4958,臻鼎-KY,10,2,8,凱基-永和,2024-09-05,9207
3037,欣興,7,0,7,凱基-永和,2024-09-05,9207
1513,中興電,7,0,7,凱基-永和,2024-09-05,9207
8096,擎亞,14,7,7,凱基-永和,2024-09-05,9207
9958,世紀鋼,10,3,7,凱基-永和,2024-09-05,9207
8027,鈦昇,18,11,7,凱基-永和,2024-09-05,9207
00679B,元大美債20年,6,0,6,凱基-永和,2024-09-05,9207
1101,台泥,6,0,6,凱基-永和,2024-09-05,9207
2313,華通,7,1,6,凱基-永和,2024-09-05,9207
2359,所羅門,6,0,6,凱基-永和,2024-09-05,9207
2367,燿華,12,6,6,凱基-永和,2024-09-05,9207
2605,新興,6,0,6,凱基-永和,2024-09-05,9207
2890,永豐金,6,0,6,凱基-永和,2024-09-05,9207
2887,台新金,6,0,6,凱基-永和,2024-09-05,9207
3481,群創,6,0,6,凱基-永和,2024-09-05,9207
2504,國產,6,0,6,凱基-永和,2024-09-05,9207
00940,元大台灣價值高息,6,1,5,凱基-永和,2024-09-05,9207
00712,復華富時不動產,5,0,5,凱基-永和,2024-09-05,9207
2337,旺宏,5,0,5,凱基-永和,2024-09-05,9207
2353,宏��,10,5,5,凱基-永和,2024-09-05,9207
00919,群益台灣精選高息,104,2,102,凱基-永和,2024-09-06,9207
00680L,元大美債20正2,96,14,82,凱基-永和,2024-09-06,9207
1314,中石化,56,3,53,凱基-永和,2024-09-06,9207
00941,中信上游半導體,28,0,28,凱基-永和,2024-09-06,9207
2888,新光金,25,0,25,凱基-永和,2024-09-06,9207
00679B,元大美債20年,33,9,24,凱基-永和,2024-09-06,9207
2489,瑞軒,24,0,24,凱基-永和,2024-09-06,9207
00930,永豐ESG低碳高息,22,0,22,凱基-永和,2024-09-06,9207
00918,大華優利高填息30,21,0,21,凱基-永和,2024-09-06,9207
00688L,國泰20年美債正2,60,40,20,凱基-永和,2024-09-06,9207
0056,元大高股息,20,0,20,凱基-永和,2024-09-06,9207
00929,復華台灣科技優息,25,7,18,凱基-永和,2024-09-06,9207
00715L,期街口布蘭特正2,14,0,14,凱基-永和,2024-09-06,9207
2537,聯上發,14,0,14,凱基-永和,2024-09-06,9207
2618,長榮航,13,0,13,凱基-永和,2024-09-06,9207
00940,元大台灣價值高息,16,4,12,凱基-永和,2024-09-06,9207
2464,盟立,24,12,12,凱基-永和,2024-09-06,9207
2449,京元電子,12,0,12,凱基-永和,2024-09-06,9207
3037,欣興,11,0,11,凱基-永和,2024-09-06,9207
8150,南茂,11,0,11,凱基-永和,2024-09-06,9207
2317,鴻海,19,9,10,凱基-永和,2024-09-06,9207
00764B,群益25年美債,10,0,10,凱基-永和,2024-09-06,9207
00648R,元大S＆P500反1,10,0,10,凱基-永和,2024-09-06,9207
00671R,富邦NASDAQ反1,10,0,10,凱基-永和,2024-09-06,9207
8064,東捷,11,1,10,凱基-永和,2024-09-06,9207
00946,群益科技高息成長,9,0,9,凱基-永和,2024-09-06,9207
5488,松普,9,0,9,凱基-永和,2024-09-06,9207
8096,擎亞,20,11,9,凱基-永和,2024-09-06,9207
4566,時碩工業,10,1,9,凱基-永和,2024-09-06,9207
00937B,群益ESG投等債20,18,11,7,凱基-永和,2024-09-06,9207
8027,鈦昇,27,20,7,凱基-永和,2024-09-06,9207
3481,群創,6,0,6,凱基-永和,2024-09-06,9207
00642U,期元大S＆P石油,6,0,6,凱基-永和,2024-09-06,9207
00952,凱基台灣AI50,6,0,6,凱基-永和,2024-09-06,9207
4167,松瑞藥,6,0,6,凱基-永和,2024-09-06,9207
5905,南仁湖,9,3,6,凱基-永和,2024-09-06,9207
2891,中信金,8,2,6,凱基-永和,2024-09-06,9207
00882,中信中國高股息,5,0,5,凱基-永和,2024-09-06,9207
1605,華新,8,3,5,凱基-永和,2024-09-06,9207
00902,中信電池及儲能,5,0,5,凱基-永和,2024-09-06,9207
00673R,期元大S＆P原油反1,5,0,5,凱基-永和,2024-09-06,9207
00706L,期元大S＆P日圓正2,5,0,5,凱基-永和,2024-09-06,9207
00697B,元大美債7-10,5,0,5,凱基-永和,2024-09-06,9207
2614,東森,5,0,5,凱基-永和,2024-09-06,9207
3062,建漢,5,0,5,凱基-永和,2024-09-06,9207
8271,宇瞻,5,0,5,凱基-永和,2024-09-06,9207
00687B,國泰20年美債,26,22,4,凱基-永和,2024-09-06,9207
2312,金寶,5,1,4,凱基-永和,2024-09-06,9207
3006,晶豪科,4,0,4,凱基-永和,2024-09-06,9207
3017,奇鋐,5,1,4,凱基-永和,2024-09-06,9207
00680L,元大美債20正2,562,60,502,凱基-永和,2024-09-09,9207
5443,均豪,204,6,198,凱基-永和,2024-09-09,9207
3580,友威科,139,0,139,凱基-永和,2024-09-09,9207
00919,群益台灣精選高息,135,0,135,凱基-永和,2024-09-09,9207
3374,精材,136,5,131,凱基-永和,2024-09-09,9207
8028,昇陽半導體,123,1,122,凱基-永和,2024-09-09,9207
00929,復華台灣科技優息,105,5,100,凱基-永和,2024-09-09,9207
2888,新光金,100,1,99,凱基-永和,2024-09-09,9207
2467,志聖,75,0,75,凱基-永和,2024-09-09,9207
3231,緯創,57,0,57,凱基-永和,2024-09-09,9207
00687B,國泰20年美債,55,2,53,凱基-永和,2024-09-09,9207
3017,奇鋐,54,10,44,凱基-永和,2024-09-09,9207
2002,中鋼,39,0,39,凱基-永和,2024-09-09,9207
00931B,統一美債20年,36,0,36,凱基-永和,2024-09-09,9207
2317,鴻海,40,4,36,凱基-永和,2024-09-09,9207
2399,映泰,32,0,32,凱基-永和,2024-09-09,9207
00878,國泰永續高股息,30,0,30,凱基-永和,2024-09-09,9207
2718,全心投控,24,0,24,凱基-永和,2024-09-09,9207
6770,力積電,20,0,20,凱基-永和,2024-09-09,9207
8404,百和興業-KY,20,0,20,凱基-永和,2024-09-09,9207
2615,萬海,18,0,18,凱基-永和,2024-09-09,9207
1436,華友聯,18,0,18,凱基-永和,2024-09-09,9207
3715,定穎投控,23,7,16,凱基-永和,2024-09-09,9207
00941,中信上游半導體,13,0,13,凱基-永和,2024-09-09,9207
2330,台積電,15,2,13,凱基-永和,2024-09-09,9207
2891,中信金,19,7,12,凱基-永和,2024-09-09,9207
00951,台新日本半導體,12,0,12,凱基-永和,2024-09-09,9207
2382,廣達,13,1,12,凱基-永和,2024-09-09,9207
0056,元大高股息,11,0,11,凱基-永和,2024-09-09,9207
9945,潤泰新,11,0,11,凱基-永和,2024-09-09,9207
1785,光洋科,10,0,10,凱基-永和,2024-09-09,9207
2354,鴻準,10,0,10,凱基-永和,2024-09-09,9207
2618,長榮航,10,0,10,凱基-永和,2024-09-09,9207
00665L,富邦�琤肭磪囓�2,9,0,9,凱基-永和,2024-09-09,9207
4746,台耀,9,0,9,凱基-永和,2024-09-09,9207
6805,富世達,11,2,9,凱基-永和,2024-09-09,9207
00881,國泰台灣5G+,9,0,9,凱基-永和,2024-09-09,9207
6223,旺矽,9,0,9,凱基-永和,2024-09-09,9207
006208,富邦台50,9,1,8,凱基-永和,2024-09-09,9207
5206,坤悅,8,0,8,凱基-永和,2024-09-09,9207
00715L,期街口布蘭特正2,7,0,7,凱基-永和,2024-09-09,9207
00632R,元大台灣50反1,27,21,6,凱基-永和,2024-09-09,9207
00946,群益科技高息成長,6,0,6,凱基-永和,2024-09-09,9207
2492,華新科,6,0,6,凱基-永和,2024-09-09,9207
2883B,凱基金乙特,6,0,6,凱基-永和,2024-09-09,9207
4763,材料-KY,6,0,6,凱基-永和,2024-09-09,9207
00830,國泰費城半導體,53,48,5,凱基-永和,2024-09-09,9207
00942B,台新美A公司債20+,5,0,5,凱基-永和,2024-09-09,9207
1536,和大,5,0,5,凱基-永和,2024-09-09,9207
2101,南港,5,0,5,凱基-永和,2024-09-09,9207
8249,菱光,268,48,220,凱基-永和,2024-09-10,9207
00940,元大台灣價值高息,213,0,213,凱基-永和,2024-09-10,9207
00878,國泰永續高股息,116,1,115,凱基-永和,2024-09-10,9207
00929,復華台灣科技優息,97,2,95,凱基-永和,2024-09-10,9207
00919,群益台灣精選高息,57,2,55,凱基-永和,2024-09-10,9207
8096,擎亞,49,7,42,凱基-永和,2024-09-10,9207
3481,群創,40,0,40,凱基-永和,2024-09-10,9207
00882,中信中國高股息,32,0,32,凱基-永和,2024-09-10,9207
00918,大華優利高填息30,32,1,31,凱基-永和,2024-09-10,9207
0056,元大高股息,93,62,31,凱基-永和,2024-09-10,9207
00915,凱基優選高股息30,23,0,23,凱基-永和,2024-09-10,9207
2313,華通,26,6,20,凱基-永和,2024-09-10,9207
2367,燿華,29,9,20,凱基-永和,2024-09-10,9207
00931B,統一美債20年,15,0,15,凱基-永和,2024-09-10,9207
00720B,元大投資級公司債,13,0,13,凱基-永和,2024-09-10,9207
1536,和大,17,5,12,凱基-永和,2024-09-10,9207
6179,亞通,12,0,12,凱基-永和,2024-09-10,9207
00712,復華富時不動產,15,4,11,凱基-永和,2024-09-10,9207
2376,技嘉,11,0,11,凱基-永和,2024-09-10,9207
2382,廣達,12,1,11,凱基-永和,2024-09-10,9207
5488,松普,11,0,11,凱基-永和,2024-09-10,9207
1316,上曜,10,0,10,凱基-永和,2024-09-10,9207
3202,樺晟,10,0,10,凱基-永和,2024-09-10,9207
4128,中天,10,0,10,凱基-永和,2024-09-10,9207
6191,精成科,13,3,10,凱基-永和,2024-09-10,9207
6207,雷科,10,0,10,凱基-永和,2024-09-10,9207
5469,瀚宇博,10,0,10,凱基-永和,2024-09-10,9207
6603,富強鑫,10,1,9,凱基-永和,2024-09-10,9207
6245,立端,9,0,9,凱基-永和,2024-09-10,9207
5871,中租-KY,8,0,8,凱基-永和,2024-09-10,9207
1785,光洋科,10,2,8,凱基-永和,2024-09-10,9207
3048,益登,8,0,8,凱基-永和,2024-09-10,9207
00673R,期元大S＆P原油反1,10,2,8,凱基-永和,2024-09-10,9207
00952,凱基台灣AI50,8,0,8,凱基-永和,2024-09-10,9207
00948B,中信優息投資級債,7,0,7,凱基-永和,2024-09-10,9207
00934,中信成長高股息,7,0,7,凱基-永和,2024-09-10,9207
4513,福裕,6,0,6,凱基-永和,2024-09-10,9207
6187,萬潤,7,1,6,凱基-永和,2024-09-10,9207
00881,國泰台灣5G+,6,0,6,凱基-永和,2024-09-10,9207
00936,台新永續高息中小,6,0,6,凱基-永和,2024-09-10,9207
4729,熒茂,6,0,6,凱基-永和,2024-09-10,9207
1722,台肥,5,0,5,凱基-永和,2024-09-10,9207
8011,台通,10,5,5,凱基-永和,2024-09-10,9207
8064,東捷,5,0,5,凱基-永和,2024-09-10,9207
00959B,大華投等美債15Y+,5,0,5,凱基-永和,2024-09-10,9207
2208,台船,5,0,5,凱基-永和,2024-09-10,9207
2495,普安,5,0,5,凱基-永和,2024-09-10,9207
3081,聯亞,5,0,5,凱基-永和,2024-09-10,9207
3413,京鼎,5,0,5,凱基-永和,2024-09-10,9207
5213,亞昕,5,0,5,凱基-永和,2024-09-10,9207
00687B,國泰20年美債,268,38,230,凱基-永和,2024-09-11,9207
00713,元大台灣高息低波,127,0,127,凱基-永和,2024-09-11,9207
00929,復華台灣科技優息,39,3,36,凱基-永和,2024-09-11,9207
5488,松普,31,0,31,凱基-永和,2024-09-11,9207
00715L,期街口布蘭特正2,25,0,25,凱基-永和,2024-09-11,9207
00882,中信中國高股息,24,0,24,凱基-永和,2024-09-11,9207
00642U,期元大S＆P石油,22,0,22,凱基-永和,2024-09-11,9207
2492,華新科,20,0,20,凱基-永和,2024-09-11,9207
2883,凱基金,19,0,19,凱基-永和,2024-09-11,9207
4956,光鋐,17,0,17,凱基-永和,2024-09-11,9207
6156,松上,15,0,15,凱基-永和,2024-09-11,9207
00915,凱基優選高股息30,14,0,14,凱基-永和,2024-09-11,9207
00878,國泰永續高股息,16,2,14,凱基-永和,2024-09-11,9207
2891,中信金,14,1,13,凱基-永和,2024-09-11,9207
8076,伍豐,13,0,13,凱基-永和,2024-09-11,9207
1536,和大,12,0,12,凱基-永和,2024-09-11,9207
3284,太普高,12,0,12,凱基-永和,2024-09-11,9207
2002,中鋼,11,0,11,凱基-永和,2024-09-11,9207
00679B,元大美債20年,17,7,10,凱基-永和,2024-09-11,9207
00921,兆豐龍頭等權重,10,0,10,凱基-永和,2024-09-11,9207
2062,橋椿,10,0,10,凱基-永和,2024-09-11,9207
3360,尚立,13,3,10,凱基-永和,2024-09-11,9207
8446,華研,10,0,10,凱基-永和,2024-09-11,9207
00919,群益台灣精選高息,9,0,9,凱基-永和,2024-09-11,9207
3706,神達,10,1,9,凱基-永和,2024-09-11,9207
8039,台虹,10,1,9,凱基-永和,2024-09-11,9207
4566,時碩工業,24,16,8,凱基-永和,2024-09-11,9207
00918,大華優利高填息30,8,0,8,凱基-永和,2024-09-11,9207
1522,堤維西,8,1,7,凱基-永和,2024-09-11,9207
5483,中美晶,7,0,7,凱基-永和,2024-09-11,9207
3356,奇偶,8,1,7,凱基-永和,2024-09-11,9207
3715,定穎投控,10,3,7,凱基-永和,2024-09-11,9207
2317,鴻海,11,5,6,凱基-永和,2024-09-11,9207
00934,中信成長高股息,6,0,6,凱基-永和,2024-09-11,9207
2337,旺宏,7,1,6,凱基-永和,2024-09-11,9207
3289,宜特,6,0,6,凱基-永和,2024-09-11,9207
4526,東台,6,0,6,凱基-永和,2024-09-11,9207
5880,合庫金,6,0,6,凱基-永和,2024-09-11,9207
6109,亞元,6,0,6,凱基-永和,2024-09-11,9207
6182,合晶,6,0,6,凱基-永和,2024-09-11,9207
3707,漢磊,12,7,5,凱基-永和,2024-09-11,9207
00949,復華日本龍頭,5,0,5,凱基-永和,2024-09-11,9207
00948B,中信優息投資級債,5,0,5,凱基-永和,2024-09-11,9207
00688L,國泰20年美債正2,5,0,5,凱基-永和,2024-09-11,9207
00636,國泰中國A50,5,0,5,凱基-永和,2024-09-11,9207
00959B,大華投等美債15Y+,5,0,5,凱基-永和,2024-09-11,9207
2867,三商壽,5,0,5,凱基-永和,2024-09-11,9207
2887,台新金,5,0,5,凱基-永和,2024-09-11,9207
4555,氣立,5,0,5,凱基-永和,2024-09-11,9207
5443,均豪,12,7,5,凱基-永和,2024-09-11,9207
4979,華星光,450,6,444,凱基-永和,2024-09-12,9207
8028,昇陽半導體,357,154,203,凱基-永和,2024-09-12,9207
8996,高力,140,0,140,凱基-永和,2024-09-12,9207
00632R,元大台灣50反1,162,30,132,凱基-永和,2024-09-12,9207
00680L,元大美債20正2,124,0,124,凱基-永和,2024-09-12,9207
1540,喬福,102,3,99,凱基-永和,2024-09-12,9207
3580,友威科,95,0,95,凱基-永和,2024-09-12,9207
00687B,國泰20年美債,79,31,48,凱基-永和,2024-09-12,9207
00915,凱基優選高股息30,45,0,45,凱基-永和,2024-09-12,9207
00934,中信成長高股息,20,1,19,凱基-永和,2024-09-12,9207
1301,台塑,19,0,19,凱基-永和,2024-09-12,9207
2337,旺宏,16,0,16,凱基-永和,2024-09-12,9207
00948B,中信優息投資級債,13,0,13,凱基-永和,2024-09-12,9207
2891,中信金,16,4,12,凱基-永和,2024-09-12,9207
00715L,期街口布蘭特正2,13,1,12,凱基-永和,2024-09-12,9207
00882,中信中國高股息,12,1,11,凱基-永和,2024-09-12,9207
00927,群益半導體收益,11,0,11,凱基-永和,2024-09-12,9207
00671R,富邦NASDAQ反1,10,0,10,凱基-永和,2024-09-12,9207
1446,宏和,10,0,10,凱基-永和,2024-09-12,9207
6109,亞元,10,0,10,凱基-永和,2024-09-12,9207
6125,廣運,10,1,9,凱基-永和,2024-09-12,9207
2609,陽明,12,4,8,凱基-永和,2024-09-12,9207
2208,台船,8,0,8,凱基-永和,2024-09-12,9207
2329,華泰,16,8,8,凱基-永和,2024-09-12,9207
3284,太普高,8,0,8,凱基-永和,2024-09-12,9207
00764B,群益25年美債,6,0,6,凱基-永和,2024-09-12,9207
2540,愛山林,6,0,6,凱基-永和,2024-09-12,9207
2888A,新光金甲特,6,0,6,凱基-永和,2024-09-12,9207
1522,堤維西,5,0,5,凱基-永和,2024-09-12,9207
00706L,期元大S＆P日圓正2,5,0,5,凱基-永和,2024-09-12,9207
3287,廣寰科,5,0,5,凱基-永和,2024-09-12,9207
4768,晶呈科技,5,0,5,凱基-永和,2024-09-12,9207
1220,台榮,4,0,4,凱基-永和,2024-09-12,9207
4956,光鋐,5,1,4,凱基-永和,2024-09-12,9207
8147,正淩,5,1,4,凱基-永和,2024-09-12,9207
8112,至上,3,0,3,凱基-永和,2024-09-12,9207
3035,智原,3,0,3,凱基-永和,2024-09-12,9207
00720B,元大投資級公司債,3,0,3,凱基-永和,2024-09-12,9207
2368,金像電,4,1,3,凱基-永和,2024-09-12,9207
2882B,國泰金乙特,3,0,3,凱基-永和,2024-09-12,9207
3047,訊舟,6,3,3,凱基-永和,2024-09-12,9207
3661,世芯-KY,3,0,3,凱基-永和,2024-09-12,9207
6133,金橋,4,1,3,凱基-永和,2024-09-12,9207
00918,大華優利高填息30,6,3,3,凱基-永和,2024-09-12,9207
2382,廣達,10,7,3,凱基-永和,2024-09-12,9207
2376,技嘉,2,0,2,凱基-永和,2024-09-12,9207
00945B,凱基美國非投等債,2,0,2,凱基-永和,2024-09-12,9207
00941,中信上游半導體,4,2,2,凱基-永和,2024-09-12,9207
1102,亞泥,2,0,2,凱基-永和,2024-09-12,9207
00830,國泰費城半導體,12,10,2,凱基-永和,2024-09-12,9207
3062,建漢,375,22,353,凱基-永和,2024-09-13,9207
3019,亞光,202,5,197,凱基-永和,2024-09-13,9207
3550,聯穎,192,13,179,凱基-永和,2024-09-13,9207
2351,順德,148,0,148,凱基-永和,2024-09-13,9207
3580,友威科,105,1,104,凱基-永和,2024-09-13,9207
5443,均豪,114,10,104,凱基-永和,2024-09-13,9207
4979,華星光,106,5,101,凱基-永和,2024-09-13,9207
2888,新光金,104,3,101,凱基-永和,2024-09-13,9207
8028,昇陽半導體,397,303,94,凱基-永和,2024-09-13,9207
6405,悅城,140,60,80,凱基-永和,2024-09-13,9207
00878,國泰永續高股息,67,0,67,凱基-永和,2024-09-13,9207
00918,大華優利高填息30,62,0,62,凱基-永和,2024-09-13,9207
00687B,國泰20年美債,50,0,50,凱基-永和,2024-09-13,9207
5234,達興材料,150,100,50,凱基-永和,2024-09-13,9207
00929,復華台灣科技優息,47,0,47,凱基-永和,2024-09-13,9207
6116,彩晶,40,0,40,凱基-永和,2024-09-13,9207
00857B,永豐20年美公債,33,0,33,凱基-永和,2024-09-13,9207
1722,台肥,23,0,23,凱基-永和,2024-09-13,9207
00664R,國泰臺灣加權反1,22,0,22,凱基-永和,2024-09-13,9207
00919,群益台灣精選高息,21,0,21,凱基-永和,2024-09-13,9207
00934,中信成長高股息,20,0,20,凱基-永和,2024-09-13,9207
00679B,元大美債20年,20,0,20,凱基-永和,2024-09-13,9207
4306,炎洲,21,1,20,凱基-永和,2024-09-13,9207
8054,安國,20,0,20,凱基-永和,2024-09-13,9207
9105,泰金寶-DR,16,0,16,凱基-永和,2024-09-13,9207
00882,中信中國高股息,15,0,15,凱基-永和,2024-09-13,9207
4956,光鋐,15,0,15,凱基-永和,2024-09-13,9207
3189,景碩,211,200,11,凱基-永和,2024-09-13,9207
3711,日月光投控,11,0,11,凱基-永和,2024-09-13,9207
00637L,元大滬深300正2,10,0,10,凱基-永和,2024-09-13,9207
2610,華航,10,0,10,凱基-永和,2024-09-13,9207
5425,台半,10,0,10,凱基-永和,2024-09-13,9207
2317,鴻海,12,2,10,凱基-永和,2024-09-13,9207
00915,凱基優選高股息30,9,0,9,凱基-永和,2024-09-13,9207
5398,慕康生醫,9,0,9,凱基-永和,2024-09-13,9207
3583,辛耘,11,3,8,凱基-永和,2024-09-13,9207
3715,定穎投控,11,3,8,凱基-永和,2024-09-13,9207
3284,太普高,8,1,7,凱基-永和,2024-09-13,9207
3293,鈊象,6,0,6,凱基-永和,2024-09-13,9207
2886,兆豐金,8,2,6,凱基-永和,2024-09-13,9207
00933B,國泰10Y+金融債,6,0,6,凱基-永和,2024-09-13,9207
00752,中信中國50,6,0,6,凱基-永和,2024-09-13,9207
3563,牧德,6,0,6,凱基-永和,2024-09-13,9207
2891,中信金,6,0,6,凱基-永和,2024-09-13,9207
1303,南亞,7,2,5,凱基-永和,2024-09-13,9207
6603,富強鑫,5,0,5,凱基-永和,2024-09-13,9207
00642U,期元大S＆P石油,5,0,5,凱基-永和,2024-09-13,9207
1436,華友聯,5,0,5,凱基-永和,2024-09-13,9207
3081,聯亞,5,0,5,凱基-永和,2024-09-13,9207
4906,正文,5,0,5,凱基-永和,2024-09-13,9207
1785,光洋科,401,11,390,凱基-永和,2024-09-16,9207
2201,裕隆,251,2,249,凱基-永和,2024-09-16,9207
2317,鴻海,250,44,206,凱基-永和,2024-09-16,9207
00687B,國泰20年美債,115,0,115,凱基-永和,2024-09-16,9207
2408,南亞科,115,0,115,凱基-永和,2024-09-16,9207
4958,臻鼎-KY,103,1,102,凱基-永和,2024-09-16,9207
2362,藍天,97,2,95,凱基-永和,2024-09-16,9207
00929,復華台灣科技優息,82,2,80,凱基-永和,2024-09-16,9207
00948B,中信優息投資級債,45,0,45,凱基-永和,2024-09-16,9207
00919,群益台灣精選高息,38,0,38,凱基-永和,2024-09-16,9207
00679B,元大美債20年,39,6,33,凱基-永和,2024-09-16,9207
00937B,群益ESG投等債20,29,0,29,凱基-永和,2024-09-16,9207
00680L,元大美債20正2,33,11,22,凱基-永和,2024-09-16,9207
4956,光鋐,22,0,22,凱基-永和,2024-09-16,9207
0056,元大高股息,21,0,21,凱基-永和,2024-09-16,9207
00857B,永豐20年美公債,20,0,20,凱基-永和,2024-09-16,9207
8096,擎亞,16,0,16,凱基-永和,2024-09-16,9207
00795B,中信美國公債20年,13,0,13,凱基-永和,2024-09-16,9207
00915,凱基優選高股息30,11,0,11,凱基-永和,2024-09-16,9207
00918,大華優利高填息30,11,0,11,凱基-永和,2024-09-16,9207
00947,台新臺灣IC設計,10,0,10,凱基-永和,2024-09-16,9207
6279,胡連,10,0,10,凱基-永和,2024-09-16,9207
2454,聯發科,10,0,10,凱基-永和,2024-09-16,9207
00720B,元大投資級公司債,10,0,10,凱基-永和,2024-09-16,9207
00893,國泰智能電動車,10,0,10,凱基-永和,2024-09-16,9207
3041,揚智,10,0,10,凱基-永和,2024-09-16,9207
3293,鈊象,10,0,10,凱基-永和,2024-09-16,9207
6449,鈺邦,10,1,9,凱基-永和,2024-09-16,9207
00952,凱基台灣AI50,7,0,7,凱基-永和,2024-09-16,9207
2486,一詮,38,31,7,凱基-永和,2024-09-16,9207
2489,瑞軒,7,0,7,凱基-永和,2024-09-16,9207
6152,百一,7,0,7,凱基-永和,2024-09-16,9207
2002,中鋼,6,0,6,凱基-永和,2024-09-16,9207
00923,群益台ESG低碳50,6,0,6,凱基-永和,2024-09-16,9207
2891,中信金,9,3,6,凱基-永和,2024-09-16,9207
3230,錦明,7,1,6,凱基-永和,2024-09-16,9207
3284,太普高,6,0,6,凱基-永和,2024-09-16,9207
3303,岱稜,6,0,6,凱基-永和,2024-09-16,9207
00688L,國泰20年美債正2,5,0,5,凱基-永和,2024-09-16,9207
00708L,期元大S＆P黃金正2,10,5,5,凱基-永和,2024-09-16,9207
00636,國泰中國A50,5,0,5,凱基-永和,2024-09-16,9207
00881,國泰台灣5G+,5,0,5,凱基-永和,2024-09-16,9207
3049,精金,5,0,5,凱基-永和,2024-09-16,9207
4743,合一,5,0,5,凱基-永和,2024-09-16,9207
5202,力新,5,0,5,凱基-永和,2024-09-16,9207
2882,國泰金,8,4,4,凱基-永和,2024-09-16,9207
1514,亞力,4,0,4,凱基-永和,2024-09-16,9207
4977,眾達-KY,4,0,4,凱基-永和,2024-09-16,9207
6109,亞元,4,0,4,凱基-永和,2024-09-16,9207
8039,台虹,4,0,4,凱基-永和,2024-09-16,9207
2408,南亞科,255,0,255,凱基-永和,2024-09-18,9207
1785,光洋科,207,32,175,凱基-永和,2024-09-18,9207
2312,金寶,150,0,150,凱基-永和,2024-09-18,9207
4979,華星光,183,50,133,凱基-永和,2024-09-18,9207
00929,復華台灣科技優息,151,20,131,凱基-永和,2024-09-18,9207
2867,三商壽,109,6,103,凱基-永和,2024-09-18,9207
00918,大華優利高填息30,69,5,64,凱基-永和,2024-09-18,9207
00940,元大台灣價值高息,58,1,57,凱基-永和,2024-09-18,9207
6869,雲豹能源,53,6,47,凱基-永和,2024-09-18,9207
00915,凱基優選高股息30,41,1,40,凱基-永和,2024-09-18,9207
00687B,國泰20年美債,31,0,31,凱基-永和,2024-09-18,9207
5488,松普,29,0,29,凱基-永和,2024-09-18,9207
2313,華通,26,0,26,凱基-永和,2024-09-18,9207
00927,群益半導體收益,25,0,25,凱基-永和,2024-09-18,9207
00919,群益台灣精選高息,31,9,22,凱基-永和,2024-09-18,9207
00878,國泰永續高股息,19,0,19,凱基-永和,2024-09-18,9207
2887,台新金,19,1,18,凱基-永和,2024-09-18,9207
3583,辛耘,26,9,17,凱基-永和,2024-09-18,9207
00935,野村臺灣新科技50,13,0,13,凱基-永和,2024-09-18,9207
8111,立��,12,0,12,凱基-永和,2024-09-18,9207
1314,中石化,12,0,12,凱基-永和,2024-09-18,9207
2303,聯電,13,2,11,凱基-永和,2024-09-18,9207
00706L,期元大S＆P日圓正2,10,0,10,凱基-永和,2024-09-18,9207
2201,裕隆,10,0,10,凱基-永和,2024-09-18,9207
2458,義隆,10,0,10,凱基-永和,2024-09-18,9207
5469,瀚宇博,10,0,10,凱基-永和,2024-09-18,9207
00952,凱基台灣AI50,9,0,9,凱基-永和,2024-09-18,9207
1532,勤美,11,2,9,凱基-永和,2024-09-18,9207
1304,台聚,8,0,8,凱基-永和,2024-09-18,9207
2385,群光,8,0,8,凱基-永和,2024-09-18,9207
6153,嘉聯益,8,0,8,凱基-永和,2024-09-18,9207
3376,新日興,17,10,7,凱基-永和,2024-09-18,9207
4714,永捷,7,0,7,凱基-永和,2024-09-18,9207
6446,藥華藥,7,0,7,凱基-永和,2024-09-18,9207
2324,仁寶,6,0,6,凱基-永和,2024-09-18,9207
3040,遠見,11,5,6,凱基-永和,2024-09-18,9207
3047,訊舟,6,0,6,凱基-永和,2024-09-18,9207
6698,旭暉應材,7,1,6,凱基-永和,2024-09-18,9207
4977,眾達-KY,10,5,5,凱基-永和,2024-09-18,9207
00907,永豐優息存股,5,0,5,凱基-永和,2024-09-18,9207
3230,錦明,6,1,5,凱基-永和,2024-09-18,9207
3284,太普高,10,5,5,凱基-永和,2024-09-18,9207
3689,湧德,5,0,5,凱基-永和,2024-09-18,9207
6104,創惟,15,10,5,凱基-永和,2024-09-18,9207
6158,禾昌,5,0,5,凱基-永和,2024-09-18,9207
6168,宏齊,5,0,5,凱基-永和,2024-09-18,9207
6589,台康生技,5,0,5,凱基-永和,2024-09-18,9207
8104,錸寶,5,0,5,凱基-永和,2024-09-18,9207
2327,國巨,4,0,4,凱基-永和,2024-09-18,9207
00882,中信中國高股息,5,1,4,凱基-永和,2024-09-18,9207
2464,盟立,389,86,303,凱基-永和,2024-09-19,9207
3550,聯穎,302,0,302,凱基-永和,2024-09-19,9207
8028,昇陽半導體,302,0,302,凱基-永和,2024-09-19,9207
2317,鴻海,233,5,228,凱基-永和,2024-09-19,9207
3019,亞光,203,4,199,凱基-永和,2024-09-19,9207
3580,友威科,179,2,177,凱基-永和,2024-09-19,9207
8996,高力,125,3,122,凱基-永和,2024-09-19,9207
2362,藍天,100,0,100,凱基-永和,2024-09-19,9207
2356,英業達,90,2,88,凱基-永和,2024-09-19,9207
00948B,中信優息投資級債,95,8,87,凱基-永和,2024-09-19,9207
6104,創惟,150,65,85,凱基-永和,2024-09-19,9207
00919,群益台灣精選高息,59,7,52,凱基-永和,2024-09-19,9207
4979,華星光,50,0,50,凱基-永和,2024-09-19,9207
3548,兆利,44,0,44,凱基-永和,2024-09-19,9207
00929,復華台灣科技優息,48,4,44,凱基-永和,2024-09-19,9207
00680L,元大美債20正2,51,9,42,凱基-永和,2024-09-19,9207
00632R,元大台灣50反1,40,0,40,凱基-永和,2024-09-19,9207
3376,新日興,52,17,35,凱基-永和,2024-09-19,9207
00958B,永豐ESG銀行債15,31,0,31,凱基-永和,2024-09-19,9207
00795B,中信美國公債20年,38,7,31,凱基-永和,2024-09-19,9207
00679B,元大美債20年,30,0,30,凱基-永和,2024-09-19,9207
6451,訊芯-KY,26,1,25,凱基-永和,2024-09-19,9207
00708L,期元大S＆P黃金正2,21,0,21,凱基-永和,2024-09-19,9207
2477,美隆電,20,0,20,凱基-永和,2024-09-19,9207
6937,天虹,17,1,16,凱基-永和,2024-09-19,9207
00664R,國泰臺灣加權反1,15,0,15,凱基-永和,2024-09-19,9207
6603,富強鑫,15,0,15,凱基-永和,2024-09-19,9207
3290,東浦,14,0,14,凱基-永和,2024-09-19,9207
4401,東隆興,11,0,11,凱基-永和,2024-09-19,9207
6223,旺矽,11,0,11,凱基-永和,2024-09-19,9207
1456,怡華,10,0,10,凱基-永和,2024-09-19,9207
3511,矽瑪,10,0,10,凱基-永和,2024-09-19,9207
4147,中裕,10,0,10,凱基-永和,2024-09-19,9207
00641R,富邦日本反1,8,0,8,凱基-永和,2024-09-19,9207
00915,凱基優選高股息30,7,0,7,凱基-永和,2024-09-19,9207
3455,由田,7,0,7,凱基-永和,2024-09-19,9207
4138,曜亞,7,0,7,凱基-永和,2024-09-19,9207
6109,亞元,7,0,7,凱基-永和,2024-09-19,9207
2324,仁寶,9,2,7,凱基-永和,2024-09-19,9207
00720B,元大投資級公司債,6,0,6,凱基-永和,2024-09-19,9207
3049,精金,21,15,6,凱基-永和,2024-09-19,9207
2382,廣達,7,2,5,凱基-永和,2024-09-19,9207
00946,群益科技高息成長,5,0,5,凱基-永和,2024-09-19,9207
00933B,國泰10Y+金融債,5,0,5,凱基-永和,2024-09-19,9207
00676R,富邦臺灣加權反1,5,0,5,凱基-永和,2024-09-19,9207
3060,銘異,5,0,5,凱基-永和,2024-09-19,9207
6415,矽力*-KY,5,0,5,凱基-永和,2024-09-19,9207
8039,台虹,7,2,5,凱基-永和,2024-09-19,9207
8112,至上,5,0,5,凱基-永和,2024-09-19,9207
00687B,國泰20年美債,29,25,4,凱基-永和,2024-09-19,9207
3481,群創,491,48,443,凱基-永和,2024-09-20,9207
1103,嘉泥,250,0,250,凱基-永和,2024-09-20,9207
00919,群益台灣精選高息,89,1,88,凱基-永和,2024-09-20,9207
00770,國泰北美科技,64,0,64,凱基-永和,2024-09-20,9207
00676R,富邦臺灣加權反1,60,0,60,凱基-永和,2024-09-20,9207
6869,雲豹能源,53,3,50,凱基-永和,2024-09-20,9207
1436,華友聯,45,0,45,凱基-永和,2024-09-20,9207
2348,海悅,45,7,38,凱基-永和,2024-09-20,9207
00650L,復華香港正2,30,0,30,凱基-永和,2024-09-20,9207
00720B,元大投資級公司債,27,0,27,凱基-永和,2024-09-20,9207
2388,威盛,23,0,23,凱基-永和,2024-09-20,9207
3706,神達,25,3,22,凱基-永和,2024-09-20,9207
3665,貿聯-KY,20,1,19,凱基-永和,2024-09-20,9207
00679B,元大美債20年,18,0,18,凱基-永和,2024-09-20,9207
1711,永光,439,423,16,凱基-永和,2024-09-20,9207
2101,南港,17,1,16,凱基-永和,2024-09-20,9207
00687B,國泰20年美債,37,21,16,凱基-永和,2024-09-20,9207
00680L,元大美債20正2,45,30,15,凱基-永和,2024-09-20,9207
1802,台玻,15,0,15,凱基-永和,2024-09-20,9207
6125,廣運,15,0,15,凱基-永和,2024-09-20,9207
2301,光寶科,19,4,15,凱基-永和,2024-09-20,9207
2887,台新金,13,0,13,凱基-永和,2024-09-20,9207
2002,中鋼,11,0,11,凱基-永和,2024-09-20,9207
1560,中砂,13,2,11,凱基-永和,2024-09-20,9207
5469,瀚宇博,16,5,11,凱基-永和,2024-09-20,9207
9945,潤泰新,13,3,10,凱基-永和,2024-09-20,9207
3284,太普高,10,0,10,凱基-永和,2024-09-20,9207
00664R,國泰臺灣加權反1,10,0,10,凱基-永和,2024-09-20,9207
00937B,群益ESG投等債20,10,0,10,凱基-永和,2024-09-20,9207
2367,燿華,10,0,10,凱基-永和,2024-09-20,9207
00907,永豐優息存股,9,0,9,凱基-永和,2024-09-20,9207
2365,昆盈,11,3,8,凱基-永和,2024-09-20,9207
2520,冠德,8,0,8,凱基-永和,2024-09-20,9207
2890,永豐金,8,0,8,凱基-永和,2024-09-20,9207
3040,遠見,8,0,8,凱基-永和,2024-09-20,9207
3231,緯創,25,18,7,凱基-永和,2024-09-20,9207
00878,國泰永續高股息,8,1,7,凱基-永和,2024-09-20,9207
1524,耿鼎,8,1,7,凱基-永和,2024-09-20,9207
2062,橋椿,7,1,6,凱基-永和,2024-09-20,9207
2515,中工,6,1,5,凱基-永和,2024-09-20,9207
00674R,期元大S＆P黃金反1,5,0,5,凱基-永和,2024-09-20,9207
2022,聚亨,10,5,5,凱基-永和,2024-09-20,9207
2359,所羅門,5,0,5,凱基-永和,2024-09-20,9207
2399,映泰,128,123,5,凱基-永和,2024-09-20,9207
2614,東森,5,0,5,凱基-永和,2024-09-20,9207
3703,欣陸,5,0,5,凱基-永和,2024-09-20,9207
4566,時碩工業,6,1,5,凱基-永和,2024-09-20,9207
6290,良維,5,0,5,凱基-永和,2024-09-20,9207
8076,伍豐,5,0,5,凱基-永和,2024-09-20,9207
1785,光洋科,20,15,5,凱基-永和,2024-09-20,9207
3149,正達,699,103,596,凱基-永和,2024-09-23,9207
1721,三晃,594,9,585,凱基-永和,2024-09-23,9207
3013,晟銘電,540,78,462,凱基-永和,2024-09-23,9207
3550,聯穎,393,0,393,凱基-永和,2024-09-23,9207
2897A,王道銀甲特,314,0,314,凱基-永和,2024-09-23,9207
2201,裕隆,210,1,209,凱基-永和,2024-09-23,9207
3548,兆利,224,26,198,凱基-永和,2024-09-23,9207
2349,錸德,204,8,196,凱基-永和,2024-09-23,9207
4540,全球傳動,193,0,193,凱基-永和,2024-09-23,9207
4979,華星光,542,400,142,凱基-永和,2024-09-23,9207
6869,雲豹能源,103,1,102,凱基-永和,2024-09-23,9207
6789,采鈺,74,0,74,凱基-永和,2024-09-23,9207
00919,群益台灣精選高息,74,0,74,凱基-永和,2024-09-23,9207
00937B,群益ESG投等債20,82,11,71,凱基-永和,2024-09-23,9207
00929,復華台灣科技優息,64,1,63,凱基-永和,2024-09-23,9207
6806,森崴能源,52,0,52,凱基-永和,2024-09-23,9207
5488,松普,40,0,40,凱基-永和,2024-09-23,9207
00948B,中信優息投資級債,30,0,30,凱基-永和,2024-09-23,9207
2888,新光金,31,14,17,凱基-永和,2024-09-23,9207
00680L,元大美債20正2,17,0,17,凱基-永和,2024-09-23,9207
2426,鼎元,15,0,15,凱基-永和,2024-09-23,9207
6603,富強鑫,15,0,15,凱基-永和,2024-09-23,9207
00686R,群益臺灣加權反1,13,0,13,凱基-永和,2024-09-23,9207
1519,華城,14,1,13,凱基-永和,2024-09-23,9207
2455,全新,11,0,11,凱基-永和,2024-09-23,9207
00664R,國泰臺灣加權反1,10,0,10,凱基-永和,2024-09-23,9207
00960,野村全球航運龍頭,10,0,10,凱基-永和,2024-09-23,9207
3024,憶聲,10,0,10,凱基-永和,2024-09-23,9207
3605,宏致,10,0,10,凱基-永和,2024-09-23,9207
5230,雷笛克光學,10,0,10,凱基-永和,2024-09-23,9207
00679B,元大美債20年,9,0,9,凱基-永和,2024-09-23,9207
4958,臻鼎-KY,10,1,9,凱基-永和,2024-09-23,9207
1524,耿鼎,17,9,8,凱基-永和,2024-09-23,9207
8016,矽創,7,0,7,凱基-永和,2024-09-23,9207
00941,中信上游半導體,7,0,7,凱基-永和,2024-09-23,9207
9958,世紀鋼,9,3,6,凱基-永和,2024-09-23,9207
2515,中工,6,0,6,凱基-永和,2024-09-23,9207
3163,波若威,7,1,6,凱基-永和,2024-09-23,9207
2002,中鋼,5,0,5,凱基-永和,2024-09-23,9207
00641R,富邦日本反1,5,0,5,凱基-永和,2024-09-23,9207
00632R,元大台灣50反1,5,0,5,凱基-永和,2024-09-23,9207
00676R,富邦臺灣加權反1,5,0,5,凱基-永和,2024-09-23,9207
00674R,期元大S＆P黃金反1,5,0,5,凱基-永和,2024-09-23,9207
2477,美隆電,5,0,5,凱基-永和,2024-09-23,9207
3219,倚強科,5,0,5,凱基-永和,2024-09-23,9207
3715,定穎投控,25,20,5,凱基-永和,2024-09-23,9207
5469,瀚宇博,15,10,5,凱基-永和,2024-09-23,9207
8163,達方,5,0,5,凱基-永和,2024-09-23,9207
3374,精材,9,5,4,凱基-永和,2024-09-23,9207
00720B,元大投資級公司債,5,1,4,凱基-永和,2024-09-23,9207
2317,鴻海,721,15,706,凱基-永和,2024-09-24,9207
2887,台新金,302,0,302,凱基-永和,2024-09-24,9207
3622,洋華,200,0,200,凱基-永和,2024-09-24,9207
8261,富鼎,68,0,68,凱基-永和,2024-09-24,9207
00770,國泰北美科技,60,0,60,凱基-永和,2024-09-24,9207
2888,新光金,57,1,56,凱基-永和,2024-09-24,9207
00795B,中信美國公債20年,32,0,32,凱基-永和,2024-09-24,9207
2409,友達,32,0,32,凱基-永和,2024-09-24,9207
2481,強茂,30,0,30,凱基-永和,2024-09-24,9207
3141,晶宏,30,0,30,凱基-永和,2024-09-24,9207
3548,兆利,42,13,29,凱基-永和,2024-09-24,9207
2348,海悅,27,0,27,凱基-永和,2024-09-24,9207
00753L,中信中國50正2,40,14,26,凱基-永和,2024-09-24,9207
2365,昆盈,23,1,22,凱基-永和,2024-09-24,9207
00632R,元大台灣50反1,20,0,20,凱基-永和,2024-09-24,9207
3675,德微,20,0,20,凱基-永和,2024-09-24,9207
4979,華星光,21,1,20,凱基-永和,2024-09-24,9207
8096,擎亞,20,0,20,凱基-永和,2024-09-24,9207
00679B,元大美債20年,22,3,19,凱基-永和,2024-09-24,9207
00687B,國泰20年美債,16,0,16,凱基-永和,2024-09-24,9207
2313,華通,14,0,14,凱基-永和,2024-09-24,9207
00738U,期元大道瓊白銀,12,0,12,凱基-永和,2024-09-24,9207
3715,定穎投控,20,8,12,凱基-永和,2024-09-24,9207
00680L,元大美債20正2,15,4,11,凱基-永和,2024-09-24,9207
00650L,復華香港正2,40,30,10,凱基-永和,2024-09-24,9207
1314,中石化,10,0,10,凱基-永和,2024-09-24,9207
1710,東聯,10,0,10,凱基-永和,2024-09-24,9207
2208,台船,10,0,10,凱基-永和,2024-09-24,9207
2477,美隆電,10,0,10,凱基-永和,2024-09-24,9207
3013,晟銘電,13,3,10,凱基-永和,2024-09-24,9207
3689,湧德,10,0,10,凱基-永和,2024-09-24,9207
6603,富強鑫,10,0,10,凱基-永和,2024-09-24,9207
00937B,群益ESG投等債20,9,0,9,凱基-永和,2024-09-24,9207
5608,四維航,10,1,9,凱基-永和,2024-09-24,9207
2376,技嘉,10,2,8,凱基-永和,2024-09-24,9207
6698,旭暉應材,9,1,8,凱基-永和,2024-09-24,9207
00960,野村全球航運龍頭,7,0,7,凱基-永和,2024-09-24,9207
1721,三晃,7,0,7,凱基-永和,2024-09-24,9207
2605,新興,15,8,7,凱基-永和,2024-09-24,9207
2382,廣達,8,1,7,凱基-永和,2024-09-24,9207
3443,創意,6,0,6,凱基-永和,2024-09-24,9207
3581,博磊,9,3,6,凱基-永和,2024-09-24,9207
4967,十銓,6,0,6,凱基-永和,2024-09-24,9207
8032,光菱,6,0,6,凱基-永和,2024-09-24,9207
2891,中信金,10,5,5,凱基-永和,2024-09-24,9207
1717,長興,5,0,5,凱基-永和,2024-09-24,9207
4903,聯光通,5,0,5,凱基-永和,2024-09-24,9207
5438,東友,5,0,5,凱基-永和,2024-09-24,9207
8249,菱光,5,0,5,凱基-永和,2024-09-24,9207
6152,百一,5,0,5,凱基-永和,2024-09-24,9207
00650L,復華香港正2,1153,40,1113,凱基-永和,2024-09-25,9207
00637L,元大滬深300正2,850,30,820,凱基-永和,2024-09-25,9207
2362,藍天,347,2,345,凱基-永和,2024-09-25,9207
2408,南亞科,160,2,158,凱基-永和,2024-09-25,9207
3576,聯合再生,100,1,99,凱基-永和,2024-09-25,9207
6207,雷科,102,21,81,凱基-永和,2024-09-25,9207
4510,高鋒,300,220,80,凱基-永和,2024-09-25,9207
4540,全球傳動,61,0,61,凱基-永和,2024-09-25,9207
3374,精材,64,5,59,凱基-永和,2024-09-25,9207
00738U,期元大道瓊白銀,50,2,48,凱基-永和,2024-09-25,9207
00632R,元大台灣50反1,57,10,47,凱基-永和,2024-09-25,9207
4566,時碩工業,50,7,43,凱基-永和,2024-09-25,9207
6937,天虹,34,0,34,凱基-永和,2024-09-25,9207
1721,三晃,33,0,33,凱基-永和,2024-09-25,9207
6869,雲豹能源,31,0,31,凱基-永和,2024-09-25,9207
00655L,國泰中國A50正2,31,1,30,凱基-永和,2024-09-25,9207
4571,鈞興-KY,30,1,29,凱基-永和,2024-09-25,9207
00633L,富邦上証正2,25,0,25,凱基-永和,2024-09-25,9207
00857B,永豐20年美公債,22,0,22,凱基-永和,2024-09-25,9207
00708L,期元大S＆P黃金正2,22,0,22,凱基-永和,2024-09-25,9207
2401,凌陽,24,2,22,凱基-永和,2024-09-25,9207
3013,晟銘電,32,11,21,凱基-永和,2024-09-25,9207
00669R,國泰美國道瓊反1,20,0,20,凱基-永和,2024-09-25,9207
00937B,群益ESG投等債20,20,0,20,凱基-永和,2024-09-25,9207
2328,廣宇,20,0,20,凱基-永和,2024-09-25,9207
2915,潤泰全,19,0,19,凱基-永和,2024-09-25,9207
3484,崧騰,20,1,19,凱基-永和,2024-09-25,9207
5469,瀚宇博,20,1,19,凱基-永和,2024-09-25,9207
8996,高力,18,0,18,凱基-永和,2024-09-25,9207
00687B,國泰20年美債,27,10,17,凱基-永和,2024-09-25,9207
2883,凱基金,17,0,17,凱基-永和,2024-09-25,9207
6548,長科*,20,3,17,凱基-永和,2024-09-25,9207
3443,創意,20,3,17,凱基-永和,2024-09-25,9207
6412,群電,16,0,16,凱基-永和,2024-09-25,9207
2002,中鋼,20,7,13,凱基-永和,2024-09-25,9207
2349,錸德,20,9,11,凱基-永和,2024-09-25,9207
2206,三陽工業,10,0,10,凱基-永和,2024-09-25,9207
2498,宏達電,10,0,10,凱基-永和,2024-09-25,9207
2845,遠東銀,10,0,10,凱基-永和,2024-09-25,9207
3006,晶豪科,10,0,10,凱基-永和,2024-09-25,9207
3149,正達,15,5,10,凱基-永和,2024-09-25,9207
3706,神達,10,0,10,凱基-永和,2024-09-25,9207
2454,聯發科,10,0,10,凱基-永和,2024-09-25,9207
4174,浩鼎,16,7,9,凱基-永和,2024-09-25,9207
2313,華通,10,1,9,凱基-永和,2024-09-25,9207
00679B,元大美債20年,15,7,8,凱基-永和,2024-09-25,9207
2492,華新科,8,0,8,凱基-永和,2024-09-25,9207
3037,欣興,8,1,7,凱基-永和,2024-09-25,9207
8097,常珵,8,1,7,凱基-永和,2024-09-25,9207
00877,復華中國5G,6,0,6,凱基-永和,2024-09-25,9207
4979,華星光,1036,704,332,凱基-永和,2024-09-26,9207
3163,波若威,235,4,231,凱基-永和,2024-09-26,9207
2408,南亞科,108,7,101,凱基-永和,2024-09-26,9207
6116,彩晶,50,0,50,凱基-永和,2024-09-26,9207
00795B,中信美國公債20年,33,0,33,凱基-永和,2024-09-26,9207
00687B,國泰20年美債,32,2,30,凱基-永和,2024-09-26,9207
00680L,元大美債20正2,30,0,30,凱基-永和,2024-09-26,9207
00948B,中信優息投資級債,30,0,30,凱基-永和,2024-09-26,9207
1584,精剛,30,0,30,凱基-永和,2024-09-26,9207
2359,所羅門,26,2,24,凱基-永和,2024-09-26,9207
00679B,元大美債20年,34,12,22,凱基-永和,2024-09-26,9207
3019,亞光,31,10,21,凱基-永和,2024-09-26,9207
00937B,群益ESG投等債20,30,10,20,凱基-永和,2024-09-26,9207
3363,上詮,20,0,20,凱基-永和,2024-09-26,9207
6415,矽力*-KY,22,2,20,凱基-永和,2024-09-26,9207
8096,擎亞,24,6,18,凱基-永和,2024-09-26,9207
3673,TPK-KY,26,12,14,凱基-永和,2024-09-26,9207
2367,燿華,19,5,14,凱基-永和,2024-09-26,9207
5488,松普,16,4,12,凱基-永和,2024-09-26,9207
00960,野村全球航運龍頭,12,1,11,凱基-永和,2024-09-26,9207
2615,萬海,30,19,11,凱基-永和,2024-09-26,9207
5871,中租-KY,14,4,10,凱基-永和,2024-09-26,9207
00882,中信中國高股息,10,0,10,凱基-永和,2024-09-26,9207
00631L,元大台灣50正2,12,2,10,凱基-永和,2024-09-26,9207
00720B,元大投資級公司債,11,1,10,凱基-永和,2024-09-26,9207
00708L,期元大S＆P黃金正2,10,0,10,凱基-永和,2024-09-26,9207
1905,華紙,10,0,10,凱基-永和,2024-09-26,9207
8011,台通,10,0,10,凱基-永和,2024-09-26,9207
9105,泰金寶-DR,10,0,10,凱基-永和,2024-09-26,9207
00929,復華台灣科技優息,11,2,9,凱基-永和,2024-09-26,9207
2405,輔信,10,1,9,凱基-永和,2024-09-26,9207
00753L,中信中國50正2,15,7,8,凱基-永和,2024-09-26,9207
00918,大華優利高填息30,7,0,7,凱基-永和,2024-09-26,9207
1808,潤隆,7,0,7,凱基-永和,2024-09-26,9207
9935,慶豐富,7,0,7,凱基-永和,2024-09-26,9207
6274,台燿,6,0,6,凱基-永和,2024-09-26,9207
00715L,期街口布蘭特正2,6,0,6,凱基-永和,2024-09-26,9207
00933B,國泰10Y+金融債,6,0,6,凱基-永和,2024-09-26,9207
00941,中信上游半導體,6,0,6,凱基-永和,2024-09-26,9207
2388,威盛,266,260,6,凱基-永和,2024-09-26,9207
3540,曜越,6,0,6,凱基-永和,2024-09-26,9207
3712,永崴投控,6,0,6,凱基-永和,2024-09-26,9207
2483,百容,5,0,5,凱基-永和,2024-09-26,9207
3535,晶彩科,5,0,5,凱基-永和,2024-09-26,9207
5211,蒙恬,5,0,5,凱基-永和,2024-09-26,9207
5469,瀚宇博,5,0,5,凱基-永和,2024-09-26,9207
6125,廣運,6,1,5,凱基-永和,2024-09-26,9207
6191,精成科,5,0,5,凱基-永和,2024-09-26,9207
6492,生華科,5,0,5,凱基-永和,2024-09-26,9207
8111,立��,8,3,5,凱基-永和,2024-09-26,9207
2362,藍天,453,104,349,凱基-永和,2024-09-27,9207
6873,泓德能源,185,0,185,凱基-永和,2024-09-27,9207
00687B,國泰20年美債,109,11,98,凱基-永和,2024-09-27,9207
2356,英業達,51,2,49,凱基-永和,2024-09-27,9207
00960,野村全球航運龍頭,57,15,42,凱基-永和,2024-09-27,9207
00940,元大台灣價值高息,40,0,40,凱基-永和,2024-09-27,9207
8096,擎亞,35,0,35,凱基-永和,2024-09-27,9207
3149,正達,41,20,21,凱基-永和,2024-09-27,9207
00679B,元大美債20年,21,0,21,凱基-永和,2024-09-27,9207
6187,萬潤,18,0,18,凱基-永和,2024-09-27,9207
6782,視陽,18,0,18,凱基-永和,2024-09-27,9207
5488,松普,17,0,17,凱基-永和,2024-09-27,9207
2891,中信金,17,1,16,凱基-永和,2024-09-27,9207
2495,普安,11,0,11,凱基-永和,2024-09-27,9207
00918,大華優利高填息30,12,1,11,凱基-永和,2024-09-27,9207
00631L,元大台灣50正2,12,1,11,凱基-永和,2024-09-27,9207
00937B,群益ESG投等債20,14,3,11,凱基-永和,2024-09-27,9207
2376,技嘉,14,3,11,凱基-永和,2024-09-27,9207
2330,台積電,13,2,11,凱基-永和,2024-09-27,9207
00878,國泰永續高股息,12,2,10,凱基-永和,2024-09-27,9207
00948B,中信優息投資級債,10,0,10,凱基-永和,2024-09-27,9207
2349,錸德,11,1,10,凱基-永和,2024-09-27,9207
8039,台虹,10,0,10,凱基-永和,2024-09-27,9207
8438,昶昕,10,0,10,凱基-永和,2024-09-27,9207
00633L,富邦上証正2,9,0,9,凱基-永和,2024-09-27,9207
2605,新興,11,2,9,凱基-永和,2024-09-27,9207
00655L,國泰中國A50正2,10,2,8,凱基-永和,2024-09-27,9207
3167,大量,8,0,8,凱基-永和,2024-09-27,9207
00720B,元大投資級公司債,7,0,7,凱基-永和,2024-09-27,9207
1808,潤隆,7,0,7,凱基-永和,2024-09-27,9207
3715,定穎投控,27,20,7,凱基-永和,2024-09-27,9207
00740B,富邦全球投等債,6,0,6,凱基-永和,2024-09-27,9207
1584,精剛,7,1,6,凱基-永和,2024-09-27,9207
2020,美亞,6,0,6,凱基-永和,2024-09-27,9207
2354,鴻準,6,0,6,凱基-永和,2024-09-27,9207
2363,矽統,17,11,6,凱基-永和,2024-09-27,9207
8110,華東,6,0,6,凱基-永和,2024-09-27,9207
1301,台塑,12,6,6,凱基-永和,2024-09-27,9207
3711,日月光投控,5,0,5,凱基-永和,2024-09-27,9207
00772B,中信高評級公司債,5,0,5,凱基-永和,2024-09-27,9207
00885,富邦越南,5,0,5,凱基-永和,2024-09-27,9207
00680L,元大美債20正2,5,0,5,凱基-永和,2024-09-27,9207
00953B,群益優選非投等債,5,0,5,凱基-永和,2024-09-27,9207
2313,華通,6,1,5,凱基-永和,2024-09-27,9207
2436,偉詮電,5,0,5,凱基-永和,2024-09-27,9207
2867,三商壽,5,0,5,凱基-永和,2024-09-27,9207
2883,凱基金,5,0,5,凱基-永和,2024-09-27,9207
3264,欣銓,5,0,5,凱基-永和,2024-09-27,9207
4105,東洋,5,0,5,凱基-永和,2024-09-27,9207
4526,東台,6,1,5,凱基-永和,2024-09-27,9207
00637L,元大滬深300正2,168,54,114,凱基-永和,2024-09-30,9207
00919,群益台灣精選高息,117,30,87,凱基-永和,2024-09-30,9207
00929,復華台灣科技優息,89,30,59,凱基-永和,2024-09-30,9207
0056,元大高股息,82,31,51,凱基-永和,2024-09-30,9207
6443,元晶,50,8,42,凱基-永和,2024-09-30,9207
00881,國泰台灣5G+,37,0,37,凱基-永和,2024-09-30,9207
00633L,富邦上証正2,36,1,35,凱基-永和,2024-09-30,9207
00940,元大台灣價值高息,33,0,33,凱基-永和,2024-09-30,9207
2489,瑞軒,31,2,29,凱基-永和,2024-09-30,9207
2609,陽明,37,13,24,凱基-永和,2024-09-30,9207
1711,永光,24,0,24,凱基-永和,2024-09-30,9207
00655L,國泰中國A50正2,23,2,21,凱基-永和,2024-09-30,9207
2330,台積電,20,3,17,凱基-永和,2024-09-30,9207
2449,京元電子,17,1,16,凱基-永和,2024-09-30,9207
2605,新興,27,11,16,凱基-永和,2024-09-30,9207
5488,松普,16,0,16,凱基-永和,2024-09-30,9207
00687B,國泰20年美債,15,0,15,凱基-永和,2024-09-30,9207
2615,萬海,17,3,14,凱基-永和,2024-09-30,9207
2382,廣達,17,4,13,凱基-永和,2024-09-30,9207
1717,長興,12,0,12,凱基-永和,2024-09-30,9207
00937B,群益ESG投等債20,11,0,11,凱基-永和,2024-09-30,9207
00662,富邦NASDAQ,10,0,10,凱基-永和,2024-09-30,9207
00957B,兆豐US優選投等債,10,0,10,凱基-永和,2024-09-30,9207
00958B,永豐ESG銀行債15,10,0,10,凱基-永和,2024-09-30,9207
2845,遠東銀,10,0,10,凱基-永和,2024-09-30,9207
5905,南仁湖,10,0,10,凱基-永和,2024-09-30,9207
6492,生華科,10,0,10,凱基-永和,2024-09-30,9207
1584,精剛,10,1,9,凱基-永和,2024-09-30,9207
2030,彰源,9,0,9,凱基-永和,2024-09-30,9207
2897B,王道銀乙特,10,1,9,凱基-永和,2024-09-30,9207
6526,達發,9,0,9,凱基-永和,2024-09-30,9207
2486,一詮,49,41,8,凱基-永和,2024-09-30,9207
00960,野村全球航運龍頭,7,0,7,凱基-永和,2024-09-30,9207
1909,榮成,7,0,7,凱基-永和,2024-09-30,9207
2376,技嘉,8,1,7,凱基-永和,2024-09-30,9207
006208,富邦台50,8,1,7,凱基-永和,2024-09-30,9207
00639,富邦深100,6,0,6,凱基-永和,2024-09-30,9207
00952,凱基台灣AI50,6,0,6,凱基-永和,2024-09-30,9207
8429,金麗-KY,6,0,6,凱基-永和,2024-09-30,9207
9938,百和,8,2,6,凱基-永和,2024-09-30,9207
3037,欣興,13,8,5,凱基-永和,2024-09-30,9207
00927,群益半導體收益,5,0,5,凱基-永和,2024-09-30,9207
0052,富邦科技,5,0,5,凱基-永和,2024-09-30,9207
00882,中信中國高股息,12,7,5,凱基-永和,2024-09-30,9207
00918,大華優利高填息30,5,0,5,凱基-永和,2024-09-30,9207
00922,國泰台灣領袖50,5,0,5,凱基-永和,2024-09-30,9207
00948B,中信優息投資級債,5,0,5,凱基-永和,2024-09-30,9207
00950B,凱基A級公司債,5,0,5,凱基-永和,2024-09-30,9207
1503,士電,5,0,5,凱基-永和,2024-09-30,9207
1514,亞力,6,1,5,凱基-永和,2024-09-30,9207
3149,正達,421,3,418,凱基-永和,2024-10-01,9207
2356,英業達,181,2,179,凱基-永和,2024-10-01,9207
2408,南亞科,133,0,133,凱基-永和,2024-10-01,9207
6151,晉倫,80,1,79,凱基-永和,2024-10-01,9207
00929,復華台灣科技優息,73,1,72,凱基-永和,2024-10-01,9207
00665L,富邦�琤肭磪囓�2,91,30,61,凱基-永和,2024-10-01,9207
3580,友威科,51,0,51,凱基-永和,2024-10-01,9207
6425,易發,102,56,46,凱基-永和,2024-10-01,9207
00915,凱基優選高股息30,45,0,45,凱基-永和,2024-10-01,9207
6405,悅城,43,0,43,凱基-永和,2024-10-01,9207
3550,聯穎,51,9,42,凱基-永和,2024-10-01,9207
3163,波若威,35,0,35,凱基-永和,2024-10-01,9207
8096,擎亞,30,0,30,凱基-永和,2024-10-01,9207
0056,元大高股息,32,3,29,凱基-永和,2024-10-01,9207
00650L,復華香港正2,28,4,24,凱基-永和,2024-10-01,9207
3715,定穎投控,22,2,20,凱基-永和,2024-10-01,9207
00713,元大台灣高息低波,18,0,18,凱基-永和,2024-10-01,9207
3581,博磊,15,0,15,凱基-永和,2024-10-01,9207
1809,中釉,15,0,15,凱基-永和,2024-10-01,9207
00878,國泰永續高股息,16,1,15,凱基-永和,2024-10-01,9207
2888,新光金,13,0,13,凱基-永和,2024-10-01,9207
00631L,元大台灣50正2,12,0,12,凱基-永和,2024-10-01,9207
9958,世紀鋼,12,1,11,凱基-永和,2024-10-01,9207
1301,台塑,11,0,11,凱基-永和,2024-10-01,9207
2882,國泰金,11,1,10,凱基-永和,2024-10-01,9207
00922,國泰台灣領袖50,10,0,10,凱基-永和,2024-10-01,9207
00948B,中信優息投資級債,10,0,10,凱基-永和,2024-10-01,9207
1722,台肥,10,0,10,凱基-永和,2024-10-01,9207
3265,台星科,10,0,10,凱基-永和,2024-10-01,9207
2317,鴻海,13,3,10,凱基-永和,2024-10-01,9207
2883,凱基金,10,1,9,凱基-永和,2024-10-01,9207
00795B,中信美國公債20年,12,3,9,凱基-永和,2024-10-01,9207
2449,京元電子,19,10,9,凱基-永和,2024-10-01,9207
3013,晟銘電,12,4,8,凱基-永和,2024-10-01,9207
3481,群創,9,1,8,凱基-永和,2024-10-01,9207
00919,群益台灣精選高息,7,0,7,凱基-永和,2024-10-01,9207
00937B,群益ESG投等債20,7,0,7,凱基-永和,2024-10-01,9207
0050,元大台灣50,7,0,7,凱基-永和,2024-10-01,9207
00680L,元大美債20正2,7,0,7,凱基-永和,2024-10-01,9207
00720B,元大投資級公司債,7,0,7,凱基-永和,2024-10-01,9207
2316,楠梓電,10,3,7,凱基-永和,2024-10-01,9207
2543,皇昌,7,0,7,凱基-永和,2024-10-01,9207
00712,復華富時不動產,6,0,6,凱基-永和,2024-10-01,9207
2303,聯電,6,0,6,凱基-永和,2024-10-01,9207
2365,昆盈,6,0,6,凱基-永和,2024-10-01,9207
3219,倚強科,6,0,6,凱基-永和,2024-10-01,9207
2915,潤泰全,6,1,5,凱基-永和,2024-10-01,9207
00933B,國泰10Y+金融債,5,0,5,凱基-永和,2024-10-01,9207
00642U,期元大S＆P石油,5,0,5,凱基-永和,2024-10-01,9207
0061,元大寶滬深,5,0,5,凱基-永和,2024-10-01,9207
2887,台新金,501,0,501,凱基-永和,2024-10-04,9207
2362,藍天,307,1,306,凱基-永和,2024-10-04,9207
2351,順德,140,30,110,凱基-永和,2024-10-04,9207
00919,群益台灣精選高息,95,6,89,凱基-永和,2024-10-04,9207
00687B,國泰20年美債,51,0,51,凱基-永和,2024-10-04,9207
00662,富邦NASDAQ,40,0,40,凱基-永和,2024-10-04,9207
00878,國泰永續高股息,24,0,24,凱基-永和,2024-10-04,9207
00688L,國泰20年美債正2,20,0,20,凱基-永和,2024-10-04,9207
00918,大華優利高填息30,19,0,19,凱基-永和,2024-10-04,9207
2610,華航,19,0,19,凱基-永和,2024-10-04,9207
2915,潤泰全,18,0,18,凱基-永和,2024-10-04,9207
00633L,富邦上証正2,19,2,17,凱基-永和,2024-10-04,9207
00929,復華台灣科技優息,42,25,17,凱基-永和,2024-10-04,9207
00650L,復華香港正2,28,12,16,凱基-永和,2024-10-04,9207
3219,倚強科,16,0,16,凱基-永和,2024-10-04,9207
5014,建錩,18,2,16,凱基-永和,2024-10-04,9207
00712,復華富時不動產,15,0,15,凱基-永和,2024-10-04,9207
00664R,國泰臺灣加權反1,15,0,15,凱基-永和,2024-10-04,9207
00948B,中信優息投資級債,15,0,15,凱基-永和,2024-10-04,9207
4956,光鋐,15,0,15,凱基-永和,2024-10-04,9207
0056,元大高股息,13,0,13,凱基-永和,2024-10-04,9207
3293,鈊象,13,0,13,凱基-永和,2024-10-04,9207
2303,聯電,12,0,12,凱基-永和,2024-10-04,9207
2603,長榮,212,201,11,凱基-永和,2024-10-04,9207
00679B,元大美債20年,17,6,11,凱基-永和,2024-10-04,9207
00952,凱基台灣AI50,13,2,11,凱基-永和,2024-10-04,9207
8064,東捷,11,0,11,凱基-永和,2024-10-04,9207
3581,博磊,11,0,11,凱基-永和,2024-10-04,9207
00932,兆豐永續高息等權,10,0,10,凱基-永和,2024-10-04,9207
1219,福壽,10,0,10,凱基-永和,2024-10-04,9207
1785,光洋科,18,8,10,凱基-永和,2024-10-04,9207
1909,榮成,10,0,10,凱基-永和,2024-10-04,9207
2032,新鋼,10,0,10,凱基-永和,2024-10-04,9207
4729,熒茂,10,0,10,凱基-永和,2024-10-04,9207
6616,特昇-KY,10,0,10,凱基-永和,2024-10-04,9207
2354,鴻準,10,0,10,凱基-永和,2024-10-04,9207
3037,欣興,9,0,9,凱基-永和,2024-10-04,9207
00940,元大台灣價值高息,10,1,9,凱基-永和,2024-10-04,9207
006206,元大上證50,9,0,9,凱基-永和,2024-10-04,9207
00937B,群益ESG投等債20,9,0,9,凱基-永和,2024-10-04,9207
2014,中鴻,16,7,9,凱基-永和,2024-10-04,9207
2891,中信金,9,0,9,凱基-永和,2024-10-04,9207
3284,太普高,9,0,9,凱基-永和,2024-10-04,9207
00720B,元大投資級公司債,8,0,8,凱基-永和,2024-10-04,9207
3014,聯陽,8,0,8,凱基-永和,2024-10-04,9207
3376,新日興,8,0,8,凱基-永和,2024-10-04,9207
00700,富邦�琤肭磪�,7,0,7,凱基-永和,2024-10-04,9207
2449,京元電子,12,5,7,凱基-永和,2024-10-04,9207
00655L,國泰中國A50正2,9,2,7,凱基-永和,2024-10-04,9207
00719B,元大美債1-3,10,3,7,凱基-永和,2024-10-04,9207
8404,百和興業-KY,593,25,568,凱基-永和,2024-10-07,9207
4956,光鋐,354,0,354,凱基-永和,2024-10-07,9207
6207,雷科,374,61,313,凱基-永和,2024-10-07,9207
3149,正達,476,201,275,凱基-永和,2024-10-07,9207
8069,元太,181,0,181,凱基-永和,2024-10-07,9207
2409,友達,100,0,100,凱基-永和,2024-10-07,9207
3481,群創,103,4,99,凱基-永和,2024-10-07,9207
2887,台新金,100,2,98,凱基-永和,2024-10-07,9207
8028,昇陽半導體,100,2,98,凱基-永和,2024-10-07,9207
2408,南亞科,74,0,74,凱基-永和,2024-10-07,9207
2467,志聖,62,0,62,凱基-永和,2024-10-07,9207
0056,元大高股息,55,1,54,凱基-永和,2024-10-07,9207
3163,波若威,200,150,50,凱基-永和,2024-10-07,9207
00753L,中信中國50正2,77,30,47,凱基-永和,2024-10-07,9207
00680L,元大美債20正2,47,0,47,凱基-永和,2024-10-07,9207
00665L,富邦�琤肭磪囓�2,43,0,43,凱基-永和,2024-10-07,9207
4903,聯光通,51,10,41,凱基-永和,2024-10-07,9207
3019,亞光,46,9,37,凱基-永和,2024-10-07,9207
00919,群益台灣精選高息,31,0,31,凱基-永和,2024-10-07,9207
6937,天虹,31,0,31,凱基-永和,2024-10-07,9207
2317,鴻海,40,12,28,凱基-永和,2024-10-07,9207
00937B,群益ESG投等債20,26,0,26,凱基-永和,2024-10-07,9207
6873,泓德能源,31,5,26,凱基-永和,2024-10-07,9207
00948B,中信優息投資級債,25,0,25,凱基-永和,2024-10-07,9207
1436,華友聯,23,0,23,凱基-永和,2024-10-07,9207
00688L,國泰20年美債正2,22,0,22,凱基-永和,2024-10-07,9207
2603,長榮,22,1,21,凱基-永和,2024-10-07,9207
4979,華星光,24,5,19,凱基-永和,2024-10-07,9207
6139,亞翔,23,4,19,凱基-永和,2024-10-07,9207
2328,廣宇,20,2,18,凱基-永和,2024-10-07,9207
2886,兆豐金,16,0,16,凱基-永和,2024-10-07,9207
3437,榮創,20,4,16,凱基-永和,2024-10-07,9207
1314,中石化,15,0,15,凱基-永和,2024-10-07,9207
00687B,國泰20年美債,42,27,15,凱基-永和,2024-10-07,9207
5488,松普,15,0,15,凱基-永和,2024-10-07,9207
3591,艾笛森,15,1,14,凱基-永和,2024-10-07,9207
00752,中信中國50,16,3,13,凱基-永和,2024-10-07,9207
00882,中信中國高股息,68,55,13,凱基-永和,2024-10-07,9207
00878,國泰永續高股息,12,0,12,凱基-永和,2024-10-07,9207
2801,彰銀,19,7,12,凱基-永和,2024-10-07,9207
2929,淘帝-KY,11,0,11,凱基-永和,2024-10-07,9207
3219,倚強科,11,0,11,凱基-永和,2024-10-07,9207
00713,元大台灣高息低波,11,0,11,凱基-永和,2024-10-07,9207
00706L,期元大S＆P日圓正2,10,0,10,凱基-永和,2024-10-07,9207
00725B,國泰投資級公司債,10,0,10,凱基-永和,2024-10-07,9207
00933B,國泰10Y+金融債,10,0,10,凱基-永和,2024-10-07,9207
2609,陽明,16,6,10,凱基-永和,2024-10-07,9207
3710,連展投控,10,0,10,凱基-永和,2024-10-07,9207
1504,東元,10,1,9,凱基-永和,2024-10-07,9207
3049,精金,11,2,9,凱基-永和,2024-10-07,9207
00752,中信中國50,213,15,198,凱基-永和,2024-10-08,9207
4977,眾達-KY,177,2,175,凱基-永和,2024-10-08,9207
3025,星通,150,39,111,凱基-永和,2024-10-08,9207
8070,長華*,102,0,102,凱基-永和,2024-10-08,9207
00948B,中信優息投資級債,80,0,80,凱基-永和,2024-10-08,9207
2464,盟立,80,0,80,凱基-永和,2024-10-08,9207
00919,群益台灣精選高息,67,0,67,凱基-永和,2024-10-08,9207
00687B,國泰20年美債,45,0,45,凱基-永和,2024-10-08,9207
00937B,群益ESG投等債20,49,4,45,凱基-永和,2024-10-08,9207
2897B,王道銀乙特,36,0,36,凱基-永和,2024-10-08,9207
3437,榮創,35,0,35,凱基-永和,2024-10-08,9207
00725B,國泰投資級公司債,35,1,34,凱基-永和,2024-10-08,9207
0056,元大高股息,32,0,32,凱基-永和,2024-10-08,9207
00720B,元大投資級公司債,31,0,31,凱基-永和,2024-10-08,9207
2888,新光金,42,11,31,凱基-永和,2024-10-08,9207
00665L,富邦�琤肭磪囓�2,30,0,30,凱基-永和,2024-10-08,9207
2609,陽明,30,2,28,凱基-永和,2024-10-08,9207
5531,鄉林,25,0,25,凱基-永和,2024-10-08,9207
00922,國泰台灣領袖50,22,0,22,凱基-永和,2024-10-08,9207
00655L,國泰中國A50正2,33,12,21,凱基-永和,2024-10-08,9207
1444,力麗,20,0,20,凱基-永和,2024-10-08,9207
1447,力鵬,19,0,19,凱基-永和,2024-10-08,9207
00878,國泰永續高股息,24,6,18,凱基-永和,2024-10-08,9207
2408,南亞科,17,0,17,凱基-永和,2024-10-08,9207
00918,大華優利高填息30,16,0,16,凱基-永和,2024-10-08,9207
3037,欣興,18,3,15,凱基-永和,2024-10-08,9207
2886,兆豐金,17,3,14,凱基-永和,2024-10-08,9207
3218,大學光,14,1,13,凱基-永和,2024-10-08,9207
2103,台橡,12,1,11,凱基-永和,2024-10-08,9207
00688L,國泰20年美債正2,10,0,10,凱基-永和,2024-10-08,9207
0061,元大寶滬深,10,0,10,凱基-永和,2024-10-08,9207
4760,勤凱,10,0,10,凱基-永和,2024-10-08,9207
4933,友輝,10,0,10,凱基-永和,2024-10-08,9207
5488,松普,10,0,10,凱基-永和,2024-10-08,9207
6838,台新藥,10,0,10,凱基-永和,2024-10-08,9207
00713,元大台灣高息低波,10,0,10,凱基-永和,2024-10-08,9207
8054,安國,10,1,9,凱基-永和,2024-10-08,9207
00730,富邦臺灣優質高息,8,0,8,凱基-永和,2024-10-08,9207
3284,太普高,8,0,8,凱基-永和,2024-10-08,9207
3583,辛耘,16,8,8,凱基-永和,2024-10-08,9207
8163,達方,8,0,8,凱基-永和,2024-10-08,9207
2314,台揚,7,0,7,凱基-永和,2024-10-08,9207
2316,楠梓電,7,0,7,凱基-永和,2024-10-08,9207
2615,萬海,10,4,6,凱基-永和,2024-10-08,9207
3673,TPK-KY,6,0,6,凱基-永和,2024-10-08,9207
8429,金麗-KY,12,6,6,凱基-永和,2024-10-08,9207
00940,元大台灣價值高息,6,1,5,凱基-永和,2024-10-08,9207
00960,野村全球航運龍頭,5,0,5,凱基-永和,2024-10-08,9207
00738U,期元大道瓊白銀,5,0,5,凱基-永和,2024-10-08,9207
00933B,國泰10Y+金融債,6,1,5,凱基-永和,2024-10-08,9207
4956,光鋐,300,4,296,凱基-永和,2024-10-09,9207
3149,正達,300,19,281,凱基-永和,2024-10-09,9207
00680L,元大美債20正2,201,1,200,凱基-永和,2024-10-09,9207
6937,天虹,83,11,72,凱基-永和,2024-10-09,9207
3533,嘉澤,63,1,62,凱基-永和,2024-10-09,9207
00937B,群益ESG投等債20,53,0,53,凱基-永和,2024-10-09,9207
2353,宏��,51,0,51,凱基-永和,2024-10-09,9207
3008,大立光,52,1,51,凱基-永和,2024-10-09,9207
2002,中鋼,44,0,44,凱基-永和,2024-10-09,9207
2354,鴻準,48,5,43,凱基-永和,2024-10-09,9207
1722,台肥,45,10,35,凱基-永和,2024-10-09,9207
00770,國泰北美科技,30,0,30,凱基-永和,2024-10-09,9207
6116,彩晶,30,0,30,凱基-永和,2024-10-09,9207
00882,中信中國高股息,31,3,28,凱基-永和,2024-10-09,9207
00687B,國泰20年美債,31,4,27,凱基-永和,2024-10-09,9207
00952,凱基台灣AI50,26,0,26,凱基-永和,2024-10-09,9207
3202,樺晟,24,0,24,凱基-永和,2024-10-09,9207
2303,聯電,23,0,23,凱基-永和,2024-10-09,9207
00712,復華富時不動產,22,0,22,凱基-永和,2024-10-09,9207
00857B,永豐20年美公債,22,0,22,凱基-永和,2024-10-09,9207
00753L,中信中國50正2,29,9,20,凱基-永和,2024-10-09,9207
00665L,富邦�琤肭磪囓�2,50,30,20,凱基-永和,2024-10-09,9207
00945B,凱基美國非投等債,20,0,20,凱基-永和,2024-10-09,9207
00948B,中信優息投資級債,20,0,20,凱基-永和,2024-10-09,9207
1444,力麗,20,0,20,凱基-永和,2024-10-09,9207
3049,精金,60,40,20,凱基-永和,2024-10-09,9207
5531,鄉林,20,1,19,凱基-永和,2024-10-09,9207
5871,中租-KY,21,2,19,凱基-永和,2024-10-09,9207
00940,元大台灣價值高息,16,0,16,凱基-永和,2024-10-09,9207
2376,技嘉,15,0,15,凱基-永和,2024-10-09,9207
2897B,王道銀乙特,14,0,14,凱基-永和,2024-10-09,9207
3481,群創,13,0,13,凱基-永和,2024-10-09,9207
1314,中石化,12,0,12,凱基-永和,2024-10-09,9207
2103,台橡,11,0,11,凱基-永和,2024-10-09,9207
6152,百一,11,0,11,凱基-永和,2024-10-09,9207
00643,群益深証中小,10,0,10,凱基-永和,2024-10-09,9207
00719B,元大美債1-3,10,0,10,凱基-永和,2024-10-09,9207
00706L,期元大S＆P日圓正2,10,0,10,凱基-永和,2024-10-09,9207
00949,復華日本龍頭,10,0,10,凱基-永和,2024-10-09,9207
2614,東森,10,0,10,凱基-永和,2024-10-09,9207
2883,凱基金,10,0,10,凱基-永和,2024-10-09,9207
3042,晶技,10,0,10,凱基-永和,2024-10-09,9207
3060,銘異,10,0,10,凱基-永和,2024-10-09,9207
6217,中探針,10,0,10,凱基-永和,2024-10-09,9207
00679B,元大美債20年,20,10,10,凱基-永和,2024-10-09,9207
3048,益登,9,0,9,凱基-永和,2024-10-09,9207
00725B,國泰投資級公司債,9,0,9,凱基-永和,2024-10-09,9207
00922,國泰台灣領袖50,10,1,9,凱基-永和,2024-10-09,9207
1584,精剛,10,1,9,凱基-永和,2024-10-09,9207
2883B,凱基金乙特,9,0,9,凱基-永和,2024-10-09,9207
2312,金寶,600,7,593,凱基-永和,2024-10-11,9207
2449,京元電子,310,5,305,凱基-永和,2024-10-11,9207
2543,皇昌,301,0,301,凱基-永和,2024-10-11,9207
9105,泰金寶-DR,200,0,200,凱基-永和,2024-10-11,9207
4956,光鋐,666,527,139,凱基-永和,2024-10-11,9207
00687B,國泰20年美債,58,1,57,凱基-永和,2024-10-11,9207
6830,汎銓,110,61,49,凱基-永和,2024-10-11,9207
00720B,元大投資級公司債,38,0,38,凱基-永和,2024-10-11,9207
00905,FT臺灣Smart,38,1,37,凱基-永和,2024-10-11,9207
5488,松普,34,2,32,凱基-永和,2024-10-11,9207
1815,富喬,30,0,30,凱基-永和,2024-10-11,9207
6933,AMAX-KY,25,0,25,凱基-永和,2024-10-11,9207
3548,兆利,24,0,24,凱基-永和,2024-10-11,9207
00632R,元大台灣50反1,21,0,21,凱基-永和,2024-10-11,9207
00713,元大台灣高息低波,20,0,20,凱基-永和,2024-10-11,9207
1605,華新,20,0,20,凱基-永和,2024-10-11,9207
3481,群創,22,3,19,凱基-永和,2024-10-11,9207
2887,台新金,21,3,18,凱基-永和,2024-10-11,9207
0056,元大高股息,27,10,17,凱基-永和,2024-10-11,9207
3710,連展投控,17,0,17,凱基-永和,2024-10-11,9207
00878,國泰永續高股息,23,8,15,凱基-永和,2024-10-11,9207
00937B,群益ESG投等債20,15,0,15,凱基-永和,2024-10-11,9207
3219,倚強科,27,12,15,凱基-永和,2024-10-11,9207
3008,大立光,14,0,14,凱基-永和,2024-10-11,9207
2303,聯電,13,0,13,凱基-永和,2024-10-11,9207
3049,精金,23,10,13,凱基-永和,2024-10-11,9207
00772B,中信高評級公司債,12,0,12,凱基-永和,2024-10-11,9207
3376,新日興,12,1,11,凱基-永和,2024-10-11,9207
2383,台光電,10,0,10,凱基-永和,2024-10-11,9207
00664R,國泰臺灣加權反1,10,0,10,凱基-永和,2024-10-11,9207
00955,中信日本商社,10,0,10,凱基-永和,2024-10-11,9207
1447,力鵬,10,0,10,凱基-永和,2024-10-11,9207
1702,南僑,10,0,10,凱基-永和,2024-10-11,9207
00936,台新永續高息中小,9,0,9,凱基-永和,2024-10-11,9207
00655L,國泰中國A50正2,11,2,9,凱基-永和,2024-10-11,9207
3234,光環,14,5,9,凱基-永和,2024-10-11,9207
6739,竹陞科技,8,0,8,凱基-永和,2024-10-11,9207
00637L,元大滬深300正2,19,11,8,凱基-永和,2024-10-11,9207
00650L,復華香港正2,10,2,8,凱基-永和,2024-10-11,9207
00725B,國泰投資級公司債,8,0,8,凱基-永和,2024-10-11,9207
1584,精剛,8,0,8,凱基-永和,2024-10-11,9207
3596,智易,8,0,8,凱基-永和,2024-10-11,9207
6285,啟��,8,0,8,凱基-永和,2024-10-11,9207
1808,潤隆,15,8,7,凱基-永和,2024-10-11,9207
00688L,國泰20年美債正2,7,0,7,凱基-永和,2024-10-11,9207
00922,國泰台灣領袖50,20,13,7,凱基-永和,2024-10-11,9207
3591,艾笛森,8,1,7,凱基-永和,2024-10-11,9207
6462,神盾,14,7,7,凱基-永和,2024-10-11,9207
3284,太普高,8,1,7,凱基-永和,2024-10-11,9207
00933B,國泰10Y+金融債,6,0,6,凱基-永和,2024-10-11,9207
4977,眾達-KY,572,206,366,凱基-永和,2024-10-14,9207
3149,正達,217,22,195,凱基-永和,2024-10-14,9207
6104,創惟,300,150,150,凱基-永和,2024-10-14,9207
3550,聯穎,101,2,99,凱基-永和,2024-10-14,9207
00687B,國泰20年美債,101,6,95,凱基-永和,2024-10-14,9207
00919,群益台灣精選高息,86,7,79,凱基-永和,2024-10-14,9207
2408,南亞科,74,0,74,凱基-永和,2024-10-14,9207
00948B,中信優息投資級債,70,0,70,凱基-永和,2024-10-14,9207
00637L,元大滬深300正2,401,334,67,凱基-永和,2024-10-14,9207
6449,鈺邦,50,0,50,凱基-永和,2024-10-14,9207
00887,永豐中國科技50大,49,0,49,凱基-永和,2024-10-14,9207
0056,元大高股息,32,0,32,凱基-永和,2024-10-14,9207
00720B,元大投資級公司債,28,0,28,凱基-永和,2024-10-14,9207
00753L,中信中國50正2,30,4,26,凱基-永和,2024-10-14,9207
00912,中信臺灣智慧50,25,0,25,凱基-永和,2024-10-14,9207
2002,中鋼,25,0,25,凱基-永和,2024-10-14,9207
00725B,國泰投資級公司債,25,0,25,凱基-永和,2024-10-14,9207
3008,大立光,23,0,23,凱基-永和,2024-10-14,9207
2324,仁寶,31,11,20,凱基-永和,2024-10-14,9207
2753,八方雲集,16,0,16,凱基-永和,2024-10-14,9207
00730,富邦臺灣優質高息,15,0,15,凱基-永和,2024-10-14,9207
00712,復華富時不動產,15,0,15,凱基-永和,2024-10-14,9207
2887,台新金,17,5,12,凱基-永和,2024-10-14,9207
2317,鴻海,14,2,12,凱基-永和,2024-10-14,9207
00688L,國泰20年美債正2,11,0,11,凱基-永和,2024-10-14,9207
00960,野村全球航運龍頭,11,0,11,凱基-永和,2024-10-14,9207
00632R,元大台灣50反1,10,0,10,凱基-永和,2024-10-14,9207
2641,正德,10,0,10,凱基-永和,2024-10-14,9207
00878,國泰永續高股息,9,0,9,凱基-永和,2024-10-14,9207
2426,鼎元,10,1,9,凱基-永和,2024-10-14,9207
2884,玉山金,10,1,9,凱基-永和,2024-10-14,9207
2330,台積電,13,6,7,凱基-永和,2024-10-14,9207
00923,群益台ESG低碳50,7,0,7,凱基-永和,2024-10-14,9207
2883,凱基金,8,1,7,凱基-永和,2024-10-14,9207
00905,FT臺灣Smart,7,0,7,凱基-永和,2024-10-14,9207
00795B,中信美國公債20年,6,0,6,凱基-永和,2024-10-14,9207
00922,國泰台灣領袖50,6,0,6,凱基-永和,2024-10-14,9207
00738U,期元大道瓊白銀,6,0,6,凱基-永和,2024-10-14,9207
1785,光洋科,6,0,6,凱基-永和,2024-10-14,9207
00665L,富邦�琤肭磪囓�2,20,15,5,凱基-永和,2024-10-14,9207
00680L,元大美債20正2,5,0,5,凱基-永和,2024-10-14,9207
00950B,凱基A級公司債,5,0,5,凱基-永和,2024-10-14,9207
2359,所羅門,6,1,5,凱基-永和,2024-10-14,9207
2897B,王道銀乙特,5,0,5,凱基-永和,2024-10-14,9207
5905,南仁湖,5,0,5,凱基-永和,2024-10-14,9207
8176,智捷,5,0,5,凱基-永和,2024-10-14,9207
3228,金麗科,4,0,4,凱基-永和,2024-10-14,9207
3605,宏致,4,0,4,凱基-永和,2024-10-14,9207
00907,永豐優息存股,4,0,4,凱基-永和,2024-10-14,9207
00937B,群益ESG投等債20,4,0,4,凱基-永和,2024-10-14,9207
2382,廣達,223,8,215,凱基-永和,2024-10-15,9207
4576,大銀微系統,149,7,142,凱基-永和,2024-10-15,9207
2449,京元電子,74,3,71,凱基-永和,2024-10-15,9207
2486,一詮,95,49,46,凱基-永和,2024-10-15,9207
2344,華邦電,45,2,43,凱基-永和,2024-10-15,9207
0056,元大高股息,45,5,40,凱基-永和,2024-10-15,9207
00887,永豐中國科技50大,34,0,34,凱基-永和,2024-10-15,9207
5488,松普,33,0,33,凱基-永和,2024-10-15,9207
3008,大立光,32,0,32,凱基-永和,2024-10-15,9207
8105,凌巨,30,0,30,凱基-永和,2024-10-15,9207
00687B,國泰20年美債,28,1,27,凱基-永和,2024-10-15,9207
00665L,富邦�琤肭磪囓�2,35,11,24,凱基-永和,2024-10-15,9207
1314,中石化,21,2,19,凱基-永和,2024-10-15,9207
00919,群益台灣精選高息,19,0,19,凱基-永和,2024-10-15,9207
00637L,元大滬深300正2,29,10,19,凱基-永和,2024-10-15,9207
3710,連展投控,17,0,17,凱基-永和,2024-10-15,9207
6257,矽格,17,0,17,凱基-永和,2024-10-15,9207
00632R,元大台灣50反1,16,0,16,凱基-永和,2024-10-15,9207
00725B,國泰投資級公司債,15,0,15,凱基-永和,2024-10-15,9207
2887,台新金,23,8,15,凱基-永和,2024-10-15,9207
6125,廣運,15,0,15,凱基-永和,2024-10-15,9207
00715L,期街口布蘭特正2,14,0,14,凱基-永和,2024-10-15,9207
2520,冠德,14,0,14,凱基-永和,2024-10-15,9207
2376,技嘉,15,1,14,凱基-永和,2024-10-15,9207
00730,富邦臺灣優質高息,13,0,13,凱基-永和,2024-10-15,9207
6220,岳豐,14,1,13,凱基-永和,2024-10-15,9207
00753L,中信中國50正2,12,0,12,凱基-永和,2024-10-15,9207
2426,鼎元,14,2,12,凱基-永和,2024-10-15,9207
1447,力鵬,11,0,11,凱基-永和,2024-10-15,9207
3324,雙鴻,12,1,11,凱基-永和,2024-10-15,9207
2206,三陽工業,10,0,10,凱基-永和,2024-10-15,9207
2605,新興,10,0,10,凱基-永和,2024-10-15,9207
6133,金橋,10,0,10,凱基-永和,2024-10-15,9207
6530,創威,10,0,10,凱基-永和,2024-10-15,9207
00688L,國泰20年美債正2,9,0,9,凱基-永和,2024-10-15,9207
00679B,元大美債20年,12,3,9,凱基-永和,2024-10-15,9207
00655L,國泰中國A50正2,10,1,9,凱基-永和,2024-10-15,9207
00882,中信中國高股息,8,0,8,凱基-永和,2024-10-15,9207
00642U,期元大S＆P石油,8,0,8,凱基-永和,2024-10-15,9207
3715,定穎投控,14,6,8,凱基-永和,2024-10-15,9207
00639,富邦深100,7,0,7,凱基-永和,2024-10-15,9207
6197,佳必琪,9,2,7,凱基-永和,2024-10-15,9207
2231,為升,6,0,6,凱基-永和,2024-10-15,9207
2312,金寶,47,41,6,凱基-永和,2024-10-15,9207
2867,三商壽,6,0,6,凱基-永和,2024-10-15,9207
3605,宏致,12,6,6,凱基-永和,2024-10-15,9207
6693,廣閎科,6,0,6,凱基-永和,2024-10-15,9207
9958,世紀鋼,8,2,6,凱基-永和,2024-10-15,9207
4938,和碩,7,1,6,凱基-永和,2024-10-15,9207
5386,青雲,6,0,6,凱基-永和,2024-10-15,9207
2312,金寶,638,245,393,凱基-永和,2024-10-16,9207
4977,眾達-KY,201,1,200,凱基-永和,2024-10-16,9207
8111,立��,129,0,129,凱基-永和,2024-10-16,9207
6873,泓德能源,104,0,104,凱基-永和,2024-10-16,9207
3498,陽程,100,4,96,凱基-永和,2024-10-16,9207
00680L,元大美債20正2,100,19,81,凱基-永和,2024-10-16,9207
2330,台積電,74,4,70,凱基-永和,2024-10-16,9207
6937,天虹,104,41,63,凱基-永和,2024-10-16,9207
00948B,中信優息投資級債,65,10,55,凱基-永和,2024-10-16,9207
00753L,中信中國50正2,52,1,51,凱基-永和,2024-10-16,9207
2883,凱基金,51,0,51,凱基-永和,2024-10-16,9207
3037,欣興,51,1,50,凱基-永和,2024-10-16,9207
00922,國泰台灣領袖50,60,12,48,凱基-永和,2024-10-16,9207
00687B,國泰20年美債,57,12,45,凱基-永和,2024-10-16,9207
3008,大立光,37,0,37,凱基-永和,2024-10-16,9207
4562,穎漢,52,15,37,凱基-永和,2024-10-16,9207
2409,友達,35,0,35,凱基-永和,2024-10-16,9207
00887,永豐中國科技50大,34,4,30,凱基-永和,2024-10-16,9207
00929,復華台灣科技優息,34,4,30,凱基-永和,2024-10-16,9207
0056,元大高股息,29,0,29,凱基-永和,2024-10-16,9207
6890,來億-KY,25,0,25,凱基-永和,2024-10-16,9207
00937B,群益ESG投等債20,25,3,22,凱基-永和,2024-10-16,9207
00637L,元大滬深300正2,23,2,21,凱基-永和,2024-10-16,9207
2324,仁寶,21,0,21,凱基-永和,2024-10-16,9207
00915,凱基優選高股息30,16,0,16,凱基-永和,2024-10-16,9207
4919,新唐,15,0,15,凱基-永和,2024-10-16,9207
3710,連展投控,17,2,15,凱基-永和,2024-10-16,9207
2476,鉅祥,12,0,12,凱基-永和,2024-10-16,9207
3042,晶技,12,0,12,凱基-永和,2024-10-16,9207
2897,王道銀行,11,0,11,凱基-永和,2024-10-16,9207
00919,群益台灣精選高息,12,1,11,凱基-永和,2024-10-16,9207
1447,力鵬,10,0,10,凱基-永和,2024-10-16,9207
2023,燁輝,30,20,10,凱基-永和,2024-10-16,9207
2231,為升,10,0,10,凱基-永和,2024-10-16,9207
8076,伍豐,10,0,10,凱基-永和,2024-10-16,9207
00830,國泰費城半導體,56,47,9,凱基-永和,2024-10-16,9207
2426,鼎元,11,2,9,凱基-永和,2024-10-16,9207
2891,中信金,10,1,9,凱基-永和,2024-10-16,9207
2887,台新金,9,0,9,凱基-永和,2024-10-16,9207
2834,臺企銀,7,0,7,凱基-永和,2024-10-16,9207
00878,國泰永續高股息,11,6,5,凱基-永和,2024-10-16,9207
2359,所羅門,6,1,5,凱基-永和,2024-10-16,9207
00642U,期元大S＆P石油,5,0,5,凱基-永和,2024-10-16,9207
00688L,國泰20年美債正2,5,0,5,凱基-永和,2024-10-16,9207
00733,富邦臺灣中小,5,0,5,凱基-永和,2024-10-16,9207
3362,先進光,5,0,5,凱基-永和,2024-10-16,9207
3533,嘉澤,5,0,5,凱基-永和,2024-10-16,9207
6197,佳必琪,6,1,5,凱基-永和,2024-10-16,9207
00730,富邦臺灣優質高息,5,0,5,凱基-永和,2024-10-16,9207
0050,元大台灣50,5,0,5,凱基-永和,2024-10-16,9207
2374,佳能,211,15,196,凱基-永和,2024-10-17,9207
4576,大銀微系統,341,151,190,凱基-永和,2024-10-17,9207
8028,昇陽半導體,371,202,169,凱基-永和,2024-10-17,9207
1785,光洋科,277,119,158,凱基-永和,2024-10-17,9207
2402,毅嘉,153,7,146,凱基-永和,2024-10-17,9207
3580,友威科,71,2,69,凱基-永和,2024-10-17,9207
00887,永豐中國科技50大,77,12,65,凱基-永和,2024-10-17,9207
2204,中華,50,0,50,凱基-永和,2024-10-17,9207
00927,群益半導體收益,38,0,38,凱基-永和,2024-10-17,9207
2399,映泰,50,13,37,凱基-永和,2024-10-17,9207
00637L,元大滬深300正2,35,3,32,凱基-永和,2024-10-17,9207
2426,鼎元,36,6,30,凱基-永和,2024-10-17,9207
1568,倉佑,28,0,28,凱基-永和,2024-10-17,9207
00922,國泰台灣領袖50,37,15,22,凱基-永和,2024-10-17,9207
00882,中信中國高股息,21,1,20,凱基-永和,2024-10-17,9207
6937,天虹,20,0,20,凱基-永和,2024-10-17,9207
2884,玉山金,21,4,17,凱基-永和,2024-10-17,9207
00905,FT臺灣Smart,13,0,13,凱基-永和,2024-10-17,9207
5488,松普,13,0,13,凱基-永和,2024-10-17,9207
00655L,國泰中國A50正2,11,0,11,凱基-永和,2024-10-17,9207
2070,精湛,15,4,11,凱基-永和,2024-10-17,9207
9105,泰金寶-DR,31,20,11,凱基-永和,2024-10-17,9207
6274,台燿,10,0,10,凱基-永和,2024-10-17,9207
00752,中信中國50,10,0,10,凱基-永和,2024-10-17,9207
00643,群益深証中小,10,0,10,凱基-永和,2024-10-17,9207
1524,耿鼎,11,1,10,凱基-永和,2024-10-17,9207
2104,國際中橡,10,0,10,凱基-永和,2024-10-17,9207
2206,三陽工業,10,0,10,凱基-永和,2024-10-17,9207
3264,欣銓,10,0,10,凱基-永和,2024-10-17,9207
6101,寬魚國際,10,0,10,凱基-永和,2024-10-17,9207
8011,台通,10,0,10,凱基-永和,2024-10-17,9207
0056,元大高股息,15,6,9,凱基-永和,2024-10-17,9207
2330,台積電,19,11,8,凱基-永和,2024-10-17,9207
00912,中信臺灣智慧50,7,0,7,凱基-永和,2024-10-17,9207
00687B,國泰20年美債,8,1,7,凱基-永和,2024-10-17,9207
00941,中信上游半導體,6,0,6,凱基-永和,2024-10-17,9207
00725B,國泰投資級公司債,6,0,6,凱基-永和,2024-10-17,9207
2388,威盛,6,0,6,凱基-永和,2024-10-17,9207
3029,零壹,6,0,6,凱基-永和,2024-10-17,9207
3149,正達,8,2,6,凱基-永和,2024-10-17,9207
5515,建國,6,0,6,凱基-永和,2024-10-17,9207
2317,鴻海,14,9,5,凱基-永和,2024-10-17,9207
3008,大立光,6,1,5,凱基-永和,2024-10-17,9207
00895,富邦未來車,5,0,5,凱基-永和,2024-10-17,9207
1597,直得,5,0,5,凱基-永和,2024-10-17,9207
2349,錸德,5,0,5,凱基-永和,2024-10-17,9207
3466,德晉,5,0,5,凱基-永和,2024-10-17,9207
4164,承業醫,5,0,5,凱基-永和,2024-10-17,9207
8176,智捷,5,0,5,凱基-永和,2024-10-17,9207
6442,光聖,10,5,5,凱基-永和,2024-10-17,9207
00929,復華台灣科技優息,105,2,103,凱基-永和,2024-10-18,9207
4526,東台,101,0,101,凱基-永和,2024-10-18,9207
3551,世禾,93,1,92,凱基-永和,2024-10-18,9207
00937B,群益ESG投等債20,81,0,81,凱基-永和,2024-10-18,9207
9105,泰金寶-DR,76,12,64,凱基-永和,2024-10-18,9207
00680L,元大美債20正2,65,21,44,凱基-永和,2024-10-18,9207
00687B,國泰20年美債,39,0,39,凱基-永和,2024-10-18,9207
2303,聯電,36,3,33,凱基-永和,2024-10-18,9207
3230,錦明,30,0,30,凱基-永和,2024-10-18,9207
00679B,元大美債20年,39,10,29,凱基-永和,2024-10-18,9207
2317,鴻海,41,12,29,凱基-永和,2024-10-18,9207
2376,技嘉,29,3,26,凱基-永和,2024-10-18,9207
3481,群創,42,17,25,凱基-永和,2024-10-18,9207
1444,力麗,25,0,25,凱基-永和,2024-10-18,9207
2883,凱基金,74,50,24,凱基-永和,2024-10-18,9207
00637L,元大滬深300正2,31,10,21,凱基-永和,2024-10-18,9207
3324,雙鴻,21,0,21,凱基-永和,2024-10-18,9207
00752,中信中國50,20,0,20,凱基-永和,2024-10-18,9207
00907,永豐優息存股,20,0,20,凱基-永和,2024-10-18,9207
2489,瑞軒,20,0,20,凱基-永和,2024-10-18,9207
00927,群益半導體收益,18,0,18,凱基-永和,2024-10-18,9207
4908,前鼎,18,1,17,凱基-永和,2024-10-18,9207
2359,所羅門,22,5,17,凱基-永和,2024-10-18,9207
2367,燿華,27,10,17,凱基-永和,2024-10-18,9207
00664R,國泰臺灣加權反1,15,0,15,凱基-永和,2024-10-18,9207
2330,台積電,39,27,12,凱基-永和,2024-10-18,9207
00948B,中信優息投資級債,18,6,12,凱基-永和,2024-10-18,9207
2316,楠梓電,21,9,12,凱基-永和,2024-10-18,9207
2383,台光電,16,4,12,凱基-永和,2024-10-18,9207
2301,光寶科,12,0,12,凱基-永和,2024-10-18,9207
2610,華航,12,1,11,凱基-永和,2024-10-18,9207
3041,揚智,11,0,11,凱基-永和,2024-10-18,9207
2449,京元電子,14,3,11,凱基-永和,2024-10-18,9207
0056,元大高股息,13,3,10,凱基-永和,2024-10-18,9207
2313,華通,10,0,10,凱基-永和,2024-10-18,9207
3011,今皓,10,0,10,凱基-永和,2024-10-18,9207
00715L,期街口布蘭特正2,10,0,10,凱基-永和,2024-10-18,9207
00904,新光臺灣半導體30,10,0,10,凱基-永和,2024-10-18,9207
00961,FT臺灣永續高息,10,0,10,凱基-永和,2024-10-18,9207
1447,力鵬,10,0,10,凱基-永和,2024-10-18,9207
2388,威盛,10,0,10,凱基-永和,2024-10-18,9207
3322,建舜電,10,0,10,凱基-永和,2024-10-18,9207
4566,時碩工業,12,3,9,凱基-永和,2024-10-18,9207
3062,建漢,9,0,9,凱基-永和,2024-10-18,9207
00639,富邦深100,8,0,8,凱基-永和,2024-10-18,9207
2349,錸德,8,0,8,凱基-永和,2024-10-18,9207
2464,盟立,8,0,8,凱基-永和,2024-10-18,9207
3029,零壹,10,2,8,凱基-永和,2024-10-18,9207
4919,新唐,7,0,7,凱基-永和,2024-10-18,9207
00795B,中信美國公債20年,7,0,7,凱基-永和,2024-10-18,9207
1711,永光,412,203,209,凱基-永和,2024-10-21,9207
6763,綠界科技*,201,1,200,凱基-永和,2024-10-21,9207
8039,台虹,267,101,166,凱基-永和,2024-10-21,9207
00937B,群益ESG投等債20,116,3,113,凱基-永和,2024-10-21,9207
3551,世禾,172,64,108,凱基-永和,2024-10-21,9207
1721,三晃,111,8,103,凱基-永和,2024-10-21,9207
1597,直得,200,100,100,凱基-永和,2024-10-21,9207
5438,東友,100,0,100,凱基-永和,2024-10-21,9207
3189,景碩,100,4,96,凱基-永和,2024-10-21,9207
3615,安可,100,4,96,凱基-永和,2024-10-21,9207
8240,華宏,95,0,95,凱基-永和,2024-10-21,9207
3580,友威科,90,0,90,凱基-永和,2024-10-21,9207
8043,蜜望實,70,0,70,凱基-永和,2024-10-21,9207
00679B,元大美債20年,51,1,50,凱基-永和,2024-10-21,9207
2883,凱基金,46,0,46,凱基-永和,2024-10-21,9207
00933B,國泰10Y+金融債,39,0,39,凱基-永和,2024-10-21,9207
2884,玉山金,34,0,34,凱基-永和,2024-10-21,9207
6906,現觀科,38,4,34,凱基-永和,2024-10-21,9207
00687B,國泰20年美債,26,0,26,凱基-永和,2024-10-21,9207
2312,金寶,41,16,25,凱基-永和,2024-10-21,9207
1444,力麗,24,0,24,凱基-永和,2024-10-21,9207
0061,元大寶滬深,23,0,23,凱基-永和,2024-10-21,9207
00945B,凱基美國非投等債,21,0,21,凱基-永和,2024-10-21,9207
1447,力鵬,20,0,20,凱基-永和,2024-10-21,9207
00882,中信中國高股息,19,1,18,凱基-永和,2024-10-21,9207
00720B,元大投資級公司債,18,0,18,凱基-永和,2024-10-21,9207
4576,大銀微系統,194,177,17,凱基-永和,2024-10-21,9207
5488,松普,15,0,15,凱基-永和,2024-10-21,9207
2103,台橡,14,0,14,凱基-永和,2024-10-21,9207
2891,中信金,13,0,13,凱基-永和,2024-10-21,9207
3149,正達,43,30,13,凱基-永和,2024-10-21,9207
00715L,期街口布蘭特正2,12,0,12,凱基-永和,2024-10-21,9207
2888A,新光金甲特,12,0,12,凱基-永和,2024-10-21,9207
3533,嘉澤,14,2,12,凱基-永和,2024-10-21,9207
4113,聯上,12,0,12,凱基-永和,2024-10-21,9207
00929,復華台灣科技優息,15,3,12,凱基-永和,2024-10-21,9207
00712,復華富時不動產,11,0,11,凱基-永和,2024-10-21,9207
4123,晟德,10,0,10,凱基-永和,2024-10-21,9207
00719B,元大美債1-3,10,0,10,凱基-永和,2024-10-21,9207
2855,統一證,10,0,10,凱基-永和,2024-10-21,9207
2882,國泰金,10,0,10,凱基-永和,2024-10-21,9207
6603,富強鑫,10,0,10,凱基-永和,2024-10-21,9207
8261,富鼎,10,0,10,凱基-永和,2024-10-21,9207
3583,辛耘,11,2,9,凱基-永和,2024-10-21,9207
2002,中鋼,8,0,8,凱基-永和,2024-10-21,9207
00639,富邦深100,54,46,8,凱基-永和,2024-10-21,9207
00752,中信中國50,7,0,7,凱基-永和,2024-10-21,9207
00948B,中信優息投資級債,7,0,7,凱基-永和,2024-10-21,9207
6104,創惟,11,4,7,凱基-永和,2024-10-21,9207
6241,易通展,7,0,7,凱基-永和,2024-10-21,9207
2449,京元電子,502,3,499,凱基-永和,2024-10-22,9207
4979,華星光,301,1,300,凱基-永和,2024-10-22,9207
4716,大立,200,0,200,凱基-永和,2024-10-22,9207
00679B,元大美債20年,134,0,134,凱基-永和,2024-10-22,9207
1785,光洋科,100,1,99,凱基-永和,2024-10-22,9207
00937B,群益ESG投等債20,98,0,98,凱基-永和,2024-10-22,9207
8249,菱光,100,2,98,凱基-永和,2024-10-22,9207
00687B,國泰20年美債,123,31,92,凱基-永和,2024-10-22,9207
3230,錦明,46,1,45,凱基-永和,2024-10-22,9207
00680L,元大美債20正2,41,10,31,凱基-永和,2024-10-22,9207
00720B,元大投資級公司債,32,2,30,凱基-永和,2024-10-22,9207
2002,中鋼,31,1,30,凱基-永和,2024-10-22,9207
6202,盛群,28,0,28,凱基-永和,2024-10-22,9207
00929,復華台灣科技優息,25,0,25,凱基-永和,2024-10-22,9207
4552,力達-KY,25,0,25,凱基-永和,2024-10-22,9207
00688L,國泰20年美債正2,22,0,22,凱基-永和,2024-10-22,9207
2421,建準,21,0,21,凱基-永和,2024-10-22,9207
2439,美律,21,0,21,凱基-永和,2024-10-22,9207
00725B,國泰投資級公司債,20,0,20,凱基-永和,2024-10-22,9207
1444,力麗,20,0,20,凱基-永和,2024-10-22,9207
1447,力鵬,20,0,20,凱基-永和,2024-10-22,9207
4526,東台,22,2,20,凱基-永和,2024-10-22,9207
5607,遠雄港,20,0,20,凱基-永和,2024-10-22,9207
00772B,中信高評級公司債,19,0,19,凱基-永和,2024-10-22,9207
00948B,中信優息投資級債,18,0,18,凱基-永和,2024-10-22,9207
2303,聯電,18,0,18,凱基-永和,2024-10-22,9207
3605,宏致,18,1,17,凱基-永和,2024-10-22,9207
4938,和碩,20,3,17,凱基-永和,2024-10-22,9207
8105,凌巨,16,0,16,凱基-永和,2024-10-22,9207
00795B,中信美國公債20年,15,0,15,凱基-永和,2024-10-22,9207
00751B,元大AAA至A公司債,14,0,14,凱基-永和,2024-10-22,9207
5488,松普,14,0,14,凱基-永和,2024-10-22,9207
00941,中信上游半導體,13,0,13,凱基-永和,2024-10-22,9207
2483,百容,13,0,13,凱基-永和,2024-10-22,9207
00878,國泰永續高股息,17,5,12,凱基-永和,2024-10-22,9207
00931B,統一美債20年,12,0,12,凱基-永和,2024-10-22,9207
3481,群創,18,7,11,凱基-永和,2024-10-22,9207
00712,復華富時不動產,10,0,10,凱基-永和,2024-10-22,9207
1314,中石化,10,0,10,凱基-永和,2024-10-22,9207
6170,統振,12,2,10,凱基-永和,2024-10-22,9207
00933B,國泰10Y+金融債,19,10,9,凱基-永和,2024-10-22,9207
2891,中信金,12,4,8,凱基-永和,2024-10-22,9207
1702,南僑,8,0,8,凱基-永和,2024-10-22,9207
2801,彰銀,8,0,8,凱基-永和,2024-10-22,9207
8046,南電,10,2,8,凱基-永和,2024-10-22,9207
2330,台積電,12,4,8,凱基-永和,2024-10-22,9207
2454,聯發科,7,0,7,凱基-永和,2024-10-22,9207
00905,FT臺灣Smart,19,12,7,凱基-永和,2024-10-22,9207
3390,旭軟,7,0,7,凱基-永和,2024-10-22,9207
3581,博磊,15,8,7,凱基-永和,2024-10-22,9207
1721,三晃,600,306,294,凱基-永和,2024-10-23,9207
6104,創惟,323,101,222,凱基-永和,2024-10-23,9207
2382,廣達,132,1,131,凱基-永和,2024-10-23,9207
3580,友威科,125,2,123,凱基-永和,2024-10-23,9207
2421,建準,105,2,103,凱基-永和,2024-10-23,9207
3551,世禾,51,2,49,凱基-永和,2024-10-23,9207
2444,兆勁,48,0,48,凱基-永和,2024-10-23,9207
6667,信紘科,45,0,45,凱基-永和,2024-10-23,9207
00687B,國泰20年美債,32,0,32,凱基-永和,2024-10-23,9207
3073,天方能源,30,0,30,凱基-永和,2024-10-23,9207
2884,玉山金,27,1,26,凱基-永和,2024-10-23,9207
2303,聯電,26,0,26,凱基-永和,2024-10-23,9207
00679B,元大美債20年,34,8,26,凱基-永和,2024-10-23,9207
00937B,群益ESG投等債20,25,0,25,凱基-永和,2024-10-23,9207
00712,復華富時不動產,25,0,25,凱基-永和,2024-10-23,9207
2867,三商壽,22,0,22,凱基-永和,2024-10-23,9207
5488,松普,22,0,22,凱基-永和,2024-10-23,9207
2883,凱基金,21,0,21,凱基-永和,2024-10-23,9207
00720B,元大投資級公司債,20,0,20,凱基-永和,2024-10-23,9207
00725B,國泰投資級公司債,20,0,20,凱基-永和,2024-10-23,9207
00907,永豐優息存股,19,0,19,凱基-永和,2024-10-23,9207
00955,中信日本商社,18,0,18,凱基-永和,2024-10-23,9207
9940,信義,18,0,18,凱基-永和,2024-10-23,9207
00952,凱基台灣AI50,13,0,13,凱基-永和,2024-10-23,9207
2891,中信金,12,0,12,凱基-永和,2024-10-23,9207
00795B,中信美國公債20年,11,0,11,凱基-永和,2024-10-23,9207
2317,鴻海,23,13,10,凱基-永和,2024-10-23,9207
00688L,國泰20年美債正2,10,0,10,凱基-永和,2024-10-23,9207
2324,仁寶,10,0,10,凱基-永和,2024-10-23,9207
2354,鴻準,14,4,10,凱基-永和,2024-10-23,9207
00929,復華台灣科技優息,10,0,10,凱基-永和,2024-10-23,9207
2426,鼎元,16,7,9,凱基-永和,2024-10-23,9207
5876,上海商銀,8,0,8,凱基-永和,2024-10-23,9207
9105,泰金寶-DR,8,0,8,凱基-永和,2024-10-23,9207
00888,永豐台灣ESG,7,0,7,凱基-永和,2024-10-23,9207
6194,育富,7,0,7,凱基-永和,2024-10-23,9207
6405,悅城,7,0,7,凱基-永和,2024-10-23,9207
3583,辛耘,10,3,7,凱基-永和,2024-10-23,9207
1101,台泥,6,0,6,凱基-永和,2024-10-23,9207
2312,金寶,7,1,6,凱基-永和,2024-10-23,9207
2349,錸德,6,0,6,凱基-永和,2024-10-23,9207
6101,寬魚國際,11,5,6,凱基-永和,2024-10-23,9207
00900,富邦特選高股息30,5,0,5,凱基-永和,2024-10-23,9207
2439,美律,5,0,5,凱基-永和,2024-10-23,9207
3055,蔚華科,5,0,5,凱基-永和,2024-10-23,9207
3666,光耀,5,0,5,凱基-永和,2024-10-23,9207
4919,新唐,15,10,5,凱基-永和,2024-10-23,9207
1301,台塑,4,0,4,凱基-永和,2024-10-23,9207
00887,永豐中國科技50大,4,0,4,凱基-永和,2024-10-23,9207
00673R,期元大S＆P原油反1,4,0,4,凱基-永和,2024-10-23,9207
00665L,富邦�琤肭磪囓�2,111,66,45,凱基-永和,2024-10-24,9207
00946,群益科技高息成長,33,0,33,凱基-永和,2024-10-24,9207
00687B,國泰20年美債,32,0,32,凱基-永和,2024-10-24,9207
00929,復華台灣科技優息,48,20,28,凱基-永和,2024-10-24,9207
3689,湧德,26,0,26,凱基-永和,2024-10-24,9207
2486,一詮,116,90,26,凱基-永和,2024-10-24,9207
3141,晶宏,34,14,20,凱基-永和,2024-10-24,9207
2201,裕隆,22,3,19,凱基-永和,2024-10-24,9207
2317,鴻海,27,9,18,凱基-永和,2024-10-24,9207
00712,復華富時不動產,17,0,17,凱基-永和,2024-10-24,9207
00753L,中信中國50正2,16,0,16,凱基-永和,2024-10-24,9207
00948B,中信優息投資級債,16,0,16,凱基-永和,2024-10-24,9207
6101,寬魚國際,19,3,16,凱基-永和,2024-10-24,9207
8404,百和興業-KY,18,2,16,凱基-永和,2024-10-24,9207
2427,三商電,15,0,15,凱基-永和,2024-10-24,9207
2314,台揚,14,0,14,凱基-永和,2024-10-24,9207
2383,台光電,13,0,13,凱基-永和,2024-10-24,9207
00937B,群益ESG投等債20,13,0,13,凱基-永和,2024-10-24,9207
2891,中信金,14,1,13,凱基-永和,2024-10-24,9207
00637L,元大滬深300正2,17,5,12,凱基-永和,2024-10-24,9207
2312,金寶,22,10,12,凱基-永和,2024-10-24,9207
00881,國泰台灣5G+,11,0,11,凱基-永和,2024-10-24,9207
1727,中華化,11,0,11,凱基-永和,2024-10-24,9207
2376,技嘉,11,0,11,凱基-永和,2024-10-24,9207
6134,萬旭,26,15,11,凱基-永和,2024-10-24,9207
00950B,凱基A級公司債,10,0,10,凱基-永和,2024-10-24,9207
1605,華新,10,0,10,凱基-永和,2024-10-24,9207
2348,海悅,10,0,10,凱基-永和,2024-10-24,9207
8429,金麗-KY,10,0,10,凱基-永和,2024-10-24,9207
2388,威盛,11,2,9,凱基-永和,2024-10-24,9207
00680L,元大美債20正2,13,4,9,凱基-永和,2024-10-24,9207
2303,聯電,11,4,7,凱基-永和,2024-10-24,9207
3163,波若威,7,0,7,凱基-永和,2024-10-24,9207
00930,永豐ESG低碳高息,7,0,7,凱基-永和,2024-10-24,9207
1789,神隆,7,0,7,凱基-永和,2024-10-24,9207
2883,凱基金,6,0,6,凱基-永和,2024-10-24,9207
6446,藥華藥,6,0,6,凱基-永和,2024-10-24,9207
2455,全新,6,0,6,凱基-永和,2024-10-24,9207
2316,楠梓電,13,7,6,凱基-永和,2024-10-24,9207
3167,大量,7,1,6,凱基-永和,2024-10-24,9207
3230,錦明,6,0,6,凱基-永和,2024-10-24,9207
6218,豪勉,7,1,6,凱基-永和,2024-10-24,9207
6763,綠界科技*,5,0,5,凱基-永和,2024-10-24,9207
00933B,國泰10Y+金融債,5,0,5,凱基-永和,2024-10-24,9207
00725B,國泰投資級公司債,5,0,5,凱基-永和,2024-10-24,9207
2103,台橡,5,0,5,凱基-永和,2024-10-24,9207
2439,美律,5,0,5,凱基-永和,2024-10-24,9207
2613,中櫃,5,0,5,凱基-永和,2024-10-24,9207
2867,三商壽,10,5,5,凱基-永和,2024-10-24,9207
2883B,凱基金乙特,5,0,5,凱基-永和,2024-10-24,9207
3037,欣興,504,4,500,凱基-永和,2024-10-25,9207
2354,鴻準,463,19,444,凱基-永和,2024-10-25,9207
2312,金寶,331,55,276,凱基-永和,2024-10-25,9207
3481,群創,258,1,257,凱基-永和,2024-10-25,9207
2409,友達,250,0,250,凱基-永和,2024-10-25,9207
00940,元大台灣價值高息,110,0,110,凱基-永和,2024-10-25,9207
6235,華孚,106,10,96,凱基-永和,2024-10-25,9207
3551,世禾,50,1,49,凱基-永和,2024-10-25,9207
00680L,元大美債20正2,39,0,39,凱基-永和,2024-10-25,9207
00937B,群益ESG投等債20,51,14,37,凱基-永和,2024-10-25,9207
00878,國泰永續高股息,33,0,33,凱基-永和,2024-10-25,9207
00753L,中信中國50正2,33,1,32,凱基-永和,2024-10-25,9207
00679B,元大美債20年,31,0,31,凱基-永和,2024-10-25,9207
3402,漢科,30,1,29,凱基-永和,2024-10-25,9207
4903,聯光通,33,4,29,凱基-永和,2024-10-25,9207
6449,鈺邦,28,0,28,凱基-永和,2024-10-25,9207
2887,台新金,27,0,27,凱基-永和,2024-10-25,9207
00919,群益台灣精選高息,30,9,21,凱基-永和,2024-10-25,9207
2739,寒舍,20,0,20,凱基-永和,2024-10-25,9207
1536,和大,34,16,18,凱基-永和,2024-10-25,9207
2609,陽明,17,0,17,凱基-永和,2024-10-25,9207
00725B,國泰投資級公司債,15,0,15,凱基-永和,2024-10-25,9207
6158,禾昌,15,0,15,凱基-永和,2024-10-25,9207
3029,零壹,18,4,14,凱基-永和,2024-10-25,9207
2303,聯電,14,0,14,凱基-永和,2024-10-25,9207
6770,力積電,14,0,14,凱基-永和,2024-10-25,9207
9940,信義,13,0,13,凱基-永和,2024-10-25,9207
2405,輔信,12,0,12,凱基-永和,2024-10-25,9207
3219,倚強科,12,0,12,凱基-永和,2024-10-25,9207
00738U,期元大道瓊白銀,10,0,10,凱基-永和,2024-10-25,9207
00952,凱基台灣AI50,10,0,10,凱基-永和,2024-10-25,9207
2324,仁寶,10,0,10,凱基-永和,2024-10-25,9207
2867,三商壽,10,0,10,凱基-永和,2024-10-25,9207
3230,錦明,11,1,10,凱基-永和,2024-10-25,9207
5488,松普,20,10,10,凱基-永和,2024-10-25,9207
00639,富邦深100,9,0,9,凱基-永和,2024-10-25,9207
4952,凌通,8,0,8,凱基-永和,2024-10-25,9207
2352,佳世達,8,0,8,凱基-永和,2024-10-25,9207
2891,中信金,8,0,8,凱基-永和,2024-10-25,9207
1714,和桐,7,0,7,凱基-永和,2024-10-25,9207
2439,美律,14,7,7,凱基-永和,2024-10-25,9207
8404,百和興業-KY,7,0,7,凱基-永和,2024-10-25,9207
2603,長榮,8,1,7,凱基-永和,2024-10-25,9207
1314,中石化,6,0,6,凱基-永和,2024-10-25,9207
2615,萬海,10,4,6,凱基-永和,2024-10-25,9207
4566,時碩工業,8,2,6,凱基-永和,2024-10-25,9207
6275,元山,6,0,6,凱基-永和,2024-10-25,9207
2489,瑞軒,8,2,6,凱基-永和,2024-10-25,9207
2883,凱基金,8,2,6,凱基-永和,2024-10-25,9207
2455,全新,5,0,5,凱基-永和,2024-10-25,9207
8249,菱光,829,456,373,凱基-永和,2024-10-28,9207
2354,鴻準,584,403,181,凱基-永和,2024-10-28,9207
3551,世禾,226,50,176,凱基-永和,2024-10-28,9207
2486,一詮,114,6,108,凱基-永和,2024-10-28,9207
00687B,國泰20年美債,91,8,83,凱基-永和,2024-10-28,9207
00937B,群益ESG投等債20,79,0,79,凱基-永和,2024-10-28,9207
3580,友威科,69,1,68,凱基-永和,2024-10-28,9207
00878,國泰永續高股息,60,10,50,凱基-永和,2024-10-28,9207
6288,聯嘉,51,1,50,凱基-永和,2024-10-28,9207
00665L,富邦�琤肭磪囓�2,129,84,45,凱基-永和,2024-10-28,9207
2615,萬海,52,10,42,凱基-永和,2024-10-28,9207
6213,聯茂,41,0,41,凱基-永和,2024-10-28,9207
00679B,元大美債20年,55,21,34,凱基-永和,2024-10-28,9207
3356,奇偶,30,0,30,凱基-永和,2024-10-28,9207
2439,美律,30,1,29,凱基-永和,2024-10-28,9207
00715L,期街口布蘭特正2,20,0,20,凱基-永和,2024-10-28,9207
00919,群益台灣精選高息,19,0,19,凱基-永和,2024-10-28,9207
6603,富強鑫,16,0,16,凱基-永和,2024-10-28,9207
00795B,中信美國公債20年,14,0,14,凱基-永和,2024-10-28,9207
00637L,元大滬深300正2,16,2,14,凱基-永和,2024-10-28,9207
00951,台新日本半導體,13,0,13,凱基-永和,2024-10-28,9207
2376,技嘉,12,0,12,凱基-永和,2024-10-28,9207
2609,陽明,14,3,11,凱基-永和,2024-10-28,9207
00881,國泰台灣5G+,11,0,11,凱基-永和,2024-10-28,9207
00642U,期元大S＆P石油,11,0,11,凱基-永和,2024-10-28,9207
00632R,元大台灣50反1,10,0,10,凱基-永和,2024-10-28,9207
0061,元大寶滬深,10,0,10,凱基-永和,2024-10-28,9207
2867,三商壽,10,0,10,凱基-永和,2024-10-28,9207
2888A,新光金甲特,10,0,10,凱基-永和,2024-10-28,9207
6117,迎廣,10,0,10,凱基-永和,2024-10-28,9207
00639,富邦深100,9,0,9,凱基-永和,2024-10-28,9207
006208,富邦台50,10,1,9,凱基-永和,2024-10-28,9207
00751B,元大AAA至A公司債,9,0,9,凱基-永和,2024-10-28,9207
00688L,國泰20年美債正2,9,0,9,凱基-永和,2024-10-28,9207
3293,鈊象,11,2,9,凱基-永和,2024-10-28,9207
2646,星宇航空,23,15,8,凱基-永和,2024-10-28,9207
6509,聚和,7,0,7,凱基-永和,2024-10-28,9207
00933B,國泰10Y+金融債,6,0,6,凱基-永和,2024-10-28,9207
00752,中信中國50,6,0,6,凱基-永和,2024-10-28,9207
00725B,國泰投資級公司債,6,0,6,凱基-永和,2024-10-28,9207
2399,映泰,13,7,6,凱基-永和,2024-10-28,9207
2442,新美齊,6,0,6,凱基-永和,2024-10-28,9207
3605,宏致,6,0,6,凱基-永和,2024-10-28,9207
4919,新唐,8,2,6,凱基-永和,2024-10-28,9207
2002,中鋼,6,0,6,凱基-永和,2024-10-28,9207
00929,復華台灣科技優息,7,2,5,凱基-永和,2024-10-28,9207
00720B,元大投資級公司債,5,0,5,凱基-永和,2024-10-28,9207
00753L,中信中國50正2,5,0,5,凱基-永和,2024-10-28,9207
00918,大華優利高填息30,5,0,5,凱基-永和,2024-10-28,9207
2495,普安,5,0,5,凱基-永和,2024-10-28,9207
00878,國泰永續高股息,130,0,130,凱基-永和,2024-10-29,9207
00919,群益台灣精選高息,67,15,52,凱基-永和,2024-10-29,9207
00929,復華台灣科技優息,53,2,51,凱基-永和,2024-10-29,9207
2891,中信金,43,0,43,凱基-永和,2024-10-29,9207
1447,力鵬,40,0,40,凱基-永和,2024-10-29,9207
8249,菱光,52,13,39,凱基-永和,2024-10-29,9207
5488,松普,57,23,34,凱基-永和,2024-10-29,9207
0056,元大高股息,29,0,29,凱基-永和,2024-10-29,9207
00918,大華優利高填息30,26,0,26,凱基-永和,2024-10-29,9207
00715L,期街口布蘭特正2,27,1,26,凱基-永和,2024-10-29,9207
00738U,期元大道瓊白銀,26,1,25,凱基-永和,2024-10-29,9207
00881,國泰台灣5G+,24,0,24,凱基-永和,2024-10-29,9207
00940,元大台灣價值高息,32,10,22,凱基-永和,2024-10-29,9207
2413,環科,36,14,22,凱基-永和,2024-10-29,9207
00937B,群益ESG投等債20,22,0,22,凱基-永和,2024-10-29,9207
6451,訊芯-KY,23,3,20,凱基-永和,2024-10-29,9207
00902,中信電池及儲能,20,0,20,凱基-永和,2024-10-29,9207
1789,神隆,20,0,20,凱基-永和,2024-10-29,9207
3163,波若威,20,0,20,凱基-永和,2024-10-29,9207
4979,華星光,31,11,20,凱基-永和,2024-10-29,9207
00952,凱基台灣AI50,17,0,17,凱基-永和,2024-10-29,9207
00712,復華富時不動產,15,0,15,凱基-永和,2024-10-29,9207
2377,微星,30,15,15,凱基-永和,2024-10-29,9207
2359,所羅門,14,0,14,凱基-永和,2024-10-29,9207
3450,聯鈞,28,15,13,凱基-永和,2024-10-29,9207
2303,聯電,13,1,12,凱基-永和,2024-10-29,9207
00642U,期元大S＆P石油,11,0,11,凱基-永和,2024-10-29,9207
1309,台達化,11,0,11,凱基-永和,2024-10-29,9207
2618,長榮航,13,2,11,凱基-永和,2024-10-29,9207
2867,三商壽,11,0,11,凱基-永和,2024-10-29,9207
3715,定穎投控,21,10,11,凱基-永和,2024-10-29,9207
8107,大億金茂,13,2,11,凱基-永和,2024-10-29,9207
00725B,國泰投資級公司債,11,1,10,凱基-永和,2024-10-29,9207
1313,聯成,10,0,10,凱基-永和,2024-10-29,9207
1709,和益,10,0,10,凱基-永和,2024-10-29,9207
2426,鼎元,10,0,10,凱基-永和,2024-10-29,9207
2881C,富邦金丙特,10,0,10,凱基-永和,2024-10-29,9207
2897,王道銀行,10,0,10,凱基-永和,2024-10-29,9207
8105,凌巨,10,0,10,凱基-永和,2024-10-29,9207
0050,元大台灣50,13,3,10,凱基-永和,2024-10-29,9207
6505,台塑化,9,0,9,凱基-永和,2024-10-29,9207
3035,智原,10,2,8,凱基-永和,2024-10-29,9207
2353,宏��,7,0,7,凱基-永和,2024-10-29,9207
3388,崇越電,7,0,7,凱基-永和,2024-10-29,9207
2376,技嘉,6,0,6,凱基-永和,2024-10-29,9207
2431,聯昌,16,10,6,凱基-永和,2024-10-29,9207
4961,天鈺,6,0,6,凱基-永和,2024-10-29,9207
2421,建準,7,1,6,凱基-永和,2024-10-29,9207
3323,加百裕,6,0,6,凱基-永和,2024-10-29,9207
00639,富邦深100,6,1,5,凱基-永和,2024-10-29,9207
3013,晟銘電,229,6,223,凱基-永和,2024-10-30,9207
5488,松普,80,0,80,凱基-永和,2024-10-30,9207
2887,台新金,72,0,72,凱基-永和,2024-10-30,9207
00688L,國泰20年美債正2,50,0,50,凱基-永和,2024-10-30,9207
2354,鴻準,62,28,34,凱基-永和,2024-10-30,9207
00753L,中信中國50正2,33,0,33,凱基-永和,2024-10-30,9207
00940,元大台灣價值高息,19,0,19,凱基-永和,2024-10-30,9207
0056,元大高股息,18,0,18,凱基-永和,2024-10-30,9207
00878,國泰永續高股息,18,0,18,凱基-永和,2024-10-30,9207
00939,統一台灣高息動能,15,0,15,凱基-永和,2024-10-30,9207
2312,金寶,21,7,14,凱基-永和,2024-10-30,9207
00929,復華台灣科技優息,21,10,11,凱基-永和,2024-10-30,9207
00938,凱基優選30,11,0,11,凱基-永和,2024-10-30,9207
00752,中信中國50,12,1,11,凱基-永和,2024-10-30,9207
2405,輔信,17,7,10,凱基-永和,2024-10-30,9207
8070,長華*,12,2,10,凱基-永和,2024-10-30,9207
00919,群益台灣精選高息,27,18,9,凱基-永和,2024-10-30,9207
2303,聯電,10,1,9,凱基-永和,2024-10-30,9207
00637L,元大滬深300正2,22,13,9,凱基-永和,2024-10-30,9207
2489,瑞軒,10,1,9,凱基-永和,2024-10-30,9207
2646,星宇航空,12,3,9,凱基-永和,2024-10-30,9207
9105,泰金寶-DR,10,1,9,凱基-永和,2024-10-30,9207
00882,中信中國高股息,9,1,8,凱基-永和,2024-10-30,9207
3042,晶技,8,0,8,凱基-永和,2024-10-30,9207
9940,信義,10,2,8,凱基-永和,2024-10-30,9207
2915,潤泰全,7,0,7,凱基-永和,2024-10-30,9207
00918,大華優利高填息30,7,0,7,凱基-永和,2024-10-30,9207
00715L,期街口布蘭特正2,7,0,7,凱基-永和,2024-10-30,9207
00946,群益科技高息成長,6,0,6,凱基-永和,2024-10-30,9207
2421,建準,8,2,6,凱基-永和,2024-10-30,9207
8176,智捷,6,0,6,凱基-永和,2024-10-30,9207
3481,群創,7,2,5,凱基-永和,2024-10-30,9207
2327,國巨,9,4,5,凱基-永和,2024-10-30,9207
6180,橘子,5,0,5,凱基-永和,2024-10-30,9207
00675L,富邦臺灣加權正2,6,1,5,凱基-永和,2024-10-30,9207
2014,中鴻,5,0,5,凱基-永和,2024-10-30,9207
2365,昆盈,8,3,5,凱基-永和,2024-10-30,9207
2438,翔耀,5,0,5,凱基-永和,2024-10-30,9207
3041,揚智,5,0,5,凱基-永和,2024-10-30,9207
3693,營邦,5,0,5,凱基-永和,2024-10-30,9207
6239,力成,6,1,5,凱基-永和,2024-10-30,9207
3231,緯創,9,5,4,凱基-永和,2024-10-30,9207
00639,富邦深100,4,0,4,凱基-永和,2024-10-30,9207
00712,復華富時不動產,4,0,4,凱基-永和,2024-10-30,9207
2413,環科,4,0,4,凱基-永和,2024-10-30,9207
2486,一詮,85,81,4,凱基-永和,2024-10-30,9207
2929,淘帝-KY,4,0,4,凱基-永和,2024-10-30,9207
3689,湧德,5,1,4,凱基-永和,2024-10-30,9207
3707,漢磊,9,5,4,凱基-永和,2024-10-30,9207
9938,百和,4,0,4,凱基-永和,2024-10-30,9207
2883,凱基金,154,0,154,凱基-永和,2024-11-01,9207
2353,宏��,74,1,73,凱基-永和,2024-11-01,9207
00919,群益台灣精選高息,57,2,55,凱基-永和,2024-11-01,9207
3711,日月光投控,55,4,51,凱基-永和,2024-11-01,9207
00878,國泰永續高股息,49,0,49,凱基-永和,2024-11-01,9207
2317,鴻海,48,6,42,凱基-永和,2024-11-01,9207
00662,富邦NASDAQ,31,0,31,凱基-永和,2024-11-01,9207
00953B,群益優選非投等債,30,0,30,凱基-永和,2024-11-01,9207
1444,力麗,30,0,30,凱基-永和,2024-11-01,9207
2354,鴻準,45,20,25,凱基-永和,2024-11-01,9207
2348,海悅,22,0,22,凱基-永和,2024-11-01,9207
2337,旺宏,21,0,21,凱基-永和,2024-11-01,9207
2303,聯電,30,10,20,凱基-永和,2024-11-01,9207
00753L,中信中國50正2,20,1,19,凱基-永和,2024-11-01,9207
00933B,國泰10Y+金融債,16,0,16,凱基-永和,2024-11-01,9207
00929,復華台灣科技優息,20,5,15,凱基-永和,2024-11-01,9207
2483,百容,15,0,15,凱基-永和,2024-11-01,9207
9940,信義,13,0,13,凱基-永和,2024-11-01,9207
0056,元大高股息,17,5,12,凱基-永和,2024-11-01,9207
00922,國泰台灣領袖50,12,1,11,凱基-永和,2024-11-01,9207
2867,三商壽,11,0,11,凱基-永和,2024-11-01,9207
2891,中信金,12,1,11,凱基-永和,2024-11-01,9207
00665L,富邦�琤肭磪囓�2,10,0,10,凱基-永和,2024-11-01,9207
00958B,永豐ESG銀行債15,10,0,10,凱基-永和,2024-11-01,9207
00946,群益科技高息成長,11,2,9,凱基-永和,2024-11-01,9207
5488,松普,10,1,9,凱基-永和,2024-11-01,9207
8107,大億金茂,10,1,9,凱基-永和,2024-11-01,9207
2605,新興,8,0,8,凱基-永和,2024-11-01,9207
006208,富邦台50,7,0,7,凱基-永和,2024-11-01,9207
00940,元大台灣價值高息,7,1,6,凱基-永和,2024-11-01,9207
6202,盛群,6,0,6,凱基-永和,2024-11-01,9207
6274,台燿,13,7,6,凱基-永和,2024-11-01,9207
8111,立��,6,0,6,凱基-永和,2024-11-01,9207
5871,中租-KY,5,0,5,凱基-永和,2024-11-01,9207
00959B,大華投等美債15Y+,5,0,5,凱基-永和,2024-11-01,9207
2886,兆豐金,5,0,5,凱基-永和,2024-11-01,9207
5880,合庫金,5,0,5,凱基-永和,2024-11-01,9207
00752,中信中國50,5,0,5,凱基-永和,2024-11-01,9207
00882,中信中國高股息,5,0,5,凱基-永和,2024-11-01,9207
00955,中信日本商社,5,0,5,凱基-永和,2024-11-01,9207
1785,光洋科,7,2,5,凱基-永和,2024-11-01,9207
2887,台新金,5,0,5,凱基-永和,2024-11-01,9207
3149,正達,5,0,5,凱基-永和,2024-11-01,9207
3710,連展投控,5,0,5,凱基-永和,2024-11-01,9207
6869,雲豹能源,5,0,5,凱基-永和,2024-11-01,9207
8105,凌巨,5,0,5,凱基-永和,2024-11-01,9207
2313,華通,23,19,4,凱基-永和,2024-11-01,9207
2344,華邦電,4,0,4,凱基-永和,2024-11-01,9207
3563,牧德,4,0,4,凱基-永和,2024-11-01,9207
5386,青雲,4,0,4,凱基-永和,2024-11-01,9207
00958B,永豐ESG銀行債15,70,0,70,凱基-永和,2024-11-04,9207
00929,復華台灣科技優息,124,83,41,凱基-永和,2024-11-04,9207
00891,中信關鍵半導體,38,0,38,凱基-永和,2024-11-04,9207
00933B,國泰10Y+金融債,35,0,35,凱基-永和,2024-11-04,9207
1605,華新,33,0,33,凱基-永和,2024-11-04,9207
00927,群益半導體收益,26,0,26,凱基-永和,2024-11-04,9207
00679B,元大美債20年,31,5,26,凱基-永和,2024-11-04,9207
00932,兆豐永續高息等權,27,1,26,凱基-永和,2024-11-04,9207
00730,富邦臺灣優質高息,25,0,25,凱基-永和,2024-11-04,9207
00945B,凱基美國非投等債,22,0,22,凱基-永和,2024-11-04,9207
00882,中信中國高股息,20,0,20,凱基-永和,2024-11-04,9207
00725B,國泰投資級公司債,20,0,20,凱基-永和,2024-11-04,9207
6451,訊芯-KY,30,12,18,凱基-永和,2024-11-04,9207
00687B,國泰20年美債,24,10,14,凱基-永和,2024-11-04,9207
2303,聯電,20,7,13,凱基-永和,2024-11-04,9207
00751B,元大AAA至A公司債,13,0,13,凱基-永和,2024-11-04,9207
00919,群益台灣精選高息,29,17,12,凱基-永和,2024-11-04,9207
6101,寬魚國際,12,0,12,凱基-永和,2024-11-04,9207
00905,FT臺灣Smart,12,0,12,凱基-永和,2024-11-04,9207
00712,復華富時不動產,11,0,11,凱基-永和,2024-11-04,9207
4903,聯光通,14,3,11,凱基-永和,2024-11-04,9207
6456,GIS-KY,11,0,11,凱基-永和,2024-11-04,9207
00772B,中信高評級公司債,11,0,11,凱基-永和,2024-11-04,9207
1447,力鵬,10,0,10,凱基-永和,2024-11-04,9207
1711,永光,10,0,10,凱基-永和,2024-11-04,9207
1905,華紙,10,0,10,凱基-永和,2024-11-04,9207
5488,松普,10,0,10,凱基-永和,2024-11-04,9207
5905,南仁湖,10,0,10,凱基-永和,2024-11-04,9207
00878,國泰永續高股息,27,18,9,凱基-永和,2024-11-04,9207
2405,輔信,10,1,9,凱基-永和,2024-11-04,9207
2605,新興,10,1,9,凱基-永和,2024-11-04,9207
3189,景碩,10,1,9,凱基-永和,2024-11-04,9207
00953B,群益優選非投等債,7,0,7,凱基-永和,2024-11-04,9207
2329,華泰,15,8,7,凱基-永和,2024-11-04,9207
3013,晟銘電,7,0,7,凱基-永和,2024-11-04,9207
3019,亞光,8,1,7,凱基-永和,2024-11-04,9207
2421,建準,6,0,6,凱基-永和,2024-11-04,9207
2408,南亞科,5,0,5,凱基-永和,2024-11-04,9207
2646,星宇航空,7,2,5,凱基-永和,2024-11-04,9207
00688L,國泰20年美債正2,5,0,5,凱基-永和,2024-11-04,9207
00934,中信成長高股息,5,0,5,凱基-永和,2024-11-04,9207
2328,廣宇,5,0,5,凱基-永和,2024-11-04,9207
2392,正崴,5,0,5,凱基-永和,2024-11-04,9207
2731,雄獅,5,0,5,凱基-永和,2024-11-04,9207
6757,台灣虎航,5,0,5,凱基-永和,2024-11-04,9207
2337,旺宏,4,0,4,凱基-永和,2024-11-04,9207
2409,友達,4,0,4,凱基-永和,2024-11-04,9207
00881,國泰台灣5G+,9,5,4,凱基-永和,2024-11-04,9207
00720B,元大投資級公司債,4,0,4,凱基-永和,2024-11-04,9207
3701,大眾控,11,7,4,凱基-永和,2024-11-04,9207
3450,聯鈞,408,29,379,凱基-永和,2024-11-05,9207
00688L,國泰20年美債正2,30,0,30,凱基-永和,2024-11-05,9207
2413,環科,28,2,26,凱基-永和,2024-11-05,9207
1436,華友聯,25,0,25,凱基-永和,2024-11-05,9207
00712,復華富時不動產,22,0,22,凱基-永和,2024-11-05,9207
2303,聯電,30,9,21,凱基-永和,2024-11-05,9207
00937B,群益ESG投等債20,21,0,21,凱基-永和,2024-11-05,9207
00887,永豐中國科技50大,20,1,19,凱基-永和,2024-11-05,9207
00680L,元大美債20正2,16,0,16,凱基-永和,2024-11-05,9207
00878,國泰永續高股息,20,5,15,凱基-永和,2024-11-05,9207
00637L,元大滬深300正2,14,3,11,凱基-永和,2024-11-05,9207
2399,映泰,41,31,10,凱基-永和,2024-11-05,9207
2464,盟立,11,1,10,凱基-永和,2024-11-05,9207
4919,新唐,10,1,9,凱基-永和,2024-11-05,9207
9105,泰金寶-DR,10,1,9,凱基-永和,2024-11-05,9207
00738U,期元大道瓊白銀,8,0,8,凱基-永和,2024-11-05,9207
3219,倚強科,8,0,8,凱基-永和,2024-11-05,9207
4743,合一,8,0,8,凱基-永和,2024-11-05,9207
00923,群益台ESG低碳50,7,0,7,凱基-永和,2024-11-05,9207
00915,凱基優選高股息30,7,0,7,凱基-永和,2024-11-05,9207
0056,元大高股息,12,5,7,凱基-永和,2024-11-05,9207
00932,兆豐永續高息等權,7,0,7,凱基-永和,2024-11-05,9207
00946,群益科技高息成長,6,0,6,凱基-永和,2024-11-05,9207
2324,仁寶,25,19,6,凱基-永和,2024-11-05,9207
6196,帆宣,6,0,6,凱基-永和,2024-11-05,9207
8091,翔名,6,0,6,凱基-永和,2024-11-05,9207
9914,美利達,5,0,5,凱基-永和,2024-11-05,9207
2467,志聖,5,0,5,凱基-永和,2024-11-05,9207
2408,南亞科,5,0,5,凱基-永和,2024-11-05,9207
00650L,復華香港正2,5,0,5,凱基-永和,2024-11-05,9207
00662,富邦NASDAQ,5,0,5,凱基-永和,2024-11-05,9207
2483,百容,5,0,5,凱基-永和,2024-11-05,9207
2492,華新科,5,0,5,凱基-永和,2024-11-05,9207
2493,揚博,5,0,5,凱基-永和,2024-11-05,9207
3413,京鼎,5,0,5,凱基-永和,2024-11-05,9207
4105,東洋,5,0,5,凱基-永和,2024-11-05,9207
4432,銘旺實,5,0,5,凱基-永和,2024-11-05,9207
6109,亞元,5,0,5,凱基-永和,2024-11-05,9207
6129,普誠,5,0,5,凱基-永和,2024-11-05,9207
6180,橘子,5,0,5,凱基-永和,2024-11-05,9207
6695,芯鼎,5,0,5,凱基-永和,2024-11-05,9207
00830,國泰費城半導體,58,54,4,凱基-永和,2024-11-05,9207
00882,中信中國高股息,13,9,4,凱基-永和,2024-11-05,9207
00934,中信成長高股息,4,0,4,凱基-永和,2024-11-05,9207
2348,海悅,4,0,4,凱基-永和,2024-11-05,9207
2369,菱生,4,0,4,凱基-永和,2024-11-05,9207
2497,怡利電,4,0,4,凱基-永和,2024-11-05,9207
3083,網龍,4,0,4,凱基-永和,2024-11-05,9207
4938,和碩,4,0,4,凱基-永和,2024-11-05,9207
2317,鴻海,12,8,4,凱基-永和,2024-11-05,9207
2449,京元電子,245,9,236,凱基-永和,2024-11-06,9207
2382,廣達,118,2,116,凱基-永和,2024-11-06,9207
2014,中鴻,104,2,102,凱基-永和,2024-11-06,9207
5347,世界,100,1,99,凱基-永和,2024-11-06,9207
00687B,國泰20年美債,72,2,70,凱基-永和,2024-11-06,9207
00679B,元大美債20年,57,1,56,凱基-永和,2024-11-06,9207
2330,台積電,61,10,51,凱基-永和,2024-11-06,9207
3324,雙鴻,43,1,42,凱基-永和,2024-11-06,9207
00915,凱基優選高股息30,26,0,26,凱基-永和,2024-11-06,9207
2328,廣宇,21,0,21,凱基-永和,2024-11-06,9207
2317,鴻海,35,15,20,凱基-永和,2024-11-06,9207
00878,國泰永續高股息,28,12,16,凱基-永和,2024-11-06,9207
00923,群益台ESG低碳50,14,0,14,凱基-永和,2024-11-06,9207
00688L,國泰20年美債正2,14,0,14,凱基-永和,2024-11-06,9207
8255,朋程,14,0,14,凱基-永和,2024-11-06,9207
00637L,元大滬深300正2,18,5,13,凱基-永和,2024-11-06,9207
4919,新唐,20,9,11,凱基-永和,2024-11-06,9207
0056,元大高股息,15,4,11,凱基-永和,2024-11-06,9207
00671R,富邦NASDAQ反1,10,0,10,凱基-永和,2024-11-06,9207
4123,晟德,10,0,10,凱基-永和,2024-11-06,9207
1536,和大,10,1,9,凱基-永和,2024-11-06,9207
00919,群益台灣精選高息,12,3,9,凱基-永和,2024-11-06,9207
6117,迎廣,8,0,8,凱基-永和,2024-11-06,9207
2615,萬海,14,7,7,凱基-永和,2024-11-06,9207
2348,海悅,7,0,7,凱基-永和,2024-11-06,9207
2413,環科,7,0,7,凱基-永和,2024-11-06,9207
8176,智捷,7,0,7,凱基-永和,2024-11-06,9207
00751B,元大AAA至A公司債,6,0,6,凱基-永和,2024-11-06,9207
00857B,永豐20年美公債,6,0,6,凱基-永和,2024-11-06,9207
00844B,新光15年IG金融債,6,0,6,凱基-永和,2024-11-06,9207
2913,農林,6,0,6,凱基-永和,2024-11-06,9207
6101,寬魚國際,6,0,6,凱基-永和,2024-11-06,9207
00713,元大台灣高息低波,5,0,5,凱基-永和,2024-11-06,9207
2915,潤泰全,5,0,5,凱基-永和,2024-11-06,9207
3583,辛耘,5,0,5,凱基-永和,2024-11-06,9207
00725B,國泰投資級公司債,5,0,5,凱基-永和,2024-11-06,9207
00960,野村全球航運龍頭,5,0,5,凱基-永和,2024-11-06,9207
1301,台塑,5,0,5,凱基-永和,2024-11-06,9207
2314,台揚,5,0,5,凱基-永和,2024-11-06,9207
2338,光罩,5,0,5,凱基-永和,2024-11-06,9207
2891,中信金,5,0,5,凱基-永和,2024-11-06,9207
4510,高鋒,7,2,5,凱基-永和,2024-11-06,9207
6216,居易,6,1,5,凱基-永和,2024-11-06,9207
6438,迅得,5,0,5,凱基-永和,2024-11-06,9207
2303,聯電,17,12,5,凱基-永和,2024-11-06,9207
3714,富采,5,0,5,凱基-永和,2024-11-06,9207
1513,中興電,6,2,4,凱基-永和,2024-11-06,9207
4743,合一,4,0,4,凱基-永和,2024-11-06,9207
00673R,期元大S＆P原油反1,4,0,4,凱基-永和,2024-11-06,9207
00932,兆豐永續高息等權,4,0,4,凱基-永和,2024-11-06,9207
2382,廣達,208,4,204,凱基-永和,2024-11-07,9207
3450,聯鈞,210,130,80,凱基-永和,2024-11-07,9207
2851,中再保,47,0,47,凱基-永和,2024-11-07,9207
2449,京元電子,61,18,43,凱基-永和,2024-11-07,9207
3013,晟銘電,42,2,40,凱基-永和,2024-11-07,9207
00688L,國泰20年美債正2,35,0,35,凱基-永和,2024-11-07,9207
3376,新日興,35,0,35,凱基-永和,2024-11-07,9207
2454,聯發科,30,0,30,凱基-永和,2024-11-07,9207
00878,國泰永續高股息,27,1,26,凱基-永和,2024-11-07,9207
00932,兆豐永續高息等權,20,0,20,凱基-永和,2024-11-07,9207
4760,勤凱,20,0,20,凱基-永和,2024-11-07,9207
2421,建準,23,4,19,凱基-永和,2024-11-07,9207
0056,元大高股息,23,8,15,凱基-永和,2024-11-07,9207
2413,環科,15,0,15,凱基-永和,2024-11-07,9207
2312,金寶,37,24,13,凱基-永和,2024-11-07,9207
2348,海悅,12,0,12,凱基-永和,2024-11-07,9207
4979,華星光,14,3,11,凱基-永和,2024-11-07,9207
1101,台泥,10,0,10,凱基-永和,2024-11-07,9207
1308,亞聚,10,0,10,凱基-永和,2024-11-07,9207
1402,遠東新,10,0,10,凱基-永和,2024-11-07,9207
1718,中纖,10,0,10,凱基-永和,2024-11-07,9207
6443,元晶,10,0,10,凱基-永和,2024-11-07,9207
2329,華泰,9,0,9,凱基-永和,2024-11-07,9207
5347,世界,10,1,9,凱基-永和,2024-11-07,9207
00713,元大台灣高息低波,7,0,7,凱基-永和,2024-11-07,9207
4958,臻鼎-KY,7,0,7,凱基-永和,2024-11-07,9207
2646,星宇航空,7,0,7,凱基-永和,2024-11-07,9207
6288,聯嘉,22,15,7,凱基-永和,2024-11-07,9207
3661,世芯-KY,6,0,6,凱基-永和,2024-11-07,9207
2401,凌陽,6,0,6,凱基-永和,2024-11-07,9207
00929,復華台灣科技優息,10,4,6,凱基-永和,2024-11-07,9207
1909,榮成,5,0,5,凱基-永和,2024-11-07,9207
2313,華通,13,8,5,凱基-永和,2024-11-07,9207
2636,台驊控股,7,2,5,凱基-永和,2024-11-07,9207
8070,長華*,4,0,4,凱基-永和,2024-11-07,9207
00687B,國泰20年美債,4,0,4,凱基-永和,2024-11-07,9207
1303,南亞,4,0,4,凱基-永和,2024-11-07,9207
2338,光罩,5,1,4,凱基-永和,2024-11-07,9207
2356,英業達,20,16,4,凱基-永和,2024-11-07,9207
2497,怡利電,4,0,4,凱基-永和,2024-11-07,9207
8261,富鼎,7,3,4,凱基-永和,2024-11-07,9207
9958,世紀鋼,4,0,4,凱基-永和,2024-11-07,9207
6821,聯寶,4,1,3,凱基-永和,2024-11-07,9207
2337,旺宏,3,0,3,凱基-永和,2024-11-07,9207
00631L,元大台灣50正2,3,0,3,凱基-永和,2024-11-07,9207
00725B,國泰投資級公司債,3,0,3,凱基-永和,2024-11-07,9207
00934,中信成長高股息,3,0,3,凱基-永和,2024-11-07,9207
2476,鉅祥,3,0,3,凱基-永和,2024-11-07,9207
2603,長榮,5,2,3,凱基-永和,2024-11-07,9207
2613,中櫃,5,2,3,凱基-永和,2024-11-07,9207
4979,華星光,261,8,253,凱基-永和,2024-11-08,9207
2486,一詮,81,13,68,凱基-永和,2024-11-08,9207
5531,鄉林,50,0,50,凱基-永和,2024-11-08,9207
00878,國泰永續高股息,56,8,48,凱基-永和,2024-11-08,9207
00680L,元大美債20正2,50,6,44,凱基-永和,2024-11-08,9207
3062,建漢,46,5,41,凱基-永和,2024-11-08,9207
3450,聯鈞,32,0,32,凱基-永和,2024-11-08,9207
00953B,群益優選非投等債,30,0,30,凱基-永和,2024-11-08,9207
2337,旺宏,30,1,29,凱基-永和,2024-11-08,9207
6456,GIS-KY,25,0,25,凱基-永和,2024-11-08,9207
4956,光鋐,22,0,22,凱基-永和,2024-11-08,9207
9105,泰金寶-DR,40,19,21,凱基-永和,2024-11-08,9207
00945B,凱基美國非投等債,20,0,20,凱基-永和,2024-11-08,9207
5488,松普,20,0,20,凱基-永和,2024-11-08,9207
2034,允強,19,0,19,凱基-永和,2024-11-08,9207
00637L,元大滬深300正2,24,6,18,凱基-永和,2024-11-08,9207
3011,今皓,17,0,17,凱基-永和,2024-11-08,9207
1101,台泥,20,5,15,凱基-永和,2024-11-08,9207
1402,遠東新,15,0,15,凱基-永和,2024-11-08,9207
6603,富強鑫,15,0,15,凱基-永和,2024-11-08,9207
5347,世界,14,0,14,凱基-永和,2024-11-08,9207
6757,台灣虎航,13,0,13,凱基-永和,2024-11-08,9207
3227,原相,22,10,12,凱基-永和,2024-11-08,9207
3260,威剛,12,0,12,凱基-永和,2024-11-08,9207
2431,聯昌,11,0,11,凱基-永和,2024-11-08,9207
2851,中再保,11,0,11,凱基-永和,2024-11-08,9207
2303,聯電,11,1,10,凱基-永和,2024-11-08,9207
2368,金像電,10,0,10,凱基-永和,2024-11-08,9207
00930,永豐ESG低碳高息,10,0,10,凱基-永和,2024-11-08,9207
2353,宏��,10,0,10,凱基-永和,2024-11-08,9207
00882,中信中國高股息,10,1,9,凱基-永和,2024-11-08,9207
2409,友達,13,4,9,凱基-永和,2024-11-08,9207
00679B,元大美債20年,11,2,9,凱基-永和,2024-11-08,9207
2392,正崴,19,11,8,凱基-永和,2024-11-08,9207
3704,合勤控,11,3,8,凱基-永和,2024-11-08,9207
5483,中美晶,8,1,7,凱基-永和,2024-11-08,9207
2413,環科,7,0,7,凱基-永和,2024-11-08,9207
5452,佶優,7,0,7,凱基-永和,2024-11-08,9207
6125,廣運,7,0,7,凱基-永和,2024-11-08,9207
8926,台汽電,7,0,7,凱基-永和,2024-11-08,9207
2317,鴻海,21,15,6,凱基-永和,2024-11-08,9207
2324,仁寶,13,7,6,凱基-永和,2024-11-08,9207
2388,威盛,7,1,6,凱基-永和,2024-11-08,9207
2731,雄獅,6,0,6,凱基-永和,2024-11-08,9207
2887,台新金,6,0,6,凱基-永和,2024-11-08,9207
3029,零壹,6,0,6,凱基-永和,2024-11-08,9207
5876,上海商銀,7,1,6,凱基-永和,2024-11-08,9207
8176,智捷,6,0,6,凱基-永和,2024-11-08,9207
3037,欣興,12,7,5,凱基-永和,2024-11-08,9207
00631L,元大台灣50正2,5,0,5,凱基-永和,2024-11-08,9207
3013,晟銘電,171,12,159,凱基-永和,2024-11-11,9207
4956,光鋐,89,0,89,凱基-永和,2024-11-11,9207
6456,GIS-KY,75,0,75,凱基-永和,2024-11-11,9207
2462,良得電,60,0,60,凱基-永和,2024-11-11,9207
00891,中信關鍵半導體,40,0,40,凱基-永和,2024-11-11,9207
00878,國泰永續高股息,36,3,33,凱基-永和,2024-11-11,9207
1308,亞聚,30,0,30,凱基-永和,2024-11-11,9207
2883,凱基金,52,27,25,凱基-永和,2024-11-11,9207
00919,群益台灣精選高息,22,0,22,凱基-永和,2024-11-11,9207
00725B,國泰投資級公司債,22,0,22,凱基-永和,2024-11-11,9207
2312,金寶,23,1,22,凱基-永和,2024-11-11,9207
00930,永豐ESG低碳高息,21,0,21,凱基-永和,2024-11-11,9207
1718,中纖,20,0,20,凱基-永和,2024-11-11,9207
00713,元大台灣高息低波,14,0,14,凱基-永和,2024-11-11,9207
00715L,期街口布蘭特正2,13,0,13,凱基-永和,2024-11-11,9207
1605,華新,12,0,12,凱基-永和,2024-11-11,9207
2376,技嘉,11,0,11,凱基-永和,2024-11-11,9207
00850,元大臺灣ESG永續,11,0,11,凱基-永和,2024-11-11,9207
3037,欣興,21,11,10,凱基-永和,2024-11-11,9207
00881,國泰台灣5G+,10,0,10,凱基-永和,2024-11-11,9207
1402,遠東新,10,0,10,凱基-永和,2024-11-11,9207
3419,譁裕,10,0,10,凱基-永和,2024-11-11,9207
9105,泰金寶-DR,10,0,10,凱基-永和,2024-11-11,9207
4916,事欣科,10,0,10,凱基-永和,2024-11-11,9207
00687B,國泰20年美債,14,5,9,凱基-永和,2024-11-11,9207
00665L,富邦�琤肭磪囓�2,139,130,9,凱基-永和,2024-11-11,9207
2609,陽明,16,7,9,凱基-永和,2024-11-11,9207
1449,佳和,12,3,9,凱基-永和,2024-11-11,9207
00900,富邦特選高股息30,8,0,8,凱基-永和,2024-11-11,9207
6223,旺矽,8,0,8,凱基-永和,2024-11-11,9207
2303,聯電,10,3,7,凱基-永和,2024-11-11,9207
00752,中信中國50,7,0,7,凱基-永和,2024-11-11,9207
2349,錸德,10,3,7,凱基-永和,2024-11-11,9207
4105,東洋,7,0,7,凱基-永和,2024-11-11,9207
8011,台通,7,0,7,凱基-永和,2024-11-11,9207
00751B,元大AAA至A公司債,6,0,6,凱基-永和,2024-11-11,9207
00688L,國泰20年美債正2,6,0,6,凱基-永和,2024-11-11,9207
2641,正德,6,0,6,凱基-永和,2024-11-11,9207
2887,台新金,6,0,6,凱基-永和,2024-11-11,9207
2929,淘帝-KY,6,0,6,凱基-永和,2024-11-11,9207
3035,智原,7,1,6,凱基-永和,2024-11-11,9207
8261,富鼎,6,0,6,凱基-永和,2024-11-11,9207
2317,鴻海,14,9,5,凱基-永和,2024-11-11,9207
9921,巨大,5,0,5,凱基-永和,2024-11-11,9207
8936,國統,5,0,5,凱基-永和,2024-11-11,9207
00922,國泰台灣領袖50,5,0,5,凱基-永和,2024-11-11,9207
00945B,凱基美國非投等債,5,0,5,凱基-永和,2024-11-11,9207
1447,力鵬,5,0,5,凱基-永和,2024-11-11,9207
1722,台肥,5,0,5,凱基-永和,2024-11-11,9207
2646,星宇航空,8,3,5,凱基-永和,2024-11-11,9207
6456,GIS-KY,175,0,175,凱基-永和,2024-11-12,9207
0056,元大高股息,77,0,77,凱基-永和,2024-11-12,9207
9945,潤泰新,53,0,53,凱基-永和,2024-11-12,9207
2634,漢翔,41,0,41,凱基-永和,2024-11-12,9207
00878,國泰永續高股息,100,60,40,凱基-永和,2024-11-12,9207
2455,全新,39,1,38,凱基-永和,2024-11-12,9207
00929,復華台灣科技優息,36,2,34,凱基-永和,2024-11-12,9207
2002,中鋼,35,4,31,凱基-永和,2024-11-12,9207
2915,潤泰全,41,11,30,凱基-永和,2024-11-12,9207
2356,英業達,34,5,29,凱基-永和,2024-11-12,9207
00708L,期元大S＆P黃金正2,25,0,25,凱基-永和,2024-11-12,9207
00940,元大台灣價值高息,22,0,22,凱基-永和,2024-11-12,9207
00891,中信關鍵半導體,21,0,21,凱基-永和,2024-11-12,9207
2882,國泰金,22,1,21,凱基-永和,2024-11-12,9207
2883,凱基金,21,0,21,凱基-永和,2024-11-12,9207
2332,友訊,21,0,21,凱基-永和,2024-11-12,9207
00881,國泰台灣5G+,20,0,20,凱基-永和,2024-11-12,9207
2317,鴻海,24,4,20,凱基-永和,2024-11-12,9207
2609,陽明,42,25,17,凱基-永和,2024-11-12,9207
2929,淘帝-KY,16,0,16,凱基-永和,2024-11-12,9207
00715L,期街口布蘭特正2,15,0,15,凱基-永和,2024-11-12,9207
00687B,國泰20年美債,22,7,15,凱基-永和,2024-11-12,9207
2314,台揚,15,0,15,凱基-永和,2024-11-12,9207
1314,中石化,14,0,14,凱基-永和,2024-11-12,9207
00915,凱基優選高股息30,14,0,14,凱基-永和,2024-11-12,9207
2887,台新金,14,1,13,凱基-永和,2024-11-12,9207
00934,中信成長高股息,12,0,12,凱基-永和,2024-11-12,9207
2312,金寶,33,21,12,凱基-永和,2024-11-12,9207
3047,訊舟,12,0,12,凱基-永和,2024-11-12,9207
2408,南亞科,12,1,11,凱基-永和,2024-11-12,9207
2353,宏��,11,0,11,凱基-永和,2024-11-12,9207
6125,廣運,11,0,11,凱基-永和,2024-11-12,9207
6223,旺矽,10,0,10,凱基-永和,2024-11-12,9207
5871,中租-KY,10,0,10,凱基-永和,2024-11-12,9207
2615,萬海,17,7,10,凱基-永和,2024-11-12,9207
2897,王道銀行,10,0,10,凱基-永和,2024-11-12,9207
2913,農林,10,0,10,凱基-永和,2024-11-12,9207
0050,元大台灣50,12,2,10,凱基-永和,2024-11-12,9207
2834,臺企銀,8,0,8,凱基-永和,2024-11-12,9207
2313,華通,8,0,8,凱基-永和,2024-11-12,9207
00688L,國泰20年美債正2,7,0,7,凱基-永和,2024-11-12,9207
2324,仁寶,7,0,7,凱基-永和,2024-11-12,9207
00753L,中信中國50正2,6,0,6,凱基-永和,2024-11-12,9207
00943,兆豐電子高息等權,6,0,6,凱基-永和,2024-11-12,9207
1605,華新,6,0,6,凱基-永和,2024-11-12,9207
6443,元晶,6,0,6,凱基-永和,2024-11-12,9207
0052,富邦科技,5,0,5,凱基-永和,2024-11-12,9207
2906,高林,5,0,5,凱基-永和,2024-11-12,9207
3663,鑫科,5,0,5,凱基-永和,2024-11-12,9207
3711,日月光投控,5,0,5,凱基-永和,2024-11-12,9207
00918,大華優利高填息30,77,0,77,凱基-永和,2024-11-13,9207
00878,國泰永續高股息,73,0,73,凱基-永和,2024-11-13,9207
0056,元大高股息,55,0,55,凱基-永和,2024-11-13,9207
2887,台新金,41,0,41,凱基-永和,2024-11-13,9207
00688L,國泰20年美債正2,40,0,40,凱基-永和,2024-11-13,9207
2603,長榮,37,0,37,凱基-永和,2024-11-13,9207
00632R,元大台灣50反1,37,0,37,凱基-永和,2024-11-13,9207
00945B,凱基美國非投等債,34,0,34,凱基-永和,2024-11-13,9207
2834,臺企銀,33,0,33,凱基-永和,2024-11-13,9207
2303,聯電,29,2,27,凱基-永和,2024-11-13,9207
3338,泰碩,28,2,26,凱基-永和,2024-11-13,9207
00713,元大台灣高息低波,29,3,26,凱基-永和,2024-11-13,9207
00932,兆豐永續高息等權,23,0,23,凱基-永和,2024-11-13,9207
00679B,元大美債20年,17,0,17,凱基-永和,2024-11-13,9207
2316,楠梓電,19,2,17,凱基-永和,2024-11-13,9207
2883,凱基金,18,1,17,凱基-永和,2024-11-13,9207
2882,國泰金,19,4,15,凱基-永和,2024-11-13,9207
3701,大眾控,15,0,15,凱基-永和,2024-11-13,9207
8240,華宏,15,0,15,凱基-永和,2024-11-13,9207
00882,中信中國高股息,17,3,14,凱基-永和,2024-11-13,9207
00915,凱基優選高股息30,14,0,14,凱基-永和,2024-11-13,9207
006208,富邦台50,14,1,13,凱基-永和,2024-11-13,9207
2890,永豐金,11,0,11,凱基-永和,2024-11-13,9207
2881,富邦金,13,3,10,凱基-永和,2024-11-13,9207
1446,宏和,10,0,10,凱基-永和,2024-11-13,9207
8104,錸寶,10,0,10,凱基-永和,2024-11-13,9207
1216,統一,8,0,8,凱基-永和,2024-11-13,9207
1708,東鹼,43,35,8,凱基-永和,2024-11-13,9207
3583,辛耘,11,3,8,凱基-永和,2024-11-13,9207
4967,十銓,8,0,8,凱基-永和,2024-11-13,9207
3481,群創,7,0,7,凱基-永和,2024-11-13,9207
00922,國泰台灣領袖50,7,0,7,凱基-永和,2024-11-13,9207
00753L,中信中國50正2,8,1,7,凱基-永和,2024-11-13,9207
4162,智擎,8,1,7,凱基-永和,2024-11-13,9207
6133,金橋,10,3,7,凱基-永和,2024-11-13,9207
2884,玉山金,7,0,7,凱基-永和,2024-11-13,9207
2888,新光金,6,0,6,凱基-永和,2024-11-13,9207
8011,台通,15,9,6,凱基-永和,2024-11-13,9207
00740B,富邦全球投等債,5,0,5,凱基-永和,2024-11-13,9207
2066,世德,5,0,5,凱基-永和,2024-11-13,9207
2323,中環,5,0,5,凱基-永和,2024-11-13,9207
2438,翔耀,5,0,5,凱基-永和,2024-11-13,9207
2614,東森,5,0,5,凱基-永和,2024-11-13,9207
3141,晶宏,11,6,5,凱基-永和,2024-11-13,9207
3558,神準,7,2,5,凱基-永和,2024-11-13,9207
8107,大億金茂,5,0,5,凱基-永和,2024-11-13,9207
00850,元大臺灣ESG永續,4,0,4,凱基-永和,2024-11-13,9207
00752,中信中國50,4,0,4,凱基-永和,2024-11-13,9207
1785,光洋科,5,1,4,凱基-永和,2024-11-13,9207
2105,正新,4,0,4,凱基-永和,2024-11-13,9207
3706,神達,745,377,368,凱基-永和,2024-11-14,9207
00878,國泰永續高股息,148,5,143,凱基-永和,2024-11-14,9207
2851,中再保,61,0,61,凱基-永和,2024-11-14,9207
0056,元大高股息,55,0,55,凱基-永和,2024-11-14,9207
4979,華星光,31,1,30,凱基-永和,2024-11-14,9207
5880,合庫金,30,0,30,凱基-永和,2024-11-14,9207
00946,群益科技高息成長,30,1,29,凱基-永和,2024-11-14,9207
2303,聯電,28,0,28,凱基-永和,2024-11-14,9207
00688L,國泰20年美債正2,27,0,27,凱基-永和,2024-11-14,9207
00676R,富邦臺灣加權反1,25,0,25,凱基-永和,2024-11-14,9207
2312,金寶,41,16,25,凱基-永和,2024-11-14,9207
2323,中環,21,0,21,凱基-永和,2024-11-14,9207
00632R,元大台灣50反1,20,0,20,凱基-永和,2024-11-14,9207
3231,緯創,20,4,16,凱基-永和,2024-11-14,9207
3090,日電貿,20,5,15,凱基-永和,2024-11-14,9207
2618,長榮航,22,8,14,凱基-永和,2024-11-14,9207
00679B,元大美債20年,13,0,13,凱基-永和,2024-11-14,9207
2324,仁寶,32,19,13,凱基-永和,2024-11-14,9207
00919,群益台灣精選高息,14,1,13,凱基-永和,2024-11-14,9207
1314,中石化,12,0,12,凱基-永和,2024-11-14,9207
3707,漢磊,11,0,11,凱基-永和,2024-11-14,9207
9945,潤泰新,11,0,11,凱基-永和,2024-11-14,9207
2915,潤泰全,11,1,10,凱基-永和,2024-11-14,9207
5871,中租-KY,11,0,11,凱基-永和,2024-11-14,9207
00712,復華富時不動產,10,0,10,凱基-永和,2024-11-14,9207
00924,復華S＆P500成長,10,0,10,凱基-永和,2024-11-14,9207
3645,達邁,10,0,10,凱基-永和,2024-11-14,9207
6603,富強鑫,10,0,10,凱基-永和,2024-11-14,9207
6754,匯僑設計,10,0,10,凱基-永和,2024-11-14,9207
2392,正崴,12,2,10,凱基-永和,2024-11-14,9207
2317,鴻海,17,7,10,凱基-永和,2024-11-14,9207
00751B,元大AAA至A公司債,9,0,9,凱基-永和,2024-11-14,9207
4968,立積,11,2,9,凱基-永和,2024-11-14,9207
1319,東陽,8,0,8,凱基-永和,2024-11-14,9207
8089,康全電訊,8,0,8,凱基-永和,2024-11-14,9207
0050,元大台灣50,8,0,8,凱基-永和,2024-11-14,9207
2316,楠梓電,13,6,7,凱基-永和,2024-11-14,9207
3227,原相,12,5,7,凱基-永和,2024-11-14,9207
006208,富邦台50,7,0,7,凱基-永和,2024-11-14,9207
1591,駿吉-KY,8,2,6,凱基-永和,2024-11-14,9207
1301,台塑,8,3,5,凱基-永和,2024-11-14,9207
0052,富邦科技,5,0,5,凱基-永和,2024-11-14,9207
2066,世德,5,0,5,凱基-永和,2024-11-14,9207
2498,宏達電,5,0,5,凱基-永和,2024-11-14,9207
2883,凱基金,6,1,5,凱基-永和,2024-11-14,9207
3114,好德,5,0,5,凱基-永和,2024-11-14,9207
3558,神準,5,0,5,凱基-永和,2024-11-14,9207
4743,合一,5,0,5,凱基-永和,2024-11-14,9207
4746,台耀,6,1,5,凱基-永和,2024-11-14,9207
6456,GIS-KY,5,0,5,凱基-永和,2024-11-14,9207
2618,長榮航,1209,54,1155,凱基-永和,2024-11-15,9207
2354,鴻準,1701,1506,195,凱基-永和,2024-11-15,9207
00878,國泰永續高股息,120,6,114,凱基-永和,2024-11-15,9207
00679B,元大美債20年,51,1,50,凱基-永和,2024-11-15,9207
2349,錸德,50,4,46,凱基-永和,2024-11-15,9207
2376,技嘉,39,7,32,凱基-永和,2024-11-15,9207
3231,緯創,40,12,28,凱基-永和,2024-11-15,9207
2324,仁寶,63,35,28,凱基-永和,2024-11-15,9207
2520,冠德,21,0,21,凱基-永和,2024-11-15,9207
2317,鴻海,50,35,15,凱基-永和,2024-11-15,9207
2204,中華,12,1,11,凱基-永和,2024-11-15,9207
2887,台新金,11,0,11,凱基-永和,2024-11-15,9207
6285,啟��,11,0,11,凱基-永和,2024-11-15,9207
8104,錸寶,11,0,11,凱基-永和,2024-11-15,9207
00945B,凱基美國非投等債,10,0,10,凱基-永和,2024-11-15,9207
6188,廣明,10,0,10,凱基-永和,2024-11-15,9207
8040,九暘,10,0,10,凱基-永和,2024-11-15,9207
2359,所羅門,10,1,9,凱基-永和,2024-11-15,9207
1301,台塑,11,3,8,凱基-永和,2024-11-15,9207
2891,中信金,11,3,8,凱基-永和,2024-11-15,9207
2483,百容,7,0,7,凱基-永和,2024-11-15,9207
2882,國泰金,9,2,7,凱基-永和,2024-11-15,9207
2615,萬海,10,4,6,凱基-永和,2024-11-15,9207
2316,楠梓電,6,0,6,凱基-永和,2024-11-15,9207
3227,原相,21,15,6,凱基-永和,2024-11-15,9207
2457,飛宏,6,0,6,凱基-永和,2024-11-15,9207
0050,元大台灣50,5,0,5,凱基-永和,2024-11-15,9207
00830,國泰費城半導體,59,54,5,凱基-永和,2024-11-15,9207
2303,聯電,10,5,5,凱基-永和,2024-11-15,9207
00900,富邦特選高股息30,5,0,5,凱基-永和,2024-11-15,9207
00725B,國泰投資級公司債,5,0,5,凱基-永和,2024-11-15,9207
00720B,元大投資級公司債,5,0,5,凱基-永和,2024-11-15,9207
00643,群益深証中小,5,0,5,凱基-永和,2024-11-15,9207
2543,皇昌,5,0,5,凱基-永和,2024-11-15,9207
3558,神準,5,0,5,凱基-永和,2024-11-15,9207
6109,亞元,5,0,5,凱基-永和,2024-11-15,9207
3211,順達,5,0,5,凱基-永和,2024-11-15,9207
3017,奇鋐,13,9,4,凱基-永和,2024-11-15,9207
00665L,富邦�琤肭磪囓�2,4,0,4,凱基-永和,2024-11-15,9207
0056,元大高股息,6,2,4,凱基-永和,2024-11-15,9207
2356,英業達,5,1,4,凱基-永和,2024-11-15,9207
2486,一詮,5,1,4,凱基-永和,2024-11-15,9207
3045,台灣大,4,0,4,凱基-永和,2024-11-15,9207
2382,廣達,35,31,4,凱基-永和,2024-11-15,9207
2330,台積電,3,0,3,凱基-永和,2024-11-15,9207
00915,凱基優選高股息30,3,0,3,凱基-永和,2024-11-15,9207
00937B,群益ESG投等債20,5,2,3,凱基-永和,2024-11-15,9207
00650L,復華香港正2,3,0,3,凱基-永和,2024-11-15,9207
00697B,元大美債7-10,3,0,3,凱基-永和,2024-11-15,9207
00680L,元大美債20正2,3,0,3,凱基-永和,2024-11-15,9207
3481,群創,152,0,152,凱基-永和,2024-11-18,9207
00878,國泰永續高股息,163,30,133,凱基-永和,2024-11-18,9207
00795B,中信美國公債20年,116,0,116,凱基-永和,2024-11-18,9207
4956,光鋐,75,0,75,凱基-永和,2024-11-18,9207
6456,GIS-KY,70,0,70,凱基-永和,2024-11-18,9207
2888,新光金,67,0,67,凱基-永和,2024-11-18,9207
00713,元大台灣高息低波,51,0,51,凱基-永和,2024-11-18,9207
00929,復華台灣科技優息,31,0,31,凱基-永和,2024-11-18,9207
1785,光洋科,30,0,30,凱基-永和,2024-11-18,9207
00948B,中信優息投資級債,30,0,30,凱基-永和,2024-11-18,9207
3689,湧德,30,0,30,凱基-永和,2024-11-18,9207
2312,金寶,57,33,24,凱基-永和,2024-11-18,9207
00679B,元大美債20年,20,0,20,凱基-永和,2024-11-18,9207
6770,力積電,18,0,18,凱基-永和,2024-11-18,9207
00919,群益台灣精選高息,14,0,14,凱基-永和,2024-11-18,9207
1536,和大,13,0,13,凱基-永和,2024-11-18,9207
2618,長榮航,30,17,13,凱基-永和,2024-11-18,9207
4919,新唐,13,0,13,凱基-永和,2024-11-18,9207
0056,元大高股息,12,0,12,凱基-永和,2024-11-18,9207
5871,中租-KY,11,0,11,凱基-永和,2024-11-18,9207
00945B,凱基美國非投等債,11,0,11,凱基-永和,2024-11-18,9207
2881,富邦金,11,1,10,凱基-永和,2024-11-18,9207
2383,台光電,10,0,10,凱基-永和,2024-11-18,9207
6271,同欣電,11,1,10,凱基-永和,2024-11-18,9207
00715L,期街口布蘭特正2,10,0,10,凱基-永和,2024-11-18,9207
00642U,期元大S＆P石油,10,0,10,凱基-永和,2024-11-18,9207
00953B,群益優選非投等債,10,0,10,凱基-永和,2024-11-18,9207
2427,三商電,10,0,10,凱基-永和,2024-11-18,9207
2888A,新光金甲特,10,0,10,凱基-永和,2024-11-18,9207
2897,王道銀行,10,0,10,凱基-永和,2024-11-18,9207
3202,樺晟,10,0,10,凱基-永和,2024-11-18,9207
8040,九暘,10,0,10,凱基-永和,2024-11-18,9207
006208,富邦台50,9,0,9,凱基-永和,2024-11-18,9207
3037,欣興,10,1,9,凱基-永和,2024-11-18,9207
2027,大成鋼,10,1,9,凱基-永和,2024-11-18,9207
2329,華泰,9,1,8,凱基-永和,2024-11-18,9207
9105,泰金寶-DR,33,25,8,凱基-永和,2024-11-18,9207
2330,台積電,12,4,8,凱基-永和,2024-11-18,9207
3704,合勤控,10,3,7,凱基-永和,2024-11-18,9207
1101,台泥,7,1,6,凱基-永和,2024-11-18,9207
00757,統一FANG+,18,12,6,凱基-永和,2024-11-18,9207
00952,凱基台灣AI50,6,0,6,凱基-永和,2024-11-18,9207
2413,環科,6,0,6,凱基-永和,2024-11-18,9207
6584,南俊國際,6,0,6,凱基-永和,2024-11-18,9207
9942,茂順,6,0,6,凱基-永和,2024-11-18,9207
3374,精材,8,2,6,凱基-永和,2024-11-18,9207
3019,亞光,6,1,5,凱基-永和,2024-11-18,9207
00690,兆豐藍籌30,5,0,5,凱基-永和,2024-11-18,9207
00688L,國泰20年美債正2,5,0,5,凱基-永和,2024-11-18,9207
00731,復華富時高息低波,5,0,5,凱基-永和,2024-11-18,9207
2392,正崴,212,5,207,凱基-永和,2024-11-19,9207
3706,神達,214,41,173,凱基-永和,2024-11-19,9207
6456,GIS-KY,150,0,150,凱基-永和,2024-11-19,9207
8044,網家,126,22,104,凱基-永和,2024-11-19,9207
8028,昇陽半導體,100,4,96,凱基-永和,2024-11-19,9207
5203,訊連,53,0,53,凱基-永和,2024-11-19,9207
00795B,中信美國公債20年,51,0,51,凱基-永和,2024-11-19,9207
6438,迅得,50,0,50,凱基-永和,2024-11-19,9207
8996,高力,175,127,48,凱基-永和,2024-11-19,9207
2887,台新金,49,1,48,凱基-永和,2024-11-19,9207
2002,中鋼,30,0,30,凱基-永和,2024-11-19,9207
3533,嘉澤,31,1,30,凱基-永和,2024-11-19,9207
2382,廣達,27,0,27,凱基-永和,2024-11-19,9207
2332,友訊,33,7,26,凱基-永和,2024-11-19,9207
2888,新光金,25,0,25,凱基-永和,2024-11-19,9207
3499,環天科,20,0,20,凱基-永和,2024-11-19,9207
6770,力積電,18,0,18,凱基-永和,2024-11-19,9207
6763,綠界科技*,22,4,18,凱基-永和,2024-11-19,9207
3707,漢磊,16,0,16,凱基-永和,2024-11-19,9207
1718,中纖,15,0,15,凱基-永和,2024-11-19,9207
1314,中石化,12,0,12,凱基-永和,2024-11-19,9207
2646,星宇航空,12,0,12,凱基-永和,2024-11-19,9207
2324,仁寶,12,1,11,凱基-永和,2024-11-19,9207
2349,錸德,12,1,11,凱基-永和,2024-11-19,9207
3062,建漢,14,3,11,凱基-永和,2024-11-19,9207
00915,凱基優選高股息30,10,0,10,凱基-永和,2024-11-19,9207
5876,上海商銀,10,0,10,凱基-永和,2024-11-19,9207
1524,耿鼎,10,0,10,凱基-永和,2024-11-19,9207
5488,松普,10,0,10,凱基-永和,2024-11-19,9207
6246,臺龍,10,0,10,凱基-永和,2024-11-19,9207
6901,鑽石投資,9,0,9,凱基-永和,2024-11-19,9207
00687B,國泰20年美債,8,0,8,凱基-永和,2024-11-19,9207
2605,新興,11,3,8,凱基-永和,2024-11-19,9207
4577,達航科技,14,6,8,凱基-永和,2024-11-19,9207
5351,鈺創,8,0,8,凱基-永和,2024-11-19,9207
6129,普誠,8,0,8,凱基-永和,2024-11-19,9207
0050,元大台灣50,7,0,7,凱基-永和,2024-11-19,9207
2890,永豐金,7,0,7,凱基-永和,2024-11-19,9207
2427,三商電,6,0,6,凱基-永和,2024-11-19,9207
2431,聯昌,17,11,6,凱基-永和,2024-11-19,9207
6451,訊芯-KY,8,2,6,凱基-永和,2024-11-19,9207
00679B,元大美債20年,8,3,5,凱基-永和,2024-11-19,9207
3211,順達,6,1,5,凱基-永和,2024-11-19,9207
00633L,富邦上証正2,5,0,5,凱基-永和,2024-11-19,9207
00688L,國泰20年美債正2,5,0,5,凱基-永和,2024-11-19,9207
1301,台塑,5,0,5,凱基-永和,2024-11-19,9207
2439,美律,5,0,5,凱基-永和,2024-11-19,9207
2476,鉅祥,5,0,5,凱基-永和,2024-11-19,9207
2613,中櫃,6,1,5,凱基-永和,2024-11-19,9207
2330,台積電,6,1,5,凱基-永和,2024-11-19,9207
00953B,群益優選非投等債,998,0,998,凱基-永和,2024-11-20,9207
3015,全漢,201,12,189,凱基-永和,2024-11-20,9207
8104,錸寶,100,0,100,凱基-永和,2024-11-20,9207
9105,泰金寶-DR,134,40,94,凱基-永和,2024-11-20,9207
2329,華泰,91,0,91,凱基-永和,2024-11-20,9207
2354,鴻準,114,27,87,凱基-永和,2024-11-20,9207
2867,三商壽,70,0,70,凱基-永和,2024-11-20,9207
00929,復華台灣科技優息,43,0,43,凱基-永和,2024-11-20,9207
00676R,富邦臺灣加權反1,30,0,30,凱基-永和,2024-11-20,9207
00878,國泰永續高股息,34,10,24,凱基-永和,2024-11-20,9207
00930,永豐ESG低碳高息,22,0,22,凱基-永和,2024-11-20,9207
2337,旺宏,20,0,20,凱基-永和,2024-11-20,9207
3231,緯創,20,3,17,凱基-永和,2024-11-20,9207
2382,廣達,17,4,13,凱基-永和,2024-11-20,9207
6770,力積電,12,0,12,凱基-永和,2024-11-20,9207
2303,聯電,12,0,12,凱基-永和,2024-11-20,9207
2356,英業達,20,8,12,凱基-永和,2024-11-20,9207
00646,元大S＆P500,10,0,10,凱基-永和,2024-11-20,9207
1909,榮成,10,0,10,凱基-永和,2024-11-20,9207
2204,中華,11,1,10,凱基-永和,2024-11-20,9207
2457,飛宏,10,0,10,凱基-永和,2024-11-20,9207
3013,晟銘電,27,17,10,凱基-永和,2024-11-20,9207
3499,環天科,10,0,10,凱基-永和,2024-11-20,9207
5876,上海商銀,8,0,8,凱基-永和,2024-11-20,9207
3323,加百裕,9,1,8,凱基-永和,2024-11-20,9207
2915,潤泰全,14,7,7,凱基-永和,2024-11-20,9207
00662,富邦NASDAQ,7,0,7,凱基-永和,2024-11-20,9207
2338,光罩,7,0,7,凱基-永和,2024-11-20,9207
00901,永豐智能車供應鏈,6,0,6,凱基-永和,2024-11-20,9207
6109,亞元,6,0,6,凱基-永和,2024-11-20,9207
8070,長華*,6,0,6,凱基-永和,2024-11-20,9207
2317,鴻海,17,12,5,凱基-永和,2024-11-20,9207
5871,中租-KY,5,0,5,凱基-永和,2024-11-20,9207
1314,中石化,5,0,5,凱基-永和,2024-11-20,9207
2929,淘帝-KY,8,3,5,凱基-永和,2024-11-20,9207
6005,群益證,5,0,5,凱基-永和,2024-11-20,9207
2330,台積電,4,0,4,凱基-永和,2024-11-20,9207
3374,精材,5,1,4,凱基-永和,2024-11-20,9207
00918,大華優利高填息30,5,1,4,凱基-永和,2024-11-20,9207
2359,所羅門,4,0,4,凱基-永和,2024-11-20,9207
6763,綠界科技*,4,0,4,凱基-永和,2024-11-20,9207
00919,群益台灣精選高息,5,1,4,凱基-永和,2024-11-20,9207
2376,技嘉,4,1,3,凱基-永和,2024-11-20,9207
0050,元大台灣50,3,0,3,凱基-永和,2024-11-20,9207
00637L,元大滬深300正2,5,2,3,凱基-永和,2024-11-20,9207
00632R,元大台灣50反1,3,0,3,凱基-永和,2024-11-20,9207
2208,台船,3,0,3,凱基-永和,2024-11-20,9207
2312,金寶,4,1,3,凱基-永和,2024-11-20,9207
2324,仁寶,8,5,3,凱基-永和,2024-11-20,9207
2353,宏��,3,0,3,凱基-永和,2024-11-20,9207
4979,華星光,50,0,50,凱基-永和,2024-11-21,9207
5475,德宏,44,0,44,凱基-永和,2024-11-21,9207
00878,國泰永續高股息,34,0,34,凱基-永和,2024-11-21,9207
2332,友訊,28,2,26,凱基-永和,2024-11-21,9207
2317,鴻海,37,13,24,凱基-永和,2024-11-21,9207
00930,永豐ESG低碳高息,23,0,23,凱基-永和,2024-11-21,9207
2449,京元電子,20,0,20,凱基-永和,2024-11-21,9207
2867,三商壽,20,0,20,凱基-永和,2024-11-21,9207
3711,日月光投控,20,0,20,凱基-永和,2024-11-21,9207
00679B,元大美債20年,16,2,14,凱基-永和,2024-11-21,9207
00950B,凱基A級公司債,13,0,13,凱基-永和,2024-11-21,9207
2330,台積電,13,0,13,凱基-永和,2024-11-21,9207
0050,元大台灣50,13,0,13,凱基-永和,2024-11-21,9207
00901,永豐智能車供應鏈,10,0,10,凱基-永和,2024-11-21,9207
1218,泰山,10,0,10,凱基-永和,2024-11-21,9207
2323,中環,10,0,10,凱基-永和,2024-11-21,9207
2419,仲琦,10,0,10,凱基-永和,2024-11-21,9207
3006,晶豪科,10,0,10,凱基-永和,2024-11-21,9207
3483,力致,10,0,10,凱基-永和,2024-11-21,9207
3499,環天科,10,0,10,凱基-永和,2024-11-21,9207
6603,富強鑫,10,0,10,凱基-永和,2024-11-21,9207
2884,玉山金,11,1,10,凱基-永和,2024-11-21,9207
3013,晟銘電,23,14,9,凱基-永和,2024-11-21,9207
4105,東洋,9,0,9,凱基-永和,2024-11-21,9207
00830,國泰費城半導體,63,55,8,凱基-永和,2024-11-21,9207
0056,元大高股息,8,0,8,凱基-永和,2024-11-21,9207
6763,綠界科技*,8,0,8,凱基-永和,2024-11-21,9207
00929,復華台灣科技優息,23,16,7,凱基-永和,2024-11-21,9207
00919,群益台灣精選高息,7,0,7,凱基-永和,2024-11-21,9207
2891,中信金,8,1,7,凱基-永和,2024-11-21,9207
1536,和大,10,3,7,凱基-永和,2024-11-21,9207
2313,華通,7,0,7,凱基-永和,2024-11-21,9207
2834,臺企銀,10,3,7,凱基-永和,2024-11-21,9207
6505,台塑化,7,0,7,凱基-永和,2024-11-21,9207
00909,國泰數位支付服務,7,1,6,凱基-永和,2024-11-21,9207
00952,凱基台灣AI50,6,0,6,凱基-永和,2024-11-21,9207
5531,鄉林,8,2,6,凱基-永和,2024-11-21,9207
2308,台達電,5,0,5,凱基-永和,2024-11-21,9207
00712,復華富時不動產,5,0,5,凱基-永和,2024-11-21,9207
2605,新興,10,5,5,凱基-永和,2024-11-21,9207
5426,振發,9,4,5,凱基-永和,2024-11-21,9207
6109,亞元,5,0,5,凱基-永和,2024-11-21,9207
6279,胡連,5,0,5,凱基-永和,2024-11-21,9207
6451,訊芯-KY,5,0,5,凱基-永和,2024-11-21,9207
2382,廣達,7,2,5,凱基-永和,2024-11-21,9207
0052,富邦科技,4,0,4,凱基-永和,2024-11-21,9207
00918,大華優利高填息30,4,0,4,凱基-永和,2024-11-21,9207
1802,台玻,10,6,4,凱基-永和,2024-11-21,9207
2204,中華,52,48,4,凱基-永和,2024-11-21,9207
2338,光罩,4,0,4,凱基-永和,2024-11-21,9207
1815,富喬,2027,1013,1014,凱基-永和,2024-11-22,9207
1809,中釉,200,0,200,凱基-永和,2024-11-22,9207
2392,正崴,156,5,151,凱基-永和,2024-11-22,9207
3622,洋華,95,0,95,凱基-永和,2024-11-22,9207
6121,新普,70,0,70,凱基-永和,2024-11-22,9207
9105,泰金寶-DR,94,26,68,凱基-永和,2024-11-22,9207
6456,GIS-KY,60,0,60,凱基-永和,2024-11-22,9207
8114,振樺電,55,0,55,凱基-永和,2024-11-22,9207
3558,神準,50,1,49,凱基-永和,2024-11-22,9207
2890,永豐金,32,0,32,凱基-永和,2024-11-22,9207
00637L,元大滬深300正2,37,20,17,凱基-永和,2024-11-22,9207
6134,萬旭,17,0,17,凱基-永和,2024-11-22,9207
9928,中視,17,0,17,凱基-永和,2024-11-22,9207
2303,聯電,18,2,16,凱基-永和,2024-11-22,9207
2891,中信金,16,1,15,凱基-永和,2024-11-22,9207
2615,萬海,26,12,14,凱基-永和,2024-11-22,9207
6109,亞元,14,0,14,凱基-永和,2024-11-22,9207
00679B,元大美債20年,15,2,13,凱基-永和,2024-11-22,9207
00720B,元大投資級公司債,13,0,13,凱基-永和,2024-11-22,9207
3706,神達,437,425,12,凱基-永和,2024-11-22,9207
2324,仁寶,17,6,11,凱基-永和,2024-11-22,9207
4105,東洋,11,0,11,凱基-永和,2024-11-22,9207
5309,系統電,159,148,11,凱基-永和,2024-11-22,9207
5876,上海商銀,11,0,11,凱基-永和,2024-11-22,9207
00891,中信關鍵半導體,11,0,11,凱基-永和,2024-11-22,9207
00864B,中信美國公債0-1,10,0,10,凱基-永和,2024-11-22,9207
00945B,凱基美國非投等債,10,0,10,凱基-永和,2024-11-22,9207
00953B,群益優選非投等債,10,0,10,凱基-永和,2024-11-22,9207
2399,映泰,21,11,10,凱基-永和,2024-11-22,9207
2547,日勝生,10,0,10,凱基-永和,2024-11-22,9207
2609,陽明,23,13,10,凱基-永和,2024-11-22,9207
3290,東浦,11,1,10,凱基-永和,2024-11-22,9207
8261,富鼎,10,0,10,凱基-永和,2024-11-22,9207
2330,台積電,14,4,10,凱基-永和,2024-11-22,9207
3090,日電貿,10,1,9,凱基-永和,2024-11-22,9207
00662,富邦NASDAQ,8,0,8,凱基-永和,2024-11-22,9207
00960,野村全球航運龍頭,8,0,8,凱基-永和,2024-11-22,9207
2356,英業達,8,1,7,凱基-永和,2024-11-22,9207
2516,新建,7,0,7,凱基-永和,2024-11-22,9207
6152,百一,8,1,7,凱基-永和,2024-11-22,9207
6770,力積電,7,0,7,凱基-永和,2024-11-22,9207
00937B,群益ESG投等債20,6,0,6,凱基-永和,2024-11-22,9207
00950B,凱基A級公司債,7,1,6,凱基-永和,2024-11-22,9207
3498,陽程,6,0,6,凱基-永和,2024-11-22,9207
00725B,國泰投資級公司債,5,0,5,凱基-永和,2024-11-22,9207
00688L,國泰20年美債正2,5,0,5,凱基-永和,2024-11-22,9207
00673R,期元大S＆P原油反1,5,0,5,凱基-永和,2024-11-22,9207
2316,楠梓電,9,4,5,凱基-永和,2024-11-22,9207
2486,一詮,6,1,5,凱基-永和,2024-11-22,9207
3693,營邦,5,0,5,凱基-永和,2024-11-22,9207
4979,華星光,440,6,434,凱基-永和,2024-11-25,9207
3090,日電貿,350,3,347,凱基-永和,2024-11-25,9207
5309,系統電,300,8,292,凱基-永和,2024-11-25,9207
3380,明泰,200,0,200,凱基-永和,2024-11-25,9207
2392,正崴,716,544,172,凱基-永和,2024-11-25,9207
8044,網家,101,1,100,凱基-永和,2024-11-25,9207
8028,昇陽半導體,200,104,96,凱基-永和,2024-11-25,9207
8163,達方,86,9,77,凱基-永和,2024-11-25,9207
00878,國泰永續高股息,77,12,65,凱基-永和,2024-11-25,9207
00679B,元大美債20年,60,1,59,凱基-永和,2024-11-25,9207
2312,金寶,115,74,41,凱基-永和,2024-11-25,9207
8114,振樺電,40,0,40,凱基-永和,2024-11-25,9207
9105,泰金寶-DR,117,84,33,凱基-永和,2024-11-25,9207
2495,普安,30,0,30,凱基-永和,2024-11-25,9207
1806,冠軍,30,0,30,凱基-永和,2024-11-25,9207
00753L,中信中國50正2,21,0,21,凱基-永和,2024-11-25,9207
00738U,期元大道瓊白銀,20,0,20,凱基-永和,2024-11-25,9207
3711,日月光投控,20,0,20,凱基-永和,2024-11-25,9207
5475,德宏,20,0,20,凱基-永和,2024-11-25,9207
00909,國泰數位支付服務,21,3,18,凱基-永和,2024-11-25,9207
2455,全新,20,2,18,凱基-永和,2024-11-25,9207
2317,鴻海,36,20,16,凱基-永和,2024-11-25,9207
6109,亞元,15,0,15,凱基-永和,2024-11-25,9207
2915,潤泰全,13,0,13,凱基-永和,2024-11-25,9207
3481,群創,21,9,12,凱基-永和,2024-11-25,9207
5876,上海商銀,12,0,12,凱基-永和,2024-11-25,9207
00930,永豐ESG低碳高息,11,0,11,凱基-永和,2024-11-25,9207
00891,中信關鍵半導體,11,0,11,凱基-永和,2024-11-25,9207
2615,萬海,20,10,10,凱基-永和,2024-11-25,9207
00937B,群益ESG投等債20,10,0,10,凱基-永和,2024-11-25,9207
00636,國泰中國A50,10,0,10,凱基-永和,2024-11-25,9207
00673R,期元大S＆P原油反1,10,0,10,凱基-永和,2024-11-25,9207
3013,晟銘電,40,30,10,凱基-永和,2024-11-25,9207
5371,中光電,10,0,10,凱基-永和,2024-11-25,9207
8033,雷虎,10,0,10,凱基-永和,2024-11-25,9207
8104,錸寶,12,2,10,凱基-永和,2024-11-25,9207
00655L,國泰中國A50正2,10,1,9,凱基-永和,2024-11-25,9207
4919,新唐,10,1,9,凱基-永和,2024-11-25,9207
5531,鄉林,20,11,9,凱基-永和,2024-11-25,9207
2330,台積電,11,2,9,凱基-永和,2024-11-25,9207
2882,國泰金,10,2,8,凱基-永和,2024-11-25,9207
2603,長榮,9,0,9,凱基-永和,2024-11-25,9207
3701,大眾控,8,0,8,凱基-永和,2024-11-25,9207
6546,正基,8,0,8,凱基-永和,2024-11-25,9207
9945,潤泰新,7,0,7,凱基-永和,2024-11-25,9207
3548,兆利,7,1,6,凱基-永和,2024-11-25,9207
3005,神基,7,1,6,凱基-永和,2024-11-25,9207
4576,大銀微系統,6,0,6,凱基-永和,2024-11-25,9207
6209,今國光,6,0,6,凱基-永和,2024-11-25,9207
1528,恩德,10,5,5,凱基-永和,2024-11-25,9207
1536,和大,409,7,402,凱基-永和,2024-11-26,9207
4979,華星光,102,2,100,凱基-永和,2024-11-26,9207
2316,楠梓電,65,10,55,凱基-永和,2024-11-26,9207
2419,仲琦,31,0,31,凱基-永和,2024-11-26,9207
00929,復華台灣科技優息,26,6,20,凱基-永和,2024-11-26,9207
2891,中信金,24,5,19,凱基-永和,2024-11-26,9207
00940,元大台灣價值高息,19,0,19,凱基-永和,2024-11-26,9207
00939,統一台灣高息動能,20,2,18,凱基-永和,2024-11-26,9207
2312,金寶,32,15,17,凱基-永和,2024-11-26,9207
2317,鴻海,69,53,16,凱基-永和,2024-11-26,9207
2330,台積電,15,2,13,凱基-永和,2024-11-26,9207
00878,國泰永續高股息,30,18,12,凱基-永和,2024-11-26,9207
3548,兆利,10,0,10,凱基-永和,2024-11-26,9207
3231,緯創,28,20,8,凱基-永和,2024-11-26,9207
3625,西勝,8,0,8,凱基-永和,2024-11-26,9207
6451,訊芯-KY,8,0,8,凱基-永和,2024-11-26,9207
8028,昇陽半導體,8,0,8,凱基-永和,2024-11-26,9207
2915,潤泰全,7,0,7,凱基-永和,2024-11-26,9207
00715L,期街口布蘭特正2,7,0,7,凱基-永和,2024-11-26,9207
2886,兆豐金,11,4,7,凱基-永和,2024-11-26,9207
2801,彰銀,6,0,6,凱基-永和,2024-11-26,9207
3167,大量,7,1,6,凱基-永和,2024-11-26,9207
00918,大華優利高填息30,5,0,5,凱基-永和,2024-11-26,9207
1216,統一,5,0,5,凱基-永和,2024-11-26,9207
2354,鴻準,13,8,5,凱基-永和,2024-11-26,9207
2615,萬海,5,0,5,凱基-永和,2024-11-26,9207
6603,富強鑫,5,0,5,凱基-永和,2024-11-26,9207
8114,振樺電,5,0,5,凱基-永和,2024-11-26,9207
1402,遠東新,4,0,4,凱基-永和,2024-11-26,9207
2061,風青,4,0,4,凱基-永和,2024-11-26,9207
6109,亞元,4,0,4,凱基-永和,2024-11-26,9207
8040,九暘,4,0,4,凱基-永和,2024-11-26,9207
006208,富邦台50,4,0,4,凱基-永和,2024-11-26,9207
00881,國泰台灣5G+,3,0,3,凱基-永和,2024-11-26,9207
00850,元大臺灣ESG永續,3,0,3,凱基-永和,2024-11-26,9207
00915,凱基優選高股息30,3,0,3,凱基-永和,2024-11-26,9207
2483,百容,3,0,3,凱基-永和,2024-11-26,9207
2718,全心投控,3,0,3,凱基-永和,2024-11-26,9207
3018,隆銘綠能,3,0,3,凱基-永和,2024-11-26,9207
3406,玉晶光,3,0,3,凱基-永和,2024-11-26,9207
4303,信立,3,0,3,凱基-永和,2024-11-26,9207
6506,雙邦,3,0,3,凱基-永和,2024-11-26,9207
9904,寶成,4,1,3,凱基-永和,2024-11-26,9207
2360,致茂,3,0,3,凱基-永和,2024-11-26,9207
3090,日電貿,4,1,3,凱基-永和,2024-11-26,9207
0056,元大高股息,2,0,2,凱基-永和,2024-11-26,9207
2308,台達電,2,0,2,凱基-永和,2024-11-26,9207
00887,永豐中國科技50大,2,0,2,凱基-永和,2024-11-26,9207
00909,國泰數位支付服務,2,0,2,凱基-永和,2024-11-26,9207
00662,富邦NASDAQ,2,0,2,凱基-永和,2024-11-26,9207
00878,國泰永續高股息,109,4,105,凱基-永和,2024-11-27,9207
0056,元大高股息,88,0,88,凱基-永和,2024-11-27,9207
9105,泰金寶-DR,78,7,71,凱基-永和,2024-11-27,9207
00795B,中信美國公債20年,70,3,67,凱基-永和,2024-11-27,9207
4979,華星光,86,21,65,凱基-永和,2024-11-27,9207
6109,亞元,50,0,50,凱基-永和,2024-11-27,9207
2317,鴻海,50,7,43,凱基-永和,2024-11-27,9207
3231,緯創,45,3,42,凱基-永和,2024-11-27,9207
2356,英業達,43,4,39,凱基-永和,2024-11-27,9207
00919,群益台灣精選高息,29,0,29,凱基-永和,2024-11-27,9207
1815,富喬,30,2,28,凱基-永和,2024-11-27,9207
2609,陽明,383,361,22,凱基-永和,2024-11-27,9207
00929,復華台灣科技優息,22,0,22,凱基-永和,2024-11-27,9207
00940,元大台灣價值高息,21,0,21,凱基-永和,2024-11-27,9207
4746,台耀,20,0,20,凱基-永和,2024-11-27,9207
2419,仲琦,42,22,20,凱基-永和,2024-11-27,9207
2303,聯電,28,11,17,凱基-永和,2024-11-27,9207
3013,晟銘電,34,17,17,凱基-永和,2024-11-27,9207
4162,智擎,14,0,14,凱基-永和,2024-11-27,9207
00918,大華優利高填息30,23,10,13,凱基-永和,2024-11-27,9207
2330,台積電,13,1,12,凱基-永和,2024-11-27,9207
00891,中信關鍵半導體,10,0,10,凱基-永和,2024-11-27,9207
2603,長榮,11,0,11,凱基-永和,2024-11-27,9207
2314,台揚,10,0,10,凱基-永和,2024-11-27,9207
2324,仁寶,15,5,10,凱基-永和,2024-11-27,9207
4526,東台,13,3,10,凱基-永和,2024-11-27,9207
2382,廣達,10,0,10,凱基-永和,2024-11-27,9207
6180,橘子,10,0,10,凱基-永和,2024-11-27,9207
4105,東洋,9,0,9,凱基-永和,2024-11-27,9207
006208,富邦台50,10,1,9,凱基-永和,2024-11-27,9207
2915,潤泰全,9,1,8,凱基-永和,2024-11-27,9207
2891,中信金,8,0,8,凱基-永和,2024-11-27,9207
1301,台塑,8,0,8,凱基-永和,2024-11-27,9207
5438,東友,8,0,8,凱基-永和,2024-11-27,9207
00715L,期街口布蘭特正2,7,0,7,凱基-永和,2024-11-27,9207
6129,普誠,7,0,7,凱基-永和,2024-11-27,9207
6526,達發,7,0,7,凱基-永和,2024-11-27,9207
8039,台虹,7,0,7,凱基-永和,2024-11-27,9207
4562,穎漢,11,4,7,凱基-永和,2024-11-27,9207
0050,元大台灣50,8,1,7,凱基-永和,2024-11-27,9207
3037,欣興,6,0,6,凱基-永和,2024-11-27,9207
2882,國泰金,6,0,6,凱基-永和,2024-11-27,9207
5522,遠雄,6,0,6,凱基-永和,2024-11-27,9207
00688L,國泰20年美債正2,5,0,5,凱基-永和,2024-11-27,9207
00946,群益科技高息成長,5,0,5,凱基-永和,2024-11-27,9207
2338,光罩,5,0,5,凱基-永和,2024-11-27,9207
4919,新唐,6,1,5,凱基-永和,2024-11-27,9207
5388,中磊,5,0,5,凱基-永和,2024-11-27,9207
6603,富強鑫,5,0,5,凱基-永和,2024-11-27,9207
2002,中鋼,5,0,5,凱基-永和,2024-11-27,9207
5309,系統電,153,18,135,凱基-永和,2024-11-28,9207
2312,金寶,115,13,102,凱基-永和,2024-11-28,9207
8028,昇陽半導體,62,1,61,凱基-永和,2024-11-28,9207
00878,國泰永續高股息,67,15,52,凱基-永和,2024-11-28,9207
00706L,期元大S＆P日圓正2,48,0,48,凱基-永和,2024-11-28,9207
6213,聯茂,40,0,40,凱基-永和,2024-11-28,9207
8240,華宏,37,0,37,凱基-永和,2024-11-28,9207
2002,中鋼,25,0,25,凱基-永和,2024-11-28,9207
00940,元大台灣價值高息,24,0,24,凱基-永和,2024-11-28,9207
2888,新光金,22,1,21,凱基-永和,2024-11-28,9207
4746,台耀,21,1,20,凱基-永和,2024-11-28,9207
00891,中信關鍵半導體,20,0,20,凱基-永和,2024-11-28,9207
00674R,期元大S＆P黃金反1,20,0,20,凱基-永和,2024-11-28,9207
00929,復華台灣科技優息,31,12,19,凱基-永和,2024-11-28,9207
00687B,國泰20年美債,19,1,18,凱基-永和,2024-11-28,9207
0056,元大高股息,21,4,17,凱基-永和,2024-11-28,9207
00934,中信成長高股息,16,0,16,凱基-永和,2024-11-28,9207
00919,群益台灣精選高息,17,3,14,凱基-永和,2024-11-28,9207
9933,中鼎,13,0,13,凱基-永和,2024-11-28,9207
00881,國泰台灣5G+,12,0,12,凱基-永和,2024-11-28,9207
2615,萬海,16,4,12,凱基-永和,2024-11-28,9207
2867,三商壽,12,0,12,凱基-永和,2024-11-28,9207
6127,九豪,12,0,12,凱基-永和,2024-11-28,9207
6129,普誠,12,0,12,凱基-永和,2024-11-28,9207
2891,中信金,13,1,12,凱基-永和,2024-11-28,9207
1785,光洋科,10,0,10,凱基-永和,2024-11-28,9207
2383,台光電,10,0,10,凱基-永和,2024-11-28,9207
2929,淘帝-KY,10,0,10,凱基-永和,2024-11-28,9207
6284,佳邦,10,0,10,凱基-永和,2024-11-28,9207
2303,聯電,13,3,10,凱基-永和,2024-11-28,9207
2426,鼎元,13,4,9,凱基-永和,2024-11-28,9207
3583,辛耘,13,4,9,凱基-永和,2024-11-28,9207
4956,光鋐,10,1,9,凱基-永和,2024-11-28,9207
00882,中信中國高股息,8,0,8,凱基-永和,2024-11-28,9207
2883,凱基金,14,6,8,凱基-永和,2024-11-28,9207
1522,堤維西,11,3,8,凱基-永和,2024-11-28,9207
2344,華邦電,11,3,8,凱基-永和,2024-11-28,9207
6505,台塑化,8,0,8,凱基-永和,2024-11-28,9207
8171,天宇,9,1,8,凱基-永和,2024-11-28,9207
2354,鴻準,37,29,8,凱基-永和,2024-11-28,9207
00757,統一FANG+,18,11,7,凱基-永和,2024-11-28,9207
00946,群益科技高息成長,7,0,7,凱基-永和,2024-11-28,9207
1536,和大,21,14,7,凱基-永和,2024-11-28,9207
3706,神達,120,113,7,凱基-永和,2024-11-28,9207
2882,國泰金,9,3,6,凱基-永和,2024-11-28,9207
00950B,凱基A級公司債,6,0,6,凱基-永和,2024-11-28,9207
00637L,元大滬深300正2,8,2,6,凱基-永和,2024-11-28,9207
2338,光罩,6,0,6,凱基-永和,2024-11-28,9207
3625,西勝,6,0,6,凱基-永和,2024-11-28,9207
4105,東洋,6,0,6,凱基-永和,2024-11-28,9207
3211,順達,1248,984,264,凱基-永和,2024-11-29,9207
8374,羅昇,61,0,61,凱基-永和,2024-11-29,9207
6104,創惟,60,1,59,凱基-永和,2024-11-29,9207
2887,台新金,51,0,51,凱基-永和,2024-11-29,9207
00919,群益台灣精選高息,45,0,45,凱基-永和,2024-11-29,9207
00795B,中信美國公債20年,40,0,40,凱基-永和,2024-11-29,9207
00687B,國泰20年美債,50,10,40,凱基-永和,2024-11-29,9207
00929,復華台灣科技優息,33,1,32,凱基-永和,2024-11-29,9207
5880,合庫金,27,0,27,凱基-永和,2024-11-29,9207
00670L,富邦NASDAQ正2,25,0,25,凱基-永和,2024-11-29,9207
3533,嘉澤,30,7,23,凱基-永和,2024-11-29,9207
00680L,元大美債20正2,23,2,21,凱基-永和,2024-11-29,9207
1402,遠東新,20,0,20,凱基-永和,2024-11-29,9207
2359,所羅門,20,0,20,凱基-永和,2024-11-29,9207
2330,台積電,19,0,19,凱基-永和,2024-11-29,9207
2002,中鋼,19,0,19,凱基-永和,2024-11-29,9207
1301,台塑,18,0,18,凱基-永和,2024-11-29,9207
2458,義隆,20,2,18,凱基-永和,2024-11-29,9207
00953B,群益優選非投等債,14,0,14,凱基-永和,2024-11-29,9207
00882,中信中國高股息,13,0,13,凱基-永和,2024-11-29,9207
1722,台肥,12,0,12,凱基-永和,2024-11-29,9207
1795,美時,14,3,11,凱基-永和,2024-11-29,9207
2303,聯電,12,2,10,凱基-永和,2024-11-29,9207
2891,中信金,10,0,10,凱基-永和,2024-11-29,9207
2323,中環,10,0,10,凱基-永和,2024-11-29,9207
2328,廣宇,10,0,10,凱基-永和,2024-11-29,9207
2356,英業達,10,0,10,凱基-永和,2024-11-29,9207
4162,智擎,11,1,10,凱基-永和,2024-11-29,9207
00878,國泰永續高股息,28,19,9,凱基-永和,2024-11-29,9207
00637L,元大滬深300正2,14,5,9,凱基-永和,2024-11-29,9207
2646,星宇航空,9,0,9,凱基-永和,2024-11-29,9207
2884,玉山金,12,3,9,凱基-永和,2024-11-29,9207
00907,永豐優息存股,8,0,8,凱基-永和,2024-11-29,9207
8028,昇陽半導體,67,59,8,凱基-永和,2024-11-29,9207
2312,金寶,15,8,7,凱基-永和,2024-11-29,9207
3481,群創,6,0,6,凱基-永和,2024-11-29,9207
0050,元大台灣50,6,0,6,凱基-永和,2024-11-29,9207
5876,上海商銀,6,0,6,凱基-永和,2024-11-29,9207
3090,日電貿,7,1,6,凱基-永和,2024-11-29,9207
006208,富邦台50,5,0,5,凱基-永和,2024-11-29,9207
0056,元大高股息,5,0,5,凱基-永和,2024-11-29,9207
2014,中鴻,5,0,5,凱基-永和,2024-11-29,9207
2027,大成鋼,5,0,5,凱基-永和,2024-11-29,9207
2615,萬海,12,7,5,凱基-永和,2024-11-29,9207
6603,富強鑫,5,0,5,凱基-永和,2024-11-29,9207
9933,中鼎,10,6,4,凱基-永和,2024-11-29,9207
00952,凱基台灣AI50,4,0,4,凱基-永和,2024-11-29,9207
4971,IET-KY,4,0,4,凱基-永和,2024-11-29,9207
5457,宣德,4,0,4,凱基-永和,2024-11-29,9207
6139,亞翔,4,0,4,凱基-永和,2024-11-29,9207
4977,眾達-KY,351,151,200,凱基-永和,2024-12-02,9207
8028,昇陽半導體,149,9,140,凱基-永和,2024-12-02,9207
6104,創惟,98,0,98,凱基-永和,2024-12-02,9207
4979,華星光,116,53,63,凱基-永和,2024-12-02,9207
00929,復華台灣科技優息,58,2,56,凱基-永和,2024-12-02,9207
3706,神達,58,24,34,凱基-永和,2024-12-02,9207
2002,中鋼,35,2,33,凱基-永和,2024-12-02,9207
00918,大華優利高填息30,27,0,27,凱基-永和,2024-12-02,9207
00939,統一台灣高息動能,25,0,25,凱基-永和,2024-12-02,9207
5876,上海商銀,24,0,24,凱基-永和,2024-12-02,9207
6757,台灣虎航,25,1,24,凱基-永和,2024-12-02,9207
00919,群益台灣精選高息,24,1,23,凱基-永和,2024-12-02,9207
00713,元大台灣高息低波,22,0,22,凱基-永和,2024-12-02,9207
2317,鴻海,28,7,21,凱基-永和,2024-12-02,9207
00934,中信成長高股息,20,0,20,凱基-永和,2024-12-02,9207
6109,亞元,20,0,20,凱基-永和,2024-12-02,9207
8249,菱光,26,6,20,凱基-永和,2024-12-02,9207
2354,鴻準,40,21,19,凱基-永和,2024-12-02,9207
6715,嘉基,20,1,19,凱基-永和,2024-12-02,9207
1785,光洋科,16,0,16,凱基-永和,2024-12-02,9207
2312,金寶,26,10,16,凱基-永和,2024-12-02,9207
2609,陽明,21,5,16,凱基-永和,2024-12-02,9207
00878,國泰永續高股息,15,0,15,凱基-永和,2024-12-02,9207
2348,海悅,15,0,15,凱基-永和,2024-12-02,9207
00650L,復華香港正2,12,0,12,凱基-永和,2024-12-02,9207
1402,遠東新,12,0,12,凱基-永和,2024-12-02,9207
5439,高技,127,115,12,凱基-永和,2024-12-02,9207
6770,力積電,12,0,12,凱基-永和,2024-12-02,9207
3533,嘉澤,12,1,11,凱基-永和,2024-12-02,9207
4746,台耀,10,0,10,凱基-永和,2024-12-02,9207
8383,千附,10,0,10,凱基-永和,2024-12-02,9207
3594,磐儀,9,0,9,凱基-永和,2024-12-02,9207
3707,漢磊,11,2,9,凱基-永和,2024-12-02,9207
4956,光鋐,10,1,9,凱基-永和,2024-12-02,9207
5864,致和證,9,0,9,凱基-永和,2024-12-02,9207
4123,晟德,19,11,8,凱基-永和,2024-12-02,9207
4919,新唐,8,0,8,凱基-永和,2024-12-02,9207
2886,兆豐金,6,0,6,凱基-永和,2024-12-02,9207
2495,普安,5,0,5,凱基-永和,2024-12-02,9207
5328,華容,7,2,5,凱基-永和,2024-12-02,9207
00953B,群益優選非投等債,5,0,5,凱基-永和,2024-12-02,9207
8046,南電,5,0,5,凱基-永和,2024-12-02,9207
9933,中鼎,5,0,5,凱基-永和,2024-12-02,9207
3583,辛耘,9,5,4,凱基-永和,2024-12-02,9207
1301,台塑,5,1,4,凱基-永和,2024-12-02,9207
2027,大成鋼,4,0,4,凱基-永和,2024-12-02,9207
2615,萬海,5,1,4,凱基-永和,2024-12-02,9207
3024,憶聲,6,2,4,凱基-永和,2024-12-02,9207
3625,西勝,4,0,4,凱基-永和,2024-12-02,9207
3712,永崴投控,4,0,4,凱基-永和,2024-12-02,9207
1785,光洋科,150,19,131,凱基-永和,2024-12-03,9207
2349,錸德,90,0,90,凱基-永和,2024-12-03,9207
2883,凱基金,80,2,78,凱基-永和,2024-12-03,9207
00713,元大台灣高息低波,67,0,67,凱基-永和,2024-12-03,9207
00946,群益科技高息成長,68,4,64,凱基-永和,2024-12-03,9207
00930,永豐ESG低碳高息,40,0,40,凱基-永和,2024-12-03,9207
00919,群益台灣精選高息,61,24,37,凱基-永和,2024-12-03,9207
2449,京元電子,31,1,30,凱基-永和,2024-12-03,9207
4147,中裕,25,0,25,凱基-永和,2024-12-03,9207
0056,元大高股息,24,6,18,凱基-永和,2024-12-03,9207
2618,長榮航,31,17,14,凱基-永和,2024-12-03,9207
00915,凱基優選高股息30,20,8,12,凱基-永和,2024-12-03,9207
00881,國泰台灣5G+,11,0,11,凱基-永和,2024-12-03,9207
2347,聯強,11,0,11,凱基-永和,2024-12-03,9207
00953B,群益優選非投等債,10,0,10,凱基-永和,2024-12-03,9207
00948B,中信優息投資級債,10,0,10,凱基-永和,2024-12-03,9207
2476,鉅祥,10,0,10,凱基-永和,2024-12-03,9207
6603,富強鑫,10,0,10,凱基-永和,2024-12-03,9207
2419,仲琦,8,0,8,凱基-永和,2024-12-03,9207
006208,富邦台50,9,2,7,凱基-永和,2024-12-03,9207
2324,仁寶,23,16,7,凱基-永和,2024-12-03,9207
6187,萬潤,7,0,7,凱基-永和,2024-12-03,9207
1101,台泥,7,1,6,凱基-永和,2024-12-03,9207
2348,海悅,6,0,6,凱基-永和,2024-12-03,9207
3152,璟德,6,0,6,凱基-永和,2024-12-03,9207
3380,明泰,8,2,6,凱基-永和,2024-12-03,9207
6139,亞翔,6,0,6,凱基-永和,2024-12-03,9207
6706,惠特,6,0,6,凱基-永和,2024-12-03,9207
00959B,大華投等美債15Y+,5,0,5,凱基-永和,2024-12-03,9207
00918,大華優利高填息30,25,20,5,凱基-永和,2024-12-03,9207
2812,台中銀,5,0,5,凱基-永和,2024-12-03,9207
6180,橘子,5,0,5,凱基-永和,2024-12-03,9207
3017,奇鋐,7,2,5,凱基-永和,2024-12-03,9207
00878,國泰永續高股息,7,3,4,凱基-永和,2024-12-03,9207
3163,波若威,5,1,4,凱基-永和,2024-12-03,9207
3625,西勝,11,7,4,凱基-永和,2024-12-03,9207
3715,定穎投控,7,3,4,凱基-永和,2024-12-03,9207
6558,興能高,7,3,4,凱基-永和,2024-12-03,9207
3231,緯創,3,0,3,凱基-永和,2024-12-03,9207
00947,台新臺灣IC設計,3,0,3,凱基-永和,2024-12-03,9207
00632R,元大台灣50反1,3,0,3,凱基-永和,2024-12-03,9207
00642U,期元大S＆P石油,3,0,3,凱基-永和,2024-12-03,9207
1569,濱川,3,0,3,凱基-永和,2024-12-03,9207
2329,華泰,5,2,3,凱基-永和,2024-12-03,9207
2338,光罩,3,0,3,凱基-永和,2024-12-03,9207
2483,百容,3,0,3,凱基-永和,2024-12-03,9207
2834,臺企銀,3,0,3,凱基-永和,2024-12-03,9207
3363,上詮,3,0,3,凱基-永和,2024-12-03,9207
3594,磐儀,3,0,3,凱基-永和,2024-12-03,9207
3702,大聯大,3,0,3,凱基-永和,2024-12-03,9207
5328,華容,500,4,496,凱基-永和,2024-12-04,9207
4977,眾達-KY,302,1,301,凱基-永和,2024-12-04,9207
5439,高技,268,13,255,凱基-永和,2024-12-04,9207
6104,創惟,235,56,179,凱基-永和,2024-12-04,9207
3211,順達,166,10,156,凱基-永和,2024-12-04,9207
4931,新盛力,177,37,140,凱基-永和,2024-12-04,9207
6558,興能高,111,12,99,凱基-永和,2024-12-04,9207
2610,華航,101,3,98,凱基-永和,2024-12-04,9207
00953B,群益優選非投等債,96,0,96,凱基-永和,2024-12-04,9207
2392,正崴,87,7,80,凱基-永和,2024-12-04,9207
8028,昇陽半導體,75,2,73,凱基-永和,2024-12-04,9207
8089,康全電訊,70,0,70,凱基-永和,2024-12-04,9207
00937B,群益ESG投等債20,63,0,63,凱基-永和,2024-12-04,9207
00918,大華優利高填息30,50,0,50,凱基-永和,2024-12-04,9207
2891,中信金,34,3,31,凱基-永和,2024-12-04,9207
00948B,中信優息投資級債,30,0,30,凱基-永和,2024-12-04,9207
1303,南亞,20,0,20,凱基-永和,2024-12-04,9207
00919,群益台灣精選高息,27,9,18,凱基-永和,2024-12-04,9207
2548,華固,18,0,18,凱基-永和,2024-12-04,9207
2419,仲琦,25,8,17,凱基-永和,2024-12-04,9207
6669,緯穎,15,0,15,凱基-永和,2024-12-04,9207
00679B,元大美債20年,15,0,15,凱基-永和,2024-12-04,9207
00687B,國泰20年美債,14,0,14,凱基-永和,2024-12-04,9207
2303,聯電,33,20,13,凱基-永和,2024-12-04,9207
3583,辛耘,13,1,12,凱基-永和,2024-12-04,9207
2340,台亞,11,0,11,凱基-永和,2024-12-04,9207
6173,信昌電,10,0,10,凱基-永和,2024-12-04,9207
00959B,大華投等美債15Y+,10,0,10,凱基-永和,2024-12-04,9207
2609,陽明,15,6,9,凱基-永和,2024-12-04,9207
2371,大同,10,1,9,凱基-永和,2024-12-04,9207
2429,銘旺科,16,7,9,凱基-永和,2024-12-04,9207
2887,台新金,9,0,9,凱基-永和,2024-12-04,9207
5425,台半,9,0,9,凱基-永和,2024-12-04,9207
8114,振樺電,79,70,9,凱基-永和,2024-12-04,9207
8215,明基材,9,0,9,凱基-永和,2024-12-04,9207
2376,技嘉,10,1,9,凱基-永和,2024-12-04,9207
2347,聯強,8,0,8,凱基-永和,2024-12-04,9207
1301,台塑,11,4,7,凱基-永和,2024-12-04,9207
2884,玉山金,7,0,7,凱基-永和,2024-12-04,9207
00926,凱基全球菁英55,6,0,6,凱基-永和,2024-12-04,9207
00930,永豐ESG低碳高息,6,0,6,凱基-永和,2024-12-04,9207
00915,凱基優選高股息30,6,0,6,凱基-永和,2024-12-04,9207
00720B,元大投資級公司債,6,0,6,凱基-永和,2024-12-04,9207
2337,旺宏,6,0,6,凱基-永和,2024-12-04,9207
2486,一詮,8,2,6,凱基-永和,2024-12-04,9207
6584,南俊國際,6,0,6,凱基-永和,2024-12-04,9207
9105,泰金寶-DR,7,1,6,凱基-永和,2024-12-04,9207
2888,新光金,12,6,6,凱基-永和,2024-12-04,9207
00795B,中信美國公債20年,5,0,5,凱基-永和,2024-12-04,9207
00932,兆豐永續高息等權,5,0,5,凱基-永和,2024-12-04,9207
4919,新唐,388,119,269,凱基-永和,2024-12-05,9207
4977,眾達-KY,508,387,121,凱基-永和,2024-12-05,9207
1785,光洋科,110,0,110,凱基-永和,2024-12-05,9207
9105,泰金寶-DR,70,15,55,凱基-永和,2024-12-05,9207
2303,聯電,51,9,42,凱基-永和,2024-12-05,9207
3163,波若威,35,2,33,凱基-永和,2024-12-05,9207
00953B,群益優選非投等債,32,0,32,凱基-永和,2024-12-05,9207
1303,南亞,26,0,26,凱基-永和,2024-12-05,9207
2354,鴻準,67,42,25,凱基-永和,2024-12-05,9207
2392,正崴,45,20,25,凱基-永和,2024-12-05,9207
6811,宏�硌穈T,25,0,25,凱基-永和,2024-12-05,9207
6669,緯穎,25,1,24,凱基-永和,2024-12-05,9207
2317,鴻海,32,9,23,凱基-永和,2024-12-05,9207
1314,中石化,23,0,23,凱基-永和,2024-12-05,9207
8114,振樺電,21,0,21,凱基-永和,2024-12-05,9207
00932,兆豐永續高息等權,20,0,20,凱基-永和,2024-12-05,9207
00918,大華優利高填息30,20,0,20,凱基-永和,2024-12-05,9207
3661,世芯-KY,18,0,18,凱基-永和,2024-12-05,9207
2892,第一金,18,0,18,凱基-永和,2024-12-05,9207
3323,加百裕,32,17,15,凱基-永和,2024-12-05,9207
00919,群益台灣精選高息,15,0,15,凱基-永和,2024-12-05,9207
2409,友達,14,0,14,凱基-永和,2024-12-05,9207
6770,力積電,12,0,12,凱基-永和,2024-12-05,9207
2886,兆豐金,11,0,11,凱基-永和,2024-12-05,9207
1301,台塑,14,3,11,凱基-永和,2024-12-05,9207
00930,永豐ESG低碳高息,10,0,10,凱基-永和,2024-12-05,9207
1536,和大,12,2,10,凱基-永和,2024-12-05,9207
4105,東洋,10,0,10,凱基-永和,2024-12-05,9207
4123,晟德,11,1,10,凱基-永和,2024-12-05,9207
2888,新光金,10,0,10,凱基-永和,2024-12-05,9207
1815,富喬,1053,1045,8,凱基-永和,2024-12-05,9207
8176,智捷,8,0,8,凱基-永和,2024-12-05,9207
00715L,期街口布蘭特正2,7,0,7,凱基-永和,2024-12-05,9207
2313,華通,7,0,7,凱基-永和,2024-12-05,9207
2002,中鋼,7,0,7,凱基-永和,2024-12-05,9207
2344,華邦電,6,0,6,凱基-永和,2024-12-05,9207
2367,燿華,6,0,6,凱基-永和,2024-12-05,9207
3289,宜特,6,0,6,凱基-永和,2024-12-05,9207
4147,中裕,6,0,6,凱基-永和,2024-12-05,9207
4956,光鋐,6,0,6,凱基-永和,2024-12-05,9207
5201,凱衛,6,0,6,凱基-永和,2024-12-05,9207
8249,菱光,6,0,6,凱基-永和,2024-12-05,9207
9958,世紀鋼,6,0,6,凱基-永和,2024-12-05,9207
00915,凱基優選高股息30,5,0,5,凱基-永和,2024-12-05,9207
6109,亞元,5,0,5,凱基-永和,2024-12-05,9207
2609,陽明,11,6,5,凱基-永和,2024-12-05,9207
3234,光環,5,0,5,凱基-永和,2024-12-05,9207
006208,富邦台50,6,1,5,凱基-永和,2024-12-05,9207
1524,耿鼎,4,0,4,凱基-永和,2024-12-05,9207
2371,大同,7,3,4,凱基-永和,2024-12-05,9207
1785,光洋科,405,12,393,凱基-永和,2024-12-06,9207
00919,群益台灣精選高息,205,48,157,凱基-永和,2024-12-06,9207
3211,順達,211,89,122,凱基-永和,2024-12-06,9207
6873,泓德能源,114,0,114,凱基-永和,2024-12-06,9207
5439,高技,87,0,87,凱基-永和,2024-12-06,9207
4147,中裕,49,0,49,凱基-永和,2024-12-06,9207
2354,鴻準,126,78,48,凱基-永和,2024-12-06,9207
00953B,群益優選非投等債,42,0,42,凱基-永和,2024-12-06,9207
6763,綠界科技*,34,3,31,凱基-永和,2024-12-06,9207
3029,零壹,42,18,24,凱基-永和,2024-12-06,9207
8114,振樺電,20,0,20,凱基-永和,2024-12-06,9207
8358,金居,17,0,17,凱基-永和,2024-12-06,9207
2317,鴻海,24,10,14,凱基-永和,2024-12-06,9207
6416,瑞祺電通,14,0,14,凱基-永和,2024-12-06,9207
00830,國泰費城半導體,57,45,12,凱基-永和,2024-12-06,9207
6669,緯穎,13,2,11,凱基-永和,2024-12-06,9207
00887,永豐中國科技50大,10,0,10,凱基-永和,2024-12-06,9207
00670L,富邦NASDAQ正2,10,0,10,凱基-永和,2024-12-06,9207
00959B,大華投等美債15Y+,10,0,10,凱基-永和,2024-12-06,9207
1815,富喬,14,4,10,凱基-永和,2024-12-06,9207
4906,正文,10,0,10,凱基-永和,2024-12-06,9207
6683,雍智科技,10,0,10,凱基-永和,2024-12-06,9207
8054,安國,9,0,9,凱基-永和,2024-12-06,9207
5465,富驊,8,0,8,凱基-永和,2024-12-06,9207
00712,復華富時不動產,8,0,8,凱基-永和,2024-12-06,9207
2457,飛宏,7,0,7,凱基-永和,2024-12-06,9207
00715L,期街口布蘭特正2,6,0,6,凱基-永和,2024-12-06,9207
0056,元大高股息,6,0,6,凱基-永和,2024-12-06,9207
3625,西勝,6,0,6,凱基-永和,2024-12-06,9207
2884,玉山金,6,0,6,凱基-永和,2024-12-06,9207
3019,亞光,5,0,5,凱基-永和,2024-12-06,9207
2801,彰銀,5,0,5,凱基-永和,2024-12-06,9207
006208,富邦台50,6,1,5,凱基-永和,2024-12-06,9207
4105,東洋,5,0,5,凱基-永和,2024-12-06,9207
5201,凱衛,12,7,5,凱基-永和,2024-12-06,9207
6173,信昌電,5,0,5,凱基-永和,2024-12-06,9207
6488,環球晶,5,0,5,凱基-永和,2024-12-06,9207
8069,元太,5,0,5,凱基-永和,2024-12-06,9207
1528,恩德,4,0,4,凱基-永和,2024-12-06,9207
2392,正崴,23,19,4,凱基-永和,2024-12-06,9207
2886,兆豐金,6,2,4,凱基-永和,2024-12-06,9207
5515,建國,4,0,4,凱基-永和,2024-12-06,9207
6104,創惟,4,0,4,凱基-永和,2024-12-06,9207
8089,康全電訊,4,0,4,凱基-永和,2024-12-06,9207
4763,材料-KY,4,0,4,凱基-永和,2024-12-06,9207
00924,復華S＆P500成長,3,0,3,凱基-永和,2024-12-06,9207
00639,富邦深100,3,0,3,凱基-永和,2024-12-06,9207
00637L,元大滬深300正2,7,4,3,凱基-永和,2024-12-06,9207
00909,國泰數位支付服務,3,0,3,凱基-永和,2024-12-06,9207
2344,華邦電,4,1,3,凱基-永和,2024-12-06,9207
1785,光洋科,438,15,423,凱基-永和,2024-12-09,9207
3019,亞光,330,106,224,凱基-永和,2024-12-09,9207
1449,佳和,201,5,196,凱基-永和,2024-12-09,9207
3227,原相,125,0,125,凱基-永和,2024-12-09,9207
2303,聯電,112,2,110,凱基-永和,2024-12-09,9207
00953B,群益優選非投等債,65,0,65,凱基-永和,2024-12-09,9207
6603,富強鑫,60,0,60,凱基-永和,2024-12-09,9207
2609,陽明,119,69,50,凱基-永和,2024-12-09,9207
6442,光聖,50,2,48,凱基-永和,2024-12-09,9207
6873,泓德能源,36,0,36,凱基-永和,2024-12-09,9207
00926,凱基全球菁英55,30,0,30,凱基-永和,2024-12-09,9207
1447,力鵬,30,0,30,凱基-永和,2024-12-09,9207
8011,台通,30,0,30,凱基-永和,2024-12-09,9207
00655L,國泰中國A50正2,26,1,25,凱基-永和,2024-12-09,9207
0056,元大高股息,23,0,23,凱基-永和,2024-12-09,9207
5439,高技,35,13,22,凱基-永和,2024-12-09,9207
5347,世界,21,1,20,凱基-永和,2024-12-09,9207
8114,振樺電,18,0,18,凱基-永和,2024-12-09,9207
2449,京元電子,17,0,17,凱基-永和,2024-12-09,9207
00637L,元大滬深300正2,17,1,16,凱基-永和,2024-12-09,9207
8249,菱光,18,3,15,凱基-永和,2024-12-09,9207
3625,西勝,15,1,14,凱基-永和,2024-12-09,9207
2317,鴻海,14,0,14,凱基-永和,2024-12-09,9207
3231,緯創,15,2,13,凱基-永和,2024-12-09,9207
6558,興能高,22,10,12,凱基-永和,2024-12-09,9207
1524,耿鼎,18,7,11,凱基-永和,2024-12-09,9207
1718,中纖,10,0,10,凱基-永和,2024-12-09,9207
00864B,中信美國公債0-1,10,0,10,凱基-永和,2024-12-09,9207
00885,富邦越南,10,0,10,凱基-永和,2024-12-09,9207
2801,彰銀,10,0,10,凱基-永和,2024-12-09,9207
4147,中裕,10,0,10,凱基-永和,2024-12-09,9207
00918,大華優利高填息30,15,6,9,凱基-永和,2024-12-09,9207
2376,技嘉,9,0,9,凱基-永和,2024-12-09,9207
4927,泰鼎-KY,11,2,9,凱基-永和,2024-12-09,9207
6585,鼎基,9,0,9,凱基-永和,2024-12-09,9207
2610,華航,13,4,9,凱基-永和,2024-12-09,9207
6416,瑞祺電通,9,1,8,凱基-永和,2024-12-09,9207
00715L,期街口布蘭特正2,8,0,8,凱基-永和,2024-12-09,9207
4931,新盛力,8,0,8,凱基-永和,2024-12-09,9207
00915,凱基優選高股息30,7,0,7,凱基-永和,2024-12-09,9207
2233,宇隆,6,0,6,凱基-永和,2024-12-09,9207
2457,飛宏,6,0,6,凱基-永和,2024-12-09,9207
2611,志信,6,0,6,凱基-永和,2024-12-09,9207
6706,惠特,11,5,6,凱基-永和,2024-12-09,9207
2884,玉山金,6,0,6,凱基-永和,2024-12-09,9207
5309,系統電,6,1,5,凱基-永和,2024-12-09,9207
6127,九豪,5,0,5,凱基-永和,2024-12-09,9207
00757,統一FANG+,34,29,5,凱基-永和,2024-12-09,9207
1815,富喬,7,2,5,凱基-永和,2024-12-09,9207
2646,星宇航空,5,0,5,凱基-永和,2024-12-09,9207
00918,大華優利高填息30,155,23,132,凱基-永和,2024-12-10,9207
6443,元晶,100,0,100,凱基-永和,2024-12-10,9207
3029,零壹,102,37,65,凱基-永和,2024-12-10,9207
6415,矽力*-KY,50,0,50,凱基-永和,2024-12-10,9207
3706,神達,97,67,30,凱基-永和,2024-12-10,9207
2317,鴻海,30,7,23,凱基-永和,2024-12-10,9207
00930,永豐ESG低碳高息,20,0,20,凱基-永和,2024-12-10,9207
2609,陽明,38,22,16,凱基-永和,2024-12-10,9207
2618,長榮航,19,4,15,凱基-永和,2024-12-10,9207
3625,西勝,13,0,13,凱基-永和,2024-12-10,9207
4956,光鋐,13,0,13,凱基-永和,2024-12-10,9207
2547,日勝生,12,0,12,凱基-永和,2024-12-10,9207
2886,兆豐金,12,0,12,凱基-永和,2024-12-10,9207
0056,元大高股息,11,0,11,凱基-永和,2024-12-10,9207
2419,仲琦,11,0,11,凱基-永和,2024-12-10,9207
2884,玉山金,16,5,11,凱基-永和,2024-12-10,9207
3013,晟銘電,10,0,10,凱基-永和,2024-12-10,9207
2332,友訊,10,0,10,凱基-永和,2024-12-10,9207
2537,聯上發,10,0,10,凱基-永和,2024-12-10,9207
6603,富強鑫,10,0,10,凱基-永和,2024-12-10,9207
00953B,群益優選非投等債,10,0,10,凱基-永和,2024-12-10,9207
00893,國泰智能電動車,10,0,10,凱基-永和,2024-12-10,9207
00636,國泰中國A50,10,0,10,凱基-永和,2024-12-10,9207
2888A,新光金甲特,10,0,10,凱基-永和,2024-12-10,9207
2897,王道銀行,10,0,10,凱基-永和,2024-12-10,9207
2897B,王道銀乙特,10,0,10,凱基-永和,2024-12-10,9207
8114,振樺電,10,0,10,凱基-永和,2024-12-10,9207
2365,昆盈,11,2,9,凱基-永和,2024-12-10,9207
3090,日電貿,10,1,9,凱基-永和,2024-12-10,9207
2408,南亞科,10,2,8,凱基-永和,2024-12-10,9207
2427,三商電,8,0,8,凱基-永和,2024-12-10,9207
3260,威剛,8,0,8,凱基-永和,2024-12-10,9207
2347,聯強,8,0,8,凱基-永和,2024-12-10,9207
2382,廣達,17,10,7,凱基-永和,2024-12-10,9207
1536,和大,13,6,7,凱基-永和,2024-12-10,9207
00655L,國泰中國A50正2,10,3,7,凱基-永和,2024-12-10,9207
2613,中櫃,8,1,7,凱基-永和,2024-12-10,9207
2915,潤泰全,8,1,7,凱基-永和,2024-12-10,9207
2344,華邦電,6,0,6,凱基-永和,2024-12-10,9207
3227,原相,6,0,6,凱基-永和,2024-12-10,9207
9942,茂順,6,0,6,凱基-永和,2024-12-10,9207
6180,橘子,6,0,6,凱基-永和,2024-12-10,9207
00795B,中信美國公債20年,5,0,5,凱基-永和,2024-12-10,9207
5386,青雲,5,0,5,凱基-永和,2024-12-10,9207
00959B,大華投等美債15Y+,5,0,5,凱基-永和,2024-12-10,9207
1301,台塑,5,0,5,凱基-永和,2024-12-10,9207
1524,耿鼎,12,7,5,凱基-永和,2024-12-10,9207
2007,燁興,5,0,5,凱基-永和,2024-12-10,9207
2851,中再保,5,0,5,凱基-永和,2024-12-10,9207
2330,台積電,4,0,4,凱基-永和,2024-12-10,9207
00918,大華優利高填息30,106,0,106,凱基-永和,2024-12-11,9207
4953,緯軟,100,0,100,凱基-永和,2024-12-11,9207
4577,達航科技,100,1,99,凱基-永和,2024-12-11,9207
6770,力積電,34,1,33,凱基-永和,2024-12-11,9207
2317,鴻海,44,11,33,凱基-永和,2024-12-11,9207
3231,緯創,29,2,27,凱基-永和,2024-12-11,9207
00919,群益台灣精選高息,26,0,26,凱基-永和,2024-12-11,9207
2330,台積電,28,2,26,凱基-永和,2024-12-11,9207
00959B,大華投等美債15Y+,21,0,21,凱基-永和,2024-12-11,9207
1101,台泥,15,1,14,凱基-永和,2024-12-11,9207
6763,綠界科技*,14,0,14,凱基-永和,2024-12-11,9207
2382,廣達,15,1,14,凱基-永和,2024-12-11,9207
1605,華新,13,0,13,凱基-永和,2024-12-11,9207
2886,兆豐金,12,0,12,凱基-永和,2024-12-11,9207
00953B,群益優選非投等債,12,0,12,凱基-永和,2024-12-11,9207
00946,群益科技高息成長,11,0,11,凱基-永和,2024-12-11,9207
1815,富喬,16,5,11,凱基-永和,2024-12-11,9207
2345,智邦,12,1,11,凱基-永和,2024-12-11,9207
006208,富邦台50,10,0,10,凱基-永和,2024-12-11,9207
00637L,元大滬深300正2,10,0,10,凱基-永和,2024-12-11,9207
00878,國泰永續高股息,36,26,10,凱基-永和,2024-12-11,9207
2328,廣宇,10,0,10,凱基-永和,2024-12-11,9207
2897,王道銀行,10,0,10,凱基-永和,2024-12-11,9207
3234,光環,10,0,10,凱基-永和,2024-12-11,9207
6547,高端疫苗,10,0,10,凱基-永和,2024-12-11,9207
6689,伊雲谷,10,0,10,凱基-永和,2024-12-11,9207
00915,凱基優選高股息30,8,0,8,凱基-永和,2024-12-11,9207
1536,和大,14,6,8,凱基-永和,2024-12-11,9207
8028,昇陽半導體,8,0,8,凱基-永和,2024-12-11,9207
1519,華城,7,0,7,凱基-永和,2024-12-11,9207
2427,三商電,7,0,7,凱基-永和,2024-12-11,9207
3625,西勝,7,0,7,凱基-永和,2024-12-11,9207
2483,百容,6,0,6,凱基-永和,2024-12-11,9207
6224,聚鼎,6,0,6,凱基-永和,2024-12-11,9207
00753L,中信中國50正2,65,60,5,凱基-永和,2024-12-11,9207
00665L,富邦�琤肭磪囓�2,5,0,5,凱基-永和,2024-12-11,9207
2066,世德,5,0,5,凱基-永和,2024-12-11,9207
2108,南帝,5,0,5,凱基-永和,2024-12-11,9207
2344,華邦電,5,0,5,凱基-永和,2024-12-11,9207
2348,海悅,5,0,5,凱基-永和,2024-12-11,9207
2426,鼎元,6,1,5,凱基-永和,2024-12-11,9207
2851,中再保,5,0,5,凱基-永和,2024-12-11,9207
2890,永豐金,5,0,5,凱基-永和,2024-12-11,9207
3374,精材,5,0,5,凱基-永和,2024-12-11,9207
6220,岳豐,5,0,5,凱基-永和,2024-12-11,9207
2603,長榮,5,0,5,凱基-永和,2024-12-11,9207
2610,華航,4,0,4,凱基-永和,2024-12-11,9207
00937B,群益ESG投等債20,6,2,4,凱基-永和,2024-12-11,9207
1307,三芳,4,0,4,凱基-永和,2024-12-11,9207
2017,官田鋼,4,0,4,凱基-永和,2024-12-11,9207
00795B,中信美國公債20年,105,0,105,凱基-永和,2024-12-12,9207
00918,大華優利高填息30,53,0,53,凱基-永和,2024-12-12,9207
00936,台新永續高息中小,40,0,40,凱基-永和,2024-12-12,9207
4991,環宇-KY,40,2,38,凱基-永和,2024-12-12,9207
00953B,群益優選非投等債,35,0,35,凱基-永和,2024-12-12,9207
2371,大同,35,0,35,凱基-永和,2024-12-12,9207
2312,金寶,34,2,32,凱基-永和,2024-12-12,9207
2885,元大金,30,0,30,凱基-永和,2024-12-12,9207
00878,國泰永續高股息,27,2,25,凱基-永和,2024-12-12,9207
00687B,國泰20年美債,23,0,23,凱基-永和,2024-12-12,9207
0056,元大高股息,20,1,19,凱基-永和,2024-12-12,9207
2483,百容,19,0,19,凱基-永和,2024-12-12,9207
2317,鴻海,18,1,17,凱基-永和,2024-12-12,9207
2303,聯電,19,3,16,凱基-永和,2024-12-12,9207
2543,皇昌,13,0,13,凱基-永和,2024-12-12,9207
2890,永豐金,13,0,13,凱基-永和,2024-12-12,9207
00915,凱基優選高股息30,13,1,12,凱基-永和,2024-12-12,9207
1303,南亞,12,0,12,凱基-永和,2024-12-12,9207
00926,凱基全球菁英55,11,0,11,凱基-永和,2024-12-12,9207
3231,緯創,12,1,11,凱基-永和,2024-12-12,9207
6214,精誠,11,0,11,凱基-永和,2024-12-12,9207
00753L,中信中國50正2,11,1,10,凱基-永和,2024-12-12,9207
00959B,大華投等美債15Y+,10,0,10,凱基-永和,2024-12-12,9207
1611,中電,10,0,10,凱基-永和,2024-12-12,9207
2354,鴻準,59,49,10,凱基-永和,2024-12-12,9207
6180,橘子,10,0,10,凱基-永和,2024-12-12,9207
2337,旺宏,10,1,9,凱基-永和,2024-12-12,9207
2348,海悅,9,0,9,凱基-永和,2024-12-12,9207
3706,神達,35,26,9,凱基-永和,2024-12-12,9207
2376,技嘉,8,0,8,凱基-永和,2024-12-12,9207
3211,順達,8,0,8,凱基-永和,2024-12-12,9207
00937B,群益ESG投等債20,10,3,7,凱基-永和,2024-12-12,9207
2609,陽明,9,2,7,凱基-永和,2024-12-12,9207
2353,宏��,6,0,6,凱基-永和,2024-12-12,9207
2374,佳能,9,3,6,凱基-永和,2024-12-12,9207
00919,群益台灣精選高息,5,0,5,凱基-永和,2024-12-12,9207
00688L,國泰20年美債正2,5,0,5,凱基-永和,2024-12-12,9207
0050,元大台灣50,5,0,5,凱基-永和,2024-12-12,9207
00679B,元大美債20年,10,5,5,凱基-永和,2024-12-12,9207
1417,嘉裕,5,0,5,凱基-永和,2024-12-12,9207
2548,華固,5,0,5,凱基-永和,2024-12-12,9207
2705,六福,5,0,5,凱基-永和,2024-12-12,9207
4906,正文,5,0,5,凱基-永和,2024-12-12,9207
6015,宏遠證,5,0,5,凱基-永和,2024-12-12,9207
6104,創惟,5,0,5,凱基-永和,2024-12-12,9207
8176,智捷,5,0,5,凱基-永和,2024-12-12,9207
2347,聯強,5,0,5,凱基-永和,2024-12-12,9207
2615,萬海,14,10,4,凱基-永和,2024-12-12,9207
2106,建大,4,0,4,凱基-永和,2024-12-12,9207
00941,中信上游半導體,4,0,4,凱基-永和,2024-12-12,9207
4540,全球傳動,428,40,388,凱基-永和,2024-12-13,9207
3029,零壹,382,11,371,凱基-永和,2024-12-13,9207
2345,智邦,132,3,129,凱基-永和,2024-12-13,9207
3706,神達,79,13,66,凱基-永和,2024-12-13,9207
2615,萬海,73,12,61,凱基-永和,2024-12-13,9207
00919,群益台灣精選高息,92,31,61,凱基-永和,2024-12-13,9207
2408,南亞科,52,0,52,凱基-永和,2024-12-13,9207
2002,中鋼,39,0,39,凱基-永和,2024-12-13,9207
2883,凱基金,29,0,29,凱基-永和,2024-12-13,9207
00918,大華優利高填息30,41,12,29,凱基-永和,2024-12-13,9207
2359,所羅門,44,16,28,凱基-永和,2024-12-13,9207
00893,國泰智能電動車,25,0,25,凱基-永和,2024-12-13,9207
1447,力鵬,30,5,25,凱基-永和,2024-12-13,9207
9105,泰金寶-DR,60,35,25,凱基-永和,2024-12-13,9207
9802,鈺齊-KY,24,0,24,凱基-永和,2024-12-13,9207
2303,聯電,33,10,23,凱基-永和,2024-12-13,9207
3037,欣興,22,1,21,凱基-永和,2024-12-13,9207
00857B,永豐20年美公債,21,0,21,凱基-永和,2024-12-13,9207
2323,中環,21,0,21,凱基-永和,2024-12-13,9207
6449,鈺邦,20,0,20,凱基-永和,2024-12-13,9207
3006,晶豪科,17,0,17,凱基-永和,2024-12-13,9207
00953B,群益優選非投等債,15,0,15,凱基-永和,2024-12-13,9207
4956,光鋐,16,2,14,凱基-永和,2024-12-13,9207
2317,鴻海,16,2,14,凱基-永和,2024-12-13,9207
2646,星宇航空,13,0,13,凱基-永和,2024-12-13,9207
4906,正文,12,0,12,凱基-永和,2024-12-13,9207
2382,廣達,19,8,11,凱基-永和,2024-12-13,9207
00915,凱基優選高股息30,11,0,11,凱基-永和,2024-12-13,9207
00687B,國泰20年美債,11,0,11,凱基-永和,2024-12-13,9207
2385,群光,10,0,10,凱基-永和,2024-12-13,9207
1611,中電,10,0,10,凱基-永和,2024-12-13,9207
2439,美律,10,0,10,凱基-永和,2024-12-13,9207
2462,良得電,10,0,10,凱基-永和,2024-12-13,9207
6269,台郡,10,0,10,凱基-永和,2024-12-13,9207
00929,復華台灣科技優息,16,6,10,凱基-永和,2024-12-13,9207
00937B,群益ESG投等債20,9,0,9,凱基-永和,2024-12-13,9207
0056,元大高股息,12,4,8,凱基-永和,2024-12-13,9207
3231,緯創,8,0,8,凱基-永和,2024-12-13,9207
00679B,元大美債20年,8,0,8,凱基-永和,2024-12-13,9207
00637L,元大滬深300正2,9,1,8,凱基-永和,2024-12-13,9207
2442,新美齊,8,0,8,凱基-永和,2024-12-13,9207
00753L,中信中國50正2,7,0,7,凱基-永和,2024-12-13,9207
6415,矽力*-KY,6,0,6,凱基-永和,2024-12-13,9207
00655L,國泰中國A50正2,7,1,6,凱基-永和,2024-12-13,9207
2014,中鴻,6,0,6,凱基-永和,2024-12-13,9207
6962,ITH-KY,6,0,6,凱基-永和,2024-12-13,9207
9942,茂順,6,0,6,凱基-永和,2024-12-13,9207
5515,建國,5,0,5,凱基-永和,2024-12-13,9207
8046,南電,5,0,5,凱基-永和,2024-12-13,9207
00632R,元大台灣50反1,5,0,5,凱基-永和,2024-12-13,9207
2330,台積電,121,14,107,凱基-永和,2024-12-16,9207
00948B,中信優息投資級債,100,0,100,凱基-永和,2024-12-16,9207
4577,達航科技,100,0,100,凱基-永和,2024-12-16,9207
00918,大華優利高填息30,89,2,87,凱基-永和,2024-12-16,9207
00937B,群益ESG投等債20,77,1,76,凱基-永和,2024-12-16,9207
4956,光鋐,65,2,63,凱基-永和,2024-12-16,9207
00896,中信綠能及電動車,48,0,48,凱基-永和,2024-12-16,9207
2464,盟立,50,4,46,凱基-永和,2024-12-16,9207
00687B,國泰20年美債,45,2,43,凱基-永和,2024-12-16,9207
2312,金寶,42,4,38,凱基-永和,2024-12-16,9207
2359,所羅門,42,10,32,凱基-永和,2024-12-16,9207
3707,漢磊,27,1,26,凱基-永和,2024-12-16,9207
8358,金居,25,0,25,凱基-永和,2024-12-16,9207
2382,廣達,25,4,21,凱基-永和,2024-12-16,9207
2609,陽明,58,38,20,凱基-永和,2024-12-16,9207
00680L,元大美債20正2,20,0,20,凱基-永和,2024-12-16,9207
00878,國泰永續高股息,21,2,19,凱基-永和,2024-12-16,9207
2455,全新,20,1,19,凱基-永和,2024-12-16,9207
3706,神達,45,26,19,凱基-永和,2024-12-16,9207
2618,長榮航,30,12,18,凱基-永和,2024-12-16,9207
00673R,期元大S＆P原油反1,16,0,16,凱基-永和,2024-12-16,9207
3231,緯創,15,0,15,凱基-永和,2024-12-16,9207
6603,富強鑫,15,0,15,凱基-永和,2024-12-16,9207
1815,富喬,16,2,14,凱基-永和,2024-12-16,9207
00713,元大台灣高息低波,13,1,12,凱基-永和,2024-12-16,9207
9105,泰金寶-DR,37,25,12,凱基-永和,2024-12-16,9207
2316,楠梓電,11,0,11,凱基-永和,2024-12-16,9207
2002,中鋼,11,0,11,凱基-永和,2024-12-16,9207
00679B,元大美債20年,10,0,10,凱基-永和,2024-12-16,9207
00959B,大華投等美債15Y+,10,0,10,凱基-永和,2024-12-16,9207
2014,中鴻,10,0,10,凱基-永和,2024-12-16,9207
6175,立敦,10,0,10,凱基-永和,2024-12-16,9207
2314,台揚,9,0,9,凱基-永和,2024-12-16,9207
3035,智原,12,3,9,凱基-永和,2024-12-16,9207
2421,建準,9,1,8,凱基-永和,2024-12-16,9207
00919,群益台灣精選高息,8,0,8,凱基-永和,2024-12-16,9207
2365,昆盈,8,0,8,凱基-永和,2024-12-16,9207
0056,元大高股息,16,8,8,凱基-永和,2024-12-16,9207
00688L,國泰20年美債正2,7,0,7,凱基-永和,2024-12-16,9207
00915,凱基優選高股息30,18,11,7,凱基-永和,2024-12-16,9207
2392,正崴,17,10,7,凱基-永和,2024-12-16,9207
3450,聯鈞,9,2,7,凱基-永和,2024-12-16,9207
00933B,國泰10Y+金融債,7,0,7,凱基-永和,2024-12-16,9207
00637L,元大滬深300正2,7,1,6,凱基-永和,2024-12-16,9207
00946,群益科技高息成長,6,0,6,凱基-永和,2024-12-16,9207
2345,智邦,6,0,6,凱基-永和,2024-12-16,9207
6188,廣明,6,0,6,凱基-永和,2024-12-16,9207
2354,鴻準,26,21,5,凱基-永和,2024-12-16,9207
3017,奇鋐,7,2,5,凱基-永和,2024-12-16,9207
00720B,元大投資級公司債,5,0,5,凱基-永和,2024-12-16,9207
2408,南亞科,321,5,316,凱基-永和,2024-12-17,9207
00937B,群益ESG投等債20,144,5,139,凱基-永和,2024-12-17,9207
00688L,國泰20年美債正2,80,0,80,凱基-永和,2024-12-17,9207
2317,鴻海,74,4,70,凱基-永和,2024-12-17,9207
4576,大銀微系統,68,2,66,凱基-永和,2024-12-17,9207
00953B,群益優選非投等債,43,0,43,凱基-永和,2024-12-17,9207
00915,凱基優選高股息30,40,0,40,凱基-永和,2024-12-17,9207
00948B,中信優息投資級債,30,0,30,凱基-永和,2024-12-17,9207
2356,英業達,30,0,30,凱基-永和,2024-12-17,9207
00918,大華優利高填息30,28,0,28,凱基-永和,2024-12-17,9207
2887,台新金,30,5,25,凱基-永和,2024-12-17,9207
4977,眾達-KY,22,1,21,凱基-永和,2024-12-17,9207
0056,元大高股息,23,4,19,凱基-永和,2024-12-17,9207
2382,廣達,20,3,17,凱基-永和,2024-12-17,9207
00752,中信中國50,17,0,17,凱基-永和,2024-12-17,9207
2883,凱基金,17,0,17,凱基-永和,2024-12-17,9207
00650L,復華香港正2,12,0,12,凱基-永和,2024-12-17,9207
2301,光寶科,11,0,11,凱基-永和,2024-12-17,9207
2405,輔信,11,0,11,凱基-永和,2024-12-17,9207
3594,磐儀,18,7,11,凱基-永和,2024-12-17,9207
4956,光鋐,11,0,11,凱基-永和,2024-12-17,9207
4979,華星光,11,0,11,凱基-永和,2024-12-17,9207
2385,群光,10,0,10,凱基-永和,2024-12-17,9207
00795B,中信美國公債20年,10,0,10,凱基-永和,2024-12-17,9207
1314,中石化,10,0,10,凱基-永和,2024-12-17,9207
1722,台肥,10,0,10,凱基-永和,2024-12-17,9207
5392,能率,12,2,10,凱基-永和,2024-12-17,9207
2324,仁寶,9,0,9,凱基-永和,2024-12-17,9207
2890,永豐金,9,0,9,凱基-永和,2024-12-17,9207
00679B,元大美債20年,8,0,8,凱基-永和,2024-12-17,9207
00665L,富邦�琤肭磪囓�2,7,0,7,凱基-永和,2024-12-17,9207
00687B,國泰20年美債,6,0,6,凱基-永和,2024-12-17,9207
2426,鼎元,6,0,6,凱基-永和,2024-12-17,9207
2483,百容,6,0,6,凱基-永和,2024-12-17,9207
3663,鑫科,6,0,6,凱基-永和,2024-12-17,9207
3035,智原,21,16,5,凱基-永和,2024-12-17,9207
00668,國泰美國道瓊,5,0,5,凱基-永和,2024-12-17,9207
2607,榮運,5,0,5,凱基-永和,2024-12-17,9207
2609,陽明,13,8,5,凱基-永和,2024-12-17,9207
3041,揚智,31,26,5,凱基-永和,2024-12-17,9207
3042,晶技,5,0,5,凱基-永和,2024-12-17,9207
3363,上詮,5,0,5,凱基-永和,2024-12-17,9207
4105,東洋,5,0,5,凱基-永和,2024-12-17,9207
4919,新唐,5,0,5,凱基-永和,2024-12-17,9207
6109,亞元,5,0,5,凱基-永和,2024-12-17,9207
8299,群聯,5,0,5,凱基-永和,2024-12-17,9207
1303,南亞,6,2,4,凱基-永和,2024-12-17,9207
6214,精誠,4,0,4,凱基-永和,2024-12-17,9207
00924,復華S＆P500成長,4,0,4,凱基-永和,2024-12-17,9207
9904,寶成,4,0,4,凱基-永和,2024-12-17,9207
2891,中信金,707,102,605,凱基-永和,2024-12-18,9207
00918,大華優利高填息30,65,7,58,凱基-永和,2024-12-18,9207
2328,廣宇,49,0,49,凱基-永和,2024-12-18,9207
5243,乙盛-KY,71,23,48,凱基-永和,2024-12-18,9207
00919,群益台灣精選高息,31,4,27,凱基-永和,2024-12-18,9207
4534,慶騰,25,0,25,凱基-永和,2024-12-18,9207
2312,金寶,24,3,21,凱基-永和,2024-12-18,9207
00937B,群益ESG投等債20,20,0,20,凱基-永和,2024-12-18,9207
2359,所羅門,32,12,20,凱基-永和,2024-12-18,9207
00728,第一金工業30,18,0,18,凱基-永和,2024-12-18,9207
00712,復華富時不動產,17,0,17,凱基-永和,2024-12-18,9207
3041,揚智,24,8,16,凱基-永和,2024-12-18,9207
2884,玉山金,14,0,14,凱基-永和,2024-12-18,9207
2454,聯發科,12,0,12,凱基-永和,2024-12-18,9207
3317,尼克森,12,0,12,凱基-永和,2024-12-18,9207
00679B,元大美債20年,11,0,11,凱基-永和,2024-12-18,9207
2436,偉詮電,11,0,11,凱基-永和,2024-12-18,9207
2886,兆豐金,13,2,11,凱基-永和,2024-12-18,9207
4561,健椿,11,0,11,凱基-永和,2024-12-18,9207
00909,國泰數位支付服務,10,0,10,凱基-永和,2024-12-18,9207
00950B,凱基A級公司債,10,0,10,凱基-永和,2024-12-18,9207
00959B,大華投等美債15Y+,10,0,10,凱基-永和,2024-12-18,9207
6215,和椿,16,6,10,凱基-永和,2024-12-18,9207
2363,矽統,10,1,9,凱基-永和,2024-12-18,9207
9958,世紀鋼,9,0,9,凱基-永和,2024-12-18,9207
3037,欣興,8,0,8,凱基-永和,2024-12-18,9207
1303,南亞,7,0,7,凱基-永和,2024-12-18,9207
2354,鴻準,14,8,6,凱基-永和,2024-12-18,9207
3013,晟銘電,6,0,6,凱基-永和,2024-12-18,9207
6425,易發,10,4,6,凱基-永和,2024-12-18,9207
00965,元大航太防衛科技,5,0,5,凱基-永和,2024-12-18,9207
2419,仲琦,5,0,5,凱基-永和,2024-12-18,9207
5876,上海商銀,5,0,5,凱基-永和,2024-12-18,9207
5483,中美晶,4,0,4,凱基-永和,2024-12-18,9207
5328,華容,14,10,4,凱基-永和,2024-12-18,9207
6426,統新,4,0,4,凱基-永和,2024-12-18,9207
9942,茂順,4,0,4,凱基-永和,2024-12-18,9207
2887,台新金,4,0,4,凱基-永和,2024-12-18,9207
3019,亞光,20,16,4,凱基-永和,2024-12-18,9207
2317,鴻海,10,6,4,凱基-永和,2024-12-18,9207
3406,玉晶光,4,0,4,凱基-永和,2024-12-18,9207
6643,M31,3,0,3,凱基-永和,2024-12-18,9207
00945B,凱基美國非投等債,3,0,3,凱基-永和,2024-12-18,9207
1449,佳和,3,0,3,凱基-永和,2024-12-18,9207
1785,光洋科,3,0,3,凱基-永和,2024-12-18,9207
2409,友達,3,0,3,凱基-永和,2024-12-18,9207
4533,協易機,3,0,3,凱基-永和,2024-12-18,9207
4909,新復興,3,0,3,凱基-永和,2024-12-18,9207
5457,宣德,5,2,3,凱基-永和,2024-12-18,9207
5460,同協,3,0,3,凱基-永和,2024-12-18,9207
6188,廣明,204,14,190,凱基-永和,2024-12-19,9207
2359,所羅門,169,19,150,凱基-永和,2024-12-19,9207
00878,國泰永續高股息,140,8,132,凱基-永和,2024-12-19,9207
00937B,群益ESG投等債20,120,2,118,凱基-永和,2024-12-19,9207
2408,南亞科,106,1,105,凱基-永和,2024-12-19,9207
1560,中砂,55,0,55,凱基-永和,2024-12-19,9207
2891,中信金,55,0,55,凱基-永和,2024-12-19,9207
3481,群創,51,0,51,凱基-永和,2024-12-19,9207
00948B,中信優息投資級債,50,0,50,凱基-永和,2024-12-19,9207
00688L,國泰20年美債正2,46,0,46,凱基-永和,2024-12-19,9207
3376,新日興,49,3,46,凱基-永和,2024-12-19,9207
00919,群益台灣精選高息,58,12,46,凱基-永和,2024-12-19,9207
6669,緯穎,45,0,45,凱基-永和,2024-12-19,9207
00712,復華富時不動產,35,0,35,凱基-永和,2024-12-19,9207
00953B,群益優選非投等債,31,0,31,凱基-永和,2024-12-19,9207
2834,臺企銀,30,0,30,凱基-永和,2024-12-19,9207
00679B,元大美債20年,34,5,29,凱基-永和,2024-12-19,9207
2356,英業達,39,12,27,凱基-永和,2024-12-19,9207
5531,鄉林,30,3,27,凱基-永和,2024-12-19,9207
00751B,元大AAA至A公司債,22,0,22,凱基-永和,2024-12-19,9207
00687B,國泰20年美債,21,0,21,凱基-永和,2024-12-19,9207
00945B,凱基美國非投等債,20,0,20,凱基-永和,2024-12-19,9207
00764B,群益25年美債,18,0,18,凱基-永和,2024-12-19,9207
00795B,中信美國公債20年,18,0,18,凱基-永和,2024-12-19,9207
4956,光鋐,16,0,16,凱基-永和,2024-12-19,9207
6558,興能高,21,5,16,凱基-永和,2024-12-19,9207
00922,國泰台灣領袖50,15,0,15,凱基-永和,2024-12-19,9207
00950B,凱基A級公司債,15,0,15,凱基-永和,2024-12-19,9207
00915,凱基優選高股息30,15,0,15,凱基-永和,2024-12-19,9207
2317,鴻海,23,9,14,凱基-永和,2024-12-19,9207
2883,凱基金,19,6,13,凱基-永和,2024-12-19,9207
00680L,元大美債20正2,12,0,12,凱基-永和,2024-12-19,9207
2609,陽明,14,2,12,凱基-永和,2024-12-19,9207
2897,王道銀行,11,0,11,凱基-永和,2024-12-19,9207
00893,國泰智能電動車,11,0,11,凱基-永和,2024-12-19,9207
2382,廣達,18,8,10,凱基-永和,2024-12-19,9207
2882,國泰金,12,2,10,凱基-永和,2024-12-19,9207
00725B,國泰投資級公司債,10,0,10,凱基-永和,2024-12-19,9207
00959B,大華投等美債15Y+,10,0,10,凱基-永和,2024-12-19,9207
2328,廣宇,10,0,10,凱基-永和,2024-12-19,9207
6603,富強鑫,10,0,10,凱基-永和,2024-12-19,9207
6763,綠界科技*,13,3,10,凱基-永和,2024-12-19,9207
0056,元大高股息,10,0,10,凱基-永和,2024-12-19,9207
6869,雲豹能源,9,0,9,凱基-永和,2024-12-19,9207
2886,兆豐金,8,0,8,凱基-永和,2024-12-19,9207
2483,百容,8,0,8,凱基-永和,2024-12-19,9207
6202,盛群,8,0,8,凱基-永和,2024-12-19,9207
2303,聯電,11,4,7,凱基-永和,2024-12-19,9207
2002,中鋼,7,1,6,凱基-永和,2024-12-19,9207
006208,富邦台50,7,1,6,凱基-永和,2024-12-19,9207
